NRfMdZUPYGeFBAQLICKEagTcJWVSDHbXO,QDACLAFBCBACKEGFEEEH....TAECJBDH...SDCHhAAAHFBAOHACfCDDhABAMDADdEHEZGCE.hAAAYHEGeHDGABFHIAHCcBGGDBBC.XDGAhACA...hABA...,1,-2,-30,28
SJdGRKODNLWcEbXFIZCYBVHPTAUQeafMg,UDCHQGGDeDHF.aBFHMHDE..JFAGGBEHRAAB.DGAELEEBhAAAECAC.FBHBIAHFhAAACEGGBADA.HACAADIHSCDFhACAODFH.NIAF.......hADA......hAFA...,1,-14,-24,10
IMAeJOYEgHbZaUKXSLWTdBGCfVQcRNPDF,OAABEHBGHAFBZEACUEEAKDEE.LDCF.dAACCDCGQEGAhABARGFA.DFFDFBDFABECeHBGhACAJDHH...bBDCSEADhACA.BDABfAGE.hADA......hAEA...,2,-28,-15,13
LHeBcYOJGdCPRaTWQIDMZbXfVNFUASEgK,SAFBEAFBKDGB.eEADBFEF..OAABdDBCCBACRFCB..TGFGhABAQGGGMFEHbFBFhACA..VBCAFDEAADCC.hAAA............hABA......hACA...,1,-20,-39,19
EMWBcZAJXYfgIdSCFDaRPKVNeLUbHGOQT,JDACXCBC....fABEdHBHCEHHaBGE.KEAD..eFEBhAAALBHFHFACODFGhABAEFEABFBHZFFFAHFHIHGEhAAADADE...RGBA.NBBB......hACA......hADA...,2,-40,-14,26
ESWRVbJKAaZFUTQXGNedDfIPHCcBMLYgO,aEHBUCCB.QGEGGBCCdEFEDCFG..IGBFHGBGCCAFBABGhAAAMADELAAFOAFCSEFEhACAVBFEKFDBAIHCFFAEhADA...XGGF.....hACA......hAHA...,2,-23,-15,8
JMZCBfPOGRSQVLaIAEXNTKdgFcWeHDUbY,XGBCKGFCFDCE..eAACDBDHUEAD..JFDDZFFHBAFEOABFhAAARBEB.QBEFhABA.LEEEABHAEBCA.hAAA.dHFHcGDAHEAEMCIFCAHC.fHAFhAEA....hAHA...,1,-16,-28,12
gWOaVfTLKGCUJFHASRDYdXBeIMcNbZEPQ,RFFADGHHdGCBBHBB..eACBMFID....bAGFZCCH.QCFGhAAAOEDC.aFABTAEAhAAALABDKDABCHHGJAEC.hABAFHEEAECF...SBED...hADA......hAEA...,2,-30,-27,3
bCWAPDGXVNfgRTdMZHeJQKYcEOaIUBFSL,DCECXCCF..fFEARAFCdGACZEBFHDGHeBAG.KGHB.EACAIFHHhAAA.BGBEhABALFDECEBHAEACGDEFhACANBAG.MIBA.JAHDcGDEaADC....hAAA......hABA...,2,-20,-16,4
ZBQDgeASMXNHIabcWLTfYdCFVGRPKEJOU,MAEDHEFHaFBE....bEEBLHEA.fDDBhAAACGBCFBBBVBFEPBCCKHGA.EAFGhABAJEGDUDAABAFFDDIFADCD.hAAA.SCADIHAF.....WHAAhABA.....hACA...,2,-28,-14,14
KTMSadYLDQBVceWCJGZOgIfPUFAbXERHN,EGFCRGFGKECD..MDDDdBEADIEEBDHE...eCBHCCCEZBFDOHBG.hAAA..fEFAhAAAFFAHACID.HABCSBABhABAaAGAQAEC..WACC..hAGA......hAHA...,1,-11,-50,39
JcOeBCUgAKfIQabMHZTGDXdVNSYRFLPWE,KHBGQCBCMAGBZDGBGDEC.dDHASDDBFGGBLADCEGHF.hAAA...OFCChABACHBGgFBBAFACaCBBTADEhACADAACXGDD.......hADA......hAFA...,2,-32,-15,17
IBMZROLGJeWfKFANQgDdbVHTPSaCXYcEU,QCBCDGHHdADEHDDGSACCCFBB..XAFBEGBBBDHEMBADhAAAOFDGLCHHhABAeHEAKDEAAGFA..bFCDPAEChAAA.aGCFYBBF....hACA......hAIA...,1,-17,-26,9
QARDETKWgCSBHXZMcfNOeJPLVbUGYaFdI,DGDETFCEKDAF...CBHCBBFAZCFBMDIH....fADGhAAAOBDAJECGLDCAhABA.bFADUABG.aHGGhAAAIFHBAHEF.WAFC.SCBEhACAXGAB.cGFC.hAEA...,2,-43,-20,23
SMdHOPBWcITCgQGXaFRfYVKLZEDeAUbNJ,UCBCJGEA.dCFBHDABBAGF..IBAACEDA.QADFhAAAaGFE.FAHHRFAD...fDFChABAKAAGEADGAHIF.SDDBhACAODHD.cDGD.TGBChAEAXGDF....hAAA...,2,-46,-8,38
OUZDXPIeJdGBfKMRTSaEQWAVbgLNcFHYC,VAADLGEA.FFAACAGBZEDFDABE....XBDEeFFGGDBEhAAABAECKEFHTADA.EBGBhACAADDC....bGAG.hADA.NIDF...cCBH.....hAFA......hAIA...,1,-19,-44,25
fPOFZCUbNJGLVHSEcAaWMYIDKQRgXTBde,aGFHMCCA.DFGBRCBF....XFADBBHCeACEOEDACDEG.UAEFhAAAJGAA.LDHBHAAEEFHFhAAAAAIF....YBAEhABAQGDC........hAFA......hAGA...,1,-23,-36,13
MCacQDZLWfGEgXAPNSITBFOVJdeHUKbRY,SHBGBHHGODAAdBAFUEGEREGF..MAHFCCGC...QEBGhAAAZFAFLDEHGBDGhABAEACBAAACIAFD.hADATGDFJAEEHFCFKEAD.......hACA......hADA...,1,-14,-28,14
WKLeagRPOfbGNEUdBTIHYSCJZXMADcQFV,DAFBFGFCKHDAeCAB.RBCB.OCBCGEGA.UGAFBAFB..HFDBSEEGhAAACFFCZCFE.AIHE..hAAAQEBA.hABALDHF.aABC...fBGFhACA.EADE.dHAFhAHA...,1,-22,-32,10
XVGFeREIDZcHJTUMAPSfLYKaCgdbOQNBW,SHBGLGEAKCABCEFD.dAHA..QAAABHBA..XFBAhAAAFGDEEDBADBDAHCEHTGGAhAAAAEID..fACDhABAaCFAOAFGNEAE......WCCFhAEAeDEE.ZEAE...hAFA...,1,-8,-38,30
DELbAZVdfQOcPeaSXUKBNYJFGMHTRCIgW,VDDFQGBC.OEHHeAFD..SBBGXGEGBCDBhAAAJHCAFACCHBFC.RDEFCEBBIAGChAAADABCEAEAAIHEfGFHhABAaCBCKEAD.NAIEGEAE....hAEA......hBAA...,2,-23,-7,16
MDLdSEfHATUcGYXVaCPeFJgQNRWOZBIKb,TCGCUFGHGEBF..XFAFCAABFCBC.QFDCRAGHZADEBEGEhACAbCBA.LAAEhAEAdCEE.EHFAAIEG.VAEEaDAC.hADAJFFA.NIAF.....OFAHIBBAhAHADCIB......hAIA...,1,2,-23,25
KQgGAPHJaBfYVbDITCUZceLXdMFSWOREN,HFDFBDGF.VEBFDCCACFBHZAEB.LCAEdFAG.MFIHSFDHhAAA.RAEA.KABEGDBFhABAPBHH.aFFC.fHFFhAAAYFGDICAE....hACA......hADA...,1,-6,-44,38
ecWSUIOEXDVFQNbfgRLTPCZAGHJKYaBMd,GGDHHDEDKDAABHACdBGHeABGSBGD.OCEHXDGDDFBGFEGFhAAAQGGE.hABANGAF.gABHhAEALCDDPHAAAGIBaAFAMIBCWAFC.EBBB...hAIA......hBAA...,2,-27,3,30
QNbcdRIgPWVeTYCKJFMZUALHGaBfEDXOS,LEGHGBCHBBAADGDAOEAESEHB.QGDB.hAAA.NEIEdABFIGBChAAAgCBCPDABeHDGhAEATEFDCBGG.JDDFMDEAAIBAfABBEAEF.hAGA......hAHA...,2,-28,-11,17
NXLKTIWHOcVEdgSDUZRbFQfCaMABePGJY,BAFBGECFJADB..XCGGLABDTGBEHEDA...OACBhAAAVFBHdAHEDBEGUGGChABARCEE.FAHD.CFAEAHFBPEHHhAAAKDAA...........hADA......hAEA...,2,-25,-21,4
RKeNdUQLVYFTBOXaHDPEJfgZCAWMGIScb,GBGASHBGRDBBKAAFdBDCLBCCFFBG.BHAHXFECHGFGEEEBhABAJCEC..ZABDAICAMADEhACA..IAGGhAAA.eBAF.NEED........hAHA......hAIA...,1,-22,-23,1
faRGJDHWVLOFAYTPZCQEBeXdKNISgcMUb,TCBCCFDDBEFE..dBHCKAAD...SCHFMCBGUGGEaGBAGDAFhAAADFCAHAEA.LFGFhABAAFBBZADA.EHAG.eEEHhACAIHEH...bGAC....hABA......hACA...,1,-9,-37,28
JEOFULgBdNfGQbDMKRPCWceAXHISaTYZV,HEFHSAFBaCAHZGAEEEBGUBCE..BEHGdBGFGEAFQBAChAAAMFIBPEAH.CHGHeFEBhABAABAEXGDD.hACA.TDED.VACE.OHAE.hAAA......hABA...,2,-18,-1,17
HVGNgPdXcLYUDJSEaefOKbRCWZIQATFBM,TGAFMAEEHECH.GBED..PACAXBAGLHDEhAAADIEEJGEASEFDhABA.EAGBeFBBOCBGhAHAKDBECAHAIHHEFEHH.NAIAcEGAaBBA..hBAA......hBBA...,2,-22,-9,13
XEfACFdHNQGLTWSBeKUDObVIPJRagYMcZ,CEFAFEHBdFDAQABAGCAHLCHF..SEBCKGBCDAGC.hAAAbGDG..VACEIAEEhAAA.REDGaBGB.hABAMBADcGGGEGABAHHCNIBFBCFA....hACA......hAFA...,2,-28,-12,16
LAbfBYGWITNEFKVDQHJPdRXgOZSaCeMUc,BFDGGAFE..TBFEFDCCDDBHHBCFdEFDRFDGOFGBZACE..CHBG.eEEBhAAA.MAFELDHBhAAAAIDG..fHBFhABAIBAEKAHBVDAF.......hABA......hACA...,1,-12,-29,17
SdgVHZODUfTbIFGEXKMAYLeJBPaRWCNQc,LEEGeEGHBDDGaGBGCFAA...QABAdACGHCFHDAEFUBFF.TGDDhAAAFHCAEHAE.KDBBMIAAhABA.JEAE..PAAFhAAA...RAFENEFESBDH.hAFAgGGG.hAHA...,1,-13,-20,7
HcfdIZMEUaDGNXgSFJVYebLRPBWKTCOQA,HAADdHBHMEDEaBGCDFAHGACD...XBGDgEEE.SDHFhAAAVFDE.eEHHhACAbCCCLCABhAAABGDDTDBGCHHBAIGA.IHBE.ZADF...hABA......hACA...,1,-5,-17,12
fQLbOWDVEJXZIMgTPaGHKdFSYUcRCeANB,BFDGQDACLAEAODFDDECA..JCHDIHFG.MDEBhAAATBCHGAGEHGAAFGAGhABASGFG.hACA.cACEeDAFACAAbECDEEFB.....hADA......hAFA...,2,-27,-18,9
NEWZISKBdGegQJFMAYTLbcDfOXCaVRHPU,TDACLGEA.DAGCOEFECBBC..aBEARFBGHACH.UAFHEHBEZCEFhAAAKHGAdAAEGDABeHDAhACAQCGAMEDEACID.hAEAbFAAXGAC..NABF.....hBAA......hBDA...,1,1,-18,19
AaEIYNDBgVTXcFMdOWZHUSKeGRPfQLCJb,aAFBEHBG....IAFEDBBCBDEE..TEEGFDADMAAF.OFFGhABAZDGDSAABhACA.eFHHPHCAhACAfEBCQBGBLDAECHGGAAHB..YCCFhADAgGDD.hAEAXAGH.,2,-29,-10,19
YOaVFUXbcAKDJCIHedWTNRLPSMfgGQZBE,JEACHDBH.dBDE.TGEBLBCE.MBGBGBFGZCGBBHBHOADAhAAAFGGEbBAC..ACACDFEDhAAACHAHIAHC.NCIC.hABASDCE..fGGBhACA......hBBA...,2,-47,-8,39
JUKLgQDGPMcNISaCZRYWHfOVFdeTBAEbX,XGBCUAADKEFCLBDADADG..MFFD..ICHAhABASBDCCHGB.RCGDHAAFhAAAOEHFdCEABHAEAGEFEGGEJEBChADAQAGDGFDF..NAEF.....hBEA......hBFA...,1,-12,-29,17
CXQWAeKNaGHTZROcUBISdFbEJVDMgPLfY,KDCDGEAHHEEFZABCOBCEUFGEBHDH.dAGCbGAA..EDDEDFIH.hAAAMACC.LCGFhAAACGDC..WBHBAHHHaDDDhABA....TCACcAGA.SHEAhAIA....hBAA...,1,-21,-31,10
PdYaEJOTAUcgHeFKNZLMGIbQBXfDSVWRC,UCBCHAADKECALCFCMBGDGEAGQEGGBFFGDHBC..SFHDhAAARADCCAAC.dCDBEEEFhACAJHCCAADA.eACE.NAHC.hAFAIHHA.fGFE.WHBAhAGA.....hAGA...,2,-25,-16,9
dgUSVTDWBFJaHILCeQPKXAZRMNcObYEGf,MGCEOGEA..EFACdABBUBDFSCBC.DIGABHCH.aHEAhAAAIDHDCCBC.QGBAhAAAKBHFAEBERDFB.cDDEhAEA...GBEHfEDB.hAFA......hAGA...,2,-41,-31,10
cAKaRTFMUNQPZCYDEfIdBbLWHeXgSJOGV,KEHBTCCBFHBA..UAABQDAD.CADCDDGAEADBdCDH.BDFAhABALEGDHGFAeFBEhAEASGAGGAGEAFDFaBFAhAAAMFAFZFDB.IABF.WHFA..hAFA......hAGA...,1,-17,-25,8
BgLNTOYXWCQEVaHbGIZAPdfRSUDKMeFJc,dHBHRDAGUGEBKBAHFEHHBBHC..LFFF..OCGH.XACGhAAACBEEEDECHEAE.hABAIAHAAIHESCDAhADADCCDMABGeGAC........hAEA......hAFA...,1,-32,-41,9
LGXWSebagQdZHUNYfTJVCEMOADIBFPcRK,DAEDFEGDRCBCGCAE..SGACeABBaGHB.dBFAUGAD..fHBHhAAATEDFCGFF.OHDChABABDHHKGDDLBBChACAXAFCbEEB...gCFF.hADA......hAEA...,1,-17,-25,8
OGdHXFZbKNRIYCUDAJLgcSMPTEVQBfWae,JEEGLGEA.SCHHTBDG.QADBBFHD.aGBHeAAFhAAAGBFEXEAGhACAbEAE.KAHFRBAG.CHDEACIHcDDAhAAAEGGD...fHCDdCBEFGBG...hADA......hAEA...,2,-28,1,29
NUMRGZHDdWeOgfFLVJEbcaSYATXPCIQKB,TCGCCHHGKDGF..BACGUDAAGCCGHFDADFID.....WECEhAAAOFAB.FFGEJBBChABAEHDEaAHFAICA...IHFEhACANBBG.RAEC.eAED...fFEEhAAA...hADA...,1,-22,-38,16
DgRcBeNGQWVOHICdPUFZMAJXYTbafLKSE,JDACXCGC..TBFAaGBA..LAAFSFDEEGHDDFEHhACARABCBHHEGDBB.QAEFhADAVFBF.IHBAhAFACHDHdGGCFEGEAGGD........hAAA......hABA...,2,-32,-11,21
BZbDXIeGaREUMdYQTgAPSWFfHCVcNOLKJ,SHBGFHBGHCDECABE...VBFAODAHKCEDZBACDIGE...eHFAhAAAGDGCEFFF.UEBEMADEhABAdFECQEBBhACAACCD.PDHDfAHENBBFBEFC....hAHA......hAIA...,1,-5,-26,21
SaLCXYKQAFDUMZIJPdHEBRebVNcGWOgfT,UCBFMECGZABG..IFEHdCFBBEFARCGD.eHFE...VFBEhAAAGACB.OGAEhAAA.fHGFhABAaCCGCDAGKAHBADIHDIBA..........hACA......hADA...,2,-37,-33,4
cMZDfWIYLPUgbFENQeVaKTJOGHXRBSACd,dEGDMECGZCDGDAGC....IAFBLFDCUDAEFBCDEBFE.QGDDhAAAaHDGKGHBOAHHhAAAXFAG.SCHHhABAAGGCCFCH.fBEGYABA.gDADhACA.eFGHhADA...,2,-35,-25,10
RYfBLUTIPcGEgdASDWMHNCeVOXQJKFZba,SHFGMCHFHCCCeGCGOBGH..QABGJEDFZAAC.aGBHRDADBFGFhABATAFG.IFFEhAAAPAHD..EDDEdEBFhADADAFE...NEIE.CGHH.......hAEA......hAFA...,2,-24,-11,13
ePBbJYUaTfNZMEcSXRdAIgHDCQVWKOFGL,HAADDEFACGDG.VDBC.KBFCFBCA.LFCFBHCB..JFFCUGFC.hAAA.aAHFTAGAZFAFMACEhAGAEEDG...SGEBhBDAdDAGAGAH.IDGHgBAE.OCEEhAAA....hABA...,1,-18,-35,17
acXRZFCUGeEJITOHVfgYKdSBWbNQPLDAM,MHFGXGBCFCAHGEEH..EABEJFBHIEGH.ODDHhAAAfAGEKEBHSEAFhADABDEG.NEIEQFEDhAEALAAGaFCFRBDBCAHCeCCC....hABA......hACA...,2,-31,-9,22
OQgbDCKdSafXcLARWZYMBHPNFeUGEJVTI,RGFGZAADMEEHHFFD.FBGDeEBBUEBE..JFAF..TEDDQABBhAAADAFFKACGaGDH.XCEEhACAADDEBHHH...NAED.hBAAEDHF...OHAACDCCdFFBfBDHhBGA.....hAAA...,1,-3,-29,26
DcdXBKCfQaZRWLMGVNJbSeTEIUPgOFYHA,DGHHXGBCCCFA..QBACZGEARAFELAAFGEDD..VCCFhACAJHBA.eFFA.IEAEhADAgACG..hAAAFDGBAAGBBHEB.fFAH.WAHDhABAMBBESEAChADA..,2,-30,-17,13
dgARJYCcaDXSBMELPIfeHKZFUTbVOGWNQ,RFDFJAFBCAHD...DBAEBAFELACH..IBBCHEFAFEBEUBDChAAA..TCGC.hABAOHBANCIA.dEECACGGaGGDhACASHAG.MIECEDFCPEAAhADA..KGHB...hAEA...,2,-42,-17,25
LVdDcKfCZYJUAGageXSTBQRPNbIFMHWEO,aGAHeDAC...SFEEQADDRFBH...bECFMEDEHGFEOFHBhAAAdHCDKCAECAGGJHDGABHCgEGBhAAA.BGBFhABAIBCFEDABDDDEfBFG.YAHBhABA...hACA...,1,-10,-25,15
ESIXeaHGbLNdcUCBZODAFRgVTJKWPQYMf,FCFCRGFG..VDGBTGEE.KBAEQBDH.MIDASECFhAAAXDAHaCCG.bGAGhABAdGAHUEGBCBAEBGDGDEBBAIBGhACAgBGC.PAEAYAFGIACDhAAAHDDB....hABA...,1,-7,-19,12
KHgBNVUOSGfacIZWAeRbYDLJECXdTPMQF,eFBBRAADDAGCLEFFCADD..dDGBMAFFKFFGHDCDBCDA.UAGCOEAChAAASCCCGBGEaGBDhACAZBABABAD...bFDDhAAA..EHGA.........hABA......hACA...,1,-22,-24,2
JUNLHVAcSPREgfQDTGBYZXebaOFIWKMCd,SHBGRDAGEGHH.QAGETDFFBHFEZDAEeFBG.OAABhABAIHAAMHFEdABA.hACAJADCUEFDLCHBhAAAABCFcBDFfCDHDEIF.XFDB.hADAaGCB.KAGECGAC...hAEA...,2,-12,-8,4
cYOJGENXIPTRCHABLQUZgWbDKFeMdfVaS,LEBEUCCBZEFG...bAAFFGAD.dFCGaGCA..SGGDhAAAOADHEDFB...IDHAhAEARAEBAACGBEABQFGEhAFADIDA.KCFC.MIBAcAGFYFFFhAGA......hAHA...,1,-14,-40,26
TKFXVcadMOeRQJUfZGNHgEYAbBLSWIPCD,BAFBSDCD..PACBCGGADBEBKAGHFEHF.....VGCEhAAAdBECOEED.eHCGhAAAJDAHUBBHZEABNBAE.HEFEhABA..EGGBAIHEWACCXCFB.MDDFhABAQCGB.fGAEhAGA,2,-30,-22,8
ISTQCRcVgdYJZBbDONHGLUfAXFMEPeaWK,FBDHMHFGEEFD..eFCHKDAE...SCEFCGADREBG..VBGBhAAAdEHAYACD.hABABAFCDACHOGEChADAHEABLAABAIHEaAEA.TCFE.gFEChAEA....hAHA...,2,-34,-15,19
TWEAFeKGgMUNCPfLRZXOVaSBDJIQcbHdY,FEEDKAEGMFEGCFCG.LHCGRCCFZBFC...OCAHaHFG.BFCHDAAF.hABAQCDCHFABdAGH.hACATABFEEHD.AAAFGAGAhABA...UGGCfBBESGAFhADAIDAE..hADA...,2,-35,-6,29
ZHMGdBRSVFPbafNKXYWcJgCOUITDLEeQA,MGCEdBCGSEBDFBAA..aCEDKCEG..XBGB..hAAAcAGCCBDBOEAAIGFGhAAALHFE..hABAEEFG.AHAGZECBBEHC.RGAE......hABA......hACA...,1,-26,-42,16
LVSdXeCUcEYWHaZQARJFTODBMKIfgPNbG,RDEDFAADDCBEMCFD..KHEE....fECH..NBAELBGHhAAAdBGFCDGAEDAFHGAAhAAAaBEBZDBHJGDABGAHIADChACA...gGGH..hAFA......hAGA...,2,-49,-25,24
VDCKNLaSJUXPFZBcTERWQIgeAHOfYdMGb,HFDFOGEAdBFHGACGDFIFKDAELAGF.SBAHUGFEXCCFhAAA.ZCFETEAFhAAAEACE.WHFA.IHBChABAAAGDfFAHbEFECDFD.JHAABAEG.QFCAhACA..hAFA...,2,-19,-13,6
LZQFYVSNDIbEBaMKCRUGcJAdTfPegHOWX,TGBCeGEAODEB.LACGFCEESDCDDCDG.EAABBDGDhAAAKGEGCEGH...RACCUGGEhABAcDAHdAHA..fAHGhABAPDAH.gGBD.WFFEhADA.....hACA...,1,-19,-28,9
VcPbgRLFUHedGSOZTEfNYBCKJXWMDaAQI,VEFH..PFBBRCCFLFBBUDCBdBBFGACHZFGB..EAEA..hAAAfHDHBGFHCDHCKDAFhABAJAAF.MAIHAGDBQAGEhACAIGAF.........hABA......hACA...,1,-23,-24,1
gZYVFdKBWEfRDUGSQbLeCNHPAXITMJaOc,XCGCMFFF..JBGHaGHF..OAABZFABFFEFKCBABDCH.EDAHhAAADFAHGABFSEDFhABAQAGELAEHhACACEHE.NBIC.AHHB...TGGE...gGAHhADAdCABfFCAhABA..,1,-7,-38,31
fYOJXSRPdKBIeFCgbGLHEDZNTAcVQMaUW,QFDHaAGD.UBFGfBBB.JECCXBCA.hAAAPEAAKEABBEHDIHHEhAAAFFGHgGDGhABALCHBDHACTAEEABACMIBE.WAFESDDEhACA....hADA...,1,-16,-34,18
LCIDEBfHbRFNXaAZVgeSPcOMJTWYQKUdG,ZGFGVFDFeBEE..SDDF.OABHTDBC.YEEEhAAAQBGD.UGGAhAAALFABCAEGDECHfFAAhACAHFCHRBCGNACFAAHA.PHACMABH...WAFEhADAKFGC.....hBAA...,1,-9,-14,5
edSENZgJFXAcaBCbIQfPDTRKMHUYWVGOL,BFEDCFDG.QFBCDGHFKAAEHEEEUDDD...VAEGLDAGhADAdGGF.EBGAZAACFFAFACEFaHCEhABA..IHEFhAEA.fBCCPCABMAIF..YDHHhAFA...WHAAhAGA..,1,-25,-27,2
RgYdGaBECFXfbKSLWJOMUeVDZPHcNAQTI,QCGCREFHdABDBFDG.CHGC.FDCE....XDAAKFACLBEChAAAJFDFOBDFUGAF.VAAChAAADIGG...ZAFE.PFABhADA..NAED.AHIH...ICAFhACAYFECaHDC...fFHAhBAA,1,-25,-35,10
HSIgQMYZBVaPdfXNCeFbRKLEUWDTOGAJc,JFBBHDAG.SACDQCBFZFDABGGBaBGGdAAE..XEEFhAAACHFGFEECKFBDUAGB.DHDGhABAOCHDAIDG.IADChAFAMFIHPACA.NDED......hAGA......hAHA...,2,-25,-22,3
ODMQCgKbNWUPHLZFXBTEcSRYAJafdeIVG,aDCDeCCHGEEDODFEDGHF..MGBA.CACH.KAED...NACCUGDHhAAALFGD.FCAHBGBEhABAEAGDSAHBhAAAAGADdAFA..IBHF.....hABA......hACA...,1,-33,-34,1
VSCgDdRBaWNbTGQKeMHIEZAcPFfOLJXYU,FHBGOEEGLABC..XABEVAFC.SBFCCCEA.hAAAdGGFBEGCaGCENCCGTFGAhAFA.GCBEeFADMAAFhABAIFEBAAEC.fBCB.YHDGhAIADEBB...hACA...,1,-20,-29,9
aZSCRGeWEPdLTJcMQKHNYgBAVODUbXFIf,OAGHDAFBUGGEFFFD....aGCGCDEBGECG..EDAGdAABJBGDhAAAMCCBKEAF..HEEEhABANDAC.BBCCAIFA.XDCBhACAIBEF...fEHG.hADASHAA.hAEA...,1,-34,-35,1
AUJdObPXNZFIWQgRGBMEDTVHfeYKLCacS,UGGDdGDBOCFF..XAEAZEABFBAA.QABG.RDACGEDGhAAAMBIDDAECVDFEhADAeCDBLHAAaHGAAACA.hAAA...bFBD...NBDB.IBHHhAEABHED......hAFA...,1,-13,-22,9
SJBCTNIFMRcOdXZaLAgVDbKYHPGWEfeQU,DHCEKHBGHBFAGBBGECDBeACG..SGGHBHHFCEGF..TFEEhAAANAAFMDFB..OHAChABAdEGHaECFAEIF..bBFA.hAFA.PHDA........hAGA.WBBFfAGFhAEA..,2,-27,-25,2
fXSYKeaIDMHORLbQEACBUgPTZdFNJcWVG,CFFGUGGG..TBEEFAFG..JCGD..VDGBGECA..SBBDhAAAeCBFDBAHOAAGhAEALEBF.EAGCAIBABCEFhAIAPABGdFEANICHfEDA.KGHBhAFA......hAGA...,1,-26,-32,6
NSDFZLaWJXcBOgMfPeAKQTCEIVURGHYbd,KEHBCCAH.EEBEUCEH.GDBEHGDGdBGH.SBBEDEIHZFFBLACGhAAAaHAE..JAEFBHDChABAMDAB..fAGEhADAADDCQEFAIHAE....hAEA......hAHA...,1,-19,-39,20
UQKDfdaHTPLVcAYMCbIBgWFeGJOXSNZRE,MBFHCFDGBEFEFDCDGCAE..OHCE.SGHDRFGBUAADDHAAhABAaFADHAFD.TCDFhADAPACH.LGDChAAAAICA.IBAAeHDE.JAGB.NAIEEEFAfADFhAHA...hABA...,2,-22,-19,3
cZQSYMOHWdfEFRNaUBJDICXLgKVTbAePG,GECFQFDHMHEAHCEEdBACFBGGaGBHBBBHDIAC.CDCC.LAEFhAAA.KCHHbFFHABFDeBCFhABAPADA...SEHBhAAAOGAEEFGA........hACA......hADA...,1,-17,-18,1
DZcaXBfdHJTWYMPACIULVbKGSFgNReOEQ,UGGGLFBBKFAGGBEFFCDBRFEF..eABHEDGF.DEFGZCCA..aAFFBAEHhAAA.dCAEJAHF..hAAA....YHBAhABAAGDECDAGIHGE..SBBEhACANEIE.OFFH..hADA...,1,-29,-30,1
eUXfgDIVZcNSWBMaGQROFdYPAECHKTbJL,CHCHTCCBLDAC.UAFAXFAF.DBBAVEBBZAEE..SHEGhAAABACBMIEAGCGAhABAQFFCFEEDdCAEABEDEBBGhAAAKGCBeFHH..fEHE.hACA......hADA...,2,-26,-9,17
IadRfCbcgBFMDGPSLNeUATKQVHWEOXZJY,TFCAVBCF..EEFDZACG...JEFAIAHEdBGCRCAB..CDCE..hAAA.gCFEhABAMIAGDGGD.SFBChACAeEEBAIEA.KAEA.HFGF.WHCEOBHF.aEAHhAAA......hABA...,2,-24,-15,9
KPUZVbRDBLYMSTJAcaGQHfdOeCXWNEgIF,GEAHHEFHdAHGeBBAXEBDEBEA..FHGEKCCHZFEERAACBEHEMDEAJHBChAAAAHIH..QBEEhAAA.CHGH.NABHIAHAhAGAPFEB..........hBAA......hBBA...,2,-19,-19,0
ORCVIHabDZNdTSGcULFQeEfJgWYPBAXMK,MBDHKDBDOCFBRGDE..CHHEHEAHDBGG.dEEHSEGDUCAB.QADFhAAAeAHDEABF.JHFGhABA....WDGBhAAABDDEAFDD.XGCF.aCAANIAF...TGAChACA....hAEA...,1,-16,-36,20
LHYZbcSDUMfWeEKdCJNVOaTBPQGXgRIAF,FDBDLFBBZDGB.SGDAUGAD.MCACeABF.KEEFdBHC.CBDB.hAAA.JHFGVAED.OGDEhAAAaEECBEAC.QEGChABA........hACA......hADA...,2,-40,-31,9
MNgJPKQYeObTVRALXHaGUBfZEcdSICDWF,XAEGaBBDGEEDUEEHBAHG.ZADAdBBE.CGHE.DDGA.FFCFMGAA.hAAA.JEABKDHD.eHCAhAAA.ODDA..hABA.bDAC..........hACA......hADA...,1,-26,-48,22
WLgJGANRUbCIDcFSTBOPHVaXMdeQKZfEY,UFDHCFDGDGHF.FCHHBFBCHBCF....aCCAXAAD.eBFFhAAAZAFGEHCC.LABAhAAAJDABAHHA....NICF.hACAICGF.SFADOADGMECFhAHAdCAEfDDEhACA.WFFB.,1,-18,-39,21
NEOAaZDVRCgJfbMcLUIXBKSedFWYQGHTP,ZFFARBCFCFDG.JEAF..MFGDLDCF.UACBBAAE.eCFEFAHD.QDAChACAHGCC.TGAFhADANEED..AHABaAAFhADADAGC..fEEH.IEHFhAEAKHFA......hAFA...,1,-25,-35,10
UIDMHRdbWKfgVAYLOCePBEaQcSNFXZJTG,LEEGOEGH.CACGBDAHQEBA.SBDDFGDAJGAAGBCDhAAAIHDH.DDAFMAIHhABARBEGdAGHKHGA..gAAFhAAAAIEE.eCHFaAFC.cFDA.hADA......hAEA...,2,-38,-9,29
CGISMOKbHLPEDeRWcaNTfVXUJdAFgZYQB,FCFCZAADBFDGCHHG.GBFGMFFC.KFHBLDCD.DFEDeBHBRGAE.hAAAaDAE...fGADhAAAXABGJAEAAHEBQACEhAFA.IHFBSDAB.hAGA......hAHA...,2,-39,-30,9
LVTDGagceAFBHQUZJIPWdYMObCEXSRfNK,BHCHQDCBZEFH.JAHB..IBHHdBAAOACDEADD..RCBCKBFDhAAAVGBE..DGDAaHFA.hABA.eEAHAFADUEGE.hACA..PAEFWHFGMAEECFEB.SEHFhAIA....hBAA...,2,-31,-18,13
ceUSdLVfAMYKPDEWHGQIFXJZORNTgBbCa,MHFGKHBGDCBBHCCCGDDCFEFDZEBB..RAEG.TBGGBAAFCDHC..eAFChAAAUACESCBFhABALGACAFHHPACA.hAGAEDHFIHHE...JCFF...hBAA......hBBA...,1,-9,-32,23
LbTXfgdeZUVaPCDNHIFOKYWBSGEJRMcAQ,QDACLDACTFFB..gDDEZFACaDFC.CHHEDGCDIHAHhAAAOBHB.KBCDBBABhABASGDFGBEDEEBEhACAJAEH.MDIBAACGfGFG.dAAAeHFAhADA.....hAFA...,2,-28,-1,27
FeAODaUMXRLWfPTdZJSCgVHBIcQNGYEKb,aEGCMGECLDEC..fCFHdCBBSEBHCFBBHBDHBAEFhAAAIHEGQAGHhABANCAA.EDABFGADOFEFhACADEFCUBBEXGAC.......hAAA.WEFATGGA.hABA...,1,-7,-29,22
RMTSHNGXZgFBWaAPfUJKcCEVOdeQDLbIY,UCBCKDCDCGCF.OCFG..QBDDDAFELGBC..IACHhAAAMDIFHGFEGEEBhABAXACAFAHDBDHGAHDF.hAAAJFAHEEECVGDEdDAC........hAEA......hAFA...,1,-18,-28,10
PBcdMCJNfaFDGgTVAUOHYIWSRbEXKZQLe,OADGHAAD..IHACSGBCRDDFEGGFZAAF.LDFDBEHDMFCFhAAAJAHB...aACAFEGAhACADDGHGGCF.gDCChAHAAIHA........hBAA......hBCA...,1,-21,-32,11
CRJBWZaMDGQHATfcIFYePgVSXbELONdUK,TCBC..fFFBFGCD.eACDgEGGSHEAhAAAXAAFLAFEOAFBhADAdBGCCEABBEDGaFEHMABFhADADHEGQBGDAECGIHCEPADF.EGAChAGANEEFRADB.....hAHA...,2,-21,-4,17
gPDQULNJdWcIHVEZaCGYfBOReSXTAMbFK,MHFGFAFBKHACDGDGLEGD..dBHG.IECBVCAEZFEFCEEC.GECEhAAABCDG..eABChAAATBGEAAFF...PABEhABANEBE....cBDAaEAHOEHDhAEA......hAHA...,2,-45,-11,34
gbPBeEaNGRCDLUXVHcfZTOAYKMFIWJQdS,KGFHMHFGFAHH..JEEBQECB.dGECSAAC.hAAAPECHBGAGaBCERAGBLADBhAFAXGBD.HBEBhABAfGAE.OBBHAADD...hACA......hAEA.WDHDeDHF,2,-28,-20,8
EZQHWLUCgGVcBMTNXFObDdIePJSaYfARK,RFEEKEHBZAFAHDDGLAADUAEGGGDBBDGG.MAAC..XBBFhACAFGBBOBCBDIGGIEDHhADA..eAHFhAHAJHCE.SHGAaGABAEBAECHB.CEBG.....hBAA......hBBA...,2,-23,-17,6
TNCcSeaOJXgfEYQMZHDIWBdLARKGUVPbF,KBBDUCCF..VDEGFGECCGCG..eHCE.OCFAXCFA..hAAAEFBGMIDGDAAHBHABhABAAIHERACA..GDAETFGEhACA.NBEH.SAGA.....hADA.aDCFgEFGhABA..,2,-29,-27,2
gXTRUFKeOYJLZBWEDbNcMHCQPaAIfVSdG,VAADGACB...XFDAUEAGKCHFOCDBLFGBBHCDEHBEDAAFhABA....bEDHNCCEHBGFhACA.CHFAaGGAAADBfAFFhAAAdDAE.RCDE.FGAF.....hACA......hAEA...,2,-25,-10,15
KbgcUZdQVDFOPCBGSLeJEXHMfYNATaWRI,aGFCRAADKHGE......gEGEZCDCVFAE.DACGFFFB..CDBESGDBhAAAeAFE.hAAAEBGHMEEF.fACFhACAYBCEAFCFIBEFcDDHdFAA..hABAPDHFBCHA...hAFA...,2,-33,-24,9
ARSbaHELMKfPQYTcIFUZgVNGJODXWCeBd,RDAGSAFBHADCLHECKHBG..QBBGTCGHFABGUECHZGAE.hAAAVFGBJDDC..XEGAhAEACDHDeACGdEAE.aGDChAAAfAGB..YAHH.hAIAgDEB.hBAA...,2,-11,-5,6
UJMSGVOBaWTCNAgZEXDeKFRIPYQLdcfbH,ZDAGDDFFKCBFRGBE....IBBAQAFCLFFFdGEH..fCHEhAAAHBFEMFBGSFBBhABAGEGEBHAGhAAATABEAABGEADFeDDH.FHGE.....hADA......hAFA...,1,-15,-23,8
YFIMOZRXcfUQgSAKETVPbGCNDdaHeWLJB,EFAAVEFHGFDD.CBDH.dBGGHABDeADDJDDCBAAB.FCCHMCIDRFBG.hACA..XAFGhAAA.fHABhABA............hADA......hAEA...,1,-20,-48,28
NGBUOeCRfMHLgbXaJEZFPYSDAcWIKdQTV,..IFDGdFAATCBDGGEBUDED.OBAGRAACHGAA.LCFGhAAAXGBDEAFC.FEEAPBEChAAADFAAADCHKBDB..hABANAEHBDHA.fFFE.MFHFhABA.aHDA....hACA...,1,-8,-24,16
bAYcWdDNPOQeZLGUICRSMgJKFfTBXVaHE,......YFCAcGGD..DEGEOAFHeCEDLDBBhAAAUCCHCCHH.RGBCMDABKGGA.hAAAFFGBfHABhABABABCXBEBaEABEACDABIFWBCBNIEB..ZEFA..hADA......hAEA...,2,-24,-18,6
YTAOLRNdBSZXWPaCHEUfGDQVcMFbKJgeI,RFBGBFEDZAAB...XDGFaGGFHCCA.UAGBDCBFQCCDhAAA.MBFCbEEHJCHFIHHGhABAAHAG..OHAEhAAANADDdFCG.SEAC.CACA.EGFA..hACA......hAIA...,1,-11,-35,24
YERSGLgVfdAIOFHacQXeKCPNbDJTBUMWZ,FDCDHDAGQAFEXAFHeFFGKFGG.CHEG.....NEBGDEFABBADhAAAUGDEWEFE.EBDDSBCEhAAALFADfADBhABAAIHCaBBC.PHFA....hACA......hAFA...,2,-36,-15,21
gLNDfeTcBOQbdCMJRKaSYIAXPWGZEVHUF,XCBCGAFEEFBAUEGCLFEA.DBCGeGBEBAAFQAGEhAAAdCAGMIFE.KCEF.aACGICDAhACAAABFZFEF.FDHF.hAFA.fGAEOHBECAHCSFAFhADA......hAEA...,1,-16,-19,3
MbJgSKOCaUYVATfQFdBIRDLXZHEeGcNPW,TCGCFGFCdCGCBAHA..RFCDDFGHZEBAHBBGEHGCGAEH..NAAC.hABAMCCB..JGAAKDAFhAAA.CHABaBDC.VDDEhABAAEIH.....fABFIAFFeFFEhACA.WHAG..hADA...,1,-7,-40,33
gHXNePQCRcWBUdAZGIOaJbLMTVFDKfEYS,ZEBHOFEFJBBG.LCHD.MBEDFEDCKHEAEDCH...SFADhAAAXGGA..PCAGhAAAQDGGRGBA.BBFChABAAHAHaABG..bCACDAEA.YDFHNGEF.hACACAGA......hADA...,2,-38,-6,32
ZKeCfQXLUMNVcdbOgTAaEIYPHJWSRBFGD,aAFBEHBG....IAFEHCAEJHEG.SFFGFFCGDFIFZFEGKHAECDCC.hAAA..QDGGhAAALBEAMCBBNEDE.dACAhABAgEAAAIEE.PBBG.BEEFhABA......hACA...,1,-20,-29,9
AdabeOJTPFIHCfYQEXgGNSRLZcKBVDMWU,dAFBeCCHJCEAFBFH.HBAH..CBHH.QAGEEDCE.XEFChAAAGGEHSABDhAAARFAHLHDEKABCBGBBDEGCMFEEhACAAAEDaGGFODHF.IEBH.fADAhADA.NIAF.hAIA...,2,-37,2,39
FEHOZPcRUbfaAYKTJMVNLISBDdCgQXWGe,TGBCMHACLFFD.BACGdCECCHHEQDCBXGFFeDAHhAAA.FGEHEBFD.HDAFhAAA.OEHFcBBHbAGBhABAaAHBAGHHKCCCJACANBGEDEFG.......hABA......hAFA...,2,-22,-6,16
AOFXMaPGQedUTIREBNLKWJfbHCYZVDcgS,FAADMBDHGDBCdCHGUFDHRBECBGGD..LCABKDGH..JEDCfFBChAAA.CAGBZAEFhABADCIHSBDFhAAA.AAHCOFHF.aGAFQGGAhACA..IDAEhACA..,1,-31,-33,2
GZQcLWbRYeXPUgNKDBaTMOCJEfAHdISFV,HDAGdAFBSFHFFGAAGGEBZEDBLABC.RAFCeDDEPDCBUDGEhAAAKDGEDAABBBCFaFFDMICGhAFA..CBCEEBEDAEEB.hAGA....IDAF....hABA......hACA...,1,-3,-37,34
SfAdXMYKCJWBZNHcELaDOTQGReUPIFgbV,XAEDMHFGKEGG...JEAFZABF.HFBBLFDEDAAFOFEBQAAChACAGAEAeHFAIAGFhADAgCCB.hAEASDAEdEBBCDGCNAIA.aHCE.TCGC.hBBA......hBDA...,1,-6,-15,9
eOFUJZcfRgNaHXPSWGIQYDBMECdKVTAbL,LEEGFAABUCDFZFFERADA..aAHHHGBE..XDABSCBDhACAGCEFQAGDhADADAACEGGGKBBAAIDAeFBE..hAEAcGAG.NIEB.WEEA.BFAD.CAEA.hAGA......hAIA...,1,-14,-17,3
YKTCcFeNDPdHLbVBAJXZMgIGRaWQSEOfU,XAEGZFACMBBEGCEDREDC..aAADQDCDOCBC.UFGDhAAATGAFCAHD...FHFChAAADCADdDGDLHEAhABABHHBAFCDgAGBSBDA......hACA......hADA.fFGF.,1,-11,-16,5
DOVdBENHMTJXLfUWeabAZYCIcFQKRgPSG,CFDDFHBGRABF...SDGDDFFD.dDDCEFAGHAAC.MAECJDECLBAFhAAAUBFFeEHHABHEZGAAhABAIEBE.KFEA.hADA.gGGDOHEC.BBDANDAE...hAAA......hABA...,2,-35,-13,22
ACFdUfOQMXPNcYBTeGHLWEagJDZRKSbVI,CEFAdFAAUDBBQCBA.MFHDXBAE..PDFE.hAAA.NIDDBAGGGEDGHADFhABA.LCHBhACAWAEFaCAB...........hADA.DGDAKAGC.SABGhAAA,2,-42,-17,25
AZaYGJCfPcHDESIOWLBFeUbQKMdTRNXgV,ZDAGGEAHJEEE.CBHD......PAACDIGEEHAAODECBGACFABDhAAAeHAA.UGGHKGDA.MCDEhAAAdADF...NADF.XCDFhABAAIEE..fEHASGGA.hAIA....ICGAhAGA.,2,-49,-15,34
PNdYZJFAUDSaXeTbRQcEBIHGKOWMLfVgC,SDABaGDD..XDGBeDGDTABERDDEEDBA.BAEB.GGADhAAAKGFBMAEALFEBhABAfBDBCGGGdBGBYDCChADAFFBEDAAG..cAGD....hADA.IBBF.hAGA...,1,-16,-20,4
WMcGIBPEaUeKYJRbZHQCFOfVDdXLNTASg,SHBGMCCAGEEHBEFDEGHD.UBFG.KGEGJFDF.ZCDGHBCBCEBHFBAGhAAAOGAA.DIEAdADFhABALAAFAIBA.gGGBhACAcBGAaGACeEBG.....hACA......hAGA...,1,-15,-20,5
ObdXNaCfgKMBSDWPGVQLUARIeFZTYEcJH,RFDFFDCDZEAAEEEAHCCA.dHGBaBFE..CGBDKCGAMGDE.BAFADAAC.GAAChAAALADAAAIF..TFAGhACAJFFA...OCHDhADANEEF...SHDA.PADDhAFA....hAHA...,2,-29,-24,5
FLRCXBGIfQTgOeEYdKHSJbMPVZNaWcUAD,LEACCADCBEEDGAGEQCFA.OFEEeGBGEFCEKBBCJADAMCADhAAA.ZBCC...aHGGhABAWHFCABFC...DIGChAAA.FGAAIFGF..fBAEhABA.....hACA...,1,-27,-32,5
LPUIYFgTOXWEAbDMKZQVScRCGNJeHfdBa,MCHFQCCB.SHGACGAGJDCF.HAGFBHHGaFCALAEAhAAAIGBF..FEEAOACChAAAXBACAGDDbEEHDIBGhABAKCADZGCA..........hACA......hADA...,2,-40,-9,31
gYKMfIPGSNQTAcBdFRUOEDXaCeWJZLbVH,dEGDUCCBEBBCDBAD..aDEHeFBG.ZFGBVFBCHAED..KBEEMHAChAAA..IDCHhAAA.SHGGhABATGEEAEAFBDFHOBHBCBBC.WFAD.....hABA......hACA...,1,-25,-31,6
LMdIeCcaQWYbEFBPfNRDJUgVXTKAZOHGS,ZDBGOEGHGBBDLCCCdFEHCAGG.QEDF..bGDCBCAEhAAA.PAGDfFBHhAAADFIFUGAD...hABA............hACA......hADA...,2,-37,-30,7
EWGOdFTVbKaUHNYZDgLCRAISePcQXJfMB,eCCHQCBC.JFACMIBA.BCAGEFFAGAEGFGEE.TAGDhAAAKAGFHEAB.YFDEhAAADDIHCEDHAHIH..SHEAhABA.PABCfABB.dDHAhADA.aAHF.NAEA.gGAGhAEA,2,-34,-13,21
HJSLRFGCVYTZXbcBMQPdEgIWKDUAONfae,OGEAaHBGHCCCLCBCRGFGGEBBCAHD...TAGEXEBD.BAAFhACAPCGBdEFBIEAFhADAKADADEIFACCA..NAAE.eHCAhAEA.SADA.....hABA......hACA...,2,-24,-13,11
FagdHeLXWCZJPbMBQSEVGNKUDAYcRTOIf,RAADTDACOAEG..FGCDdBEHHBBELEDGCDDA.ZGDAJEGD.MADChAAA.BCGBSBHFhAAAEGEB.NDCGDDDGABACIDFDhABAaGGA..eDADWFCC.....hACA......hADA...,1,-22,-23,1
bFAQSWGOEgYfKJMVaeIcHURNZCTLXdDPB,SGFCOFEF.EHFA..fAFEKBFGMAAB.aAAH.eADDhABAHFBAUGGEZCDCLHBAhABADDGBBHAAFEBDABEH.QDDBhACAWCAH.gAGBYEEAIAHFhACA...hAEA...,1,-12,-22,10
HeJNYTLRKbUCAadPGWFEIBcOMZDfSVXgQ,aAFBGEAH.FCHBEFFBBCCD..MEHBZGFGSDGDXECDQAAFhABAHADFeBADNDDBLHCAhADARGAEKAGA.CDBEdEAAhAEAWAAEIHAH.DEEC....hAHA......hAIA...,1,-11,-13,2
LAFDURSgHWYIafCVZbPQXNMGcBOKeTJEd,UCBFRDAGHADC...IHBCCHAAZFFFQFBAMEIF.BAACKDGHeDDHhAAAEDGA.dBAFAFAFFCEBhACASGDA.gAGBhABAaEHD.fFFBPADEXGDFhADANIDF....hAGA...,2,-33,-3,30
eFJGfBNRILSDcAQbOdTEaXUVPCWgZMYKH,QDACdDCDaEFG.UEGCCBHBZFADKGFD.FCFCGBDF.BHHEIHBDhAAADAAH..AFGHOAFGhABAXBCB..VGDEhACAgECA.MAEAeDAF...hABA.fBBEhACA...,2,-37,-22,15
fBCLPEGeDRgVFXaUOMHIWbTScQJdANYZK,ZAADBFEDCAEALCFAGAABDFFC.RBFD.FHGAUGGEHDAG...IGCDhAAATDAA..SEDFhAAAJEDGdAGF.AHAEKDHHhABAEFGE...eHCEXACHMIAA..cCDAhADA.....hAEA...,2,-25,-16,9
cVQKdMDYFASGOaHIBbUTNZPWgEJRXCLef,SHAEOCDGHGFEBHFDUGBAZAAE....gCAHhAAAEEADJDCCCGCE.eADC.fDEChABA.cEGAhACAKHGCdEGE.DDFA.ABED.IBHETAGC..hADA......hAHA...,2,-38,-19,19
YXfBbZIeFRSCMgKUOVGALQNETDdHPaWcJ,LDACEGFCdBEDHDEEaHGA...JEAE..fGAGBHDEZFBEeBAGhAAAFEEDCBEF.MFIDKAAFOHCGhABAABIH..NADDDCAFhABAcDGE...XBGF.ICFDhACA.REAE...hADA...,2,-27,-18,9
WXfLNSTDeYBAPMCOFgaKERUQHdbIVGJcZ,MBFHFDABKCFHREFE.HFBDdEDG.....bFFDVCAB.GAGCZEDHXCCGhAAALAAASACAhABADIDABGABAIBCOAHDhACAaGGC.EGAB.........hABA......hACA...,2,-25,-10,15
LWcRJUbVgMaePdTKDNAFCSGXQBYEIHZOf,FEHBCFFCGADABAGB..EEFHZFBC.OAAFLECFRAGF..UDAFVADDhAAA..MEIDeGDG.hAAAdBABDGHFAIDG.SGAGhACAXBFD..YDADfDFB..hADAcGGE...hAFA...,1,-20,-25,5
dReUgSFDaVfZJYEBHCTKXLcWAIQOPbMGN,QDACOGEA.MBIHdABBUEAE.FDDCVBCGZCFA.EGFCBBHChAAAHEEAKAFELACEhAAA.AIFEIGCChABA.PAGB.NIAF.......hAHA......hAIA...,1,-4,-53,49
EUWcgfCdTRZaMQVSXAJLePKFYBGbNOHDI,eAABKAFBBEHAGDFC.ODDDDGGGUBAG....gGCBhABAdEDDZFAHQACChAAASEAGAGFB.JACCFHCANCIAIDCFhAFA.cGAACDGB....hAGA......hAHA.aBEEMAIF,1,-15,-41,26
VcDTQRCSOJHgLZYEefPGKNBMUaFAXWIbd,XCBC..WFCAdGDCDACA.QAEECBGDOAABHDCEhABALDECEFHF.eHFAGDAEhACABFGGMBIDFBGAAFHCIAEFhADAbECA.cGEDSHAA.gAAEhAHAfCDB.hAIAKHBA..,2,-19,-13,6
NFfUPDVXAGTIJgCWOaMSeRBYQKZdEHLcb,TAGHJGEA..CBAB.OBBB..aFBDSDEABFAB.QFBEhAAAZDEEEEHHHACChAAAcADEFDCF...PFHDhABADAIFAHAF.IFFF.MCAB.YHDGhACAKAGF...hABA...,1,-8,-40,32
YPCbIAGULKBEMWgSFDROHaZecNdTfXQVJ,GDDCUGGDLBADKABDBCGDMEFC..SGFGFFBADCBERAFF.aAHDhAAAZBDB..eEABdHAD.hAAAXGBH.JADAhACACFHCAIDGECCH..........hAGA......hAHA...,1,-27,-32,5
CdHPBENDZXfYTQaOJgSeAcWRUbLMKFVGI,RAADUDACLEDHKFFCGDCBCAEB..HBFEBBADDCADZBGH..fGHGhAAAQGAHOECBhACAJGCC...SHFGhADAAIHA.WFFCMCCG.IAEGhAAAEAGG......hABA...,1,-17,-36,19
XQCNeGAWKTRBEPFMOYbcIgfLJUaHdDZSV,TGBCEBBDFGCA...ODEA..bEAFIBDELBDDJDAGUFFHhAAAHEGDZDFA.SAGBhABAQFEGeAFDhACAAACBRAFEMIEG.........hADA......hAEA...,1,-13,-19,6
SKBYdDXWUREeMTVaQCObHJLIAfcGgNPZF,GAFE..gFFGNDFE.FFCFKBCEdAGCDAABUACBEECCeHBAhABAMIDA...VEGHhACACDCEOEHFHEABLAHBhADAIAAF.AIHEcBBCSDAF.BHBEhADA.XBED.hAEAWEED.,1,2,-40,42
KCNTRbJdgWBPVEDHAZFQYOMSGeLacUXIf,QCCBMDEBGBEDaCHBUFBA..IAHHCHHGRFFH..JACGdGFChAAABHEDVDAF.DGEDAAHGFBBHhAAA....YABEhAFA.........hABA......hACA.SGAFcGBE,1,-25,-31,6
XQTaNebEAMRJLBFdYfcVgGCZWOSIKPUDH,JAABFDABdHAD......fGBFgCFBCEGAZFEFOFAChAAAKCDF.UDDCDAEBQBGChAAATGFG.aDBHNBAH.hABA..EGHFAECDMACEBDFD...cFGAhAGA......hAHA...,2,-32,-26,6
ARFYVXfZBgcHeQWOSGDEJKTbCUNPaLMdI,RDAGFCFC..XBAEZECDBACGHDFGQFEESGFEDIACKAEGCAFDUFDGhAAA...aHBCdEAGhAAAACGD...fBBGhABAeADFOGAAEAHFJEHF......hADA......hAEA...,1,-11,-31,20
ZeOMDKGQcfRHEBgFIAUXYCSbLNaVWPdJT,UCGCCHHGLAHB..aGFC..VAABdCEEZFBEeFCEDDACGAFChAAAQABERDAABADA..hACA.FHBEIAFGhAAAAGIH.SEBAWFFB......hABA......hAEA...,2,-41,-16,25
AJXOZVdNUBaYRGQFLHTcDegfPSWCEMKIb,JFCAOADGZDEC.dDBDBHCDRBCG..FGBBHADC.DIGAeFFG...hAAA.fCBAhABASGCHCGAD.ECFAKFHBIGEEhAAAABBG..XCGENAIEaABB....hACA......hADA...,2,-41,-23,18
cZFBVbXKQSaJRCWMHOfLDgEPTNdYeAGIU,UAGHZDAGBBBH..VBAEKGAAQFEE..JECCCCFCMEHHhAAAOAEH.DFGGEADA.hAAA.TGGE.dFBChABAAIHAIHDDFGDH.SDGEaHAC.hACAWCDH....hABA...,1,-27,-48,21
UPfMbSVJRIAGNHdCeTXLYZaFgDQOcBWEK,GEDHHDAGdHGDeGBCXFDBZBDCFCCH.DAACQGAFBEHE.EBDChAAAKGGDUAFEMBFGSABEhAEA.JDGFAAEGCHDEhADA............hAGA......hAHA...,2,-36,-10,26
TVGbLReDYMdJNFPUEHcZQWXaBAfKSgIOC,KAFBSHBGOCDF.CEFD..GBEDRAABDFHF.MGEAdEAH..FDFCUEBDhAAAHFCDZACE..XACBhAAAAEHBIHHE..hABA............hACA......hADA...,2,-37,-33,4
gbGKWLEIRMAaFcYDJTOPCfQZSBedXNUVH,aAFBFHBGDCCA..TABFCGFE..ZACAeFHFdEEH.UDFG.VEBDhAAA..gDABhAAAKHEGEAHD.MAIDAEHA.JAGFhABAOBAH.fCDABHECNEAA...hADA......hAEA...,1,-15,-40,25
ZRFPQfVTAMGbYecgODLUHENBCaKJIWSXd,GBGAeGEAODEHUAAGEFCGBGAG..KEEBJCCF..SGGChADAdCHEFCAH.QGBHhAEA.fDBFhAFATFBAAABAbBFFgBDBHABGCHHB.IHHEhAGA..WHDG..hAAA...,1,-4,-27,23
YXgNKREUTFZcMOQbJaAIGCfDeSLdBWVHP,GGDHCAEDDDDH.SCBABFDAHCFB..PDGB..XGGHhAAAgAFEKABFUFAEhACAZEBE.MEIH.QAGAhADAJAAGICEGfHDBLAHB.hAFA.WCCC...hAAA...,1,-20,-25,5
TaVXEZOJWGUCKFSeINAQbLPBcgfdMDYRH,QDACLGEABBHC..fGDCDFCERDECHADDVBGHECCDOHAGhAAAJECBUBCH.CFEBKFHHhAAAFDABSFGChABA..IGAEAGBG.bAEB...cGEDhABAMICE....hACA...,2,-20,-18,2
UWCVBXgERaYLMFNHIdGDcOJKbSZefQTAP,UCBCVDBH.BHGE..XAACEEEE.RGDCLAEGFADGHFBHdHDHhAAADIBA.OBHHKCCCZDGHeAFHhABA..fEEAhABAAAIBCGEC.aGAB.MIFENCAE.....hACA......hAHA...,2,-24,-11,13
caJYQCKMHSFRLIeEAdfUBNbZWDOXPgVTG,UGBCBFDGZAFADDDD.OBBG..XFGH..PDDAhAAATABCaHEE..JAEGCFGEKGAGhABASHDELCAFhACAeBFAAECA.dEADfGEHNEEB.gCGBhADA...hAAA...,2,-36,-25,11
GKBIMfPdLgSQUWaEZFCbRXceYDOJATVHN,VABHHEBHGBAB.BFHBMFGHdAGELGACSGFGUDDEaFAHhAAAFAFERDDA.eFHD.DBADhAAAAGDEKBEC..fEAFhABA.........hABA......hACA...,2,-25,-25,0
AGOIVbedXRBCWTcHfZDFLYMENUQKaSPJg,OFEFVAAD.dCGCBAGB..CBDC...TADCHFAEDHGELEFEhAAAMAFAECAFQFDHhACAaABF.SFAHhADA.JDCGAHDGIDDFXGBHcGFDhAFA.FCFA....hAIA...,2,-37,-15,22
EYOXAQeGbCdUIMRFDWcLNSgfHJPaKZBTV,QDACGECFdFHAMBCCDIGELGEE.SCDDfCGAhAAAHBGBaGAEKCCAZABABGBEhAAATDAAEAEE.XFCBhACAAIEECAFB..........hADA......hAGA...,1,-15,-25,10
YSXRUOEDfAgbLBIPFHKCJZNdMcaeWVTQG,LGEABFDGFCABKEFACBDEZDEF..dHADMABG..aCBDeBBD.TFAAhAAAQGGC.hAFASAFGXAFEUDGGhAGADDIDAAGC.bFCBIHEA....hAAA.HABCNIEF.WCFChABA...,1,-3,-44,41
gIYRZTfQNLeOAJWHSKGcFPDaCVMBbXEUd,JFBBHDAGGADAFGAADFDD..CFHD.BBFD.EEFDdDAD...IHDBhAAAZBAETGEC..hAAAfDFELAHBAFAChABASABCKEGCaHGEMDDEXAFF..hAIA.YFFF.hACA...,2,-33,-19,14
ISJBYdHRfaeOAVLPFZGCUNTEXbQgWMKcD,VFDFFDCDCHFD...UBFGEAFC...QACGMAEB.KFAGIACFhAAABHGHHBAB.aCHDhAAAADGHLDHD.hABAGFCBNAEFXFFBWBADSHBChABAdCEC.fBBEhAFA...,1,-6,-42,36
FUDLACTQXGaefMRZVESKPbcBIHNOYgWdJ,QABHGCEBeAAFMAIBRFEAZCAD..EGBHKDDD....cBEDhAAAIHCHHEAAOGAGhAAAgEEFdAECFGHDLHDEhABAAIFACEHA.aAEB.fDGBSAHFhACABGGB.WDAEDDCF.hADA...,1,5,-13,18
VfSOgAMCFRYWbBHdIDaGUEKLQPeNJXcTZ,FAGERAAD....bDEBdHGB.aHDAUGEFKBAALAEF..eDCBhAAAJEEG.TAGDZFBB.hAAAfFBGSDAHhABAgACGCDCEBFGADEIBEDHF.....hACA......hADA...,2,-32,-15,17
aIKYTZXRLHEJNgMeVUADSQBbOdWGFPcfC,QCBFBAFBdHDBFCED....fEFACFGHKEBF.TFBChAAARACCHAGBEAGB.JBEDMDAChAAAUGGE.DBIH.OHDGhABA.WCADcEFBIHAA...hABA......hACA...,1,-4,-44,40
EUGRZWBKYDPNdJOIcXLAFTHabVSgfeCQM,HBCFaCFC.SFAEeFFECDCE.MCECGFADZFGDBBBFDABDdADFJAEA.hAAAOHDGXGGGADABFDFGhAAA......hABA............hACA......hADA...,1,-25,-37,12
DfMAVFJYUgOBKSRaQZEGNbCdWPecHLTXI,VDEDJCCH..UAECBBDE.RFAH.ZEFGGAGG..CADDdGGEeHFELHCGhAAAXCBBDGBGMCABhAAA.AAGH.FBADOEDHhABAKAGG.aEHD.........hABA......hACA...,1,-10,-43,33
IBPEaUcVQSKLFAfZYbTODdRCWHGgNJMXe,ZAADTCBCdEFECGHD..HGDEGFABJEADMIFE..IEAChAAABDEGEACAUCCC..VCFChAAAKHDCAAID..bFBDDBHDhADARFFE...NCIE.........hAEA......hAFA...,2,-33,-7,26
dHgFNBORJVaKLIDWZXMPcUeECQGTfYbAS,SEHBdCFCFDBHBHEDRECG....aGFGKGGBDACHZECB..MABDUACBhAAACHBCGBEF..hAAAfFFHAHHD.hADAHAGDgEADOFAH......hAEA.LDCCIBAHhABA...,1,-16,-40,24
CDTRFKMYQAJgeVLHbfUOIWGcBPEdSNXaZ,JEEGeFBBHDBEUCDC...OGEGIAHEGAACBHFDdHEHXBFGhAAAaAEC..CHAADAFEhAAAFABFKGBF.QGGAhADAAHHEVCFE.fADF.cGDGhAGA......hBAA...,2,-24,-20,4
XAfSNaMPgWFLREcbBJGUIdVCKHZDYOTQe,SHBGaGFH.MFEBPABE.FEGEREBHEDCGBGGEGAFG.hAAAUFFAIHDHCEABKACBDIGGhAAAOFAE.QCEDhABAACABfAHEWAHB.LEAC.hABA......hACA...,1,-21,-24,3
fPZFeYLNTQJbIBVaWADUcESCXGKgOdHRM,DAFBEGFC.CBDA.KCEB.dDCEMBHDZFBA...FFEBLHAE.QAABhABAJBBFBEAE.aEFEAAACUGBEhACA....hADA.SGGH...XDEAhAEAgAFB...hAGA...,2,-52,-31,21
LWHeUNKfDFYZGXcTIRCPEaQMBJdOVSgAb,LGEAHFDFeAECUDGHKDGFDACGFHACZAABGBBF...XBGBhAAAIDEBCHFA..aEDBBBEHhAAAOFFESDAAhADAAIHG..NBAA.fGCE.TBGAhAEA.....hABA...,2,-31,-16,15
KcdfBEHVSgXCDTJZMbGRFLQONYeUWAaPI,aHBGKHBGdECABEDCHAEF..SBEAXCAFDFEAZCAFGCGChAAALHFAOFFBeABCAHADIABAhADAEAGC..CHDEJBHBhAAAbFAC.FGGG..NAEB....WCDGfCDEhABA...hBAA...,2,-24,-5,19
ZEVCJMTHQDbeAKRXBWSLdcUfFGNPIOgaY,XCCBSEGDdGAHUFDAGEDH..IBDEaBFAZCAFCHHEJBGFHGDAhAAA..DAIDAABABDGGhADALFBH.fABFhAAANAIC.OBAHECEA.MEIH.bCCEhABA.KGAD....hAEA...,1,-8,-27,19
DGHYVFEgQfTWSBdMNOePAURLZICcXJKba,RADGLFBBCGCD.JAGDaDFEHEDH..FHGAQBAD.TDGFhAAABAHGdBBA.NCIG.hAAAOAEBAFFE.IHGEhABAXEDDDFAD........hACA......hADA...,2,-50,-23,27
OYCZDfEQcLgTaNGMBRUSHebdXFKVPWAIJ,JEEGOAFBZCCD.DBBH..EGDCQDEB.LCCHaFBCMIAChAAABHBGUGGGSCHFhAAAHAFFdCAE.FHGEKABCWGCChABAAIEGCAHA...........hAEA......hAFA...,1,-23,-31,8
bNAQeVKIWBgfZJCaROHGFUPLXMTSYEcDd,eADGVDAG.KBDDBBABZFDD...CHED.aBHBHFFCGCBGFAHB.LFADhAAAMDFA.SDGAhABA.EHGGDEEGdFGFAAAEQADHhACA.IGAFfCAAhACA......hAFA...,1,-12,-34,22
ZYSNKdfeDaFcGTHbVMCBPXUWORJIEQgLA,ZDAGSHBGKDFEdGHC.DEGGFFCDGCDD.HAACMBBECCHB.BFFEUGGEhAAA.RFBE.EBFGLAEEhABAAIAC...NDAAaFFGhADAbCDB............hAIA......hBFA...,2,-46,-7,39
NHXdCYTKGIgfLOReAVaWPbUEFSBQMJZDc,VDAGaHBG......PEAEEBBCBEEAJGEA.ZADH.DFGFHAAChAAAdAGECGBDTAEF.KAHHhABA.GCGEfDHEhAAA...........hADA.RCDEAFFGbFGD.UGDFhABA...,2,-32,-8,24
IRbONCfFGXcMTPVWJUegLSaHZQKADEYBd,DGHHBFEDRCEC.ODHB..CGBCGEBFMCBG..TBFAVCAAUEGDhAAAeABALAFChAAA.SEBAhABAaHCEQACAAHBFEEEG.IAGCNCAAfGHA.hABAcGED...hACA...,2,-31,-11,20
bBNLORJYMSfEDAdQcVXTFPgWZCHIUKGea,QGBCXFDHFABD....gBBDCDBCUGFEGEBAeCFDBEHGhAAAOBFD.RADF.MEEBhABAEAHB.dADC.VAFGhACA.TGGFWFAF........hAFA......hAIA...,1,-13,-22,9
FWLUPINdJHEeQCKSgcXTfaBYGRbZVAMDO,DGCGFDCDLAHBUBDH....IBBCdEHAHFDC.eBAGCGGBKDAEhAAASDAH.hABAgGBDTEEFaGAChACAGAEGRBGF.........hADA......hAEA...,2,-44,-12,32
SEcdTONGJDeaUHFCLfRKWVAQgIbPZBYMX,QCBC..gGDCIHEAZCFGBAACMAECSEBDhACAdFCFOFFFNAGEGBDEhADAeAACaFBHFHAAfCBFhAEA.KGGHABDE.......hAAA......hAIA...,2,-23,-23,0
YNPJAbMGadDcTXSKUZgeIFQEBRVOCfWLH,GBGADGGD..TGDHKCEBUEEHZBGF.eDAGQBBDRBAG.CDADLFCEhAAAHGBE..hABANAABABIFaCECdGAC..cGAHhACASFHH.IAFBBBFD..hAHA......hAIA...,1,-18,-22,4
IHSAMfFOcUVDdJGYRWBLCNEKZPegXbTQa,MHFGOCCHUDACdFBD.GAEBRAFHLHDA..EDFEKAAFeFEG.hABAXCCBQEGHhACAaDHDHFCBfEEEhADAcAAEDHAC...WAEDBHAACGED..NAIE..hAAA......hABA...,1,-10,-16,6
fMZSbRIadLVUNQJcGAegTKBFDOWEYPCXH,eDACKGFCDDHFEHGA..CFDB.HEDBZCCA.SCFG.RAAEIHAHhAAAaAECLBAF.UAGEhAAAJFAEAACE.BHFFFFAC.hABAWCHH..XGDGfAFEMFID.hAEA......hAGA...,1,-18,-37,19
YEbadSLIGMAHZNJcOCPWeUXQTgBFVRfDK,HGFGZFDFJBAAOBHF.CHED.eDAGUDCCQGABBBAE.RAEG.DDHBhAAAKFHDEDAF..dFFESCEBhABAGCDBMCIBhAAAAGBC..PACA.XGAC..hAGA......hAHA...,2,-28,-17,11
RODAHLCcXKISdWaQgPBEUJfTFVMYZbNGe,HFEELAFBCECDKBGCSHCE.aDDDPBAA.BHHEEGGHJEADhAAAFCDH...MACFhABAZBEF..NIAF..eEADhAAADBIFAEGG.XBDG.WFFE...hABA......hACA...,2,-32,-26,6
RXBPLDZFadMWUfYbOcKAVJNgHEGeISTQC,VFDFJGEAHCAF.GAAFSHAC.QAECXCFABFAGhAAALCAFDDCAZFCHFDEAMAAEhAGA.UBBE.hABAfHGBOEFCKAHBAIFE......hADA.EHAEeFFE.TBGChAHA.,2,-14,-14,0
ObNHGDCQgRYUBLeIfSTEPXaMcAVZWdFJK,VGFGZDAGFADB.KGGAOABC..HEEHCAGC.RBFDUAAFBDFFLBFAhAAA.eEDGSFAAhABAEEAC.PHAChAFAMIAAADCG...WFAA.dDHE...hAGA......hAHA.NIEBDFDF.,2,-22,-20,2
QCVfRSXeAGMIFdLTYUJKOEgZDbaPBWcHN,MEAEFAFBdHFDLCFAUEGG.OEGBZEAB.DIAE..aCACBCCFHBCHhAAACHEARGBE..SHAAhABAAAFCGACF..IAAChACAJFDHEEEE..........hADA......hAHA.bDDD.,2,-30,-22,8
WPJgQMCDNSeUAYIETVZFOdcGaRKfBLHbX,EHBGVABHZDCH..FHFCOHFAGFBB.KCFALAHB.bAEBXDAChAAA.JEDAgEFBhAAA.CDABDBGHhABANCIGSHAA.AEHDIAHEhABATABCaHECfGGBhADA.BGAD.,1,-12,-17,5
QHRIKEgOfWbPLGYcJDVNUZCXaeSFdBATM,MGECHABHKAHF.OHEA..fAFB.PBBAhAAALFCCGCEDcCEChAAADIGCNDAGCEAAXEGHhABAeFCHSHECBHDDAHIHTGAEIEEFEAEAWFBFhABA......hACA...,2,-25,-13,12
QRTIJUeWKfVSYLZBAgNFHcCGODdbXEaMP,FHBGCFDDDHGAdHEB...EABDaFBH..MECGQGEERCGB..IFCChAAAeACBKCEHSAFFhACAZAFAACCHHCGFOADFhADAXDAG.JAAFfAGF.LFFAhBAA...hABA...,1,-17,-26,9
MTXLUSgCHNGYJQbARBIeFDKWVcfaEdOPZ,BFDDFDCDKCGC..VCCC..aEABdFGHZGDAMDAHLEFG.UACBhAAA..SBHHhAAACHHB.NHEDJHBAAEGCeFBDhABADBAE....fBFG..hABA......hACA...,2,-44,-37,7
DOKIeXPLQVUEWCHAJZYMaTRbFSNdBcfgG,JFBBZFACMABH.RDBC.SDDHBHEG.....fAHAhAAAGADB.OFGBhABAIDFCeCAEXFFChAAAPDABLBDE.QDGEhACAECHBCHHGACDC.aFDEFHAE...hADA...,1,-23,-24,1
QeATWRYGSCXJdObZKBEUgNVcMFILHDPfa,REFHSGAHCDHG.dFDEOAACZAACBBFCECAH....UCDCNEIC.hABAMFAHFCGELAEFhACA.DFHDPEBHhAAAaDAAAAHE.TGCF..WFEH....hADA......hAGA...,2,-33,-32,1
cGdQeZSETJNfCRMOBPLbgKDVAaYWIUXFH,aHBG..IFDGUAACFGEAGDAF.QGFFSFDCJACEhAAACEBE.RAFBBBAFLAEHhADAKFFCAIACXBGD.hABA.dBHAEEHFNEIEMHAG.PCCADIGAWBDFhAGA......hAHA...,2,-36,-4,32
aEWZHVDCGgUXJSdRbTNPQeOKBMAYcLfIF,LGEAFHBGEDAE.ZBAEHBFADABCGBECUDDC..SFGDhAAAdFGFREBD.TACDPBHBOFHFhABAMIEE.AGAEfDGFhACAIGAC..WAFECAFC.....hAEA......hAHA...,1,-17,-18,1
OCBcgNUHZJePARTQEKSfWXGYDFIbdVLMa,TDCBEFHBKECA...SGCD..fBFHXBGADAFDhAAAIDGCdCAALFGFhABAOFBHBAAE.hACAgCACNEFEZADF.PFFFADGH.RACC..hAGA......hAHA...,1,-20,-27,7
OBJNaLeXPDARSKGcgUYQHVEfbdFWZMICT,RFEEGACBUBDHHEACEGABdEEFFBGBZAAF..CAAF..BDABJFFH..LDAAhACAeEFG.DFCBKHAA.hADA...cGDHhAFA.QBGEfBBE.....hAGA......hAHA...,2,-36,-15,21
XKbDPZfCWeEdMFOSNLBYQTUaAJVcHGgIR,JFBBVGFGGADG..RAABKFABDGIBZAAE..CEFC.eHDEdGCCMADAhAAAOFEC..LEDBhACAQAGAUBEC.AECB.hAHAHDFG..........hAAA......hABA...,1,-25,-29,4
TUOdgMZKSYNVFCIfWXGRAcLbEPBaQJDeH,LGEAEHBGBHFD.JACEHABA.OBFDMCACKFCB..SFFAhAAAVEEE.CCDCIFAChABAXBEDGAGEhAAAAHDCPAHBDIBG..TEDE.dDAF...hABA......hACA...,2,-30,-13,17
CQGSZbIAPeOLVJFWHNEgcRfKXMBTdYUaD,eEEGVFBG.FAAFHACG.EBAGRGEAKECH.BDAAdEFGaEHB..CDCFGADDhACASDAA.IHHGhAAAAIGGOBHFWAHFhABA..NIAF...cGACfCGEXDDBhACAMHAE....hADA...,2,-34,-3,31
FbESeUBLOGNZfaQKWAXMTPcJIYdDCgRVH,MGECTCBC..JBADdEDD.CGEG.RGAAHCCF.EHFEUADH.BFGFhAAALAGDGEAANAFA.aAHFhABAKEAAAIFA.....hACAXABBIHHH.DGDDFEHFSCFAhAEA.....hAAA...,1,-20,-23,3
gRXFfdCUNeYEScaMPbTZWQLGVAKBODIHJ,OCAFHFDGJAACRFBG.FBFAdAEG..UADEeDFB.ECCF..aEHDMFIHhAAA..TDFEQABFhACALHAGAHHDKAHFDGAEhAGAIHEDXDDBCEDASGAG.hAHA......hAIA...,1,-10,-24,14
GCfeUFPJcKgaNXHVOQZMdSWIBLbAERYTD,ECFCTFDHDHEC..GEDHCGGH..UAEAFGAG.JDCEKCDC..aACCHAADhAAA.OADGMAHHdDAGhAAASGGHBCCFLHFAhABAACIBfCCEcGBFNEIE.....hACA......hAHA...,1,-23,-24,1
VSIMUKXOLYGZNDBCbdTHQEafAFecgRPJW,eCCHRAAD..JBEFSGAAUGEH.OEGDLDAGZADCBEEBhAAACACE.dBABHFBHEHDGACIFFBFAhAAA....PCADhABAIHAEKAGC.XEFA...NDIE.hAEADGIB.....hAFA...,1,-19,-31,12
HBNOAVfGgJELCPbDWURTZeMQIKdXacYSF,VEBHGAFE.EADFLEDBCAAC.DDDCRFBHeHFA..QABDhAAAKFFBaCAF.SHGAhABABHECACCFJDDFPBEEhADA.WFFG.........hACA......hADA...,1,-22,-31,9
FdLENcQHOJUBWgTCZDIfKYXARVbGeMPSa,RGFGVEBHGAEG.eEBFMDAC...SAEEaDGEdABFLDDDhAAAEABA.QAGEhAEAOGDCBEFD.TFGHhAAACCBG.IBEFfFGB.YHDAhAGAADEBPBHD....hABA...,1,1,-34,35
XOFWdabKZADMfGVeIUTYBcENRHCJLPSQg,MCHFGEDH.eFHHUFCDBAGEEAFE.HCCACGGH.JADCLBBD.hAAASCCBQBAGhABAOAEHWFCDdGEHKHAAAAHAhAAA.DABEIDHE..cEEANCEF.hACA......hAIA...,2,-26,-11,15
ZLINUBADdXJWCScMEKOHTVfgbGPYFaQeR,XCBFJAFB..CBAC.SHGGEHEG.KHBCTEEC..hAAAgBFEGDAD.hABA.FADDQDGFhAAAeAHFLHAEIACGBFACABIBWEBAcGGCMFAFhABA.OFEDfDGEhACA.,1,-17,-28,11
WRMBGUSeFIHZPDgXYQJAbTVdCNOEaKfLc,VEFHCFED..OFHBECGB.KCCFLFCD.RADDBAFGUGAHFEAFhAAAZCAB.DEEA..XFDDhAAAJHDG.ACAFdAHAaADD.hABA....fABFMBIFSABAhACAIGAG....hABA...,1,-26,-42,16
QFSgEaOCHUILcfWNDZARGKePVBJXTdMYb,GBCHeCCHBFDGJAFE.dCGA..MEIDQABGFABA.SGHFhAAAaGDGHCGDLEAChAAA..cDABhADAWEFBDBBFAHFEPHBE.XEFC.TFAHhAEAgFAF.hAFACHGA.IAHANIBF,2,-23,-9,14
dIDTWgcLOYNJGXMfHPRSZaBVebKFQUACE,CEFAEAFBDAHH....TFFC..gBCAOAHFJDAGMBBFhAAAHCGF.SAAEhADABGBBeDHBFGDCAICEdFDEIHHEhAEALAEH.NBAE.fBCH.hABAPHACaGGD.KDEB.hACA...,2,-37,-6,31
dUKHQaMCXOLJeSYAPgFRIfVGWEDNBcZbT,FHBGRAAD..VDEGEBCADEGGBGBBZFDD..dGGHUAGAKAFA.HBAB.MDDHhAAAOHCC.JFCAeHFAhABA.ACEA..IGFEhACAfADH...NCDB.cEAE.hAAA.QDABhACACAFD.SAHB.,1,-13,-24,11
VbXQDRYTZLHBfOMWgcIaJeCUENPKAFGSd,SDAFdCFC..XBGBRDBEZGDALCFEHAAFBGDDOHBChAAAMDCB...gFFHhAAAIFFCaAGCCHAENIEF.hACAAHABVABA.DEGETEDEfFBA.hADA.WAEF...hABA...,2,-23,-20,3
WGILFASVcHgXYaUbDJKBETCZeOMRdPfNQ,SCFCVGFG.HECCXCGEUGAEJEHHBCEG...EDBCTBCEhAAACBABZGBG..OEABhAAAMDGDdAEH.NIEFQCAChABA........hACA......hADA...,1,-14,-39,25
KVIXTYObgUCWdSJEaMBeHcFNADQLGZPRf,DECDQDACZAAERBEG.KGDC....VGEAXDDD.OCBAhAAAUDDFCEAASGGAhABA.aCFFMBIHHGAEhACANIAB.LAEE..fCAChAAA.IEGD.hADA...,2,-38,-19,19
PUIJTZQCgHRdLGFNYbADScVKaMfeBXEOW,DGHHSCFCKACG.MAADBCHE.EAAHODCB.UFEDTEAGhAAAZDFECHBFHDDE.LHAChACAFAHF..YFADhABAcDGF..aAGCXBDBIGFCQBBHhACAdCDB...hAEA...,2,-27,-16,11
DLCZMXWORHAUEYBdfbgVFeQGaNTSJIcPK,EGFCdEGD....bFCEFEEC.QAEEGAEDaGGETCBD..hAAAJCAEPHCCKAADDDDCCEAHZBGHhABAMHAE..XECHhACA..OEACAIHEBBCB....hADA......hAEA...,1,-17,-27,10
EKDXTNOZbSULMgdAfGQJPWBCHYcRaIVeF,QAGHJGEABBAB.CCEAHBAARACC...VDFGeBGD.KDABDEED.hAAAXGADOHCCZCCEhABA.UFAF...hAAAMBIFdGHAAEBG.PHCA.cAEBIEEEhACA.....hABA...,1,-23,-29,6
JKdDBScgabRZFHLOWXPNMQVIAUeTGYCEf,UDCHeDACGGEBEDAF.JAGFdABD.DGGFBFBF..SDGDhAAAaEEFRBCGFEGA.LBFGhACA.XGAEMAIDIABFhAAAADFDCHHEKAGC.........hAEA......hAFA...,2,-32,-26,6
XbCOKeScAFDgQPZdGRLfBHTMNEIUJaYVW,FHFGDAFBQGDDdEGGLCECBBHCHDBFMFEEEBCB..UGBF..hAAA.aEEHYCABhAAA.XACCCAHGKACCSBAFhABAAEDHPDDA........hAFA......hAGA...,1,-19,-33,14
MfIeSKaZJYVARgUGbPdNcWTOHLDFBCXQE,UFDHGAFEdFBA..NBIE...TGGELEAGBHDAXBCChAAA.EEEBICADhAAAKBAF.JCEBADBFRGFA..bBBFhABAPHBC..OAGDDDDECEGA....hACA......hADA...,2,-37,-10,27
CAEYVfdDNZMIJXFaWQLSTBecgbGHROKUP,ECFCVAADDBGE..MDEB..IDCFFDFG.QGGGhAAASAEBeEEE.gFAAhABAbDAEHGFCKHCACCAAfHEFhACAdGAC.JAEBWCHB.BFFD.hADA......hAEA...,2,-24,-16,8
VJcgfdOKQBaGCeANSWFLTIEMUbPHXRZDY,SHBGLCCHTGFEMDFG...UBEHHGCCZEABDDBC.JBFEfEGEhAAAdEAGQAAChACABCHACCBDeEFBAFEA.FEBEhADAIABCEADA.PHCC...YAFChADA...hAGA...,1,-12,-17,5
JKFZAaYNUbVHMegGTOdXSRQEfDCcPLWBI,aHBGUCBCHCCCeAFF.GEEETFEH.dBAESHGAECFG.DADChAAACAFDLEAABHAFKGCGAEEBhABANIEBMCIH.gACFhAAAOCGB.........hACA......hAHA...,1,-1,-34,33
FXZQNeTfHYOKgVDSbJMAEaBGWUCcPIRLd,EEHBaGACGBEGUFDC..CAAD...ICBHdEAEZDDA.eGEAHADHKAAEhADADCCH..SECHhAEAbAFF.MEIBAACBBBHGhABAWBGH..cGGF.....hAFA......hAGA...,1,-24,-27,3
MabSDgJWXFROPIQUKdVEcNCLYTeHfABZG,BBGFMIDA.SCDHDHCG..JEEGXBAFFECB..RAFAOAAChAAAIHDH.KGFAdGAGhACAEDABCCCH.LEFAhAAA.eGACAGHFaDGAWCCD......hABA......hACA...,1,-34,-41,7
QABUGTWHRLfFgXdVMaZSJPEeDOIcNCYbK,UCCHTAGHREADLHAG..gDDAdHGBMFDA.SGHFhAAAECHB.eCAHDBDEOBAHhAAAIGAECHEHKAGGhABAACDBBBAC..........hABA......hACA...,1,-26,-35,9
HJCUFXSIWOGDbYZBLAEfdaMVRPTcQKgNe,EAFBdAFBMEDARDBG....TFGDKCCAeHDEJABD.FCFE..IDHBhAAAOEAHDFCA.ZBAFhAAABHAFAHGA.aHCA.PADFhABA..cADH.QEGEhABANGABCEFD.SGBHhACA..,2,-32,-21,11
eTPgcAWbGfdDECFQUJSVLKYBZaNXMIHRO,GAFEdHFHDBCHFGBEQFAC.SFGCLEAGBEHGaCCHNEEA.hAAAMAACHABC..RFEGeDDEhAEA...TAGFhAFA...gBEEAFDHfGHAhABACGAC......hACA...,1,-20,-25,5
adOUGBecEMYNSVgbCLDJZfHRQFWAPKXTI,XGBCaGFC.UEFBGCDB.BBGHEAEG.MABG..NABC.gEGEhAAALFDBDCDBhAAAZFBFHBBEQCGHhACAAEBGKAEAIGAC.......hADA......hAGA...,2,-32,-14,18
CLXSUJTfaRHKAbVZeYMBPFGNQIgdDEWcO,VGFGZFDFMACG.FDBHQGCB.dCEFDBAEEADAOHAE.hAAACHHHLAHDSCDDhABAUCDFTAGG.fBBChACA.aEFEKHFEAIACYDAFhADABDGDPFFENCIE....hAAA...,1,1,-36,37
GPZTCOAbHDRKQJefSEBWIFLcVgMadUXNY,DHCEQCCBeBGH.EHGABCAG.FFGALEED.VGAEgEEDhAAAMBCAdFFBUGAAhABA..NAAH.GABChADATCFHCBEGOAFGAAGE.......hAFA......hAIA...,2,-26,-18,8
MJaURTHeSPdBLVQKZcEgOYCXNIFbGDAfW,MCCAaAAD.UFBAHEGH.SHBGBGDELAEEVCDE.KCAAEFFD.hAAAOGCECHHA.XDBChAAAFDDFDFFDAABC..WAFChACA...........hADA......hAIA...,2,-51,-9,42
HgcNLTOeaJSUbWDZfVICPKBRYXGMFQEAd,dCFCHAAD...gFAANAAFLHACeFDD..JAEESADHhAAAUCCG.DCAFVGFGhAIACHHABFEE.RBFEYEGHhACAGBGCMBBFECCBAEEC.......hBAA......hBCA...,2,-26,-4,22
WcTSdMbRYHfCZPQKVABGXOLaJUIgeEDFN,GCEHXFCAOAAALCEEUECC..IBCDEFAHDEIBFHEA.hAAA.NABC...TAEEhAEAMIFARFFE..fCCHhAGACFBFQDFDAIBABBHGJHBAWAEA..hACAdFFB.....hADA...,1,-15,-21,6
RKaSUHWZQNAMFVGcTPDXbLEeCfgYOJdIB,FFEFVEBHGBED..TDDBDADELDBCEFFF.eDFBCEGB..hAAA.fGHEhABAgACGJHBAIHAEhAAABBCA.aBAFSEBAUAGDZAEFACCD.PHCChABA......hADA...,2,-21,-10,11
QdSegbFXEPHJVYaKcCIRNTfMGLWBUDZAO,QAADdEEDSGBFeAEHFCAB..XFDGECEAHCBB.JHDEaEEChAAA.CBHGRDAE..NCHG.MIEAhACALAAC.BAHGhAEADADHAIAC..........hAEA......hAGA.OEHB.,1,-14,-21,7
AYfNWeCMTROLVJbKHZdcGQIgEPaDXSUBF,...NDHC.eAFB.TGGERFCHLDAC.JAFDbFCF.KCHBdEBGQACBhAAAEBHD.DABBhADAXABDBHFDFGACAIBG.hAAAWFFEOFFBZCCA........hABA......hADA...,1,-9,-31,22
eYfgRLNXWdDTHAVaBGJZKIEFUSQMbCOcP,BCAHGGDHJACDZAEA.KDFCFAGEUCAH..MEBCCABD...OFFEhAAAeEDG....fHAHhAAARGAGLHEEXFAChACADEGCAGDA.aHGEECFH.SAEBhABA......hACA...,2,-40,-24,16
aWbfPNOGJLAERIHMZTFDedBYSVQcgCXKU,ECFCRGFGMFADZFFH..DAEABGDE..SHAEQCDACEEFUDADhAAAaBBD....fAEDhAAAOBBE.GBGEhABAAACHTFCGdEBE.........hACA......hADA...,2,-36,-28,8
OWFgDSVXMePcZCEHLJabTKUfQGNdARIBY,BFDDOGEAFCABDAGC..SCCGMBDA..eCAGZCEDCHHCLHEAhAAA.aABGKGEHUCGGhAEAfBGBQECChAFAdHABAGAG..IHBH..YDHFhAAAWFFE.XEBBhABA.EABA,2,-34,-28,6
cbSePVNHKaQgBOfdRIZEJDLUYMTAWXGCF,XFGHCBCCFEFG...SCHBeACE..PAHDVCFDHBDHhAAAKECC.QDAChABAOEHFRFDFZAFBDIGEYGBAhACAAAAHGBAE.NAEF.aFAHfCCEdGGA..hADA......hBAA...,2,-12,-11,1
CbeXPVFHdMAOBITZJaYURNWcDESgQfLGK,OAFBTGGG.ZGDE..JAAAaBDB..RBDG.....NBCGDIGESGDEhADA.fFBEhAEALDAFCBHDbDEG.hAAA.XEEGFGAHMDIFAAIHIHAB.hAFA.YHDAcDGF.hABAECCB..,2,-43,-15,28
TdMAFVLDaOJbeBIKEWYSPXgZGUcRHfNCQ,FDBDLAGHOCHDJFBDBAED..EBBH..SEEGXDDGGGEHhAAARGCA.fADBhABACGAGdABCVFGFbEFAKBGDhAAA............hADA.WDDFPCDG.hAFA...,2,-37,-13,24
CGEaFUSMQcLdDBAIJNRTWbXZYPefKHOgV,JGEATFDH....XDFBZDBBeFHHHCAAOACGCGAE.aDEGUFCAhAAAQAAHdAFCDABEAIGAhAEAIBEG.RAGHbGAChAAAPBBA.fAHA...hAGA......hAIA...,2,-28,-9,19
FJWYCHXbLeBgMOUPGTQdIVSNRZfaEADcK,DGHHKAFBFABD..JAFECCEG.HBCCLFEGBEEC..OCGDGEBE.hAAAdDBBSBBDhABA.ZFDGfDHGhAAAAIDA..WDAAbGFAMIDAUFAF....hABA......hADA...,1,-29,-34,5
fFIgEBDWSAceQLUaYZPMRKOVbNCGdHXJT,eDACQDCHUEDCZAFEMEBH..RAACKFHBVAAH...CFEAGADFhAAAHCGDTGAEFGCHIHGBhACABGGDDCCG.AADA.LDFGhADA.aGGA.......hAAA......hABA...,2,-27,-7,20
aWZARMKgVXNEJLCSYdBTFQfeUHbDOPGIc,KAABXFDHEBFF.LCEECEHG..dFACTCBFQCCE.hAAAUGFEbEAHODEChABAGEBEaADGAIBCRFGDMAID.hAAANCAA.SHDCBFFFeABADACF.IEFAhAGA.....hACA...,2,-16,-6,10
fMcQVRTLdgOWZXBHPKCEUYISGJDeNbFAa,aGFHMCCA..QABDTFFG.dDADODDEXCFEBDADHFBChAAACBBCUFBDSHGEhABA.DBFGNBDBAGIB..fEFDhADA.cGACLAHBWBDH.hAAA......hABA...,1,-3,-39,36
UAKPQSEVaHgIYdeWCBNXfDOcMJGLTZFbR,QGBCSEHBEBHHHABD...IEAGeDBEBHBF.fAFBhAAAcDGGMCFChAAALFDDZFDBFDCDRFFHAFCDKBDBhABAPABE.........hADA.gGGHhAEAdCEHCEAADBAB...,2,-16,-7,9
NQELYBeSIKFODRTaPVZJcGMUCgXfdAWbH,HAADEGFCBBADSFEAKBHB.OHCERBDC.aBFCZEBHGEBBCEEE.hAAA.XDGGABHE.hAAA.bCECLDADhABAIHHEDDDBTGAF.PDHD.cADBhACAMFID.....hACA...,1,9,-37,46
JLWGaceKNRZEXVYUOCbASIPFDfdTHQgBM,SHBGFHBGdBFHHAABBDHDMEAALEBG.aCGGKDFC.ZGFEEFEChAAAVEDGUABF.CCDHAHHHIEHGhAAA.DAIDQAEBhACA.WFHBcFAB.NADF.XGEAhAFA...hACA...,1,-18,-24,6
AecPCMXdWZGQFDaSJHKTNEgbORfIBVLYU,eGEACFDGdCABZFABQDED.FEBHaFEDJACGHAEG.KDHDEDCA.OAGFhAAARDDABHCGLGAAhABAABBE.MAIFXGFDhAAADIGG.SEACNCCHfCAC...hABA......hACA...,1,-3,-29,26
TYSgHbLOWJNaREQcfUdeVCKBMPZDXFIGA,SGFCHAADLGAGOFABJAEEREEA..QGBHUCFFdHGHCFHAMBBFhAAA.DEGEFDDBIHHChABAACAF...YCCDhACA.WFECNCCCEEADeBFF.KAEF.hAAABEDC....hADA...,2,-24,-18,6
JYZedMcPOATINUVgDaKfELQWFCSXRHGbB,TCBCUCBCDAIB..KFHFLBFFFBFA.CFGC.XEDAHGCABAGEhAAAZFACMDEA.OACGhAAAAGIFIHGE..hABANAIEaGEHQFAF.SBDHhACA......hADA...,1,-22,-37,15
EDCXRMTPHObeZcfaLSFVIWGgdJUKAQYNB,QCBCBFDGDFAHRFBD.MACAHCAC..eGFEZEEF.aFCALAEDhAAA.SGGBhABAFAFEWHEGGDEFdBHEKABAAEIDNAAAEBHHhABACBFC...........hADA......hAGA...,1,-10,-25,15
XRGPCQcEgKNYFTMBeIaWJLfUAbDdVZOSH,DGHHVBCFZCEF.HFBHGEBGQBBA.EAFGgAAFhAAA.KGGFNEADFHEABFECaEGAhAAAJDFCLAHBAHBDdAFHSDAHhADA........hAEA......hAGA...,1,-12,-25,13
MEFLPZTdGVUCbBeODQgYaKXRcIJSfWANH,HFACFHBGLDFATEGHdAFEUGGEBCDC.DDFAQBGB.hAAAaACGKBAC.RGEGIAHHhABASDBEADACEEEHPFCChAAA.ZBBACAEDODBC..XADEhABA.....hACA...,2,-22,-13,9
SHKNUICbPZGQEcTFDAegfRLXaBMVJdYWO,eGEARAADLFGFBDDGMFAFdECD..OFEFKABFUAEFCHDA..ZACCEEFHhAAAFDGA..DCABADDB..hACA.XCFGaGBEJDAF.hAAASDBD.NBIE.IAGF.hADA......hAFA...,2,-34,-26,8
eQgTbLPZYWHDcKFVSAGdCOfXENBJIaMRU,dBCGCAFB.ODGHEBCHBEDE..JBEHMDHFUAGF..eECD.TFEGhAAALFAD.PHDEhAAAZBAB..WBFAhABADABA....KEEFSADBfDHEIHHHhACAaGHF..RFBF.hAEA...,2,-29,-28,1
EMcAWfIUDYRTaBPVNFQHSXgCLGKOdbJZe,..IFDGUAFBDGEERGDA.BHHE..VCGDFDAGHGCA..SAEGhAAACEECKABC.OACBhABAdGAE..JDCDEDEBhADAAIGA........fBCFhAAAaHGEQGAG..hAFA...,1,-31,-43,12
EFSKTWDJCafLUZObBGHeXdVYcMQIgRPAN,EAFBKDABDAHF..JDAFCDCD.LDGBZEDE.BHAAeGBGdACD...hAAAVDEHMBBG.QFGAhABARBAEADDC.SBHHhACAaHCEOECH........hAAA......hABA...,1,-28,-42,14
ATfFQMVHGUZJXDWRCYLBPebKNSdaEcOIg,FGFCQFCAHAEHUCGAZADGDDDERCAF.LFFABEEH.eHFEKABCdGADhAAAEEAG..OAADADEFMIBAhAEAGBGG.JHAACGDE.hAGA.....bCCF......hAHA......hAIA...,2,-25,-8,17
DedaBMSQVbgcTIKRJZECLAYXGPUWHfFON,XFGHUAGHHBDDFHBCOFBB..eEAFdHCDBEACQABChAAAVGFG...bDCCTDGEhAAAICGG..JFDEhABACAEFAGFCGBBEfFCHDACA.....hAFA......hAHA...,2,-17,-10,7
UNAKHGPSVdacMgBJDXIfYFbQRWeLEZOTC,KGFHHEBHGBBGVACCdBAEMBFCBHFD.DAIFXCGH..IGDFhAAAFFDE..bEADhAAA.RADB.eDEAEDEA.TGGEhABACCAFAFIH.aHBC........hACA......hAFA...,1,-17,-25,8
aBDcHPXNQOdSULgMGWEJIFKRZYTCfAbeV,eFBBBCAHDCCAHCCG.XBABOEBCUGAELEHH.MCAFEGGE.hAAAFFFEKAEARAGFZGDA.CDFAAFCEhAAAaGEB.....hABANEEB....SABG...hACA......hADA...,1,-6,-48,42
EdcIbPgLYUWSAKBRFHCaQOGTZeNXMDfJV,BHCHFDAFCGBC.aGFEGECHZDAF...eEHBMFDADCCB..JBAEVGEGhAAAdAFH....IEHGhAAAPHBE..LDDChABAUCDFAIHAKGADRACGOAHB.....hABA......hACA...,2,-38,-9,29
KWPYXCTQMgLZIBeDVFfJOHANacdbEURGS,aHBGdHBHEGEEGAFA.KDAA..PCBE.CEBH.MHEGZDEGeADGhAAADDDAFFEA.OFBCAGCD.hABA.NCAC.UBAB.SHGAhAAAXGGBgBGCIAHA..hACA.BEHA...hABA...,2,-32,-15,17
bSAQfMTOGRdDegUXVCBFNPLJYWZcKEIaH,MFFFTDACGAGA.DAAGeFHB.XCCFCFCFBBECFDDALHDAhAAA.JEDEZBBFKAGAaGADhADASCFGQGGAhAEAfGABdGDE.......hAFA......hAGA...,2,-25,-18,7
VOQdPINcCZEYUgFMfTBbWJGLeDSXKARHa,HDDFaDBD.QGBCdEDE..IHHCNEAACACG.EGECUGGHFGAHMBDChAAABCFGJAAF.eADHhABASBCGKBHBABFEODGDhADAPCGB.........hAFA......hAGA...,1,-14,-30,16
VNQJDMEfgBcLGKdRTaXISeAUOZCFWYHPb,OADGFBBDHDEG..VDBCQEBB.MABCfHBHhAAABFHFGGCHdEGGaFHFSBGAhAAAABCGCCGD.PAFAhBAANGBFEAGA....LCAD...hBBA......hBDA...,1,-18,-20,2
fPAIgTREBeNXMKFOZYaSbGVUWJCdcQDLH,TCBCBCAHeCHF.MAAEOAGH.ZADHaECESFFAGGEHUGCGhAEACEFBdFBADBFHLBAChAAA..PAFGhBAAAHEFIDHEECCG..NEBE.KAHB.....hBBA......hBCA...,2,-20,-20,0
IacPCHXVgSEdfARTGLOWDJUKYBQFbZeNM,TBCFOHDADAGC..UDEBBCEFQAFEFFGFZDEE.MACE.hAAAaFCFCADGHFBH.VCAHhABAEGGBACIF.LEBDhAAAKBHBeFADcBAH.PHDC...hACA......hAEA...,1,-3,-27,24
GBgfZCcNYTaDVERKdMQbUWeHSJOXIPLAF,FGACGGDHBEAGZEDC.CAHD.....NBEA.aCBDDHEAEADC..dDBBQFBChAAAUAAC.eBAHhABASCFFOAFF.hACA..XDGF.LFFAADIHcEGAhADA......hAIA...,2,-44,-18,26
HSIOWMYfQUbcTACJZKFaGLBeXPEgNVdDR,CEFAJDCHZABD..FCAGLEBEBCHE...eFADEBEC...VADEhAAAdEFCDEADRGCG.HGAAOFGDhABAMBAA..fCGGhAGA..QEGA.bFDDhAAAADDC......hABA...,1,-22,-37,15
DOMfTBJEGXUACNgKFPVZLHdaRceYbWQSI,CFDGKHBGFCABZAFB.dBBHRCCE...eECE....bBGFQGEGhAAA.IEHBhABAOABEMCGBTEACBFBEhAAAEGGE.XFFAABHH.PHAALADBaGHD.hABA......hACA...,2,-37,-13,24
LAaPVdZcOQRINWYHEbTeGKSXUfMFBgDJC,aCFCVDAGZEEB..ODGDQEGH.REBF.IABG..hAAAWBCBEGDFeFFD.hAAAKBCASCAAhABAUAGCFGBDDEIHCHGFPAEG.cAGD.NBEE..hADA......hAEA...,1,-15,-25,10
gSLMGIATafDKUHFXbPNVQWYBZdcJOECeR,aGFCDGHHHBBD.FEGBXCGE..PAFGVFBH..QAAFhABABBACdDDAODAHhAAAEBECCDAHeFFESFCGhABAMEEGACCFKADC..NCIGZGCE.RBEB.LFDHhAGA.....hACA...,1,-3,-17,14
DgLTVKRbBdMWQNGcJYSUPFfZAeEaCHOXI,eEGHEEHBHDEDOEBADFAFLBBAKBGC.BGBDdBAGMBCEQBFEhAAAGCDFJDBGUFAGFGGBAICAhABACGEE......hACA............hADA......hAEA...,2,-32,-22,10
DRXfCQdTLbEZWMABeHOUNGcJVYSKPIFga,BEFAOFFCUDCGGDAA..JDAFSGCC.KDDDFGBDDBADhAAAXABCCEHBdHFBTAGGhABALAGF.ZFEEAAEGHBBDhACA.NIAF.YHEG....hAAA......hACA...,2,-46,-8,38
EAIfBCDOLbgWXZTdHNcQaVMeKYPRGFJUS,BFDGOFEDLAFC..bFAAXEBBdEGBHBCBQFGBhAAAMCEAKAAF.RBCAFBGBSDAHhABAIDHAfAEHhACADCADZEEF.TGGCaBAF.YHAA.hABA......hACA...,2,-19,2,21
PMUXgGaTHJeCFWKSZdBbfYEcDNOAVIQRL,QFDHRFDFLCCCUEBAGEAAHGFEeBCBCAAB.FAHB.KGGEdAHEBDFHhAAA..bBFBEBAFDCADAIEEICEChABA.MBDGhACA...........hACA......hADA...,1,-12,-29,17
RdGEOUVbQCYaFJKfBISNDcWeHPMTAgZLX,ZFDFXAEGGCFGUDBHQDAF.CABH.FGHBKAGHBGAA.ICFEhAAADFCBeBCCMFGDhABAAHDBLFHF.dGAGhAAAOABF.YEDBfDDFSAGEhADA.WHCA.hABAPCHB.,1,-12,-26,14
JgIFRZHcXTOUYQPBEdNMVbDeAWLKCfSaG,KDCDSEGDGEEH..JEAHFCAB.ZFEHHBDD..XAFEhAAATGDHOAAFQGCAhABABGHEECFGMIAADECAAFABCHHGaADAhAAAICDF..cCGFPEBB.NAIEeEHBhACA....hADA...,1,-12,-16,4
GTFWUeKLOSYDABdCbgaRZfNcXMIJQPVHE,dBEECFDG.aCHHRDAAZFFB......NABE.XAABMFED.QCGFhADAHFFCTDCAFHAA.hAEAeFAHKCCELAFEhBAASACFABDE.BGCFbEEB.fAFB.hBCA......hBGA...,1,-16,-22,6
cWBaMSdDXLKEHVFfPeTGIQAZgNbYJRUOC,ZAAD..bDDDJDFHRDFD.UEBF..CBHEBEBD.MIFADAIFLHEEhAAAECHD.FAGDeAFFhAAA.IADBQACEhAFAAABF..NHABOCBAcGAE.aFHD.XCAChACAKDHB....hAFA...,2,-34,-20,14
eZfSEYDQFHLPgKUaCBWNGOMdVIAJTbXcR,JDACTCGC....XEEGeBDBSHGADCIFHACHLGAAhAAAKDAFaFFABFDGGAEEhABAdAAAAHBGbFGDRGEA..EFAH.hACA.FHDE..........hAEA......hAGA...,1,-16,-22,6
DFaePUKEMfOTIcgdZbWBNQYHCJGVASLRX,SDBDRAEGDBBA.FACDaGEG..UAFEKDCC.EHGAMHFG..TFEAhAAA..gDGBhAAAZDGFBHBGNAICQGABhABACEDF.JDAHAEFA.LFCH.eCEHhACA.....hABA...,2,-33,-18,15
RVPXgaUGbALEMSFfNYWKQHBJTeIdCZODc,MEGFSAFBFCAB.....NCFEKDBGQGAGBADD.JEEHeCBEhAAACCEFZCGFDGHB.RFBF.XABBhAAAaGEH...hABAbEAAACAHEEAB.YAHH....hACA......hAEA...,1,-30,-31,1
LWaBCSKOTgRDcIMUNfdQZVHbJGFeYEPAX,XDACaDCDBGFA.KBCH..OEAFRCFE.DEEBMIAG.UFBCdAEGQBBGhAAAZFFBHCDBJAAGhAAAFDHH.eAHBEAGGAGEDCBADSGCBhABA.......hAEA......hAFA...,1,-16,-28,12
BaPGceQdKNSZgUfCLDMVYJWFEXIAHbRTO,HGFGTFDHBEFB.aGBHGEAA.eABDKAEBZDAAUGGGCABGDAHHMDEChAAA...JBDEECGBAICE.hACA.OAHF..hADAcFDENEEF.fBDE...hAEA......hAFA...,2,-37,-16,21
NYeWHJaPcGOAbdERVCQBZKDXIMTLgFUfS,dAFBRBCFQCFCKCAFDEGB...MFGBLDCGFGAHUAACSEBDhAAAeAEGHEBF.JFHHaFGDhABA.GBBFADAE.VGCAhACACHEFBDHA.........hADA......hAEA...,2,-29,-12,17
HeDNIaCLcQbRgWBMSFUTJfVdKPEAGXYZO,XAGHZFDFeFGDDCFC..aFEALBCF.QFABhAAAgDAFMIAAFCECUGBAhAAAfBAGdHFBKDCGAGDBOAEChABAIABHCCHA.cACDWDDE.BHDB.SEGEhADA..hAFA...,2,-25,-13,12
RMIZWKNFLSAHcPXbDgUadfCVBeYGJEQTO,HAADXCBCDFDHaFHFdGDC....CABEeFFHJADA..EAHFOFABhAAARCFEZDDH.KCGAFHAGAIBE...hADA.PAEBbGEA..hAFA.fEEEBCCC.YEHF.hAAA......hACA...,2,-21,-20,1
EMPFQZcbgUOXHCaKGVdfDTYIBSLARWeNJ,RFDFeGEAEFAG.FAFHZBAA......bCAHgDFBUGAG.HAEAhAAACCDHKAADdEDF.DHGCIADGhABASAHHLAHDhACAAECB.JDFBMDIB.cGACaFDB..hABA......hACA...,1,-18,-20,2
JANcRXGfTMPaeCHSUDdOEWBQYFbLIgZVK,RAADXFGHGAECMFFH..eAGHHCGFDHDAEGBEBFCBFGHBLEBEhAAAICEBZDAEKAGAAIDE.hAAA.fBBGhABAaACF.SFEA.dGAB.WADC.hAEA......hAGA...,1,-11,-21,10
SEDCRTQXBZNJLFHgdMVWUKbfGYeOaAcPI,..IFDGDGGDTDDCBAGCZACDLDAFHCFAMECDUBFH.KACGfAGGhAAAGDEFeBBBhAAAABFFSBACEFGA.hABACHEC............hACA......hAEA...,2,-26,-22,4
IfYBDaXJSLGORbQCVHWeMFZdEgNTcKAUP,UCBC..fDABBGHDDCGD.JDEELBHBOEDH.RFEB.QBBAhAAAHADA.eFBFhABAMAACdHEFEGACTAFDhACAAHDA.IHHC.aEFE.SFAFhADACEDA.....hAFA...,2,-39,-1,38
LSGNReTEXFHQBcAUbYKfgCOaVZIdJMPDW,UCBCKHBGCCDA.ODGDZAGB..dFFAMEID.DBAELFAC.SEEChAAANIBD..hABATFCDFBBDBHGHAEFB.hAAA.fCFFaAEGIEHCJEAHGADFhABA.EGEA....hACA...,1,-26,-38,12
gYedUDAZXQESOTbCPVaWKcHJNLIFBMRGf,XDCBEFHB..TDBGCGFA..aHFEKEEHHFCCLAFCFADEBABDhAAARBDB.GBEHfBAEhAAA.gGCFhABAeHAGDFFAAEIBQCGDOCAD.PHEAhACA.cEAC..hADA...,2,-16,-13,3
ZdHTXIAfceYJLBQDGMCRNPbKgaEVUSOFW,eGEAJEEGLACGBBEGDEFBGGDH.REAE...NIDH..KDHF..hAAAgBGAEACB.hABASDCAFHACdDACTFBDhADAAIDEfBAG..YDDEhAEACAABaGAC......hAFA...,2,-35,-19,16
NQbRVLeIXUYgPOKGZdWAfJMDBHEFaSTCc,MDEBDFCFECBHFDBG....aGADCFAC..QCFCREDEeAEH.UAAChADA....YAGBhAAAOHFEKFGCZEGFABAHfECChAEABADF.SCHHNICD.bGAAhAFA......hAGA...,2,-33,-28,5
GTQWbdIACPVJRDfUSEeLXFaHcZOBMgKNY,VDBHRAADDFGF..UGCGeBDD.LHEAFCFF.HAEBOEAABDHC.hAAAMAAFKEDGGACFhACA..QEFDhABAdHFDCAHG.PHAESGADaBGA....hADA......hAFA...,1,-5,-31,26
LQEfFWcbdCaeKSIPHBRJOZMNDAGTUgYVX,TCBHUCBC..VEFBQEDC.FHBG..bAFCCDAGaBFGSGCAhAAAHABCBGEAODFAhABAMIFEAIFE...GCGGhAAAXGABEFAFWAFEcEDB.KABA..hADA......hAEA...,1,-1,-30,29
JeDIWCLcXHNAaBKgRUTFdQGfMOEZbSYVP,aEHBKEGDUCCG..dCFGQBGBMBAAEECCZAEG..SCADhAAAVCAC.JFAHeGAChAAADIEACFEELHDC.hABA.XFCCAEAHBFFE.......hABA......hACA...,1,-20,-38,18
dDRCQOBMGITJbEVNULXgWFcZAePfYSKHa,eGEA..fDCDKFABaDBF.DFACQDGBBCADGABDJEDB.hAAAEFHBUACFLAGDhAAA.XGFCFAHDABBDSGBHhABARFCF.CAFHMIFC....hADA......hAFA...,2,-24,-20,4
DWZdbQNMYcLHVBaRCAfXFIUgJPOSEeKGT,FGFCUCBC..JACBOBGB..eCADTFGFDBIBZECG.dAGAQEDAhAAA.NBAE.hABAMDHDLHAABGDECAAAhAAAAEIHIFBE.PHECKCEF...hACA......hAEA...,2,-43,-19,24
FQdOGcYeWJNVLPUbEfASDCTKHRaBXZIgM,SFGEDEFACFBD.HDAFBECDZBCEMDDEFHCEdAADGAEF...hABAeFFEJAHFLDDBhADAUABDEHAE.AAEHKDFC..hAFAaGGHXGAC.IGGFOHCAWAADhACA.....hAGA...,1,-16,-29,13
QRUFaSNYZJKbEgMDAOGTBfWLIedPCHVXc,ODACTGDH.BCDDLAACdGBBHAFD..VBBFQEEEhAAARAECaDFB.SADChABAZFGBJEABKCGCEGHD.MIDGAEDF.hAEAfEGF.IBBFCGFB..hACA......hAHA...,2,-20,-15,5
KBWOINbZgDMAfaPEcSQVeGJRCFTYXdULH,aHBGEHBG..QGDBGABDRCFBFGHD..XBFDdEDCUEAFKDCEBHFEhAAAIEAB.bABGhAAADIDA.ACCB..fAHEhABAPEEASFCE....hACA......hADA...,2,-28,-24,4
TBcLeERSJFgHfVCQZINWDGdPKMAXabUYO,aGFCUCBC.ODGDBDFBeBAD..SAAEJAEDHDBFCFFBQGGFhADAZBCF.IAEChAGANCHE.GDDEhAHAKGCHAIEC.XGED.TBFEcAGFEHBE.hAAA......hABA...,2,-32,-9,23
GNAMJDfRKYCZPTcedgIHbBLXEVSaFOQWU,DACGRDAGCGAC.ZECD....TEGBeHFAdAHEHCDCBHBGLAFCECCH.hAAAVAAEFEFE..OBDGhABAUGGBACGC.MFFDKFED.hAFA..PHBAIBBF.bCFCaADD..hAAA......hADA...,2,-23,-8,15
RedEOPZKAJgaSTDWHbMFVfLIYNGQUCXBc,aDCDDDFFHDBB.MEGBVFDCLEAD..IDACGACFQBGDhAAAUCEFBHHGRAAEhAAAEHGAZGACACCASHDAhABA..........hACA......hADA...,2,-35,-14,21
RYVKegcXDJQZbGMWPHdTCEaUNALFIOfBS,FDCDOGEABADERDCB.KGAB..eHDE..XGFHDCAGQAEDhAAAZCGDGBAEMDIBHFCChAAAdGAC.EFHHaABE..NAFE.hABAAFCHfHBB......hABA......hACA...,1,-22,-25,3
bGdMUKaDLSRZXgHcEQNABeJFCIYTPOWfV,BECDFAABCGHD...TBFEOFDG..VGAAdDBBKCGH..LBDFhAAARAEH.ZFEAHGCAhACAEEAHAIHAeEBH.IAHEhADAWABC..fDGFMEADDBCA...hAEA......hAGA...,2,-29,-28,1
UbfLWYcPFMTGKIedCXSBEJAZaVDRQOHgN,aDAFRBCFQFFHHDDFUAFGLFCD....WFGBPBGBhAAAFABAGEBEICADCDHBBCCBhAAAABFFDAIFOEEBhABA.NEBE....fDHAMFIBKAHH..hACA......hADA...,1,-19,-20,1
ASBDgacLWGIHRFbOXfJKMNCTEeQVYdUPZ,SFGEBAEDaEFDLGBCGBBGHFAA.FGGBXBBHKFDECHCGeBEAhAAAQBFD.hABAdAAE.PHBCDHDEWDEAhACAIECHOAEGMFAFNAIE.EGHF...hADA......hBAA...,1,-12,-14,2
FZcTfIbQgdNPCVXaYDMeASBLKHROWJUEG,LCAFHBCFODABUAGBFAHFZCEG..TCFA..fECChAAAIBAG.QGEGhABANFBB.CDBHVEFChACAYHFE.DEHH.eGBABHHE.WHAA.hAAAEBBE.....hABA...,1,-10,-26,16
BIfDMLWOZAFeEJTbQdUKHNVGRSagcPCYX,FEEDEGDB...JFAEQEAC.KDDGNICF.RBBA....aAFG.hAAA.PADEXGEBhAAABBAGDACGLBBBhABA.ZDGFAHCHTCGCdAHE......hABA......hAIA...,2,-37,-31,6
dMGLWeINbYPKQHSOBcUTaXJgVfDECAZRF,RDDFMIAGLFFA.eEAAbEFC...KCAHSAAABDGEUAEFaDCEhAAA...JBGH.fBDHhABACHBGFAHBdACAIHFEhAAANGAF..QGGE..hADA.OEAC..hAEA...,2,-30,-24,6
UACYHVFcabgIPWOMLeNDJGdKZTEXBSQRf,HDBHVDAG.aFHD....IAADOGCC.MBHDLAED.hACADIEEJADBdAGEKGDEEBBHXGGHhADABEGFSEEHhAAAQGAC.........hABA......hACA...,1,-26,-30,4
FSLaUHQAgXbMBPIWNOfcTGdRVJDEZYKCe,XCBCMBFHBFHB....IDECOBBFTGDAdHADRBGHVEFFhAAADHAEZADB..CGCESEAAhABAaBABQAGChAAAbABA.PDAD.fGFB.cDFDhABA....hACA...,1,-18,-29,11
ABcINEgbaVFdUDfOJHKYTLSRPGWeXQCMZ,BFDG..IDFBEBFH.aAADdHADDEEFOHDEHFFCKAGALEFAhAAARCBA.GBAFeHCCQGABhAAAMEAGAHIBNABF.hAGA.....bAGDUEBB.fAEHhACA....hADA...,2,-19,-16,3
NZYKELaGfDUOVPgABMIJedCFHbcQXSWRT,BBFDJCHD.CAACHEEBQABD..SDEETEACZADFEAGCaHBEhAAADDCD..UFGDPFABhACAAHADMEEH.eCCDhABAdHGH....cECDWFEH.RACFKEHB..hAEAfAGA.hAFA...,2,-27,-11,16
fCBcaHRdVTOPDXeULEGZMFSJYAIKQNbWg,QGBC..WECCCECCBAADHGDGdAEGODFDDGDC.eBEGhAAAEGHBZFFHSDAFhABA.JFABAEECKAHH.NDAH.hABAfHGHRBFF.PCHF...hACA......hADA...,2,-31,-19,12
JRQXNSUVCTgAFMGYKEHdObeWBcfZIaPLD,FEHBGBGAEBGD.HBCBdBAE.OAAB.eEFBBEBBZEADaFAFDFCFQACGhAAASGEDVDEHhABATAEE.AHHA.MIBEhAEA.KAHB...WGDA...fCDHhAFA...hABA...,1,-18,-19,1
cBDEUJNeGTWLMfIZQKOYRdACbXSgaPFHV,XGGGSAFB..aAEHFDAG.HCGFBCCBEGFGUGCGeCCETDAAhAAAMFEBZABE.OFBDhAAAdDEEABHHCAFG...PCHFhABADGDF..........hACA......hADA...,2,-33,-14,19
eZcWCGaMKQTINOJYUFLgVbRHBEPADdfSX,DGHHdAFBSFFEeCDFZBEB..CGCB.aGCEKAAFQCCD.TAAChAAAOHBC.JDBBFDGChACALBHBVEAF.HEFAhABABADCABCG.fGHA....hAIA......hBEA...,2,-31,-17,14
cVZNHaPAYfIdSgERGWBDTMKCOeLJXbFUQ,..IFDGdAFBSECGRGDA.BGGCDAGFMAEFCEGFLCAC.hAAAJAAEFBHH.QDEAhABAZBECaDEF.AHAHfDBChACAEGBH.WDAFKEAHOFHD..hAAAeFBHXGDFUGGEcBBAhADA,1,-14,-31,17
PRefgUAdMbaNITcHGEYJWCFOXBLVQDKZS,dGFHMHFGaEEE..TAADHCCFGAAE.JAGBFAFGBGAGQDBEhAAAKAEH.SADBhACA.REEEfDGBhAIAAHDANDIC.IHCHEEAB.CBHB...hBDA......hCAA...,2,-27,-25,2
CbgJfSdWMITQZGeEOLANVKHUaDcBPRXFY,VDAGUCCBDBAD.BBFCRGFEFADA...CEGE.JEGF..dAAC.MGAGhACAQGCH.ZAGFhAAA...eEADLAHDhAGAAFDCKFEB.cGCD.PDDA..hBBA......hBCA...,1,-31,-44,13
SKTHbUPCdVILXJeBQcgARZMNaEFGDOfYW,MGCEaAFBGGCFDBGH...OCFD..YCEFSDBChAAAKHBEHBBHPBBEdHFFLAHHhABAeDAFBADFcGGFhACAABFHNEIA...fEAEWAHD...hAAA......hABA...,2,-31,-10,21
aKNbTfRZGEBdIMeFSADQHCYWPLVUcJXOg,DEFAQGDCCGCG.....PDCELBDHUAAFJHFCXFBHhABAOCAH.KFGB.TAEAhADAZFDFECBABAHAdCFHMCIHhAAASDFB.AHIHWEAFgFGEhABANCIE.fGAEhACA...,2,-39,-10,29
ZJCNTfLaWHPIVXYcOUQGgSFbMEeDKRAdB,BHCHZFEEJCBCCAAF......TACDaEAFHFBB..IAHBhACAXCEBOEDEUDGFQAGEhAAAGCCHSGGGhAEAMBAEDIGEAFHGdFAHNACF......hAFA......hAGA...,2,-36,-14,22
GYfbWPDFLKMOUgEIeVNZBHdacCSTRAQJX,QDCHJDACGECD.....fHAFPHDE.LHDAhAAAOBCAUAGFIBAGhABAeCCGZAFDdGHAcFEDhACACDHFRFAE.AAFHXEAH.YDFGDACA.hAAAMCCA....hADA...,1,-13,-15,2
baEIJWULYSBdCHfDRMTXQVZOGcFPgKeAN,aHBGJCCHLBEGBEDCHACG..RGFE.MFFAQGBBOGEGFCFCKHDA.hAAAAIHE...EACCIAHGhAAAUEFFdBAA.CAFFDAIFhABATCAG..........hABA......hACA...,2,-34,-20,14
FHCWTYJGPOEXfBeAdULbDSKgQIVRcaNZM,dGDDUDACLCDHDCHH.KEBDQFCERAED..aABHMFGFCHHG.hAAATAACGCGEECEFBACEhAEAAIHA...SAGEhBAAIAEEcAGFNICF.HACB..hAAA......hACA...,1,-24,-30,6
dVcTDaBXPRKWFMIGNgYOHCAfEUeJbSLQZ,UGBCeEEG..JDABSBFHZFDC.dCEGTAAGDDCF..BAEEhAAARADCKHCGFGFDGCEF.hABA.NBDC.ODCBHEGDCAHChACAAHBBEAHB..........hAAA......hACA...,2,-35,-19,16
YTIbVOSPUFcNRLgCZMWaBXdEQKeJHfDGA,TCBCVAAD..OFCAUFADFGGD.RAEG.CAFHZADF..MIBAaCGCBHGGhAAAEFEC..KEDFeFADhACAJAAC.DICGADAB...hADAIEHDSDHD.NAIE.WGFE..hAFA......hAHA...,1,-19,-36,17
gaFZLdECcTDeOWMHRJUYAGNQIBVXPfbKS,QAGHVDBH..XADA..bFFBKFEBaDCCZDGFdGAECEFEDIBGhAAAOACD.MEFAhAAARBBGJAHFAEAD....IHDAhABABHHASGBA....hABA......hACA...,1,-24,-31,7
HfCaOQFBUNWDAbSVgIKMRPTedYZJcGELX,SCFCVAAD.KAADMDFA.RFBC.TEEHdADGZEFDGBCELBFChAAAHGACCDED.aGGDFGAHNAED.hABADFIDAEGC....IDAEhACA.eHDC......hADA......hBCA...,1,-13,-27,14
GAFKHYRQIDWLSZJgXaMNTUfBEeOPcVdbC,FEHBKCFCRBDBQGDF.DGCDLCAH.SABBhAAAJFAFaAAH.TFEBUCDHBEFHhABAEHFC.eADEOGAAhADA.PAEAdBBACGGDAEBF.......hAIA......hBAA...,1,-28,-29,1
dRICLFGMfXEegHabTKQZVAOcYSUWDBPNJ,OGEASHBGUAFEDCCABFDC..JHDARABFLHFGGDGAMGDEhAAA..XCEChAAAEBGAeCBBaHBAKEDC.QAEBhABAABIH.WDDEPDAF..IACEhAFACEHFfDCA.hAHA...,2,-27,-23,4
BdEQUeKaSWRZINLcgJDTYAOFHPXbCfVGM,ODCHFCFCHFFB..XGCHCAFBGBCGdBDFQAACKEAH.SHAAhACAZEGDIAAFhACANDAE.LEEF.hADAgAGEDEHDAEFGPEEB.fBHEhAEAMFIHBDAF....hADA...,2,-26,-7,19
cVOafLEgARGFXCIMdNBKZTYPeUHSWDQbJ,GBCHFFFBCGDG.MGDABFADKEFCZFBF..TGBG..eDEFSDADhAAADEBAQBABhAAAJHFEOBBHLBHFhABAAHABXAGA.IFHEdGHCPADE..hACAWDFE....hABA...,2,-29,-25,4
aAYedKMSPRVUBJNCgGEDTIfQZcOXFLWHb,dDCDSHBGRAEABGDG.CEFD.GEAE.DHFCIECC.ZACBXBAFhAAAFDHHLCAHhAAAHEFAAIEAKHGA.MEEDUACAhABAJAEEECFA..fABE.QBGDhACA...hAFA...,2,-24,-16,8
YAXKaHGWVRfCBLJMPFSEUZdbOTgIcQNeD,KFHBaGFHGECGRBFABDAB.LFBD.MADASGFHZAFG.dEDChAAAOCBG.TEFFhAAAgBCC.IGADhABANCAADBAAADBHWCEACEADFEFG..EABF...hABA......hACA...,2,-34,-16,18
CgVRfBYKFLaHdWMGQAZScbXNeIPETUDOJ,ZDAGSHBG..XCDBeEFHEDBBDCGECCBB.RDFFBACG.FHGAhAAAaAGFHFBDMEIDAIDE.NDAA.hAAA....IAGFhABATDDFJABA.fCHC..hAEA......hAFA...,2,-35,-28,7
gdAVIQXYJeUBENKFOGSTRMWfacPHCLDZb,QFDHXDAC.JEHDBFED.KAADFABDOGAEGCEB.SGBFhAAARBDFMICA.aAGEHAGFhABADECC..ZFFFdDGHIEAGhABAUGGAECBANADF......fBDFhBAACFBC...hACA...,1,-10,-17,7
NUdLRAJKVZFeQXPafgTSGEYDWOCbBHcIM,JDCHVBCFZGFA..eEEA..XBGD..PBFGaFAC.hAAAfDACTABCSEGEhABAEAABDIEACGHCBFCBhABAHAEBMICGdGAAAGGDKGDGFDAF......hACA......hADA...,1,-14,-23,9
SecUILYRWXAEJDbfagMdPBVTHOZKCNQGF,DFDCaHBG.dGDBBEDCHADAZBAECACC.GCGA.FAFESBHD.hAAAUGGGICFBLDDChAAARDAFADDG.EFAF.JBAFfFEBhABAMDCH........hACA......hADA...,1,-20,-33,13
MdBCLJYGZafNIFPTbUcRVOKWgAEDQSHXe,QCBFXCCBdBGALADCGFEBZAAEaFGD.....IAEChAAATECEUCGDRCAFKGADAFDFhABADGID.HFEDMICGJFBFhAAAfDHCFABFPBEF......hAHA......hAIA...,1,-5,-12,7
HKeCALPIOTVDRdUSQcNEXZagYGbfMFWJB,LGEAOGEADAGCUDAA.QCGDEABEZCCE..aHBGGACFhAAAMFAH.JDDBBHHBKGABAGFC.hAAA.TCGA.dBGBhADANICB.XEBA...bEFAWCAE.hAEACAGB......hAFA...,2,-21,-19,2
dQZTFPbJNCcURHaeVKDOgBfYWGSIAEXML,XAEDdFAGZDEDFHEE..JDEGCDDF...RGAEHFFAeBBG.KAABDFCABDCGhAAA....fADBhAAA..WADDhACASDHHIEHDMIAEQAGEhAEATBGF.NIDF....aEBChAGAgCAGAHHE,1,-27,-33,6
YPGVZeJXBOHSWCNAUgLfFcEKITaRdDbMQ,UDACLGEAFGDH.KFEE..aFFEDHAC.QCFCGDEHZACFeDCBhAAABHBEHACH.SBAGhABACHHAAFDA..gAAEhAEAfAFBEAHBIFBERAEF.MIFAhACA.....hAGA...,2,-27,-12,15
gfZSbAUEWPXCeFMNKOQaHLVDYTJIdRBGc,EGFCXCBCFDAG.KEFGQABG.LCFDVAFGDHGCTDCDhAAAJECB..dABDRAFGBGEChADAGADE..gDGBhAEAfFAASFAGAIDA..WFEGhAAACHHAMIAG...hACA...,1,-4,-35,31
PCZgUEeGKRbSLdNWYQIJaFVMTOfAHcDBX,DHCEXGGGZEBCUGFHGCAG..KACBSHDELAEC.dCCH.hAAA....NCIAQGBEhAAAaCAAMDIBOCEGhABAAAFABHAD.gDEAeDEA.bADG..hABA......hACA...,2,-34,-16,18
PYLMTKSNQBWfebIgZOGURcFEJDaXHVCAd,dHBHLGEAKCBB.SGBBBAFBeEAF..IEBCOFDAUGGHhAAAFDDDDDBGHADH.AEEC.hABAMBADQBGEhACA..WAFEfDGEgDGG..hAAA......hABA...,1,-17,-45,28
aQKRbZUTgSCFIVOLDAPBeNJXfEGcHdWMY,BAFBeEEG.JADBEGDA.HBCHdAAE.MIAC.aBHHKEDB.ZFEDUDAF.hACASBFDCGGFFHBG.hADAIABDLAHFAGAAPHEChAAA.fGGBGCBE..YBFFhBAA...hADA...,2,-36,-13,23
BbYOaNWQfPLZEVdAFTcCegGIXRDJHKSUM,TGBCCAFBGCFC.RFGF.JDCEHEAD..KBFEMFDDBCCF..bBCHaHFAhAAA...QDGFhABALAAFEAEBdDAEABCG.hACAeFEEIBBEDFIHSGADYAHB..hACA.NAED.....hADA...,2,-25,-2,23
BgbYLaSVdWTAURDCcFNZKQMeJHPOIGfEX,UFCADAAFCDBF.FAGFZCFC..MIBEHEFB.OGBCGBBH..EECEBCADhAAA...bGFALFHBhABA.aBCCSFFGhABAVAFE.TFAEAAEANDAA.KDEE..hACA......hADA...,2,-32,-18,14
DcISUOgeCREFJGBdWKVQfNLXZYHAMaTbP,aAGDTCBC..DCIBSEFGUGFA.eFCDEABGFGAFGABDBCDChAAAdEAC.VBFAQFDAhADANEEA.LAFDhAEAXGGFZEBFAAAC.MEDA......hAIA......hBAA...,2,-21,-6,15
GHNXECaIBLbMKTYPZQdJAfOSVWecRFUDg,SDCDVFDF.eBCCRADHFAFA..DGEAGDBCHDECEHDACAAC.aBGGhAAABBBDLDADKBHB.hACAPHFCZFFBJDEEADDFfHABhABA.cABBNDAE....hAEA......hAFA...,1,-11,-26,15
cTRIDAJaMLFfPKOSCeZYgGVQUHEWbXBdN,MEGFFDCDKEEA..CCECZBBFGBGG.UGAHEBFE....XGDHhAAABBBDdAEA..cGAAhABATGGG.DABAAEECJCAFhACA.LAHB.fFHESGEChAAA......hAGA...,1,-20,-44,24
PEDNRMLUOcBVaIfWQYCGTgeSAHXbJdKFZ,XFDHdDCD.ZCFADADB.MDIFUEAFBBGG..IADAhAAAQGAACHHDGBAFTFDGhAAASDDFAFFA.hABAbFFBKGGA.FCAFEGAHNAEFOHEC...hABA......hACA...,1,-20,-27,7
JBIDRWONLQUdHXTegbAfCKMcaZVPEFSYG,KEGDMHFGZCBF..VGAGEAEE..FDDGGBFEBAAC.DCDF.RABH.OHAGhACALAEC.dFFDTBGHhADAeECA...ABDGCHHHhAGAaBAH..SHEA...IFEGhAHANIEB...hAAA...,2,-34,-16,18
UOQFCASKdYNfVZMIXaWeDgEJBTRHGLbcP,dDAB..fFAFMFDGaGBE.eAAC.DEDDEBCBJFEBBGGA.HBFDhAAALEEC.cBEBhAAAOFAB.CHFGADEDSBCHhAEANDIA.IHGAWACE.RGAA..hABA......hAGA...,2,-32,-16,16
QaABdeWJbVDIHPTKRELgNGcXMFZOUfYSC,eCAFJGEA.DFCGHCAFKGAA.RDEALFCBGFDB.MFABZACEOHDChAAA.UCDDSADChAAAQAGGACGABCHHdDHE.hABAWCCG...IABF.EEHF.hACA......hADA...,1,-17,-20,3
EfZSNFTdOLKbcABHIQXVWGYMaRJPUCgeD,HDBHQCGCVDGDGBDFaDBG..JFDGUGGF.CFEB.DAGGEAGCSGBGhAAAFFAF.dFHChABA.KBBGAIDABAAF.hACAXACGMDAB........hADA......hAEA...,1,-18,-32,14
VDMfQKHUObdBEcGRZJLaXCISTYNWeFAPg,VAADMCHFKCAF.HBCCUFCD.dBEBEAGARDDE.ZGAELHFA..hAAAaDBDCGAB.SHGAhAAA.NBIA.FGGGAGEHDABGhAEAfEAHQFFDBHDD.JAHFIDFHhAFA.....hACA...,2,-28,-4,24
aFPMJWHGSZTOICXDYNVbQcKULBfERdgeA,aAFBFGFHMBFHHCAEGEFGZACH..OEBCCBHEDIDA....NBAB.bBABhAAAKHAEBDHH.EHCAdEDHhAAA.AGDAJDHF.SEADhABAIHHAYAFC...cEGChABA....hAEA...,1,-18,-37,19
VKRgcXDSPZWbUaGCdFeLIQOJBfEATNMHY,MFFFHGFGKECFRCFC...XAACDCEDZFABUGGGCBCA..FFAH.LDEEhABAICAEQGCDhACABAACAEHE.TEFDhADA.VAEESAFH....hACA......hADA.PCCD.,2,-38,-6,32
LcTKeXFVAgRHOCEBUYJWMQINZdfDabSGP,RGFGHFEEEHCE.BBHC.JBAEQBGCZBED.DDDGSADBhAAALAFEKBBC.FBAHAHIFCEHGUEBDhAAAMCGBdEHE.fEFDhABAGGAH..cDCB....hABA......hACA...,1,-12,-32,20
ATVOgFHEfGKLBeZdJPWYMNRCIDbUcaXSQ,VADGFDCDEABD..GGDBLBFHBEFAdEAA..JDAA..PFHBhAAAMCIHRDDFDCDG..UAAChADAXGAAAHBF.OHDAhACAfAHAKADC.ZDGHWFDACGCC...hAGA......hAHA...,1,-18,-22,4
PegGWSOTULMbKNAFcJRdYZQCEDXBVafHI,JCCHRDAGdHFBZEEC..QEFEDGGF.BHBDaGDB.HBBE..eBHFhAAAGADFOEAHLGAChAAAKBDA.ACHFcDDEhABACABCEACA....XBFB.fHAFhAFA...hACA...,2,-34,-19,15
LCRMZJVKGeHWAfTUbBFdYPQcNgaODSXIE,TCGCBHHGdFDG.QBFG..gEBFOFFADADEXCAFhAAALBAEMHFGhABAZEBBKCAAHAEAADIHUGEEhAAA............hABA......hACA...,2,-29,-28,1
FebTXGcYVIABRZQSUCgMfLDaHONEWJKdP,RCDHSDAFCCHF.MHFCLACB.aFAGHDDH.EEBHKGCBFBEEhAAAeFFDTACFGAAEhAAA..cGDHIAEAhAGAABIBZAGFQEGFfBBGDBGF...hABA......hACA...,2,-16,-13,3
XQONAJEeCaBdSIcZKFURGTYVLfWHDPgbM,EGDBaDABBFBCdBFG..SFGEZBBAFEEHGGAB..TGAFhAAA.VABFfGGGhAAADAIF..gEDEhABAMAGFOABGAGHHeDAFCDBAKFHB...YDFGhAFAWADB....hAHA...,1,-13,-30,17
bNIFEUTgLVQCPJMDZGcfXAdOWSKRBeaYH,OCCHSAFBKFGDBGDEeABCHEDD...NCIE.FGBH.EAFGgGFChAAAQBECPBABhABADDAD.GEBEhAHAXABAAIHGdBEERCGFaAAB.....bFED.hAIA......hBDA...,2,-25,-2,23
YaWgEFLHMZNfdbVKJBecDRIOPGSXTAQUC,CCAHaHBG..EGEEHCDBZBBF.dGGDKBECBEHH.DBCCRFAA.OAHDGEEF.hAAA.SBGDhABAAAAG.QCAFhACA.YHEAWHBAFCHDLFAEfHGFhACA......hADA...,2,-40,-7,33
bHYgDEAMFPQdUeRIfCJZcLBSXaTONKWGV,MHFGQGBCUDCH.RDEA..CAFB.JBAFLADHBGAG...aCFGODGBhAAAKGGDGAAEHFCDDCCChABAAHIHdBHA.eFBEfBFChACA.SAFE.NAIE..hAAA......hACA...,2,-29,-16,13
PKdJSMYBAeTRfDgFLcXbVUEGZHCONaWQI,TAEGDHCELCDG..XGCAUEECZBABOBBB.aDDGQFAGhAAAKGAB.JADChABAMBAHBGHCADIFfGHGhAAA.cECDEAGECECCNIDHIGFEhABA......hACA...,2,-34,-29,5
aSgXFGQANYMOTebfKcZWUdCJEPHVIRLBD,MCCAOFCA..TGBEeADHKDAC.ZFACdDFA.ECBBHGFERFGBLAFEhAAADABD..SBFAhAAAgEDFFEHHAEIDNBAChABAfACA.WEDECHDA...PHAChACAIBGCaAHF..hACA...,2,-21,-11,10
gBaIYZEJAdQPbFXOLDMcHGNVWUCRSefKT,QGBCFHBGOBGHLFFCMCEGHCBAGADEVGFE...UCAEhAAASDFBeFBEKHEEgAAHhAAABGAC.IEHChADAEHGAAAIFdABF........hAFA......hAGA...,1,-9,-15,6
GePFgLQDSATKZUbJHEWfXRIOCVBMdacNY,ZBCFUDACJHFGEGEC.....XBCEIBABCHBE.BAFC.MCEGhAAAaCGD....YAGDhAAAGEAHFGEBLACChABADGGCAHAEKCHB..WEEGfHBHhABA......hACA...,2,-37,-28,9
QBPIDOXJRGcYWFUSaNTbHEMfVdAKZgCLe,KCFCCFDDLAFCQBAEBDHDDCEB..JABCRDFCGEBB...hAAA...cCCHhAEA.FFFCSAEChAAA.aHGETGBFbGBAEGGCfCFFhBAAAFHC......hBBA...,1,-20,-48,28
DPRLgVdbfNEHOUTYGICaMSKAXcQZWBJFe,XCGCZEFHBBHCeBCEDCAA.LAAFdEAA....NBDDOECBhAAATCCBGFBB.hABAaFAHMIFAAIAC.QFGAhACAJEHFFHDE.........hACA......hADA...,2,-35,-21,14
CTdRAfUDEWFbYQBeGJagNXSOLVcMZIPHK,UAFBDGHHFEABQEGBGABG...aECDXFDALEEBMCFGhAAAZABAHCAF.CGABRCFEADEEEDHHhABA...YHBChADABHHE..........hAEA......hAFA.JECGNIAF,1,-19,-31,12
aGgOREUYHJLTXMKbdeNSZfcBVWQAPDFIC,DGHHCFEDGACGOCDFRGCG...UAFHHAFHLEADTFAF..KAACeBBDhAAA..SGFHhAEAfGCEBHHEQDFAhABAFDFHaCBH.EACH.XEBAMIAE.dHEFhACA.NAIE.....hAEA...,2,-18,-8,10
eKLQOGTfBJcDFMbWYPUEgXRSZNVAadHCI,aEHBCCAHKGEELGBC.GAEGTCEHJBBBFDCH....MAAChAEA..bGAE..PEBEhAGAEACBXBGBhAAASGGANIEB.AICGIAHDeFFE.fFFChBAADEBBYAEE..hABA...,1,-14,-32,18
NYLUZaSOeJdbcKDETMWGCARQHIVgFfBXP,QBBHHGFGVAACFFEABGBG...PEECLBGF.aFAHSABEhAAAJBEF.dAEFhAHAKDAEDBFBMIDECHEFIDHChAIAfFBB.NAIC.UGGE.eECB.hAAA......hADA...,1,-17,-19,2
ALWfYMeRJCagSNXBUbDcOVGQKIEHZTdFP,LGEA..fGDBMABDeFCHCBGAaAEASAEG.hAAABBHBbCBADADFVCGFKEFGhABAICEAZCFGFGGCAIECRDAAJFAFhAAA..XFBBcEEF.....hACA......hADA...,1,-17,-25,8
TGYcSAZLRPUeKOJdFHDEBgbMXIWfVNaCQ,ZDBGLFBBRAEAUFGDeDFB.OEDBFHAGHCFABEHD..MCBAXABDhAAA..IFEHhAAAfBGC.aAGAhABACHFD.TADE.YFFFAABBKCADDICAEFADWFAAhACANDAF.....hADA...,2,-25,-22,3
aKQDYNXTUfcLOVSEFZGbMJARWIPegBCdH,RAAD..IAFBeAEGCEEGHCFHKGGH..QACGDEID.XBADhAAATGGEUDAFLECBhABA.SFEDhAEAZGAGMIBEADDBPCFHBACC.......hAAA......hAGA...,2,-22,-21,1
BLaJfUCTAdMcRNQbSPZOXeDWYEGKIHFgV,dGFHMECGRBFG..QACGSAFEZFAGeABHDIBG...EGGFGCDChAAAIDHCFBAB.VADDhAAALAFE.fEAFhABACHCDcFFGNBAEODHDXFDB.KCFBBHEDhAEAaGBB.....hABA...,1,-3,-18,15
TOZGSBPWfLYEXDdbaRKFINcCAgUQHVeMJ,UCGCHABHMEEAOAACZFAGBEFG..fCFBEECH.DGHHaBDEhAAARDAGKBHBFGDE...IFFAhAAACHACAGAE.QADGhABAVCAF.JHBASGGAWFHB.XDDFhACA...hAFA...,2,-30,-14,16
EQZXeYadGITAWSFPbJVUDgcOBHfRKCLNM,SAFBFHBG..bEDBUGDA.DFDEOADDBHBCRBCELFHHhAAA.MDFGEAAFQCGAhAAAZCBHXAGHaCBChACAdFFCTGFEACAH.PEAA....hADA......hAEA...,2,-25,-19,6
DNQIfTSJZVERBbAWHMKFCcdaXgLGOUYeP,HFACFHBGCFCF.dCCH.aFDALEEBGAEHOACGeCEG..DBAGIEGAhAAA..TDAHhAAAZGDGEBACBHGFAAHEMIFEhABA..cAGB.gEGC.hBAA......hCDA...,1,-10,-38,28
gBYXFHCGTEaWAdMSVcZIeJbPOKLfNQRDU,SHBGVGFG.ZACBeCBE..PGBGKDGALBFA.hAAANGBH.QAFBhABA.DCEBBEBB.FACChAAAHCAFCAGDEDEAaDFAAIAEdFACIHHG...hABA......hAEA...,1,-21,-24,3
bNVZadRQCXIKcfFYDeSHLOEWgTMBJPUAG,GAFEVAAD.dAAHCGFA.KDCG.FFEFDEAD.HGBEOHBE..EADF.hABA.TEAFBDGGJDEHhAAAUGGFACFC....NEIA.hACAaBHF.XACD.IEHA.hADA......hAFA...,1,-18,-40,22
UVERgOFbCIPLaDNQcJeSAWGdfTKMXYHZB,dGAHKGFCMHCCHDFDBGHD.UCCGRAEAFDCFCAFE.LAAF.DIEANAAC.hABA..QCGHhACAeBFAAIGE.GEAE.hACAfBBFTEAC.ZEEEEHDA....hADA......hAEA...,2,-30,-12,18
egPYZKbADfGIMNBLOdEVCJTcUWaQHRSFX,DCECGAFEMCBHLABF.dGGDVFFBTADAUGBE..QFAEhAAASAEEeEDBhADA.PDHHKEGCAACHIDEGhAAABAHGEDDE.CAHDJCCFaFFB......hABA......hADA...,2,-39,5,44
aVMTeXfSIQYFZWNHRgDAOUECBbKPLcJdG,UAADCCEABFADKGBFLHBE..dFDAaCCBMCEE..eBFEXDAFhABASDDG.hADAQDGEFFGHZAFAHDEAhAEARFFDDABGADDF.OAAB.EEBB....hAEA......hAFA...,2,-28,-23,5
SgUBIHVacJPGFeRfbdQXELYTNCZWOKDMA,UGBCHDBHVBDH..aBCHJFFGGBEH.FHGAeBGBRDAE.fGAChAAAdEGFEACG.TABDhABAZFEGKAAD.DFDCAEFFBAFChADA.IHHA.cGDA..hAEA......hAHA...,2,-22,-18,4
NOAIHXMYLaQdBDJFbSREKPfcTgVZUeGCW,XFDHLCHDaFFDBDEC..FHBCRACDKHGE....fBEBhAAATEBAZAGBUACGCFGG.hAAANDEEADGDMIDG.dABGDDFHhABA.SGBEEFAB.cCBH..hAFA......hAGA...,1,-24,-31,7
NfLBJYUOeAMICbaQHZVEXgKRWdDGPTScF,MBFHCFDG..QAGFZADDEGAH.KBAGdDGBDFFFGBAG.SHBAhAAANBEGLEAFBHGChABAUGGGAHEC...ICFChAAAbEEEaAGF...XDBB...hACA......hADA...,1,-21,-33,12
cFaOYCUTZHbMKNRLfQJDEIVXPWBSGAegd,dDCDFAFBOECDCCHCZAAG.HCAFKFGC.LAHD.QACFhAAAEFFB.VFGFPBFBBHEHhABAABEF.eEEH.aDDFUGAAhAAA.MIEA.NFAD......fCAFhABADIBE.IAHHhACA,2,-32,-12,20
bCVWNJDIZBMgPTAEQfKUSOHReYdFGcXaL,QGBCUGBCODAHeDGH.dADHFGEHGAAE..aBDACDDF.VCCChAAANIDB..DCEEBFFEhABAMAIF...gFDDhAAAABHDfDHGKEEE.HFGB...cABGhAEA....hAFA...,1,-12,-33,21
QbgSeYdXZUTODCEJIWHFNAVLfPcRBGaKM,VFDFLGEA...fBBERAABaAFCKDAD.QEBA.hAAAbACBSCEChACA.eEBAdCHAZAFDUGAChADADBEF.JHBAICHFFEFFNAAEAFIDBFADgGGEhAEA.....hABA...,2,-15,-8,7
dMTEbgILSKQDJRHVeUFcNOGPZCXaBAWfY,...fHBHdGFHTAEHECAC..IGACSAAC.KDGFhADADDHDJEDHRDCHeBAC.hAEAFDAHOBFC.PFHDhAFAXGCEAFBBYBEFMCIH....hAGA......hAHA...,2,-28,-28,0
acGCdMfZNAOKIYgFEbHRQPUSBJTDWVLeX,KDCD..gGGGFFHFEHDE.REAB.UGAABFEA.DEDGLAFHhAAA.aBCGCCFGfBAFhAAA.ADIFIHCDhABAHFFFSAHFJADFTAGCeEDC..XDGDhACAdBAA.MCCFhAEA...,1,-17,-31,14
JgOMDUGFdbRYBASZKNQcXHVEeLaTCfWPI,SEHBZDAGKFFC.QAFEXBCCHGAAeBCBLFEEhAAA.TEAHWHEEJDFAhAAA...MBFCDCAHFHBAhABAdBAA.bCECBEEFABBDcGEBaCGACFCD..PACAhABAIHHH...hAGA...,1,-1,-20,19
ReLfcTFXWBVQdDCMbHEYaPGIJONASZKUg,SEHBUCCBeEGBLHBE..TDBEFFAABBADdGCGCHGEHADChAAAEABD..aAHHIAHFhABAOEDEZBDAKFDG.fEAGhAAA..WFHHDHDEMACE.hACA......hADA...,1,-14,-30,16
HTKObYZeQPcEDBRXaAJUFgfVNCIMSGLdW,UAADFHBG..VAFCCBDE..MIACGCCFLDAEHFEHKAAF.ODGDhABAZEEFeCGB.QFBEhABAPDABEFCABBHFhADAaGHD.AFAD..fGGBIBCA.SGEDhAEA...hACA...,2,-22,-15,7
JBgOWNXbHUFZdAMRCPeEfITcQLGVSYKaD,MEEDCFDD..ECGCTAACLACD.SGHHaFFFBACB.OEEChAAAXGBCHAFEZAECAFAFRBDBhABAeDFC..fGEChAEAIFCEcCCB.....hAFA......hAHA...,2,-24,-23,1
gRWVGAJUMObZHadLcNPQXCeKfESYTDBIF,UAFHOCHDZEFHdFCELBDB..NACG.QCAA.CCGD.hAAAfEEE.hABASBAHDIEC.hACAICGBFGACgFDCRGFCWAECAEGBMIAAaAAB.hADA...PBEDhAIAKFHB...,1,-20,-39,19
gadSMIeOALQNYWGVDPFHcbUTKfRZBEXJC,LDACQCBC..NDFE.GGAH.DAAGFFACHEGDUABAfAEFhADAZEGBBBHEEFCEXBFDhAEA.JEDGCCEFaHCGhAAASGGD.MBIHIHAHAIAA..hAEA......hAFA...,2,-35,-3,32
bLeCVAcYPBRIZDJMfNXFdEQOKGTSagWUH,...PGEAIDCFDDEC.MBAF..XDDCEGDCKCHDSBFBhAAAaHBC.UFFGhABALAHHCBBGAIHA.BCBChAAAZBDHfHBBFFAGOADC.TEAH..hACA......hADA...,1,-24,-33,9
EfdgTOLbBKaXUCIDGJQHWZFcVYARSeMNP,RDEDMEGFEDAG.dGCH..OHFABCFGKEDC..UFCACCABGABDJBBEHAGHhAAAFFAG.....hAAA.....YFHFhABAAEAHNACFfBFE.....hACA......hAEA...,1,-26,-45,19
JTISVdOBNGCHZacfPEbMXgFUKYAWLQRDe,LDACQFCAeBFHJAFE...SACHdBBFBCEEGEEEhAAACHHGaBHB...PFAFhABAMFFAFHEEUCAFKFBEAICADGIBhACATAACOCHF..NHAB......hADA......hAEA...,2,-21,-17,4
VKYbNDdgPXGFMOIABLUeRaEWCScHfQTZJ,LEBEeADGEFDH.CFFHHFAGQCGEZBCAKAHB....NAAEDFFFPADGhAAAFGAD..MDBCADHBBCAFhABAaHGA....SAGEhABAfGDC.......hACA......hAFA...,2,-30,-25,5
WNLTaABGQFRHfIYZbgSEMVOcXUKdCJPeD,GCEHRBCFHAAF...IGGGZDFHSGCBMEAC.OADGUFAHCCAFhAAAeHFEDDBG.LFBEhAAAaABCBHEBfHABhACA.gAGAEEEB.....hACA......hADA...,2,-36,3,39
ZYVEFWSRJHANKDGXePUCLTIQMgBOdfbac,KHFGXCCBUDFGLABG..IHEGQECBMDAHOHAAhAAAdEFHaFCF.ZBAFECCEhACASHAC.hADAJACGAHEEDBGCeBGHCBEABFACfGHC..hAAA......hABA...,2,-30,-24,6
JZgERGCWfVQdYHNUKDLMeFXAaISPOBcTb,aAFBSHBGBEGE...TDDGZDBCEFHFCAGE.....fFEFhAAAdCAGNBGGDFFHeHDGhAAAXACAACFF..IGHDhABAPHBCOAHH.cBBC..hABA......hACA...,2,-36,-32,4
LQbBeIRHfZKNUCFcWYGXaEJdPTgODSVMA,LDACBHHGRDFEZABEUCFC.CFDG.FAGD........WHBGhAAAYFBC..hAAAXFFCJFAF.dAFDhABATFFEDEBBMECBAFIBeDAAIHHHKHDE.cACGhACAaCCA....hAGA...,2,-43,-29,14
dMTCKcRIAVEbFBeSPWYDfOZXGLQJaUHNg,VDAGEAFBBEHA..SGAA..PHCEDAGCOEDFhAAAZDAAXABGQFGBhABAJBHDUEEFNICB.dGAFCADCKBGFhACA.RBCAADHBFHGA........hAAA......hACA...,1,-17,-28,11
GeTbEJUYKLfXgCDOZHRQAadSWcPIFVBNM,SDAB..WFCA..IHGEBGFAMAFEeBGHTBCChAAAbABB..EAFBJCHBhABAUDDFLCAH.hAAAXCFBCEHADEAD.OHBEHGAAAFGHaEDG..hACA......hADA...,1,-14,-34,20
gXBEdaDGIZNRJWSObKAHPfVULTQeCMFYc,HAADVAAD.TEAG.eFGBMAED.FGEE..gGDEhAAABHHBdAHC.DCCAIBFAhAAAZCEBJAHFSADChACAKFACAFEEUDGC.CDDDcGAC..aDDENEIE.OGAEhACA......hADA...,1,9,-29,38
YPIbVeZEQDKdGASUWOXBMCfLTRNaHcJFg,UGBCODACBFAF..MCDALAAFREEHHGBAJCFD...FDCBYAAGhAAA.IHHGhABAeDHDQGGGhACA.DGFBdDGHAAID.XDDFfAEDaAFG.hAEAPBBE...hAIA...,2,-30,-22,8
ZQTJgaeFKdRBObPYIHGXSDfMLUAECNWVc,CFEDVAADZBFA...QAFBJADB.eEAGKGGAdBAGBEHH.OEFHhAAA..PDFFhAAAIHDHGCBEDGIBMGAAhACAAIGE.ECDF.cGFE...aBHDFGABhABA.YHBG.hADA...,2,-35,-22,13
QcfdRHLYVFKOXaMEGZNUBJTWeAICSPbDg,SEGDDACBQEBEdGDFLCDHFGHB.KEAFaFDFGBBAUAFEBBDHhAAATGAHAEAFCHBC..hABAbBEF...fCGGhAAA.........hADA......hAEA...,1,-12,-48,36
FZcfSbadEeAVKXYROLINGHMUgWDBTJQPC,XCCBRFDFLAGBGGAHHBACMFCH.UDBHgCFFBAEEQGFAhAAACDBHZAFE.SDGAhABAdHGBEFGGeAAFhAAAADAD.KFAE..........hACA......hADA...,2,-14,-14,0
fSBEGZPLMXDKcCTIVaeOHWbgJdNRQYAUF,FGFCBFEDZAFEMIBEDCEH.KDHD..CEFE...TEAA..aFDBeCCAhAAAHFAB..bACCdBBChAAA.RCFEAEADSHGEhABA.EFFEPEHDcAGGOACG..hABAWGAGNICF....hADA...,1,-22,-36,14
fLXWeKBHUQdIcVYSMgZOERJbAPaGTFNDC,GEAHFGFCCECA.LDHF.eHAAKHBAHBDDQGFCdEGFVAFGhAAASCAB.MDCEhAAAOCBHJADAAGEBPFABhABA...aGDFDAGC.fEEDhABABACE.IBHA.hAEA...,1,-6,-32,26
XWcgRULDOBYPGJEaZfQMVdSbCeTNHIAFK,KFAAXCBC....gCEHREEGDDEEBBHCGAACEADCZGEEfGGChAAA.MAHHhACAdHAHbECFCDCG.NDIA.IGEGhADAACFC.WAEFcAAAODHF..hAGA......hAIA...,2,-30,-22,8
efCPJUTKXDFLgBQNWOYaSHGdZMAbVIRcE,VAADRAADeDHF..CAGG.JFED..UDDCKGAG.DIGELAFG.QDBHhAAAOBHDaGECSCFBhACAHFBF..hADAdFGB.AHAB.IHHAEEAHfADCXACAhAGA.BHCA...hAAA...,2,-33,-14,19
QZKDOIGLVgdTYMNURBPbWEfCacJSHFXAe,QAEGKGGEOFCEGCCFLEGH.VEEBdAHEMFAE.UAAFhABABBAB.PDBHEHEECHBH.hADAaGCF..SAEChBDAXGAGeAAEDDHF.IDDD..hADA......hAGA...,2,-21,-19,2
eQVPfacMZOYIAdbSNTWUBGXCKJELFRgHD,dAFBSHBG..TCAHBDCDXCFHJCHBFGBD.HBCEeFDBhAAAQGGH.hABAfGBBMEFHYCFHhACAAABDWBEEUGGBCFHEEFDCRACB.DCAHaEAH...hAAA......hACA...,1,-12,-25,13
dKLZSfaEBYROcICbPUgFNeAHVDMJTWXGQ,DDGBMIFG..TCAGGAFCdGCFZEAG.SBABaFGEBFAGOEEFhAAACHDBUCCH....FFDEhAAAAHHHJAECXADCKDCAEHAEhABA...RABE.IHBE....hABA......hACA...,1,-25,-28,3
cUIPgABFOCGYNSTWDdfVZRJXQeabLHEMK,OCAFCECDGGCH..SEGHDBDEdFAGZCGDRGDC..QFABhAAA.eCDEbBABEEDEKEDFIHHEhABAAIFABCDB.NACB.hAHA............hAIA......hBAA...,1,-24,-40,16
TWgRPKYdISLcVbMUCGZBOeQAFXaEfHNJD,XFCEaAFBHCAEDCEB..TBAARDFF.KBHBIHFDLDFH.hAAAVADFMHAGGDAFhAAABFDFQAGAhABAAHFDFGHBfAGCNDIE.JFAFgACC..hACA......hBAA...,1,-1,-21,20
cDaSBdHgbIRFGTNCOKLXMWPYJQfAVZUEe,ZBCDUGGDeCHBDCGDBDCGdCFAHFDA...IHFBGBBBCGACKFBFLCHFhAAA.MBAFhABA.....PEEHhACAJBADfAFF.AIAA.cGBEhADA.aAFESABBhAAA..,1,-24,-38,14
ZYLOTeWFaREDVdgBKMSJGQcUNICPXAfHb,HAADZAADLHBAeCEGaEEGDFIB.dEAGKFBG.SCCFJFBA.QFFDhAAAUCDA.NACD.hAHACCHGAFFC....fHBDhAIA........hBDA......hBEA.OHEEFAHF,1,-2,-47,45
dPUXECIKZHNQWAGbaVLJFfSegOcTYBRDM,aGAHJFFC..FAFEeDBB.OFFB..TDBBRGBADAFE.dHCDXBCChAAAEAAE..CFDBKADBhACANDIA..ACAG..bBFHfCGBhADA.SFAG.YDDChAFABEADMABA.hAIA...,1,-18,-45,27
QLURKVGMCYTSZDJHEWFPfIAcdBeOgXbaN,BFEDeEEGOEAA..gCDHaBGAQGDEUFBHKAHFMIAEhAAACADA...SBCGhABADEHHHBBHFGFDfGGGhACAIDAGAGCEXBFC..NAGE..hADA......hAEA...,2,-34,-20,14
TFDfaUKYJLWHVPRdOBICANQSeMbXgZGEc,SGFCMDEB..XBGBGDBCTBGDDFIHUCACKGDBLHAAhAAAHACFVDEAdCDFBGFEhABAAAAEeABFZEAEFAFBaCGH.hAEAJADEPHFC.IHAGCHFD.NDIE..hACA......hADA...,1,12,-20,32
IVSbfLDECZdBUWPYQTaNcJMFXgGHReAKO,OCCHVDAG...SABGLAHBCFGBdGBCUEEE..PAEDhAAATBCF..NHEB.JGAGhAAAMCAH..FHEEgEEEhACA.HAGDeACEAIEAKEGC..hADA......hAEA...,1,-21,-27,6
NcVWMgQdIfREUAbJSKTXBDeaOZYHLGPFC,SDCDKEHBBCDADHDCOAAE..HAFDLDAFGBAGCDDCVGCAhAAAMFCEdAHE..IHAEhABAEABEAGGH.TFGGhADAaEEA.ZBEC..PFABNEEF....hAAA......hADA...,1,-12,-31,19
UCHGQWfDXSKFJBAegYEPbcOTZaMRLVdIN,eGEAEHBG....PCAEbDDH..TBACaDGCLBFA.hAAAVEDGdADFIAGBhABA.NEIECCGHQEAGhAAADCEG.SABGKDFFFDCFACID.YHFEhACA.....hACA...,2,-21,-10,11
EMAcSCWRgdGbNBLQOHDKaIZJfTeYPUXVF,CFEDRAADdFAAGACGBGCDLCFCHAGF..aECAJEHF...eAFEUGDChAAAFGBGEACEABBD..SEAGhAAA..bGFEhAEAOHDAKCDCIDFC.....hABA......hACA.fDFF.,2,-23,-18,5
bKAgPYWRLQXMEHfdTSFaBCcOZeGVDJINU,...PGEARAADLEAA.MFGHEBDDdBBEFGEFBDHFCEACZAGFeHFAhAAADHAG..JACEUFCAKHCG.hAAAAGBE....WABEhAFAHBEA.fDDD.SAGAhACAOBFB.....hAIA...,1,-22,-26,4
ZeDPFSXOHaIdAYKUVTNfcgQEbGMCRWLJB,UGBCTFDH....fACAQCBAGFEBMICCRCGHLBEGhAAABADEDDFBFDFCXGGGhAAAaCACADHCKEDA..cGABhABAEEAECGAD.ZAFESABF.IAFGhAEAYCAFNIEF...hAHA...,2,-19,-10,9
VEcTPGADgLHYIUZWCFKbMBXaQORdeJNSf,DEFHLFBBHAFEUFAFCGDFKCAG.BDHA..QFFEdCCFeBAB.JEDGhAAASFHH.hABAEFDHcACF.TAGDhAEAAICEIADG..FFAH.MIDAaGGH.hAAAOEHD.NDED..hABA...,2,-31,-15,16
gKCZOIMSdcRYHQGTbaWJXDBPLeFNUEAVf,VAADKHBGOFBE..MBHDdDEDRAACHEEAGAEFaEBD...JHFAXGEEhAAA.DBEGPDHDhAAAeCDEFHAE.NADFAIDGhACA..fCCECEDC.IDAChABA......hADA...,1,-8,-33,25
IFXQgNJPaWHbBeRUZCVMDTOAKSdYfGcEL,dDABGAFELBBCFFBBQGGEJFDF..aEFGHCCBBHBHeDGHhAAAUBGHCADGDIEA.OABBhACAKHFC..SFGGhAAAfAHEEGAAIFEFXDDBNEAE...hAEA......hAFA...,2,-29,-12,17
UCOKMEZfLISbdAPWJRGFYTQDBVcHNeXag,JGEAGBCH.FFGCQCAFBDBDHGEEeAFHaFBB...CEEBOBGDhAAAMEABEDGC..LFAHhABASHBAdDDCAIDAWAAEhAEA..YABGDAIF..cDDEhAFA......hAGA...,2,-24,-22,2
RIAdOLVDMUBfPEKbcWFGCaZXQeHTgJSNY,OFFBVAAD.DDCCBDHG..EDFEKDCE....bDACFEFHCHCHZACGhAAAQEBC..hAAATGAEgAFGhACANAIA.IHAFdFCB.MIFAfGHAhABA.WAGB...hADA.XGDC.,1,-18,-27,9
JNYdZFfMHeTRSPEQcgUWXIAOBKVGbaCLD,KDABVEBHGECE.CAGC.DGGF...JAAFdHGFZAFBMBIBHDDERACC.EHDAhABAQEEA.hACA...UADEXAAFhADAABHHOEGFaCCCNBHA.....fFAEhAFA...hAIA...,1,-16,-27,11
FAdZIBGMKWVeOUSaRbDQLENCJfXYPHgTc,dCFCBFDDKADAeBADUFGARFGH..DCDDLAAF..CHDE.JHAEXCEAhAAAHEDF..TBBDhACAABFG..IHAAhABAMAFEOHECaBBGEFFF..fCGFhADA..YAFChACA.PCHD.,1,-17,-30,13
HeZgECFbKALJMdafcVTQWOGYSPXDNBRIU,MBEAdAFBaFFE..VEAGQDDF.GGCBPBAGDDBBBCDFhAAAUACFHDEB.gGCFhABAECGDCFCFKBADAHHEfHGFhACA.........hAAA......hABA...,1,-19,-27,8
fPWJFONHXMKGaAedZbDTScgVIBYECRLUQ,eDCHdCFCDEBG..TFGDSDCE..VGCABACBCBACRCECUFAEhAAA.QCGAhABA..WFADFFGC.HADAhAAAKBBGAHHEcBAD.IBHHYAEEEEFAhABA......hACA...,1,-19,-34,15
LfAHBcaKJNCdUSFVWgIObYZEQDGMXTPRe,BFDDaAFB.JEFECHFB..UCAGFBFH.....VCGF..IABEhAAAOEDEZAAADIDEGACEhAEAMGCG..XGBChABATAGF..PGAE.....hACA......hADA...,2,-45,-35,10
NSTZfPgFbcBGMIEKDQRAeJHVUCdXOaWYL,HFBGUADCdCABOGFA.aDEHLHFE.SEFETADGZCFEhAAA.PBBH.FHEChABAcAGBBHBDMDAHhACAIFFGKBFA.DFBBAAIH.eDBB.JDDB.CCHB..hADA......hAFA...,1,-7,-28,21
KNABLbSYEURfWOMFeZQJacVGDTXPdIHCg,BAFBSDCDECBARECG.OBCE..eHAGJFFH.aBAGGBGG.hAAADEEGXEADdAACCHAHKGCGhACAAHGBLDGD.hADA............hAEA......hAFA...,1,-34,-37,3
LBacCXgEOfWHYUbNGDZJeFRMKdTAQVPIS,VEFHSHBG.BDECCHEA..EABCOBBAHBEAUDCAGEGADAIHhAAAJEADFGBBKGDA.AAAC..hABAQAECIEABaDGAhAEA..XCAE.fCHGhACA.....hAFA...,2,-27,-22,5
XIfYeHdbLScgGKPZUJFCWVQOTMREDBNaA,XCBC..YCAFeEEHdFCCLABBSAHBGECFhAAAZGFEFBFCCHEBQDGFhADA.TGGAEACCBEDBhAAAACEEfBGBcDGAPFABJHAG...hAEA......hAFA...,1,-12,-17,5
SIUXJbERQZKAdeTLWcHaMCFgYPNGVfBOD,dGDDeFCALBHFHCAD.MAACFDDC..gAFF..PFADhAEAGAABBFDBDFHDICHHhAAAXCEGJBBBhAFAEGFF.QGGCABHC......hAGA......hAHA...,2,-31,-13,18
BQMFNLgOJKTXRZAUVEPceSDbGHIdWCfYa,EDAFeGEADADGGCBD.dAEBCBCA...aDGCQCDHFHBC.LEEAhAAAOAHFKEEHTGGEhABA.ZAGDAAAFPFBChABASGEC.IGCGWCEEBHHGMIBC.hACA.NDAE.....hADA...,1,-21,-22,1
NScbJeAFDYdVLCaBZTGOgQUfIWKXRHPME,FHFGDGHHdADECAFG.BHFDGAGE..OBABUFCE....IFGHhAAAKHCGHBFG.EDBBSEDEhABAJDDD.AEIBLEABhACAaFAH.TACGfFFE.hAEA......hAGA...,1,-34,-39,5
QMeWKbCaZTHVJSAcgfFIYGUOLDRNXBPEd,...fHBHIFEDGADGUCAFOAHFDGIDRFAFBAGA.dDGFhAAAeBGBKBAF.aFFEHDAChABAVDDFAFHCFHEALAAEhAEA.NEIEEGAAMFDFCAFC........hACA......hADA...,2,-19,-3,16
ZBYWDIUPeSfMJXKdTRQCLgGHbFVAaEONc,aEEDOCCHZFCF.BFEGDAIB.UGBE..SCEAMHFG.KBBBTAGFhAAARGFA..CHBBLDAAhAAAGADCFABEEAGB.hABA.YDHD.IDFAfBDBhABA......hACA...,2,-36,-23,13
cBDgSTXUCVKQaWdMHINPEZObJRAYLGfeF,GECFFDCDDACE.SCADUEGG.CCBAKAABQBGB.dGDEMBGFhAAAHBAFIHCDhACA.EGGGbGACAAHFfHFBhADABEEB.XFBCaBFH...NBIA.hAEAOAFA...hAFA...,2,-25,-23,2
ZFYMCKUABDLbITfJRgOPXQGdcSNeEaVWH,LFEDTCBC.RDBGOCHFQDGA.GGAHSAAFeAAGVBEDhACAZBCCMHAGCEAGAHHFDGGAhADAIADC.fDGEhACAgAGBdHGFEGFB..aAGG.FFAG.hAEA......hAFA...,1,-6,-7,1
MREebOVGAXSdQCBNTDLWgIZaYcFfJUKPH,SFHBdFFBCBEEBDEA.DHEGLHAG..IBAAZCCF.aBFGhAAAFBHHUGAAKDAHMHEAhAAARCACeEBA...bCEAOACGhABA.AEGG.NAEF....gEFDhABAfGBF....hAGA...,1,-12,-42,30
CPORcafGgHWKNYJQEBeDAXZdTLVUMIFSb,dDAFLADGUAGAFEGBSAAC.CDEH.OGDCREFH..aEABGACDhAAAHBBDKCGBJDDEBCCEhABAAIFEZFCB..MAIF.hACAIHAFbFAD.fFHANEIC..hAEA......hAFA...,2,-27,-19,8
CaZBfGRUYMIXSVLOFdbHeEDWJKTgAQcPN,QCBC..cFFGCFGCZFDDBAHDGADGRFAD.UDAD.IFDBhAAASCGFLHAChABAdAEEeAAADBFCKCGEhACAADEBNCIG.fHGF......hADA......hAFA...,2,-27,-27,0
LAXSGBEYcVUaZdFJIgeKNfQOWDCMHPTRb,SCBBBBCCEHEA...VEEBZECCdDGFFHGA.JAFB..eBEEKEAH.hAAA.QGGChABADAEEMCADPDFG.RFCBABAGhAAAXCAC........hACA......hADA...,1,-22,-39,17
eAQJWTRUdNKbDZVXOECgLHISYBGPcFafM,QDACJDAC.RGBEdDGEKABEDAFFZAAE..OAHDCGAGLGFE.hAAAHCFDSEDChABABEHDGDDEFGGEaAGBMIDGhAAAAAECUGEE..NAIE.XBCA..EBCAhAEA......hAGA...,1,-5,-31,26
aTdKYJVXQWZSPADBFMeEIcGHLCONbfgUR,DFEAMAEEeDAC..EDEFGAFECGEH.OHFA..fBCHhAAAUACGaFBE.dCGFJHBGXEGAhABA.WCADhACA.ZFBBAAFFIDEELCBAgGGEhADAKAAG.....hAAA...,2,-33,-8,25
FSEOgQdIYHeLaBMTVGNfWbXRADZcJKUCP,ZFDGKDCDCEHCSAAB..EADHOFHFQEEDdCDCHFAFLHCEhAAAMADCGAGEhACA.fHFBhAIAWAGDXBAFADIHDCCHUBEEFAHHIGHD.aFBChABA.BDAD...hBAA...,1,-4,-24,20
QHEFagdSAGbCTYcWNJeULRfKVMOZIDBXP,GGDHTGGG.......cDBDJEDEUEBCLDFEKACCOAFEhAAAIBHCBHCAQABFhAAAFBACdCDFAIAA.CBEDNIABhACAeCHFREFAMAEE.DIGA......hAIA......hBAA...,1,-10,-30,20
GgQFARVBEcXPMbdWTOaeLZKUIDfHSYCJN,VFGHEEGD....PBCBMCBEdDFE.OGCAaCGEZEAE.KBGCDBGChAAAHFCGCDBA.GAEEhAAAFACCAEDHBGABXGGA.hABAWHAALHCA.IDHCYBABNAEF.hBAA......hBBA...,2,-30,0,30
FfbOSWQaXELRcVGePZYgBdUIDNKTCJMAH,HDAGFHBGOFFFSGAC.QADGXCDDLADAhAAAVGDEeDFGZBGDBCBF.UAFChAAAIEAADBBEKEDGCFCGACAGhABAfHBBaCAEEFHB.cGGE...hACA......hAEA...,1,6,-26,32
cbTVZGfAXURaCMIYWHQDLJgBEPdFSNOKe,UCCBCCAH.MABE..IAGEHEBCLHAGJBEB.BFGEdFECSFGAhAAAKGEFeBGH.hAAA.bADAZEAD.AHHDaGDHhABA.QACGDCBH.PCHBOCHD.hAEA......hAFA...,1,-14,-34,20
WNKPDUAgHEdTBGOaSLMQVJZeCcIRFfYbX,HDAGdFAABHFHOGFGLBBEMBCC..QGAAZDCHeFEHCEECIAGAhAAA..FCGHfGDDhABAXAEBKAGGhAAADFFCAEEDEDAEaCCA.SDFC...hABA......hACA...,1,-11,-31,20
HLKJgUTFOQCDaMeSbAIERPWZdBYVGcXNf,ECFCRAADZDEBBEEGGACF..XGFGHDCHJHDEUFBHFCHB..QFAEhAAADCDFMABGSADAhAAAAHHB.PBBDhAGA...........hACA......hADA...,2,-34,-22,12
QJRUNfCZEDSIVBbgLaWTGYMdcHKFeAXOP,XDACODAC..QACBJEHF.UBGACFEFZGACEFBDDCGDSFGDhAAABACGLBFChAAAaHFC...TCCDhABAMEEEdFDHKBBD.AHAAPEHDNIEF.fBBGhABA.....hADA...,2,-34,-8,26
EfXSYLcCRBOgVATUPbHIaeGDQZMNdJKWF,TCGCUCBCHBFH.aEHDeACB.QGCFMDFDdHFF.KFGGEGAEfADDhAAA..hABASADGcAGFBGFGhAFAOAHFADEEPECAIABEDBBFNIEF...hAAA.JEDB....hAEA...,1,0,-24,24
MfYVOUBJEWSHcIZLCeGaKATQFdbPXDRNg,TFCAFFHBdGEA....XCFADDCARGEAMEID..VDBEUCFCBABChAAAEHBEHDAFZGAACAFHGBCFhADAKAEFADAB..QABDhAAA..NAIEfEFE.hABA......hADA...,1,-18,-20,2
XaZbMfIgSYOERNeKVQFLHCBJUDGWcTdAP,aGFCZFACMBBE..IAGCSGEAEBDG.RDAE...KDGEFDFECEAFBFBBhAAADAAB.GCBHhABATCDFAGGG...PBFAhABAbEFE...fHAB...hACA.OHCCNIEF..hADA...,2,-31,-23,8
TAWFBDVXJOacHCYZSLEPfQMbdGUIgNeKR,BFEDDEFA.JDHHaFBB.HAAFZADALFFH..PFDHMAFEdCEEhAAAUGGH...NDEFKAHFhAAATCAAAADF.FHCA.hACAODCFCFHFSAEE.EDDD...hABA.fBHEhACA...,2,-35,-20,15
CWJIBOaTdLMeRVFcGHEDQXZYfKUSNAPbg,...PFBBgADC.CDAC.IFGGBGAAOHFAdGDCMACFhAAAeECFRAFGFBEHGAFEDHECQDBBhABAZDGBKFEFUCCBhAAAADAB............hABA......hACA...,1,-18,-22,4
ASPGZQFEBaYIMJDNXcLHUfCWdKOeVgTRb,GEAHFDAFEBCC.BACG.aBGFMAAE.DFCGXGDFLEHFHGFAhAAACAGD.KBDBOHCG.hABA.eHAETCECAFIBSAGEhADAZFFF.YDDGIHAA..hAEA......hAFA...,1,-12,-32,20
EXOVRgSQDFLBAIJZaPHeMTUCfWKGdYcbN,JFBBZDAGaFDDHDEH..eFFHMEHF..TFADCAADKBCG..GAEFhABAdCFG..bABEXGFHhACAOCHF...gDAFhADADIAGBCACIHHGfEDE...hAAA......hABA...,1,-16,-25,9
SAGeQYMTPZOXWFdaBVIHgbfLCNURcJKDE,GDDCeDACQFFBMAACZACE..OGFEFFAHBBFFHBFF.fHBFhAEACCHBNABD..RGCGKCGFhAAASAHHAGIB.hAGAYGAEPBBGXECAaFGA...hAGA......hAHA...,1,-12,-18,6
AMRGWCDgfeTQHbEUJIPXVaZFNLdYcKOSB,GGCBCAEDDDDH.eCGDHGFAEADEUAGC..IDDF.XBAGhAAAaEEEFCECLBBFhAAA..cGGAhABASEHHBBHAMFADRFAH.fECEhACA......hAFA...,1,-23,-31,8
cOgEPSMbGAVBCYdHRQJWFTaNZXfDILeUK,CDCFdCFCHFCFJEBG.FDEH....aEHFXCAFDCAC.eFAFKHDG.OAAEhAAAEFFD..MAFEhAAAGCGEBCDGRAECWGFAhABAZAEA....IDAE....hABA......hACA...,1,-9,-45,36
PBdWXUbMJESZLcKVfITYONHCDgGRFQeaA,dEGDXCGCUFBD..MBACSGHD.LFAEVAFC.ICDFhAAAOADDCCADDGFFRCEF.hAAAQBAD.hABAABEEBHCAJHEA.EEGC.KAHHfGGDhACANEEA..gGAFhABA..,2,-34,-9,25
MXAQdJKEBGCYSURcHaNLeWDbPVgIfZFOT,QGGDdEEDJCFA.KGEDBECBGADA.CAGH.SAACUGAGRAACHDEBhAAALAFC.eCBEhADAbDAA...VFGDhAEAfDHAFHEC..MDBBACCB...EGBFhBBA......hBCA...,1,-4,-27,23
dcDRbgMABJYIXGCVPQZWFKUeOTNSEafLH,BAFBJGEA...XACAVBCH.ZDGFKBFCUAAE..eCFB.hADAOBAHTDCFSAGEhAAAaHAALFEHHEAFhABADCFB...........hACA......hADA...,1,-33,-35,2
EKdJLZOSCgFAcXYDbGWReVaQMUHfPTNBI,XCBCDACBGDFCRFDF.eDCD..aCHHMDIDHCED...PECHhAAANAHGBEAEKACFLGCAhAAAOAFGCHFGABIF..bADFQGGAhABA.fEAEIGAFEBABhABA.JAFBSBHBhADA..,1,-1,-21,20
FeSaXfgBOLRWKCHYQPVTbIMNdJGEZAUDc,UAFBDGHHeBDC..aFDD..XEADBAACLDGFRBBBKACECFDG.QBCAhACA.VEAFhADAIEFF.MAAFhABAdHFD.ECFEAIAASECBOHCG..YAHHhAFA...hAEA...,2,-32,-24,8
IOYgZAQMNJHdETPcSaKLbGXUVFRWBDefC,MFFFJFBBHDEHdBFG..EGGH..TGGE.SDCBaACBKHCAGEABhAAAVADB.FBHBBGDBhAAAeDCGCCAAOAGB.hABA............hAEA.gEGChAFAAAHCNCIA...,2,-28,-18,10
SPOQdRVKLZaIcGNEFCUYTAWXeJMgBfHbD,XDACMBEABFFBHFBFDIGE...OFHHQEACdBCCREDEKBAHaDCE.hAAAGAGE.EDEEUGDGhABAAGAA.JCHF.fACChACASGDHLCDC.IGHFhAEA.FHAACBFC...hAAA...,1,-13,-16,3
SCPYfUBQMAXRDKIJTFHOWbEgdaeZVcGNL,XFCADGDEKDAF...JHAETEBH.FBBBOBBD.ECFHdHCDhAAAeGFAVCDG.GAGEhABASFAF.PADDhAAAUGGGMFFAADAHIBAF....hABA......hACA...,2,-35,-21,14
bPegHKRWfVTMaIOXQESAZNDCGdcLUJBFY,DHCECFFCGCGGdGAGUCDCBEBB..FADE....PBACeBBDHGFAhAAARGDE..VCDAaEGC.hABAOHAEECGC.ABFE..hACA..NDAA......LAAChAEA......hAFA...,2,-32,-24,8
LTNHKJRWVcXMAeGaEIbPYSZBfFdOUDQgC,GAEGaAFB.EGGA..IFHA..YABFSFEDhAAAfACHOEAAUBAGhABAgEEGTBGFKHCChAAA.JAHF...WHFAXGGGAEBA.PDDAhACABDGHDCABQGBChADACGAG,1,-25,-28,3
IGgbBMPVXARZKTHaJOUNLWEQSYdFcDefC,ZDDFHBCFOAHFLFGF.QAAESCBHdFCADIEECHABIAGGhAAAGGBBBGGF.VBFHhAAAAHEH.KFBETDAHhADA.aEEDNEAG.ECGAFADF.fBAGMAFF.hAEA......hAIA...,2,-15,-8,7
gXQLRBFaVEMJZSKAeITHUbGdNfWYCPcDO,eDACHEFHGCDCdEFG...fFBGCDGEDFBB.OAACQACChAAABHEAVAEGMAIBSAGHhABAADHGIHAHUDAFhAAAWAFF..PEHD...gECHhAEA...hACA...,2,-24,-12,12
IdHfYMXUeSVCLTOADEFcPbBJNQKRaGgZW,FGCD..PFBBBHHEJEABKFCCGFEB.ZCDGdCDAHBBAMBDEeHDEhAAA.CAFD.LFEAhAAAABAADAIF.ECBG..NEEBaEABhABAICFF.fBHA..hABA......hACA...,2,-48,-7,41
caWbRHQfPBVFdYECeLANIDJXSKOUGgTZM,DACBXAADKEFDGBEHZADB..MGCC..aBAFREFEQBGChAAABHEGdFAGEDDCCBFDADBC.JDAF.hAAA..OHAETGGEhABA.bFBDfGGEFADC..eDHD.hACA......hADA...,1,-13,-21,8
CHeQLRfYOBMVcSJFUaKXIEPdbgGWTANZD,DHCECEFAHFDHLFEERBEG..OABDVCBD...JHFAaGBB.KABEXGAGhAAA.EDCHbAEDhAAA.GAGEAHDB.NEIG.hAEAeDAB...YAFC...hAGA......hAIA...,2,-25,-20,5
QOUHIXaSJfCDYPTZWeANKBcdMgbFEVGLR,BFEDdGFHMHBCFAEFGDBELAAC..QDEBOCFGUEBCHGFEhAAA.aBHFSBBGhAEA.CEGCDGABTABGhABAeAFEAIEGNDAEKCDG.........hADA......hAGA...,1,-22,-24,2
fNcWBIedMPXYRTQFOCVUSDgbGaEZKHALJ,LEEGJGEA...fEBDNAFE.BAFBICDBeBAEMGDEhAAA..PBGDhAAAYEHBQGAFhABACBFGSCAFDIFGbEAEaAHFEBBHKHBEAACE.dDDB..hABA......hACA...,1,-19,-31,12
OfCFKJQLNPBVMDUcWZHYbXEIdeaTSARGg,REBHOFEFFDHB.KGGBQGGDLBHFBFADDBFG..UCDDZACGHCDFhAAA..XAAFhADAdFCATDAHAHAE.fHABhABACGEE.NCGE........hAEA.MICA...hACA...,2,-36,-22,14
HYKdSNcRJXUTaQBGDEWLbZVfAICePMOgF,CAFBMDEBFHGE.HAFC.dABBSBHHRDFB.UEACTGAH.BDCBhAAAEAAFLDDBhAAAZEAAAIHE.eHCA.OBDChACAKDHBNCBFJHDEXDFG.aAHB.DFGE..hADA......hAEA...,2,-22,-14,8
aMDBGbKWCeSIQJfZTLFPUXEOYVAgHNdRc,HAADdCFCaGBHDFFH.BHBDKAAH.CHGD...eCHDSBFDQACChAAAZEBAFADHUFFF.XGDHhAEAECGE..OAFGhAAAADDDNFAF.MEDG...WEHFfAGFhAFA.....hACA...,2,-34,-17,17
DPMcAETXgbIGBZHFfYaQLCKJVdOUSWeRN,EEHBTCGC..XCBB..gABDGFDHZBEAfFAChAAAaDAHQDEHhAAACFDCJBDCdHBBSGADhABA.RFBBNIEHDHGCMACEcGEBADBHBDDC...hADA.YAFC.hAGAKDDA..,1,-2,-20,18
eNaHVbCMSUYfDKFWAJIGgQLPBTcREXZdO,GECFQDACLEABBCHAREFBXBDHZACBdAAC.eACCHGCACABCMIEGhAAASAGA.UGAEhACAfEHADIFAKEDBAHHAhAFAgAFH.TCGAECFA.aGGC.hAGA......hAHA...,1,0,-7,7
DObcKSgVPRWJeTEIYBFAMHQdXfZaUNGLC,MEIBdDAFZFDFUDDBGACGLABACFFD.DFGFOEAD..KCAEVAFFhAAARBGF..JFAATDGAhABA..IHAGhAAABGHDAAIB...........hACA......hAEA...,2,-40,-28,12
egYcGPAFMOBNDKWHRQZdIETSLbfXJaVUC,OECCBAEDKEFDRFGDZGBAdAAB....ECCELAAA..XGBAhADAVAFECCDB.eCFE.hABA...gCAChACAYEHH...cCGDAEED.MIAEDDBHQGEBhAFASGDEfEAFhAEA,1,-14,-47,33
bRASPIWVKBHDOgQXFCYJZaEdUfcLGMNeT,SHBG..PEGHVBFAHCBGOAHBQFFEhAAAFEABCBDDZAAF.dACDUEDALFAAhABAMADA.NEEC....hACA............hAIA......hBAA...,1,-9,-43,34
ceAJEWXMagFTbNDBYPdQRVIUKZHOLSCGf,EDCDMFFF.FDCC..NBCB.DEFEBDHA.dFGBVAFE..UGDCHADFhAAAOABHCDABGFAFeCFHhAAAADHE...JEADXGGHhABAaBHB...gABF..hAFA......hAIA...,2,-31,-24,7
MfAQHdcbZEGJDRXTYgOVKaSIUNCFPLBWe,dDAFZAADJFCGRFGD....TFBCOHFEKDHB..aEAG..SAABhACAUBGBFGAHBDEDhAAAeAFGAEFA.QACEhAHA.bFDBEEHDDGFBgACCIDDCCBFD.hAFA......hAGA...,1,-11,-39,28
ebJKTQUIPGNgXLBYOAMRcfdHSZEWFDVaC,MECGRAADdDCAZGFAFAAD..DFBBCHDA....eBFFKBDAUGFGGCGC..hAAA..XGDGhAAABFAC.ADADHAFDEAHBaGADJCHFhACATADE.........hADA......hAEA...,2,-36,-22,14
EVNGfXLPMKCeHYORQgbBFADISaWdcTJUZ,DGHHSAFBdADE..TDDDJDCHZAGD..EFAEGGEHLHDEhAAAKEEFHABEOBHHgBDAhAAAFBBBaFDE...hABA..WCHH........hABA......hADA...,2,-29,-24,5
YcLAfTCQMDNOZJGUWIFgHeXPbdVRBKESa,CHHGDIBGZCADUFGF..FDGBeCFG..XFFGdDDCBFEA.KFAGaBABhAAALHEG.ACCE.hAAAfECB.hABATGAGNBCB.OAEF..WGAAgAGHhABA...hACA...,1,-32,-45,13
MYIHaJOFVegQRBENTZbCGLDUPdWXScAKf,KGFHMCCAHEEA.aAHBFFFA.eDEARGBA.BBABEAEA.ZAEAGBCGDIBEUDBGhAAAdBABSDAFhAAA.AFIB.IGADhABAOBFD.VFDF.NAIE....CACC...hAFA......hAGA...,1,-10,-25,15
JMQURXIGfecCTOHAbdEBSNPWZFDKgLYVa,dAFBEEHBBHDDSFFE....PGAGFCFCDCAALAFEhAAAaGBBMBAERBDBGBBC.hAAAeBAFCCDBOEAGAGGE.hABANIEB.KEFD..YGEAVBFE....hABA......hACA...,2,-38,-8,30
ZgEWJBFeCYUaXMLQSDTAHNORVIcbKdGfP,HFDFOFBBRDEG..VAFC..ICCCKADBdHGBGBAGZACAEGECBEDBhAAACDCA.aHGALFFAhAAASEAC.AIGA.cFAEhABAfDFB.WDHB...FAGHhABA......hADA...,1,-8,-32,24
PLEUGfWSQVATbYcMFHagBCRNdOKZeXJID,TCBC..YBDGFACCHBFA.aHEEBFFC.CGDE.RDEDOAFAhAAAKCGBeCBG..IBAHhABADIGCEFAF.GEAAhAEAfACDWFHDSEDDAAAFMICAdEAB...hABA......hAEA...,1,1,-40,41
FAYCSfQIJUdTaGKHNVLREcXbDOBPgMeZW,SEGDQCBCUGACdGDFGACGHDEGLBFGEFBB.bADBDEIFhAAABFGHPHFC.MFAHhABAeFFDZAECAAAAfHDDhACAIEEB..aCBHNDIE.cCFA..hACA......hAFA...,2,-14,-2,12
FPXGZNLebCVfHgcaMKRQJTEWAOIUSYdBD,ODACSGFCBHFDDEAFFEGAGGAB.ZACGeFCD.CEECHABEhAAAgCFE.MIDAhAAAKBFAQGGEhABAECAE.IGAHYDDBdFDD.NADF....hABA......hACA...,1,-17,-26,9
aTBHdXeROcGQJVYSEWMPCfDKZILUgFANb,aHBGTGDCBCBE.HFEBeDDG.RBFG.OAFBGDBEQECGhAAA.JABESACAhAAA.EGGG.MIFAhABACHHCfAHADCADKBBDLFFCgEGH.hACAABEFNBAE.....hADA...,2,-17,-10,7
TAHIMNEdbcaBZPOFfKGJeXCLSgVYQUDRW,HFACMCCAdEFEaBDHBAECZCDG.FDACGFAF.JDHBCBBELGFChAAA.SDFDhABAgAAFVAFCQDAFhAAADEGC...WAFGACIBEHDEPHDA..hADA......hAEA...,1,-16,-21,5
ZJbKICVUeYaXdcFONRBPELDMWSgGTHfQA,ZFDFKDCDCEHCeBAF...aBDGdBFC.OHBARCEDBAGELCBEDFGB.hAAAMAACSDHFhABA.TCBFfEFEhAEAAIHE.JFHDVFAHUAGE.XGED.hACA......hADA...,1,-24,-26,2
ELFORaBGfDQYcIZVgPbWKTSeAXJCMUNHd,JGFAUEBCHDBGLAFCFBCB.RGDABHBCDADG..QGBE.hAAA.IBDBZBFCPAABhABAbABF...KAGESEEFhAEAAFECCEHH.MFFCEHDE.aGGA.fDFDhBAA...hACA...,2,-25,-24,1
JTcOCUWGaAfdHXRbPgEQYIKNDMSFeZVLB,dCFCXBBHRGFE....bBCBEDGB.IADDDBFEFHCC..ZECABGGHhAAA.JEEBTEGDhAAACBGAUFBDGEACAABF.fBAGhABA........hACA......hADA...,1,-19,-42,23
EARUeMVBaZSdcHILKJOGCPfbQYgFTNDWX,UBDGMHACBADGZDAFdCFAHDDFLHBEKAGAGGEH..CAGC...hAAAPAADQEGAhABAFFGADDGG...EFAEAHHFeEEBhACAaCBD.IBBE.JAHBbAEF..hAAA......hACA...,2,-21,-17,4
WSPfJIbgOGRYFMTeNVEQLXABcDZUdCKHa,BAEDZFDGCDEGHDABSGDE..JBHHIEHB..gAEHhAAAOEDERAGFFGABMEHHhABAeCAD..EBCAXCCBhAAADCAH.dABBaHAE......hACA......hADA...,1,-24,-32,8
SYRHAQDfJKWNVcGZFEbdMTLeaIgUPCXBO,QAFBDEFHKHAC...VEACGBFAEAAD.MADALEEBeEBEaBAChAAAUDGH.CHDGBADEhABASEHH.RFBEACDFJCCGhACA....NHEF.FGGA......hAGA......hAIA...,1,-17,-27,10
MNfWTGedYPBKQbZAXgSacIHULVDRECFJO,SGFCaHBGHCCCUEGADFFG..RDBG.ECFGFCGGMBBG....NBDB.hAAAfGFE.hABATDAD...hACA.dFAHPFBCKBBAbGAAAAIHXAFA.hADA......hAEA...,2,-39,-6,33
QCVbBgeAOPcaLISFDHNTUJYEGKdMXfRWZ,OGEAaHBGLABCFAEDHCBFUCEC..EDFDdAGD.MGDARCGBZAAGCHFH.BAHHhAAA.AGAA...IBCDhAAANHAB.JEHB.hABAKCGGfEDC..WFAF..hAFA......hAHA...,1,-20,-33,13
IfbNMJgGBaeUVQOdcXADWPRTLEYKHZSFC,DACBRAADEDEBHEBB.SFGGCHEF..IDHE..NBIAMIAChAAAGFBBBBFBUGGEhAAAQDFDdDAHAAHGPBFEhACAYEEF.ZADHfACFJBAHaAHB.hABA......hAFA...,1,-16,-21,5
ZSAfEbcTOJDHCFUIaGgLXdQVPYBMRWeNK,EHBGTCBCDAFE..HABHCFBF.FCFHUAFC.GABFXBGBdCAGQGDAhAAA.VDGBhABAYEDHBHHH.WFHFhAAAKDEFACIB..cEAD...OBABhABAIHBAaFFH...hADA...,2,-31,-11,20
YdWZSQPLTKVACUeHXfBgbDGaJIRMFEOcN,UEBEHAEGBCBEDIACGAGGJGFG..MDEHOAAF....NBAEdHCHhAAASDFB.hABALADETDGGAFFEeFEBhAAAfDCAaGGC.......hACA......hAIA...,2,-32,-30,2
gMeEHWLVbFJIPBcaQATYONZdDCKXSfGRU,TDACOGEAZCGB.dFAHCCCDKBGF..XCEHSHEA.RFCFUADHhAAAMDDHEABG.LAEGhAAA...hABA.FEEFIDAA.BCCCaAHFABBFNIAFDGIDhADAfFHG..hACA...,2,-39,-17,22
FgQfeDBRANJGHdaWOEKISPCXYZVUTcbLM,GECFHFEEaEEAEBDCKDBB..SHACCBFC.ZFACUBBF.TGAHhAAALHFE.FAAHhABAfAGDeDACRCEEAIBC.hACANABFdCGFWADC..OEHF....hAIA......hBAA...,1,-4,-22,18
QEIDXNKYPZALBfedcRbGOUWHTSCaVJFgM,LAFBBAFBdHDBRCCCOHBEHDFB...SBABaAAB.VFGHhAAA..FEBHQEBHhABADBBBNEIG.KCDEPAHFhACAfCHC.cGEC....hACA......hADA...,1,-27,-34,7
UKBRCgTPEQNIDcMfSaZOVLeXAJGHWFdYb,JEGHGEDHHCBBFDCBdAFFUGEBBBAG..RAAD.CBHA...TAGHEGBB.hAAAQADHDGDA.hABAMDAHfHEHhACA.SBDFaGCB.ODHFeDHBAHID.hADA......hAEA...,2,-34,-10,24
GOfCADdeJcTSLaXYBHMIVZKWQgNPFEURb,eEACJDAC...TFBHaEFDBABCHGDE.MBAEZAFBKFAC..QAGGhAAA.PEEEhABAEHCGRACCOEDDhAAAADAADCAGSCDGLBHFIGHF..hADA......hAFA...,1,-8,-36,28
WcTBfLEAVXPHNIObgKRMeQZUJCaFdGSYD,XFDHHAADOGEAKEAB.eECEZBCE.UDGECHGG.dBEBGCFGDGIB..hAAATFAEBAHEfCAAhABAECCGAACE.PACAhAGANAEF...IDDH....hBAA......hBBA...,2,-32,-15,17
QScODLZERWTABUaHMNFdbXJPYGICKVefg,BFCFHBCFFAEDdCAB.JCGDGEEE.CBED.KGCA.eCABQAFEhAAA.SGHDhABADIBCEFFD.RFABAEHE...MBDFhACAXAGE.IFHGfGDE.hAAA.OABG..hAGA...,1,-23,-37,14
PJcbgRQXTIWLNDUYOBSaVKGEHZAdfeFMC,eCCHCBGE..JDGB..gBAEQEDC..XCGChAAA.IEAGNADDDCCHOAAEhAAASGFGKBDGEFBHhABAAADAFGBE.cAGFRGDA.TEGD.WBDBhABA.LFEDhACABHGA...,1,-19,-33,14
bOVLfUYXCeKARZTSdHMWPBDaJNgEGFQcI,ZBCDSFHBdFCEHAFGMDAEBGGD.DACGJEDG..EBAHGAAD.hAAAFGCHIEGHOAGBLEADhAAAUGAECFHAADIB.TGFChABA..aGDDNAIE.......hADA......hAEA...,2,-28,-18,10
DRbOBLATefMdcQGSUHYNVPaFZICWKEXgJ,TDACMDEBdFBH.GBABSBACHGFG..VAGBaDEBFBHH.ZADChAAACFFDEEHBJGAC..DCDA.hAAARFEHBHHEABECfDBEhABAQEGENDAE.WHAG......hABA......hACA...,2,-18,-5,13
OHgXPEdKIGcCNeSJbAWYULBQTZRMVFfaD,UCBCBFFEZBCBMEAFFCGC..DACAHFCB..XFDBEAGEKHGEGBAChAAACBGC..NIAH.JFAFhABA.AIFELAEBhACAQCFB.VGFAaEGF.OBDD.dFBA.IAAChAFASEEF.hAGA...,2,-27,-9,18
VJfLPEQIdTBScRHDUeGbaOFCMZWNAKXYg,XGBCVAAD.LBADQCED.dADCBHHH.RBFBUBCBhAAAeHBEbAFEFHECMGFG.hAAAZEEEAGGEKEBF..JAHFhABAEHFGSFAFcFEGDAFEODDBCHHB..hACA......hADA...,2,-11,-9,2
SRdQUIPTgNeVWLJMHDYGEKXaFACfBObZc,BBBDOFBBZFEERDFE.UDBH..TABGeHCGLEFEMCDA.DGAFhAAAEEED.KHGCFGHDAAHGCAFC.hABA....fDAAhAAASAEFICHDPAFE....hABA......hADA...,1,-33,-36,3
VUHCOIMBNLagEdFcRWAYPfTJeKZDGbXSQ,...fDCDTFCAKBBDDGBGGCFG.XAGESBEFhAAAQGAHUGEBCHBBIBBBhABAMFHHLADFhAAAaCFCECAB.dEAHFEBGWFEEAIEE......hACA......hADA...,1,-8,-31,23
SXecCUEBfJYOTZWNMRPIDALGKQdagFHVb,GAEGQFCEaHEGHEAESAFB.eCDGCEGHEBHDBHFD.JABDhAAAOHAAZEAF.WABHhAAAMIAG.REGFDAHFLDDHhABAKEEC.FGGA.........hABA......hADA...,1,-9,-19,10
YPJXEQdKCgbUMaRVLDeIAfWBOcFGZHNTS,BFDGFDCDZEEGHAFA.SFEEJHBE.EACGKBDG.CCGD.UFAH.hAAAMFIHaGHD.RBBFDBADAHAG.hABA...OBBHhACANIDH.....TAGC...XGEDhADA...hAAA...,1,-31,-41,10
FOfWJbKLUCDaZePMIHYEXTgVdGNcRSQBA,OCCHJGEALEDFUADB..DDGAZACG.MFFAHFFG.EAAC..TGAEhAAAVGCG.GBEBhABA.RCAEBAGBFEFGfAHGhAAAKEAF.eEAB......hAEA......hAGA...,2,-23,-18,5
DQZFERXKfPTVIcBSHLAOYJbagdGeUWNMC,OEEGJGEA..aCFHGCBG.eBDGUFBBMIFACAFE.DFGBZBAFFAHFhAAARACC.KFDA....hABA.fGAAhACAPAHF.IFHDSHGAAAGD.bEFAWDFENDAC.hAAAEHCE.....hABA...,1,-11,-34,23
VcTdHLOXZJYRUKGFegMDBCbNAWQfaIEPS,QCBCaHBG.EBFCSDDF.TFGFHEDFXGAChAAAJABCUEAE.KACBeBDAhAAADIBGBGGACGFD.NDEDAEAHIEEChAEA.PAHFdBACLHFA.hAFA......hAGA...,1,-11,-28,17
MQgXYCfGZDENPRWLBAFdTcaUOIVKbJeSH,dFAAaGFC.UACB..VGBAKCGA..eDCCMDBE..QEEAhAAA..YBAChAAAfAGFDFFGNAFGPFHDhABALAGDBFCFAEADFEBGOGCC....hADA......hAFA...,2,-29,-26,3
SMLUKCJgIVEeWcPFHbZfTDGXBYAdOQaRN,dGDDQAADaDDG.SBGFUAFGKHGE.CFDF...JBAC..IFGFhAAAeDAH.cEAGhACAFEFAZFBB.DCADXCDAhADABEEG.AAEBNCIAMAIDLHDG.gGAFhAFA...hAAA...,2,-34,-12,22
YbJWMEXaAQcFCBPZOKdITeDLVUfSNgHGR,FGFCBBBDOEBBKFDAdCHA..eAEHLDBE.UFADNAAH.HAEAhAAARAGF..JBBGMFFGEFDD.hAGAAHGE..CABB.ZEEADGGG.hAIA..SHDE.....hBAA......hBBA...,1,-29,-32,3
ALGdTPNMEVQRXWBHbFeaYJcDfOKCUSZIg,GAEGTGBC.MCHHEGGB.QGAH.REFDBCBDHCCEbACGaADB.hAAAJDFDDCAFKHDA.SEAEhAAAIEDGAEIHdAGF.hABA.NIDF...........hACA......hAGA...,2,-22,-16,6
cYSHgCADUBNbJMPQORedIXfELFVTKaGWZ,DEFABHHG.JBGFMGFA.OFBAdCBG....IDDBXAGDhAAALACGFCAHKGAAaCEBhABAZFCD..SFFHhAAAHGDEgBBDAIFA..NCFAQGAFhABA.....hACA...,1,-29,-30,1
RPFUaWQgLDcVdfJYbZeGSAXEOKCINBTMH,XGGDEEEDKAGE..CGDB.BEEDHGFERDAFUABCQABALGCEDDDB.hAAAdAHC..JAEFZDFASFAChABAAAEH.NIBB.hAFAMAAF.aAEDgCGGfGAE..hAGA......hBBA...,2,-25,-17,8
cEBVKeIXCUfMWRdLbYPHNaGFQJTAgOSDZ,SDCDZFDGEBEABAHFKEGD..eAAFCGABUAEHMIBG..dHEBLEAAhAAA..PDEBhAAANDBHFHGA.QABFhACAACGBDEEE.ICHF..WCHB..hACA......hADA...,2,-33,-30,3
AdUPEJQOMCSfXRVcBYGIHgbeWFTaLZKDN,UGBCJCCH.OBCDCDHD....XFBGRCFEBEADGEDHHBEEeFFHhAAAFAHHLAAFhACAKADEDGABACAE.EHGA..SBBEhABAfBEFYFED..IBBHhADA....hAEA...,1,-26,-30,4
CBMQYEXHNJaFSIcLeRUAVbKDWZgTfOdGP,VDAGKHFGZCBD....TFCBOAGDGBCFBFGCMEAF..hAAAYFFGEBADHDEDaAFGhAAAFFCD..SEEAhABAIBEE.eAHFAGBBDBID.....WEHBhABA.....hACA.fGBECDDC,1,-8,-33,25
BGSQaJgIWNYcbdOLFVTCRMEeUHAfKPDZX,KHBGZFDGGBCCQBDAaAEB...JHFE..IEHB..hAAAYAECdAGCFBAC.CBHARDGDhAAAEDAHHCBDAHHEDIGABEEFhABASBHH..NCAA......hABA......hACA...,1,-22,-28,6
TKaGdUXWfcFegNRCOIHSMYELZbPJABVDQ,BFCFVFEE.QAFA.KGFAdAEEUBAHfGBD.FDFChAAAeEACRCCB.CHDHIHBBhAAAMIDALBAB.hABAbAGBAFECTBDF.aDGFWEHH..NAIE.hACA......hADA...,2,-31,-15,16
GECXKMDZcfRYdLUVaJIFTOWgSAQPbHeBN,QCBCHAADBAHAEHEGKECADHEGZBEC..RCCELGAAaCGA.FGHD.hAAA.TACFOFFGgEGDhABAADIHeEAGCADC.MAFHhACA...fHBH...hAAA......hACA...,2,-26,-16,10
TNVIKMEbRPDGSYWQUdBOLeafZJCHgcFXA,VEFHKGFHMFCB..EAFERADAGCEE..SDBHQABAhAAABHHGOEAGeFEDfBHAhABACABBHBCEcCGFhAAAAHHBIEHFDICGWEDF...LDADhADA.....hAEA...,1,-9,-26,17
ZPNFcLEDdaRXAWYGfCKbOVeHQBMTgSUIJ,GAFEKEGDODBEHFEDBDACMBBE...TCABSACGUFAEIHGDhAAAZGBCFAAFEFCCDDHDhABA..RAFC.ACEHfDDEhACACHGCeCDG.........hADA......hAEA...,1,-9,-33,24
ACBLPdKMeOfJSHcEWbaZXgQFRDINYTGUV,CEFABAFBLBEFKEHD..eDADJAAF.HCEG.ECAEaGAAZGFA.QECGhAAADFAA..IFHGhABANHAD.TFDChACA...........hABA......hACA.GABFAIBG,2,-56,-10,46
VRZgaUdQBFWLNEPTSCMJDOXeKIbAcYHfG,HAADGEDHVEFCRCDCZFBFUEACdGAEBACG.LAAFEDEC..TADChAAASEHHMCDDDCFGhACAeHEAKAHBAAHB.fGHAhADAaBCE.WGAACAFG.....OHDChAFA....hAGA...,1,-11,-17,6
XUFEWMASbDNQecPJIKgHYGBdOfCRaLTVZ,SHFGDACBQGFAeBGH..JDEGIACGHADDBDHA.ODAEhAAAfDDC.hABACFCGaEFHTFCH.XAGEhADAEBDAMEIHAGABbFAFPEAB.KBAB.YHAGhAAA...hAFA...,1,-13,-22,9
eNagFZJQXBAELOdbCSUcHDfMTYKIPGWVR,LFFBdDCDCBFG.SBCHUAACDHBA.MBIH..KFGCGAFAhAAARFDC.NDAE.FAHFZEBF.XEDBhABAEDFC.OACAhAHAHEAA...YFHBIBDD..WHBGhAIAaAEA.....hADA...,1,-1,-41,40
acfJEFAYPHZRCeQSdLMBbXOTDVKUNgGWI,HAADRFGHeECEQEGBLHCEBCGCXEBBDEAB.VGCGKCDEUAAChADAGAED.aEAH.fDDDhAAAEGAAAFBE..ZDFAhAEAdADCMBEC.........hACA......hAFA...,1,0,-21,21
DERLFHfZGdbMXCWOgVceBNAUKSJTYaPQI,KFHBSGDD..JBEETEADaEDA.QEFAEDAB.FCDAhAAAZAACdACHMGDECHBFOAHFhABA...cCCChADAeHCEAIAE..YAGFDFAHRCGB.LHFAhAFA.....hABA...,2,-39,0,39
FbNXEVYJKRDHSAPcWTgLfdBGQZaIeMCUO,...PGEATCBCLEEEBGDCQGGCZCFCeDCH.MCGHCHHB.hAAAOFADFHAA.bAEGXBBChABAEABH.JDAHDFCBhAAAAAGA.WAFEdACF.aFED.IEDE..hABA.NCIE.....hADA...,2,-16,-14,2
OdbFIBDZQTfNCXgLMHGWeVUJPEaScRAYK,OCCHdAFBFEEEDECGZAEA..QGFG..TGCFCAHBLDHHhAAAMEIBHBDEeGCEUABFhACAECBE.SGAHhAFAAHGDKAADBHEAXDFG..WDAB..hABA......hACA...,1,-7,-37,30
dbYIDVfMKJcZaBNTHQGgFUXSPLEROCWAe,dDCD..IFDDDHDCMGCAKAAFZBCABBDDHBGDQCBG.hAAAFAGBSFAFhABALFGDEHCECGGEACAFeEFG.hABA.bFAD..fHAFJDEENDAA...hACA......hADA...,2,-29,-22,7
EcRWACMQTKdSJbYgeXfZNaDGPFBVIOLUH,QEBCKFHBdBAF.SAECJEFD....bFBFeGFCZBGF.hAAANEEGaDGADECG..FGDDBABEhAAA.IHAHhADALAFCECDCRBDEAEADCBCH.MDBCgAGA..hAHA......hBAA...,1,-22,-25,3
LeFGTSKIcAPEDdOfCBaRQYZJbWXVMHNgU,EHFGOEACBHBHRFDGZAEH..JDAD..XCAGHCECUEFH.eBCAhAAAGCGEKAHHABBHDAAA.hABAdGAGCDDG.aDDC..QFCEhACA..WBBEMEIHNIDH...hADA......hAGA...,1,-19,-26,7
PcVBdTZJNCLUOAFeMQbgIKHGaWfESYXRD,MEGFQCBC..IBDCHEEFaHCEEBGAXAEG.DDHBhAAAPCHFBGHHdABFTCEDhAAAJGAECDEF...OBFEhAFAFAFGbCAB.KABC.WFHD.SEEDhAEA....hAIA...,2,-27,-13,14
aPfHIeQbNCFAVdSWEDLXYKMJRgUBGOcTZ,VFEEdAFBSECG.DGGCXCDG.MIAGJBCFUDGGhAAAGAABOEBHZEABfFCEhAAA.IEHGhABAQGECCAGDAHHH.EHCA.KACCBCHD.aDAGhADAeBAF....hABA...,1,-8,-31,23
VOBHNRKeSLGdWgXYbIQJPDATacEUFCMZf,aGFCUGBC.MABEZDAFOAEEBEHA..HDEDKCEDLACDdAGE.hAAA.XCCCIDHHhAAAJHEEABABEFFGCBBC...hAFAfGCA.NEAE.eBHH.SGGEhAIA.WFBEhBAA...,1,-24,-32,8
ONPJdYaXZMIVfHSDGeWKRQbABgLECTcFU,BAFBEDCD.CAAC..FCGEOFFE.JAFBdHFD..aHAEZDCA.MCCGhACAVAACHFDA..DGDBhAAAeHBEKHEGRDABQEAGhADAAFEDLADB.....TCGCNBBF.hAEA......hAHA...,2,-26,-17,9
NXgMQCSODcIPLdJRFGZfUWAKeaYVHTBEb,KEEDaDCDHAACEDBE...XGDFQACESFHHOGCCIGHFhAAAdDADJAHFGBFEhAAAUCFBAAGB...YAHHhABABGGCgFAD.MIAECFBGDFAH.hABA......hADA...,2,-23,-8,15
cYGMeaFBPKdRSfEXAQHObNgULJWTDZVCI,HADGOGEA..gDAALAFHJBAFDCBAZFFF..CHEA.IBHAhAAAGDCDeHBCBABFdGEGhADASFBCEDGAADEGQGAFhAEANEAE.TECGYBHD.MCCGhAAAaFHB.....hAGA...,1,-9,-18,9
YUAaeBHMVNEPdQWCgGRFKXOJScLIfZTbD,BDGFVFBG.EHGE.dABCCEHGGCCB.FDAFOECD.JDBBLHBAhAAAZAFG.DAHFAAFAaADDhAAAHFFF.MAIH.QACGhABAREEBSEHHIAFCfHAFhADA......hAHA...,2,-34,-9,25
GXRHPBDEUSYdfIVaFCMAZWcOeLgJQTbNK,ZAADOGEAeGEELCBCQACE..TCGCKAGCRFBDBDDAEACASFDChAAAdFAC.fFAHhABAIEFB.FGCHhACACHFGABEEgAFF.NEBF.....hAFA......hAIA...,2,-30,-16,14
POWbVFNSMIAdKBaJRLGXCfeEQTUHgYcZD,dEHAKEHBBCDARFCCLCFFGDBC..CDBB.eACCEAAF.UAAEHBCD..hAAA...gGAEhACAYBGF.DAEAOFDDhAGAbAEAFHFEMFFD.IAHFADAH.XGGChBAA....hBEA...,1,-5,-34,29
QANRFgebODBESPVdXMZIKLcUfWTJaYHCG,RDAGeCCHOGEAEFGC....SCAHVAAEdBFAZGAELGBC.hAAAfEFHJEDE.hADAaBABCCDBAFAHFAGDDIGA.BEHChAEAMIEA.KGHB.WFAD.....hAFA......hAGA...,2,-31,-12,19
MSQcARHdXLKIWOUEfDBYNCTaJFePVgZbG,HDDFdGDDKFAAOAGBUADA.DAIFBHBB..CCCBaHDEFDBE...VDAFhAAAZFFF..MAHB..hAAAQGGEAFDG.hABAXADFIBBFfHAB..hABANAIE......hACA...,1,-28,-45,17
dUMBYLVNfFeXQcHTgKGOEDAaWPRJZbISC,aHBGRAADZDEB...SECHCFDGMBCE.BAHELHEA.VCGHhAAAFBFGQFAAhAAAHBADKFAC.EADCDDCAAGGGJHDCbCEFdAGFhABA....NDIEXDAC..hACA......hADA...,1,-11,-26,15
QYRJFNPLHBKCgSUfWAMVZIOcaGEXbTdeD,ZFBGOGEAaGFF.GACG.EHCATDFG.eCECDAADQBFAhABARABGJAFA.PGAAhACABEHACEAASFHBhAEA.WEFCADHGMDAC.IECF..hAAA......hABA...,2,-30,-12,18
dYRITcNHEJKVBADMOUSCLWgFXGefQbPZa,MFECUAADCGHDLDBB.FHDGGDBF.eDGHfBHAhAAAQBFGZACCdHGBRFADTGEEhABANBAC..EDDHKADEACCGDGAHhABA.SDGA.....hAGA......hAHA...,1,-12,-24,12
cHPCJLIARZFEaUOYeNDXdbWfQTGVSMKBg,ZDDFaDAB.OGFC..eEGDDAADdGAG..fDHEQCBAhABAVEBGMFDBKBCHBEAHhACAHFEBCCFBLBBChADAABBEEHBE...NAEF.WAGFGCGESBEFhAAA......hABA...,1,-10,-25,15
ZeTMDVgRNbdEXIBSGLOUYKWFPfJHQacAC,CEFAeBDGDCBA.REGB..dFBAEFGCBGDB.LDADOHCC.UDDBKEDHFDAHhAAA..JAAEHAGB.hAAAaBDAAIDAMAHF..hAEA............hAFA......hAGA...,2,-45,-31,14
MKgYXTJDdLbUGPFNCEeSfcIBHWQAZaOVR,ZDEDaDBD.OACGRFGD.KFCC..XAABDDCCLEHBUCGGFEDA.hAAAEGAH..fBAGhABABGDCQBEEhADAMEBETGAC.JHDG.bAEA...NCCF.CEAFeADFhAFA....hAGA...,1,-12,-22,10
RATPKODgLVBIdFbHWYZXMcGQeSECUfNaJ,KGFCOFCHDDFELCCFBEHFFCAF.HAFCZCCC.MCIFGABF.QGGFhAAASEADUGDAhABAaGEHADBF....gAFBhACAIBAHWEEG...YADHhAAAeECECEAG...fGCEhABA,2,-25,-22,3
VZWSMJFNXEIULgRfdABCKceHYbDPTaGOQ,CBEAeCCHHDBGDCAC..aHBGQGFHZFEC.MCHBFHECEBBHLEABhAAARCGBAAAF.KGCH.bAFC.hABA....PFDGhABAOEAHSBDBNACB.....hAHA......hAIA...,2,-26,-11,15
baUTZDWEFQfMBgeILXHCAYKVNdRGOJPcS,KCFCVDAGdFAD.GDCHODGD..JBABSGEB.UBGDhAAADFGCFGGG.MIAEgBCDhABA.IHBAhACALAHB.CBEF.ADFHNADB......hAIA......hBAA...,2,-41,-32,9
PLGXWOKSYMTQFEBbUefACJacZDHgVIRdN,aDABDHCEHEFA..VFDGIFAG.RABD.dACBLAEAGBBDXGBHhAAAOBABKHGGSFBFhABAMICGFFCCBCEAhAAAUAGBfDFECGHB.JDHF...hABA......hADA...,1,-8,-20,12
AKgScfEUHWNTORFGPLYVdBICJQeaZDMbX,KAFBSHBGEBCC.UCDHHFFB..TGFHOFCF.GCEAhAAALACCdEACIHAAhABACCHEQDGHeEHDDDBFMACEhAHAABGBfAAE.REBFFGDF...hAIA......hBAA...,2,-12,-12,0
eJVEIOgMHKaRbBYQNFdADfcPUTLZXGSWC,DACB..PCCHLEADZADHGGEFCGEF.eDHFJDCGEHCE..hAAAOBAHMCGFaGGBBCHFhAAA.YGCEFFBCAIAC.hABAfAFC..UADESFAFhABAWFHB.IEEFhACA...,2,-33,-22,11
OAcagUNdVBMLGQTPEWbeDSJfKFYIHRXCZ,aHBGUCBC.dGBBMBDBGACD..QBEEEGFH.eFFEJEEEKCFChAAAIAAA.HBGDhACACHHEAFAA.NCBABFEG.hABA............hACA......hADA...,1,-17,-43,26
EcUfQPTYHXdSWKCeVOLBgMFINaADJRGbZ,DGADJEGHGACGECAC..UDDHQGAF..PABAHFDBdEADhAAASGBHCBGG.hABAVEGHBCAE.MDIDhACA............hAEA......hAFA...,2,-43,-24,19
TGbQNJfXOEVIWCUZFYgPAMHBKdDLcaeRS,MEEDKBBDDAACLBEG.eFACTCFHQFGB.JABBOEBHhADA.EEDHIDCFhAAACAFEFHFA...gGBFhABAABIFBEHBcDCG...aAEHSHDAhADANIAF.fAFFhAEA,1,-16,-50,34
CSFQgXMKHZIWLABRTUOEJYbadceNPVfDG,BFFCTDCBUABD..JFEEaEDB..dHGHeFDH..PEAFhAAAVAEC.GACD.FDGAhABAXEAEMFCBKAHFIFHEhAAAACCBEFHF...YDDC.cGGChACAfCAA.hAEA.SHAE.,2,-25,-12,13
eCFgGTIcBWDSQNKPXYAUEbMZdfaHVLROJ,EGFCMECGZACGdDGGHCAARABF.OAGF.CCEG.FAEAGDEFTFCFBHHHhAAADHEA...SGCChABANIEH.KGABPDABhAAA.AABF..fAHALEAA.eHAEhADA......hAHA...,1,-7,-31,24
TUcbEdfOaHXBgDIeGYZQMWVKALRJSFPCN,JFFCSAFB.FDFECDDGUCFH..ECDHOBBFHAAFBAHFhAAA.DHCEeGBAZGFGQDABhACAMAIHKBDHLDAHhAAANBIA..cFBBdAFHXGED.hADA......hAEA...,2,-30,-22,8
FSfdaCEgIYATLXVDBMKQJOPZeRHUNWbGc,TDCHXAEG.DFHHBBCA.KGAGOGCAZADFHGFAUCAD..NAGG.hAAAGCFC.SFAFhAAAfBAFCDECICHGhABAAEIFMFEG.QABDeFAE.WHBGhADA......hAFA...,1,-19,-29,10
UbPceDaMSEOGFZVTHIAWNYLJRBQfdgKXC,...NDDG.LEEGBBHC.fFACdCBEKFEF.UBEC.PHBEhAAADIEEaFHB..EBHHOABGhAAAZABBHGEEABDC.YDCBhABARCFFQFAF.CBFC.....hAFA......hAGA...,1,-4,-39,35
GKLfVCcDBPSREHXTUQFNAbdaMWgYOJZIe,dAFBaGFH.MDID....gCGEOBEEZAAGeDBBLFFDhAAACEFCDACGBBABSDCChABAEHGGHGAAUEBF.NEEEAIHEWACAhAAA...ICDA.fEHEhABA....hAGA...,1,-23,-28,5
YDgdTBSHWfbIePOZGXRFEMCLNVaQAcUKJ,KGFCJFCH.DCGDdBFHBDCGHAAF.......fEAFhAAAbBAFeEHBZFBGXCDG.hAAAEEEGCEADLAHBhABA.aADDAGBBUGGD.......hACA......hADA...,2,-38,-26,12
DYVaKOZBWFGCgeNfEPTcQJMUdAXSRIbHL,RBCFHAADLCHBDAFCaEAHKGCD.BDAHFEEFGGEB..eCFHEGCF.hAAATFDDQBFDhACAJGFG.dEGHABFB..IABAhAAAYADF.........hADA.OAFACEBG.fEBChAEA,2,-27,-19,8
eHJUdfTRVPLNAEcSaCZKFgGMObDQBIWXY,EAFBSAFBZDDC.KDBAFGAEGEEHMFCGDGDGBBAH...IHBEhAAAXABGHGDAdADA.hAAARBGFVADF.NDAA.AEHDaHDGhACA.CHGH..bAGB.......hABA......hACA...,2,-24,-16,8
QDFNcZaVMUbCPdRHJOWGgSBAXfEIKeTLY,EGFCeCCHLBEEDIACFFAC.ZFAF..MHEECHDGRBBBHFCC..OFDEhAAAGDEFSBAFhABABHHGAIFAIAAGKDHHTAEChACA..NACF.aBCB.......hAHA......hAIA...,1,-14,-29,15
JYEWLINBegaSXUcGHCZDFTQPRfKVAMObd,OCHDJCCH..EABELBBABEAD.aDFHUGGEGGBBHBGFCEDHDEAFhAAAQFDA.RBDDKGBAhAAAMBGF..dGACIHGAhABA.eDBA.SGGEhACA......hADA...,2,-28,-23,5
HAfFUNGZDSCEPLVYgbIedBTROKQacJWXM,UGBCGEDHZACGCBHGLGAC..VDED..gBAGhAAAeDAEBFHG.OAFDhAAAaFHDJAEFMHDEAGGDFGEHSBHFhABA.EEAGbDAC......hABA......hACA...,2,-25,-25,0
CaONXWPUAbLMKRcgJfeHVZSBDYFGEQdIT,MDEBKCFCRDBG...JBFDeAAEZFFB.DAGCGBBG.dGACTEGB.hAAAOHDEXDGE.hADA.....UFAHhAEAAABFcACAfFFESHCGBHHHECCEhAFACHHHaAFA.....hBAA...,1,-21,-30,9
eYBIMNEZaObcVXCLGQAfFSJPTWdKDUHgR,FAFBJCCH...TEGBdGBDDGHFUDAAHEEARFDG.BAAF..MIBAEBDAZAFFhACAaBHH...ODABhADAbDDC...XGEEhAEACABD..........hAHA......hAIA...,1,-29,-32,3
TUARBFeQDKgOHSacPMIdZLWfYENVCGXJb,FBBDeEGHQDCAKABFHADA...aCGHPCCFMCAB..ZGFGLFABhAAA..WAHHhAAAfCHEEGBC.CGCF.hACA............hADA......hAFA...,2,-32,-31,1
EBZOQaNPWLUdJHKfVDbGMecCTRSXIAgYF,FHBGBHCHOAFBQBGD..aBAHNBBE.LEAG.dBCDKABEhAAADIEGbEDEGCGG.hAEAeGCECCECSCCFhAFAAGADEDDE.PHFA.......hAAA......hABA...,1,-24,-28,4
UPTSMROWgJfBIQCHFYZbDLeVXcaNKGdAE,UGBCSGFCMFEH.OEAD..JCEHBDDAQBBBHAADFGHDhAAAZAFADACCLHFEhAAAeAECVDFGaDHH.KCCCAFGD.TGCHhAIA..WDAG......hABA......hACA...,2,-31,-10,21
ePMQXJbSCREadUYWGANLTDHIBFVKZcgfO,LDACTFCA.HFCGFBGGKBBEZCFC..fBBHOFAB.eHEAhAAAMFGBQAGEhABA.JEADSBEBhAAACEEB.aEHD.dDEH.WDAAAFHBNACFDIBEIHHGhABA.BCAC..hACA...,1,-1,-34,33
bPHdWGcRaTBJeZMfUNIDFOQCEYKgSLVXA,HAADGEAHRDDDBEABeABEMEHDUCFD..DGAGFDCA.QGDGhAAAEHBEKGFB.SAHBhAEALADAAHIBbGAG.dBGEaFGATBEChAFA..........hAGA......hBAA...,2,-31,-2,29
bJCXWNGFTHZUgcDLEdYMOBVeQPfAaKRSI,aEHBKEHBRGFA....SFCHJDAH.CDBF.XAGAGGEFFAGAhAAAHECBUCEBDACGdEFAMADHhABABBDFeFAB.fABAhAEAIHAE....bCEC...NBCA.hAAA......hABA...,1,-16,-32,16
DeYVfHOCbQAcMUPGKILXSZNWBRFETdJag,UFDBKGAHLFCDZAEFBAAEFCEH..dCCHJBCDDEEC....VGFAhAAAHDAE.CGAE.AEGE.MEIHhACAGAEF..SHAAhADANABC.EAHF...aGFD...hACA......hADA...,1,-30,-37,7
JcYLGaIVPFbXfKHTCARDdZOEQNeUMWSgB,DGDEdDBDZEFDEHGE.eFBDUCDG..SADDBEHH..JHAGLAFHhAAAGBBE.aBAE.VFCAhABAFCGG..XEADhAAAfAHAKADACAFBAEAH.QEFEMEIH..hABA......hACA...,2,-28,-10,18
FVHCENXBcgKRJSaPLbfWOIdGDZTQeUMAY,FCFCHFGHCCDA.XCGCBDAB.KAFDRFGD...aECHLBAE..hAAAfBBH.hABAWFEHdAEBDICGZCAA.QFBDhACAMAEBAHAEYAAENEFG....hAGA......hAHA...,2,-41,-23,18
CKcEOQHYVJADRfTPNGgMBLXbSWaFIdeZU,RFDGTCBCGAAF.BCGCLCHH.SFCCaCEFFCHD.IGGBhAAAdGHGeHACZGCGKDDFOAEHhABAQDACHAFAVDEAhACADAEE.fFAG....hADA......hAFA...,2,-23,-4,19
MKWLNTBFbAPGdDcVgfZQJORCISaXHYeEU,dGAHVFDGZAAC.QFFBRACE..CAAFaHGAHDAG.EDGHKDFHLDDHhABABHCG.FAFEAAGGDCAHhACAfHCF.ICAGhACASBHHYFHBMBBBTDCEhAEA.PFAB..hAFA.gBFC.,1,2,-25,27
WVJZAeHdOIFRbXMLCTSKfDEUagcPNQBYG,eDCHHDEDdDBHOBABFAAFRFBE..MEBFCHDH.KFGCEAFFUGGB..aGGGhACA..PHCGBHBGGAGEhADAJCDCZAGF.IHHGhAEAXEEB.SBBH.DAIF.hAFANAAF......hAIA...,1,-9,-20,11
EWdeYLHJbUNKFZaCOVPQgXARfMDBcGTSI,RFACDDGGBCCHGECG..SCEEEDBHdABALHFAHFECUAAFFBDDCGHFhAAAOHDC.QDEChABAAFFGMAFF...hADAIDAG.YCHF.JAFEKBGEhAEA......hAGA.aHAA.,1,-13,-28,15
NWQGgOZYaDeUFPAKVIHfEMBdSXCbJLRTc,KCFCVGFGHDBG.MEFHdDEECBHBLAEE.REGB.TADA..hAAANIEBGBAFODDBaAFDhABADGBFeFDF..PABDhADAAFBAIAACBHAHXEGA..hAFA.cGDB..hAHA...,1,-8,-31,23
ZFPEXcDaRQGWIeMgOJdLbVHYUNfBTKSCA,ZDAGFAFBEHACDGFFRBCE..QECEGCGC.eEFEMGBC..JABGLHBGhAAAHFFA.UGGHhABABHDEKAGEAAAEPAHFhAHA.XBDDaBBBWACE......hBAA......hBEA...,2,-23,-10,13
CbUNTeDZdGEcXRgWFBHMVIYKQAfSLJOPa,LCCHJEEG.OCEFaBFH.UGCEeBABDAEEGGAF.EEBAXBFFhAAA.RGFAFACChABABHGG.MAIH.YADBhAAAAHAASCHBCAGHNEIE......hAHA......hAIA...,2,-32,-23,9
MfaeHEJNPXSQdRTLGUOCFBAbIWKVZDgYc,..IFDGKCFCVGACDIAC......gDFGMIFAfAGFhAAAaDBH.eDBFhABAEEDEJADCXACH.hAAASDHHRBBE.TDEA.LGFAhACAOFHD.CAECBHDHhAGAABAG...,2,-27,-25,2
cOYQgVXdEKFaTBILWGHbDURNfPAZCJSMe,ZFEESDABeHCGOAFHQFGH..XBCCKBBEaEEDBCEGhAAALEBCHGCAUDGBhAAAfGAAAGIBMABFgAGEhACAECGA........hADA......hAEA...,1,-19,-20,1
IaCHVgDKeEBGYcAdfUPQbONMTRJFWZSXL,UGBCQCBC.ODHHTEDG.FDADSDEDLFGDaAABhACAVAEE.DBAAKBBCEHAABDCHhADAGECEAFIH.dGGHfAHAhAEANCAE.MAGF.....hAAA......hABA...,2,-26,-15,11
RSOJMAUCYWfLKNeaZGDVPTQEBFcgdbIXH,CHHG..fHBHLDACeBHDZBEGDAEA..TGEEEBBCFEGEdFAE.hAAA.IEBARFCFJBBEUCEEhAAAKFFFaCAC...hABA............hACA......hADA...,1,-25,-33,8
QdbTDKaIYGCLBEZUAVWcRFHMJfgXSPeNO,VAADRAADFFAFHCDC..JFDD..XDAESAGEeAHHQBGHhAAATGFH.DEDGKGCGhAAA.aADA..YEAHhACACEGGBACD.UFGGAIHCMEIF.....hADA.fCDDhAEA.NIEF..,2,-35,-7,28
MWBNRPGDQegXKHVfdIZCbTOLAUacESFYJ,aGFCEAFBFABD..MGBGBCEGRBFA.GEBA.eHFEKDDAHBBF.hAAAdAAGCEEBOBHHLADChACAADBGSFGAhABAWHAGDIGA.XGDDVEFE.IADD..hAGA......hAHA...,1,-12,-27,15
YAMUWHPeLCgdEKTRBXaGSZIFQVDOcNfJb,UFDBHAADeFHBCAAB.dFDFEAEBRDACBHEE.GADCSDDBFGBBDDIDhAAAOFAB..fAGEhACAbCGH.AFAHMEGFhADAPCAF.gGGE.KCFH.hAFAaCCH.IACFhAFA...,2,-36,-5,31
gPKVdJSETebNcQDfULCaROAGMFWZIHBYX,MACAFCFCZFGFBHFD..XABGKCFFdGCD..ECCFeAFE...hAAAbDACQFGEhABA.DGAFLEEDhAAACFFFaBGAABDA.IHCH.gFBC.hAGA......hAHA...,2,-42,-21,21
CFaWdcBYPGLNAKRXQEOIDfVbgJMHZUeTS,XCCBQGGD.EAAADBGE...VFDDgFDDHCGHeBABhAAACBDH.FHGGdCFCBFBBYHAAhAAA..PADAhABALDBGAFIFKEEEODAHIHACfCHChADA.MFFE..hAEA...,1,-13,-18,5
aUYPDCXTSNdFbfELAHROJIgKWeZBcGMVQ,HDBGJFFC.KBDBeBECBHAHGAACQGDAUDCA.DGHF..XCGAhAAASCFG.NBAA.hAAAbGCE.LFAFhACAAHFGIAHA.ZFBFMADAaEFECCBG.....hAHA......hAIA...,2,-18,-18,0
VUNfWKXIHYaPZbRMBCQDFTEScLJdegOGA,UFDH..fFAFXBEA.HBBA.PCEFZABBMFIDBAFEhAAACAHADEABTGCC.cGEEhABAdEEBeEBH..hAAAgCGFAHEDNCHE.IDAGaDDG.bFGFhACAFGGHSDDDhADAOHAE...,2,-15,-15,0
QTafgREYSJHOdNGZWcUKPbBDCXAMVeFIL,eAABLCCHQADDTGDB...fFFGEFAE.SGAAhABAHFGDdCEGNBEHGBGGhACAZAABUDGFKECEBDAGhADACHCDAEAC.MIBGIHAGaFDD......hAAA......hADA...,1,-6,-12,6
MHDKIYRbNFETSXQeWfAUVgJaLCBOcdGPZ,VEFHaDCDBDBD..dCDAGGBFMFEBDCAFKAEFRCGH..FGBC..EFEEhAAASAFAQABChADAeCFAAGAF..JAFACAAHOEAEhAAA.........hAIA......hBAA...,2,-31,-28,3
BcWSeURfGFDJMZIKXAdbLTEVPaOYNHQgC,LCCHVBCF.aCACOFEEHGDE..CFAHBAAFSGAC.eAFHhAAAfFGEFHEEMBIDhABAZAEBKCABACGCdDGB.EEEBhACAPHBA.NFAB......cDGHhACAWHAG.....hADA...,2,-26,-14,12
cZYIUKWbVgeSPCfadXHEBTLOFAQMRGNDJ,QFCAGGCBJDCBZAACUCFG.KDBB..VEFGeHFE..CDAF.fEAGhAAAdAGA.HADAhABABBEDLFFGhACAACAGMAIFDFAF..........hABA......hACA...,1,-14,-36,22
CgaLKODJEGZXMUNWcPFIbTVABeYSRdQHf,BAFBSDCDQDADCHEA.LADFKCHDDCBFGGAHMEHHUGEGhAAA....cACGhAAAFABFbAGD..TAFEhABAAGCD.RDDAdFFF.fGHAaGCDEEEE.NCAE.hACA......hAFA...,1,-16,-25,9
XBgHEcDPWRAbJTCZFaGNOSdfYQeILKUVM,JDACTGDCZAFA..GGABSFBA.dCBAQFFCLBFEKBDBhAAAMIDABHAFHBBCEEFAhABADEEARFGFAIFACAAC.FCFEaCFGODAHhACA..fEAE...hADA......hAEA...,2,-18,-12,6
MDJQHKWAYPOcCfVNTeUdGLIXEBFaSRZgb,OGEACFDG..VCCCeCBCGAACLABC.XAGEEGBBBGHChAAASFBA.hACAZDEGMADEDDEG.HBFGhAHAAHHAPHAEcGEE.fEFA..hAIA......hBAA...,1,-20,-27,7
cTNIGQCZBPESDbMOXeaLRJUKHYdgfAVFW,VDAGFHBG..TAADGFBBZBEEBHGG.EAFDDEFG.ODBB.hAAAeGDELEFE.hAAAJHAAKADGdBCBAACCWCDDhAFANDDDCAGB............hAGA.SHFAhAHA.MAIB.,1,-23,-24,1
bAUdTSRafBLgVCGcPeEDYWZOXKJIQMNHF,UFCATFCERGFEBAAC..VEFHGACCeBHHDAFBZCAC..KEAHIEADhAAA.MCBGhABAFEGGdAGHaHCE..fGAGhACACCBGECGE.WABA......hADA......hAFA...,2,-39,-19,20
cLCNRXFdHIOKJafDbQYZWABSMVGgTPeUE,MAEEVEBH.GECB..TDDBUABDLFHFRBEEdFGEHABDKBFBaAAHhABADHBG.QCABhAAA..YDHHhADAAGIBBFBGSDDE.eAHHCGEGFGAH.hACA......hBAA...,2,-18,-6,12
QAKDWcUGePadROEIMbJXHTBFLNgfSYVCZ,KHFGDACBUEBEGCBD.eEBFdHADRFEA..OBEA..MDAEJAACHEEBhADABAEDLEEEhAAA..fCGFhAEASBFACEHEAIDG.cECDaAGAIBAHhABA......hADA...,1,-16,-42,26
OSRNPgIAWJaLXfYeDCbVHUFBEKGZQTcdM,aDCDLDAC.XFDAeEGFCGCAHBFH.BHAGEFBFKHFGQCAGhAAAdEHCMCBGSEEFhABARAFC.gADAhACAACIHWACC.fAGBDIAE....hADA......hAEA...,1,-16,-27,11
XUgeVHZKJSFdQaWITbYGNECRODPfcMBAL,LDCHXCGCUCCDVGFE..ZCEHKGHDFBGAdGFG...QAAFhABAIFAA..TABDhAAAYAEC..EHDGhABACFCBDHCE..PHACMIBABFECAAEB.eDAFhADASEGE.hAIA...,1,-17,-23,6
SYGRIgAMKOQeZUDbWdfTBcCFaNJLEVPHX,OECCeADGUCECDEGG.dHGFBDAB..CHCFFCCBaFAF..LFGDhAAA.ECCFHFAH.XEFEhAAASACF.hABARAEEAGDDQGDG.WBBF.fAHEhACAcGDD...hABA...,2,-43,-20,23
NOVHbCIBRAWfaZTDPLgMJQGYFeESKXdUc,aHBGZFEEDBGHLABC..JDAAGEEA.eBDASFADhAAAKFAGdHGB.UABCOCCH.hAEAVDGBCHCBBFBFADFCfAHEhAAA..gDDH.MCIHhAFA...FHEE.hAFA...,1,-14,-39,25
JeTRfENaPHMKXgOYbDBUIASWFQcLZCdVG,SAFBQGBCLFFDdDBDGCGEeCACRFBE.EHGEaABDHCFEKGFH.hAAAOEHDDFDABADFIABAhAAA.FEACCBHEJHAAhABATDDA.fAGB....hADA......hAEA...,2,-26,-2,24
YPgaREQGeUMfdBDNALcTXJWbCSIZHFKVO,LDACTCGC.JFHFCEDCZGFAHBGF..FAGCOEBC..gEAGhAAAaGEFQAADhAAAUACHMBBDBAFBNHAHABAF..hACAXCDA.bEFAIBEE..hADAKGCG.....hAEA...,2,-24,-12,12
KFJHSWEIbLNGgRPXCfOTeVDYUaMcAQBdZ,QGAFdGFHFFDHHACGEEBALDEAGBAFRAEACHAB....OCADhAAATEGBDCFAaDDFADCFKFFCSGEFhAAA.IHHEhABANICD..XFAAfDFH..hACAYAFC..hABA...,1,-2,-31,29
SfCXNREHMWKAJLGTVcbFPeOUdIZaBgYDQ,GGCBVEFH.FFADeBECdBDCZEEABAAB.DDDCSDAE.CBEA.hAAANCAAHEBB.MCBHhACAKCGGABIDLAHB.hABA.cGGDOHCEaAEA......hACA......hADA...,2,-32,-20,12
KeBLJXPcHDUSYQbIdENTFORgMVaWZCAGf,KGAHeEGHBFHELCCC.JDABXBDD.HBFHDCGBSAHFhAAA.QEDEhABAIFFGdAACNBIEFGAEhACARDAGMEED..aHDAWHEA.CAFCfCHChACAPADA...hBAA...,2,-29,-25,4
JIGAEWOQBfRXgLbYNZCKPcVeDMSUHFadT,OCCHBHHGRBBALCHF..NBHGCBFCKGEE...VGBGDCBBUGAChAAAFDFB.dGDH.JACGIABEhAAA.AFCA.QGGHhABA.fEEDXDAG..hACA......hAGA...,2,-41,-37,4
bJDgeaXTSLOGBVRYUPCQZMEcfHNWAKIFd,KAFBFAFBdGEEDEDG...eFFEaAAC...TAABSACE.LCFGhABAOADBVEAGhAAAUGEFCHHDMIAG..EEFFhAFAHCDBAAHC.IDGHJECH.....hBDA......hBHA...,2,-37,-14,23
OAZbXaRPEWUIHNTCVGcdJSKFQLgeMDYfB,XFDHaCFC.RBBC.EAAD.UAGCHDDGCGHA..GDBHJBHHFHGA.QEAHhAAALFBHMFFBhABADIBABGBDAGGF.PAEAhABANEAE..TADDdFGF......hACA.SEHFhADA...,1,-9,-23,14
SIMXKLfBYOQeVJDZaUdTcFgHCAWRPEGNb,RAADGEAH.SAACXEDCLAEABAEBQBDHJFHBDGGBZGCEhAAAaGFFdAGH.TGCBhADAFGADHCFHCBCC.AFCBECDAhACAIHHH.fEGG...hADA......hAFA...,2,-18,-12,6
UPXWLTcQSdNHaABRDgGJFEYfIKbOMZVeC,BFCFDHCEGBBGJFFD.FEEF..EAAE..IAFAKCEF.MICAhAAAZBFCCCCA..UDGDXGBAhACALBAD.TGGEhABASEHB.NAEF.AHAEgAGHhACA..fHGFhADA.,2,-54,-16,38
TdSeUWKDJVMIOHGLRfPNZQYBcbaEAgCXF,XGGGTFCE.dHDFSCCH.UGGEDGBHJAAA.MDCFhADAOHACGBFCLAFAhAAARADF.fBAGhABA.ZCFEBEEE.aCHDAGAHFGEDKAHD.IADFhACA....hAGA...,2,-26,-18,8
gYCSIZeFUBEfKTRNMGWJbPXDaOVLHdAQc,QCBC..cDCHCFGCZGCE.FFBBBHACKHBG.RACA.GFDBhAAAJBGH.XACHDIDGODEBhAAALBAH.AFAFSDHBhABAeFAGEAGE.fAHAMBAF.hABAPHFC...hACA...,2,-25,-15,10
JgDaEQINFeTXZHAfOCdGKWBYbLUVMSPRc,OAFBCFFCGBAAKAAABHEDLGFC.UDAHSAGH.RDDA.hAAAJHACDGIHQDGBhAAAFDHFeFBFZACEABDHdDDA..hACA.....bAGBMABE....hAGA......hAIA...,1,-23,-29,6
AQNgcFXCGEYDRBefOITLWJSHPabMZdVUK,QCBC..NBGEFEAFCABBEBFBDEDHBFHF..OADALHAChAAAJEHH.SADDhAEAHFEH.bEBAdBCEKHEAAAAF.hABAgAGE.cDGBYHBAfGGEhAFAICEB..hACA...,1,-6,-45,39
HIAUYNLDcKGTRbQEWSFMgPdBaVOCeJZfX,UCBCLGEAKFHFGEDATCCC...RAFD.QBGH.SFCChAAAMAACdFADaFFDhAEACEADJEEAZDFEHACCAHBEDIAAbGAGhABA.....FCAF......hACA......hADA...,2,-29,-9,20
YJCeAfcHPVXabNFEIQDUdBTRWZSOGgKML,HAADXFDHaEFGFFDF..EFGEDEBBBCGHRGFGZAEFSCDH.hAAAGEBAMHAG.YCAGhAAAJAGFCDCE..AIDE.PACAhABA..NBIC.UAGH.....hACA......hADA...,2,-26,-12,14
FgGPTHXfZeJbYQWURBEIcKVDaSNdALMOC,OAFEFEGDGABGHAACZDAHJEDH..QEDCRGFEBGCG.ECFHKBDADAGGhAAA..SDAEhAAAAICCCBHB.TCFF.hABAXGAHeFHHWHCE..IEAAhABAaAEDNEAE.MDID.fEEBhADA,1,-13,-26,13
LAWPfKRcBIMJQFHEdgeDaCUVOYTZXGbSN,...fDCDKCFCBFGCJBBCFGGFHEAC.EEFFeCADDICECGBDOFHDhAAAZBEAGAAE.SAGChAAANIAD.ABIF.hACAPGAGIEHFQFDGaFEH.YDDAhABA....hACA...,2,-48,2,50
RaOPZJbFYcdSIeGHTgLNQDMEBKCfXAUWV,VEFHRDEDOGBA.ZCAHFCDH.dGDE..eHFAGDBAHABALAFHhAAADDIBMADEBACA.CAHGACAHhABAaCEG.JHAA...hACA.YFHBSGEAIBEFTAGHNEAE.hAEAKDCB.....hAIA...,2,-24,-6,18
WFZIDbAQNeHaJKUBMVPOYCdfGLgcEXTRS,QDACeFBBHCCGKGDEBDHEMIFAOEEHCDAF.dAEALBCC.hAAAEGGGXBBERAGB.hAAASBGC.hABAFGGGDDIDAHAEaDFC........hABA......hACA...,2,-33,-19,14
CZgadVUEPLRITfFJHBbMNGAWcYeDXKSOQ,......WFCAcFCA..DGGGXCCFKAEC.ODHBhAAAZBDFdDAEEDBFRAGB.fEEEhABAFABGBEHDMIBAhAAAAACDSADG.CHBDaCGGPCCFIAHDhAEA.TGFA..hAFA...,2,-37,-30,7
UFMVaJCgKWeIPBLfZQbHYRdXTcNAOSEGD,OEGHGACBDHGGFGCG.MCFA..VCAHJDDC.KBGC..eBAHBDEBhAAALGAAQACEhABAbFFC.....YFHBhACAXGDD.cDCCAHFBEDDB....hAAA.CFAB.WFAD..hAFA...,2,-35,-14,21
MFUTXgcIQNWBECJReZPYVfDLKHAbSaOdG,SAFBaEEDGBEDFGGEUDDG...TBBBXEBF..ICHAhAAANAAD.BHEAhABACHEDeHAAZEGFVDAFDDDA.hAFAKGDCAFHA.OHAEMBBGcDGGEADB...hACA......hAEA...,1,-16,-19,3
OIXKJNgVAUbYfPHCQWcEDaBRFGMZLdSTe,UCBC..bDAG..fAFGCDGDQFBGEHAE.aDHDBHGGFCBEZFEDhAAASEEB.hABAeAACIBGDKAGCJEGHhAAAgABCAGDA..YCHHWHAADFEDhAEARADB......hAFA...,1,-16,-21,5
RSKODgJadfTLHcCXAUENVWIBZbMFYPeGQ,EGFCVAADBEAA.ZADAFAFD..eABDREDH.KHBCDCHB...aHGEdECAhAAALEBBCFECADDE..hAAAUCFFIGGGMFIF.hACA..PADF.SHAG.hAEAgDFDfAHEhAFA...,2,-36,-24,12
HeJPUfSaCWYMOARgdQVEGBTNDcLZFKIbX,RDAGQGBCEGEG.BBEETGBADDAFZAAAKAHB.....IAGFhABAXBAAHDFBPFFAhAAASDEF.hABACHEFMCCHODFCAHHA.dGACNAIE.FADF....hACA......hAFA...,1,-20,-22,2
EBARfHIMOeGZFYLJDaScWdCTKXUgQPVNb,RGFGHAADODEAeBEEGCBCFFFALEAH.aDEESABFhAAA.dAEDCCDATFDGhAAAXAGD...UEFBhADA.PFABNAIABHBAAIBEMDIFYHDG.DAFAhACAKBDD.....hADA...,1,-3,-17,14
INLeCGAdROQEaVPfJTKSMUBZYXWHgbcDF,dDBDOBDGQAFB.EFECaBGD.VGFAJEHB..KBBHMCAEBGAGhAAAZFAE...XDAHhAAAHCFC..cFCGhABAFDDCNIADCABAAIAA..PADDSCHH..hABA......hADA...,1,-19,-25,6
FIGZBaCVYSXAJgUKDNPcQbTMHdEfeWORL,JDACKGFCDCGD......PFFGbAEFHDCAdAHE..EGABeBHFhAAARDDFLAFDFBBAZCAFaHAGhABACHDF....VACHhAAAYHBGABAG.........hABA......hACA...,2,-28,-17,11
eVUAIJPfabLZScKQTRgNDXBWYEMdHOFCG,JGEAaHBGLDFAZCAF.KAACQDGF.RDCA.NCBEBFCD.hAAAEGFDMAEE.OBBGhABACAGEeCDDAIBG..IBGChACAPADC..fGGBSHDG..hADA......hAIA...,2,-34,-29,5
DLOEIaFNPTHbXeJfBCdQSGMAUWKRYZVgc,KGFCRGFGZBAB..VCAGDDIFLHBA..EAFGaGAGFDFF.TGCEhAAAHDCFeADD.BAFChAAACEDHSHFGhABAAABE.....WFBDcEEDOAEHNCHE.hAEAXABAfBFAhAHA...,1,-27,-28,1
dHRcOCBKPeGYIUZTbAJDfNWXaMQSLVgFE,JFCHDACB......fEECXABHaFEFMFHH.LHDAhAAAFBFEEADA.dBGBHDFAREBBCGACBDAAhABAKGGFeCDF.IDADhAAAUADCbDFBABIH........hAGA......hAHA...,2,-21,-21,0
eKIUPJRTOHADSgVELBCfGFbWacNQXZYMd,DGHHSCFCEACG.BDFACCGHGEDEFAAB..aEEHQFAEhAAA.XBDAZEAEYHEGhACAMFFCeCBG.hADAKAHBIEHF.PHBG.TCBHhAEAAABHLHAAWAEA..hAEA...,1,-18,-26,8
UTLCOPZabWFcYRfBEeNgQJDXdSHIVKAGM,UFGCLGFACGCD.ZBCH.aDADFDCF.RAFH.BAGC.eAHFQACBhAAADDIHdGCDHAEBKHEGMIAEhABA..TEFD.hADAOAAHPEEB........hAFA.WBHH...hABA...,2,-32,-20,12
MFBeQGLCZUbaRNOdcPfEWXYHJSKVAIgDT,DACBMBDHBEHGGEFGZCDC.UBGCRFCC..dFFE..PHAEEEAC..hAAA.XADBHADEKHDAhAAAIBBBFBAFQAGChABACEED..aEHF.cFCA...hADA......hAFA...,2,-24,-18,6
cFQgaSOPLKDTeXAdBJWZHVGNRbIECfMUY,JCAFZGFGGBFE.RGAA.IAAACBCC.UDGGFAGAQEDHhAAA..gGGGhACASEHFLFDBhADADCAFTEAEXDDAAABCBDCGWAFE.NBCEEGCHhAEAfBDF..hADA...,1,-23,-27,4
TWXgKdACOeHRBSZcPGJMYfLEaVFDbQNIU,CECDHFBGBBFESAAFZEFE.GCFAMEBFLDAEVADE.DHDAhAAANBBGUDCF.XFGDhACAKHGGAAHCeACC..hABAcGAC.YCHHaEDD....hADA......hAGA...,2,-42,-6,36
cLgKNWYQBMHOPXZDVdRfaFIGJeUbSACTE,CFCFEGFCLCBEKAGA......NDDC.QDGABCGHHBDCOAEAhAAAXFADVFDFdABDhAAARDAC.FCAA..IACGhABAeEEESEHBAGHDcEEF.....hAIA......hBAA...,2,-30,-19,11
eMGacHSNTKgDBdAQbUJOVCPZXRILYfEWF,QCGCUDACOGDGCAHDZBAG..RACHLHAAEGFB.FCGFeFDHhAAA.MBFDaGHHSAEBhAAATEBFDGBBAHHDJCEF.hABA............hACA......hADA...,1,-29,-31,2
NHaRcFXedKVDWQLSZOEYbICPATfBUgGMJ,BHHGUFGHMCAHHCGFRBEB.FGFHeCDA.dAHCVABHDGDF..LEEBhAAASEAHEGBF...hABAIHBEAFBGTABFGDDEhAAAaGAB..cECAWAEC.....hABA......hADA...,2,-25,-13,12
gcfPeGbOKAQDaTFVRUEWdJBZMXLYNCIHS,aDABVBCF..ECFGdFCFBHFAZBEBLFAH..CABDHDCHSHEChAAAgAGG.hABAPEFAbFGBADAADGIBTFAFhAAAFAHD.UACA.WFFG...MIAEhAFANACFfDGF.hAHA...,2,-17,-14,3
XPSMJeGQOgHIEKBFYAfTUNcCRVZbWdDaL,TCGCUCBCCHGE..ZBGFdAFE.DFEALAED..XACBhAAAMGCGeFHBGECG.OFHHhABAIGAHBEBBAFCA.hAAAfGEF..NIBB.....hABA......hACA...,1,-26,-38,12
ZbefGQSRTcCHgaDELPMBIdFXUYANVKJOW,VDAGJFFBZDBF..eDGDGBBD..QGACSBHBTAFAhAAACABA.HFEBDDFGEHGAhAAAPBAGBAFH.dEFBUADAhABAADAF..OHAAbDDBcGGDaEHD.MCIBhACAIFAA...hAHA...,1,1,-23,24
YgTVIdGJZBNLaPWRDCHEXQFSOfAbUeKMc,UDACMEGF......gCBCVAEGGDEDBHCELFHBhAAAaFBCRAED.DFDGCHFDEACAXCCBhABAFAHH..fAAAhAAAAHGFKHAA.YEHDdHDF...NEEA.hACA......hAGA...,1,-22,-27,5
GNVdUgEILOAaPKWcFQbTXRfCDSMJeYBZH,aAFBKHBGFEGD..QGFG.TAACRAABDDCGJCFA.BHHGhAAAHDDG.NCCE.UFBDIGDEhAAA.ABGCPDAHhACA..bAFEfCHACDAG.MIAChADAZEEFdACF....hAFA...,1,-5,-36,31
GLCFUbdVaTZDSRIMWYNQJAHfOeBgXEPKc,HFDFOEEGBDBC.XGBHKBEDGEAEFACF.UAABdCFF..aFFGDDFEhABA.SGHDhADAMAFA..NBAG.AIFAgGCHhAEAEECDLDDAVAFG......hAFA......hAIA...,1,-15,-27,12
PdYBZASegbcKUaLONEVJTWFIRGXHCfQDM,eCCH..bEFHUBAHLAFCEGCD.VBBETFDC..IEDGhAAARBEE.HGBGCAECfGFFhAAAQEABMCIBhABAdCGHBADBAHIBSDFA.KGAF.ODADhACANIEH....hADA...,2,-16,-2,14
PLDKBeRWFYMXHJGZTUEcSgQIfaVCOANbd,dHBHLFCHBBDEeCADRBAFFCDD...MGFEXAFEHCEGGFADhAAA.UAFHSGEEhAAAQBBCfGAHhABAaHFECEHAAEEB.PFHBDAID.KACC.WEFE..hAFA......hAGA...,1,-5,-29,24
UbaKOZQDGCTXHcLfFEPJYWMAVBdeRgNIS,dBBDeFBBRDEG...ICAHSHCA.UFBEaBBAZDDG.QAEChAAADDGACAFCHFGBfEGHhABAFDAC.PHDAhACA..WFFDMAHFAAHHBABBbCCCKGGC..hADA......hAGA...,2,-32,-12,20
QRebVWAEITScLUHPgXFDMOafYBKJdCNGZ,TGBCLCCH.HFGD.XABGFFEEOAAEaBEB.BDEE.JAFFhAAACGACGBFCREAA.bFEDhAAAAIHESAGEhABA..cDAGPEHBDBIBfDDEhADAKHAA......hAEA...,2,-33,-1,32
QDOVHAJSMPZXeUKIFYRGEaWdcbNTgLCfB,MEGFXFDHUACGFDCEGBAA..ECAFdFDE....cAAGhAAAbAFE...TCGBhADACGACBCFBDGBBODEFhAAAAFGCSFGA.eBEBKFHB.IAHHhAEAaHCC.WFAF...hABA...,2,-27,-18,9
QgJKLFdfbMGTUZeAXcOYSVWCDHEPIBRaN,XDACOGEA..SBDDCBBCHFBAEGHDBFBB.RAGF.QDEEhAAAKABFFDAA.dDHEMFEAhAAAUAGEAIAE.....hACA.cGDHYACCDCIDaEAHNIBDLCDDhABA..fDFBhADA..,1,-9,-27,18
gOYGRKJLIUDaXcbPSWMFNCVEAHfeTdQZB,HFDFeDACdAAFQCCFBAGC.OADEGEBHKFFCLHBGUCGCXGAEhAAAPCGFSCCEhADAFABGCEAHAIAA.fFHChAEA.........hAEA......hAGA...,2,-21,-19,2
QJXYUbcAPHWNGIaCDOdSVgEKLfMZFBeTR,HAADGAFEaGAGOFHDdFEB..SDFCVCAGKGFELFABhAAAMAECBDCAeCHFQGEDhAAAXFDH..bBECAABF.hACANBIECDAGDAEF.fEEBFHBE....hADA......hAFA...,1,-1,-13,12
gXDKVPUFGMfZLCTWHYJedEBQSNcbaAROI,RFDFOGEA..XCFAVGBA.FADHMCCBLCBF.CGHD.TADGhAAA.HDFEeEEGhAAABDAGNEAA.aGABABBEDBIBhABAKBFGUDDE..fFCAWABFdHFD.SHBGhACA..hAEA...,2,-35,-5,30
QcaGXDFHLbAPUBKEZVJSdMgORCNeTYWIf,BHHGKEHBZBBDSAGBdFEH..OECDRFBFCBBD.eAEG..TGEEhAAA..YCFEhAAAICEE.fACBhABAQGAGGEEBDGHHFHEELEAChAEAAACAPBDD.EBAF...hAFA...,2,-31,-17,14
fKWSMIOZcebTVLaPdCABRXUgNHGDYFJEQ,BFFCXDCBUAFCHEBBDBDD.FAEH..EDEGQEFG.fAGAhAAASDAFMDIHhABAIHBD.OHEEhAAAZFDBeCAB..VECBaAHDCHHHAABC.gABFhAFANAIEJFHF.cGAChAGA..,2,-42,10,52
HGYTbXEZQOIfUKAgVNWLDeJRcCSPMdaFB,VAADLGEA.DBGFJFFCRAAF....CHBF.MDDEdFGBBFDCGGAF.hAAA..TADCXEEBhACAQAFC.hADAfGEBAAHGWADHSFAGaEEGHDAC..hAFA......hAGA...,1,-6,-43,37
gVedAEMQaOfZGLRcPDYbHJISCNTKBWUFX,MAEDQGGD.ODACZFFALHBE.RDFEDIFEbDDHIAHChAAACFACKBBH.BAFAFCAH.hAAAXFAB.eBAChABAACFBEDDDaCHF.cGCCPAHBHDFFSFBAhABAWCCE....hACA...,2,-30,3,33
IcMCDgAaHbJQSUfLZGOWXEdBNYeRKPTVF,aCFCHFDF.JEAEUECGZAGBGACH..XEFEdGAHBEEBeBBAhAAAKGHD...VGEAICAEhAAACGAHABAG..SCHBhABA.fAFFOCCCNCIE.PHBChACA.FEABMFGF.hADA...,2,-26,-17,9
XNZIcaKCbDUVBfWFSYAMJQTgGLEdHePRO,MIFGJDCH..QABGTACG.LHDEHCEDRAGFOCAFZEFEIGADhAAAKEGGCAAF..DAEEBHHEhADAFGBFACCFEBDA.eAFEhAEANDDA.aCGG..........hAIA......hBAA...,2,-20,-19,1
FcBMVGPCLWJdgKATeZNQROYHXDEaSfUIb,eADGQFDHRBCGHDGHDDFFECFF..aEBASAAFUCGA.IHCDhACAFCBGMIBE.VADEhAAACEEDJAHF.KGHHAAHC.NBBA.XGGEhABA..fGAABACF..hAFA......hAGA...,1,-15,-20,5
eIYDLfKRQMUZJAcBaSNCOdHGTPXbEgFWV,aEGDCFEDHBBGGFBF..XFAGEBAC.FDEGeDBEDIGE.LADGhAAAKDGBRAEE.MCCEZFCFAHHABAHBhABA.NEIAOHBChACAdAAFTDAAgCFH......hAEA......hAFA...,1,-6,-21,15
UHGZWSbLPCJeQXMEOBgYfIaRNATFDdKcV,DDFFdAFBKHGEUGCAHDFGZABB...SFGGLAHHCHBFeFDB.MACFhAAABBAC..fADChABAIBEBRFGFAECCTGBDhADA..FEAAGBEB..WBGFhAAA......hABA...,2,-45,-3,42
SLQRbcfWBaUAVeEMgJTZDOCKPNYFIdXGH,VDEDMEGF....TDCDOHFE.KAHD..NAHG.FBAHdAAFGGAHhAAALGBAQCCChABAbFED...fBEDhACAWCCCBAEFAIDA.EDAH......hADA......hAGA...,1,-22,-29,7
fNZORgCLSUdFDMIVKXEATYcQHWbGJaPeB,TCBCQCBC.HABGGEFGaEFDeBHDNAHA.RFCD.LBBEhAAA.SGCHhABAdHGDDEABIDEFKFAAAIAGWAEHhACA............hADA......hAEA...,2,-26,-19,7
LXPZgIUdFJBeDRCaWSNKAETbHOcMYGQVf,TGBCHFDFMDIH.QBFAVCCH.XGGCZBFBUFFFJBBCeADChAAADBAD....RCAHaDDBhAAAWBAFKFADAEHGOFDFhABA..YEECLCBD....hACA......hADA...,2,-17,-3,14
UfHgdXBMJbNYEFOCeVAaZKGDTSIWPQLcR,aEHBKBBDGDDF.DIGAIGFA.QAACREBBHAFCXGFChAAABGABJADB..NIAB.hABAEDEFFADHCAFEAIHE.SHCChACALDHB.fFCDdEAC.YAHHhADA.eCGF.hACA...,2,-20,-14,6
bCXZWKBAeUPTcdaJfOgSEMHGFLIQYNRVD,eDACUCGC...TAACaFGG..OBACSEDHEADD.MBIBhAAAHGDE.FEDEIGFDhACAQGAENEHA.DAFACDFHZFABhADABABEACEHdAFFJEAE........hAEA.fHDDhAIA...,2,-20,-20,0
KBICDZERdHbaPYUeXAWQfNSLOgTJFGVMc,QCBCSHBGOCAFJFAC..VBDCKFEBCDCA..DBAFEAGCdEFGhAAAHABA..PDHFhABA..eDGDACHA.hACAfGCBLHDEgGAG.hAAA......hABA...,1,-18,-36,18
RfbLQMPTEVWFSCNJAaYOKeIGdgZDcHUBX,OCCHeCCHdEEFZAFCHADABEFGRFABLHFA.MDIDPEHBEAAC.hAAAFACG..CCGAAAHFaEEHKDAFhADAGGAFDFDB.XBEChAAAfFGA........hAFA......hAGA...,2,-29,-10,19
CMVPIDOKgGAdWNBTXHbLJUSYRZeEcFQaf,dHBHBFDGHBAHJEBH.SCGGZACD.EGFFQCEC.CAAB.hACAPFCE..DIFGhAFAKDDGAGAH.WEHF.XADEhAAAUFGHRAFE.FAGCfDHAMABE.IHDHhAHA...hAIA...,1,-20,-36,16
cgGJbXdIUeRLCVDSAfONTWZaYHMPFQEKB,OGEATCBC.ZFADHGDEFDGH.EBCGBCAG.GAEBJFBEdBHG.eAFDhAAACBBA.DFGGAHID...fHAHhABAaFDH..hACAMEAHKDEGcGGEXCDC.ICHEhAAA......hABA...,2,-37,-3,34
IAgQcbLJXEaZBDeWfFPCYNTGHUdMSOVKR,QCBCLGEAEDGDaEDCZAFG.BBCGDEIBeFGH...FGABCAAATGAGhAAAUAEDMDGFSCGEhACAOHCAKAADAGFG.hADA.gDBF.bEDC....hAEA......hAFA...,1,-24,-26,2
LJgWKFVcdTbNaDPZXeHMfRYACSQEBIUOG,CFCFQFCEBEHE.UBDHLHFA.JDDEKAFC.VDAAdBCB..hAAA.TEGAaDAGDBIFXGGAhABAHEFF.MBIDhACARGAEABAD.SEEHOAFA.WHCG...hAAA......hABA...,2,-33,-11,22
OCdLRJIgbUGVAfHDKZPaeWQNTcSXFBMYE,DHCEKCFCZDBEeBGH..QEFE..NAACSEEHhABABACEEGBACAEC.RBDG...JAAFgDBHhACA.UGAChADAAIHAPHDETGGEFAHFMAFE....hAEA......hBBA...,1,-23,-37,14
DRUaBgFCZOHJAdWQcePTNbGSEMIVXfLYK,QGBCeGEA..PCHHTBEEGFBBEDAC.MABG.XCEHhAAAYEEEDDCBUABGhAAAaBCGBHBHCGDBHGFGAIHGdAFBhAIA...NBBE.SAGA.fEBFhAEA..hAFA...,2,-20,-8,12
GYdAJCSNTHBbLgVDXWRKcOQPIaFfeZEMU,SDABHEFHBCBHLACADAHF.XDCAKBCDQGGGhAAA.ICFHfGCEhAAAEEFGMFAFYCFEhABAJDDBCHDH...bEBDWEABOACGaAGAeFHHhADA......hAEA...,1,-16,-23,7
KQTOUGBgCSbVIXaeEFYRfZMLdJHANcWPD,...NDDG.PGEA.QFBDUBCFBEEACEFH.SAGHhAAA..bBAEXFADhABAEABCRBEEMIFEdEABAGGHDDEBKFHDhACA.OHDE........hADA......hAEA...,1,-23,-36,13
fJcDbARYZLGSVMEFBaTXCINWKQedHOUgP,RGFGZFDFLBECGCDDSBBDMBCB.BHHATDFA.CDDH.IFGGhAAAKFCG.dBEBOFAFhAAAUFAE..fACGhABADCIFAEAGEBAFaHDCNCIG......WHAAhADA.....hABA...,2,-30,-17,13
KSPDOXEZIVMbcYTgURACFdQLBJeNfaGHW,CEFAdFAALCCEBHBHeCFF..aBGHHDGDKAAF.SBAGDIAC.hABAEDDFIGAH.hAAAMCBDYFHB.hACAUADHFGGEJADGfAGBPDDD..OHCGhADA.....hABA...,2,-25,-24,1
aXEVfBJNLHOQeRMUSTICKDAZFWPbdYgcG,ZDAGFHBG.....PHDEdCCH..gCGDGAGEEAAGBDBDhAAALFEGHFCGOADGhABAQADAMFHFTGAEhACAKDEBAHAB...........hACA.WBFE...hADA...,1,-24,-28,4
UISVHPaQBAEFgTDeNYLdJWGKOXfCZMbRc,EAFBTGBCDEDG...eACBLEBHdGGDGBFCKAAFOAHBCFEH.ZFDAhABAMEBC..bBCCcADFhAAA..IHEHhACASBAG........hABA......hAFA...,2,-31,-27,4
INYFJCWfbTZKLXcOeGEadAVQRBUHPgDMS,QBBHBADCUCFHHCBGDFGB..MEHHSGBG..YDFDhAAACGHC.fFAAhABATAACZFFDKBEAXECAhAAAeEDBEGBHAIAGRAEEPAFANCAE....hACA.WHCA...hACA...,1,-12,-24,12
aJDAgLbCcIZUEOGSWfBFKYPQNHXdeTMRV,LGEACFDGZAFA.EDDHGAAG..fBACBFHGFEFDKGAAQFABhAAAHCDDdEADMBIDhABA.RBFDaFGAAADA.gCBFhACAIDHFSHCAWAEC..NIAF.hADA......hAIA...,1,-13,-32,19
eCObAfLSUNJTHYIVDRBPEdaWKXGQFcgMZ,SDCDUDAC..NAGE.TDEBHAAE...IAGCDDDDBEGHhAAAEHGCaFGEKHECGEDEhACAFCHHMEABeAEFCCADACGFLHAAhADAJBBC..RFCA.dBHG......hAEA......hAHA...,2,-16,-11,5
FdRPfMUcDLaZOTWKACYeBHNbEXgSVIJGQ,CAFBeAFBBDGBHFDH.EDEGSCDH..VAACJFCCFGGAdEAGfDCDhAAA.hAAA.UBAFDAHDaGHBTDAEhABAKCHBADAE..YHCCNECEXFFB..hADAIBHG..hACA...,2,-53,2,55
JbHfFGELBdSIQgTRNMDPKXWOAceYUaCVZ,eGEAaGFCZDAFHCAD.FFCFECDDdEGB..QDGFRAEBDBBEKHBG.OGBEhAAAAFFH.UAEHCDEG.JAHBhABA..fBHEhAAABABASHAG..IGAFNFCF.hADAMABE.WHFA.hAFA...,2,-21,-20,1
YZVFcKWAeIREBOgDbGafdUMXHNTCSPLQJ,eFBBRDAGBFFDOCCCDBHB..GBADaFGHdAFFUGADHBEC..CEEC.LBBDhAAA.JEEDZEGFhAAAFDHHKGDDAGIB.EADE..hABA...fBFANIDB....hACA......hAFA...,1,-13,-33,20
HKZeIUNGdgbRfEAFVXPBJQLYcCaODTWSM,XCCBBAFBQFDALEBGCCFH..DIBGSGFAHCAFZACDeFGDhAAAUGBDdCGC.bAEBfECFhABAAABD.FCHHhACA............hAHA......hAIA...,2,-30,-23,7
VWYGHIAebMTgKSPRUBDZaEdfCOQcFXNJL,MDEBKGFCRDBGBBCDDGCHZAAF..dADF..CBEC.QGDCFHEE..hAAAXDGEJBFD.LFAFhACAVGAE...hABA..YEACICAFAFGFTBGGPEFCEAGEhACA.....hADA...,2,-40,-23,17
LMCBbWJQdKXHIcfAZTSNPFYGOeDVERagU,SDAFFHBGOECC.DGEHRBAG...UBGGMDIHCHGB.BHEF..JBBAhAAAKCGBHDDG..fFGEhAAAACFATGAE..hABA.PEABeFHBEEBEaBED......hABA......hACA...,1,-29,-34,5
gPMSTbfHZKWFUcOaRJdIGeXABDYENCVLQ,BAEDDGHHEACGCGEGLEDG..PDFEMCAF...TGCGhAAAHBBAKBFGFAGHUECHOFGDhAAAaFGBdHBHGBAC.hABAAFAH.NAIA....gFAC.fDDDhACA..hADA...,2,-31,-19,12
KVHfWCPdBTUFNMeEgGYcLbISOXRJADaZQ,aEAEKDAFHAAB.CHHGBAGDTFEG..FFDHMICG.eCAGECDBGCGChAAALAED.bAGFSFFDhACAOEFAXABAhAAAACEGDBIDZEBB..fHGB.dGBFhABANIAF......hACA...,1,-12,-19,7
ULHIZTJMYOcfbPWBReCVGdgASKDXNEQaF,DGGDEGFCFDAGHADC.ZBBCMCFDODGD....fGCDhAAA..WEAHeBAGCGCBdGEEhAAAAAFDSBGDhABAKAGC.NDIGQGAG.aDDHIDFDhABA.....hACA...,2,-35,-25,10
PKdVRETLFANaYZMUJCeBfGcSbWXQOIgHD,aHBGZFACJBAEBEDC.GBEB..SBHD..WFDAhAAAOFHDHBABDCEEdEADVEFBhAAATACHLDCChABAFEHB.AFBGMEEHCHDH.eAEAfGHA.hACA......hADA...,1,-18,-25,7
gEXISHLCTPebQBGZJKfDRdONYWVFacMAU,EGFCSGFCHAEACDEE.eFABBHCFGCDDZBABKEFADEGA.RCAD.dADCOABChAAA..NEIE...hAAAYECBFGADaCGFMEEBhABAAIDA...........hABA......hADA...,1,-19,-28,9
QSFfecagJUHDAMZTBYROCGbNEdKILXWPV,MEIBTADCRCFA..GCDCEAAD..KFEHXCAF..PCHBhABASGADFGGFfAGAhACAaFCDJADA.DIAEBHFAhAAA.CABAdFFFWDCC.QFAH.hABA......hAGA...,2,-21,-21,0
TAeFgaHGXNSQRbPMBcDIEWKdYCZJfOLUV,FDCDaCFCGGEF..SAHHQGBBRFDHMCAGBEDBDEGAEBEE.hAAAdACBZEAFJAFCLDGHhABAVBAH..AIDG.eFHHhACA............hADA......hAEA...,1,-24,-25,1
IPAFGTDeLXJWERHgCcVBMbYNUZfOKSQad,GBDBTEGD.DFEHeBADLCAF.JDBEEHDA.RDEHCCGBBAHA.MFIHhAAANAEF..UGGHZFEDKGAHhABASBBA.hACAaBGAIHGG.AGGEFDGAHFBH.cCDGhAAA.....hADA...,2,-27,-4,23
RMPXTYGdNeWIBJCHSfVAFQUgcOEDLZabK,FEHBQCGCUBAE.OEFHLDDDZAAFKACFMHBC....XFCBhADATAECdEABNEBG.hAEAeAHDBHGEHFFBfEHChAFAAFFD.EDCAaEEGRAEA......hAAA......hABA...,2,-20,-10,10
gGKZcQLACdHbISJXDMOTWPefYREUaFVNB,dGFHHAADSEEFDIEAMEFD...OBECTAEGeABD.RFACECHHhAAAUECD.FGACBADGGACEhAAAKCAD.QDGBhACACDFEIAHC..........hACA......hAEA...,2,-29,-13,16
eASNUQCMLOVcJXgFbEKWRdaTZYBGPDfIH,UGBCMEECLBEG.OFAAVEEFXCAGFHGE.KEBCdHDBhAAAZAFFGCBF.fFFDhABAHBCGAAHEQAAFhABACACA.........hACA......hAEA...,1,-24,-27,3
ZBaAUfeRVTMDCIdEgLHQJPKXcbOFGNYWS,UDACeFBBRCCGMAAE..CBCFdEGFEFEA.HAFBQGBEKFGH..XAABhADAOAHBNAGGSFEBhAEABHFH.AHIH..hAEA.fCECDAIFIHDHLEHH.hAFAJBBEcECC..hAHA...,1,-14,-27,13
TQCVXRJGFbfZLeaWdKIDHBASgOUPYMcEN,OCCHUCBCMIFA..ECGDQAGECBFC.REEBGDGEFGHBfFEBhAAALFAFaCAFKAAFhABAHFAABCFE.AADCSFDDhACAYADHNBIG.XBDFJHCA...hABA......hACA...,2,-25,-5,20
GPbcTKDQCFAIOYXZegNBRaHfSVJMUdLWE,OGEAZEFHeCADBAGCRFBAHAFA..VACGMIDELBHHGBBD..hAAA..PDHBbCABTGCDhABADABC...CHHFIDDBhACA.XDFDaGDEfEDBhAAAJFAF.....hAFA...,2,-20,-4,16
JBNcPLFSMgCeZWQOaKUYARDXVfbGdTHIE,RFEEDEFA..XCAFVCBCGAEBdAEGHDFA.EAHDBHCA..NADELGAAhAAAMFCACACGZGFAOHCEhABAKFAGAAEC....hACA..fAAEIFBF.....hAGA......hAIA...,1,-10,-35,25
QFHJaDRWYEMBSdNLgbZCATXecVKUGfOPI,TDCHXDAC..eBAEKBCHUDGEGAGC.OFGBQGCFhAAAFCACaFAEDDEF..RAEFEGDBhAAABBGEdFHAgGGEhABACEACAEFF.fCAD.IGAGhACA.WFEH...hABA...,1,-8,-22,14
cZMIGWRTdVXUFJYNDQHSPBeLfACgaKbEO,aEGDKAFBEHBEZAAE..GEAEREEB..dBAEVAFDUDGD..FDCGJHFGDAAEhAEAHCCFBHHGLFADhAAAADHE.CACF.OEFBhAFAMAEF.....IFDC...hABA......hAFA...,2,-26,-21,5
VXRDQELcWgUdGFMYbePaJTCKHAOSZfBNI,ODCHSCFCBEGE..VGAEDFIFLHBG..gGEGhAAAUAEDdBADMFFBhAAAbEEE..aEAECAHBAFAANADCRBAF.hABA.EGGF..WAEF.FAGEYDDHhACA......hADA...,2,-36,-10,26
RKTLJFBebVcdOQPAXSWCaGUgMIDYZEHNf,SGFCaEGDGFBFUBCFMIFE...DIEGEAGGHAGHRECDLEFEhAAABDAAeDDAVFAFdAAEOACDhABAAFFACAFC...ICEFhACA..NDIE.fAEB..hAIA......hBAA...,1,-18,-20,2
PATBdgVEQfCSZUGDJXNFaMcRYKeHObWLI,TGAFdEGDEBFH..CBDC.SECDGEDCDIGEJCAG..FAHH..MEEGhAAARBADKAECOBEA.hAAAbFFC.LHDAhABAADDDBGHE............hACA......hADA...,1,-26,-40,14
eWGUJTCNYaSEFPKgIHbBcdQDZXfOMRVAL,LEEGGECFJAAETDBH..CBDF.aAGDFHEA.KHAEHFAE.bACFhAAAdDHC.DEAH.ZBFBOAEFhABA.VGEEACCH.hAAAWDHB...NIAFEBBH.....hAEA......hAFA...,1,9,-45,54
HKPCFLMYSAWETVfgGBbdQZUIXRDJeONca,TGBCVAAD..GECEBGGGdAHCUCEFRCEBDCCC..JFFA.eAFEhAAAOEAC..aHEAHAAEhAAACEAC.FHDE.MAGDhACA.AADAEEGAfGBG.....hAFA......hBEA...,1,-21,-26,5
VJAHafdcOXUMPIDRKLYGbQeFZENBgSTWC,HDAGaAFB.dGDHOEAFXAACUCEF..MIBGDGGBKBCFGDFA.hAAAeCHBFDHBEHCEBADC.hABASFBDCFEEADDH.hACAcADE.........hADA.IAHG.hABA...,1,-19,-39,20
dBNcMLgFJKPQfIZXUeETaHbOCSYVDRAGW,dGAHBFDGMBIHFCAHKEFH..QBBDZAFH.UAFBTDDAHDEEhAAA..OFCHCDADVFGBhABADCCEAHDH...NBIC.cEDChACALABC.JFHF.....IHEEhAAAEEBH...hADA...,1,-16,-32,16
CTfcSMUYWgNOPXGZbRKAFIdDeJELaHBVQ,FAFBdHFHJFDHLGFC.HCBABCDACBGH...TFFHSGDDhAAAUDAA.....gDEAhABA.NCAAOBBAhACAPCGDGABF.....hADA......hAEA...,1,-26,-44,18
IESMHGLJRVPOaWBdfFKCgUADeZXQNbYTc,DGADZAEGQEFH..YDAGTEADECCEMFEDLFDFhAAAJBDA..RGFAODFFhAAAaGHDdABHKCHDUABEAIFCXGAAhACA..cGBG.SDHBhAEA....hAFA...,2,-36,-3,33
TBRgESYQJdLcNafOHDXUMZPVIbGFCWeKA,TGDCRDBHEGDH..QDGEJDGF.LAEDaECHHACBDABGMIFEhAAAZFEF...VAEEIBBBhAAAGBAECHBAKAGFADECBFEBhABASGGA..YEAF.hAHANBIE......hAIA...,1,-1,-24,23
FGRKNADCEcMLdHUQTfZPYIWJVXaeOBSgb,DFEAEEGDLECHUBDG.QDAEZFAD..IGHCJBCCaGGCBGADhAAA..gAFHhAAAFFEFRAFCABAH.CCBEMIDGhABA...TDGEfDDB..hABA......hACA...,2,-41,-25,16
dHTLbQSfCKUWDgOINBeGJaAVcXMEFZRPY,XFDHFHBGRBFF.dBFHHDAELDFBQFEDCGHB.UBABDCCFOCAHhAAABAHCeFAA.JFHHhAAAaBDHADID.MIFA.PHAEhABA..........hACA......hADA...,2,-30,-22,8
cdEWIaZTVLeMSDfJbGRHBANQFKXPYCgUO,FGFCXGBCCADG.UABEdBGD..EFDC..aEGDZBAHLECG.hAAAMFIHfHBFhABAGADFBDDCAHEHQDFBhACAPHDEOCGBIGAE.eCCCDAGG...hAAA......hAEA...,2,-23,-18,5
ZNaERTdMbCABLPWIVXFKeYHUSQfOJGgcD,BAFBLGEA..ICFGFFCDeBDDHBACSBEE.QEFChAAAJCHBGECDgFAFhABADHGGNEAE.aDAChACATADGMAIBAEIBWAACKBBF.....YHBEhAHA...hADA...,2,-26,-17,9
EJADTLQMeagbZKHPBcXFVUIRWSfYGNCdO,DECDTDCHLACB.QFGFMEGFaBEFZDADKAAGBHCD.FBFChAAAIABG..hAAARDEFSAFEhAEAfGDAYAHBCHFHOBHDADEBeFHH.bAFB..hADA......hAEA...,2,-25,-22,3
gBbVEHXTfMKAGdRPYUISOLFQJeDWZNaCc,dCAHRAADUGGEOCECLFCHFGEF...eFEFDAAEZEBH..CCDFBEAAhAAAEAGCHABC.XFFFhAEAfCGC.MAIFhACAAFAF.GADFPDDBIDECSGAHhAFAQGAFNCIE..hADA...,1,-12,-22,10
DCgZYWEALTIaNVeHMfRcbGSXQOUBKFdJP,LDACaGFC.eGEAMIBEREBEGBCFQEBBBHDDKAGFFGAEdBAGDAFEhAAACEHGZDDB..EBAAAEAD.hAAA.IBCD.hABA.NBICfFEFSHAC.....hABA......hACA...,1,-15,-31,16
PaSYDLWAbNXcITgFGKdZeCUQfOREHVBMJ,XCBCTCBC.FDFGdBFB.ZEBGUAEC..fBCDRGBEHEFGMBAFhAAAJGFC...aEDFDGCEhAAAAHHA.NICB...cBGAhABAIBAF.KDECCAHB.EDHBBEBA.SBBEhACALEAD...hABA...,1,-10,-22,12
KFdaOMJSecTDfRgPICUQEAHLVWYXZbGNB,HDBGLFBBVGFAXCBFGBCDBBGB.FDGAdFDB.OEGFhAAAMAABeFBFDBEFRAFCPFAHhABACBBCEEFG..AEAH...hABAWHDAbFDD...aDDC.SCADhACA......hADA...,1,-1,-24,23
ULOFcSaTCBDPRHKAVZIWdEXGQMfgebYNJ,VGFGZAADdEFB.EFHFQGCB.MEEAeFCF...bFAFJBBBhAAALAEGOFABFECChABASGGD.aGDDhAAATBFBCCCDDGFBPCEEKADCAEIH.....hACA......hAGA...,2,-24,-10,14
bfHgSXaUADTRLIKVBWOZCEPFcGMJYedQN,DEFARADGKFGCBCBAZFAD...CGHG.FDDBGBEF..JAAGdGAG.QDCHhAAA..bAGFhAAAHACA.SFFDhABAaGDEADIH.IEAG.WDHBEGHFMICEhAFAeFDB.....hACA...,1,-28,-36,8
HYXDbaGEeMWQfgACFBJPKITVRLSUOZdNc,FBEEBAFBKEBE..TDCHREEHLAEC..OGFCdDHAHAAFXCAGhAAAaGHF.GBCHhABAMADB.fBHChACAAGDH.CGEFIHBHSHCANFEFDBBEEGGB.QEADhADA...hAAA...,2,-26,-9,17
DJOgcQSBaKZLdWfTFeYNbPCAVMXURHGEI,VFEEXGAB.HFCBECEF.DBAE..JAFGOFHB..gCABhAAASEEBKABGdDBEhAAA.fAEBhABAeFABNCIE.CADGAAHCMCHF........hABA......hADA...,2,-31,-23,8
DgSWALPcIfYVbdGMOKUERTZXHFaQBCNJe,LGEA..cGDEfCHE..bAEBdAAAGECBhAAAODACEACBTFAHZDAH.hABAXAFGHDGHFHACBDDBhACACDDF.NFEHDGIFgAGFAAHAIADF.MFDFhAGA.....hADA...,2,-9,-7,2
QaFbfcNRIdgJGSUCKYLBVXAEDPZMWOeHT,EHFGZFDGOCEDHEDBaBFFFFAD....fCAFRABHdAFFGCGEUEAChAAACGHH..LAADhADABHBAAIEAMAFGeEAE...hAEA............hAIA......hBBA...,2,-27,-18,9
gaYDFcIEUPNRTeOGHKfBZJAWLdCSQVXbM,dDCDCFCF.SGCEQAAC...XBFGMDFBaACGDADFFGGDEHAChACAUAGD..NEGGRDDBeBCChAAA.OBAFKAGABEHFhAEAAHDBLFAF.......hAFA......hAGA...,1,-17,-33,16
ScGQOCNYMdFWXRDEZUVBIfKegTbHAJaPL,aDCDSDCDGEED.OGBECBFD..MBIDFBAFRBFDDAABZGFA.BADChAAAKGDA...eCCGgDAAhABATEGAAGAALCBChACA.QGAANIBHdAHAEAEF.IAGFhADA.fADFhAIA..,1,-12,-17,5
bWeYSTfDgCLGIXMZOHAERdQUaKNVBJFPc,EEHBQCCBUCCE.aEBCKBFA.BEFBFEGB......cABAhAAAeGAESFFGhAAA.DICALHDEhADAIAEHZAFGAHHD.NCIE.JCADPGAA..WDFEhABAfEEECAHB.hACAMAEE.,2,-33,-28,5
MCPYROKIaNLZGEUQSATcXWVbgDdJeHfFB,TCGCXCBC....VDBCDFGBdADGJGBG.eDHFHFFCBHDGMDAHhAAACFDGRAFHKCAE..aDEDLBFEhABAZFAB..EAAEhACASHAGAAFF.bABA.....hAHA......hAIA...,1,-5,-28,23
NOgBLcXGHPdRJaCKTeAWbFSEfQDUMVYZI,FHBGSAFBECCA.DGHDUFGA..MBACVAEAZBCG..ODAChAAALHDE.XDFFhAAAPGDA.RDDDCEAFTCGEhABAACAG..fAHEIBBEBADC.hABA.cEAD..hACA...,1,-24,-32,8
dNLSADeCEVbYBXHRafZKQOMFJWUcPTGIg,CGHDECFC....VEEGBBBCHAEARADAZDDAQDBE.OGAAhAAAJEACUFFF..TGDHhABAgGAGLCBChACADIGE......YDHHaAHFfACFhAGAMAAC...hAEA...,1,-7,-39,32
gFZEYPGSXWBHLeCbaRDMUTdIfOcQJAKVN,KCFCVAADFACG.ZGFEEDCA..GECA..SFDEBHBEeFEEhAAACEGDaGAGDBFE..UCCBhABATAFB.dHGH.fDGBhAAA.OHCA....hACA......hADA.QADA.,2,-40,-9,31
GLKRSWQNXCcOdfMAbaHEePYBTIFUDVJZg,aCFCHDED.eCCBBFHGTAFHUDAC..DGCBJHDEZAAELCHB.hAAAKBACSAGFhABA.QEEBhACANEAGCDBG.....OHEAdADEAHHGPFCBhAAAFAEB......hABA...,2,-30,-13,17
FWKIQXfcdYHATeRCaLVZJDENMBPOgGbUS,eADGaBBDLAHFZDBCEHEG.BEHG..OFCDGDEGUGAGFGHBKGCBhAAAQCFA.XBBBhAAAfBEAdFFFADDGhABACAFEDEBEMAFE..bEACSGGGIADF.hABA......hACA...,1,-4,-29,25
VSGaTQLJDHKgIPURAXfEbedcOYMWBFZCN,EGFCdDCDOHEA..MAGBFDFEZAFACDHFSHAGGAAC.QEEFhAAALGACDFFCKBDH.hABA.ICBHPHACAAAFhACA...XFGAfFADeAEDWACChAHA.BHHG.NDDA..hADA...,2,-26,-17,9
RbfXNYaABUCQOJdgGEeTPKMLcWVHZDIFS,BFFGQABHOAAFJEAEdBEG.GGCF..EGABeDCBTEDEhAAAKAGAMCAHLFHD.hAAAWBGFZCGFFHGE.SGABhACAbADF..fHCH.hADANAIEaGFDACCECEFB....hABA...,1,-12,-22,10
CLVNfXAEdaIOFSgTKMZBceJDUHGYQWPbR,aDABFDCD..SABDKBCCBAHG...eACCUFBCHGFCGBECQBFFhAAA.WEFEhACAPFHD.CBAD.NIAH.AIDAECCBhAAAdGAHOFDC.MBEFJDGBDAGF..hABA......hACA...,2,-33,-3,30
OWKMSIBdDJNaUfHVTQeFGZgAcbRYLCXEP,RAADLAFBCFEH.EDHFODGDKCDD..SGGFdCEHDFIB.JDAFUGBGhAAA.HACEQABGhAAAFEAG.ZFCGAEFA..hADA............hAEA......hAHA.YHCG.,2,-40,-22,18
gTXPABJKEDLVdSZRcaGfNeCWYIUHQMbOF,KDABLEACdBBDZEGBRADHGFCB..eFCBCABG...IFEDhAAAQBGGOAFD.hAAAFHAAXGAGBCDHDAIDhABASGHH.fHEFWFHH.hACAYEEC.MDAEhACA..,2,-40,-16,24
aWKZYGAfQBODJIcURVLHMXFPTgSCdbeEN,BHHGDBED.JBGFUGCA.RCCBLAABHGAAFBDH....TDEHhAAASEABCHFE.dEFBEBAFhABAaAFAKEAG.GFCBhACAAIFGOCFE..IAEAMGFE....hADA......hAGA...,1,-25,-33,8
HAeEMFgWDbIBJVUGYKRQTSLaXPcZdfCNO,MEGFFHBGDCCABGCG.UCCAKDFHRAFG..QDAELEHF...hAAAXFDAZFDHCFFDHCAAhABAADIDEACG...gAFFhAAAIACG.JEHF.......hAEA......hAFA...,1,-26,-37,11
MFBbILYVGZECHPdWQNSRTDfOcaJgXeKAU,MBDHBFEDLCAFGEFGEGDHCDHGHDCH.dCCFQFAGRGAC.hAAADADGfAGHhABAaCECXAABKGFAAIGEFCHB..hAGAbCFF...........hAHA......hAIA...,2,-24,-19,5
ABTXKRLCSdJOQHMWGPeacVEIgFDNUYZfb,XABHKDBDRAFFLABCdEFB..OFBGMBIB.GGBBeHEAaFDDEGGEFBEGhAAA..DDFHNDAHZAGFhABAAHIBBFHE..SEADhADAQDCC........hAAA......hAFA.PHAC.,1,-9,-22,13
NbVEOAaDXKJGWMQdBZUSFPceTHfRgCLYI,XCBFKHAEGBBA.QFDEZCFDFGGDeDAHHADC.RFGBLDEEhAAA..IADAhAAANAIE.bFDGOCAHhABADIBEMBAF.BGBA.SAHB.hACA......hADA...,2,-21,-10,11
dDUEGCbBRSKVLeNQTXOfAPJacIFWHZMYg,aDCDFHBGZBFH..MDGBdGFHEECE..GAGECCBG.BABCKEHBLAEChAAAeEAFTAEG.hABA.XACDAFECJHFAIBCFhAAA.........hACA.YAHBDDAA.hADA...,1,-32,-34,2
ePKRCODNTWMSHQAaIXGYZfFVBJgUcEbdL,XGBCGEDHZABAFAGEJHEE..UFFE..EAFDdFABeBHDKBAECFDDDAABhACA....TBDAhAAAMIAAHDAE.aAHFhADAIDACfCDE......hAEA......hAGA.BGDFcDEB,2,-39,-3,36
fEMYFeJdICOLNDGHTRWaAbKUBPgVSXQcZ,UGBCBFDG..VCCCXAAGZAAE..ECFGMEEB..FEHHJFHFCAFG.hAAALDDEGEACHFFBhABARAEAADAC..KEAFPHCChACA..SFFBfAHE...hABA......hACA...,2,-35,-10,25
eZUTOFJcAaRBKgbPNQEISXVHLGfWYCMdD,BCAHKHBG....PGEAQGEG.EEFGIDDGSBFBhAAAHCFHLEDFhABAGACDfFAHhAAAWEBFMCIDDGGGeFCCZACFTCAB.....hAEA......hAFA.FAGAAEID,1,-21,-26,5
CeQgLAUPFRZbfMcDdOHGYJaNIEWXTKVBS,FGFCRGFGZBABMHBCdFCGHCDGGDCD...aCCGEGAF...TEGGhAAAKCGESAAFCBFE.hABAeAFGgACBhAEAAADBPCADfAGB.DEEHOFFANICF.hAFAIFCH..hACA...,2,-30,0,30
fNPCEHDFOcRTYdMGLUSBAXgaQVIZWKeJb,aGFCVEFHZDAF..KAHHeCFC..JFBD..fEFHCDEA.hAAAEBBGDEABFHDCRBBCdDDGMAEChAAA......hABA............hACA......hADA...,1,-33,-55,22
cELRdXeJaIDHBYgWVPFUAKCNfQZTMObSG,CFEDQCBCZBFA.OGAAGEBALGECXBBDaCFA.HDFAhAAABABC...gDFGhAAA.PAFAhADAAHFEfBDE.MIBASADHhBAAEADE.eHDADFDEWCADhABAUGGA...,1,-12,-24,12
JbcNdIBfCMgeRTaQHASWLDZYUGEOPKVFX,LCCHZFDGGDAAOBFAKAEFFCGE..XDGF..bABBNCEA.hAAAdEHEBGCE.CGFF.MHFGhAAAeCAHaAGE.ADDHDDFFhAFAEHGEJABA...IGAH...hAGA......hAHA...,1,-24,-26,2
TeGSPEgDYaXLMJKZVBWUdOHFAfQcNIbCR,QCBC..IFGCCHDFeADESFEGEDEBDIGE.aBHBhAAALEAF.JCAAhAAAKHFEBABEWCHHUGDHhADAdDFCFHAEACGBfADF.bBGFRABE...hABA......hAGA...,1,-18,-29,11
bAVRdJUKLCPOTFYXMfaWGcIDBeQSgHNZE,RDDFdGDDUGFFCDFB..OBFEFCGB..MDBB..aFAFGADFDAGABHGGhAAASBAAHBACEGGEhABAAAGEKAACLDBA.hADA..PADCYECFfEGF.hAEA......hAIA...,2,-32,-20,12
UEMJRGTaVeSOWZcIXLdCQDfYHNBPKgbFA,EBDHJGACGEEB..VAFEODBEZCAH..XDFEdHEFDBCCHBFEhAAABFHHKABG..gBAEhABAADABMFGBRFDHeFADhAAASFDG.WAFEcCDD.IHHFhABACEAD....hADA...,2,-21,-17,4
CQGNTPXKOeRZFMcgLBUEDJIdSVWfaAYHb,HAADQGGGGBEG.TDBGKACAOCGHRGAAMEIDLFAE.hAAABAHADFGD.IHCGhAAASAFBVCACfADAhACAAFHACEEB.NEEE........hABA......hACA...,1,-7,-30,23
dMGNUDRfYVeAPaOZKXIbLETcFSWBgCQHJ,OCCHXCCBLCHB.EEDHTFEHFGGGBHAFQDGAhAAA.JCADMAGFUGBEfADChAAAeBFCaBAGIHGChABASABFCGAD.dDAEDFBE.....hADA......hAFA.YHDAAEEC,2,-19,-17,2
dAQWMXKgeJNCYHfFUROZLETPBSIcVGbDa,MFFFKGFCeHEG..CECCHBAGFGBGUDDARAEFLDGF..EAFEBBHFhAAA.SEDHhABAIDACVABHDAGCAGIFXGCChACAJDHF.NEAG........hAAA......hABA...,1,-18,-36,18
HCWXVJRPcQdYeMSKaGfbBTNLOZgUAEDFI,FGCDCFDD...XCFAJEEARCAA...QGEGdBGCMBBE.SEBBhAAAKHAE.fBABhABABHCHLAEBhAAAOEAH.gBDHEGHFDECD.WFFE..hACA......hADA...,1,-31,-43,12
ZDJdOUfEGIKFMabNcBPCAHQRTVSYeXLgW,QBBHTBBH.SECAeEDALABEZFFADAFAdGBD.OEHHhAAAEBHDKDGHFAFC..MIBEhAAANCEB.BBEGAHID..hABA............hACA......hADA.REAB.XGFD,2,-26,-21,5
bLIWgHSUTAPMJFVONEQGaBRdcYDXCeKfZ,JCHDFDBDOHDA..EEBCGAABBAHARBBEdCHE.DIAGCDFC..KHACZFGHhAAA.LFAA.hAAAIDDFHFFA.SAEEhABAABEEPHCEMGAG...NACD.aEFHhADA......hAHA...,2,-35,-23,12
XIUfZPBHEJQMKLTeCVAYcSRGNFODabWgd,SHBGREBHGFEBOABFDHEG...aAEBbCAD..dDDDUCDGZAFEBHAEhAAAJCHB..MACAhAAAKDABTDGECGGB.AIHA.hABANBGAFFDE..XGCDIAHC...hADA......hAGA...,2,-28,-17,11
XEIZSVMNPCYJFDUfdcTLBeHQgbaRGAWKO,OCCHEGFCZDAF..MDFGCFEGFDGH..DIFCUBDEdACGLHBGBBBC.hAAAQAGAaBFE.hABAAHHEKAEFSHGEhACA.VFAFYDDH.fAAEhABA......hAFA...,2,-39,-26,13
NZHDcdYLWfVMBAGbgPCUREXeSFaQOKJTI,GAFE..gBDGCGFFRCCA.XFAHSABC.aEBChAAAKGDE.IDHDhAAAZEEADCIFdHABLHFA.hAEAfABGBHHEAAFF.bCFDEHDEFEBA.OAFAhACA.....hAHA...,2,-28,-13,15
CcWEXYBNLFHfaQRSJMZbKdOVUeADPITgG,DACBTCBCCCFH...EAADBHBELEDFHEBCQAEFJFGD.hABAMFFFZADEKEFF.VBGBhACAAEHCIHGAGEAE.hADAXBADNEIE.fEGG.aAHDhAAA......hABA...,2,-41,-2,39
ZcHCgafWUBbDFKGISRMLTQVXOENdJYPAe,eFBBZGFGHAAACEHF.aFFAUAFABAFA..DGGGKBDHGDAHRBGD.MFDFhAAAQDAA.OHAAhAAAdFEAJABGADDF..fFDBhACA........hADA......hAEA...,2,-38,-22,16
gBUPIaLNMDdcFeQKSTHOfXGZYCWEbAJVR,JDACVGFGBHEA..UBDD..aAABLGBCDBHH.dAGGeGBEhACASBBFHEDAXAEHhADA....hAEA...YFGBEDFAAACCPDHFMAIDFBBChAGAKEAEfHBFhAAA.CEDA..,1,-20,-36,16
KbfCQJLagZAWeROIYXGdDHPUEScTVBMNF,eFBBRFDFODAD..XBBDdCHADFCBHABHEBEA..SEGGhAAA.TGDHBGADMAEHhAAAKHGECHAGLBADhABAgGGCAFEGIDEB.YBHBhACAPDFD......hADA...,1,-17,-27,10
KXfQRdaENUgSYFAbHDOeGZTVMCcWBPILJ,DHCEGGCBZCGB.MABECBCA.BFCGLECCKAHF..QDDGhAAAdAFCEDAA..UGEESHFAhAFAAIHA.bBCCOAAGhAEA...........hAGA......hAIA...,2,-42,-30,12
KScNMCIaTDPQgFYUOeEJHVLbGRXZWBAfd,dAFBKAFB.SFFEMEAF..CCCC.aEACDEGAQGGBFABE.OCBAhAAAeECHHFEBLABEhAIAGBDEXFDHhBAABAACADHEfDFDIBHF.gBGGhBCA......hBDA...,1,-15,-31,16
HbEcYRJdaLKgVZWQAfDUFGOPNCXeBSMTI,DAFBFCBBOGEACBDA.BABESFFA..IFAGHBGBbEDGhAAAEEEC..RBABaDDAKAHFZAEHhAAA.QGCDhADAAIHGfGAB.........hAGA......hAIA...,1,-29,-37,8
DPCXfMSWALUIBaVTNbcOEJHFgQGYdZeRK,LDACBHHGaDGF.TFGG....NHCF.bAFAEECH..JEBHFAHFhAAAGBCBZBEDKFABDEFACDAF.hABA..fACFhAAAMCACAFIB.UFDC.IHAA...hACA......hADA...,1,-8,-40,32
EZFDGQUSeLVYBcPaRNMfJdWKbTXOHIgCA,EEHBFGGEDABHGCEH.UAAGSEDELFCABFCH..aFABMCADhAAAdHBBKGGF.TDCBhADAXAGBHADECHEGAICG.hAFAZCCG...........hAGA......hAHA...,1,-7,-48,41
OVGCJWgSIaZKPYcULREeTAbHDFfQdMBXN,DHCEQGBCBCFB.OEHHCFAG..JAABSEED.ZBADhAAAKAED..PCCFhABAUEEDLDCHEAGDAHABHCFDhACAFGHFMIFA.XADE..NBHG..hADA......hAEA...,2,-58,-7,51
CNVTafZDWEJdIGMgASHLFceXbKPQYUOBR,SDBDHDEDFAFFeHACKCGD...QGGAOACDBHBDCCBFTDBDhAAAZEEEDGID..JAHBdGGEhAAAMBABAAFCLECBhABA.XAFA.......hABA......hACA...,2,-30,-22,8
PQXMWdcYAZgHDKFbfLGRNTUJVSOBIaEeC,ZGFGDHCEKFCGFCHBLCCDGAAF.RFAE.UFFA..SFFChAAABAHBECDA.eBDG.CABC..hAAA....PDDEhADAXDAEdAFFAEADbFADNIAB.TAFC.ODEChABA.....hAEA...,1,-20,-27,7
ReMIZWbTFaYVfgSXEcKBdCOAPQNGDUJHL,QCBCGDCCJFHHHBBALEED.eDADZAEATGEEaDHB..hAAAfBDFXCGCKCAFhABAdHABAIFADFADMDGF.hACAIGHB.FAGB......hAAA.YFCHSGAHhADABABGCCEA,1,-17,-18,1
BHCWfPIgceUDZFNKGOYTAQSMaXLdVbREJ,SBDHaAGDLGAGdFGFRFGF.BAHAHAAFCHDD.....PEDChAAAIDAFeDAAZDEGKADFOFAEhAAAADEGMAIB.XGEBhACAEBFBJABE..fGHE...hAEA......hAFA...,2,-32,-8,24
SADFHfbeIMgCXPJZWGBaTENLQdYVUcOKR,FEAEHAADeAAEMCGH.CGHD.JAHBGCCC.BFBBaCCA.EAGGLGEChADAdHEB.UGAEKGBDACAD.hAEADBEFIHFG.hAAAXDEE...WFDDNAFE...hACA......hADA...,2,-25,-25,0
WeAFCBNRcbDVZHQXUMGfYSJdagELKOPTI,CCEARDBHDEGCZBBBHEBC.UGADMABE.GGDF..fHFBhAAAJBEEdDFC.aFFAEBBAOADGhABA..IGAChAAAADIFBBGA.NIAF..........hACA......hAHA...,2,-30,-29,1
LdfIaOgSEVDXJbTZUFcQYHKWCeGNPRMBA,dDCDaHBG.OAGD..SGHFEDFF.XAAAJDAFZGFAFABHhAAAQDFHKGBA.CFAFGAEBhAAA.NDEGMFGHhABAABDGIFDGDDBG........hACA......hADA...,2,-42,-16,26
RcfNUaSHFeIMALYPTGBVgOXZQdEbCDWKJ,LGEATCBC.BCGEOEHDZDBHQDEH.dACGCBFFKEDChAAAJAFG.fGDChABA.aHFASAAFhAEAFCGDMACEABHG...PGAA....hAGA......hAHA...,2,-36,-31,5
GbaCFIQWKAMfZBSLDURcgPNTHdXeJOYEV,MECGBFDDSDAFDIBE.UAADRAEF..PAHFHGBAdBFHeGFEhAAAODEA.EGGFbGAChABACEBC.FACA..IFFAhABAKHEEAEGE..fCBAcBCD..NBIC.hADA......hAEA...,1,-24,-27,3
cCRHGBgKUAYeTdLSDIaWJPZXQfONbEVFM,eDACTGGDdFBF.LHEASFDFDBAG.aCAD..JEFGZAAEQADAhAAAOAHFECGHFBHDCGBCGEEEhAAAKGAD.YCDEhABA..IDECWHAG.XFGAhABAfEBF...hACA...,2,-30,-2,28
UVEYMSNdKAZPBfDQTFHcIGaWeLgORCXJb,BFDDDAFBFECGHAFAGEGAaAAFLHDE.OFFARAACCFFF.JDBCUGBDhAAA.ECGEMCCCdAGBKCCAhABAAHCBZFAB...fACHhACA.TCGBIEAB.gGEGhADA..hAEA...,1,-10,-31,21
cXHFaLDEQMTKCReWAZVgYISdGJOBbNfPU,ZGFGVAAD..IAFEGBFEBEDG..fCFGUGGEHEABhAAALCCDDDAFEDDEMCIHhACACBAHeHBE.ADEDSAHHhAAAdHCB.OFEG.NEAE....hADA......hAEA...,2,-20,-17,3
XSHPUbfKGOdgYNDcTVWQFaRJCBZeAMILE,LCHDXFCEHDBAUGACKDEHdHDD....NAHG.DBAC..VAEHhAAAFGDEaCEARDFB.BDBBeEABhABAAACC.MAID.EACHSAEChAAA...fHGBhABA......hAHA.ODDH.,2,-36,-2,34
HAaWZQOIeJXCKSTdRVLMEBUPDGFfgcbNY,aCFCQFDH.eDCGJDBFKBCGdGBCLACEBAAB.DHGGGEDHhACAFEHD...gAGChADAbBBAHAGBAAGF.ODFDhAAACHGHSHCG......hAEA......hAFA...,2,-45,-5,40
HRcadEUGOPALTeMXNSYCFKBfVJQIZbgDW,LFCAeAEHMGEESGHBFEBC.KDFCBBHB.JDHFQAFAhAAAZABHDHAA.RBBAdBACEEEA.hAAAOEABACGD.NIDHCEDDIADFhAGA..WCHH.....hAHA......hAIA...,1,-17,-38,21
NAIcXWMCfgeRUBFdZGaOLbEQTKJHPVYDS,XCBCMBFH..CFHBeBCHRCFBUECGBBACdFAEGADBLEABEHDAQGCGhAAA.KGGGhABAHFGB.YAADhACA.NCIG.AAFCICHF.fAGFhACA.FEFDaEFH.hADA...,1,1,-33,34
TIFgRbAUYCZVEXNWfPSceLJBDadGMOQKH,CHHGVDDF..EEED..XCGF..fCDCSEAChAAALCHFDCAEdHBHMBBGhABAKDAETFBFFFAEgFGFhACAAAHC.........hAAA.YAFBNIEH.hADAWFAD.,2,-55,-15,40
WXBfITEbcMgVQRDYPJGLSCOUadKFeAZNH,ZGFGHAADBHBDTAEEEBCE.MECG..VEBHDIBGJGDG..LAAHhACASDGHOEDGhADAaCCAdEAGeAECAHAANAIEfEHAhAEA.IFFF....hAIA......hBAA...,2,-27,-18,9
KIcCZbGXdYPQBAERUSJeMfgLFaOTNVHDW,UCCBJFFB.eFDEMAADLHBG.FBGFTDEAHDAB.KFCACDHHZABGhAAAGBEF.dFAA.QCCChABABHFAAAGGEFHB.hACA.SBBC.aDHH.OHBChADADABE.IAEG.hAFA...,2,-23,-9,14
bGeLWJPZfVdTIAKSORYHcBCaDXMgNFQUE,KEEDSDBDRFAGHACGBHEFDGGE..MCGFFBHDUCDDEHCC..eAHBhAAALABFJACF.ZFGFfEEGhABA.dAEChADAAFIHOHACCGAHaHFE........hAAA.XDAC.hAGA...,1,-21,-26,5
AWJYZfFcbLNPKISeXBTgMEVdROHDUGCaQ,JGEAZAADFDCDLEDFKHEE...eACGBDGGMCHFdAHCHFAH.DEEHhAAACGAFAAEE...fCDFhAAA..cAEEhADANIBH..SBBGXGGH...hAEA.EGCFOCFDaFGG.hAFAYBAF.,2,-30,-27,3
cefOdKTYSDXNFaWPCUVGLMREbgAJIQZHB,JDACZEFHBBFF.eHCGOBFD.dBHETFAEDHGE..FFCGaDEG.hAAA.CCCB.UACGGEEEhABAMAHHRFAB...bAAHAIGE.hACA...IEHA...cAEBhADAfFHG..hAAASBBCNBIG,1,-28,-37,9
QOSUAYJXdEaTKgbCZIfFNWcDVGReMLBPH,JDACdFHAaAGF..KABECDFE.ZGAC..FBBB....NGEB.DBEAGBBHhAAAeFADMECELAFBhAEABFFD...QFCChAAA.SHECAEIFEHFAgDGFhAHAICDBfEDFhAIA..,1,-26,-47,21
AKRcYQUDTaMIWBHgVCbJGPfLNOdFZSeXE,KCFCRAADQGDDDGGB..MAIDBGAGHBAECCFCGACFLGBAODAEhAAAdDDEFEAGZFGFSCHHhACAeABGAGAH...hAAA..cDFGYFHB.aFFB...hADA......hAFA...,1,-19,-22,3
DCRHIFNbAWVcKMGSgZXdUfQeYETOaJLBP,VAADKGFHMIAG.GEDGSAFB.ZDCEUCBG.QAEHhAAAEFCAaAHDBHFDCABA.RFFGFHAAhAAAbCFG..ADAD.gADEhACAdAHAeGAG.........hABA......hADA...,2,-16,-16,0
TUHCKEJaBXdLIbcGMYSFOQPeRgWZNVDfA,UCCBKBBDEEDEBFGC.LEAF..bAFFMAAAFHEE..OEABhAAAQBFDRFCG.ZFBFhAEADDCEAGDFCEHBXACBhABA.IHHG..cFECYDHFhAIASHGAeCFD.NBBB.hAFAfHBB.,2,-29,-11,18
dTVQZAENXCSKcLOfIgPUFHWDYaeBJbRMG,XGBCCEFAKHGE.LBADOFCC...IGFCUBCFHDAADCIFeAGFhAAAJDHF..MHAEhAAATECDZAFC.EBCESCFFhABAfEGB........hABA......hACA...,1,-29,-30,1
HYJVdCPSTXLIEQUfZNAaKDGRcFegMbBOW,DGGDGEDHFAGD.MBADBBBCHBBG..JCCACCEASDGC.hAAALHEEQDAChABAfAGGAFFG.RFBE.hAAAcFAEeHAG.OEHD...YDEGhACA....hADA...,2,-57,-2,55
JOTGLZHAVScbEdKRMaYQFINgBPCXfUDWe,VDAGSHBG.EACGKGBH.MAIF..aEFGQGDDhAAAFCEAIAGGBDGE.CHHFXBCFhABAfDCCDFDGeEHFhAAA.OBAF.GEDE...hACA......hADA...,2,-39,-13,26
TXeaWcRfEIHVYSLANCDJKMdOQbGUBPgZF,CAEDKEGCdBCCQGCFGECBBHGGZGFE..FBGBeHCA..aAACRFAGEBHDhAAAHDCC.SDAChABAAGGCDBBD.MACCODEAhABAPBCCXDAC..WFBD.fFFBhAGA...hACA...,2,-27,-6,21
JXBdUILEcPOKMaQDZFWVfgNHTGbARYeCS,RFDFeAFBCAHD...SEBCBFCDdBBALFHBEFCG..cGFHhAAAKAEA..aGABZBACFDFDhAAAfGAG.hABAHEFGTDCFAADCJHCC.......hACA.IEAE.hABA...,2,-37,-21,16
eaEGIFRSKHVbdQWOXDCgNfBLUYJZTPcMA,eEGHGACBFACDREEDKHDGHEDF.dHABOAHF.DAAFCHHD....fAEHhAAABHHBLDAChABAJBABZBEEPFAEAABEEDFA.hAEASHAA.......hAHA......hAIA...,1,-21,-27,6
DSCIedcEPFVAJfWNBUYaGgLQXbOTZHRKM,JGEA..NDHCBEBGUEBEGBBDLACG..QDFEOGCEZCCChAAAKEADMDGB.CBAE.IAAChACAdBGB.EAHBFGAHhABAAHEB...fEEE.aECF..hADA......hAEA...,2,-34,-24,10
IPDMSFfYeAVNGJRcQZHKEXUdWaLBCgbTO,VEBHJFEF..QDGHKACD.UGBGdCDBLAECBEEB.CEEA.hAAATCAD.OABChAAADGEHFGFF.eBADAGGERCCFHAEBhABAEDHB.aAGE........hADA......hAEA...,2,-34,-16,18
HECAUSOfFPVaDcWJZeKBYQTbXMgNLRGId,UGGDOCCHFCHB..aGAADDEG....JADGKACFBCACQEGFhAAA..TDGGhAAAMABDLFBHIEEHdHGHhABACADBAFAB....PFEH....hAFA......hAGA.WDCBeHAG,1,-33,-36,3
BgLQZAEMUIPTKcaOdVefFbYDWHXJSGNRC,MAEDUCBC...TBBCKDGFaAGB..OAGDeFEH.FDDHDDDCHDAFhAAA.JFFDSADGhAAA.GFAFCEGBBHHChABALDHB.AAIDIHHGcGAH.dHBDhABAfGDE.hACA...,2,-25,-25,0
RQKeIWagDdHfLPMYBVCXFNZcESAGObTJU,OFEFTDAC.UGACRFEH..QDFBKDAA.eHAEaGGFDDIDHACBhAAALADGMGBGVAFEhABACCDD..FBABNEIE.ECFDAACF.hAEA............hAFA......hAIA...,2,-41,-1,40
QMZFARgNVOPWUHDKaYGcCJfeXTEbSBILd,RAADVAADOAEG..UGGEKBHHGEBB..CEEBJAEDeGCA.TCDAhAAAEDGDBEAH.LAHFhAAAdGGBMCGH.AIAANCAEhACAHGAE.DGCGaHFEfDCE..hACA......hADA...,1,-7,-31,24
PJGXbUdBCMeVcgYAOSIKRaWDTQELfZNFH,SDCDKCFCRDBG.DBHHTFDCLADGZGFGHAACGAAE.UEDEhAAAdAEFCHBCeHAA.VGFEhACA.....YCGFhAEAAFFGIFBCQFACEDHBNDAG...hAAA......hABA...,1,1,-27,28
BbZcTFVfXYeRCQWJKaPLESDNgMAHUOIdG,UBDGdDCDBFDGZDAFFHGE..XGGERAFF.CBBA.JGEG..aEAFLCCDhAAA.DDIHMAFHhAAA.OADB.hABAIHDAbEEC.TEFGfABFeBHH.hABAKHAESHAEhACAADHH...,1,-27,-39,12
CYVXZdMeLaOUTBDPQRcGAfbSWHIgNJKEF,SHBGHAAD..gGGHKCDDCGGA.VADFdBEBLCABhAAA.UEGHBGCGDAHHhABARDFEAEEH.bDAGNGAFEEEBXAGEhAAA.MFFHaABE.......hACA......hAEA...,2,-31,-8,23
EeOUfWHYXQDRLbVFSPacJNAGICgdZMBTK,GGDHCFDGdAEAZAAFBAFH.KBCEOCEEUEAAHCDE..XGAAhACAQBAHDEFELHFAhADAFHACSDGH.hAGA.cEBBAHIBMAAETFGHfFCB.hAHA......hAIA...,1,-15,-33,18
OYXgTQaUPZCdDWVFJGKSfANRcEBHMebLI,RAADBFEDeAEGLCAF.OCDCXFFCQBGAaAHDZCDADDHBhAAAFGBCKFHBAIDG..EHAGHABAhAAAMEEFIHEFhABA..TDBCCFCBWFFB......hADA......hAEA...,1,-18,-25,7
IbgdFNEPTCSJGLKBOQceHUMVRfYWZDXaA,..IFDGbDAG.FCCGEEGA...CBFFSGAFLBFEKHACOCAGhAAA..eFFFhAAAHGEAMBADfGCFhABAYEHDDIBAADBHdDEB.......hACA.TCDEBFAG.cCGBhADA.,2,-28,-27,1
LNCREYZMDScFOeIKAbJdfBGaXUTVHPWgQ,dDCDBECDaADAUBDH.HGBC..PBAGQCGDLFCGCFHEREED.hAAAEDHBZABBDBGB.FHGAOEAHhABAKHAAAIDE..JCAFfHGBhAEA........hAFA......hAGA...,2,-28,-22,6
MYFDWKRPAcHBdQJOGIgTbUeNVSfaCELZX,BFDDdGDDJFADOFGH.GBBC..gEGCUBGBeADC.hAAASHDACEDELCFEhABAMEEEDBCBKADDAACC..hACA............hAEA......hAFA...,1,-34,-47,13
dNBQMTJKbVgcEeDHRZUAISGXFYWLCPafO,GEAHFGFCLEDGCACG..aBGFOHACBGFC.MAGHKGCH...VAAChAAAEAEHDFFEZFBAUDADhADAAHAC..SDDEhAAA.XBAGYCHHfDAFhABAQBDE.....hADA...,2,-41,-9,32
WOYUSLbZdAGCecTJPfIKaQXRBHDNFMgVE,eCBBTDAC..JFCG..ICGCaFGHRADA.DBIBFEHB..VEEDhAAAEAAE.OACFUAGE.SAFAhABALDDAZEAFhACAdFCACGHF..fHDBKHFABCAFNIAF...hADA......hAEA...,2,-16,-15,1
BdHgWFNTOISMGUPCfQZEKRbVecAXLaDYJ,XGGDDFDCBBBAdGGGHGDA.FBAAOGCA..SDCGhAAAUCEB.CBGFZDFBECABKFADRADFbFABhABA..eHACAACE.aAEEhAAA............hABA......hACA...,1,-13,-43,30
RbSOXdLUEcDafgJHVeKAYCZPNMWGFIBQT,ZDBHMCCAFFADBAGCRGDE...SDEFdBCBLEECUGDGDAFHaEAD.hAAA....JGFE.hABAeCGBAHHHCHCD..NAIE.IHBGhAAA.QBAAbFFA.EAHF.hACAfADF.hADA...,2,-37,-22,15
ceaMKABGdDNYWJIbfFHVZQRUPgTECXLOS,BFFCdACADFGB....NEHE.JFHH....ICBAFHBCZBABQCEGhAAARACAUCEC..hABATFAFEBFGLAHBhAEASHBAaEBDADDH.......WFFDhAFAbDAEfAAFhAAA.PAHB,1,-31,-32,1
BKOQEMJfeLPGVFWTgNYUXISRCHdZcbADa,DFEAaEHBBECAKCAB..OGAAMCGD..eADALBAEGCABFBHH.hAAA.TFDD.NEAE.hABAUCCF.XGGHhAAASHDACDFCdAFC.....cGEBhABAAHCAEABHfBGBhADA..WHAA,2,-31,-28,3
YVQfRWBeGEDTSbXMJNUIKZacLFOPAdCgH,CFEDHAAD.QDGGRBFAeCBEGDBCEBHBTADH..XADFhAAAMEFHUDCFKGHBaBAHFFADAACAhAAAdHEBVFCFBAGCSGGHhAFAJDHB.........hABA......hACA...,2,-23,8,31
PfNXKbLMZgGIOeWVYacdATDEJSUFBCRHQ,EDABSAADFGEA.RCFBHCBCQAFA..PFBFXACGhAAALDHHZDEG.IEAEhABAeEHHWDCDaAGAACEEDIBAhABABGGD.NEFGKADEMDDC.OFAH..hADA......hAEA...,2,-17,-6,11
NZVDECLOYQFXGfbKIUPJcWSdMAHeRTgBa,HDBGRAEGBEAEZEFHDDAGEBFF.LABD.OADGFHCEGCEC.hAAAKACCIGDCUDGE.hAAAJBHBSHGAhABAAIFA...TGAEaHACNEIE.CECG....XCCBhAGAfFBE.hAHA...,1,-13,-33,20
MbaSAedDLQEVcYJBgNWKCXHRfFGIUOZPT,DFDCQAADEHGE...VADBJCFABAHD..gAGChAAAKAABCGEB.XEFAhACARDEGFADD.GDAFUGACZDAEhAAATGEF.aGDHAACG.dGAC......hADA......hAFA...,2,-40,-5,35
MTZOUFEWAXgCNRDbYPeILHadQVSGKJfBc,CHHGDHCE.....bFFGeDGH.HDDCaAGF.VGBGKEDH.BEBCMDBAhAAAOBAB.EAGEACEGNDAAhABA...RABE.ICDEhAAAQDGG........hADA......hAEA...,1,-31,-34,3
BVAagRGPdXYDCcSFTeOEZMQUJNfIWHLKb,aCFCREBHdCCH.DGGGCFHG..FEFB..eAHFZFBBUACG..fEEChAAAHAADKAGHBFACAAGA.hABA......hACA.gAEBPHEE.XDGG.hAAA......hAFA...,2,-38,-34,4
CSeDRXUFPLWJTfYVNEMHKcbOBAGdIgQaZ,dGAHQCBCCADG.DDEARBFEFDCDLHDG.JBHDTGDA..hAAAfAFF.hABAVECENDIEHEEE.KCBEhACAcFAABGGEAAFEIFGB.aABA.SAEDhAAA..hAFA...,2,-31,-29,2
PFdXANSKBfVMEgJbIRWOcYHeDCaGQULTZ,SAFBBFEDMBFH.EEBG..JAACRACDOCHFHFFBDEAF..aBBHUBGEhADAZFEB.FEBFAGIFKDEA.hAEA...fCDGhAFAbFBE..IGGDWGAA..eEHDhAGACBHFLHAE..hAAA...,1,-21,-24,3
NOAcaHMTSUdXYRbKFgDBLeWGQEPfJVICZ,aCFCHFEE.MACGUEACdGBFRCDD.FAHDBCBCLDECGABFEEBA.JBAFCHHGZFFChAAA..AAGESCCChAAA..XGBEhABAKGHBDIDG.eAHB......hACA......hAEA...,2,-28,-15,13
QKeIGAVNUZDLcBbYWPCfMaJFSHTdXROgE,UFDHDAGDLBCEBCHB.....bEAFPCAC..MEDChAAAaFBF.FGDAHDECdAHEXFFFhABAOABEEAFAKCDA.hAAA..IDHGAIFANEAE......hACA......hADA...,2,-31,-31,0
WFGBbUAIfRJSOXgZKTYdcHNDELVCePMQa,RAADSGDBOAEGZCEAKDCC..dFCGHFFDDIBC.EDABLHFGeCFGQGABhAAA.aACDhABAGFEBBHHEAFHAfBHEhAAAXDFG.........hACA......hAEA...,2,-29,-15,14
gFcPeAYVdLaJIBUKGXZTSOWECMRNbDHfQ,VDAGdEEDaFHB..BBABKBDEZAGD..SFADOCCC.EEFAMFAAhAAARGDA..DCCGQBAGhABA.FHEGeDDHhAAAAICALGAAICHB.GADD..hABA......hACA...,2,-30,-21,9
BMJHSdYEWbceURIOaPfNKAGDLQXCVFTgZ,GDGGDECDQAFHCFDHFBFH.ZBAABDEGHEFBdACDEHEE...bBDDeHBAhAAA.RDAG.OEAHhAAAaAGF.NIAB.ACDC...XDGBhABA..TFAC.MAIH.hACAJFFF.SBAGhABA..,2,-17,-11,6
NTeKHIJYaDQOMLbPXfgcAERBFWGVZdCUS,BCAHGEAHdHCFSCDHeDBHHEGD..JHAGDIGAQGGDhAAAODEGMFFHLAEE.hAAAPFEFfAHGhABAgBBBEACFFAEHWBGDCDDD......hABA......hACA...,1,-16,-19,3
LeSYgOZKWNUMaPCbBXTdFIHQfJcGVDEAR,eFFCSHBGOFABZAACKECBUCCB..MBBDCDGABFAGdCCDFGDDHFDGhABA..QAEBhAAAJEHBGAEFDEFA.ABHC..hACA............hADA......hAEA...,2,-32,-28,4
MeLSVONAUQgcJBbKfDCXIPGdWRFYEZaTH,UCGCQCBC.JFACBCBH.KHBEDEFHCAFC...XGDDhAAAGFEHdADCFADC.EAAFaGAHHEBAhAAAeCHD..SAGAhACA.NIDF.AHFA.....cDDFhAHAIHHG.WDFBhABA...,1,-22,-44,22
BIJYcOWUQNSEHRLgCVGedAaZKFbDfXTPM,aEHBZFEEFCBG.DDGETAAC..BBHBJDDC.OCEBUEBBQADDhAAA.EHCALFCHhAAA.CADGeFAHhABAKCGCXGGAMCAH.IHAD.WAFEhACANEIESAGFhACA...,1,-18,-43,25
RWXLMCdSOgKJGHEFPeUbZNcQAIDaTVBfY,DGHHVBCFBEDC.RACG.LBGB.dGFFSBGFKEBAGGABEHAGhAAAeFDCZBAF..QFCFhABAIAABaCAD.hACA.TGEC.WCHFCACF.....hAEA......hAFA...,2,-30,-24,6
ZIBVSRYbaDEJAPcFUNOHgQLGKfXWeTMCd,FHBGUDACOACDQEECGCGGKAGG....XFCETGGECAAGhABAdBEEBHCDSFAChAAARBCB..aCGDDFFDAEIH.hACAPBAF.cGGEgAED.fGAAhADAMAEC..hAGA...,1,-16,-30,14
GZJdCUbKeMFaXVNHRTfADBIOLEYPSgWQc,DAEDBAFBLBGHEBCH..SCADQFDEGGEFJFGFUABFhAAAeCGFFCCHaBHF.NBFA.RBEHAGIHhACA...OFADhAFAgECC.cABB.CAAF.MCID.hAEA......hAHA...,1,-18,-27,9
ARXPQcKfdUIYEOSCVbaBGZNeHWDMJgTFL,XFDHQCBCKEABdEDG.UGFE.EEFGCCFCaADD..GGADhAAAeGFEDAACMBAC.TBDGhABAABBCRCGH...fBGChACAIAHDOFBD.....hADA......hAEA...,2,-37,-16,21
dPgVSFOYUJDHLWIMZQTfbeXaEBGARKCcN,CCAHdHBH...VCCCFEFEUECBHDFGLFFA.MCFAQGGChAAATABA.fHADhABAeAECEEAGAGDERAEFKCCG.hAAA..NAIE..SHDE...hABA......hADA...,2,-30,-11,19
IJGYPEUeQBTVSWHNZKRbFADfCOdgcXaML,DAEDCAFBdGEE..XABEMACD.LDDGGEAEEBDCUFCE.BGGEhAAASEFEHBFCKHFAFBAHhAAAACAF.OAHFaGAH.IHCBhABA...PCEC.QGGGhADAWCAH...hABA...,2,-35,-9,26
EHRXPbdYSLJOfANWMIaCTKUBFgQDceZVG,MCCACFEDKBBE.FGAA..DEBGZFEFGADEHDAG..XBFHdGBHLHFAhAAAJABG.AHAD....hAAAIAGATGGEBAHFhABAQCFE.eEHFEDHF...bCAC.hAFASFFBfHCFhAGAaFAG..,2,-24,-18,6
YcXBRIQAWVLdUaDEGHKgPfJMeCNOTbFZS,VFDFdAADDBHB.HEBGKAFB.....gBDAJCAACADA.OFHHhABAFGHBZCFC...SAAEhADAYEAFXEEFhADABBHGRFAB.ACCHUGCFaFFF.EGFF..fECFhAFAMDIH..hAHA...,2,-37,-5,32
afPHWEGRIUcMOKBbZdVXgAJDFNLCTQSeY,FEGCLAFBQCBGeEGH..aECHHFDDGBCEIBDD.MAFGhAAAKAACBDAGdBAGXGGFhABAAFBFDIEACBHGSHAChADA..fFBFWFHHEEFF.RBFE..hAEA......hAHA...,1,-7,-26,19
MbHYUGCNSXKJVDQPIOgcRWfLeFZadEABT,MEECHAADUAGGGFDHCADD...XFAFJCDC.DCCFQFADhAAA.OEEARBEEfHFFhAAAeFFDFGGAdACFAAFDBEAFhACAYHAGKHDA.IAGH...hAEA......hBGA...,1,-17,-18,1
KNYJbSABUdZQITaPORDeVHMgWCFGLfEXc,BFCFZBCFQGFGaAGE.OAFADIECHAEBMAAFCEFFGCAG.hABALGFAEFDDXGBGhACAKCHDJACBSCFGhADA.AHIHIFHHPHAEeEDH...hAEA......hBBA...,1,-16,-21,5
dNWHTXDIYfGRFBPCgZAJSEcUeMbQOKaVL,JEGHSAFB.EDFDUCAF.MBCAOFHBKGDF.LABAhAAA.dCAGNAAF.HFCHDDFF.hAFAfFFE.hAGAFAHBCFCFAHAAcDCGQBFAWCCC....hAHA......hAIA...,2,-48,-3,45
VXGMSECJBTcRHUeYbDaNOFfLgKIPQAdWZ,dCFCZGFGGAFASGHBJEAH.BHCF.RBAGHAFGeDAGDACG.OHBEhAAAFECFLEAH.hABAIEHHQBCGhAFA.AGGGVEDCEADCcGFH.....hAHA......hAIA...,1,-17,-19,2
OGQMAEgBPdWYDLSeHIVCUbaZNfJKcRTXF,BFEDdHBHDCCALACGHBABCAHF.UCEFZGEA...JDHDRDGBFDEBGEAA.hAAAAHHH.EAFD....hABAPHDASACEhAGAeBAF.IFCF..aAHF.NCDE...hAAA......hABA...,2,-29,-23,6
YHOcUgXaVZSRFTMIJePCbBQLEAGfKNWDd,KGAHDACBHEBBUAAD.aGHHZFED..FDDFMDDD..JAEFCDBH.BAHBLAEEhABAAIFE.GBDFhADA..fFFGhAAA.dHBHcEGEXBAHSEEFhAIATDFH......hBDA...,2,-32,-27,5
bKOJBCPecDGdVEAfUXNaSMTYgWFHLRQIZ,UCGCaGFC.MABE..TCGE..gGFGFGBDRAECZCCBOBBHhAAACAEH..eCEBhAAADAIDGEEFVGBGfCBBhAGA.........hABA......hACA...,2,-29,-27,2
HQVceDGFBLNdSKbIgXRUMACYOEWaZJPfT,CAFBEDCDZDAC..JCFG..TABGQADG.eBABDGEDGCGGhAAAFEGHLHAESFFDhABAKGHB.IAHChADAXEDDRBDFAGIBOHEC.aFAEPFBFfAFBhAAA.....hAEA...,2,-27,-5,22
URFfSVbdMGLcJaWZHOEeBANXKQDTgIYPC,KGFCDFEE...TABEIAFE..CGADUGCBFCDC..SAABhACAdCFFLHFAaBHDZGDGhADAEEAA.AHAA.XDDHhAAAQDBG...YHFGfAEC.hAEAMAIFcEGA..hAHA...,1,-23,-38,15
OWIANHMRSPLUBdYegbDEGVXKTCJfcaQZF,HFACSAABUGEGdEEBeECADBAGGDGG.KAEGTBFE.CAHE.hAAAJHBE.aCCDZDACFDAD.hABAOGAGAIHEMACEPFFBhACABEHC....gBDD..hAGA......hBFA...,2,-25,-15,10
bXcQOIWPUfJCRHgLFAeBYSVGENZMDTdaK,eAFBSEGDECEHZCCBDCEG..dAHEKCDD..XFGEQGDChAAAOHFCIHBGUCAGCFFChAAARABFHEAGFGAF.BEEFhABA.YAGHNBAF.MFIDaDHB....hADA......hAEA...,1,-9,-21,12
SagEHJTOBcQdRDLIebFXKMZNGUPAWVYfC,VAADCFDG..SAACEDCA.HADGOFEFBHHFdGCGDDCHLAFHhAAAeCGBFGEEKGGDMICAhADAZEBE.GEAEABHD.fEEFhAEAJDHFTADCcBBA....hAGA......hAHA...,1,-16,-20,4
dDbCRBNZaUVgWHXcMFSfGTAKQLOEIeJPY,KGDDQFCAODDG.EAAB..eBCC.JEAEdCDD.DHAERGFGBAAFhACAZDADUACF.VFEGHAGFhADAMIBE..FGABSAFChABAfFEFAGID.......hADA......hAIA...,2,-27,-19,8
XZAfUBJFEPLIeQWSNTKMbcHYCOdVDgaGR,BHHGJEGH.EAEALFCE.eAHBSAABKCEE.MGEAHDAHhAAAOCFCdHCBDBAHgECChACAaCCC.XGBEhADAAGDAFGAH...QAGAWBBC.NEAETCBFhAEA...hABA...,1,-13,-28,15
bQZNKMISfTLePGDBEgXWHAJROdVcaYUCF,OFFCdCFCaCAD.UAFCFFAG.ZGEA..KCHHMIBE..SHEEhAAALDCAeCHFDGGGBABChADAXEBCADEDRACA.VAAChAAACHAA....NDDA.fBDA..hADA......hAEA...,1,-20,-39,19
FYIfeJdLBQGaPDVOZHXAUMSECRWcKNTgb,MBDHSEHBRGDE.KBHH..TAFGFEEA...IFGBhAAAfCCAdDGBQEADhABAaBBGDAEHOGAAZADFAICAEAFBhAAACHAENACE..gGDH....hABA.eCABBFEB..hAFA...,2,-17,-16,1
NGXIgSHOJRPFBMUdVTAeCZQDYaWEfLcbK,eFCACFFCDDDA...aABEEEADLAED.KCCBXGEE.SFCHhAAAOHEAJDHFFBHFhABABBFCUCBAdCAGAEEBZADAhACA..YHCA.fAHGhAAAcGACNEIA......hABA...,2,-32,-25,7
fLWIXSRFUNBMVdPTGHCOKQeaDJbcgEAYZ,ZAADLGEA.XBADRFFFUGAHMCFE.dCCHTDFCHDEEKAFChAAAaFACDIEG..JEAEgACChAAAAAEF.WBFChABAIGDH..FHAGBACAVDCF.CFFD.hACA......hAFA...,2,-24,-16,8
gIacLUHEQZRJGPTKFSDYBMNbCXfAdOWeV,OCCHeFBB..IDGGLEFC.EFDBZAAARFADGADDKEDEDFDDBGGChABAMCAH...NDAA.XGGAhAAA.AIDG.dBEChACAWAHBaBHF..........hABA......hACA...,1,-23,-36,13
CPYOGbVLUTReXfdHBSQcDgEMNJaFZIKAW,CFDGOGEAGGEFLCBCRABC.eADEdAFBHEEABHCFQCFChAAADDCBMAAF...aGAHFBHDhABAKEBAABGF...WHEGhABAPEAF..bEFA.......hACA......hAEA...,2,-26,-16,10
SZFYgGIDcRUWBeCVMbAfKdQONTPaEXLJH,KAFBdGDDQAFEOCDF...TABGaABFEBHDLDAE.hAAASGGDFEGAGEAGhADADFCDRGFABADHCEBFMFDCABBHfGDEhAFANEIE..JFAFYDFFhAHA......hAIA...,2,-24,-13,11
CMITaFecQXYdAbDJRLKVNSZEBOHUgfWGP,DEFHLFFCKHAC.SDAHZAFBBBAB.UCGG....fHGFhAAAGAADPDCBhAAAMDDB.aGGB.FGDHQEGGhABAdHABAGACRAEF.NCCGHBDDCHHE...IDAHhACA....hADA.eHDA.,2,-24,-4,20
JaRZADBdCUXLKbOcEfgQYMSVHTWeGIPNF,DFEAdBEEUGDFKECH..OAGHEGHF..QBGGMIBE.SEAAhAAATBBB.eEFChABAIGEDFGAA.aDACACBGBACAhACALABC.fGGE.gFAEhAAA.YDHBhAFA,1,-30,-35,5
ALJORGEPMebVIWcagFHSdTKXZDQUYNCBf,OAABGBCHMDBD.eHFEVCFD..IABGaGGFHCBGTDEChAAAKFBEDFIB..QEGHhADANAEBBBED.AHDBJAEChAHAEHBC...WAHH.......hABA......hACA...,2,-32,-7,25
SHQfVcUFZDWgAJaTIRPbNdXeMCLBOKYGE,aAADREFH....bGBGXEDD.MHCCCBFGBCGH.KEDGEBDBHACHhAAAQEAH.hABAVBGBFEAEDGADAGGFIHHHhAAANAEBdCAF.LDAEOHEC.SGBDhACA.cDFC.hACA...,1,-5,-26,21
MGagHdcYQXVWbIFDUKESLTBNOACJeRZfP,CECDRFBGZAAB..MHFCGCDDHBFCdEBFQGBC..WAEGhAAAICCB.FDEDUGGBhADA.EEHHSBEChAAABAHBAHCFeEFF.aGAHgEGH.hAFA......hAGA...,2,-23,-18,5
GMTaFbNIYdHZWUSECAXOPKeLVRQDfBJcg,XDACKDCDeCGBLAAERFBF..fEHGBAGGJEADGEDChAEAMBFCFHGE..IHHEhAFAdCDGHAAF..ZBBEhAHA.....WFFBSGFCAICE.hAIAOFDD...hBBA...,1,-17,-27,10
dfcFNSbDAJaCRBgeOYMWLVUZHEIQTPXGK,CDGFBFDD.eDHFMBAALEBEUFBCZDAEEBAA..QAGAhAAA..PAFDXEGEhABAKHCGfFFAhAAAFFDESHEGACCCaBDDgGGBOAHH.YCAEhACAWEAD....hADA...,2,-28,-21,7
KQBJYXISEZbfGNPFcUdTDVHWReaAgLOMC,LEEGCHFDKAHH.JDBE..XFAFEBACZFBAGADFFAAB.dGGBDAEHhACA.HDFHeAHHAEDEMEIBhADA.BCCESHAEhAAA.fCFAcGCG....hABA......hACA...,1,-18,-40,22
ALOBFSMRXJcIQEZUKdaTYgfPCHbNDGeVW,LEGHFDABMCDH.JBAF..QFDHZGBGUCDE.dGHG..aBGBTAAFhAAA..fAEFhAAAHCEDbBGHDAIH.hABA............hACA......hADA...,2,-45,-17,28
dTYeZLJQVRbMaXUBFgEfPGWCSNKcHOADI,DGHHTGBCeCDF.LFAFQADF.VEFBMBHD.UBACBEHEhAAAEFCBGBBG..hABASFEDKBGEcGDFhACAAFIBIFFE.ZBEB.....hAEA......hAGA...,2,-24,-19,5
YNfaMWcbXELDJUPFdCTIeHSQKBROVAZGg,ZEBHGAFE..NCCF.MDAC...bEFGLAHF.UEGDhAAAdHGBIACCeACAQEDChABABBHBOEAHhAAAAHGB.fBAB.aECGXCAChACADBEHPHAECGAD.SFDHhABA.,2,-24,-24,0
JacRegHAbPNBOWFUQLVYfTESXMdDGZKCI,...NDHE.BAFB.FEFEQAADLBCEVGDATDDF.XADAhAAAdBHCDCEFZEAE.KCABhAAAIGDH.cGAEhACA.eDADACDDOHACYFFBSGGBhABACDFBaAGD....hACA...,2,-34,-7,27
XRPgDEdaGFcOAWJMZTYLCfeUVBIQbNHKS,MDEBTFDHLCCD.eBGDBCGAQFACHEBDXBCDhAAARFFDDAGGdAEEaHGAFABG.AAFCJFFAhAEA..CEHHfABDhAAAIBEEKAHB........hAHA......hBAA...,1,-19,-24,5
TbACYdfSHVDBgKEecJaIFOWZGLXUMQNPR,dEGDSCFCDBCCBCHEKHGG..eBFC..aDBCFCCAOFBFZGDCLEAAhAAAMFEF..PDHFhAAATCAGACDFCADG..hABA..fEEEgEEBEGAFIHAEhACAXGGBNAEF....hABA...,2,-32,-20,12
cLRYINbUfVHXOCeaJBZESdKDTAFPWGMgQ,FHBGGAFEQBGDLECARFFC...IHGCUDBDHABHCCAAaAAGBEEBhAAA..ZFAHSEGEhABADDDGAFIHMAIFcAEEhADA..NBBF.bFDD.......hADA......hAEA...,1,-10,-29,19
BOfYVKUGdHEQbLgceaJPWDRXZINMTSFCA,BAFBOGEA..VDACKGBHdEFBHEEH.QCGFLBCFeHDEhAAAaABD.JAEGDIBA.XFCDhAAAZBEEMEIB.SCAHhABAAGHCfADC.......hACA......hADA...,1,-22,-28,6
NFJbaYTeMVIEcKPZOfXGRBgLSADHdCWQU,HEEECFEDUCFFFEAE.aBBA..eAFA.MABGIAHD.EDDFKCDBhAAAZGAAOHFGGGEFBCBChAFASADEdGCAQGAChAGANAAE..YBGF...hBAA......hBBA...,1,-6,-34,28
gfJEReaVOFcLSNPAQMBGHCZUITDWdYKbX,BFECGCCFHACBUEACDAAHdFECKEAC..XDGDJFAH..EGGFaAFHhAAA..ODEGLABAhACA.SAHFhADAAEHCCFCF.TGGE.bGAEfHCFhABA......hACA...,2,-50,-4,46
fNeXPKQGBIUFVaRESALWZMgCbTDcdOHJY,LFBBZFACCBAH.DFGCdDDBHAEC..JADAfCEA.XGEHhAAAQFFHBABAhABAIBHFFCCB.aEGAhAAAEGHB.WEAFMCDG...bCBDcBGDhADA..NEEE..eHAEhABA...,1,-11,-34,23
HFSMRVIAEZJbPcTgQUCNdaDfYXBGOeWLK,EDBDZFDFJBAA....PFGF..gCGEQAFECAEB.hAAAaDDG.DABG.XFEBhAAABFHHeDBDLHBEhAEAFCEFSAGEMAIFIBBAAACEbFFBUGBFhABANEEFfFAC..hAFA...,2,-24,-21,3
GLaeJdTAHYVWfRIPEKBbcSCZMDUXOFNQg,HGFGVAAD.RCGBEBADBAGG..SCDCMFBEUGDFFFEG..QBEChAAAgGAELEADhACAeEAE.dHGHYAFAhAAAIEGHKDEACCHFDIAEOBBGaDCC.AIAA...hABA......hACA...,1,-6,-15,9
feCYVNUdESaRbLIcAHDMOPZGTKgJBWXFQ,DCCDOCHDZGCAGBGAKEECBHDAFGGF..eGFACFDH....VAEBhAAAdDAFEGCA.REBALAFBhAAAADABHEAHMBAG..hABATBCB.WAHFXEEB..fBAHhABA..hACA...,1,-21,-31,10
fTgZKQIdHeEMVbADUBPJGWNSLYOCaFXcR,DEFABHHGGGBHSDGFOCCHFBEA.REAC...TAFDKFEFdBBEHFFGhAAA.MABAAIDEUGABhAAA..JBDH.LFADhAFACGHEaDDC.cBGD......hAHA......hAIA...,1,-14,-40,26
fDSOGaWBUNgKQPRYCFZVAdEcMJIeLTXHb,dAFBEGFH.MCHFeABDLDDHHACDDCAHGGEBBEFAUECDKDCD.QAGHhAAARAACFDADAFIH.IHHGhACATGBC...fHCHhAEASDFBaGAB.NDED.....hAFA......hAGA...,2,-18,-12,6
PMBWQSfFeCUdXOAYVcRgELDbJTaKGHZNI,VAADRAADLBHH.DEGFJHDE..KGCHHFCAZAED...IAEGhAAABHAFQEADhAAAFDEECHAGUGGCOFEF.AACC.hAEAgAGGEECE.aDBE.....hAHA......hAIA...,1,-20,-30,10
cHKdGPaATVNIQWFBRMCJLOEfeYXDSgbZU,VEFHQCBC.FCHDMADALHBG.EFAGfEDHhAAA.XCBCDGGDbAACUADGhABAKHCAdBHAaEDGNBACBFCDhABACFHBeEFFSEHB.....hACA......hAGA...,2,-20,-14,6
SJNFWILDfKaAPbeXEGOcYgBdQHMVTZCUR,eGEAECBBGDGEODEH.....gCBBdGECMACGVAFFhAAACGAERAFG.JCCAFEAC.LABEhAAAKHAEAIHA..XEBAhABA.BEEAQDFA...hAHA......hAIA...,1,-20,-22,2
YGFWOMVADXgCaEKLJcdfRTPZUeIbSNQHB,DAFBCHHGKDGFLBGH.dDDARAAFZDAAUGCA..eBHB..IADEhAAASHDAHBAABDDBhAAAFGADMGFAAAFF..hABAaGABECFF.JHFEfFGH.TGBEhACA.....hACA...,1,-22,-36,14
TdJZLbHQDWAeYEVfPSaUcNOGIFRKBXgCM,EDCDVAAD..SCHBUGGE.OGDA.GBDAIECDhAAAFAACBEHGXGBHMCAAhACATAEEJFBFLADEhAHA...........hACA......hADA...,1,-13,-46,33
THERJFcSAdeIQPCZDaBVYXgfLbWUMNKOG,eCCHQCBCCEEF.aHGEBEGC..VAFCXFFGLFFCUBADhAAAKFAHGBEDECFBFHDGAIFEdHBFhABA.ZFBADIAE.fEDGhAAAMAEE.OADD....hABA......hACA...,2,-21,-16,5
ADGJWTRScLHOVQFIEBdYZeCPXgaKUMNbf,DCIHJFEF.RABELFDFHCFDOABD..QGABEFAFBAAFdFCEZBEDeGEChAAA..XADHhADAKDAFMFFC.fBGAhABAADED..TGGESCCGFAFGCBHC.hAIA......hBBA...,1,-15,-26,11
UXHceVMBIGZKARgdCNQDEWfPSYFOaLTbJ,RDAGCFEDDECHEGHH........PABDSFHBOEDFaAAFTGBEhAAAUCDA..HGEChACAeAFDBADFIHFEhABAKBGBdDFENAHE.QGAG.fAFFhAFAFADH.....hAEA...,1,-19,-25,6
SRYLAZgcHTaCUEQeIWbXDfKPONMdBGVJF,ZAADHAADCCHA.EBED.eCHH..bECDDDGHKAGEOFAC.dHGFBGGAhAAAJCCF.FAEDRAFA.LFFEhADAAFEH...TEAEhAEAaFED...QCCDIHCCXACFhAAA....hAFA...,2,-26,-19,7
YSXDENOJGVZUcPMKbTCWQRAFgHLBafeId,FCFCHFDFBFGCaFBEeAABdFAB....XDDHDAIBEACCOBFHhABA.JFGDVBBB.ZGBEhAAAUCCCMCIHKAGHCHEA.WFAFhACAAHABLADA...IGHDhABANDIE......hACA...,2,-31,-7,24
LKYMJUBgHODWZfaSPXIVbAGCTeQcFENdR,CFFHTDCH..eCBHFGAHdFEEKBHH..JGAGUGCE.HAEH.DBABhAAAfHEFaBBC.hABASDFCIGGAAEAAhACAQAAF.NADARAEEMCHFBEHG.OEEBhABA....hAEA...,2,-33,-18,15
VBOTZcReSgDaNPYFLWCfUHQKAJbMIGXEd,MDEBXAGHdFBHBABDZDGF..eFDHDAAD.aAEH....NHEF.PCBBhAAALCDC.CHCCHAGDhACAAAGDIDEG.hADAEGGBTDBESFBHFADEfFFBhAGAKABG......hAIA...,2,-29,-15,14
gELWcXCZabBMKGdPTSYDFNHRQAIOfVUJe,OGEAUFDHeBADLCBC..XCGECCGHaFBD.MFADKAAGGADFhAAATDDG.DGABNCDF.RDACADFFhACA....fBBGhAAAgDGAWHBA.....cGFDhABABEED....hACA...,1,-19,-34,15
AWFfTeGdHVbERJDOINZSBYQUMCXcLPKga,FHBGTDACeFGD.HCCCEAAD.RDGB.DCCC.OHDEZFEHSEBBhAAA.BAEA.UBGBhABAMDEECACG.XGAHhABA.PFFC.aDGEfEAGVAFAIHHHhACA.QFCEhADAKBBD,2,-23,-22,1
ZLDgfeMAJPUbOQcCBXVdESHKYRNWITFGa,JDACUCBC.OAACCEEF.BEEFdCFHHGCA.KFAFRCFD....NIEH.hAAATFGHGFBDZACHDAFChACAeAEE..AICG.QAAGhAHAXAGASFHB..hADA.WADHaHEE...hAIA...,1,-25,-27,2
bQARPUJNEKMWeaZCTgDLSYXBOFGdcVfHI,UFDHEDCDKGEEMBDD..aBECCAEA...DBIHSGAEBAGEGAAEhAAAdCAH...VDGFICEEhAAAAFABRFAF...NIBBZEFFhABALADF.OHCEFAHFfABFhAEA.....hACA...,2,-25,-21,4
BSDJKdgAcHEfeXPGLUbNZFCIQYORaVWTM,HDAGeCCHGBECUBDGZCGHCEAD.QAACRGCG..VAAGTFCGhACAMGFGBGGH.DIEAJHFGhAAAKEFBABEFECGE.XGABhADAPFAB..NADF.IAHG.aEGE.hAIA......hBAA...,2,-15,-4,11
OaPdLUJBAEDbKHFTgIRZSYGQVWXfecNCM,EHFGDGHHKDEHFCEF.....TBAARDFFZDACSBCHGGCF.QGAGhAAAXCGCfADDhAAAeAFGCHHE.MAFEhABAOHCCaCDGdFGBJABBAGCEHDBB....hACA......hBAA...,1,-13,-16,3
fQZDKbGagdUVPBYMeRLJTONCcHIXASFWE,SAFBFAFBEHAC.ZCGBKGFFGGEBdCACUDDDBDEB.eFCELAAGhABAOEAFCAHC.HBCEAGGA.hACAfCACDCGB.hAEAaAAC..PDHFMIBA......hBEA......hBIA...,1,-3,-34,31
FfaCNBVYeUbGMREDISAJcKPLTHgOQWdZX,KDCDLDACHFDGOBAHdEEGFGBC..CGGGBHEGVBCG...UBEBMIBGhAAA.EFAGDAAC.AICA.JAGFhABA......hACAPDGFTDFC.WDHHXAGBaHFENHAF.eEAFhADA.....hADA...,1,-16,-36,20
UKEMFgDLScROBANJZedHIaXYVTQbGCPfW,JFBBZDEDeAHBHDEH...aCDBXGGC..TDAHQAEAhAAACBAD.PBBBfGAAhAAAKABEMCIBFGCCDFHFhABAcGDAOADA.NIEF.......hACA......hAIA...,1,-13,-23,10
BVENYOdeFXDSAGfRcZaHUWbTIPMQLJCKg,GEDHRAADZDEBUFCC..TCBG.IFAAQAEE.LFHFhAAAJCFAKGHFBAEHhAAANCAE.OHAA.FABAhAEASDBAAIEE.aAHD...WHDAhACA......hADA...,1,-27,-33,6
EfaGbcTPHQUeMAXRISZLKNJOVCBDWdFgY,REFHSCFCKBAE.OEFABHAEDEBF.dADDFEBD.EHBGGCDGhAAATBADQGCGhABA.MCCDXFGEhAAAZAFB.JDDFCHEA.WADGfCHEaGDE...hABA......hACA...,1,-23,-28,5
AbIVZCTeOJKXdBcGaQfRgMLPEDYHNSWUF,VAADCADC..eFEEOGCEKGAHBBBB.GBDDaBFARDCF.LDEGhAAADAGCHFGF..SGDBhABAFFADAADFZCEC.TCAChACAdEFE...fAGDMIBA...hAAA......hACA...,1,-15,-26,11
gSJGMFPOdALefXZNDBbIcWUTCREKVQYaH,LEEGeDACZGDEBBAD..IGDDUFAECDEC.EAGE.QCABhAAAaAGE.SBGGhABAJADEFDGE.OEBDhACAAFED.fGHEDIGA.WBBEKFGC...hAAA......hABA...,1,-15,-40,25
KHMTAcWECegGNRaUJbXLOYIQDFVZdPfSB,EHBGCAFBGCFCRAFB.UAAFJBBG..LECA..IBHGhABAFHEEdFGH.SHDEhADAKAHBMACC.AFBFeFCG.NIAD.hAEA...aBEF........hAHA......hAIA...,2,-39,-30,9
FWdOTSLAZCEPKfQVYbNUXcgHGMDJReBIa,EBBDKHBGQBDA..bADCUDGBXGDGHBADMEFB.hAAADGHHRCGHIFAFhABAFAGFdFAHOAAATEDDAGGBCHDBfCEHhACA.NECEcGGD...hAEA......hAFA...,1,-7,-21,14
ZdEeTWcCQbBXfLPGaIURHKSAYgDMOJNFV,DACBJAFE.FGHBZDAG..dADHEFFB..eFCF..TFAACGFHBBFALHFAhAAAGDCB.IGDHhABARBGFKGAB..AIDA.gACBhAEAMFFC.VDFA.....hAAA.cBAC..hABA...,2,-38,-17,21
cNZbdKfYERAHXULTPCMIDBVQWGegJaSOF,XDCBUDCHLAAB.CHED.DACBBFGDQBGGGBEF.eGCEhAAA.aEAFSGADhACA.FDHFZFFBKHFCEHAEhABARACFAGEATADB.MEECIEAC..hAEA......hAFA...,1,-14,-28,14
CIXPYEJVZFGdHNTWUaQSRcbeAgDMBOfKL,MCHFBAFBKECGLCEB.CGCB.IBAE..XGDDhAAAEFECZGEEdDADHACE.NBBETGFFhABA..aCGEQGAChACASFBDbAFBADDGDIBGPCCB..hAEAJBDA.....hAIA...,1,-7,-38,31
fZQHXRYdFEeBbCAGOUaDVITcWKLSgJNMP,GDDCUAADDDCA..TDAHKEGELFDA..JCGFMFBBfBAAhAAAHBEG.XGGGhABAdHGB.FHACBAEEhABAAGBGaCDAIEEG.WDAGgAGBhACA......hADA...,1,-25,-32,7
MQaCRKHWbfZNFSBcLgIUVPXDTeYEOAdGJ,dHAFJBFA.aFGFRDFA..HBAC....fCCDFFADBHGELFFGhAAAIEEA.UECFXEBDhAAADIDC..eADChABAOAFBADDB.MBBDCDAC.......hACA......hADA...,2,-36,-25,11
LNBfdTGWJVQXDYecICSZAEbMaPKUHgOFR,EGFHMHFGKFDGUDGH.HFBBOAABLACDBHHEdDHEGAEE.JBAFhAAAQAGDDDED.hABAeBEDCHDH.AFCEaBCDgAGGhAEAFHCE..NEAF..TFAF..hABA......hACA...,2,-24,-11,13
XZJBHbdLFDOMVeUfKAISRgQCcYEPWTaNG,SCFCQFDHCHBFEAAD....PBCAaDAFGACC.JEDGhABAbCABFGGE..DEHHMIEEhACAUAGCABHERFBF..gDDEhAAA..WAFCNABFBHHGdDHE..hBAA......hBBA...,1,-9,-28,19
FZcMOaJWRQLIHdBgKbPDTVXYCUfEGNeAS,SEHBFCFCZBAG.ODCBJHCA..QEBFHBCGBFGBKFHBPBGBhAAA..DFFCXFDAhABACCDH.fFAAhACAEAGAeGEEABBGMIAGaAAG......hADAWEECLAFC.hADAIHHH.,1,-8,-33,25
JVZGXUOdfSBeIbYRAWKcTgHQMFaCNPEDL,KHBGTCBCHCCC.MABDFDEB..CBEE.EGFBDGIDLAHFZCFB.XEGDhAAAOAEAdHFBBEAB.hAAAIACE.bFAAhAEAABAGcEGD.aHBAJAFF.....hABA......hACA...,1,-6,-38,32
ZPKMEeQgCFTBaRHJUOdbAGVYDWISLfcXN,GEDHDHCE.SGGHLBEEXEDHZBDBMDAB.EFFEQGAHhAAACDCBBCAG.HGDAUEABhAAAdACEAHFE.WCFE.IDGDhABANCIAKBBC.eCBDFGAD......hAEA......hAFA...,1,2,-30,32
YaCPSfDeOKTHLcGUFZNXAQBWERgMVJbId,BHHGECFCRBBC.MEAC..VEEGJGDC..dCGACFAD....SHBEhAAADBDFOADAHDAELABDhAAA..cFCAhABAFGBFZEFAAHAB..........hAHA......hAIA...,2,-39,-25,14
JRKaOcdIXfTgWEZNCePQVHbGUFDYABLMS,MIAGSDBDKFCC.OEFHdFGB..XAEATGCE..EEGDCGEH.hAAAQCGAHBBAbEAB.hABAFACE.AHHFBDCFLDDChACAaAFAIEDGfAHEWAAF.NCCH..hADA......hAEA...,2,-21,-11,10
dcRELMUgYAVfaDNSXebKITOQWPGJBHZCF,VDAGaHFG..DHBG..SDDHeDBHKEHD.OGDAQEDHhAAAGADDBCGDCHHG.FCABdGABhAAAEAFCMEID.UABEhAEA.AHDD.fABE.....hAGA......hAHA...,1,-21,-32,11
NJCBKDVXSaPdUHgbfWLEIZGTecYAQMORF,MAEHODCHREEH.FAHH..CCGCBBBAKAEA..DDEH..SFAEhAAAaABCUGFH.HDCD.fHBBhABALCADEGCChAAAIHHG.........hACA......hADA...,1,-34,-43,9
PafXJUGEDbgedCOLYTQAcNFMHIWBZVRSK,FHBGMECGHCCCBHACRBFGKACG..aBDD..XEAEJAFEGGEHDAAD.hABAeDGDdGEH.LFCGhAAATDFC.AHCB..ICBEhABA...ZBFESCAHfACFhACAEHGACFAA.....hAFA...,2,-22,-18,4
STfFONWZXVCKRLQUbgaGDYHdeBAMJPIcE,JCHD..PAFBEAGD...SDDDTBDDFGGEOHFAZBADCGCH.hAAALBBE.QGDEhAAAUDDFaFABDIFGhABAYDADeEFHACCHMFFC.IAHCNIAB.hACAWCCF.KCHB.gGAFhABA,2,-23,-8,15
UDJHOadRYQAeSXMfECbWVFTNKZcIgPBLG,SAADMFFF.EGCFbEFF..FAFBTAFEKFGAZCBG..ICHFhAAABGEEUEABHEAFdDFChABAQCDCAHBD.hACAeABCCHHH.NBAE.PAHFDEIDOHAEaHEC.XFCBhABAfBBB.hAFA...,2,-20,-5,15
BJZOEUDNfScYdGKMbATCLgFVXQaHWeRPI,CFEEFDCD.QAFEaACBHADF.REGD.BBHDZFCGUABFDIEE.....hAAA.fEHGhABA.SDFBhAFAdHDBMAIBABEDTGCHLFAHXDBA.eAFChBAA.IGGF.hAAA...,1,-18,-29,11
PXbNKORIAVUDCHdELTgMBQFYacZGJefWS,VFEEUFCADCEH.HBFHdAHGEDCALBCF..TABEMFBHQFFAhAAAFFAC.aBAFhABAGAEG.eHFAhAAAWAFCSGBA......hABA......hADA...,2,-22,-22,0
ZRfECSgLMPOdeBaGINFQcTAbKDYJVHUWX,KHFGDEFH..JECDVCAD.HDDAUBACZFCG.RACF.EEGE..CBGHLDHBhAAAMIDG..dBEEeFABhABAaBGG....IFAAhAAA.FGGG.......hACA......hAEA...,1,-21,-42,21
EbWZKPgRecaSJALXCBdVONGHfTUFDMQYI,XGDEBBEAdABDOCDHGCBDHCGF.UAEHDGGCMHAGQGGGhAAA.IFABhABAEBGHZEFGKFAAgABHhAFAeAADSAECAFCECAHC.fHEF.hBAA......hBBA...,1,-3,-31,28
FYZfNQRdACbHBXgaVcKeUMSIDOLEJGPTW,HDBHXGGGaAHHKFFDUFAC..MFIDDBBALFDDGBCH..TDFGhAAAFCDAZAGHQGAGhABAdEEAAAEE.BHGAVCAAhAAASFDD.EABA.....hABA......hACA...,1,1,-26,27
SdKYOZRGfDLFIVNWgQAbCMPHETeBJaXcU,CBFDMECGHEDD..EAHHBGGG.aEAFXBDGUBAH.KGBGZCGBRFDGDIGEhAAAFHAA....IAGFhAAANEACQBAC.hABAAFFC....PEHD.TCFAeDCCSHGAhACAYACC.hABA...,2,-25,-24,1
abFZJdMETPgAQGLcIYHBVUDfKRSOWNCeX,QDACLFEF..IECBBHEADGHHRAFE..OFHHCCCDaAEHFBHBhAAAJCCA...dGCFMBBEhAAAEABE...TCAFhABAgDFDAACE...cGAHVFABfGFEhAEAKEDANDIE.XDGAhAFA.,1,-22,-24,2
HYSXgRVPQTaZAOfMNBeEFcWILdJbGUCKD,MDEBBAFBFFEE..IAGCJEAB.UFBEDHCEHCAG..SDGChAAARABE.QBAHhABAaCFBAAID.fGHEhACANEIG.EHEC.cBDA.WEAFhADA.dFGBCBAGKHAG.hAEAgECA.,1,-12,-40,28
OTSRPDWENJUaXcLbZfFdAGHKYMQCVgIeB,HCCHKGFHMDDGCAEB..VFFAeABG.BEEFSBCEDFBB.ECFEJDAAhAAA..UGAE.XCAHhAAAbFGFZAFEdCHEACHG.hABA...QFDAIHDH....hACA......hADA...,1,-18,-32,14
LeNVTBOHQCaEgcfRDbKPZUFWXJAGIdMYS,dGAHMHFGSCCCLCDFeABD..NEBHBEGGHBGBaEAG.EGABhAAA..fAFAhAAADAIDKGCBPFFCFBGDXFGAhABAAEEGIADDVFDF.OACACBFC...hACA......hAFA...,2,-21,-11,10
AFMVgUWKLEBCRDbdPIfSOGTaHeYQcZJXN,MFCFUFDHKFAGLHFCBHAA.CCBA...DCDCdEFG...IABGhAAASDDAODDFGAAChAAATAFG.eFAHhADAQAFE.cGGGJADBAFABFDHD..hAFA......hAHA...,1,-17,-45,28
FMCfDGJKIcbeSHTEgaLZXdUWVQBROPNYA,CBGEDCECGGAHKEDB.....IAADeDBCSACGEEBC.hACAaGADLCBEZDGHdFAB.hAAAVEFF.BADEPHCAhABAADGAMBIDJAHF.........hADA......hAEA...,1,-25,-33,8
QAPFTKdfDVZRbJSGBMLWIeYUCNXcaHEOg,TGBCKAFBDGIBZFEB..JCCEBEDELAAF.eEFBCCBC.XGDFhACAHDGDOADD.hADAAICE..dFADRAFDSEBEhAEAMAIH.IHHE..YAADhACANAIAaBBGEFAF...hADA...,1,-4,-47,43
JCPFNOSRGfeWEDgYbZMacLTKdUXVBHIAQ,JGFAFEGDODBEGEBB...eADBDAEG.....bAGDaEGCLGAGhAAAdBBDVBEABFEEAIBG.hAAACFBA...SDAAhABAfBFCECHFYCAEMHAE.KGED..hABA......hACA...,1,-23,-29,6
fCeEKHbPdVINQBTXLMZAWacDGRSFOgUYJ,aHBGDCECRCGF..OBEAUEDD...JCDACAGE.KBACHABG.dCADVGFEhAAA..QEAChAAABEEBLFAAAIAC..hABA...cDBEFGFDfGDC.hACA.EEHB....hADA...,2,-32,-31,1
SBVWHZeMEIDFNXbTQcRYdCLOJGAagfUPK,aHBGUCBC.KGECBEDCHAEDeAAB..EHCEFBFD...XGEFhABAbCGD..QGAAhAAAcACC.dABBCEHGLAFChADAJEDGADDA.fGHESAGE..hAEA......hBAA...,2,-27,-19,8
MaYITDZVJLSCFcKNPHfAEdOWQgbGeXBRU,EEEDOCCH..QAABGAEGBEGEUGAEMBBFaHGA..TBEGhABADIACZFFF.JGBCSAHBhADACBHF.cEGAhAEAPABAAGDF..WDBC......hAFA......hAGA...,1,-26,-36,10
RIEGHTVeaBDbXANSQMYJcUKdOfWgPLFCZ,QGBCJCHD.KABEdHCH.OEBA..gDGEhAAAFBFACGGEZFCA.EECBHBCEeCCADABChAAAAHGDMBDG.cAGAhAEAfEAELEEF.IFFH.hAEA......hAFA...,1,-7,-39,32
UfYOXbcSDeIBFLCHRaJAKTgWVGZdMENQP,TGBCVAAD..dCDHMBEA..EFHFQEFHUEAG.fDAAhAAAOGDC.bDCFDDGEhAAABHEACEFEaAHD.AAHBKADChACAgABH........hABA......hAEA...,1,-28,-31,3
HMBXKbcIRTNSFAeCYDaWEUJQdfgPOLGZV,eAFBCAEDDDDH.EFGH.UFCBQGDF.dBADPAADGBEBHDEHhAAABEEEKCCG..IEGDhAAANBIAABEF..aEAHfAGBhABALHAAMBHFXFAD.cDAFhACA.SGGFhADA..,1,-14,-24,10
dRgAeaXDVTHWNCQOfMcPSLFKZUBJEIYbG,aAADXFCA.DHGAVFBC.HGEACHAD.QBDDMAAA.SEEChAAALDHFKDBFhAEABAHGECCEIAFChACAGAEBRDEDAEAEeFFG.NIAF.cFAC...hADA......hAEA...,1,-13,-19,6
deCBbOEUKPIAJLSgVfDZWGcFYRMTNHXaQ,SAABVAAD.DGEHZCGBGEAFFCDCMAEEHFFC.QAEGhACAdDADCFBB.BBHGEHGAUGDAhAAAIDGF.JDCC.hACAfGAA.......hADA......hAIA.cDED.,1,-12,-28,16
BAfJLZDXGePSgWHNUaOETYCcdMIbRQFVK,JEEGZAADGFDD.eDEGSGBGHDBF.aAGHTBGA.CHAAMIFGhAAAIBDA.RAAFFGHDhAAABAFCAAHC..DICCXACEhADA..WFAFNDIE.EFDB...hAHAYDAG.bCFAhACA...,2,-41,-1,40
MEIFWBfQKTZGARdNJegVCXSDOUbLYcaHP,RDAGJCCHeAHB..CFGC.DGBCUGAALADG..aFHDHEFG.PBAEhAAAMFFF..FCABBHCDhABAKAFG.GGEH.hAAAAIAA.NEEH.XDDB..SBEDhABA.YAHBhACA.EGDB.,1,-7,-47,40
WBCZUFgONYSKQfLPRVTDJbXdMeHIEaGAc,BFDGCFFCZFBB.UFEGFCAA....OAHFSAGF.KEBDQGDGhAAALCAGRAAEDCECJCHFhAAAdDED.eABA.EHGEhABAaDEEAGIB...cGGE...NEAE..hACA....PHBChACA..,1,-26,-34,8
OVAacXQBLPDKNbREeUMTFdIJGYSgCZWHf,XGBCBFEEDBAAKDFARDEH..UDGGFGGA.dACG.GADF..SDCEhAAACBABZEAE..hABAfGGFOEABAECFaGCHhACA.LADE......hAHA......hAIA.bBCAeGCE,1,-17,-48,31
MDadQNLGCAgfUSWZIXOPYTHJRVecBbEFK,UCBCSCFCZGFE.OEFA..PAEGTEACHBFC.REEA.hAAAVAACeFDDBGGCEACGKDDEhABAaEDFdDAF.LHBGhAAAAGGA.fAHE....hADA......hAEA...,1,-18,-21,3
DJIKMXBTcaRNbWZHPLSYQVeCFUfOEdGgA,DEFHKDCDBEHC..TCGGRFEG....bCAFZBBE.LGAChAAASGBFQAFFhABACHCB.fFHGhACAEADG..dAAFADDHIEAAXAGBaDFGNIAHWEGDhADA.....hAFA...,1,-21,-42,21
ZKXPgCNLEbMVOIHGacTSRUfWdeQAJYBDF,JAFBBAEDZFEFKGEE.....XDCFCBCBLHBAEBCE..MAAFhABAOEBFHDGDGAAEhAAAaAHB.SGHDhACAUGBHfCFAeDHBAAIFDDAH.FDDCNBBE....hADA......hAEA...,2,-23,-19,4
SBUAbVWdCDfRGFHTLZXPacgKYeEJINMOQ,VAADCFEDDCDG..GCAHFAFBLCEA.ZFEGaHBG.KGHDEHBE..hAAAJDFAMADF.QEBFhACABEEBAAACdFBBfEEBhAEARAFA.........hACA......hADA...,1,-14,-43,29
GFKMXJfOSABVUTDEQdZRbLgNHCWPecIaY,BFFCUDCBDDAFQEBHZBFF.LAFFHFEBCHCD.eABD.aADFFBHBhAAAMDHFJBCA...SCHBhAAAADFH.EHBGhACAdGAGgGEANABC....cGGEhACAIHHH.KDED.hADAfAGF.,1,-5,-31,26
eXBUYgaPWDOKQFZNbHAVILRfTGJdCEMcS,VFDFLFBB.TCBGdCAAEFBB..SDFGBBHGUGGHaGDEDCFDhAAAKEDHZADB..NDIEHABChAAAAAGD...IBHGhABAfABBCFFBcAEFXDCC...hACA......hAGA...,2,-31,-21,10
RaMDeYWHVUQPFJgCfbKENcGOTXdABSZIL,SGFHZFDFRFBHDEBB.eACGHAGD.UCEAQDEH.PEABhAAAFHGACBBFKDCC..EBAAhABA.NECGGBEFODHDdADBhAAABDHC.IFHFMCAB.WDDF..hAEA......hAFA...,1,-13,-24,11
GaJFRHEMfVXILYNOZbBPCScWQKUTdeDgA,aCCGJDCHHEFE..MADG..VBGDIGHHLACG.OCCAhAAAZFFDBEBH.CCGASAAChAHAcGBHKBAFdEEChABADDDFGGBBEHGAfEAANBEF..WEFChAIA.....hADA...,2,-26,-15,11
XSdYgTKGORUQLaBZfPbEHWMNCVFcDAJeI,JEEGeDAC...SBCGdBEA.TCFAOEAG.QACEhAAALFCDBGGEZFGDfGDHhABAEGABMFFENEEGFAFAhACAABBH..XAFAKBBD......hAAA......hABA...,2,-29,-25,4
UALZdgWVKYTXMHGFCfBDPEaOcbReNQISJ,LDCHZDAGdACB.VEEEKHEC....XEFHMBEEFDAFBAGGEAAF.hAAA..aEDEOCHDhACARCFG.QGAGhADASAHBAHHB...WAAHTGDAHFBACCEDDCBE.hAAA......hAFA...,1,-9,-33,24
IHLPOXKQJBgAdcfeFYMRNSUEabGZCVTDW,dHBHeGEAFAGDREDG.UEAFEAAC..GCBAZEEH.CADD.DIGEHAGDLABGhAAAOBDE.KEGEBCDBAHHD.hAAA...fFAAhAEAMDDHSEGHaGDH......hACA......hADA...,2,-43,-1,42
cBIUTJWRQegOGKLNCEZVYdPADbFXMfHSa,DGHHXGBCHBCAaHCGBEGB..UAGC..JCBCQDGChAAAOCFAKEEDLDEF.hAAAEFBGYACCAIDAFCADMFIHhABASECD.IAHHWFAD.eGFChABA.....hACA...,1,-16,-32,16
WJUVagbLIQHSTBMcKeNYEADPXZRCdFGfO,DAFBZEFHdCEBGDBHOFBEUCGG...aHBALAHH.IBBDhAAASGGABGAGKFGChAAAeACGEABCAEAH.XBCAhABACEHF..fDCAVFDE...hAEA......hAGA...,1,-25,-34,9
KLVfATcNYDHMQOZEIgPSaeFXRCGbWUBdJ,TCBC..cFFGDFCGHGEA.OEAHEAEH...gDGFhAAASBGFaBAGeFDBhAAAFBED.RBBDbDADBEEBdAHAhABALADCAHHHMCADIDEHCHCH...hABA......hACA...,2,-17,-11,6
FOTNGIaLCMdPfKVSDJbAYHXcQWURZBegE,XFDHQCBCRDBH.BFGD.eFCHEAGDFFGDOBDGGABHLBHBhAAAMFAFdDFCKCADDEEGACAB.hAAA....cGABhABA...........hABA......hACA...,2,-28,-27,1
CbAIEOQSGWcXaFPKgNUMDVHRfedBTYJLZ,OCCHSCBBGAEG..XBDCFHGEKGEHUEEDDDHHHAEGRGAC.hAAAeEEDBABFJHCCCDGE.AAEEEDFBhAAA..QAGEhADAaHGGNCIA.MCBFfDAC...hAEA......hAGA...,2,-21,-10,11
XGUgcdFDNKbHZOeRPBAMJICQLWTVEfaYS,JCHDQGGGLFCF..TGBEEAGF.aDFDSBAGGAEHUCADhAAAdFEGDCDEKABGZFDFRDAFAIFE.hAAACDEE.....fAEHhABA.gGGB.cDEAhACAFFAG....hADA...,2,-31,-9,22
eSNQafGMcJWIbDgPXELVBRUAYFKdHOTZC,FAFBKEHBdABHHCGFZFEFSHGE.QGCHfHAFMACFhAAA..JEBG..WDFFhABADAEBXGCBhAAALDAFBHADRAFF.AEEB.TGGACFHHaEBE.ICAFhACA.....hADA...,1,-18,-27,9
deFZWQVPcSUJCNObEGYMIXTHLRafKBAgD,DGHHdEEDZADCQBDA..VAADSDEAJGAC.CDBGOFABhAAA.GFCFMEIFIHEBhAAATABALBHHhABAaCDGKGGB.BFHBACIH.FHCC..PEAEhACA......hAEA.NAHE..,1,-8,-33,25
ZgDcGWRUECNKdSXTOLeMAVIYbQPfJHaFB,VAAD..bDBHQAFBJDHF.FCDBBAGCZFGD.DAIBGEADhAAARACCEFED.CADF..KGFDSHCGhAAAOEEG.MBADhABAIGAA.fCHEgGGB.WDDAhACA...NBBE.dGDEhACA...,1,-14,-24,10
RFgaeZKUDALHIPcbWNCfJSOdEQYGVBTXM,LFBBHAAD..PFCHbBGB..CABD.SCCDdAFC.EGGEhAAAQGFFGADCVDFEhACAXCCEFBGCeFADhADAKDFBAIDG.ICADNIDF.OEAH.BEHAhAAA.....hAFA...,2,-16,-2,14
JLdfTaGRPNQUHOYBSKcADbZFCWeEIXgMV,ZFDGCFED.ECCG..XBFEMEACLFBH.dGHAfDBEhAAAGACF.RGFEQDEAhABAOHDCBFAGKABGAABGDEFGhAAAbDCFeHAEIAHF.......hADA.JAEE.PDHDhAEA...,1,-15,-16,1
bBPQRDGNcFfHdAVSKZLYUeJCWXETMagOI,VFEESEHB.ZDCELHAEUGAD.CEBHEAEGaACH...OBDBhAAAIAADBABCRBFBDFGHhADA..NBIG..fDFFhADAdAFBABIH..KADB.eFHD...hAGA.WHFA...hAIA...,2,-29,-24,5
NPHMaDCYfEKXZBQARbgGdJSILcOTFVeWU,RAADGAFEdDCA.SEAALEHDOHCAFCDDeFEA.UABEHBFEaHGEhAAACEEBEGAF...XGFDhAAABHDEAHAA.gADFhACA.........hAEA......hAFA...,1,-12,-32,20
TMEQFZGXKCgBYOIPfcUDLdHaJeSRbWNVA,MBDHQFCEFFDBZAFGKDCG.BBCD.OAFBIABG...hAAA.PDABfCEGhAAAUGEADHGCHEADaABGSEHHhADARBGF.NHEBAICATGACECGFCFFA...hAEA......hAFA...,2,-24,-19,5
gFXVTGIZYOcRHJKSbNDPfALBdaeCMEQWU,dDABCDGF.EHGEUCDE.FGGETBEG.ZGBEOADCHAAGKAHH.SEFFhAAADIDGAFHEBDACMEIHhABA.QEBBhADA..XFDH.IBAHhAAA.RCBF..JFAH.NAIE.hABA...,1,-3,-46,43
KLeBUaMWVDRXOPNHcCSIgEJTfAGZQFYdb,ZCDFFGFCdBFHKFGCLFADBFEF.UBGCaGBA...MBAHDCCGOACAhAAAHFBB..CHEDSGGGhAAAEDBH.JBBFAIBC.hABA...YDDEWDFG.XDFAhAGA.NAIE.....hAHA...,1,-22,-42,20
cHEUJIaAKFVGfYDTgQMBNdXeZRCSWbOPL,KEHBFGFHGDCCDAFE.QBACBEAEdFCFZACBCBEE....bBGFOABHhAAA.LBGFhACAHFAHUEGB.IHHBhAAAaHCEADHG..fFFBgCDBMECEhAIANAEH......hBAA...,2,-44,-3,41
IHCRBYfEXaOMKJcGSFVQUZPDgALeNTdWb,LEEGeDACdEFG...IGDDHGBABAFBECFF.aADCKDBHGAGEhAAAFACAUAFFDCCGAIAC..TBADhAAACHGA..YEAGhABAfGGF.MIDASFHB.hABA......hAGA...,2,-29,-17,12
NLBdRKfOIXZCYEPMFTbcVUSJGaDQAeWgH,eGEAHAADLDFAdCDEKBEC.IEDDZAGFCCBB.EGDGFEAH..bGACUGCEhAAAGADF.DIGAADFF.hABA..gFFGhAAABHHGOEFEXDAAMACE......hACA......hADA...,2,-34,-3,31
PcIfZRVNXDWaKEUBGHTFbJCgAQdSeYOML,dFHAeCCHMFFDLAHB..IHAARFCGVAFF.DCBBKEADBAABHGFAhAAAFCCD..JABCCHDFABGFSBBDhAEA..hAFAPFBAfEEFNEGA....aAEH.hBAA......hCAA...,2,-42,-11,31
YTPOGDgBfSaUXQMZRcNLVKFJdECbIeHWA,TCBCGECFDBIB.BCAHaGCF..UGGEMCHBZAAERCCC.LCHHhAAA.KAGGJFHBCEAHeEEChABAAEBBOACG..fGAGhACASAEAXAEHNHAB..dBAB.hAEA......hAGA...,1,-16,-31,15
eQTOHWYDFJKSMRXPCBbNacAZgVdUEGfIL,ZGFGVDAGEEAC.GDDALAHB..TAGAHFCGDGAHKBCC.MABAhAAARFBBCGAG.BHGF.NEIG.aDAGhAAA.AIDEdDGG..fHCDhAFA.eCCE.....hABA......hACA...,2,-20,-19,1
aUQLAGMXCFPbITDfSgEVHWeZcBNdKYROJ,XFGCFEGD..ICBGDADG..SCADEGHFHACEeCFGhAAABFBAKHEAODEDaGCEUAGChAAAQAGBAHHHMBBChABAPECH.fEAAVCCE...hACA......hBAA...,2,-32,-11,21
JNYadLWcIUZXfeMRgFAEDVbTBPSCHOKQG,DEFETFDHBCBA..CBDCHGAAOHFA.KABFJCDB...aBAEdAFGLHFAhAAA.IAFChABAUGBFXDAChAAA.MDFGgFFBEACE..bEFASCFBhACAQECDNCIGcDAAhADAfAHA,2,-30,-27,3
gRGSAbNKPJWHLfDXCEFOaeIUBQZMTdYcV,KHBGJGEALCCGDBBA..EADGODAB..IBHFBACAZBFFhAAAdFAE..VEBCGCEChAAASHBEAHFB.hABA.PEHFfAHACCGGaDCBeEDDMEIH..hACA......hAFA...,2,-31,-25,6
SbaJcEefPDMKXVIOGgQNFLACTYHWZURdB,TGGGHAADZBEA.dHEHBCAFSEEA..JCDAEGGEeDBHDIBAMCDDhAAAXAEA.OCGDhAAAgDAAFABFAIFECFEFhADA..WAHB.RFBEaGACfAHE.hACA......hADA...,2,-28,-10,18
PDHIFWCUAXVaNQKLbSTOZYBGRdfMgEecJ,aDAFKGFCLBEE..SGBEZABFBDFGRFACdEGG.MHFCEDAD.hAAAeBAE.JCDGDEEDFEEBhAAACDHBABDD....NIEHQAGEhABAOHEC..fEHGhADA......hAEA...,1,-19,-41,22
gDFfLSKebPZRaHNWcQGXVOEUYCJTMBIdA,DGHHLCCHeFDDZDBCRFFAHAAE...NEEE.QCGBGBEGOHAAhAAAEAABCFBG...MDABhACABAHCAGBA...FAEHKDGAhADAaACD.XEGE......hABA......hACA...,2,-33,-11,22
BdJcQXTYKEACVWMLfPgDSIeRFaOUHNGbZ,VDBHLCHD...PGDEDEEHSHGGRAAE..aEBGUDGGhAAAGBDABHAGJHACXBCBhABAKAGFADAC.MAFFhACAgGGHFHCE.OFAE....hAAA......hACA...,2,-32,-19,13
DOQSJELZRePXfAYKGVdcHbWaFBMCgNTUI,GEAHVDAG.dGGEHGFE..aACHMEECCEGE.TAACDCID.SCHBhAAAEGBBRAGH..XCDDhAAAAIAAKGCA.bGDCFAFHhACA.BAHB.NFDFIGADJBAB.LADFhAGA....hBEA...,2,-18,-10,8
QBTPMDCaAgIWNfGOVRSLdFEbJZXeUYKHc,..IFDGfFAFGGEBOGCC.SGFHFBCCJAEGeDDAhAAAKEDCQBEHhAAABHBCMCFGDABCAHBBNEIG..LBAAhABAdEAHEDHF.XDAC.YAHFhACA......hADA...,2,-22,-16,6
XdOVeLJEBPHFafNbDcIGQMCSTRUKgZWAY,dGFCeFFCEDEBHBDG.aEBF..fCHEDAHBGAAFMGBGCHGERGBA.UBBBhAAAKEAFZDEEAECB..XAFChABA.OEHHhACA.LEAD.BDFB.NIAF..hAAA......hABA...,1,-8,-21,13
bUdJTPFLOMNXWRgVAEcDIGQaCZeKfYSHB,EHFGDACBGBDG.CFBF.ZCAD.fFBCHFGBBGEAdEGEJHBCFDCCLAGFhAAAOABAXGCAhAAA.RAECADFCIDBGhABA.aEGBKEFF.SAHH.hADA......hAEA...,1,-12,-33,21
DPFVLEZTBdXHfUKIOJacMNeGRACQSgWbY,CFCFSGFC..bBCGDCBA.FGADEEDEBAFDdFGAHAFAKEDD.ODBBhAAAaHEE..MCEGhAAANICB..eABEAIHAQDAAhABA..WEHBYEHH.PDDAhACA....hADA...,1,-19,-40,21
ZCYJAVUNBPFKfQOLRWeMIGHDEdbScXTag,UFDHBFDGKDBGQBADLHBERAFD..MIFEGAAF.EFAGSBEDhAAA.TFAHhABAgCFGZDAEJEHHAHIFNCIEhAAA...FHFAfAHEOAEGeFEG.hACA......hADA...,2,-19,-16,3
efHBGCTSMOVQLZPIEFKgNRYUcXbJaDdWA,eFBBBFDDCHEFMAAD..OBGHLCCGZFFF.EBHBKDDCRFEA..UAEFhABA..XACBhAAA.JCBHDBBA.AEEEfEHEhACATFAE........hADA.SHDGhAFAPDHD.IHAF.,1,-16,-42,26
TbdDVPNSQJeOfAHCcZRIXEgaYLBUMKGWF,CFDDZGFGRAFA.EGBC...aDFFBEDB.MCFDKACBFAEEdHGF..DHCEVCABhAAA..SGAChAAA.QCBChABAJECGeDHHAICA.HBGDIBDA....hACA......hADA...,2,-46,-18,28
ECBKLcAYWTXNSOgGfdHaMIRPZDJbQUeFV,TCBCSGFC.GBBAHGDGaECERFAGDEGCQGAC.eAHDhAAAEBHBCHDDLABGhACAAADEXBEBODGB..hADAdAAAIAFBPEDC.......hACA......hAFA...,1,1,-27,28
YTgAIXLBUDVWbaKJfESdeNPMHcGZOQCFR,XDACBFFEDABF....VDAHaHACJBHD..ECHHdBDG.eBFDhAAAMHAAHGFAZDDGCHFG..hAAAYECGAACCLCCEhAEAbGBA.KAGC..NACH...cFGDQBAAhABA.....hAFA...,1,4,-36,40
BCXSMRKfYDJFZGgaTWedLPAbQEOVNHUIc,EGFCOFBBHAABUEFFBDCF.CHHE.MCIF.RBAH.KDEG.DFAFFCFAGEBBhAAA..aECG.eAEChAAAPAEEAACH.bCGF.hABA....NIAB.IHHB.XGEGhADAfGDF..hACA...,2,-29,-26,3
CdKaXENGSPLOYUAbMDeQgWTRZBfVHJcIF,DDGGeDACQDBH..WFACRAAEBHEFHDCC..JFDGIGCHhAAAFGAC.KGGHEAFHSGEFhABA.PACAhAGALAED.UGGEABGAMBID...hAAA......hACA...,2,-32,-19,13
IQTfXCUHAFGLOgEbBVRWceSKdaPYDNJZM,FHAEOHDAEBAF.BEDBREEF...eCGDKEHDdAGBaABH.DIGEZFAH.QADDhAAA.XGGBhACACAEGADDFLCCF.hADA.gAGEbDAD.cECHSGGGhAAA.....hAFA...,2,-33,-25,8
edFOXKLYQVZURaAWIHSEgGfJCMPcTNbDB,HAADSAFBEDGEGEEACEGE.MIBA..TACFDFAGdBEEFCEHKGAChAAAQGFGZECFaAHFAGHH.hACAIHCH.fCAChAAA.cFCFBCCA.eEAF.hADAXCGA..hABA...,1,-8,-33,25
KHADJFfcBeRObCYGgSQUVPNdLTaZEXWMI,FEGCBFDGOBBDCEFEGCAE..SGDGUAFF..VACDPFBBhAAAdFHC.LADGhABA.aHGGEEDG.MIEGhAAAIAHCACIFDGCH.cEEC.eCFE..hACA......hAEA...,1,-28,-32,4
MaKCSTDfcOeQNUEJAHXBgLYFbZRGWPIVd,XADCBAFBLFEC.FAHDRFAGGCAD.IHGGdHEHaCDDSCBFhAAADEECOCFA.hAAAeCFGQEGEhABAUEAFAACD.YAFCZDFAPHAEMFFF.CABH.fADChABA...hAEA...,2,-16,-15,1
CadRDBVYbSINEKLWecGAMFZfJTgUXPHQO,FFEFZFDFJBAAUBAA.HBFF..QFGHCEAG.dCEBDHCCBACEhAAA..bCCBIFBBhABAKAHF.eHAAAHHEMDIDhAAAfAHG.XDGAaGGB..YACChABANEBBEAEE...hAGA...,2,-30,-27,3
BQdDSWKYGRITbHVZCNFcUAPLgMJOeXaEf,LGEAJCHD.XDFCaGGCBFEB..dBCBDEDBSBGBhAAA.KFBERBEDTAGBhAAAHCAAZGAEFBCGABIFMAFC.hABA.EDAE.QGAA....hACA......hADA...,1,-16,-37,21
HBeKTEFcYVIZGWROMLdfDAaXQPSCgNbJU,aEHBXCGC..QBABCAEF..gDBCbFDHHCFHeDABhAAAKACDEHEGFAGAVFBDhAAAIECHGFEF.OAFChABAMFAFfFFEABBFNDAABEEG.cGBDhABA......hACA...,2,-10,-6,4
egVWXdSPAZBbLaTFcOQKIHfRGCEDNYUMJ,BFDDaDCD.FCABQCEAHBFEREEA.CAGEDDAGUFAD..eDHD.VACGhAAAdGHEADID.LBBBhAAATGGBKBHB.GGBFhABA.EFAENIAHMABA......hAFA......hAGA...,2,-29,-3,26
AYKXMecdEfFGLQJDgTBHVCPIaONZbWSUR,XGBCeCHDEFGFGCAGLBAD..DEDDTEBCHABACCDH.aGCCZFGBhAAA.SBDDhABAAAHA.MFEBcGAHfAGDhACAQEEBBGFHIAFHNEEB..hAAA......hABA...,1,-11,-16,5
RdZaQJSNECHMeXWFOcGfKbYULDgTPIBVA,dDAFQCCBJFGH.EHGACAAC.HGDA.eDGBFBHDGACCKAAF.UGAFhACADBEG..PBHFhABABFEAABEGaHAC.SEEBhACAMEEG.OFAE..fBFAhAEA.....hADA...,2,-41,-8,33
RaIeJMNPFHWKcGLbEgSUZYfOTQVCDdXBA,RDAGeCCHMAHFFBFH.KFEFGGEF.LACDEAAFUGAHZBFF.OGAAhAAAQGFEDABHBADHhAFAAEBH.aFEGJDHF..NAIE.hAGA....PAFA...cCABhAAA.....hBAA...,1,-17,-28,11
BMVdbZFREWTAfCUOSHcIXeGgDKPYQaLNJ,UGGGODCHHCBF..IEGHXDDHeEEBDIDAKBFH.QGAGhAAANBADBAHE.dAHCFCAHhAAAEAEHAAGBCGDH..SDHDhABA.gABCaHGGMICGbBFC.hAEAWFAB....hABA...,1,-6,-38,32
LQaRJZMNHPCFOEgDXTAKGWBVSbUYefIdc,GEAHVDBH.SEGHUGEB.eAHBdAGCQADGaADDZGFGHBAFhAAAFDGCOGACDFIBAAIFBCBChAAA..bDDA.fACAhABAIEEE........hACA......hAFA...,1,0,-36,36
egUcWTXaIJCHLSQDEGPdfYOAKBMRFNbZV,MAEERDAGFGAAZGDE..VCEDUACG..TGGE..IEGAhAAAJGBCLBEEDABFGCDFhAFAdBACOCCF.AGFFBBCChAAANCIG..........hABA......hACA...,1,-27,-34,7
LbNZVAcHCfQXDMFgeJdYSKOBEIaRTPUWG,CFDDQCGCDGHF.FFGGJADFdAAE..KAABEDDC.RFBD....TCBBhACA..PAGFhAAAUADFLFEBhAEAZFAFAHFD.fAGBMFEA..eDDA.OCBFhACABHHH.aEHF..hAEA...,2,-47,-5,42
CObUETHfcKJeWYPALNaDZgVdSIMFGRBQX,aDCDZFDGdBEA.MDAFGABBBCDCCGHD..UGDGEACH.HGAG.KCAHeAHDhAAA...PEHBhABANFEFDCCD....gAGAhAAAIGBA........hABA......hACA...,1,-28,-34,6
DeVIBOgcYfQXPRWSCNKJGLaEFHZUATbdM,dGFCDGCGeHFABCGDOADH....gBGD..hAAAfFACPACASEEEhABANCCGKDEF.LBCGhAGAFHCGZAADTAEEMIBAIEHCQEGEhAAAWGDACHHE....hAHA.aDDG.,1,-25,-34,9
TScYRDdFCHMOEUXQPZAfgbLVaIWKBNGJe,...fCFCbADGLDHF..IBAABEFEGEAFeGFETEDChAAA.cEAAhABARGCEdAAFFGAD.CCCGMAEEhAIAUGBF...........hACA.XAGF.hBBAQADCAIHG,2,-23,-9,14
PfYDRQSWNcFgLBZUGTOeKdaCXEbJHVIMA,...fDCDRFDGSCAD..NCBCFFEBBCEA.UBBCGDGAhAAATEBEKHAACFCG.XAGDhABAJEHDHAGF.MAAChAEAADAHDIGGQGAG......hAFA......hAGA...,1,-21,-28,7
EfCNadIbZgUXHJGLDVTQcAFOMeYBPKRSW,MEGFeAFBBCEDRACB.EFEECCFE..dEBAZBBDUAAEHDFC.LGAEhAAADEHD..QAGEhAEAFBADPFHDSHDEhAFA..NIBBaEACIEDD...XGAGhAGA...hABA...,2,-28,-16,12
HKUReCQbYPMBWgFATZaOcdSIGNEXLfJDV,aDAFdDCDSDGDGECE..XAABLFCFDCCGKAFDRCEHCHAAQACGhAAA.PHEGhABAWGFE.AEIB.ZAEAIFEHhAEAEHFE..JCHB.......hAGA.HBGD...hADA...,2,-23,-12,11
UcOWGSJHCLgAZbYNTeQREIXPdDfKVMFBa,ZAAD..NCCA.TCGEeCAH.QFFGRFDA.EBFFIAGDhAAA.XDFBdEBHDAADfCDGhADAMIDEBHCFUADEhABAcGAFOFHHSAHB.CFEDAAEC.hACA......hAIA...,1,-11,-24,13
NLVCaAcPWIOKYBHMUZedQbXDgfSFGJTRE,...PGEAIAFBKCAB.BCBAHFCBZDFAQBGCDEBB.SEFChAAAFAABGADCJABEhABATFFFECCA.NIBFLAHFhACA.aGCGAIEGWFADMDAF....hAFA.eEBF...hADA...,2,-24,-6,18
WOXBYMJAHRQfCbKFgSEcVDeULTdINGZaP,RBCDCHHGFADFEGDC...DBBBUGAG.dAAEGCEGZBEA....aGGDPAHHhAAA..OAFEhACABHFGMDIHAAFEHEFHQFBFhABAKDAA.SCCB..hACA......hAFA.cGCD.,1,-21,-32,11
FRZOaHUeEdQIGNVKcJTgDbPLMXfWYBSAC,FGFHRDBGZAFHOCDHHBAAEFBG..dGDAGEGCKFFC.JHCADBGF.LDABhAAAMAAE..fGFEhAEABBABACHGCHBCUACFhABAIEFC....NAFE......hAHA......hAIA...,2,-38,-15,23
GYIdcFHZMfLEbUSRCBPTagAOVQXWJNDeK,VAEGQCGC.JAABDGGA.KABFGGABdCCAHEAHZAEDMEAELHFGhAAAUFGFCHAG.BHFDaEFE.hACAABGC...OCHFhADAWEBA.eFDF..IBDF...hAEA......hAHA...,1,-16,-22,6
AdBMgOQcDbJVZLGENKXSPeIfFRCHWTUaY,MAEEODACDBCA..JBAAZAFGLAFGGDEBEFDEKGEG...XGGChAAASDGE.eEDChAAAICDAFHAEHEGHhABAUDAEACFABADAQGCG.....hACA......hADA...,1,-14,-25,11
WgIbSQXBTEeUdRDFcVNPaLHfKGAOCZMJY,OFCACECDZBCA..MAACJDGH........gFADhAAASGHBQAEEhABABEHHTDDHEHDGeACDhADAdGEDFHACNCIA..aAHBfBGDAHHCIDBFXEADhAEADEDE....hAFA...,1,-11,-44,33
UbXfaANKdCFPYEDWTBGcOMVRLgZJQHISe,KAFBdEHAFDFHEBCC.DAADBDHF.GEADMCCALGCCZGFGHBABSHBChAAAUBGD.XDEAhABAAHIBCFAE....hACAPDAA.......WHBAhABAOFDE....hADA...,1,-20,-42,22
SPgaRYCNTBIOEbAHdXQJFKDGWcUVfLeZM,XCCBQGGDFFHFGBAA.UGDGLFBGZCGBMAFCSFGDhAAAaEDC.CCHANCFGICEAhAAA..OAGBhABAABAF.JHCGDGCDcCAA.....hABA......hACA...,2,-24,-23,1
OCJBcVUYAaZDNeSKgIbPELHTRFfWGMXdQ,ZFFADEFHeDBBKHCA....IDAGEGADTGCARCFA..FACGGAAFhAAAdAAE.CGHBBBFBUDCBAHFDhAFASHFE.hAGAPCDFfEGF.MBFEXBGDhABAOCCG.....hADA...,1,-25,-26,1
eBQcLYIPKXaHRNOJgVTSfZFDUEMGbWdCA,BFFEQDACLACB..PACBaGAGRBFB.JAHF..TAAFhAAASDFAFCEHDEHHMDDBhAAA.GGAFdAFBAICG.YFFFhABAIEAC.KGHBHAEBNAIE....hADA......hAEA...,2,-21,-13,8
OSTIHQcKFJNGYAPfeREBaVgdLDUMXZbWC,eGEABCAHaGEEdCABDAID..UAEFMBEHZDCE..CCGE.OAHF.hAAA.IHHGHFAEKHCAhAAAFAFAJACFGDAEAGIB.hABAfFDAEEFA.LFFCWFGH.SABEhAEA..hBAA...,2,-28,-23,5
WBbHZCNDLVXgITSAKUdeYRfEMcFJPOGQa,UFCEeCCHRGFEMBIF..FEADOGFEQGCCBCGDHABGCEGF.DGAHhAAALBCE.XAABhADAICEEAAIBKCHBhAEAfFFHEEDA.cCCH...PAFAhABA.GCAAhACA...,2,-27,-16,11
JUHBeOQVENCWXbGMSFRcfdZPIKTaLDYAg,JDACUGDCBFAFeCDH...QEFEEBGD.CCHF.XGGGhAAAGADDSBCDhAAARFCAdAEC.IHAAKACHLHBGhABAAIHAHDABOEEA.NAIEMDDEfBAChABA.....hACA...,2,-26,-5,21
QKDPVBfJELIbWCURaSgOcZXGdeMTAHYNF,HAADFHBGQBADDEAEBHGEECCDLFDA..IBGCCFAGRBFAaHGG.hAAASGFD.hABA..OFAGcBDHhACAGADAdEHC.MCIHAEFA......hAAA......hACA...,2,-30,-19,11
ATUeMPRLOKHdSYQGCZVfDbgEJFacWXNBI,TDCHeAEHMGEE.RGCE.LBAFHAACSAHDQFBDCDCCZDEEhAAADAHBEGGD.JEFEFEAFaBDChAAA....WFFEhABABAFBIHHCAAIFOHDC......hABA......hACA...,2,-23,-10,13
IfYJRWBbDEQcaTGHFPAZeSMXVgdLOKCNU,ZDEDMEGF..VCBBdBEBKAAHUFBD....IDDBJEHFBACBDDFAhAAA..QAFGhAAAaEADGGAF.FACFAAIDeHDAhABASAFE........hAEA......hAIA...,1,-32,-37,5
fQCLGDSOUcZWdaNPVREbYTJKMFXHBAgIe,eGEACHHGGABAOHCCZCFD.dBAA..aEABVDDHRADG....EFEDbBEAhAAA..JDHDKFADMHBGhAAAXDGABDDBAABFfCCAhABADAIF.cACB.....hADA......hAFA...,1,-11,-28,17
HUKbGfOVRYZNcgWJDIaTMdLEQeCAFXBSP,FFFBXGAFBGDGHAEAKCDB.GDBE.OBAGVAACZDED..hAAA.NIEF...WDDEhAAAIBFBMEIHEHGECHDCSGGEhADA.PCHDfCAE.hAEA......hAFA.cEBA.,2,-25,-20,5
TNLXUcaGRgQZfOBDdAWHSFbCEMKIPJVeY,HDAGSAFBCEGEKBGE...JGEGeEDF..TDBBXAAGaADFGBGEhAAARADFZGFGBFFBDBFHAFEAhABA.FBBAECAA.PHAEhABANIBB...........hACA......hAHA...,1,-14,-29,15
GeBNVcCIbDELHPSZQUfdgMaJXARYTFKWO,TFDHFAFBOEEE.GBBABBBA..VBDFCBAE.DBHFEHBC.HEABhAAASEAF.QGBHhAAAUGDEfDEHhABAdBAGgGFAMCAH.aCFDAHGCYAHBhACAeDBHNAIE.....hABA...,2,-19,-4,15
UWQIeXfBNZSFgYMVKGDTECLJaPdcRbAHO,OBDGUCGCQBCB..eCCBBDBENCAEFCFAMAEE.GFEFhAAADBBFEFEGLFCHhABA.aDEFPHAEdHFD.hACARGFAAEGH...IAHG...fEHEhAAASFBD.hABA...,2,-36,-14,22
QYeGMCaDTgRZLPFUdAbJKOVWfScENXBIH,KDCDOFBB..VEEDSAHD.EFGGXGBGBAAFQDCGhACAeADECBCC.aCBBDHGAhAAARGEGZAFHFCGGAFIB..JAEFhADA..fBAA.NIEDHBDFMEFE.hAIA......hBBA...,2,-22,-16,6
bRAdMfBKgZNQSEXYVHULIPOCFDJeWcGTa,dGFHMBFHKBGAZAGB..SADHEDAB..XAACHCEBLAADhACAIHHBCHEDDGACeFFHhABA.GECEbDAAABFGBDHGhADANBICQBCA..YHAE.hACA......hADA...,2,-21,-15,6
KFQUPVXfgAGEObJLSHdWMBCeNZcDIaTRY,ECCGOEEGLBEEdDCEBGGDeFEDZAAC..IACGRGAG..KCADhABAQEAAUBEG.hACAVCFHXAGFAHAEbFFESAADhABAMEIH.NAEDDIBAaHDE....hBBA......hBIA...,1,-8,-27,19
FROfYSWQTPVgIHUAcBCbdLZEeGMDKJXaN,CBBDLCCHZFEEGBEDKGAA..aBBBFFAG.RDFA.OAFD..SDBGhAAATGGG..PFDDhAAAIADAHCGBAHHEBHAChABAECEBDADA..XDDFNBAEfFFAhABA......hACA...,2,-30,-17,13
eGbJdBVagFKUZDESNRWIOTcLYCQAPHfXM,HAADMFFFGCFAdFHEVCCHFCBG.ZAEGDCGH...SHDChAAA.RAGD.IHCGhAAAOADATFFCLFAGCBEDAEFHhACAPBHD.fACH.bDDB.hAIABBAC.aHGC..hABA...,1,-11,-24,13
gMCPKONDeEGZBFJWRQIXbAHLYdTacVfSU,HFDFdDCDaAADVEBF.UAEGMDFB..CHAE.KGGGDCIDGBED.FFAChAAARACFQAAFhABA.XGGGLHBEhACATAGFfAEHgDEB...hADA......hAEA...,1,-4,-32,28
JUSQGVWaFcDZLNfbRTEPKdMXHeIYAOBgC,OAFBCBBDUEBE.GGCH..aCHFFEDADGGCZABA.LCAD.hAAA.NDDB.RAGFEHGAKAGGdADEhABAXGABHEEA.eDGBhAAAAHEABAFC..........hACA......hAIA...,1,-7,-41,34
fYgUEeNPKDaJLWGQVBOAcHIXZRTSCMdFb,HAADZEFHSAHDdFBHFCDF....bFFAgCBA.EFDDhAAAeHCEKAEC.aGAHLFHBhABAGAFGBADAAGBAXACChADACDADfEGH..NIBBDDEC..hAIA......hBAA...,1,-12,-21,9
SDIdQPNXJAaZOWLgFMUTcYKVEfRHGbBeC,aDBDZFDFOBEHLDFCFGBGUAEG....TFFAKEGBEAACHAGFhAAABHAFCDBF.DGEDdACGQAGAhAAAXEACAABFMDAHhADA.....YDDD...hAEA......hAFA...,1,-22,-28,6
gXOfFNEeKJAZbVDGIdSWUQLTPBYaHcRMC,ZGFGDHCEdCBHUCFGLAAEBFABHBAHRCGF..CFCA.OFDD.FAGCEFEGhAEA.eAEFKECEAGFA..hAAA.....bADFhABAIAGC.SFHH..hAIA......hBBA...,1,-31,-42,11
cVJfMbOdgYTNaLIGUPSKZRXBADCQFHeWE,DEFACFCFHBBEEAGA...JCHDMCCA..dDEGTDAGaHGE..LAAEhAEAUFFCSABAhAAAKGCGZBFBBEBCAHIDFEDDeFADhAFAVGAE.OHDC..YGFE.hABA......hACA...,2,-23,-16,7
QbdKYSPJfMUWTFcVOgGNEXaLCeBAHIDRZ,DHCEZBCDQCAGdDDHKDGH...SGEEJFGF.UBFFTBADhAAAVFAC..OAFEhABANAIA..EEEEXBEGhACACEHD.BGAGAAFEIABEREAA...hADA......hAEA...,2,-41,-16,25
IGFLacSDCXUgARKMOTZQNYVbedHEPfBJW,KHDCMIFGZDAH..QGDF.VCCBbDGDdCEE.HAAEECGHBGGFhAAAJAEE.GAEEhABAaBHFDIFACHAAXAGAhACA..ADCA..........hADA.ODBHNEAE.eBBChAEAWEDA.,2,-40,0,40
cQdMfbXRFOKSVHGgCLZAYIaPTEeNUWBJD,aHBGEGFCUBDDBEDC..DGBCdBAE...MIDGXGDDREDB.OEFDhAAASGAC.HCFBhAAACAHEABEA...IEBBhABAeCBFJFHH.fCFCFBHDKHAA.gACDhABAYAEC.NEAE..hACA...,2,-33,-21,12
TYGBNHIDcfKRQCFAUgMVZOPSedaXEbWJL,MFFFVDBG.ZCFG..SGHBdECDEHBE..JCBCLAAD.hAAATAGGBBGANBAGDGDE.hABAfDHEKGGE.hACACGAD.AGBC.OAEH.aFFF.....hADA......hAEA...,2,-40,-21,19
WYcMdXeUETFLQGHbaVSPONIZCBRfKJADg,DACB..gCBC..cEBFdFFEUECGFGEGLADBhAAAHACCaAHFSGADhAAAOBGDZFAFBHGHfCFDhABAAHADMDIHeEFEEGCBTDEA....hABA......hAFA...,2,-26,-6,20
ZMVNYCISbOfHLDUagdGEJcFATRWQKeXBP,REFHKGFCeFBFBAFEZACD..MABE..VAGFCBBB...SBABhAAAOFDFLBDDhAAADCEHaFHDdFDAEDFHFAHF.AHCE.hBAA.....WCEC.....hABA......hACA...,1,-29,-43,14
BLGZPUSRfIDVFYOgNAXQbCEHKecJdMTWa,XCGCCHHGKHCC..eBADJFCA...MAGDaDADBGBGLFBAZAAGUCDDhAAARBBC..IGFChAAAFHGEOHCC.AHAB.hABAEAEDdAEFTDEC..PFFGfAHAhABA.DFAH...hACA...,2,-23,-21,2
RUQJAcINSDKPbCaMGWZgFBedVOEYLXTfH,..IFDGSCFCDDBH.KAAD.CHHGGFEBZDBBBAHA.eDHFOCCFhABALABA.fGFDhAAAUFAFAEFFNIBFaBCGhACAMCAA.FHAAdBHAYAGF....hACA......hADA...,2,-30,-24,6
EefJgGFLcbWAOZIQTUaHYRNBSXKVDdPMC,OFBBQFDHUEFFHBCA.REACBHGH.KCHBDFDHdHAFPBDHhAAAEAAG..eADGJHDGFAGAhABA.LACC.hACA.cDEAACFE..ICHFaGGGSAGHhAFA....hAGA...,2,-35,-13,22
GANRSgaeEOXUFIZbVLQPMKHJTfCBcdYDW,RDAGSAFBeAHB.EFEHOEDF.FFFGIDDHZGAGLADGhAAAMHAGKBBE.HDGBfCGAhABABBEDdDAFDACFAFBANAAFhAHAaGHDUGGF.........hAEA......hAFA...,2,-24,-12,12
RJYCDHdPegQVZKNEAfbBXWOITFGMLcUaS,BFDGXDACOBADFCHF.GACBLAACUEFDRCDE...CHDGDAFEdGEGeFHFhAEA.QGBGhAFAKCEGEGHF.AHAA...hAGAfDCCIBBDMFCESBHH.hAHA......hAIA...,2,-37,-13,24
YEeXTMIaOQPFSGRdKfJBVNUbAWcHgDLZC,HAADDEFHCGED.eDDA.XFABMABE.OHEAFHBAGADF.dCCGhAAAfACBBGHBUCGFhAGAWEFA...cAGEhAAA.ZFCBEHFAICDDaDDF.SAEBhAGA...hAHA...,1,0,-38,38
OJCBNTMKWDQUEgYIbRSZAXVaHFcfeLGPd,aDAFHDAG.FGAA.eHDGLABCGBFAODEFCBDHBHADMBGF.KCCEhAAADBACECHD..IFEEhAAAbFBH..RGFCAEHB.hABA............hACA......hADA...,1,-22,-35,13
ecDEAQdMNRTFWKfPbCXIUaJBLHOSZVYGg,dBDHMECGREDHFAHBKHAC........bBGFXCGCUACGBABDhAAALBAHHGFAOEFChAFASGGGZEBA...hAGA............hAHA......hAIA...,2,-48,-25,23
MgNYXdaPVObSZFJLfWAUGIBREDTKeHcQC,UFGHGGDHBACGDABBeCFFHBDA..QGAAMAID..gFAFhAAAXDFCPAFChAAAODGFZADGLBAFhABAAIGAEECGKCBANFAH..dGDAaHAESHFA.hACAfCCE.hADA...,1,-1,-16,15
AFdDaeHQTSVZIUNCcJfOWYXMKEPbRLBGg,DGGDaDBDHFGDQACG..TGEFSDHBVAAFZDFEUGBHCHCG.hAAAJEDEOAEH.XFBAhACAEEAA.bAFBRAEFBFHDhAAAABHF.dAHGNDAE.fBAH..hABA......hAEA...,2,-25,8,33
fQNMeXKbWVTUFadPELRBCcZOHAJSGgIDY,SAEGGAFEDIACQFACeGEA.KFEBVCGH.UAAFaDHBECBBhAAALDAC.CEEDOHAEhABAAEEHIGGGfFABhADAMBBC.XFDCbECD.FCEF..hAFA......hAGA...,1,-14,-19,5
XMNZVBOYcRbQPEgfWACFLDUeIaSGKJHTd,LCAFDECDeEFE.SCHBKBDFHGFEdBAAMCEBZAFHBAAE.OCFBhACAREDB..PAHDhAAAgGBGAEADFHAEaACGJFGH.hADA.XGED.NBDF....YDCBhAEA...cEGAhAFA.,2,-31,-14,17
FTOfSZbHQaGJREcCeAXDYKULgINdVPBMW,XAFBDGHHUBBCLGDE..IEECdFAHBEFDMDFGFHEC.hAAATEAD.SGGAhAAAZAED.HBCDhABA.aHCEJAHFECAFCCAFAECEgEGA..hACA......hADA...,1,-20,-44,24
CWNRXZSgYMTIaKfAPLJOBFDEQeGHdUcVb,LEEGJEGHBBAB.DEIB.QBFDGCAFUGDG..VBBDCCHE.hAAARFBG.ZAFHSAEFhAAA.MCAHIHBHhABA.aFBGABIFFHGAEDEHeACEdHABcGEB.hAHA......hAIA...,1,-6,-31,25
cFgNfEKYGVWMJbIeUXBCaOTZRDQLHAdSP,dAFBSHBGFEEE....fCBFEAGFGDBCMECHJBEB.eBAFhAAAXEFEBHEAOFDHhABAZBADQGDFhAAAAHGAPBHDNACBKGHB..WDDC.....hABA......hAIA...,2,-25,-15,10
LCDPSEMIGXdVUBKJQOFAfHZcWagYTReNb,HGFGZAADaDCATEBB.eDACLHBE.CFHDDGFFEGABGADFhAAA.XGDBVBFCBHHEhAAAKCHDOEEEAAEA.hADAWBAGREBENEGE..SGAF...hABA......hACA...,1,-5,-26,21
PGMcRULHgSTAZIBKWJXYCNQEeDFfdbaVO,BFDDJCCH.CEFE.EHEGFBED..dGAF..aEHFVAED..OBAChAAAMGFA.RDAH.HAAH.TDGEhAAAAHHAZAGFKADC..hABA.....XFFC.NIAF.DACGhAGA.fEEAhAHA...,2,-38,-31,7
HLYcJIfDXNBbdKgGaSeQTMFVORAWZCPEU,CFDDUGBCLCAG..JCBBDGHFBFGBdAGAKAAHGGEH..eDEDhAAAQAAC.MBHFhACAFGBBOEAA.hADAAEHH.ZDEBEHDA..cAEA...IEDEhAGANAFE...hACA...,2,-39,-28,11
UJSdWCYfTKgLMGARXbcZDVNQaeHFOBEIP,XFDHZAADDEIF..QACEHBBHOFFCBGAFECHFUGDHdBEFCDAG.hAAA..TFAEKBHBMAFDhAGAAIFA.REEE....hAAA.cDDANCCEFHGE.IAHF.SHCGhABAfHAF..hAHA...,1,-8,-32,24
SHMQXDAbPeOcBCKGNFYZagURfJTEdLVIW,eGEAOAFBCDAG.GECCFCFA.ZACDUFAARGFG..JCAFEDCG..dHADLACGhAAA.IBAAhABA...SFDGhADAHBGHMFFGDCCCACEDcAAF.BGABhACANIDDYEFE.hAGAfAGF.,2,-23,-12,11
PbfAIGXDVBMgJWOSCEcRUZQFLdeTKYHaN,XAGHDFCFMCAA...JGAGOAEE.CAAF.RBABUEGFZGEA.LEAAhAAAeFFGKDFEHADC.hACAaGDE..NDAF.fHGBhABAAIEA..IFAEBDDE.WEAEhADA.EHAE....hAEA...,1,-15,-41,26
FeJfXCEMQHNPaVLdROIYTWcKSBGbgUADZ,ZEEEeFFBJDDGCEAC....MFBBQGEEHFCBaFHBdBHG.RAAC.IAAAhACA..WEAFhAAASCGC.BAHEhADA...........hABA......hADA.GEBEbBCH,2,-30,-24,6
eMGgWCAbQOTYFZSPJKcVEDdBNIRaXHfLU,QDACODACFGHBZABCJCGB...KGACVACF..dGFABAHCRGCGHAFChAAAUGAFGCDF.hAAACEEG.AIDETFEG.hACASGHHEEGEDCID.IBAD..hABA......hACA...,2,-34,-12,22
LDdbFEeHUIcBNZCYTSgKQMAJPGWRfOXVa,GECFRAADOAEGaCADLFGDdCGG..FCDCEDCEHGAA.UAAFICHAhAAABHDACAGA.SHFAhABAKHBAAEBDJFCE...hACAfADBDBGBeEHH...cFGBNDAE.hADA......hAIA...,1,-11,-23,12
bJMcBTNfELOHIGeVXSYCaZPWQgARdDUKF,dGGEKDABFBHFMDAEBDCC..TAGA.EEEEOEFF.HGBGhAAAeCCESFAGhABAaAAFPFBHQADAhACA.AIFADEEFJHDENEAAIFHCXDGE.CBEB..hADA......hAGA...,1,-10,-37,27
bBQZXPRWISTYKFOMcaGfNgdDeLHVJEAUC,CHHGQGGGZCAD.RCBF.SECFKHCA.MAIFaDGBGADDhAAA..fDFChAAANCAGDCGGLEEFVAEHEGAFhABAAABCBBBCXEGA.IHCG..hACA.FHEE....hADA.OEDF.,1,-7,-19,12
HCdGfeIAPBagVYWOSZKQUJTFLNbDEMcRX,aEGDVAAD..OFCDZEAHUDGHFCFH..LDAADEFH..MDDFhAAAXBCGdHGF..eHCAhACAAGABBBAF.gAFEhAAA.WFHH...KGFDQADChAFA.JAHB.hABA...,2,-37,-23,14
YVDEaKdOcQZLeGAHTJfUPIRNCbgMSWFXB,TBDGJDAC..UFGBRCAA..CDHH.MICEFFHBBEEFDBAA..KCGHdGFGhAAA.OGBAZEEDeFAAhAAAACHA.HAED..IACHhABA..NAIE.SFACXACFEHAAhABAaAEA.....hAHA...,2,-39,-20,19
GRVZcbYDXSQTCeIfEPOLKWgJNFdHaAUBM,MEECRDAHZACE.....bGAEDGHH.SHBACFGB.eEGFECEGPACDhAAAODEGKGEHJFFFdEABhABAAHBEBAHE..VAGFhACA....XECA.IAAFhACAWEHH.NEIG...hADA...,1,-18,-37,19
fCHgSbAdNLBJXYIKVWcMPTaZDQROeEUGF,LCCHJEBE.XFGCKBEA..VFEHMBBC...TGCGhAAADADGODHBEEEDFGAFCBAE.hAAASEAC.hABAAHIFdCGGBHAF.WGAEaHFC.....ZCAEhACA......hAGA...,1,-13,-49,36
OGMWLYcHTIJPFXgCNVDAZeBQREaSbUfKd,ZFEEBFFEEBGBaGAB..UACEKCDAGAACLAAFHAEA..IEDFhAFAFGDFXCGA.hAGACEAGDEEAABEE....hAAA............hACA......hADA...,2,-46,-32,14
INfFXYDPEGcMWgKRQOUALZHBeJTCVbSda,LDACHFGHeFAFCAGC.SGEHdDGF.aCAGNBFC...FGCFDFGAGDADhAAAMBEF.KBHF.OBBAhABAAHBBBHCGJAFFTABFhAAAbDFE...IHHE...fFADhABA..hADA...,2,-50,5,55
XeUDGOgWSPYAVcaEZRMNTJQFdfCKHLIBb,VDAGaAFBZDGF..MEIF..JCAHFAACCHHG.KDGFLDDB.BHCAhAAAeADDGABEOFGDhACA.SFDFhAEAAGGBEBHB.NIAB..dAFC.IGBHXGED.DDFFhABAPAHF.RFEH.fGBAhADA,1,-20,-24,4
MRWDgTCUPESYZIAcJNeKQFHfbGaXOLdVB,JGEAKDCDQAEHHCAFGAAF..OEEELAGHdAHEBGGGMEDEDDCEhAAACCBFUGAFEDHFSGCBhABAZAAEAEAD.eFABhADAFGDD....aDGA.......hAEA......hAFA...,1,-12,-27,15
CfSGdAHeZVTRDXUabJYOKLFgEQPWMIBNc,HDBGeDACZGDETGGGRAGF.UDGD..bACAOHBA.KABHLDEFhAAAFBDGEBGC.QDGBhABAMGBGBHADCHHHfECEhACASDACABABDGAHaFAG......hAAA......hABA...,2,-14,-11,3
bJPQZLIOcMGfBWYEKCadDHeVATXNRUgFS,TCGCREFHUCBH..FGBHJFCG..ZECGLAAF.OHFAMAGFBCEBhAAAEHAAKBCFCFHH.DFAH.hABAeAEBAIDA...NICH.hACASADC...PAHFIFGAhADA.fDDBhAFA..,1,-14,-46,32
SGQFHdWAVJUPTBCLaXONgEKfMRecYbIDZ,JBDGUCGCBBBECDCD..LABA..OFGBEHGA.MIAAeEEFhAAA....bGCADIAAhACAZAGF.GDBBFGBAdAGDhADAAAAC....PFACXBED.KGFC.hACA.cEGASFAFhAFA..,2,-40,-23,17
ZUALJWSDTEaMbCFYIBXQcHVdOGgfPeNKR,LEEGSDCDDDECEFGFMBFG..CAEAFEAHBDAG.QBAFhAAAHACBdDEHGGBH.hABAfAAHPHAENGAFKGHFhACA...........hAAA......hAEA...,2,-31,-26,5
HcWRBeLECFdTMJNbIgKGOPZDaAVXUYQfS,XDCBUCGCQBCBHEBBRFEF.LABF.CAHB.FAFEdFBGTBAAhAAAMAFB.JABA.IHHEhAEAKHFEOFEE.DIDGhAAAAEFE....fDHESEDFBHCAhAFA......hAIA...,2,-24,-23,1
VAgSdbXaEfLJDcFGCHRBQONZWMKPUeYIT,SAFBXGBC.EEBGJBBD..DFIDFCEFCDAC.BFHH..NCBB.ZAFFhAAA.MDAFUFEHeACGhABATDEEAEHC..dFGGfHBFhAAA.LBHB...hAEA......hAHA...,1,-27,-34,7
ZFeGUEMDYfCbXSNacWBRJLgHVQPdTIAOK,ODCHKEHBeCAHUAECDAAD...CHED...SHDEaEDA.BDEDhABAJGECHAGDQGAChACAdABHAAAFFDGHMGCE.fCCAhADA.NFCBRADELCAH..hACA......hAIA...,2,-29,-21,8
bVBICFYeLNGOJfKTDHRgZEQdWMaScUXAP,VAADCBBDFCFA..LGFEGDED..OHAGKEDBDDCGRDAAZAFG.EFGCdAEDhAAA.MIFE..SADHhAAA..hACAcFAFACIFBHHGeBADNGAFfHDF.hABA......hACA...,1,-8,-45,37
fNEQcdJPZSbUTIVWADYRXaLBgGKeOFMHC,RFDGXGGDBHDBGAGAKADE.FABHHBCA.CGBD.EAFHdAGCZFABUGDG.hAAA.TDCEVDECDCAHhAAAaHGE.LBBD.hACAOFBGMAEF.NAIE........hADA......hAFA...,2,-23,-6,17
HGMVEXYIJCBPNFSWKDdQTcbaURAgOeLfZ,OEEGeEEGLAFEHCBEMEBDEECB..XGBDIACB.CEHABHDBhAAAPADF..SGFDhABADCAFQAAFhABAcAGBaHGE.ACCHfGEGZFBB.VBFHhADANEAEKGHF.....hBHA...,2,-12,-10,2
IRVLgZWNMQaYBXcTfAbDOdSFGKPHJCEeU,DEFHOEGHFHBGGCAEHCDDJAAC..CEDB.EFBFUGGG..RAFHLFHBhADAZCGH.MFADaADFBFCChAAA...XGEChABAfHCBAACFdAFB......hAIA......hBAA...,2,-30,-20,10
NTMVIJPCZAYWSLDQbdGHORcgeaEFXfBKU,SHBGLEGHQCBEdCAGHCECOGBGREDH...eHFEhAAAEGBBXAFCBABBKFFCNBDBhADAMFIB.ICGBhAAACHEGACCFDFAC.cABB.aGFBfDDEhAEA......hAFA...,2,-23,-11,12
TEQZUPOGNeaLfKBcDHMRgJdFbYVWSIAXC,TABHZBCFOFGF..eBFEaHEA.KFFEBAGEDCGBHECBRBFG.dGHAFFDGhAAA..bFABVBAFSCDAhAAAAFAE.EHEG.hABA............hACA......hADA...,1,-11,-37,26
FJMbKGgXcLURTVZWSdCAPOBEYDfaNQHIe,OAFBEEGDDADG...aAAFQDCGHFGDeCDDFHCE..JEBDKBFF.hACAGCAAXFEHLAHBhAAAUAGERDFATABChABA..WEAF........hADA.SGDDhAEAAFIDBAGDfFED.,1,-4,-17,13
aGOJIDLMQECbHVFdZNSBgATeXcKWfPYRU,TDCHeDACKAFD......fBDHPHBEUCGFaEGGJAFAhAAADFDGLBAGMDADQFDDhABACECCHEGFFAHBNCBE.hACABADBACIBXCFC.cGGH..hADA......hAEA...,1,-16,-24,8
OLJWCUYFQTSadfMNbVPcAZgREHGDKIXBe,ZGFGRDAGEBFADFFC.KCGCBHED.LFBACABE.FADDQDBBhAAA..aAHDMAFGVDFGhAAAAADFHFCF.GADEhBAAeHAAOABD.UGGESGBDhBBA......hBFA...,2,-30,-13,17
dDFPZCBbVURJTKgXYfIOAEcQHeNWaMGSL,QGBCHFDFeBFCaGAASFHBLBBADBFDFEEAZECCBGHB.VDAEhAAAUAAC.JBDFKACC.hADA.XGFEfHADhABAAGABEBHBNDDF.MAEE.......hAFA......hAGA...,2,-17,-8,9
eUWKXYZfBVEDOHJAMPTaGICdQNRSFcgLb,TFDBGEAHdHAD.QAADRCFDFGBCLCCDeHEEUBEAKAGBZACA.hAAABDDDDGFEHBGDAIFGMEADhAAAaDHD.CDAD..SDDGhACAgGGE........hABA......hADA...,2,-25,-3,22
RCDMJIBcfLTZdSgGANaXePKEHOQWYFbVU,XGBCKDCDEGFB.HDEHQFCDFECC.UBBHDGAFJAAFBBGCLHFGhABAdGAG.GAEDhACAAAACaBEH..eEEAOEGDhADA....YCAF....hACA......hADA...,1,-14,-32,18
PDQXTIZHcJUELMWCVKdGgAORSBYFebfaN,ODCHBCAHeDFA..aACDDEEF.QGDFXFEEZADBHABAJBADhAAALBFE.MECBhAAACBFCKHBGdFAGAEIDRBGBFGGF.hABAfCDA.NAEF.TDEA.IHHAhACA.EGAF.hABA...,2,-19,-14,5
OPaJHUWMKSbBfVZQGNIDdAeCTLEgFcRYX,CFFETGGDLACB.FDFGRBAHOEDA..JDHBHACDUEBHKFCHBBHBhAAAfBFA.hABAQEABIAEADGABhAGAdAHE...ABBCeHCGgGAG.cEFDhAAA.PHDChABAMCEA...,2,-37,-12,25
DaQBOAfGRTLSYWbVKJZeIPXCMEFNcdUHg,GEDHTBDG.SAGD..WDFGKBAEeHBE.IDDEhAAAXDBH.MADAhAAAECEEFDBDNGCF.dADBgBGBhABADGIHBHADAHHBLHFA.YHAEhACA.....hABA...,2,-23,-17,6
NZOHcLAQEYSKbDGdXeMBRITFVgJWPfCaU,EGFCSAFBDDEB.dFFDMBGBBEGC.RDCB.FDHB..JAAC..fEAGhAAACEAD.NBDA.hABAHADBLBBBADHAKGDB.hADAXADBIHHE.......hACA......hAGA...,2,-37,-36,1
QcEDVIadPAHOKZCLeTNRBMgYUJbSGWXFf,HDEDODCHKHDCLAHFeAEARCAC.BBBB.MFBBUEAH.SGGGhAAAXGFG..fAFChAAAQACADGIFICHChABAaEGAAICA.TEGEYBDB.JCAB.hACA..WFEFEEDB..hABA...,1,-3,-33,30
gMAZWLONVFKTRdXcUeBJfYSaQEPICDHGb,ZFDFLEEGOAGDVBAEKCAD...dGCCUCDHBECB..JABGSGGGhAAA.QAFAhABAIFHBDEBDbADBAGEDhACAFFFB...XGBA....hAAA......hABA...,2,-45,-23,22
aGcQIJUVFRPZMWTdEHegbDSLXKOAYNCfB,CFDGaEGDGGEF..IDDEUBGDFABDREAGZGAA..MFCHdAACeADGhACADGABLADHKBGAADCF.hAFA....YDBAhAAAfFEG.BDGF..cEFFhABA......hAFA...,2,-36,-26,10
gUKEZbNGJFMSPOTfXICYDVHQBAWdaLRce,dAFBaDBDLDFCREFF..eCDCKBDBEGFCZEAGGAAF.MGBAhAAAPGBCODHF..hABAXEECIEEDDAHDhAAA.HBADAIBC.cAEF.....hADA......hAEA...,2,-24,-19,5
aJIZEPAYFBOKgLWfNXMdURHCcQeTDVSGb,BFEDKDCDLHDE..NDBGdCHGHAGB.CAADeBAADCBGGAEE.hABA.aAEGZAAEADACFDFBODGHhAAA..fGBGhACAMDDB.REGFcECD.....hABA......hACA...,2,-43,-11,32
dKVUOYHQDTIPMBcCNFgbeZRafAWLGSJEX,GECFSEEDECAFdBGFUBCAHGEG.DEIFTBGEMAFG.BHEFCAACFCEFhACA....bEADeHCGhADAZDFHaAABADDHJEABKGHBOBBGhAEA..IFCG.cAFGhACA......hADA...,1,-1,-30,29
CGSKYaAMFBOPUEVZWLIRHTdNgQeXbfcDJ,BBGEODACUAACZACELHACRFEB.dCGEQDAG.eCFDhADAXGFE.fEDHhAAADDIFCHHFSHAAhAEA.aFBEABBBMEIHFCDF.EAGA.WFCGhABA......hACA...,1,-28,-33,5
fBMgUFSPKeCDNAVIHZXTEabWOcJQGLdYR,VGFGHGFGTADE.EAABaAGD..OHBGQDGCLDEHhABAdGEGRAAFfAGChACABEAEMEDCFDACKFCEDDDBIGBEhAAAXCGA..bADH......hACA......hADA...,2,-21,0,21
CYZWHPJGTVeNEIALQRgMDUXbfdKSOaBcF,QAEGRFACMEEC.DEIHUCBD..bFDBKGHD.OHDEBDGBCFGAZABAhAAAHCBB..JCEETACDhAAA.eHAAIAFGhACAAABFXBGAdFGB.SEEE.hADAFCABWAHH...hACA...,1,-14,-27,13
KBcSTIOGMVLRfUCFYHQAZNgEPeaDdbJWX,ZAADEHBG.eEAFDDADdACG..JGDCKEGFBAEA..SFCAhAAAOBGHMDCDLAGF.hAAAfCEAFEDEQACAhAGANEIG.aHBGXDBA.IHEEhABA.....hAHA...,2,-31,-26,5
ONRTHBbEdVZMJaXfDeWcgLAIYKFPCQGSU,KHBGCFEDGACGUDEC.REBB.HEAHBHEFdAGE.ZABAMAAF..aGGGDFIB.hAAA.eHDE..gFFBhABAIDCEFDGEhACAQAGFOFCC.NEAC......bBEDhACA......hAEA...,1,-14,-31,17
DgJVZHdYEabcMeLATIUCPBRXfOQKGWFNS,TCGCCHHGBCEB..RFEB.OBBFGBGG..FEEBDAGAJEADHDBD.EFABhAAAaHGA...MBADhAAAAACCUBBFXGCG.hABAfBDC.......hAEA......hAFA.KGCAWGFC,1,-28,-29,1
YXFWKHefOANJdLSPQMVZGaDgIRcUbTBEC,dDCDSDCDMDHBGBDDDBHH..RGFEUAEHBGBDEAAB..CEEAFEHDhAAAKAGCeFFD.AIHEJACEhABAPDAB...QABChADAaGDH...cGDG..hAFA......hAHA...,1,-27,-35,8
KdVbeACfGXYHDgBNPFZULISQJREOTMWac,CECDXAGHDEEG.BADGFAFCZCAALCCA.QGEHRFFC.hAAATEGAaHDGdABCbBABAGCE.hADA..GEAF.hAEAgGBANAIE..IHAF.hAAAEBEB.MIFEKEEC..hAHA...,2,-41,3,44
AXOfVZDUJcdTHEPaKMeYbILFBQSGWRgNC,XDACOFBBZCCFUFCGdAACHCFC.EGEAKBBC.MCDG.eCGFhAAAIADFBFGASDDChABA.RFEBCHHHAAGADICAhACA.JEEA..cGAHaAFH....hACA......hADA...,2,-29,-24,5
RDfCXgFZVPYOBGLJTaUMbeNIKHWSQcEdA,DHCEXGGGZBFA....VGFEOAAFBDBEGEAG.JAFCUABChAAAeFEDKEBDHCEHQDEFhAEAECCBAAEHCHDGFCHD.hAFA............hAGA......hAHA...,2,-43,-10,33
IdUYNZOfVQMAbBPeScRTEgXDWJLHCaFKG,BFDGSDCDRAFA.EFGFXBBC.DFEELAAH.aDGChACAKEABdEEAUGADZEAFfAHAhADAQCFBAACD.hAEAeHFAcGCA.WFHHCHEFIDDEOCCAMFAFhAFA....hAGA...,2,-34,-15,19
ONCRFZHbLgVIKWfSBTdAJDUaceMQPEXYG,JEGHaDAB...MDDEQFAA.EDFFXFEDGBCDCEHFFADF.hAAAHAFCLHDA.hAAAIAHAWCAFSGADhABABHHGTFDCACCEDCIFeABA..PFCFhACA.....hABA...,2,-25,-16,9
fQeKOWUFaBPMSdNZXAgHYDVIECJRLGTbc,HAADVFDG.CDEFLHFEGDAH...TFACfBGBKGDFUADAhAAABHHG.SFAGhAAAZEFAAIBEDCAHEAHBJDFGbBAE.hACA....eHAEFCHHMGEANABB.YCCFhAGA....hAIA...,2,-9,-9,0
cHWCeFKBDaVTEgbUdSGNOQXZfMAYLIJPR,LGEAJGEA.RCEGHFAEeCABBABEDCID..VABETCDA.EAGGhAAA..gAFEhAAAdCCGSFBHOFEAQDFEhADAfBAEACIDIAEA..hAIA......hBAA...,1,-13,-32,19
EbNDGCJWdPOfYKaeRSXMLHAQVgTZBIFcU,VEFHZEFHFCBE.UAGGECCF...DFCGGGAH.CAGFdDAAOFBHKDEERAAAhAAA..MEBAAHIFQECAhABABDHB..IABDhAAANAIE...JAEB...fFHEhADA...hADAaGDAXAED.,1,-7,-39,32
SVabTWReZONYPdGAHKUgXJEfLMcIDFCQB,UCCBXDACECGALFAF..MCBADBBAFGFGBFDG.aFED.hAAA.TFBFRBFHOFBBhAAA.NABF.PAEA.hAGAADAGKEFC..........hABA......hACA...,1,-33,-38,5
gOZFHJfLRDAYXESVUbMGeaCTNIQWBdcPK,EGFCUCCBGCDBeDHH.CDCD...TGDBQFAHBHBCdDFAKAACZADEhADAHAGBLBHBDGABXAAChABASHCA.hACAMFFAaAEAIFBD.cGGE.hAEA......hAFA...,2,-17,-8,9
KICUgSfeLbJQBNTHFcYRXEZAGVMWPDOda,MIDADACBOFABKDBF..CEEA.UEEG..SFCDeCDFLHFEhAAAJAFE.QDGChABABACG.HGBGFFAH.YAEGhADARGFEXADBADBB.VDGFWCFE...hAAA.aCDE.fBAChABA.,2,-35,-8,27
KLDBeAfQbSHGcIMXFTUaZEVWYJORPdNCg,QCBCSCFCHCCDGGAHMEIFFAACUFGBaACB.ZADE.EDGGVEEEhAAA.JHBG.OBAFhABAdHFHCFECKCADBHGGADFB.bFBGhAEAIFAC..XAGA..hAFA......hAGA...,2,-14,-7,7
ORLFXgcfHEGKCJBQIDTbdNAaSPeMYUVZW,aAFBeCCH.UBGGZDGFOHAEFACB....XGFE..hAAAcFEBEGADCBFDBEDAhABADAHHdACAAEGH.MABD.VEABhAAALAEDHCDF.KFEA......hAGA......hAHA...,1,-16,-31,15
CVGLZDYSHPeBRXJaFOWTAgcEIbNKUQfdM,EHBG..IGFHKECEQEGEMFAHCCCHLGBAZAGBDGEG.SEEAhAAAeFAFRBCE.JBAEFCAChAAA..OEBAAAFG.hABAbDGFfGCB..dBFH...hACA......hADA...,2,-24,-20,4
AgECbaOFQPKDTcJdMUWLXNZYGSBRVeIfH,CFEDOCCHFAEF.KCGDDGAB....JGAGMBHDLADAZBAB.GDDEhAAABDDFRGBC..IFHEhABAABIB..EDFBQGFChACA........hAEA......hAFA...,2,-57,-34,23
XKMHfJLgEdBabSVAQNRDeTIZWPCYOGFUc,REFHDECDeDEHZEFD..CABE.ODBEGBEB..FGAAUBBFKBFAHABDLAFChAAAdHDBBAHD.aEAChAAASEDB.hABAAADE.QADCNIED..WDHH..hBAA...YHBEhBEAcDGA.MDFF,2,-24,-21,3
FDAEBVKdLUJXaCGReOQZYcHPNbgfITWSM,BHCHVFEE.dDDFLCBAUGGG...JAHHaFBDGEAH.OADEhAAAQDAFZGAE.HAAChAAA..NEEHfABGhACAIEGBSAFHDGIB.AHABEEEBCDAD.hADA......hAEA...,2,-29,-15,14
RbUDCPLQfTJKMXEcaIVAdBNHWSOegFYZG,BFEDHAADOEFEeDADFDCHZGDEGBDHRADC.DICELDDC.fGAFhAAATDGAKAACMCABhACAEHGG.aEEHABIH.dAGASBCChADA.bGACCFCE......hAEA......hAFA...,2,-26,-3,23
PgJYKOGSNQfXDRcIaCbLVFdTWeAHUMEZB,HFEEMBDHZDGDBBAB.JEBFKAEGGDEF..SCADQADAhAAADBBHRAGD.aGDBCDCE.LFFDhAAAdFDC.eAGHAIBAEHFAhABA..gCEDNDAE.XABFhAEA.IGAE.hACA...,1,-13,-16,3
GOLXgBKPZYCMWHTSeANfIEJdcVQaRUFDb,..IFDGEEEDJCCD.dCFE..QBFEUCAADBFAGGAFLHAAhAAABFAFKBBCZDAF.MAEDhABATGFHeEHFABIF.fDFGhACAaADHFAAE........hADA......hAFA...,2,-29,-17,12
MTeSgJGABIRLCKfVbPNXdDWEUFcQaHOYZ,RDBHKDAB..VAAF..PAFHdFGHDHECUFEC..FAFHQGGChAAAOHFE.ZBCFeBHDhAAASHBE.JAHBhABABEDHCDGD.fADENCCA.EDGD.aGAChACA......hAEA...,2,-28,-23,5
XVNbJgRQFZcSPHTaKWLdAIOCGUfYeEDBM,OAFBGCEHUFBE.eBADEDCGBCAD.MGEANIEF..JGFGQAGGhAAAZEEE.PBBEhABATAEDKEAEdBCAAFHCCDGEhACADECE...XAGB....hAAA......hABA...,2,-31,-18,13
eDAYFCQMVbZEBfRIUNKTSXLgWacOHdGJP,CFEDQFCA.MIFAVGAEZEGHBCCDRDBA.UBEDKAHF..SAAHhAAALAAFaHEGOADGhACAHDFCdBFA...hACA............hADA......hAEA...,2,-41,-22,19
LRVDFbCcSWEBQIMAYdJHKNTXegUfGPZaO,JCCHHDAG.TBGGeHAGUGGEGGAB.aEGCRADE.FCCA..CEFA.SEEHhAAAEBAA.BABChADAMDADAAFFKGGE..gBGHhAAAPHEC.ZGCA......hABA......hACA...,2,-30,-5,25
QUacdKZfRIATFBDMNOHVYGWSgXJLebCEP,TGAFFFGEDEBD...ODAGHDDAGBAH.SCFEhAAAgFFBLFFDeHCCEEDFhAAAPADEQAGDhABA.UEADdHBBKAGCfACDAFDDBDAC.MFIDhAEA......hAFA...,2,-13,-11,2
fBVPJaOFYLDdTIKcSeMCAURHbQEXgGZWN,RABHQFDHEDFD.GEAAZFBC..fBDAVDEA.aEAAFBBDhAAA.DAECdHABIGGHhABASFHBMIDGAHHDUAFChAAAbADC...gEDENCEFBAHC...hACA......hBAA...,2,-16,-12,4
NacIWEHdYKXVMeQCJgZULGFBAfRTDbSOP,TFDHDGHHOEFD..aFFD...IAADEEHDdHBHKCFC.MABGhAAACDCAZDAFLCDFhAFABCHBAACBRAEFSBBHhAGA..cGAHHFBAXAGAQDFD.hAHA......hBAA...,2,-24,-22,2
NJKRgFXHPCEcWMaTfZQIBGOSbVDeALUdY,UAADdHBHJCEBKGCA..REAC.FEFB.HDBGCFFC...EFHFMAGF..hAAAaAEAZABCBBDFOHFAhACASBFADIEA.AGGF.hABALAHB..NDAG.XEGB.hADA.WFBDfDAFhADA..,2,-38,-28,10
FaOKXgBbZGHERMcQYfdeTLUVJCINSPADW,DGHHFAFBKFFABEDCGCBBHAGBRBBH..QACDdEFDLGDGUEAECFBF.hAAASHDA.hABAAGDEOCHFXADE.hAAA............hABA......hACA...,2,-38,-30,8
CcZEWQMRYSgBHIaAeGUOJVXdKNDfbTLPF,eDACGDDCUEFHJACA.dECHDGAC....TAACFBFDCHHF.ZAGH.EADAhAAAMIBA..SGDBhACABGFBaCBAAFHFOCCAhADA.KGGD.fFBEPBHF..WBADhAAA.....hAIA...,1,-21,-42,21
HVKAJfSQYWbadLgUTMcNBZeGIFOCXRDEP,SDCDQCBC....bAACdBFCUGEDTBAG.MIDENCFABGCAhABAeBHFGAGCOGCAhAAAXEACDADEEHAEHEFEhABAAIAA.fDDBaADD.....hACA......hADA...,1,-3,-17,14
YgZaTfFcEeNSWXAbLUPRCQMIJGdOKHDBV,LDACREFHQEDGMHBCGBDHdDFDHGFGDAEABAAF..VEAEhAAAZDABaAHFTACG.fAGFhABAFHDG..hACA.EFFCSGBHACIB.....hAEA......hAFA...,1,-11,-24,13
TIBMdPNFgHbeJEKGWDQZXcAUCSaLOYVfR,UGAFCEFALEDDOFEA....VBEETAFHMFIB..dHDHFGGFhAAAHACDeCBGKHGEDICAQCEDhAAA.cBAAhABAAABCaFADfCHA.IADFhAFABECBNBIA.....hACA...,1,-20,-22,2
JEFRPIbVZcBMeOTHGfSXKALDUgWaCdQNY,LEGHDAFBUGGE.aDBBdFFC..QADA.JGDEEGCBFABGICDGhAAAZCEEBAGAeCBFhABAHDCB.SAADhAGAABGCCADBRCFE...........hACA......hAGA...,1,-13,-42,29
YaDAfJOUMZPEGXeCLIFVRHNKTgcbdWSBQ,JEEGUAFHZCCDEGFH.GECD..CCGAFAABRCBEHGAG.KAAF...hACA.TAFDbFGDSEBFhABABHAG.aADBDEAEhADAADGF.fEHAMBID......hAEA......hAFA.XGGE.,2,-45,1,46
HFbCBIARESWZVUXLfcedTKNDOPYaJMQgG,RFEEEAFBZDBCUGAALGAG..eDDHdDFHKAEHDCDHOABH..hAAAaBCCMHFC.QDABhACAgBGEFDHD.hAAA.CACBABAHSEGD..WFHBfHCBhADAcEAC.NCFE..hABA...,2,-38,-15,23
ebJaWRXHYDcEfUSIgPTOGKFBVZMdQCNLA,eEEGaDCD.RFCHHBGBDFGB.EAACSEEB..IHHChAAATGCHKAEAFDBCVADHMBIFdCGChAAANDAG.AFHF..WCADhABAXGAD..fBDGgGEFOBBDhACA.BHHG.hADACGAG...,1,-8,-18,10
dCVFcHMfYSQNbJgKXPOBRDAEZTaGLIeWU,TCCBaHAELBGH..eGDGUACBdAAFFEEFMGFG..fFBBhAAAQAGDJBAFKDFGhADA.PDBHBGDHDGGAhABAAIDAEAEAZCDE..IHHCCHFG....hAEA......hAIA...,1,-21,-25,4
QOBcWZHTLdXUEPYaeDbVfMIJgKNSFRGCA,OGFABFDGZAFAHGCCLCEAUEBD..EACDaBAHDDDA...VAEEhAAAIGFC.KEECFBABhABACGAD.AICAQCGEhADA..WEHDdEEF.XBBA.PEBFhAAA....hABA...,1,-6,-46,40
fYdQEFNMHCWbTZABagGXVOKDRSLcJeIPU,aEGDXAGH.KGGBSCAD.JEBBeFAB.IFEChAAAfCHEQCBGhABAFDEDHAAACDGATADDhACABHBAGGDBDGIB.LCDEcDCD....hAAA......hACA...,2,-22,-18,4
DJXQGIRMdYUFLcHfeNaOSVAEWZKbBgCTP,ECFCZDAGKAACBEEG..CDHD.DBIH..JFFAQDAB.GDGEhAAAIBGAMHACdFDGFGEEhABALFBHHABENIABODCDhADAABDH..gADBXAFC...hAEA......hAGA...,1,-10,-48,38
HUZTGPcVQadLFMOfeJBNSACDYgEKRIWXb,CAEDDACB.EGHBKGBG.RDFD...XFAFHAACUDACZECFGEEE.hAAAVBDCQBGFhABA.dFDFLAAFhADAMEIHeHEABAGEAGACICEFWCHH....hADA......hAFA...,2,-21,-17,4
DPcISFNHKEWAeURYTQMafLbJCVXdgOGZB,UAEGTFDHQGEE..fBACJBCH.CHGAXDFAhAAAOCHBBHADDFAFPCDGhABASBAFHEBDKDAAhAAAABHEeFFHMFDCaGHF.......hACA......hADA...,2,-32,-19,13
MdSCaKXWBYJNPfALRgIFUZEbQGeHODTcV,LFBBRAADFEFGZDDH.EHFCGEAEHAACDEDC...TAGGMIDAdFHAhAAASEGGKCFGBECFJFDHhAAA....fAEAhACAAIHGICEA........hABA......hADA...,1,-26,-30,4
IBRHPTeFMXGQZKJUCSDdaYWcAOEVNgfbL,ODCHECFC..VEGF..fGHALFCFBACGRACAHEFHPDAEhAAAeHCEMBAF.hABAGBEDZDDFKAHHCHBDDDIDhAAAdFAGaADFWDDHADHGNIEFIAHF....hABA......hACA...,1,-10,-11,1
QEcbGCSFWHJaeXPgBMURVAdKIZTDONLfY,dAFBKCFCZDBEOEFELBBE..QGCGEHGEGFAFCABHFADHHEFAhAAAaCDEeAEG.PHDChABABHGHMBID.REAFAEEHhAAADIAG....NBAE..fGEBhABAbCAC......hAEA...,2,-26,2,28
KCJFbMTBNeUaVgfLRZWAcEdXSGQIHPOYD,EAFBXFCEGGAFHDBA...ODFGDABCKEBFFADAMAAHBAABeBBAhAEAUFGDaEDH.VFFChAGAfGBE.LCAChACAWEFC.AIAAdAGDICEECHFD...hAHA......hBAA...,2,-15,-14,1
ULJQcDNXgaKEdHWISfBbTeGRYPFMVOZAC,UEBELFCAQAEADDDC..XBBCKCBCHFEASGHBhAAABCHCTDFCeBGB.RDAAPACGhABAMDABOAAEhAAAAEEACHFH.JHAE..gGAEaDDDEHFA...hABA......hADA...,1,-11,-14,3
TALFVPKICaGOUREbeDgYMQHBdcSJfNWXZ,LDCHFCFCKECA.CCHCGFEBUCAG..EGHFeADE.DBCEMBFGBBAGhAAAdGAF..JHBA..hABAfDDDXCEAACCChACA..IADDaGAH.OFGB..hAAA......hABA...,1,-25,-43,18
LHceJSIBAXKbEPWGYfURaMgQODZNCFVdT,KGFCEHBGGCGEUGCE.MECGOEDA.ZBAHFBDE.dFAFHAEF.eCHFhAAASAAGBHAEAACC.hABAPFDG..fADChAGAaCAD.DBGECAHBLGDA.hAHA......hAIA...,2,-29,-13,16
MOEeNgdTbAJaQScYRDUBICfZGHLXPFKWV,aAADSGFC.RCAGBABEfEGH.HBEGXFCHFEEBKGEGhAAAMCFBECCH..NIDDdHAHhACATFAB.AHHEJAHBYFAAhADADEGCCAEF..........hAEA......hAFA...,1,-17,-33,16
baFSQeEOIWdGBTPJDCgZYKfAHXMUcRNVL,HFEEMGECRBCGLBFA.FGBCeEBHECCFOABAIHEAGDEFhAAABABA.TECAJCHFCAEF..hAFA....ZAFDKAGChBAAAHHAXDDC.NAAE......hBBA.aGHD.WCBFDAIF.hABA...,1,2,-31,33
KTMdaUADLBJEReSgFPbCIXQNVGZWcfYHO,BGHDJDCH.RFBH.eGEAFDAD...CCHE.QGEGGABBZFAF..fACDhAAAOEEAKAGGMDIBhABAdCAAAHDBDAHB.EBBD.hAAA..SDDF.....hABA......hACA...,1,-29,-34,5
WebLKYUFcMAgVRXEDOZTGIPBQaNCfJSdH,VGFGEDAFZEEC.GEBGBEAC..QBCACGAD..SBCHhAAAdGDCHDEHeFAFLHEChABAKECDFBAGAIFARBFBDACAICHGhAAANAIE...WADE.....hAFA......hAGA...,1,-13,-20,7
IGAXaEKDONBRLFcSHQMeZJCTPYUWfVdgb,aFHBDGGDBBDALDAEFBFH.HBGF..eHAEZEBGCAAA...TGEEhAAAPABAUACF..hADAVDGDbGAE..AFFCECEAhAFAKBBFODDH.NAAE......SFAChAFA.MAIBhAGA.WEEH,1,-10,-31,21
NWAaVdUCIRHSbGgfBXZPMeTFQEODKLYJc,aEHBUCCB.CFBA.HBADGEGCBADH.ZGDAeFDAFDFHEDCD..OBEGhAAADDAF.KHDELAGFhAAAJBAB...NIBHAABEICHDhABASAHH.gFAFfGAEhACA.MAFE...hADA...,1,-21,-26,5
MDKWIRAUZSFNfOLGadgcPeJQXbYCEHBVT,SDAFFHBGOFFFGBCAdEFH..PBCDQAAA.XCGBhAAACGBBEAADHAGFBAEDhADATGGDDCFFKFHFICEChABAAECH.UGDCfGDB.aGABeACEhAFAYAFC..hBCA...,1,-4,-28,24
THWKUaVZSPANfDcMIdBgJLFRQbeYGOXEC,DACBMCCABHCCLDEGFECD.QBAA.eFAEOCEDXAGBhAAACGAAHEGFKFFHaBEGZDAAhABA.AFIF.....hACAcAGFIHHCdAAEJDAEbGBG...EGEB.hADA......hAEA...,2,-34,-9,25
QEgADPITMVFNHXceGdWfRSBOCaJbKZUYL,DACBTCBCMBDE..FGCDHCFG.eGEGdADBREDGBECECAGH..aHGEKFAHhAAAZBFE...UEGEhAAALBAFEBAA.AIHEPFCHhABA.IEEGNEBE.....hABA......hACA...,2,-25,-22,3
MONfEFCAbIBePZWVUQDKJRgdSYcGTLaXH,BFDGeFBBZBAEUBDHDEHBKEDE..RDDF.dAHA..SFADGCAGLHFAhAAAHAECMBID.hABAOABGfABHhAEAFGFHADDF..IHDFVFFAQGBD.hAAA......hAFA...,1,-17,-20,3
FRWZCTJEKaOGgMeLUcbSQfPdAVHDNIXBY,DDGBXCBCBCGBRFEEZFGF...CABC.EBEDKHCEGGBF...eBAEhAAAUECB.SADBhAAAPCAD.AAGCNDEBIHHGhABAFBFG..JFAFOFAB.MACEbFED.hAFAfDDA.hAIA...,1,-21,-28,7
JFHVOPgTBEfcIQMKdUNCYLSDRAWeXZGba,eDACZACFaFAGFGDE.HEBBOFDG..PBACBBECEGCG..IEDChAAAKGABdAAECHGELAHDhABADEEG.AFAHXGGGhACAJCHF.VADEfFHEMFFENIBF.SCCDhAEA...hADA...,1,-6,-32,26
RITGgXaHFPAJMQYdcNDSZWefKbELVCBOU,MAFHdGFCDADGZEAB..eCDEKCGDLFEEBCHGRCAG.GACC.aCHFhAAAHEDD.AAGCQFBChAAANBAE.fABBhAIAEAGECHHBOHECIGHFXGBH..hABA......hACA...,1,-17,-28,11
bcRXUDfNPOaVTFCKGEgdJBAWIMHYSeLQZ,MCCAHDAGeHDGZBABRCFG.DBBB.....NCHE.OGFC.VFAGhAAAFEDEKHBA.EAHDJEECBFAChAAAABAH.IADDhABASAHHQGGB......hACA......hAFA...,2,-34,-23,11
cRbBIKQSMWFdCGUVYJDLNTegZXfaHAEOP,OCCHRAADBFEHKBEA..QFBF.SEHDFHACdDHCGEADhAAAVAEEDAAFLADChACATFEF..eGFAhAHA...gCDGfHCFAIHEEHCE.hABA......hACA...,2,-38,-18,20
TSEGNZcBOKbPLRYUXefVHQMAaIdCWFgDJ,aAFBCFEDFAEF..DBBC..SGHBEEGGZECDBAHCKECC.LADBhAAA.UGFHeHCAHCAFhABAQAACAGIBdBGD.WDCEhACA...gGAF.JDGD.hACA......hBAA...,1,-22,-34,12
gZYKGTbEBaQdHOWUfIPDRXVMJeLNcFSCA,ZAADGEAHEEFGBECEdFGBHAAC.UCDD..IGAFDGBDRAGHMICAhAAAeAEH...LEHBhAAAFGDAAAEA.KGDEaHGE.hADA.OHAE.fCFF..hAEA......hAGA...,2,-35,-19,16
SFcAfeJHYPaODRbWBMgVIQKNCZXUTGdEL,eEEGJFBBHDEH..PDABaDBE..DDHBRGCCBECG..MAAChAEAIHGGKGHFCCBBZAEEXCCBhAAA...UCGDhABATGDC.........hACA.dGBCSFAFhAFAAAHD..,1,-28,-30,2
eRdTFSBNMfZDPICVUHGgbOcaQEJXAKWYL,KHBGLGEAdCGBFGFBBDCE.MFFADDAC.CACB.HDCCGEBG.OBFBhAAAQFBD.XEGEhAAAAHIDeBHFRBAFTACDhABAfGAE..IHHE..hACA......hAEA...,2,-34,-21,13
gOUYPNVDZRGSQeTdFWMAIKHBbcELfaJXC,KCFCBFDDEDBBaFGB..CAED.UDAE....PFDEDHBAZABCGBAHhAAAeHCAFAGAADHH.HDCChAAALHFA.XFAChABAgCGAOHBE......hACA......hADA...,2,-30,-28,2
QWZSAFPTXLDeREYBfHNbMCIOcVaKGJdUg,TGBCXEGD.LEDFeCACRAEG.BGEEHFGDMAFACGEA..IEEChAAAVBEDGABG.hABAdGBEQDBEhACASBAFAGAHDIEAEBHFNEAAcDGF.....hAAA......hABA...,1,-9,-12,3
ERXcZMWaKOSIfHFVTGQYACJPLNgUBdbeD,CAFBJEEGLFEC.UCCBBHDH.eADDDDIH.EBFBRFBB.ZFGB..MHEChAAAKEAB..OHAAhAAASDFC.HACAhABA.FCAHTBAD.QAGEAIHE.hACA......hAEA...,1,-29,-31,2
KTSWLBAUEdIPbXYNDORcgGeMfJFCHQVaZ,EFHBdHBH....IAHCXFAC.DDEBOECERBBFGCFE.MIBEhAAAFBDHQFGAhAAAZAEESFDDLBFFhABAACFB.bFAGNABF.eDAECBHH.aACB.KCHBBHHGYHEAhAEA....hAFA...,1,-11,-16,5
gfPcHJWOQLDaFUSXKBEZebYGCRMdAVNIT,VAADTCBC......PEFBJFEDOBFCQEABLDHFhAAADBHHUBEBXABEhABABDHAeECCGGAFMAEEhACANADB............hAIA......hBAA...,1,-20,-27,7
UXdREDYKWGfSbLBAPOTgHVceICZJMQaFN,ODACHEFHVADH..eEGBCBAFZGCGQAAAFDAH.XGCGhAAAEAGHDCCD.KAFF.fEEChADA.LAGBhAEAPBHDgGAF.IHHAhAAAaDCANEIA.....hAIA...,2,-19,-17,2
NaURVGfZDbLgFBHIKCTeYXMAEJWOQSdcP,JCCHODAC.dBCA....NEHG.aAFEUGCCRCFCGEECZBEA.DICGLFFBhAAAFFAA.BGABhABAIHHECDAG.eAAHhAAAMAIBAEHF...EABFSEHH..hACA......hADA...,2,-38,-24,14
GbXcKVYFTCOafDEQSBHedZJUMgIALRWNP,LFBBRAAD..NCGGGEBAXCEEKHEAFHEE.OCBADDIH.SAAChADABFDBeBHFJAFGhAEAMBEAAEED..PEHHhAFAbACF...cFEB.....hAAA......hAFA...,1,-20,-34,14
ERCafgAZTQcFLdIGJPVSXKBWONMeYDbUH,TDCBFGFCdDHCGCAG..PFFFSACFKCBFBFBH.OADFhAAAMDEFeAFDDFEHHDGHhABACGAG.aHBCfHCDhAAAAAHGZBFG..........hABA......hAEA...,1,-16,-31,15
TIMefCJFVHODNLEBdSbQUWXPZYgaKGRAc,TCBCeCHDCGFC..FHACOBAG.LBGBdDECQDBEUGCAXDEFhAAAZAFE..gGDDhAAAKFABAIFGMAFCfACHhABAHFGFDFCEBADESGAE.WCADhACA.aBBC...hABA...,2,-15,-14,1
OWScfXUHEDGZLQYTMPBFebJRKVIAaCdgN,aEHBdEGDOEAE..SGCB.XBGDUBAGDDGEGAAChAAAQGCHTEEGhACABGHFFFAFJADCKDDEAHAGCECG.hAGA..NEFG.cCDEEBGE.YFHBMACG.hAAA......hABA...,1,-3,-38,35
CEFeHIQBdZXPTfGcASObLJgKRYWMNDVUa,OCCHLEEGKCGDRADAMAIB..DBADaCFDCAED..FGHDHAAF.BGGBhAAAZFCD.XGAAhACA..TFFEfEAEhADAAIFASCHHJHDG...gBCBhAAANDDA.VFAF.hAEAeAFG.,2,-37,-3,34
XAaPJOCMDVIfTdHgcUeKWNGLRSYFZbEQB,JCCHMIAG.DGFG..VGFA..TBAAdABHHBDHUAFGKAHHGECBhAAARCFH..FHCGbEAFBCADhAAAADGC..OEHFhABACAFA.ICDF.fHEB.hACA......hAEA.gFAF.,2,-26,-15,11
KGPbeJFAVNWfcIdXYOSBMEUTHQLgCaZRD,VAAD..fFAFdBGA.XCGASGGHMGEETADGhAAALAAD.aCDADIDEhACAPEECJDDDAEHA.NIBDIAFAhACAOHAAEFEAQBBACFAA.KGCA.hADA......hAFA...,2,-30,-1,29
RNCLWZQdgaITXFbfcOPJMUGEHDeVBYKSA,CFDDLFBBZAFA.QFDDdEFF.aEBAIGHB..FBBFhAAA.fEHChABAPADDUDAHEAFEeDDEBBBBSHDEhAAAACAH.NIAF.WBDG...hABA......hACA...,2,-42,-16,26
ORaUZQPFIEXbSeKAgNVGJYTHLMDBdcCWf,VAADJFEFHCFD.DABHdBEG.CEAE...OFCFRAGHZEEE.FDAB..EGGDhAAASDDGACIF.hACAGACFLGAAMEIDhAAABFHA..fFAFaDEE...hADA......hAEA...,2,-29,-26,3
LURCYGPaKeNcFgWbMHOETfQVXSIZAJBDd,DGGDdGDDLEAHRGCGGEAH.KCFB..eAEGFBCB.....gCCGhAAAMIDEODDFEFGG.hABA.TACAQGGFhAAASBGAIAFFAIHE.JCHFCHAH....hABA......hACA.aFFA.,1,-14,-31,17
eUFJLEBDTYSQVcbdNZafIXWPKMCRgOAHG,HFBHGDDCeDHHUACGLABEEBGA.BHABDAAF.SEEDhAAAQGBGbBDGZDGB.IAFGhABAPHEAKCBF.MBFChAFAgCBG.AHAH.JDFF....hAGA......hAHA...,1,-5,-18,13
dgKcJICMbGFDXROHWZUPeVQASfEaNTBYL,SAFBEAFB..NBIABEAGdBAGKCED.JEAECHBEGCCG.FGFEhAAAREFCOBCGHABE.ZGEEhAAAPCGFeBHBAHAAaGAG.hABA....LFED....hABA......hADA...,2,-29,-18,11
OWUScXVJNRDGEAMKfITQZYdaBCLgbHFeP,MHFGKHBG..TDDGQCBEdCBBBABCCHCELBBCHADAFHFAeFBChAAA....WAHHhAAAcGAC..JFFGDDGAhABAAGEHZFAEaFFC..gAFB...hADA......hAFA...,1,-18,-27,9
NWPLadGVJDfQEXIbcUFYSMBgAOZCKRTeH,OFCAKBBDRFDFHBGB....NAAFLHACaCFBdFBD.GCBBJADAQGFDhAAAECGE..hABAIFGG.bAFAhAFA.FHEESHAEMBBEAIHGCEHB.TDBC.hAGAWFFEDEEE.cACChAGA...,1,-4,-27,23
UZFQHIgcDfbOdWARXKJMTaNVBPLYSCEeG,KDAFMAFH..aDHBVAGFBFAH.LBDB..CEBAEDDDeFFFGDFEhAAAFDFBHAAD.IHGAhAAADCABfBBBhABAdGCDABHG.XGAE.NEIE.SCCFhACA.....hACA...,1,-17,-30,13
bFeMDCgXSTHdPYLQfAOJVZWKaUIGcRBEN,VFBGZDAGKACG.UFDHGACG.RAGD.BAGCEHEC.FGGE..DAEA.CEEA.hAAASCGAdGGALBABhABAACCG.JBFH...hAAAaEHFICAA...NEEF.MIAEXFAAhABA....hACA...,1,-7,-51,44
DEBIfZHPgOYVdJMLTFAQGKWbaUSecNXCR,GCEBKHBG.aDBDSECD.eGFEcADG..NCDF.XFGFhAAADDDH.IHEGhABAfHEBZGAC.PBBBhAAA...OFAHYCADJEFGMBFEhABA.....hACA...,2,-31,-25,6
gLDYbXaUQPKedHGRJSEIMZVACNfTWcFBO,CFDGTCBCFCAB..BHEFOAFGLCCA..bDEEUFGB.KAAEhADAHFCC.JEADSAFChAEAEGHFMBAEAHCF.fFFDhAAA.WADBDEBAaCGD.QGBGhAIA...hABA...,2,-39,-20,19
XaCOAUVNTYIWSfEKMbcgPBGJHLFRedDQZ,VEFHTCBC.....ICGHfCGBKFAH.MAAB..hABAbEDBgFABhACABFFAJHEEFAEBRAECDDBAZAAEaGDFAIBA.hAAANEAF....WHAASFCDEBBE..hABA......hACA...,1,-7,-28,21
UQeJRdcMbKCfYODXPEWHIZgTBVLSFAGNa,aGAHUDCH.QADGeDEBdECA..MDHBKBBCCCGFOCAB.DCIDXEGBhAAA.EGFGWBFChAAAHGACZABEBBAGSGEGhABAAAGB..NIDF.......hABA......hACA...,1,-24,-28,4
bKCYVTOIUZeWBfHQRMESPaNLcdDFXgJAG,KGAHVDBHODCC.ZADCBDGA.HGDGQEGHMEABEADDSBBBhAAAaHGE.LFCBhABADABFXBGEAEADCCHC.hACAIEEF........hAAA.eHBGfGEChAEA..,2,-29,-26,3
VUPWgHMTRANQYIBaDXKEefcFbSGOCLdJZ,QCBCBFDGDBFGKEBHEDGD...eGAAFACBGDDDCEFDLDADdHCHZADBhAAAUBFD...gACEhAAAMAIDAHGF.IEDHhABA..aGADXGGAfFGGhABA......hAGA...,1,-7,-42,35
cEfFNYZDAdKWXTVPOUeSQBbaJHMCRGILg,dAFBXGBC..TFDCOCADUCDAQDECBHDG.JAGHCGHFRDBBhAAALFGF.EADChAAAFBAGZABFDEABAHEDKECB.hABA...WFFB.eCHFaAHF.MBGF.hADA......hBAA...,2,-28,-16,12
IBWEbcCDRVXdgYAKFTfSMPUeGLaJHOZQN,FFAASGFCMEDB.UGBHLBHFHAACQDDFBFFCEAAFCFHG.RCGHdEAFhAAA.ACGH.KADCfGHAhABAeCCGGGEF.hADAaGACOADD.IAGF...hAAA......hACA...,2,-28,-2,26
PXAMFfdSJcLQgEVGKIebDOWYBaZCHNRTU,MHFGFAFBdGEE..JBCCQEAH.EDFEKFEA.eGACDDIBOCDBhAAABAFHZDDA.CEADHAGBhAAATGGH..PBBBhABAXABC.AAEHSGCH.gEEEhACA.IBHEhADA,2,-40,-18,22
STZPLAIOMKBcWGNUCVfdXERbDaQeYHgJF,MDEBBFEDGACGUCFB.CABE.dBCCRCEH.DEID..aBBHeBAF.HGFGhAAAFAEAZCGHAIBE.KGHF..hAAANABF...VEBBEEBE.hAGA...QAGDYHBG.SFBGhAIA....hBAA...,1,-20,-24,4
dGJCDNIVPfeAYbUZHWQFELMXcRgBOKTaS,UCBCZGFGQADAEEHFLHEAMFBC.RDECBAGEKAFG..aGCFSCAFhAAA.dGBDCDFGIFFGhAAAVCBE.fFAFhABAAIAE.bADBFCGA.gEGAhABA.....hACA...,2,-36,-5,31
PKHUgQEeCRAMGOIaSTcVYdZXLbBDJFNWf,MGEAOFEF..aBEASBFH..TDAEVCBFdBHEXABChAAABAAAFHGE..hAAAWFAAfAEHhACAKDEDgCFGeHAAAADBIEHFYHFELCHBhACADEAF.NADHPHBEhAIA..,1,-8,-30,22
AHTYEMJFXCIgWVfKPNReZdcUDLBOSaGQb,TFDHEGFHFAHH...CBHC...IDGG..gDBHhAAAVDBDKEEARGBCZAEH.UABFhACABADHaHAGQAAFhABAAGAEYHFAMDAH.WCCEfDHE.hADAeFFEDEID....hAGA...,2,-26,-15,11
gRQEVSAJHaFMTKUDPNdbXZWLeGCYcBfOI,JDCHHFEE.FEHFKCCCUFAB.DAIBdEEE.ZAAELBACGCGE.CHDFBDEBhAAAOBFG..RCAA.EHAGhAAAADGH...MAEE.hABA.TAEC..PCAD.NIDF..hACAXGGA..hABA...,2,-29,-27,2
KAUXZScdJMaHIENWeQDLGTCPgOfFYVBbR,XCCBZDAGdHADMBCAHAFC..EGGCeEFGDIFC.TAAC.CHDCOCEChAAAfFEB.VCFFhAAARFAGUDAH.SGGDhACAJFAEaBAH.........hABA......hACA...,1,-2,-28,26
NLHbEVeKaGRMUSIDcfBOWFCdQZTgAPYXJ,XCBCJEEGHDBE..EHBEeFFA.KADCGAEFUBFE.DDAHBHAFOACFhAAACEFDZECBAIAG....hAAAPFGDNBAE..LHEEhABA.aCCAMABH.IGDEhACA......hAEA...,1,-21,-26,5
MaRLFJfKSbOdZeITPUGCAENDXQgBVcYHW,EHFGDAFBQGDDBHBH..VCAGHAGFMAECaECFFBBF.JFGFSBGAhAAA.dEDEhABAIDAHTDFD.PDDAhAAACHDGAGGE..NBBB.gGAG.YABChAGA...hACA...,2,-32,-13,19
YTCPROQHAdUGVXIfeLaJSbBgMDcFEKNWZ,UBCBVCDF...XCFA..fCAHaGCE.bBGBMAFEhAAA.DFGH.FEAHEGFEhAAAKFHFZFAD.TGCBhABACFEEODBEAGIDGABH..ICAE.hACA......hAEA...,2,-36,-17,19
SLOJZaQPbNeGUVTYFdKAEgWBfDHMIRcCX,EHBGBFDGHGDCMDCFRBGF..CDED.SFGGLCABOADCZAFH.aECBhAAAQADC.hABAPHFENFDDUGGAVDDGhAAA.FAHDADADfCCFDHAAXBAF...hACA......hADA...,1,-9,-14,5
PWGBSEgNfecaRObYUXFMHDIVKZQLCdJAT,TCBCGAFEEBCB....fDEFaFBAOBAHUGAAMBEFIDHGhAAAVFEB.KABFLBHBhAAACAEBdGGHAEBHPGCEhACABHHB...SAHB.NFCFcADChAGA....hBAA...,2,-23,-16,7
GgFMSLWeVPZafTKYRBcIOEDJAHdQbXUCN,QCCBXCGCUCCDCAHBGFBB..MICELEADeFEEZAFChAAAfBFGKFCGBBBFIAAChACADADBAEAH..dFHAhABA...NEBC.SHFA.VEFEhADA.aHCC....hAEA...,2,-21,-21,0
PgGZSDMeNcYAQaBCHVOJbdLfEIWRXUTFK,QGAFBCEACCAGHGFEOFEAdAADLFBD..IBAEhAAAREEAUAEFKDCBPDCG.gGDChABASDGEDGIHhACAMFAFeDFC.NCEHAIFEJHCCfAFF.hABAEDAD.....hADA...,1,-3,-21,18
bGJWfLSdVecIBNCTODKgEAaZQHUPRMFYX,QCCBUFDHMEBH.FAAF....bABHJADC.LCGDdGGDeEFEhAAABFDE.CGGDDCABKCFAEAGAhABAZGAA...HADFhADA............hAFA......hAGA...,2,-43,-21,22
cBPOXCaWNDdEARSfLeJYVTKbIGMUgZHQF,RDAGLCCHeAHB.JEAD..TGGGKGEHGCGEMFDCZAAEHAEGFGBEBAAChACA.OCEFCCDCaGAHDBGDhAAAABIH..SGGDhADAfEHE.........hAEA......hAFA...,1,-20,-26,6
DJUbEWFVMHTOgGISQdeKaZcBYfNLXRPAC,JFEDEGFCFDAGHBBC..OAFDGCGG.SAFDeHDGZBBABHHAhAAA..NAAELEBChABAXDGHAAFBUGGB..hACAWEAAMGAC.IHAEKHAEaACC..cEEBhABA.....hADA...,1,-17,-19,2
TDPNYIXSBKJGWdMQOafVZcRUgEFHLCebA,TAFBDACB....PDBAIDBCBBAAGCGEdBFC.ODAHhAAAaGAAZEEAUFED.EBBGhABAFBHFCFCGAEDE..NHED.YHAChACAKADD..MIAA...fEABhAAA...hADA...,1,-21,-35,14
GbKfXFVMBPdTWgUCaZHRYDQeJLISNEcAO,GECFKHBGFEGDBDBGdCHC..TACGUAEG.aGGFZEDD..HEAFRABB.hAAADCAH.....hABA......hADA.JAHFSGEHNEICAHHB.fHBFhAAAXGEDMDDCWCDACAHF.hAIAeBBB.,1,-28,-34,6
GKgHYQTaeBLXANEPVCWfObIZcJDMUdFSR,EHBGCFDD..OBADZDBDDBABUFAHFEFG..RFGB.GDEAHGDG..QAGBhAAAaCCHBBFCLAEChAAAABDC..NBBE.PDHBhABA..WAFDIACE.MIBAhAIAKEDB......hBAA...,1,-19,-30,11
JGPDOHVNfSYeQUXbIZaWMgCTcARBLEFKd,RFEEEDABKEFEdEGCGBDF..OHCG.VCCFfADH.hAAASHDAQAFEhABAbBADaACG.MFAFCHBAACCFBBHBhAAAJHFEDCFH..YEDD...hAFA......hAIA...,1,-21,-22,1
QecKNITLJPdODRFAgZbEHSVBfMWGYaUCX,ZAADECFCHBBCBCHAMCCC...GFABYHEGCDEH...QEEHhAAAKHEA.IHBBhABAJDBEdEHGOBFAhAAADFBGADAHSDHB.fFHGhACAWHAAaFGH......hADA...,2,-31,-28,3
DJYBIFRQGgOdSTEAKHUXNCeMPLcVfZbaW,UCCBCHHG.eFDEMBGFLHBG..fBAGaACG.JECEhAAAIAABFGAF.GFAFhAFAdHCDEDHBADHBKAFGNBBB.hABA..PFHB..cDADbBFADDBF.hACA......hADA...,1,-8,-39,31
GEeIXMcaRLBKOVUFYQDHZgPNWfTCdAJbS,SDCDECCG.eBCCMCFH.aBGCBHFGKABEUDGC.QEBChAAADFAHZFFCPHBGhAAA.fDGDhABACAHGAIECJGEG.ICAF.XDDB..hACA......hADA...,2,-33,-33,0
NRfEUKMPDXBGIcSFHgVaOWLbAQeYTZdJC,QDACeDACZGDECFEG.RGBEUGFH..KCGEDAGFBGBAGACA.SAHDhAAAFCFHHACGaGAHhAAALEFEAABC...hADA...YHFG.....hABA......hACA...,1,-27,-31,4
aAQMVBXSCOYPcUKJZgFEHTfDbGWRdeILN,QFCAMEEDBAGC.SCEECCGB.OADA..YBAGhAAAPAHF..KBACJBEHhABAZGFCEGHFTEGE.hACADEECbEAHGCAFRFFF.dHAFLDAEAEBD.hAAAcDGC...hABA...,1,-6,-23,17
ZBQcdfRLAWGUXSaMFOHNVKCJebYITEgDP,UAGHSFHBMEEGHGFAKADE..CGFH.eDCF..IFBBhAAATAABDDFABHDCdFFFRABFADECXFADhAAAFAHH.OADDhACAJEEEEBEA..ZFCB.fDAA.hABA......hAGA...,1,3,-40,43
PHadQBCcVIbDYFMXegGASLRKTUOWZJfEN,SDBDLDCHRGFAKAEDUGAHZAAC..EFGHHAGHdGDHBHHGCCFH..hAAA.VAFHIEFAhABADABFFEDEXGAC.hACAeCABABIFTCCHOEEHJACE...NDIE.aDHDhACA......hADA...,2,-14,-14,0
DaGLJKNbFAcgWVEHIRSMeOCTBZUPXdQfY,....gCBCVDAGEEGARACFMDFA.CFAGBBAAZGAEUBGB.dFEChAAAQEFDDABF.hACALECFNAFA.bADEhAAA.AICG....cGGHIGGESAHFhABA.OEDFhACA...,1,-23,-26,3
fCaUBVAIgJKGYdZbSWMOXNHeDTcLFEQPR,JGEAGEAHZCAF.SAAC.OBBGNCEF.DFHHLGAAhAAAFGEAEBGE.QDDChABARCDE.CEHFBADAAHAFIDHFhADA.KGCGdAFFMFID......hAEA......hAFA...,2,-37,-19,18
acbNHOICBdFXWURVDKTYQJEeALgMfGPSZ,MDEBGAFEZAABaDCD......bDFBNCECOCAHBGAH.FEHFUAFEhAAADHGG.KDBG.TACChAEAQABB..hAAAeFHFAIAGfHDBSCHHIAHGhACACHFB.XFBCWHBA.hAIA...,2,-28,-16,12
VEHgUbIXBOLTaAYCRPfGJQKeZWDdFMNSc,RDBHGAFEQGEFeCBADEAFFAAG...MDFBSHCGEGHD.UEFFhADAXACG.OAAHhABATAFDAIGAYHBChADAfBCF.JFAFKFBAdDGBNAIE.....hAEA......hAFA...,1,-14,-16,2
SgOaCPYRcQJFBVWbUMDTNAGfHeEdKZLXI,GEDHHFDFEAEEdGGGZAAHLAAB.SDGGaHGECBGARFFG.JBEAFDDGhACABCDH..VEBFhADAUFAEMCCADAEAAHDBfGAEhAGA..eACF.....hAHA......hAIA...,2,-25,-11,14
LCPFGHbDTSZXdgOJafABNUQKYEVIMecRW,UGGGKGFCEGCHMICE..RDAELDFGCDDH.GABBHDFGTABGhAAAZCDDdCABOAGH.hABAaAHFBAGE...hAAA............hABA......hACA...,2,-47,-17,30
PHGfQYESMIdBCFcZVDKTRAWaObNJUgXLe,OCCHJGEA.UGEGLEDFHADFGCGAQFAHEAGE.MCIBBHHGhAAAFEFEZBABDCBHKGCGAGID.aFAFhABA....gCDEhAAA.XAFE.eACF.hACA......hADA...,1,-15,-21,6
OQZRBAIPdVDTNcaFSMUCbfeGKJLWgYXEH,dHBHVFEEDCCA....TAACaHEAFAGBUDCC..CFFF.eAFFKFBHLAAChAEA..hAFAYDABEDGAHCDCOCHHhAAA.QGCCBEBFAGGGIHHChAIA......hBBA...,2,-32,-17,15
FUHIJAWfDPYEbMTQLRVcdeXBSNKZCGaOg,DACBEHBG.MFIDLEDG.RACGdEABeDADBHFBSEEEKAHH.GGDFhAAAOBACUBEFHCGDhAAAAAHG...fDDBhABAYBBF..bFBD.......hACA......hAEA...,1,-21,-22,1
EcZSfNgaHLKUCIGXeMYRbTPBOQFVAdDWJ,dHFHDEFHEHACSGBG....fEADaEBCLAEHKGFACFDFhAAAXBCC.MBADhAAAYABCRDGD.bCBAhAFABFFC.FAGAVAFBAIDG.JDHF....hAHA......hAIA...,1,-20,-31,11
aUAfbTNPZVHLJREXWcYGBDQCdISFeOgMK,TCBCZAADLFBG.RAGD.EAAF..XACE..WHEEhAAAGDEFBDEHDDDAdFBEIGGDhAAAeADDMFIBaFHFAAIBhADAfEFH.NAEB......hAFA......hAGA...,1,-25,-26,1
CZOKXDFeNJdPIELSQYTUBWMgHRcfAbVaG,VDAGaGACGBBF.ZDGHKFGE.DAFDeEAEdADA...EGFDQCGBhAAATDEEBCADMGAG.hAAAHFEHfBFBhABAABCECHHEXDDFNBIC.PHAAIHHA.YHBGhACA....hADA...,2,-15,-14,1
QRTZdbJgGFYWLUfBEeXAPKCDMcSNIVaHO,CFEDMCHF..SDFDVCEF.HACGQAFBTBGAdHGFJCCD.hAAAFEHDLGFEUFAEEDAEhAAAXGAEAHEE.DIFEhABAIDDHaCAD........hABA......hACA...,2,-21,-20,1
feKJXWLHZRTCBGEgUcSaYOVdMIDAPFbQN,FHBGQCBCeFFFKAHHJFAC..LAACREEEBHHGGADDUECE..hAAAaDDAOHDA.MEIHhABAAHGA..NBBGXAEDhAEA..........hAGA......hAHA...,2,-34,-30,4
WIJOVaeEPAcTZYUdQfLBDNMKRCXgFSbGH,ZEFHdGFCLFBCBEHFDHAG.KAHHRAEF...CADGFCDHGAAC.HDBBJBBD.hAAAaEDF..EDHHADAH..hABA...TGBFhACAYHCGUAEE.fGHEMAIFSBGHhAAA.....hAHA...,1,-21,-31,10
HKbGNAFgaIOdTEJYePMZUCVSDLQXcBfRW,FAFBaHBG.dHAD..EEFEeDACZAEG.UEEB..SEDBQCGAhAAAXCAEBECBRABEKBADhABANEIE..AHHH.OHFEhADATEAB.JAAA.MDDGCFHC.DGGFfGCBhAEA.....hADA...,1,-15,-28,13
FXPTdCQAJagZDEGKUbRSBfIVNHecWMYOL,aDCDDHCEKDFB..RAFHBCAF..IGHBVEFD.HCCE.eBHDhAAAMCEHOADCFDBBXABFhAAATBAC.dCHACHACAFABhABAJFAFZFCA..EHDE.......hACA......hADA...,1,-22,-26,4
BCebRgfGQHWEKcUXPVOaSZFLMJdYIANDT,DAFBTGDGeDAB.RAAB.GEABHDGB.EAHFKGCCUCDE..VGEESGHHhAAAZDCG.LADEhABAdHAHADIBBACCCCAFfCHAhACA.QFFE.XBBHhAHAOAGB....hBAA...,2,-19,-10,9
JBXTRUHFIGKCZYLdMDWgVAQfEbaNcSPeO,EGFCaHBG...SAGAOEHFBDAARCECUBADFCDAGCFGZDBALEHBhAAAdCABDGBA..VGAAhABAAGHBQAGE.hACA.fAEENAAB..PEEH.hADA......hAFA...,1,-15,-22,7
WNgfaXOPIEHCFYbSJMdDUcVAGKTeRZLBQ,KEABeADGZFCFLAHDBGFE.QEGC...NDBBaGDHXAEDhAAA.IAGDhABAEBBACFAHFEEBSEGBhACAMAAFDFCH.UDEAAIHA.TBBD...WEHHhADA...OAHDhAEA..,2,-29,-22,7
NcCgAbOdXQLMaPfEeIFGVUJZDRBSKYTWH,dDCDXDCHQFFFLGACMCBB..aAEHEDFAFFGHUAAH.ZGBChABADDIHBADGSBBEhAAATAGE.HAFD.cCAEhABAAIGA.OEEDfFCF...hACA......hADA...,1,-18,-20,2
ZVaBLPQeGKbgAJUIYRSWFXHNcTEMCdfOD,JDACUCBC.RBFH.FGHHHFEC....TGDGEAHBMACA.CGAF.dDGFhAAADFIB...ZFCDBHFAhABALHEAPACA.hAAAeBFEbBDBABBASDDE.XGAChAGANBAE.fBBDhAHA..,2,-27,-16,11
DYKJfCeRcOGQHdaWLUbFNIgZPMBESTVAX,XAFBDGHHKACG..CEAA.RCEEGAACHGDAdAGALHCE.FFGHNEDF.hAAAZEAEBCCASADDhAAAAFFE..JFBBfEEGhACA.OAHFaBAH....bAEDhABA......hACA...,1,-5,-43,38
ROBXeTfFAEUPZGWHCDdKNYIJacbLgSQVM,UGBCZEBHGBBBCAHC.dDEDKABD....IAEGJADA.aEHDLEGBhAAA.SEEBhACAMAIFRFDGBBGCeCDFhAGAfGAG.ACAFEAAEPCFGDFFE..hBAA......hBDA...,2,-44,-17,27
UMKeOSFIJBLVgRPfYQCDGTAbXEWHNZadc,EGFCHAADZDAFdEDE.UFGGMIDCOFCH.FADEBDDH.VAGHRFEF.hAAA...fBGFhACACAAETFDEAHIBXCDAhADAaAEFKGAD....IACF.gDFEhAGA...hAGA...,2,-23,-21,2
WXMBPYRZOKafILEbCVJGTDQAUHgFcNdSe,HEFHFHBGdHEBSAFB.eDADXBGDMABBBHCHRABAZBED.ODBFhAAAaFABLDCFhAAAEDDCCACFJAHFDGGG.AIHE.cGDAhAEA...NEIE........hABA.PEFE.KCABhACA...,1,-3,-26,23
WOYQeUdALCaFcgHJXVbfZSPINKBTGRMED,aDABFHBGHCCC.JDFDXBAA..VAGFZFBASBHDhAAA.IHHEhABANBACBFHGTEBCGBEEEFGEhACADBCEOHEAeHAAAAHACDDD.gGEH.hAAA......hABA...,1,-1,-32,31
GbKNcdOFSgWVIPAJLeTCERDfaQUBXMYHZ,eAABTGAFRCEC..DBIHaDHHBGEB..MECGZEABGACCKGFA.dEHGhABAFBBC.SFDBhAAA.gBEHhABAWAEEIHCEAIGELAEECFCH.fCAEhACAXGFD.....hACA...,2,-30,-12,18
EHRBQXfMJZYKGgCbLSIAWNVcDTOePdFUa,VAADDAFBOAAF..dGDCFEEAaEDAHCCDRGEE.BAGB..QCFBhAAAMDAF.ZADEGGBBhAAAbEAC.IHHEhACAAHBD.NAIE....eEGH.EACF.XBFDhAEAYAHHKEBF.hACA...,2,-26,-2,24
efDFOWbYXTaHBRLUQJcPAMIKVZCNGdgSE,MHFGKCFCCFGC.GCDE.dAGESAGG..fFBAhAAADIEGODECbABD.XADEhABATBCCBCAELDGHhADAUFBHcGBDAHABIABFNEAC...EHGGhAAA.....WEAChADA..,1,-12,-39,27
UeaISDWXcfZTKPHVLQGEOFMJAdNbgCYBR,dHBH..gEBHCGHHRCGF.eBEDaAEGDDDGXGEH.ZABBTDAEhAAAHEFDQBFEhAAA.OBHFhABAJECEAGFENIEBBHHE..IBAD.SADDhABAcGAC.fAGFhACA,2,-39,-15,24
NeFPXdICaVcbDLgfBEGAHYZTRUJKSQWOM,HGFGTFDHRBFAKGAB..QBECMABEFECC.XABCdGEG.IBHBhAAAaCCG.VDFHhACADDDE.LCCFBFACAEEA.hAAA............hAFA......hAGA...,2,-35,-15,20
cASIWgKERVMQUCNGPFdLTJfbHDaBXZeOY,SHBG..WEBEKAGFEECERAEG.MHFECDAFGGEB.FBCDhAAAdBBFLDFGTEGAJAEFhAAA.HFACBGAFeAHHhABA.OCAHAHCGIBAE....hABA......hACA...,1,-4,-41,37
QfZWXKEBURMACNDSHGbgLacFeYVPdITJO,CAEDDGHHGDDELAEDFFAE.eBAG..VBAFdBGGJHCE..OBHHhAAAZDBFKEFDBGGD.MIBEhABAADDDSCHBhAAA..gCEBaAGA.YFHHhACAPDAB......hADA...,2,-32,-24,8
WHYEZTVDGPdObegfMURcICBLXFQNASKJa,SEEDKEED..aABDHGBEZDFADAIFdCCCOAAF.gADBhAAAMEACRBDACAGBBGBEhAAA.LHFAQCFEhACAADHG.JFHDEFGF........hABA......hADA...,1,-15,-38,23
VWBAgeIMbXCYFKJNdGPQaSEDZOTRfLcHU,eGEAMCCA.CDDG.FEBDKAFCdBAA..GCEBQGEHEBAE.DEGD.OAEAhAAAfFBBLDEChABAHACE..WCHBhACAAAIHIHHC.YEFGNDDE.aHBG.hADA......hAIA...,1,-14,-27,13
REXDPTLAOJVBSfFdNYUeQgMKHIabCcWZG,VFBGSEGD.FBGGdBHE.UGFHQECCMFAB.KCDAaAAFCAACZACEhACA.GDAEECCA.hACADDHDLEFEAHHB.hADABEDBYFFF.......hADA.gAEBhAGA...,2,-31,-17,14
aJKQIGUBEVSDbfONZMdLYFgCcHXeAPWTR,TCBCRDEDKDAGGAFE.BHGGSFAG.DEGEOEDHZEBCMHDAhAAAdBBFLBHHhAAAFAEFCDEFHFGDAFHE...aHAEIHAEhABA.EFAAfBHA..hABA......hACA...,1,-25,-26,1
bedNLHSDKMWBcRFJaTfCEXYGOgIAVUZPQ,UBBHQFDHeFBAdFFFHAFH.DADHKGDGMCBBBAFDFGGD..aBFECEDC.hAAA.EBHFGDAF.hABA.ICEGAIGE.hAAAPHACLAHBSBBBcGAC...hABA......hACA...,2,-31,-14,17
ILQRNgJAeVWYTPbcOfZUGXdSDKFCaEMHB,eFBBVAAD...TFEC..bCFBOCEAUFAFGEGEdDDHDDAECAAChACAMEEBBBCBLADChAAA.NAIA.AEIB...hADAWFDDYAEE.fGHASBEDhACAKHDG.FDGD...hAHA...,2,-22,-13,9
eFYOXcbfgRWVUaJICBEALQTNGMHSPdKZD,LDCHQCGCTFGCGACB.HFEDdAAEDBGHeDAGFEECOBAChAAA.XFCDfGAGhACA.....hABA............hACA......hADA...,2,-42,-16,26
HScPfYgVDLGMNIEaKUFbORCJXZdTeWBQA,HDAGSHBG..PHEE..gDDBDAAHMFDAIBCAhABAaHFEKBFBFACHRBFCCFAGXFBFhAAAZGAG.dDADeDDGhACABAGBAIBA.fDGALEHFNADFEBAB.OEHDhABA....hADA...,1,-1,-22,21
MZbYdDWgKeVaGUPCNcITFHBAfLXQJSORE,LDACXDCH.SCEEEBAC.MFBFZFFEdDGG.DAFAKEHBeBEEhAAAaAHFUGEACCEC..hAAAIDBAFGHHAACFfAGEhABAJHBGODAH........hABA......hACA...,2,-27,-26,1
ZcKQVTEIPeDLMfXJdONRGgFHbWaSBAUCY,CHHGZAADKDGFQDBA.EFFGIABD.DEAAMEDC.XACDhAAAJBHH.dFAGRFAEGADChAAAFCGAHGDE.bAEFhAHASHAGAHIDUGBE.VFEF....hADA......hAFA...,2,-38,10,48
UOgNXKGfSHQeBbERaDCVAPILJTdZWMFYc,LGEATAAD.dBDDZDFDFBBDUDDC.ODBBXEFG.KGACSHEChAAAHBFBBHADbGAGhACAEDAD.DIGEACCHPAFAhADA..WCHBMIFG....YDDDhAAANBIAfAEE.hABA...,2,-30,-8,22
RIgaSZXcVOHBTMbfWNPCULDAJdEYFQeKG,JEGHdAFBEFHD..FGCGQECHKEAF.RCEB.aACGZGDA...XCBGhAAAVBCB.BADEhABAMBBD..fBBBhACA.NAIE.PHEE.CBGBDEFFeBGB.hAAA......hABA...,2,-49,-4,45
UfODBJXLRFASacIYMVbQTHPNgCWKdEGZe,SAFBaHBG..IGECMHAAVAAFQBDH.TABGhAAAHBEFPFFHhAAA.CEGCdDCEZBFHUEAGhABADIAABEAHXEDGFADFAHHH.cGGDNDIE.KAHF.hACA......hAHA...,2,-13,-11,2
fOaNIYFZKXCGREHeDgUbQSMPWJTBAcVLd,VFDFdDCDOAGD..aDDE..IGFCFFAEKADGGAFGEBDCHAADhAAADIGEUGAC.SFDHhACAMCADJFFAADCBcDGHhADALBHB..NIED.XAAACEAH..hAAA......hABA...,2,-23,-9,14
gdCPJcYGDOWefFBKbIZVUTHXMNARSQLaE,QCCBLEGHaCABdFHA.CCGB...PAHFJFFDGEAG.DADChAAAODDH.fABFhAAABGDAIBAGhABAUBECHGAAMBDGNAIERFEHSFAE..hABAECFB.....hAEA...,2,-21,-16,5
cYQWTaUbJFBDPZdXELRACGNSHOIgVfeMK,CECDSGAHHBBE.OCFBIFAH..VDGBMEIB.KADEQBBAhAAAaGFG.bEDHhABABDGADCGCZAEEXDEFhAAAEEAFAGGH.gGCE.fCAGhABA.eDDB.WAHBhACA..,1,-12,-21,9
UKWFeOXadBIZgLTYcCRSHfVbNMGDEJAPQ,QCGCKGFCFDBD.OECFdAECBFDGZFFELCBA.TACFhAAACAHGHGAE.VAACMICAhABADDEHAHBCUEAE..hACAeHEG.aAGHIAHF.YEEDhAEASCGA.NEIE..hAFA...,1,-14,-32,18
RUDNZCfIWeOaHBMVYdGTcKELJbFQXgSAP,UFDHZFDGCBHC.....fCAEIDBH.eEBFOADHBAHFMFBEhAAAdBBHGAEE.hABAKHGGEHGCLCHFhAAAFHDEXCGAAGHEDGABaDDF.......hACA......hAEA...,1,-15,-40,25
bdYCfgAEOHMQGIeVBZSWNDcKXRaLUTFJP,EDBDMAGDGFED.eFCFBBBEZBCGSHEEDDIH.XEGGhAAAaHDCUAGHFDAE.bFCGCEEHAACGhAAAHADF..IDDFhABAWFAH.KFABLAHF....hABA......hACA...,1,-17,-22,5
YOFgeVPHfNSICDREAbUadTWMJKZBGXcQL,aGFCTGBC..JFBFBAECGCDHQDEHLAFGOHFC.hAAAeBBDPBAFHAGD.hABASFFGDEHHAHADUEEBhACAMBADKECB.XCCB.....hADA......hAEA...,2,-24,-6,18
QLZCaVDdTOgFPESKHWIAbGceJBUXYNRfM,GAFEeEEGBBHCUGFG..XAFBRACDQFBBZCCE.CEHHDEDGOCAFhAAA.FABESHBGhAAA..KHDGIBAEhABAAGEC.........hABA......hAEA...,1,-26,-42,16
SMeHJaYDgTQNWdBfVZOAKCEURXGPLbIcF,KEHBCFCFUAAFRFDBGBBC..LFEC..ICHHFAHHeAFHhABAJAABDIAG..TDFGhAAAQDACdAECBFBGhACA..ZGDAAEDGPHAGcCDC..MDIFaAFE.hADA......hAGA...,1,-25,-26,1
gZMHQcWadDJOURVLFfSEYBCKbGeXPANTI,TCBCZAADQBFC..aEFGDICAJFGHREEAFGHB..EFBCBFAEhAAACBHAKAFCeACF.AEEE.NDEC.hAAAMDDDHACA.dCAC.hAEAOHBELBHB.SHAC.hABA......hACA...,2,-20,-18,2
GJBLKgPcDbQeMNTEASOFafCZYUIVdRHWX,SEEDOEGHFAED.CGCE.UFDA..IECEdEAFRAAC..HAGFhAAAGBBHBHHHLABChAAAKDDG.PAFEDGAF.hABAQFFGMDAENIBB.AIDCfFAEhAFA.YCHF.hADA...,1,-14,-26,12
LUdWDMQZcNKJOBTYfACHXVgeEbaIFRSPG,CFFCXBBH..eCDDEAEG.aGDBFCFBRAACGBEDUGFC..DAIFMIEChAAAZEDFKHBEBGGH.TEAFhABAABAH...gGAAhADASDAGLDFAQDGANAEF.hBEA......hBFA...,1,-12,-29,17
VIWaOJRceLUNBZYTdgEHQfSKGAPFXbDMC,XGBCMCHF..ICDGaCGA.OGEARBDDLEAE.BBBEhAAATBAGEGGAfEGAhABAKGCDACFHFEECDBGACGEB.JADEhAAA.UDAFNACF.........hAHA......hAIA...,2,-27,-27,0
GTeFWBSCJVYfUgNQKPARdXbDOLIaHMEZc,XCCBDEFHLCBEHAFCEBEEGBAE.FFHHSEAGCFCB.hAAAJGFGfGEBhABAUDGHQAGEAIDGRCECOFABhACAMACA.ZGAAeEEABFDG......hAAA......hABA...,1,2,-23,25
HASfcTRdVEMPGCFeQJLKOYXBWZaNbUDIg,SHBGTCBC.REBH.EECFGBCFFEEDQBGEKAEC.XGGAhAAABBAHZEEC..bGAEhABADGIDHACGAGGBdDGHMDABhACAPDABCHEB.LAAC...YAHDhBCA....hBGA...,2,-21,2,23
XSUIfZATNLCJcaDMFOHGKYEWQbePRdBgV,TDACLAFB.JHBEDFCG.FCHHHDFC.KCDCEGDGQGFAhAAA..PGACdCAH.hABABABE.XGGEhAAAIEBAABBDNICHaEAHMEDGYAHHeAFCgADDhAFA.SFFGhBAA,1,-12,-32,20
PBELRYUGVIfWSJHcMZKNCTeFDbQOaAXdg,dGFCBFDGLAFERAAFGBEF..VBFG..ICCESDBAhAAAJFGFHFABMBAGKDFDCDEF.hAAAeDHHDEAA.OADDhABAADHC..PADA.EGEFYCAD.hACA......hAHA...,1,-14,-25,11
DNCXeJRZacbFKgHQBLMdGWIPESAOYfTVU,OGEATCBC.UAFECEEF...eDCGZEACaADE...FAAFHACEhAAABBHGdDHGGEGEIHBHhABASGAAAIHGVEAEXGDChACA..cGEAKBBD.LAGFhACA....hADA...,1,-7,-28,21
ITXHNefBYdWaEJMFSVbGORQLgPZAKDcCU,KHFGDAEDCDHDUCBB....XGFHHEGBeBFCBFCHdGDA..EEGBhAAAFEEG.SFABhAAAGCAGQDDAhABALABE.gAGDAGFF.IACF.hAFATGDFNECA...hAGA...,2,-24,-23,1
dNUaOTIVYAJbBRGMcLHKZfEXCePQgWSDF,JAFBRDBHMBIFHFFD.KEHHZADG...EFEGeDFCQDFA.SABFhAAADBBFdFABaADGIHGEhADAAIHEBABBGCCEhAAALHAACHEE....PHAE.FAHF.hAEA......hAFA...,1,-15,-22,7
IDEOBgCVNAZPdWcFMQTLGUaXfYSHJeKbR,ZDAGdHBHFDFHMCDELHFEGGAF.UBGG..fFDBHDAEKABCRBBChAAADFHFBEHFCAGH.AGAB.PABDhAAA....hABA.cDGA.aADASEEDbFFH.hAGAIFCC..hAEA...,1,-8,-33,25
VUJRGDTYIQefAXWZSgMCcNLdFHEabKPOB,ZEFHSGFHCDHCLCBGFADFHGAG.EBBFKABGBAABUFAA.RAEC.TEDFhACA..QGDEhAAAAAFEXDGGMBAFhABAdBGBPFHB........hAHA......hAIA...,2,-33,-18,15
VXZJIaAeUcKPCQgBESGdDHTLfYORFNbWM,eDACKGFCCEGB.BHDHGCBCDGABHAAGLAFHOFFH...FFCENEIC.hAAAMFBFZABE..IHAHhABAaDEAADHD..PAFAhAAAEDDEdHDB..fGGB...hACA......hADA...,1,-22,-27,5
cfAKLQZWOESdNFPXMJDIVBTgUHbYeGCaR,KGDDQAEGZFGH.OEHFSAAB.dACFPDEE.XCBHhAAAJDDCDAFFBDBFhAGAUAGC..HACDeBHBCHGHaFFChABA.fHDBAGCBWECG.NCAG...FHAChAHA......hAIA...,2,-40,2,42
QKdSLZPbABTXJUODNEFagMWfVIRCGYecH,XABHJFCA.UAECOAFB.DBBHFGHB.MIDE..fACDhAAAVDAB.CHDHGAGEhABAeEEHHCGB.KDDHhAAAdHFF...........hABA.SAGAhADAZEAFACCBBDDAEHAEaGAH,1,-18,-30,12
EQFWSGMVNgJZDHACbaLTPXReIfOUYBcdK,aEGDLDAC.TFFBXBDH.eFHHIBFHUFBEBABAhAAAKDFAQFDAFFEHGAFEhABAMAFE..NIADZDCAhADAAAADCCHDPBBG.fHBBYAHH..hABA......hACA...,1,-6,-29,23
BZaOCUSfGAMWNFIRdYETegVQPJbDKcHXL,MCCAFHBGdAGA..TCAFeDGH..QCDAJFAB.KDAEHGEGhAAABHHGOCEECBBH.SAFChABAADFE.WFFChACANDIGREBAEAAF.....gGEEhAAAPHBC.DAIF...hADA...,2,-30,-17,13
PWBQbNTCcHOIKeDfZGgadXLUFASEYRMJV,SAFBECFCRBBC.MCDHJEBC...VCEDBGHB.QGFHhAAA..TGGEhAAAHGBAOAFGKBBCDICAfHAHhABA.ZCGBaDAHdDAE....hACA......hADA...,1,-23,-29,6
GMLZBReCdXFPDAQgKfJIbcNYWSaTVOHUE,KGFCJGEA.....IAFE..NACFSDGBaBCH.hAAAOBBBEHBEMEACLFBFhAAABDFDeAHHCDEGXFCHhABADABHAHEHfDHA..bAFA.hACA.WBDG.TEDAhADA..,1,-29,-46,17
EGRBFWHCYONTQUKIVMbagDSdXcPAJfZLe,JFBBZFDFEBEEBAAFHFAB.CBCF.OEDC..QDGDUGGBKAGF.hACAICAA.VFGFhAAAMEAD.aBBFDDDGdHDBhADAXDAEAEGA.fAFB..hABA......hACA...,2,-46,-17,29
aeHZFYdMXLJbDWRAcKIGCQNEUOVBfSTPg,KHBGGGDHQDDBUEGBBCGC..SBAETADA.PFGBhAAAaHGEHCCF.FHACdBHAhABALBAFDCDEAEHGcAFChACAIAGC.CFAB.ODAHfFDF.hADA......hAEA...,2,-31,-9,22
MLAXOGcVYbJZHUPBKgaSWedQTNFICRDfE,XDACGECF..VBFEJAAE.ZDAEHFDGBBCAaDHD..SGEHhAAAdGBATDFAFGABCAGGRCCBDABChAEA.MEHFLHDAhAAAADID...cBDF......hAEA......hAFA...,1,-9,-27,18
QdWNCgMDFRaKbPSfEBOXHeVcLJYUZAGIT,TAGHdGFCCCGD..MCIHRDBGKDHB...SBAAEFBDBFDCHBCGhAAAeFCBLHFG.hABAJFAFYAECAGFCGAEEhAAAIACC.WEEEDABEaFFA...hAIA......hBAA...,1,-7,-41,34
ZcLEWPVHaeJgDRAfdKIXCBSOTGbUYNMFQ,dAFBXGBCBECHOGFEGBBG..UDGFMIDEZAFA.LDEHhAAA.EADBVCAB.HGBEhAAAJHFADBAHRABEKEEDCEAF..hABA............hADA......hAEA...,2,-31,-17,14
bLWKcJPAISTHGURFgQBdZECNMDeVXOaYf,TGBCGBDFUAAF.RDAD.QEFDBGFCdAGF.CCBGMAHBDEDG.VACAhAAAOFAH..YEDHhABALDHFKFAC.hABAPHECAEGDSGDH.....hACA......hAFA...,1,-20,-28,8
PgbeYJZMBLHQUNFaAEVSOWGcTCdRfXIDK,EEHBVDED..OFCDGEAACBFD.dFCA.RBCG.XDAAKHEE...hAAA.PAHFgFEBhAAAeACE.JFAFBHHEQBABhABAFBADAEID..WAFB.....hACA......hADA.fCGFDGGE,2,-22,-11,11
RBYePOCVFdMNHAQKXbEWZJGLafTUcDIgS,QFCAXGBC.EHGAJCBBGAGA.aAAHUADC.DFEGgEGGhABASAGABEEBhACAeDGBODBHFBAGMIFAhAAAACCBKADF...ZAEBfCGB.cFDChABA...IDDFhACA,1,-15,-26,11
McZbaVOgQNTYDdGfAFRHLWeIECXSUKPJB,RBCFHFDFeBHBCHBHUBGF..KCABBCEEMAEAZAAC..VCFFOHFChABAQFCD.TFGFhAAAdEBEfCAAhACA.FFGFIABESDDF...hADA......hAIA...,2,-25,-23,2
UbPfACdXGSHOYDJeWNcVFaQLITRgKMZEB,CFCFXBCBGBACHGEADFGB...JABCeAAC....NDEHFHBGhAAALFDB.RBFAKGBEhAAAZEFCBAGBPDHBdCCASEAEhAEA.OEDAcAFCaGAH.IAFFhAHAMEAF...hAEA...,2,-24,-12,12
YRaJBKZCOMAbGPNUeDEFSTXHcWdVQIfgL,GAFEUCBCDFBASFHFHGDC.dEDGQGAA..IFFFhAAAfDGGgBCGhABALAFGYDAHhACAJABABCHGCHEGAICAbDDBeFBH.FAHFXGGBhAAA.....hADA...,2,-20,-10,10
fLeETOKBDPVUXgSNWFdHGbaRCIJMZcAYQ,QCBCLEEGeAHDODEHDBAG..UGDHXGAG.SFBEhAAANDAH.dAEEbFBFhAAARGEGCCGH.MCADABGFEHGEKABEhAGABCEB..........hABA......hACA.gACH.,1,-15,-24,9
TbMCXFcLQPRJSEaDHVKAGfYdZIWBNUeOg,GAFEdHBHZDCFBAHEeEAHOACG..bEFBCBHBFGGD.LECHhAAAQACDREEH.SBFEhAAAaCCCDEIFKBABACFCIHHEhABA.UEAAMIAE.....hACA......hAEA...,1,-11,-32,21
adVYGSFALgeQfJUWCZDXPRNBKbOcHTIME,LEEGeDACQAABJDBG.UGDHCBABDIACRDFBBGAE..KHDCOEAEhABAHFBEMCABEAHBaADEhADAdBFB.....hAEA............hAGA......hAIA...,2,-45,-21,24
gVKeUcNfHMbaPDGFOIEARJSWXZQTCdLYB,RDEDSDCDZAFG.CBEC.LHDABEGGKGCGUGAA...fCDAhAAAMEIHaCGGDIACOACGhABAAAGA...JBBFQFAChAAAdEGA.gDDG.eABFhABA.NIDB....hAGA...,2,-29,-28,1
eTAZgMNcJOBbFYLaCIPWSGRHQXKdUDfEV,ZFACMCCAJDCGBAGC.FFFALFGD.CABG.ICAA..hAAASAADGEBAQGEChABAdADGUCFEEAHBhACAeDDGAIEG.NAIE..OABCaEHD...WFADhADA......hAEA...,2,-32,-28,4
egONLRQEBMCAKGHcIWXTfSUZYJdPVDbaF,KGFHGEDHHEEA..IGDFXGDHSCCHUAGAZDBHdAEEDBGCFHAChAAAeDDC..gCGDhABANEBE.RADDEBBDhACACDHHAHHATABE..fFAH.hAAA......hABA...,2,-15,-14,1
TXBcOSRIFfEQUGAWYaLgPJMCeZdKHVNDb,aHBGLGEA.JAFCCHHEdHEFHAACDDCC..TCGCBBGF..SGAChAAAFEAEEEEE.UABGhAEAAAAE..gFCFhADAMFAEKBEH.NIEF..XADD..ODGFhAFA.IFFGhAGA...,2,-44,-8,36
DYFGTKLNWcSRAefgUBOJMPbVZQCIaEXdH,eGEAUCBCBHGBOECB..MEFH..bCCEQFAB.hAAAaGDHEEAH.HBGFDEGCFAEFhAAAKBBGWABC..hAFASABAAIHCfHADPAHFCBDB...hAGA......hAHA...,1,-20,-35,15
GFdRJfAQcgeDXEYSNOKUVbHMaBPWCTZIL,QCBCeGEAEABF.SACCKAHBUBDEHCFFBGCDCBDGZEAF.LCCDhAAAGAFCFFGERFCAADAEDFIDhABAXEDH.NAAAOFABhABAMFAF..........hAFA......hAHA...,2,-25,-6,19
efFcHKNRPZAObgCUVDIJdSQLBEXaGWTYM,OGEACFDGDHFG.dAEDLBEEBBHA..aGCH..GDDF..hAAATDCDMCADfDBEhABAFABDHCFHKHEANIED.PDAHhAAAAIBA..gBBGIHAESEHBhABA...hACA...,1,-19,-43,24
gYBONDafIdHRTLcJPSXGUAMEbVKFZQWCe,MHFGECFCKDABFDBD.ZBAAQBBA.CGHD.eFDHBHEGOADEhAAADAFC.aDECdEGFHAGBTEDDhAAALFFA.cGAAhABA..........hACA......hADA...,1,-16,-43,27
TVBZSXOJNFWIYQcKeaUMPHGECfbADgdRL,DGHHdCFCRBCFLAEDBAGFZFGBOAHB.FBAB..IHCB.hAAA.QGCFhABAeBADaAHD.MEEEGEDACDCDADBF.hACATEBFXFFBJFAF....NAAF...hAFA......hBBA...,2,-31,-19,12
aEODTCKWJPfNcZGQBSeYbXAULMdHIgFRV,LAEHdFEFHFAE.FHGAaBAFDFFEKHGE..JDDF....NEBDZAEGBEBFhAAAeDFE..XAGBhABAMIDE.RABFOHDEhADAWHCC....PACFfGCA.hAAA..cCGE.hABASGBFACFE,2,-33,-23,10
fQHJDbTSNVWYeEIXcaCgAFZGBOPURKdLM,FGFHZCBFGBFGOAAB..UEBHRADFdEEA.MIACHBCG.DDIF..SFHBhAAA.NDAG.hABAWCGD.EHCEIHGGhACAaCBC.AHEABBHDPAFA.KGGC.fEEAhABA...hADA...,1,-24,-27,3
dHWBMGUVZDKbTgQecXFOCfEPNSJYRAIaL,LCCHdCFCBEDCMAAFGEEA.UBFBDGFF.KDAG....bDGHTFADhAAA.eCHHFCCBOEAHhABACCAFEABE.SHCAhACA...YBFCAEED.aBBGhADAWHAG....hADA...,1,-28,-32,4
BKFXMGDdIaOVbUcNPSegWHLYERfJTQAZC,BDCFFFAAGBAFDFBBdFCBODDA..VAEAUFGD.....hAAANBHG.PCHH.eGFChABA..WHAELCBChACAEBEE..fDABTDEAAHHACEACMIEAhAAA.IGECcGDCSHAAhADA,1,-23,-43,20
IDVWbYadQLOENeKTGBSAFMUgRHCXJPfZc,MAEDREFHCFDC...XGEBJEBH..ZAEHDABE...VFAE.hAAA.bBAC..aAAHdHDBhABALEHHODBAEAHHhACAKAFCBDBCAHHG.FDDH.......hADA......hAGA...,1,-30,-35,5
XdReUKCZObcAQTSFDMYVEHGIJfgWaLBPN,QFCASFHBMBCAEHGAHEEB.JABB..gCFHhAAALCFANAEHRGBEKFAE.CFDEOHEEhABAABAD.DAEAGDABhAAAfCCCaBFAPADBdCAG.....hACA......hADA...,1,1,-23,24
VYCSecFaKDIRJgGWPTBEdNHXfMQAZLUOb,LBDGUDACOGDGVEDB..CCGA...eAHDFGBBDFEEJEAHGBBChAAA..TDCEhAAABFHEEHGEHACEMDEAABBF.hABA...YDHBSABCKAGA...hACA......hAEA...,1,-17,-32,15
bCYeLPVZXIDQMOaNgWGfRdFcJHBEKUTAS,CFEDeEEGLCAFZAABDAFA..MCCBOCEC..aHEG..gGGEhAAAGBDBdDHAJECDEHBEhAAA.KABEAIGA..SBFEhADAPDFD.IGECWGAC.FEAGBDDChAEA......hAFA...,1,-24,-26,2
dZAaCRIJXSNLMcYUPTFEfbWKOeHGgVDQB,CHCHRFDF..JBHFSGBF.LCBFMBAEUCCHFEHH..EAAH.hAAA.fBFGhABAKEEAHAFF..VGEADFACdHAHhACAAHIDaEDBXDFC..YADFTGFBWFAAhADA....hAEA...,1,-13,-33,20
abQGBJAecWEZfIOgLFCTUVDHPKRXdMSYN,eGEAEHBGZDBDODEHLAACFAAE.UFEDHCFHKAGGRFAAdHAH..SDEAhAEAaDBCGADFAHHF..hAAA.fDHAhADACBFDDCBAMDHF...NEIE.BCCC.....hAFA......hAGA...,1,0,-30,30
RYPAOcFbgUQBdHITGXWNLfCEKJVMSZeaD,FDCDUCBCQACGdBGBHGDAGBDE..XCGGLAADCHEFEAFEhAAAVDGBZEFGDFCDREABAICA.hACA..OBAHgGADhADAIGHGNAEF........hABA......hAEA...,2,-23,-2,21
LBcIVECGAedDJHXFSTfbWKUPNaMORYQZg,DFDCHAEGFDCCTBCH....fGHAKDGGPFDCMAGBRDAGQAAFhABAZFACLAAEhAEABFHGICHDCHCHAHAE.hADAdHAB.SGEG.WBBA.aFGGhAFA......hAHA...,2,-27,-15,12
ITELeVJAOXMWQdYcKHZGDRFafSUPBNCgb,XAFHQFDBdFHEKBEAZFFFRAAE...FEAESDDEUGDD.BBGBhAAACCBA...IEAHhACATADGeDFCAGHDOHEChADAMAAF..YBHB.HGAEDDED.hABA......hACA...,2,-27,-17,10
ITdaXSCfgMHBZAYWVODKNFQeLcJEPUGRb,VAADKEGCQCBA.LFDAEFDFUEAGGACFRAFG.TFAHhAAAaFFHCHAG...fGHChABAMICGBHHAAAIDWCFGhACAODDA.FEHFJHCA.......hAAA......hACA...,2,-28,-8,20
egWNVBMLDXRZbPOHSdTJYCfEcGQKIaAFU,FGDDUDACeHFA....gAACVCAFBBGEDIECREEA.ZGCEOAAEhAAAdDGC..JFCECFBA.EGGDhAAA...GAEChADAKHACAGGBMDDC..LBHB.bBCDSAFFhABAfGAE.hADA...,2,-34,-6,28
UHZEMWXIPfDFVOeNcLJATKdCagRbGBQSY,KFHBdEHACGDGRBFABHEA..QBDHUDDH.ZDBGMDAF..ICHBhAAADECB.FBABOABBhAAAeEFDLAFEhABAADHC.aBGB..gEFHSHFGHGBGhACA.....hACA...,2,-38,-25,13
YXHNEFVUgTJdaPcZQBbLDSORfKIGAWeMC,MDEBXGGGHDFEFGCEUCBC...JACGdBAF.aBDCZGCEBEBDDCFCOAABhABAREFEKCGE.AHAE.CAGD.hAAA.EFAB....hABA.gDDFcGGE......hACA......hADA...,2,-29,-29,0
dSaBMDAeGHLgNCETfbQOXYKZFVIPUcRJW,eEGHGGDHHAFELCGDCACB.TADGQFCHOGBGXAADhAAAZCBDFBAD.IHAAhAEA.UDEEcDDA.hAFA............hAHA......hAIA...,2,-18,-18,0
EPBFNJfWMODQRYdHACcVXbaeZgISLTGUK,VDBHaGFCZDAF....SFFEGDCHUABCKAGEBACGJAHF.MGDAhAAADIAE...RBDGdBAEhABACFDD....bAEB.hADAeFFGIHHF.EGBBNIEB.OHDA.hAAA......hAIA...,1,-20,-26,6
QUJZXSFKYGaPAOHdgRNWbLEBCITeMfcDV,ODCHHDAGdGGDRAFC...bADBEGHH.BAACCAHC...eFEDMBGFDICAhACAUFBD.XBBAhAAAKFGCaAEBAGGB..WEEHhABAIGAF.fDGB...hACAcBBFJCHF.SDAFhADA,2,-29,-24,5
TCAOWXUcDEBbGVFeZIgMRdJQYaPfLHSKN,ODACXCGCUDDCDCBC.BDHFGDEG.eAEFZGBEMICA.dHGFhAAAQFCD.hABAaEAAfBFGhACASGHDKFGANAAFCBGBABBHEFAG.FADG...IAGChAIA....hBAA...,2,-27,-17,10
YfNVWIceACagPBTbDMKdZFHELGXRJQOUS,aEGDBFDG.DGHFdDBGHAFGEFCA.GBBB.RCFF.JAAGUEAD..fGAGhAAA.VAEFhAEAWFFD..IHHBhAGAAEHACABD...PFEFMACA.KDCG..hAHA......hAIA...,1,-28,-33,5
UbDLYKZgRCXMcGdeNAHTJVaOEfWFIQPSB,TBDGJDCH..OAACEABD..FDBHQAEDBFDGUBGEDHBEKHGEhAAARFGD...CCACMEABhACAdHEBADDC.HEEAaCAB...hAAAfHAFIAHCSEEG.hADAYDAB..hACA...,1,-17,-40,23
JgKbLBVaGMEWCXdFcAIQeDHUPRZOYSNfT,QDACDAADUAGCZFAFOAHF..SADCTCDA.KEDBbFFAhAAA.BGBFGCDFMACBhABACHEF.FHFAACBC..HFGBhABARDFG.....fBDFgFCB.hACA......hBBA...,1,-7,-35,28
XWfVZSYNTKLCQRJeBUaGIdbEDOgPHcAFM,MAEDXCBC..VGDESAGF..NCGGLBHFhAAAREDCBACCaGGGdABEDIBEOGAAhADAHCGBAAEDFDBF..fFAGhAAAYHAACHHEeAEHUDDF.....hABA......hAIA...,1,-9,-26,17
QVPMDGeBKREgIfSYTbAOCHUJFXdWcaLZN,OFCACFFCHAECFHEAdBEA....aGBDLCAGZBAC..QGGGhAAAMFABDEFGBBBEKBHFEDBFhABAfECHTGEAADIHXDEAhACA.NAED.......hADA......hBBA...,1,-13,-42,29
HSPXKFJQOWfNCgTZaVYecALRUEDGBIdbM,RAEGDDFFBGFDdBGGHAAF..XBDCFFGAJADE.QDFH.hAAAOBAFNHCD.CABBZEAAhAAAVDCH..eHAG.hACAAADEUGGCEHAE.........hADA......hAHA...,1,-18,-34,16
eMgWHXYdScEZafOQLTPUNAVDbCFIBJKRG,DHCEFEGDBEDFRDABGCDF..eBFHMFHBHCBH.dACHEADEZFBE.aHDAhAAAfBBF.hABAOAFG.QEEBhAAALAHB.........hADA......hAFA...,1,-21,-30,9
eETMFfVCgLAGQHZbYJUIDWKPdaBNScRXO,QCCFHGFGZDDHJAFADAAH.KGECdDFG.BFCHSEAARDAG.OAEGhABATADG.FCHFCDADLDFChACA.ABBEbFCDhADAIBBH.aHECNEHE....XAGAhBDAMAAC....hBEA...,2,-24,-20,4
NfSFXZDdVIOcaYAUeWMHbEgBTCJLKQPRG,UDACMDEBHDFEEGECBAHCCAGGLGCG.KDAARCGBGACF.SEEFhAAAZABADFAGIGHFhAAAOGAE...YAHBhACAACIHeDCC...WHAG....hADA......hAEA...,1,-26,-28,2
dZVCOaGJEQBNbAXcUKLIeHSTFDgWfMRYP,XCGCKGFCLFEFHBACFGCBDGHF.....fADBhAAARAAGdAGECFHBGDEBJDEBBBHAADDCUADEhAAAIFAD.SHAGhABA.WFCBMAIF.YCABhACA.....hACA...,2,-34,-21,13
YQKTJGCIVbXSMLDfWPaNARdOcFgHBZeUE,RDEDOCCHFBCHBBFDUBFG...QFCHJBHH.CFHB...IADGhAAAXEEBLCADhABADBBC..WAAChAEAaGGBAAGFdGAE.HGFEeFAAEBDFKGDD....hACA......hAFA...,2,-40,-15,25
VbeCNEZRWDacGPMFAXUQBKTfISLgJOHYd,QCCBBFCFKBFH...IFAGSADHLFCEJHCCHFFAhAAAVEGF.CHAF.EDAAZAAGDCAGhABAaAEEGDDFFGDFAEAG.XGADhACA.fAHA...hAAA......hABA...,2,-22,-20,2
MKcTBbCGgUZDPQJWSYeFNLdOAXIERHVaf,EGFCHBDB.aGCDMDDDKDBGBAGFGCAG.ZAFEDBHDJCGB..SGEEhAAAFABELHAAAFABRBAA..hAAA...fCDBhABAcFADCEHE..PFHHYFED..dADBhABAIHHG..hAEA...,2,-21,-17,4
LEbgIKBWHfcUJReQSNXPDOACaMFGTVYZd,MAEEGBDB..VFFFdEEFLABC.bGDEKCBA.BBEEHDBFhAAAfBGA.hAFAJECE...QGBEhAAANIBBDAIDAGDCCDDFaGACFDHFYCAF.EABAhABA......hAIA...,2,-30,-13,17
cRdgGOUHEeIZATMVaQJFWPYbXKNSLBfCD,TFCAaAAB..QDAAJEHF.FFGE..PDEGXADFhACAKADDLABDCHDGREEF.hAGAdAFAgBGHhAHAOEAGEFFDeCCGAHBEMBIH...WHCA..hAAA......hAEA...,2,-23,-15,8
PfIFADTeQMBJYVHKRbZENOUgCcSGdaWXL,DECDTDCHMBDG.BDDBJFBD..HBACREFAZBCCOFHD..CHHG.GBFGhAAAdGDB.aAEHXBGAhAAAfHFD.IAHFhABAACAHeFAD.YFEDKHDAEDFA..NABF..hACA......hADA...,2,-26,-15,11
PBWaAgHKcIbZeTUfMLGXJRVOECFNSdDYQ,HDAGKHBG...IHGHeAFCUCAFLGAGJBHD.RABEEHDAFHGE.SBGChAAADEEF.PFFEhABABDFCaFFA.AEIH.hAAAbDFAZABEMAFA.XDDFOFACCECA..hABA......hACA...,1,8,-35,43
eBMJYAEZIKRVadQFbfNWCGXHUSTgPLODc,ECFCZDAGKACBRBBC.dEGFFFFA......NDFE.CBFCHEAF.TDDEhAAALHBEDCAHBHHEhABAMAHFAICG...IFBGhAAAQGEC.fDHEXBAGUGGChABA.....hACA...,2,-31,-31,0
MUNHfaGdgLbTKYASXCDWFVeORIEcBPZQJ,SFFBXFCADHGAFDAF...ODDBIECDEAFE..BHGHhAAAZFAHMIFEUACHHCGBhABAfBAFdHAB.gAGDhAAATCEGAIDACFHAWCCC...eFFA.hADAPDDA.NABF..hAHA...,2,-17,-15,2
MGSNAOeDfPdXLbWBYVJZRHgKUFcECQIaT,eBFDDACBdGHALBBEBEDC.JDHBREFAHCFE.KAFDUEAH.EGFBCAHB.hAAAQGCA.hABATCCEMEBHNICHACAF..hADA.ODBG.....fFEEhAEAXBGB....hAGA...,1,-20,-35,15
CBIfATOdgcRSEZPGWFYLQJNXHeMaUKbVD,TGGDdDCDRAEAZEAC.GEFGFFAALFFC.QCCDXACFMAIFhAAAKAGDDBDEBBBBAEFAOAAHhABA...SHEGhACAEDHDYHCEJBHBeHAA...hABA......hAFA...,1,-9,-25,16
TGWOgUPACEQXDdZFJSRINHKfYVLMcbeBa,CFCFEEHBDGHFdHAD.ZGDAFACD..RADAHCAFKFEE...VDDFMBHHeAAFhAAABCAE.GAEEOCFGhACA....UGEBhAAAAGGC.XGBA.SEBFIHHA.hADANBIC......hAEA...,2,-37,-11,26
fRFPIaCgTJcLeMUdOYABDVZNSKXQWHbEG,BFCFZBCFSCFHKACG..XBBCQGAGHFDAGFDFhAAARAFGFDHH.IAHHCDDD.hAAAgCAHTCECLEABhABAMFAAOADGAHHGDIDG.NDIC.....hABA......hACA...,2,-21,-12,9
NMbOIWRADFEKaJXgQPBfVLTeYUSHdCGZc,EGCDKEED..aGAEJFFF..QFGEBEHGLAACeEAA.UAGBdAGECCDGhAAAGADEZACE.MDDDhAFAIHEE.AEAADBADhABAFBBB...XDGCfHAD...hACA......hADA...,2,-28,-23,5
YcNbTHIfQPRSUgJWMVCDeZEdLGaFBKAXO,XDACOGEA....NAFE.TBCGHEADQBAH.hAAASCHHgBFGhABAJDDDMEGFCHCADIFCEGACdAGAhAAAaAGGBABBYFED......hACA.IFHE.hADA...,1,-17,-23,6
dZCeKQGTRWSLDFMEABJOVaNUHcXPgYIfb,BECDVFBG.aHACHACG...XFFA..PBAEIEEAhAAAfGGH.hABAdDEGCDADKAHBQAGChAAAGAFEWCAEDGECEFABAIEANDIAUDGC....hABA.cADA..hACA...,2,-31,-8,23
ECIHAfLKOaSWgNTcXYGZJbUFePMVRQdDB,KDCDOEGH..aDHBSCAB..NGEB.XDGBZAAGUGBAhAAAFADC.eFAFMAECVECAhAAARBEEdEEBDCEEBCAHCCDGAHBDLHCEhABA........hACA......hAFA...,2,-35,-20,15
HKSTJfEeFbdXNUMZVcQgLOaPACYIGDWRB,CFDGGAFEDCBH.RECDKEEH..JAFGeADD.FCBHdCDG.UFFAMHEGZBFEhAAAQFAC.hABA...OEABhACAAHIFIABHBBBE.........hADA.SHEGhAEAECHFNAAE...,2,-51,-16,35
GTPdZLFJcUIKYQeNDAOHafgRWCbMBSEVX,ODCHHDAGaACDRAFC.CAHD.BCHD..EGCCGGEFdHEDFBABUEFB.KDDEhAAAQDFD.hABADAAEfEAGhACAbFADMGFGSDDBTACEZGAE.cAFC..hAEA......hAGA...,2,-18,-12,6
RbcNFZfWADPLECIOTdVJBMgXQGKHaYeUS,DEFHEDCD.CGGD.OBCE.dEHCJEBBBFEB..MAFAQGCEhAAAGCCFHBAEeFAHRAGB..hABANDAA.fDAAhACA.AADCPDDAIFHHTGFHgFCHhAAA.aBEA.SHDAhABA.,2,-38,-1,37
SNWDCKUAgVZBOHMGLTcbEYeXIFJPRfadQ,VGFGZFEEBHCH.HBAALCFG.TGBGbAEE..EDGHeCDHhAAAFECFRCDCaDAF..dEAGSAEChABADBIDCABB.KABGhADAAHHFMADEcFEB.IBGE...hAAA......hAIA...,1,-10,-18,8
IGSWJTBCFDbNaVQLAgHXYKfRUPZedEcMO,XFDHKHBGRDBDZADD.dBFH..EEGBMICC.GDGASAGB.hAAA.WCBCBDGBCACCFDDEhABADAIBaFEDLEBDHAAAUGGFhAAA.eDEF.OCAB...hAEA......hAFA...,2,-25,-8,17
GRTBOIAaHWeXNYFUCDLbSKgZdfEMcPVQJ,aCFCHFDF.eCCC.XGGGFCAGDFBFSHGAKFBFdADH.EAAGMDFBhAAA...cDGGhABAPAEE..QAGFhACARCDDBFHDACGEYFFDCBBC.LHAAhACA.....hAEA...,2,-24,-16,8
YFUBEKgTRXaZDJLfOQVASHeGCNcPIMbWd,SDBDHFBHCCCD....NBBD.IGHFMGFC.dAFCFHDAEDGAKEEDhAAARACHZGDALAFB.hAAAOEABAHCFeECGPBHFhABA...........hABA.YEAFBHAH.hACA...,1,-23,-26,3
IgZQfaBOKbUCYdWGLSMRNHTDEPXFeAVcJ,VFDFJGEAZCAF..QFADBAAE.KDCECHED..dAGALAABhACA.SCFChADAMDADRDCGHDGFEGHBFAEA.AGGFgDFFhAHAfGBHaCDA.....hAIA......hBAA...,1,-17,-35,18
HWTIFBCGMYVRPXLQZDKOgcfbJNeSaUdAE,ECFCTFDHBAFB.GGEBMBAA..RFFFLAHBDDIHOEAF..gCCDhAAA.bGAChABAeDDH.UABDABFBIDFGhACACAHE.VDAH......hADA......hAEA...,2,-40,-10,30
DCWBcReGMgfXOJQbVaHEIdYPNTUKSZFAL,CGHDBFDGRGDA.MFAD..XDFBJACC..QGEHaGBG.hAAAHCCAEDADdBDB.NABB.hAGAKHBEZCBALAAHhAFA.DBIHWHAGcCGH.eFFG...hAHA.fECBhAIA...,2,-33,-18,15
RIJgQHKWYaEebAXLVBZScGOTCUfdPNFMD,LADGBEGHSFEHOHAGUGEGdBCHFCFCDCDA..RCAG..JHAEQBGHhAAA.KBAHhABAaGGEEDFDAABH.ZEAETAGFhAAACEHF...NIEH.IGHF..WFBChACA.....hACA...,1,-28,-31,3
ULWRCKOIQTYdebNZaDAMPfEXVSJBGcgHF,MCCAEHBG..SFFDBHAAGCAEHDFDFCHBLCFCCGHD.OBAAhAAAQDDATEBGhABAdAFDNAEAaHFEAFID.XCAChACAJGDE..gAAC...hADA......hAFA...,2,-30,-5,25
LdAQEGPURJcNFMXHbDYaeBTKCVgZfSIOW,ECBBUAGHRCFA...JCDFFACFHGDCDFCB...eFBDBHGDKCBDCHHBZAEE.hAAA.SEGFhABA..IEHEhAAA.OFEHWAEBAGIBQDDDcACA.XGADhABA.aFAB.hAHA...,1,-28,-39,11
LOeRKBJMIfWbcVDdZEGQNFCUXaHYASgPT,SHBGTCBC.OEEFKFAFMHEA..IGGF..hAAAfBHCbABF.hAEADEEGdGCDZFCHQDGAhAFACBEGXBFBYBEEAGIHPABAeBDD.BCFAhAGAWEFA.EHAA..hAAA...,1,-4,-35,31
BbZJGcPAQfEOdXHDYeRKLVICMUaWNSFTg,EGFCdAADDBGERAAB.KADFLDFC..CDFHUFBDaHEC..SEDGhAAAFHGE.BGCAZCCE.hABAJACE...PBFEhACAAAGE.OFBBXFFB.eEEDIEGEhAGAMICE....NEAE.hAEA...,1,-15,-43,28
SIKQZJYLONagCHUPTDdBcefFMVbERXAWG,SGAHQGBCJCCGLDEH.aGGACHFDHBFB.UCAGDHCAdACGhAAABGGBeDBDMFFAVAFDhABAEAAE..AAGC.IHFEhAEAKADEOBHF.NEEE.gDGF.hACA......hAIA...,1,-14,-19,5
LMBRJINDFVQfSKbUgdOACHYZEPeTaXGWc,HDBHZDAGeABHaAGD.GADCLFDGBBGAJACADEGGFGHF..QFEChAAAKAAA.UGAEOEFAhAAAAIGG.CGAEEHDA..hAFA.XDDB.MCCE....hAGA......hAIA...,1,-15,-31,16
aCZVSHcdgBDTUKOLNGFRJWQYeIPMbfEAX,XGAFCHCHZEFCHADAdBAADFAG..UACFLDDDGBFGFCBHRFCFQFGEhAAAeBHB.MAFEhABAfAAA.AHIHSHEGhAAABHEGODCE......hADA......hBFA...,1,-14,-23,9
FWOIVKeBfcNdEGQYXPZgLAMUbRTCaSHJD,UFDBTFDHCCHB..HDBDFCDD..OABDKHBABAEA....cCGBhAAAdAAFGBBB.hABAXEFBgFAAhADAMIFAaHGADEAFIBFB.eDFD.NIDBEADFhAFAPEHFAAIF.SBGDhADA,1,-23,-24,1
GBafDVHLMKYTCPZdXeIEJQScAFUbRWNOg,UGBCRAADOAEGBDBB.DABELDCG.MHBCTAFGZDGFdFFC.hAAA.eDFDEBGCSFCAhAAAAAEBFBCF.NICB.aHEAhAFA...fDHAKACACHHG.IEDGhAHA.....hACA...,2,-36,-19,17
bDMXVGHTNFWdgIeZKBASUEYaCfcORLJQP,UFCEEAFB.CHBG.OBBELADAQGFH.DEABVCBAHEBHFHGAhAAAdEFF.IHDAhAAAKAHFAEAC.SEDBhABA.fBHAcCGCRFEA......hACA......hADA...,2,-34,-17,17
eBOHZbCWVJQLdNSaFUcKYTgGAXPREfIDM,REFHEHBGDBGHBHFDZAAG...CACG...JGAAdCDA.aEAEUDCF..KGDChAAA...TAEChABAAAEB..fHGFhAAAeFFEODFC.HAGBWCCE...LAHBhABA....hACA.SHCAcGGH,2,-38,-21,17
MSTafBVWDgcCINUFZEHKJPYdGXbRQeLOA,SAGDaGFCBDFB.DBAGCDBF...UEFCEBCCHFBCKHFE..JCDCdEADhAAAGEAGXAGCQCADhAAAOHACAAHEMEEFhABA..TDDC.fFFD.hACAWABC.ICHFhAFANDDG..,2,-32,-16,16
LWQKeGZURATHPOFCaNMdYcSXEJVgfbBID,HEFHFDCDCADE.aCAC.MFBGdEEG....SCCCJHDA..gAEAhAAABDHCDHFELAAFhACAKDECeBHFZDAEAGAEOBFEhAFANDIG..cABE.EHAEfHAFhAGA.WHFA.hABA...,1,-12,-43,31
FEfNBJDCHWgISXGedLZbVKMAQTaYRPUcO,QFCAaGFC.RAACUGEGOAED.EEFGBDCFDDAGHDCB..hAAAgDEBXBGCeEBDhABALBHHVABAKGAHhAAAAHBH.TBFD.PADAfHDBCHGB.hABA......hAHA...,2,-19,-10,9
NEZcJOQbVfBIULTFeYaDKGMSgRXWPCdAH,HDAGECFCZBBCJGEC..OACEQACG..fGHChAAAIEEDTAFFeCABDFFAKCGHhAAAGGAHSHAChABAgGEB.XDDCCFAGAFIHNIDB....hABA......hACA...,1,-13,-20,7
GRcQVLeFABZJHCbOPdDNMXWISEaKfTYUg,BEFAZDBGCCCG.OHDAdDHE.DDBCMFAH....IBGHSFDHhAAAECEF.aDFH.KGBBfABGhAAAUADH.RFGDQGAFhACA.LEAAAGIBJHEE..hADA......hAEA...,1,-32,-34,2
fUXEgMbZSWAOVKDHJNFedGLYcTPIQCRaB,ODCHKGGEDAAAHCEEFAHHGBDGLDAF..TEGDQBCBhADAaABF.BHCEUGEAEEFCMBGDhAAASFBEADAH.hADANBIE....YEEFIGACCHAB...hAEA......hAFA...,1,-22,-23,1
AHGSFeLRNXQdOCTbWMDBaJcKgYVfIPEZU,GBCHSEEDFFEHeAGBLDAA.XCFDdDFCOFAC.CCAE.hAAAbGBCDIBCBHHE.aBBGhAAAJDHBKHFA..VDBAhABAIFHGEGGB.ABAHHAGD.....hACA......hADA...,2,-19,-12,7
TNXIOURgbcLeKYAWGVHPEQBZdDfCJFMSa,GEDHVGFG.ECCFBGABZABCDDEE..CCCEMEEGaBHD....TAFChAAAXADFUFACRDBB.hAAA..bGEEeHBAAEGC.hACA..PBFG.fBAA.hADA......hAEA...,1,-18,-28,10
TNdCOQWIAFMSBVXPgfYHDKbZcUGEeRJLa,SHBGBFFC..XCEE..fFCCDGIHZGBEUEAChAAAEDDEJADEaGGBdDCACCADOCBGhAAA.QGFEhABAAADGFBACMBDAVBFH..PAHFYEHHhACA......hADA...,1,-22,-29,7
cNfXICJAQabeWMTPFRgGEUBVKDOdSLYHZ,aGFCeGEA.MDCCFEEERABDGAEF.BAACKBFBDCHHODEELADBhAAAZDAH.....NDBC.hABAIBBCAAFC.WFCBhACAPFDBEHAA.........hADA......hAEA...,2,-38,-26,12
SYVHMdDKOIURcZFaeXEBbPNGAWJfCLgQT,JGEACAFBLFEC..TBFFSEAEHACDDBADKACD..OHAChAAAIAHBUGGFRCDFFFBDhAAAaCHB...eDHDBGCChABANICB.AEEA...fEACQBDA.MDAEhADA.....hABA...,2,-26,-22,4
ObNTFaPZJBEGWCeVgMYHRIcSULKXDQAdf,OCCHTCBC.FGFAZFGDBAHEGABF.CGFF.eFAG..MIAEHBDHhAAARECASCGFhAAAKEGGDHBGAIGCdADF..NHABaCAHPBABhABAJAFA...EAGB.....WFDBhACA......hBBA...,2,-28,-8,20
PdaJZTOWLCSEgKUDXYBIfAQMbcHNReGVF,MFFFHAADeEAAGCEHVCGHdEAGZGBE..TEDHLBFE.SBCHhAAAgGCBKGGGhABADGGABBBDfADChAAAAIGCQECBbGFCcBEE.....hACA.NADF.....hAIA...,2,-15,5,20
fIJTbPGEDcLYAXVHKOWZedBUFNMCQRSag,VABHHDEDOCCB.eEAFBCFFUAEFMIDARAAH...SFBBhAAAaCGE..gFCChAAAIAGFTEDDhABAPHFADIBELGFEAIEAKEHF.dDGG.CAEAfDAChADA...hACA...,2,-22,-12,10
YNdIERCZLMTDPFAXcHaWUfbVeJOgBKGSQ,HEFHUGBC.VCCFOCCBKHAE.GDFG.QACENBEF.EFDGhAAACAAEMFID.DDGAAEBBXAGBhABA.WAEHhACAbCAHeHCC.BACFYFHB.IDHFhBAA...hAEA...,2,-28,-9,19
NLVQXOabUeGIFgBMPWJdCcDZTYSRKHEAf,LGEAQDCBaAAFeHAGGCAFFFFDBAGCMAHF...JACCdFAECGCH.hAAAZBED.SDHHhACARBGHEHGC.AIGA..NCGA.OABHhAFA..........hAIA......hBAA...,1,-18,-28,10
NRYLMGKEbSHVPIeXaJTWBFODUQAgCfZcd,CFDGZAADdCABRDCCLAHHGABF.KFHHEGFC.HDDC..IFAChAAAaEABJHCA.BCCE.OEFFhADADGIHADDA...fHCFhAEAYFABbCGBVAEG......hBAA......hBCA...,1,-14,-27,13
fMEUCFbSWORQdJcKITaNZBALVDYPgXHGe,VAADDACB....PEAEHDCCeAHH.EAGHFGEE..SHEEhAAARCDCJHBAKBAD.aGAEBAHDhAAAAADBLDFB.hABAXEACMEFCCCGBOHFE.dAEFIBEGhACA....hAEA...,1,-16,-33,17
VIQBOKbHfaeLdgTScYMNEJAWUCRFXGPDZ,CHHGXCCBGFBBZCBC..QDGHBHABOAABKCEAHCAH.hABAfHBHaAFGdEFB.hACASAHFMCFCJEAEACCAhADAUFFD.FACEDAEBIAFDeHDC...hAIA......hBCA...,2,-20,-8,12
SPWOYUDNEFJCHgfXRebdLBcGVaTKZIAQM,MBDHSHBG.OEFHUFGGDBIH.EEBDFCCBHAEB..fFCBhAAAeEECdBGEBGAAhAAA..cADChABAaDAGKABBIFAHAAGE.WDEE.NIEBCGHE..hACA......hAEA...,1,-23,-39,16
QLbdPSWZABcDYNKFOVgEfIeJMaCXHGTRU,BAEDDACBKGHBFDGC..OEDHEDBD..eGFGMDAF..CFADHCCHhAAAGCFERGAALFEChABAdBHASGAHAAID...hACANDBB.gABA.fBFFhAFAIBAHaHCE....hAAA...,1,-12,-43,31
UQKBgeZTSNGIHMdWPRECAcXabLYVDOJfF,aGFCLGEA.DEFFJFCFUAEEKECC.BHBAZAAC....SEAHhABAIDHG.MIEEdCBD.hAAAREFAAAIH..XAGEhABAVAEC.FEBFeCAGTABC.....hACA......hADA...,1,-24,-33,9
CgYbVFRHGUTKPMDZcAJIWBEOadNXSfQLe,JGEABFDG.EEAGdCCG..SFEHLAHDeDDECAGC....hAAAgDEEVFBBFABC.hADAGBABTAEFMCIHhAAADIGEABIHIHCE..WEEGNBHAQGGEhABA....hACA...,1,-24,-27,3
IBETQcHMXFgeKUSdPVfOWCaDNLAbRGJYZ,REBHJFEFZCDFBBHC..TEGHHCCCFGBA..eAFFUABHdAHE.VAAChAAAOFAH.CGGF.aHBChADALCFBAAEC..hAAAGGEBEAEE..MCIF.KEBASGDChBEA....hBHA...,1,-12,-24,12
beWFDGKOdfTCXQHSEUBRIMVgcJaNLZAYP,...PFBBbFDFeFAGDFFC.GACB.KAAHdFDE.TADECDCGXAGFhAAASCBF.hACAEGGGBFHDRAGB.MBIDhADA.cCFANCAEAEDAYDDC.FAAAfGFChAFA...hADA...,1,-10,-25,15
CXHdeZcVRYKFUMPWOBbfQSJNLTaEgIDGA,CFFCdDAFZBAERFABFHEE..UCEC..MDEGOFACBHHE..QGDDhAAAJEFALAFC.hABA.EGGB.DAEEAABG.eBHFhACAVECB.KBBEWAEA..SBEGhAAA..aDDB..hADA...,2,-34,-29,5
DXcVWfCdQIYGSKNHJgFBbRPaZTOeALEMU,MEGFDFEE..XGGDVCAC...CADEdECAQFADGGCHSBFGhAAAKAAFJAEHBBHARBBAZFABhABAOEDHAAGG.EEHB.hACA...WEEE.......hABA......hACA...,2,-36,-19,17
HTAcaebVfOBJYgZCGWKQXUSPIEDFNRdLM,eCCHVAAD.BEHC..JEEBZFCBGBGGKBAEQBFCUFBA..hAAASDAGEGGCFGAEdGEEhABAMFABABEH..aAGAfGFChAAA.gCDFCEAG..hACA......hADA...,1,-23,-30,7
KLCEAVMZNBceQOGIDFJYPSRgaXHdUfTbW,ZFBGBFDGQFFAOFGHGACBFAGH..JBAGSCGC.hAAAaHAAdEDB.TBDEhABAKDEHECAAMFID.NIDH.eDHHhAAADIAA....PDAG....hACA......hADA...,1,-21,-30,9
fQVdNTUJOPDZAKGYcFbELeHCMRBgIWSaX,GEAHFHBGEBGG.eABGHCFECCCEBHFD..IECASGGCXGGEhAAAQGCH.hABAdBGFTBCD.ODAHhACADGABAHHAKAECcEEFbDEE......hADA......hAEA...,1,-18,-23,5
XGJHIUfdaVPeTAWZYbMBCDRQgFOKEcNSL,ZAADMCCADCFBRAGF.FGCEKEFG....EBHB..NEIG.SCBHhAAALFBGGDAFHFFCfECHhADAaBBG.PHEEhAEAAAFC..WHEABEFHCAAC......hAFA.OFBB..hAGA...,1,-24,-28,4
PIHKYdOJSDGZWRLCbNfXgFUBaMcVETAQe,QDACeGEAHCADKAFCdGEBOEDGDCFAZACHLEEGCDHA..fBBFhAAAFHBABAACMBIDhAEAVAECAHCH...IHAChABA.SCFA.WHFAhACA......hADA...,2,-32,-27,5
ZNTVaFCBHDYIQgcAeUObfJXSEWMdLKRGP,eFCAUDACOGDG..JBAHEHGEdBFCRCEH.ZGFA...TDCGhAAAFBCABHACDBHF.QAGGhAAAAEID..bFAFfFHGhABASAECMCIF.....hABA......hACA...,2,-35,-24,11
MgNaQcObVWXELJfATePFRKCBHZdISYDGU,TDACFDCDKCAAHAFG.dEAESEEDGEDAUACHMAHB.aGCDQFFChAAAOADHVGFAhAAAXGAEEBAA..fGABhABAAIFG.PAFBBDHC.ZDFE.DAIFhACA......hAEA...,1,-6,-13,7
IZOWHPcCUYGeMXFdDQEfTJLKBRVabNSAg,ZAADOFBBHDCC.CEHFGGCHXCBD.DGGEQBFF.TACGhAAAKEFABCFA.aEEBhAAA.SBBFhABAIFFFcGABeHEGFADGEEAEJAFE.....hAEA......hAFA...,1,-14,-28,14
bLYVGafOBECHMSAQTIJDPNgUXKFWZeRdc,QCGCTDAC.JDEDDCGC...NBAF.UCAB.KGHDZECBdHBBLGEAhAAAGABFaAGGBCDAhABA.EHAGCDDC.MACASFAAhAAAAFCBIEFE.gAFC.hABA......hACA...,2,-28,-19,9
LHTMdIDebGUPKSaYVgFXRNBACOQWEJZfc,OEBEEGFCZDAFLAFAHBGFdCBCDBBAGBCCKGFF.aACA....VGBAhAAAXCEFBFFBAABCCHDHQEEBhAAA.hADAWHACcCDH.MAEAIBBH..hABA......hAGA...,2,-27,-14,13
aXBDMAVJdPRTYNCgSfGHLOeQbWKEUFcIZ,VDEDdDCDRAEA....TGEBCBHC..SEHBHAAHeHAAQAEFhAAAKHGAECFH.FBADIEGDhAAAXFAHDADHAGHHJDCFhABANFAB...fCCB.LHDEhACA....hADA...,2,-27,-13,14
WHNTAZgcPSCBFUOXeIGbKJfaLQVRYMDEd,ZAAD..gDACSDCACEFF.FAGEOHFAeHFAGGCB.hAAAJFFEfAGHhABALDFCRFAHDDIBEACFdGAA.WDDHhACANCDF.ADFCBFGB.IHCEaAEG..hADA.QBCFhAEA.MCFE.,1,1,-14,15
dZQcXDSLaPCRgHbUKMONWJEFVATeBIGfY,eGFABECDGGCHdAGDZAAF.QGGCDACBLEDGCBEDHDDEKADE.OCGFhAAA..NIEHEGCAAEAHTBAGhABA..ICFHhAHAfGAC.XAGEaCEH...hBAA......hBDA...,2,-30,-9,21
ZKYJITfaVWLeGMFOCQHXNESdbBARUPgcD,UFDH..PDACDIGEKDACJFFB....TCGAaAGBLACGhAAAGAEG.OEHBHAAAXCCDhAAASHBABAGDhACAAADCRDDFZCFAIGHE.fHABhADAeBAG......hAEA...,2,-27,-11,16
TgcBOJfVDdZaYRbEXMFeIPNWSUQGKCLHA,TCBCBFDGOCFE..JDGHDEBBdFCBZEFARGBA...ECCEMFFHFAEA.hAAAeAAE..NIEF.UGGBhADA.QAGBhAEACECCLGCGAIDEfAEA..aCAC.hAHAbABC.IGGEhACA.SHAG.,1,-7,-25,18
IMaGAfKTHYNLBJPdZOXbWRVQUDSeFgcCE,TGBCHAADLHFA.BCGGJCBFdEDFXGAH.REEEQADAhAAADGHDSAFHeFDBhACA..FACFCDEFMDIFhADAAHABYEGDNCCE.........hAGA......hAHA...,2,-44,-7,37
aIEFHeRYQZcLSVXfCOTUWMADGJNdgbPKB,DCIHJFEF.dEBG......bDAEPFEBBBHH.EACGHBBA..hAAAeCDARCFHZGAASHGAhAAAfADHTBBHhABAUGGCADACgDGDKFBA.FAFC....hAEA......hAHA.cFFA.,1,-12,-17,5
fWZHEOcSIdeXbQBaKVCUgNLDPGJARMTFY,RFEETAGDFCCF......fCEAZBAAODEG.IADEhAAAXEAGBFCHKGBCCBAGNEIEDECEhABA..JBHFAHGEMFFHhACA.HGAAEADDSFHBdEGA..hAAA......hABA...,2,-40,-11,29
XNOQHUTRFCeKYdGVAEbPJSDIaZWfMBgLc,EHBGJGEA.DAFEZCAF..MEFFBDDA.LDFE..NAIEHEAAhAAARAEGCHCE.KACBdABDAHGFSBAHhABA.IGDEhACAfGAG..cCCDOCCG..hAAA......hACA...,1,-27,-44,17
VEfPXUAIQGDbeJKRLNCFgSZYBOdacTHWM,QFGHGDCCDGEDeBFERDFCLFCD.CAHD.SEBFBAAHdACC.hAAAaGGCHFDFMAEHEAFBXAAChABAAEBH..IDDDhAEAKCGDNDAE.FGAF.......hACA......hADA...,1,-10,-27,17
ZAXENYGIUcbaKgHDSPBTMCdFWQRLfJVOe,EGFCGAFEUBDDaDCDHCFBDAAC.BAGA..MFFEdBBAQEBChAAARFAGLBBHJFEFOHCEAIHA.hADAXGAC.NBIA.hABAIGGAKEED.SAHBCCAF.WBDBhAEA.....hACA...,1,-12,-21,9
OJSQHUDCIXTeNAGcFfWgRZYbLMKPdaVBE,FGAH..gGBCRGFEZDCHLDHFKEBFdAECBABGOFGB.SGEDhAAAHAEHUCACCDEA.XGCChAAAeBAHAFHAGAGEhABA..fBGFYACH....hACA......hADA...,2,-25,-12,13
eJYVObSXPRNWICQdDBUFAKLHMacfgTGEZ,KDBDMAGD..aAFE..fHADGEEAZACBeFDCJCHD..OFABhAAAXCGH.PFAGhAAARFCB..IBAAhABAdFHGDBDDBCAAAHGG.LAED...hACA......hAFA...,2,-29,-17,12
SCMJRLKdUEPZbcVfADgTXBIHaFOWNGeQY,DAFBTCGCBBDA.HBGBOACHGCAF.QGGESGBBCAAC.hACAJEGHLGCGKAADUDBBhABAEDEFZADF..bEAEfAGFhAFAAGAH.IEEE.FGAHNIAFMFFEhADA....hAEA...,1,-12,-14,2
fNJCEdTZcDAgOGLSVPMYWbaeBRFUKHXQI,GECFLDCHSCADVGFA.MAFC..bFADBCEE.FGHHhAAAKAHDQCGHhABAIFEHJACAdCBDZGCEAFIDOCFChAAA...YBAF...WCBEhABA.....hACA.aABE.,2,-20,-18,2
eRbcZEBLINSFKWDOAUdgXfPCTQHYVGaJM,dGFCXCBCCCGDHAEAGDGC..aECBJHBGMFECRABA.ZBABBFCCLADFhAAASAHFKHCEDAIDhABAAFACUEDA..fHABhACA........hAGA......hAHA...,1,-22,-32,10
PTeDCVEBbIJGZgYWAafNOdKUcXQFRLMHS,aHBGOGEA.dFDCUCEA.QCAGRABCLCFCMBFESDEAhAAAeAAEDGGACHBBBDCA.hADAJAFA.....hAEAgEABWDDDAAGCKFAA.XGFG.hABA......hACA...,1,-23,-32,9
VAPLadQJFGIDXBEWUMfbKgTYNOcCReHZS,aDCDdGDDQCCFGEEDDGHF.BGHB.EAGCUGCB.MFBBKFBHTACFhAAAOCAB..CBEHHBBDhAAAZDFGAFDCLEADhABAFAHD.ICACWAGD.bBFGNABF.....hAHA......hBAA...,2,-17,-8,9
LdWPBKAHSJIFYNZGeTOXDcgVEMfRUbCQa,HDEDJCCH.FGCHZEECeDAE..OAAHDIEE..VEGBEBFCRGAECBAFLAHDhAAAdGECBGHHAFBCSBEAhABA.IBCFhACANAIC...TEACcBDH.MAEEhABAfGAE..hADA...,1,-21,-32,11
LScDdfYAKGRJgZVHIMUCOEQTFPeNXaWBb,KGFHGGDHREEAZCBDHCEG.IAAFMDFC.CFBA.EGAGFACC..eHBAhAAAaEGEBGAGLABEDECA.hAEAdAFCACDH..JAFE..hAFA............hBIA......hCAA...,2,-30,-26,4
fgXQJDKNUPVRCdGacTBbAWOeYZFHMSLIE,OEEGeFBBFACEHEAGLAAFEGDF..XACGDCDFUFDC.RFGBGAEEhACATBGEAHFA.ZAAFSDGFhAGAIHHHgAEHhADAJAHF........hAEA......hAHA.KFGE.,1,-12,-17,5
AQKceBfWLEUGSDbOYaCgPHJXMFZRTdNIV,KGFCeAFBBAFELEDBUBFH.DFFA..OABHCABA...HDFEhAAAMBAFREDF.NIEF.AIBC..QEBBhACA..hADAWFCDSACAaFHDJCCE......hAHA......hAIA...,1,-32,-38,6
gWECXdQYaGcNPOZAHJeLVbKFSfUDMTIRB,eFFCLFBBKBFHFEDFSCBH.DBADTACBRBGB.BABCEHGEdBDAhAAAQFADGEEB.hABA.NEAA.PHDC.hACAACEBJBHFfFDE..MAFG..hAAA.IGHFCDEA.hADA...,2,-22,-19,3
VMQXWNYDEUHLTAfagReIKZdGcPCOFSbBJ,aHBGRFDFeFAGZDCF.GCDB..CBCDFAGDBBCG.MAECQGEEhAAA...XDAGhABANAIEDAAFHGFEAIDA.IDAAhABAcFAG.SFFEbEFE....hACA......hADA...,2,-25,-22,3
KGLHAQEWcPNSgUXVJRDBTIfCZbedOMaFY,EGFC..PGEASAGAUEBE..JACGBCDB.ICBBhAAACHDCZBCG.dEAHMBHFFFDHKGAChABA.HDEGAAAF.WHCGhACANCAC....XDFDDBBCfBEBhADA......hAEA...,1,-23,-38,15
QXbEOHFdTLDgRCBJMfYGZKVIWANUaePSc,aGFCSDCD.QDDFXABDOEHFdHGBDCAG.REACCHBCBHCDhAAA.MEADGAGCVDGBhABAAEACUEED.PBDAhAAAbABAHBFE.........hABA......hADA...,2,-24,-9,15
daXFNbPUCZVcAefMLGJSYQODEIRTBHWKg,MDEBJHDA..QABDOAEGDGGGRAFABFGCKDHB..dDFAFEDH..hAAA..NECA.PDDAhABAZBACABHHLDAFSGAEhADAEAAEIEBD.......hACA......hADA...,2,-35,-28,7
gUXGPSKONABFJEHDcbWaLMRVYZTCQfeId,JCAFHFFA.DECF....bEFFLDFA.VBCEZFDDCCHCeDAHhAAAdAFFUBCEGGBBSABChAAANAEBABAG.ECEGaBGGhABA.MIFE..YFHD.fGBGhAEA...hACA...,2,-26,-12,14
HNdJOVWURSQEeXDPATBKGZIcCYbgLaMFf,TGAFBFFCKAGF.ZDDGCGFE......bAAFLAAD.aGHBhACAMEFEFHEAHFBFNDDAOHCEhADA.UAGBSCDAhADAeCDEDIGAAHABIBCBgEACdEAEWFFEhAEA......hAFA...,1,-22,-24,2
NJKMaHSXIdbAVgQeDPLRGcBOEZCFUTWfY,QFDHeFCHLEEBRCACBAEHEADFZDAB.CGHD.UDFH..fBABhAAAJHAAaEAC.XEGEhABAdHGHAGBADAIH..PAFFhACAOAAA.FAGF.......hADA......hAFA...,2,-26,-22,4
YPLFfKNESMeDaTXUIAgZWcGOQRHJVBCdb,ZAADGAFERFFBHBFBJEBABFHACFBF..dAEE....PHAGfDHAhAAAEFFD.SHAEhADADBDEaDCA.TDDGhAGAUABCAIHE..cCBDOHDC.....hAHA......hAIA...,1,-16,-29,13
TCQfBAUYcNGKDVRJHXLFPdbWSgOEeMIaZ,UCBC..NDDGDCCDJFDDHAEGLAEC.dHGBSAAE.hAAAEBHFIACCZGFECDFGBHAEhADAAGBGGBEH.KEEHhABAXFAAFEGC...WFFC...hAIA......hBAA...,1,-25,-34,9
DWGRYLBJAMSTceIaPbNKVZEXCFgdOHQfU,SAGDTDAC.eGDGaEED....NABF.VEAFZDFF.CCBFFADDdHDHOGAAhAAAHFFCUDDFDDDHGBCFhAGALHAABEHBhAHAAABBMAAFIHHA.PAHDECHF...hACA......hADA...,2,-9,-5,4
gINRWdLbSFAMaQCOfGPHecTJZXDYKBEVU,aAGDCFEEGCCDHDGFeCEB..TGBFZFAEXBCBKAAGBADAVBAHhAAAUAGF...IHEBhAAANIBDRGEE.LDADhACAFAEAAHIBMAIFOEGB.fHGF.hABA......hACA...,1,1,-19,20
LgaBMIZGYcVbefFAWNOPURCKSQDTHEdJX,OGEAREFHKHCC.DAGCHDBG.dBDFLBDEBBBAZAGDGCCH.VEAEhAAAeDADFABDAAAC...hACA.NEIA.CCHDSHBGhABA..EGABJEFE......hADA......hAEA...,1,-23,-29,6
UbBTWPEZSKgJCDRYXeHMNGFOQcadLfIAV,UFDHTGGGEBHD.ZBBCSECF.JCCADBDC.RDAFeEEEHDFFNDBEhAAAOAAA.QGABhAEAdAFEfACBhABAAIEABHHEWHBA.PCHF.CAHD..MEAFhAEAcCFF.aGGG..hAFA...,2,-26,0,26
BUQGTSfFWHdVPcbRXDEZIgACOJLMeNKYa,CECDLAAB.eEFCNBHC.KDBABGHDGFAD..SFDHhAAAFHDAHACCdGHE.VBFEhACAPBAB.RDDEDIBCEEDC.hADA..IBEEAIBCMAFE.....aGGHhABA.QFAGhACA.WAGF.,2,-35,3,38
NOcUQgIeAWHXdJFPfbSVCMBKZEaRGLYDT,XFDHdEEDFCBD......PAAHSDBDCCHA.BCGHhAAAZGDCaFBHGBCD.DGAEhABA.NDIG.UAEGQFFEhACAIAHFABBFJAFEfGGBMEEE...hADA......hAEA...,1,-23,-37,14
OXBNKcFPMCEWSTDfIdLRaVYUJebHGQgAZ,OBDGBHHGKDGFFABF..MBEECFHA..EEDESFDB.DCEChAAAfAHGLFAFaDBGhABAUGDE.eCGB.hACAGEAGAIFAXABENAAA.cFGBWDCCTGFFhADAIDEE...hAEA...,1,-25,-34,9
DHSOfACTZVMeLBNEdPJcQRaYGIWKbFUgX,CFFCZABH.MAFBeDDBLFGHEDGC..JHFEQGCG.aBGBhAAAIBFBKEDB.FEAAhAAAXDAGSBCFhABAfFFEAHADBBHCNACFdCHA......hADA......hAEA...,2,-36,-22,14
WAUNHCLPFeQVTbDEcSKGMfdRJZaBXgIOY,HEFHCAFBLEEHFDEGQDBB..bCGBDCGE.SFBAhAAAMABCdGDCZDBBaABCBBFFhACAIBEFODAH.WEHBhADAAIGCNAAA...PHAE.....hAHA......hAIA...,1,-11,-35,24
JgXQCEWFKdIHVDGAMeRLONZUTaBfYbcPS,eGACOFFCZBEGUAFCBCCA.....fFEGbAAF.SDFAhAAAJCCFQGDChADAEABHKADEIFBChAEA.DCIDABIFMBAFLEECTGGCaHBG.cDBHhABA.....hAIA...,1,-21,-25,4
bLPNaYHXVEeMOKGZQFJcRBfgAdDWUTISC,dHFHDAFBUGGESEBELDEA..aCBAHDAHEGDA.ODDHZBGHFFAFhAAA.RADB.BBCB.AAIFTGBFhAAACGCC..PEEEhABAXBACMAIFKAGF......hABA......hACA...,1,-17,-29,12
aAWQUHcbIPTDBfLMZCNGJKXFOeVYEgdRS,QCGCHEFH..cBADIGBFDCDDLBECMDBGZBEDCAACJHDAhAAAKBCEFHAA..VFFBhACAEEDAdEAERECE.ADIB...hABA............hACA......hADA...,2,-22,-22,0
aJBLQFGOgWUfCITeZAVbYPXNDHKRScMEd,VAAD..bFDF..XDBADCDAKAGESDAGEADH.aCHFhAAABGGH.FBHHODDGhABAWFCD.CFBG..ICBDhACAeEEFADAF..YAFEPDGD..NBBFcGGChADAMIEA....hAEA...,1,-26,-34,8
LREdAIeagCVWTPKGNJYUBMDHXcbOfQZFS,aDCDVDBH....TEFFKGAAGEDG.JADCBAEH.DCADHAAChAAAbAGH....fBDEhAAAFGHHSFFBhABAEGBBABIFeHEE.CCBA.......hABA.NEIEMGCEXAGFhBIAcEABODHF,2,-33,-16,17
fgACDcIGUJRHdYeBQSZaOXbPFENVTKWLM,CAEDDACBGDCFRBFBHEBAdFGCBBAEZGAA...OFHH..PCBGhAAAFHCAEADC..TBFDhABAKCDAMAIHACIH..IACHhAFAJFFF.QFDBaAGF..NDAE..hAGA......hAHA...,2,-23,-22,1
MDVeABcQfEJKbYGRNSZPagHCTUFIdXWOL,QGGGJCCH.KAHHGBECRCCA.SGGBZADAaEFC.CBGFFBHDhAAAXCGH.OAAFhAAALABEDFCFAEAEfFAFhAFAEGDA.NEIE........hACA......hAEA...,1,-24,-34,10
QEfSAJUPbdLTRcKaWgNFCXVDMeYZIBGOH,JDACUCBC.dGBBRAAA.KAFE..aFEC......NDDH.FGBCCFFC.XDFChAAA.MCFChABA.ZEAABAAG.HEGBhABAfHGHADABPAHD...LEEDhACAWHAGDAGE....hADA...,2,-39,-35,4
AeFRKcSGZaCHQJUbOVIgBLTdYXNEWMfPD,eDCHFEHBKBACGADCZEFF.CAFEHAGFUECE.OBAD..VAEFIHFFhAAABGAF.LFEAhABA...YACDhAIAEBHHMFFFDFBBAHIHSDADaEHF.JHBAhAAA.....bACFhABA...,1,0,-34,34
HGZgARCeDaSBcTNLXVEYJFfMPQWKUIObd,RFEEDGGDBDGC..TAADLFCF.ECCAJEFA.FAGGMADE.QBEChAAAKCGAOFCEHCABhABAGCABAFIDCHEG.eAEBhAAAaAHD.SFAC.NIBF.....hACA......hADA...,1,-18,-29,11
AfTbHVJcgCWRDMOZLUYSIXGdBFNPeKQaE,TCBCHGFGJBFB..CFAG.RBCFDABGZBEALHBC..SAHHhAAAIFFDdCAGFEADeHDGhAEAaHGAAHAH...fBBAhAFAbDEC.gDGAMDIB...hAAA.YABE.hAGABFDDKEDA,2,-26,-26,0
XLROFbZNgYTdHCBcVWMJQaIUeKPEDGSfA,LADGRDEDOFAGZBAG..gDDGdGHABHCF...VFAAJBEA.hAAAIGGEUGEF.eCAChAAAKAGC.EGDFDDGASCEEhABA.AFIDFAHBNABF......hACA......hAEA...,1,-16,-37,21
IHLgNbKdQaOUERGPAMeFXJVcSTDZYfWCB,FFAGJADG...VCBGSDEEZFCD......fGHChAAABHEALFCH.hABAgCBCKHEEaAHHUAEAhACAEGHFREEEABBB.eAHHcEGBDBAHCHBC....hAAA......hABA...,1,-24,-33,9
MUbOXCeQEWYVFHTBZIKJSGPgLafRcdDNA,UFDBODACCCGB...QFBCEAFA.VFEAFBABBHFA.KDCFhAAAJAFD.SACBhAAA.GBGEPFAHhABAgBBDaGGARBDFDDBHACCAMFIH..eEFGhACAWHAG.....hADA...,2,-32,-10,22
GBAUKPQMfCDgFIJZEWHXSOYNLVcdaRebT,KGFCMFFFCCAF.DCEC..FFCGZDABHAGH..OEEALAAEdADHaDGAhAAAeDEG...bEABBHGGhABA.ADDFQGBEhACA.IAHFEGDHXBBHSFDHhAEANCIA.....hAEA...,2,-30,-24,6
HDNcICPKQdRMVSBUZEXFfgJYWabeGLATO,OADGDHCE..IGACCDDCKGDH..QDFAMBBCBCEFEGBBFCCHhAAA....gGGChAAAJAFAaGHF.eBBBhABAADFFHCGF..PCABdCAE.SAGAhACAZFFFYFBCbBFC...hAHA...,2,-27,-24,3
UNaRdXGHAgWVFKILPefECTMBZSYcOQbJD,VAADFAFBLGFC.eEBECCHCBFHCZCGH...SEAGhAAAOCCCJHBGDEFD.UBEA.hAAARGAEGGEFAIEGKABCIAHFhAEAEDBA..MADE......hACA......hAHA...,1,-26,-31,5
MGOIcJTSNaXEDgLdBKZHUWPbARYeCVFfQ,RFDFeAFBFCEA.MDIBGCGA..OEBFJFAE.TCAD.SFEHhAAAaDDCDCABdCBGKDEDHABChAAA.UGGFbFCDCBBB.hABAfGGEIAHD.cAGA.NEAAEEGDhABA.BACE...hACA...,2,-20,3,23
eDNbROHETYAPZdVBcKIagQSJMXCLfGFUW,ZDAGBCAHKBCAaGEE..QFFBMBEH.CAGC.LFACGFAFFAHDhAAA..eHCGDBAG.NAEDOCGDhAAAEDFDAACE.dCCEIHDDhABASFEC.fABF.hAEA......hAFA...,2,-31,-23,8
YdBbHXagTZFOGcDRQUNEJCfWMSAKLVIeP,KDBDLFBBeFCBdGGHBHHDHAEHaBCH.ZBGBFFFGGCDA..DAACRBAEQGAGhAAAUBEGEFABCDHH.hADAMFFE.AADH.IHDEhAEA...PECA....hAFA......hAGA...,1,-3,-37,34
MEVDXPBSgATdOFNKRcaYeGCWZbUHLJIQf,TGGDdEEDOCCH.KAGAaEDE.GBDDZEGDUABFLDAA.JHAAhAAAQBECEEGC.hABADHCCBABHAIDA.FGDERFAF.hAAA............hACA......hAEA...,1,-18,-34,16
aGNcfYMASKRCQFZbgHJeTUPEIBXWLVOdD,SEHBCCAHZDDAHFCG.eFEHUGGG..ICCABAABLFABhACA.dCEFaBDF.NACB.fAGFhADAACIDKGHDRFBDbBFBJCHFhAEA...EEBEXBAB....hAAA......hABA...,2,-26,-15,11
dDJOKZTUYcABFaNgISGCWePXRfHVLbMEQ,BEFAFAFB.aHGE..IHDHCBEE.eCFFRFADHBADLEGHMFEFdCDEhAAAJDAB.ZDGB..UDCEhAAA.ACAF.SAEEhABAPAHD..XABC...fHAFhACA..hADA...,1,-27,-34,7
cDZXgRBOMGPSCIANYVdUTaJbLHWfFeKEQ,VAADdEHAaAGD..LFFHHFEHFFAGKADEEBCDDDGE..ZAAFRFCGBCDAhAAAOADF.GGAFCAGAAAIF.hACA......hAGA.NEEF......TDBEWDAGfDFEhACA..hADA...,2,-34,-23,11
FeJOBcbRWPHTUICgKVLEAZYdXMaNSQDGf,ZDAGXGBCMFGB...aHECQAAG.DGEDfAEBhAAAFBGCeFHFBDHERDGBHDCATADChACACDAEgAGHhABA.KCBCLFCBAACBYGDCSGABhADA......hAFA...,2,-23,-6,17
RcHFQIBfKZVdXgAEbWeMJLSGPYONTDUCa,EHBGeGEALFADGEBBOCEGDHDC.CDHF.RACEFCFFBACGKHGEZAAFdDDCAAGC.hADA..MBBDSHBChAEA..NAEBaEEFhAAA.....QEGAIHHCfCCBhAFAgBGB.WAFAhBAA..,1,-25,-26,1
ZWUGMaFegNPQdEcVTDKbOfAIRCHLXJYBS,CFDDLBDG.XDAABFBBSAAF.ZAFBUFGCMIFEhACAaDEFFHCGeHEG.NAHEdAAChACAEBDH...TFAEhADADFGGKCBH.OEEGAGEE.IGGE.hAEAJBHF...WDADhADA...,2,-40,-15,25
gKQBEMWaUGZFXScLVHYADCfdITNPeORbJ,DAEDdEGD..TBEEeHFAOBFGRDBB..JFAFKEHBBHHGEBBCMFCDhAAAUABDZEDF..SEFHhABALHDA.VDCEhACAAHCH.CGAC....fDAE.IGDFhADA...hAAA.NAEF..,1,-20,-31,11
FKgTOHMcDEXQNZSVPBUGfLaCJRYIWdAeb,FDCDTGBCMAAC..EFGHQBCDZDFC..SCAHhAAAVEFGBGAHfCDChABALBFCCHDAJAFE.RABAWEEDhACAAHIHKGCC.....OFABDAGGNBBE....hAEA......hAFA...,2,-25,-16,9
MaFTJDUcgfdOSeCHIQGbYABXVREKLWPZN,BFFCVABH.EFBGLFCBZAAF..MACCaECAFAGGDGHF..UBEF.hAAA.gBDHhABAOHDACHAA.IFHGGDBFAAGEhAIAKCGD...PHEENDIC.TFAC.hBAA......hBCA...,2,-29,-12,17
SMgZENUPFcBaIWCOLDYHQfKJXVRAeGTbd,eDACTAGHdEFG.MBIFEDBF..UGFGFFBEBACG..IBBGhAAAOHDEDDHBQBDGhABAKHGE.JGCARAFBAAHBSGADhACAZBBA.NFEFaDFA......hADA.CAFC.YFAFhAAA...,2,-33,-7,26
UWbAXPQcKeRLBNfMgFIEGaZDJHSCVdTOY,XCGCQCBCKAADeEEA.LGDCBFAHMCDFFGAHEBFDZAEBHFEBhABACEDCdHFD.ODBF.hAAAUGGEACHEPABE.hACANBAC.IBHEDBGE.SHAA.hABA......hAEA...,2,-16,-14,2
ZGQaTfVWLbMRKBUFXHSOEeCJIANcYDPdg,...NDDG.DACB.dGHAZCEAQGAD.aDBBfBCFhAAA.VEEDLEEDhAAAMCBHKBHBBFCB.UCGHhABAXGBDOAECCABGAGAA...YAEChACA.PHFC..hADA...,2,-33,-29,4
NKLXGRDafTIbQJMVcedOWZCPEgSUHFYBA,LCCHGACFaDAETBGG..IHHCQEFCMIBAeBAChAAAOEFBCHGH.EDGBUEAEhABAFBAFBEDHKGDDDADAfGADhAAA.JAHBdHAB......hACA......hAGA...,2,-19,-12,7
QTfBLRKgWMHCPaDdFZIESeUGcAYXNbOJV,XCBCOGEA..JHBGQAAHBBHBLDDEKFDCMAFC.CHBCDFGDhAAAdAAFFEAH.EADESBFHhACA.UEAFhADAABDD.bFGHfBBERADB.gECAhAFAPHCCZBGDIHHAhAGA..,1,-5,-30,25
eXVfWKaAbFQdHGTDIYcOCgSRJNEUZMPBL,QGBCdGFHGACGDGCG..ICACOBHDCDFCREDEEEAF.UEGEhAAAMFCCBCCELAAFhACAXCFCVAEEKAECaHCEAAIDFABEhABA...........hAEA......hAHA...,1,-15,-26,11
MNUdOXDBRPEeIcKYTVCHLSgfJbFQaGWAZ,ZFACUFDBdBFDODAHDICABABC..EGAH.eCGFKGFF...VCDFhAAACCDGLCBH..hAAAfDBGFEFF.hADA.aEHHAABCNBCH.XGGCIHAF...hADA......hAEA...,2,-47,-28,19
bMJfEgCdAOGeNZRITSWFPKVDQUYXaBLcH,eHDAZGFGRCCC...IGAESBBE.FHCAVCFG..QEEGhAAAUABCaDDBBBEAhAAALAEEHFFCMDAHfEBGhAEACBFBAAIFGCGE.......hAFA......hAGA...,2,-24,-15,9
JadbUVNWDFXMRZGSHBTfKIegEcLPOYCAQ,QGGDJEGH.dBBEUGBG..VECDDBDEFCAGRBFGZADHHGDEBEHChAAAKAAE..eFABEDDELBHFhADAOFFBAIDGaEEAhABA....WFAF...MFCA.hACASCDE.hAFA...,1,-14,-30,16
BPIFWKMYeLZAUECHgSbDfJQTGdORNXcaV,UGAFCHCHHACB..SHDADEFGQFGBGEGGdGCFRAEA...XCAChAAAaAACBEDAFBGDMCCBhABAeBEHADAD.EFAA.fHFBhABAODEANBIE........hACA......hAEA...,2,-24,-16,8
aTQBHXfRFdceKPCgDJOIMVZbLGNWYEUSA,aEHBBCAHHFCERAAGFFBGdCAB.KHBA..CHAH.DFBB..OHFAMDEA..hAAAVAEEZCEDLAHDhACA..WAAGEAEHSEGBhADAAEFD.XGDBfDCAhABA......hACA...,2,-33,-29,4
USZaLNFAVIbTCJgWEHfGeQMXBRDcdKPOY,VAADTCBC..CAGG.JFCA..EGDGGAEH.MHFGBCGEDCAFKFGDhAAAOCGDUCDDZFAHaAAE.hAAAFAEBAEDE....IHAEhABA..WHEAfFFDXDAEhACA......hADA...,2,-36,-21,15
cHaVEgBDMFeOUdNbCZIPSXQLKAJRYTWfG,JFBBTFDHGADA.HAACEABCBCDF.MCFBFFGFOAFA.hAAAUGDGbAFEZGAA.SFHDhABA.XGFHhAEAQDABKEBEABDCWDHB....hAAA......hABA...,2,-28,-12,16
NPGUXTJHeLCOMFWaVYcRDAKQZgEIfSBbd,ZBCFEHBG.SAEAdEBEGBDCUFAB..JHFEHCAFCEHG.FEGFaGDGVFDFhAAA..RAACADAEKBHF.hAAA.QAFChABA..IHHABCCCNAIA......hABA......hACA...,2,-26,-18,8
WHOAgDUbIEdXFQLeTPNJBCcfRZYVKGaMS,DAFBUCBCEBBAdHGH.FAFFQGEA.LAAFTEGB.JEBGBFFGhAAA.CCHA..RBDFZFDFhABAYCHH.KAGF.hACAaEFESHBE.OEAHAFEHICDEhACA.PHAE.hADAfGHE.,1,-19,-25,6
ESDJXNOQcWMLPbGafFYHATdBeKCIVZRgU,TGAFeCAFCGAB..ZGDEREEBUEAH..SHAADABC.XDEBhAAANDBB..OBBAhAAAQDBDMEHDLHDAhAEAGDGGFABAACIB.BAHG.....hAFA......hAGA...,2,-30,-19,11
MDbHKRSTUJAQIVLCeaWdPEXcYBFfNZOgG,VEFHLEGH.eBAHdAAGEDHD..XAFEBBFBFHAAZEBFOCBEhACAMDDBDIBG.KFFDSEAHhADAJABA.AHHCCECHhAEAPCDA.fFAENEEE...hAFA......hAGA...,2,-33,-20,13
FSYOIaPDKVcHMNfUTeBgEWAGRCXZLJbdQ,GCCFCADCLDFAJFHF.dFCCFBAD..OFAF..PEFFDHFEKAAChAFAHAEE.MAAEfCBBhAGATGCHBAHBhAEAEEDEACEH.XGAB..bAEA....hAIA......hBAA...,1,-13,-37,24
DaTEcRLeKbfdQgXJHWUSBMVIZYFNAPCGO,CECDGDGGDGHF.EGAALAECeADH..KHCAdAABQAAC.hADAJCEBUGBABAFFVCDChAIA.ZEFE..FGECPHDAhBBA..........hBDA......hBFA...,2,-34,-26,8
KZOWaSeEDNXCLVPdcIGfgMHUAQJRbYFBT,JADGRAADFEFGBCGHZDDH....OEACaFHB..ECAGDAGC..CAHGLFCAhAAAdGGGGACFMEDChABAAHDF..QBGEhAAA...........hACA......hADA.YCCCWEHH,2,-45,-29,16
ZXAfHSMgYUQFBJTcaIKREbOVWeCdGLDNP,HDAGSGFHMHCAUEEDFFDCBCHB..JADCaFBFKCGE..ECDFOAADhAAA..WABDhAAA...dHBHDHGCNACF.hAHAXGAB.ACCE.YEEC..hAIA......hBAA...,1,-34,-39,5
BUDVSCFaJeAMXHdPbGEfgNcOYZKWLQIRT,MEIBdDAFGDFC.EAACNEBC...OECFZBAELFCE.IGGHhAAABAGCDGIBCDEBFHEChABAeAHF.ABEH.HAFBbFAH.hAAAfDGC..cACBKAEF.WBEHhAFA.....hACA...,2,-23,-21,2
BWKdaTIZQYXfAUNeDHgVSMcRCOLGJPEFb,UDACeFCHHDAF.SAHFMFDGCHHGLGBCJABG..PAEFhAAAEACGBBAE.KFHBTEGChABAZAEF.XGEDhAGAAAIFDECG.cDCAOCHB.FHBEdGGD.aCGE.hAAA......hABA...,2,-31,7,38
RcNUQEDbVedJfWgXATKMLCFZBOYaPHGIS,KBDHCHFDFDBDZGBA.BDBC..aGCHHDDCGADBSAAFRFDF.UGGEhACADBIBeCAF.dDEFhAAAfCGG.hABAXAFAAACCTGGFOFCEIGAFNBICbEAC.hAEA......hAGA...,1,-13,-27,14
LRBHTQfFdDgSJICYUXVcaGKbZAMOEeNWP,EFAGeGEA....NBHG.PCFALACBHFACQGDAFABCDCCFJEDAhAAACBACUBEF.VGFAhAAA..cAEBKEEAAICEMBIBhABA..ODHDBHAE.fDAEhADA.....hAEA.SCBDIHAH,1,-5,-16,11
HCedEFJGaMTXIPKYgLBRbfAZNcWDUOVSQ,ZAAD..NDDG.DEIFOBBDSAED.HAFHeHDAdEEGEFFEFDCDaBEDhAAA..MHCG..hAAAIADCPFABKDGBhADAYAGDBGGF.fFAGAIHA...hAFA......hAHA...,1,-23,-30,7
LWTQBbJIgCZRVYUGEMaSADFcKOHedPNfX,DGHHFAFBOEEEdHDB....PAFBXAAFLCAAQCFHhADAJECD.CHHGRCCDUEECEHCG.hAEAMEIHAAHC..KBHBeEABhAAANDBE...fABCBGGC.IAHFhABA....hADA...,2,-34,-17,17
ScfJDCGMKTFIPNgdbLeBHRaOUEVXAWZQY,QFDHSHBG.JDBBDAHH.GBEEKGGDFAEH..ICCHhAAA..NBHCdABAeFAEBDEEhAAA...aFAHOABBhACA.EHECABDD.WEGB.YADEhAIACDDDMCID......hBAA...,2,-35,-30,5
SRGDCOcAeaWQVbHMYdBJKTPZFNUfXELIg,aDCDVEFHHAAC.dHCFKCGBZDADFBEB..UAFFEACD.LHFA.hAAASFEGDFADOBAHhABAAAEHQDGEhAAAMGBABBHBJHAE...NEIE.fEEB.hADA.gDDAhAEACGHC.eBBB.,1,-5,-18,13
RVDYSdWOUfgHNQaBAFMJIceZLXTKbGEPC,JECCeGEAZBBCLCBC.KEADGAFE.EHBARCFAVFBBDGFHdACH.hAAA.OADGUDAEHEGBhAAANFED.BAHCAIHG..hABA............hADA......hAFA...,1,-24,-28,4
NUKJMEFeSXIfcWLDTYdBHACaPGRZQbVgO,aEGDGEDHZAAE.QGAF..gBEDNABAUADG.MEDChAAAFGGHeDBH.IDHGhAAAfGAH.WFFDhABADFIBdGDAACIF.RAFC.OAGDKDDC.SDCChACA.cGBDhAEA...,2,-38,1,39
DUWQeLIbYMBaSJPVdgCZHXfAGORTFKcNE,GGDHRAEGKCEF.EEGCUFFCeCFGLEAE..bADDBCBE..hAAAaGAHSGDHhABAJBBD.dHABCEFCXFBFhAAAADGE.FAFGDIGGIBHG....hABA.MCAF...hACA...,1,-1,-44,43
cgKZFLWUDNfQHCJEXMRGeIVaPSTbAdOBY,BDGF..gCBCFFFAUCCHDBFDQECF.HFEDEHEEREAFhAAAeADE.IGHHhAAAaAHD.PCGD.hABASHAEAAHFdGCG.OABCKACB...hACA......hAEA...,2,-43,1,44
cULJZKSWgYOCEMIdNDGQXfRBaAHbFePTV,HDAGeCCH.TADGUGFGZAEEKGAA...SCBF..WDFDhAAAOAACCCBCMAGFICGBhAAAdGHCDIEEGGAFhACAQDGEXDGABABBAEADPEDC..hADA......hAEA...,2,-20,-18,2
PRLJMdfSbGCFXIHDQeNOZVAgWUcBYKETa,UCBCBFDGECGA..TGDBaGEE.LBFFdGAC..SAEHhAAACBHAXGACICCBhABADGHD.eHFAOAAChAAAAFFB.gEEG.cDGFKGBG.JFAAhACAfDAE.hADAbDEC..,1,-26,-27,1
GTaUIKReLCFdSQbNWJPcDYOMHfVXEBAZg,ZEBHTAGHaBDG..KFHFRCDCLAAF.CHFC.SDFA.hACAQFDENFEDJGCGDAEC.hADAMACCHBBAVAAFBHHHhAIAADEGUAGCFFBB.WFGD......hAAA......hBGA...,2,-26,-16,10
DCKGFOIfVTQZJAUdBgRESePWNXLcYMHab,UGAFBFEDECAFeACB......PAHBXGGGLFAAhAAAMFEHaDHFDGGFKCCC.FACChABAIBAG.TDFGhAAAQCEEAFBBgDACSEHDNEDE.hABA.YADC.hAEACFHD...,1,-14,-38,24
QCXAYNGcRdTaSbgOPHIZBUJVFKDeWLEMf,GAFERDAGdGDH.SFDDOCDEHFAHZBCFBFGHUGGE.JDADKBBADCCDLAFGhAAA.MABAhAGACAABACIF......hAHA.NEEF.aGFC.........hBAA......hBBA...,2,-42,-18,24
aUdCIXJfBPbOWcYANMELTZFgRQKVHDGSe,MHFGEGDDZBFGFDBD..QGFEKGDBHAFDDBDFeDEA.dBBFCDED.XDAHhAAABCAC..OEFEhAAA..YAEEhABANAIGLFAAgGBD.....hABA......hACA...,2,-36,-7,29
ZYDaIKUgACNfBXbVSdHTJeWQLcRPOMGEF,CFDGBFDG..XDEDSCFHHABDeDBDQAFERBCH.MIDEhAAAFCHBZFFGDECDKHBCACAH.hAAA.fGAAhABAdEHEJBDDLDAFOAEEEHFCaGGC...IBBHhACA.....hABA...,1,-13,-19,6
FUMXgDRIZKEGHSaQeBLCcYJNWATbPOVfd,TCBCOGEAdAED.UCECXBEB.DHFGRBBFKEDDHEDB.SCGBhAAAQFADBAHEhABALHFGCGAHJFFAAIEA.PDABhACAFAAFIBHF.EDHF....hACA......hADA...,1,-15,-24,9
FPGcOIJNTXBaMAWDVRQdKgSUCeZfELYbH,VFDGdDAFKAAD.UFGBeBDD.ZAAFLFBC.HBCHGBGEOAFFhABANAEDBBFB.MECFhACADIAE....gCGHhACA.SFEHEDFDYDAF.hADA......hAEA...,1,-18,-30,12
adLIeUDSfZbEROPYHXVGJNgFBCMATWQKc,TCGCKGFCdDDFLGAC.UDAGfFDGZACA.EDEGOEFChAAAPDAD.HABE.hABAXGGGJBHF.FHBAhAAABHEEAECAcAGA.IFHBDIBG.SEEGhABA..hADA...,1,-11,-37,26
NMFYHefBSLabXPCAgGTOIEZVRWdQJDcUK,TAGHEDCDRBCE..QEEGJFBA.DBEAUEFD.MDAHHGCABABChAAAaFAF..XCFEhAAAPCEE.AAIF...ODBEhADAIBAG..WEHHKHGA....hAEA.FCBG....hAFA...,2,-33,-14,19
NJEBfMgFQUHeCWLDAaVGbSIZXdKROTPYc,aGFHVEBHGBBG..SEECZBFFKAGCOFAF..YBHBhAAA..NEIEBBEGhAAAfCDBFEDD.HGFAhABACHCGDGHBbADAdCACTCAA.cGDBMABE.hAFA......hBAA...,2,-21,-8,13
TSfWPAZHORNcULVXBYJCGDFbKaIegdQEM,ZDBGHDBGOHCARGACUGEBLBAEBFGE.CHAB.DDGG.KCAFeFEE.QAEBhAAAMCBC.SDAChABA.fDFDhACAACFGcAGA.XBGA.JHFEFABGhAAA.IFAE.hADA...,1,-18,-34,16
WUIHTJLKgEfSCPAOYdXVMZeNQRcFBGDba,dDCDXFCAMAFCZGFA..eBEHQFBDRABEBAHHDIGE.aGFBUABGhAAA.TADAKDFHECCDhAAACCHCAFID..OFAFhABANFDD....FBFDWDHF.IDAFhADA......hAEA...,1,-19,-29,10
YAQRGWfVICLecTDZKdgOUbHPNSBFaMJEX,RACFGAFE..fFBHIDADCEBAeAFF..DEFDdGDCUABAhAAAHBAF.SFFAhAAA.aAHDEDHHAHHGWEFChABAcGGH.KHAG........hAEA......hAFA.bECD.,1,-15,-39,24
NADPfFIVKYWUceBJHRQLOETCdbXSZagMG,DACBFHBGKDAEUEBEBAGEHFEH.LADH..OAAGCAFC.XDCEhAEAZBFBaHGGMIBAhAAAABFD....PFFGhAFAfBHC.IBAF.WHAChABAeHEG.QCGGhAIA.TBCC,1,-33,-35,2
dAVSRPFgTQIOUNDJCZbBKXWcMEfYLGeaH,SDAFRDAGFGAA.QABCOABGUGEHDDEEZGCABDGD..XFEAhAAA.MCFGhADAEEDCLBFEaDFE.hAEAACDD.PECC.IGAG.NBEFCDCCWFFEhAAA.....hAFA...,1,-20,-44,24
JWeRXBAUfgOCMLENHPSVIGQadFTKbZYcD,UCBCOGEACFEA.LCBCHAGH...PAHHIHHG.QGADhAAAdEAHKEFEZFCBDDGD.hAAA..JDHDWABEeFDDhABABGBEAAEB.MAGF.NEIE.GAEA..hACA.aDAH....hADA...,1,-17,-20,3
CQIJYeKUaSFPELXDHZOfdNbcTAgWGRVMB,GAFEMGCEBEEBCDEA..QFAHJGFE.eABDKBGEUBADFFGA.hAAALHAEDIBGOEDHhACAdAEE...NAIETACGhAEAAEHHRDAE...IHHD.aFFH..hAFA......hAHA...,1,-14,-43,29
gVfdcWZeDbCTaIHNGUJAEORMLPKXBFYQS,EDBDMAGDLDDFKHACBHGEFAGD...QFGFVEED.dGAEZDAHhAAAeBAACACA..TCDDhABAIAAD.NBFG..hACA............hAEA......hAFA...,1,-23,-45,22
NMSXRUHfKGgVdJEQPIBbaeAZCLcDTYWFO,ZFEECAFBLCEHDBGH..TACGFBHH..OCCBSHCGRFGDUGDBhAAAKCAF.GDDFdBAGEEABhABAIAHC.aDHFhAAAAAHE.....WFBF.MFAF.fBABhABA..hACA...,1,-32,-33,1
bdYQVZKACaWNBJLEcPISRfFTDGgMUOeXH,aEGDBFDGLBADEBFH....IDHBSGAGFCCDDHACgBCDhAAAMCBH.eCFDhABAXFGFdCGHQEBEhACAKEEHAAEGCACG.WFHHNICF.cAFA.fEEEhADA...hAAA...,1,-1,-45,44
IFdYPbgBUVKMOSHCEafeQLJRcZDAXTNGW,XCGCTFGH.GFEHFAHHdBEH....PCEBBDECUDAEhAAAKCBAMHAGSHEAhABAHACECFCDaHFEeEFCLCADhAAAJGACZCCFAIHENIAF..IAGF....hABA......hACA...,1,-5,-21,16
VYHWKUTIDRLAcFMbECSPOQfJZgBaeGdNX,FGFHMHFGECFB..CGDH.ODHHQAFC.ZFBFBGBDGEEFdAAFVDCHhADAHDCEUABB.hAEADIGAAHIDSAFAhAFA.fBBEgCAANIAB....hAAA......hACA...,2,-25,-16,9
XFHLRMDKCAWdOVfGEeScPIaJNTUgbBQZY,OCCHVEBH.GAEGeEGH...SAABIAHG.JFHBUAEFhAAABHCFQCAGhABA.XGDEFAHBREFHDGBEhACACCCBAEEHfEAAEDEE......hADA.PHDCNCIA..hAEA...,2,-27,-11,16
MEfcJLRGNTXKHIQObUSCDgdFAeVBaPYWZ,eFCAaBBD.....PHDEZGAGMBFAEDBH.JHDELAABRDBA.hAAATCFEHDFFIBADhABAbACF.CAEFDCGGFFGDBGABhAFA.fAFA.NAIE...hAHA......hBAA...,1,-12,-29,17
fLAEICJcYVHWZPNgXabDTQBKFdSUeROGM,CFEDJGEA....VDAGZCGB....NBBD.aAAF.DBGAQGBAhAAA.BDDAKHGCSCGEhACAeDABOAFAMIAChADAACFDEBAB..........hABA......hACA...,2,-53,-36,17
SdOALEeVUBHYTIcGCXgbfKQDPZWaNJRFM,EGDBVAEGHFFE...TDDFIGECCCAB...XDABhAAA..gCFDhAAAfABEDEADZDDANECEJBBChABAFHGGMDFCOADGAHCDeECDBBHB.....hACA......hAHA...,2,-18,-15,3
LeWCYEORFSBgGZMcKQAUDIbJNHPdaVTfX,UAFBDACB..JEAEHBDB.aBAE..VGBCTGEDLCDE.hAAA.CGAA.EEEHFDGEBHHEhAAAZDAAMFFGQGFEhABAAGCDIHHC.NIAF.PAEC....hADA......hAEA...,1,-16,-37,21
ULEDeVIXCNWGdKORSTacHJMYQZgAfbPFB,...fDBDbDEDBEBALBHDEBEA.eHFEIHBH.hAAAXAAFCEDHNIAB.dHGFhADAKBCCSEEChAEAaCCEJBADMAGHZDGBACCE.UGDHDFAH.WFAF...hABA......hACA...,2,-22,-7,15
NZaMPRYbBIQdgOUefHEFLCJKDXVScAGTW,TAGHZAADMDDB.RAGF.BGFC.dGHCUGEGeDDBEFAAFDGH..CCEA.DECFhAAA...XABChACASAECAFBBGAEEhADAaHGA.bGAE..IEHH.OGBChAAA.fEEBhADA...,1,-12,-38,26
LOTfWMUdPbRJGZFYXCVEQSIBegcHNDAKa,KEEDLFFBODAETFBC..MCGFUAGEdHBDRBABGADEZABEFAHD.hAAACHDG.QGGGhABABEHGeDFC...cFDFhAAADBFBAFADfHEF.....hABA......hACA...,2,-27,-19,8
XeSHaQMEJVFZINKDCARdWcbfYgTOUGBLP,RDAGdHBH....bBAAfGFF..TGBAUACEBEFGhAAAXGDDSDGChABAHEEEMFABEBEEJFACFGGBIBGFhAAAKCBFDIEAAEHD......cEDChAFAODFA.PADAQAGAhAGA.,1,-4,-28,24
eRWbKfMPXYTgNAUJBVZQLDSCcEIadGFOH,JGFAVCDHZCCH..DCAG..SBAFCFGC..ICGGhAAAdDBCOGBAHFAARAFDKHDAPABChABA...XGEDhAEA..YFAF.NAECACIHBHHEhAFA.cAFB..hAIA...,1,-34,-36,2
KcHQGOIJPaDNBeYAMfLXRTbFWgUdEVCSZ,LCHDRCDBFBGC.UGACEGAG.CGDE.KFBEHCDDGEGEODFF..JAAFhABAaBBDBAEG.AGFB.fEBHhAAA.TAFAhABAgGDDdCACSHGE..hACA......hADA...,1,-17,-37,20
IBCSQDRHVWcGJEALPZYfbdMOXUFKaTgNe,LFBBZAAD..fGEEdDEBMEAHXFEAKFGE.aBDETDDFhAAA.eFCHBHHBhAAAQBGHDCAEHBGDWABAhABAcDAD.EFBFAGBDYDAC..hACA......hADA...,2,-24,-19,5
UJTdGgECSZcfFWNDOLHMVPKYXIBQebRaA,UDCHTAADGADF.EAACCDBFZFAB.FDHDDDHFLDDEMFIFKGEC.hAAA.IHCGBHGHeGAEhAAAaADG.AHAE.dHGHSDFDhADAfAHCNAIE.OFEE....hACA......hAGA...,1,-23,-24,1
ONUQFMZTeYWPJHGVfBKACgadXSLDcIbER,aEGDXFCELBADDHGA.....IAFFRAAAUADCMIAGZFCBeCFEhAAA...WGFAhABAHDFG.fFFChAAAAAHEdDEBSDCFcBFD.......hABA......hAGA.EDDFNIEF,2,-30,-27,3
CUTMaFQfAONHGBZXVcWPSKDRgJbLIYeEd,OFBBHEBHBHAHZCCF.XGFE..VFED..PHCChAAADAEEJBDCLAFD.hAAAeBBCCHGHMBBHQDGEhABAAABE.GCDCSHCGgAGAhACAIAHD.dDGAaEABNDAE.hADA...,2,-40,11,51
YGeAcCVOTaFBRNIQgDJfHSdLWKbMXPUZE,VDBHTAAD..FAHHREFH..QGCCDGIBHBCGLACCKACE.hAAAMAAFXBGCZFEAEEEGhABAeDDD.AEIHCHGHBHDFhAGAgFADfHFDSBEBdDGF..hAFA......hAGA...,1,-5,-21,16
KBIEYTaHdORFCZbJXfgVUNMDceWGLAQPS,SGFCBFEDEBFG..aCDHdDDB.OFCHCCBEZEAH.JAGH..XGGHhAAAVABD..MIFEhAAA.DEBDeACCLEHBhABAAIAGKDFEIEHD......hABA......hACA...,1,-26,-39,13
AZIaLJMKbNYEUSGeXBTdgOHcWRFfQDPVC,ZDAGLCCHKBDB...bAEGEEEH.GDGGBEGCdDAHOGCCHGDARAAFFAGChAAAfCGF.hACADBBBCFCC.ABAD..aFAFMICChADA...........hAAA.NDIASGGHhABAeFAF..,2,-23,-13,10
MgHTLUKBGIPZfQaNbAdSXDYVCOFeREJcW,SFAAXAFBDFCFCEBF...FEFHRADGEFFH..JBEB..MDFEhAAAHCAGLHBABHFDIHHHhAAAfGHA.hABANDDAAABFdDGD..YEEE...eCAAhACA.....hACA...,1,-13,-41,28
WQTFELaDIZXUVMBKRNHcCdGeAJSPObgfY,SDCDOGEA....bECHfFGFQEAFFBBELCBGhAAAIDAGUCGGMBHHhAAAKADCHEEHCHHGeEEGAGEFgGAAhABA.YDDETABHaAGGXAFBhACA.BGHANIBF.hABA...,1,-4,-13,9
KUNSAVePBMdLGfQOCEabZgRXIYWHJFTDc,VFDFeAFBMEAC.LEGFGBCBOFAACACB.ECAGaBACZAGFXFDEhAAA.IHDGhABAWDDGFHGA.DIBAKCDBhAEASAAEAHBEdAHE.fFFB.hAGA......hBBA...,1,-16,-22,6
XDcOeHGaSJZCFBEdNgITUAMWLRbfVYPKQ,LCHDRAAD.VCEFPECE..XDAGDIBEeCDA.aFGGSGFEhAAA.CACEBBBGhABAEGEDdGAH.IDGAhAAAACDFMIDGbGBCKADHcAFAOFBA....hACA......hADA...,1,-17,-32,15
ZSbNeKGdHYEgBXWIPTLOcDJfQVCMRAFUa,UFCEaEHBZFCE..SBHDeEADGAACdBAFHBEBEADC.BDBBIDDChAAALEAB.DIGAhAAA.JGFGQBFGhACA.MFIDAAGFNADEKEGE......hABA......hACA...,2,-26,-12,14
CHcgFRNDXVdaQITYWOKZGMEJbLBeUfPSA,HDBHFHBGDHFGdBFC.aFEAQCAF..TBACOAEHGAGAhAAAMGAG.JFABBFEHfADAhABASAFGCHHE.hACARDFC.NIBF.IAAEKGEA.ZBCF....hACA......hADA...,1,-5,-31,26
JLVdGbKFAEOgeSaCXMNQUZfYITRBWcDHP,OCCHSDCD.CGBG.MDGF.UAFAZAEA..IEFFRADHBHHEDFDEhAAAJBAF.LBAFhABAGEGC.FHECABIBeHDG.hACAXEDDfHBB...WDHF.hAAA.PCCA..hABA...,1,-26,-28,2
dKPBCaUYNVQWTFRDHEJLGZIScOXebfgAM,KHBGCBBDUEBE..VGFA..TGDDFEEHDAHHHEFC.LADEhAAAZDBF.SAHDhABAXAEAeADDfGHAhACAAFAHdDHABHEG.aBAANDCD......hAAA......hABA...,2,-32,-16,16
YTGNKfOCPDgLSIaFRJMBbeUQZWdEAVXcH,XFDHHAADTBECGACBKHEE...CFCADIACSDCG.FEADhAAARAADBGAEeDGFQGBAhACAZDAGdHGFAFID.YAHHhADAfCFD.PEEGIFEF.MEIFhAEA.....hAAA...,2,-30,3,33
CdIMSGZbKQYRDfBHXVFOUeAPcaTJgWNLE,aHBGTDAC..JBAE....NBCBEGGEIFGFGECB.KBHBQGEChAAADIEEBGDD.HBFGhABAFAADeHAGAFDB.PCCEhAAAWDCGCEHE.dDACMADE.....hACA......hADA...,2,-33,-9,24
ISbUEJZcYLedRgXKHCafVTAOBFMWNPQGD,FDABMCCA....PFBGGDGC.IGBHSGGCUGEGJACChAAAZBAD..LDEBhABAeDDGdAGDXAGDhAFAKADACHCAaFABfBCGABAD.OHDEBFDC.QGAChAGADAAE.EDHFhAIA...,2,-22,-13,9
XQNIfbOcUYeTRMgGSZLPJWaKdACBFDEVH,BBEAEGCDHAACQEFD..NFBD.fGDEOAFAUFGATBGChAAAMECC..gDBBhABASBGDPHAEhACAaCDCAHEBCBEHFFACDDADIADF...cGGDhAFA....hAGA...,2,-27,-18,9
OMXRGUcIWDZVAdCBLfJaeYTHgKNSEQbPF,CCEABAFBLAABaEFE..eCCBHGAC.KBGCEACEQFGHFEAF.hAAAOACBRFDBUCEDIGEAhADADGHHABHG..fBAGhABATDCESDGCMFIB.cAEBhAEAWHAA......hAHA...,1,-22,-24,2
UNBQPAgVbCKTSJYFIZXfRGHWLDOcadEMe,VAADKEGD..SCAEFHDAZDDA.RGDEHEAFLAEGOADHdGCCeCDGhAAABHCDAIHE..CHGH.TAEFhAAAJBHB..XDAAhACAfEEE.DEIBaGGAMAIB.NAHE.PFAFhADA....hAFA...,2,-16,-15,1
NMAfbeDWKTEYQdGVISJHZUOBFCLPRgcXa,eGEADGHHKACGEAGE.dEEBGGCB..IEAAJDDCHEADZACGBDGBhAAAFGBELAAF.hABA.gAGAhACAaCDBAIHAfCEFbEFA..WCCC....hAEA......hAFA...,1,-18,-30,12
UbIaDCXBHOdKNYJZFRMAfWgEeLQTSVPGc,...fHBHEGFCQCBC.VAEGPACBGDEFUGEGaHCEhAAAXDACBHHCdABFKAAFhABAJECBFAGG.RCFCADDGeEADhAEASGHD.IFCHDAIF.CEHD..hAHA......hBAA...,1,-8,-13,5
RBKIXNFLAedPOGYZbWTcMDHQJVESCfgaU,dDCDGECFZAFA...TCGFMCCEDAAFHCBA.QAEEJDFD.hABAEHFECDAH.aAAFUGCABEHHhACAKGAFNIBFAADG..eHEGhACA.....OCHBWHAC.SGHBhADAfGGB...hAEA...,2,-34,-2,32
QGgZPDULFbRcOCEHNBXYITMAfSeKWaVdJ,eCCHKAFB..aAAFdFGHGDEGZGBCDIACLDHHRBAH.CDBH.HAEHBBHEhACAXCGH.IAHAhAAAMBDBADAGSHAChADAJHFA.PHCCFABAcEDG..hAEAEFAE.NAEEfFCBhAFA.,1,-7,-31,24
UBADOPLNYbJQdMfgWcEVXKCRZFaeTGSHI,DEFHOEEGLCCC..bACGQGBA.dADDMAADfEDGhAAAcFGEEFAHKBACZAGFhABAFFDH..eCEGSHGEhACA.IEHDBDCGAICG.PEABhAEA......hAIA...,1,-22,-23,1
SPBfOIGWZNeVJdcRQTMEUbCHDXFAaKgLY,aAFBLCCH.SAGDBEGEOECBGBAEZBADeDEDdHBHQGGGhAAAMIAE.EACACAHHDIFGhAAAAGEAKAHB..gACBhABAYEEEfAEAIGGD...hAEA......hAHA...,2,-36,-9,27
CWSBYJaAVGFENDZUHbMcPfgRQOdeTIXLK,GBCHFAFBEEDH.DIECUGEAMIAE......PDAEfFDHhAAAQABEODFCeBHFhAAATCACLHAEhABAKGFGCACABAHEaGHDACGF.........hAEA......hAHA...,2,-28,-20,8
WcVJeMfEgATLbdIOaYUXNPDSRFZQGHKCB,TDACdDCDOAGD.UFCBXGCA.DGBCSAEFRBBE.hAAAFAABZDEE.QAGHhABAKDFHBHHG.WFGBJCABeFGFhACAEGADAFIB..LAFDIGACYFFFhACANDIA.....hADA...,1,2,-34,36
bCSUOAIRegLPdENJYQaTXZfGFWKHVBMcD,RFDFeEEGLBHDdCACECGG..JAAC..aDEA.ZFBEFAFHHABAMCDBDEIHhAAACGAE.OAFE.AAFE.hABAIEBG..hADAgGGEPFHB.NIAB......hAEA......hAGA...,2,-42,-7,35
IYdcJgGOVNCQTaeAbBWRSXHFDMLZUEfKP,BFDGRDAGHADCFCDBDEHHZDABUGDE..EBHBKCCE....IADAhAAAdHAHJAAE.OEHD.hAAACHEG.aBHBAIBA...SEEChAEAMFEC.fGHAcCFF..hAGA......hAHA...,2,-40,-32,8
VgaKcTNZeUBbOQLSDCPfGAYIWHJXRMdFE,..IFDGHFDFJBHFRGDA.dABC.EADA...aCECTCCA.ZBFDhAAABGHHQFAAhABADDAHfDCBYBCCXFFFhAAAMAFEFCABKHAANCIC.......hACA......hADA...,1,-16,-25,9
EDYfcMFCOPABLGWeQHKbgIdaXVSRUJTZN,GACBeDACKDEF..IHGHaHEG.SHBEUADDZCGDEAACDCDB.hAAA....fGAHhAAAMEFHCDGHADFCLFAChABA.WAHB.......hAEA.bFDCXCAChACA...,2,-36,-28,8
KIDRdYGcECTPXZBWbfMFQLeUHAaONJgVS,OCCHJGEA..SCFHDFBFdCHEGAEG.EGFBTBAC.hAAAXGBFBAHHbBAFMEADhAAAFGDF.QADFhABA.eEDGAADBaHAENBIG.......hACA......hAEA...,2,-27,-27,0
GceEBMfJNXPAadVULRFKZObSCDTWYIHQg,aEHBUCCBLGBCKFCFZAAC...SCAFDDIF..TBGDhABAIGFGHGFAQAFEhAAA.GDCBhABAeFADBCAEfCCFNAEHADFDdGECFABE.CEAHWCFGhAEA......hAFA...,1,-17,-24,7
AZFbLYUKWEHSeDdXICQPORaNcGBgVfJTM,ZDAGLCCHKADFHBGHDBIFdBFCCCAC...QFEDRGDE.aAAFNFBDBGBBhAAA..fHABhACAMDGHAAHC.FDAE.hABA....YFHFEGABSHGAhACAIGCE.....hAEA...,2,-33,-28,5
gaGcBITOHQVSACEPNJDRKLMWUeYfXdFZb,EEGDJGEA.RAED.KCAELHEE.UBGEeDCD...XAEHhAAAZBAFbGAC.aEAHBDED.OAAAhAEAHCGHSHBChABA.AAHACDDEDDDB.MFIFfABFhAEA......hAGA...,1,-16,-33,17
ZERcAOPYUGHWJFdQbCMBTDgVfIeKXaNSL,OGEAUCBCGCGCHDCBFCADdGAH..CGHABBDBDGBF..VAFF.eEEEhAAA.....hAAA.aEDENDIGLABAhACAZAFEEGDHAGFA...........hABA......hACA...,1,-18,-40,22
DcLHTCbQafXNZUJgKYFVdIOMAWPSeGRBE,SHBGeEGHRADFBCHFDEFGHAAF..CFBAQADAaDAE..hAAAfAGCXBBGNDEAhABAJFAD.KDFBFAGBIHHHhAAAACHA..WFFCEFCC.LDAA.hACA......hADA...,2,-25,-23,2
PBCJcEHbegOTFUALWKVfSYQGZRdXIDNaM,KDCDVDAG..SDDBQFFHZAEAdDDADAAB..MBIDBHDBCGAD.hAAAEHGEeBCE.TAFGhABAFBCCABIBLDAFhABA.fHAHYHDA.XGEFIDGChACAPCGB...hADA...,2,-24,-21,3
BFAgOZUERKaNdQTXHWSfPbJeVCLIGcYDM,OFBBEDAFKHAC.dCCF..QECDHGDASEEG..fACGhAAAJAHD.CHEAIEHHhABAcDFFDIFCMADChAHAAABAZAAEaCEA.XEEBWEAE.eBBB.hAAA......hAEA...,2,-30,-15,15
CaAHYIFMZbKXUfLcPEdOVQSJGBRgWNDeT,HAADFHBGZDBEKAFEUACGLEBB.EACGdCFDQDGCGAEFBEFAhAAARDDH....WFHHhAAADHFA...CHCAAFBBIEHAhABAMCDG..fCCEOFEBSGGEhAFANEAA.aCBC..hAHA...,1,-5,-34,29
AcJbMfZRKLSgVQUOFGTPEeYCDaBIHWNdX,JGEAMCCAZCAFKCFH.LAEA..VADAOEGDFABG.GDAFhAAA.EHDGeAHH.DCCFhAAABABDHDECNAIEAGAFfGAFhAGAREDA.SHBA...hACA......hADA...,2,-26,-22,4
UNgdAMZCKGHeOPfcLYaIERQWVFXbTDSJB,MEEDKBBDGCEEHFGFOAFF..PHCCLEBD.aHDCEDCAhAAAQABFFFHD.hABAXBDDTAGAJFBEhACABCAGNDAE.AAIBCFCH.fFFCYACG...hADA......hAGA...,1,-9,-24,15
GJObeICHgYFVMdRfUDZELSTXQWAPBKacN,KEGDaHBGGAFAODBE...eDCGCEAGHAACFFFFdABHRFEB.DFBAEFBCLEHDhAAA..XGBAhAAAACADBHDA.JAGBIAEGhACA..YEHBMAIB.fBDFhABA....hADA...,2,-30,-18,12
GMCWgSZHVOBadNUYbJXcPQEfRITKFLeAD,GGBDMBFH.CHHG.SACGHCCBBAFCdFFGUFGF..JCHDXCGEhAAAQGAA.ECCAhAAAIABGKDAGFGDDAEDHDIAAhADA...gEAEOAGB....hAEA......hAHA.aBGG.,2,-25,-24,1
RHgLSMBJPeKcNUXabOZQdVfCYWDFGEIAT,RABHHFDFLGCAMCBBBHBCeEAD.KDCBUEGA..aCFAODDBZFFBdAEFhAAACAHF.DEEGFBDE..IHHEhABAABAG.TABHhADAJCFE....cDAA....hAAA......hABA...,2,-31,-20,11
bMFLSdPNOfYeQTXZKIHgGAaDCcRUJEWBV,aFGEDAEDRAGB..UBEEEDHF.BEGB..MADBLHBEdGGH.OCAGhAAAeDFFQAAChACAZECAKBGB.HGCEAAIHJEAD.hAFA.WFBCFABE.SGAD.fCEFhAGA...hABA...,2,-34,-10,24
bdLRKMgWHABYCIZSTVPFQUXEODfNGeJac,CBBDZDAG.SABE..PBEEFAHFUFCBOFDCDHGGGBCDhAAAeDHD..JDAFaDFAdDDDhAAA.KABEMFFDHGFCAGBBBCBDhAEAIHAE........hAEA......hAFA...,2,-30,-26,4
FfdVHOWLRJUEYgPbBSaAeINMTGcZDKQCX,eGEAMCCAGEEHZACGDFCC.KEBG..QGBHXBGG.dDGCOHEEhAAALDABUBAEgDDEhAAABAHBAHHE.NIEB.CAEEFDDEhABA.HGAE..JAHF.....hACA......hADA...,2,-14,-14,0
bQXDfJMNdPcUVAIFOLBeRGETHaCgKZWSY,OCCHLEGHRDFBGBDHTBBD..HEEFaFAD.KGCBZAAB..SDBGhAAA.YEAFhABAbEDDDIDAMAIB.hACAdAEBPADE.cCGAAIHGBHBA.CGHA..hADA......hAGA...,1,-14,-20,6
VWceaUOGKFQHgSTZXYBDPfIdLNCEJRAbM,MECGVAAD...eAAEUCGGOBEAFDEDHGFE..TEACZDAABCDBhAAADGAD...PFAFhACAIEGB.dGDGCFCDEAFHhADAACHCbFFG...aBBHKGDB.....hADA......hAEA...,2,-28,-15,13
UTXCBgJcQfFSHIeYDKMaALERZbONdWGVP,LDCHRBCF.ZFABOHAAdGEBGAEHUEGGCABGBAAC..JFBAQCAAhACA.FFHFhADAHAEDeEEADIDGMIDGhAEAEGFB....NCAA........hAFA......hAHA...,1,-14,-39,25
bcQTCgKaNeAMXULVfdGEDRJOHFPYISZWB,XGABLADGdAAAGCEAEEFH..DAHHOAAAFFDF...PEHHhAEASCCABEBBbECHhAFATGGH..CBDBaBBChAGANIAHAIFE.MICA.fAHEREABJDHF...hACA......hAEA...,1,-7,-24,17
ANaWKLOZYBCTgISGVMReHfQcEDdJbUXFP,aHBGLCCHZDCF.BDHECBCD...IEGDGAECMAAFeCEHHGDGhAAAQGEEDBBFdGAD.hABAUGGAPEFCAEBANADB.KAGHhACA.TEAE.SGHDfABB.hADAEBFE.....hAEA...,2,-18,-11,7
EAFZDgaMBTKXVRHLWceGJfPIQbCOUYSNd,ZFFADGHHMEAGBHEBKACG..RGDEHAACLHAEeCHHGCCA.JEFChAAAfBDF.hABAPAGBbCFA.CDDBOFCGhAAASAGAEFABADACFCAE...TEAEhACA.XAEF.hABA...,1,-11,-19,8
fJLYDIKdWZaSFBVegXEPCTGcHRANbUMOQ,UCBCMIFG.OAACQGDFLGFCDIBEKDCEdAECZDDBFABG..eBHFhAAAEAHD...CAEGTFADhAFAHGAERCFFAACE..fEFGhAGA.ICFFWHEABEHA..hAAA......hAGA...,1,-18,-20,2
aHQBEAZFeNXPIWYDgGcCLdOfSKUVTRJMb,ZDEDeCCH..XBAGICBCDHAE.GCGGLAHBdBDHSDDHhAAAVEDERGEC.MEAAhABAaFAHBGCBABIH.PAEBhAAAgGGG.CFAHKAFC.....hABA......hACA...,1,-14,-26,12
eHEOBAYQFcMVbJaNWKfGDZLIPURSdCTXg,FGFCMECG..JCDEaAFE..KFADDGGCLBBHUGCE..RABAdEAECHCB.hAAA...TCGChABAeDFGEHFEBEFCAFFE...hAAA...YCDE.....hACA......hADA...,2,-53,-26,27
BUJTDfceFQGYOMWLgaHZAKVXRNCPIdSEb,XCCBCFDDdCAB..EDAFBGBG.UGEBDGFDeCECFEABGCGA.hAAAMACELHBA.hAAAgCGAaBBBABAF.hABARDCE.IHHHSABETCEEfGHAhAEA.cFBC.hAGA...,2,-29,-20,9
FeGaIEcTdgVHPbNLZfKYCUBOWDSJXMQAR,RDEDFHAEeHBEGBBA.EEGGdBCH.HAGB..bFDHLFAD.hAAAfGGFKBGDUGGGBGAChABAOABADDFBSFCGhAAAMEDHACAFaAFG........hACA......hADA...,1,-15,-21,6
dDZRFNfEVbWOAKHCgPQBJLUSIecMaXGYT,CCAHQCBCLAFCUEBFeDEH..MIBEGCDBdACBDCGHFHGA.EGFD.hAAA...bABFAAGHgFCDhAAABGEF.IBHAhABA.aFABTEFE.NCIEfGCEhAEA...hAFA...,1,-22,-24,2
XTCfMWDFRKSEGZJdOaegNAcbILYVQUHPB,..IFDGLFBB.VACBQFGCUFFCHCEEXCEB.hAAATCCBCBAEMAIBFEADKAGHhABAEGBF.JHDCOFABhACAaCABeAAE.ACID.........hADA......hAEA...,1,-15,-20,5
IWXFGTOYbEPCfBHAVdRSKDcNQgJeZMLUa,dDAFRFEEDBDGQAAB.eFFBLDADUAFF.IHACFFDFOFHFhABAEHEE...PGAEhADAfBBE.AIHESCGDhAAAKCFHNIBD.JECE.MDIHaDDC..hABA......hACA...,1,-9,-36,27
NPLCYJVRfHMUcbKFAgXSQWGdODBEITZea,SGFCQFGHdDBGOCDHEEEE..ZACFaBHDLGCA.CAAF.hAEAJFBDRAFE.HAEEMFAHcBABhAAAKDFCABCB....hABA............hACA......hADA.WFDHDDIH,2,-29,-15,14
KAFJSCEfLWDQgZGMTXHOYcVUIdaePRbBN,FEEDCDGFLBBHDBHFZGEE.GEBH..MFDHTEGEHBCH.OBBHhAAAVAED..dAAGaHAC.hACARCFB.NEAA..AHID.EAFHfDDBhADAQFAA..YHCE.hABA......hACA...,2,-21,-9,12
OIQBgGdYZHAFLMbEVCfNeWRDJaKTcUPXS,MEGFECFC..CEEG.eAFBDEBG.KEBDUBAG..SFDHODHBBFAHhAAAGABCZFCFAGFBLBDHhAAA.fFHAhABANAED.WEADaACD......cGGEhABAPCHB...hACA...,1,-14,-46,32
TVQLBKNUZMDGeRYXHFJOCbIWagAEPcfSd,EHBG..fDCDdDCGQAACKBFGZFADMFHBeFFE.RFDBHBAAhAAAJBGBOEAHCAEE..IAHAhABAaFFHABFH.SBEDhACALBDB.BDHFDIEA.XGGCWEHB.hACA......hADA...,2,-25,-4,21
VOgIDYAZbCERPTUdXMHGWLaQfcBKNJFSe,CFDDECFCRAFA.UEAC..MABGHEGFLFGDQADDBBDEKEDGFDECeAABhABA.OHAEDDCHAHCA.hAAAPHDAdEHA...hAFAWAFEfHDF.....cGABhAGASCCG.hAIA.IBBG.,2,-33,-3,30
XLHTURQfNIZDASPKbGdaVEFBgWCeOcMYJ,SAFBKHBGdAHA.EEBGBGDG.CGHH.OBBE.MIDEXDEHhAAATDDARACB..QCABhABAfEHEZBFFAHAFPGEChAAAaEAE.FHBG.WCAGcGAG..hACALABENIEFDAEE..hAHA...,1,-20,-21,1
aJMgEFUCXRfcOLTHNIbWPdYGeQDVBAZSK,ZFEEaDAB.JBGH..EHBGFBCEUDCC..CFCC.RBFA...OAHFHFGFIGEDhAAA..hABAPCABGACFDABDBFAHhACAADDH.SDHBKEEAMHAA....fGHAhAAA..hACA...,2,-51,-11,40
ePEdQOKDURfbNGHcTYBSMXACIWFJVagLZ,CFDGFHBG..aHCELDFAZFEF.eCCAEHACdBFCKAAGRGFA....NDAF.hAAAHAEG.TDAFhAAASACCACAF.JDHFPEEHhACADHGEUAGE..bFAC....YBBGhABA.BFAAhAFA...,2,-29,-6,23
CMdZgNALHYbXPTVaQIUScWJeOGRfEFBDK,LFBBHAADXCCATGECQFCB.UDFESDFBhAAAJAFGeHECRABGFAGGBHCDKECEhABAMEAE...dFAGhAAANDIA.AIHA...........hACA......hADA...,2,-31,-8,23
aMEDAUOYWVgTXRFPKJBQdcbHeGfNLSCIZ,UDACOGEA..VGACTCFA..RCCHFGDAKDBCBEED.dHBBHAEDhAAAeADB..fABDhADALHFGSAAEhAEAZAGHMFEEAGHA.WGACXGGGJAFE...hAFA......hBAA...,1,-13,-29,16
HPBMJRSFUADVCaebKYNXQcOdTfLIgGEZW,DFCFaBBD.eDBEKEFB.....XAACOBHFdAFALHFEGECEhAAAEEGBZEAFHAFGMDDCJFDBhABASABCAIAACDAD.hACAbFGDYCEH.NCIE......hAEA......hAHA...,1,-8,-22,14
cEKSLUeBTIbYGaZWHPgFONQAXdCVJRfMD,XGAFCHCHRACB.DEIDKFEH.UCAGBCCC...TAFA..hAAAIEDDGBDEWFFFhABAHFAEFHGG.OAFChAAAAEHFJEAA...fEHAcGGHEHCCSCFHhABAeACCaAHF...hACA...,1,-24,-34,10
JIUXYbQFTMORcfVeaCLKWPHSBdDZEAGNg,GAFEJGEA.UGFG..bBCHTAAD.MFDHRBEG..VEAHhAAACAEGKDDA.HCACBHDGdFAGhAAAEEHBABIB...NADH.IEHAhACA..YABF.OEDEhACA.....hADA...,1,-19,-25,6
HbgENZLKCXfVUPRIGYcSATWOBaeFdQJMD,TDACOAFBBCGD.FDCBJEFC.DBBCHBAH.EFEALHDEhAAA.XDDHfFHChAAAPAFC.GFABhABAYAHHAIHAaCAGQGAEMCDE...hACA......hADA...,1,-19,-25,6
XeSfFAdCIMYRPQTOVZGUDNJbLaWBcKHEg,CFEDMCCARBFA...QGADOAACZFAHDHDA...JEAAaECHBEEFhAAAHDEEEAGH..gGGBhAAAXCGE.SAGChACAAEGCdFGA.PHDE.....hABA......hACA...,1,-19,-38,19
PBDMIZXWdcbRaCSgAVEGOYFNQTfJULeKH,EBBDOFEFFGCA...TDGDUDFALEBD.HBDEBDCAIAFChAAAZAABWAEGdAHERFACCHGHhAAAAIFA......hADA.YHAGfGHEKCDCDAFE...hABA.MDIB...hAIA...,1,-15,-32,17
dNcMFTYVGIaBWZKfASPgQXJDELCUbHeRO,SHBGQCBCDDGHECAD.LAAC.UGCEeFCCRBDEdFAEMAFGhAAAFHGATBFA.YEGBhABAIFHEaCCHZFEHhAEAAFBB.XAGECHDB.......hACA.bABA....hADA...,2,-22,-10,12
bcEZORKIeBYMVLDfdGQHSUFgNJWTPACXa,CFCFaGFC..EBFHRBCGKFAEBDHA...MECELAHDDFGC.dAACGGEBhAAAHEECFGDF.JDAAPCADhABAAGCB...XAGFhACA.cACD.....hACA......hADA...,1,-31,-32,1
VcFDBMCEYabRPfOXIUNgGAZWSKHeQTLJd,ZDAGSAFBKGBAHFGFQGDALEEDdDFEFDACBFHECAGF.EEECaFBAhAAARGFG...OABChABAIFBC.UABDNCCHABIB.hADAeHAE.TCDA......hAAA......hACA...,2,-20,-16,4
BCLUKSONZIAHdVJcGaMTFXfDeWQPYgEbR,dDAFVFDFGEDC.MIFEFGGADDFF..QACC.PAGHhAAAYCAH.EGAHhAAABGHFUCCEKEAB.NBIAAABBhAEAJCHB...TAEGeHAEgDFAhAFACABF.....hADA...,1,-5,-36,31
TFcVENHegMPAYUWIRfOXdQSCLGZBaKbDJ,UCBCRAADOAEGdGHE..CCGH.ZECCBEFGKBGF..DAIDFAFF....EADDhAAAHFCH.MDABAHDC.hACA....IHFGhAAAfGHC..SHAAaGGBJDCATDGChBCA....hBHA...,2,-44,-36,8
LHQcOGUBbNVXKECJYfARIPgZSFDaWTedM,RAAD..IAFBZDEBDECE...TGCHeFHBdFBGLCFFQAGGhAAAGCBCBHDAbAACXEGFhABACDHG.JAHFfGFAhACAAIGESADH..WADH..hADA.MFAFOFHD.hAFANDAE.EFCA.,2,-28,4,32
MgZEabJXUQYPfRKTASFLBVdWICeHOcDNG,SEEDBDGFdEADCAAD.HBGH.DAAHGADEMDDHZGACaHEA...JFFChABAQGBC.hACA..fGGBhABARADFAIAGFCBF...........hADA......hAFA...,1,-26,-40,14
FdDbJBQfgRPcMaeXCTKESGVZUWIHOALYN,LGEAFHBGDCFFBBCAQDBB.RBGDMFDDaDGD..CFBC.KFBFGDDChAAAUADEHAAE.hABAAHIDdEEBfADDhACA.....cGGH.eAHD.hAAAXGED.SCBDhAFA,1,-23,-32,9
TFgDfeONVZCcSIWGadPLHJKEAQbMXURBY,MFFFUCCBBAFGFDCC.DFCEeBAA..OFGBVAFG..ZDGDCEAH..hAAA.SEBDhABAGAGEdGEALFCBKABFABDD.hAAAXADBRGAE........hACA......hAIA...,1,-22,-41,19
WGaRQHCePDZJVfAUNgFXSbcBTMEdYLIKO,UCBCFHBG..SDFHBHGEMIDGEBDGdBFDLAHD.IDDHhAAAKFFGGDDA.aGAChAAAQGGG.hABACFDEDBCBZCFEJACEfFAAAGBA.XCADhABA.....hACA...,2,-32,-15,17
HcURdAXWMBeFYVPTNGOaSQJKbgCZDLIEf,MFFFFDAB..VDFBTBEE..GBCHSDCEQAAFhABAKFACCHBHZDGBDEEDEHAC.HDBBhADARAACAADCBAGFeAHDNEIAaGDHhAAAJHDE...........hABA......hAFA...,2,-32,4,36
HdCYagcBGENTODWfULFbQeIJKAVMSRXZP,SAABXBBHHBFACFDG...aFFFBHHGGFABTGAGOECAhAAADACBUBDGLCAFQAGGhADAJFHFAHDAMABEREFDdDHEhAEA.....cGDENIAH....hAFA......hAIA...,2,-26,0,26
DgBHWCFOZUaLPJKdNfISTcYEQMVAXbGRe,XFGHGEDHDDEEHFDBCBHH.ZBDALEBF.KHEAfFAEhAAA.SDFAhABA.cEBCEAGAQACGhAAAAICE........hABA.eFCBWABHUAEAhBAAaDDGJAEEIGHC,2,-23,-22,1
KVMXSHcCdLWDUEaITPJgBAeONYQZfGFRb,eEEGOGEAQEBAZGAGFDFD.RACB.KEBAMHEEHAACdGAALHFAhAAA.DDAFECHD.aCABTBGAhABAJAFCAFIH..NICF.GBDEhADA..........hAEA......hAFA...,2,-15,-15,0
YTEWaZHNJeDMBbQgfKFURIVASdCcXOLGP,SEHBCFED.OFEHPAAG.EEBFZAEG.JCCDDDBG.BDFEhAEAQBACKHAC.FCGAhAAAIGGCADGFdEAELFGBhABAGBCD..YAFE...aDHHhBAAHGAC.MDFBfHCFhBDA,1,-16,-33,17
cNDWCPJFOHRIBEZXVeUTGadSYfbQMLgKA,DACBCFDGFCABRCFGBEFC..EGGCZEBD..eABBGEDGdHDF..SBHBhAAA..bDABhAAAMBGBKGGCAAHH..WCEDhACA..OAEHXEBB....hADA......hAEA...,1,-39,-40,1
ASVIQacWPeRbdOFCgfYGKMZEXJHDNTBUL,SCFCQFDHaFBB....PAFAbCAE.FACF.CEGF.gAABhACAGGDHKEAEMIDGhADAEEDGHFBADGCHBDFEhAEAABAG.IGGF.cAFH.eEEGhAGAOBHDYAHH.hAAA...,2,-25,-1,24
JeEHLCOBFQRTGWUVcZadSKPAIfXMbgDYN,XCBCMCCADFGB...JFCAEEEH.LAAACGGHBEHH.REACGAEFhABA.UGDFVBFCaCHFdACAhAAAKCADAGAE...IHADhACA...fHGFgDEE.hAEANIBBOGAE..hABA...,2,-43,-6,37
aFEYAXQLBZCeHDOWJbGRIgcUfVSNMdKTP,XDCHLGFACHAHDAFA..JAGHRABA......ICGAhAAAUFCGSCADdEAAKEGBaGEHhABAFBDCACAF.QAAEhAAABFFGeBDA..OFFA...WDDChADA......hAEA...,1,-30,-39,9
QYZIgHAFTBWDNfVROcPEGaJbSeUdKCLXM,FFFBBHHGDGCG..VABERACG..ODHFEGBBGCED..JHAESAHBhAAAdDCFLAAFhACAXEFE.QAEChABAIAHCAGHDWEEF..fBGGhAEA.aFAB...hAGA...,2,-33,-31,2
dDfYPXbBcUaGSTgOKLHCEJAWZQMeIFVRN,QFDHeCHDFFFCRDCA.dCEE.DIGA....fGCAXCGFBGBHhAAAaDBBGADBSACHhABA.OFABhACALHFGCDDCABEGMCBHIHAENIBH.YABEhAAA..PFFA.hAGA...,1,-15,-24,9
dQJSAHbaBPKDMLWYcUERTgIONXeGCFZfV,HDAGBFEDDBCHMDFFLGAG..WDHBUBEH.RDBC...TADHhAAAOCGDeACDCHHF.hAAAZFCDdADBJAGD.AHGCaGAEhABA..PBAB.......hADA......hAFA...,1,-19,-39,20
JSQOYTdXACRbBKZfIVMGDeNHgPFUWLacE,RDBHKEGDZAEA..VAFAMFDHGCCF.DIGEHGFA...gBCDhAAAPFAH.FGACLBABhAAA.aACCEFGEhABAQFCEOCABdGECCHEABFEA.fCHAhABANAIE...hACA...,2,-16,-14,2
INQScJbTLfMaeEYUFGXAZBKWDCdRPHVgO,KBBDDAEDRCFEHDBD.OEHDQFCE..JHEELAAEMBFCEHCAhAAAFFAH.AGGBBBBBdAECVDFFhABA..NIBH...hAFA.SCDDbDDF......hAGA......hAHA...,1,-12,-40,28
cPJaZMTdRAUOHCDVQWYXSKLBgFNebEIfG,OADGCAAFDGEA...QDDG.XBAGSGBCBEGChAAAFBFCeBFEIDBHhACA.GACEcGGFJEFChAEAZDBFMIEAdHAFRGDEADFG........hABA......hACA...,1,-14,-42,28
OAJeHcEIDXfZSdbWaLTQMKCVNYUFPGRgB,HFBGEHBGDAFEZACG.dEAB.aHEETCFA.KDDDVDDE..UABBhAAAFBHD.RGFGBEHDAABAeFHHXAGAhACASAGFLFCAhAEACFGE..PAAH.....hBAA......hBEA...,1,-10,-26,16
JObIMLGRQTWCAVPdZceUafKDYSgXFEBNH,VDAGdCFCZEEA.UDAHKFCG..DCCE..SCHDFGHBBHEGHAFHhAAAOAAD..MEFFRFAEQGDEhAAACCHE.AHBH.hACAeABGaGGH..fCCBXDDBEFAB.hADA......hAEA...,1,-26,-27,1
bDGLdKMYRHJeWAaEZFfQSICXOUPNBcgTV,aEHBEEHBFEAC..QBABCBGA.XEBBUAAFBHDG..hABATGEGDDGBGFCBhADALADBKBDCMCDBRAFF.hAAA............hABA......hACA...,1,-30,-41,11
TefPCFIQcgASRDaKUGYWdJZOBNXLEMHVb,RFFAKGCDUAAFGDDG.dCDBOFDHBAHALABHHDAF..TAGDhABAeHFACFABFAEB.QDEGhADAAGFEDGAB.aGAE.hAAA...WDAGNIEFMCIBVDGF..fDCBhAGA...hADA...,1,-4,-31,27
KeWagULEZdDBFJRVcGYNbXPSHCMIOAfQT,QCGCTGGD.KFAFaFCDLACFZAABDBEHBHEAJBEB..VGBAhAAAGEEB..NBBA.bBGFhAAA...SEAFhADACGHBIGFEAHAC.fADFWDCG...hAEA......hAFA...,2,-25,-25,0
XGFDRKWcfTQENLJUSIAaYdBPVZbgHeMOC,aAFBBFEDZDGFHBFA.OEAHGECHFGGBRGBAKCCE....fDCChAAAEDBHJBAB.ICBAhABAAGGDdAAB...PDHFhACA...VACEeAHBMFDFDIFA..hAFA......hAGA...,1,-21,-24,3
OFTIHUYEGXCgbZVBNJcLaARQSKWMDfePd,SDAFKGFHMCFB.eFCHOEBB.FABDHABA.UGEFGDGEhAAACECFZCDFBHADJFABaAAHADIDQGDEhABA.DCGAhADAdCGETADFIHHAEDCE......hABA......hADA...,2,-18,-17,1
ZKEAQXgNTSRHVMYCUPBDeadIOcLGJfWbF,QCGCXCBC...TBACRAFGMFCACGHBUDCEDIAGdGGB.OHDChAAALHBEGADEWDADhAAAFDGD.EABCAEBDSFDAhABA..YFAABCEEIAHGhACA.JHFA...hABA...,1,-12,-20,8
LPbYHXAcaCRDFeGNIKSBTMgJOEVUfZQdW,CFEDDGDEFCFBGCAA.KEFABBGE.MDIFOHEA.UACEQBBDhAAAdCFHLAFA.hABA.PEBH.HGFAhACAADED.aAFGNCIASAAG.JHAAEDGFhADA.ZECF....hAEA...,1,-22,-25,3
fJXGIgAaDTLZbVQWPKMOUeESHdRFNCcYB,TCBFLFBB.VBAFQDGA.KEDBMFFHOFFHUEGHEFBBhAAASAAEHAFAFGGANABFhAHACBHEBHGF.XCEGhADA...IAECaBCADCFF...hAIA......hBAA...,1,-10,-28,18
IbXPKETDFSMafRWNgZYdOAeLQcVCUBJHG,eFCALDACQCCEVFBE.CAAC.BABFJHBC.HEFBGAGC..hACAIBEGXEBGEAGEhAAADGAHSFHHhADAaGGBfBBFNICF.........hAEA......hAFA.ZCEGdAED,1,-8,-17,9
PFELdUKZgYNaXfTOHbIVWRQMCAcGDSJBe,GDCCJEACBHEAeCAH.EHGELAAF.KHBC..YADAhAAA.aBHHfFEAhACATEGFHFAFVCDHRABDMFFHhABACCGBABCE.cCEFDHGCFAHF.....hAFA......hAGA...,1,6,-39,45
XNbgZdEWKcUfMBDLFYHRJGQCVPITOSAae,aGDDeDAC...XGCA..gCFGZABCdCFEEFAGKAFGUFGDhAAABGFBDAIDFCCA.HEBHhAAA.JABACHFDIEDEhACAOEECABID..WFADfAGE..hADAMIFC....hAEA...,2,-33,-20,13
HYaGBNCAEMWgdXecJQSPKZOFLIVTUDbRf,EGFHMCCAdDAG..XGBEeBBA..QEDBKBGEFAAHLFEEhABAICFDUDAH.DIEAhACAfEHEaGGC.hADABHDBAGAD.cGBHPDFAZAGF.OABGhAAA......hAFA...,1,-21,-22,1
DCMUAGfIOQTXBVZKeNJdabLPcRHEgYWFS,GAFEOGEA.QFACBAGCZCFFKFADJDCEdGGBLBBARBBA.HDAEhAAAEAAE....YHBGhACASFBH.MBIDhABAAAEHIDAEXDDF.eHBANFEH.aADG.hADA......hAFA...,2,-16,-11,5
XIHgJbCFaYOZEVQLRdTWUNPGecASMfKDB,SGFHMHFGDHCABAGAHCCC...JAAGCAAFFEAGOEBC.EFHFQDFBhACALAEETGBFhAAAUBBD..NGDF..hAIA.eFEFACGB.KBGFIGAEgDGF.hADA......hAEA...,1,1,-48,49
ZOFRXTaVWdNUMEKPLbYgeSfCHBIJADcGQ,DCECQAGHZGFCRABC.aHGEdAFH..UFDAEEGG.KDABLGAG.hAAA.gBCHhABAeBADSDCBHDECBCAFhACAACIFOHDCTFGE........hADA......hAEA...,2,-27,-19,8
NCegUADTcKMEOVSdbZWFfIXQJPHRGLaBY,DAFBKGFCMDBFEGGD..OHBAdHCBZECE.FCDE..XBCF.hAAAQAGAPAECRABBLFHBhABAaAAFBFHEYDEEhACACHAH.UEAHcDGGSFFFhADA......hAEA...,2,-26,-23,3
TUbGgNEfFDQaeAMdSVXZWBHcYKIPLOCRJ,SHBGXBBHZEABBFEAHDGFKCDBLFDFRDFG.UAGEGADDhAAAEGHHDACAQDAAhABA.AHGGMFIHdGED..hACA............hADA......hAEA...,2,-31,-19,12
IcFHNLTJdXGgQZYCDeMUKARESOVaPfbBW,RFEEEEEDODBH..aGCA....bBAEIDFCHGCELAEDhAAAdCAGXAFFGAFEZEAEhAAADAIBUBBEAIHG.VGFAhABABEECFCHHNDAE..........hACA......hADA...,1,-9,-16,7
JYTdAgKGaIZWLcOUXPHEeRfVMQSFNbBCD,GEAHaCFCZEEB.LDHFUGCG.XEEDHCAFEGHFRAEC..MBBHQCCEhAAASHCAFGAHBABFhADADIFATCDEAIFGKADA.hAFAcABA.........hAGA......hAHA...,1,-6,-16,10
TOgLeZaPXIbGVNDHfUBRdAEWMQJScYFCK,EGFHQFDB.JAHFSFEF.FACBKEBHOECBeBAHZDDAhAAAaDGC.IACDhABAGADEDFGAUBEGBAGDAHFDMEIDhAEAYFAHCGAH........hAAA.LBAF.hAFA...,1,-16,-24,8
ZdeacECUPJMVQNDOTXBYbWLfGRIAgSFKH,SAFBFEHBZAGHdDFG.eABC...aEDBEECAUFGAMCBF.QGGFhAAADEFAOBABBADGhABA..bCCC.fGDFhAAARGBA.IBHDACEDgAEBKBDE.hABACCCC.JHAANCAE....hAHA...,2,-20,-19,1
FfZVILKNBGbUHDceaPJQOECdASYgRTWMX,SHBGRAADMBGD.FDEHZEBELEGFBBHEUFGBHACG.DAHHeADAhAAAJCAE......hACA.EHEGAFAFTFCChAAA.WHFA.........hADA.fCHEhAEAIFHEKBFBNIAF,1,-31,-42,11
bXZKQaSGFLUCTYHAEWdfMgBOPVRecIJDN,EAFBdHBHMDDGBHAC..OEDHRACG..eBFCJBDF.DFIB..XGEDhAAAZGEEQEAHhAAA.aEEDFGHHUCABCEHFTDABhABAACHC...fCFGgDGFcABBhAEA...ICHAhAGA,2,-31,-25,6
PWASKLeDVbgfHRNYCcOJaZETGFMIdBQUX,SEEDLFFBeCBHDDFC...VFDB..fGGEhAAARBGFCGBHOADEaAGE.EBDHFDDGdBAAhABABABAXGABAHIB.hAAAbFCDNBAE...YEHH.ZBFA.MACDhADA.....hABA...,1,0,-27,27
DYGNUgWXfMFZdSCeTIALKPEVOBaJcQRHb,KDCDECFCBEEG..aEGGJEABQABE.HFEBDABHGCADhAAANBDF.UFGF.XFBDhACAfFABMAIDhADAdAAC.SGGBeAECTDGCAEECLFDDhAEA.....hAEA...,1,-12,-27,15
JgYQeBZTDKLOGMUXHRdPEFVCaNSWbIcfA,JGEAQCBCZFAE.DFBHKCDDLACEGADD.UGDFHCFFdGHAFCAFCAGH.hAAA..aHCCSDFEhABA...IBDDhAGAABIFgAAE.BDHBOEGB.hACAXEDB..hAIA...,1,-23,-27,4
NMXeOFIbTUBcHEQaAWgJYLfPdVSCDZKRG,JGEALGEA.dCGCSGAFDFACZACGKEDGGAAD..XAGEhAAAFEEGTBEA.BDAFhAAAECAHAACC..WDCDhABAfHAB.CDCEMFIHIHBF..hADA......hAEA...,2,-41,-30,11
WBcCNdRfYSGZbPOXETLIDKAeJUMFQaVgH,eFCAUAFHMHFGFCCH..aBEFHGAE.BAAECBDDRDFD.SEDHhACAZGCE.ODAHEBHDLBAFhAAADBCHKBDDADFBJFAF..hABA............hACA......hADA...,1,-25,-35,10
cbPQUFKLaWOYESXGfJTZdMgANDeHIRBCV,DEFHeFBBHEBDBDBFCABC...VDFC..PHDEFBCCLAEBhAAA.aBHFODCG.hABAEBECSFFGhACAGBGCTGGHMIFAAGAHIBCD....hAAA......hADA...,2,-31,-24,7
NFcYXMCaQbfLATBdVHGKOEgWeJUZIDSRP,TGAFdGFHGACG.OBHHEFFB..eCAHJEBFZEDBSAAGhABA.PCFGFAFDXAAFhAEAMADHCCED..aEHB.hAFAbEBAAIAE.BAGFKFFC........hACA......hAEA...,1,-16,-28,12
eZBAVYgdEHISaQFbDKWcfXMUOPGTNJCLR,VAADdHBHEEAB.HCCE..aGBFQGFFFFGFKDAF...WCEEhAAAXDDHUDGFOADChABATBFF.CBBD..eEEFhACAACDGIHEEDAGA.MAIB.....hADA......hAFA...,2,-33,-8,25
CbaPdFSGKJDNfTgQcBEYUZVAHOLeMRXIW,LFFCMHACRCCC.XDBBCABE..aAFCFBGFGGEBKDAF.DEIBTAAChAAA..QCGFhAAABHEGEEDFUACEhAFAABDCeDAHIHHG.WHAEdFCFNIBB...hAGA......hAHA...,2,-26,-18,8
WERecDFQaBTLdZVJKHNIgYUObCXMAPSGf,GEAHEHBGRAFB.DDBCQBCCBHHEdFFGZBGBKDEAHGFA..IAAChACAUEAEOFCG.hADACHDBAABDSDHHhAEA.eBEFFAHFTEGELGBA....hAFA......hAGA...,2,-29,-10,19
WHKgGeVNaEXCPdORSBbDMcAQFYUJZfTIL,FGFCUDACZBFG..TDGFLAAC.HEBBKAHDGAADeHBAaAEGEFFDhAAA..CEFE.dGBDOCCFhAHASHGADIGGAIEG.QCEBhABA..fBBC.hADA......hAEA...,1,-20,-24,4
bVCLcXKPREfeQHdOTMZUDagJSAGWBIFYN,GGDHBFDGFCAB..bDEECCEALEFB..XFBGRFAH.hAAAfABAeBBEQAGBhABAOADBMFCGhAAADIEGaDHB...........hABA.SAFEhAEAAICA...,1,-31,-34,3
QXdMVPfDGSRBObJKITHagWLUNZcCEFAYe,eDACQFCAMDGF...VGFEDBAEGGABBCAEODDCKADGHECEhAAAaBFG.LCECZCBBCFADAFFD.hAAAdGHA.fHFHhABA.SBGEJABAICHF...hACA......hADA...,1,-10,-24,14
bEgDdfIeCPBWcNUKaRGMYAHXTSFOVZJLQ,XDCBSFHBFDGDZAEG.LAAB.QDEFgAGDhAAADGCAdACDeHEACHGFPGDAhABABCHCNACF..aAFHMCCBhAIA.AFDC..........hADA......hAIA...,2,-36,-17,19
PJEBDgZacbXAMTKfILWRCYVNGUdOQFSHe,TAGDKHBGLDAG.RACC.CAAC...VDFHNEDCGEFA.dEAFFFAEhAAA.eAFHEGAADCCCaEEH.hABAXCDAADHG.MEIHhACAIHGH..WBBC....hADA......hAEA...,1,-26,-27,1
DUANYVfeBOWSXLMZcKHRaGFJQEgbIPCdT,VAADeAFBOCCG..SHGAMEFCKHAGHGFGGADBJHCAEGFHhAAA...IDHChACAdEDADDBHAACGfECGhADABAAF.LDDGcAGA.FFGA....hAEA......hAGA...,1,-15,-22,7
UEgbPHSYeXCGAfTdaJZFcBQLVRDKWINOM,dGFCaDBDZFGDFCFBBGAE.LBBGDHCCKGAD......IDDBhAAAOHAEMAEEUACAEDGEhABA..PEHFhAAASBBF.XFEECDGAfDAB.hAFAcDDCQAFEhAIA...,2,-37,-36,1
AGZCKgNBTUeJFLMadbQPOfREVSYHXIcWD,GCCFKBBDBDDAeAAELCFCdBFFQEGD.OHDGEDGESFHDhAAAXEAFIHAEhADADFAGAHBFCCDF..TFEFhABA...FAECaGCB.....hACA......hADA...,1,-10,-43,33
NLbHgUDOGIJZaAFBQWPXTeVSEfRMCKcdY,FFFBQGGG..PEAFeCBHSFBHEFDB.MEEGhAAACADEKCHFdAFDLECDhAAAHADFgFDCOBAAIGHDhABAaBAFAGADBEHAXBDA....hACA.fDDBhAFAYHCG.NIBDDAIF.,2,-20,-1,19
XHWcMKJLEGfdVUYgCFSNbeTPBAIDOaZQR,DEFHODCHQADFREDHHAFD...MCCFKABCLHFAEHDCGBFGdDHChAAAVGAEUBBF.CDEBFFADhAEASBAH.eDDHhAAA.PHFCBFGDaHCCXEGD..hABA......hACA...,1,-7,-14,7
bUAXTeRVEYKBNJPMZIaGSCdfQLHOFDcWg,XDCHeADGEFDHBFHE..JBBCMCFEaCAF.GDEH.dAAGfFGFhAAAQDBFHBGHhABAOFADDGIFgGDBhACAAGHB.TAECYHDGKGAH...hADA......hAEA...,2,-24,-13,11
YcPTOFQZJdIEWbCVaGMNgXSUfABRLDKeH,BEFALAGHDCDHKDAAeDCH.HBAG...PFHHOBFHQEEEhAAAZAAGJEHB.IDABhABAEGCC.CHEEaCEBMBHDhAAA..gFADUGAAAGGF.....hABA......hACA...,2,-45,0,45
gTUMYSdcQGAKBDHbXNECfIPLJaVRZOWFe,KFGEBFCFHBDC..NDAB.CGHA....IDDFJAGHRACG.ZFAEOEGHhAAAeHCC..UBADSGDHhABAdCHE..QDADhAAAAHIHDIFA.EFFBfFAG.hABAPDHD...hACA...,1,-18,-44,26
AeIDgYENGLMRfPCVTcXZdKUaJWBSFbQOH,eFCHDACBEGHBGEEG.LCDGRCDCCEHF.TDAAZBAHUAGC..hAAAJABEBEFCFAHDOFABhAAAHFBGABFE...IHGGhABANEAC.MDIFfADE...hAFA..cGFC.hAGA...,1,-14,-30,16
CfJBYXKQNabeDgWGAdUISMOLFPVTcZERH,UGBCSGFHODEDFDFA....TCABZAAFRGCECBEDBABG.KGFHhAAAaDCD.DAIFGAEDhACAdAFDLEAB..hACAcCCEfFGB......hADA......hAEA...,2,-35,-29,6
SgBGUEFLDdAIKCefNQHTVMRWXbJacYZOP,CFEDeGEA.QAFBTCDBRAEE...bDDGJCHB....aFGAZDADhAAASAABBHCAEGGGDIGAhABAdGADAADEKABGNACCMAIBhAGA.....XCFA...hADA......hAEA...,2,-39,-5,34
bKVJeMdcOWLYfGDTSRNEIBgaHUFAXPQCZ,XCGCCHHGKDHB..eABDdDBEOFCCLFDHGACDDCGF.SABFhAAAECEDBFBBHAFChAAAAIHEZGAAJEHBMGFG...hADA.WFFBfDAB.....hAFA......hAGA...,1,-22,-28,6
RAXbKDILVTZOPgMeJUNcGWHEQYdFSfCaB,KGFCDEFHLCCCZBFG.OABEMCADUECAGGEHHFAB.EBCBdGADhAAA.FEAFCAGF.RDGBABAH..hABAIEHD..hAAAPDDF.........hABA.JHDANIBD....hACA...,2,-32,-20,12
YPMNUIBcWLJKZAHfbEGFRXgVQeODdTSCa,HAADEHBGRCAC.XAGE.QFCADIECSECGaDAE.MFAHhAAANDIEBEGC.LAFFhAAAZBGFABCCGAEEFHFA.gFFHhABAOADHCEEEPHAEIGDF...hACA......hAEA...,1,-2,-20,18
JWFeXRQIMSGUcPOAKYVNLEaBgZdCfDbTH,KCFCVAADLFEH.EGADaBGH.ZDFECGHF.DECGHBAH.FAECRFCAMAEDhAAAGDBE..UFAEhACAOEEAAFHHBGHAdDHA..hADA...fGFA....hAFA......hAGA...,1,-20,-27,7
BGZgcVfeCLRMUFdNQDKWOXITHEaYSAPbJ,JGEABBGFZDDA..VAAB..CGBCRAFAMCIH.UDDDFABH..dDAFDFABhAAA.KGDHODHH.hACA.XFGG.hAAATFBEEHCCaGAHACEF........hACA......hADA...,2,-41,-37,4
PfKOCLgXAeNQVHSGRTdIMUWEFcbBaJDZY,eDACVEFH.HCEFGGBBRAAEdHGBUACGFGBGBHAGDIEG.ZAFA....hAAAPAEEKEHDOEBChACACAACLBBDAFGD.SEEFhAHATGDF.MDFG......hAIA......hBIA...,1,-12,-24,12
eLCYMfGFBHEbaVQNPUXDgARZSTWOJIKcd,ZDDFTGBCJBBC...KDECeDFALAAF.CBEC.MDAFGCCCBGGEhAAAEHGEaFCD..QAGEhACA.PHDChADADBFDAHAG...SEGDIEBGcBAChABAfFAAFBGC...hACA...,2,-46,-9,37
MSELJXNcZAYDWKQefRFbPgUOBdHGTaVCI,DACBQGBCeDCGFEAG....bCEBUGBABEBCHFGDaACDCAHCSCFChAAALHFGXDGFhAAA.ZCBAWEDAhABAfGFB........hABA......hACA...,2,-38,-19,19
gZTKYAMBGQRXaNIVFPcebWfEOHJdLSCDU,MHAGGCEHRCCC.aDBD....IGFCFHFAeAAC...bAEGfBGAhAAAHFCBdCBBLEFAhAAADCADZFBAKEFEAHAG.BAFHhABA.XABD.NDIC.....hADA......hAEA...,2,-30,-6,24
BUgHTQCMZLIRAcdOSWEYbfVDPaXFGeNJK,OCCHSAFB.EEBG..fEDHDEEC.aAFBFGGAGEAEhAAAeABDKACABFHEgFCAhAAAQGFACEHAMICAhACAIACG.cGDBWBHF.....hAEA......hAHA...,1,-22,-33,11
gcNIWPLQXTMfUYBEADZedJVFKCaHOSRGb,DGADZDEDJAHDFEBD..KACBHBDE.RBBD.GCDD....bGACgAFDhAAA..hABAIHHGLHFAXDGAhAAAfFFHBEAFAIBCeEHHCHFESABChAEA.....hACA.NEEEPBBHMFBE,2,-18,-17,1
CTHDSaRWEgJOcVGKYfZNUIFeALQPBbXdM,LDACBHHGdFDGMCCHTCEC..DGBBRAGBEHGA..OAHDGEBChAAAKBAFZACG.UEEFFEGGACGBhAAA...QAEFhABA...PFFBCHEG...SDDEhACAaDHD.JDADhADA...,1,-11,-35,24
WaTJYMPfcbEHNeKBUFIOZQXSLdRVgACGD,DBIHTGBCMCBG......fAECbCEEHFEE.KDEEFFAAIFGAhAAAZDDAQAEEhAAALCACdABFgBGGhABAAIECCHADaHBA.JEAG.PEEBEGHFBEHAOHEEhACA......hADA.SGAD.,2,-2,1,3
DFXMWYPSKOdVaZAcBRfJeILNGUgTbEHCQ,RDBHJEEGeAFDLAFAGEED.UABD..TDAEEHDEHBDBDICEFCCAhAAAMIAA...PAHBhAAASABEdHGBaEAHABBEBCHGhAEA.IGCH...gFGFhAGA.CCFF..hACA...,1,-1,-32,31
RcJIeQgVFYMUaKDZSEHLfGAXNBbOCdPWT,BHHGOAFBCEFA.dBDE....TAFCREADJGCE.QEBAFAHD.hAAAMEEDUGGH.DIDEEACChAAAHDEGLCAGAACF.hABANAIA............hADA......hAEA...,1,-31,-33,2
HPcgdCVUOfXeLaQWAbDSFTBRENKYIZJGM,DGHHFFAARDGHEAGF..KEDFZDAFGEEAHBBA....PDHFdAHECACGUAEHhAAAOFAH..eHBAhABAaGFDQGDFhAAA.AEGBSEDCBDADICCGMABA..hAFA......hAGA...,1,-14,-31,17
bVdSFUKREYIBCDfJWcHAaLXOQMZGgNPeT,aGDDLFCA.OCAFMFFGZCCBGAGG..PCADeACGbGEEhAAAdAFDFHGA..UCCChABAECEH.IGAFCGAADCGE.hAAA.fABEcDFHAAIB......hACA......hADA...,2,-30,-5,25
KXEMFGCPJQUIYADcaWVgHRBfdZebNOSLT,DGHHaHBG...VEEGRCBCdBGAZCAA..eFFGOHCALBEB.XECDhAAAEAABMFAHCFACQABFhACAUBEDAFDD..hAEA...WHFE.BEHA....hAFA......hAGA...,2,-39,-17,22
GZVdQESNRTPebgDafFAIXHUYBMOcLCWKJ,HEFHBHHGMBFHODAFLGCAKFDDZCEAQADHEAAB.RBBB.TECDhABAeHAE.DAEGFAAGAAIFUCCDhACACFHA..JAFCdGGBhADA............hAHA.SBGFhBCANIEF...,1,-6,-31,25
LNfVRcaOFJKPHBCeDGITEWXUbgAdMZYQS,MFCFQFDHLBAD..fCADVBFHREGD.OHFCKDEDBGAAhAAADEIFIHAHhAAAEBDC.UADBACCH.dEAFSAFEhABAaDEGFBGE.PFFBCBBE....hACA......hADA...,2,-25,-11,14
JIVXTgeUEdFSACbPNWRYLHZBcODfKQMGa,CFDG..NDHE.RAFALCACZAFEBFFH.DEFG..KCABMHDCGAAF..hAAAJAAAXFAH.hADAeHCCEFFCFEAGAECF..hAEAbDDC..YCFG.....hABA......hADA...,2,-34,-30,4
UcadMFGTZDQPbCRLXfKOAJBSHVYWEINeg,SDABHGFGVAAC.EBAAeDGF..UDGGdGBGFAHFZCCCDIGEQDDEhAAACBHCLGBEXADFhAGAKAEFAGGH.BBFH..hBFA..WHAAIGDA.....hAAA......hABA...,2,-36,-1,35
LCHXNPVDGeZQabSRdJfBMFIUWAYcTKEgO,TCBCKAFBEHBE..LCACHFGD..NACFDCIHZEDCaEAF..bDEBdHEBhAAA.BDGAFGBBIAHAhAAAAABC..YDHBhADAOHDEPBEE.eEBASAHHhAEAfBAFWBDBCEGC..hAFA...,1,0,-35,35
NPEUXdZJgMTDLRYcfHaKWFSOQCeBGVIbA,EHBGUFCAZFDFMEDCLFHB.RDAB...fDAFKDEEFGFEOBCChAAAeACEGBBF.hABAbFFGADDDXAGBhACA..dBHEgDGCYHEGaGBH..hAAA.WAGFCGCBBAFD.hABA...,1,-9,-21,12
fMTJPGIUVaDNEQAeYbKcCZFXSRBHOWgdL,eGEAKHBGCFGG.FHBC.RDEF.OECA..dDBGMAEETAAF.GADHhAAAVGDA.DEIH.ECGDQBBHhAAA.bBFGhABAcCCE.SGAFWCAD..gDGBhACA..hADA...,1,-14,-38,24
GXERQKMdLcJYNbPUWOZSFaeATDfBgIHCV,TAFBDAEDBBFA.HEFECHCDGDDDRDAH.MDAHLHCG.JEDBbFGFhAAA..UAACZBAASEBGhABAFGHB.ABIHIHAGhACAECGAKAGC.YGDCNADE...hAFA......hBAA...,1,-7,-25,18
dKRMASWVZbHGLNeDXQaOfJPITgEBUYcFC,SCFCVGFG.HECCLCFGDBAEaDGBJABC....PEHFhAAAgEEABADGUEAGhABAFAFACCDC.KCAC.AAHEZGAEhACANIBB..QEAEfCDAIEHChAAA..YHEAhAEA...,1,-17,-21,4
YZWBcUgEdGeCAMHJPIaTKVfLDXSRNObFQ,JAABaHBG..KDAELCHB.DGABRFEHODDGFHEA.ZEGFBDDCUEAHhAAAdBFE.GDAEeBCEAFEBhABAMEEG..PAHFhACA..IHHE.TFCF.hADA......hAEA...,2,-32,-27,5
XDaNOCeSVBZbYILTQPRGAHMcFWKJdgUfE,HFACMHFGFAEHJBCDdEGF..UEDAEHFADAAFOHAA..CHDC.eAABhABABEEHZBGD..IHAGhABALACF.PFFAhAFAAFAGKCAB...........hACA......hADA...,2,-43,-24,19
GJCXBTPadSQHcbgMDAFfVEKWZLIYUONeR,FCFCVDAGKGAC.LBAFUFFE..eACBJCBC.BFDD..aAFEdAGDhAAAHEEA..gCGGhABAMIFADECEAIDGEADE.hAAA..IHAFNCIECGGB......hAFA......hAHA...,1,-30,-32,2
MUADLZXJNYbOWBfgadEQGVHceFKPRITCS,DGADZAEGJDBD....bFABBDDB...aACDQAAEhAAAGGEFHDGBFEEEKAEARAAFCFDE.MIDAhADA.ADCELCEEhAEA.XGGFNIBB......hAGA......hAHA...,1,-28,-30,2
ANcFRYXbDKOUGPgQBdfEeZTWJCVaHSILM,FHBGXFDHDAGF.UAFBGADE..QABAdABAEFFDZDADJEBD.hAAA.CDFBHEGDSDDChAAAMAIH.AFGFRDGB.KBADOHDChADABGHA..........hAFA......hAHA...,1,-20,-26,6
HROUVFWcNJZfKYISQbPEAegCMBdDaGTXL,eAFBCBFDdECGGEEBLEDBHBAAUGGG.FEBD..NAHE.ZCAG.KBAGSADBhAAAQDGAEABGhAFAAAHGBHCDDDDG..aGHFhAGA.XGBC.......hAAA.ODFH..hABA...,2,-26,-11,15
OgIaBfNFEWLKTZGQdMbVYCHUPRDXeJScA,OGEAaHBGBEDCFAEDLEHDZBGB..GCACMGAC...VGBEhAAAHCABRCCB.DGED.eCDChAAASABAAAHG.IHHAhABANABDEEFBKBBC........hAGA......hBAA...,1,-21,-25,4
HJOCgXZYAPRIVKbLQDWTdBNFcaGUSfeME,RAADVDAGLBHH.QEABDDFHdGFBBCGHFFGHGCDBUADH.eGCAhAAAMICEHACE.CGAD.hACAXAGGAIHA.KHAChAAA.....WEDHNIAFaECD..SGHHhABA.EABF.hAEA...,1,-3,-32,29
QXZVKYBHFacWMDSAGNUgeLPJCEfbORTdI,UAGHeEEGLEABCEEA.EFDBOGDA.RABC.TCGDdFAA.IDCBhAAAQCAGXABChACAKCEABDHHFBDEWHAAhADADECHAFIF...NEIEJAFA..fHCBhAAA.....hAEA...,2,-36,-13,23
TCDgAWJEdVYUOQIaBReLGFfcMPSXZbHNK,EDCDdCFCUABG..ICFEaGGE.BEEALHCAFABF.MBFEhAAASADAZEABHEDFKEABhAAADAFCAFIF..JHFGOFFAhAEARDGH....eHBEfCGFcAGA.hADA......hAEA...,2,-32,-16,16
bDHJBWITMaQXGNYUSFfPEcKLRZeCdVOgA,HFDGJAFBBHEATBAA.QGBGGCGEUEDH..SBEAhAAAFCAB.EAECLEBBhAAAZCFGdDADOABAhAHAACCDDBIDMABEaDDDNIEB.YEHF..fGDAhAFA...hAIA...,1,6,-39,45
EABOaMIUXRQVDPGfeYWLZgJCbScKHTFdN,aDABUFDB.RCCE.DGCCGACB..eBGHLHEGZCCECBBG..SEAHhAAAKCGD.TFGGhABAdGACNABCACAH.BCHBOECChACA.MIFE.IHAC...hAAA......hACA...,1,-24,-35,11
WdeFaGMZKHfUBXOYbPNVDcESTCQIAJgLR,JEEGLFBB.RFFCeAABaDADGAAFZDDGKAGGHGAG.UAGBOCDAhABA....bCDCPACEhACADGHH.EFABCHDAIHFChAAAAHEE.........hAFA......hAGA...,1,-22,-23,1
ZVBDWKGQUPOeRAHJTMIECFfLNcaXbYgSd,JBDGMFFF..CAHH.FCFHLHDE..NECC...aDGCXAAChABA..gBADhAAAdADCZDGBBHAGKDEBGEAChABAUAGB.OGFA.AAEE.IDDFhACAfEDE....hACA...,2,-33,-30,3
SOAJQXCbZFgdaPLHWURGfcVBKITYDNEeM,JDCHCCAHFEGE..dAACLGEEHGEERBGD.GDAH..VADCBGACKEEGhACATACF.DAACNIAH.hADA..EHCG..MHAAhAGASBFAACCA.......hAHA......hAIA...,1,-27,-34,7
FNbPOMURcACVdBJXIKaeYTSDHfWLQGZgE,dBBDJEBE.KDFD..aDHBeGDA...SAEDHGAGLAEDhAAAZCGD.FHGA..PDAFhAAAOACDMDDDUAGCAEIFCHAGhABABABC.IGEEDHGE.fFFBhBAA.....hACA...,2,-37,-21,16
YWPBACHeVKZRdfcbMSgLTXIGNJUFEDaQO,CEFAHDBGKHGE.ZCFE.dBAC....bDCCMHAGLHAEIFBBJAFE.hAAAEAGC..QBCFhABAOFFB...PFCChACABBCEAHGHeDAFfEGBcBGDSEHDhADAXAEB...hAAA...,1,-12,-32,20
KFbHNGJDQTfecLUWaZCBRYdgOIPVMAXSE,SFHBFDABHGDEJCCFDHDE...QCFATFAH.eDAFUCFChAAAaEEBBAHCdAAAgFBHhACAOABE.ICCGhADAMCIHXGGFEAHBKGFENIAF.....hABA......hACA...,1,-2,-28,26
OFBCYHGNSacIefUJKZPbVTEALRWXdMQgD,LFBBXFDHdBFHMEBA.DDHBOFFA.FEBECCAEGADB.hAAASEFBIHAEfGGEhABAKHGEZFDBPCCChAAAbADH..EBBFAHAD.WFAGBABF....hADA......hAEA...,2,-26,-18,8
HCFcfDOYgWIPdQJSKLMANUZGBRVbaeEXT,ZEFHGCCFBGBBRGAG..aABGXBCH.HFDHCFFHFGHHDCEG.ODHFhAAA.....hAAA.gAGFhAEAIBAGdAGH.QDAGSBDCLHAAhABAAFHGNFAF.....hAFA...,1,-12,-40,28
UHLCZXKIGSOAYVEgBNWdPQRDeFacTbMJf,VDAGBFEDdHAD.QAACDGBFFAGA...aECHTGFH.MDFBhAAAUGGG.LBFBhACAXABDKBDAGCGEhABAAHDFEDDH.NEEE...PBHB.eEABcADFhAFA.fGCEhBAACCCD...,2,-27,-15,12
IcBbDaeKPUYdZNQfLWTFOCGSXAEJHVRgM,EDBDJDACHAEGREFF..MCCEBBCA.DEFDaBBGKDHF..UFBHdHGDZDFFhAAAQAGBLHCA.hAAAFFADCAEC...SFCBhABAAIFEIEEG.eFHH.NBAE.fABFhAEA....hAFA...,1,-17,-28,11
XYVDWBbefgcQGTHEICdZaLRMPKUNJFSAO,ODACVEFH.BCHCeCEF....fAACQADBHFBFhAAACBBEdEACaAFFRGBEKBAF.JAHFhAAAFHGA.ABCCDEEH.bDFHhACA.....cCDAEDCF...IEHEhADAMFID...hABA...,1,-19,-22,3
fcLNPQXCSbFdYRKUGeaAVEDJIgZOTWMHB,EGGEDEFH..JECDZCCC.OAHH..TDAAMFADHAAEBBHELADGhAAAQGDACHAF.SDABhAAA.dGCChACAKGFGUAECaCDCABBE.IEGD.fHCFhABA...hADA...,1,-11,-46,35
dMbCXaNGIEKOeWfRQFZTJUDASVcHYBLgP,SCFCVGFG.HECCBBHELBACdDCGCBFA.aAEBGABHKGGEODADhAAAeFECRFABZGAE.TGEChABADDGAAEED...cCGDhACAPCAB..MIBE.....hAAA......hABA...,1,4,-30,34
aNQZORCXPgdFISTMGLcfBDeEYHWUKAbJV,JFBBVDAG..QCBFRADB..PDFDdEGHSAHDhAAA.MDADLGAGhAAAfFDCDBIDYEHBhABAUGGGAHEEaBAGNEEE.CBFE.gBBE.IAFAhACA...hABA...,2,-28,-17,11
cWgBbGKTdMVCYfPFSAZIRJXDOHELUeNaQ,ZGFGRFDFDCGAEBGHLACG..eCCGQBAG..gDAGhAAABHGAKHAETDFAhAAAMFABCGBB...fEAAhABASEGEACEGIFHGOBAGHEEA.hADANACF.cDCEbFCH..hAEA...,1,-8,-35,27
PefRAQFaEBgIUYHZOCNMKbDSWLTVXGdcJ,FFHBaEHBBECAUEDBHCFEZAEF...OAFCCHDCKCAD.DIEELBBEhAAA..VABDdGAGJEFBhABA..eEAFADCDEBHFIHCChAAA.NAEEMBAFSEEF..hACA......hADA...,1,-18,-36,18
aFIBfJRYCbXZEAGWdMgTcVPNOLDSeKHUQ,dGAHTFDB..PCBHLCAA.SAEHKHFAUAABFGDDIBBAhAAABFFD..RADF.CHHCZFFBhABAAFHE.MEEA.gAGChACANAIA..DDFEeEADaEEA.fHCDhADA.bCFEXAFFhABA,2,-32,-21,11
IADNeZPcRKMfLUJQTSHEXbGaYWdFVOgCB,DEFHeFBBZBGBRCCG.KDDBMBAA..UADH..QAFBHGFGEGAGGAAEhAAAaEFHdEHAFFCAOFDBhACACDADADHG.....hAAANCIE.PHFA........hABA......hACA...,1,-22,-23,1
HbgEdYKFaUAZJfIeSRWTXMBCNcGOPDQVL,ZFDFJGEA.eAGDRCAF...XGGGCAADGACCDACELDHBHDBAEAAEdBGFhABAKHBC..UFCGAFBFSBDHhAFAMAFC.BAHChBAAOEEA.........hBDA......hBFA...,1,-23,-25,2
WVNHcFAgbKCSZOaTGMURYfeILJBEQXDPd,KHBGSGFHOFAGGCBDRDFA..fAFEeGDALEEGhAAAEAGEDDCFdADF..NBAFHFDBhAAAABCFCCGFaBHD..MCCGhABAIBAFBDDBPCAB.....hABA......hACA...,2,-26,-12,14
AZEJSTRXVKcYMNOHedfFbIDPUBaLgWQGC,ZDEDEEED.JEAHRDAF..KBBG..MEDFOBHDdGGB.FAEHDCDG..BGCChAAALHEGQGGEhABAABAB..SBBDhAAATGDEXCFD.YHAAeADAICHGhABAaDDB....hACA...,2,-42,-12,30
WcAKdFZUMQBYLfEVIbHgeCRPXNOSTDJGa,FDABZFEEQBDALBFCECBE..VGAEHECEeCAFCHFC..XEGDhAAANAIE..SCBHhAAADHCGaBBAAGEGKGACMACAhABABHADfDGA.IEEHgCEAhABA.....hAGA...,1,-15,-22,7
NDFLaUCQTdZXGEKWASgIJBVPbROMeYcHf,SHBGJGEABBAB...VBFARACC.eBCAHBGD.DIEGFAAFUFABhAAATEFD..dEEHGDBBhACAEDAG.AIHA...hADAPEHDMHEAcFAF.NAEBCFDA...hABA......hACA...,1,-4,-35,31
DeVCWZdcAFgXHNMELUGQTbaBRIOJYKSfP,XGBCHFACMCAAUFGEQDDB.aBHDIEBE.OFEFhAAAKGFESADEhAAADACGeBDDCCGEdEGB.AHHDNIABLAFFhABATBFABDBA......hABA......hACA...,2,-29,-13,16
bGOELHNVKcQWTUBYPCRFAJMeIfaDgdZSX,eAFEaHBG.DFGFZAGH..SABCXDECOADHEDGB.LGFGhAAANEDE.KEAEQEAEhAAATEGEBBAECCDDAHHAIEEAhAEAfFBFdCFB......hAIA......hBAA...,2,-30,-20,10
gLWKdJVCPfUSQDRcNAHTEYMIBOebZaFGX,EDAFMCCABCGE..OBABeEDGZGAAFDGGGEEALACHdGHEJHEECDDG.hAAA.UFAFQAAGhAEADBEC.RFCEAFBB...hABA............hACA......hADA...,1,-22,-36,14
MQLAVZHOPBGYTIECgJSNdWfRFUXbeKDac,ZBDBHFDFBEHATEAGECAA.CAGC....SDFHdAAFRGBCFFGHUCFChADAbCGF..KABCDIGEMDIFhAAALFADAGGD..VCCGhAEAODCH.........hAFA......hAIA...,2,-29,-16,13
SfKNbMGIHOJLRXPZWCaYVAdTQceFBDgEU,dEHATCGCeCDG.BAFCDBFHUCBCKAAB..MCFEGGED.IAAChACAODDHLEBFhAAA.XCAGhACAPEABZEFGCGFF.aGBDAFFAFHFEEEDHNADB.....hADA......hAEA...,2,-27,-10,17
cOaLDFQSPVNGfXJWUBIYRbZACHegKTMEd,CEFAHFDFKHGE.EDFD.dCGDOFCCDBDE..FCAFQEAC..hAAASFFGVBCA.hABAfFAHXAFE.hACAWCDFIDHH..bABBABBD...eAEEhAAAMIACaHAC...hADA...,2,-38,-12,26
UZWOVDLJTBPfEYFeMgbcQNSRaHCdKAIGX,XAGHZEFHOCADDFEBLHBA.BFDFEADEeABB.MIAGhAAAbCCG.QFFFhACARAFB.aDFGdABFAECBIFAFhAFAWAHH..........hAGA......hAIA...,1,-27,-31,4
JQcNUATCLBfMEdHFDWKOegPGVZRIXbYSa,CFEELAFBBHFD.EHACHADBDABC.KGHB..eECGGDABZBDHXFGGhAAASCAC.JCHFQBBGhAEA.NICB.hAHAADFCTAFFdDHEOFBCVFAB...IAAFhACA....hADA...,2,-31,-4,27
AJXGTHdFOgRDCbPcVUZQEMfeLSKNYBIaW,JDACGABHHAEGdGDGFGHDOFDA..RDFECBHH..PBFDUFDEZACHhAAAMAAF.LCHHhABA.KCCFBHAHaHGAAIAA.hABATFAGDGGB.........hAEA.cFAA..hAFA...,2,-36,-10,26
LQAFdbKZHVPMUYOaRGWSegBEXcCfIJTDN,FAFBdAFBZECAHDCBMEGFOBCBGACA..SAACBHGAECABCHDFIHDHhADA.JAHDDGCEhAAALFFDAAIDKBAC..hAEAPCHFaEGA..WDBD.XGGEhAHAfFHG.TBFChABA.NEAE..,1,-10,-26,16
QMBXZELFfJPeHTKCAONacRDWGUgIdYSVb,aDCDDHCEUAEB..dGAH.SGEGVEFF.QEEFhAAABBBBEAHHLDBAFBCEJAFAeCEAhABA.HCAFKCFFAIFCNIAF.hACARFAF......WCAFIDHG.hAAAMIFE....hADA...,1,-10,-35,25
CAYIMcQLJNdEUHfKDbGPRVTFBOXZWSaeg,MCCAQDACLDEGJGCE.ECFCHCDB.KBGCDCAHGAAFRDAFFFGDBAGHhAAAXFFF.SFAAhAAAaGFHCABE..AFFG.hADAIHAEdGAD........hABA......hADA...,2,-27,-20,7
ACWgGfLdTNEbSXPFYRODJVMUcQBIKaZHe,CFDGGAFEdHAD.EDCG..SBDHFAAFOFECDGHBMHEA.UEAHhACABFEBKADHaDBB.eDHDhAAAAIFA....fHBFhADANAEF..bCFBYAHHJBAE..hAFA......hBCA...,2,-36,-24,12
BcUCYbQAJEaPVWHSXRKOeMZgFIGdDTNfL,JEGHEAFB....aEDAVAFAHCAF.RBGFKHGEeCBFZACH..FEDAdHAHDDAFhAAA..TFCFLCFAhABABBBE.CFGH.QACAhACAAIFG.SHEA.XEBDhAFA.MIAE.hAAA...,1,-19,-22,3
XMIaDYbgFQJfHcZLdARPNBKSWeGCOETVU,RAADBFDGKHGE.eDBCGFADCDHE...EDBFUGGGMBHFDFEC....hAAAbAEDFBAF.JADCfEFEhAAAHGAE...hABAcACFZBFEAHEC.SGEH.WHAAhAEA......hAGA...,1,-25,-35,10
OYCcLDZBdFQIUJMSGXVANeRgaHPWETfbK,eFBBRDAGHADCEGGB..TGEBKEBE..ODFHCHCCDGGEZAGBFCCEQGDDhAAAUAAC.JAGBSEEFhADA.XGABhAEAACBGNEACaADAfDGF...hAGA......hBAA...,1,-18,-22,4
PMROfBCUcFKWDNSeQgXJHGEIbaZLdTAVY,VAADMCCARAGF..BFGEUGEGFFEH..DGAFeEAC..QDBGhAAAXAGD.HGBAEGBA.hAAAIEEDZAEFdGACAHDHOADGhABA.CHHGcDGCNEEFJADF..aGGH..hACA......hAGA...,2,-16,-16,0
HBdDTfcCKOSgPYFLbGeQEJNMZVIXaWRAU,UGDCdBBDDAFC..TAFCCFBG..OEHFSCHD..PFGHhAAAFBBALEABhAAA.bECGGDDD.hABAEDAGMACCZAFEXGDEaEEAAGGG.BCDHfGHChAHA...hABA...,1,-16,-35,19
VOLAMDGZIURSNbTeCgQacHEBYXFWJfKPd,DFCBGEDHZAFERDDGSGGH..TFGACAFFaBFDHCBABADAFFABhAAAJHDGKAAC..dHEFOAHHhADAAIHEUABE..bEADhAEA............hAIA......hBAA...,2,-42,-15,27
UJONYRBALTZeEdDKVGIQcbHPFSMXgaCfW,TAEGZDEDdBBCKGCA.GADHQCBB.HGEASGGFhAAAXECHCFHE.fABHhAAAUCCEOBHFYEFAhABAAHIDLEAFDAGCIHCF.cBGB.hABAFEAF.....hACA...,1,11,-25,36
ZgfRWHFIOJLXMGVYSAaQKPCBedDUbcTEN,QFCECFEDdADG.DIDGUCAG..TBDGEFFEZFAGRCFA.HCFAOBBHhAAA.LGFEhABAMBFA....YHFAhAAAAACDPFABBABH.eHACcDBD.NADFfEGFhAIAFDDC.hABA...,1,-10,-22,12
RJaEeXNCLOQdcKITHWYBgUSFDZbMGfPAV,VDBGRDEDEDAG...eGFCCDCELBCE.dBGGIGCCHFADBBAFhAAASEFF.DBGGhAAA.MBAFPHFEABDHXGDDhABA.........hABA......hACA...,2,-31,-31,0
URVJSfDaIHYgKFZeMOPNAdTcGXWBECQLb,TGBCXAGH.BADGQAAALCCARAFC..SEFGhAAADGEHIEEEHGEG.YCDFhADAFGBAeEAGMFIHNDIGdBAChAAAcFAB.EADCCHGC.......hABA......hACA...,1,7,-30,37
RfbQcIaZEVKCHeAgGBOFNdDSPULYJMWTX,GGDHFDABDAGD.UEEBLCCCMBIF....TBADXEFERCEC.hAAAQFAHaEAA.hABAEGDBCGAHAAFFBEDD..hAAAOHAENBAHdBHESGGG...hACA......hADA...,2,-24,-24,0
IZEeXLBKSTDcQaCfUgNAMdWbGJOFPHYVR,MHFGdHBHGCBFFAEHHGBARFGBZDFG..EDDHeFBGBABDKBAADDGB.QBGFhAAACAHC.UCAFhACA.AIDA.JABA.OAGHhAAA...........hADA......hAFA.YFEA.,1,-20,-28,8
bQFZDJUXdWeRNMIfLPTHacGKASYVOgEBC,SCFCVFDF.ODBCECACBAGC.CABD.FHGEZDFADACB.XFEChAAAeFAC..MAEBhAAAIBDFLFFBTGBFhABA...cDGBAHCB...YAFAhADA....hAEA...,2,-41,-31,10
JUPDIFBOEgLKXZMdVCaTWbHecNQfSGYRA,JDACUAFB.DEAAFDFHBDHF..EFBGLCDHZAFH.dGEECBHH...hAAAaCBCTACF.HFGBhABAeAAE.QGCChADASEAD.........hAEA......hAGA...,1,-33,-39,6
BPYIVSLECgTWKZcUNaHAFGDMRdXOJebQf,FEHBDIDCMEGFdADE..JBAEeAAB..QFEABFHG..IECChABASAFALACFhAEACFCG.TGAAhAFAZGAC.UBEFaEDGAIGAXFDAfCEF..hAAA......hABA...,2,-41,-24,17
gGJaXCRBeZcNDOWUKdEFbSMLTQIPHAVfY,VAAD..gGBCGECE.JBCAXAGBBDAGZEEB.DIGAOGFAhAAAUAAE.KEAAFBGFMEFEhACALFBCQADChAFA.IHFAAAFCfGGBCCEA...hBDA......hBGA...,1,-17,-29,12
BVMZSENLcUgQIGWfdJaTAFORKDYPHbCXe,FDBDODCHDADEHABA..CFECeAEGMDEHECHBLDDE.UABFhAAAIHGGGDGEdAGHTGAEhACAADFEKFHB..PHAChAAA...BHEGSGCH..hAGANBAA......hAHA...,1,-20,-26,6
egTPcAXJCKGDaNfMVHOLSWREbdYFIZBUQ,JGFACFFCKBCAGEBB..DCGE..aCEFMEACOADCLBFF.hAAARFAE.bCGF..FHECBGAChABAeEGHTCAD.hAAAPHBAACBD.NIEB.fHABSAFEWACChABA.....hACA.ECCEdDDA,1,-18,-32,14
RDQCfZJWPMXNASIYKdVeTHGOUaLgcEbBF,SHBGKHBGeCFEGDAGOCBFLADD.EHGEFBFE.REEEDBAAhAAAQFDACGHCZECBJADBMACDhAAA.AGGCdAGF.TDFChABAaGAG..........hAFA......hBAA...,2,-35,-8,27
VaPCdOYMEXfQGgKRTFHcZLUDINBebSJWA,VDAGCFEDdHAD...MCAEEABE....XBFAQGFD.KGCAhAAATEADHAFAZDFELHFAhAAAIHAGeDGB.hABAbDCFWADBADAD.aFGA.......hADA......hAEA...,1,-11,-28,17
UeWPSOAKdMaYXGVfcZIbJCgDQHLFENTRB,MIAGXGBCGCAC..VAABZFFBJDCACEED.DFCDLDAA.hAAAFGFFEAFCRDGFBDFAUADGeBHBhABA..WAFEhAAASFDHAIHA.KABG...YFHBhAIAfBFC...hBAA...,1,-16,-29,13
AgeLacWXZPbICFSBJEMQUONHfTDYKdVGR,eEEGaDCD...XAABZAEA..bGECCGBBFAHDBDBA..EGDEQGAFhAAAOAFHHCBEhADADCBGdDGG....hABA............hACA......hADA...,1,-32,-39,7
JFcHdWKDVSEgIGMQZBUXCLRabAefOPNTY,eEEGOGEA..TAACFGBEdBEB.DDAFVGCC..SAAEhADAECGHGAEHQDBHhAEABHHGUDBGCEEFLAHBhAFAaCAHAAHE.fEHG.NIEF.JFAF..hAAA......hACA...,1,-12,-19,7
LSIgaQFKfDUMZdYOCBeRVGXcWEbNTPAHJ,LFFCSHBGaABDFCAB..KDBGUBEBMFAHdHEF...CEEDRCGHXFBAhAAA.EHGETABGhAAAAAECHCFA.IBHDhABAfGGDDBDH...ODCBBEEF.eEAHhABA.....hADA...,2,-26,-20,6
QETbPIeNAOaHgSRJCGLdUXVDWFfBMKZYc,ODCHaCFCHFBBRAFCGEEALEGF.dCCFUABFDIGEFACEBGHE.KGAFZAFAhAAA.....YEEFhABAECHD.PCAFhACAIDDC..AIEG.JCAFCHAD.....hAGA......hAHA...,2,-32,-12,20
HZfXLDJcBdEVaPRQIOeFGUgSNMAKbWCYT,KHBGCFDGHAFAZAFBLEEBDEAEBHDA.dCCE..aHAA...RAAC.QGGEhAAAOEFF.FEGGGCCHhAAASADBAFAD.hABAbBAB..WDHFfFCH...hADA......hAEA...,1,-23,-32,9
ZgTbIYOLHdRJVDfFcBaPWSCGXNEAQMUeK,MGECUGGDeEBHKBFHZGFE....TGCG..ICCChAAAODEBLAGDHFAGdDAGRDEEhABADAACFAHBBFGEaACCSEDGhADAXBBHAADC........hAEA......hAFA...,1,-17,-29,12
PgCfZcKbGFBdQNRTMXSDIHOALeWJVaYEU,LEEGeEEG.JHCEVFBB..aAHDUCBB.CAHCZADHKEAHFCDBdGEB.hAAARABH...MIFADIGAOCFChAAA.AABF.YAGFhABAEGAB..fGGB..hADA......hAEA...,2,-34,-26,8
GOBMWPSZeKaXNFDbYEJRHgcTALQCdVUIf,QGDEdGFHUBEEGECEBDCAMCAB..SBAGKAHF.hAAAaBHDNBGGDCDE.EFHHJDAFhAAARFAF.HEFA..TABEhABAAECBCHEDIHAF......hABA......hACA...,2,-27,-25,2
DOfNGcLaKJQMBWYAPgSFTZIeVHbURXdEC,SHBGZBCFeEAFHGDAUCDHdCGC.DAAFOFHF.GAACaFDAJAEEhABABGFB.AHFFFAGAIHBEhACARFBA..EAEGNDIG.hADAKDHD.MDAF........hAAA......hACA...,2,-21,-21,0
IWNMcQaHOBKCbDfUJZgSVAFGdYEPXLRTe,dDAFEHBGLFADeDEE..IAHCMIFAQDCEHFABOFCChAAAKAEBCBGHDEIDUAACZABESGHDhABAAGDAFEHD.YHDChACAPGEC.XCCB...WCFEhADAaDAGBEEBfEFEhAFA..,1,2,-22,24
OQXCYTLIdVEFfPHSBMNZDGAbaeRWcKgUJ,eCCHRAADKHGE.UGFG..QEDGCABDLGBCdCGGFCHBHGAE.BEHAhAAAMIBADDCEADAH.aHDE.hAAA...gBDBhACAOADG.XBFF.IEEFhADAEAGA.SAGEhAEANCAE...,2,-29,-19,10
fUbCPKMGJODEVISeBWTLNAdaHRgcFXZYQ,dEHAHBCFRCCGFGDGXCFE.QEEFUCAA.CHFDKFCHMABCOAAHhABADBHB..EFAGSAFHhACABHHHLEFBhAAAAECFcGGA.ZFAF..YADGfAHEhADA......hAEA...,2,-32,-11,21
fUBVDAbLTOPaEeKMNGQHJdWcZYIRCFXgS,LDACTDAC.aEAEKBGGGAAFHEEFdCAFZEEDRBGHFFCG...SAAAhAAABHADDEEFAGGHODHHhABA.EGAFMGAANIBF.hADA.....WAFEcBEECDDG...hAEA......hBDA...,2,-27,-15,12
XGHdgaNPBbAfFRTcJYESMOILDVZKQeCWU,FCFCTFDH..JDBHSGGA.MAHDOFHFLADAhAAAVEEGZGBGeBAB.WDCFhABAUBCDHDECdAAE.NIEBBEADhACAAAIH....fAFB..hACA......hADA...,2,-40,-3,37
ODABMFQecUaWXgIPRKYEbNJSZHLVfTCdG,FAGEQDACUAAD.aEEH..XGCA..PCFBKHGEEEBChABANHDBZFAELDFF.hAAA.fBAHhABACFHCOBECDDACAICEBAEF.MCHDcDGB.gGADhADAICCF...hACA...,1,-23,-29,6
PAYbIRcBaDVfeWGMQKJZCOHNUdESTFXgL,..IFDGBFDDVACD..eAACGEEHKCCGCHGHHAFC.dFAFEHAChAAAFHGALCBFACADRGAEDEAE.hAAAMGFG.JDEENDEF.TAGEhAEA...XFAG...hABA......hACA...,1,-17,-21,4
PSLYJXQTGNREMKAVBgWUFDHdeOZbCacIf,BFDDUCBCDEHBeECEZBFECDHE.....aHAEIABE..SGFFhAAAJAFB.TEDHhABANHAB..MIFEhAAAABDE....gFACHDABdGFH.OAEGhACA.fGHAhADAYADB..,2,-42,-32,10
fYeNMVKJcQLGZRFCdbgTAUDHXSWBOPIEa,UFCADEFAHFAB.SCBDOCGDEFHH..aAFEeACD.MBFChAAAVECFKCEEQABFhAAA.ZGFGCGAHdDADbADDAFFDhACABGFE.IBACNAIA.....hAFA......hAGA...,2,-31,-9,22
VSfBUNbFdeYOGEZDaAJcPKQRIgTMXHLCW,JGEAKHBGQCBC.RADC.IDDB.MAGFXFGFhAAACEAE.SBFAhABABDBEUACBbDEHeDFA..hAAAOCABZFCBDFAHcCGD.....hABA......hADA...,2,-41,-17,24
FGBMaZScXbVWLCRPAHQUNDYKOfeIJEdTg,QDCBUAFBDEAA.KFEGOAAB..fGCDeBDH.EBEEhAAAdGEH.TDGBFAGCBHFGhABA.MIACaEEFSGAEhABAXACHWEADCBCA.AHGE.NIBD.JCHF..hACA......hAEA...,1,-25,-28,3
BbAFWeMTgLdUDKVRCcPJIfQXYaHESOGNZ,eCCHTFDBdHEH.KFCHCAAF....JCBGIFHB..fHCDhACAXAGAaACESDFGhADAGAECBGADhAAAACGDMAFELBABDBBEcGFG...PEAFhAEA.....hABA...,1,-28,-31,3
PHFLcIegOdYbUKCNBTQXVJEWZGfARDaMS,DGDESHBGHCGBFBAFLFDE.eBABgCEFOCCHdAFBhAAAUFABCCHEBHDE..hABAXGGGJBFDEFHH.WEAEhAAAfADA.ADAH.MICA..cGEAhACA....hADA...,2,-28,-22,6
JNTVORBPALZDWdYgaIQbFcefKSXCUEMGH,ZAADDGHHdADEaDCA...QGAHFHEE.eEDBfAGC.hAAASEBGCAFHEABBGCFAhACAJEFE...NDBDOHDEhAFABHHCAAFA..YEAF...IHCChAAA.cACBhAIA.KFDA,2,-29,-28,1
IFZUKcPVGdCHLBTaJRQeSfgMXbAENOYDW,OCCHDACBFGHBZDAAUDGC..KGCB..VFCEGEEFHFAFLBFEhAAABGGB..JAFEQFAFhABAeADD.fBDEhADAMAAFAEEG.EHEE.......hABA.NICB.....hACA...,2,-26,-22,4
FAcXVGIabMeNBTLZSDCQgWHJdYOPfKEUR,VEFHaGAH..MGECeBEHBDAAZAAE..DAIBCCFB..QACBhAAAHGCGJAGFdEBGOEFC..hABA.KBHFECAAFFBAAHHA..hADA.cCCHXDCDIHEENEAE...hAAA......hABA...,1,-16,-25,9
dNBAPXCafULKEFeSIGVTHORWYgbcMDJQZ,CHHGUGBCLDACKDDH.FDGHeADF.GGEHHAGDOBCCRDFG..hAAA..gDAHhAAAMFEDJFACZFFAdAGHADHCaGACfBABhABA..IBAE..hABA......hACA...,2,-25,-17,8
HUKbOYAcVPaTNXJeCBSRZLgIMEQWDFfdG,VAADTGBC...JAFBBFEA.SAHBZDFDLFHBMFAGQBADhAAAFDHDdHBBUCDBhAAAKDAB.OCGBAHABaHEEeECGhABACHGA....IADEDBIB...hACA......hADA...,2,-25,-19,6
XfCITDHgYJEVaWGLQUOcReZSANMKBPbdF,MHFGBFEDdHADFAEH.CFFE.DBBFHAEG..JDDEEHDA....aGBBGBBChAAA..LCHHhAAAODHBREABeCCFAABGKDEEhADAXABF.IFFG.gGCFhAFA...hAEA...,2,-31,-28,3
DVTBaLNIEGJSZYPCgKHfWcOUXRFAebdQM,dDCDDIBGBGFDaFBB.LCBCEFEG.GDDBJAFHZAAC..CGCFHAGBhAAA..fHGFhABAOFAHXEABAFDHeHBAMAHHhACANBBB.SEGE....hADA......hAEA...,2,-26,-25,1
NWMbXEHJgDfKLcSIPVTRYeUdCQaBZGFOA,MCCAEGFCHAABDFGBLAEESFFC...VDBCTCAG.eEEChAAACHHGaGCFGGBFAGBB.hAAANCIG.XAGE.hABAfADAICGD.......hACA......hADA...,2,-26,-15,11
KbVWYOAgZJGFRLecIMfCUaQHNPSTdEBXD,ZFDFGAEGFFGERCCELBAA.eGFCMAAFCHCBUBGEQCGGHEABSEDFhAAAEHBA.hABADIAAKAFE.bDAD..hACA...YBBEAEHH...cGFHhADAaDABNIEF.....hABA...,1,-10,-15,5
DPfOZgIAcLEGeQFHSMYXCJBRdWTaVbKUN,EDCDGDDC.eBFGHFFEMEBBCHAABBGH.RBCCdDGHTBCH.aDGCKDADhAAADIDGOABGZAABAIBELFGBhAAA.SAEChADAJGBA.........hAFA......hAGA...,2,-34,-6,28
IYUKMdFcQPfOWVJLRCZEBeDNHASgXTGab,XGBCGCEBaDBD....ICAHUGBHdBBBQCEDhAAAOCAHJFFCREGDEDCDBHHENABFAHAD.hAAA....TAFGhAHAKAHFMIEAPBBAWEEDVFEF....hAIA......hBAA...,1,-7,-26,19
LBSVFWXPKdfUDcZYIJOeEGCAbQaHMgTRN,aGFCHFAC.MDAARDAFLCFABFHGFHEA..XDCDKAAEdAHGDIBAZADC.hAAA.JBAAEECG.CDHA.AEHA.hABA..QBEGhADANHAD.SEEB.....hACA......hAEA.PFFA.,1,-21,-22,1
bRKTfPcIaUZLNOXABWeFVJCYDSHdMgEGQ,BAFBFDCDCADE.SDHFHAFFdAAF...EABEQGFEKDEE.TEEDhAFAPHAE.IFFHhAAAaBBELBHH.hADANIADAFIHWGEG.VEBA.DIGA.MBBFbFBG.hAHAfAHA.hAIA...,2,-24,-14,10
aCRAObEUXBVIMDSeQLJNKWcFfHPTYZgGd,EDCDBCAH.MEDGeBBELAFAKEABFCAGHGBC..TGFGZAECdEFBhAAARABAAHABUGGG.XDDBhABAVEABSGCAhAAA.NFDB.fCFB..PCEChABA.....hACA...,1,-13,-16,3
dDIGQZfAXUSaNMJKObHBLYEVCgTPRWecF,XFCASFHB.MDAEKDBDHFFH.BAEDLBCAEBCGCDDE.TCFDhAAARBGF.eEAEdHABDEIHhAAAQEDCAABC.hADANAIEOHEC........hABA.YHAG.hAFA...,2,-31,-8,23
YIAQNeXDSbMCEJdRfGHPTWcFBgZaVOUKL,QDACeDACDFCG.SHEAMFFE.EAEGdHCFGCDDHADHTBFHhAAAFAAFBACF.aEHB.hABAUGAHKGGFYFAAhACAAGEFXEEACBBD...fECFWBHB..hAGA......hAHA...,2,-15,-15,0
BYdPabJXcKTHLQNefAGgUEMWFRDOZISVC,UAGHEGFHFAHHDFCF.ZFEF..SDCHBGGE.dCCBaACG..XCGGhAAAKDGHHBEBLCAFhABAeCCD.fEEDhACA.AGBHMIAAOFADIHHFCAAC.hAFAPFDF...hAHA...,2,-37,-12,25
DVfYeUacFZCQbSLOHgARBTIWGENJdXPKM,BADCTCBCGBGE.JDDHdGEC.KEEADBEGVBGB..eFCBaDAHZAAEhAAACABG..QFFHhAAALFCF.OCADhACAAGGCIGADEGAB.PBEBMIEEfCEEhAFA.....hABA...,1,-17,-24,7
fEQMDeYdTABCJgSKcNPXGIVLOHZaRUbWF,BEFACAFB.JGBCKFFC.....PBBGXAAFGCDALDCAhADAZGEEUDAGFHGAEBDHDAIFdHBBhAAA..AAFBSBHHhAEAICGF.OAGH.aFCA...hABA......hACA...,2,-33,-33,0
UDCQZGIHcdWYRAgBSXKEPOFfeVLNTJbaM,SEGDKFHBOBBA..FGCGeDAD.VAADLCAF.TAGChAAAJHCGMCHD.DCDECHEGGDDHhABAHDBAdAGB..hAAAWFGFAGIHBHHD.EFDAfBEA.hACAaGAF.....hADA...,1,-16,-23,7
fWLERMceISdbQGaNTgXBZDYHAPOJKUFCV,OEEGKAADFDFE...CDBA...VFFFLCFCREAG.eHBAdBDDQDDEhABANGDB..hACATABABCBBDGAHAHHBPFAHhAAAJHBA...fECCEBGEMADE.cBDGhABA.IHFAhADA..,1,-22,-28,6
MDNLABdHYXaWeVcIbfFEZQURKGgPJCTOS,dGFHXFDHaDBD..eADC..ICDFFAAFQDEAKBGDPABChAAAJBEG...CAEESFCFhABAMFIBDBIHADDBBHEDhACAHDEAVFGF.cGACfHAB.hAGA......hAHA...,2,-26,-22,4
KLDWcFYMGRXTSAdeOIQVfbHgCEUZaNJPB,eFFBODACQECH..bBGHCHHEZBEEJHFEBGBBDACHFDHBGBCDhAAARBAB...SFEBhABAdAEBIHACfFDEhACA..EGDDaGAH.NADF....hAAA......hABA...,2,-24,-19,5
LABZeQTbUOFVHIDCJXRMGgPEdWfYNKcSa,BEFAeBDGQFFBUDBBFAAC.HDCBDDIF.CBBARAGBGAEA..EDAEhAAAdGABfGAChABAKHGG.SGDHhACAAHDE..bDGD...IADGMEEE..hACA......hAGA...,2,-45,0,45
aTIPLKOMgcBSAbEYRJWFeNGXDQUCVdZfH,EHBGRFDFFBFHGCGE.QBBGUCAGCAAB.dCECHFAF..TEAFhAAALHFAMFGHBGGBhACASAEE.AADH.hABAYDCBWDDDXGDADADC..ZAGFaAHFhACAKEEC.....hBAA...,1,-10,-22,12
UPTfSFbIJaCcQNBZMRKEVdegAHYDWLXOG,DHCELDACOAFEGDFG.UAGHTAACSABHFGAG.JHAChAAACFDEQDAChAAA.BDEA.MIEGhACAKECDEFEDeCCCAEBH.WDGBfHDB.IHHHhABAaFFD.NAFE..hADA...,2,-31,-21,10
REVaBWcFXYTMAfDUGSNOJIPgeHCKbLQZd,DAFBGCEBOHFAJFAF......IHHCeDEDCEAALHBAhAAAZEEFEHCE.BGDCFEHD.TCFBhABAMCBDACCFUACCSADDhAAA.PAEGKAGCdCHA.aBBBcFCAhABA.....hBAA...,2,-26,-18,8
EVJKFZbWGdPHeNRQTXUfCcSLMBOgaDYIA,EDBDVDEDKGCH..FAACZCDD.GAGCdGCFHAGBRACF.QDBChACAUGGE.CHFFLADAhAEABGEHOBABDDIBAIHGJFAF..hAAAPFAB.........hABA......hACA...,2,-26,-11,15
DTZPRHGfNcFCEdbIAOXYeSWBQaLgVJKMU,ODACXDAC..SEFAQCFCaADDLCDB.JGAAhAAAKAAFDACEPHDAGFDHhABA.NIEF.CDFAEAGAdAHAAEHAeFCGhABABCCDMBIH.ZFAF.fGGBhACA......hADA...,2,-21,-10,11
IgHRPLXGAUdYbaDNWVJQSeBEcKfTZMOFC,dGFCaHBG.DADG..VAFCSCEH.BGDEKAACZCBE.FEGGIFBHhAAARFEH.LABFhAGAAEEBUEAF....hAHA.NCIGQCCCEBCC.fGHEhAIAMDFECHGE.PHBE.hADAYBEC.,2,-24,-23,1
ZKCQLWcfYJTREbdOVMgSaUNBPHADIGFeX,DCECFGAHZGFAKCAELFEG..fCEFJEAB.EEGHOHEEhAAAVAAC...SEDFhABANEBBBAFB.AFFAeHBChACACGDAQCGD.WDACYADD.hAAATCGCdFBBMICE.hAFA...,2,-42,-8,34
UKcBYTaOFECLAPNMeDWdbgXGHIQRJZSfV,MCCAeFCHDBIBdEFE....XBAFGCEGIGHBRGDEZDAA.VBCBhAAAKAGBBHHH.TGAHhAAAaAGGEHFE.CDAFAFABNAIE.hABA....WCGB......hABA......hACA...,1,-25,-29,4
RdDeTEZALcaIBQVWPGfYUXJCOgMHNSKbF,aDCDQGGG..PFFCGCAGUGAHCFDAOCDHHBGHSEABhAAAKAACRAFDDCIH.EFDFAHEHLHAAhADABABC..hAEAVCEH..........hADA.WBCF...hAFA...,1,-14,-27,13
dOCBAMUYaTPbNKSRFIfHJEDgcXWGeZLQV,UFDBTGBC....PBEFKDECFGGHHDBADFFA....XAGChAAAGAAFZAFFLCCFhABAdEHCBDACACACMDIFaGFDSAHDhAAAIEAHfADB..hACA......hAFA...,1,-15,-36,21
edQREZBOWVSbaHMTYCgPUDANJKGfXIFLc,KDCDXAGHLBGBdEED.EFHHBCBD.OEBDSABC.HFCFhAAATGDGCHAEUAEEAACHJBEFhAAAGEEE.fCCDhAHAcDGA..QGGC.WADChABA.....hAIA...,1,-19,-25,6
ISHXJTFNeMAOVcPBfGbRgECZaDWdKYQLU,OFBBVAAD.BEHFGECERDCF...CDDBDCFAKAEFLHDE.hAAAUABDIGGBHAGBXCAEhAAAFEAAMFAFAFEE.hACA.fEFGEADAaHFC....YCHBhACA....hADA...,1,-19,-33,14
OQgALbfBWKHGScXYCNRaPZVUTJEDFIedM,LGEABFDGHABFGDDDXGDECCGD.RAFDZDBCTGBG..DBIDeACChAAAdFAAMAEDQBAGhABAAFCH.bAFAKHGASDCDhACA.NEIC.PFFA....hAAA......hABA...,1,1,-24,25
ONgRHBPGScTDKeMZaWQVLYJdUbCAIXfFE,XCBCFAFBOEEERFDF.BGHCGEBE..SABHTABBDAFDKEAFhAAA.ZGDAaAGC.VGFAhAAAJDBE.dDFG..CCGEAHBE.hABA..EADFNAEE.........hADA......hAHA...,1,-10,-41,31
dBIKSAORWUCQJeXDZFfTEVGNLHPbYgMca,OFBBUFDHQADH..eABDDEIDZAADTCEEEFAFGCBEhAAANIEDHDBC...PDDGhADAgEFA.MEAFhAAAdGGAKHDAAHCCCADD.FBHFLGEA...hAFA......hAGA...,1,-8,-9,1
JQATNCDFIEPXWaSYfUOBdKeRgbLMZHcGV,CHHGDGHHFBFHEACG.....XBGBSEEBUGEGBDHF.KECGhAAARCCCLBADMHBAZBAB.hABAHFAF...cDGEhAAAJADFACCF..IAHFaFCF.OFABhACAeAFD...gGFFhAEA.,2,-41,-8,33
ZCfLadNMRQbBPEXKUYgIFTDAHeSJOWVGc,HDEDSGDBJEGD.ODFHGBAD.CFCBLHAGaBGF.dDAGNAAFRCBChAFABGBA..XFBDhAGAUAGC..IAAEhACADEBDAAIDeBBC........hAHA.WHFC...hADA...,2,-27,-22,5
GYfNOgKZXRHMQJWbCIEDPVATcBeadSFLU,BHHGeEGHdCABFDEFUAFFGBFG.....fAAFOECFKEHHhAAARDCFMFBD.JAEBCCCBDGAFhABAAIFA...TDAFhACAaAGASEAF.NEIA.gGEDhADA.XACAhAGA...,2,-48,-9,39
bEeGKdgQTDPWJAFYaORUVSMLZNHcfXIBC,FAFBOCCHUACC..SCGDZGDGHCFC...XGFGCBADEEBDKEDDhAAAdAFB.QDDGhAAADIGA.JEADAGECaHAEMDIFhABA.NIAB...fDDBBBDCeGBA..hACA......hADA...,2,-32,-17,15
JaDUXeVRTZWQEBCPfOgSLcGNbKFAdMIHY,dGFHMECGHBFG.aGAFUGDA.eFHHRECGZABAEDFEBHEG..CFCFOCAHhAAASDACLBCChABA..NACFFDGHABHDIHAHhACADAAF.........hAHA......hAIA...,2,-26,-26,0
PAUaXTNfcORHKQVdJZbDIgECLeWBMFYSG,UFCAaEHB...XCGATEEB....NACB.OACGHGBCKAAFhABAQBAFdGGHZAGDDDDChBCAgEGECBDD.LDCGhAAABBEBMIFGSHGAACIB.fGAFhABA.cFFChAGA..,2,-21,-21,0
URBNPOIMfWJAecCTbdZKDgHXYQSLGaFVE,eAFBTGGGdBBE.DFFEHBAH.QGABGFCBFEAGEFEHBDDEODDChAAAMIFEJBFA.AAFECADDZDFChAAAKDGCXACBLFDDhABAaGAD...........hACA......hAEA...,2,-21,-7,14
GUWPHdRIQVgfXJOKEBbaYZDFeATNScCLM,SGFCCAFBGDGGUGCGHCAG.RDFA..QGAGVCDA.fAAFhAAAOEAEKABGBFDDhADA..aBAHZAECeFFDhAAAACFFNICBMAFEdAHE.........hABA......hADA...,1,-4,-24,20
bIDTafOgEVNBcWXYGeLPJRQMCSHAFdUZK,dFAAKDAFDGHFaFGH...OFCHECDFBDHH....XAGAhAAAeHBALAEARABG.CBBASHFGhAAAAGACUDFEIHEEhABAgCEH.NDCA.YDDB.hABA......hACA...,1,-29,-39,10
RUIWgCAPLXcbBDfKVQGSEaOFedHJYTMZN,LDACXCBCBCHDDAACKHGAGAEC.EHGEFFDB.eCFCdFGHHABAhAAAJEBD.MHBARFFA.IAGHhABACBCH.AIEAbEAAhADAfAGF........hADA......hAEA...,2,-43,-2,41
LgIURQcVSOBYAMDFZGbTEWKfPaJdNeXCH,FCBDZEBHGBDCEFGF.KAFAaDDHdHFB..eBFACABAHDGHLHEG.hAAAUFAD.RADH.cFEBhABAOHACAGID.DBBA..hAAAbFADfDGC..NDAE....hABA......hACA...,2,-19,-16,3
gcBfOXLJIQePCFWGESKaMUAdTHNZYDRbV,HBCFZAADDGFDVGFEBEEC..ODFCLGBEQFCDeCECCGGB.FABGhAAA.EAFDKHBG.MFFGhAAAdHBDTEAC.YAHFhAEARACC.........hADA.cAGF.JCCFhAFAWFFE.,1,-10,-29,19
CLQEPMFeSbADGJOKfVXUWagIdHYRZTNBc,DCIHOHDAKADG...XCECUDCH..aAFFdDBB.HAGFZGDCBHHAhAAACAFAEABDFFEG.eFAChAAAABBC....fFGBhABAgGGH..IHBE..hACA...YDAHhADANIAF.LDFD,2,-37,-22,15
WHZIJKGEQagbFOTYRULdfeXCNADBVScMP,DFCFSBBDMIFEHEEFZEDCKGEHGAEH.EBCEaGBA..FEABOADGhAAARCAELEHDdHGDeBFAhABACAADBHAG..cCCAhACAIEDF.........hAHA.gEGBhAIA...,1,-11,-30,19
TOHLBRdaWCGYKAfNgUSQEcDIFMPVXbJeZ,...NDHC.gFCA.UAACEGAGIEBGMBID.XGEGhAAAJEHHZDCEHAFB.hABABBEFdDEBaADHCDBC.KAEGhACAfHADcBBCDAHF......hAEA......hAGA...,1,-20,-32,12
DROIBebGSgfCEAXQZaHJNYdUWMTFcKPVL,QCCBaDAFHDDF.JFCHdHEF.UGBG.MAIHTGEB.FAACPACDhAAADBEERCEH..BFAEhACAGCFASBHFhADACAEDAAGB.XEGC.NAEF......hABA......hACA...,1,-18,-21,3
UdJQBLCGHfKYXbEMgecPVARTSaIZWNDFO,SDAFaCFCZEEB.DGHFFGBA.dAAGQEBEBEBALBDCCEECGDFGhAAAKHGG...bABCMAEGhACAeAHB..PCDDhADAAHDHTBED.ICCFNIBH....hACA......hADA...,1,-21,-27,6
bKDfFWHZUXAcRgSdeaCVQEGLBPYONMIJT,RAADSAFBeBFE.CEGE.EFCALCBEBGDHOFADMFBH..TGDHhAAAKEBEFFFD.ZACBAEEHdCFHhABA.aGFD....hACA............hADA......hAEA...,2,-39,-33,6
bETHPDFcMAXKVINeOBGZLdWgUSaRQfYJC,VBCFeGEABAEC.LBABdFCF.UCGCSHCERCCA.fABFhAAAJGBE.CAGBEGGEhABATEEC.DIAEMFBFhAEAAIHGKACBNAIG..GCEA.....hAAA......hABA...,1,-15,-33,18
eYUIZVcWKgBTFNSHRQaMbfLGOACDPXdEJ,CAEDDAFBdBCCEGGD..eGAAUBBAZFED....VDECKAADBDAG.hAAAFDHBHGAE.QAGBhABAMCFC.fEAHhACA.OHDCAGEFXGGAIFHGhADAWHAA.....hAEA...,2,-46,-24,22
gRPXUHLWbSYcMDeVKQBdTNfAJaZEOIFCG,JDCHaEHBZFCE..EBDHOAED..IGGCCBHDGGEH.RDBA.XAAFhADALHAASCGHhAEAMDAHDABA.KGBDdBBHhAAATEEEAEFC.gAFF...hAEA......hAGA...,2,-32,-17,15
AWGRbeMJFULKQYTcIHBZgEPVdDCfNXOaS,GEDHRFDFMCIF.FCCHKDFAQAEE..TGFGHEABBBAFhAAAEBBEdFACDGGD.CHBHfGDEhABA.NDIG.aACAhAAA.WAEHeAHHJDBA.UGBEcBDC..hACA......hADA...,1,-14,-21,7
ITQcNdHbRFaEWKZeSYfOGDJAgVCXMPLBU,CFDDMFFFLCDAUEAH...QEEFdAABRGAEFEHF.EBAEZBDG..SFAChAAAOBBBDHGEAHEFVADEhABA.BHGFIDEFhADANBIEHGAE..aDGGWDAG..eADAhAEA......hAHA...,1,-6,-26,20
TNeVdEXfAHWOcaKLJbBGDUFMYCSIQgRZP,HFDFOGEAaCACKACGLBGBBFBB.DCIDMAFGCEEE....QEAGhAAARCECZCAE.PCCGhABANDIG.dGFEEBGGfABAhADAAIBE.JHAA.......hAAA.bECF.FHECIHHGhAEA.,1,-17,-28,11
EfaSARJNdDZFOQILWgMcBCHGUbVTeKPYX,RFDFdDCDFHGEQDGDLAFE.MBBGBBCFGAEAUCFC...bCABeDADhAAA.KCHH..XGAAhAAAEDCB.SGDBhABAAACG.DGHFIHBGgAGBcGFBhABACFFD.....hACA...,2,-30,-16,14
UEgLdCRPGIYMHeKSZTOAFcWDaBNJXVQbf,FHBGDACBBHAG..NCAD.JHFA..QGFGUECF.EEHBdCDHCAGBGDBFhAAA.MGBGhABAKBFCSBBDhAAAZAEF.AIEA.aDAG..XDGDfHDF.hABA......hADA...,1,-12,-58,46
gJCVAXKBLFUWDQPESNbYRGcIdaZHOTfeM,XGAFLCAFUEFDDEID.EBEG..SBDB..NDDFRDBGhAAAIDCBdGBCHGECfGDEhAAAMABGCAHEAIECBCHEhAFAWCFC....PABB.bEEA.YAFAhACA.cGEAhADA..,2,-24,-20,4
RQYFegXbVcDLSHIBKPAaUCJWdZNTGEOMf,aFFBCFEEdBFHZDEGGCAD..MAAFQDFFFGGA.eECHXEBChABA..bAAEcAFHhACADHGGLEAF.hADASGDHIBCEKHBAABIB.....hAAA......hABA...,2,-28,-17,11
PCSRHUBDOIMWTbgZdLcEeGJKFfNYVAXQa,XFCAaGFC..SAAARACGHAFBDIBGMBIF...TGBGhAAAbDDCdGFBLCDBhABAeCAFKFABFCFD.fDAAhADANIEHAAACCAHCBCHAIAGG.....hACA......hAEA...,1,-14,-18,4
XDUWGSBOJZNRKFeLgEaIAdfcCYHPbQVTM,dHBHCFDGHAFAQAED.MDDFDABCUCCAGGEHSEFAhAAABGAC.JFHBNABE..KEFCeHDEhAEAEACFACAB..fHABhAFA...cCGBbCFA...hAAA......hACA...,1,-23,-27,4
AFWaVLEQJIcHTbSGNfgRPYdeKUZOXMDCB,FAFBaCFCLEGBECAE..JDFCHABA.SGBDGAAF.NADB.hAAA.RDDH.dAHG.KGGEOAHDhABADEABCGFDAEEE.QECChAAAIDCCcGCH.....hABA......hADA...,2,-36,-10,26
DXeHRKEJBQUcIMaPGLTFOYbdVWgfCZNAS,XCBFeDACHEDEKFHFBGCC.QGGGUEEHMEDBGACF.hAAALAHBFAGC.bFABhAAAWEABCHEBAGABDCAA..hABARADBJHEA...aHCC.TCGA..hABA......hACA...,2,-27,-1,26
bfWQgaVBZAcXFJRSEYHLTePGKIMONUDCd,FGFCJDCH.RBCE...SFHBEABHLEEC..eBGBKHDAMAEAhAAAUFEFDIAE.dDAAfEBEhABAQABDaDAABAHFhAAAACIH...cDDAXGBC...hABA......hADA...,1,-25,-37,12
BOUbIDLKecCZQVAJFNRSgMGPEHXafWdTY,FDCDRDAGMAHFEGDG..HFFD..aDFCdBEGBFGBOCGFUACGDIBGKGDEeACFhAAAZGAA...AEEGJCAFhABASAFF..hAAA............hABA......hAIA...,1,-28,-41,13
VJNQAYdXbfTUCFaRKZLISeMWHODBPGgcE,XGBCTCBC.UCGECBHH..FHFARAACLAECeGAGHADDBDACGBFEhAAAEGHF...NBAGAFEHdCCDhAAA.aDFH.KFBCIFCBhABA..MEEFDFIF......hABA......hADA...,2,-22,-15,7
PVIfEKSHNcWOQMZFAYXJdCUaGLBgRDbeT,XDACCDGFGDBELHFERDFH..DIFGTEEDVAAC..EFDGSABDhAAAHFBB.NADE.hACA..WDCEMBIDABGFdAHAhAAABAEGeFAFIAGEKFHF.OFAB.hADA......hAEA...,1,-11,-14,3
bdKUIgAPOcWYVZLSBJaHRXeTFQNGfMECD,OGEA..cFCAVBGF..ZBCEBBDCHCAFeFFEFGBAQDDChAAAGEAAECEFCHHHDABEKABHhAAA....IHAFhAEAAHDFYAHFLFHBSAFB..hABA.aGED....hADA...,1,-9,-29,20
OJKQfHcUaVISXCBEgMLdbRNATPWGFZeDY,TCBCGAFEeBDF.DIDEOFEBKHAG.HACGaFBA.IHHEhAAA.CAGGECGGgFEGhAAAdDEDRFAAABIHFFFAJBBFfACFhABA.........hABA......hACA...,1,-15,-24,9
eEGNRTWXQPFZBgMSHAfJdOIDLVUYcbCKa,dDCDOFCHLACCUAAC.....bDGHCDEFKBDD..aHBAEEAFGBEDhAAAREGH..XGEChADAFFDGBAHH.MBBFhABAAGIBJAEEDGAD......YAHBhAEANIEB......hBAA...,1,-16,-38,22
VUcKHWgaCPSFJOBfdQAeNbDLIRMGEZXYT,eGEADACBRBFBGBAEECAHZACA.....TECGUGACKCEDHEGB.aEEFhAAACDHFSAHFhAAA.JEAGBGAC..hABAfEFDAIEC.......hADA......hAEA.NHBB.ICCF,1,-27,-29,2
IZTYaeRgNCbEMHWFXKAVdLJSOQGfUPDBc,VDEDLFFB.SCAGGEAAUACGBAEAZAFA..aHCGeCFEhAAARDCGCAGD.EGGFHAAE.FEAFhAAAAGDEdBAEQDGAhACADDDFIEHF..YFCA.NCCF..hABA......hAGA...,2,-18,-5,13
XERGNFMHLQPOcCaBYeDIdgSAZJbfKUVTW,ZFDFJGEA.KEBCUEBE..VDGB..TAFAEAEF..RABHFEAHMACBhAAA.LHAG.hAAAQDFH.hABAOADFcGGDaBABBHCHDIEE.IHAHhADASEHHADDCWEEB..hAEA...,2,-37,-21,16
XZEKCVLJTegacUPDWMABQfOYbRGSdIFHN,QGGGOGEARDCBGADGSDFD.dECBFCHDHGBCZDAFKCFBCEAGJAGDhAAAeBAA..aACE.hAAA.PHACDBBDAIACBCDHhABA.fGEBYAFE.NCIE....hABA......hACA...,1,-10,-19,9
DJUAadETcQKLZNfSIOXWBVMRYbPFCgGeH,EDABTCGCKECC..ZDGHSEBC.OFFABBAEMIAC.hAAARFAC.PFCDCCCGGBDDhAAADAGEUBBHAEIDdFED.LAEFhABA.IHHHWAHB.....hABA......hACA...,2,-31,-18,13
VKZDFLJgICeTYAGafbcOdMWPXNEUBQSRH,aGAH..fCFCODBBdDFCMFBF.XABGUAFHSHEEhAAAVCCDZGFG.FCDHgDGFhAAACHHBeBAA.AAEGGFCBhACA.bAFA........hADA......hAGA...,2,-33,-3,30
NXPURCVYgIHLJABEKTdZacMSWFQfbeGOD,BEFAKFAAdGDEaAGB..MAFEFECB...QAABeBBEDHGA...hAAAXFGHRCAFCCHF.VDEGhABAIFHFHDAGACHHZEDBhABA...SFADfADBOHEChACANBIE......hADA...,2,-32,-16,16
SWNZVeMFCDHXBOGRKEcUJPbYgfdITLaAQ,SGFCZAADMFHHDCIBHACG.OFAFRDCBKCFE.EGHH..UFAHPDDBhAAA...gDAChABAdCCF.IHCDhACAaEEAAHEE.QCFFNBEF.FEGECEAB.BAHAhADA.....hAAA...,1,8,-41,49
IPSJNaCRKcLEFZXDHAVeQTUgMWObYfBdG,eBDGUCCBMABEOEAC.....fHADdHCBIFHGSDEGhAAAaFCE.CBBAKCHBhABAEGAFFFFFDGFDAHIF.TAGEhACAbAEABCFFGEGEJAAH.NGAF......hAFA......hAGA...,1,-10,-29,19
ScEPNTGBZJgIHVUMXFQOLWADYfbRCeKad,DACB..fCFCCFDGKBEH.dDBGEFADTGGEBCGC.ZEDE.JACHHGFGhAAA.UDCFFGAEOAFGhAAAADHG....hABAYADDeHDE.aHAEPAEB...hABA.NBBEIEHEhAFAMBIF...,2,-43,-7,36
ecZfTIYJVSWXgAECBGUMLPFDRaKHdNbOQ,CCEAGCEHUGBE.MAAFLCDDDCBD..KFGDdAGFOECH.eAEGhABAfFHC..hAAAIHHAJBAE.WHCAhACAAFFGBBHG.RGDAaDAA.....NABF.hBAAQCCA.hBEA...,2,-33,-25,8
FcMEXVQeLUIKYZPSGRdaHgWDBNfAObTCJ,ODACCHHGFBFH...EFHBQFGDUGDEKCFD.ZGBEGAAFRAAE.dAGHhAAAHEEDDHAA.BAECAHHF.hABATDAGMCIBXDDDhADA..........hAEA......hAFA...,1,-24,-31,7
gbKZUAPCRSeTMcIJGWFLdfDBYOXaQVEHN,RDBHSGDDeDFC.MAIDJADCGDDG.LBAHdEEHBGHCOHFAhAAAaDAEVACC.HFAFhAAA...bAFBUAGAhABACEHD.cACCFBADDDDB......hABA......hACA...,2,-15,-15,0
KdcNQXECfYLMPJUOIGTZFSWVgHRbABeaD,aDABdGCDQAGF.CBBB.LFEF.MBBAPDEAJCFHIDCBhAAAGDABFADGSHBChABAVFFF.RFGHACAEhACABBADKFBA.NCIEfHABOAHF...hADA......hAEA...,2,-26,-13,13
eBYPXdLZJcGEQMObagKTVDCNHAUIRSWFf,REFHSAFB.FBCCfBCABGHD.XAECZDDGJEBH.EHGAhAAAOFFH..aGAEhABAKDHBDDGACHDG.AACGUAGEhAFAeAADdAHELFCB.......hABA......hACA...,1,-18,-35,17
XdbDMBOfSHGZYgIJeVcFQPRCTLAWNKaUE,KHBGUFCEECFBdAAB.DIGAMFHD..BFADSBECHADAZGFE..hADAIABGeDEBFEGHQFEFhAAA.CGAGADHGhADANBBE.aBDHOBHH..fEAHhAEA......hAFA...,2,-36,-27,9
PgfUFaYQKWVSNDLEJOTCHMdeXIZRBcGbA,...fDCDFFHBQDACKBGH.SAEFLHAGEEGBOACHhAAACCEEMAAFdBHEIFFFhABAZEACBGHA...bDEGhADAAGGDPFEHUGBEaAGHWBDC.DAGETGDAhAHA......hAIA...,1,-15,-20,5
SgDALIEGZNKMWCRfPebdVQYFUXcaBJOTH,EDCDGEDHKHEG.CAGDRCAB..eBAFdCFH..QACHFFFFUCGDaBEBBGEGhAAA...OFABhABATEADSGGAhACAABDF.IDDFZGBG.MIFAfAHAhAAA......hABA...,2,-32,-16,16
cbYFZgOCdEBRGATSIWLMfJeKHDPXaQVNU,SGFCLGEAJAFDeBDHHDDA..DEAFXBAFaABD.QFAGhAAANBFE.UACEhABAYCHFFCHFOHBChAFACDABBHBGAFFA...........hAHA......hAIA...,2,-40,-11,29
eITCfWEMQPOLgJKGadNDHSXRbZFAYUVBc,VEFHBAFBeEAC.CHHG.ECCF..QBAHOABGLEDBhAAAKCFAGECBaHACDGAE.XBFBhAFA...hAAA............hABA......hACA...,1,-29,-47,18
ZFEeafMLUITSOBbNPXWgQKYRJdDAGcCHV,GGDHHDBHZFEHeBDGMEIBLEAGUBFE.SBBDBGGB.NBHC.hAAAPHAA.XBCEhAAAWDGD..KHAGJBABhABADAGEAGED.CFEC..........hACA......hADA...,1,-21,-25,4
RAQOMGPVFWgTLISZHYceCBfNDXaJbUEdK,OAEHGBGAFABE..TEGFLEBDSGCBHBDAeDEFBFEChAAAfAFFDCIH.hABAXGGA.aAABhAEAUGGFEGEF.KAGGAFAD.QBBB.MCAFhACA.....hAFA...,2,-27,-9,18
OMJNcDZWYSBegEHUabdILPKGCQXAFfVTR,FCFCTFDHREFB..OGACJBDC..DEAFZACD..SFHBhAAABAFFEECEHAAFaHAC.dHFDPDCEhABACEBD..AEHDMCIHhAAANCBA....cGFG....hACA......hADA.eCGH.,2,-25,-21,4
CZEOcQHgFAbGUNJSfIYdBMXLPDaWeKVRT,UAGHSDCD..fCEDdABEMHFCLFFGDCCH.eBHFhAAARDABTDGGEEABOBDChADAQGFBFGDFAGAB.bAAEhAAAJDDEBDDD.aFAHKHAACFEF......hAEA......hAFA...,2,-17,-13,4
eQWGaLXMgRPYdfcBOSDTUIZCEFbJNVAKH,KDBDeBDGQDCGGDCGaFHHLEFB.MCHFgGAFhAAA..PGCGdBBEcGFHhABAOAEA.DCACIAFFhACAEABC.FCHFNDICABIDXGDDfHBDhAAABEAF.....hABA...,2,-25,0,25
gbBacMeLPfHRIXVKADSNGCOQJTFUZdWYE,DGHHGEAHQAACFBGBdBAD..EEGABEGC.MGCALFFAHAGHXCCGhACAAICESADFhAAANEAA.CDDHOHDA.hADA.TBEE.ZEBE.WGDA...hABA......hACA...,1,-10,-29,19
daZebMWXTSVgLBCJfUcDYNOEFHAGKRIPQ,KCAHRAADQGDDdCHCZEEH..eCCCMBEA...XCEFSAFAhAAAVDGDBAEF.fGCEhABADEACNACF.EABChAGAAHCBIHAG.aDDHWFDB...hAAA......hAHA...,2,-31,-23,8
QMSDKEgIAHTfdXaONCGcPBZYWVLUeFbJR,TFDHXGBC..aCEAOCAD.CAGEGFDBBEBGZDCA.VAAChAAAeBAEFAGGRCDG..SHEGhAAADDHBEGHDADDG.dADF.hADANCIC...YFAFLCGB....hABA......hACA...,2,-20,-11,9
GXcSeLRAdKDVJINQPaHZMbWgECUFfOYTB,DGGDVFDF..JACGQFADHBFHZCAF.MFIF....bDDHgCCDhAAA.CDABUCFBhABAfAHG.hACAOGACBBHBXFFBSEHB.eFHDhAAAAAEEKAFBNIAFPCCD.hADA.WBBC.,2,-16,-12,4
fGBdgLcCXbKAIQJOHZVSFYMDUaNPeRWET,QDACHFBGSGFHMBBG.aBCG.eCFBEFHFGDDHBEAGLCHFhAAAXAGDAAGCJDEFZGDAFGAAhAAADBAD.NIBF...WHBGhABAfCCB.......hACA......hADA...,1,-4,-21,17
RAdBWEbGKLTPYgcSOCZXDQeaUHVMFNfIJ,BFEDEHBGKGHBLCAF..TEBB..gBEFhAAAOADGZAABDEEEaEFBHABEFEHB.hAAAfCGDJCCC.hAHAdHEFWAFAbGAAPFFA.SDCDhABACGDC.....hBAA...,1,-8,-27,19
RAZKBINUQHbacWTGCYJMSFXeLVEPfODdg,BCAHUCBCHBFCaGEE...TGEHCAGD.MFECXDEELHAAhAAAECGE.OABEDAACRFADAAEEKDDEhABA.IAFF.hADANCAE.bFCD.GCBESGGHeHFA...hAHA......hAIA...,2,-25,-4,21
dcXRQHfEKDePYNIJVGWSMFCLgTbAaBOZU,OCAFdDAFRFABHDFHKEEE.DEEH..eECB..NCAB.IEHD.hAAAJGFEVAFE.SDDFhABAFBGCCDDFLAAEhAEA..bFGHAFAFBHAC......hAFA......hAGA...,2,-36,-22,14
cBXQCMYUSeObKRfGJIZAgVdWTDaFLENPH,VDAGTGBC..FBBAEEDBHGDABCFE.CCCC.UDGF.OAGFKGGC.hAAA.fEBChABAJGAEAIGA.dACFDACGLFFDhAFA..NAFEXFFAMAID...SDDBhAAAeDDG..hABA...,2,-27,-17,10
WUOdbQTMPGfDHEBNcXRCgVAaKJeFYIZSL,aEEDJFFB..FCFHZFCF.LAEGUDAG.OAAEdGAE..QGCHhAAATGGC.GACBhABADCGFBCCD.XFADhAAACCCEAEEDKAHF.ICEH.SDAFhABAMDIF.fHEBhADA.NAIE..,2,-30,-28,2
IDQFOHXSPKGWJTfCMUVYBNZRedbEagcAL,LFCHDAFBFGABHCCCXEGFKHEE..GCFGJBAD..CFFHUBGBhAAABHGAZEBA.eAABEFAFaGHDhABAAEAH...QCDHhACASACH.WCHBfHAF.hABA.MIBENEEE...hADA...,2,-26,-20,6
JTSBFGDXfZMRdNYWLgaVKHOCeQUPEIbAc,JDACTGAFBHEA..DAACZBFEdAEC.....NIEB.LDGDhAAA.aAFCKFDEHACDCDEFeDGDhADAQEDE.hAGAEHAAIDBA.ADIHSFHHhAHAXEACfDHAMBFAWHDChAIA...,1,-22,-42,20
CNgLOHGESABWeMXfJFDRUTbKIVcQdPYaZ,BAFBMDEB.JADBRAADUGBF..KAAC..VAFGdEGB..aHGECHEFLDFFhAAAHGCCGCBCEACB.hADAAEFD...eHFAFHACTBGChADAIEBE........hAEA......hAFA...,2,-28,-23,5
NafeHMBGRPgcEUKYbWCFOLdQJISAZTXDV,TDCBXFCA.DHGAaGCD..HACGBAACRCEB.....cAEDhACAEDAAUAAE.bAGDCFACFHFAhADAdFGB.JBGBAFAHNIBFfADFhAHA.MAIB...PEHDhBBA.KCBE.WFEF.hADA...,1,-13,-19,6
aIVJgOFUZNRDHLYTedQbCcXBGSKAEfPWM,EHBG..PCCHaDCB..JFEBOEEF.ZAACDADDLAHBhABAeCGBdBAHQGABhACACDEDBAEAKGGCfBFDhADA.MEGFIEABFGDDNAEE...YAHHhAAA.....hAFA...,2,-33,-14,19
SPZBCeaKAfFbcEgRQTJMLNUXHdWYOIVDG,FHBGEHBGRAFBQFDE..MFDAUAGCXBACdBAAODDGVFGFhAAADGFA...SACChAAABHEGaBDFAFCDfEBDhABAgDACTAEANAIA.....hABA......hACA...,1,-23,-25,2
GTQZDEgBXAcNSYbPUMHCVWOadeJKLRFIf,SHBG..PFFCMEFAVAECaFCAeBDB.LAAFhACAIECCGAEFZAACDACChABABDHAAHCG.NHDBbEABUGFDhAHA.CFFBdCCD.KFDB.fCGHEBBB.hADA......hAEA...,1,-12,-17,5
eRLWacCGbfgFVJUDIBQAZOTMXEYPSKHNd,OBDGMGEC..EFAGSGHBHABFdHBHLHEAaDEC.CFHBGBDChAAAfAAH.gCGGhAAAFCHHUAGBIDABhABAAAIHZEAGTGAG.XFFD.PDAAhADA.NICH...hAEA.RFCC..,2,-12,-4,8
aUPZDeQJMFGKSROBbNHVICLWYEdXgATfc,TCBCaHBGZDCF..DBCGJDFA..FEHHGAED.KDADSCADhAAARFEEBACCHFAACAHELCFGhABAEAAFdFHAAEEHUFEE..hACAeHCEMIEG.bBBG.....IBGDhADA.XFAChAEA..,2,-14,-11,3
YfGLZUMQNFecDTbIRaVWCHEOXPSBgdKJA,GAFEZAEGMCADFACGDGCB..TFGHREEG..aDBGVCCA.CHBEHAABhAAAXGECBFBGKBACAIFA.hAFA....fGAEhAAA.LCFEUFEENBIG....hABA......hACA...,1,-10,-35,25
TWVMSHQFUeLgYKGDPRdBJCOXbEcaNZAIf,TCBCVFAC..HACCUEDCLHDEKHEEDGBB.dFGFBBFGCDAC..OAFDhAAAEEAG..aABENAHCZCCHhABAAHIH....fCGAhAAAMAIB.SAGA.eFFEhABA.....hACA...,2,-29,-17,12
aMEeNOWUFDJPCdAYVHbZfKRBcQTSGIgXL,VGFGHGFGZDDH.KFCBBDFGQAGBGBCC..XBAFLAADhACAEEHBOBCC.WHAGhADAUGBF.DADACEBDAEHHfAGAhAAA........hABA......hACA...,2,-30,-18,12
CgaFDeIVKfTUcYHMbPBENWOQGSRdXAJZL,LFFCaEGD.eCAFKBBHUFAAHCDAMEFCBAAB.EAGCODEH.hAAAGBDBdGAGXGGGhABAAEIF.ZGCCCHDADGIBfFCDhACA.TACC.....hACA.bDAA.NADFSDGChAIA,1,-10,-33,23
aObJcGZLXSTdFBWNIMHPRQfKDeVYAUECg,UGAFCFED.OFEAJDHHZADGLBFE..TFAFFBAFBEBA.hAAA...IGGFhABAMAEHHGDERCAAKCFHDCDFeHCAhACA.ACHG.aAAA.cDGA....hADA......hAFA...,1,-32,-34,2
BJFdHAKgILbRSXQOVEUaTPcNCGfDYeZMW,KHBGLGEARBFA.SBDDQDEHECAAUBBD..aGAETEBFhAAA..NFDDfDEHhAAADFID.YBEGhABAMAEGJHEE.dFFHAIACIFAE.ODHFhACA....hADA...,1,-27,-28,1
WXGdYMLROTNaSCPfUBJAKEZeFIVgcQHDb,KEHBEDBDFAFD..IGDD..gAAFHBACDGFAXBGChAAAdDEGMEHFLFAHhAAA.TGEENAEECAGEUDBHhABAADGA...........hADA......hAEA.eAHBcFAE,2,-34,-16,18
JIORAcYTUbMXBPSQadeWGNDZLCgEFVKHf,TCBCMFFFBCGD..QAFBeBDFGDACDHDECEFGEBAH.KGHHfABChAAA.JGAEhABAIHCEAHGG..hAAAcEGFYEECbEACSADBaAEAdAHE.hABANIDB......hACA...,1,-13,-25,12
fNOHLVbSFKgaeWCGAPEIDZMTUJXdRBQcY,EHBGZFDGUAAHdFBBBAED..QADF..fAGGhAAAOEAALBHDSDEFhABAgGAFaEGACDACAFGAIBCAhACADAGCJHFG.XFFCcCDC...hABA......hAEA...,2,-30,-26,4
aTLVcQDJbGeEXWIBUCgSFYPZNfMAKdOHR,KEEDdDBDREGHLAAE.QAGGJAHHGBAFEFHB..XFAFhAAABCCBCGFBFCFHZEEDMFDBhABAOGBEHAED..aEBAhAEA............hAFA......hAIA...,2,-33,-17,16
OYdJeMKEVHTNXDUcAPZLBgaSWIFQRGfbC,ZFDFLAFBBDCB.SACGFEBDGBCHCCCF.dGGF..JEDFKCAFEDABHAFChAAA...XEEBhABADGHHAAHCaHEE.IAAChADAfABH.OCHFMBIB....hAEA......hAFA...,1,-22,-36,14
VHdUPCefIQagETXDYZABbGKWOMFLRNJSc,BECDKGAHOBFAFCDDLAFH..RDCAJADBSBBBHFFBdDGDCHBC.hAAA..eFAEQGEGhABAEABADAAF.AAIHbEFA.hABA..MAHFcGCDPCAB...IHHBhACA...hAFA...,1,-21,-25,4
EaRBQTZGWYPcgAXfDNIbUKSdMOJFeCVHL,XAFBDACB..IFFAKHCEdDCAMEBHOBEH..FACDCGHGHAFChAAALFFCRGCE.QCEChAAAZFAF...hABAYCADPDCHAFEF.......hABA......hACA...,2,-30,-30,0
LSgIRAaVcOdJNWeXYFPCQbGTBKZUEMHDf,aCFCVFDF..OFEEdBHC..JHFEeECC.FBGCCBCGGEAABBAAZCAEhAAAUCEAMIAA.DIGESDBBhAAARFAE.AAHG.hABAWEHB..YADC....hACA......hBAA...,1,-25,-32,7
cIARVKMUSFJDZTeXBPbgEYdfOaWLQGHCN,VDDFMAEDFCBD.ZFCGeAFD.BAHB..bFABEAAB.dGHCOHCEhAAAaDHD.LDDGhABAHGBGCCCH.IHHGAGFEUEAEDACEhABAXAGB.YDHF...hAGA......hBCA...,2,-18,-15,3
gJeGBUfbPTLNVFWQZAEdKaSIHMRDOYXcC,KDABaAFBHCAERACF.ODEF..XFCGCBGC.eECEBDHFUGGEhAAAPHFELAGHhABAFACFZEBBEDHF.SGBDhACAIGDBMEIBDAID.......hAEA......hAFA...,2,-22,-21,1
PAcdHRNVgBSabJYEXCUFOIfMQZTeDLGWK,dCFCHGFGRGFE.VAACBBHH..aDEAJAFG..EGCAUACGFDAD..OHCEhAAA..IFAChAAAfBHEZBAFDEEBLFCEhADA.KGABAHEB.gADH.SAGFhAIA..hBIA...,2,-48,-8,40
MCXadYZKIcLWNGBDTeHVJFASOPRfQUgEb,OCCHRAADQDFFUGEG...EFCHMACCCHFC.dEEBZCDFKBHDLEABhAAAGGAFBBEHDGGCTAGDhACAeAAF...JADEAHHASBDFhAAA.......hADA......hAIA...,2,-26,-19,7
JTgDbBHFNZfPMOVcAUdKQIYSXGWLaeCRE,dFHAQGBCSECDGFDFLFDHCBDCECEB.JAAF..DCBFBADEhABAFGHDZCFFMFBB..OBFAhAAAAHCDUGFGKABEIAFChACA...XCCAaCCH.RAGF..hAEA......hAFA...,1,-17,-21,4
TdLHIRMBOKPDbYVNFZCgJWSGeXfaUQAcE,TGBCdDBDHAGD.MFIBKBEGDDBB..VFDDFEFGZFGD..CAABJFBBhACASBBGGAEC.XGDBhAAAaGGD.AACFEAHDhABAIBCABADCOFAB.....hADA......hAEA...,2,-24,-21,3
JTQEBGLgMICOPcNDeUWRFKYdXafAZbSHV,ZDAGSCFCHAGFJDHDEACGBBCD..GFABLEEFMEDCOACGhAAAPFFG...DIGAhAAAUGGHFCCAdHDHXFBAhABAAHHEbBAB...........hABA......hAEA...,2,-24,-16,8
KFDEXPWRfIZbHTSMacUQGAYNBCVegJOdL,BFDGCEFA.eBADJECFLBDFDEIF..EBBA..XFGEhAAARCDDZGCCHAFHMICAaEAHUBGDhABAAHGE....YAHBhAAANAEH..........hABA......hACA...,1,-27,-41,14
WfRDTMPYeENSUXQaCKOBGZgdIFALJVHbc,VFBGHAAD....bDCC..fAACDIBGTFDDMFAD.eADFhAAANBEH.SGFHhACAUCGEQGGGCCBGBFFFGCEBhADA.........hAAA......hACA.dGABAECC,2,-24,-18,6
NRGgVWXOBFCaZTSYeDUHEMKQdAfcLIbPJ,LGEA..IEFAPBCDREAEVAAE..OHBECDAFaGCE.hAAAZCEH.SBADhAAAeAFDDGHDHEBGKAGG.ADDEbBGBhADAJCHF...NICF........hABA......hACA...,2,-25,-18,7
FfXVRUTSdPGgBYaJcNIMZHeEKDOCAWQLb,QDACFDCD..VCGHTFDHdCAGGEECBAACaGGA.JAGDIAHGhAAAHGAE.KBDECHEALDFAhACA.fBBBhADAUGAHSBBB....hABA......hACA...,1,-10,-32,22
ZfLaKFcJUVdCQWGPgYISeAMRHEDNBbOTX,HFBGEHFGDAFBBHEF.TEFAZFFALDAH.FCHHJABDUACGCAGBQADChAAAGGAF..hABA.gCEAhAFASDEAMCIF.........hAAA......hABA...,1,-19,-31,12
AYBKVGeQRJUXCgWfLFIPTSMcOZbEdNHaD,KEGDVFBHGCCH.QDAGUGEDCBFD.....fGAEhAAAIABA.TFCEhABAMFEEZDDEdCHGaABEDAAFADCG.hACABHHGRAEAXFEDLAEC.SDADhADA...OAHDhBDANIDB..,1,-7,-24,17
FLfTIagEZcDHWYeQJPNCVRUBGdXbSMKOA,LCCHTCBC.aAGDZAEHHFFFeEEC.JECBCHDARBAB.BCEFdGHESGADhAAAKGBF.ADABFBHHhABAIADH.EFDF.hACADCIHWFGF.........hAAA......hABA...,2,-32,-22,10
MYJAWDgaXBLKedNVcUEGTOZSFbQfPCIRH,DACBXGBCBFEALHDAdDAA..VDFBEDCAGBEHZAAE.FBAHhAAAfHGB.hABAIDCCHFAFMAFChADAACIDaAECKEHD..........hAEA......hBBA...,1,-26,-28,2
DTUafQPBXOEdYKFNAeCJRbLHGIScVWMZg,eEGHCEFARFDH.LAFEHBDHGBBCSECB..VAGDZAAHDHBAhACAaAAH.fEEChADABFHHXGAGdEAAFADDAADCJHFEhABAbCFE............hACA......hAFA...,1,-9,-17,8
PUYQHBcDNKEOFgfdbeRWLZMGACSITJXVa,SEGDTDAC..XGAFVBAHUAGGHBBEBCEGDEDCKHEEOFCDhAAAFFDAdAFH.bDGHeEEHhABA.LFABhACAMABGAHHFCCFAIHFF..aHCC....hAAA......hAGA...,2,-20,-12,8
CefcRBTGHOSdXDZgYKWaFJNAIMQEPLUbV,QFDBLCCHVEFGeFBB.RDCE.BABEHAABdAEGZBECKGABFAGEAADD.EGFAhAAA..UBFGCHHE..hAAAfGAEGEDE.hAGASADFDAIF.......hAHA......hBAA...,1,-1,-30,29
EAHDGfBLPdIRXVQYMNSWbTFOJeCcKUgZa,DCHDGGDHLCDEdEDCRCGH.QABBMCBH..SABAhAAATGEHFFAAeAEHKHACUEEFhAAA.aAGCEAGC.AIBAfCFAhABAIHHH........hACA......hAEA.YCCD.,2,-20,-11,9
cgYMBWAHXZSUdFKfePbaTQDGCRIVEOLJN,XBBHUCCBdAHCFAAFKDGB....eEDGaGFD.DHGAGDGC.RGAG.hACAEGCHLBFFJBEC.hAAA.NIEF...cEBHhADAMFAEBADF.ACEHSAHBfADF.hAGA......hBCA...,2,-30,-26,4
VdPFUQDeRNBEYCXZSbLgKGAIfMaTcWOHJ,MCCATGBC..OAABJCCE.dEEDFAHFDGIHREED.BHED..CBAFZAFFhAAASHBELEAEKCGEhABAAEGC...aEBF..hACAWEHHPAEE.eFGH...NDBB.ECAAhABA......hACA...,1,-25,-31,6
KICBSQbUPeHXFJRTZVaAMOdGcgLDYWfNE,dFAGGAFELDFBDIAC....fFHANDAFKEBE.CDEASACBhAAAQAEDUAAFhABAPEBBHFCB.FHFCTCBEhABA.ZFFBAHHAMAIFcEDH....hAEA.WAHHIEEAhADABHEF...,2,-23,-10,13
TUIBbcYaPZdOSfMRKDXWAJLCNHFQEVegG,JEGHLAFBHCBBFHEEEDDH..eHFEGGABUACGBFAH..bFFAaBBAhAAAZCGBdAFD..OBABhAAASAEDMHACKEBFhABADDIDADADCFEC.QEDA.....hAHA......hAIA...,2,-16,-11,5
gVQFWXISUBfeYZHcCGbRTLDJdMOaPEANK,KHBGQFDHFEGD...XAAFSCCFBCCFeEDHHCFBGAEDhAAAbADHLFCDhADADBBAMEIDPAFEAAHE.NDBE.hAFAVEABIGHF.......hABA.YDFDCHFA.hAIA...,2,-24,-6,18
RMdgFOLQbYcUSBCWVNJTPfeAZHGDXKaEI,HCADXCCBKAAGaFCERAFC..dGACFFGGLHDE.QEGAhAAAbEEHUAFFBDHHCABF..hAAAWCEANEAG..JDCETEBGhADA...fEEAAIHADCCCEACE..hAEA......hAFA...,1,-14,-22,8
KcRYXFAaGQIUVdCBDOLfMTeNZSgPHWEbJ,GBDBQCGCUCACdCAGBHHGDDFHLGDC.MCCDeAFESDDHhAAAgEEDHFABhABAEGEDKGBG.RDGFXEBAhAAAaAGACHGHfBDA.NEIE....hABA.WABA...hACA...,1,-13,-14,1
AJfcSKUCRPDNFEdQLOXGeIZBYgaVWMTbH,JGEASHBG.CABH.RCEHDBCH.FFAFdDGH.QDCDLAAHGAEFhACAIBEABDCAhADAaAGH..MAAFHDGBfEAChABAKHCE.PHFANIEF.XFDChADA.YFFChAEA...,1,-24,-29,5
PRYGMXSbEQfKLWFNeZHTACcJgOIdUDBVa,CAFBJGEA..OEACdHBDBBED..VAACRCAHGCCG..SCDHhAAAQBGBKGEHFEHFhAAAeDHH.ZCEDAAFH.IHADhADADBAGaGAG...YBGB.XGGEhAEA...hABA...,1,-20,-35,15
ReATQBYDUSKZJMNbXcEPIOVfdFCgGLHWa,BCAHDAFBKAGHMBFA....XBCCEDEEOEBBdGDFFEBCGEGEhAAALAAHaACC.AEIB.TFCAhABAUGAHZDEA..hACANICF.....cFFAICHE.CCCB.hADA......hAEA...,1,-27,-31,4
DNQJFbeaGAKfLEPOBYcdTXIZWMVUgCRSH,LCCHOCCHBFEGdAGG..TGECZEAHMDDCUDGH..CGHCRCGFSCEFhAAA.NIAF..hAAA.FADBeEBDaAFEAIBAfBAAhABAEBAA.cGGAWFFB....hACA......hADA...,1,-23,-35,12
BTVDQGUAeFfHMCSgXdaOJRWYNZEcPbLKI,FDCDHFACCHAB.XEED.OCADJBADREGD.....NEIAZADDEEEH.hAAA..bBBBKABEBAHFhAAADGDBUCGHeBHHfHCFhABA.MFHFdBFBaAGA....hAEA......hAFA...,2,-42,4,46
TENFXcVDeQgJRYMWbOGSZUfLdBKPIaHAC,CFCFEGFCFCAB....XDDFDGDB.QGBGRCDDMEBD.bBAFOEHHhAAA..ZADELFFBhABABBHGIECFhAAAADCH.cEGAVAGHJABEWFAF.UGDEKGED.hAFA......hAGA...,2,-30,-4,26
UYPVGBfFCRQgcONJKWADEHIMdLZSbeTXa,EEAEHFACdAGELDFCZBBA.SBBFeHEAaFFA...UAFEVFCChAAABGED.CFFGgDCBhAAA.NIAF.WFHHhABADIGE.MAFF..TADFYDEG.hABA......hACA...,1,-19,-21,2
fUMHYcWIbaFOBGPRTSKEVDQXNeJgdCAZL,ZFDFLDACUAEGHDGH....WCGBIDDHFAAC.OAABhABAGGEB.RGAGKEBADIGAXDAEhACAeBEDdAFBAFFGMAIFhADA...cGBE.BBGESEEDhACA....hADA...,1,-18,-26,8
CUAdKYVEGNQODRTaSZPFbWBceMIXLgJfH,dAFBKCFCEDBBQDCB.OFDFDGABaFDEZAAC.FEAFBAFA.eCHFhAAAXGFGLABEhAFAJCGF.CHGEAFDA....hAHA............hAIA......hBAA...,1,-32,-44,12
VTMEHNOcWBJQgbeSfYGXZRFaAPDUIKCLd,DAFBKGFCdGCDMBCDHADA.OBGFBFEHQGFE..eCBGhAAASFDFGDAAXDEAhABAFADHAAAEUBGDIHHChACACHAH..LDEG.ECAB.hADAcEAH...hAFA...,2,-28,-22,6
FdUVCacfWIZbEgQJNPSLBMOGXKYDAeHRT,eDACRBCDdCHGUAEFCFAG.....aBBBfFDDZFEF.EDECJHBGhAAA..SHCEhAAABDFBMFAFOCFA.hABAKFHH.AHHBTACH.FGFDcGGAIBAGhABAQDAF.hACA...,2,-29,-29,0
JIFEGTHCWUKSBdZYfgPQRaVAODbNcXMeL,OFCHDACB....bEBAXBBDLCDEFGABEGAGHADG.CBABKEGChAAAdFFEZAAF.fDHEhADAPECARFFBAADEMAFGhAEA.eHBA.........hABA......hACA...,2,-28,-14,14
FGMTIaKNBUAWVSOQJLeYZgHDCPbcfREXd,VDAGSGDD.QEBFJBACLADHZCCADIGA..CFED.bEGBhAAARGFGdGBG.FDFHGACDhABA.IGAAhACAaCHHKAFFBAHAACHHOAFA.YFFD..hADA......hBAA...,2,-30,-12,18
bVMAJgSRdFHZWLQcBfUCEOaXNYDKeGTPI,SDCDRFEEHBEALCBDBBECUEGGCHEF..aDHD..XFEFhAAADCADKGAFeDDF..hAAAPHAAIABFMADHhABAAICE.dGDA.ZBFE........hACA......hAEA...,2,-30,-24,6
cFCeNQVbHUJSXARZDIKGTPLEOaBYdMWfg,DDGBGEAHLCDFOHDEBHACdCDC..MBDC..fDBChAAAFFFGCAAC.eEEHQCAFhACAHAEDSBBChABAAGACIGHGPDHB.aEAH.WHCG.cGGChACANAEF....hADA...,2,-26,-23,3
bgNWCcOLXBQSAFTEKPUYZGMdReJDHfIVa,TFCEEAFBUEFE.ZCBAMABC..eBHDDFIDHCEG..IGDBhAAAaFEA..NDBACAEALHFEhABABDDGAAHG.KABGPAABhAGAGEAG..dHFBfECB.hBCA......hBDA...,2,-24,-16,8
WPZHVbIMFOaLDABfCURdGKXSNQcJEgYTe,CBBDdDAFGGEHKAAD..SGFAQECB.JABCEFCF...TBFHhABAPBFHHEEE.hAAAIGAGOCHHaHBEhAEAABCBBDHDfGAC......hAFA......hAGA...,1,-28,-29,1
dRMOKTWVQabDfLgCXAYPZcIBGESFNJeHU,ZAADBFDGSDFDJDEG.UBGFdBEDOHAEKHAC....VEBGhAAAaCCF.DGHBLFGFhAAACAEA.ADAC....hADAPAHDIGEFFFHDeACCMCCE....hABA......hACA...,1,-34,-36,2
DFNQAaHecdRLMGKfTVWJIbZXOSECgYUPB,aDBDHFDF.eBDHdFFALDADGCFEKBGC.VEAEIHBD.ZDGHhAAAXBACEABF.CHAB.hAAAgDDF.hABA.PHFCBHHBDIECNAEFACIH.RACFMGCC..hABA......hAEA...,2,-16,-3,13
YJHSQcRaVGZbEPUBfWDLACXMTOKNFgeId,MEECTGGDKCAB..FFAAeEHFdDDFHAGH.SDGGRGBEVAEAZDCFhAAAEBABBGFG.DIGAAAEECGFFhAAA.XGACOEAB.hABA...gACD....hAEA......hAHA...,2,-21,-19,2
FDKLbeAEVHBIGUNdQYCWcOTaJRfMgSXPZ,VBCFBFDDGGEH.UAAFdGHCQEEC.CBABOBGFhAAAJBHFfBEF.hABAMADCgDAEhACA.SAGCZDBDDFFCKHAALFADAFIHEDEE.hABAIHFA.WCHHhADA.aFDH,1,-11,-32,21
SHdZBNOgWXILEMUeDcQJAYKTRfPCVGaFb,TGBCRAADCFEH..GBGGFFEHHACGBBFAOAHF..XFAFhAAAIDGDMFDDDDCDQBAChAAAABECKHGG.fDDAhABAaCAHdGGBNECB.gGGA.WFADhACA.EFFE...hACA...,1,-2,-32,30
XBGSRICfgeHZVAcdTJEKNUbQOPMaDLYWF,TGBCJEGH..EACGUEFB..OBGFMBIDLAADFCBABCECGFBFhAAARBFFCCDC..eEBAhACA.....hABA............hAEA......hAFA...,1,-31,-49,18
bNSQECJBWcTHMFDPGKRaOdUAYIZgfeVXL,ZAADeGEALFDB.SFFCEAEACCGFBCBF..TEADHECDDDDChAAAKAGAOCHDAGID.hABAIAECfHBDhACAVCCENDAEQEEC.cCGEFGGE.hAAA......hADA...,2,-19,-18,1
eWfcNXLMQCUTVdZgbHYSJDPOKEBRGAaFI,aAFBeCCH.....fEFAXEDDQBCECHACUGCAdADFZBEAhAAAgBGGHBAFSBGEhABADCBFKEAFBHGDhAAAAHFEIHHEWHBAcDFA...MECFhABA......hACA...,2,-31,-11,20
JCRHeVBAMZEQDKSUNdcgFLaGbXYWITOfP,EAABKDABUFEBdFAG..FCHDGBCH..XDDD..IHAAhAAATFGBOCFDhABAfDFBCHBA.RAGBeABChABAAHIFMCCHQFBEDAED.NEIA....hACA......hADA...,2,-35,-17,18
HeAWCSKNOTIBfdcbPLgRYDMJFGZaVEUQX,SEGDOCCHBFEGdGDF....PCHDLCCH.RAEDDAAChADAJAADZBFBaGACUBGEHFCBeAEChAAAABBFKEAB...IHHGhACAfGHAcFFE...YEAFhADAMCEF....hAEA...,1,-22,-28,6
XJILPSGKMVOeNCBbWYTcdaARgQHDfEZUF,QFDHDHCEECAC.FAFBJEFCLBCB.GCFEKBEAOEADhAAANABA.BHAD..WADBhAAATDCD.dABFaHGEhACAAGHAHFDCfCHE......hAHA......hAIA...,1,-23,-34,11
JPfcSWZDUBFKNQeEIGTCdXbgRMYHLaAOV,JFFC..fDCD.SAGEDBACUEADKBGAeCEGEGEGIHEDhAAA.CDBDbFEAhABAMDDGHABEABDD.PFAChADAZDEEBGAH.QCABdHBB...hAEA......hAFA...,2,-46,-6,40
eCOdbEHIBAQUJZSagGYNTRKMLFcXDPVfW,QDCHJADGZECC.aAGHGCGC..NCBE.KGDBLEHB.hAAAFADBXABFDFFBVFCFhAAAeHAE.dCDA.EBFFhAHABBHBAIGE.SBAC....hABA......hACA...,1,-25,-27,2
EJHZfFAWPVKegSMLbUGOCITYadQBNXcRD,VAADeCCHMBED.UGFECHCA....TFBGdFAEQDGFhAAABEGA.XGCHhABADADAHBFAfAGChACAADCHKFHHgFEESADEbDDC.OFDG.ICBHhAGA...hAAA...,2,-36,-3,33
DNALRVUWZCEGXKJcfMHPQaYeFISBdTbOg,LDACVBCD.UFFHCFCGGAEFKGDB..JBCGMIFE.HCEFaHAG.hAAAFDAFBAGFdHCB..OAAGhAEADEEGAIGG.REGF.ZCFA.hAFA..EBAC...XEAE..hABA...fBGFhACA.,2,-37,-9,28
cGPJWKFRMgeSTVNLfDadbCBXZIUHEOQAY,GAFEJGEA.KFDGMAFAeBAH...SHAATBFALAAFhACADHDGdHGFBCDHZECGIDHBhADAEEBGABHG..PABAhAAAFBCD...........hAEA......hBBA...,1,-26,-37,11
EOCgXYHcDMBRdTWSAPfNeFZQKUaGVJLbI,...NIED.eDCHZBFA.KFDGGABELAACEEHB.OCBB.CGFH.gEDEhAAAHBGBMHACBDAAhABARAEB.TFAGAFIH.hAEAfGDB.......hAGA......hAHA...,2,-27,-17,10
GMUEDVBFJIXLQgRCPOSeaKHZYTbANfWdc,...fFAFdHBHGAAFUGCHEDEFVAFHFAEA..JFFBLDAAhAAARCEA.CHGD.OAAFhAAASGEBKAHBHCCFZFAE.hABA...YEHDAACCNDIE.MAIFIHAEhAHA.....hADA...,2,-13,-12,1
aCHIZbXUGcAWFdDReTNBPVgJESfMYOKQL,FAFBDEFERBFEeECDBABD....VFGBEDAH.MDBHKDCCLFDAhAAA.HFABbCDEGBAFhAAAAHHAdACA...PBHBhABA...SHAAfAGBYFEHhACAaDHDCHGD....hADA...,1,-20,-28,8
agNeXPcMEOCTUBIQKHYfRGSbLdVDWAJZF,JDCHZFEEaDDE..eGEA..XAEAMBAGCFFC.BDGD.KHCAHAFEhAAARBAAGDBESDAHhABALAHBDGIBWDDBhACAAIFGNABB.....cCGDOFHD..UADEhAHA.IHCHhAIA...,2,-29,-14,15
EKaOFeBGRNXPfJMVdZWHYSgcDLCAQUIbT,QCGCUCBC..ICHDEBDDKFEHOAFBFAAAGGEF.REDG.hADAPABH.MHBChAAAdAFC.ZDAE..WHAGhAEA.....SGBADGAEAEEBaGGGNIBF.hAHA.XEGB.hACA...,1,-23,-25,2
bTLfEMFNIBGRgQOCcSaeJDHUXWPZKYAdV,dCFCTFDHLDHB.EAAFFABBBBDFGCEB.QEAAhAAAOCAFCAEE.SHFGhADAeHFEHGBAXAGF.hAAAWCCHKAGGADDAVADEMGDANEIE....IGGHhBAA....hBIA...,2,-20,-10,10
MPGfTCLAFBgDeZRIbUOJNKWaSVdcQHXYE,BFEDDEFHeCACRAGBUACG..OBEEKGFB.aEBEdCFC.HFAE..hAAAXFDDEBAA.MDIDhAAA..PEBAhABAfDBFCEHFAIHG.FGAG.IHHG.NICBWACChABA...SDGFhAGA,2,-38,-21,17
aCGBFYbKMZPRNcSOUfIWQAdJHLVgXEDTe,dDBDLFFC.XBEGDEFDaHACBGGG.FCFCKFAH.MDFERADF.hAAASAHFOACB.hABAIABBAIHAHFAEEHCEhADA...CFHA.bDAA.NEEDfGGAhAAA.WFBH...hAFA...,2,-32,-22,10
HEYfXBLaSRJFbVdGKQNPCgeOZUcMIWTAD,HEEEEHBG.XDBGaFHDRBAB.FBHDdFFGGACBQAEGCFCE.eDADhAAAOHBEZDCG.UAAEICGDhABAAHHHDAFEBEHE.hACA.SGED......hADA......hAGA...,2,-20,-15,5
OAgcRfJTFHYDKeQPXIBNSbEMaWUGLCdVZ,RAADJDACFFBDHAEG.DHFGKEHB...QCEHXEEB.BACF.hAAASAHHMFDHaBAA.hABAUAEFCEAGZCFAAFAG...hAAAfHAFeFGDPHDE...IFEEhAFAEEGF....hAHA...,2,-31,-22,9
TRZFXLCSbfQHOdNDKaVABgWYUPJeMGIcE,BFDG..gCBCUBDHJAHH.GGCD.EACETGGFZBFDFFBEhAAALAAFSAFFhABAQGBGHFFCNEAADECGhAEAKGEHACCD..PBHDIEEA...XEAChACA...hAHA...,2,-33,0,33
VeHXEIdZCDLWQbGUAMaNBTgRfFJKcOPYS,MHFGBFEDRBFAFAEHKBCA..OACH..SAEEHEDEEGBDZDGFhAAADFBDLHFGQAGChABAGDGGAFABTDAEfAAChAAA.JDDA.....PDAEhACA.....hADA...,1,-17,-27,10
HRBLDQdefGgMaATXbFEWUIPSVKcOZYJCN,TCGCFGFCUBAF..SEBCKECB.OEHFZBEGCEAD.HBCABHDHhAAADABC.eHAA..hAAA.gFDDhAEAAHIHEEEH.PFGBVGAE........hAFA......hAGA.YAFGNAIE,1,0,-50,50
BPISCTFKcVLNedGEOXaJZQHYRMDAfWUgb,UCBCBFDGSAGECHFD.KCAFLFAGdGBCGBECOCFD.hAAAXFGDaABCZFGBQDCDhACARFDFDIBE.AHEA.hADAfAEC.bAAGICHF.hABA.FAHF....hACA...,2,-30,-19,11
SAQBReIWFDgPUMbHdLaEJXfYZOKTVGcCN,QGDCBEFARAAB.eCFAFFADDACCUCDEHAEAdFGALEBB.hAAAJAFCfHEFhAGAZAAE.TDDE.GEGEhAHACDHAAIFG...gGCH.MDCFhAIA.ECHDOEABhAAA...,2,-22,-8,14
dCgaIOATBGPfSbXVeQYNWMcKJRZFHUDLE,BDHHGAFESGEG..XDDEeEDGQACGhAAANEHG.MFCBJBBDZFAHUGGEhABADEIDEBGFCCHAaGFBABBEfAEDhAGA..bADB.WBAFKCDA...hAHA......hAIA...,1,-21,-23,2
VCNDeMcEgIUJKRaQABSYXHbLPFdTZWGOf,SEGDHEFHLDDFFBGGZBAAGAGG.fGBDVEAF.DCCChAAAMDEAECAF..IAFGhABAKEEFaHACABBABACA.hAAA.XADA.dDAB.OHFACHHFNIAF.hACA......hAEA...,2,-15,-15,0
aNICVXTHOfDEeFdbgKMLWGPYJQcBRUASZ,SEHBZDAGaABE.CEGG...XDGDOCCBDFDDFAHHdGAH.KGDGhAAAMIDCLDFDGADFhAAAJCAEBEEG.AAIBIGAAhABA.........hABA......hACA...,2,-38,-32,6
DNCLJKVgHOTUZGIeQXcMPaWdSbfREFBAY,DACBCAFBKDHBHADB.UDFCGFCH..IAADQCEG.MCCFhAAAaHCAdHGF.SDBFhADAbGFERACA.BHBDhAFANICBLBAFJAHF..OFBC...hABA......hACA...,2,-23,-21,2
ZISYAMPDRJVKUbcfaXFLeBTEWOGHdCNQg,DDGGRDBGKBFEUBAE......fABDXFCALFAHhAAAeHDATDGAEGGFOEBGhABAdFEFCHHAQFAGhAAAZAEA.SCCEAIEAMCCEJDFF.....hADA......hAEA...,1,-23,-24,1
SGTCOARMeFBJUbdIEcKWDaPLVQYfZXNgH,eAABJCAF.dFCGEGEEKBFE..DCEELFFA.QDGFhABAfHDBZDBE..gDGBhAAASAHHCDEBADCE.hACAMAFC.BFFBIHHH.aGAF.PHDEhADAXGBB.NBAF.hABA...,1,-12,-45,33
IMdPQXDBLNgTHcGfKWEOYeVAbRCJSFaUZ,CFDDJEGHFCABZCBF..dFHC..QGCFBFAELFFH..TBDAhAAAHCFCGAAFhAAAKCAF.ECDCeAFA.ADGG.hABA............hACA......hADA.SGAFIAHH,2,-32,-31,1
GRbFOAJPdUBNEDVXHILKfZcTaWSeYMCQg,dDCDBHHGDFABHBBAKDFH.ZEDB.aHDEeHDA..CEAAGAGGFEBHAHIF..hAAAUBDBEGBH..IFGHhABALDHF.TAAFhAAASDEE..MADC...RGBA.hACAJADA.....hAHA...,2,-28,-15,13
OHFZEYUQdJfDCRKgIcPWMVeXaNBTASbGL,GEAHHFBGZFFCUEGCQBDHdGDBDCCA.CAHAKAEE....gBGFhAAAIAAF..PCHHhACAMBDC..XGAChABAaDAEBEFBAIHG.SHAEOCACEEEE..hACA......hADA...,2,-26,-18,8
dXRDWJHKPSZYOeMTCIfUENbLQAVgGcBFa,VEBHGAFE.FFAEdAHARDCC.DGFCHFDG.SACCOCAG.MBABhAAATGDG..fEHGhABAEAAGLDEAADCGBHDGhAFA.aHAAXBEBKBBF.YFAFhACAIHGCNDIE.....hADA...,2,-27,-2,25
IOCaZLHRVXdTJFPQcWAYeEKBfbUGMSgND,EDCDBFEDUAFAMEBH...SHFADGEBCBCAZGFG.HAAH.VCCBhAAAXBAFdDGE.FFBFQAGDhACA.AADBKAEDhAFAfDGB.......hAGA......hAIA...,2,-45,-20,25
QeTDIJAPVXFabgdfKCEGSNZLURcYBWHOM,XFDHFAFB..bCCGdBFH.CCBE..EFFDSFFC.LHCChAAAUGADREAABDGChAAAHEABQGGEhABADEDAAIFEaBDFKCADNAHE.......YABEhAFAMBBATECE...hAGA...,2,-30,-8,22
dCHRbMVTAIKODNgJSYBEFGfLWcQZPUaXe,OCCHDACB..JEAESAACBGEBGAEALHDE.QBFAhADAUDGFaGBCdGGCREFEMAEGhAIA.ACBHKBHB.NEBG.hBBAEAHBFFDC..WDAC......hAAA......hABA...,1,-11,-45,34
UZCYHdIVFQPJTbMWODEaAgBKGXSNcLRfe,KEGDXECB..NEEE.RAFBUBBCZCCC.HGFGdAFFFCHH...QAAFhABAPEBHJHBGMEBDhADAOBAB..DFIHhAEAEEGCAFCDBHGGSEFFLECB...hAAA......hABA...,2,-26,-18,8
PIScGDgJaFLRBQfNTHAZMEYbKdVUWOCXe,EAABKHBGUEBG..CBFAeFAA..IEFBGGEFJDEDLCBEhAAABDCDQACChABA..fBFChABAHDGBAAHH.YEHD.VGDE.WACChAGAOHCC..PAHFhAHADAEA,1,-24,-40,16
cXKPZRdeNLJgUTVMWIGafCEYHDQAFOBbS,BDGFSHBGKHGEREDG.eAEBLHCA..gDDDUAEG.hAAATCGDVCAC.MDBBhAAA.IABFaBBAEBGGDABEhAHAAGGE...ODHDcECH.PAFAhADA.ZGFA....hBAA...,2,-26,-18,8
UWbfJFDEeLQZBVXGaAMOPcRNKSIdCTHgY,OCHDRAADKHGE.dHGFHFCAUCDC....bBFAFAFF.EDBAQGAGhAAABHDG.VDDGaACBAIBAhAAAMADH...PAEEhACA.SEAAIFDGCAHD.YBADhABA....hAEA...,2,-45,0,45
WQdHLJTXYBOZEcaUDSKVgCRAGfMNIPebF,MEAE..IGAFeAABFEFGQAACLGCE.XAFBhACAOACFEBGDUCCCDFIFKHCACCFDAFBFhABAfFCF.hACANHEH.WAFCJFFGBCHB.aCFCSGGBhAEA.....hADA...,1,-21,-22,1
RCaSdDFQVKXEMAcJINBHgLbTZOPfUYWGe,JGEABFDGLCCGZAFAOBBG..UGAAGGEFCHDG.dCFFFAAHKCAB.hABA.MIFEADEF...hAAA.NIAH.HEFC.TAFGhACAfDCCeDEAaADHDEFB.....hABA......hACA...,1,-17,-39,22
OWTUXEbcSgaJLBPGHRDVdZNFeQYMCAKfI,KHBGOGEAUCBB..EBFH..SFCGaDBBBGDDGBGERFFB.hAAADAACVAGFZFBBeBBGhADAQCEHCAEG.AHEE.fEEBhAFAIABCTADA....hADA......hAFA...,2,-32,-19,13
JHCUYFNVEgfSBXdIKMTOZPAQGeRLWcabD,QDACGGDHLCBEaEEH.JAFEUDGDFEAA.EHGE..SEFAhAAABECHXACGKFADMBAGhABA.OACAAGAFWHCChAAADIGECGBC...NBIC.fCDFICGH..hABA......hADA...,2,-34,-14,20
cHTgAVOXRbSLCQFJMDBWdIKNfYUZaGPeE,OBDGREFHLAAEFABF.MBCBBGHF..dEDCKGEB....fCHEhAEAUAGEaAAHeDCDhADAEHEEHGAE.AAFCbBEBCFACDDDGhAEA....IHHCNFEB....hAHA......hAIA...,2,-40,-19,21
EBZaMVOFNfRHgWSIXdLJUQPYbAceKDGCT,KDCDCCAHBGEGZGEG..MCABFAFF..RFFC.HAAD.SBEHdDDFLAAEhAEAUEEGQCGEhAHA...bCBDACGBDAIBhAAA.EGAG.ODHDNIBD.....hAIA......hBBA...,1,-25,-33,8
GOfJRCLSAQMTYdBXUIFHZWbaDVPKcNegE,MGECdGFCBHGBUEBEFBCHHADAZGBE...aHDCDBAB..KEFAeDGDEAGGGCDFhAAA.JBACCAFGAEFBhAAA...QEBAhABA.TBGFIHHE..WEAFhACA......hADA...,1,-19,-40,21
dYBUeFgVJaCRHITGOQAXEbMZPDcNfLSWK,EGFCMECGDGCB....fBGDLCBHSAFHdCCHUFBAeHFEhAAAVDFACBAC.HACAIEGHhABAOFDB.ADDA.bAEBhACA............hADA......hAHA...,1,-26,-27,1
ORPIKLcAQGgBaJCVYUWeXFTbDSfdHEZNM,QFGHGGDHaGBB.JEDCCAFB...UDAAeDDEFBGCDCHH..dACCECAHhAAAMFDH..RACE.KHEAhAAAAEEHBCCC.WEAAhABAbAEB....fHAFNCIC...hACA......hAEA...,1,-26,-28,2
LNCSDVBYegZMIQJHGbfKOFRTaEPAXdUWc,XFCAUGBCLFEA.CAFC.SCFHBDDD.eAEAZAABQBFDhAAAJBHFHCBAfGHGhAAAKDFA.FACGaEAGhADAAIFAdFAA.NIAF.DAIFgFFFMIFA..hABA......hAFA...,1,-10,-31,21
AXYIJcgeSPaWUEbZTHDfNRVQCLOKGFBdM,XCBCJGEA..eCBHaFHF.UAGHZFEHDFBBREFG...CDGHKABHFBAGBHAEhAAA.AFCC.IAHDhAAA..SADHhABAEADBHFCFfCFCNIEF..LDADhACA.dDDFMBAFhABA.gGGD,1,-16,-32,16
dHSeDZfcGRJLMYEOBgATPNWVbFXQaCUIK,TCBC..PCAF..NEIE.bEEAXDED.CHDAKAGAhAAAdDCBeAAA.ZAGFfGGChABAGGEFRFAAMICAhAAAYACAOAFBADHHFGAG.aFCF....hAEA......hAFA...,2,-29,-5,24
NgUdMFKJWeScbTYQfPXREaCIZDGALBHOV,LFCABEFAHAABOHBAVAFG.UCEB.dFHCMIFG.KDEEeCADhAAASDHB.TDBChAAAQAFH.hACAfABCRFCECGGEIADFDCIBNBDEJFAF...hABA......hADA...,2,-28,-8,20
VYeBGAfIQHDJOZSaFTbCLPEKXcWMUNgRd,QCBCDAGDOEDCZCAHSDGE.aFACTFGG.CHAALAAEhAEAEHGAKFDC..WHAEhAAAMAFFUADFRGDAdAHE.hABA............hACA......hAEA...,2,-32,-27,5
cIaVWQFMSNeDHOBUTEPZdJGbKAYCgfXRL,CFDGXCBCLCAG..aGEEQAGA.MABANCAGDGBCHGAGhAAAOABCUGGB.TCFGhAFAEHAAZFGDdCECJECEKBBCAHDB.hAAAfEBFRBFA.IEHF..hAGA......hBAA...,1,-8,-21,13
RFeTJAPWGDVbKSNdUCXZOBEcMQYfagHIL,GAFEVFDG.SFBHdBHCUBEF.CCDBZFDDBBAH..EGGGQCBHhAAAaACBHDBC.REAA.FHFCeHAChABAAAHDDIAGKGHB.OEEAhACA...MAEC......hADA......hAIA...,2,-17,-14,3
FbATIGeLcXMRENYWQSOUgZPHDJdBCafVK,TFGHeFEFLAAE.MCIDRCADEFCB...NEEA.QGAFhAEA.OCCEUACBPFABhAAAHAFEDFAEBDEBhABAfGHAFCHDAFFF.IDGD.XBBChAFA.WFCH.hADAgGFF.,2,-21,-1,20
PQMRWeFJVXLEHANcgTKdGZYaBCbUSIDfO,...NDDG.gCGC.dEAEGCGAaCEBBGBHCGFBSACHhAAA.IEEDhABAOFEFMFDFeEBFJAFDXBCFhAAAEABFAEAHKHBAYABFDGIB.fGGHhACA.....hAEA...,1,-20,-26,6
IEHVCYPSFAfUaJQbcGMeOTXLNgdBDWRKZ,aGFCJDAC...QBGDGECDMICEeDCE.TEFCLAFHdGBCBAEDhAAADFHFKCHBEBBGCBBE.PFDHhABAABHA..fAEEhAAAbCAD.XGEE....hABA......hACA...,1,0,-39,39
dAORQecGBKDHMXNSWTYLEZCIPFVUbJagf,RAEGQDACeBCDGEEHDFGDHAEC.MAIDSGAE.TDAEhAAAYDHFLCFAhABAZECBCBCE.IHGHhACA.FHACUAAA.aFAE.dGEAABBHBADCKHAAWDDEhADA.....hAGA...,2,-12,-1,11
PGHdBKaASfQJVTCEUgeODXbNMRLWFZYcI,QGBCVAEG.CHDH.EFEEUAAC..eBACOFHFDEGCXGDGhAAAMFBCLCEG.hABAFDACZCCA.ICHChACAHFEDdAFCKHGAAHHFfAHETDAB...hADA......hAEA...,1,-11,-23,12
GeYgFTcUAIJOCMaSDNLVPZbKRdEQBWHXf,JEEGMIAG.DGFGLAFAZGBA.RGDE.EDEABCAEHBBHGDAF..hAAAeADAFGAGUGGEAAHH.hAAACCHG.aEGG.NDAA.VABEhABAKCGEdFCB...WHFE.....hAEA......hAGA...,2,-23,-13,10
UVMgBDNbIeQOAFScPRKJWYTdHXEZLfCGa,FAFBSHBGRDCB.KACGJFFC....TEDFdCAAECFCLFGBhAAAGAAF.UBFD.MBBHhABADEGA.ICDFhACA............hAEA.eFAGADHAPHBChAAAWGDA...,2,-46,-19,27
JXERfNeFGYUMBTgPDSbdKcQOLVHCZAaWI,aHBGJGEA..RCAF.eDAEGGAFUFEE.BAEA..TAGDDGIDdDFBKCEGhAAAQABALECACADEhABAABGC....XEAChAAAfBBD.NIDB.MAIF.SHFAhABAcDGE....hAEA...,2,-30,-21,9
ZUVcATFLJIfeDOWRXMYCGdHBaSgNbPQEK,TGGDLFFB.JDCBeFCA.DCFCOBBHRCAH.MIBACAACGACChACAdADBBBGASGBDhAEA..bEGBEAFEKGAFZCFEhAHA............hAIA......hBBA...,1,-14,-37,23
IORFcHZBQLCfDXVGSAEeTbYJNdPUgWMKa,EGDDeDAC...TAACbECE...JFFBNCHG.dCFC..UAEGMFAEhAAAKCBBOADEFAABZBCFBAHDhACACAHC..DIGGGGABhADAAICE....PDABWDGBaDEH..hAEA......hAGA...,2,-24,-20,4
UQOGEPWcFaBSKDRbYMALgCfXHeVZJTdIN,LAFBCFDGHAFAZAAFdBCCUGFAGDGA.EHAC....PEAFhACAFEDFaCAHBHCD.SDDGhADADGGB.RCGFMAEFhAFAAIEG...........hAAA.fAHAhABA.XEBD.,2,-29,-20,9
KGcPSeVYOHBTWdFXDUAbCRaEJfLIgZQNM,RDBHaEEDEGDHLAAE.ZGCAQAGD.KGFDGBFESBDDhAAAYAEDODGFhABABHGD.dGAGDEABUCBChAGAABCFCHHHICACMCIB.cEEA...hAHA......hAIA...,2,-20,-16,4
CaAcPENOebYgUWfRFGdIXSBZHVLKDQMTJ,EHBGOEEG..eDBC..bAEDUACGRBBHFGGDIEEG.SDGChAAAZEAEHGCAKGABhAAAQAFBMCIBCADHAGFEcEBDhABA...NIED.WBAFdGGHBEHB.hABADAIF.....hACA...,1,-8,-19,11
EIPKQcMaORfTgAZdHUCSVNeFYbGWBXDLJ,dDAFUADCSACHeDGFFBBG.GBGEBHACLDDDEEDD.KHGGMFCHhAAA.RFFF..gBEAhABAHAFCCEEC.YFABhACAbGCADDIF....PCABaEEF...hAEA......hAFA...,1,-13,-20,7
MfONEVAFSXBHgILUacDQdPWRJCYTKebGZ,SFAAXGDCBFGAHGDELBEEUCBDaFGEDDAH..dCHCRCBDCDFBTCEGhAAA..KACCeACGhABA..ZDDFfHBDhAEAEHAGAEIHIHHAPAFA.YHFGhBAAMAIF......hBBA...,1,-9,-26,17
fZEVMNIcOUGRFJPeSATYgdBWDbKQCHLaX,TCBCdHBHBDGB.DGGEKFBEHACGLAHD.aDEGZGFA.VBAFIGEChAAAUAGH..FDEB.hABA.eHFAAFAH.YEFGhACA..WDCHQAEF.CGGCfBCDhADAMAAE.hAFAOFAB.,1,-6,-27,21
VCJaLYOXcWfZeDBQTKPEdSAUHGRMNbFIg,HACFMIDAFEEBVBGB..CAHD.LFGB.XAAFfEAHhAAAeFBCDABFBAFHKCGCdGAEhACAAIEAUEEERACB..IEHHhAEAaHAA..cEABZAEBTGGE.SGDAhAIA..hBAA...,1,-7,-25,18
OPXKRgQWbTLHBCNAaFGJEYcUIfSedZMVD,GACBEDCDUAFASGABZDGD.MGECVABGDCFA...PBAFhAAARFDBQEAG.hABA.TDDABAACABIHJHFAhACAIHBFfGDGODDA....hAEA......hAIA...,1,-15,-25,10
TBeGJMFXPaIWQDVLYOfcKNgEbRAUdSCHZ,dFHACHCHHFFCBFFAGFAFFDAA...XBBDaGCA.QBEHhAAADABDLAFDfDAEhABAKACC.NBIG.ECHFAEED.SDDBhAAA.eHAGMAHF.IHEFhACA.....hAHA...,2,-43,2,45
PbJUWOcdHRFLgKETQNBfIVAXeYSCGaDZM,XDACSDCDGGEFDEBBZEFG..MCGFJAEH.OAADHAGHFHGEhAAALCHFKCAF.TFAEhAAABBCC.VCDDAEECCGCB.bFCDhACA............hADA......hAEA...,1,-7,-38,31
MFgOfNHSLWCZBGJRVUDIbXYKcQAPaeEdT,eCCHdFAAFGGBOEFGHEDBLACGZFFGGGABJAAFUBAF..DDIBXBGAhAAAKCCG.AIAAEAFChABAMICE...fCFFhABA.SAGACHHABBDBIFAEhACAcDFD.....hADA.aFCB.,1,-9,-33,24
EVJNaRYSgdTZCfWMbFGOQAHeUKPBDXcLI,eBDGKGFCBCAFDHGALBHB..VBGFJDCB.RDAA...SABFhAAATFBF.CFAGMADEhAHAGABB.AIHAHEDHhAAAXEEFIHAC..EHCC....hAIA......hBAA...,2,-36,-26,10
bFEGMfcTWOSUYAXNQZICeLDBaHdRJKVPg,XCGCZEFHCHADLAFEDDBB.BHCEHADC.RFFEKFDB..VDBA.hAAA.bDCEEACCGBAFhABAMCIH.fHCBhACA..TFDBWHFASGAB.hAAAAAID.ICAH.hADAaBGB..,1,-10,-30,20
PfeODZgaEQKYWVMFJTLNUCdAbRHISGXBc,RGFGHDAGGDCCBHEF...fBBAeBAHOFFADGAGZAFFaBEHQAGEhAAAKAAE.VFAFhABAMEFG.TFGEhADANACACGEC.AFDDSHBE.XADDhAHA......hAIA...,1,-5,-25,20
RVDMcOIBXaUbFeTfPKLHSEWQGJYCNdgZA,DDGBOCHDBCBAUFFCFCHF...eBAD..TGCHKGDDLAEFhAAAEBAF.QAFEhABAGDBHCHGHdAFDACCHMFCBIGADhAAAaDDC...bFFE.....fHEFhABASHGA.hACA...,2,-37,-18,19
JIXRWNgdCbYMcSTaADLeOVfHFZUKPEQBG,DIBGOAABHCADFGGHUAFA.KGFHEAEF.GDEA..XDFGhAAANBCE.CGDH.MDBHSDCAhABA.TACDhACALHBE.eAHD.fDDAhABA......hACA...,2,-32,-28,4
TaMIERGLDWUeBNXfgCVKJSPHAFdbcQOYZ,FAFBdHBHQAEDOEEDZDBC.MDDF.EBBGRBBEDCGC..UEEHBHBEhAAAXCFGCEHC.JDBHhAAASHGEAHAF.hABA.YFHBIAHG.LDGDNCAE.hACA.fHEFhADA...,2,-38,-19,19
feOWgHcXINGaKBdUDJTFEQACVSbMPRZYL,SBBDMCCAZDDFLFADeFBB..OFHFHDFDXAAFhADAGBEHBAFCDCID.FACGEHBEAFDBCHFAhAAA..PHFARDEG.hABAfGCB.WAEA...cDBChAEAIHDH.KEBChAHA...,2,-26,-3,23
FYLVUKgCbSeaZTdJcGAHBXEMIQfNWPROD,BADCEBDH.QEFC..fEFBPEBB.RGBGFDAAVBDHhAAAKABD.CHHAeAHHZAFFdHCFhABAJAFBACADMDIB.IBBFhACANGDHDFAC.........hAAA......hACA...,1,-17,-30,13
NBdPLMJARbYeEfUgKQXDaZGTcFICHOVWS,RAADeGEAUFFFQDBD.DGCCaCGBGAFCFFBAHADFOHBESBHHhAAABACGLAHBhAAAAHED.bADFEHBE.KAFAhACAZEFG.IBAECDBHNDAAdDDD......hABA......hBFA...,2,-13,-5,8
fGAZcHBUNKdgXIeDVQaPTYFEWMLSCJRbO,ZGFGBFDDUBEEdBGA....IAAAeHAADEAA.QABHhAAAaDCG..TGAFEEGFLFAAhABASACBCAHF.hADAJFFA.OAEFAFEG.NEEHKEAF....hAEA......hAGA...,1,-25,-36,11
IGaCPNOcLBKSAURgFfQTbDJXHeWEYMVZd,REFHFHBGQAABDCCAHAGF..eHFEEBFBMEIBZFBCGCEC.CDBE.ODCEhABALACGSAEEhADAADAH..fAAEhABAJBHDYDBF.ICCFNDIEBEDD.UFDEhAHA.....hADA...,1,-2,-16,14
NLADFTdXYSUcbGZMBKCeRIQVEfWOgaJHP,TCBFXGBC.UABEGEFG.BFDACADARGFE.VGAA..EAHHOEHFhAAA...gACBhABAJEEEPCEEADFGDFBAhAEAFECDSFAFZAFE.MICAKHDA..hAAA......hAFA...,1,-7,-28,21
VOgaBFCDXMKNbLEHGWfJAPIdcRZQTeYUS,dHBHRGFGZCDAeCDBUAFCOHFA..aABEBAHA.FDGDCEEC..MBIBhAAAKBACLDAD.hABAEBEAGFBB.fEAFhACAAHABPDBD........hAEA......hAIA...,1,-30,-33,3
bIMDWFaTHGVJSOEZdYAgBKLcUXCfQNePR,KEGDLDACUFDA.XEGF..fDDFeFAGRACA.MCDChAAAFFEGaHCA.HAGFVFAGhABASGGGZABE.hACAAEEABCEACHGHPAHFIBAADDAE....hAAA......hABA...,2,-26,-16,10
TOMKVLEQIAfUSWFCXJGDaNdBcHbeRZYPg,SGFCCFEDGACGDBFDdAGE.BEABHGFEeAAFREAFZAAF....gFBChAAAMCHFLAEChACAIEFAADIF.fEHGhACA.FCBAaGCDbCEC.....hAIA......hBAA...,1,-18,-21,3
bMBEKUGcTPaIWfRLQYSACHZDNeXVgdOJF,HCDHDHCEeBGHVAAGdEDFFCGCBCCB..UGEDGDAA..PFCDhAAAIGHF.RADB.LDAHhADAQAAFAAEGCDCGZFGFhAGA..NICF.........hABA......hADA...,1,-12,-30,18
QNRYGeaJfTOFCASDMEXHcPdUBIWLZgbVK,MBHHHBCFdBFGBEHALBHDZDAA..VBDDNACFGEFE.eECDhAAAaABH...JBAFTGDDhAAACEEB.AEFA.EHAEXFAGhACA.UGFEIHHA....hABA......hAHA...,2,-26,-13,13
CMfTaBGZPSKXJLWFVegDAIEYbdRUNcOHQ,EHBGdHBHRACGUAAD..ODEDHDFHCGHD..TAGCaBDC..BAFEhABAGCAHSFBAhADAJCGFFHGA.eDEDAGAD.IEADhAEA..bEAANAIEMAHFfAAE.hBEA......hBFA...,1,-19,-21,2
dHJMYFbOTLCfRWUeZaXEQKDgVBNASGcPI,GEAH..PGFAIBHGdDFDHFBEMEGD..FHECOCCGhAAACBED.fBAFhABAUBAGeGBAaAECECCEDFABBHHEhAAANBICAADF....JHCE.......hABA......hACA...,2,-28,-15,13
LUWCYHgbNEVPJdAKTZfRISeGDBaFXcOQM,ZBCFRAADeAEGBCHE.FDAAOEFBLHFE..CHCHHEBG..bAEDhAAAEGAF...PADHhAAAJFEAKGCG..fEHChACAIAGCDEIBaCGAXGGEMEAD..hAGA......hAHA...,2,-34,-19,15
SbVDNAfYKWaQTFXCOMGILEgBZeRcPUHdJ,KHBGQGBCFEGD.CHDHGDABECAHBFDEZBFC.RFEE.UAGCHACBdDCB.hAAA....SFBFhAAAVDFEAIFGfAFBhABAaBEG..TABH...MFFFhABAICAF...hADA...,2,-42,-1,41
SBNbCQYdZOPWMRUVTKLGfAeJFHgDIEcaX,FAABDHCEEFBH..XDFBBAHB..CDEAdADAOECE..MIDAhAAAVGAEKABH..fCBBhACAAGEGHDGB.IBEGhADAaAGH...NAIEQFGEPBABWFAFhABA......hAFA...,1,-25,-41,16
NTODdVeEPMGgCJAHFIaLcYWXSBRbUQKfZ,HDAGFAFBLGCA..WBBESADHRFCCUGGH.QDAAhAAAZAGHOCAGDACF.VDGDhABAEDDEMBGDCDDE.IFAEhAAA...aFFAYAHHBEHB.KGGDhADANABF......hBAA...,1,-4,-27,23
SZGgeYXWHTBVKQadEMCAFIJbRLfUOcPDN,JCCHRFDFUAAD..OHAGDCDDZEADGAEB..eCGF..XFGAhAAATGGEBADChABAQFEAdAFC.EABCMCIHhAHAAEHEFFAG..........hABA......hAEA...,2,-33,-31,2
QISgYVdePcbMBTFKRALCXGWaJONDfZHUE,CFFEXFGHGDAA...JBDEDAAA.HFCGUCGGEGHH..SDBAhAAAVADAdAHA.eGAE.hADAPEDFMIDGFDEAAHAF.hABA.aCABfHBFZFEB.gCBBhAGA.....hACA...,1,-3,-24,21
ReZLXNJfMWbHPdacFCYSAKVGEDQUOIgBT,KGFHGBCHQECFUFDDOCAFBBDERBAELBHF..NAIG.MAAAhAEAHEGDdEEBFFADSGABhAFAAHDADAFB.TGGEhAGAXGBD.fDEB...hAHA......hAIA...,2,-24,-20,4
QDKMJYfUCFRcSGgHVXbLPaTdeAZWNEIOB,ZAADEHBGBHFDKDCA..MAEFJEDB...UBGACCAB.FHEERCCCGAGEhAAA.HABEVEFEXFGEhABALFBD.aGCEdEADhADA.AFFF...NAFE........hAEA......hAFA...,2,-30,-20,10
dKODAYIbaUEVLGNgRPZHJCMfXBSTQcWeF,..IFDGUCCBEGCBLADGGGEFRAAFHDEH.CCGD.MFAABHEFQBGDhAAAeBAFKBHBADCHaEGEhACA....gFAHhAAAPAEG.fGHASEFF..hADA......hAIA...,2,-23,-17,6
DSJMHRaNcZYBbdeVIFGEgTPLWKfCOAXUQ,QCCBJEACHACGRFFA.aHGAZAFD..BEEAeCAEFGCG.GBFEEHDE.hAAATACD.LBHHhAAAfEDBAEABDIFAMIAAhABANABE.bFACdGAEICHE....hACA......hADA...,1,-7,-14,7
SVEZBAYbgdOaGTHeJKDIMWQCNfLXPFUcR,...bAADgGGD.OABDTEBD.eGFEJEBDKDEEDAGEMDEBhAAACEHGLADAFBGC.hACA.cFACVGCGBFFChAAAdHEFaDGDHAGBQACENBAA....hAFA......hBAA...,2,-9,-8,1
RDOYBMaFeWANSZfQGLXCTcdbUgIJEVPKH,SCFCQFDHGBBDCFHE.dGGHUGEGJAFG.EAGEKEAEHACGDAADBEHHhABAMDDDFGBF.AHGCZAABhAAAXCFH..hACA...cFACIEEG....hADA......hAFA...,2,-26,-23,3
RVYKbODMATHLcfNeaBIQSJPGCWgXUdFZE,HADGLGEA..NAHGBGGAIHAD.SBFFJDAEGECHCCCB.hAAA..XABHhAAAdEADECGGRECH.KABDDIEAAICG.fGCEhABAaACA..WEEEFGAB....hAFA......hAGA...,1,-21,-28,7
EIUaRVQDXCBYFPSKNWLcZbgTAHdeMJGfO,HDEDMEGFGACGEEBAaBCF.QFAB.CAECBBAAFFAHSCHBhAAA.NEHGLBABhABAZFCDbFEHAAIHJEHBOHDAhACAICHD.........hADA......hAEA...,2,-18,-18,0
SgUTdOCJZMBIWNHKaLebQGXEAVfDYcFRP,DHCEFHBGRCCC..SFGEUFEH.dCAHOAFDCBEDZEAE.BEBD..hAAAIAACHABEKEEEeAEGhACA.GCEFAHHF.hABAfHGFPAHF.gGAFMDAF.hADAWFEBaFHF....hADA...,2,-31,-24,7
PJSEODKagATebYHQIZdLBRNfGCVcUWXMF,TDACeGEAHCAD.QABAZCCDdHEDBFDARDDAGEBACABG.VAGDhAAAUBGBMEIDJEEC.OAEBhABADADG.aFAHACAG...hAAA.IHADNIDF.....cGGFhACA.....hAFA...,2,-36,10,46
GFZNECeHDVYgMdBJfOaQcXLRbPIUWATSK,SFHBFDAFZEFC.CGDA.HAFC.DIDCVCCBMCCCBDAC.OBFHhAAA..aGCAXFAEhABALDEE.PACAhAAAIBBGAGHBKABDEFFB.eBHH..dGAEfAFBhACA..hADA...,2,-36,-19,17
WIfELBYMXDTPJRSFeZGUbCKQNdcVHgAaO,OCCH..fDABECGDBGGGMFECXFFE..DABETGCFhAAAJHBC.RABCeDEEhABAUBDHCBBCKAGH.dAEE..hACA....cAGAgGADAAEH.aFEGhAGALFAA.SHGAhAAA,2,-34,-25,9
TLeQCNZdVHDFMUSbafRAgWEXBcJIPYOGK,EHBGBHHG.JBGF..IFFA.OCBEGEDALGAEhAAAQCAEZEGBHAEFDCDEUFBEhAAAaACG.AAEG...WEBAhABAPABC.KAGCCGED.dFFAMAIF..fDEBhABA..hBAA...,1,-9,-33,24
fVgHQOaPUZYXEIMRbNLFTAGJcKDBeCSdW,JFEFKHFGBGEE..CGBFdDAB..fEDFHACHQDEBhAAA.OAFCUDAAZDGHhAAAEEAH.IBCA.hABA.MCFENABH.LDHFFGBFACEDDAGHWHAAaAHF.hBAA......hBBA...,1,-17,-37,20
aPZACBbOfLFcVYQWDJdeKREXSNgMGHIUT,BBBDOGEALEADFAED...VEFAQCGFDDCC.dEADREBGSBDGhAAAMIBAHDDGIAGAhAAA..hABAaGBFADDGCBCHfGHA.YHDEhABA.eADGKEHB.NAIA..hACA...,1,-17,-27,10
ELPgAOIUTJXWSRYcQVKfabFBZDMNGdHeC,ODACUCGC..XFBBSDHD.RBCE.QGDBKHGE.hAAAaBBCbFEHBHGGZFABDAGChABAMAECdFDECHHB..PBEDhAAAAICA...IACCWCGF..cABGhAEA.....hABA...,1,-20,-38,18
RBbAaOeUXYCZLPHcKMdVJDgGQfWEFINTS,OFFBeDCHUABG..CEDHLCEGHGEAMBDGJHBADEEF.GAGEhAAAQAACEGAE.FAHFNEIE.hAEARDABBHHGAIDA.aEGC.hAFA.ZCEFKADD.dAFE.......hAGA......hAIA...,2,-21,-8,13
LCIEXRDUKZVbdYgeTJWfBHAMFNaPQcOSG,MHFGFAFB..aBBDQFAC.SBDCLDEDCHGFIFFFhAAARCGHDHBAKEAF..bFCFhABAdABF.eDCHJAGBfDDBhACABFHHAFFG.NCIGPBBF...hAAA......hAEA...,1,-9,-37,28
eCaGcHIOFXbgTUEQBNSAJLMdfYVKRWZDP,MBEAdHBH..VCCCKEFAZBAFDBGE...CCFFGDCGHFAGOEFC.hAAAFCABXFGE.hAAATFAEQGGHhABABCDEAAFAJFEF..YHEEPABC..cBFChAEAIACF...hAFA...,2,-27,-21,6
HbSfQJPXGBVCRdeETNDZAFcMWOgYKLaUI,FGFHMCCAOAAFKEEGLABA..aFBEHAFE.SEDDhAAAJBFEGDDFCHACRCAEECCFDIEAAGGG.hAAA....cFAFhACAWEAF..UACFIFHG..fHAFhADAXCFABGGDhADA...,2,-27,-24,3
KTRSADOdQYEIMJLBgfcHZNFaVXeUGWPbC,dEGCEGFC.JAFDBBAD.....fBFEZBAFaGDC.eBHDUDCGhAAAGDCA.bFADCGHATACChABASEEBDDIH.hACAOHFE.IEGEMEAD..cBGEhAEAFDAE.....hAAA.WAFE.,2,-34,-6,28
ZNKROAVSGCFTYDfUabQLHceBgPWdXIEMJ,SBBDCBCCFEFG.DFDHUBGG..QAGGHFDABDACPFFHhAAAdFBEEAAH..MFBBhABAJCDG.KBEC.AHHBGDEHhACA.fACAaGHF.....hAAA......hACA...,1,-18,-41,23
XQaKTHfcLgYdMIDJWESVNeCRZFUOBAPbG,GAFEXFCAaFFHHBDELBAFdDFG.MFIDIEAH.JHAEECDHhAAA.VFACeBAACAHCFEGDhABABFHEACCH...PAHFhAAAKBCC.fHGB.....hACA......hADA...,2,-15,-14,1
FLdcVQDYUEXTHgONBPReCSZMIJbKaWfGA,FEEDdDCDQEAGDBDF.ECGGHDAA.OEHFBDFEeBAGCFCCMIBAhAAAJFEC.KHFA.aAFB.hABAGGBFLACE.hAAA............hABA......hACA...,2,-44,-21,23
cZYabdRUXVWfAEJPDBFKQSIONCLeTGHMg,JCCHDAEDFEFD..QEGHOGCC.CHAG.eFACGAFAHABBMAAChAEAZDBA..aCGGdBHE.REDF.hAFA...XFBDhAHAWAFAAIEGBHHEIHGE.NBBC.....hAIA......hBAA...,1,-17,-32,15
HaCZbGJBgdXNRMQTSPOAeDEcVYKIWUFfL,EEGCVAADKAGD..UGGELFAEHEBGCGBGZADB.GEEABBEEdHDBRAAEMAIFhAAA..SAHDhAAAAHHB.eEEEDHCCIHAGhACAfDBF.bAFD.....hADA......hAHA...,2,-23,-12,11
bIMdZSNQTYRVPBfKECHJXDLOUcGgAaeFW,aEEDFDCD....IBHCdBAHSCDG.QDAChAAATBBEVEFABHEG.EHAEHAEDhAAADFCFUAEHgGDEhABAAHFC.eDAHWDGBMIAE.....hABA......hACA...,2,-31,-11,20
XbULCGFMVaBJdIDZWKNPASQRcOgYEeTfH,RBCFOGEAEGDC..eAAHTDFEHDFB.UGBACADFFCBD..aAFEBBFHhAAAJHEG.DDID.ZEBENFAF.SHCAhABA..hACAgCEFfAEF......hAHA......hAIA...,1,-12,-38,26
fcDXOaMgVHYJGEPWUbNICLBAdRFQSTKeZ,dEHAQCCBSHBEKFABZAFEDGDC..OEABaGCG..MDFGHBCChAAAJGFAEEEE.UBAEIEHAhAAABHFARCFA..FACFhABAfFBH.......hAEA......hAFA...,1,-16,-32,16
DQVaUIbEFOLGXPcZRAdCegHNYMWJTKBfS,eCAFHAADMCGH.JBHFBFDE.SFGFDGABQGGAUCDEIGCBhAAAEFDBLADDhAAAXBGAZEBBABFCCFAENBBF..hACA............hAFA......hAGA...,2,-38,-16,22
DUfcdHKObATXZESBRCeLVaYMFPJIgWGNQ,XCCBZFEEBBEFCFAFLEBG..aHAEMFGH.FADEJBCD..hAAAIABGGDEFQBGEhABAUAGGdHDBKEGEAEDFEABFhADASDAE..eGAC...hAAA......hADA...,2,-27,-26,1
COIJdTVeaMPScLHNBQYAbKDWgFfREUZXG,KHFGDACBFGHBEDFA.ZDAAGGBB..CDHH.JACCdHDB..eECGMBGHSBGGhAAAHEEABCDAAEIF.hABA....gBADhAAAREGDOBBHIAHFaBHB.LFADhAFAQFAB...hAGA...,1,-16,-28,12
PUCNdaFOGMgYSBWbHQTKJIfDRXVeAELZc,EDBDLFBBZFDF.UAACCFHA.dDEHOAGDGAGG.MADCSCCAhAAABGHAHFDAKAEBIBBChABADIFG..XBDAhAIAVGACAADF....cGGHaEBA...hBAA......hBCA...,2,-25,-17,8
ZHRMgIXTfGbVWJBQKaFDYcUNeASdECLOP,EDABCECDLAACZBDGHGDARBED.MAFE..XGFFGAAB..VCGBhAAABEDEaEECDCHD.UGAHhAEAADFDSFGAdFHA.hAFA.OCBBIHHEfCCB..hAGA......hAHA...,1,-1,-33,32
BeQYTHJORbEIKSXWFcfgVNMDdAPZGUCaL,ZEBHUGDHCGFHBEHDQGAH.HEFAOBFHECFFKFBE..XACGhAAAFAEH..gBAHhAAAMDEHDBAHdGAAADCHaABAhAFA.....YAGHJAHB.IGHDhAIA.WDDB.hABA...,2,-47,-3,44
fdCGgLcZMASOWVQPTaFUIYHKDXRBENeJb,OCCHQFDH.aFBBFHDA.UBFGHDEEKEDBDAAFBAAFeCCB.fBCDhABACFAF.LCHHhACAMIAEAIHA.SGHDhADA.WAFBPACG.TFFFhAGA.....XDGEhAHA,2,-41,-20,21
gUTVMBRfbPFZWSKIACdQXOGeEcJYLHNDa,CFCFdEHA.OABEEBFH..JFFGLCEH.DGDDaAAEUBGA.MEAFhAAAfHEF.hABAFDADSDDFhACAKGADIHHEAGCHQGFH..XCCChAAA.cADB.hAEAYBGB.,2,-36,-24,12
ecBfQYKbVdGMTWaPIgFXAJDZHCRSEUOLN,DAADHFGHCGHF.RBEDEHAGLHDE..eBBCBBGAQGECKCBC.hABAdDCHGEDBMAEETGCDhAAAPEAG.FDABXBDDhACAZBGB...OGBG...cAFBhADA....hAEA...,2,-40,8,48
gUMGPRaBAYHOWXCNZeQVbKTFLcJEDdfIS,HFDFODACCFCGZABA..QFECKHGAFBHFLAFBJBCADBGFdHGF.hAAA.SCCGhACAMIAARDGBAFDF.XDFA.hAAAeDAF...bFFAcAGAEHAE.IBAChABA....hACA...,1,-4,-38,34
KgAFUfRDTcdYPQGNXICLSHJWVbeOaMBZE,UGBCDHCEdGFBQAFCGBFE...XCAALECAHEEAJCAH.hAAAVACEOBBGBDHFEGAFhABAAAAEFGHB..fAGBhACATGDD..YDDENICDCDDF...hADA......hAEA...,1,-6,-26,20
ZMaEUPQAbfBNXDdGKOSRHLFJCcYeVTWIg,BFDGXAFBDBFDKEBHREAB..LEDBFGFB.CDFD.eDEA..TACBhAAA..ICBDhAAAZGFEMAIDEHCEPFFAhABAAHHB...fCABdACHSGAFhABA......hADA...,2,-52,-15,37
KbfgZQVWBPTXDEdLHGaCUSRAOIFcMNJYe,FDCDMCCA..JFFBeAAF.KFBF....bAAFfDAHhAAAZAEH.VCFBBAHHTGGHhACADHCCLEFEHEDDaAFEhADASBGG.ODAHNAIG.QACDhAGAWHCG.EHGACFHBADDEhAEAIHAH.,2,-26,2,28
OXDfEFLBRKMdNeYaAgIbCGcQTPUWHVSJZ,..IFDGbCBF.GGEBTFGG.UAGGHBAA.JCGFOHDEhAAAXFACEDED.BBHHREABdADDhABAeADCAEGDCDHF.QCDEhAAA..........hABA......hACA...,2,-17,-15,2
cBdOaPbKHgMAEDNFfYUeRWCJGXQITSZLV,EHFGDGHHFDEHUDAC..RBBE.CCEC.GDBG..QDFBSGAFhAAAZAAELADABCCEaGBChAAAKDGCMEEHAGIB..NIBH.hABAfFGH...eAGHXEGChACA.....hABA...,2,-30,-23,7
LUgcJWFNCMKQPRZGVbTBEeSaIdHAOXDYf,OEGHXAFBDAGCLBHH..UDCCJDBDFADBMAAE.KBDERGDEZDDAhAAAGBGE..bFGDhABAEGBF.eFEH.IFAHhAEAABCBfFCA......hACA......hAIA...,2,-28,-22,6
TLXZbaHDJYBOPRCNSVAKGMcEeIfgQdWFU,KEHBMEAEEEAG..eAAB..IDGGQGCHFBCBLFEBhAAAXACBaAHDDHBEBBGDhABAOEGBCHGA.SAFDhABAAEDE.GCCFfAGB....hACA.WFAD.ZADF.hAGA...,2,-26,-18,8
SLPJfKbAEOZFWdUVRCYDXGITcNBagMeHQ,EDBDODCHFAFD.UADHRDEG..DGGGGEFA..TAACBHEGMIAEhAAAeCHBHECFLAHBhABAJEAHKADBbEAH..AEDG.dHFBhAAACAGD.IAHFaFHD.......hACA......hAEA...,1,-10,-22,12
eDPUXZgbGQLMJVKTAIREOYFBWHSNfadcC,RDAGOCCHBEGEHFEH..NEHG.aHGA.CAGC.DEEA.UAGHZFAGGADGhAAAQAAFMBACJFCBKBHFhABA.AIGG...IFABhABA.FADFSCAE..fFFEhAFA..hAHA...,1,-18,-42,24
SRONFMYaUTbZeVcCWEgDHGBKPfJdLQAXI,SGFCRFDFFACC.MIFEUGAE.ZDFEeFCH.CAHE.EBFFHAEFKBAG.hAAAJBHHdGGFAABE..IDADhAAAOAHB...aDCBhADA..TDCCbEDBWBBCDAEEBHFD..hABAfGAE.hAIA...,1,-9,-28,19
BaSFgARHJTfUIDMKOYEWZcXGdQbLPCeNV,RDBGJBDGUEGF..DHEGOGAE..EDDGZAGDGBAAdACGLAEDhAAAeCGHBACHFFEHACFGHFAChAAA...IAHDhABAKHGE...YHFG....hACA......hAEA...,2,-33,-32,1
HRKgMfPDAFBOdTCcZLSbIaUeXJYNEGWQV,OCAFdFFBCFAEZBAELDDA..SHEAaAGGUFDD.eFCBJABE.hAAAEAEF.GAGEQFABhABAHDDAKAAAMEHHDEAChAAAADCFBCHE.........hACA......hADA...,2,-24,-17,7
fbgMGdSaYCNcUDVPXKRZeQELHOJBTAWIF,FHBG..gCCBdFAFSGGACGFA.UADADDHH..XBFChAAAKBACRFEC.QGBGhABAHDFGBDDEAAHEfDAFhACAMAIFaDBC.NEIGcFEB.....hAAA......hABA...,2,-27,-18,9
HfICQaJSbNKeVZYPDFXTMRGcWEBdgUOAL,LFBBHAADCFCE.aCCDJEAD....SFDDKGFAeCCA.VAFChAAA.ZGFGDGCF..FBBDhABAMIDAREEA..WBEDhACABEEA.dADHOFABIBHF.QEGEhAAA....hACA...,1,-11,-36,25
gCUBbFDRMWaTYfVGJdQAcNKZHeEXPSIOL,KHBGZDBGHFBFECCH.SGADLCFCCHEBBGEE.FAFEDFGH.MBEDhAAAaACB....TGGDhAAAfACHJDFCABACeBDGhABAIHHA.gDGG.UFBFhABA......hACA.WAFE.,2,-26,-16,10
UDKWBMXdAEHPNOaGLFeJZYgSVRfcTCIbQ,ECFCHAAD.OGEAaFGDGDAALHBG.FBEHJAECZFAG...SCHDhAAAVAACRDDHfDGAhAAATAFCCEFCIDCFhACA..........hADA......hAEA...,2,-23,-19,4
eSMIYZNHTQfLgBPVKCAUJaFEcODWRdXGb,UGGDJEGH.FBFHEABH..OCHDDBAB..dCCBGFABeHAAMGBGhAAAZCAAHAAE.QEFDhAAALAFBBAHAKAHDCEEFAAFGhACAaHEA.RDBA.SHDA....hADA......hAEA...,1,-10,-27,17
LKMVZIGaEdcDWHSJOXPFfQBgCYebAURNT,REFHTDACKCDGZBAF..GADBdFAD.DABEHADCJDDE...OCHFhAAAFGEGBHGECHBC.eFFEAACCLFEDhABAVGAA.EHGASAADhAEA........hAGA......hAHA...,2,-24,-24,0
dgBUODEAcGMQKZLfYHXRTSaeFWNJVCIbP,MEAEZBCFLBFAHEEBRCFA.aDFEFBAD..JFGHCHHG.....IDADhAAAPGAAdCCD.BAHFhAAADAGAADIF.GEBChABAKAFBfEHAXGDDSFHBNFAF.hABA......hACA...,2,-23,-22,1
TgMeIbdKSYQDFLBWcNGVAZaUPRHJEXCOf,UCCBRGFGEECD.OAAB..TABGeAHDdDFGSDACDGAC.BEGEhAAA..NFADAAEGaAGFHGBChABAJBEHCBFE..MGEAhACAKEAB.FHFE..LDHBWBDE.cGDBhABA......hADA...,1,-19,-24,5
YTDOEPWMcdJXSAHIagCeFNULbfVQBGKRZ,HDAGaHBG.eACDFAACUBDCLHDG.bDFBQFEC.KAHBhACAYEHHDEEC.PAFEhAAAMIFEdDAF.SFAGhADAAEEAIADCCGHA.fFAEBBFA.hAEAZFCEEDGE....hAFA...,1,6,-26,32
CFRONDaAUXPWefcHgKJVQEBdGZbSTYILM,UCGCXCBCeBBAHFDFKGGC...JBHHEEDBBBFDZCEH...TACEhAAALDAHFFFAOAFGhABANIBH.ACAF..fDFBhACAgAAC.dAFFSEAA.hAAAIHHF.CEDCDIBEhAEAaGDE..,2,-26,-9,17
RTcXVFfAbKULEgSZBadQCNGJYeDOPMHWI,UGBCEDCDZEGBdDAG..CCFHGDAGeBCHDEFC..OFEBMHFAHAGFhAAARAAE..XGBDhAAAFBEFAFGAKEDGLAEGBGDA.hABAaEEA...........hACA.NIEF.....hADA...,2,-29,-14,15
KHGNRUgJSVMOdbBCLAEIFXQDaYeWPZTcf,EAFBXGBCDEDG..eGFCZBAB...TACGKDCHHAFA.GEFAhAAANBBE.UACG.SFAEhABAMAHFdGAABECGhAAACEEDAFHGIHECaGEBYEFG....hABA......hACA...,2,-31,-13,18
bCBJZQIDHTgeFONWcfYPMLdGaRVKUESXA,BBBDZAEGQDGAHEFHeBEGODCA..NHBD...fGGDhAAAMBIFdAABaBDHKDADEGAHhABAAFDGCAGG.JHCA.DCGGgDAHhADAFBBB..YFCA...hAEA......hAFA...,2,-29,-11,18
RTbWLFIBcHOAPYNCKGJDeXUgMSZdfEQVa,...PDEHNEBBGBCHDECF.UGBE..SBDEZFDFdDHAEFFEQAGChAAA.aFAHhABATAAFLHFAFAHDBAFAhAAAHDGHYDAHCFAFKCAD.eBCB.MACEhAIA.fGFBhBAA..,2,-20,5,25
IPdDBNMGZATSLVJgeCHQbaRcFYfXWEUKO,TGGDSDBD.LCEBJGAC.CHAHHACHaADBFGEG..XBAChAAAECAAKBFF.OBGFhABAdEFBBEDGNCIC.MBIDAFHFgGDChACA.bFAGcAFA.fAAHhAAA.IEBGhAHAPAEA,2,-40,-15,25
GJaMWLZEOVHUYXfQCFDKgBTcSAIeRNdPb,eFBBRDAGdGDHGEGEMAADLFDDZAAE.OHFEUAGE...fEHGhABACGBHDCDAKEEDBCCDhAAASDBC.ABHFNAEC.hABA..JAFBEFAFVFEA..XDFFhACAFBBE......hAEA...,1,-2,-26,24
LHeMGKNATYPQORgdbDIcCJfWVXUEZSaBF,TCBCQCBC.RBDCdHEFDFCGCAFE..JFEE..VFFBEGBFZEAESCGAhAAAFABA.eHBEhABAMAECKEHH..NEEDABGAPBEDhACA..........hADA......hAEA...,2,-32,-22,10
KHTeSaAbOBgfMEVcXIdLUQZWFPJYNCRDG,OAFBBFDGMDBB..ECCE..VADCIABDdDEDLFHBhAAAZFEEFHBE.JAHBCDBD..DGAEKGCDhABAeECAAGFE...fBHEhAAAXCBB........hADA......hAEA...,2,-37,-32,5
LNEHYWXfKcFdJZBSDAGaRPbeUVMCIOgQT,aCAHRAADeAEG..MIFECEDG..OFCHQDCDLFFDHBGB.hAAAWGEEXCED.hAAAKDGEcBDFdGAABGHAhACAABCFGGAFbACD.IAFF....hABA......hACA...,2,-19,-15,4
ILSBEdXGFgfOMeYCZbaKRWcPJTUQNAHVD,DDGBSDCDEGCB.dDGGFFDA..OBEHMACG.CBCAZFAHKAFARAAH..hAAA..PBADTDBHhAHAUGGFACIF.HGCA.hAIAIAHEBHEHXGGFfAED..hAAAYCCC..hBAA...,2,-39,-12,27
LaGNJbEXTCDUBIAeQZSVFRKOWMgHdcPfY,QAEGSDAFREEEKGGH..OCBDMDCCdACE...PEBGhAAA.LAHHhABAaFADJFDHECGHXEFBTAAChAAADFIDIAGHACGBeGAE.FHGAWHBGcACF.hAGA......hBAA...,1,-16,-17,1
MaZNbEARODIePXTJdgKcYLUWFBCHSVGQf,OAGHDEFHeDBB..XFBEdEGBKAACLAGHFCAFBFFF.HGCASHGChAAAQADHaHBCZABFhADAEGGEAEEH..IAEChAHA..........hAIA......hBAA...,2,-36,-24,12
NOHTJKDgaeZBAYfcbPMFWERVdQUGLXSIC,...fHBHbFDFFBAH.EDDCdFBG.UFGFGBACLBEFXACDhAAACDHC.OCGF.hAAATAEGDAHF.eEGDhABABDCCAFEHcGABMFAH.WFHH....hACA......hAEA...,2,-34,-9,25
VNGaLYZMBSJKbUTFPXECfQgeOARWIDdHc,RAADDACBHFGD..VECFaDCHLBFAZAEF.BDHHKGAAUFFFFEAD.hAAA.EDDBCDBG.QGEChACAOADB.AFFGIADChAFAdAAEGAGE.MDIFSHBA..hAGA......hAHA...,1,-12,-29,17
gbAYNLSaGXHKBTfMZCJFeRDPQIUOWdVEc,LGEAGACBKGECBDCCMIBEZGAC.FABEDGHB..QBFBhAAA..OBHDdDEAEEAEhABAbCEHAGIB.SDAGhAAAaDGD.TFAECBDA.RCCB......hAEA......hAFA...,2,-28,-20,8
BDTXcAOgNeLMEHYaIPWbJGUKdfVSFRZQC,OGEAeGEAEDBEHDCB.aCAH..IDGA..bBDEGEDHhAAAdHFDSAHDhAAAFGABQADHCEEBBAFCDIBAXBABhABAABBDNIEBMAFEPDHDWCHB.....hABA.KDDC.fGCFhACA.,1,-7,-17,10
bEXMfgRJANVDLFeTGIBHYZOWadUSQKPcC,DHCEFGDBGBDCBAACZBECOGFA..aEGHdAGA.QFAAhAAAKDAE.CBCB.EHFE.MGAGhACAgDFHAEIB.NABC.hACAeHAG.TDCCIHFH....hADA......hAEA...,2,-41,-24,17
DYSEJaFBfQCbMHXGZOgceLAKVIRUNPTdW,KCFCVGFGRDFC..UGGG..TCGEDEBE.SCDF.aBAGhAAAfBAA.hABAQGBBbEABXFCFhACAZFDHOCCCgAFCLAACAEGHIADFhAFAdFABYAEG.hAIA...,2,-19,-19,0
WUXaAMcQRbKOLgPGTSCDdfIEBFNYZHVJe,QFDBRDAGKAGELHDGGDAD.CBDHDCHHdGCBEBCDBACG..FFAFZAFGhAAAHFGDJGFG.eEEB.hABA.UGACAABDMAAF.hADAODFA.........hAEA......hAFA...,2,-30,-12,18
MVGgIQAZYCNdSPBHWLJaDFEcOTKRefUXb,CFDDdAFBBEFELEGH.aBECDGID.EDCAOGBE..RAFEUBAGhAAAMDFHGBBC.IBADhAAAAHAFZEAFSCGGhABAPEAB..........hACA......hADA...,2,-47,-21,26
VKRTDOFcMdIaSEALfXHCJWUQgPbYZGNeB,LDACHEFHCCDGUGDEQEAH..bCBHZAAC.eDHFBGBGRCEHOEFDhABAFAFHdABHSAHDhAAAfBGHXGBAhACAJFHB..PCAB.....hADA......hAEA...,1,-16,-20,4
QDXYeKcRLABTbIGENMJdaOVUPHCFWfgZS,TGGGGAFEEEBE.MIDEJCCE..dAHAaEDFOAAC..PACAhAAAFEEA...fDHGhABASGBBDFGDYEAChAAAKBCD.RFDBBAFFIHAF...hACA......hADA...,2,-31,-19,12
EWQaCRUXSPBGcbHNYefZDFITdMKVAOJLg,LAABEHBG.aAGDUDAG.XDGHSDECBHHF.GDCDhAAAcEFHHABE.NGDH.hABAfFBEDGAD.hADAIHDFdBGHMAEEAFCCJACA.WHFE.CCCH.hAFA......hAGA...,2,-35,-7,28
CYcOTASIQJgDEPXFbMdUGNeaLZRfHVBKW,QGBCJFCH.EBDBXDDD.FAEDMEIBGBACaGGHLCADhAAAZGEERBGD.VDEGhABABACEKBEECHAG.OAHBhACA.AFHH...........hADA......hAEA...,1,-15,-38,23
EFabWSTGKBXIJLZVHCYfQeRgdDONUMcPA,aDABSHBGGDEFKAHFBEFD...XFACLFHHZABECBEEQABHhAAAeGDCdBFDOCHFhAAAMIAAAECDFDAE.bCCFIGAAhABA.JFDAYHFARCCCDHDE...hADA......hAEA...,2,-12,-12,0
XARGDCWUMcOKBZNIPgeaTVLYSJFEQbHdf,GDFCDAEDCDHD.UAEG.MIFGOGBG.BBHAZDBB....IBBFhAAAeBAGTGFHhAAALEHBJDBA..EEFGbGBAhABAdAFGADEF....WDAFNCAE.aAHDSHBAhABA....hACA...,1,-14,-37,23
EbPIYcSdOGHZAaCFgJVXKDBfQeNUMLWRT,aEHBFEGD..JECBKHBA.BECF..eCBAUEEGMIAERBAH..EAED.hAAA.PACC..hABA..YFADhAAASAFHOCDCHGDGAGCCCHHGXBGHDBHD.fFAChACA.NEIE.hAFA...,2,-34,-32,2
JISCFBRLdQMeZcEObfYPATWVXNgaHGDKU,VEFHXCBC..aGBGDBAH.UDGC..IDBBCGECBFBDdHABhAAAMDDEZAEG..EACH.hABAOAHD.YAEAhAAATGGENEDE..HGCG.KECA.SCAFhABA...hACA...,1,-11,-40,29
STeRdNcAUHJCQFGZDEKfYXPVaWgMILObB,HADGCFFEGDCEZFEHKGCD..XGECVCFA..aDCHMADA.IABDhAAALCAEOBFAhAHABEADSHGEhAAARCEA..NCIAAHHC........hAIA......hBAA...,1,-24,-27,3
SaTZXOYDGeQBHVICRbMLPAgfEWFUNKdJc,EHBGUGBCdABF..JBDDSDCFZBFF.OBEHDFDEGAAE.hAAABGADIAFE.hAAACBGHMDHDLFGHPFFBhAEAAAFE...WCBF.FFCENAIA....hAHA......hAIA...,1,-29,-41,12
bSWOXDBIEYgRaJQVZdMfcePCGNKTHLUAF,FAFBSHBGOECDBABCEACG..RFEBQAGFdBDG.MEHHhAAAeHDAGEAHKBGBHEEGhAAAACDCXBBDDEAH.IBAChABAaCHDJCBF..fHAF.CHGA.hADANDEB......hAEA...,2,-30,-4,26
YNFPKQXCEbScUgAIVRfLMDOdJZeHaWTGB,VGFGRFDFLCCC.MFFGDGCAODFB.ZCDD.HDACaCAD.GABDhAAABGBC.FHACQAGEhAAACBGG.SDDFhABA.UGGEIFAEfACBhAEAdDHE......hAFA...,1,-14,-30,16
GRPQcNeUMVFXDSdbTYLCJaZIAWfEgKOHB,EHBGOCCHBHEHRAFA...QABCeABFUGADFAEFDIEEdDAD...hAAATCFGCDHCZGFCAFDE..hABAgFGHGADE.hADAPEDC.cAGF.....hAFA......hAGA...,1,-18,-27,9
UIPeSWTEANMHVCDYbdXcgJQGaZFBKLORf,MECGVFGH.DAGC..dDDF..XFBHJCBBGAFCFACHLDADhAAA.OHEEfCHChAAAUFFFeBEESHBChABAEDFEABBD.CADGcECD.aFFB.BAEBhACA......hAHA...,1,-18,-27,9
AQWFVDdHOcUSJgeNZEaKIYXbMBfCRLTPG,FGFCDGDEOCFCUECC....JAAAeABHZGBA.aHGG...IAGEhAAAXBEH.BAEChADAfFAB.CBEE.hABATAGEAADGQDCGdEFFSHGANIAHKEFAMHCEhAFA.....hAGA...,2,-43,-16,27
JWHMgbESOPTdFBZLcRCAQVeDUKaYGIXNf,VADGeEGHKCFC.GEDG..IEFCXACGJDCD.HFGBhAAAMBIHECBFOHAG.hABAdAFFBHDDLDAAhAAACBGADAGGaEHFfDFE.gBADhABA......hADA...,2,-28,-14,14
GHMRbeDaIZXKcCdFWUENfYQAgSOBPLVTJ,OCCHBAFBLFEC.JDBGMBCG.eFFGaDHF.XDGEhAAA.KGBHdBBDFBGDEHAA.hABA.NACF.fHEBhAAAAHABSEEFPEAB.......hAHA......hAIA...,1,-33,-36,3
VcXNLOIfZSKMaDHQCbERgATGPWdUBFJeY,TFGHGAFEdBCF.BEFGFDFGeEAF..VFGBXBAEOHBEhAAAZECHKDADDCFCHDCFCGBGEAEChAAAADCB....WBHBhABAJEEFNIAH...fBDESFAHMIFGhABA......hACA...,1,-17,-19,2
RWXCMFNZEUOeAacdBSDfVLgTHJYQKbIGP,aAFBBFED.DCDGLDDCHDFG.JDAHQAGGKBBA.GGBHhAAARGFGCEFG.FDBCEAGFeFAAAAAF.hABASBAE.hACAfHGB.......hADA......hAEA...,2,-43,-14,29
cUPDECZJAIVFfHTMdNLBRabOXWSYQeKgG,VDAGFCFCHFFB.dBBBLBCABAAFRGBE.OEFC..SEBFhACAeGBAKGHBGAGEhAAA.PDDACEEBAHIHIAFHhADAfADFMAEHNIAF.XDGA..hAHA......hAIA...,1,-8,-31,23
gJaMUedCcXfOATIPZBVHENbWQYFRKLDGS,TCBCZAADHFFD.EEBF....NDAGQGFGRAFHDEDBSHDGhAAAJABCUFBDCCHC..fDDBhADAAEGCBFHF..bCFChAAAFHAEKHBALFHB..aEEC...hAEA......hAFA...,2,-18,-16,2
XNaYBWJDgZSFdRIHeTbfKUVLOEQcACPGM,CECDMEAE..aHCEBADGDDEG.SFFG.RAFGHABFeEAHTDGAhAAAKEGGLFAGQCCAhABAAICGGGCFXFEBhACANDDF.JADG.FGGE.IBHE.fBBAhADA..hAHA...,2,-27,-15,12
QIRVHbcGaFMEeKABXSWLJOPNUZDTCYdgf,BFCFSGFCJCAC.OFABUGEB..ZAFEDFIB.CHBD.dAAF..QDCChAAARFABHDCCGDGEhADAFBFFMABB.eCCEhACAAGDF.XCGD.WAEE....hADA......hAIA...,2,-30,-29,1
dHNSfIRgXPDaKAUcWCTGLbVYBZOJEQFMe,UCBCCFDGGGDHLCFC..VFAFZFFAEGAEQEFFFHDA.MBCEhAAAeADGHCAC.NAEB.hABAfDGC.hACAIAHBXCFBaAAEADEA.....WDDHhAAA.....hADA...,2,-21,-14,7
bXWHaRFLSQKBZOAYCIJPcgNTGEfMUdVDe,CFDGJGEA......PEDGNAFE.EHEAUEAA.DBBAeBHD.hAAAXBACaCHB.LBDEhAAASGCHBEHGhABAAIFG.IGAE.cGGF.TDAEhACAfCCBMDDC.bCFDhABAWHAAFHAG,1,-32,-54,22
YgaSeCEDZbHQKcTIFXOPANdUGBLWRVfJM,UGBCLCBBRGDE.VDEBMBDD....aCHFCHACDFCGZGDAHADD.hAAAKHBG..IFGGhABAFGGAOCAHAIHAdCBGBGBChAAAJBFG.SAGF..eAEC..hACA......hADA...,2,-38,-11,27
REUCFKJcTZWeMDfIdbaONALVYSGHgXBQP,LFBBVDAG.SDGDGDGCHADGBABCQEDDEEDE.hAAAUGAGCGHBFHEEJCCAZAEDeAHBhAAAMEAHDBAFdBCHaGCEABGA.hADA.....XBGE...hABA......hACA...,2,-21,-5,16
QMCPIRbEUBgaGZfWNAcdXTeOHFSJDYLVK,XGBCTFCA.HDEHFEHHDABELAHB.KBCGCBBFRADCUDADBAHDaGDFhAAAZCFG....fBFGhABAAAAFdGAASCCHhAEA.JFFBQGFE...hAGA......hAIA...,1,-11,-32,21
WFCgIdQNbEDHeJPRcKMLVAXaYTZOfGSUB,aGFCZEFHOCCBGECCBADDFHDC...CDCFdBAFQBFF.EGAChAAADGAD.JCABRBDBKABDMFFGhAAAAAIH.....TCFEhABASADC.WFHBIBHC.hACANIEF......hAGA...,1,-29,-31,2
KgPZHdeMBGaNRIEXJfQSLOWDTbcVUAFCY,CFEDKHBGZBFAeCAFBGHAGDCB..RCCG.EGHB..XABBJFAG.hAAA.SHEChABALEAFDIBATABC.VBEAhADAAEHBFECH...PHDAdDHG....hAAA......hAEA...,2,-42,-7,35
IFdQebUgTJHPRNGMKScEZYaXLBCVfOADW,DACBFHBGdBDDQGFAUEDD...JDEGHCFCRADC.MABGKBAD.EBBFZEADhAAA...aEFEXGGChAAACGCE...fEHChAFAADDD.IAHEgAGH.hAGANCIE......hBAA...,1,-29,-31,2
PLaKABNOTWRXYZdMSDGVeHbgIJQFcfUCE,BAFBODACRFBDZAABdBCADIACGACE..HFAA..IDFGhAAAJEGDFADA.UFGDCAAF.EAHBaEDEhACA..KEAEACFF...hAGANEEE.TGDF.....WAHBMFFFhAEA......hAIA...,1,-26,-29,3
MAJOLbeKSFNEfYXVWHDTBgUdQGaZRIPcC,LAABKDCD.SACAEGDG..fHBDXAFDVFFGhACADEABBHFA.UBGChAAAGDADZADDREECIHEHhADACBFGABAG.JDFGOCAGFAHFWFAA....hAFA......hBAA...,1,-15,-30,15
SXEDfPRdNYGTeBHLgbCAaMUZJcFKIOWVQ,MAEDZADGFFEEKHAC..OAAHQBBA.EFFBDDEC.RFCBdHGBGBFGhAAABFHALHEAhABA.CAFCaDACJFAF.IFCChACASCHD..fFHE.hABANAIE.TDAB..hACA...,1,-5,-43,38
AdZVRGfTHaPILOEMUNcgKXFSeJWBYQDbC,ZBCFRCADGABDHEFHaGDALCHB..EFBDUGCA..NACDKBECFGHHJEDAhAAABBAGDDFG.ABAH.dEHEhAAA...fAHEhABAIHAH.MIDAXAGCSCEA.hABA......hACA...,1,-11,-29,18
FEMgeNGSRCdJcbWQYKBVUHAZOPXLIaDfT,ZFDFODACLFFGDBAD.FDAHEGGF..MECDeHCAGACARAFC.JBGDhAAA..bCCE.QDGHhAAABDHH.UFADhABAAHHDIGACaBBE.fCAD..hABA......hACA...,2,-34,-11,23
IOEKbcdRgaFSBWYJMQAVHPXTUfCeGZNLD,VGFGXFDH.UBFCCDFEGBAE.LHBEDAEDOAAE.KHAChAAAdECBRDAH.aAECBDCEJAHB.hAAAAGIF....PEEAhABAfFEH.eACBIHGE..hADA......hAFA...,1,-17,-37,20
fQZFNUWSACRgecKDdYaMLJXGPEHbITOVB,RDBHeGEADAGA.dCAB.MAACLBEE.JCHBGEAH.EBHBHFEDhAAAIDEGTBAH.BDADhABAQGBBFHGA.hACAWFFCADFGCEDAKGCA..aBDG.....hADA......hAEA...,2,-25,-15,10
FMNLESfDOJaUBWeAcIPTbZXKHVdgRYGCQ,..IFDGTAEGZEACKFGB.dFGD.RCECGAAEFBCFMDIDLHFAhAAA.SGAHhACAOBEHUGAABAHBAEACbGCE.hADAHAFF..........hAAA......hABA...,2,-31,-13,18
YXfFQELHVRTcUKGIMaNDJbdOWeCBZAgPS,SHBGXCBCFGCDEABA..HDFBRDGFUGGBKABCMECA.aBGADFADhAAA.JBCGdGAE.eAEChAAACEDBBCHBAHID...PGCAhABAfHEB.......hAEA......hAFA...,2,-36,-15,21
PIQaHecXUKOCFBdGYLTbARWVDSNfZMEgJ,RGFGDHCE..SFAHZCGBECBC...PACBaDEDHAEC.XDBAhAAAKBEFFGCHdEGD.LAFEhAAAAIAC...hABA.NIEBMGDGJDDFIDADeEABOACGCDGE.hABABBBC....hAHA...,2,-21,-20,1
JbPTHBDeZARWFLQagSMNGdXCEYKVUIcOf,RDAGLCCHQDFAaFGC...SBBAMABEdGBFCEHEKAHH.IFABhAAAOHFE..JAHBPEEBhABABBFEDEFBZADFFHAAhACA..NAAE.EGGB........hAFA......hAGA...,1,-14,-35,21
EBJHMAgRLbTacVOUYNPKdXQfDZCFSWeIG,RFDFLDAC.TBGDaCEFOAFG.UBCGPFDC.XGBGhAAAQCGE.ZCABhAAACEHAFGHHSGGAhABAeBEDIABC.BAFFHFBDAFCH....hACA......hADA...,2,-21,-17,4
IGCgLceMbWNdafQDPHEBVXYFKAZJUSTRO,JBDGUFCA.RGFEGAEGCDAH..LHDGMCBF....bAAEdDGFhAAA.QDDGhABADAAEEHAGBAGCVFAB.XFFChACA...YAFCKEGAACCHSEADhAEAIBBG.cCGGhAIA...,1,-26,-27,1
GHYfXOJgZCVNdKeAPFSIQUaRDBWbMcELT,FAFBQGBCUGFG.RBBFBBEDMBDB.LBHBHCAD...fGEChAAAOECHZFDDCHHFdFAChABAAHHG..IBHAhAAADEEAbFFB.EDHF..........hABA......hACA...,2,-31,-19,12
NJGXSBTZaRVWcgDYIeUKCObEMFdAPLQfH,LDACHEFHJCDEGEABXAAFBHDA.ZGAERFBA....VAFGhADA..cCADDFEEIHEBhAEAKBACOAGFMEEAhAFAAADC.QFGESHGA.....hAIA......hBAA...,2,-24,-19,5
JZFNfdRAQBGPbEHcLXCUgYDVIMaKeSOWT,BDHHGAFEEFBBHEDELCDBCEAHUAAC.DHBGVGDA..aBDFKABH.hADAOFAHJFHB.ZCFHFHEEhAEAdADBAAHC...PBABhAAA...XGGFIDCG...hABA......hAGA...,1,-20,-26,6
ZLaYSIPGQKFTENcXdDUAfbMgWVBOHCeRJ,MCCAVAAD.BEGHHDGFRDBA.LEFD.SHCEGGEFKGCCEDCAhAAAXGAHdADCDCIDAGAA.hAAA.bBFBOAFE.hABACFDH.JACEaFAAICAF.....hACA......hAFA...,2,-22,-11,11
ABcQEVGUHdLJXKZYfeMOgTCFbSNDPIRaW,QGGGEGFHGBAGdAFCJGCE.ZCEG..eEDCOGBACAGF.FEFGSABAhAAA.DCEEIECHhAAAaCCF.AIBAVACBhABALFAF.KBAF.......hACA......hAEA.MEIBbCFA,2,-23,-11,12
MZBDIaLNJfQSEXeWAbPcKCYHdgFRTVGUO,...bFDFKDCD.HFGDFEADRFBHTAGC.UGDEOBCDBEEDaGHBJDAHhAAA..SCEDhAAA.EGFHWABCPAHHhABACCBF.dAEB..gGAA.MCIFhAFADCAF.IDFChAGA...,2,-34,-10,24
PUSVbQYacIDELFZBNeWGgTdKJCHAfMXOR,XFDBOFBBUDGG..SGFDQAABaAHHDBDALBFDhAAABAHEeCDAGEBGdGECCGGEhABAfDAC.hADAPADD.YDHFIEEDFABB..hADA......hAFA...,1,-14,-33,19
GMOeAKfFaBgVYDNXEcZbPRIHQULdJTWCS,KAFBFAFBBEDA..VCBADAAD..EDBGZFEF.RFCBHBGBQFEEhABAdHAF..JDAHCHCCMCBGhACAACFB..aAAC..gCGGhADA.NEBC.cACA..IAHFhAEAUEGF...hABA...,1,-20,-33,13
UISCZPVJfWHQYDNAFROLgbdGXeaBcKTME,FDBDLFFCdGHGGEDEaEBFBDDAKAAF...MBADEADC..UBGFIBGDhAAA..SGAAhABAZFDHJHAAHBBEDIAGACBDhACA.OFFD.XDFATGGE...hABA......hACA...,1,-22,-26,4
YUJFHgQATPICdLaDSeNWbRXGBVcOEKfMZ,TCBCCFDGLGFC.DAHDSFCA.eAGDNBBF.RDFEBAHChAAAODACKGFBZCFEUADBFFAGHGBAhAAAAEAF..IBAEhABAaCCC...bEAH......hACA......hAEA...,1,-22,-30,8
UWPgcEedSJMKTBGQVNfIHLFOYDACZbRaX,ZDBHRDAGUFGC..PFFDEFEB..dAAFSDFCKAGG.BFAEhAAAVBCA....IHAFhABAFGABDCGBCDHBbACE.hADAaEDC...XAGC..WHEGhAEAcCCFMFDF...hACA...,2,-41,-31,10
eUAYZLacMPRNdTWKQFIVEXHJDBOfbCSgG,ZFDFaDCD.MAIHRAAC.dCBFKFFD..FFHBEDGCHAEHDAHB.BHBE.OEABhAAACGBC..SAFFhAAA.eCCEAADGcCFDhABANIAB...TDBCIDAC.JEHBhABAfGFG.hADA...,1,-23,-33,10
CbXMFKREYTHGPAdBOIJWVfULeNcQSZDga,OCAFJGEA...VGBELAHH.eCCEQGFHDBAAaAEA.hAAAbDDG..FEEGKAECEDAChABATBGHHEBFAGIBIABFhAAA...WCCFfBFE.hADANIEFSHBGhACACAHBXEGA...,1,-11,-29,18
EbRgVIFdJQADCBUMWXSTGHZYfKLecaPNO,BAAHMFFF.SBCGGAGAHBCHZEEGKGGFeCAD.aGAEODBB.hAAAEAGCbFCF..RCDA.IHGHhABAFAEGdHCDAIHACEGG..hAAA.....WDHHTCEH.fABFhAEA...hACA...,2,-31,1,32
ZWLBbORXYSgIcMKGUDCFNVdTPJEHQefAa,aCFCZFDFBHFB.OCEGRAAFSFFG..IAHAKFBEDAEE.hAAACDCE.FGCD.dCCHJFBHEBHDhACA..QAAFhABAAIHELEEEXFGE.gDGFhADA.MBDCNDAE...hADA...,2,-29,-27,2
RVJOdcaDNbfLEKUGMTCAeBQgWFPZXYHIS,BFFEQCBCFFAHZAACHABG.SFEEJDDB.OAFHaBEE.hABAbDGFEGEBGECE.hACATGEBeCHDPDAAhADAIGAE..RFGF........hAAA......hABA...,2,-29,-6,23
JdaYfETHZBeIMVCFAQScONgbUWGRLPXDK,SGFCOGEA....NCDH.UBCDRBAF.LHDADICEdAEH.fFBEhAAAEFABHDFCBHADhAAAMCFCFEFGAEEB.cGAHhABA...WBBDGDBEKAEC..aDDH.hABA......hACA...,1,-17,-25,8
XeRNHVaSATQGFIUPbBdKgZMCWcOYELJDf,QABHFGAHUGDFBEFGdFBEZDDE..CCCB.OAFBLBADDIBCeDAAhAAAHBFF...aHFEAEDCGDBEhAAA.IGHDhABAbAGBKFFDMEIF.......hACA......hADA...,1,-14,-35,21
UBXeSQabONEdTIKMDLCHfcRJFAVYWPZgG,VAAD..PGEAZCGBGEAHUDECeAHDQGDG.aDEFOEAHhAAA.EBCAdGHATGCAhABAIHACDFBCCDABfAEGhAAA........hACA......hADA...,1,-20,-27,7
TXRSgabeMYVZQAfEBUCcGJPOFKdILNWHD,BFEDCHHGGDBFJCEC.FCAG..KGAHdDHGLHCCHFDBDFGH..RCBA.aHAGhAAAMAEA..VAEChABAQGGC.EACHhAAA.....cEBC...IBAEhABA.NAIE.XEAChACA,2,-43,-24,19
aeSLHgBNFQDbKTJXVEZUAMOPRcWGYdfCI,OCHDRAADGAECdHGFCFHC...aFAEeDED.HEAHBDCCFHCAQBAGhAAAKAGE.TDEBhABAXCGDEFGGUAEAAAEDMADFhAAAPHAC.cGDAfGHA..hACAIACH..hAHA...,2,-20,-11,9
MZHPAcaIQURVWeOBbJTNgFCKdXfEYSGLD,aHBGQCGC.UFCHVDFH..OBDBBHGGTFDGFGHDCAHE.hAAAdAFEEAEDGABA.hABAMICEPFFDAEAEIADFhAAA..eFAH.JBBHKAHD.fDDFhABASHBADFBE.hACA...,1,-14,-24,10
YeMaIbJVDBdLTFUWASfgGPCQREKcHOZNX,SHBGGAFECDEAREBE.EAGFHABG.ZEGBXGGE..MHAEhAAAICCAJCAABAEBTEEHhAAA.UEAG.fFDEhABA.PACCKHDA.NDEB...hACA......hAFA...,1,-23,-27,4
eEaJSOIYQWgHMXKPCBFGVNRUDdcATZLbf,ZADGLGEAeEAGEDGGJCEA....OEBBIAHGQDCAhAAA.HABFKCEFPFEAhAAACAEABAGAFFFGGGCFNBIA.hABADACCADAA.fFAE.SBADhABA.WBBBMEAF.hAFA...,2,-25,-15,10
QeXCGfRBTFVOILcYMaDbPZASNUWEKJdHg,UGBCEAFBdDAEHBEG.QEEGCEEGGABCBHDAFGGH...IFCGhAAA..YACFhAAADEGF.PBAHhABAAGHDNBHGKGAA...........hADA......hAEA.JDHF.,1,-24,-40,16
IePJfFGNAWHCgdTQBEbDYZLSROcKaXMUV,CFDDTGBCBEFE..DGCDZEDG.LABEREAF.KCFFMCCAUCBD..hAAAeDAEJBFCFGHHAAFAHAFChAAAdHEB..EFAFSHEGhABA.aHGA.IACH.PDHFhAEA...NDDB..hAFA...,2,-23,-23,0
SdVecPbYNGLERZBCUMKDJAQFgTHOXfWIa,FGFCHEFHOFCDXAAC....IBGFdCEAeEHH.cAGChABA..PBAFhAAAbEBDGBCELDCEEEAFBAHEhACACFBGMAFG.DFFCAAEBgGDBWEHB.hABA.aGEH....hACA...,2,-39,13,52
EdcbZRDBYfJGWPQLTUKSNaeVCFHIMgXOA,EAFBdHBHZDCFBFCH..JAFFGFEB.QCFBTEFC.SDAGhAAAaEAE.CAHAFABFhADAMABGOCDDAIHA.RGAEDIDAhAEAfHEF.LAHB.NBEAeBBFhAAAIEHF..hAGA...,1,-20,-22,2
TCSAgLVXaMfdbYHJcPZQEKIWGUNFBDReO,LFBBaDAF.dEDGHDDFJBGF.ZDBD.QACGKACCGBADUAEEhAAABGFCeFHH.CABDAAHG.hAAA..XGBEhBAAMIFAfGAA.cAGAIHFENAFEDEIFhABA......hAIA...,2,-34,-10,24
ZaNgefbTDQYVAEGJUHdXCPWRSFKBLMcIO,EHAEGDDCUCFEdCAE.CAAC.RGFE.KHBALDHB.MADAOCCGZAAC.hABAaDGCeGBG.TCDDhACADGFGQAGHhACA.AGIHXFAF.PHFCWBFESEBChAHAFADE..hAIA...,2,-18,-16,2
gDBICHNcaQSdMUZLbfPWJRVOTeEAFXYGK,XGBCKGAHDCHHBFHFHDEH...aEGESCDAMEACZACGLHEAhAAA..fACFhAAAJBFE.RECEVBAFhABA...eAEAAGADFBAF..gGDAhACACGGC.NDGA...hAFA...,1,-12,-38,26
dGYRfXeSAaZgVILJbTEMQCBDPUcFKNOHW,aCFCZGFG..VAFCLEGB.JABGEFEA.QCDGDGAGUDCEKFFDhAAAHFCB.dDBGGAEFhABAfAAHSHCAhAFAAGGAgACC........hAAA......hAFA...,2,-28,-15,13
ESfLTQcBDgaFbVNOPdZMYCGHIWAeXURKJ,eDCHUCCBRABGKBHB..EAFCSCDB.LDGBQFFChAAADCACFGABVBGF.OEHFhABAPFEHMFDBGADFhAAAHEABIABCAAIB.fDAE.hADABGHAaGEH....hADA...,2,-24,-5,19
RMGQAINODCWaKcFLETUfegXHZBdVSJbYP,OGEADAEDCBFA.KGBHFAABLBAG.UBFH..fGHGhACA.eBHBHDAGdCBEhADASDGGJEFB.hAFAbADBRGAGMEEFAEFH...WDDCaAGG...hAAA......hABA...,2,-30,-30,0
EZTfWIKSUAaHBdNYVCJgcOeQMFDbXLGRP,BCAHdHBH..VCCCJFFE..OEDGeGFEFDGF.DADALAHFhAAA.GABFEFBCTAGBhAAAIFCCKBADAIGEaCEG.hABAHGAACBEB..........hABA......hACA...,2,-33,-28,5
DHXfJcMASIOgLVRCPaBZUYWGEQdKbTeNF,OCCHLFBBRAEC.aEGABCGCZAEG...UFFHGAAEdCAE.KGFAeFDDhAAADGDEHCDC.fBHAhAAAMEFEABBG..SBHHhABAIGAHCEEDPFAF..EDCB.hACA......hADA...,2,-33,-9,24
XQETHFIfaVWcNJGeMBYbdgUKAPDZLSCOR,ZFDGCDGFRDBE.EDDGHGBC..FBEEaHEE..VABA..NBAH.eHFEBBGChAAAdHAFKEGGDFACLAFChABAOBAB...XFFChACAQCGE..IHHC.cEAChADAMIDE....hAEA...,1,-18,-27,9
fNLbIGRKdcaPXFHeDCgTJAEWSYOQZUBMV,EAFBSHBG.QAFCUDFDBCDEMBBCVEAELCAEhAAA.GDGEdGGCaHAAPFDDhABAHAAA.eEAGDIDG.hAAATDEEADDD.........hACA......hADA...,2,-34,2,36
bFMQYTNdPecZHUDKGAXICgOWESJfVBaRL,CHHGOGEA..SDGCVAAH.aADBREBHLHFG.FBFAhAAAQGCG.hACATBEDNAIGeDHDcBBChAAAHCDFDDGFKFFGAAHCIEAEEGAGBHFH.MDEDhABAYHAAdEBF...hACA...,2,-28,-6,22
ALIBXZWTbHgceUVGKNRMfJDCaOFYSQEdP,LAFBXGGGZCBFTBDAHEDB..eABAGBDDRFBD.JDHHCGFEFAHFhAAASGAFdEEH.IEAGhAAABFHCbCAF..hABA............hACA......hBAA...,2,-20,-19,1
ESObWHAcTIXGFKLRDBYCaVMgPZJedfNUQ,TCBCXFGH.KGBGDFFC.BCGD.CAAE.MDIBZAFG.eAAG.dAEAhACAUFAFSDDAhADAOFEH.bBGBADFF..IHHEhACAFFFBREBEaGAH..PADFNICB...WDHHhADA.....hAGA...,2,-34,-10,24
PGJEcXKbBdAWQMYgTeLSZfDVNUOaCRIHF,MFFFTCBCLCBC.ZFCDVADDUBFGCGFAHFAGFGAF..JAAGEEEFhAAA.KHDABEHFAIHE..hAAA..YAHDhABA.SDFBDFACNEGC......hACA......hADA.aAFFIHHA,2,-35,-20,15
IAcYCXDPaVgQSdZHUfJWbeMROTGLBNFKE,CFDGXAFBDGHF...aGGEQDAG.dBCDUDDA.WABGhAAAMFFA.ODEEhAAALCHHBHDBKDAEICHEhABAYEAF.gGDASFBHfFBBhACAeAEG...hACA...,2,-43,-22,21
JXfOWeCVMBaRKZgNFUdIbLEAGcTDPQYHS,TAGHDAFBQGDD.HAGFSABHXBCDODEG.hAAACHHGBFHCaGFFRDADgABFhABAFFBAUGEGIAEFhAAAEGBHAECE.PDAE..fDFChAEAeEFCMADFNEIE.dGAE...hAGA...,1,-5,-11,6
KNATCDJPOWSgQFbRLaIYfUMHcXeZdVBGE,TFCAJFED..OCHDSBFH.QGEHRDAFaHAC.fACChAAAUAAEMDEAXEAFhABAeDCG.dAHABFCFhADAKEEEAHBBDGHDgBDHFAGB.ICAFhACAcADE.....hAEA...,1,0,-34,34
eOHEcaRLSKfUZFVMGPAXDYJQTdIgbNCBW,XAFBDEFHQCBCdBCA....IAAFbAEBBEGB.eGCEhAAAHCEF.aGDALDHHhABASBGHfAHEhACAUEABFGGFMBBEADIF........hADA......hAIA...,1,-21,-24,3
TFGNPDVBKIaHUSeOgfMRLJZEAQdcWbCXY,dGFC..bAADCEGB...TEAAGEAADDFEKCEDHFGHeCCD.OCFAhAAAMAEGLHCEhAAAZADEAABC.QDDHhACA.cAGDWFEF........hADA......hBAA...,2,-36,-12,24
CBeFSRMGXNcUEOYfLWJZagQHAIVDKPbdT,DHCEKHBGdECABFGGFBFHREAE..GACF..XGEHUAAE.OCAAhAAALHFG.ZDDDaGGEhABAQBGAAEGA.hACA.IFAD.PAHF.CHAFMADAhAHANIAF.EEEEWDAE.hBAA...,1,-26,-34,8
ITHEaGDUNMbRcKAWYVFPdfBSZQLJeCXgO,VAADFAFBdGEE.BFFEQEAGLHAAeEFD..CCGA.OAFHhAAAHBBHEEHFDDEDUDGC.hAAAMHACbEAC.KADBAGCE..hACA...YDCHfCAGSHGAhADAXDDB....hABA...,1,-5,-34,29
LWGgAFXSJbYRUHBZeICTcVdfaDPEKQMNO,XFCEJCCH.RDBA.HFFEZBGF.CGBH...VBDGdGDGDIFA.KEAGMAFEhAAALEFEGDFEAHHG.hAAASBAAUAGCBBDAhABAIHHE..fABAaABAEEAB.hAEA......hBAA...,1,-12,-34,22
bJKCVceZRDQIHONgAXaTBYFfSULWGPEdM,XFCAaFFBBCBA.FACBUGBB..LCEEGAGGdAACMIEGKDDBCFFHeHAAhAAAZAEF..QGGGhACAIGHHOEBBhABAAAIB.TDCFSDAGEAFE....hADA......hAGA...,1,-11,-27,16
PJINCWfKGHAXQLUbcREeZMdDSBVgOFTYa,XDCHQDCHUBAFRGACZEGH..dHEBBBFAOAFCFACB...aEABhAAAIBAH.CFADKGFFhAAAAGGCbFAD..EBDCDCEEhABA.SCHB.gEGEhACA......hADA...,1,-27,-33,6
HPaFecOIWZDfgQAJERLXNVGTYMCUBdSKb,JDCHEDBDLAFD..XGFBGGEFTEGCMBFCBFAEKBGGHAAEhAAAFCAH.eDCGICGGhAAADACEfHAHhAHA.AGEE.RABENDICCHDD.dEFH.SDDBhABA.PHAA..hADA...,2,-33,4,37
gDLaKfBZHXcIOCSJYRbVEdTePWAGUNQFM,UAGHFGFCMFEFLCAH.KEEGZCDGHCCCXCAFOHAE.CEHE.SGADhAAA.RCGFEADEhABAeAAG.AHHDNGEHDAFEBFCGhACAJFCB...........hACA......hAIA...,1,-26,-28,2
VfMHXCgDaPZKBcFAeSLTJGWdYEQNbROIU,SGDBLFCAJAFHdCFH..EGAGQDDDRABD.UFGAMIDEhAAAXBAHDBAFZDAEKAHFhABABAHDADHC.TACA.hADAYFAD.bFBHIFHA.fEDFhAEACAEB.aGEEhAGA...,1,-8,-32,24
NXBIgPYceUOMbFSTZRJGELADfQVdHCWKa,DAFBVEFHCFDE...KCCF..aACBBABE....IHGDhAAAPBFHeHDGMICESDBAhABAZFABJAAF.EDHHAAEDQAGEhADAHGAE.NDIE.XFGE.hAFAgCFA.hAGAUAGFFEDF,2,-34,-19,15
IfCAbBOcaeFULJZGWSYdNRHXTMPKQgEVD,BAFBaDCD.eDECFDGEUACGLAAD.GCBESAFFdFFFRGCG.HEEDhAAAMIFAKAGA.EGCFDIAAhACA.CBBFAAHE..cGGEhABAZBFA...NBBC........hADA......hAEA...,1,-19,-22,3
PEXKHaZfQNbMICAgSBcWeLROFUJYdTGDV,BFEDeGEARCCDOACB.FHAAUBGB.JAEFdDEFGCACDAFE..EGGBhAAAKAAGZECF..QGABhAAAMIDG.CEFASHDGhACALBFAYFFC...TEAFhABA....hADA...,2,-33,-21,12
bdCTaSVXDeNJLfMBcOUAKEgPQIFZGWYRH,KAFBEHBG.QFABFDAHGEFARBAC.HCDG.CEHD.TGFC.SDFAhAAADDCHeABH.NDIE.LGAEhAAABCED..ODBChABAAIHA.IAHD.WFCH..hACA......hADA...,2,-26,-23,3
WUFBIfSAVLDRQbdKPJgcGZECNHTOXaMeY,LAGHDEFARBFE.dGFFJBABGEBD.CCAA.HEDHOFAHMHACeACChAAAUFGHBCCC.SGBHhABAAAFHQCCB.hACAKAGCgBEHEABETEACaHEC...FEGEhAIA......hBAA...,1,-12,-21,9
VSAYgDWKcZaLQdMUCPfeNHbFXTREOGJBI,DACBKHBGZAFBQFFGdGEE.UAEGCCDD..eBHBHDCB.FHBARBABGEADhAAABDBB..IHHHhAAAAEEE..gGGEhABAWBGB.....aAEFMAIBfDGAhACA...hABA.NDAE..,2,-34,-23,11
TbLKceOXPRDIGaAZYCSdFBHgUQJWNfMVE,CFDDFDABBCDEHDCA.UGFFQDAG..NACH.MAGF.EACFLBFAhAAA.eDHDhABAXEFF.DIGEIBCFhAHAAHFE.YHBAdBHGJHAEfAAFhAAA....hAEA...,2,-39,-23,16
ecJRHZGEDOXUKdWYIfFPLMBVAaQgCNbTS,QGBCCFDG..bAEBSHFG.eBDHJABCRAGFZAFDDHFGhAAAXEFFUEFGdGBGWBAAhAAA...IGHGhABAFDCAMEIHAFCAaDAG.......hAIA......hBAA...,1,-14,-36,22
FTHbRNYADgXVWfGPcaMIeZSBLOCKQUEdJ,DAFBVEFHGGAF..aGBGeCEDBDEGLAACKACG.QFGBhAEAdAGEFCHDHCAA..hAAA.NIBB.gAGHhAGA.XBBGfCEBcEBG.IFDChBCAZEAECAEE.EHFE.hABA...,1,-4,-22,18
XORHJUINMCgcPZVYSEDaWKeGQLfdBFbTA,OADGRDBGUGDA...MAAHCFBD.....gCBEPEFAZBBChAAASCFF.hABADGBBaGGDKEFHeAEELHDGhABAdCFBBHAB........hACA......hADA...,2,-35,-31,4
OSGLfPKCNMTeDBUJAbYZgHIcaERQWdVXF,ZAADHAADaDCAQDDH.dADBXFDBFAGFSEBBLDGBhAAAKEGBNCIE.eHDADHACBAEDhADAAHID...gAGFhAFAEGDAWCCC.........hAAA......hACA...,2,-27,-18,9
fJZFRIMVOAKHeLbECWaTcSNBXgDdGUPQY,KDBDLFFCCHAE.aFAH..TDGH..NIAFBFCCDAFCGFEFhAAAUCCF.QACGhABA.JFBEFADERCDEMAIFhAEAACHGeBAB.bGDAEHCESDGE...hBAA......hBBA...,1,-18,-28,10
JRcDgYUMZSGHaIXOfEAKFLNPBbTdVeCQW,KEEDLCCHBCBAdDFBCBHG..JFFEDAEE..UBAAZGCAHACA..hAAAIHDDXFGBEAEDhAAAFBGG....PGAAhABA..........hACA......hADA...,1,-44,-45,1
dWCeZVFHbgAMDBQXUcYPRNOaJIfEKSLTG,DFGAXABHUBAE.......YEHFRAFAaGEE...fFCBhAAASGACLAEEhABAdDEDCECA.eHCAhADAFHCC.HCDBABEFBCCEcBFH.NBIC....hAAA......hABA...,2,-47,-6,41
GZRVgFeIWafTMbBDOLXHKPcCSAYNdUJQE,dHBHUDCHEBEDRACH..FGGHeBGH...IDDDaBEE..MDHBhAAADFHHOEFBLBAHXABGhAAAKGAF.CEHBACAFNIBFGFBFhABA..gFAC.fAEBhACABCHB..hADA...,2,-37,-22,15
DEHbTJZWRgMdONUCKLfPAGYIeQXVaBScF,GAFEeGEAQAFBaDCDBFED.FEAEDBCDHCGB.JABDZBAH.RFADdHFBhAAAUCDECAEB.KFDDLDHBhABAAAAC..IGADhADASAHB.EADB.......hAEA......hAGA...,1,-16,-21,5
gWcOIUNHaDGXPCdZfSFRKeALVBMbYTQEJ,LFCAVFBH.MHDG..TEFHQCBHJDDG...WCAFhAAAIBEGHFABDAGAhABAXBAGdGGESCEEhACAKDAGADCABHEGYABG.cDFCUAGBNAAFhAFA.aGHB....hAHA...,1,1,-27,28
RKZbQPDdOISVMHACNfWTBEJLYcXGegUFa,CFDG..fFAFBEFEEGGB.LDHH.XCCFGAAFeAEGhAAAUFEDFAACKBHHbGAGDICA.hACA.IHHG.hABAMHAANEIATDADJADEcDABRCDA....hADA......hAHA...,1,-17,-20,3
JHZLfRUTVWbKaQNFIgOPEDecAdGBMYSCX,dGACBBFDMCAHCBBCHDACLFEGUACC...TGCF..VDGFhAAAKAAHaEBFQGBEhABA.FDDAgBDFhAAAOFFBDGAHeBHDAFAC.YHEG.SDFBhACA...hAFA...,1,-11,-27,16
QLBacCGDAIPESOeXNJdKZRbgWHMfVUTFY,EHBGOFFB..XFGDJACGZFCB..RBAD...bBEDHBFF.MCCGhAAAUAGCFBHFLDADhAAABGHF.aDDBCEHFAFBDSBAGhABA.eHDG......hACA......hADA...,1,-20,-31,11
McSXdTECZaQIHGWVFbOeYRABDKPJNLUgf,BFEADGHHKACGJBADLGCG..UEBHMEFE..XABBhAAAdAACECDFZAGD..aHEA.hACAHAFB..WFAHhAEAFCDFOCHDeDCDAFFG.PHBE...fEFBhAEASAFFCAHC.hAFA...,2,-34,-28,6
YJVOHSIBLaAgbKDCcREfeGXMTZUQNFWPd,KHBGDAEDRAGBeBCHGABC..TCFGZEFCQGAEFGGB.dFDAJEDChAAA.OCADSGGGhAAABAHHAFCCCBAC..ECFBMFIHhABA...NGBH.PDAH....hABA......hADA...,2,-30,-19,11
TgeIQcbLONHWJXYUASBaFCVGDfPdMZERK,SEHBBEFACEDGGGBBDAFE..dBAHZBAFKGCA..eAHFQGGGhAAALACCODEGHCDAXFGEhAAAAEAC.aHFEhABAfFBF.MICG.EBFG..hABA......hACA...,2,-35,-14,21
aITfbQOPHUeYVNDAFJLMSWcZCRBKgGXdE,JFFBSFAGZDBF.BAHDKBFDGACCdACGECHF.....IFAAhAAAbAEF..OBAHhAAAHEDDeCHFVFFBDHCEhABAAAEHFHGEMDDBCBAG.........hABA......hACA...,2,-26,-21,5
NfOcYIMLVdQgbBAHRJGXZaKeSDWFCUTEP,HDBGRFBHGACGaDGGeAAGDEBF..CAGG.EFAH.....NIEHOAEHhACAIBAALFFAhADAQGFGBHAAJEFGKHCCSDFChAAAFAFF........hABA......hACA...,1,-5,-39,34
dfXCYUDZFcKGWaReTgMAVNIEHLOBJSPQb,VAADEHBGHBCE.LCGBOAFBBDGH..JFBAQFFChAAAdDEFCGGBDACEFAGGKHCGaDCHeBAHhAAAMAIBAFID..SFFDhABAbEDF..fGAB..hACA......hADA...,2,-30,-16,14
AgdNBOaITWKMHRcXDPJeSQYCVbZLEGfUF,dHBHBAFBOCDAaECA....TEABKFEHMBBFHDGFRAGB.DHCCeDBHhAAAQBBF.CHHGZFDAhAAAEGGEGDEFFBHFAIAE.hABAIADE..WAED....hACA......hADA...,2,-23,-21,2
FWfVXPTdIZSbgBROHUJCMcLaDKYQNEeGA,FHBGVAAD..TDGEdFBBZFFD..SGGEBHECRDEFHAEGCCCGMECChAAALAHBDCBH.KCDDQAGHhABA.EAEDhACAAAEE.XGFCIHCFOFAE...hAAA......hACA...,1,-13,-24,11
cGDFPaKLbIVdTWBUOCNeJHQRAfSEXYgMZ,SAFBXGBC.MCDHZFEADHEG.FCCDKGEGLBEH..hAAAbAAFdCGEBEGB.CHCCJBEHhADAQABGAFFC.hAEAfAHG.EDAFYFBD.hADAcGGA.PAHBhAIA..,2,-31,-29,2
cOSMIWBdfHRVaPUZNgKYCFbXDGJQLAEeT,EGDDeDAC.OEFAMCEEBAHBdFBDHGFGRAAF.aAFHZDFG.KEBBFBHFDHGAJBBEhAAALADA.ADEG.hAAASEEG.hACAfGDA.......hAEA......hAFA...,2,-38,-16,22
RbeHaEJKUNBZDgCGSPfFcTMOXVAYQILdW,QCBCdDCDRAEAHDFFEFEBKFBABAFH.DACACDHGGAAE.SFADhAAAPEFA..FFFHhAAAMFDDOFAHAIACIHGEhACALBDB.bBFE.aHDC.....hADA......hAEA...,2,-22,-19,3
ecdYGbaTAOEXgfHBJPCLKVMUQFINZWSDR,EAADXCBCHFCDBBEB.CACC.KADD.UCGAQDDEFFHFZFDADAFGhAAAREAH...dHBBYFGDhABA..aCECACHGOAFGhAEAfEAE.......hBDA......hBHA...,1,-25,-34,9
cbVZUaMdRYQSfeOKXGgCLFIJBENTWDHPA,VAADaDAF..RABF.QAFBeDGH.KGEAXAFG.GEBEhAAALEFA.IFCChAAABAHBEGHBTCDFhACADEEBADDCbFEDMIDG.dGACfGAGCHHHJBHB..hABA......hADA...,1,-9,-20,11
JFAGRQXMBLHNIeZCfWVESaOTDcbUgKYdP,RCDFXGFBBFFCLABEHDBG..eHCACBHB.VCFEaGBC..DDIBbGAChAAA..KCBGdBCBFCGHADABMFEEhABA.ZAFEEAFC.hACASHFG.....cFCAhAAA.....hADA...,2,-38,-3,35
PeJgKUMDYWLRbTNXHSaQABZGFIOEdfCcV,BBGFGBCHOACFEGADCBAH.....PHFEeHEEKEFE.MAIBhAAADFDFLAAF.hABAbFAFNFADXGBFhACA.SADCADECIFFAdFFDfAEEhACA.cEGF.hAGA...,2,-34,-20,14
gdRfZEDcTPGBbFSQOLaeKXJUIWYHMCNAV,VDAGdCFCZFFB.DCAF..TFCBBHBHFGDHOFFE..LABHhAAAKHEEJAHF...UBGEhADAIAFHHEABCHHHNBAD.AAFC.hAEA.RECE.ECCE.........hAHA......hAIA...,2,-30,-23,7
RNLMSFJYgTCOBfPQdWZcXHeIAVKDaUEGb,KGGEUCBFECAERFAHLHFA..SEGGFAAB.JEBHTCEGhACAOHCCBGCA.QAEDhADAZDDBXFEHhAAAIGGGAHAFaAGHNADAMAIFCABC.dEGB....hAEA......hAGA...,2,-24,-21,3
gNceAbQYZWXSaOPIRUDMLTfCFEGdHBJVK,QCBCZAADSDCAODEFREFB..DCIHMIFALGAECGHC.EBEChAAAHGCEBHBDKCGF..hAAA.NBDDAFCE..WEBGhADA.aACEUGAA........hABA.fEGHhACAdFHA...,2,-28,-22,6
IaeJKUNfFALEWRPYTVGQbHBODMdcXZCSg,EDCDRAAD..TADEQBGEBGAG.MICCdDFEZCGFCFAH..SBCGhAAAIHHD.JGFEUGBEhAAA.FDCEAABELEFChADA.PAEGYFEFbDDF.DGGA...hAIA......hBAA...,1,-15,-21,6
eOLAQdFcSgbBMKZEfRJDVGNHIWUYaPTXC,dFHAFAFB.SECDBEDAKEHDZCDCRAEF..DHDCGDAEHAACUEEE.hAAA..aHBCXFEHhABACCDGLAGBADHEQGCAhACA...bABAEEAB..fAHEhADA....hAIA...,1,-18,-29,11
VedTRXEDOCbYcUPgWaSGHNFIAJQfZBKML,JDACZEFHBBCALGDGeHBC..dBBB.RAEC.DBHF.CBEE...bEFAUDAHhAAA.....hAAAPDDFaCGFHFAB.hABAIHHGAIGGKFAAMEIBXECAEABF...hADA......hAEA...,1,-18,-38,20
QfOaBELGZTbUPWKSVeRADgcdHMJXFCNYI,DACBdHBHMFEDFGHB..CFEA...IDBGOCDDBFBFLBFEZAFF.hAAATACG.UFGGhAAAKDAESHAChABAeDEBAGCFHCFE.XEAC..NICH.fBAChABA....hACA...,2,-51,-10,41
bHRKBeLZGFOdfMTEUQNCIYDWJAcPXVagS,XCBCVDAG..SDHDRCFDKAGC.BBGHeEHHZACHODEHhAAAMFGD.UFBE.CHFGDICEhABAAABBaFEHHABELGAChAAA.FDFBfAEBEAFFNAIE.....hAEA......hAFA...,1,-13,-20,7
eKSHfGbCZEdLOTcNPFWMUBQXDVYRgJAaI,eCCHKEHBHGFAGBECCBHCZDADdAAE.OFHF..TAAC..hAAANHAFFBGAMHACBDAEXGDFhACADIEE.RDEAAECAIEGHhACASAEDEFAE........hADA......hAFA...,1,-22,-23,1
AePYMaJUdTBWgOcRLZKEGHSXbCDfINQFV,eGEAMCCAUDBAdAHABCAH..OBGBREAFZFCBKCDFEFHF..HAAE.hAAAXEDBCEGCDABE.IHEAhAAA.FHBEVAEChAEAAFGE.aEEF..WAEE.....hBAA......hBBA...,2,-33,-16,17
XaecSbHdIWMLQOVDCFNAPTYGUKRZfBEgJ,TCBCUAGHKEEH.ZGFEEBFD....JADBeAFG.SBAChAAAdHCF.IEEAhABALBBHVGFECDGFACAD.PDHDhACARFAFBDECaEBC........cEGBhAAAWHAGMAEB.hABADDAD..,1,0,-42,42
OZDfbYIUPcKCVMWJTBFdgaRSHEGLeXQNA,ZAADDACB.....fGEEIGFHUBGGKDDB..CCCGMAFBhAAATGCEBBGE.FGGCaHFEhAAAREBH.HEAE.EBDEeDHBhADAXCDCAIAA.bEFA.....cGAChABAWEAF....hADA...,2,-30,-29,1
afPFBdYGAISECcRVKTXNUDMHLOJeZbWQg,SAFBCFEDRBFA.KEBGXECB.UAADMHFG.LBAFhAAAeFFHZGAAbEFE.QBDDhABAaEHFFFAA.YEDBhACAICDH.EADEcCGB...NIAF.hADADIAE.....hAEA...,2,-22,-22,0
OSQLYWXJPZcGagNCFbIeAERUBDKVTHMdf,UCCBBFEAKCAAHEFBdBFCSAGALEDF...XGAEJCHBZAAE.hAAA.GEAENABA.FGGGhABAIDHG.EADChAAADAHBMIFG.OFCG.WCADaCCACEFBAFHC.hACA......hADA...,1,-19,-28,9
fXKeQYcgBaGNTIAPbWMRLVdSOEJCDFUZH,...PFBBbFACRDEDLHDEdACG.EDAEDEGB.FAEFHAECKGDDQDBAhAAA..hABAcACBaAHD.NCHAADDEMEIDhAGA...........hAAA.SHAAhABACHHDfDEG.,1,-10,-39,29
QcBUbWREXKaJegPMLYSFADfHOIGZdCVTN,HFDGGECFZDDGCGHG.VEAHQACG.UAGGRAEFKHCE.eHFCMEAEhAAASBCHDDIH.hABAOAHFIHFENAAHBBBChAGAEFADXGBD......hAEA......hAFA...,1,-8,-26,18
dAVRDCbacYXIBGQeZfgJWMLOUEFKTNPHS,DDGBaEGD...XAFCGCEAZGAE.JCBCMAACLADGODCCFGHDhAAAKGHF...TFDDhAEANFAD.SHDGhAGAdCGBAACBCHDA.bBBE.ICHGeBAD...fHAFhAHA..hAIA...,2,-35,-15,20
cFLDPTBKHJWARUdCYXNIOeSbgMVZfEaQG,dDAFXGGGOBHF..SDCDMFBCZFFD.EAHDQGCBhAAAGEAAFEFCDFAHBDECKACD.JADBhAAAAABFUBEGCCAF..IHCHhABAbEEB.fABF.cDGAhAFA.....hADA...,2,-25,-13,12
XBdCMKZaFGcTNWHbOVJSRfYDQeAEgULIP,UGBCLGEA.XBADdCBFCGGHKBFD..aGBAGEDB..NBFCHACFhAAAODAE..SAHHhABA.YAEChACADFAFAIHEIDHABEBB.FACGWDFH.hAAA......hABA...,2,-44,-13,31
eafMETIcSABQdRKYGUCWOZLgXbNPHFJDV,BFCFRBCFKEHHGAAEUCAC..OHBEZFDHLBGD..XFEAhAAA..bGAGHADChABAFGFGDIBAaBHFEABAIFBEhAAASEDE.AIHG....YEHBhAEAWAFE....hAGA...,2,-36,-22,14
TZKXeNHBWgRaMYSOGVLdQcEFUJDfCAPbI,..IFDGKDAFXBGEHGDCBAHERBDB.aCAHMFEA...SABGhAAAVAFDQCCBhAAAEHGCJFBC.DFFEABGCTGAFhACANBAF..gFAC...hADA......hAEA...,1,-15,-31,16
RAaGLCJgBHNFdETcXWZMDVKbIYPQfSeOU,aHAECDHBBAAFHFED.dBGEEGGE....TAADXFEBMBDFDAGAKDADhAAA....ICCGhACAYDHB.PFBGhACAfGCH.eADG.....hADA......hAEA...,1,-22,-49,27
HdKLReWIUAVaPSMNZQEcCTbfFJGXODBYg,VDAGaAFB..MDAFZFDG..QAGAEAAACDDE...TGAEhAAAFFFEXGECBEHGgADGhABAKGBCLCBDeACDhAEAWDFGAGHASDFF.....hAAA......hADA...,1,-7,-36,29
XEUfYNFITbDdZSLQKCBeAMPHWOaVgJGcR,MECGHAADaFEA..VAFEJDCAGEAG.RAFB.UBCC.NAAD.TGEEhAAADIFG.dDHASCGAhAFAKFDDCAEFACAF.OEHFhAIA...XFCE.EFFEfHGFhACA.IAHGhADA.,2,-27,-21,6
gcKHQUINObRVMJXfFLCGPSAWZDTBaedYE,DHCETGAFBFBB.dAHGEFFB..KEEFUCFC.OFBGRAAC.VABEhAAAMAEB....fHDFhABACGGGSDGDhAAAAAFHaEAGeCCB.......YFAFhABAcAGFIDDFhAEA..,2,-54,-15,39
RbBYcaCDWPUFEGdOQTAXIHMSfNZLKeVgJ,HEFHMHFG.SFBEZCCCLFBFKHBEeBBBJAEE.BDEA.aBEBCFFDDCGChAAAUAFEFCAH.dECAOBAHhAAA.AHHEIHEBhABAfABC...NEEE......hACA......hADA...,1,-22,-33,11
QYVCFKPWLZMNGTDdJXOHUfBcgISbaAeRE,eDCHQCCBCFAE.FABEKEHDLGFEZBAFGAEFDEGAdAHA.JEABHGDEhAAA.BHHG.IEEAhABAaGDFAFDCEAEDPHAChACAMBAD....TGBAOCCA...hAAA......hABA...,1,-14,-24,10
JHDSZcUdVgabEMFPRfXNYQATOIKBeLGWC,TDACKDCDBDGB.LFEGGGABCAACHBDGDIGAZCDDdBAD...aFFDEAGAhAAA.MDBDFAFE...hACAPHCEXBBA.hABANAIEAEGCIHHD.......hADA......hAEA...,2,-26,-23,3
OaTZIJYVfXHRNQeLGDAEPdCbMcKgFWUBS,EAFBCFED..MBFHKBCCFGAEBDHD..OBBHZGAA..JBAH..fDEAhAAAHCCFQGFAhAAAeHEEDDAFACGDdAEBbFCH.hABA.....cEGH...WAGHhACA.....hABA...,1,-23,-37,14
cUQgLDYEVAbSIeHONdFCMTGaXRZPWKJfB,SHBGeFBBOCBCdEGDFBEE..CCEGMCAAGGDB.RDFBZAAAKAFGBHGHhAAA.UEABLAHBhABADGDG.EGABAFEA.bDAC.hABA.ICHD.......hACA.NEIE.....hADA...,2,-43,-6,37
WdPFYUSQeGgDAVcbfJMELOCXZIaRBHTKN,VAAD..bDAGMDEBEGFDLHBE.OBDDCDGCXGFBhAAAZAGHaEGHREBHHAEG.NBIA.hACAPBFB...hADA.YHAAUABHeFACDCDFAHID....hAEA......hAFA...,2,-18,-3,15
KdScGFLWQDJOPVTRBaNYCIUAbEegZHXfM,eCCHZGFGHCCCMBEDSBAAFAFD.LGBCQEFGDFGAJAGHhAAAOABF..PEAGhABARFDBBBHD.aHAACADDAFFDEFAGhAAA.fDHEdHAD......hABA......hADA...,2,-20,-17,3
RAOeWKfDYSMNUacFVCTZIQHBPXbLJGgdE,OEEGKDCDDFBF...MEAGaACB.FGBE..CFGHZAFDQADA.hAAABFGCXFCALAAFhACAJAEB.gBBBhADA.ECFAABDFfHEFNDIA...hAGA......hAHA...,1,-23,-52,29
UScNDOEKPVJAMbGfgFReWCIYQTaZXHBLd,GBGAFHBGRACD.CDAD.QAAEZBDBBHHELACFUBFC..SEGDhAAADIFAKGBH.VEBChAEAABAAMGFG..fGHAhAFAeAFH.IHEEYFAD.aFEHdEEAhAGA......hAHA...,2,-27,-22,5
aRFLHIKPJZbSQUcVNEWBDOdCfGgeXMAYT,aGFCRDEDHAFF.KHBEJBDHZBBH..QGBHUGED...VBFAhAAANCAGBHHEdBBEGEBFhABA.eEHBADID.FADAIBDBhAAASCAFEFBADAIHCGAC.....hACA......hAGA...,1,-9,-29,20
QdKANMYBWRZUXCTbcDIVgaGPOHfEJFLeS,MCCABFDGRDAAZCFBUFAB..CEDE....TGBADFEC..VBDGhAAAaEADGEGEHFGBEBAFLABGhAAA.SCAFhACAdHDHNEEF.WAFG......hADA......hAGA...,1,-27,-30,3
MZSVWPQNdBDgGLJebaUAfCEFOXcYRTHIK,EEGDFGDDOHFA..XFCCRDAFHECEKAGEMDACZACH..VAFBhAAAQBADdABBDIBGLHEAhAEAeBHH.aDEDfGBAhAAACDHH.TAEESDCA.hABAPFAH...hAEA...,1,-12,-13,1
JGaIBFUXdDOgSLPVZbCNAREcQWKHTfMeY,RDAGQGBCKDDEHFGD.MAADeHBCGCEFBAFGUACBDGHB..SAEHhABALBHFZFEFCAHGEDBAhACA...TEEFhADAfAAEaBBEIEHF.XEBAhAEA......hAGA...,2,-21,-11,10
HQIRPOeacfAEUCTBGMJWLKSNgDZbdFVYX,EFFBTABHBHDB.GEAHMEBDLEED.SFGBhAAADIBAdHFDVADEHAFGQBADhAAAPCDGaDAGAAIDCAGEWHDAhABAKDEC....NCHE........hADA......hAEA...,2,-21,-16,5
YDIaKCLbWEcMReFUNTBgPZQSAJXfGHdVO,JDACXFGHGACHdBAA..OBFEDEDGKEBHLGDC.EAACRBECFFAHhAAA.UGDBBEFDZACEhABAAHAG....fHEBhAAA.........hACA......hADA...,2,-35,-35,0
VCWOZXGIBJDEYUNHbTagPMLQdRSAecKfF,KDCDFCFCCFBCZACE.GEAGBHEF.DCHBUCCB..HGFE.aFDEMADEhAAAdAAEAADA..eBAB.hACA.fDDBhAGAOEFEIGGHEEHF..bBDEPHAA..hABA......hACA...,1,-8,-48,40
UgGQZdVcFJaBHRKWOMPXYASDLeTNEbICf,LEACeDACEAFD.CHEAUGBHQFEH.ZDEGdEEB.FABDBBHERBFE.hAAAOFCBMDAG.YAAAhACAAGAF..DGHBNEIC.hADA..IEHC..fGAAhAEA.....hABA...,2,-41,-11,30
gZRWSANIGVbLHXdPBeFEJMODUTaYfcKQC,GAFEVFDF.LECAdDBGBGAFFADG.ECCAMAEDDHFA...aGGB.hAAA.fHDDhABAQCGGCBBERDGFSABGhAAAAHAHICAFbAFE.HDCAPFBB....hACA......hAHA...,2,-19,-13,6
SPFUWNBYgbHGVXILAQaTOZMEDKeCRfcdJ,QFCAaGDDZDAF.DFGEeDGDRAAF.dACGSAEFUAFABGGG..hAAA..bCCGHCDFXCFBhAAAAHBFMCIHKAGGCAHA.fGHEhACA.cGAH.FFFH.NIDF.hADA......hAGA...,1,-17,-26,9
QBaYCETOdeFDNbcPAMGgfLIRZKSUJWXHV,GBGALGEAZCAEUCFGJCEF.HCBHBFCCaDAH..CHHC.EGAG...hAAAOEDCdFAAeACCDBEC.hAAA.NIEB.PGCC.hABAAICA.MACE.fBCBIBAF.SHAGhAGAXFGC...hABA...,2,-35,-8,27
AcWPCfRaOXZDGKdVTLSYNQbBUFIMgEeHJ,...PGEAfGFHRBFA.OABHDEFEKACBdBEELFAESBGDhAAA.QGAEhACABHDFIHAFMEACEEGGhADAeAEAAFEBCHHEXCAE......hAAA......hABA...,1,-14,-36,22
GSDIOXMRBYZFcHWdfTAKePJCULgNVEQba,eCCHJAFBLECG..gDFEEEAH.QFAChAAAaBBCDGDGOHBGMFGFYAEChABAFADFHBGB.dHDBfHFFhAAATCAGAACCCBBENEIE........hAIA......hBAA...,1,-17,-18,1
PVcMFYUHLBZIQTbXJAfdRGeSagOWKEDNC,dCFCRFBHeEGBaBAF...OCDEEGAD..CACC.VACCFFFHHFBH.BEDAhAAAQCAC.hABAXFEHfDBHhAEASAGEKHGGDEIHPAFA.MDHF.hAAA......hABA...,1,-15,-30,15
TaKEJCLVISfgXDOdFMWGAUZNeYRbcPBQH,ZEFHeGEARDBH.....PAAFHADFaBAHEEFELCCG.VECEhAAAIHAD.SBGGhAAAfGBBDDIBhABAFAEAMAFEAAHCNIBFYBHFBHDAKBBCCHFD.XFDGhACA....hADA...,2,-25,-5,20
YDegUSKMBRcWXHVNdZAabQEFGLJfTOPIC,QGBCGACBJEEH.OEHH..IDGHCCACDAHH..eAAChAAASHGABECFRBDBXGDFhAEAVBAFZBFEaFAFEEFB.hAFAFGGG....fBFEYHAG.KGADhAGAcDCG...hAIA...,2,-22,-17,5
aTdMQAceUgFfNIVPKSLXYDWZCBbJGHEOR,eDACFGFC...IFHBPGAC..LACGDECGCDHC.BDFAJGBCGADFhAAAOEAETBAAhAAAMCBE..AACGUGEEhABANICB.SAHB..XCDGhABA.WEEG.ZAGFECFAhAEA...,2,-28,-20,8
KOcWgZCRIYBXHLSFPEDaUJQGTbfMdAVNe,VFDFKDCDOEDC......cEAFZAFEIGED.hAAABGGGXBBDLAEFhAAAPAFCDIECJCHFQDFBhABA.GADEfBBBAIAGeHFCCGAGYDAHhABAFFAH.aGCHhACA...,1,-5,-40,35
HOEJGcAWIfTgdeXQZBFUYRDPCaMVNLbSK,..IFDGTGBCeDDHZFGFBBHBFAGCRABCDBEE..CCFC...MCEAhAAAVFEDLBCB.hAAAKBAGEFAFJHDEACAB...hABA..fEAAXCAD.QGAEhABA.....hACA...,2,-26,-26,0
OKCVSIBgfYeANDJcaMbQWFTEPZRUGdXLH,DEFHaDCD.QFAAFGCD..TAAFEHGARACDUAFBGEAG.LHFEhAAAHDGHKBADCEEHIAEChACAfGFC.AEBC.NAICMCEAhADA..........hAGA......hAHA...,2,-22,-21,1
GKOSJCFAUgXPRDQMYIdLZabcNfEVHWBTe,UCGCXCBCDBCE...QFFEMFACdHGFZFFEaGBE....bBGBhAAA..NADF.EACFHCDEhAAABFBGeBBDOCFHCHBEAIDG.hABA............hACA......hAIA...,2,-29,-22,7
XKVTLSJHPEZQOAWgIBRUGFdacYeCMbfDN,..IFDGBFFCGAAEdCBG.aHFAeHACMAIBDEEE.KFGBLGBChAAAHCFGZACCQDCBhACAAFIH.gBFHhADAUAGFFGFHCCDBfADFXFAC.SHAGhAGA.PDHB.hAAA...,2,-18,-1,17
QBRNXaUALJSKTHCVYbIWOcgFdGPMeZDfE,SAABHBCFCFGC..VAAF..IFAAOHEEFHBGdGDAMCIFhACAZAFGDFAAECDH.QFFHhADABGDB.XCEDhAEAAHABKADE.TGBC.WACAcDFG.hAGA......hAHA...,1,-25,-29,4
MEeVKAHNFfOZdUWbPRIQGLTXgCYDcSaJB,HDAGFHBGOACBZADGUFFE....PBGFIDFF.LAAHhACATEBD.CCHHDAHFSGEEhAAA.aADDMIFEhADAEDDB.VFCBABBFNEIEdHFDWFAF.....hABA......hADA...,1,-16,-29,13
bScATRNeJCUfGHLIgVPYdKOQBWXZFEMDa,REFHeEEGUACFGEACLHBA..IGDB..gDCDhAAAVABCdHGHQCFAhAAABAHGZDAFEGCA.MFIFhABA.DAFFaAEF.cBACAAGF.....hADA......hAIA...,2,-23,-10,13
HdEDPBAXFSRVMIZcgGfNLQWYKaUbJeCOT,FFHBRBCFMIFAZCCCGAGE.LEAGQEFFKGDE.aAEAUABFeFCEhAAA.CHDDHBADDGAABEEGhAAASHAA.cCGAhABANIEB...YDAF...hACA......hAEA...,2,-32,-2,30
TdQHFIDeWVUMYbXGJLPKBSgAaZfNOcRCE,aCFCZAADOBFF.RFFD.EAGB.dACBHEAHFEDEDIEGeACF.UDDFMAAFhABA.....XFAEhAFALHCAKCCABDHEhAAASGGCAGABfAEFNAIECDBD..IGEDhAHA....hBBA...,2,-34,-13,21
LKMZGeOUaAgCJfbIXTYNFWDHPcRQSVEBd,CAFBJGEA....IHFDXCFA....TECBFECGDEBFHBEBhAAARADH.SBBChABAEAACBEFDdHABKHBCZCGBOEHDhAAAaACA.AADF.bFFA..NIDF......hAHAcAGF...hAIA...,1,-22,-30,8
AOEVDUCcYQfSbHMaeJFLXdTBRGgWPNKIZ,ODCHVFFA.DAEAUACG..CAAD.QCFG..SEHDhABAMABFJAFAFFDDLHAEhACAdEBABDDGgGEDhADA.PBFFNIEF.IEEEACIH.hAAAEBDH.fGGEhAHA..,2,-28,-28,0
CFYNeLUTRaZSPGKcHfEJbWgBVXAOQIdMD,ODACdGFCDBBHFEGG..eBBCLACBUGEGaCHBZAECGECE.hAAAKFACfBFGhABA.EGABJCEA..gCDEhACABHHGAHAEIEECCEEGYEHB.NADF.hAIASHAA.hBAA...,1,-23,-32,9
SJZMcWTdObHXPGKNYUAfgaIRQCBDeVFLE,aHBGQFDHBEDC.DBCDFCBGLAAH.JDDAZBEF.MHFGTGAAhACAdAHCOFAE.hADA.XAEDKAAD.hABANDIAAGGAfEHGREAE..CHDAEHFA..hAEA......hAGA...,2,-38,-16,22
gdYXMHTZFOKPDRGVSNfLWEcbBQUAaCJIe,JCAFeGEA.dCABMAFEHEABZAACKAAE..RFBGGGEBVDEB..SAFAhADALCHHECECBECFhAEAAHBD...ICHAhAFAgDFAXGCDFECA.DIGA.fBDGhAGA....hAIA...,1,-16,-17,1
bGMaUFRTeWgLPJcSXBDOEAZdHKIYVCQfN,dDAFHDAGKAGDVEEC..QECE..NICFMGBCFHDAeEFAhAAALBHFJBEF.SCCEhAAABHHCDIBCOAHDhABAEABCIBFF.CHACfBAEaBBAREAB.hACA......hADA...,2,-24,-11,13
WDASBUfVYOKTbNdCMEcFIZJegPRHaLGQX,SFFBUGGG..VAFBKBGA..TBAAdGEECCAE...MAEGhAAAEECC.FDBDZFAA.JADHeDFEhABA.PFHD.hAAAaDDB.GGBFWAHHACCD.BABC.OEFEhAEA.....hACA...,1,-20,-29,9
JEAPGFgLQHbdOVaXWfTDCRKINYceSBMUZ,FGAHLDACQCGGdEFGaACB....XDCGTBGGDGHHKGGC.hAAA.IADG.hAAA.YFCBeGDGSBGEhABABAFF.MIFEJEABACEHPCAB.hABA......hAEA...,1,-18,-36,18
cgJNYaSMDfVGZPLKCQeBFRAIdXEWOUHTb,XGBCOCCHHAFC..TDAE..gGEDJAAB.hAAAaDFBMCDEDFAHfAAChAAAVGEGGCGEPDHBhACACEFGBDEFAIDAdADEEAFE.bFAD.....cGGChAFASDDD.hAGA...,1,-13,-16,3
bCfGTVSEYJPBXAMUORdcKNFgZWeHDaIQL,MIFGOADGRCCE.dFBFKGADFFEH..ZEFEHBAEDFBE.aDDALAAF.hAAA.bAGDGAFE.hABASGGGEGBH.hACAPHBCBHFAAIHGNBBF.eFFG.CDBA....hACA......hADA...,2,-24,-11,13
aDSIKTFOYEcLXNQWPVdgGRUeHbMAJfCZB,JAFBZDBHBGEH.DGGCSDCG.KGGHTAED.OAHFhAAAEBADLHCG.hABAXEGG.NAAF.hAFAWEDG.dHAB.RACBeHFAMAHHAFFB...hACA.aEAHIGDChAIA.FEBH.,2,-37,-28,9
eNEXSQbfMDcWZYKJHgaVdIPUACLGBRTOF,GACBBFFCOACBeDCCEDGC..QCFBMFAGDGCDZFEBKAAFJAFEhABAaGDB.dEAB..IGABhAAAABIFLHFGRBAEFGGGSDDBhADA.fFAA.cGCGhAEA....hAFA...,1,-9,-35,26
GIMbHLJRUNdZQDfKWegYCABOaSPFcXVET,aDABSAFB.FBCCXBAA.EFBATCGGGGBBbFGHJDEHhAAA.UGGHZEEHDEBCKAGC.hABAeAADCEGGBDCAOHBAhABAVBEEMFBA.........hACA......hADA...,2,-15,-15,0
LCUVaeWfITYObZFdMDgNcHPRAJKBXGSQE,BDGFGCEBECEBLFFCUGGG.aEBB.eGAA..IBGDhAAAOADEFGGFDEAC..NEEA.HBAChAAA.AABAXDDChADACDHAVBAG.fHEB..YFCHhABA.dHAB.MAFGhACAcAGF.,2,-25,-13,12
GDXBUSYaIMHWecTVbQECLJFKNZdfgRPAO,ODCHXCCBBEDEUDAG..SGEG..aFDFMDHBhAAAeGFCTBCCQGAFhAAAEAEECCHE.FACCZGAAfDGDhABAPBAB.AFGGDAECIFFFcBGA..hAHA......hAIA...,1,-22,-26,4
EVAJfaWdKNcTSIFPCeRHYbDgMLQZOBGXU,aDCDdAFBKHGE..TEFFFBDH..eAADHGBEDDHFMEIBLFCGhABAOBFHBBFH..UCAGhAAAAIDE.WAFE..hABASEHHCBGEbABA.ZEABEHEAfDEFhACA.....hACA...,1,-13,-33,20
PEDSYKUXOgceFVIBQfMNdCTJAGWaZLHRb,aGAHZDBGLHDCHABDREDC.ECFHDDHF..SAAFKBDGUGGA.OFCChACAeFBDFAFCBHAHQGDBhAAAMFIFCGAC.AEAD.bBBChADA....XCEE....hABA......hADA...,1,-16,-22,6
BWSdbgcNXTYHICMDGLPAKOfQVUJaReEFZ,OCCHVEFH.UGEGRCCF..eFBFFBFBBDGFdBAF....gAFFhAAAXAAFHEFGhADAMIFA.DBIHLEHBhABAABDAQGAHaCADEADCSDDBNEEE.IEAFhAEACCHA.KGHB..hAFA...,2,-31,0,31
SWDIFfedbBLYNHAUQCOVEgGRMTKcZaXJP,CCAHODCH..EHCEGEFGMBFH.KABGZCFDaBEC..JAFC..SEAHhAAADAAFFCDFdEHCLCHHhABAHDAC.AFECQGDGhADA........hAEA......hAFA...,2,-37,-28,9
ZBfKSXAGTDPdEcWOFgUJYaVRNbLeCQMIH,DDGBdAFBEECHOFDD..FHCEUADA..aBCHRABFLHFECFHC.hAAAQAGAIBADHCEAhABABDEFKFBAABDCPFFFhACA...WBHHYBAF..NDAE.hADA......hAEA...,2,-32,-29,3
XJYNBCfGDabPLQTAdVRKcHMFeSUgOIZEW,VBCFRDAGKDDEHFGD.FHBAUGFE.OAAHEAGC...JCGHBBFGhAAAGEAHDACGaDGBLGBAhABAABCH.MIBASHEAhABAIAGDXFACNAIE.CFEA...fEEBhACA..hADA...,2,-22,-22,0
MCWbVGXcIgZOQETNSJPAFHLedaYfDRKBU,FDBDeFFCdGHG..aAGEDHDCRDCF.KBGFBHGG..MDAHCBCE..VCEAhAAAGACG..IGAFhABAOCHDEFCA.SBBFhAAAAAFGHCAFfHCBUEEE...hABA......hACA...,2,-31,-24,7
CLbXRFUQMAdVONEWeGDaHgZIPKJfcSYBT,dDBDVFDFOAFA..EAFBeBHFDECBHABHZFEEKFCC..JHAASBBBhAAABGGBLDDEhAAAXGBCFAGAMBAF.hABAAFFC.NDAG.aGHD..IHHC.PBFFhACAYDAB...hADA...,2,-29,-13,16
PfIGAMaKedJLOXCRNSVgFcUHBTYZWQEDb,KHBGdGDBOEBDCEBG.RBFE.SCGD.FBBAUGGF.HCDEhAAABAEHTBAGZFDCEHGADIDEhABA....fEDBhAAAAHBHaEABeEFGLDHBNADB...cCAAhABA.QAGEhACA.,2,-41,-12,29
BDcIHYOWSeZfPUaLMbJXNdgGVARCEQTFK,EBBDQFCAFEHF.KAHFDEDCHAAF.OFECeACEZGCEUFAAMDBDhAAAJHFA.dBHGGADE.hABAAIEGCDBABHGA.IHABhAFA.SCFB....hAGA.fECEhAHA...,2,-35,-19,16
BPfAMKUcEDRGLbIFVOaeSHZNWTXgYdJQC,KAGDEGFCDHCAGAAF.LGECFGAH.aCHBHCDC.ZEAA.NADF.TCDFhAAA..XBADhAAAdEAAJFCHCDCDBACDfEFBhABAAHHCMEBC....UCGE...hADA......hAEA...,2,-25,-21,4
HMNZBWeXDJOQdfPKAaLEVGFRcTCIbgSYU,aEEDLDCHGBEDRFEECAFC....IAACSBBCHACAMEEEhAAABDHG.XGADhACADABCOCEAdGHCKEDDAHFHEHACcEAFhAEA..TEACgGEANCIE.eAFEhAIA.....hAEA...,1,7,-34,41
GOULPSaMHeVdZcgAbECNRXFYJKTDWBQIf,CFEDXFDHFAEF.KEABDGAB.BCDC..fAAGUCGH.LADHhABA.aAGCeCBBhAAAZFGFAAHCEEHBRCEFJDCFQGGHhABA.IDEAPCHDSHCGhACA..MIBAhACA.dGBF.,2,-43,-7,36
DbFPEBIdUYZLQHgcVfeCNaWTKOAJRGXMS,JEGHGBDF.MAIFDBAAFDABBHAC.UGDFLAGFHABH..VDFDhAAAeECD..CFADaEDFKEDHAHBChAAA.RBCA....SHEAhABAEHGAIEBA.YAEC.hACA......hADA...,2,-43,-5,38
fQPJNKgcBVbEUHWTSeAaYORZIXdMGFCLD,OCCHRGFGZBABdDFCFGHBLAHD..DGCHQCCBJEAB.KGAGhAAABGDD.VADBUGCGhABAHEEC..SADFhACAeAAHAHBD.aEHD.IAFFMAIFCHEA..hBAA......hBEA...,2,-31,-20,11
YWOSQTcAIXJLaHUZGMVBgfDEPNdRKCebF,XDACaAABZFFE.GGEFBEFCDBDE..PAHBdAGARBBD..KFAHCDFBeBCBhAAA..FFCBWFAHhABA..SDAFhACAQEDEAEEHLHEAMACE...fEGFhADAEBDE.NDEF.hAEA...,1,-9,-35,26
PfIeYAFSQaLgCTWbBORcXHGJUNEDdZMVK,SFAAQGGDaCBECECB....TEEBbEEG.BAFBRBFCHFBDhAAAJCAG.EDEEZGEEKABF.PADAhACAIHBE.AHADLBEAhAAA.gDGE..hABA......hACA...,2,-34,-4,30
VJCXIeRWKALFfZdQcETBMODPaYUNgHbGS,FDCDZDAGdGFDEDHF.BEGDDGFC...aADDUAEHHCFC..SFAGhAAACAAF..IEEBhACAeHCAKBBGAIBGLGAAhADA.fBBA.....hABA......hACA...,2,-48,-26,22
cZVHDebRTMIGSNYfPgWACdKLOBJaXFEQU,CEFAdEEDLDCFBADG..aEABEADE..QBFCZBEGDICERFGF.MBIFhAAAGAAE..NIAB.fDEAhAAA..hACAWHFEAEHGOGACFCBA.......hABA......hACA...,1,-19,-44,25
WENKJbMXcPTgGBIefRDdLZCAUHSQYFaOV,SDAFFGFCOFCD.EBCCKCFB...MDEFPBED..GEAEhAAAeAGDRGEELCAEhABACEFAHFAGaAHFNAIG..XAFAhACATAADBDHADFIFACEA.......hADA......hAEA...,1,-8,-26,18
MHOfBQYgFUKJZSAEILaXVGNDPcTReCWbd,LCCHVBCF.DICE..TEEFRAAFCEFG.dGDAMFIHOFHH.BFBFhAAAQCGCFAFDKBAF.hABASFBDADHG.hACAEAHBIHABaFCEXADE.GGDFhAAA......hACA...,1,-21,-29,8
gcUMICRYPeHEdWGFADbaBTfVXLSZNQKOJ,DGHHBFED..VCAGXCBHLAAGZGBCKDFH..JHDEUADEMAHFhABARAAF....eBFEhAAAEDFEdAECFGHB.AGBATEEEhACASHAG..NAIE......gGBAhAGACDDB..hBFA...,1,-26,-29,3
IVEdKaJTfPGbSAMNLCRHOgUZQcWeYDBFX,LCHDRCDHOCGDZBAHQCBA.eAAHBFBEFFDGXGCEhAAA.EAEBdAEF.KGEGaAFFhABATBEE.fGGBhAAA.PHAESBHBADDGMIEECFFDgGFAhACA.hACAWHAGDEEE,1,-17,-40,23
eYJTWdERIfONMKHbFACcXULSaGDgVBQPZ,XGGGUGGDLBGHGCAGDAADBGDCZAED.eDFG..JCCBdDDGRBAF.hABAIAHC.OADChAAAKFECFHAAACCCSHCGhABAaGDF.........hACA......hADA...,1,-20,-35,15
ZadJTGfQKNMDVXCUSHWBgYcLORIAEFPeb,EAFBeCCHZDDCdHGBGEAFQGCHKHGA.MBCADEHB..CAHD.UDFGHAAChAAABFAD..gGDEhABALAAFIHAAhACAACHB..........hADA......hAEA...,1,-24,-30,6
WZEKBabTPOUXfJLVcIeFGQNCAgSHMdDYR,SCFCdAABREFHZFBDBHDF..TCAEUAFG.XFBALBHHVABChAAA..eCEDQEFChABACBDCHDAEDGIBEHAAbAFAhAEA.OEEB.fGHG.hADA......hAEA...,1,5,-26,31
FcBJbOLWVNDSHMfXgPadUCAIQTeEZKYRG,QCGCTGGD.EFDDZACG.REACFCDBBAFE.OEABLEFGVBBDhAAADBHBHFBFMAACXEFChABAaGBE.dGGHAEACIHEHhAEAKBEB.........hACA......hADA...,1,-11,-23,12
eaYKICDfQPdHAbFWXVJcGRSLEgBTMZOUN,FHBGVEFHGAFA.RDGFLFBAECBEBABDMBEAUAAB...aGCAKADChABA.DIGEQCEFhAAAHBCBAIDA.XDAChACASGGA..........hAHA......hAIA...,1,-18,-28,10
bLeFRUcSCVTYXZaMNOKJfHEdAIWPDBGQg,..IFDGPFCHDABDBCDA.GCFG.QAACbBGBLBEBhAAAFAHBREAFUDBH.CGAETGGGhACAXAEFaGDDMHDGhACAKFFC.fHGFdCCBAAHC.eDBG..hADA......hBAA...,2,-14,-9,5
KTSOdZXfceJGDNaYBUHLQMbFVgARWPCIE,RAADCFDGKBFHOAEG.ZCEA..XADB..fGEEhAAAJGAAGAAEDGCH..aDEBBEBAhACAUFFCLFGHhADA.MCDD.........hAAA......hACA...,1,-31,-46,15
IEaHPGTWdOcFYXMRDVLegUKbAfQSNJCZB,SGFCJAFBBDGF.EHFAHBAE.GECFTCDHOHCC.FHGAhAAAYEFA.RCBBDACChAAAeFAHKGCBACEHfADFhABAQGAECBEBaEHD.....dDADXAGBhABA...hACA...,1,-11,-19,8
FSaEJHWBTXKfACROIYVZQPLeDNUbdgcMG,CEFARFDFODAD..ICBHZCGBLACHDGCH.UCEDdDDEMCADhAAAFHGA..EAAEHBEHBAHGhAEATGDDKAEA.AIFEQBGChABA.PFAD...NDIA.hACAcGACSABAhAEA.aGHH.,1,-25,-26,1
IEGfAcebCNdaXgKPSTVWQJYLRMOBZUHDF,eGEACFDGdCAB...aCEGKABA..SGBB..VGEEQDBFhAAALFAFMADChABA.BDFCZCFGDEAGFDHFEEFFhACAAGBA.bAEA.........hAAA......hABA...,1,-12,-51,39
MRJWQABELaPHfcUFCGOeDIVXTNSbdgYZK,LCAFaCFCHFBBUGEBGDBH.eHDEDBID.XDGESACHdFFFZABAhAAAMFFG...RAEEQDDChAAABAGEfGGEhACACBAEIEAGTFBC.NIAF.....hADA......hAEA...,1,-7,-13,6
HMGXQKcUPfOBTNVeAZFJRIbWSCgLDYdEa,ZDEDFDBDRAAC..IHEA..SEDFCCACDECG.EAFAMFAAhAAAQGDEKAHF.PFFGhAAAfCBCBCHDTBDChABAeGAAADID.WDADgGGC.dAEEhABAaGHDXABA.hADA...,1,-22,-28,6
MRVXWZAdSHENLfBYagQeDUPJFCKTbcIOG,dEHASEHBEGABLDBHBEGG...aDECeCBEDGFF.UAGB.JEADhAAACCHBKAFE..TFCBhABAIFDFMIDGXABAhAAAAHIB..fHAHgBEDFADGcGGChABAOCFE...hACA...,2,-37,-21,16
JICFLWTcKdBgPQNOSXeRHUZEMYaDfGVbA,JAFBFEGDLAFC..TCBAKCCCdCAEBBHFQCFGOGFEeADDhAAAREAAHFDHZFAGEABCaEEFhABADFIH....fEGChACA........hAEA......hAFA...,2,-34,-21,13
EfZLIJegQCFPOBbcaVKGdXHWMTNDUAYSR,SCFCRDAGZFBGLCCGeEFA..QGFDFGDEBEDA.aACEKGABdAGFhAAAXBAFMEEEDICAAAEEEHGGhAAA..IBAFhABACADDODCB...cAGA....hABA......hACA...,2,-33,-15,18
TPARYbeHEXVQcBDdSUOKIaZFJgfNLWCMG,RAADeGEAEHAC.QAFBBBED.dDFAOFHDKDBCZBBCFFEB..fHCBhAAALEAEMDHDhAAAGEAEABGC...YHFGhABAbACF..XGCDDCAHSEEFhACAaBGE......hADA...,2,-20,-12,8
FZMTafEHGdeCgAQBRUPNJcOKLSXVDYIbW,QGDCBFFCRAECUGCDJDCD..KHGELBAC.SGGEhAAADBBC..bDGHFAFDZCAAhAAAaAHFHEAEdEFHCEACAABE..hABA....NAIA....XCEAhADAIHBG.....hAEA...,1,-22,-29,7
JecWBgTKGEbVMIPFZaRODHSCdNAQUXYfL,XCCBLGEAJCAF..eHEABBBAKGDAEDEAMFEE..FDHDaAGFhAAADGIFCGBA...AGBDQAGFhAAAfDGDgCAEhABAGDCE.bBEF...IFAAhACA.....hABA...,1,-12,-38,26
caQCeZUPIHXdfSNEDbFBMAOVLgYTJKWGR,LFFCTCBC.JBCAKAAFGDAHRAEG..aDGFeHEEZEDC.UAGEHEABhABAdAAESHGAhACADDFAFGBHBAFDAGHDOHCA.hACA............hADA......hAEA...,2,-26,-16,10
SeaDfKUTOWIGLBRAFdJPCXcHQEbgMNYVZ,FEEDJCCH.CGCE.HGDG.QAGBEAAC.MCFDVACC.ZAFFeEABhAAADEIH.KACH.UEGAOGFChAAA..ICAEhABABHBDdAHE...PCCB....hBHA......hCAA...,2,-35,-17,18
PUdVLJDMYOFbEScaCZXeBgfITAGKHQWNR,KCAHQFDHREDC.dAEDJHFEMIBE.OBGDEHAE...SDBAhAAACHECeCFGBFBDgGGEhABA.ICBEhACAADCAHAACNAEF..PFAG....hADA......hAFA...,2,-40,-25,15
ZNHFMLAeEKICJaYORfXBSVDTUQdWcGPbg,eEGHEAFBKBCCCDDG....JCEGOEGB.REAEBBACSDAA.hAAADIEETGAHdBBBGFBDhAAA..gGDEhABANDIEFAGA.MCIBAAFD.......hABA.IEFAfCAFhACA.VCDE,2,-37,-17,20
LKgUWYNdOGAaPfCTeXIRJQBbZVMcEFDHS,aHBGCFDG..eBADRCCCBDGBZFGH..MAFCFCAHDBBELHDA.UBCEhAAA....YFFGhAAAdBFDABBB..fGBAhABAIFCGJAFEQEAB...hABA......hACA...,2,-52,-19,33
PecRXGQYWaBELACVdgJfNUbOFIZSKMDHT,dBBDJGEA.UBGCFCDB.ZGFA..MAAEDIECHFBA..TCGFeDACRCEBhAAAQGAE.hABAaAFELHAG.hAEACECBfEHAOBBHKGCHPEEC..hAFA......hAGA...,1,-16,-31,15
ORMGPbcWVYSQKEXUTNADBHJCafFgZdeIL,DFCFBEFACHDH.FEABZBGFdDHA.LHBERADB.GBCE..PABFhAAA....cBADhAAAVFFC..SDDGhABA.EGAFTGGGAFDA.aCFG.eEEDhABAMIFA.WDAF.hACA.KFBA.,2,-34,-29,5
aFXcKJZIADLCOTEMBVYNQPGebgRdHWUfS,CGHDTAADBEDC.....VADCQBGFeGEGRDGF.dGAAHDADUDGBhAAASHCGaDCB.hABAXDDCKBDEZFDBADAHOAHFhAAAMCBF..NACF........hACA......hADA...,2,-28,-10,18
PNdULMaZYQcGRBWJObeIgKFTCfSVAEHXD,XCCBDACBdGHALDBAZAAD..QGCHRBFEBAFC.OCEDhAAAeEABKGFATBGG.CDBASEGGhADAAGDEEDFD.hAAANAEB.aHAC..cFBBJADBIBAFFGHH.hBAA......hBCA...,1,-14,-28,14
eDTgcYPWfLRVGQAbZOJMUNBSEHFaXdCIK,ZFDFMBEAUCGHBFFBHACGFDFE.dGBA..CAAC.KBBFDACB....TFFFhAAA..YBBFhADAPCED..LFHBhABARFDHQFAFADCH.OHFESDADhACAaEDB.IAGG.hAEA...,1,-12,-44,32
LaeZDPUIVBMXFCbSdWHTNGQKRfOJAEYcg,EHBG..gCBCeACEDDCDUFEDBFHBMAGHFFHD...CGGBdFAFhAAATDEFQGEChABA.KEDAfAGChAAAADECLBBCZBACIHAGXCGASADEhACA.....hABA...,2,-29,-14,15
RINgVPMdfEGBTXLAHDQKbOCUWaeYFcJSZ,HFEEKDABCEHA.aFBA.FBDE..JFFDZAAE.RCAG.....IDGDhAAANEAC...PAHFhABAMCIFfDEBhAAA.BBHFTGCBACGDQGBGOCCDeBCEhACASGHH.hADA...,1,-10,-49,39
RLcXUZfICMNSEgbBKGPWdYDQaVJAFOeHT,OFFBHAEGTDCDLACHUDGCZFAB.CEDE.MGEG.EAACBAACGEAGhAAAdGCFDICAaCCGACHGFDHH.hADA......hAEAeAGH...cAEGfGHASHGAhAEA.KCEB.YBBDhAIA,2,-23,-19,4
cRIVQdADOJaTeFGBNWgHbPCLMUYXZfEKS,DIBGaAAB.FBFFBCBE......NEEHHFFEbAEDLHBG.hAAAMEEEUFDEZFFCKABBSEAChACAIEBFdADEhABAOADH.JAHB.eHFGWAHB....hAFA.CGAG.fGCFhAEA.REBA,2,-40,-14,26
KgYdQELSCNacGBPDMeTWJVROfIZHFAXbU,XCGCKGFCdDDFLGAC..NBBDGEDHBAACMFID.eBBHhACATGAC.JDAERADG.IHHGhAAAFCHDAGEB.gAGGhABAEHBE.aHEADDAD....OCCAhACA.....hADA...,1,-8,-32,24
UgcSWdGfJZeTVFOPLQBINDMAKYaXbHCER,KAFBXGBCCHDH.RGEE.UDGG..SDDBdAAD.JCGHeEAFhABAFEAGLAACBBCHDHGAAHBFhADAaBCC..HCDBcAGAhAEA..GEBEfFFB...hAEA......hAFA...,2,-35,-18,17
JeKNZVdgQOGaISRMHcYXWfPDCEUbTLBFA,KAABZGFGdFAFQAGDGAAA..SFFGMGFCHEBD...XADHhAAAWADF.PHEEhACACEHGEBHD.UDEFLFDBhAAAAIAENDAE.VCEC.OGACIEHE..hADA......hAFA...,2,-15,-6,9
YVIbZfdLCRMSHecKUgTWQXGDEaAJPNOFB,JGEAOGEABBAB..VBGFZAFALDAE..CEFDMACDeFCBKCEFhAAATFBB.QAEBhAAAXGADEACAaFHFAFAAhABA.FBDH..IEFDfHAB..hADA......hAFA...,2,-35,-26,9
UWRJDPfTKVAGdFcICESLMYbeaNZQgOBXH,FDAFCFDGLAFCMGCE..eDECZBEEOEFDHABARGFGDDDD..PDAGhAAAKEHBAAAF..dAGFIGBFhABA..EHCCSACFhAEAaFAH.NDHCBDEA....hBAA......hBBA...,1,-21,-34,13
OIJFNfgRHMBQYXZGcdLCVSabPUEeTWKAD,DEFHOEEGFDDB.....fFGHRGAAMEIDBDGFQAFEhAAAZABAGCAEdFAAVCBB.hAAASGDDaGGDUAFFEHEChACAeABE.KGHBACCD.NAIE.......hAEA......hAFA...,2,-23,-15,8
SJgPXAIWRGVfHYCDFLQTEZUNedMbcKOBa,RAADGEDHHDBDCEGBFCADLGFCQAGA.EAAEZBFG..UGGHNIAH.hAAAdFBAMIFGKCCDBDHDhACAaFEG.SGDFhADA..JADB.........hAEA......hAFA...,2,-21,-20,1
PDgTZMFeBURHCVbIcEJWAdSaLXYGNQOfK,aDABLDACGDEFOEACKFBE.DCGEZGACFFFABBCC.RBEC.CHEG...hAAAVFGF..IABEhADA.EAGEAIFASACEhAAAXEDD..QGBC.hABAfCEB.hAFA...,1,-30,-31,1
LaCAKTNOIeFMXJEbRQgUfPDdVBWGZcSYH,TGBCOGEAFAED..MFFEEBAG.RBFAQAAEUAGC.DBDAdHDBhAAABDADGEAHZEDFSDCDhAAA..hADALACBaHGEAIECIFAEXDGE...hAEA......hAFA...,1,-21,-26,5
dECGUJPAVIXNOaHMDLTBFWcZbfgYReQKS,XFDHaDCDHAACDEAHBCCH..FFFAZBEG....bBGFfHGDhAAARBDAKDAC.SDAFhABACHAAUGDEAIHA.NEBBLACEhAGA...cGBH.gDGChAHA....hAIA...,2,-26,-25,1
LEURVXbIeMTPdGYAaNOQcWHBCFSKfZJgD,OCCHQCBCHAECFEHDKACEZBFEDGGFLGDCUDDE.RADF...XGDHhAAAIAAFTCGFhABAdHAFADAH..aEEA..hACA............hADA......hAFA.NIDFBAGA.,2,-32,-9,23
NQcedYXaDSgLOVFUTBfMbZIRKCJWAPHGE,HEBHEGAH.QBGGeFFFdCCC.aAFHDAFHSAADOCHD.UEFHhABABFDG.MAACICCChACACHCFAHIBGBDENIEB.XAGFhAEA.........hADA.LHAA.hBAA...,1,-4,-28,24
bQYWdTAfaNHEDgJKPLcRMSCXFeUBZVIGO,aHBGHDAG.EGHDDAFEKEFHLEBGRBFC.CFHH.FGBABCGFZAACGBDEhABA..QACGhAAA.dBAEAAGD.NEAGJHFAhABAMDIH....eFDAIHAD.OHEChACA....hADA...,2,-27,-17,10
NTLYbSKgMOVQXPURAZEdJHfCIGeaFWDcB,ZFEEEEEDHBAECBHCGBDEeADA.FFHBDBBC.BDAETGBFLFCB.hAAA.bBEAKEAD.MIFChAAA......hABA............hACA.QCGBhADAPEACUGEFACCB,2,-38,-19,19
DHSOAZVTCcUBGLPKIXWJReQgdbMNaFYEf,VBCDCHHGBEHH.GCEDLBGB.KEAAXAEBRFCA..eACEhAAAQCBDdGACMIFGFACChAAAEGGADIBG.OHCAhABAAABF.TFFG.UECF.IAHFhBAA......hBBA...,2,-23,-19,4
aNZISRKcEedDOGMPUQgJfFVTLbYCHBXAW,aHBGZAADSDEC.RGAE.KAHB.EEGFdGGHOADHMFFHQAGEhAAAJAAF.FEGGLAEBhABA.CGEC.BCCEhADAAGHHIEEH.DGAAUEAB...hACA......hAGA...,2,-43,-18,25
QVOfaFRNWYIGTZSJKgHXeLBdPCbAMDUcE,UGEDQGBCOCBDaCAC..FEEARFGH......NAGE.IABGhAAAZEDHKBEH.HGAGLAAEhAEABAFGCAGBACCEDIDCEADF.hADAfAHA..WDGB...hAFA......hAHA...,2,-35,-24,11
QRPcKYVaWgefGFECNIDSJTMHUdLXOAZBb,BFDDREFHKFHB.aAGE..eAABGBCBFAFH.EGFA..CHCA.DIGE.JDAAMBHFhABA.dEDA.LEAHhACAAFGGQFAC.hADAPAAA..cACDYHCA.WEHHhAEAfCEE.hAFANIEH.SEEB.,1,-19,-29,10
fcAQZCUYaTFJDgMdPLHWBVbXEeSGRIONK,QGDCCADCUCAA.aBFHFGAA..DABEdAHCHEEGBEEH..XEADhAAAEGEF..SDCHhAAAIHGHKBDBAGHEZBFFhABAJDBA.MAIF....WHFA..hACA......hAFA...,1,-18,-46,28
RWaZDEQdOACFBfYgIbVJPHKeTUXNSLcMG,FBEEBFDG....fEBEIBDHJAGFKFFC..UGDH..hAAASGFELAECMEEAhABAGAAEaDBAEEFCdGHAhACAAICACDDG...gFAB...hADA......hAIA...,1,-30,-42,12
IUTefNXBKJgQRbSDCMcdALPYFOHEZVWaG,LGEAFHBGOBEHHDDGZEAE.VFAHGCGCUBBD..eBBB.XFEFhAAAJAFE..QDGChAAA..hABA............hACA.bBECCHHGdGDEACIB.EAHBhABAaEAAIDAE.,1,-11,-18,7
XLGQNCZDOEFAUBbcYIeWaTPJSMHKRVgfd,BHHG..bAADIGBAaHAC..TBECJEED.HGDAKEAFRBAHVDCEhAAA.dACFLACEhAAANDIG.DDCEOGAGhAFAAECG.YFGHeCFESGGF.MIAGhABA.gDFBhAGA..,2,-28,-6,22
NcbWagHKXYLJATeEPOdMBfZUSIFDQCRVG,TGGDEDCDdBAABAHD.ZGEAICGC.QFAGCFGBRFBBGACFhAAANACG....bDFE.hABA..aFDCKEEEYBEDhAAAADDA...OBAHMFIB.fAGFhABASFAFDFFE..hADA...,1,-18,-31,13
DUFbJfSIRKdBOHCMAePVLXcZaEWYTGQgN,eFBBVFDF.LAFCZCDE.aHEAECHH..TABGGACH.QDABhAAADEBCUEFDJCFEfGGChABASADBIHBHhACAKBADBEDHCEEBAFCAXBBC...hAAA......hABA...,2,-23,-6,17
TcGVFaLIReXZKAfDOYbEWCgSPHBUdQJNM,DEFHOGEAEHAC...CAGC.SABDHDABBAEGQDBDMCGHGBBBhAAAFHDALACEhAAAeDHD.XCFEKHCEfBHGhABAYBDH.gAGE.UEGBhAIAdDEENIEF....hACA...,1,-2,-18,16
GAfedEBLXYaZDQCIWNHFTKMcJPObURVgS,dDCDLCAFaAAD.QECDCHHG..IGABNEIE.HDGHhAAAFAACKGCHMIBAJCCGOEAChACAUAGFRFEF..VFDGhADA.SAEDfHAD.....hAFA......hAGA...,2,-24,-20,4
QWbREUcLGMOfdCIZHeXPFYTAVNgaDBKJS,VAADaHBGBEDC..KAFBQEFFRDCE.EBFHUFDB.LEADhAAAMEIH.dADEIBBEhAAAeHFAFCGDACDFNDAADDID.hABA.JDBB...SHGG.WACEhAGA...cGDAhAHA.fCGF,2,-30,-20,10
LWZQaKCTRGdJNbPHVgOYUESIMADXBfceF,DEFABHHGeFDHLEFAZADA.aGBACCHF..RCCC.GBBE.dGEEJBAC.hAAA.PBEEHFADVFGHhAAA..OCAHhABA.ECHFMFFFADFGfAGB...hABA......hACA...,2,-27,-17,10
VeFZUgdRBGALWDKNOMbHTPXfEaIYJCSQc,LFCHDGHHOFDDMFFDHDFE...XBFEEEACaDEB..IBDDhAAAJBBG..SAGEhAAAQGACcDADhABAVEGDeAHBZFBB.dABEBDDFACGD.KFFD..hACA......hADA...,1,-7,-24,17
gePYIbSCFfUMRLAVdZWKNcBEGaTXQJODH,dDAFZDAGKBCABFHBGFBH..TFDEJEEAHAGBeDFE...IDDAhAAACHGGFBAD.MHAGhABAAAAA...VACCcGAChACAXGGC.DCFA..YEHBhADASAGC.fFAFhACA.,2,-31,-24,7
EPJFCZVKRaLNMeQOGXSUYWcfITDHdAgBb,BFDGEHBGFDDBCCDEZEFB..RFFDLEFC.MBABOAAA.SFAHhAEAUAGD..hAFAWBCCIHHA.hAAAHAFG.ADDH.bCADJBBFKGDBaDHFeFHB..hABA......hACA...,2,-35,-20,15
CfdKHeNDGVSbBALMZIXaJFQgWRYcUTOEP,MHACXFDHFBAD...QAGFRAFGUGFH.OCDACEEC.fAAFhAAAdEAB.HFGHhADADICASDFHhAAAAEDHIEAEaBCB.JHAA.gDGEWDDD..hAEA......hAFA...,2,-45,-11,34
NTSeaXIgROFJAPdfcbKLMQUZCWBGVYDHE,dHBH..fCFCKAHHQDBACECEBHFDGFCBDGBCHCAA.EAFGhAAA...SFGEhABAaBBCIHFBOACEhACAABABbDEEMBIDZAEF.WGEEYAACNHAF...hADA......hAHA...,1,-17,-22,5
GeVcPRCdNDXAUZSHQJWTIKbELBFYMgOfa,SDAFQBDGJFAG..IBBDKGFBLDHHFCDG.MBAHhAAAOHEC.aFAEVDEEhABAPEECdHADDCBA.ABBCHAFAhACAWBHD..EGDA.BBFE.fHABhAAA.cGGFhABA.CACB..,2,-34,-10,24
cWfYaOeBKLNgSUJbTDPMXdCHIEFVARQGZ,QBCFGEDHZABA....fGAAODEGeHFAKBFCLHEAhAAASAFBUEADTCAEhAAAMADACHCAEFCG.FGFGhABAAICEcCDEaAHFBEAD.......hACA.JCHFDACG.dEED.hAHA...,1,-2,-15,13
ORWMadSTZGPJUIXbgLNYVDcBHQfEKFCAe,RFBGMHFGdAFCZEFDGAFA.UFBE..XBCCLACB.NBEE.DAAFhABABBACHCAB.fDDFhACAKHDACFGE.eAHHhADAOFABaHBC.SFDAJEHB....hAAA......hABA...,1,-11,-28,17
NfOPWEKBSTHGgICQZcXDaeUVFdYRAbJLM,JEEGMDEB..OBAAECAFBHEAHBFCGGAFCADE.QGGAhAAAZFADDGHBUECEVBFD.FBBA.hAAAdAFBADDE...bEAAfCAChABA.KEHBSFGC.hACA.IAFG.hABA...,2,-28,-11,17
EDbRfVFcSAaZTBXLPQWNMYJIdeUKHOgGC,TCCBXEBE.LBAGQDAD.MGCCIEHBdHEBeCHDhAAAKGABOAEGCHAH.DCGAhAAAREEEfAGDhABAFFEEAAIFBHGA.WBBEJDDA.........hABA......hACA...,1,-9,-32,23
PYQOfXRLDZTeUVEKNJHAaWCSgIBcGbMFd,CFEDSHBGBECAGGABMAIH..FHFAdAGG.QDCBOBAHRBFBLBEDhAAADIEGeEFCUAAChADAKFFE.HFGFADIH.WDBDhAEAIBCD.......cDADhABA....hACA...,2,-36,-9,27
YGVaTKJIPScBbLZCQfUDdOAFgREHNWXeM,FCFCRDAGEDDGHFFB...XDCDeBFAMFFGGABF..VAAChAAAKHCAPEABBHDAbFADLCHHhAAA..CADBQGGDhAFADCAEAHIB.......hABA......hACA...,2,-19,-15,4
bfAdRFKSBHNaCEGJWDIZgPXQLcVMUYOTe,dEHARFEEFCACKBHHBHACHAAE.CCDC.GCED.DFCAIGFG.ZFAAhAAAXGBFLHBAMAAEhAEAOBFF.TDAHhACAbAFC.ADEG..SHFAEHEE..WBBEhAGA.....hADA...,1,-23,-27,4
MEWDVFbHeBNcQXJIKCUPSOGdgRaLAfYTZ,TCBCEAABDDDG..FDBBeBAF.BBHAQAFAJFCD.CDGAUGGGhABAOHEAGECCdDEH..hACAaFGAAHBBZEFEMAFD..hAAA............hABA......hACA...,2,-35,-25,10
JAEUaCbSPHQRWNdgVGLMOBcFfeZYTIXKD,UFCECFED..SDFDHCCGREGDdCBGGAFEMIBG.BAAG.FFAHeBGHhAAATCCAKGACAAEDaFHF.hABA..QADBhABANAIE.LHEAfAFGICAGDCADEABAhAGA.WFFD...hACA...,1,-9,-23,14
QYHGUgfaTKBIMRAVJDedLXNWCPZSFEcbO,JAGHdEGCLDAG..XFAECCDE.SCCEEBAAOFCDhAAAHFEGUBFGaBABKHFCIHEBhAAAMAFC.AAFBeEBEhABANEEA...PDHD.....hABA......hACA...,1,-19,-34,15
QMLVRHNYfPAgScUKGBbDdCWJOXZEeTIaF,SHBGKGFCGDEHDBDFCBAC...OFAEXAFGZFDF...eCBAhAAAaBBDFAHDMDGHLAEBhAAAHGCCfEDAhABAADAH.cEAGBHHG.bFGDdHAF....hABA......hACA...,1,-8,-24,16
MWNCAcgfbZdJSDVUKITOHQeFEYPLaXBGR,...fHBHZDDFJEABDAACKDGG..OCGDeBDBFFCE.EGFFLBCGhADABAGCGBBAhAAAMIFE.CBACAADE..gGBHhAEAbFGDdFAA.SDBB.IGGFhAFA....hAGA...,2,-46,-11,35
dNUBTVPYeLagOIDHCFGXMWSQJbcfAEKRZ,EEHBRBCFdBGBBGHG..TAAD..VBEDeDFFaFAD..OGAEhAAADCIHCEEG.FGGGGAAChAAAMFBE.QGEEhACA.JAFAfAEFAHDBKDCB.NIAD..YDADhACA....hADA...,1,-19,-29,10
ZCTMFBDPEWJVfOUdYHINALagGSRQKbeXc,aDCDSGAH.QGDCbGCG.eBEHXBAEZBCDMFIBhAAAFEAFDFEGECGC..JFEAfGGDhAAAdBBA.IAHAhABAAAHDgEAEGADEKHFACDGFBHFA.hABA......hACA...,2,-17,-8,9
WVSAdTKLIRPZaDGJUgfNYBOMFXbHCcEQe,TFCELCCH.RGFAZAGHDIAEGBBDUBEE.....NAEFOHDChAAAFAAGXEGEHCFACCADECBBhADAQFGF.hAEAeDEDVFAHAABDIBHEaEFG....hACA......hADA.fEBF.,1,2,-15,17
UIYdWLTAXCKcVEgPFQbBSZNMGDefRHJOa,XGAFKEGDEDBB.FCAHBBBD.ZCDGGABFDIEE.REFEHGCC.aCEGhAAAUGAGdAHA.LADEhAAAAEEHCCCD....cGGEhABAPAHB.SEEBMDFAfAFDhACA.....hABA...,1,3,-44,47
UBYRGXZaCKQALegOSWPTNHIfbdMDcEVJF,LEEGeEEGOEAASBAA..PACGTDADHGEEIHGGhAAAfBFC.hABAdCHAcGBFJCBAFGAHYAFHhACAXAACZDCFaGDBCAHAKFHHAHIB...WADBhAHA.....hABA...,1,-7,-11,4
EQbXIBCMTUYSZFaLHDPeRgGJdWfONcAVK,VFEEEFAA..QEDD..XGBABHFAMCIDTAGChAAASCECaAFHHDADeCAAhAAAgDECdHCFfGGBhABAOBAGAHHAIAFFCEHD.ZDAEFCDBDBCAhACA......hADA...,1,-4,-17,13
IRTHUZFeOBaDQgbWXGPcNLCMJSEVAfdKY,dAFBKHBGRBFAHEEBZFEB.FDDHBDACDBCF....QBGF..hAAAWBAEPEBB..hABALEBCCGHASCAFhACAEAFCADHH.fBDE..IGHAhAAA.eFAAaHEEXDGAhADA,1,-10,-52,42
MQYgLUVaTWRBKGbOCIZFcDPNAEXeSdHfJ,EGDDXGGDdBFGHGFA.MFEEQCBB.LEFGaCCAREADKAHDhAAAOGACCDAF.IACBhAAAFACEDDDHADIHSBFHhABA.fEAC....hAEA.gAEFhAHA...,1,-22,-28,6
JKINfPXbgeMVYaTdACQBUEDRWcSZFGLHO,CFFGUABHRACH...SECAZEAGGCEHOAEEKBGC....IEHHhAAAPHDAXFFEhAAAeBAD..MFEHhABAVCEEaHGEAHCDBEAD.DBIHFHAA....hACA......hAEA...,1,-25,-29,4
OGdJNQZWABEgbYeUFSHaMIXKRLTCDfPcV,EEGD..bEFHUCAAFHBCHCDEMDFC..KFFFRBBHLAFE.DAAFhABAPFBDODHDdAFHQFCEhACAAABBBHHHeADFhAAAIEAHCEDD.fBGE...hACA......hADA...,2,-35,-1,34
OLZJGVbBIdfgaQUTSAHRXNCEeWFYDPcKM,RBCDCHHG.eCABFBFH..DECCKAAG.LCGBGAAHBGBBdAEC..aGDHUFEEhAAAAIHE.HDFC.EAHHhABAPEEH..MEADhADA...........hAAA......hACA...,2,-38,-31,7
McNabGOWgHAVdYXDEeIBJPFCLTfUQZSKR,VDAGXGBC.DADGeGEA.BDFCFHGECBCCLCHF.TGABhAAAQDEA.SDDDhAAAKABFMIEAaAFFhACAOGEGHADBABAEEEHB.JBECfEFAhADARCAB..NAIA....hAHA...,1,-16,-18,2
NFGTcQRAIfDZMXBEHgYUJbOWLdeKSPCaV,DACBZFEEBDEGHEBBUDEFOCBALBFA.dAAEKEAD.CGBA.aDAGFDHFhAAAGEGE...hABA...cBGBhACAAEBHfHADEEBE.JHDE..bGFASDHBhADANICB....hAEA...,1,-19,-33,14
LYCJaBeVdWHQgMZPIRXEbTANOcFSDGfUK,OGEAFAFBDAAFGGEFKGBHLBAG..CECDBEFEeEFEdAGBHCBCMCEHhAAA.ZDACPEAFhABA..XBGDhABATCGEAADCSFACUGCEaBCA......hACA......hADA...,2,-23,-17,6
JSFRCLEaTeZYIQDPKBXcNHVfdUgOAbMWG,MCCAJFEF.FFEELBAG.ECDFeDDGZAFH.IFHADDFF.BBGGhAAAXDACHCAHfHAFhABAUFBHADIH..hACA.bFAGSGGHCHDE.....hADA.aDFA....hAEA...,1,-21,-33,12
WaMcFSICVeDZKNTgbfXQUJHORYdELPAGB,GGDHaEGD.FAAHCBFADCAHZADCKAHH....TGDH..gDFGhABAXDEEQEBAhAAAUEAGOFCAdHABhABAEHAAAHHBBBCDMCCE.SBED..hACA......hADA...,1,-19,-37,18
aDEXCTdZBbAWJUFKYgIPfecGMRSQVNOHL,JDACFFHBKAHH....IGGFeECHGBEARBFH.QCAAhAAAOGAGLEFAEGADCBAFdGFEhABABHDFADIH.UABE.hACA..PAEHcGCD.SAFBhADANFAFDGIB......hAEA...,2,-27,-18,9
LCKHUgGRdMDXNQbVFEcfAPeaYZJWTISOB,aDCDZFDFJBAA..TEFF..IFFBBCGECBDGHGDAGDAHMBFBhAAADHBC..QAFBhAAAbBABFGBG.EHGEAIFEeAEEhABA.SHAGKCGARADB.....hABA......hACA...,1,-9,-23,14
DGFXVaBHJTbYPCWAISfLKQEUMROdgZcNe,SHBGKDCDECCE.MEFAOCGH.ZBEDeGDGDABH.FDCB.XAAFhADABFAEJHFG..bAFDhAEACDHE.AFBD.LFFAhAAA..UGGAdHABNACBaBEB......hAFA......hAHA...,1,-22,-31,9
eOSERAUKIBVXdgQPcaGJFNYWfZDCTLHbM,KGFCVDBHdDDF..QACGaHCG.FGAH..NFAD...fGHChAAACDBCHAEA.MDHDhABASCGDEAFC.AHAABACAhAAAXGDB........hAEA......hAFA...,2,-44,-29,15
eMfDCgLPIEBcYJNAFUXOQTKVSdHbWRaGZ,FEHBUDCHOBEFKGEG..dDFCHDBBREAB.aGAFZABG..eBAFDBAHLAHFhAAAEGDFBGFC...hAAA......hABA.YAHDAHHDXEGB.....hACA......hADA...,1,-29,-41,12
gTGOHWEIeacSfAQPFLNbUdBYVZDKMCRXJ,FGFCLGEAUECCBDHBZCCEDBGA.KECGRAFE.....XDGAhAAATEAEGBBBOHAGEBCEhABAeAAF...SEFAhAAAfFFFAHAHNICFYDAD.CEEB..hACA......hADA...,2,-28,-24,4
TBcEZHJRbFQgWVeXdAaOSUKLGfDMPNCYI,aEEDSAADLAAEDGAE..MCGFCHEA...IBHCBFFHECEChABAZAEBRECEFDAFQCBChAEA.gGGChAHAeAHDAGIBKDGGfECH.NIAH.cGBDhACA.bBBB....hADA...,1,-4,-35,31
NUBfPCAXKRecgJbDGVTadSMOYFQHZLIWE,RBCFeGEA..JHAGDBDFGBECaAHB..MFIHFEHBHBADLBEFEHDCBABBhAAACDGB..KABD.hADA..gEADhAAATBGCdEAHSGBAQGFCWFCENGAF..hACA......hADA...,1,-1,-34,33
fRUHASPebNWEDQFcGLgMZaOKdJYVXBICT,eCCH..NCCAEFFCQAEC.FEGBLAFGMHDAZAAEODDGhAAAKCAHdGAAVGCGBCGGIEAGhABACHHE.fHGFhACA.........hAAA......hABA...,2,-33,-26,7
PRCUaIGBZOXcbDENWMSQJTdgfHKFAYVeL,VFDFeEEGRFDH..CDAF.aCBDGAFE.BDDGOAEH..XAAChABADBDFEBHHMFAB.hACAQGGGdGGBHEACABEHhADAPFBBIHAEcAAB.....hAEA......hAFA...,2,-25,-15,10
BLYVRZEUSNMdbKJCPfQeacgWADOHTFIGX,DGADHAEGFDGGGAAEBACG.VEEHZEBB...ECGCUGGGMFCH.KDCCCAFE.hAAA...QBAChABAaADB..WFDDhAAATEEGIFAALBFASEHH.hADA.NAEE.....hAHA...,2,-35,-6,29
UGDKebdFcWOEBgTfQJMVIHSNCRXaPYALZ,ZAEGDDGBeCBAdDDGFGCC..OHFEBHHG...TAEGJCAD.MDIDhAAA.HFDECFGARCFC.XCGFhABA..PACBhAAAYEAG.ABBGLHAEKFEB...hABA.cGAH..hADA...,2,-48,-6,42
LRScQCMUGVaOgJYZFKTBEdWDIAeHbfNPX,eFBBHAAD....NEDDLADDREFHSBAFQBEECCECGDCAOGAAhAAAJBHF.FAHFBAEHhAAAEGGDdFFBDCBFAHED..fHCFhACA..cCEDMEID.aCCBZEBChAFA......hAGA...,2,-27,2,29
WUgbLQNSMaZJVFYCOAPIRKXfGHcTeDBdE,RAADXGBCHFCCeHFABBBHdBEE.UBGELBAD.SEHDhAAAMECCaEACZGAAFDCGCFCBAGGGKACEhAAAGAFE.DFEH.EGFHhABA.....WFAF.....hAFA......hAGA...,1,-15,-20,5
MFIUcHbVLgQCKSOTNXBaDGWYedfRAZJPE,ZFDFEDCD.FACAUAFAHFAFLHDECFHC.OBADXCBE.BCGChAAAaFBDDEFBGCEE.eAFEhABARACEAEGHMCIH..hAAAbGFA...........hABA......hACA...,1,-13,-32,19
QPTKfbFDgIVWUSZcLYeXMGAERCNHdaOBJ,CCAHHDAGdBEFBAADJEDD..QBAFKEEF.FHEEDEHD..IAGGhAAAUGACZCDC.LAHFhABAXADE.MBIDhABAAFAG.ECGF.aFFC........hACA......hADA...,2,-55,-20,35
JCXUaAYLdWgSEQKGZPceRMbOVBNfDIHTF,dDCDSHBGQBFEKDFBGGCDZFAH.eFAERABEMEGH.OBAHhAAABEDBNAEB..fEHGhABAIBBC...hAAA............hABA......hACA.FBDCJFED,1,-20,-34,14
faGXUSeQTNFcODRYdbWEgMAKCILBZVPHJ,CFEDLAFBZCGBHCBCaGHBGGBH..UCBFeABETEEDFAGB..hAAA.DGEFdEABEFBCAIFAIHHHhAAABADBJBHDSBAChABANBFE.OHAE.....hAEA......hAFA...,2,-20,-20,0
DSVTEbBNeHgIfWPXUGYFAROZCKMQJcLda,RDBGOFCAKGHB..QBGHLACBdEACDFAC.TFGABGEFHGAGhAAA..IAHFhAAA.fDEDhABAXBBA............hAEA......hAFA...,2,-41,-39,2
TFfRWDQdNbeIBJAGMEPacOCgLYXSHZVKU,MACAEAFB..aEBBOBEELEEH.SHGAZDGHUCBAFGFHRAACDCDEhAAAdGAH.eEDABDDFAFBH.hAAAPHAECBAC...hABAXEGE.KCGA.fFDChABANAIA.IAHF.hAGA...,2,-31,-10,21
XAMUHaZYGPWIOCgEFDJVNbSTBLKeRfQdc,MEIBaDAFGAGE..IGFEOFGBCAEEEBGG..DGEB..NDAC.hAAASECFBGCALCCHhABAKACF.RCEHfDBAhACAdDDAAGBB.ZABEWFHH.FAAF...hADA......hAFA...,1,-24,-29,5
IKUOSJMDCaXcAeLdWNgBVQTHfGFbYREZP,dAAB..gABDBGAGTEEEHBGBGGCHFEAARFCHEHFEZADAKCCAOFFChAAA..MFAADDBAaAHFhADAAECG.eAFF..hAEANDIA....fCGF...hAFA......hBAA...,2,-30,-8,22
OdDMBWfYAJQNUcXTeZPaKSFIGEHbCLgRV,JDACQCGC.UECFTCGDZACBKHBAFGGCGDDGHBEFLFGFhAAARGAG.dFAADAGCBBBEhABA..fFBDhAAANEIA..XAGAaACAIBBDECAF..hABA......hAFA.CHFD..,2,-32,2,34
TZMVARGKLQJHYbPEegOSfWcNXFBCaUDId,GBCHKGDDLEAHQFGAHADA...PEAGEEEFeCAA.SGHFhAAAcDGBXFBEhAAACCHADGGBdCGCMIEEAFCE.hABAYFAF........hABA......hACA...,1,-19,-20,1
KfeBUPCNFLDJbSQHIaYEGRTZgdXOMAVcW,VAADKHBGBDBF.UEGFCAGGLGFG.DADCSHGE.hAAAQECGaCEDEHCGGCGEhACAZADGdAACODCFhAHAMDAFAHEGfFBA..eCFA..hACA......hADA...,1,-17,-34,17
EFOdbPSVLAGRZDQKJcMfeNaIgCTHWBUYX,RDAHZFEEKDCCJBGH..MBIB..eADD.aFAFIHFE.CHCD.hAAAHBABBACGXAEFhAAAFFDA.ODDEdDGESAEHhABAAIDCDGIF.fAGE..hADA......hAEA...,2,-44,-27,17
JWSdDLGYMbNfgaOPcHQIXRTCZBFUAeEVK,eDCHEEHBKFDE..JBABdBHCDCIFLHAC.GAABMAHF...hAAANAFC.aFDD.OBEFhABAPFGHQFFEhACA.IGAETEAEBAGFAGIDSCCFhADA......hAEA...,2,-34,-21,13
JGDbXcTKNeQPHZWAEUVBRgLfOdMSIYCFa,VBCFRDBHLGFE.OAAFSBAD.CCHC.aDGFDIGE..XBEChAAAKBFDQGEBhAAAZGBGAAFCBEECdGAGIEAFhABAJACF..cBGA...NDAE.eDHHhACA.WEBH.EEEAhADA...,2,-30,-19,11
aOQYPCVDHZEKTNgWJLbMBXFAGdeRcfSUI,dCCGeFBBRAAF...SDCFaFBD.OEEDQAEB.CHEFHFFAhAAAEGGGKAED.NAAC..hACAJAHF...MBBDhABABFDFAIFA.GAGE..fDGEhACAIFACPDDADEDH..hADA...,2,-25,-23,2
aPfKSACGIDLWYBQgJEHNOXTcRFUMVdZeb,CECDGDCCLAFABDBF.QAFBEEGCHBCBOHAA.XAAChABATAABFCGE.UFFGhAAAMGEGdGAA.eADBhACAaCAD............hAEA......hAGA...,2,-22,-20,2
YdXWJScaDLZNVBHFIgROfCGeTKbQPAMEU,EAGDdGFCJACB..SEGCDGAC.LFBBZCFHBEECHBBGFFDH.hAAAgGDG.hABAfAACCCHGeAFEKEAEhACAPFAB.AFEF........hAEA......hAIA.MEIFUGGF,1,-3,-43,40
YJefWAGFELPZQdIVgNaBTRXHCOUMKDSbc,EDAFLFBBZBGF.QFDDdEDG.VACGNIDFBAHB..XGGGhAAACFGF.UBGBMBBGhAAASCAA.hABA.YCCA.eFBDAEHDFDFHPFHDhACAaFAH......hADA...,2,-34,-13,21
MPZaQFeHJNUfXTAVOdDcBCSIGKgbRWYLE,VDEDDFDCBFGD..CAFEGCAHKABDRGCE.LGDA..MDCGhAAAaACAFFBDJFAF..UADHhACAXAGH...hAEA.ACGFOHFE.SECF.hAAA.IBAF.hAGA...,1,-28,-49,21
XMCTHfDEPJaBbVOLgYGSIcQeRWUZNdFKA,CFECHEFHDCGD.EDDA.aBCCBGBA..OFABLABAGADF.IDAChAAAQCCBeHCChABAUGGENBIE.KAGGMGCEhACA..PHDG.JCAF.....hADA......hAEA...,2,-42,-6,36
LEJTWcBFQAVaGgfYOXUPRHSIKCdZNebDM,aBBDGAFE...fDCGOEAAUGDAHDABKHGAdEECZFAHbFFFLAGDhAAA.EDDGTACHhAAABGHE.FHAE.ACAHYEHBhABAXADAREFCCHDE.DACA.MAIF..hABA......hBAA...,2,-16,4,20
SMPCJZHedYUBDFIGVcWTfgRaAEKNbQOXL,EAFBKHBGQBDALFEHMCHF..JFFHeCAGdBGABEHAFHBAGADChAAA..VEAETABChABARAAAAAHC.ODAH.hAAASEHH.CDFD......hABA......hADA...,1,-3,-38,35
ZFGICPTcLRaQODfSMAbeHgWUYNBEKVdXJ,eFBBHAADUAEABEHFKBADdFHCZDDFGDEA..IDHACAGE..hAAAPEBGTEBGLBDAhAAAaAHF.DGGAfHBHhACAAFAB.gGEANIDFXBBD..hABA......hACA...,2,-30,-12,18
LZAYXgNHfSWJbPIGCQVOaKBdTMFRUEecD,XCBCHAADSEFG.JAHFPHFACBFH.OECABDCAdHGHhAAATEGCREAEUACE.EGDBhAFAeAAE.DFBDAFIH.NDAEfGCAhADA.ICFEQGAGhAGAaGEG.MGEA...hAEA...,2,-26,-7,19
QLdKcHaNbFXWGJPMUgVADCYRIZefOBTES,DAEDRDBHeADFOFBDBABD..EEFBLEGD.dBGEHBCF.aFHHhAAAFCAHGAFAMEIDUFDChAAAADAACBAB..IAHFhABAfGAAQFDGNIBD.WHDA..hACA......hADA...,1,-20,-21,1
WegYKBbcSMAXPEFfNLJOTUdHaICDZQVGR,EGFCFHBGLABC.OFDEdBEBIEDCZCBGGBGAeBAAKFACBHDGhAAA.SCDAhABAAGHE.fDGBhACA.TFAE.aFGACDFDDAGH...hADA......hAEA...,1,-27,-38,11
HKZceMYLTOAGfQURXDJPNaFWgBVbESdCI,QAGHRCDBDCAG.JGAGaDHF..FHEEBCGC.EFDBdBEC.CCCGKFGAhAAAZFFHeAEELCABADAEGABFhAAA..fEEDhABAPHAE.........hABA......hACA...,2,-35,-28,7
JCQEfDKOaZVbMFYLgdBRPHSTXWGeINcAU,JGFACFCF..QACGDCHB.OEEHVBCD.FDHBLFDHBBACHGFEhAAA..SHAAhAAAXCEBeFAHIEBAhABAAEAHfAGBKAFFaAGAMEAB....hACA......hADA...,2,-37,-17,20
gUSTNIBDHeRcMEVLPfdbWFOXAZaQGCYKJ,QCCBGGDHKEEEUBGDSHGA..IFDADDFHeDBBRCAE.hAAAMFBDLAEEdDHCFAHHhAAAABBGCACB..gGFChABABBEA.EAEC.fGCA..hACA......hADA...,1,-16,-34,18
dEUafcWJQGegLPDbZSICOYAVRXFBNTKHM,RBCDXGAFBFGDKDADHCCA.dGGGEDGD..aDHH....fGBHhAAAJBEAQABGhAAAeBFFLAHFDAEGSGEBhADACCBGAHHA..NIEFMACCWECG.....hAHA......hAIA...,2,-29,-22,7
aeLDOZAPbUcVHGMWdXEKfYNBCJTgFIQSR,UCBCVGFG.GGBF.MEECdDCGKAGG....NFAF.CBEDTFDBhAAAFFGA..SAGDhAAAeCGFDBAFACCA..cACAhABAXFACEFFBBHHE.....hABA......hACA...,1,-21,-41,20
XAGTeDSdYCKFVUMWJOEPRNgQBIaHcZbLf,GDDCTEGD.DFIDdCABCBBA.KCFH..FAEEUAFF..MADFJFEF.EDGEhAAARGAE...QEAFhABAIDDD.aGFAHABChAAA..cGCCbEAC.fAHEAAIBSGGGhABA.....hACA...,2,-31,-10,21
dCgWTJFEGUQBAHSRMVNKbDOYLfPcXaZIe,SDAFVFBG.KBCCODBCLFDF..fABEhAAAXBFGaBHDZBFDeGFE.hAAACCAD.WFFFFBHDEGABUCCBhABAAHEBMAFEDGGA..cFAD...IEHEhACA...hACA...,1,-18,-23,5
AVYGRaHCLFfceNPIZBTDXgEUbSMWOKQdJ,VEBHGEDH.aCEGLACAFGHD..eBCFICCABAGHDAIHEBAH.hAAAUFAC..MIFEhABAKCABdACFAIDAHEFECHCA.cFEChADA...PAHFTCGFbAFD.WEADhAEA.....hAAA...,1,2,-28,30
fPLHZDGOdWENSagUeITYKJFQCBXbAMcRV,MECGRGFG..VAABLCDADGAF.dBADECHHaGHB..UAFGeBEC.hAAATGEEJEAG.CHCBBGAEhAAAAFFE...cEGGhABAPFDF..ZEBAODDAWAFE.SADFhACA....hAIA...,1,-10,-33,23
PVNXcHJgYIEdSBTWbaeKGRQUAZMDFOLCf,MCDDOEACLBBF.CEHH.fCBH.VFFEXGDDhAAAJGBG.IHHEhABAEAAFdDEHBHEGTFAFWADEhAAAeCFF.RAFGACADDCIHNAEA...gAGHhACAYEFBaHAC....hACA...,2,-17,-16,1
MZQAVCXJOTIeEPBWcbSKDFUHfYgdNGLaR,CADCXFCA..TAEEECEABGGG..bDFGKDHH.FHACHGFEhAAA..fDAHhAAAgCCDdABCGGABhABARACCMFAGAAIFJCABIAGGWAGHSECGhACADFFDNECF......hAGA...,2,-15,-14,1
PXDdaICeGOcAWHKSUNEBfLJQZYVbgMTFR,HDAGSFAAUDFCBAHGLFEDZACE.VBFE..MIACRCAEDIAAaGCChAAA..eGFEOFHDhABAACCCKDEAEDDE..fAAChAAA.........hACA......hADA...,2,-30,-23,7
ZADGPWETNeIMQaXJSVbdHOUBYcKLFRfCg,DCECGAFEEEDB.eEFA.QECGaGGB.XGGHSCBBhAAAdFAC.UGBDBHDAKACGFBAGhAAACHEEABAATADE.ICCHhABAJCAFVCGF.OAFE....hABA......hACA...,2,-29,-4,25
KZEIUedcNTXCWaBRYPgGOAVSDQMJHbLfF,SGGEMIAGHCADLGBEKACDZAFA.IHHGdBAE..TEEChAAAXACECCFE.BDDGhAAAREAG.PDHD..hABAOHACDFFFbAFF.EDFBeHFE.WCHD.hACAaCDD.....hADA...,2,-20,-11,9
eKQWaBZdbHDFNIcVfGLSUMJRPCTgEXOAY,KDCDaGFCBDCCdEGADFFF..FGAB....IBCHVAACLFEChAAAUBGE.REAE..CDHB.EFBBhAAAAHCA.eBEDZAEA...hADANIAH.fDEF..MACA..hABA......hAGA...,2,-43,-25,18
NYHLMcUeZbOVgBEKDCaQAJfIFdSGXWTRP,JGEAFHBGdCBDGACG..XFCARCGD....NCAGLFBBhAAAMCFEUGFHeBBDODAHhAAABGAADCEHCEFH.AAHBSBAEhABA.TDFFYBEB...hACA......hADA...,1,-26,-33,7
bIXNPLeWKOUSTgZadMBfJQYGAcHDECVFR,DHCECHCHFBEAREFA......XCEFLEEB.KEAGSAFGhAAAZDGDMDAABBHBJBBEQDAAhABAAECE.EEDDIHAAhAAAeHAG.UACAaCGEdHGD..fGHAhABA...hACA...,1,-22,-39,17
ZVRfNdGHJCSEBLXWcKIOFgPQebDaTAUYM,MFFFVBDB.RCFC..dCCEJAFA..EAAGBBAELHBE..XDAGhAAAKCADFGGE...QGFGhABADBEHAFCE.ZFBHhACAfAGDHDFA.CBFASEGAhACAcACBIFHH...hADA...,2,-32,-20,12
UCOEJdAYWKbaFNHGIfVZXecSBRgPMDTQL,KHBGaAFBHCAEGBBA..VCGFeAFF.BGEGRGBAMEFDDEFFLABChAAA.CHFH.EECGACGB.WAAChAEAFDHD...IAHChBBAfFAEXGFD..cGGAhAFA.PAHB..hAIA...,2,-32,-8,24
RPgcQHXIAMaGYENZJVUDFKTLSBeWbfdOC,MEIBGEAH.EGGAZCFDUACGFBDFKFGHLGAABAGE.eBAD...hAAAfFEAdBAGCBFCRFAA.hABAPBGBQDDBhACAIDDGAHED..aDAENIAHDIFE.....hADA......hAEA...,2,-30,-3,27
XFJdWVTOUDbPgSacCHLAfEZIQMReNGBKY,ECFCQFDHRBBC.eECFGFBHBAAFKAAGFAGGdGGB...TDAEhAAADGIBbACF..SEEEhACACEHGACCDZBFC.IAHGhADAMFADXGFD..WHEG.OFAHhAEA....hAFA...,2,-23,-19,4
VDbXLAdZEBCKHNIQeFORgYPacWSTGJUMf,dEHABCAHHFEDQDCBeDCDFBDFOBBA.RFAB.PCAD.aGABhAAASHGE.hABATDGF.UAFChAAAVAFGXFDEZDDACHDBKABB......hADA......hAEA...,1,-9,-21,12
OPAKWDeaFMcTSBLUYJRbHIXEdVgfCNZQG,KHFGDEFHeCBGMAFD...SBFCBDCBLGACUEAG.RDFCHBAAhAAAEHEGdGGH...fHCBhAAACBHHQFGAOCFChABA..PEACAEGBWADCFHAE....hABA.YADH.hACA...,1,-13,-33,20
NVQRJcTEKCUbSBPeDgMYZHFdLGIOfaXWA,QFDHRFDF.JDBBTDFA.EDBDCACHUCGDBBHDDHGE.MGAAhAAAHBDB.FGHHdCDAIBAAhAAAaBCG.AIAA.NABF.hAGAKAFA..SHAC....hAHA......hAIA...,2,-31,-31,0
LaSHYXPJBTUNFMEbfRCdVZKQWGeIgOcAD,aEGCSCFCHCCE..XAAFJGBCBDBBUEAHFGAH...EGGERFFAdADBhAAAKGDBQBGFhADA.eHAE.IBEHhAEAOEDGDIDG.YCAFNEFE.fBCEhABA..hACA...,1,2,-46,48
EZYUNQWHXAGMORcdVbISePLTBCaJFDKgf,MBEEOFBBdDAH..VCCGSGEA.LFAACCHAJGFAKGDDEBDDhAAA.UEFB.QCFBhABA.WHAAhACAAIGARBAFIEFA.TAGGBHHBDIFAfAEGhAAA...hADA...,1,-21,-39,18
BRWJSYXKdZgMDbfHQGcENAVULTaOFPIeC,UBDGTAADFFCG..eFEDCEAG.BFGHRFFB.JFBH..SEGEhAAAKBDGdAGFZDAADBAC...hAAA.HCFG..QGAGhABA.ECABAFFFaGHDPHCEWFAD.hACA.YAHF.hACA.MDBE.,2,-31,-14,17
XOYIVTSRNPfWGaZUHbKQFMJdCDAEBgLec,BFEDLEEGeDHBOBCF..IDEESGCGRCAB..fAEDhAAAaBHFHCECKCAGhAAAQGGGFHGE.dABHhACACBEFDAFEEGCHXAGFYEABNIAFWCFH..hBAA......hBEA...,2,-21,-13,8
LYagIWQFSRVeCUAHNJXcPTfGDOEbMBZKd,HFDFJDAC.XAFC..TFGHDDBCEABGBDFHdFGALECChAAAaHBA.IHAEhADAQACH.SAFGhAAAeCHDADFE.NGAFPHECfEAEOEDCZBBA.hAEA......hAGA...,1,-8,-26,18
dfAREKUcMVNITJeaBHCPLOFDGXYgZbWSQ,RFEEKFAAMBHD..IGHFeABHBADC.HEBFLADFDCDC.GAAChAAAXAFBZCFBSHAGhACAdDDGAIBG.EHEGhAFA...cAEDNBAGaFHDCHFDOBHD.YFDAhAHA...hAAA...,2,-25,-10,15
PNOfSVHTGFCUJbdLagBRMKcEDZIQeWYXA,OGEASCFCHDCBGACBFBGFUAACdAACaFEBRGAE..KHEGDCDFZAEBQDGBhACA.eFAGhADAXDAFABIF.fEEBhADACHGAJHAE........hAEA......hAHA...,2,-22,-15,7
DaXIgTYQPCUSNedbKZcOHVEWJGRBfALMF,FFAGXCBF..TBCAQDFBUGEH.SHAEeCGHKHAAZBABhAAAHECH.EADEJCEBBGHFhAAAAIHE.DAID.IFAChABA.YFFFNABF.....hAGA......hAHA...,2,-34,-9,25
acYbOgFZfSJTPXdVUWMGHLCIDBRNEKAeQ,QAADaHBG..bDCFODCF.ZCDFfAEDTBFCXFAGhAAAVCFA.MGEAhACALFHFCDAEBHFEEABA.hADAeFFBYAEESEEF.PBAHhAAAdDHAWHBEIAHFDAIF.hBDAKEBFAHHF..,2,-11,3,14
TCAaEOVJGPbNYSDMBXRQLIKfUegWcdHFZ,aEEDEDBD..ODAHGBED....bGDCNBCEDABGBCHE..XDGAhAAAQBBBLFABhAEAIEEBUGGEeDFEhAAAWBDFdGBE.FEGHCFDCAAGE...PHDASACEhABAMBBF....hAFA...,1,-8,-19,11
LITEfMBNDHRbaKCWQOVZGUSJXegcdAYFP,FHBGLGEAEDAE.MDDDBEHCDCEARCCD..KFEACAHB....OBBDhAAAZAECSGACJADG.hABAeAAEdCACAHBA.IFFHhACANIDF..bGFEaDHF....WCFBhADA......hAFA...,1,-32,-35,3
OHIAgGNWTYLEQMJRFPXdZaDVBbUScfKCe,GAFETCBC.EEACQFGBRFDF.FDEDdBAFZAFGDGGBBBAESDGHhAAAKGEH.eAHBIGAAhAAAAIHG..gDCHhABA.........hABA......hACA.YEAAMIAE,1,-14,-30,16
eZUaTQMHBLfRNYOFgAdKGWECcSIPDXVbJ,GACBCFED.SGABDFFA..bBEBZEDD.aHGEMHECBGFFREAC.hAAAOBAFACBA.KCFEEABEhADAICCE.PDGDhAAAJAHFUGAB........hAEA......hAFA...,1,-19,-38,19
eYUDdbBQASWNHFOfcEVaXCgTRPMGKLZIJ,SHBGHAADFEEDOAHDEACG...VDBGCEGHRGEE..MDCCLHAEhAAAZAFEeECEDCADdGHGBCHBhAAAACGH...fEAGhABAXDGD..........hAEA......hAFA...,2,-26,-21,5
VaRgNMZYXeUITKWCfdSFPALJOHGQcDbEB,OAABGBDFQDAEDBDEBHEA.RGDAMAACZCCG..eFFCUEEDKCHDhABACHAAdAGFFECE.ABCDJCHBHFAEhACA.EGHB..aHGE.hADA............hAEA.YHAG.hAEAXAFBWFAG,2,-21,-15,6
BIKTDcZWGEfPQJNdbYXMgaVRFUeACSLOH,LCAFOFCAHBEDKBDCDFCGZDBGEFGH.QABGdCGC.XDGChAAAMFGDaCBD.RGAGFAAEhAAAAHBBBHHE.TAGEhADA.WGAEfEHCPHDC.bFCA...hAEA......hAFA...,2,-27,-5,22
ONIUgHcJfFSGbDPTCXBMEVWdKaZLRQAeY,eEEGOGEAUDAGHDCB.JCAGSGHD.DGDGCAEGBBFH.hAAAMDIFVGAAKAADLAEAhABARGAEAIHE.IBBFhACA.fDCHFCGD.PHDCECEBaAGAhABA......hACA...,1,-13,-28,15
RcFePfJbaYWGMEIHDCTQVKdSULgABZOXN,BEFAOBDGRFDHFHAG..eCFE.JCBCaBGDGDAE..ICBGhAAACAAEQFDH.hABAKDEHUEBGACAF.NAEC.fEHChACA...WHAGMCIF.DGHDhACAdHEDSDADhADA...,2,-45,-16,29
aONUMHgVcdZBYIReEJGQfWPLTAKSXDbFC,SFAAXAFBDCCHFCAD...CBHB.aBBBUACCHFFH..VDFHhAAAdBECZDEG.BFHBIHHDhABAREAE...eHDGhAFA.EAFFJHBEfEDAWAAC...hAEA......hAIA...,1,-24,-26,2
IeKJdGUPCbWfEaAYFcNTDVXgLORSQZMBH,FHBGTCBCDCCA.....VFDEXAAFLBEDOBDARFAHZAFBMDGDhADABCHE.eABAdFDFUAGChAEACHGC..WCAFhAAAEGHHADDA...cFABNEIE...SHEAhAFA...hABA...,2,-25,-18,7
AIdKbOfWEQMLNegcFSHUXJGTZVBPDYaRC,dAFBOCCHEECHLHDG..gBFHFBCHUDGEGCAEhAAAZGACBFGEDIAAaGEEAGGCKEEFbAAC.hABA....fADEhABAQDDC.NEIE.......hACA.cCGE.SDADhADA,2,-31,-13,18
PgOKDXaCcUHAbLVdZEJGFTYQBMfeRWSNI,LFBBdDAFJAAC.GBDBFFFG.QFFABAFC.MCAFRDDA.SBAEhAAA.IDDFhABAOFCDXBGFhADACFECcDGA.AHHF..VEAF...EHEAfGAAhACA.NIDF.hADAKCCC.DIAG,1,-22,-33,11
IZfaFQKdJUOSTGACecgPBNLbVRDEMHWYX,CAFBeGEA....PADBBDFBNACG.LDAHRGFADDEG.HEDA.hAAAXAFDZBAFaFCAKDHFhABAdHADODHF.SHDGhAAAAGCEbBFA.MAEBIHBE.fEEBhACA..hAEA...,2,-40,-9,31
EbSeAWHDFGTUMYPaBcgXNOQIRZdCfVJLK,DHCEGBDBMCDAaAABBAAD..XEFG.OHAAIAGDhABAdBBECEAAJDDFKEDD.SHGEhACAAAFBFFHDUDAE..hACA...PCGDNADH.ZFFFfHDFhAIAEACF.....hAEA...,2,-33,-15,18
SKgQTfYWHBAeaFLdbEVONIDXZUMRGcJPC,eEGHaEEDLAAEEADB..OBHFDAEDZBBFRCEAGBAA.JFBDCGCFSBHFhAFAKGEB.hAAAQGGHTDCCfAFAhABAWAGF.AFFA.dDDANEAE.IEHFhAIA......hBFA.MICE.,1,-4,-18,14
bKNVIEGCJOZTBgYeDARfMFUSQLPdcXaWH,RFACMHFGFGGD.UDACLEDH.dCAHaCEGHAEBKHDA....IDGChAAACFFDJDFGZABE.BAHGhAAA..eBBADABEAFHC.hABA.SGBD.cEGD.XEEGhACANIAB.EAGA.hAGA...,1,-25,-26,1
CUBdJgcEAHWeZGObLSPIYNQaVDTfKXRMF,HFDFeFBBGDAHOACBLBGDSFEGIBAGQBCEaEBF.hAAADDGGKGHFMAFB.FBABhAAABAEHJHFGEAHBAGADWFFBhABA.....PHAC....hADA......hAEA...,2,-25,-9,16
SMLZDgbNBJAaGRdKVOcXfYCEFWPQeTHIU,aGFHRCCHdGBF.KEHDOBAE....XEEAfDEA.EBGEhAAAFAHDQEBChABAeACCTBACIEGH.hAAASGGB.MHAADIGGgBEBhABABBDBAAIF....hACA...,1,-16,-36,20
PfEVdNOABMZKSRCDWXacGeUTQgIFYHJbL,BECDKAABCFBB.DGHF...aAAFeBGF.QACEFDECHAEEJGDGLFFHhAAA.EDDAdCHGOFHFhACAMIAAZACBRGAE..hACA..cAFB.......hAGA......hAHA...,2,-37,-18,19
WKTYIDRaCHQOAdeSbLVJNUBMFPZXgGEcf,dEEDSDCDLDAG.JBGFBGGD.MAFCFHBEZBCEGADE.EFGGhAAA..fGGChAAATGDGIHBG.hABAaABCCACGQFAGAGBCeDAFbBFF.....hACA......hADA...,2,-31,-15,16
aGCTBRZdMWfFQcJbESYXVLUDKPIHgeAON,aDCDCFFHBAACZAEA..dHAFMDEB..FAACQGCG..cFGBhACAJBCA..SFBChACAXFDDLDADhADADAGCKGHB.IDGDeCHBACCH.NCCF....hADA......hAEA...,1,-23,-45,22
DPVfRgNBULWbcMETCdHKeGJASYOaFQIZX,OCCHFFAAZGAEDFEF..VGACRBBG.BEGALDEE..bFDBMAEEhAAA..EBABCGHHHFFDhABAGAEE.SHGEhAAAaBDA.IADHXCACfAGBhABA..NIBF...hACA...,1,-15,-27,12
CQZKXIgHVaPATUNSdGbJWRMLFcDeBYEfO,TCGCSGFC.GAEGJFBB.RCADFACFDDBDeFDABAGA..EDDBOACHhAAAZGAA...KFHBhABAIHHEHAEFaEDGAIFCUDGChAAANIEB..dAGF.......hABA......hAEA...,1,-15,-20,5
DBcdfPSCEIKMALVHgRTUWYOaZQGeFJXNb,LDACVGFG.RBGFUFBGOABCZBCAGEAE.FDCCXFGFhAAA.DGEDdDFB.SAHBhAAAEFFBMABGADIHTGCGhABA..aAFFQAFC...hAHA......hAIA...,2,-25,-16,9
JZFYCdPQgKbEVTWLGaOMAeDRcUBXSNfHI,DAADUFDHBFDG..SDCFHEEGZCBAFGACdDAAQGAEhAAAKAED.EACHVBFELAGHhABA.aDECAIHAeHEChABAXGFD...NAIEfAEC.hACAYEHFCEHEbDAG..hACA...,2,-27,-20,7
MTUgeCDbXGFQcPYEBdZaJSOHIWLANRKfV,RDAGKCFCMAHFUDBD..CGHE.DEEG.GBADQDDG...PFAFhAAABAHAaFAE.SGFBhAAAIGCAAHEE.hABAVACATEGC.eHAA.FADAcEGBhABAEHDA.dCAB....hACA...,2,-24,-22,2
XWeLNgaHVFAKEQSOTfIYRGdDBJMUPZCbc,EFAAQGGD.ODACfAEC.RCCEDCHBJBGDMAABZFFDCHBG.hAAAXGAALBAFaFDHhABAFGEBABIB.KAHB.IGCEhABAYBBABDFHPFEG.....hACA......hADA...,2,-22,-19,3
DONfaRVWCZgILSHUcGXbJPYEeKMdQAFTB,FFFBTFCADBAH...OBFCaBCD..RDFG.VDAEZECFLAHDhAAAHACAUFGH...XGEDhAAAPBEB.EFADKGACdEFBhABABGHB...fDAACCAC..hABA......hACA...,2,-36,-3,33
YPDgVJEZOURQcdACaKeWfBTIXHFNbSMGL,CEFAaEEDKHGE..eFCHBDHG..XACCFBFC.SAEBhAAAMDBFLHAADDIFJHFGEFGAUCEBhABA.QDAEhADAAAEC.TAGGIEDG.HABH..hAAA.NBAE.....hABA...,2,-43,-6,37
NKcOWfSaYMgLCFEeIQAbTXHPJGDRVZBUd,TCGCHEFHJCDE.DGAEZDDC.dFAAKHAG..OFCC..SAHBhAAAaFHHMBADCBCBEHEEQBEBhAAAAEBG.PHBChABAVBAEBAEA.NDIA.fBBEhACA......hADA...,1,-20,-34,14
KOdcNDSaVJgAFTXeHRCUILbPBMEWQZGYf,FEHBTDCHeCCG.HDBHUABELAFGBGHDMBGFEHDAZABC..GFADhAAAKDFBODAHdHEHDFGAhAEAaAAHJAHBAHCB..CHHG.IBEChAFA.........hACA......hADA...,1,-14,-24,10
XFgQPBYSMDHTJcdINRebfKVCEOGWUALZa,LDCHXCCB.FBHDQFBCBGFD.SGFBDAABHEECJBEFhABAIEFCRDAB.eDAFhAAAKBBCCHHAEABH.OADEhABA.WHBAAAHCaEHD...PHBETBGH.hACAdFHEfAFEhADA...,2,-30,3,33
YIDdWKHNeABZOXMVfPTEFagUCQJGScRbL,BEFAOBDGMDDG..VFFF..PFEHTEDA..aCACCABHQDABhAAAGAGA.hAAASCFBREBFbABEIHHEhABADIACdGAF.WBHBKGAD.eEHBAFAG...hACA......hADA...,2,-23,-14,9
MgeKFHOfENTAbaUZScVDXIBQYPWGJdCLR,UGBCZDAGSABEDGIBBHFE...QFFE..PAFEhAAAJFCELBFARCBG.hABAMIECKEFEFEBCfBBDhAAAEADB.AAHH.aFFEcGAH....hAEA......hAFA...,2,-43,-26,17
gaNCPWHZIcLVUDAKSOBTGQRXebdFMYJfE,KEEDBDGFGBAGQGADeGCG.FCCB.MHEEJFAF..EAEF..NCAA.hAAACGGDHCFBZABE.LCCBhAAADDFFSEGHhABAOCHF.TFCD........hACA......hADA...,1,-15,-31,16
ReWbaOCdMNZKfcTYLQPXVJSBGDUEAHgFI,HDAGFHBGRACD.eCHD.aAFDCAEGdAACZFDD..KHAG..TGGELFAGhAAA.XACDVCEBBAHEhACADEEEEFHBAEHH.IGFHhABAOHDC.MDDEfAGE...hACA......hAEA...,1,-6,-35,29
AcQfYHXRKDdPaOGNZTWSbCEBeVLMUFJgI,QCBCHAADXDBHDIGEdDHEOEEHZFCH.SADCEHAE.VDGBhAAAMABG.UEEDFGBB.hACA..IBFAhAAAcAGFYBEHKAGCaFACNHEF.......hAFA......hBAA...,2,-19,-1,18
OCRVHZgdWFUDeQLGYJNIEBMfcaTbKSPAX,OGFARCDHHAGDdGCEUCDCeAADGEAC..JFHFEFDHBGAF.MFAEhABA..fACBhAAA.TCBEKFEGAAEHCCCHhACAgAFEFHEEDBBE.LAHB.IBAAhABA...hADA...,1,-8,-24,16
eUZVfaASOYIGMCbHEKBJgLWNXcTPRQFDd,OCCHGAFECEACHAECKGGA.BHEELACG..XFAH.hAAAPEGDQFEChABADBBEUDDAVCCBAAEESCADhAAAMIFAEHAC.WHAANCIE......hABA......hACA...,2,-29,-16,13
JLEAHINbSDPOKdYFfBVcXeUZWQGgCaMRT,HAAD..IGFHSGDGDEHDOCCDdCFBFGFABAFG.XDAEhAAAeEBDUBADQDEBhACACHHEaAGG.MIEAhADARCFA.TGACEAEBAEFFNEEEbCCB.KEGA....hAEA......hAGA...,1,-7,-26,19
YEAegTIPdDKcVCFNUJaOSBHZRbfXWLMQG,eDACTCBCdEFG.DAGEKAAD..CDHC.UDFC.OHEEBAAEHEBEhACAZFCBRAFA.XACELEABhABAMFHFGADA.ACHC.hACAIBGC..cGGANEIEaGDCfFAEhADA...hADA...,2,-23,-15,8
AaBQYOFdVbLfMcZXSTPCKHJgIUGeNWRDE,aFFBQGGG.OEADdDAHLAHB.fBDHhAAAZDCBSAACCGDGKGGHHBFDhABAJCECIHECeDEFNACFDDDHhBAAAFFDBDAF.FBBE.MAFA...XEGAhADA....hAEA...,1,-12,-29,17
gMJdBGfNcVbFaDEPXKQOCLASYIHRZWTeU,SHBGHAADRBEEZEBAeDHDMDFG.BDEAGCDC....NAEB.bDBDhAAAFGFADCBE.EAHDXGBAhAAAQFGB.CBAFAIEChABAICCF........hACA......hADA...,1,-15,-26,11
ETJDLHSGXaUCBINRPbYWKcOeAfMVZFdQg,MECGZDDFFEBFdDGG..QABEEBGG.DIEELAEFHAEHSGGGhAAAaGGDUGAFCCBBBHAHhABA.RBGB.PFCA.hAEA..bAAEKGDD........hAGA......hAHA...,1,-21,-23,2
AHJKQMdNeZDRFXEYcWgSVBTLPIUafOCbG,HDEDKAADMDBHdDBHeFCHZGDE.DBBARECG..FBCDXBFA.EGFC.hABA...WAGBSAGEhAAABAEA.LFABhABAIHHDfEGFCCEEAIFE.QADChACANBIC....hAFA...,1,-13,-40,27
CNEfQJPYZMaIdRALXeHBgcOKGTFbSWVDU,LFCAeADGBGACOBGHGAAGFCAE..SEDADIEE.CHHEEDGFhAAAfCEG.hACAQGAHYGCCMAFChBAAaABAIEAHABIHHCDAKDCDWHEENIDF.PDHDhAAA.....hBCA...,2,-23,-12,11
XOHeTKCWdGaIAQYNZDFbcUVfMSEJgBRPL,QCBCZAADDFECFACE.UBGA..MDIFEHEEBGAFLGCGHEGFKGHDhAAAdEEAGAGG.AIBA.hAFAYAEE.bFCFhAAAcCDF..SABG..hACA......hADA...,1,-18,-32,14
dXZARFaYIKcbTSLgOeCPWHEDJBGNQUMfV,RFEEFAFB..aCCDKHAC...TBCCLBEG.eAAECAACHDEGDFABBHHEhADAQFDGMEFGdHDFhAEAAHFF..ICAChACASGBH.........hADA.gGGBhAEAWCFAEEDFNBBEUEBE.,2,-21,-17,4
YTMSCVRcDWJGIUAOgBHbaFLfKQNXeEdZP,OAFBHDBHFFGHLEDCKAED.QGDEeFDBEHBAdBBFZABGTGGGhAAAMAGH..CAHD.cDGFhABAJFAB...ICDHhACAAIHC.BHBBaEFBNAAEPAHF.SDADhADADDDE...hABA...,1,-1,-22,21
gJZCNOBWIDMScUTPQRXGLEFaeVKdAHfYb,HAAD..fCFCbBEAZADG.OGBGBHEGDFGASCCFhAAAUGGHQDEGXFGALAEAhABAFHAEeDADKDDDhAAAAAIDJHEECDHA.WCAF.IDDC.MFCAhACA......hADA...,1,-6,-24,18
fbMcdWeHDFaOZXVIgYUNQGJRKAELBSTPC,BDGFTGBCCFAG...MGECdEDHeBBDHAEADBDHFHEC.OHFAZBFA.VAABhAAA..IHHGhAAAUDEGQDGAhACARACF.AIEESEACfFGB.....hABA.cGAEaAHF..hACA...,2,-42,5,47
DTbPdOcaQNRCMfSKIFXEHJLAGVgYWZBUe,GEDHVAAD.....gBDHZCEABGFDeFCDTDBCdEEBaACHhAAAQAFHRFAD.hABAMFIBfGGGhADAKFAFFDBEEADFJAHBAAEA.UGCEDAIF......hAGA......hAHA...,1,-7,-16,9
KXBFHgMCaWGbTeDdLfYZRJVOIQAcNUSEP,UCBCSAFBEEFC.KEBGFGGAHEFA.MAHFCAGCGFAB.eAAEhADADDBGLHEC.hAEAfBBDZBFAJHDAODDGhAFAABAFNAAHBDED.WBHH.....hAIA......hBAA...,1,-21,-22,1
eKVPgDAXNbfMZCYcBaGIWQJHUTLdRSOEF,XCBC..NBGEMFABCCHBBDFCGBBG.QGGEhAAAJAEEHDGH.LCHFdFCHSCCEhAAAOAEH.FHBGeDABhABAKGGD.PHBGADABfABFZFEF...hACA......hADA...,2,-29,-6,23
LUgOFTWaEMPAZbDJQVcHfGKXSIdCRBYeN,DHCEQAEGHEFAKCFFSABHdABGBHAB.eCFALDBCUEDGOHFAhAAAFFBC..aADEEEBGhABAAHGH.bACD..VAGBhAAAGGAB.CFFB.........hAGA......hAHA...,2,-30,-6,24
VHdFgfDUYbBXPRJTOWMNcIGAQSZKCeaEL,ZBCFeCAFLDFEdGECFCGE.DEBFUFBDBGHC.RAEA.OCFH..MFFHhAAA..IGHHhAAAAACAKGCCCBHH.ECCE.HDBAhABA.fACBXBAGJHAA....hABA......hAEA...,2,-37,-17,20
WXLTbFPBRdcfKVOQEGMJSIANYZHgDeUCa,ZAADDHCEUACAaBFG.LHFAFFFGBDBA..RAGD.dEHEKGAB..QGCAhAAAMAFH.SAHBhADAAGGBHEGDCAAB.TFAEhAEA..PEBEcDEG.....hAGA......hAIA...,1,-26,-34,8
QAYTIcZEOdMCReNbGDSBUKfLJXgHWPFVa,TCBCZAADdAGDRFEE..eEHDGACEDDEHBCGBKHDELFCF..hAAAXGADHCEA.FFCDhAAAaEADAABE...IHHGhAEAODABCGGD.SGED.fAHEhADA.JCFF.hAFAWBBC.,2,-40,-12,28
ZKFXeIgaTAEfdbJHLOSQVRBCMcDPWUNGY,EAFBdHBHHFEBLFEHSDGHQABDBBCFCDAD.DEDGUECCGBAGhAAAKHGEFGAHeAFC.aCGG.hAAAAEAH.bCFA....hABA............hADA......hAEA...,1,-23,-24,1
AaHOVXIdPfJWMbRceDGBCZgUNFTSQEKYL,aDBDHDBG.OBFC..IEFGdGEGfADBMBBDRAEGDCCECABGUGAHhAAAFHGA...SGHHhACAKHCCADFE.XFFFhAFAWDDB....cGAB.BFHAhAAA......hABA.NCAE.EBCF,2,-41,-14,27
XHaYLBbGQJSfMUKRPgVFEOdWZDceTCNIA,aDAFLAFBBCFCGDGCSEAG.MDIHRAFG..VDCDEGFEdBABhAAADIDA...TCAGhABAIBCBADDAXFCAhACA..bGDAfAHCKAAD.PHAAhADAOFABcDFDCFEA..hAEA...,2,-19,-17,2
JIWPKTAVbXUOZaFYGQNgfBHCEMedRScDL,XFDHOADGZAAHFABDGEEA..QADB.NAAE.BHDDhACAHDFEEDFE..dAGAhABAcFBBDIFGJEABICHBhAHAKFCDADCH.UCCEaDDGfFGAMBFG.hAIA......hBAA...,1,-9,-27,18
JAEVGPQKcXFUIaDTOHWSdbLBgCRYfNeMZ,EGFHVEBHGBBG.KAHFXEGG.UBAEIEGE.aAFFhAAATDDD..WBEHhABAbAEEBHDF.CCCB.hAAAfEDEMFABAIEA.PDAB...hABA......hACA...,1,-26,-28,2
SJcBEZKORXeTHUDafPVICMYLNdFAGbQWg,QAGHSHBGBEFDKECGRBDF...eABFTCADDGEC..aCFAVGFGhAAA..CEDHMADBhAAALBACFEHB.bGAAJEABEEGChABA..OCCH.......hACA......hADA...,1,-12,-34,22
PcYRFfWMNKZCGaSIdbTUABQgeEXVLODJH,QGGGEDCDLEEGJEBCHFAC...PAACRCDEFHDCMGAAZAFBCHBGGGEFhAAA.IBEGhADATBAHUAFABDHE.hAEA............hAFA......hAIA...,2,-33,-9,24
DPTOZEeHJbaWYdGINAFcBCLgQUVXfKMRS,BFEDCAFBLFECQCCCUCCB...XEADMIFA.DDFBOCAHhAAAZAAEeGFAHFCBaHCEdCFEhABA.GABFAHAEFAEF..hACA....cDGFfAHA.SFHHhAEA..hAHA...,2,-26,-19,7
ZTdaQSUJHfDXABVgCGeIRLcNObYFMPWEK,VDBHCECDGGCH.RFGB.LHFE.OAFFbBEB.FHBA.MAIHhAAAEDGHKHAG.dCAFaFGGSAAGhABAUABFHEDBfBGHhACAADDEBHAG.eBDBNCAE.PEAB.hACA......hAEA...,2,-13,-4,9
QbfaNLMgPOCHXKDZdGYJTFcSEeWIBRAUV,VCDBQCBC.aACEMCFG..OGEACFGEKACAZFABdHCBGAEEhAAA.TCGCFAGCEDHBhAAA.eBADBEDGAHIBUGDFhABANBAALHFA........hABA......hACA...,2,-24,-14,10
XCDSBKcRJWTeMFZNEdYVIQbaGPHLAOgfU,OGEAUCBCCGHD.BCEH.KGAAJFBG..eBCAFAGE.ZAAH..EAEFdHFHhACA...VAGFQEGDhAAAGDBF.LEEBhABAADGF...fHCBSFAEWCADhACAMEIH.NIAF...hADA...,1,-22,-38,16
VDWYBTRHSAbacfeUgFdJXKPOQCNELMIGZ,aHBGeGEA.FDBFdHEBKFEEQDCE.EACCIDEG.ZAAAhABADBFBBHBDTBGGSBFBhACAAAAC..fDGGhACAJCHFODAHCHHBMAFCGECE...hBAA......hBBA.YFFA.,1,-19,-21,2
WNGKAXOIEHDVSMYTRcZgCdfUJQFLaebPB,XDACEDCDDACB..MHCARFBFZGFE..dBHCJAAAQAEHLFEEeBFChADABHFHGEAChAAA.KFGAAAGCIHDChAEA.SDFCcDDACBAA.fCDChAFA.....hABA...,1,-14,-30,16
fWYUKOCQScdHIBgXNTaGRDALEbeVMFJZP,EDCDeFBB.FDDGZGAG.....fBFDUGGEKCBHOBEGhAAASEEGdDGCBHEGXACGhAAAaAHF.DEGCLBAEhABAMIFEWFEACEAF.QEAG..cFEChACA....hADA...,1,-16,-30,14
fNXEPFabVKADgHcLWGZYJUIMdTRSOQBCe,HFDGLGEAGCBGZDFGJACGMAAG.dAHARAFA.OAEFBFCD..eCCBhAAAfGAG.EDFChAEAFCEC.aCAHKGHBAHDDDGIFhABAcBCF..........hAGA......hBAA...,1,-14,-32,18
aKRSfEPWFCdGebBQDZOALIgNVTYcJUHMX,LGEA..NDHE.VBACTBEE..JAHBUCBAHADCaGFFSEFAhAAA.PEAFhABACCHBdHBHeAAF.hACAQFADDIECADIFYEDEcEDBMDDEKGEDEAFEhAAAFGCF.....hADA...,2,-14,-14,0
QPWcOYSDBZVbGfCEeHJUXKaTRIdALNMFg,MDEBQGBC..PBFDOEHHDEAAVCDFGBAB.CADBHFFGhAAAUABAaBFG.IDBAhAAAADHA...NEAGFGEBhAEAcAGABDGCfHEB.JFBBKBHBhAFA......hAGA...,2,-20,-16,4
RTMeAUVWYKBXDCcgLZbHfOSPEJNGQadIF,VEFHKHBGBACB.DEAACBHCLFBE.HADGSHEA.hAAAJDEANACCGGAF.hAAAdDDBRFBEMAHFAIDC.UBAChABAWBAF..XFFA...ZCCFhAEAOFHDEAFF...hAFA...,1,-12,-32,20
CMUWcYAdBTQXNVeKDEgbZRFPSHfIOLaJG,dFFBQABH..NHAFKAAEDHEGEAEA.ZECEFEBEHAGF.IEAHhAAAaBDD..CAGFMIBAhADAUEGE....cCCHhABAABCCTBGC.XGGGgGBG.hAEA......hAFA...,2,-46,-8,38
XaATCeLVdDWfcIENbOBUgKQJHGYFZRSMP,CFEEVFBGdFBF..DAAD....fAACEDAC.OHFEUAGCQGBHhABAHBFCGCADhAAAFBCFRFFCSEEChACAMEIH.aAFGTCED......hACA......hADA.eHEAWEAD,2,-24,-1,23
UdKcSFaNRgEeAOfMZPGYWITbXHJDBVLCQ,MDEBZEBHGBDC..IAGCTAABHBFDJBBF.DAEABCHBLDADhAAAQGGFUFFFdBHAhACAKADG.SHEGhADA.aHACgGCEACCF.fCFEhAAA.YFAHhABA.WFFF,2,-32,-2,30
AXdOcfJISKWGEYMaUbFPBTNLgeVHZCDQR,XGGDOCCH..JDFHSDEDGBGG.EBGDaGAE..bCBDBACGhAAALHBG.eACGhAAAHBDHDEAHAADCfBAAhABAIAHCKGECMEIDPBADNICD....hABA......hAEA...,1,-15,-22,7
QYFIdfCRXNVScPLGKegBADEUbMaZTWJHO,UCBFMHFGZCCC..JCFFOFFEFADA.dAABRAGB.....XBFBhADAVGAG...PBHDhAEAGEGAKEBBeAAGhACAAGAADIAE...EEFATEDE....hAGA......hAIA...,2,-30,-26,4
JARcHFdCGDbOWTNPXaSKfUVYIBeLZMgQE,RGFGHDAGFAHHGCEHOFGF..TACG..PEBDXDGEaEHF.hAAAKHBG.UBFC.IEEFhAAAeACHMCAHEFABAHAHhABACFEFDDDF...NIAB.fCAFBBEA.hABA......hACA...,2,-22,-7,15
GaDLJOESVfACWNUIYMbcBHTdZRgKFeXQP,CFDGUCBC.MIFABEFEHFBBdBBERGDA..KFFDeBHDQADE.hAAAGBGGDFBH...hABA.LAFE.hAAAEDCF.SCAFfDDDAHHDNBEEIGHHhABA.....hACA...,2,-41,-17,24
IVbfLEGMcgQTUdAKXSaNYOeBHWJRPCFZD,XFCESAFB..aABEOABC.HGFERCEEFCCHDIDE.bDCCfGBGhAAA.LFFGhABAEDHDMHBG.cBDDhAAATAGEAFFA.YHFAeEAFBFDF.PBAHhABAIAEG..hACA...,2,-30,-1,29
IcLPNfDUEbYWCBFdRMAGZJeaOKHXTSgQV,GGDHeFFCKEBAHCEG.SCDDVBBGLGBA..PAFAhAAADEFGEHGEbCAH.CHCGdABBhAEAAAAHZAFFaFEG....hBAA............hBCA......hBEA...,1,-10,-36,26
PJFfSDIVGRQEMOCZHUBXYaLgAceNdKbTW,eGEAdAFBKHGE..TBEEJCFA..FFDHSBCB.VEBGhAAAGCBBRAGB.QAAChACAMIDCCGAAHBAFBEBE.hABAaEEAAAIFcEGA.NACF.PEAB.DIAAhADAIHHCOFFB..hBAA...,1,-9,-25,16
IOPAaCXcHWMFTKYRfeBbdUGgLVQESZNJD,aFFBXGGGHAFEFDEAKAHH...RBCHBEHCdACGGDECLABEEAEHZGAAhAAADFCG.ODBECHCG.MBADhABATFAF..YDGHhAEAfGGC.......hAGA......hAHA...,2,-23,-15,8
FPdaDcJGTgMWSRHLICeObQZNEUABKYVXf,KEGDXFDHFCAB.dBFHDFIDGCAH.MIDASGCG.RCCE.hAAAIDFB.CFABOGFGhAAAbFAHZAGBEBECAACGBBBFhABA.fECHaABEJHEE.WBHH..hAEA......hAFA...,2,-28,-26,2
RHCPgFAcYXTZWdBJfDSNLMIVOebaKEUGQ,XCBCZEFHdECBBBCDDFGB.LAGH..IABFOAEBeCAFhAAAKBGCUFBFGGBFRCFGCFHE.hAAA.FEEFABAG....hADA...cADB......hAGA......hAHA...,2,-35,-33,2
SbdZfTKHAacXBeVIQEGOWYJMPgDNUFCRL,XGBCBEFAeHDA.QCBAGDEBOABA..JFAAgAEAhAAAUBEDCHHF.SHCAhAFAdAAFZFEE.TCCGhAHAKGAFACHDaCHDIGHF.WCBD...hADA.MAEEPFDC.hAIADIFG..,1,-5,-23,18
dQCcaOVeNGLTUgXSHZJRWAMDBfbFPKEIY,DFGABFDGFCHBECGA.dEHGCCEB...OAEAeDEBLEABUBAB..hAAAXFEHSAFEhABAJDDA.AHHGMACF..hADAfBEDbFBD.PDBBKDCBIGDAhAEA.....hAAA...,1,-24,-39,15
MRCTPZVAFDQcKUOgHISaXeWBGNJLEYbfd,QCBFUGBCODAHHFGD.SFFFaBAF.eEAGGGEFhAAAJBHDEGAEfEFAhABARAFHTABEVCCHDGEB.KACDIDEChAAAXCFCBADBNBED......hABA......hAFA...,1,-2,-10,8
bICVOLHQMBXRKUDgZJfEFcNaSAedGYTPW,dAEGTAGH..bFBGCGFCLCDC.MIFEBFGA.XCBHhAAAUBAGZEAGEABHFGADaHEEAEGDeDHDhAAAGAGE.WEEHhABAOEDD..........hABA......hACA...,2,-23,-19,4
HMOFJAUcSbRIXKdTWLEfGQBYNagPCeZDV,SGFCRAADKHGE.dAGETEGBLDCFGECABEHG..aEAGCEDEDIDEhAAAHBFEFEABAIAA.UACEhABAIGAE.EACDfDFAhAFAQFECNAIE.eDDE.MADE.hBAA......hBBA...,2,-32,4,36
CTSGFPKcLAEObZUVIWNDeBMRaQgYfHdJX,OCCHUFDH..VBDB..IACGDEACBEHBMBFF.aHECQAAChACA..hADAfAGGdHGBCHDASBFBhAEAFBABcFACEFAD.bDFD....WAHFhAFANDIGeEDH...hAGA...,1,-18,-37,19
gUVaRDCGPBLefQXdFYETWMSbZKHJNcAOI,OGEAUCBCRBFHGGABBHAFLCCA.eCGHfHGH.hAAAQFEAFFBCEAEEMBBChABAZABAKAGCJECAAEIH..hACA.IDAF.aHFCDADGCHBA.dFBB..hAAA......hACA...,1,-17,-18,1
eLKcbUAFafYRJCEQgGPVWTdMBXIZSONHD,FAFBaHBG.RDCB...EHGAQGEHGCDB..VDAFdBBABBHB.hAAAXCFAIGEDSEGAhAAANADBDAID.LHAAhABAKEFHbABCAIEGJADFgECHPEAD.MDIFhACA.....hACA...,2,-22,-1,21
HVLPIDFdGYfAWXEQOJZcKabeRUgMNTSCB,EGFCQFCAZDAF.KAAFaEFCRGFE...UAGCMIBE..SACDhAAABCFDLECCDGDE.hABAdCCBfCEBhADAAADBOAFCJCHBeHDG..NEAE.CAEC......hABA......hACA...,2,-23,-23,0
FKMCUABbTeRLWQXdHZaNfPDEJSOcgYGIV,TGGGLFFC.XEBDHBDAaGDA....NAEE.DICG.JFAHSDBChAAA.OHBGhABAYDHHIHGAhACAFDBAKEEGCAFAADABBBCCeAHHWBAFdBBF....hAAA......hABA...,2,-29,-15,14
MBGYQRFIeAKEbUZLcSWfgJdXHPDOaTCNV,KAFBUGBCLEGF..SDDH..WABDgADDhAAAdAEGHDDBDEHBaCFETCBChABACHFG.MEIHBHBEhAAAQAGB.IFFHADABEACB..hACA......hAFA...,1,-32,-33,1
JZcCVeaIDWFAOMHdfGPbgNSKURYXQLBET,MHACHDAGGBDE..gACHKAFGUEGFRFEBQAGChAAAEABDJHAA.CGFGeDEHDADDACGA.fDDAhABA.NDICSDGDhACALFAABHHE.....hAFA......hAIA...,2,-23,-15,8
TIcKBGCRLZbaAUdYgWfEJDPOeQFMNHVSX,dGFC..gCBCEGCDDADG.OFHFeCFCMEIFHECCSFAGhAAA.IBAFhABAKECBGAACCGGDRBFD.ZADGaAHBhACAAEFH............hADA.WGAA.fAEAhAEA,2,-42,-5,37
AgCFJDBZPafSOeEKGMHYdIXLVRcNUbQWT,FEGDBGHDZBAEaEEB..OGDEKGCFHBAF.dACALAGHRAGD.UGBAhAAAQDFCAAEG.hABACGAGDAFBPECA..hACAfEBASBEEEHFGMAIF.IHHAhADA....hBAA...,2,-32,-22,10
WUQMIbXCAVHEdBgSeaTfRcDYGOJPLKFNZ,HDDFEEHBdDBDBBDE.eCHDaFDA.RFBF.DAABOBADLHAA.KBBEZBFBhAAAUGEHQGFBhABA.IFABCCHDAGBDSCDBhABAfCCEGAEF.FCFHMACA.hACA......hADA...,1,-5,-21,16
WPGbaATRIDKHXYZOBFJCfVegULNcMdSQE,REFHDGHHKDECHGDAZBBB.BADA.CAHA.eACELFFCMHBA.dCAB.QCEEhAAAEHGCGAGEACHC.TECFhAAA..XGADhABAFFAB.JDABfBAE...hACA......hADA...,1,-13,-28,15
ebVaBcNOfPGCgJFEDRSXMdLKYAWHZTIQU,HGFGTFDHQCGH.UFADbBFCaGGBBBAE.OCEHGCBChAAACCADFBEADBBFSGAGhABA.MAEAdCCEKEGGhAAAADIDIACG.......hABA......hACA...,2,-24,-12,12
IgbCLAYDFBTRMWdEUZeaVNHSXOKQGcfJP,DGHHFFFBRCAFdBHGZADF..eDAA..aAACVEEAHDCA...XFAAhABAOHACKACGGAFEhACAJGBA...IHGEhAFACAACAFAABCAHMDHD.WAHBEHEA..SCCEhACA....hAEA...,2,-36,-5,31
NPSWOXEJILKDefVdQTUGYFgMRBcCZaHbA,SHBGODAC.EACGJFFC.KFBHDIGE.eBBBdHDBUAGBGEEA.hAAAFAGGMBFHBEHAZABEHFAGhAAA.AHDC..PDFAhABAIHHH.LDDBfDDA..hAEA......hAFA...,1,-15,-33,18
FRGLYQNWEZBDCVaegSJdUPcTfbIKOHAXM,MBDHFGFHGDBELCHFQAGBEEBE.DAEFaACA..eDEHSAFGhAAAUBBD.cGCChABAfEHE.IHAChAAAHFEEAHIH.........hAGA......hAHA...,2,-26,-21,5
VMPGcQDNeYBXOZWHIKFTSaRACgJfEbLUd,CAFBJGEA..EBCHUAGHdECG...MDIDGEED.DACGeABGBHDFODCAhAAAHBGFKAAD..hABASHAEAGIB.hAHAbFAA...........hAIA......hBCA...,2,-38,-37,1
TNDIRCBfAMeGJKYZagdUPHOcFLEWbXSQV,MGEAJHDAZDAFdGCC.UCBCHDEA.FDCFLBFA.EHFEXABGhAAAQDDC..TAGDhACAIACCCGHBAHHDKCHBhADAaFABOBAH.WEHHSFGC.hAAADAFDBDHC...hAEA...,1,-11,-28,17
TWVaDUNBQGIPMbJeOXEHgLYSAFZKCfcdR,FEHBCCAHdBEFRFCE.....TGFGaBAHUAFBBDDHGCED..IHCDhAAAMICG.eACDhABAXCCHHEAGLBHBhADAACCDKEAH.fFEAcGGC.DAEENAAF..hAHA......hAIA...,1,-22,-25,3
DeNMbRFPJBOdWZKcSEUfLGgXYaQHVAICT,TGGGDEFHMAFE..RDFGFFDBBEGG.dDDCKFAH..ECHBLBAChAAAGGCH.XAFDaDBDHAAGhAAAAAHECDDHeDAF..NICB.hABA...JDAE........hACA......hADA...,2,-25,-22,3
CRJHOdDTKWMIbLXfgZNEUPcBVYAaSQFeG,SFAAQGGDGDBERDEGHBBH.DAIDTAFGMDIBLDADhAAA..XFGDhAAAfACANEDAEHAAUEECcACFhABABHECAIGG.eBEGCEAAdAHAIHAE..hABA......hACA...,1,2,-12,14
SdPHbJDKQXREMeLYAOFNfgZCGUTWIBacV,FDCD..gAGEGFEHTDGABFAHaCHH..VBAFdEABHEFFhAAAJBFA.KDDERGAAMAFEhAAA..LACEhABAAEFHfABBCHFDIHHE.PBCCDEAD.XGCDhAIA...hADA...,2,-21,-7,14
JCXVTBGQbLaOYZSeAUNKWHdcRMgDPFIEf,KGFCHDAGRFAH.DGGGFAGBEDFC...CBHF...TABGBAFDGAAFhAAALDEAOHFAZECFAGIBUADEhAAANICF..dGCBMCIHhABAIGAF.........hAIA......hBAA...,2,-29,-23,6
FKVfdXCRMWBSOYgIAJEZQcLPDUTHbeGNa,JDCHQCCBLHDEDFAHHAEHGDFG.aFCGKEEB.dAACRAEBMCIBhAAABGAHSBBEhACA.ODAB.ICHDhADAEDAD.PEGDUABFbGBA..NEIE.hAEAfHGHCHBA.hAGA...,2,-20,-10,10
DSeOBLYCPZNVWGUAfaHMgETQJXcKbIRFd,aCFCHFAC.MCAAEAAD.QCEC.JABCKHEC.IGCDhABAFAFFdFHEeHDEBFAGCBECNAHA.GEGEhACA.AEEEfCCDhADA.TDBBcEDCDDIF.OAEAhAIA.....hAAA...,1,-18,-22,4
fHNPQEaVKOFYBZCeMRdTXbGUIcJSgLDAW,HAADQCBCVGBEFFECBHDF.ZFBD.MABEdAEEXAGDGDGCUAGDhAAAJCCF.LBDBhAFA.AGEA.fGHEhAAA.PDABaGHD.......hAHA......hBAA...,1,-15,-18,3
DbEFLKUIfARGJOXeBdCMNcYaZHPgWQSVT,RFBHOHDABCEBdFFD..CGBDMBEA..NAAF.aFDGZDDG..HCDGhAAA...PEAAhABAQAFBVEGHDBIDECBD.hAGAFACGKDHB..........hAIA......hBAA...,2,-43,-18,25
JRTBVFgLYHAZXfQOIUSNdacPWMeCGKDbE,XFDHQDACUBFCdFHA..aEFG....PDCBeFAACBAEKFGChAAAEACHRBAFBACAFGDALHAEhAAAAIEE.OCDGhABA.SGFHWFADDAEB.JAEA....hACA......hAHA...,2,-37,-8,29
GgDPBCcXEbJedYfaTZARULKNFQOMWVHIS,UBDGKDCDFEFGQFCB..MCAFHGEASFHFDCAFBEAHXGAGhAAAEGBB.JBBHhABAeGCE.dBFBYFFChACAfBBB.aGAHZBGBAIEA..NABF...hAAA......hAGA...,1,-12,-35,23
ODIfdNWeAPScRFKHEgGJUVYaBMCZTQbXL,SHBGRDAGKGACHACHGEEHUBAB..aEDBMHCAZAEC...bBFAODHHhAAA.DDDGIHGHhAAAdFEDeFAFADFH...hABA.FAFAEDBB.........hACA......hAEA...,2,-24,-18,6
MgGNHYWCARPEJecTQIOXUaZFbDBSVLdKf,RDAGJCCHeAHB..QFGCOFDE.UBECZBCADHGEBAABLCGFhAAAKCGE.MADGGDAEhACA.HFEDCBADAGBDEDDE.hADA..IHDF......hABA......hACA...,1,-25,-31,6
HcTaSNOALBgQMZdFGWDUIRXeEPYbKJVfC,LAFBQGGGMBCBFDBBGBCBUFGARDCF.eEEC..EBAFPAHDhAAAKHAA..JDADfFAGhABACCHE..HFEDhAAAaHDAOAEABDHG.ZFBDDIGEIACAhBAA......hBBA...,2,-20,-6,14
GUYDPJNRSMIHQeZLEgbBXaACWFcdVOKfT,FEGDdCFCKBHDGABGDEDF...JAEBRFFH...SEAFMEIFHCAAeHAAhAAAEFAC.BAHA.AFEF.hABACAAC..VACEOGEChADA.fDFH..TGBC.hAEA......hAGA...,2,-32,-26,6
gPHcGZIKBFNdXWVeLARDQSaJfCTbYMOUE,RFEESDAB..fACETECDMFHFOBAD.EBHBPHCChAAAHAEFZGAEBCHCNEEB.hAAAXGAB.VCDGhABAAIFADCCHJACA.........hABA......hADA...,2,-25,-15,10
UOEWRcTgJVSBMCFeaXYZQLbNIDfGdAHKP,HDAGUGBCEAECREDG..TFAD..VDAABGEGMDFGCGGDFCHBeBAAhAAA..aAFHZGFGQAAChACALEEEIBHEhABADADFdHADAGDD..........hACA......hADA...,1,-17,-23,6
VYDKRcGQZBCEOWUTJbIdXLAMfaNHFPegS,MHFGaHBGHCCCFAEH.eFFG..VEFEDICERCGHGGAFBACA..ECACOBAAhAAAUAGF..TEAChAAAbCADdAGC.LDCEhABAAABC.NAIE.SAEB....hAHA......hBAA...,1,-5,-16,11
EPIKJGCRHBTWDcZOSAdgXVLbMFYNaefUQ,XGBCVFDF.LBADFCAH..aAFB.UABCQCCAhAAA.EDGCPEEAIFEEhABAKCFAGDBECCFGBFHBDAGEhACAOBHFAFAGdHGDgGGCMICC...hADA......hAEA...,2,-18,-18,0
IdeTWXRBVfGCPEJZcKYDSHAMOQbgaNFUL,MIFGODAC..QGDFaAAF.UDFAdEFGTAFFRAFEBFAHGBBHhAAACCHC..EHEAJDAAhABAZACFKEDBDFAF.AGDEbFADhAEANDIC..FHAELEHFIGGH....hACA......hADA...,1,-14,-15,1
RgAcaEHfeVMNDICTXWdLQGUPFYSBZObJK,aAFBECFCHBBC.eFCGMEHHDBAACAHB...XFFHLDBFQGAFhAAAUEDHFHDE.BCADhABAbADD.RDACAEED..fABFhAAAIAFDWHDG.dEHE....hACA......hADA...,2,-31,-7,24
IMdCWQGXBYaZPeNHFOgDAJETfKbRVScLU,EAADKGFCRDBG..SACBLBCGUAGCdFDGQAEBBDHC.aGEDhABAeHFAFEGG.DDAHAGCBTGGEhAFA..fBAEhAAAcDDA.IGBDCHBGXBGEZFDB.HCBBhAHA.....hABA...,1,7,-38,45
AFUGJLQTdISfcBCaKYHVXMNWPZODegRbE,UBCBLHDAdBFG.SAGDBGFBKEEE.HDDB.MGFA..PFAGhAAAZBCBeBAH.bFADhAAAABADFCHDJCHB..IAHFhABACHFD...aCFHYHAA.XCADhABAWACFDFAFEGCA.hAEA...,2,-42,-6,36
GFeZXcIWJEaURBfAQNYbLdDHPVSTMKCgO,QCBC..bDEGDIACHGFESFEFMACDCFAEGBEBhAAAFDGDXFACIADCECFCRACEhAAABAGEAIFA..NDICdFCAhABA............hACA......hAEA...,1,-19,-28,9
ULHCBXRIWgYVOSTcNAQZdJPDMeEfKbaGF,dDAFJFCH.DAAC..EEDGKDFHGACDLCFCBBGHRFBE.....IHFBhAAA..gFGAhADAVCAH.SBCGhAEANGEFADDC..QDFEMBECfEEEhAFAFGADCBAC...hABA...,2,-37,-27,10
GeDcLSbUWROXdgNHZBVQKaCMPYfAETJIF,EGDDTDACFEGF..GAAFeEDGLHAG.UBCERBEGXFAChAAANGEH.BFEAKDFCCAAAMBIFhABA..PHEEhAAAYDCEAAFCDCAG.SBGEOHAC.gFBFhACA...hADA...,2,-26,-9,17
MdJWIZKXLOaADBGgEYSbRcVfHFPNUQTeC,BGDHEGAH.SAGAREGF..fDCEHBCHFCGDUFGFQADGhAAACEEGdFAA.JEEBZAAFLCAFhABAaADA.DIDE.hACAYAGB........hACA......hAFA...,2,-28,-22,6
PYIZSHBfFEAQVdJGeWbDCKLUNgOaRTMXc,dDAFeHDADFDGKDDDUAAG..OCBFRGBC.MHBE..XBEBhADA..YBCChAAAZEGHBGFGEFFEADDDQBGAhAEAJAFC.........hABA......hACA.WEAFCFAC,2,-39,-32,7
BJEZFOGXfeYAUIbgTRaQHdNCWPKSMVcDL,UCBC..IFFCTCGG.RCDFHDAF.CGCAKHECSAGAhAAA.MFCGDGADLBHFhAAAEFBDFFHDOAEBfADDhABAAHAG.aBBGNIEH........hACA......hAFA...,1,-28,-29,1
JPbdRBVQFUWLATOMgYDGZCeIHXfNEKSac,OAEHMCCADFGBZFDA..CDAH.HFAF.XAACEFBFKDEA...aHFEhABAJBFCdAGBBGDCFCCFLDHBhACAAADA.YEEEhADAIHHG.SAGE.PAABhABA.....hAFA...,1,-13,-50,37
YPRcTGJNLeIgSHVFXbUMdDWQfKaAZCEBO,EBBDBAFB.OEACRDEB.GFDHJFAFLADDeCAA....gCEChAAASCHB.hABAFGHFXACAMBFEDFCEhAAAfGHAACGFCEHG.YBHDPHDA..hACA......hADA...,1,-26,-29,3
agPTGJBdEYcWVQfULCFNDIbOHeRAMZXSK,MEIBSDAFKDFE...aBCGTBDHGDDFdABHEAAH....hAAA.cFBDQEEGhAAAfAHACEABDGABIHCBhACAHGFAACIHXBEAgFBCBGAC..hACA......hADA...,2,-30,-12,18
aVKGSfeXbETPAIJgcQBUHFMWDRCYZNOdL,JGEAQCBCHFAEFAEHDBAD.RBDC..ZFAFOCEELDGBKCBD...hAAA.SHCEhABA...XEFEhACAEGEDADFDIAHDBBBBMBIDCHHFdEEDaEEGfHCBhAAA....hABA...,1,-22,-30,8
DONWaGAQgBeSTbYcMFILJREVfHCZUdPKX,BHHGSAAD..TDEC..bFFHMCCCFFAALCDAhABAEGFHHDBDCEADdFECKGCHXECBhACADBAEOBHFaAEAAHAAeACEhAAAICHF........hADA......hAHA...,1,-24,-25,1
QVPgYBcZFJUdOIfabeMDKLGNWEHACSRXT,SGFHXDCB.QEEC..gFGCBAGAFFCDJBBGhAAAOFBC.IAGGhAAAaADAeCEGMBBADCAHLFHBhABAWBFDAACECDHC........hACA......hAGA...,1,-26,-34,8
PXeQEKDMfgYcZCAUaFLGWVIHRbSTNdJOB,aFHBFHAEGBEA..IABBHFGBSGACdDGBBEBEXADAhAAAEDGAMACG..fDBBhAAA.YBAGhABAZEDDCBGGACDBWDAF.......hAGA......hAHA...,2,-40,-20,20
CFWZbSDfKIQRgEYOcHNaJdTeBMGLVUXAP,FEGDZAADSHDEDGBA.KEDFQEDE.EAFGOBFChAAAHACGJCACdFAH.BHCGMIBGhADAGCEBLAEE.hAAAVFGHAHHGCDAD...fCCB..hAIA......hBAA...,1,-25,-26,1
LJPANSeHEXGIgRfMYCBcdZUOQaFVbWTKD,eCCHXCCBGBECRAFC.MIDEBABCZGAGQGAEFBAD..bCGFhAAATFFDLAECJDFAAFHGhAAASGECHFCBgDAFhADAfFHACEEA.......hAEA......hAFA...,1,-3,-15,12
UMeAGPCWdDVNQSOfKJLTcRXaFYZBEgIHb,GGDHCFDGdBFH.DDGCQGGGOEFC.KGADLEAH.RAAEFCDAhAAAZADFBEFD.IDBChAAAbAFE..MACEhAGAAIDE....WBAESDDD..hAHA......hBEA...,1,-23,-48,25
NZFLbaKXWTRDeGVBfIMOgCdHYSEPJcUAQ,ZEFHLCCHaBED.KAFC..XCCBTFFFDBFD.GBGCBDBHMFIFhAAACEBC.HAGHEABF.hAAAPGCGJGCAAHHE.NIAH..hABA...WDAF.......hABA.eABFfEEFhADAIGAH.,2,-28,-21,7
IKCUAdVaGEBXePQMNFfOJWbgYDTRcHSLZ,dEHAaBBDGEEDEHDABBGH..eFDBMACAFFAG.OAHBJEBC...hAAA..gBEBhAAADGGBRBAASGBBLBAFhABA.KHGAAFFCVCDE.......hACA......hADA...,2,-33,-16,17
OGWcDNALSVEMXHPZUFJagBCTbdYIKfRQe,LDCHSEHBEFGAHFADUAFFFCDG.aGFBCEBH...dCBGKAAC.RGDC.hADAeEGBOEEGGAEFhAAADCCG.AHDBMABE.ZCFEhAFA............hAHA......hAIA...,2,-41,-6,35
RXWHJbPgaeFVKABZSLdcfDUEIYTQNGCMO,SBBDdDCDDEIFUABGEBEG.....TGEGQAECGEABhAAACHBHRGDGHGAA.bDEEaGGFhAAAFAGG.ACCGBHHGLCGBhAGAfACFIAHFMBAHOEBB..hBAA......hBBA...,1,5,-29,34
UbRIgQSaNYDKMfCTdGVWHBXOFLcEeJZPA,REFHQCBC.SCGGaCBADGBGMACACABE.GAEFHEDGOGAEhAAALCFGEFHD..hADA.JAEFAIFGIEEAhAAANIBDKFAETAGCdDBGBHHH......hABA......hAHA.FHCE.,2,-24,-3,21
EOHNAJGeWPZBUSXDcKLIfQagdMVTRYCbF,eHDAZAADSCGFDGACKCCH.LCCA.QFADaAFEdDACVEEChAAAREEGCAEA..FECGEHGCOHEAhAAAAABB..JBHBWDHBhADABACF...XCEC...hAEAcFCA...hAGA...,2,-27,-19,8
cZIUXWMKNAbTPaHJCFQLdDGERBfOYeSVg,TCBCaCFCHFBB.CAHD.FHGCLADADEFC.EFGFBCHG.OACChAAASBAD.gDDGhAAAIFDBWHBAhABAKGEBAFAE.....bEAD.JAFAdCCB..fFFChACA..hAEA...,2,-42,-12,30
SeCNQFbYAfDVWgRXEaZBKcHdTMILOJUGP,VFDGRAADEHGE..BHBCKAHBHABA..MCEFODDAUAFBGDABhAAAeFFA.CGAFFGHDAICG.DBADXCFDhAAA.aADBcGCChABA..TEBEIAFF...hACA......hAGA...,1,-15,-31,16
gTRPcWVfNSbZMYaUIGOBCDFJeKQLAXHdE,dDAFTGBCRFAB......PAHFVDAFSGFAZBCA.hAAAMADCaGFBUDEF.hAAAIBADOCDGBDFChABACHDH.DIGCJDHF.KAFEQDGDAGHD.hABAEEEB.....hACA...,2,-25,-19,6
McEIeZKFNDTfHXAGgUPYSCaRJbBVdQLOW,UAGHSHBGCACG.RBDHBAFHQDED.LAAFMCACIEAHhAAAKCCDDHFG..HFABhADAGFAH..PDHDhAEAaGFHVEFAOGDGEABEeAHB....hADA......hAEA...,2,-21,-18,3
gVQMAILGSJECOUWbcHeXPNfdaBRTZYKFD,GECFSEEDEADBUAFE..bGCCHFGFeCFBXEAH.hAAA.fACChABABCCGTAAAZAGFYFAFhACADCIDQGEAAEBCJHFGCFBFWDEEcAEAPHBCaDCF.hAIA......hBAA...,1,1,-11,12
bPEXIWfORJAdcUYNKGLCSDZgeQMBFHVTa,UGBCKHBGLCFHDABDZABD.QGGGBBFA.FAEEHEDE.aDHHEDCGhAAA...IDADhABAOAHDAIHAdBHA.NCABSFDGhACAMAAD..VGEE....hAEA......hAFA...,2,-34,-17,17
FIEVOGSXecHPCUfBYZWaMNJgbQARDdLTK,DGDEdGDDKFAAECAA.GDEH..eDHFHBBHCAEEUCDFBBACZADC.aFCAhAAAMIAG..JAHFbEBChAAAAFIH.LAGF.hABAIBHESDDCXGEAcGGFfACDhABA...hACA...,1,-18,-24,6
ZUVQLcBaOYRdeECDSFIPNKMgTHfGXAWJb,JGEAUFDHLEDFBCHB..OCBCdAFEeAACDCGF...FHAG..hAAAIACGKDBFMAEFHAEEhAAA.GEAEAIDCbBGD.hAHAZDCE...cGFDaHGEEBCFCBAA...NFEB.hAIA......hBCA...,1,-20,-25,5
dcaTESePAMFfZUVKQBYgNOJDCGXIHRbWL,MHFGFCFCZCCBKACCBAHE......gEBHOGFECCAAGAAFhAAAHCCGRAFFLAAFhAFA.dFFDaFEGSHCEhAHAAEHDUGAH.YAHBNIEDDAEE....hBBA......hBCA...,1,-19,-34,15
GEcaegHUTdJbARQLZBPOSCDXWNKIFfYVM,QBDGLFCABBCFOFEACBFA..DDCEXGCDKHEA.IHADhAAAFCAF..VDFEhAAAGAGE.aHGEHFABhABAdACCAGHB.REAASBBD.fGEEhABAEGGAeAFE....hAEA...,1,-10,-31,21
fZJIKVBcQgRaYNFDAedGLHbCSETPOXWMU,dAEGGGDHLAAFCGBB.EFBGTAAF.OCFAXEFC.MDIFhACAUDCFZAGBJAEGIBBFhADABEAGQDFGhAAA.aHBCNDEE.ACCG.bGAC.SHGEhAGA.fDCEhBDAcEGD...,2,-21,-16,5
DZVRKIHQYacfEUXeACdNFSbMgGPJOWTBL,dEGDFAFBMDIFGABG.OFBDBHBEZABA.RCAG.KAGGHFDCaGGBEBFBeCGBhAAA..AFDA.CHGH..SAHFhACAbADF..hADA.JEABWBADDDEB.IHEE...hAEA......hBAA...,2,-24,-18,6
RgaLBCTfNdFZecEYUVOAHSKDQXJbWGIPM,HFEEDGGDQACGXAEG..JAHHGCDDMAAF.RAFAaBBHBDAACHCF..hABA.TGAAdGEAeEHBhAAAEBBCUDCBAIAA.bFCHPFAEhABA..LEHBNEAH....hACA......hADA...,1,-6,-8,2
ZaLQAOTNbPKHRWISYVgCBXGMecJFUEfdD,ODACTCBC.....PFBGHAGHWGCA..SFEAhAAAVEAFBACDMIFAJEFAEAEAhAAAdBBDaHBA.AGACNABFKFDEhABARAFC.IGHFCEHF.......hAGA......hAIA...,2,-26,-14,12
KYFGgLQWAUVDdTNCHSfbeZEaXJBRIMPcO,UFCADGDEdCABCHBG.HCEA..SAABeAAEEHGC...aBEHJFADBACBhAEAMAEA..PAHDhAFAKDHHFHCA..GEEChAGAgECCQCBEAIBA..NBEF.fCGEhAHA...hADA...,2,-24,-21,3
IMeTgVKfYaZFUQcDOLPbHdCJRBGXNWASE,SAFBEGFH.MDEAgEBE.KFGEfEEDhAAAZAEHUBCEQGAEhAAADHCEOCAHPABG..hAHAdAGDCBDHBHGFNEEEABBFIDHEeBHBYFCAhAIA.cBBC..hBAA...,2,-29,-14,15
bFNaAHBSQfedCJPRMYXTGIZcEUOVWgDLK,SBBDQDACdAADCGFA.REFB...MAFGTGCGGEBHZCCFEAGDhABAVBED..DIGAKACFFCFChADAAGBHBCHH.fEGEhAAA.eHCE......hABA......hADA...,2,-29,-22,7
dNMYKaVcAFHGQgbZBeTOJEfUWRCPDSLIX,FGFHGBDFQBGDZAAHBFEC.OACAJFADUBDCRDFA..DGAHSEFEhAAALFHHdGBC.hABAMDDFKGGEVFCB.hAGAACAH............hAHA......hAIA...,2,-30,-26,4
VfdCaFEBGZOATRLYcJMWHKgQUebPNSIDX,RADGLGEA.JAFCHFAG.QFEEUBDCeCACNICF..IHAEhAAAXDGF.dEAHCDCHEABChABABABG..ODFEhAFAAHIB...cGGAMIAEKEFD...hAGA......hAHA...,1,-21,-31,10
DUTBcVPHJSYWZbedKXROgaELCMAINQfFG,QCBCGEAHUAEGBFGC..VFEFPAAEHACH..SBFGhAAAZAAF.eDEBhADAdHBHKDGEOGBG.aHGEhAEACHHEIDEGfDHGFAHDcAGA..hAFA......hAIA...,2,-26,-12,14
NaBFKPUZJHTDLECdSgeYbVXfQRWIAOMGc,OHEAGBGAaDBEKDCGZADCHBCC.DABDLBAHEFEC.CFEA.dAGBeDHBhAAAVFAC..QFAFhABAIHHEAAAFMCCGBACHhACA............hAEA......hAFA...,2,-26,-17,9
NgdeCZLXFaUGAOfQPKbBSDMYHIVcTREJW,ODACQCBCKGCDBEFEDDFBHGDC.VADERADC..EAAF..JAHBhAAA..NBHA.dEGHCCFCZDDFhAAAXGAD...hACA............hADA......hAEA...,2,-44,-24,20
MCHNRgcDKYFETQJdISXZOAWVUBeaGLPfb,UFDHaDABLBEA..bABGCHHGHFAA.RDCCDGEHKCCEFCED.EGAHhAAATAACdGGC.SACHhAAAOAEAADAHBCHBhACAeFFBPDHBMEID....cDAD.hACA..JCGH...hAEA...,2,-18,-14,4
SKePXLTVARfCZcGNbIHWUQgJDMBaFOdYE,CFDDZEBHGGEF..NEEGHCCEQEFH.DCDCMAHFFDBCdGBGEGGHSACChAAAKBAF.hAAAeFADPAHFLFFChABAAGAB.fAEAbAFF.WDFA..hAGA......hAIA...,2,-21,-15,6
OXGPaJBEHYSKTQcWgFbZUCReDNAdMfIVL,dGFHMCCA..VDAGLEHFGGAHaEDHEADEHFEF.KBGGQBGAhAAA..gGADhAAAFEEAbBAECFDEDGIFNABBfCBGhAGA.XDDBBABC...hAFA......hAGA...,2,-13,-13,0
eIQfYUDHRWTgPMOVNbBGJSFcdXLZEaKCA,eDACQCBCUFAFRDCA..TDEH.MFAFNDHE.BCGFGABDhAAASBBEFGDB.XECDhAAAEBHBaGFFAFFCIGFAhABADBAF...WBHHOBFDJAEA...hACA......hADA...,1,-15,-27,12
aGdUITEJBMgbQeYcSLCfXVRZNDHWFAPKO,OCCHdDAFUDFC..EEECBACE.MEDFbGBE....QBEBhAAA.eHFAYHEGhAAASEABCAFF.hABAXFGGREABDAIBFAGDAACAaDGA.IAHFhABA......hAEA...,1,-20,-41,21
VbaBdACORHJQXYLTDSMfeFKNPcUgEGWIZ,CEFAODACHEDB..QAEGLBCESFFGMBBF.FAGCKHAChAAA.NIDH.UDGD.GGCBhAAAICGGZFAEaDDFhABAAHFEJACH...YDAFDGIB....hABA......hADA...,2,-29,-16,13
LcfKdXIAQegYZDSVbOHFENPaRTGCBWMUJ,QDACeGEAZCAGDFDBSEEH.OFHFEGBBaCEDGBBHhAAACAHABEGFMEDF.JCGHLACAhAAAKHBGdAEBAAHC..hABAYAGF........hABA......hADA...,1,-13,-38,25
WPHeRAMXOLSaVdUKTZfcEGNCgBFbIQYDJ,MIFGXFCALDCB..SAGFdFHAKDABZFDBECHFCHAABCEChAAAIHHE.DCAHJAHFPBCAhAAAHABEAFGD.OBGHhABAVCEBUFAE........hABA.cFGB..hACA...,1,-22,-25,3
SHgVQNfdOJFEIbMLKCTYWPGAUXZBRDcae,XCCBBEGHRBFADGBG..aDGCHFDF.QBAHdGGDOFBHEEAEMCADhAAA.CAGB..TEEDhABAPBDB.AHGA.cGCEhACASFFG.NDIA.FBEA.IDBAhADAKABCWFAD.....hAEA...,2,-24,-20,4
RUbSDMKCfOFJcGBadYgWLHEAeVIZXQTPN,eFBBVGFG.ZBAE.QAGG..TACBRGDAUGGGSFAAhAAAKABE.CHCAfCEHhABAOEAAFDFDGBDEhAAAdEFBgAFE.HCAEADID.IHAChACA.....hAEA...,2,-14,-10,4
HDKbZXeUFEgIRJYaAGdMVBcCPTONQSfLW,dACAMEEDBBBC.CFEG.TAFE..QDFASBCBLFBFhAAADDFEKCACZFABUAGEEGFAhAAARBDF.aDGEAFAH....hABA............hACA......hADA...,2,-43,-34,9
URgAPQTeVHYGfKaJcFWZbMdXNCSBEIOLD,QCGCeADGHFGHGCAGaAAC.FDDFZBCEdAGECGBFBHAGEGDFLCCChAAAUFGBAEAH...PDFChABATFDB..fGFEhACAJEBE.........hABA......hACA...,2,-35,5,40
NcRAIeKZbgPWEXaCYOdBUQSJVHTfDMLGF,KDCDZAAD....PFBGEBGDCHAA..dGFFQGFH.JAHHVABAhAAAHDEGDEIDLAEFhAAA.FCCBRFCHAFBDIHDEhADAeDDE..WAEE......hABA.aHECBGAA..hAGA...,2,-34,-18,16
KMcEZDSJNLWIRGTVAbUaeQdPFOCgfYBHX,aGFCQAAD.dGBFPECHCBEA....fADFhAAABAGCKCBAEEAFSDAGhACALDHDREFATDDGVACCAHBH.hAAAbAGBeBGFFHGE.........hADA......hBGA...,2,-24,-15,9
QfSTcPLeKWNabDBMGdRgAUZXIHCFEOYJV,ZCDBHEFHEHCEOFAB.JFCDQAAF..TABHLBGHhABAKBHFaCFBBBDCMBADhAAARFAHAGFAIGHDCEHE.hABAYDADfDCH.SGDHhADAeGDGNAIEDCCF.....hAEA...,1,-7,-25,18
IdNXVDYJHeMZBEQcUTWACfORPLGKgbFaS,CAFBOFBBLGFCKAAC.FEEE..SGGAdGCA..XBBChAAAVACFDIDEJEAGHDFGeBHHhABABFFB.QAFEhAEATADFAIFE.fFDE....hAFA......hAIA...,2,-30,-26,4
KNPVgFSWOQIMDfcTaUHELdGbYAXZBJeRC,XGDCZFEEBECDeDCERAAF..KAHH..VAACSDFE.hAAAOECAQCGChADADBEFTGGEHGAAdAFDGEAEhAAAAEIB.CAFH.NICF.........hAEA......hAGA...,2,-22,-21,1
ZCPAcVdBRKEQaJMDIfNHeFWLUSXgOGYTb,VDAGBHCHEBDA..QGDFMFEA.DCGCICBHHADGFGADUFAHhAAASEFE.hABAXABHgGEAhACA.OBHH.YDDCbFFDCFDBAADC...hAAA......hABA...,1,-19,-28,9
YPTeVFJAXUODdCgcMNKLISWGbaZERHBfQ,XDCHUEGDOBCEdEEA...CBAH.MBAALHEASADBGEAChAAAZCGFEAHDHCAB.BAHGhAAAQDDATGGEFGADhABADADA.NICF.KGCBIAFA....hACA......hAIA...,1,-9,-22,13
EKMYGPRaDUBLeNfIZdHVWgQXbJFSAOCTc,CFFEEGFCKHEAGCDB.RDBH.UEAEBCADLBBEeAFG....NIADZAAAhABAHDDD.VAFC.hACAQDGEXEEC.hADA............hAEA......hAHA...,2,-33,-21,12
FJAbefdWDKZLTGVNRIPgUaYSHQBMOXcCE,eGEAdHBHDGDAKEACZDCALFCCGAAC..RAEA...IAGEUCGC.hAAAaDGESGGGhACABDEFXABGCFAF.EGCHAADC.hAFA............hAHA......hAIA...,2,-34,-32,2
cXZdJFVKYUAQIWPfNHgGCSDaeMBEbLTOR,QCBC..IECD.fBFDgEFCCCCHDBBDhAAAaBDFBACFLEGHhABARFBHXGGDJGDE.KAFAhAAAAEFFNAEBSHDA.MBIDEACGOHBChBAAdBACYFAD..hABA...,1,-21,-29,8
gMRIDHVBJYLWSZNATEGKFcXOPfebdUCaQ,ECBBFDAFOEDB..fAEFeFADdFHC.CHGD.QCGGhAAAMGEERBFHDFFABACALAAEhAEASFFBAIEAKHBAXDCDhAHAPCCE..aGBF.IBAG..hABA......hACA...,1,-22,-28,6
GKFOEdQLHgcefPaNSZJYAUXDBWTbICMRV,XGCEDAEDBBFA....TDFFCEDBMIAARGAG.KCCA..EFFBdAAFLCBHhAAAHBGDeFFHaEDBZAGFhABAAFFD..UEACIACAhAFAVADE.FFHD........hAIA......hBAA...,1,-15,-23,8
MRQaBDWAIeXdNFZEbJSKUCGOYTcHPLfVg,eDACdGFCZAFDEAFD..JEBESBCC.CGEGGDEDOACGTEGEhAAAHECHLAHFhAAA.gGAEhABARBBEaHBEBBHCACEBXGGH..bFBA...hACA......hADA...,1,-2,-30,28
eTYLOdQJPNZCGMbHFfEDISKVWBgacRXUA,eDACTDACLFCD.QEEDNGAB.CCEAGAGAbEFBFCFGEAAEhACADECAKADHBHAAaHGGRCCDAEIHhADAOFABdAFB.JAAEPHDChAEA..........hAIA......hBAA...,1,-11,-14,3
YQObfDBUTceJgPNWVGEXIHZLCKaFAMSdR,dHBHQFDHOBEHDFFFBDBA.UACG.eBHHJCAH.....hAAANAGA.GFAF.EABBhACAIFADLAFACHCGaDDBhAAAAHIHRDFC...YFFCfDCE.gGGFhADAWBAF..hAEA...,2,-28,-28,0
OaKbIJWVNEPBULcGSfgFRAMQHXCDTdZYe,MEIBHCDBXEAFDGEGZAFA.OFDBKCGD.JAAC..VDBE..hAAANEIABHEHLHAGSHAEhADAFHGCRADDAABC.TCGGhAEA...eFGBIBBGEAGE...hAFA......hAIA...,2,-30,-14,16
BfdTZecHXEVFNaQLUOJSDYRWMKGAPCgIb,CFDG..bDBHdADE.ZEFDeHCAHCEE..XAGGVGAC.FFFAQAFEhAAAUABBOAEFJDBA.hABADEEE...YDHHhAAAMIDEAHHE..........hACA.IHAEBACD.hAFAfEDE.,2,-18,-16,2
OaZWgbMPBQUJEHCRXFTSVedKDLGINYfcA,ODCHaCFCZEEB.....bGFEMGAC.QCBAEACFHBFGXEDBhAAASAHBdFFFDGGFhAAALAFCIADCfCAAhABAAHCA.PEADBHHHCABC.TEGEhAFAKGDD.....hACA...,1,-7,-24,17
cKeXPAZWFfbDYMBTCOJHVRUgLSEIQaGdN,ZDAGFHBGDCCABGBE.OBCCHAGFUEBF.LAACSFEGEEFA.hAEAaFHD..dGGDKDGEXDDBhAFAABID..WADEhAAAfCBE.MIDECDFG....hAGA......hAIA...,2,-48,-21,27
KFdHJIZACDcNGaWgEOMRePTUYVBLfXbQS,CAEDDACBGDCF..aFHFEHBGOFDG.RGBC.PFGB.UBADhAAABCDDLBDGXBFFhAAASGDCdDACHDBE.hABAIEHBABBHNAIE.WCFA...MFAChABA......hACA...,1,-24,-26,2
OLbSDPVgadWFEKcTYJIHBCARXNUGfeQZM,XFDHUFGHeCGDZCFHLAFA.DDEFPADG..VCBBhAAAdAHGFGHHKCHB...TCCAhAAAIBAGBCADAGACRFCEhABAfABD.MECFSADBhACAaHEE.WHAE...hBAA...,2,-27,-19,8
aUeWbANJSFILMQHXgYdDRVPZEcBGfCOTK,SDCDLCCHQFEFHAAC.XGBAgBEF.DEBFhAAAVBEGEFGFBCHHCBAGKFAAaDAChAAAeEEA.AFIDNHBHIEHDhABAMIEE..dAGE.......hACA......hADA...,1,-7,-26,19
JLDIbEGPVNHFTSOaZBeYWUCKfARQdcgMX,dDAFMCCALDEADFGB.EGDBGFAB.VAFEFFGD...ODEEhAAAaABDBBHD..eDBAhABAYFAHCFHBAACB..hAAA...QBEA....hABA......hADA...,2,-35,-33,2
ZJfNEBKCILbSWeTFQaPcXOdRGMgAUHYDV,HEFHVFDG.JBFD..ECFHKDBHLAAF..bBBAeGAE.FBCHhACAPEAHXAFGdAAFMIFEhADAAHGHDAEF..fBHAhADABEHBCDDGSBHF....hAEA......hAFA...,2,-25,-18,7
KPDYRcJSaIbCZBdNQeWTUfOAMFgEHGVXL,MHFGFAFBEECFGBFE.LACGDCHDRFEA..SACHaDABCAAFBHEGhADAQGCHeFCGTGABhAEAOAHFHDCCKHFA.hAGA.YCCEICAA.ZEADNCIG....hAAA.fEEFhABAAAIF...,1,9,-29,38
QYGdTDSaeIHbRfNCKFgUPAOVLcMWXJBEZ,LFFCMCCA.XEBDBDFBEGCG.QDBEdDAESHCAhAAAeACEHGFGRBBCCGHG.gGABhAAAAGGFOBHFVAEEhABAJEDA.ZDEE..YBADDACE.aAHBIHAAhAHA....hAIA...,2,-12,-5,7
UQZPXaMYfEdJNFBGOSAKCTIDLgHcVWebR,KFFBTGGGLEBD.HECGVEAFeADHUDFEQDGAZCAA.hAAAXBAHaBBCMABEfACAhAAAdCEGFAHFBHEHhAFAOHCC.CAGADAIDgGCAWAFF...hABA......hACA...,2,-10,-9,1
CFUVDAMXfNYPJOaRGEQdTbIZHBWScLKge,XFDB..YHFCJCAF.aEGAEAHF.dGBB..IHDGhAAABABBSAGFhAAAKDBCCEBDUEDGDFHH.AAFFNEDDRBCEGAEFhABA..QBCA.ZCFAhADAcFAC.eFFGhACAFGFF.MDFE.,2,-14,-11,3
cdUPRSFXQgKADYTHfbWeOZCIMJBNGaVLE,DAFBHEFH...bBAEeAAFZBGH.MEAGBAEEGAGGLECHEGFCdGAAhAAAUDAAREDA.SAGEhAAA.FFHDgBDDhACAAABB..fFEECHHEICBC.NIDF.hADA......hAEA...,2,-18,-11,7
JTDZYVFNMHBPECbGWIagRQLeOKScUXfAd,dGDDJEGHZCBFFCFEHDBC.BGGACBFCGEDA..IABCRACBLBAFhAAAeAEAKHBGUEGFADEG.hABADFAB...NAAE.EGAFhACA...aCGF........hAEA......hAFA...,2,-32,-25,7
RCMHATLfJGSDYcIbKWBOQZFPeNUEXadgV,TDACLEEG.GBEDDFCG...IBBGKDEGOHAGFGGFeGAEhAAAUAABaAFFdGEA.RDGHHADFhABAfACD.SDDChABAYGDC.WAFE.BEAC..hAEA......hBAA...,1,-18,-21,3
ZfDCXaWbRLPEJVMcIBSFKOAHGNYTQegUd,HEBHGAFETCAFeCBFdFFBDEGC.CABA...aAAERFDBLHAEEDDC.hAAAMIFAIAGGBECBFADGhAAAKGGEAFHE.QFEAhABA.gBGA.fAEEhADA....hAFA...,1,-13,-23,10
dHeOGJYZDWIPfERABXLcSbTVaNQKUMgCF,XEBESDCD...TEEAaGECQCDBMEHH.FABAdCGHhAAAHFFCeHAGJHAEDBGAPAABhAEARACDBEAD.cGEEhABAbAFFKEFCCBEB..YGAC....hACA......hAEA...,1,-4,-20,16
XSfZOcIAWeYgQaJMdBEbCFLKNPVUGRHDT,eGEAQCBCMDCCdDGDEGDB..FFHFLAEEKAAD.VDAHUGAE.hAAAGBFADICCSAHHhABAfFEGZFCGIADAhABAAGIH..........hACA......hAFA...,1,-17,-27,10
WMGRJCESecIXQOZKLBgFYfATDHbUaNdPV,TFCAHFDGUBAB.aEACdHGB...VAECMBEARDDG.ECEF..SEHDhAAAIEHAOCGBhAAAKCAHBDCCFHAAAACCDBIHhABA...NEAE.........hAEA......hAHA...,2,-28,-23,5
fdgEMSIVRBYGcbXOTKAWFZPHCQLeJaDNU,FCFCZGFGHAAACFAA.eCFADAAD.UFAAdHEF.MEEH..VECDBFCHGCAFhABA..XAEChAAAKFFCAAHG.QCCChACAaBHF.fAGD..EBCGIFGAhADA...hACA...,2,-42,-7,35
UGaCeNbAFBTEWYOMLJgXPIHfdKZSRVDQc,FFFBBFCFEAHDOBAD.LAHFJCEB..XAAFHFEEfABDhAAAKDBCZGBG.RGBAQCCFhADAUEBDCCGH.NEIAAEEEhAEATACF.MEIHIFAG.SHFAhAFAcAEA...hAGA...,2,-34,-5,29
LdcfSEgCGVUBeTMaXRODYHIKbQWFZJAPN,LGEAdHBHSAEHCBCGUDDFBBGG.eEFBaHCC...ODBDhAAADCAFHAFCKDGB.QDGGhAAAFDDHZABGAHID..NBAE.EFAEhABA............hACA......hADA...,2,-29,-29,0
CLFPGHUaZSWDcRgfdTNBYeAVQXMIbKJEO,QDCBMFFFKHGE.EFFFOEADLBDEFEDB.HDGDZACG.DABCRCGB.fEAGhAAAdAAEBCEGAFCHIHAAhAEA.CAGBPFCBhAFAaAFD...WFED.....hACA......hADA...,1,0,-38,38
NePAfUXaVSIDLKQYcBTJRWOdEGMFgbHCZ,UCGCVBCF.DGBBLBGB.KEAAQCECBAEC.RACCOGFEhAAAdAABGEECFEDHHBAFhABACGDG.eFFCfHGFhADAaFAA.IHAA......hAGA......hAHA...,1,-16,-30,14
SIOCUEfDXdcYWQHBNGAeLJFRgKTVPZbMa,JAABFCFCRDCC..KGBF..TFACZEGH..aGDASHFC.hAAACACC.EEEEDDIDdAGB..hACA....WGFEhAAABEBHAEGDLAEEgCBCPBADICGEhADAfHCBYAEF.hABANICD...,1,-33,-41,8
BdUYOTVHGLWAJaRISCDeFbfcMQXgPEZKN,JDCHaCFC..RFBB.CAGA.DEAF..FEFB....bCAEMADE.QAAFhABAXEEFEFHBKBDBBHEFhAIAUACB...OEGDhBDA..........hBFA......hBIA...,2,-48,-36,12
DYLUagWCQZKdTBJFHPINXeVcRfMOAEGSb,SDAFDACBUFFG...aBCGCAGDKECBBHHG.FDGAHBDF..IDCEhAAAeEAB.RFACMFFGhABAEGCB.GGCFLAAFhADA..WBFEdEHA.......hAEA......hAFA...,1,-22,-33,11
FgeQDNdcZOCIKXSVEBLMATRHfaUGbPWJY,RABHHDAGUGCAGBDC...PEGHJFFFFEACQGCA.hAAADAABNEDD.ZFAF.CCGAIBCHhABASGAFBAGDhACAAFDA.aFED..bADF.....YCHHhABA....hAGA...,2,-48,-2,46
VXUYQdaJLBZNDORFSfHTGPEWcKMAICbge,CFDGeGEAUBDHQCGH.dCAEaDAFBFAADHBA.FEEDHGFGGAAFhAAAEEFC.KDDDACGH...bGAAhABAXAACLAFEOEAHhABAfCEF.......hACA......hADA...,2,-39,1,40
eGbNYWTZXQJLHEfdKCMDBIaASVcRgOUPF,SCFCVGFG.RECC.OCBEFADF.eBFDGCAB..bECFNIEF.hAAA.....TEGGhABAXEFGJFAFEABFhAFAdGBGCAGGBHDFAAEAUAAE.WAHH....hADA......hAHA...,1,-17,-23,6
NaEZcSUFbJXLfABgHDTeIOYGRVCPWdKMQ,HDBHDECDeBADOAEHRCDH.CFAC.dAFEKFHH..MEIFQAAB.hAAAEGCASFFEhABAUDFDFAHF.XBGDAADFBGFC.hABAIBCE.VGEA...PHAAhACA.....hAFA...,2,-26,-16,10
QTCUBNMLRFVXGEgWfHDbOIeJYaAPZSdKc,ZDAGKDABQBCFUGDFBEDHLBGHFBAB.GABDEGAA..gEGEhAAAHFAFDGGBOFFAhAAAeAFAaDEGAABE.dGGECCFF.hAEAMFEH..........hABA......hACA...,2,-22,-21,1
HRaWUOfNgFTVPBEJYKebLCcIAZXMSdGDQ,ZFEEMBDHSAGFDGBDHFFF.RADB.UBAG..OHCC..gBFDhAAATDCCPBABhAAABEAEEAHB.KFDFLFABhABAIEHEACCHXDGE...hABA......hACA...,1,-15,-33,18
IageBGYOTbfUMQDZAWLENXcRCVFJSPKHd,EDCDXCBCRAAB.FGCDSGAA.KAGFdBFG.IFGChAAAeFECBGHCOBAA.fECAhABAMBEHDIFGAEFELEFFhACACEAC.JFAD.aEHFYCFG.hADA......hAEA...,2,-33,-23,10
OCJMYNUKdbIDXHSVPLcZTRgQeAfWEBaGF,EHBGBFFCFCCBJBAD..MDAFUGBF..dGGDDFCCHEEA...SAAFhACALDDCZAFEhAAAgFCBAAGE.aBFBhADAOABG.CHGEKCGCXCGG...hAFA...cEGDhBAA...,1,-14,-48,34
cFJUeIdaGZRNCbLBVESAXWTOKfHgYPQMD,XCGCTDAC.KAADHFBG...PCBADEBAFFDGUFFAdAEGZGAAhABACAFABABEEGGG..AIGE.fCFGhAAA..hADAgBCDMIFEJCHH.eBFEIHBHaDAH.hACA......hADA...,2,-28,-11,17
FQRcBAaGDdCMYIfPgeSHTbONWULZJEXVK,aEHBDACAdHGH..CECD.MDEG..IAAD..PBFChAAAgAEGeFBASFFFhABAHDDAOFDENIAHUCCChAFAZFAHECBA.KCGAFDHD.......hACA......hADA...,2,-26,-24,2
eDHEfUMgIVTcbJSCFAWdKGPOBLRNXZQaY,dAFBGEAHBBCELHDCRAADZCDE.aAGHDFHDEACH..UEAEMBBF.VDEChAAA..TFEEhAAA..cADDSCHDhACAAIBAKAHB...NIBF.XGGB..hABA......hACA...,2,-36,-12,24
cBHRDLAefaYWOVKgUMNTbZJQdSCPXFEIG,aDCDOGEA.KGBHMBFH....TBFEbEECZAFFdFHE.CCAE.FACFhAAAGDCCBHECDGHBAADGeABBhAAA..fBBGhABA..YBEFWEAD....hACA......hAFA...,1,-30,-35,5
CWRJOPaSUeGLHbXcVDMYFNBfEZIgTdKAQ,CHHGRFDFODAD..PCAHUACGLAHB.HCEHXFCFhAAADGGAFAADBABHZFBB.IFHAhABAdHFFAGAB.QCEAhADA.aDCC.SCHH.hAAAbAGB.MFFB.fBCFhAEA,2,-24,-24,0
gDUYMFOIHZXKAGSbadBecRLJPCQTVNEfW,SGAHaAFBBEGE.RAFALCHDCDHE.QEEGTEACEGCF.hAAA.fDCFhABADHGEUBAAFEDFICAB.hAAAZGDCAIFAbFFCeBBEJCCANFAF.....gAGFhABA...hACA...,1,-12,-22,10
aAVFIUdcOLCHBJRQbeMENTSZYDXfWgPKG,VDAGUGBCOFFE.HAFCBBHE.QABHMDCA.EFDCTAAChAAAZGBADGGA..fEAHhACA.WEFEhADAPHFGGECFAAGEIDFGcACDCHDBbADB.hAFA......hAGA...,2,-28,-14,14
HabWCKLATXIFPVMgDedGScQJfOZBREYUN,TCGCFGFCMHBC..DHAGeBABGEAF.SAADJCGHZAECEAAGUGFAhABA.HADC..hACAaDDCCEEBAIAAXECChACAICDE...........hADA......hAFA...,1,-16,-34,18
YEHUOVFJXeWLMTSAIbNcaRPgBDdZGfQCK,..IFDGNCCA.RGDA.BCAGZAEF.GDDFQAGCKBHFEFGEHCAHhAAAOAEB..FABFeFAHhAAAWEDEMIBE.ABBAaAFFhABADIGACCHA..YGDE....hACA......hADA...,1,-20,-24,4
HBLIKENRGXAQWMSDUVFZdcCfYPOebgaJT,MFFFUCBFFDGFZEGHdFBG..CAAE.....fAHCOFCHeBFEhACAaCAGHBEHBADDKEAFhAEANCIG.GEECAGDH..hAFASAEEDDIH.YDBG.bAAEhAAA......hABA...,1,-22,-38,16
eDcKgTWfQEARHNBMPLGbYUFSJZaXCdOVI,RGFGBFDDMCEELDBH.GEEBUDEGSCADJACEZBEB.CCCC.hAAAOHEA.eBHFhAAAKFBB....gEGBhABAfHBFABCENIBB.......hABA......hACA...,2,-37,-31,6
EfNZCYHFebTgPcAIGQKVRMJUXOdBLSWDa,QAGHVBCF.JDEGOBFF.BGAHLDBDDBAA.fBAChAAAZCGBCDAAHFEDFFFE.hAAAeHEA..TEBFhABAcABAAEECKAGCRECBMFAB.dAEAaADA..NDIE.hADA......hAGA...,1,-9,-23,14
XZDaFRdBNMgAPbfWVCTKGUOYJcSIQeLEH,...PDCHbDAG..VAGBCDGAGADG.OFHBJEFF.SHAChAAAIHEDeFBChAAAEFECHAFDXABCDBAGaCAFhABAFCCGBFAAMACEABIDWHCA.....hAGA.KEGC....hAIA...,2,-20,-6,14
cRfXBQGeADJYNMCWTSUgbILVPFZEHaKOd,DEFHJGEA.MBGH..TCGCUGAH.....IBDELACGhAAAFDABZDAAHFAFOHFAhABARCEDBBBAQEGAhADAAACANIED.SHDG......hAEA......hAGA...,1,-30,-31,1
KQECGNPFebVSMUAadHfgcJYDZRTOWIBLX,aEHBdCFCHGFE...fBAEgFDBJGBGDFAC.ZCEGOCDBhAAABGGGKAGGEAEGGBGGhABAFBAC..bBDCSBBBhACAACIDRGAE.WDADIAEF...hADA......hAGA...,2,-22,-15,7
BWFIPXaSUATEcMHJfNegDCGRZQVbOKLYd,EGFCMECGHAAB.JECBeAAE.DAGCRADEZEDDQBDE.OGEChADALFAFBGCCIHHHhAAAaDFDAFAB..fBFHhAEANCICCBHC.........hACA......hADA...,1,-24,-31,7
bJRAKCIUGZEDQaXVTWdNFOBeLPSgYfMcH,CFEDUFGHZCGF.QCAA..VEAEdCGAFGBHBFFBLEEDhAAA.SAEGhABAfBBDMIEAHAEEbACDAACAKGAFhAAA.EDDADFABaHGE.....WGDGhABA.NIBF.OFCF.hAEA...,2,-31,-9,22
LMFZWEeXIPAHTGUKDacgORSfdJbYQNBCV,TBCFUECBKCAE..aEBGOHDA..fDGGdDDB.JAAEhAAAbFAH..QFCBhAEABBEGLCHFZAGFEGGChAFAXAGCADFFDIBE.RFFESADE.hAIA......hBEA...,1,-19,-24,5
RGAfbZLIaMQcJCOgBXKDYPFUENSeWdTHV,ZAADaDCD.QFFG.CAFB.gEGABDEAKDCH.DABE.PBFGhAAAEDGE..SBFGhAAAeFAHdCBGTFDFhAEAHEAF............hAFA......hAGA...,2,-31,-30,1
HUTBZVefXSDROJLcAMGPWQabCEIYNKdFg,GBGAQCBCCFAG.EBFC..ICAEKEEGFHFAUFBCBCCEVFDFhAAA..eAEC.SACBhAAADGGB.OGDGhABALFBBAEIHMICG.aDEGYABChAFA.gBEChAGA...,2,-39,-12,27
cJIHUWNfAdDgOPLQTRZEbYFBXaSCeKGVM,dHFHDEFHODBBQBFHZGCA.EDBE..FAHFXGDF.aADECGGGeCCBhAAAGDFEMABEJAAEHGAEhAAA..WAFBhBAAADDC.....gDGF.LBBChBFAbEAC.SEDHhCAA,1,-13,-26,13
YDULgOKBCIFHASMNeGXfWJTPaZdbQcEVR,SGFHeCHDGECC..XDACJADAaHGE.ZFAE.dBFEQCEGhAAAEBCARDDD.DACDLDHDhAAAODBHCHAAFHCEMFFBhABAfBAE........hABA......hACA...,2,-18,-18,0
MBCUSFcIPDgTGKEVLfJOZbAWHaedRNYQX,HDAGaEED.dGAARFCB.QFDEBFAHUBCBFCAG.....PBFBhAAADABGTGFGKCHHEAFGLBHBhAAAOHCCAFGDeAFDhAEAXFGD.CABF.SHAA..hAGA......hAHA...,1,-8,-34,26
GeNfWKJHaYQFcXOVRMbPZDBUCTLdSIEAg,eFEF..fFAFJFBDHGFA.QGEGFDECOBEGVAEARBBC.hAAAMEAEZDAEDBACBEFCUDGEhABACAAELCBG.hACASACFAAHG.NBICWHAC.KHGG.hADAaDGF.....hAEA...,2,-15,-3,12
GKRBODHVUMZcfCQWIEgaJPYLbSFTeXANd,GEAHBCAHDDCBHAADUCGCMHFG.ZAECCDEH.QDGB.IHDDhAAA.aFFCPACFhAAALCCASFFGhABA.eFBBAGAA.dAECKHAEOAFC.hACAfGDC.hADAEHFA..,1,-4,-39,35
DZKgfJVIceRHCbULGaSFENdAMXOPTQBYW,MIFGXDAC..ODFBQDEDBCHEDBAEKBFG..JACDVDCBhAAAeEGHHGCCUGAEaCAHFGDChAAA.EBABACCC..PFAHhABA..WAHHfGGB.IBFChACACECA....hADA...,2,-32,-14,18
QHPFbeaZRTOSMAIfBXCdUVKgWcLYGNDEJ,BFDGXGAFdCGGUBBEKDFG......gECELFFDNAEDhAAADBDH.EGHDHFBBFBBHaCHFhAAAZBEBODAB.hABAAHIBCGGEWAEC.YCAF...JFFBhACA......hADA...,2,-28,-27,1
YbWTAMBQLEPJCVUfgKRdHOSDaFZGIXecN,QEBCEDCD.JGFAUACA.KEECdEEDHBFEDBCCFHDGGGAB.hAAAeHFE..YCHHhABA...bAEFhACAAGAABFGC.CFDHfBAFODAH.aAFAhAAAXCCFNDIE..hADA...,2,-32,-17,15
IYeWEFHROKfQcDCLgZbJMUBVNdaGAXPTS,XCGCSGFC.eFABFFGFRDCD..OEFAKDAC.QECDhAAACHAFLHCEZCEE.MBEChABABACGNCBB.aAFAACIHTDADhACAIBAEEGCF.fGHADBFD...hAAA......hABA...,2,-40,2,42
RBWKfMOPGaeHATdUDNCZScgXJVEbQFYLI,TFCADDFFCCDG..ZGFESBFH..XDGHJBBA.EGBHhAAAFDADLFCBRFEFBGHAfGAAhAAAOEAG.hABAaCHBHAFAAAGG.NEEA.cEFAgABA.hABA......hACA...,2,-32,-19,13
EgOYbWFTdGJQAUHXPNfaICDRVMZBKLeSc,HCDBXCBC..PDAFaGEE.DGFBVDEEBGGG.KBHFLFCBhAAAeDHH.SAEBhABAEABDOFCHbFGDFADGdGAG.hAAAJBBAAFDH..NAGECHAE........hACA......hAHA...,2,-20,-8,12
DFQOEYfeHLdGXVTWUBJMISZNaPbgKCRAc,DGHHFGDDODFDEACG..eCFHHDBAGECCVFAD.UAFFBACGJCBBMAIHhAAA..SGADhAAAaAFF..PHFChABAKBACAHFE.QBDAfEHE....hABA......hAEA...,2,-26,-13,13
EDaNFOeCSXHIYgKQVfWBMdPcARLGTUbZJ,RFBHLDACGAGAUACGZGCGDACH..FGFBCBFEHCFC..IFAAhAAAKFAGQEED.hABA.fHGHhAFABBHEMAFE.dAAEPDDEAHHC......hAGA......hAIA...,2,-31,-25,6
UNJTeSROYBdLIZPCGVaAWHKbDgFQMEcfX,HDAGKHFGDCFCFEGG.EADF..XDAGUBGH..JHBGSEDAhAAA.RABFBAGFIHHGhAAACGEFGDGEADDE..hABAbFBGQFAAMAFHfBAF.eFFBhABAdDEB.....hADA...,1,-12,-27,15
IYURQXeFbdGfKLZgNEBHPAVJCaOWcMSTD,VFEEaDAB..OCEFMFAC.DEGE..UGBEREBE.QAAChACAFBGBGACCLADBZFGBEHDEBBAEhAAAAIHA..JDHHCGAH.hABAWBEH...SBHB..hAFA......hAGA...,2,-27,-24,3
NHQCRAXdLJSOPgaYKeDWZbMfGVUBEcTIF,XGGDLFFBSCAG.OAFBgBFA.aFEBhAAAKDEFDECEZABA.fGCGhAAAVFACBABCEEAFICBAhADANCIC.CDHBABEF.PAEAWAHFMDDFhACA......hADA...,1,-23,-29,6
cBCYXWGEKDAZRTeJgHIMQPdSOUfFLVaNb,RBCDTFCAeHDEHFFA.MAHDdDECUAFG.FFGCLEAF.hAAANACBBAACCABFXACEhADAEFDCAGCHZDFAIHHE.hAIASCCHfCBEaCHD.....hBBA......hBCA...,1,-9,-27,18
WUaNCTbKMXSAJgOYdIFEGDRfPcZLBeVHQ,JEEGOGEA.dAEDEFBARCDD.......PAEFZAAFBHDDeFHFhAAA.HGDGUDFEaACFNAIE.hACACBHF.KFAE..MBAHhABAAIHA.ICBDDFIF.fEAF.hADALAGD..hAEA...,1,-22,-38,16
AFgLVKHZETMdIPaWDGQeNbcRCOJUBSXfY,LCCHKDAFECEA.TFGBMEEB...dACFaGAEDBFCGACB.eFGBhAAAbEDHRCEA..CBABJCCBhABAUGAFBDFASBADhAAA.fDBAAACEFHEE.....hAFA......hAGA...,1,-13,-23,10
aECBGebVUdYTINfHgQMLAXJcSPORKZWDF,XDACSDCDRFBF.KFEAZGFE..FGHBaDDFEGAF..BABGGDEFhAAAeFEFVBCGdGACTBFFhAAA..NHCBgAGHhABAMCAAADIB.JCAFODHHDICECAFA....hACA......hADA...,2,-18,-7,11
RVALGefBWbdCHgaNMIJFESPDQUKZXTYOc,eHDABFDGdCABHCCC.aCHFMEEC.FEBBPGBA..DGADKAAEZGFAhAAAXADEOBDCRGBEAFFGLAGDhADA.fHGFhAEA.CAHA.NDEFIABCEEHBSCBFhBAA....hBCA...,1,-7,-40,33
QEORbJISKLWcMDaXCfAgVZdUHNGPBTeYF,VGFGUCCBHAAE.GBGCTCDBFAEGEDGHOGBA..RFACIAHBhAAAKDFFLGFE.hABAMIAGDHCCCDAEAIFAdDAENCICBEADhACA...eBBC......hADA......hAEA...,2,-21,-13,8
GLWHRPDeMEfQCbUdFYKgSaOVBNXTJcAIZ,ZEBHLFEFHBBGDEHDeCDAMFFDQGGG.UFAFFBGBKDEDaBBDBAEChAAAXAEB..hAAATDGEABIF.WBFEhABAEABACGGG....dCACSHAG.hACANEIA......hADA...,2,-23,-17,6
CScgHIJBAYeFMVTdGWaPUEKNQZObLRfXD,FDCDMEIBdACBGCBG..aGAHEFFDKGGHQABHZGCE.bBGFRAEHDDGHhAAA..CGEDSBADhAAA.cDDEhABAHBAABEEGAGAD..YFBFeBHF.WAFChADA.NIDF....hABA...,2,-34,4,38
EFbPUJKdXeNADcZRfGHWICBYVMgSOQTaL,ZFDGREBHGBAAHCDACGHDBDDC..MAFEOFDEQDAHLDHDFACFhAAAUAEDdHEF.eHAGABBBDBGAhABA..fACAhAAA..ICHF.....hABA......hACA...,2,-23,-23,0
NSPEMDKRaVeTCfAYcIGJBXdQZLFHUbWgO,..IFDGBDHBXEFFdAGGZACG.HFDDUDAA....WHAAhAAANIEF...EBGEKEECVBBEhABAeEHD.CHBBAAACGDAEhACA.JFHF.........hACA......hADA...,2,-40,-13,27
AagTDKYVfCcJGPBUQZSEWeLdbXHFIRMNO,TGBCDGHHKACG.....VDAFCEAAGGABBFDEZAGFEDEE..LABDhAAAdFHEHCCGFBGCMCAGhAAA.ABBA.aFFF..YFFFhABAfECEJADA.......hACA......hAIA...,1,-14,-35,21
AgPVGEZSUdLORNCHTMebJBXDYcIfWaKQF,VAADECAHUFBC.LAFDOHBA..CEBDHEGDMIFC...eAFHhAAABAAHDFFBIFGDhAAA.aDDFFADB.ADGBPCDDhACASGEGdAHENIEFTACC.XAGAhACA.....hAFA...,2,-19,-19,0
JUXBAWTCYLIPVHfZeSOFEgQcNaMKRdDbG,CHHGLGEA.VDCBHBDE.ZGAC.eFFCSBGFEDGG.QABGhAAANAAF.MDABhADAdCBCDFBAJCHDXGADhAEAAGED..........hAFA......hAGA...,2,-36,-25,11
HFODgRGKMYXadfCSVbNLUeJBZTAcEIQWP,EHBGQCBCHAFBDFIFRBFEGFBHKAAB.MBAGaDAH..dDDGCHFHSHBGhAAA..NCCEUFFHhAAAJEHFBAHAAAHBIBDEhACAFDEEODAH........hABA......hACA...,2,-26,-17,9
IgTVJDLbNACQHSPMBFcROaEWXeGUYKfdZ,CFFCSDAFBAAC.REEE.aEFA..ECHBeFDDGACC.UGBAKAHBdGAAhACAZGEA...ICEEhADAgBEH..hAAAJADGDAIH..bCBFAIFE.....QGGAhAHA...hABA...,2,-32,-22,10
MNUSCgZbKHQXeGYFVaJOcfIWLTABERDPd,EGFHDHCEdDDHUBDD..SFFAZEDEKAGGHDAG..eBGFGGAFhAAAFACGJFAE..fBAGhABALAAFABBBBHHEhACAMBIBCBBB...gAEF...hADA......hAEA...,1,-21,-32,11
MOfZFaAeXHGbPIdTVSCNcWLBDEUYKJgRQ,XAEGHEBHGEGG.IBGFdHGDSDDBCBCC..NAACLDDEhABADFCBEHDGKDGCJFEFgBAEhAAAMBBH.fFAEhABAaAGAACDC.PFFA....hACA......hADA...,2,-29,-11,18
MGQOZJcLBfTgaUXWdeVACKYPIRFSEbNDH,KEGD..PAFBFADEEDAGDBAE.GBGCZFCCLHEGBHAG..fDAHhAAAaHBE.XGGEhABAdDECABBACHACRAGBSEBAhACA.NEECMADHOCCG..cGAAhAEA.....hAAA...,2,-31,-15,16
LOICcGDKaATVBJPFWbZQYdHNEfMRgUXSe,TGDCVFEE..BBHCFECCZFFCdCCGHFCF.EEBDMDBB.RABBUCGDhAAAeAFFOHFECHHD.hABADADEAAEEJHAA..bABChAAAQAGB.fDDBSEFEhACA......hAHA...,1,-15,-18,3
UcAHeIDLdNWBSRFKMETfCXYVgQOaGZbPJ,HFDFeFCHLEEBdBFHBGGCREABMAFE.EDCACBBC....XDFEhAAAVAAFQBEBhAAAaADBGCABZCGB.PEABhACA...UGGFADFGNDIESHAA.hADA......hAEA...,2,-18,1,19
eAQIKFObCdMYLBPRSUNJcXZgDHWfGEVTa,KGFCOCCHCCBH.dAGBLEABRFBA..SBAHUGCF.JBFHXDFDhAAA.DDDDfGGDhAAAGABFECEBTEEAhABAAIAA.FHECMIFAPBHB..cAGAhABA.....hACA...,1,-28,-31,3
VDSANGQfZREeMFgIBTYWPOUacbdHJKXCL,QAGHZGFGeAHDMEEHFEFEBHCD..TABG..YBCFhAAAPFCD..aAFHdGGEhABAKDAECFAEDBDG.AGDA.fDCChAAAECAB.IFGC.OEABhABA.....hACA...,2,-42,-13,29
EFUIdTVNJcBPDAOWRMLabYCZfeKXHGQgS,OFBBRFACMBDH.LDGD..aAHHCBDFeAFAKAACHFEEGCAHSHDGhADAEHCGFAACdFEATAEChAEA..NACFBGHAhBIAAAIBbDFA...fFCB....hCAA......hCBA...,1,-13,-17,4
RfDFBNJSLHeWEGYQVdIbMOPAXaUCgcTZK,XFCAaFFB.UBAGCCBA..TACGZCFAKDCHDEHDBAGE..SAGBhAAALEAH.eFDDhABAEHEC.QFAGhACAdFFBIHHDOCECAEEC.......hAAA......hABA...,2,-32,-26,6
gLFHORMGAfTEbBNVQXJdIZeaUWScKCYPD,EGFCBFDG.QAACJFCBZAEG.UFGG...SDBHhACAKCAEPDEDDHAA.FBEB.OEEFhADAMEAAAGEH..fBGEhAEANABD........hAFA......hAGA...,2,-46,-36,10
LRQYbNGBgFKdaAHcOWXJICPTMESeVfDUZ,HFDFOGEAXBAB.CHAH.MCAB.SEBCeAEGVCCBUABChAAARCGFQGFChAAA..YFHBhAEA.GGABFDAHaGAAABDE.WCFDPAGBfACBhABADAIFZEDG....hAGA...,1,-5,-13,8
JGXZPdBOHbTWgNaDLQeSURcEFCMVAYKIf,KHBGJGEAZDDABEDG.HADA..TACG..NDGADGACeDHHRABD.EGAHhAAA.FBFCCBHH..MEIBhAAAAFDA..ICADhABA.XEAEdHFD.OHDCgDAGhABA.aDHB....hADA...,2,-36,-19,17
IUMDRNFbTSOgABZKYVePHfQJdacWGXCLE,KBBDVFDFeFBB.HDEEQAAFdGDE.aBDDGADD.CAHBLFHDhAAAIFAEMEEEhABADFGB..NEAA.FGGASACChABAAADGBCGBPDCBfDCAWAHB...hAFA......hAGA...,1,-9,-28,19
DQYbSHeCFfAXNPEGJLMdZIOgKVacWBTRU,XCBCEHBGLCFGdBFDZFFFOAEE.KDCCaGDEBCBC..UGAEhAAADAACQEFChADASABCHDGHCHHEFFACAHABNFAB..hAEA...JHEA........hAFA......hAHA...,1,-20,-26,6
MQZLdJXGaNIDcORKfBSFUVWCeYEHPTbAg,QFDBZDEDJDAE.GBDE..NAHA.IDAC.DFCDOGAGhAAARABDBHAHUABACHGGeFHBhAAAEAFHHGFA..hAEAbAGFAFAGMCIH........hAFA......hAIA...,1,-17,-31,14
KIeDUARbGSOLEHFVfYMNcWBTJZdXagCQP,REBHSGAHOHACLACGHFGDFBFH...VAACMIFA..NDCG.hAAABFHF.ZDDAXEDHhADACDHEKBBFeGDEDCIBAEAA.hAAAEBDFfDAE..YAHDhAEAWAGF.dHEF....hAFA...,2,-21,-13,8
ORQSJCZBfMabgXHeEGNFAKYPdULVTWIcD,KHBGdHBHLAAC..TCBFIEDBOAGHRAEA.QDFBhAAASDGHCBEBBHGEhABAfFFGMEDH.gEAHhAEAXEAHEFHBNAIEACDD......PFHFhAFAWBHBDADFaGDF..hACA...,2,-34,-11,23
baMIZWAfRPBQcOgLXNVSDEdTHUYJFGKeC,RAADQGGGOAEGLFGD..NEAESEBHDECAdDFDHGCAJDDGhAAAKDAD..CBAHMICAhABAIACCAHFE.BBHBgDGFhACA.ECCATBFAFADA....hAAA......hAIA...,2,-28,-18,10
XQPgCeMcbJBRNWfdZAEFVTIaUSYGHDKOL,EEHBTCCBUFDC.GCBEKEGDLAFA.QABGPAGFCAEF.hAAAMHCC..JBABBAAGhADA.RCFENEAEfGFDhABAAIFEIFCEaEEASEBFDICAXGAG.hAEA......hAGA...,1,-15,-20,5
ZegdJAXGMETKFWcVIfbRHUDSYNQPCaLOB,MGCETFCEFEFC....VABG..IBFDRDDCHAGFDFGGSGHDhAAAQEABCABBOEADhADABHHCeBAD.hAEAJFFFAECCXDDBEGAB.KHDE.fCHAhAFA.YBBGhAGA.aHAE,2,-23,-11,12
JUYVWbDIceEQOBMZHagKLFPXAdTRNCSfG,RBCFSEGDGBFEUAAC..VAFADFHH.eDBHOFBEBAAB.MDDAhACAaGGH.KBDG.LHFAhADAXEACAHDANCICCDAB..hAEAJHAA.......WFEBIEEFhAFA.....hADA...,2,-33,-17,16
HbgRJZBQCNKXGcASIaPfTdMFLUDOeYWEV,SAFBaHBG..fFAFMADHUCFFOCEHeEBCEFGHHAABhAAARAAB.ZDGDBHHHCGEBXAEEhACAAEID..IGEFhAAA.dEACDDGBWHACbDAE.....hADA......hAEA...,1,-19,-20,1
TXSDgeaMbLRZNWAYOPBGfCIFHdcJEUKQV,OGEABECDCCCHHGFAdAED..ECDHUAAF.KAEEVBAB..SHCChABADDFBaFCD.LEEAhADARCGHZFAFAAIF.GBEFhAHAIHHH.....cABF..hAAA......hADA...,1,-26,-28,2
bOCcHZDSgXWfeUBJAGYEKdFMQRVTaNPIL,EGAHFDABMFBFREGF..aACD....IFCBLDFE.bAFGCFHAZEEDhAAA.DAGGSECBhAAA.XBAFhABAWBAC.fEEGBCDEADDFKCHFdGCD...hABA......hACA...,1,-7,-51,44
aXGfeISEcAYTZBMOQCLKdFHPgUNDbRWVJ,ZEFHOHAGLDADdBABFBDCHFDH.UAACDAACRDGHJHAG..GEDAhADAeBFG.EAFDAEBBBCDG.hAEACFHG.KAGC....hBIA............hCBA......hCHA...,1,-32,-33,1
CKHJDPcVdYZFGLaISQMWROUbXTAEBeNgf,eCAF..fBGAKFHHDCDB.VBDBZGEAFGABaGAC...SEFDhAAAQFGDMCFChABAWCBH.RAAF.OCEBhACAbFEDACIHBHHDCEBA.PAEAdDGA.....hADA......hAEA...,2,-31,-5,26
RNYOFDVGUECQZbdfIMHXcgaWeBLKSJAPT,REFHOGEADAEEGAGEUEBE...CCEE.ZCDFdBCEMIACHBAD..XBBBhAAAaEEBBEBA.KGBASAEEhABA.AACA.hAHANIEF............hAIA.VDFA.bBFA.hAAA...,2,-33,-21,12
MUOeVIQTNGfHgDcFJELCWPdBaARYKbZSX,RDAGKHBGZBAAMAGBUFDG..eCDH..VFAFTFGD..GADFhAAAHBBHDEADFDGCEGGBCEGCdFEAhAAA.AAIB..SBEBhABA.ODBHNICF..cFGAWAHD.hACA.aADG....hBAA...,2,-21,-16,5
SFETGbVJQHAWaCIUMOBDdYgKfPRXZNLec,CFEDMFFFDHFC.dBFG.KEBHRBBCZFAB..LBDF.SHBGhAAAEDFHTAFFGAGE.hAAAJBABAACCaBABUGGDBAHBhABAfEGE.NABB.FHCC.bDGD...hAGA......hAIA...,2,-30,-18,12
bCJgRZEIecOKMSWUQTfXBNaDHLPGVFdAY,CFDGJFBBRDAA.ZDCF..eFFEKHCA...MIFAUAEG..QAAChACA.TAGDBAHEaGFEhAAAHGAGLCADhABAGADE.FEEFAADFgGECEBBE..IEHHhACA....hADA...,1,1,-40,41
FgMJKYEPSUbQcIRaCfWDdAVeLZGXBNOTH,LFFCGBDFBHEFTCCAFDAH..MFEAJAEA.KAAC..ECGCSAGChADAQCAE.IACBhAAACDHHDEDC.AIACeFDBhABANGEB..HEBBgGGE...hAEA......hAFA...,1,-13,-32,19
URCPIFeOVSEJdGHZNgabDfQKAYcXTLWBM,XCBCTDAC.BGBBUGCC.RBCE.CECFFHEEeGEC...OAFAhAAASEGFdCHG.ZAGDaEEGhABADFEBKGHBAEEGLADAhAAAMFFE...IABFEABF....hAEA......hAFA...,2,-42,-10,32
BWENQdZCKUIRcGbaeLVfSXTDYgMJHOPAF,BFEDEHBGdFBBZABH.CHED.KGGA.UCGFRCFDGADC..aABEeDAFLAEGhAAA..fGBBhAAATDDBDCAEMDIFhADAOHECABIHFGGD..WFFC.....hAFA......hAGA...,2,-29,-26,3
YaUeVgQGfOIFPbNMKTBARHEcdLCXWJSDZ,HDDFEAFBLBDHCACG..XAGASAAHDEADZBCEaCHFUGDDhAAAeDHBQGDFhAAA.OBAFFHGGNCCCKEFBhACAAADCdGGAJEAB..YEBB....hABA......hAFA...,1,-14,-19,5
cfPEQAHeKVIZaCObMFSLdDXTNYgWRUBGJ,HDEDeDCHKABEVEBFZFAF..CAAA.OAEGFGFDLADADGGA..TGDEhAAA..NAHE..hAIA..gCBChAAAWEEERBCEBFFC..cGCDECHBAIFEIHHHhBAA.....hACA.MEAF.,1,-16,-17,1
MGWcHdUSKNFXeEfBYTaPOgDJQbIRLCAZV,MGCEGAFEHFFBdBDAKFFHFDAD...ECBHBCAC.aAGFOFBADABCQCCFhAAAIDHHCAABAEFCZGBAhAEA.....hACAWCFGSHBG.eFHD...hAFA......hAIA...,1,-26,-27,1
UAYWgCPMfSDOBZXdaIJEFQNHLRVeKbcGT,....gCBCMIAG.DFCGZADAaFABEDDA.QEFBhAAALDEHRCGHVGDGKABAbGBCTFAGhABA.ADGA.CAEBSHGAhAAABFCBIBBHFGFE.eAHB....hACA......hAEA...,1,-13,-19,6
SPMYRaOADZgKWXJBGIdLEQUTHeFCcNVbf,ZFDGKHBG.JCBAGBBE.dBFAEECGQEGHHCFAFEBH.CFCA...VADEhAAASEEB.hABAMAAFaFHFAAHGDFAD.XGEGhABAIHGA.LHCA...hACA......hADA...,1,-15,-30,15
aVTgNXLbJRFEcPIGYKSQOZBMWdAeUCHDf,UGDECFCFHDDCDFCF..VAEA..TCBB..gABDhAAALADGREFAEFHF.ICHGhADAKAAGSAHDhAAA.OFAFBHEBMEABAGHGfEDF.hAEANDEF......hAHA...,1,-24,-28,4
WSLICHeKaTNAOYZQFMRbEPUJDcXgfVBGd,OFBBQFDHRGFA.EACBUCDB..DDAG.XFAFVAACdAHCSAHFhAAALFFCCGDAKDDGhABA.TBEEAFAB..hADAFAEBMIFA.PEHHgDAEBAEC..hAAA......hADA...,2,-27,-10,17
dMWUecfBgXCTESNLVKPRDYGAIFJObHaQZ,JCCHOFBBHGDGZCCFdCAEUGFE..eFBHBGDDCGGB...SAEAhAAA.LBBFhABAKEGEDBAEAGDA.FADBaCFBQAFChAAAMFFA..fCHA.hABA......hACA...,2,-33,-28,5
WdFSOUAaDKETgZfYNBRbHPGIVLMcQJXCe,KGCDTGBCZBAB......NADC.bDFHHCEAGAEDLEGBMCBDJACDhAAACFAB..dECDSEDAhABAABIFDAGH.fEHEhACABHAE.........hAAA......hABA...,2,-38,-14,24
PYBNaTZXHIRfDcOEKegWFMLCJdQGSbAUV,VEFHBFDGaAGE.ZAACHCCF.RBEADABGEHEAKAEE..eGAGFDEELDAFhABACCBHdGDA.SDHFhACAAHHF.UGGEhADANCIE.....IEBD.fCDAhAHA...hAAA.OACE.,2,-24,-20,4
KYIbRNXLWVgdBScaCZeOUDQJfGMEFPHTA,KHBG..bDBHRCEHLCCB..WDFDdCGABBEF.aGHFCBFDOCAHhAAA.QABGhADAfFADMCIFhAEAEDAGFABETGDH.AHBDIGHFNAEF..hAFA......hAGA...,2,-32,-32,0
bHQRKaZTLeFJXOEcCgPfUVGSDBMAWNIdY,..IFDGdCFCHGFEKAGBaAAF.ZFAELDBDJDHF.EBBACCCE...hACAPDEAUDAC.SFFGhAAAMIAEABHA.WHEChABA..NEEE...QAEAeAEC.ODHDhACA....hADA...,2,-27,-19,8
dKMHZgOfeUcQPVRXTaLNGYCbWESBIADFJ,JEACMIAGZAAC..ODGDUAFF...QAAEREFD.XEBAhAAA.LAEGhADANIDHGBDECGHAECDDBGDBDIFEhAFAFGACdFEC...KGAG.fCEDhAGAPDHDaCAE.....hAIA...,2,-31,-16,15
eZBWXEPIGNQfdgKSDTOVJFHYMURcbLaCA,eFCABFDDEBFHGCAE.QDCGdBCCSFAGDBAHOFGHFEFGMIDEhAAAUAGD..RCABLAHDhABAAHEB..WDHBhAAAPEHDfHAFKAEE.....hACA......hADA...,1,-17,-22,5
LgDMcEZTFaCbRQWfHUPIOdYBSJAXVNeKG,VEFHKDCDGBFC.LCAFMIAGZAACFBDCCEBD.RFBC...QDDChABA..WHFGhAAAfCHE.HAFAhACAIHAGOEAHBGGEAFIBeDAEDABAEAGG.hADA......hAEA...,1,-13,-30,17
CFRMTNBPfIVKEacXWHQbYJdSeGZgDLOAU,UGAFFGFHMCCBBACG.....IFGBEGBHaDHH...XBAGhAAAQEED.bAEAhAAAdCDF.SAFGhABAeFAFZBABDICCAEAGRGDG.NACDfDDFcCFD..hABAHEBC....hADA...,2,-32,-6,26
eJKTGSbDFVBNHAIRaCLcPgZWfEOQXYUdM,RDAGLCAF..gBAEfEECQFCAUBGHdDBBMIAGhAAAeAFCKGEEGABFDADAVBGBhAAANHEH..AFCECCEA.hABA.cGFD..PDHB...hACA......hBCA...,2,-21,-12,9
MUdegJOALQPYFaDTHIRcWZbNXGSKfECVB,LDACQCBCFABDaFGBDFHB.HEBHRFBFZFEF..XFEEKBFCCDFHBADDhAAAMBIF..dBACgBEGhAAAADIH..hABAYFADIGAH.cAFANAEF.fHDFhADA...hABA...,1,-12,-29,17
XKPDZdcWIMUBQSbCJHefFOYaVGNALERTg,LDCHTCCB.XGEFKBAAZEEG..dDGF..IEHBBAGCSGGHhAAACACGHAEEFAAHaHBAhABAGDAGACGE.RCEADIGGhABAMDAH.QEBG.....hADA......hAEA...,1,-16,-24,8
ADPBfTKVeNagGSQRCHJMFEZXYbLIcUWdO,DAEDBFDGKBBAeBAD..aDBDSGHB.CDCA.MDADFBHDEGBEhAAAXDGD.LGDEhAAAIGFEUBGFdAECACCEhABATDDG.NIAF........hACA......hADA...,1,-31,-41,10
SEIOZTXYbcCGKPQWgLaMRANHUFeVDJfdB,UFDHFDBDDFDEdFBABAAD..EDAGZGBC..XCCF..bBDEhABACAGEKABA..QGFChACALAEBMIDAhAAANEAE.eAHH.fGGBIFHGOADAhAHA.....hABA...,1,-33,-37,4
HGeCIbXSEJTRNPODULaZcVfMBFgdAQWYK,QCBCKHBGHEBCGABHCHHE...IGADSDAF.TFCGhAAAPEGFUAGEaCGA.hAAAZFFD.VACEBEEBFEEGhABAAIFAYAFCXFAD.ECAANDEF.....hACA......hAFA...,1,-9,-14,5
IKZgaceQHAdMSFWTbGYDRXUCEfOVBJLPN,SHBGTGBC.GBEHDDDGRAAD.UEGAEAEG.OCBDBGEALDGFhAAA..PAAEhAAAKDAFaECGQDDFhADAAHIBMDIHFBGEYFAD.fHDBhAEA......hAFA...,1,-22,-24,2
MZGDFKBaIPHfSRQAecOEUNXYLCWbVJgTd,eEEGEDCDUAFA..NAEF.LHDE.CAED.VDAD..TEEFhAAAMCBADBACBDGBPHCEhAAAHDAB...SBHFhABAAHIHcABFXGGFYFDA..JFHB.hADAZCDEKDDCfACBhBFA..,1,-10,-26,16
VJEaQDbAWTYgUGMICFdHSOeLfRNcKXZPB,TCBCUCBCMGCE..FHECdHGDOEDBLAGHRABE.KGGCZBGHBEHBhAAAECFHDGAEAIDE....hAAA..gDDBhABACHHAeFFGNBAA.XAEG..JHAAaDAH..hACA......hADA...,1,-14,-31,17
ZIBaCDRdKgLbFGOHPefMXENYVUATSWQcJ,SGFCQCBCZGAGBCBACAEA.RDCB..dAADLHFAFEEA..OAEEhABAHEEEfBGFhAAA.MCAFNEICVEAFhADAAHGAcABA.aAGGKCHFbCFA....hADA......hAEA...,2,-29,-10,19
DCVOeSXcMgZfYGBARNQKabdFTUHEJIWLP,QFDHKAFBdHADFBHB.HAFH.JEAFLDCECEDC.eFFDSDCChAAAMCADZABGGCGEhABABEGAAGGGNIAF..aBCCTFAEhAAAUGGFICAE.WAHBDEED...hABA......hACA...,1,4,-30,34
GPbdQRHTSaCLJBMfUeYEOXKDFANVgWcIZ,VAAD..gCBC..IFAAPABCdFCFHFFCSDEBhAAACHBAJDDDBGEGMHBEhABA.UGGHEDBAOBHDhAAAXAEFDCFFADGAcBGAZCFB....hAHA......hAIA...,1,-22,-23,1
aUKOFdGbfXZYWTcJHVeRgLMQNCAIEDBSP,EHFGDFEABHFD..aBBBODACdHCBGECB..XGAHhAAAZCCETADCJAFA.eFAFLCFChABANAAE.ACBC..SDCEhACAKFGGfCGC.WBHBcGGChADA.HDFC.gFBBhAEA,1,-21,-24,3
IKPdXbRBYOQMGZJCWUENSAgDcVFTLefaH,DACBVDAGFCEE.LEHHeDGDHFCG.KDHHdAFDRACF.ODAG.MEFDhAAA...JGAE.hAAA.CHHBEGAEAEAH...hABA...cECFaHDEXAFEBHDB..hABA......hACA...,2,-35,-25,10
WefCFVXcZRJSLGIMgEDHNBbAKTQOdPYaU,KEHBTDCHdEAE...aGCDUAAC.eBDCFGFG..XBAFRCEELFFHhADAGBECMFEDDIEABAHAhAEAQFAC.hAFAYCHDCGCA........hAAA......hABA...,2,-31,-24,7
TCAbOWgeIQZKDMfRBLFXHUdGJVNSaPYEc,OGEAeGEAZBEGKAHBDDBG..RCBCLFBDFFAGUDFH.dAFG..JAAGSFHBhAAA.aDFChABA...EBBACAEAAHAF.hACA.gECHQGBAMEADBBCA..hAAA......hAEA...,1,-12,-42,30
BbcKagLUSJIAHVWQefGROPDNMTdCFYEZX,HGFGQFDHGCFEODCBDBAAMDED.CHAF.EADEBFCHKGBFaHGAUCAEhAAA..JDFEACHGeADGhABARBAA....NICFTAGHhAAA...YFFC...hACA......hAFA...,2,-29,-12,17
cfWbSLVEBCgDQPaMZFNYOTHAReIKJdGUX,RFDFKDCDGAAHUFGB...XGGE..fAHASDCChAAALADGBDFECHCGQAFBhABAMFDB.FDABhADAOFABAHFHIGAAdCGHcBAGbCGDEECFPFEFhAAANAIE.....hAEA...,1,-7,-30,23
WQgfMZFcRBbVUCLATISJYEaGeXONdHPKD,SGFCEDCDGBEC.eCBHOHBGHDFEKFGHQABH.gAFGhAAAfBBBMFIFhABAcGEABCHHbFAGCDDCTFCFhADA.IGACaCAFNBIADAEE...hAEA......hAGA...,1,-7,-12,5
UceZWNbTfRGVBdJHFDXSYEOaCPAgMKLIQ,MHFGLCCHUDACeEEEZCEH.....NDAG.TGBAGFCFdAGHHBEAhAAAFBAA.DBBD..SEGHhAAAOFHDCACEAIECKEDBhABAIDHF.WEBDfACB.hABABDCA....hAEA...,2,-32,-11,21
DHgWcbRFfTMVISZdUNQOYAaGEBeCLKXPJ,EDAFBEFALDDGKHGE..JDDEDADGHAGF..gFCAhAAA..bFBGfBBEhABAMADFSEAFhAAAdHEFQBFHAIAEaABF.CHAEXGGF.cACChAGAFFGE....hAHA...,1,-23,-30,7
IgbTDJBeUSXNOdcafLREWCYFQGKHAPVZM,VGFGZFACMBBE....IGACTGFHJBFHBEGD.UABGXEDEhAAAdCGB..fFCEhAAARCAFEDCH.CDEDFAFChAEAKHDAABIH....bFDBSHAG.hAHA.cDBBWBHD..hAIA...,2,-31,-20,11
NADTHYOUWVKBgRcQdPbESCLMXGfFeZIJa,DEFAHEFHOBDHUGDFKAGFBAHARBBC...dFHCEEBGLFDE.MAAFhABAfFAG.hACAeAHHIHDBaHAEABAG.hAAATBEA.VDAFcDEB....hABA......hACA...,2,-29,-23,6
ADPFMZHQGUIbXOEdgCeRWNSLBJVfcaKYT,DGHHFGFHHECCQCBBGAGEUAEG..bAEBEBGE..dGBGCFEBeEBAhAAARBACSABEBGEDJABAhAHA....fCDAhAAAaDHH.YDHBAGDDMIAE....hAIA......hBAA...,2,-25,-14,11
YLRadTcXKFCBDHGVOfeQSgEUIbZPMJAWN,...NDDG.LFBB.dGDEXFED.CDAEHAAGVDCGfBHEhAAASFAHECGFhAAAIADE.ZGFGMICAhABAJAFDABCHREGBaAFGKBAFBFFC.DDHF...hADA......hAEA.OCEB.,2,-21,-7,14
fSZLCgXIJMPAVUEOaYQHGcbRDTeNFWKdB,EDAFaDCDHAACGFDDRAGD.eDCCFGFG...dAAABDAGZCFFLAHDhACACDGG.XADFMFABADIFOFDFhAAAQGAADBFH.hABANEIE.KGCD.SHFA....hADA......hAEA...,1,1,-26,27
PTdeVQFcOULCNRIWbJYZgGSfBKHEAMXaD,XAGDaHFG.DBAGTFBB..dGFDeCCGFEACUECECEAB.RADA.hAAAIHDE.JDFGhAAAZCDA....SFFAhABAfEHGBAFEKHDGAFFEMBCCQGAGhABAcCAA....hACA...,1,-25,-28,3
WEJHIPCcQRVXBUGdLbMfKDaSNOYZAFegT,eCCHTCBCEEFA.HAACCFAG.RAFH.BBAEGEAEdDFAMBECDFIF..SGGDhAAAODHHAADCFEDBhAAA.....JHCAhABAPHCC.cFDAXGGALAHBhABAbBFA.aADF....hAFA...,1,-4,-26,22
GYSKgNLMDXTaIOHCcbQFfeUdWPVBAZJRE,ZDBGJDCHGEEAKABELHDG.DDFCaACHHADECBEE...QEGDhAAAFBGDUGAEdEHA..hAAA...PBAFhABABAHCACCH.EFADSDDB.NAEF.MEFHhAFA.XFCE.hADA...,1,-19,-26,7
VLJGaPCXgdYRbUTZAfOSIBecWFEQMDHNK,SDCDBAFBeEACFGHBMHAAHFEF.KHACVBDFLCDBGEFECBBH.hAAAdDAG.RAAEUAGFAABFOCFDhACA..IHEEhAAAEADEDDHB.NDIE..........hAHA......hAIA...,1,-7,-26,19
FCQaJdSfIABHYgeUWKGRPVDEcMNbOTZLX,HDBHeGEAKDHBREFHDBFG..EBGEMAAF.OEABTCAA.LACEhAAAXDDDFCFD.aHAESBDGhABAAHIBBGABUCCEhABAPHAC..NFCFCHDDJHDA.fDGBhACA.IBBF.hAGA...,1,-11,-17,6
TbBdZRgUXOYEWeDMCGVScfALKIQPHNFJa,KDCDQCBCHFDGFGAGaACEBHDC.ZACHRDGHUFAH..OAFHhAAAEFDGeAEHCGHC.GGEFhAAASCHBADGH.LBAFhABAIBHF.NIAF.JEFA......hAEA......hAGA...,2,-27,-7,20
HXMNGUEBLdRCQVOIKWDYgSeJaZcAbfTPF,TCBCFCFCMIDG.GACGBHGEdFEH.CCFC.OFFCKFBB.DIAASAEChAAAeAAFZGEAAFAA..hAAA..fGDGhABAHFACNAEBEDHH..........hACA......hBCA...,2,-46,-12,34
cDTHMQgUfXFaORKSAdBNCZYVPJbGIeLWE,BFEDZDBH..VBFCJDHHGCBELEDE.EGGBDABG.HADG.QGGGhAAAUACCFGABOFDDhAAAKBGGABBF..CGAA..hABA..bGDCIFHC.WAFEMDDA.hBAA......hBBA...,1,-21,-24,3
MRYHILcKUGTPeCONFEAWfgBQVdXaSbZJD,...fHBHQABHdHGFaFEAZBEDJECFRBBBHBGBLADBKCAFUEBFhAAATBFD..CHACFFFGhABAEAGGAAAFBGED..SHEAhABADAGC.MEEG.IFHEhAFA......hAIA...,2,-25,-12,13
XYQVaRGbFJLSfgKAITZMdPEWHBceDUONC,ZEFHMHFGdHBF.EDAGBFFD.DCGEUACB.CFCG.XBEF.QECBhAAAVAGHRCDA.FEGAhABALFHB.SGAFhAAAKGACICCB.WADC.eHBChACA......hAHA...,1,-23,-38,15
HWaEGOYUedNKMJIBRbDfQLcgTFZSPCAVX,XBBHHDAGaGFCOEEAUADC..dFBBKHDAMIDGBGCB.RBCADAHFQAGDhAAALACCTGGGhABAFBAD.ZEFACGAGAFDGECGF.hAAA....GGAFNAIE.....hABA......hAGA...,1,-3,-21,18
eVGSfNRdLbDOIFHYgAaJWcZEUXMKPBTQC,JCCHZAADEDGD..UGFHKAEGBFEG..CHAAeADASDCB.hAAARGAA.dCFCLCFChAAADBAGFDHF.HGFAACAC.aEAD.hABA.XDAD...MGBC.TAGAhACA....hADA...,2,-40,-22,18
bFIXLEaDTMQecUWJCBGKRZYNSOPdgVfAH,HDAGFHBGLABCDAGAMAACQCGF.eFEDUEGF.JAFFBBDDhAAAKEEBRBBEZCCC.NCBE..hAEAOFGFPHEC..hBAAdAFB..fBHEAFFG....hBBA......hBDA...,2,-28,-16,12
bEFNYDWLVIeKBCQXMgGAfZOcSHTaRdUJP,ZFDFSDCDaAAF.REFC.UCCC..PFABFHACDAGC.LACEhBAAIDADKEBD.BFFHhBDACDEBQGCA.hBEAMBFGAHIBfDGDHGEETBCD.dAAFEGCBhBGA......hBHA...,2,-32,-7,25
DVIeBGKJEdXLSWgANcZQYaHRUbPCMFTOf,ZAADaGFCHDAFRDFHUCDCCFEF...FFAAOHAC.DIEE..IFDHhAAABCHGGCCBKHBEdAGHXAGGhAAA.SACAhABAAHAD..NDIE......YACGhADAMCAAfEHEhACAJHFA,2,-40,-29,11
ITeMWRcUBKQCZEDHFJaOLdbgVNGPXfYSA,TDACMDEBRDFE..BDBHCBBHZGFEHABG.FFHDODCGLGCAdAGB..hAAAVDGD..PBFChABAXGCGSGAHhACAIADD..WFFHKFCCEFADDAEE....hAAA.aEEF....hABA...,2,-21,-16,5
AgWPLeUKaVHNTYBGIXfcOQFSMdZEbDRCJ,...PGEALFCAUDGHKBFH.aDBEHGBE..TGAGGCABhAAAXAAFfBEHhABAOHFCSACChAFAdADHZDFADICGCHHG.AHHA.eAHH......hAGA......hAHA...,2,-21,-14,7
QLZCEDGPcNgbXeFVHIWJAdfRMSaUTKOBY,dCFCRFACMBAEUCAF.KFGDBDDA.LDFDEHEEGDCG..NAIE..hAAA.XBGDFAFCHGCChAAAJABEAFID..SCCChABAaGBF.TDACYAFE....hABA......hBAA...,2,-30,-18,12
YIOXRBJQHAGWfUcPKaTbMFgeZVSdNDLEC,GAFEUCBCKGECaDCD..MCHFeABB.SEACDIGELADBECHHCFEGhAAA..OGAEBCAHJFFAhACAAFFC...fFBEhADATAFE.........hAAA.FFAG....hABA...,1,-18,-43,25
fBeYgKVNZDUGQEFWMSHIJRcadAPOCLTbX,OAFBLEBE.TFEAXECF.BAAFeEHFKHCEZBBG.DGDDQCGHhACAFCGAMAACSCDAhAEAJDAFRFFC.dGAGhAFACAHDfBBD......hADA......hAEA...,2,-34,-16,18
LFGYDWJbOeMdcHQRTSCVEaXZfBgNIUPAK,KEEDFAEGDCEA..JDAHeCACdHAFHAAC.RGFG.TGGG.SGBEhAAACEHGEDEE.XFDBhABABFCC..IAGGhAAAAIDGLCHH.WDBAOCEA...hACA......hADA...,1,-35,-37,2
WODcbFJZefBdCTEaYGIQSMPHKAUVXRLgN,VCDBRADGLFEF....NDCC.DCCCFBHDZBGDBAAEdHGDEABA..hAAAaAFE.GEGCSGAAhABAHGDGABDFXFGBhAFAODAF...cDDB.....hACA......hADA...,2,-27,-21,6
DETdNWgaISKXcFeQBGVRHPUbYMOJLAfCZ,ZDBHTCBFdEFH......NEEC.aCGCKHGEXECE.FEHHQABChAAABGBGRGEEPAEChAAAbAED...ODABhABAADHGfGAADAIH.gAGE.hACAIHCDSBBEhADA...,2,-28,-25,3
UVXJaNfBdCQPTIcFEGWMHegKSAORZYbDL,ODACRGFGZBABDDIFLEED.UBCGVAGD..aAFCBHED.dCDEhAAACHHHQGAGhAAA.TFGDcDFH.hABAEEBFMCFCHFCEgDGESAFFABBD..hABA......hACA...,1,-13,-27,14
gFTGWOHDBMLJNfPbYdSXUKAaREZIQCecV,aEHBEDAFZBGF..CAGB.eCCD..VDCG.FHDATEEAGFABHGDAhAAAMIAEJFBD.fBAChABA..PABHhAAAdGGESBFDXBEBAACC.IFFBhAEA.....hACA...,2,-20,-16,4
PJMYIDOcAaGfESFULgXbdQZWVKNReBCTH,GEAHEAFBUDAALDHF.XAAFQEFEZDEBKBEFeDDBCACAHGAAhAEAMBACDFIDAHHB.SACEhAAAFAGA.dHAFhABA.NIEBBCGA........hAGA......hAHA...,1,-16,-20,4
eXPaENJbIORGCSgYHATDfQZWdcVMFLKUB,TAFBDAFBQEGA.dAADMDBBLEDFBCGHXEFFhAAAEDADJCCA.ICCFRAGF.hABASFCGgGAEhADAAFHCZABC..cFEFKHGAeEEB.aHAANIDF.hAEA......hAGA...,1,-14,-17,3
GdMRYAZXaJBTfSENQgecPHCFWbDIOUKVL,aDAFBFFE.SDDFEDGH..QACGeHDEHCGHCHHAbDEDICBBhAAA.KAEHLHAEhAAAdEABMEIHAHFBJFBGNGAH.hABAgAGFFHAGDEEA.......hACA......hADA...,1,-15,-18,3
gNQMJHCfIESdcGKBWDAVTPRFObaULZeYX,TFDHRDAGFEFA..OAHDUEAALCFG.eBDCXGGAhAAAQAACHABFCFDEIHGChACASGBDdEDBKFHBhADADDDAAGCEPHAEaAFG....gGDAhABA.....hAEA...,1,-13,-19,6
FdUHTYLKOZNbaVcPCQReMfXBJIgDSGWEA,dFAAHCDBLBBHKAAAOAGDZFBB..aBDH..VFAECGEE.RADEMIFEhAAAXAEG..BGGEhACAIGHFDIAGSEGGhADAEGDBADIB..FCAB.UAGE.TDEChAAA......hABA...,1,-18,-21,3
MJSgKaVZeBcbHYIGdUFWQCAOPTRDXNLfE,ODACREFHDBGHLEEF..fABDMAIF.JCHFKEBEZGDEBCAEhAAAHAFAGABFFCCECFGEAEEGhAAATGAD.EDHBSFDEhADA.aHAA......hAEA......hAFA...,1,-24,-27,3
cAQWEHaZeXDJRfGFIPVMSTBLUdNOCgYKb,EGFCaDAFZGAGDBBA..RAFE.FCGG....IEBDVACA..TGGGhAAABCGGdEEH.CEHFKCAGhAAAADIDHEDA.XGEDhABAJHAG.fCCEMEAF.....hABA......hACA.SCCB.,2,-34,-14,20
FOVYGbPUIcAdXZaWCHQMSefTgNDRBEJLK,ZBCFCFEDHBFASFAG..eCBE..TEGDDHGEEHEELHBAhAAAFHAEOAEGVCAH.hAAA.bDBG.UDFFIFEEhABAABBG.aCFGMCAFgGGA.BAHEhACA.....hABA...,1,-12,-20,8
dCeBDGQIMXKZEbWcHAfJUgNYTOVFPSLaR,JDACUCBC.....NDDF.TAEH.FBBGSHCARGDE.hAAACFFDDACEIGAF.hAAAKEEHEFAD..bCGBWCHBhABAADFE...fBDDOHAE.PHFChAFAdGGABEADMBFE.cEGChAGA.,1,-24,-52,28
VUKgLHEZOXbRYMGcNCASfWITePBDJQdaF,SHBG..IDGFTDCBBBBCQGFEdGEDFAHBKEEBhAAALAAEEGCEOABBhACAXDGFRCCEMBECNCCFAFBAfFAChADA.WAFEDIGEaAEE...hAEA......hBAA...,1,-20,-29,9
WCgcBDPZJfKXMdQRLNebAaFIYGUHSVEOT,aAFBFHBGGAFAHCAEEEDFODCG..CDHCBAHGDACBZEBAKEHH.dGGARFFEeHDChAAAADEC..IHCBhAAASAEF..hABATABH.gEBF.PFEDhABA.....hADA...,1,-16,-30,14
QfHBSNUgLEFIAYcRKOTXZPVJDdCGbWeMa,RAADKGDDOAEGZBFG..JABGDDFH.GEFC..eFFBQBGBhAAABEGGUDCBEEBEIDDChACAAAGG...TGDAhADAXFAC.PFHDCHBF...MAABhABA.....hAIA...,1,-22,-40,18
PKXFALNWGYgOTSVEbfeDaIBQMdUZHCcJR,LGEAGAFEOEFBTDBDEGHF..eHBGaEAABADAMAGBUBBFhAAACEDB.RDFA.KFDDAACG...hABANCAH....gFAEhAAASAEF.fAHADIEGIABChADAdFBD......hAFA...,1,-11,-29,18
SCPfXMKDNEbYdUeGQHgAaOTBIJcRFZWLV,aGDDTGDEBGAA..JCBCRCDDZCBD..LAADCHBH..XAGChAAAMEFEDGBE.NEAG.ECGChABAdGGHUFGDGBEF.hACA............hADA......hAEA...,2,-37,-28,9
cOgNbMaTeYJRfGULKEFPZHXDIVdQABSCW,SBEECFDG..OBAD..bDACaACGeBHDJCCGGAGAhAAALEFF.EHGCZFAFXABChAAADFHFdFEAAHIDBGADhACA.WFDH.NDCF.MDIF.....hADA......hAEA...,1,-21,-35,14
EaIbYKXFHfUDSeLGZOQWJVdBTCMRNAgPc,...PGEAEAFBaFFC....IBGHKCDAFDGDHEBEUDECDDHBhAAASCBFeFAGGABHhABAOHCEQCAFhACAJAAABGABCAHAMAEEAADE........hAIA......hBAA...,2,-27,-17,10
DRcGdCEJbOVXSTYMgPfFBNUKQAaLHIZWe,aDBDLFBBZDDG.eDEADGFCGGCHCDAD..EACBJAFBOABH.hAAASAGHMBAF.hABA.PBHBBGAHNDDCKBCBhACAAHEDHGFA.IAFCWHAG....hAAA......hADA...,2,-27,-26,1
AOUQEMRHBaCDbNYgfXPKZSLGTFdWVecJI,ODCHUFCAMADGHAEBBGHEDEDA....NCHC...fAHEhAAAKBADSEADLDEGhABATGEHFDBGdBFG.WFFHhACAeHBE.IAHGABBC.EBBE.CFFB..hAIA......hBAA...,1,-16,-33,17
WQLePFVcRfHGIZCgBUAYKNTXJbOEaSMDd,KHBGTCGC..XAFEOEDC..aCCBMFCA.dCECQBDChAAALBCHFEHFVFBHRGFAHBABhAAAIAGCCGEC.UGGGhABANABB....EGAFDCAH.....hAGA......hAIA...,2,-15,-12,3
WdXLeGCJHAMfYNBKDIUVTSOQcPRZgFEba,MCCA..NDHCDCEGUDDC...SHCEQDABRDBHZBGHFAADEEEFhAAAaGAH...XFAChACAeBACCHGAADAHBHBHKFGE.hAAAIDDD........hADA......hAEA...,1,-25,-43,18
DYSGXdZeHNBOWCAPKFEVJTLgRQMfbcaUI,KAFBFEHBEHBA..TDAARCFF..MEAA..fHDBhAAAaACGDIGAGDDAdFFDHCCCBHAFhAAAWAHBCBBD..ABGG.JABEhABAQBDDbBGD.IFAFYFCDSGGGhABAeFHHPFABhAFA...,1,-14,-16,2
DJCNQSGgIVBYPeAcUHdRZaOWKTFEbXLfM,HEFHRBCF.ODCHTBFFEHGALFFD.MAADDDBBCAFE.NIBF.GEABhABA.IEHHhACAVBGBBBCHPHAEAAHGdEDAhAAAaAHFFABGXGGE.fBBAhADASAED.....hAEA...,2,-16,-8,8
UeEOQBPGbTVRMSWXFAHYNKaLCDcZgfJId,HAADKHBGCDEE.DEDGZAGFJGFE..UACG..eGCA.OCCEBFGFGEBDhAAA..VEAEhAAAMBGFSHAGhACAFBAFAIEA.NAGALBHF..fFAEhABAIAED.dGHA..hAFA...,1,-14,-38,24
ZWMaVGPEJfFROTIULNXBeQgcYKDSCHAbd,dCFCZFACMABHaAGF.GEGAEFAA..FAACTDEFUCAB..LDHFhACAXCBDBEDD.eGFGhADAgACGKGBADIBC.hAEAHBFAABEF.WHAG.......hAFA......hAIA...,2,-23,-9,14
gGISWAJMQNfRdVTaLbPcEDHCXOFZUBYeK,MAFHQCBCREAB.dCGBaHFALABE..bEEEEGEA.CFAEXECHhAAAOAAEUGDABHBDhAFAKCCB..IAHAhAGASAHFAFFGJHFENBIA.fDHE..hBAA......hBCA...,2,-24,-20,4
UDeOSFgEfYXMGJWcNdHIKbTBCPaLAZQRV,QBBHVBCD.eFDFSFHFFBGFEHGE...XBGChAAAMEABJBEF..NFCBdAFBKFBHBBAChAAACHDBLEAFAFFD.hABA............hACA......hADA...,2,-30,-29,1
GeVNYUAfDSXBMgdEbQJCPaFRIOLKTWZHc,DGHHSFFBMFCG.dAACQBCG.CGBB.PFAH.RCCHOHCChACAKBHBTCEDHCFAhADAeAFCNBDB.AHDFBCADhAAAEEAE.aGEGIEHHLEAD.WFHB..hABA......hACA...,2,-26,-11,15
bGgPKQMINSJLCRAZBWDOUTdfYHeFEXVac,BFDDDEFHUEBDdCABHFGH.eFCDXBCD..aDDFGAGGhAAAKAFBMEACSGEGhABALFAFACBBZGAAOBHFfADDhACAFABC.EGGE.......hAAA......hADA...,1,-21,-22,1
TdUAIGgPMZSQFVeOWDNbYHfBJKEaXcLRC,GAFEMCCAZGDESEDGFFBG.eACBDBDA...NDIA.HDEEJBBHKHBAhAAAXAAB.RAGBdDAFhADAAFAHPEBB.OFGFhABAWFAD...fAHE.BGFGhADA.EHDELFGBhAEA..,2,-15,-15,0
PGKJaWbMSVLgeYQDAXfUZdRTCcBFEHOIN,XCGCZEFHdAGGCEAH.FDBGHECH..OFDC..ICBDhAAAGADAJHFGaBBA.MFBDSADEhABAVAAELAFEhAAAgGDHeHCCDCIDACHE.fCEC.hADA......hBGA...,1,-8,-22,14
XLFIBERbQWaUNSPOKVACZdfcHMgeYDGTJ,dBBDHAADMACGeGEAGBDETEBELHDA.FCHDBBHF.RAEFQACGhAAAUGAESBFChAAAPDHFOFEChABAAEEFCHDGfGAA.......hAGA......hAHA...,2,-21,-6,15
WNSRAPbeYEIcXZUJMLQDfTBHCGKaVgdOF,eGEAEHBG...ICAEXFFA.JAHBMFBGLADADCGCBAEGhAAACGDGGAAEKDCC.aFCGdGDGhABA.OFABFCDFNIEB.AIBA.hACA....YFADZCEF....hAAA......hACA...,2,-29,-22,7
bQLaSUgMdJVRBeHFTOCDEGPANXYZKWfcI,XCBCZDAGKBCA......fCADcEDD.QCFAhAAASFGBMIDEdACCJADGhAAABFCBFCFGCFFAEGBHAGBDNIEB.hABAIAGALECDaFHB......hABA......hACA...,1,-19,-31,12
EWPQNJFcDfHYGXZKaBMAUdSLVROTeIbgC,dFHASDBDRFDH.eCDBIDFB..bAEGCAFE...PFEFhAAAQDAF.NBAH.hAAAFGHD.DCABHBGDXCGAhABAaHACACCG.LGAAODDBEGFFWAFE.cDFHhACA....hADA...,1,-16,-22,6
RMTNeGAgKcSFWOVZaLJbBXQDCHdPUIYfE,KHBGSAFBFAGD.OABCaEGF..LADBBGEGDEAGHCAFdHGFUDGBhAAA..IABHhAAAfFCEMIFEeFEGhABAAFEC...cCCCZCFAbFAACHAE...EGFGhAFA......hAGA...,1,-21,-27,6
MHSYGEcfLBJCUWATXgPFVdeONQaIRKZbD,TCGCXCBC.FGCDeFBD..QEEBIDAEZBAAMCADHFFAhAAASGHFEGEBfFCEhABABCFCJFAECCEDABIHVABAhAAAdAFC.OAHF.aHEE.....hACA......hADA...,2,-11,-8,3
RcGFJBYaedWEPISVfgXNMDbLAUHZOTCKQ,HABHOBDGTDAAKEEE.RFDAGBGABDCAeGFCEGAB....IHHBhAAASDHD.fFAChAAANADFDEECABGDCDDC.QCAGhABA.FGDFaFCGdCGB....hACA......hADA...,1,-3,-32,29
UYFPQJEfbVXKORDTZWAGeIdgNaCHLcMBS,eFEFdHBHaAEHHCCG.LAADBBCDUGGEFAEEJEFC..EFBG..hAAAbEACXFDB.hACAOBGDDBID.TCAFhABAAIAA...IDDHCBBBMHAC...SGEHhACA..hADA...,1,-19,-35,16
HBcXOAfGUbVSaKYCMdQPZEJFRWNILDeTg,UAGHVDAG.KCED..MHEAQEFGZAFFFEED.RCAH.....NAIC.hAAALABC.DIDChAAA.TFBEBADCOBBChABAAHAE.fHABSEHHaFBECGDA..hACA......hAHA...,1,-29,-34,5
ZQOXLIHgNMcTWSeYKPJBFVfEUDCGdRaAb,QFDHOFCALDGHHAABMIBE.TDEDSCBE.hAAAeAFHPAGFBHHFfAEFhACADEBFdACDACIBXGEDhAAAgGGANHAH.cDBG..WEDEhABAKEHD......hADA...,1,5,-33,38
bcMdTIFPVRQOAEYgUWeJXBLKGfSCNZDaH,EHBGUCBC.eFAABCBGKFGDSFGG.ZEDHaGDCHBFGMAECdAAFhADAFBHFVEAE..OEFAhAAAAAIF..gAEChAEAXBFDfABFCDGDDDDC.cBDDhABAIHHA...hAIA...,1,-10,-38,28
DKJcXLeQHCVZAfdNFEaTSRUIMYWPBgGOb,dHBHFAFBEHACSBBH.UBEAMDAG...PEDFBAAE.OAAGhAEAbEFC..DDABJDHHhAHAXAGHeFFDCHHHAEBBaGGChACA.....TECF...IHEHhADAgBCE.hAEAKBGA..,2,-35,-21,14
STNPFbAXEYIeBfKZULDQWagVCHcJGORdM,EGFCeGEAKBGFLBBE.DFEEQDBF.aGADCHBFJCCBRACAMEFGhAAATFCG..FEEHhABAXBEDBAHFfFCAhACAZBGB..WDAH.....hADA......hAFA...,1,-27,-30,3
aYCDTXARZJPLEKWOSQUeIVbfGdcgMFHNB,RDBGZFDFLHBEECCH.OCAGSDHH.QBEGIAEC.hAAAVEAHGCFC.dHFBhABAgAAGFBGA.hACABHAGCFDADDAHTGGGAHAB.KACC....hABA......hAFA...,2,-19,-18,1
gfbEUPRTKDQMdVGAWeCINOBYFHXcJaLZS,eAFBCFDG.OEEEBHEFFFGEHECF..JCBBaGGD.LACHZCFD.hAAAfEBAEFAD.hABARBAFDCHHMFCHdHAFAIHA..hAAA..IADA......hACA......hAFA.XDDBSAED,1,-2,-45,43
KPaEeGgLHQJNYAMDVWTdUZCBISFcbOfRX,DAGDTFDHZCCBBGHD..IDECFHDA.OADARAAFKFDA.aHFAGBEEhAAALBBE.QCGBhAAAJDAF.AIFEWHAGhABACHBB..SAHFfCCA.PFFAhACA.EGBE..hAHA...,2,-43,-19,24
TadXHJfVSeAgELFWMUQBYOGbZRCKNDcPI,LCCHFGFHUECBBBGFOBEC.ZGFEKAEDDBGE.....IABHhAAAdDGAJAAC...SGABhADAeHAEAFAD.gDGBhAEAEGGG.QEEA..hAFAbDABCDBA.....hAGA...,1,-31,-45,14
aOEbLIJDWHQXBZKUfAVcdGeCNYSgRFMPT,VDAGGEAH.CAHB...SFGERGDGFDDA.MADGaBAG..EAEAIHGEhAAA.JAGBDDIBhAAAQABHBDGCZFGFKGBFhABAAEFDdHDDeCAC..NAIAPEDD..hABA......hBAA...,2,-22,-21,1
NGFgeEXHaYDcUMBdRbVOCWSQKTLZPAfIJ,JGEAFGAHeBADHCAFDDDCUDFF..BEEFdGGFRGCE..ODHF.CCCF.hAAAQCCCLHBAABGGhABAIAED..hAAANBBB..ECGA.......XFAEhACAaEEHMCFA...hADA...,2,-34,-27,7
TGbBSAfNPLOJDdEHZCWXRYagQUcFeVIKM,...PHFCJAABDEBHdBGGHCBAZFEE..CBBB.XAFD.RDEC.aECDhAAAUGFEFEAD..IEEFhABAMFDF...TBDDhACABHBGAAEGLHAE.ODAA.hAAA......hACA...,2,-38,-15,23
JHFMCLWQGZeUXaVPRgYfNTBSOKbcEIDAd,dDBDJDCHHEFEFBGELCAFGGDFZBDAUEGG..aHAGRECA.....hAAAfBABBGBEKBBCEGDChABAADDCMAAE.CAEF.eHAGhACA..XAFA.....hADA......hAEA...,2,-29,-14,15
XHIOCFaSJGbPLKMgNYAReQdWVTDfBEUcZ,eBDGdGFC..TEBDBHBHUDFGZACGHGBGOFBACEGDFDCA..aCAGSGHFhAAA.JBGFhABAPDACKAGC.MFAHhAAANCAC.AEEE....QGGHDBBF.fBGBhABA..hACA...,2,-39,-12,27
bFBYLGTRIMEdAQXKZWgCHcNDOSJfeUaPV,QFCAZBCFCCHEHFCGDBEGSFFH.eBFGaGFE...PACBhAAAFCECLAAHGCEEIGAFhABAEGAEAAHB.KHGAhADA.WBBD.NDICOHBCJDHFfEAFhACA......hADA...,1,4,-31,35
HbLAPMQICWaNeYcGSKUBOZgTFVDEfJdRX,QFDBCFDG.aHGANCIA....eCAEGDADKBDCBEECODHHhAAAZGEETBDH.DGBHhABAfCFFdAFD.hACAXGAD.bDACACGGMIEA..WABChAAAcABD..SAGEhAFA,1,-26,-32,6
ECRGXcbJFZUYLBAOfDeIQMNKHgSdaTPWV,OFCHDEFHQCAEKAFEHFECdFBE..aABDTGFA..PDAHhAAAEDCECAEA.GBGG.hAAAXBDCcDFAFAHDhABA............hACA......hADA...,1,-22,-32,10
PBRGQFLEJbZSgXKdYCHOWfeUaNcVMTAID,DACBRDBHFGHBLCFE.EFBFZGDA.SACDKGGDdEFBHBAFOBEFhAAAeDDFUAGC.aEFENAEF.hAAA.MEIDADAD.IHDChABABBAF..........hADA......hBAA...,1,-20,-35,15
VeNCBEILWYGgDdFKQSJARUOHabTPZMfcX,UBDGODCHHGFE.aHAGTAFA.MIFEXFCA.eCAHhAAACEABBACGEDFH.LCHDhAAAGAGEDIDCKDECSGFEhABAAFCAbABB.fBDA.NEECWFADhADA.....hAEA...,1,-11,-25,14
MbfSQVKGYUDRITXPZcegaCFLOdNAWEHJB,ECFCHFEEBEEGMEBF.SAFEKECBUGGG.DBDFRABH.....TECBhAAAZEAHeADGCBBCLEHHhABAdEGBABAH.JAEF.fCGChACA........hADA......hAIA...,2,-40,-21,19
YbQWfDJIaTXHEULgNPOBeKGFcCVAdRMZS,RGCCSAABQDBBDDDG..aHGAHAGFUBGALGFE.NIBFBEEDhACAeEEG.GACFhADACEADAFIDdACG.MAAFZFAE..hABA.WGACIEHE......hAFA......hAGA...,2,-20,-18,2
FIfUBGTceJKZbQVOHEWASRPaNYXDLdMCg,SCFCRDAG..aFFGXFABLGEGCGHG.IHBEBCBDTADBhAAAeAGFZBCG.QAAFhABAHEDCAAIHPHDChABADDIFMFAHfDGBcEDB.KDCA...hADA......hAEA...,1,-16,-20,4
MSCLbJfHZcTgRDBEPXIQWOFKVGeaAdNUY,UGBCMHFGLCDF..fGEHHCFATFBBDAAHBEAFhABAEFFAXDABQDFChACAFACAKAADeCDDAHBB.dAGBSHCAhABACHGEbCBH.ZAFCcADA...hAGA......hAHA...,2,-18,-4,14
KXINfLUPOHDYWcFdTMSVBaCZRGegQbAEJ,EEEDKAAD....XBEFfBADLBHFUCDDHAFHDEAG..hAAA...WFAGFGFGMGAGhABABEBFCEGGRCBE.eHDGhABAbCFDAFEHIHAG.NCIE.PHAE..hACAcGGF.SADChACA,1,-8,-36,28
dgaAQFPMbRTGBeUNOVfWDLXJHYcKSECIZ,FGFCMCCARDBGBCABUDBA....OBGB..fAEAhAAALDHHXGFCHDGHKGBGCCFFhABAIADAdAGFADAF.QEDGhAAA.TGAEeABA...WAFEhABADFIH.....hACA...,2,-32,-18,14
eFZYTSIfdKENMLWaQbCABcRUOGgHXPDJV,RDBHUDACOFEGHDGD.DFDGeCAFFGBB.ZGEG..SGGDdBGGKABHMCIHhAAALAAE.aBCEhAEAbBEHBAGA..gGAEhABAXGDAJCEE......hAFA......hAGA...,1,-15,-24,9
NQfYVbAIRWCgXeUBOTSdGcMaFJLHKDPZE,RAADCFDG.eAEGOFGB..SHFCdADGGAAEaCDHLFAB.hAAADCFGEHCA.QEFChACAVDDGAEHD.WCEGXCGAhAAABGAHMAIH..JAEEKDBH.NEIEfFCFhADAIHHG..hAGA...,1,-17,-20,3
JQXPTcWIKHSYgfUDZBeRANaCMLFGEVObd,CFEDFFAGGACGOEFDdHAD..QGDC..TCEF.hAAAIAEGSAHHhABAfCAGDDDFBBEGAGCAMHEEhAAAVABFJAEA.PDHBcBGA.WHDGhABAKHAG......hACA...,2,-39,-20,19
DAbWGUXPRcMfJKeZIYHNCOFEBdgaQSVLT,GAFEUCGCRFAF.MBCHKCBC.eFDAZECF.HEAD.OBDDEGFCBAEDaEHH.hAAA....SAAFhACA.LFFChADADCIBAACGWBAF.XGGCPDDA...hAFA.fAGFhAGAIAHA.NIDF.CHDF,1,-21,-35,14
bUMJdOWZgXeEKBcNfTAIDaYSCLFHRVQGP,DGHHaAFB.CEDC.LGBEHACGRCFE.QDDHGFAFUCABdGFAZBAC.XEAGhAAAKAFEBFFHNEIG.AAAC.hACA....SAHFhABAPHCC.MDHD......hACA......hADA...,2,-29,-16,13
MPITQWFRKbfYVUJOCZdSLaBXeEGgDcNAH,HFACMCCA.TDDFFEDGREAH.KGFH.....fAEBVGEEJCHHZAAEhAAASAHH.hABABBAAECAFDICAACEEIDHDhAAA..........hABA.QDAFhACAWAFC...,1,-29,-33,4
FcMPZbDVXgNBSeQLAEWKUaGJOIfRCYTdH,EAFBUGBCGGAF..IGFCCDFEdECFHABHFCFF.MIFEZDAGDEHH.hAAA.XADHBBACSFEFhAAA.QADFhABAADIDaFHB.JBHHODAB..fCBFhACA..hAEA...,1,-13,-39,26
bLPVKIcAOEUaGYRJDXQBZCSdTFWHgNefM,EAADaCBBGAEGRFCD.DAACQEFA.ZAGBCADDTFFGFFADHADAhABAeHBAMIFGLHFAhAEAKDAFADCD.UDCEXEDBhACAdBGANGAB...........hAGA......hAHA...,1,-7,-13,6
ScLHgYVRKAdOBeTWCZDNIFPfbQUXGJMEa,BDGFeDACCFAGZACG.DABEFGFA......bEDCUGCA.JEBEMEABhAAAEBAH...aHFG.hAAALCFC..hAEAYAHBKHBAABBD.dEFF.OCCANEIEICDChAGAfABB..hADA...,1,-29,-41,12
HUAfFgWebZaYKBSJdNQMRVOPcTGLCEDIX,FHBGeGEAZDCFKAGEBBCDdBCH...MFABRDBDOHCC..TBGGhAAALAADDGFCHBEBUEDEAHHEhACA..fCAGhABA.bGFAaBGESAECJFABNDDF...hADA......hAEA...,1,-16,-21,5
YeLDMCBVWabUSGAfdTHZNcQEKOXgJIFPR,TGBCHGFGZDDH.QAACOBDD.JAFBIAGC.FACDRDFBeHDGhACADFFHBFDAVEAFaGGBhAAASDAE.hABAfCHEcBFCECAHKHBAPEAC..hACA......hAEA...,2,-30,3,33
CMAaRTfPNSFYLgWKJZQcXeEUdBHbDGVIO,TCCB..NIEDFEHBLCFH.KAABZFABQGBEXAGCUFEAhAAABAGFDFIHGACAhABAIDHFCCHB.AHFHaFGDhAAA.RACE.fCAD.SAEBhACA.....hACA.WFAC.,1,-20,-22,2
bcBHNCLKZgTDSXUWJefEQVYdAOGaFIRMP,GAEGaAFB.FAHBMDAF....PABDBCCEHCGBLEHHhAAAgECASEDFhABAUFGFJDAF.EGFDYFEBhAAAABDGRGAA...cCBHKEFA.DGBF.WABGhACA...fAHEhADA,2,-22,-19,3
EDXZSTNVgCLMeOWaJFdGfYIQKRBUbPcAH,EGGEDEFAZCCF..SAAA.TECHVFFDLEABhAAA.MABCWHAAFGDBdBEHhAAAGADFIDBEKCEDBCBDhAGAbEEHAFIBHCGB.XFAGNBIC.CCCE.hABA......hADA...,1,-16,-22,6
KWDXgVaSFBEPfOYQIJZcHMRUNGCeTLAdb,dAFBKHBGDBBA..XECF..aAFGSBDFFFGCBDEH.EBBBhAAAOEACQFEEhABAZBGDHBCCMCHF.REABNDIC.hAAACCAD.eFFD.AGBHgCAEfCFE.IGDFhABA...hACA...,1,-24,-27,3
SXDfIBFbQZEKRGNdVgLMcJOPHWeACTaUY,CFCFTFCAUBDH...SBFHDGDBBBAC.FEAHZEGFRBCE..GEEFhAAAdGAALAHBMABCJAHFHCAFhAAAAIHA...aFEBfHEBhAFA........hAGA......hAIA...,2,-39,-20,19
OJBTWPKUbfMZCVNYDAdRLcSEFgQeIaXHG,dDBDRFDFLBHDEFDG.FDFHQFAF.aABFGBBABHHG..hAAATAEFKBEDfGAFhABAMCIFCHCG.NADDACACgGEAhAAA.IAHEXGGF...hADA......hAEA...,2,-27,-23,4
OgSIaYREGbJNceWCLDQUdMTPfBHZAFKVX,FEHBXCCBOCAB..SBHH.aEEHYECB.hAAAGGEBNBFGeHFACDDBDCEAhAAAQEBGUABCMIAEhAEAfGDEBGAEAFECKAHFIACB.EGAB.hAFA......hAGA...,2,-26,-14,12
aUPWMGREVBYOILJHQFZKATCDdeXNgbfcS,TFCACFEADIAG..dFAAeBFC...NACC...gABDhAAA..cGGEaCGDUBEGhADAMIAAEGGCBEHAOECFhAEAICHE.JGEG......hAAA.FFAFKDBCXDEDhABASAGEWBDD,1,-15,-32,17
eCfWBSYGAIXHUZdJKgMVEFaNPQDRcObTL,HEFHdDAFKAFAMFBBFDGD.aGDG..QAACDADGRBAD..OCEBhAAALHCECAFHBDCHSGHBhACAAFCF.UEBFJAHB.hABA.EHEE..........hACA......hAHA...,1,-24,-35,11
CHAQKVLIfDGFdZMNBJEWOSaXgeUbcTPRY,VBCFLGEA.DAGCdGDBZBBABGGC.EAAFOBEA..XAFGhAAAUDFFTDBD.hACARFAE.HEACKACC.ICHChADA.fEEFMIFANDIE.SGADhAEA....hAGA...,2,-29,-23,6
VaHNGDYRTQZeFgMJbCOdUSKXPLIAcfEWB,EHBGVDBHHAFB.DFEERGDE.ZDGDeAAB.MAFACFBDUDAB..XDGDhABALEDD.ABBF.fHBBhACABHHB.aDDAhADAYACC........hAAA......hABA...,2,-31,-22,9
ZHYLgSIKcaedQXUONTBDCRJPVbfWFAMEG,MEIBEGFHZFAALAEA..IABBKAAFaBCF.dDEEUFFDOBHHhAAABFCEDDACRDAF..JBHBbFGBhADA...FEAAHGAChABASHAEQDEHNCCBCGEC......hACA......hADA...,2,-16,-15,1
IVFODTZBJfYKAXGLUCacgPSdeWEQMHRbN,XDACGDDCLCBHUAAB.CAFE..aBHB..PCHHdGFH.EDDAhABAMHAAHFFFRACAIAAFhACAFFCEOHBA.DIACBDAAhADA..fAGB.ACFAcBCDhADASDGG...hAEA...,1,-20,-21,1
MYdRCPVcSHgUJQANIEXTWKBbeafZLGFDO,EHBGXCGCKECE.BFDBeDHHZACDLCDG.DEABOFGF.hAAAdCAACCBHVADESEHBhAAAHGFE.UGACAHDCIAHFhABAbEED..aAFBfFEH..hACA......hADA...,2,-22,-21,1
EfVXULSPdJTNKCWecFaBDRMAObZGgYQIH,OFBBZEBHGBDC.QFGHHABFEAGEVECALAHB.dGEAJCEAhAAATDFCKADE.CAAFeAEGhACAaGGBBHCCDBBHACCD..hADAYFHBIGAC.......hABA......hAIA...,2,-24,-1,23
SQRPLNUWMVdgGFaIYOfXDBTJcHbZCAEeK,EEEDeEGHKAGERAEBLGAG.UBGGMDGHdCAHGAAD.aCFAOABGhAAADEDFBHEFJFEB.HDAFhAAACECB.AIFG..SDHHhABA.........hAGA......hAHA...,1,-25,-31,6
baLQXURdWKfENHZOeAcVBgJITDMGSFCPY,BFDDJGEA.DGHFMAEGFBHF...CACG.....bFFBaBGB.LDAEhAAAUCBGdGABKEFCEABEHFBHhABA.eCCEAFAA..hADAVAEF...IHDFSHDG.hAAA......hADA...,2,-40,-26,14
WeCaAbKDfXEFISQRUMJNHTZOPLYcGBVdg,KHFGDAFBEBBAFADE...QGCHUEFH.MEADJCAEHGCA.ZAGHhAAAPEBH.LFGBhAAA.GDCBhABABCFAdDDE..........hABA......hACA...,2,-41,-20,21
YSeGPVHUDOALCbBdXNgREfaTZWJFMKIcQ,LAFBBBBDdHGF.XEEHREDF..aBDHTAACZDAA..FCFBKAEDhAAA.QDCAhACAeFBF.VDGFDEIHCCHCNIDFEAHFhADAJAFE...MDBF.......hAAA......hABA...,1,-1,-40,39
ULGFSfCINBcOaWMJAVRgdKYHTDbXQPeEZ,VGFGRDAGdFHEKDFE..HAABDGBC.QCDG.eFCCEBACLHAChAAAFAFGCEHCBBHDaEEHMEBHhAAAABFH.....hABA.gAGF.bFFDXGDDhACA..PADF.hADA...,1,-19,-24,5
EcZJgXWePdIfaYBOVLTKNGASRUMQFHCbD,UCCBQAGDCFDG.DGFAZFFB..JECH..XAEFeEAFdBBF.hAAAaFHDOBHH.TACChABAKHEEACAFRDEC.FAEFEHAEhACA............hAHA......hAIA...,2,-40,-28,12
DAUMNVTOFKfIdGgeYHRLPbEBSXWcaCZJQ,MFFFTFDHKDCG..dBEAGBFGeAEEHABBRABALHBGECHHBFFESFBGhAAAXDACaCABCHFFJHAAhAAA..AHIHNAIE..hABA.FGGDfECF.....hACA......hAEA...,2,-20,-8,12
AaZXDHeJVEcdWRMIYKUQOCGNgbFTfPSLB,XCCBDGADeDAG..EGDGdBGA.MBAEKAABUAFBOGAE..CCDDGDFChAAA..NAFG.FGCHhACAfEBA.hADASFGGBHHFAEECaEACHEDB.JCAB..hAAA......hABA...,1,-26,-27,1
eDMCQcAXZKagPEdGNWUVOYJLIbHfFTSBR,KDAFaHBG.EGBFdCBD.GBFEUDGC...OCAHLACAHABAFGEDBHHAhAAADAHD.CHFFACECZCCD..hAAA..NGAH...YABFhADAJDEF.fFDFSEHH.MAIBhABAXGGG..hAEA...,2,-37,-13,24
QYHbWZSecUMVAKXCRBDPgTdNfIFGaOJEL,KFFBXGDCCCCB.BBCADAHB.....PAFGdHFD..ICAGhAAAGECH...OFBFhABALCAHHCDFWABChAAASDGAeCDAUGGEAAFG.gCGChBAAfGDE.aBEF.JABEhAIA...,2,-42,-9,33
EfcOCKJeZBSGHAaFDbILXRVQdNTPUgYMW,DGGDLGEARCCC.dCGC..TAEAUGBGMCCFEHDE...OBCGhAAAJBAABBHGGEDBAFEA.hAAAFDAFXDGD.hABAVEAHNEIA..........hABA......hACA...,2,-36,-24,12
WXRgGUNZOTeAdJFDYQIVaEBcKCLfbSHPM,dEEDDFDCQCAFaBED.BGEBKDBGCBAHLEHD..bGAGPHCChAAA..XBGFhAAAGCEFUFABOGDAhABAAAIHFABCIHHE.EADHSAEAhADAMFAA......hAEA...,2,-27,-22,5
QFLCHAGePYUDgSTRVBIdWOfXcbKEMZJaN,eFEFUCBCDAIB..SACGRGFABEHA.IDDCdAFA.ODGFhAAA..XCFEhAAAcAEE.KEFHZFAGaBDD.hABA.QDACLFBDCABCAHBB.....hADA......hAEA...,1,-28,-39,11
bgFMDBACXLPONSTEZUYRKJVfHGdQWIeac,XEBELEEGODDA..NEAEECCAZCAHRAFA.KGEF..fBBFhAAAdGGHQABEhAAAIBHEaGAA...gCEAhABADCIFCHCHSAEFYFGH...hABA......hAGA...,2,-26,-19,7
KDZPRbIXCEcASefOaNGBLQYHFJgUMdTVW,eCCHaDCDBEGBLDGDHBBE.JGAAUBEC.dDAGTAFD.KFDGDHAAhAAAZADHRFEG...IHHFhAAAECGGAABFOHBEGBAEhABA.....FHEAMFID....hACA......hADA...,1,-10,-25,15
QPAJZagMeOCDGYRcfTSEVIdbKFXLWNUBH,JDCHZDAGaFEE..eBFDDHBGGADFRACH..TAACSBCGhAAAEHGE.dBAGFCHH.LFEBhAAANAIEBDFD.HGBEAEHF.hABAOEAHCGHB..fEDA..hACA......hADA...,1,-12,-31,19
DdZbRaGceSWUEBMHCLJPgXQFONfYKTVIA,dEAEZGFGRDAAaCHDGDDG..eBCCUAADEEEGHGAALDDC.JHFAhAAAgAFG.hABAFDGFOAHB.NGCH.hACA............hADA......hAEA...,2,-27,-21,6
QgCGeFBcOPaXYIbRLJEdTMZUKWfNDVSAH,QFDHCECDFACB.BBFD.OCFEXAGE..IBBAhAAAbEGHLFFDdHGBMEBAhABAKHCA...fADAhACADHACSAFDgGAHeAAHPDCGhAAAaDAHJFFCEAGE....hADA...,1,-16,-24,8
VcdWFORaHgJNCTYSMQZUBIPXLEGeAKbDf,KHFGDACB...VGCAdGHAFHBE.RDFCHCDEJFAE..CDDF.SCGEhAAAZBEABHHB...PBABhABAEBCFGEEF.AIBE.hAAAfFAC.cDCCaDACNABFMAIFhAGAIAFF.eFFB.hAHA...,2,-28,-16,12
fMeFGdWQcDHLIVNAOKCRZJaYPSTEgBbUX,CDGFRDBGZAAG..aAEGSGAH..EDEDBCGCXBAEMGFGFEGAhAAAdHGBQFBEhAAAHADBLAFEIAHChABAAHDFKFDB.PBEC.TEGD.bFDD.eDAGhACA.....hABA...,1,0,-26,26
MHADEGZXSdfOgRFKQVBUTeICJaPLcbNYW,DEFAEGFHZCAFdDCF..OAEDREDHKAGB..BDHEeHAE..CCEF...JFFEhAAAaBAALBAD.hAAA.NIAB.MBIH.AGIBSBGDhABAfDFGFGAC.....hACA......hADA...,2,-39,-36,3
PUASRfLHeTXdKDYMFNgGQOcbEBWVJZICa,SCFCRFDFLBGHeDBHdGBGDGDG..MAAEFCBAGACF.QGFDhAAAbGFAEBCDBDEHhAEAJEHF.CBEDUGAFADAF..hAFAfDFF.......hAGA......hAHA...,2,-26,-20,6
SWCOATGEKeUYfFgDVRaMBJNQbdZXHLIcP,GCEBEEEDKDHD.UAAHFGDH.DADC..RCAEBHBGJEHB...QGGGhAAAdECCZFEHLGBAhABA..IFAGhABASBDFWAEG.ACCEeCFD...fECAhACAaAGC.MAIFhADANIAF...,1,-24,-34,10
CVEOPAMacJXSFIBLTQZYUeGgbNdKRfDWH,MHFGJCCH.FAEHBCFALBAGZFEA..eCHHGAGE...NGBD.hAAAdDAGKEDGDIBE.CGAB.ODAHhABAAGIB..aBEBSDHHhACA..IACG..hAAA...YHDChABA..,1,-33,-47,14
LdVZHFDcgSMNRUOPfJEKeXaWbTCGYBQAI,dDCDZBDBDFFCSAADRBFF.UGEGOCAD..JBFAKGAE.eAAEhADAaGAH....bDFACFCEBCCDhAEA.AHGH.IEAHhABA.LFCF.FGHD.MCCAhACANIAFfFEGWADC.hAHAYDHH.,1,-13,-43,30
BKfGCMEQHYVSdIcegJUWFTLXDONRAbZaP,ZDAGBFEDKBFAGCFA.ECBGQACBHACASHBCdBHAeFEEJAHBhAAAFGDALFAEOHAGRDFEhAAAAABFaCEB..CBAD.MEIDhACAIFBF........hABA......hADA...,2,-23,-8,15
QMUIRZbWHcdLYSgKJOaXANTBEVfFCPeGD,BHHGECFCFACGeDAA.GGCBQECAUDFARADGZEFE.HFABdABALBHBhAAASCCFKGAF.hAAA.OAFCAAFE.NHDHfBAEhABACECA.DIDE.....hADA......hAHA...,2,-25,-5,20
EFASfXUYQOWNIgCBZbMeKDdGaPcHRJLVT,XGBCUCGCOCBA....IGHHCFCABFHCZAFEMFDADHAEaCEFhAAA.HAFALDADhAAAVABBEGEDAEEE..SFDHhABAQEAD.gDGEKGGDdACF..hABA......hADA...,1,-11,-34,23
DgUMfATZXeCcBKHQVOYPbRJIFaLEGSdWN,ZCDBeGFACDBEBAFEHCEDOEAE...bGBERABCFFFE.EHCAGBAHhAAA.SGAFhABAdCHEDIGGMAAFAIHAXAEAhACAKCFG..QEAG....hABA......hACA...,2,-36,-2,34
DQXZLHbOdgMaNeICPWJFVYEBTfSAcGKUR,KGAHUFCAQCFGLHFEOABHdBCC..aEBAeDDC.CACF.JHCAhAAAFAFD..VGFCEFFABDBAhAAA..fAEDhABAAAHH.cDGDDAEH...XEDDhACAHFADMAIF..hAFA...,1,-21,-24,3
gNTfARbDaUHBJWQcXYZFSPVKOGELdeICM,DHCEHBCFBCBAQFGH.XAFCFDEASECDVAAFOHCChAAAEBGE.dDGF.CFDGMDAFhACATFGHAHAE.RAAAaAGA.hADA..UADE.JEEF......hAAA......hABA...,2,-35,-2,33
fCYIWeZNaAFJgBTHbLPRcDOUQKXVdMSGE,JCCHTGGGHFBE.LGFGRBAHDDDB..UBFDKCADdAFGGEED.EHEGhAAACABA....IAHChAAAeHAANGBF.AICCBEAAhABAPACA...........hADA......hAEA...,2,-40,-12,28
RFWICefcOgYVaSPXDQKTNUGLJZMdAEBbH,BFEDHGFGFEBHCECA.eHACOCED..VBBC..aAAFSEFChAAADHEAKACF.UGDGJHAE.hADAMCAD.AEDDECEA.hAEA.bAFFIAGG..fBDAhAIA.cDGB.hABAYHFG.,2,-44,-7,37
RLeZFNMfAQaIDUHKTEPYVGCBWSOJdcbXg,aGFCDAFBKECG..TCACEEEE...VFBDBADA.SHEChAAAdDFHXACALCAGhABAFAFCMIFAAHBBQBGGhACA.IHHGHDDBYAAECCEGOGAA.hAHAcEGA...hAIA...,1,-18,-26,8
MWKcBEdaAgTbNPHJQRLGDSIeFCUfYXOVZ,TCBC..PECCHAAAREAGDIEC.eEHHCHDEUADE..fAGChAAAXDGAOFDEhAAAMAFDKGDABAGF.aHGEhACAAEBGgBCH.NBAEJDGD...hAIA......hBFA...,1,-20,-25,5
XTBDIgHPZWURSVcJKfdGFeCLQYbAOEaNM,OEGHEAFB..MCIBTBBBDCCFHEAA.ZFDGREBGSFADhAAA.JBEBfACGhAAAFHDCCDAF.YDEEhABAaBGEBHHEIGHH.WHCA...hABA......hACA...,2,-33,-17,16
MGFJAEaLdWZOQTcgYHeUXfIPRDCNSBKbV,EEEDaEEDLAAEZCBG..TACG..YBCFeFAAfHBHhAAARBDGCDGE.SGGDhABAKEABMHBGFAGGABFAWBHBhACAQGGEHEGD.......hAEA......hAFA...,1,-17,-21,4
EOIFfKNVAgCTbBWSHedMZDPRcXYUQaGJL,TGGGBFDGSFFA.HFADMDFFDCCGPAHFRAEC.XGCChAAAQDEHGABChABAJDAEEHDGOFAHFABE.fEGDhADAKCHBAIHGCAAC.WFBE.dAEB...hAEA......hAFA...,1,-2,-19,17
FaAHDXBVWKGCOdIQcUTEYPeRgZNJfMSLb,HFEEDEFABCBAKEAGCADAdDDE..QDGFUAFC.ECBCeHBA.ZAAChABANCED...MAIHSDDGhAAALEAH.FFGHhACAAFIHWHBE.IAHG....hABA......hACA...,1,-32,-34,2
MPAZKXSNVQBcJdTUfGFLYCObRDEWgHIea,XCCBSCFC.QAAEBGFFdCHA.UGGGFCABLAGFhAAA.OFCDDGBGgGDAhAAA.IADAhAFAeEAH.aDCEMEEFAFFEKDFGNBABJHFEfAGBhAIACCEA.....hABA...,2,-26,-19,7
eZQaYVCHATRXgIEfJONdGUBWLFPMDbScK,RCDBXCBCEEAE..OGEAdABDBHAELCGDMFDE.DACG.SBAFhAAAeFBGaHGACEHAAIGG..hAAA.TAFFICBHhABAfCECJHAA.NCAE......WHCEhACAPAFA.KFCB.hAEA...,1,-19,-31,12
JAeTdPWDHZSKNOXgVFfRcLCQUBMaIEGbY,TAADdHBHDCCAZFDA..KCADOHEC..VBFBRBEFLBGHhAAAQFABBEAFMFEBEDBE.hABAbGFE.AEEA.eFAFPFFAhAAASABA..XCCCfEHChACACAHF.....hACA...,2,-19,-17,2
fIOCTcMGFZDbPNALgKEYUQaRdeWJVXSBH,KDCDUGBCQFEARBED.dAABJCAC..VBFABDHG.HEDA.hADAOABCTGAAGGEHhAAADIFA..NEIAABEC.EBDDhAEAaAFF.XEACSEECIAHCMFDB.hAFA......hAGA...,1,-19,-20,1
fLQTCDOAFHUGRbXIdZaBeYMVNSgKcPJEW,UCCBGEDHREFB...bGDAdAEF.BCAH..MDAGSCHHhAAAKABAPAEF..EGCFLAHBhAAACHAE.DGAHFABGhAHAXEAFIFBHaHBCeFHHNEIE...gFDBhAIA..hBAA...,2,-34,-8,26
TEDMBAbOQFIPcaYXZeVJSGKHCLfUdWRgN,ODACFGFC..IAGCaAAFZGFE..eDFASADHHFBBCAGALADBhACAdFBHRCFG..TCAGhAAAMFABAFGBQEGBhABA.PHCCXGDB....hAFA......hAGA...,2,-20,-20,0
HdCNcKaLOMWgRfFTAVPIUBYbZGJeDSEQX,VAADUCBCBHGE.ZBGFeAGD.DFGGSGADECDE.HADDhAAACGDHKEAELGCE.hAAAMFEGWHAG.REEBFHGAhACAAAFCICFE........hABA......hACA...,1,-30,-34,4
EHMDaGIJAVZLeBPKXWfNTRYdOCgFcbUSQ,VDBGeFFCKABH....XGFG..fGCAhAAARABCOAEDFGBAUBDDQAGChAAAHAGHDGIHIHEEhABAAIDGLEFCWDADNBAE...TEDD.CEBF.hADA......hAEA...,1,-12,-28,16
ETfIgeVNYMAZaXGHKdRSBUJFcCQWPbDLO,XCCBHCCHdCGARAAFBGBGFGFA...CFCG.QBEA..WAGHhAAADIEGEEBB.IADAhAAAgGGC.NIBB.hABAAIHAZGAGGCEESAFEJACG.bEFA..hACA......hAIA...,2,-31,-9,22
fIUSONZBPcFKXdQCReWAETYbDLaGHMJVg,TGBCDACBLBAF.HDEAJDFG..VFDGfBHE.SGAFhAAANCACBBCG.FFCChABAKHGGdHGBCEBF..eCDChAAAEHDAbBDE.MAFE.......hABA......hACA...,2,-39,-3,36
BEMgfDCIRQWdbLZUPONTaeSGKJYcVHAFX,FFFBXGAFEBEF..MDHFDEIDRBBA..dGBDZAEAODAC..aFEBhAAASBCDKDEC.hABA.JGFA....hACA............hADA.cDGGAFEBfAAEhABACAHB,2,-54,-46,8
YgXQIHTfLbEWANSVZDKBdGUPRMcFaeJOC,SCFCDDGBBHCBUEDGRGDA..MCBD.FADEaEAB..eDCEOBCBhAAACGGE...XBFGhABAIEGG.fGAChAAAEGHBAIAG.NCIAKAGCdBHAPHEC..hACAcABCgFAHhADAQECG.,1,-17,-29,12
LceXBMGUCZDfVIAJKaNdObYPHSgTERWFQ,JEGHKAFBdHAD..OCCD..PFDGHAECSABDhAAAEGGC.FHEAQCGAhAAALEAFXCFAhACABCCEGDAACFCDDICAIDEGAIHGNBIA.bABE...hADA......hAEA...,2,-22,-20,2
RWPfLFXcSegHKQCNdZJbAEaDMTUVIYOBG,DGGDTGABUFAC....IBDHODHFBEFFGDGGREDD.PCAFhAAAFADD...cDEDhABASAGD.eBADhAAAKAFENAIAZBBFADDDMGCG....WFHDhABA......hACA...,2,-39,-12,27
KfLeSJORcMNbTIQVdDXACBPHWEGaYZgFU,BBBDHAADEDGEGAEFaDEF.ZGFE.FEDGUEBALDGDSAGD.hAAAOGEGMDBHbACFIHHGhAAA.dAEEAHAFCDHH.hACA.WHACKHCA.........hABA......hAFA...,2,-28,-11,17
VDGBNAbEIgeSWULRFJdYMHaZOfCcKXTPQ,EHBGeGEAUAADRECD..FAFBdDAHHEEAZEGH.CACH.KCGA....XCGChAAAQFEAGCAAhABABCFCNIEH.AEDF..IAHAhABASCCELGACMIAE.OBDFfAHEhACA....hAEA...,2,-22,-12,10
NXOQRbcfdKCHeZIWVUSaLEYFGBJPDAgTM,MFFFXDACRCFC......fCCDCFFBHFABIDEGhAAAUAECaAABEHCAFHBABHHGDBBHAIAAhACATABC.OCFGhABAcEGGeDCH........hADA......hAEA...,2,-29,-22,7
VBbeDZfLIAXYRUdcFKEOHgJCaGQWNTPSM,REFHdGFCFECEKAHFHGBA..CGDHGBDEQCBF..TAACMEADBHHAhAAAeCHF.DABEZDACIBEGhAEAAFCD.XBGGhAFAcGAF.OHDEaACD..NEIE..SAFHhAAA...hAGA...,2,-19,-16,3
LVbMOZgDFARcTHQdEKaXUNWeGJSCBYIfP,TFDHdDAFEACB..KDFCUEAA..eEHBJHFCBFFE..IHAEhAAALCFCMEFHZACBDDHHhAAAABGCRFBD.QBAFhABA.aHBAWAFESAFEfGGE.hACA......hAIA...,1,-23,-30,7
FRTefKDICHWGbBMLaXPOUdEVgNJcZAQSY,SGFCFCFCeGAADBBBCACG..HFBAGECHBDFCMAFCLEBC.hAAAXAEAUACEdGGDEHDEhAAANBIG.JBAD..ABFA..hABA....YHEAfCCB.IBHDhADAaEBG...hABA...,1,-17,-27,10
VFITfHQdMJYGKbCARBcXeLOPNSWZEUDga,BFDDXDACOECA..SHACECBFDDHF.aDDCFHGE..TGFBhAAAQGAAMCAAJFBEhABAKAFDCFGDAHDARAGFLADBhAAAPBDA...NHCBUAGEgEGE..hACA......hADA...,2,-23,-16,7
UXaJLESTDBMIbcYZWdQNCOfGAVKePRFgH,VDEDeCCHRAAF.HGFAUCBH..JDHBLHBEEFDC.SGHFhAAABHDEMBGB..cBFChABA..WAGBNAIE.hACACEABOFAHAAFCKEBBgACC...hAAA......hACA...,1,-17,-25,8
LaTQPONcbZKCGMJBEWDFSURdYHfIXAeVg,eFBBVFDF.LAFC.aDGHPBED.OCAGNAAC.ZAGBCDHAJDDFhABABHFA.DAGDSBBChACAUFADdAAD.fGGGhADAXDBEAADC........hABA......hAFA...,2,-27,-25,2
GZWVcLRJdaESUFHBbXQMYNeDfOPKAIgTC,TCBCCBGFZFGF....VEAELFAA.RACCJEDCEAECFBCDBHEF.hAAAQGGEMBIDeDEHhABADGEC.OCFAACBFIHAFhACA..WHAEaHDA.SAABhACA......hADA...,2,-29,-26,3
XOeLWdNDQMVIfGYEBaHcATZRFUPgSCbJK,ZABHUCCBSBECCFGC.KEGCeHCE.dAACDCGAMFBC..fGAAhAAAEAHBBADCHAFBhACAADGAFGFH...PFHDhAFAgFCB........hADA.bDBA.OAFAhAEA...,2,-37,-26,11
ELaKbdUAgDWTSeVBCXQZRGHfJNPcFOYIM,DACBSGFCBDAG.CHHC.QGDEGDBCHAAC..JHFANBGC.FDCFhAAAODAB.MIBAhAAAEAFFKHAEdDHEAEEB...hABAgBDFTCGF.......hADA......hAEA...,2,-46,-9,37
feZNKCILgdGaMQHVAbURcPFXTEYDWBOSJ,REFHFHBGEFHFDCCA.BCFCOAAB...JEBBeEAA.KABFLCCAhABAdEFC.MBEA.QGDDhACAAGIF..hADAbDGF...PACG...XAGEhAAAWAHBfDGBhAEA.CBDD,1,-32,-54,22
MXgNYdEePZVaAQTJDHCFcSLBbUKRIGfOW,QDCHTEGD.DBIFFBBGLDFFBBGAUGBFRADFGCGG.OGCEhAAAXBDE.NDEA.hAAAdBAC.eFAG..hABA............hACA......hADA...,1,-15,-47,32
KAGPcQfDHXMRaFEOSNIVWbgCLYZBTUJed,GAFEQCBCDFGFMCACRGCCFDGA...OEHFSFAF.VAEFhAAAbFBHLDDDhAAA.BAHHTEECeDAFhABAdGHAKHDEACADcABAfADBaEDBEHFA..hADA......hAEA...,2,-11,-11,0
QXKIcAMfRSUbJBPgFEdLZYTOWNeGCVDHa,MECGRDAGUFGCBHAC.FHEALBAE.ZGAATAGDOBFBeBCChAAA.GDGCDIAAaBGDKFCBhABA.ACAH...fEEEhAAA.........hACA.SCBGhADA...,2,-37,-35,2
GgUIfReFOEcSXZMTPBYNJVWaALHDbQdCK,HAADDAFBdAGBCHADGDEGUAAB.RCCD.FECB..EAGG..SGHFhABAXADEMEHHBCHE.JGBEhAAAaEGCAIEA..QEAFhACAKADF..fFDF.OEADhAEA.ZGDE.TCDAhBHA..,1,-10,-28,18
AQdVOERZBMJIgXYfTcSKGCWHaFNUebPDL,VBCFODCH.REDFBBCCMIFA....JAFCXFAH..fEGAhAAASHGAKDAFhABAGBDHHFDDFFBDNADHeCAFhAAADCIDAACCdFGE.EDHBIGHA.YBFFhAEACBACaHBE....hAIA...,2,-29,-7,22
NZQgMGKcAPCXDFEHbJBUOSIRTWLafdeYV,XGGGEGCDHAACJHEABCFC..UEGEOECDRAEA.LEEDdEDCeDAFhAAAVDAHZFAB..QCEBhABAMDIBKABDABIBCDCCDADEhAHASCCE.IAGD.WACEhAAA.aHCC....hAIA...,2,-30,0,30
CSDXZWOdMBQJRAecFVUaTKHLENbYPgIGf,FDCDaDAFHDDFEFHF.....NAAD.bADF....PHCCICADhAAACFGFDECHZGDE.dGAAMCCAhAFABBBEQAGGhAIAAHIHcEEB....UBFFKGBD.....hBAA......hBBA...,1,-18,-23,5
DfHXWgQNMAISGLCcZaPKYVdTJEFOBUbRe,GEAHLAFBCGHFZAEGaHAA..KECAdCBD.EGEHOAAF.BCCGUAAFhABARDGD.DDHHHEEB.XACEhAAA..gGADhADANIEDABID..SDAGcEEF.hAEA......hAFA...,2,-33,-16,17
JBVMEdaIHAbDRfXgGYNQUSTecCKPZWOFL,RFDGXCBCGAAFQCEDUFAF.eEHBKFHHZCEH.OGDGhAAAFBHBBBFEMABEEHAAdHFHaDABhAAAABFC.DGAE...fDCEhABANAIC.cGFDPBBA...hADA......hAEA...,1,-13,-23,10
gWNJROPYZEeDGUHaAdfMVQLBKIXcSCTFb,dGFHMECGQGACKAHH..XDFHCFDCFDDE....bBFFNCAGOFDChAAAZABF.eFHHhABADAEF......hACA.HBEAAADBfEGFBCCCcGAESAHHhAAA....hAFA...,2,-36,-20,16
SKgeITFYAPfHJVUZREXcDWaOdCbNLQMBG,HAADVAEG.RAEBEEDC.DDABaDFE..dHGFCFGALDDFBCCDKDGD.eABDhAAAFHBA.AIHA...JAHFUEAChACA.XGDAhADA.OHACbFFCNGAF.MEIF.SEEGhAEA.....hAAA...,2,-26,-7,19
OcagEDARCMGIHQKePUFBYSTZNWJLVdbfX,RFBHCGADGBFGQFECKEHH.UAAFBEAF..SAFDZBCF.JAHDhABAdFEC.XGGChAAA.aFCHEDAE.ADEGIHHChADAeBBB.FEGFNADF.......hABA......hACA...,1,-23,-30,7
KSZCeGHcXWQAVBYFNfEgOTUaPRJbLIDMd,BFDDFHBGEDAEOBAD.UCFFaFEH..RFFALAAEMHFC.KAEBCFFCGGADhAAAHCFC..XCCEhAEAAFAC.NIEF.fAEDhABA.gACE.TCCChAGA....hAHA...,2,-39,-17,22
eVLHJYRGZWEbITAaNCScdfOMFXQBKPgDU,CFEDSAFBdHAD.ODFCXBFA.KDACDABE.UFDHLAFChAAAJEBBGBBDEBCDTDFFhABAaGGF...NAEE.MAIDhAAABGHA...eGBE.....hAEA......hAHA...,1,-22,-33,11
gSLJMeTHBCabVGKOYcUWAfZDEPIRdQNFX,DHCEEHBGRAFBdAFE.FEDB..SAAFLCBD.eECDBHBG.CHFH.aDADhACAGBGCKDEH...hADA.cBCCACAF.PGFChAEAQFFH.NEAA.gEGEhAFAMAAG......hAHA...,2,-34,-22,12
WQEGOPdNIJYCVbHFecaLgDKARZSTUMBfX,ZDDFSEHBMFHHBGCA..XBABEBABGAFCdGDEJFBD.CEADHCCAhAAAFEBAeHDALAHHhABAKAHBAEAB.TFFH.hAAAfAGEOBBGPFADIADC..hACA......hAFA...,2,-17,-15,2
UCRdAYEFXIeGbaTZWcQJBPfMVKNDHLOgS,EAFBXGBCGGAF..aHGETDFA.ZCBDQBADBBDBMBAFhAAAKDFBDHGGHEAG.gAEBhAAAUDDECFGHAEIH.IHEEhABA.WBDF.JAHB...fEEEhACANIDFSBBFhABAYEGBbAGF,2,-20,-6,14
IGbWXDVCaOAZHFJRNMUdTgSYQLfeBEKcP,HDDFFDBDRAAC.UGDFdEGG.SDAHLFHHBAGGKHGA....IACFhAAAGBDFXGDEhAAADBHD...CHADAEEEhABAZBAA...........hADA.MDDFYCGFhABAeEAD.PFBF.,2,-28,-22,6
PBJeDTMYdXHQVKGOgCNWfIaUbZESFLcRA,BAFBeBFDDACGMFGDdFGDHEAF.KCEGOBBC.CHBC...WEHFhAAAaGCAZBGF..EAHBFEBChAAALECBAICA.JBBChABA.XEEB.......hABA......hAFA...,1,-24,-42,18
NKgdAOFecBfGRHXIbMZTDUPaEYQWLCSJV,FGDBeAFBBDDGRDDGHACD..XBAGMEAFTEGDDGFC..aCFFECAEhAAA.QFCChABALCHFCGABSGGAhACA..NBBBKDAAABHAOHDCfCDB.IHHAhAAA...hAEA...,2,-39,-3,36
ALYGHeUWcXBTPQESbJZONVaIFCMgdfDRK,GECFeBDGUDDG..XGEEBACFQFGHSCAAZEAHNAAF.hAFA..aGEDFAGCCBAGdAFFhAAAfBED.DDGEhAIAADCH.....YHCA.cBCAhBAAEDGA.....hABA...,1,-18,-32,14
TROUBfaYXMNGbEALPKcdHCVDIgeWSZQFJ,KDCDdCFCCEDCDFBF..eADAZAAGFGGG..RBABUGGCBAEB....aGCAhAAAMIAC.GBGEhAAAEEECLAGF.HBDBhABAIGBA.SFFD..hABA......hACA...,2,-37,-34,3
SDFBaYXPVCERgIGcONJLZdMbUKWfTHAeQ,QAADFGCDBEDC.aGEE..XEFH.CFAH.RCDFIDAAhAAAGBBFOAFALDHDhACAdBAGMHEEKAFEfGCGhADAAFEDDIGG..PCFCEDFFNIEF.....hAEA......hAIA...,1,-18,-29,11
IRUNYdfDeOAJaCXTVgWBHZMLKScbEPGQF,CDGFTCCB..VDAFBFEHHFFGMBGDLCDBKHGE..bEAGEBBAhAAA.GGAFFCAGRGAA.NAIE.hABAdAAFDADCODGD.hACAAAIFaCEF..........hADA......hAEA...,1,-17,-21,4
dJecUVEAKgROQTFDBHNYSXfWPbLZaMGIC,KCFCRFDFQBBGDIECBAAF.HEAB..SFFHXCFEfFFDhAAA.PAEHhABALEHH.MDCAhACAIAHCJHBEeBDC.UEACACIDOHFAFBBGWAHBhADA...aEEF.hACA.CDDD..,2,-29,-13,16
fJQOTKGWBYECcRLgXAZPUbHDaIdMNFVSe,UFDHDHCEdGFBFBGH..SECHeEAA..JABAQCBChAAA.OABETGADKEEEhABABGGEEAFD.RCCE.XEGAhACAAHEH.ZAGFPEFAaHEEMEAF..NAAE.hAEA......hAFA...,2,-37,-10,27
HLXaDBVOFPKbReYGAdNgIUSfQMWZJTcCE,dHBH..IFGCSACHMEEAJDFECCHBLABGDCED.OFAChAAAKAGDeBAHGCAFAACFUGGEhAAAQAFFZEFGEEBH.hABAXGDDBBEB........hACA......hADA...,2,-26,-24,2
OPVFdCDRgNSLHTIfEQAGJaeBUWKbMXYcZ,JCDGBDGF.KDDEMBBH..XGCGZFEEOFADFABH...CADF.DHFChAAA.REFA.SHEAhAAAHAFATDBDECGCACCDaFAFeAEAhABA..UADEWDFA......hACA......hAFA...,2,-36,-22,14
aGNDMeQAfHJBCObZYKEIXFdWSVgPcTLRU,HFDFJFCABAGAOBCC.ZAAFEACBFFBD.dFGA..SBFDhAAA..PAHFLCHHhABAaBFFDGABQGGGhADAADDF.CGACKEACIEAHXCDDWDFGcGCChAEA.....hACA...,2,-29,-26,3
eHRDgIAPWQFcKOLYBGTEbUMXJaVZNCfSd,QCBCFAFBOEEEBGGDEAEH..UDFEMBEFJEAH..ZCFGCCHBdBAChAAAeDABHFCA.DGIHABBA.hAAA...PDCHhABAWHEA.KGCH..........hACA......hADA...,1,-24,-37,13
IBeEDVdMQACPbFNYTgfSJGXUWOZKcaHLR,CFDGFHBG...TAADSAGEGFDHUCFBZCGFKECCHEECLAEDhAAARABEBECFDEIHdAGHAFBA..hACA.NDAE.fHGBhAAA.JDAB.OHBAICCE...hABA......hADA...,2,-30,-14,16
ACMfXGUPLNORgBbYJZcHFTQWSIaEeVDdK,CBFDXFDBUCAF.LDCGRGAG.BGFHJFFE.ZAEEHDDBFGACQAAChACA.SDABhADAECGF.DIACKAGGhAAAAIFGMDHH.fFCENABHbBCB..YHEEhAGA...hAEA...,2,-29,-25,4
CMXBIVYUQOHZJRaSfDGENFAcKegLdWPTb,eCCHdDCD..TFAFMCHBBHHE..VDFGQGEAZFDCJBDGRAAAhAAAfAGA.hABADGAAEHCGFDAFAIFG.gEDFhAAAPFHD.CBAD.IDAA...hABA......hACA...,2,-33,-14,19
LBQUOMHFZGaKPgJeEfCcdWVSDRTNbXIYA,BFFEQDCHOABDFGDEGAGCKCAF..JBACEGBF...fDCFhAAAdCHGSHGAhAAADHGARADE.TBED.XGBBhABAAGEBMIFGaDADeEAFCEEF....WFDDhABA......hADA...,2,-29,-19,10
HdYDaJGZTOLbWXEFRASCKeVIfgUPcQNBM,SEHBeCAF..fDHGUDCCQFFGMHAAHDBCdADGDBFEhAAAJFDEGAAFOGAELBABhABAWBFC..hACAFGGDAFADCGDBKFAA..IHHA.cBGDhAFABCFH.....hAAA...,2,-17,-14,3
LgQcNXAGYVUJMaWEKHdRIOSCfBTFPeZDb,GEDHUFDHMAIHEAACHBCG.dHDHRBBAODAHSAGDBDECTFBDhAAAFABG..ZBGFDEGA.hAAALEAFQGAEhAEAcGGGABEC..JHFG.aEFFKDBE.CADC...hAFA......hAHA...,1,-4,-19,15
LZSVDMfOBNPKabUYFcITCWXHQRdGJAEge,eCCHLDCHZGFEDDFEMHEGBEHHKEBD..UEFAFGBC.....IAHGhAAACBEGHAFCdBBEACCGEABHhABASEEG.hADA.OAGHNACH.aAEH......hAFA......hBAA...,1,-33,-34,1
ADBCVecQbUdLJagMFOXRPYKNHGEWZTfIS,CAAHVFDF..QDEEdBABLBGFJACF.MFCHFHGC..RDAEKHBCHCAEhAAA.EHGGZAFE..IDEAhABADIDAeGEC.UCGEhAAA...OFABPBHD.NEAA...hACA......hADA...,2,-18,-17,1
VHbQYGSPNgDdCKMITRaXEeZfUcFWLABOJ,BECDVFBG.QGEGGACG..SCAGPBBB.DGABdGCACBHEMFEEhAAATAED.XBGDhAAAEBEGeHCAZACFfGGHhABAFEFCAHAG.........hABA......hAEA...,2,-23,-14,9
INUeELKHDbcfCJGRMYWXSZdFBaOAVQgPT,QFDHTCBC.UBFGLDHBDCCG.fDEGCBAGGDACMFIFhAAAXFDG.dACF.hABA......hACA............hADA.BHGEaBGCAFACPEEAhAEAIHEDNIAD,2,-36,-32,4
fUgIWEQYAGJKdDNMFLSCZHabBOTceXVRP,JCDGDGGDFGADLHBEZFDF.HEFHBDBB..OAABeAEH.RDAB.UABFhAAA..IAGFhABAQCGEACBCKCGGdFHG.SDDGhACA.CEAF..aAGA....hAEA......hBAA...,2,-31,-28,3
gJOWAFSBDUVXQTCGHdMcZPREKaNeLYbfI,FEHBSFGEBCDDDHCGUBDD..QAEBCEBFdCGEZEEH.RAACKDFHeAFGhAAA.LABD.hAAA.bDADIHAEhADA.OEDBAFDFXGGE.....hAEA......hAHA...,2,-38,-24,14
NODYfAaSQMcKCGXPLTJbFIURdHeBWEVgZ,SFAAMFFFKHGEGCBHLFED.TGFAJAAG..FAGGUAABhABARDGBHEACeDEGBHCEVADChADA....NEEADAEBhAAAAFGE............hAFA......hBDA...,1,-21,-25,4
aUIGdSHBDbAZXJWMOfNFKcEeVRLYTQCgP,XBDGMDEB..ODFBFDFFKHAEEECHRAFE.LACD.QGFEhAAAgBAAUAGGhABAdHDBBEDGDEAEADIHZFAFfEBGhAAAeDHDVADECHGHaGGG......hABA......hACA...,2,-32,3,35
IKJXRFYQSAVTcGMLHNCgbZUBOePdfaEDW,TFDHMEAEHFCG.CAGC.ZDBBBDFFeBDAdBAGaHBADGHH..KGGDJBCAFBADhAAA.QDEAhABAAEIF.GAGELHDGhAAA.NBHAUFAEfEAA.WFHB..hACA......hADA...,1,-10,-27,17
SPYNMZRfWDecILbBTXEGJOVgACaFQKHUd,CEFAFFAAKDHDdDGF...SAAE..YCAHZFEDRCCBDBEDeAEChAAA.LGBEhABABAEBXGGBJBBA..hADAgGGGaAGB.QDDF.hAIAPHBCMHBC...hBAA...,1,-23,-36,13
eIgGPYJDLEFRQcaVBNTfKdUXZbSHACOWM,CAFBMDEB..eEACGBEDJFCF.DEAHLFFFFFBCRBBH...QAABhABAaFGBBDFG.NAIA.KAADhABA.dHAFZBDA.SGHBhADAAHDDOEHDIADF....hACA......hAFA...,1,-27,-28,1
VCHKLZdJWASbOYTRgXeFQMfIPDEcaUBGN,OCCHREFHeDEH.FGFAMECH....fCHEIACBEHEEaEEE.hAAABEDCGAEG.CHBBKACHhABAZBCG...dGACAEAASBGAhAAA..TGDEXGAHhABADCAHNBBE.....hAEA...,1,-17,-31,14
BKfeFXIUESGgJdQcbHVPOMRYCTANWDLZa,DACBLDCHBGFHKBFAFDABUACG.GBGAJDDH.dGEE..QBDEhAAAHFAB..OEFFhAAAMDIFRGAACHHGAAGEZDABaCFBhABA....eBAF.EDGF.SHGAhABA....hADA...,2,-34,-14,20
JAHQeFNKZCYESdGDOXcbPMBUVRgWaTfIL,QBDGFDCDZABG.CFGB.SAHBdFDAGCBEODAH..bBFFhAAAMEFDBGADRBDCaGDFfCHEhABA.JFFFAHGAeBHDhAAA.KGAADACE.......hABA......hACA...,1,-18,-28,10
JfMGXRbCATWEZSDIBPUaQVOKNdYLecgHF,EGFCSGGEDCHF.BAACaBCF...QEBBKBFFdGADLCAHhAAAeFDHHADHJEEDMIFEhABAXAGC.CDGDABCF.ZEEFhACA.IHAA.......hACA......hADA...,2,-40,-14,26
SVaJHEBWbICULfgQOGXcMAKFeYTdRNPDZ,KEEDeCCHdAADRGFE.DCFHZEFG...SBAFJDAG.HBFCBGFAIGAFhAAACFBF.LAFChABAQGCCXGBDhACAACHD.YBEF..TADF.hADANIEF.aDBBEAGF...hAEA..WFAD,2,-51,-3,48
aRDQdFGbSAcEONBMXPIHJVWefLTgKYCUZ,OCCHBBFDMCCH..XBGAHEEHJAACeHFALEGBKGEACFDHZGAChAAAaGAE...RBEBdBBFFAGGSGDFhADAADDA.hABAEDDAIDAC.fFFB.hAEA......hAFA...,1,-19,-28,9
QIHGFWOYafBRgKPVcUdDbEACZJTMNXLSe,CEFAJBDG..MDDGLEGF.eEAGQFGDGGAHFBBHOHDEhAAA.aAEGRDDBKACC..hAAAcDBHDGIFAIDAZAGFXFCAhABA.SCHH.HBBA.hABA......hAFA...,1,-13,-21,8
BCNQJLAEIScGMVaRedWDXYbfFPgTKOHZU,EAFBSHBGGGAFMBEBRBDH..eBBHdHGHDDFFXEAA..hAAAfBAEFEFDTBGEhABAKDBHOHFAZAGHBFHDhAAACAHB.NADE.JFDFAEIH.........hABA......hACA...,2,-22,-13,9
FQWcVZESOJGAgBMUHNRLYdKbXTPCDafeI,BBFDMEIBUGDEREGHdFDA..KAGA..XBAB.CECB.fEAChAAAFBGD.QCAHhABAVADCEEFG.OACGhAGAAHAB.NIAFLDDE..YDAFhAAA......hABA...,1,-21,-37,16
DOKCMJWgBFLZNPedHESYbIGAQafTVURXc,aGFCVEFH..UBDHRCCF.DIGACHCA...MGACJDAD..BHHGZBFBeEAGhAAAHCFC...EBAF.hAAA.bABCAEHF..fHABhABATFBC.OCHFWEEF.LEDHhACA......hADA...,1,-24,-26,2
RHEeNFVfgSQJMIBAWYOaTcCbUPXKZdLDG,OGEATGBC..CEAC.UEBE.KHCCLDDGRBCA.EFFHeEEEFABFVADFhAAASAHD.hADAQAAFIEHEABGGhAFAaAEAbFDF..........hAGA......hAHA...,2,-29,-20,9
IQbOEdBMJgcHSDKfCVeXTUaNARFLPGWYZ,RDEDLCCHGDBAZEGBQGDF.EBACMFIH.JADCHAFBDBAE.hAAAfHFF.hABACFBGeEEAXBDGaDAGAHBDhAAAPHCC.IBHFOBEHBAHA.hACASABEKGAF.hAGA...,2,-26,0,26
URTNIScOPYdLaMACVGBfEeFKgZQDbXHJW,CBGFVCBFGDDG.BEABeHBE.FGGBZDBHDDFFHACD.UFGHRACC..hAAATBFFSCHBhABAOEEHdGAELAHBhAAAMAFAACAH.EFAE..........hABA......hACA...,1,-19,-20,1
IfTbEPHcKDaXAeWQUVOBMNFRZSgJLCYGd,eDACQCGCUEFHBFCHFFGGZBAE..SCFAJFCGLHBACACG.hAAAdEAH...fCDChAAAbGEGHADBDAGAABAE.hABAOFADMBEE.........hACA......hADA...,2,-27,-25,2
gWSXfQGYbDPNcHUJTERaeOMIBFdKALCVZ,LFCAVCDH.ZBEGSHGAQDBDGBGGDICE..NEEH.UAAChADA.TFBGaBBGMFADhAAAFAEGAGEG.CGGE.XGGEhABAfHAB..PAEA...hAHA......hAIA...,1,-17,-23,6
TYZRFIWXLdbOefKJEHcADGUCPVaQNSgBM,UCCBVDBH.QGEG..gGGEMBAEZEAARGACFBGH.IBBAhAAAXBGHdAECOFEAhAAAKDDCHGAEADAGDBECCHEAaEGEhABABEHE..........hABA......hACA...,2,-23,-13,10
KMGRTNELZDgIQeCXcJVUSfaFAdPbHBOWY,dHBHHAADOAEHKHACGCGGRFEF.EADADBDDQFEF.CBFA.XBGDhAAA.VDAHhABASDDFFEGE.AFIDBFBBhAAAMACF.NCAE.........hACA......hADA...,2,-33,-21,12
ARIgWaSXdeVEcGDMBNZKQLTFHCUOPfJYb,RAAD..IFDGaGAAdDEE.EBDDDACE..BEAGZAEEKDBBLCFB.hAAAFBAHUEGBOHBGJGDA.hAFAAGAGSCCDhAAA.XGGBeBHH.......hAGA......hAIA...,2,-33,-29,4
WGJAReLZBKbCSaVgYIdMfHNTEXPcDUFOQ,LFFCKBBDCDDA.SBEA.aBACgBFH.dDHEhAAAfDDGHGAATACGhABAEADAXGEChAAADHGAFGEDQEADWDADAIHARFBFBDFG...YAHFhABAIEFF..hACA...,1,-11,-31,20
ZdbXcWUfPAOgJEDTRVGaBYHIFQCSLNKMe,OEEGEDCDDEFD.REAGGAAFBEBDHGAC.FBBECCEDLGAA.MIEAhAAAZEGBdAEC.bAFEXFGGhABA..WAADhABAUBGC.AICA.........hADA......hAEA...,1,-22,-29,7
WSaALcEONdVXYMbgTGeDPKIBCRFHfUJZQ,EDCDdDCD..XAADMDHB..TADAGADHeEEHDIFEKHDCBBAC.hAAACGBDFCADUFGGZBFEQGAGhACASAGCACGCLDFEhADANEIA.........hAAA......hABA...,2,-24,-17,7
RABbIEgYJHaSVXGOcdMZfCQeNUPLWFKTD,BFDGEHBG.JCBCSBCF.GAEBdAGAMIDGCEACQDGDhAAAUFABLFFGKFCADFHBAEBA.hAAAIBAEHACCaABGXFEHhABA..ZDEEfFAH.hAFAeDCA....hACA...,2,-25,-17,8
gVObNIDWfZTUJQPGXMdSKCRELcBAFaYeH,FAFBeCCHHDCBOEFG..NEHG.DAIHZABAJAABGCAE..MGDEhAAAdGEECDHBRGAELAFHhACABGCDaEEA......hADA.YBED.......hAAA......hACA...,2,-28,-26,2
VZcbAPEQTeRMSBOWDHLGdUXaNIKYFJfCg,QGBCeADGMFFHBDGCDDAEHBFFLAADdEBHUACB..aAGAIHGBhAAAKECFFEHHCCCBZFFAABBC.hACAEAHB..RFABODEBhAFA...XGGC....hBDA......hBHA...,2,-20,-20,0
gRJZMfDUdKWYBEXbFaQAGSITcPVLOeHCN,SGAHTCBC..VAECOFEG.CBDHRDBGMFIF.UEECdAABKCFHhADABDHHEHDGFECDABBB..hAAA.IHGGLAFAhAEAeBAFNDIC.JEABDGHB..WHAA...hAGA......hAHA...,2,-25,-16,9
cLSJTdEWVfNGHeaBgXDPFOYbUMQARZIKC,RGFGZDAGCCFF.LBGD.SABHdCCAEEAB..VEDAGEECHAGHhAAAaAABBDGDDCIH.FADEOFAChADA..bGAAMHAEhAEAAIFE.IHGGKABE.cBDA..hAFA......hAGA...,1,-19,-21,2
QUGTXeWVdAbZEBJPgDHSFfcRaYKIMCONL,ZDAGJCAF.DGFFHFFBFCGF.RDEF..KABCCGBE..LCDBQBGA.UGBHhAAA..XAGAhAAAVBCE.dGHEAIEEBAFGhAEASADEaEHF.IHAE...NEGA.hABA......hACA...,2,-43,-15,28
YWUXACcMRLdVafEOSFITGZNHbDgeJQPKB,CBFDMECGRFAA.LFGDdDDA..aEBGOACH.SDGAhAAATACAGFEDHGCADFBHeHCAhAAAPAEHKCHFBBABYAHDhABA...WDAFAAHE.....hABA......hACA...,2,-29,-11,18
SeRFPQZDTOdLWfKUbgJYNEAXcBMGaVIHC,BHHGMEIBGCBGaDGFHCEFCGFA...RECBQFACTBFG.dAEFLAEEhAAAKBAC.bEEEJDAEhAAA.EGFCAIBG..XABEhABA.ICAFSACBeDDE..hACA......hAIA...,2,-17,-16,1
MHZYfVPGQgCELdaeSKRcNJXOUATDWbFIB,TAFBDACBFGHBBFEA..ZCBC.VECHGDCDCCHE.dCDB.eHDAhAAASDAD.KHFAhAAANAHC.OACAUGACADAHIFFFhABA..MBBDfEHE.hABAgCEBaAFF.hADA...,1,-19,-34,15
DXGOPcgSLVQWBNCJKTAHeIFYafRZMEbdU,HFDFFDCD.aFABREEGMEBHEGGG..UCEADIGEGGDHOADE....hAAAPHAESACDhABAVAAHBFFCCAHHKADCTCGFhAGAADCC...........hAAA......hACA...,1,-20,-30,10
KDLJBdTINaAfVFeMbCYXUGEHScQPZROWg,VDAGMEGF..CGCG.UFFEGABDHBCG.QCGHZEADOAGFKGAADDIFhAAALAFGdFDF.TFDAhAAAIHEH.AIGAeCDAhABAXABC..SCAF.hACA......hADA...,1,-13,-21,8
AScfegBRDbEaWIVQTUJOLGZHKdNPFYCXM,SHBGeGEARDBA.EEBAaFBE...VAACQCGC.UFFChAAALAHBZCBAKGDEPAFDhAAACAHFADFF..cACHhABAfEGHBGBBDAFBIFEA.OHBEhADA.....hADA...,2,-26,-14,12
MGSHeBJNgacPVEYCWZDQOAIbTfFXKdURL,TCBCXGBC.dEBHLBHFGFDBeBCFJFEC..aHFE..PEFGhAAAEEAECGDG.ZAGFOFABhAAAABAB..fADBhABAKDEAUADBSBAFBCAANICF....hABA......hACA...,2,-21,-6,15
KCTZVEdJIHafBYDUQAFSgNbLMWOeGPcRX,FAFBSHBG..NHEFLEBAODCDeGDCGAGCRBBH.KFFECADFZGFGhAAAdABHHCCABBEDDBGDhABAAGDEMIBE..PEFAhACA...........hAAA......hACA...,2,-26,-26,0
ESBVCNDXbILOWRdgfcGPQAKFUeMYJZHaT,FFAAeAEHMFDBZAACHDGF.EGEHVABC.DIEEIGBB.OFDBhABARAEHdEFB..fHAFhAAAcGGD..PAGHhACAKAHDUFGFaDAHBEECNEAB.....hABA......hAEA...,2,-26,-1,25
dDSXYeZcKafPGVUbNLRCEJTHQAFBWIOMg,BFEDOGEAdABHDAGC..XBFDeCCAKFAG..aAEGGAAC.hAAAVDEGNIEF..RDDEJCAGhACATGCC..HFCFhAHAAIBGIHHEMCIHYFBDZAEA...fFHEhAIA..hBAA...,2,-24,-17,7
KUQBDdYNRgcbVGPESeOLaHCfAIWXFZMTJ,XCBCZGCCMFAEKBAEBGHF..dAEGRBFA......gEEHhAAAVEGDEEDE.OFBFhABAaGAHHCECAAFEFADD.JHDEDICGhAAA....NDAE........hABA......hACA...,1,-25,-27,2
fPDVAEcbaZeJBCTYFHWGKMUNRLgOSQdIX,EHBGaHBGZDCFBHFD..CBCD.FCAFGEEHUAEELDDF..gBFDhAAAQGGAdAHGhABAXBGDDBBDAHIHeHEAhACAJAAEHEEEKCEFMDAD.......hAAA......hAHA...,2,-22,-14,8
CGXOEBfYgSTdDANJaKMPRZULVQeHIbFcW,aDCDKGFHMCFHZAEA.LFAFQFED.eHACHBAF.FDGGCHGAGCEFhAAAEHCABACH..gCAFhABAdEDAABHB.NEIE.hACAPAEA.........hADA......hAFA...,1,-17,-25,8
KHfPYOFAbWacSQUZDIGdXJMLTgRVNBEeC,aHBGQGBCZDCF.DGGDdBBB.MDIHLEFG.TECCVBEHBHDAhAAAEAECCDBG.KAFCHBBGhAAA.fHDFhABAOHFGAEEB............hACA.cBFBIFFEhABA.JDAF.,2,-33,-9,24
faHNWCTLQIObSAMdGKDURXZeFPEYcBgJV,MEIBKDAFDGGBUGDEZFCB...FDDBEFBHBGAB..JCHH..aEFEHDEDhAAA.CFHD.QABFhAAA.IAHDhACASBCHdCGDXAECYABE...gGGDhAFAfAGCNDCE.hAGA...,1,-31,-40,9
WEGMZQCVDHYSdPTFbXcgUReBJLAaIfONK,aHBGOGEA.KGBHEFEAZDCG..CCCFHCEGdHFDFCBE..XEADhAAAUAGBBEACAHAF..NBCBMICAhABADAAG...SHGChACATADF......cDGHhADAeECCIEHF.hAFA...,1,-14,-42,28
UCNVBeLRJDQPfGSZFgTIHYdWKAbEacOMX,EAFBOCCHUGAA..VEEHLEDG.DBAAQAGBGCDBSCADhAAAFGCDTFAEHFGBhABAdAACKBEDaAHHMCCFhACACEACBGHD.JDFA.........hADA......hAEA...,1,-13,-19,6
ZfQeRGXCBHdITAbJUPVcMFWNgESODYKLa,JDACVEFH..MIEAFAAF......NADG.SHDC.hACADCCALEAHaAEAQDFGhAAAeCHDXCEBhAEABBAAIGGFAICGbAFA.PBHF.WFBAhABAEGDGKCBH..fHABhACA,2,-33,-29,4
RgaBTXSMVJIbAFGHNdWOcQPeEfDLUKZYC,FGFHGEDHdCAF.OFHFQFCGEBDA.DEBFKDAG.CDDH.RDEC.BHCG.hAAA.SBHHhABAVCFAJAAC.IAGGHFAE.hADA..NEAC.PAFGfBDE...hAEA......hBAA...,2,-30,-14,16
LcVeTMIBNSDOAEUKbfRFCPGaZgXJdWQYH,UFCEKHBGRBFA.CHBG.GAAFZAEF...JGECdCGA.QBCDLDAFeEHDhAAA..TAAChAAAMEDA.BFFF.DGIDhACA.AAHF.bECCFHFA...aEBG....hADA......hAGA...,2,-31,-23,8
MZFEYQgPBdISDTGHefUbWcVJRAaKXNCLO,KFAACHHGLAHBOCFEZABAFEDH....EADEQFGABGHE.SGEFhAAADDCDHGDGeDDGhAAAUCAC...WFAHhABAcDDH..JABBAFCCNADF.MIAE...hAFA.PAGB..hBAA...,1,-22,-27,5
IKGLBeWPYQEHadgSTNFCZXVOJbcfMUDRA,GEAHLEGHBGDDeHBA....PHFAQEDGHAACaBEChAAASAGDFEEA.XACGhAAAOAEGcEGDhABAfDAD.DFADADCGWHCG...EBGGhADAdCDDNDEF.CCHA....hAIA...,1,-16,-19,3
cTAYPNBHRfQbZXgSMVFaGOEKUIJWDCeLd,...PDEHBBAHHBDERAFB.QGAHZCBBSFHFMIEEVEFDhAAAFHDC.GDBHECAHKGFBhAAAIAGFDIAGLABAhACAcFBAADDD..fAHEXABBOFHDhAEA.....hADA...,1,2,-22,24
NaDZHFIMgVWPTXLbSRfBYGCEKQJceOdUA,aHFGHBCF.MABA..VAFCTCGGLFCGSEHHRCBEBDFDGAEBhAAAKBAD.JFCAeBBEhAAAOHAGAIDADDHD.FFABIHFBhAFA.WCBF......hAHA......hAIA...,2,-27,-14,13
LZAOaKDJETYRXVbeIcfgCHNGUdSPFQWMB,OEGHDGGDECAC.REAF.....VAFAIHDD..fCDGhAAAHADCNDEFGABEdDFFFGEBhABAMDDHLECFACGEaFHFKAHBhAAA...YEEHeACCCEFA....hABA.SHAGhADA...,1,-14,-20,6
cVQRODZNXICGeLaMPgfAFBEWUbJTSdHYK,FEHBEEGDUAFC..bBFA..SAADdGEHKHBE.QEDChABARBCBDGID.XDAGhACACEEAeAFALBAHPHEEfCBFhADAAACHBDFBJFAEHFBB.....hAAA......hABA...,2,-26,-4,22
ZRaGdFbEJYSLVMHQgTPUNAIWecXOfBDCK,eGEAXDACBHCCKBHHZDBG.GBDBdHFHFDGBEABD....SGCHhAAAMFFC.HBAGhABAgAGEPEHDAFCAcFAEhAAA..fEEACDFH.aBFBYCAAhACAVFAB...hACA...,1,-14,-22,8
JBXCGNHLFfUcgMYPdOERDeKSTQVabZIAW,JAFBBFFGGDCBLBDB.UCAAMHFCdHGFOAAFRDGD..KGBCSACFhAAA.TEAGhAEA...aGDFhAFAIABHADHCCHBH..FAHFgAFEhAAAPFFCDIFE.....hADA...,1,-9,-49,40
bJWGKQBMTCSZfFDXHRLdcNeaIAgPUVEYO,UCBCVDAG.OCFG..JGAEKGFEBHFD..CAHDZFDHDABARFEEdABF.hAAA.eEFEAIAA.EADF.hAAA...bFACQAFFhAGASFHB...FAEB....hAGA......hAIA...,2,-35,-34,1
EWdgHKAafPSGeFOIUCJbcNYRVXTLQBDMZ,aHBGSHBGGAFAFBCGOCBF..CHED.JGBC....bEFENADG.hAAARCDH....TEAEhAAABBFFDGAD.MFEAhABAWABD...dGGEKGHBfAHGIEAAUGEEhACA.YDFEhAEA..,2,-26,-26,0
bCeWNHFcJYSXgBZUGLAQVDfEMdIOPaTRK,QFCADHCEEHFG.dFFEOAFC..TDAARDADKECC.CHHHeACFhAAAHEGFJACB..XGAGhABABEFB.ZAFG..hACA............hAEA......hAFA...,1,-27,-43,16
OeSBYCDQFUVMWIPbNXJTgHAcRLaZfGKdE,RFDFLDCHZEAAGABEEEGG..OADFBEEBCCGADAAF..FHFAMIEE.hAAA..IHABhABANADD.XAGAJBEE.hABAgEEDABIB.fBBC.hAIAdAFG.SHGEhACA..,2,-40,-10,30
RSOILDGHdVKCWXbUaYZQFPJNAMEegBcfT,eECCBFDG..TEEBSCAFLEAHDBAEGCGAHAACKGGHCAFE.XAFBhAAAaBED.QCGEhABAFGCA.JHBGAHACMFFDhAAAEBDA.gGGAfCEAIDBGhABA.....hADA...,2,-18,-14,4
DWVQbHKICXPRJGfUBTLNMcFZaOSgAdEeY,dEEDeCCHDEAGQEDAKFBA.CABD.RABDGADFBDGHLFAB.hAAA.MCIFFCAEaAHBOHEAhABASBEGAADE.hAGAEGGG..YHAEbGDC.....hAAA......hACA...,2,-34,-22,12
ecNFfHLRKagPBSMTZIGEYdbUAJVDXOQWC,VAADDECDOEGH..CBFA.eFDFFADELGEGRBED..aDBGBHADhAAASAHDMDAFZCDHhACAEEAB.dACGACHGJDFE.hAAA............hABA......hAEA...,2,-36,-36,0
ScJTBGRKIVWfCYXeHdLaPNAQDOMEgUbZF,QEGDOFHF.MBIFUBCFZECBSGAG..JACDBGDHhAAAKBAFIAGGhAAAVDABCDGDeEEBHBEA.dEBGaABAhAEAAFAFgGEGFHFE......hABA......hACA...,1,-17,-25,8
OFKWVSCQEXYLIGbAPHNceJdTgDfaRUBZM,HAADeGEAdCABTFEEDDBD.RDFGBGBAZABA.MEDFKEED....SBHHhAAACAECXAFA.ICEAhAAAADGF..NEDEJAEAhACAgDBF.fGHEaCFB.hADA......hAHA...,1,-10,-38,28
UcKPJaEZLfdDbGFWHXSCMRQYOVAeINBTg,eGEABFDGUBDHKAGE..aFCDEFHF.LAHBDDECGEACFCBFHGDChAAACBCE.REAB.QCAHhAAA.OEEAIEEEhABANDIG...........hABA......hACA...,2,-29,-27,2
SHAaOCbTBLcMDfGVWZXUKFNeQgJPdRIYE,CDGFBHHGLBBHDAADGEBFZFFB..UDDCKGDHFADF..eFBGQCGAhABAJADA.dHAFIBHEhAAA.SGADhABAACBDaFGGOCCC...bAFCMCAF.hACA......hAGA...,1,-29,-30,1
FUAYZOTRXHaVcGBNPfDdCJWebMIKLgSQE,ZFDFTAEGRADGHCGD..aHGGVDADBEHA.....fAHChAAADCCGCHHCeDDGIHADhABAKFFD.gDFFhACAEAACAICAXGACNCECdDADbGCA......hADA.LCCB.hAAA...,2,-21,3,24
CgWUHSPNfcQRXMBaLDVEGOJYZbITAKeFd,KEEDeEGHCEHC.UBADHACG..SEAD..fDCAhAAAQGBAXFGEhABAMAACaBEDDHCCEDCFOFADhACAJAHFZFEBTAGEAIHE.dCGHWEHHcDABBBDC.hADA......hAFA...,2,-24,-6,18
NfELbRPBVWgOCUdSJATcMZKGIHeFDQXYa,MFFFKBBDHFCCFCFC.DIBG..QBAGaDFD.EFAGRAFCBHGH.hAAAVDBEgGGEhABA.CCHBSDDHhACAAFHCTACA.ZAEEIGADXGAGNAAE.fDBFhADA....hAEA...,1,-18,-23,5
PFYHdEMKJTXNgfABCDcLSRVeGUOIaWbZQ,CHHHDEFHLDDGRAFEGBCCUGCE..aEBFZABDFAAFHAFG.dAEGEDGAKGFAhAAA..JFHF..TGAChABAXFDH..hACANFDBAEHCBFAF.SHAE...hAGA......hAIA...,1,-22,-26,4
cRUTINAVLfXFegBEOCDJbWHQMYdSaZGKP,VFDFLDAC.XFAGFDEFBHAH..EAAADCEE..JHFAHEBDhAAAMBHFdAFBZGBGKACHRCED..hABA.UGGCIBCDhAAAACCDeCAHCEBG...........hADA......hAEA...,2,-28,-24,4
HTbIRKVBgDFGZMYAUCdNPEOaQfSeWXcLJ,UGAFdEGDEBFHQGDA..fCCASAAFeECFXDFAhACALEAFHDBCIHEGhAAAVGFADAEHFGHFMBFEhADAADAECACD...........hABA......hADA...,1,-10,-29,19
eVHUZSLIOTgNQKWEFRPdBYDGfAabCJMXc,CFEDMAFH..XCDHVEFC.UBADZGCELDAA..IEBDhAAA.OAEEhABATBGCQGCGhACAEACBFGAB.PDFAdAAEBEECDIGAAHHC.aBGE.JFAFhADA.eFFH...hADA...,1,-7,-26,19
XRQCTVEfgGLSZYedaPHcMNbOFDJAWUKBI,KGFCXGGGCAGF..ECCFGCAG.SFCGeCGFdFCD.aADEHBEDhAAAMEFAOCAB.hAAADBBCAIDGBBAC.QAGGhABAfEHEZEEAYHBAPCCE..hABA.NAIE.....hACA...,2,-31,-7,24
ZSEAWCPecUOFXNTBHYdRfMLaVKDgbJIGQ,CFDGeGEAUBDHFDGD.....TFCGBHAAdEBAMAFAaFFA..DDBChAAA.JEAHQGEEhAAAZBBAAIHA...cCABhABANICBRCEF...fAHCKABC.IHHEhACA.SCHHhADA.,2,-51,-19,32
YHKQCTINLdcVRDEgPSGeMfJUaXBObZFAW,HAADKFFBCGAF.TAEELCFEdEDFRFDD..EBAGSGGGGGBBMIFAhAAAUAGA.BCCGZCAGAIBE.hAAAQDEBcEAEDDADhACAeACEaDHH.OFAA......hABA......hAFA...,1,-5,-13,8
XYZBOGICPKLUSegaFVbHNAdEQRcDMWJTf,EFAAREFHMADC..TBDF..fHBHXBABZEGDOCBHhAAACFDDKEEHSAGAhABA.eCCGaHBGbDACAEHCcGDAhACAJAHH.BFCC.IEEF..hAHA......hBAA...,1,-22,-25,3
FNfWOAKXZaVILCEUGgMbRdYTeDPHBSQJc,ZBCFaCFCLEGBCCHDGBEC...MGCAdEHCeFAADAIHHDBABEAFJACCFCAChAAA....fHBBhAAAAICAVGEA.EABD.hABA............hACA......hADA...,2,-30,-25,5
gOfIeWLGcPaCFJEHAXQZDBYSNbMRTKVUd,QCCBDAAFBFDG.SHGAMAEE.KDFAVFFGUFAG.dFFFOCBBhABA..IABFhAAAeAHFGDDBaAEEFFDHhADA.HAGBACIHXGBD.YADFhACA.NIEF.....hBBA...,1,-12,-29,17
fAcRHPedYLNDEOSXgQFTBKGMWaIVZCbUJ,RGFGHFDFeACGdDEFLBGBEEBH..XBDCQGCBBCBCKCDCMDIBhAAAaFAGZBABCDAD.UDDFhAAAJAGFAIBA...PFGFhABADIEASGAH......hABA......hAEA...,1,-13,-20,7
VZKefEYWIQGJNdFPAMcDbHaBLCUROSTXg,DDGGHDAGBAHAUBFDRECB.SAAF..XAACZEFEKGBFEHGAhACA..IBFAhABA.JADDNADFFGDF.ACCEMAIFhBBAaHGECGEH..ODAB...VEFEhACAfDDBQGAEhADA...,2,-35,-16,19
LJHKEQDAedMafSBcFVbIYNWCgRGPZOXUT,MEGFaAFBBEGEFCAB.....VDCCIECE...NBAF.CGCERABGhAAAGAGEZFFHODABhABATFDFJAHBHEAB.KFHHhAAADFIFAAIHdCCBSHAE.....hABA......hACA...,1,-17,-28,11
YdGTXZgWRAaHMBKNLDVSPObEQCfecFJIU,HGCCKAGEDFACSCDD.OFEGQCBCCFCB.eFDGFHGGJBDChAAAUCGGdDACXABEhAAA.ZAEFgAGDhABAAHHFaGBHMIDCBACC.......hABA......hACA...,1,-19,-26,7
SFEOXKBgdVaJNIAZfGMcQHUbYPWTDReCL,ZEBHMEAEHAFBUAAB..PEGDDBHD.RDDHLAAFSFHBFFAHEFDGhABAKBCD..BFAC.hACAdCFEJHDEABDG..GGBHhADA...........hADA......hAEA...,1,-21,-34,13
gSZKeAWGLBDIdCJTQfbPNRHaVUEXMcOYF,LFEFBAEDdCEFCDBFQCBF...fFCAPAHDRAAEHFEDhAAAaHAC..VBGFhAAAEGBBMEEC..YACEhABASFAFKGHDAGAADDDDIDED.hACA......hADA...,1,-12,-33,21
ZPVAJaCLOUBgWbeSFKMQHDRGNdEfYcXTI,CDGFLFCABFDD...bBEGSGFG.MAABQGAHhAAARBCDGDAANDIAECCB.fGGAhABAXAGEIEEFhABAPAEAAFDGJCAFODHF.UAEEeEEE.hACA......hADA...,2,-27,2,29
edWZSGcHOPbgTEMfCQANFIYLJaKUDBXVR,FHBGLGEAKDAEBAGERDFDdFBG.ZCBGGDEB.HFGH..OACChAAA.PAGDbBFETACGhAAA..MIEAhABAfFADAEEHNCIA.IBAFaCAGDFAH.XFDAhABA....hACA...,2,-27,-18,9
fRCbWgOQLJNUTPHMceZDIXAFSaVEdGKBY,aDABVFEEGDEF.KAHFBBHC.RGBECAAE..bAAE..OEBEhACAJGAEUFFDHCEA.MFIHhADAeDDDDCCHAHDAFBEA..hAAASHAG.EAEC.fBCBhAEA.....hABA...,2,-24,-18,6
AXKEDPVBZYcbILHMQFWdRNJCeOGSTfUag,KFHBEHFGDHBGBCDA.ZEAD....bCCAHAFHMAAFFCAC.RABE.CBBDODFDhABAGDEE..SFCBhAAATAGAUEBEaGEH.hABAAFAH....PEHF.....hADA......hAEA...,2,-27,-21,6
RTBVUWceLEXCZKfHFJPIYGNQgdASMDbOa,DCHHaDCDBGFAUEAA...eBFBEBBFZFECHAAC.FGAC..JAFHIEHGhAAA.GEDEhABAQDCCADHCSAEChADAOHBC...........hAAA......hABA...,2,-48,-16,32
QZCDHONaBMXgUWGITJAbLcPYdSVKfReEF,LGEA..cFCAdGABVBCA.RAFD.FCCGZDEEDAGEHBABaFADBEFDhAAAMIFE...UBEEhABA.GCGE.hAAAIDAGADIHYEAGfABAEFFCCHBG.NICB.hADA...gGGGhAEA.,1,-4,-33,29
BITUPVFMAHZDcLbGXWNOKeEdSRJYgQafC,DDGBLGEAGACGXBADOHFA..EHBASDHB.JBEEhAAAgFAF.hABAfAEBCEAEIGAAhACATCAA.PEDDVDDGAIHA.cACBhAFANAIEKFGA......hAGA...,1,-13,-31,18
cEALKXRHaISOWVgZDCdUTJFbGfBQYPNeM,KAADRABHHDGD..SECDOFAA..VGDADIEGUCDD.JCHHhABAGAEG.BAAGhABAQEFH..hACA.PDAH.MIAGAIAE.aBCAIAHGhADA.gGAEhAEACAHCFGHD.fDDE,2,-34,-18,16
RQAcYNaHbXVTFgBWPCKfOZUMJeDSILGEd,...NDDG.HBCF.VFGDFEHBBGACCFDD.KAEFZFEF.UFAAMFCHJBEGhAAADEGH...SBBAhAAAIABCECGAQDAGhABAAEEC.aEED.......hADA......hAEA...,1,-29,-42,13
VeEfBcLXPgCWRINMGHQDOYaZSFAKUbJTd,UGBCJDAC.dEEFEFGEBBDELFCH..XCAFCHAA.RGDE.NBBF.hAAA.HAFFOAAAaDDF.hABAFAGFAFFD...KDCE.hACA....bFFE.eCFGfCHAhADA.cGEDWFAC.IFADhAEA,2,-38,-24,14
cEFNOQgRSHYIABGCVWULPMXdaeKfbDZTJ,CFDGUFDHLAFCMAIH.dECBKAAE..DCGCZCBG..JFGHEEAD.FADAQBDGhAAA.RBAD.hABASGGG.hACAHCFFIEHEBBCHWHAGPHBA.aDAH.hAGA......hAHA...,1,-26,-33,7
DNUZYbTIgQdEFPMRHAWXKeGaVcSfCLJOB,KGFCGAEG.aAACSBBBLFFGBEGCUDGHZEDF..TDBChABAQBDHEGBBFHFGMDBDhAAAABIB.eHBE.fAFDhABACEDADBDBNDACIGDF....hACA......hADA...,2,-25,-21,4
HaTLSDZGdBeXNWREfPVIQcCJgOFYAbKUM,UGBCaAABLGFCDACGGGEFBBDB..eDFCXAFA.REDC.EDDAhAAA..VCBFQDBAhABACDGF.OBBChAFAAAFEKGCGMEADTAFD.dAHANIAH.fFGBhBAA......hBBA...,1,-14,-21,7
bVEFeIUXJLcPfAKdgCHMTBRZQDSYaGONW,KAFBCFEDHBFAMDGFBAACZFEF.DDDG....SADHaFBA.OFAEhAAANIDH...VCAEhABAeCAF.IGGBhACAJCHH..LHBCPHAAfEHGhADAAGHH.gACAhAFA..,2,-32,-25,7
egEIXDZCMSNVTQfHOPRbKaLGWBUFdAcJY,JGEAeGEA.EAGEDAGCZDCB..MDIB..NEEB.QCAEHBADOAFBhAAARFAA.KABCLEDAhAAABCHA.....hAEA............hAIA......hBAA...,2,-46,-27,19
dPVDYCOfZRXLGBKWIUFbeHTJQAacgESMN,aHBGEHBG..MGECdHEBDGGE..OAEFZDCHRBAAGBGAKEECUACCFAEFHCGHhAAA.JBABAGBC.SAHBhABA...hAAANDDE............hABA......hACA...,2,-40,-18,22
ZAFGRDJeMHPUbgOdSBQCVELTYfNKIaWcX,FGFHREEBDGDFMFCAHABA..UEGFOCGFBCEECCEC.LDBG..hAAAfAEDKBBA.hABAaDCBXAGCAAHF.hAAAeHAEPDAHdADF.SGHDEGDBTCGCNAIEcGAEhABA...hACA...,2,-23,-18,5
RfEKSMGaDNCIOXALPJYBZQFHUeTbgcVdW,LEEGJGEAZFAE.FCAHHDACeBCG..TBFG..gFBEhAAAdADARAAAKEEG.MAFCDIGA.hAAAIGHFAHBEBHED.QGEChABA.bCDAWDHHSBHHhACA..aHBECHBA...hADA...,1,-17,-23,6
XJGDVSUIcgOYZKNRfHCFMQAdeEPTabBLW,dEEDEDCD.aBEDBCFD.LAEAJHDG.DGGCSEABUGCH..hAAA..IBBDhAAAOCCHKBAHREEACDAH.MAFGAGAHeBHHhABAPBHD.TFGCXFAB...hABA.cGBEZACH.fADEhACA,1,-25,-27,2
aJDCAIZYFBHLWOUXQfdcTEbVGMReKPgSN,ZAADBFEDLFBGUFBE.QGFEdDEHEAEFGABCeHCEKDFH.SAGEhAAA.aAEBhADACGHEABGBFDCAOFFG.hBAAfAHE.......hBCA......hBDA...,1,-20,-41,21
aJdTNVKUCgXRZLQbBFSHDIMcefOGEYWPA,aEEDdAAD..TEGHKHACUDGF..XGBEZFCFLCBGBCGBSDEAhABAHADCDCAFMABChAAAeADA.fCDHhADA.ODCBEBGCWFHDAFFBNAIACFDE...QGGBhAEA..hAHA...,2,-22,-15,7
MXUNVTgCcFKDBYeIOAfLJbGHPWQRSZadE,LEEGGECFHCAEQCGDSBGEdABFEHGAMHEC.UAEANAAC.hAEATABF.CHCGKFGAhAAADCCHBBEB.IAHEhAFAAHAGfDEBJGACWDDF.....hABA......hADA...,2,-23,-14,9
XZKAaDQJLMFNVcdGOIgWCRUSPHEBTbfYe,QCBFMBEAFGHD...VBEAGDFGOEDAIDBF.CACG.hAAARAAGPGACBHEGTECFhABA..fGGHhAAAXCGBAFAFDIBCLHAENAICcEFD.WFAChACASDDE..hADA...,1,-8,-30,22
AJbFMDHQVLTcZEBNYaWdfCXKPUgeSIORG,FDCDDAGDQDEALCGFZFEABDHE..aHEEdHBF.CAAB.KAFFUDCGhACAeBAD..ODAHhADAAGACJHAE.HGEG...hAAAcEGANAEC.fAHE.PBCGhAEAIAHD...hAFA...,2,-34,-26,8
YGIDNXcQLaKPHBFMSeCOVWEbgZTdRfUJA,GAFEDACB..XFGCQFBGLEEHaHEAKFFGBFAE.FGCDhAAAMBEDCAHG.VAACEADCZCDChABAdDAB...fCGDhADAAIDCIAHANIEF......cECAhAGA.....hAAA...,2,-26,-23,3
DVIfQOXPZNdWGYEJcATgRbBULKHSeFCMa,REFHUGGGHDCEFDEGCAEC..DGBF..VACG..IHHCQAGBhAAAOAFDZGCEdFCF..hABAGAAEECCDAIEA.bFDDKFAHhACAMAHF..aDGDfFBB.NAIE.hAAA......hACA...,2,-23,-16,7
MJUdTKAXERfbcCIYDGVHgNeWFBLOQPSaZ,RBCF..fCFCCFDGDBAE.HFFBeAECBDACLHBCQACFhAAA.SEEDhABAZEEFMEAHdCGBAIDAXFBAhADAECAA.IHAA.......hAAA......hABA...,2,-35,-14,21
VTHWPfAaFGYgKUECNDdLQIeRSJZbOBcMX,GACBKHBGEBEE.CAACDFFELDBG..eCAGJDFEZGFABGHC.MCFEhACA..XAAChABA..VFDH.TFAHhADAWADCACDHFDFA..YFFC..hACA......hAHA...,1,-28,-39,11
EeHdbDNIPGTRMCJfZQaAFVBOYSUcgXWLK,BCAHSDCDUCEH...XCGDLDHDKGBHEGBBdFFEDGAH..hAAAIBAAGEABTABChABAMADECAHAZBEB.AAACFBDFhACA..OFFBgGDD...hADA......hAEA.eAEA.,2,-20,-18,2
QMTRSKXHFPEAZcWYfOVebUNJCdIDBLgGa,ZAAD....cFCAfEFG.OAGFeECEUBGD.hAAACGGCdHBDBAEFLACBhAAAGDCGMEIHTBAFKGEAhADA.XCEC.......hABA......hAEA...,1,-27,-33,6
aeObPXRTCfdQKAZgYBNVHLIcMESWGUJDF,ZAADBFDGHDCCLAFCMFDD.SGCGGAEDJHFEFAAB..OCGDhAAAXBFDCFFE.QBCEhACAAAHC.NEEF.cFAHhADAEFHH.DCDCeFFH.REAFdDAB...hAEA......hAFA...,2,-22,-3,19
HXceUVEAIZdKCYFJBTLGWSPbfgNaRDMQO,ZDAGdEHACGDGFDGGBFAEGABD...SGCA..PCFChAAAbFGB...fGAEhABAaAAGDICAMEFHOACDhACAHFAEeEAEEAHFAFDEKFFC......hAEA......hAFA...,1,-5,-48,43
VLGDBQTaPEfFebOcAUZNXSHJRWMYCIgdK,ZEFHSGFCRADC.MIFECFHFdHDB.KCAAGECF.DHAGBAHCaFAC.hAAA.EBDCFCGE.OEAGhAAAAICCUCAC.HBFA.hABAJDHFIFDE.......hABA......hACA...,2,-48,-15,33
dbORMWcfEGPQFSKHCJYeNgVDXTIAUaBZL,UGAFBHCHZABHLDDHdAHERBEB.MHEE......fGAEhAAAGBAFQCFFhAAAFDACKEFACEDG.eDAD.NABFDDIBhAGAIHGHAIGAaEBA.OGBGEFFE....hADA......hAEA...,1,-5,-39,34
dCVAeBcSEYZNObXQWfTKgIGPJLFHDUaMR,eAFBSEGDZCBEOFFHQCAF..TAACKGCBGAEHhAAAJHAALEHDDFCAMEIBCFCAADAHhAAABDEE.EEADNEEE.XABGhACA.fHABgEAAFHEAaACFhAEA......hAGA...,2,-22,-7,15
CXeKdSLODEVfIZNHPbTgcJAaYRFQMGBWU,aCFCRDAGMDFCBEHA..CHAC.eDBB..KFEDdEEBLFHBOGCCDBFGhAAAECCE....fACFhAAANADG.HAFEhABAbFAD...TGFCcGGG.ABAH.FFCDWAFEhABA......hACA...,2,-40,-14,26
DBGTUFRVCAOZXYWbLPEcIafNJeKSQMHdg,ZAEGXCBC..bCFCLFGD.EEDCIFHH.aGEAhAAAfADC.hABAJGCASDBFhACAMCABdBGBBHAAUGAEVDCFAFIDOCEC....hAAA......hABA...,1,-23,-26,3
TQFHBOYdRgfWGUDaCbeMNZEXKScJPAIVL,VFDFLDCH.QAFHHCACBGGGdGGARAEH.....fHDDhAAAUGAEDAHFaACEbABGeEAHhACAMEDG.ZCFEXAABhADA..SDAFPCHDAFFE.FEGC.hAGA......hAIA...,2,-21,-4,17
eRLaQUOJHCAbdcWYMgKVDXENBTfZIPGFS,dHBH....cFCAMDDGKHFC.DAHHEFEGBDAEZCADGDEBhAAA.eHAERABAaAAGUADHhABAOFFC...CFACAFEEhAEAWAGB....gECF.hACA..NAIA.IHGHhAEA.SFHB,2,-46,-11,35
ZNfHFcRQTEUJWKXCIbVaABSedgGMDLYPO,eCAFGEAHDCDBLDHF.OAGHfGGHFBAEQEEChAAAUCGAKEEHCBEGVADFBACBSHBEhABAdAGFMHBA..hACA..PFBCNIEF.......hADA......hAFA...,2,-29,-9,20
TLQZVIcFPMEDUXYCSKRNAdaHeOJgWGfbB,dEHAaDBDHFGDeECDOFBH..gADBGAEHBGFBLDFEhAAAVDDG.FGBG.EHEEDADAhAAAYBAHKBBCAHFDJCABWHAAhABA...TEDH.IAGEhACA......hAFA...,2,-25,-8,17
WETfNKdbVUGcOYPRFAgXMCIJDZHQLaSeB,MFFFCAFBDBAE.ZAAFLBEH..eDEAEGDH.TAFGKHGE.VFAEhACAUCGF.GCADOADBhAEA.REGFACEAIAHEhAAA.HEADaFDDSAHBWFFG...hABA......hACA...,1,-9,-27,18
ROaFUdgfASJBVTcYMGXQWLPNIDEebCHZK,BDGFTFDHMEAC.GBDHQBACLFADIBECECAAeHBEhAAACGHFHEADRFEB.OAHHhAAAaABEUGGEfDHAhABA.SDDEcEDB......hACA.WFFB.DAEC.hABAKGCD..,2,-12,0,12
AQIObHgSGUKcJEVRaNdfPMeFCLTDXBYWZ,QDACOGEAHDCBSAAFKAEE.JGDGEDHB.aHBAdCFCMCEAhAAAFCDBLBHBDBCD.hABABCGH.ZFAEAHIBIDAHhACA.........hACA......hADA...,2,-29,-29,0
DScVdRLPQGfgYbOXECBUaAHNZKeMJITWF,HGFGZDAGeEEDJFCF...TGGEDADA..VBEELCGBGEEBfABGhAAA.bADGhACAECCGBHAHABHGMBAEIAHChAEASCAFdFCA.......hAFA......hAGA...,2,-25,-13,12
UKgbZYPTCXVGWFdJQILHfeBRDENAacOSM,OCCHMAEDKBAAZAEA....TCGACEECGEGGdAFA.QGEChAAAHFGHBHAERFABDDGEAICEaGFHSDAFhABAUDAC..hACAgEEC.......hADA......hAFA...,2,-26,-20,6
ZQcSRBIMdTNDAfFJXVgCYabPGLUeKHEWO,JCCHVEFH..CFGC...aGBGGDAALBEEKFDGHADDEHDC.OAHHhAAAQCAH..hAAASGHFIHHGMABEhAFAdHEFDCAHfDEC.FDHF..hAGA......hAHA...,2,-31,-17,14
DMdBAKVSJPXegCWILYRHFcQTNZOEbaGUf,KEHBVDED..JADEeBFC..CECHLHCCRBBGFHGA..QGADhAAAZCCGOBACaFAGUBGDhAAAMEAA.ADAE..SEHBhABAXEEC.IHDE....hACA......hADA...,2,-41,-20,21
EDKFXVfIOJLMUdegWYZGTHRCaQbANSPcB,SHBGBFDGEGHFKBBDFDEH....VCDHfAFB.OBCDhAAALAGHdGCDeFHFhABAgDAGZCAF.TACChAAACHFE...aGEDAGFANAIEDAIBIDGAhACAJFAF.MEAD...hABA...,1,-10,-30,20
IUWRHFDgNEOZVdTJMYSeaLbAGPCBfQXcK,GGDHBBBDQFGCKEGCUBAGHECEDEBCEFCDOAFE..dGEATGAGhAAAMAIF..eADBhAAAaACFAHIDCDFB.....hABAfCEAcGACIEEDFCGE.gAFBhACA...hABA...,1,-18,-21,3
ecJaETAHPOWFNGCBISKXZDMbgLRVUdQYf,HFDFOGEAFABDGACGCCEDBDCDKGBH.ZCFEMCIDLAFG.RCADdAAFhAEAQGGG.fHAHhAAAeEDF.aEEFhABAAHEH.....WAFAIHHCSAEChADADCFE.gCFBhAHA..,1,-17,-21,4
gObVRLNYFedSPUTfMBDEQAKIHXCWcGaJZ,KCFCXFDHCEEG.GDGGZBBE..OFBDRCBGLBFEFAGA.SHAGhAAAUFGF.MAEEhABADAAHQDBHhABAHEBF.....aGED......hACA......hADA...,2,-42,-12,30
cHMVTgQdDJbSIEaZNYWBCeKfPULFAXOGR,XDACOEGHGADGHACB.MFBE..gCGFDGCG.SGGBhAAAaGBHZAFBNBACBBBHhAAAeBFCKFBG.PDEDhABALHFGAFHA.........hACA......hAEA...,1,-20,-24,4
ANBYJXdDafZKCMGELHcQTVUgbRPIFOSWe,BFDGJDAC.dBFHDGFFZCBE.KAAFCACG..GDFCHGBA..QEAFhABAUFCARAGB.FGFC.SEEGhACAAIDE..XGAFhAAAaBCGMFIFEAEC.......hADA......hAEA...,1,-23,-42,19
UWGAJCeOSHNPEbgZXdTIaQcYFBKVLfRDM,JEGHCECD..SCADHCBBEFCAZADAdEGG..aBBEQAAF.hAAAFHEABCGHLBHHhABAfEEGMAEC.GGCBhABAAIHEODDANAFE..gGAD..hACA......hADA...,1,-8,-36,28
XSBdOcDZWfMYAQNVGKIHbULFEPeCaRgJT,VEFHKGAHHEGF.LEBCFFDB.EAFBeBDHCFDD.aCFGRABF..JCFFSABBhAAA.OAHFhADADAIFfBDChAAAMFABAAEE..NBBE.IHCFPFBD....hABA......hADA...,1,-17,-28,11
LcaFTRECBZGdXWQPKIYNfHUMgSebODAVJ,LFFCaAFB.TCBCCBBCZGBEdEBD..XADAQCCHIAGEhAAA..YFGBhAAAfGGC.MEEEhABAeEFCDDAFAGBGJAGDcGCGEACE.BCGB..hACA......hADA...,2,-31,-22,9
HCBTFKeVUXPSacWNIMfdERYAgQJGbZDLO,QDACGECFDBFCOCCGBHGEFDFD.KAAFeDAF.UCGCSHAAhABA.aCFAcGGHhAAA..IEDDhACAMBAGEGAAAAEGgBCB.JEHF.LGBChADACFHCXGDE.hAGANACF.fAHE.,1,-10,-17,7
FTNVEYHSdCLMgXZWeaBQKbOJAPGRUfcID,GEDHUFDH...fDGFDAEDFGGC..TFAGECCDHADBdBADLCFGhAAAMFIHXGCBhAAAeDBEBEHCKBGEJFABAADFRAFEhABANBAESGGF.CCFA.....hABA......hACA...,1,-4,-27,23
DeKVNXCEUgdRIFSfaZMQPBcWTJAbLGHYO,GECFHFDFODAD.............hAAA.eGBENCFECHHAEDCHdADGFFGEhABAaAGCQBCHhAAABFAFWAHBAHHDLCGDDCAHXCEA.RBBB.IGGDhABAfHEFMACEhAHA.cFBD.,2,-32,-16,16
QVKNUHZRPTacGdSDAXJgOCIWfFYeLMEbB,XDACJEEG..OEADCBBC..IFDBFAABLHCE.hAAAMDEGBBHF.VFGFhABAUAEFRCDGaFBBdHGBSCCDhACAAIFE..fCHA.YHAGhACA.EGEF.hADA...,1,-24,-40,16
UCJEWVZTQefKdBIXSFYONGPDbRaLcMHgA,CFEEEDCDZBFA..eBADKDCFBFHDSEEA.OGCGGGABDAFCaCBGhAAALEHB.MBBGhAAAADFGJABEVBFE..hABATGFCfDDBdAGF.IHFC.hABA......hAFA...,2,-39,-6,33
VREYMFbXaTfZNULJHKQdAWceDBGCPOgIS,eGEABGDHCBEAODEH..SFGHEEBAFCHF..aGCFTDFFhAAAZADALABFKHBAdBAAAHABDFGGhAAAGCBE.IFAEhABAYFAF..MIEE.fEDAhACANAEF.JBHF.WAEChADA...,1,-13,-32,19
eXTUEDNcFLdRgMfPAZQWBVObKaCGISYJH,QFDHVDBH.OCGHaBAF.GDAESBGGJADC.HADHhAAATAACDEFB..NIBFFEGChABAdAHC.....MCADhACAPCEDAHGABGAEKCCBYEHB..hAAA......hACA...,1,-18,-20,2
VKPBHGDdWZgCMSbcQJUTaYAeRINOEfXLF,eFBBRAADOAEGEGGBLDAG..VECFBEGCDCADdAAFZCEFMAFGhADA.SFDHhAEAQGEATBDEaCHDAHBF.NBIC.hBBAFBGB.KGHF.........hBDA......hBFA...,1,-20,-24,4
eQIJNLSZWGDKgTcbaPUOAHFXfMdBCRYVE,XCCBMHFGdDHABACGRAFC..EEFFeDABQFCB.JABASEEGhAAA.ZGAChABADDFEKDEEcGGHaAFB.hADAOFADAIBGFECDCBDHIFHENGEF...WAADhAEA.....hAEA...,1,-17,-26,9
FYJBVMPROAIDKTgcUbQeWECXfdZLNGaSH,DGHHTGBCUBAB..eFGDEECE...XCBGZBDCLAEEGAFGhAAASHEGHABEYEEHhABABDDEMCIDOAHFhADAKEGFcEADQFBGCHDA.....hAEA......hAFA...,2,-26,-2,24
BbCENdVeTUAZXLYPFgSDOKMaWcIfRJQGH,XBDGLGEAFFAADFDG.OAED.KEFDaAHH....IADAhAAARDACQGGB.hABABGBECDHGEDCBNIBHeDHHhAAAAIFGZGAE....gAGGSBABMCAGhACAfAFE..hABA...,2,-37,-22,15
UEdabAOgDKMJQILZSYVeNBHRGPCcFfXWT,OFCHDGHHKCCH...QFECLAFASAAFVBDB.eGAGhACANBAAHDFAGEADCBFE.hAAAFEGG..XCBDhABAWFFD....EADBaHGEABCBMBBFIAHHhACABHAD.....hADA...,2,-19,-19,0
XPRTIFSWJacAbDYVEOMCKQHfZNegLBUGd,DACBVDAGMEDG..KGFFHFBEZDGD.eAGHBEEHUFGAdGCH.RADCFDAE.hAAA.SBAFhABA.aBGGAHEFYAADhADA.CDHB.fCCD....hACA......hADA...,1,-20,-41,21
LYgNQbGDKXPOdEAMUcWTVfCZBJFSRaeIH,UFDBTCBCCCHB..BGABSBED.aFCDHBEF.LCAGhAAANIDBGDEFDEBE.XGFHhABAdAGCEFGAAFAH.MACEhAAA..WAECfBAF....hABA......hAIA...,2,-41,-17,24
SUFfcGAITVWaKDRXQEgNZLeHPMJBOYbdC,VEFHaAFB..DEDDQBFA.EABGZFEG.LABHHFBCMDIBhAAABHBAOADGdCEHCEABFHEEhAAAfCCAADHD.hADAIHHDKAHB........hAHA......hAIA...,1,-17,-43,26
GROYZUEfBbWLKgHVMXANTcDQICdPJaSeF,TCBCDAFBCEGB..dDADJEDG..eCCERGFEZFBAUGCABCHF..LAGHhAAAKAFDHABC.MAAFhABAXABGAIBA.QGFEhACA.aDDHSAGE.ODHDhACAfEEB.hAEA...,1,-25,-28,3
SQWBfUdDeVMXOCLFcPTIEZKbHAYNaJRgG,aHBGJFBBGADA..QGEDBFHDdDADDAFEeEDC.MBBDCGDE.hAAALACGFBFA.cCCBhAAA..IEFFhABAEDGGKAHDAGAH..NICD.SGGB.hACA.fACAhAIA...,1,-12,-50,38
UCOecdYbRFAgQPSJGfXaHDKLZBWVEITNM,QCBCJCCHGBEC.aACEKAHF..BBGEEHGA...IFGAhAAAMGAACHEF.eHEA.dDEFRABEAFAAhAAASGCD.hABAfFECDFGG.LDAF..hABA......hACA...,1,-25,-39,14
KbYVINPGJcFRAMCBeUODXaTHQZSgWfELd,BGEBeFCADHGAaHGEHCCAZAEG....SABAfAGALHCEhAAAdGAHKEAC..VEFGhAAAICFG.GCAGhABAFABBAICAMADEOFAH.XDFE.gCCDhACAEGDBNAIE..hAEA...,1,-10,-24,14
YQDNSHGWCLdaPIOEFJcBgZeKUMbfVTXRA,QAFBDGHHHGDACACGLAGBaADH..ODGFJDCC.BBAGZEFGKFAFhAAAbEAE...TBAFhABAAICG..YEEHhAAASBEEdBBEEGHF.FGAFcDAC..hADA......hAEA...,1,-12,-29,17
TBIgVUeXWAGYLSZaFbQcDOEKfMCJPdRNH,LFEFSEHBaCFFQDAA.OHAEKAAGfAGEhAAA.JDCGRADATFCHhAAAIFGHUDEB.eBCBhABAADBGGEAEYHFAFADBDCAHCAHC.NAIABGHAhACAXFFA....hACA...,1,-13,-14,1
UDFgdGfZNSJObYTBVAaELKIQcHeCRMWPX,aEEDEEEDLFHD.QCGCHAAF.CEBF.WGAEUGAAFCHDdBAGhAAAGAFE.NADC.OAFEhABA.TGDEhACAAEEHKGGDIHAGeCCC.MAEFDAEE....hAAA......hACA...,2,-28,-4,24
WXAEPVROGgbZLUMQHFTdefScYaKBNCIJD,ECFCVGFGGCCE.ZABGMDBHHFABdCAFeEGF..SEEFhAAA.aAEHBAGCNAIE.hABAIHDFDDEG.AEFAPCABhAAAODCD.........hACA......hADA...,1,-15,-34,19
LMKaXcEWYPTJDBHRQCVIfAFOeUSgZNdGb,OFFBUAADZECHdAHCLDBDKAFD..aEBEEGHH......hABAPCEBTAFGBEHChAAAHCFCCADH.fGFAhADAACBFFGHB.gEECGGAFXABBcADBJHAAhAHA.DAIF...hAGA...,2,-33,4,37
IdVgRaFQECbLYWGKJASNBTUXZOfeHMDPc,BFEDXCCBZDBDeAADHADGDIGA....IAGDVGDAaHACEDFGhABALFDEGADEAGHHTCFGhAAAOGCC.MFFGhACAdEAGgCAE......hABA......hACA...,2,-26,-10,16
OYPWIbEfKRJQXAaFcNUeZGHVSBgMLCTdD,aAFBFHBGUDACZEDC.HEGBBBCCLDDGdHEFDAEF...OABC.hAAA.PHAAIAHFhAAAECDB.KFDGRDGB..QCAGhABAAIFAeAGDSBAGCBGC.WAEH.hACA......hADA...,2,-29,-14,15
JDfMeAcdVXRPQIEaFCUbOGLSKBZWHYNTg,dCFCXBBHQCBG.EGAEFAGC.UEGCGEDELEAFBHHGZAEGhAAAHEBC.TCEEhAAADGGEMABAABBB..cADBhABA...RGCAIHHHbCGDSFAEhAFA......hAGA...,2,-20,-5,15
UfNYSbKXHOMcTVBLdREFJQPDIZAGaCeWg,aBCGCAFB..eEACUGCA....NDAF.SDCHKHBGHEFHMEEDhAAAVEFBLCEA.hABAEDABQCGEhACADAFCAGBH.WBCEfAAE.XAGAhABA......hACA...,2,-30,-26,4
EbFfQAKTNJcaUOSCHRLgDPWdYZIeXVMBG,TGBCJGEA..aGABUEBD..OEAGHADCLAHBDBCA.hAAAdFEFICHBeFGHMEEAhAAAEGCE.FBAAAHIDKCCE.hABA..SEEACCDD.....hACA......hADA...,1,-13,-45,32
VBDEdPbaZTJCLMQYNHIFRXgOeAWfSKGUc,SHBGGBDBUCACBEFDDAIF.dGED..aFGAZCBD.CBGBLAAFhACAMHBEQGGCHDGDIGCFhADAXFACeBCEhAEAAIDAKDDFEDDC..........hAFA......hAGA...,1,-16,-27,11
LHKePWTBEdfZVSbCXUIcJOQgARNDaMFGY,DHCEFHBGLCCDeECA..TGFGdFFCZBDB.SBFHCDADUACB.hAAA.JFABOCAB.hABAADIFaAACGCGE.HAFDhADAPAHBBCDDEEHB...fGGBhABA.XFCAhACA...,1,-19,-25,6
GUgLWONKIQXERDTAdHeYfZCJScMVFPabB,dDBDHFDFeBBGZCFHCCAG..SGDHMEAHFECH.aHAGBCDC.GAAFhAAALDHD..NDIA.hABAKGFB.XFCBhAAADEDCAHBD.fAGH.JADEcGGC.hABA......hACA...,2,-26,-23,3
MHbVeRaYOINGKLcgBSPfDTZAEdXWFQUCJ,dFAAFGFCCCAHJDAE..HAGB..eBAEaFAD.OADFGECGLFCFhAAABEBESEFEhAAADAGFAGFB.ECDBQEGEhABAUACFMAFF..........hABA......hADA...,2,-35,-20,15
HVKZdUPOENWefXIQGBgDFRMSLcCbJYAaT,HBCFKDAFdGAHOCHD.EFGHeFGH.XBBEQBFB.BEEBhAAADECGRDFFMEABLCFChAAACGBCbFDH.AABA...aACAhABA............hAFA......hAGA...,1,-17,-40,23
VcaLIGREfMOdZQYUgHASFNTXPJKWBDbeC,SAFBTGBC..JFGDKFDBBACGDCCDCDAE..aFDFLDFBhAAA.GABFEAFFMECChAAAdHGFQDDDhABA..gDGEFHBGNAHEPEABWFFF..hABA......hADA.bBBA.,1,-10,-41,31
SMWceJGAaQXHYROKENBUgTfdZFDVCbIPL,aEHBXCCBHFCEOCAFKGEE..BDAHTBGEdDHEFEDE.CGDD.PAEHhAAALAAE.MICGhAEAeHAE.AACBRGEAEFACgDEFhABAZAFGDCGH.ICCFSGAA.hADA......hAFA...,1,-9,-22,13
LMbRVdDHJFQXAWUIZYcEgafBTGSCKPNeO,UCBCZAADEEFG..aAGHBECEGGEFCGBG.KFECeAGF.LDHHhAAAMDAFRBDF.DAIHHFBC.FHAChAAAQCDFAIEG.hABAIEAD.cGGCfACF.hADAPCHFOHCE..hAEA...,1,-11,-30,19
gKMTRbZLWHIfXJACVPdcFeUGNDSOYEBaQ,VDBHdHBHFDFD.GFCBDEFC..OHCEBFAEaDCCKABA...MCHFhAAARFGBLAEDHBDAXABFhAEACAHH..eGBAhAAA.SBADEFHF.gAFFhABA......hADA...,2,-29,-18,11
KOLebXERFfgPTMHDVGZCdYWaJQcBSUANI,KHBGeAABEACGFGHB......PCEGHEBBDAIBGDCCCADHdGFEaGEGhAAAQDEHBEAHAGHBOBAHhABALAGB..hABAXCBBfCCHMFIB.YEEChAEA.cGABNDAAIBFFhACA..,2,-25,-15,10
VGefLKQgESdIBXOYZWbDcRNCJFPAUMHaT,UFCAaAABGBFALABHKBDE.QEGD.EEABIHGEhACA.ODAGZAGHDDDARFAHCFHAhADAFBECABBGHEDB.eHCGhAEASEEBXAGB......hAFA......hBIA...,2,-28,-8,20
bXQUDJZKEcaMOAeLfBRYGCSHdTINgVWFP,eEEGLAFBBDGDGFCBCAGG.dDBE.TABFIAAC..NBHE.hAAAVACC....hACAPHAAbCCC.XADDhABADIGEJHDGEHAEMIFGACGARFCA.....SGGEhAFAWEDE..hAHA...,2,-25,-12,13
gHOQEDbFeLMAVSadKfYBGWNXCUJPRIZTc,VFEEdDABKAGD.BFAEGGAB...XDCDJDFGRFCA.ZBCG..hAAA.TBGDHGFEEBAAhAAADDAHeABAAHAB.aAGGfBEEhABA..NEIECBAD.....hACA......hADA...,1,-7,-43,36
fSIOaLbKTEYXNGcHRPDCgZUBWdJeQMVFA,SHBGaDCDLEHDKACG..EEFB..XCAEGADCRBAFCDFFUGEBhAAABCGC...dFBHeFDFhAAAMFIBAHAGOAFGhABA..TAGF.NDHG....cEDAhABADBIF.....hACA...,2,-25,-20,5
QcTVFZBMDYNdEKWIHARSafCLJgXPUbeGO,RFEESAFBCDGC.LHFAXBBDUCAGGEAGQEEChAAA.VFBHBCEHDAHDdAHAhAAAEADDIADA.hABAAECAaHECfEHA......hACA......hAEA...,2,-36,-20,16
QGHIJTEagfWdLBXUCVMeZNSKPcObFADYR,RFDGGACFHDAE.JGDGTGAF..aBGE..fHDBdCDDBFAECCAEhAAAVDFCZDEE..KHGAOCBAhAAAFHAC.AACGDGIH.hABA............hACA......hADA...,1,-17,-35,18
cGMaJWBeDYKIUfgbdZLCQVAOSFEXTRPHN,OEGHEDABRCGD.HEAFGBAFJACA.BHBG.DEEGKEDD.UAFE..hAAAfAFGdDHACBAFAHEEFCBGhABAXFFG.NDDE.hAAAaDDA...........hABA.eAHB...hAIA...,2,-31,-22,9
FSDeOfJNBLKUATYbXVdWHZCMgGcEaQPIR,TCBCXCBC.dGDCZADG.CBAG.GAAD.aBHFPFFG.FGDChAAADFHB.ODEFJAHFBDFChABAUEADAEDH....hAAAbFAB...........hABA......hADA.WEHBMIEE,1,-25,-28,3
RWJXLBVPUECTeOQDGHdfFNbgYIKZMAacS,aAFBSCFC.RECC.JDDCBCAHUACGCEAF...eHBCDBAAHACBhAAAFAAH....bAGHIHDAhABAZGFA.AHABXGGEhACAVEBA.EEGHTEGC....hABA......hAIA...,1,-23,-30,7
VUDFCHKNdOESWRGIcTgAQMbeJLXaZBfYP,MFFFeEEGLEABZCFGBBHF.....fAFCPACGDBBFHFDAhAAA.KACEOFBBhAAASBADGEGEIBBFhABAgDCAACDGbAGHXGCEaHGE...hAFA......hAIA...,2,-24,-18,6
XdeOPLNABMRJQDSCUEWgGVIacTYfKZbHF,BECDJAAB.QCGDCBEA.ECCBGBFC.aGGDTFGD.hAAAKGBBZCCFFHEEdHBDPBEAhAAALDBD.AEHCDGAFhACAWCADVFEF..IFEB.cABFhADA.....hADA...,1,-20,-27,7
AcJZbdSEDUVgFNaXPeBYfHQLTRCIGOWMK,JFBBZDAGSHAC.UBCFVCEFFGCAaFGC....eAABhABABEBFHEFGTAGFIDFEhACA..WDAChAAAMBIBKACGAAGDdBFD.DGGFNIEF......hADA......hAEA...,2,-42,-15,27
OZACKgGaPSIfULTMYeXVQWbdEcJNFHBDR,KEGDaGAH...SDBDUDDBLADEMCADeHEEQCGB.hAAAdAACJAGBFHCGDEDEOFGBhACAADCECHDDGABF.IFDEhABATBDFYFBA..XGAAhACAWFHB....hAEA...,2,-30,-14,16
bNWdADgaZFPJMHXGKSRQBEYLTfUVcCeOI,DGHHaCFCZEEBFDEH...MDBGHBBD.GADFSAGFRCFEBHFAEGGHLHAAhAAA.TEAChABAUEBFCBAF.IBHGhAAANEIE.ABCH..PDHDXECDKADC.fGEFhACA...hABA...,1,-9,-29,20
GYLXfQRgIZHTJbUBAPWCaVeDcKNSOEdMF,CFDGaDBDDGHF..KEDE..OBEGdFFAMCBGFDED.LGBG.QAEEhAAAIDADHGDChAAATCGDUFAEBAHCADCA.hABAPCABeCGBSCCEEABE...hADA......hAEA...,2,-33,-21,12
MbGNCRUVEcXYJgDWfIPKBZFQTaAdeOHLS,eFFBLFFCMAIDGGEFRBCC.EEAH..XGABJADADBCB.IHEHhAAAKDDC...BDGDhABA.QAFEhACAAHCAdAAESCEEbDBACHHE.cGAB...hADA......hAEA...,1,-20,-30,10
HgXRcWbfEaNAFKZSBOdPeYVCJDTGQLMIU,FEHBKEHBBCGGdGDF..eEAHCFFE.DCCGGCABLAFDMHAG.HAEEhAAA.RFDB.bCAC..aHGGhABAAABA...SAGEhACAPEDC..........hADA......hAEA...,2,-38,-28,10
fdODaGMVbEcHeQXWFIYRSBAPCgKLNUTZJ,CFDGLCCHUBDH.TEGHZBBH..dAGBaCAFGEEF..bFAHEHDEhAAAHADD..QEAHhABA.FCHHICGGhAAA.SGGGAHGFKCAD.JFEH.hACADIGG.MAFA..hABA...,2,-22,-21,1
TdgGSECaeBMZVQOIFRWLcYNJPfDKbXUAH,dDAFSGAHCGDHBACG.MGDGZCCF...QCCEOAFC.FCGERFAHLHFAhAAA..hABANAEHfAAAhAAADGGCKCHF.XDACAICA.......hADA......hAEA...,2,-41,-28,13
bfXSBHgGMceIFWNdTKLVJZYPDURCAaOQE,aGDDQAAD.EGEEXDABBCEAHGAGMBIFeBEEFFCDdAAFTCAChAAALCEHZDDEDAGCRGFCOAEChADA.SGADhAEAcDGDIFAF.KHDA...hAGA......hAHA...,2,-21,1,22
PZbNMJDRLXBAfUHTIGcSCeKdaWQFYEOgV,HEFHTFGHGECC.CADHKFADaBADFEDE.EAEBVBEG.ZCBANGAF.MIFGhAAA..DDDC.LHAGhAAAAIAA.ICHHhABA.SHECdBHAQABEYCBBhACA.PAFA.hABA...,2,-16,-10,6
gSPNfIXROGQHFdCeVZEaMYWbcTKJLDAUB,BHHGSHBG..NBBA.XBGCRGDE.GDDEFFAHdACACAACZBBEhACAMAEC....bDAChADAKDEADIEEAFGH...PGFAhAEAfFCHIAHF.....hAAA......hABA...,2,-52,-10,42
XPOMEdYbcZIHBFQaVLDGUfWgRKSANJTeC,JDACeGFA.CEAA.OBCCdBAH......bFDGIEHGBCGFFAEDhAAAaFAH.LHDEhAAADHAAGDCFUDDA.gCFHhABAKAGEAEHA.TFBAMFFG.EABF.cGGAhADA.....hABA...,1,-15,-32,17
BNPZJFELWMYVAaIUDeSfHTOXgcRGdbQKC,UGBCSEGCHGDEOBAG..gAEHGCFEQCCDhAAABFEAZACHEBAEMCAHACHADGGEhAAAeAHD..TEBFhABA.XGDC......hAEA.dHABKBEBCHFH...hAHA...,1,-9,-23,14
ICRKAFBHYSbNZcMfVLOGdgWeQUaXJTDEP,BHCHHDAGSACDZEFCMAAC.LHFEdDCB.eDGHaAGC.TADHhAAADFCC.EFDDCHGGADGEFBGG.hAEAbGAC...fBAEhABAOAEF.........hAHA......hAIA...,2,-53,8,61
DVZILXFHcMGRfPJeTBOCYSdbEWagAKUNQ,UGBCQAFBDACGZFEBLAAC.XGAHFAFEHCEEGCCChAEARBCF..JAAFeEHHBEBEhABACGEAdBBA.EHCEaHGAACFDKCGGhAGA.NEGE.....IEHC.hAIAMAIF....hAFA...,2,-34,6,40
PbUdTfYMEOXLWNQDcgFSCeAJBRIZKaVHG,JFCARDBHKGDGHADAGDGAUGGG..dEFG..TAACMCAE..OAEAhAAALHAC.NDCF.DDDAhABAFCAHSAHHhACA.CBDBAIHEBEHG.IFAH...hADA......hBAA...,1,-26,-31,5
eZKDEUSGNLdICRPVHYbQJOcXWBagMTAfF,eCCHKGGEUGADGBECLAFACBAB..RAGFHEFBQAABOCHD.hABAXEAHaCEG.MACHhAAAfGDFZGAEDDADNEEAhABAIEBG.YHFA.JEFEBBDBhADAADFDSACHhAEA...,1,9,-33,42
dCDFfaBPbVNJMWAUOEXQZSKRHTYcIgeGL,UGGDEAADZEGDRDEEHABA..TEAF..IBFAeFDGLACAhABADHBCFDCDBDAEPCEChADA.NIAF.MAFA.AFHDXGDFhAAA.KEAD.....gBGHhABACCCBaGAE..hADA...,2,-27,-12,15
ZeOSVENBYLUagQfHMRTbXKWFIcAPJGDCd,GECFDFEAdDFBZAAFSADH.EDGDBDAGUBADQGEGhACAHGCAMDBFREAC...TAGAhAAAKGADFGGAAFIDCHGCeACANAFA.hABAaGCF.....fCCD.hACA......hADA...,1,-8,-26,18
URYMTcCWKZSLGDNedfQgFJHPAIVaXBEbO,VDAGaFFBBCBA..OGEAREGH..TAGBCCHCKGAA..LADBhAAADFABdEBF.QDFChABAFABAHADBAEEHEAGAUCGFMEIHhACA....WFBHSAFD..hAGANAAE.fBBFhBAA...,2,-26,-21,5
RQAITUSZPKLeCVDGEWdBOfMcgFYXNaHJb,TCGCZBCFLCFE.CAGBGGEFdDCCBEFB.MHAAFFBC..XDFAhAAANADFHAAC..JEHBQBADhABAADED.SBEFhACA.eDAFEFFBOBDE.hADA......hAEA...,2,-25,-16,9
PUVCgSYcdORLeXHTZBNDGAfJKQaWEIFbM,KDCDaGFC.EGEEFEEE..MBEHUGAG..CAAC.SEBCdBGGLCAChACAeBBCHFADBAFCDICGAEAH.hAAAJDHBQFCChABA.ICDE.PAHF...hADA......hAEA...,2,-32,-23,9
XWFNQBbAUDHMLeZfIPTGgOdcJYVECKSRa,UFCADIBGHDDFeDBFZBAA....IAHGPGFGGBEFOCGBdADAhAAAJADE.EABE.SHEAhAFARDAHXDGAFDDEBAHDhAAAAHHFMCIB.fFHE...hABA......hACA...,1,-13,-18,5
bVLHFXQaJNKfeBIUGEZPRcYMWdSADCTgO,DEFATGGGOFDH.LADAHABHFDEE.aAFFJAADKBHH..BFFBhAAAIHDCEBGF.RDAHMBAHhAAASCCF.CEAD.hACAbFCA..XFAAfHAF...hAEA......hAFA...,2,-41,-7,34
QWeNLRcHfJVIaDFOEdMbBZSKAXgYTCPUG,XCBCTCBC.UFAFQCGA.eBCGNIAB.LFDEhAAARFFGHABG.fFHAhABAJEDGaDHB.FFBBdBFABDED.hAAAKAGCAIHACBHA..........hABA......hACA...,2,-21,-12,9
GOeMAJbIBgWcfdaTZSPRNFKUXDQLEYCHV,JGEABFDG.....gFGCfAFEdAACZCDBRBFE.KEBDUGAEhACADCHFLACD.hADACBDCGGABMBDBIEABhAEAaAAF..SFFEFGEDXCEC.hAEAYEFE..hAFA...,1,-24,-32,8
VLGNdEPZJYeaURXWDIQAKSgBMFTfOCcHb,KAFBBFEDFBACODHBHDACLFDBdBDCZAFD.eBGHUEAH..XGGGhAAADBADACBG..MHBChAAAfHAF.CADFVBDFhABA...NCIEEFAGYFFB..hABAaFFG.....hACA...,1,5,-49,54
LgMQVDPRAaNEeTFfUOXZIbGBYCHJSKdWc,aAFBeCCH.FBFHODCEZFGDGBAGBBACHAGBKEED.dFDHLBHDhAAA.QACDhABADGGAAHEFECACTEAFUGAC.IHFGhAAACGEA.........hACA......hAEA...,2,-27,-13,14
WKOJFfUcZgQGYVXEHeabPANdDLISCTMRB,dHFHDEFHLCCCSFCHMGAEBEFE.OBFEFAAFUGEB.ZBFFQACGhAAA.GBAEhABA.XDDBhAEAECADaAFAADEHCAFA..WFFGKCHBcDBD..hACAYHAA..hAFA...,2,-28,-28,0
QVdaFYXbKgOMJGCBHSIAUEPZTWLRNfcDe,EGFCTFDHLAEA.RDAC...fCBHeBBGQEEBhAAAaHEEXAABKBHBOGAAhABAGDDBCCFHBDHGSAHBhADAAADF.PEAE.......hACA......hAFA...,2,-20,-12,8
KIUNbRdHSGJMXfegOAQDTWYFCaZEVcLPB,DFEETCBCFDCCZEGB..EAFCLAECBDGDUFFARBAA.HEAAGBEFhAAAXGCEeFBBAAIBQAAFhABA.CEECaBHHhADAcFDC..KADB.......hABA......hACA...,2,-29,-6,23
FMdBLXKegSVOTJPQbaAWNGRYfCIcDUEHZ,GAFERAADCFEH.DIACEEADFEBG.BCAFLCHH.KFCHeEFA.SBDBhAAAOACEJCECQFDDhABAAAGB.NIDF.hACAIHBF.HGFAMEAFdDCFXGGAhADA.....hAAA...,1,-16,-29,13
XeGCabSgMBUNLWdFYRAcQVZJOHKIEDPTf,VEFHOFFC.KBCBECBE..DCFF..TGCHeHBEGBAG.hAAACEHF.aEBB.SAEGhABAMAGBBABBLAGBhACAFECEAAHG....ZGEA......hAAA......hADA...,1,-26,-32,6
CefWdIXLEaGSgMOAHZcbYPURNDJQBTVKF,HGFGZAAD...bDDHUCDH.DAEDJBGBBFAGKGBB.CAHG...fAFAhAAAdHEBLDHBEEADGACChABA.SBBFhACAMDGD..AHHDPFBA...hAEA......hAFA...,1,-17,-47,30
XgbGVLBQcCfFMWPYTDEdOIZHAReaSJNKU,RDEDeEGH..aEDHJBHFUABF..XDEHGBEDBHFGQDBFhAAACHHA.FFBHMAAFPAFDhABADDIFdHBBZBBAAHIHKGGE.hACA....gEAH.LAFChACAfGEG.WHAGhADA..,2,-25,-16,9
IYgGCTZQASHDRKFBeLVEUPJNcdOWbMfXa,HFFAREEEKDCBBHAEVACFUCFD..JBCGdEAA.OHBG.MDEFhAAAXFAE..IAHAhABAGAFECDAA.QAAFhABAAHHFDIDAeBBDLHEG.NAIA..hACA......hAEA...,1,-16,-29,13
RZbGdJIKQMacFLPXWOAHgUTNeSCBEVfYD,UFDHTDACeBAD.BCDDVEDG..DBGGZCFCdAECKHAG..MIDAhAAAaGAALHFE.hABAPBBGOEFGACAEHAFEhAAAgGGGCEHD.fHAH.bBBBhACA.....ICGGhADA,2,-26,-19,7
bKTedaICNWZAgUMQBSEFPHYVDRcLJOfXG,MFFFQGAFBCGDFDCHHDFD.DBAHRADCLBADJCCH..fBEGhAAA.XEDHhABAKAHBTGGBdDHECBGANEEHADDGhAAASEAB..PHAG..hABA......hACA...,2,-36,-16,20
NDZOcRVYafQXHIUCWGgeJKAbPdSFMTBEL,dHBHMIAGBCHHLDCBDFIBZCCARAAB....aCEBQAAFHBFFIGFHhAAAUGFHGAFGhABA.eDBBJADEACHESADChAHATEGD.NEEG........hACA.cDAC..hADA...,1,-18,-23,5
SbXFNEaYRMeOdgDBWUHGTcAJQZKCIVLPf,QAEGCCAHLCDH.SABHFDHH.EEDFaHCA.RGFG.eDHDdBGBBFBDhAAA..HGFEhAAATABFAIDEKBHH.VDADhABA.fGDHNEAA.MADDDDGF.UGAFhAGA......hAHA...,1,0,-33,33
CaWMFYBDSJGOPfbXAQZIeVLdEHUTcNgKR,ZEFHeFBBLAEAHBAAUDDH..NFADRACDaHDA.MAFEBBAE.DDGEJCFAhAAAGGAF..fGFBhABAADEB.QEGEhACAIFHAECAB......hAAA......hABA...,2,-33,-12,21
YdGCZEgVcASDPLWaQJFXKMROfHBIbUTeN,SHFGDEFHLCCCQCBBFFAC.MCHFOFHHBGGH.UAAFhABA.eFDBYHDGhAAAdDEAZGAAEHBA...hADA.gAFHAACG.aEACKAEE.fDGAhABA.IDDEhAHATADC,1,-13,-49,36
XEUeTPVOSRIaJNCYZGBMDfAbFLKdHQgcW,LCCHKEHBQABE..gGDG.XABGhAAAUCFEeEAETGABOFFDhAAAIEFANGAF.ZEGBMIAChABAAADCFBFHdDEC..cCAHEAHBSADAhAEA.....hACA...,2,-22,-14,8
TMJXbRfKVYWSGBLHDAIEgNCPOdQaFecZU,EHBGCFDGdCABFDDBZCEG..MFFG..XGAHRBDGKBGC...VEFHhAAASDABBAHEDFCDIACBhAAA..NBDB.hABAPHDGOEAB.aHECcBAA.UGGEhABA......hAEA...,1,-29,-30,1
EJULWZSCfYMaNceFIbdHGQDVBKgOAPXRT,REFHTGGDECBA..UFBALGCAZADA.CFDDMCFB..NAAAFFHDdBGDGDAHhAAA.DACGBEDEhABAOFAHAHEHJAHFfCCBhABA.aBBGeCEB.....hAFA......hAGA...,2,-31,-19,12
TgYQWRVEXPSONBKHMCcUdZFJDLAafGebI,GEAHeGEA..TCAEQAAB.VFFBPFBD.SDFChAAANBEBKCDH.CAGBdEGHhABAJHCCADGAaACB..fEGBhABAIAECWBFAEDAABADCMDEB...hAFA......hAGA...,2,-22,-15,7
CVMOUXcDJSdWLYNZBIFTbaRPHeGAgQEfK,EGFCCFED..MHFGUABADBHFdDFA.LEBFZAFDFCBF...aDDBHACEhAAAAHIH.QEAChABAKHDGXADE..cDEChACASGAD.WDHBNIAFBEHA...hAAA......hAEA...,2,-35,-23,12
SLUWKFOVabRdfCJMANgYDeHXEZPcTQGIB,...NDDG.gAFB.DIEGHCFEZBCH.PAAFQFGBhAAAIHHDBDHHLADEhAAAKGDDFFBFaCECbEEAfHAFhACACFEEAHFG..YBBFEEBB...hAHA......hAIA...,2,-21,-20,1
GZgdNDHaLcWAPUYSKTFJMQCVIbEXBeOfR,UCBCSAFBKEGH.FBCCMGDE..QFDGCAHG.IDADhAAAEBFGeHDE.ODFGhAAARDECGEBAZADBdBAGDGIBaHFEhABA.LAHFAGAD......hACA......hADA...,2,-32,-17,15
UgAMOdKBJQISVWNDebfRXTFCaZcLEPYGH,dFAGJCAF.QAED..IGHHVAACDEDHeDDD.RGDAFDGChAAAaDAAZFFCLCFC.hAAAEAFAYHEAHABEAEEG.hABAMEFGBHBE.SFAG...hADA......hAEA...,2,-26,-13,13
BFWDNPeTECKdIUScOVLYQaXgZGAHbMfJR,HFACMCCARAGFBDHC.FDEBDCBBeBAB.CDCB.dFGG.SGEFhAAAOGDELAECaABA.XDFDhAAAGEBHAIGAfBBBhABANEEB.EGGEIGAG...hACA......hADA...,1,-21,-29,8
GaJOKcBbfSVPeYDgQZTNLEXWCHIFMAURd,dDAFaCCG..KBFBBFHB.SBECeGFCDCHHZFBELFDE.XGCEhAAACACDFEBEAIBC.UGAGhABA..JAAFODEAhACA.fHGB..YAEEhABAgBBENDACEEEEWBFAMIDAhADA...,1,-18,-37,19
WefQVLEdHKZJTUOGACaNMRPDgYSXBFcbI,aEGDMECG.DBGA..SDDAFHGA..ICBEeFBBQADEhAAAEFDF.KDAEZEAHhAAAUGDGACFGCADB.PAFChABAXCGABBBH.WFHHLFFF...hACA......hADA...,1,-26,-34,8
VgGdBRLKQJWMUbAIXNfaDeTZSPcYOCHFE,XCBCaHBG.DFGBZFEB.SEBH..cDCEOADGhAAACCHFHADCFDEGECBHVGAChAAAdBBFREGFKGDCQAGEhABA..JFHFWCADMCAHAGEH.IABChADA.NIDF.....hAEA...,2,-21,-8,13
YMODdXLBZfIGTSFUVJERPQcAWCbaHNKge,CFDGaCFCKCCB..eFFE.OEDBdFADBBHH.ZFEBIBDEGADBFGHHhAAAVCAG..ECABPAEGhAAA..ABCD.WHEAhABA..HCECNEED.YHAEMAIFDGCF.hABA......hACA...,2,-31,-11,20
ZQFESCIeLTbAKOMgadYfBNHXDJVGUPWRc,MEGFaAFB.dGCHBEGEHADADEABGDAH.UAAFRGFAZGBA.EAAGIFHAhABALCAA.AAHFKFEGhACAgBGH.NIEF.hADA...JFAFPEBG...cCGFhADA.....hAFA...,1,-13,-31,18
cfKeGRdgWQHJCObBaESVDYTPMIAFZXULN,XCCBUDACLHBE....cFFBfBGB.eCEFhAAAdHBFQBGEhAAACHGG.BEAESFFChABADBAFYCEBMBCEACCGFGHBKGGC....hACA......hADA...,1,-26,-33,7
VbPfaeXRCNZcKJYOWMISBLQFHDEAUTgdG,UCGCdGFCGECG..VAAA..PBBAaDAH.eEHBCDFFZEBFKBFEhAAA.ODDAMFHH.BFABhABA.FHAADGBHAHGA.TBDChAAA..fDABNEEA...hADA......hAEA...,2,-36,-22,14
XBgEJQIaHGAVWbceMFLOURDZfTKSPNCdY,VAAD..bAADeGEAFGFGUFCFZDAC.KFABSGAD.CGCH.hAAAXDFABCDDECFHIBEFhAAAHCGBAAFCMBFEhACAOAFGDGIH..fDDF.NBIA..hADAdACE.....hAEA...,1,-18,-21,3
XUNBYdVSWHZLQcaRGTEPIKDMfOFegbAJC,CFFEXCGCUCBE.BFDBdHAF....SDGBHBCFLHCChAAA.QFAGhABAaAEBTFCGIAEG.hAAAKFFBDBACfBBAeBFEAIFCNCAG.....hABA......hACA...,2,-40,-18,22
OBcIZXJFReLfCTQWANYSdKbMDgUVHGEaP,SHBGdAFBMIAGUEGFGDEH..aBCBPCAC..BDAEhAAAIAHFJEAH.FFBELHEAhABATGGGAFHCKCFEgACDhAAAEEDE.cAEC...RFDFCBAChABA......hAFA...,1,-13,-34,21
aIbZeEgXJRdHDSPFTBAYLOGCWUfcQKMVN,LEEGCDHBUCDB.QCGDKEBA.MBAAaDAB.ZFCF..EEGHXBDAhAAA.dCAHHGAEhAAAPFAFBGEAAAEFOFHDhABAfBBE.NABF..eBEE...hACA......hADA...,1,-16,-33,17
VNYJBdQWXILDFAabSfHUPGMgZKRECecOT,aAFBSHBGHCAEGECCMEBC.ZAAE.EAHHCAFBOEFG..NEHGBEBAhAAAdGCFQABAhAAA.IAHHhABADHACACIHfFFEPCFGKGHB.cFGB..hAEA......hBAA...,1,-17,-25,8
feEKgANWUSGHLdDPQZJaFRMOIYcCVTBXb,UCBCSGFHHECGLHFEDECHZBGB.aGAGFAFH.RABH.MAEC.OHBAhAAAIEAD.CEDDBDDBhAAAXBDF.bBFEhABAeFHHKCADAEID..NHAFdBAC.....hACA......hADA...,1,-12,-26,14
EDZCdPMbTfKALXFHGIBJaUOReVQNgcSYW,XAADFGFHHCBFBCAGUEBE.RBGH...QDFA..cAEFhAAASGGA.hABAEAGACHHGMBBGbADFfHEDhAAAKEEAAHAA.LBFAJFDF....hACA......hAGA.aFDA.,1,-19,-31,12
VTIELXZACbKFOfJGMDQcHRWeBSYadNgUP,KEGDOCCHGCCHDAIHHACDREAFBACG..aGECdAAE.UAFF..TFGDhAAAEHDA.ZAFHADHGFGCBhADAJBEBMCAD...hAEA..WABF.SHBC.NIEF.hAEA......hAHA...,2,-35,-22,13
OZdMHYaNTfegUcFVJSbKPLGIDEXARCQWB,CADCBHHGdECGHGFEaDGF....TFABeBEAUBADFBED.SDDBhAAAKEFDLBADDAFEECHBhABAAGGAQCBAOFBHMDFFhACAfGCH.cAFF...hAIA......hBBA...,1,-17,-26,9
BPZdaeGLKbQUgAVYJWXISTFCRcMfONDHE,VFDFJGEA....XDFBTCFACBHARAAF....MAIFOBCChAAADGCDBDCBdACBaGGDGADGhAAAKFAF...QAFAhACAABBDIHBEcDACfDDC.NDIE.hABAEEHB.eFAB..hADA...,1,-21,-24,3
ITVJZUcFSEDabBRNGMCAgXKHdWYOQfeLP,KGFCHDAGdDDFOCHD.eHFEIHDG..VEDFZAGBUADHhAAASHAAEECD..aGAChABABBCA.NADHMBFFhAAACCBEACAD.XBGB.YABDfEFFhACA.LHFA.hAIA...,2,-25,-17,8
EVKHafAFgYPLRedDNUSTIJXZMCGQWBbcO,FHBG..gDACLABCRDFDDBHBUDBBSDDC.TFCDhAAAXEDD.CHGH.QABAhABABHEG.bFEFhAEAOAHDKGHBfGAAAAGF.YCHBhAFAdFADNAAEIBCC.hAGA.MIBE.,2,-29,2,31
WbKHBVMadNJRSATXGPYcIOeUZgCQEDFfL,XABHGAFE..PDBA..cAFAeBCCZFDA.QFAGhAAAFEBDLGFGbEFABDHChABAaDGGdDEC.JHAESCAFhACAAGGAIEHEOHBECDBCDAED.KHGAMBADhAAA......hABA...,2,-24,4,28
CSZacdfIUQKJDRXAONbeMHPTBgVWYGLFE,OGEAeGEAHEDGBAGCVAAFGBDG.FDAGSGAHZFAC.dCHEhAAAIHEAUBEGKDBBDABGhAAAAAFCMADF..TDFDhAEA...WBFGEGCFCAHH....hACA......hAEA...,2,-31,-10,21
BHcSKCaOPUVgIQYZJMFXDdRLebfNTWEGA,HDBHSAFBKGGDCBDE.OABCUFDE...VFFBQBBH.hAAA.JFBCFAGHDDEGLFAFhAAAfHAF.NEAF.hABAECHFBHDGaEEA.IAHHMFIB....hADA......hAEA...,1,-17,-36,19
dXacVYDNJeAfEOTLZUgBCWIGPRKFHMSQb,OCCHLADGUBFGBEAG.CBHEGEDHKFCBFDAD.HCAE..QGFEhAAAXFAEaGHB.hABA...cEEDhACADDGAJHCEAHCBEBCE..gABDIEHH.MCEEhAAASAHH.hAEAdGAE.NADF,2,-31,-21,10
gHJNLGdSBXKFAIaDMZQYUOeWfcTERPVbC,aHFGDIBGMBFHZCCC..QECCOGAG.eAHB..fGFBhAAATADGRAAF.VBCHCFAAHAFBhAAAJAHBLBABhABASGECBHEC.KEGEAHDF.......hACA......hADA...,1,-10,-23,13
CfNcAQHEJdbDVBagKXIOMLPTZWYeGRSUF,EDAFdDCDDEIFBCGEKABE..OFDALBDEZEGB..eHBASFCHhAAAFACB.CGGA...fGADhAAAAAIFQEFFhAEAbCDC.aHCE..IAHFPFAB..YCFGhAFA....hAGA...,1,-26,-37,11
TPALHeJbCBSDdMKIVaFGgfUOXWZQRcENY,eFFCJAFBBHEADGIFKDFD....VECBFCGCGBAD.UFBDhAAAXGFBZAFA.RCADEAHFhAAA..NEAE...PACDhABAADDHLHEA.CADD.MFFA.IHHEhACA.aHAC.fFAEhAEA,2,-30,-25,5
bScaCEfQBKGJMRFUOPgeDdLXYAHTNWZVI,TFDHZAAD..bDCCaEBG....CBEEEGHFQCGD.BBBAhAAAKFDDMIDAUADEOHBEhABAeEABDEHFXFFBhACAAFFDHAGB.WDBE.SFBH.fAGChAGARACB.PFHDhAIA.,2,-24,-17,7
TCEDdXKGfbYORgLBJSZWNAcPVeHFMUaIQ,VAADeDCHMCEG.UGFEQBGC.EDFDdGDAGEBH.hAAA.fCAGhABAODAB.LFAHSHGAhAAAWCHHcGCEFABEIAGADEIDKCDB...hACA......hADA...,1,-17,-21,4
AJYaEQfLMVPIXOcgWbCSRBZGHdUTeKFDN,aDCDQGBCLEHDMAAD..VGBAIDCAOAFD...hABA.gFEFhACACFADSCCFZAGFdGGEUGEGKBDAhADANABCAEEHEBBC.XCFDWAHFBADE...hAEA......hAFA...,2,-19,-13,6
LTXFEQSbKeOYGPfUZdACBMRJcIHgaDVNW,MFEFRFDF..JACGHDDGDECB.VFGBLDDEFFCB..ECAGQBAHhAAAKADD.eCHH.hAAAOBFAYBFAfHGBhABAdFAAADDGCDHBBABCIGACNAEF....hACA......hAGA...,1,-9,-30,21
fRGWdgKADLeSbaFVIMCOJXUcBPYTHZENQ,DIBGSAABFBFH.MDGBCGHB..ODBGJDAF..UBDBBCHE.hACA.TEDDZEFFEECHQGABhADARAAE.dHEHhAEAAACE.LFHDeGAG.......hAAA......hAEA.aHEC.,2,-43,-14,29
SdBKMCZXEbYDfIAQLGNUTaRJWPgFVOecH,QDACGECFUBECaBCBRFGF....JDABPAHF..VABBhAAAODDG.eHEESBHFhABAKDGBMACACGAHEGCDhADAYGFC.IBADAEHC.TFBDhAAA......hABA...,1,-20,-24,4
FYSBQgNMGWJEcHTUeXOACLKVdPIRZfbaD,KDABVDAGdBBD.RGFE.ZFDH...aHGEDEFBFAAFBDHA..QAFGhACAMIAA.JCGDECGFHACChADAUFABOHAA.hAAAAFFHCGGGICEF..fDDBhAHASADE.....hAIA.NBIE..,2,-44,-10,34
dMbceETBGARQWFSHONDYPXIfLZKVgaUJC,QFDHFAFBHCGFOFEEDFFC...XECFfCFD.KAEAhAAAaBDHUCAAdHBBbDAFEABABHBBhABA.AIHA.SAAGhABANDIG.IAHG....hACA......hADA...,2,-31,-24,7
KWcAXQgIRYDUMbTeSEJVPNfCZdBFOGLHa,XCGCQCBCRBAC.UGDF..MDEFeAGBSGHFEADG.hAAAJFABPEDG.CFACBBAFhABAGADBaHGE.KEGAhACAAHEAIECDDCIH.......hAFA......hAHA...,2,-29,-20,9
XYCEgdLDTFRNfHKVIBOGWZaPbeQMSUJcA,CHHGEAFBLFEBDIFG.FAGFRBCGHEBB.KDHFVCBABBAH...OEFHhAAAZCFFaFAC.eACChAAAMDAD.SAHFhABA...........hABA......hACA...,2,-38,-30,8
eREFNGCBfJcbHIKDYQPgXaOWdSATLZMUV,LADGZFEEUADDRBFHECGF.FDDFGBBG.BDHDJGFCHGCG.KAABhAAADEAHQEAAhACA..XGAAhAAA.OEDB.SABFMCIHNCCBCAHC.fGHAhAEA..hAGA...,1,-15,-38,23
VEKXJWQbFGRPZMdUDOaSBAgCeIHNYcfLT,CAFBeFBBHFBD....NAAB.fEDFLEGFEBCGJFGH..QADHhAAAFGDAGAEFPABBhACAMBBDDDDD..SDHFhADAAHAE.gGDC.IBHDhAHA...hAFA...,1,-11,-30,19
cTFQICJBPgZaOLVAWGdXUDfeNbRYESHKM,dGAHUGCEDDFFeDEBRGFE...SFBDMAIFFGDG.CBBG.BEDCZADCOEAAhAAALCAE.AAEG.XGGEhABA.bDFBEAFAhAAA.KCFC.QDAEIAHC...PABChABAaCDG....hBAA...,2,-30,-15,15
MPcQVHLSDWYbKeGAUEXZCgFOfdIJTBaNR,UFCAZBCFFGHBOCAFdFCE....TBAGaAFDRABA...MFGHQGFHhAAALBFGDFGG.hAAA....bDEBeEADhABAEBHF.CEHGIGEGBDCFNEAA.....hABA......hACA...,2,-26,-24,2
DEZFQeXVSPGKIWYOgHTCdJfRNcAMUbLBa,UFDBLAFBDIBGZDAHeDBC...SGHBGBCBKGGA..YFCEhAAAHCFCCAGFdAACJBCARGEEhABAAEID..BAHAFAHD..hACA............hADA......hAEA...,2,-34,-22,12
YFMIAZNgUBLeQCKJHPfWcXOVRDaGdESTb,ZAADUCBCBHBFQBDCKEAGHDFD....fGDCXFBAOHFEhAAADCIFaAFEdGAGEAGD.hADASGFG.hAEATCFCFDDGMAIFAEECNFAH....eFFECCCCWACAhAHA.....hAAA...,1,-18,-21,3
YgDQXZCVdGBWLfFANHKcbMTURPeISJaOE,HDAGKHBGMAGBUDFC.eACC..JAAAEGBADGGEZEDB.dHGBBDFDLAAFhACAAIHE...bBFAhAGAPAHH..SBCAhAHAaCDG..OEAH.YEBAhADA....hAEA...,1,-1,-57,56
CBWTeGPFUNRVJOabSQIAELcHKDMfgXZYd,LCCHHDAGKDFDDAAFMGEE....fAGGZCEGCHBFBAEAeCHHhABAFDACUAGFRFAD..VGFChACAOEFA.SAAEhADAAHAHcADAXBBE.dGDA..hAFA......hAHA...,2,-35,-13,22
JZfCUWPHLQOAagbSTcDIFEKRGMedNXVYB,aHBGSHBG.DHEGFBBH.KCGFGACDMIFG.eEDCdAEF.XBAChAAABGFDZFDBUDGCHDCAhAAAOGAAACIB.gDAFhABA.cGGAIACC.EBEF.hACANBAE......hADA...,2,-27,-19,8
aNUDYAbJFgLSQOKHePdTXVIfRBWGEZCcM,FDCDSDCDOFHBHBDHdACA...TABCIGBE.BHHGhAAAGGCFZEFDCHCAaAHFDGAHAHBDJBGFhAAALAFHKEAF.XEDFhABA.fBEA.EEHHMADAhABANBBE.....hAEA...,1,-12,-30,18
YMHdXIcQBgPfEWKaOARGCLTFNSeJZVUbD,RCBFLCBBFGAA.SBDDeAAFZFEAUAFFDGDBHDFC.dAGF.XGFChAAAIHEDBCHEhABA....gDFGhAAAEFFGKBEBAHIBCHBGNCIA........hACA......hADA...,2,-32,-22,10
BQAIWPXRLgdEVDGMcaHCOTNSFeKUbfJZY,..IFDGPDACLBAAdCFE.EFBCDGFGGEFGMDCEaAFEOBFHhAAA..SHDAhAAAKDHHfHBHJBAD.hABA.BHHEAFAB.WEAHREDF......hACA......hADA...,2,-43,-10,33
gXDEfLbIZYQeORVNTWScAMaCJBGFdPHUK,CBGEGACBFGAD.HCABKABE.XCFF.EGHDLGCCZGAG.QDCChAAAOAABNFEBSFAAhABAMAEBBHDCdGGDhAFAPDCADCID..fEFH...hACA......hADA...,2,-38,-6,32
VdNMBcZDYeWSJTXIECFUKGfgQOHaPALRb,LFBBRGFGdGBHBBCDZBCE.DGFFeFEF..JEHF..IDBChAAACBGBFBAH.GBFG.QADEhABAaEAHAEBE.NAIE.hACAMAAE.....WDDASDDBhADAXFDB...KGGDhAEA...,2,-45,-16,29
QVbCUGacRMHdEZXgFYSBWONfPJTeDAKIL,LCCHVEFH.CAEAUGBGaCAH..RFCDHCBGEGFA.ZFAFFABEBEEC.hAAAOFHD..NAHCJBFBhABAeAHH.KABB.IAGFhAAAbEEC.MIEE......hABA......hADA...,2,-34,-11,23
NaFRXDfcWAOGgPLIdZHUBMEKbYSTJQCVe,GECFLGEAZBBEBEDDKEAF.SCFHQCEACHCE.eAAE.aEHDhADARBBEDEIF..fGBEhAEAAAFEOAGF.IHFEhAFAdEAEMAAF.EFFAYAHF...hABA......hACA...,1,-7,-35,28
WfdaUXENbOLSIARgeKJBFHMcVDYQPGZCT,RFDFKDCDFCEAHDDB.MDGFDCCF..QFAHZFGBCAHA...TACFhAAAfAAC.dCBFhAAAaGGCUGBEEAFCNBAG..hABA.OEEGSAEEACIH.eBEGBFHB.hACA......hADA...,1,-20,-21,1
GNTIALeEKUVBQaOfdFPRCWbHXcYMDZSJg,EAABVBCFBDED..OHFEFAFBRFDA...CBHAHFCE..XDFBhABAMEEADFAGJCBB..hACANIAH.AHADeADHKGAGaAAFdHGBhADA....PFFGWCHB...YAEEhACA....hADA...,2,-30,-29,1
gDEJLcQXbPMOeFNRVTGdYAZaSKUBCIfWH,ZFEEKDABBAFGCBHC....IDCEHFFFDEFBLEABXGCAMADEhAAAOABF.FDGENBAF.hABARDCB..GADEAFFAaCHD.hACA.SGHHfAHC.gGADhAAAJFCBbBCA.....hAHA...,2,-29,-11,18
BLTedfGEaWPHRNgQDcOZJFXASCMYKUIVb,MAEEUGBC...VCGFBGEH.TABHdECAEGFB..aEDEHCADRBEC.hAAAQABADAIHZEGB.hABAXDDBAEDGCGAD.IHHGhAAA.........hADA.eAECWHBA..hABA...,1,-22,-31,9
SRIOfLGFbJTdgDYQXPMHEeZBKANUaVcCW,aGFCCFDDRAFA...OABELDABFCHD...TCEBdAFBDHCE.QCCHhAAAMEIFHGEAZCAFACCBUABFhAAA...cDDChACASGBC.IEFDfHCBhAEA......hAFA...,2,-31,-23,8
YNCMHFIaOUefSGPDXcZTAbKBJRLVWdgQE,BFEDLFFCdHADQCBHEAHD..NDCEHBCGFDGB..aAGHODFGhAAAUADH.eFAHSHGAhAAAPBABDDDBXEAEhABA..cGGCAGGDKFHD.....hACA......hAEA...,2,-32,-13,19
XFBbKZSGNcECUIYPOHeLdDTAaRWgVQJMf,aCFCRAAD..VDEGQEBC.MFGDfAGEBBFBKHAESFAChAAAGAAFEEDGIDCBhACA..OEHBhAAAHGCAdADBAHIH.WFGH......hAHA......hAIA...,1,-22,-26,4
LZVAWRgBSXbIQdYKcPJfMTGNCaHeFDOEU,RAADSEGD..XFEFQCAFKHAEJDEEMIBE.TEBDhAAACGHDHACDeAGF.DABHhACAEAFCLAEDAEDDBEAHdHEDhAAAPHFA.fDHGNCIGaGCF...hACA......hAEA...,2,-25,-6,19
XfBZGYKCNWPbLQOUHecdgVSEaIAMDTFJR,TGEDFDBDRAACBHAC..GDADKCGA.CBAD....PBFAQEDAhAAAUDGAeHAAdAEASGGHhABAIFAADDDChAAAXFFBfADHZGCA..NEIE....hABALDADcGGEEFCAhACAABIB.MCCE.,1,0,-16,16
gQPdWYMLDCENUVebOKIBFRAHcZfXJGaTS,HGFGZAADJFGFTBBG.QEAFdAEEMHBCLBGBCDGCUDDBeADGhAAAKACG.BHAH.AIDEXAGBhABASDEDPGCAhACADIBAECCB..NCIE........hAAA......hAGA...,1,7,-40,47
EOeYGJcUFDbAZRLQWadKSBVCTfNPMXHIg,ZDBGLBDGQGAHaFHB.KAABBEED.CGDB.TGGE..NICH.hAAAPCGBHGAEEEBCOCABhAAAeCAHGFCF.hABAcAGFDAGEAACAWCCGSCCC.MCFFhACAIGFB.JDFE.hADA...,1,-13,-17,4
GTAKVJZYURMbFLPDgCQXBcSIeWHNOaEfd,KDBDVDBGZFBE.UBABMBGF..FDDALBAA.DICECFFABHHAhAAASGFA.eFEAhAAAHAFB.aHECdAEAADHH.JGAChABA.....YAHF...hABA......hACA...,2,-47,-18,29
fFTIREDJHKBSUZNGaYXCegQMVAcdWLbPO,dHBHLGEAOBEHTDEEREAE..DCAHHADBBFFC.ZGEEaCBB.XFBChAAACDGA.QAGEhABAAGDC.WDHBhACAbAAEFAHB..........hAAA......hABA...,2,-43,-11,32
KNbXGCYeLUIagcFdBADPfSJEQZVTRHWOM,DACBSHBGECEE.QCDHZGFARFAFHAFG.ODBAKAGF..XDGGhAAACDHDLFECaCAAFFCEhABAAAEF.JHFA.VDAFhACAMICAGABFeBAF........hAEA......hAFA...,2,-15,-9,6
WYePESQAFUJOfbXIKHcdgNZCDVLMBaTRG,FGDDUFCAOHFA..fAFE..bDBDXCABhAAAKAFBHBDFdABFZEFACDEFDIEGLCAHhAAAaGGF..RBGF.YABEhAFAEGAAAGEC.IHBENDIEBCDF....hAHA......hAIA...,2,-21,-18,3
JMXYaNIfGDbeVERQSLdOATKUCPBcFWHZg,TFCAKFFBCHDH..BBABFGGBHCACZBDB.JAAC..MCCF..XAGBhADAaDHH.NEBAGAEEhAEADGAHeDAB.EFCCSDEDhBAA........hBEA......hBGA...,1,-17,-51,34
bOUWPRNVGIMLKJCDXYQcdTefgaZFASEHB,SEHBBCAHOCCDUDCCRACG.GAECLEFEKBCC.CBAC.DGAHQAGAhAAAdFFB..fGBDhAAAaGGGFEAFAGDCEGABhABAHCAB.PHDC.IBHFMFCFXGDAhACA....hAEA...,1,-12,-22,10
NPCHGUfRDZQMSeXOIYdKbEaAgTFVLWBJc,FGFCVFDFBHBF..JAFA....PCDECHHBGDFG.RCCDZADHhAAAMBDC.eCAB.OFFAhAAAdCAEEFBFAIEG...hABA.gDCGTABA.LAHFNCIA.hABA......hAIA...,2,-30,-17,13
XYIRAKDPWOHJSbeLZNFUBEcgCMaQGTdfV,KHFGDACBODEDHBFASDBBLHFEFAGDUEDC.BADA.EHDACADGaFABhAAA..QGAEhAAATDGF.dBABfDCDhABAYDHDAAIDPFCF.....hABA......hACA...,1,-20,-31,11
IGcZbOWSDBLCFfKPYdHERNJAQTeVgUMXa,QDCHeADGUAAB.MFFA..IFCDGAABZAGFOFFHDGIBCBEHhAAAFAHBKGCDdDEHHGEEEEHDRFABhABAAEAH......hAFA............hAGA......hBDA...,1,-22,-26,4
MgcUKGRNbLFQJEOaZAeDWBCPfdTVXHYSI,eFCHDAEDBFGDCEHF.dEDD..TAFEHCBDSAAFMFFD.UGDGhACARCDHLCBF.hADAFACEQBGAhAFA.OHAAAHGAfAAAYFHBcBGDhAAA......hACA...,2,-30,-23,7
JYEBVHPRGLUMQbgXdNDIWSfAZOTKeaCFc,OBDGTGGD.KEEEeEFC..CFHH.FABC.JBEHEEAH.HGDERDAFUGAFhAAAMFCB..QDCChADAbCDG.XGDChAEADADESAHHACCC.cEFD...hAFA......hAGA...,2,-26,-14,12
CLYegEbXOIdPBZKfcRaDQTNWGVAFJHMSU,FDBDMAGDCGEE.LBCH.eDABEGHHOEEEdGFDZFBDKAHF...hAAA.fCAAhABAaHECDDIHTEFEGABFAABHSCAEhAAAYBHBXGAGBFDA...cGDChACANAFE....hAEA...,2,-38,-9,29
JfRAgCDHGKQeYNFIBOZXcMUPaTdEWVbSL,CAEDHACBGDAHeBFCFBGFOFED.ZEBFXABCMIAA..PDEChAAAdFFFEHEG...bGAAhAAASCAG.hACAfHGFAAGCKFAANBIEIHHFcEGEaFAF.hADA......hAFA...,2,-24,-4,20
dLcACQRZWBTaUNDYJgMSfeVIPHXGObEFK,CFFCRABHBCHCUAFC.DHGC....JADBMADC..SGEDhAAAeCEB..IGDAhAAA.HEBEOBAFFHAGLBADhABAAHFCZFBFTDGH.aEDBNIEHgAFAhAIA.fFGFhBEAXGGB,2,-48,-23,25
aFKJHDAXUGOPRNWQEeVbZITgMBSCdfYcL,UABHOFEFRCCA...QFAGeBGFZFEG.TABGMIFE..BGHAhAAACAGCdEHC...fCFFhAAALAHBFFBFKHBGHDCGhABAABEG.XADFPCABEGAB.bFCDIHHChAIA...hACA...,2,-20,-7,13
RKgFLPcTEBVDMbNQfSIJaHAXZeCdYOWUG,ZADGdDABOBHFUDAHKGDGLDEA..TDDDBGCDDBFE.MBAChAAAQBAB.hABAIBHGaEADACCECHGAGFDFhACAFFGDEDGG..NAAF.SDDDHFAD..hADA......hAEA...,1,-15,-30,15
cNIdVFABfaCJXTGLWHEMeDQSYgRKUPOZb,aEGDJEBEGEGAHCAAMDED..DAGE.QGDASDGCRBCE.UGABhAAAZAAB...NBFCIACGhABAFHBCBAFDCCGBXEBAhAEA...WGFA...eAFGhAHA......hAIA...,1,-16,-33,17
dAHJbYEGMZCWXKUcDaROgVTefFBINPQLS,HFDFJGEA.EEABGEAGMFGFZDEACAAE..KAEGUAAC.DCIDaCFEOHAEhADA..TDCAhACAeBDEBECA.IAHEhAEANEIE..........hAFA......hAGA...,1,-18,-44,26
WMJONbQHYgaLKBISRPZeUFCAXEDfTcGVd,DDFFTCBCGGCH.dBEBJFGF..OABFQAGDHEAAaBDHBDEChAAARCGB.eFBD.FAEFCGGBAIBGhAAAEEGE...VECHhABAMADA..NCAAgABCKBADIAHAPHDChAGA.....hABA...,2,-21,1,22
PRgEDQMUfbHedTKYBJZcFCVNXSAWGLOaI,LFEFaDCD.RCCBEAGAMDBD.UGGG.HCEHdFAAKGFEBGEGJCFCFAEBhAAA.CBAG...XAABhADASBHD.AGAH.hABAOADF..gGBCDGIF.bBBBhACA......hADA...,2,-31,-28,3
RObIDUNLZeHCaKfYJPWFBcMASGEXVQdTg,EDAFVCDBdBCA..RADG.OFBGDDIF.LFFHeGDCHAAFCCED.KAGCJHBEhAAAFFABBAGH.AACE.XDFDhAAA..TDGEhABAIHGE........hACA......hADA...,2,-36,-25,11
aNWSHcMULfXQVeODTCKJbYgPIGdBZFEAR,RDAGaHBG..SACBMEEFUDGHLFBA.XGDAQAEHhAAAeCCATFGAKEEEJAFAhAAAbCCE...PEAChABA.dACEBBBB.FGHDAAHE.WCHD..hABA......hAEA...,2,-22,-9,13
aPIKScCLMREBVeUGYNfdXJbHFWOZADgTQ,DAFBTCGCQGDD..IDCHKEDDCBGCLCEGMFCABGAGhAAAeAAFGADA.fGFDhABAdCBBJEABbFGDFGCDhACA.WHFAAEIB..PEEA...cGAEhAAAEBBFYAFEhADA...,1,-15,-25,10
EAOHaQICKGVNWgLRTBJbZSMDYUXdFePcf,ODCHQCCBKBEEGGEF..NAEHLAACBFGBZGAASABDhAAADICEXEGBdDEHeGDEhBBA...PFBHhBCAfACEAFCG..IEEGCEAF..hBEA......hBFA...,2,-32,-28,4
QAfDWaRJNcPCeZBgOdVTGIHMbYUSLXEKF,DACBaCFC.RADB...JDAE....NIDB.CBGBeAAHBFECdGFFGEFGHBGBhAAA...MBABbECHUGAEhAAA.LFHBhACAEDCEQFABAAHA.cGBD...hADA......hAEA...,2,-26,-22,4
aZDdJefRgQGFUWOSYBbCNIHAXVKcLEMPT,KDAFEDCD.MHFC..aEECDECDdAAC..JHBCeCFG.RFAD.GABHhAAAUGGESBDDhACABDGACDDBHDEBAIEA...XAGChABAcAFA..........hACA......hAEA...,2,-37,-24,13
XNKQORCFDabULGcJZBSPAdETgHfVeMYIW,EFAAHEFH.VADHMFIF....IHEGNCDGKHBE.RCACDAGBUEFELDHHhAAAGADBZAABBDFFhABAACGEdHFFfABHhAFA.eHAEXCGA.CAHBaEAG...hAHA......hAIA...,2,-12,-12,0
OFcRVHCKIAJBbdZEQgLSYeUXNfGaTMDPW,JAFBdEGDZFCH.EBBELCDH.eAAFXAEHGGEH.TDAChAAAPFFB..FEGGRBGFCHAGhAAAKHBGACAE.BAHC.QFABhACASEEF.NDBGMDABDBCF...hADA......hAEA...,1,-17,-19,2
XLEWGeSAKTVCRZfYUBNDcMgdIbJPOaFQH,VBCFRCDHZAAFUGBD..DHBG.MCFDdBFF..JDFEaHEE..FGHBQAAFhABA.HAGBhADAXDAGEFAAWEEDhAEAeFFF...AAHAKACCTFGF.CAFA.BEHAhAFA......hAGA...,1,-9,-32,23
CEVaZDMNQJAFXdIYHOgfKSbGRTcUBLPeW,XFCEdHBHHBAHOFFFKABE.GFAFRCFGUAFFBEDGLHFGeBFACCDHhAAAEADF..aFHFMAABhAGA.QDDDhAIAAIEG.IGGEfAEF.SDADhABA.....hBBA...,2,-21,-11,10
EGFDPBcRJTZeHKNCYMIUadQOSXWVALbfg,LGEA..gCCBEDDFDCDABAGFJCGFZAAEKDAF..CHCG.MFFHhAAAUBBGdFAE.SAGBhABA.VFCFhACAAIAAfAHC.PDGB.RFAA.TGGDhAEA.NCIAaAED.hAAA...,2,-41,-12,29
NRWHgJKVUIbfTScCOeYPAdXBFLEDMQaZG,dFFBXGAFBBFDLDDEDEID..MBDHQAADGAEFRFEAHGBAhAAAKABCUCFF..hAAAfAGH.hAEA.SECGCDADYFAEAFAE.....hAFA......hAHA...,1,-26,-29,3
TZLAINgEDRWfKMeSaObBQGUYPJCdFHcXV,..IFDGEFAFRCDEKBCE..MBFHeEGDSDAGOHEE.BHFBhAAAQDADUACHPFFChABACHBFFDHBHFCD.XAAFhADATGBAAFAH.DBBH.WAHF.fDCBhADA...hAEA...,2,-23,-16,7
VOLYAQRWacNHbGgBDZXMTSPEdCKIUJfeF,REFHaHBGHFABGAFADBAHZCFA..MBED.SHGEPDEHEAEACAEBKFFChAAA..UBBFeCBFhABAFECB.....hACA............hADA.OFEBAAIFWHEA.hAHANAAFBFHA.,1,-20,-22,2
XORPMQGUFSCVYfEIWeKZbgDABcdHTaLJN,dEGDaDAFLFCBJEDD..ODABMIFEQBBEFCFG.SBGDhAAACBBA.fFEEhABAIBDGKGGBhAAA.ZFBFDEIBBHAEcFAH.TDEHNABB.hAGAPAEB...hAHA...,2,-44,-8,36
IEZAFVdbGTWecRKLOfUgMJXQNHaCDYBSP,FEHBVDAGdCBA.GABFeDGD.REDD.KHCCLCFBUADH...MBAFhAAAXAAHQGAFhABAaDDA.CHCADGGFBHHG..hAAAIHHEEAGFAGAD........hACA......hAEA...,1,-18,-30,12
DHLGOcRJgTUSEKMFIBCNXZVWfbaeQYAPd,dHFHDGADHACGLAFBOGECJFBA...TBABEDBE..KBEDIFDEhAAABFFF..CHAAZAAAhABAfDEF.eFFGhABAAHEBPAHF..cAFE.RDAASDHFhACANCAE..hADAWEEE.,2,-42,-6,36
CWUPASXGOgDZfaYMNVbLFTecdBQJREKHI,XBCBOFEFZAAH..aGEEMBHF..VFBAFGHBeEAEBEEBJCEAhAAAEHACHADA.CDED.PDAEhABAAACF..SCCBhADADICCfAFF.NAIELFGBhACAdGCA......hADA...,2,-23,-13,10
RDJWCUaMgTAHIZfXYPBSVebFLGKQcdNOE,HGFGZAAD.XACGBAHEVEBCFGBCGDEF.KFDGdGGD.EHDEDICEhAAACCCB.UBFF.MFAHhABAADIH..IAFAhAAAPDAE.....SEGB.eBEDhADA.....hADA...,1,-14,-36,22
LeADOTBYCdNgJcEQXfFbRGUZaSMKWHPIV,DECDTGDECGFG..dBDDJCBC..EGBD..XFGFFDGEGAAEUCFHhAAAZEDCMBDG.KGAG.hAAAHEACPAGB..hACAIDAAeHFABHADNAIA......hADA......hAEA...,2,-27,-18,9
dAaUVFGfCIJBHScKELPQZebgYOWMDXTRN,VBCFGEAH.CBHDBCBAHCFBKBACLBEHZEAF..eFHH..gGGAhAAA.OFFGhABADFCE.RACBdGBDaAGAfADBhAAASHAG.PHDA...hACA......hAEA...,1,-21,-23,2
dHSAPNeXJaOgbDQZMfKcYCTGEWRULIBVF,eGEAXGGDODEHDGCG.ZCGH..MACGKDCFCDFAECBF..RFADUABDhAAABFBFFGFB.dDEHAAFC.JAHHhAAAaBEG....bABChAGAfCAE.......hAIA......hBAA...,1,-28,-31,3
fLDMbBRUIHaWEJCVNZGgPQOeTYcXSdAFK,FAFBLCCHMAEFBHEFUGDFHAAE.aAFBEGCC..CBGH.ZBADGEAEhAAAQEFDeCHF.TCGEhAAAXEEC.AACAKHGEhAEAfDCG.DFID.IAHFhABA......hACA...,2,-34,-7,27
IacOSUKFDNZMXVCbRQHgPLBTYfWAGJEde,JCDGEEEDdAAD..eAGBaFDH...SBBCKCCBDGHFZAFCMBIB.hABACCCC.RCEAHEAFLGEChAAABADCTFBE.fHFBhABAADIBIEGCODEENIAF.bDAC..hACA......hADA...,2,-21,-21,0
PTXZSIJfWQRYgANUeDFCcbOELdVKaHBGM,UDACFEGCCDDG.OGDGLAFA..dCGCKCADBEDCGGDBMBCG..hAAAXAABSHBAhABA.JCCAQEBChADA.YHAAAGBEDACGEHGEaGGA....hAEA......hAGA...,2,-36,-27,9
LQFKYBeNEXVSDcJbZadIGWPHRgTOUCMAf,LDACFFHBKEACBAHEEAFE....XFCFSGDBDFIDJBBCZCAC.hAAAdHFFGAFCHCEDREABOBCGhABAMIBE..ABAH.fFAGhACAeCHH..NAAF.bFEB..WGEChAHA......hAIA...,1,-7,-26,19
gQBJEcXGZfdReUbHaSFKTVAMWODCYLINP,OCHDDAEDLDAG..IDBB..PFGDBFBCJFFDhAAAEGAGGAFEdHCFUADAHFDHhAAAFDDFKAGBACBH.CCAF.NCIEQABEhABA.......hABA......hACA...,2,-41,-12,29
SDUGHCOJgcXdPNLRafWTVMYbeZEQKIABF,BEFADGGDHEEEJCHB...XGCCdDCHLHAARCAH..aAHFTAEGhAAAMCEA..eAAEEBBGKHGAhABAABGGFGAD.GCCEhADACDABOGDA.......cAGDhACANDIA.fGABhADA...,2,-39,-4,35
AaYcbgLfWdSHXDeJCOZREPVQKGNFMTIBU,aHBG..bAADLABCdAHGHBEFeCDA.CEFBRDBBPEBF.KGGCNAAG.hAFAMIFABGDE.AGAD.gDGHhAAA.SGADhACADDIHJFFFOAFCEEEBVACF...hAHA......hAIA...,2,-29,8,37
CZcSKOYGDWBLJTRHNVEfbQUXPIMFeadAg,ZDBHSAFBOBGDDDFFBCEC.LFBBRADGHFAB.EDDB..QFGFhAAAXFEDIAAAhACAMCBGFDDDdGEEAIFECFDGKACGhAEA.GBGE..WBAFNEIE....hABA......hACA...,2,-20,-14,6
ZBGbTDCcHILFNJOWfgdYERMePKXAQUSVa,QFCAVBCF.BDEEGGCHDAADHDACFAFBJBHHOFBH..hABA..fFEDhAAAdBDFRFFGMIFCeHAGKAHDAEGAUEAChABAaAFF...........hACA......hADA...,1,-20,-22,2
UKRGJXNHOfCMcQVgbZTaYIFeLPSdBEWDA,RBCFGDDC.JEAGNCGC.HBBA..OHEECDAC.MBECQCGBhAAA.VFGFZCABaBHDhAAAFGBB.LFCE.hABAdFHABAHBECEFDGAFAEIHKHCAfHCF.hACA......hADA...,2,-16,-15,1
ULeWYXEVgMBDRSJZPTAGKfaIQdcHbNOCF,KGAHaHBG.dFFDHCCC.OFFGFDCDLCCE..eCACXABGhAAAEAGHMFAEBGHHSCGAhAAAJAFEZGCA.AGEG..hACA.IDGCbGEACGAF.......hABA.WABA...hADA...,2,-37,-8,29
TIgPDdUJeHKSBaVbFQLNGfcAMWCXOREYZ,MBFHXGGGREAH.ZCBF..TGEB..PFEDdCDEUBAAJACGKGAHhAAAaCGE..FGGA.LAEChAAAGBDFAEIHOEFChABAECADIDDEDGCF.SAGE.hACABCHA....hABA...,1,-11,-26,15
KDAVQICBJMYGPacfRbgEeFZXTSOWUNdHL,QFDHBBBDJCFE.MCEAGEGA..aEADRFAC.EBCCFADB.ZEDBXDFEhAAA.SBBDhABAOAFA.WHAGhACANBAC..LFFDADEGIAFCCBFC...cGGEhADA....hAEA...,2,-30,-29,1
ZBMdKOVGbHFAIPcTRQYfLJaeWUNXDECSg,..IFDGPDACRADG..QBAALEEGJAHBaHDG..UGGAhAAADGEBEBCBCHAFZBGB.BADBhABAMFDFKDDGOFHD.hACAVFAFHAEB.AEID.YAAD...hAGA......hAHA...,2,-18,-12,6
McDRWQdbZECafHPIKeVJTULSBGNgAXFYO,FGFCMDEBRADH.dFBHZCAB..EGFHCHAB.HADG.KAACJHCAUCBE.BAHChADAGAGEAHEB...ODDEhAAADIGAQCFEhAEA.fFGBeFCC.....hABA......hACA...,2,-38,-16,22
YcDSGJAKLRBTFMOdZVePUEbNXaHfQCgIW,KDBDLFCABGHGFGBAdBFCeDAH.UGGHEFFD.....bADBaDFGhAAAHDFCCGEG...IDCAhAAA..YAEDhABASAHHAIEGTAGBOBACZCCFPHBChABANDAA....fABFhAGA,2,-37,-18,19
DaLKXeAgUIBMVbPWTYCfSRHEFZcOQJNdG,UCBCBBFDMCCH..PAHH..TAGGCEHD.SBDFhAAAEHGEFGDHZEBEQEFFhABAdAEG.DCBBaEGHXECDhACAAABE.IGHA.WHDAfGBAhAAARGAE.OFEFhADA..,1,-29,-32,3
LTHVFdNcKQSDWaMIXCPUbRGBJgAZYEfeO,ZDAGEHBG.OACBLBCAHGFEFFFBdAGCKAGHDAAF..MEFACDGC.UDBDhAAARBDBBEFDAEAD..eEDHhABAVFCE....NACF.hAIAQFAAaHGA.......hBAA......hBBA...,1,-20,-23,3
NPcbEZBRKSQYgfWeJLTUdOGIDXaVFMHCA,...NDEH.PFBB.ECCFBBGF.KGGESEDAQAAFfDGAhAAAJDBA.TBEDhABAUFBGOHEEhABADCBFXAGAaHACFFEDMADCAAEC.cFGB..hACA......hAHA...,1,-27,-32,5
DfaScTIBHYdPZEMbCNKAOUWeXFRLgQJVG,ODACUDACeCGBRBAELGAE..gAGBQEEEJBBAVAFBhAAA..DGIDfADEhABAaEED.SEGAhACAIDDHHGBGdHGF.EAEECDDBAIDGXGFAhAAA.....hAEA...,1,-15,-16,1
bJPSTdEeVCDAXUBHQaKRfcOZMWNgIYLGF,BCAHaDAF.REBC..OCHHZCFFMIDE.....NHAH.IACAhAAALDEDFBEHJABCSFADhABAdDCGEAFG.eGDEhAEADIAEACCA...XGGEUGGEKEEC.fHBFhAFA...hAAA...,1,-26,-29,3
GHUDVcEWJBNOYSeFfTQIMRCdXZgbAPKLa,LCCHaGFHHFBCDBCBVCAB..ECFCBGABOADFeFDC..FCHDQGGGhAAAMFEC.CEHDXGDAhABAgAFCAIBGKACAhACA.UAFB........hAEA......hAGA...,1,-16,-25,9
IACbBgSePKaUDLfNQYVOHTFJXEMdGRWcZ,BBBDeCCHKEFADHAELECC..NGCH.QFCAOAFEFABFEFHHhAAA.GBDFRFAB..hABA....WHEEhAAAcGFHACIF.CACC.bBECSAGG..hAEAaDAGfEGFhAFA...,2,-36,-31,5
JROTWeMDGKVFScZfPdUHCLNYBIAQgXEba,QCGCEGFC.aEECREBBOBAB.eDHBDBDHKAGCFCDB.ZECHdGEChAAACAEELHFEBHABAHIH.hABAXBABTAGGMBBChACASGBF.cDACfDFE.hAAA......hABA...,2,-31,-17,14
KMFHZBdRAXYaTWbCUSGVOegJNfEQILDcP,aGFCTCBC..CDFBGEAFeDEH..JFGDEHDELHAEDABG.KCGAhAAAFAEHZAFGBBBEABEFXABAhABA...bEAEhACASGAB.ODBANEIEfGEAhAEAIAHH.cEEAhAAA.MCHD.,2,-34,-1,33
JcMNDdOXCTEHVUAQSgYKZfIPeabRLWGBF,SGFCKHBGZAFB....fFEHeCDFbCEDLEBFhAAABHEAFDCCMBAHdBAECAFATCGHhABAEGGBHDGDAHHE..gGCHhACAPBCA.aAHFWEAHJACEDIEC...hAAA......hABA...,1,5,-29,34
MEDcYZAefVbWIXTaSJBOPRHQCLUKgFNGd,eFBBVAAD...ICAHaFBA..JHEEOFFAHADCLDHDhAAAUAEBFFEHGDBFEDEGDIBE.hACAZAGBAEAB...bAAEWGAGhADA...XEECBGHA....hAEA......hAGA...,1,-15,-19,4
XOMNgFcALGWZUbRJDfKEBPTaHYCeIVdQS,GECFUFDHRAEF.DGCHKCGGBCDC...TAEDHCAECEHG..eABDhAAAdEADQGGEhAAAOCABMFIDFGABAAHE.LABEhAGAbBGD..EGAH.aHFA......hACA......hADA...,2,-21,-21,0
LbMGIXDEFHNUPJRgTeQYcASBCWOafVdZK,BCEACAFB.aGBDVDEGZDCF.LEACGABBDFFDHBBC.UFCFRAGF.eFHBhAAAQEAB.hABAAEEGOAAHKHCGIHAEhACAXGGG.........hADA.EGGBPDHDTBGGhAEA...,2,-17,-14,3
eETgZFBHaRJKGQLAdMWXDcYbNIUSCfVPO,dGFHXFDBDCGD......bAACICEDCCCG..VEAEhABAOAAD.EGBCTAEFhACAgAEEBDHEREEEKAHDhAAALGAAAHIFMCIBWFGBNIAF.SDCFhACA.fDAEhADA..,2,-27,-19,8
WeQdAFfaITPLYKgVXESHZOMDCbGRcUBJN,FAFBaHBG...TEGBLABCKCGE...XCFCSGGAHFFHhAAAOBADCAFHREDHBCDFJDEH.hAAAeFAAADCD..fACAhABAIAHH.PHBCgCBDEECFMEAFhACADFIB...cGEChAEA...,2,-29,-11,18
dQIBeRJOSgKMAZcFHXYEUDLCbVWfGaNPT,ZDAGFCFCHFFBEBCALBFGCAFB..VBBGGDFE.aBAFTEAFhAAAQFDGeHAEODHFhABAKHGAAACG..XGABhAAADDEHfFEANDIE.......hABA......hAEA...,1,-11,-15,4
bTDCacFGWLPKEUgeHJANVRYSBQfZdIOXM,VGFGRDAGBEFA.ZCGHdGBH..OACDMDIDDBCD..CGHE.FDABGGAFhAAALECAKFDA.UBFHhAAA....eAFFhABAABAHNIBD....SAHBfGGEIDDFhABA....hACA...,1,-32,-35,3
TWVFASEIMNRQZgcUbPBYGOfdaKJXHCLDe,SAFBEGFH.MCDHNEDGZADA..UFFABGEFOABBdAACJAHDCDGE.hAAA.DAHH..eCEFhACATEAFFEABAHIF..RFCA.hACAQGAA.......hADA.cCEH..hAEA...,2,-35,-28,7
AaNZWPUJKbFQcLETMYegRHfDdCVXBGOIS,aCFCZAADUGAC.KCDFFDBD.QABDLGEG.EEDGMFDA..hAAAgGGEHCFEdAFHCEAFhADABGCD.IAEGhAAAAHIB.NAIE..WHCA......hABA......hADA...,2,-31,-30,1
QcPHUXYOAMILRSGKJCFEDaWbdeZTfBVNg,LCHDSBBDGDECCHBH.DBBA.aEBBdEFE.eCCGZDCFBGCGhAAANIEB.QGGEhABAHBGHUEBHOHACAGHFMEABIAGGhACARADA.KBDG.......hAAA......hABA...,1,-12,-21,9
aALUFbCKWMVIgBYZXGNDPEQROTdHfJSec,UAADCFEDKBFG.MEDG....VDAEBFBBZGFGGGDF.DIGEQGAEhAAAODGDdCDHJDFEhABA..SAHBhABAaACEADDGFAGA.IADC.XGAGNCABEFFE.hACATAFA...hADA...,1,-22,-26,4
eRgQOYFUWZMXKACfBGDcSbTPNLJEdHVIa,BBBDGDCCDEDBSDAH..TFEDLAEGEBFFHFABhAAAIGGDRCGF.QBAHhAAAFADB.WCHFMCAHhABAXCEFAHGFCCDA.cGECNEIE....hABA......hACA...,2,-27,-23,4
VWbOJNQISTdgceMDREPLABHYXUCZFafGK,HDBHXCGCUEGEFFFDaAHB..GCBBKGDE...VGBAOBAHhAAAJADA.IGAE.hAAAdBCFcAGADIFAEEEEAEEBBBBEhABACBFE...WCADNDDF.....hABA......hACA...,2,-23,-21,2
AQWLVfegcaTCFXPbSBNYGIUOdEJKMRZDH,QDACLFBBeFDGaEEH.FBCA..XFBDSBGABAACGCAHhAAAUACFODDAhADAEHDEKHGGMDIFDAHFAGGBfHEBhAFATDEGCHAF..NABD..IAGARDGB.hAGA......hAIA...,2,-22,-2,20
PDTfaLYCMOBJVQZWdeUHKREIANXGFSbgc,XFGHSDAF.....bCFBcGDEDDHF..aAGGCHAAMDCGhAAAJFBFZFDC..eBBChABAHDCCEEFBABCF.FEABPFHDhAAATFCHLACBBCHG......hABA......hAEA...,2,-20,-13,7
UZVACNdRQcgKXTYSJPeBDOEIFGaWMbLHf,dEGDQFDHKBFG..XBCGSDDF.JABDBEAGDDADECGChAAAIADHGEAE.MEEAhABALDFF.fAHEhAAAUGGCADCHCAHC.RGAE..gCADhABA.PHEA.ODDDhACA.,2,-32,-14,18
DSKUQPZBXfRMYbEHaOecdNVWAgTGLIJFC,TFGHLFEF.FFHBSBADKFBG.UAEFZBDDBHAGRDCF.MBCHhAAAECGHaHEA.OAHFhAAAdAGE..NABCAFAHIHAEhABADADH.XBBB.fFEFhACAYDFC.....hACA...,1,-5,-40,35
TbQNdSUaGFKMgeZcACWBERXfOHPLIJDYV,BBBDXCCBOEEELEGHDDID...VAEEQGBF.hAAAdACHSDFFhABAUBFGGDABMICAeHEEAACAEDBBhAEA.fBHA.PEDD.IHAHhAHA...hAAA...,2,-35,-9,26
ALTGCQPVFXfUWJZgDHRaENceOIbMKBdYS,LDACGFDHCGCG.VEEGFCFB..UBBHZEABDHDGHAFC..EABD..hAAANEIC.OFCB.MAIHhACAKECEdAAB.SEADhADAAGHHQAFE.......hAEA......hAFA...,1,-20,-28,8
SNgIKDOLPQMXZRVFBAYceTGCbaJWHUEfd,eGEAGFDHCDDG.aFAFHCGBUAAFdADA..SDEC..gDBDhAAADDBALADEhABAMIAGRDFABHHGAAFC..hAHAYBFE.cEDDbEBB.EABENIADOAHDhBEA....hBFA...,2,-18,-13,5
KTSUMJLNePfAEdCZWYacgRQFDGIbHXBOV,EEHBCHCHZEFC..aAEHRADA.FCBFDHGC..GFAHHDACBBCDKBHFUDEDLAHFhAAA..PAAEhAAAdBAG...WFFDhADAcGEG..IHACXDDB.OGAAhABATGGC.MAFA.hACA...,1,-13,-29,16
NKYPbdHLTWUMeBZaIfDOQVCgFSGXRJAEc,EHBGKHBG.....PCAEHGDATFAH.MDFCBEBHZAFAIFGGhAAADCBFQEEAhAAACHEHFAHFSDFChABARABAAGIBNBAEdCDE.UAEE.eEDD.fACBhBAA......hBBA...,2,-31,-6,25
DdZHYTEGgSJXCOaBQVeKPAUbWcRMIFfLN,UCBC..bAADRBFHMFEFFDEELHBG.DECFHFAF.TGGGhAAAgFCH.XAEDhAAAaGFBBDHGQFGBhACAKCADADDCIABFdEAAEACF.SAHBhAEACEEEeAFE.WHFG..hAGA...,2,-17,-14,3
dEeKPRLNSQVXfOaUHTICgJAYWFcZbDMGB,FHBGZAADMCEBdAFAKHGARBFA..LFBB..SFEHQFGDhAAAXDABaCCHHACECDGC.hAAAAAGF....cDFDhAEADBBEEDDD.eEGFPFDB.NIEF.fCEGhABA....hACA...,2,-43,4,47
FPWMGALKCBYHfRZNbeEcIOSdJUXTVDagQ,CDGFHDBHZFCC.eAEH.EHBGOBEHdAHA.UBBETEEF..aAGHFACDhAAA.MFHDACAABAHEfDGHhABARFAB.NCAE.IGGFhAAAJFDF.DFID.......hACA......hAEA...,2,-44,-6,38
GMYeOCURcagBWEZXIHJfKAFNTdVLPQbDS,TGBCdDBDLDFC.QAAFDGABSAEHMHFE.OCFEhAAARADAaHCG.BEGF.ECAEXEGHhABAIABBJEAFfEAGhADAKAHFAGEA.VDCF.....hADA......hAEA...,2,-20,-18,2
SXFQWBMcPOTGbgZYEfADNeKCLHVIJUaRd,DEFHKDCDLBAEHAFEJAAB.UEEE..dFCASAFAFFABBCCF.MIDAhAAAOEGB.GBDEhAAAZEAHEDHD.ADFGCADB..hABA...aGHFXGDD.WFHH.hACA......hAFA...,2,-29,-29,0
aUKVHTNRACgLcWEQPZSBFbMfJDOGeIYdX,CAFBLGEA.ECABZCCHFCHHMGCC.JEHFGEBE.eAEDdCAG.hAAAaCBAKGGDHAFERCEBADID.gEEEhAAA..hABA.WHFAPHCCBHAEDBDE.OAHB.hACA....IABHhADA.,2,-43,5,48
cBUOYXRDaWgTSbPEJFfCHZeINMKGALVdQ,LDCHQCCBUABGODGHRGDA..DCEFaCGA.....WFFDhAAAgGGB.hABATAEFbADCEGAGFHAGCAHFeEAGhACAMDBHGAGEAAFEdGHABEHESEFGhAAAJFDB......hAEA...,2,-20,0,20
QFLNGADgaYEZfJRUOPHbWMSTKIVCdcBXe,DGHHaHBGZDCFRGDA..ODBDHBDAMIFA.KDAHVBDF..CGGCdAGFhAAABAGBeEECFGBHGAAAhAAAAABCEACA.UDGC..hACAWCFASAHH......hADA......hAEA...,2,-28,-17,11
EeJZQPTSfMNRUWaKgDYVdHBGLCIAOXcFb,ODACFGFCEEEF.ZACE..QBEESGDAMIBERCDB..aHGEDABEhAAA.dBBABGBEGCGChAEAIDGFAGABXEBAhAFAeAACJBFE...PFFA....hAAA......hAEA...,2,-27,-17,10
EOfLWDTdNSHCYaIXPeKcVbJQMZBUFGARg,RDAGOCCHLFDFDAIH.dFFAHACD..CHAF.IEHBeAAEKCDE..hADAVEDGJEHF.ZAEBBFADhAEAFGBEAHAB..EBFEfAAHhAAA.TGGC...SBGDhAEAXCGE...hAFA...,2,-35,-12,23
KYFVRcXTANaDUJefgQMbWdLGZHOBSPCIE,aHFGDECDeEFE..QDACMBDH.dHAFZAFCOCFESHCAhAAACAADKECB.VGFA.RBAF.hABAXFEGAFFH.JAEAhABAfGAD.WDFEGBCD.BACChAHA.EEEE...hACA...,1,-12,-28,16
DTAIaQBJMPeVWgCHbRFYZcUXNGSdfELKO,QGBCMIAG.eEBEVABE..CCBCHAFAFDFEZDDDUGGG.XACBhAAASFHHfEGFhABAKAGGDEACIFGFhAAABHACJGDC..PCDCgFAC.YFFFhABA...hAFA...,1,-12,-27,15
HXAPCfLZJcSMNdEgKYITbDaFBRQOVWUGe,CFDGLFBBZAFA.SGFEMIFE.EBEBKEAF...TFGHhAAAaBACBADCODEAUBGDHCAChABAAEGEJEDAdFFC.gACDhAEAIHDEDFADFHCA.......hAGA......hAHA...,1,-17,-32,15
GfLHAgCZaYUDQVFcTOWPKSMEbNeIdBRXJ,ZDBHUGBCQAEAFBCB.OAHHKDFHMBEEEDAB....NEEH.dHEFhAAABFGBRDAEGEGE.hAAAHDDBCBACaFDFDADC..hABAcBCF...PFFB...hACA......hAGA.bBFEIHHA,1,-15,-22,7
ISQYCDEeFdWKbacXZPAfBNGUTHLVMgORJ,BFDGUAGHLDDGMDBBRDEF...SHGECHHGDCCG.eCHBFHDAKGADhAAA..aDBFZAFAAACCfFCChAAA.hABANBBH.TCGA........hACA......hADA...,2,-46,-27,19
FHfWKJPZICgMdSTcNVXOBYRAGaeDEQbLU,aCCGEEGCLFBFHEEBKFBAZABGCDAE..dACGSDAG..NDDCOHDEhAAABAFGABHADDDAUAEEhABAFHCE..JAHFIHHHhAAAMGEC..........hABA......hACA...,2,-35,-26,9
ITegcSPQZfBbRadMNALXWCFJGDYHVOKEU,LDACCHHGFCHH.DHBGHCCCKFAD.EAADUGGE..eDGD.SGBGhABAQFDFBFCChACAbCFB.aDAC.dAGBAEIBJBBEhAAAVFEF...OACC.....hABA......hACA...,2,-39,-8,31
KOTVJQZLIaFWAfEeDNcCgPRXBbYGSHdUM,eCCHDACBCHAG.RGFEBGAGGGCFHBEE..dCFBKABFOCDH..JCAHhAAAQEAFZDGFaEEG.hACAFFGCAGBCEHBA..cBAChAAA..........hABA......hADA.XDGA.,1,-22,-26,4
KbIJYFENABGefPQdcXHMZVSCUgWDaTROL,eCBBQCBCdHGBHEDGMIACZADD..CFGAUFAEDAGEaEHD..OABEhAAAKGBE..JAAEEAGEAEGEBHDGhAAAGDEE.fDGHhABA.cAEASBFA..hBDAWEDF....hACA...,1,-25,-27,2
dTYMGZEVOXQefARWIgFbULDPHcNBKJCaS,RAAD..IFDGFEFGUGDBDGAGHFAFBBHCKDDH..CHDE.dHGF..TBCDhAAAMAFGGACFhAAAZGFAOCEC...XCAHhABAfCGBAAFF..WFFE...hACA......hADA...,1,-23,-37,14
QPSMTKAgLVBERdIaeOXJWcCHNYDFGZfbU,LFBBEBBDdBGH.eADBOFHF..XAADJEDA.CFGEHAFFhAAADFCBFEAFGDDFZCEAUADFhAAA.....SGADhABAKHDGAIHGBGHAIGEB...hACA.aEABNIDF.fAHGhAEA.,1,-23,-25,2
gPfTdAHcZUVeECIGaQJRYXFLSNBDMbWKO,HGFGUFDHECCCCCDEGEAA.QDGBRCFBFABDLFBFSAABhACABAHGDDIHMICE.KAFC.hAAA......hABA.gGGEfAEEAAFD.cDBAeDAF.hADA......hAEA...,1,-9,-31,22
BDIHRfOWQEdNcgZMSCYFXKGALTJaePVbU,LFCATGGD.aCDBeFCA...VCBDBACADHBEIBGBhAAA.HGECOAHDQCEHhABANBBDZAFBMCAFCHDGFHAEhACAXGEDABBHPEAB.......hAAA......hABA...,1,-14,-21,7
QYaWDEJPgSVNFORUXKHCMcdAIZfbGLTBe,ZAADGAFELAECBGGAQDBCaFCC.DHAAEGFC.JCCFPBAGhAAA..SEEEhAAANFDD.RBEEKCHHMFIDhABAAHHDfGBEbADF..YHDAhACA......hAHA...,1,-21,-25,4
WdPbOaRNCHgXYMLBfAZEKcVIUFTSQGeJD,ZFEEEAFBKBCC..VAAFUDGHFFAE..QCAEGADFDFEGdEEG.hAAAOAHHaFHD.CEADHGAAhAAAXDACLHFEhABAAHAH..TCDG.......hACA......hADA...,2,-25,-18,7
IKcYSQEVWPLHZCDOBgdUTXfeFMAaJRGNb,aDBDJEGHGACG..IABFKGDB.SFEHQEAFEDFChAAAVAGFLAEA.hAAACDDCDIDEBEEDUGGETCAChABAXFAGFGAHADIH.NAIE......cGCBhADA....hAFA...,2,-27,-23,4
daRGZBKWbfCHFLOMNTeIgVUXcDEAYJPQS,JGEASGFC.dCAHRCEAZAECBAAFKCCH....bDAECCAAFGAGLCFDhACA.MHBEeDHFhAAAIDGHUFCE.DGBAhADAABAH.QAGE.WBBE.fHFFhAEANIAF...hABA...,2,-43,-12,31
IEdMTQAVULRPODBgZSJGbWXYfeCcKaHNF,UBDGLFBBOFAABCCGZAAFSFHD.GEEEbAGF.XAEChAAAeFFHCDADKEHDaDEBFACFhABAdEEA...MBHDhAFAAICA............hAGA......hAHA...,2,-32,-25,7
eCVGbXFZBOaJcdYHSREWKfILAQNDPUgTM,QAFBDACBUEBE.MFCFCFEG.GEGGFGHB.BHDD.OBCDhAAAaBDF.dBAAHAGHSFDChABARDFEKGFBLAAFhADAAEADPBEB.TGEA.......hAEA.bGAG....hAFA...,1,-4,-31,27
PaCXDSeKZLgQRfBYFMbHUdNAcVEWJGOTI,VDAGJCCHGBEC..TGDG..IAAFaEFD.DAEHeBBGhAAAKGBE.LADAhABARGFABDHFFCADMFID.bCGBUAGChACAAHBBEDDE...OFABCEHH....hACA......hAEA...,1,-10,-33,23
CRTGfNKEbBHdWQaIZVUYAXcgMOJDSLPFe,XCBCMCCADFGBLAEEFGCD..CFHFRAFGGGBH.KBAEBGFEhAAAHDAFdDFHaCEEZEAE.UACBhABAAHHE.....hAAA............hABA......hACA...,2,-38,-33,5
MGCaQEKNHUXcWAePZgbTRIfJBDLFdSOYV,eFBBZAAD..TAEEIFEBBHAC.LEHDdAGAOHDAMFEBaCEFhAAAEDDAHBBF.UGGGhABA.XADCcCFEACDEhAAA.bEAC...fGCEDDGF.YFFBhADACEAC...hACA...,2,-17,-9,8
MJFOBAZeUQGCITadWKcLPSfXVYDgRbNHE,eBDGQABHGCCECFHB.aHCEKCEH..LCHHSAGE..hAAAXFBHDCIFREADHFFHhABAJFFFODADBADEAEGGIGDFhAFAdAAFPAEA..fCCE.hADA......hAIA...,1,-13,-22,9
ABGTXPJLZKVgcWNQFCIHbSEeOfDUYMdaR,GCEHTCGC.JFAFLFGFZFGB.KFCB..VACB..cBCHhAAAQFCE.IFFFhAAAHFAFEADCOCADhABAfGEE.YCEB.aAGEACHG.hACAPCAB.NEIECBAB.hAEA...,2,-26,-2,24
RXIOPKSaNeCETDbZdfQUBcMVAJFWHgLYG,FDCDHAADLCGFRCFAOEFEKDAH..aAGBCGHC.DGIHZAFG..dDCCQABDhAAABBHBMEAHJHDE.hAAA...gADHhACAXEEH.PFEHNADB.EGGF..fDHEhABA...hADA...,2,-29,-13,16
VGdHIKNfOAMcSaQDYZbWPRECeXLBJFgTU,MHFGSAFBDGDGZDAC....PFBDECDA.CEDCLHDEhAAABGADJAAH.FDBGUBFEdACCIEFChABAKEHB...hABA.fFFDcEGD.....aEEGhACAbAGDeHCE...hAEA...,2,-29,-28,1
EKdeaIXMRSYHNTABCPJOcbVLfFZGDQgUW,CBBDJEEG..OFFC..bAGBLAHF.ZFDFQDAChAAAUEADKGAGdDEBeFCD.IAEAhABAMDAARACE.SHGEhACA.YCDC....hADA......hBAA...,1,-31,-35,4
OZCdAIPgFYKNBaDRefTGcMXJHVQLSbWEU,..IFDGFDCDKEEABAHBDDEG.RDGB...eAABGAACMEECHAFDhAAAQAGDLAEDbGFAhABAEGHFZDBDAIEA...gADDhACA.NIDHaFAB...fCHEhAFA...hACA...,1,-2,-32,30
KTdOFJfNXPSHLRCeADEZYBcbVQMGWgUaI,EEAEBFDD...VCCCMFIDGAACUDFGaHAEKAGE...dACGODAHhAAA.FCGCNIDFSAHBhAAALFGHRFEFAICGDDDH.hACAZBDF...bFAC.......hADA......hAEA...,1,-19,-26,7
WHJPYOKQZIDabeCTLUgGNBcVFRAdXMESf,XAEDSHBGHGDE..JAFEOEDGKFAAZFEDaDGD..CCFEUCCFhAAAgDBD.NBAGBBHDhAAAFACFABAGdGGC..hABAEHGC.fBBFPCHF.IGBChABADFDF......hACA...,1,-17,-29,12
VCMdAYTbLaRBGgJDKWHINcZXUPQfeSOEF,TCBCaDCDBHDF.GEGAJFAE..KAABHAFD...IHAEhAAANADBZGBE.UADCQFFFhAAAfCACOHDEhACAEEFHCCHGAEEBLBEEDCCB.cDEA..hAIA......hBCA...,2,-22,-15,7
JacZSYbdIRgKTLeCBDXPHEGUNAVMfOQWF,VFACOCHD.FBAC..JBACZECB..SGEBdBDFRGFGKEAHLAGFhAAACGHD..BAFEhAAADEFD.HDBGEEGB.NCIAADACMDAEhABA...........hABA......hACA.fHCH.,2,-37,-25,12
EIcTGfKOHVdXMRCBPaAUDZNQbJFSLegWY,UFCAZFDGQBEEFAGFLBDFeBCD.....gAGHhAAAEEGBTBEDKACEHAAFXFAEhABAMIECCHHEaFHFDCIBJHEEhAFASDAG..WEECYFAFhAAA......hACA...,2,-22,-6,16
ABSfgEYGJZFKcNabCeQdIUVPXLHDOTRWM,SEGDEHBGGCGEZAACKCFA...aGGHCHFDeCBHQDEA.UEAEhABAXAFGDAIHTAFBhACAMAEBAEEDBECA..hADAgGAA.FDHD.NAAG..dBBB.hAEA......hAFA...,2,-22,-12,10
fYNcbTgDSCeWPJRLKVEdMQGHXOFAZBaUI,aBBDUCBC....IBACfFFH....NDAGTCGAhAAASHBE.CADGPCFHhAAALECC.VFCEhABAEEDFMHECQBEFXAGEOGFCAGIDBFADhABAbFADDIEC....hACA...,1,-17,-27,10
gUSEHaMdPbZNTQFKYfXRJBGVIOWcALeDC,eBFDDAEDCDHD.UGCGHFGDdDCGZAAF..QABHFFCGKDAD...fEAGhAAAJBFFBBHB.IGGDhABA.OEFEhADAAEDGSGBGMAIH...PACDNBEAXGAGhAEA....hAFA...,1,-17,-41,24
XRNFULgJZTSIdGDKVfaYWAEPQecCHOMbB,QGBCeAFBHAAHMDHDBECCRGFEUEAFLEAFZACF..SGGGhAAAGBDFKBAGaHAGAFEEEADAhAAACFECOHCC.NBIE..hABA............hACA......hADA...,2,-28,-6,22
JGTLIeOSbCRAVHagNBEKdMFWXZfcPQDYU,HDDFaHBGBEDCKFGBMICG..XBBDZEBB..fBDDhAAAQGGEDCBGUAFGGAGGhABAIHEGODAFSEAGhAAACAFEAADA.gEFCdGDD.WCEGhABA.....hACA...,1,-15,-24,9
AgXFdSQEPJIYCcUZRfWTBHGOVLDbeNKMa,FGFCSFAAEEEE..JBFECEBFZABC.RGDC...TEADBEFFODDBhAAADDGC..eADHhAAANAIG.aBBHAHBA.dEHEQAFChACAIFDEUGAFfEGA...hABA......hACA...,1,-27,-30,3
RAVXBHTaQPedgCcUNfJKWYDbGSMEOLFIZ,XADCBFFCaHAC...QGAEeACBdBHCCDFBUEFD...fCEHhAAAKFAADABDGGBHhAAAEECDFBAAZCDBAHHFHGDAhABA.TAGFcDAANCAE.JHFE...YAEEhADA....hAIA...,1,1,-27,28
bREgfBPDHdOWcGASXFNLCKYVeZUMTQIJa,XFCELCCHCEHCKABE..eABFUBEDQGAE.JHDEbEEBhAAA.ECHDBAFE.DGFAhAAAdGHGOCEG..hABAWEABAFFASDADFBBHNIAF.....hAEA......hAFA...,2,-29,-28,1
CGZAHbKMLBYDdIaROFEXVUecWgSNPTQfJ,HDAGKGFHBBGEDCGCdGABRCEE.FFEE..EAEAUACB..eBCH..hAAA..WFCHgCAFhABA.SFGBhACANHEF.TECB.fFEAhADACEECAAAAMBFC.YHAC.hADA...,2,-44,-18,26
HQNUFBEJIXWAcYPLMVZeKDOCbTSdgfaRG,...PGEAMHACeCDDDADH.ODBB.CAFE.TFADdBAFaEHHRCBBHDFAhAAA.UDDABGEFhAAAIBAAAIHELCFChABAKAEESGCH.fAHEhABANDGEEADB......hACA...,2,-23,-21,2
geAMNVdbYBORKFXQTWZGScIEDJfCLHaPU,MECGVDAG.dDGGBBABKHGE...QGEGZGAAGFDH..SADChAAAEBECDEBH.CHDCaEEGhABAUBAGAFFE....bDGBhACARACF.FGAD...WAFA...IHHAhAGA...fCCBhAHA,2,-35,-16,19
TIZSBNWHADcEQLGfaYPXVJCObeFgKdMUR,DGHHQGBCLFAEGCFG..aHCGPCABJDEH..OCEAhAAAeECE...FACDdCCDhAAAMDIHRFGFIAGBhABABHFGHCAAEABAfHDH....hAEA......hAFA...,2,-33,-8,25
VUDRMSaQdOgFAJCTZIbPWcYEHNeXGKLBf,CFFEZEFH...IHBA..WDBEECEGeABAKACHBCHB.UGCAhAAADAADMFAF.QCCDhABAdEACFDFAAAHA.TBGEhACA.bFBAYEHBNEIC....hABA......hACA...,2,-54,-6,48
cdgGSNaLeURKWCHfOBXQJIFVMYADbTPZE,DAFBTCBCZDCAdGGH.GBFCaGCFLAEG.eBHFKHBCHEAAhAAAfGFFBHFD.JDEDFBAChABAMIFAAHABEADF...hAAASEHFUFAECABC.......hADA......hAFA...,2,-23,-16,7
EHWfTXDCJQGLeAPNdUZROYBFbcVIaMKgS,dHBHZABHOCFEFEED..VBDBMBEE.KGGFEAFCHFAG..TCAHhAAACEAHGEDB.AADA.UCGFhABABHEG..IHFFhACAaDCE.SEADfHABDBBG..hADA......hAEA...,2,-29,-23,6
AEFHCGULWaJcVBZIRfYSdXTgOeDPbQKMN,EEHBCCAHLBFH..aCFHJECDBBGH.RFAH.SHBGdAAF.hADA.TGDAeHFADHDGhAAAPDCFQABEhABA.MFFAAAGAFGFA.HADEWAEE...ZDDFhAIA.fDBAhBAA...,1,-19,-29,10
LfRcTYXBHFAINbSQJagUPKEZMVCeOGWDd,..IFDGNBGE..SAEDaCGD.UDCBKEAFEBAEZDAHCBAAeFBHhAAA.OADADFFDLAHDhAAARCDCTFGDBGHBhABAABEF.bGAE..........hACA......hADA...,1,-22,-32,10
CPfYbJUdMEGXKRHTSNIeWcVZOLBQDgAFa,FEHBCFED.....PACGbAAB..dCDAGCCHKCFERGEA.HGCC.hADANFCF.eHAE..VAAFhAAALFAEBBHDDAGHhAHAAAECfDHAUGGFMFBB......hAIA......hBFA...,1,-10,-31,21
QLOBTRDdSGYgKNFaEWUVAMcPfeXHCIbJZ,MCCA..fDCDHCFGCDAC.JAABQAFBBFGBRBEG.SFFChAAAGEAHKGAGaGGHEGEFhAAAVDBBAHHA...eEDHhABAXDGAIGAA......hACA......hADA...,1,-17,-27,10
bFQETKVWXSYNZaDgAJBeGCLPfMURdIHcO,JEGHGACBLFCEMDHFRAABHAGF..OFFDQCCAEHBEKAHBXAAAhAAA.SFABhABANDAEDGEBAIHA.BGDFhADACDEF.PHECdDCA.IAEC...hAAA......hACA...,1,-9,-25,16
EYgMRCScFeXGJbdAHVTBQZfOULaINDKPW,VBCDQABH.ODHFUGGHLHCA.aBGFNEGAPCDDhAAAEGAC..MAFHSGDGhABA.FAGEXEGBhAAAJCFEAAFGHDAFBCABfAEEDABCKFEDgEAChAEACFEA..hAGA...,2,-23,-6,17
dZIAKDeVHEObQJcUXYMaPFRBTWCNGSfgL,eEACHDDFOAGHQCGHJAAB.UDDC.MACGaFAFFGGABAHGCHAG.SGAEhAAALCCCdDHGhAAAIGHAABEG.DGFDEGEFhACAXAEA.PBAGWDAA...NIAF.hABA......hAIA...,2,-19,-17,2
cZJCXMQNVFRTYbUdIagLeAGBWPSfDKEHO,GGDHBFDGSAGEDBIBEABF.HEAHZFBGCBDCMAED..QBFAhAAAFFGCRBBD..TGEHhAAAUDDHIEAAhABAaCGGeEECAADH...........hADA......hAEA...,2,-28,-15,13
VfEgFUZYGXLbDIcaRKQPWOdMHJBSeTANC,VDBHEHBGFDEF..UDGHZAAEGAEFLAEDDIGA..aGGEQEGBhAAAOBAH.MCCFBHDBhAAASFAFAHBBCHFD.hABAfCGFgAGH.XEEDbDCD.hABAIBCAKHEC..hACA...,2,-30,-1,29
KLQSAXcWdPITJRHNbYeDBZEfMaFOGUgCV,XCBCdHBH..TDDBHDGB..NFBD.bABDDBAC..BGDEZADHEAFFhAAA..MIFCaHBGOAHFhABAUADDCFHGKDFEQGGFhACASEAAACGHWFAGPAHD.IAAChAEA....hAGA...,1,-4,-32,28
LeEFNRcGaHVIJBKAPWbQYZUCMTXSOgdfD,...PFBBQFDHZBAF.MAEG.TCEAXEEG.OCDGhAAAdGGALDABhAAAEDFCNACH..RFGF.aDCFIAHGhABAKABBABHDYBHB.SGBHhABAfHCF.DIEG...hADA...,2,-21,-13,8
CRUfNLPDZBEFXKJYbIWMHSaGgeTQVAcdO,OCCHCFFCRAEC.UGEGLHFEZEAH.BEADEDGF.FBCB...KAAD.hAAA.JADG..IDFGhABAMBIHSGHFhABA.aGCDgCGB.eDDD.hACA......hADA...,1,-36,-40,4
cIYGXBdUFECJKPObDgLNQMZWHeSfVaRTA,..IFDGXAGHdAGAEHEA..CAEAKGGBOAAE.DADCLCBChAAAMEFEHFGDSCFDhABAaGBARCCCAFBC...YFFDhACABAFA.UDAFPEEHNIAF....WCHHhADA...fGBDhAEA,1,-21,-28,7
dYCbBaUKOPAWHMNJgIVcRESFLZTDeXQGf,HFACJCHD.VCDFEGBCLFEFZAFA.DCAGXEGA.QBAChAAAfFAFCHDFBGEBhABAaADE..KGGEAIHA.NECF.hAAA.....cDABSHGC.hABATACE...hACA...,1,-13,-40,27
WaGbdYefFRPHBIOEAgLMZQcTDUJCSNXVK,MDEBQFDHDDHF.CBGH...XGFEKHAEaAAF.dBBE..eDCHhACAfFBCFAEHHDADOADHhAAAAIHA.LAFBhABAZFFB...........hADA......hAFA...,2,-32,-26,6
FIeHWVRCBZEPXLQKOgdUYfNbJcaGTMDSA,eCCHHGFGRCBEZGFAEBHHLAAFKFEA.dAHAUGBG.....NFAB.hAAAcAEAGACDMFDChACAAEIB.FBEH...VGAAhADABHACXEGFgCEHfBBGhAGAaDACDAGG......hBCA...,2,-14,-7,7
gUIXLNTCKaSPBWdZAFOGfeMYQbEJRcDVH,FHAEGECFeBEEQAEE.EABDRDDFVABFHCGFUGDBLFFHhAAACDBDSBHBBEAGdEHEAHHDhABAMAAB...bCDChACAcCEADIGGIGGDNADF.KHAC...hAIA......hBAA...,2,-24,14,38
gNZEUMSaWKPHTLVRIODfGbQCYJedABXFc,BFCFFGFC....NEEG.UBED.aFHFKDGBHBADLAEFRFAD.DGDHhAAAGDDF.CGGBeHDAhAAAAFBFXABC.ZCAAhACAMADHSCHBPAHF.IAGF.hABA......hACA...,1,-18,-36,18
PbGaNZLfEBDHFKAJWTMIVReUgQdSOCXYc,JDACMFFF.RCFC.eEDAUABGdHAF...CBFE.XGAA..PAAEhAAAaAFCZDBCLHFGhADABGGGFEHBKEHB.AGHB..hAAA..IFAD......hAEA......hAFA...,2,-39,-34,5
MFZCTGaQNLRKYOcAEbBXfIPgeHWDdSUJV,BFEDXCBC..fBFH..IBHHeDDCDGABUGDAhAAAMHDACGHCaCFCLDBFhAAAREFAODCEEBCDPDGFhABAHABESFACJADE.FGAD....hABA......hADA...,2,-22,-18,4
XTYQZWKgUcJLICdEfbSFBaOAHeDNVMPGR,eAGHVFDG.MFDBGDAHRABA....XFFHQCGHZFAFKDCGhAAAgBAA.UAGFhAAAJBAFCHEGdHAH.EHGCSEFFhABABFADADDEDABENAIE.......hACA......hAEA...,2,-24,-6,18
DRZgYPJTQUdXKIMEGWcbaABfLCHNeOFVS,BAFBLAFBCDGBHBBEeBAEFFFEDEEG.ZFBA....PHAAQGGEhAAAUDBF.XCADhABAKAAEMAIFEBHH.cADAhACAAEAHOFEH.SCFC...hAHA.YFFE.hADA...,2,-35,-9,26
AWGZdYEXUfJQBICLgVHeTRONFaSDKcPbM,GEDHZDAGdDGCEAACUGCC.QAEFBCBGCHBH.LCDAHEDHeADGhAAAODBCFGGF.DGGAKGAE.hAAA...bBGDMFIFhAFAWBAF..fAHEgFAD...hAGA......hAIA...,1,-7,-22,15
OURAVZDHGFWbPceNMYfJCXgELdSTQaIKB,DDGBGBCHFHAC...bDFCeDHD..MICGJCED.CGHD...XBCBhAAAEACALAAF.hABASAGCTEAH.hACAaGDCBHHAUFACAAGFVGCE.....hACA......hAFA...,2,-34,-18,16
AFcdCbLEPZXMgSUaBVWDJYeGNfORTHQIK,FAFBCFEDLCAFZDEH..MBAEUBGEBEBEDBAE....eCCANHDF.hAAAOFBDHDGFKBHHABDCdGHEhAAAEDCE....PHEAhABA..........hACA......hADA...,2,-40,-36,4
ELJedcXFKPHZMObRVCDGaQNgAYIBfSUTW,BFDGUGBCEFGEeCEE.dDAEFBFHKHFCHAAB.MADGRABADDIF..GGEFhAAAQAGEAEEE..hAAAfDCASEDEhABATAGFJGAA....cFGA..hACA......hAEA...,2,-33,-14,19
APCHKGEXYZfQIBeONWSaVUgRTbdLJDMcF,HDBHEDAFZBGFQGDGBABC.OHAASGEEUADERAFAdGAGLEEAhAAADGIFFCED.CGGFKBADXGDGhAAA..fDFFhABAIADCNFBF.......aCCGhAFA......hAGA...,1,-7,-32,25
RaBKeSZYWOALGgfJdIUTPMQFDXHbcCNEV,GECFJGEA.dHEFUEBEMBACDBDEHDGD.CAFE.EDHFRBCA..BAHCeCCGhAAA..SFBDhAAA..ZAGBOCAHhABAAHIDfBAG.IEEF..hABA......hACA...,1,-18,-48,30
ZOLgfdDYWBbXVIKAMFScRGQaNTHEPJCUe,SHBGREBHQEFB..TGGGHBEGPCADUACHZCGD.OBFGhAAALAAEdDAFDFDEBHDHhAEA.bDDBIFAGhABAAAHHMAIFFFHDaGDAECFBCGAG........hADA......hAFA...,2,-17,2,19
OVSEDHYaQgLZfWBPNTICKFeJbAXMUGdRc,MGECGCEBRCCH.OFHH.ECCDDIEA.aACBLAEGZAFG.fEFEhAAABEAA.TGAAhABAIBAEKFCE.eHCChAAAABBHXDACdGAHSDGH....hABA......hAEA...,2,-35,-9,26
CaHdORFPJZcBUfKXEgTNIWSYMVeAGDQbL,QCCBLAFBCFHHdFBERCGFFAACZFED..BGFCKBDH.EGDH..TDGEhAAA..IEAChACASDACMIFAACAEDIBGhABAaFCBPADA...cCEDfAHGhACA.....hAHA...,1,-29,-33,4
WKQTLeJIcPEZGgdaFOSUXVHBNYCRMfAbD,DACBQGBCLHCAeDFD..JDDDPCBGEEBD..ZAEFdFAGFEGDhAAASEAE.hABA.XAGEBEHBCHHEMAAHhABAAHAA.KGEAIHHA...gBCHhADAaEDH..hAGA...,2,-40,-18,22
KGRDOLZbWEYXMeQAPTcVHNdIJaSBFCfUg,TCBCVGFG..dEDGJEDGBCBF..CDGEUGAHKGBBRADA...DEIHLDCChAAAZAAE.EAGEXBFChAAA.MHFEhABAAIDAPCFA...NCAC.IFGDFEFE.hABAfEAB.hACAOAFG.,2,-29,-18,11
KANfSVIMPTDXgYWQLJOdRceUFGaBHZCEb,SHBGVFAC.MFEBTAAF.DGGGXAAC..gDEGhAAAQGFGLBDAhACAJDADRCEAUCCAaDAABDHEhADACAHHEADEAFFAIAHGPDHD.YHEAhAEAdFCE......hAFA...,1,-1,-26,25
FNBRcZMESIWfLaXGVAPQOKgCTdeYDbHJU,QDACKDCDCEHC.dGEBDGCEHCDDFEFF.BAAE.ZAEAEBDDSGAEhACA..IABDhAAALHFA.GDGAhADAVAFHAAEE...PHDC...ODAFhADA....hAHA...,1,-8,-50,42
KRCPgdELGQIOcNYMUaDWSJTFbHXeVZAfB,KEGDCFDDdCABGCCB.OBHH..NECEUBEHDFAE..SGBGhAAAFGFEHDDC.eADCAAFABEAChAAAPBAD.EFEBLAHFhABA..IHGEMFIF..aHEChACA......hADA...,1,-23,-32,9
FGQMTfaAUOdWbCeSIRcKEPgHXZJVYLNBD,UGGDdDCDCFAD.eCDFRFDF.KAHD..EHGEHCFFZADC.JAACLCHB.hADADAAHFGBE.MICA.hABATAEHAHBHOCADSEABhAEAIDFD........hACA......hAEA...,1,-19,-37,18
fZAMNCdQOSGUJPVaKIRBLHgcbTFXEYeWD,MBFHdEGDSCFEUCGC..JHFEaCDF.KHBGBGBCLBAHHDDB.hAAA...bABCFGGEEAGAhACAeFAF.DDDHACCCQDABhADAPAFERFDA.cGDE....hAEA......hAFA...,2,-21,-18,3
BYMfVDdLRcZKTSaIeFGJOXWPAHNCQbUEg,CFDDQCGCUBDH.BHFDMDHFDBAB.RDEDZAEEKHCE....TEAEhAAAIHHE.eGAChAAAJFFB..OAEA.hABA.WDAAAIHA..NBIAEBAFgBBF.hABAfGDA.hACA...,2,-41,-25,16
TLHKfdUReaWbCQJISVgOPFcNEGMAYXZDB,ZEFHDEFALBFAKECCdCAC.eFFA..aFACCCBB..QGDGhAAASGDBOABEFAAEEBHFACED.hABABHAATEAA.UGABhACA...........hAAA......hADA...,2,-48,-19,29
URCSPJWZDOgYFXeKLEGbfMBNQdAHcTVaI,TFDHVDAG..UFFERBED..SBGG.JFADDCBAOBCBhAAAFCGFKHBALFFBhABAEFCC..fABHhAAAMCAFBDDFdAFBABBFaFHHCDDB.WDHB....hACA......hADA...,1,-20,-36,16
PRXCGITeUcHbQBNgdSZKMVLYaDJOWFEfA,XFDHCECDGGCH..eDAHHDBHBFGHdABAKGHBLBCADFGE.OAEAhAAAEAHFADFFRADF..IHHBhABA..TGAFhAAAbDEF.NAGE.SBHBMICC.aCGF..hACA......hADA...,1,-15,-22,7
EDeAXfTIVbUaLWHORQMZdFSNgPcCJBKYG,XCGCTCBC....IAAFUFECaACGHEEG.OGBAhACARCCFQAGFZAGHSGHFhADANAAE.gBEAhAEAcGGDBHAEKHEG.EFBEDFADABDE.....hABA......hAFA...,2,-27,-2,25
ECXWSFOfBZNRJcUPVbTeGgAHQDaYMKIdL,HFEEaDAB.KBEFdCHACDHC...SGADFACDBAHFREACUCDC.VFFDhAAA.....eFBGhABAgGBFDBBGMBGHhACAEDDB.OAADfHDBNAGE..PHFChAAA.....hADA...,1,-24,-26,2
OXGKYWVePJINadTfcbZgRQMSBCFLUEHAD,DECDODACKDGD...VADEJBHF...aBHHdEAA....TFDEhAAA..cBCGhAAAgGFAMABGSBBFhAFABBBECHADFDFBEGAEADECGEEE.eHAANEIE.hABAfAFF.hACA...,2,-32,-26,6
bGCDWHdYcIJXeUEMFVgZRSQLBPKOTaNfA,GGDHCAEDDGGH.dCEC...IBCHXFAGeGACMDDF.FHBEZAFBhAAA.QDAChABALCFHKDACaFFAAGIHHAAEJCHF.hACAECED...........hADA......hAEA...,1,-14,-32,18
CDWaIQXfGKRMbZVFUTJAeSBYcNPLOdgHE,BDGF..NDDGLCCEOFGBHFCGDABE.aBACQGFEGCBFMFAGhAAAZFAFFAHB.JEFEAFHGSAHBhABA.hAAAPBEE.EADA.CGACIHBFKFED.hAEA......hAFA...,1,-8,-34,26
dUQHECfAOLPeMZaBJVTIFbgGNXcWKDRYS,OEEGLEEG.MEDFBBFE.JHFE..VFABFAABGDCG.hAAA.cGGGDDBDSGAAhACAUAFGEBAGfGEChABAAGGC.PADBaBGDIBCD.hACA.NAIA.XEGAhADA.WAEF.,2,-36,-9,27
bSTcCFZIEJUDfHXAdWOLgGYeaMQBNRPKV,OCCHGECFeGEA.MDCAQGEHBDGGRAEE.KAAA.SDFEhAAACHADZEAFEABF.JAEBDEIHfEFEhACA.AIBELGAEhADAYHFGaBAH......hAAA......hABA...,2,-24,-20,4
VFGLJeEbgMBKRISDACYNQOWUfdacXZPHT,CFDGQCBCUBDH.aDABZBBH.HFFBFGABLDHHeDHB.EHFEMAEEhAAARECF.DBIFABFCOBFEhAAAdCAE...cFEGhABATGBE..JACEBBGC.IEEHhABANIBF......hACA...,2,-26,-4,22
IXCaASeJVfDPGHMdNWYUKOQFcLTEZgbRB,eFFBJFBB.DDECHBDEdEBG.....NDAEUGFEOADH.FEGELBBDhAAAEBABZFCB.RDEABHHBhABACHAG.AACE.SAGDhAAA..fFDA.MBFCKGED.hABA......hACA...,2,-33,-22,11
NXRHTWDOGeMZLJbYSEVQdKaUFcgCAIfBP,BFDGXCBCRDAAHGBEDFGB.OFGHGEAHZAFHLACG.JDEEbAAChABA..SAHFhAAAECACdAHEKFHHFFHF.CHEGAGBHIEEChACA.........hABA......hADA...,1,-11,-30,19
EeZXMYPWKSDJaUGBRfdLVcHFIgNTAQCOb,CFEEEDCDZBFA..MDHB....PADBKBEHDGAFUFAEBBCEREGFLBBBhAAAHGBAIEEDhAAA.TEAEODEGXGGAhABA.WAECaGECfAGFhABA..dGFC.FCABACAF.hACA...,2,-31,-10,21
dfOJDbeVKIPBMNcYCELTQWaZSGAHFUXgR,UCCBREFHOAFBDBAD...eEEFKCFBBFBF..MDDD.NEBA.CHGGLHCAhAAA.QAFDhABAaHDESBAAhAAAACBBHDGB...XFECdCHAfADEhABA.....hACA...,2,-41,-23,18
FIJUgRLYCdZcQXTSMbPVEGAOafDHeNBWK,aDCDHFDGBGFAFGBCJAGB..UAFBRBCA.CABE.dCAEZDGH..QDFBhAAA.SGADhABAMIACbBBE.EEHFOGCAhAAADBBG..NIDBKGHBIEFF....hADA......hAEA...,2,-43,-7,36
SBMGPdKJDfVCZEOLIAagcQWXNFReHUTbY,aHBGQCBC..XBEFFGEERBDGeBHBUGDG...TAAEhAAASEDAMADFGDEDhACAPFBDKHGGDECHCFAB.hAAAEGHHIAFGAFHF.cEGCWAHB.NCAC..hAEA......hAFA...,2,-21,-15,6
QURKFVaDGCebEZIgMHJdLTNYfPSBAXcOW,XDACOGEAUEBEFEFA...DDDCCCCD..eCFGZABCMAGFHACEdAAAhACALEEG..YEDHhAEASCAEAGABQGBFhAFAKEAFaFHD.EGGEIHCE.JAHFhAAANIEF......hACA...,1,-3,-29,26
DMcKFbBCPIYUJVTRefZAEHOXNQLgSadGW,EDBDOBDG..XGEFLDCH.aAHBdCDFDGGCMBAA.KADEBBAEhAAACBHE...YFEBhABAJCHHTGAF.eAFChAAAAHDDHCEEQGCCgEACSDEGhABAWCHH.....hACA...,1,-9,-38,29
VCLAZKNRGWIOUHEYegaPMdDFBTbfJcXSQ,ZDAGKCFCGDDEOFFBUGABEBCA...eBCGaHGEdBACBDGA..TEAAhAAAJADC..SBABhAAACFHBADHA..WHAChABAIGDF..gGEHDBID.hABA.fCFFhACAXAGA...,2,-42,-19,23
KdYfTPWcQVDSgNbRMUEBJaFGOZeHACLIX,CAFBLDACKBCH.dCGH..TCFA..PHFGQFEEhAAAVEDHDBEGSBEFhABA.NIBH.bGAG.UAAChADAEAHDJCAH.FEHD........hACA......hADA...,2,-29,-27,2
fTYGXBNVPCJOQdLFWaegRISUDcHAMZbKE,MECGZDAGEBFH..TAAC..XBAABGCG.VEFHCHGFQADHhAAAdADGFAHF.aAGDeHDEhAAARDABUEGAHFBAAIBGKFDAhACAfGAE..NDDF......hABA......hACA...,2,-18,-12,6
FcDAPNbUOSXfVRJgLBCeYGWadMKEZHIQT,...bDEGUGGD.SGAGXGGGRACDLEAEBAHG.CBCDeCGDhAAAGFAF.aBFFdADHKHDEhAAAEHCCICACQEEChABA.FCDEAEBA.........hABA......hACA...,1,-17,-24,7
ZCfNYOADVEULSbWIaBKMFPJRQcHdeXGTg,VEEEEGDDUCCA.LAAFSBFH....IAGFhACAaBBCBECHFCFGJDABRFFDHDFChADAdHCHeAHDTEACCDHG.NBBF.hAEAAHGADADC.KFHBMAIF......hAFA......hCBA...,2,-30,-7,23
EeQTPfDYMOALUBHIcFaGRSJgKVdbCNZXW,UGDEHDBHFFFERBBG.SFAHKGGG.dHCDCHBA.ZACGEGAA...eADAhAAAPDFA.DIGEMFDGhABAABIFBEED.aFHDgAGHhACA.bDEENAAFXAGB.hADA......hAEA...,2,-32,-15,17
LHDUJCFPcBIgWEOaYfdTZXRQASeGMKbNV,SHAEeHEAGFCFMBAAKAAE...VCCGDDFHUADC.CCHAFBGBhAGAPEGH.BDHF.hAHAIFCAgDBAhAIAEDABOFEF.aAGGfFHG.hAAA......hABA...,2,-30,-26,4
aOKLbUWgPCeEBTdfSDcNHXJZYRMGFAIQV,VEFHaEEDLAAE.UAEF..gECEeDCABBHEdHDFDHEAhAFAHBAH.XAEAhAAAZFCFMCHBACHEOCDEhABAKHAE....PBBBCAHAEHAGfEAEhACASGGH.NEIE....hAHA...,1,-3,-27,24
SeAMTDWPOHXcIQZVRECbKYBLGadgJNFUf,DIBGOGEAHCAD..XDFBIFECQAGERFAC.EAAFCFHFKDCHhAAALDAFdAEFJAHFUFCEhAAA.eBCFAEEETABChABAcDDA..bGDA.......hACA......hADA...,2,-20,-17,3
bMFSDLEYgKBQCPXZfVHIReTJaGWNdAcUO,UDACMDEBFEBDLBGB.EACGKAFE.CBADZGFGHGAA.RFEE..TDDChAAAaBEF...NCCD.AHDHOCCFhAAADEIH.BHBGhABA...QDGF.fDAAhACA.IFFAhADA.JAHB,2,-27,-23,4
eMVfDEaIBZXFUOTdHKCgcPRQLAbSJWGNY,JCCHGAFE.eEFAMIFADAAB..ECGHBDACZFAB.FEDDUFEDdBCEHFBBhABAKAAC.CDEB....hADAPHDCLAFAAHHA.hACA.SFGANDIA..fBDBhAEAIAHG.....hADA...,2,-30,-21,9
WXBYeUJaHOMNGZREgCfPTKIdDVFcQbSLA,BHHGeDACUFAFaACCHCEC..OFDHMECDZFEFEHEA...fDCDhAAAKBBGDFGCFEEHQAFDhABASBFAWHAAhADAXGGB.NAAH.gEGF.CFAA.hAEA......hAFA...,1,-19,-27,8
LAJDPCKgIXBacNYfdOTQUWSEVMbZFeRHG,JFCHDAEDKDDB....IBHCXAFBBEDA..aFFF..hAAANDBH.dHCF.TCAAhABAUGGGEAAEMBIDZADEFFBAeDABhACA.HFEBAACFCHHBcEGFfHAD..hADA......hAEA...,1,-27,-28,1
cENQBgIXRLWbKVFHMAdOPaDGSUYCTZJef,OCCHaHFGGAFAUGEG..CBBDZDBH..fHBBEDDDBFGA..hAAA.IACELHBGhAAAKDHFVACEFAECAHIHDIGE.hABASCHHJDDA.eCADcBGG.NBBE.hAGA......hAHA...,2,-35,-9,26
BDCAeTdIRbPaUXcWQEfZNFKHOJLMGSVYg,TAADdCFCRGFE..aHAEUACG...XFBCQCAAZFDBFHFAhAAAHDCFLEDESFAFhAAAVAFBBHDG.AABHIAEAhACAPDHB.WFFE...EBHH.hAFA......hAHA...,2,-16,-16,0
KSdRTfEIVLGQFeYXAWDaZBgCPJNbUHOcM,DGHHBCAHCEDC.JACC..UBAGHAFF..MBGFKDDAdGGD.RDGB.EGAALFAFhAAA.QFDChABAFFEEeCHDAEBEaDCBZAEBhAAA....NICF.bACB......hABA......hAHA.SHBA.,2,-29,-19,10
UgRcMCQGbHXWADSVaITYOfFBZEPJdNeKL,SEAEVDAG..aDDFTFEB.OAFGBBAAEEGD.JBGFhAAANDCDKADALHBC.hAAAUADCcCGEMDIFCGHDQBABhABAHFEDAGADDAIFIHHAfHCB.hABA......hACA...,2,-17,-15,2
TMWcIfGULOZNCXKJPBFaSERdAgDbYHeVQ,DACBHAADeHBEQEAH.TDFAMBDHIFFBGGCHOAEFhAAAZAEHCHGE.KAHDBBADaCCHEEEBhACAAGAB...YADFhAEAWEEE.UGGEXECC.FBGA.SDABhAAA..hABA...,2,-41,20,61
cMaIeEKCbfZTJRgUFPGQXYSdWLHVOADBN,DAEDBFDGMBDDeDBC.CEFE.ZGDG.RDAD.UAFBFBHB.GAAF.QGAEhAAASEGBLFFAhABAOAABAGDG.aFAHEHDAhADA.KHFA..fEEG...hAEA......hAGA...,2,-38,-21,17
fFYADScgIMVNKOPTdaCJWEXRGLQeHBUZb,DGHHSHBG..IGAAVFDHKCABOEFC..TDCEhAAAdBAFCGDE.EAGFRAFGGDBChAAAeFFEHABDBDEGZCFAFADBhABAAGGDMEABaHDE.........hACA......hAFA...,2,-31,-4,27
gYNJMWPQBLeVSDdCFUOAKGbZTIcfHXREa,GEAHTFDH...fHADRBFCEDAA.aDGD..NADG..MIDAhAAAPCCCBFBALGEAhAAASGGBdBAFCADC..hABA............hACA.FAGBAIBEKABF..hACA...,1,-12,-37,25
XLRHANeYISDOTWdBUfJGKFVQbZPMCcgEa,eGEASHBGOHCCdBAFUCECGBCA.FEFAQCAEZGDC.hAAACDCEEFAEaAFHLAHBhABA.ADADIEBFhACADBBGWAHBBAGGfAGE.KGGC...hAAA......hABA...,2,-36,-4,32
ERObFLWXcDUfKVGJPedgYMHABICSQTaZN,CBBDSEHB.QAFEZGBEEFCCOBFAFACBLDGD.hAAAXFCCDICCUGGFKFAHhAAAJDDE.eBADdCEAMIDEhABAAECDBFHC...IFAFaBBH...hAEANAEF......hAFA...,2,-33,-18,15
JFVHEMWZRNTagcPXKSGbLAOQdYfUDCeBI,QAADdHBHUAADDEECCFEFBGGF..FHGEECFGZAFB..RFACaDCE.hABA...PADBhAEASAHDLCHHADABfDFEhAAA.IHHEJFCE.MBDEhACA......hADA...,1,-36,-37,1
CLAHUbNfcYBWJPVXQgTEIFZKMaedOGDRS,UFDH..bBGF..NBEG...fCFGBHAA.JFGDXBADhAAAQCAA.TFAChAAAIAFHZEDFaBBAhABAdCFDOCHDDCIDCAFCAACG...cEAFWHAG..hABA.PHFC.EACFhACA...,2,-43,-5,38
cDOBLNZaJdYIAUbECeVGHSgfMKXRFTQPW,EGFCCEFAGCCHHAABSFFC.MECCRADEFFHB.TAACQFCAhAAA.PHAChACADHDCLFAAaBGDdAEBAGIBeAHFhAAA.gDAEfCDB....hADA......hAHA...,1,-5,-20,15
QUcSJLWEVZAFRfeBDXMIPgTOKCHaGYNdb,FCFCRFDFeCDHDAHH...MCCD..PCAEODGDKEBHHAAE.aAEFhAAAGEEBdHAB.UGBFhAAASEBDJHEGLABEhAFAEAGBAACEBHHB........hAHA......hAIA...,2,-30,-15,15
TZWfIKQaOgGRBMJbNdAFDPLEUHcVSXYCe,FHFGDEFHEEGBUGAE.HCFH..SBGDCBEEZDAE...WAAChAEAIABA.KAHFOCBGhAFAGEDEMHAA.hAAAbEBCAADA.LHEA.XAGB.hAFA......hAGA...,2,-32,-21,11
dBQVHWfDJZeXbFTLGAgYRIaSMEPNCcUKO,RAADaAFBEECE..CEGE.KDGAdDCCBFHFHFED.DHBCZACC..eEHHFGADLHCEhAAAADGE..gBBChAAASEEHNDAA.hABAODAB...WCDA....hADA......hAEA...,2,-34,-29,5
JgMacWeXYZASDfVGIHUCEPNBdLKTQbORF,SHFGVFDG.HCBDECEABFAFdHBDTEDGOADH..JAHBMCIDhAAA...aHAEeDADhAAAZBABDEEGIEHAhABACHHE.LACE.KFGF.....hABA......hACA...,1,-8,-36,28
baOPeMXVTfGUNAgRCKcYHdBSFDQLZJWIE,CFDDKHBGHAFABEDGDEAAZBDG....JCFFEGFH..aBCCOADG.hAAAMCBBTFGH..hABAUAABNIEB.AIHGRCGDdFABQEEChABAIDDDeHAC..fFBAhAHA....hAIA...,1,-23,-30,7
aFCGRUHfEYbLeXBNMOVQTDZIWPSAKdgcJ,KAFBdHBHJCEBCEHA..UEDHHGEA...EAABLEABBAEG.MECHhAAAQDBAZADD.IFAGhABASGFHAGCEaCHHhACARBAA....bAGDXEGC..NIAF.hABA......hACA...,2,-31,-23,8
KYWPFTQVeCZdXUgBfbJAHOSLDaERcGNMI,HDEDSGDBaGCHRCCFGEGAMCAB..KBEH..PBFAFFGCVBBBhAAACGAEdBBE..UBGDBGDAhAAAJEDGAAEBDDAF..EGADhABA............hACA......hADA...,1,-18,-30,12
MTKQJWdEDaNLCAScbVgXYReOFGHBfIUPZ,SHBGVAAD..XDBARFAGFAEEBHEFUFCHZFFA..TBGBhAAAQBAA.JDEChAAAEAEFDAHBaGGH.CFFCAAHC.hABA.bDAGeFHB.OEAH....hACA......hADA...,2,-24,-20,4
gReDdMTCVHGQaPWLANYBUZOSJIEbfFKcX,BFDGZADGOEHHJHBE...EDEEFAFB.KBBEXFCH.eCBHhAAAMEDG..CABC.VBGFhAAA...HCADaEAH.hADALFHBAHACNAIESGFFfGFG..hABA......hACA...,2,-39,-22,17
PWfFHMdUTORYIgGSBCeELXcKbVZaNJQAD,DACB..fDCDFBDAdEGDUDDDREAC..IEGEGGAFBBGBhAAAeGCAECAF..XGGGhABAcAGG..KGGHVDAFhADANICBABEF..HBEBMAIFOBAA...hAEA......hAFA...,2,-31,-1,30
DgCPGIMLXJNWQYZBUSVdReFcaHEbfKATO,TEGDOFCHDBGH..CDECGBACLBBBJGACQGFF.hAAABEHCSABEhAEARBDBFBHDaFABEAHH.bCCBAFEA.IFEHhAFAMAAC.NIEF........hAEA......hAFA...,1,-13,-31,18
WVaIeGZDUCTPBKAHSfbLOYNQFRMEcgXdJ,HDAGSHBGLGACOEFHQACD.FFGHRCBCEEGCXDFAhAAAJBFH.aBFCeBACDDIFTEDHhABABAAFAAEGfAGHhACANIAB.cEBC...dHGHICAGhACA...hADA...,1,2,-27,29
CbENgPUAIMTLRHFXBGJQWDdfeOaKYcVZS,TFDBLDAC.RFBCHAAEBBHCGAADQCFEdGBGeBEFOFHDKDFChAAA....YHDAhAAAZGFGSDCDhABAEFEGNAIG.PFFAIBEHMFAHFGAH....hACA......hADA...,2,-8,-4,4
WPOHZUSfBKcDgCEFaARGYQVeTJXdLbMNI,REBHQAGHeAFH.JGAGLAAE.MEIFIDADOGEEHEFDhAAASFADKBBEDIEGECDEhABAACDFGCDE.YDGHhAEA.........hACA......hADA...,1,-12,-36,24
XTSGVBaENWLIZAYCUOeQHPdKFgbcDJRfM,UGGGOFCAQGCAdDCFFGHB.....bDEADACG.JBCGfFBHhAAA.XCDGhABASHCAGADDhACAVBFAEDAELBADAEAHCBHH......hAAA......hABA...,1,-4,-43,39
MJeQEYdVBUFabSZLTXDNWgPCAOIfKRGcH,OGEAKHBGGADDHDCBMBCHeABB..QEDFdHDFVBEDFHAASGFHhAAALAECDDDGNAIC.hAAA..PDHFADBH.hACAIEAH.fGAC.cGCAhABA....hACA...,1,-9,-32,23
cCZKWAaJUSPHEeOVIMgQYBRFbNdfDLGXT,aGDDUAADHAACEEHF.OEAC..IAFFQAECREBG.FGFBdBDGhABADCIDGGED.XBGAhADAcDEAKGAHAHAA.hAEASAGHVDEA.......hAHA.MIAEBEED.NDHE.hAAA...,2,-23,-4,19
TAagZWNYJVREKdSXQIGUPFHcfMCOBLebD,aCFCZAAD....NEDF.JEDE.RGBA.dFAC.QBEFUAGGFBBHHGFAhAAAMFFH.BFAG.LACAhABADDCATFBF.AEAG.hAAA...gACF....hAFA......hAGA...,1,-31,-33,2
ABEDTUQJdGIcSgXVNMKePLHZRWCbfYFOa,BFEATCBFQCGH.dCDEIEEDSAFCXACEhAAAMFIB.eBHHHCAGWGDChABAfGFFFHGE.aAAEhAAAAFBDDCGDUGBHJHAA.cAFF...NCAE.hACA......hADA...,1,-12,-22,10
DZHgJONYBGbCITEePcaXdKSQWURLFAMVf,MECGDHCEHCBC.JDFCOAAE.BDGDCHAF.EGHDeFCA.aFGGXBGEhAAA.dGBASABDhAAAUADEFHFCAFFAfAGBhACA.NCEB......bEAChADAIHDG..hABA...,2,-38,-23,15
YacCbDKEeZMdIVRGXPfSOUTLJHQBNAgWF,FHBGaHBG.CEDC.DGDA..KFEGZDEE.dGGCRACGGDGA..PAEBhAAAOAHDLCAB.hAAA.HCAFBABDAIHG.YDCDhACAEAFEICFEfBGF.SFHHhADA...hABA...,2,-34,-25,9
JLFNDAVXfWGaQRCdPITUcMEbSeYZOHgBK,XFDHGAFERBBECDAGdBFH.....IBCFTGGCUFAD.hAAAEEDDbCEC..SDHHhAAAYHAAHDABhABABBHBLEEBFFGGDDDFAIEEWADEaACA....hACA......hAHA...,2,-21,-15,6
aQCBgZebXHMFTAINLDRcPWKUGOVJYEfdS,LGEARFDG..PHAEKDFDOBBG.JBAHEAGG.SCGHhAAACBGEBCFE.eBBEHFAEhAAAFGHHAECBDIDAUCAH.GBEAhABA..fDHAdFAB.aDDH.hACA......hADA...,2,-37,-10,27
UWDOHdLPTQXYVcKaBfARCFeEbgJSGNMIZ,FBBDEDCD...JBFASGFEGEGA.MDDCZEACUDEBDIGA.HGAEhAAAdDACLABC.hABAPAHH.TGBBhAAAXACB..YEFE.KBEAfBEEhAFAAIDACBCC.eHDChAGA..,1,-19,-26,7
NKbLTGYREIHOcPVWgfaJDAdBUeCXSFMZQ,dFFBUEBEeAFECHEF.FFBEZAEG..KDHHLDHBGCDE.ECDBHCAG.hAAA.OFDAPHCA.hABAVBFF...fACBhAAADAIFBACGMEABNEAA.....hABA......hAEA...,1,-8,-38,30
SPYVZUaCNFJTgXQLfBGeEKWdIHMDOcARb,RDAGSHBG..PBGDVCCHUCGBaCCA..FGGG..gFFDhAAALHFAfEFAhAAABCAEEFBGKAEDIGBEhABADGADADAH.YFDBCABCJEHF....hACA......hADA...,2,-35,-20,15
bTIgCVYeKNRaZFHEAOBXGULDQSdJfPWMc,BFFEGABHDDEBSEFGdACB..JCHBfGGC.MAFEhAAATBEHCBAG.eHCEhAAAKCHBRFDD.aEADHFAAAHCFXCEEhABALCCFWCCDIHHH...hACA......hAEA...,2,-35,-17,18
CVINSbJGcYaOMRLPQeWXHKZEgBfATFdUD,FFHBDDFFCBBA..VAFC..SCGGGFCBaEACMFAC.LGEChAAAeDFEHAACZBDDEAGGhABAfCDGAHFA..hAAAdDAHNIAF...bACB...cGBH.hABA......hADA...,1,-17,-22,5
OHCdSJTZNeXMYQGEcaIKPUFfLbWVRAgBD,BAEDDGADOBEHdEHE..TCFDZCAG..eBFAMACFGGEF.hAAAaEFGIGBH.hAAAKAHBFABDLHFAhABAVFBEAIEGCAFCJECA.XDADEFGE.....hABA......hADA...,2,-27,-18,9
ODbSePLaCKVNcGUMXBEgWAfYdZRTJQFHI,dHBHRBCDQGFGFAADHFEHOEACDBGD..eCAFaCHF.CEFG..KECFVBDBhAAA.GDGEMDHHBBHAhAAAEAEEACCF.ZGAE.IABFhADA.........hACA......hADA...,1,-16,-26,10
ASZgCbcMPJBNedOHXREKGYQFLIUWTaVfD,SCFCCFDD.MAADPFAB.BHEFdBBHOEHFRACC.KEFBhABAGBACFDDHLAEEhACAIHCDTGDE.hAAAfDAAAIGEgCEDbFBD.JFFA.NBIE..hADA......hAIA...,1,-17,-29,12
CEFYVSKQGcLJagdAHNeZbUTBOIXDRWPfM,HFDFeFBBZBACUCCCBHHF..XBGEDCEBREFA...fABAhAAAMEAAFCFC.SFFEhABAKAGE.QDAAhADA.cFBEaADCAFAH.NAFE.....hAEA......hAGA...,1,-14,-44,30
YFSUCeEOVPgfADIJaRKMTbdLcQZHNXGWB,DEFHaDCD.RAEA.KAAD..MCAAdADCLHFEZDADHCFA.GAGABHHAFHEChAAACFGC..eGBGOHAAhABA..VCAF.fAFAhABAAEEDIGGD.......hACA......hAFA...,2,-31,-22,9
AbYXPZeOLCcdFfMHgVaJUTNKIGBRWSEDQ,XCBCZFDFeEBFOAAFLECC..CDEH.FFHFHFFHaBFB.UCGHKHCEBADGhAAARACC...EDGEhABADFAFAHAH....YFAHhACA.dGFAMIAC.....hAEA......hAFA...,1,-25,-27,2
ECSeXdHYNPFgAZRJLBDbIOGMafUQcKVTW,ZDBGLFFCBDACDDFBOGAA.GCCBMFGDUACBKAFE..TACDhAAACHCF..eFHFXBFAhABAdAFHHCGF..hAAAPCAHAFCG.RGEA.IBAF.aGAD.hACA..QGDChABAWFBE..,1,-19,-21,2
NEKIWQTVfLYZcAbeMCBGHJFUaOdDPgRSX,MDEBGCCGFDBDUGFC.dAGCDDHBRCAF...XGBEKBBC.QADDhAAA.TGEHhABALHBG.ZCFEcAFAhACA...AHAHCHGA.BDFA.aGGAgADBhAAA.EEGAhABAIBBA.,1,-22,-25,3
OecWBFXRNQSDYaKbGJIAMgTLHZUfVCdPE,TFDBLDAC.UFEDCBHC.dHBBODEE.eHFABAAB.FACBXEABhAAAQCFDSCAEhABADAIHKEABJFHFADHEMAFDhACA.HGAC.fADEEECB.WFFEhAEA.....hAEA...,1,-7,-35,28
LVGUDdaZWPXYeNMfOBQFSIKCTbEHRJcAg,LFBBGBDFUGFCaHEAZACG..XGBCeDDC.MEAHBDHESBADhAAAKBAHCGAB.EEGAhABARFGBAAACDAIFdAHE..YBBEhACAfEFFFEDG.......hADA......hAEA...,2,-26,-18,8
CSPFgaMUZYXEGcQJfTDLVARdObNIBeWHK,RDEDOCCH..IBHFBDHBeBCGHACDCDAF.SFBFFBFA.hAAAMHFEZFFFEGDA.QFAGhABAfCAALEEEhACAAGCBNIEHKBEGaDHD.......hADA......hAEA...,1,-19,-25,6
eZKfPNVAcEYFMCTSBRaXIUObJDGdWHQLg,EHBGFGFHCBDBBHFD.RAAB...XDGAOAFBDGGEGCDF.dAACQDDChAAAeEAGZFBEKHCEhACA..PDBDAAGFMFAFhADASEGE.IAHB..hACA......hADA...,2,-38,-22,16
fGSUHeWFNCPOgJVcKBIbYXDMZTRdALQEa,QAADEAFBGGAFHCBBeBEDFGHBCGFE.OHDEJABA..KEADIBFChAAA..XDGEhAAAMFFCRGAEAGGDfFHEhAEASAFE.NADEVCAFBDFFDEEB..TCGChACA....hAEA...,1,-9,-17,8
UZbWDOXAQgeIadcGKJFVTPfCNREHMBSYL,QDACeGEAdCABGCEEKHBGFDDD..TEBDCFFH..EHEEBAHBhAAALGACZABADGBHOBBGhAAAAIDGaDGA.JBHB..fAFBhACANABF.MEAFSGHH.hADA......hAEA...,2,-23,-20,3
DWESVZHgYKFMGCABRIQcJOUNTXaLePbfd,RDBHQCBCOAEH.UBGA..TAFGaFBCLAADeEEC..hACAfGGFdDEEEFHHZGAAhADAgAAFFHFCMAEEAIAEhAIAcGDA.NIAB........hBBA......hBCA...,2,-15,-10,5
ZFSHfLWYaERTMCOABIPgNDXbUceGdKVQJ,BFDG..PEBEDGHFUCBBeAEDdHEFKAAF.QGDFFEECHABALBGBhAAA..hABAaCHHEHACMADHAADE.gGAChABAXFAC.cAGG.JCABfCEBhAFA...hACA...,2,-26,-26,0
XTCNQdbVZPceIAEUWOHGFYfBKMRaLgSDJ,UGBCOFBBFAFBBEHF.RBDA.aDAHLDFB.DDACJEFG.CABG.dFEChAAAZDBAeAFE.AHCDHDBChABAGGDFKABGMDCASHGEhADA..XACB...hAEA.NIDF.....hAIA...,2,-35,-16,19
ZQWYPDJVFGUHLNbBfTaKeICMRdgAcOEXS,EDCDZBCFQGFG..WCFDDBIBVCECFCHHGGDF.UACGhAAANEIE.BDDB.aFADhABAKAEF.CCAFMFAFRAFAABBE.hAFAXDAA.PHCA....hAAA......hABA...,1,-23,-27,4
QaeKcbTdRZEWCSgXHYIJAGPOFVMDBULfN,OFEFVGCC.BDAFLDFE..fEDFaGAFKFGC..TACGhAAAZACECCFB..XEADhAAAIBFCABHEFHGGMCAFhABADICEUCCF.QGGFeCHF.dAHEECDGhABA......hACA...,2,-34,-5,29
HXcdfBOGRNLCeUQKIDYgJSTVPAbEWaMFZ,EHBGaGFHZBABHAFB.dGEABBGARCCALEEAUDDC.KDAFDEGC..JACASAFFhAAA..hABATGGGAHAHMCCFcAAAhAFAOGBE..NAIE.CGGD.......hACA......hADA...,1,-8,-42,34
NWHUYGAPSXDMVcaRLKFEIgZTfdCJObQeB,XGBCDIBGMCAG...aHGEKDDC.FFGDEAADZBFCdDGD...CFHDOFFBhABAeDBDBGAGHBDH.hAAAUDABAHEF..PABEhABA...SEFFVAGFLACChAGA......hAIA...,1,-7,-41,34
AcICROKaTENGHYQSgPVJZUFDWXdbLfeMB,CFDGRDEDKBCG..EDBGHBFDQAEF..PHDAJEFDZFABFGACDFABhAAAdEBFLDHB.hAAAMICGAIBCOEGD.hABANDIG....SACEgABAWBAFhABAfDDB.BGCDhACAaCBC..,1,-19,-30,11
bZBPTXfNIaWAHEgRUFLMOYGeQcJSKDCVd,HDAGECFCUDADMAAG.GGEBQGBD..SDFFhAEAKACGVFEHZBBATBCD.NBICIHCHhAFAaDFEAAAC.FBFEhAGA.ODGD........hAHA......hAIA...,1,-8,-29,21
AaLJSOHMdRDXYQVWeEbCGBgIFKUTfNPZc,LFFBSGDBOCDHdCEFDHFG..QGABeHAA.CCFABCEFhAAAFFACUCAB.NFDB.cCAGhABA..ABHGHABChAAAMEHDXAFA.WABA.EGEF.hABA......hACA...,1,-20,-31,11
RJedYNWTDUbFIHXAaKfSCgcLBMEVPZGQO,aAFBKAFBCHACLDDC.BBCCMICG.EABCZFFH.GBACRFDG..hAAAdCCCNEEC.DDFDFAHD..hABAIDHDAGBD.SFAEhAAAcGBE.QBDCJFHF.YBAFhABA...hACA...,1,-24,-31,7
EWbgZCVXdaMFDSUJfQeBKcGYHIPRAOLNT,OEEGLDAC.ECGF..bAACCGBA..dBCBMDFADAGD.UDCE.JAEGhABAfFEG.hACABHGEcGCF.HDADhADAREACAFFCNBICTGFE.......hAAA.WBEH...hAEA...,1,-19,-33,14
ScRXPQEeKLHYbGCgBdVTNOAMafJDZUWIF,MHFGJCCHZEECUDAC..FHCERBGF...QBFDKGCCLEFGHADHhAAAGACEBABCdFAGTAEEhAAAAGIB..DCBHIGABhABA..SGEB.XDGAhADA....hAFA...,1,-23,-33,10
GTaYefNgQbKZUBLDdJEFAIXMORcPVSHCW,MFFFOFBBRCFC...VCCGHBAA.CGHFGGABaDGC..eAAFfEBDhAAAQFGBKAEA.hABABAFFDEDAEAGEIFEFhAAA.PAHB.WFCB....hACA......hADA...,1,-18,-26,8
RVFZWfYIeSGUHEPDTcCKgJdQNOXMLaAbB,RDBHFDAFZAEA....fDCBIACGGEEHHBGDDCAE.TEFEhAAACAHBKHDG..dGAEOFEHhABAMAAF.aHAEAFDBBDHFhABA..WFAASHGAEAFAcFGD..hACA......hADA...,2,-26,-24,2
BCeKPHOZADFUaJWGXQTNVSMdRcLfgIYEb,UCBFJCCHGBECQFGB..VFGDMDFAdHABREBELAEChAAA..fBGHhAAAIACA.bDADCHFDeGBGhABAKABGOHDCAIHCDICGaEEFXADB...SEGChABA..hAGA...,1,-11,-19,8
ILQRcKabBeDGNOgXEMTYfZCUHdFVJAWPS,SHBGLDACQFDERCDE.KDHDaBADBACGGEGG.OFCGhAAAEGCDMBEG.fFGEhAAACFADHAEAFACFAIAGIGAEhABAcGEA.DCFA.XCEG.hABA......hAEA...,2,-19,-19,0
MeIaXVgGbYNZUEKFHWfPcDTQBOASdLCRJ,SEEDCDGFRDBE.eACHaGBC...VAGDGFEH..bFCDZBFEhAAA.EBDBKHFEFBBBfAEChAAADEABBAHCAADELDDEhABAMIDE.gEAA....hACA......hAEA...,1,-17,-30,13
VYUIDMaPTOWdNRKSbJfGZHgFCEQAeXLcB,eFCAXDACLDCGBBBC.UACBDIGE.aDABOGBG..dAACRDFA.hAAASFGCJBDF.hABAfFAHGGDFgAGChACACHBCAHHF........hADA......hAEA...,1,-27,-31,4
gPeaOEfFIcCHRMVJSGbTZXWNdLDUQYBKA,eGEAaEED.EAECFGBE..CGBAHAAFMEBE.SBGHGACBZGFEXEEFhAAAdGACDAFGUAAE.hACABCFFKFDDgEAHhADA.OCDAfEHA...hAEA......hAHA...,1,-13,-28,15
YLdZfNaKgJFUbMXIADRPSVTeWGcHBECQO,RFDGSCFCeBGHGBAHBDGD..EDDCQCCELHAEfDBEhAAANIBH.KHGEJFFChAAAFADEMHDE.XEBChABAAGACDCIH..........hACA.PADA.WBHBhAHA..,1,-19,-28,9
HUbNOTPcZaMXKAdLWGgJIDBFSeYVQfRCE,LCCHGAFEJDBADBHHBBBAeAFC..QFABCHEFUEFA.ODHFhAAA..PHFChAAAaFEBKFGHdCEB..IAEEhABASADC..YHAGRCAFEFDFNBIE..hACA......hADA...,1,-16,-33,17
IKEPFNSBeOCGVRcdDHgUWYXTaMbfZJLAQ,KGFCEAFBFABDBAFE..OEFCGBEE.REAFdHDHDBEHUEAE..XCCBhAAAMADBZCFEACHF.QFCChAAA..hABAICAENIED.CEHE.......hABA......hACA...,2,-45,-24,21
SWXQCANMbgLHZFOGaKdVDUIBJcePREfTY,MCCALGEAFADCGDDDdCCEDDIHBHBG..JAHDeBEHRGFA.EBAD.hAAA.TFAF.SEGAhABAWADE.QGCEhACAAGCG.bCBCgEFC.hAFAOAHB.KAAC.hAGA...,1,-15,-33,18
LeEaBKcURFCMgdbVDfASWHYINOQJZGTXP,SCFCHAAD..IBGEOAABJDFETCCFLDBG.hAAAaGFEcEEB.UGGGhACACGAFdBCADIBEAHBENFAHQFAEhADA.XADAeFFCEAEERGDC.MIBChABA......hACA...,2,-22,-1,21
PJGZUBFTgOKbDISeRfdXQaNLHVWYCEcAM,JCHDZCDFBFAB.FGGHTABH..KFCADGABeAECdDDA..aFGCLABHhAAA.HCFFhADAVBECCFHAABIDMAEA.GDAEhAAAOHCE.SEAERGEE...hABA......hADA...,1,-23,-27,4
MINCfTKYcVdBQXgPWFJbeALEDSGaUOHZR,DFDCaDAFHDDFMABD.CHED.KGDH.....VACCQCGC.hAAAgAAFFGFHeDGHABIFhACAEGFCSHAChAFAUGAD.ZCCANAFG..fDCCTBFC...hAGA......hAHA...,2,-28,-13,15
DBMNdfaYQKHXACUZgFLRISPGVbEWecOTJ,CFFCZEFHFCEEREBG....SGBFGCAGEAHBeABD..OEGDhAAADAIHBCADdACA..aHDGQBEGhAAAKDDD.AEHGgGDFhACA.IFHE..hADA......hAEA...,2,-39,-32,7
RgaNZHBXbQYfICeTEWMKdASLFVJPDcGUO,SEEDLDCHVEFCDDFCGBAH.UEBDRBDEaCHFHGFABFAEXGAAhAAAQGDAIAEFhABACAAF..EHAEKAGEhACAAEEAFBBGPDHDOAEG......hACA......hADA...,1,-6,-19,13
KJWGfDNYSTUbRIaAMcQdXHCFLOPeZEVBg,QFDBHBCFLGEAeCBAVBFGBHAHKFBGJBFC....fEAFhAAADGIDSEAHhAAATBACUDEBREEE.ACFBdABEhADAXGACFDHB.PADAEGGB.....hAEA......hAFA...,2,-20,-1,19
AaMWOEXQRdPIVTBHJYgcSFbNCZUKfeGLD,aGFHOCHD..QBFDdFCE.VCBGBCGF.JDBC..gEAGhAAAFGFBCBBFKAGGGEAEhAAAABAGMADC..XEGChABARADF.IEEA.YHBEhACAcEFA......hAHA.SBCENBAE,1,-5,-39,34
SQGVWDeZLCFfJgYBTdcUbEMIRPNOAKHXa,XCCBSFAAGGAHDFDBLBDD.FAFAJEGDBHFGdDAHbAFBhAAAECEA....IABFhAAANEFEABFB.HFGBaABC.hACAQDAF.eCHBCHHG.fFEHhADA....hAEA...,2,-21,-19,2
RKCgBYXOcTLbSAHFZJdGDPVMUENfWQeaI,FDAFZDEDdBCADDGD.MFCFUFCH..EEHB......NABB.WAEGhAAAQAGH.eBCAhAAAIHDE.RDAHKBAFhABABGAHOBHDTGGDSGFHAEDA.hAGA......hAIA...,2,-42,-22,20
NcebGfWdLYXVKgRaATCUJFQZPODBMHSIE,UABHFAADQGGDOECCBBHDHFDB.SDGGEFHF.eEBChAAAGCCDdADCLAFEhACAXGCHVFAF.KAEChAAAaFGACEGC...........hACA......hAHA...,2,-26,-8,18
PBMRCDGcINdLVOTFgXYZWAJfabeUEQSKH,aDCDeDAC.EFDFQGAFKAGE.HAAFMHFGDADDGBCD.ICHHhAAAdGEGOGFCFEHF.hABAYBFCAFBE.fDHChAAASDFHBFAECGBA.NAEBLCEFhACA.....hACA...,1,2,-28,30
QTLPMAEOYaCcUZXJSfgKDGWeNHFdRIVbB,OCCHCFEDZBCB...JADHSEAB.KHBCDGCCGCFGeHBEFGFChAAAdAACRAGB..IBAGhABABFCA.LEFEhACAMHFAAIEEaEHDUAGG........hAEA......hAFA...,2,-35,-28,7
QSRaIDAFLWbXHYdTJgCGNMOUZBfcEVeKP,LCCHXCBCHBFGdADDJHFAGAAF.OFEEUEECBEAB.hAAAECHHKGBB.SHFAhABA.aFABAHAEWABFhAAAYECA.CEHENAEDfAGF..hAEA......hAGA.cGCA.,2,-40,-1,39
CIREHfdZDMBcJLOKAFTXeVUbPNGgWSaYQ,FEHBTDCHeCAB.UAGA..bFFBGBCCSAFHQAAEhAAARFBDHBAEdGFCMAHHBGBCJFHDhAAA.ODAHAGDH..hABAXCEDNAIAaBEBCHEGfFEEDEAD..hACA......hADA...,2,-19,3,22
YfRPUOZITgVELABcFebJNXdWSaKQGCHDM,FEGDeEEG..JECBdBFB.SGAEQGEGGBCADFBD.fGEHhAAAUBDDZABD.IDAGhABA..gAGChAAALHDABACFNCIC.WBHHCBAF.MAFEhAEA......hBAA...,2,-34,-20,14
JBKXZdUHWLcPFEOTCfgebVMNSQDAIaGRY,GEAHRFDFBAHDZDBBdCADHBEELBBGFHFAEHBC..OCABCFFH.eHFAhAAAMBAC.QDGAhAAAAHCDaBED.KAGAXDGGhABA..........hACA......hADA...,1,-15,-32,17
gKJOcdEGBSQMLXbPUWfCTIVNHeZADaRFY,aEAERDAGFGAA..KBAFOEFDdAECBEFA..MIFELEHB..hAAAXBAAUBBACAGF.TADFhAAA..IBHFhABAHFDFAAHHDDDCJHDAEDEFSAFH..hABA......hACA...,2,-35,-30,5
YHAIMTdJcRKDUPbgSZBfaOVFLWCNEeGXQ,TFDBJCCH..RBFEDIFGUDAF.....gDFCBAHGaFGD.hAAAFGCHLGAGCBHE.hAAAeACGQGFDhABAHEEFABAFMBBFKBCHSGAB..fFABhABAWACENEIE...hAGA...,1,-28,-29,1
HZBVTKEYMNdCfUAPeSDJLbORIaGFWQgcX,SDCDDIBGLDCBOFEGRGFE..aCBHFGGH.QAGChAAA.XACHBABDKEHDhAAAMDIHCAGFAADGeCFCJGBE.hABAIEFD.....gFAFhACAHAED....hAFA...,1,-14,-41,27
OVAdcaCUeKYZELPJNIGXFDTWbSBgfMHRQ,dAFBCFEDUBCAKGDEZEBD.LCAB..PAEG..JAACGCFChAAADFIF..TDFDhADAbECHBHBD.MBABhABAHCCCOHFAAHFHaAHDEGGFNAIA......hAEA......hBAA...,2,-26,-26,0
KfHSLVgCMBTaWNOXPdQbZEFAUGDceRYIJ,DDGBeFBBRAFA...JDDCKBBGHAACLEAA..VAFBMIFATEGAhAAA..NGAHODHBhAAAPDAE....dADAhABAZBDFEGHHAACC..........hAFA......hAHA...,2,-38,-15,23
bCYPHJUfEgBeAdRGLVTXWOaQSDFIKNcZM,dGFHRFBHLDFE..VBAHTAGAOHAEQBBCFBGA.KGFFhAAAZEDCCBEA.HAEB.fABDhAAAgDDDBGAGhADAAHIHGEGEaDHFIGDGMDAHPACGEEABWHFAhAEADGEF.....hABA...,1,-6,-8,2
VQISLBAbFHMNcgOWdZUEGTPRCXfeKDaJY,FCFCHFACMFIF..gGEGdECGZAABUGFBGADB.RDFGCABDeHBAhAAAKHAGDDDA..aAEAJCAEhAAA..VACFSFGGhACAAAID.NEAF..WAHHEEGC.....hAHA......hBAA...,2,-24,-4,20
ACacQgRZfFKVSXMWYIbTNLEBdeDJOPUHG,aEGDQCBCZAAE.FAEASCFB.MAHFIEEA.hAAATCGANIAFLEEBhABABACFdHAB.eFHBDEBFPCAChACAHFCACBACRBDEfGBHKGFA.WAEDhAFA......hAGA...,2,-29,-6,23
GKUcDdICJfYXgaBWFAQTMSRNbLOeVZPHE,TGFBSFEF.RCCBLDHHOFFAZAEEHAACKBCDDGCAdAGGCCEC..hAAAJHCCXDAGBDDHADFG.hAAAMDGD.eFBBPDABhABAEHFA...........hABA......hADA...,2,-37,-8,29
eOKZcQTMAgVUEYPJSbXGIdHFBfLDNWaRC,UFDHEHBG..JACGXCDGGGEB..dCDGBEHADBFB...NCGG.RAGFeEFAhAAAZAAH..TFAAhACAAAGH...VADEhADASBBD..ICHF.FHGChAGA......hAHA...,1,-29,-31,2
SNWVBXRGAbUgCQEMdLYcZFDeIKaJfTOHP,UCBCQGGGEFFALAECZAFCFDGH..DEEDKGHF..JHCEOGBChAAAHCBD.SBGGhABA..NEBGBABAXDDHhACAAAAACCGBMAEFdDGB........hADA......hAGA...,1,-22,-29,7
UaOgdJPTSeGHBFNWYIXQLRDfVECZKAMcb,MCCAUCBCODGDdEFE..JADC..TFBEeDDCBHFD.FGAHhAAANEEA....IAAChACALDBBDGIHEBAHCAHEABDEhADA..aGCE..gAFG.SGADhAEA.WDFFhAGA..,2,-40,-32,8
aCFDHEULAONgQcePWKbGJYBXIdVSRZMTf,OGEAQCBC.eHDAKGBHGBAABDFHdHAFSCEDREDDZADHMBFChAAATCFE.aFCFFFAGhABADAHHEACB.AHIH.gACAhAAAPDHF.WHFA.....YEFGhABA...hAFA...,2,-17,-13,4
IBReCZHgPXSFNYWJQOTdGVaEADKbLMUfc,DGHHLCCHMDDD.UAGG....IAGARGDEeABFCAAFHBEH.hADAXEAFSFAHhAEAFAAF...NEEBJFFAQACFhADAdBEE.........hAFA......hBDA...,2,-33,-25,8
RBLAdDSZPEGNWgFbOMUeKcIQXTCJfVHYa,SGCDZDAGEBFA.GCAG..NFEHFHDEOCDB.UGGBKADEQBBFhAAACEGG.hAAAVGAEaEEDLCFAhABA.AHAGDBBAWGEEgAFEMDFC..hACA......hADA...,2,-24,-24,0
KNLPMXWTEOgZDaSQUdCfFIeHJAVGBRcbY,VCBFGCCF.RAAC.....bGFENEICMFCB..XGBHhAAA.TBGFOFFBDEEAhABASBHFdFDAFEAHeBCGhACAAAAEBHGG.KEABPFFAEEFEaAEGCAHB...hADA......hAEA...,1,-9,-23,14
FLdAUCSgOEQRWDHZeTfPbXKcVBNaYJGIM,UGAFSEGDECAA.QEDCDCDCHAFDZFDBeEAG...fCHAhAAAbFGH.cBAGhABABDEHNBIG..aBDHJACEhAAAGGDDMEDH.FAGHAFGFCBAC......hABA......hACA...,2,-17,-4,13
RJcKYQdLBaEbMHTGNOIAXSfZUgFeWVCPD,SGFCUFDHeEHB.CCBA.RBCE..KBGGQEDFBFBG.EEAEMEAHhAAATBGC.GACDhAAAOCACAHIBXDGEhABA..fGGCFHAGWGAE.DABA.cDEBhAEA.....hACA...,1,-16,-35,19
fVEORLGNPgaKbACJeQDHScBdMIUXWYFTZ,CECDJFCADGHFHADA.BCHGdFAGUGDH..XCADFABH.ZDECEEDGhAAALFFH.GGAFhAAA..PADHhACAaCCFKAGCeBGDSBAFMCIB.IHHAhABAWAEH.....hAEA...,2,-47,-6,41
LCOQGdTHfVaZBYMgERXbKFUSNeDIJPcAW,LAFBOEBEdCEATDCDHGBC...aFBDZFFCBAAEMACG.RAFGKBAAhAAASFEADDBC.JCAGhACAAFHGCEGC....fHGHhADA.YEFC.EAHB.hABAFHDANIEF.PAEB.hAHA...,1,-12,-27,15
ObNRdTKBWIcHgePFYEJaMADVfSCQZGXLU,VFDGCFEDGCAE.UAGFOFAD..RDECdACATDBGBGHH..IHHEhAAAHFCBeHFGFABFJAFEhADAADDHDAAF..QDFAhAEA.XBDG....hAFA......hBAA...,1,-24,-28,4
gGPZNYFWaJEASVQTHDCIfOMXbBRLeKcdU,QCCBTFCA.DDIHCBHC..OFFCMAACBGEBRCEFLBBEKHGAdFBGhAEAUFAAGADFZCAEFHFEhAAAaHDCAGAB.....hABA............hACA......hADA...,2,-33,-23,10
SIbZRFLeaDPGgXUHEfACTcNVYdJMKWBOQ,TGGGVAAD..dBGAKFEGBGGC..OEAFSHAGZDBHFAGALFFDhAAADEEAGACEUFBHhACAEAEDACDG..CEGB.NAAE.MDABhADA..IHEERDBA.PCHF.hAEA......hAFA...,1,-13,-23,10
MBDXUKFEQagGYHVWCfSNPOdTcbZJLeIRA,BFGAXECEKBEDFDBG..aBHFGDEFHDGDCABD..SGBGhAAAOEBHdCEF..bFDHZADEhAAALBAAeGFGACCFDIGEhACAQAGE........hABA......hACA...,2,-31,-14,17
FIESNdfPVKWCBMeXUAbDgHRYZOQacTJLG,DACBHGFGRDFCZDBCQEFG.aFCEJGDEGACB.EAHBSCDChAAAfHDBKAFECCAEeFAFhAAAAIBC...bCEEgFBAhABAOCCF.......cBFDhADA.FHGE.NEAE.hAEA...,2,-42,16,58
TAaFLVJcHBdREbMGPIWZDfYgUCQKOXSeN,aEEDFDBDLFFB..VDGBHAAFBFCAEDFEGECG.IAFAhAAAWAEAZCAG.DBBGhAAAgADD.hABACBHEKFHHOCEB.eEACAEEBdHAFbGAC.MICAhACA.fGHAhADA...,2,-31,-2,29
MTLFKgdNVEeZADQCWXOaPcBHRYIJSUfbG,DEFACHHG.OFDHaDGFBHCGHCBH..RFEA.JAGHUEBDGABF.MEIHhAAAFABBKDBE..dFAAEEEAhAAAAHHFQFFFhABA..XADG.PAHD..hAEA...IHAGhAFASDEC.,1,-18,-31,13
AHCEMDaXFedYRJSLKPbcTUQNIfBWGgVZO,EBBDaCBD.FGCAdFGF.RFAA.LAEG.KFGDPAAC..TDDFhAAAUFDGQBFGhAAA..IGAEhABAfHGHBHHE........hACA......hADA.WCHBGADE,2,-39,-17,22
QWaTGFDVAYKIdbXBCSHMURLJOgZNecPfE,KHBGdHBHBAFECEBG.MEHHUCGA.LHFA..JDDBODDFhAAAZCFEeADF..fAEChABAECBDQAADhAAAaACG.FGFBAGGB..IAHDSBFA..hACA......hADA...,2,-41,-30,11
KNBVGYWebCLEdFMJgHaZIOAfcDTPXRUSQ,DACBTCGCRADB..UGGAKACHBGFCGDDHeHFALFBF.dAGHMFAGhAAAHBABaAHF.ICEHhABAAFAB..fCHGhAAAXGBHSEGGQGCE.NEAFWFEFhACACHFC.EGAF...hABA...,2,-18,-16,2
CUHJcANRXMdTbFaQZKfEeSgYGIPWODLBV,XFDHdAGDFHGEZCEAKEAB..eAAB..SGGDGEEB.IBADhAAAODCFLHCChABABHADVADDCADH.HDDGhABAJFABAAFBMICE.aCAE.EBHF.....hACA......hADA...,1,-12,-23,11
IERDYTSVXgHMaQdcGZUKPLCeAWbOFBJNf,OGEAJCAF....IDCCDIEATCAA..SEFBhAAAXCEFMFFCQFDChABAdBHEZCCHPBHHeGAEWACEhAAABBCGNEIE.EFBH.......hABA......hAGA...,1,-24,-29,5
UTLcAEXWYaHgGQCJNdVRBPSbIfMZODKeF,XGBCaHBGGBFE..CEFH.dDCCBEAE..SAGE.hAAAIFAAMBAGDDGEKFEFhAAAeFED.FCACLBEFhABAAECDEHGAHAFEQGGE....hACA.NICF.....hADA...,2,-33,-21,12
dHVgWLATaPFfGMEQBICNbOeRXcYJSZUKD,aGFCFHBGMCBHBDFB...CGAF.OAHH.RGBE.XEGE.JEEDhAAASCDD.hABAZCABDADFdAEBVCFGgEGChAAAACAF.PFCA.EABEIAEBhACA.NCCA....hADA...,1,-29,-36,7
cgaXKADTSUfJYINMGERbBdPZVQHWOFCeL,SDABUDAC..JDEA..IEECGGAFRGFABCFFZAEAHACFhAAAFBBALGEA.hABAaAABAGFADAGETGBENBIA.hACAMDIH.ECDF.dAGD......hACA......hADA...,1,-24,-25,1
YFNMAgKQcSVEZIOfXBRHLTUWDJCebPaGd,QGBCSCFCEEGFOCDC.BHHELBBEUBAD.DAADJEEBCHBE.hABA..eAFGbFBA..hAAAGDABdGGGFEBAAAHCKGHDhACA...ZAFAfAEE.XDGEhABA....hACA...,2,-27,-13,14
UJEDbZdHPBGMVeOagTCWLIFXQcNARYfSK,RAADSHBGUFFF.DEFGdAGEHDBABFBFMFDC..VDCEOADChAAA.TBAGCHDCLACEhAAAFCHFXFGA.hAIAQGDAAIEAfGBFKAGCJHFA.EFAG.hBDA......hBEA...,2,-38,7,45
TOQDZJGbLfANMcCRBHSPgEKaVeYIWXdUF,MCCARDBHBAFEHAGF.SHEAEEECKDDC.eAAC..IDAFhAAAdFBBUEFGOGFEDIAEZDBAhAAAJAHF...GABFhABALFHBAGFACDHDaGDFWGAG......hAEA......hAFA...,1,-12,-27,15
XBVLCQHOWIPAbcYNJKaMfSTUDERdeZGgF,...bAADNDDG..KABEaEDA..MDBD..SGEEDHGARCEA.hAAAdCEDZADEFHCABHBBVDGFhAAACBBGHEFAIFAA.hAEAAIBAJACEfAHE......hAFA......hAIA...,2,-33,-19,14
ROINaFbJLUdYGSDXcKABVMgeEQTWPfCHZ,BECDVFAC.MACG..eAFEEBBC.QEED..PGAAhAAACCAARABC.OBDDaAAGJCEEhAEALBADdDHA.YFEEhABASHEEDCIFXAFEACDA.TGGChAGA.fHEBhAIA.,2,-33,-14,19
QdOIHWNacPRYFTbGDAXfCeVEUBgZMLSJK,CHHGeDCHUGEGBAEA.ZCEHMBFHLBHH.KGDAODHBHABH.aABHhAAARFGBFHAA..TFABhACADAGHAIFG...fECHhADAEEAD.........hAAA.JBAHIHCHhAEA.cCBD.,2,-38,-12,26
aRbJcKHYETIeOUMdVgWZNASFXBQGCDPfL,FFAAQABHDCCHLGFCRFCG..JCFFHDFEEHCE.eBDH.MICEhAAAdEAEVAFE...hABA..gGGGhAAAWAHBAFDABDACCCCD.aACFKADC......hABA......hAIA...,2,-26,-20,6
fSaIXTNBdeJHKVZLAGCgYWEDObQURMPFc,GGDHCFDG....gFGCEEGCDBFDQABAUCAC.PEADhAAAFADCSHCChAAA.IDEBhABANECA.eAHDJCDDKAHFZFABAFFE......hACA......hAFA.OHDEMBAF,2,-20,-16,4
XIdaYCNJKSGOAfQDMbLVETegPFZBUHcWR,QAFBMCHFLCEBEBAH.eADAFEAGZDDEHGFEREFA.dAAC.CAHAJDCHKHGGOHDAhAAA.AGAFDBDBhABAbGBC......hACA............hADA......hAEA...,2,-27,-21,6
YgVFbGDSEWNMIQTJfUaXPKHZRACBceOdL,BBBDeEEGLABC..gGGGFHGAGAFGECEBMFBAQEBHhAAAJHBE.aAGHKBDDhAAA......hAFA............hAHA......hAIA...,2,-46,-31,15
ZGeIaDQXMSPgFVAdRTNOCJfLBUHYcbKWE,TCCBOAFB..CCGGLHAEHCEB..cGDGKHEEZBCF.GAAEhAAAIAFFDEAFQEFGhACASABHPBGFhAAAFHGEACEH.dHAD.REAEfHGBBEBA..hABA......hADA...,1,-15,-20,5
KRcAOVBZJbXgPSCMEQLTaFNedGDUfIHWY,OFCABEGHZGDC..XBCESECCCGCB.MAIDLCHD.hAAAaDBBNBBE.GGEF.hABADAGDfAEAhACA.IGBDYAAAKDFFADAFJHAA...hADA.PAGB.EGGEhAEA...,1,-20,-37,17
OKeGYTIAfQUbgcNZdLVEBMJHCaFRWDPXS,QCGCUCBC..bGFE..gAEFZCFDdAEGLFBDhAAABBAFMDACJCHB.CHAD...hAAA.FFHHDFEHSGBEhABAOBAHKAFAeDED.YEAEADDC.fGFAhACA..hADA...,2,-27,-25,2
UZCEWAOIYPbTMLfdFaNRDJGVgSceHKBQX,OGEA..IECD..PCECMBEALCAAhAAAFAHBRDBGDADAGAAFgEGDhABA.SHAEhACAHGAABHHEQGDAZEFA.CFADADGE....hADA......hAEA...,1,-20,-33,13
YdDcTAbWNfSKgRFQVGXaeCJMELUPBHZIO,...NCCA.KDAB.RDGBQECAGBDGeHDACCEF.EFFELAFCBGEFHAGFhAAAZFED.OEAFdACDDAAFhABAAIBA....fAEBhABA.SCAFFGBCXGGAaDGC.hACA......hADA...,2,-25,-16,9
PGKbEXIgSUOFJHRWLQDBdAVYTaCMNefZc,TFDHMAEE..eCCAZDBBGBCDEHEG.XGGESBEEFBAFHDFDhAAALGDCDAHFAIFAaABGhAAACAEB.NAIE....fDFAhBAAcGACKDADIHBF.ODBBhBCA.....hABA...,2,-13,-10,3
TdQIfMPbNcARZGEHYCBSLUXeKFDVgWaOJ,ZCADECAHHEFACEDABHHHLAHB.eDBADEGA.VAFBaAEB...TFAEhAAAdBGCQGFFhAAA.MBAANIEHABABYFDDhABASHAEKBBC..gFCGhABA.OFFG.IDCAhACA,2,-28,-9,19
dRGQTUVEeSDNIHFJcgYfXOBabMWAZLCKP,ZFEEKDABRADBQBDE.UBGDEFBASGGEDIEGHAAC.FDCCJDAChAAA....gAFDhAAAfDHEOBAEhABAaGABMAEEAHAF.CEEB.dHDB......hACA......hADA...,1,-15,-34,19
ZFDRMGbXQfNUTLOCcKIPJeaAgVdHWEBSY,VDAGdCFCEGBH.BFFFZFDHFBAG..DBEFMEEAGBBC..XADFhAAAQGDG.UBGAhAAALHAGCGGCKAEC.ICHFhABAeDADAIHE.WFGDSABFRAFF..hADAfFHA.hAHA...,1,-18,-23,5
ZENSTPBfRCAUeLYJWdMbDKXQaIGOgHVcF,UFCAeEEGLEAB.JBCEdCAH.DCGCQCGGaEAHGCEGOCDEhAAAHABCFHGE.EEGFhAAASCAGBHAGCFHA.hABAAGHFMIFA.KAGE.......hACA......hAEA...,2,-25,-22,3
WIVeFaJGdADENXfbZYUcLKgQBRSHTOPCM,DGHHXGBCZGDAUBDHKEDB..BCGEHEBD.OFFGCAEC..MCAHhAAA..IGAAhAAAeBAEFGFFaBBHdEHA.NDBB.bAFBhABA............hACA......hADA...,1,-30,-38,8
UdKARZHeSfIVXgCLBDQcYGNOWPTJaEMbF,ZBDBHDEDSAFHVFBF..XDBGLFFCBCDHDCHB.QBBBhAAAGCAC.WAFBhABATGGD.aAHFMIEChACAFABEdHBHAGHE.RFDBICCF.CAAC.NAHG..hAEA......hAFA...,1,-9,-12,3
MUVPCFfNGYTbEeKAWRLScgJZQHIBDaOXd,RFDFSDCD..gCGHQDEEBAEBaBDFdEAGUCDGCAHGFEHHhAAAGBAG.bGFAKGEAhABA.AHCALCAChACA.cCGAJABAIAGD....hAAA.DIFE.OFFAhAIA...,2,-24,-15,9
fbLYXMEIVgBQOCcAaRdTSeDGFUHNWPJKZ,aEHBTCCB..SCDBGCGCUFDGHFBH....WEBFhAAAKCBFfABBhAAALADGMAIBEFEEIAEChADABABCCCFDAHIBdHAHDIGAPAGF.bGECXGFHhAEA.....hAGA...,2,-22,-9,13
CGQaDWdYReFIZXNKMSEbJPLUTVBOgAcHf,HAADCECDGGCHDFCGdCHARFGB.eAEAFAAF.ZGDAKEEH..EFAD..JAFDUACGhAAABFAHAEDA..QFGAhAFA.aDDAIDDHhACAMCGF.SDGC...hAIA......hBHA...,1,-10,-46,36
CLYcFGfHaIBEeKdRSZNDQOVAMUPbTJgXW,UFDBTCBC..XCDELFBG.FAFDHDADaDEF.BHGF.eFADhAAAKHEGdACHRBBCZCGFDBIDOADAhABAAABFMIAA.bFGB.hACA....WBHD...CECA...hAAA......hADA...,1,-18,-25,7
MUeCEZGSFbRJgWPKNOfILdTADHXcQVYaB,DEFAXFDHQFFH..VCDEBCFCUFGHeAACZEBBFFACJACB.hAAA...PCCBhAEANABA.OAEELAFChAAAAIHA....YHAEMCAFCDGASBGGhACA....hAEA...,2,-29,-20,9
HUKMEQfegVSXOFGDcNbBaIZAWJRLTdYPC,JFBBLBDG.TAAFdFFDCAHDHBBE.KEDHMGFE.EHDGQCEEhAAAeCGFSAEChAAAODAC.DAIB.bCCCIDHAhABAACADRFBA..PHFAfGHC.hACAXGDG..hACA.FADE.,2,-32,2,34
ALEUKFTRBDGbPQONaHYIMgZXCfeVdWcJS,EAADKFHBFDEHBFBBGGBB..QFEDOAAFHCFDMEDGXCBDhAAAeCEEdCAH.JFAFAFAFTAEHhACADFID.PHFChADANAIG..IAEECAHA...WHEAhABA......hACA...,2,-31,-8,23
WcDUbMYafTZVFLSdHKGeXEIBJQOPCgNRA,DACBMFFF..aFHFZDAGLHEASCHFKDGEGADCeBDB.EGAHJAABhAAA.QGGFhACA.CGDBRFABWFDE.UDADhAAAfEFBFAGEdGCE.IAHFBBAA..hADA......hAEA...,1,-15,-20,5
BJNcPAGEMfTHSgeaFdLURZDQYOKXCVIWb,EACATFDBHEFA.SFCGeCFEdGBALAADUBGEDAGC.OEAAhACACBAF.VBBE..bFADhAAANEIA.AGHHGBDA.hADAfDCEaHEEFDFF.......hAEA......hAFA...,2,-10,-10,0
EQdXaBUfWDRcTVGIAHZeCNPMbgKOFYSLJ,HDBGZFEECBCE.MFHDKHAE.FCGCLEFC..QBDEdBEEBDABUBGAhAAAfFAD.hABADGIBRECF.VFEHAGAA.NAEB.hAAA...PABFOCCBJHBAaGHD...hABA......hADA...,1,-9,-32,23
FYPeMVQGDgaJAZHTcXdKEbLORfWNSBCUI,HBCDTCGCdEFG.EHBGLAEARCAD...fEDGSHGAhAAABBBGUBGFFGFHPEDDhABAMBABGGAHDHFGaAFBAIEGhACAXGGF.KDBEOEAHCFAEeAAE..hADA......hAFA...,1,-6,-12,6
SbUBOLgCYNVEaFDdAIeXMcGRQTJZPWHfK,eDACMFFFGAGAQEGCZFCHHAACKAGEUGCEODCELACA.hAAACEFG.YEGFEBGDaDEG.hAAAdGBEAFCC.IBEGhABA...cDAB......hADA......hAEA...,2,-22,-7,15
NOULEAFITPfWSadDBQRecMXKbZVYGCJgH,TGBC..fGDBaGGE.dGACDIDCQBDERAAFMEEEKAFGhAAAVBAF.GCGGhAAAJEAGHFDANAEHLFCEhABA.AFIHFGGH.........hACA......hADA.ICDFSHBE,2,-24,1,25
ZKfcCPBaGQVSDLOMgRXEFTWNJUYbeHdAI,ZDAGKHBGCCDABBGE.QFGCDAGELFEA..MIDERCFF.FBDC.hAAA.TEBAJAAHUFBDhABAeACFAGAB...fHEFhABAaEEH.SAFGOCHD.ECAFNADF.hACA......hAIA...,1,-28,-30,2
MeEgNRZPFCSWJUfILBaGdXOVDTAYbQKcH,QCBCKCFCMEAE.eEDEEEEB.RFCC.ZEGBCHHG...JFACUFAG.LAEEhAAABBCDdAAEOEHFhABADFIHAHAE.....hACA.bADF..........hAGA......hAHA...,1,-26,-39,13
PMaZbWQTXGAUBOIeYJLfKdHENFDVCgScR,BFEEOEEGeEABLEBDKECHHBDBFHGECCGA.....SFGGhAAAPEHDaHDEZACGQAGBhAAAXCAGAGAH.UGCEhABAJABDfCHA.dHAHDAIH.cAFEhACA....hADA...,1,-11,-26,15
QcSEdBVfCNbDXZGeIUOFPHMgALJYTaKWR,LEEGJDAC.TAEAKDGCRFCH...QGCFEAAGBACE.CEAGDDBGhAAAGEEBUAGA.ODEAhABAFFAHHAECAIFA.aCCASBBEhACA.fGGBNIEF..hADA......hAEA...,1,-25,-27,2
QINfBVbgHaTdScDFKMORLYXGePUJEZAWC,QGGG..NHBFVABDHCBFaDGGdEFG.SFEHFBFC.hAAAODDDLFAGYAEAhAAAGBDE.eAHBhABAUABDEHGEZGAGADAACEGA.BEAB.....hACA......hAGA...,1,-11,-14,3
UbdGQOfaBEHCZRFNMLPYWJAITVSceDXKg,VEFHeCCHKDFE.UGAEGCBD.QCGEaFFA.BBABEABEZBEEhAAAFEBHMAFCLAFChADA..PGCCJHEAAEED.hAEAIADD........hAAA......hABA...,2,-25,-25,0
YPdSfIKgeCAGWFENTDBVLRMaOHUcQJZXb,FGAHTGBCBHCA.LDFFaEHB.HACGUBAAQFCHJEFH.hAAAZCAAXBGG.hAAAbFDDdHGH.IFHEhABAgEACABBHEAFEDIGAMCFE..cCCAhABA.YAEH.hACA...,2,-15,-11,4
HMWSPZdaTBUeFRObNIYKGDJECgAQXVLfc,XCCBVFDF.LEBGHAABMDIF.SAGDdFHEBHEBeBHHhAAAFDEAREAB.OACG.hAAAIBAFKDCBJHFGCADGAGBAfHBFhABA.cAFE.ZFFFaAHFhACA......hAEA...,1,-10,-18,8
RbHVGKYLecMNFDCAIdaZPfUEBJQOTSgXW,dAFBaCFCZEEBUABE.BBHAOCCD..SGFE..WABChAAARDBEHCFAKGBGeHFAhAFAMIFGDFCHAHAH..IAGFhAIA..fEHEEEGA.QBDChAAAXBGA...hBAA...,1,-28,-37,9
AaFNbfGRYXecDgVQKTJWIdCZMSELHBOPU,aAFBFHBG......NAEAGBBEXEFGDFFCVBCD..QGEChAAATGDB.IDFFhABACCHBSEAF.hACAHEBFBBGHPAADAGIHfAFAeDFGcGGChAAAKDAD.....hADA...,1,-5,-38,33
REXKfIbYBVQNMTLdgCDZaOGHWScUPFeJA,XCCBKHBG..fFAA..bCFAVBCGMGAAdEAFCHGGZGCEhAAAODFCHADGSHGAhAAAUEED.eFDAhABAABAFIAHABHDB.TDAGDHFAaCGA...hABA......hACA...,1,-17,-20,3
aEeCPNOGbLWTJVBdHIfDFAMUgXcRQZSYK,UFDBXCBCRCCEZCGFKEFG....aBEGCHDAOFBHGCAC..LAAEhAEAJAEBBGGAdHGB..hAFA.IHAEFACFMBABhAAA.QAGFEAGE.NGCB....WDHBhABA.....hAIA...,1,-19,-29,10
aTbQXSgAJHFVOcMYdLUGEPCKNfDeRIZWB,JDCHFDAFOEDB..MFEFdGFEUBGCEAAHKAHB..DICARCGHZGFGBCBBhAAA....aBCATEGFhABAQGAB.hACASAFDAIHGHACAcDDF....hAEA......hAFA...,1,-29,-34,5
TRGfJSQNMOWeEYcHgaZPVBLUbKDAFCdIX,FEHBdEGD..TGBAREBDGAFG..JBEHQBAEOGDA.EFABHAFDhAAAZEDBBADAUCAFKHDAhABACGFB.XDCD.hAAASHGANIDDeCCE.......hABA......hACA...,2,-19,-14,5
OPITbEMeDSGfVACYZHgaXQdULKcRFNWBJ,ZDBHHDAGaAFCXDGD.dGBGKCCEFABHBAAEOFFB..IEAGhACAEBFCMACCDIEESGDHhAAAGDFGAADF.CCHEQDDChAGALDHHRGAENDEE.......hAHA......hAIA...,2,-26,-10,16
AdTaGOgNRIQYUWFSefXEBDJPHVZbMCKLc,TFCEaHAEGCBG..OBFCRGDE.QGADUBGHFBDBeEDAhAAAfHGHEABF.JEAGHFGDhABAZCDFCBAFKAGC.AFBBNDAEIEHDhAAA.SADE.DFGF.hADA......hAEA...,2,-14,-5,9
BIFHaJGQeERDYMVfdgbXUONcKSWZTAPCL,CAFBLAFBBHFBHFCGJBDBGEEF..eBCFEBBD.DACE.MFIHhAAAfABBdDDD.XFBAhAAAOBGFNAICKCHH.hABASHGE..WHAEAAHFFDACaFFA.hADA......hAEA...,2,-28,-21,7
LReSfBEKgAWGMcPbIdZJONXTaDUQYVHCF,MEAE..PFBBdAFDOBDD..XEDAaABD.DACGUCFChAAAVBCBCHDFFHGCLEGDhAAAeFFFBGAEEAFAADGC..hABAWBAF...cGCD....hABA......hAFA...,2,-33,-31,2
AfYacTbZCBOPEKXNgeMVLdUDHQRWJIFSG,aHBGTCBCZDCF..BBCDOAAH..KBGFXFBCeDBBLABChAAADDIFHBECQEFHhAFARGECIEEA...SAGEhABAfGHAcFGACEEFEAGEMCID.hACAdHEF.....hADA...,1,-7,-24,17
HBSVNJTOcaGKYZfbDALFMedIQCRWEPXUg,MEGFdDCDCBCF.REAF...EFCFUFDHBGAE..SBAE.JAEEhAAAOGEC.aBFGKDBEhABAZAABDCADAIEG.eEHDQEGEhAAA..XCGAgCFF.hACANAEF......hADA...,2,-34,-32,2
XQOGSYbPKMdFJcHZCLWaDTUAfINEeRgVB,..IFDGeHFCRCADBFFF.OBHDSHCE..bCDGMACChAAA.FAHDJACGHBEBhABACFCCLGAGaFHBDFGDAGBFEAAFhAAAXCBC..QAFEPBBG.hAGA......hAHA...,2,-26,-16,10
SOLYHBTcgPEMKRfIJdCUFQNGVZaDXbeAW,OCCHLFBBBGCDTAFC....PDFAKBADRCDE..fEHChAAAJACGdFEG.FHEEQGGGhAAA.NBBG.hABAZBBFDICG...XAGBAEGEWEAD...hABA......hACA...,2,-31,-30,1
YNPfKHCdMRGFDeXWTLUOaEcSVbIZQgJBA,...NDEH.PEGHHABGCBGERCDBGGBF.DEAGXECGLBFCaFFHhAAASAAB.hABAIADFgGGBhACAAAFEKCGAFEHF.TGCEECBC.cGAC..hAEA......hAFA...,1,-16,-22,6
bcQCGRUXEYFDVJONHKaBgMSITWdfeZALP,LGEA..bAEGQEBBGDEEXCABFCHDDADGOAEEhAAAKHCEBAAEMDDG.SCAEhABAIDDHTCGFhACAdEEFfHABAFIDCAHBRFAFEGGF.....hACA......hAHA...,2,-26,-12,14
DZaRLSGCeHAPNEXVMIfOcJWbFTBdQUYgK,EHBGXFCA..IGECODFAJFFHFGGFBEFE..UBBGhAAAKCGEDEIDaAGG.LAEBhAAASAEDCBCEAAIF.NBAG.VBAFhABA..MFIBfEBAWHBG...hABA......hACA...,1,-30,-34,4
WCOaTKJZEUBSLIfDgHAXbQdFPNecGVRMY,XCGCdGFCFHCG..eDADGFEHREGB.MCBGCDFD.OFBAKBDA.JABChAAAEAGDBDED.LHFAhAEADDGAABCB.QGAChAFA..PDBA...NAAB.YAFGhAGA...hAFA...,1,-7,-44,37
HebUdDPWaLROMcAQTSJKGIZFCgYEXNfVB,QFCATGGD.SFFDKCBEZEEECGAG.EGGE....XCEHhAAANCAHBAACHAEA.hABAeEAHUEBCDDAAaBDDOHAEhACAMBIBAIAGGDEDIHCH.FAFG.fACFhACA..hAIA...,1,0,-30,30
DJaKEMSGcUILZYORgAbBPeWTdXHNfFVQC,BFDGeGEAdCABHAFAFGCFCCDBDEAG..KFDCEFGFGBDD..IHEHhAAAZFABOAEA.AAAC.hACAPHAA.XCGAhABANEDH...fACF.VDEFhACAaHFEMBBEcBBC.hADA...,1,-20,-27,7
eDaAOKXdFVQIfBUHGMNSZcWLYRJEbCTgP,KAADdFHAFAAAQBFBBGACHGDEGFDH.MAEDSCEGZDABLBCBhABARFBF.EGBFCDCGTAFEhADA..eDHBhACAaEFDAIAEOHFE..IEAFfEFBhADAcADB....hAHA...,1,3,-34,37
fYASEIeHGTMLcNbZdXaFCKWQRVgBJOUDP,SAFBeCCHHEAFMAFCLHFA..NHCFZABCaECAFACG.CBEHKAAFhABARDFGBFDD..UDFGhAHA.DICGfCAChAAAACDH..IBHEcEEC.XEBChAIA......hBEA...,2,-31,-16,15
RQYJSHDBeFNWdbPaVgGXZUOKcLAECfIMT,CFEDMCCARBFA...QBAEJECF.DGDABEHFeCFAFGGD..dFHChAAA.aAGBGAAAZDFEUEAFhABAODCAKGFBLHBEhACAEFAD.IDDESADE...hADANIBH......hAEA...,2,-41,-7,34
OVUTILFHKJZBEcbNgQWfDaeAXSCMRGPdY,XGAFMAEERECH.dDBHOCBE..TADGLEBFHEGDJGFCEBAHhAAA.....NEECQAFChABAfHEBDABAhAAAACCGCAHB.PCFA..YDFEIBBFhAIAKFFFBEGA...hACA...,1,-13,-24,11
eBHFVUDMaQTPIEcLKRfYXdONCgZSGbJWA,eFCAFBBDDBIHQAEH..TGBBEFGEKCAFREFB...XGGChAAAdCFDCAEEZDAGSHBChABA.GABEhADAWEEFAABABGEA.HBGBMAAFIDEGLHFAhADAOEAC...hAGA...,1,9,-35,44
edVIXOHFEWBZbgLKYfJSMQcTGPAaNUDRC,UGBCDFCFeFFCdEEF....XAAGFCCCBBGAZFGBLAFE.hABAKCADJCCBMHEAQGDEhACA.TADChADAAEBCRDEACABA.IAGHEFDH...bBFA...hAAA......hABA...,1,-11,-37,26
MRIJbALDCgTVaPQeEBZYOGSHNXdFcUWfK,CGHDVEFH..aBGCeBFHBBCEZDCFGFBB.HEFHdHBFFBBAUCCBKFAFhAAAMIBA..IAEAhABAAADGDAAG...TDAGhACAEAGEOAEF..NCIA.....hADA......hAGA...,1,-22,-25,3
EZNILSQWGgXKYCJAVdfBaOPMHTbFRDeUc,VDAGBFEDODBE.HAFCTGABFGHBDBBBUAAG.ZEFFLDFChAAASGDCQACChABAGADCKHEAJFAEAIFAfCGHhADAMIAA.........hAEA......hAFA...,1,-15,-23,8
EPQVdCSBIJZXeAKWTUGFcOabYLfDNRMgH,TGBCGCEBOFEG..aBGELAAFDDEEMFIBEBBE.PAEChACAQEED.CAGESBCBhAAAJEADeHEGAGHHKECEhADAWCADFHCC..YHEA.NABE..hAEA......hAHA...,2,-22,-10,12
DMBHXSdCbaePNERAITOZGVWFKYUgLcfJQ,TDACOEGHZGBG.GBCFVBCA..KGECUDBGLHEA.JEFAhAAADDGGHGAASAGGhAAACCACeAFB.NBAA.AICGIABAhADA..FEEFcAGFMEIFBBBC.hAEA......hAIA...,1,-12,-23,11
COMFKRTYcJSHbPNXVGeULIDWfQgABadZE,BEFAaEHBZFCEEGGH..CCFC.MFBE..FGAHRBEH...TBAGJBBGSHCGhAAA.HBGBhABAPECG.XGGGhAAAeDAAIHAEDDAD.WGAEfBGBhABAACADKAFC.....hACA...,1,-24,-32,8
AMYSPKCadeFbfZBWOTGQIRHNJEcDgXLVU,MHFGSHBGKEGG.dAACFBHDZBGBBAED..TBEAQECHhAAARCCFHEEAEDAGDBBC.XFAGhACALBAE.ABGHPDDAhABACDAH...aFADfGDGOHBC.hACAIHGG.NADF.hAIA...,1,-17,-21,4
AEScQGJCgaXMNTWHfVUPIDLFbeOdYKBZR,EAFBQGBCGGAFCBDCaAHD....MABENFEB.HDEDUGGEDFHFLABDhAAAeCBDOAABhAGAKCCCRBEHSADChAGA.JGDA..........hAHA......hBAA...,2,-23,-16,7
bMPHCUYKDQVRcAeIBdJGfNZOWgLaETSFX,eAFBdEGDJAAFGBAC.ZFEFOCCGLGAG.EEHBFBHB.MFFBhABACACFUCCE.DAABRGBAAAEG.hABABHGAfHGBhAEA..gEBAaHCE.....hAGA......hAHA...,1,-11,-42,31
DKWFEMXfeUdbTHOGgNZBRQAYcVCLPaIJS,VAADCAFBLFEC..aFBAJBAD..KDADFBFHEFFH..MECFeDEGhAAAUGGFdBGCHGAE.hAAAOEHF.NIDBBDCAhACAAEHEYCCH...IHDE.hADA..DAIH.WABEhAHA...,1,-8,-49,41
DCeASdgYfZcbBQLGEKUXaINVRFHWPJOMT,SAFBdHBH..fACGZCGBBCDBGBBGKGDCUCFFIBADhAAAREBAFDAA.HEABJAEE.hAAAMFDFDABF.AADCgFGAhABA.cDEELHFE.aEAHNIEF.hACAPFFACAHC...hBDA...,1,-15,-22,7
TQMLCgWISaPGcZJHeKEBYAFXUNRODVbdf,FEHBXCGCRAFD.DCBCdGEF.QACDLADACFHH...IAHGhAAAaAAHGDCF.ZEAAhABAJFDH.KCADBHHEUFFAhABANIDBOHAGVCDFTEAFMAIF.....hACA......hAEA...,1,-13,-17,4
DXJdUbTWfgCZIQBOPMGYKEHeAVaNcFRSL,VDAGaHBG..FFDALGFCDCAB.dGCDUCDE....WDFChAAACEAHQDGE.hABABGGHMIAEKCBBEAHFAAIH.hAAARADFSEEA..XAGDhABA......hACA...,1,-24,-46,22
IXReDdNOaGHPTgBKSAbEcYVMFJCLWUfQZ,EHBGVAADFDDB..LFFBUADAZFFGRADFDAFG..OHFCGDBDHCGHhAAA..PHBChAAABDBC.SBGEhACAAFED.bEGBcBAG..MGCEWAFAfCFFhADA...hABA...,2,-34,-2,32
ePAWCTUONHfEMGQJYRFZaKXDcIbLBgVSd,TGGGUDACOAGB.HEDHMFFDGBBBQDGHRDGBZGFEKAAGDCFEIDDFhAAABHAC.SDABhABA.PHBAhACAABIDCAEGEHCEFBCE.aFAC......hADA......hAEA...,2,-22,-15,7
IDXUdgEYLPJKAMSGVNaWfeRCBbZQHOTcF,MEIBSGFHGCBG..VDACaCAB.eEGBRGDCCEEH.ZGBEHBFA.OBDFhAAATAAFFFAFDDFFdABBhAEAEFCC.LADChAAAJEGFAIBE.NCICBAHC........hACA......hBEA...,1,-5,-13,8
YIZbKQOfLADMdBUWJcXNTCVFGPEaeHSgR,dCBDUGGGJFCB..XDAC..TGFGCBFAGDEH.EBCFeEHDhAAA.SBAChABAREBAZGAAKAAC.OFADADDC.hADADAFAMAIBBEEE.cADF...NDEH.hACA......hAIA...,2,-37,-21,16
UVcPZbWEHOXRDCQMKGeBgYFfdTJNIaLSA,VEFHZAADEEFG.HDBARADA.QAFEKGDDBBHD.FGDHdCBF..JFADaABGhAAAAAEE...UEAFPCCAhAAA...WFFAhADADIGEMEIH.........hAIA......hBAA...,2,-38,-18,20
BDVgYAEfbZLFaSHOTUNIPWMXKcRdGQJCe,EHBGZAADLFFCFDDB.HCDGOCGBUEAG..ICAFMAFEKHGEhAAARFGFdAEGGACF.CHBGBDGHhADAgABEAGGEaHCA.hBAATAGA.PFED.....hBHA......hBIA...,2,-19,-11,8
GWAYgLVZOXNCSMBPdRbJHDfecIFQaKETU,LGEAVDBG.XDBCSDGD.BBHARGAAJAABHFAB.DIFEhAAAeDCEFADHKGCEEDGETEFHhAAA.GAEFhACAAFAFYBAD.gFGA...hADA......hAEA...,1,-14,-24,10
UFWRKPMdZSQTgVYIbNfCBaAcDEGJeOLHX,DGHHEHAEGCACeCACHBEGUGGBFFEB..KEEBMAEEZCCD..QGDHhAAAVFBB..bAAGCGCCBADDhABA.AFAF.JDDC.hACAOHDE.........hAEA......hAFA...,1,-16,-25,9
GaeCScYTDNJBAfZKMIPQgVWHbXEdORLUF,ZDAGKGFHMGBCQFDH..VDEDHBGF.XGGAEBHH.RFABLABHhAAAUABHaCACeDHHhAAAcDFCDAGGBADCABFC.hACA.IEBF.PHBE...hAFA......hAGA...,1,-13,-17,4
RAaXCeGHIWQEPJcMNFdSVLUBKOYgbTfDZ,aFFBCFEEHBED..QCAFEBBC.JHFEMEBH.FDHHSAGChAAALDCHKHGEOEDFhABA.gCGChACAfHCBDFCDAEGB.XBCFIAHAPFABNAAA.hABA......hACA...,1,-11,-30,19
DBAPETUOaQeZGcNgXbSFKfMLJYCWHRdIV,TGBCUGGDQABA.ZDDFGAAF.cGGBNBGA.XDFGhAAASAHDKECCfFAFhABAMDHBJFAECADA.hAAAWAFA..........hADA......hAEA...,1,-26,-29,3
ZdYBCWPLUXERAgJeTcfVFMSHaOGKbDNQI,JEEGeDAC...TAACVACG...MFHBHBFGOCEBKHFADGBAQCGBhAAAdHAHBBAA.CGFHLHBAhACAEDDA.REACAAGFhADAfFGFSADAaGDD.....hAEA......hAHA...,2,-31,-11,20
STbFOEZDaMKBReVXLNfJcCWgQUYPdHIAG,SEABFGFCZBBADEBA.KDECBACA..eAHDLFCDJGEG..CCAF.hAAAQEGAUECEdABFADCGhAEA..TBGEEAFFMIBEhAFAXCAC.NAFE.WFFE....hAIA......hBAA...,1,-28,-33,5
dHKCGgNQOMaRLETFIUXJSYcBPfAZbWeDV,ZAADeGEADCGHdAAFKECDCFEF..GAEF..QFFFMDIHLFAEhADAECDDFFABUBBF.XCEChAEASBHBBHCBhAFAAIHA....WEHH.....HAEDhAAA.OHCEaHFE.hAHA...,2,-27,-17,10
AcHDbCKQdgZLPRMEJUGVNeXYfaBOSTFWI,DHCEKEGDdCAFLEGFRBGF.MFIBEDDF..GABHeBAG...XFCEhAAAfDAD.BFEDhAAASFHHFACGICGChABAAIDGbEAB.CDDDQGAE.PAFAhBEA.....hABA...,1,-17,-30,13
FJcQHGBLdVKPRDaESeCZMUNgfTWOIXAbY,FHBGJDACHAEGLECEKBAE.RAFE..DBCEEFDG..CFDF.ZCFA.MIBGUGGEhAAA....fHGBhAAAOCGHAHFE.bFAC.hABA.QCAFBEHG......hACA......hADA...,2,-38,-22,16
YCTREZBJMIacVefbXLQWONFPHGUDgdSAK,CFEDEDAFBGCC..JEFHMBEA..aFCCeABA..XAAChABAQGGE.OCDHhAAANHBHHCCDDICASBGAhACAAAGATCAGZFABIAGDfCED...hADA......hAEA...,1,-25,-31,6
SHAYUBcOZDVINEKGFJQPbRCXgeadTWLMf,BHHGOFBBZFAHDEID..VECBECFB..KHDCFACH..QACGhAAARFFA.CCHC.XAGHhAAAaEEDdBAGLAFEhABAMDAGHBEB.ABAC...YCDB.IHHGhAEA....hBCA...,1,-27,-28,1
GfIFLDBOKACNXYVQeUWbRZJPgHTdSMaEc,XGGGQFDHUFACRAABZDDA...JAGDHAEG.TDFFMBIDEHGAhAAAGEDA.FBAEDAEGhACA.BCEBAHFBCADCNCIGeDBFhADA....WDCC......hAAA......hABA...,1,-19,-22,3
WdfILQMRgFSDPKYAbBaJCXHVENTOeZGcU,aEGDCFFEHCCA..EAHBTEBCZFEHGACG.UEAAdAADLCHFhABA.QGCAhADAgGCFDGBDKDFEABEGBEAChAEAJAAFNEIA...........hABA......hACA...,1,-19,-21,2
FROIDYCcBMSZTagKeNPGdHJAWXVUfbEQL,VEFHUCBCEFCF.LFEDFGBARAFE..DCBACHADBHHGZCBG...aADGhAAAKEBA.eABGGBFAhABA.JDHBAIAG..XGDDhAAAfDDB........hACA......hAGA...,2,-35,-29,6
fbOZYAMPBXCVaHgRUJWFQTeDNKLEIGdSc,MBFHXGGG..VEFFHEDC.UDAAFBAFeFHHDBAGKBCALADDhAAAEGDGGAEFSHBGhABA..fCHChAAAbFAGOCBDAHCEBHABCHECaCHF......hABA......hACA...,1,-7,-20,13
XPGULeRIFZYfTQKNgCDJdEMBSaWOAVcHb,VGFGHAADXCCA.UDFELBADeAHDREBFFBGH.ZEBDTAEFhAAANEEB..DAIFEGGCMCBGhAAABDAG.SFEDhACAaFDFAAHD..........hADA......hAEA...,2,-32,-9,23
FHfYAUITPSVOEJMZXRQcKDNeWCbLaBdgG,UCGCTCBC..VEBGJCFC..ZGBARBBA.KAAFDFFF....eFGFhABACHAHLAFABFEGdAEHFHGAhAAA..fAHEhACAAEAD.SEDC.....hABA.EGDFMFAD.cDAChADA.,2,-38,-34,4
eZWTOPYUMQAJCVGILDSKRcdEgNfFbHBaX,JFCACBGFGECCLCHHDAFE...RCAG.EBCC....fGFHhAAAFGFEBABCXCFGhAAAeAEHZEAHTACFODAH.PDEChABAMFFEAHCB..IHDH.KAGF.hADA......hAEA...,1,-7,-37,30
cJgTWSUGeNQaOfXDFBKYRCMPZEdLHbIVA,JGEATCBC..SGABeFEF..aAADOAFHDDAFFGBCKACACHHGZBFBhAAALEAG.HDGFhAAAIBEAAIHA..hACA.cDGDWCAG........hADA......hAEA...,2,-36,-31,5
aSKeLYTFRIfANBHVOMCUPEXbgcGJWQZdD,HDBHMAGDUAABEHGG..XACG..gDCEGEECJBFFhAAAZFEDaDDDKAHFLHBEhABAFFDHRADFAFCH.NAIE.BDADOEAHhADACHHE......PCHD..hABA......hADA...,1,4,-28,32
DOGbHgCILRXKJBWAQeFUcTESZNYPdVfMa,QGGDFAADUFCB.EEBEZFFE....NDBF.dBEA.MAHHaABDDEFGhAAAODAFGADF..hABA..bDDACHAGRGCEKCCCBCGBhADAAHHE.cEEC.SEGA.hAAA......hACA...,1,-6,-38,32
XKCLABIJbadFcGQSfZUHgVDMNPWeYRETO,BAFBJGEA.aECGdDBDGAAC..SAHHUFGBHADFDCADMGCGhAAA..NCBF.eAHDEHAA.hAAAXDFAKABE.AIEA.hACAIFBF.FDFD...fEHEhAEA....hAFA...,1,-15,-44,29
UKgVJGQSECHfWANBTbIOMZdFLPRDcYeaX,TGGGOGEAZCGB.dCDEFCBELCBDDEBBeACCUGAF..KGDBJACGhAAASDFC.hABAEAACCBGC.HAFAAIEABHHEhACAIEDG.PHAC...cFFBhAAAXGDC...hAHA...,1,-26,-32,6
XLGTgIbZDKeSFNdRUCHJVYEWOcPBAaQfM,QGBCXFDBLDDEGFDF..IDEGDGAAKAAFFAED.dDABhABACCCCJEBC..EBHHOBFChAAABGGEAIHGMADA.hACAbABG.eHFA........hACA......hAHA...,1,-17,-38,21
EPXTHJKMLUCcWNZfAQaVFSgDYIBeGROdb,VBCFFAFBDCGH.BCAAGCGA.dGGDEHAE..XGDCHFFEKAAGLEAHhAAACHCE.NAFA.AEEFaCCGhAAA..SAGFhABA..IEHH.OEAAhACA......hADA...,1,-18,-45,27
ZWcMTQNYgCDRJbaPGFeHSBUEXfVLOdIKA,ZAADMCCAQDBA..NAHE.CHEDDEEFJFAH...aGBGFBADHAGDhAAABDBHEGGC..fABDhAAAOAEDKACGAFFB..hAEA.cFFBTGCF...gDDFhADA.PFHB.hAGASCFH.,1,-11,-31,20
EGZAKYLCUFMfcDPWgOHTJeIXbdaRQNBVS,LCCHCFCFUFGD.FFHD.MEAFDCHF......PCAAgEEFhAAAHADH.TBGAhABAJEED.ICEFdBGFRFABBABEhAAAEHEEAEBE.KFBD.fABCWHFG.OADAhAHAbDAC....hAIA...,1,-20,-25,5
bfSZTdRPBEceXWYKGDNCUVFJHOaALIgMQ,LGEAMCCA.QDBBSEEGTGBAdAGHBACH.EHDGXDFAhAAAKEBHGEGEDBADNBIEhABACGEBFHAAHAEF.AGACIBCHhACAfAAF.PDEA....hAAA......hAEA...,1,-8,-27,19
EWOHXRYFdMPbDCATfGBKQgVZIaLeScNUJ,TFGHGGDHQCBG.ZBDHIFDDaEGGLAFBeBDHSHEAhAAA.hAAAUCAEEBHHHFBARBFAFABAMIAEhAEADCADAHADBABAKEEEgFAH..hAFA......hAGA...,2,-15,-5,10
TWZfJDEgBLaKHGbAIXVMPUNceFRCOSYQd,VEFHUFDBeBAD.RDDA.OEBB.SABDdFACTAECZECFDIEAhAAABAEGLCGBKCDC.hAAAHBBDAEEGMFAB..hACANAIEFGGECCGA..WFHH......hADA......hAFA...,2,-36,-8,28
KEAYDTdaRbLeFIWGPHUCQcMXJBNOVgfZS,DAFBdFHARDBGeCABFBFG.GEDEHFFH..UACBCHHH..MDCCBDGDOEAHhAAA..VGAAfCGAhABAKHDAADAF.TGFGhACA...aBCAIAAFPHAC...hADA......hAEA...,1,-23,-32,9
RZUOYKSDWHFbVMLQTPeNfGdIAgcaXJECB,aHBGXGGD..CHHEZBBEUCBBKEGDDEEGHEDDFECH...MDEATBFFhAAAeAAE...fBFFhADAIHBBAGGBJEAEhAEABABCOHEESAHB.bEFA.QACDhAEA..hAFA...,1,-15,-31,16
EKTHcCMBXRJADIYbfaQSZPgUVeFLdNGWO,DACB..bDBHaEFBQAGDZGFE.UGEHVBGB.LFBBhAAAdAAFNADE.OAFGKFGC.HBDBhABACEAAMIAEBDBCJAEBABBH.hADA....IDFF.fEEEhAEAgEGA...hAGA...,1,-18,-22,4
MKHZcaSGDWUJQLbATFVXgfCYdOPeINBRE,VBCFXCBC..CDAC.OBBG.eGDABCHARBGB.EBGF.KAACZFAFhAAA.aDFBDGEG.UGAHhADAQAEGAHHB.FHGEhABAfHEFdEDE...IEBChAEA.NEED....MFFEhAFA..,2,-34,-15,19
MdDNfOcCgGRTQeBUZIYFSWKHXJPbALaVE,LDCHaEHB.EFGADHCG.OBBDCHCD.GECBQADGBBECUBGFhAAAIFEBFFACKACChABAHAAF.PCFGAHBBMFIFhAFAdFAC.NIEB.....cGEE..hAGA......hAHA...,1,-12,-29,17
MTZcRbQEIOVHKYUGaXeBSfDNWPLCgdFAJ,MAFHZEFHRDBH..QFDAEGGE..IGDBOBCEKBAEUDAGaHDChAAAeEFC.BAGASHAGhABADGAE.NADD.PBAAhAAALBHFCCHDFDDHADDC.......hACA......hAIA...,2,-28,-19,9
deRbCTOVFGQUHYEfgDKNXSWBPJLIZAcaM,aGFHeECC.RFAB.CGAA.OHFEFGCC..UDEBEADD..DAFCKBCF..XCEEhAAASBAFBFHFhABALEAAABCF.MAAEhAEATCAEQGGAfHCFNBIA.JAHBcAGBhAFAdFFE....hAGA...,2,-33,-13,20
VKYeDNbXgZRISPEUaTWLHcdGJMfABCQOF,BFFGQEBEOEDBKFFHDAHD....XAGCZCFGSCBGhAAAPAAD.UGAE.aAEBhABATGDA.HADBhAAAdEHG.JFAFAACFCHHB.FGEHeDFG.....hADA......hAGA...,2,-32,-12,20
UQJSCagOLHbRFcAeYGTWfDdXIZMEBKPVN,GECFTCBC.DBFDdEDDZBCBBCGDKHGE...VGFGUBAG..SAAHhAAAaBGC.LBHBhACARGAAADGH.eBEHfEAGhAAAMHAAEFAC.NADFCGEC......hAIA......hBAA...,2,-35,-13,22
FGXDHISPcMWAYQOeUgbCBaZKLJdERNTVf,QDACOFCAUCBBCCHABFFGZAFC..KACDdACF.EGHFRDGH...TAGFhAAAFEAH..DCGHSFDHhABAMHAG.WDCEhAFAABAH...eFCFaGGE.NCCF.fCEEhAAA.....hAGA...,1,-27,-34,7
LGVWaIbMUPNReCgKcSOAETHfXYBJQZDFd,HBCFXCBCJBHBDHFGFGHF..LAGHGCAA..aGBEMACE.UEEChAAARAFFeFEECCEF.KAADSFBChABAAFAF.EGCBhAIA.....fHFDBADB..hBAA......hBBA...,1,-25,-28,3
YgbaPKdWIMAEeVRDUNcJSfTBZGCHXQOLF,EDBDeDACDDHDUFAF..JEDDSGFG.BADAZBFBCCHBQAAAhAAAFBCB.bFDHKGGEhAAA.dHAB.MIFGAAIFRCEENCIEhADA....fAEA...hAFA......hAGA...,2,-43,-22,21
KGaXeNILAYWPfVSdDMJQCgEBRcHbZFUTO,...PGEAfEHAdACG.JHEACBFEBHCFRGACHDAEZCDB..FDFCUDGChAAAOCBAKEAE.aBGE.hABAeACE..IBHFhAEAAAGH..WBACSGABDEEF..hAFA.MIEE...hAAA...,1,-21,-31,10
EDJeANdgcFCXTWOKGfISbVRHZaMUQLPYB,dHBHFHBGCEDC..XDFC.OBEEfEFA..SFBGhAAAVBAFZAEG.aCABMHEGhAAALFHBBCEAEFAHhABADIEAeAHBADGE.gDCDWHFA.IGGEhABA....hACA.HABC.,1,-5,-30,25
KeFDOXWYVaLQGfRCUScgMPJdbNTIBEZAH,HDEDKEEDDIACOCBD..XBGDVACEaGCBLGAA.QBCGhAAAfAGCCAEGUFGHhABAgGGE.hACAJHDAdCFCNCAA.BHHGEAACABIDeDAG.WAFE.hAAA......hAFA...,1,-13,-17,4
VCLEgOXGYTbKPAaRZcBSFfJDNIHeMUWQd,RBCFBFDDFABH.JAACDFCB..HGFAUFFAdAEA.LEFE.EDCGXAGChAAA.GEDEhACATDAGKDAFAHAAaAGH.hADA..SHBAIHAEMIFE..hAEA......hAFA...,2,-35,-26,9
YXZbGQFPMTACDaLEJcBgHfSOIWVUdeNKR,CFEALEAC.EBBCBGAGHEEASAEA.OAACICFBhAAAUDGEdHAHKGCBXGEAhABAZCAE.bFBCFHGGMEIFhACAACAEaEAE..cAGC.fADBhAFAeEDC.....hAAA...,2,-37,3,40
cVeFBLbDITSGNPUOaWYQCgfHJRXZdKEMA,VFDFBDGFDFAC..SDDFGECAUBCBOABH..aAEFQBEFhAAA.gGGChACAJHFEXBGEhAAAdHADEEABMEFFeCGFbBAD.NADF......hABA......hACA...,1,-3,-37,34
EdbUPXcKTQLHIgOSBWVDMCZNaGYRAeFJf,FGDBEDCDUFAC..XDCFKAGELCBCHEFBOBAFBGFEDIGACHAGZBFAhAAA..aCGD.RAEB.hAAAAIGG...JABEdFHE.hABAPAFATGDCIEEBSFFEMABENBIE.hBAAeEBH....hBAA...,2,-20,-15,5
UfJMZXIdYPNRCAaLOVSTeKDHQBFEcGWgb,LFFBODCH.TCACKAEADHBG.BAAEEGBEGEDA..bFFEhACAfDCF.hADAMIAAIDGCdBABYAFGhAAANIDB.AHHFaFAGeBCGFDFG..gDEDhAEA.UAGEhBAA...,1,4,-38,42
ITaPLeXBbDMWZUONdFEQHGRfVcSYAgCKJ,KEGDJDAC...aFEBeBCCBAGADGDBZACD..UGADdEBGFAAFHFFEGAEEhACARDDF....fBGChAAASGHFABBDCHEEhABAIDHE.LHCAMAECNBIE...hACA......hADA...,2,-26,-26,0
UFeNdMcOYVSKHJPICDBbQfZEaXLTGRWAg,FGFCdDCDMDIHOFCD..SAFBHBCHJBFF.CCAC.DEHHBFDA.QGGHhAAAEBHHLAAFhACAGDAGAGAC..eAEEhADAcFEE.KAHHIEEEfCGA.aABFhADA......hAEA...,1,-23,-27,4
KWUIbPXAdgNJeQYcGCLfHFEVTSZBODaMR,dHBHJGEA.QCECGACGLBFCFEHF.EFACSEAF.hAAAODBDDAFGaDHBKBGBIEEFhABAXBCFADFEeCAFhACACAHEHGEG.TBACMFIF.WEDA...hAEA......hAIA...,1,-8,-23,15
gFVZMHQDJKUYNGTbRaBLSeXPOcEfICWdA,FCFCMGCEQEBBKCFC.UEFBGACGRGEC.LFHH.XCAHhAAA.OFBHhABAfBCGCAHEADIFZEFFDDAEhAAA.JHAGNICF.TAGH.aABG.BAEH.hACA......hAEA...,2,-23,-21,2
IYUQDaBZHMAdeEbJWGVORFPNSTcgLfKCX,dEEDEDCD.JCAGGBEC.OHDAFGHB.SEGD..TGBHhAAALBBGKABEXAFAhAEAIBHGQFABhAAAaEBC.BACAMBIHAEAG.eGDE.WDEEhAFA.....hABA...,2,-32,-25,7
WbeZYKIACHGRgOLaBDPQfJSMXENFTVdcU,CBGFGCBDREEB.LBHBDAAG.QAAFSCCCXEBDhABAFEAAdADF.UFGF.eFADhADAKHAAAIEG.HFCDaHDEBEFFhAEA.fAEAEHGANCHE.....hAGA......hAHA...,2,-35,3,38
HWdQANLZYcEfFDVSITUgMaeRJKGBbCOXP,LFBBZAADEEFG.DCCESDDFUGGE.MEIFeAFH.KGEHBBHHhAAAOABBHEAD.WAEBhADAAEAA....NAHE.YHEAhAGAFEEE.IGCFaADC....hAHA......hAIA...,2,-35,-27,8
IQaHbVXWJFZcTRAgPdENGfCDeLUSOMBYK,dHBHGEAHCDGBLCCDSDGFBAGFKGHD.aAADHBEH..bADDXGFAhAAA.FABCTGCGhAAAADDC.EAGCNAIEDGIHhADA...UEEFMBIH.IGAG.hAEAWFEH.cCADhACAgFAE.,2,-19,-8,11
WCTbMRLfPaBNSdZeOJHDAIUFEVGgcYXKQ,FGFCEGFHGBBG..gBDDXGCGKBFCCDDG...TDEChAAARAABLAFA.aGCDhAAASADHeEFGHEAGhACAAACGIGAB.UDGE.YBADhABAWHEGfCHEhADABHGA.dGAE.,2,-21,-6,15
dIYHZUQbCNLMAOPJGXWgSVRfeBFKDEacT,OEEGGECF..XGEESACG.RCCHBAAEKBGGDGAH.EBCAaAGFhADAdGBEHGFA.UFAFhAEACDABMBFDABFH..WDHHhAFAgAAF..fGDAFDGF.hAAA......hADA...,1,-19,-28,9
TZdMCISVbDEgHPeWBUGaQNfKOLAJcRXFY,JFBBXFDH.FABDTAGG..MDDFSDDGDAADHBEFeGEGhAAABFGAUADGQFAEhABAKABDODFGADIF..hACA............hAGA......hAIA...,2,-36,-33,3
WUQCZXKREALeDTgNbOGBMFJPYVcdfSIHa,eBFDDAFB..TABE..NDBEOEDHBAHCJFEB..VACDdGHASEAAhAAAaFED.hAAAQGAACCHDXAGGhABAKDDEAIGA.LCHF......hABA......hADA...,1,-29,-33,4
OeYaPAIWEXQCfTSGZgRMBKFDNLcdHVbJU,EHBGCCAH..SGEEGAGAZFDCRBEB.BEFDKCHD.FAEHDCDBLDBAhAAA.dBBDVFAFJFHBeDADhABAaAAC..AAIDXDAAhABA...fAFB.MFHHhACA.....hACA...,1,-20,-29,9
AXcQSEMbdLGYODZVgeWBITNFaHPURKJfC,XCGCSGFC.MFAHdEHALACG.OFGHVBDFgCAChAAAeFCHBCCAIAHGhAAAFGBEHDFAPBFAhABARDAGKGAHJEEF..AIDA.EBAG......hABA......hADA...,2,-13,-13,0
UOgeMDQIcXRSPNFCVAGKHdZbWLaJYfBET,KCAHdDAFZFDFLDFA..JHFABABEUGBEOECH..eBFAhAAADAAHQGGGhADA.XAEFPACACAGChABAVGDCADHDHDED.aDHDEEDE.TBGDMCBE.hAIAICDE..hAHA...,2,-29,-19,10
JcefHUgODIFNKLYWZSXETaPMQAdRBCVbG,BCAHVDBH.GDBC.eEFFHABEUAGDgAEHDFEB.FGFDKAADhABALHBGZDGB.SEGAhAAA.TBGEhABAMCCAAFIHCHHEbDDFJFAFODDG.IAEChACANDAA....hADA...,2,-28,3,31
becVdgQARaKEDMSCGNPUWTOZYBLfFHXJI,RFEEEDABMADCGFDD.UACGOBDHZAFCLFCFHBFC..IHEGhAAA.eHAAVCEGhAAAdBBEAHEBaBBBDECHNCAAPHFChABA....TDFABGAH....hABA......hACA...,2,-19,-7,12
TFAJXHSNLPQaZRCegIGcVBfWdKDYEUMOb,XAEGHDAGSFABLFAEaCHFZCCECEFB.eEEGGBDGBAABdAACDCHFhACAEGGEUGCF..MADEhACA.bFCEADABNAIG..hADA...PFHD......hAFA......hAGA...,2,-22,-4,18
TPUDWBLGIgEOZCaQNKJbAFRMfcSHVXdeY,RGCCMCCA..SFBAXFFG.dDBCeHBCTAEGDCAF..BAAChACAIEFBODFAaCCDKEBEhADAAABG.FAGGHFGB.PAABhADA.UAGE.......hAEA......hAFA.WDBE.,1,-6,-35,29
ERWPNYbcQCFMKVdIfSBDGTeHOgUZAaXJL,aGDDXFCALHFARDBA.....NDAG.bBAC..QBCChAAAMFABKFGAdHBFSEFAhABABHHHDAAETCFDOAEDhADAgFBHAFFCJBGF.WCAB...cFGDhACA.CEEF...hADA...,2,-24,-19,5
OVPFgLMZUdGTSWbHKYaXJceRfNACEDBIQ,CFEAEFGEBFAF..QDDBOCCH.FGECMAIBdEACGABH.hAAATCGDbBEE.KECFaGAEhABAXGBA..hAAAeADGfBAEDFDFIHEE.gGGEhACA...hABA...,2,-34,-18,16
ETbdgNAPBRIXVGYeHCfKUDJSacOLQWFZM,RDBHVEFHeAFD.HFFFCCAE.KDHFDGCD..SHACOBGF.LAAChAEAQEBHZFDBEAGBhAHAdBECAEACBBBC..IAAFhACAYBEFfCCE...hAIA......hBIA...,1,-9,-39,30
DOJYHaXGWPTRfQgScbAdFNVELBMCZKeIU,dAFBFCFCEECAMEAA.KACBUGBA..DFEAOFGFHBFFGEGE.hAAA.TABBQFCChAAASFAFABBF.LFEFhABABCADCBHA.ZAEG.IDAA..hADA......hAEA...,2,-26,-26,0
ZFSfUeQcLJgDbaPMdVYAHRBGTNIOXWCKE,RFGHGCEH..IHDEXEAH.KAEHEEBAZEEHFFDAUACC..hAAAeBBFLHBEDBGFaDDAhAAAMIFEdAEG.ABBDBEGAhABANBAC..OAHFCAHFfGGBQGAA.hAGA......hBAA...,1,-15,-21,6
OWcTIHeQAKUDJVNEYRPXLZgbSMdBCFaGf,DDFFJFBB.EHGERDEH..LAHBZDCB....bBAFSDBEhAAABFHEFHCCGAEDOBECTGGEhABAeDBHAFAD..KACCVABEhAEA...........hAAA......hABA...,2,-28,-25,3
UVMPYGdEfZKXaALSegQcbNCBWTIRJFDHO,SGDBeDACQAAB..NAEHCGBDBHDF.IHFGFDEGHCBHhAAAUGAE.MGDAPBCAhABAdAFDZADHaGHDADHGLCHBhABA.gDFAcFFB..WCAFhACA......hADA...,2,-35,-1,34
EFMJVRHedYAGbfXIPaSNgZKCDLTOUQBWc,GAFEXCBCaDCD..SGEEZDAHDFAHLEEGOFAEQACGhAAABHBFEBCH.JCHB.hAAARAFDdHBHAIDGfGHEhABA.IAEFNBAG.CABA.WCEBMAIF.hABA......hAEA...,1,-13,-21,8
OcJNZfeWRgLETCdFDAXGSPVYKQHaBUbMI,GCEBSCFC..VGFEKGEAHGAEBAFEUCCGMBDAODCBhAAA.JBAAfFBFhAAA.eHAAgEGGhABAEBAFCAEDDFGGADIDXDDD.YCAFhACA.....hABA.aDBBIHHA,2,-27,-8,19
dVMLORKaZIbGAXBHPEUSFWcfDQJeTNYCg,XGDCHDBHEAHB.UABHFGGA....fAACJCAH.TBCBhAAANDDD..CFFCdGAFMIDAhACAOECGaEEGZAEFGEGEhAAABGCASGBDDAIH.....hACA......hAEA...,2,-31,-4,27
QSLRUGbHPdfJATCEaYVgZKIFXDBcMeWON,TGAFCEFA..EDECaHEA..VAAFZCDGFABHDIBG.BEBC.eDGFhAAAOGCG.QFAEhAAASFCELFHHhACAUADEHAFCfAFEAIHGKCAF.IHEEhADAMDID.WEAC.NAHA..hACA...,1,-12,-18,6
FSTGXKPWZEHgNOQYMVdfJbADecUCIBRLa,DEFHeDACCACB.BBCALHBEFGFAGBFA.KAHDZCGF.HCBD.OAFGhAAAMCIDdFCA..hAAAbGFEAABFIGAChACA.aFEH..........hADA.SCEFhAEAXBEDEEABNIAF,2,-37,-30,7
FcUWGZPXJHeNVgQfdAESLTCYIbODKBMaR,EEEDSGDDLAAECGAA.....ICGFDEHHMDECFHEEUACGhAAAGGAHZDDC.JEAEHAFGhABAeCCA..NBBE.gEGFhAEAfFFE.AFAB.......hAFA......hAGA...,1,-17,-29,12
YEVWUFZSPcAgOQaTGBMdeDKHfRILJNCXb,ODACQFCAGGAHMABBdCFD.KFFAHFFARAAE.IHADLEFChAAAJBEGCAFA...YCBBhAAAEEDF..WHFAhACAFDEASCHH.ACAHaHFCBCDFDAFC.hADA......hAEA...,2,-23,-6,17
UaZJdbRKOWSLNMTYVIAXgfQePCBGDcFEH,XCBCQCBC.CHHEBFFAGAGA.FGGCEFAGaECCZDFC..dFAAKHAChAAASADAMDED.hABATDEFIHFGAIDGeAAFhAAAPCFADGDG...cAEB...hACA......hADA...,1,-18,-23,5
eEIYXcSDKgOfLBdGTRVNQFbJPZUMCaHAW,EDCDXCBCDFAG.KEFGOACC..BHEDdFHGGBEHTACERFCCQEEHhAAAFBHB.bGAGhABAZFAH.CGGFAGAB.IHHHhAAAYHEA.cCCASAEH..hABAfCAE.hACANAEF...,1,-6,-32,26
JWXNZALbaFIQYURSdHBOTGDCcEgeMKVfP,aDCDQGBC.RAEHHEDEBGEFGAGGDHECECAF.MCCA.KHFAfEAHhAAAJGAG.NEIGLDGBhABAFEABICAEhAAASAGHdEEDCGGBeABE......hAEA......hAFA...,2,-26,-4,22
EPVOBMLFJYfbRWSXDgTAHdCcNIZKQGaUe,CCAH..NEBB.KFDGGBCHUDFD...EHGEOECBBEHGFGBF.JEFB.hAAA...fBGChABAbAGH.RGFGSFAFhACADCAHAAIHdABB.ICCB.QAEFhADAaGAHPFDFMCIH.hAAA...,2,-27,-25,2
NFCBZQRJXDIdPMWfGASObUgceLKEHaYVT,OCCHUCBCeFAAKFHFHBGD..aBDAVEDGFABGZEFA..QABHhAAARGDGDCHH.dGAHMAFGhAAAfAFCAIHE.hAEASGEA.bADF.....hBAA......hBGA...,1,-7,-33,26
SJcWeadICDTUMLFfVYXNHAbgKZEBQPORG,KHBGBCAHQAFERFCGGAEG...JDACeAHDdFAC.CGHH.DCFD.UACGhAAAFEBG....fABEhAAAXFGEADHA.ZDDFhABAOEEE.cGAAWHEC...aHEE.hAFA......hAIA...,2,-31,-27,4
GafCQdLWbMNJZOeVRKBDHTIYFXSgPEAUc,UFGHaGAH.CBHE.QFDCLCDB.MBGFZAAE.eFHFREAB.DAAFHCAChAAATCAHFDGF..SFEHhABAPAEDAFFGfDCAhABA.dCHC.......hACA......hAEA.NIEBOAEFBEAG,2,-15,-4,11
DQLgPNcZbGXIWRMaTOdfHVJUYAFeSKECB,FEEDeEGHKHGGBAGFLAFA..PAAFZCCDGBAG..XFABhAAAIHDAMICAhACAaGCB.dDDG..fFHEhAAAJAEFAIAAEGCEDGID.gEEHNEAA.hABAWAHHOCEC..hACA...,2,-26,-17,9
WFGVEDbSRfYgCQAXdJTeIBHUacKNLPMZO,XGGDdGDDJBEC...eDBDBDCDHBCBUGGGaBGA.KHCALADDhAAAMDAFZEEEFFAC.GECFhABAEABDDCEG....hAAA.SGEAfAHECDGCTGAEIBBChACANACF......hAFA...,1,5,-37,42
RHDJAGgLEePZdMISYVbaONQfBTXcCKUWF,LFEFeCCHdGAAMDFBSAAD..VADAaBFB..OFGDhABAQGDCBCBHXGAAhACAKGGAUCGHFAAFDAFEGDEBhADAECAB.IEBC.YADBhAIA......hBBA...,2,-22,-17,5
CSEXcfaNAHBbPeZTDdLIQRFMUKVGYgOJW,BFDDeGEAZACGDBFDLABGRDEC..FAHFUFACKFCCGBAE.hAAAOHCCCHDASAGFhACAECEA...XEFAhADAaGAHAIHE.HDCC.......hAAA......hABA...,2,-38,-24,14
NYIaZFGPRbgHfOQJXdeLDTCABEcUMKVSW,EEGDMFFFKBCE..VAAF..SHCE..WCDDYBGHhAAAaBHF..FDAHRFEBHCDBhABAQGAAJCAAXEAHhACA.........hAAA......hACA...,1,-16,-43,27
PMDRXFBIScWUGZdTYVCHaKQNAOLJEefbg,JAABeCCH.....bEFEMGBC.XDCCIBHG.SDFGhAAAUAGBdHEHTEFBhAAACHDDKACAAHIFLCAHhABA.fGABDAEBBHHHWDFCYGCC.hACA......hADA.aHAE.,2,-40,-15,25
UeaQBXJCbgVASKHWGOTNcEFYLDfPZIMRd,SEHBKCFCGDDEOEAD..cGFAEGFBLABG.hAAADDIHfDCBhABAZCAAMIAAdAFFaAFHQGAEhACABGGB.XEAC.CCBF....hAAA......hACA...,1,-22,-23,1
XRJDMVPHLNbKTOCIWYdASgcFfaUGZEeQB,SHBGFHBGUDACGCGCEFCH..BDBARDDF.MEIDHAAELADDhAAAKAECCCEB...YAHBhABAAHHB..fAGFhAAAZBFDXFFBDFGH.PAED...hACA......hADA...,1,-13,-31,18
LgTPRaCecNBZKEUMWQSIXDbFdfHJAYOGV,GECFVFDF.LEBD.TACGPEBBCHEA....NAHABHHFhAAAECEFMFIF.SACGhAAADABF.FBAFdGCEhACAHDFCAAFB.OAFAaCCEcFGBKCCB...hABA......hADA...,1,-18,-19,1
NEIHKVXfCTeRBQJWOcAMgSbFYDGdPUZLa,MHFGSHBGFAEHGDDAdFCBZGFE.LBCFaABD.EAHHKCFB..hAAAXAEFTGAHBDBGhABAQDGCJDHHODAHhADAAHADYBAHDAIFNIDF........hAAA......hABA...,1,-16,-21,5
CKgELUeOXbGMVZAcYWQfHPJRSdFBTIaDN,......cFCAYFCA.QAEAHAABJFBFSHDGhAAAdGGFTDDEDBHFCFHHEDEHhACALACHUAEFeDBAhADAbEAFVAAHAHAF..fGFB..hAFA......hAHA...,2,-21,-10,11
fXPQOIbHcCZJESYVRTgeWBdaFGKALMDUN,DACGUCBC..XCFFQADE.OGEAHCDFCGBCZGBAEAAB.SHFChABARDFGeBFEBCADhAAAFFFCAEHFMFID..PAEChAHA...ICCC.JFDF.hABA......hACA...,1,-17,-28,11
GIFTaCOEYBQVMRDPKASbHgUZJfWecLdNX,SCFCHAADUAGEZCEF..JAABeEDFdECCGEEBFFBDCHEF.EHEABHHBhAAA.MCADDGABKEABhAAAAHGB...fBDChACA..cEGANAEBIHBETCCF.hADA......hBCA...,2,-29,-22,7
aVPJbOdFNfDHKBWGLgCEIAYUXZeMQcSRT,UCGCZADGMAHDQBCBRCEH..aGCDJFADdDAAFEDF..DHFGKGGA.hAAABFGC..WBHHhABA..GBEE.hACACAAEAEAB...eHBAcECFTCAE..hACA......hADA...,1,-27,-38,11
SPINCcVdWGBfJTHLDeXFgYAQRaOUZbKME,aDAFUAEGZGAGKFDE..EAGB..SHAE..IAEEhAAACCCGdGHCBHFGJBAATCDDhABALBAFDFEHFDGEAFHGOHEChACAMAAE...cGGA...WDBHhADAfBGBeDFA.hAHAgEBF.,1,-12,-39,27
GWEacLXKNZUVeFBHgTAMDdJYIPfQCbSOR,dCBDJGEA...IAGCQCAF.CDDF.SDFCGAGCEABHLFGHhAAA.XAEDhABAZEFCeFBHBADGgAEAhAAAAHEBDEGCfFFEOFABaGDHKEAB.NEDE.hACA......hAEA...,2,-32,-10,22
JSCQWbVXfLRFEedPDcNYBaGUMKZgAIOHT,OFBBTBDG..CCHG.QFEG.VCAAXGAC.fEGFhAAALAEDRAFFeDDAhABADGIDNEEBBDBA.aHGAhACAMAAEgGCBAHCD.IBBE.hAHASAFGWHDG.hAIAEEAB..,2,-26,-13,13
GgPQJeVFCNUDRXKYAIZTLdWabBESMOHcf,TFDHdDCDaAAD..BHHGMAIBHFFHGCCBQGABJGFG.FBEACDBGDGCFhAAARCFA.KGAFADAH.LABChAFA.EAFFSDBDhAAA..cDFD....hAHA......hBAA...,1,-22,-26,4
cHZEbVPSJOaeYRfdICAFXGLWNDKQMTBUg,XBCBLFEFDBHFKEFG.MDAGBCED.UGAEHAEF.EHAA.VAAEhAAASADE.aGHDhAAAYFGHRFCF.dEAAhADAIHEACDHAAEEE.WCADNEDE.....hAEA......hAGA...,2,-35,-12,23
fIcPKJVaAYFMZNCWHGReDgBXQLSEbOUTd,FGFHMECGCDAG.GCGE.eBEABFDFLCBDSBGGOGAEUCDGhAAATFDA.fGFAhAAAIBBGKGGEaABCAHHEhACAZDBB..NAED.....WHBADDCG..hABA......hACA...,2,-51,4,55
DAMbdTWYaPJERVgfSXHNUKeZLOBGFcQIC,MHFGTGBC..aDBDEAEC..RDFH...gDGGXBEFHBAHhAAAUCCFKACCeEDDLGFGhAAAOFAHBCHDFAHBIFDEhABAAIEAWADC.........hABA......hACA...,2,-22,-16,6
QILcJMTSeWOKAVNafDUGRCHEZgYPXFbdB,VDAGaHBG..UFEDRACAHFFAZDFG.....PBGFXDCGdAGBBFDAhAAAQACG.hABALFAAMCIH.TBFGhAAASFADOBABADDADCAECHHC....hACA......hADA...,2,-21,-15,6
TCgbORKGIAfHBFJeScVUYWXNMZPQLEadD,BFDDJFFB.SEEBUFBA...XGFEMECEQBBChAAALHBEaBCHDGADCAFEOBDGhAAAGBGEAGAHFEAG.VBGBhABA..YAEF.....hACA.NADF.....hAIA...,1,-22,-34,12
aLICSGdXOBJPZRcDNAVQFfbgYWMeUEKHT,FDAF..gCCBMGCEeBGFUGADHCDBaGGGCGGBGAAF.OHFChAAAPBFAZGBADEFFAHAB.hABAQCAD.hADAYFDHWAFF.EABE......hAAA.TEAASFHBhAEABDHG..,1,-5,-24,19
gMQVUFPSaNJRbDeAXLTIfBZdGKCEcYHWO,XDCHLDACTFAFBFEAZBAB..KEHFCAGC.EAAFHFAA..OGFChAAAMCIBUCEHFCFFaAFGhACAJHCGDAIDACAH..dGGF.hADA.YHCA.WCED....hAEA......hBCA...,2,-26,-24,2
GTOgQCSXDPWRYNfMEZAeLaJBKbHIVcUFd,aAABKDABHDDF..IDCCUAFFFFHHdBDBODCB..CEGASGCChACADCIDRAAE.fHGFhADAEHDAAIAC.JAHDhAEABGAA..bFAH...cEEC.hAAA......hACA...,1,-25,-35,10
GOgFLHJYNTVMSbaKEAfCIeUZdPRBcXDWQ,CFDGeDACdCAEBHBEDFCGGBGG..OEEFLFFFHCFCJHAG..hAAATADFVACCSGHDhABAaAGC.ADED.IAAAhACA.UGGF.PCCBXFAChACA......hAFA...,1,-23,-24,1
aWBZGHRJUeXPcVIYNKLDSCfFgbQMATEOd,TGGDEEEDdAADBBDG.ZDGBREABUCFB..XFADVAAC..hABA..NEDGLADBhAAADAECCGEDFBEA.QEEBhAFAMIACAIFC.OAHFaDDG.......hADA......hAHA...,1,-8,-36,28
gLPZfYKFMQCbXBcSUdADORaVNTWIJeGHE,DGADODCHRABD...aHAETDAG..IBHHJGEC.GFDDhAAAEEEELHBGZBDEKFABFEHFhABACCFCBDHH.SADAhAAAAADHNAEF..WDECeECH..PCAHhACAfBGBMIDE..hABA...,2,-37,-12,25
NZbaEFeJQUSLDcHRGVIMWBXKgYOCfdATP,TCBCZAADEFAH..FHDAQDGALBEDHEFERFECGAEB.MACAhAAABCFCKHCAOCCFdBBBAHHD.hABAPBHH...hAHA.aDFB.JECBSHGEDGIF.cGADhAAA.....hAIA...,1,-7,-17,10
IaWOBVXSTHKUGAJYdgCcFEfQLPDZReNbM,dDCDCFDGFCABQADH.DGEAeAFC.MIDEIHGB.aFDBhAAABCEG.XFFDhAAATCGGKBADAHIFJABEgFAFhABAEDDDLBHFPEHDZEBF.....hABA......hAFA...,1,-19,-28,9
EOBLbIVGXCRgAKDNMZFWeTSUfdPQHaJcY,KHFGMCHFFBBF..eCEFUDFBdGEHHEAE..aAAFJHCGEECF.BBDFhACA.LEAFIBHEhAAAXGCDCAEF..hADAACGHDDEHNBIA..TCBEfGGB..hABA......hACA...,2,-45,-13,32
aNGWFCMBZcJVdUIegLfDQSXEPATHKROYb,KDAFRFDFODAD..aDDFGAGGFDFEBBBFZBCB..JFFAUGCG..hAAAeBAFLCFEDEECSGAAhAAAEGAGAFHG..hABATFFC.....YBDEhABA.NACF.CFCB...MCCFhAHA..,1,-24,-30,6
FECGgVAcZTNMaJbLfIeUXdYDPSHBWOKRQ,TFDHMHFG..JBCCLDAB.ICGHUGBGdDFD.DBFESABHhAAABFGDKBAD.QGBHhABAFEAG.CEDCgGGChADA.ADCF.NIEFaDHDfAEFhAEAXDDD....hAAA...,1,-12,-47,35
UZKgNHADCacXMOfQdGRbBFIYVWJPESeLT,DFEAaEGD.MBFH..OFCDdCGCRCAE.BCBH.FGEHVFAD..PBEAhAAASHGE.hABALAAEUGAA.KECBhAEANEABAEFCCFHB...fBCB...hAFA......hAGA...,1,-33,-37,4
SdUgCeaNJMQVKBRLHbXGYcOfIZPFTEAWD,DGHHdFAACHFDeEFD..JBEGQBEG.KAAFRDFHLAAFhACAHGBE.GCCGOCBG.hADAIEGHFHCCABCDSGHHhAEAaDBCMBIHBAFB......hABA......hACA...,1,-25,-33,8
PEFYaeNBSRJIULCDWQdgKHOfbVGAZcTXM,TFDHMFFFFDCC..aCEAeAFG.BEGHJACCLDHDDDID.dCCAhAAAHFBC.OABEhAAAfBAFbCAF.VGAChABAACHB.XAGA.EGGDNIABIGGDhABACEEB......hACA...,1,-7,-28,21
XbGSEcVOZKaQJRTDfeWHCBNIPYdLMAFgU,UGBCXFGHGADA.EAABOFBE.aAHDQFGD.hAAAJHDADBEBeEFCHDEFBHAChABAPAEALDAAhACAAIDCgCBA.cABBVAFE.KHBCfFDBhADACCFBNBAE...hABA...,1,-1,-23,22
SKXcZFNdGCMLDBWJYQPefgRAVHIUTbaEO,VGFGUFDH....aCDGEBCEKEAEZGBE.FCAGdGGDGCEDLBHFBAEGhAAA..JABDQAGEhABAeADE..fHABhAAAAFCE.........hACA......hADA...,1,-25,-36,11
bDGOWLdUQaSKCVRTeZJfgXPHEFNcIMBAY,DACBOFEFLCFEdDCEUACGQDCC.KFGHCGHGRAFAZAEE..JGAEhAAAXGAG.EFEDhAAAFDHH...NIAB.IBAFhABABEFB.AIFG.....bBAFaDAD.hABASGDD.hAFA...,1,-19,-35,16
GDXVfNWJBYFTPgUCbaMQSceROEAHLKdIZ,HDEDLEGHKHEEdHABGADGDDAB...fCBEJAAEBHHG.TFEHhAAAUBGF...CBAFaGABhABASCCB.eFBGhAAAECGAADAF.XGCC.NIDHWAFEFBEB.hAEA......hAFA...,2,-32,-6,26
MCTSRAEGJVHbYKLaPODZXBUIQfdWNgFce,EHAEGGDHHCADKEGCaACFDFEE.BFAFUAFG.QFFAdBHA..hAAANCDE.FFBE.MAIDSHAEhAAARDDGAHEE.JABC.hABA....VBEC......hAEA......hAFA...,1,-10,-38,28
ZSDGXTKCQYEJbVILOUNeFcWgBfMaRAdPH,dCFCHGFGSAGGXCCFCAHF..QGDCJDAB.VACBICGDhAAAOBBHUEGHeCHHhAAAFCED..gGGGhABAMIBARFBCACAFDBCAGEAF......hACA......hAEA...,1,-6,-16,10
LZVBfeEPUYOSgARWCIDGXNFcbMHTaQKdJ,CFDDDCECGGEFFHAC..MIFAHCAF.QGAEdDBGLFDCBAFBEGDHhAAAPCHD.UCDDhAAAODEGSEEAhABAAABFIBCGXACA..bAFA.KFHB..hACA......hADA...,1,-4,-33,29
dKGLEXONPSCFZBbVDIUYTgHWceaRfQAMJ,dFAGKHAELEBAOFFB..SEFEFDHBZAEDBDCBDAIF.UAACTGCEhAAA...HADBhABAeFGBRABHAHHEMBGFEBGF..hADA.XFEDCDAF.......hADA......hAFA...,1,-22,-32,10
MGcIKOUfWdEgQHPCSDBJFNZAVYbTaLeRX,VAADTCBC..LCDDeHDCRBFA.GCFGKEDFUFAGdADFEGAH..hAAAQABHCEBDBHHEFHDChACAAAAAaBEH..MBIFhAGAIHHCfHFBgEEB.PDHHhADA.DIAA.NAEF..hAHA...,2,-17,-3,14
VbNQUOaJDfWCSgRdMecIBZKYEAFGTPXHL,GBDBTCGC.HGFALAFEVEAH..QEDCUGEHOCEHDDHHCCBEhAAASBBGdABF.hAEAeEAFBHADKHBAADIH.PABAhAAA...XEBD.aFFA.hAFA......hAGA...,2,-19,-7,12
LgfTUcJDPONSGZAbIeRdKaYMEHQFXVBWC,eGEARFEEKDEC.MDCCHGAAFEFBBFAF.LADGTGBE.UBAF..hAAADACBODCDSFAFhAAAAEHD.IBAGhABAaHCE.YAEC.EDBD.XBGAhADACHHEcCGA.....hAIA...,2,-25,-25,0
HIVBRCWeKEgFQPOZcadfMUJGTNXDSLYAb,HAADBFDDRDAECGEHKBGFFAFD...OADGZEFCdADGUGGG..GGEHhAAA..NEEF.SCHFhABALDCFADEGVFAFeHBEhAAAEBBB...........hACA......hAHA...,2,-31,-21,10
EcaBgFZJKfUTAXYGHMONPdVSQWeIbLCDR,XFGHGEDHOBGBdAGA.QGAGeDEDLBFFRAAD.aGDBBCEDhAAAFADBZCAAKACBfHGFhACAAIEAMBIH.NCIC.SAABhACA..IEAAbFAFDIGE..hAEA......hAFA...,1,-3,-24,21
MZQeCVGYgHIOFPDSaBbdWXfEUTJLRNcKA,MEIBQBDG.eAGBVCDEGDEHHFBBOCBHDHFABFBEdFGCXGCHhAAAEACD.JFDANDAGAHEAhAAA...CBAC.IHAEhABAFBGA..........hACA.PDAE.SHGAhADA,2,-26,-12,14
YcZdgBGNCEXFUKMOQeTVfDRIAJWSaPHLb,SDCDaCFCLAFG....bEFCZDFEdAHCBBDBCAEE.FGAGUABDhAAAOCAAeHEE.fGAGhACAIFHBABAEPBFDhAGAHDAA...cGGAgGFD.EEDFhAAAKDDBMICE...hBAA...,2,-18,-13,5
FPYXgLcMEfSdVWACQBGebKaTIOUNJZDRH,CFFGBDHHGCGAKEDE...aFEHTBEH.UBAGJDADZCCA.HEBFhAAAFBGA...XACBhABALFAEMAIFEGFCfHDDhAAASHBA.dHABAIHG.bACB....hABA......hAFA...,1,-14,-28,14
LbXHMRGDUQPeISNAJFCWBcdgZEfTVKYOa,CDGFBFDGdEADZFCGEBFH....TCGDKAGG.OHFAaDDG..LHFAhAAAXDCAHBAFRBACDFBDhAAAUACFeABE.NAEF.FGAFhABA....WFFCfDHA..hADAbFBH.....hAFA...,2,-26,-12,14
TGAEaOXLFSUNWBbdQMDKeZHYcRVCgIPfJ,EEEDaGDDLHFAFDGG.UEBEBAHB.QEBCDADHKAAB.ZAAHHAEChAAARACC.CCHF...IHHAhACAfDDDTGCEhADAAFGDSCAG.NEAE.....hACA......hAEA...,2,-29,-28,1
OTagBYRLWQbKXecHJNUVEDZPCIFfASMdG,dHBHGDDCOCDAaAHHBACBLEED.QDBHKDHDeBBHJEAHUDGFhAAA.DGIBCHGA...FBAHhABASGGEMAHH.hACA.TFBHgGBH...WAAFhAEAcFFC....hADA...,1,-22,-28,6
NZYPRDgJeXVKETBMUSQIWcafGdHCFObAL,LFBBZAADRDCCDBHH.JGFG..eEGDKBDDBEGDUGDH...QBGDhAAA..cAFBhAAAfADBHACDCFADFABFhAFAAIHE...NEEG.........hAGA......hAHA...,2,-38,-32,6
BJMRdaKHAXYeQDIbcFgCPWGOSUEfNVLZT,XDACeDACDBBG.....IFHBbEFHFBHB.CCCB.GEBBUBGGEFEEhAAAVGAEZFAE.BHEGhABAMIDEaEGGAAGF..QCEBhAAAgBDBPEHDSACCNABB..hAFA......hAGA...,2,-25,0,25
TIXDZVNEOeYdgWBMJcSaGQKbHFCLRfAPU,UCGCTCGCDGBB.ZAABECAH...eFAAdCDHBFEBMFIF..JFGHaEAEhAAAKGEF.FEDARGFA.AAAF..hADA..XACDhABAOAEC.gAFFSGDB.....hACA......hAEA...,2,-40,-20,20
DTMAadLIXUgNSKVbCGcEJOWZRHFQBeYPf,aEEDLCCH.UAGGSAFEKFAH.VACBCBEGGEEF.EAAChAAAJFBH.OCAHRGDA.hADAFGGABDBF..YAAHhACADIGAADGC.ICFH...NAIG.hAEA......hBFA...,2,-33,-31,2
gFAZCdaYXJSbeGQLTBRcHKNWMVOEUPIDf,dBBDXGBCJDFD...SCGAeFDHQAEABBBARDDBKHGEMEADhAAAOADA.EDBAIDDDhABADAHB.fBHAhACAACFCCHECaFGE.........hAAA......hABA...,2,-33,-33,0
KedXIHTZPRBSJFLEbCcaVODGMAfUQNWYg,UCGCQCBC..NCDC...gBGGeFGBdEAEHFBBTADChAAARFEDBAHESHEGhABAFAAFLACAEFAFCHGBVEFEhACADCEFAADEfFCF.YAFC.hAGAKDEC.....hBGA...,2,-20,9,29
EMbOZKRfNIVYUFAeSWDdJLcBQCHXPGgTa,SDCDDGHHdDHALDFHBGHAHCGFGDBEaADCECAA..OFEEhAAAKHAGRACA...IDDBhABAUAFEAEEE.eFAH.WGCGhACA.QAFCCBAC.....hAAA......hABA...,1,-9,-28,19
GgLOeAZEURYIWXfFQJdNbCBVcPKMTDSHa,UCCBRAAD..IHACXGCHFDHD.dEAGCDAFBDFH..VACEhAAAKHGADHEEHFDF.GBFAhACAOBFCAHHHEDDE..hAFAfACB.JFAB...bEFEMFCFhAGA.SFFGhAHAaAABeAFE..,2,-42,1,43
ALKRWJZaHbNOdETBDCVUfgXYePMGQIFSc,LDCHKCFCRDBGZEGF.HFFH.OCEDdAACBHBGDAECCCHEUFAD..XGCAhAAA.eAFAhABAPFDDGDAA.IACAhBAASFFBWBBAaAEE...NAIA..hBBA..EBDB...hBIA...,1,-15,-33,18
UQWLIFPCRSKcHOgDdEXNZfJBYGTVMaebA,UCGCQDACLCCEFBCHRGFEKFGE.HGDEDDFCdEDHEFBD.ZAEEBAFE.hAAAGDBFTGCGMEADhAAAaEGE.AHBB...IBAFhABACADF..SBACcFAD...hACA......hADA...,1,-16,-23,7
SHTLdGPFUXZMQaIfgDVNeEYAKOWJRbcCB,OCCHJFBB.RAEC.CCBCHACHLFFEGEDHFGCCZAAC..QAFFhAAAaHGA.IHGAhABADAIHeDFEEDGCACAFKEABWEAFhACABEDA..TGDA.....hABA......hACA...,2,-28,-10,18
fDRMTLZHgcWJIEXNGOePFSKaUAdbCBVQY,CFEDBFFC.QEBBDECHMDGH.LHDEHBFC....gBCChAAAJBBGXCEDOBADhABAFAABKBGCADEG.dGAA.hACAbDGFfFAA......hADA......hAEA...,2,-41,-21,20
QDGMLeBPTRCUgZAYJSFIHWKVfNOcadbXE,SDCDFCFCHFFBKGAH..VGDGOABHdAEA.EDHHQBGBhAAA.GDDFMEDDLACHhAAABBCHPGAACAEFZFBFhAGAAIHGIABF.......hAHA.fFEAhAIANDIA...,1,-8,-25,17
fgGLdaYEXeMTRQZCFWIOHBPVNKcASbUDJ,UGBCDEFH..JECDGADALFAHaHGE..EBABeBEC..TFGDhAAAZEGHCACB..FCBHIGEBhABABHDE...NAHEAAGHhACA...SDBHfCCD.YAADhAEAMDAF....hAFA...,1,-15,-49,34
ZaYgVQOfNAJeBcDPFSdWTRMCEbKXLIUGH,JEGHeAFBBBABDBBHFHEE..dAHERFCG...CFDE.EGAHKDCELEFGhAAA.UDCFHBDC.aEAChAAAVACF..fDHEhABAACIHSGGETGBFMBAF..IACEhAEA...YFEBhAFA,2,-38,-25,13
EBSdPZJRQHUaMcXWLITDeOACVbYNGfFgK,VDBH..NCCAFGDCKGEGBEGF..SAECdACGZGAE.JAABRBDHUGGEhAAA..aGHDMBIFhABA..XDEGhAAALAGBIFFA.TAGF.DIEEhACAAEFFCAFDYCHB.hAEAfDAA.,1,-21,-31,10
CbKJPfSHXIOFWaRgMdGALEYVTZcUDeNQB,EDCDTFDHUBFD...DFAGeBGHBDAFCEEBKFHB..JAAESACBhAAAHGAE.XGBDhABAFEEHRGFAdDGDAEDB..LCBHhAEA..........hAFA......hAGA...,2,-36,-30,6
CfKgQUMYELHZJcXWNdOIeDaGBPASRTbVF,TCCBVDAG..FCGEKGEH.UGGEEEEAZFGF..XCEHdGADOBCChAAADAAHBFAF.ACBHRFBAhABAfHEF.hACA.MBBALABCJAHBNADF.eHBA...hBFA......hBGA...,2,-26,-15,11
YPNTHVADWJBMQFUZIeOfdbCEXLRKcGaSg,DEFHJAFBBHEAMFAH..FBCBZEFF...eABDdHDBCCAFLHAE.hAAAKEEFGCEF.gEBChABA..hACAPEAEHEGBAIBEWAGHIAEH...hAAA......hACA.fEHE.,1,-25,-41,16
fbXUTZAROQdecKGFYWDNaVSCPELgIJBHM,OBDGQGGDdGHGKGDAGCBD.FAFGDGAAaAHD..CEECLCHBhAAA..IBABhAAABAHGMDDFXDGHhABA.ZFCBRCAHeCFBWEAD.NIAH.SFEHhACA.EEBH....hADA...,2,-30,-15,15
QIdcURHgSCMXFDLOZPNWYTafAeJBbEGKV,eEGHJAFBBHEAEDECKHBA..QFADdCCERAGBHCAH..CDGAFCBHDFAB.hAAALCCHOGCAZACAhABA....WAAGhABA.....TFGC.ABHC...hACA......hADA...,1,-18,-46,28
KEAcUQOaIVWgXTJHPRbBSeYZCfMFGNLdD,UCGCQGGDOAACaCAC....VFFHXDFEHFABRDCGBECEhAAA.SGAEhABAZBCEfGDGFABENIBHLBFEhAEADCADAIHA.IFFF.WEDH..hAFA......hAGA...,2,-21,-20,1
ZGcSTdDAKbgMRBNWJEYHePaIXOFVUCLQf,KHBGMCCARFCEBGAC..NBBG...JCFAEGGE.HDEB..aHGAOFBEhAAA.FAFACDBHLBAChAAAfACBGEEFhABASHCCDEDGAADE......WAFGhACAPBHD.IDDFhABA..,2,-45,-16,29
eMSgNXDHOGEFKACQfdcTIVZBbRLPWJUaY,QGGGdHBH..TDACZGAARCFFLDEFJGFEUDGH.aDAGMBCChAAA..SCCBhAAA.XAFChABAOCDDEFCFKEAGAEHCCBACfBGBcACABFHBWHFAhABA......hACA...,1,-7,-40,33
CXDbJMFVZGKALNcRIYUQePBEfagTWdSHO,LGEARAADUGGE.QGAFBHEG.aBGATBGG..SBDHhAAAHBEFCDAD.bFCFMDDFhAAAFCBFGDEBKDHBADCH.hACAIEAHeHAAfEFAWACC...hABA......hAGA...,1,-18,-23,5
UgGfRWXKEcZdQOTLFeaMJSHVCNBYPDAIb,UCBCGAFERBFH.KDCGZDDHdFAB..OABEFBDFMDHF..SFADhAAAHBADCBHEBFFHDHGAAHDA.hAAA...IHADhABAfCHAXFDFEFBC......hACA......hADA...,2,-36,-26,10
LMZKSNXIcfCbEHeYJBDWdPaVOUGgATQFR,TFCARBCFMBBH..KHBGSBFH..XDFBIDDECABBHEDDhAAAeCBHJACADGBAdAFEhADAaBAGOHEC.gGADhAAAFFGENAIA.bFFABHEA..PEFAhABA.....hAEA...,1,0,-26,26
PYDQBTVZHCRJGKWadAFNeXLfOUbEMIgSc,eCCHXDACOBHBUAAB..MACB.SHGAPGDGDGACTFFChAAAZDEG..CHCHRBDAJBABhABAKGHFdGBG.ABFGFEDD.hABAfEAAIAHD.......hADA......hAEA...,1,-12,-32,20
WCgEXTUbNdFGJRaPDMSeQVYHAOKZLfBIc,ODCHKDBDLFGFBAHD.....IBGECAFEEACGUEDCdAAFFADChAFAGAAERCDC..aHDEMDIBhAAA.eEABQECDhAGAVGFE.AIBE.fHCFWEHH...hAHA......hAIA...,1,-19,-29,10
MfYgBeaWORSPTGbXCEUdDZAJVLQFHNcIK,LFFCHBCF..NCHCKGBDfEAG.BAHEeDFBOCFChAAAPGDCGADG.XABBhAFAEAFCdBAADEIBAGABJHEChAGAFEBCIHCGMAIHaACBWDDD....hBAA......hBBA...,2,-21,-13,8
MRcOWQGXgIeSNdfBKVZHUaLFAEYTCbPDJ,TGBCCFDGDGHF..RFEF.OACBGACG..IEECeAAF.SAEEhAAAdEBEBHABKBFFHCFHhABALAECEFGA..hAAA.....PDHDcBDB.WHEAhADA......hAHA...,2,-32,-29,3
CSLZTDgbdIVfBOFcKPNQERXYJUWAGMHae,HGDACDGFLGACDDAAdCFH...VACABHFFFEEFKAFE.QBCAhAAA.EABFYFAChAAAJEHH.AIHAMAIFaFDFeHBGhABASHACZBFETDAHIAGF.fGGBhABA..hACA...,2,-30,-13,17
FCePYGHcZgLfORJDUMQWXdbBSNTEaAKVI,KCFCVDAGCAFB...eDGDGEFCZAFA.LAAFOFCD.DEAE.QFBBhACAXFEDBDDEhAAASBCFEACHAABCFGAHHFDBhADA....fCGB...hAEA......hAHA...,2,-29,-20,9
KPWOeCGdbYMDAagHXVFTcJUELBQfZIRSN,aCFCXFDH.FABDTBAG..JBFDUFFDLDBHBAEFZECHhAAASAFCKBGEOCHDhABACHHAdGFAMDAD.AFEB.gDGFhAAA..cGABEEAHIHBEhABA.NADE....hACA...,2,-33,-15,18
FaKRSCIDTGELYgeUOdMBXfHPQJWcbVNZA,KDABCCAHDDGHEDCF..LHDEeGAE..UAAFMCFCBGHGHABAJFDG.hAAA...bFFEVAFDhABAAHBDRDDB....TEAEhABAgGEAdAGB.XDFA.fADEhAEA...hADA...,2,-24,-22,2
aKgbVRATcCBYHdGfWSNOXEFQUPeMJIZDL,CHHGHDBHdDCGGEEE..fHGD.SCAFhAAAOADCFDGHUEGAPDABeFDDhABAMCAEIBHCLAHHhAAAaFADgBDH..bGAAAFFCTABChADABABF.WAGD.hADA...,2,-24,0,24
abdPAUYFOBVQJGRHWZeLfEgSXDcNMTCIK,FGFCOFCAQCDGGABCHGFEZBBDLCHBEEAF..XGCChAAADFCGMBAHTBGGCAHEKBFCdGABhAAAAIEEBDEE.JADC.hABAeDGDgGDDSGAH....hABA......hAGA...,2,-17,-2,15
YMCVJRGfUKcTINPXAbaWFZODLHSdBEegQ,aHBGFCFCDBFALBGHHBACBEAG..EAAAQGAACHGHREDF.UGFEhAAAKCBCTEBE.hABA.IADFPAEDAAIFhAAAbEDFOFHFdFHA........hADA......hAEA...,2,-24,-21,3
dGfUcLbOEJaKYCWXMHQTPDeFRBSgAVNIZ,VAADZAADdFAF.GAEEUGGELEFAEFFB.KBEECAHGMDHF.QGDGhAAATGCEDAEGFCCChADABDECAIHE..NCIE.fDBFhAAA.OAGDaGADWEBE..hAEA......hAGA...,2,-28,-14,14
NWfTUGOYCdRIbgHeXcPJQZMVKAFaLDESB,FEEDDFDCBFGB..NAAF...TBAAGAGECHDD.dFCE.RGFA...hAFAbCECeBCF.XBEBhAGAPADA....hAIA............hBAA......hBBA...,1,-30,-55,25
LTSfZDPQGBHRcaNXUJedEKVIMgAbCFWYO,FEGDOGEALAFC..SDGBDECCQBBFBACAHFCBhAAARFCE.NECF.XGBChAAAUAFDJEABECFB.KCADMEIBhABA.ACIDCHHD..WHCAfCAB..hACA......hAEA...,1,-26,-27,1
AKVLQNcIeCUOHESFMZgXaYPBRGbDTdfJW,KDBDLBDGQEEA..IEAFCBAG.HEEFFHFAMDHFhAAAXGAGaGBF.BHFHGCCHhABADDGDdBBGJADE.AIHENBICeBHBhACA.EFCESDDH.YHBGhAAA.....hADA...,2,-19,-16,3
cHeIXZOEVfUPSACMLaRKYdGFQTbDNBJgW,LHAGaEHB.RCBCKHEEdCBAGEBF.FGDETEAADIGEBCHHJDGF.hAAA....gGBDhAAAHACCIAGEhABAOADFEFDC..fAGESCGEMCABhABA......hACA...,1,-19,-36,17
HQYgVFeNZDUMAWEGBcJTOPSfaIRdbKLCX,GEAHBAFBJADBOGFC..SAACaABHdCDCKADCLEHFhADAHBGFQGAC.hAHAgFDAeHDEDBIDAIAAhAIA.cBFE.TFBB...PBBFhBBARBEFCACD.XEDAhBFA..,1,-8,-22,14
PdaFCHNMcUGbRZEWDATVOLJSKYfQIegXB,VADGJAAB..KGBFQFFC.eCAEBHEF.aAEFFAGACCGF.MCIHhAAAGEBBZFDFEDAHDGEG.hAAAADEH.LAHB.hABA.YCGH.fABFgCCEhACA.PHFC..hADA...,1,-7,-44,37
FSPKMLgDfRdQecUWbaYGOITANZXVCBJEH,XFDHBDCFJFAE.FCBH..KEDCLAGF.DIACdBEB.eABHhAAAUGGH.aACDOHBChABAADEHZDFA.EGGBHFAE.SBAFhAAAPDGDMAIBfAEE..hABAcGDA...hACA...,1,-18,-37,19
PVXLbKZeFWECcNMAGBUHgaOIRTSJfdDYQ,BFFHHEFHaAFBRDCD..SFBBdBGGQECC.XAAHhAAALACCZBDHFHCECHECMDAFhACAAFHFGBCD.OBAFhAAAIHCDTAGC.fGAEDGIB..hABA......hAGA...,2,-29,-6,23
YdRPJEWVIcabKZeAUSQHGfBMFgNLXDTOC,UFCAHBCFBFBBMEDE.FEEHLAAFDBHH.OBEACBACRDFB..EFADVFFEhACA...IEAHhADAbFCH..eFHFhAAAAIAGSCCCQAECfCGFXCAD.hABA......hACA...,2,-24,-21,3
CXFQAHPaZcJLKVTBeRYgSdDfIUNMbEOGW,HDAGaCFCZEEBLAGB.VFCHBCBBeABARFBASAAEDGFB.hAAAUAEFMCAG.EGHD.hADAGEEBCDDHFAHDQGGChAFAAFAE.........hABA......hACA...,1,-12,-29,17
BWMFLVRCSQbEIGPUcXJKAdHYeOaNDfgTZ,dCFCHFDFeDBDaABADCBH..TACGBDFCFFGELFGFRAGH.CHADSABDhAAAEGAC.IBHBhACAPCCB...hAAAUGDFcAEB........hAEA......hAIA...,1,-21,-31,10
OMgKcAYHJbXfDVGdSFRCNZUBQTLeIWPaE,HFDFJDAC.XAFCDGFFGAFEFBCA..CCHCUEAEBFDALABChAAA.eFFEIHGEhAAAaCBA.EFFC.MDAAKFAGAHHAhAFAfHABSBHHNEDF......hAHA......hAIA...,1,-13,-34,21
VDLMYCBaRgSUXNIAPHGTKFQeEbZWdcOfJ,HEBHTECBQBDF.eEHFECGCbFEEZAFBdABG.OFEHhAAAfACGDBHBMDABYBEFhAAABFFE...aGAEhABA.SAFE.XDAFAIHA.hADA......hAEA...,2,-14,-10,4
GTFJAIESKPdLDaRQgYXCbBHOcfNMUVZeW,EAFBSAFBdDAELFCFRFDH..QBBCXABABDHEOEBAhAAA.NCHC.UGEB.ZFGHhAAAWFFHTDEF.ACEBIGABhABADHACaCFHCADA........hACA......hAEA...,1,-20,-23,3
cTMSPHGYULEFeafZRXIJdOWNVDBgKQACb,CFDGTCBC..MEADSDGEGCDBUFFCEGEF.FACBeEBBZBAF.hAAAXAGDdGBA.OAFBhAAA.VEGBDDIHBHEGhABAQEDFACDC.cBABYBFCaABAfGAEhAEA.hAEA...,2,-33,9,42
SKOcLUBeFREJNPQCdgAaGbTYHfDZIXMVW,GEAHTCBC.HAAFDGFDZBFAMDGH..SEDFKCHHLDEBBFADhAAAFHGAEBCGPBEA.hABACHCCAAIHaGHD..fDCBhAAAIHDAWEFG.OAEA.eCADhACANADF.....hACA...,1,-15,-17,2
KfQaUbCDJGRNcSMIFEYWOAXVZHdeTBgLP,VABHHDDFdBGH.BGFDLFCBKACG.aHGECHGAGGAF.RDGB.SAEAhAAAFAAF.YBAFhABAAFBGeCCC.gEFFhADA..fCAEQFAGDAEEhACAJCEG.NEEGMBID.hAHAIFHA.,1,-3,-19,16
IKgULQFJZMSbXCPAYaHfcWeNdRBVDEGTO,aCFCHAAD...fHADeFFERABGDAIBTEABKEAA..LHAAhAAAFEFCMAGDSECEhABACCCBAEID...WFAAhADANHCFBECBGGEFOFCE.IADC.hAEA......hAFA...,2,-23,-17,6
aOYDUXfIdCgNTRHcFQbBVZKWLEJeMPGSA,OCCHDAFBUGGE..XGEDdFFC.CGCG.TABGHBDE..QGGEhAAABEHBKDDCEHDEMFAHhABA.SDGDhACAAAEF.fFDEIGBFNDAAFBHH....hADA......hAEA...,1,-18,-46,28
baCSHZTfAdWNRQEgeDYMFIcUPJVGKBLXO,dHBHRAADQGDBeGEADGAD.FAHHUCAF..VCECKBAEBAFE.LDFChAAAOEAHCDBAHECGhABATGGE..AHIB.NACF.hAAA...EECA.MIAA.....hACA......hADA...,2,-35,-11,24
RIeFWTGDdACVPNMLOYJaKEZUcfHXBgQbS,VDBHMCCALDEG.OACEaFFEEBHFZCAAUADHHGFA.BCGFhAAAQBAGRFAGeAHBFFGAhABATGCDDFDAABBD..CEFFNEAAhAAA...KGHB.XDDB.SHEAhABA...hACA...,1,-8,-11,3
ebWUaKROFGcLMgPHCXABNdYfDVIZEQSTJ,dEGDDACBZACBQABH..JFEEeEBCUBGHKHAE.OBGDFHGALBAFhAAA..MFFHhAAAHFABAFDBBDAH.hABANAFG.fECBEHGASCCG..WHDGhAFA.aEHF...hABA...,2,-28,-28,0
VISZUdJbLROeACPWfHNEMTQFaXcYgBGDK,CFDG..fDCDECCB.MCFDTACDaBGH...XGGGhAAA..cADGBEHDKHBAhABAIEGHZAFCJEAFLHAGhAAAeCGFPCEFNBAAFECHYEHBDECF.hACASFBD.hAEA...,2,-19,-11,8
MNVYgTGFHCRPdBZWSADaEfJLXOKceIUQb,EGCDJEEGLAFAKAGD..eCCDUBCBQADC.MGFGhAAAVGAA...TGGEhAAAHCFGCEEHdBAG.BEADhABASABFACFHDDIH.aEGCXDBEIHHA.hACAbFAF.....hADA...,1,-11,-30,19
aTMIWRSFeVbCBQJAEUfgKHLdNYGODXcPZ,UGBCKHBGLFHBdEEFGACGDDEA....XEECZFFEaCACMBFGhAAARDAH..FBCF.VGEAhAAACBBFBHHA.AABEECFAfAGHhABA.NACF....OCFAPEAChAEA......hAFA...,2,-27,-19,8
SLXAVIRFfZKHEdMQeGJNbPWCOBDUgaTYc,VGFGRDAGFFDCZACB..KBCAHBGFdEBE..eAFGJEEC.....PAAAhAEAOHAE.BFBDhAAADDECaDDC..cAFBhABASGEF..XGGCIHAEEABFhAFAMCHF.NCIECGCA..hAHA...,2,-31,-21,10
XAIEbNQSUdKFBHPgfcTYROeaVGCMWLJZD,EHBGQCBCdABGBGGAHABG...gDGFTCDGREBEOEHFhAAAeAGFaHCE.GFADhAAACGACLBDCDDEFAHHGbFFCSGFDhADAKCAD.fCGA...hABA......hACA...,2,-23,-1,22
FcbeWQGDCNXgPRUJEfLdSZOYIVaATMBHK,BFECHFEEFDCFeDEEGABFDCCA.CBHA...XFBGRGBEEAFE.LAEEhAAASDGAODBEhABAICFDACFGMHDEbCABQFGEhACA.NIAH.......hADA......hAIA...,2,-27,-14,13
JKDRPLcSXUgVIFfCZdbWaNBEGTAYOHMQe,OFBBHFEEQECCKBCE.DACGREEFLEHBSAADUFCAIBFChABAFAGFZAEH..WHAGhAFABDAG.EBAEAHHFMDBGhAGA.JDHF.........hAAA......hABA...,2,-32,-16,16
SedJNWbHgBQcAFGRPYMZXfVKOLTUaECID,FGFHGEDHRBAB.MCAGZCEA...XBFAKDCALHAAUFAAEDBADGCE.hAAAdDEB..JAFENIBB..hABA......hACA.WCHBgGGEBHHGAADC.....hAFA.fEFEhBAAOAEACABE...,2,-43,-10,33
FNcRHeaTMOIYBXdCZPLUbQAKGfDSJVWEg,GEAHDGHH.SAAFVFEF.EDEBFBHHREGDHBBCeEFG..aEBCMGDAhACA.IAEAhADABCBAXGCDdBHEPHCAhAGALACA.QGAFfHADJAAB.hAHAWDDC....hAAA...,1,13,-31,44
OEXbLBWRNeaAJUQgVPGTIZMYCcDdSKfHF,JDCHUCGC.QBCB..PEFFIGAAMAGH.CDHG.DFAGhAAAKADEFHBE..OBAFhAAAbFEDBCAH..NHBHAABEhAHA............hAIA......hBAA...,2,-49,-38,11
TSUKfZDRMIVeEGBWCNXgAbYaOFLQPJHcd,aHBGFGDBQDFDHCCCdBBFUDGCKGFE..DGIHMABE..eAEGEFAAGGEHhAAACECC.NBEF.XBCBhAAA.gGAGhABA.ACACbDABOFCE....hAFA......hAGA...,1,-15,-23,8
ZBVAFHRCWXSUeETMLJOcPQNbKIdfgDYGa,HBCFCFDD.XEGHSGBBEBBH.MAECJFDE.OFGB.QBDGhAAANHCHKEAA.fDAHhABADCABaBGDBDFGAHDEFEEFhACAUGAETCFE.LFHB.bAFAIAAFhACA...hADA...,2,-16,-16,0
PHgTScdCbfUZOQBVFLEDNWYXReKIGJMaA,HAADSGFCCBGAUFFBZDBDBDEEFCHB..DBBH....NCDG.XFDBhAAAeEBD.KBEEIAEAhAAA...MAIFhACAAEIF...........hABA.PHAA.cDEAhACAdHED,1,-37,-54,17
XfWFBDEUQHKSbGAJNCTPMcYLIZaRedOgV,JAFBTGGG..MCAHLFACZDFG.aGADeHFEdFEA...OBBGhAAAVBEE...XGDDhABAWDAEBABH.UEGFhAAAQFAHSBAGAFGACECB.....hACA......hADA...,2,-34,-15,19
DHMKGCAdISOLFRUVcTNBaPEgefYWZbQXJ,dAFBOCCHLGFCRDGF.UDBB..TBDCBACGaGCFEGBDeAEGhAAA....WCCChAAAQGGB.XGEDhABADBGHMDAFCCAE.ACHDFEECcDDD.NDAEfGCBhACA..hADA...,2,-38,-23,15
VTbcDNZfSOCXFHKBWGaUMPRQJYLIAgeEd,EDCDTCCBDFAG..ZFDGOGEA..XABDFBAFKGAFBCFGGBEChAAAMEIFQGAGhABALADEABEDeHFEdEBA.cCGAhADAfDGA.CHCEaHFE....hAAA......hABA...,1,-11,-27,16
IEdSKaCVTbRQAcgeBfOHDJXMGUFZNWLPY,eGEABAFBHCDADCBA.XBBGGDADFDGEZBFALGEE..hAAAIGCAdEBH.KAFEhAAACABETDGAbADD.AEFH.hADAfBGFMIAE.NIAH.YEAFaFGA.hABA......hACA...,2,-28,-9,19
ANdVFLcXRJeUBTZWOESGMPQaIgCYDfHKb,dCFCVDEDLHDG.RCAEUDGCBCFBZACD.OHBGEEDFGABDhAAAQGGA.aEDHIFAHhABA.CHHEDAIHhACAfBBA.bBGFAHBF.....FEBHhAAA......hABA...,1,-20,-29,9
TQVLUEdGFHWXbPNBagZeYRScCOMKfAIDJ,DEFHJDCH.QCBCLEECUABDGGEBHAFA..bAFCBFFBaDGGZAAEhAAAeCAD.RGDECFAGMHAEhABA.AGCA...IHAEhAAATEGFEECAFHGEXCGANIAF...hACA......hAEA...,1,-5,-15,10
bSZWAXfLRKCUYGJHIEdaQFgMPVDTOecBN,XDACLFBBCGAGGFEHHCCCdHGF.FABGPAAC..DGDGeCFFhAAABHDASAHBhADAABDHKAFH.UFCGJDHBEDFFhAAAgBCA.MIDG.OCGD.hAEAcGAG...hAFA...,1,3,-33,36
OcFeNAWaGDXPbfLTgKVUdJHZMSYCEIBRQ,GEAHDAFB..XABEPACG.LBHBKGFBdGACHAAFZCDGMHDGhAAASBEH.EHCEhAAABGAFODGDFEAEAHCBaEEDhAGAfCAB.VEEA....hABA......hACA...,1,-6,-31,25
NEMVJXCSDebBTKWRcULdGZAfaQPFIHOgY,QGBCFHBGHACDOHFA..NEAHMACBXBEH..DGADBFEGhAAAKFGCRGEGUCAAdBFEABAHaHEChABA....IBHBhAAAEAGGVDGFCBDF.eECC..WEFC..hABA......hADA...,2,-34,-6,28
ISTLZBOWRgfHMCeKVAJXPcDdNbEFGaQUY,JDACXCBC.DFGBdACB.ECFFFDHBGEFGUAEC...SAGGhAAAZFDBBBHHREBFHFCFCHAD.hAAAKHAAAADD.NEIA..aABH.hABA.IDEF.......hAFA......hAHA...,1,-21,-37,16
PLGWdIZRFUaTQfcAbJeBKHMOYVXgDCSNE,JEEGKDABOFCG..XBEACGGD.EGHDLAAC.dCDEhAEAIDDAFCHHUGABTFBFhAAA..QAFFhAGAfAHEAGED.bABC.eHDEBHFDMEAFhACA......hADA...,2,-33,-33,0
QWMePJdAIbfCLcZGENaUFHTRXVKgYOSBD,..IFDGCCAHLEAEZAGBGBAHEDGB.UFAAHFAC.TFEGhAAAXAEBKBHHOCCAhABABFGHDBIHMEIHeDDGJACAAHHA.hAAAfHDBaDAC.......hABA......hACA...,2,-23,-8,15
SfAcgTUZXeKdLRQMFEWHNbPVODJBYIGCa,TCBCZCDBKDCFdACB.LDHHQCFB.EGGAHGEE..NCAA.hAAAPHAADGBABEHDGAAEhAAAaBBAAEEH..cAFFhAHAXGCA.MFFBWCGDOBFG.IHAGhABASFBG.hACA...,2,-24,-10,14
ZEGSJAWfaIMFHQXVTLRdcUeKDBPCOgYNb,aHBGMHFGHCCC.QGEBXAEALFEAdCGDeEFCBFBFCHBBOCAEhAAA...NEDEZBGBhABAGABF.AAHEfBAGhAAA.IHHHTCEGUEAEDAEE.hABAYACE..hAHA...,1,-4,-24,20
KQVHLDeCPYcWdSOMgFIEbRZGTXBJUNfaA,VBCFLAGH.DGECCBHE.....PGBC..cFEBhAAAdADEOBABMAEGIBADhABAEEDCRCBH.GEBAhACABAABJHEGfFHAAHIBKBFD.eBFB.SDABhADA.FHFC.hACA...,1,-8,-30,22
AgDHUeLTVMEdQIBJNaPYGXZfFSRbOWcCK,HFDGUFCALABHTBAAMEHHdCGBBHGG..NAIG.aAEGGGAHhAAAZDEA.fCDBhABAFAAH.SADEhACAbFFGODABCDBAAHIF.DAGBEHAG.......hAHA......hBAA...,1,-8,-21,13
XJbBEaPMVgTKYGNLFQOURIfWecDASHCZd,CCAHXCCBBGEG..EACFMGCE...TCEEGBGCLBADhAAAQECFRGAE.fCDChAAAeFFEcAFCAHGEHGAAhABAdHEBaDBF..gAEGKAGCNBIE..hACA......hAFA...,2,-31,6,37
SVDCbJOUGXYFBRTcAMaeQHIZPEKdgfNLW,eECCHEFHZDBDECDCdCBC..NHBHLBCG..SHEEhAAACABFOAHFUEDEXGADhABABAECRAEGcDGAAFIH.hAAAMEAHIHHEKFDAfGGBDDFA..hACA......hADA...,1,-19,-21,2
XSGHYWFUebIMLcgECfDJNAKBPRdaVZTQO,BFEDRDAGdGDHZBACQGGH.OCHDSCGDHADGFCCEeFBDMBAFhAAALAHB.EAGDhAAAfBGF.hABADEEGAHIH.aGABXGGB.YADHhACA.bEECIBBHhABA...,2,-29,-5,24
BaVXJEASIeULODHdCTNgRGMPYFWQbZKcf,eCCHUFCADACDHGCG.TBFEREABGAEA..PABFFGFD.QGGEhAAAZAGD.KADHBAABhADAaHACJEFAEEGGSDCEhAEAIDAFOBHDCFFC......hABA......hADA...,1,-3,-30,27
cZEFgJebPNdGVQfOITaLSBMKRYHAWXUCD,XCGCUFCACBDE.DACGZBFB..FAADeAAC....bFDHNICF.dFFHhAAAGCBFQFAChAFAOGFGIDCD.hAAAaAGABFACMBEHKAEC.......hBCA......hBDA...,1,-23,-32,9
dIKRCUTLAGEPJNbfHYWacOMSeFQVDBgXZ,EGAHJGEA.....fDDHHCAFaCFHMIAGSHCE.FAEFhAAADBGGBHFGXAAEhAAAIABGCCGALADHhABAAFGBNDIA...bEFAcECCeGAA.QAGChADA.....hAFA...,2,-21,-20,1
AJNOEfYSDgbIWLBUTcRQdGHZXVMaCFKPe,JEEGEDCD....SCHBDBHF..IDAGBABGUGDFRACFGFBHhAAAZCABXAGGhAAA.aEFGFGGBKADAAIHAfCEAhABA...bAFFTGGG.hACAdHABMCIHCDDB.NIBF..hACA...,2,-25,-24,1
MfORcDgIPZVNXYbeUWSJGFHCQTLdKBaAE,EGFHOCHDRAAC.DFAD....IDGAVAED...XGBHhAAAeCBDUGFBSADHhABAFABECEDBLHBEBEDDAGAAfHGFhADA.PCEFNAAE.bAFA.hABA......hAEA...,1,-16,-32,16
EPAcGeWSdKQgFbDUOfJYLCaBHXZVNMTRI,eFEFSAFBQDFBFBCC.DAGGUFBDOBBD..JEGDCEDHaGBEhAAABDAG.HCEAZADAMDIDhABAIAHFAFAB...hACA............hAEA.WHFEKGEHfAAChAAA,1,-35,-39,4
RBVMcaXTIUOCGZgLAeHdSJfFbKQWYDENP,eDCHHFEEJHFEFHGAKAGF..QAABDCIF.EADERADFMDHF.hABA.XECBUCABOFEHhAAACFAEgGAGhAFA.AAIDfEFB.bCFEWHACNCDFBDBChAGAcEEA.IFAEhABA.,2,-46,5,51
PZWXOHUKDeCcTMQYaEASIFVgdRBNfLGJb,SAFBFCFCdGGHBBBGLHFAGDBG.JCCDZADB..OBHDKEGGDAAChADACAAD....TEEAhABAQAGAEACEIHCDhAEA..gGEDNCBA.fGAAhAGAWEGB...hAHA...,2,-33,-32,1
VNDfcOeaJKZMLWHPCXSbGQRETdUBYIgAF,FCFCDHCEOBGHeHEAKAACLDBG.HFEGXEDDGABDEHBEdFAGhAAABFHD..IFCEhABAACDC..NCCEaBFAhADAMIFG.CFHBSCAF....hACA......hAEA...,2,-40,-18,22
IPNGEOfSReXUbaHdBcKYZJACFMWTgQVLD,MAEETCBC..QEFDDDID..PFFHGAAD.fGDGhAAASHACeDCGhABAUABDaCGGBGDB.YAFBhAAAAIAGCECDFDADgGGAIEDDEEAB..hACA......hAEA...,1,-8,-36,28
AGEZFLBSPOIWXJDeCacHQKfYNTgMdURbV,ECAHZDEDBCAE.OHACXAAE.DDIBCEBEHGFGQEED.hAAAKBEENDDA.MDDH.dHGDhAAAUAFBRFAHACHC..FHDALABEhAGA.SHEG...hABA......hADA...,1,-23,-29,6
NeaDMRgcSHFKfAVZECdXPIGLUWOBTYbQJ,ZDDFEEHBdGCE..PEACLCDG.UBABBAHA..TGFAhAAAQABHJEAH.eCGFhAAADEEE.MIDA.cFFEhABASAHF.FEBAKAEDAIHECCHAIHHDhADA.GGAF..hAFA...,2,-23,-22,1
GMWfHIRLQOcFENAJXBSeVTCgPZbUdKaYD,XGDEeCAFCBEG.ZFAGdDFC.KAGEDBAH.GBFEMGBA.HDDDLACChAAAOAFAEGEAAFBABAEDhAAASDDFTBBF..hABAPCHBaHGA.fDBA.IHGEhABA....hBAA...,1,-10,-32,22
OANIPDQefbXVcLYgWEGaKJBFTZdHMSUCR,..IFDGPEGHDDEG..QAEC.eBCBXFCFhAAAVCGHLAAHhACAgBCCEHBAKGAEFGGGTDAGhABAdEBAMFFFCHCGAIFEbAFG.....WEHHhACA.aEEFBAHD..hADA...,1,-9,-17,8
YgGNEVHbcLZaRQedKIFSMCWTBOJfPAXDU,DFEEUCBCGGEFEFCFHADALBEEZFDB.RDFEdGAEKAGCFCFE..CCAABCDGhAAA..fFHAhAAAABBE.XGFDhABANACF.bFAFaGCF.eCCD.....hACA......hADA...,2,-27,-15,12
HSBdEAINQDTUVFJGCfWZLegOYXacPKRbM,QCBCTECE.FEDBJBHHGGEF.CHAAZBGBeACD.OFGFhAAAaBAH.KEAEMAEESADEhABABFGEAGBCDDIFUGAC.hAAAfGFE.gBDBYCFD.hABAXGDD..hAGA...,1,-18,-25,7
RaYMZBGdOSgKTFVCeEQDJcNfAIbHWLPUX,HAADLGEAUAFCaCEHZDCBBFFCdEEG..SACHKGBBFAAF.CHBF.EFAHhACA..DEAH.JFHDNIDD.hADA.ACCC...bGDEPDHDhAEA...RAEAMDDF....hAFA......hAHA...,2,-28,-25,3
eFUKVgaEJQWYMZdRXAPfBbGOTDIcLSNHC,BFDGOFEFDGHFLCHDHFEBFCEFUCEF.KDCDaCAH..EADAQBBHhAAAMAAC.ZFAFdAGFhBAARAGFABAC..fHGFhBBA..........hBCA......hBFA...,2,-32,-29,3
VXZNSYWIgQKTFdEecfRGaUObHADJPBLCM,DEFHJAFBBACGMDDHZBEG....SCCF..YBAEhAAAIFHFKHECFDAHdGBChABAEHBC...fFFEhAAAaAGG.........hACA......hADA.ODHDAHHB,1,-37,-58,21
ZKJGQbUWTgDMBYESaXPIeAfNLFHcdCVOR,LGEAFCFCdEBC.CFEEREABZBDF.KFGEGAGG.QCEGUABG.hAAA.TAGFMDDBEACDhAAA.aBABXGEAhAEA...IHHAAIAAfAEF.NEIC.hABA......hADA...,1,-18,-37,19
POgbNeRcHEDKGaTQYBXCdIZFSAWVMJfLU,VFACJCHDLFCF..OBEA..gGGFNIED.hAAAeDBGHBBGKAFFTEGAhABAQACGBHDFdEDDhACAFEFFAAAGWAHH.fCEAPEAFRFDFEAHFDADEaGGEhAGACHAD.....hAEA...,1,-9,-15,6
MXbYeTcACVOURBZIdfFGNELDHKaWQgPJS,CEFAOBDGUBGD.BHBFZDAG.dEGDGBADLFAAHGAAKCCA..aHGAQBAGhAAA.JEEDhABA...MAHHbDGHeADChAAAAEAG.IFDE.....hACA.fGHGhADA...,1,-16,-36,20
EAeFMBQaCfcXGDYLPSbOUVZJNKIgdHTWR,MEGFBFCFCDAA..XECBDICELAGB..PAFEOACHUADAhAAAZGFE..KFEAdDHEHADAhAAARGCCeBADFDDF.fCFFhABA..YFAFSBCD.hABA......hADA...,1,-12,-36,24
eLbfTAVQGCEYPgKMUXNHZWFRdBOSaDJcI,QBCFCBCC.ECEFgGDF.UAFCHFBCZAAFFBABdECDhACABGGE.OAHHhAAADFFCIGHF.LADBhAIAfGFEADGF.VDAEPCHDXGAGhABA.....hBAA...,1,-11,-31,20
SQgBMTOHUGFfJePCaYbKXILcdNVADWEZR,DGHHECFCZFAFQAEGBAED..OACDUEEEGDCGFBAD.eCGBhAAACFHF.aCBDKGFD.LEDEhAAAdDAGAIBG..WBHBhABASFCG..MFIF.fABFhAGA....hAHA...,1,-19,-39,20
DBUFOXVWcAHYIPNgTERJSKdLGQfbeaMCZ,HAAD..IAFBgBFEREDFKCCEdGGHLEAAQEDBeDHHhAAAaADFMABBDDCHBHAHhAAAOHECXDGE.hACAWHFGAHDHNCGAEAHB..SGAE.hADAfCCBCADA.hAIA...,1,-6,-21,15
agZSIWBRMYdAbNXOUPKJEeLfVcCGHFTDQ,XCBCODACUCGDKEFG...eHCALFBE.VADFCBADFGHBQAGFhAAAaEED.SGDGhABABGBCMAFHAIFANDIAhACAJADH.EAAE..fGGG..hADA......hAFA...,1,-22,-32,10
UKAFgBGIEXDQJeONVYcZTbRWfCdSMLaPH,BFEDEGAHDBCAQCGH.OGFCNEEG..VFFAZDBFbADERCDE.hAAA.CEAC.dHBBLBFAhABAaEHHUAAFACCA...FDDEhABA.IEAEXGBD......hACA......hADA...,1,-10,-32,22
GIaZLdJXFQWRDHPMSKUEYVObcBACTfgNe,TGGG..NACEGFEHaDCG.LBDAXAEEQEBBhAAA.DGABMAAE.hABAKGDEEHDGOFEABHBACHHDhADAeBHFdEFFFAEGHFAHSDDBYBCA..hAHA......hAIA...,1,-13,-14,1
cFMAGSYNWHbBEZeXdJfQKCVRTODaPLUIg,SGAH..YCAFHEGFBABFeGAEJDBEQAAEhAAAKBDACFDC.RDDFDHGALHDAhAAAgCFEMAFAAGCBNIBF.hADAEFEAdAHA..fCFFOFFAaDBF..hAEA......hAFA...,2,-24,-11,13
ZXdTABgMSNFafDEKUcQGVbROIJePCYHLW,BBFDMHFGFAEHDDDGUFFHGDDA..RAAC.OBBD..eEABCFGELBHBhAAAZAGFdGDEADCHSHDGhABA.fHABhACAEECFKEFC.........hAAA......hABA...,2,-41,-25,16
EMGSNKdeRPZFAXODbQVITWcfUBJaLgHCY,XEGDOFCHDBGH..QBEE.TAAGcAAGBHHEhAAAJEAH.aFABHDCA.EEFChAAAGEBGKHGE.RCACFBHFhACAAFHEIBCDWEDA.fAHGLHDECDEDSBEDhADANAEF..hAEA...,1,11,-36,47
HCgNDdaUQVWcEYJeFXbTAfBKZGPSROLMI,KEGDZEBHSEHHLABGMCDDHGEE.CBFCDDGGdHABUBFG.QDAAhAAAVDDE.EHGAeFADhAAA.FACD.XCAChABAAEHGBFEA..........hACA......hAEA...,2,-31,-20,11
SRGcKbPJQCMBeEfdZIHTDLXaNOUFgVWAY,SCFCREBHGBEEKDAB..JAABCHDG.BHAE..EFGEdDGHHAAADFGH.hAAAaAGCOAFA.FHDGhACAgCCDAECC.hADA.bCBAMACGZEBA.IHAD.TGEFhAAA.....hAEA...,2,-33,-8,25
XNLVbQWGBFECAIcdRgJMZOfPaeYDKSUHT,dHBHRFDFMIFAZFGHOBDH..aBEAeFEBKDGGHBBF..TBADhAAAXGADLAFBhABAbEAA.QEADhACABFFECAHGAACC.IAHH.......hAAA......hABA...,1,-14,-28,14
LIAFWJYHGbKOPgZQXUSeaCRMBcNdTfEDV,JCCHHEBHGBECOBBEZBGBUBGB..aEAFCGHDBHAH.dDDHTFGDhAAADEGALFFB.hABAABBG.WHAGKCAD.QACAhACA.SGCEMAAE...hAEA......hAFA...,1,-21,-31,10
UHadQRCePDBEKTXFYfMNbVZOcWLIAgGSJ,SGAHUAEGdGDHRDEG.eDEHBHBB..ECADKGHFFDCA...fABGhAAAMAAC.NAHA.VBBFhAHA..OFGHhACA....WEBGLFCBAIFA.gAEAhADA...hAIA...,1,-12,-49,37
QDSIdUVPCWAbcOJTeZKLfBHXRFNgMGEaY,OGEAJFCAZDEC.KACGBHDDHFAH..RACB.FEEG.MDFAGEAG.EAAChAAAQAFH.hAEAICACUGGGCCHHACCFTGCEhAAAeAFG.LCCB.....hAHA......hAIA...,1,-13,-28,15
IPfQLEKZHOGebYFgVMTcdDUSNCRBXAJaW,aDCD..IAFBQBAALCAAEFFEKFABOCGHGAEFbFEEFFDDhAAA.MCHB.TCEFhABADFDDSEAAhAAA.NIEFCBBGXDACAFEAJAHB.fGHAhACAeHAEYBEF...hADA...,1,-10,-12,2
KSGHMUNLRCaBfAXTFVQOgPYbEZJDIWecd,XFCAVBCF..QEBHODFA....PCACEAGGDEFFhAAAIFAHeGFAdCHGKFHDhAAA.SAEEhABAHGBAMIFANCEDCHBGaBEF.AEEHFCAF......hABA......hACA...,2,-27,-8,19
TOFNHAefSUMbPgDIdBVCLaWJRKQXEYcZG,SDCDMFFF..bBACDBHH.BEFELCFEaACG.RGBEXDBFhAAAEGBEZDDFGAAE.hABAFEHFABBEfEDAhACA..PAFHIEGCCHHH.KGGEcGAHhAAANAEB.....hADA...,1,-21,-23,2
ZKDYgINGRJaEMPOTCAcfVSWQedLHFbUBX,VAADQGBC.eDDDdFBDLFHHFGFBUBABBAEAZFEFDEBG..hAAA.IHAANAAF.hAGARADD.ECEH.OFFAhAHAAHCFfAGHSBHBHCFA.....hAIA......hBBA...,1,-15,-24,9
bAEXRKOgYFUJMIZaWNBPcSfLdeDTQVGCH,RBCFOCCHFABH.UGEGMHCAZEAH....aDGFBHGE.SBAFhAAAdBGFeEAGQGFChAAACAHCADHC.KHAG.JCEBhACANAGC....fHCHDAGG.TBDFhABA.....hADA...,1,-25,-38,13
BADZIYVFSTHWENCaceUJKLOGPbQfRXgMd,ZFDGVAADSAAB.HAEDNBHC.aGAGUEDELECCGEACQCABhACARADC.MIFEhADAAGGGDIDAICHGhAEAFGHDECFBCCDDJEHF.OHAE......hAGA......hAHA...,1,0,-25,25
XcGDUIYZLBdMbWPAQVCENJFfOHgeTSRaK,QGDCEBBDFGCA.HBDEeABGSABEKAHHGDDDDAAD.IEEFhAEAZFABBAFAdGGEMAAFhADAPHAACHFG..fGFBhAEAOCBFgAGDaHCC.cDFAhAFALCEEADDB....hAFA...,1,4,-17,21
TfWGSOEYJHdaKeMZgcPNIUCXQBDRbLFVA,TCBCGAFEEEAB.HAAFKBEFMDFCZDCF..PHDGUGFECGEDBADFhAAADADE..RGAG.FEFHAEFA..hACA.SAHBhAFAJAFEdAAC.aHGE..........hBAA......hBCA...,2,-35,-10,25
gXRAZPDYBTbENKcFWGUMCVJOaHLfQdeIS,DHCETGGGEFBH..KHGAFFAA.UAEB..MGDCCBBE.OACGHDFC.hAAAQDCBdGDAeFDESCDAhABAXBBCAAACZBEFhAGABHAG..NDIEGAGEaDAEIBHG.hAIA......hBAA...,2,-19,-12,7
efIPBLFgZKaJAOYRUDHSWdXQcMEGCbVNT,OFBBUFDHDAFEHDFE.SFDAdBECQCACMCDDGAAChAAA.VAEGNADC.eFHFhACAfBGEBHCGFHDAKGGGhAAAAHAH.....YEFC...hADA......hAEA...,1,-3,-37,34
dgYGKZAMETNIVHSQcXbeLUCFfODJaRPWB,EAGDTCBC..VBCEHFDF.QBFG.XGGGhAAAbEEAeCBBLFAEFGCHDGEFaGGChAAA...WCADhABABAHF.YCHBKDFCABBAMIFGIBAH.hACASEEECAHB.hADAfADH.,2,-8,-5,3
fJMeXPEVRWOAdTZcbNDGCaIYULSgFHQKB,ZBCF..NCCAGBDGCHEC..aFEEUEGDSDAFHAFGBAAEMAIFhAAAXGCH.EACChACAVFACOFEFdBEDbDFChABAIHHE.LFAHFHGE....hAFA......hAGA...,2,-22,-11,11
CDATdQKYaceLUBMGRFbPgVXEIHJNWSfZO,TFCAQFCE.KAAFaBFHLBCFBCCFMAIDGAEG.RFFDFEABhABAPFGH...XDBChAAAEEGGJBHFSHAAhACAOHACCBGFACHDdABF.eEEC....hAEA......hAFA...,2,-21,-10,11
aAbgMHIDZcFGVNfUKQXCLedOWYRETSJBP,MCCADHCEFDBAGEEH..VCFFUAGC.XABGCHAD.dHGBOAEEhAAAREAF..SEDChAAAJBAGBFAGAGGF..hABA.....HECCIAEF.NIBBfGDBhACAKFHB.hACA...,1,-16,-42,26
VDRUCAWZHOGcgaBSFJIQXePNETfdbMLYK,ZGFGHFBHGBCGaBAAFBFEQGCE..XDDF.eGFAhAAAECFBdAEDLAHBhABAKEEGRBAHAIBEcCACBFAE.IAEAhACAPAHFfFGFMFFEDEGECGDA...hADA......hAGA...,2,-13,-10,3
dQEHRGaZVYgPeLKWTFBOSfXCbAUNJDMcI,UDACJFCH.DACGMBAA..dECAQEECEEGCGGCBZCDA.VAFChAAA..PDDALHEChABAKAEAFBAABFAFSHBGhAAACDAGNCIA.IHHAaCCH...YAHBhABA...hACA...,2,-20,-20,0
CAJRZEVWPaUdTcfBQbOLgMeINFHDKGYSX,JDACZDDFEACB....VGFEaFHFUCFB.dGBFTGBHBECA.QBFFhAAAOAHFMIEGhAAAIEHA.FCCAKBAFhABASEEECAFDAEBH.......hADA......hAEA...,2,-31,-29,2
UfAEcBNRdPSIFZWDTbLOJQYCaHeMKXgGV,BFEDRDAGdGDH.SDFDZABGDBIF.LDBA.OBBCJEGHQAFFhAAACHHGHGACKDGG.XAEAhAAA..VCDAhABAAGIDNABD.IGAF......hACA......hADA...,1,-22,-37,15
fbAWeBFLDdScCaUHNXPKVTOQJIGERgYMZ,eAFBLCAFdEAGCEFGHCFF.XCDBKGEB.OBBDJCCDGAAFhAAARGAAMAAEZDGB..AGGEFBGAhAEADIBG.aHFE..NEIE..hAFA............hAGA......hAHA...,2,-36,-15,21
OVTUAIdeQXSafGREHLWJbZNcFYCBDPKMg,eCCHQFCA.SDEEaCAHRGAGHDFGLCBFJABBZCDDFHGGBGFGhAAA.DCDHMAFAOAEEhABAUGDEAICAIACFhAEAdCGB.fFAE.WHEA.cEGBhAFACFFB.....hAAA...,1,-10,-15,5
IEDeSPBACRYcObUXFJQTHWdNaMfZGLVKg,RDBHOGEAUFDA.FAED..QBACHCBFdBHAaADBMFAF...ZAEEhAAALEFEKHGA.IHHGhAAADDDGSDGHhABABHCEABBGCHAG..........hABA......hACA...,2,-31,-30,1
JUEPcbdOZWLHNYGfRAKeVIXMBDaQSgTCF,KDBDeFBB..VACFXEEEBAHH..DIGAaCCE...QABHhAAATFCF.JCFGEHDAPAEAhABAdCFEZEFELHEAhADA.NDIA.fBACAFHFMEBE.CGAC...hAAA......hABA...,2,-37,-2,35
ScFUaOIHCXKZAWPLNdfMJeTRDYVGgbEQB,LGEAdHBHMDEC.TCBEDBFCGBAB..EAADSGGDhAAAFGADaEFGHAEFKEEFAADE..NIEBeEBBhABAREBB..YEHFhABA..........hACA......hAFA...,1,-14,-32,18
MBfHAXLKbQYgSEFaGIdTWRZOJDCVPcNUe,XGGDKDCDQDGE..SDEDaAGEdACH.RABCZEABDGDECHAAPFCHhAAAUDDE..BAAAhAAAAHEHLDFC.gAFDhABAFDADIGHA.OHCE..hADA......hAFA...,1,-15,-31,16
RbXEaMFOcLBGNAgeWYSJQTUPKZCIDdfVH,eGEASHBGQAFBUBABZAFGDIACdCAGHEGHRDCH...EEADMIEAhAAA.FCHBOECEBABBACEChADAYHDC.PBDBhAAAIEFG.fGAFXCGE.cBBEhAEANGCF....hAGA...,2,-28,-2,26
IcdBVACFNgbZMKGSfQPUaDHYTRJEWOLXe,FEGD..bDDDZAEAMEIHGABC.QECDaFAEDCBF.HFEBRADAEAAFhAAAODAH.LHAGhAAAICHGBDGCAHBGCGGGKCCFhACAfDDD.......hADA......hAEA...,1,-6,-30,24
LDVNQbgHBaXSERKWZJFOcPGUfIeACdMYT,MAEETDACLBFA.DAADQDGFHCAGBHFFSECAhAAAEEDFKEHH.WGAAJEBHFFEEhABAPFED.GACHhABAIHHEAIGAdCAF.........hACA......hADA...,2,-27,-8,19
ZeIKUYFEGVCBOHSfbPAWLDQMTgdaXJRcN,LFCHMIAGdAGC.aEGERDBGZBBC..KFADFGFBEAAD.GAEGCEAD.BACChABAOACEHGEE.bDBEhAEAAHHDDAAC..TCGChAGAXEFE.....NEIE..IGDChADA....hAFA...,1,-4,-38,34
ZRYcIXBMFgLWPADJHfSGCdUbEVKOQaNeT,DGADJFBBHDEHGDCBdBEBECBF..KDCC..QBFAaHFG.eABChAAA.TGFHZBAFcEGBhAAAIFBD.BBHHhABAMAEGFEHB.WAFCACIDSACHCFFC.hBAA......hBDA...,1,-16,-27,11
fWQSCOLcZEJeVXTFYdIMHDBbKaGAgUPRN,UCBCRAAD....fGCGSAHDLCDCEFFG.JEHHeHFAhAAA.TAEHdAEDMFAChAAAHDFCDEEAKGCEAAHCPFDChACANDAGCACE..cGDE...XGADhABAIBHEaDDF..hAEA...,1,-17,-26,9
XTQNJGPgKZaAHYMUIOVEefbCSdBWFLcDR,HFACUFDBOAEDEBAHeDDA..CAAB.BAFDLBGBDCDAREGH..TDAGhAAAJEAG...PHCChABAKHAEaHGA..AAHF.IADHhACA...fCBB.hACA......hADA...,1,-23,-40,17
DYIdcfJSULMZgHOQRTGCaeWBFEKANbPVX,...PECCVFEEDBHFdACB...JAABUBDBZCCB.OHCA.QFAChAAARFAFCAEC.aAGBhABABAFAFFGA.AIFE.NAIE..hAAA....YBBFIHHG.fCEHhACAMGDE...hAFA...,2,-48,-21,27
EaTUSJYeKfHBPZbVAcLFXMNODdQWRIGCg,FDCDMFFFOBGFdDCARAFD..GADGCHAG..aGHFSAAD.hAAAJFDDKBDE.BEAFZFAFAHHEhABAXGDBDGGA.QBBGhABAIAHFEDAETGBG.eEFGPCHDhACA.....hACA...,2,-37,-10,27
FJGdeKZXQMPaANHfgURYICBcOTVEDWSLb,HAADUCBCRBFHCFCEBEGH..TFAEDGIFLBEEFFFG.GGDHhAAAKADBZEDBMDEFADDC...hAAAfGAAIAHFOHEChABAECCF.........hACA.SEAFhADA...,1,-29,-31,2
NdOSVBWcFKLQEeDICHUPGRYJTMaXfbgZA,OCCHBCAHFEFELEHF.eEABCHGEUAEARFCB..JBECaAAE..hAAAXBAF..hAAAgEBDNEGA.hABAdBGE.SDDDWADDKAGCDFFB..IHAChABA...hACA...,1,-22,-45,23
TUaVOIWfMNdYPDKLRBEZGgQXJCbHScFeA,TFCAVBCF..OFEE..fBDEMEAH.dAABPBFAhAAAKAEHBHHG.ZDAG.hABAQEEBJFCB.hACACCHCSEHF.eHAGABBBIHEGhADA.NEBEDCFFEAGA..hAEA...,1,-10,-37,27
DGebJBVARYFXZcLMIHECNTgUOSfadPWQK,RDAGXGBCLBHBHDEHEBAA...CDBD.TGBDUAACODAH.hAAASHGGdCDBQFGHhABADFHDeAHFBEEDAFIHFECDhADAZAFFIGEE......hACA......hADA...,2,-17,-17,0
DbdVIMegUQJYWFXGKTfCZERSBcOHLaPNA,DGHHdCFCMABEeCBBUDGH..JFADFADGKGGB..CFDB.ECCBBAAFHCGDhAAALGCG..hACANBEAABDF...bFBDVAGDhAGA...IDEA....hAIA......hBBA...,2,-40,-30,10
ECfGgTXaJdcAOUIeZbKPLBWDRVMYFHNQS,ODACUDACeEEEZDFGKAGEBBHF..RBCA.MGAAHFBC..QACGhAAAEBACCFGG...GGCFhABAXBFHaEDCdGGAhAEAAICAIHFFPCEC.DADA......hAAA......hABA...,2,-29,-10,19
CDYdGSZAeWgRMBXQUIbPKfLVcEHaNJFTO,eGEARAADMEBGQBGG.UDDAIHBBKACDLDAHEGFDHCDGhAAAaFGAFADG.CHDADGADdAAESFBHhADAABFCBCGBXEFAhACAfAEE.NIBD......hAGA......hAHA...,1,-6,-25,19
TcFMeBWYCNZgLaIAVDQEPHOXfRdSGUbKJ,VFEEEDABHCGD.OHBARCCBdCGCGDAE.KHDAJDCD.FFHDMBAAhAAABFED.CAGHZABGLAEAhABAAAABDCDC.....hABA............hACA......hADA...,1,-26,-33,7
cfUHXQKCPdDebARZYFBVgJNGTaSELOMWI,RGFGZDAGFDEDBCDB..JHAAGGCH.SAAFEAABLDCFMEFChACA....IEAAhABAUBGFXGAFhADAKADACBGB.DGGAAACA...gBBF.NFDB.hAEAaDHD.....hAFA...,2,-40,-27,13
GZMJCKBVbeHEYWNPTQgfUALSIXcFdaRDO,SDCDXCBCdACERDGDGBBHZBFE.CAGC.BECC.eGECEGHF..hAAA.NIEB.TEEA.hABAfAABABBEIDHFhAEAFHCGaFADDGCC.MEAHJAFEKEDH....hAFA......hBAA...,1,-14,-22,8
KaJWXEYVBGMPUFNOQTReCAdfLgbZcIHSD,LCCHZAADHDCCKEGCJDAB.EFCBBHBC.GEFCMAFBFBHD...hAAA.NEEC.QGGAhAAARADDADHC..dAHEfGBGhADA..cBABDFFBXACAhAGA......hAHA...,2,-33,-20,13
YPJgFHTOUZSEIdNRcMAbKLafQBDWVGeCX,LCCHQGBCBBHHDCADGCEBeBDECDAB...XFFFJFFFFGDB.hAAAHAAD.ODBChAAASHAGIHEB.hABANFAFMCCEKEFCfAGF....hACA......hADA...,2,-41,-5,36
QHYGEcTSLgRIUfBNDFXWdCOZPaJbAMVeK,eAABHBCFGFDHEHEA.TDFHSDCELFBHRECGUAGHBADEDHAGhABAXBABdACFZDGB.aBEEhAAAAFBHMAFFKHDA...hABA............hACA......hAFA.cAGAIHHA,2,-16,-5,11
YNWUPLIMOAcRHbJDeSdKVBCTGfgEZXQaF,RGFGHFDFDCBA.dAGAKGCBBBBF.CADGGCDDECGCZADH...aCAC.FECG.hAAA.NFAF.UGFALFFChABAOFAFAGBE....hAAAJDBASDGA..fAGAhACA.....hABA...,2,-32,-23,9
gFGTDRCJPMbaUYdLVcEeHQOfISNWXKBAZ,ZDAGGEAHREGH.JAEEMFCE..aAAFUGBHdEGELCDC.EHDAhACAeAAC.OCCAhAAAfDEGSGEDhAEANAIE.KAGGAIFA..FHBGCCGG.......hAFA......hAGA...,2,-31,-16,15
JFAYQbWIKZTMRHCGOSLDUecNaVBXfgdEP,QCBC..bFEEKEFGMDAGCBFHOFABDABAUAGD.eECBhAAAaFBDBAAF.XACEhACAdBEEPFAB.AIHEIBCFhAEAZFDC.TCGC....hAFA......hAHA...,2,-36,-25,11
MgLQKGeNbDUfJdOEPCRHWIAFZBcSYTaVX,BCAHSHBGaGEE.MFEBQFCC.KBFBNEAG..DFIFJCCCdHFHhAAA.EBFECBHEHCGB.hABAAEFFFGAGZABETCCChACA..gAACGCEG.....hADA......hAFA...,2,-28,-17,11
IdHKDPBTgcSFbLEaZRAOWCUJfMeXYGQVN,OAFBUGGGMICE..XGGAQEDA..IAAHhACAKGAABBCETBGGSAGEhAAALCCBEBFFaCGEADIFWGAChADACDAD.eHAC.YFEA.NAEEDCBFhAGAcBAA....hABA...,1,-8,-38,30
MEdfNDFXTBcYZJAbOVWPQGgaeSUCILRKH,OFBBVAAD..QAFBGDBHeGDCCDCH.LAAFREAE.HBBAhACAEGDDdGGENICF.FBHDBHHEhADAZCDFAADCPAEG.hAAASFFEIGADKEGEfCFFDFIF.hACA......hAGA...,1,1,-15,16
OHGMEZcXPYVaAeCNKDbLWQRJUdgSTBFfI,eAFBKEGDDAACLEDB.QBCEUBCESBFEFEAEOFFDhAAAGFABECHH..XBAHhABA...YHAAhACAAHDENICDbDAC.........hADA......hAEA...,1,-6,-47,41
VXZCWfYUAFPSKLaJbIGBOcMdHNQgeTDRE,FAFBSAFBLGFC..JFDBGBACBABD.OECAMIEEdDDHQBGHhAAA.eCCEhABADEAFVCGBCEGG.fFGEhAAAAAIB.KDBDIHACHADF.NIEF..hACA......hADA...,1,-17,-29,12
DFeGEUILaQHdgRfTKCOJWZYbBAVMcXSNP,VFACXFDB..SFGEDBGHGCBAEEDELAAF.aFGEhACAQBAAdHFHRGAE.hADAfDFBTDGFOAFAhAEAZADCBHADABIDMBFBNHDHFCCA.....hBBA......hBCA...,2,-16,-6,10
IdLJZFMCNEKYcQXfWUBDRTPASeHaGbOgV,SDBDeDCHHEDFaAHHOGAA..IGGAJEDCZCCE..FAACMIEAhAAA.EGAGKBCGQCAEhABAXAFAUEGEhACABDHDDAFFRGDEAHHF.gACB....hAEA......hAGA...,2,-21,-12,9
LJTYRHXWIecQVZBDKObfgdSaAFMNPUCEG,FGFHMCCAUBDDGEEHLCAF..TAGHREDH.HFAB.IDAHhAAAeAHHQGAGhAAABDDFDBAGKGCCfGGBhABASHGEAEIBPCBFCHEB...YCGFhACAWDFC....hADA...,2,-24,-16,8
UWOAbgEaMLBcXGINTRSCJZVKdYefPFHQD,EHBGLECCBHFDGDCGTAFA...SABACBACZCGBKCAAdFDC.hAAA.eBFDFEAHQGGAhAAADFFGUEACACCAaGHDMIBAhABA....IGGG.NBIA...hABA......hACA...,2,-28,-21,7
XSCVMaTfORNFPbDJQYgZULeEBGcAKdWHI,KAFBdCFCHGFE.XBBACEEDaDHH..OAAFRDAHFGDB..DAIHJEAB.hAAA....QGGHhAAAYAEDZAGFLCCEhACABGBAAABCIBHHMFFE.fGDBhADA.....hADA...,2,-34,-21,13
gUJEQZdfCTMbLaVBXDPeRYNKAScFOHGWI,SAFBOCCHHGBAGDDB..IFFAUCAFEFBDdBEHCAHG.MADBhAAAaFGF.BEDH.DHFGhABAPHCEeCAB.NAADABCAcBGDhACA..WFHH......hAIA......hBAA...,2,-28,-20,8
SYTZMAHfCJILGOKceQWgVDbBERaXFNPdU,CFDDJEEGLDBHGDAA.KFGE..QAAC..VACCBADGhACAaHAEFHDCdBHESCCChAEAZDEFAAHEHBFDfCEHhAFA..IHEBeAHFDGDAEAACXGGChAGA.NCIE...hAHA...,2,-20,-18,2
SEGgZFWTHCfQJALUXIbDNeYOdcVRKaPBM,LDCHUCGC.XGDEIHHD.DGGBeHAG.dEEFRABGKAFEaAGDBHHGhAAA..MEAEhAAASACGEFBGZFEBFHBEhABATBAA.CAFDJCHBABHA....NDAH.cEAEhABA.....hADA...,1,-13,-31,18
eTRJaYdKWMUGfPONFSIcgBLXAEZCVHQDb,CCAHHBCDDDGH.eEAH.TAAFaBAG..dAGBMFIFGEECOGBCFEAH.hAAASHFC.hABAIEGBBEDBADDEEGCFhACAZAEHQEDE..bCGB.YEHBhADA.KDBB..hAEA...,2,-34,1,35
dMcVUaYSDTRFAGgeZbfCIJBWPKEHXQLNO,eFEFZAADCAHEBDFCKGGBHDAG.LAACdECE.MBHHVGEG..aFAFhAEADFAA..TBDChAFAFGBHACDH..GACFfBBAhAGA.IGCEJDHF.....hAAA......hADA...,1,-4,-39,35
HgdTSOaRGJMZbWDUECPVQNLKeBAfYcXIF,...fHBHXCBCFDHHdAFF.OAEDRBCGMAACZAAE.DBGECDGBQEAHhAEAKEEFBHGAAGHA.IFFDhAIAHEBB..gGEChAAAaFHBbDDCECBDNEAE.......hABA......hACA...,2,-25,-6,19
TeIQgWaLCMAObNdKDcGYHFJEPURVBSZfX,OGEAdHBHKGHBGEDFHBEDEDAGUEBABHCB.ZBAC..TBCGQGAAhAAA.aDGBCAEEMBABhAAANAEH.DIFGFEHF..hABAPAGDSEDFeGEA......hACA......hADA...,1,-10,-21,11
bfJQIdCXGTPDRUcAaWZYHKVNBFeLEOMgS,aCFCZAADKHACBFHGFECFLEAB..MIDESEFC.JACBhAAAICDD.CEHGGAFChAAATECGDFGDREEFABEC.hADAHAFE.NIDHEBAD.......hAEA.gGGEhAFA...,1,-19,-37,18
afZIKSXADLEJNCYTPbGOReFQWMgdcHUVB,EEGCJAFB...CCBA...TCBAGGCBOGFEFCEHMEAC.dBHEUABDhAAABBAHZFAEKADEAHCALBHHhACA.NAEE.YFBEhAAA.bFFAQEFC..hAFAcGAC.aAFD.hAHA...,1,-20,-26,6
GcCORVPFTNKbQfgdYHLXSDZAaUeWIMJBE,aGDDUDAC.eCGBMAIDBGAAGADA.CACG.VGFEFEFF...KEEAQGBGhAAAdAEHHCCF.LAGHhABADAAEABIF.JHFAOHBChADATDAE.fBBE...hAFA......hAHA...,1,-8,-27,19
PLVHGKFXSEJZQafIgWCNRBMODAcUdYeTb,dGFCeDAC..TABELECCHBFDFDHHEFBEJADFZDAA..QAGBhAAAaGHD..fHABhAAAIGDDCABA.NIDH.hABABCDF.MFECAFGB..cFAA..hAEA......hAFA...,1,-14,-29,15
fXMgcKNUSIWPTBEGaLAFZCQVdJYObeDRH,CCAHdDAF.OABGDFABHAEB..MEDDKDEDUGFASGGF..hAAAIACGTFAAEEEFhAFALBHHABEGZCFA.JHAEeHCAhAGA..XEAB...NCDEBHDAhAAAFAHD.....hAHA...,2,-28,-18,10
IZVdWcDCOLGgUXeBAKHPTRYbJfSNQFEaM,KCFCTFDHRDBG...JBHFSGAG.FFHBEHGE.MAFCZADDdGEChAAADEAFCDEH.GBCDhAAAXABEBFHGAABE.HFBFhABA.PDAAfAFHaBBG.IDHFhAIA.WFFB...hACA...,2,-29,-16,13
gCKZWLVJSIMDdBeaXTAOHRQEGFcbYUPNf,ODACRBCDEGHF.GGAHFEFG.....bEBAPAAA..NCCDCAGEhAAAKFDF.ZAEELFGFhABASFAEDBCA.dHCHaDDAhACAAEAA...cDGA......hADA......hAEA...,1,-20,-33,13
BEZbQCDNSVKPIcFLWTYdgfJAXRUHaMOGe,RCDBaDAFMDCDGECE.BEFCEAGAZGDA..QGACCBAC.SAFHhAAAKEGDIHHGhAAAFCDCTABFdCHG.gFGChABAJADEADAB........hADA......hAEA...,2,-33,-23,10
BbCQRSZTYgFUWfDeXGIOKEcHAdaMLVJPN,MIAGJFFCBDDG..QFGERBCE.SDEFTGAHFAACfBBChAAA.eEADhABAIEACEAHFAECAaCFFhACAVAGFNADB...CGEG.gFBBDDIDOADGKGFDhBAA......hBBA...,1,-13,-37,24
TIeDPFGQSEfCVAgXKaYBHNLJMbRZUWdcO,KGFCBFEDHGCCJBFF.MGACZFFB...UBACdACG.OAFEeBHHFGBCQDFGhAAA.SACHhABACEDFAAFE.aEBE.hAAA.NBBG...bBEC.......hABA......hAEA.WHAG.,1,-11,-48,37
HLAWJbRecOSCPIdFUKYDEMaZXQVfGBNgT,JGEARFDFOCCH..SAGDCHAC.dCEGUGBEDCBC.EGGDMAAChAEAZBEC..QAABhABAGDBEBHAC.TDGHhAFAAFAEeEEE.IAGGKGDF.aADG...hAHA......hAIA...,2,-36,-16,20
UQPaVMONgTKdZSHfRLFbeADJEBCcXIYWG,EEGCCBBD....XEBCIGGCGDDDQCAG.aGDCVADHhAAA.MHCGOCEDhAAANDAE.KAGDdBHESABChAEAfGHAFFAFAHGFDGDCcEDH...WAHHhAFA.....hABA...,1,-15,-29,14
XWaURbCZdASGDQINJHKFYeMEPgLfcVOTB,SEHBQCCBJFCHHAEH.FCAA.eHCGMFEH.EBHDLEAHhAAA.VGFEBGGAaAGDhABARACAZAFBAADDDEDHNBACKEECgEEFhACAOFAF.........hAAA......hABA...,1,0,-23,23
aJMRfbKSVeQNdcOXEPLGCBAYUDZFHIgTW,UAFBZEEEHDBE.TGCHaEGGRDAD...KBHBSFEHeAAF.QCCAhAAAdAFFXGEDhAAAEGCHLABECGBCBGHEABDDDIAEhACAIHHH.WHDAMAEB.fDFFhADA....hAIA...,2,-20,-12,8
WETLBdRFgHXZGcUQDVCfAISJKNMeYOabP,JCCHKGFHMDDG..OFGF..PHBEEAGGBAAF.RCFAHGCGhACAXBAB.GDADhAAAQADBCAGHAAIFIFAHhABAeEABaEEF..TDGH.FADH..hACA......hAEA...,1,-21,-30,9
JfFNXHaPGTOCAQIBYMUVLEKSRgcZdWebD,BHHGUFDBLCAFEGADRECH.ZCDEdAEH.eFFEJAHD..FABGHCAD.hAAAaGEB.GCEFCBEGAIGC.hAEAIACGMDIHKGAG.hAAA......SCCF.hABA..gEFBhAFA..,1,-20,-31,11
UPNGSJTFDaZRfXVEWKeYbAICMOQBgLHcd,CBFDMIFGBFAGLCFEHEGHdBBCUFGGGGBB..TFEADEFDaAEGZAAEhAAA.RFAC...XECGhAAAECCHeAEEAABE..IDDEhADA.OAHFcCAGSHAGhAHAfDFF.WHAG.hBAA...,2,-25,-6,19
fQJeDOANTYKgCdFXEGPLSZbRMIHaVUWcB,TCBCKHBGdDEAFCAH..ECHDLGAEZGFAREDCHGBGUFGDBAGC.QACEhAAADDDDAHED..hABA.NCAA.CCFBGAAFhAAA.SEAAICFF.aHFC....hABA...WBHF.hACA...,1,-15,-29,14
TdQVbcSHgRZWUYJKOFILMPNXCDBEaefAG,TECBVBCF...SGHBHDFFZGCEUAGDKGAGFBDDMABA..hAAAXCGCCHAADDIFBHHBhAFAaCACAGFFdFBD..cEGGhAAA...........hAHA......hBAA...,2,-31,-26,5
WXeEMONYVbTDdaHQUCBLSgJIZPcKAGRfF,GEDHRDAGFGAA.eFHHMAFH....YFCFTEGB..dAHCHABEhAAAQGDDBGADgBEChABAJBAE.IDAFhADAcCDCAIBAXGEAEGGB.NAIA.DABCCDDD.hAEA......hAFA...,1,-11,-19,8
RAVYXTgKHLPUDNGFfbOCJZWcdeSIMaBQE,XFDHKGFCHGCCUBCHDCDA.FEAE..OAHBCDGE.ZDAEdAGFeADChAAAMABABACC.EDFDAFEC.hAAA..TFGC.hAFA..gGBD.NIEF.fDFEhBAA....hBBA...,1,-16,-43,27
OaCWdXcRGEgZAUQDfeSFLVbIKBMHYNJPT,QGCEDEFHeDBBLGAA..IAAFBBACHCCDJGFAOAEChACAaGDDdAEERBFFGDADhADAZGFEAIBG.UCGC.FHAC.hAAA............hABA......hACA...,2,-23,-21,2
cXGSeZQHJPTDaMBOWYfAdRUIgCLENVKFb,UCCBCFDGLAFCECGA.KCGCFAGE....XACGGFABSEFGhAAAQCEDHFEFhAAAPFHDaGGA.BCDC.hABAODADWCAHAACBdHBF..IADD.hABA......hADA...,2,-27,-20,7
ZXJAfVYdbPcIEFLONRHTUaQWgDMBGSKeC,VAADdHBH....PAEHEDCALHBE.RCFEHADETEFFUFGChAAAQBAGDAFEBEEChACASGHFCFCA.hADAZDCFAIGA.bAFB.IACC....hAAA......hABA...,1,-15,-28,13
BVGPTgeFAbfdOELZNcSMaWRUXKYHCQJDI,dHBHEGDBZBFGSAEH..MEDGRFGBKGEACHHGQBCADDDC.hAAABABAVAGBGDAEhAAA..TBAHeEFAAHGBhABAODAB.cEBEaAGG.UDGF..hABA......hACA...,2,-24,-17,7
JROIBNFQAbEYfWZCgMDKaPVSGedLcXTHU,EHBG..fHBHCBBFDCED.aDGE.SEDGdCADLHEGTGGGhAAAJDFERDCDBBGD.FADBhABAAFHF...bCBE.ZFBAhACAKBFC...........hAFA......hAGA...,2,-48,-18,30
HSPeWGYbUgdJLBTMKREZDFCfOVIaQXcNA,HDAGeCCHGBECUFGCdAFDBBHBKBAAZFDBDGGGCGEG....VBDBIFAEhAAA..aCHBQCABhABA.NIEFAHCEhACAPABA.WGAAYHAA.gDGFhADA...hAAA...,2,-29,-19,10
BKcXEeGNfWIDdaPCFAgLOVRHTMZQbJUSY,LEEGODACHBACMCADZDFC.QGFFJECHUGEA.BHDE.KAHBhAAAECHBeFAFGAAFfADDhABADCDHdGACaBFG.hACA............hAFA.FFCCAHHG....hAGA...,2,-24,-12,12
HVRcYEOGIZKSDNdMfbLWgAJFaQCUXeBTP,JEGHaFAA..UAABBDDGHDGBRAAF...EHAGGGAFKGDB.DIGEMDFDhABALAEEADCC.QCEFhAAAXECFTAGChADA..PFCAVADF....cGGEhAFAODAH....hACA...,2,-34,-6,28
ISWRfQVeGHEcTdBLaMXDgUNZbPAFOCYKJ,CDGFJCCH..SHGERGDG..QEFAVFCHHBAHEAACTAFDhAAAdBFDBADD.MGAAhAAADADBNCIE...PFAFhABAAAHGOCHFKEEGIDDEfEAD...hACA......hAEA...,1,-21,-30,9
NSOUQEZCIGKWcYXPHBgeMbfADdRVJFLaT,dEAERDBGFFAFLCGB.aGEASGEF.QABChAAACEECKBBD.....WHAGhADAYECHHGFAeEFGhAEAfAHGADHHDCFE.TADH...NIDDEGBFhAAA.....hAFA...,2,-29,-26,3
AXLdVKgBRecDCSQbZIUPJFaMGNYEHfWTO,XGGDLDCHKCFCBFFGRFDF..DCAGCBDE..QBAGZAFCUFFE.JCDHhAAAFAAE..GFAFhABAEEAG.HAFC.WDFChACAAIHAdADE...gGAE...hADA......hAEA.SFHB.,1,-12,-27,15
AFGfdKYVICEJBRgSTbLaOWHcZXNeDQUMP,GEAHdAFBKHGE...IHAHECAFRBEA.SBBALEEAaACBHFFBhAAA.ZADF.eGCADEBEMGEEhAAAFBGG....hABA.fHDHCDGGBABF......hAEA......hAIA...,1,-14,-36,22
CfBHPSRNKbJeYGWALTVOMXZIFDaUcgEQd,TAEGMAGDZFGF.FFCDaDDC..UCDA..EBHFQBAAhAAACGGGBGAHSGDCKADG.hABAJABBeAHF.YFFFhACAAIACOEAC.DEIHdFAAfEFF.hADA......hAFA...,2,-31,-20,11
TGVNIHYRQMCAcZKgdEDSFBPbfWOeJaULX,ZDAGKAFBEDFEFHEABABC....fCBAOFEC.aAAAUADBhAAATFFDGAGE..hAEANHBFHDDFRGAECCBF.gEAAhADA.DIBC.SAEF.hAGAWAHHeEEE...hAHA...,2,-29,-22,7
CFHadEZVQLMDbUJAfGOgXRIYBPKSNTWce,OFEFREFHBDHGKBCH..SBFH.TACGeFCDFAABdHGBEBHBhAAAQCEFLCABhABADIGEJFCBGCAA.hACAIHAENECFCAHBaCCC.MADCAEHHfGAEhAEA......hAFA...,1,-13,-30,17
BDLgSWIXJdGFRNQCKaYUebAHfZPMcTVEO,HGFGZAADMAEDTAAF.OFAEDCFDLGFCSEDE.IEAAhAAAXBGD.GCBChAAA.FHAGQBDDhACACBFEaAGAeEFCAHAHfHCH.PBHFhADA.....hADA...,1,-6,-23,17
BPYUFAcWTXeHRSObEQdMLGDCfaIJgVKNZ,TCBCeADGRFCC..OEDAEFBE..QEFHMEIFLCBBDIFCaGAHhAAAJAHBKBHD.BAFF.hAAAPADFFGGBAFAHXGADhABA.SBDGdCACfGDC.hACA......hAFA...,1,-15,-22,7
SGDQJVULfTaPAYHKgFMEcWCXRZBINOdeb,HDAGKAFBMBAAEGHHCHCFZADFBEHB..OEFCdAGBeAACGFAB.DIGAhAAAQEFG.hABAUDDGfDDEhACAaBHHAGCAFBCAWAHB.IHDCSFAD..hAAA......hAEA...,1,-14,-27,13
YQNVOMcbZWUdKHECAaBeJDfLIXSPRTGgF,eCAFJFCHLBFC..IDDF.XEFFSACBhAAARAGFGEACgGGFhABAQGDEOEDCcABAhAAAWFAF.dHGHHCBAADIBDFCE.fFHAhADAFGEDNAEF......hAEA...,1,-13,-15,2
dRTYZKLgICWOGXMJFPVbeUQaHBcDEANfS,SHBGTCCB.ZAACKAAFLBGFCHHG.GEDGXAGCMCCHhABAJCHFFHGG..bFEGQFADhACA.BBEChADAEFADAFFCNAEFdDHARCABYFCD....hABA......hACA...,1,-1,-30,29
cZBXOdLCGIAPUEYFaNMJeVfQDTSRgWHbK,EGFCFAFBMDIF..eCABQGDHTAGASBBBRFGBHCAEKDEABACHhAAAdECACEHGAEGDUEAFaEEH.hAAA...JAEFDIAGgGAEhABAcBGE........hACA......hADA...,2,-20,-16,4
YJZHDWLXUbfcaKVPBERFISGdMCgAONTQe,ODACTCGC..QCDBJEDEHFBFDABCLAAF.UGBEfHEHhAAAaEFDKFHBBAHDhACAEAGDFCDCSECGhADA.dAEFCEHBACCHNIEF.ZABE.XGGF..hAFA......hAHA...,2,-25,-5,20
VXNEZeDFPLRUCfJcQgOBIMWAGSHTaKbYd,SCAHaDAF.KBFCbFED..dFFAXEDBEHAGZDEE..DFDFLFCFhAAARABA.fGGBhABAJEHB.cABDhACAODCBBBGFMAAHADHE.......hAEA......hAFA...,1,-28,-30,2
WBSeZDKQXRPbFcVYUCMTJHEfGIgAdLNOa,LCCHaDCDBGFAZBABKAEHRAAH..FFAB..VGCACFFC...MCEBhAAAJEHFHADFGAGEAHHD.OHFChACA..eHAAhAAAQGAAXCGEcDAD...TFGEhADA....hAEA...,1,-14,-33,19
CaEcHJRSNdUAbBYKgfPZLQWTGVeFDMOXI,BFDGKHBG....fFBBLAEEQDEAGCBFFEFCDDAFhAAAOBCF.XGEEhAAAIHHBECGEHBECSDABhABAdHEBAEBAbACC...YDHHgGBEhACA.....hABA...,2,-23,-20,3
TcRbUNMIYCAEHPVfJDLdWQgSFGBaXZKeO,ECFCHGFG.VAACJFBELHFAdEAG..QCGGFEHFBEAHZAAChABAOECERAEA.UADEMECChACACDEBAHAD.DHBE..SFFGhADA........hAEA......hAFA...,2,-29,-22,7
XQHJDEcZAfMUaYCSeOWbdNLKGPBRIFgTV,UFDBCFED.OCDCdHADKDFCBGGEFFCF.....VDAHXCCChAAAHACADHAAZAEC..ABBG.MAAFhABA..aADH.eHFEhABAWCGHLCAF.PFFAIAGAhACA......hAEA...,2,-37,-24,13
XZDPbOFBgYIKQCecWVASaJLRMHfEGNdUT,SEEDJFFBLAFCMCGHHBAA.GBEFdAHEUAAFZDEGDAAE.OHBAhADAgGAG.hAEAIAFGKEBBCFDD.eHFEhABA.VDAFAIHE.aEHF.EHDE...XADDhADA...hBAA...,1,1,-21,22
DZGQbPHMfWETVFIKJRXNLSAYaedCcgOBU,eCCHCFED.OEFGDIGAGCBH..PAACMBID..EADAFFAFKHCEhAAAXGDH.SADEhAAAAHFHdBAFBFBDQGGHhAGAfAGFWBEGIGGC.JEEAhABA...NDAA..aCFAhACA...,1,-19,-32,13
UZeSPVOYNdATBaXGIJCDgKRMHbQFfLcEW,TGAFBFCFaAFE.GCEBJEFC..DABEKHCCHAFHFGFD.LEAEhAAA.EHGEUEFDZCDFSBBHhAEAPACB.OHDChAFAdBAEAIAACEAHMAIF.......hAAA......hABA...,1,-3,-35,32
ADOcfSHEZVeINMFXWJaRUKPTBQdYbLgGC,DEFHOGEA..SDBEEGBCZACG.eAACMIDGFEAF..XBEAhAAAaAGG.KDFFBHEFhAAAdGACLDAACHHGACCAHCGBICFAhAEANCIE.JEDB......hAFA......hBCA...,2,-32,-21,11
HSXFEdBaMTYDJfRCLKIPbAgQNWecGZVUO,QCBCeGEAZDFAOADCSFAG.EEDABBHF.aBBHMEGBhAAADHAGRDCBLADG.hAAAICHGAHHF.gGDGhABAWHAA........hACA......hAEA...,1,-27,-40,13
eVbgHXFIUaCPQfORTSNAdcKGBMZLDWYJE,dAFBGEAHZFFFLBBCDAAD..JCHHEFHDeCBC..VDCHHGDGhABAFHDG.UBGFCDEGQAEEhACAOEAF..SDAChAAAABIBBHBAMDGF......hADA......hAEA...,1,-17,-27,10
GQMFONJgYITHELCADPZBbdaUcRKeXVSWf,ZFDGdEGDUGBAKBAC..eACGSBDDGEAEFDDB..JEAA..hAAA..IHHEhAAATAFFEEEFAIDEBEFF.bBDEhABA.....aAHDXGGEfEHEhAEAMACH.OHEC.hAFA...,1,-26,-30,4
IYCQKDbSUPEMBXcHReFJVaWOALfTZgGNd,LDACZEFHGBGCdCGHCFDC.QFGADBDC.UACEEAABBCEFHFEFFHBGhAAA.aFAEAAEATDADhABA...NIAB.KBAEhABA.SAHFMACF.XCEDeGBG.hADA......hAGA...,1,-4,-31,27
fYSeRCDbJHUTLXgZdMEFaNQIWPKcBGAVO,VFDFOGEA...SCABCDCGDFAF.JAEGUBFC.LADDhAAAZDECMIDGFHGA.QBAFhABAIBHGPEABhAAABBEGACHA...fABEeFFE.bECD.hACA......hAFA...,2,-29,-26,3
BVMRcNdQIAFCaKUEZYWSbXHeOfLTGgDPJ,FEHBCEFAKACGZEBG...SBACHCAEeCFGLBEGGEDGDFHDBDBDhAAAMIFA..RFDANIDBdHABhAAA.AGGFEFBC..bGAChABAfAGG..TCCC..hACA......hADA...,2,-27,-17,10
BbFRcdXUYKHOQeAPEWMVZLGTgfINSDaCJ,EHBGMECGZCCELFCEGFBB...TGFHfGGFSGAFhAAACEFABCAHFCDA.dDAAXAGHhAAAKEGCOABEAIAAPBBAhABAgGCC.DBIFaHEC.....hABA......hACA...,1,-16,-17,1
OVNcGAWQIdgFEJMLbXBRCZaDeYKSUHfPT,QCBCdHBHEBEGLFFGBFGCZAEHDBAEKEABUAGH.HEBC.TACFhAAA...NIEF.AHFBIEDAhAAA..hABAFHAAMADHbEEB.XAGECGHHaDHF....hACA.SDGBhAEA.OECH.,1,-1,-29,28
XTegPCbEGLQSZVKUfaAFdNJWMDBHIYOcR,FAFBJCCH.DCBGBHGFHFFF..OCAHRDAA..XDGAeCGBCHCE.EGCHhAAALAAEZAGD.KGABhAEAaFEB.AADG.dAGFNBAF.MEFDhAFA...........hABA......hACA...,1,-24,-38,14
ASGTUXaRIHDQcBbZMVePdYJFOKWfgLNCE,GBDBXCCBRAAHDGBEBGFAZEBA..eFCDdGHEFHECKFGC....gDAFhAAACGFEAHBH.SFEFhABAaCHD.HBGDhACAbDDA.PADA..OADGfHABhAHA.NIEFECEF..hAIA...,2,-26,-15,11
cLRJCAHfbZQFBaOIMTUEVDdXWYKGSegNP,HAADZAADBFGCOEFEMHBAUADB.DGEGdDDH...XAFDhAAAKCGD.eFAFPGAC.hADALEAACGEEAIDG.fGHEhAAAFDGE........hACA......hAEA...,1,-31,-38,7
dVgeMGAFCYNUOfcRPSXQKHaLTWBZDJEbI,CFEDUCBC.ODGDRBFA..SDGAQGADKBCDLAEGhAAABFAFDGGCJDDA...IACAhABAVGBE.MFFFhAFAFACA...NEIGfFCEXDDAaAAF..hAFA.WHFEbBFA...hAGA...,2,-38,-21,17
gCHNPbVUfDGBXLSJWFKQIAdcEYZROTaMe,dAFBEHBGRBBFOGCA..aCGAeBBBHECF....PECEbEFAVADEhAAADDHFBEAF.SBDBhAAAFHGAKBADIHEFhABAAIDGZGFEMABGNDDB........hAIA......hBAA...,2,-31,0,31
SZOdLDCFBJQTUYcEHXaRefbPIgNWKVMGA,SDBDZDEDdCDGLFCDCGFD.BBFGQDEGUBAD.EAEGaAGAeHBAhAAA...PBCChABAIHFB..NGABKCHBhACAMDHDAIHC.DEAC........hAAA......hABA...,1,-18,-41,23
XeWUfIGZTLNODMSBaYKPAHQRcgbFCVJdE,QBBHRAAD..gFBHFFGGCHBDdADB.EAFAeECD.UAGChAAAfGGC.GBGChAAATGEGOFEHhACASDEDaDDEKBEFAEGA........hADA.cDBB..hAEA...,2,-27,-22,5
BFWZKGOgDbUSYLQCPNdJecTVaAfXEMRIH,EGFCMECGRAEG.BHEFZDDEGBBBDIGE..SBDHLCHFCEADdGAF.hAAA..eEGHTFDChABAABBA.fDADhACAHBFCWFBE...OABAbGAC.....hADA......hAEA...,1,-11,-33,22
eWTREbaBQgcCYKMOUZLPDAJIXNFfdHSGV,JDACXCBC.FGCDdAAF.SGFGGAGGeEDERAEA..EEGCBCEGhAAA.QABEhABACDFFMFAD.UGGHLDDBhADADFACIGAAfBHAWADAaGCC...hAEA......hAFA...,2,-25,-18,7
PGQLMUWNCTeHSOZdDFJEgbBKaYXARcIVf,RAADVAADGAEC.MEBHUGGE...CBFEHDCESCDDdGAEDGEDEFGBhAAA.BHCFKCGH.aGEFAADC.hAAA....cDGHhACAfFCE..PAHF..WCHHhACA.....hADA.NEAE.OAFA,1,-26,-28,2
VEfQYJcRTLeUbXdCNOIWKGFgaMZPBASDH,DEFEVDDFEHAE..QGFG..JCDERFAD.LCBH.hAAAUGFEbACCXDAEhABACCADOBBA.IDHDhADAKAFAFHCA.MCGBBCGAAAIHSAFE..hAEA......hBAA...,2,-40,-17,23
aTDOedYcVBHJNLWMXPGAFUZbfgQEKSCRI,ZBCF..gCCBQFGEKGCFCDGCaEAAOAEG..dHBHVCFGhAAABAAFHCABJFDG.LFHHhABAMBFC.PFCAhACA.AHGA.FHEE.fBBE.EFAGSBGEhADA..hAIA...,2,-26,-13,13
eATNSVOIDRGPWfCHUbZaJdMgFcYQEKLBX,SGFCVFDF.DFDERCACGDFG..PAHFCECE.UACAhAAAZAAGaAFGdDDFFGADQBGAhAAAEGCGBCFBAFIB...hABAOBAFfGBEJHFE....cEGFhABA.KAFCeAED.hBAA...,2,-24,-8,16
DLERIVMXfZFObAYHQWUCKBacdTgNGeSPJ,QFDHCHHGBBHA.dEDB..TAADGBADeCEDSCFEhAAA.JDAFDADBLEHDhABAEEAGIAFAXGBDhACAfDHCFAGEAFIH...HFDEKGAF...hADA......hAEA...,1,-7,-35,28
ITHEGORBeAFVYPLaWbcNdZgMUXJQSfKDC,FCFCVAADLDBG..aFBA..bEFHdDDFZBAAMGFE.JHDESGADhAAA.DHBEhABAIAHBEADG..hAAA............hACA......hADA.GBEDBBGE,1,-30,-31,1
TScaGAZYbDgQVfBNIUXCeJMHEFdRPKLOW,ZAADDACBQEBEBAHEUAEC...CGHDMBIBFDCFREEC...LAFDhAAAOCHF.SFEFhABAGGBFAIHE.....hAAA............hADA......hBAA...,1,-41,-43,2
HagcSVBWAYXROGJPNTCDUbEQeMZdFLfKI,REFHJHDA..TAFCCBEG.DDDEEFBH..eHAGdGGD.LEAEKAECHBBHhAAA...aEDDSABAhAAABAHCACHH.OCAAhABA..NDAAQDFGFGDFIEEC..hACA......hAEA...,1,-27,-31,4
GATBOfaDMJLZKWNebPIYdECSXQgRHcVUF,BFEEaDCD.JCCAZDAF.KAGE..eDGD..IGDAdDBESAGAhAAAQACGRGCC.VCEEhAAA...FGFDAHHFfABFhABADBIHMEAF..LFFCNEAA.hAEA......hAFA...,2,-42,-16,26
HIECdKOJUgLBfMZXPVbSeNYaWADGRFTQc,GACBTCCB.HDDGCHBH.KBADUFBBLHECBBEDZGFEVGAE.SCFEhAAAeFFA.NDIC.aFEGhAAA.AHEFFAFGQDAEhABAEDAG..dBAH.OCFCfCCB.hABA......hACA...,1,3,-19,22
dNVCHPIYBWEDATKMJXFQOLSafZgGebURc,KBDHMIFGFCAFLDCB..SGCBZBDAeAHBUEGHdFAGCEHDHEEDhAAA..PEAFhAAABCFGDBIDAAEEXFEDhABAaHGG.fABFbBBB.NIAF.IBGHhABA......hACA...,2,-34,-8,26
ALRdDGSNOCTYJKIfebcFPUBHMZEaVQWgX,LDCHdGGEDCHDGDADOCED..CBAG.JBBGKBFD..eEGHFGBCBEGGhAAAMACGZAGF.aFBH.hABA..QGDEhAAAXAGAACCGNBAE...IFEE.fADGhACA...hABA...,1,-22,-42,20
CPNQJUXeBDWgLMZHEGKOaTdfSIAYVRFcb,VGFGRDAGFGAA...CEAC.QGFH.UACGXDCFBDDBDGEHhAAALFBB.ZAADHBFDhABAKGAFTBGFSFDChAFAIEEFAFGC...cDGCNBIC.eACAhAAAMIAA....hAGA...,1,-16,-25,9
VbHUMfXTAJcNKRWQOSGZLCPEIeBYdDagF,JGEAKHBGRCCC..QGBFOBFG.ZBEFCEEC.ECGEBEBB..dABEDHFEhAAAFDCAHABEMADA..hAAATDGFADBF..NEIESECGhAHA..LFAA.hAIAIFFA..hABA...,1,-18,-42,24
DVcYgObZFIfAWCQLRPHaGeMdSXTNKBUEJ,QGGGLFBBRDFAHBCBeCDCdEEA.SAGCXBGAKABHBDAFhAAAEAGADDGF..VFDFhAAAgEBGOAEDFGGHhABAAHEFPABEMDAF.NBHE......cFAChABA.....hADA...,2,-13,-6,7
PceQFAZHTVXODBNCaERdLYWgGJbfUMISK,HBCDVCDB.DFACBCAGCFCH..EHBCdFGF.LAAE..gEFDhAAAJFAEUAFF.SAHDhABAKHGG.PHFChACAQGDGADAEZAEF.XCBFaEEH...hADAWBHHfGAAhAGA.MEID.,1,-9,-28,19
cRDUSPOaYgCdEWfQBFIGLXZeKHbANJVMT,JFBBVFEE..MDDGRCCB..DCADUBAC..SFABaHFA.hAAACDHG.dAGE.EEGBfAAEhABABEAFFACA.IGCEhACA...GBEFXECBKAGEAHHDNAIE.hABA......hAFA...,2,-36,-26,10
CTDZQHeBRMbNfgYFXJaLGPKAUWEdOcVIS,EGFCOCCH..IDBATFEF..ZBFAQGCDBAHERAAF.MCFDhAAA..fHBFhAAAFFADaACFLAFChABAPEHBAIHEWCGFdEAASADFDEEF.eDDHhACANDIE......hAFA...,1,-15,-18,3
GTcHMJQCfEdPNbVXeZAYORgUSIBDaKLFW,OFBBUFDHBCHBDCAGLBDEGDAEHCDG.MCACJDEC..QGGAhAAACAHEdAAF..PHFEhADANABF..bFCHXAEEhAEAZEFE.AEHD........hAGA.YAHFSGGEhAFA.KHBG,2,-32,-9,23
WfKUSTcEHJGOXVdIZAbeRgBaDFPCNMQYL,eFBBBFDDDHDGFGFD..CFDE.MDIDLAAF.KDEHTBDE.EEADhAAAHDGFGCFAXAFEhACAdABCADAARDBAaBCD..NIBF.hADAWEAC..SBHF...hADA......hAEA...,2,-28,-20,8
VgFfSJYNIcaLEObKQPGZMUAWBDRTXHedC,BAEDDEFARFABHABACHHE.FHGEJBCH......IDACaGGBEGED.hAAAKEDGGBFCZAFCMHDAhAAAAIBE....TFAFhABAXEGA.........hACA.eAHDdCFHfDCAhABA,2,-50,-21,29
RFCZQPGdaJHgeSKVEYAcLDOfIUMNWbBTX,LFCHDEFHODBBUCDG.MEBB..bAEDBCGC.RGFACFFBPACHhAAA..aAADJDGD.hAAAeHCAKCBGEAGA..hACAAHGE.IAEENDAC.......hABA......hADA...,1,-28,-39,11
WOGTXaMEIcZAVSKgeCFNbUYfdJHPLDQBR,VFEESAFB.KFEHeBEH.FHACUCCFdFAFHCAELHEGDIGEBABEhAAAOEBEGBGEhADATCGGaAEG..MBAGhAAA.ICADABGB.CBHENEAEfECBhAHA......hAIA...,1,-15,-22,7
gcQYLDVINKFTGeXAJCRBOMfbEUWZPSaHd,JFCABDCF.MGCEEGADZCBC..SHGCdAFA.QEAChAAADHFCVABE.KBDE.TDEChABAeFBBADHGCBBF...OFFAhAAAfDHG.WHCA.aAFF..hACA......hADA...,2,-34,-34,0
JNeAXPKHaCZUfgdBQbTESYWLVGRMFDOcI,KGFCCCAHZEBEUGCE..dHADQCBGEAAE..SGFEhACALAGDGABHFBHHDDECOACDhAEAIEDG.NAICAAACXAEEhAFA.aEGGBEAG.YHFGhACA..WHFA..hAHA...,1,-20,-35,15
OYXVGgfSICAbdTcBaMRPJeZWNUKLQDEFH,TGBCaEGD..RAFDeACBZDBGUGFHLFEDDCFBHACGOEAH..hAAAVBGHGBAE.SHBEhABAADAFdAACBEGGMAIFhADA.WEDE.KGHB.FECH....hAEA......hAFA...,2,-25,-4,21
WeEfdcKgXIZUJDCaMYNRQTALbSPVOBHGF,SDCDVFDF..HBAEGAAFFAEFEBGGfCHEKHAE.IGCAhAAAZCEAUDAFCDEBMEHFhABA.RAFF.AAIHLFFBhAAAOFFDBDAE.eFAD.cDDC.hABA......hACA...,1,-2,-20,18
FMNdcbHOGQZIaXfJSWeTARBUDEVYLgCKP,BADCEDABLDDACFHF.KFFEFHEA.MBAFdBCFHFBFGBFGQAGDhAAAZEBG.aGAHfBBDhAAASHEAeHAEhABAAAFCDABC.gFDE.NDIE.cCDGhACA.IHHG.hAEAWAFC.,2,-43,5,48
SfQNYEMGFIXLbKDJTUdCOWPAVRaHeBgZc,RDDFaDBDBCCBZFGD...SHFAQAEA.EEDFFFBBLBGBhAAAKDAADICA.JBAF..dAGDCCCE.hABAOABCADEEHGDGeDHHhAAAfHAF.MEAFIFFE..hABA......hADA...,2,-41,-3,38
QNXcGTaMVIRFJZAPSYOUWCEbedgfDKHLB,SHBGODACUBCEEEDE..eEGFdAHGDFGBLDHBBHHEQCEAhAAAXAGF.TEBHhABAaFAGMEFH.IHHGhAAAFADHAIGAPBBB.CHDE.bFCDfAEBhACAKBAANABF.....hBAA...,1,-12,-18,6
aNVRFedWKYbLUAgfEHIQTGJPCXZBcDMSO,EHBGQFDHGCGECEDFBFBH.MBDCODDA..aCBHRBBCdEAEKDDFLCCEhAAAAGFD.fGHChABAIAADTAFChACAJAHFXGACDADASGGGNACF..hAHA......hAIA...,2,-26,-13,13
SXOWVUCdBeAJDbTQfRcZFGKgNaHLPIMEY,JFCHDAFBQGDD.RAGF.ZDEFGDFANEAF.LADFMFIH.hAAAEECESGEDhABAOBBB.UBGEBGBGAFAC..hAAATACFFHGE...aGAH...ICAGhACA....hAEA...,2,-38,-14,24
LAKIWZDMSgJeYVQfBbEFHXUNPdRTcaCGO,KHBGZAADSHACeAFE..VCBHBHEFFGFGUEGB.dHGBRABEaHEChAAACCGBLDEH.AICA.hAAADBGF.MEFEJACEQCCAhAGAbFBC.EFBGNDAC......hAHA......hAIA...,1,-20,-22,2
aHSAefGOWXJbYEVRgBcDLMdZNTIUQCFKP,GECFODAC.JHDEEGCD..RDAHBAEADGAHLABCZAAE...IGEHhAAACHHGFDEA.aCCCAAGG.hAAA.eDHB..WDGBhAFAXCCB..VAFAMAIFNIEB...hAIA......hBAA...,1,-26,-32,6
FZfJgVcNDPAbYeBCIOWdLSREMKQTHGXUa,eGEACBBD.ODEHdEFFSCDCRAAF.KFDBQBGH.hAAAHFABGAEFUDAHFCAHhABAZDFAgGGEhACANDDEDAGEAHHG.BHCG.IHAD.EFAAMCCEhAAAaCGE......hACA...,1,-9,-22,13
RefJTHXDNAFcBUKPMYEZbgVLOGQWaSCId,BFEDKGFCMHCCZAAB....VDFALAADGCCCaDCB..CAFAdGGEhAAAfFCF.TAGEhACADHACAEAEFFAG..hADAcBEF.YEAD.EBCGOHCEhAEA.....hADA...,1,-32,-34,2
DXQLGTSKeCUbPBfOYMHdgcNaEZWFJRVIA,XECEQDACLFHDGABDKECH.UFEGBGBB..fGABhAAAMICAdDBHcAEHhAAAaHDCZCGF...JACDIAHEhABAABBBDBAD.eCAECGFB......hACA......hAEA...,2,-31,-14,17
LHZADBUfMKSRNVdXWaGCPEIcYQFOJTgeb,DEFAUGGGKDAERCBF..dFDE..aAGHCAEH...EACG....IACGhAAAQFCC.OFBBhAAATAGCeHFGLDEAhABAADECMDIDSFFDNCBF..WEEGhABAPGAA....hAEA...,1,-28,-40,12
ALIDXcWEZVOgUfaPbMFRGQdJTYCHBeKSN,LFCHDAFB.XDACEBBAOCGB.UFDDaCGG..MIFARCDBdGAAhAAAJFFE..CADBBGHHhABASACGAGGE.cBDDhAAA....WCHBVFAB.fBADhABAFCAH....hADA...,1,-27,-37,10
XEfUPOHDFQAWVeIYGKSdMCcaTgRJZLNBb,VFDFeGEAGEBB.KACBSGGCdGBCMCHF.aFAB..RBAFLAFEhAAABHBAXBBDhAAAEDDG.UBGH.HDFChABADIGC.AECDIAEDcCEA......hACA......hADA...,2,-24,-11,13
GKfWTUOSdECFMaHcYgDLZJIXQbNVPeBRA,KGAHTCBCUGGD..SGDFCBEF.aCHBHGCA..gDEHhAAADDEALEEEIGGChABAbBBB..VAGFhAAABGAC.ACACfECHOCAB.FAEGMABEhAFA......hAGA...,2,-25,-19,6
aSGDQACBbcJRUPKYHOETFfZIeVdWMLgXN,BBBDJGEA.UCFHKAFEHADB..TACGFEEGZFBBeGAA.dDDCMDIDhAAALAFA.XEAGhAAASABHDEGHAHFGhABAbDAB....cGCD....hACA......hAEA...,1,-29,-33,4
YALCSJMZgbEcUHNWaBReQPfXFKITGDdOV,SDABMHACZCCC.EBAAUDGE.HGEAaAEDBFDCRECC..PAEEhAAAfHDD.FGAChAAAKABDTEGHDIGEdEACODCGhABAACEGCADC.JGEA.cCGFNIAF....hACA......hADA...,2,-24,-13,11
ATfQOdWXgSCZcMFNLUGeKBEYHIbVPaJRD,TCGCQDAC.dAADXBEGCHEF.MFIBLAEAGFBBBCFChABAEAEEHGEGbDFDaGHDDCBFhAAA.fEEHhABAOBHFSEDAZCBBNDAAKHBA.VGAA.RBCBAIFE..hADA......hAFA...,1,15,-7,22
DKHCRXeaZgUENdFGfLbVYcIMTPJOBSAWQ,QAFBKEAEHAGDRDDC.aACHUBCA..dHCFFGADLEBC.VFFAhAAAICAGMAIBJDFAhABABHFEAFCB.CHHGZFCG..hAAA.EEHBfGAA.cADH.hABA......hACA...,1,-8,-28,20
HQZGMafFRJCbKEXcTdBSNWPeYADOILVgU,DEFHOEEGLCCCUDBGHABCGGEB.MBBHFGGERFDE..CAAFKACEECGA.hAAA...TAFDhABABAFHSEGChAFA.PDDFAIFAIHAHgAGHaEAH.JEBBhBCA......hBEA...,2,-28,-14,14
EBAcgMfXbYFLeQdSOZKINRJUGCWaTDHVP,MCCAXCBCFGDCLBBDdGDCZEFF..KBFA.RFAB.JDFC.GEDHhAAAaADH.DGGE.HAEC.hAAAEFACAHIB..fAHEhABAeHAGOABAIEHGCDDG.....hAFA......hAHA...,1,-10,-29,19
SNAOTgJIaeZXHbQVEcKLUPdDMFYBfRCWG,ODACTDAC...JBFAaFCAZFCEHDGF.QAFFEDDGLHFAhAAAUABGdBBBFDDCBDHGCGAA.hAAASGAFAIHAeHCA.hAEA............hAGA......hAIA...,2,-35,-13,22
TSOWAQZIgMBUKbCcdaNEFVDXPYGHLfReJ,ZEFHMCCAKEHB..CAGCdDAHEBED..FDAHDDGA....XBBFhAAAGDDCfHGFhAAAeHCGSCGAAHFGQFAChABAIEDGBACA..UGAEaHBE....hABA.NACF.....hAHA...,1,-27,-28,1
WaZbcgPYOFdSeIAMJXNUGRfQCKLDBHVET,MIFGJDAC.UDDGGACH.REGD.CGBALGDEHFDDEHBE...aDAFbCFAhAAA....PAFAhAAAFFABdABC..IBBAhABAAIHA...fFHEDCFABEEB.WCFBhACA.....hADA...,2,-33,-13,20
eMdENJHDGOATISYKBaLWgFbXUPQRfVCZc,SGFCBFEDLFHFFBFG.UDAFRDDC.CHCD.eCAC.dCHAEBFAJHFGDHEChAAA.GACCABBE..hABAIHAAaDFF..hAAAbFAEQEBH.fGDAhABA......hACA...,2,-30,-27,3
LaEFBWgMAcVTZXKCQYNObIHdURJDfPGeS,TFDHKDAFQBAA..OAHHHAGFRFCGDDBCGDDDeBCEaGHHhAAABGAHMEEGAHGH.ZEAGCHHANABDhAAAdABC...fGAHhADA.LFFBFFHB....hAEA......hAFA...,1,-15,-17,2
XTedMCUEfYcKWFGJOSNBZIPALQHDgabRV,QAEGDHCE.aABHVDFE.eADAdGDDUDCCEHGA...fGAGhAAAKDCCFAHFGAAEhAAASCGCZFDAAFCF.gGGGhACA........hADA.XEGECBFA.hACA...,1,-16,-28,12
LVBOaWMGcbdeAENSgXPCJTRFUQIYZKfDH,EAFBSHBG..PDBCTDAAUFDDQGEDZAAC.DEEFhAAALAHHVAFDBHHEhABAaDAHMEIH...hACAcGAEdCCFADDBXFAACGGDFCFH.IDHFhADA.....hABA...,2,-23,-11,12
cTMEWJRfBgKFGCeDYdbZaILAXVPUSNHOQ,VEFHSGFC.OEADTGCH.EAEBJCEC.BEFGKHAAFCCEGBCChAAADBAC.dBAEZDAFLHEGhABAAAAE..XCFEhACANAIE..cEGA.....hADA......hAFA.MIEAWHAA,2,-21,-21,0
IUSJBNWELKVRHZCOYQGFfagecDTdAXMbP,MFFF..bFEEUBADSACBBECCEAHBLBFG.VEBHhAAAHGAEZDDCOCGH.hABA..YFDHhAAAFGAHfCBCaBDC..eDAFDIGGAAFCIGGFhABAJHDEKDHB.....hAEA...,2,-15,-11,4
TePLfbQYXMCUKFSZWGcDIHaJRgVENdABO,OEBETDAC.LGACQBBFMBBCKEGHFAFAZDDEGCDD.DIEGhAAAaHBEREGF.EBHD.AFFDBHHFhAAAfGEBXAFBhABACDAHSCAE.......hACA......hADA...,1,-14,-24,10
ceNMOLAHRGPCUZaSQfFTBIYVdbEWgKXJD,RCADGGDHCFED.UGAHZBGH.QBFEFFBDBHGG...VBBHdEDF.EAAFhAAAKACF..DDIHeCDGhAAAOECCLHAAABEDaAFG.hACA.SGGE.fEAEhADAIFHAWAFC...hAEA...,2,-38,-12,26
SOAgVHZUeXcFTYDPCaGdEbJQWfBRLNKIM,VGFGZBCDUGAH..eABC.FEDGDDAC.CEGHdGGDJHBE...QEDEhAAABBDGRAECKFAE..hAAAMABEOCGFHBEE.hABA....cGDC...PAFGhBAAaFDE.....hAFA...,2,-34,-25,9
RbOgeXVWGNKPJTAMDfSLHCIUdYZEBcQaF,DDGGLCCHCFBG.UGDAdGFEZGBEBGBH.QAAFFDAG.RADG.OEEEhAAA..gEFEhABAeFHH.VBGBhADAGABF.KCEF.JAFAAHHHMCEH.SGAFhAFA...hABA...,2,-36,-13,23
VOEaRcIZHUDFGgATXCMJYfbWPdLBQeNKS,CCAHJCHD......bEBCdAEALHFAeGFASGDDEHCE.hAAAaGABIGGG.hAAAZABFUCBBDBIHFAFHAEEBTABFhABAMAHB..fDGE.BDEEhADAKDFF......hAEA...,1,-26,-31,5
VJeXNZDSOFCIGaWTcPdKBUMEYfARgLHQb,RFDFLFBBQDAGJCAB...eBBCZAGHOEHFFDDBCAAC.GDDFhAAATAGAdBAF.KFGDBFBAhACAEGDE.AFHHHFFB.bAEBhADA.....XDGADCEA...hABA......hACA...,1,-2,-26,24
PgTCZDAeIacLfGQMXOFKNbWUEHdYRVSBJ,aDCDLGEAGEEDXBEEKBAF....bGBCUFBF.dBBHRAFHBDAAhAAAPEECCBBBAICGeDAChAAA..IHGEhABA..fADBMFAH.NIAF.ECEBYAHDhABA....hACA...,1,-17,-27,10
fYVNMbCIHEJgaTPRQDSXcAZBOWedFLKUG,ZFEEBAFBOAFEdHDBFDDFKBAH..GABE..fEBChAAAVDFB.MCIFCFCE.HDEAhABAJAHB.aCCE..TBEDhAAARGAADADC...SHAAAGIHeHDA.LEADhABA.NEIEIADFhAHA.,1,-10,-30,20
PNAUDZHTGgaQfOIbJXBEFLeMVKdYSCWcR,UFCAHBCFTBGDGCBBQFGBOFAGJBAH.ECGHLFGF.hAAAeFEHKAEAdBAHCHAG.cEABhABANAEB..DEFAaHAChACA...fHFB....hADA......hAEA...,2,-15,-15,0
FbPCROAJZYQLKDeHUcaBTGgSVNIdXMEWf,JFBBQFDHLAACKCGHHBBAUCABBFHC.GDDDSGCDhAAA..VGDENIEBdAGHMBEAhAEAEGGG....fEEDhABA.bFABCFACACIFDDDE...eBBEhACA.....hAFA...,2,-26,-4,22
AUPEQMFbcISBfHNKaCZgXdLeRYVTWJGOD,EGFCMBDHFDAG....bAFGSEDD.HACDaDHBCBBHZEFAdEBEhAAAeGBGRFDD.VAGBTGGDhABA...JHAADCAAhAAAPDFFICEEBDAFNIAH......hACA......hADA...,1,-8,-20,12
NAHeQEYXMagRFKLTCSGVPUbcIDfBJdZOW,eBDGEGFC.MABEREACFAGBLCCD.CEHDGEFCUBBG..IHCHhAAABGAHJAFAdEFHODEHhAAAAAIF..HEDBXGDChAIAaADDKCGASCHB....hBAA......hBBA...,1,-19,-25,6
gFOMAIQSReCTbDHfWBELVYJcGNdaZKPXU,SGFCRFEECCFE.DCBAHACDBHCBLBHH.VFBHJAHDGDBHhAAAdCAEKCEF.UAEF.hAAAFABEAHIF.eFADfEFBhABAEEGE..NIEF..aFCE.....hACA......hAEA...,1,-19,-24,5
EXcZHCaMWReSQfgDdBFJGAbTPUOKYLIVN,TCBCUDACOHCE.LEEGIAAF.EADFZFDAHCFECHHH.aBGAhACARACH.QFAEhADADGAEFAEAGCEFAIAAbEDCKGHD.hAAA............hABA......hACA...,1,-1,-25,24
NWaGXcdbJAZHLEDQVFgMYPCfeORTBSIUK,ZDBGHDEDDFCGFAEB.MHFCCHEF..ODGHRAADBEHA.UBGAKHGA...hAAAaFCCGAGE.dBAAhABAbDAAACDHLACEhAGA.EGBF..........hAIA......hBDA...,2,-30,-29,1
TPaLXGRUbCEVfIYKQWJHBANZDcMOSdFge,DHCEOCHDFGHH...eCCEaBFH.GBAC.RAEECGDHECDB..VFFEhAAAIECF.KAABQGAChABAHAGFAAEHZEFE.hACAMACF.dDAEPDDB.....hAAA......hADA...,2,-29,-11,18
HVaGZQRBNTFICYAbDXEUdgMWLSfcKOJeP,DAFBXFCAUGFE.dAFB..MDEFLCHB.SCCEhAAAKDAFOACDeBADHGBEaEAHQBAAhAAABDDGFHGACHDGAHHGEECDhABAfCFA..PBGB..hACA......hAEA...,2,-28,-16,12
BbJCXeAcGDMNLUgYOdWRTIQEFZfaPVKSH,GDCCMCHFUCABOEGF.dAHGREDH..QGBGZADGaBBB.KABGSGGDhAAABDDF.CFACAIBAhABANBEH..LGFAhAAA..gGDH.WCEBIDFEhABA.fEAAhADA..,2,-30,-24,6
KDSLCUHgIeAfbXJQYEcZRBdTMaFNVOGWP,XCBCJDAC..EEFGRFBGBFHHdABG.MAECaAFC...FBBAVFCBhAAAODFE....hAAAPCFADDEFCGGG.UGGAhADAIHBAAGAA.QBFB...hAEA......hAGA...,1,-31,-34,3
GXUJRBdHPQaeITYfFCADcZObgLWKNSEVM,ZFDGOGEALHCAKGBH.SDECEDFF.MAABUABB.BCEHhAAAdAEC.QEBDhACAIBHATCBDFAGBAHEBDDIDgGAFhABA.NFBB.......hACA......hADA...,1,-22,-38,16
NWQAMKSJIgTVcZUCGaXHOYFbePLERBdfD,SHBGJGEA..TFAHVCCHUCGBGAFAHFEGFBBCeAHBhAAAEGBEBBAE..DIEEQADFhAAAAFDBKDHF.IAHFhABAZDAECADFaEECYEAD.LHEAhACA.....hABA...,1,3,-26,29
JNdgBTbHOQXDAGfZCUVEFKcaPYSIeMWRL,GEDHCFDDUBDH.FHGA.KDAB..aBAD..SEHHeBHBRGDCLFABhAAAdBBHBAGGHCFBODDGhAAADFIFAHHFZFAA.ECHH.hABA....YHAAMEACNACB....hABA......hACA...,2,-28,-18,10
JPYDSbITQUXgEadCKcGBZeHNMAfVWFOLR,VAADOCCH.REEA...JEEBDGCB..SGFHTAFH.QADBhAAAXGGHEACBaFCB.hACA.dFHCCDHE.GAGChAEABDDEeEADMDDAAGABfFDG...hAGA......hAIA...,1,-18,-29,11
RVCfEWFdUKSHGZBYPLgDIcXAMTeJOaQbN,MIFGTFCA..eBGHJDEC.QDBE.RAAC.CADGEBAEdADAUEDEhAAASEACZGAABGGBhABAPBHFDIAA...IHHDhAAAAFBDOAFHaCDH.bFAD...fFGAhABA...hAGA...,1,-15,-22,7
RVWaQAOPfTSKbNJeFCGUEBIXLZHdcgMDY,OGEATCBC.KGBH..JFCACCDA.GBFCBDFHLBBBdACB..hAAAMEHBRAFG.aBABAAHA.PHBChAAA...fDEGhABANIEB.FAHBIDHG.XEBEhABA...hAFA...,2,-44,-20,24
WSbBKCaJTUFDYdPOZIAGRNfMXgHEVLcQe,GEDHRAADMBGD.HGBGLBEFeCFGSAFCBGGFKDCH.CGHD.JHBETABHhAAA.DECE.dDAAhABA.OHECIHHGhAAAAIBC.NGAH....fBHA.XACBhAFAEBGE...hADA...,1,-7,-33,26
ZIeYBKUHQJaDRVGWgXbMPcdCNOAEfFTLS,EAFBTGBCLDEA.ZCCDeCEAKHGEHBABJBAFREBEGEGC..hAAAWHAEXAEF.hAAAMBBCdACFNAIG.ABAFSAGBhABABGEA.aFFGDEEG.....hBDA......hCCA...,1,-15,-16,1
JQHUgKRMAeENDZYPCTGBIWSdOVbfFaXLc,EDCDZFDGCBHCBAHF..SDECOCFC..VAACFADALEHBhAAA.QBABhABAgGBAMIDEAFECDADEPDCBhACAIFBG.bFGDXGAGHBDDKGEC.hAGA......hAHA...,1,-15,-24,9
eSdEQVYCaIHGMLWJRNZbKfFTPgBDcXUAO,SAABEFAA.QBDECGHFaDGHGABDMAIFLCED.hACAJHAGNHBFKFADFCAF.TDGEhADABHEGDAHDUGFAAGCA.dFCBhAEA...IDBG.....hAAA......hABA...,1,-10,-34,24
ATfLGEbVCOMKBadWIcSUDeNHgFPXJRQYZ,TDACGECFEGBD.CAFB.OACFBAABdCBE..IGEBUBFHDEAHhACAHCFC.PAFEhAAAXDGAJFFC..YCDBhABAAIAGLADBMICAKHFEaFACSGGEhAHA......hAIA...,1,-5,-25,20
SRagPOQeFVbWDJdcZHBAIEKGfTCYLMXNU,EAFBGEAH.CBHDLAAFXGEG..SCAGRBBA.aFEAPHFChACA.OEDAhADAQABAFFGG.bDGFDGDGhAEAcCECBDHEIHAHfEBBTAEFhAGAMIAE......hAHA...,1,-16,-19,3
fKXPIdLDWJVEaYOACeTGHRFZSNbUBcQMg,eEBEGACFHFFFZDDBSHGAUAAFQFBHMFCH.KAEH.ICHHhABADFGEJAAF..EGAHOEHDhADAADDD.CCDE.FHDGNEACBEGBhAEAfDAE..dEEAWDFA.YAFChABA...hAGA...,1,-7,-16,9
SMYdJeARObUVDQTKFCZNLcWHIXafGEBgP,RFDFODACUBGG.DBADKECHZAGB..LEADHFEEaFAAGABH.EGHFhAAABDFG.SGHHhAAAdCABAABAQFFChAEACGAENBIG....IBCGXCEF...hABA......hACA...,1,-12,-35,23
FQCJaOMLGceSKNRAfbEgDUdZYBVXTPWIH,EHBGDAFBdEGHBBBF....XGBHTEGB....PFDEhAAAIGDBQBGEhABACAAEOCEBLFADGAGCeEADhACANCCAAEAAfBDHUDBE.YDDAhACAWFFGFADBaADG....hAGA...,2,-17,-17,0
HgXCdLUfKVSYWMAJTQZeFDacbEBIPNORG,JDCHQCCBZGFA.FGBDDGAG..aHEAEBDFBHDD...IEFAhAAAOAFGHEFG.hABACACAdHBFLACEKCAF.hAAA.SEEFMAHBAFID.eBFDcEBA.hABANAIEgGGBhAGA...,1,-22,-34,12
YFdMQXEGKZNVRbUITSePJfCcADWHOBgLa,HFDGOAFBLAAHFGHB.dCHGMICCQDDCGECBKDHFVEAHUAAFhABASHGA.hADAPACBCBDBABHGDDCCBAEFhADAaGAD.ECEE..NHCB........hAGA......hAHA...,1,-5,-27,22
MfRQGXOaNCdEIADBLVUbYcPKHgSWTeJFZ,LFEDUFDH...bDEEPCBB.KGAFSAEB.hAAATGAGFGGHMBGFQBBBhAAAOBBGCDDGdGGFAEIBDABEhAEABHCH.cCAC.WAFH...hAFA.ZCGB....hAGA...,1,-10,-35,25
KUcOVENHPIXgMbAZSRWeTQBJDLdGaYCFf,SDAFRFDFeDADBBCDLHAGGDGA.CBGCFCCHUDDB...OFBDhAAAVFAAHGFE.IBEHhAAAgAGAMFDAhABAAGIH....WBABJABEDEEEaGGH....hAFA......hAGA...,1,-17,-20,3
NgfIFbSWeTaLUQVHRKEXJcGZDCdMYBOPA,...fFAFFGFHSDDDeFFFaCGCQCFDHDBC.EGBBXBAEhAAAGADCDAHHCHBGMEFAhABAOCBHABDD.IAAEhACAWAFA.UEGFKFDB.......hACA......hADA...,2,-17,-17,0
IfFOWgRSZAdQCGeMBLVJHaNYTDEKPbUXc,dFFBCDHHGDCCBCHBLGBCHFEB..aABHTDBBDGBB..EAEAKBAFhAAAUCEC..IAEHhABAODAH.RBFBAIBE.MFIBhACA...........hAAA......hACA...,2,-33,-32,1
THLOJCecaIGNUYAWRZEMDVQfSgXKbdPBF,RGFGEHDCMEEHDCGD...QBEESCCDKCHBdAGFBAACHEGFLCAHhACAOAADCBHD.aEDENADE.hAEA.ABHH.ZADF.fFABhAAAXEBHPHAA.....hACA......hAFA...,1,-20,-23,3
QTaXEHGeDgdbOUJKRMALfIVPBYZCcNWFS,LGEAVAAD.BBHCCGEG.....NDBGFFCFTEAA.ECGGGEEDhAAADFDE.dCECUCDAhAAAKCCHABAG..fAGBhACAPADE.ZFGF.SGBA.aADEhADA......hAEA...,2,-34,-26,8
deRUNWXPbDAHMKfcVYSLGJFQZaTCIBOEg,KAABVAADLAEG.FGCCaCHD..CHFDBGFEEFHBeAHF.RFDDUDDBhAAA..XCCGhAAAPEBF.DADF.MFCGhACAfBEASEGE.JFAF....hAFA......hAGA...,2,-42,-17,25
aKUEWVecCHdLNOfBbFGQgAIXDPJRZYMTS,XAFBDEFHRAFEZCEC...MBDD..aAAHKHBGUFAEEFFF..eABBhAAACDBG.LEHH.hABANBFABCACGGEHADHAJEDDhACASEGG..cEAEdGCA...hACA......hADA.fADC.,1,-14,-30,16
EZecMSHAgLOUaXNfDVJFRKTGPICbQWYdB,LEEGUAAD.aAEAXDFD.DEBEJCCD.FHBEKFAGGAAChAAACFDE.QGEEhACAdHCBBAHAEGGEeAHH.MEIFhADASADFAFDH.OAFBfHGB.hABA......hAGA...,1,-9,-45,36
CRHKPLFEZXOeGgbVdNASIWBUafDQMcJYT,SHBGBFDGaBBD.DCCHQCGA.MIBGJBDCCHFD.KAFELBFFhAAAZEAG.OGFEhABAGFEBbEAFVCGFAIFAIAHDhACA.fEEEYBAB...hAAA......hABA...,2,-36,-14,22
feJANYbURLZaGIDWBQVMcXFOgHdCTPKSE,...bCAARADGZDAF.aGFHGBGE.DECFBGGFMBAGFDFHHFFFCCHF.hAAATEDDKDHB.fGAEhAAAJHAA.NEIGUAEFhABALCDF.IBAF....hABA......hACA...,2,-42,3,45
ODAFdaVcbSPfMJgeYWKUCBRXNQZLGTIEH,aDABVAAD....SBCGMDEB.JGECeCFH.KHGECGAGBCGFhAAARGBAQDBELDEAhABAIAGHOFBFACAGdAEAhAAA..PEHDfFGF.WAHHNBED.hACA......hADA...,2,-36,-11,25
bXFZUeKSHIdYQELRWfgGBMcaVDPATOJNC,TFCAOEEG..JCDECBHC..FAABUAAC..KEHDHFBBdHABEGHFRDAH.hADA...fADFhAGABDBEaADFDGFBADIFXGGEhAHAZCFCSEFB.IBCD.hAIA......hBAA...,2,-28,-28,0
TaLeEYgJOAMBIHScFPQWKNRZdCfUDbVXG,MBFHHDBHFFGH.QAEGKFGFRFAAdDDEUACBDBHF....VAAChAAATDACLDFA.hAAAeGCAEDHDJAFABGAGSGDAhABAWHFA.CHCD.XDDD..hADA......hAGA...,2,-25,-15,10
gcUSOHMaETBCIfNVYRZdJeFKAXWbPGQLD,XCBC..PFFCGAECDEABUFFHHGAGaAGEBEDC.CBCA.hAAAIEDA.NGAD.hAAAYBEC.dHEBhABAJHAEKDGAAABC..WHDAbCBC.....gACFhAGAOCFBMACEhAGA...,1,-17,-30,13
CMgJAEWSTcDKXFRYOVHeIaBPGUfbLQZdN,EAFBTGBCKEGB..FEDGRAEA..OFDEHABHaGDEBBBF..GEBGhAAAbCAC.LAGBZCEECFHBMBIDhAAAAEIDSGGAhABA.DDDEYHEEIDAEfEAAhABANIDF......hACA...,1,-3,-24,21
IXdUBGMZJWNHaeSEVTfDFRAYbOLKgQcPC,OGEAKDCDQDGE..CDEAXBAABFDGGBDEMBGHJHACHDABhAAAeFFBSEDGhABA.EAGETAGEhAAAFADDAFIF....YHDAgBAHICHGhACAdEAA.....hABA...,1,-10,-25,15
cdVZQFeEfSHWLRGBPaXCbOATIDMNUgKYJ,TAFBMCHFUCBA..KGHD..JFDGVFCGZAFB.FHAG..EACESBDDhAAALFAFBAAGhABAaCCH.CHHH.AIFADBBD.hAEA.NCIE...cBECdFCCeGEA..fEEBhABA.WDADhACA..,2,-29,-25,4
EbJWFfBKVUXNeAgPCGdQIYcDaZOHMTLSR,CFDGdEAB.QAAB..cBEBaDDFHFGDLDCAEDFGJAHFFHEGhAAAKGCCUCGB.eBAHhABAABGH.GEAEDIEEMCCEhABASGGBbFADBADC.......hACA......hADA...,2,-25,-6,19
aPWEfZFeADYQbCHXKBdSVcRJOgTMNGUIL,DAFBQCBCHAGBBGDGSDADRBCD.OAHHTFFHGEDHhAAALBBDaGDD.EGAAfGGFhABAeEECAHHE.YFBBhACACAACKEAD...dBDF......hADA......hAEA...,2,-20,-13,7
agcLVSfBAeJZNHIXWYRPdTCKbOGDMEQFU,ZFBGHAAD.XCCARAACdAEACDHE.OAHBGDFAEGEH..UDAE..hAAAaGAG.LADEhAAASAHHAGHANEGE..WEBGhACAPFHDKGCB.DAGFMCIFQCCC..hABA......hADA...,2,-23,-1,22
WNCXfcJQYHebZMDLGIKaEgVOSdRFPUTAB,BFDGCFDG..XCBCJCBCHCFDZGDEDECFLEEE.KADEaGAHEACDhAAAODHF.RFGB.UGAAhABAABHG...fBFDhAGA..QAEFeAHBMDEEIEEFhAAA...hAIA...,2,-38,-22,16
JPVSHcCfULNWIDKXBgFAeQEZaRGbdTOYM,QAADEEHBRCCA.dDEDOEGHMFBG.JBEASAFG.CGHBUGCChAAALCBD.IHAAhAAADBIFBHFBADIHaACFhABATGAE..PEEBHCAA...fAGBhAEAKCEC...hACA...,1,-19,-26,7
egZOMWXbaLHTcSfCIVPFNBAREYDKUJGdQ,RDAGEHFGDGDHKAAAGBCH..QEEEeBHBZGFA.MCAA.XFABhAAAaGBBHEFE.SADChAAAfBEACABF.IHCEhACA.FADGBFDEAIEGYAGF.hAGA......hAHA...,2,-19,-16,3
aPOXWVLZcFNQJBKIRYATEDCbdfHSGeUMg,DDFFdEGDHACBGGEHMAFA..aDGDOEAF..XGAGhAAAVGCGLDEEFBFAJBAABADDhABAIGHHAGDB..CDDESEAAhACA.......hAAA.gAEGhABA...,2,-31,-27,4
GXQgcaJeIEZYbSCBKWVHfRNFDOdLUAPTM,MFFFXCBH..QAFBaGHB.JBCFEAAEZEGHSHCAhACABCECKAADHEAGRBFDFFEFdBDAhADAADGA.TGAE.cFBAhAEAIHCA.CCAH.fAGB.hABADGGFOFDF..hACA...,2,-29,-1,28
JeLKdNDaORZQEPTCVMUXAIYHSFWBGfgcb,HAADSAFBBBGAGGEB..fABDbDBALDHBdFEGaFBEhAAAOFBEZCCGPFGHhADA...CEAEMBHBhAEAACAFFHAE...........hAAA......hACA...,2,-24,-23,1
THDLCXNEecdbKMBAOaJWGQRZFgIVYfPSU,aGDBGECFZCCA.FDCG....VEFAPBEAUBGFDBBCLCAHhAAA.CHBE.XCGAhAAA.NCAC.EABEeGEAdECFMADAhAHAAHIDOGAE........hABA......hACA...,1,-19,-27,8
HNYDgOXGCadIceQZUfFVAbMSJWPLTKRBE,MHFGJCCHLBEGRCCC.HFBDDCBFOBGDGEFGCACGdGAD..eFADhAAAZFCBFAFBAFIB..SDHFhABATABFBADBNAEB.hADA...XGDDcFEG.....hAAA......hABA...,2,-35,-7,28
ZIUQOAWNHDTXGcMFLfgKaPEYRedJbSCBV,HAADTECEXFBA.GGEHMEHHfFACaDBE.EAEAhAAARAGFdAEC.SACHhAAABCDHZEEFIBAGhABAOEEAAIEADIAEFHBCKCGF.......hACA......hAGA...,1,-8,-18,10
XGBCMdHNDESTWIQVRUbceZgFaLOAJKYfP,KDCD..PCCHBGFBdAGEDAEE.EDFE..SEDA.TBGChAAA...IHGBhABARFBCbAACeFHDgEGFhACAaBDDAIGEJDAB...fHDBhABACACHMFBFWBEF.QGDFhAHA.,1,-29,-35,6
TEVSZUAWLcKODIfaJFHYMeNGBbRgdCPXQ,LGEAOCCHDAIHaCHHHACD..eBCBBEGERAFCdEAECFDB..XAEHhAAATCEB..EEFHZAGHhABAABADKAACJGFA..MEAFhACANECE.GGBF........hAEA......hBAA...,1,-18,-20,2
GQJIdYcEWRLFCAabXOfPZDHNMgKTBSVUe,XGBCOGEAZFADHAFH..MCCEKEBGSACDeHDEGDBBIADGhAAAdBACEAGH.LEFChABAAEAHaDGA..PEFChAAANEEABGHA.UGFE.......hABA......hACA...,1,-12,-15,3
FcZEWVSBGeXaYIfOLKPCbRMHNgJdAQDTU,DFEETFCAFCADZCDA..EAEC..SHBCeDABXFGB.hAAAaCFCIFBHLAAEhAEACAHBRACEMIECHFGBJBBFAICE.hABAcEECBAGD.fAHA...hACA......hAEA...,2,-34,-1,33
BFDeXcdJUVPaETgRbfWGCZSMAOQHYIKNL,QAEGHAADKHACBHEADACF.eEFEdEECUEBF..aEBEEGGHTBEGhAAA..bGACfGHChACACEHEMICA.OFFFhADANDDHLAAF..FCCB.cBGE.hADA......hAGA...,2,-20,-11,9
NOgQXBUGLcVKaHMbECRTZWSdYFPAeIDfJ,eFCHDACB..JEAEODED.QGFHBAEFLDFGKCDEaDBAHEDDhAAA.MFHFEAGFCAEARAGFZGAEhABASEGE.hADAFEABICDAfABFNICF.XBAGhAAA.cGAB..hABA...,1,-21,-24,3
HTJFcAPWEMGOefZVCXKaUNBDdSgbILRQY,EHBGMGEAGCGE.eEBCVDAE.KCHFUBCEDEIF.dABG..SGBAhAAAIGFERBEBQACGhABA.HAFEhAEA.FEDEAAGAODABCHHENICBBFAD.....hAAA......hADA...,2,-22,-14,8
TDRdCVOfMcgJLaIPWAKZEeHBFXUQSYGbN,KEHBZDEDeHBEHGFABBFDFAHH.QFADGACG..TAACDAEGCACBOBCBhAAAMIFA.JFDHLEHHhAAA.aCAHIEFBhABAABGHEFBESGAFNBEEdBHE....hACA......hAEA...,2,-21,-9,12
GgKeSVEYRMJNHcUIZCBaLADFbdQPOfXTW,DGHHFAFBdHAFOABB..XEGGGGAHeCFG..SHGAhAAAEEECMDDDHADEIFEFhABABEGALCAChACAAAFGPDABWDEC.KEAG.......hAAA......hACA...,1,-22,-28,6
TMbLeDFREfBIVOHYaGPQJdWgKZXcSACUN,UGGGMFFFLCBCDEEH.EFAHBHDG.OAEHaGCFGAFG.hAAAQGGFdCBHKGEBZBFHhABASAACCACC.hAFANEBDeACCFHAA.IEHE....hAHA......hAIA...,2,-47,-11,36
gVHKTFafcGCBPZdMILNUJeSOQXAERYWbD,ECFCRAAD....bDEBDACG.VEDAHBFCKBBFTEAH..aGGEfGGBhAAAGEBCCAGCBBHBhAAAdADAIHAE.hABANEEC.JDHBODHFAFAC..WHDG.FCDB.hACA......hAFA...,2,-23,-11,12
KWAcZDYaOCPTSJQfVLIMUdREXFbeBNHgG,DHCEOCCHCCBA...SBGDJCEA.QGGALFHDUEEGhAAAEHAEFEFFBHACHFBC.hABAGADCKHEAABFEZBCDPAAGhAFA.fHEBMCAF.XAGBhBAAeFAC......hBDA...,2,-38,-5,33
WLXHDCcKYQITNAGZgdFfUPJabEROeBVSM,GEDHZDAGFADBUAGGJGBG..EBACRFFB..BGDDMABA.LCDChAAADGBB.CAFD.KFHH..IHGEhAGAAEFA..dABGhAAAfEBHaBFB.OAHB.SGGEhAIA...hAFA...,1,-17,-47,30
ZLAFJGfBUYOeCgVcaTKMWHQXdRbENSIPD,FHAEGECFUBFEeAHH.CBDD...VFEFTCBBKECD.HAED.XFGAhAAARBCBEFAF.IGADhABADAEDAIGA.BDADOBABhAAAcABG.aHEGMAFE..dGCE..hAEA......hAGA...,2,-34,-4,30
ERHLcATFPSaIXWUNBKDZeMVCQgbJGOdYf,FGFCSAFB..aHCGXGGEUBAAKBFDDFCHZEEC..VEDBhAAAQBGG..hAAAbCEA.OABDdEBDEACEhABAHDAAAAEE.TADC.IHADBCCB.hAGA.MDIFCFHC...hABA...,2,-24,-18,6
SNWTRIXJdDHfMYgBVPKcQZUCeGOaLbFEA,SHBGTCBC.RBDH.XFFBDDHF.HFAGMFAABAACKACEQGFDhAAACADAOFDDaAFEFFEBhABAAFAA....NAIEJDEEhACAfBGF.gCBD..hAFA......hAGA...,2,-33,-18,15
HgfBRIFKNacSYVJXQEDWbTAUPCeLGdZOM,CHHGGGCBZABAHAFBBHHGFCCBaFBB...SAFAJHAG.QDEHhAAAEEEGDGGE.TBCAhABAAHFDeEAH..OADGhACAMAAF.fCGBKDGG.YBBFhAIA.WFFA...hACA...,2,-34,-7,27
CLcHVDdGRXYeWFAMbEIaZBgOKSNTPfJQU,MHFGEHBGZDBDBBBA.KFCFTFGE..JFFACEGCLAECHCDADBDAGAGEhAAARBEBeDEDAIHA..hAAAaGEBSACFhABA.NBBC.QDAG.....hAIA......hBAA...,2,-28,-17,11
CWKUHcZDELbgTABFRdQfYGPISMJeOXNaV,FGFHQCCBGDCC.SHGAeACG.ODFGXAGD.VCEBhAAAKAGDUFACHBBHDBABhABAbFCHAHEEBEAA.fGBEhAEAIBACJFEENEIGCHDA.......hAFA......hAGA...,1,-7,-21,14
IfEJeFNGaYZLCPbHWBKVSMgdTUcDRAQXO,QDCHXDAC.OAGBEBCH..eHAEFGECaHCCZFGDCAAE.HAGFhACAKBAFSDHBhAAAdDDA.TFAEDFGBAFCHIGDChADAfDAANBFE........hABA......hACA...,2,-31,-13,18
NfTFZBgRKEXHcaQJLVGOCDUYbWdMPSAIe,eGEATCBCFFBG.BHBFKAGFHEDC.aACGLBBEGEGCCFCDDEIF.hAAAUCDF...bAFAhAAAdHDB.SBFDhABAAFGA.fHABgDAC.EEEB..hABA......hACA...,2,-31,-11,20
HcXdAVYWLEFZGeIRJQKNPbgDCSUOBaTMf,VAADLGEA.FGABZFEDeAFHRFBD..KBFF..PCCBDADFCGGE.SEFEhAAABDEG.MBIHhABA..fEAAhAAAcEECAACC.EAHFIBDDQDGE..hACANBBE......hAEA...,2,-35,-18,17
XVfQbHBPYDaFeSAGOKcMZdRTgEJNWICUL,OCDGKGFHMFCAdFAA.RGDA.EAFC...JBCAIHHE.CCHG.UGCGhAAALEEGVCAEQBGEhABABDBF.DEHFhACAFBAAAHHC...ZFBBNEAA......fDEFhADAPACAaAGE.hAEA...,1,-26,-27,1
CFXBUePfSGIZMDTcYObRaVKJgdEWQHNLA,CFCFFFFBBBGCeDEE...SCABGABEZFDBDCFG..TGGEhAAAOBHDaAEBKECH.dAAFQGAHhABAHFABAAEGPADBhAGAIDDH.MDAH......hADA......hAGA...,2,-30,-22,8
MeEDaFHbCOdYTVXKLWZfUcJSIPQAgGNBR,GAFERDBHeAAD.EDHBDHFGHEDA.OBABdADF..VEDEKFADLDCChAAAZBGF.UGGHSGADhABA.QGCDhACAABBCNIAFBFBEaBHF.......hAGA......hAHA...,1,-5,-28,23
UBSXbNEVFWgGJZOYACfLRPTaMQcIeDdHK,CAFBLFBBRFBD.aGGBQABF..ICBCDCECKCADBGGGhAAASEAC.bFEFhAAANEBB..FEHBGADEhABAZCDAAIHE.fBGD.MDFEeAHF..hACA......hAEA...,2,-34,-15,19
PcaeNAQBdMOEIFKJfCDHTLYgUbVZGRSXW,QGAFMAEE.EDBGKGGE.CBFEDECDHFDBLEFEUDFAZACARBCE.SGGChAAA..hABAPCAD.aHFCADAHBHHChADAdGDA.IBGE.....hAAA.fDDEhABA...,1,-13,-43,30
PXScgLOTHfWKdZRMUYACeDBNJVFaQbGIE,DGGDBAFB.JADBVDBG..QBFBGAAFEHDA..SBAHhAAALAHBOGAEhAAA..HEFFfEAEhABAdDEEMIBEAFEAeBDAaACBIEHDXEGF.hABA......hAHA...,1,-8,-34,26
dOCHFaIVfGDSRcJLZNUKebBMQAXWEYPTg,EGFCTCBCdDDFHBBD.FAFHIGDEGBGEDICGREFBLAEBZEAAKAAEBHHHhADAAGCD..XGAHhAAA.PAGBhABACAHE............hACA......hADA.aEBE.,1,-23,-28,5
SdOfWgaTCeBDVJGcINKFbLPXMRAZEUYQH,UCCBHEFHOFBB..fGFHaBDDeAAADAGGGBGC.IEFEhAAAFGDALCFAhAAAPFAHMFIB.AHHBYCCFhABAdGCGTACHCHCD.JBAFNEAE......hABA......hACA...,2,-23,-4,19
OfReTFXcPQAbYJGHBSLIgadEDMCUNKWZV,JGEAGCCFBHCALEAC.aBGCEFAGDEHDUDCHKGAC.ZDGH..OHDEhAAAeABH..FADBPBBAhABAABAD..HBEAhAAAgFFDMAIDCAGC.NACB......fHBHhAHA..hAIA...,2,-26,-25,1
UHOIdYFPLJNcgDTKeGAQaXVERSCMBWfZb,QFCAVBCF.EGGDSBGFBABCZCFHHCCEdEAHFGGALFBDhAAAJHCC...cACBhAFAgEEHKAHFABEEaEEFhAGA.CFHA...fHAB...hAIA......hBAA...,1,-8,-37,29
dOFRfYaPZEUNHMScJIQCLbGAeVgTXBKDW,eFBBTFDHBHDD.KECGDAFE.OBDFFAGARBEB...aGBHEHEEUEADhAAAHFGHMEIB.SHDAhABAICCHCAEFbABDACBH.hAAA...XDGAWDFB.....hADA......hAEA...,1,-24,-28,4
caORDFVLYIXEKBPTSWJUAQCHMZbNdfGge,QGDCCECDZGAG.dEABGCDAeABAOCCGDAACLBFG..hADAIHAAKGGFBCCETEEDhAAASEAFUAGHMDEGhABA.fGGGaBBH....hACA......hAFA...,1,-16,-40,24
ZETYfcQKbAWHIPUCNDGdRMSBgVFOeJLXa,HAADUCBCCGHDDCDF.dAGDRCGB.MFBCBGBB..FGEE..OBDDLAEHhAAA.XGCDhACAaAGCEFDC.TCGF.fADEhAHAKABCAAAF.WFFENEAE..SGFHhAEA....hAFA...,1,-9,-45,36
APYWGcNaJXgVQCEDbBSLKMHIOFTZUfdRe,...PGEAGAFE.aCCHJCFA..XEDDQABADBBGSACEhAAAMECAHGBEOADChAAAFHDAUGGE.RFABAAIBWFAEhABA..NBAE.........hABA......hAFA...,1,-21,-22,1
gXYFHMOWaRUGTfQBbZAIceCDSLJPKENdV,eGEACFEADEFC.LCBC.KAGEEEDHdEFF..XABFHFBAMEBChAAAOHBGaABE.GAEDhAAATAECBGHHAEIH.IDBBhAEA...SDDCNIBB..hAFA.YHFAWEAD.hABA...,1,-21,-31,10
TVGWFDYQMaEgXHfUcRONJbeACdLIPSKBZ,LCAFSHBGKBEABBFDZGFEGDDEFBAFDDFA.MDCD..aEABEBHHhAAAHEBF.UGGGOHAEhABAJEEC.ABDBCFGE.IAGGhACAPADF..........hADA......hAEA...,1,-23,-31,8
HFMCQSARKULgeGOXBDYaVIJNTcPbWdZEf,UCCBLEEGeFEEODCHDIAC...aDAFVCGB..JACF..hAAATGCG..cAFAhABAbAAF.ZGEGHAEGhADAMIAACHHAAFIBKCHB..gFACBAED..hAEA......hAFA...,1,-20,-27,7
OZUJgISYCNLPHRXeFAQaKBcfTDbGWVMEd,aFHBBFED...TDGBGECH.MBBCdBFBZEBBJAGF...SBAEhAAANICH.PCAHhABAXCDE.AEAGKGEAhAAADGIBbGDAVFAF..ECDEgBAGCAHB.hACA......hADA...,1,-16,-29,13
NPSeZVTdUFXQCRMDaYILGgKAcHOWBbEJf,HFDFOAFBBAHD.EGADJDCB....NBGA.eEAFZCAB.dFEAFGGBXACGhAAACDDE.DEIFaECDhAAALDGBKACE.ABIH.hABA..cADDfGCFPCHBSDAChADA....hAEA...,1,-19,-33,14
WCUIQaETMDLFKAVeGdBYONZXcPgfRHJbS,VFBHGAEG.BHEFOCADZDAF....XBCF..cEEHhAAAPDHHRGFCJACFSDFHhAAAUAFF.aAHDTDFBhABAMABELHAAAECG.dGGH...hADA......hAEA...,2,-28,-9,19
gbHdGXaNTWFCPeBJLcIVMRZUQSYODfKEA,HAADGBDBaCCD..NAEF.TFBH.CHFGBHGBJBBFLFEF.hAAAVDGDZBECSEEChACA.DFAFfGHAhAAAKEGBAAECdHBH.XEBA.FHBA..hABA......hACA...,1,-17,-28,11
dYINbJZQSLBCDgeKGaVFUEXOHPTMcARWf,RAADdHBH...ICCAJCFGQDABLAAFDEEGeEDA.GEGGhACAFGGAEDHFHAFA.MBBAhADAAIAA...YEADhAEAZFAECACGKGFFaFCC........hAFA......hAHA...,2,-37,-6,31
XCAfeVUTZYDRSGMBOgWaLHPdNIFcEbKQJ,eFBBUDCBZBCARCFFGDDABBFB...OBBGaHGA.LAFAdHBFFGEH.hAAAEHGG.KDAEQDFDhABACDHHAFHH..fGAEhAAA.........hACA.YDAHDACC.hABASAGE.,1,-10,-36,26
WCKGYAEJBaRLZQIUSefgdHOcMPXNTbVDF,BDGFaDBDZFBEUCDE..eCHDdFDBOAFE..PADD.hAAATGFGDEIDCDBAKABCACBCJAFChAAALHFE.QGAAhAEAIDAD.SGCA..hAFA......hAGA...,2,-40,-29,11
fGRCdOPeKUcJLZEBaDAWQVTgMFNSYHXIb,VEFHMFFFFDCC..SGBGHADG..bGAEGEAD.RBDB.hAAACDAFdGGBeDACKAGEcACGhABAJBAAEEGA..DIEEAHHDTCFGhAAANAHG..IHHGOEAC...hABA......hACA...,1,-11,-13,2
BTXRAQVedEFWKcIYJNLfCaPGDgUbSOZMH,VADGeEGHFAEF.KDBA..IHEF..NBGGLDADhAAACFGAGCEDDAGEUABCOCAAhAAAHECGBBHGRDAGAIHG.dHDDEEEBhABA....cGAEfHBB..hACA......hADA...,2,-26,-19,7
bEDdGTVgNXORAQCPYUafBeFWSMKcLIHJZ,CHHGUCBCBGFDFAFG..MDCCLGEC.HCFEJABDZADEEBDGDAACGDEDhAAA....gEDChADAOHBGQEAEhABAaEAHeHCG.KAHB.......hAEA......hAIA...,2,-33,-22,11
UPFISEaWLOGVJdHABKZgbcYRCfDeTXMQN,KGFHZAAD....bDEGREEADFAD.eCHBMHFCUAAFFFBC...EGCBLBEChAAA.OFAHhADAVAECdCDGADCABFFF.hABA..YDHBCHHBXEABNAEF....hADA......hAEA...,2,-30,-19,11
RVJCUPagSAOQKBXWDZHTcNGdLEFeYbMfI,QAADKFFBBCGDDIACZDFC.HAFH.TFFAGCBBLCDDhAAAFAEB.eCAHMEFGIHDAhACAJGBE.CCHFaEBDAFHCOAAChAAA...XAGE...hADANCAE.EHAC.fADHhAHA.,1,-4,-40,36
KDJBVHEZLOgTaIMWYACPcdeNbGXQUFRSf,CFDGdHBH.eAAFGGEFUCGGRCDFKABGBFEH.HBCHEGAG.LHFG.hAAAOAFAaCGBMICEAAEF.hAAA..NCCG.XDADhACASBFCDGGE.JDHB.......hADA......hBCA...,2,-24,-20,4
eZTHPARXgEFDOGLSCKfQaBYJIMUNdVWcb,XFDHEAFBDBCA.GADGCHBC..KFEBQFAHBEDF.ICAGhAAAMEFEUDAFdGGHVAFEhABA...bDFETBAGhAAAHDAGAFFG..FGHD.LAHFfABHhAFA.....hABA...,1,12,-43,55
ACgBfPGeScWLUIJdXQaMKRTNVDbYEOFZH,BBBDGAFEeCHHSDCDLECE.UBFEIAEAdBDG.QDDBhAAAKHAERFCC.NCIEDEHDhABAEDAAFHGAAADF..CHBDfFFChACA.WHDAaAAG...MBBFhAHA......hAIA...,2,-26,-23,3
TGIWOdZVSPbUXRNHKEJcQBDfCegMAaLFY,aEEDFDCDGADG.OFFCVABC..SHEEUCGFRAAC.KCGCEHEChAAAQGBHBAHBCHCE.hABAMEIDADAH.LAFFhAAA.YDDDWGBE.dEAC....hABA......hAEA...,1,-18,-28,10
dMfSNQFaUROcWEVPXeJCLGbKBgHZITDAY,dGFHMHFGSEEFFAEH.UBADODDB.EAGAXFAF.hAAACHDALCGHKEGFBDBGgABChABAHAEE.hAAAIFECAIHENBIEaDBC.RCFE....VGAE.hABA......hACA...,2,-20,-18,2
EUTafPRSCFMHVbQgBZdNeAYWXDcLGIKOJ,XCBCDEFHLDAAKHCE.EBCF..UAEEaHAC.RABA..FEDCMHDCHDGDhAAAQEGGBAHGZGFE.hABAdAGEAFGH.....hACA............hAIA......hBAA...,1,-25,-36,11
YQWTIFUCeVgHfKRJOXDZBbEadSMPcGALN,LGEAQCBCTECCUCFB..CHFB.eABEHFBCKHBGOEEEZCCABAHChAAAaAFF.MEAFGABFhAAAADHD...NCACIHADhABAFBFF...fGGD..hACA......hAEA...,2,-28,-12,16
EWBKARXNISPGVfgLcbdDeQTaZFCYUOMHJ,XFDHSHBGGDGG..fFGDLACGdDAFQCAChAAAZBBCFBGBUGAHMHDAJAFGhABABDFDRDDBIDGHhACA.PFAG.......hAAA......hABA...,2,-24,-7,17
egHXUPQBKNbLJSYFWfCcZMDVOGARdTaIE,TCCBaAFB..ECHFeEGBHFFFUAFCBBAAKBBCLABB.JDDBhAAAFCHDCGBF.MFFD.OHBAhAAAAFFDdEAFXGDDhADAQEAESHAAfBAEcAGEDGIB.hABA......hACA...,2,-20,-9,11
ZBOWKCURQHDPgYGTfMEIAeFXJbNVaLSdc,FAADXDAC..JEGF..VDEGaEBHdAHGBHDF.KBHBCDDC.QBBGhAAAHADEDGIB...hAAAgGAFTFDHMFADhACAAACCeFCELDFCcAGBOHEE..hADAWHFC....hABA...,1,-17,-31,14
dLXaJNfMRWKQegbcVSGPDTFAUEHYCIBOZ,HBCFCFDGBEFEdEAHLCDCXGAE...JFGBMDID.KDAEeBEChAAA...bDFASAEEhAAADAGEFCAGAGFHEFDAOFGFhABA.NAHA...fHDBRFBB.gBGAhABAcABE..hACA...,1,-15,-36,21
FWLefUXdERJbHDPVgTGIYNOBZaCKAMScQ,MHFGQGBCLACEeDFDUEDAdEADRACHHBFHDAHF.....PHBGhAAATGEHGBAEhABAIEDENIEHBGAC.aCCAhAGAAIDEcDGH..fFFBEAAF.hAAA......hACA...,1,0,-25,25
NEaWZIbOJGVUQSCDPMYgXHdBAKLfTFceR,LCCHFGFCRDDB.EHDAaGBHZFFA...OBFEVAEH.UEAA.CHAA.hAAAMBAB..XACAhABAdCBABEHAADGDKCAATDFEhAAA.eHCGIAFFJAHB.SEGAhACADBBE.....hABA...,1,-18,-24,6
DJOcTNgfXELBMYaIHCWebRFZQVUGdASPK,SAFBKHFGOBAH...TCDE..fDFAEEHHMAAGaCBBhAEACDDEeEBEFFEHQFBEhAHAUAFDAGFCDHDAJAAANDGC.hAIA....XEGABHBG...IGAGhADA...hBAA...,1,-20,-32,12
dZESJDBPbGfINUALHVQcMKaeROCFgYTXW,LDACVBCD.MECFeFFCRDFD.FGBE..TFDGdBFGEAAF.DDAFBBGChAAAGAGE..fFAEhABAIEEFAIDAcABBhAEAKHGG..CEBE.YHDG.WBEFhAFASGEG..hAAA...,1,-20,-25,5
efbaDVHWCYAKFLQZMXOSNcBgTJEURdGPI,KEEDFGDDZCAGOBAF..SDEGBGCF..TBGAJAGFEGFCUCDBhAAA.dAGFGAAFhAAAeFHD.aCHDDCCHHEACCHEHAAED.hABAMFFA..NDAA........hABA......hADA...,2,-31,-20,11
LaMOKbSXfAEDHUPBTCNeIcWdZFQYJGgVR,DEFEUFDHBCBACCHB...eHCE..IBDEdEDEZACHFBFE..hAAAQCEHJEAC.hABAGAAEVFGHLAHBhAEA...aFFBMAEC..OFABhAFAKHBGSDADhAAA.ADDBPHFC.,1,-18,-34,16
ebCRAgBQUNLYGFWfJIXOZHEMPKdDSaVTc,QGGGUDACLHBEFCGB...JAEFXCCFZDFEHAAE.MHFAhAAAKFBFSEGAhAAA.TAEFcBGGCHADAHEHhABABDDF..NEFAWDAFfFGF..hACAEEDFDGAE....hADA...,1,-18,-26,8
GeLZIMENSAFQbgYaKcPVHXJCBDTOURfdW,QGBC..gBDGKCFG.VFGDXFGDBGCHOEAChAAAREEDfABDhAAAdBGFeEEFZAEAMBBFSBABhABAbDCB.aCCH.cGAG....hACA......hADA...,1,-14,-25,11
RTKHDCSEBQVJYfePIZGMUFNdaLbXcgAWO,OFBBKDAFDEFD...EGGFQFBE..YCDEeBDBIAAChACAMBCCFDAAaAGBXFEGhAAA.AFHERCFATGFAhADASAGEBEHFfAHA.hABA......hACA...,1,-28,-32,4
XbdNYAJCFBRcTWQgEHMDOGaIeZfKLVPUS,FDABRDBH..TBAGQBGHHEEDDIEEGDEGeBGBKEHBLAFChAAAUECCXACAdGGFACIFBADHhABA..gBAEhAAAMHBG.IHAA.fGGDhABA......hACA...,2,-21,-11,10
eYEGFfBULbMOgaRZKQPJVATDIcXWNCdSH,TAFBDACB..IHBH..WGDAdDHEHBED.EEEDfADHhAAABGDBLBAFhAAAbCDG.OHEEaBADRDFAKECFhABAQAGE.PDBAAICC.cGGAhABACHABSHFAeFAF.hADA...,2,-19,-17,2
LUBQTIdOWGHJbCZgSMaVYceAfFXKENDRP,XGBCKAFBDFEBLEDCUGEB.BBBD..QBAAdEAHGBGEhAAAHBEHCHGA.SEAGhAAAaCBE.YEFGhABAeHAAAFFDFACCRCCFIADF.JAHB...hABA......hAEA...,1,1,-32,33
NSJEQBPZROGIeTDVHbCYdKfXAUcLaMgWF,UDACaDCD.MAAEFGCD....JBAEBCHDZEEAGBEFeFHHDEFCHDADhAAACAGA.dGEAKEDF.AFGB.LEHBhABA.NADF.SGAEhAEA.EBBC.QGDAhAFA......hAGA...,2,-42,-13,29
DgGYKbAZdJeQPEOVFCNSMcRaXWILBfTUH,ZDEDJFFB.QGBD.EADEFDAB.SCDAMCCCRBGD.aGCCXDBDhAAA.IHFDhABABAAEUACH.DDGEhADAYEHBKEEEdBGB.OCAHCGAH....hACA......hAFA...,1,-16,-44,28
PFADbWgTOYedRNaJLHIMGESUVfCcXZQKB,DACB..gFDHTGFA.eDGHdGDGaDEAJAFELEACHDBBMAAFhABAEABDUAFD.CGAEZEFAhADAKDDC.BBDCAHGAOACAhAAA.NIBFSCHBfDDE.....hAEA......hAGA...,2,-15,-11,4
bOaKgXIeNPLUVRGJdFfYZDMWEHcCABQTS,TABHOCCHKCGD..XDAEeABALFAFRGFEdEDF.FFDBfGBFhAAADIGE.EFGECFFDBBHHhAAAQGDESFHHhABAaAFEIFAC.NBICUADEVBDF..hABA......hAGA...,1,-3,-27,24
PgINTUaLFZWYEODAXebKMfVCQSdRGJHBc,XDACKDCDMGCE...CBBC.dAGCGFDDBACB.....gGABhAAAIEAB.TCFDhABAaHDAFDFGZACF.EECFABCBeAABhABAfAHE.SGHHRADFHEFCcGGEhAFA....hAIA...,1,-9,-29,20
fbWHJcRLIVOeMFXSUYBQZKNATaDGdCPEg,DDFFdBCGEFCF....bBFAHAFB.RFGHICAGOHFGeDDFMBIHhAAASCBCBHDEKFADABEChABAaBAGGDCFCHBB..hACA.fFFAWEAFLADA.XEGChAAA....hABA...,2,-33,-6,27
AEefRbNdITQgUMJXKGFaLOCSHPWcYDBVZ,eCCHRAADdDCA.QEDAUGFH.MCAFJBEH.KGHDGAGEFDHF.LGBAhAAASBEB.PGAAhAAA....hABA.cABEDGAHBEAAAICGEGFHfACGhADA.bEFA....hAEA...,1,-9,-32,23
aLQBRFeAMcfHZUIbWTgEKdOPDYJNGVSXC,MCCAHAADZBEAUDBA..ICCG..TAADEDGBOFEEhAAAPADAJGBA..NGCB.SEDEhACA.CEAGaHAChADABFHBFAGEABHEfBGE...hAEA......hAFA...,2,-42,-15,27
MECHYaUeAfXOTFDVWZdIgPQLKNBcbGRSJ,XDACTAAD.FFFEDIBG.ZECCdBDG....PBGBKGACNABB.BAHChAAAGGCFRCAC.MDIBhAAAEFAECGGCHBFC.aBBF.hACAAFEA.OAED.IHEC...hAGA......hAHA...,1,-20,-24,4
gYDCANQdEVSBLJFbUZOPXKHcfeITWaRGM,dGFCEEHBBHDDFEFGZAAB..OCBGKFDHHAEHeFBH....TEAHhAAAaFFCMBFADBIDACCGQDAGhAAALHAA.UDEFhABA.PACAfACFIHHH...hAGA......hAHA...,2,-29,-13,16
NOfCUDPbWXTGHRQIMSYdBAaKEVFZcgLeJ,EDABFDAFZBGBLDDA.eHFAOCCA.CGBG.DBIF....bFEBhAAAWBDC.GFAFhAAAQGCCIHADSDDGhABABBAAAGGFaCEGKACA..cGGGJHCENABB.fAFGhACA..hAEA...,1,-11,-38,27
FVHRPbaIJeEMOZULXTgAWBfGYCSNDcKdQ,BFDGGAFESBEEDIACKBBA.dBAFQDBAHCGDREED..aHGAeDHBhAAA.OFEGZDABLECDhAAA...hABA............hACA......hADA.gGGBAADC,2,-29,-29,0
cNZTWEdFUIabfKCVYGLegSPDJBROAXQMH,QGFBMECGHFAAZFDDEHDE.UBEA..aAFEKGHDCDFDGBCDeCAASAAChADADIAABGAHAEAE.hAEA.NAIC.dAAB.bEECfGFEhAFA..YEAG..hADA......hAEA...,2,-23,-11,12
HFBeOVgcMRSIaZWTdYCLDPfXKQUbJAEGN,GEAHHDAGeHFEOGFCVEDAMDBA.RGBC.aBGEZBGFdAACLFFChAAA.DCCAfDHChACAKADE.QGAChADA.JBDEABADNIDHBGDDSBBC..hABA......hACA...,2,-19,-2,17
DbBNEgXZHeFPMWfaLCScIQOdUATJRYGVK,JADGREBHGBCF.DDAGBCGH.EFCBZGDAFFFEMAAE...aFECSCDBhAAA..hABAIHAEdDACABBE.TAGChAEA.KDEGbGECNCIE.......hAFA......hAGA...,2,-48,-27,21
ScTFXHCUMAKVEgNJZOGBYfDRLePWIbdaQ,KEHBVDAGEEBE....JGAEZDEFBADHDDAFRGCCLEGB..PBBAhAAA..IHDAhAAAaDGB.QEEDhABASFBG.TAGBHAFAMIFGAABE.NCIC.hACA......hADA...,2,-32,-27,5
RFOLeGDBCVbNPKJEQTgaIUAdZYSfMWHcX,dCFCZDAGSABEMABEHFBERAGDLGEA.eDFBBHEA.bBBFPDHDhAAA..EFGBgFBDhAEAaDEH.ABCFfBDFhAFAWFAD.cAGFOAAHDBBFCBDA.hAFANIAFQEDDhAIA...,2,-13,-12,1
AbXCPEGUDTeMQSNcZIBaJFVKgRWdLYHOf,CHHGGEAHDGGC.MBEF.QEGDSAEHZGEABEBDFBBCKHACREDHLDFEhAAAOAEGAAAC..hACAXAGCEDAA.TBBDhABANAIAaGDH...JHAE......hACA......hADA...,2,-38,-5,33
aAYXCDZeTSFRGEdIQKUgJLcOHPWBbMVfN,CHHGDGADZCADeEAE..SCGGFCDCRGCE.GDECdBFDKAFC.UEFHhAAALDDF.HGBAhAAABCBCbADGMBBG..hABAfAGBABID..XGGE.hABA......hACA...,1,-22,-33,11
DMGYfBCLRXTNQUHdVObPEWaZIeAgcFKSJ,FHBGKEEDDADGMIFGGGBBBBGH.LDDE.RAAF.XFEE.hAAAQAABUAGCdFGDODCHhACAPBEHEDBGaHFE.hBAAeFBAABFD...SEAF.YEHFhABA.fHDFhADA,1,-20,-29,9
GEWSXeZJVOUBKLCHNTYbcadDAIMgFfQRP,MCCAFHBGQCBERGCC.GACFEAGDSABEeEGDZCGHOBABhAAAKDGGCGHE.HEDB.NAIE.hABATEAG..cFABhACAaDEHDBIDADFD.fHFF...hADA......hAFA...,2,-32,0,32
TAadHFULKBRNQfJeCbMZcGOYDPSWEIgVX,aEHBdEHAFEBHLGBCBCAC.RBEG...QCCEeBBHMICEZAGHOEDGhAAADGEA...SDADhABAIHFAXABBhAAAAGIBKACCfFFE.CHAD.bCED...hAFA......hAGA...,1,-20,-33,13
XfZFHVbaJTCeQLWIRgSDBEPYGMdANcKOU,KHBGODCHUCBBZGFEHEFG..aAADCDFFLGBERAGH..DGDBBAAFhACAEDDBGBEEdECHAGGB.hADAXEGBFAEE.JDADhAAA.QGAH.IADHSAHBhAEA.MIEE..hBBA...,2,-33,-6,27
HaRWPSDNYIBQJUACTKObLVfcgZXeEMdGF,CFCFTGGDKBFH..LHDE..fFDAZDEFEFAF.MIDChAAAFBAFHDGFaCFARDDGSACHhABADIAE.IAGAhACABHHGQADFJEADABIH.....hAEA......hAFA...,2,-29,-26,3
dfEILNDFJcWaTOYHUXPKVZQSAGgRMBbeC,GEDHRFACBCHE.CHDFdBDDEAFB.LFAF.DCAFJDEG...aACHOCCBhAAAUFGG.KGHDZDACACHD.hABA.MBGDeHAA..hAAA.IBAG..cABB..hAEAYHEA..hABA...,1,-29,-37,8
EIfJLcMDVPWXFdaUGTBRHOgeZYSKAbNQC,QCBCEEGD.JFACMDAG.DGDGVAEFXFAD.aDHFTGEGhAAA.BEGGOAFAhAAAeHAEZACC.SHEEhABAADAGCDHGIACGfCFA...hABA......hAEA...,2,-32,-27,5
ScXNBTJLZHdfbaWVQeCEYIGARFOMPgUDK,RDEDMEGFUDAFDCFC..KABG..XDDEBGDALCHFZDAHdHAFaBAEhAAA......hABAQGGEEHEEIHHEhACAABFBPGAASGDD.cAGANIAB.hAAA......hABA...,2,-42,-19,23
NEJOCdAePbYMaIXBRDQWZTFKcgHLSVfUG,eGEA..PFBBMDCC.aCAHBFEB.QBGHZEFAKDCHHABChAAAVFBAGGEH.NAGE.hABAOEEAAAFD.IADChAAA.DCBB.FAFBLAHFfBBBhABA......hACA...,2,-28,-11,17
bCIKeaTGZRDUfHgPXJANOdLMSYVFEcBWQ,dDCDSFAGFDFCBGHCQDED.CCAD.IGFHKHBC.eABFhAAATBCDZGBEDAECfGHAhAAAHACB.XDGFhABANIEB..OBFEMAEG.EFBAcEBAhACA.aBFG....hADA...,1,-22,-27,5
PagJFXdcLMITADHUQZONBYWfKbVRCGEeS,DEFAUDCBZBEAOAAFBFBB.......fFFGKEEDVAACGGDBhAAASCGG.hADAPFBHaEABFAHFXAFEhAAA.dAEG.LFHBMDDFAIHANDIA..hAEA......hAFA...,2,-32,-20,12
HgfRDbSVOBaMXWEPCQLIUeGATNcZdFKJY,TCBCZAADFFFHKAEA..HFAHRDAA.SAFBBHHG.MCFDEGAH.hAAACEHCIABCGCGGADFH.hADAdHCD.JFGF..fHBHhAEADAEBOEDBaFCC......hAGA......hAHA...,1,-12,-34,22
ZBeULOWaXYRKEFIQSHNCAfGDcMPgTJdbV,GDCCMCHF..TABEbCAB..BCGGUEDELABCOBABaGAGhAAAREGBEGEB.FAGE.SGGDhAAANBEFAIDG.fGAAhAFADGGDPCDA........hABA......hADA.JHAEdCEE,1,-2,-27,25
RZOXBPUKbTCMaAVGLDSHcfdFIeJgQYNEW,VFBHGDGG.DBADHCEEdAEBFDEGeFHH.QFFFEECF.RBCHZAFChAAAOFFBBEAGKHCETBAAhABACBHD.AGED.SCAHhAAA...fHAD..hABA......hACA...,1,-4,-37,33
NXYecaUPJHWQRMZgOTLBIAFVDKSbEGCfd,VFFASGCD.EGGFCABEdADC..XDDDeHBCUCFFHCFHRAFA.hAAAZAAG.TAEEBFAH.hAFAAECCKCCC..fDDChAGA.NCCE.aGAF.WCAHMIDCLFHBhAAADBBF....hABA...,2,-21,-13,8
UaEGKNHYBASdJLbVPegfODICXQRMZFTcW,SEEDJFFBLAFC..VADAeBBGOHBECGBA..QEDChAAAMDCHFABB..TDFFhAAAcCAHUAGE.aDADhADA.EHFENEIEBCFD.ABGGPEAB.DDHFhABA......hACA...,1,-11,-27,16
TQMdJeaHLZAfVPEcBGWXFgYSDbRNOUKCI,VAADEHBGBAFE.GDBDFHDA..SDECDDGFRBBC.OFBAhAAAKDHFCCFF.QGAEhACAdHGFeDADLFFAAAED.hADA.cGFA.WCHBgAAC.hAFA......hAGA...,2,-32,-21,11
PROTBZLWKeDbJGQdCHIYAFMfgaScVUNEX,FGFHMCCA..aDDDVDBGUADA...EABBXFFD.OHCEhAAATCFDBGDFZFBAKHCGhAAAeAEEDBIDJBHD.dABBCDBH.hACA...IHAEAHAB.fAGHhAGASHGA..cGGAhBAA..,1,-22,-31,9
IReBWGLYUKOTaSHbQcECZPJFdXgNDfMAV,VGFGRFDFeCDH.BAHDLCFG.KCBHaCGBHAEG..QGADhAAACAAAJEFE.XGFAhABADIBEAHCAGEDEUCABOFFGhACATFAF..SADCcEBCZABE..hADA......hAFA...,2,-15,-12,3
dAbLgcZTJXIeKQUCVWPfDMSFYOHRGNaEB,LGEAZAADJFGF.XDFBKBFC..CGAB.VDBA.....hAAAfBDESEAGhADAFAFAHCDERAAF.NDICBHDAhAEAABFB.....gFCAcGCCeEADhAAA.....hAFA...,1,-15,-44,29
VIYUAKbDBRXaQSGNHJcgMdTZePLWfOFCE,KHFGDAEDRAGBQBDAGABCHEEC..JBGDMDADdEACZGBGLHEAhAAAOFFGCFBD..EDDF..hABAIFCGADBDBDHAaGDAhADASCCD...NAAF.....hAFA......hAGA...,2,-35,-10,25
ZGRfIBAQgTOLKcdbNYECFeJXaWDHMPSVU,QCGCTDAC.KECEdDGB...bFFDNCAB...CBGC.FFBHJECBaEFHhAAAHACB..MICGhABASAABUBEE.ZFDBhACAfDAHBHABAHHE.OEHF.YAFChACA....hADA.XGFADAFE,1,-12,-14,2
YSKQabERHVZPNJXcOMCIWdgBUfDFeATGL,TDACLFEF.KCHBQGABEACB.RCCAHBGFZECDJAFBOFEEhAAAMBAF.CHHGdACDBAHAfBAChABADGIF.AIFASFHBhADAbDAD..PFGF.cBBChAAAIEED...hABA...,1,2,-34,36
FQEXKCABPRgcHfbNdVSWDUYIJZOaGeLTM,RDBHHAAD...NEDD.SEEADADB.IHEFOCDEaAHD.hAAALFBFFHAEEBDECFDDAHGEBFGEhAAA..cFGBhABAdHDHUAEFZAFC.........hACA.eCCG.MBBFhADA...,2,-29,-23,6
JMTaQVPWcdZOeNfAYGCIUSXDbKgRLEFHB,GGDHUGGGDCGDKEGCLDCCHBBHBAEC.MFCFQAAA.hAAA.VBEC.PDABhABAcFAG.ZECBOEDEhACAeBDCAEHFIHAH..SBHBhAAA.....hADA...,1,-19,-26,7
KXHeJLIWZbdfVPEgFUDNTGQROCYBASMac,aHBGXGBCHCCCeEAFLBADZFEC..dBDBVGFEEBAA...UGDAhAAATDFHRCEACBCB.AGBAMIDAhAAAJECA....IAGDhABAWFHB..........hACA......hADA...,1,-8,-25,17
bcYeERQTAWIZHfXSgVJNDFKaLCOBUdMPG,ZAADXFDHSDCA..JDCFDEBHKCGHaGDALAED.BGAGhAAAdAEAMIDA.PDFChAAAcCAG.EGGAQAGBhADAAEID.IGGA.fHAFhAHANIDBCFFAOAFE..hABA...,1,-21,-37,16
MUVOFcZPYLDEHIWBGNXgeaRJfAKQSCdTb,QFCESEHBdFCEMIFAUGEG.FDEAZBAH.LACCDABCHBBEhAAABGACGADFXDEAhAAAaBHD.JCCAAEEHCEAETFGFhABA.OBHB.......hAEA......hAGA...,1,-11,-24,13
ZCXIOfESPDBbgGJeUTaKWFNMVLQYRHdAc,CFDDXDAC..fDBGEBBC.DAADgGGGGAGEUGGAhABAKHDEFDEE.MGBChAAAQBBAHAGBAIFCZEFEhABAIAFHSDDFBEFB......hACA.eBDAWADB..hACA...,2,-42,4,46
ZdTgLJNcaMGOERXCBbFQAPfKIVYeHUSDW,KHBGVAADHDDG.SFABZAEFdHEF.LGFAJDCB..aFEAGAGGhAAA.EEHHXDGAhAAABAECQFCEhABAAHBA.IDBEeAHHDBEHWBBGNDAE...hACA......hADA...,1,-4,-31,27
MLbBVNUTHfQZRXASKgYOWCeFacJGdPDIE,SAFBKHBGOAFE.CEDG.FECA....aDBGGEGEDFGD.MEBHhAAABGEDUCGBTAACQADAhABARADFAIFG...hAAA.WAHDeCAG..cDGCdFFCEBBE..hACA......hADA...,2,-38,-14,24
ZAYQWPRKdFHaNUMSfceJgGOLDIECTbBVX,QCBCRAADFEFGHEAFUGGHSFHB.eGDCJCFAGACFDAAACCGCBHAFhADAZDCF..AIEE.PADEhAGAKHBA...NIBFMEFAhAHAfEHA..cECG...hAAA......hACA...,1,-17,-21,4
EXRIfQSAGBPcDWOZVLCFUJTegHbNYMdaK,GGDHBFDGDGHFZCFGLCBACBDE..FCACJGAAeFCF.HAFE.hAAA.NAED.MFFG..hAAAKFFDXFABRCFG.hABAIDDDSBBEAAHEWABCOCAH..hACA......hADA...,1,-12,-45,33
WPgQbGUSacdXOJZfDVBAeNICYEMKTHLFR,eGEACFDG.ECBETGFELEBHRCFB.....PAFBgGBEhAAAGEDBSGADhABAaADDdAHG.JABDDIBCACEHIEBAhADAMAAE.FAEE.......hAGA......hBAA...,1,-16,-21,5
RCBWEXeVHYMgOcFSUbZQIAGPLdJfTKDNa,LFEFJCCH.TCBEKCGEDBFD..aGCBBHFG..EGFBeEEFhAAAHAFE.MBACOGAAhABASEABUFGCZABEAEDCPDFEhAAAdDAE....NIAB.CHAGXGGBhABA.....hACA...,1,0,-38,38
DKbSTRWLAOMCQZJYBgVPXfFUadGNEHecI,CHFDZADGBAAF..VGCG..XAEGFCAGdFGAGCEDHBCBeFFEhACADFAA.SGAEhADA.TFDE.LBBFhAFAAAAFMECA.YDFCfAHENIABIAHDhAGA....hCAA...,1,-20,-37,17
bfJCeUIKXQPANVYBFaGHOTMWcgDLEdZSR,VAADFEGDGECE.HABCTBEAMEAB......WEAAhAAAcBFGLGFCZFABSAAFhACAfGBBeEEBhAEAIAGG.QDGH.AICCBBHHhACA.aEDDDCIBEADAhADA...,2,-24,-7,17
PIOSCDMgNfQTAXZVJbFcULRYWedaHBGKE,ZABHVFDFFHAC.LFDCRAAB..eDEAaCEDHADDBBGBKDAD.EGADhAAAPHDE.OCGFhAAADGCBMDIF.fCEHhACAADAGXAFB....JHFE.cEBBhADA.....hADA...,2,-24,-20,4
KHVWYLaMdTQXOFDAGUecPECbNJRfBISgZ,GDDCUDACeCGBEAHHCCBB..JCEBBGCG..SABDZAACKBEE.hABAHFFBVCFF.LHFAhACAdGAHQACAhAAAFGAFDGGEAADE...........hACA......hAFA.PHCC.,2,-19,-18,1
WMCYKBbVOGARFXeSJTDaQcHfPIEdLUgNZ,XCCBSGDBDCFHQCGH.HCBGICGEEGBBdGHGUGEDhAAAZABAMAFGCHBFBAGE.hAAAOACAAFFE.eEFChABA.aCBHfDAE..gFBEhAIA....hBAA...,2,-33,-9,24
TPUXLbHOFCKJeGIBDEfSAMNaZgdcWVQYR,MHFGaCFCZEEBdEHA....VCCDRDCEUGBDLHAEHADECAAG.KCBDGAEBhAAA.DEADECGFAACC.hABA...NCBC.WFAChABAQGGH........hAEA......hAFA...,2,-31,-19,12
DSPLVEIWZefFACYXbRMQTaKJGdUHcgBNO,XGGGRFACQBECKAHH.dCABHCCABHCBDDGALFFA.EAAEIAAChACAZDBA.FFBGAAFCCAHFhACAMBDG..JHFE.hADA............hAEA......hAFA...,2,-40,-23,17
FLdNIGORUZecTQCWAPgKaXDVbYESMfBHJ,KHBGDDFF...VGFAEHGEMABEBBBA..HDCHFAHDLGAGdDAAGAEFhAAAUGEAeCGF..QCCBhAAAAHAFaFDD.XEBChAFA.SBBEfCDBNDICOCGBhAGA....hAHA...,1,-17,-23,6
VbCLQMAFdSJRZKOIWXgEDHcTaUeNYfPBG,SDABJDACZAFA.ODEF..XABDEGHBHBCC.aGCGUGEHhAAAeHEG..fGAEhABABAFAVBGBCDFCMAEHhADAFABEKFAD..gDGHDAAFNIAF.PFCFhAGA.....hABA...,1,-8,-28,20
RfagKJdYCPAZETDFcGUILWMXNVQHbOeSB,TCCBDGHHFFEFGAAF.LCEAXAFD.VAACQAFFhAAAODFEBEBCaDDCKDAFJHFChAAACEHBZGAAUGDG.IHBHhADA..MDCF......hABA......hADA...,1,-19,-20,1
DHCLEUgYIJPWTRXdZQNfeSOaGKAVBcMbF,BFDDMCCADCBFHCCCLGACEFGEUAFC....IAFAJAAC.hADA.TGEERGEAZDDHNAAFSBHBhAEA.aEBBhAIAAHIDVCFC.FHBCCHHF.......hBAA......hBEA...,2,-27,-22,5
ABXZDUOIEadVLFRCQSfbeHJPWTKMNgcGY,BFFCXFCAUCBB..ECEAaAACLAAF.CDCE.SHGEhABA.eFDHHAGDJAGFhACAPBCGKHEG.MDIDhACANDAE.gGFGGEBEAAIFDBFHOEEA.IFAFhADA...hADA...,2,-29,-6,23
GLbRQYOZCTPBWUJecfMdEHKAaFVXINgSD,aEHBXCCB..IGDCSBHHLAFHQDACZFBFTDCFhAAABFDHJGAC.fGFGhAAAdFFCEAEBAHHHVBAChABADFIBGCFE.YABE.OAEFhAGA.....hACA...,2,-20,-7,13
RWDLPOVHGZJMgCaQBSNeTUdAXbYIEfFcK,XCBC..bFEEEEFGFCCD.KADADEAFLBHBOEHDHACEhAAAJHAA.CDGEBECF.SFDAhABAeGBEdAGGIAAEhACARGAE.WCFD......hADA......hAFA...,1,-23,-34,11
IHGFYTLBKcSADdVOMNQZJWaeRECUgfbXP,dEAEMAGDQEGFZFGF..aBHHEHEAUCCG..fCDEhAAA.bCEBPFBDhAAAIBAEFDABTGEBhABAKHCCAGDADADENBFA...........hACA.eACA.CHAD.HAFChABA..,1,-6,-23,17
PZHfSTdObKLMIAFEDURaBQCJcYVeGgWXN,DGGDaDAFBEGHQEFH..JACF..VGAEeGECGAED.hAAAXDDGPDEGHECGhABAfCDDdGAFbAFCKBAEhAAA.IEAGAHIH.......hADA......hAEA...,1,-17,-27,10
BDYIabLPfGMAVZRQgKJHSCTUdXFNEcOeW,ZBDBQFDHKBBAHCFESDBDCGBD.dDCBXFEEEBAE.eCABhAAADIGEIGBDhAAALFCH.GAGAMEIFABAGVACEhABAgAGEJEHBFDFFNCAE..WHEG..hABA......hACA...,2,-19,6,25
NDHaVWZSGPcUMCJXdLFIORfQTKEbAgeYB,eGEABFDGDCBHHCAD.aCFFZEBBGFBBUAAF.MAEF..JAGHdDDHLFFBhABAICHG.RAAE.hAAAQADCKHAC.hACAAICA.YAFE.NEIE.WEFE.SDDBhAFA.CFHG..hADA...,1,1,-39,40
cMXDeFdUHYWJaOVCQgBNGRKfIATbZELPS,ZEFHLCCHSBEDXCGADFBH..dHADUGEAHAFC..JDADaEHHhAAAOHAACBBG.BBGFhAAARDBEKHDAAHIB.EABEMBBC.hADAFCED..WFCG.......hABA......hACA...,1,-14,-33,19
YNXGEaBfKgOAJcIMWdZePLbVHCTSUFDRQ,JGEAMCCAZCAFLDEG.HAAETGBHUEBHFEEADIDC..RBGH.QAFEhAAA.XFGChACAaAFFfCDChAAAOAHFAFFHIABFeFAD......hADA......hAEA...,2,-38,-4,34
ZGAMgQTIEYcSKPaVBXFfNUDJHdCWbRLeO,QFDBEGFC.SHGAKBCEVFBGFAGBUFAGHDEGdBDFCCBARCACLFADhAAAZEFB.AEIFMACChABATAGF..ICEFhAIAPCEBaBABBHDANAABDIAA.....hBAA......hBBA...,1,-9,-12,3
bETDIOgeCGLcSfVRaWBNPZdMQKHJXUYFA,TGBCDEFHODBB..eCDALBBG.SAEEVEFEaADFBAHEhAAAZGEEMIFGHBAHXCFEhAAAYFEFFHAAAGABEGHHhABACACA...cAFAfDDE..hABA.NDIA.....hACA...,1,-3,-27,24
WeHMgRFGcONdbUaZQBAfIKPXJDYVSLCET,KHBGXDACDBBA...SHACEGEA.eFBGMDCGRDEBFAGAGAGAhAAAOBACdFCFaEBBBGGHhAAAAHIH...IHDBhABAPADA.JBGF.LHFACHGB....hACA......hADA...,2,-35,-14,21
eCUYZHKROdbJcGLMFfVaDPWAgTSEXNBIQ,SGFCXGBCBEGBQACD.CCGAZFCBRAFEOBAB.JFHBhAAALCFDFDCE.aHAGhAAADCIDPAEGAFDE.TCAHhABAEEAHeFEH..YHFGKBBC.cEGAhACA....hAIA...,1,-20,-28,8
eaNKYGTUFHLOJPcICWZgdMBQDVRfASEXb,EFAAXDAC..bFFDaHAC..KDGBTFEGFHACHACB.OCAHhAAAJBDC..IHDBhAAACEEG.ZBGH.dDDCBGDGhABADAGCfHGH.AABC.eABF.hADA......hAEA...,1,-22,-25,3
YPaXKGIOcdHULbCeNBJRWVfDSZgMAETQF,EEHBTFCAFBED...aBFHKDAC.GDCA.OFFBdBACHFEBLHBAhAAAeEEEBCBB.hABAJEAB.WAAEDHGASACAhACAMBHDADDD.QCGHXGGB.IAGChADA...hAEA...,1,-17,-22,5
NCKJRLdEbfIYgABcSTQUeaHDGMOPWXFVZ,SEGDUCCBHDABDAGAMBCH..OHBEXBDCZAEAKGFD.LFDChAAAdCAEEDHDIAFGhAAAAADDBBBF.QEDAhABAaCGE.WHBEFEGACHGAJHFA.fAHAhACA.....hABA...,1,-7,-23,16
TWZRHcFCMGfYBDgaXILJPNSOAEbdQUeKV,EAFBQGBCKFFA...VEEFZDADHCFGCAEAGBEDBHHE.aABDIABChAAALADFJHFE.hAAA.SBAFhABAADBGdCCAeEAFTFCD........hAGA......hAHA.WHBAFEHF,2,-17,-9,8
LAdfNYHWEQBFVcZOJMXRGUSbgKPDCTaIe,dHBH..NDHCHCCCQDBAFFFHZFACOFEF.XCGFUABESAEBhAAAKAEDDCABaHGAIAHFhAGAABCC..fFABhAAAEEBA.BAHH.cDEFMICE.hBAA......hBBA...,1,-21,-23,2
OfLgIUHMTKdVRebFcXDASWYEaNCJZQGPB,SHBGEHBG.CEFD.ZCDGGBEDBECGfGGGLCACUGEGhAAAMAAGdEAA..RAECFFEDhAEADABGADEDaBCCJDHB...hAFA.OAHD.HDGF.....hAEA......hAFA...,2,-30,-12,18
DBdTRKCWMEUJFaSYHLeNOfGPXbZAVIgcQ,VAAD..gGGGQDGGDECDBHAHTBAFKFDE..CGGA.MFEDhAAAUADCJBEF.SBFEhABAHAFELHCEhAAANBIGOEADfDDD..XDFDhACA.AAEA.....hADA...,1,-17,-25,8
WVdYBZEFPIKUXgAbNMSCJGDecTRHOfQaL,MCCAJCAFGGCHDFGB..eGACRBGBHBBE.QDECLABEdAGHhAAA.BDEEEFGEIHHGhAAA.UGAAAIFENDHCCGEEhAFAODDB.WABCZDBA.KAFC....hAIA......hBAA...,2,-34,-3,31
RQdYcXWMBeIfgKTCPLODGbZUFaHJNEAVS,SDAFdDAF..XGCABFDGeHECIFGBKFFC.CEEFLDDChAAAOAAEDGIDZFAEFGADhAAAaACHJCEG..EBHDAEEH.hABA............hADA......hAEA...,2,-43,-31,12
bgMJfRVcTUIOGWYKFaSECNXBAHPZdDQLe,HGFGZDAGDGDCLCAH.eAAEMBFGfDDBVGAA.TAGGhADAOHFAGFBBKACBFFFAhAAAECFG.CDCGBEHCADFFdBAA.hABA............hACA......hAEA...,1,0,-37,37
QYZLESfCPJGMFIUDOcdKaTXbRgBWANHVe,HGFGeBDGQEGELEFEEBFHCDCG.GACCMFBH.IFBADFAFOAEGhAAAdAACaHAC.XEDDhACAgEDHAHDANAEF.VGEAhABASBHF.......hACA.fBBChADA...,1,8,-26,34
ePGEgXSZNLFWHfRcUJOBKdDVITbCAMQaY,QAGDeCCHEHBG.SHGEZFDFFBEFHGFARFCDUDAHODHH.BAABhACADDDAVEEB.TABFhAAAAGAHMCGH..PCHBhABAXDAB.NAEBfBGBJFAD.hADA......hAEA...,2,-11,-8,3
fWZFAXPUNaEgJSdYIVRHGCOQbecLTDKBM,XCGCUCBCEFCF...JDCBSFAC.dAEDVGFEHBGBCBAHOEAHhAAAeFFCLAADhACADADBBEEBfHGBhADA.WHAGACHAPHBGaFEB...gBEFhABA...hAFA...,2,-34,-10,24
THbeGYKMJgVOCdANfWFLPSXREBDaUQIZc,...fFAFLCCHXAGGRABHBGEBDIECUFGCZAEH.HFDGeCGHhAAAKAEH.MCBHJDDBOHAEhABACHAGAEEHFCGE..PAAEhAAAEDAGaGGG...IAHF...hADA......hAEA...,2,-20,-15,5
QdREPOXZaYSTDGHWbLKeBAfMCFJUcNVgI,MBFHJCAF.UEBG..VEDBQGDD.EBDHOCEC.hAAAaHCCSABFhADADGBHHAACLAFEKFGDBBHGCHAGhAEAFGGD...........hAFA......hAGA.NEIE..,2,-32,-31,1
VUEGYHaBXAMfDbeNQdFPLRWZOJSgCcKTI,DDGGeGEAdAGBLADERGEG.OBAEJBDD.CAAG.KFBH....IFBDhABAEEGCHAADBHCEhACAAADB.bDFEFEEB..ZBEAhAHASGCHgEDB......hAIA......hBFA...,2,-39,-20,19
RGUMgQFEPeXSdWAVabNTLBDCfOJIYHKcZ,VDAGaHBG....TAADLCGDBBEBCAGCOBAE..JEADhAAAHDDBKGFGZCAC.GCEHhACAMFIBQADAhAAAFEEC.EHDC........hABA......hACA...,1,-22,-31,9
fTBFaJOCESgKNUZIGdMALQPHebVcRDWYX,LDACHEFHeADHVBEADFCE....XGAFBEFGaACFOBBBhAAAEBAC.KCHBZEBCdBFDMBIHhAAAAHHH.QGEAhABA.PHAE.RDGB.fDEH.hAEA......hAFA...,1,-8,-28,20
JeRIXCEOYWVNcFdbLBSTaMPQgDZfGUKHA,RFBGCHHG.ODAE..VABEFBAHLBHHBCGG..aFDBQGEHhAAADCIBGEAGKEEGAHEG.IHAEhABA.EAFBYAEChAAA..cCCAbDEH.SGGBhACAMBAF....hADA...,1,-24,-33,9
JWMPCIUEYDFaAOceTSbHKdBXVfRZNLgGQ,OEEGeDAC..TDGDSBDGHFEHBACH..XCBGhAAAfECARGCAZAFAgBFChAAAJGFAMDADCHAFIGAGhABAEABCDIEE.ACAEKGDD.......hABA......hAEA...,2,-24,-14,10
PaUFcbBJSYMAHDgeOGRNLTCIVKXdfEWQZ,DHCEeEEGRCBHLHFACFHA..IGBHKEGGdAFG.EBFCZAGB.UEDBhAAAFDBHBADA.SGDBhAAAAIBGOADF.TCCHhABA..fABH....hABA......hBAA...,1,-33,-36,3
NBHOIQdcPRMYVTJWbCXaeSUKfLAZgGDEF,ZEBHGDCCDABDFDFGBHFF.OAADdGGH.REGB.MEAB..VAFG.hAAA.JADDCFAH..eADDhAAAKEDFAIFE...EBFENIAF.hACA............hAEA......hAFA...,2,-51,-29,22
FbYgOaSCGRDTNXdVHKUMZBLcEWAQeJPfI,QFCAeEEG.JAFEfGBG.FCBEbDEHOFCE.hAAASAGGGBBFTEAGhABAdHGFVCFEKHGEMCHHhACALCAD.EEBGAIFE.IAAD..hACA......hADA...,2,-17,-15,2
RDcBCWXJaNVKYbTUAdgHPOSMQELZFIeGf,dCFCHAADSDCEEAHBLEFDFBAD.eAFFRFFBBFAHCDDG..JCHFaHDEKHGGhAAA....bECDACAFPEBFhACA..MBEAhAAA.QCGA.....hADA......hAEA...,2,-24,-22,2
JbeZfCgdIBAUDQMKSRFWaHGNcPXLVYETO,DFEEMBDHKFHBFEFGHCEAGFAD....NAAD...XGGEhAAALHAAEBAFJBCEeHAGCHECdAGChAFAAFHHSAFEhABA.aHDA.VBEE.......hAIA......hBAA...,2,-41,-5,36
McdReQVCUBbYIALJHZgETNOGDSKFPXfWa,HFBGZDAGEBCAOEEAGEDHKAEEFHGE..XBFHaAHF..dHDFeACHhAAAVBFDBHAC.IGGHhABAACAFLFBH.hACAJAAENIBFDBBF..fGAAWFHB..hAAA......hAEA...,2,-19,-12,7
QGYBKONPfDSFAVTedcHWZMJUXRIELgbCa,TBDGdDCDHAEA.MGAEJFBE.RGFE.LBBF.CHFG.QBABhAAAGAGEKFFHOHAE.hAAA.NACDDEEGAADCcFEBhABA.ZDFA..........hACA......hAGA...,2,-32,-14,18
bZIOUJfABFHcGRVEYKMedaCTWSPXLgNDQ,FGFHHEBHGCCFEFGFKEEAMFBHdEAG...CGCC.SAHDLBDCDEGHhAAAZABEUGDEAEAD.BCCEhAAA....cAGAhABAYFHBeDAGWDECPEHH....hACA......hADA...,2,-30,-17,13
CYRXJHSETUWFbKdAVGIQBLOacPefDgNMZ,VEBHQAGH.ODEGaEEC..eEHDDCCAMFADZBBCRAFDHGEEhAAASDBAEAHB.UFCDhAAA.FHGEdACFAIEABACChABA.LFFE.fAEENBAECDHB.hABA......hAFA...,1,-10,-15,5
DHPWEXNbVeOaRFgIGSfdMKLTJYQZABUcC,UGGGCAEDDGGH.HCBF.ECAF..XDEH..bGAGOGAGhAAAFABAGDDAdABCLCDEhADATAFCQCGAhAAABCHBWDBG...........hAFA.NEHCeHBC.aHDEhAGA...,1,-2,-36,34
MJXfOTYWaPGRUCLKSAbFcVHdgBEIDNeZQ,FHBGVGFGdAGA.BGFGDCGEZDBH..QDGGMIBE..JAEAXECHhAAA.OADChABATEEG..aDADPAAChAAARCDBCCCC.KDDEAAIB....cGGAEDABNHAF.hADAfABF.hAHA...,1,-22,-30,8
bCJBafKNPMITSUHQGOWZRgedFVDcYXELA,CAFBaDABKBCH..MHFC..TEGHHGBEQAAF.OCDAhABARGCAeEBFdDGGDEFDYDDHhADAEBAAAAEFBDFEfEBDhAEAIDADSFFGUGGF...hAAA.ZCDBgAGEhAFAcCGA..,2,-31,3,34
CQLeZPSAFBWdfIaNbRXKTgMOJEcHYGVDU,BFEDdHBHaAEHRBFAKBCA..MDAG..JHFAEBBEHEAD.GDDFhAAAUEGDLEED.hABAZAFHADIB.fHGFhAAAIAEFNIBBXFBB..ODAA.hABA......hACA...,2,-27,-22,5
GcHKfZDLNCYSBgFdJeXTMURAQPWVbEaOI,QCBCVAAD.aGBDODCA.GADFKBGEDFDCLCGDhAAACCFGBAACdADFXEAE.hACATFECUGGDAFHBbGAEEGEBhAGA....IHGE....hACA......hADA...,2,-35,-17,18
aLICAdPDWTZbHRKJgYBSfMNFUXVOQGecE,dHFHDACBZACBHDFBKFAGJAFA.BDDF..MDFCUEAE..OEFChAAAQABDeEDDaAFBCGHB.hAAA.AFEB...PBAFhABATGCA..........hABA......hADA...,1,-35,-39,4
TALJENKGVdPHQRUWObCXgDSfMBIZeYFac,EAABGEAHdFAGHCACQBBBRBGF.OADACFDHDFHD.MAHBBGEHIHFGhAAAZAEBFEEA...TFGGhABAAIEA.JBEFNDIE.KGCAhACA............hAIA......hBAA...,2,-30,-15,15
NILYFJVQSdUEgADWXaHOCTMZeBPRcGbKf,DAFBaGFCHDAFOEFDCCBB.ZGCABEGD..RDDHGAGCKHBA..IAGBhAAALABA.JDAEQEDFhABAdGAE.gACBhAEAACAA.WBHH...MDDEhAFA.cGCFfHGFhAAA..,1,-27,-34,7
VGQUFOYXRbLNgCcHaMfKIZBSJdWeDPAET,VBCFQCBH.ODHHXAGGLFCGCHHE.aAHDMDFFKAGDBHHAhAAASGGDdCEADABFhACAAFCAEDAH.GCGEhAAAFGFDYHAAbFBG..NABF......hADA.cADG..hAHA...,1,-9,-21,12
YSIGELDaAgOTcVUZXNCMKBJdfQebFRHPW,ODACVEFH.ZGAGCBHC.BADH..dBDCeCDCFHECHEAH..PFFBhAAASCAG.hABAIFDH.ECGBhAAAaHCEABCH.gEGB.TBBDXAEBhABAKFAEfAGEhACA..,1,-22,-31,9
AKVRBPdWegcJGFDEOTaUICSNYHfMZQXbL,VBCFBFDDdCAB.eGFCJEEC.GCEA.DGAEEAED.OCABUAEF.hAAACAAB...SDHDhABAHFADMIFEQDADhACAXFDCLAHFAHABKHBG.WHEC..hACA......hADA...,2,-24,-20,4
SYOFTHRJcKaGDUeBgQEZMVAPNCIdWXLbf,CFDGdHBHLAFCSAEHFAAB.RCFD...KEFCDAIBUCBFBCCE.ECAEMCIHhACA..AIFE..IAAChACAXFFC..hADAfEECOCEATGBCJFHFaEBA.eDADhADAQEAF..hAEA...,2,-33,-22,11
ZDWLMNfPIgaTHSGQbYcBFXEKRJAdCeVOU,eCAFOBDGDBHBLEFG.MHCCfDCH..IEABhAAAgFAFHBAAQGDFhAAAcBGEBGAAhABAEHGEKBEBAHHBCFDD.VEFG.WBAC.aGCHSGHBhACA...hABA...,2,-20,-19,1
fXaMNJcWFHeTYLGAVgOdEQDKUSZRPBICb,VFDFdDCDEGDB..KFAESGFBZDFE.BHHGCBAA...fAABhACAaAGF.MEFEhADANDAH...JEABFHGETADGhAFA.LCFEADFGQAECDFID..hAAA......hABA...,2,-43,-16,27
KLHYWCdAMDTeaGScfIXgUNJFZREbVOQPB,TGEDaAEGGDCB..SGCH..IFGCXAEChAAAgABENEIEZBAHEHAAOACFhABAQBFEKEFCLAHBhACAWCHBAFDFeFBDcCDDfDAFhAAAFFAE......hADA...,1,7,-29,36
ScGHLYDaNCFQZEAOJIKWUbBegMfRTXPdV,OEEGKDCDUFGBBFDB..MFAFRGFE..TCBCdCAA..SDFAhAAAHADDDGBCaCFACBFEZDDBhABAADIB....IBAGhAAAeBBG..fHCFPAFG...hABA......hACA...,1,-33,-36,3
GXdPYNMfIWVaOeKADgCLHFBSTcUREQJbZ,DAEDCAFBFHEABBFA...SDBAUCCCRDFD..ECHFJAAG.ZEFDdFDBhAAA....NCIG.IADHhABA.aCAHKHGAhAAA.LFAH.HEDFcFBC..hACA......hAHA...,1,-36,-43,7
DSTGBLMYINbXUKPgcORHCdfJFZWVEQaAe,SEGCGFDHMCDG....IDCCNDEHUGAG.KFBB.PBABhAAAOCAC.CAEDJHFEZAFFVEDFhABA...EBHDhACAaABEAHGH.DEEELHAG.XGGBhADA......hAEA...,1,-14,-32,18
bKWOeUBagVSNLXQJGCfAEPFTHIZDMRcYd,EAFBTGBCZFCC..MAIBRBABdCEG..KGGGeHDAUCAEBBFB.aAHDSEDEhAAALAECQEGFhAAAJABE.CCCBAFFHhABAPHBC.IGAA.DDFAYDAFhACA....hADA...,2,-28,-19,9
UgQebXNZOSVfdIATYECaBcJWMHLFKDRGP,EGFCaBEEBFHG..JBDDMIDEHAFH.FBABRFAFGBCEUEAH.QEEEhAAAXFDF.OACAhABA..fHAFhAAAAHHGCGDGLBBDKDGGDGIHgAGB..hAIA......hBAA...,2,-24,-16,8
CHVDOPgTMcIaEUWRLXGJFeQYKdBNbAfZS,ZDAGCHCHDCFCOFFB....TBBCIGAAEEGA.RCFDLDHBhAAAGGEBFFBGQBCDhABAKDADBGAGAEFEfADDhACA.SHCEPACA.MIAEaCEC..hAFA......hAGA...,1,-15,-30,15
agFYDVPbcNRIESMJXHBUTKGCAfZWLOQed,ZAADLEEGeBEEdHAHaBBE.FFGCDACA....VEAA..PBGHhAAA..bEEFcFAGhABARCCAEAGG...MIDChAFA.XCDEBEHE.......hAAA......hADA.KGDFABID,1,-17,-43,26
QFOPJVERLAUSbgMTKNBWCDIcGaefXHdYZ,SGFCMCCAKEEGBDABDFFEGEAB.eAGDHEAGZAACOCHDhAAAJDDE.RGCEAHBD..gCAFhABANACH.IHBEhACAfAHA.dHGFFAHFEDDALHEAhADA......hAEA...,1,-12,-22,10
VLfXMeYSHDNZcPEUOKgIdbFBTWCJRGAaQ,VBCFLDAC.XGBAMFFH..SCBDDAAAZCFB.EAAE.hADAKGDHdFCB.BHEATAGBhACACAFDRFGBACCG..aDAHfAHEhAEA.eBEDNDGAUGAG.OCHDhADA.....hAGA...,1,-12,-28,16
GadHSPULXTcBDfIgYCAbFQKMVOEeZRJWN,QGBCMFCF.ODCCZGFERDGHJACG.GCAHdAGGSEFHhAAA.PBCGUEEETAGGhAAADBBF.IBAEhABACGHGAACCKHEEEEAE.eBHHWFDD....hACA......hAGA...,1,-14,-26,12
dRIGQLWFMPNcTaBUDgfSZeJbXCEVAYHOK,HFDFOEGHKDDGdBDDRBBAGBGCLEHB.MFDB..NCAA..TEBFhAAAUEAGDAHH.SEEBhAAAeFGBXBEBhABAEABAAIBA.IHAA..WHFG.cBAHhABA.....hACA...,1,-14,-26,12
XCPaNHBSeEYMbgTLQOcfRIdFUVDAKWZGJ,KCFCZEBHJFABCEEG....aAACBDFC.eBAEMIAG...TDAGhABAOBDA.RGFGFEHDVEGBhACA..AIDEGDDEhAAA..XDCF.HFACECAE...hABA......hACA...,2,-29,-29,0
AgHKTQfZMBJFXVbPEeDORNcIWGULdCaYS,HDAGKEHBQCBBMFBHJEFF.FBGB..XADA..PFEHhAAADIDAOEHBRGAE.IBAHhAAAUACFCHGAaEDBAGIB.hABA.fAHCBBAFEFFENAFEWAFH.dDDA.hABA......hADA...,1,-15,-23,8
YGKTLdUfBZMRISVHEQCeAWacgOJDbXNFP,aHBGOGEA.DAGCXCBB..FHBAGFDBKBGELAEBhAAAdAAFBFAEMIECSADBhAFAEEEA.QCGHhAGAAABC.cDDBbCBFYDADfAGF.hADA......hBAA...,1,-13,-37,24
aCcRHWfYPIGDZLgVdFOBbSNEAJQKeXUTM,QAADKGDDeCBHUDEBaHEC...RAEBHAAE..fDEDhAAA.IEABhACADGHBgGAAVAGDOFBChADA.BBDDNCAAAFIDXBGBCGFH...hAEA......hAFA...,2,-25,-24,1
KFaXUZGVMIJePfOWRdHNYAQbSgCDcELTB,SGFCCAEDDDDH.LBAFBGDFFGFGXCGGZBGB..MFIDhAAAIFCA.eAFAhAAAODBFdBCHHFABACIF.hABAgDDDTABHaHFE......hADA......hAFA...,1,-8,-50,42
NaZKUYDPGIOHRXBEecLfJdTMASbWFCgVQ,SHBGFHBGCEDC.QAGEaADH.ZFDFKBFHUCAEDGAGGCADhAAAODDARGFABFGA..hABAeDGF.LAAAhABA.dFAFABBCbFEH.....WAFChACA...NDIE...hAEA...,1,-3,-48,45
fQEdAKJFTaUPVSZRBONMXDGWYgIeLbHcC,KEEDFAADUFCB..SDBDBDBD.OAFDXDDADDHFGABHhAAA..gGADhAAAIHAB...hABAbAFCCGHFEHCG.AGFH........hACA......hADA.JDHHaECF,1,-35,-45,10
TLDJHUVRgQABYKaFIfPNcCXebOMESdZGW,KEGDaAFB.FCAB....PAHFCHAE.eDBGMAIB.dBECZABCGEAFhAAATGDGLAGFhABAHDGHUGBERFEB.AIFABFFFhAAAIHCEcGGC.XEACEABADIGA...hAEA......hAFA...,2,-26,1,27
LTXDfOaVIZJBQCgRMGEdAbPWcNHFUeKYS,...bFDFPGEA....NDBGFBCHKBBGLFBHDDAF.OAHDhAAAIHCAZAFBJDAEhABABGGDCHDGRDFAEAGE.dCGCAIHE.hACA....WECCcADF....hAFA......hBAA...,1,-25,-36,11
HRdFDBUbCXSVOfTcaGWgAPINZMJeELYQK,..IFDGNCAF.ZFGFMFEF..JAAAEAGCLBHHKFCFHCEBdEBGhADABDHECGAG.SDBAhAAAODDG.TGFEhABAaHCA............hACA......hADA...,2,-36,-31,5
HbaOWKRdJXNgEBeIZMDCTfYUcLGPFQASV,VBCFHDAGOHDG.RACHdBGEJFGH...XFFAEDFGeFCGZFAHDBIBhAAACGCC....fAABhACAUAFCLBABhABAPEEAAFEAaACA.NEIABHBAMDID.....hAEA......hAFA...,2,-19,-14,5
WNVXUATPBdgKQESGLcaHYZFCeRDMfbJIO,BHHGdAFBKEFFEBBCLDHDHBFGFGBFRGBE..DEDDMAEE...JEDHIDBAhAAA.OABEhABANDADUFGF..AHHH..hAAA..TBFC.......hABA......hACA...,1,-35,-36,1
aZFXONHdSfTKcbGADYCLegIMQUPWRJEVB,DAEDCAFBLFECeHFA..MIBAQCGD.UCBBRDEEVCBA.hAAA.BACGFGBENDAAHEBHhABA.SHEEhADAKAAC..bFFCAHBH.gBGHIAHH...hAEA......hBAA...,1,-19,-30,11
VHcSMBNDZTRGQIWUXeLPCAfdgOEFYKJba,dHBHEDCDFFHFJEGH.....aGBGHCCF.SAAFBBCDDCFATFEDhAAARAFFQADF.hABA.IAFG.hACA.WFEHeDAFCEHBfBBAOHBEKAHBcACAhAEAMAIFNEAE....hAHA...,1,-17,-35,18
LKMdPQcOTNVZAaJYCHDIEgBebSFXRGUfW,JCCHHDBH.DIBEEABEeDFD.FBCGGEGA.UADELAHFMEFBdGBFhAAAPFAH.OHFAhAAATAFCZDDF.AGDHaCABhABAICHEBEHA.........hACA......hADA...,2,-26,-13,13
CDFHfXQbgPMTdKOaALBJNRIUEeVcWGZSY,LEGHBAFBRFFBUFBBVBBE..GCAHZDEHCHAF.HCFE..XAFBhAAAQAAB..hABAgFBBMEABKEEDAEIFhADANCAA.IHED..eEBE.WABChAIADIBA.fHDHhBAA...,2,-30,-13,17
aQGgMfZXEYcWKdHJVASeUNTLOPDRICFBb,SGDDeDACUFAFLABCOEDF.DGGBCHGHFBDDBHHG..QAFChAAAMFEFZCEEEBCE.hABA.YCHDKBFCJDHB.hAAAAGFETCAF.IHAG...hAFA......hAGA...,1,-25,-27,2
aMPXNHOWGcfbIeFUZdYLKCVTRJEgQABDS,BFEAaGCD.MDCG..PBEEHBGDGGEB..fHFBhAAAeFBCFBDAdACGLDEChABACEAC.RDAGEADHAAIDSGBAhAAAXFAHOEFC.cGGA.hABA......hAEA...,2,-26,-8,18
CQdFPcDXJOEIeYHTSKMNAagVRLZfBUWGb,aCFCVGFGZFAC..UGCBGACB..QAFFdGEDFEDGDHAAXAAFhADAEBAD..ICCChAAAHDCESDGGhAEA.MAIDAIGELFFCfGAGBHHBCEBDcBDFhAGA...hABA...,2,-27,-7,20
GAKaeOZYQXTSUfJIgWFdELBcCRHDbNVMP,KEEDeFFBOCABZBACQDFE..XDCFTAGESDADhAAAUCGEJFGD.gFBFhABAdGBABEBGCABGDIAA.hAAANDEE...MCCAABEFfFHAIAHDEGDDhACA......hADA...,2,-36,-7,29
ABbOLXFJQHEdKSVGIfeUgZTNaCDMRYcPW,BAFBOEEGLEEH.FHBGQGBEdDDCKAAF.VAFCGBGGhABAIDADeDBBUGGChACAZFDFTBCF.aACGDAIHhADAMFGH...YDHBPBCCAFBB..hAEA......hAHA...,2,-20,-11,9
BZNYIDCFOcegGMKUWPbfJEXQRAaVSdLTH,aEHBVFEELGBC.BCEBZFAE..IHCDDICCFAEE..OAABhABAeBDFMBAF.KDBBhAAAUDBH..WAFChABAfGFB.EAHDQBFDAEEF.hACA......hADA...,2,-38,-26,12
KVdQRFBfSJUGAeIPOWHEcZYgXTMbNaLDC,eGEAOGEAEBFFZFAD....XDGETBCAMIFAaBBBLECGhAAADAHBKAFH..dDGBFADG.hAAAfCCHJBADAEDC.hABAIGABHFCB.YHCANFEB.CCGA..hACA......hADA...,1,-9,-18,9
CgGANFUdSZEKTecRfJWIBYaLVXbDHOPMQ,UGBCdEHAEAACeBEF.REGF.JEEDBEBCLADF..VAGDDECHOAFDhAAA..PBAChAAACHDGAHAE.FFEBKGFA..hAFA..fDFEICBF...YABChAFA....hAGA...,1,-33,-38,5
LQTURPHSIeBWbCaMcgdEXJNFAKVfZOGYD,KCFCVGFGOCDB.GEFALCDC.QDGERABHHDAFeHBAhAAABACGCFHB.aFEB.MAFChAAAdAEB.EBABNAIE..AHHG.fEAFhABADBAF.TGBD.SEDChADA....hAEA...,1,-14,-20,6
VPUegRFabOGSZXBJHWcMYdDCKNEAIfLTQ,LGEAQCCBUCAC.eDEGFGDAbCGH..SFGEhAAABAADJEADHADCMBBGdFBEDACCCGHHhABANABD...AICCIDFFhAGAfAHE.PDDB.....hAHA......hAIA...,1,-17,-27,10
OWEFgGPARdUbHZDCNYQcJMTBSfIVXeKLa,UCCBHGFGDBFCCFGC.QDBC.MADDSHAG.IAADhACAeEDALCHHhAAAOBFE.WAEFFHGAGDAEhADAAIAEbGAA.ZDEB...YDHH.hABAJADEBBBA...hAHA...,2,-28,-8,20
ZYSfVAIgXMNBUCDcKEWRGOFQHdLPTbJea,XCBCMBFHUDGFDFGB..KAAFRCEA..OFCDHFFCdCDG.LEBFhABATFAE.JHDCeAFChAAA.aADFSAGHhACA.AHID.NBAEBEED.EHGA.FBBA..hABA......hACA...,1,-19,-26,7
XKEfFJDSNTUIPbGWBcZVHQMCOadgeALRY,LFBBXFDHKEABFCDBDBDG...SGDFUBDG..IHGAhAAAGDFEBHHAhAAAZDFEQGABMDADCBAEaAHBhABAeABDAACC.EFGA.NACB.......hAHA......hAIA...,2,-32,-25,7
ZCOaSEYAeHIKWdVfXJGBMbDcUPNgRQLTF,eFBBHDAGKGHHdGDA...XBAFJCEEBCCADGBAUACB..PEEChAAARDFALHFAZADAOAFAhABA..EDAEYHCAhACAIBAB..fCCBMAFE.NBIE.hAEATFGE...hCAA...,2,-22,-21,1
BEQUNbfSDYdTAZcKOaHMFJGLCPXRgVWeI,ZDAGOCCHaEGE.HAFDFCAE.JFEGGFBB.LHEACHEARBDF..VFAFhAAAeBFBBEAFQAGAhAAAUABF....hABANDIG.SABADAIFdFDCACAF.KGAD....hACA......hAEA...,1,-13,-14,1
EZfQgYIMTWRGBKcNVXdSbFJLeDCPUHaAO,ODCHECFCZBBC..QDGD..IEAAMAAB.TBAEhAAAREAEGEEEKAGGNDEEdHGB.hABAFHBELHFADDBACAGF.hABAHFFEAAIF.gGAB.BHDD.hACAXADA..hACA...,2,-25,-9,16
NOGfBVbWDCHIEgeQdaMKTYcSUFJLRPAXZ,ZEFHGECFBBHC..VBAHDDEFCFHDHDGH.EAEAQADCdHCH.hAAAKGDGTBFE.SGGAhABAFCBCRFAEABAH.OEABhACA.fDCFWHAG..eAAGhACAMIFE.....hAFA...,2,-44,9,53
UbOLQTGgDCeFSfVWdaBXJKNAPIcRHEMYZ,..IFDGRGFGHBDAEEEGZFGF.OFAHLGCAGCACDDECFDBE..hAAAfHCFdBHGBEEEJBDChABANAABAIFE...MCAAhACAYCHD..bFAF......hADA......hAEA...,2,-25,-9,16
NCgHdaFBVSOGbcMQTLJDeYKRAEIPXWUZf,EHBGXCBCZDFG..CAGEHGFAaFBE.BCAGVCFFGCBG.MBAChAAALHFA.DHCCeAFDhABARADGAAIBIABDhAAAPEDDfFGBNDAA..gFGAhADASEADcEDA..hAFA...,1,-2,-24,22
PeWLMTJGOXcbVfZBDaNHSFEgAYQIdCURK,QCBCCFEDKDEA.eHDALACB.MAEDJEDEGABD.hAAAXCFAVFAFBDHAhABAaGBDSAFHhAAAEAFCAFFEdHGF.UGGE.WEADcGDC...fCFBhAFADBADNAIE..hAIA...,1,-1,-40,39
TSUdEWYRXJfaFGgQPOAVHeLIKcCMDbNZB,VDBGLFFC.KAHDMFFADHDCZADABAHD.UAEHdCEG..ECBDRFAD..hAAA.JEAHFAAC.QGGEhACAAFDC.eHCAhADAIABC.CGGB....NICF.SCGAhAFA..XCGEhAEAaFCE,1,-27,-40,13
eYKHJZASdfOcgPLMbGFEUNITBVRaWCQXD,SAFBOCCH....PDAFMIDEbBDDFDGBUADE..hAAANHEFBDFEaGGG.CAAEQEAAhACADFDBKFEF.JFCAhADAAHCBdHFH..fBHGcAGC...hABA......hACA...,1,-22,-35,13
QKUfWHFgBcDCXPLMAJeNaRTdSObZGYEVI,JEEGaDCD..dEHEOBAAZAAEGBDF..EAEBQEFCUGCD.hAAAHGBEBFAGCGAFXCAAhAAALCAG.AIHE.eCFAhABANAEF.SGHB......hACA......hADA...,2,-38,-7,31
AKFQdCEJIONgXRLYWaDcHUPTVZBbfMSGe,FFAAQGAFCBDD.JBCDOFDD..XEFDLAECaBEDDEDGhAAAHBGBUFFD..PAAHhABAZBAF.BHHHfDFBhABAMEEHSAEFAACA....hACA......hADA.EHFANBIA,2,-44,-18,26
eZabGDPCHEAcXJKMfSVdQRLYgWFBTINUO,XDACMEGF..VCCDRECELAGF..gCFChAAABABAICCHOGAAeHEEhAAAaFHDDCBBCBHCABFD.KADBSFGEhABA.YFABWFFDNAIE....hADA......hAEA...,2,-31,-26,5
ELXUQPRFaDefBTKZSWYAIgNJMObCHGVdc,..IFDGNDEH..MBDFOEHFHGCAGADGVEGB.dGBCEAACUBFEhAAAREAG.aDBADDAABGFEhABATAGAKHCE..SACFhAFAAFFB..gGAD.CAEA.hAAA......hADA...,2,-20,-17,3
YAWQdMfgESTeZXUbHcNaPVGJDOCIBRLFK,dGFCMCCAEGCD..eDHBUAGAHEBA..aEACPFABGBCG.OEHFhAAACAECRGDEKBAD.ADDH.QCEChABASEEB.hACA............hADA......hAEA...,2,-26,-24,2
cFKCWPBAYDSEGeQLVRfOgHaJMdbTNUIXZ,DGHHGACBLDDEREEDOFAAHGAA.MCEGdDCF....TGCEhAAANBCFUCAHZEGF.KAHHCHFHBAAChACAAAGG.EEFD.eEHBhADAfBAA........hABA......hACA...,1,-18,-25,7
cVYEFBbGSQZAXeUONKgLfRdJMCDHITaPW,XDCHeFCAUBGDKBGDLAAF.dEHEJFHFDDDBHCAD.IHDDhAAAaGGC..PAEFhACA..cCEChABAEBBCBHBGSGFBQEAFAHBBNACD.fHDBhADACAHA....hAEA...,2,-22,-21,1
HaeJXGKbZIQScWgVdLPRDTUABOfENMYFC,BAFBEDCD.MFGDCGEAHBAE..JBBAKAHFZCEDSAEH..hAAAgEABLDHHDFEAhABAAFHG.ODAH.hAAAfGCH.NICDaGBBeBHB...hACA......hADA...,2,-49,-22,27
HDBEaZfJRVWCGXOITPbFMcdNQSLUgKAYe,eFBBDAAFBEDAZABHRADF..CFBCGBEHOAHF....TGDAFDHHMBCAhABAdFFHQCFFhAAALFFDKAGEAHIB.HCAE.hADAaGGAfGAE......hAFA......hAGA...,1,-18,-29,11
gVGeWPELUDOIAFfbZNaQKHTBYdXJScRCM,FHBGZAADaEBAHCCC.BBGHdHEF...SEHHCAGDMCGF.GEAFhAAAeFBG.EGFDDAIHAEAEbBACQCDBhAAA.TFGGhADAJDGB...........hABA......hACA...,1,-21,-27,6
PgHdZYDECfeAaBJWOcSFLUMXQbGINKVRT,JCAFOGEA.FAEDLFEB.MBCAXAAFGCFGKHEARDCH..hADA.TCFG.HDBFhAEAYCCCEEEEfGADhAGAADIFBHBCSHGA.QAGEhAAAIEHF.NABF...hAGA...,2,-23,-19,4
TfCDEBFLJHSYUOQIgdXNbVZGRceAaWKMP,aAFBKGFHMGBC..TCDEDFIHBEABLEFCHACG.SBHFhAAAUAAE.IHHGhABAXEFENDAAZABERCDAAEFC.fGBAhACAFHCG.JGDAQAGE..hADA......hAFA...,1,-6,-26,20
HcWIZUCLgbGFdOeBVaSEYRQJPMTKDXANf,HAAD..IFDGZFFCLAECGGEBFHFCeAEHVECFaCCFEDDEQBGBhAAA.MBBHhABADCHBACDGNDAC.fBFAhAAAcGAD..CFFCdACF.BDHA...hACA.SDAGhADA...,2,-22,1,23
PaAZHcdETOJWBgRKFMYQUGbIeSfXCDVNL,ZGFGHDAGdAHAEFEBOFAGBBFHKBHD..MBCBUGAEGBECeDFG.SAADhABAXBCBCBAFDGFAhACALFFBADAG..hAAAcGAD.........hABA......hACA...,2,-26,-23,3
faMNdcKZJWGOeAbQVCBgDRIXFEYTLUSHP,VEFHBBBDREFH.FECGECCF..LAHDHADGaBGDdBDBZGCAGEAE.hAAAAEID.CHAEDCAD.XABFhAEATGCF..SAAFhACAfECFMDACNAIE.KHGA....hADA......hAEA...,1,-11,-25,14
dPfNCEZQSMLAbUcVWHeFBTIDJGXROKagY,UCBCVAAD.eGAEBAGGDHEAGGEB.REDC.aBFG..dCGF..fEFChAAACCDGEFAH.ZDDDhABAMFCBABDE....hAAAcGGE...WACCTADE.XDAChACA.KDHD.hAGA...,2,-41,-15,26
AGFHLVQWRgCdPTNKfOaUBMcbYZSeIEXDJ,FCAHHDBGQDDBRGACCCBF.dCGCTGEH.KBGBOHDEBCFG.bABBhAAASEFE.hAEAEACGJFFAAHHD.LGBChAFA.gAFCNBAGaAGGMCIF....hAAA......hABA...,1,-12,-23,11
UeXPHTOWDfLVEFIACGMaSgYQKNRcdJbBZ,CGADMACA..aCHDSGEE.QFBEKDBHNABH.REFGJCDGhAAABHCF.UDFG.eAEAhAAAPCBBHBCAOAHHhABADGCG....fHGB.EEDAhAIAIHHEACBH..hAGA...,1,-27,-33,6
OLdNEMePVWKYcFBGIbTRHXCfSDAZaQJUg,QCCBJDAC.OGDAdEFDEACG.eFDGVAEE..KHCEFEAGBABDhAAAGCGE.IABHhAAATAFHRCFACAHBDIDAAGHCZFAFhAEA............hAFA......hAHA...,1,-23,-29,6
JHgSYRMAcGPEQZCbLDUOIWFfTeBVXKaNd,GAFEQGBCCDBHDDFBOBCF..FHGEeDFHBHDAKBECdADDHAGFhAAA.SHGEhABA.MBBBAGHCPAABhABAEFDB...ZCCF.LBHBIFHCWEADhACA......hAEA...,2,-37,-10,27
FULECXBNdgRYKOIcSPeaAHJbMTZfVQWGD,HFDFMDEBZAABQBGBDECF.FAEBUBFECCADBCBBdGGG.RCEF.KACGOFGFhAAA..SHCAhAAA.aGADAGIHJHAChABA..bDFAfDCA....hACA......hADA...,1,-23,-32,9
LBcMVURFgGQPJeZKWHYaASDObXdITEfNC,OEACdGFCEGCD..CBFD.BHFG.MBAEUAACFBGCQDDC.hAAAeFADKCCHHGAA.hADAaCEDSEGChAEADCACXFFAIDBG..NEIE.cBGE.hABA......hACA...,2,-35,-24,11
ZDGXAOgUHacNCLTJbSdRfFIMPKYQEWBeV,ODACHEFHaFBE.CBCD.TGCG..bAEDdEEB.REGFFBBE..MAHFhAAAKBHFEAFHBDBA.eFEBhABAZADFDFAFADID...hACA.cGAHNIEFSBAFfHGF..hADA......hAEA...,1,-17,-26,9
PMVOWfGaeHYJTNEQBCdDKgScRbAXULFIZ,XDCHUGGDFCEBZAEA..VGAG.OADDGCAC.HAAGJBFG.hAAAEDHHCABE.DAFC.SGDChAAARFEDAHHALDGFMCDFhABA...aHDEeDAF......hADA......hAFA...,2,-24,-13,11
XaNHGRbEJQdIfLBMFPKVgeYDCScAWOZTU,OFBBTDCB.UEFF..aDGEHBAERACCEBAEJFDF..dHBHLDAAhAAAMAGDKFGEeAGB.DIGChABACFACACHA.ZFCENAIE...hACA............hADA......hAEA...,1,-23,-25,2
GeRKaFAYgcBHMNUfDIOWEVCZPSLQTXdbJ,....gCBCHDBHMAGBUFBCIBCFOFGFEFGFZAGHLBHBhAAAQCEFXEEGhABAJABGeEEDKADCAHAABAEAhAAADFIDCHCASHEG......hABA......hAIA...,2,-16,-16,0
UAcXHYbWLVFSCTRgBZdaPQOIMfEDeNKJG,HEFH..bAADVBACSAFECAGC.RACBBDHGdFBEaECF.QGDHhAAAIGBCMEDEhAAAEADCDDADKFGC.UFDDXDDBhABALCFCFBGE.gGGG..hACA......hAEA...,1,-9,-18,9
EXbPgfWTQSLOZdaMcJICBAFDGUNeRYVKH,FEHBUCCBeCCGREFB.KDBGHFBB.EBAH..XEEA..PDAFhAAA..fFCGhAAAQAGGOHBChABAaDFAMIDEIGAGCEHADFEBNABFbABE.TAFFhACA.SGHHhADA...,2,-34,-9,25
QNeVSgJdIYbTWEOcUaBfRFXLAMCHGPDKZ,MEEDCBGFHFEEDBABZACB...QEBAeHBESBEEJBHD.dGFBhAAA..IAAChACATDGAODDA.aECFhABABEFEFFAEAIGAKGAAgBBCWBEFEHFA.fAHEhACA...hAFA...,1,-11,-31,20
dMFCNWbTDHRgXSYEQAcGKaOJBLZIUVfeP,KGAHOFFBBFHEZBFEUECF..eBBEdAEF.MEEDFGFD...NACD..hAAA.TABCDDDFHDGFhAAARBDA.SHBGhABA.EEBBAIDGaDAB.IDGDfGHACFFF.hABA......hADA...,2,-42,-14,28
gVbSaZNBfQACXLUMEWOKcDPRFGIeTJYdH,XEBEUAFHEFEE.KBCHDCCE..RBGH.FHGEGFEF..TDGChAAAdAABVGAA..SGDGhABA.aEAGBAGFhADAACBFMICEOBEDIADFYBBF..hAEA......hAFA...,1,-24,-32,8
caCTHPXEMbJQYFfZAVgRIOeSGDKLNWBdU,VGFGRAADOFCC..eAFBGCEBLEBABBHCdEFHUABH.CCDAHGAAhAAAEAEHMIFA...hACA..bDAC...hAEA..YHAAfDGCAGGGIACChAAADDIFWDEH.aAGA...hAEA...,1,-14,-22,8
FSPEDAfYKVeMbaHCGTOQZLIdgcXRBNJUW,KHBGMAGDHBFAGBAAOEEBLACG.dHGFXEAFBEEDUEGHhAAAFAAESADHhAAADHBCACFH.VDGFaECBCHEEZCCA.hABAIAHF.cGGCNEAC....hADA......hAFA...,1,-16,-22,6
ZXKYPEQCSLAcMOVJUTFBIaGeNbfgWDRHd,OCHDJBDG.FDFDBGDHGBCGeABD......NBBG.fFGBhAAADIGEHGAGXABFhAAAKFABEEEA..CDEFADAAcAFAhAEAMDDH...TFDFIAHDaHDE..hACA.gCGBhADAdGGF...,1,-2,-48,46
ASgCDVYcdQLMNJTXIHEUKFGBObaZPefRW,CFEDVFDGdHADLBFA..JDDC..TDGHXAFEHAACEEBFhAAAFECHBBCEODCGZGAC.hABAeFHF..fGHChACAAGBBDADA.cDABMIDE.....hAAA......hABA...,1,-20,-29,9
bfYKdaAQBWCHMSNIOPVJgGeXDcETRFLZU,BHHGHDBHMIDGSDGFOAEE..JBEDeFFCDAAB.EFDD.FBBAZCBHhABA.UGAD...hAAA.YHAEdEHGABIDCBGE.hACANABF.VFEFXBGA......hAHA......hAIA...,2,-34,-16,18
ZMHNbIDGBfREgVSYPFAKUQWcaCJTedXOL,KEHBUCGCQCBB..aFHFCDEBeEABOCCAZEFDMFAB.HFBEhAAAIGDABFEBECAHhABASBECFGGD.AAAFJAHFhABAdACFXDBALFCEDACD....hADA......hAEA...,2,-23,-16,7
AKYLHXCURVZFMSWEaGJIBcegbPTOdfDQN,LCCHXADCUAAFZEFBSCHB.EHDEGFDF.BHDChABAgBEDPDDETBGHhAEAfAGADAFEAIEAhAIAYEAHCHHEFGBF.aAAA.IFEE.hBGA......hBIA...,1,-13,-22,9
IbVeNZYGDQUARPFCWSJdBHgLEcfTXaOKM,RDAGCFED...JBFFdBCAHGAAECEA....TDFDXEED.aAGCMABAhAAA...IFAGhAFAbABB.eHAEYHDGhAAADIFAADHEFECHBEHGLBEE.fGGDhAGAKADB...hAFA...,2,-28,-19,9
XONEcFaTMYPLRDSCQJABZWUfbVeGHKIdg,ZDBHUCBC..VBFCeFDGKGGBdAGF..OFEBEHFA..aACGMEBBhAAALFAB.DHCCSADGhABACCFD.ABCFfEEDhACAbCGH.......hAAA......hABA...,2,-34,-32,2
SOWbHFQPBLZJCETXVGKUaIAecMNDdgRfY,MDEBDGHHRCEC...SCAHOAHFHFBHFHCABAAELACDZACCCAHBXADDhAAA.KAFEUDFDhADAAGFE.eGFAdBAEfEGBhABAbCCB..JFAC.EBHB...hBDA......hBFA...,1,-16,-22,6
OeXZSdERIbUWDPQCgTafGALJcKNBYVHFM,LEEGKDCDBEHCHAAFOBFCZFEFdABG.RFBC.UAFGDIGA...CHBH.aEAAhAAAADHE....JADFNDCD.hADA..FEADMFAD.hAAAeGECEGHF....IDFFWHBGgADFhAGA...hACA...,1,-16,-39,23
aSYBLEUFPDHTAGKcXfNIgdCbWQOJMReZV,KGAHXCBC..IGEFCFDG.QEAHMHEARAEEZAAEaBDBSDEChAAA.BDHFhABAEEDEPAADDICGAECG.hACAGAEEfGAENDHC.dFFFOHCC.hAEA......hAGA...,1,-19,-27,8
QeYWFMNKIARcOEDafZGbSXVdCTBLPHgUJ,RFDFEDCDDCGAZEGBGDGA..SDABdGAGCBDA.TAAFLCAFhAAAHAEAUBBEJEEHeGAGhAAAFDFBKGBBADGDOHCE.hABAfCGB.XACBBFCB..hAGA......hAHA...,2,-28,-9,19
FaQbSNTVEGfKOeAUgdLICBRPZHJYMWXDc,dGFCLAFBCDFBBDBGRBCGHEFC.MICADAFCFFBAQDAH.SACEhAAAVAAA.fAHGhABAeEFAAEEG.IHHGhAIAZAFE.YDDF....hBAA......hBBA...,2,-51,-11,40
cgXHFbYeSAOGPJRLCMBZIfVKdNDWaEQUT,GECFJFBBLAACMFBDBADGZDEC...IDGCKBECDCCB.aCBFUGDHhAEA....cAGDhAAAXAGF.FGGFhAFA............hBBA......hBCA...,2,-41,-39,2
KHfZUBFNOCdGVEAPTMQIJDbcSeXLYRgWa,MFFFQDACDGCC.SEEHLBFCRCFGaAGHKGGF..ZDCDBCDDhAAAOFHDCFAB.GBAFhAAAABEF.IAEBJBBBeHAAhABA............hACA......hADA...,2,-40,-18,22
gLPZIXEHFeUaATMVcfQWSODRCNGBKJbdY,TFCAMECG..VACGQGFG.SAAFDAFACEGGBFHAKBDChACAdFCCLDDEZAAFEBFA.hACAFBHB.UFAGADIF.fCBHhADAOFDFNDDF.bEEA....PFFBhAIA.....hAEA...,1,-14,-25,11
bReZIcJEPgOKCVDHfTFWaBLMdUYXSGQNA,RFDFeFBBZEAA...JDDCECDD..OHFEKBBBCAHH.HBAB.FAEEaGGAMAHFhAAA..dHFFUACEhABAXGACSEHDhAIAGBEFAFGD...IAACgGDADDIBfACBhAEABFCB..hAFA...,2,-32,-10,22
CBfSHTLMOdFVcQRagJNUZYbWGEDePIAKX,KFFBXGDGCDFB.BEEBHACGLADAdBAEFGBA.QFAHRAGF.hAAAaAACJDDFZCAA...hABAbCEAEEHF.DIGEIGHHhABAAIAA.SEAE....hACA......hAEA...,2,-38,-19,19
LKZCPcUBARbVWGHOXeFMIQEgfYNdSDaJT,RGFGVAADHACG.eBADMADEECCE.....fEGENCDC.hAAASHCADFCHTBGAhACAKCGEPHFAUFACAGDEGEEFhAHAFAGEIEEHQCEC....hAIA......hBDA...,1,-1,-19,18
VOHDKdZAfTeQgcCbSNXYIFPaJBEWRUMLG,TDACeDACQAAB.CFEH.SFAA.XDFGhAAAYBFBPBAGBADCEFHBhABAUFGAMIBELHBGhABAOGAGDDGGKAHFAHABcADEIDHDaEDFWCEFhAFA......hAGA...,1,-7,-28,21
QeFNfagUJLEPIDHVTMOSKCGdRWYXbBZcA,QGGDFDCD.aCACgACG.LAFGIBHGDFIFhAAATCFDOHAGCAECdABChAAARGEG.XFEFBDAEAEGDfCGGhABAEEHBPFCD.......hADA......hAGA...,1,-21,-29,8
GPJdOXUWeVQbHDNSMfRITZFaEcCgLBKAY,GAFEdDCDUDGGeEFA.QCCHDAAHMEFF.RAAFZFEAFADF...EHAAhAAACBFEBGHDAIHA..YFAGhACA.OHDAhADAXFCF.VFAF......hABA......hACA...,1,0,-48,48
MTBVIdYNKfcCgUHRaEbOXAeSGLJDWZFQP,SAEGJHDAZDAF.QGDAMFFE.BCEFdCHAKAAFCCHF.UAEChABAHEFG.aBBH.bFACAGEALCCHhACA.FHAEhADAPHAC.IACDfGGBcGGEhAAA.RDDC.....hABA...,1,-15,-31,16
XDEgKWefOFSGQJVPYRBIUAbLHaMdTcCNZ,LFBBaHDC.TAGHCEFDZABGDGGA..EEGGKHFCeBAC.OFFHhAAAGBGAQDDFhABAJFAC....VCCFhAAARADFIGAD.......hABA.AIHE.....hACA...,1,-8,-40,32
JUeRSLAcPGYZNHXgbfCVDdBQEIOWKMFaT,GAFEZAADHDCC.XFAGfFBA.CACG.DIEGBDHEEFGEOHCGhAAAKDEFMFFHFAEA.aFDCTDAGhAAA...eHBAhABASBHBAGGB.PACF.gCFDhAHAdADA...hAFA...,2,-26,-6,20
DEKHcgfbCGXVaRSTZYOdANPUMQILFeJBW,UCBCQFDBFFBDBAABDDIDKCEC..HFEA..fHEFhAAAGAEBXDGFVBBDaAHFhABASFDFZDEG.hACAdDACAGBGMBEEIACHLFADJDDA.cGGEhADACHAD.....hAEA...,2,-22,-5,17
VKQHLFRNEAgCaIDcTYBGOeUPfMWJdXbSZ,aEGDDACB....TEBEGCEA.UGBHMDAGJEACdHAD..SCGGhAAAKEGAQBEAhAAA.FHGARACAEBABAABDIFEFhADABAGA...OHDEfGHA.hAEA......hAFA.WAGB.,2,-26,-25,1
AILYMHECGDebgcTFaORUPNWdZJXfSVQKB,LGEAMECGHFAAGADGDDIH.eDGH..gGGAFCBCaHAEUAGEhAAA..NDDFdAFEJFBESDADhABAKGEEAFFG.hAAAIACACBDHcABD.......hAFA......hBAA...,1,-17,-22,5
ICNBSGMVgKOXWfTFdEJHDZcePARYaLbQU,RDAGLCCHQAACUBEE.CFGB.BCCDGCAGMIAEKHBA..OADGhACA..XGEHhAAAfEGCFAHDEACCDGIHZAGBhBAAeEEFAIEAaFEB.IGBDSGGG.hBDA......hBFA...,2,-26,-17,9
XfHbCDINaLTORMgeUZVAFdJWKBcYQEPSG,FEEDJCCHBFGCQGFE..SBEGGACGHEBBDDIF.IHADhAAALHBARAGFgBADhABAeACCZAGBABAEKHGGEAEG.hACA....PCAFfDHACEFF..hAGATFBE...hAIA...,1,-6,-30,24
RDTONAZQXSefUBJMWLFHKbECcagIVPYdG,QDCBXGGD.SFBBeCBBBBFHMBIFFHDCHDFC.KADChAAAEGHBCHAF.aHEC.VAEEhAAAdFFEDBAE..TFEDhABAAAGCfDDEUACELHAA.gDGDhAHA...hABA...,1,7,-30,37
LHIQGMJeObdWVcZfETDSUABRYCFaPgKNX,RDBHFEGD...aAEFKBGCLHBGHACAQGDCGCAG.eFEEdCCFVAGFhAAAfAAC.hABATGAHDFDDAGEACHHGgDFEhAAAIACG.MIFE......hACA......hAEA...,1,-12,-22,10
cPCUXEdDIKFgZSHVYRQWOaJNBeLMfbTAG,GAFECFDGUBDH.dDCA.KEGGFFABZBBEHEFF.RBAD.OABA.aFEFBEDEhAAA.MIEA..hABATFAHAIAA.XAAChAFAICHFSGHF...YHBGhAHA...hACA...,1,-16,-44,28
KeYXVaDCURWGNMLPgFcAZQTdJfObBHISE,QDCBTGGD.JHDGOFCA.BDAHHGAESCDFhAAAKFDGXCGGVBGFDCBDCCBBUGBDhABARACH...NADD.MBFChAAA.gGGBAGFCfCEA...hABA......hACA...,2,-22,-20,2
cLBaZNGVQefgHXbSTdMJREPFOCWYIAUDK,KDABLAFBZFACGEGAVECB...eAHFHACGSFFFTGEBMCHBhAAAJAAE.RBAH..FEEACDFE.hAAA..IHADhABADCEGBDCBNCIE.fHAD..XGGHhACA.....hAEA.EEDA.,2,-30,6,36
QGaFUSZAOMYDPVHIXfbWETJgBCNLdecKR,MDEBDACBHADB..XGBD..fDFFEGDB.TFBEhAAAgAGFCHEFLHAGhABAdDABKACCGEGEhADAFDFGSGGGAIFAPFDAIAGBWFAFBBEBcDBBhAFAaFFG....hAIA...,2,-19,-19,0
TBKSIDNPfAGJgOWMbRdcYVeFLZEUaXCHQ,JFEFOGEA..MBCHRBEDdAEB...VAACeHAA.FAADZGCAaCFECHAB.hAAA.HDABBAEASCDDhADADFFG..NADEABGGhAAAGAGE..gGGB.bEAChACA......hAEA...,2,-41,-10,31
VbWZXTLPKQgSDERdAGUHfJaecCBIMOFNY,UCCFHFDFaDFDeDHHCACG.BDFD..MDDHOHAAFGGE...VAEEhAAAZADHLAHD.hABAPFBDgDADhACADAFBEBBDAGDCJFFB.....cBGDNBAG.hAAA......hABA...,2,-24,-16,8
XDYFPaBfKdTWgZCEIRNQcAVMUGSebJLOH,VFEEGEDC.SBDGeCDHLHAAHEAFDDFFFBHFBFBGKABBTGFEhAAAZACD..ECFEIDHHhABARAAF.QAFEhADAAEHDMAFE..........hAEA......hAFA...,2,-18,-15,3
KCcXSREIVBZTHPeYLUGOWfAJabNMDFgdQ,aDCDMCCA.FADCQBEE.CEFG.SAFBEBBCBHGGHAGFhAAAPAHDeGEC.LBADhABAGGDHfAAChAAAAEGENEIEDGAF.KEGA.cDDG.RCAG...hACA......hAHA...,1,-8,-27,19
QHVaJFGegPDRLUEAWKBbdCYZcIfXTMONS,BFEDCFEDZBFA...IHAC..fGHGMBDH.OEADhAAASACCHBAEVDFHhABAFAFCeEHFDIFELAEDhACAEDFDAHIHKHCGdCEB.XAAD.TEBChAAAaHAC.....hADA...,1,-22,-25,3
BbKTeNgEfDHSQcCRdJMILaYWGOUZPFVXA,KEGDTDACeDBE..EAADHEAC.SGAFQACFCHGHdGDCMFDChABAaBHBGGEH.UBGChADAPBEFFDDAAGCFBCAFhAAANIAFDAFC..cABF......hADA......hAEA...,2,-22,-6,16
IQEAVKJeBZaDNXfPSGLcFHYOWRUbdTMgC,VDEDJFFBBFDA..aGHHDCHD....XGACSADHLCEEhAAAFDBG.OABChABAUGAHdAFBTGDB.CDCBIAFChADAAGIFeAAA.NBIA.fCFA.hAEA......hAHA...,1,-21,-46,25
EHQCBAMWZPONbcIdKYXSRDLfUVeFGgTJa,MECGZAADOBFF..bGAGdGFC.KEGGSCFGREAH.DCIFLAHFhAAAUBBDFAEBTCDFhADAJEFB..EEHDCAECAHIB.hAAA...WGBE...NBAA..IHGFhABA....hACA...,1,-26,-33,7
eHcVOLGMfaFCTJbNQSZUXDKYEdRWBAIgP,..IFDGPEEGHADA..VDAEOGAGLBGHMIFEFCAFhAAACABEJFFDQCCChABA.ZGDGDGCDEAHBdBBHBCFBhACA.AHCH..........hAAA......hADA...,2,-44,-2,42
SbFWZEIDUeBgQROPAGfNTKHVdLYcCXaMJ,GAFETCBC.HEEELDEACEDFMACG..SGFEFHDAEBBBDAAFBFBAhAAARFBF.OHBAAHABKGGEdBDEhABA.....hABA.cAFF.aFHF.JACA....hAHA......hAIA...,1,-15,-32,17
MRYIULdgcOaNbBHPFJKXSfZQTDCEWAVGe,VFBHeBFARBAB..UCEGdEFCOCCD..NAEB.BHEAHGFEJDHFKAABhAAA...SADGhACAfGABZEFEDFAECDCFAIDAhBCAMADG.....IHHG.hBGA......hBHA...,1,-23,-34,11
JeBAdcGRDaEPSHUKfLOWYgZFCMTXNbIVQ,GEAHDGDEEDAF.HAADKCEG.OHDE...gADDCEHCTDCC.hAAAXEGF.IHAHhAAAVABFeHBAACADcGGChACARGFGaBHF..SFAAfDDD.LAGFhAFA...hABA...,1,8,-32,40
DCQKJTXSOZGVIFcWLfBUeERYNgdMaPHAb,DAEDCFCFKBFH..TGEA..SEFCOCDHZCEBGEDAFCACLHAAhAAABCDDeHAARCGB.hABANBBB.dAFF..aCACAGGC.hACAQGGH.JAHFIGBF.hAAA......hABA...,1,-19,-30,11
eQBGKAXcWdJZSHRCONLDaMfbFEYPTUIVg,XCBCdHBHSDCDRCFD..CHGC.OFFBLECEDDEH..MBGFhAAAFABGEHAA..PBCEhABAIAGHeEHFBHCAhAAAADDFJAHFZFBA.aCCAYCAD....hACA......hADA...,1,-21,-29,8
MGKIZQeHEcCUVAbFXBdLgOTJSRYfDWaNP,XGBCLCAFTDEGRDEH..DBDEaCBEMIFEGEGGZCBFeGCEhAAAHBECCHBF.AAIH.FAGDBEBBhAAA.OABGJDABSBAChABA.........hAFA.WHDANCICIDDGhACAcEDC..,1,-17,-28,11
HdXOCUAPYBTREJKQIDcMebaZVFLGSgWNf,BFDGEDAFKEDADDAA..MBFDaAEE..ZEADFEBDGEFE..gDGFhAAA..WCFGhAAANADG.dABF.OHCGhAEACHHHAHGDTGCE.JAGBIDDC..hAFA......hAHA...,2,-41,-29,12
ABEWKaMCNPgXbIYfGTeHcUOZSFVQDdRJL,EEGDKAFBMDGF..PHCA..bACF..fFBDhAAAeDEHHBADOBCDSHFChAAAVAFGdBAFLFABhABABHHACFEANAHEIFCE..YDFChABA......hACA...,2,-26,-9,17
eOdGUTDWcANgEQbKRIfJCLPFHYXSZVBMa,EHBGKGFCRDBG..JACGLCFEHFEF..XAFDSFEF.BGBFhAAAMBBDeABEdDDGUEGBhAAADDGHAHAH...NCCC.QBBDhAEAIAHCCHGAYAFE...hABA......hACA...,1,-21,-28,7
QcFeZRPXIBTGADYMVKWLaSgHbEONfJCdU,MCHFVDAG.LFBA..SDHDHBAGEFGBOADAJHBAdCGFQGGGhAAAeAHBRDDEXGDAhAAAIACCBEBBAIAEDBGEhABA.KGEG.gADHNEIACABC.FDFH.hAIA......hBAA...,1,-6,-14,8
YaMJGFBgHDOWLPefRdEQACVSTKUbNIXcZ,SBBDTFCA.UEGC..IBHHXDCAZFGD.aAEHMADGhAAAFCADBFFBDICEOBFEhABALAAEeFBGdDDHADHEKGFDhACA...NHAB.YFAF...hAHA......hAIA...,2,-26,-23,3
KaZQFfWbCUIDYJdTBOAVRcgSELXGPMeNH,VGFGRAAD..SGAAEGAH.GFEBMCCHeFDFKBFCaDCHFADB.hAAA...fEAChACAWCHH.CEEDDDEAdBFCBDEGhAAAADHELHEAPCAHNADC......hABA......hACA...,2,-27,-12,15
fJBSFCWUOMVIERbLNGDdHAPeZQYgcTKaX,eFBBQFDH..gCFHKBCHaFBD.JCCCBAFD.SEHBhAAACACGOBABVFGFhAAAEEACLAGB.DAIHhABAABEEYAHHTGGD.fEEG.hACAWFADMAEF...hABA...,2,-34,-17,17
PgXfYODJCHFZMKeWbUcLBESQVNGTaIAdR,dCFCRAAD..XCFHOHDEJABHHGBG.ZFGFMACCKACC...eGFGhAAAbDDFLAFEBAGDSDEDhAHAQEBFVFBBhAIANCIE.....TEGH.AECGfBDFhBAA...hAAA...,2,-20,-9,11
MITJdKSBUaODLEXgPZHFCAcVfWbGQeRYN,VAAD..fCFCGECERCEF.MFBF.JCDFSEAChAAABGECaFFALBEEEADF.hACAXBABPCHDHGFAhADAAHID.WFBD.QAGFeFCBNCIE..hAFA......hAHA...,1,-5,-20,15
SdGIFbJNEHOXeBZKgDVCYPRafcTQWAMLU,MIFGUAADdHFDGFBDFBGA...JABGHECCOFAHBHAE.KEACDEDE.hABACFHC.RBCH...aBECTDGFhADAAAAC....hAEA............hAFA.SGAEhAGAbEFDNDCF...,2,-37,-33,4
XADLIaUPKCQJMVgcFBNTGEZbdWOeRYSHf,DEFHaDCD.KGBC..CBDE.QAAFMFAD..VCEHFAGDBDHG.hAAAGCCBECBCdDHGeHFGhABA...SACHhAEAXGBAACAGLFADUGFA.....hABA......hACA...,1,-24,-33,9
aQYHEZfAdLWSbPUOCMXJecNKVDIRGTgBF,LCCHSHBGUAGGCHHA.MIDE..XGEDJFGH.eCFEhAAAKGBADEGGGDCEBBBC.hABAFFEDYBCD.hAAAEEGFABDEdBFCPAEC.cEAHNEAC...hABA......hACA...,2,-35,-9,26
RLYbWFfXDSAICEBNMOcgdKUTQHaVJZPeG,EEGDBBFD.MFDFOAFBdBBH.UAAGHDEH.JEAEeGCC.RDBH.LEHFhAAA..WADHhADAFAGEXCAGDGGB.hAGAADDACGAGNBIGKHAA.aBGD.......hABA......hACA...,1,-22,-30,8
YWcAgSBKaDJMEIGLUFdTbPVOfZRQeCNXH,BFEDDGGDMCGFGAABLCCGUGADdHEF..TDAH..PCDEhAAAOHACZBGBeECAhAAACHHEHDAA..WEHHhABAAEEE.KAFAEAFCFACC.fCHA..hAEA......hAFA...,1,-20,-28,8
SPeEZgOKNbRDfdIVTMHaFGcUAXQWBYLCJ,XCGCBHHGCCDB...JDCBSCFD.EFGGOAAF.hAAAKACDNBCE.DFEF.IHHGhAAATGDCHBGBGADEhADAAGGDQFBFLFFEPHBEeHAG.bAFAdCAAhABAMFAB....hAFA...,2,-22,-12,10
FROeNcUKfSgVGEYBLQbTMJHWdXDPIaACZ,FBBDeFFCUBFCKBFH....SBBGVEACGEEDEDBGBBHA.hAAALACA.TEAGhAAAMADDWHCADEGCaHBChABACHHB.RFDD.OBHF..fDDBhADA......hAEA...,2,-32,-20,12
NbDfScWIHFATELMgQVCBGXReUOaYKJdZP,TGGDMEGF..VAAHBEHB.REDF.UAFGOEAGKDHB.ZCDA...hAAA.NECG.fHBFhAAA.SADChABAICDHFFHHAAIFEBBDQFDEXAGH.eDEChACA......hADA.aEAF.,1,-16,-28,12
VSeFAfRECgZTDXbOBcUNGPQIHWJYKMdLa,RDAGCFEDZBFADIGE...OAACUAFCGEDD..IFHBHACDJAABhAAAKDAHdGEHLEDDhAAA.aHAE...eFFHhACAADIFEHBC..XCCCBBHB.NADF...hAIA......hBEA...,1,-26,-30,4
OgfESFVKGZeMCQcXTYdRJaDIPUWbHALBN,LAFBBAFBOEACECBBFFGAKHCE..ZBCBMCAB..CEEG.QGEHhAAA.XABEhABAdEGCJAAHDCIBICHAhACA.PEDB.WEAHAHFEgAGHhABA..SHAAhAEA..,1,-5,-55,50
CBLJeVPKWEYgDFNSGZTMdUIRQXAafcOHb,aHBGOGEAHCCCBAGCLEGH..JECDVEBAKEAH...EAGADABGhAAASDAFZBBA.hAEAdBAFIHDBXBGAhAAAAAIF.fFFCCFHB....eEEChAFA......hBAA...,1,-1,-49,48
WgZMTRYKCbUePEGFIXaVcLQDSABHdNJfO,dBBDJGEA.OHDEZCAF.RBEC.CCEB...eFAFEADG.FEEH...XDGDhAAAaAGDLGAE.hABADFFGAEBABHBCHABD.fAEFhACAMEIHKDDG........hADA......hAEA...,2,-33,-31,2
GdaCEROBANgTcUPfZWYbSMeDKLHIFJVXQ,TCBCUCBCZGFE......bFGDSDGCeFDEKFBDLBAEhAAAIEEF.VGCAXAFGhAAAQCFD.hABAaAGEEHCAOBEBAHAF.NCIC.cEAC.WADHhACADGAB.FFGG...hABA...,1,0,-29,29
GbQcLHaKSUDWITVXRCMAFOYZeJBPNEfdg,OCCHZFDFJBEA.BFEG..EGFGdGBFGAAEQDFGLDDEKHDADBCChAAA..TGAGhAAAVAGD.XEAA.hABAMFFGFHFAPCAF.NACF.....hAIA......hBAA...,2,-27,-17,10
TJPIFZGXMHCSBLcOdfaKRWNYQUAEDbeVg,EHFGDEFHeDBB..VACGJBHD.FEGDGBCH.HGBCBGAGOHFGhAAAfFDBKAFC.RAFF.hAAA..NCAC.QBAGhABAAIEE.TDEGIABAMFIFSDFBhADAdHCB....hAEA...,1,-8,-25,17
BPUJTeSNRfdgLKcHVOWYbFMIGQCEZXDaA,UGGGJFCA.eCDFRADA.dHBFLDCGHBGHOCED..bAGBMAAGhAEAQGGEZADE.DDAFhAAABCBC.SFAEhAFAfDHC.gBBEKGEA...hAHA......hAIA...,1,-15,-25,10
PZCLBWfTdXVGgUAReHJcENMYKbOaIFQSD,RDBGJFFCEBFE..MCABKGEF...OEDGFFAADBIFZDBHLFFGBBHD.hAAA...TBCFhABAXAABVGDEUADEAHHD.hACAeHFA..cGAAbGAA...IBFAhADAPEFA.CBBC...hAEA...,1,-16,-31,15
YNLUVHQOSbWaBAZePfRXGFcCIJEDMKTdg,ZFDFeGEARFAGFCDBCDDG..EAFCKFHH..dBAH.....NCDDLEADhAAAHCEBOFGH.SBABhAAAaEGCBEBAAHIHfAFFhABAXEDAIADFDCCHMBIB...hACA......hADA...,2,-31,-26,5
FgcBMRaHUXNLKdDGECJIYQPOWAbVeTfSZ,VFDFeDAC..SCGEZDCCFHGA.BEBHMCFEaEHF.HGACUGAELDFFhAAAKBCE.DAGEEBADhAAAIEDF.PACAhABAADFGfAEB......hABA......hACA...,2,-35,-13,22
cNIVeXdYLSDTEZPWObgHFaCGBMAJfUQRK,JDACUCGC.KBDD....NIAB.eABB.dEBALGECDAGAZGBG.OFAChAAAHEEHFGGHCCFDMFEEhABAADFG...RABE.IAEFhAAA..YAFGSDAF..hACAECHB.....hADA...,2,-33,-30,3
AbWMCeIOTaZfScLEHgNdUGQRFBVYXPKJD,MCCACAFB..eDCHOFGBaDHB.ZFAF..SABGECGFHAAEdDEEhAAAGGEDQGCAhACABCEH.XAEAKBGGACAGIEEAhAAAfAHELDAH....hACA......hADA...,1,-4,-33,29
UNXCGKcHaSMVLFgWDTBZbAIQEJfOYeRPd,EGFCJEEG...OAAFeAFERBDFUCFC.CHAF.KHDEHEBA..aGGA.hAAA..SEAEhAAAMFFCLACBFGBFDIFEBHHDhAEAACCE.IAGFQBFC.fBAAhABAdBEG....hACA...,1,-16,-34,18
HZLXMGaVBPJCdYQSeTDOKcAbERNIFgWfU,ECFCRAADFEFG....fDABUAGGLDCDMCBCGDDEBFAFCDEF.hAAAdBHA.SHGEhAAADDIBKHDG.AAEGIFHGhABAHACEaHGA.VFBF.YACA...hACA......hAEA...,1,-1,-34,33
gZGacJdEHQUKVbPNTAISCfOBWReFXYMDL,CFEDOAFBRCFE.FGHBMEACLEEG.ZGAEaCAA..dGEAEGFFUCAEhAAAKBDH....VFBHhAAA.....NABBABBEhAGAICDHBBFF.XCGADEEG.cAGDhABA.....hAHA...,2,-36,-30,6
VbLGKZBgdMNQOfSaeUPCAJcHRFXIWTDYE,JFBBHGFG.XFCA..IGGHDAFBEABC.LFEFKGABBEAChAAAdACGQDFAhABASFAFaCCCeBEFUAGFAGFD.hAAAFECGTDFF........hABA......hAEA...,2,-38,-9,29
HZRPXEbcMDSUYdFQCLNTAGIefKgaJBVOW,eFEFKHBG..aAGDBECA.OAHHZFFEXDFEEGCD..MCBBhAAADFAAUACBdACEQAEEhABALDDDAHHEIHHEhAEA..fGAH.JBAF..hAAA......hABA...,1,-24,-34,10
DAFUCXYPcIZBVHMQWGLbOgTfNaeSEKdJR,FFFBXABH..PCFEZGDEBGCC.MDEBGGABLAFBhAAAbEBG.OEAD..hABAfEGB.hADAaAGEEAHFdBDFDEIBAEECCBBBIECG...hAAA......hABA...,2,-30,-26,4
fWENBRYbXCSVMaOTeQgdPDKGJLHAZIcUF,ZAADUCBCFDCDEFCFRBED.....XBGACGFA.MIAGaHECeACAhAAAdFEGKFGHLBGHHADAAEEC.hAAA...IGAGhABAfFGDBABASGAH...hADA......hAFA...,2,-33,-22,11
afbPIJYUcNHWQMgLARDOEKBeXFZSdTCVG,DAGDOEGHBEFBFAEDZAAC..dEDBCADE.GGBB..aCAD..fEAFhAAA.bACDhABAIGDC.UGGGhABAHAGHMDEGAGIHECACXFBBSGAFPFABhACA...cDDChAFA..,2,-42,-20,22
dDEXSKUNPBHZIWacAJOTQVfRegCYMGFbL,JFCAODCH..QABGVAEH.eHDACCHDGEEBLAEAdGHEEBBHhAAAKEHHUCEE.BFAFhAAA.HGAEIGDChABAaGGFADAB.TGAC.fAGB.hADA......hAFA...,2,-19,-18,1
ENUZHYGKMVeLTIdCWJcbQRPFagBOSADfX,DAFBEGFCUBDHZACDGBFC.KEEDVEAG.LHACdEBHCAAF.JEFEQFGEhACA..hAGAFAGHaHAGBEDE.AABCfBBAhAAANICD..MBIF...hADA......hAEA...,1,-25,-33,8
UTCeMSacKBdNRbFWGEHIDVJYZgXQLOAPf,UCBCCFEE.MCHBaEHFKAAABAGF..RCDA.FFBDGGEBHGDG..DEEEJDBBhAAAZABA..QAFFhACAADAG..fBFEhAAASADFNIAF......WFDChACAICHE.gGAAhAGA,2,-44,-27,17
bZODcIgMWFNBLATUQCaHGJREfVXeYPKSd,QCCBaGFHGECGRCAHEEBD....VCFGXGAD.eAHHhAAAPFFGKHEGdADFZAAEDFAFhAAAICAA.gEFHhABAMCCEFHAEBEECAAGCCHGEfEEC.hABASFDD.hACA...,1,-6,-14,8
EgXZAbIPFJBTOfaKCYVMdSRQDGcNLeUHW,..IFDGFGDBBBAH.OBEBaHGG.KBFCCHDF..MBEGdAHARCBBDGAC.hAAAGCDDLDFFeFFChAAAUGAFEBAC...ZGFEhABAACCCbDBC..........hABA......hACA...,1,-25,-31,6
MFZNTKAeXfJQVWHBPOCgLcRIaESYbdGDU,eDACXDACQAABHFBFBACBCBHC.LGFERGACECEE..SEGHhABAbBFGDFEF.FFEDZDDChAAAKFACfDGBhABAJADE..WHDAOBBCIEDFdAGF.MCIFhADAAHHD......hAHA...,2,-16,1,17
NcKCQbVEDOLWSHXaeMgRGYTFBfJUdPZIA,KHBGQGGGEACG.OEBHLDGHHCCEaAFCeEEC.MAAFRBABTDCDhAAABCHHUGDE.hABAZAEENEIE.CBCCDCFG..hABASCFC.XFEB.YGAEhAEA...hACA...,2,-15,-13,2
eQZAJaHEXLPVRNfBCIUKDSbMFTcYWGOgd,JDCHaEHBHFCELHDERBDBBHAC..CACGKAFBSBGH.FGGHTBAChAAA..WACEhAAAODAH.eFFEABBEXBAChABA.NIBB.IHHGDAGC.cCGBhABA.....hBDA...,2,-37,-27,10
KHTeRWIfBGbAMYgSaVFLDXPZOCUdQNJcE,MCCASHBGFGDCLBBDDHEGZCAD..OFECdBGEQGAAhAAA.JADEKDHD.TCDDhAAAREFE..fGGEhABABBAFAHHBaCFFXDDFPAHD....CADC.hABA......hACA...,1,-12,-37,25
AgafSWPGQZEdbNKXLeBJMcFRIVDUOHCYT,aHBGSHBGGAFAZFEBEFDB...dBAGKGFBLDDHeCCABCHBMFAGhAAARDEADDBHOEHBHAAECAEC.hABAACCC....WAEAhAAA............hACA......hADA...,1,-23,-29,6
OCKWARFQEdHIVDUBfLPSGMYgcabTZJXNe,QCCBEEHBHFABDCCFBEEFLBABGEGGMGEG..gEAGhAAAaCGBZFCB.JHDAXAGAhAAAeABCKCHHAHIHFADCdAGF.hABAIDDFfHBB......hAFA.SFDAhBAA...,2,-14,-8,6
bMgWaIKZGHFLCEDYXdSTfeJQcVRPONAUB,BHHGMCCA.aDGFKDGCHBEEFEFC.LEDH.DBBEdDAD.SEDDhAAATFAH..fCCBhAAAQAGE.cFADhABAPAFAAIFAgGGBWFFB.IACChAEA....hAFA.CDDB..,1,-21,-38,17
YAFILJOMDaQSWNRBZPfbeVHUXGKECcgTd,LCCHMBEADGGG.aEGB..SDCDREDHBHHBZAFH....bGFChAAAeEBDHEAFUBAEKEEGCDHAhABA...TBCEhACAAHGBIBHGQGCAWDHH....fCEEhAAA...hADA...,2,-27,-22,5
OEPQcbeMIgRaJLZKVNfDHXTYGUBdWCFSA,EDCDQCBC.eHDAgFBERBFE.JBAAKEDB.VACEDEGBHAEHhAAA..XFAHhAAAGAGAdFEC.CHHDFGAHhABASFFCADAG.cGGEMDIF.aDGC.hACA......hADA...,1,-12,-15,3
XRFVPYNAHIJUcOLMQDfWGgTZaESCeKdBb,HFDFJDAC.UAECLAHFDEBHGDGAZGDEEGAGCBBA...KAABBAHAREGB.hAAAFDCH....PFCAhACAACIDIHAH.hADA.MIFA.fAEDWDAF..aGGHhAAAeCCEXEEB.hAGA...,2,-27,-25,2
gcVRUAfIeYHOMBSDaGKXWCQLJTbEZdPFN,eGEAHFDFMDAHDHBAGAAFKCCC..CDEDQGBETCGA.ZCFDdCDBhAAAFAAF..NIEHVDAFhABAAGHH..fAHGhACA.OBDAaEEF.......hADA.XEGE.hADA...,1,-12,-24,12
EVgRDYcOZBbdXHJWeQUaMPNfLICGFKAST,TFCEECFCRBBC..DEAAOBFCBHHG..dGABXAAFHDDH.JEAEeDHDhAAAUGGEMADA..hABAfHABCFGDKHAAABBC.hACAgDDBZFCF.WAECaFFH....hADA......hAIA...,2,-32,-10,22
gWHdLBceZNRObJVFPGEKaTDIXSMfAQYCU,CHHGUCBCHBBAdGFCBDEDZEFA.RGCA...JBFEFFGE.GDAEKFBG.DAIH.hAAA.SAEChABAAAGC......hACA.YHAAWAAC.......hAEA......hAFA...,2,-44,-44,0
AGQUHfMKILZgcCJEBRSPeXOdbWaDNTYVF,QCBHHEFHKBEFLAAEZEFHCHAC.BCGASEBHeHBCdCCAaFDEDDIHhAEA....TACAhAAAFFAAAAID.UAFDIAGHhAFAJCHB.EFEB.........hABA......hACA...,2,-28,-20,8
WJFdDIeAGVTOfMSUbKXacQgYCENRBZLPH,VCDFTDAC..MGCAUADD.KFFB..aBBDQDDC.hAAACHDBRCFABHAE.PHDGhABAJABFdGAADFBGAIHE.GADFhACA.fFFB.SCHBhADA.....hAAA...,1,-21,-33,12
RKPVFQSCXHcONWDZdITgfEeMJbABYLUGa,BAFBLDACUAAFRABEKFCGFBDA...QGGHCFGB.HCFEODEFhABADEIDdBFF.gEAAhAAAeDDDMEIFAFFCaHAAhABASCGD.XDAF.NIAF..hADA....ICHAhADA.,2,-51,-6,45
CJHcXTdEUMgaZBbRSADKPQWeGFOfNIVLY,DGHHQGBCGEBCOFAH..IAAFLAAFJAEHXBFChACAdGGFEFEB..MDADhACAZDEEBDDFSEDFhADAAFGF.PCBD.FBHBNBIECBBF.cGDD.hAFA......hAGA...,1,-22,-23,1
CUXNKAScMRWaVbBfTIYQLDEZFPGHeOgJd,SGFHMECGRFAA..aAFEVCCE.BACGTBBG..IAGEhAAAQFFCDEFBEAEBhABAPHCEHGCA.gDAGhADACCHF.XCGDAIHEcADH.fAAFhAAA...hAFA...,2,-26,-22,4
SOXeRMBNUWaTQJLYPFfGZAIHgVKECDcbd,HAADVDAG.KBGF.DECEdAAE.OHDGRFAABHGGUAGB..TFGGhAAAJFDE.LAEH.hACAFHDAfDFDhADAAFFB.ECHBCADD.SCCEMIAAWCADaFAH.YHFGhAEA...hACA...,2,-29,-17,12
EBYASXdbQgWUOZCMFKGeVDRPcIJafHNTL,XFCEQGBCUBAGZAAAMIFE.FECEGBED.DFADPBFChABAJFFH..HDCALEGHhACABDHFAFBHSEAFhADAdHBH.WADHCHHCeACG.....hAFA......hAGA...,1,-18,-22,4
KUOCLacHBQRbGeFdSgNDXfJAZPEMIWTVY,ZDAGEGFH.MDGF..IAHA..VBAAKCEACGEFaHEABGBEQGABhAAAGDAHdBCBSECAhABADADE.JDHBAAGHTDGEhAAAOBFC.........hACA......hADA...,1,-25,-35,10
XMARKbadgIOEGUVYLFDCNcBHQJWSfePZT,RDAGKAFBdGDHOCDFUBCE.LBAE.DADECGGGBAGG.HCGFJHDE.hAAA..SBAFhAAAeCCDTEGHAIFG.aHACEHAAhABA....YCFGNBFA....hABA......hACA.WFCAfFAC,2,-30,-27,3
HZcaFLUgdYCfQINPMVBbXeWOASREKTDJG,SEHBRFEEKEFE.DAFEJAEGZDEF..FECGUDBH.dHBDCHHG.QABFhAAA..NDIC.hAAAMCFCBDBF..eHFAhACAAICAGBBF...aBGD....hABA...YEAFhACAfGDB.,1,-28,-40,12
ASPJOXgIELeFYKQDdTfGWMHcZaCbVUNBR,JCCHODAC...XFAFEBFFeAHDFBCCKGFC..dGDEGABFhAAAMAHBZDFGCEEAUFAFBGGHAHEA.hABASDDB.hACAIAAF.LHFADDGF.WACEhAGAaHFE......hAIA...,2,-30,-29,1
LcIbPXEeVCYBQGOFdgDNHKWaUZSTMJfAR,RFDFLGEA..IECEXBCBEHBECGCCBGAEGBDH.OHFEhAAAdDFGDIBCHBADKDACaAFAhAAASGGE.MFABhABAAIFEPDHD.eEAA.....hACA......hADA.YAEC.,1,-8,-29,21
KPdbMcCFBgfJeOAaZWSQITUXNRDYGVHEL,aCFCZDAGQCFG.UACBNCBCDEDAGFAHHGACKHEEdGHAMFFDhAAACADD.BAHF..gFGGhAAA.eBAEhABAAEHGIBAETAFC.......hACA......hAEA...,2,-30,-24,6
YEFCOWecSKfbQDAdXVIHPLGUNJaZBMgTR,VBCFHAADLGBE.GEFEJFEFBCHEMBFARCAB.EEDEFHGACCCBOCEEhAAA..eFFEhAAASAEFKGCBQAFChABADCADAGAHIHHE.PDHDNEEDaEAH..hACA......hADA...,2,-23,-8,15
THVFRUJfSdbNeMKQAcEgYBaZXCODPIGWL,EHBGBFDGZDBDCAAA..DCDCGEDE.LDFCHGBAFEFHRAACUAFB.hAAASHGGNAGG.hACAKEADAEEF...YFFChAAAOFHHPDAF...IADFhAFA.....hABA...,1,-16,-42,26
TgNIHcCJeVFfGPBKXREMbQUZYASOdaWDL,SEEDOEGHdAEDDABELBEG.TGBH..gGCHhAAAIDGCHCCEJAHDeDEDhAFAFABDPAEABDCEKDBDhAHAEGGCMFIBQDAG..YBBAhBAAAHIDNAIACFFB.....hAAA...,1,-6,-22,16
ZYTVeMbcfWaQAHIKOUNgGELRFDPCdXJSB,HDAGOCCHUFGCGAEGLBHHRGAG.DAGGdEGF.XABCJBDGZGCE.hAAA..TEDFMABG.hAFAfHGBaEEGACGHKBBE.hBAAgAGG.FDAF.CHFGBFGA.hCAA......hCBA...,2,-21,-1,20
ZQfSRdGgKBTHMLDXPFEVbIJOeCYWAcUaN,aGFCQFDH.RBCAGDEFKEEEHACCMBBHDBGGXAAF.hAAAEHCEVAGD.IHHGhABAODAB.CEAGAGGBcDCGhADANACB...fCGF...hAIA......hBAA...,2,-25,-19,6
IaPDOJXTVgRLbAGEYeUSNHBcFdMQfZCKW,EGAHeDACUCCBHFGFBGCDdFAGMAAD.QDEACHEAKABA.ICHAhABAaAFD..OCFEhAAAXFBE.gGEFhACA.LBBAAGFCSDAF.hADANFBH..FEGF.WEHHhABADEGE...,2,-50,8,58
CeNUObDMBPQfaJSXGHAIZcWRgdKYVTLFE,ZAADRAADdHFBKEFG....VFAGFAHDCFCF..UCDCDFADBDGE..hAAAfFFH.hADAJACEXAEC.hAAAHFDEAICAIAHF..cCCA.hACA..WFHH..hAFA...,2,-53,-34,19
cfdeKUPGXFHJLARCBbgEZaWVTOYDQNSIM,BDCFEHBGZDBDaFHF....TAFGOADFDGGBQFDD.hAAASAFEIFHHcDEGhABAeBGBUABEPCADhACAFFBBLFFB.ACIFCDFBgACAhADA.YAHBhAFANAAE.MFFD.,1,-11,-12,1
GBAZRIDUSYMfVcdQXPNCFgHaeLbTOJKWE,ZGFGDHCEUCGESHAC..MAFC..fBDHVBAAdEDB.hAAAXGCF.CEAEFBAFhAAAaGFC.LCFEhABATEADKAEDEAFEBEEBAABE.......hADA......hBAA...,1,-19,-38,19
cHaQeVgLWSdBIXOTMUDFfENKYAGbCJZPR,GGDHCAFBZDAC.RCEGHEACQEGFeABHLEFAdGDDBHCG..OCDChAAAUAGGDBEE.EDCEKBBFhABAAGGC.....JBHBhACA.aGGHWBAF..IHAEMIBE.fACFhAHA..hAIA...,1,-4,-36,32
ReQUXdSILgCVEGZWMOYaTKBADFHNJcbPf,FEAEHFDF.JBGH..PAEHRCAEUGGH..SABBLFBFCABHEGEFhAAAZBEF..MFDDOFFAhAAATEFGBAHADIFC.hABA...NEAE.fAGGXACH.IGHHhADA....hAFA...,2,-42,-12,30
aGDJdUNEbfgcOQSXKLeRWFYTCHIBZMVPA,aEHBGDGG.dCBHUCACEAGA.....gGBGOECBXGCDhAAALBFBeEEHRFDDFADGhAAATABCCEDFBABFMBABhABAADDGDIGANBEE...fAGBSEAH..hADA......hAEA...,2,-25,-13,12
XCgcJKURfGNSaQbHZMOdPVDIBWTeAELFY,EEEDFDCDCADE..JAHDKDGB..RABFGGEB..aAGHQFAGhAAAHFCCOHAEVBEHBHGGhAAATEGCADBGLBAAhABA............hACA......hAFA.XBEDcGBD,1,-15,-32,17
eZLgKDXUVIQAYabdTfJNMWGERBOFcSHCP,aHBGTGBC..JBAEMGECGEBHBEBBFGFBHBFE.CEFG.eCGBLFADhAAADBEHUAFFQBAChABAADAH.dCDCNEIA.EAEAhACA.OHDCSGAC.....hADA......hAEA...,2,-28,-7,21
BcCSVRZDagdLYIKPQeAbONTWGFUHXfMJE,OGEATCBC.FABBHFCC.MIDEJDDGBCCHCHBC..SGFAhAAAZEAHDBIF.aBFALHFGhAAAIDHCQAFFhADAAFCC...NIAD.GADE.fABDhADAEDGF....hAFA...,2,-28,-20,8
RfNTDaQHYgFKbZeABcEOVCGLMSUWXdIPJ,EEGDOFCAGDBELDGHMBDH.UEAG.dAFDIAHERBAA.TAEAhAAADIGAaDDGHGDA.hAAAgBACKGEAeABEACIHhAEAcGACCHCH.SEFD...hAGA......hAIA...,1,2,-22,24
TcNKCaAPHeSILWGZQEbJXgBfdUDYFVORM,HFDFSDCDLCEEGBDFEDBD..XFGGfHEHdBAFDAGEhAAAFFFCRABCMIFG.TFAFhABAcDGCKEEC.CADCACIBIHHGhAAA.........hACA......hAFA...,1,-12,-22,10
JSAOMWTPbNBRaFIZcgQdCGDKUHeELfVXY,MDEBTCBC....NBEF.RAFHFGEGZFFD.QFBHdAACDHDE.KDEDeEAAhACALAAE.fGHAhAEA..hAFAYCDC.AGAAPCHDaCHD.IHHHhADACBBC.UBBE.hAHAEHAE..,1,-19,-24,5
RCMHAaBYedVfOPLFDJXNQGSgIWEKTbZcU,BFEDdDCDOHEALABHFCGH.DGGG..JGACXGDC.QDFGhAAASBDC..hAAAIHABEFDCKABD.ZDAAhADA....cDACCBFCAHHFaCGAeAHB.fFGFhACA.NIAF.hADA...,1,-28,-41,13
NQUaTPEGgOdJCcKVSDFLeIXMZbYfAWRBH,BFDDQFDHaBBD.EACBOFCH.dAGHCDDBKADC.DAGGFDDAeBAFhAAAMEADZCEH...fHGFhABAREFH.UCGEhBAATADF.PHDEJFBB...cAABhAAA.....hBFA...,2,-30,-19,11
KbgEHZUdNYVCWaDfGAJeQPLOXBFSRTMcI,JFCAeDACLCHHBFAARFFC...MDEEKAFAEADAHAAB.ZAEGdFDG..hAAAVFAFCBBEDCGDGGEFhAAAADEC.ODBEFHAE..hACA............hADA......hAEA...,1,-10,-45,35
MJSgbKERLYUGfdaZIQeVcHXNTFODPWACB,MFEFSDCDKBFHLDBHGCGCdHBF.ZADEQABDeFEFVAAFhAAA....cFFAhAAANEAAFDDA.ODFE.hACADHBGAGGBCHHFBEDC.bADF.....EAGEhABA......hAIA...,2,-27,-9,18
BXDdLJMQNRPIKFTUVOGWSHbcfCYeEaAZg,BFDDdDABMFFFQACBRGAA.KHBGUAGEOEFCGACD.SEGBhAAAHBFG..fFAHhAAACFDFEDDE.AHHDXCEChABADFAE.LDAA...hABA......hACA...,1,-20,-30,10
IHWCGeOQSUVELdRJPcFaAXbYDKTZMgfBN,XCBCDACBKDDDZGFA..MFEFBBDDHBGHGCEHeFAA.QADAhAAAUGBE.EFFDdDAEJHAChABAFAHDAIFC...TAEFhAAAfFHA..NFEF.CDEESDADhACA.....hABA...,1,5,-36,41
QBPIcJCHVdeLZKSTNMFgUEbfXOYRGWaAD,DEFABHHG...IGBACHFDHBACdHCD.ZEACTCDDFBHB.EAAB.hAAA.XGGAODHHRAEChABA.aFAGAHAFQBDGhABA..JEFF.eACHSAGFhACAMICC.bEECfGDBhACA..,2,-28,-16,12
NVbPQdKZHeUWSFRcXMOLafgYTBEADCGIJ,CGDHJFEF....VBEDQCGBZDAF.eFCBUFFGFDCE.RACC.MIFAhAAALFAB.aHGAhAAAfCCC.hABATABFADFDIAGFPCHDKDAC..SAHFhABA...hACA...,2,-28,-25,3
HJPfIMOXDEUdcYZRbLKCeQgGSTWABaNFV,aEGDFCFCHFFB.JAEAIEEB.OADHEBBGdECA.ZBDFLHBEhAAACHCH.QBAGhABASEGEABGGBEAAhACA.NCIG...........hAEA.fCFGhAFADDAA.cGFC.,1,-23,-36,13
NZYDcJdTULaGQeHXbKgWAMEBORVSIPFCf,BBGEODACRGCG...SGAAFEAGCDEC.ZABCDHGEdBFGLAAChAEAGEDFQBGAhAAAHDFBKCBC.AHHEMIACEFBA..hACA............hADA......hAEA...,2,-41,-23,18
CYBWZTKdEXQPaUgDVSFfMAbIcGHOJeNRL,..IFDGGEDHHCFA.eDBELBCCCGAABCACTFABEHCEXGGAhAAAPGECaDHBDAFCSABChAEAMIAG.hAAAAFCBOCCANEAB.WBEEdBAEgCFFhABA.fAFBhACA..,1,-6,-17,11
BgPWGTYMfEAQFceDLOCUNbIRSaHdXZVKJ,FGFCeFCHLEBEUEGC....IEECSAEEdACDXAGHhAAAZABCJDFGBBHB..hAAAgCCA.hACAPFABTGCEYBADEFBFAGIBDDCG.NIEBaFFAhADAKHDA......hAHA...,2,-29,-15,14
SeGDUIVAOgEFLHfMCYBNaJZcRTKPQdbXW,EDCDFDBDHADC.CEEFBAABaDGFZDAH.RACHKGFEdCBB....XFGHhACAeFADGAEEDGFDUCGHhADAAICCOFHDLGAEMIEEhAAA..NIAF..........hABA......hACA...,1,-20,-23,3
YLROCWgQJcBTbEXVAUaKfMNeSZPGFDIdH,aFHBKGFHMGBC..SECAGBCHDDIDdAGCLBAHOABFCADDQEEBhAAABGFF.EHCEhABAAHBFUEAEeCFA.FGDDIHHEhACA.YEAGWAAD....hADA......hAEA...,2,-39,-16,23
XTUMGgedQLEKPRIYBSNWHZJVcCaAFfDbO,FHFGDACBODEDUEBBGBDH..dHBHLHBAKEGCRGFEBFAF..hAAANAAG.ZDCF..JBBFVADChABA..CEFAAIHA..hABAXBGEMAID..eDHD.EDDE..hACA......hADA...,1,-23,-34,11
HdSQJXMCfRLcaGWZEBAgVOKYUeFDIPNbT,VFDFKDCDeHDA.FBEBDBFD.....IHHEPBGH...hAAATGAESEHDhABAJDBC.CBCHRGAGLAEEhAAA.aACBWFDAZCGHAICEODAB..NBAE..hACA......hADA...,1,-22,-34,12
NbLJTUGRMdaFKZHVBDegPOWEACcISQfYX,CFDGSHBG.QAGEXFAALEFDUDBERADB.aABGKEHDhAAAHBDBDDGE.eDHHOEEFhABAAHHF..fBCChAAA...bAFC......hAEA......hAGA...,1,-25,-33,8
LZVDcNWefSGaMJURYBAPKIFgdEQObTXHC,KHBGFHBGEBEGQAFE..ODDC.TAACXEECHDBFhAAACEHDLCBFZFGBDEAH.hACANBAE.eAHFSCGAhAAAMGDE.UGGCBCCEAEDHICEA..hABA......hACA...,2,-28,-12,16
SQVYLEJZbaCXHGRNBMUgOFKcfedTADWPI,DACB..PAFBSEFBQGEDLGCEEBBCZDABCFBCGADGhAAABHAFMCIF.OEGFhAAAFEHHKHAGeEDAABABIHHAhABA.JAGB.bDAE......hADA......hAFA...,2,-24,-17,7
NHeXCFJRLgaDBdGPSMQOKAVEWbYIcTZfU,VDAGEHBG....bDBD..IAADZBFDUACGHGEG.XAGGhACAFHGCJEEFLAABhAFADCCEBDFAdDHC.PFCFhADASDDCMFAHKEEDAEID...YACGhAHA.....hAGA...,1,-4,-27,23
ReXPOUHgfAQWFbMVdNZSTGDJBEYcaLICK,FGFCMECGdBFHZABGGDABBGBC...EDFFaDAHCGBA...KGEBeACBOBDEhAAAHDGB.ABAC.QDGFhABAbFDD.NIAF.DADAhAAA....cFFA.....hABA......hAGA...,1,-18,-32,14
DUCcdBKIPLWZFaYRJGNOXMEeAgfQbSTVH,QCBCTGBC.DBDECHFDdECDKHAC.LEHFFBFD.RAACGAFGhAAAOAAGMAECEDAF.eEHDhAIAAFGD..fCDAhABAVGEAHECABAHA........hADA......hAEA...,1,-15,-16,1
GXEbUQWVeCMHDZOSdJgNKLTYAIfcFaBRP,..IFDGfAFBFFAB.BCGEGDEBEGFEUFCDQCBD.hAAAeHBAHBCEOAEBhAAAdDAANIAFKBAETGGGADFC.aBABhABAPEEA.WFHBMFFB.SBHHhACA.....hABA...,1,3,-22,25
dJRZUYaSWgVFcEfGOCQDeLIbNBMTXPHKA,dDBDJDACZAFAUAEA...SDFF..gGABhAAAFHEEEGBBGCGCOABCQABEhAAADHDGLEEANBAA.hABABGHA.MDDCXEDD.KAHBAGCCaGGHhABA......hADA...,1,-11,-37,26
ZEeXYVRdabQLDKBUSJPTIWfGNgcMOHCAF,FEHBZDEDeBAF..XGACRBGBdHAB.aCCHQGGF.DDCDhAAABFEG.SBAChAAATBDG.fAEGhABA.gBGCODADADDHEEHF..hABA......hACA...,2,-37,-24,13
TRKWeYVUNFDGLBSPIAQZMdaJEXcHgfOCb,QFCAdAABEHACHBFAOAFHCHED..TEADKFFEeCAH.UAAHhABADHFEGACCBAHBIHGGhADAAAHCaEFD..JDHFXGAGhAEAfEDAWDEA.....NCIESDCChAGA.hAEA...,1,-13,-20,7
UgcMdSZTYeGDEfVLCJBbHQXNAOKPaIRFW,KDCDaHBG.FBAFUDAC..MFDBdBBBZFGD..TBFB.GEGAhAAAEEDGLFDGBHAFHEEDhABAXAEDADADOCHFhACAIAGH.gCGFSAFEDACAfFBGhADA..hAEA...,2,-26,-23,3
EIfXWNCVTBSALMdcZbeHQOJaUPGKFRYgD,dFAGZAADeFCAOEFGUBFHKECE...FDCDRADDDIAC..EFAD..XGCEhAAACGFEBHHHABIBMCAChABA...HFGBaHAE.hAAA...PEHBYCFG...IDAChACANAEE...hADA...,1,-24,-35,11
gJFUGbaAZLWeDdRSEfPcNHCQOTXKVMYBI,ZFDFLEEGDBIBdAAFEFBD.....PBCHHDGFCGAH.QBEBhADATCFCKECBMBDDBAAChACAJFFFFGGH..UEAFhAEAaAEEABHD.eHAGfHBF....hAFA......hAGA...,2,-21,-20,1
ZgSUQWLfCNKJRIaXFbPVHGceYMAEdTOBD,dFAAOGFAZDACUEFCLACB.CAAD.JCDERDFC....aEBFFBBF..hAAAVAECHGDA.eACGhABAMFDFAGIB.BHFEDDIF.SBAAhABAQAGENDEA....KHAC..hAEA......hAHA...,2,-24,-22,2
FZUYEgdRacKfNVQeSTWBAHLDCPXOGJMbI,LAGHDAEDCBFA.XEGBOEFA..GCACJAAF..MBFFFAACZGAGhACAUECC..EGGARFFBaEAHhABAKHDA...fCCFhACANADE..eEEB.SAGBhAFA.....hADA...,2,-29,-24,5
YQWJLEHTDMgCSdPXfOIRUFcZBGeNaKVAb,QCBCJEEGHDBEDGCFMFEH..CAFA.dBFC...PFHHOCCAhAAARGACUAGEFBHFBHFHeFFBhAAAaFDHAEEA.....hABA....YDAFEEABgACGhADASABEfDGAhAEAIHAE.cGGA,1,-14,-37,23
CWQdPHgSUVObaDeXJFLMAZfBGNTEcYKIR,BFDDTAGHEBFH.KAACCEEE..dDBBHCBB.UEFGOFAFDICG.eACChAAAFGACLADFAGDEZCFC.hABA....NAIA.IGHGhACA.WEFHPHFESGCGhAGAaFHF.XBCAfAEFhAHA..,1,-19,-34,15
GeUQCcXOFdZfIHELDKNTgbARWMYaBSJVP,RFACMCCABDDA..SEEGJDFB.GEGAeABDUAEFCFBH..hAAAOABEdHFB.IDFChAAALFDBDBIDKCHHTAFHhABAAFAA..aHACPHCA...QCAGhACA..hAEA...,2,-36,-26,10
MVbTCcegPQaSHRLWONZBKGIfFYdAJDXUE,JEGHXECE.UGBBVAAH...CHBD.eHFE.QCGChAAAHCEHLAECOBACBECBhAAAIFFHfHDHhACAdAEGAAGADABEECGGMFIHcDBBPDABSAGAhBAANGBF.KEHB...hADA...,2,-23,-5,18
LDXaHGPdbBOJFQZREWSUYcAKegNTfIMVC,eCCHTCBCMBED.LAACDFGHHDEDdGHGOHBEFFDEZBFDEBEC.SFHHhAAA.UABFhACAAIAGKDHD.fGADhAEAVBGF..........hAFA.aAHFPFABBCBE.hAGAQEBB.,2,-16,1,17
FUTNHePDSCZXAgaGdJOYbMIWKfVcQLEBR,GEAHJFFB.OGFCMAAD.KHBA..VDADLAEE.BCAAhAAAFCGCUCDDHCDAeDHHhABASEGECFEAAIGGdACE..hAIAIHHE...fGBAhABAQBGBEAGA....hACA...,1,-5,-43,38
NeREIBCZGFKATcMDYSagWQdbVHOJLXPUf,MFFFDGHH..aEBCQAFBdDCFHGAAOFFGJBBALEHB.UEAFhAAAfHEDRDDA.hABABAGDCGAAFCACAICETCGEhAAASGDD..bABE.PBAB.NAFE.hABA......hACA...,1,-19,-20,1
TQWdFYMXGgEKPZUDSHcICBbfAaOVeJRNL,aDBDeFFC.RCEGLADAQDEBdCCAMBBGGEACKAFEZFCBDICAHECChAAACFGHBHHGAHEA...OBHHhAAAJBAB...NCAH.FHGAhABA............hACA......hAEA...,2,-29,-10,19
IgWSabJVDONHTQRCZBGPFEMcfKXdYeALU,LDACUCBC..IFDGSHGA.JDGFDFHHHEDBRAFFCFAH.BCHBhAAA.FFADEABEfBEHhABAKHEEdAHA.ACBAaACChADAOEEG...NAAE.......hADA......hAEA...,1,-22,-39,17
EPNIcAHYbeCLSgUKGDXJfRZMTBQWVdOaF,HAADeGEALBEESDCEKHAEDGIH.JCFBZCBDBGGBVDEE.dABHaFBEhAAAFCAF..EAEB..hACANAIA.AAIFCEHF..UGCEhAAAXDACMAEE.WGAGIHHG..YHCGhADA...hACA...,2,-20,-13,7
SEdMgKHUODCcIfLYQabBWFTPVeGXJZNAR,RFEEdDABKEFEUGBB.DAHFCBFC......ICAHLBBE.aHFAhAAABHBHFFGA...VEBEhAAAeEEHGCCFZAFFAABEEEAFhADAMAHF.HABE....cDCDhAEAYFHB....hABA...,2,-33,-21,12
ATIbULFXRdfKgcQVNDCeOZGWSYMEJPBaH,TCBCUCBCFFBD..dHEHKGGDQAAF.DDGGOFEBGAEHhABASGADMCFFEEAB.hADABFHGAEDELFHBhAEARAFG.fHABgAAC.....hAFA......hAHA...,1,-8,-44,36
RJPKNXgAZMWIQCfOYbDeTcEBSaLFdUHVG,ZFACMCCAQBFH.CHHA.fAAF.OFBHDCBETEEChAAABEBEaFFDFADCHGEChABAVCGHJEDDKECCNIAHAHIH..hACAIAEF..eAHBSAGFhAAA.dDDB....hADA...,1,-13,-26,13
VKYFdCTWGXecOAJRPHQLEMBUSZNafgIbD,JFBBRGFGHCADLAACMAEGBCEAZDEC...aBGC..IBBBhAEADEFBKHDAFACCCAGGGBDF.hAAAeGDA.AHHA...hAFA............hAHA......hAIA...,1,-33,-41,8
HdFfGZbLVPcNYTDMAUOJWRESXIQeCBgKa,UFCAOEEGRGFE...XADHeBEHBFEAKGABHFDFFAHH.ZDAALBCHhAAA..cAAHhABATCAEDGIH.MDBEhACAABGHJFABEAGH..SAECCFGEaCFE..fFBBhADA..hAFA...,2,-29,-19,10
RSCZQEIMfOHdVgUBADYNXebJcKGTLWaPF,DACBXCBCeDED...JFCAGECC.LBHBaDHDFGAECHDGQADAhAAA.EGBBIABChAAAfGFCHCEAhADAgDAGAHHC.bAFD.KHGAPAFEhAEA.SHEEhAFAMABF...,1,4,-36,40
FAWPISHXKbDGQRNBVgMfCJTcYeZLUaEdO,..IFDGXCCBKDEBDFFB.REAA.BCHEMCGDCAED....JHDCTGGEhAAA..eGFEhAAAZEDDaAEAEACFFCAFAIACPBAFhABASAGE.HFAF.....hACA......hADA...,2,-31,-28,3
QCgWPTHZSXbDaUeIMROEfVALKJBFYdGcN,KGDBFDABdDDGGEDF.QFABCFCD..PBFCTBAEHGEGhAAAXDGEDCAG.eAHFhAAAMIBCEGGFAABC.BBED.hADAcABAgEGBZCDGSDAAaFBH.hAEA......hAFA...,1,7,-35,42
bgfUDVFcQIWedHYJMXENKBOZRSLPGTaAC,CFDG..bDAGUBDH.FAGFQEEC.eHAGHCAFMACCEGGHBEFAhAAAOBGDZGCESGGHhAAA.LBDEhABA..........hAGA......hAHA...,2,-49,-19,30
AcKEgRDIbCVMdJSLUeTPZBfOaHQXNYGFW,KAFBECFCDICECHAC..dFGGLEBC.eAAHZECDBDBC.OBAEhAAAaAEEQFGFhAAA.NHBF..FAHFAFECgEAAhABAICDDbFACMIFA...SEHHhACA...hACA...,2,-47,-22,25
LMPNYIWAQUdReaSbOCKfcZTFEJVgGDBXH,QFCARBCFeDGD.aDEFSBFF.OHAGKHACfBAEhAAATEDA.EHGGgAABhACADDIDXAFH.hADAMICA.PEAGIHHEAGFA.dEBACCCDFADFhABAGAGABEGC...hAEA...,1,-2,-17,15
TAFCKcBLaUVeRSPEHObWNGIMYfgQdDXZJ,FEHBKEGDBAACLBCAUCCGeFEF..RGAA.SEDFHFDD.OEADhAAA..NADFMCFAhACAgCFH.dGGHhABADFIB...........hACA.XGBD.hAIA...,1,-19,-48,29
WBYCXPLJFGKAQHVgSceZbaTdUEORDNIMf,HABHVDAG.SEEAZFDH.aEAAdGGBOHFEDBBEMADCBHAH.CGDELBFEhAAAFGBAAAHC.QFGDhABA..hADAeDDEbBDDECHBNCCBIBHCfFAC..hAEA......hAFA...,1,-4,-35,31
RYdBaHLXCFEfKgeTSZWAPQONDIJVUMbcG,QDACOFCHDBGH.JCBAUADA..MBHBGGEFdFDBBHACLEEChAAACACH.EAGGKGDBTBAGhABAZCFFABAG....IGGFhAAA.......cAEBhABAaDDG.....hACA...,2,-32,-30,2
IfNOVBTXdHERZCMgJaeQPFSbYUAcGDKLW,GDCCLEAC..IHGHOBGDVFEDBGFFdAEAHGAERAACMCHDhAAAaBDC..QAAGhACAFDAFSAGE..hABA............hADA......hBEA...,2,-32,-22,10
PNBURKDCbfOaJGMeXTdcEQIVFSgWLZYHA,BFDGKDAFCGFG.OBADGDDD..eGBGdFBEEEHFQGGA.VACBhAAAFAHBSBCEhAAA..LDEEhABAZBAAAHDA.NIADDFFAaGAH.XEAGcGGD.IBHAhACA....hAEA...,2,-24,-24,0
KHeSYcNOGQaAIfgXWTLVBRFPbUMJZCdDE,..IFDGXGBCLBFCBDECFBFFUFAAMFFGZACD..CAECDIGAhAAAEFFBeABF.SEHHhAAANABE.OHEChABAaHDEADDD...WCGH......hAFA......hAGA...,1,-22,-49,27
UaBWNLMbfSYgADIQRdKEeTGcHFCJZOVPX,DAFBREFHdECHEAGHGADF.FBADJDAG.ZGDCOAHD..XDFGhAAABEHBLEABMABE.hAGASDDEACHG.hAIAIGDGQFGAKHGA.eECF...hAAA......hABA...,2,-27,-27,0
KWAQIdbRPFNZYSefOHCTJVGgcUaDBLMEX,dGFCRAADFEFGZAAE.eEDEOAECHCFG..CGCF.JFBF.GAEFUDAFDIAAhAAAMFAF..KHGGADCH..hACAIGHF..hAAAbDDB...PBHDSFCB.fCAFhABA..hACA...,1,-20,-39,19
YGTVHgNZKESBCbDcMIeLFOdaPfQURAJWX,JDACXCBCGECDHFDF.ZCFFSGBEBFFDCHHA.DABG.MCIDhAAAeADELHFGFAACaBHDQEBEhACAAHBC.hAEA.WAGB.TFGEgGAEEBFFIBBEhAFA....hAIA...,2,-29,-10,19
HTgdMBbNXQJERVGUCfIcSePKLZADaOYFW,OEACFHBGHCCCdBBABFEA..XAGEQAFEEEGF.REBCUGGGhAAACHDB...IEHAhABASEFFKACEAAIHaFHD.hAFATADFMBBF.........hBAA......hBCA...,2,-34,-18,16
ReUBfXGCQLDdaWTSbFNgYZHPEcMJIAOVK,ODCHKDAFUECHBAHDGBGCLAEB.dGHGTGCAFGEG...hAAA..NIEH.ZCADECAGMFFAhABAACCE.RACBeBGD.hAAACGAEDEEGSFGG......hABA......hACA...,1,-20,-38,18
RMHdabCJLeIcVfUDNZQKPOFTgXSEWBGYA,HFBGdAFBCEDALBBAeCEGVBAC..UEGEDHEEZDBEKGBB.FHGE...hAAAXEFGEDBHBACAAGAHMAFAhAAAaFFH..JCFEfHBBhABA.NBIE.OEAH...hACA......hADA...,1,-10,-35,25
eZITEJQPKCMFSVWfgUdNaAGXYLBORHcbD,XAGHLAFBBFFHRDDB.HACDDCBAeCFDIDHB..TEABhAAAEFBEQBAHhAAA.PHFAMIFAFAEGhABASCEFfHDHdHAFAGEBODHF.cGBEhACA....hADA...,2,-28,-8,20
aRVPMWfYdQcHDOAXJLIGSUNKEFbeTgCZB,XFCAJEEGLAGBGBBC..UDBAEADBFDFAeFGF..CAHDBBAFhAAAaACD.RFFA.MEIB.hABA.fHCBhACAQAACDIFAADEEIBEHKGAB.TGBBZBFA.hAEA......hAFA...,1,-13,-20,7
fOBRSGIEWeKTbJMPHcZYXLVdCgDNQUaAF,OCCHSBBDGAEGEBEG.KABA..JGEAMDIBHEFCZGEELEAHhAAACHCG.DAFEQAGEhAAAaECFAIHGFACDBCHAIDAAhABAeHBATEFE.cGABXDDF.hADA......hAEA...,2,-19,-7,12
DcZTfQVgMWOYPReGNKdbUELBCIFAJXSaH,XAADSEHBDEHBZFBD...QAFEVAFB.MFGDOCDBhAAAPCBAeHDCNABH.bEBDhACALEDB.IHHHhAAAADBGJEABaAEBHCEEfEEE..hADA......hAHA...,2,-23,-1,22
NdTODIXUYMWfFgBKGLPVeHZcQCESRAbaJ,JCCHTGBC..OEEADDGGUCCF..MIBEFABEBHHFKGHHLGBEhAAAeFCEZBFE.CAAC.SACBhABA.AHCGaCFEhAEANAEFdEHA..IAFCXGEA..WFFDhAHA.....hBEA...,2,-35,-30,5
EXgTJWFMUaVDfHIcdYQNPGKZeBbACOLRS,CECDRFBGEFGE..XAEA..JBFCMCBAaDCA.DHEA.HCGDdABAQADAhAAAGEAEKDDBBAAEhACA.ADAHSAHBhADAWHEGFDFA.UGGEfGAG.IDAChADA...hAEA...,1,-22,-26,4
dUCDOTRGgWQAMbINPVYKaZeXELHFSJfBc,MCCA..IBDHVCFG.KDAGZFBEeBHFLAAHFEFC.SFGEhACAJFDBBFACUAAChADADEDGOAFE..TGGAhAEA..........hAFA......hAGA.gCDAAEBD,2,-39,-29,10
CWJDSabgZGdNEYXQTAIPMfKcRUVOHeFBL,MCCAKHBGRDBD.UDBAHEEGBHBECBAG..DIGA..aADGZBFEGAEFdAEH.hAAAEGDHQGDEhABA.AHAA.PGFG.hACAVDEGeBBELBADSDGENIEF...hAAA......hABA...,1,-16,-18,2
edPFVfDGaZASYROUcJQKbgHBLIMENXTCW,SCFCRFDFOBGH.UEACQFBG.KAEHbECABBACLAAChAEAMCIB.EGGB.NIBH.XAGFhAAA.TBCBhABACAHDWGAAdGHA.FCADDBCBaDEFAEGHJEHF...hACA......hADA...,2,-15,-15,0
bTCFgXJOPUHBaAVRIKcYQLDWEedMSfNGZ,VGFGRDAGKGHH...QBGDDBFC.eEEGMEFE....fBEAhAAAZGAETABECDABFBBEhABAJFFG.UFAHHCDHAIAAIFDFhACA..YHCG.EFAEhAAAdAEB.....hABA...,1,-7,-32,25
JMSaAVfZgcUFKPNIWDTYHeQBLEXCGbRdO,VGFGZAADUGAC.KHEG..IGACDEDG.HBBGeBFABCFGLCCDhAAAEDHBCFFF.GACFhADAREBCdAAFMICAAFGF..fDHGhAFAFDAC........hAGA......hAHA...,1,-16,-30,14
FUBMPAJVLWfYDQEKNGCdIaeRTcOSgbZHX,LFFC..fGDBDDBCEECCKAGFNCCF.dFAE..eFDETADHhAAASCBD.hABAbAEEZGDEFGAFMAIFAAIBJDHFhAAAWHEA..YDDACABAIDGFaADG..hADA......hAFA...,2,-28,-15,13
aXWAYSBLJCMVFReKbfdZEIOGcPQNHUDTg,BFEDLEGHMCGBRBEDKBBBdAACZAGH..OFACGGBH...QDCBhACANEAD.DHGGhADAaHDGABDG..SEADhAEACADC..........hAFA......hAIA...,1,-30,-49,19
OebAgUIadMcYFWQTCGPVBXNZfHSLDJKRE,UCBCaAFB.MBIDFBCC..QFEEGBDEBGACZDGFHCAADEGDKFCAEEDFhAAA.eHAAAHIF.dBGF.hAAA....cEAChABAWHBACHGG...XAFC.NCHC.SACEhAHA..hAIA...,2,-39,-10,29
FKJDSdONLPAaHecEbCfWQXMTRgGBYVZIU,aDBDHFDF.EBGBCGBG.QBAA.TFFFGBCB.BDDDVEAHhAAAIFGAKDEG.SAFAhAAAdHADNADEAIFGeAEHhABAbDFA....XGDEMDIF...YABDhADA...hACA...,2,-32,2,34
EFIGfgVNOLJMSZPBeWCbXDYcQRTadKUAH,HFEEEAFBGDEAVCCBLDAFMDBF.SCGBZAGHeDCFbBBADEIFQGBAhAAA.hAAAaBFGdGGBAEFC.FGDFfABBhADANCAGPABACHHD........hAIA......hBAA...,2,-7,-2,5
CHZFVRgATOEeNWQPbUcJdBKfIGYLDMaSX,TGGDEGDB..eACBQCBBUGGGJBBHKEBF.GEDBDGAF.MDEAhAAAaCFG.SAEChABAHDFAFGBD....gEDEhAAANCIE.PAEGcGCDBEBDIACHhAHA....hAIA...,2,-23,-12,11
IfOCQcRaWbGPEFUVKTSNBJHgLADZdXYeM,ZEEEXGBCMBDD..OBBFQCGC.aFFDGBED.EFHHhAAAFAAFUFACTDBENABB.hAGABAEG....hACA.JFCG.gAGEADHC.DEIFeFDDhAHAfCCD.CFAF.hADA...,1,-18,-26,8
XIaYeVTDKdfgcJUFSQPNGCAHEBRLZWbMO,BCAHRDBGZGDA.MEDGOAHF..XABB..aHAGeFGFDFFCdBAChAAAfEAGJBGF.hABAUAGE.SFCChAAANGEFCCCE.AGDBECDELAEFWFFF.IFBFhACA.....hAEA...,2,-32,-24,8
VZfJIEWNOMHcTaFDXCYeSPgdbKGRLUQBA,VGFGZFDFJBAA..EAGA..ODAGHCECTDBADHFE..CGCF.eBCGhAAA.SHCGhABAdCFDKBFCLFABBAEBAEHEfCAFhACA.IFEF.MGAAhADAaFFG.....hAAA...,1,2,-50,52
GSRPMHCTIXWZdJYaUEVcBLgDQeOAFbKfN,FAFBKHBGGBBARDCBHFEB.CGEG...TABA..XGGGdEGGaEADEAHFhAAAVDEB.BADCDIGGOADDhABAAIEE.fHAFhADA.NCIE.MBFA.IDHDhAAA.WFAA...hAHA...,1,-11,-38,27
MPDRTLIAWUFGXEecJCSYNgQfOBVbaKHdZ,FGFCXECBEEEF..eDAGCGGD...SDHBNABG.QAAChACABADGaCCCdFAAPFAGhADADEFCLFFChAAA.ACFBUAGCJCCEfHCFbFBDKGDG.ZAEAMIEEhACA.....hAFA...,2,-22,-14,8
FdQUBcHWZaGCVALEMNRTPIOXbKfSgYJDe,MEGFTFDH..OAFBKCCF..SGGAJDBAFGCC.QDFFhAAAUAGABBADHGAGZFEF.hAAAGBEBAHHFLEAFhABANCAGPABA..........hAFA......hAGA...,2,-34,-12,22
ITWBUaFcgAdbQJCDOXLVfGeNRYMPZEHSK,QGBCDGGDOCFGLDBCGFDFRDFEMCDEZFBGHABC..KDAG.hAAAIAFGBHDFaCAGFDDFhAAAAFIBJAFACBBE..fAHAhABAeFHD.NIDF.PDFBSACE.hABA......hACA...,1,-7,-21,14
PeNcRdXJZCSfFOKTbGIDHBMaAWEULVgQY,UGBCLFBBQAFCeEDBRBBF.dDCDZFEBCHGG.FGGA..ODFAKBGEGAEEhAAADAACBFHHABADEDGC.hADA......hAEA.gFEANEAE.XBBE.hABASEBG.hACA...,2,-29,-18,11
aBUgIDYSPReTdKEQOcFGLZWAfMNHXbJCV,MCCAXFDH..CGBEBHEFUBFCDBAH...SGAChAAARCFFdADBQEDCFBCHLFFEhABAAGHAHAADJEAEaAGEIHGEhACAeHFAKGAF.........hADA......hAEA.OHAC.,2,-23,-19,4
ADEbCIeNVMXfaWGdKBQSHTLFUPYROZJcg,DGHHCFED.eEFDMBFH..aBCBdAAH.BGBDSGBBLBDDUDGEhAAARDGFZGDA..JDDFACCF.ECAFhABA..IAHFhABA..NACFXAGA..fDAChADAKBEA....hAEA...,1,-21,-41,20
CNMIAFBQaYGeSOHXdPTbVfDULWEKRZgcJ,FFFBBFCFQAACaAFEGCEB..ODHDdCBH..TGGGVFBDDADBhACALHCGEAGGZCEAJEAFhAAA.CEFG.MEAC.IHHBhAEAABIDSACF......hABA......hAEA...,1,-15,-27,12
GgHfBZOTLAXFWECPKNYSbeUdDRJQMcVaI,FGFCCFEDKBFG..SDAGUDAB.RDFGMAFE..aGADGAAFhAAAHBBCBABAOFBHAHEDEAHBhAAAPCDD...NICB.hABAeHFGDCGE.QDGEcFCF.IDEHhABA.fGGBhADA..,1,-23,-24,1
XCcHUFbABIRLEfJgDSPNZMTOaeVQKYGdW,RDBHEDCD..JEEBSFGE.ZBAATBDGeHCEQBGAhAAAKGCBdAAF.XFDAhABACFADHGFE.FBDAADAGBBHBfFABhACADDFC.NEEHMIAGaAEA......hADA......hAEA...,2,-37,-3,34
fBUEaRQOYNCFGgJAWIXSbVecHMDTZPdLK,XCBCSCFC.eEFAMDIDZAAFLHDEBHGEUEBCaEECQGABhAAAOAEE.CBFCFDEAhABAJFEFACCG..IADDhACA...cGGADEEGPHAAKBGG.EACAhACA......hAFA...,1,-8,-29,21
ZbDWHJBUdQFCVTRNfeAIXLEPgYaSGKMcO,XDACEDCD..PCFGaHAC..GECGMBCCZDAHDFGCJCCCdHGFCFEAhAAA....VAGFhAAANIBBAAIF.LABD.hABASEFFOFAHWEEEBGGA.FACE.fGABhAFAeCCG.IHEHhAGA,1,-8,-32,24
CBHAOfdWeDNPLSGUXFgZbRITEVMYJKacQ,dDCDeFCHDEIFLDABGACBUDFBFEEHZCDE.RABH.EFAF..MAEEKGDG.hAAAaGGFQGFChABA.CFCBBCAHAIFEOBHBhAAA.NEIE.PHAC.SCGE.hABA......hADA...,1,-18,-20,2
ERWfPQdGTgABIUFOYbLKXJNeSVacDHZCM,UGGGOCCHLBGHKCGD..JHFESGDC..VFDAhAAADBEBCACEEGADRAAF....hABAfEACdAFHGADEhACAAHFF.FHCCXDDANCBG.aFBD....hAAA......hAEA...,2,-35,-20,15
TBgKdJDPESfRQOHVUaeXWCLMFNGbAYcIZ,..IFDGTADCBFDAKCCH.dBGEDCAFSGGBRFGD.HAABhAAAaHEEeAACCHAFLFFEhACAFGBFGBEDADCGZDCEJDAF.hAAAEHEA...........hAEA.OCBH..hAFA...,2,-31,-8,23
eIcKTQBDZHOVfNYRFdCaSLbXgAEUWJMGP,UGBCMDEBGBEDeHDEKEACBHFD.HCAEOEFCVFBF....hAAANCDH.FGHH.CACDaFGGLAAGhABA.XDDBhACAAAFFWDFA.IHHH......hAEA......hAFA...,2,-34,-18,16
ITJUVdWABcMNZbGRXQaCDHOeLPfFKgYSE,BBFDMCCAZGDERCBG..aACEDBAG.HEACLEEGFHACKADA..SGGFhAAA.IBAFhABAUDGGdCAC.AGAE.bFAEhACAXDDE.CHGA.OHBC.PAFGhADA.YCFGhBIA...,2,-32,-28,4
TACfIKVcPDYFMXeGJgLOSHNEaZdUBWbQR,CFDGKHBG...VGFADGHFFBGE..MAEAeABEGFBBLBFFHCBEhAAAECDDZBEF.BBHGQFAEhAAAAFFA.fBBEhAEAIBABPDABXGDA....hAFA......hAGA...,2,-37,-16,21
cBPWJUKIDLXRYVZNeFGaMAOQfdECTHSbg,ODACdGFCEFDBHAEA..SGDG..gABDhAAABEFCJAGDKBBEDICELCGDhADAXFAARADFZDBAFGFAaBHDhAEAAAID.fGAE.CGHA.....hAGA......hAHA...,2,-40,-12,28
acLPIQUZNVYJEbHXOFBfDeGgdRSCTMKAW,aHBGLGEA.QDBBUCBEZFGF..VFEHEDHDHBAG.OAGBhAAABCFCeFBAdEFECHAEMFDHhABAADIF...cADAhACAPAEG.IAAF...NCAA.hACA......hADA...,2,-35,-5,30
OAeZPHVIQDgSNfcWXBUGKRbCTYMEdFLaJ,eFBBZGFGHCCCQFDHSBGE..fAEGXFCBGAADhAAAKCCCCGGAMAACFEAFaEGEhABAAIAGVDEADCHD..NADBBFFDhAIAUAGC...........hAFA......hBAA...,2,-21,-5,16
WfEYDSBRIPOeMTCHVUbagGXLKNFAQcZJd,ZEFHdDCDEAEDSEHBBDAH.RFBG.OBBC..MIBECHCAHFFEbCAE.hAAAaAFFGACF.XAGFhABALAHB.FAAGhADAAFAC.QFDA......hBDA......hBHA...,1,-16,-20,4
gCNXVUDLMRTFIBbScOKAdJWGPaHfEQYeZ,JCCHGAFEHGDGEACB.QEEHeBADZAECCEGA..XEAFUGGEDAAEhADARFBFFGHH.BHEASHAAhAFAKAAHAHAHdDHAaBBA.hAAA.fCCE......hADA......hAEA...,2,-27,-9,18
dgMOUTXWSRVCAZaFcHPbYKJeBINfLDQEG,ZFEEaAFBHCAE..PBAAKEDFBHGA..IFABLCHHQGBDhAAAEABCdGEEMAEFhAAAUBEB.TDCCSGGEhABACHHEAEFB.bGBCYAHFeAGFDEEAOHEEhABA.WACE...hAIA...,2,-12,-9,3
ZbCBfEXPMgNWOUdaYcGFSVQIKDHATeRLJ,eADGJFFCZFCDBECF.EBHHMBGD....NCAG.OAAE.aGABhAAAGFCD.FABFVDAEhABAIHFHKHEAAADG.TGABhAAA.RCDECDHAPCCA...WBHHhAFA......hAGA...,1,-18,-36,18
ZAFTbNHXPQgWKJdSCVMcIReEOaGDULfYB,TGBCHAADXAFC.QGDGKDECSECACGFB.MIFAhAAARCDEOHAGDEIHUADGYCAFhAAAAHHAFCAH..NAHG.WCCDhACA.dEED.cCGAIABC.EFFFaHGEhADA......hAEA...,2,-27,-4,23
IEDULTVgGJSMAdaOWKBYPZCFQXcbHNfeR,dEEDOCCHBAFBZAEAFCEF..QGFG..XEBAhAAAHDGHNEEAeBABEDHBDICCUGAChAAALABC.TFGDhAHA...........hABA......hACA...,2,-40,-21,19
GfdQaTDRBLeVPYAWHSgCUIKcONMFEXbZJ,HDAGCFEDUBCAKGHH.OACAFBHH...EBAEZGBAGEEEQCEGhAAATCGDDHGE..LGAChAAAeDAG.PHAChABAAAIF.gAFFIFHGMAEEJBDF...hAIA......hBCA...,1,1,-36,37
GOWTKCMfHaIVQbDcEBSUdXeYNJRAZLPgF,ZFDFLGEAFCFEGBBEOCDHKBEC..CAEGMEIBHFFD..aHBGVAAFhAAADEEABAAC.dADCeFAEhACA.JBHBABBF...hACAgBEA.TGAFIAHD.hADA......hAFA...,2,-25,-23,2
MFKXcOfTaWPYUVIHDCSAJLgbQdZRNGeBE,JEEGLGEA.QDBBdACGRFBHGADFBGBHFHDAKEEH..OBAHhAAAaBAA....YAEHhAAAIHHHDADBAAHAZCEEhABAEDHBMIAE.fBGF.WHFAhABA.....hAEA...,2,-32,-20,12
NTURIDQMVXaeFAdPBCHfcZKObgYSLJGEW,BFEDHDBHZAEAKECH.ODGF..bAFESABDLAEDEBCDTEDChAAA..UGGFDCIFMFIFhACAXCADaGAD.AAGECHDAhAAAfGFG.cGDCJCGB...hABA......hACA...,2,-30,-9,21
HJLbFcNGQWeZXKgMfBTCADRVSPYaIUEOd,VBCFSHBG..aGHHECBAHDAFLDEHFAAFGDFCeEHDKDAFhAAAMBHFBFCFAAGC.DECCRFCA.hACAIBGA.OHDAhABA.dACF........hAFA......hAGA...,1,-18,-23,5
QHAZYRDNcOIMXgVFfWKLUdGCaEBJbTePS,ZGFGDHCEOBGHMDCC....XAADVEGB.FFAAKDBGdFFFCFDABBAGhAAAJAHD...eADHhABASGAGAIHE.NEAH.hAAAIHAE..WADELDAD.hACA.aBDE.EGDF..hAHA...,1,-28,-37,9
fAHJUcNBaRWQLDOGSIFgKYEdZVPbCXMeT,JBDGUCBCBBBERBFHLFHB.GEDGFEFHKEADdFFAZCAA....hAAAbABAMABG..fGAChAAAAAHBHFDBaDGGDIBGhABA.SAFE..IHHBhAFA......hAGA...,2,-45,-10,35
YdEDAZKfBOeMcWXSUVHJNQTaGLFCRIbPg,ZDAGBFEDMGDA..XDGFSABEUAGAHCFD.QGAAhAAATCBHLEADhAAACBFCICBD..bFCHYECGhAEAEHGEACAFKABDeHFE.WCHBNBFE.aHEC.hACA......hADA...,1,0,-28,28
BfdCYSHXWQRIFTPaKMLNDVZGegcJOEAUb,BHHGCFEDHBFAQDCCFEAF..aEHDLAACDADAZFFD.eAFE.hAAAgGCHOECDADBG.hABAbFFGdBBF.SAGEhACAWEBF..RBDGICHD.KBBDMEEEhBAANEAE.....hAEA...,1,-15,-20,5
AUPBcYWICQgFXTfKGJdbLEDZeSRaMNVHO,BHHG....cFCAIGBA.CEGD.FCAB.XBBBhAAAKAAEdBCAEHCAZEFDRAGB.NIBH.HAEChADA.ACEA..PFDChAEAWDEB..QFACfHEF.bCFADECGhABASFAFaHGE.hACA...,2,-26,-23,3
PLXJKgdBYcVUCWDfRGaQMeHESOITANZFb,ZDAGFHBGLABCKFHFBGBD...VDEDCHDE.DIEERDFHGACH..hAAAaEHBMIFAECCHSBFGhAAA.IHHEhAFATBAFAAID.........hAGA.NCBEXECDhAHAgEDF..,2,-38,-31,7
QabgPORULZHcJYDFTfKVWSAdEXCNeMIGB,EFAACHHG..eBGHGDBFBGBAQAEH.aGHBgCAGhAAARBACLHCEZEAAJBHBDBIHTEFEhAAAKABCSFGFhAEA.AIAGdDDBMABEIHEC...hAGA......hAHA...,1,-6,-29,23
SfeQAdXCNMVUBDcJgbPOYREWaGHKTLZFI,dFFBCHHG.MAIDBEHHDAGB..JFBG....PECDOFEEEACGGACBhAAA.KDEEZBBCFHCGhABAIHHH.SGEAhAAAeAHFACCDXDACNAFE....hACA......hADA...,1,-31,-41,10
VPODABHRCYefETLXgJIFcWQbKGNaSdMZU,HCDHCFDD.eCFEECFHLAACXAADJHBCFBBB..QGAGhAEAKGDCaEAG.MEIFZFFB.UGFGhAFAOADGADCFBHDH.RAFE.hAHA.....fEFFIFBE..hAIA......hBEA...,1,-18,-19,1
EcCNLMHAZPdeGDRgKXWFJOaSYTbUQfIVB,ZDAGeCCHGCFADAEEKCGDFAAF...JBHHSBHB..TGABhACAQACD.hADAfHFHIFHAVADChAGAEGBGCFHBMIAEAIHGdFDE.REEF....WCABhAAAYFFFBEDA...hABA...,1,-16,-29,13
YQCbXIfMcdgKRDeaBLZVFSTJNEPUHOGAW,QCBCXGGG.MACAdHDFRCDH..aCGABHAALBACZCBHSEABhAAATFDD.ECHHUDFChAAAHAFDAAGECHHG.fHEHhABAKACADFGE.FHBA.......hABA......hACA...,1,-9,-22,13
LIaCTYPdWANVeDFKXGObBUMHScZQJgERf,VFDFFEGCGCBG.BBGEUGAHHFDGZADAQBADJFAF.ECEEhAAAfADD.hABAaHGAYEDC.hAAAdGGEAAIFDICAKEAC.XBDG.MDFA.hACA......hAEA...,2,-20,-19,1
GMgWIPaELDdNRbVZfQFSXcYCAeJUBKTOH,eFCAUGDEKECEHEADGBEDMBBE....gGGA.ICAGhAAAaAAHDGGANAEHbDEE.hABAZAEBFFBF..SDCBhABAXBBBCEFGBAGHOHFGWHCA..EDHBhACA......hADA...,1,3,-32,35
GaNJCUfXWgDSObBTAEMFIdRQcVHLeZKPY,FHBGdCFCQCBGHCCCZBAEKFEEGBGA.aAECJFBC.UAGD..hAAAfEDE.hABAgGFEOEHHBAEAhACAAAAGIFAF.cACCeHDCNEAECHADDEIFhADA......hAFA...,2,-24,-21,3
DROBJMEVCgdFIASWNLbHYZacQKPUXTGfe,SHBGLGEAHCEGZACB.aBAFQFGB.KDGEXECBhAAATGEDGCAADIACBFFChABAEECHCACGFFAFAEFE.NAED.bAFEhAAA.....cFDBPDHD.fBEFhADA...hABA...,1,-13,-16,3
SOIDABVKJLMPRHNTZbGdXCFYQUEgWaecf,KBBDMBEAHDCCZDDGdBAGFFDHUADC..EEGA..aFBFeHDE.SFAHhAAAIHHEDAIFhAAAAAECBCHBLBGDRCBFTGGAhABAXFFB.CHAE.......hABA......hACA...,2,-28,-20,8
JLQDHaXPVTWSbeZfGMCBdEYRIOUcAgFNK,FHBGJCCHLBEGQCCFHFBA..aDGAXGDA..TFGFhAAASGGDZADEfDAChABACCAHEEFA..hACAIEAHcGFCAFFANABFDBIBPFAC.bFDDMIAEhAAABAHF....hADA...,2,-19,-14,5
WeUZEBdKgXPVJDOcSMCfYRAbHTaGLQIFN,TFDHaHAELBGH.FDAGeBBD.ZADGEFDEKBGA...PFFAhAAADAGEOBCA.SGGDhAAAfDFHAGDFHCEDhABAQFAAIFHENIDDBDDB...hACA......hADA...,1,-16,-26,10
cPAaQUSdRFHfZYKBXbDegWJVLCGMTOINE,aEHBQFCA.UDABRADCFHAAHGFEZGDEBFCHXAAEDDEH.eBDAhAAA..JABFCFGEMBIFhABA..TDAHIDEAhADAEBGH.AAGCSBGH.YFABhAEA.....hAAA...,2,-44,5,49
IXFKeSNYZcdVOETMGCJbaDRLWHBfAUPQg,UCGCQCBC..ICCCFEGFeDEF.SABAZAFGdAAFVFDEhADATAEA.CGCHaGADhAAALHAEBHHEABAHgEBFhAEAKAHF..NICD.OHFC...hABA......hACA...,1,-21,-22,1
FZJeGOPBRYfCWcQLaUSMNgATVbEKdDIHX,VEFHEAFBKGAE..DDBEHFFGZBEG.GDBBBFBE.RABDCDHC..QGDGhAAAaGDB.MACCAIECdAAChADAXGADFAHFOADFhAGA..fAFH.WDFE.cABChAIA....hBAA...,2,-36,-9,27
aXGADQcfWgSZJCLeIRFYbBUKEOTVMNPdH,DAFBQCBC..fBBASACCJFFELFFF.hAAAREBAFBHHBDEGKGDHEGAHTGGEhAAANHDD.dBDH.aGAHhABAADIBgDAA.CCGBeECF.IADChABA...hAFA...,2,-34,-16,18
PYANSbCHKLDGMUQOEeaZdIWgXBfRFJcTV,SHBGHDBHLGDAMEBEUAEF.EDFBeCBCZDDHdAHE..WAFEhAAABBBD.RFABFHGETEGBhABA...YFBAhACANBAE.CHDBDEAD.OABE.IDFBhAEA.XGGAhBAA..,1,-12,-18,6
DLUPTWReZEBSbIJMdAFCgQcXKHVfYGaON,CFEDQCBCKBFG.HABG..VFBFfGGCGAACaCECNCGGLAEBhAAA.PCHHhABATDCC.eHDABHAEhACAIAHGdAGHAFFFFECDXGGFDFEF.WFAFhAAA......hACA...,2,-34,5,39
QFCGAcMUVKHaXOYZLENPWDfIRTJedSgBb,UFDBKDAFHAABOAEDLDFB.EEDH..NAAC.DBGERBGH.eEHDdBDGBBBHhABAFHDACCDA..AGADMFBBhAAAaGFDZEAB..fCHEhACA..IHHA.SGCDhACA...hADA...,2,-31,-23,8
LBaEWSOMNDFXKUQCbIAYcTdPHGZRJegVf,TCBCdCFCHCAG.ZGBAREFE.eFBE..fGCEaFHF.EBAHSAAChADAOAFDMEBBhAAAFGGDKAECCAEG.IAHChBBAAAHB..cGGE.PFEB..hABA......hACA...,2,-25,-17,8
ZCHdbNUOSgDIYEceMQXLBVGfTaKFRWJAP,CFDDHDAGdCAB.UFGC.SDGGDEDEEFBF.MBFFLAFD.BGFHhAAAVAACGAGE.hAAAaABGFAHB..JEHBAGACPHDEhADA.ZDDF.......hAEA.NIAF.gGBAhAEA..,2,-37,-5,32
GeREOdCPULJHbaDAFcKSYTVINZWgXBfQM,FAFBKAFB..SEBBTBBC...IBADNHDFZAGB..XDFChAAABDEAMCCC.RGFAdFAChAAACDAEUEAFLCHFhABAJDDFaGGAABDC....cGDBWABE....hACA......hADA...,1,-21,-32,11
GdeHYWXObMQgcEJUfaTDARCBIKLZVSNPF,BDCFLCCHZBAD.SDABFEGAdBFAHFEE..XBGGMADA.hAAAQFGHEAHFUFCE.hABATAAFAICA.IAEChAAA.VFDD.NEEBeHAE...hACA......hAHA...,2,-31,-3,28
IQdANRHBZTKGUeVgJOXPbDYFWCcfELaMS,RGFGBEGHKDBEGADFeACH..JEBFODFG..XCEHDFFGFABB.hAAACBHA.EHCALDDFhAAA.MFAFIEDGhADAAIHEHGDCTEAGUAEFPBAH....hABA......hACA...,2,-25,-20,5
UGgbIVFRYTWJeMNPKHcdfOLXaDZBSQAEC,EFFBUCCHGADA..bFDHFHBE.RDAA...TGGEJBHH.eFBDhAAAMAACKDFHHEGD.fGEEhAFAXABADAIBhABABBBAAGABCCFFIDFF..WAEGcGABhAGAdCAEaDHB....hACA...,1,-4,-22,18
eZJQAKLVDCBcEbgHGXUWOYSTIFdNfMaPR,KDBDVAADDAAG.BEFAEDCA..HAEEGDCEUEFG..OAFFSGCDhAAA.FEAHdHGBNEEG.hACAfAHC.hADAaADHPHFC.eCFC.....hAEA......hAFA.JCHBACDG,2,-43,-11,32
YRSAQEKITGMUXWHOegBZLdFaNbCcDfJVP,EFHBTGBCUCGC.HDCFeFFEZBEDLEAG.aBAHbADF.DCBBfBCEhAAA.JBGDhABA...PBEFhACASAGEAHADIHHEMFGHXBBF.hADAWHBABHEENAAE.CDBA..hABA...,2,-27,-1,26
feMCdNTRLEWFgVaPQJGDbIcUSOZYKHXBA,MDEBdEGDRCCELBCCFDBG..VCFAQEABDBAH...IGCHhAAAUFGAOBCEhAAAKAGEBCAFeHBATGGGhABAEAFA...aEFHPFAE.....hACA......hADA...,2,-25,-23,2
cVYaEFUNGJMXTCfWZBRLIdAeQgOHDPSKb,eDACQDACOFBGDDGFKBCA....bCDBVGFE..EGHBUBGGhAAAJBAG.MICA.XEEBhABAfHEFBHAHhACAIHABABBA.gAGHSEHBaGBAhAAANADBCGCAWDEH...hAIA...,2,-21,-20,1
FbJTPYfCHIaEgUSDNeVWcAKGXLRZBQdOM,GBDBLADGBDDBODGFFCAC...TEDD..fDFFhAAACBHGHCADaCFBUEAEDAACeHAAhAEAVEGFABIHKGFGXGBAhABAQCCC.MFIDPABC.EAFG.hAFANIEB......hAHA...,2,-11,-11,0
fgWCAdFJKZRMPTBIDYceNVQEaLbGOUHSX,dEEDFEEDKAEGMIAGBACGDBFH....eABDQGCCLGDEOBFEhAAASEHD.XBGGhAAAfGABCBDFZEAEhACARDAC..TGFEIDAE.NIEF.EBAE..hABA......hADA...,1,-13,-36,23
BfDEVaXRSLFYNGJOgPUZQCKdTeIMAWbHc,HAADBFDGDICGaHCEREDELEEE..FEBDGCBEODHH.UGGHhAAACAGAdAADeADCABFF...hABA.bADFfAGChACA.ECDGXGFASAHH.NDAE.PBHFhAGA....hAIA...,1,-1,-37,36
SEITZdKHVGCbaMOAeRcgXPWQDBfNLFYUJ,eFBBRAAD..XCFHQFDHBHDALBECFFCCUFFFSDCAhAAA.IBBGhABAdHAFKDCCHAEHCHADMEHDcAGAhAAAWFFHDDAF.NDICECFB.....hACA......hADA...,1,-6,-28,22
XPLAYFUDJWHaOBgGVEecZKfSIMCTRbQdN,UGBCDEFHHAFEODEDGCCC.EGGGZBCDKEGESCAE.CGHE.hAAAbAAB.dHDH.XACEhADAAAIDFDHDJBFCBCHHeHDEhABAfHAH..MADC...hAFA......hAHA...,2,-29,-16,13
TAZbKgXEWLJNRdVYPHCBGOSUQIDfMceaF,ZDAGKHBGEACGLAAC.JDFARCFEdBAE...VEAGHECG.BGGBhAEASCCEIBFGDEFBhAAAMIFA..aGGCFHBEhAFAAAGF.bBBE...XAGFWEED..NIEFCAHAhABA......hAEA...,1,-13,-32,19
GMBHKLXJgPEWVZNQRfaFTISCdbDeUcOAY,MEAEKBBDLBEB..JCCEEGBFZEEARGFAFEGGSHBA.dBGGhAAADDGGUFACAEAEBACDHGEAhABA..XAGGhAAA...PEDBNEIEaADACFDG.eBBC..hACAOHCE...hAGA...,1,-16,-28,12
IUJKFbTaMdRgBEQYPHfLOCDVGWSZNAcXe,XDACeDACUFAFKFBCFGFF....aAABMDEEdDGABGHC.QEEEhACAHEGDfBHEhAAACCCEDBBB.VABESHAAhADAAEFH.IAHCbFCD....hAEA......hAFA...,2,-38,-13,25
ETJfVYKULeSXNOBWZIAPGaCHgFMRdcbQD,aGAHHDBH.MAGFdAEAQCBEEBCG..fAHEVCFHKAACLFHFhADAeHDE.XGBEhAGABEEHIFAGhAAAGDDGCEBDFBAC.REGDDIAA......hABA......hACA...,1,-7,-15,8
FAIdZWPDKcMYQaXOHEBNLCJgTbVSRfUeG,dCFCZAADDEIFKDAA..MFAFQAEB.OHCAEGFDBHCD.CDHB.hAAATFFG.SECAhAAAfBCAeAHFhADAAIHA.IDCG..cEBDaCGHHFAAhAFANADH..JFFC...hAHA...,2,-41,-18,23
OcXCENdLAKDPJTVGeQFfUWMRHZaIgSbYB,KHFGDEFH..JECDTACB.GFBHFAFBUACGRBEBHCAD.ZEEA.aFHDhAAASGGABAFBOAHDhABACAAC.dHAFABHD..eHDGhAHA...QEGF...hACAWCBG...MAIFhBBA..,1,-6,-42,36
bVZPYTKBGECMaWHLfXeFNUcJRgdDQSIAO,OFBBVGFG.ZCCF..TCGEBFHGEDHBMGBCHAEC.LHCEhAAAeAAGUDDERCEFDEGDQAGDhACAAIHA.PDAEhADAKBAFCDBH.aGAC.XADHNEAE....hAFA......hAGA...,2,-17,-12,5
VRcNfDAXUPMHGLSgYeZJBTOIaWCKdbEQF,XCGCMFFFLCBC..SGBAeDHHBAFFTBBDaGDFCAABKGBFhACAEAFGFEDG.VEGDhAAANEAD.AAHCUEAEGCFE.hABA............hACA......hADA.YFFF.,1,-9,-25,16
NGIOdFDSEVeWHbcfZPKLRBCQTAJXgMUYa,JDACMFFF.UBAD..aDGBGBDBdACGDCFEEHAA...eDBDHEEBhAAA..bDDEZEBGLEHBhAAACHBBAAEB..gAGEhABAIHDASAEE..WHEGhAFA.fGHEhAIA.KDHB,2,-28,-20,8
CKBTcGeJbFADaLVPXWZQgNRHIOSMfEYdU,LEACXFDHZCFHQCFA.RAACHFGBSCCBEGAFdAGBCHHHBEBDhAAAGEDCJGAEADAADCDChAAAaACA....PAFEhABANCIE...MCIH.fCBEhAFA.KGGE....hAIA...,1,-2,-30,28
JYIOMWCaRNFeVUZfdgGEbSBQDLTXKHAPc,JGEAOGEA..CDCH.RDDEeACDUABC.ZEAA.dBAEGEAA.EEDABCGChAAA.DDHFLAEChAAATGAC.KGDDACEE...hABA.....YFHBICHDMAIFhADANIEBfCFG.hAEA...,2,-36,-29,7
RaNGPKAeTOWEFQXUZfCLHYScIJMDBgbdV,eFCATDACECDA.FGFBUGFH.ZEDGLHBEHACD.SBAAhAAAJHBABCFHdAGFaDBBNEEBKAAD.hABAAGIF.QBGEhACA.fAEBCEHA......hADA......hAGA...,1,-14,-29,15
VBQGdgZeCSYEcOTJRFDAKXILNafHMWUbP,XGBCLGEAaCHHHDEH.UACG..bAAFVAECGDCF.ZAFBhADAeEDDCEAG.EHGATADEhAFARAAHADIF.KFCB.IHBBhAIAfGFA..MFIH.BFFA.hAAA......hAHA...,2,-14,-2,12
CANLUgEeHaJObYIMPcZBXVDWQfRdTKGFS,LDACEGFCHAABJCFGOHDA...IAHCMECHZEDB.BAFGhAAADGACQAAChACAdADA.GEDFCHBGAIDA.gCEChADA.aGGD.PCHFXDGAhACA.fAGBhAIA...,1,-10,-34,24
aDCdZScFUTQNWGPLOYRVEeMHfBXJIAgbK,KHBGaFGE.DAIFdGBGZCDBFDFH..UCAC..TDCF..QEGAhAAAGGDHOCHHhAAARAFBeFAEMDAFBADEIBBDhABAACDF.CDBCNACF..PGEC..YAHHhBAA...hABA...,2,-38,-13,25
HdDANUgSCbIVaTBXFYGfPJKLZecOERMQW,UCBCCFED..VDAGaAGHBEHG..FAAHGGEHJDHH.ZFBEeGCGhABAEABA...MIAC.hAAAHAFHDEAFADDE.NBFG.gFFBhACA.IADE...hABA......hAEA...,2,-39,-23,16
JVbIYELfMGFdaKAWDTOXReSgNZHcPBQCU,DAFBTDCHRBAH..eEECSGCDZGCG.HGFEBAGHCGAE.UECCVAAFhAAA....IGHGhAAALBEE.fFEFhACAMDDEFACCKBHBAAEGODHH.NAIEcGDChADAJEAF.ECFF...hABA...,2,-32,4,36
BULYWaXHDNEJFbCMQGeSRdPKfIVTcZAOg,OAFBUGGGLBGH..aAAFXECCHCBFEGDGFGACCAGEGEDHhACAeEEGRBAH.KGGC.IHCEhADATACEADDH.BEADhAAADCGGNIEB..MBIH.SGDGPEABfBDAhAEA..hAIA...,2,-18,-12,6
TMbcPLXafEYOHAGNZVCeUFSKRIBdDgWQJ,GEDHZGFGCBFD.FBGHKDABBEBC.dBBCDBBG..QFAFJCCC.hAAAMEIH..bDGFPCCGhAAA..XGBDhABAEHGEOABA.NICF.UEEE.IGAHhACA.....hAFA...,1,-22,-42,20
RANFXBPHQSDLJUbgZdWKCITcOGEeMfYaV,XGBCHDBHSBAFLCAAJBFB.UGGHZGFEKGDC.CCFG.TEGHhAAAOEFC.GAEDhAAAeHAA.MCEHaGEDACBF..hABA............hACA......hADA...,2,-24,-24,0
GNMLgBKSRXPAbcFdQZeOCJHYVWaTIfDEU,FHBGZBCFeHECCHGE.HCEA..VCEGaFBC..TEGEDBDHGDABhAAAMAIHBHBEKAGC.SAADhABAXFFCAIDAbAEEdACFhABAODAB.........hAFA.WEHB...hACA...,2,-33,-11,22
QaUbXONWDGJZdITSfFAMVRHLEKBgYecCP,RFBGHDEDKBCEBFHBeAGHCACB...aABHUAGGOAEHDEAC..ZGFAIDHGhAAA..TCDHhAAASGAG.ADDFMIAGhAFA.EHGAcBAFPFBE..XEFBhABA....hACA.NIBB..,2,-49,-8,41
QbDEgIeUBOJKMTZFHXAWSVfNLYPRCacdG,SCFCVAAD.LEDHRDGFCGCG.aGAAdBFAGACDDFAF.ECABeFCEhAAAUFFABHAA.KGGDhACAMAAEZDBE.XCCChAFAAAEA.fDGB.NICB....hADA......hAGA...,1,0,-35,35
TQHXMIEObDGVPgRaYJKeSZCdcFfUNLABW,TGGGHCDBMABF.OEHBDDCCGBDF.VEBDgEADhAAA.aACFKAFEZGDEcGEBhAAAfBHALABEhAIAAIHABHBHXEECICFEEDHF.....hBAA......hBCA...,2,-15,-8,7
LCDTYGgfaHQBEWUdcSbVMFZAOKJNIXReP,KGDBJGEA...XABDRDABLDCCDAAHGEDB..aADBBECChABAEDGEUAGGSHAChADAMFFG.FAEEZFCBAIFGIDGEhAEACBAC..........hAHA.gGGBhAIA.fCDF.,1,-25,-30,5
cGRfCSVFJAMQbETgWdaOZNLBHYXUeIPDK,QFDBTGBC.dCHCZAFBBHFGHDCCUGAEIBCAKADG.GDGChAAACDAE.FCABACDHMAAEhAFAEFFDaFBG..OBFDhAGANIDB.....XGGEDFAB...hABA......hACA...,2,-33,-8,25
KQNGecCdZWUXFTRAaOfYJMPBbHVDgELIS,OCCHJGEABBABHAEC.DBBCLCFCKDFAGDDECEDC.ZFACUGBHFHGG.hAAA.AGFA...aDBDMBADhABA...PHAChACA...........hAAA......hABA...,1,-14,-63,49
FTRCaAfNWPEXDVdZcebMKgJQBUHOILSGY,...NDHC.EDCD.VACHdAAFZEED..eBFFKAHBQEBGhADAUFGGHFBB.OAFDLFADhAAASCCGFBABREDFAIEA..hAEA.fFDCXBGD.DFIFMAEEBHAA.hABA......hACA...,1,-2,-24,22
JHZDUNcXQgePMVLCYFfbGWROTSEAKdIaB,KAFBdAFBBEDAZBAHUFDH..XEAC.eFFAMIACLCDEhAAAFDEG.GGBFOACAhAAAEACEaGGDDIGE.NAIC..hABA...gCGHCBADbBBD....hAHA......hAIA...,2,-40,-10,30
afBZeMVcGdQTFgIUbEXYCOKWPNAHLJRDS,JFFCDGDE..SBEABDDGZEAH...MAAAGGDBQDFChAEAFAGHUACBEHBC..CAHB.ODBAhAFA...PAHHhAGAADFBLAAFfEBE.eHFEcDGAhADAdBBF.....hAIA...,2,-39,-18,21
DJFGRHSZdCcgPQWUIefTLMYAaBEKNbXVO,aEHBBEFA.KFEF..XACGDCBAFFAE.RBFCZFDC..CAAF...gCDDhAAAQGGHIGBAhABAeCDHLACEhAGAAEADEHDA...NBHGOHAE....hAHA......hAIA...,1,-24,-42,18
BUXJLYOKcHVSQMTREZaDPCGgebFNdWfAI,UGGGXFCALBGHKABE.HGAE.SBEGQDCCMBAHhAAATBFEZBBD.DIGECEEFeGDEhABAFAEGdHDH.AGHEIAHChAAABAFC...JCHB.ODBB..hBAA......hBBA...,1,-16,-23,7
adCeZTXBHKbWESgLRFfNIcJYAUPOMQGDV,UDACMDEBDCABdGBBZFGBBBBGHAEG..KFBGEFDGLEHD.FFFBhAAAIBCC.JDDAhAAAADCHOHCE.QAGGhABAaCHD.CBEBeEAF....hACA......hADA...,1,-29,-35,6
aBNIUHdRFJQPOEZWMgcDAKCXGVYTefbLS,KFFBXCCHGCGA...VBAEeAEHLDAGSEGHBFAAIAHChAAAdGCE.FEBHJAFChAAAQGDFOECE.hABAWABC.MDFGDGIDAHHFCCBAfGHAhAGA......hBAA...,1,-23,-26,3
PXdfWASQLeRFIcEDCNUHKOZYaJVTbBGMg,SGDDQFCAeAEDFEEC..EDAFDGBFCEHE.HCBAZCCB.aCABJABETAFHhAAA.BFHBMHFAhAAAXGGHdHAH.AHAFIABFhADAUBFHKBAD.YDEG...hABA......hAFA...,2,-26,-2,24
aHGKVZPSRLMBfQbTCgFcOdJEIWXDYeNAU,HBCFKCAHZGDESEGALDDCBAACQGEH.CCHDFGBFODGDhACAEAEA.XECCeCABAECF.hAAAaAGD...PACChAFAfABC..TGACcAFDdEEAIDFChABADFIF.NEAE..hAGA...,1,-2,-24,22
NWBUQGYHFdbgIaZJSDfATECKXceRPVMLO,TGAFEEHBKFDE...eABDRBFA..MADAOEDABGFEUADEGGBBhAAAHCFGdEBAIHHGhAAAZBBGDEEAABFGXGFB.hABAcAGF.PFBA...NCAE..hACA......hAHA...,1,2,-28,30
ecDCIFMQRbALUYJSTZOHVKGXWdNfBagEP,LDACUDAC.JEEBTGFEZBFH.HFCHKHAGGAAFdCHEBEED.EHAEhAAAeHFEDAEG.FEADMCBEhABA.RCEE.AFDH....hACA.SBGCOAHF......hADA......hAHA...,2,-29,-17,12
BbeHRcYIZOQaLPdUCSMVEFAKGWDXJTgfN,GEAHDAFB.JAABTABE....NBDFBGDBbEGF..HCDAhAAARFFE.IHBH.hAAAOFFDQCCAhACAaGABdDACSHDAMFIHEGCEABAB.KEBCWBHH.hABAfGAA.hADA...,2,-33,-12,21
MDcbgFXBeLPIZHYNJAOaEVQUGSfRTKdWC,OEGHaEHB..EDFDQEDHGCCCRGAEdBEHCBHHDCBG....bAAHhAAAXDACBACFeAFEhAEAIGBC.ZABANIDFAFBEhAIAUBFE.SHFAfCGF.KGHBWHAAhAAA.....hBAA...,2,-23,-10,13
IASTFcPVRgNeGHYWbUEZDCQBfLOKJMXad,TFCEFHBG..VAFCRFFC..eFABHFDD..bACGEBBA.CBDAQDAGhAAAfDCDKBAFhAAAXGFAICHAADFD.hABAcCFCNDIA.........hACA......hADA...,1,-12,-22,10
VFgZXUNaAORMfJPKCSHBDbeLIcQEWYTdG,MAGDJGEA.KHACHFAEBHGEDFCG.LDEA.QAAChACAEAACTBCGGBEFFEEBZCGBNAED.hADAOEAA..fDBDhBAACFHH.eHBAIFAFYFFChBDA......hBEA...,2,-36,-8,28
fGPVgcQDeIKMLREHdbTNFSCAWYBUJZaOX,BFDGJADGZECCODBC.GBFA..PDHDVACB..QFFFhAAAeHBEMDCELBHBhABAEAGAHAAFdGAFTGFAhAAA.FDAHAGIBYCADXDEA....hACA......hAEA...,2,-20,-10,10
WFfCMTHcLQIRJDAZBKEOaUGSYbXVgPdeN,KBBDEEEDUBAAGAEC...SFFEXBFC...VEAFgGBDhAAAdGEBeCHBFGFDMIAEhAAATEGG.LDDDhABAQDCAIHHGDIGEAACHBADCaEAGPACGhAGA.NAIACHAD...hABA...,2,-17,3,20
aSBDbIQCKWPFXeZVONfRELGHAdcMgUYJT,dGFHMCCAUBEE..TEBCBHCADDDF..IEECCEFG.KAEEhAAA....FBBBXEGFhABAeFAB.VGCChACAfEGBEBGFLDACAEEB.cGFAJAHFSGCChAAAWBBC..hABA...,2,-53,-10,43
UHfbZWVCgaQeTPRIMSDdLABOKNFcYXEGJ,KDABFHBG...XGGEGAEAHBAHZAACCBHH.aGEH.QFGBhAAAeFEFRCDB.SCGAhABAdDGEACCBBAGFOEAB.cDDHhACAEHBEfFBF..WDBH.hABA......hACA...,2,-30,-3,27
AMHKOQJaUIdgTDePGLbCRVfNYBXScEZWF,KAABOFCAQBDEUCBB.dHBHDDAFGCGELAAERGFE..VDBAhAAA..fHGDhAEABAGCXFCAEDHBFGCFMCABhACAaBGB....IGAG...hADA......hAEA...,1,-14,-30,16
XGRJgIfdDEUMNALBYKQbcVHWCeaZOFSPT,LAFBKEGDQCAFVABG.HGBC.CBFFZABASECC.TGGFhAAAGAGG.JDCGfBEChABAEEADMFIBAHHBBAHBhAEA.bEFE.eHDEaGAHFFEF....hAAA......hACA...,2,-11,-7,4
gKQHMbSDUVEaJOWeIGBFdLAYcPXTNRZCf,...PGEAXBFGRBFA.ZEAB.CAGFKDHBQDAFHDCF.SEHBhAAAVGFA.EABEOBAHhAAAeDDHBAHBFGDDAEEE.hABAcGABTBBCNIDB....fBDFhADA.....hACA...,2,-19,-8,11
HAGJdTRQPbfDMcaISegUCOBKWZXYFNLEV,JCDGRBCFQFBC..bACGDAAF.aAEGeEEE.UGADBEGGZBAFhAAAFFEDLEAAEAGFAIHA.hABAdGDA...fGGChABAMDIHIDAFCDHA.KHCGXBGBhADA......hAEA...,1,-17,-28,11
cSFNdAbVgDfBPJIECUGZOLeQHWTKaMXYR,VAADDACBBHAG..JEEBEFFF.GDCELHAEHEABKDCA.MAFFhAAARAEEFAAB.AIHE...fBGHhACACBDDZEGBQCEDhADATEAF..aFHD.....YDGHhADANICB....hAEA...,2,-33,-10,23
CLMgRVTbBIaSKUGQPceEXJfHFdYOZDWAN,CAFBMDEBRFBD...VBFEBCBH...SFFCUDABQBABhAAAeDDE.EFGC.XGAEhABAHAAAFGHHdHEBZBFAAFFA.hACANEAD............hADA......hAEA...,2,-33,-22,11
SWeGIQFOANPYRdZaBTLKgVcDCbfXUHEJM,...NDEH.PFBB.dFHEBBFAKAEE.VEAFDDFA...CAAE.XEDBhAAAHFFFMIAG.eDDBhACAIGFHFAEGACCD.ZBDEhABAaADHTABC........hADA......hAHA...,2,-36,-26,10
VgSAQLFDfIXGHcNKJRUebaCBPWEZTdOYM,QGGDDFDC..IABEHCGHNBBFKCEHRGAGUGGE..bFACCDAEBDGGhAAA..PCCHhAAAEAECZBFEOCAD.hADAMHBESCCGAFIHfFFAXEAE.hABA......hACA...,1,-16,-34,18
deZDXFVOPfSWRaMIYQANKJgBUEGCHcTLb,JCCHUGGGGBECHEABLAEA.dDEFDGIHFACDOHCA.SFAAhAAAaAABMICEQFCChACAABBDKGFEBAHACACH.hAFA......cDGE.eCADhABA......hACA...,2,-40,-17,23
gMJKBHEPSACLfYdDVRGWQXeFcaTNIUZOb,CAFBLGEAdGEE.DAFBRBCCGAGEQGAG.FBADTFBA.UBAEhAAAbCCD...MFDChABABEAB.EDGAAHGAfDEBhACA.....WEADeABG.hADANICBIAHHOEHF.hAEA...,1,-23,-24,1
SPTgLVNIcRWFaEbDQeMGUOfXBKHAZCYdJ,CFDDJCCH..SAGE..PEEDTGGCLBGD.hAAAIHCFcABFFHBChADAEGGADCBBeCEG.MFADhAEA.ODHDfAEAKEFFAEBE.YDAFhAAA.dAHE....hABA.NIEFaACG.,1,-17,-19,2
KUMDJBAScTXFNWeIbVZELfOCRHYPgaGdQ,TGBCFGFCeFCC....VDGDZCDEEAFEOABFCAAC.HEDB..hAAAPCAGgAFBhABAdHCBQEAFMBFBBHHGhADAAEEG.XEBG.WAHBIADC.hAEALAHBfDCHhBAAaEGE...,1,-13,-15,2
BfObUTVcCMZLEYJXHDgPdQANRGKIeSaWF,REBHKGAHeAFH..aACBBHDA.OHFETDFC.CDCF.ZBDHLAEHhAAAEEFH.JGCEDAIFdAGCAHAG.hAAA.GBAESEBAhABAFDHD.fGGH.....hABA......hACA...,2,-26,-26,0
GgJcAOUaWeBPZCEYDVNXdRMTLIQfbFHKS,UAADeCCHBEEFZFDF.CDGH.DFGH....XFFBMBFCLFABhABAQAGFFCDGSEBBhADAGBAG.JCHFAHHAWFADhAAA..EADAYGCA.NICHdACFhABATDEF.IHHFhAGAHAEB..,2,-24,-20,4
VETDCQJgZaBcGRHKOANXYWePLSIbUfFMd,XCBCeGEALCBC.SEFCIDGHUGGEMAEEEGBCCECEQFBHhAAAZEBABACG.GADAhABAKAHBADHG...WCHHhACA...bFEFFAABTAFCDGIF.aHCC.hADA......hBEA...,1,-2,-22,20
ebVMHKAYNIScWadBXgfLZOTREFPJQUGDC,..IFDGSHBG.aGDCdGFDBAGAXCCELEFAZEAFRABEFGGGhAAA.QDAAhABADBADCEHDeCFHMCBAHAGDKDDDADIF.hAAA..NBBF..gCGA.OFABhACA.....hABA...,2,-24,-7,17
YcLMOCGZPSUTgAeQafEHJdFWNBVDbXIRK,QAADaAFBHCAEdEFHFCHFBHGGDDCD...XAAEREEBKGCDLAFGhAAAMGCCGCEFZBDASEDDhACA...hAAA............hABA......hADA...,1,-28,-30,2
EXfNMZHdKAFRWaTLVbBJIGSgQCOeDcYPU,FCFCRDAG..TCDGVFFHBFADGFBB.SHGACBDE.DEFE.hAAA.PBBDUABGfAFGhAAAMHBAZDEAdAHAAHGC.hAEA..aABGLHCGJFBA.IBHHhAGA......hAHA...,2,-27,-16,11
JFIBVfWUQXZRdaYTKbLeCHcSMGAgODPEN,OFCHDGHHEACG.FDEFBBFD....VAFDUGEEZGFEdCCH.aCHFKEGGhAAA.eCBAHGBEMABEhAFAAFFG....NBBE.IHAAhAHA..fDFF.WAFEhAAA.....hAIA...,1,-34,-35,1
dgbOKcDGeLQXZBPTfRFNaSUIHMYWCAJVE,JDCHVFEE..EGGFdGAD..OAFBDCEGeBCHLCACZBGH.BAHEhAAA..fAAAhAAAREEB.aADAIABBhADAMIFGCEDA.AGAEKCGE........hAEA......hAGA...,2,-37,-27,10
RJQKWLIXbACDVaeBcgEMYPOFdTfSUHGNZ,CFCFVEEEBEHE..EABCMAIH..OBDCFAEA.dEAH..SHAGhAAAUGBF.HGEEhABANDBDRAGDKGHD..WBCFhACAIHEAADEG.DGAHeFEE.....hAAA......hABA...,2,-40,-25,15
KCTQNFZEafRLIJVAWYbBPGcXeDgOUdHMS,...bAADGACB.eFDHDFCBUAECHBADMCFHCDFG.TGAChAAAFEHFaAGELFHB.hAAAIDCAVEDFAHDHBHHHhACAcDGG.ODAHKACA......hABA......hACA...,1,-6,-32,26
dLVTISCAFWeagXbQUKYJROfMNcGDEPHBZ,eCCHXGBCQGAHKACH.RFCB.MDDGGBEFDFFCHCAFdBAGTGGGhAAASBAFAIFG.aAFGhAAAgEECUCGEOFEBhABAfAEFEHGABFCB......hACA......hAEA...,1,-1,-14,13
WgKLbVcTEYNRDJfQaZPHSIAMCeUOBXGdF,eHAGOGFABAACdCGHFBACKFEHLADG..VECDEDEERCADJEEA.hACA.QGGBhAEA.aCDHZEAFHBGBACDHMBDChAAACFCF...........hAFA......hAHA...,1,-13,-40,27
cJfbgLUaKAGPDTQHdCBMOEWZXNYVeIFSR,GDCCDAFBQEGACBAGBFBG...OGAAEBHFZFGH..XDCHhAAAVAED.IAHBhABAFCBDRFEF.fACFhACA.bGEG..........hAGA......hBAA...,2,-34,-29,5
GVPDENORBIcSFgafYWUTbeJMKdLAQHXZC,HCDBXGDCCGCBGBFCDEEF.OACHRAFE.BAEGSDACFGHH.hAAAaHAE..fHEHhABAUABAeFFEKAHDADDFVEAEhAAANDBA...........hADA......hAFA...,2,-24,-21,3
VNLgaQDHURSfEZWTeKJMBYXdAPbGcCOIF,GAFECAFBFHGE.LBBA.QEDDDCCDREEEEABA..ZGCATFABhAAA.KHFCBDGFdHAHAHDDhABA.PDAAOHACIACChAEAVADF.aEHDSAAD..hABA...fAHAhAHA.,1,0,-44,44
OQgEZaKMBASLRDcWXGFJIefUVdNbCYHPT,SDBDRAADDAGC..XDGDFFEHeHCGUECFdGGHCEEB..HGEAhAAA.OBEFQBAHhAAAZFAHKCDDMCIBACHG.WAGFhABAIACG..fAEE.hAEANBHE......hAFA...,1,-21,-26,5
EdXSYAeOGTBKcVCMFbRWJPgfDNaZILHUQ,GGCBTGAF.KFAHCGFE.MCCF..RBDFJAAC..PBDDDIGEZFDBLBAHhAAAHAFD.EHGAXDGHhADAAGCCBACAVDFDhABAFEAB....WDCDfAFD.NCIG.hACA......hAEA...,1,-18,-21,3
SfMcOGRFBIZHDCQVbKTJEXYPgNAWadeUL,aAFBdGDDLBEC.SGADMABDOGCARAADBDDGHDFDCCFH.QDCHhAAA.KHGEhACATEACEACAXAGAhAHAPEFGAAECWDHB.fCDBFGGGDADH..hBAA......hBEA...,1,-16,-26,10
CQGETScOHXANDPaLUgWbBJdIMFYRZVfeK,DACBLCCHUEBE...bAFABEGH.dBDFIEHEFAGG.RGEGZGAAhAAA..eGEACFEFGCAChABAEDFC.SDGChACA.OADGAIHENCIEaBAH......hAAA.WEAD.MIBEhABA...,2,-48,-4,44
PHKYGLTXJeQSBFNdRfcIEUDMbVWaZCAgO,OGEAHDAGKGGGLBFCJDFA.eDCBBGAAFEFGdFGBRAAC....IHHGhAAADBIFMADCVEAFhABAZACCADDA....YHCChADATGCDSBADNAEF.fAGFhAAAEBDF.WFEHhABA...,1,-2,-42,40
afSYMQDFJGLIcAZUXTKNeOgBWHbPVECdR,UDCBXFCAKAFB...OAECBCBCHGDA..bCBEECHHdABD.hAAAaGHFSADDhABA.MFAFDCFD.FFGGLFGFhAAAAHBE.NIBBWEAACEABYDFDJCHF..hACA......hAEA...,2,-32,-15,17
SZTGLMCKbFeNHcBYAOWdfPJVRgQXaDUIE,dDCDJGEA.RAEA..QFGDDBAAUBGC...SHACGDCFMDAChAAACFDHFFAE.HACBBEABOHCEhAAA..PFCHhABA...XACBIABCEEHBTDFBhAEAKGAB.NBIE.AAGG...hAFA...,1,-8,-37,29
TOYNMIVCLdWXgAGfHUBPaJFcQZeRDbSEK,GEDHUFDHBCHBaDCEFFAAZDEC..DBGG..SAGEKAEH.TGCHhAAAOCAD..MDAGhABACAACLACFXABDhADAAGCH.fBEE.PFHD.cAEAhBAAQGGA.hBBA...,1,-19,-48,29
YTBUQFdJLENMVPXKgGaIeRCSAZbWfcDHO,ZAAD..bDAG..fEFGDDGAHAADTFACBAGEFBFFLFFFhAAAMDDH.XGGEhACAKCHHaFAH.ICDHRFGF.hAAAAICAWEFEOHCAQFCC...hADA.ECDE.NCCE...hAEA...,2,-27,2,29
aBWAScNJTZUfYVReIQbEXDKLGMPOgCHdF,SHBGJGEAZCAF.UBAB..VCEHRAECeFHH..QGCChAAAEEDFKGFDGCEBOAFAhABAHDADaCDBAAEH..NAAB.hAFAfABF...ICHEhBAADEHD.MFIDCFFBBAHB.hBDA...,1,-2,-29,27
HSZeXFaYPAJgETMGLIKQOdbBDcUfVNRCW,EDCDGEDCKEAG.QGAFdGAABGGH.DAFEUACBVDFA..REEFHCGFhAAASCDF.ZBADeBAHhABAFHGGaBFEAGID..gGCEhADAMCCFIADA.....hAFA......hAGA...,2,-22,-5,17
IcHPdCAUQORBJGTbfLXKWEgMDFNVeZYSa,UDCHOADGRBEDBBAAGFCD...TCEDLEHDKBGA.EGFDDAAGFGAFhAAAeFBD.ZBBFSBDFhABAIHGCPDHFhAHACEABACHG....QGCA.fAFBhACA..hADA...,2,-36,-13,23
DaRJUHXLFGWBPdTNZKbSYMcOIQEACVfeg,VDBHeGEADCBA.RFAB.UGEBLCFFFBDFBEEAdDDCZABA..KGAHSDGEhAAA.MAEGhACAIBBE.AHCFCAFBhAAAfDAH..gDGEhABA.aFGF....hACA...,2,-47,-21,26
GTZUbYXdacBHMEWLfVFAIOKCeQNDSPJgR,KDCDeEBEQDGGDHGA..JFAAGFBFUGEE.XAFEdEHABABAhAAAMIDELHAAFABHOBEHhAAA.CDAHSGGChACAgAGCZBAAaGAC.EAEA.....hADA......hAEA...,1,-16,-25,9
FVCSeBIPdMGNcaYXQWRHfbgTZOUEKDAJL,FAABSBBDBDGFdCEAMFEFGGCF..aECDQFABHADFbEEF.hAAAZDAA..OCHBhABAKHGAAHABLFFACGGFeDABIACChAFA.PHAA.cAGFYCBAhACA.....hAIA...,2,-22,-9,13
KIdgCUQROVTDYZMJXHASNbcGLEPeaBWfF,SHBG..cEBHEHEA.aDCGfBBC.FEEFhAAAKFFEdADDCFDBUADAQFCHhABAOHCATEAGhACADDIDMIAGHAGFAGBHNAAELDDCBAGG..IBBEhABA....hACA...,1,6,-41,47
VXPLWaAQUKfbYNRedHECDcJIZGFTMBOgS,QFCAKGFC..fACG..bDAGRCGHdFCHEFHHDACDhAAAIEABFCHDBAGESCEDhAAAPFFF.aAGBYCDChABA.NIAF.CHHEcBAH.JHBE.hADA......hAEA...,1,-25,-27,2
BXVUMgCJWdZKRSHcFTfEIDaPeQAbYOLGN,OGEAGECFBHGEUEBE.MEBD..CHEEdCABRACHHAFHFCHH.EHCCDIBA.hAAA...PBABhABAAAHBLAFBNEIA..gCEDhACAZBDFSAAC.....hAEA......hAFA...,2,-39,-10,29
eXGbWEHBcVNDaCZFMRKdPYJTLAfOUISQg,ODACSGFC.QACDXFDAGBFCEFBFHDFCBABGNAEF.hAAADAHFZFDBFGAD.MIEChAAAKDDDdBFH.PCADhABATBCHAGIF.IGGE.eEHB.bFBB.hACAcADF.CEEC..hBAA...,2,-8,-5,3
BQTeSDRaKUcdLAEHbCIgFJMNYGPfOXWVZ,ECFCCFDDFCAB..MHFCGBEBOFBG..VGFABEHF.QBADhAAASABEaEABKFABdFGDhABAHDDEIHBH.hAAA.NIBB.fBDE.WAHBeAFE.hACADFGE.cBBAAEEG.hADA...,2,-24,-16,8
fEeFJATWKNXPIUbYQDcLZOdHRBGCaSVgM,KGFCXCBCUGCE...QAAHLABDOAFAdEECBCHCCEFH.aDFDhAAA...SAGAhACAMEAEeADDJECFAFBF.NADH.hBDA..bCFGDIGE........hBEA......hBFA...,2,-36,-25,11
REGXTAgbcSJBCMUDYHZVKaFNdeWfILPQO,...bAADJCCH.MDHHUAFGHFDAKHGEFEDEdDAG..eHAG..IHDGhAAAQBEBRACHEEADhACATAAE.AFFGSGAEhAAADGFHZCEA.NAIA......fGHAhACA..hADA...,1,-21,-23,2
aCKcZeAFLYdbfMJPODWGNXQRBUEgVSHIT,LCCHdHBHMDDG.JBHFDECC.GDGCQGBDBCAH.EAEB.SGGGhAAAIABACAGCKEFAZFAEhAAAFABE...fBAEhABAOFEFXAEDgCEA...hADA......hAEA...,1,-16,-32,16
CPOdBGTXbQJZRDeKNgYEUaFSWMALcIHfV,LGEAHAADCGACdAEHGABH..TCFGbFAAZBEGREFAKDBA..NAAE.hABAECCE..FEFCSGHDhAAAAGIH.IBHChACAfHABOFCBBAFB.....hADA......hAFA...,2,-20,-20,0
BGQfMTCRWLaeVKIbHcXOFPdDgUYZNJSEA,GCEHMFFFRCFC.LGBG.VBAGKGCAIBABHEBCOFGBdEAEUGGGhAAA..NDAG.JCCBhABAAABCBHHE..TAFEhACACFHE...WHAGeBEC..XADBhAHADAIF....hAIA...,1,-7,-31,24
aRScCgLNIGQOXEePHJfMAdVZBFYUKWDTb,VBCFFBBDUAFG..KFGCDGHF..aCGHRDBA...CAEELHDEhAAAGDFEOFDFEAHD.eADBhAAAJDAFACAEBHBG...hABA...YFCGWCAD.SGAGhACA.....hABA...,1,-23,-40,17
aYHFPAMgOELUdfTIQBRCKXSJcVeGDNbZW,OCHDEGDDdFAH...TDEBBFGHRCEG.CAHE.KFHF...XFBAhAAAJBAC.eBCGDBFGZDAAhAAAaDAB.FACAAGFHMBECLGFAhABAfHAH.IBAC.SGGDhABA..hACA...,1,-29,-34,5
IXEOMCNTgYJdRLSGeaABQHDcfUPbFKZVW,BFFCQFCAHFBADGAFUCFGFFHDKCDHZBAC....IAAHhACAOAEEMEAACHGG..gACChAFAJHDCdDFF.SFBDhAGAaAAAAICA.fAGH.PFFAhBFAWBFA.NIBF...hBIA...,1,-28,-31,3
QBFZJdDHfbATOVXIgYceMRaEGCNWKPLUS,OADGXFDH....IBFC..YCHDeDEGaBABhAAAECDACBCE.KACGLAHFhABAQEAGFGDAdGGCDAACbFFEhAEAAIEG.TAFFgCAHMIAENIEF...hACA......hBIA...,2,-23,-8,15
QVHNLfEAgGBKYDUadPcebFCIJZMOTXRSW,GGDHKEGDDGIH.aAFHdGAA..eDGBFGDE.CCDFZCAF..OCAB.hAAARABH....QCEGhAAANIABfGBHAFBABEDDhABAPABA.IEEHMIEESCHFhADA..HAGD.hAEA...,1,-9,-40,31
dDbWEBVQTcZLXfAMUeKgJPGHORFICSNaY,MIFGUGGDeAACKADG...JCEGHCEE.RGBGFFGCCHBG...NACA.aEGFhAAA.DAEGEFAF.BDAEhAAAQFBA.TEEGhAHAcDDC.XDGAAEBD..gCCDhAIAOAFA...hABA...,1,-26,-30,4
ZMPFORfWQDYaKGACUBSHENeJdTVgXLcIb,CFFGUGAFBBDEEEHF..eBAGdCCC....TGEBVGAGLEEEhAAA..IBADhAAAbDAAZAFC.MCFD.ODGBhABAfCFBDAEGKBGCAACFNEIAXEBC.hABA......hADA...,2,-28,-22,6
LRPMWDUEgZYVaNATFbJBGSQXcOeKdICfH,FGFCJAFBGDBGQBEE..OHDAeDBCdHAFCEEE.LBAAhAAARBCB.PFACDABFEEGEZDEEhABA..aGGFAAEHBEHAhACASDGE.KAHD...IDAChAAA.MACA...hADA...,1,-18,-22,4
CBPAgRZMVbaWUITDQfdXcGKEOLFYHSeJN,RGFGVFBG..aFAHUCDADGED..dDCCGAEHKHBA.OFGBFDAFHAAEhAAASEAF.JCAChAAACEEDACGB.MDHB..hACA............hADA......hAEA...,2,-36,-33,3
UWZadPDTVOIEHcRSCgeGJLAQBXFNMKbfY,XABHFGFHMAAA.KDBA......bBCCUCFHZEAF.aGGADFEEOHAChAAAEAHD.HFBESEHFhAEACBFBeHFELAEChABABDEDfHCFdDDA.PCFC.IAFFhAIA...hADA...,1,-13,-21,8
XYcOgGSaQLMPZdHWFeRCADNBEbUKVfTIJ,DAEDEEGDKFAE..VDEH..ICEG..XDCBhAAAOCAESHAGhAAAaEHFLDABMDIFZGBEdHFDWEEDhABARAFGAACCBCGG.fHCB...hABA......hAFA...,1,-26,-33,7
GAPUBXSKbfZcHdeDRNgJOTVEaFICWYLMQ,BHHGSFHBKDGFZBCCHAFE.DDDGREAB.JFAHOEED..EBBF.hAAAFGEBCAHHLABEhAFAGDBCADAF..XDEAhAAA..fGCAdGGGNABD.....hAHA......hAIA...,2,-45,-13,32
RKcIXbVMFPWDTJaNHAQOfZBgYELUSCGde,QDACOFBBZDEEBFGDEGDCLFHF.CBBFGCDFeCBDRADDKABEhAAAXACFMIFEFAGADBIHaECDhAAAHGCE..AEEFfAEFhABA.YHAA.dFFAcAFChBAA....hBBA...,1,6,-28,34
bZFgRVfKUXcGCNHeLMWJQSaOYBdPIETDA,ZDAGFCFCRFFBKBCA.UFDHGEAA.HCCFLBFBMBAA...JFABSAFGhAAA.OHCAhABAdGHEIABEhAAADACAAIHG............hADA......hAEA...,2,-46,-21,25
KUAaedbOBDfRPVLSWGcMJTHYFEXNQgZCI,aEEDdDCDOFCGBEDH.DEBHRAEFLAGB.GGEBMEADJBHBHAAChAAAFABDEDCH..QGGHhAAAgEADZADECADBKGCBhABAAFIB..eFEA.fHAH.hAIA......hBIA...,1,-10,-24,14
LBMCgRaVQKOdNGbWeSZUAPfIFEXTYDHcJ,..IFDGEFAA..XCGADFABHCAAJAACBFFD.CHEARCFDQBDAhADAdGHAGAAFbFGF.hAAAeHCASCHBhABAZGAEAFEA.fAED..YAEChAIAMFCBaDCEKDDD....hBAA...,1,-7,-18,11
AeBJFHCWgaOZUDfVRGXEIMPTLcNSKdQYb,eEGHFDABCGEG...aBFHUBCADDDF...REFB.EABA..MBIFLFEDhAAA.NEBA.KGADQBCDhABAABAEBHCD..JBGFhAAAWCHB..OFBGfAGA..hAEA......hAFA...,1,-30,-48,18
CKHTFAIZQXYcgbVDOeBNPSWLERMdaUJGf,QFDHXCBC.....gCGBbFGDOFDEBEBESCFFhAAAECAHMICGaABCGABDhAAACGBCHAGDAFAAIHGHhABAYACC.VCDEDCCENCIEWFFE.dAGF..hACA......hAEA...,1,-6,-8,2
IfADHRJcSXLKOUZCPFaYNGEebVQTgdWBM,RBCFSDCDLHAAOFCAZACEFFFE...aGGBGBEH.eHAEhAAAQCEDdHEBMDADAEIBDEBHhAAAHDDDJAGH.KABHCHHGYBAHhABAEBAB........hACA......hADA...,2,-23,-8,15
WbAPRBYGVDScKJHQFLICUdfXNgMTaeEZO,BFDDGEDHSAFAKDCCQAGBFCFHLACHCFBG..dEHEXGFEhAAAMHAAeACCOCHFhABAAGDA.REAF.DIDA.HAABhAAAIBBCfBEENIBH.aGGCEEEB..hAEA......hAFA...,2,-25,-5,20
eLdJHBfNGaOXYMRIVDKAUCZbFQgPTScEW,UGDCZDBHFEEHQCFF..gBCDSFBFEBGGLACHhAAAHFABBHEFGAEFhABAXDFEMFHBIEDEhAEAKAEEAHGGCBAC..........hAFA......hAHA...,2,-23,-23,0
KcURPLdVAZYMFgGfEDeTQJCIXWNbBSaHO,ZFACMHFGFCCFGAFADBCG.QEBC.JDCACEHDXAEBhAAA..bEFAaHGEOBAEhAAAKEDB..RCECLBAFhABAdADH.AHBE.fHBFEFFDeHCA.IAHDhABANAIE.HFDA.hACA...,2,-23,0,23
HTNdVFgCYUfRPBAQXbSWJLOeEKIacMGZD,QCGCSGFCLEEEEEDB.aDBAMFABZGAA.HFEF.dCBAhAAAgBGHCHHEUBDEfFCEhABABEBHAGCAWACGhAAA...eBAGKHBG.IHHADAEG..hABA......hADA.NAEF..,1,-9,-25,16
BdWaGUTgHDCNVOISZPAeJcRMbFXEfYLKQ,eEEGJFBB.RGBG.MDBEFEAH...EDGFLBBEBFDD.aDGAGAEBhAAAUGEC.TABCDDCDCHHE..hABA.OFGFSAHFhAAAAEFDXDAC..KEDD.....hADA......hAEA...,1,-25,-29,4
ceECaWQRfBKZAUYTGPbNOFJgHdIMXSLVD,UCGCTFGHGACG....PCCFOEEFFHDEHFABdBGCIFEBhAAASAGAVFAGhABADEADEGGA.aGDBWAEBhACAfBAEBADDKDHBADFC.......hAAA......hABA...,2,-23,-16,7
gVaSbdIMUQKLHJFAETRNecPfXYWODZBGC,RBCFeGEA....fAEDXFBFOCAEBAGBCGHE..aBAHSAEEhAAA.dAHAhABAIGDAUDGAKDEBJCEBhAAAFACFABCFECHHNIEF.PEBBDBEF...gGFBhABA.MFFEhACA...,2,-37,-16,21
JOXKBfcLHeUQRISYVPgZMbEadWNACDFTG,CFEATCBFGCBH..JFEHKCGE.BAHALAEGHGBCUACHQDGFhAAA.IGHDhABASFHHVGAG.ZFFFEAAHhAAAaADH.dCFBAAGEDEEG.OFBG.XGFDhADAeCAD....hAFA...,2,-26,7,33
gLfJDKQeHSObAVcNUBRMEXIGWZdYaFCTP,VAADUCBCMDIH..EEBAGAFCZFFDdBGAFFAB..CHAG...TGGDhAAALADFDCAHKEDHhABA.eFFFHFBGSHBChACAAEHCBHHEIEEEaBDF.fBEEhAAA.....hADA...,1,-18,-22,4
IWeaKNTMAdBDOgRZfbJUQGFPCXEVcYLSH,dFGEOFEDZAAD..JGCEUBAA.FFAHCDFA...EAED..VEAELCGDhAAA.HDCC.hAAAIHHGaAGGTCCHhADAADHBDIAG...........hAEA......hAFA.fBHE.,2,-38,-28,10
ISbfZdOVcXaHNUGKQRCEDTLJePYFMAWBg,BFDGSHBGZAFAOBAA..VDAC.aCGEUEFF.KBDBCHFGEBBAhAAADCGFLDAHhAAA..JGFCeHDAYFBGhABAAAHC..IHHGbAFG..fDDBhACAXGAA...hABA...,2,-41,-21,20
IKNaQJDcTZESCVOBFXeUbPWAHMLRGfYdg,LAABREBHGBCFdFEAKHGEQECFDABG..ZEGBEBEFCDEABAHEhAAAFHBAeEAH.UCGC.hAEA..PACGAHDDMDGHhAFAfFEH.ICCFNBBE..hAGAcAGC...hAHA...,1,-18,-35,17
OXcSUVfINJRWKgDPdbLYFeCMTBAQZGaHE,ZACFaCAHHECFEFEB.OFGFSBGD.UEAAIAFE.RBBCKBHBhAAAgAADdEEBLHBAhABAeAHDCHHHMFIHAIBEXFCDhAEA.fEEB...hACA......hADA...,2,-17,-15,2
ZCaOILWMGKHXfQdNgJPYUScTbEVeDFARB,BEGHaBBDLDGHGCCHHEAA.QGGGdGADJFDEUAEDSBCChAAA.bGCGEDDCDAHBhABAABAECCACICAGKGHB.hAAAfAEB.......hABA......hACA...,1,-1,-39,38
ReWbICMHgXcYFLJTGdSKZQBVfEONPADUa,aDABRFDFeDAD....bFDGMDIH.HDFHXCGBFDCBLAAEhAEAGCCFKAGABHHAfGHChAAAEBHHOBEHNBBFDABAhAEAIBBF.CFCH.cFAE..JHAC.hAFASHFC.hAGA...,2,-24,-1,23
eXNcdAOHVUKEQgLZMRTaCYFDPIBWGJbfS,ODACVBCD.UCGDQGBCLAACZEFCREDB...aACACGBEDFACBGDBhAAA...JHEGSBBGhAEAXAFCdBAAABHCKGGChAFAECFA..MFFE.FHACWBHH..fHEFhAGA..hAHA...,2,-31,-13,18
cUVXABKTdQPNLDReSbCfZOFgaIMHEWYGJ,BFCFTFCEdGHA.QAFALBAAeADG.SGFAhAAACHFEOBCEFEADICECHFDEEHBGhAAAGAGEUBAEAGAAKEEHhABADDHF....fDDD...hACA......hAFA...,1,-18,-21,3
ULDSKgARWOfbZYIcHFNTJBPGVQeXadMEC,RFDFOGEAZEAA....IAACHBEDNICFBCCDGDEF..eAAChAAAXGGEaEBE.dGAECGBHLAHDhAEASCBC.hAFAADDH.WFFEfCEF.YACEhAGA.FAHF....hBEA...,1,-20,-21,1
QGdVbTFEKfXZJMSICaDUOYNegRPcLBAWH,QFDHdCAH..bDDDFCDDKHEEZAAC.SAGAaDFE.DEHHhABAOFAFeBFBRFABLFCDhAAAADAB.HAEA.hACA............hADA......hAEA...,2,-31,-29,2
ELCZAfVgUeFaMbDTRGJcWHPNBSOXdYIQK,VAADUDACFFDC..aBGFDCEH.GAEH..JGEEHCGDBEGBSCCBhAAAdHAF.QGFAhABAKAEFEDDAZFCHAHADeACChACAMDAB..........hAHA......hAIA...,2,-35,-19,16
FXPcUEDRLVCHATIYGZedbWQagSKMfJNOB,TCBCGAFEZAAC.dFGEQDGA.aFEDgCADhABAKADCJECGBAAFXFDC.hACA.UGBCDCIBVFAFhACAAGHGYBFA..WFHHSGGGNAEE.hADA.FHDEEAGE.CBCB..hAFA...,1,-13,-14,1
JeGFIYOaEBNWUXCZQDSMLcKfbHRAgVPdT,VAADTGBC..eDCAFDCC..OAEABDHHUAFGCGFE.DHFCSBCAhAAALFBFKEFFfEGEhABA.bFDHAADC.hAAA..dCFFIGDFaFBG..WDAF.hACA......hAIA...,2,-39,-16,23
LRVMKPNCXaQOUcgbZYGfedDHBWFSITEJA,LDACMGCEKFAD.CBCB..QBGGOADGUBBG....cEEAhAAAZDCEGBEF.hABA.eHFEDIEG.HFADhACABHHBSEGEIHBHJFFA.AABA...hAAA......hAHA...,1,-19,-31,12
YfBDCUbVeLRdHPcGaINEFOWKZgTMXJAQS,SGFCBFDGDCAEUAFGeFAB.LDCGHDBAGEFCaABH.EADHOACFhAAA.ZAEGMBIBhAAAAFIHfGCECHHE.hABAbCFBdDAC.IHBHNAIEKCAD.....hACA......hAEA...,1,-10,-24,14
MgSdAFfXEDNaeLQRUJcVKCZBTWbHGYIOP,XGBCEHFGDHBG..eEEGLDEG.QAFEJABDKAFDCDCH.BFCHhAAA.TFFFHBGHIEAEhAAAMCBASHFAhABAABADFFDF.NCACaDBB.......hABA......hADA...,1,-10,-36,26
QRdWYZPEagBfJFLcNHbMIOVCTXDAGSKUe,KDAFUDCHeHFCQCGHRBBG.dACGZFBHEHGEBDFA.FGAFLGFEhAAAHEFC.IHAGhABA.CGCCDICESFDDhAAAPAFA.fCEF.NACF.MDBB.hABA......hAHA...,2,-28,-13,15
KOGaTRLWUMBIAcdNHQYZSbeCgfPFDJVEX,dHBHQFDHZAADeBGHCHBF.....fEHGDCGGEBECOBBGhAAAaGGB.RDCCUGGGBECBIEEDhAAAAHEBHCAE.SAFChADAPEAB.JCCA.KEAD.....hABA......hACA...,2,-21,-19,2
IEGbgRNDZAYcWPOfeKJFVSTBdHCMaXULQ,......YFCAcFCA..OHAEKHFAFHAG..TFFAhAAAHBBEMAAFUABFQAEDhACAEDDEGAEFREFEDIEGhAEAAIDEPDADfCCG.JBHFBDHACEFFaFHF.hABA......hACA...,2,-13,-12,1
COMageRAUGdbSLWYEPcJVDNfZFTBXKIHQ,GCEBdAFBSEFGLECF.EFGEJDBDDAFDZFDABEEC.KBCDHBCAhAAAOHEEMFID.aBHD.hAAAeHCGABID..WABFhADA..YABD..PEAF.hADA.NEAE.....hAEA...,2,-26,-18,8
fBNGCRgWdQAaZPDKHJIEYSULcXTFVMbeO,aCFCDHCEHDAB.JGFGEDDG.UGEBLEDA..XFGBhAAAFBHHMACCeECFBBABCAHHRACGdCCBhAAAAFAEKCAC..SAGFhABA.........hABA......hACA...,2,-32,-31,1
egFNMBKSLVAdEcQPfHaCYTUWGDJZXIORb,dAFBQGBCHAACCHHEUGCBDCEDZGFA..ODCCeEBEFDGD.BAHHhAAASCFEACBG.EEAHhAAAfBFB.hABAaGDD...WACHXGFB...hABA......hACA...,1,-30,-36,6
cHROQYMWSDUPFeKGXCJdNfVabgELZABTI,TGGGHAADQGDA.MCHDSFDFDDCHUDDAPDAHhAAAKFADCDAD.dFGB.VCFEaGGGEBFAhAAAACCDIGBB.hACA.cGADOBCG.WECE....hABA......hACA...,2,-24,-11,13
XULEaTCdOVIgPFMKBcWSDZQNRAHJbfGYe,HFDFJGEAGACGeCCCXFGALBFC.aHBCCHDB...dCAGOEBBhAAAICHAFCACBEEG.hAAA.WBFHDFIFQCGGhABAAHAB..fFBG.EAGEhABA......hACA...,1,-22,-29,7
CBPcANSUaLMDHdJfIOYTFbeQgGRVEWKZX,UGBCMEGFHEDDdEEF.JCDEOBFG.FHGAQABA.RBGHVEAFhAAAKCDGXGDAhAAA.BBCGAIACaFHHDEIDfAEBhABA..IEAE..hABA......hACA...,2,-48,-10,38
NBOZMCXKEgUaceVdPLASGTFYRbDWQIHfJ,GBDBFGFCRDBG.DDGBQAAFHAAC..NIEFBFECMHAA..CFBDKCFChABAEFAE...UBDEaEHHeDAAhAAAdEFDADAD...SHAGhABA........hADA......hAEA...,1,-25,-36,11
XNMbVRLISBAfQCHOJDETaGZgKPYWUdecF,CHHGJFFCDGFC..EAHDGGAFZFBG..KHCE....PCCBUCFHdAEHhAAAeBACFDBC..MAEHhAAARBBE.SBFDhABAAIAA.fAGA.QDGEhACA.ODAFaFAG.hABA...,1,-15,-36,21
KdPNXDIEOCAVeLfbQacZGFWMgHUSTBJRY,LFFCQCBCaEBAZBFEGAECFAFG.MBAGHECE.TEGCBBHCJCAEhAAAKBDHdHDF.PAAEhAAADAGCEGBB.AHGF.eDADhADAfDGF..cGGEgGDGhABA.SEAGhACA...,2,-26,3,29
QWTJdXPcIfBMKAYLNOUHeDGZagVSECFRb,LGEAODACHDGDGCAGZAAG.aDDCSFDHEHCG.FGAFQADBhAAAJCCGdGFE.cCGHhABAIHHGBAGAACID..hACA....YAFE....hAAA......hABA...,1,-18,-24,6
YNOdbLHMaKPAfXEURBJTDGgWeQcCZFVIS,EGFCUGDCRECD.BDHC.DAHDGAEH.eEADQCBCZCCEFBAB..hAAASHEG.hABA.OEFFdCHELFFChAAAMFBGPBDAAIHG.fDEF.hABA......hACA...,1,-12,-43,31
XYMULcGREWQCfZHKAIFaPbJDgSTdNeOBV,FAFBaHBG...JDCDSFFA.dCABeGFEBECAXAAHhAAA.MIFALAHFhAAAGGCHRDAHWDDBCADF.HAEFhABAIHAGDIGGNHEFOBBAVBGF....hACA......hADA...,2,-24,-18,6
YRIJOSFgbBPZHLWDVNMCUQeKdGTfacEAX,REFHJEEGOAFB..FAACBGDEHBCHDBAEMIAC..CDDD.QFGDhACAdDBCGAGEaGBGAGAE.XGDEhADA.SAHFhAEAPFHD.WCFANIBB.KAEG..fADAhAAA...hAGA...,2,-37,-22,15
BHEIeaRcUPAWNXZLgbVGDQOCFTJKMSdYf,XCBCZFDFLFFG..VGDEDBAGQAEFCBAC.TBCAhAAAJADHKEAF.MAIDSDGHhABAdHABBCGGIHHEhACAeEECaGGARFADcDABACFH...gCEAhADA...hAAA...,2,-30,-9,21
PKZGUdDNYFQTRaSeWJCbEMIALOHgBVXfc,HFBGVDBH.XDEB..PBHHKAGDUAAFDGEC.FADFREFGeHAEhAAACHHG..EHDCABCBOAFHhABABHAG.ZBDFdGFA.YCHFhABAaGDCSCAF.....hAFA......hAHA...,2,-22,-14,8
UQSCfFPXedEgAWaBbDRLGOKYHJVTIZMcN,BFEDRFDGGCAGOFHBHCCH..JBGHVCFGZDBB....MBBGNIAFQAADhAAA.CHGEFAFAhACAPBED..eEEGhADAEAGGAAACaFCHDCAGKADGIDAF.SFFBhACA...hAIA...,2,-38,5,43
COXJHTQGNRKSLVceEWFgfYIDMbBZUPaAd,OCAFJADGHFEHGGCHKGCB.LFCC.VDGFECDCFBGH..hAAAfACFDEHDBHHGZCABhABAaCEHdAFDCEFB.XGADhAAA..NAIESHAG..hACA......hADA...,1,-8,-34,26
NJSEDWMOIPCYKAagFLcGeBXRHVfQZbUdT,aAFBLCCHGGCFXCGAHEAB..QACEUFFBdAGCTDADhAAASEFB.DDEHMIFAhABAICAACHBEAFAD.FAHBhAAABABA.RADB.fCCENEEA.WFGHhABA.YDFC.hADA...,1,-4,-20,16
XdEaeQcACGYSbLRPfWKIOTJMHNFBZgUDV,CECDSGAHRGBE....PAAFKCDEIGEG.OCBDhAAAMAEGFBFDBBAAUGFFhAAAVDEGdEGB.eDCGAFAF.hABA...YAHHfAHA...hACA......hADA.TGGC.,2,-30,-27,3
YgXSVZdacHePUbFKWLGNfTEBOMRCQDIJA,XCBCVBCF.ZCFBdAAFHDCCUGEG.KBGGGFBB.TACFhAAABHDFMEABCAHADEHHAICC.SEAGhABA.aHAGhACAcDGD.PEBFWEHH...NADBEDFFhAIA......hBBA...,1,-1,-39,38
SFLVKCQTdEbgPfaMRBJGUZcDeXOWHYANI,SHBGFDBDLEDFCFBA.QBAC.EAGDbDFB...fBBAhAAAMFADBHFFUEDGhABADFGAXACAhAAA.OFECWHECAHCENDDF.KBEC.dDAH.aAHF.hABA......hACA...,1,-22,-24,2
NbDTJFGRPLSIfaUgYdMCBVWHQEKZXcAOe,OEEGeGEADCBA.FFBARAECLCBA.SEABIEGBUBEAhAAAdFGBMIBABDBHHGDChAAAEHAE.KABC...cCGAhAEAAHHDTBGH.PABAaAHFCHGA....hAFA......hAGA...,1,-5,-38,33
IXCFNZBeLMfbATaPOYScgDHdWEVRUGQJK,aGFCOGEA..SAGADAGCHAEDdCACEBCG.RDFEUDCBGCDFKBGHIEGBhAAA.CBAFFFAHhABABHHELEBEMIBAAIGA.hAAATGCC..PABAcCAG...hBAA......hBBA...,1,-7,-27,20
KXBFZYPeVLWScgfCbTdEMNODQHUAGIRJa,GEDHRFDFKFAGBBEEFHAEZAFE..eAFGLCBB.SAAEhADA..fDEBhAAACHGHTCGCdGGBEABCOFHBhABAHBDFAAGA.IECHaEAB.PHAC.hAEAcDGA...hAFA...,1,-9,-30,21
SFKdXaIfOAYDbNgHMWQRZEJcVGCTBLeUP,DACB..gEBHHEDDQADGRGDGZEECEBFEVGFE.GBAGhAAACDAFBACDUCGEFHACXCDAhAAAIAHCAFID.bGAANDIE.hABA...MAFE.......hABA......hAFA...,1,-10,-15,5
JARZWHgYfcPbNLOGMFKadIUXBEVQCSTDe,RGFGZGFGHDDH..fGBC..PABALFDCMIDEaBEGhAAAdCHCUABCBBGFQCEDhAEASCDCDFAAAGAFgEBEhAAA.cGAENAIE.FFGA.hAFA......hAGA...,1,-12,-27,15
JFdSKHTAONCUQfBMDWVgZGeRYbEPaLIcX,OAFBUGGGBCAGDBBH.....VFDFGCFGRAFC.EHFALDDEhAAAIEDG...XDAChAAAdEBEKEADACBGNBIC.CABCMCIDhADAZABF..eGAC.PHCA..hADA......hAEA...,1,-21,-31,10
ISBVaCdWUDNfAHEPKRgYZQTbJMOceGXLF,HDAGEAFBKDBBREDGZBAG.QGCGJAAC.ODDAGADE.XAGFhADAFGGE.BDFGCBFEdCHAhAAADFGGAAHD...gGGAhBAATGAE.MGDALABE..IHDDhBIA.SDDDhCAA,1,-15,-26,11
WRGgZQIUMBdEDaYfHeAVbKCXFSJcOTLNP,VDAGCFEDFAEF.....SGDGJDCB.OFGDTBAALBBChAAA..PHAChAAAWAGH.GGEBZDFAUGAEhABABDGBdAFEDEEG.aAHD......hABA.fDAEhACAAIDGKEDA...,1,-10,-44,34
JNZTcUBRIEXDeVCFYHfdSabPKWLgQGAMO,JAFETFDHBEDA..RBAC..EFBCeBCH.FGGAHAFA.SDHBhAAAaBAD.KHCGLCHHhAAAgCDCQCFGhABAAGHGNABB.ZFADIHADDACACGFD.fGGEhAHA....hAIA...,2,-28,-16,12
NEYPLCIFQRZbcBHfgMXJSGUDKaOVTWAed,dDCDEHBGLFADCGAH.FHFEZGDGBDDCHBEH.MAIHJEEG.UAAGDCAD.hAAAKEAF..aBCGOHFEhADA..TFCChABA.ABBF.eCGF..PCEA...hAEA......hAFA...,1,-29,-30,1
JQGZNfSRCXAHgYWEaMDTFbeIOKcBdVLPU,HAAD..gCBCEHACDICEFEHHeAAGKCDGBADAdAEALFFHhACA.JFHBQBGChAAAGEBEfDHChADACFCGXEEGYFDB.MEDG.IAGFhAIAODAE.....hACA...,2,-33,8,41
UPFLaXTKSHJgOVdQEBGYNWMACbDRZIfec,CAEDRFDGZCDE..eABFUFAEFCEBLBCA..XGCASCAGhAAAHFAE.OFHBhAAAQAGEEDFCBGFGNABBMDIDhAGADIBEICCF.fAHAhABAcGFDaDFEKDAD....hADA...,2,-25,-13,12
CYWTXaVSZRbgfEMeIOULHQFdDKAJcBNGP,JAFBBFDGGDCBCEFE....TCBBaDHDZFACRBGB.....gABBhAAAMFIBeHAEUGGEhADAQABDDCHBAAID.hAEAcEAA.NADB........hAFA......hAHA.WHBA.,1,-24,-29,5
fIWLKPJHXVZAdNMBOgEYSDUCFaQRTGcbe,dGFHMBFHOEBB..EFGFSDDFDEBBCDHD.FDGCRDCHGABChAAA.eHAEfCABhAAAIADCLABEhAFA.PFDDXAGCACCGgAGE.hABAaGCHTGDAWFFE..hAFA...,1,-15,-27,12
ZeIBPNTVDYHALObadEMQJcWXGKFSCgRfU,LEEGaDCD.MCEEJHBE....XCGBFHBACAACRGEAZAFABCCC.hACA..TAACDIGAAFDDOADBhAEAEAEA..WEABhAAASDEE..UEEAIBBDhAGAPHFC.....hAHA...,2,-33,-29,4
ENXHKIeOgLBDMQYGdScfFATJUWabVPRZC,TDCHJDAC..UFEDaGCD....VEABRAFAECFDHFFE.KBBHeBBChAAALCHBDCIFMABEhAFAQAED.YAADhACA.SGEDFGAGAIHA...hAGA......hAIA...,1,0,-39,39
TcRfdMeQDHECXSgYFUOKBWNLIVbGAJaPZ,aDCDTFDH..RAACMGFEQDAA.DAGECCGD..SCCFhAAAFGHDOADFBDADLHDAhAAAbGAC.JDFAZAFEdABEEFDAhABAXBGA..YEEC..hADA......hAEA...,2,-26,-14,12
WUSfdRJFBAYaNHbLXEVIPMGcZKeOCTQgD,aHBGHAADLABCVCDH..MGCEGDCBZADCeFFGOFGD.TBCDhAAADHFCSHAEhAAAdBFCFFAGAIEA.NBIG...XCGBhAFAEEAC.IAHFKHDACCCCWAGH...hAGA......hBAA...,2,-14,-1,13
XLAdGUYSKJBNVMZQPaOCbRHWgEfeTcFID,GBDBSGFCBCBFMIFEZDAAQFAD.OEGDRADDgDGFhAAAeHDA.TBBHhABAIEEGDGCDAFBC.UDDHhACAJACENAIEaDAC.CAGH........hAAA......hABA...,2,-21,-16,5
YIWZSeLEKXUcdBMfbJgVTaRCHNFODAQPG,QFGHGAFE..IHEFZBFBSBDGEEEDKABE.XCAChAAAdEBHBAEEMEDH.fCHChABAgGGHaHCChACACBCHFDHFAGAA..WFFD......hADA......hAEA...,1,-22,-29,7
EFHNXQUOecRWYbMfgKIJSBTaCAZGdDVPL,GBCHDEFELAFCEEFDFAAEHDAG.QGBEOBHDRGAE...YFDChAAAbDBC.fFHChABAKGHBIAGFBCCEhACAaGDDABDC...........hADA......hAEA...,1,-17,-24,7
ZPFSKTNOcEXVUMdDACYIaJbeLBfQWgRHG,CFDGaHBG..JCFELEBE.QCFARBBCHEEHZEBBSHGEhAAAKAAD.OACDEAEA.hABAXCACMIFGdEACAFADIFGFhABABGHG.fAHEWHBA.PHDChACA.NGBB...hAEA...,2,-28,-19,9
RWHgYDeAaOCZQTcVfKbNLXMPFSUEGBIJd,CDGFQDCB..TFGBVAAFKEADLBBE.MIBEPEGBhAAASGAGUADCBHDDhACAJEEHdEAHHBGBDFDBAIFAZFBEhAGA..fBGF.NABHXCDAhAAA....hAGA...,2,-31,-9,22
dTVADecSKRagFGEBLWXbOZPNMfHICJYUQ,DEFHSDCDKFDB.RAAC.aCAHGEDA.LBEEXAFH.ZABChAAAMADEHFABCFHEJDEAQCCHhACAdGGAAGCD.eDHHhADA...FGHDBAHBWHDG.....hAAA......hABA...,1,-13,-25,12
CbVLKAQMIeXOUdWEBSgJPaGYRDTcHfNFZ,MFFFeDACOEFAdAFGBDFC..SAFH.JGFCaACBGECChAAADBEHHDGDFADG.CHAELBAFhAAAAACHXBGDEBGG.hABA..PDCF.......hAHA......hAIA...,2,-27,-26,1
DXGdeNFgHcKWTELaAQUBJOYCZIPfbSMRV,BCAHJEEG.OBFECDAF.ZDAE....PGDESGAE.hAAAMDGHVEBFDHFGdAGDFBBAhAAAHABCKHDA.ECDCAAIFQEDEhABAUGGE.IDHF...hABA......hACA...,2,-30,-29,1
MSUeOcANYfaIXBHZKQJFEbVGDCPTdgWLR,...fFAFaFFBBEBGKBDBFBEH..EGFDVAACDEGB...CHFA.PBCDhAAAdDHGLGAEhAAA.MIBGeAEEADAE.ICGAhABAZAEF.JDHB.......hADA......hAGA...,2,-33,-26,7
WBbVXAaRHdgceIOGTJLQESfNDUYMZPCKF,RBCFHDAGdGHG.eCHDGEEATAAFQFCE.EGBBSGAAhAAA.DACAUAGGMGFAhAFACCFGFEABWEEGVAAHaBFHIBDEhAGA........hAHA......hAIA...,1,-11,-19,8
gVYKBXOCbecJGQWUPMaELATHIZFfSDRNd,HEFHZDAGSHACRFBFdABG..VBEBBCCFOAFGCFBA..eEGHhAAAJDBA.QBFDhABA.PACCaEAHAIFCFADBhAAANICH.KFHB..........hBAA......hBCA...,1,-19,-28,9
GdaHcQeDERObACXNFBfSMIgTWLKZYVJPU,XGGGBFEDSBFH..IDEFTGFHLABAhAAAKDGHVABCUGCAaCEBHDADQAGEhAAAeEHBDHCGOEADhABAAAHGCCCBfBHE.MIBG...hAEA......hAFA...,2,-27,-6,21
aEKUDGbNeAIfLdgTHcYSRCFZOXBQMJWPV,LGEATGBC.HCEGSBFGFFCBZAEGBBAAJECC...PDHDhAAAaAEGECBF..DEFDNEHCAIFAhAAAdDAH....YACHhABACCCEXGADMEIB.KAHB....hAHA......hBAA...,1,-21,-26,5
eZGSJADaCbVIMQXOBTRFPWfUYEKNHcdLg,DFEACFED...VCCBICFC..MHFEOHFERAED..FGAC.hAAA.PAFAUAAFKDAFhABAHDGD.LBBBhABAeDHDSGDBaBDBQFBB.BGFA.hADA......hAEA...,2,-32,-18,14
YRfEXIFASTBWCVcQJDbLZOPHKUeGagdMN,SFFBBHHGCGFD.QDBBJECA.DHAALABC.ZFADhAAAHBFCKAGH.eGBE.hAFAgAECdEGDMCDG.hAGAYAAAECBG........hACA......hADA...,1,-28,-41,13
QYcCJeEULXARVHaGOfMBIWTPNZbgSFKDd,VBDBaBBDGGEF..MBABBDED.TEGDZFFESGEDhAAA.KGAEdBFDQDBDhABACEAGJADBeHAALHAGhACAAGBDOAAHIDGG..WCFAPAFEhADA......hAEA...,1,-16,-22,6
QWZRGAdLEFSKbBNDVMXHUeIcOTaPCfYgJ,dEEDLEGHFEHDKCGHBBHC.DAGAMAFAHCAA.UGCHeEBF.OAEBhAAAaCEA..CEEB...hAAAfCBBJABEZFABAIHE.hABASHBA.NCAC....XGGChABA....hACA...,2,-37,-29,8
gUaXfNdQeZLTEKWHDPAYOISMGVCJbcFBR,OGEASGFHGACGCAAC...JAHFFCBCBEEHUAFA..aAFBXECDhACAdEAAZAAFEDGDKCEFDEHDhADA..AIHEMEIFhACAbEAF.RGBE...fHBF.NBBHeFHHhAEA.....hAEA...,1,-20,-21,1
ORCUAPFfeSVNLGbBdQcHaWEXYMTgZIJKD,FHBGSDCDLABCBBEHdFCDHBGD.aGEDXFAC.MBBEhAAAgDEGJHDEKDHDDDEEhABACDCCAGGH...fHGFhACANCBA.........hAAA......hAFA...,1,-29,-39,10
BHWANcMFCgTPGSfKbLZaORJIUeXYVQdED,MCCACFED..TDGBSGDHKDAH.LGAAaBCH.RFGBJADGIGADhAAA..XAABhADAQAFDdBGBBDDAhAHAAACEFGGEPECBbDFE.......hAIA......hBAA...,1,-22,-30,8
UDSMERNFICWaHVefgdJTcLKGYAbXZOBQP,ZEFHBFFEUCCCDBFD..MHEAEBFD..FHDGCAGF..HFAAeAAC.dHAHJAAChADALBHB.KFAAhAAAAIBCOEDG.SDCDhAEANAEF.aHDCfFDF.hAFA......hAIA...,1,-22,-45,23
QaZbdcVUDCPeALSIEXgROJfGBNWFTKMYH,SDCDXGBCRDEH.OBCEGBCD.BAGCFEFCKGAHHAAEZGDEdDAFUAGChAAADDIFCHEE..AABEEDAFhADAJEGB.....NDEB.hAEAMFAE..aHGE.......hAAA......hACA...,2,-23,-21,2
OIXdBQHCbATKSGDVUPeLFYfNaMgJZWREc,KFHBSEHBDBHH.UDCCeFFFLBDAFBBA....fAFChAAAaACGJHCGZFGHREAG.OGAAhAAAdHAFBCAF.CEHCAEFDhABA...GBDE......hACA......hADA...,1,-30,-32,2
QcDRGUAfEXFZHITYLdVMKbBWaSePCgJNO,XGBCZBCFHEFHTGBBLDCD..MCFEBHGH.SAFAhAAACHHEJAAF.QDFGhABADFEHUDABAAIDECAD.YFHHhACA.dEEGKHEA.aGABeBCG...hABA......hACA...,1,-5,-24,19
gBDJCSTOPNUYKRQFZaXeAGMIfLHcEdWbV,MEAELGEAHEEBEHBCdDGF...VBCADEACJCCCCHGH...OFABhAAAUGAFRAFAZDFB.aABCeAADhABAGEBF...hACAfBHEWFDF.BADB....hACA......hAFA...,1,-13,-25,12
NaBJIWLACRYQTFMcDOPSeUbGdgEVZHfXK,RDBHQCGCMAGF.DDBCOAHB.eBCGUEBCGEEBEAFCHGFEhAAAKHGABAECIACHAGHCCAAF.hACATEDC.FEHD.hADASAEF.dHBB.....hAIA......hBBA...,2,-33,-6,27
bYADQeCXWGIUELVcHSdOPTBgJNMZRFfaK,DECDeGFACCBA.GCAG.UCGAVEDFHADG.SFDCOAEHBAAChACAJDCC.ZBFFFAAAKAGCABHEQGDAhADA.hADAXGAEIHCD.LHFG.dFAAhAFA......hBBA...,2,-36,2,38
VTNFQDUHEegYXRbaZGfcISJdPWKLBOACM,CECDMEIB..TGEGQBBEUGGAHDDHEBGB..eEED.XFAFhAAARAABaBGD..fGAFhAAAICEFSGFHhABAJAFB.WEAEBACC.AAIDFEABDAGA.hACAYCHB..hAEA...,2,-20,-16,4
UXMdSTcBFLKAeGIDWCJZNYaVRbfOEgHPQ,GECFDACBCHAG.JHDEZCFH....aBEAVCDF...REAB.bBGH.hAAAOBDBEGGB.HCAHhAAAQAGEXFACSHDGhABABHHEKABCAAEEeBBD.IADFhAFA......hAGA...,1,-13,-30,17
cHNQGUdYSJAPReTFCfIWEXLaZMDgKBObV,RFDFTAADCDEC.....IHFDXAFEZCFEMBBADADBBEBChAAAOEAC..VGBGNAIG.hAAAQEEBUGADdCAFSFFBhABAAFCEPAEHFAHBfFHGEGGE.hACA.aGAH....hAFA...,2,-22,-12,10
YNcLeTFMfbVBZAIgRGCOaHXSQdEPKUDJW,RAADOCBBHDBDQEGAdACCKCFF.UBGCDGFA.JADD....NHBB.hAAAeHAEFAFE.MDAD.hABAVEDFAGIDGECF.hAAAXBGAEGGB.....WHEA.hACA......hADA...,1,-4,-35,31
FHeCOMQLbfRZUSBgWTJKDaPYVXAEdGNIc,GACB..cEDCHDGDCHHB.MFAFLCBFRFDEZBACBDEH.hAAA.WGACJHBGDAAGPHDEhABA..VDAAAAIHEAFAhACA.IADD.FCDC.eEEG.QGGEhAFAfBGFSDHBhBAA,2,-26,-6,20
TQRZUPNMGSJIBXHcaDEAFgVCWLfebdKYO,FCFCCFDDLAFCeHEAdEHGKCGC..OAACRDEHZABH.UCAC..MFCHhAAA.GADESGBGhAAABHFFHDAEaEDEAGEH..hADA..gAGBfGGB..YADBhACA....hADA...,2,-32,-15,17
AUOFMIgJGeBXKDQNfEPaHbTWLZdCVRcYS,UGGDMEGF...JCHBBAHE.KBEBQEEFEBBEHGCE...TDBFhAAAZDAECBGD.RGCESAFHhABAAIGC.OBBEhACAIFEE.eFAANEAGaHBCWAAC...hADA......hAEA...,1,-23,-33,10
TOHPeGfZUaRcQCLJSXVbdBYAIFKWNMEDg,FAFBKHBGMAGBEEDH..DBCEOEAHHFGFeDEGGEEBZCAB..aBEHRGCACHBDhAAALBBB..hAAASBGA.hABA............hACA.bDCDBFFFIGHGhADAWDCF..,2,-32,-26,6
WcDaYSIALGZXPEefHFUBbVOTgMdRKNQJC,LEGHZCDFEABCHDFCFECDBBEGOFAD.MCCHdBBCKHBA..JFHDCFAEDFIBhAAA..SAGGhAAAAFEE.XGCHhABAfBHA.........hAEA......hAFA...,2,-56,-20,36
QKUHAdVLPMbBGYfDZWcRCaXENegJOFSIT,dDBDVFDFMEAF.BFBAGEAA.DAFAZFEERCAG.CAAC...EGGGeFHHhACA.OHBCFABATDEAhAAAKBFH.AAEFLCHFhAIA..PEDE.fCDBhADA.aADENCCF.JBHB.IBBGhAEA,1,-21,-23,2
fReZNLTAVgHYOIcKFdJEaGCXbQPBUWMSD,VGFGHAADOGEA.KDHDdGCA.JECCEGBDGBBBCFAF..QDEFhAAAUFAEMADCDCGEeBADhAAALDCF.AIDGIAEAhACA.aFHDXAGEBAHCSADDhAGAfEGF..hABA...,2,-30,-9,21
HSEDfTRbINaMGVdJYAWKgZQFUXeBPLOcC,KHBGQFDHFDDH.eBFDBEAGLFAFCDAB.SEAEhAAADHEGRAAE.ICHGMBGD.hAAAdGGGADHGZCEFUBAG.XACFhABAOGAGHFGDEGBDfDDA.hACANEIE.aAHF....hADA...,2,-37,7,44
WdQJHVbOeAUGYcXZaCKEDBgPITRNFSfML,UFGHGAFE..XABCCEHCEBDHBBAE....IFCChAAARFFDSHDEMHAEdBGDHCBBhAAAVCEDOEAH.AEFH.hABAYHEA.aAEGDADC..PDAGhACAFHAE......hADA...,2,-26,-17,9
UDFfQOVSXMLEIRWdCPYaAbZGHJcBKeTgN,ZEBHGGDHJEFG.KEEE.eCAH..TDDHUAAFFGAGOBAA..hAAASDGHXADDMDAAhABAIFDAdAGACGHH.hABAaFADHADG.cDCB.BHBADGDA..hADA......hAEA...,2,-22,-22,0
aAYWCOQSXVbKEFIUNBPZdJMfeRTHgLDcG,CFDGQAAD.SGEEVCFCEAAEUCCFBBEEdDCB.JEHBeHAEhACARECH.HFFEDBGBaGADhAAAAEAB.....OAHDhACAbDAHIHHE.NADB.PHDC.hAIAMEAB....hADA...,1,-14,-22,8
QMBaGfZVXWSHTNRCYDPUIegbFcLOEJKAd,QAEDaAGEGDCCZAAC..XGEDHCECRFADDGHBIAHH.hABAeDFCFCABOEEDhACAKAAFMEEBBEHCVCBFSGFHhADACGGCPGAC.........hABA......hACA...,2,-18,-9,9
NWUeRDYAgQcLOGZMfBEJSCFPHTKIbadVX,QCBCLEEGOBECGFEFZAACBAEGEHBC.JCFG..FAGETECAhAAAKGEA..aFACdABF.hABANIEH.....eDDEhACAYAFCAHHBcDAFfGBC.CEHE.hBAA......hBCA...,2,-23,-19,4
REHXDVgGNWTafIBSbCUAecZPJLKMdFQOY,eFBBZAADJFAFMDED.FCEAQFDD.RCFF.XGFE.hAAADAGAgGGChADAGAACNDAC.aCDDBDHE.SDCFhAAACEBGAEHALAEE......hAIA......hBAA...,2,-25,-25,0
ZbBIWAJUeQYERTGHfXFSPDOgCLaNdKMVc,JFCAUDCH.eAEEQCAFRDGB.HGAAFBADDGIBCAEGLHFG.hAAAaFFFNEBG...dABDMFDDhABAVCECZFFFBDDDACGF.hACAEAGA...fEHESCHB..hADA......hAHA...,1,-4,-31,27
UYgKZfXFcEAeIWObRLHQTPJSaMVNDBdCG,eGEAOGEARAFELFAEHDCBQEAE.JAAFaDEB.MDACDEIDBADBhABACCHHUAAHKHDE.ZAGBhACA.FEEAAEAEIHAEhABA..WCCE.......hADA......hAEA...,2,-30,-17,13
BgVZTMYRDebaAELCIUdOcGSXJPWNfKQFH,CDGFdGFCGEAEJEEE.......NEDAKAACQCBB.FFABhAAABDDEVAEETEGDhADAMIAC.DGIB...aAFHhAEAEHGGLFEFOECFSBAC.hAGA......hAHA.XBCCPEHD,2,-26,-22,4
bgATPUIeYfLKFOCDGZdXNEVQBcHaWMRSJ,TCGCUCBCeFAA.LADHOCBBDGFAdHGB.EADEQAFChAAA.BCHE.aEEBRDCASAGAhAAA.hABAJGCAAGFEIHDGfACECABAXDGChAHAcGAAMEIH....hABA...,2,-33,-14,19
RUCbeQPdZYDMgGfNLaWVFcISJABKOHTXE,OCAFTDCB.RFBG.CGHG...QGGEdAGCDIGEGBABLAGHaBFH.hAAAFAEF.SEDEhAAABHFCKFFEEHBGbACD.eDBDhABA............hACA......hADA...,1,-20,-26,6
OWPRIEBUcJFCADLHGMZKbQNgYXaTedfSV,DGADLEGHGEBHMACGKHGE...QFCF..NICHXCGDhAAATBEDeAHHSAFDhABAWEBD.IADChACAUBCEJBAB.AEEA.HBBD.bGBGaGAHdFGBOFFBhAAAEDDE....hABA...,1,-8,-11,3
bZgTGIfUdRQDaEJVACcYXMOBSHePLWFNK,CFDGXCBCBEFEHGBALECCFDAB..KCEFZEFDGAAFUBGHdADGDBIH.hAAAEFAB.ABAH.MFIFeHBAhAAA.....NIEB.hABA............hACA......hAFA...,2,-44,-20,24
CeXKJEbNDgHQBOZGfUPYTSMdFcLVWIRAa,eCAFXGGDEAGBDAADHGDA.BAGDZCFHGDCEUEAB...TGGHhABAMDACFABFLAHBhACAVBEFREFACCDEJFBF..NAIE.hAAA............hADA......hAEA...,1,-14,-17,3
VRFBJSfDKYdaXZOMcEIgPTUAHNWbeGLCQ,HAAD..bCAALFBACDHE.QCCCVFDHBGGESGGEhAAADIGCKAGE.dHEBaCECXAEBhACAZABE.cCFBhADAEFAC.IAHC......hBDA......hBEA...,1,-15,-35,20
LONFZJSdAQEYeKCGgfWUVcRPXHTBIDMab,EGFCKDCDGCGG..gDFCUGDAREABHABABEDDDFDCMCBFLAEBhAAAOACE.NCICZFAAhAAA...dCDD.AABCeHBGhADAfGGG.cAGA...hAFA......hAGA...,1,-18,-20,2
SBDbeafdRJQWTFPLIMNcCHZOKUEYGVXAg,BFEDDEFHeDBBdBBGRAEC..JACFQGGG.FECDIHAGhAAA.MAGFCHEGZEAH.OACGhAAAEAEDGDGE.hABAAIECbECDfCEE......hAHA......hAIA.PDHDNBAE,1,-23,-34,11
PQGUcReWbZASEfYKOMLCBJXNdITgDFaVH,SAFBEHBGKECE.LFBAJABC.XCADdCCB..TGDFhAAAFEEAaGGFHFFCGAAFhAAAUBFGeAHB...hAEA.WAFEAHEBfCDHMIFACEFC.IHCChABADBBF.....hBAA...,1,-6,-26,20
ReLfIJgMTFUYGEaXQDAPcNWBVbHdSCOKZ,...PDEHNDDGBBHCHAFB.dAABOABDZEAHeGFCLGFA.hADAJEFEgADFhAHA.MCCH.FDHDYDAFhAAA.aCEFDDDH.ABBD.....hAIA......hBFA...,2,-45,-9,36
ZcPSGOdaXQRHgAYVbUIKECMBLfNeWTDFJ,VAADUCBCKEFA..MAFALADA.eCHBDHGCJHBEZFDA...hAAASDGDODDAdHADhABAXEDC.QADGhAAA.HBFGABHEIHEG.hACABHGH.NCAC.FDDA.hACA...,1,-16,-31,15
fRTVWgZaPcbJKABOGUNIeFLEdDMCSYQHX,GACBUCBCeFAAFHCGEDGGDDGF....CGHH.SGADHGCA.RCCF.hAAATAEFVFFC.ZDDFaCFGhABA..PABG.hACA.cDAGKHAABGGF.NIEF....IAHFhAAAMIFE...hADA...,2,-18,-14,4
RcFfeJDPCZEaYKLdBSGXVINUWOQHbAMTg,TFDBRAADFEFG..eEAADGBFZAEG..EGDHKAACBGGEGDFG.VCBGhADAUBGH.QGAEhAAAAHCDMEID..fEAChAEACBEBaGHDLACBdHDD......hAEA......hAFA...,1,-14,-23,9
OVgCdcXaBGHbeKfMPZNRADTSIWUYQJFEL,SDABUCBCQFGCEGHB.LAEC.OFCECAHCXACHhAAABGBDHBFAKFEDMGAGhABANIEBAHDC.TDEB.WCHDhACAFABCdDFD..aAEC......hAFA......hAGA...,2,-31,-12,19
FHbfReJKgOUBQZLWYDPISNXCaTAVcEGdM,VDAGGEAH.MGFEFHFEHEFARAED..eHCAKADEUBGABABELGAAhAAADGCE.SADFhAGAXBBE.CEGDAHIFdHAFfBBEhAHA.gDDE..hAIA......hBAA...,2,-32,-16,16
NAFSLBCfMgeXZOcUHaITGPRWbDdKYJVQE,FEEDBDGFMCECeACDZEACODBB..HBAAaBHF.TGBFGEEGRGFADBIHhAAAKHAA....VAEFhAAA.EGHBAIAGLADAhABACEHE.fEHE....hACA......hAEA...,1,-19,-23,4
EHTUAJfYWdeBSQXMFGcRIZaDNbgLOPCVK,JGEA..fHBHdFACBACB.QEEBFDHD.RAAGZAEAaCCC.DGAGhAAA...NDDD..LHFAhACAOFCFVAEAhAAAKGGE.EBACHDAE.AAIB.eDECMCDE...hABA......hAEA...,2,-39,3,42
JgKRPdCeZFQDMWXaHAGLbIfSETVBNOUcY,LFEF..fBBDSAEAVAGHBCCBUDDEJEAGKAHHhAAARCAFdADFZDFA..DGGAMABChAFAaFCH.AHAH..IHHGhAHANIEH...OFGBcDGC..PFCFhBAACGAD....hBBA...,2,-30,-23,7
PbXVLeSNUHGafcRdICJWQTKYgOEABFMZD,MAEEDHCE..XDACeDAAUABGHABEGDEBaGGG.RGCA.CGAHJBFEQBGAhAAA.KGGAODDAhAAABFCD.ZEEE..hABA............hADA......hAEA...,1,-23,-31,8
LIFZYVEdDgRGUWOAfHeaCbTMNKJcBXPQS,HFDFCDGF.TDEFKEBGBAHBQDAGLADAFAACZBBCEHAC.dAGERFGFGDEEhAAA.OCHDhABAfGHC.aGFFhACAMEAHcBCB.XDGH.SDDFhADAIHCBDGCE.hAEA...,1,-5,-28,23
LOCKBPZcedFVTINGabUMYDSRJWgfQXAHE,HDEDLFFBKAHFZAFFeBGHFEAC..TBCGGACCUFBHDIGAREGBJAFD.hAAA....fABChAAAAIAAEBADBFCAPEHBhABA.dDAB.NDEC........hABA......hACA...,2,-27,-9,18
cMfHUgEFAaCGWNXIJZSQPKORBVeDTYLbd,aGACCECDGGCH..XAFEZBEDQCBHOFDEBDECDAACLBHDhADAdHEFMEAGHFGDEDHBAFCEhAAAIFAD.SACAhAFAKCBC........hAGA......hAHA...,2,-35,-16,19
YQdcgXVAbORMCSHZBIeEDWJUKaPLGNfTF,OFBBRFBHMBEA.HDFEBGGBeBDH.DIDEJDFDKDAFLABH..hAAANACGFHGGdHEF..XDAChADAACHBCFHF..SFCHhAAAIDHDEDDAUAGBaAHFfBAEhABA......hADA...,1,-23,-26,3
DKYOTbUWJQaefBNILZSEPVHXRGMACdFgc,CEFAdAFBFAGEDAEF.KCFH..OCEEUFEA...JFEHeDCF.BHDGhAAALEAEZBAB.EFBE.hABAHACGXGGBRBAEAIDA.hAAA....YCHBWCHB..aGGG.hACAIGAF..hABA...,1,-33,-37,4
IBVTOSaCfHeLDgZAEGPKcMYFWXQbUNRJd,GEAHKHBGMAGBFEEA.QFGHUBDA.RAAC.JAHFBHEA.OAHBhAAASCAD.aFHHhAAAHBDA.LDAEhABADABFAIGAEFFBcGAF..XEAA.hADANEEC......hAEA...,1,-10,-35,25
bFLQMaKJIgORdSTEAceYHDVBGCWZUNXPf,eGEADHCEBCBHGCDEZAEE.UBFG..XABC..fADChAAALCFH.aDACIDEGhAAAOFACdCHETEAChACAcBAFHFGBWHAGNCIG....FGAHMFFChABAKHEA.....hADA...,1,-9,-25,16
TMLSYZCcJFNEAaBgdQWRPGXeODHbVUfKI,BFEDQGBCRBFAGAACeEBEDHEEHFEB.VBCEUDFD.KFBGICAGhAAALADFZDGF.CHHAFAGGhABAAFAFdHAB..XEAChACA..........hADA......hAEA...,2,-40,-4,36
fCOYNZeKMBDXbPcQEaWLHUgARVGJTFIdS,VCADGDDC.FGABdGGACGGA...OGAEZAACMCADBEGC.DFID..hAAAXGEH..hABAPEEFEDGHaBFAHAGHhABAAHIBJFCFSACG.fDDAhADANCIG.KCCE....hAEA...,2,-30,-19,11
GbLaRSMCHIEdJAWNFQZVeYfTgBKcOUPDX,FHBGZABHeFCA..TGEDKBEGODHDDAFEGCABLDAB.SHBGhAAAMFBAHACGdDEFhADAAIHEQBGChAAA.fEGCgGFCBBAAPAFA.hABA......hACA...,2,-22,-15,7
bXOSYWQCEJcfIMBeTaVdKANLHRZPDGFgU,LFBBRBDBZCBFDBAA.FFDB.UGFHOGEA..SBEAQDGFhAAAJEEA....IDABhABABBDFaCBCVFABhACAKAAFAGIHHAFE.PHDCgAGB.XDAChABACEFD...hADA...,2,-29,-17,12
SCFWRNcbHMVAIEBOgfQUeJKDdaYLZPXTG,BFEDOGEAQFBCUEBE.eFFGDDCGdCHALBCCZEFA.TCDGhAAACDFB.FAHFRABG...hAAANCAE...bGACMIFAhABAAEED.IDHCEAFD.fHCFaDAH.hABA......hADA...,1,-10,-28,18
bNQdWBGAIcJPFMSRZYaCeVLTHUKgfEODX,JGEAFGFHRAGHZCAF..CABD.LHAAHADD.KCDCEFDD..DCGG..bCEHhAAAQDFH.hACABAFDAHHCIDAGhADA.PDHD.SCCDYABGeCCBhAAAUGAE.OGAA.hAFA...,2,-32,-18,14
bXIDWYEFZOgfKGcVBHdMLaSPReJUNQCAT,TCGCXCBC.DFGBECAH.ZCDB..OAABKGGFGCBGBHHEMEEGhABALACA.aHBEPAFAhACA.RECFJAEFUAGFhAAA.CFHEAABF..IFHD.FHDE.cBGDhADAdGEE....hBCA...,1,-5,-31,26
OdICUERKbMBcNeSPJYHZQaVGDXgFLfWAT,TGGDdDCDCCHC..EAFDREAGKCBH..BAHFeFEB..SHFAhAAAJDHFZAEA.aGDGDDGH..hAAAXGAALBACADADUABChAEA.MFCENHAF.....YEHHhAGA....hBAA...,1,-25,-36,11
GDfRIcQAZVCPUJEOgMbXKBNdYaTSHFWeL,VFGHUGGGECFH..OCFGMAAB..KFAEdBEC.aDAHHCGF.eDCBhABADDIDRGBGQBCEhACAADBCCAGH.JAEA...hAAA.bFEHBAHB..NABF.SEEDhADA..WBCB..hAGA...,2,-34,-9,25
OKUaGIPJRLVWdbFCEHSfcBZgAQeDNMTXY,QEGDeFCHMCFG...XGAEOEHDKAFGGCAC.JECGVGEEhAAAdHGFCADESACChABABDHBAAFGDCCGTCCA.hAAA.aGEFIHAE.PDBBWAFA.EEEAhAFAfGDE.hAHA...,2,-19,-18,1
EUPGJbfVRcIDNQFSMTgYCdZALKBXOeWHa,BDGFXFCAOFAGHDBAUCBCGACB.JFFF..VFEDRBGFDAGEFAGBhAAAMIBA....hAAAgADECDACADFBKBAA.hABAeDHHEFAF...fHCB.IABFhAFA.SDDEhAIA,2,-27,-20,7
SXTeNKYabMDPFHELCRgJfdZIBcGOUAWQV,VEFHSEHB.eFEHKCCF..aFABDCGC.HABCCHDG.RFCFJAFAdBECBHBBhAAAGCAC.AHGBQCCBhAAAXBGG..hABANABC....MEEBEGGEfEFBhACAIFCE......hAEA...,2,-36,-7,29
FRSHXTeLDAJPcUWZGbNEQCdfVIKgaBYOM,JGEAUCBCGCDFEFCF..QGGFdGBD..fEBFhAAAVBGBKEEEBAFEMBAEFAEGSABAhAAA..XEFEhABAeAEBAHFDWHAGNIEHICAG.gAGFhACAOBAH...hABA...,1,-17,-24,7
daUJZDKQTALNVFHGeYgIBScXMCObfERWP,LFBBVDAG.GFEBeDGD...IDBDSACG.MFFFhAAAbAFGRBBEdGAG.aAFDJEDEhAAAKFDHAABFFHDC..gGGAhABABDGECGABEACEWBHD.....hAEA......hAGA...,1,-16,-19,3
dQGcBDWSeYUATaPJNHEOKMfXLRgbVFIZC,aGFCJGEAHCAF.KGBDMAFE.LCDDRDFA.VCFFFAGBCABHdCADGADChAAADGBB..eABChAAA.AHCD.NDDA.OBFAhABA.fEHA......hBAA......hBDA...,1,-21,-35,14
NVPFDKUIEbBfJRWMCcGSeOdQgTLaAZYXH,XFDHHGFGVAACDEBDKGCB..UGFG..IAEFEAAFBHACRDEDCCDAhAAAGCBD.OAEGhAAAgAGDLCGBhACAaHECACFCNBIE...FDAE.......hADA.fECEhAIA...,2,-25,-15,10
dWbFHXLMaPDgNQCUTSRcKEZVOJeYAfIBG,BFDGdGAHFDBHLCAG.aEAGDABE.QGGGUEFA.SDGFhAAAKGBFEABFZAGBJFDBAFCF.hAAA..GADH.hABA.WHFEXBCGMCIF.NBIECDEE....hAEA......hAGA...,2,-31,-30,1
AHagKJBfEQGSIFDbCTRVOWXZPYdNLMecU,HDAGaAFB.JHDGBEGH.QBCFSFAGDCGECGCH..RDFCOBAChAAAZDAFdDEFLDHBhAAA.eHBGAIHEKABEEAGAIBHHhAEATFEE.WBDE.....XFGEhAFANEAEMABE.UDDEhAGA...,2,-23,-6,17
VfSgIQDEOHKbYJLdFBPTMRWZeCNGUAcaX,XGBCVDAG..SFGEQBAEEABFHDFE.KHDAJAGBLCFEhAAAFGEBBGGAPDDFhABAMGAAZADFCGGCUEAFAICG.hAAAaADH..fEEFIHHD....hABA.DBID....hAFA...,1,0,-26,26
UFAPdZXDceabEHgGVISMCOWQKJfBTLNYR,dCFCZFEEDBGHaFFC.HDCFGAAC..SDAACHEC.QADBhAAAKADDJBHDBFBD.LDDFhAAANIDDRGAAAHHA..XBAFhABAeHFAEGAB........hACA......hAEA...,2,-28,-15,13
KHTVYfXbEBDONcCAFSUJgMQGaLIWReZdP,SFAAUDACMAAEGBCFLFED.RACDeABDdFDHKHFGHGFA..hAAATCGFfBFHhACAEGGGBGBHNCIEAEAF..FDGFQDEDhAEAIDED.WHBAPHAA...hAFA......hAGA...,1,6,-23,29
WNCVceaZgfdFIBODYKPTXEMbGUJSHALRQ,RAEGQCBCCEAE.eHDAZECAdHGFBGECDIBEKFAG....XCGDhAAAMBAAUCFD.HEFAhAAALABHNACF..hADAaAHFfDDBIHHDOEDBPGAE..hABA......hBEA...,2,-34,-14,20
aJZXRWPKgfBeFdVSIMYCNEGDHOTbcLQAU,UGGDaDBDZFGDRCBF..KEEABCAB.dAEA..SCGGMEDB.CAAC.hACAEGEFHGBEOCGH.hADA.bBDFQAGAhAAA.JABAXAGEWDDB....gGAFhAGAfEAE.hBAA...,1,-27,-28,1
VGKSbHQILgPTJNXcBECYOUaWfeRAFdMDZ,MIAGVBCF.KGFBHCFBLDBB..TFBCJEHB...NBAABHBDhAAACBAGUAEC..aHGAeFDDhAAAFAHBDFFFZDDASAHDhABAbFDD.........hABA......hACA...,2,-29,-21,8
UeOHGQTXKaEYcLJbNBFRVZPfICAdgMDWS,dGFHDDGGUBAEODBDHDEBGDDA..TEAHaCAG..EAFBLFHDhAAAJHBA.BAGHRABEZAGFhAAAPAEBCDGD.AEHGMDDFhABAeDAF...XGCC...cGEDhACA....hADA...,1,-12,-26,14
YVUEFfdbRBcgJIaTAPODQSHNXZKeWLGMC,OFCHSDABHDEBZGAGeBAHLFGFGBGECCCD.UACBFABEdCEFBFHHhAAA.JFAFaGEFAEDEDIEEQAGEhAAA.XDFChABA...MIBA.EFBA...hABA......hADA...,2,-23,-6,17
MZYIWQLFbTdCHSeVfGAaUgOJPKNBEXDRc,UGBCOEEGKAEDBFDB.DAGAMDBC.ZCFH..IFHBLHEEhAAAFBABdAGDHBFAeBAEGEBGhAAAAGIH.JHDAEFEEXBDFhABA..YCAF..WFADhACA.....hABA...,2,-31,-21,10
DbQcNeEYSAZRTKGWCIVUJgBfXOFdHPMLa,RBCDKCBBGCEECADG.UFBHBGEG..OAEGFFFEdCGCHBABLHAEhAAADHGAQEGE.hABAeHCAEEAHAIEA.TECEhACAWAAC...IHHAgAGA..hBCA......hBEA...,1,-10,-43,33
bJYFBdRaEQILAKNOcgGfSDXUCVeZPWHMT,OCCHGAFEDDBBUGEGCHFH.ZEAHHEEA.MDDBJACG..BAHCdABDEAEHhAAALDFG.AAGH.NDCC.hACA.....fHABhAEAXAABeFCCWEHH.....hAHA......hAIA...,2,-37,-24,13
MOBXFRNVcgLHSfdIaPbUQTDGKAYEJCWeZ,JCCHCAFBZDACBFGC..FAABRFAE.....VBCELBAFHFEDdCGGhACAaFED..UAFFQFBGhADADIDA.AIDAEEHFMAIHhAAA.....NEEF.SHAG.hABAfGHAIGHD.hACA...,2,-44,-17,27
UeBIKWYRFOgdCbGSHXEfQcDNJZPTLMVAa,aGDDeGFABGAAKFEARBBC..OBABdBFEGDAEHBEC..EGGF.QDDFhAAANAAEZCGB.LFFChABAAAHC.IDHEhACAFEDB.bFBFfHBFDCCF....hABA......hACA...,1,-2,-25,23
IRYAOEXBLFbMfcVPJWgeDKdHGQNCUTZaS,EAADBFEELEEHMBFE...VCFCJDHDeCFCKGBDHCBCGBCGCAEGUGGChABAZDAH...IAHEhACAAAABOGEE.FBAEfACChAFA.WFCBDEEENAEF....hABA......hACA...,1,-7,-28,21
cWdeHNaKDJMYIQRgUFGLZVOfBACEbSPXT,EEGDSHBG..PDBFTDGDdHCHHFDAKCCC.DGIH.JAGBIHHEhAAARDAD.FFDAZBCEhAAAOACAADFDCBAH.bAFEcGFDhABA..eDECMADAgBAFhABA......hAGA...,2,-22,-9,13
SgFHbaLIdBORPWNTDJfVeGKCMQEcAZYXU,XFDHSGFCHAFBLEEEdAAFBECBOBADRDGD...PCCEhAAANAEE..DDBHfAFBhABAeFABCHHH.EBHFACCC.hADAUFBC.FACCIAHG....hAFA......hBBA...,2,-27,-15,12
XLTQgOMdYCfNWGcSVZDHREPabUIKBeJAF,FGDDXDCHLHFA.QDBBOFABMFFACAHF...NCBFGGCBhAAASDGF.DADGhAAAEBHDaBAGIDAFhABABCHEACCATFGC.gGBFYACEWBFBhAGAZCDB.....hABA...,2,-23,-15,8
CEAVQOZXMfTFLcUGbYdgRSBWDHKPNIaeJ,QBDGZAEGMCAAFEFAUCBA..GGDHdHBHSFGCDCIDKDBD.hAAA..PBFGaDEBJFAFhABACDFCAIEE...XFAAhAAAfABF..cGEA...hAEA......hAFA...,1,-24,-33,9
WPbQaEBNfceSURCFDdGAZJKgOVXIYTHML,ZDEDKDCDOEDC..VBBE..ICGATAECLAHDhAAA..PAAEhAAAQGFD.BEHGhABAfBEASGABCFHGFHAAGEAHAIEGXGEAhADA.....hACA...,1,-22,-38,16
VSLKFcaTQHCGPBRMXJfONdbAgDIZYEUeW,DACBZAADEDGDUGFA..eEAE..SEEEFDEFaFAH.QBEChAAACHCDBCDF.MBIBJHDC.hAAAOBABdFGDAAIF.IGBDhABA..WACAKHDEcDCH..hADATBGA...hAEA...,2,-36,-27,9
HXIcEBGaZVDKAWJbQRUYOTMfdCLgNeSFP,JGEAREFHOHBE..MFBGCGAH.LBEC.eCAEFBECHCAAhAAA.XDEFIAAFhACAEABCaHAGDCHBAGIDQCEHhADAUEAF.fDHANAIE..PFHDhABABGCB....hAEA...,2,-24,-22,2
ageXRVADEfIMSJdYOKBNGcTZUHFPQbLWC,DGHHEHBG.MEAGdFBBKDDAGFBFZACB..HGFEFCFH.QAGCLBBAaHAGhAAAeCAF.RFDFABBGIHEDhABA..SFFEhAAAJAFE.BBEANCIC......hABA......hACA...,2,-25,-11,14
IMfbHWYgBUCAJaeLVDPEFdGTRNXQOSZcK,aGDBVFBG..DCFCEAGGFGAD..dDABGCBFRACD.QGGGhAAAOHEAZDEAKEFFMFIFHACC.hAAA..gDAGhABACBACADIHeEAF.PCHD..NIAF.....hABA......hACA...,1,-6,-17,11
AbIXJEQPgDcFLadBROfTKMNeSCYWHVZGU,XCBCEAAD..PEFEDFGBLAFD.dFEERCECOFCBhABAKCGCMECGNEBA...eHAEhAAACCCEHACCVABA.ZEGFAIEAJAHHhACA...gGGE.aDAG.hABA......hAEA.fAGF.,2,-12,-10,2
ebDWSFcOHCdAgGVBKIfMRJYEZPaXLQUTN,GEDHKBBDMIFERCEEEFBEZBFC.....aHCELCDH.QGBChAAAUAACTAFDeEGBhABADEACSAGGhACAOAHDdGGAAAHCBHDAJADBPFABXDAE...hADA......hAFA...,1,-10,-19,9
OAISHDWVFcZMLYaTJPBCKEGeQNRbUgdXf,SCFCDHCEFAGDZDEA.MEFHLBBE..aAGG..JDADPEBEhAAABFFG.KADG.GDGChABAeDCH.QBBHhACA.NIEF.bGFA........hAAA......hABA...,1,-13,-45,32
fDCGRcTAKZHgbPeSOFQNYBUdLIXaVJMEW,ZBCFHAAD...gDFFbFFG.SECBFADAQCFGhAAABCHBUGGEdABGXGBEhAGAaBEAVEAFMIFE.fBGBhAHADACERFDHADDC.KEGA......hAIA......hBAA...,2,-17,-9,8
BegIMKDXLCZFWNRUfSHYaGbAEdJOVPcQT,EEEDJFFB...ODHH..VEBBQFAHBAEHeACHIBBDhAAADEAFLAAFFDABNCEHRGEA.hABA..SHGAhACAaDDAAHBD.dDDH.PDHB.....hACA......hADA...,1,-21,-30,9
cdWePGFKOVYANfTagSJDMLbQZIHUXRECB,TCBCaAFB..JDACMDAFLHFEZBFGHGAEREFG.BFBBdGCFeBBGhAAAGEDH.KHEAOEABhABAADGB..NBAH.SDFEhACADDIHIGGHEBGACHAH.......hAAA......hABA...,2,-19,-14,5
agSILKfXOYUMVWZPCBdARbFQcHeDEGJNT,RDAGQGBCHBFAeADCDABDEGFGGEEF.JBEBaHDG...IEEBhAAAfBHAOBBChABAMACHVDGF.PFBBhACABDAFAEBG..........hAAA......hADA...,1,3,-39,42
TBAeDSICMFdaKfYVQJHRbOgNEWPLUcZGX,SEGCCBFDdACD.KDDEVCCBHACG.RDAA.ODHFEGCE..LAHHhAAAUGBDZGFAXGAChABABAHGABAC.IFEChACA.FHGAaFEAfBGA..JDAD.hADA......hAFA...,1,-7,-36,29
DeYWZMVObRBadKCgQHPTAEGJNSfLFXUcI,EHAEJFEF...SGDHFCBHUAEC.DDAA.eCGBZDEA..MDIHVABAhAAA.OEDEBAHAKGBAhAAACHHFQAFDHABEAIHE.hABAfFAB..cFFAIDDHhABA....WHAGhADAaGGB...,1,-7,-42,35
FTXLdeCaOgRAcNVESfBPUGZHJbDMKQWYI,VAADEAFBBHAC.UEBEHAFH.DDEDKEGBQFAB..IHHEhAAATDGGdGFDaHDE.hABAOEAGAACG.cADGhAAAfCDE.ZAGBJHCAMBID.FBBH.hACA......hADA...,1,-14,-29,15
bBGDedREWTXAQJCVPUNLfcFZKaSOgMHYI,JGFAVDBH..UGCELHFE.FEGFKCHD.OACGMHAAHBCAhAAA...IFEGhABABGAEDDEDeAFCECCB..hACAXCEBADIBCAECfBGFaCBH..SDFHhAAA.bAFA.hADA...,2,-41,-17,24
ABHKZfgOebRYCMGETaWPUJcDLNIQdFXVS,KBBDZAADOBFFeFBBRGFE...MDEHEAFG...aHEEUCFG.DFDBIFBDhAAAdEAFFDDG.SFDDhADABHAEHACEbFGBCAAC.hACA....WAHD.....cACDhAFANAIA....hAGA...,1,-18,-38,20
JaDLgBUPTMYHeKIGdbACREXVFZQcWSfON,EBBDFDAFQDEE..SEGBOCCHaCGAgADBhAAA.BCHATGGGhAAAMIBEYABEKFEEdDDDAHIHhABACAHDXGEFVFAEWAFEfGAFDCAF.hACA......hBAA...,2,-24,-16,8
RFNXKbDYfAGOgQdaCBMIcPWZLSJUeTVEH,OFEFdGFCBBHE.MABE..IDFB..PEFAZDAGSFCChAAAeFCF.VAGFhABARBEGFDCEKGGEDEBDfBBChACAABDC.gADHaGAHCCCC.cDGDhADAJAAFEGHFXGAChAGA...,2,-31,-23,8
IBYQWPNgbAfXZEaJceGCLKHODdMFTUVSR,ZEFHEEED.aCHDeDHH.LDAFHDCHOBBAMCCCFGDDUBFF.VGAGhAAASDDC.BGBHhAAAQCAFNACD.hABAAFHAXGDDcEBAKGGDDABEdAHE....hBAA......hBBA...,1,-7,-14,7
FcCdYMSQXGKZeVPRTAbIWBJLaHfUNDOEg,..IFDGBAFBaDGEHAFEUDCBDCDA.EFHBFAAF..dHCDMHAAQDAEhAAAKFHB.eACChABARACBAIAA.JDDALDFDhACA..fGFD..NICF...hAEA.OFBECHAE.XBFAhAHA,1,-23,-25,2
FPSLKINEdAYDHGfUebBOMJcXRQaWgTVCZ,HFDGUAGHeHAGOCDE.JEHDRDBA..QACDaAEA...gFFAhAAATABCCHAGFDAFhAAALCADKBGG.IDHBhABANDCEAIHG.DIGA.bFBA......hACA......hAEA...,2,-25,-14,11
OHFPbJCVTeQcIaDZEgYLGKMWRNXAdUfSB,UGBCBFEDOBADFAFB..JEHHCAFC..eFFG..QGFGhAAA.aEACZGBCEDEBYDCChAAA.KABCMAHDhABARAGFADIF.SBCH..HEAC.hACAPHFE...hADA...,2,-38,-22,16
QLHIAdSVPBRZUYEFXCOJfWaeDMbNcKTgG,dEHASCFCBAFEUBFBFGBB...OADHJFEB..aCCCDFEEMDIBhAAA....NCAC.KBDChABAGEBCLEAEABIBRAAB.hAAAYDGB.CHHH...fGEBhACA.eHFAcAGAhACA...,1,-27,-37,10
LBbaSeKVcTGOUADWRIPEZMNfYFJCHdgQX,RFDGEHBGMCEE....NCAG.FEBDHBECQDFGBBCDSFEAhAAAKAAA.VDDATCAChAAAODBFAEIBIAEGhACA.fHGHCHFGdDHA.XGACaABA.hAEAcCCFDBBD...hAFA...,1,-15,-16,1
BcFJdXRDTQAbfGMgWZIeLHYCaPVNKSEOU,GAFEMCCAZGDELCBCHEBD.aFAA..PBGBKHACSABAhAAA.EFEDBDEGFEHHdDDDhABAXBAFDCIHAFFGfHDBhACA........hAEA.IHHGCHBDNCAGcFGAhAAA..,1,-16,-33,17
UAQJVaMESGXLPYgBNTfKCWHZFRdcbIeDO,JADGaHDC...EBAAXBCHLDCC....PAEFBHGGNDIATGABhAAA..fFGGhAAAKDFAHGFAFEHDdFCB.hABAIABCDBGDOHBAAFFAQAGC.hACA......hADA.MFFBGEAB,2,-25,4,29
bILMSUQEORdXHaKcFDYGJBgTVNfeCWPZA,LGEASAGDQACERBBDHEDE.KGBEFAHFDBBF.GEEHBHGGgBDEhAAA.hAAATEAAfAGGhABACABCZDGFAEIFIEBHEGEF.OBHD.dDDF.hADAaHAC.....hAEA...,2,-12,-12,0
QEbSAFPOKIUaDTfGBWZReVgLXNMCJcYdH,OCCHUGBCDGIBGAEGZEEE.RFGD...eAEGLHAA.MDBDhAAACBEDJCBFdHEB..EDDGSAGEhABA.ACAD.hACAKABAIDGD.......hAAA.aAHFTEDCBDHEWGDAhABAXBCB,1,-9,-49,40
XNDBLfAHZJWKERcTVOYeGaQIbPSMFgUdC,HDBGZFDFJCGBKGAD.RAEE....VFEFOCCGGBAFQEAEhAAA..PFCBFAGBUGGAhABACAAHDDIHBAEEAIHGEEFE.hACA............hADA......hAIA...,1,-16,-38,22
eNGWMRVTPKCabUEfFXdcSBDLHQIYJOgZA,GECFMECGRFAA...VAEAKAFE..CFHF.aGGAUBCEFDGE...dHCHBBCDhAAADFDC.HEAB.QCDDhABAJBAF.OHAEhACAAGFH.eHFGNAAF.......hAIA.WEGD...hADAbBFEfGDE.,1,0,-40,40
QeLdEGNfgaKBYTCOHPVFZUAWRDIMcbJSX,DHCEMCCA..JBDDXGGDLFFB.GBAC..NDBDaBHHBAFFhAAA.CFED.ODFFHAGFFFHFhABAAHEFREAA...IDFEhACASAGE.eAAFdGBC.EEEBfACFhAIAKGBA....hBAA...,2,-24,-17,7
QcTfDJWaAORbKdMEeNSgFYHUPCGVBLIZX,OFBBRDAGKFFC.dCCFEADB..SAGGFGHFHFCB.UEEAGAFELHDEhAAAZABF.QDBBhABAfFAADFABaBHFMCHHhACA.NBBD...PHECCHHA....hAAA.BFED...hADA...,2,-20,-6,14
HPEIOaCNSdbQXZKGcVeAWDfTMURBgYLJF,DACBMFFFRCGHBECELCBC.FGBAEGFD..aABGCGBD...dAEFQGCGhAAAZBFEKEHFGDBFhAAAeAEDAHHB..fGHAhAHATAFF..gDDB.JDAB.hAIA......hBAA...,2,-28,-18,10
BVNWZdXKcDLfMQOTaASUEHbgJICeYFPRG,UFCEECFCHBBC.JAECIFFC..eFCEFDBEGBDBBHHGNEBF.hAAAdBAG.KFAHLDHHhABAMIFE.OHAEAGHESEGEhAAACACC.........hAHA......hAIA...,2,-33,-23,10
GHBdVFLDWJNAEOPbQeXTRKgSCIZYfMacU,OCCHQCBC.eHDAXFEARDEB.SHCECAECZAAE.MADChAAAaBGDUFCBBFDFFFHFhABADIGG.JBEDAFBBEAFF..hAAAPAHHKGGC.ICACfHAB..hABA......hACA...,2,-26,-17,9
XOEeQNWHLbCdAPMRTafKFGBDJIUVcgYZS,MECGaDAF.FGGHDIAC.UCGC..VFCH....gABAhAAASBBBEHGAQBDChAAAHAEELCDDhABACGAEAAFCRCFCKBADJFEE..YGAA....hACA......hAEA...,2,-30,-20,10
PAaJBKDRHgLOcbCVMeZIWfTQXSNdYEUFG,BDGFDEFEHACBOFEGCFBE..MICGZAAG....ICDATAACSGHDhAAAdEAEEGBCUGGHhAAAPEDFACIH.JAFFKAHDhABALAHB........hACA.bFFB.WEAC.hACAfGAA.,2,-34,-8,26
DaKeQRfZPCWcSHGdUELgBVXNYbTJOMAIF,FHFGKGCDeAFBQDGHZEEC..CAHG.SCAFdDBGLAAEBFCF.hAEAXGBA.bCBEhAAA...OAFHhABAABBAIGED.DDIDfFEDcGGC.HABEhADAECEB.....hAGA...,1,-7,-42,35
EAKZOHfMBDGdVQJUNcXCgePRSLYFTWabI,KDBDZDBGOHCAHGBCMAEGDIAE.GCDD.dHFBVACGUABD..XDGDhAAACBGD.eFCEhABAPFFGLAFB.hAAA....FAHH.aCAAEECFAGHF....hACA......hAIA...,2,-21,-17,4
EQDSbBICZRcTGFAaWYKgVLNfOeMJUHdPX,aHBGKHBGLDAG.OFEEMFEFHAGFdGBB.EGFBQBFChAAASEAHBFHECCEDZBBHRBAA.hABATAEFAAHB.WDFAhAAAYHEE.NAIE.eFFE.....hACA......hADA...,1,-8,-25,17
AISgZVdCTKRGYEfQWBOLMPJFbDcHUNaeX,SHBGZGFGCCFE.KCCARCADECCE..QAGGOFBF.PABGhAAAJFFG..DFEBHFFGhAFA.aFEGeBHFACEEIFBHhAIAdAAF..TDECfDGFBAFFMEAFhADA.....hBAA...,2,-29,-23,6
THCWMBKFPYDQegZSIbJNdOfLAUcEVGRaX,EGFCGCBDRAAB.aACBHDDH.CEAE.MHBABGAAKHGAFAFCDBAB..eCGBhAAASEGF.JBEChAAAdCDBOFACAIAA..hABA............hAEA......hAFA...,2,-35,-34,1
GJbHOUPBNDfKWZadYTIVCESeLMFXRAgcQ,QCBCJFEFHCFDUGGEBFGC.DGABKBAGZFCB.dAFH..TADChAAACGHF.EGAFeHEG.MBBChAAAFAGCAFAF.GDAFhABAODEF...NBICaBAHYCHB.IHCAhACASCGH..hABA...,2,-30,-9,21
IadbUXWKHLSOVTeFYJCcREfAgDZGNPQBM,ZFDGGAFEQBEEMDACdACGUBCGKFBBLAHBOCHB...VEGFhAAAFCADCHBF..EFEBAABDDGAEhAAABFAC..IEEAhACA...aHGE.....WGEAhADASEDF.hAEAeCEB.,1,-25,-26,1
VfIEHMgLAZaUBTWKSdYcXNGCFPeORbJDQ,UCCBTGGGKGHH..dDFG..XAACCBFDeAAERFAHDDAB..QAGEhADA.IDHChAEAHEFHgFBChABALCCBAFHGaFDDBGEFSHCG...hAFA......hAGA...,2,-34,-20,14
gEKPOHVWYDFLNScRGCQUIZJTdMbaAXfBe,BHHGEDCDKGEEHDFE.VEAEDGBGFABE.LAEASCDB.RAACCCHGhAAAQCFF.hABAZEFAJAEAdHEHaHAAACCGeAADhABAOFDF..NAIE.cFGB....hADA......hAHA...,2,-22,-19,3
XVTYMbDJOSIdRNcHBUWGfPKFCAELaegQZ,EEEDaGDB...eHFEQFFHZAAC.TCEGMFDBJBGF.ODABhABAdCAGNBBD.BAHA.UEGFhACAfECAKCDAAFBD.hADALBHF.XGAC...hAEA......hAFA...,2,-24,-18,6
QXDJPWdVAOcZUNFgIEbGSBCHMYTKRefLa,OFBBUFDHFCHH..EBCEGACBBCHHHGFCMDDG.KEEC..eHFAhAAALFDBQFAChABADDDEPAADdCAFAICG.ZAFE.hACA..NADF..........hADA......hAFA...,1,-19,-25,6
DPaAdeEWXMcUfVNYBSHOCLJGTQFIgbKZR,dEEDEDCD.MEIDUAFA....VBFEBEEAHFAGCGGGLBAGGABFFHGChAAA..bCFEZCCADBEFhAAAAECGeCAH..cGEHhABA...fDAE.NIAF.hACASHAG.hADA...,1,-8,-37,29
YKUBIZLQfNAFPHEaCRJXMVGWgbcTdDeSO,FCFCHDAGEDCC...CEGE.XEEGGEAG.bAFEdGFB.DIGAOBBGhAAAUACF.BHCFZAFALAAFhADAfFAC.AEHFaCGBhABAMEEF..gGGG....hACA......hADA...,2,-21,-20,1
QRfSNFLadWTDKYAVgeHIbJcZGBEUOMCPX,VFDFeFBBHCCG.JFEAZCADBBCBUCDH.MAAECDGG..QAFFhAAASCGAFHDCaGBHTBAEhABA..DHGGAHIB.hACAIAGD..cEBAEADA...hAIA......hBAA...,2,-35,-16,19
HDPRMUSCbOTgBZXLGQacFVIYfKdANWJEe,JGEAEDBDDDHD..MBIHCACE...OBEFBBBAZGFEGDBEQDDBhAAAFABD..IHDGhAAAfAFGAGIHeBGFhABAPAHF...SHAAgDDDaEGHhABA.cGDBYEAFhADAKEAD...,2,-35,-23,12
GZPHfIKCRdeQMELTaBDSAOJbXNFgUYcVW,OEEGJDAC...XAAEFGHHUAEA..VGCAGAAF.HFEDhAAAIFGDKCGARGBAdEEBhABAeAED.EGAA.LDAGhAAABAHGAEIB.gAFG....hABA......hADA...,1,-21,-25,4
dXgDONTeHSJAUEYCPZQKVFMfLBcIaWRbG,EGFCCFDGZAFAKAGA..MEEALFBH.BDGHaGGF.RDEDGABFdGADDDDA.hAAA..OFAHeDAGSABDhACAAECC.hAAA.PCACQACA.....hABA......hACA...,1,-29,-31,2
PDLIYBgXfKHbaeCZASTMNGEQdFWUROJVc,TAEDGBGAEDBC.QAEAFDFCREAG.OEDDJAHD..VGFGhAAAPFFBLBAGBACBXBBChAAA.fDFEhABAKDDB.aHAC.CHHGAGBDMFFE.dHADhABA......hACA...,2,-22,-1,21
DCKFJgZTeXREBaAUSfNOMQHPcYVWGdbLI,SGFCOGEAHDCB....PAFBVACAdBGFLBAHDIDEKBABhAAAFDGEZFAFTACCRCEBEDHB.hABAAIHEUCCF.MFEDhAAA............hABA......hACA...,2,-26,-16,10
GFNaePIHBdbJUMTROAfQEgXLCKYDVcZWS,EGFCXDACKECA.DCFHZEAH.GBCDFGAA.eAAHHFFFBEEBJEDFUACGhAAAMIBC...ODHFhABAADBAQCGDCBFB.hAFA..cAGANIBB.aFGAIAHD.hAAA......hACA...,1,-20,-22,2
eEJRKAZQSHPBFCYVTLcfWdXONDIGbMagU,SDAFBFDDCAHF...VEDALBBC..fCFBhAAAdHFFXGAFDGIFIBCFhABAMBADUCFHeCHHECCFKFGAhAAAAHCDZFAB.HGEC.FAHB.....hABA......hACA...,1,-4,-40,36
gYOVHbNSIAWCcXdafPJEFKDRQTMUBLZGe,CFDGdGFC.aEDHJCBC..ECDBKEBD..RBEE..MHBEBCHD.GDEBhAAAeDBBOAAH..hABAHGBESBBBhACAAIHAXAEF.FABE.TFGHLAHB.YFADhADANBAE.IGHDhAEAfAHE,2,-33,-24,9
QgMPZDcIHESXFJUVAaOWLGefNBTKdbYRC,OCCHGECFeAEHBFEGdCGH..bAAFCAEE.QAGB.PEHDhADADBACICAAhAAA.EHEE...XGADhABAFEAHJHAEAEBCaFFAfGEAKAGH..hAEA......hAHA...,2,-41,-12,29
bdHeZUNGFQPLWEgMSDcICXfBaRKTOJAVY,VAADdHBHeDDH.ZAFDGGAFFACB.LHFEEGFF.SEDEhAAADCHHCFBH.BBGAKAHHOAAFhAAAAEGDbCFEHADA.UDABhACA..NEAE..PEHD....hAEA......hAFA...,1,-1,-30,29
NRPQIOZGASUJCBWXTbcVdHLFgKeYaEfDM,SGDDJGFABCBA...TDFB..VDDDHACAFADBgAGBhAAAKAGB.YHFEhABAEDGHDGDB..MAIBhAAARCCAICAF.OFAFACGDCHFD..XFAChABAcEECeEAE.hACAfEHC.,1,6,-42,48
CSTEVXcDKfLZAaPRYQFOBWJGgbeHUINMd,aCFCRAADQECCBFHGGCCE..eEGDUFEBMIFEdEAA.CEHASHAAhAAAEHCE.VCDChACADIAAKACEZAGF.ABBDFAFAJACE.hAIA............hBFA......hBGA...,2,-36,-10,26
IdTQDCUKBXRLMeWZAaFJYGPVObHcNSEfg,aEEDJCCHGBEC..PGAAOHEAHDBA..SEGEhAAAEHEEfBAEdGBEQACBhABADBFECGHGBADFXAGAhADAMCCC..eDFGAHIB......hAAA......hABA...,2,-24,-22,2
BZFObAcEDTdCgXSeWaRVYGULNKIMHPQJf,EHFGdDABCFHB..SFDBeBGB.RCEAGBBFUFEGLDDEKFABMCABhAAAHFBB.JEADBFGChABAOACEAHAHDDID..XAAFhADA.aHGENIBF.......hACA......hADA...,2,-28,-16,12
NLCSGFAdEWYfDBKUVHQJbIRPcgXeTOMZa,dAFBEHBG.....fECHDDEGBCBFKAAGUCAEQDCHhAAA.JAFCRFFAgADDhAAA.XBGGhABAOHDAMCAF........hACA......hADA...,1,-30,-48,18
SWeVbUdQIgJMfKYXaPHGZDOTcNAELFRBC,EEEDLDCHBDHG.CCHC.eFHDUACG..dDACQFAEJGAG.KEFEhAAAaACHGGDFDAGBOBEDhAAATAEF..AICASGEDhABAbBAF.IECCMEID...hABA......hAGA...,2,-32,-19,13
EYdNOQfDcGTABLgUWFXPSHMJReCaKIZVb,BAFBLDACUCAAFEFC..SFFEJBGFRAAE..eAHBKEDCZBGDhAAAEFDB.dHAH..OFBDhAAADCDG..GGDDhABAgGGGPABCCBEAaEBB..IFBAhAEA......hAHA...,2,-31,-20,11
QSAFDNcTPIgaeKCLOWZBYUXfVRdbGMJEH,FHFGDACB...TAADIHAG..eHBACGBBLBDEOGAGBEGHhAAAUFFA.XCCGhACARCEGdECFGBAEEDABQEEAhADAAIHA.NEIGcAFH...aBDCKAGChAAAWCFA....hAEA...,1,-15,-28,13
OeGgJFQBdAXYEbPIfNKZDWTScHMaVRLCU,EGFC..bFEE..IBGCKAEDZAACDFAGSEDFHCED.VABHhAAALBGB.UCABhABAGEAAgGAChACAFAEFBHHGAIEA...........hADA......hAFA...,2,-29,-17,12
HKJEDdGCYFSfAbZPOTVIUMXaLeNcWBRQg,ZAADODAC..VFDGMCAGLBFG.eDHFNAIABABE.RFFFHFCAhAAAKHBAEDECGCDFhADACEAAFCDB.ABGE..TADFhAFAIGAEaHAE..........hAAA......hADA.WCCD.,2,-24,-8,16
IMVFCaXWQKDSLEJTeRgANPOBfUHdcGbYZ,OGEAUGGGdCCHGACGZCFE.MHCCFGAH.CDGB...aFCEQGAEhAAA.KAEASBFAhAAAEEAE.eEAEAIDE.hABABBDCfAGB.cCAAIHEHhABAWFFEDAFG....hACA...,1,-15,-38,23
LMAESOIQFKVcUGPCfZHdTJYbXagWBeDNR,EEEDOCCHFCGF.KCGDUCBFGEGC..CGHCZFAHdGAB..JHCE..XADBhAAAaAAC.BCEHhABADACARBDHABBC...IAFFhABA..........hAHA......hAIA...,2,-47,-34,13
GTXfQSVNUJdOeMFACHBZRPKIabLYgEWDc,BDCFZGFGKEGGaFHFLBFC..EEABDGAEGECD..XDBGhAAASBABUBCCdBEHhAAAeGDCAHGDCGDG.RCFA.PAHFhABA..IEEEYHAA..WCAFhABAcACBfHAFhACA...,1,-23,-33,10
DLFEOPCXfQcNMVJBgGadbATZUIeRSYKHW,ZCDBUDACeGAERGFE.KGGCHBBCLCAGOGAA..CBHE.QFDChAAA.MEDCBBCFaAHHhABAbCFDAEIH.SEAEhAAADIAAFCEEEAEA..PHEC.fHABhABA.....hACA...,2,-23,-12,11
dVYXFSafcbPOTUJHAQGKZeRNDLECBIMWg,GCEBKDBDeDFEDAEALGFGBHCF..MACFdAAF..VAEAFEEHSEBDhAAA.aEHFhABAcEDB.OHAEhADAJHFEABIDZBCBEEGB.CHAE.ICCC.YEAFhAEAfAGF..hADA...,2,-34,-15,19
ObXENVadfTFRSPIHUQKBLCMcWZAeYgDGJ,eGEADACBGBEEODEHEGFB..aAGFdDACFAACRDCD....SAHDhAAAIDFDUGBAKGAABHDBhABAMACG..cGGFhADAAGIB..YBHB.bCCB...hAEA......hAFA...,1,-18,-29,11
BQeYSaJfZEPXGMOdRbHVNDgTLUAcFWKCI,FHBGCFEDBECAQEEB..SCDAJEHHZACG.EGAFGBEDhAAAOFHBdCACHGCEDIEG.LACGhAAAAGAE.cDAGhABAWDCC...KCGF.......hABA......hACA...,2,-31,-25,6
THBcZeIaQdgYLAUEFRWbMPJGDfXOVCKNS,EFHBFCFCRFFB..MHDAGEAADBGH...XEGBVADD..KDAFSDCHhAAABHBDZBGDaBBBhAAAdADFLBBG.hABAAIHG.WDDDPAHDfEEENEEA...hABA......hACA...,2,-29,-19,10
WTBZVfQGRDdXgJLeYCOIcNKSbPEUHMaFA,BHHGZGFGQEBBGDDCdBAC..XEFDLBFBCDBB.OEBBhAAAIACGKAHH..bCGDPAHBhAAA.HAEBaBCGAHABhABAWDDB...fDHADGGC.gGABhABA..hAEA...,2,-24,-21,3
dgGWMJeQYCLTaUSFfHIbRNEAZKBPVXOcD,BCAHXFDHDFABGCFE..JBDGeFBCCHAELDACUAAFFHBGHFGHhAAA.RCFEABBDZAECKEAAOFFHhABA...dCDChADAWFAAMAIF.........hABA......hACA...,1,-22,-32,10
BZXVeRYdMDbHAOGQJTaFfcSKPCNLWUIEg,ODACGDDCJABCFGHB....SGCACHFD.LBHDhAAAUFGHICFEBACFXFFFhABAeBFERFAB.MBGDDCCBAAAFhAEATCDB.fADFKDGG.WFBDhAGA.EFCA....hAHA...,1,-29,-32,3
eWNHcZDdPKMIGYUXSTCBEQAgRfJFVLbOa,RAADFDCDLFGFOEEG...aCGBeGDEHDCHDAFBKHDEGBAEUFAE..hAAASADGBCGDAGAEJEHDhABA......hACA............hADA......hAEA.WAHBNCIA,1,-34,-37,3
ANRLeCgQBVGMWDYbOUEPTFKXfJacdHZSI,RFDFLEGHeCDH.CDFFBACGGCGG.MDAHDDCC.ODBDUAEA.EBAGFHBAhAAA..KHBA.XFFHhAAAJBADdAHE.HACEZEBEAGFDhABA............hADA......hBAA...,1,-5,-39,34
EfJaDAeUKMQLPYNGCRWcbOTHgBZVIdXSF,UAADMAEDLDAC..PADFGFBHRGBE.bGFEHEFA.BDEAhABAIBCFdAHGSHGEhADAfCHADFABAIFEKHAGhAAA.QAGGCCFBWFBE.OFFA.hAFA......hAGA...,2,-29,-1,28
TSLUKDBeZGEdfJgcQYAXNIWVPCMaRHOFb,XCBC..IGAF.PGDGaEFEHFDH.FBGCTDAAhAAALAAADBACZACDhABAdGABfHGDhABAJHFG.cCEAACACWCGDMIAAbAFE.KEBABHCGEAEC.hACAYECGCDHB..hACA...,1,2,-34,36
NOEPJHMTSBaFQCLDgRVXdUKbIYAfWGeZc,GAFEeFBBZBAEOEFBEFEB.HCCB.MFBHSBDHBHHHQAAFhABACBHGDAAA.REGHXADBhAHAdDGBUGGFKAFBIHDAhAIAABBG..fEED.NEAA..hBDA......hBFA...,1,-8,-25,17
cARgbJYHGQZdBEUMVLfSICFNKXeTODWaP,RAADJGEAGEDGZCAF.BHGDUDFALFAF..SCEDhAAAFADCKCGGeDCFDCID..aGBBAFID.hAAA....bADA.hACA....QABAEGBBMCDEfFFBhAFANEAAODDH..PHCChABA.,1,-21,-35,14
GRcJHIQCELDYUXVBdfMZbaTgeSNFOKPAW,GEDHRFDFHCFDCGGBEEBALACDUBECBHCH.dCAFMFIBZAAA...aHAGhAAATBGFeCEDFEBFKGHFAGEHhABAJAEA..DEID..hACA.XGABfBAE.....hADA......hAEA...,2,-18,-12,6
THdLFDfZcMAGeEBRPWSOgJCNQbXaYVUKI,eCDGBHCHRACB..SCBGJAFE.CHBF.QGEB..hAAAXABFaEFC.YAHBhAAAKCGFHFAGFHEADBIHhABAfEFDMEIBABBH.GADF.WFFAhAEAOCABNGAF....hACA...,1,-16,-31,15
XFNSKUCJHEeBLGAVcTaIDYbgRPZdQOWfM,TFDHaHFG..DHBG....bDFAgEGDRBDHdDAB.QCBBhAAAOFAHMBACNBBH.hABAKGGEUAGHCHFDEHCEBGDEhACAAIHEICGE........hAAA......hABA...,1,-19,-33,14
BYCgfPGQLAcKEFOWTbZRdDUMVHNJeaXSI,KAFBEEEDFCGFOCDF....TACGZFGFDCAHMBFCHAAD.eFCHhAAASFHDBFAGCBHG.gGAAhAAA..hABAfHEBQEAFACCHbDEDdCCDNICB.aGECIEBGhACA...hACA...,2,-24,-18,6
dWMUBKFAERYePHacDOQTGSfJLgIXVNZbC,ECFCRFDFeDADHBBC.aFGADDFC...OBCCTEAC.GGABSHFAhAAAfFED.hABALABCXDGANEEB.hAAACBHFMIAABHHEAAGF........hAFA......hAHA...,1,-6,-34,28
BPCDTeAIXMQOZHEfgRVdULSbWNGaKFcJY,MFFFOADGZAAFHEDE.EBCBREAHUAFFLCHF.SGCDhAAA..NCIAaADHKHGGFCAFhABAJFDF.BCFC.CAHDTGEAhACAIDDE.XEFB...fHGBhACA..hAEA...,2,-39,-8,31
FDKfEPOgZBACaeXILUYSHdbGMNTWVcQRJ,eCAFXDACUCDDHFBFdGBCGGEB..TFGA.WEDEhAAAQAGC.REECDBBGhAAAKBFCfBBChABAEDHD.gFDEAECF.ICDEhACA.LAHB.hABASHEAMACE,2,-15,-2,13
fULbHBOgIZeMPaERQDYSCNTdcJFVGAWKX,XGBCUDACLEFGHEBABEGBODDBZAED.MAIBaHGE..EGGARACDQGDChAAA.hAAASCACCACCTGDGJAEDhABAFGGGAAEBKHBGfEEBICGEDBGE..hAEA......hAGA...,1,-1,-24,23
eMdXLJbANSEVOcYQaDPRTBKCfGUZWFgIH,SAFBEDBD.OABCQAAB.aBFCRDADTFDCCAHFGGABhABA.UEDAFDFC.ICDFhADAMIBEXGGHhAAALFFBAEDDNAIE..YFHFDCDEKCCD.fDFBhAEA....hAFA...,1,-15,-16,1
aYKLAWIFbdEBgRXNeVfCMOPJDTQZSUcHG,FHBGdAFBBCDGRCCC.eEFCCDGB..MCBDOEAC.DAEBQABFhAAA.UGFEHAAFaFCAhACALEED.AGIBIHCBhAAAgAGHXBGEfAFAPHFChACA.....hAEA...,2,-35,-22,13
gQFdPOXTKeSERCWLYAUVIaNMJfBHGZDbc,VEFHaHBG..MGFCBBHCHAAFDAAH...bCFBQDCH.hAAAdBCDODAEKBFHSFBGhABACHEBLAHBAEHC.NGAFfDDBhACA.cADBFHAEPHDChACA......hADA...,2,-35,-4,31
ILBSGHYCEQfRgJVDXbMUTFZdKONAPaWce,aHBGeGEALEFABBHEGBBGHAEF..CDCCQEADRDFGJHAG.XBBGhAAAMBAHFAFDKGGD.hAAAAAHE....cBGAhABAIFDHEEDD.fFAA.DIDA.hACA......hADA...,1,-14,-29,15
PYHERGVMFJZNgUDfACKBdIXWOcaSbLeQT,KBEEdEGD..XGGEODCH..SDDEeCBGTADGHFFDEHDARGCAMABGhAAAZAGH.UAGEADAFCAABBFDEhACA..IDGGhAFAaGCB..........hBAA......hBBA...,2,-27,-20,7
gPHNJGScBDTaIWYRLEFbUVfOZQAMdCeKX,CBGEKAAD...XBFBHEFFJFBHGBCCBBBBDEEDaFEG....IHFHhABA.RGAEEEAFhACAUADB.fEHGhAAAODGFAEEGMEIHeECBPCABSAEC..hADAWCDA.FHDE..hABA...,2,-39,-5,34
KbMDGNPgAfUOQFXHBLCZVETScWaJYRdIe,UDACQAADFAAFBDDDZBFDEFBG...TGFHSGGH.hAAA..aFEDYDCEhACAdAGAKGBE.DIBEGACFhACAPDHFAFEHODHDXADCCCEH.WGAG...hADA......hAFA...,2,-32,-7,25
eXTWKCZOaLQMGIJRbcfUPNgYdHDBVFASE,SEEDEGDD.eAACTGAG.KFGBCGHDaFCBMEFD.GAEHhAAAJDGBRADG...bABDfAHAhAAANBAC.dCCDDDEHhABABHAE.ACBFZGDA.......hADA......hAEA...,1,-18,-23,5
KTfcNdDPLMHBOeRFgSUGYAbEICaWJQVXZ,EHBGaEGD...QDBGVEAH.KCGCTGDH..fAFFhAAAdBBGDFEAMAHDOFFEhABAFADEUCCEADADCGDAJHEE.ZFAEhACANAAE.PBBABGHA.eEEA.....hABA......hACA...,1,-1,-25,24
EcbMDQgWUYFNeXPZRaSdBLOKTfGCVHAIJ,EDCDMCCADFAG..QFACUFFE.FGEBXGCCZDFHRAAF.dAEDLCHHhAAAKBCH.TDDGhACACDGGAAAB...cEBAhADAgAGH..WHAANIDB..aCAHOAEAhAIA....hBAA...,2,-34,-14,20
CbSQRMAHegKBDdZVOEFcTGaIWLfNUYXJP,HFDFKDCDDEIHdDDHZAFFOBHH.FDADGAAC.aGFGLFGFhAAA.NBAF.XFDBhAAA.JADFPFBD.hACASAGCMEECAIAABBHC.EFBB...hABA......hACA...,2,-27,-26,1
fREZaGbMNBUgWOYQXeFJcKDVLCSAIHdTP,HDAGTGBCREDGEABE.ZCGHaBDDGGAF.MIEANGEBBAHA.UDGGhAAAOBFH..XAEFhABAJAAFDHGGCAGGAADFPBBFhACAbADB...........hAHA......hAIA...,1,-4,-29,25
RVNBKLQTdEZDSFPbGMCXWAeaYUHgfIOcJ,aDCDHEFH...fFBAOBGDRADCBHGGLDBCdEFC.EHDAZABBSGADhAAAFGAG.GABDhABAMICACGCAAFIB...hACA....eBAFUAFEIFHA.hAEA......hAIA...,2,-29,-10,19
RgABMPQXUFfOacTKGHDZNIESLYVebdWCJ,BBFDQFDBUACGFGDBOCCC...TGAFKFGHDCBFZBAH.EGGGhAAALDDC.eCHBhAAAdDHCCEAD.gAGGhABAMAFC..PHECaADA.HEBENIEBSCFHhACA...hABA...,2,-37,1,38
UbdaOZgGEcSJDCXPMeWNYKFHBIRVTALQf,LDACQCGCUFBCdEAHOHAAZFGFGEEAEABG...JBCADADCCDGA.hAAAXFDE.MIFGhAAAeAFC..NBEAFAGChAIABBGA....IGGE...hABA......hACA...,2,-32,-15,17
MIJOTYGAVUSgcPLDeQdBZFabCWNREKHXf,SDAF..gDCHLBGDQACAZDABaGDCCHBBRAFHHAAEhAAAMIAGOHFEhAAAGEFCAACEVDDF.UFGFhABADAEB.BBBD.WGAENBIC......hACA......hAFA...,2,-16,-13,3
eMEQNaFIZDCJWVbdgGBAXTfOHScULYKPR,XCGCTDAC.HBACUADDKCEBRGBG..EAAGaFAA.ZEFGDFHB.CECH..hAAA...WDAGdAGEBHEAhACAAAHGOHCASEEDhAEA..cGGH.YABChAFAMDGBNAIE.IBHG.hBAA...,1,-13,-29,16
EfSNFCVgbKWJLAaMdHTUcYDOGQeIBXRZP,dHBHTDCBUAAD.DEECQADD.BFAFREAEZBDAEGBF.SBAGhAAACHFG.VFDHhABA.KAHFWEHHABBA.HFDAhABAYBGF........hACA......hADA...,2,-44,-21,23
BIfCNJFLTAeOPKEUVcWMYHdXbgQZSDaRG,eEEGKDCDUAGB..VEAAMDHDdACD...XGDGQBAGhAAASHAGRGEEBEEHCFAFFBHFhAAAABEH.EBAG...cGGFhABAHFCD...bCDGDEIBaAGGIHAEhABA.fACGhADA...,1,-3,-35,32
bSEILXdNDCBYUQVATfOKaGJRMHPWFZecg,TDACKDCDGEEH.MEAHHFBG.FAACeHCG..gFGDhACASGBCECDALBDEhAAANICDCBHDBCCC...YADEhAHAQBAFAEEBaFED......hAIA......hBFA...,1,-13,-23,10
gAaPdJbVNERIfeXKcCQMFOZYBDWTGSLUH,aAFBJCCH.....VDCFEBAARAGB..eHFEKFFD.CABE.QADBhAAA.OEHHBCGETGBEhAAASFCDLFFEhADA.gBDDAEGHdEACNIEB.XGDDhAEA.MBIH..hAHA...,2,-25,-25,0
YGETaSWXUBMHRDVIbAdPOJQNLcfFCgeKZ,OCCHJDACLGDGFGFA..CBFD.KHGAZAACGACB..EDGAaDFCSAEChABA.UFDChACABBHA.HFADDHAC.hADAIAACAIAC.dFFBNEIC.fCCBhACA......hADA...,2,-32,-29,3
MANJKCEObQaGYegZHXIPcLWBUSFTfDRdV,KDCDOCAFQDGEGGCHeACGHBDFXGFE..IFGChAAALGBEBAFBSAAAhAAAFDDBDCCGVCFGhABAAAFGNDAECBCHEHCEaHAC...YBFE...hAEA......hAHA...,1,-4,-24,20
QFAcNGYdIVCZEPUHOgWeSbDaTXBfLRJKM,GAFEdHBHCAFEZBEAEGFD.UDCAHAAF..OABHeFFADFBA..XEGDhAAABDED.LEBDhACAKDGDMEAFABIBNEAAIDCFhAAA..VACA......hAFA......hAHA...,1,-15,-35,20
UWgRVXCHKBNYMDFAGOTSLdEfaPJcQIebZ,GDDCTAAD.LBDEdDGC.EFADaEDHJFGBQAEH.IGADhAAAeCAGZCFCUCAFhACAWHCARFEFCGHHBAAC.MAEChACADCFHACIB..fDAE...hADA......hAEA...,1,-13,-19,6
RJGEdacLSgHTXCFZMBUPNOKDQWYfebIAV,VDBGRFBHEBFF...dFFDaDDCLHCC.HAGDTBACCABG.FGECZAEHhAAABADG.UGGENEICDGADhACA....WEFAhAAAeADDAAGC...........hABA......hACA...,1,-17,-36,19
cENGXLQSbfVJdIBWOAKFTRYaCDMgUHZeP,FFAAREFHCDHG.MDFCHFCBZAAF..eEAB.EFHFXDDHLACBSAGHhACA.VADGhADAJAGDBBBF.AFCB.YEGDhAGA.DIGAPBEB....hAAA......hABA...,1,-24,-26,2
ETOagReYXbAVKdCSWPDcZLGJFfHUMIBNQ,VFEEKEHBCFAC.....SGAFDGCFLADGJBDD.HFFB.UCDAhAAAMEEGBCCGEBBHaAFDhAAAeCBD...XFDChABAAHBCdADB..WDHBPAHB....hACA......hAEA...,2,-30,-30,0
ReCaZdJYWAXfEKUPBIbVTNOQFLMgDHScG,EGFCUGBCBEAA..IBHA..bCFG..TBAFOCBFhAAAFGDELDDBDBEGHDAGhAAAcACAGEEDCBHDdHAHhABAYADFABBFKEHBNAEBMDFC......hABA......hACA...,1,-17,-22,5
HPLDXKRaFTNVMgYdEQcSCfeUBWZbJOIAG,GEDHHFDFLACGKDAERCFC.aBHFFABD..VFGBMECFdDCF.QDFChAAASEHBfGBHhABABGGE.WDAHhADAbAFC....IGAEDIAANCCB....hAAA......hABA...,2,-37,4,41
YSNMLHAOaJKRTZDWeUVXPfCIEFcGgQBdb,aGDBJDCH..RFGH.ZDAA.DEIF...UBBFVAEA....fCGDhAAACHAAECGC.FAGA.hAAA.gABHhABAdEEHSHGGMEFFAEGHKCFFeFDHIHEE..hABA.cFAFBDDB..hACA...,2,-38,-29,9
ZIcGJOBFbSWfQKgdEHUTMRYDLNCXVeAaP,aCFCZAADGGCFBFHG.FBFG..SFAFQDGDdBBHUEBCTECChAAARFGDDAFGLADBhABA.CGECeHEAPCCEIHCGhACA.OEEAfEEEEBGE.MAIFhAAA.NEAE.AHID...hAFA...,2,-19,-7,12
ONSYMBFJHeAPVUdKXbgEGIRCTWLcDZQfa,UFDHKFAA..XDEHEBHDRAEF...TAADLAACZGEEaAHBSEAChAEA.MEDChAGABADCFGGHeBDH.AHIBdCADhAAAgBBECAFHDDIDfGCCNEIC..hACAJHAC.....hAFA...,1,-14,-26,12
QPNAgfSBVcLCEaFDGIZJRTYdHWXeKMUbO,SHBGVDBH.CDEC.aAAAGDGAZGDCRBGF.dFCDHADA..XAFHhAAAMGFCOHACQACGhABAACCCBDACEEACIEEHhADATGEA..eAHB......hAEA......hAFA...,1,-14,-16,2
eYEKcaIHCVRLfdBMAJTGSFDWUZNbOPgXQ,JDACGCEB.DIGEUGGFZAEA...OBAAXBAB..eHAAhAAAEFECKFCCaFFG.HACBCFDGLAGDhABABFABAHADFEHD.hACA.NAEE....gFAA..hADA......hAFA...,2,-32,-24,8
ESGNePZVHYIcBdKgOQfWMCaTXFLURAbDJ,DEFHJEGHGACGeDBBZEDFHEDD....IAHGBDGEdHBFKBAAQAFGhAAA.fCBGhABAMAGDCHHAXADAhAAAFEBH.LCHFAGID.EEABNCAE...hACA......hAEA...,2,-29,-18,11
SCMIdQGLTEZaKPAcHDWXOJbVNgeBYfRFU,DHCEXDACOBGH..JAAE..VGFAeFFBBCCGREGB..FCDDCBED.hAAAdHBFLBAEZAGFKGEFAAIFhAAAHEAB...NCIE.hABA..fFCFMAEAIEEG..hACA......hADA...,2,-30,-23,7
YdJfFDCGPWTeKcHURgIVLXENSMZaBbAQO,QDACdDCDJBBG.FBAACDFD.GECF..TGDHKAECUGGGRAGB.hAAAVBGDLFCC.hAAAEFADMHAABBFDAFHCfDEBhABADGHD..WBAF....hABA......hACA...,1,-14,-39,25
HNSMdPTCXDIRcEJgWUGALZOBbKVaQYefF,OFFCKEGDQCAF..fAGEFAAFHFBBSFEFhACAdDFFCADBDBDFRGCA.JCEAUBAEABFEBHHGhADAaECF...NBIAMAEEhAIAPFAF..XDDCIHHC...hBCA......hBDA...,2,-25,-18,7
cWLQgFfCUNKDTXAZSRIVEOGBbMJPYdaHe,SDAFRGFGEFDG.OHEABGBCJCCC..dBBFeCFELAHDhAAAFCAB.CBFFKEFGDFADABIHIGCEhABAGDEF..MBBAhAAAaEDF....cFAB...QCEBhACA...hABA...,1,-20,-35,15
WdIDbANMCEBFOeVfTJcSHXaLKYZGPgRQU,MBFHEBEEBHCHFDCD...OCADeGEA..TABGJAACHDDG.LGFAhADAKDABZAGB.PAHDhAEAQGAG.dEGFhAAADCCHAIHACADEfGACSEDHXDGDhAFA......hAGA...,1,-15,-23,8
DIGXQLCdYNKceFVAERgbUOZJSHfBPTWaM,ECFCRAADUGGEZBBCHFFBBEEF...TGAAMIAEGGCHLDHBdAFCKCADhAAA.eEBCAFFG.bFCHJDBDhAAA..SAFChABA..WADHDFEB.XCGA.CACC.hAHA......hAIA...,1,7,-32,39
KUZSBMGNPaICAbLVWcegJHORQEYdDXfFT,LFBBVAAD.eEDBJGCG.HAEH.QABCdEBCDIEEFDEAKFFGZAEChAAAMBHF...PHFAhAAAIFHEAEAA..hACA............hADA......hAFA.cGACODHD,1,-10,-42,32
MOAZaVGBcNKWCHQUPSDdXgfFJLIbREYeT,aDAFVCBFGECA.BEFCKEECCHCEHGFE.UBCDDEABdBGB..fAGAhAAALHFERABEeCFAhABAODFAABBF.ZFBE.hACA.cGAA........hADA......hAEA...,1,-16,-34,18
UaTIDOdGBNWXcMQKgReFECYLHAVPbJfSZ,VAADJGEAZCAF..UGGE..aADCDHCCGCDDBEEH...XGCChAAAMEAFKDGG..eBHBhABACBGGLFBFAIFC.hACA.PFABSADC.ICEFhAAANAEBWEEG......hACA...,2,-44,-19,25
RAYUKVgEIWafZLeSOTFXCdNMHBcPQJGbD,KGFCVDAGEGCH....aFGEZDCALBGDOADHFABHCFFC..MCAAhAAABFBH.QBFGhAAAJFDDDIEEABIH.....hABA.gADGIHEEWBHBSGADhACA......hAEA...,2,-35,-32,3
KXeWVaTAPGcdZFYSObJBgRDIUEQNHMCLf,GAFEdCFCFDBE.SFECOFFC.BHHEDFAF.EACBHADDLHDEhAAAKHCA.eBAFaAAFACHCPFAGhABA.ZCCAJHFAIHAEhADA...NCIE.fGBF.hAEA......hAFA...,1,-6,-39,33
PFfGVZQUTCMASBKJcRNDEXIYedbaWLHgO,SEHBJCAF.RFCA.DHEE.EAAE..XAEGeCDCdGABaHFAHDEDhACAOBCDFDCH.GCEHhAAAZDGF.TGAECAFFMICEhADAAAGE.BHHGKABHIDAE....hABA......hADA...,1,-21,-22,1
BaSPYAOVDIRQKdNbeCFXgfGUJTMLHWZEc,VAADRFDGKGAD..dCEGeFCA..CACG.FHCE...XAFGGBFA.hAAAUGGDMIFAHDCAEDHFBAEAhABASGAHAHGAOCCBhADAICHA.NDAE.fHCF.hAAA......hACA...,1,-19,-30,11
SHNaZGOFIUXAJKYEdDRBgbLfTQVeMCPcW,KDCDEAFBDADHBHEF.LCABQGEG.eHAECGDC...PDDChAAASHAA.aEEChAAAZAGB.FBAAUGGEJECFdEAEhABARABE.bEFATCGG.....MAEChABAWCAG....hACA...,2,-30,-11,19
XBVfLaPKMIYJQZGFdATOSEeUbWRDgNCcH,TGGDOEGH..EECCeFBB.UCAGRACGDFADCAHA.HGCGBHAALBHFhAAAKHEA.MBBDJDDBGCFGhAAAAIFASGAH.hABAbCCEgADG..NAEF....hACA......hAEA...,2,-25,-6,19
FQZUIYdBMADgfWHOKVGbPCcReSaLENTXJ,DACB..fGFCHDFAOHBEKDEDGCGACGAGRBDD.SAHBhAAALGCCTBGEFBDCUFBFhABAdHGHACADVCBF..hACAcDBHeAFB.NBAA........hADA......hAEA...,2,-16,-11,5
INBYdHAeKfTPJRgcCEUSLFXQDZOMVGWab,KDCDTCBCRFDG..CFBG.SBEDLCHH.FDGBDIAGZEAG..MEEEhAAAVGBC.GEEE.hABAbAAGNBBDBHHG.dAFAhACAAAECfAHA......hABA......hACA...,2,-43,-14,29
CYSBdDJFXWUVEQIbLGaHROAcgfKeTZPNM,...fHBHKGDDeDCEZFFEMGECCAACBBCADIDAFDEB..UCGEQCBGhAAALCAHaGABHAEEhACARACEAHIB....gDGFhABAPHFC.YAFCdHAB.WEAGhACAEECG......hAEA...,1,-16,-23,7
UVQcgMSJbYdfPZaHRBeGWETOFDKACIXNL,XGGGLDACUEEG.QFACMGCCJAFCdEDBZAAERAGFBAAC.hAAAGCAEEECDFHGGACAFCFHG.hABA.IEHF.hACANIAF.gCFB.SHCAhADAbBCA.fBBBhAEA...,2,-35,-2,33
JHGDEgUSTfKVcPBNZdbQFRMAXWeLOaIYC,XDACeEEGOHCA..aHACCACGHAGFGGCHDBEDEBHFUEAD..hAAASDCHKHGA.hABAPBFDBFDE.dACGFGADhADAAIHAIFGG.JAAH.TFAAfCCEhAEANDIE....hAFA...,1,2,-29,31
LdTWXGDQZbEcOJUMgSYVfCPKeBFIRAaNH,aCFCHFDFLEGBdBFHXDFFDCAF..ZECGEDCFOCBEUABAMFADhAAA..SAHDhAAA.VGCEfHFHhAEAKAFBFABDAGIDNEBCWFFA......hAFA......hAGA...,2,-21,-21,0
GeIXfaLdMWVFSJKbHONBADgQYRPETZUCc,DAFBQCBCRDBG.EBFCUEFGGFEBeHFA..IEHFaACGdHAD.hAAAVACGFBDH..KAGFOHAChAAABBAC.ADGC...hABA..PFDDCCADcFAA.XEDChACA......hAFA...,2,-32,-14,18
WZXCKVbLfgYDENHIOQaMGAFBSRTdJcPUe,FEHBSGFHdADE..JAHBUBAEZEDH.CCHFKDDGLHAE...hAAA.fEGDhABADCBDEABEHCEDOEBF.MFDGhACABGHATGDHeFAE.WAFA...XGADhADA...hAAA...,2,-31,-22,9
eRCTHLdYZKMPNcGJSIDbVfEWFgXAUQOaB,UDCHQGGDOAAFeBAG.RFCD.HGAGLBEFdFGHZAFFKAFCMIEGhAAA..NEAEGBGEhAAAJACFDEBH...fACFhABAEGEG..FAEHAFGBCCFC......hACA......hAIA...,2,-19,-10,9
GeRHFQTYfKZUPOBdNMbJEXSDAgIcWaVLC,..IFDGaHBGLEFAGGEBRCBCFBAB..QDBG.hAAAfAAGZAFGPHEEhABAOADFNFAD.JHAEEGGGhACAXAFFDGDGAICAgCGFWBGHCFGE...hABA......hACA...,2,-25,-11,14
eRGZTJFBIXdUNEgMfQHKVaLcDPOWYbACS,eCAFGCBDZDEHFFBCBHBCdFEDUAFC..EABAMHEAQEGFhAAA.VECF.aAHHDBIFhAAA..OHEE.hABA.bABACCCDSBEAJDHFNIAB....hABA......hAEA...,1,-19,-27,8
NDOVeAZBTSXcaQUfELHCWMGdJFgPbRIKY,BADCTFCASEFA..aEHDUBGBECFBCBCFMAAFGCAAJHBG.hABAFADA...bGFCIDCFhACAKHAE.DCFDeAAFhAAAAIHAZBBEXAGC.cEEFfFBBhAFA.....hACA...,2,-33,-12,21
PBDJgGZERFIeXWAcYOCHUNfQMTLadbKVS,OGEACFFCHAECUFCD..fECGMCAGLFHHdFAAKHCCSDBGhAAADBACGBDDEDDGIHHEhAAA.XDEEhABAACIFNIABaFAD...PACABDFE....hAGA......hAHA...,2,-27,-17,10
gbFPDEAQJTKaWHdIYVeLUfRXZGNCBcOMS,QDCHTAAD.aHACdGCF...IDFAeADGUAGCRGFEGAEDhAAANDFE.CDBG.BBCFMIDAhACASDGHFDHF.hADADIFEAFAAKHAAHBABLCDBXGGA.OFCDhAAA.....hAEA...,1,-6,-14,8
AFTXLIYcdUZGQWVgRPbSOKeECNHBaMfJD,FEHBTDCHLGBC..IBGHdEEDUCDDQABF.hAAAVFEEgBAChABA.RAFASEAGhACAeFBBEGDDCAECNBIAaGHD.MIAEDAGAAIHG.XBEDhAAA......hACA...,2,-17,-16,1
MdPKfSAUYTHZbVJLeCBacFgQDRXEIGNWO,UCGCHEFHVBACeHAGBCCHFGCH..DGDEEAADGAGA..OFEHhABAMEAEKGAFABGAZDACJFHDLFGDhACA.aGAA.hAAA............hABA......hACA...,2,-29,-26,3
DGcYQUgAbZETONVMJfCaHWPdXLBSRKFeI,ZDAGEGDD.OFFBMFHD..CAGD.aBFHHACG.dGFABBAGKDAA.eHBADDEF.hAAAGCGCQFAGhABAAEEE.TCFFNGAH.fCCEhACAWBBE........hADA......hAFA...,2,-31,-17,14
GWOPLdbJKfSMARBDNTZgIaUXEcFHCQeVY,BAAFDAFBZDBGaGDCUACG..EEEBFAGFHAED.CCCB.QEGHhAAA..VBGD..hACA.WEAAPGCAdBBCJHAAhADAfCFCAEGH.NIAH.IHHE.hABA......hAIA...,1,-19,-41,22
ZagSTdJHICBRPQVLeWMEGOcUADKFYXbfN,FGCDXCBC..NIEF.aAGF...SECAJGFEHCEHCHAFBGEChAAA.RFFHQGBHhABAeCCHMAFAGAAFUACEKBFDhAFA.fDGEZDAHdEGF......hAIA......hBAA...,1,-16,-19,3
RGXJIUPYcNHfCBLFSWDOVEATKebZdgMQa,TGGDeCCHdGAA.QAEAGABH..IFAEUGDA.PGCGhAAANFEBHAAF..BHFDhABASDFE.DDAFhAAAVDEAAHHEKAHF.........hACA......hAEA...,2,-31,-15,16
CGPVTXcUFZJKMIbNLODgQHSRdAaBWfeEY,BFEDeGEAEECGCBHEGCAF..TCFCUGBAZDFGKEAFMIBG..hAAAIAFGLFFCDGGAhAAAHCAA.RACGAHHFfBEGhABAYAHHPGBAXACB....hAHA......hAIA...,2,-41,6,47
JdCPQBONFfGLaTAKSgXMZeHVRWbcEDYUI,KAFBXGBCMDCAZAACHDEH.RBAB.....bFCEEFCG.DAFAUFAChABAIBFACDAB.PHEEhAAA.....hACA.BHDDFGGAfCCBaGFDAHHDSDEAhADAeAHF......hAEA...,2,-39,-9,30
TaVJEeObKHAQNGIZLfSRMWgdFXCPYcBDU,QFGHGAFELCCHRFCG.MFFAdEEHCDBG..PFEBBFADDABEhAAAUGGHaDHFEACC.eBEDhAAAKCCHAHBFZFAA..SAHDhAEAWAHBFBAB.XAEA....hAFA......hAIA...,2,-36,4,40
COdJBKDLWXEScQUFGHPNZRaYTAIbgefMV,..IFDGbFDF..eDAFMAADCAHDOECHBAHHDIDA.LCBChABAEFHDQABGGEAEHFFAhACAPBFBNAFEaDHHACDBfGAAhAAA.dGFE.KDHBSHCChADA.....hADA...,1,-10,-13,3
ZPTfWKOGcVHIDSgRbFBaeCLJANXUYQEMd,XCGCUCGCQDADdFHEZFFF...TGFHKBDHOFCFGCDCHBBFhAAADBFGRABHBGAC.CDEAABBFhABANADF..MAAH..hABAWAEE..cGDCIHEASFGEhAIA.....hACA...,2,-31,-5,26
bICYJOEQcKBVeTdHafFGWSgPNZDAMRULX,MEIBUBDGLBBF..bFCBCGCDOAHHEAAFKFBF..BBCEeEEFhAAAHGEEFHGG.SDDGhAAA.NBEFDADGAGAAXDGEhABAJCEE.........hACA......hAGA...,1,-21,-38,17
YUbKHTCgBEeWRGAIQcdfaVMJZDLOPSFNX,QCBCdHBHaAEH.MDFHZDBBDGFDLBFE.SGGAhAAAXDGEUABFKEGACBDGEHDAREDFACAF.hAAA..ICGAhABA.fFAFVAFE.OADGFGGF..hACA......hAHA...,1,-19,-22,3
BeSfGaYdFXcObHgCRWJDLVMUNQPTAZKIE,ZDAGKAFBBCDCSFHFGFEBdGFG..FEAF...OABFHEDHCCBFhAAARCGB.DBIFLFDDhAAAUCFHPFAEABIH.EADFaBAHhABA............hADA......hAEA...,1,-23,-34,11
gXDVeJKaPcTLROdINbHYCBUMFWEfSZAQG,QFGHXAGHDBAGeHCG.KBFH..aBEFTACGOFEGdFAF.hAAA.IHEBHCDDBDGAhAAAFCDDEDAFSCAGhABAAAGFGFADJAHH..cGGA....hABA......hACA...,1,-9,-29,20
OUQYZGTbfPScKEMDgHFJVIeNCWRdALXaB,XAADOCAFUEGBZADBGDBG..bCCE..fGHChAAA.SEFAhACAcECGKABGDICEFBGBIBGFhADACHEGdGAA.aFECBHGH......hAAA......hABA...,1,-15,-34,19
YLdJMDEPHSGVFNcZQfgOaBWATUebXIKRC,TDCHUDACeCGB..XCFGKABEREDFLAECdHBBMHFE.EFAGSAHHhAAAFAGG.ZGFAhBAA.QGBChBBAfABHOCCABBDDAGEC.IEHH.CAEAJBAFhAAADEIH.....hBDA...,1,-12,-14,2
ZNWdVKCDQGLPMJAXUeERSHIaFbTfcOgYB,XDCHUGGDRGCAHBBCFGFA.....fDAAOFABBCEEZFAGdBHGhAAACCHEDBCBLACEhABA.JEFGAEGBEGBF.aGDDhAAATCEF..YBAD.NBDF..hAGA....WHFAhABA...,2,-48,-3,45
GSKFRfIcNXTBHgPMAadJbWVDEZUOYeQCL,aEEDJCCH.....VCGBZFFBUGCD.eADDQAACLBHFhAAAKDAEFAEGIAEGhACA.XGAABBAGPCFBhABAAGHH..dAGFDGBFEECBCFHA.....hACA......hAHA...,1,-21,-31,10
RCPBAZecgUbYfWQILFETdJDSOHVKGMXaN,ZFDFeGEAUCDG..bCCH....fCHEQGABFEAHdDABhAAADHBCOBEE.KEGAhABAGBBAMAIBXEEBhACAaGHBCFFEAABG...YACGIAHC.LADEhAAA...hADA...,2,-26,-18,8
NfdUXZMBQeAKHDTGagCSWFRcPLEJVIYOb,HFFAGACBaAHHCEGDFCAARFCBLHFA.EEAHIAHE.OEFHhAAAbAADdEFF.ZACEMEEFhABAeDCAAIHE..DIEE.SFAGhACA.PCEC....hADA......hAFA...,1,-1,-35,34
AYQaDcIfREUKPVONZLGJMebBXTHCSgdWF,aGFCDACB....IHAGRBFBEBHB..UBDGKBFB.OFAHZDBDGDEAhAAAeFFEBHEDHDGDSADAhABAdBADAHIB..hADAQDAEcGGCfAGB.NBBAMEDDhAEA....hAIA...,1,-22,-23,1
JHGZNIXTCRYDgMQUEPcdbFLVBOeaAWKSf,KAFBJCCHZFBG..XFDBRBFH..DDBFMAEBUFFF..PCHHhAAAdADG..FHBEBDCDhABA.aHAASHEAhAAAHGFAIBCD.CFCG...YBADhABA.EAHB....hACA...,1,-28,-38,10
McYNIODHBfALQJWETPCegGXSRFZbUdVaK,LFCAQDACEBADCCHAGDDCRBFD.FGAEZDBG.dHGFKFHBMEAB.hAAA.NCAH.DBBEBDGGABHDJHAEhAAA..TAGE.hABAPABEXADB.SEHF.hABA......hAEA...,1,-19,-27,8
RIWTGgdOMVBPELeUXJNHZcaDFAQYfbCSK,QCBC..YDCHCFGCKGBARECE.TBAGdAAF..MFIDhADABCHHLHEGUGGEJEFAhAAAHAFGaADD.ACIBSAEChAIAIBGDGGAF.OFFHEDGE..hABA......hACA...,1,-10,-25,15
WfAHSJLQOGVEFcXPCTMYBbdDIUKZaNgeR,HDEDJFFBLAFCGGCBFBDB...XBFBCEHCMFCGBDBAdGAAIDAFhAAAUABG.ZCBFaDEGhAAAeDGH..RGBAAGBG.hABA..SHGA.OEABEHGA.hACA......hADA...,1,-8,-30,22
dgDcQWETRYZAJMCLNPBObISHKGVaFeXfU,CHFDLGEABAAF..OFBDSFGE.KCEDVEEAFFACXDBFhAAAUBBC..dBFCDBAChABAQBGAEDFCRAEAACCGMBIDhACA..NADDIGHFaHAG....hACA......hAIA...,2,-40,-16,24
EIOMRVCeKfAYJZLcbgdGNTUWaDXPQFBHS,JFBBZFDFLFFG..bDCEdADE.TCEEaAHF..DAABQFAFhAAAHBDAEHECODAHhABAMBAG.RDGB.CHCBeCAEhABAADBB.gDGF......hACA......hAFA...,2,-24,-18,6
XZOGRUHWAFVMdYcPIDbEgQaNKSfeTLCJB,VGCCMHFGdEHA......PBDHbFDD.EEABaCAC.KDFBSFGDhAAA.eBHDhABACBFBXCCBGCEE.hACAUGACACBAcGACIEBEDBEGNADFfAAEhABA.LAEChACA.BCHA.,1,-4,-12,8
TASYNJWRICPacfKDQgXEUMLdGbVHOBFZe,SHBGJGEA.RBDH.IEAF..aFFHKAAEQDGFhAAA.EGCAMDEGdCAGVAGBhABABEHGFCCF.eFCBhADAAHHDWBBBCAHB.cFABDBCCXGAG.hACA......hADA...,1,-18,-44,26
YGQFOdfCSKZPgMEABRXUHIcTbeLNVWDaJ,BFFCXDCBUAECHEBB..TDDDLAAA.VGDEDGBDaBAFhAAAJAFFGEEB.FBHBhABAOGDCCHHEKCAD.gGGHhABAAHAH.RAGB....cEBF.hACAeACF.NCAE...hACA...,2,-30,-2,28
VafNMWYDQeUOgCdZEFALRcIBKPJbHGTSX,LFBBRAADBFEHKBEAJAHD.HDEFGDEH..TAEHSGHDhAAAaGDB.MGAADIEGQACEhAAAOHDA.gCAHhABACDCAEHAEAACB.IGGF....hACA......hAGA...,1,-20,-32,12
gYJSRKdUBeWFOAfMbXcZNIGEVDTPQLaHC,MCCAXCBCZGDEGCAEDFGB..QDGAaEEBHCFD.CCFHJGACSGADhAAA.KAFCBACFhAAAeABEOFEDADDCfHGFhAEANCEGEAFE.........hABA......hAEA...,1,-6,-36,30
FRASWENJMBDabIYGVgPUTKHCXeQOLZcfd,SAFBEHBG.MCDHaFFF....bCCHIBBCGACBVBAFhAAAUEEHKEACHCEAeFBFhAAALFHBZADFdHGHAHADWAFEhABABAHBDHDG.PCHFCGEG.....hACA......hADA...,2,-15,-4,11
PSYXEKfOLVBdCHcWQeFTDMagZIJANbRUG,RAADUFGHGAEC..SDDFXGEDKEADLABABEFACGDAHBFAhAAA.QDAFhACAeAHB......hADA............hAFA.DFEHaGBGIHBHhAGAAHHBNADE.bFED,2,-41,-20,21
eAWKTSdaUIDHFVBLQMZPJXNGOcbCYERgf,TGBCaDAB..DFCGHBCEBBBCLFFGZGDC.XDFBODBECCGChAAAEHFG..REGFeFBDhABAWFADSEBChAAA.IAEDQACCPEDDNAIE...hAEA......hAFA...,1,-2,-32,30
SZJgMcXNKHaRIWGBAVECYDbeTdPQFULfO,CCAHDACB.eDEDdBEFFFFCUFAFLGAC..OBEGZABH.JDHFMDEHhAAA...XCFEhADAKBADaGCD..IDBAhAAABHHEAHBDEEAE..bGEE.....hAEA......hAFA...,2,-36,-36,0
QgeLCPcYdEFbaWTRZOIKfAJUNVSXBHMDG,JDACVEFHBHEA..DBDEGAAF..eDAFCEHH...PDCFhAAAdGGBFFBH..aBAETAFChAAAOGAE.KBGDAEGFUDDGhABA..NIDFXCDBMEAD...hADA......hAEA...,2,-35,-28,7
OQEFcNdeALYRJVaCUPTKIgbDXHGBSMfZW,LFBBRFDF.aBDBPDGF..IDFGDEBBHAEGBBGFSEDChAAAMABGZFFCQBBChABAFBBDdHFBADEH...hAAA...JBHBCAHEUGGF.KCEA...hAFA......hAGA...,2,-29,-18,11
RXBVgMWSdIKQCefOYaLGTEZHAJPNUbcDF,JGEAUCBC.DAIBFDDFBFDB..MBHFdAEG.KACG..CAFH...OFDHhAAALEEBGBAChABAEHGAHCFDACIF..NIEH.hACA....cAABXGAE.WAFDhAEAIHBG...hAGA...,1,-39,-42,3
DGdVJIcUHfLCPBRSFNOAXeWMEQZTaKgYb,XDACMDEBZAABKDGF....bCCDDGADGAAFdHDB..VACChAAAIGBA.cFEEhAAAUAFE.HDGHCHHHBGGBhAIASAGD.NICDAHIDECCB.....hABA......hADA...,1,-14,-34,20
gVBHOFTfaYMZNICSXQbPdJGRKWLUcAeDE,EEGCBFDDFAGHaAGE.ZAACCFEH....QBAFdFAFJEHB.REAHLAEFhAAAAADA.DADBHDEAhABAOFCDTGAA.MCEEhACAIGHA.SAHBXGDA..hABA......hACA...,2,-29,-27,2
IGRFJfMadKZUbWBSOTXHDCQcLVAEYeNPg,eCCH..NHBF.ICBCRBCDFFBC..MIACaFGAZABA..UAGGhAAABCGGOFFFHGAEDAADhACACBEH.QAGAhADALBBDAHHAEFDD.PHECJDFEKEEDSAEBhAGA.cEEC..hBIA...,1,-13,-25,12
UcgMDQZBOFSPAfICTHJWbXYNGELRVedaK,CFDGHADG.JEDGXCBCGGDFLCHFRBFA.dCBCKFHH.UEADhAAAMIBADABEBBAFOEEFhAEAPGAAAEDG..IHADhAFA.......WHDA.hAAANBBF....eCCEhAGAaGGA...,2,-34,-16,18
aEGOTDQHJbePfVZdSMgNURWcIBYAKXLCF,KGDDLGFACHBB.EEFAODEEDHCC..JDAEeFGB...VAEHhAAAZACEdAHE.MGBAUDABhABA.....cACBhACAIBAHBDDFAIEA.aAGF.....hAAA......hABA...,1,-31,-42,11
ODJZNCIEbFUfdGcRWgQVKSPXTMaABYLeH,BAFBLEEGeABDHGCGDHGAZDFBCCBF..IADGFEAA..UFDChAAAGCDBRADF....hAAA.WFAE.gAGChABAKAHF.XGAFMDIDAICA....hACA......hAFA...,2,-41,-26,15
MaLQCFPgDRfXHTcWKZdGbSNBUOeEAJIVY,JFBBVAAD..MDDGQCEF.CGHH.FAHH.DDBFRFCCHAEA.hAAATDCDKAEAZFFAdFFESDGAhABABEAGOBHFhAAAeBCGIGAELHDA......hACA......hADA...,2,-37,-4,33
HWLgfIZTPBGXASFacdEeURVNYQKbOMJDC,aDABdAFBeAHH.UFEERBCC..VFDEQACDKFBH.MEEACHHELAGBhAAA..IFCGhAAAZDBEBABCAIDGSCEAhABAEDHF.NCAC.......hACA......hAEA.YHFG.,2,-30,-17,13
cZTUMBDEfFVKWgQSdCabXAYPLHJRNIOGe,LGEAHDBGJBBCREFD..IEFHGFABZAEAUACBDABCFFAC.KDDC.hAAA....gDGBhAAAdHFDaDHFAICA...hAFAPBAB.NIAF..eAHB....hABA......hADA...,2,-27,-24,3
IdKVXeQLWRfSUBYHFgZPacCEGOJNbADTM,MIAGdAFBKHGE..eEFFQBBCRAFD.UEBFBADEHCECZDBAaGGHhAAAEFFC...JABFNAAB.AFCCDFAFhACA....IEEDhAIALBHB.SDDEYHCA..hAFA......hAHA...,2,-28,-20,8
gGVFUcEeILNWafPCAKXZBRYDQSOMdJbHT,ZBCFRDBHQACHMHDCdFFDHBEBGEFA.FAFFEFAFLAHD.aBADhAAAfDAD.hABAAAAHKCHDXGDDBHBBSAFEhABAOEAH.......hACA......hAEA...,2,-22,-14,8
LXHIUaQZEBNPgFMRcYKeGVDbSWJCTfAdO,OFFBXAEGUCCGZFACBCHH....PFCDMAAARDCGKBADeHEGhAFADIGE...SBBBhAGAJAAC.CDFETFFAhAHAAAGBLEHD.aBEDEHBEFFAF...YAHBhADA...hAIA...,2,-29,-23,6
JLSdeYgPIfHCcDKNTAVUQEXGRBaWZObFM,UDCBQFCAEADEGGEFBFFGZAAF.FAGFJBAHdHFB...eCHFhACAPDFBHEAD.DAEHTBFChAAAAEGD...RGAEaBBAhABAWDCA...MEIFYAFCfCCBhADA.....hACA...,2,-20,-12,8
NZSTCLFOJfMUABWKbIEDPaVYGcgdQXHeR,KEGDEHBGDAFE..aDCHGBECdEDEHADHRDADZGFGCHDG.LACH.FDHFhAAAfBGE.hABAAHAGBCAGbECB.IHGEhAAA..........hABA......hACA...,2,-45,-19,26
WTUYCEZLFMDgGVASfbaKBHQXIdecPONRJ,SHBGaHBGBCBEHFEBQAGE.dDADPEFARFGF.TAEBhAAACEFDEGECZBDD.FFAGgEAGhABAACCCKAAC.IFDFhACA.eAGHcCGCJBDFUGGE.hADAMAIFDFDF....hADA...,2,-13,-7,6
MCEcZAaeNHbIUVFdWLOKYJgXfDQTPBRGS,eCCHHAADUAEAdAHGOAFDKHFA..JDFA..XEEAQEDDhAAABBBG.SBEFhAAAEHAEAAID.aDAFICCAhACAFHDELDHFfDAEDFAB.PHCA.hABA.MACECBGB...hADA...,1,-13,-23,10
cTdURSPNDYgOaWVHBfJbeZAQIGMXLEFKC,QFGHMEAELCFAKBDD.CGCB.dDAD.SGAGDAABOFFEaFDGHEDEhABA.BAGD..hACAfAAFbFADZBBAAFAH.hADAIFBCEHEA.TAFE.RDEEPHDChAAA.....hAEA...,1,-14,-17,3
SDMCFIAXZNYeHEbfQRKPOgBWULVTGJcad,ZEFHeGEAEECCQAFB.KBDHPAFEBCAEUGADLEAHGCEEhAAAaCHBdCABMIDAIBDEhAAAAEAF..YDDFhABAfGDH..ODHD.WCBHhACA......hADA...,2,-22,-18,4
MeSHCAPBEQYZJKUVaGRdLDXfbFOWcTIgN,EEGDZEFHKBABUAFCGEAHLHEEDDIH.....XCCHFAHFOHCGhAAATABA.IDHAhAAAMDEESCDDhABA.AEAAQADAJDABVFBCaHBC.fFEBhABAcGAH...hACA...,1,-8,-32,24
BPNIFSgGEZdUQaXAfRTOcHMbYLeDKJVCW,TFDHOFBBHDFE.MCAGLDAB.KGGFVAEGBHAHIAAGhACAgCDEZFFEdDBFhADAaABBAFHEREDF...bAEA.hAEADFCFWHCG.........hAAA......hADA...,2,-34,-4,30
IEBTCdfJPSaFWGAMVKULODbYHZXeRcQNg,KAABUFCADCDEHGFEZFAA.eDAB.RBAG.QFGF..IAGEhAAABDBCTCFBdDDBfCGHhABAJAEG.aFAHhACAFDDCAAIF.MIACOFFA..YHEAhAAA......hACA...,2,-36,-9,27
GYVUNceIOJRBEdTXZQAfWbSHgFCLDKaMP,...fCFCbDAGHABGCFEAKHGA..aAGAMDIHGCGEUGAHeBFHhAAAOACDBFCDdEDAZCDBAEBCSBAChAAALHBADGIHhABAPAEC.........hACA......hAEA...,1,-4,-24,20
FDWTPYLIgXCbOBMaQeKdASUGJHEZcfRNV,UBCBGGDHEDHFZEDC.RCAHFACBDCGA....TFAGLBHF.XFAEhAAACCACBFEHMDDFhAAA......hABA.aFHD.KHDASCEAJAEA.cADDhABA.NIAB....hACA...,2,-39,-23,16
DRLUHcJOdeVKSbTQICFZBgYWaPfMAEGXN,GBDBXAFBDEIHUFFCHDDD.OFHHdEAEeHCGKCBG...TBCAhAAAIAAFZCEEBHBGhABA..YEAHhACAaFCCfCBEEDGCLADC.cGDC.hACAJFFF.SHAGhAHA..,1,3,-24,27
SDZbfEJGVYIXNROcdLPAWHQUBCKgeMFTa,QFDHUGDGCGCG.KGBDMCECFEAE....aAGHSFAChAAAZDEAEACB.GDCH.IBCBhABANAAEOHDCdGGBABBDBAHChABAeADGDBIH.fCAA..hACA......hAFA...,1,-26,-30,4
EQObDMUWYPSfgNKBeGJdLFaTHZXARIVcC,RGFGVAADEBHH...QBFBDHAEUEFF.....PEFGSBBBhAAA..fDBChAAANADAKAECBCAFJFHBFEBHhABAHDDBAIFE.CGAF.MCEHgGBA..hACA......hADA.dAEBaGDH,2,-28,-15,13
TRGafPgCSONdAMZQYHBeJbVDcKIELUWXF,MEIBQFDHBFBA.eEEE..VDFFDGCBKCBEEAGA.UAGD.FEAChAAATABCRADB.aBAH.hABA....gFDDhAAACHGFSEHHdCDCZAEB.....hACA......hADA...,1,-17,-30,13
ELOUMYWTHfNCJBGZVIeabgSXcRDdKFQPA,LFFBUAFHMABETFBCHGFE...CBDEBDHGGEDDZAAFVCCEeBFGhACA....aGDBSDEChADAXCGAcGAEhAAADIAAdFHC...KBBEPFEB.AAHCYEADhAEA...hAGA...,2,-14,-14,0
MaXACFZSRLdHUBVcDEeYNTWgQfGPOIbJK,FGFHSDAFdBFEBBDBDGHF..eDHF..NGBB...TCBDhAAAQCCDGEAEPCFGhAAAODEB..IEFChABAJAHBMACCAIDECACALFCB....hABA......hAGA...,1,-19,-39,20
TdFAVSfNYBDJICXLPHgKEOeaZGRQcUbWM,VDAGSHBG....fAAFBFCHDAEDIFGBhAAALFGFgDGEhAAAEACH.aHAAGDDDQDDChADA.cAFCUBGHMCADdBCBAIAENGAF..hAEA......hAGA...,1,-7,-34,27
DUZcbLdPSCOTaXWGJfEAYHVeIKFgMRQBN,HGFGVFDF.KAGD.MAAEQBCFBFEADFBGUGGE..ZBBAbBEDdCHEhAEA.CDEH...aFAFXFAChAFA..JDAAhAAAAIAA.IAHFFDBE.gCGE.hAHA......hAIA...,2,-30,-17,13
NXCMcIJPdOaYRAHZEBbLKQTGFgfVeWDUS,ZDDFBFEDKCGEQDAHFBAC...fGAGeGAEDAECUFFAhAAASACG.NCGE.XBEFhABA.CDAB.MAAFhABA.IHDDdDGDaHBCAAIBEFCH.TCCChADA......hAEA...,2,-33,-33,0
dRPbgNKQfTaeFUYAZXWMOSIBLCcVJGHDE,XFDHOCHDBGHGLCEE..VDBEGAADDADF.dFAFRAAF.PFGHhAAA..bFFHNAICKDAAhABA..QAEChAAAaHBC.eBGFFDEEAIHAWHACMADE.CDCE.JFEBhACA......hAGA...,1,-1,-24,23
WbPRUQTDZEKCJOMIdXeScYHgFBGaLNVAf,...fCFCbFDFRFBH.QBCADDBHEAFG.CHHA.OBCFdFCBSHEChAAAHCEEFFGCBHHBhAAALDAHAAEF.PDGDhABA.UAFBKABC.MAIF.....hAHA......hAIA...,2,-24,-6,18
TcCGXfYOLNMAUQSHBEdWRZbIVFJKDPaeg,UFCAHBCFBBFEdDBFZACGVFEA..FAGADBIH..eEEG..TEAFhAAACBABGCEF..hAAAXAGFOHECMCAFhABAADGDEABDbFCDKGGE.aEHF.......hACA......hADA...,2,-23,-17,6
NPgIJbCDdHBcYFVGMAUaOEQTLWZSKXRef,UGGDaEED.QECALAAESEHDREFE..fGCGhAAANDDH.ICABhABAJFAHDBEGBFCAFAFCMEBHhACAEHCATBBCKCCFeABAbEFDCHAD......hAEA......hAFA...,1,-7,-28,21
FXMbZSeEfYOCcJIDKWRdGVTHALPBQUNag,LAFBQGGGaBBFFDFD..MCHBSEBEEECA.OEAHhAAACGHGJHBA.KCCC..RADFVFEHhAAAAEIDPGBC.NBBD.bDADhABAeEED..YAHHDBAH....hACA......hADA...,1,-15,-18,3
SgYPfZHDKQURBLaEGCTbVNIcFWXedOAJM,SFAG..gFCA.fDEGDEAGQCCBhAAARBCHaAFE.GABHhABACHFHTDAHVCFF.NIAFIBHDhACAcCFC.WFHH.dFCAAFAHMCIH.hAEAYABEPFFB.HFGDhAAA.BGAA,2,-21,-4,17
NeGOXZMAgRQKaJYdFIUSbLDCWHBTfEVPc,QFDHKEED.aBFHJFBD.dBDDFAADUFGB.LABCCAGBBDACTDCDhAAA.EHGG.hAAA...cGDChAFANCHGeEBBXBFDAGBB...RCBEIAHChAGADEIB.....hACA...,2,-29,-28,1
TCOQdMgBJINFfAbLGEDHYWRcSKPXaVeUZ,GECFDEFEHFABRCAEKAADaCBD...eAFGUAECZGDECFFB.dCGHBHGG..hAAAIHHE.FBEDhABAABAFEDDF...WEHHhABAPEAB..TGDE.MDAB.hACA......hADA...,1,-21,-31,10
OWgcdTIFACKZeQUfJPLXREHbNYVMBaDSG,KGFHeBDGUBCD..JHFELAGHECDD.HCEB..bDFANIBB.VDAChAAABDAD..aAGASFAGhAAAGFBF.OEHFhABAWACE..dHCD.......hACA......hADA...,2,-35,-7,28
cdAHYGbLMIfNZTOECWSXVUgDQKPJFBaRe,HEBHGAFEMAEG..NDEAZDAHOBAC.CEFH.SAABUBGBDEHFKHDGhAAAFGGCBDCB.aBHFhACAeBEBAFFF..LHAEhADAIHHGEECB.XACA...hABA......hACA...,2,-33,-12,21
XAFYEeWRcJGOfbSgMZTDQUdKaHCPBLINV,FAFBeCCHRDCBGAACOEFG....SBAFMCHBDFFD.QEDDhAAA.UAGGKAHHCADBhAAALHFENCGC.AIBE.hABAEGHBJFAD.fBEF....hACA......hADA...,2,-38,-16,22
aEGJUSQOFefLBHRVcAPgXTZDKIWYCdMNb,XCBCTFCA.DDHHKCFE....ICEECAFEMBDB..aEADEHGAhAAAUFFAOGBA.FGAHhABAfCACHACEcEEChACAAIEC....PAAAZBFDWEAANAIG..hAEA......hAFA...,1,-18,-30,12
JLNXOFeHcCgBYKWVPZMQbEGUSaAfTDIRd,TAFBRFDGdAHCLACG..ODAGHEAECHHABABCKHDA.VECCZBAAQGAFhAAAEGFFGCGEaHAGhAAAAADEDDEG..ICEFhADAJDHF.FFAC.cACE....hAFA......hAHA...,2,-15,-15,0
WZLNfXEAcgRMDKSGBTdJHUaIFYCePOQbV,RAADKCBDGAFEBGCFdFAGHFFG.UDAFFEFA.CACF...eCFEQDDAhAAA..VGDGZFBANIBBhAEAEAAGADHB...MADHhACADHBG.SGGB.aBGAIAHHhAFA..YAEDhAGA...,1,-4,-38,34
DQLOCYNSRIfGZaBVbUgHeMdWAXTPKJFEc,XCGCKGFCFCAE.DCBCQAEB.LCGDCEHGSDEBhAAARECG.GDAABHEEVFAFhAAAUGFFHADAdABFAIHE.TFCChABAEDDE...OHAENDIE.fABFhAFA.aAHB..hAGA...,1,-15,-16,1
QIaCLZgPWDHFfGbVYJXMdeETRAcSBOKUN,BFEDKAADUBDEQFBC.CHHE.ZFAG...PEFDDHDEfADChAAAGDAF.VAGBhABAXGDH.dBHGTCDAhACAAGID.SCBFNADBLFHDWFAD.hABAHDFD....hADA...,2,-28,-18,10
ENAaXKIYVMdSCeTODBLbHfWJcQRgUPZFG,XFCEKHBG..VEEESBDD.eAFBTFCHBACFHBABhAAAJHFERDEEUCCG.FAHHhABAGAAEEFACAFIHIHEGhACAYHBACAHH.DGGEbAEHfEBA.hADA......hAEA...,1,-12,-16,4
TMaSLNUdDHbKGOQeICfEcYRAPZVBFJXgW,ZGFGFBBD.JCHB..XFGH..TAFCMDFBLHAChAAAUBAAHFDEKEDHGACEeDADCDGFhABAECFB.REAC.ACGGBHEEhACA.aAGAdHABDECD........hADA......hAEA...,1,-11,-29,18
ZHPGYCMELJQRTXVUgIcKBOdNWfDAFebaS,eCCHaAFBZGFGHEAF.GEEECACGLECDRDGBTGCCUDFF..IAEHhAAAKBBFBBHA.OGDGhAAA.....hABANDAE.WAFH.AHHBFACBSGBD..hABA......hADA...,1,-6,-36,30
gYFbHLONScTWZPCUdDMGfKBQEJIaeXVRA,FHBGHFDFLBGHSABA..TBBAZDFHPEAFUEBFDHFEMFIBhAAAGAEEBCACEFCFaBAH.hAAAeAEH...XDCChABAADDCbEFA.OAHFNIDD.CHFA....hABA......hACA...,2,-19,2,21
WXFUDcVLOECbQRAfKSBGTPJeMIdaHNZgY,KAFBSGACBHEDGBAC..JBAGMCFBdDGBaAEGHECB.ZAGB.hAAA...gFGChABAWGFC.FHAEUACChAAAcCDGOFAH.CDDB.QFDCADID.hABATDAG.IHHGhACA.,1,-17,-33,16
WRLMAeTgaUJCVdNDZXGPBfQcSOHKFbEIY,eDACaGFC.CGBE.dDDFDEHHGDAG.BHEDQFEDOBBEKEGGFAGEEDFChAAA....IHCGhAAARACCMFAGAHHEUCGBhABA..NCEF.XAEBfBACSGGEhACA.....hABA...,2,-33,-19,14
INFaGCRSbKWUVLgcHPXABMJQEdTZYfeOD,JHAGEFHBZDDA..eABDOAGBDDEB..FFGHaFBA.GAACRFCE.KBHBhAAAUAGHLHACHACDAEAHhAAA.BCADdHEHfAEEhACACFAA.WDADgCFG..hACA......hAEA...,2,-32,-10,22
PIKWBCXSeUVQNYbdgEaAFcZGRLMOHJfDT,FCFCZEBHLBAAMDBHHGEADIBG...TGEBIAAB.KADCCFDH.hAAAeHBEQBFAhABA..NEEFdBCGEAEFAHHGRECEOAHDhACAJDFF..WDAD.BDDD..hACA......hADA...,1,-12,-27,15
PDWQBMOVZYfRLFCKgNSEUHbdATaGeJXIc,aCBBJHDA.....XFFBIAGCDAADBBCB..MDCCZDFBREBGhAAACFCAKCHH..SAEDhABAEFHFUAEAdHCBAGHE.hACAeEBCPFAB.OCHDfAHAFDDG.hADANDAE......hAFA...,1,-19,-33,14
ERTaGZYIBKCOPeFcAVDQWdLUMSNgXbJfH,VFEEDAFBdAGB.LCAGMCEC...SECGXEADJBADHFEGhAAA.RABA.GCCE.hABAIHAFCFHBeHDGAEDA.hAAAQCGGNABD.fHBB.hAGA.aCHD.BHDE.hACA...,1,-19,-21,2
bQNWPgXIRZGHSBaAEJDCTcFMeYKdVLfUO,DFDCTGGGMCIB..eCBEKHBALDDEUECHOAHF..bAEAQADEhAAA.NDAC.hABAgACF.hACARGFA.HGBCBGCEAGFCJBGHCBAF......hADA......hAGA...,2,-32,-10,22
gQfdDbRaMFVYXNBZWTeCGHSOKIcPLJAEU,UGBCQCBCDDEA.aFAGFAAD....XBGCZFGBeDDDGEDBhAAAOBDGIDHEhABA.LHBAAIEEEEAAdAHAhAAAbADFMADE...NEEF.BAHH.CHGE.KFFFhACA......hBCA...,2,-26,-5,21
SgMbCTIADadGKBQJRUYZWcPLEfFXVNOeH,dGCDKBCGBEFGJDFA.RGBE.UGGAZAFF........PDAEhAAAfADBFFGE...hABAXBBFODDDeHEChACASFAB.bEFCCFBCABBHDIAAaAHF..QAGHhAAA..hABA.cDCE.,2,-31,-28,3
MfRSZDJUYANagWOeEdKIcBPVHQCLFTGbX,aHBGOGEA.dAEDKDAEBBHAHDFFLHEAGAABXBFERFAA.hAAADFAGJABFAFIH..NEEC.eDDEhACA.EDAE..IHHAhAAA.........hADA......hAFA...,1,-24,-33,9
OGUXQDCVcfFLHdYEZbMPeTBIgKaANJRWS,JFBBRDAGOAHBGADA..QACBCDGC..VFDDFGBCLFFBhAAAdCAEZABF.MEEHTAGGhAAABHHH.KBFDAHHBSGGFhADADDID..cBBC...hAFA......hAGA...,2,-28,-23,5
GUZgBRVdNXKHPTDfYCMQaIOcWESFebJAL,LDACUCCFBGFHRECAdHADKGDC.HAFD.DIGACCGA...aBEHOEAChAAAEFGD.FCAB..eAAEhADAAICCGABF...hAEA....gGAF.NEIE..hAFA.PHDA..hAHAfAGA.,1,-13,-43,30
BcaWPADEICKXZYLeVdfROgHNMSFGJQTbU,DGHHCFEDZAABLDBD.dBHEODFDHDCDSAEDJBFA.QGEHhAAAUEAABHFHaHAAhABAAEDFKACG..YEFAhACAeEHF...fAFERCCEMHAC..hADA.FBBE....hAGA...,1,-14,-37,23
fNXFRbDEBSMWOAeGZJYKadcHCVgTLUIPQ,eEGHGGDHZCBEKBDBdFCEHBFA.CACG.TEEELFADUAGD..QEFBhAAAXGDDRAAADIGAhABABHAB..MADAhAHAAFAEaFHDcCCC.gFBFIAEC.NDIE.hAIA......hBAA...,2,-15,-12,3
KXNZVFMecSPJATYgHdLOUaIbBGEWQfDRC,TCBCHAADLHBG.UGFAIGECGFAFQAAFhABARCEHCCCGKAHBZADEMCGH.eADGhAFASCADAHDFdGGCaCHHEDHFhAAAfECF.DFID.....hACA......hADA...,2,-10,-8,2
bSFPCLYTdHKMGUVgDBcJOZWfQRNEIaeAX,SGFCCFEDLCAFdDFHKGBGGECB.UBBBDHCABGFH..hAAAOADAfAGChABARBFDIEHAABIB..XCBDhACAPAHD.TBDAMAAF...gGADhADA...hABA...,1,-27,-35,8
cEQRaLeKAXgZSTObGPIMFfVUYNCDWdJBH,ZEFHSGDDOCADGDDAMAID..FCDAVABEUEFF..CCGGDAFBhAAAdFAEBAAE.ECAGaGAAhABAeAGDAFHB...XGGGhACA.bEBBIAHA.NICB..hADA......hAEA...,2,-28,-23,5
XcMLWJFAbaUNHCPTZGSeODVdKfQEYIgRB,UGBCCFDDZAFAGCDDeAEADEAA..dGAHKCCCEDAG.....IACGhAAARDFEBABAMFAH.hABAJFFBbFGB...aGEDhAEAHEDDSCCCOCFAfHGFhAAA......hABA...,2,-30,-18,12
RGPVaIcHOFANfYbEKdLBXTZMSgJWeDQCU,...fFAFbDAGECHH.LFHFBGCBZDFHMAEA..gAGChAAAJAAFDICAQCEEhABAUBCCRFEB.PGDEhACAIBAGODCFAHHCKEHBdBHE.SCCChADACGAAaHCE......hAIA...,1,-8,-12,4
FOLHfQDaAURNTKSXCZYeIJVWgBcMbEGdP,REFHKGFCCDHG.eCED..JHAE..VAFCBACBMIFA..EFDDGAABhAAAFBBF.LFDBhABAHAFDQDCDAIAAUDACTDGHhADA..........hAEA......hAFA...,2,-41,-13,28
ZYBdUCAecSTQLVJRfXGDaPKEIMFbHgWNO,SDCDTDCH.QBABVEFG.JHCGXBAB.DADChAAAKBGDECDEMBFDHGDAgGAChAAANEBGZAGB.BEGGhABACFCGAIHG.eDED.cAGA....hACA......hADA.fHGB.,2,-13,-8,5
XLISaeCJENTKgOPMZWBdRbHFVfYGDQcUA,XDACSDCD.CHBE.EHAC..KCAHODECMBBA.ZAGBBEGEdAABRFGDhADAFGHH..VBCFGAEEhAAADDIFQFCAhAEAAEEFLAHBIGFHaGFH.NGAF.....hABA......hACA...,1,-1,-32,31
QaNKWUYdRPeTScEFBCVGfAHDXJObMILgZ,HFEEDECDOBADMEBFLADAZFGH.aCEAKAGGUBADdCDCRFDF..TDGGhAAAEBFD.BHBACHCG.hAAAVDCC..fGAChABAAAIF...XDFC.JACEhACA......hAGA...,1,-12,-31,19
GUcPFDXEgOJfMTRWCKLHZQVNbBaASYIde,SHBGdHBHGACAUGGEFDEH.DBFGEGFF.OACGMFCA..RCEA.KBAAhAAALAAFZDCFQBFBhABA..NEAABEGFhACAAAGAIEBF.PCHD....hAIA......hBAA...,1,-23,-28,5
JcPaFRVWHAUKXELYZDbOMSGTNgfQeIdBC,UFCAXFCELDAHDCEF.OACBGAAC...TBGH.hAAA.fCEGhABAIGAAdHFBBAHGCAFGJDFBaHEERCGFhADA...WFFGAAAFEDCB.YHAGMIAEgAEBhAGA..hAIA...,2,-28,-15,13
XCbFBMYecPIHJfdLTgRUDWSGAQaNEZVKO,aGFCECFCKDGB..CCHBBBAEeDAC....IFCBJCGHdCADLEBHhAAARGFADGBD.GDDEhABANEEA.OAEEFACHMAFGhAAA....PEAHfBAA..hABA......hADA...,1,-30,-34,4
dcZXVSMQeHaAONUWDLECRGPJTKgbBFIfY,ODACUCBCDFBELFCH.EFECREEBJADCKABABBFC..FGCB.hAAA.fCGAhABAdAAFZAGB.SHGAhADAMFID.HCCCAGEBCGAA.TGAE.IFHDhAEA.cAGA..hAFA...,1,-21,-46,25
FXYSdEBcMQZVGHLKIeUCPDNJWAOabgRfT,aDCDRAADFEFG....XAFBdFBEEBECBAGEMIFEZBGDHGDE.LCDGhAAAeBCFCGFB.DFABNEBC.ACIH.hACA....ODHDhAAAgGGBfABF.SGDDhABA.....hADA...,1,-17,-29,12
aZcLJFRCGNdXWIQATSBDfegPbHOEYMUKV,TGAFSFGE.DEFHeABD...PDEBHECHOCDAhAAA.MAIHKAFDaDGBZABHcGGHhADAFADFCHEGdGGEXCGDhAEAWDCH.ABDGBAFF......hAHA.fHBDhBAA...,2,-26,-24,2
MdcJGQCNABXaLVSfgWTPIOeYUbZKHEFDR,BFCFXGGDLHBE.SEEE..gAEAhAAATGGEODBGeFECYDABhABAbABCHBGFDAEEMBHBhACA.JDCHCFHBNDAGaHAE.fBBHPFDC..hADA......hAEA...,1,-5,-27,22
XUWacQLGePMEKRIACBTHJdSZOVgNbDFYf,CFFGBFFCHCCASHACZBFB..VFAB..gCGHhAAADDAFFAAC.XABCaEHB.hACALFHBPHDAEEBEhADARFCDAEBHdAEE.ODCA......hACA......hADA...,1,-21,-24,3
VEaPBLeRSXAdOHIQNZcGYTFWbCgDJfKMU,dDBDOFBBQGEDZCCFGDGAFFBC..CEDA.DAIDKBHFUGDH.EAACBEGDhAAA.eHAERAEDADBF.HBCChABA...cGGFhACA...YADC....hAHA......hAIA...,1,-24,-36,12
EVbOCJDMIZdXWHePLQaRTKGAcYNUgfSFB,...NDDG.UFCA.SBHDBHFDEFGAOADCCDAD..DCBCMFEBhAAAZACCdGFCHBABeEEEhAAALFADQGAAhABAaCGBKABCAFAE...YCEHFGHD....hAFA......hAGA...,2,-27,-25,2
LZAQJfFXHCUIcOYBbRgDaPGWVMdKNTESe,QDACFDCDCHBC.UEGCOCGDBAACRFED.DDEFGADB..VBBEhACAMCAGdAED.KCFDEEABhAAA..eHCCACGHfABFhABAXFAEIBHD....hADA......hAFA...,1,-27,-32,5
QHEcMODCRJIBegAfZSVLWNGXYdPaTUbFK,ZDAGSDBDLFBGGADCdAGF..aHDETGDAUACB.KCGGQFGChAAAEHAE..cGGHhAAADCHBCBAC.RABFBAGEhABAACFE.fDFE.WFAGYDFDhABA......hADA...,2,-31,-7,24
IEWQBCJcYfbHKMdPOTNeDRALUgSaGFVZX,LDACSGFCaFCCFABCZBEH..EDCDQABEBGDE.JFFEfEFDhAAAHAGF.dBEFhADAOHEATEAD.DAGChAEAAAIFgGAGXDDBCBHG......hAAA......hABA...,1,-19,-20,1
HIeSdXTCEObcVBaAQfUGDLKRJYPFMZNgW,QCGCUFGHGACBKGDCRDCD...JCDHFHDCZAAE.....NIEH.hAAAHCGF.eCACdGABCGHBhABAEFABOBEF..hACA............hAEA......hAFA...,2,-34,-28,6
NabVITAMegEURXBCJZSGYHDWcQPLfOFdK,eCHDUGBCBAHCZAFGGFDDHCFEDFEF..QACGLEAGFFGFhAAAdEAAaDFF..bABCTDDGhAAA.ABBBMICGhABAECDACCAG.SGHH......hAEA......hAFA...,1,-11,-31,20
dMDbcGCXfKILWTFgJPeBYaZEURVNQAOHS,ODCHHFEEdCCCDGFFGGAH.CHFH.XACGKBACLADCFAGCJEAHBCFAhAAA.ZEBEEGHF.REFG.hAAANDIA.AFEB....SDDAhABAMCAF.fDGB.IHCFhADA...hABA...,2,-26,-21,5
GNcOCDAefdKEbaHZWLFMSBJUVYPQTXgIR,dDCDKAFBEBCCHAED.LHAGMDDA.SEHHBFACUFFH..VBGHhAAAQDGHXEAChABAIECDRBBEGGEFOHAAhAAACADC.AAIB.fFEF...hABA.aBBH.WFED.hACA...,1,-2,-28,26
gaWIOQRGZPYEbVfCBdJDTKNLAXSeUHFcM,XGGDSGDDHEDGFGGB...MAABaBAA.OHCEQADFhAAARBGHZBBAEFACVDDABDBAdAGBDFCHhABA.KEGAAHAEcAEFhABAICAF..........hACA......hAEA...,1,-9,-25,16
ebSIVYZfgLcPBNKMTOdRACWHEaJGQDFXU,HDBHEEEDGBFCFDFDeAGD..SGGD.IBAAhAAAZACGfHGDLCCDBFHHhAAANGABMICA.dDAGABACWFDGhABAaHAGDBIB.........hACA......hADA...,2,-37,-6,31
KFXNPBeHLMGRbACcWaQJIOZfSTdEYgDVU,CFDGaHBG..QCBHODAEZEEG..SBFHdHGFECFH.DAABKBDFhAAAFGAE..XAGEhABANIEHBFHGLEFDhABAMFAA...GADEABBGWGACIDHCfADBhACA.....hACA...,2,-31,-18,13
VZHQTWJLRaANKYPdFXGgIbOSUMDfCBcEe,KHBGdHBHFFFBGBBA....IAHBOBFCUEGEDCADBDEEeEABhAAAHBFDQGDEhABA.TADFLCCBhAAAABBF.NEEG..PHFC.bABAMDEC.CAHF.hACAcFAA...hADA...,1,-18,-20,2
IbFWfZTQRHVCdeKDUcYOJNEGABaMXLSPg,MAEEXGGDLDEE..SDED.IGBFhAAAWFHBfAAFQCAEhABAHDBHCBFCdDGHDBGGcAGFhACA.OBBANIDDAIAEBBCB.PGECbFDC.hADA......hAEA...,2,-22,-18,4
SEXDFdGaCUeTPQLbcAHKMgfVWBRIZNJYO,KHDCMCCA..VDABBEGHZFEAJBAF..OEEGEGAE..DEDHFBBEdCGDhAAA..aAGFUGEBeAAChAAA.....QGBAhAEALAFCAFIF.fEEG.hAFA......hAIA.WDFE.,1,-22,-40,18
ZbHGVUMYAOESRWXaKCNJeDQdBIgFTLcPf,OEGHEEHBRDED...aFBEKBEC.CCDC.eCABDAIB.BDHC.FAGCLHBGhAAA..fBADhAAAbBBFHDAB.VCDDhABAMADGAIEG.SGGB...XCGChABANEAE....hACA...,2,-30,-25,5
eFQBfPTUNWCJKDRYSVEXAgMLZcHbIGdOa,LCHDZGFGHCCC.GGAFaFAAFHAABEDC.TGGEUABACFEG.DDHDRBBBSAEDhAAA.hAAAXGEHAEACMAGF.IAGFhABA.ODAFfFFBWCFH..hAEA......hAFA...,1,-8,-37,29
EdKZBfHJUgNXcbVFLGRPYIMOSeTDWACQa,CFCFaFHBKCAEZAAA..HAEGUDEC....NHAD.XGCE..hABAbEFCLAEE.hAAAGDABRCDFIGHGhABAMAIFSGBFDCIBAFAA.ECAABDCFgBFEhACAFABEYHDG.hADA...,2,-23,-17,6
cUHFYaLBPCTEIRXVfQgKbDWAOdSNGJMeZ,OEGHdAFBSECEGACGMIBCZBAAHFEHFGDALBHDCFCE.EAEBhAAAICHD.REAB.hAAAfBAHKEHBDDAGABBA.hABAJFAG...cCEEaHGE.BHAC..hABA......hACA...,2,-19,-19,0
IdaOXNBKfYWcUDMJSCAHbFGRgEQVeZLTP,HDAGGEAHRAAFEDGAeAHBZADBLAAF.ICDBaFEFOGAEXAEEhACAKBFH..fGGGhAAA..YEHDhADAcAGFDIEESHDAACCG.gEEBhAEA...hACA...,2,-19,-12,7
fAUaXYCMQLNcWKIbHVegBJZODdRTGSFEP,UFCAXGBCMAGHLBAD..NGED.KEEFHCEBeCCDBDAGOHFAhAAADAAE.dDGHRCBA.GBDHhABAFAHB.EAGAAHFHCBBB..hADA.....WFAH.....hACA......hADA...,2,-32,-18,14
XBPgbWfKNeODEVZCYdQLFJHRUIMGTcSAa,aFFBBHHG.....bCCCKCGA.eECFDHCEZCFBCCCEdHEDFGAGRADBUAGFhAAAGABF...SAEEhAAAAHHH.XEGDhABAPCBB..fABF.NBAE.EFCEhACA....QEGChABA,1,-22,-37,15
gBXOPNIYWAfbVZdUTMCFHJcDaQSeGRLEK,VAADUCCBMFEH.HAAEJFDF..DBGDaCFH..eFGBGBGAEDEH.hAAABFFD.XAFBhAAAOCHB.IHHEhACAAAGAfADCdFBE.CHBE......FFAGSEAFhADAKAHB..hAEA...,2,-28,-15,13
PBeRVgYFOKMLdGTEQZfCDaSHIcbWJXNUA,BAFBeDACRFGF..VDACFHCCKFEELABC.dGCBGADF.EGDEhAAAfGFFDGAGHCFA.hABA.IECEbBCAJEDG.hAAA..NCAB.AIFAPDHF...OAHBhAIA.....hACA...,1,-16,-18,2
AIRPUWdBgfGQNZcHJeCSTaYEbLFOVMXDK,RAADUCBCBCDHGGCBZBEBHBGBCGAA...aFADEBFD.LAEFFGEE.hAAAMFFCKDBBAIFA..IACBhAAAdACBQGCAhAFANAIE...........hABA......hAGA.cGGESFFE,1,-19,-25,6
BeSCJcPMEHIFKZWROafANQVYdLgGXbDUT,VEFHLCCH.XAACDBDFBFDA..SGGCCGAC.JCGDhABAMFCBHGCGKCEDZEABRAFD.hAAAfAFEQBAChABA.dACB..........hAFA......hAHA...,2,-37,-19,18
OGQKYNZCIFcWLbVgMREJDAUSdaHeBfPXT,SFHBdEHAaEBE.HDEDeAEGBBFC.XAAFTFDDGCCDhAAAKBDFZGDAFCGELBBFhABAVDAC.MCAF.EGAHAIAAfAGBhADAPHFE.......hACA......hADA...,2,-13,-11,2
dFHUcANgPReLQBDObXZYSKITfCGMWaVEJ,...NDEH.PADGLEFCDFEC...OACGXGDCZGBASGGFhAAAKBCG.TDCBhABAfBAGGAEF.hAAAMCBHWBGDEBBE........hAHA......hAIA...,2,-48,-14,34
eWSREOAIfZbTUgDaGdMPLHVCKXcFYNQJB,ZAADTCGCUAEC.DDCCaGBE..dHEFLFGFHDFE.KAFGFEBANEEE..hAAABCCG...eABFhAAAWFFGEFAG.ICEEhABA..fGBH...hADA......hAEA...,2,-42,-26,16
TaAcbDVQHJSXEUICLPBfZOdNGWYRFgMeK,DACBQBBHHADBSDHDUGDALFAFBEFHZFBBOCFE.dGGGhAAAGGDHRAEEFEDEMABEhAGATAGF.AFAH..cDBGhAAA...........hAHA......hAIA...,2,-22,-19,3
LIJdSKBcbHaNUFgDOYGQZRTeMWPXACEVf,EGFHVFDFLABC.dDBABDACHBGDUDFADCCEODDHGABBQAGAhAAAZBEB.eCCBhABAWHAEAHGA..CFAE.IHHAhAAA.KEHBaGAH......hACA......hAEA...,1,-14,-26,12
DObVHceSYTZBgNURAMaLJPCGWQfEFdKIX,LECCJAFBGDCBQFAH.FBBDIFFBDABG.VACFhAAAHGFG.SEGAhAAAZFAGBHEF.gBEDhAEARCAFABADMCHF..CHGCEHBAKBHFXGCD..hAFA......hAGA...,2,-18,-18,0
XIacKgJEQLfNdPOFGRZCBWYMUDSeTHbAV,XFDHaHBG.KEABECEA.QCBDLAAFdAEFOADGGCCAhACARFEABFBGMICADIDATFGGhADAAEFA..IHHEhAAAgCFENCIA.PAHDCECD.....hABA.WAHF.SCAFhACA,2,-22,-17,5
KRQTDLeEYSIaWVOPJUfHdgcBMGFCXANZb,ZAADKCFCQFFGDHDGLAFG..eEBBSDCA.aHAGWBDChAAA.OBAHUEGBdEAEhAAABDECMCFGCEHBABHG.RACFEFDAhAEAIGAF........hABA......hACA...,1,-15,-41,26
CMfDcVTXKPgLaQSJBRIUZHOAYEdeGNFbW,EAFBdHAFGBEAFABD.CEGF.MDEBDBAE...TGEBKFHHLDAAhAAA.QAGAhABABHHGIDBC.UGAChAAAOFAEeDHFNHDB.WECH..fBCAhACAXCFCaADB.SAHFhABA,1,-17,-34,17
JgKFDVUXcEbaSGRNfQWBHCYMAdZLTIOeP,dDBDLBDGOEDEJHAGKAAF..DEEGUGCA..XGGFEBFH.hABA.aBHBSAEChAAAGGEFRFAB.QBAChABABADCCAFCACCG.TCGB.IAHF.PFBAhACA....hADA...,1,-23,-33,10
ZKFTJaQbDMOSPIeRWCLHXNVdgUAGcEfYB,EGAHBFDGFDEAaHCE..DDCFOCDC..SAEDeEAHREEDLABBhAAAXEFAdADFUAAChADAAHHAGCGE.fHAFhAGAZGCAJBFA.MIFEIHHH.CFACNBDE.hAHA......hAIA...,2,-25,-15,10
RNQaPdZOAJCKeVWGDcBEbSIXfFYUgLMTH,KDABeFBBGECEBEGFEDBG..SAAF.XBGChACAFCFBgACGTBCBNAFAPEHDhAAA..ZEECADAFCAGBhABADIEA.IGAF.fGHChADAYFFFMAIB...hAEA...,1,-22,-27,5
YafgHTGCFUNJXceVZEdOSKIWQPMbADLRB,DGADLFCARFDFBBEAaGAD.HAAFGBBC.UDFAXDDC.eCHHhAAAEGHDdGBESCEAhACAKAAD.QADDhADAMAECABHE.fGHC.TAGDCEDF.hABAJHDE.....hACA...,2,-35,12,47
RHAaZdXBSeKWYENVgLGcCUOQPMDJFTfIb,aEHBXCCBBECA.KGEE..ECAC..VCEHGCDD.UGECOACEhAAAMEBDDIACFAEETDAAhABA..fAAChAAAIEHCRFACAEAHSHBAeHCG..WAFEhACA.....hACA...,2,-32,-16,16
RXSTKfLBbZgdIJUAWcMQPFGaEYOCeVHND,MCCAFGFCEDBG..OAECCHAD.HGFEDGCCRACDSCGB.KDADhAAAfHBBBGEFgDDAhABAJEEA.AICAQGAFhACAaAADeAECVBFENAIE.....XEAChAAA...hADA...,1,-21,-22,1
ZBbKOeMGJHLUPCIfNcgdWSFDYAQaVXRET,VBCFEDAFBHDH.KFFHeEEC.GEBCHABGUGAGCAAC..IDAEhACAfBFB..hAAANEICdGGG..WAHHhABADFAHABHCaCDD..........hACA......hAEA...,1,-27,-37,10
EKUZaHgOXLRSQYDdfAGBCJIVTMebWNFPc,CFDGJFBB....IHGEMDFE..eFFH..bEAHFAEGEEHFUEDFhAAAZDDA.HABF.OEHFhABAXBAG.SAGEhAAADCEGfDABAHEHGBDF...hADA......hAHA.BAHA.,2,-23,-19,4
IRTdCNVPfGMWKEFJXabZDScQeAOgYBLHU,OGEABFDGLHBEUCAC.RFFGdBACCDFA....VFAGGBGGKCDD.hAAAJBEF...XEAChAAAbEFE..DHDC.hABASABE.eAFAACBE....hAEA......hAFA...,2,-35,-34,1
ZbQTXDANGOHEIfRLJKBYdCgVWScaPMFeU,OFEFHDAGEGHHRAFELFCDBBDFCAAA....VDGHSGGAhAAA.aADGFFDEUCDDZGBCQAGEhAAAXCAHAHDA.hABANAFC.IDGF..KCAC....hACA......hADA...,2,-20,-18,2
KgPMHCRJULabIYEWTBdAGQFSfOVZDXNce,QECBFAFBOECDZCBBDIAC....XBBBeFFGKCHF.MIBAhAAACCGAUFGF.LGCAhAAAIDAFECAB.BBFGhABAAHIF.fAGBNBAF..cGEA.hACA......hADA...,1,-29,-32,3
dBCDLbTHRMVEfaYQGJeKNIcXFSPAOZUgW,ZAEGUCBCdABCCEAG.LDBHHGBG.RDFB.MEEGEBHF...aGABGGCFhAAAeACE.KDAD..IHGEhAAAFEDBAGIB....hABA.OCFE.BFHGDDDE.....hADA......hAEA...,1,-23,-26,3
EHXMJSfCGLRFYbVQBdAcUaeTONPgKDIWZ,aGFCeFCA.OBGH..gCFCDFIHZAACEEAEHFAA.MBAFhAAASDDFCAHALBCDhABAFBHF.bEEABGABABBD.cGFFhABANCIGKAFE..IBEHXCAA...hACA......hADA...,1,-11,-23,12
WbBZEHfVMLeIONQTFUCDgGXSRdKJPAcaY,aHBG..bAADBGFEZCEDHAGHMCIB.LEAHOCCC.QGFDhAAA.TDCHCBCFDFFGgAGChAAASGDDdEGDhACAKAEBJCADAAFA.....cECH.hADA......hAEA...,2,-37,0,37
QYdbHOXAfZeacKNFPULVMWIRgTGDSCBJE,ZFDFaDCD.KEBCFGCDUABELAAC..MAGFRFEBGEAG.CAHCBHHGhAEAEGGAdHBB.HBDBAHEFeCDGhAFA..PAHFhAAAIBBFDAFHQDGD....hAEA......hAHA...,1,-20,-24,4
ELNHQUWOTSFXKgRGfCDcdYZaJIBVMbePA,LCCHQFDHOAHBSDCEKFAFRADC.CHHG..dDFFZGDA.aFEABDAGhAAA.MCBC.PABGhAFANABE.HAFE.hAAA..WHAG.TEBCFEGAgCEFhACADGGA.....hAHA...,2,-24,-18,6
WMPQbFgNBfdcJXeYKEATLGCVDSRaZIHUO,TDACCDHBDCGC..RBCB.aGBFZAEE..HCCHUGFEOGFA.PEFGhAAAQFCG.FGAHhAAANACFBBAF.fAGFhABAdDAH.XGDCYEEAABIB...hBCA......hBDA...,1,-18,-37,19
fcIXZEWaGVeKSYONCdgUBTQFLPRMDAHbJ,HFDFJGEA...fBEAXDFBZAAFEDBHGDDF.KGGGSFBBhACAOHAECGABUAAChADAQAFDLAHBhAEAMBIHDBDFAEBEIDDFaFGG.....hAFA......hAGA...,1,0,-36,36
SVaXbWCGJedQMfcKIBEYDgFORTZHNAPLU,LDACVBCF.aDGG..XBGECBBE.JDGHdFGB.MEFHKAFDBHHEhAAAEGAGDFCAFFDGRBEA.HGAEhABAAHHA.UEAF.SBBFhACAWAAC........hADA......hAEA...,2,-35,-21,14
CSBKDZbEQgAUJWRFcfOPGVXaLIdNTeYHM,UDACJFBB.RABC.FACG..OCHDGDFA..aGCAdBFB.eHEGMGFGhAAACDHBBDEDZCEE..EAGAhABAAFAA....fBBGhAAAPHFE.XGCDIEFF.TGAHhACA.SDDDhAEA.DCEE,1,-12,-44,32
cVQeIUJKbPCLBgNFSDXHfEYMROZadWTGA,QFDHeDACUFAFKCEECHBFLAEC.BECHFGFFDAAGHBABEEHBMDIHhAAA.RBFBZFFBdADFGDCFhAGAAABE..cDDAhADAIHHG.PBHD...NIAD..hAIA....fBBDhAHA,2,-21,-21,0
DHUcGKJaYBSeQMWRZgEAFNbVPfIOdTLCX,FHBGVAAD....fDEBdGDCCCDFHDEDUAFCKHEE...aAAFBBFAhAAA.QDBDhACAMBDF.RBGF.EGHBAHIBPFABhADAIHFD.TEBEXGGBcDABYAEEhAIAWEEG..NAIE..hBDA...,2,-25,-14,11
NQOTXgHKWGYCfZVEPSDdUMABFeLbRIJca,eCAFLFBBREDC.JAHDaBGH..QCDD.OFFEgDCChAAAKACCGAAECEHEZGAGVFGHhABA.EACGDIDAMIBChAEAFAFHIGDE......hAAA......hAGA...,1,-8,-26,18
LEWGKdYcgQaHTBZFPXeRNDCSOAIUbMVfJ,UCBCMECG...JFBALFHBGGEB.KAEAdAAF....cGAChAAAQEFHHGCATCFFhABAZAGHXBDBREAEDIEACCDFhACA.ABCC....IFFFfGBE.hADA......hAEA...,2,-27,-19,8
JRLTWfXNabedHSBZAMUCIYFPcQKDOGVEg,CFECFHBG.QFDEKCEHDFGF.GACG.EGGBJDAFLAAF.hAAATEAAXECF.hACAaGAEdAGG.SDFGhAEAABDDMIEA..IFHG....hABA.cABB.VAGDhAEA..,2,-44,-15,29
FdJARDCIMceNgfWHSGYUVBZEOXaPKbLTQ,DAAFCBFD.MCFCeEGF.....fABHHADDGGEFUEADZCBBhABAOEEHXEGAaHCCKHGGhAAAbFAG.LAHFhABAFHBAADDFIDFDgBCFSEEDBDFA..hACA......hADA...,2,-15,-13,2
GafYLCRPBeSJbcdKEOZATVUIWNgXFQHDM,VCDBUCBC....IFDG..WGAC..NCIAFHGEQCAGhAAAHGDGGAEDhAAAfHFBCCGHBHAHSABEhAEAJDDAdABF.EBHHAAEA.gFGBDFCF.hAHAYHBG.PAFAhBAA.,2,-40,-13,27
OGgTXJEZfMHdBCASeIKcYUFVNPLRaDbWQ,eCCHKHBGUCBBFBFH....VEDGLECADGIH.QBFBhAAAGBAG.XGFFJDHDEGBH.hAAAMADCBBGBADHCSEHBhABAIACF..NEAC......PHDEhABA....hAEA...,1,-23,-30,7
HabKfBcEJZSRADOGFeXPCMTdQNVYIUWLg,DCIHGAEGeFHHCCCHdGFC..VADHUBGALHCAHGAAKABDBEED.hAAAEBBDSEAChACA.AEHH.XDAGhAAAMDEF.NBHG.IGHE..aGEA.fGAEhABA...hADA...,1,-22,-27,5
EdIDeTWQYFUVKcHbaSXgABCGJPONRZMLf,GCCGJEEG.OHDERGAALCAHdGAHDCFF...eADCTDCCQFGDhAAAUAEEKFGAHCAHhABA.aBGDXAAAhAAABBBBNBIA...MAIB.EGDG...IHHAhABA....hADA...,1,-5,-28,23
ZUeNFIHDPYCEcSbfAXgJdWKGVBOaTQMRL,XDACdDCDKGDGGAECBBBC...aDGHTFECRABG.ZCFAUGAFFHGADCGEhAAACDAC...SHBGhABAAGGD.JGBCOEAChAAAMFBELBDBNEIG.IAHEhACA......hADA...,1,-22,-29,7
LWbAJCMHFSVROEcTgGfXePNYDBdUQIaZK,MIAGHFEEVEABRCAD..ODFHECCE..TGCEGACA.XFBDhAAANAAEBHHE.dDGHQDFFhABAaEAHKAHF.WBCEhACAAFIHCABHFHGA..SECE.fAHEhADA...hABA...,2,-21,-4,17
MTHXZPLKcSNFVGEfdRWDgOBAeUbYaCQJI,eDACUCBC..aAGHJCED..MFHDHGBCZDFALEGB.SABFhAAAFGFBVFCDEAAEdCGHDGIDhADABCAGAGBACAFD.IECEhAEAXFAB..KAHDNAEE......hAGA......hAIA...,1,-21,-22,1
JKLIgNMCVcDRXHUTFPEaAWSdZGfYeOQBb,SAFBdGFHGDADeGACBHEFKCAH.LEFGIAAB.MCIDhACACGHEDIBERADD.HECD.TACDhAAA....hABA............hACA......hAEA.EFBBaFEB,2,-35,-33,2
gOHfFPXMASNJDbGUeYQcEBTKIWZdVaLRC,JCCHDCECGEFA.eBBBQFGCBHEGKFDDZBFH.aFEDLAEChAAARFAG.CFBH.OAAFhAAA.FBHDMDAFABEFSACBhAEANDDB.........hABA......hACA...,1,-26,-37,11
PNSgHJVUWbZYRBcMDFCKGXOAIefETdQLa,eGEATGBCQBBC.LFFEPAHFSCAEhAAAJAEBUGCGZBGHBAEFMBADFHGACDFGKEAAhAAAOBFD.fFFChABA.EDAHaGADgDCF.hABAWFEF....hACA...,1,-8,-30,22
cGXOYTZPeERVCSBfJgdUAMWHDKaNLbQIF,MECGDHCEKFBGLCDA.QGFGFGFDGACGOHAEZEEGEAEBCEGHBBFChAAA..JAHF.hABAdBBCAEABaAHD.ICBAhACAXCEA.........hADA.PEBB..hAEA...,1,-28,-37,9
LBJOMZUICFVWARYaQDcdXPHfEebSTGKNg,RDAGQGBCDCGG.dCBBXDDDHGFEECFH.eAAESFGHhAAAGEBDKHDGLBCCBAFBMEABhADAIGBCCBEHFBHFAIFEaAFAhABA..cEGFfGDC.NEIE..hAEA......hAHA...,2,-27,3,30
DXdURZYQACGaKPBcNbgIELTMFSOHVfWJe,CFFCKDAFBAAC....NBFE...IEAGEDCELGFCFACDHFBEhACA..VFAEJDFCDGIFhAEAdAHCUAAF...hAFA.RCDB..YHBG.ABHHaAGGcGCDhABA......hADA...,1,-28,-36,8
WUdBYbRSDFVfHKPNZaQgCTcJMGOAILeEX,LEEGEAADUDAFBGEBRADADGAH..FCFD.HBACKBDCZEFA..aHCACHDF.hABA..JBHFOBHBhACAAGGB.eGAA.dHGB.hAAASDDHVDAFfHGF..NAGA.hADA......hAEA...,1,-23,-29,6
TNMJaGUPYBDdVfbHcFRAXLIKWegOQZSEC,XDACKDCDeEDA..QAABEBGE.CDHH.MBBAGBDDUFCGBHFBhABADCGDdDDH.fFGBhAAAcGAE.AFBFIHAFhABAOAFGSFGBNACF..aCCAPDAFhADAYHEG..hAHA...,2,-29,-14,15
YcCZMQHePIObgRVfBTJUSKaFNdDXEALWG,GECFCFDGZAFAHCFCeAEH.OAGDRGAABBDAUGAFKACF.FCAB..DGHFXABAhAAAABAC.LGDAhABA..cEDAhAAAMEIH...IHFE...gDAGhABAfEAF.hADA...,1,-12,-46,34
KIVHgCEJacDBQPLMTYWbZXGAfeSNRUOdF,SDCDUFDHODBCdHDB.FFBHKADA.HBFBEACE...aFAHBAGBhAAAQBAGLBAHMIBChAAATGGG.YDEFhABAWEHH...XCCBACHC.NBIA..hABA......hACA...,1,-17,-29,12
GdDTVMfKEWFCeRUIHbJXaLcZOQNSYgPAB,BFFCdACADFGBMHFCKGCA.FDBD..eFHFUEGEHBGF..JAEHXEAHhAAALAAFZCDB.OABBhAEASDDF.hAFA....YAHBAIEG.GGAFhACAfHABCAGDIBBFhADA...,2,-36,-25,11
aDLOWTMFfZIHGPRgScEeKUdJCAQYbXVBN,QCBCXCBCBCHDaFGB.LFDE.OAFAMBBEfGEEhAAAHADDGGCFgFAChABA.EGCFeBFHhAAAdAFCAHIFbFGDDDID.FDFB.IBHF.hABA.SDADhACA...,1,-8,-14,6
MHZSGLgQKcPWIYVCRBNFdbOJAUXDETeaf,XGCETCBF..eFFAaDDC.HBFFZGFELBHDQECAKABAPBCAhAAA..WFAChAAAYDAFRAEB.FGHDdGBGhABAJHCEAADEDDGHfAHG.....hAGA......hAHA...,2,-23,8,31
MSCfYaVGgEFZTJdPWLDIQAHbRKNcUBOXe,HGFGRDAGKGHH.UCGEBCDFeACA..MBFDSCCG.CEEF.fBGDhAAAaBAD.VEFAhABAEFFAFFBG.JAFEPHDEhACADGDBAACC...bFAD.OBBG.YGCEhADA...hAAA...,2,-24,-18,6
XCEJONcIfRHKYQdMUSZFVeWGBADgTbLaP,DAFBTCBCLBGH..aFCAXBBG.EHGENAIG..fGAHhAAAREEHKDDEdEBBMICChAAAUBFFSHEEhABAFADF.WFFGAACHgGAFCACAOCAHIHHAhACA.YEEChAEA...,1,-15,-27,12
MdGHSXQFbLZKOWAeEPJTYIBacCfRDgVNU,EDCDJDAC.....IGHFBHEHCBADDFGE..VFADUBGDdBAF.hAAAHAEF.XDGGhAAAQFBGFFEHLHDAhABAKAEEAGIB.eCAF..PCCA..hABA.....aHBEhACAfDDB.,1,-1,-49,48
EBGFeZRMWNQITHOLDASJKCaYcVbfdPgUX,SEEDCDGF..aHGEVADAdDCCUAACBFFEFHAERADG..MDADhADAQCGC.TBAEhAAALEEAAGAFJDCHKAHFhAFA.bGCA..PHFE.EEHF...hAGA......hAIA...,1,-16,-31,15
gUaJKfWNEZVGAdFIQPBHbXRYcCMTeSDLO,dAFBQGBCBEBCHAACRBFG.CFFC.MEDC.eHECLDEAUDBEaAEBhAAAKFHD....fGDGhAAAEEGAZFFAAADDIBBGhABAXADD..........hACA......hAGA...,2,-39,-13,26
NZCQPefdFaMITGLHRbJXSKAVDcgEWYOBU,DHCEEHBG.OBGHBCFCZACD..QBBCeDHBdGFFMABBGEBDLECGhAAAHEGHJAEBXAGAhACAAEAE..gGADhAAA..WBEFNAIE.fGDEhAFAaGHD.....hABA...,2,-20,-17,3
afDSKYHdORcCbFAQBeLgMEIZUNTVGJWXP,BFEEeEEGLGCAMAAAZAFG.UGGE..TEGGJBDA..XCBEhAAAaECGDIGA..KBCBdBABhABA.OCFECDFHAIEEEEAFIHAEhACAGGAF.fDAESBBD..hAEA......hAFA...,2,-31,-18,13
KHCDFQEWfOGVUgIeNTcJXbSMZLRBPYAda,KDABCAAFFHGEEDHB...OAFHUEGD..eCDB..TFGC.hACAJDCASEAFhADALBACBBHFPBFCAHIBdGAAhAAAaGADHDBBQGECfHDF...hABA......hACA...,1,-25,-27,2
eMPYTKBQASgNVWDZRLHOdcFGfCUbEaIJX,SHBGVAAD.ZCBHLAEDdEGAGADACGADEDCB..JFEFeGFEhAAAMBAH..TAFChACAQFADAIGE.gAFEhAAADIBGRCGF..cGDAfGHCaFCH.hADA......hAHA...,1,-12,-18,6
McQIEfPCXSWBeJNYbZaOLRDdUTKGgFAHV,MGCEQCBC.EBFCfGAD.CAAD.XFGEBCCEJCABhABAYABAZFFD.OHCGhAAALCEGdDEBKGAChADAFEEGAACCcDGDIHHGWEAGNIAF...aHAC.hAEADEFF.....hAFA...,2,-30,-3,27
ObGCTYAUFefDKdZMPNgVaRcIHESLQXJWB,UGGDeCCHKDFEMBCD......NACH.aGEFRGBAHAAHSDGDhAAALGFGJDAD.BBGBOGAChABACBEAAFEE.DEDB.dADCgEGFhAAA..cDDA...hAHA......hAIA...,2,-31,-27,4
EJaLKURWBZCSHXYNIgbfMcFGVPdeQADOT,DECDTAADEDGB..LHDEKFEDUBEEBAHDZAGFHGFA..XCDGhAAAICCC..fBAEhABAMFFCFEAG.PFAFhACA.dFGDADAGOECFaBEGCDAG.NIBB...hAAA......hACA...,2,-23,-18,5
XVZfCTBLIaDHGOKdFPScUJNQAbReEWYgM,RFDFEDCD......gCDHMBIHZABECFBGBHAEaAAB.HAGDGEFChACAKFBAFFFA.SCBGhAAAcAGG.NDIAAADBeFDFhADA.XBDA.fEHEhAFA......hAGA...,2,-28,-21,7
JHgUBQKZYMPVDIFSAcbROTaXefCENWGLd,RAADTAADeAEG..ECGBGCCG.LCGHJFFCUEBABBEE.ZGBChAAAMHCCDEADIAHChACAAHHEOACF.XGGHhADA.CGEB.NIADdEEC........hAAA......hACA...,2,-27,-14,13
KUWOZYNcPXgERSAJdbCQGDIMBTfHLFaeV,dDCDQGGGDAACBHEAHCBFLBBAaBHDeADE.UGABOAFBZEEE.hAAA....NCHE.cACChABA..gGABhADA.SGGGJDDACBGA.IEAAhAEA.MCGDFGDH.hAGA...,2,-39,-4,35
JZcAHGWXaVfgKLFeMRBNbICSYUEdPQTDO,HEBHXAGHVACCKGGBFGDA..RCDE.BAHE..IEBBCGGEUAAEdEEBhAFAQABG.hAGADFFDJBGFAIFAGGAFhAAAaDHD.fDGC.eADE.MEIDhAGASHBA..hBAA...,2,-28,-7,21
OAKHgCDXBUfcbMZINWTeVRadSGLQEFPYJ,KCFCCFDDBEBAUDBD......bBABIDHG..NIEB.TFFHhAAARFFA..dCHGSBAAhABALAEAFDDChAAAJHBEAEEADIBG.XFACMAEH....WFHHhACAaCCG.EGAA.PAFEhADA..,1,-30,-32,2
QRLWSCdUTZYKbHNEMFfIOAJagPcDeXGVB,aDCD..gDACDFGBGAACBEDBLGACSAAFCHBE.UCFBhACAZCEAKHGGHFFAEADEMIAGhADA.IAGEhAEAAHFDJBFEeFEFXFBH.QBCE.hAAAdHFD.....hACA...,2,-23,3,26
fIXZeMODQNJLUSAFPdaTRBVCEKbYgcWGH,FAFBdAFBaFEARDDGBABC..CHGB.KHGE....bCAC....gFDEhAAAGEAEfHCBhAAAZEAF.OBBEhABANICFLAHB.ABDE.VCFAECCA.cFCFhACA.IFHG.hADA...,2,-38,-12,26
NeKDbfQUXIWBLZHMcFPdgTSARCaOGVYJE,aBBDOEGHGGEF..JBAFeEBEDDEB.QBFHUAGB.XGAGhAAABCCHZFAD.MIDAhAAAPACA.dEEASHCChABAAIBGCBACEDHF.KBBEfFBBLFHB..hABA......hAGA...,1,-9,-34,25
NdWAGRVCIfDaTKFbLQPMJgBOUHcXSeYZE,RDAHCFDDDGHFKABELAHF..QCBHMICGBEHAUAGEHADCSHEEhAAAZEDCdGDHACCF.GEEDhABA..IHGFhAAAfADFFDDA.bCFC.JFBFcGAE.hACA......hADA...,1,-13,-29,16
aAEMNHcdIXfDFWCeYRKPgLOBSQGUJbTZV,EGFHMECGHEEAdDGG...IDCHXACBFEBHCHBB.RBDB...KFDHLBHFhAAASAFAQABFhACAJHEGZAAFaGABAHAFfAFEhAEA..DBIHYFCB.hAFA......hAGA...,1,-1,-34,33
DefABWIRLObYdUFgJGSKPVMcCHXNEaQZT,BFDGRAADLBEDOBADdGFBFCEFGBGC.KGCAMACCHDBH.EFABaEHDhAAA.ZAGFDAEE.AFFA.IHHGhABA...hAAAbFBH...gEEGSGHH..hACA......hADA...,2,-29,-21,8
FVaTPZdRCgYGfIQOXEcASJMWKbBDHeLNU,MEGFKHBGBACBHAABLCFCUFCHFBFF..aFFCZADF.CHFD.GCBChAAA..IBHEhAAAOHFCEGDEAFFH.JFADDIAAeBDChABANDHE...TDFB.....hACA......hAFA.RDBE..,2,-22,-16,6
EcCaWMOURLJTVgZSPDeIKNQfFAGHBbdYX,GCCFBFDDdCABEEAGCHEF.MABG..OEBHUCGCLAFE.hAAAVFGFSEEEhABA.eAHHIBCDhAAAKGGBfAEGAGFB...YAGDhACAcFCD.aBDH....hADA...,1,-13,-45,32
KfPIbdCZFLGUeTMHWaDBSJXYVQROcAEgN,EHBGKHBG....IGEGbCBF..ZCGFFDDHLGECUAFG.MDDEhAAAHBAAaAFBDFIDJABCXEABhAAA.QDGFhABARECFAGIBfEAECGGETADGBAHF...hACA......hADA...,1,-8,-27,19
cLKHSBFGdTXQZEVPMUabWYODJRfeINAgC,CFDGKDCDHDAEFFGEGADBdGFB..XBCCEBCB.MIBGaDGC...hAAA..bAFAOHAGhABADIFGJCHHfCAChACA.NIDFAHHE.LEEFSDDBBEAAZCFF.hADAPACA...hAEA...,1,-11,-18,7
FZOYWNUAKJfXCGREbLMgHIPcTaVdeSQDB,JCCHCHHGRDGH.LBEGHDBG....IAFATGEH.dCFC.eBAEhAAASBAHBHAB.ZFAChAAAOHCANBIC.AACEKADBhABAfEAB.EHGC.MIAG.cEEAhABA.aEGFDFID..hAHA...,1,-14,-27,13
abCdHNKOXFJSEZARfeVgPBQcIDTLWMYGU,RFDFeFBB..VFACBEHF.QDBADBDHLEDCMGDCUBAFCHADHBDGhAAAKCEC.OGFE.hAAAFBADSGGChABAAAEG..PEDAIAFDWAGH..aEAGNIDFJABAhAGA.....hACA...,2,-35,-1,34
WHEFMRTdfJUOSabYePNLQACVDKZBXIGgc,CFCFDGDEKABHBGBC.GBBC....gDAFHGFEFEFARAFAdAAGhADAJAABOGEA.aDHBhAEA....eHCEhAAAPHCGNDEBAEAE...XGAH.IDEHhAFA.EAGC.MCEEhAGA..,1,-24,-33,9
AYNSTHRcJUgfDCGIXVbQPFeMEKLWdBZaO,SHBGHABHRBEEUFGADHEGGDCE..XAEEQGAGFDFFEBBAhAAALAHBBFAFaDDBhABAAFFDNIEB....TDAAhAAAcGGD...JAHFfAFBCDHG.hACA.IDAA.hABA...,2,-25,-9,16
YUgTJBVHaDNFIOGEMbXZWKCQLPdRcAfeS,SDCDUCBC..JEGHBHHFHAGHaEGCDGIHFGCEGDDG.MCAHhAAAXAAC.ZBDEhABAKABECDAELAGHhACAdGAHAFBD...fFED....hADA......hAEA...,2,-32,-32,0
TCIeLZFQfHRaAEbJYSgOPDXGKNWBUcVdM,JCCHSHBG.OEFHDHAGKCFA.BFBBUCBC.dDHACCAB.LBGDhAAAZABA..FHGCQADEhABAHEDB.AHCAEHGGhACA.bFBAgAGG...PFFAhAAANDAE....hACA...,2,-47,-7,40
HbTRXCPMGJYZgKUdFNVceDBOELIWaQfSA,TFDHXADC..CAACGAEGJEGF.ZBCFUGDGFFHH...VBABhAAADDIFODAFLFABaGFDhACASFCCHGACRAGBMCCFhADAKAGCdCEF.eCHD......hABA.BDEA...hAEA...,1,-6,-12,6
bFgXZUDJCYTASIRGOLEHQKcNfPdMaVBWe,SCFCREBHLFHBHCDHKACG...fBFDMFECBAEB.eBHHhAAAbGDE.FHAAZABBDGEDCFACABAGhAAAGCCG.OFHDhABAEADFNAIA.aCAG.........hABA......hAFA...,2,-23,-11,12
cQWNMBCeKDTgIdVbZJFUfGSEAaXPLHORY,XGBCLFBBOAAERDEH..QADAMEECBHAFeHCADFHD.hAAAgCAGdBEBZGDE.hABAUDGAfFDHhADAEAACaCCF.HCCE.WAGBCAGAIHGH..hAAA......hADA...,1,-11,-17,6
eRNKQUbcMAPLDdCHVfBXOYGFWgESITaZJ,LFCHDFEAHFCEBBHBXCDHGCAE.FABAEEAA..SCFBhAAATGABJAGFeHEAKEGEUBAAhAAA..cADDhAEAAFFCCGGF.OHAC.WFHHaACD...NCHA.hAGAMAIFdDDF.YAEHhABA..,1,-12,-14,2
GVbfXLMOJgZPIFQUBETAcKeNCYdSDHRWa,eCCHCFDGdCABHFGHRGFEGBFA..VCFD..fFAALCEDMBEGhAAAJBAD.ZEABFEEDBCHBhABAAIBGKBHHSBBEhACADAFHaABA...........hAAA......hAEA...,2,-25,-15,10
TDOEcXSdMICNYGWbVRKZJeAaQHPgLfFBU,HBCFLGEABGFADIGAEGDB..SBDBdBAGMBIB.CFFDGCCChAAA..WBFDRAFHKCACZEBGhAAAAHCF.aAGB..QFAChABAfHGF.FFGAOEFA...hABA......hACA...,2,-23,-20,3
YTSbOKWGfHQZdBIcVaeEPJUgNARCXMDLF,CADCDIBGLCHFFBFH..SFHFKFEA.GAACQDCHhAAAZEEDdCHEBBAB.IGAChABAVFACeDDDEGHDJAEEhACA..NAEEAAFAMIAE...YGCAhAIA.OCDG.fDFEhBCA,1,-17,-30,13
FdeTHJcgKGZXUYIWbDVQMSPNELCRAOBfa,OAFBaEGD.FGEAeFAHHBAA..JBBCKCGCZDDEUEBC....hAAA.IADCDAFCMBEGhAAASEFCEDAACHCBBGHAhABA.dFCD..gGAG.YHFGhABA....hACA...,2,-36,-33,3
CPYARfBMeDdUTZEKJQNFXVcWSLaObGgHI,BFDDDACGUGEDECCBKFFB..QCFFFACC..VAFGSAFChAAALHEAODDHhABAGEAEIEBACCEG.hAAAABCBMCIHdBAAJDHBXGBC...WBDBhAIA.....hABA...,1,-25,-26,1
NOZacFPDXYLVfEAIHKJUdbSTMBeCQGWgR,HDAGKGDDdFEHSFECBDAG.CAHGGGEHRBAEZAGB.aDFAFCEH..XBAFhAAALFBFEFABAHGA.hAAAIBFA.JADFhABA............hACA......hAEA...,1,-12,-52,40
VQCJEFbXdcBUOgWSLHaNZIPeKTDMARfYG,RAADGAFECGDC.EBAFFACCdDBCBAGAUFFA....ODFASCCBhAAALFBFaAEBIHAFhABAeCDF..DEIHMDIDhACAAGFE.fEDF..YHFAhAAA.....hADA...,2,-42,-22,20
WKTOCGYUDZIgFPNAdSfQHaceMRLXVEJbB,dAFBQGBCHGDGaDDBeABHLCHD.EEAHJDEA.BADGKEEFCBABUAFAhAAAZDBF.FGFB.AABF.fADAhAAARECA.XGGFhABAWEAC..OEHDDGBB....hAEA......hAIA...,1,-6,-27,21
ePTBKgVQYbEFdRNZIDUHCGJOfcaXMSWLA,eDACBHHGKDGFQAAB.EHGARBEFZBCDUCGCCCAHGFAD..hAAAOGBC.cDEHhABAMAFCSBHBhABAAIAG..TADHYHDEFAGCIFADhADA.DGGAfEEEhACAaGDA,1,-18,-45,27
eOTWZPgGLQfVbSKaMFEBdYRDNJXIHAUcC,CHHGeFCA.OBGHTDECZCABGBGCLHAEQAEF.VCBEhAAASAAF.hABAaFGE.EADG.BECHhACARGCEJFAGIHHEACAD.......hACA.UFGF...hAFA...,1,-4,-29,25
AUfaFGLQHSDYNZecMKgECXVWJBTIPRbOd,aGFCFHAEQCBDHDAFDABEZECD..MCFCKBCA.EAAFCAEA...VFEGhAAABAHD....PFAEhACAbCDEAIAC...fDFBhADASEHB.NAAC....cEFHhAEAWAEF.....hAGA.IHDE.,2,-27,-15,12
MATYNKOSEDFXbBZWGfaRIPJHLceQUgdCV,TCBCKHBGECCH..DFBBFGCD.BACGZABA.GEAGRGDC..JAHBLFFGhAAA.eBAFUDGFhAAACEGGACFBOAEGSAHHhABA.XAFBfDEGIHHC.hACA.cGGEdHEFMDEFhADA...,1,-13,-32,19
gQYOBUXLVKNDPSAGHeJTdCbIEcFWafZMR,GGDHJFFC.CAFH.EAHDFEAC....aGABMDEGRCDB.QBBHhAAABDGCUBACLCHHhABA.KADBNIEF.SFEChACAeBEEdACA.IHAEfEAF...hADAgFCG.hAFA...,1,-23,-27,4
IDdHEBGJMPUcQgfXSOCeTRWFNKLbAZaYV,ZDAGaCFC...IGGDDCBBdFAABEDBGGBF.MABB..UGEBhAAAQCGEXABEOACEhAAACHCB.TEEEhACA.WCCCNBIAKAEDAGIB........hABA......hACA...,1,-10,-48,38
HZfAKLSGOIJbEUTdVaCDYMBNXceQFRgPW,KEEDSAEGOHBE...JFFDUAGH.dDCGaDDGDABGBHGA..hAAA.XDADeHFCFBEDhAAARGAE....WBBBhABAHCGFADAH.IEAC.EADFCEGBNEIG.cAGAhACA.....hAFA...,2,-32,-29,3
UgeKOSLaCMFWAcVQENZBYPRHdJXDIbTfG,QFDHECFCBBBCRADG.JBCC..DAAB..IGGE..bFAChABATAFFUFEAeDCGhACASCAGLDHBCDFDMIAGhAAAAHBE...NIEB..PEAG.dABCfDAEhADAKEHBaAHFcFAHhADA..,1,-7,-35,28
BAbCYTDSWJdNMGHUQfLOIKPXecFgZaVER,CFDGTAFBDGHF...JBEHdCAE.MBHHHBAG.UEEFQCDEhAAAOCGFKEADeADEFGHBaHAEEAAAhAAABGEA..AHAASDBGhADANBAF..LFFB..hABA......hACA...,2,-33,-14,19
PTAFYbNBcZWdXCKDGRMUEQJLHIfgeaVOS,FHBG..NCCAZDDFdCCAKAEFGBDHRGEE..UEGGQDGG.JAAChADALAGF.HAAEhAAAfGGFeDABaFCChACAOFAB.SBHBAIHGBEDA...hADA......hAFA...,2,-21,-21,0
XTMaVcdCbJfKDOUWQLZgSPFeYGAINBHRE,BFDGRDDFEABD.MDBB..aGCHdFFH.CHEG.JBHDKAGC..DIGCUCDHLFAHhAAAZAAE...SDBGhACAeFBH.AGDHIFGEhADANCIE.HAEB.....hAAA......hABA...,2,-44,-21,23
JfXeTHVRLOcBKaFdCYPEbWDQMINSZGAUg,UDACJGEA.eCGBHCAFREEF.OHACBAEA.KGBCdECA..CAAF.EABDDEHH.hAAA.MIFE.SAGBhACAZACBAFDGXAGEhACA.LCFBFGGA.......hADA......hAEA...,2,-29,-29,0
LAeVJYKfFRBSWCNZIOEacTDdMgUXHbGPQ,JFFCKHBGRFEABDDG..SCCF..NAEFZCBDEAFE..TDEGhAAADBGC..MABFXFBEhABAGGDBLCABhACAAIDG...eEHB.YAHBWEFECFDHaCGAhAAAcADAdBEE...hACA...,2,-40,-11,29
NOeQLEFbTVPZcAagCBUIRXHfKWSYGDJdM,CFEDUGGGRBFA.HCBFKBCA.SAGCGDDD.DDHFdHGD..MBBAeAAAhAAAEBHDFFBE..VEDFhAAA.ZFAF.AADA.aAEEBCAAhABAfHDB..YAEBJHAA.hABA......hAEA...,2,-30,-8,22
UcTOMPJWVCdGSDbXZBEeLNKFAgIaYRQHf,aHBGQFDHHCCCUFEHOADH..MEIBJBGH.CAAB.GCAC.hACADIGAXAGCBEEEEAHDhAAANIDF.AFCA...IEBAhADAfGGB.cGAETCGF...hABA......hACA...,1,-20,-31,11
aPMIQZNbfcHDLXgCdSTGJKAUEeOFRVBYW,UGGDeFFBOEAGFCEGBFAH..aCCG.MICEZABD.....NGAH.hAAAbBCHHDFALBHHhAAACBHESBAB.JACEhABAABECEGDH..........hABA.YEFAPFHBIHAFhACA,2,-47,-9,38
aOBIGgTEdPMARUfJXYKNLScFHCeZQWbVD,UFDHJDAC.KCHDLGDG.FDFACDDBeABDZFGH..QGAGhAAA..WAGFDBAEBCCEhABA.GAEFhACAEGHHPDAFAAHGXEDASADG...hADA......hAEA...,2,-48,-21,27
TgJaKQDGYVRUdIbePcNfWMSEXAHBOLFCZ,HFEEBECDLABECHAEZAAB.JBFAKAEF.DGBCGEFARCDA.dBCEeDFAhAAA....cEDDhAAANIED..MAFEEHAEAHEEhAFAFDBD...........hAGA.aDHD....hAHA...,1,-27,-35,8
aFNZQePVUAEIMBYJgWKbHXLTdGSDOcCRf,EGFHMBFHBAFE..JEBCKABDHAACLADBdGGFDIBECHBC...aGEBFFBGhAAAZAFFQDEAhACA.eAHFPBDDAEHD.hAHAIAHF..WDHH....hBAA......hBDA...,2,-33,-28,5
eRJTSYPIWGCUaBNEMZdHOXQKFgALfbcDV,LGEA..cCCBeBFDJGAA..SCGE.hAAAIAHBWCAFGDBBhABAUGFHaBADEFFCMBIFhACAHFAHOFEAXABAKGDHAGIDDAHF....hAEA......hAFA...,1,-22,-23,1
cJDRYCGbaQTWKUZFAdIfMPEHLBeXOgVNS,dHBHMCCAEEABHFABBHEFOHFE..VDCASFGC.JACAhAAARBAEGEGAQBAAhABAKAGEFCFCIAGA.hAAAPEDAeADE.........hABA......hACA...,2,-24,-11,13
cTSVMOKDAUIYCefRHdBGaNbQEWgLPZJFX,UCBCCFDGRAFA.dGHCGEAG..aDGCQBCCEAGB.LFFEhAAAZEBGXFEHSHDAhABAOABEADEAICAFhACA..fHABNEEHgGGE..hADA......hAEA...,2,-32,-16,16
eURFXVYCZKNcafTLJbEPQMWdHIBSDAgGO,OFEFUAEGRAAF.FAAD....XCDCCCEBZGAEKAGG..aGDCLEHBhAAAECHH..MFIDhAAAdEBHHCBASGGFhACADAEGAIDG.eDAB.NCCCTEEE...PHAChADAWDAD.BAGA.hACA...,2,-36,-3,33
CeRMfWFBcAdPVLKgaSOQDEJIYbGHXTNZU,dCFCVFDFKCHH...SFBGDCEEEDDA..JDAE..IAFChAAAGAAFHFAB.NAIA.hAAAZABC.CHFFMEHD.hABAfHBBWAGHBHFAPEEB...hADA.aGGAQCAAhACA..,2,-25,-23,2
DYMBZbXgQRGKCaWSIdNTfOAHFVUELJPce,FDAFEDAFLDDG..PFBEDGGDMGCEBHCAZADH..bFED.hAAA.XBBFRCDA.hAAACHDGaFFASACGhABA.NBIEOAGDABGB.......hABA......hACA...,1,-30,-36,6
LGeDFHYEXZJMCgdcVPKfWaRBUATSNIbOQ,SGFC..IBAHOACDLFDDDFCGFBEAEFGFXAEGhAAAMDDC.dFACPDAFhAAAfEEB.aCGChABABHHBAHHE.NICBbEEB...eCHD..hABA......hACA...,1,-24,-34,10
GSZcbgYFeNMBQdRCfaTLKAWXOJVPEHUID,XDACVFBG.HFBFUAEGGCDGZCEE...bBGDFHGE.eBBHhAAAMAIDBEHGRABFCFHGTGFEhAAAKGEAAICA....OBABhABAEBFFDGAF..SBHB..hACA.gEFDhADA...,1,6,-31,37
AfRTICZFgDQcLGPNeBbXHSEJVWYOaKUMd,TFDHZDBHDDADLBEF.GEGENDADBCHGHBFDEAFG..VDEChAAAOHAE.KBBEdFHCAFFB.hAAAfACACHDEFFAD.hABAgEBH.PHAA...hACA......hADA...,1,-13,-20,7
QOSZKBEcJCUXNWRGYPDVeMLTdIFbfgaHA,QGGDODCHKGDHBAHEJDAA..UGCH..XGGERCFCGACHhAAADCACMFEALADGhAAAdABC.FDEA..fDDDhADAaDGDAICCEDDDCABCYFADeFAF....hAFA......hAGA...,1,-18,-26,8
fdLXKgAbBTDcVUaJCWeOYGRIQMNEZFSPH,TGGGVFDG..UFACCBDH..ODEARAEA.MFEEEAACFDCA..hAAAPCAFdDFFKGHFAGCCBHEGhAAADEAC...cAFDhABA..aACDWGAG...eACC.hAEA......hAFA...,1,-24,-32,8
OUHQLAFfRbNCcaTMJeZDWEGXdIKVPBSgY,FCFCRAADCFEH...aEAEMHCAZEFE..DDEFGAFE.dACFKAACBECDSHAChADA.OHEAhAEAUGGCQDDBhAAA.AICGbFACcBCD......hAFA......hAGA...,2,-46,-21,25
JDHBIVNKAMTQPUeFGEgYfRbSLOdWCXaZc,TGABQCGC.UBAGGBDC.EBFEfFDBSDHHOAEAhAAACGECZFFFDFAABDEEIBBHhAAAKDCAAHHFeACGFAGA.hABA..YHBE.bFFBWEAE.aHDChACA......hADA...,2,-17,-12,5
aDYCWgIMGfcBJNZVSOPKEXFLUAbdTRHQe,TGBCHBCDeCFH.DCBBCEAC....IAADMFDHGEGEBDFDZEGBhACASEAGOAGFEFAChADAFGBBLACChAAAADDC.dAGBQCBE.YACGhAGA.fFFAhAIANEEE...,2,-32,-5,27
DdIXWfbaKYZBCQNETgcLVeFPORUMHGSAJ,dEGCXCBC..fAEAaEDG.ZEDFQAECECAH.hAAAgAGBLGAGFCFBhABAPFGBOHFCRABAUGCChAAAHEAAAHIBDBAFbACF.BEHCNIAB.....hAGA......hAHA...,2,-7,-7,0
AKWVfXFIPMYGdgODJSNUeQcTZaERCHLbB,KCFCVAADFACG..MDEBGEBA.dHGFDFBC..JAADUAFC..hAAAQCDCTDGDEFHFhACACGAGHEFABHBGAHIH.XDAChADAIDHFPFFF..YAFChAAASGDD...hBEA...,2,-28,-19,9
JgUSaVdFXbHWDPOBIRNGCcYfQZTKLEeAM,JCHDSGFC.dAGEXDBCHAACDDFDBAAAREBHGADE.CHED.hAAAfGGC.hABAZACBKDHBeAFFAHHB.gEDChAAAaDAB........hACA......hAFA.FHBE.,2,-36,-20,16
VCfBNPeQTWKaUFAIdRLGgJDZXMOcbESHY,dCFCRFBHGCACJHCG.ZAGF..MADGOCDF.EGEEHBAC.VFGFhAAABEHH.eACEQEBDhABAKBBCFDFFAHIBLBHHhACADGGE.XBDB......hAHA.SEEDhAIACHED...,1,-16,-19,3
XAVcJSfOQaLTIUPZHgRbYDMWCKNdEeBGF,VFDFSDCD.QGFEaEABLBDGUBBFHDEARDEA.DFBHMAIDhAAAKHGEEBAABGCEFAHHAFGEJHAAhABAOCAE..IAFHhACA.........hAAA......hABA...,1,-21,-23,2
IMSGDbNWYETVUZcFCHBfdXLePOAagKJQR,aAFBJCCH..RGDG.MDAFGBFADHGA......NDFE.EAGG.TEAHhAAAUACDZCGH.CEDGBGBFhAAAXABC.LFFAhACAeBBDAICAKGDBIHHH.bADBYAHHhABA.....hAIA...,2,-25,-21,4
CeZQWIHYFBOfEdMGAgcSJLVKNDaPbTXUR,SHBGVFBG.DEFGaAAB...TAGAXCCE.RFGBZADEhAAAQCBGHBADBFDDhABAODEC.EGGCdCGBMFABhACAACFFgFACJADGNIEB......hACA......hADA...,2,-20,-12,8
QNLDEHPXYBZJVFGMOabAIKWgecSTCUfRd,KHBGeGEA..TCFECDDDUAFEdGGDLBAGHFCE..XDCAhAAAZEADFEGEOHBEaDABAAHAIGAAhABA..WCFAhAAASBCH.fABA..hADA......hAEA...,1,-23,-34,11
TFJLQAIOPRZESKbGBUDNagCVYXdMWfeHc,OGEARGFGEDBE.KGBHBEAD.DCBEaDDB..CCGF...XBEEhAAAdHAFMAACeEEC.HCAFhABAFEEELDHFQACBhADAAFCB.IHDDSAGC...bACA.hAFA......hAGA...,1,-22,-31,9
KMSHLFDXfARaOYWIbeNUcBPQGJdETZgVC,RDEDOCCH..IBHCeBCEUFDBBHEFGAGEdDHAZFBB..CHGEKGAChAAAMBAD.LCBEhAAADIEEADAB..aBAFWEBFhABA....NACBPEHDEAFB..TGGFhACA.....hABA...,1,-22,-30,8
NXIVTdHfLOEZWYaUcBCRDbMSKeQgAFPGJ,GEAHJDAC...IHAEVFCEHBGFOHFEZFAB...aGEGUABAhAAACBCF.DFFG.MFIHhAEASAACKAFC.gCDFhADAFGGB.PCHH.NBGA...hAEA......hAFA...,2,-31,-24,7
cZNKBeVYHdTEQACJRWOIfGXMFPaDLUSgb,CEFAJFBBRFDH...OCBHGBCF.FDGADCDDLEABUAFG...SADChAAA..hABAgGGDZFBBBDDGeAFChACAHFDHdACHQGGEADHFfDFE.hBAAMCIB....hAAA...,1,-8,-41,33
WSNeEVOHLMCXTYcfGJZgAdBaKUDRFbIQP,dEHABEFAUDAGRDCBFAFA..QGCF..SBAHhAAAEDDEHABCMAIHTCGAfECDhAAAJABAZFBF.ABGC.DGHDhAEAbFFB...IHAHWCCC..NEIE..hABA......hACA...,1,-18,-34,16
IJVPWegaZCBdYSDORUQbKGAcXNEfFLHTM,XCBCEHBGFBFH.HFAHMAAB..JAEE..VDBG..WCEEhAAAaGFHBEHH.SGHDhABAREFGbGDA.AEFE.fEDGhABAIFAGPBBGgACF.CAHADCIDhACA.....hACA...,1,-8,-37,29
WVQdIUZRCPBHOKgXabcMSeAGfLENDFJYT,LFEFEHFGFFAB.JCCC..TDDFQGFEdHCHZFFARDAABCHHHBBAKEGAhAAA..aHBEMDFGhABASBAFABHA.fGAHhAAADEAGYADCWAFC...UCFEhABACFCA......hACA...,2,-24,-8,16
LHRfQYTDXVFZKegSJEBIAWaOCcMUbdGNP,OCCHCBFDUGBA.dHAFGEDBLAFA.RBDF.QACBDGEB.FGHDhAAAZGFCKGDHSABEhAAA.BDGGAHAHaDAGMBBFhAEA..NDDFfAFBYFFC...hAGA......hAHA...,1,-28,-30,2
cFCOLMeQRgdSPBAaDGEYZNJfXKVbUTWHI,aEHBDEFAGBACZFCE..JAABKGDA.UAFGHDAHFHGECHAF..LHDAhAAAeFBF.RDDA.dCCESAGDhACAAIEA.ECCEfFGHhAAA........hABA......hACA...,1,-19,-39,20
EaXfIOWJDAKBbSTRCGFLUcdMNQePYgVZH,BFEDTGBCGBEA.UGGAMCAB.QABBeBHF.PDCEhAAAgGCDZFFEEDGFXCBHhAAAOFCGJBDEKAGDRABEhABA.FFAF..cBFE.NAIA....hADA......hAEA...,2,-18,-2,16
HfORMAVLSWDZbKdgcTeXEBPGJQaICYNFU,VDEDSDCD.DEBBZGBE.dADE..TEFBEGHFBDBDGGDFhAAAJABH.aCGF..CBFDFAHDhAAAfHBB.MCCEhABAAGAD.bAFA.cABBPFAA..IDEBhAEA.NEIE...hAFA...,2,-35,-21,14
WKOCRDUdPfNEHVZbgFXAYSTMIaBGceJQL,TGBCMHFGBBBA.GGABeAAFLEBA.KHFCCAEBDDFHdBCHNDEDhAAAEBFA.ZEBG.FCAHAIAGSGEChACA.hAAAaAGFQDGC..OFFA.hABA......hACA...,1,-14,-35,21
QTIMaREYJgAVXWFdHUOGNKCfZeBPScbDL,XFDHFAFBdHEDHDDDUDBDOCBA.KACECAHEeACF.BHBFSEBGhAAADIGALBGHhAAAQCGEMBABaGGARFGBEHAChABA............hAHA......hAIA...,2,-32,-19,13
LBQGDbdRJZfSMFKOUWYNEAHegTCcVXIaP,HFDFeDACCFAGXADH..aGHBLFFHBHACQCEEhAAADBBDRCGDfGBAMBCGKCGGUDAFhAAA..NADHAFGCcDDBhABA..IECB.....hACA......hADA...,1,-16,-32,16
GaKZVOebDdNQIcJWgTHUABEXSPfCMLFYR,BFCFXFCESAGE..PCBBMCEEFDAHRDECGABDZFEAeEHBhAAADFGDdAGA.IHHGhAAAJHDG..TCCGhABAAHDBCDDFaFAHKHBE.bACCNAIE.......hABA......hACA...,2,-19,-18,1
PfGMTcJALBYDRNSOCUeXdHIEWbaFZVQgK,LAFBBAEDDGGHRFCGOEFH.UACGeBFFHAADEFHH...aEGEFCAFhAAAQFCHKDDHGBGEhABAMEBB...JAHFhAAAAICGSAHBCGHH.IGAE.hAIAZCBB.....hBEA...,1,-17,-20,3
VbYFcMQITeUCBNLgWSOZGJAREPKfadXHD,RDAGEAFBKGHHdBBEHABB.DAADVEBG..FEEDMCAB..TGABhABAeEEECHCEBDGALAGBhAAASGGDOFFBZBFCADDE.hABAaADF.....YAFCIHGE.hBBANBIC......hBDA...,2,-23,-15,8
eHRSfUEPgbLADMVQYJCONZGFXcWKIBaTd,DIBGMEIBQGGG..JDCFCFDGZEBBFAFH..XBCBKACGBEEBhAAAdGGCHAEBRBAF.SEAHhABAEBHD.PAHFhACA...........hAAA......hABA...,1,-26,-44,18
OUbVcPHMdZfBWgeQKXEaSINTAJFDYGCLR,DFDCGGDHLDHFREBDOABDUGBF....VEFEHDBEZBECfAABhACABAFF..eAHBhAAAQADBEEDA.hABASGEENDAAADEC.FAHD.CCCB....hADA......hAEA...,2,-20,-14,6
TYQbINVKMDdaRUePZACLEFGJXfgHcOWSB,EDABFHAEGBBA..XECGHAFDOFGDBDDHTFEEQFEFhAAA.IBAAhABAKCCCDIDAaGAFeBEBZAAGCDGHfDAEhACAgDGDSAHBNDICMEDF.dAFEhAAA......hABA...,2,-24,8,32
WLHQAOJCUPIfcBYVNMbFaRXEZDegdTKGS,OEGHCFFEUFCA.....fGCHBACB..NAFE.MFCCFCCE.hAAAXBDAZEGF.eDAEhAAAdAGFKBBFSHDAhABALEAFAACAIGAH....YHDGhABA...hAEA.bCGB.,1,-32,-39,7
YTMEBDebHQJFKGNgSWdXOLCfIZPacVRAU,UCGCMFFFDADEHBBA.FFEAKDBAGDBH..SECAXFAHCADDhAAAZBFH...PHBGhAAAaGDH.RABE.AFHFEAFEeAHHhABA............hAGA......hAHA...,1,-21,-36,15
NbAeLcFIMHXQDVaKGOBSPCEgdJRZYWTUf,eEEGFDCDMAAFHECB.DBCBKAEBOHBCBHHE.CGHC.dHCHZAGH...TAEAhAAAUDGH...fDAEhABAAAGAIEAG.hACAQBBFaCEESHEEEEED..JAHD.hADA......hAEA...,1,-15,-34,19
ZRYJbeUEfHDQFBCXKASPcdTVOWaINgMGL,SHBGdHBHOBEH...aGDC..gAGGLBBDZEFFJCCD.hAAAbAEC..EFFADDAHBGHFhABACCHGAIHE...PDADhACATCCC..IHEGMAAE....hADA......hAEA...,1,-22,-37,15
EBXHcUJACfKVWFeIgDYZQRMNTadSLObGP,KEGDVDAGeFAD.DBBFZFDG.QBGHRFBB.MBBGaACGSFEDhAAALHFGOFABhAAAGCCCEEDCBBEA..hABAXGBD..cFGDJEHBACABfCCBhABA...hAFA...,2,-38,-1,37
TIYbBZOWgCAJKFMSEfNcGadDHRLVUePXQ,JEGHMIAG..EAFE..NAAG.GBEE.aBBADFBA.HBDGLEADhAAAVFFGeHEGQGCEhABATCGGICAFhACABAGAODEBCHEBACCH.FGACSCGEfCCGcEBEhADA....hAEA...,2,-20,-10,10
MfadLIZUDPXEVGBeOJcTFbRQCNgAYKHWS,KCFCHDAGMHFCaFGGLGBGZADE.UAGCXDDHEGHF..BHEAhAAAJFAF.FADBRDGF.CBAEAEFH..hABA.SBFDhACAfBAFdDDAPEAA.......hAFA......hBCA...,2,-32,-13,19
OaYPMXRGTKIVCEZWUJgcfeQLBSDNAFHbd,FCFCHDAGODADaACDMEGFGDCD..IABDEFHFZBAE..JAHHfAHGhAAA.eEHBhAEABAAEDDFANIAFAAGHbFBC.hACAdAFEXFFBKEDACHCF.......hAIA......hBAA...,2,-24,-9,15
agcAQfULGVZHEOMDIeCPJWNFTSYRXbBKd,QCGCUDACLHCEZBBBHAEAEGGF.DAGEeEFGJGDE.FAAC..SDEDhAAARAGDBCEAKCCEaDAHhABAAGAF....fAEFhACAOHFEMDDFCFFD.......hADA......hAEA...,1,-15,-27,12
XJFSOAcDBaRTVZMNbYgKfLPUGeWIEHQCd,DAEDaGFH.RDBGZGEA..MDCC...NDBC.bEFA..KGHHLAFGhAAAGEEBeAAEEGAGCCGDdACGhABAFGCFABIBBHAD..TAEChADA..........hAEA......hAGA...,2,-30,-30,0
YXZWgHfKJLIRVAQbPTBMDEFeScUadGCNO,QCBCTCBC.BHEADBEHEHCGeADGUBFCaCGB.GEEH.OHEAhAAAZECEgGABhAAAHEAAfBAHJDHB.hABA.IAHFAIHEMABEcGACCDEF.NAIE.WCADhACA.KGHB...hAFA...,2,-10,-8,2
bgOTSRXfQKVINUBYEWPJZDLGMcACFHeda,FGFHHDEDdCGCaHGE.ODAERDDB..XAAEQAGEKGBH.VFBChAAAUDAABFAC.EHEA.hAAAJABCDBIB.MAECCGGE.hAEAeFDDgBDASGGEfEHEhAFA......hAGA...,2,-27,-7,20
LgRdSBPfGFKDbOcIQeTZYUECMJXANHVaW,HGFGVDAG.aDDGLAHBRAFABDGG.GADF.FHGEDDIB.OABHhAAAIFGCTACCZEDDEGABhAAACFAC..MEEDABBD.NECE.hACAdGCC.fDFBKGAB.....hAEA......hAFA...,2,-20,-6,14
JOPFBbSfHTAVYZWEgIXLNKaCeMdRDcQGU,VGFGZAADEEFG....XCGEKCCFCAFHdEHERGAC..DEFEQGDHhAAA.GEAEUAACJEAChADAFAHFSGGDhADATAGA.AEDE.gBDEICFA.LFFChAEAeACA.MDEB..hAFA...,2,-16,-9,7
ONgFbPYEWMHcLKXCSUVTRaQdIAZDBGeJf,DAAFeCBBOBBEFDEC......PHDEEAFDMGEAHABGKHDESFFChAAAUDGF.TBFAhABAaEBEdHAFAAFBBHBGhACAJDAE.gGGB.YDHHcAGACHHEhABA......hACA...,2,-35,-7,28
SOadMYZfFEUeXTgBDNcGbHPRWALIQVJKC,LDACVEFH.CGFE.OACGMCCG.ZECBEHGAUGAG..eCHF.hAAATAFGDFIHGBAHhABAHFDBRFAEIAHEKEECSABAhAAAdBFA.fEBD...hAGA......hBAA...,1,-3,-25,22
RFIKPaYAbUCSeJXBGLOTgQNMcVZWfdHDE,CHHGeFFBBGFDGAEHLACBOBAC.QFAEMDEGZGBEdAGHEDBCFEGFhAAAKFFC...aHDGAIFEUEAFhAAA...XBAFhABANCIE.......WEEChAEADDABIDEC.hAFA...,2,-36,-11,25
bVcSWQONaACUBHGXFYIdfTeLJRPgZKDEM,CFFGUGDCHDECFGGEdAGF..eBHFJFCH..RABH.ZFAF.KCCHEAEB..MACChAAA..bDAESCEEhABAOHFA.AFHCBEFGhAGA...........hAAA.YFAFfAGFhBAA..,1,-33,-35,2
YXJMBKTDCcASNgeUQGafWRLEFOPVbIHdZ,SHBGeGEAQCCCGBEH..fCGCRGEEEEGHFFAAOEDAhAAAbCAD.HCBAdFDHYADEhAAAMBCGBBABDIECAGADNADDhABAaBHF.LHAE.IABF.hACA......hAIA...,2,-7,4,11
LfQCGdEBYDTJAMFKSOXRWUHePbVIaNgZc,KHBGSGDDRDDGHFGF.eABE..VAACICED..NBEDZDABhAAAfEHGGFCFBDHAhADADCBEABIBFGFBOCFA.hAAA.XAFE.UEAG....hAEA......hAFA...,1,-11,-30,19
WGPHEOKfSFIRgcQDBZLeTMYVCXUbAdJNa,JCCHaHBGGAFAHGDGKFCFFBCG..RBGF...QDDDBAAAeBEHMBAFhAAACCAF.UGFEAFEEdAGBNEIE.hABA..EEAH..SDGHhACA.IAHCDAED.ZFBA.hAAA......hACA...,2,-33,-4,29
STIEUgPAHWMbLQcdRNGKYfFVJXOCDBeZa,HFACMCCALDEGdCEARDFFKAAF.FFBG..JFHDXGGF.CAEEBFFChAAAeBCDSBHHhABA.EHAE.PADEhACAbGAAcCAH.NAIE.fDACDBAA.hABA.aAGB....hACA...,1,-14,-30,16
RYdCZPMKNBAacGeXbWTVfDUFHJEIOLgQS,GEAHeDAC..XGCAbBBC..VGFEDGIFUDGDHAGHEFEFLFAChAAAQAEASABFhADAdAABCDHAMEDEKHFAAIAEaDEHhAEA...TBGE.....hADA......hAEA...,1,-2,-17,15
YWCTVAbDUHIEKFGMgQXeONadSfBPRcJLZ,DAFBHEFHEECDFAFA.GECEQFFAOADBdGAHBBFGRBGD.LAAFhACAZCDCCBBE.ABCF..IHHEhAEAMIFCeCAH.SFEDhAAAfHEB.PCEBYABCWCHBhAIA......hBBA...,1,-13,-20,7
RTEgVJGMNDLWbdSKOfUXYHeIaCFcQPBZA,EDAFVFDFGFDD.DAGGLCHF.dGBGSCGBKBAFOAEDhAAAfABDUBBE.hABAXDCB.eHBEhAAAIGGGaADFCFAHFHFEcDEHBBBDAGIF...hACA......hADA...,1,-10,-33,23
AFaMNULfZEVJIbSHdgPDGBRCTcOeXKYWQ,MIAGUDACLCGDZABE.EHGAVEFH..JEEHSHDEhAAAHAAEdHBHDDDDGCDHBAHBCAHDOFAEhABAKCHB.QDABhACAFCEFaGAG.IHHE....hADA......hAFA...,1,-18,-20,2
LfKIcEaFMGAWgJBCdYTRbONDQZSPeHVUX,JGEACBEAdBCG..RCAF.OGACDFEC...QFDBSABCHAGBhAAAUGBGLEEC.hAAAfFHAIAGG.hAEAEEBD.MDAHAEIBBECD.bDEANIBB...eCCEhAFAKGFB.....hABA...,2,-34,-16,18
ZUHXSfgKEBAPMcQYeRGaDLNIWOVCJTdFb,MCCAQCBCRAGF.GGCDLFDA..IAHGOEBFCAEEJDFDhAAAdDBBFAFFZGEEUGGESCAFhAAAKFCCEEADACID..hABAPDHDeADB.NBAB........hACA......hAEA...,2,-18,-12,6
CNEAXWHgQPcYTbDJILOKRefGZSFBVaMUd,HEFHQCBC..PCBDTDEHJFDFOFCFKADC.RAFEeEHBhAAAZBFEBHHGMIEACAAEAFIHXACFhABA..gBCBhACAcFAGDFGDIAGC....hAIA......hBAA...,2,-35,-4,31
SZNaQgEGdBfeVLKXPATIcUHRbOYWJMFCD,TCBCUCBCHDFB.RAFC.OEHD.JGDEMFEB.DBBAZBEEaACAEDGFhAAABDHDeHAG.LEBAhABAXGAEAFAB..bADChACA....WFHH......hAAA.CDDBNBAE....hABA...,1,-10,-33,23
CJeSgIcfWOTVNHdBQaKGbMDYARPXUZFEL,XFDHFDAFEABH.LCEECGCB..SGEAIBCH...hAAA.fFADhABATDFENCEHBCCBKHGAMEBADHAAADEChAAARDFEPAEA.UFGF.....hABA......hADA...,1,-6,-48,42
IWXRPgeOadKcNbAGYDBfCJFLVESQMHTUZ,GDCCDAEDBFGDCCACFAAGLDFA..EEAHMABDHGEEZFBD..ICHChADA.XEGAhAEAPHDCeAGD.hAFAaACBdGBCKCDDbCEBAHAD.fCBHSGDC.hAGA......hAHA...,1,-14,-32,18
cTbBYJUIKfCSdeGgFQVMOaDEWLHXZANPR,RAADTCBCBFEHUDAF..KECG.CGHGdHBHeAGBGAFAFHAE.QAAFhABAOEDB.DFFEEHFChAAA.LACEXADBhAHAAAHE.NAIE...PEHD.....hBDA......hBFA...,2,-28,-24,4
gHAaCBDGIfKNEZVbUXcdLFOQeWMSJPYTR,CCEADGCHGDEFKGFEZEDBUFAH..dEBBFCCD..eABGMBAH..JAFChAAA..TFGFRCFDAADE.hAIAaBHFBHHG..IBBFhAAA.fHCFNDIE..EBBBhBAA......hBFA...,1,-29,-38,9
ZgfBDOaYVRWLGdPNHJTESMACbXFIQceKU,XGGGQGBCKAHHZBFE.BAEDDBAH.aFHFREDHGDAG.dAGCNDAHHFEChAAA..JCCETECHhABAEDHDACBG.FABE..hAFAIDFA........hAAA......hABA...,2,-31,-17,14
bTSfIPeCQcZaLBgAHVXDWGdJNROFEYUKM,VBCDXAFB.DCDEdFEC.RDGH.FAABUAFCKFHD....MEEHSFBFhAAA..PCBFhACACABF..cGGChADAaGFFBBHD.AADCWDDCNIAD...EFBB.hAEA....bDFE.hAIA...,2,-37,-30,7
YcWNSKbBDIgQMaZeOGHUTPAfVELRFdCXJ,VDAGEDBDLEEB.dGGGJDFD......YADEhAAANBHESAHBKAHFDFDBQGGGhAAAaGBHZBBCGBFEhABATACCADDD.FGBH.XFDD....hABA......hACA...,2,-33,-11,22
DQOVJKLNHeBTXWafEUYIcPZFSbCgAMdRG,dFEFGDFCQGAAJBAALDAAHAGHeFHBBFDF...TCCEhAAAaFAA.fAEGhABAEHCE.IACAZBDFSBHDhAAACDFHAEIFDIDAKGCANACB....WFHH.hAFA......hAGA...,1,-7,-22,15
FUMSENdfcgWILGAbCOYaXKTPRBQeDHVJZ,CAFBaDCDKBCH..RAACBHBEDIGE.HGEAZEBG.UBEA..EHBEdDHC..hAAA..fFFChAAA..gDAHhABALBEAbBAHXAGBQDGA..hABA......hACA...,2,-38,-24,14
eRfBdGaVAWgJbXHScMPCZKNOEQLFYDITU,JGEAHEFH.SCACMDAFZBCE.KFCH.EBDFQCGBFBGH.DAAFhABAIHABUDDHeDBDhACABAAA.dEAC.aDBDAAHCbGBChADAPFEB.NDIC........hAEA......hAFA...,2,-25,-12,13
BFgceJRAHUCEMZLdaYXWISGPDNOVfQKbT,UADCMAEEZFCDLHAGdCFA...XFGCIEBHGBAA.hAAADEFEVABBKCGGBDDFhAAAFGGGeBDHAHBAHFDD.CBGF.hABAaHECSHFG..NBICfGBChABA....hADA...,1,-13,-26,13
gHYVOSFPZWcGDLEBNTJfXCIQdKURebAMa,MHFGaCFCHFBB.OAACFBBFZEBA.GAEAEAHBBEDEJHBE..CDGD.IDAEhAAA.dHEHKADDhAAAREGDACCH...YFADhACASAGC.PFFADDIF...NCAC.hABA.fBHEhACA...,2,-36,-11,25
HgWPFDSJYdVAEQfaLcIMZBOTKeXbUNCRG,QGBCLCCHMGEEBAEGKHBEeEEH.UBAHRCGFGAEGHBFF..hAAAPBDBDEADSDABhABAdHGHAEEHEAHB..aFAHZGFEhACA..TDAG.......hADA......hAEA...,1,1,-25,26
ZCNabfLRJHEYAVIgWDedBSPGKMUQOcXTF,VAAD..gGGGDEADBCDA.SBCHKADD.QGBDhAAAOFEB.XBFBhABAFGADZGFECGCANDECaDAC.fFAFhACAJCFG.EBBHAFCC.WDFA.dAHAMBFChAAA.....hADA...,2,-40,-9,31
AEPJVWZUeTRYKCBDdILHbONcQFaMSgfXG,JCCHVGFGZEEC..UCBERBFH..KHBCCDGDBGCH..DDIFLAEBhAAAHABG.OCABQEAGhAAA.MAFASGAChABAXGGEAEEDEBHB..eHEG..hABA......hACA...,1,-23,-35,12
gRZLCMfHUGYBAONSFXcWPTaDdKQbJVEeI,SDCDXGBC.....PDDEDEDGKFGBJFBFEHEG.eCBHhAAAIABCZADFLAHBhABACDAAMADB..HDGFGAFAhACAAGDHFAHH..........hAAA......hAEA...,2,-31,-19,12
VeCfKUXbWdcHAOEMgFaLDBTSZPNQYGIJR,MEGFFAFBDFGEBGCGZGCG...QDDFGAACRECA.eFAFKAHD.UABAhAAA..XCGChAAAdAFFAGIFOBEEEHGE..aDDAhACASDGE.NICD.IADACDBA.hAEA......hAIA...,2,-25,-24,1
QLPEfcRbHBKTAYaFDNOXMIUeWVSJGCgZd,aAFBFHFGDEAG..ODABMFAF.UBGA..VCGDJCBA..CHGG.ZAAChABALAAEEDDB.REBCBEGHhAEAACFG...XFDEhAHAeGBA.......SGGEhAIAdCAFfFFBhACA...,1,-26,-39,13
AMLgZFVaGeORDfJPEbTHdWXcKNBUQYCIS,LCHDZDAGaHAC.eBBGRDFE.DDBE..JAACEGGGHAGBdHBB..XBEHhAAAKGBEBGGD.UADEhAGACAHBAGFFFEBG....hABA.OADGfFDB.....hACA......hBAA...,1,-28,-29,1
NeHUIcXRTGPKFgVQBdSZYMaADWEfCJObL,DGHHEHBG.CEDC.ODBCLCACHAAF.UFED..XAFATCFHKFADhAAAFGAEQEFFhAAABHHAZAEAMAIDAGIH.fFHAhACANICHeDAF..ICFB...hADA......hAFA...,2,-29,-12,17
NbXHdRIYZaeGJPfLOAEUgCTDWScVKQMBF,UGBCTGGGDGIB..SEBEKABDBCFH.FDHF....XDAGhAAARBCGIFBF.aEEGhAAAeEEGGAEF.fGDHhABAAHAEECDACHEH.WCAGQAGAMFADNICF.hACA......hADA...,2,-44,-15,29
GQVZNBKFAIXEULTMaYbDeHgJfScPOWdRC,EGFCUDCHLBEEMCGF...aDBCDGBBHAAEJBDG.SFFChAAA.OHACdHGHCDACVAAAhAAANACBFGCG..ADFHICCFhAHA..YDHB...eEAFhADA.fFEAhAEAWHEA..,1,-19,-34,15
dbWEfeUKOBPAHJQSZMcYLVCRDTNXaGIgF,JBDGZBCFMCEALEGFRGDC..DIBE..XCBGGCAGFHGE.dFEBhAAAECGG.UFDFBDGCAAEASHAEhAAA.hABA.cFBDCDEAaABF.IAHH...hADA......hAGA...,2,-36,-27,9
SLCFfTZPcYKOAIdaVEMWbeJUNDHQRGBgX,dAFBaEHB.EDAG..MDECeEEFUGECDABCHGFAREAA.GBCBBHCGSABDhAAACCGHFEAH.ZACChADA..PDHDKGADABIB.hAEA.IEFEbAACNIAD.......hAEA......hAIA...,1,-9,-28,19
gdHLcaNFQRbAKTXeDYJSPIfBGCOVMEWZU,KEHBTDCHeDBC.DAADSDGC..fFDCBAHACBEBMAAHhABAEBFGZEAGUFECHFFHhABALCBEaGAD.FGBEbBBChACAAGGGXEAC.......hADA......hAEA...,1,-20,-22,2
RGOCgHYWEVeXSBPDFfTdMNLZIJUaQKbcA,RFBHCDHBHACBEFEH..eAABSCABBAHEDCCBFFBF.dHGFLEDChABAZFFGUAGEaBGC..KDFGAFIHOHFEhACA..WFDFhAAAVACE..fAEEMDHD...hAFA......hAGA...,1,-19,-24,5
bfgHJAKFCPOWSZGedETXaBMcLQNVYDIUR,KEHBCFED.OAADSDDFGFBBdBGC.EBAA..XDEFBBDCMAAEhAEALAFG.NICH.hAAADIEGUDADbFBHHGFChAFA.ABFBFEHFZEFBaGAH.......hAGA......hAHA...,1,-13,-24,11
UFGVaQCWPMDBcISRbJgeAKYHNOZXdTfEL,KCFCHAADZBBCdAHG.TFEFEEABLFED.UFGFVGBE.CCFGMDAHhAAABACH..SAGAhAAARDCEJHFEAFBE.ODEChABAfACD.........hACA.FHAG....hAEA...,2,-29,-12,17
HaCDKXcREOSUYbZFdAWBNePMQIVGTJfLg,BFDGeGEAMHAAQAACGBFE..fCGCLDDFgDAGhAAACDCEKAFA.RBBCSBAChABAUGGHZFADAEHENCCHIEEFhACA.........hACA......hADA...,2,-37,-5,32
RFLXdgMOUfbEcNKSPTYDVABeHQGWaZJIC,BEFAHAEGGFAHaFHFZFBD.ICDA.FBADXBDDdAHA.OBFAhAAAbEFF..NIEBKDBAhAAAPHDE..DHDEAFEHQABChADACEAD.LEAFMABEEEEBSDCGhAEA..hAFA...,2,-29,0,29
CPVOdJMfbcETXHeaDAISRNQFZWBKYGgLU,SCFCQFDHZBFCBGAHKBAFGEFGLAEECBCG.ODFEMABF.hAAA...fDEEhACAECDGTDAD...hADA.XECGeHFAAAIB.NEICWHBAgGBDhAAAPADC.....hABA...,2,-18,-18,0
ZaIWbNFDJOSMPfKAYdQeVcgXGRULCBEHT,QGBCeFBB..VCCDXBEEUGGEBAHFHDDBaEHF.IEBGhAAANAFC.DFGBOEFChAAASACHMHDAKDGChABAAABFdAHA..cACG.....hACA......hAEA...,1,-20,-27,7
bXRNBTeKMOPGUZIFAcYWDgLSEHQJdCfVa,......cFCAWBFDLEBA.HAGDQDEChAAAJEHBdAAC.fDAAhABA.aBGHXGDChACANAICBADHTFAAMDAFODBAUGFHFBBCACIHgGAFhADACHCE...hACA...,2,-20,-17,3
KLHCeRAMOcbIaXUSgZYNWGfQJPVEBDTFd,OCHD..cGDCaDDH..UACGZEFC....NFAFGBBBhAAAQGBG.JAGBEGHDhABATAACKADCCHAHAHCBIGFDhAAAXAGC.SCGA...hAFA......hAGA...,2,-39,-20,19
JOTUHMeCNYBSLVfRgFQAPbadEZGIXKWDc,aHBGdEHAEECGZFEF.GAFGKCEE.DEBB..JBBHUABAHCGD..eHFEhAAACFBEBAHASHBGhAEALACG..fFEAhAFAFDDCQGGEAAHC.......hBAA......hBBA...,2,-25,-23,2
OVfBKJXTbEZIMHNcWSAFCQeYaRPDULGgd,FFFBQEBEeCBCRFBB.DHGGGAGCdBAC..OAEBBHHGKGAD..hAAAJEFCXAEFEGADZFDDMAIBhAAAHDDA....hABA.cAFESABGAHCA.CGHBaGDD..hACA......hADA...,1,-16,-20,4
bPCDdHTXfYAVKOIRcaQSGNWUJgMFLBeEZ,VDEDOCCH.RAEC.QGBCGCGE.UDBEMGDCBBHAZAACCGHADABCHFABhABA...fCAChACAAGDCIBBHaDDFSFHBhAAA.JAEE.FHEA....hAEA......hAIA...,2,-31,-11,20
BLAKHUDdfNPaYSZWGCVXTEFOcegQMRbJI,UCCBDGHHdADE....PFHHSCAGZAACGEAGCAFG..XGAGhAAAEFEFFHEEeCFBhABAMDFDRBGH..JAEGBFCHhABAACHCKDHB..fBBFaGCD...WEFHhACA.OEHF.hACA...,1,-15,-30,15
eDMYSNEfQIZJLbFHGKTVPdBXRWCcOAgaU,UGBCDHBEMDAE..SDDHEFCG.QGGGIFHHLBBGhAAAFDAHKAAA.TCEAhABAPHDGBFAH.XAFEhACACCAEABHEaCFE.NIAFZFFF......hADA......hAEA...,2,-34,-23,11
FNOGSbLWgYAPKJZMCRcfETdHVDaQBeUIX,JCCHZFBHMBHH.RACG.EABEHEEFDGDB.BDCDUAEBFHGE..GEFEhAAASCADLFHB.hAAA....YFEFhADAAAHECGDGfBAB..VFAHaGAH..hAFA......hAHA...,2,-28,-23,5
CbRSQNATFaGYVLUdcHfBOeMEWgJIPXDKZ,FFHBGEAHLDAEdBDA.HBGFOAEGEEAH.JDGH..IGEAhAAADICGCCCC.RECC..QGBGhABAAFIHaBBB.VACC.hAAA.fGCFBBBDMIEEgBGDhABA.XFED.hACA...,1,-4,-28,24
XEZDAHYJBUeCOScfVTWINaFdMRbLKPgGQ,HFDFJAFBBHEAUACB.CCGE...SEDF..cBAChAAATBCB..IHBAhABAaFAGFAAF.dDGDRFGFKEFFgFGAhADAQCGEEFBAAAFGOHAEfCEChAHA.WHFAMACE..hAHA...,1,-12,-30,18
VTafbMFWIUEGPQReLAZXDBcdYSKgOCJNH,ZFEEXFCADECHBBDCdAFB..KCFBCEEB..HGAEaEAD...MIDAIDHAhAAAGBFE.QAAChACAeDCGAHGE.SAEHhADA.OFHDJBAANIAFfFFChABA.WADBECCB..hACA...,1,-15,-37,22
DeBMOcTNCXbgFGZdEKVAaJIPfSYQULRWH,JCCH..fDABQFGCRCDCHBGDDAAFBFAFMIDG.OEFChAAATBGDCACG...XADChABAgGAAGEDEhACAEHGGAAFHaGBCSBAG.....hAEA......hAFA...,2,-31,-6,25
BRFGSICDdXOMTQfUaPZVKJANbcWYEHgeL,...bCAA..cFCAEFGFHDFE.eFCFRCAHSGAHDABB.hAAAOAFDQBFHhACAfGGBPFABZEEFKAEChADAAADGNBBHYEEF.BEBFIHCH.hAHACCCEMIFA.aAHH.hAIA...,2,-16,-3,13
FfRUYHBNWSPTDJOAQGXKEgaZCVcIMdeLb,GABHKFHBEEED.ZAFB.CEAA...IDBGdECH.eCFCLHCChAAAFABDUGAEBFEH..SHDAhAAATGGC.JAEDhABAQDGAaEAC.cBACfDGAhADA......hAEA...,1,-24,-27,3
CObXfHMUPcVRWZBTFQaeYDdKJIgESLANG,GGDHCAFB.OEFCXACGHAAC.UDAGVCEGRDCEBGBB.FAGDhAAAeFBADGAH.dAACKAEDIHFBhADA.SEAGhAEAAGGG.NDIGMEHF...PHBChAHA.....hABA...,2,-24,-19,5
VCdgYMfNKbBJcUFWARLHeOIXTESDGQaZP,RDBGeFFCOAEH..IBBEEEFH.DDDGaGHBZEBB..CHDDdAACMCADhAAAKBGABDFA.JHDEUFAFhACAFAHB.ACCE.LBDEhABA...........hADA......hAFA...,2,-38,-29,9
WQIFXUPJYeCNZcMbTDHaALKERGBgOVfdS,LEGHKEHBGDECOAHHdDBD..SCGHQFDAFGBGXAAFhADAUACB..PAFEhAAAeBEDZFBF.cCBGhAEAMICEDBADAFIBBAFCfGGB.WFAFhABA......hADA...,1,-15,-28,13
aFDPNGScAYOWeUQMbBJfHRZLXgCITdVKE,OGEAeDACMEDDBAGCHFGDLDEG.CBBG.TCEB.dAACEEAGhAAADEGGGBDFAEEFUFAEbFAGhABAfADD.hACARAGF............hADA......hAEA...,2,-34,-9,25
BLIaPbDFJGQfCKEHYdUMZANOVRXcSegTW,OFBBRBCD..XGBDSDCF.eGDCTAGABAADLGFGhAAAaAGH.DIFEJFHBfFDEhABACADCHBDDdDFHMEADhACAAHAH...cEFHICAEFDHDKBEA.hABAYCBFNICF..hADA...,1,-17,-24,7
RXTAgeBGSLYaZUVPWIEQbODJcHMKNdFCf,eAFBBFFCSACBLEDBZCBGUEAG..PAHFEHGA.QGGHhAAADCIFJFDH.MDADhABAKHACdBAFCBCAREBB.AGGEGAFEhAAAaDFC..IFFFOCDD.....hABA......hAEA...,1,-3,-28,25
HFSEaOTQgdYUGMCZVIJKAeBDfcWPLRbNX,DGGD..fHBH..cDCHLDEGRBAF.NDIAFADBaDGCQFAEhAAAdFFDUAACMAFEhBAACHCHZAEE..IBGDhBCAAAEEBHHHbFCASFBA....hBFA......hBIA...,2,-23,-23,0
AXCZLOgBNHPDSUMVIEcedRKTWfFGYJbQa,XGDCCEFAZBFALADFBEEBHADA.DAHBMIBA.EHFAdBAGKGBAfEGGhAAAGAAE.JCCDhABAQECAAFAD.hACAOEHDNCIESGGGIAHERFAH....hAAA......hACA...,1,-11,-23,12
HQZLIBPbXgNVMReDJOETcfdGUAYCaFSKW,aEGDKDABHBCGLCDCBGEB...XDDCNEAG.MFIBeHDEDCHHhAAAEABC...cEEDhAAAdHABAGAGCACD.SGCBhABAZDBHPBHF..bAFE...REFB.OADChABA.....hADA...,1,-10,-20,10
UaeIfOXHTQVSGBKRDCLJZFdbNWgcEYAPM,UFDBeCCHOEFGHAEFQCBFGAACRAEFDCGECGAHLCHD.JABChAAAdGDG.bFFE...hAEA.NIDH...cEAChAAAAHHAaAGCXDEE......hAHA......hAIA...,1,-16,-18,2
FdeCIBAgGRcbVWafTPKHMLEYQXNOJSDUZ,GEDHRAAD..VCEAfAACKAFE.HBDCLGFCEEAAXGDChAAAODABDICAFHGAdBHChACAeECBIDDDBHHG.hAAAABDGgGAG..WCHHaEGA.TACChACA.PFBBhAEA.MEEF.,1,11,-17,28
SRKdFcGADEOfgaBVQXTCZIYPbJULeNHWM,OEACaHBGBEDC..XBDEZCAE..IFAF...hAAA.PBBDbCEBUFGGhAAANFEFMGDAKHEG.FAHHABAHDCIFhABAEGHHVGAECAHC.JHDE.LADCWBCC.SDEAhABA..hACA...,1,-14,-31,17
NQWGFfRZLHdgMCIDcXVSPEJYTBaeUOAbK,KHBGQCBC.GABFRCEGLFFHdEEGCDGADAFEXAGE.SECDhAAAPFHHJEAFBCBAhABA.eADFAIFENAIG.FFHFhACA...fDAEZGDE.MEEFICFFhAAAEGAF.aGBD..hABA...,1,-12,-21,9
PQgfJRSceDTUBXGFZbVYEMCWONILHaAKd,KAFBQGBC.JBADSCED.eCAEDBFETFEAhAAABHBEFHGAZDFA..VDGFhAAAYEBAMIDCOABChABAIGHBHDAF.ADFA.dCCBPAHDfBHAhABARFCE.....hADA...,1,-13,-19,6
GdfAYOVCNITDKRLZSUJWcaQgFeXEMPHbB,OFBBCFDD..TBFEDAEDKBAELHAEZEFE.UEAEJAHH.aGGB.hAAA.FHDA..ECCEMDEFhABAHACGBGHFdEEBABIB.hACANEIE...SDBC.QCFGhADA....hAFA...,2,-38,-18,20
ZcUMFEAXdbNBIOLKgSQJYGCVTPefHWRaD,dGFCBFDGOCBHLBEFKDDD.SAGB.QFGFhAAAJABCCGCD.TDAAeBHBHCFBhAAAaBGHDBBGZFDB.MCCAhAEAEHEGACCH.XFAEIGAF.....hABA......hACA...,2,-24,-24,0
eNFKSVQMRdUAODGPCaXfZJIbEHcBTYgWL,ODCHDCECCDFH...aDEGZAFA...JABAEACHBEAG..gAGFhAAA.eHFAhABANDEE.KEHBQFGFhAAAMEFD.RGAE.AFAC...PCCBIGAE.hAEAcADD..WHFAhAGAFCABdEGC.,1,-12,-42,30
IgOQLFVRYaMKNBTJDSPXAEZHecbdWGUCf,ZBCFHFDFeEAFdBFHUAACCAEF....ICECQGGE.FDBHhADAVGFCRDFH...MCIFhAAABHAAJBGDPCDBhAEAAGBHECAA............hAFA.WCHH...hABA...,2,-36,-18,18
PRCYdIGZWaOTAfcNbMEJHVgDKSLUBXeFQ,...NDHC.EAABHCCCVFDADAIDLADABAAEFACFRCCA..dEAFZEBBOBGDhABAAFFD...fGCEhACAMIFEKAGHSGDGhAEA.eFAFCHHEIHAGaEFF..hAEA......hAFA...,2,-24,-23,1
PJFYAafgGcRTIQebUKXLOBVNWHCdDSZEM,aHBGGAFE.RABGQGFFUDFFKCBELGFEBFDG...VAFDhAAANHAHHCDB.DFIDSFAChABAEEAA.MCEFhACAFBAHAIEG..fADF....hADA......hAHA...,2,-31,-16,15
USDWQORXafTYVCZELPJgHIKFBdceMAbNG,GAFEDDFFOEHDaDCD....TACGVAEAZBABEEFBLFADhAAA.JHBAIHCAhAAABFHGdCAGeDBHAEHC.NDECUACEhABAWEED...QGFG.fBHChAHACCED...hABA...,2,-17,-15,2
SKVGLJgOMbBIaEeACXDRdUPTfNcHWYQFZ,CEFAXFCARACH.dDCFUBGG....fHEHHGCEQEADhAAAFCADKHGALCFChAAAOCEHBCAFEGBB.AIHEDGGBhABAPABE..NAEF.YAFE...hACA......hBAA...,2,-30,-16,14
JgfXReBFHdNEYZOQUaDbIAcVMLCKPTSWG,VFACCHFDKEEB.....TAFESGBGGEDB..JBEEXCCDhAAABDACdABDEBAEODFGhAAAaDAGDGEH..AGHDMIBAhACAPFHD...WAHHgEAC.hABA......hACA.fBEEeCCB,1,-5,-36,31
bPYgISBGaTfDVReKLFOMNcCXWUdJZHEAQ,QCBC..YFFCSEFGaDBF.DBGFRGCA.LHBAhAAAMEBB.NGEF.CDDEXCGHhAAAUADCdFBD.ZACCAHAD.bBAChABA.....IAHEBCHBfAGBhABA.KCADcGGHhADA.WFAD,2,-25,-17,8
MWTGDRgHUIbcfKCdOeBFLJEQYAXZPSaVN,ZEFHSAFBaBED.MCDHGCAG.DIBCREEAUAAH..IAAFhACAfHBHCAGGeAHHhADAFEAGLHEG.hAEAQCGAAHEBPECC.......hAFA......hAHA.WHFAgADG,2,-25,-14,11
HUgdKEIAXVefMGSCJQNZORcBaWLTbPDFY,VADGMDEBGBED.CBAH.JCBFZFGFRFFFBHDALFBF...TCBFhAAADDFGFEEF.HGAEhAAAdDFDEADGACAH.eFFDSBAEhABA...QAGCcABAWAFEhBAA.....hACA...,2,-33,-3,30
cIWbLUOMeAGgJfHaDVFBSQXEZPYKdTCNR,JFEFHDAG.VEDEFCBEBABC..QCGHZBFD.KGHHdFCECADBRAAChAAA..IEAHhAAALHBAUGAEOAFHAADC.hAFAfGBBDIGA.EAGA.....hAGA......hAHA...,2,-48,0,48
PYOgRcKeMfQISZdWADUFHGVLCXETaBbJN,FDABGCBDCECC.EACCBCGB..JFAG....PFEGOEEDRGAC.hAAAKDGG.eHAAQBCGhABAIAHGdDGDDAAE.hACAUGGC.HBECXAGA.aHGE..hADA......hAEA...,2,-35,-12,23
HgGRIXdPBOfWSEecCQFLZMTUVAbaYDKNJ,aHBGDGHHKACGHCCCGGCBRFEB..dACGOAGDSCGH.EEBBeCEDhAAA.CCCGFCABMBAD.hABATAFFADGF..NFAB.hACAgGGB..IGAC.hAAA.BEHA...hAEA...,1,-5,-39,34
daLfZGQYbKAXBRCcITHWOEDMJPUFeSNgV,XGDCCDCF..TCGGHBAFEAGCDCCC.JEBBFGFE..eAFDSABAhAAAVEDCLCHBhAAAZFBBQEEFKHGEBABBhADAICAGMEAF.NIEHdAFH.....hAEA......hAGA...,1,-3,-26,23
HdYVTIOCJNaEAfeLcbZWDKMGPQUgBSRXF,eEEGLGEAZAABDGAGKCFHMEAEGBED.UDCESBBC.FFEAhAAAHGEGdBFF..VGAGhABAIEAH.CDHCaHBEhAAAAIHEfCCB...WFAEgACAhADABCAD....hAFA...,2,-20,-20,0
WaeQdSBKTZGXOAVcEgfMFUHYRPbCILJDN,VDAGEHBG..MGECUAFGRBCB...CEFFLHDADCBH..aAAEeBAChAAAdCGDBHADZFGHOFBEhABAAAEG..gFCDhAAA.FEFEPCHDIAGAWADBKGHB.hACA......hAIA...,2,-26,-24,2
ETCWMHafSGQDedVZcUPJLXgKIbOBRYANF,FAFBEFFB.CEDA.MCAHHEAB..SCGCDEHFdBDEZCFGUFBALAAFhACAKEFCOBEBBBBDAEIFTABDhAAA..aGEDfAGFhABA.eFHH......hADA......hAEA...,2,-35,-23,12
bLXYKTagefOPGIVSZNUWQCHEdRBDJcFMA,LDACKGFC.TBGDaDGFeHAE.OAABIDFE.ZGFAUDDEhABAQFAGHCABEGCEhACABHEDDEIDFAFCAIGAbAAE.hADAXEEC.fEBB..hAAA......hABA...,2,-22,-21,1
TDKYWHOMcLSCNEgdeUfGVQIAXbPBaRZJF,XCBCBFDGREFGFHAEDFBE..KBEAHGBG.OACGLDBD.CAHG.hAAAEEDG.eAGBUABFfCEFhAAAGGDF.IHGFhABAADDC.aFGC.......hACA......hAEA...,1,-13,-41,28
VGPIZDYcefgSFJNWKbBTHAQRaCUOELXMd,aDAFUEBELFCBMDAGGEEAZFGF..DEFFeBHF..SACDhAAANIAB.KAFDbBCATCGBhABAAAGG.CAGBEDDAdAAF.hADA............hAEA......hAFA...,2,-27,-27,0
XFGBKbURTMOSJPDYcILHWfeVdNCAgEZQa,ECFCaDAFGECEBHBHUGFHREEA....TAFDMDCH..ODHFhAAASACBDADG.IHGAhAAAHEECeCAH.NBBBACAHhABAZCEE.FHAAKAGE...PCCA..hACA......hBAA...,2,-19,-17,2
JbCOXaBeHUEIVgdfWSQcYZMLNTGDFPAKR,KDBDRFDFCAHD.OFCBBAFE.HCDF..EEACVBGHdAAF....SDDChADAQGGGZCGDNBAF.hAAADGGA...ABBBJFBBhAEA............hAIA......hBDA...,1,-32,-41,9
egHTKYcVQfWabUMBRdZFOJXGDSPAICNEL,CFDGLCCHHAFAKAAEVFDE..QGEH.aFAHMAHHBDHHhADAdCEAZCBGOBAHGEEFhAEADCIFAHCEEBCAgGAHhAAA...cGFDfDEF..hAFAWBFB....hABA...,1,-7,-36,29
GQLKIDgJaNETPFefBUSHVRcbMCWAdOZXY,dDBDZAEGGDDGKFAFDEGG.JABE..EGDEFGGDBHGGHFAA..REEE.MBABhAAAAHHE...OCFDhABAQADFLCHFaHBE.hAAANIAB....eCCFfABE.SBHBhACA..hAEA...,2,-47,-3,44
IKOXZLBCSRdEATMQWDbgaYPJNGceUfFVH,MGECQAFBDGCF.aEDA..JBHDGFCBUBEF.FADBHDAG.OBAAhAAALCBA.CAAFdCFDhACAAACA....WFFEhABAYHFA..PFABNCIG.eFDDhAEAfGAC..hAGA...,2,-25,-23,2
NKeUAVXcFBfMIHTEPdYJDaOgQGSRWCLZb,XFDHBFEDMBFHHBBC..ECBHdAGEJECDOEBG.QFFAhAAARGFECAECZBGH.KCHHAAABFGADhABAfDFD.IAEAhABA..YFFCDDAE.aACF.hACA......hADA...,1,-18,-35,17
QgHYSfAcXPVaGOJRFNZCTMKeDLIUBbWEd,XCBCVDAG.GDGCJFCB..FGEBCAHEKEEFLBBCBDEBEGEAdBHG.hAAA..HGAASHGAhABAAEADaECF.REFE.TADAhAAAMAFFDBGB.IGAF....hACA......hADA...,1,-18,-25,7
YRPGIQESaZeUKJBXOTcDHVdAFNCLbfgWM,CFEDLGEA..fCAFMDAFRACGGBGAQACEEDDDaAAFUGBEhAAA.BHHEOFADhACATAFGDFDH.dDFFAFFHNCCEgGEAhABA........hACA......hAFA.PEBA.,1,-15,-16,1
ZaCOeMTPKXJHYfAVIdFGcSUENRWDQBbLg,VDAGdAFBFBGH.GDCCUFFE.RABH.DBAABCEDLADCZEAB..CHEA.MFDFhAAA..KEGBHBGBhABAABIH.SEEDhACAEAAF.NCCF.QGGB.aEEF...hAHA......hAIA...,2,-25,-22,3
CgNBceMEaAWTDXZVPSIYKdHGJFLRQUbOf,TAFBDEFAZCCF...SBBDKDBBHAGDFADEQDDGUFGA.OHAChAAACAAC.BABEMIEGhACAaEHF.AHFG..WDGFhADAPGDAdFAB...LDADbFGD.gGAAhADA...hAEA.eHCE.,1,-2,-22,20
abTLZGDXMOKCUgVJRYWSPBQfFEcIdNHAe,aDCDTDACZAEC..DHGAMAFE..KDHFCGDCUDFE..JACDRACFSBGAhAAABEECFCAF.EFHHhABAdGAHAFCD.LFFFhAAA..OCDD.......hABA......hACA...,2,-43,-25,18
eGKAYSFCTcUObfDBadHVEQWJMPINRZgXL,SAFBFFFBCGDG.UDDGODAH.DBBGBHGF.HEAFECFG.QGDFhAAAMEIB.PBBAhABAIDCG.ZFBBhAAALCHBKBGC.AIHCcCAFaCAF..WEEEhABA...NIDF..hACA...,1,-25,-32,7
ERIBbeSPNLDdUCVcKAFXZaGTQfOYMgJWH,ZBCFGBDBQGFGOHDEMABG..gAEAJCHBHFEGEEDChAAABFDB.eFAFSGADhAFANAAHdHCF.CGBGcEBHhAGAAHIBaCFE....YBBFRBBB...hAHA......hAIA...,2,-15,-5,10
CQcgPZFfODdVNaSMGJHELeYbBRTXAKIUW,UGBCQGGG..PCBBFBBFDADAdFEAaBGHGEGG.EBHHLHBAhAAA.bEFATAEHhAAAAHAF.KABCCFBHZBEHhABAfDEFOCAB........hAEA.SDCHhAGA...,2,-28,-18,10
gGbFVJAKaXHLcRINZUBMEWTYeDdQSfOPC,aFAAHADGLDEERFFFZECHBAAA..MHBGECGC.TACGeDADDIBASBADhAAA.PFGFhABACCBH..bDDBJCCFAACCKGADhAAAIEFH..NEIE.UAEE...hAEA......hAGA...,1,-8,-18,10
WQgDafJTSYPUMHXeCFZbBKRLNGAVEdIOc,VFEEEAFBdBBE..OCDHQEFG.aHGETCGD.SDABhAAAPEDHHADBCACAZAEEhABABGABKGAD.NIBBACADIGCFhACA..........hAEA......hAFA...,2,-30,-19,11
MFeRJXTaACEQPbBOgNIZWfGKHYdUDVcLS,CFCFQGBCBEHE.OEHH..IEEEZABG.GBADhAAAYAGHDBFELHCGhABA.MEBDREEFXBEDhAAAaGGAAIAE.bCAGNADFKGDCdECF......hACA......hAIA...,2,-36,-11,25
RMTZHSFYKcQIANbCVOdWLUfBJXeGgEDaP,CFDGVDEDdCABLBDA.BAAEJGAGeAEFGGEBDDDD..aHBEMIDGhAAA.HEGFFGAEKFEChACAQDAHAEBH.OACBhABAfAGBXAGC.....hADA......hAEA...,2,-37,-12,25
OPfVFUCAWYBaRXgeGLcDJTbHZdSMINEQK,BFDGXCCBeFGHLDHBDBFD..TEEDZAEAdFEF.SHFAhAAAMABG.ECAFKAHBfGCChABAUFAAAAGGaCGDgFAChACA..cCCF.bAAC.hADA......hAFA...,2,-31,-18,13
dNRAPBQYfaVeOHZTgGbJKXLIWMFDcCEUS,QGGGaHBG.OFACZFEATAGAGBCCKDAGLAEG.hAAAIFEGMDFEcBBFhABAEHDGdBAB.ADIHPCFAhAAABGAF...fDACeEDE...hACA......hADA...,1,-2,-35,33
SYcVZdMCNKLGHAQfaEWbBJIORPeFUTDXg,aGFCEHBGBHFD..IHBCOCBBeACGFAEA..DEEE.SBBDhAAAVDDDZDGFCAHAKEBDLGAChAAAAECC..WEFAhABA...........hABA......hAEA...,2,-48,-31,17
MeRPOAfgTQKYHXJbCWVUdFLBDGSNcEZIa,TCBCKGFCHDBG.JDHHCFAG..UBEELADADEHD..GGAB.hAAASGHHNBAEEBHDaBCC.hABAMAACRFAC.AEEHQGEChAEA.........hACA......hAEA...,1,-25,-27,2
WRfQaTAgYMFEZNIUHBKbOXDLSdceJCGPV,MCCAFEHBEGDGZGDE.UFAEKCFH....OAEHXDGDLAAFhACAdAEF.JAHHCFDD..VDDEhAAARGAEQDBE.hABATEEGACGFNIEBBBBFDGGHSBBE.hACA......hADA...,2,-28,-14,14
LTRHcabNSEFfIJUgGVZCYKPdOeBDXWQMA,TAEGRGFGHDDH..aBFESEAG.EFEEIAFG.JABAhAAAgCAGGEAECDHHKCCChAEAPBAAdDGC.OFHHhAAABAHBDBBFQGDGAFDH.LDEAhABANICF.UAGG...hBAA...,1,6,-13,19
AOYBPRCdMfDZbeWFUSJgVaXGELNcHQTKI,OAFBBFDGRDAEdEFDDBBHZCDH..eBFDFEAH.UAGH..JGDAaADGGCBEhAAA.LAHFhABAHBACKHGAAHHE.CHDHMHAEhAAA..fACF..SGGChABA....hACA...,2,-30,-27,3
OfYKcBGDdEJXPaMCHUSbIgLFNWZeTARQV,QBBHVFDF.OFCBKAFBBDFAGDFGdDBB.EFAB..JEBDaCEDhAAAHAAESBEEhABA.IDHFFHGANAEE.hAAA.eAHBAEAAfFHCDDAHMCHF.CAHE...hACA......hADA...,1,-16,-23,7
QSGecWVTAYafDFJPRgLCbMHZBKdIEXOUN,aHBGDGHHFDEH..JAAFRCAELGAA..bEFFZBFEBEEDdGEF.EFBChABAUAAF..SCDAhACAeAFC...hABAcGDD.TAGGAEBH...PDABhADA.....hADA...,1,-25,-36,11
TCGfQWXYabBeHIgZJKOdNUDPLFARcESVM,RDAGEAFBMAHFGGAF.QFFB..WBFFXACG.hAAAbCEAeFHB.ICDBhABAgDCEJGDAdFAAhACANIEHPDAHAADA.SAAFCFFBaBCGBGCD..hAFA......hAGA...,2,-30,6,36
eIRHQgFGPATSDLdOKXEJWZVCacMbBfNUY,DDFFdGDBKAAEEHGE.ZFAH..aHDGMEAA.BGHHUECF.eBEGRBCEHCFHhADAQAAF..hABAgAGEFEABAGBHSCCBhADA.........hAEA......hAFA...,1,-27,-35,8
EBMOFbcSdTJKLWXZYfURaQANgGIeCVPHD,GAFEeAFBCCED.HABGBCHBOEDH.FHEASFGE.TGAFhAAAKEEBXCAEhAAA.YHAARCACAABGIEEAhADADGGAEEABMBBE.dHGHWCHHfFCDhAEA.aHDA...hABA...,2,-19,-19,0
dUJZYNQRPbcFCITBXeMKaSfHAVgLWDGEO,VFDFLGEA.DGAHGCFCdDFGUDCGZCBEQGAE.RACA.hAAAPBDGFCHF.TDGEhAAABHHDMCAF.aAGChABAfABGAFCG.EHBE.JCAF...hACA......hADA...,1,-12,-26,14
gJXGZAEfHeKTaFCOLNDMRcbBYVdPUSQIW,ECFCHFDFKDABFCEE.CGHBLACGDAFA.RDCF.BGGH.dADASHAEhAAAQFCE..WBBDhABAXGEH.ADIFeCBGhAAAaFGGMAIB.bBGDPEEG.IABFhAIA....hBAA...,2,-39,-11,28
AJgbBPORNcfDVWeLQFETSGdMZUIYXaHCK,JGEABFDG.OEDGRCAF.....fBBFDEFAeEDGFAFB.hAAAEHAETBEH.SFGHhABAMFDDUAABIGBEhACAaCEE.KAHHAAIB.gEAC.hABANDAHWHAG...hADA...,2,-38,-26,12
EaLVYZIGDWKUSAQegXbCdTPRHOFcJBMfN,QDACeDAC..bFCAdFEB.RACFOHACFEHDBBCA.MAIFECFDLAHFhAAAZGBADABCKDFAAHHB.hABACHHG.TFBC..hACA.cAEAfAFFaEDGIFHD.hAAA......hAEA.WFADSHEE,1,2,-27,29
fMYJdAeRcONZbKPDBHXEUagICQLVFGTSW,eFBBRFDFODADZBAEKECEBHACHBEH..EDFHUFFG..aGGDCHDBQAGEhAAAFECHGADB..hABASACFfGAGhACAMAAFdDGFAIHG..NBIEDAGE...ICDGhABA....hAEA...,1,-10,-26,16
DgWFZcEaINOHeXPRSYLKbCTGdQfVBUJAM,DDGGFHBGZDAAEGGE...aAFHOAAC.eCECRACFLEEB.CGHDGBGEhAAAQECCBGAChABAAAGHMFFF.WACEhAAA.....IHAFNEGA...hACA......hAEA...,2,-34,-30,4
YLaJOTCMgAdBSZVDKfUHPQWXbEReGIFNc,dEHASGFHDECGUFECQAFD..XAEFREEHeDBFIBBAhAAAFDAF.NBDELDHDhABAaBBCOGBAMCAFhACAAACCBHBEKGCA.HAGF.......hADA......hAEA...,2,-35,-12,23
RIcHDeGZTCPJNFgLMQVSaXAYBOWfdEKUb,BAFBOGEAdGEEUFBBREAHHBDBGCABZBAG...CBAC.JAHBFDEE.LHFAhAAAMCGB..QGGFhAAAVAEE.SEHFhABAAIDA.fFCAECHHbEFA...hABA......hACA...,2,-19,-19,0
bSeJONYaMWRdPGDVfgZALHFTEQcBXICKU,LDCHTCCB.EAHBQAEEBGFD.CDBGKGGCSACD.hAAAOAEBNIDH.aDHHMHBAhABARDADGAFADBIBgDFFhACAAIACFGGA.IFDGeAAFWEEF..hAAA......hADA...,1,-14,-24,10
CZdLGSIgUBVQNfbMeaJWcDPROHAYKFTXE,KAFBFEHBEHBAdDCBGFEF..SACGUFCGBAHEQCDHhAAA.fBABhABAMABGaBHHJBBADEEFOFAAhADAAIEG.YFFH.TAGCCFAA.IGAFhAEANAAE...hAFA...,2,-39,-8,31
cGWKDIULTbBRYCEAZSgXOHNaFMeVfJQdP,ZDAGXGBCHFBGaHGGFAGE...eBAG.JCFBQEEF.hAAAPCBC...hABAcBFCKAHBIEHEhACATGGGBACBCHDHAFGDSHACNCIEMFAGdAAE.DEAEhAEALADA..hAEA...,2,-23,-7,16
FSUdaXJZgVGKEcHIPLBWRefCQONbDYTAM,SHBGdFHAJDAG.ZACBGADFKEFD.HDEBLCADBHABRGCACBECOEDFhAAADACG..AEDAUCGHhAAAXCGE.EHGGIBAFhABA..eCEC.fABEhACA.....hAGA...,1,-18,-29,11
AVLfaEZFbKgQJDSPHcWXUGYITNeBMRdCO,VFDFaDCDZAEA..FDBDKEFE..QCGGDDACHFCG...XBDHhAAAUABE...YCAEhABAIFHGeHAEhACABHAFMIFCCCEFADHEEGGBJAFE..cEEA..hADA......hAEA...,1,-16,-35,19
GcbJYTDPgZEKeUOaIMVQFXWNdBLACHfRS,HDBHRDAGGDFCJEEDDAABZADEKDDC..eBDAOHAGMHAA..FAABXGGGhABA.dDACBCGEhACACFHA.fFCFhADA..SAGHYHEA.gDGAhACA....hADA...,2,-27,-26,1
HGIOYcTRJMCaNZEfSABeXUPDFQbVKdWgL,eEBEXCGCDHGAFBDD..QAAFKEGD.dEAALABHhAAAHACFOFCFTGCAMIFEhABACBFEZAGFSFFBhAEABFHA.UAFFPFAB.......hAGA......hAIA...,2,-28,-13,15
HbaQDBKEAWXgUFNJcPdfLGMYVOZTCeRSI,XCBCFGFC..NICB.JFCA..dCGCGGEFMCAG.OAHBZAFC.hAAACGBH.RDBA.HDEE.aAEChAAADGABBGAFABBC...hABAWBACcFCE...PEHD.fBDBhACA..hADA...,1,-21,-38,17
ZaKGSJAfLeWYHMEOQXbBCVDFITdRPgcUN,LEEGeGEAHCADMEBDEAHB..ODEEQAFEBHDDCAABFGGAdGBGPHDAhAAAUACFZEFE..hADAKABCSEDDhAFAAIBC.fCEF......hAGA......hAIA...,2,-34,-8,26
caRMdAZFNILeGCVYWJSbEHDXKTOBgUQfP,ZDAGFHBGLABCCHAE..VGFAJEHF..EGEADCBE.KHCEBFCE.hAAAQCDH.hABA.fFEHhACA.aAGGdAFGAFBAeEFEYDBD..WCDHhADAbAGD...XBGHhAEA..,1,-31,-40,9
QHWCESLBfPMYGbgVUeNZODJAFTXIadKcR,FEHBTCGC..XCAFdCCFKBEE..QGCGCADFLAGBBHGGhAAAMGCGGDEA.bDAChABAgCDC.hACA............hADA.eFAHZGFG.DEIBAAABaFBHhABAcGGA.,2,-31,-11,20
TaZBbSRgWcONYKJVCeHPUGIXLDdFQfAEM,MAEDZBCFSGDBREEB....gAFHOFFHKAFGCCBCHDBFhAAAGAAGLHDAhABAFCGHAADAaFABBACA.WBHHhACANAIE.....JFAHeHAA.UGGEIHHChAFADCFB.fEGEhAIA.,2,-25,-11,14
RQZKgLJdTVcYUOeIDNfAFSECPbGMXWBaH,EDABCFDGGGEF..XDCABHADRCBBKAGFJAGD..dGAH..TCGHhAAAVFEB..UACGeACAhABADIGE.ABBH.SDDEhACAMCID.aFFGZFCF.......hADA......hAHA...,1,-22,-30,8
agOKfGPLNScEZMYAbFDBWVdeUHRJQXITC,FHFGDAEDBBFAdGBAUDCHHEEG.RBGH...QAFC..TBBFhAAAaADF.OHAGhABAKBBE.fDBEhACALFFENCACEHGA.MGAAADHD.......hAAA......hABA...,2,-37,-23,14
YNUEWAQeVJcXZBLDGFPSMaIfHKRdCOgTb,eADGVFDF...JHACZCDEBFFCDIBEGDBA.FAEHPFAC.hAAAMIFAaBAC..IHGGhABAKCEGdDBFCGHG.OBAEhAAATAGC..NAIA.EEEEAHFE......hACAXDFAfFAEhADA...,2,-27,-26,1
gUdVaQLIHZTKfEGSCcbBWFNJOMeAXRPYD,REFHDACBUBDHdGHA..QBECLABFHFABKGBA.EHDGGDFE.hAAACDCGBAHCFAGHJFHBMBBFhAAAAICA....XDAChADAPFEB...gEDFaFAB..hAEA......hAFA...,1,-19,-29,10
XMfIKLWDBQHCePNESGZgVdYRAFUbJTOca,UGBCJDAC..OBCCaGHH..MCBCKAAEDFBGBAGA..HEGFCFAF.hAAAeHAEEEFEZAEDdGEGAAFCFHEEhABA....TBGEhADAXDAA.fEEG.IADEhACA...WDHBhAIA..,1,-27,-40,13
ELNWUFaRDKMSZXAVJGeYcBPQHCITOdfgb,VFBHeHDABAFE.QACBCDEE.OFCAdAAFfGFGhADA.EBDCWDADFDDHDEAHhAEAKDDGMBHH.SAHBhAAAAIDAJAHFGEGEcBAHPBBB..hAFATFGE...hAGA...,1,-19,-21,2
EAdbJaSRKPTDGILZHOBQeVFMXUcNfWgCY,JCCHaEHB..KBACDEBBLBFEHAFFBHGG..VFAEFAAE..MDHFhAAAUFDC...fDABhAAACEFAAIEA.dDDD.hADASGGDPHACTFDF....hAEA.IBDAQACChABA..,2,-46,-17,29
NcZMfHRGDQOJTIgbCBFeAXdSVYWLaUKPE,dFHASCFC..VCCCLEDHUFEAKAHBPBBG.EECBZGAGhAAA.MAECHEAFDBBDOFHBhAAA.JAFGTBFChABAIGFB.CCAE.eCADAABE.....hADA......hAEA...,2,-28,-18,10
ZCWPgaOLMdYeAEbTHcDGSFVJfIUKQNBRX,TGBCDHCEGCBD.FAFFVFGH..JDFGUCFG.KCBGBFFBRABEZEAChAAACBED.....PHDChABAOHFALDEDhADAMBADeEAHAIACEAGE........hAEA......hAFA...,1,-6,-45,39
GLVZFcECOAXTBJeQNIKdfRbYgUaHDSMWP,BCAHJFCA.eAEFQABGKGGA.dGHERFCD.....bADFgDEFhAAAaGAD.DDCHMHEAhAAAGAGEZAFBFHCCEEADAIEAhABANEEB.....fACC.UEGFhACA.....hAIA...,1,-16,-21,5
WBMVSYTZGKdcFIeUgJAaQOCPNRfXbEHDL,aGDDOGFA..CGAARCBBXABE.HAFBDFHFBEFEMEDF.SACGhAAATEAGZEEGKDHHFHBChAAA.eCAEUAFHAAEE..hABA...QEDDNAIEECEB....hADA......hAEA...,2,-42,1,43
VcOGgaMNQETPCYHXdfbJDUKeFZRBLAISW,SHBGVAAD.GGEBaBGF..QFGGECCBCCEGHAFBXADDhAAAdEAGJABG..DAAFUGDBhACAFEGGREBEBFAB.ACGFWEEChADA..........hAFA......hAGA...,1,-13,-30,17
XLRVQZGUWCHeNcMJEaDbdBOAKTIfFYSgP,TGBCFHBG..SDGD..XBEDLAHBQGEDhAAAZAAFUADBHFEFhACANEBDMCACaGGADBIFdEDGAAHCfAFDhABAgEAA.REGFWDAC...CEFAJABEhBAA.....hAEA...,1,-6,-20,14
DTOFIKEgfRSLUdQAYcbJHVXaCGZBePMNW,...bAADJDAC.HAEGaBFA.CAAFGEGABEAFMEHBDEFD...ODEDhAAAKGDDEBCGRFCB...SEAGhACAUACAAIFCcGAFhAFAXDDB.........hAGA......hAHA...,2,-29,-27,2
OaAcgXTYMKRfFVDUNHbQJBeEZdPLWIGSC,XCBCMFFFKHCG.REFE.FHGA..DDEAHCGDQFCHBAAHeBCBdEADLHDAhAAAGDBESBGEhAAACAGAAHHH..gADFhABATBEGfCAENAIEEGAB.WAEChACA......hADA...,1,-11,-23,12
TSaCeXGIHVZfLKWbFMENgUQAYRJBdDOcP,RFDFdDABDABDOBHF..TBFGSDFE..CFFEGCBAhAAAHFFFfFABKBDCFGHHMBIFhACANBAHUEDC..ADAHBGADhADAaHBEXGAC......hAAA......hABA...,2,-32,-20,12
BDeQLUFaOWJGNXfCdZTgbKRVYPScAHIEM,HDAGEGFHBDFBDEFHQABAFEAE.OFCDJGAGGAGG..hAAAXBFBdEDBZBAE.TFAHhAAAKAED.VGFASFGEhABAABDCMBIH.........hABA......hAEA...,1,-17,-32,15
aBFCXQUHOLNgeAYKVMTDPIdWRJEcSfbZG,KCFCVFEEDADD..dGADRBAD...JADGSEDAZAAF.BAHACDDGUBGFhACAOGAA.LFGHhAAAeDADAEHH..MFDHhADAIGEA.EAEH...fDHEhABAaCFH.....hAHA...,2,-34,-31,3
eEONSCQGdaXgTPVbfRBAIWHKYJZLMcFUD,HAADJCCHLBFGMGBCFAGD.DHGAEHEC..SECEQFAGdFGFhAAAXGGB.TACFhAAAVADDfDAGhACABBAHADHAKDGF.ZDFE.eHDENAEFaEEB....hABA......hACA...,1,-4,-20,16
bLZSgYVNCWEeQHPXJBUGRDAaIOfKMTcFd,OCCHKGFHMGBCFGFALAFEZFDH..SFAH..YDBChAAACDHG.EBAGeADEhAAAHEFGXAGHhABABHBARBECAEABfBEGTACC......hACA.dBBB....hAGA...,2,-31,-15,16
RKPOdLYVZNaWFcfBXJeCAEMITGUbSHQgD,EGFHTFDBGBAG.UACFSCCHHDEHQFCARAECKEEE.dAGEhAAAVBABaEGE.FHEEfDCAhABAXEACCDHDMIAAhADA..IHCHDFAD......hAAA......hABA...,1,8,-27,35
XTHAfCgIZcQESKRLODPaebVUMWJYNGFBd,CFDGZAAD.EGCFRFFBLAEA.DDCGeFHD.VDCEUCFAMAHD.hAAA.JBBC.GCAEhABAdFFGTEAEAIBC.fACFhAAAIFHF.QAEHSHDG.KGADhACAaGAH.....hADA...,2,-31,-6,25
eYfSaJRCdPKLZOEWGIXgHMNTADbFUQVcB,DGHHUGBCQBDABECC..eBABSDEAaGED.CBHAdDBHLEGBhAAAEBAAGFAF.hABAIHDBgDDHhACANAEH.TAEGACCD.FBHDcEFDfCCFhADA......hAEA...,1,-15,-29,14
aAgWRUEVdHbCTNfMKOeISJFDQcYXPLBZG,RAADVBCFHFGD.CBFB...TEEFMECFKGDHeGBG....JEDAFBHDhAAADEAHQGGEhABA..XACEhAAABCFGaAGGADDA.WCBDdDGFbFADNCAE..fEGBhACASAHF....hACA...,2,-27,-9,18
JRgUGDaTFCZWbQPAEVNKBMISefOXYHcdL,ECFCVDAGBADH..SBHDODABHECCdAADRFFDUGGF.DFBDFAFBhABAZABBQDDChADA.AHEAKHACIDHHhAAAfBCH.XGCBcGBD....hAEA......hAHA...,2,-29,-21,8
NRBQCJdHDIESZOeMPUbYcLTKAfgGFXaVW,GAFEXFCEaDCD....VCADREABBFFGJFGH.DAEB.EAACSHBGhAAAeEHD.UACChABAbFDD.LAHDKAHBAADF.hAAAFDEF...........hAFA......hAHA...,2,-24,-24,0
FHAYWXECZQDbVGJBfcKdNIaRLgTPSeMUO,XCBCCHCHDDAB.GDGCBGAGKDCB..NEFA.RBEC.LAAE.hAAATEBHSFHHhABAMHAA.UGEDHADBABEE.EAGEhAFAQEEB.JABB.....hAIAfDGB.hBBA...,1,-11,-43,32
HbcTYfdWFEgXQIZOSNaADMRLVBGKPUeJC,DIBGLAABBDBHKDHHUDFH.CAHE.HGDG..TGADdAEFFFCEEDBAQBDBhAAA.OAGDhABAaBFFMIFC.RECBPGFAhACA.........hACA.eEEEcACBWDADhADA.IHHE.,2,-28,-18,10
SXRCGZDFeVbYQBUMIKcNHTAfaWOLgEPdJ,aHBGOEEGLABC..ECEEdAFFSCBECEHFZECE.FACEeGDGhAAAVFBBQBCGhAIABHAGMEIHIHHCKHGG.hAAANBGE.AFGEfEDE...gAFEhABA...hBAA...,2,-24,-18,6
XZBHSedTbVFACfQGcYDWgIORMULKNPaJE,QGGGGAFEDIAC...IAFEMAEBKFFCaCEDEFBH..BCHEhAAASCAFdEACVABDAAABCDDGhABA..fECChABA.WFFF.gGCCOFEH..hADA......hAEA...,1,-23,-39,16
ReJcdFaOfNKgPGBUDWVAELZXMQTYCHSIb,EDBDZAEGQFGC.CEDB.HABH.SHEAIACBeFAAhAAAcEEBFCHH..OGBEhAAANIBD.PAFChABABGDHDBADAHHHMDEC.YFHHbCCA.dAECaBBChABA.KEAC....hAEA...,1,-6,-20,14
OaLSeGRYPHgNVJZCKQXBTMUcAEIdDbWfF,EAFBdHFHDBBA....fGHAaHCELDGHGEAHRECBHAEDgABChAAAJEAB.KHCAXCAGhAAABHADMBADACCE.hABAIDDAFEEG.eFFANBIECHBC.....hACA......hADA...,1,-13,-15,2
DEbgGfTPLBAIUJSHCaMZdKFeQONXRcYVW,UDACJDCHHEFEMGBEKBHF..FAEH..OEABRDCC..VFFGDBDEEAAChAAAGAGE..fCCBhADATABEBBADhAAAAIBCCHHGZGCA..........hAEA......hAFA...,1,-24,-32,8
NXWMPUgFRaAKTDIbSeHCVYBLcGEQOdJfZ,DDFFSHBGeCAFHEBFCEFD.BBEALCCDEGAB.QAFGhAAAdEGBZGDG.XEDDMBAE.hAAAPHECgEDDhABAFABCADHEKEHHICCF..YDAH.hACA......hADA...,2,-19,-13,6
cegGRdSPJFObaCLZfYDXMIQWEVKNATUBH,BCAHHFDFeBFCRFCDdCFE.SDADFHGE.OABFaACB.LBDFhAAAZCDHDFGE.XDGAhABA.IHHH.hAAAECEBKAGEAGADTFBFcEAG......hADA......hAEA...,2,-46,-5,41
bESIKLOTGeaFYHfVAZXQRMBDUWCPJgdcN,XDCBQFCARAAF.DCCD.UBDCCHEF..JAHBdCAA...bEGDECFBhAAA.KGHFLCFBhAAAGEAEaADHFGBH...fEGFhACAAAHDMFADBABAgAEENIEH.IFEEhAGA...hABA...,1,-13,-22,9
dQLEUGbfYCcJHRZVXgSAKaFeIWMTONPBD,FDABeGEAMFEFODEHBAHDDCAD..dDFDEFAAGBCD..bBBBCHFHHFBBhAAAZDFA...XFFAhABAACHEaHAE..TAFHhAAA...NABF.......hAHA......hAIA...,2,-31,-24,7
EIQZWgPaVSCAdGRDKLNcBfJMYUXTHbFOe,dGFHREEBLBDBBDFBMBFAUCGF.HGBEFDBH.EAFHZFAC....PHFEhAAASCHB.hABACEFGDCACNACE...JAAEhAAAXEAG..OCDB.eHAEhAEA......hAFA...,2,-37,-12,25
BQLZDeJMUEbaXPCONVdISWATcRKFGYfHg,REFHGACBHFABQCEFZFDEDFAA.eCCFMEDCEBAD..aCGACFCAOAFChAAAdFHG..IHBBhAAAADIBKBBCFHDA..fCAGhABABAEC.JHDE.XCCC.hABA......hACA...,1,-10,-20,10
SJgAOGLCEWBfdaTbKNVDRIMFQPXYHeZcU,LHDAEEGDBDECdEBGTCDA..KABAVAGFDDIB..RAEE.FFFC.QCAFhAAA.XEBDhABAYHCEHABChACAeFCEcGACUGGFSAGEAIHECEHCaFEH..hAAA.ICCE.hAEAMBAF.,1,11,-39,50
HGAgPebMYQKIDFUONJTZSfXBCcRaVEWLd,eGEAMCCAKEEGFEBFUBAC..OBHB.JGACSAFGhAAA.BHDDCHFFaDBDEDDFdCAAhAAAAGDE....PCHFhABA.QGACDIAGZFGDfDDAhABA.XGDBcACE.hACAWAFE.,1,-24,-44,20
cIKHFCfTNAdMSXZVGQOeDbgYPBEWULJaR,SHBGZABHGGEFeDABDHEG....bCAD..PCFFBDDEEAGEhAAALFCFRDEF.KAHHhAAAHADCCBDE.NACEAADCXDCAhADAOEGF..WDHBJDHFIHAE.hABAfAFA.hAIA...,2,-22,-9,13
CMdUcYEZDaWFOGLTRIJbKQSAgNeHPVBfX,eGEAHGFGBGAFCDDG.MEECdBBEUCGB..EBFEDBEBaAAFFFCHOHBChACALADCRFDC..JCCFhADAKBADAFCB....NAIE.hAEAPFDA..fBDE..hAFA......hAGA...,2,-39,-20,19
VAIEHZUFeQNYgJcOLadGbCPXRBDMTSKfW,ECFCZBCDeHFE.QBFANAAC..JHDEOCADdBDGGEABhABACEHFRFAC.DAIFMIDEKEGG.VEDEhAAAAHBD....IBBFhACA.UEEAYABE...hADA......hAEA...,2,-30,-12,18
JTBaUDGZHIbRNELPKAWQcdeMYCSOVfgFX,QCBCeCCHCEHA.ODEF..fBFDFHAEJFHD.aHGAUADBhAAAZABEHFAERCGBLGAChABAKDFEAAHCdEEG.MAAChAFA.....SHBAXGEABEDDhACADGGE.....hAGA...,1,-16,-22,6
VZMGPYFAdUDgBSabICLTeQJNEWOHfRKXc,DDFFSEGD..IAADLEAFQGAGNDCE.OACChACAfDGDKFGGXECChAEAZEDHPHFCAHHFdCCFhAFAUBBBBHDFCHCHeADGEDGH....WAHBhAGA......hBGA...,2,-33,-13,20
SKAUCTFJfWNGMXVaPdcQZOBLYERHIgeDb,TABHJCCH......NDHEGEAAXGEG.VEBAaFEEdBAAhAAAQBGBBCFGEHCGIFGEhAAA..DFIFhABASEADAAEHFAHD.MIFA.cADDhABA.ODDA..hADA...,1,-22,-32,10
KHVCIZeSJPdYEgbUfRLBWNGQOXMaFDTcA,HBCFCFDDZAFA.SDAGdCAA.EFCGUDEDRAADLHDEBBBBGGAFhAAAOCHF.MFAFDDCFAHHEIFGAhAAA.PBFGhACA...........hABA.YADDfEEGhADANIEFaFGE.,1,3,-50,53
fIZbCQOdEVXLBTYAWaMDUFHSRNJgGPeKc,aGFHUGEDHAACRDAF...JEACGADG.eACFKCDG..IBGAhAAACHAFdDFF.EHGEXAGGhAAALDGDBHCCAGAEMHAGhABASFFC.NDIE.cADA.fEHEhAFA...hABA...,1,-15,-27,12
AcfBZgUdVJETGKWFeaQbDNCYSHIXROPML,BFDGUFDHdFBAEGACGBDEKAAB..FEHDQABC.DFGHCDBGHDEChAAARDAA.OADDhACALHEAABGD.fAGFhAAA..gAGBJCFA.WHDAhADAaFHF......hAFA...,1,-12,-43,31
IRfHYWgbKcEeAFJNGZTXCPdBMQSVODaLU,JCCHGEDHZEEC.CAHDdCCDBDHD..QACB.OGBELACEhAAAUCGCfBAAhABAHDAD..WAFFKGBAEGEBhAGAAIGG..NIABPAAB.....hAHA.SGGAhAIADGGG.aBFD.,2,-44,-1,43
OPZDfUYHcQeNTJaGERdLKICWgMXBAFVSb,FEHBVDAGOCAB.ZBCEDAFG.UEGBHDEH.eEDDJGBA.GEAEhAAAdBHALADHCHCG..hAAAWAHDMEFB.ACCG.SGGAhABA.fABAcBABNIAF..hADA......hAEA...,1,-17,-32,15
UVMPcIJWAXOfDgeRZbQEKCFNTdGLHSaBY,XDACOFCHDBGHRFBF.ZGFE..QBCAKCCC.CHGF.FFDFTAAChAAAdEAALABGHBFBBFGHhACA...YFEFhADAMAHDPEEAIAHAACAH.....hAAA......hACA...,1,-6,-38,32
fVDQRWYZAdXNPcgIJOLEUeMKFCBaTGbHS,XGBC..NHBF....PEFDIDFAOCCCEECHUBAAhAAA.KFFGBBGCaAHB.hABATEAB.bABGSCEChACADDGG.WFHHAICEdAHA.cECEhAAA......hACA...,1,-30,-36,6
XfWFgBRLJZbHOPMYaeQDCVdENcGUSAKTI,TGBCXCBC.FGCDBDEC.REFDLBCCZAEDHABAMEGF.aFHBhAAAeDAD.CFEGVAGFhAAAECGGGEAFAIHEKDCB.fAHGhABA.JFEBOEHF....hABA......hACA...,2,-24,1,25
NMaObKDFJSVXGREIPHQBZTcLWdeYgACUf,UGGGMCCA..OAABDGBAFCAF..SEEG.GGEFhABAICEGPAEEHGDEQDGAhACABHCDTDFAhAAAWEADeBAEAAIF.fEEGaGCHJDBB.XDBDhABA.EAFD..hACA...,2,-35,-4,31
KgQDZHMYBRIVEbXeFSCJUANcGaOWdPTLf,GAFEOCCHdAGBLBBAKDFD.QGGADGFEZBAD.MEDDRBGD.EHAAhAAA.XEAAFGDCCADA.hAAAJFEGAIEA.aADA...hABA.PFAFfAHE.....hACA......hADA...,1,0,-39,39
HIPbZNYJWRAFdXaDVQULMCETgOeGKBcfS,dFAADDFFQFCAUCCDLAAF..MCCFECHH.OBFAKHGEBEHAhACASBBCHFCD.IHAEhAAAZAEFJFEAABCEaGED.hADACEAD..eADH.fHGB.PCHDhABA....hACA...,1,-23,-29,6
aPNQeWAKgXIZYSGDEbUTCdBOJVLFfHRcM,XGBCZAADGEAHDADGEAGA..UCECCFGABGAA..VABHFGDARACBMBEChAAA..aBEDQGGEhABAADIH.KGDEIHCFhAAA..SEFA.dDDChAGAOEEGfCGFhAHA...,2,-27,-26,1
KIPSdDfFebNagWEMHULAOGCTVYBZXRcQJ,CDHBVEFHBBFD.ZEBBRCCF....JAHBKBAC...SHGAhAAADGAAeHAG...aGECEBACMAEHhABAUAED.AIFA.ODGBhACA...TAGFcDAG..IEEGhADA.fFAAhAFA.,2,-47,-36,11
gPSCEYeaADFfKVOWbMNQHTIJcXZBGUdRL,DGHHFAFBKHACOEFD..MDDCHFCB.JDAEZEGBBCGHdBBHRFEH.LDABhAAASBFC.CBAE.hAAAEECA..eCCEAIHE.hABAfFAE...WAHB..hABA......hACA.NEIEIADFXGCF,1,-22,-29,7
OYFcfEZMNIdKQDACVTWURaLSGPBXgbJHe,CFFCTFDHUAEC..LDDCSDFD.BGCG..XDAFhAAAJCACOBEGFDHHEGHFMIAEhAAAdBADKEAAABIF..VGBAhABAaAGA..PFHB.......hACA......hADA...,2,-29,-26,3
aGcOgIfBbCSNVFRXDLEeJWUKZQdHYTAPM,MHFGGEAH.OGFC..fFEFCAHHSCADFAAEDDBAEGDD.hAAAeCEEUBBFQFAFhAAAdEEE..YCHHhABAAAIBaFDHIDEGBGAANAGE......hADA......hAEA...,2,-33,-15,18
OBaVHdgfYXSTIZRMGcPQFCNAeEULWKbDJ,EAADUDACKGAHDCHH.BGDBHDCC.dADG.....gFCDhABAfABCXAFGhACASHBEIFFCMDFF.hAAAPCHHCHGAAAIBLAEAJFHD.aDDF...hAGA......hAHA...,1,-15,-38,23
WbFPLAXgSOQfKDYZJeRUGTdaCVNcIMEBH,SGFCODACKGCDZEFDRDBAGACB.dDFBaBGF..CHAH..VFCFhAAANDIE....IFEFhAAAMCIFBGACHBBAFCAEhABAPBFHAFFC.gFAFDAFCJHFG...hACA......hADA...,1,-13,-23,10
VIXRDANLGBWdPOSUZcFeQaMbKCgHTYJfE,GECFdEGDSCGGZBFGFHDA..eBAAQBCHMEAB.CFBATFEAhAAAJADA..EGGGXGBAhABAAABDBDGE.OEABhACA..aHAE.KCDDYEBC.fGHAhADA...hAAA...,2,-25,-14,11
JLASDbOQHMaRFZVGWCNTKYIXUEgcPfdBe,SHFGDEFHQCAEHEDBRBFH.ZDAEGDGGCCAFKBGA...XAEBhAAAEFAH...PHBGhABABHDDJBBAABIHOACFhACAMAAE.aEDDFGHF..NIEF.......hAHA......hAIA...,2,-27,-11,16
ICFZBAGWPUMYVNaJHgXEcfbOeQLDSTdRK,GAFEUCBCMIFA..NBAGHFEHEFBH.....fBCChAAAOEEFLEGFDDDDdHABIFBHhABAFAGDZACAADAGWDFEhAAAPEHD...aBEB......hACA......hADA...,1,-17,-28,11
GTcdJWBSVPNfgUaQCEMYbOZRHAeFLIKXD,FGDBKDCDDCADGADA.dAGEJDGDBFGG...SAACVGDE.hAAA....PCCBhADANABBUGBAQFAChAFA.MBBDbBDE.OHFA....hAIA......hBCA...,1,-25,-48,23
ZBeTANPULDdVIgHGcQfMXCWROKFYEJabS,UCBCdEGC..IHCFHBGHQGDG.MFIDWAHHKAECFDDAhAAAEFEG..aECBSFCDhAAAeHFAABBCLADEhABA.DCCCgDFDfBFGCHGGRBDFOCAFhACA.....hABA...,1,-15,-18,3
LfPGMHDOSAdBUgCEaRbIcTQXKYJNeFVWZ,dFFBUGGGCHBB.ECEERAAC.......bEBHTBDB.KDFGNAAB.FFAEhAAAZCCH.LAFEhBAA..PDDHMCIDDFFBhBBASAHBBBGAaEEAIAFC.cGGChABA...YHDAhADA,2,-33,-28,5
SMRGVZfXPgBYaQdHAWDKCeITELNcOJUFb,DGHHeCAFEACGLGCA.OACGFCFAMFDCRCCGZFFF...XEGBhAAABHFGaCBGHAGFKHBACAHHhAAANIBH....cEBFhABA...........hABA......hAEA.JDDA.,2,-51,0,51
WVEfabSeYdZIQGTBROgPNLXKJHcMDFACU,UGGGVDAG.EGDA..aFGEeAAE.ZFABGFBFBDCE.OABC.hADA.gCEFhAEANICB.LCHDXBAGhAAAKAGEHAFBDBEGAFFECEEBfCHASBBG..hABA......hADA...,1,-17,-20,3
GaOESRbLJAUIFYVefZKHWPdgCNTBDMcXQ,FGFCVFDFZDCH.HCFHdBHC.CAFA.BHHE.DACBXDAGGBAA.EBCA.hAAA.SFFBhABALCHBAIBEUCEDeAAAfFBAhADAKFAG..WHBEPAEA...hAAA......hABA...,2,-21,-21,0
bBDcKWeVJUFGLYgAOdfCZIHSRPTEQaXNM,dDCDZDBHSHBGRAEA..EAAFaGFCMDABDEDA.KCCC..eABEhAAAUGDDLBCAAIHA.hAAAODFGfCFAhACACEHDIBGBTEGGNAEF.BCHD...WCBDhADA.FHAE....hAEA...,2,-28,-22,6
WRFXfTbQSEGPYgeNHIcJdVLBMDOaCZKAU,REFHXGBC..TBFBQAEDEDCBGABH..YDEChAAANIAH.HFCCIAHChAAAJABHdGHGBCAFDEAACFFBhACAAFIHFGAGSAHF......hADA......hAEA...,2,-25,-17,8
TMYJLXgdaPNHEfDQSWOZVUcFeAbRCKBGI,CFDDKGACGDEFMDFGLFCHdFAD..aCAAHBBCDIAC.SAAGhABAZABAUFFD.FEHB.eAEChACAAHDDBEAEIFED.hAAATDACJAHF.........hACA......hADA...,2,-36,-11,25
XTSCYMWZPKBNcdFabOUGRVAEIJHQefDgL,JCCHQBDG.eAGBDEBBLEFC..XCBFhAAATGCHSFADhAAACGEHMDGFWEABKFGABHGEdCGBFACAhABAaFDBOHAE........hABA......hACA...,2,-36,-29,7
LQSZIWaBgHRXTFEDAUKcNObYfdeVPGJMC,KGFCOGEA....bACGfDCG.dHDHeHAA.PBHHhAAAJBAECEFGQGAEhAAAZEACaEEBBCDCRAFDTDGBhABADABBAADE.UADE..NAGA......hACA......hAHA...,2,-28,-17,11
ZOXDVcdENIbgQLAJTBRKeGYUCPHFSWaMf,TGDEKBBDeAEB.GECDUBEEHECA.FBCBSHBAMAIHOFGDhAAADBAFVGEC.ECHHhAAAIGAE..hABAgFADACABBEABCHBAaCGF.....hABA......hACA...,1,-14,-27,13
IgAQKCNZMUBVbGDfecHEXWdPSLFRYJTaO,QGAFCFEDZBFABDCH.GDEC.DAFEeHAEHABEEEHD..XDCChAAAdCAFLFFBFDHHRBFCJDAFhABAaABE...IGHFhADAAIAAMGAA..........hAEA......hAIA...,1,-9,-36,27
MdbRDQNTYXWeGaISZJUKEAPgfOCFBcHLV,...fDCDFDABHEEGMIAGdCGBDGGGQFAE.TBCHhAAAWBAEGEAF.hABAaHAEIDHHZAEBKDGAAACAhAAAgGDD.CAHEBGHHcFEB.LHFEhABA...hACA...,2,-26,-11,15
VUEcbWDHGfQXYCLaFRZISKBJPNOdTgeMA,EDAF..bAADHCGBGACFXACGLCGFaFEAZFADSFDHhAAA.BHHD.NBIAOFADhACATGCAMECAAFCHUDDFhADADAGA....YHDGCHGHFCDAIBAEhAAA.....hAFA...,1,-7,-11,4
WcRVfEDAgJKaIPQYCeNZHFTXbdMOBSULG,KDCDaHBG.QDGE..eCDFHBDFFAADTABDXCGCdHGHOAFEhAAASEBFUGCGhABALAFG.WGFGhAAAcFACREFA.EDABABDF.JFEA.....hACA......hADA...,1,2,-28,30
USQLDMPZXWfYNOgbGeEHIAdBcaVFTCKJR,BFEDaCFC.FAEFCGAH.KBHDUECG..QGAHDABCZEFA...XGGAhAAA..WAFAhAAAfHEB.hAEAOADHgBBHeCFH.IHCFACAEdBBA.hABAVGEE....hAFA...,1,-24,-45,21
ZGLdWFMcCNXPTYAJaRDeSHVBbEKOUQIgf,JDCHRFFADCEHHEFEBBGHKGAC..UDBF..IBBCZAAEGFAFLHDEhAAA.FBDACHAF..hABA.XBFD.hAAAPCABAHHESAEGEAHF.OHDE.hACAfEFF.hADAMCIB.,1,-14,-45,31
BPRaJFgdHTCMeKXQUSVbNWIGfEcOADYLZ,DEFHLFBBZFBCRCDC.JBAH..dBBBCHFD.KGFHUDEB....SCHHhAAAVAEC...hAAA.NCDC.IAGGhABAGEGE.EDAEAEAHBHAC..FAEB....hACA......hADA...,2,-41,-32,9
EZRaQWTHIBDLVGUKXMbCSOgecJYPAdfFN,dAFBFHBGECFARCBH..QFEEHDDBDAGGGGEBKGCB..MAEDSBCFhAAA.ODAHhABAgCGC.JEHBhAAA.AEEE.fDGAaABC..ICAEhACABFBA.....hACA...,1,-23,-28,5
FHIMJDQRYOPSWXKLfAecVGZdaECUTNbBg,eFBBVEBH.ZGEC.EDFDCEHE..UBCF..TDBHBGHGHAFE.hAAAJGDERACEPDHB.hAAASAFHKBAHAEADdEEBaHAChABANBAE...........hABA......hACA...,1,-23,-30,7
MVUDaWdOTcERgZeLJXbBIAfQNKFHPYSCG,QCBCKAFBFACDHFFBSACCGEABMAAFUFCH.DGABdDGBOHFAhAAAEDDC.ZFAHeHCEJFFEBEEBhABAIAHC.AFFF.hABAPDFACBED.VAEE......hAHA......hAIA...,2,-13,-11,2
FBVNWcKeXPUYdbCGLgQfHTOEZDJIMASRa,SEHBRFEEFAAABBDC...VEEB....NAIE.KEBB.PACAhAAAdBFAGGAFLHBEhABAQCDAHAGHTBBFhAGAEDABDGIBIHHC.AFDB.....hAIA......hBAA...,1,-16,-34,18
bMfEUIJQSgFAVWTaYPGdKCHROeZBLDcXN,TFDHaHBGGAFA.dFFDHAGB.RBAAeHFCZCAGLFAEDFAD.XABGhAAANEBE.MHEChACAECEGIAAF.hADAQDDH.SDHHAHABWDEF.hAEAPADC...hAFA...,1,-2,-22,20
HYUTaANXKZSgGRVEBcdIPQJefbWCDOLMF,KGFCZDAGSBAARBEDBACB.dEGFQAAG..fEEAhAAACHEADIGELEBGHBDATFGAhABAAHDG.XBGHhACAgAGGEFAHcGADIEGG.eFABhAEA......hAFA...,2,-39,-4,35
ecQOPCASFETGMIZHYKBgabfUVRDNdWXJL,EDABMGCEHFDCBBEGaEHFUCBF..DCBGdBHAJCFELEHB.eAAEhADAOFAB.CBDEAHHHFGABhAEA.TEFCIDDBhAAAZAFBKHCE..fABFNFAF.XGBDhABA....hAEA...,2,-35,-12,23
KMQcDYAfWaUHNFEZVLTSdgCBPJXOGbRIe,aHBGHEFH.EDGGZDFELDBGdDAFBCGD..JFBF.OBAGRAFEeFACMFEDhAAADICGAACGUAEH.FAHFhABASABDCHHE.hACAXGFG...bDDB....hAAA......hAEA...,2,-31,-13,18
ZEIDWXGSACFYcRdBbOTLHgfJeVaQNPUKM,FEGDRAADBCDHODBEHADC...JHFEVFDH..QGCEhAAAUAACMBDAEEFH.DDFAXFAChADAAGAE..YBHHhACAdCFE..........hADA.LEAA.hAEAfHABNDIA,2,-37,-17,20
adKMAZHSfOJNgVbLBGDRWUEXYFPQIcCTe,HDDFOCCHJDAA..VGACBHFD.DBCEUEGG..EAACFBDDQGAFhAAACCAD.TDGFhADAeABCKFED.AAFASBFChAAAfBGFNAFG.....gGGBhAEA...hABA...,1,-18,-40,22
QJHLNZRISfYBXOaDGAEecbgCMKUVTWdFP,eCCH..gFDHMFDEKAGE.UDAF.TBFEFGGAJABHLCBChAAAZADF.SACAhABABGBCXDGEaHGAAIEEcAGFhACACHFHdGDC.QDGHNAAA.RFAB.fBFDhACADGGE..hAFA...,2,-33,9,42
BFDHAWGdVISZQCbKRUPYJTaNEgOfXcMeL,dGAHVDAGZDFC.CCDD.KEGA..UAAG..JBAC..aBFGEGCC.OAGFhAAA..fDABhADAXGGBeFEHhABAFGHDAEAF...IDFEbEBERGDA.PADA.hAEANAIE......hAFA...,2,-34,-19,15
JRMgUACPcTfIGYZSBVdOHbWKLFQENaXDe,CFDGTCBCGGEF.ZADASFCHBHBA.OBGBHCAAKFAELAEHhAAAQCED.EDHHhAAANDIGaGFDDAID.JEEF.gGAFhABAAAHF.fDAE.IACHhAGA...hABA...,2,-29,-7,22
EYPSITMJUOGVNHdXCDeWAbcFLafQKgZBR,FHBGaDCD.QCCEZAEDBHAF.RCEC...EDHHSGFA.MGAEhAAAUAAHGADFHFEDdEBChABADGIFeCAB.AEGA.hABAcAGEfABAKADF......hADA......hAEA...,1,-16,-27,11
HRCJIGOMePDUYbaZXTEfNVgSBQLKcWdFA,RFGHCAFBGCFCeCFF.UDCCaEBB..ZEDF..EBEB..VACBBHBAKAGBhAAAdCBCAIEE.JHFE..MIAAhABADCAB.....hAAA.XABAfCAC.SFCFhACALAHF.WAHHIFHGhABA..,2,-29,-26,3
ZcDIGHXbgSFEMfPYJTRVdNeQaLBUCAKWO,OCCHDHCEGEBHHAEC..XACGSGHDMIBE..fDGDhAAAJCEEREGH.NFDDeBBEhABAaAGCBHAFCCAC.AGIBKAAFhABAWFAD....cGEAIHCE..hACAFDABEDDE....hADA...,2,-22,-17,5
gURVacJDOFKHEBYfIQWSCZbTMXPdGNeLA,REFHVDAG..aDDCDDFBOFHFHADBBGAC..ICGESHEEhAAACCBFZFBG..MICEhABAdAECeHAALCHFABAFUDAFhAAAcGBGFAGEEHEE.......hACA.fGGBhADA.bAFB.,1,-10,-29,19
CUZScEPFbKXGHOIVNYdLRAfJDTBQgeMaW,JFCHDEFABGDG..QAGGeBAB.MBACCFFEZAFA..ECDGFFHFhAAAKFGEGADEHGEAVCAEhAAAdGACADID...fEEChABAaHCC.WFAHSCFA..hABA......hACA...,1,-15,-37,22
adNXWBRPcEbHfVLKTQCYMgIZeDAUJSFGO,UGGDJEGHGACGdBGA....XFDFREBGEHCCHAFDLDCG.hAAATBDDQCAChABACGAE.YCHHMBBBIGCAhAAADGIFFHEEaFAHBHEA...cACBhABA......hACA...,2,-31,-1,30
LMfeEYKWCcHSOJDQIGgTZBdbARaFUXNVP,RFEEFFAAUBDH..XGDA..VBGFMBBGeABDKHGACCAAHDADhAAA.OEHFDECEQDFAhAAA.IAGChABATGBEBADB.AEEAaGAHNCDD....hACA......hAFA...,1,-20,-38,18
BSUJXKaLCMDTVFOfcHIEPeGbNgdRZAWQY,QCBCSEGDUFDAKACBLFFC.CCHG.MAHDDIBEFFAEfAFEhAAAHAEC.IBDChABAEGEDeDEGGCAHhACANAAE.gGAHdGGA.AEACBHHEaHAG..hADA......hAEA...,1,-4,-26,22
aEHRJLQZSPFcYACOBNVMIbgWfGKTdUXeD,CEFAOAFBBHFD...MBDF..IBGA..gDAFhAAAfHGBTBGBhABAUDAHeAAEDEEDHFFALDFEhADA.SEDDFHACAIFA.VGAAWADBhACAKBDAaDHDEFGA...hAGA...,1,-17,-26,9
cBPHUVgSXNfdTKGEDOAZeYQFRCMbaLWJI,ZFDFeDACFCEAMADALBAC..IHBCBDAGUFFHSECChAAA.XGEHhABAdGABKCCDDIAAAEFHRBGFCBBFaAFEcGGAhACA...HFBC.NCCF.....hAHA......hAIA...,2,-43,-9,34
GPEQDJHVFCZbXOMIgefaTYWANLcUKSdRB,LGEAKGFCRFAHBEGBGBAG.EGAGDIEEJEFAHCCD.FCFACGCEZAEF.hAAA.OBAHMBIDeECEhAAA..aBCATACChABA.AHIF.NCICSAFE.QFDAhABA...hACA...,1,-18,-28,10
bWXEeUdZFNYgKITGaODLSfHAJCMRQVPcB,MIAGQBBH..PEFCBGBGbEGBEGBG...dCGHFAEH..hAAANEBB.KGGG.TBAGhABAaFDHLAFCSAGAhACAAIFACGFG.cDACeADB.YDDE...hAAA......hABA...,1,-15,-24,9
XMWHIJSUQEDFfKYPgCZGcNRbadOeBLVAT,XGFBMECGHFAA.JFDAQDGC.FCBEKAAE..PCEHhAAACBCAGBEHRFAA.dHGBBBEBhABAABEEIDAASAFEhACADDHB.fGEG.ZDAC.NIAFaBBGhADAOAFA....hADA...,1,3,-31,34
eBKCdXPDMSFIGJVLOfbRNTYUZQHEgWcaA,KDABCFCFdCABDAHF..FHFAGGCHLFEG..OBCDRGBA.TAAChAAAUBEGHDAA.EAGEhAAAgCEH.hABAaADFAIEC.BGBCMDIDIFFDfABF.hACA......hAFA...,2,-39,-19,20
ATQbWOMFJUEYHDBRcaKgVNdLSeCPIZfGX,TCGCQCBC.ODHHJFAE..ECBFDEEBRACB.KFFF..VFEDhAAANIEB.LAEC.hAAASGBAPHBAIBDAhABAfCEAAGBEWAFDMIBE..FAHH.hABA......hACA...,1,-20,-28,8
HMURbYFDSTLQEOVdXCBfZKJNIePAgWcaG,....gCBCaHBGGDEDHFFCMFHDbGDCDDDE.LAAChAEA.EECFVCEGCFAGBAHAhAFAKBGEJECAeBBDAABEcFAAhAAA..YHCGTADA.dBEFfHABhADA.NIEF...hAFA...,2,-8,-8,0
GgCdeEbFNRQafOHcJTSVZDKBPALMUIYXW,MAFHUCBC...XBBCGGCBCAGA.dACHeDDHFCGC.RCFF..aACAHEFAhAAA.JFAATGGBhAAA.SAHHhABADAIBBDDEABAEIHAD.YDBBEHGA..hAGA......hAHA...,1,-23,-29,6
TLIbeagOXJVSdNBMWcKEAfDPRHGQZFUCY,DACBRGFGQCGDUEBB..CGGBLCGHeECFaABH...ODAAhAAAXADB..JHAESGAFhAAAdGEGBAEFMDIFhABAWCAAKAFG.AEFDfEHG.PFDDhACA....hAHA...,2,-42,-23,19
ZXOYTWPKFEDGCJgSaRAIbMBfUdcVeQHLN,MCCAUGGGdGAA..VGCEQDFCHFFGLAACZACG.XAFFhAEATDDFKFCG.DAAGhADAJEBA..aHDGAHIFIBHChAIABEAG..fAHEeDDE.OBEEhAEA....hAGA...,1,-11,-27,16
SPaOQfHRBYAUXVTIbedCcMGEDKLFgWZJN,XCCBTFDH..eBBDCGDCGEDBDGIHFCGCZAEC...JHEGPBEBhAAA..QCAChAAAHEAARGAAAAIFUFFEIABBhADA.dEHAEAEG.KACHgGAFNICF.hABAaFAG.OCEC.hACA...,1,-3,-5,2
TDcOfUVdKaeJZICgLMYAbEPQWGNRBSFHX,EHBGQCBCGCGERCBCFCHBHFDCDCAH...OABEUGDCdDFAKFACaGAHhAAAZAACCHGG..MBADAAFF.hABA......hACA............hADA......hAEA.PFHFBEEC,1,-13,-35,22
TYURdPLCbKQGaSfZMeBNIDgAEJHOWXVcF,EDBDOFFC..VFCDFCCHUCFF.dGBFCFGHQBFCGABF.hAAASEADMFAEBCAFhABAIHACAIHE.HBBEhAAAXAGETDDF.PHEC.KACCaGAHhACA......hAEA...,1,-5,-30,25
WMCLVbRFQTgeYUONSXADEHfZKaPBdcIGJ,EEAEHGFGKAFEBCFA.dAABGFCDJDBF.CCCFLDDCREEG.FFHBTAGGhADA..eAAChAAAOCHF.SAEBhAGAAHIF.DCCEaHCC.IBHEMDDD..hAEA......hAIA...,2,-33,-22,11
dPIXCQfHOUaVZgJbTNeEWKSMFALRcBDYG,LFBBBFDDGDEAdFFD..XAEGCBDCQBAGHBCFUDGFZAFEJCHBhAAATBAE.EFDFKGHHhABAFAHFRFABDCED..IGAGhAAAODAE.aGHD.......hACA......hADA...,1,-2,-23,21
geAUOLcBfPQIKdbXVEJCDaRSHZYGMTFNW,UFCAOEEGBFFG..QBGDdAFC.XCBCJCAECACB.DBBGhAAARCGD.SGFGhABAHEABZGFE.MAFCFDDG.NCAEeGBGhACAACIB...cEGEIAAFKEBA...hADA......hAEA...,2,-35,-20,15
WEHTNZLFCPYODgQafMKcVXbSRAGIUdeBJ,UAGHBDGFEAEGHBDDZEBBLFFD.FFDFCBBHOEHHDABG.QFDChAAAMEAGKBBE...hAAA....XDABhABARFBDAFAFIGHFeAHDWFFH...NIAF.hACA......hADA...,1,-26,-33,7
JSeFVIgPWNCdYQGMKEXUBabcTLDROfAHZ,HDBGZDEDeHFEFCAB..VFFE..gABF..PABAhAAACBGAdBDEGEADMFADEGCGhAFABHAGaBGD.bDGD..hAAAcGBCDBAH.OBFBAIDGSAGC.hAGA......hAHA...,2,-18,-11,7
IdOPcEAZDQVLbYgRCTWXFSaGNfUeJBKMH,ZFEEDEFALBFC..bCADRDBBCHCH..TABEFBDB.GCEFhAAAUFFFBFACMIAGIDCBhABAdBAG.OGAEhADAEGAFAFIB...QAEF....hAFA......hAHA...,1,-13,-44,31
BIRSJZLYAaNbFUcXQgCGHdEfTPOMVWDKe,aHBGFHBGUDAC..QDAEGACCdHGBEAAC...TAGAhAAAODGBVGFAKFEFBCGBhAAARDCDSADGZAEBABBD..hAEA....NAIE.XFACCAGA.fEGBhAFA.MICGhAGA.DCCE.,1,-14,-31,17
KBebCNEaTJZdUWDLXQcOfIHSVPGARMYFg,RFACMHFGFCAHBEHB..bAEC..EBBGTEEEdDEB..DHGCQFABhAAA.OCBHhABAHBFCSAFChAAAPFDBACDDKABGeECGaDEAJCHFWABE.....hADA......hAFA...,2,-31,-12,19
PeQLBgGKXZdJUDVIOSMcaTRfWAYNCHbFE,CFDGHDAGFCAB.EFHD.QACCLDEABBEAKDFEZFBCdFADDABF.OEFBhAAASEHH.MHAGhAAAaAHH.....hAEAfABHAIDAbGAG.eFFH....hABA......hAEA...,2,-44,-8,36
gHFfTQGCbKLEDRONPJXIMYSZWdVaAecUB,eDACBHHGFFCHQAABGBGE.CEGE.LBDAEGBH.OEFDJAGHMIDAhABAZAAFdDDA.AIFA.gADDhAFA.TFEHhAHADCADNEBE...IDEASAHB.hAIA......hBFA...,1,-21,-26,5
FMNZWDbYVOdgSLeXaGBKIUCPHQcEJRATf,FGFCMECGZBFGDAGC....VCBGdCAALFBF.aFCEBAEAhAAAKAFF.IACEUGFCCDHH.hAAAQEGE.hABAEHAGAHCAfADC.NDDF.WGAE.hACAOEEBSFHHhADAeEAG...,1,-26,-34,8
FRegEAdIVKfDCYNUTZGaSJWOHcMPLbQBX,dCFCVDAGDFFC..CBAB.UDBGGDGC..aGGEJADDHACG.MCAHhAAALFEB.BBHAhAAAFGAC.eFABAIBGKHDEfFDEhABA..NGDDSABD.hACA......hADA...,2,-31,-31,0
MTNVZGJRUQSCcPXALHDFBWbYIdagKOfeE,HAADDFEABFBF..bDCCdAABKFFGeDBE..MHBE..TDGEhADANAIEZAED.GADFUACACHFChAAAXGCDAAHF.FGGHhAEAIDGEaGAH..fCEG.hBEA......hBGA...,2,-22,-22,0
XRaZdCbcFMPVSTKJIWHEQAYGeNLDOBgUf,eFEFLFCHDAEHBBBBUCDGRFFEZCAH..dCBACHBH.FCGE..MGAASFBDhAAAKDCA..JDHFhAAAHAFA.EACCAGHBGAFEhABA..NIEBfEGBaAHF..hABA......hACA...,2,-33,-21,12
SgMcaXNDeLBfPIZKbREVAdHFJYGUWOTQC,dEHAHDEDFAFEGGCFUEEF.OBAA.TCGDCAAD..SDCDhABAMAEFaCAB.DDADBHADhAAA.IDCEKHCAEACEAGCDhAEA.......WBCGQAGHhABA.cGGE.hAFA.eHFAfFBC,2,-39,0,39
QOBKSJLXEeCZAWGfURMgbIcNHPDVTYaFd,GAFEREFHMDAC...bEDB..IABEHFBDDIDC..TCEChAAAaAAFdFACBAFEKFGDLCAAhACAXFBHCHHE.AHEE..hADAfBCH.cECANAIA...hAEA......hAFA...,1,-13,-27,14
gMKZPQdRIYHaAESeTCDOcVUNfWbBGJFLX,EEEDSGDD.eBHFCEGBOFDH.UBECfDABBHAGGBADhAAALEFA.gACDhAAAKHGGQFAEhABAIHGGaADGADDBTAFGDCGE.NGEHbFAB..hABA.XDDBMEIF.hACA...,2,-25,0,25
BFEAYbDZTRdQaJGgLWcPNVeXOIMKHfSCU,DACBTBBHQFDA.GDBALFDB.PADGeBAHXBGHhAAAIDDGKDGBfFGDhABACGHCBHBAECFFAEDGYAFDhADA..ZFFF.aAHDWHAGcCAChAAA......hABA...,1,-11,-22,11
faHJZIUQdDgGcbSFBORANeVTYLKMPWECX,eFBBTFDHLCCE.MBBAPBDHCDDD.aBFBZFEF.UDGEdAHCGDAEhAAA.SBAGhABAOAFAAHHENBAG..hAAA............hABA......hACA...,2,-30,-25,5
bFaCYEXRZTGePOAcVWNdIHSKLfDBQMgUJ,VAADdHBHSCEH.KDCDDDGG.QEEAMBBA.JECBaAGEhAAA.EHGARAEA..TCDEhAAA...PFHFhACAAFAGNDGEICHALEABfEHCBHEE.hADA......hAEA...,1,-22,-33,11
cefIPUWbOaBNZVQASDJRYTXGFKHCdEgLM,JEACTFDHGGAH.HBCGdBADEAGG.MECDeCAG...fGGDhAAAPBDDUDFCbDEABFFChABAZDABAHIBDGGD..hAAAXAGACAFD........hACA......hADA...,1,-18,-20,2
OGPZKXRJTNSHgbdLBVfQaDUcFCMWeYIEA,GECFZDAGKACBREEGJHDE....SGBDHDAHbBAA.dHDHLAFDhAAABHHA.QAGDhABAaCFEDEGC.FDHHMABB.hACA....eFCGIHHC.AHCA.XAGAhAAA...hADA...,1,-10,-28,18
CWBeLEGUKPfDZTYRAMXVJSdbgNIHOcFQa,MEIBVADG.dEFF......gGCDICBAOFBFhAAAQDDACGGCBABFEFGAKBGAhAAADADFZEDFRCACAGAFXGFChABA..bAFCcABBaEAG.eDFC..hAGA......hAHA...,2,-32,-8,24
MNPTVQLfOZaAXCEIHYgcdGKSbUWFBeDJR,XGAFEEGDHBAE......gAGCdBFFSAHBUEABBFDChAAADIDAJCDBNEICTGAChABALAABZADFaFEEACIFIHEHhACA..YHECKFEA.FDBD.hAFAMEFA.QACBhADACHCA,2,-29,-8,21
aHKTeFEOUgZBQIDXSbVYAJRNLGMfdCPcW,JFBBRFDFLFBFGADA.dFHG..CFHD...PEEAaFDAHAGD.eABDhAAAEACCOCAHUGEDBACAhACADCDF..SBBDhAAA...bAGFAFAHMCIFfCEFhABA......hACA...,1,-21,-24,3
bgLfNVCOPUHXGEeaYJTMBDKFQIRZScdAW,...bAADgGGD.LBAEVFBAOHFEHBFAXFEFhAAAeECEJAHDBACCFFACIDHHhABAZBEF.SDEGhACAAHAHNDIACFGG.PFDBEEAFaHEGMCCFDAAF.KADChAGA......hAHA...,2,-7,-7,0
fGgbacOVCJPUMZYLQIEKXSFdARBDHNTeW,BAAFHFDGeBBCGCBHaGBHOGFC.CDHA.UBFHZEFA.QEAHhAAA.IHHChABAKEBBFAGFABEFNACB...fACHhACAbDFAJCDF.MICA.EGCA....hAFA......hAIA...,2,-35,1,36
PfSCGaBEYgMRcLQbdVNJIAXKeZFWTODHU,XGGDKDBDFCGG..OEEHDGAAUDFH..SABHGDADECCGhAAAMIDARBFALABEhAFA.dHAFJFAHAGGD.eAEChAAA.ZDFC.TGGA.PFCBCAFA.BFFBhABA...cCDBhADA..,2,-21,-16,5
beITaWAKDJEMSGRdQLXHCOfNBcFVgUZPY,JEACSHBGGGAH.QBFAHDEC.CFBD.fABHBCDFFHFAUEDDhAAAZBAE..bFGHeBBDhABAaDDG.AGGGDEAD.EACEhAEAdBGHODHFNDIE........hAFA......hAGA...,1,-5,-21,16
PMLaRFAEcCQGWIgZKYDeTOHdNVbJBUfXS,CFEDQFGHGACG...IGCCKAEBDDFAOHCEdBDH..bDEGhAAABBHCUBAF.SCFAhABALEADaGHDFGAHAAEChACAEBAB...gFFH...hADA......hAGA...,2,-35,-23,12
WQLFZRXCIcNGABgTdDMOVEPbHUaJefYKS,TGGGMBHH..EECEHBAHUEGFaDFD.eFDDKADA..QGDGhAAAFCDAXBGECFAE.IADChAAANDAF.AABCdAFBDAIFOBBChABA.bGAC.....fHGHhACA.SEEBhADA,2,-25,-16,9
FIRGZBDVSJAWabPCOfHYMecUXgKdQNLET,aHBGCFDGHAFA..MDFCeFFHUEFBKADBdFAELDDH..FEEGIAHEhAAARCBABCAFDCIDJDBF.hABAAHDD.....PADAhACA.OGEEfABFXBCC.hAAANEIE.EHGA....hABA...,1,-14,-34,20
ULKOIZQNXFagAEfBVPTJGWeHcMbYSdDCR,BFEDTFDHJFHD..GCBHHCEA.MAFASFBCCBEGLHFGKCCHZGCAhAAAQAAC.hABA.FBBBAICAVCGHeADA.hACAbEAHDICG.OBHF.IHAC.hACA......hADA...,2,-20,-10,10
dJZeCMgNVaIREcTWYUQAbXKLOPSDFHfBG,KGFCLEEGOHECSAACHCAGBAHDJAFGZECG...CGCA.MECDhADA..VAEDIDFFhAEAEEAB.TBCFUABFADEBhAAAbFADDCIFFGHF.fHDB...hACA......hAEA...,2,-23,-16,7
WTAgHaVYbRECNGKOcDSMFUdXJLfIQPZeB,HDAGaCFC.VEECRFBB..CBHBGDDGOHEASBFDUBBA.JGAEhAAAIHGFZAGF.eFHBhAAABABCAEIB....hADAgAEEEBCANEIEDIAC.MCAD....hABA......hACA...,1,-10,-25,15
XEgTJceNVUaKSHbWBfMDYGFIPARCQZdLO,CADCdDAFLCCHEHGA..JFCFeAHH.UEFGSACHHBAFBHFEhAAAMDEBDBFFGBFAFGAEABAF.hABARFFAZFAH..OEDDhACAgAAC.NAIE.KAGD.....hAAA......hAEA...,2,-21,-17,4
ZeTUQWJMDHCgKAfcSOLbaEIRYVFXdNBPG,SHBGOEEGLEBDEACG.RAAC.FAFFdGFFBHEDZAFD.UEEHQADChAAAMAAF.DIDCCAHEAGIB.hABA.fCCEhAFA.aAHDYDCD.NEAE.....hABA......hAEA...,2,-40,-11,29
WFMRgaIAbdDTULSecJBVKGCHZfYENXQPO,dHFHTECEUBDA.LFCHeCGDBABCGFEBCHDCHFEEZBAD..ECGDQBDDhAAA.OCHFhADAMAAAaFACIFAFhAEAADCHDBIHSHAC.....hAFA......hAGA...,1,-16,-22,6
VeNbICfLPOaMZHWDgQAJEcFSdUTXGKBYR,EDCDFAFBdEGBUAFAGCACBEEA.RFGB...eHDC..bABFCFGHLFBHhAAAODDA.ZBAAHGCChAAADDGHADADSAHDhAEA.TECC..XBDB.KDHBhABA......hACA...,2,-33,-3,30
QBXgJTRYbdPMcDUKVGaCZfAEOWFNLIHSe,OCCHFHBGLABCHAECSHDCBEHA.JEFFTCBA.RBEDdGGChAAAMCHBDGFBUABFKAHH.hAFAaDDF.CDFEZFAEACGCEDGFIEAFhAAA..QEDC..hAGA......hAHA...,1,-12,-26,14
dJIAGNZMKYbHQURTPfWSODeVBXECgLFac,GEDHZFACKBEDHFGBRFAD..TGGE..WCCHDAIDBCGC.hAAAEAFACHED.FBAG.aHDAdEFEhABA.JABEAEDG.MBFGbCCG.hAAA..PHAC..SADBhABA......hACA...,1,-22,-27,5
EbcZLHWIGRXYDPOegQSBfTMFUNJdKCVAa,aAFBEHBGZDBDLBGFHGFAGEDGRABA.DAIDeEDG.SAHBhAAABCAFMCCCFHDCJAACCHHEACDH.hADA.bAFH..cEAChABAIAEF.PDHD.....hACA......hAEA...,2,-29,-3,26
BNQcTZUXdESAKMCgYeODbIPJaLVfRFWHG,CBGEeGEADIBG...IECB..aECFLFAFRACGFGAB.HCAEhAAABEEENEIC...QGGDhAAATGBF.ZCAFXAEDhABAEHDG.KDGCMDCGgEEFOCHD.hABAPBBA...hACA...,2,-35,-2,33
KcGOgedNRJUZCaQHXAEIWVMLTDFSYbPfB,EHBGVAADLFAD.FACDSFBA..bCFABBFHKGGFGAEFhAAAeDCANHBDJADGZECHaCAHhABAHFECAGFB..IEFFhACAMEIHDIAE.PAHDOCDF....hAEA......hAFA...,1,-7,-17,10
EcVDNRbUFdPMKgGSBZWaOfXYILJeACQHT,CFFCHCDB.ECHHDBFHRCAAFAGAdAGCKDHF..SFBEBDAEZGEE.aGFH.hAAA.OCBA..hABAXAAGLEAAAGHCTAEHhABA.cGCE.....hACA......hADA...,2,-53,-12,41
LOHCQMaeNDUEWfJFBZTRYSKdbPGAgcVXI,VAADXDAC.LDCBHAFGMEAC.aEDDeGCA.DAACUFGGhAAAEEEEJHFGFDFEBFAE.hADAZADFRACCSBHDhAFAKFFDdGAD...........hACA......hAFA...,1,-13,-22,9
bHeSKafECIcXFAJTRDLOgGQPYdZNMWVBU,TAEGDAGDOHBE.GBAAQCBB.dFFFZCECMGAGBHACbDEGhAAAeFFF.KACF.aEEBhAAACHBFIACA.hABAXGGCAFCELCHBYAHH.WEAGhABA......hAEA...,1,-22,-25,3
BbaICYFAdLKecHXgGMEZPRVSWfNUOTJDQ,dEEDKGDBHDDGGFBHZDGDRBFA...VACDSADA..NABCUAGFhAAATCBA.QGGEhAAA.aAGG.CABEAEIBhADALFBBXEAGEGFBfHDF.hACA.DEAB.BHHG.hAEA...,1,-14,-16,2
VYWHAZeGdDOXNLgURfTbSKJIPaEBFCQcM,ZFBHGAEGDDFD.OGFCLAFCRAGB..TBBGKDGC..JBBHIDAHhAAA..PADBhAAABGAECBAF.MIAEVFGFhABAHEBG.AGEH.eEDDNIEBfFGBSEADhACA......hAEA...,2,-34,-5,29
CAEDIcUZFbXRMTNaQLJSVHBegOWKYdPGf,EHFGDACBUEBEFCEF..RFBB.MDHD..aBAHLAAF.JBFEHEGFhAAA.BHABOHAAhADAYBCFdEECGGEFhAEAABBHZAEA..XGDBNDCF.SEEAhABA......hACA...,1,-22,-24,2
SfLRHZBTdUKgDPeEbXYaOVIJGNCcAWMQF,QFDBFAFBLGCAZACEBGGAUAGHKAAFDIEG..EDAE..bEADaEFFhABA....IFHGhAAANICD.AABFSCEDhACAHCFGgBCBXCGDOEBE..hACA......hADA...,1,-24,-27,3
JFXDNHYUTGOZVdeIfECcKSWRabgLAMPBQ,MBFHQGGGFDCD.DAFEHAACUFCEOEFCZABC.dGBDeDAD.ECGChAAACAHFSHGAhAAA.aGGGgDEEhACAAGADBCGHXDAB.NAEE......hADA......hAEA...,1,-15,-29,14
JPQKgTIGADbRBELVXHUYNFCOafSecdZWM,RFDGLCAFHDAEUAACFGDCCCCE..aCDA..SHEAdCGC.MBAEhAAAPGAE...hABAKHGCIAHGDIAGEEHH.hADA.....YAFEfGAG.hAEAZCED.WGFE..hACA...,1,-15,-46,31
MbdHOXWPaTUGQBJDCAVKZFLSeIRfgYENc,KDAFZDEDSBCGeCDARDFC.....fHBHEBDCMACFdFHGhAAAOEHB...WAEEhAAATAGGGCACQGDChABABDDFCBACAGGDFFAD.......hABA......hACA...,1,-19,-32,13
cbPGdZeNUJWYRgTFLaHKOBCfQVESMAXDI,XAFBDACB..bEFHGGDF.ZCDAUDACJAAC.RFDH.FFFAaFBEKFCChADABAAC..fEAAhAEAQAGDSAHHhBAAIDEEdAEAeHBG....NCHE..hBEA......hBFA...,1,-20,-26,6
TLCdAKQNGeZfSPMIHgFYcaDbXVEWUROBJ,QGBCeFEFZBBC.SAHDMFHDHBFHFABHaEACDADE..XGAAhAAAVFDG..UBEFhAAABDAETDBFCACHADFDNBIA.fGHAhACA........hAGA......hAIA...,2,-23,-20,3
RcabVPFfJTdLIDMZKEGNASeOBCQXgUWHY,eFFBOFCAQCFFUCBBHADHRACD..aEDBVGFA..FAAFJHBCTAFFhACALAGB.MAADhABAKEBFEFHB.AHAE..hACA............hADA......hAFA.CBBBXDGAYFEF,2,-14,-11,3
gRCHPNfEDacVUYFITLBMAdWXeOZSbKGQJ,XGBCZFBGSGHDKDEB.GACG.QAGDJEDHCBFDHCAG.hAAA.PCBBEGGGDFABaHCEhABA.UCFFFABETCGAhAAAMEAFAFFD.eAEE........hABA......hAHA...,2,-25,-5,20
EYPMHXBWSTfJLOARCIDdKFeZaNUGbcVgQ,CFDDDGHHdAHEFFEFZDDA..UBGFGABA....VFAEQADEhAAA.EGGAMBBHBAGDhABASCCGJDABAEHCKCFA.hADAeAED...aDFENIDF......hAAA......hABA...,1,-19,-45,26
CYHfXIDLBTZAcOSQEeRbGaFMKgUWVPdNJ,SDCDQGGDeBAFREEHGBCBFBFEKDDAUGAH....PFBHhAAAdCAANABD...JDFCCDHG.hAAA...fGGBhAGADABGBDCFAAFCEGDB.MIFAWFFE..HAFChAIA......hBAA...,1,-6,-31,25
dPMHUcZaTDQCANBfYRgFIGWbeXJVSKOLE,BFDGRAADFEFG.GGEF.eBHDVACEKCACLDHBdDCDHGAEZGDGDAEBAGAE.hAAA....fFGDhAAA..IBHDhACA.WDDDbBFDSBBEhABAEHAA.MAFGcBED.hACA...,1,-21,-30,9
FfMYDLOQVbJXBEGNHSZCeRPAgdIaUWKTc,dHBHUGBCKAHHFBCB..MAADDDEBLGFC..QBEChABA.bCCHJAFAXFGHhACABAACEDFBGEEAhADASDHFCBBH.eCABAGBAIDBA.aAEAhAHAcAEH...hBBA...,1,-19,-41,22
QAGCYXcUJLIRfWTPbKDSOHVNeEagZMdBF,GGDHXGGGJCAALDHH..IFCHRGAE..TAFEhAAAKGAGOFFAHABBNAECaAEChAAAMFCEBABCAGDACFACUAGEhADA..fGEA.WDAADEDG..hABA......hADA...,2,-32,-16,16
ZQVMPKedILbFTDSgEBYUHROJaNcGWfCXA,QBBHVFAC.KEFGeFFHLGCCFADADFEDEDECBAAFHAFCRBBG.aDAEhAAAGAFE.CHHH.AACEMFAEhABA..IAHFhACATGGC...SDBGYHDA..hBBA......hBDA...,1,-4,-31,27
DFEdKZXIVGCSPcQbRgYAHTUeMOWNLaJfB,TDCBeAEHOEFA.LGFGJBDEDGDEdABHKEAAZAAF..XFFFhAAAIACFGAGEhACASHAGQEAGhAEAbGBE.gGAAAGGA.MIDAaAGEBDCHhAEAEFHH.CCGC.....hAGA...,1,-4,-20,16
FRENfHQXdADCUGZWVeJBcOTgLMYabSIKP,DEFAUCCHGBBGZEFG.eBFCJDFE.BHGG..OFBGLGFE.hAAAMAABaGHD..SBGGhABAKAEEPHAGFAEFECGAhABA.HEDEdGAAACAC.CDAB.......hACA......hADA...,1,-11,-35,24
VeJNcGMIKQTWHbYLEZRfAgCPBSXUaODdF,CFDGSEGDUBDH.OEBFFFAF..eDEDJFDDGADC.MAABhABAKGHDQAAChACAHAFDbFED.EDAC.ZCGFAHAABHHEhACADAIB.dBBENADF........hADA......hAFA...,2,-30,-10,20
fXCIBFHgKdaUQecMGRNYJAZSbPOTEWLDV,ZDAGSHBGOFFB.EACGDBHB....XDDBBFDFFABDKBGEaFBBhAAAUBAB.QEAGhAAA.eDHDMDIFhABAGGCFYCGFAGCEPDFDLADECECE.IHGHhAHA.gCDBhAIA,2,-31,-16,15
CRXGZUQOLTdcYaPgSIVfBKEHDJNbAFWMe,FGFHeCHDCGBH.RFFEGBBDZCEH.UGCGQBAHLBAFdDHE..aBGBhAAASAGD.hABA.fFAAhACAKABCDFBCNIAF.WAFE.OEDG..YBDFhAAA.IAEEhAHABHFA...,2,-39,-4,35
MLDRWeJSFUAKbZECXYgfGaVIPHTOcdBNQ,KCFCZDAGEAACCEEG.....XFCB..gGAGhAAAaEHBVBFEHFEBTDBDdHABBHHHhABAMADADFGGeCBCSGEChACAAGID.YAEC.GABFhAIA.IDHA.hAAA...,2,-29,-11,18
PRcODHZaXLbMEYAGfIQdeJSBKVgTUFWCN,GAFEQCBCeBAFJACGKDCC...TEBBFEDFCFBD..RDGBDCAHaBHFLHDGhAAA.EBDChABAAGGFIHAEBFGE.hACAUAGCWEHH.PEEF..cGDEhAAA......hABA...,1,-5,-40,35
EbOBTgMFCGRKLQWXcPZHUIVAJdDeSaNfY,DFDCeEGH..aBAA..fACAEHGABCGH.MAGHCFGD.KAEDQEABhAAAXFDAPAAFhAAAHADDUGCE.AEHHSAHBhABANAIEOFCHFDDD.LFAFWDAE..hACA......hAFA...,2,-24,-14,10
VYgIaELJAGUQCDOBFWZbNPMeKTcSHXdRf,UCBHQFCACFEG.OABHFAEBZFFF....NEIE.eCGBKAFCSCEDhAAAdGBC.RBFA.hACAfHCBVFFFIDCDhADAEAAFAADF.BEAE..PFHD.MAIFhAAA.....hAEA...,2,-28,-22,6
ZCgVbKUHBGIaQNOPLTfeFEAdWYDSMcXRJ,dHBHDACBMFIDRBAHZGFE...CFCB...VCDCUEAEHACEBHEBGCGChAAA.QFADhABAODEGLBDDeAFGAEAF.SAFGhAAA.XFFF...hACA......hAEA...,1,-4,-44,40
NDKFCBYVRLTcZbOUeIdQWXEgGAafSHPJM,aAFBSCFCHCAEMGCCDECD..KAGEBFHERCCB.LBGBZFGF.OHAEhAAAIGDAQACGhABAEHEAGAACACEBfGGEhAEA..PCHD.FADCCEEA.YFAFhAAA...hAHA...,2,-19,-15,4
GLZcfgVXQCbYDUWHIBNFdaJETKPOReMSA,GGDHLFBBZEDC..fGDAVCGDCHBG.DEFBHBDHBBHFFFAAaDBGhAAAEAAC..KCEGOAEGhAAA.....hABA.MHFAAHIBXCBCQACB.YAFEhADA....hBAA...,1,-9,-40,31
CbKfAZIcGXJUdFMOYWgESePDVNRBaHLTQ,ZAADGAFEUCDHFEDD.OFGB..gGACSEAGeFGFhAAADCCC...RAFEaACELBHHhAAA.CADBKHDGAECFXGDGhADAdDDFMBACEEFA.......hABA......hACA...,1,-21,-26,5
bOELSAXHMRgFWPNGJZaVfCKDeYUcBTdQI,XFCARFBGFCBC......NEAGZGFAaAGFCAAA.DICEUDFABGGAdAAFhADAQBEC.hAEA.IHBHODAESGBGhAAAAIGAMCEG.WHFA...PDFFhACA....hADA...,2,-41,-36,5
SUQgbTfKXEFGIARLDMWOacZCJYdPNVHeB,LAGHMCHF.aGFFCABFdHGB...VDEHeABD.SDDAhAAAUCBD.bEGFTEBAhAAAKAFDFBDDACIDDAFDODAHZGBC.hADAPGCCBFHAfAGCEDBB...hACA......hADA...,1,-13,-25,12
eOAUfBGRIHFLPCbEaTYMVDcQZJWKgSdNX,BHHGGEDHHBDDLABACEGF.EBFEaDFBTDAAMIBG...DIBCZGCAhAAAKGGGSEABhABAdCDDXDGEeABFAGAHfGDEhAAAFAGBPCCB.........hADA......hAEA...,2,-20,-12,8
XKSeafFHUCbcIPWgGBOQNMEJTZAdYRLVD,dCFCRFDFDHACSACF..eDBCaDDFFHACCAGC....ICFChAAAgDBBBCABOFFFhAAAQABEMGACEDHFhABAZBGBAIHGLAEAKFHF.fFHAhAFAbEAE.WHCE...hABA...,1,-6,-35,29
GeIdMaHVEPTfWgDZcJBNQSRLYAUCFObKX,UGAFOCAFKCACGGCH.eDEGdGDAaEDGHAFE.EECD..TADChAAAfFGG.DAEHhAAAZCDCBHAH.SACBhABALDHDADABCEEG.FBGEXFACMIFA..hAFA......hAHA...,2,-29,-9,20
GJLCAHFXSagRPcMKOUEVNDdYIWTQBfZeb,XCCBSAFBRAFC.MCDH..KGFHUAAFEABA.DEEGdEAH..IDBGhABAQFDFBHEBhADAeHCGJFGH.AHHB.aHBCcGABhAAA..NAHETADFfBAE..hABAbFCC.....hAEA.CEEC..,2,-23,-21,2
WQaVOdAYfbUReTELJBGHMZPKcDXFgNISC,...fCFCUBBHRGEGEECCBGEGHCEEMBCEKGAA.DFABFAEB..IBHGhAAASDADCGHGQGBHhABAaHBE.dCCGhACAAFIB.eDABTEFALFFH....hADA......hAEA...,2,-21,-21,0
RbBMNXLIKWPGDAeCcYZVgEUQJaTfSOHdF,eAFBCFDGZAFA.EFGHUGFH..QABD.TDAAOCECFHBChAAABCCBXFDCLAAFhACAKDEA.GEACDAHDAFFGYFHBhABAJEFEaHCCSECC...hADA......hAEA...,1,-14,-28,14
QaMPGSDJCAXgTHOfKbcWdVBUYNFZILReE,XCGCHEFHOACDKAAD.....WGBEBCCG.UEBCFDHFZAFGhAAALHCGEBAC.aEFEMAEChABASAFFDBEFCHCDAFDC.hACATAGF.fEDHcCFB.dGGG.hBAANEAE..IBDAhABA...,2,-32,-14,18
LOdVMPBbUWFYNXJDSHZaRQgKceCIETfGA,dAABVFACBGFB.UDABFCDG....XGDDJEHHHFCBZDFFRBFC.KBBBhAAA..CHAG.EDAE.GAEFhABALBDD.MIEEhADAPDHD.YEEH...DIAGhACASFEC.hADA...,2,-32,-17,15
aUVbfEJcHgQPSRedXGOAYZLFTBCKWNDIM,ZFDFFAADCDGGKEBC.DIGA..MIDGUCGD....VADFECAGHABAhAAAQDDBRFAG.dFGDXFFHhABAAGCCLAHFBEEBhADA..IGACaAEF.fCBAhAAA......hACA...,1,-22,-35,13
LMSTbfJWePCUYVXNDEAZFKGQIadORcBHg,ZFEEGACBaBEB.OGAARBAE.BBAELGAESEFG..TDAGhAAAJBHD.eCFEUGEHhAAAVDEEXDCHDAIFAAFCFHAEhABAIHHH.dDAA...gCEChABAMIEA.WHAACGHA.hACA...,2,-11,-11,0
KeXgWLSZbOCDVYIJEUGNfARdFcHPaMTQB,RFEEdAFBHCEAMEDAQCBCBFCF.KAACeBBH..XAGAhADALGFE.ZGBEOACEhAFADIDEIADDEGAANEICAAGC.FCEChAAAaHCG...TECHSBGGCHFD..hABA......hACA...,1,6,-33,39
GVQJBEbODWecSUaMLTAIFgNCXHKYfdRZP,FHBGCFDGKCCBdHEB.ZBDBGBEH..VEFABGHH.OHAGeBFHUBBHhAAALEFH.AADA.IEAFhABA..XABChAAA.fAEFPAHFEFCA.DGADhACASEHFMADE.hAHA...,1,-20,-40,20
PWUHGDacANdBRLgbXKOVZEQYSTIfeJFMC,BFEDRFDFLBHD..gCDHKCBEOFAEEFBH..QAEEhAAATAFG.eBADMABChAAACHHBUDDFHDGFaGGC.hABAABBGNIBH...........hACA......hADA...,1,-21,-24,3
MfQXALcYgPeTNDFUHadZJIWKGbVEOSRBC,LGEA..cDCHPCAF.eDDFTCGA..DGAHUAEHhAAAdCGBZACAIFAChABAKEFB.GGEHEAFESDHDhAAACACCMICGfFCGAABFNECE.aBBE.JEEAhAFA......hAHA...,1,-16,-17,1
HEJNOWVTRaBIUcfZSFbLQMeGAPDgCXKdY,DACBXGGGKFDCHDEC..JEEHOGAA..VDAEaAHFBHFFhAAAUGAAZDFA.FBAALHBGhABAeADC.AGGECDHEdAHENBBC.hADA...RADF.IHDC..SAFHhAFAMAAE...hBFA...,1,-19,-23,4
KRYObZQdacDfLPSIAWCMHUGFNETgVJBXe,CBFDMEIBHDGFUFFHFCBA...EFAB..VGEEJACB.BABG.eEAFhAAARCFCODDBZADF.dBACDEEEhACALAEA.SHEAhAAAAIDANAIE.XGCGKHAG...hAFA......hAGA...,2,-25,-17,8
bPGCDHOfSAeKMQXVJEUINYLFcZWBadTRg,MEGFXCCB..JAAFEFDAUAGA..IFAHLFCBZAEHBEEGhABAdAACRGFA..PEABhACAGGAF.DBIDOADChADASDFAKCDE..NEHE.cDBC..hACA......hADA...,2,-30,-20,10
dHBcYNTMZXbJWRELaGDAQeIfCFSPOgUKV,QDACeGEACDDG.FCFGOGBGUGBGKEGDdAACBBDA....hACANDECZAAEbCBD..RAGFLFFChADADGIDABHG.fAEDhAGASCCB........hAAA......hABA...,2,-40,-20,20
ageBJNHDdOWXSFUcbTAMZRCKGELPVIYfQ,RFBGCFFCGCDDEAGG.LFAF..PHFAVGCA...IDEChAAAQCAC.eABAhAAABHEG.JCBEDFIHOADEhABASGGH.FBGEcEAGAECD.MGFChACA.....hABA...,2,-29,-20,9
RBaZTeGYNQEJfLbFdSXCVWDcAMKOIHgPU,OECCHAADUAEARAEAZAACeDFD.GDADQGCHJCHD.LEADhABAFGDAdHGB.CGGHDGFBAACEKGBD.hACA.PCGFBAHD.TCDEhADA...NAIE.fCCB.hAEA......hAFA...,1,-13,-17,4
GCaAOIJgVebMFXZPSYUdELNTKDQWcBfHR,OEEGJGEA..eCBHFGGEZGCE..SFBHdCBELACAKABGDGDDhAAAQBGGBBAGHDEChABACAHBADAH...IAHDhADA...bADD.MFIBYDDFhAAAEAFF......hABA...,2,-37,-21,16
FCLJEBHaVbUfKZYIGPNAgRXScWQTMODed,XFDHSHBG.QAGEMFAE.DFEGFDDCLACGECAGBBGBhAAAHBAAaAEF.UEAFKGADZDGHhABAIGDD.PFHFhAAAAHHFRABE...cDDGOFFFCHEA...hABA......hADA...,2,-17,-15,2
PBAdQbYIFcSCGgLTNEVZHOWRKMfDXJUea,QGBC..bFEEFEECCEFGGBAELBFEEHEAZDGBHACCRABEMAAHhABAXFCD.UAGHhAAAaGHDAGEBIDDEhABASCCGTCGAOEACWFADDAGE....hADA......hAEA...,2,-15,4,19
YJfXeIOQRgdTCPAVUWFENDcMGZKLbSHBa,UFDHFAFBEEDHDIGE.GDADLCDA.HAACaBBB.JFHH..XBGFhAAAeBHDOEAD.hABAQGEBdADCTFAChACA.AIDA.WHAAMAFD.KEFCSECFhAAA..fGGBhAGA..,1,-17,-18,1
YgIVFATSHKMRceEbWPadNGZCUDfBJXLOQ,HBCFMFCFRBAEeAHF.EFGA....PHFEdCFCNABGZFADDDECBFEGhAAALHEA..OEADhABAYAEEVAECAACGSCHHhAAAKEEC..WDHFCGDC....hACA......hADA...,1,-1,-37,36
LEKPXRdeDTHQVZOBGbWgUFSJfAICNacYM,CFDGaHBG..MDBBLBGHKCCB.RDAHDBCGHCFC.ZADABHHEGEFC.hAAA.bFFHUAAC.FHBAhAEAfDDAAFHC.hAFANACB.EAHBdCDB.QGDCWCEF...hAGA......hAIA...,2,-18,-16,2
JdcFTHNMQZEYbUDWVBKgeLPGSIXaROAfC,CAFBdDCDFHGEHAEA.MCBAEHEA.UGDA.DGADVDAH..BGFAeABDhAAALDHFGDDBSGDFhACAaDFFABBG.JAHFhADANAAE.....YADBKGCD...hABA......hACA...,1,-18,-28,10
CBUbcdIDgTZVXGLfQAYPFHaKRENWeSJOM,FHBGHFEERECC.ECGC.eFDDSBGE..JDCECCGABBBDUBABdGAEhAAADDDE.ZAFEGEGE.hABALAAEAAEFaFAAKGHBOEAHhAEAMEFE...IGEE...hACA......hADA...,2,-31,-10,21
NDIHQaJOKPeLfYUdCTVAcZSFGWEgMRbBX,ZDAGGACBEBCA.MHECBCHADGDGHGDC.JAGBKDHB.LBAFUEGDdAAChACACAHCACDF..FFBGRGAA..hADAXDFF..hAAANIAFaGACeCCD..fFDF..hAEA......hAFA...,1,-20,-23,3
BcUXIFYOGdSbQTNVPRKMEJgDAeaWZLCfH,aDCDZFDFCHFBBBGC..UCFGFDGFGCAGdACG..QEAGhAAA..NHABVEEFKCHHJADEhABAADIDLACAHFGD.hAHAIAAASHBE......hAIA......hBAA...,2,-29,-26,3
VgAUaMSBTJOdCFHPIKGbeNfLYXZQEDRWc,aBDHBBGE.JDGHCGFAHGBE..KECAeCAHLEADZEFCEEBF.DGDARBCC.hAAA....cAGChAAAAGCASFHH.hABAOACGPDFAIHDENIEFfADB.hABA.XEEH.hACA...,1,-19,-43,24
XUAbNPQRYGZdTDMaBHVeWcFgLCSOEKIJf,...PECCREFHZBDEdBBADAHH.BDHGHGEAeHAAFCAELGAA.hAAASAEDKDEDIFBBhABAXEGHAAFC..hAAANCAG.YBFB.MCIBaAHF....hABA......hACA...,2,-36,-20,16
SDdRNgHLbMaAYcPOQZEeIWBfVFGJCXTKU,...PGEAQAEGZDCB.IGGFBFAFFHCGGGAB.JCDFhAAATCFGSABAhABAdBABRADE.NAIELFHBhACAMEIHAAAAOEECeDFHfEBAXCADKAHF..hACA......hADA...,1,-1,-19,18
cPYfFWVdZHBITJXEADeaOMKLgCGSRNUbQ,aEGCKFAGCFDFGABG.RBFE.UADA...QGEFPFEBFFAAdCBEhAAABGGA..IBHDhABAXGAC.DDEGOCFDhACA.MEIHSADBNDHA..YHAEhAGAWAAD...hABA...,2,-35,-29,6
aJZHPdYGLBNfIVEOCWDQeKXcUMgTbSFRA,aDBDJDACZBGBHFGD.dCBFLGFEBFEF....NAAF.VFBC.CCCE.hAAADCGE.KGAE.XGEDhAFAMEAH....hAGA.TDFGSEFGAAIDYBEDIBFHhABAOFDH....hAHA...,1,-26,-38,12
cIgbHOKDRQMUedAGJCaEPBVfZNFTYXSWL,CDHBaAFBBAAFZDGF..FGCC..TDEE..XCDCLAEA.hAAAIHGGHECCDBGARBCEUGDGhACAdABEABEFJDAF.EGFBhADAfFAA.SBBF.hAEA......hAHA...,2,-30,-24,6
FfCVDaHSZAGJMXKLbBRIQUeOYgdTNPcEW,JBFAXAGDLEGDRCCG..UGADeHAG.OCEHdBAF..PEHBhAAAEGDAFDBC..CADFDFBGhABASDGEZFEB.AFAFKADFhAAAIBEH..gBAC.hACANAEFfFHEhABAaGDB.MIFE.,1,-13,-20,7
DBYUCFQZPNELeSJfgITGVaAXWbMdKRHOc,XCBCMCCAREAE.HFDFDAAEBEGBUGAHCHGBZADA....EDFESFEChAEAJADC..fBBDhAAAIDEGTGAChAFAaEEFAABE..WCEEdHGHKGDD...cCBChAGA....hAHA...,1,-20,-35,15
LcaeSYJBFNARdGZPTCDgEbWOIMfVHUXKQ,dBBDGEDHZGAGCBFBEDAE.OHCE..IDEGVCFE..HFAChAAAUEGGXCCEKFAGLAEChAAAaGHDSBFChABABFFCACIH....RDAEDBADWACC.fGGAhAGAeHDC....hAHA...,2,-28,-7,21
IKNMTJcPFbBaDGUAdOYWLSfHCgeRXEZVQ,OCCHLGEAHAECCAEDRFAD.EDGEZDEC..QEDEKCBB.TGFGhAAAJAAGFCFABACD.aBABhABADAFEAEAHdAHA.YEABhADASECH........hAAA......hAIA...,1,-1,-45,44
fXPEVdHgLKeacISMBFDGbQNOTRCYJUZWA,XCBCECFCHCBAKFEG..aADCSGAABBHEDGEAGCGCQADBhAAAOECBCGHAJDHBUDEChAAAABAD....fEAEhABAdBABeFAFMAEGNIAB......hABA......hACA...,2,-19,-14,5
YMZPcVBAaEgfebKFLHdQGTWOISRCUDJNX,aAFBEHBG..eDBCKDBAHFFAdEGCGADD.OHFGRABECBHGUDFD.DIFEhAAAJECG...NBAGMCBAhAAAPHAA..BHDBhABAAEED.fCGFLDAD......hACA......hADA...,2,-26,-17,9
JeKDVcZNIXfgSWEUHdQBGRMOPYbACaTLF,CFCFaGDDFFFA..eAFEDIAC.ZDFG...IBDAXADA..SHGEhAAAUAGBHBACdDAFhABABHHGMGFGODEAhAAAPDDBADAB.LFBFKEAB.cBED.fCGHhACA..hADA...,2,-39,-19,20
GXRJKIPWUTLZNbEQSBAcfHgDVFOYMCdea,HAADVFDG.FEED.MEDFCAHD..dBDEeEBDGEAAJCEC.KBAC..IAHGhAAAUCAFLCHHhAAAZACBEGFCBHHG.AIFE.hACAfDFG.......hAFA.DEIHaAFF...hAGA...,1,-19,-24,5
EFRaPedNQMXVWJHgYZUOCGcILADKbBfTS,DGHHBFED.SDFDRCECeDAE.dDBFQGEDMIBE..XAEGhAAAJEBFHACDZDGFCAFEGEEFhAAALBAEABAHKBHHTFAEhABAFHAC...PAHD.....hABA......hACA...,1,-13,-18,5
bBfUcaXedKPHTIDQGYSWNMERCJVFLOAgZ,ZAADBFDGUGACaAGE.dDGDHAEF.DAABGECD.SAFHhAAAMHECCFGH.FCDBADAC..fEAEhABAXFGEeHDGhADATCGA..IAHEQCCC.NIEBEEEChACA.JHAA....hADA...,1,-16,-24,8
JQAZWNUcVdBIaOHRMDfPYKgTEGFeCSbXL,ZAADUCBCdEFBBHGEOHBGRFBA..DIAE....fBFChAAAKEFC.ECCGFAHD.CABF..hADA.XAGBJADA.hAAAAIGCcECC.aGFAMEIH..YACGhBAA....hBIA...,1,-31,-57,26
fACOcPIBaKVURgDGESXHJLWbQZYTMdNFe,CAFBOGEA..IHFDKGBHRBDAGBGC..SGDBhAAAJABDLEBAQDBChABA.TADFMAEGNAAEfBGChACAAHHD.PFFE.BHAC.hABAaDDF.....hADA...,1,-25,-32,7
ZOeUbaYLKGEdSWRfVCgQHBMXNPIFcJADT,DEFAZADGUFAH..bFFHLDGF.KEEDEHBEdABASAEHhAAA.REAACABFHDAAXDDBhADANIDHFDHD..ABIBeCDChAAAaDHD....YAGF.fAHEhAEA...hADA...,1,-21,-24,3
cEYFfIUDVJMWeXNACLZdbHPSRaTKBGQOg,CEFALDCHdADGHGBARFFHKEAGBCFCGCEH..ODDBEBAH.FAFAIAEChAAADBAG.MICGhABAXGGEACHE.ZCAFSEHBhACA.aGAC......hADA......hAGA...,2,-38,-21,17
VeUWfBYcDAdJCGabQLIKTOEHgXRNMFPZS,CDGFaGAHLBBH.KEEDOCBF.HFBCRFBDFGGDSBFDhAAA.VGEAeAFFfEEDhABABADHDIDEdAHE.hACA.bADBICAFEBHBNEIE.MAAE...hAGA......hAHA...,2,-36,-11,25
SKUXVdYbCTIOfaBeLADMQJENWFPZRcHgG,QGEDEDCD.FABDRBFGHFEAGDDBSEADKEAGUGBEdDHECAACODHFhACA.BHBCAHHAJADDhAAA..NADFZBBE..hAIAgAGE..YDDC.hABA......hADA...,2,-24,-15,9
YfDeGdCPOKaBHXMTRbFVAcZNLJUWEISQg,ZAADLEEGUCDH.EBAAQAFB..YCEGDDIDdHCHOECEhAAAaADBBAGC.MBIFhAAATGGGFECB..AHGENIABIDGFhADA.SCBHgGED.fFAAhABACGAC..hACA...,1,-23,-31,8
IfaBMOHEdSPCDgXVFbAKRGeTNcZJULQWY,KGFHRFBHeEGB..TEBBZAAFUADALAEF.QEGAhAAAIHDA.BHBAHBGHdBGGCDDBDIGGhACAXBAGFFEFAAHA.NEEE.hABA.....WAHB.....hAGA......hBAA...,1,-20,-25,5
RWZGbTHMALKXYBUCeJPSNQFcDOVgdafIE,KAADBHHGeEDDSAGBFCBF.DEBGOBFEdEHA...aEFBEGBHRFBD.hABAZBBE.GDDG.hACATCFCHADDMAFEhADALAAAUGGACGFCNCAA........hABA......hACA...,1,-16,-21,5
SKHJbLQRDTecFYGMXWgUEOPIBdCZANVaf,VDAGaAFB..KEBGHGFELAACQGBBDEFG.eCGDFGDEMAHDhAEAXDDD.UACGECDBOFFAhAIAIBACCGBGAHHDfAFHhAAA.JAHB......hABA......hAFA...,1,-5,-36,31
CXRLONZIKJBEVHgaFTYUeAQbDSMcPGdfW,QAFBDGHHMEAGGEEAdFGHCABD..LHFEZACEKHAABCDGEFDEHDBAhAAAFDHD.UACE.AHDFSGAEhAGA.PBHDhAIAWCGFRFCD.IBAE....hAAA......hABA...,1,-2,-39,37
gTGLdPBKVEfAWOIJYUZNHaRbcFSQXCDeM,OGEAJGEAZCAF.HDCB.RBDEFHBCSDDG..CBAHDBFGMFDA.hAAAGAEDLFHHBDGAhAAAECGHAIDG...IEAChABANABHaCDA..........hACA......hADA...,1,-29,-34,5
TDNQWYXgBKPEHJfIGFUObdVAaRZeCMcSL,RBCFZFEEMEBFLEAG.DDBCQGFH.XDFFKDGAHADGhAAAJGCEfBBDhABAGAEFOABHdAHAAEFHaGCHCEEBSHAGhAAA.NEIC.YFHBBFCC.EGAFhACA......hADA...,1,-5,-24,19
abQFgSNVGOXdRJcPfIZBCMKDeTEYAHWLU,HFDFLDACaABA.QAGAFDCA.SCFGVCFGOAECdGCFJFABhAAA..PEABhAAAfABCIFFDCBECDHGGhABA.EFGGAIAA..WBBDbFEH....NEEF..hAEA......hAGA...,2,-25,-7,18
TGYIDRJWSQKFPbLHaUNeBVMZcdfgOAXCE,XGAFCFCFGACGDIGARBAF....JACAQDGAKFFB.FEECLCHDhAAAUGBBBAGHMIDGhABAZBFGdCEE.OAFAhBAAABABEGGA.IGDE.....SDDFhBCAbAAD...hAAA...,1,-18,-29,11
fNbADHUGXQCZeaOWMLgIJEBdRPYFcKVST,DEFAUBCFQFDDZFEF..aGDHOEHDMEAB.LAEF.hAAAIFBAJBHHdCFC.PACDhAAAFFBGKEGH.SBABhABAfAFHAIHG.XBADCGHH.eAHFhABA.EGGBBHAH..hACA...,1,-8,-32,24
JEWLTYUIeFaVQAcdKDRNbOMXSHBPfGZgC,dAFBDEFERFABOGCA..XAEFSDACBFDEGBBBZGFE.JAAEhAAAEAHBLDEC.hAAATGFBIDDFeEAChAEAaCAFAICAKEFAMBAE.fGDECBGD.YFFEhABA...hAIA...,1,-13,-27,14
HdEWfRVbXCBISPgcJTZUAaDOeLMNYFGKQ,OEACMBEAFGHDKBCGHFCF..EGECRFAF...XEEGCCFBBFGFSDDEhAAA..hABAgGBDTABAADAHDCIBhADANAIAQAEAdGEA.fABChAAA.IDGA.hAEAJHFEaECALDAE,1,-10,-23,13
WgbHcTZUeNAPSCEaXKDdJfMQLGORBIFYV,CFEDaFAADBCH..dAED.MHCALBFB.OFAABBHAFABG.VEFEhAAA..gGGChAAAHBCD.TGADhABAeHAGAHIBEADHKCEA..fDDF..hACA......hADA...,2,-42,-24,18
IcNODeHJMSgRYKQZBGAWEFVfXLUdCTaPb,EAFBFCFC....VFFCXGFGLDBFdEHCCBAC..aADH..bDABhAAA..NICF.eHBAMAEGhAAARDCE.KDHBBAHE.ABCBfCFEhABATEDDIABCDBHD.SGBAhAIA....hBAA...,1,-16,-30,14
TSWKAGdPIcFXeUYaQZOfbgJLBCDHNRMVE,dGAH..PAFBIFFFFGFA.UEBF..aBDDZAFBOEAG.hAAA.fDHGhABAJACBCEEGHGAEMIDEECGCSDGAhAAAAEECGABCXADE.....hABA......hACA...,1,-18,-27,9
MTOVfARISYbcQXaWUCegLPEBKHFJNZdDG,RDAGSHBG..bBAAXDACUFDG.eBACLBFEBDEGHBFDhAAAFAAEJFAHdGFFDGGGMFIBhABA.TFBD.hAAA.OCHBAGADICCH.....hADA......hAEA...,2,-32,-8,24
TgNXCVSZDHYKURPbLfcOJFedBQAWGaMEI,aGAHMHFG..EDHFTAAD..XABCVAEF.DIGEHEAAKBGGRCCEhAAAPDHBLEBBfDBDhAAAJADAdGECADGCIEFFhACACFFE.SAGB....hADA......hAEA...,2,-20,-18,2
EdfaAUYRTgQFXSMKOHWeLbBPGJCcIZVND,REFHTCGCQECF.FDAHSAFF.OBBFeHCGLAAEhAEAbADDGEECJCCAIHGHhAAANCIE.dBAGfGAHhAFAAHBBgGCBKAGABCBDCAHA...hABA......hACA...,2,-14,-12,2
KOJHMNDZFLTSeaAdWQGIUVRbYPcBCEXgf,QGBCUAGHRBDD.....PCCGBBAEXEGHKFFEOAEChAAAJFBEMBAD.ZGEATGDEhAAAaDBDAIFG..dAHAIHHEhABA..YDFEEACC..fCAEhACADCBB.FHAChAFA...,1,-10,-38,28
GaUCJZSVFWIRdYLOKgQcPbEAeTXDHBfNM,eDCHXGCEDGEABEHB..MCGFGADEaFGDUAAFCDBFZAGHFBAAREACdBHGhABA.LBDBKGCB.hAAA.....cEFAhABAbAEBADABfHAB.NEFE.SFAFhACA...hADA...,2,-32,-14,18
fCNQLTSKOFbdVaZDBMGXYJEgUAcIeRPWH,eGEARAADHDBDCDDG.QFFHLAFA.KEEEOABEFGAFdGDCZGAGBAFHGCEBhAAA..XACEhAAAEBADAIFA.ICHFhACA..fEGFSGHHaDCHDDAFMCCEhABA......hACA...,2,-20,-6,14
cBXELIDCeTbVOQSJUPYdFNfZMgAWHRGKa,HGFGGBCHKAHBBBAAEGACLFDCCHEF.eCCETGAB.ODHHhAAAQDAEUEAFdDBBhABANBBFMIDAAEEG...aDHDhAAAIFDDDABESHAA..YFGFhACAZAFF....hADA...,1,9,-35,44
KJcVMIZaFLRYfBdbWGXUCQEAeHgDPTONS,eFBBDHCEOBGHKGGB..JBEEMCEF.ZCAFaEDHLFAG.RABABHAAhAAAdCBCGEEF.hABACHDAEAAFAEIDHFFE..hACA............hAEA......hAFA...,2,-39,-27,12
XdNRfSJAKagDCebWYBVZPGFLUETIMHQOc,KAFBaHFG.CACD...eEBB....bAAHBABDZCCD.FAGELGFChAAAUCCCIDHAMHBC.hADAHFDEOCEFdADFNAAEfHFHhAEA.AIBCDEBF.VCGF..hAFA......hAHA...,1,-22,-27,5
NCcWTDMObZJgGVSLFKBHIAUefEYaQXPRd,UDACEDCD.QBGARAABCCHB...TABGOEADZFFFJACCGFBBhAAALFHDBEHEHFDChAAAAEFAeAEC..aEEAXDCAhABANIBB.DFHFMAFE.....hADA......hAEA...,1,-13,-20,7
AMFfDPCSabJQHdUcYOLRWTgeKZGNVBXEI,MHFGFHFGDAFE..CGDH...SACGaDEDQCGGHEDCUEABhAAAOEACRBEA...TACGhAAAKCDDZDGFGCAFBBAFEHBEhABAAHBBfAGB......hABA......hACA...,2,-28,-22,6
AQJaOVLdPBKRgcZWISDEGHNXeCUfMTFYb,QGGDaGDBLDBBBGEEKAFE.RDAFZCDD..SABCDACGHGBGeCGFhAAACDEDUFGGMBAH.hAAA...FEABAGADOBCFhABAPAHD..WCCB...EGEFNAIE.XACAhBAA...hAFA...,1,-16,-19,3
VaKXJTRWZDIEAfQUNCbeHBcgGOdPFSMLY,QCGCCHHGHBBABGGCGACGdEEC.FEACMBFGLHAA..aHAChAAAKGGC.XAAFhAEAJDAHRCFDDACAAHBEUFEE..hAFANEDG............hAGA......hAHA...,1,-20,-33,13
MGgACPZHKQcSIWeTUbBYFfLRDdaOXNEVJ,ZDBHQCCBSAFCeHDAUACGBAEDFHGARFAGDGID..OFDGhAAAEBAF..MBHDABBECHDDKBGChABAICFC...hAIA.WEBDbFEEfHABLDEC.aEEANCIE.hBAA......hBEA...,2,-27,-14,13
ZGeYMNKTHWJbVfCLaXIPEBAUFSQcDgdOR,FFHBQGBCDAFE.dBEBZEBEGABCMAAA.KEDFHCCE..bFFBCBBCLBEEhAEA.XGEGhAIAIHHDBGCHhBAAAAABSGEHOCGH.YDDC.NAICJDABhABA.....hBDA...,2,-27,-8,19
QdKDLNcJMEaGUbZgWfRFPCOXTAeSHYIBV,eDCHSCFCHAFCBCEEdAAGLDGFJDGF.MECBEGHHGAAChAAAZDCF..fADChACARGCECEEHOADGAIBE..IGAAhADA.KAFEDDIDaHFA......hAIA......hBBA...,1,-15,-24,9
cdFCbRgEYKMVNaZXOHAPfUDBGQTJIWeLS,UCBCBGDHGAECQFGCJCBF...IAGCLFGB.dDGFFGCGhAAARAAE.EABEKFFD.MGAEhAAAaDFBODAH.ADIFDFCGhADAeHBG.CAHB.YHCG....hAEA......hAFA...,2,-27,-25,2
ITbRdeHMLNZaWKSOcQVBJgXADECPGYfFU,DFEACFEDGACGFDCC.UGBE..TAEGRBEFHAGDMGCCLFFB.hAAAZAABKBHF.SFHHhABAOEAB.QABEhAEABFHB.JHAEAHHC.PHEE...IDFEhAGA...hAAA...,2,-21,-20,1
TPEDdRMBUYVacKGfCeLZXgFAIOHbSWQNJ,OFBBHDAGSACD.QBGCNFCDJBEE.EGADdGGCMEEDhAAABAABVGFGKGDBCCCH..hACA.LCHHZADFgFBGhABAAGAB.WFFCDEEA......hAFA......hAGA...,2,-45,-3,42
HAQIGCWbOVgfSRZeTJMaULDENBdXcFYKP,QFGHGGDHCEGF.OCAH..gAEDSDCERDCBeDBDhAAAMAHDUFCCLAHBhABAEBFHBBDFXGAGcABGhAAAFACH...KFEBAEEC.IGAC..hABA......hAEA...,2,-25,-12,13
fWMKCbceJLPgTVEYNDQZFOUadHAGRSBXI,RCCHSFFBBFDA..XGCG..IGCHMADACBAE.bCBAhAAA.eEHDLFHBhAAA.TCFFEBFCYABEhAFADGBBFHEEaBDAADIBfEBBKAGG.cGAChAGAgEEB.NCAE.hABAOHDC.,1,-14,-17,3
OQIWRcTEYeBbAUVDNHZPXSLCGFgfJKdaM,UFCADHCEZCBE..SCGACAHAGEAB.FAFH..JFGFKBCA.MCBFhAAAQABE.RAEB.hAAAEHEABHEAAFFDHEGF.hABAPDDC.XAGBfDGEOABGhBAAIGAH...hBBA...,1,-24,-33,9
FGEKBAXCeaLDbVPMUWORZdTHQJNgYISfc,CFEEaGDBDBAA....VCAFUBFD.RDAE.dGHEHFABJEDA.....hAAA.NAIC.IHFGhAAA.SBCHhABAFGAGKCFBBABF.eHEALEHFPACFOACAhAGA......hAHA...,2,-34,-26,8
eWcGPdJQgMabRDKTVNUXLYBSOFHfZACIE,EEGDeGEAGDBEdCABQAECMIDE.RDDG.KDDE...VABANIBDLCGBhAAABBGGOAHFhAAAFEBFZGAECDGE...cABAhADAPFAB.aEFHDAGE.......hABA......hAEA...,2,-20,-6,14
CFUOefWZbgdGSBYPTaXEIHJVcDNQRKLMA,CFCFFGDDUBDHOAAF..eGFEZDCGdACFBABC....TAFChAAAXDGGHFGB.JEFBVGCChAAADCHDRFAELAHBhADA.AEEH...fCCBWEAB...hAEA......hAFA...,2,-38,-17,21
IFTRcaYeDSgAfXJQPCZHOUBKLdNVbMEWG,XDACJDAC..CEEFZAACOEGHBGABKACG.LEEDdAEF.VBGHhAAAEGDBGCGE.hABAFGFFcBBH.aBDEhACADIBAAGAC..QGBE....hAEA......hAFA...,1,-17,-46,29
JIUBFdaPRVZOfCcYMNSAQeHXKDgGEWLbT,eADGKDAFDCACEHEGLECG..TDCGUGFGdGAEaGADREFGZBFECDHC..hAAAMCBFADDG..QDGChABAHABDXGCFhAAAGABF...........hABA......hAFA...,1,-13,-27,14
GcVebRHFdQagZNKEYOBTAfJMCXLIWPUDS,MDEBXEBELCCD..IGGFUBGHDIFGSCBBhAAAGDGEeFAFRCGFdBEG.aCAHNAAAKBEBhABAOHBA.AGAFCABAPHBEhACA..........hADA......hAEA...,1,-20,-25,5
SJWOKBTIVLfeNRAFXcaZPdMEDGUHQbCYg,XGBCaCFCZEEB.dDCFDAHFGGEBHCCDCCAH..SABA.hAAAOFDAKGAFTABGhABAIAFAVEGFLCFChAAANICB.FDGFMBIFECAD.UAEB....hADA......hAFA...,1,-9,-12,3
GEdTZgWHCbMeLVNFUYSRfKQPcXIAaBJDO,JCAFDCIHGGEB.dCCGZCDHHAFHMBCDLCADFBGC.UDDERGFEKGAHhAAA...QFCGhABAPFCH..IEGChAAAAFGCBHDH.OABA......hAFA......hAHA...,2,-38,-18,20
ZRYWEcSdMKQLgUeNPIaXOBFVADCHJfTbG,DFCFCEFAHFDH..TBAHZBEBRBCD..ECHHSEADKDAG.QDDGhAAAUGGEeFAAIHEFhABAaACGBHFFAFFGfGHAhACA.YCECdAAEMHAC...hADA.NAIEOADC.hAFA...,2,-20,-14,6
IQfdeJUCGSWFAMTHNKZRVLcgObBPaEXYD,MEIBHEFHZBAELAEAOECBBEDD.aFAHXAEG.IABChAAAfEED.eBCHhAAACDEF.SHDChABAAIDETBGCKGABcGGCPFHDYCAHDAFE..hACA......hADA...,2,-30,-16,14
TgYfVQcORAWbHeBINKdaESDMPJUXLCGZF,HAADeAFBBCEDKHACaDEEDHAE...MCAGUFGHLFCBCAEHGEAFZEFBhAAAFHDG...TBGEhAAAYDAB..fCCEhACA........hADA......hAEA...,1,-22,-40,18
HSeTQbRadcDVEfBAOJNUPgWYGIKCFXZLM,OEEGJDAC.UDBG..PFFB..gGCFGBBHIFAHhAAACGGAZBEA.LFDBhABAMEAFeAAGQCFEhACAaBHFDADA.fAHEAFGD.YFBBhADA.....hACA...,2,-33,-11,22
IPOBNLFSfbeTYCKWVgMcdEADaHZQRUXJG,aEAEZBCDRDGF.UGEAGADC.OFEEBBHFFBBDSHFE.eBBFhAAATBEBKAHHVCGFhABA..MAACEHAGDDDBhACAHGAC.XEACJGBA.IEEF.hADA......hAFA...,1,-7,-25,18
CMIKXUQYZFAREDNcTaHBVfGeLWJPSgbOd,EGGEDACB....TEBEBHFEGCEALAFEJDAD..SEFDhAAAOACBMICAIHBBhABAXDCDQGDChADAFBHHABGHRGAA.cDCF.aHGAfAAEhABA.PADGdEACCDHBKBDHhAEA...,1,-13,-17,4
DMLBGRIceZaFUbTgEJfSVKNCWXQOPdAHY,DHCEBHFDGEBHRACB.eBCHaBHF..UGBETBAH..EFEEJAFE.hAAA.SEAChABAKHGECFHH.QEGAhACA.dCFEYBHB.MAAE...hAEA......hAFA...,1,-30,-31,1
QFUDMZNXdcWKeTbaIGPCLBRHOfYJSAgVE,VDAGQFCE.UCAHMFADZBECdBGAKHBAeHEA..aFFEIFFDhAAACDDD..BAHChAAAHFCHOABAfADGhABASEGEAEEHEEHHDDDA..cFAB.hACAbGFE.....hAEA...,1,-18,-20,2
ZIGFAbgQXPCSYVDUWfdecOMNaREKTBLJH,QCBCCHHG.SACCDDDCUFBFdACGODEDMABD..RAGFEBDChAAABFGDLFAFhABAHAEC.IFHHAGEG.hAAA.gDEAYHEAWEGFfHEHhAEAeFCF.NDIG..KDBG..hAFA...,1,1,-39,40
XPfMTCLcgUDNBKZAOFEabJYGedHIRSVWQ,OEGHaDAB..JHFAeCCEHFCCRCGD..SHBAVBFA.QBAAhAAAXCCCMEBHhAAALFCEUABFDAGEBAHEhACAABGFFEADEDFB..........hAEA......hAFA...,2,-21,-18,3
eSEHOCBVNaJFLYPUQDRGMbZgcTXKfdIAW,SDCDEDBDHEFFCHCDBAAB..aAEHJDEBLGEA.UGBGhAAARAFDMFABZEFETAFFhABAKHDCdCCFAHIBeBBF.NDAE..hACA..FDEB.........hADA......hAEA...,1,-8,-33,25
HZQYgJLPGFIEcWOXRCbUSeVfAaTdMKBND,TFCEKHBGBACB.HBABZAACQEEE.JAFHLEHFhAAA.GECHEFHFWDAHhABARAGDCCEASGDGhABA.eFAFAIDEaCCCMIFADACGYAHF.hAEA......hAFA...,1,-18,-20,2
NEOJKPUfSbTYeQGRgFaVCXMHZAcBWIDLd,BFDGDACBLCFEECAEKEFH.UFAG..SAEA..bEEHhAAAeDHBRBABFAEEaECACDDE.MCCChAAAHDGFAADE....hABA..IHFGdECANIED.OHBA.fBGFhABA..hACA...,2,-42,-16,26
SVLgdOTDHQbaGBPeZFWMCAUJcYNXEKRfI,UDACJGEA.....NCBF.KEBG.RCDH.SEFDLAGHOABEhAAADEEDHCEG..aCADBHCEhAAAZGBA.MGAE.AACG.hABA.....YEHFEAFB.IAEFhAGA.dAHE..hBAA...,1,-35,-39,4
ACHBgDIXYUKTZLJREMcaFbWSdQOPeVNfG,BDCFDACB..XFGCKGBDZBDALEFARBDA.EHEEaBAF.FFADSEAFhAAAOFEHeDFGhAAA..fHGBhABAACHBCDDG.IFDEUDAFMAIFcCGD..hACA......hADA...,2,-40,-22,18
SEXNWaMDBVbQHIUCZGgROPFLcedKfJYAT,SFHBXGBC..aHGEMDBB.DEDGVABHQGAFHDAACGGBZFEBhAAARFDDFAAFLEEChABA.eAFDdACCfADHhAGAAICEEAGEBFDD.IFFB.GCEBhAHA......hAIA...,2,-21,2,23
UPJVEXSBROcFeTabWdDAYHLKGMIZCQNfg,HFDFKAEGMFEGZCDCCGHG..QBCD..NAIGUFAEJGDCEGAFSCAAhAAABCGD.OBEChABAFHBEeEAG.aBADhAAAbFFFDIGAAEEC..........hABA......hACA...,1,-23,-30,7
ARgUCIEPfSWGYVdQJacXMLZeDTObBHKNF,UFDHEEGD..SAEFGDADdHGFQBAEJAFD.aFEFMAAAhAEALFBHZBBA.DGDBOBHFhAFABDDFNIEFAHBECEFBfAHEhAAA.........hAHA......hAIA...,2,-33,-16,17
FPHXOJdCgSIUMTVRBecaYKAQNELGfWZbD,EGFCGECFZDAF.DABHHEDAOHACdAFD..CCDF.SAFAMBBG.RGEGBFABhAAAeCHFaCFH.ABAHLGAAhAAAfDHE.hABAFBEH.XCBE.IACF.hACA......hADA...,1,-16,-21,5
QacLMKIOXGATNCUfRBSEbYgWFJZdDHPeV,CHHGREFHEHCC....bCAD....gFBFJDDGDEIH.HDCGhAAAeACHQAGHhABALGACKFFHOCCGAACFTAEFhAAANCAEfABF..BBHAWFHH..hAEA......hAFA...,2,-34,-17,17
UcSVLTQMDJgEINbAfCXPZOBYGeWHRKaFd,XGGGZFDFBAAEGCDBHCBFRFDF.FHGE..UAGF.SABFhAAATADBDAIFEADG.IDFChAFAACCBCFAA..OHAAhACAWCGHKBDDaDGEdFFC.....cDAAhADA.....hAHA...,1,-19,-24,5
YdVEUSARaWNDLBKfgMXJTIHFCOPGeQbZc,RDAGaHBGDIGELEFABCBB.KAFC..MDHFJAAF.HGAE.FAFFOHEAhABAGADEQCFBhACAZEFFdAAFUGDEAFBG..NCEE.hADA...XDBA.....hADA......hAHA...,1,-19,-23,4
UOSQBgCZPKbGTaDVXFEdfJYRLNMIHWcAe,eFCAUGGDQABABCEBCAAC.KDEDGBBADFAB.FHFAdGDH..JADAhACARBGHMEBDHBGHAGAHOADEhAAA..SFGGhAGA..........hAHA......hAIA...,1,-31,-34,3
FHWTgAMDINKbVGUEXPSCfcRJQYLeBZaOd,DDGGKHBGGBBAEAGH...SGFBCHGERFDG.QAGDhAAAeBCFaEAHFAAGTEGA.MEABhABAIDDFVADFUFDAhACAXADBfDEFJHCA....YCFFhAGA.BFBBhAIA...,2,-34,4,38
gMUTKcfOZXPGJIWLaRDCQFSYEeAbHNBdV,HAADdEGDMDBCTBFBKFCE.OCCCZEEF.GDGE..JBACIHBGhAAAaBEE.DEEDQGGGhAAA.SEAHhABAYFAGEADDAEAFBHCGgGEF.hACAfEAFPAHB.hADA...,1,-4,-33,29
BVHWJTFGcEOaISCLYAeXdNPDbRUfKMZQg,XAADdHBHDCCAREBD.KDEEZFEB..BDHBHAFF..JDDFTCAHGDAGhAAAEDDGOHFA.aADChACACHGGAGGC.eAAE..hADANCEH....PFFEfEGBMAEE..hAEA......hAFA...,1,-20,-22,2
dfMcQXTWLOFGSeDCUHKYIRAPgEZNJBabV,EHBGZFDFBDCG..aBEDVBCGMHFG.QEED.XBCChAAAWAFA..OAABhABASCGHDFFFCDHEHDABhACAIFAE.AIEGNEABJHAAdBAA....cGGChADAFEHD.eDGD.hABA...,1,-20,-22,2
gIQGdAcJBeHTPNVERFLMXaCWODYfSUZbK,JAFBBEFAHFEF..PCADEHAELCCD.MACCaBGBOHFEhAAADEEE..SAAFhAHAbECHKABH.ICHChAIAdAHEAGGD.eBDHTCDCNBBEVEGFXGAB.hBCACFED......hBDA...,1,-6,-23,17
HeSDBNWAbEcLIXQgPGCJaVdOUMfYKZTRF,EHBGLGEA.QCAGPBDH.CHCE.aAEEODDG.MFFGhAAAKGGFTCGCHFAEDAFBNAAH.hAFAAEFG....cABAhADAIFED.gFCDJAHF...hAEA......hAGA...,2,-28,-20,8
XQAaPCONfDUSLTEgKMGVHWJIedbRZFYBc,CFEDOGEADECH.UDFBLGAG..EBCHKDAFMAIBGBCA.HBGBhAAAIHHEdGHAZFFBFDAChAAABBADQGCChABAAICA.aAFGNBFE...fDDG.SBFAhACA..hADA...,1,-24,-30,6
cBHMNbKVAaUgOYIECdLPQDeFXSTRfGZWJ,UGBCOGEAEFGEdBBELDDGDDIF..eECBFBEG...SDEAhAAATCAFRAAE.ZEAFJFDA.hABABAHGMADC.NAHE.KEADhAAAADEG.aHEA..IHHGCDHF....hACA......hAIA...,1,-19,-34,15
ceDgIBHYWAULOfSRVZNbEQXKdFGJMCTPa,UFCALEEGOCDESGBGZAEE.EDBHKBACGGEB.JBBCCHHD.hAAA.aFFADAFCBGAD.hAAAHDAEAACCfCFFhABA.NEAA.XACFMDIF.....hAEA......hAIA...,2,-34,-22,12
PJKMgBfbHAXFRGEWIcdeCZaVQLTSOYUDN,RBCFEGAH....IDACdFDDZCADQCDCLFEEOAHDDFIBJHEEhAAAMHBEBACDHAFDAADCFCGBhABA......hAFA............hAGA.WFCDCBAHTEBAhAAA...,2,-35,-31,4
NcEQbRSVHBgfaZPWJKCIdXFLOTYDAeMUG,MAFHUFGHGEBF.ECBBQGAB.RFEFSHGEhAAABCHFaBBAZAFDJCAECHBEdAEEFECATEAEhABADDAF.ABBCeDHBhACANEEF...........hAAA......hABA...,1,-14,-31,17
AObVPCdSRYUDaLNXKMFIQgGEBJWeHcZfT,OFBBVAAD.dCCFRDGF.DHGGLEBE.KFCFMADE.FDEEQGGBhAAAEFCE.JAFFeAFAhAAA.ZBABAICACGEE.SAHFhACAaCHH.IADDBFHAWGCAfGAAhAGA...hABA...,2,-33,-20,13
CUWcEeXTgVfQHOPNFdBYDSMLAZGJbKIaR,ZFBHJFEF.KDDCRCFD.UAAF..EDBE..eFGH..TFBF.hABAVACDfADBhAFA.OAGFFEABBAHHhAAASDGAAGGBIHAEaGDG.CHHG...cDCChAGA.....hABA...,1,-30,-36,6
XATPKRDHbZLfSNEUWJMBGVeYdgCIacFOQ,KGFCHBCFLECDSCFFECAB.UGFF.MAEEBAADGCAGeBGDdGAEhABAIGDGaEECOBCEhACAADIBTEFCDFIH...hADA............hAEA......hAFA...,2,-31,-15,16
ZPLGYaeWQRMCSbTFEIJcDNBHdAUKXfOgV,UFCAXGBCOCDEZBABGCEB.eEHBRBBCCHHG....SBGEhAAAbFCEFAGF.JEAHDICAhAAABFFHAECCKADG.fCCFhABA..PADAaGHH.MIDA.hACAIABENFAF.dCGAhAHA...,2,-39,2,41
FDTgJdcOICEMLNKfZAXBYGPHebSaVUWQR,BHHGGAFEeECEaFDDUEBDQBAD.FEGADGFG.JBCDOAEGhAAA.EGCBMIDALBEAhABAKAACAIAC.XDADhACA.HFECSBHB.WADB..hAFA......hAHA...,1,-3,-40,37
dXKAPcINCDTHFBESMgUZfJaGQWRVbLeYO,..IFDGCDBGHDGFFDDHBAGCMACGZGCG...aAEEQAABhABA.VCGH.eDAFhADAdGCGABCC.NCDBEBBDSCFFhAEAUGGH.JEBDWBHBLFFB.XCCEhAFAKGDA.DAIF..hBDA...,1,-10,-20,10
EZAOfXdMeTcIbPLWDYHQSgUCRNJBFaVGK,ODACdGFCMGBA..TFDA..bAEGLHCADEHD.QFAFhAAASDDFgABBhADACAAERCABBCHAaFAHKDFGAHGFhAEA..eCFHPBFE......hAFA......hAGA...,1,-22,-29,7
RYVEPLJQZMCebNWOAUTaBISDcFfgXGKHd,UFCATGAFBHBG.DEGFFAGD...fDBFGAEHHBBEdEHGRFCEhAAAEHGGLAFFZCEECAAF.hACANBAG....AIDEaEEEhABAcEAHKBBD..........hADA......hAEA...,2,-32,-13,19
OYWQXcVfPNBZTMgbdHDECLGKUIASFRaeJ,SEHBFEHBRCDE.eFEHOCCH.QAGAVADF..fDFEhAAABHHEMEBHbDAChABADGFFLAHF.hAAAKHGEADHCaGCHJCAAXGAEcABF..NDAA..hACA......hADA...,1,-12,-31,19
XbGCcQYIWJMegSfPUNOBERVKHAaDFTZLd,FGCDZADGLCGBdBFGGEAEQEAD..IEGFJEEBeCBGhAAASBBA.hABAfFHAUGGANAIEEABAhAEAKFFDAFDHDECEXECACHAF.WAAC.MAFGhAEAOHBCBDDC...hAFA...,2,-19,-12,7
VgHaZTUQRGIPLNKbcJdfAFeMDYBCWSEOX,MEGFDAEDBFGD..CCFCEAABODAD..XDBCHBCFaAGBUACHhABARFEB.GEDGLDFChAAAKAFEJBHBACAFeHBE..hABASFHD.ZFBDIFCENDAE.hADA......hAIA...,1,-15,-25,10
YdXVaRPOeCISbKZBAHDgFJNGcLUfMETQW,DHCEJCCHGBECLCAA.UGEGEAHF..QAAFdGAC.aGGFPCEBhAAA..CGEG.IBFFhABAKFAABDHDHABAhADAFHAENADFMBHH...YEAE..hAEA......hAFA...,2,-27,-24,3
MUTBGgYXPOJDRECVKfIAZHaLWceSQbFdN,HDDFLCCHeAGBQGAGFEBDdEHCUADHBFGFGAAE..gAFBhAAAXGDG.PACEhABADBIBCGGGKHAEAIHEaEHF.hAAA....cGEA.....hACA......hAEA...,1,-14,-25,11
GMQYXTSHIKCdbODPUgceELNRAZWFfBJaV,ZDAGFHBGBEDCaADB.GBEBMDGB...QBACXBFASBAEhAAAHFDDCHHG.OHEAhABADEBB.UGAEeFFEEEEHhACARACAAHAD..JDHB........hAFA......hAGA...,1,-19,-23,4
MFNLZQgdXUDcaWCYJTGbHARBEeSVOPKfI,EBBDeDCH.OGEAKEDEMAABLHFA.QDGGdGAGXDADhABADABAaHACCHCC..TGFGhACAHADEABHABAEH.PEHDhADAFBBB...NDDD.gCEF.hAEA......hAGA...,2,-28,-9,19
deQONWJMaFUIcgXBSPKDCYHTEZGVfARLb,RFDFdDCDeDAGODFG..JCHBaGAD..FFAEUFGA...IHCHhAAAXGGG.BCCHhAAAKBFADABECBHF.HBBCZABEGAEEhABAAFEF..LAFC.bEAC.hACAWFFDMIAE...hAEA...,1,-21,-26,5
ASaLWdXbgNYfCRPTDQBHIVOcZUFJeGEKM,SEEDLCCHdFHG..XDAF..NGCBCEADRGBEDIEEBCBDIACAhAAAOHECUAGFhAAAFCECJAHDGBEE.KADHhABAMHFGAACC.aCCF....WHAEgAEEhABA....hAGA...,2,-27,-25,2
bdMRPYISJTBZaXDFOWNVeEKgGHUQAcCLf,CAFBLGEAdGEE.MDCEREAH....ICBHSECD.BADBhAAAXGCCDBAHOBBEhABA.VAGHKGGGgDGHhAAA.HADFAHIDbDFE.PFAFhACATDEGaFFGFABE.NBAEEAHFhABA...,2,-28,-15,13
adDTHJBbYeSREOVgKPAQMWZLfCcUXIFNG,MFFFZFDFCHFB.UBADFDEG.GBDB..aGBDDGIHHADGBDDH.eHBEhAAASDAC.EGGGhAAAVEAAKEAG.AEHFLAHBhABAXAGD.dGGATDGC.....hACA......hADA...,1,-19,-23,4
fYEVFgHeCJNUAPabKSGDXMBQTdIRWOcZL,aHBGKAFBDIACBEDC..dGGBRBGB...OEDBZAAELCEB.EGGEhAAAFEAA.eBHBCFADJAEEABCF.hAAA.SHDAhABAGCAFMICCQEEG.IADFcGFH.hABAfCAB.hACA...,1,-21,-35,14
JQKERIPMdDOCLFBUVXNafSeHbgTcYGAZW,ZFDFJDAC.QBEERAEF.MADADEFHCHHEFCHF.BHAHUAAC..VBAHhAAA..aDHBSFFGhABAHGAA.gDCChACA..cAGEAAHDKGHHEGCF..hAIAPEDD...hBAA...,1,-14,-44,30
JDLUCcaOMBWgPbRFGISTNZeKAEfHXVdYQ,ECFCXFDHdGAG..QFCHJEAG.LDBGCCDB.OEFBhAAABCACPHFCFACB.hABASBHDNCIEKAEBAHHE.hAEAVDFF.DDBG.aAAGMDHF..gGBDhADA.RAEB..hAGA...,2,-21,-21,0
RaWOCPDSJUGdEHZYgLBKFTXNVAeQfbIMc,eDACQCBC..fAFAMBIBRBFHaADDOCFE.DHGCUFBChAAAEEGAHFEEZEEA.LABEhAAABHHHFHEANECAADEHIABFhADACAHCJFAF.dGAC.......hAFA......hBAA...,2,-13,-13,0
FOCPaLcXNQHEgBIJYbVZSKDfMeRUGTWdA,CDGFLCCH.XFGCHAABEGCB.BEECJHBA.VAEFKABFDAEAeEHBhAAAGBGA.dFEEADDDPDABhACA.aFGHQDABhAAA.gBDB..hACA......hADA...,1,-24,-25,1
WQcJFKSCLXPMeDfGdHRNVYaTABgUZEIbO,UGGGZDAGEBCA...OAADQEBB.JAGHSHEChAAALEEGMAIFfBFAhACAHGDERADHNDIG...YHAAhAAAAGEEIEFB.cFAGCCAGPBAGDBHD..hABA......hACA...,1,-13,-23,10
WPaVbMYEKcQLNGFZXeTHBAJUOgSCIfDdR,JFCAUDAC.OGDGCAGA..DBBERDFE....aBAGMBFF.KHEEQAEChAAAGCAHFHCCXDDHhABA.TBGGhACAAAIFSAAFdHGBWHAGVCGF..EGAELFADhACA...hADA...,2,-32,-20,12
bKZVfCDLASJINeBETXcFRWGgQHdUPMOaY,JCCHeGEABFGCEAGE....TCFCFGECGBEGQAADHGAEdAAChACAPFBH..MIDAhADAOADCaAGG.KCDE.fCAChAAACAECACIH..SCGHIEECNDIGhACA......hADA...,2,-26,-15,11
GceRaKdSQHMXDZOfILFbJVUNYBPCgWATE,ECBBeFEFKGAHQFBE.MAEADEDFOEHHLFHBFCHFbBAAUAAFhABABBHF..CCFBAFEHTDABhAAA..RADFSFFFhADAHDECfGGA..IAGAhAFA.....hABA...,2,-34,-8,26
UPMgfXaSVTOGZeLIEFJDKbQHcNWCABRYd,RDBHUGBCMCIF..XDDB..VFGFGABBeBDDEFEAFDFBDGGAhAAAQGACHAGBNBAE.hABAABADBAFF.dHDBfDHAhACASAAB.ZBEAIECF.hACA......hADA...,2,-15,-13,2
VENdaARFQbXJMfYeHIKgCZDUPGOWBLcTS,QCCBXDAC.MABFeGCAHAEGKCDECHGFZCGD.DIGEUAACGEAHhAAABCGHLHAC.hADATGEEEFFENAIEAGBEFGGA.hAEAfACG..IAGF.hADAOEBE.WFHHhAFA...,1,11,-38,49
VBHEQDJWYSNKUPZOGXRdFfIAecaMLgCTb,aDCDLCHD.TGEDVEEHBCBA.HBFEQEDGDIAC.hAAAJAFESGHDhABAUBABPEAHOACC.XEABhACAFCEFIHHBAAHH......hAAA.MIBACDHA...hAEA...,2,-29,-12,17
GVRAIYaLeHbUdfJPZDCTMFOKEgSBXQcNW,aHBGHFBG.dHAB.JCEEZAAA.CFEGFAHFKAGE..EAACBFFE..QGGGhAAA..NCCGVBEAhABAABCFIHEH.hACAeEAAbDFE...PEFAMEABSHGAhADAXADF....hAEA...,2,-35,-12,23
LNdEFBOKabCGSAZPDWIJHQfTRUMcegYXV,DHCEJGEAHCAFQEEGRCFD.UACGeAFA...XACAVAEELDGBhAAAdGAEEDDDBFCFhAAAaDDHCBBF.AIFA....WCHBhABAIHAC.MBAB.....hACA......hADA...,2,-24,-20,4
TXFANcCLGWQEfUPdeVJDSIMYZaHBRbKgO,CFDGGECF.QAAFEGFAUEAG.dDAGeBBEJHDGDGIH..MDDAhAAAaAGEHGAABCHCKHBGOBEDhABA.FCGCAFIHLHEAhABAfCCASEEB...IAHDhACA...hADA...,2,-32,-12,20
PcZbCOeWVXBfGSIdELgYaQDJAHKMRNFTU,KHDCMECGFAEAUBAAZACF...CHAA.eDFF..XAFCBBAESEGAhAAAEFFF.LEBAhABAaAHDDACEAIGG..RAGH.hAIAPDHH.....bEBG...hBCA......hBEA...,2,-35,-31,4
aRLBIYTFcMOSJgEbeUDGCPdKHWZAQfXNV,QCGCXCBC.aFDBRGEGBHAF..TADGFDHBMIBG.OADFhAAAgCAB.hABAEFAAeFCADFFFCHGBdBFGKAAEhADAWDADAEECfHAD.NEIE....hACA......hADA...,1,-11,-29,18
DPEWQYNIOaKMJgHTSdbfBRAcXFUeZGCVL,FGFCeADGZDBDCABE.DEHF..EFAF..QAEH..IGEAhAAAKAHBJHAEHAAFSBBAhAFAdDFGBEDGAHCCcDEEhAGA.UGGC.LBHBWEAF.ODDBhAHA.....hAAA...,2,-35,-18,17
SNWAELRfHUOGBIgFZCaQYTKcMPVbXeJdD,EDBDLFBBRFEF.HACBODDGBGGG.FFDGaAEFQAGB.hAAA.KGCEMEIDbAGFeABGhADADHDASBADhAAAAEIH.fDEBIHGE.CBEB.cGBC.hABA......hACA...,1,-19,-25,6
XVbeJfYRgZKGIPcMHaLODSCQANFUBEWdT,UGBCEEGDdAAD..VBDHeFAB...JFEHRFGBZDACKFCH.GAGE.hABA.IDBGMACBaGEHhAAADIGA.CADC.AFAA.FAHBBEFEhABA..XBCA.fBFChAFA.....hADA...,1,-26,-27,1
ZGAXDdgPNSYTHKcaCROIeWQFBfMJLUEbV,dDAB..gFFGSFAEHCAFaBHFCGFDICGD.QABEhAAABEECfDGBhAAAJECEUGBFEACDVADAADEEDIAGhABANCIGKGEDRFCFOBEC.eHFA...MFFAhADA.....hABA...,2,-9,-5,4
RKVQNcFPYOMXdbUIEGBCLHTgaDeAJfSZW,SDCDZGFGKEGG.QDDFFECBODCAMGFA..dHAFUADHhAAAEEADGADHCBAHHEABgDGDhABA.DIDAhACAADHAfBBD.WGDC.NAAF.PGCEhAEA....hAGA...,1,-16,-28,12
BCXAPDSJLEgNOcHKMaVWfTbeFQYRZdIGU,DGHHJFFBLAFCEACG..OCFHHECHKBAHMFAC..aCGAVBBDhAAA..fHGFhAAAeGAGFCGAQGDChABARCEFdGBEICCFBAHAABEHSDAD.cEGFhABA....hACA...,2,-20,-20,0
McDEUNSXaFVbeORKWGTgJLHdfBCYAPZIQ,ZAADMFFFEGEHUBAD..XCECFDFC.eAFGKAGAGEAD.hAAAJAEBdFCH.BHHFAHHF.hAAAIEAADICG.aFFAhADAOEHF..RACAWHAETGAA...hAHA......hAIA...,1,-23,-33,10
ABJcFdWKeENQYRbOVMSCLfgXHTIDPUaGZ,BAFBFDCDdBBEeDEG.EFFDQAFG.RGDA.VGCECEFA.LACDhAAA.XCGEhABAHCGDDAIDaFCGAHAF.JEABKDADhAAA...bFBC.MABCfADA.hAHA.gGGBhBAA...,1,-17,-24,7
QVRNYDdaWZBMACEHLUSOgJfKTFXbcGIeP,EGFHLBDGUBDD.ODGF..JEHHKABEFAAF..XGAFhAAAGEABeHBEQFDAhAEA.NEIE.dBGH.aEEDBEBEhAFACADESGAFfDDF.cGFA.hACAIHCA..hAGA...,1,-21,-31,10
bRSJATZeXHUWMBYDCcQPVNdafLgGIOFEK,ZADGXAEGUDAEBABEDDAC...CDGC.QGFG.PDFChAAAVFEFdDDB..fFCEhABA.LHBGhACAIHCEEAGEKAHBSCBEAAAF.hADATEDF.eFHBhADAMEIF..,2,-46,-22,24
VLCYWDcIMfXNeGHEZSUOQKPJgdFBRTAba,aCFCVFEELEGB..CBHCDHACMGCA...XFABeACBGCEFhAAAHCCDZAEESGBEhABAOABHKEEAJAEE.FHCEhAAARDAG.AFIB..WADCIEHCNAIE....hADA......hAEA...,1,1,-28,29
bEUZVGHBKgNdfIPLDTRFWeCOcJAQaYXMS,aGFCMFFF..EAGDVEADBGDF..KGGEdDDB...IHAEhAAALBBGREAAFCAFeCHBOABEhABAAHEHXEDB.bAEBhAAAUCGB.HEFCNDAFDGDB.CHAD.....hABA......hACA...,1,-12,-22,10
agHXcGSROEIfWALNPVKZJCdbFUDBTQMYe,LGEAVAAD.JEECdBEG.FCGBUBADBHAC..QCGFhAAAMFGB.eDBD.HGAEhABAXEABSDDChACAOEHBEAECIEEDAFID.KFCG.CAGBDBIHTAGHhADA.....hAAA...,1,-3,-39,36
EAgNQeZfRODcULbGVTCSdHYBMJWKXIPFa,QCBCeFBBZEEFOAAFUGDFLAAD.GEGGTCCHCDEDSCHBhACAdBEFBCFDMAHDhAAAJEAHKCFGIHHEhACAaHACABBE.fEGA.DIDC....hADA......hAEA...,1,-13,-26,13
QSGeAFcPgdaZbRECTOIYMDKUfVHBJWLNX,FHBG..PDACdBFHZBBFEEFDCGHB...OADHMIFA.KGAE.UBFGhAAAHECGBEGEJDAHLAHBhAAAXBAC..GEDEhABAAABAaFGH...........hADA......hAEA...,2,-31,-22,9
TNFQVPBGLeaZgEODYSIcUMbdCfXRJKWAH,TFDHQGBC.BECCLDHDZDFAEBEFDCEC.SADAhAAAUFFBMACGdDCF.CGACfBBBhABA.RGFEJCAFhACAACCEHAAE.FAGDPHBCaGDF.....hAAA......hAGA...,1,-10,-23,13
OUeILaTdAGPKFCXBVQEgZJNWYDbMRHScf,KGAHFFFBBEADEBDE.ZEGD..JFFB....NCEC.DDAC.MACASDFChAAAODFCUAGFhAAALBAG.dGAAPFDFhABACAHD..XFCD.....hAHA......hBAA...,2,-42,-38,4
YZbGPKefVRSCUTMOXIQAWgBEDLdNHFJca,BFDGLEACdAEAHFFGFGAA..aGEBZBGDGAAFKDCCeHAARGFA.UABAhAAAMCID..OEBBhAGAICFFAEIH...EEFEhAAADFEENADF...........hABA......hAIA...,2,-28,-23,5
COYSbFDHPQLWJTBMUXfAEVIGaNRcZdKge,ECFCVEBHGGEF.RBADZFBGKCDCCDHA..ODHH..SFEHhAAADEAHQADALAFHhABA.TGGEMAIDfDCFhAAAIDAFaAHD.NBBF..dHBD.eEEEhACAFHBE.....hABA...,2,-15,-11,4
aZXgeUBOEQCJDIRMTbFKfNHYAdSPLGVcW,dAFBLCCHGCGEVFDEaBAC..ZGCA..eEAHOFDEQAAGhACACCEF.IBHBhADAMEAFTDBHKADHHCEEAADHSGBDhAAA........hABA......hACA...,2,-25,-13,12
AYMBVcODLZWIJXQUbNgEHKeRGCfFSPaTd,MBFHVDBH.DEGGLHCAZGFA...JBHFQCCDUFGA..hAAA.gABAhABAEGABKAAHGACBFFACSGCAhACAaEEDAIGABCCBOFFG.IAHD.hAAA......hACA...,1,-19,-23,4
QAKDCUBGMRXgEYTSbaOJHZWPecNIFdfLV,KFGEDEFACHAEUECB.GGBBRAGH..EEBD..TBADSEDBhAAAOBEFHBCA.ZFFF.hAAAeEHHNIEHdAEF..fBAChABALAHFAIBABAFD.MFDF..hACA......hADA...,2,-23,-22,1
UDINdHfcPGaVKBCgWeLZRJQFXMbYTESAO,OEGHUAFBDEAAdAEDHABA....PBCDVDFABFDD..hAAAgGCEeDED.hABALAAFZGCA.QEDEhACAMIBG........hADA......hAFA.bCEE.,2,-33,-29,4
KeTENMcgfQGIJHbDCRSFdOZVYLaXUPBAW,eCCHEGFC.MBED..gDFCQGBGJBABDDFD.CHHHRAFBSFAEhAAAFCAG.dCCAOEGHhAAAZFCDLBEEhABAaFABPHDCAAHGKGAD.NBIE.fABF..hABA......hAEA...,2,-19,-13,6
ILgGKCPdFaEJZHWYTDBQOSNXVMcUfRebA,LGEAKGAHCEAE.dCEEFDFAaCCDZBDB..HAFA..TAACDBCHBFADhAAA.SCHBhABAVFEBMACEfDGChACA.eHAEACFGIHCG...gAGEhAAA.EHGAhAIA.YCCDNBBE,1,-25,-29,4
VJGUcBfgKMRNPAYZeXbDEFCIdOaWHLTSQ,ZFDFeDACDCGAFACFdCDA..OFDG.HGEELBCCQAFChAAAGDGA.BHAGfBAChABAKEAFMADEPDEEhAEAABAB....bAABCFBB.aGHD...SGBChAHAJHAE...hAHA...,2,-26,-11,15
ZBNGPDAaXKedSHfYLTFRQIgEMOJUVbCcW,XFCEKEEDdCAEHGCELCEERCDG..QGGHIAAFMADEhACAOADEUGGH.CHAHZDFEhAHABFCC.NAAFGAGEhAGAACDBaCBD...fBBB....hAIA......hBAA...,2,-22,-14,8
ZVEQYMUAJIXTORcSNDbeGLWKCfgaBHPdF,JDACXCGC.RBAC.SDGB.DIGAbECALFDAKGHDCAEE.hAAA..aBFCBBGBdAADFFAEhABAEDABMICEAEFF.OGAGhABANDIG..eHBAfCDF..hACA......hADA...,2,-31,-29,2
PeJMbOTWDIEGNLQRKBYXCdSUHfcVAgFaZ,FAFBaCFCZEEBeECD..MDBGOAGD.DGGCEFBDLBAGKADA.BEFDhAAACBBAdAGF.UGGCfHFBhABAABAC.JDABbECBhAAA....IEHE...NEEC.hACA......hADA...,2,-35,-28,7
OaTHdYLFXGUfKEDbRVcZJCQNgBMeAPIWS,..IFDGOCCHTGGGdCEDLADA.FFGCUGBH.KBEGbBBHhAAARAAFZDFD.CEHGQAGEhAAANEEBBHAH.AAFA.PHCGhABAaEEB...XFACfDAEDBBB.hACA......hAEA...,2,-24,-16,8
EJLdcADQfMIWNbPSgCKYVUaFXTOGRBeZH,DAFBMFFF....NEFG.bAFB...SCDACCCAKGGB.UGGGhAAAXBGGOBABBDADhAAAHEBDLECHdBHGAEEAfBBBhABA.IEGFWHAG..gACChABA..hACA...,2,-58,-8,50
QICFJPZgBSADeXfEWUKcNMbVLGaHTOYRd,DECDeDACEDGBUGAH.KECGMAAC.LCCCGACHHGDGOADEdGGEhAAACEAC.FEGAZDDFBEEBACIB.hAEA.XGGEfBAAhABA..NHBDbAGBTBGE.....hBAA......hBBA...,2,-23,-9,14
EagTSeOcAUHGFdVLXIRZBDWYMKQPJfNCb,HACFdDAFLDHBRFCCBDEFDGBFMCBE..KGFGQAGE.JGDEhAAACCHCaEHD..gFAHhABASCAHeEEEhACAAABC............hADA......hAEA...,2,-50,-26,24
fQIBeKYAgcFSMXdNZODPLJETHaUWRbCVG,FHBGMAEDdHEBZEEBDDCGLAFG..ECFEHEGHUECARAACCCCC.GDAEhAAAQAAFBHDGKDDDhABAAAFG...SCGEhADAXFFEOAHD.TEAEaGGH.bAEChABA.....fEFFhADA,2,-22,-14,8
FULWdHeYQbBJNMXEgCSAcaODVPTfZIRGK,OCCHVFDG...TEDFZACGREABKHCG.LEDEHBDEeBAF.hAAAQGAFBCEHMAHHhABAXGDCCCDC.AFGCDIEChAAAIHHEFAFC.....dDAF..hACA......hADA...,1,-11,-27,16
KALaIZeSfdHcXVJBEUMFNgDRTGWQYbOCP,aDCDZFDFSCEFHAAC..XBFGBGHAUEBGMIBGFCHFDAEEGAEBhAAA..WHFAhAAAQBBBOBHDCHACAACGIFFHhABAfFFEdHABJEFA.NCEA..gDAFhABA...hAEA...,1,-5,-23,18
aQJPUIOSLEVXeWZAgbcdDMYBGHFKRfCTN,...bAADdHFH.DGAABFDGFFGERCCACGHD....aEBDJEAC..IBFChAAAOBDA..LAAFhACAEAGEeHCE.AIGAMACEhAIA.GDDFfEECNCIE.PBHFhADA.SGCHhAEA...,2,-42,-14,28
fKdJTSBINGDXbeaCYVZgHMRELPFQWAcUO,UDACKDCDdABD..SGDEBEADGDDGDCGC.eHAA..CGHAZDFAhAAAMFGBRBCDLACChABAFAGFADGD.OHBEJFHF..hAGA.IAHFNCCD..aCAF....hAAA......hACA...,1,-28,-32,4
GEagFWHICeSXfZYJRKAVcLODQNdTPbMBU,VFDFLEEG.OBADDBFDdGAF..TGADMBHDBDCEGAEF.hAAAaCCFFBAGHFCE.IGHHhAAACBDHSHGAhABAZCFA............hACA......hADA...,2,-48,-6,42
PTeQCONRWKYafLVSFIGDAdcEbXHBZMJUg,dAFBEHBGHAFBMHFCUCGG..gEBA.TABDeDCEOBBChAAANAEC.RDAEKGBAhABAfBAG.SFGGhAAAIFGHAADDbFEHXGDBBDHD..hACA......hAEA...,2,-31,0,31
VZJdCYUFBMaQPWTHISXbGcLREKfgDeNAO,ODACVDBG.dFAGUDGCBEFE..MAACaCAG...QAGChAEA.TAECSGGHhAAAXGGCbGCEcBGHhABAEBBCKFDG...DEEBAIAC......hACA.CFCEPCDC.hAIAHABG.,2,-31,-12,19
QdPJfTKZcNUACeSgFaEHDVBRLXbIMWYOG,SDABFAFBEECF.HEDBDHAGREDFLHCA.XAGEIBDBhAAAMDCAOGFCdAEEfDFAhAAAKBBDZBGB.UGGHhABAAEIHCACC..aEAGBHAB......hACA......hADA...,1,-10,-31,21
TMZHPWdLbIAVSBfXEgNOJUKGDaQeYFRcC,BCAHEGFC.OCHFKHCEDFAH..eFHBRABA.CAADZGCCHCEB.dBHGLFAEhABAAAAF..fECChABANCEAGAEF.aEAFFDBEhACAMFID..WHAGICAF...hADA.SGFBhAEA...,1,-24,-26,2
DUcZLbCWRJKeANgMfSQadXEBPIVOFYHTG,MCCAQGBCdEFEBGHD..VBBDFEHFHEDHTFDHDBDA.ZDADLAFGhAAA.CABFRCFAKCFGhAAAeEAFADDE...fFHEhADASAHHEDEBOHAE.YBADhABA....hACA...,2,-34,-2,32
HJYRgMUXCQAGZETaVOPWKIFBcdNbSLeDf,ZCCHTFCEaCAC...OBFCKFFBFEAEBGGE.dCBFSHAEhAAADEFAHADDRFABUAEA.CEHB.AGFBGDAFhAAA..EGEBhABA.....WAGHIAHD.NIDB.hABA......hACA...,2,-37,-20,17
FWaAIPdcKEbTZJSDGLNgfROeBVCMHUYQX,dHBHKAFBEBCCZDCFDIGA.LEFB..fFAAOAEFBACGhAAACDDGHFCC.QCAHhAAAFBGCAAHA.PHAChABATBADSFFH.NEICgCFAhACA.....hABA...,2,-45,-5,40
FbEWdJgNAXaVSfZUTYIOKRLGHDCPQcMeB,VBCFSCFC.UFGCTEEF.OGBAKAAFRFBHLEEBhABA.HCACCGHAPBFGhAAAMIEAFAFGEBABdFAG.JDFAhABAAEABfBCB..IHFGhACADBID......hADA...,2,-23,-13,10
bIHTNVBPOYXdcaZGAEJRCgMQSFDeWLUKf,EDBDJFCA.REFF...CHDD.QGDGDGAG.eAHHLCADUDDCKBBEhAAA..fCDDhAAAHAEENBAGBHHGOHFAXGAChABAaCHFAIAC..MEBE.SBBHhABA...WFFE.hACA...,1,-10,-39,29
GLZgHWMfITEbOSKRcNUYdFXJPBAeaVDQC,eDCHVFFA.DFHHGCCDLBHBHAAC.MBEETGEE..OHCGhAAASADEREAD.UCEEhAAAFDGE.XBBBhABABAHBAEFFCDAC...........hACA.gGBAhAGA...,2,-30,-12,18
SUBQNfKEJFLgGeRcAaHIdMCYWOPDVZTXb,aCFCHDAG.MFGHCFHG..ODACDBADZBDG.XFBCUGCEBGFDQDFDhAAAKAFE.EBBFFBCDhAAALAHHeEECAABC.YEHBhABA.WHBA......hACA......hADA...,2,-46,-10,36
VCQGOJZMEDRLdUBXHcPNeTFfKWgaSAYIb,..IFDGVFGHGBBDZFGF.DFFDdCDBUEBAHAAB...PAEChAAAeBHBFDFEKCGGaHAAAGADCHAH.hAAA..OEEGMAFC.hABAEEABBEDA.XGCA....hACA......hADA...,1,-16,-23,7
eBSHNgOfPadGTIRCADFbUZKLQXJVcMEYW,DGHHUGBCKBFHLCCD.QAFGJHCE.MGFCEBBGeDGHhAAABEFHHACG.NHDD.fGAGhABAdDDB.TDAAhACACHACFDAF.ZADBcAABSFDA..hADA......hAGA...,2,-39,-8,31
STYeJOaUNKcMDHFfWAIVLbQCdZgRGBEXP,VFDFLDAC.CGBBZEFERCACBGBG..EFCESCFB.eACGhAAAaACGKGGB.MBEChAAADAGGFGGHACCE..IHAGhABAbDCA.dCEC........hAFA......hAGA...,1,-32,-35,3
RKVLPQFOGecDZfIdBSaJgWUATXHMCYbEN,XCCBHFBHCAHD..EAFDRCFFLBBFFBCF.eDADZDEHdHEHBFDGJDABhAAAUGADABAB.MFFH.hABA.bEGBKHGG.PDHDhAAA.OACGcECA......hACA......hADA...,1,-10,-23,13
BMLQaZURHgJGAbFPOXIcNKVWYfDdeTCSE,FHBGODAC..XBGD..ICGFKCCD.VFABfFCHhAAAeFEA.SADFhABABABGLAFChAAAaGFDZDECUACE.gEDCAAFF...hACA......hAGA...,2,-42,-24,18
KMecZRSPYWFHfBaJDdIgLbATQUGCVXENO,UCCBGCCFCFGC.EEAG.KGFAMAFCZACA...RGBE.SEHD.hAAA.PACEFHACfGBBhAAABBAADIGAdGEAIBADhABALBGFAFFDTAGC.....hABA......hACA...,2,-39,-16,23
RHbUQEKgcCaLdDWGNSMeFVJBOZPYITfAX,RABHUFDHEFEB.KCHD..CBFGLEADDCFFGAAC...MEIHeCHD.hAAAJDCBZDBB..IGGFhAAATAFGAAHC..bADBhABA..gGGDaEEANIBD.SADDhACA.....hAGA...,2,-24,-24,0
bgMPZFEUGNKfIVROeJLAHWQXadBDYSTcC,QFDHaFHBBHCD.SBBDCBGH.MBEGFCEHEAEGGDDFKGFB.hAAAICHBRACF.eFAAhAAALGACAHAA.HCABhABAdHGHYADF..cEFB.hABA......hACA...,1,-15,-27,12
gKcLWPBJSQDfUMbGINHZRYVFACOEXadTe,EDABaFHB.dBBE..eFAHKEEELGCABDDBQBBFUAGB.GAGChAAAHCFCZBCBRBEBFGECAIEGXGGGhAAA...hABA............hACA.cGBDJFAFDABGMDADhADA..,2,-19,-18,1
XYBgNQeVcHTIFZWfKDbaMdOGLCPERSAJU,JDCHUCGCBAGAQBCB..VEFEHBAF.IEEHFFAFZAAG.hAAAKGGBDCCEMFIH.OGBGhAAAGGCFCHFDEGABRBEFAHHF.hABA..XAFC......hABA......hACA...,2,-35,-15,20
UNKJdBRfTWbVMGDIPEgLcFSXZQeAaHYOC,aCFCHFDF.CDBCKCFDBGBC.RADA...TACGVCCH.MECBGFEBDAAF.hABAEABALBHD.hAAAFHACSHCChABAQGFGAFEEUAGENAEF.fEAAWDDF..hAEA......hBAA...,2,-22,-10,12
KPNOSDWedYCfQXaMARZBTVbHcUgLIEGFJ,ZFGHBFFC..VDADHCAFUGDELHEA.ECGBFEEGKFDFOADHhAAADAIFdADC..CAHB.fGAFhAAAQCGA.aBBFhABAABAGRDDA...cAFFgGAA..hACA......hAEA...,2,-26,-21,5
WdDabETCLJcOgFQNKGPHUMIZfSYVBAXeR,eADGRDAGdDGCDCBEEBDBLBHB..OFBHFHCEQAAEhAAAGFCBHAFGMCFB.fHAHhAFASCDABGFAhAGAAHHEaACACHHG..gEGG.PDDBhAHA......hAIA...,1,-7,-30,23
BIOHMfADWeaKSNURFYXcTEGVbPJZLQCdg,DEFHaDCD.KHACUAFA..FBGH..XAAFECCAGEAB..bFDAhADAZBABLEHFQEGFhAAACCHHBDBGOHEEfHBHhAEAADEBeACG.SCDB...hABA......hAEA...,2,-25,-22,3
IGVWbRJDdgaFKQZULEYXfeHMTcPCOSBAN,GAFEVAAD.RABGdDAAFHDAZDDALHDG.EECFXBGB.eDBFhAAATEGF.CAHDBCHAhAAAACGFIHHGJEEBDCEHKHAEhACA.QFFB...UADF.hABA......hADA...,2,-21,-11,10
WFcUBNSbaePVAMJIHCXTdQGfgOYKZRELD,JCHDCFDDdCABGEBG..OGFCKBABZEDHLCHB.DAAGFHGABDEDhADASDDE.hAEAaADHPEBF.AFFBMBDGhAFAIBFH........hAAA......hABA...,1,-42,-43,1
XJTEZKMeOWDbPABNgfSQCVRaLGFIHUcYd,BFDG..fBGACCGARAEGGDAHFAAFHAAFUCDE.dFDF.TDAChACAEFEEMHAA.OFHHhAAADHFAPCHD.AHIBSGBFhADAaHEE.IAFA..hAEA......hAHA...,1,-25,-28,3
FLVTaQePRBEWXcbgdJOGUMNAYIZCSKfHD,ZAADCEFAKHGEDCCH.FGHFLDBB..TFECeADFBDHA.EDEChAAAXAGE..hAAAgGCAdFAHJAEBOHDChADAMAFCAABC.IBFFfDHA.aDDHhAEA......hAGA...,1,-34,-36,2
eXbHSBcCOgEdDJVQGARaPfTZILYMUNWKF,RDAGaHBG..TBCAZDFELAEAUFDG.KDCDeAHBHAACBGBA.CBFG.hAAAEHFADIFAJDAF.QGDChAAAABAG.IFGEhABANEEBFGGC..SFAF...hADA......hAFA...,2,-30,-18,12
INAHVGbOFfQaLYeWDBCdUXSJZgEMKPRcT,VCADOFEF.FAADQDEALAEG.eGCABDAF.dFCAUAFF.hAAASGHBJFAFZCECMEIBhACARACFTDGF.NIDF.hAAA.AABC...........hAEA......hAGA...,1,-14,-37,23
VNFKaHJWUSXcbITLOGZDCREgeQYAPfMdB,MCCABHCHFADEKBGCHEECUCAE.....XGCG.IFADhAAAOGFAZAFD.CEDEEHEEhAAAeDBC.ADGEfGHEhABAdBHE.........hABA.aFCBSADEhACA..,1,-23,-48,25
VfURFPNZAaXSCQHDcTeKdIJgEWYMGbBLO,XFCESFFBHDBADEDD...eDFGKGABdAGDIBCAEAACMIFAhAAABFGF.LAFGhAAA..fBCAhADAFHGAZGAAaBAFcCGE.gCEH.hABAYCBFOAEH..hAEA...,1,-1,-40,39
gCFSGcDEWIHUMKTBAPRXfNdZaQeYObVJL,XFDHdHBHaBCB..eFEHOAAE.JDAALAHB.FECESAFHhAAADAACEEAHHAEGhADAMFADTCEHBCCEAEIBfGGEhAEANICFZDFF.QEGEYCHDgFBFhABA.CAEC.hADA...,2,-30,2,32
CdPZOJGSFNTfVWbQIagKRXBUceHDELAYM,MBFHdEGDZCBFGECDFAAB...TGCBVAFG.QCGD.hACAIHHBaEDFRGDAXFADhADABCDFeABB.EAFGhAAAABDBCBEDOCAD.SHAG..hACA.fFGFhADA...,1,-12,-32,20
egRUcZTFOdfaPKVYLQbAGIDJMNHCXWBES,GDCCDEFHMBGHCDBHBBDE..EEBGeFFGUADCZBFEFGACdFAG..aBAEhAAAKABB.LAADhADAACIF.JHDENEEG..HGFAhABA.SDHD......hACA......hAGA...,1,-29,-30,1
HGEVJWPDXKANYfTFLeMZdIBUaOSgbCQcR,...fFAFTGGDeHAEdAFCUFECODCH.SEEEhAAACCDFRABHGEGCVAFB.JBBADICChAAAADEEFCADMEDH.IDABhABAaDHH...QCGH.EGBFhADA......hAEA...,1,-14,-15,1
LTeDcQgEGdfHKUZRFOASCbXNMVJBaIPYW,CFEDXCBC..VCEGBCED..aCAHIAGG..PAHFhAAALFFA.DFBAhAAA.gFCAhABAEGHDfFBDUADBFBHDADBCbFFFMEAHJBBE.YHFGhACA.....hABA.eHAAGDEF,2,-23,-2,21
SdZbFcKRGeagTVAOHCPIMXDJfEWNULQBY,OFCACFDD..ICFCDIACEGAE..UGGGLBBEBCAGdDGGFDCGKHGEhAAAGABH.eAHDhAAAaFAA..TEEFAABEHCCChAEAMHBG..fHEFQAGESGCBhAFA...hABA...,1,-10,-39,29
faSFNCDRGAXEBZVJIgUOTPcdHLMWQbYKe,XGAFBHCHJEFF.UGGE..OBEG..PBDBdFHAMEAAhAAAQDAF.KHCChAAAfCBDSDGFhABAFCHHNAFCCBBCDABE.AFABEEDF.....ZFABhAEA......hAFA...,1,-23,-37,14
fgOCBUJHYILVXZTeNERbMaPAcQKDWFdGS,KGFCDGHHdADEGEBB..SEFAOEAHBCCHUFCGHADCLCAFhAAAZCECeHCCEAHHMEDEhABAaBACAAAE.....QGAEhACA.WHDAfHAFCCEA.hAFAIHHGXBBF.hACA...,2,-29,-15,14
PIGAWJFKObfRESCLcBQTVDaHeNdgZMXUY,FDCDOCCHRGFE..EAEALGFC.QGADTBGC.DGCAeAAAhAAAdBDFMIDCUDGFIEEFhABAADAGKEAD.SGBChAEACBAGVDFG.NIBB.XDDF...hAHA......hAIA...,2,-25,-19,6
PeMKcDfELdFHZBRYbGICTQWXUOJSgaVAN,eGEAMHFGDHCALFCCHCAFZEEGBBBA.RCEEGAEFCCDG..QAFBhAAAXDACOHAEhAAAgGAF.AFDBKABChAEAfFAA.EDHF.dCDCbCFEIHHHhABA.....hAGA...,1,-1,-25,24
PeBTRMZEbgAWHQSYLJdICGVDKUcfXFaON,QFDHLCCHdHCFCHHDGEAADAIFUCEH..XDDCFCAD.OAABhABAeACARGFAZAFDEEFDbFFFhACA..ABAH..SGAFhAAAIBCDKAEF.aEHD.BCHEMDIH.hADA......hAFA...,1,-7,-23,16
QPITfADgWBFdLEOcHKCYSZeXVbGRNaMUJ,DACBBFDGLEAHOBGFKGGDCEGA..ZFCHeABD..XDDAhAAAGBECaAHFMAGD.UADFhABAQEAE.TACHhAAAAFIDFGEFEHGA..cGACSHAAhAEA......hAHA...,2,-27,-21,6
fMYeFBCZPLNGAWQgEbKUcHVRJOIaXdDST,QCBCEHBGKCBA.HAFEJAFG.aFDA.dACFSEHDMEEG.FCEEhAAABHGDZEBG.NIAFACFH..hAAA..gFEAhABAbFAC..cGGAOCAHDHDA....hABA......hAFA...,1,-12,-32,20
OECGHaXBNYPUJbKcRdfISVLWeZATgDFMQ,TAFBDGHHFBDD...OCAFGDAEHEBFBBAC..NABB.UDFGKEEBREGHhAAAdGCE...IAHAhAAA....hABA............hACA......hADA.LBCDWDDE,1,-33,-37,4
LOVKYGQScUaHNRBPJeITFAEdCgfWXDMbZ,EEHBCFED.....fFDEDIBGMAEGLFHFOBAB.KDFEQCEBhAAAUBABHBDEBFFHhABAJGBC.IDBFhACA.FFAGAIECdFFAWHACXDDC...hADA......hAEA...,2,-30,-29,1
BcLYSIgDWJRFZfMGbHKPUaTAeXOdCQNVE,eFCAXGGDdDCBCDHA..QCBB.VGAABHAG.LBEChAAASBFEDCFBJCAFhABAREEAfHDFMGFC.hACAHAACKBBEaHFEADEFODABEGAE.cDGA.hADA.IHDG.hAAA...,2,-27,-12,15
PYXDWKLCUHefbcdMQBEVaFRSINgAOGZTJ,OEGHZCDFJFAB...XECBKDBCLCFGCCDA.HAAEeGBG..hAAA.fBFHhABAdGCBMFIFBFGBaADBFBBDSADEhAAANIEFAAFC.........hACA......hAHA...,2,-31,-31,0
KGTRMZQJLADHIcBNPYCaVbfgeEOSWFXUd,HFDGBFDG...PBACaBEE..VCAH..gAGGhAAAeFGFSDEAFDEBXAEHhABAKACGGGABMIDCJDBBhACAABADDAGAIHHB..NEICCCCBEDHB...hAAA......hABA...,1,-2,-30,28
HWXYIPEeZLGbMJDFRdUOBScAaCQVgfTKN,aFFBCFFC..QEBB..fGDCKHCCHACBXBGDhAAAPEAGeAFBLAFEhABAbABGDGIFdGHABCDDAGGD..hAAA............hACA......hADA...,2,-35,-23,12
gHAZLecSOPKabGEVWRNUYXQDFfJMBCTId,eFFCOCCHKBFHGAEG.EGBEVDCE.RABA.UGDC..QFBHhAAADBDHFAGCJFHFBGEDhABACAAC.dCAEADAEZFFFLAHBhACA.SGHBaEAB.WHCG..hAEA......hAFA...,1,-17,-22,5
GYQEOHJARcPXaTBNFgIDUWbCLVfKSMdeZ,RAADXCBCBFEHFEBHDFGB..UCEB..CFCGLCEHKHCC.dBGGhAAAeHFGZEGFQABBhACAHACEAHAB..PBHBhAAAaGADNAEF....WHCA.....hACA......hAEA...,2,-37,-19,18
CFUJHWYVMGeELKgcTDQaPBIZONRfbXSAd,dEHACFCFFEEDHBAB.VFBDMAFB..GCEHEHBC.KECC..TDAAhAAAQACDBFHC.IAFChAAA.OHFEhABAfGGGXFFFSACHAAIH.WAHBhABA.eAGB..hACA...,1,0,-49,49
ZYIdgQPTfXWNGEHCODAVbUMaKeSFJLRcB,UFDHKHBGeAGHFCHHLCBGBHEFZBAA..dHGFQACF..hAAATEDCXFABGDAEhAAACAGHDGAFAGFAMADE.hABASDGA..cGFD..hADA......hAFA...,2,-38,-25,13
WJdIEbgVRXQPTfcCGBHFeZUANKaDOYLSM,KAFBOEACLEBF.MAACdABBEFEH.VCCGQCGA.hAAATFEDCCHBHGFAFDDEUGBHhAEAAIDG.DCGFSBCBhAEAIAGG..........hAFA......hAHA...,2,-33,-22,11
QAMGWCfKTOYVaDPIRJXZdLBHcNFSeUgbE,GBGACFDGKBFH.OAAE..VBAEaCCGDFEGRDBA.ZFAHBEHHHFCEFADEhAAAeAEC..UGADhABAbGEAECEFAHEE..MFGFhACAfDAB........hAAA......hABA...,1,-6,-43,37
CeZdJXYIRWPGbQDgKFMNBEVSLOcfTAHUa,aDAFCEFAdADG....XEGDRGBAGBBCDIDGFHGEBABE..EAFDSCEBhAAALCADODEGhAAAfBCA.AHCFUAGFhADAeEED.ZEDE.IHACPAHF...hABA......hACA...,2,-27,-20,7
aXBEPZYeOUHbIRgQMLFcSKVAJGfDWNdTC,GECFDACBdGHA.CEAFBDCCZDED..OHEAUGGGHFAARFAA..MBIFhAAALABG.FCHHKHBAhABAAIAE.JAEG..NCCB.aCDHhADAEDEE...........hAEA......hAIA...,1,-25,-36,11
VXQTdBMELUORGZYAbNSDFeKCgIJfacHWP,SHBGeEACKAAA.CEFD.JHDE....aDGEHDDF.VBGDTCAChAAAMCACLFBGhABA.OGDERFGB.GAEDhACAAGBFDAGAFAEBIHHG.fCEDhADA.cBBAPFCHhAAA...,1,-12,-23,11
UFLJQObTNaCSZRMfGPeKcVWIEdHDYgAXB,UABHLFFBOFCATFBC..CDDARGFEGCBD.eAAEKHBA.VAEEhADAECEGHCAC.DBGGhAAAAHIDBAHEFEHB.JDHB.hACA.bFACSHCA.MEAFfHDBhAEA....hAFA...,2,-22,-8,14
ZRAaUJGKDOBNLgSEIHdXCecFWYQfMVPbT,aGDDUDACGEBCDCIDBDFDLADA.SDEDEGBEHACGCFGHeACDhAAA.FGGCQAGGhAAA.MFIFbDFAZAGBhABAAHEAKDDD...NIAB.IEAA...hABA......hACA...,1,-3,-32,29
ZEQJMaUPWKTVSHceAOCXDdfgGNIBYRFbL,CFFEdDABGDAABFHBFCGELAAEZECD...JFDFMACE..UBCBhAEAKBED.SHGGhAFAeFFBAFEH.DIBA..fBADhAAAgCGG.IAHE...hABA......hAGA...,1,-26,-48,22
MZFICYOSXcWdPReHJLVQaADGBUfbgTEKN,BCAHUCBC.....bFCFTFED.KHGEMCDEZCFFFDDACDEGSHEAhAAA.XAGEhABAdDAGPAAE.RGBE.hAAAeEADHAGDJCHF.LACD.aFFEDIEGhADA......hAEA...,2,-20,-17,3
cSDTYXLPBKeUfAMaROIGNQVbWdEHFJCZg,aFEFRFDFODADGEGG..QAGE..VBCEdACDFDFDCDFAZAFChAAASGHBDBAG.hABAXGAGPEACBHCEhACAKCCDeAEHAIAAMGAEIBAD....hAAA......hABA...,1,-21,-22,1
BQLXMUegANTSHKZIfRFGOYcCabdPWVEJD,SGFCKDAFZCEDRFAE.OCCD..CDDCdGGDVCFDDIBG..BGBEhAAALAAEMIECeAFAhABAAHED.HABEFBHH.YDADhADA..aEGA...bCBBEHCA..hAEA......hAFA...,1,-15,-38,23
MDLbPNcCJdWGYXVHeSTAKQUgROafBFEZI,KEHBQCGCRBBD.OFDBaAEBBBGBZBCCDIGELFCB..NEBG.hAAACHEG.dDABGBEE.hABA.VFFESGAHhAAAAAFFfAGHIDAH.MEGFcDDF.hABA......hACA...,2,-34,-16,18
RJQSbINEKTAcVaHYXLBUMeZDGCPOWgFdf,VDAGaCFCHFBB.LGFGBEGBeFEFDBCDCEGHOBBA..FAFGdAFAhAAAJADBSGGGhABA..bBADIAHChACAEEDBAGGE.XDDBMAIH......hADA......hAEA...,2,-30,-18,12
THJIaOWcAGQSZKPLXRYeUDCFVdNgMEBfb,QECBSEHBZCCAKACBLHBGRGEA.eCAHDABAFBGGdFFBMBFBhAAABFCF..TADFhAAAJAHHaEGA....OFABhAFAABGDXGGECCHA.......hAGA......hAHA...,1,-14,-36,22
ZMdNRUYCEBDFVPQIOcaKXSJAWGLebfTHg,LFEFeGEA.TAFCZBBAdGBB.UDABEBDDDDIDFEEH..QAGChAAAIHAH.ODFChABAaDAHKAAC...SEBBhADAABDCWHFA.bDDE.fHGF.hACAMCHFNIAFCCHA.BCBC.hADA...,1,-13,-21,8
IJBYOCgKQWTLaHcXbAESfMFeGVPURDdZN,EAFBSGFHFABD.eEEDGDDG.UDADdFAGZBCD.JDGFOHBChAAAKCGE.QFGBhABALAAFaAEFXBDChADAAHIBMFDDVCGFDBGCBBBA......hACA......hADA...,1,-8,-22,14
LMUZTYJdINRAaPDFOCSXVBcfeKGWbEQHg,aHFGDGHHCACF....XACHBFECeCCGKEGEGEAH.EAGBHDFDhAAALBAFUFADZECHhABATGCFJAEA...NDEB.hAAAAAIFOHDESDDG.fHABhABA......hACA...,1,-18,-34,16
DESaUfWNBGLAPRQcTKedgXFZOVMJIbCHY,QFDHKGFCeDCHdGAEFDBDZAFH..MDDG.JBBECCHBDDBF..SBGAhAAAaABD.fHGFhABABEEBACEG.PAFAhACA..cEGA...XFDDhAAAOEEA...IAHEhABA,1,-36,-43,7
LfCVHJeXFATKBbNWDaPEQcRGMdSgIOUZY,TGAFBFED....bEBDDGEG.EBCDQBDDRDGFdCEG.SAAFhACAOACGUAGFZBFHfAHAhADACEBE.hAAAJHFE.FBBGAABFWFDFaGAH..cDEC.hAHAMAEEIHHH.hCIA...,2,-27,-20,7
ZgcdUWIXLYKGMeBFEbSANVTaHOPRCDJQf,TFDHaDBDHFGD.OHDECAAF..JEAEQAABZGFE.dADFUACChAFAIDDF.XAGAhABAKCHHMHAGeGCAhAGABBGFbDFGAGGE...NCCF.PEEADDGE...hAHA......hBEA...,2,-36,0,36
ILUTDCJXBFcgANOKMRPEYZWedfQGSbVaH,KDCDMECGRAFC...EHACZEEHdDBCQEGH.GAACVFDAaCAGhAAALFAADHGC.CHDBJADFhAAAXAFB.BDHHhABA.FAHDAIHA.OAEB......hACA......hADA...,1,-24,-25,1
bGFJCfgRQZNacPeILOXYBWTASUMDHdEKV,UAEDDAGDEAHHKBCD.GDEHCHAA..RDBGZEFE..aFDEeBBGLDAGhAAAOEABBFAA.AICEMFHBhABAdHGBFADC.JFDBfAHEhACA.NHCF.cCGD...hADA......hAFA...,2,-29,-25,4
YbPFGZRWafLUCSOdDecJAgEHKTBQNMIVX,ECFCTCCBBEEG..QFGFMHBA.XGAH..bEGFhAAAGBEBZACAREACfCCEhABALAACUDFD.hADACBBDOEBCDGGH..cAGAAEAF...hAEA......hAFA...,2,-24,-13,11
LedFSbaPYDUBWVQTCZAcGKRENfIHJXOgM,KGAHRDAGEGHH....IGEFXAGCMDFEeHCA..FGGAaEEEDBEGhAAAUBCCBDBE.QACAhABACDFFAGGFGFBF.NCHG.hAAAfDEE.OBFEdABCSFAFhADA....hAEA...,2,-38,-8,30
GLafIARYOKbCDPQgXBFTcUZWJENVHSdeM,RFDFKDCDCEBG.DBIF..QBGEBHEAFBAD.UBADZEDB....EGHFHGFGhAAA..dAGCMECAhABALFAGfAEGhACAAFGD.OHAC.PDGBXABB.WAEHhAAA.....hADA...,1,-22,-44,22
PVOBRKfgUbMYSEZecCXGHJDLWadANTIFQ,TCBCQGBC.OEHHBABDKEFG.UEDCMDFE.SAAChADAeCFACFBEHADELBBGhAEAaGGB.dEDFACAGIHHGhAAA...PFABRAFCfGEFhAFA......hAGA...,1,-20,-22,2
FKQXJaBDYeLWHgdOCZNRAbUGIPfTVSEcM,UFGHGAFE...fGGBSCCBEAAFFAHD.KBEGQFDChAAA.aADDBADHhAAAYCABLFAGgDDEhACAdDADCHAGRFDFIBAGPHAE....hABA......hACA...,2,-37,1,38
dCOaPQBEgLHFNZWVXUSeRTIAMDGfKYbJc,DFCBKGAH..JACGdDAC.aCDDBBFD.LDCDFBGAZFGB....XACBhAAASEHHeGDAhABATEEA.AGEFMAIBhAAAfHAB.bDFCCBBGOHFE.PCABhABAECBG....hACA...,1,-23,-41,18
DSQARfbPTWCFOLBdeGVHYXUJKIZEacMNg,RAAD..fDBDTADEFFGEBBHA.dABDVBFBHFDH.UFADKHBAZDAEhAAA...aHEENCADSHBGhAAAAFEF.hACA.PFACWFFECGGGLBHHeBEH...hACA......hAEA...,1,-12,-23,11
SNgKCZXURWPcIOHFdeTaJBVQbAYGMEfLD,MEAELCCHDFGB.SAGDKAAC.CGFCZDAHUFCG.RACC...PHFEhAAAOHAC.dAHAaDGAhABABCCD..bABAAEIHEBFHhADA..fHBHXFAC.IAHAhACA.eFDC..hADA...,2,-35,-23,12
bTNWDXRecGZVfPLgAMOIEdFaYCJUSQKBH,OCHDEAFBdHAH.FBACCGGE...UEACKCFFBCAGHDEH....bADGTAAChAAA..DIAARDCHeHDGhACAGGCF.fCDAhAAA.........hADA.gEADhAEAIAHAaHGESEGE,1,-29,-30,1
gXVIMJLDWcEdKfHORASaFUBTPQebZYNGC,FDABTABHQDFD.ZDDHNHED.GDBECEAC...VGFEJDEEDCGChAAAEBBC.dAGHKAHDHDCBhABAABAB.UADABDHBeDHFhAHA............hBAA......hBFA...,1,-20,-22,2
ZSGKMfIDNFXUWQRJaECAYVeHgdLbPOBcT,VFDFeFBBdACA.LAHBODADBDCCZGEAKBEH..MAECDGGAFEEChAAAUGGE.RBCG.EBAFACAFHCFChAAA....PAGBhABAcABBSEAEfGBA...hAEA......hAFA...,1,-18,-24,6
dZUAbMaBVCTEHJSDfIYGPXgWQeFRKcNOL,MHFGBHCHCAAFHCCC.SEADDEGH..IHEFGCGEXFCHhAAA.WACChABAQBBEFFEC.KHAEhACANIDDOBDAZAFHAAIBaEABEHAEJFCA...fBDFhADA...hAGA...,1,-8,-44,36
RCdDIGMWFeabNOEfHXYUcTABVLKgQJZPS,BEFAVDED.KEDE..QDBGJCEE.SGCBCEBG.dAHChAAAICBCMEIBFGAD.hAAAaABEOCHFHBCC.UGBEhABAAEAD.LAEGPHFCDAGFGEGE..hACA......hADA...,2,-40,0,40
CKcVbJIfZHRLGMNXAPdWDSQTgFEUBeaYO,dHBHDGHHQBDAFDFHBDCG..eCHDaBAEOCGFKBDB...VFADhAAAIBFBZDAELEFBhABAGAAE.MDIDAEAFSGDEhAAAEEEBCFCB.JHFE......hACA......hADA...,2,-37,-7,30
dNPBDVfbAgQWHUCKYTZFGLEeMaSOXcJIR,QCBCUFDHKGHBZBEGGDFC.EGBHMBCHaHDE...OADAhAAAJAEERECBdABDBEHH.DIDEfAHAhAAA.AIHA.hACAHDECCEEC...FHAAeEHHSBADhABA......hACA...,1,1,-36,37
OgKGZbVEWfCDIXLTAUQYSdFJeBcaPRHNM,UCGCSGFCFFFDBCAB..aEEEHDCDMDCHKAFDZGBE..EABBfAADhACA.IBFChADALEAHAAIBdBDGhAEAJHBEeCDGRBGFOHFE.......hAAA......hACA...,2,-32,-10,22
WVARHOLbYdSFgePEBIMDfcZTUCKQXGNJa,RDBGLFFCdGDHFAEA.eGAABACGMCFA.DDDFZCGF..CCBH.QBDHhAAAGABF..aEAEAIHAOABHhADASHDEEGGE.hAHAfHGB.......hAIA......hBAA...,2,-33,-25,8
XdgFSKIHZeRYCQTcLPUBMJaONVbfEGWDA,dGFCFAFBKHACHDFCZDFERFCFQDBC.LBCGBCBHMAADaGAF.hAAAOHFE..NBAE.hABAVDCFEAHBDDDE.AIHA.hACAXEADIGHGCFGE......cBCAhABA...JGDEhACA...,1,-1,-39,38
WMGJDBXSeKUYdcVaHIOZfQFPRgALNTCEb,LDACCHHG.EGDCMECHGCGAJFFEBACBSBFC.eBAChAAAKGAHUAFGdGAC..aCCAhABAOAAH.QCCFhABA.........hACA......hADA...,1,-24,-50,26
LHdVWCNOJSEIPXUFZeYMAaGKRbQTgDcfB,KDAFQFDHDGHFBEGEdGGD.CCFC...JBFDEDEB.....IEHHhAAAUACAFEDCZAEA.hAAAMDCBaGFB.GACEhABARFAA.gGABLAHF......hACA.WAHHNEIASBAChABA.,2,-45,-8,37
SdRBKWNFXHJPUZVcICALbMaEOGDefYgQT,MDEBaEEDGBEDDDHF..eABH..fBADQBFFdFHAREAEBGHDhAAAKDBHFDDGHGAAPFBBhAAAZFEBIADFhABA.ADCF.EACG.........hAFA......hAGA...,1,-18,-22,4
EaYXZgbICWMVQcTPRGADKfNeUOBJFSdHL,DGHHKHBGeAFEOCBDFDGBHGDE.LBAEEGHF..XBDBhAAAZDFAIHBECCFC.MEABhAAAVBACQBFEhABA.PDDBAGBENEFGJEAASFFC..hACA......hADA...,1,-13,-25,12
gRdJMDafNWTcKCYGSVEeOPAQZFbXIUBLH,FDAFXCBCUDECHFGFRBFG..MDIHDBCG...aAAB..fECAhAAANGAH.TAGFhABACHEFGDCF.SGGBhACAEDHDOFAHAFFEQADFIGEE.BAHChAEA.....hACA...,2,-34,-12,22
JYVMCBeNKHIXOdWQTDbRaPESLfFZcgUGA,JFBBVFACBCBC..eAFEHADC..ICEGXEDC.dFHGQGFGhAAADCAF.aEBAhABASCDBFEFCZABB.hAEAgGEEAHEBCDHAOFHFbAGF...EAAA.hAIA......hBAA...,2,-24,-15,9
BaZdMgXIcRANQWDSVKECJOHGPbeTFfLUY,QCBCDGHHKACG.EAFAOGAAHFEBGDGE.eFCHTCDFhAAAfADAUEGDaHCEMDEBhAAA.IABFhADAACACSAFBCBGAJFAB.FAHF.BFEG.dEAB..hABA......hACA...,1,12,-35,47
YCHBLFNdSREOQPAafUbeVMIGDcTJKWXZg,UGBCeFBBMAADGDFADHEC..JCACKBHFZEDF..CDCHLBBChABAdAEERAGB.EEEHOAAA.hACAAGIH.fCFEhADA.IHAC.cGGF.XAFBhAEA....hAIA...,2,-36,-30,6
aeOVQUCJMNbFgAPRLXTKEZdGBISYWfcHD,RFDFLDCHKFAGZCDG.BFFF.SGGE..fABEhAAADEECaBHD.OCHBQACDhAAACADAJHAC.bFAFAGGE.PHEChABA..TCAH.EAFHIAGFhACAWGFA.....hACA...,2,-40,-17,23
DTQaJRGCSYOIXdAEeFBZbVLMUfgNcKPWH,EEEDBDGFZFBCLBBH.MIEEfBBF..gAFAhAAAKHGEHBEDDAFATFEDhABAaCACJBHHCHCASDDHhACA.IFAGAABB.FADD....hADA......hAFA...,2,-29,-26,3
OdZceLFIBYTEDNJPMXfbKHRWUaCSGAgQV,VEFHODCH.ZEDHeBDHFAGF.BDHF..EGCHDFCA...JAACPABGhAAA..fAGChADAKFAHHFFHRBEHaHCACCCEABEBhAFAdEAE...LAFD...IHHHhAEANBICMBBF...hAIA...,2,-27,-18,9
TPBEacHFWDOUJMfLZAYKbgNeXdIVQCRGS,KHBG..NDEH.dEAFQFBACEHBGEEA...TCBABBAAaGBAFGEFDAFDhAAA..UADAfAGGhABAAIHA.gEFDhACAXAGB.IEADSDDBEADB..hAAA......hABA.WABHMIBA,2,-39,-12,27
dNSTbFZOKYEADCIcBMfaQWHGVLUXPReJg,DAEDCFDGBEFEMBDD..QDCDHBADLFGFUAED.RFBF..JDFEdHEDhAAA.SHBAhABATAGDFEEHKACFAHHA..IFAChAAAaAHH..........hABA......hACA...,1,-22,-41,19
CfMUROXQbIGFWgBYEaDJNcHVASPKZLedT,SAFBKCFCLEDFdDABCABD.UGFH.REAF.XFAC.QCADhAAAbEFEGAAFFGEABCHHhAAAECHH.JFCB.HDDEhABAAHHE............hADA......hAEA...,1,-11,-37,26
LWKQbHUVZFPSCgIETYMecJDRaOdAXGNfB,XFGHGAFEBCCHLEACKDABHDEFZFABFADACECG..EAACMFFBeHFAhAAADCGB.RABH..dBAGNCIG.hADAQAGE.hAEA............hAFA......hAHA...,1,-17,-29,12
UBNIfeEYMXSZOcdVHRCPGAgFaTKLbDQWJ,FAFBTFCELGFC.QACFUCDEIGADECGA..XFDFhAAAOBBHdCHEHBAFPACAhAAAAAIHaDECDIFA.JHAEhABABCFH.eFGD.MIBCcDGDCFHAKGEB.hADA......hAHA...,1,-10,-14,4
eVXfLbQDOBKMgdJFICTSUARZaEPNGcYWH,ZDDFaAFB.EACBGGCF......YAHBeAHHXDGEhAAALDADDBACKDFAMEBDhABAdHGHIHBGSFFChACAAFHH.PBDH.NEAG.cFBF...hADA......hAEA...,2,-29,-20,9
RTcMgELNFUDXZWfCIYeHQaBSOdAJVKbGP,JDCHVDAGGEEA..RDDHMAFALBDEUBGADAFA.ZBAB.CHGA..hAAA.IADBeEHBaCHFhAAABGHH.dHEBAAIFKHBAhABA............hACA......hADA...,1,-27,-39,12
RLKSBXOCAcbEaZTFMHVUgJWPfeGDYdINQ,EHBGTCCBHCCC.UCGGJCGD.....PCAFGADF.DBBDIHFDhAAANCAE.LBAChABABABBCEEAAIDGaEFHMBIHhAAA.....gGCCWFBAfAGFhACAYFHB...hADA...,1,-22,-30,8
NIOfgRKaDEdYVWUPBQTJSMZbeGXFLcCAH,HAADOGEARDCCKGGADAGC.dADG....VFAGUBFBBDCEQEGDhAAA.JGAGMBDA.hACAeAAHXGDEFCECCHDAAAAFhACA.....IHHEaFAG...hAFA......hAGA...,1,-18,-41,23
LRBKbTaPJACFNWGSHEeIcDOgUXMZYQdVf,FEGDGAFEHFBDECDBeHDADHEA.UAAFZCABdECALADCREFA.BHHAKADE.hAAA.aBHFAEDGCEBC..SHDGhABAOBDCMAIHhABA.....QFDCfHAF.hAHA......hBFA...,2,-19,-19,0
ECaKOSJUgYBXFIdZGfQbHWLVNPRcDeTMA,EEHBCEFAKHGE..SFCCUBDH.BBHBFGDCZFABGBAF.QEEGhAAAHAAFLAGHhAAANEAGRBFBDBDAMCIB.AGCB.aHGEhABAOEBAJHCE.........hACA......hADA...,1,-14,-30,16
PCKdVYcWObNBMFJTADgSRGUeEZfHIaXQL,DGHHSCFCRAFBGAAF...EEECHCBE.aGGELFCDKGDHVEFEhAAA....YDHHhAAAcADB.ODAHhABABAGBMAIFFGFFABIDgCDFZFBB...hABA.fABFhBAA...,1,-13,-22,9
NFITbVdQKMCWLHcZOgaXGSAEJBeYRDUPf,BDGFeFBBDFCCUDAC......NBHEFAABTFFG.dACGKCAAMCEBhAAACGFA.LHCGhABAHAEFZDAEOAHDaEEF..hAEASGDFEFDD..RAEEIHHGhAGA......hAHA...,1,-23,-30,7
BGYIHTNQDAPSgcaJfbZdMVUCEFKXOLWRe,SHBGaHBG..bEGFMCBE.UFDECDBCEGFHFAAE..XCFGhAAAOFACLCFGhAAA.eHFCBBAA.hADAIAHCNEEHAEAF.cDCDfDBBdADCKAFBhABA......hACA...,1,-17,-33,16
TegIVYKDMGQcbaFXSWLEAPdNORfHUCZJB,dHBHOFBBRDFBHAEDZBCDBFDDeCAG....IAHBKAGAMAAGQABFhAAA.aCHHFFFChAEA.SHDAhAFAEEAHAHGDNCEG.fCHCCGCC.TBEF..hAGA......hAIA...,1,-5,-42,37
WQDRGcfZEJVCbTaeILMFXUYdgHSOPBANK,KHBGQAFBGFEBZCDAEDBG...CBBE.bEEAeHDE.LAAEhAEAFGACXAACdECEHAFCOHCChABABEBDADDEDDFG.fBCHhACA........hADA......hAEA...,1,-20,-23,3
VeFJTbWYEACIXPBSdZafQHULDGKORMNgc,XGGGSEGDZEBHQCAFHDDDLAFHKGDHREBC.MDAE..hAAANBBH.gACDhABA..cCEGFBHD.hAEAJHACWHBAAIFCCHHGBFHB.aAGEDGFB...hAAA......hABA...,1,-2,-27,25
ICRHBEbLVJPAKYfcQadZFSTOUGgMXeWDN,KHBG..fHBHaGBGZAEB.FCGCOFHDGABC.MBABeAGFDCFBhAAACEHFHBAHBAGELFFBhABAJHDCAFEE.QEBBhADATDCE.XEGBNEAAEADB.bDDD.YFHBhAEASFEA..hAAA...,2,-20,5,25
KNCPdLTGeAJaWMQHUIDZXgcSBFOVEbRfY,aDCDQFDBHAACDCECZBFA...XCAGSEGHFGHFEAFEfGADhAAAKEBD.CHDBdAFDhABATABEAEEF.MECGIHHHhADABHADOHEE......hAAA......hABA...,2,-27,-18,9
fPMeGHLgYSOVBCJUaDNXFWQAcRdKZbIET,RDAGdEHAZFBGEDAC....TAFGMCEHHGCELCAESAGChAAABHHGCCHE.aCFHDDFBFFACAIFE.KABFhACA...IBHDhADAPAAC..eDHB.....YGDGhAAAJHFE.NIAF...hADA...,2,-31,-10,21
CcRMdaLJFgPDbQWHVBAeOXfSTYZNIKGEU,eFCAODAC..SDHBTFAA.ZAAFKFFBEECACACA...RACCaDAChACAFCDEDGDB..QAGHhADAHAFDBAACfFHGhAFAYCHDNIEHIHCG.cGEBhAGAMEEDdHAD....hACA...,1,-4,-28,24
OPMfVDKWaBSNLATIEHbZFecXUQRJGgYCd,EGFCHGFGFCBBXACC.QCGCJADFGCECCGAHdFAF.MBBBhAAAfEAGKEFFBCEE.hAAALEDFABHETGBE.hABAIEHEeAEG........hABA......hACA...,2,-38,-2,36
DXLIPWdOcAeEMFRGKZHYfCUJQbNTSgaBV,MEGFFGFHGEBGKECAHABGCBHF..UAEGQBFF..NFED.gGAEhAAABDFB.DIDAhABALAAFIDHGPBCDhACAdCADAFHEEFEF........hACA......hAEA...,1,-16,-37,21
bOPUTHLeGFRYCXVIDNSQEZcgBfaJKAdWM,dGFHMCCAOFCFUDBALGCAFBEC.RAEE.CBBA....XDAGhAAAIEGDDDDE.QEEDhABAEGHH.ZAGBBBAHhAAAaGBH.AIACWDAD.PBHD...hACA......hADA...,2,-32,-27,5
WgJMVOXIebDYHcLENATfaQSCFdZRBPKUG,aGFCQGAF.FADFdDEFBEDGKGCBUEADGBEE..JBHFMHDGhAAA.OBBBXBAHhAAAeEGDDFID..YAFChABAHACFEBEGAIHESBGGCGAA...hABA......hACA...,2,-31,-14,17
JBaFGMVCDPXQNKIOgHbZEUcWARLdYeSfT,RDEDdDCDeGBASAAD..fBDDBHBCFGEDMFFECFBC.DAGAhABAXCBH.KGGAhAAAgBDCHAFDEBAFWHEGhABAABBELDFA.JFAGaCGD....hACA......hADA...,1,-17,-30,13
RBEXOeFVQHfUSCGYZTLDaNdMbIgWJcKAP,BFDDEGDD.ODHFFDCFHCFCUGAGCAHB..ZFFELAFEDFEC.dCCEMBBDhAAA..IGFDhAAAJADHKAGD.ADBARBEA...hABAeEEEQFAHSACG....hABA......hADA...,2,-29,-23,6
MLfOHCTGXgdJADPZKWbIURSEFcBaQVNYe,ZFDGKHBG...IHEAUDDBSACFFCAHBAAB...aAFBQAFChACA.NDCH.MHFAhAAALECEfBDGhABACHHGGCGEdEAGADGEPFBBWBHH...EBCEcGCAhAEA....hAHA...,1,-10,-43,33
DLgEKANJBIHXCGcOZWPMVSfYFTbaUdReQ,JAFBHDBHGDCBOGDEZABHMFID..SHFAFEFCaGAH.RFAB..hAAADAHDEDGE.ABCGNAECBEAChAAA.CADC...PBFAhABAfGFF........hAFA......hAIA...,2,-38,-19,19
aCRKEXQVHSeDMNTdbWIFGfPgBJZYUOLcA,CHCHRFEEEEFG..XEGDQGCCHCACDDEATBGB..bABDFFCGhAAAGADF..gDEBhABABECBJBHB..hACAZEAFYFADOFHDAABBaAEA.KACA...hAAA......hADA...,1,-9,-11,2
VQHgPFSAdcBaIbEeKCXMOYZGfLNUWTDRJ,BFEDaHBG.EBFGCFHD...OEHDGADGLABAUBGHDEFCRCACQCEGhAAAHAAFFFBG.AEHFdFFEhACAIGFEKHDA.MIFAhAAAfGAA...WFAE...hACA......hADA...,1,-16,-30,14
fAPdUgKOYQTHMFLeRBbEGDJWcISZNVaXC,UGBCOCCHQAFCHAECMIDCLEEGBCHCEAACDAAA..JFHFIECDhADAZDDB.aBBGCFFHABCEhAAAdGEDKHAA..FEABeDABhADARCDE...WDFA......hAEA......hAFA...,2,-18,-18,0
FZfOQDUIHKXPYSNbABLgGJcWaCVEdeRTM,BAFBGECFJADBaCAD...CHCD.ECFBdHGHRDAE.FAGHZGFG..QABEhAAAUAAFHBGDKHDE.XCDAhABASFBAAHAA.hAEALEFA..gDGD.hABA......hADA...,2,-27,-15,12
VOdWTXJPcabCeLZDKNfRIAMGQBUYHESgF,QFGCUGGGHDAAEFADSFCC.FADHOFCHdAGC.XCDEhAAAJAAF..cGDDhABACGDBLACA.DGFFhABAfDDDAIDEMAHFBBBDYEADWEFA.aDGGhACA......hAEA...,2,-31,-13,18
WgPEJBNCcOMGYaKdSVAbZHDQFXeURLTIf,ZGFGHFEEDFBHFDCAUCFGLBEG...fCAA..hAAAPBDFBBAFCGAFOBAAhAAAMFIBGEAFKAHBSEGAhABAADGG.XCAGeHAC...IFDChACA.WHAAhADAEHFC...,2,-51,-10,41
bOWTDBfSYPMCKJNEUceZHGXRIALagFQdV,aDCDQGBC.dCBBbFEBOADC.DEEGSBAB.hAAAPACBCGHGKCFGJHECEEAAUGBFhAAAeFCG.GAGGhABAIABDAGHDgAEH..WDAGBEHAhADAYEFG.MAFEhADA..,1,-12,-23,11
DBUVRYGSHbZeIacXFPWgKLMOfdANJQECT,JDACQGAF.CFAEBDHCUGEDRBFC.GAAFSADHZFAA.aAADhAAAFEEF....gFFBhACAMIAA.dGEEhADAAFBE.ECFCDDDCVCBF.......hAAA......hABA...,2,-38,-14,24
IaFQLTJdXbfCPONSWBKgZAVHEYDMceGRU,HDDFEHFGDHBGMEAF.eHFAGCDEUACGFFBELCHDdEHC.XBABhAAAfACE.CBAC.hAAAPHBAOBFDWBGFhABAKCCDABIH...........hAFA......hAGA...,1,-15,-30,15
fPOVeGZEaIWTNQBDACdUHLbKYgcXSMJRF,CFCFHBCFKGCG...gBGG.SEHFRBFEfCCGOAADhAAAGEGAEEEDIEBEhACATACFBEEHAAFFdHBFLFABhAAAbGFA.YBAFMDGD....hABA......hACA...,2,-34,1,35
YCXGUbafLJeBPdcFSHNZTAOMRKQEDIgVW,MHACQCCBDAFE...VEGHCFEEUBBGaGCF.LFHFBGABdABHFHEAhAAAHFEB.ZEBAOCFFhABAEAFH..ICAEhAAA..WAEGYAHF....hACA......hAEA...,2,-44,-10,34
EAIbeJROgDLTcPFYCQZaBUNWSdKGXMHVf,eGEAOFFCLFBH..TAAFFDDHQABH.BBEEhAAAUDACSAFEhABAGCEBMACAfDADhADAAEEHJHAGDBGA.PHFCYHFG.CBHAaDHFNGAFKDCBhAAA......hAGA...,1,-12,-23,11
fGTIZbVagWYFAJUKQNBHMeSOLCEXcPdRD,UAADQGBCBEEDHDAFeAGHLDEF.CBBB.EFHH.PHCChABAdHFDDDCHGAEHIEADhAAAVDFAaGGG.gDGAhABA.FADFADEGKFCAMDDFSADChAHA.....hACA...,1,-12,-14,2
DfQCJXSFdgUGHbITaVZYOcMAEPWKNLeRB,EHBGKHBGeDCADGBE..QDAEJABF.FEDEUBGBHGDC.TAAChAAAVFCEZFFF..OAGHhACAAHFF..NACB.BCEHhADA.CGGESCCBdBDF....hAEA......hAFA...,1,-18,-34,16
JaVgPNSbTHQMEGIdOWBfCKZLeXRDFcUAY,aDCDVAAD......NBAE.bDEAHBEGQGCAMEBBGEGEhAAAOEAEBBDFKAHHZGFEXEDHhABAFADEADCG..gGAFhAAASBBFEFFEWAHHCDAD.....hACA......hADA...,2,-16,-9,7
SNfLUQFcEIXdTCKRbYDaVOPeBHgGWZMAJ,SDCDLGEAUAFBQGDCFDCC.EEAHdABE.CDFG.RBCDDIAG.hAAAOHFCeEADBDGBhADAGEEBMFFAAAHCJAAE.fAEChAAAIGCAKBDBaGAE..VBGB..hAEA......hAGA...,1,-2,-32,30
AJYZDPHFfLGceQKECNOWMXBISRTVUbadg,JFBBDHCEFECELDDEGCAE..QFEAKAAG.EAEDCFGGOAGHhAAAMBBHBEHC.SACFhAAATADD.UAGEhABAaCDEAAHF...PHFAfGGB..hAFA......hBAA...,1,-26,-36,10
QXaPBRTZNIOSGVbEAHJfdUFWgMcKeDYLC,HFDFdDCDFAEDMBEAKGAA.eDCFLFGB..XFFBBBAEZGDGNCBH.hAAA.ODFESCGDhAAAbEAD.AIAE..JCAFWAFEhABA.DDABQAGEaHGE....hABA......hACA...,1,-2,-34,32
RNbUSaAEJZfDYWcXKMGeFTHCLQgdVIBOP,EDBDJFBBZDCFDFGB..........YADBXABCKBFChAAAGAFCFCGEHFAHLDHFhAAAdEEGBEHERGFG.NBAE.hABA...SHFGAIEEfCEGMFDFCEAH.hACA......hADA...,1,-17,-35,18
CMUbgIZHFSGDRQXKdVWBYAEPJLTfONeac,JCCHLDAC.TCGHOHAG..aAFECAFEUEEH..gFFEhAAAHAGBFEHHDABFRGAGKCEChABA.dACCBFBGAIAAfEAFhAEAeBED.MEIHIDAESGEGhAFA......hAGA...,2,-39,-14,25
aYHFgZJRVdSEXTCKMPLGbADWQOecfNUIB,DAFBQDACOAAF.eDFD...NEIA.BFEDHAGHZEAH.VCFFhAAASAAA.XCDBhAAAKHCALADDhACAGFBDAHGEfAGEIHED.aEHDgGAGhABAdECECHAD....hADA...,2,-24,-10,14
GAFVDRTOKXBLMWfCaEJHQdSIgNYUbZPce,VFFADEFARBFE..KCEDBDBC.LCFEMIDE.CAHG.EACGHBCD.SHDGhAAA..hABANDDAUGAEZFBGeADEAGFHOBBDhAAA...fEADaGAH.dAFBhABA.IGHE.hACA...,1,-21,-29,8
IdQXDCJgBEVAfKPZNTUbOMcYHFWeLSGaR,KHBGZAADUGACOCCE..MCEEHBGF.FABHLFGBGEEBaEBEdHDBQDBDhAAA.hAAACDDBBAEDAHHGfAEFhACA.NEAE.cDGA.eAHB.SEFFhADA...hADA...,2,-27,-15,12
SEHJDNILTbQKfdegWOGFXcYURZaABCMPV,MFEFVDAG.HDDG.DABDLAHB.TEGAQCAB.hAAAfGFAdGCHeBBCgDDHhABAOGAEGDGGhAAAXGGAUAGAaEAHAIECCFFDEAGB....hACA......hADA...,1,-6,-14,8
BCXDUMdVLPWRegIYcQOJFAHEGKfbaSNZT,EBBDKGAH..aFDEZFFEBBDACEDA..DCGGdCHGLADHRDBC..eACFhAAA..gDGHhAAA..cGGGhABAOGAGFAFHABFDfACESDFBNCAE...hABA......hAFA...,2,-39,-28,11
MXJEKGUTRWFHDgBNSQPcVAZaLCfIYebdO,ZDEDCDGF...IHEAeACDOFFE.MIBEXACG.EHAAhAAAKEACGDGERECH.FFAEhABADBAHBAFASHAChAAAPDAEAAHELCFD......hABA......hADA...,1,-20,-37,17
XFDceSGgYQZLKIOHAfBJMPTdWVCbURENa,BAFBMDEBdFBHCAAC.UFFDEFFA....aACCDIEG.eCAFGGCFQABAhAAAKDDFHBDCAHAD.JBHFhADA..TBED.hAEA..bAGF.NBIE.FHGE.SHAGhAHA......hAIA...,2,-28,-18,10
HRKOdaABcVQYGbJgFfeDITLUECNWXSZPM,VDBHQFGH.GCDFJEFD.FDAADIGELFBE.CBAB.NBAE.hAAAXAFFZAGFHBCGOHCChAAAaBBG.AEAHBHHDhABA..YEHFfAHAIGDEUACESFFFhBCAMIAE.hABA...,2,-31,2,33
aVDXPKGQOWReBgLTHdYNEZUcfSFIMACJb,CAFBaDCDDBAE..KAADGBCC..OBFHeEFEBAEDLHFCdHCB.hAAAEGBHUGGESGCHhABAMBIB.ADCDJDAB.XBGFhACAPCEGQDACgEGE...hADA......hAEA...,1,-26,-28,2
PEZFbYQfSeKLGaTNMOdVDXAWBcCIJgRUH,BFDGCFDG.JCBCRAAFHEAF.EGHFFFGE..QDDBSABALAHHhAAAGGDBaFAEMAEHhACA.dAFCDBAHAHCEIHFEhADAUAFD..PEEA.....hBAA......hBDA...,2,-38,-15,23
QHefXdDPaCSNARYBbJTFVGZKMWIEULOgc,BFDDJDAC.FCABGACHKCEC.MGCE..EAACUGGDLFBD.hAAAODHDQCFGhABAeEFF.dAHEDHGEaGACCDDD.SEFAhACAACCH....bAFA...hADA......hAFA...,2,-36,-24,12
HMcegaVUFbLBIYRdDAZPSKECTQNXJGOfW,ZDAGSAFBEGFD.QDDGXEGB.OCAHHADCMDFG.hAAA.eCFAgEDChAAAVFFBFFBHBBHDIEHEhABAdCAFAHHDPHAGCBBB.......hACA......hADA...,1,-5,-22,17
TKYNZVaXPQgFeIUHcOBGdSMDbELRJWfAC,CFCFKGFCZEEF..aCDBQBCFFFBA.UAGAOAFE.dABBMIDEhAAADGIBLEFARDGB.hABA.fGBGhACAAIDG.TDACNEAA..XFDD.gCEChAAA.ICBFhAEA,2,-35,-32,3
ZFOBReIUQKLGANTCWYbSEdMJcfHXDagPV,CHHG..bAADdADE.MDEGJGCA..HEAHDEEG.aDDF....PCBDhAAAZDFCFAGG.BGFEeEGHhABAQACEKBFALCADhACAAIBANIDF...YHBA...SDDDhAFA.EAGEhAIA...,2,-35,-14,21
KHbXQgVGREBUZdfTCJPeWDIaALFNYMOSc,FDCDMCCAOEEGKEEGHCFG..QBEDGCAABEHHZFGFdAACCAHCeGBChAAADGBAAHDFLABEhAFA.SGEAhAGAXAGAgDAFEHGA.fADFhACA......hADA...,2,-32,-7,25
fAdTJWaOSBPDbYLVNEQCXRIZGFUgMKcHe,dGDDTDACJCCA...aFCAOAFG.BFFBbABB..LFFDhAAA.VADFNAAB.CAGGRDGBZFBFhBAAFGCHMIFA.HBGFhBBA.....AEEA.SGGGDEBA.hBCA......hBDA...,2,-35,-8,27
SIJBGPeYCdRgEHAZDOcFLQVbNKaWMUTfX,DAGDFDCDLCHHQGDD..VAACKDGBMECAUBEF...XBBGhAAAJHBGBDAFGEAEhABA.eAEHCGHAdFEFgGGEhACAAAFC.OFDA.....hAAA......hADA...,1,-9,-39,30
LHSBcfMCJXZPDNaQeUOTbAGdIgRKEYFWV,dGAHRAADEGAHFDBH.LAFABGHE..MDCCCDEHZEGHDCFA..QGDEhAAAUGEB.OABDhABATACEADGG...IDHHhAAAKGFB..YADBWAFC....hADA......hAGA...,1,-28,-39,11
beMgKJDNACLXOPYSdHQERZWGcTBIFVUfa,LEBEXDAC.OBBA..PFHHdBGEEEGDRDFCGEDCBGCDFGADhAAAUFBA.aAACMFFDhABAJCDEACCASAGEhACA.QGGBcBGA......hADA......hAEA...,2,-26,-12,14
HKXFcgRIfPDGMZVbUQOSLdTEWaYBNeCAJ,JDCHXCCB..FGHBRAFC....fHEBGAGEMBAFVFFGhAAAQBDF.hABAOGDEdCHAWEAHBGBEhAAACFDDACAAKFFC..IADFZCADSGADhABATCEC......hACA...,2,-27,-16,11
XVdKMYFOTCcRNQHUPgbLSDfEaAZWGBJeI,ZEBHGGDHBEHBeEDC..IFDCdBAEKAEDMAIFFABG..CAEC.NBHG.hAAAUCDF..bCDGDGFEhAAA..EFAHAICAJAHF.hABA.XGBH.OCBD...hAGA......hAIA...,2,-51,-5,46
BXaCZKTNeGMPdcAUgSEVOFIDRbQYLWfJH,SGFCEDBDFACG.DACGRFBC..QAEELEDBJCEEHGDGaAAFKCCChAAA.TDEH.eAHBhABAMBDG.PHAEhAFAAIHG...gDGF.IAHHhAGA.bCBD...hAIA...,2,-16,-16,0
IXROdQZEBFWcfDNaeSTVGLPUYbJgMHKCA,REFHdAADEEDFBHFF.FCEF....fBEGDFADeEGD.SDBEhAAAGDCELBHDhABAUEABJAHBHDADKABBIHHGhABAXADC.OHAC.WDHHcGAD.hADA.aGCE....hAEA...,2,-19,-19,0
VOfbXDKFHeUWPNEdcTaAgLQBZCISMJYGR,LDACQGDCCHHE.SBEDMAAE.GAAGRDFBOHBG..hAEAfCGCXAFBKBEDhAIAeFFB.UAGFNBIAEFDChBAAdDCA.cFAHACBCBFBCIHHA.YDHBhAAADBBE...hBFA...,2,-24,2,26
dVOFWTDCQgSKcLXHZMERUafNGYeJIBAPb,dHBHVDEDOAAC.FCFFDCAD.CGBG...SFEBKHCGLCBHhAAAHEGDZDCBEDCAUGGEaADDGFAFhAAA.JAFEAEHHbBDAhABAQCAF..XAGFMIEE.hACAfABF.hADANBIE...,1,-5,-22,17
fJbXZSWVGUdcRNQYBACLKPaTEMgeDIOHF,KDABTGBCEAGE...eDEADDDAHFFFFEAB.JABHZADG.SHEChAAAGCGEUGDAdABENAICBECDhAAAACFG.CAFG.LFDAhADA..aADBMIFC.......hACA......hAIA...,2,-27,-9,18
dfJVCScUMXARLEeNBFKPYIZQHDTaOgGbW,RDEDEGDBeDBBBHBB.KFEG..IAACHDBBaFHHGAGA..dBCFhAAAfAFACEECUAGEAABCLDDEhADAPACAQGGEhAIAOEAH.gGDD.bCCB.hAEA......hAFA...,1,-1,-21,20
cFTdIVKESULNeXMZOGWDARbPHJQCBaYgf,RAADHAADCGDC.BFGB.aGBC..fBEAFAFHdEAHKADBUFGD.LFEHhAAAXGEAOEAEhACADDDGAIBG...JAHFQCGEhAAA.cEEGTGAF.IADChAFASAGEMEEA.hACA...,1,-21,-32,11
FECKJIZcTBVWQLOGHbaNDgXMdYUfPRASe,SEEDeEGHCBAC.KAEDZECCBACGQFACLAAFHGCE.NCDH.hAAAXGBB.dGGBhADAfDEBAHDHEAHBIDCFhAFAcBAD.WAEEOBFD....hAGA.aHFCMIFE..hABA...,1,-20,-22,2
DZXIOLPAJMeCHGTQBYURKcFENdgVWabfS,eAFECBGFHFEEGEDFBDDCUBAAKGBAFGGF.dBDG..VFAC...hAAAaDHFSGEDhABA.ZBFAOHFEAECETCAHhACA...........hAAA......hABA...,1,-20,-43,23
DYTAaKCFXJbOPUfdQRGVZcLeBNgWMSEIH,aEHBKEHBFAAA..JFBAOEFH..UGGBdHGDRECFZCEF.LAABhACABEBE...gBGGhADASCDGEDBCHAEEhADADEAD.AAIDCCHC.XGAGPHAE....hAEA......hAGA...,1,-23,-36,13
RcGUeYOSKTgVNaJXQDECHfMAdIWLZFbBP,dHBHLGEAZDEDBDACRCEGGDBCUCCH...OCABKBFG...gAADhACAaGHB.XBGEhADAEHEECABD.MBEAhAEA.AGIDFEECbFAGeCHFSGAD.NIEF.DAABhACA......hADA...,2,-36,0,36
NWBRFSOIAGfKUdJYXLHZcQeDgEabVPTCM,KGAHUGGDdFEC..XDFFZABGeBEA.DAIFEDCF....aHGCPBBBhAAA..MCABhAAABAGAFDCFSGAAhABAAEEG.JHCEHCFCcADEgFGE.hACA.bBFA.CADF...hAGA...,1,-25,-31,6
gDJVFMUXPfKCLYZAQGeOTScbHRdINaBWE,QDACOHDA.SEEHHBFGdEDGaBBEEBCD.DEAFFAGF.MIDGhAAAXGGHKGCA.CFEEZFBFhAAAABIFeGFC...cAEHhABAIHAEBEDEWACCJDFA.....hACA......hADA...,1,-17,-24,7
WBMNIGCcUFDHZgeVYTRbPLEJfSOQXdAaK,aAFBBFED.MBFHGGCFUCGCDCAE.ZCDAeACD..VEABRDADLFHHhAAAEFGB...SADChABAOABC.XGAChAGAAIBC.........hAAA......hABA...,2,-33,-27,6
RXWIUMfKEQZODgBbHLaGSFTAPYdeCJVcN,dHBHeEGHCFHG...JCCG..VAFAREEH..XEABUADAKDDCEADEZAAFhACA..DIGABGECLHBGhAAA..SDGAhAIATCFCABADYAHH..WFFBhBAAMFAB.fBBFhABA..,2,-48,-14,34
QKHcFbPWMOXYfeJBUgTELVdACZNDRSaGI,ZDBHRFDGGAAFKDDGFAED....bCFAMIDG..XEACeAHHBFGDhAAATDCHEACDdHAFCBEHDGCHhAAA..aGDE..IHHEhABA..cEGAOFFA.fBGFhADA...hABA...,2,-37,-9,28
BGYcSFRaVJOTMIbCPLEZQKdNADeUWgfHX,DECDeDACUBDH..fAFDBEGAGEDGSFFBFHAG.RABCJFBFhAAAMABA..CHAGEFDHhABAKBBBAGHHHCEA.YEHBhACAaBGF..........hAEA......hAHA...,2,-49,-13,36
aYACVLIbHNcTfXBKRUMQSgFWdEeDZJGPO,CEFAVFDFLEDD.HFABTBAABCAGKDBHUBEB..QDFEhAAASGGDFAFAEBBEDDAFhABA.ZBFE..PFHDhAAAaGGHIDDE.NDIE.fAGBhABA.MICA...hACA...,2,-20,-20,0
ceOSIDNPGRHTJdVBLYaUEFXAQfZWgKMCb,ZEFHKHBGCAHDeCAD.OFDBDBACGDDD.HBCEdCDCBCBELHFGhAAAUAFEEFBGAHBA....hABAfABDMGFASCABhACA.IGAGNIEF.RAFB...hADA......hAEA...,2,-36,-16,20
MNZOEDagbWPcfTeRYCSFGHKJVQAULdBIX,UGGDBDGFMEACOHCADCFB....aBAA..bFGD..PADAhAAATFBA..eCEAhABACACCFBCEKECC.QCAChACAAHAALAAFIFEBZAFAEFFB.cDGB.hAEAfHAD.hAGA...,1,-17,-29,12
UdCgTNMOFQWGIVRBXZDfKHEeLYaPbAScJ,JCCHUGAF.CGFE...TEAFMBAG..FAEAQGFG.GAEBhAAAVCFCRDAGBABFDIEA.hAAAKHCC.eBCGLDDHhABA.aBCEADGD.SEHH...hADA......hAEA...,2,-33,-27,6
aQYJEPTMNUfgXbGDKdCcIZOLBARHeFVSW,RDBGHDEDFBHB.SAGB.QADCJAEBECAA.TGCHUFGB.hAAAfCAH.hABAgDBAbGCA.hACADIGAKCFBCAAGIGGG.OFAHBGBFAAHGhADA......hAEA...,2,-38,5,43
dTXZIKQBCbUYSaWDLAeEfJHVNMRPgcGFO,EDCDJFBBHDEH..MGDARBBD...PEEGGBEB..FAEGTGFEhAAAXBGGKEADCEHHUAAChADASBDCDDIBLHBChAHAAEDH..........hAIA......hBAA...,2,-28,-25,3
SGBUHcJYdMTeAQKNbCfPEaLIWFRDZgVOX,KGFCCFDG.EGCHLECD.FBEARDBGDIFCZBAC.OAGHGEED.BHEHhAAAUABH..JFABMAADhACAAGHA.QFAFhAEA..NADF.fEGF....hAFA.aDDA.IAHAhBEA..,1,-18,-43,25
ZFKXWTgCHLUAJGNdRMOQPYeVSEDcBafbI,GECFdCFCOHDCQAAB.eADESFADECHFBBDCfDCBhAAAbGDG.IBADhABA...KGBChACAXFGETEGHCADFLCCAABEH.NIEF.MBFChAFA.....hABA...,1,-14,-25,11
dWfTeFVcSHEBLAJORIQNGbXKCYaZPDUMg,RFBGQCBCGCEDKHEEaEAH..DAADUFBEdBCD...TFGAeDAH.hABAVDEESFFChACA.BHHGJHDEIAAHhACANAED.CBDG.........hADA......hAEA...,2,-30,-25,5
IFOgGbdJSKQDRTcaVeBAYWUCZfNMPELHX,UCBCZDBHMFEFEGHDLACCHAFHFHAA..GDDBdFEBKGDFRBCG..aGGDeAGDhAAA.AIGE.CEAD...hAAAfBDBNABF.hAHAIDFD.OCHD....hABA......hAHA...,2,-29,-15,14
dEZRPYgaTeULVCMKbJISADWBFGHNQXOfc,DAEDFEGDGECEHFECQAFGOBEG.dACGZCCARDBD....PAAFhAAAaBABTGAG..hAAALDDCMIFEKEADJCHBhAHA.AIACBHCENCIC........hAIA......hBDA...,1,-15,-20,5
PSNYWIdAQGMJKReOXZVDLCcTHUEgbaBfF,MGCEJDCH.KAGGOGEAZBAG.LBBE..CDFAHEAAECABaEEGFHGAhAAA.SHDChABA..NAHE.ICEDhACAAFHCRGBE...........hAAA......hABA...,1,-33,-39,6
JcQCfgDSUbEeZPYHLMFOABRWGdTKIVXNa,RDBHdGAHKGDH..IECB..XGACJABC.CFDFDGHDUEEB.hAAAeHDEZBBCHAEAMBFEAHGAhAAABEACGCDF..hAEANCICaGFB...fACF..hABA......hACA...,2,-32,-29,3
bLWdJPeVYaQECfSRDBIXOUgKNMTcGZAHF,HDAGLCCHJDHB.eGCA..VAADQDGDCDFC.RAFFDIGAIBHChAAAOACA.UBAEhAAAKGFDMEED.TFADhACA.ZADC.AHAF.WFBD.PCEH.hAEAaFHH.....hAFA...,2,-23,-12,11
ORLeWMdZIVFKUJHbCXcGafQAgBPENSTDY,BFDGEHBG.SAGEDAFERCDCLHEA..MABEdFFCZBGDFGBHKBEChAAAHEBACEHHGGEBaDABACAC.hAAA....NEDFTBBFhAFA.....YCEG.hABA.OABF..hADA...,2,-25,-22,3
NSCaUOGRYdABfcILDgKJZbPEFQTVMeXWH,BFDG..IFEDLBEEDGDBKCDFJHFCZFFA.EEFEQCAGhAAA.MCECXBAChAAAHDFDCHAAUEAGOEHFhABA.GABFYHDGAAGD...fHAHhABA....hACA...,2,-36,-14,22
VCTJZGNeAKBSOgMIPHDRQdaFLXYWcfEbU,KEHBOCAFMHCCHFBG.RGEAdEEHaECA.LBAE..XADAhAAA..YCHBhAAAfGGCUAEAVAGDhABAJHAC.NDAGBACCSDDEPDFBDIGC..FCCChAEAEAGC.....hAGA...,2,-26,1,27
YOVFNLRgGKHCPSZMIJQeXfTWdDUBcEAab,aHBGOGEA.FAEDLBGHGAAE.KDCHCEHB.SHFAZCFG.JAAChADAXDCE.TGADhAAADCFFBEAD.cFFEhAEAEAGCAADC..........hAFA......hAGA...,2,-45,-25,20
IbMBEGScdfAgXQRJPLUOYZNFaDKVTWeCH,XCGCRADGLFEFUCCDODGH..ZFFFaDDCDHAC.KAAC..TAAHhAAAeFCGHACA.hACA.IAHBBFHEEAGDhAEASDAA.cFAAAAIH...hAFA......hAHA...,2,-26,-25,1
FVBKbQHTEDYXGfcICWNOLRMJSZaAedUPg,dAADUCBCFFHFBGDFKDGD.HADA.DEIDGEDA...IDBBhABANAHCLEEHMAFF.SHAAhADAAGACeAAF.VAGFhAEAQGGG.YCFHfECAhAGA.cGGC.CCCB.hAIA...,2,-27,-26,1
FLfKeaJIGQRbZCgTNcVPDBUWEOXYMSdAH,HDEDLCCHeCCBJDABQFBCZABA.CABE.TGEH..NCEB.hAAAVCEHDIBCBDAC.hAAAEGHBXGAHMFAHAHFB.hADAKDHF.IGCC......hACA......hADA...,1,-19,-29,10
aHBURdPeTFNESQIXgOYGVKbfZLAWCMDJc,CBFDDGCG..aBAGUBEG.RABH.dEHC.eEDAFDHB.ECDBQDAHhAAA..IHDHhAAAOGFE.GFADKHCA.fADFhABAAIFAMADE.HGFABBHCTCAESDDGhABAYAHF..hACA...,1,-19,-31,12
IOaFWRAPVECbZHKeXJGdTUYcMDgBSNfLQ,VDAGCFEDHAGB.KDFHeDGDGBBD..dBBDUDACMIBGDHGABHEB.hAAASEDHLABCQGBGhAFAOAGDaADA.hAAA..WHEGAGIBEGAC.......hAGA......hAIA...,2,-23,-22,1
dEWPVDBKIfFcQOXSTMLgHNZeCYGaARUbJ,UFDHdDCDEAED..VBDBBCGF.KGHDFEAF..QDFBOEHD.hAAASHBAMCCB.hABALBAANIDH.CFAF.hAAAaHAAAHFA.RCGH...WGBCICAH.fAGDhACA..hADA...,1,-32,-33,1
FQBAIgDdVYOcKfLSWCXbaZReEHTNGMUPJ,DACBdCFCOHDEKGHBLDBF..SAGACEGF.aBAFRDDDEAFEhAAATEDB..MICAhABAUFGCFAEHAHCA..IEBDhAAA..YCFG...fEHAhADAbFAGZACE..hAHA...,2,-45,-16,29
PIaEObRKdQXAGBgeSNWDfUFJHTVZMCLYc,GGDHBAFBSEFDDDGCUADHHDDBZBBECHBA.LBAH..PCGBhAAAIGBE..hAAAEDDH.OFHFKAGC.hABAdDADAEIH...eFBG.WBHBFCCH...hACA......hAEA...,1,-23,-26,3
WQXDCUYJGVAbRNFTKgHSdaIPMfEZcLOeB,RAADTGBCHFGDdEBC..aBFGMEAHZEAEOFEEeGCABDFB.QACEhAAAXBCCCCAD.JHDEhAAAADEH..NIBD..FBHB.hABASDDDIHHGEDGE.WAEC.DBIDhACA......hADA...,1,-9,-24,15
dIFDOgbBJHPNQeCETUGRfSYZLAKXMcVWa,XAEDMECG..VACGdGADFAAF.OFEDBAGFJGDE.HCADhAAAQCCHEBGF.TEAGhACAGDGCRDFCfGGFhADAYFCD.ABIBKHCAaGHDDFAB....hABA......hACA...,1,-12,-19,7
bXOUBHcLGQfRYFETWSZdKMaVDAJeNCPIg,JEEGeAFB.CCED.....ICEFXBACOFHHUDBFBAAEhACAHAACGGABQFFGhADAfBGARGACFEGA.TDAGhAAA...WHDASAGBdAGBMCDDhABA......hADA...,1,-20,-23,3
QNWAbZaXUcYKDPRdVgSMFeHOELfTBGIJC,ZDAGaEHB.UEECKHBA.DGBCREED...dBAG..SAGFMIDG.HDAAhAAALBCETBCGBHBFhAAAJFDH.CHGB.QFABhABAAEHE..bAGFcADA...PAHFhACA....hAFA...,2,-40,-17,23
BePLOZVSHRbAaXGdKIUWDYTfcNCFMQEgJ,XBCBKDAFUGGE.DFGB....TAAC..cGADFCGHQFCGhAAAECAEBBFCPEDBhAAA...OEHHhABASCEHbAGBaEABIBDHfCFAhACACDDFMFBF.eAHD.hADA...,1,-26,-29,3
fVCRSYUOEWTbKdeZXJFGIMaPDLNQBAHgc,HAAD..fGFCVDFFCHBC.SAGHOAFA.TECDhAAAKFDAeDADJBDEFBAFGACEhAAAMEHHDGIB..QDABhABAACID.........hACA......hAEA...,2,-25,-19,6
NQRSVbDFJZefCPMKGgWUdEABTYILHXaOc,TGGGLGEA.aCEHOFCA..QGBGRAEASDCADBACFCAChAAAJACHZCGBCEBE.MBAHhAAAGAFAUGDFAAFFBFFBhABAHFAB.NEIA...........hACA......hADA...,1,-7,-28,21
aLYODfXSFEPcKUABMGZHegJRQVTCINWdb,BGADZGDAeCAARDEH.QAEBCCCB..IEHFdEGFaDDAOECBhAAADAIB....SCFEhAAAPFAFKFGGABEHHBABhABA.JFAA.TGDH...WACEhAGA.....hABA...,2,-36,-26,10
HJbVBYXdfgcaDFNeGPKTUZCLRIMOQWEAS,SDBDHFDFVCFDBHAHdFGF....gCCCaEAF.DFEHhAAAFABHGADBPDBAKDGGhABAUGGACCHELGAEhACAMFCF.OHACQAGFABBGYFFFcADG.hADA......hAEA...,2,-16,-7,9
ZBKLReaYMTEUdfCWADGgNJQPFXOcSHbIV,DCECGAFE.JDBAFAGF.ODDCHDGFVFABBBAELDBD.hAAARFDB.eACC.MAIBhABAEFFGdACFfFEAhACAAHHD..NBIC..........hAHA......hBAA...,2,-39,-19,20
fGKAgOIUeZDNHLcSYBJbMRXCTQVEadFWP,OGEAUDACDGIBHAECLEEDSCBB.BEFAMCEGCFHBQFAGhAAAEBAC.FABEPAEEhAAAKHEGAAID..eCFAhABANEDE.JECE..bFFF.......hAEA......hAFA...,1,-15,-33,18
CgXOaeEKMDTVdFbLJYUfZBWRGcQAIPNHS,..IFDGHDEGCDBAOADD..aBFHKGGAMECCDGAGdCFBFCABJAFAhAAA...UGFCBHFDhAAARABGGEAEAHBBNAIC.SDHFhABA..XBAGEHCA..hABA......hACA...,1,-11,-44,33
QZIYLXSRgKfcHBaAUEMNFTOCDPbGeVdJW,EBDHMHFGFDAB..CEDCDAHHGDED.dAGGQABHZBBFLFCDSFAFhAAARFFAKACC.HGBAhABAAIHA.UEGH.TBEHhADAPFDD..........hAAA......hABA...,1,-19,-24,5
AHeaIBGfVWCJENOTXPFdSULQcbYZDMgKR,HDEDaDCDBHDFVGFA..CEAC.EEAG...TADGFAGGdAAFLCAAhAAAQADC..cGAChABAZCGFDGGBMDIHKCEARFABhAFAICGA..fEFCNEDAPAFA.hACA......hADA...,1,-3,-31,28
WeVHMgfRTXQLcYZKJOUPDSCNAIEbBGdFa,EHBGBECDGCBDaCBB.eHFAHBGB.MADGRBGHQEGBLHFEZDDHhAAAOEAH.UAACDICC.hABACADDAIAEIBFCdEEGFFBA.hAEA............hAFA......hAGA...,1,-2,-29,27
CFbVcGDYMARJZPOTSdQaBKgfIHEWNUXLe,RDBGJFBBZAFH..OCBHSBDA.dAHEBGFD.KAAG..fFHAhAAAIEGCHDDBhAAAEACFUFEFeADGCCAH.FAHDhACA.....cGGADIEE.AGAB...hAFA......hAGA...,1,-29,-36,7
cdEHUJFTPAYQeaGLKbDfZOMIXNBVSgRWC,QDACaAEGLDFGDAIHZFGH..MDIFXGDEBAGD..VEFHhAAASBFARFBG.CDCEEDAFhAAAJCDGFABFAFBA.eHCAhADAKHAE............hAEA......hAFA...,1,-23,-28,5
PIdMKOAGTUeERNCVFHbDQJfLaXWBZgYcS,TCBHUGGDRGCA...CFAGHADADAAF..QDAELFDDaFHDBBBFhABAZCGD...gGEBhAAASCEGdHAFOEFAhACAABAGEDEC.FAFC.fBHA..hADA.WCCB...hABA...,1,-14,-33,19
MGHfFLgZNcIKCVJbQAPdYaBWeXDOUERST,dHBHBFEDeAAFDGGDUBGGREBD..MFEGHACAFDDGZCEF....IHHGhAAAVEAC.JAHDAHADaBAHhAAA..OBDAhACAEFHH.SEAF.fHEBhADA.NGEFKCBC.bDFA.hABA...,1,-6,-37,31
SUeDLEGbRNaAXHYfOIcVWTKCMBZFgdJPQ,HEFHOGEAVCCFKGBHBAADZAAD..dBFEQAFAeEHHLAHDhAAAEDGC.RGAEAAEC..XGDChABAfFEG..hADAWADB...TCAB.MCFH.hAGAJACF.SHFAhAFA..,1,-10,-21,11
CYNKIVfGOTZaLeMEUdQDWbgPJSBcXFARH,HFGHCFDGKBFH.VAABGCADZDDGLFBH.ECDEUGGD.DIDAbAEAhAAAJHAG.BFABFGABAHEE.hAAA.RDEB.....hABA.IEHEfDHEaAGF....MBCAhACAWADC....hACA...,1,-14,-32,18
ERaMQWfDbJPGZXNdLTAHCSVgKOYcIBFUe,SBBDVDAG.OEFC..cGBDFGGEEFAF..aGHDMHCAhAAA.QDCAhABADCGGPEFAZADG.dCGBACAFCAFFhAAAKHAABABC.........hACA......hADA...,1,-18,-42,24
ZIMXVdHNYSaPTRWEOAKJCgUBeLfDcFGbQ,CDGFBHHGLBBHDGFCFCHDGEBH.ZGFGMFCCdAEF.HACG..SBDAhAAATBFFECCDKDDChABA.JHACeBAH.fFAAhAAA..cEGBIHBF.hACA.XBGA.hABA...,1,-19,-36,17
HBMYGXPacERLeWIKSDfdNACZQOUJFgbTV,CFFCQBDGUAFC.JDGDFFBG....TGAAVACG.BGHAGCADhAAAaFBA...EDHHeAFChAAAKGDH.DICA.fDAFhABAADGG.OEEH.....hABA......hACA...,2,-42,-23,19
PJFWNYGQLEOKHaZBgCRDSIMbAUTXdVfce,XCCBdCFC..VGDAeHEAFCCH..NCHG.QCGALBAFKHBEhAAAaFAF.BDFF.CFBDSFCEhABAIAEAABCGUGGEhAAAfGEFJBAF.WAFEEAGE....hACA......hADA...,2,-30,-19,11
GeOVCTgYMbKDUaQHWIPcRLSXdEJFfBANZ,ZEBHOHDACHHG...TABEMAACDEAF..aEDDHEDC..IBHBhAAARACCSEHHhAFAdAEAJDADBHEFAIDG.eCDChAGAVDFH..bBGBKGAB.......hAHA......hAIA...,1,-24,-25,1
bLRdeFTZaOYMKBVUNAGSPXEgHWcCIfQJD,SGAHEGFCHAABCDCF.QAFEDCIB.RCCAFBABaGBC..OBFHhAAAMIDEBEBF.NHEB.GEBDhACA.XAGChADAcEGB.IHHE.fADAhAFAJFCC.dGEC....hAHA...,2,-23,-14,9
FDUCaZYQEHLNXGPbOeIVSKTWgAfRdcMJB,RDAGdGFHMAHFFDEEUAEG..CFHHZFDA..EGBBLBCGGBACOACFhAAAeBFH..IGAHhAAASDHDKACC..hABA....WHEAAIACfAHABBAAaEFE.hABA......hAFA...,2,-32,-30,2
CSMLBAGgDcENUbWfQKVYRTPXJHaOFdIZe,GDCCDACBEGHB.UGGG....fGBEKADFVBGF.RAFGXFEDhAAAaHAE..FGAGdDCAhABAZBEDeCGBSCBDhAAABEABAFEDcBDA..NAEF....QGEChABA..hACA...,2,-18,-18,0
FXJaSAKDBOTReYVQIfLWHNZGMgdPbCUcE,KFGEOFEDRCEH..eAEAQCECLHCCHFBAZCAG.MBIBdABFCHHEUAABhABA.EDAHFECDaAGHAAAFBFAEhAEA..TGGChADA.IDCGfAHANIAF....hAFA......hBCA...,2,-30,0,30
ORPJCWceQNKbGDgEZVXBfATIdMSFLYaUH,dGFCFHBGLABCUBGAREFG.CAHG...eDAGQFGFKGCDGBABDCFFZFAEhAAABAEF..TCBFhAFAMEEH...SEDBhAGAaGAD.OFFH.....hAAA......hABA...,2,-32,-24,8
WZeNQJSaGYIBVgHCLMfTdOKUFRbPEcXAD,ZFDGeDACJDEGGGEB.BBFDHAEGMEFETFAEdGABKAAC.FECARDAGEHGEhAAA..ACBGDADCNIAH.hABA..aHBE..ICCEhACACBHCOFFA........hAGA......hAHA...,1,-21,-26,5
FQBZLWHCRDaYPVKUdSNcOeAbMfIJXGgET,MCCAJGEAGACG..TCAFQAFCLAGFHAAHREBGDIDGPBHDhAAAUEGF.dHGBSEAGhACAOAAEAAAE.IEEGhAEAXFACEGDDBAEACDFBaHAEKDDA...cFDEhADA....hAEA...,2,-18,1,19
ZfIgBNMKHCUTARYJQWXabeEdFcPLGVSOD,RFDFJDACQAAE..aBGAEGGFdDFAFDBELAAEGAEFODFGhAAADFACZEGD...IFABhADABHCEMAECKFFCCFCAAIHE.hAIA....WHAG......hAEA......hAFA...,1,-18,-45,27
WeFZYAOLDaIKUGfBNCEbdXJgMHTRQSPVc,LBFDDGHHKACGGGCBBHHGCCCF..EAGGdAAF..JCDCMFAC.REFA.hADAQEFG.hAEAVBAFeAHDZEAAAHGHODDFhAFAaCGA.IGCA.fGAEhAGA.....hAAA...,2,-25,-25,0
ZVYCNUIMATXdJgPRHLWbOQfEGcKSaeFBD,TFCAXGGD.dEBEJBHF..RFCHLAGB.ODBAQCDGhAAAEAFD.GCFAhABASADHFHAABEBAVAAAhAAAYAEECGFE.IHGAAFHA.HABDhADAfEFFaFHFDFFF..hADA.NAIE..,1,-4,-19,15
EbTZWBIcVPLAQRCFfaUMdKGNOXHYJSDge,QGDCFBBDUBFC.KHGAOADFHBFASDDC.eCAHhAAAbDACZEFEBEBH.IHBAhABAVFAFLEEDhAAACAGEMACEGEEF.XBBFDGIFEGGF...hABA......hACA...,1,1,-23,24
RYJbfHXOCDePcNMZaEWTLBgdUGAFKSIQV,SDABVEFH.RDDF.JBDHHCFE.CBCDDGAHeHDG...NDIE.aAEBhAAA.EGGGLEAEhAAA.BCGAdHBFAEHDICBAhABA.QGAAbAFAOFFHMADEWDBHhABA......hACA...,2,-22,-22,0
BTUHYGOdLXaCDAQNbgEJFPReIVMfWcZSK,QCBC..gEBHJFDDFHAERAFF.eCBE.VADGMAEDhAAA..fFGAhAAA.ZFEBKFGABCHGhABATDECYHAGdFABaBBACABHAGABNIEB.EDAC.WEEFhADASBAD..hABA...,2,-28,-6,22
PYHgKcLNMCIFSaRQTGJVEUXfDWAbeOdBZ,eEEGBDGFZCEFHFCHKEAGLHEA.NBDB.IGHB..aCDGhAAAQGAHGCEDEDAFhABAXBBADBCD.ABIFdHEBhAAA...PEDHgGABCABC.SFGAhACA..hADA...,1,-12,-34,22
KEMZDUPIOAadXfJGQCgFcReWHbTBYVLNS,dFAAXDACJFHH.GGEF..QCCDFDGHeCCGHGAGBHEGLFCFhAAA.SBEChABAKAGGEECCMBAChAAADEGEIACEAGACCBFG.gFDC.hABAWAGB....hAEA...,2,-42,-10,32
PKbdWZMRSBCGIDYALFOgUNXecQVTEaJfH,FGDBODACUAFC..eFCAQACGEHAE..aACBJFGDHADCKBAC.hAAAbFGDZDFC..RBGFSAAFhAEABEDGCEAD.IGFAhAGAAFFD..NECE.cCDF...hABA......hAEA...,2,-39,3,42
cLTJfAYMGPKaVCNFESQXODIUBHdWegZbR,GBGAKAFBCHAC.EBEF.QCACDGFBBHGHHCGBeFGDZEED.REACLABChAAAJCBD.fFDAhAFAMACC.aAHFFFCGhAAASGADXDEF..IBAE.hAGA....WHBAhABA...,1,15,-54,69
WPOASCHBgEJNVUZXLdGafbDTecRQIKFMY,CHCHBFDD.JEFEVBFB.ZGFALFBF.dDDDaDBEDGID..TAAFhAAARAEA..KBCFMAEFhACA...PFAGhADAAHDESBAB..EAHDNIDF.XEEChAFA.fEHEhAGA..,1,-15,-53,38
fNOWZgeJKUPAYITEdaQCBHGLDXFVRMScb,TCBCaDABBFBC.GAABDDIDFFBH..MIFESAFF..hAAAbDECOEEEZFDCeBEAhAAAKHECAADAEGABCGDFHAGFLDHBhABA...........hABA.XGGF.hADA...,2,-27,-15,12
ecSIDKGbTdLVYHfXaMJFgWNRBPECOUQZA,SDCDDGHHKCACGFADdABELGFCHAEH.aAHBFBHD....hAAAgBFDWGDABCDDhABAEDEBCEFH.QFAChAAA.AHHB.IHAE.....hADA......hAEA...,1,-25,-35,10
dfJVDMNRWPIHYZTaCgQKFUAXGSLbcBEeO,GCEBLCCHBHHGeFGFOCAFdAAC..JBECVFBCDEFB..MBIDhACARABA....WFFDhAAAIEAA.HGAAhADAZAFECCDCKAGCAAEC..SHAGbFDD..fDGAhAEAYEHH..hAFA...,1,-21,-23,2
WNRVPCdbQSZLOAYHcFXDaBeJMUIETKgfG,HAADXGBCBCEE.eGDAJEDC.MACE.EEFCKEAF.GBDDRDBDCHBB.hAAAdGEAQAGGhAIASAHBODDFAHGFFDGCaBAFhAAAIHGE.........hABA......hACA.fEBB.,1,-8,-23,15
YcVgXGQJaFCTWIMKHLREDfNSebdPABOZU,BEFAZAEGUDDG..VBBCGEGC.QABDaBHBFGBE.CGEH..hAAA.TEAAMEAEHFAGhAAAEAEEDHEA..SBADhABAdEECADFC..cGGE....hABA......hACA...,2,-38,-18,20
ZSKaXLMfJAROCUdWEFcQbNGeIgTDVYHBP,RFEECFFEdHCFECAC...QBBEGEAEeAEE..TBEGVCDFBBAFhAAASGAFaDCHMIDAhABAADAGOEBEFDGD.NABD.IHHChACADAAF..PBHB.KGHF..hAGA......hAHA...,1,-4,-30,26
ZDLNacEAURKWdCVSTQJHMPYXeObBFfGgI,KDAFCFED..SDFDTCGBHFFF.MBBAXEBC.OCDGhAAABCECfCCAhAAAGGADgABCDFDBaEEFEAHBhABAAAIBUGGCRFAF.dAEF.QDGE.hACA......hADA...,2,-18,-7,11
BMJUPGWECfFAHdYaKeNZXTSRgLVbcIODQ,HDAGdAFBKFFEeHDEZABA.XFAHRCAF.LBCA..VDCDhAAAICADDGBDBHGAMIBEhAAAUCGCGEDB.EAGFhABA.FDGE.AFAFaGGA.......hACA......hADA...,1,10,-44,54
UERTIBKLgAcPNaMOFQYfDJVSbZCeWdXGH,...PDEHaAACFCFD.QECGDECF..SBDEhAAAZEGDCFFHeAHFXBACHACBRGAGBEADhABAgGFGAIHAMIDEhACAfDAF.bDFB.dCHE.UGBFhABA.IAGE.hAEA...,2,-14,-9,5
UBVOcCGTDKbHXaIPfeNZMRgFYALESQdWJ,LEGHSFAAQCBEdAEDUGDFBDAGOACCGABEDCAHKHDCHEDAhAAA..aBFEfAHEhABAZCFEMFAB...hAAA.FGBDADEAEGHD.JCHHCABCbDDD....hAEA......hAFA...,2,-16,-11,5
FQLBOYMHUCgRSXcAGWdfDVNbKJIeZTEPa,dGAHVFDGKDFG..eFACEBCF..FAFALBCEBHDG.MECCHBDBCAFERCGBhAAASGGE.hABAACAC.fHGBhACADIFEJAAEZEAAaDAG.OHBC......hADA......hAEA...,2,-30,-17,13
DULYMQBEaXdZHPecKRSVCIOJbFfgGNATW,TAFBDAFBLBGH.QFEHBBADaDCCdEAAHDBF.eBBFKFEBVCGDhAAACBAFOFHB.FGADhAAAfHGB.hABANIAD.AADC...WADF......hABA......hACA...,2,-35,-18,17
ZNKPRMcVCeIFDXaQbYGHETUfdALBWOgJS,LAFBBAFBOEACSGHBZEED.KAACMAEF..CFCEFHDEDGGDaABHhAAAQEEF.hACA.bCGBGACE.hADAEAEBfDDGABHHJHAENCBE.PHAE..hAHA......hAIA...,1,-15,-36,21
UYWcBNSCXaFJdKAEOLHGIQPDTbMRZeVfg,OFFBLEGHGAEDQDDFDGDB.MFCFRBBFZEGH..eBFE.hAAAVBAG...UGDHhAAAcFAGBGABNCIGCDADFADFhABA..KHAAAIHA.EDDF.......hACA......hAFA...,2,-23,-16,7
EPZOeHQCYacfRGMNIgBWbKdDVXFLAJSTU,SAADTFCA.EAFCOBCC.QGGGCBEDaEDB.RDDAGAGChAAAMDAC..IFGHhABABABAKDAEDIAC.FGEFhACAAEAFPFADeBGH........hABA......hADA...,2,-30,-20,10
dCKYHOWZcGAUQLSDNTMgIaPFebREVXJfB,UDCHQGGDDGEH.MAGB..IGFHFCHHRDCG..EEAEXADDhAAAJBAABGFC.KFADOCGHhABA.ZFAAAAID.SCAFhACATFCDgADEeAHD.fHBBhAAACHHF...hADA...,2,-36,-16,20
GMdKXADaebSFcLQYVJPIONTHRCWBgEUfZ,eEACSAFBLFCAQEBBJHDE.OCACHACACHHEBCHCEAHHZAADhAAAdEGBKFEG.DGHBbDFBhAEAFAAC...YCEDhACAPHAA...NIBH.WCDH....hAFA......hAGA...,1,-11,-22,11
MdIGZaPDUAYLbJOQeNfHBFXEcKSVCRTgW,LGEAJEEG.eBFDHADABBGDXCBGKEEG.CABG.REAF..TDCGhAAAMCAFdGGD.IGAChAAAaBBHDIAA..AGIB.OFCDhACA..NIDHFDHDECFC.SACAhABA......hACA...,2,-26,-24,2
UVAKWCHLYDJQNfEeZXPSdRBIaFgbMOGTc,CFEDHFDFDGHD.JEAE..QAAEEGBHZAEH..SFGCBFCHFGABMEBGhAAAGBAF.TBGEhAAAUBFHAFFEKEECLADDhAFA...NBIA.fHGH..hABA......hACA...,2,-35,-19,16
YIVeHTJNaCAbRPcgOUEFGSZLMQKBdDfXW,RAAD..PGEAOAEGFAGDZFCE.LEECKDAEBEDCDGGF..XFAChAAA..ICFDhAAAHCEAJEFGCHDEACDEbABAUDAFhACA.EAHFMFIH.......hADA......hBCA...,2,-30,-22,8
UaCEZTIbdeXAVgLQScGDNFYKfHJRBOPWM,VFDFLDAC.SAGBDDCGFFAB.KECDHACEREFB.BHBB.OBEEhAAAPBCE.MIFAhAAACABFEGGDZEDB..TDFEhAEAIFAG.eABCADIH.cDGF.NIAF.hABA......hAFA...,2,-28,-19,9
XSJUHWTeFbGADBNPfKCLYREZOIMcaQdgV,DAEDBFDG....fBGEKBFHLAEEEFAG.OBAA.MAIDhAAAaBCDQEEDhAAAdEFB.gDAEhABAXFGASDDBJEHBWGDGeHAEFGFHGCAChABAAIHECACC.....hAFA...,2,-25,-22,3
fKDRdWPEJZGMCONIAbYBeaUcQgFTLVHXS,BFDGaAAD.QBGDFFHFLADEHCBH.XFGFKGEARBGB.dFEAEEEAhAAAZACCGCBHCGBF.OEBFhACAAIAE..eDEGhAAA............hABA......hADA...,1,-23,-24,1
QTXGCOeaMRFHNALVIKZPfJSdUWcbBgEDY,LFBBVDAG.ZBBEJGAESEHB.UAFBbEED.BADCDBAG.hAAAQDDCGAGAeDHHhABAaGFA.RADG.FGDCAFDGIHHChACAKAAA.........hAAA......hACA...,2,-26,-16,10
BTPIOXUNFSdQKLeHZEGfDWMCJRAbgVacY,VAADaHBGBEDC....TGFBOAFEUEDCSFGDdBHALAFDhAAA.eFFEZBCCfACDhAAADECHMEAHJHAEhACAAHEEgCGB.PFACIADFhAHANBAE......hAIA...,1,-14,-25,11
VUgWFCEYdbcaILXGZMPQAJSeNOfHKRTBD,SGDBeEEGOEAAKBCBBDFE..UEACFBAHEFHFdBAA..aEFFXFCDhAAAZAFC.QAGAhABAJHACHFGBDCFCgGAFhACACECA.YCDE....hADA......hAEA...,2,-27,-23,4
JKcIEQRBfNLMVAdCUbTPSDaXWHeOGgZYF,dFFBUGGG..TAFCDDBE..XEBEHCDGOBBBZGCA.FACGKAFChAAAIHDBEABF.REBFBHHGhAAALCEBAFAHCDGHSHAGhABAaEABeBGF........hAFA......hAHA...,1,-17,-27,10
IUOYEHdSLTWcbaAKJRfXMgVGPZDeFNBQC,KDBDJFBB.RDEA...MDDGGGCFZEFG.eBBEBDAACHHG...OHDAhAAAEFBAHAEHdABCLAFChADA..WAGBaGGAAIDGhAEA.....fDCE..hBAA......hBCA...,1,-28,-35,7
GaLSWQPUcBbRAOJNfeMXTEVFDZCHKgYdI,OEEGJGEA..eCBHXAAH.EFGAFDDG.CBBCHAFGKFCEdAFGaDFEhAAALHDG.SDDChAAAQGAFPAHFhACABADDACFCMDBDDFIH.......hABA......hACA...,1,-16,-35,19
MDPgfBaKTOYNUEGdCFIWSQJHLZcRXVAbe,MDEBDACB....PCFEfBGD.BDHDTDBGOGCChAAAUEFBdBABCBDB.FAEG.SGHDhABAJGBCLAFChAAARCAEAFCHeFFC.KDFDNBAAEGHFIHAH..hACA......hADA...,1,-18,-29,11
DafNSEGYKUQVCLOcWZABPHbMITRgXFeJd,HDBHMCCARAGFFBDH.JFEEdFAD.DAAC..aFAB..SDEDhADAEAACKAEH.UGEHCBHC.ODFChAEA.ZGAEADGCBHGDhAAA.bDFEIDBC.XFGFNIAB.hADA......hAEA...,2,-31,-22,9
NZJafbKEAMecXWRIPBCdFVgOQTDLYSUGH,eCHDXCBCREEBBFAFFACE...OHFCQGDALCCCUBFGGAEFhAAAZFFHaFCBKHAEAGAGMCEHhAAA..IACAhABACABCdFHA...........hAFA......hAGA...,2,-25,-19,6
OUGCBWgIPLfeFAKTNJHQRSdEZaYcbVMDX,TGBCJFBBHDEH.RBBD.dEEFZAFH..aCDC....bFCDVAAFDGID.hAAAUGDEBDAC..gADBhAAAIAHF.fFAAhACAABEE.KGGH......hAFA.NBIG.SHEEhABA.EEAF,1,-22,-23,1
UbJECQXaYeOVRdZHgTDFAGBPWKIMcLSNf,GGDHBFDGKBFHMEEELABG..fEAHJHBE.CBCEaHCChAAAOAFA.RCCAdGFEgAEEhABA.FFCGAFEGIDAFhAAASAHH.NDAFEGAB..YFHFhACA.eCGH.hACA...,1,-21,-33,12
LVJGEUgICfOAaWdYNFMbRDSHPXQTZBeKc,aAFBdHBHFDFH.RFGF.HBAF.XBGGQEBGZEDABHGGKBBALAAEhAEAVACF.GAEFhAFAEHACUEAFCCHAADDE...NDHEDAAFhABASGDE.......hACA......hAEA...,1,-12,-19,7
VYUHDXGaECZgSKOTFBLWIQfNMedPAJRcb,JFBBRAAD..VDEGUGFDHEADGCBB..CAECZECFKEGF.FHGALAAEhAEA.QAGAhAFANBICdAGEAIAG...cBFChAGADGGA...........hAAA......hACA...,2,-26,-26,0
LcWHJOMZRgICYPFfeKGNbVadBUSDTEXQA,LGEAHAADMHEAZBAERAFG.CBFD.FEACKHBEGCCA..VEEABFEEDDGEhAAATEGF.EADAQEAGhABA.ABBCJCDBhACAOHAE....IAHH.hAAA......hACA...,2,-28,-17,11
SOZcLeUKfFVdMBGJXCQRAENYDgPHIWbTa,EHBGDACBHADB..bDEESDFC.ZFFFeCBBUDBGFGFGdBGFhAAAMACAJEHD.CBFGAAHH..hAAA..NDAC.YFDHhABAIGEDaAHD.cBBA.....hABA......hADA...,1,-17,-28,11
FTXcEKGgeSZYAWJRIfbHdMDOPLQBVCNUa,JFBBRAAD....IBFCHDEHdACG.DHEALHBEBBAE.NCIA.UAFDhAAA..FEGD.XFAChAAAKEDF.eDDBhACASHDGADFC.fEACOADD.QEGAhABACHHCaDBD..hAEA...,2,-43,-19,24
OMCgNUIfdaWZTAQcPDJXeLEBSVHFYbRKG,QCBCDACBeDEDLFBBEAGEBGHEHBEEFFDA.REGBKHDAGBFE.MHCAhAAACAGH...NIEB.IADDhAAAdBDBZFAFADABPBABhABASBAC........hABA......hACA...,1,-13,-22,9
ULJHTbGaZgAEdSBQXCeOYWcINRPDKfMVF,SDABXABH.OHDA..YFHH..IEGHhAAANEBC.DAEEfAFDhAAAVDCCFCGAUGBAhABAHFCHTDEEaABEAHHEBAGACDDFeBDG.cGFAhABA.KCHFMCAE..hACA...,2,-28,-5,23
TKONaYcLUIEVfPegBRSbJWCdHDFXAZGQM,GBDFMGECKDAFaGDGLACCUCAC..EEDG..VBFB.eHBAhAAABHGFRBBA.SEHFhAAA.JAFAdEFHDBACABAAQEBDhABA.NAIAIDDFfHDFhABA......hACA...,2,-35,-9,26
DYHAeJZQRVKcWLOTBUXgSMPbEfNFCdIaG,ZFBGRABHKDFDLBEEBGDB.UCAD..SGGAMFHB.EHCEfDDChAAA.CDHBdFFEhABA...aBBGDECAhAAAAIFE.QBFF..WHAAOEAChABAgCFDNAEFFBDDIFGHhADA.,1,-22,-44,22
cQUKPNDdFIGgVXOaLeHMYAWTfbRCJSBZE,TCBCRAADCFEH..BCGCEEDB.UGBAKDHBDFCD..FEHHGGEB.hAAAXBFHODBELAEAhACA.HGEChADAYBAEAFAD.bFADSCFDcADA.NAIE.hAFAIAHF.aFFAhAAA...,2,-29,-26,3
FASQNRaOePTcEMUVIHLDKXYZBbGdfWgCJ,QGBCRDAGOFDA.eEBE..TFADMGFGUAEDHAAEDGGEXCDEhAAABCCGdDGD.gGCHhAAACHHBABACSGDHhABAPHFGEBHD.IACF....hAFA......hAHA...,2,-23,-15,8
aHCXFEIYNAOGLfUTgMWQRcKBSJZebDVPd,LHDAUCGCMABERAFDBDEAZGBG.DCDCdBFGHCAEFGHF...EFAG..hAAAIFFHAHHBODGDGBBEhAAA..fACHhABA.WBHBKEDC......hACA......hAFA...,1,-32,-33,1
RfYMXFOaHZWECKQBgcSNGJVLbePUIDdAT,REFHMCCAFAFBHDBEZGDE..EAGCKFDDBDBC..SBBGJCGH.hAAALAHDeACCIHHAhABAAACC..fFHAhAAAXDDCOEBF.CGAE....hABA......hAEA...,2,-37,-27,10
AIMUTbNgCXRYZGSJBVdKafLeOPHEWDcFQ,UFDBTCBC....bADGCFAGRADA.ZDFCSCAHBABG.KDDAaGGFhAAALAHB.OEHHhAAAPGCEECFBDACEFFABhABAAFCCMIBA..NECA...YAHHhAGA......hBAA...,1,-17,-33,16
XJTQReMIZGCfSDcLBPgdNYWFOVabHUKEA,XDCHJDCH.RABA.MDDGZAGF.GEEF.CDHB.DCEDLAEEhAAABEGDdBFA...NEAC.YDAHhABAFGGH.aHGAHCADhAAAKHEA.AABG...TGBDeFEF.SACBhAIA....hBAA...,1,-20,-27,7
fTgBFGLIdCJYQMWUVASDOaKHebcENRXZP,OEACaEHBHFCE.eBDHEGCDRAEGZCAD...TBGFBBADLEFEhAAA.IGFEhABACHHGQGACMDCG.WAAEhAEAAHAAKHGA...NEEA.fCFE.FGFDhAFAJBBA.....hAGA...,2,-21,-15,6
DbIWNBfJQPLHKZceAgUFTVROSEXYaGCdM,FGFCVABHOEBF..SBDHEAFA.aGAACFDGMDAA.DIGAhAAAbEEC...NICFBCFChAAAfEFB.PBEBhABAKGGAeEAC.ADGB.TABG...hABA......hADA.YAECdBHE,2,-25,-18,7
LegWdbVUfOSINDPQETKZaHBFGcCXYAMRJ,JAABLEEG.eCAFdHADUAEBOBHD..SGGCDBEAEHBEZGEEhAAAHDBDBBBEGEDEhAAACECDAGDE..RCDE...bDFEhACA.IFAE.NDDF......hABA......hACA...,1,-15,-29,14
KMVJeEDCZgAbHFSXRaNLfQOWUPdYBIGcT,HDAGSFAARFAHLAAFOABBUGFE.dAGHIGEGGBBFTGDHhACAVBFG..EEECDCHFhADACGHEZACDAICEFDFB..NIEB.hAAA..WCHHBHAG.cDGD.MBEHhACA......hAFA...,1,1,-23,24
KENYLFSeZOdJcRMXQGHUgTVafAPBIbCWD,BFDGCFDGDICG.ECGALBGHFCDD.ZFFBOEAD.dGFHRABFMCEBGAAFhAAAHFAD..TEFEhABAaDACAIHE...IAFBhADAKCFD.SHBA....hAEA......hAHA...,1,-28,-31,3
SbGLdOWKMXgRZaUDIPeFYAEHNcVJTfCBQ,ECFCHAAD.VDBDJEHD...CBHDBGEFSADFLHFEdEEFKCBBMAEFhAAARECB.ZDGDDIBA.eFFBhAAAAHAC....NCAA.fFAGhABA........hACA......hAFA...,2,-33,-26,7
bWVGFJceATIQDKSdBZaOYXERNHUMPgfLC,TCGCQAFB.KEDBBHBFZFED.aEACOCBHEBCA.HGAEUAGFMCCAhAAA..fAAHhAAACDGA.VGFAFHGE.hABAeDEHAAIFIADDDCBDSCEF..hADA......hAEA...,2,-19,-18,1
GEDANYKXHdUaCbLTZJgIfMcFVRSOeWQBP,KHBGdDAFaDDCLBEA.ZDFAJAHB....fCADFGABSHEAhAAAOFHHeEHFBFBBhAAAEBACDHDEAGFD..XFBFhABACAFAbDAE..IABE.MFADcBEAhACAWGDE....hADA...,2,-34,-26,8
QObKJTEfAdVXeBZRSWDPYcaLGHCFINgUM,XCCBeFCAZBBERDBEDCFH......PHBCaFAEGEEBHBFFFFABhAAANBBG.UGGG.MABEhAFAbGCAKAEG.EACCAEHABBHChAGASGHB.WAHD....hAAA......hABA...,2,-27,-10,17
gfaKLDNSQWRPMBTJIVGOUcFAbYECeZdHX,EHBGCEFAdADGHAFB...XEBGaBFHDFHF.QEEBRFAC.BBAFhAAAIDDCOCBCUCAGhAAAAAIFeHFA.fEHAhABAKAHBLHCGNDAEPBCA.MHDE.hABA......hACA...,1,9,-41,50
VdXfaUJGFOWDANTePMCYZEBRbQILHgKSc,TDACMDEBZAAB.BAEDRECD..QEFGLCHFKGGBVBGBdHBFXAAFhADA.fCDHhAEAaCEFGCBAFGHFDGFBhAAAAGAAeHAECBGC.EAFA.......hADA......hAFA...,1,6,-31,37
bHMAJeZcVIODKUBTWXSREafQFGCdPNLgY,ZFBGVAADDAEA.BGHA..XBGHEAGA.aEEAFACF.dHDBLGBChAAA..gCEAhAAAYAFDMADFhACAAHGH.JHFCeCHFOEAAKEBE.WHAAfBAAhABACFFD.....hAEA...,2,-32,-21,11
ecZfFVJMLPKWYRgDEdSXbCHTGBQaNIAUO,UFCAOEEGZADA.FEGCMCDF.KBDERABD.DHDAdHGB....SFGAhAAACFADHCEEBEABQDABhABA.IAGChACAeAHB..........hADA......hAEA...,1,-36,-47,11
UYdPZMaXgeDLWTVKSNBAEcFCJIfQHGORb,EAFBCFED..JDHHQEDD.GGEHRFAGUACGPCHFZCFB.XBBGhAAADGGDLAAFhAFATDBF.SEADhABAAIHEFAFE.fADE.....hAIA......hBBA...,1,3,-44,47
JTDXMWgYdUeNPAFfKQGBEOcSZCHIVabLR,FAFBQGBCBCBG.EDAHSEADHEECaFDCLCFARCFF.DAHHhAAAMIBE..YBBEhABAeDCHACCEKFHFOADAhACACAHG.IHHBJABATFDC.....hAIA......hBAA...,2,-35,-9,26
VNCOYLQXKDURPcJMZEBaeFgSdWAGHTfbI,HCDFTCBC..fGBA.VAACCDHAOEEC.LHDEhAAAKAEGUGGCPFAGhABAcDFAMGEC.EADEaFCFhAAAgAGA..WFFF.AAHDbDABhADAIHAFNEAG...hAEA...,1,-16,-19,3
fKcBPAYEeWHTSRZdCULMGXOabVNgJDIQF,eCCHTFDHZADF.CBFD.LDEEGEEH.XFAB..aGDGVBBFhAAAJBADDAIDQGGBhABAFGAD.KADGBAGCAIEAEGCBhACASGHHdAGCMCIB.......hADA......hAFA...,2,-32,-4,28
FMRYLZSgIfVQJAGaTDeHbUXKCBcdNPOWE,aEABTEGDHAAB.UCFAKHAEBGED.dCBAOHFEFBFF.RGBEZDDFSFAAhAAA..fADGhAAAJEDGDAFCeABEhAEACDCGNAIE...EGHF.MAIF.....hACA......hAEA...,1,-22,-23,1
GRdACcHUDYJQSBLVFMfNeXgZEWPKITOba,HDBHUAFBDEAAQBAGBACB.FAFE.MIDGeFDCZDFG..EDCGKFHBhAAA.IFAHOHDAaGGAhAAAdDDAAHCB.CACCJGDESBBGhABA.fGAE.XDFEhAEA....hAGA...,1,-10,-44,34
EdWLBDPGIHfQCbOKMAVageUcYNTZFSXJR,VDAGeCCHUGFG....NAHA.FADG.SCAFJEHB.EGBBhAAAdGEDBDHBDACGIBBHhAAAQDFD.CAGDKGCChABAADFH...aBFCgGAH.YADGhABA.ZFCB..hAIA...,2,-40,-23,17
PcMgSFTZXECVKQYAaUdIWNJbefLOHGDRB,UFCEdHBH..ICCAJFGF..eAEGOFFBDDECBACDMFAGSBGHhAAAZBAA.XADAhABACHFDKDAH.QDEHhACAAIAC..NDIE.LEHB..hADA......hAEA...,2,-51,-25,26
cUGaREMbOKJfgXWQLdNIYPTVSZDBACeFH,FDABUFDHRGAG.EBDD..MDFHOAAH.KAGFJEHH....XCEHhABALCCH.ICGEhAAATFAAZDAEBHHGCHHC.hACAeABE.....cGECaEHH..hAEA......hAFA...,2,-41,-25,16
QRMdTIPAUVCaZJWDeSBYEKgLFGNXfHObc,UGDCaBBDZGAGDFCF.BDACKAAFLGFG.GADDXCEGHCGDhABAODHDQEEDhACARACF.TEAEAGAA.CDCA.hADAeAFE.SAAC.EGFCNIBF.fBFBhAEA..hAIA...,2,-43,3,46
GDCeEYBfUcMPaLJbOAgKISXNHVFWRQTZd,KHBGXGBCHBFAFFFGRDEH.ZFBEdCDGGDBH.DAAFeBBH.BEAGhAAAUBCFPAHDLAFChABAOHDEAADC..IGHDhACASADC..NIEF......hABA......hACA...,1,-12,-32,20
PeUObCXYTHKEaAMRfcIDGWJdNLBVFSQgZ,MECGRAAD..IHACDFCBGBFGdADHLCEBBAABFCAF..SAHDhACAQCGDZFAFeEAGhAAAOAEHXGCBhACATGGEEHEA.AIGAfAGC.cFGAhAEA.....hADA...,2,-34,-5,29
aJQUFeVdICBTgcMSWPGLXfHNbYOKAZRDE,DDGBEEED.QAABeCDFdBHCBAFC..gGBGMFHH.SDCHhABAGEBCfBAHhAAAbAEE...hADA.YFEDAGGB.aHGAFEABCFAC.TGDChABAWCCE......hACA...,1,-18,-25,7
SJAeNWQgHMKTEZLICYPfDbFROGVcBaUXd,eGEAQCBCMHACKBADZDFECFAH......fCCGhAAAbGAAFHGCOBDEGBECBFGGhAAAaFAAXBGBdBAGAIBE.hABANAEF............hACA......hADA...,1,-19,-28,9
QJFdHAaBPGTWRCXUELZefgDOcIVKMNYSb,BFEDTAGHCGCC..UABGLCCG.eGAADDBG.OEEE.IEBChAAAMAHFSAFFhAAAJHEGdBAEAFAH.GDEDhAEARACA.EEBFfGDA..cFFDhAIANCIE......hBAA...,2,-46,-4,42
PeMNDWEdOaQCYAcgSbUXJTRHZLKVFGIBf,SHBGUCGC..TFBBHEDBZCFAKDEFFBBAIADD.BAAChACAeFADDHGEdFFDaCBBCGDAADABhAAA....cAFFhAHAbGFA.JFFA.........hABA......hACA...,1,-22,-36,14
FWBQRYSXOPUJGIATdMHDEKaeCfLZcNVbg,dBDHHAGHEEGGKBFD.CFHBLBBDZDDD..NHBD...VFAHFDABBAAFhACAQEDGRAGB.SHGAhAAAXGGGOCCBhADAUACAIHEGAIEGMIAEDGAEfFGEhABA......hAFA...,2,-21,-17,4
FKRCcPBQdfZWNTaLOVgMIHDeSAGXEUJbY,XECBEGDDUGGE...JBGBFBEA.KCABCACCBBDC..dEFHZGFGTGAEhAAAOBEF.MBIHhAAADAFEAEAB..GBAEhABARCCEQCGD..fGBE.hABANAEBaFFG....hBAA...,2,-30,-26,4
febITJcRNEUGMVAQOYXLZaPFSKgBDCHWd,QDACODACLFCHZBCAFGDCKCBCBGGGCEGD.dABF...eAHHhAAATFADRDDE.UAFAMDIHhAEAAHID..aHEASGAHhAFADBBG.fAGAbDDB....hAGA......hBAA...,1,-17,-30,13
SCAKeMFPXYBRdZEQOgVaULTcDGfIWJNHb,MEGFXGBCRAAB.dBBEZEDB..OBFDaADGLAHHDEDBGEEC.hAAA.IGBGJAEB.hAAAHAECCHGEKAGEFCECBCAFhABAEDCB...gEAC....hACA......hADA...,1,-14,-26,12
NXHLJWdGOeRFbAfKCUagSIDZVcPMQTEBY,CFEDaGFC..SDFDZEAD..PADAQAAFECAA.BGGChABAXDDBJCCEdFABGCFChAAAOHBCeFCFFBGFAHEAfACEhABAKADA........hAHA......hAIA...,2,-33,-18,15
AJaODdCZGgbPQLfHWIeYMNFEcKRBUXSTV,aGDBdEGCGDAE..bCDCLAEF.fACGIGGCeAAFhAAAMBADFHCAEFAE.KCCFhAAARAGDBEBESHFAhABAAGFHDIAACEECgAGF.PFCC..hADA......hAGA...,2,-25,-12,13
HVFCEJIPUdWAXgfLDbReTNOYSMGBQcaKZ,XCBCLGEARABB.eAGBOEHD.MFAEGEBABFFDQEFChAAAaGCB.HBDFCEGGEAAGhACAIDAHdAHGACEHDIDANEIASFADhABAKGABZAEH.......hADA......hAGA...,2,-24,4,28
bETHBMGUXaDgfCANJcIOFQLSRPeKWdZYV,JGEAOGEALEDFRDCB..KADCZCFD..VBFBTBDC.BAAGhABAMDIFUGAHDAACCCCFAIDG..hAGA....NBIEFAEAhACAPHAA..dDAAEHEE......hAHA......hAIA...,1,-24,-38,14
KXIGagZNFDfOYJMTVQbUdeWBHCPLEAScR,SCFCRDAGKGHHGBBHZCBA.FEGEDGFG..OADEMAFC..QGCDhAAAdHBB.BEFFhABACEAEEGGAABFC.XGEBhAAA.IAHDaCGF.......hACA.NBIE.fDFFhABA.TECG,1,-21,-35,14
EZDBGJRUeFANQSHYWbVdCfPgKIcMXLOaT,SGFCHAAD..bDEGCHCB...PFFBIDBG.XBGAhAAAOHBAEBGG.DCADhAAABFDEREAE.UGAAAAGANCCB.hACAWBCG.dAFDKHGAMABE.TDEE.hADA......hAEA...,2,-26,-13,13
gBLCWSEUbPFHDeYOTGNZJQVcMIXdaKfAR,BFDDLAFBSBEEUCAHFHEGDEAD..eCHHODEEGEAGZCBGQGGHhAAAMGFG.hAAAXGAAdEDHKABCAHDFCFFEEACDhABA...........hAEA......hAHA...,2,-27,-25,2
HSabXLFDABCTdPGERIZMJeKcgNOYUQfVW,BFFGCFCFdCABGEEEEBGERAEB.ZBGD..eBAEKCED.....cEADhAAANAAF..OFAHhAFAUDEF....fHGBhABAWBDF.HECB.SHAAhACAaHGE......hADA...,1,-26,-35,9
DQcJFaURCdBgOPXSNHETKWZeLMbVAIfGY,GAFEDAFBQGDDFADAUFGGdDEBBHAF..ODGD.SDCDhAAAHECBKCEF.ZABEMCCBhAAAAIHE.IBADhABA..YBAFaFEDCHBA.XGGG.hACANAIETGAB..hABA...,1,-22,-30,8
cTadDSOGVbECLIYMZfBRXUeWQFKJNPAHg,HAADTCBCdCGE.SDDFOBEB.GFADECFALEADMGFABEEChAAAUFEFQDAFhACAFBABKFBB.NIAD.ADHHaAAADCCGCAHBhADAIFHF..fHFB.hADAeAFF....hAEA...,1,-6,-18,12
AQGaSDCWXLIZTUNVbHdefYcPKMEJFOBRg,GCEBDGGDCCFH.LECFZFBB.TAGAUBAD...VEGDdEGHeAEHhAAA..fGAChAAA.YACDhABAKEEFJAHBBHACAEAGSADHIEAHbFED..hAFA......hAGA...,1,-6,-47,41
eaALTQcZMbCORSHIgYGUNWXFKVDEPfBdJ,LDCHTCGC.ZACGMEEHCEHE..RFFBHBFFIAAD...GCADhACANABAFHAE.DBGEEAHBBGFEhADA.....hAAA............hACA......hADA.dCECaFBA,1,-23,-38,15
AGbgTPONYaRQBCXHeUKLEIZDcdFSJWMVf,GAFETCBC.OEFB..NGBD.REBDBHAFCAGAHADBKGHFLHDGhAAAZFDHDCCA.dDFDFAAC...hABASDAFMFADABBH.hACA....PDHDYFHHaHBE...hACA......hADA...,2,-26,-17,9
WQCNVdYJebEBSFIGOMRcPgLTfDZHKUXAa,QGBCVDBH.JAHHEEFE.BHDFFABEGEDEOABG..RAEC..hAAA.PCEETGGEDGIBhABAKHEGAFHD.CHAE.dEAB.eADHhAFASDGE.MAAF....hAFA......hAHA...,1,-17,-30,13
BFCLMEVfRSIaQbNPODTdAZHeUgWYKGcXJ,ZDBGeBDGUAFA....gCCEKHBEGDFCXAAGBCBHCACA.hAAAMFDE.EAFG.RFGHIHDChABAaFBE.NEAADCHDhACAAHID.HFBE..WAHH....hABA.JFEF....hACA...,2,-44,4,48
JVbRdHPZgYNOaKTCEBUFDIXALGfeMSQWc,GECFMDEB.SBGBQCBE.JDHBRBCGdEHEHGCEZFAF.NABD.OACChAAA.KCFBEGDB.hABABBBFDGIDIHAGhACAAAIDLHFE..fEAB.eAGBhAEA.cGFA..hAFA...,1,-16,-22,6
eaWCMKTdOBFGbgYPVScUEfILDNRHQZAXJ,XFCAaAAB..CDGHKCCFOFADBBDGFFHBGGDF..bABH.hACA...gAFHhADAPAFASFFFhAAAUDEE.IADHDAIFRFAB.ZCFEAEID.WCECMBBFhAEA......hAFA...,1,-16,-27,11
EfdAQHDaFLbNMTGSBIZePUCVcRXWgYKJO,QFCADGDEFACGLDCEMIFAGCAEBBFCZAGFeFAD.UAAFCGFH.hAAAVCFDRBAF...XADFhABA..YFAFhABAKFGBEDCEAFFFaEEENAIE...SEBAhAFA.IEHChAIA...,1,8,-42,50
fFKdCAcMOUaeZQGWDLHJRYgTSBbVPEIXN,OCHDUGGDeAAFZAECGGEBDBHB.LCDDJFAF.RCAH..TCEDhAAASFDC.BHEFhAAAbGAA.EBFH.XCBFhACAfEGE.KACDAAEAaBEB.HDEC.hABA......hADA...,1,-11,-23,12
IZHVBSOCdUQFRfcWbXMDJKGTEPLAYeNga,eGEAaHBGHBFFBDDGCEAB.dDFF.FHBCRBDH......fHFBhAAAbBCCDFGAGCACEDCBACCENDIEZAFAhAAA...SACEhABAOFEA..cAGA...XFAGhABAMGCA.KABA..hADA...,1,-16,-19,3
aKbZBAUEWcCYNDQeJgIVFTGMdOXfRPSLH,EGFCCFDGDGHF..eCAF.JFCHVCAD.GGAHOCDH.RBFE.SAFGhAAALFFE.aFEAZEADhAAA.AABG.UACF..hABAWABANDDH..........hADA......hAFA...,1,-27,-32,5
PgDRMdHcKJZYCLEBGUOQAafNITbVFeSXW,aHBG..IADG..TFFAFBGEeFFFSAFE.hAAAXCFBPFCHRABDHCCAhAAAKEDBJEHDCDBDBHHEOBFHhABAAGBCNBAB...WFAFDEEHMEAF...hAFA......hAGA...,1,-18,-30,12
UbRNGXWDLTCcOKgVYQfSMaJBHdIeAZEPF,ZDAGEAFBUDAAREFHGGBB.DADACABH..KGDC..VABHQCCChAAA.MCHDBAGBdHGHAFIDFBFDhAAA..XEEAhABALFBC..OHAEfHGHSAEDhADA.aBHF...hABA...,2,-31,-15,16
EDbYFeHcGABfKWQPgCRXNVJMTLaOIZSdU,KEGDQCBCCGHC.RABG...XAECJGEAMAFALEDF.hAAAaDBGZBFE.SFBDhABAdAABUAGCEFACDIFGFEDGhADAHCEEAEHHBGDG........hAEA......hBAA...,1,-24,-25,1
JeCdLgEcMaPfKISUVGXTBNHbRZFQOWDYA,JEGHdDABEDEB..aAAHKBCB.UEGGGBBEBGBEHADC.RBGBFGAB.hAAA.QBEBhABADDEHAHIHCDFF.LHDA.hABA.MIBCIHAH.SACChAFA......hAGA...,1,-27,-36,9
TKVRPIaJHcYfMObGUgBZNAeLQXDdEWFCS,eFCALDCHDBFBdCCEFCECCCHD..KABARCAB...aHACHAFA...hAAAfHEBMDHBGDAGhABABFFHAGFDEAGCSEEChAAA.TABC.IHHGcGGCbADFhAGA.....hABA...,1,-19,-29,10
QabVZdMETSAUfBPDOecCGKIRHLXJFNYgW,BHHGDEFHeBCDGAABKAFE.RCEGHEAELFHDFDHD.....NDGG.gGBHhAAA..hABAQECB.hADAaCHBVEEDMIACEAHHSACBAAEE.PAABhABACCDC.IEADhAEA..,1,-17,-23,6
XPYfaLFGJRAbDSMKONeWgZBUTdHEVCcIQ,DGHHKHBGOACGeEFDZFBGBGDB..UBABHGFECDEF.QBFChAAA..PAHHaCEHLCCDhABAJAFF.AFFFSGAFhAGAMEIF..WEAGdDHA...EHEEhAAA......hABA...,2,-39,-14,25
XBSRCAOTLecdPUMVIKaYEQJfGWDHZFgbN,OFCATFCA.LDGHeEFF.dGAFUCDAMABGKADE..EBEBfAGAhAAADIEAFBBD...hAAANDBEBABCCHHG.ACBG.PAFChAFA.aDDCJHFE.......hAIA......hBAA...,1,-26,-28,2
TSZJILeHcVgOaWQFUGRYAdCbDXBKMNfPE,CFEDDAFBBECDKGAF...MEHD..PDEAEAFE.ZCADLCAFhAAAHECH..VEGFaABCFCGGhACARACBABIH..dHCDXGEAhADA.NIAH..fDDHSBAF.IBGHhAAAcBDG...hAEA...,2,-37,-18,19
bTMBJfRFUINKGeCOVcSaZYWXHQgELdPDA,MFFFBAFBRFFBUDAFKBAF.GBGC..eFCACBFF.ODHB..hAAAVGAESCDHhABAZAACXEDBHEAH.EGGEPHCEhACAAACG...TCBA.fAEEhADA.FAHF..hBBA...,2,-24,-20,4
ebaFLZNcUJdTDCfWASBgIRMQXEOVHYPKG,BFEDRAADMDDCEFCD.HDDGKFEDGAGC..aFADFFBBZGFEUADCTAFChAAA.DBDFCGHD.AHCD.SGGDhAAAQBAFODHDhACA..........hAGA......hAIA...,1,-24,-29,5
ATfBcRbaUeZDVEYXdPCIJQOFMgHNKWLGS,BHHGRAADUGGEDFCH..EHDEdCCF.CBFH...JBHHOBAH..MDFFhAAAHDFAKEADGFDFhAAAAEBE...fHDBhABAaDDDeHAEZACAXDBA.IHAEhACA......hADA...,2,-33,-30,3
DROaZCBQNgPVLTdKcWAFGbJSEXMIHfYeU,GEAHSDCDEBACMIBEHAACeGFC.UDGEDGDGRAGDZFDBCGAHBHGAhAAAQAED.NDAE.PCDAhABA.LDDAhACAdDDFKHBCABIHFFFA.........hAAA......hABA...,2,-15,-10,5
DXGebUTNBJLCPEfQYMdVOWaSIRKcZHAgF,FHFGGACBeCDHUGEGBAHBCHDC...ECGAQDCFdBAB.OBADhAAAaADCRFCAZCAEHBFCDFAHXDGEhABA.TGAEhACANEICLHBA..fGHEMCFF.hAAA......hABA...,2,-18,-5,13
aDbMCOSeHIWVcQTFUBGKdAgfELZXRNJYP,EHBGZAEGREDC..JACGaCHF..DECE..CCFE.SEGAeGAEHDBE.hAAA.VAFCQABDhAAAFGEEBDFBKHGE.AFIDfHEBhABANCAH..PFCGMIBC.IHHHhABA....hACA...,2,-40,-10,30
UKcIDbJNLWQORgZSPFdEfABMTHYaGXeCV,TEBCHDAGaFAB.GFEBCGHG.KCGGDIAC.JCBCLFDF.OBBChAAARFDCZAEFFCHDdGBCAADDBAHEhAAA.MCAB..hABA.eGAG.........hABA......hACA...,2,-29,-24,5
AOCSTILXDHGZcFYdRUKPQbegNfVWJBEaM,SDABTDAC.LFCBDADDZEGHFBBFREGBKDEG..QECDhAAAeBCF..gAFHhAAAfFFAJFFFaBGHAAEGIABGhADA........hAIA......hBAA...,1,-23,-33,10
CJgbfLNTIBPGcEZSdDaeXHAUOYKWQRFVM,UDACKDCDQFEARABC.FEHFMDFG.CEGC.JBCC....bFEDhAAAfGAF.hABATBAHBHBBGECChACAZAFDDDABeHBCAHIBOCEH......hAEA......hAFA...,2,-32,-23,9
UFWNKgABaCOGXLZYJVSEIHfPQDbceTRdM,aBEEGACBLGFAJCFC..EGECHDFE.fDCDQBAGDACGhAAAeEFAdBBBFEBDKDDABGHHhAAACBHDOHACZGAESAFEhABAIFDC.........hABA......hAFA...,2,-19,-16,3
NDOCFaRBIMVLGdXJgcHeQKfYUEbWPZATS,SGFCDEFHOFAH.CEAF.RECB.BHED..VBAGGCDE.XDFFhAAAJCEG.HGAAKADC.hAAAfBAFUGGF.hABAEAGF...WDCDAHECNIBHaCHDIHHF.hACAdBDB.....hAGA...,1,-9,-33,24
feBLFXZYERdKHATQUWNCIgbDGaMOVcPJS,UCCBCFDG....ICBHDAFFMCHFOHDE..PGFEhAAASBFEBAGEXGDFhABAEGFEdECFAADF..QGAGhAAANCAC.........hACA.gDEHhADAaDDAcCGEfGCG.,2,-37,-37,0
WGVFDYKRNLQBbHSUMATfZCXEPeJIgOcad,ZEFHCFCF.EEDDeDAE..JADAOBAC.dBGGVABHDHGA..KEGALCHHhAAABBEBHEEBMDDGhABAAHCA...TGCDhAGAPFAFIAHF.......hAAA.aHCE....hABA...,1,-21,-36,15
QFfYEXdIReMBCWNVKZGOTJDPabHScAULg,UDACLDACQAGCFABDEGBB.dFDB.eHDABAFF.CGDB...VACAhAAAKECDZFFFOEEATBFDhAAADIGA..aBACSFHHhABAADHC.fDHAXGBCMDDEhABA......hACA...,1,-16,-30,14
JYAgcFaTMVBINEfWCGLOHRXdQbKUPSDeZ,FHBGTAEDMEHD.BFFDEAAD....CGHGOHACXDBG.QBGEhAAAUECCSDBFhABAeFEDZACHAHEB..cGFHhACAIBAA.WAFFHEFE.dADG.PCFChAGADEAH.....hABA...,2,-34,-4,30
CEdgQfVRXSOMcaTYbGJDFNWKHPAeIBUZL,eAFBUGGGCBAEdFHE.QGEARECD.ODBFaAEC.....hAAATBCG.bDFCDDBFhABAFBAFWCGB.KCDBACHCIHADhAAALHBAEACBfEDE.SEADhABAMFAD..hACA...,1,-20,-38,18
XJfagITPScERFQbYVWUKNHMCdBGLODAeZ,ZAEGXDACJFFF...aHAC..IBCETFCH...SFCGhAAAEBDDRBFHFFFHQAAChACAVCAF.KCHBMDEEhABABHGHOEFGAGAE.......hADA......hAEA...,2,-36,-20,16
IONPSALeaWKQZfMCcVDUYJbGTgREdFHXB,aAABQGBCZGFA.MEFACHAC..DDFFJAGFGCCGRCBB..FAAHXBGBhACAOHFESGGEhABAABBD.LAEDhACAeDBDKADC.........hADA.fGDBhAHAcGCD...,2,-34,-27,7
MbYGDcJHWeSPgOZdNCaIAfKFLBVQRXTEU,KAFBBDGFQGDBRDBE..TFAGMDEGGDAEDHGCHEFCSADChAAAOABHdAFAaBAGABIHLHCAhAAAXEEGbCCBhABAJADB.....WCHH.....hACA......hADA...,1,-8,-24,16
UePaGJCYAfNDIFBKWTVdLgMZHbXcEROSQ,DACBBFEDKGHB..TGBCdAFCLEAEZACGHDFG....XEGGhAAARDABSHGAUBGE.hABAeAAHaCDF.CFHAAAHH.IDCEhAAAFHAEVFDF.MDAE.....hACA......hADA...,1,-22,-26,4
ZJcOPaWdECIFMANfeSbYTgGDXRQHKULBV,eGEASHBG..bCCHTDDGGBEFDECBRABHKHBEBFGC.JABF.hAAA..OAFBaEGGWFADhABACHGGFBGD..AHHENADFfDAEhAAA...XACB.hAIA......hBAA...,1,-20,-29,9
FWJDEfBbOdNGPTeIQVgRXCMYAZLScHUaK,ZDEDSDCDUAEHFAAFDBHH.BACGdHADGDAG..eGBA.hACAIBEDQCCGhADAVGEGRDGBCHHEAEAH..LAAFhADA.aHACKGFBEDEAOFCFNDIA...hAEA......hAFA...,1,-17,-27,10
KWAYPGZgMDBREUcJbXaLIVNHCOedfFQST,GAFEZFACMAIBBGGGUBCGJADB....aCFHVFBCHEFG.CHBD.dFFBhAAAFECGQBAChABA.KAHBABAHPCADhAAARDACEHDA.XGGA.......hACA......hADA...,1,-19,-20,1
ZQCEYMdPJfWVUNagLKDcRbIBOXeFHSTGA,QADCEEGDdAAD.JFCHVAFG..aEGCLCCA.DFAGRDDDIBGAhAAAOHDAFADFTCAGhABAAHIB..CEEGMDIDhABAWHEG...NIAF.cGGA.BACD.hAFA......hAIA...,1,-23,-26,3
IJFbOZeEHPSBVNRQfaTKGWXALcUYDdgMC,LDACUCBCdBFF.CFAAFFFEOEFG..EDGEHFAHBAHFRFDF..aAAAGGBBhAAA.AIHEDABCMAIDhADA..JCEF..eHFAhAEASCGENDDF...fAFAhAEA.KBBE...hAFA...,2,-27,-23,4
URQgPZEJXMFDbYcBHNSWfGCIKaATLVOed,LADGeFFCdDDFQBAFZEEFJCHF.FEABDEAH....bGAABHGHhAAAHADASCFBhABA.GCAHKGHBADCBVBGDhAAAOHBA.........hABA......hACA...,2,-35,-13,22
dcgRKPNWZVfBQHEeXFabYGDSJCTMOAUIL,UDACdDCDRAEAKCAB....PDDCZFEDBABAEDHF.FFDF..aGGAGCGEhAAADCBC..SHCAhAAACHHE.MIFChABAAAHALFAF..cAGH...hABA......hADA...,1,-35,-36,1
ZIfeWXYGCDRLFBOAVPTbSHdgJQUcNMKEa,TFDHSCFC.dFECQDFGUDAF.MCBCaAADZGAEeDAG.hAAAXGACCDDARDFD.BAAEhACAAIBC.bAFE.gGGGhADA.cEACNEIAEBDCfAGFhACA.YHEGhADADIEEODHD.,1,-11,-18,7
DJBeTcFOgRLCPdWafUSKAXNGYMZHIQbVE,XFGHGAFEMAAFHBAFQEDA.ECDGBEFA.eACChAAAFDADOHDA.gDGHhABARFCFLBHFCHBFdBCChACAfEBFSGGBAEED.....hABA......hACA...,2,-31,1,32
QdMFBOALENUgPWXRbaSHfZcGTDKJIeYVC,EDCDUCBC....PCFGXAFG.RDDF.SBCCHDGDZGFAGGAFhAAATFAGDADEIADEhABAVFFDdBAC.MEIDhAAABFFEOEDDAAIB.LHAANIDH..hABA......hACA...,2,-12,-11,1
DdfEGbOXNBgCKUaJYWZIcHMeVSFQRALTP,LDACTAFB.dDGCGDDGOGCEBEAFCCED.aAAE..JAHHZCGDHEAChAAAeECD.FGGGAABGDGGEhADAbFAH....XGEHhAAANIAHKBBA.UADEIGAE...MIFEhAEA.....hABA...,2,-22,-7,15
eSHVfNPMGLcWEgFAYROKJaZICBQXTDUdb,RFDFKGDBZEAABGAC..QCEBDGIDdADD.SGAGHDDA..hAAAfBFFMBBHLACDhABAECBB.AIBEYHFEhAEA..........hAFA.aCGDXFGBhAAA.TCGA.,1,-14,-42,28
TJPOGdEYgaIfVZCUcNBRHQDbWSeFALMXK,MAFHXFCAKHAC...JHAEOAGH.GBAGEDBG..aFHHfFGFhAAACBBB.UCCGhABANABFBBGEREDADIGGbDFGSHEChACA.AICA.......hADA......hAEA...,1,-21,-40,19
dKBEFYRJDAMgOTUWaLCPZSGfQVNXcbeHI,OCHDTCGC.UFFCLAFEZEAG.GGBHQAEGXABB.hAAAeGFEIHBDBEDFYDBFhAAARABBAHIH.WFFEhAEACDAAfFDA.NDDF.cCDA.hABA......hADA...,2,-28,-1,27
ebXAcOYJdEHUNZLDIMPaGRgFWSBQKTCfV,OGEAdDCDHAAGZCBELCHFDGCF.MFAFaAAB.RGDC...FDGGBBGChAAAKAFB.CFBAeAECAAHG..hABAJBBEEDFB.UGGE.hACA.IFAE.......hADA......hAEA...,2,-48,-12,36
GUdaEQeXZfDBWRMHgNYIbKTAFPJLCVOcS,JCCHLFCA.OEADSGGGGADCUGAGaCAA...QAFBhAAAZAFBDIAGBHFFMBAChABANEIA....IABDhAAAKEGEAEADCCHGdGDE.EEEDXDFE.fHCBhADAHADB..hAFA...,1,-18,-27,9
fMSNgXITPCGQKDZLVEWeAbaUYcFJBRHdO,UGBCFHBGBCBEHCDCdFFFOAHD..SBDBXFGF..TDBAhAAACAABKGHB..DIDGVACGhABA..eEAEACAC.hACAaCGDJHDA.fAGAMGAC..IBFEhACA....hADA...,1,-6,-51,45
aTJSKAgDMbXWNEVfCIdReQLUBGcPYHOFZ,MCHFXCBC..ECAFCCHD.dFFGRDCC.LCDDBGHHGGCB..hAAAPEBDOFFAaAAETADHhABAKHGADGGE.bAFCNDAA.hACA....IGDE....hAAA......hABA...,2,-28,-25,3
BbVaeFSXQZYAHgJKURDdPMWLOCTfINcGE,HFDFKDCDRCGD.dCAC.MFFCLFED.CBCC.fECE.IAGAhAAA.GCDFhABAbGFAaEAFSFBDhACAQAFBAICCgGGGDBIBWAAF.OBBAhADATBDCNAIE.EDFB.eGAAhACA...,1,7,-32,39
aQFHJDKYUeGTZgLAOWPfcISVXRCbBdEMN,OGEA..fAABSCABRBFFBDABMCDB.QFAFhACAFEEGDHDAKAAEeCDB.GFEHhADAZCFAAGCG.PHBChAEAIAFBCECEdHFDEEABNAIE.aHCC......hADA......hAEA...,2,-35,-1,34
YMABIFVPHSgRLOJNQbZcaEDWTUeKCdGXf,FEGDVGFGHCBC.SAGCLCCCOABCQECBZEFEEFAGDBAEUBFFhAAA..eHCEhAAAKFAHCADDXEDFMIFAAAEEBGDHhABA..........hACA......hBIA...,1,-21,-23,2
AHadNXDgBERVLUPMIYGJSbfKOcWFTeQCZ,HFEEaAFB.dFBCDBBCBFDCRCCE.LBADUFEF.MAIFGCAG.SHDGhAAAfGHCKFHHhABAOAFDFAHB.QCBAhAAACDGGACAH.NAHA.EGBF......hACA......hADA...,1,-15,-26,11
UOAgQcVKNEdLaMbPGWCTFRIfJBDYSXeHZ,QCBCVDAG.EGBDaGAA..MCFHGAFECGFD.FGHFRAFBJADHBAHDhAAA.SGGDhABAeHDGZEAEODGDAEHCKABGdFDF.hAAA..bADB.........hABA......hACA...,2,-18,-16,2
JMDGUIWeQfKTLPEXRgbFHCBcYaNVASOdZ,SEEDODCHZEDHDFGFUBDG...eCGHQAFCKGHHLAAFhACAXBBCREAHFGCHCADEBHCChAAAaCCH..ABBC.MAIBhABAIAHF.fHFBTDGC...hACA......hAHA...,1,-16,-36,20
UOVZGINDeCMaBHfWcgXJYTLAdPQEbFRSK,QGBCEAFBFGDE.SAEEKCACUGAAZCEEGFDH.DCDCCAHEBECDhAAAHCBE..fHFHhAAA..gGFHhABAYDEGAEIB.dABFPADBOEBEIEFDhACAMAIB....hAEA...,1,6,-43,49
XJGRCQWaIfFYTHNdMcDbVLeKgAZOBUPSE,ZFEEBFFESABAEEABGCDERBFE...CGHF.aFACFBADHECA.MBEFhAAADIBGLAGBKHEA.hABAAHIHOGBE.XBEBhAAAQCABICCFfHAB.hABA.NAIE.....hACA...,1,-14,-31,17
FCZLWgdTSNRJfBQaeXIGEVPbUHODYAKMc,KGFHMHFGFHACZCCHLDABdGBB..SAAFJDDF.BEEBQCFFhAAAaHAC.XABChACAIDBH.VAEAhACAPEHFUEGA..DIDGAIFACCHB..gAEChADA....hAEA...,2,-33,-20,13
aVbYORAXcWGSZfLDNPUCBKMFQeETgJdHI,XCBCGAFEZDAEDEADUEFH.BCBFFECGEADE..JADFdHCHHFBAhAAAaAHH......hABA..YFGBhAAAAIDESGGGNCCF.CBHEMIFAeFFF.....hABA.IDGG.hACA...,1,-22,-31,9
XJUPDIVLHfTMFCgdeEBAOKZaYcNRGbWSQ,ODCHKEHBZFAF...aACD..NDGE.RDDAGEGE..SCFChAAAQAACXCBChABAUAGDIHDEHABAfFEGhADAFHAAdFFGBAEFAHHHcAGA...hACA......hAHA...,1,-15,-24,9
NLQSAUDXbeGYIdMcPaWZHJERKVCBOFTfg,DFEEXDACGACCdGEEMIBE..aCFEHAADRAAD.CCGEBAHAOEHBFFBChAAA..TACC.hACAfGADNEEBLHFChAEAAGIBeDDH.IAHG....hAAA......hACA...,2,-24,-23,1
YKFfMLNHWXEgbaJRdCeTQGSUZOIPVBcDA,KAFBFGFHLBBFHCEEEBAG...aDAHRGEAeHBEGCGC.ZECD..PFAAhAAABBHBAHHG.MCCChAAANCIC...XGAFhABAJDBACEGESAHFODDA.IACFDACE.hAFA......hAGA...,1,-11,-19,8
VeHQfYWBFEgLJCMadcNSZXTKRPUGDAIOb,OGEAVFDF.HDCBQFAD..YAFFFCBHEGGEJBHDCBBBMAEFhAAA..dAEHSGAAhABATDEH.KAGCPAAChAAADIDAAADDeEEEBCFBaDDBNBIC.....hACA......hBAA...,2,-20,-10,10
OEPQbBHZaCAcRLefIdgMSKVTFYXWNUGJD,RFDFLEEGeDAD.dHGB.SDCFTGFHFACG..XBAFhAAA.UAEFDBBFPDCBhAAABHAFaCHFAHBF..fDGBhABAIGDHKFAAWBEGNIBFODEG..hABAEAGE.....hACA...,2,-25,-21,4
AKEISeRfBdWUZQgXPNJaGDCTLcFYbOHMV,KAFBEAFB.eCDGBFHEdCBCZBAG..QFFH..PDDChAAAaEGADFCDCEBCLHEGhABAFACEOFABMHAG.AIAAIGFBhACASGHHfAGBWDDD...hAAA......hABA...,2,-33,-29,4
YKBFZEfLdWGIQeVACNUXOJHSMRacTDbgP,UGGGXFCAOACBHDBA.RACF...TGEADGFG.....hAAAbEBFPHECBAHDFAAFhADAEHAGdAFHGBDAQDFEhABAAGAECAFG.NDIA.........hACA.SEADhAEAcDGE...,2,-24,-13,11
RYGdAPfgHJbWQeXUDITNcOKLMaZFBEVCS,...fDCDHADGJDAAQGGGeEAEXAACDAAD..IFEDhABANFEF..cFAAhABAOCHDLBDChACAMIBCFCFEVGEECDDB.SHAGYGAAACCEbAGF.hACA......hADA...,2,-25,2,27
IfLGZFTdcbaPRMOVAQEWeBCJNDYUSHgKX,EGFCeAFBBEAACCED.DGAFUGEB.HCGBKDDC...XAACLFCDhAAAFEAHTABFdFCAaEECMIFEhABA.AAEB..JEFESDBEhABA.IAHFfBGF.hACA......hADA...,2,-36,-23,13
dFONKCVbYDREBecSTHMLUaAgZWJIXPQGf,ZAADJGEA...XEAGGCCDFAGBKDHDCEFG....VFBBDGDERCCFBEABhAAA..eHCASEFGhABATGAA.HABEhADAMFIH...........hAEA......hAFA...,1,-32,-33,1
YGeaZKOdEFbUCVRcJXBMDLQTANSIHPgWf,SHBGHAAD..PEDH..gEBDfFGGGEDHhAAAeAGBaCEBKAEBEHDEhABAbEAB.CHHFRCCG..XFEDhAAADGAHQBGHNIEBWACE....OHAEhAHA.....hACA...,2,-22,5,27
NdUagMbIYFSJCeEDAKRHWLVfQGBTcZXPO,RBCFHFDFLDHBQBGBGEDCTCCGZAFAOCFFdAEAaABH.MAAFhACA..IBBDhAAAFGAESHGECEBDEGACDIAEWDFAhADA.BEBHPHFA......hABA.NCAE.....hACA...,2,-14,1,15
SOfLATKWIbJRcaXFBQMZUYHNegGVCPdED,KGFC..bDBHJDFGRABA....aHACFAAEBHDBMFFGZAGF.HEFCeAEGhAAA.GGABCDDFEAEGDBAHhAAAOBDCAGEG..IDFFhABAQDACUGGFNIEF......PDDBhADA....hAGA...,2,-28,-5,23
MYELGPVXNabSHeQfdgWROJFDUZKBTICcA,MHFGLCCHGAFAXBGA..aAADSABFQEBGdHGFhAAARFDFFCDDZAEGBEFDCHAHAAAFEADEhACAPFDD..NCIE.hAFAHDAH.eACC.fGAE.hAHA......hAIA...,2,-17,-4,13
CBWbXKeNQMaLOZcEHVFJTRGfYPUIAgSDd,SHFGDFEABCAB...XDCBKFGGQAFGLCFEOHEEhAAAEDAEFBCA.RGBAfAGFhAAAUEABAHDB.CEGCeFEGhABAMEEGZADF..cFAB....hACA......hADA...,1,-15,-43,28
XeYPTCOgbcZIRUaLQMSdGJfAHWBNFKEVD,BFDDFAFBKEECDAGD..eDFE..PCAACHFC..OEAA.hAAA.gDDDhABAZABDIBHDRFADaHEE.MEHBhACASBAFdCFD.fFGHAADCNBBBEGEA.YHAAhAAA...hAFA...,1,-28,-38,10
bOWJcTFPKXgZAdHEVNBaLYefGSMICQRDU,dEHAEDAFBCGEaAFE.LEFFeDAAGEEC.MCAGCAHHDHAG.OFBEhAAAJGAE...TACDhABA...FDDFXCFBhAAAAHHE.NBAD.SBFDIHDE..hACA......hAEA...,1,-23,-41,18
ALcYDKfCOQTWUgEMNVGeJZadFPBSXIHbR,LGEADACBCHCC.TCCGUDAC...ECGFMEHHGAEBZEEF.FDBHBECBhAAASAAFHAECADGD.hABAKHAA.OFEG.hADAWFAGNEIA..........hACA......hADA...,1,-20,-43,23
dAIbPFQGVCBUgDSLJNWOaERKecTfXYZMH,..IFDGbDED.FFABQAEC.CHAGBGHADCAEJDECOHBGhAAARFGB.eDBETAEDhAAAXCGDMADDAGCFPBAAhABA...........hABA......hACA...,2,-45,-17,28
XKbeAaMZETgVOUIGLDFfYCdPNJWSHcBQR,MFCFTCCB..VAFEOACG.GCGGFGFECBCD.dGFE..JAAFSBEAhAAABGDC.XEBGhABAKDDCAHEBZDAAEHBC.hABAIBBDDFAB.fGDDPEFE..hAGA......hAHA...,2,-36,-21,15
MCdJeUOEKZINgXQDBWRGASHTbVaLcFfYP,TCCBVDAG..LAHBFEFG..fADBMAFBCGED.dCAEUABGhAAAOGCCKHGCZEEANFAD.hAAAQGAFDCEA.hABABBGDWHAGAEIH.SGGC.bAGB.hAEA......hAGA...,1,-18,-24,6
SBOYMfcReQbZEGDIHVdFgTXaKNJWCULAP,BFEDMDEBRDFEeHBA.QAACZADAEEABDIDEHAFD.dGGFFGHDXECFhACAKAAC..JCCDCBDFAAHEhADA.SEABhAEA.OCCEfBHGbCGD.IFFHhAEA......hAFA...,1,-1,-40,39
XIHWafGQAVTKJZYPeLdSCFDNOBgREUMbc,KDAFJFBBZDCFeGEG.dBFCFBEF..DIACBBCCRBBB...UGGCMHBA.hAAA..XEFEhAAAHAGFaAEAQBGAhABAAHFE..TDAFPFACCEEC......hACA.NEIAEBDBIBAFhABA.fDHC.,1,-10,-32,22
MELTUbWYAKHPBNIefgdcJCZOVXSGQaDFR,KCFCBFDDeHDEdCABCHEFZBAG...ODDHSEBCGEACDEFFFFFGRAED.hAAALAEA..hAAAbGACAHIB.HCGB.IGGFhABA.fBDE...hABA......hACA...,2,-30,-28,2
SZNAWOGQCXLgfeRUPJVBHMEFIaTDYbcKd,GECFXABHLEBD.eEHFRGDAJDBCBCACMIAAFHEA.TAGAhAAADAEG...bAEFdDGHhAAAZABCAFFEQFBFhABA..CCCH.fADG.UGGEhAHA......hAIA...,1,-11,-27,16
aRVFIQUSdECbXTMDNABZYWOJfegGLPcHK,ZDBHOGEAJEGD...eEDCGBBFLAEA.HCGDaBGFFEEFIDAEhAAAQGAGdCDBCACBTGCHhABADIGAAACG.BBBChAFA.fGAE......hAGA......hAIA...,2,-39,-13,26
JSEVbHAPaZNQWgRIKOBMGXeLdFTUfDYCc,aCFCQFDH.RAABKECEMGEE.GAAFeHFAdAEDUGAE.DECCCBGH.hAAAJEFCSAHBhACA..EAHHbFABAAAANDAHICDFhADABBFE.FEHHfGHA..hADA......hAEA...,2,-33,-9,24
JIAgZMcCEfKHPYLVRTaGNXUDBOFbeSdWQ,ZFACMBFHCHGD.KFGFHDEALADDRAAC..aGGAGGBB.UECHDAEBBDCGhAAAOAAFFCFASGADhAAAdHAF.QBGChACAAFBC.........hABA......hADA...,2,-36,-18,18
WHMULbEdTYFGeXKJaNORcSQPVZABgIfDC,BFDG..gGAFDECHCFGBHAGFUCEBLDBEdAFFFEHDGAAFhAAAeFEFKBBF..JFAHaEAAhAAARAEF.QGFDhABAZGDEAHHE.fADAMEFE......hACA......hADA...,2,-19,-18,1
XeaJbLDOAfgBWHMICEYSKPFZQVUNcTdRG,BFDGHFACMAFECEEB.EDEAKACHZBCEUFAE..TGGGRGEE.eBABhAAA..aDHD.LAAFhACAAEHAWEDA..IADHhABASDEEFHDE.QAGE.NIBFdAEEhAGA.....hACA...,2,-29,-15,14
ZKMceNfbUYVHJICTBPDQAXLdSFWOGRaEg,XGGDLEGHFDCEGBBAEHDE.ZCGH.MEFFeFBE...NCDH.fADAhAAAUBAE.VFAFhABAJFAH.CGDE..PAFEhACAAAIDdAEF....SCGA.OEFBhAAAaDEG....hABA...,1,-4,-24,20
EQXNBUWJFLOICfKeZPgMbYAaGDcRSdTVH,aEHBGDCC.DFGCSAGHdGHAHFADECEFQEBDBHEE.JBAFFBAFhAAALHDACAHC.KDDEhAAAZADAMEABAEAE...hABAcFEG.........hACA......hAEA...,1,-23,-26,3
OSRHdZEfBeADNFGMVKWQIXLaJgCTcbUPY,DGHHGEAHMCCHKGGA.QACDLFDDaACECHEA....TDGHhAAAbCGD.UAGC.OBEDhABASCADHCAAdGBDhACAfHABAFGF.NAIGFFFH.IAFAhAAA.JDDE...hAEA...,2,-16,-9,7
DGgfCULRXaAQKeJcTPZNWIFdSbBVHEYMO,QGGDeFFB.JACGTDFA.ZGCAIFEBdEBHSBCBhAAABBGFEDDEOACA.hAAADIACfHAFhABACBAERAGBAEIBKCEE.PDCB........hACA......hAGA...,2,-39,-16,23
dSTfNGIWCEXBQLKHAbMZJcVYPDgFeUaRO,MECGZFDFJBAA..VACGDGCF...FFHFeFAFUFAG..RCDAdFGFSGFHhAAA..fDBGhAAAICACEAGGhABABHGGKDGDAFFB...cFDBPAFE.OACAhABANIAFCCGB.....hACA...,1,-29,-30,1
ZNcVJgdMbSFPKGEWRLDHQIeXYUfCTOaAB,ZDBHVAADdEEE.MDECFHDAGDGA.RCDD.LCAFHAEE.eBHBhAAAXGAB.UDAFhAAAfGBECCHB.OHEGhABAAGGBBDFBNBBF.........hACA......hADA...,2,-31,-11,20
QGeMNYUIcVSOHTEWgZPaDfCRBAXLJFdbK,XFCAFAABdGAFKCDDGBBC..MIFEUBEH...IBAGhAAASBFAOFFHHDFGhACAEHAGZEAADIGACGGAAIDAbDFAQADBhAEAeDAD........hAGA......hAHA...,1,-8,-29,21
FSWZGAObEHdKRPDBaNMYTXCeUgVLQfcIJ,EDCDHFEERAEF.BADC.MBHBTGEF.CAAF.UDCELAGBQGCChAAA.IHAAhABAJCAD.SAGChACAZEEEABIDOBBAdCEEKGHHDGCDaGGF......hACA......hADA...,2,-24,-14,10
POLMAdWSGaJHEUfFYNRbXeBQTCIKZgcDV,dAFBGEAHHCDCUEGCFCABRDBDeACGBHFB..CCDHZAAHDGEA...OHDAhAEAAIAG..aCHBEGAG.hAAA....fFEFhAFANDIEXGBEIAHFKABA....hAGA......hBAA...,2,-31,-28,3
CTbYdUcPVFBQGIOASafeZgEKRHJLMNWDX,SAFBeCCHEABDKEFBHCFG.LEADMHFCDAIBCEFG...TADChAAAdFHAUAAC.cEBBhADAPBGFBBDA.QGEHhAEAOFCEaHAEfFCA..hAHA......hAIA...,1,-16,-24,8
GYUESJXPTBNVZReaIQMOLDHCgfKAdFWcb,dAFBFHBG.....bAABUEDH.SBDEXDEDBECDZAAFeAFEhACAQCGEOEGDDCEDhADACDDAKGEBAGEB.GEAEhADAJCFE.TGGC.NCCF.aEAH.MIDA..hAEA......hAIA...,1,-11,-26,15
dVMWeYcTRENCIQSBLDaZGPXbOfAgFHKJU,FCFCHDEDUABDdBHEMEDD..eFBA..TEADRGFCCEHF.SADGhAAADAECZBDB.PEGFhABAOCCBACDC..KBBBJCAFhAAA..YHAAEHAA.NAEFBCGCaAGE..hACA......hBAA...,2,-26,-17,9
dUAQaKRPLYcMVEOeDJWIgFSBfTNGZbCXH,aFHBKCFCLBBD.MFBCOHBE.JDFB..IDDGhAAAFADHBAGGTGFAGCADCHDAHDGBhABAACHGQAAFhABARGAAPADA....cEAH....hAEA......hAFA...,2,-37,-13,24
VRfDMBNdCcYKFWQTHZGJAEaegISOXUPbL,EEEDeCCH..SAEFOAGFUBAGLBCFRFCH.MIAGBFACCGGAKCFAhAAAQGFGZAFEJBADAEGBhABAIAEA.XGADhAAAPGAAfEHEdEHGFEEE...hABA......hACA...,1,-14,-19,5
PBfUZDAgcEdVaXMeLJTOGbKSCIHRQNWYF,EHBGdEHAaDAD..eGFELFEBJBDH.GBABSFBAHFAGNEGGFDAHhAAA.BEHEZADADDDAAHDG.hABA.VAGFMAHDOABDhADACHHE...IEFF....hAEA......hAFA...,2,-28,-12,16
JCIENAWUbGZaTeYDfBMcSXOQFdKgHRVPL,UCBCGEDHZGFEaAGG..eEFADBCEBCDE.MDIDSBFHhAAA.OGAAFHCGgGGBhAAAHADDPAHFCBAHEHEChABAABAH....bFECTCFD.fFBChACA.cDAGhADA...,1,-15,-29,14
EeSfRXTaZFJGOIKDPWVNcUdHLMYbBQgCA,EEEDSDCDRDAF..aACDZDEHGGEHOFABDEDH..VGCAUCFGhAAALBHBMBIDBHAAhABACBFCAFIBeCAD.TABAhAAA.FHGEKCDA.PAEE....hACA......hAEA...,2,-23,-11,12
SBWJFgHAaRTYfQcDXLGNKCUOZMIePdVbE,TCCBQCBC.DBADGEAFKFCF.UGEGMEIBeAEA.dDHAVEEFhAAASACFBHFAFBFAhABAAFFEaGHB..fHABhACAcBGB..LBADNAECCHDA..ODFAhADA....hAFA...,1,-5,-27,22
XcLfAeOQaYIMCTNHbBPRVWGgUKZdDFSEJ,eFCAQAAD.aGEEMCBE.CAFEHEAABBFBVFACGDEBKDEEDHGEhAAAFADFSHBEhABA.EAHDXEEGhAAA.fAHEADDAIFHGNIAF.PACC.hACA.WDHF...hACA...,2,-19,-19,0
AUbKJQWcfBPTYSXGeZIEgdLHRDCFVOaNM,KGFCJDAC.QFDE..fABEBHAHTCBBSFGEhAAAeFCDZAFHEGGHLBBChAAAHBGFCGBFVFDFaEAHNEDDAGIBUAEChACA...cDDFYAHH...hADA......hAHA...,1,-8,-19,11
aMcWTYEFIAHRdPeBVKOJCfZSgUNDbLGQX,RDDFeCCHBHBCOFDD..JBACCGACZCGDUBGDDIBG..LFHDhAAAGACHaDAB..MACEhABA...TDBFhAGAFFHDADFE.dGFCKAAB.SFFD...hAHA......hAIA...,2,-35,-26,9
EdODPaVFTJNQSGgeHYBLMfcbRZXIUKCAW,EAFBDFDC..aDAGFABD...TFFCJHDA.QECHSFCGeDAFhAAABBAGLHFAhABA.fHADhADAbAGBZBEFXGGBIDGDCFAGAEDAOCED.NAIA..hAAA......hABA...,1,2,-42,44
ARQfTCgdFZUBEJDGIXcPbMaHSKVeNLYWO,QFDHCHHGFFDH.UBCHECHBGAEG..XCGB.hAAAPFABaABHKDCANABE.LDAFhACA.WFFDhADAODDE.AIBGfGGFdHAFBGGC.DCAB.hAEA......hAGA...,1,-26,-28,2
MXOaWTBAVRKQSCGDbYPdfILHEecNJUZgF,RDDFQFCECAEC.GAECDGBB...PFFDdBBEIAGEhAAALACHHDGDEAAHeAHDhAAAJFCFZBFEMEBG.XEGBhAEA.aGADBHHGACBF.KGFH....hABA.SACBhAIA...,2,-35,7,42
PQCOBfgGdcJTKLWNYXMAbSIVaEHZRUeDF,SHBGVDAG.ECCAZADH.eHDEFCHHCFCGOAGF.BHGBfAAEhABAdFGF.TEDFhACAKABA.LAFHhADANEEDMAADAIDE...........hAEA.IHGBaGAC.hABA...,1,-25,-29,4
XNUDZEICaHAOLSKYRBTJFfVceGgPMbQWd,SAABKCFCBFGCFCBE..VEGDGEBFMDBC..QGEChAAAdADGXGACDBCEEAEGCEEAAGDCLAFChACARGAE.fBGBhBAA.eEBC.....hABA......hACA...,1,-11,-38,27
OLIZXMRBfVCFUeNdHcSEQAWYDJbgPGTKa,DACBJGEA.....PCEHKDAFOECG.ZFADXBGCBGCF.hAAACHAEFDHFUBCD.dEHASDBEhAAA.QEAEhABAAAHC.bGFE...gFCBhADA....hAEA.aFFAIHDF,1,-32,-51,19
INMCPFYBXWOQRcgETZdSGVLJAefDaHKbU,eFCHDGHHHEBHKGHHUAFAMCAC..FDEGBBCB..XGEDOCCEQBAChAAARADE.hAAAEEFAdHBHGEAELDADhABA..AHFDaGGBIAHANAIE.CEHD...hACA......hADA...,1,-15,-22,7
WaPQKfXRLgVUBOZcJGYIETdSHebNADMCF,MEIBFEGD..aAEFQGEEKAAE.XDGBRECDLAGF.UBCChADABBFDZEEFGBBChAAAEBHB.SEDBhABA.HGAANIADAHHA.DBEH.CDAGfDFEhACA.gAGEhADA...,1,-18,-26,8
VKEMdZRFDCbNYABTaQPeIOJLfgGcXWHUS,BFCFTFCAQAGF.eEGHIGAHODAHLBAEhAAAGCCBXAACUBEGKEHFMIAEhABAdHADFFEGbFEDAIDCaDBChABAfGHC.WAFESHDEEDADDCCBCCHChACA......hADA...,1,-4,-13,9
ODLbFMfUAZJaXYEPHBeCNRWcIKgdTVQGS,ZDEDaAAD.EGHHBDBG..eAEACHFB.RCCH...IAEEdFABTAAChAAAQDDG.SGDDhAAADBHBFCAHfHEBhACAAHAFXEGC.HAGFNBIC.....hADA......hAEA...,1,-20,-32,12
gbCNOcGHaURYXDKSPWFBLQJATfeVdIMEZ,TDACeFBBdGDA.MGFCZEDGCGGB...OFBFGDDDHACCRACCXCAAhAAADHEGKDHF..SDDGhAAAFAGEBHFG.QAFChABAAAFCIBAG........hABA......hACA...,1,-19,-24,5
fFRJNBMSZeOAdVUDYgLXTGbECIKPQHWac,UCCBDACBLEAEGDAGCEFBKDGD.HFDA..aCHBFAGDRFCD.BCDHMFIHhAAAeHFA.dADDVAEEhABA..XBADhAAAEABF..QFFB..fGAEhABASHAGAGHG...hAEA...,1,-11,-28,17
YKQEAGRUbZDgfeMcJHLBaPOXVSTNdWFCI,RCDFZEFHDHGAeCAD.MBCAHBBH.aHDE..XGCGSGAGTEDChAAAdDHECCAD..IAGFhABAKFACAIAEGAEF.hACA.bDGFfFFBJCCD.BABFOFABhADA.NIEH.....hAEA...,2,-17,-13,4
bTWIgLPAUVGQCfHRaKOFNSMdXEcJDYZeB,VACFQGDH.HDEFKGCEOFABFAECSDADdDEC.XECFhAAAJBFGZAAHBHDH.hABA.WAHFLFHDhACAAHHCUBBCCDFH..aGFBMBIHEEAE.DFCD....hACA......hADA...,2,-21,-15,6
bQAVEcDSKBGUadRTFgXPfZMLOCYNeHJIW,VDAGEHFGDHBG..BDGDUEADdBBH..RBADFEDF..PFDGZBGBLADAhAAACHCH.eFFGhABAIGBC.QAGEhAAAADDG.SGGE.aHFA.hACAXADFMCID..hABA...,2,-40,-24,16
XMWdcgKYRHZSUeFQVCfTLGOBDNAaJEbIP,aEEDEDCD....IBGHMBDHdHBH.KGFBHBADZBEA.UGAAFAFC.CDHDLADBhAAAOAAFDEAEAFGBJEEFhABA.....hAAA............hACA......hADA...,2,-44,-29,15
ecgDEBCGXOKMYUQLHWbAfPIRNZaFTJVdS,..IFDGNEHA.ZCEGaDBD..FAFATGEHdDAB..SGGGhAAA.eDHFgAEHhAAABBBAXGCChABAOBABKCGEMFBDYEDA.LHAEhABA.....hACA...,2,-29,-25,4
XSNBcdQIMGFCLAOHYDEZPaeRTJKgfUVWb,OFBBDHCEECAC.ZCCF..aEFGeAAE.JGFEKHAA.UAEC..bBEGhADAXDCD.BHGAhAAAQGDEMFIFCHFCABGEhABAYCHB.PAFA....hAEA......hBAA...,1,-26,-39,13
dRWFYSUCbBaDeMVcXTfLNGQZIAJgEHOPK,EDCDHFDFKGEEdAFE.FHGEUCFABCED.DFGBMBED....VBAGhAAAXFACLCHH.hAAAGEBGIHGF.hABAAIDGJACH.OEHFWEADCADCeBAH.fHAFhABA...hACA...,1,-24,-25,1
NQVIMaCdKPSRJUYBHDWTGEAXeZgfLbcOF,eADGZAADLFDBODCHFHAEQAEE.MDCHCEFGdHEF.SBAChAAAJHFABFGBDDGGTDGBhABAAEAG...gBGChACAfACFbDDFcDDA..IFAFhAFAaAHDKGBD....hAGA...,2,-26,-21,5
MXdOZJcCKABUNSFERfQGDegILPHYaTVbW,UGGGSAFBEHCC.RFBCGAACeEABLCDAHGFE..TEEAhAAAbBBD.MBIFdEEBOAHFhAAAcADF.AADBBCAB.hACA.NDCHFHCEDGAB.........hABA......hACA...,2,-22,4,26
dQOKLDUfJbaBMHPRSVEWICFNAYZTgecGX,TFDHeGEAGEBB.dAFEQFBELBEDDIBEfDEDhAAA.aADDMIEE.RBBFECHBhAAACCBAAGGEgAGChABA.ODABKACC.......hABA......hAHA...,1,-15,-20,5
XIdOMGTWJFBPCcfHeLYZQVDAbUSKERNag,SGFCKEHBEBEA.RCAG.aFEF....IGAGMBBAGCEDhAAATBFAFDAHBACDCBHFHDCAhABALFBBQGABhACAAFEGNDICdAFB..WHEGJFDF.fGGBeDEG.hAAA......hABA...,2,-20,-3,17
SXEaATZdCDcLGMgfVIQKJNRbHeBFOPYUW,dDAFCAEDLDAGMGEE....VAFBIDHFKHDG.RFFEHABBFECDOHFGhAAAUAGE..SFCHhAAAaEFEZABE.cFAEhABA..fHAB....hABA......hACA...,2,-30,-20,10
YZRfLcDPCSVJGAUBINQHdOEbegKXaMWFT,BHHGQCBCdAFGODCGEDGD..eGAAKEEH.MADAFBBE.ZACCLAHDhAAADCIFCAAC..SFGGhAHAVDAF.AHDAIBGChAIAHGBEXDGCWFFD......hABA......hACA...,2,-29,-16,13
IfAJHbOaGDSdcVReYTEXNLQgPFZBKCUMW,JFBBHFDF.aABADDDBdBEG.RFAG.eFHH..TGGCEBFGLABDhAAA.QFFFhADAPAHBBEEBKHDECEAHMBBD.hAEAfCCAAEEBOCECSDGA.hAAA......hAEA...,1,-21,-22,1
eJOdFYNagbDPEfXBKGMUcHQACIWTLZVRS,CFDGTCBCZBCC..RBGH.JDFAFFAC....aGGADIEG..EHFEBEEBhAAAMAECHFGFACGE.LABEhAFASFBAOHAEhAGAdCAGgABE.fEEAhAAA......hADA...,2,-34,-32,2
YBcbIUeZTCDMWPgFSGELNJOVfHXRKAaQd,QFCEBFED..IBEC.eHBCCBEFDAAC.MFFFPDDGhAAAFBBGGAGA.hABAEFAAJEACODDEVABFfGGDhADAXEGAAHHBaDABdBHE....cGABhAEA....hAFA...,1,-19,-32,13
KTgGJCAOVIHLQZEWdaNBYbcSFMXDfRePU,OFBBVGFG.HGFGQBGDEDCA.dCDFaHCEBGAD..YAAFhABASDAH.MGBAhAAAXAGGDFEGRABHeDHDhABAKDGATEEHJAEEADED.IAEC.WCCChACA......hADA...,2,-22,-11,11
CadcEbXHWMPKDTANLeVOIgYSUJFRZGfQB,LEEGOFFC...IGDFSDEFJCFC.FBDEZAAFQGDGhAAACHAF.dBGAbACCHEAHhABA.MCIHDIBGNIEFgABAhACA..UEAC.fAFBhADABHHDaHAC.EDEE..hAEA...,2,-27,-5,22
VeUbBSHZdGJNPXAcWDEMRCFYKIagQLfOT,DACBMFCFCAEC.FAAC..KBAF..aCEGQBEHLGFC..ODAEhACAeFGBBGBCZADGdDFDJDCHhAAAXGDDABDF.EAHBhADAIHDF..fFAE.hABA......hADA...,2,-52,-14,38
JUYSMCWBAVZLedHgaDNKbcXOPGfTIFQER,VDBGeFFCdCBA.HFAEaABH.KDEE..XGGGOACG...GGBBhAAAfECFFBGF.hACAEAFAJEFESAHHhAAAMADECFBGAHAH.LGEG.DIGEcBDFPHBChABA......hBAA...,2,-17,-11,6
ULSdWJOaPYKNcbQVTGgBCIFZHeEDfMRXA,UGGDLEGHdGAA.OCCH..aCFDKGCG....bEBFVADGhAAAGADBCCGHZFEBEBCDDCBFMFDFhAAAAICE...SDAFhABA.WEEA......hACA......hADA...,1,-24,-44,20
eWQBJZHSFbDKcgaCdNfILVTRUYMOEXPAG,eFEFBHHGHGDAFAADKGGBaDGF..dDGF..fEEELEBERFBBMCIDhAAAEAFH.ACFG..QBCFhABAZADHDFAFCCCC.VDAFhACA.TAGC........hADA.UGAF...hAAA...,2,-31,2,33
QDEIBGKRZcVCMTNHXgfSJYUabeOPLFdAW,QAFBDGHHBFBDGDBBRGEGZABA...CEGB.TDDBHABH..XAEBhAAASDAG.UEGHhAAAeCHB.OHBEhABAPFCBFGFBdGAEAAIB.ECAEKFDBMDFENDAE....hACA......hADA...,1,-9,-15,6
RCeGJUOHbXEFIaQAdfZWMPNDBLcTSgYKV,dCFCZAADMAEDDDDBLAAG..SFCCKCGGCFFF.eHACUCAAhABAHFGH.EGEHIHHBhACAAEEAPAFA.cDGGhAAATFBD.....gEGHhAEARDAA......hAFA.OAFC.,2,-29,-3,26
GVUHSRaZbDQdEOLCXfMcTKYJgBPWFAeIN,eGEAGAFEHCGBSDBBREBEZABDDAFGEFGCLBADCHBF..MBBChAAAKHBE.JHEABBGCFDEFABAHIDEDhAAA..NDAC.hABA............hACA......hADA...,1,-24,-29,5
RTKHVICAdDMSeJbfZULFWQaXNOPEBgYcG,MBHHeFFB..JBADZBBHLHAGFFBE..aFEFODFEBAFC...hAAA..gAFBhAAAGADEKHGGHDCFICAChABAdBEEDCCHSGGE.....hABA.fFHAhACA...,2,-31,-25,6
BGTIKLEFANUJHfZVQaWOYRbPXCceDgSMd,UDACJFBBHBAEZGDG..QCGDOBEERDEF.....XAAChABACHGHDGGEMAAEBGAB.GAEFhACAKDBGEGDBFEDD.AFGA.hADA..fAHEWCCE.....hAEA......hAFA...,1,-23,-29,6
AeUKGHLQWOSfcNPaTdIRVEXDYFgbZCJMB,UAADKGFHLAGHOBGB...SBBH..NEBATGGGhABAdFBBIEHC.VDEDhAAADFAFFFCEZADACBAABDCBhADAAIHC.HBDD.fHDFaFAH...hABA......hACA...,2,-30,-27,3
OYfdQbeUCSRBMAXPGIHKWELNZFDVJagcT,XFGHGAFEKFFHLBDDZEAHDIEA...JHBCaBDF....TCEAhAAAOFHH.dAAFbAGBhABACCCEBHADMFAAABBG.IDADhACAEDHBFFDG.cEFB.....hADA......hAEA...,1,-16,-30,14
WSOeAXRYNcMBHaFKbEDQTZUIPfLgCdVGJ,REFH..NDDG.BDDCHCAFaGBDFFFB..KCFAEAHB.DEFEQBBBhAAA.UAFBfGHAhAAACEAB.dGBE.GACFhABASEHBAGAFYCFAMIDA.....hABA......hACA...,2,-41,-10,31
eaOZJAENSdCbBKDVfQHFGLYIXgcUPWMTR,EAFBSAFBdBBEBHACKDFG..DDGEQAABFEGB.LFBChABAXFEDgGGHhADA.PHBCTDCDhAAAaDCG.OFFGACFFCDADfACB..hABA......hAEA...,2,-48,-8,40
BDCNaRTHIJWVFPMYEGdLbgOcSAKQXfeZU,KEHBQCGCeAADBHDADDCG..CGFC.RBEEHDDB..IFDAhAAAJCCBFEAH.MDAF.EHBG.hABALBBDgGGEhACASBFDAHBG.fHGBNADF.aABAhAEA......hAFA...,1,-24,-35,11
MVJZPBGXeYRcUOFACIbfKQSLDHagdTWNE,CFDG..fBBDSGFGHFECdCEA.TDECEGAE..MIDGZADDBHHHhAAAeFFERAACOHBEhABAFCCDAIAA.ICAAKAEALAHHhAAADCGEaGAC.WDBH......hACA......hADA...,2,-17,-17,0
LFEBJUaNQPOWDRdXHTAZYGfcgICVMeKbS,ZEBHGAFE..fFHAIHEFCBBBMAED..KCAGLBFDhAAABCEGJFGHaBBF.NIAH.OHAAhAAADABE.dEABTBGGhAFAAABE...cDGEeDDD.SAGEhBAA.FFFH...hADA...,1,-7,-37,30
YDBZSTVGXNeWFPMfaJIUOREKALdCQgbHc,CDGFQCBCHDBEDABEBFAASFAG.GDEDeEHHFFCDMBAC.hAAAJAHFUBBDRFDG.AICELFEFhAEAdGHCbAEB...hAAA....ZAFE.......hABA......hACA...,2,-28,-12,16
GdTbWBMHOLfaKDgRcIZCUPNSeAFJEYXQV,FEEDEDCD.QGFEdAAE..TBGDBHHBMDCBHGFGLHAAhACAKBGDDDIF.gAEHhADARACFZBADCAFC.PEBB.hAAASEHBAICC.JEEAXFCH.hAEA......hAHA...,2,-31,-5,26
NMYTDgZKefbcaHURXLOJWAGIVEdBFSQCP,GEDHVDAG.EFBHFGHBQAAC.CCHE.NHCH...MBECDABBZDFAhAAAKHECeCDG.fDAAhACAbACGHAFBREDELHAGhADAOFAHACIHBCCG.SGGBhAEA......hAFA...,1,-8,-15,7
NPLfCGVXKbRDaIcTSBHdgZYOFWMUEeAQJ,QDACJGEALEDFCEHDGGCB.KEFDbDAD..DBCC.aBGCIAFAhAAA.SCHDhABABBACgCDAhAAAOHAEMCDAEFBCAGAF.fACCXGGF.cEFAhACA....hAEA...,1,-19,-38,19
IHSDXaMCVAdGTKWZQEJeFcYgLbfUPORBN,GBDBKGFCQEABeCBGFAAB....gADAfGBGOCAChAAABEGF.HFCFDFACaHDEhACACDEGVAGDAIHGdEEA..hADA............hAEA......hAFA...,2,-30,-19,11
XTAUcfWRSKeNdIYgLEHJMaCFGBZbOVPDQ,UCBC..fHBHSCFHeDADdBDA.IHEFLHDCJACAhAAAMCIDFFGEBAHGZFAGOAFGhAAAVDDA.DGGGTBAFhABAAHBA...cECC.....hABA.KEEDgCGEhAFAaACG.CGAD,2,-28,-21,7
RPJVFAgBcQSIEYMeCdTUKZbWfXDGNOLaH,BFDGSGFCEBFH.MDBDCGGA..dCBFTDCAZFAF...fAEFhAAADFFCOADALCFAhABAHDBAJAHBFHCAADIH.cABDhACA...YEFCKAADXGEDhABAaGHD......hACA...,2,-32,-9,23
cJZgKPaWAfbXISMedBQLUYNVFRCHTGODE,XCBCSGFHdGDCLCDE.UAACNECG.RAGBHEEAOAGBEGAEhADAJFAFKEBA..aGHFAIDG.hAEA...fFHAhAFAIAAGMBFH.BEDB.QACChAEA.FFFB.CEHADAIFhAFA..,1,-11,-19,8
gMKIXZHEaJbVLecBQCFAfYDSTNPRGdOWU,DACBTGBCRADBGDDH..ODDHUFBH.KBDEZAFAaCED..JAAFLFFFhAAABFGH.CHHFFBGGhABAAFIH.SGGChACAdHADMDAF.XDAA..EHDA....hABA......hADA...,2,-29,-19,10
POLdeNfWacTIFHGRJYEXDVBCbAZMQUgSK,ZFEEQGABSABAOCFDLCCH.dGACfHGBhAAA.aDCATCAGHADEJBABhABAEGBAXAEFhAAABEHEAHFDMFCG.KHCANIEHWEFE.....hACA......hADA...,2,-17,-16,1
fcEJWSUNbDaCgFOQKHVGIeZTRdYXLMBPA,EHBGSDCDUAAD.DBHHCGDB...FCAHKEFGHDECGEAH.eBEHhABAZBCAdGCFLAGDMAIFAGHHhAAAJFHB..NABFaFHFOBDBhADA....IGAF...hAEA......hAFA...,2,-23,-21,2
QAIbPRUOBfSdFgGXYMNLcZJDCeWHVKETa,..IFDGbDBG.RAFE.OACABCDAdHGBFBGAGFCD.MBAHhAAANHABLAACZGAADIAAeBBGhABAHCFDEEACQCFGhAGAACIH.fFHCXBBC.....hAEA......hAFA...,2,-25,5,30
NIREBMHDCdGUFeQVTgWJbcSZAKOaPfLYX,KEEDaDCDLEHD..XAGGRGBEBAFAMAHBCDHHdFAGFADF..hAAAeAACQCAChABA.TFGDWCBE.JFCDhACAcFEHADDF.fEAA...hAFA......hAHA...,2,-33,-28,5
GeKTJDUNFLMEAISPdRQBWabcCOZgfYVHX,SHBGdCFCBEGA..aECBCEFDZDGB....fHGFhAAAVAADGBEBeBCCJEDFDABBFADBhAAAEDAHAFAH.REDH..QGAGhACA..cFBHYAHFKDDC..hADA......hAEA...,1,-23,-26,3
aQECZIXULeFbBfgOSRJcADVNWGHYPKMTd,VFDGGAFE.HABGKCFH.dFGC.EFBCCGBGZBCHXDDBLHAA.FAAFhACAfCAF.hADAOHAGRAGDAIFEDHGGNIEH..hAEA..YEAEMFAC......hAAA.aFED....hABA...,2,-29,-7,22
QYPFMKSgAfULdOCRaeIbXDGZcNBVJWTEH,UDACdGDBRBCG.eCGB..IDFCDDDDZFDBBABA..JFAHEAHDQGGHhAAA.FDAFhABASGGEACIHLCGBhACAaAEB.XGAD......hAAA......hABA...,2,-41,-30,11
ACdJNMZIDOeESBUaTYVRGWLKfHXbFQcPg,JCAFMECGZEFFDAGC...EDGCBCHB.UECDaFGH....TEAChAAARABDLAFHKBACXADAhABAFHAC...QFDFhACAPEHDAHDH.CBHCIFHE.OCDChADAYHEA..hAAA...,2,-43,-15,28
dfOLVaBMJQXSZIKGeHPAcCUYFTRgWDbEN,UGGGTGBCRCBF..DBDGEDEC..dBHGLADEBBAC.JCCG.QAAChACASGEBIGHGhAHA.KEBGHFAFhAAAAHEFCFFB.FEDE.bBDAfDGF.aBGEMAEChABA.....hAIA...,2,-27,-24,3
LASPCOJFfXVaWKdRcUNYDZIbGTHBEgeMQ,CFEDFAAB...XDFDVGAC.KGCERADHUCAHDFBB..ZAFAGDEFhAAABGHF.EABEeCBB.MAEDhACAQAGD.hADASGGEOHCEaDDE......hAGA......hAHA...,1,-22,-32,10
ZTSEWdBcgDFbLOJUaKCAIMGXNHYRPeVfQ,GBGAHEFHRBBCeAFHQBACZFBH.SGECdAADBEDDDIGELECGhAAAJAHB.aGBBAGDF.IBFFhABAMEAD.NEAEYACEhAGA...fDDFEADE..hAHA......hAIA...,1,-10,-23,13
PcKaVDNGAUBILTFQMCWRHZbSEfOeJgdXY,BHHGLDACQBFACFAARFBF.HEAFZAAEEEGAeACH.dFGD.PDDEhAAAaGEFDBEC..AICGIHFEhABAFHGAMAIHSCEAhAAAfECGOCAB.....hABA......hACA...,1,-7,-31,24
QgRFGBKfDALbIZSUHCOXWMNJdYVEecaTP,LGEAZAADSCGBCEDD..XCGGMEACdFABEEEEeHAA.TFGGhAAAQBAA.hADARGAGFCCAGCCDBDAG.hAEADGIBIAHFOAFC.NIDF......hAAA......hABA...,2,-24,-7,17
OSUFMNZJQKXBdeGCYVPERTHLgfDaIcbWA,SAADFBDHMGDGZCFHKEFG.BEBGGEAD.CAEE.VCDH.EAGCRAAFLHBEhAAA.DIGGhACAcADF.AGIDOHDAhABANAHE...QGAD.XCGFhACA.dGGA.hADA...,1,-15,-29,14
VRYeXZFASObBafJgILQdEHPNUWDKcMCGT,OCCHaEGD..JFBCLCHB.dHDHEAGGHADDUDEADABCKBACCBFH.hAAAGACERFAG.eHDAhAAAXGGBACHH.BHAGhAFAIHHGQEECNCAC..MCIF..hABA......hACA...,1,-15,-26,11
UKVBOYXJHRLFZPWTQANDecMSaCEfdGgIb,DEFHMDEBCHFD.dFBHGEAF..IBDEKDAEBGADOCCB.JFHDhAAARACGFDHF..PBABhABA...TGEBhACAAEDEeBAG.aBGAEAFF.fHCD.hAAAbAGHYHAG.hADAXGGE.,2,-37,-12,25
gbafReFYHDIVWTcdQAUSJGNPCMEKBZOXL,UGGDSHAEGCAGCHFD.MFCABCAH.ZAAELABG.aCHFRCFFeBEHhAAAFCCE.DAGEIAFChAAAVECB..TFGFhABAQGDH.AHAEJDEEEBGGKCCE.gEAFhACA...hACA...,2,-20,-11,9
IVKabSALQDgNYTZEWdFUXHMceJRGOCfBP,LEGHQAFBDAGC....NECAZEEGdGBGFCCFHADB.MDDFeFDBhAAAGBAA.fGHChAAAPBEAKFFFaACBABBE.hABATGEEEEAE..WCHB.....hABA......hAGA...,2,-33,-6,27
AZNKWeVOYgCSaDBEFfMcGQbIUXTLHJdRP,ZDAGKHBGeAFEOFFB..CADE.SAAADFFBBDGA.EHBC..MEEHhAAAQBDF.bBGFhAAAXCDCHFAAdEEBAGCC.hABANEIC.VCAF.aGFD.......hABA......hADA...,1,-9,-40,31
MIUSdGEaATFDQfbVJNWOPeRHCcXLKZgBY,DDFFQCBC..bBGDVGCG.JBFDOGAC.eAABCEADLACGhAAAKACCZCCBBGGHhABAMIFEUGAAGFCBAFGEFAHBhABAfBFG.NICH.PECC...hAFA......hAGA...,2,-24,-13,11
eEZgANIfcbPOQJWGdBRHXSTaMCVDKYFUL,..IFDGfCFC....PFAFJFFHGECERACH.SBDDhAAAaGGACGCD.KAHDhABAFCFAeADGEGFDZBAFgCAFhACAADEH.cFAB.OEHBdAFFBEHChAAA.....hAFA...,1,-20,-22,2
JUTYBgZLXMIdDecRCPbfNEFSOWQGAVKaH,VFEEKEHBHGFA.JBDHUCDG.BAFCLFDD.MACGDBCCRCAACEBC.hAAA....fCHEhAAAFCFCSBBFhABAOHBAQAGEADGD.aGAHgEAAhABA.IAHFhACA...,2,-44,-17,27
ZCAQBRDfWbIOPUMGNVTeYKXEgLJSHaFdc,QGDCBFCFRDDBDDAG.....bBCAOEHHMEFAGDAD.hAAAVFGHeBCGKAGAXGBGhABAEFAD.LAEEhACA.SDGFaCGEFACEdAAECBFBAIHA...hACA......hAFA...,1,0,-34,34
EIXVZNLWSTHFbQaYgBOAKdcUCDPGMefRJ,KAFBUGBCDAAHMDEC..RDDG.EEFA..XGFDZAACLHFG.hABASEBAFFDDaEACBHBAhACAdAFGCDAB..PBCBhADA...fBHEIAHHWEADhABA.TFGC..hACA...,2,-40,-31,9
ZGeLQJcMVHPFWCEBIKNdSfAXRbTaYODUg,REFHaGFCDDGEZDAFLADA..JACAMICGHCFDFFCCCAAE..BGAGKAACdCDChAEAAEHD...XFADhAFATDCF..OAFAhBAA...........hAHA......hAIA...,2,-38,-37,1
PaDWcGSLKdbTBERMVegHAOXJZFNQCUIfY,OFCAJADGZECC.FBCH..CAAF.UGAE....ICDA.hAAA.YCABDGGAGDEBhACALHFCKGCH.bDGHhABABHHCEDEE.VAGFeADGAIFG.NCEF...fDAEhADA.aBBF.hACA...,1,-25,-33,8
GAMCcHbLDRIVXTaFSOdPEBYQKNgfJeZWU,MBFHHDBHDEADREAH...IHHAXGFCFBDDdBBHBBFBKGCC...hAAA..NAAF.fDDAhABAJEEDZBGB...WCHBhACAAHAECCBF...LAECaGGGSGDDhAFA......hAGA...,1,-24,-32,8
FJdZDfMeQHBYKEgXLUcWOTAVbRGNSPIaC,VGFGREBHGBCF..SAGDaEGF.CHBF.FDEDZBBADICA.eGFGhAAAQFCEBEABEACALDADhAAA.WDDAhABAAIAAbAGH...IBAEJACEMDIB...hABA......hACA...,1,-16,-26,10
BQTXaNcJfOPEULYeCHKRZdAFbGSWIVgDM,GEAHSHBG..VBGHMFBCQBBATCAG..XFGHhAAAcGAA..OFFBhAAAPDCEEAEDUCGEeEHFhABACAEGKABA.ZFAAAIAEWEDEDFFF.BCAD..hACA......hADA...,1,-11,-12,1
SfTHVKALCFZGgYbJDRaWMIcUBNQdEeOXP,FDABZEBHGBDC..gEDGJFGDDCBC.RAAE.MEAB.UBGFhAAAQCED.EGHHhAAAOFEFXFBCSGAHhABAHAGHAIDCCEHFaDFE.......hACA.cGFBBADFNEIE.hADA...,2,-23,-23,0
OWNGAeBSDHgITaFYZfRQbcEKUVCJXMLdP,SDABHFDGTBAAFAFFZBEH.RAGF.QFFBEFAA.KHDECHGAMFIBhAAAdDCGOEEAGGAFABCEBABChAAAIDDAaHAC..hABAfBHA.......hACA......hADA...,2,-24,-8,16
eJfHIdVPMKENZUBLFXgSAcbaOWCRYGDTQ,aHBGOAFB.RFFGGDCEQAGB.eBCEHABGdAAC..PEADhAAAMEFDKCCBEAHF.NEHGBCGDhACAFGEHSCAFhABA.ADID.bFDHCEEBDCCFfFBH.IDAFhADA....hAEA...,2,-26,-5,21
AXIUWTcCaLHfPSDQMYVRNeKdbJOZGEFBg,XCGCUCBC..TCGGCHCDHFED.SEBHQGCDVAAChAAAeADA.dHGF.JDDCZAFAhADAFFGGAIGAICDChAEA.aGHFfAAHDAGE.MEAH..hAAA......hADA...,1,-10,-25,15
JNSBZCIXObFDPcMeLYKdVHfQRUWAagGTE,GEAHTGGD.JAEEBGDCZBAB...CFHBOAGDDFIB..MEECLFFDhAAAKGDAdFGEHBCH.hAAAQEAFUACAABADECHBhABAIABA.XGBD...hAIA......hBHA...,2,-28,-18,10
JZIGTaSCBdRUYFXPfNHKceDAMEQgOLVWb,EAGDQDACLCCB..VFGDJFFDZFAFGAAF..aCEFSFDAhAAAdCAG.UCGBhABAFEHBPABCfCDHhADAKEEDDGDBAAHH...MAIFWHCE....hAEA......hAFA...,1,-18,-20,2
fTOJFLGIVCWRQdcbDHBEAMYaZegPSNKUX,MHFGaCFCZEEB..eBCF..SFABUAFFTFDDOADEFDFFLAAFhACAIABECHGGQEAGhADAdDAFDFIHBCCEhAAAAHDFPCHFKAHB.fDDAJEDB...hADA......hAEA...,1,-7,-29,22
TfgPFZKCcGYUWQBIdRDJSbaOLMXVNEHAe,eDACTCBC....gEFBFBABCFDGGGEFUACGBAEBdFAAJHCEhAAAaFFA.LCFC.hAAAMFIDXCGE.hABAEGCBAIAAfAGFZBEEKEBDWEECQEDGhAFADAGE.....hABA...,1,-4,-22,18
YgLVeHSGJMNbKPBFdEOADZQacXCWUITRf,DEFAaDAF.CCBA.UDEC..REAE.....fHCDLEDHHAEChAAAGABDMFIFKCGEBGHFhAAAEACAAABGZFFF..cFAEhABAICHE..gGEBSHAEhAFA......hAHA...,2,-31,-28,3
RXdJaFKMWgfQGDcPTVCUZLIHOABEYebSN,EEGDeGEA..SAEFREBBdAGEFAAF.KFDDMIFA..fAAChAAAGDEBDDDATAFCUACF.hADAZCAB.IDDGhACAAIBGBFAD.NDIAaHAC.WEFD......hADA......hAHA...,1,-19,-27,8
RPdJDaeMHZfYNBbGKATVOWcLXUQESIgFC,VADGOGEA.LCBCQDAHEHCA..SDAGFEFGCHAC.dBFEhAAAaBGEHDFC.fGABhABABHFGGEDCAFCBcDDChACAXAAC.IGHG...hADA......hAEA...,2,-25,-16,9
QbXIFMSfCBagADZcEdGVWKOTUYeHLPJNR,ZFDGEAFBGBGEKABEUDBHHDCE.LHAE.JABGQBGHhAAA.IHGGhAEASFGABAFCACFFDAAFdEHEOHAChAHAYGEAPBCCNIEF.....hABA......hAGA...,2,-27,-17,10
OAdfFNHaPRbZULBKWcYTCQVJgSMXIEDGe,dAFBFHBGHCCCaFEA.RFEBZAAGUCEELBGBBGDB.KEAH.....hAAA.WCBB..cAEChAAACGBH..JDAHMAIFhABAEDHD..DIGE.eABEAHHBfCAFhACA.NEIE.....hAFA...,2,-39,-21,18
QRLOIJBeFcKDWUYaEZVgfCNSTXdAPHGbM,HEBHMEAELFGFJEHFBGEC.eFBAKACB.DEIBUDEH..EHDEZAFA.hAAA.VBFDCCCG.TBCEhABAAAEF...PHAChACA...........hAAA......hABA...,2,-51,-13,38
BZHbMLEJUIQdOAVYeWKfPXFgSCcRTNaDG,VFDFeGEAKAGE....XBAAFACBSEGCCBEB.RCDB.NADDGDBFhAAAZEAEHBABMBIFhABAJGBEUBGFdGBG.AIFG.fGGGhACA........hAIA......hBAA...,2,-25,-19,6
PTNadCLZIKEUVSeWQOAcJDFYgGMBbHRfX,JFCHDGHHFDEHGGEFBAHDHAEG..REAH.XCCH..PAADhAAAaACGLEFG.hACAKBHHECCFSFADhAAAeCHDQADEACCB..YBAFgGDFhADAfFDB.hAGA...,1,-7,-38,31
ZUegFWAJISbRCdHDKLBaQYOXcfPNETMGV,SDCDCFDDDIEA.LFHBBGFHQDEHXFCA....hAAAfACGEBBGMFBFGBEFhABAVAEFeBHFWDAAhACAADDFIGGF.dHBBaADGODABPDHFhAGATBAA...hAHA...,1,0,-32,32
LPXHbGZWacIKfMTCJeQUFgNVdBSOYARDE,DGDELCCHHAFAGBDEZGCEaCEA.KFFE.MFAECEEE..QGGGhAAAFHDA.VCAFBDAESGABhABAAABHEHAA.PAHDhACAXACB..cEGAIHHBfAFFhADA...hAAA...,2,-33,-6,27
HSfDXbgERWPQYdCTNOVacZKIAFUJGBeML,FGDDUDACBHFGeAAELFFGHFCGDAIF....XCBAEFFGRCCFQAEChADACBFG.OBHHhAGAaEBBKAGAAHHBMEIDhAHASCHH.fEFB...hBAA......hBBA...,2,-45,-11,34
IDHgCBPcQREVTSXbMFGLJONZeaYUdfAKW,KHBGDACBCFDGBCDA..QAEGEEBE..SFDAMAHFLEFEhAAAODHBeDBCUGGBhAAAAHID.HABC.gBGChABAcGADRGDA.TFACFBAB.....hABA......hADA...,1,-22,-28,6
GUReZAMECbWcPaHTIOSKYQLDXfFNdJBgV,CBGE..bAAD....PDGBaFBHHCEAOFCDKDDDQGFFhAAA.DAGBfGAFhAAAdEGFgACEUABCZEEFhAEAMFAHcDBBSHCAYAEB..hAGA......hAHA...,2,-35,1,36
HDFdTgcKISZBbQOLVNXGMAJeCfWaPERUY,JEGHeAFB.CCED...aCGERABHUEBGHFBHDABD..dCHE..TAGDhAAAKEFF.ZDBEBGAGOHEEhACALFHH.NEEG.hAAAMFAF.fADDEHBA.YCCEhAFA.....hABA...,1,-14,-35,21
feCTKJEBRZbWIXgdYPUALaFHMGVDNQcSO,LEGHaEHBHFCEGGEFDFBFQFEF.ODBGCBGGJACCEEECBAGFhAAARCDCZBAB..ICFChABAdFAA...PABEhAEAAIAGMICA..NIEFfCHEKDCD.hAAAWFAD....hAFA...,2,-37,-3,34
ScAXLRKWJVZTIaYbfgdFPQGUMBNDEOeHC,LADGRDAGKGHH.VCDGZADB..aGEE....fFAEhAAAdACCQGBAGABCBFDBhAAADCIFEGFFOBFBCGCHAAHEXFGBhABAJAHF.........hABA......hAGA...,1,-17,-33,16
HaTECDRfSGNYPIXBFObedAJMKcUVgWQZL,KFAGVEFHQEFH.ZAAFaAGB.CCEFDBCF..SACDhADAGDBH.PFDBIGDDhAAAFBHFOHEEdADDMIBEhABAUAECLBHFEHAAfDDBYEAFBCAFhACAAAHE.....hBAA...,2,-18,-11,7
KMbaOQcGEBHfNTYFJUeLgDVISCPAdZRWX,ZBCFXFDHKCAA..aBGDOAHF.GDBABGBHHFGH.TBEFhAAAJDDCLAAEhAEA..DBIFSHGAhAFAAHAHWFFF.QFGBEEBH.fBBDhAGANABF....hAHA.FBEC.,2,-30,-17,13
bdOPZIfCEXBaLYcMJHARgeKFWDSQGUTNV,RFDFKDCDDCDBQADEGCEH.UGFH..NBAF.dFDCZAFECDAE..EHBEaHGEhAAA..LBFBhAAA.MCAAHCAFeAHFhABASHAC........hABA......hACA...,2,-30,-20,10
OKFgeNJfTbVaQEHAUYWDGLSRdCcMIZXPB,UCBCDACBGBDGLCFFdHGF.CDHF.MIAGZGEGBAFEKBFH..FEADeHAEhAAA..JAAF..fABFhABATEGD.aDDDhAEAEFEF.AADC..SAHFcFBA.PDCBhABA.....hAHA...,2,-37,-21,16
RSVIKEWPeBQYFDbOaXZgMTHNGUfcAdLCJ,CDGFJDCHRDBE......SGAAIGFGEEEAeFHD.BAEFFDHBDCAFhAAAOABBZABEMFBHhABAHFDC...UAFDAIEGdBFDhAAAKCCC...........hACA.WHAA...hACA...,1,-29,-37,8
dCRbcSTNQZEHXGMDIWKgYLfFeVBUOJaPA,CHCHRAAD..SGAAQBDAZEACEAGGGEEBDCAB.KGHFLGFChAAA.eCFEVBEGUBBGhABAaHEAAHDBdEGH.TEAFhACANAIA..XACBIEED.YHEGhADABDDG......hAEA...,1,-9,-11,2
AaFeGKLRPVQMbISOUHZWgXNfTDEBYcCdJ,aEEDFHAEKGECLAAE.RGBE.QCDB.MCBFbCCBOHFAhAEAUBGCHECHZAFAXCFAhAGATABFBFAD.CHHEAFIFhAAA.....PADGSBBF.hABA......hAHA...,1,-16,-22,6
LNXJOYMKWaQPHSARGeCEDIBdVZFfUgcbT,RFBHCDHBDCGCdCEEZFFD..UDAG....bACBTDDBLAAF.hAAA.XABCJAFG.hAFAMDGFKGEFaBBFHGBAAHHHEDHBhBEABFDD.FGHD.cAEB....hACA......hADA...,1,-20,-34,14
EcPDCFTZUMeWORfQNgBHLbVXSJAYaGIdK,GEAHdAFBKAAA.EGGADIACFBBBZEAH..eBEHRCEB.QDGBBHGHHCGDhAAALACB.VAGHhAAAXDCHAAEBaFED..hACA..IGACCGGCMEIF..fADAhADANIAF...SGCEhAIA,1,-9,-27,18
WNOXaYRLgSefBPIbKHJGZdUDCcTEFAMQV,MEIBVEFH...OGCEaGBG.LBAC.eEADfHCDhAAAIFFFHADE.JDDEhABAdCEECCAEEAHD.AIACQDABhACANAHEYDAC.SFCEPFBAKHGA.hADA......hAFA...,1,-14,-16,2
cdXIaZTEGKDJbfSLHWOAeVPgRNUYBMCQF,eFBBVAAD.RCCG..UGFEBBGA.QDDGdCFA..aAADEGDEDFFEhAAAJEAG..SAFChACAHGAGOAEDAHBBNEIA.CHGF.hAAA...cFGAIDAB...ZECFhADA......hAEA...,2,-25,-17,8
HLWEMJeVAYUdOCKNXgGIfDFcRbBSZQaPT,dGFCKDAB...XABCICEADAFC.FGDDRDFABGGBZDEA..QBGHhAAATAFE.LDCFhACAEACGeBAGAADE.UGDHhAAACHHC..NEBE...gFAA.cDDChABA.aGHD..hAEA...,1,-23,-31,8
RDMFIOfKgLANeBCGTdPEYbcHQJSUaVXWZ,eAFBGCCGdDADECGE....bBDDQGAHUFGH.XBAGhAAAZGAAMBIHIGEEhABAOBACKDGBAAFCNFEFBBFCCFDG.hAAATGGH.cEAA.....hABA......hACA...,2,-23,-4,19
gVGNUdIAcRbFBEYWPLXTDQZHCSJeKfMaO,RAADBFEDEHGE.....PDHHTAFEQACCHEFCSECAhAAAKHCE.aCDEOBFGhAAAVFABUGDCABACFDFHLEAGhABADEBACDHBeACAfCDFMCAF.gGGAhAEA.dGAE..hAFA...,1,12,-22,34
VfIYPHcNgOGMRaCEQUeDALWKBZbdTFSJX,KDCDZDBHdEFH.FGHDXCAB..VAAE..fGCEhAAA.IBGAhABAYAEAHABG.cFEHhACANBICOHDAMDFGCGABEDDA......hAAA......hADA...,1,-25,-35,10
UZMLJRCPOWVIcHKdfeSbDgXaYEQNABTGF,TCCHFEABZFBELFHH.RCFH.OFDF.VCFCIBAAhAAAKAHHeFGDDFFB..XBDHhABAEACAAEBCBHAC.MFAEhAAACHEG...cCAB...fFHEhABASCHH.aCAEhACA...,1,-17,-38,21
CVbKQWMSEZUfFcDLOTeRIaAYNBXJHPgdG,BFDGJADGHFEHdCABCHFDKDDC....MAIBSECGUDEC.FGBHDGAEhAAALAHH.eBABhAAAIBDBAEHH..hABANCDD.XGGA...PHBE.hABAgAEB.hACA...,2,-42,-30,12
fgHRAPBYIVdKJcGTaQUDFCNXEbZSeWOLM,BFDGVAAD.KEFCGECE..aAGHDEEEFDACCEBC...ECCDSCHDhAAA.OEAHhACAMABAfFAFhAAARGFAAHBA..PCDGdHDBJFGB......hAFA......hAHA...,2,-43,-21,22
QFXEaAHebDfJgMSCUOWZBKNGVTRPdYILc,HFDFeFCHDBGHJBGH..MEBBUBBG.ZDCGKABEGCGERFGH..dBDALAFChAAA.FGFFaFCBhAAA.AHAB.fEAAhABACEEBBAEB..NBIE.........hAGA......hAHA...,2,-31,-22,9
dTfVXAgJaKSbCQNBHOcGMERUIPLDZFYeW,aDCDKAFBCHACBGFA.HBACGDDE.RABD.IHHGDIEE..FGFGeBEGhAAAdFAH...fEEHhABAAIHA.gGBFhACAJCHBSAEFNADHMIDA.EDHFLDAAhAAA.....hAIA...,1,-23,-33,10
NZdGISXgJVMQcfWKREUBbaDOTCFYAeHPL,eFBBHFDFLCEEdFHEGCBFXFGF.JAACQECBhAAA.fABChABAWAEAEDFHBDDDDEAFCHEBAGGEPEAFhADAIBEF.SADCMAIF...hAEA......hAFA...,1,-18,-21,3
UGVbIKeTMaCLRdAOgNQBfPJYDXFEcWSZH,OGEAQCBCBAGCJFACDDFC..FFGDEECA..SHCChAAAUCACGABF..IDFChABAKFABeHCETADDhACAMDIFCHHERAGDAGFH...fEDE..hADA......hAFA...,2,-32,-29,3
EBPYACgJQKaXVFLSfeIGbdTHZNUcOMRDW,CAFBJDACKBCH....aAHHFFCHLCFD..SGEHhAAAeFGHGACHdAHAZDFHUFAHMCBBhABADABFEGEFBHHH.AEDH.hACAXDGE.fEDAIEEF..hAAA......hACA...,2,-45,-23,22
BPLbWEVFeQJMKUSZOXgNAaHYcIDRfTdCG,aCFCHAAD...IHACDBBERFBDdAFBBFGFLEFCEEDC..eCFEhAAAQDCEKAFCZGEGOEBFhACAXFGHAGDAfADGhAEACGFF..PCAAWCCG....hAAA......hABA...,2,-33,-12,21
XQUEfVGRLAecKBHOMaDPIFSTCZbgJdNWY,KDCDBEFAMEECDEEFFGHH..CBGBZCAD..JCHHdGFA.....hAAANIAF.XADG.hAAAEGBDfGCBhABAGBBCABAG.eACAOECDaBHDIHHH..hACASAGF.hADA...,1,-38,-42,4
bLQNBDCSAcTWIdPHXRaJZFYVgKOfGeEUM,TCBCdHBHHBAH.RFCGZAEDFGCD....VAFCOEFFGGEH.UABDhAAAMAHHQEDEhACABHHDDDAHSCHHhAAAAAEC.IDCFPEBB.JABA....hAEA......hAIA...,1,-10,-22,12
XgQbCaNFcJZIMDfSOdYVWeUGPBTHKALER,LDCHXCCB.QEFGCGFA.FADDJAEEZBFEDDFD..fGBGhAAAdDBA..WDADhAAAeCAF..UDGFhABABHAGKHGGAACAEGHDREDBaHBEIAGF.OHDEhABA.....hACA...,1,-10,-35,25
TQSAHXbNGWIBLZgEfDOVeKaPYcJMFRUCd,XFDHGAFEBCCHZAFH.EFHDDBCD..OCEBKDDG...aABGPHFEhAAA..JHBAREAFCFFBhABAdEAA.TGFD.hACAABIB.NAIE..IADFfFEA.YAAFhAEA....hAFA...,1,-30,-32,2
GCUgbAONfJdZQDLIFPKYBSVTcHRXMWeEa,OGEAJGEAZCAF.DGIHLHAA..PADGKBHBBDDE..TCAChAAAHABARDGH.MAGDhAAAEDECCEHG.UFCEAFDH.dBGFhABA.FACH...SHDA..hAHA......hAIA...,1,-27,-35,8
QCRJNMBYFKLOTEAbDXgIPHSeVZGfcWUda,DAFBXCBC..PDAGHCEDSGFE.eHDGZDFCcEEChAAAdFBDaEGARAGBMABEhAGA.BHFBFABC.KBBGOFAHhAAAACIF.IAEGfAGA.WHCGhAIA.CECA.....hBAA...,2,-45,1,46
AQYcgTaOGIKSdbPBRFZDEJeCXHMUNWfVL,QCBC..YDCHTDEHGFBHKFFFdFACBHFAFBDEDIAGhAAAeBAGCFHHHAGFUBGBNACD.hABA....fEGBhAAAAHFF.gADBaGGC.IHHDhABA.PHBChACA...,1,-8,-39,31
HAgNWDYSQbUCfOJGaRBILZEXPTcKedMFV,...NDDG.DACB.SEFBUBAB.CEDD.JAECGADFBHAEZFEFEDHH.hAAA....TBDChAAAKGCAdHGB.MABFFDBHAHEBhABAgEAG..QGGFhACA.OCGDaHDEICDChADA.,2,-38,-29,9
NaOfTGdcAYeWXgBQMFZLJHIVUSDbKECRP,eGEAXCBCQBGGFAFE.ZBEHLCHHJDAA.VCFFSABBhAAAKADDRFCG.aFABTGGEhAAAGECB.ADIFgGAHhADAMBADIFAADAEE.CBBB......hAHA......hAIA...,1,-10,-12,2
VKYPcZGBXUMIeLRFNEOSaDHgdTQAWCfbJ,CFDGJGEAKBFH......PCBCGEFEUDFGICDD.RFAB.hAAAEFAC.OGBCDABCdAHGhAEAACAF....fAAHhAAAYDBHBEHHMIDCLAFGFHDA.hAFANEAHaBCA....hADA...,1,-29,-32,3
QfgNLTcASZJIaGVDUFdWXERMYPCHebOKB,SDBDZFDFJDCC.GADCUDGG.FEFBdABAEAAF..MHAA..hAAACCGCeHDAKADC.BDHDhAAAQAFE..hAIA...fHGDgGAB.NDDA..hBAA......hBBA...,1,-27,-39,12
IYeDRVCHcSOgGQKFEPMUaANTJLXZfBbdW,TDACJFCAZBDC..BGBDdDGB....IHACeACEDBAARFGFCABDHDDGhAAA..OEDBQGFDhABAKAFFEADBMCIDACHA.hAAA..NIAD..XCCCfHED.YCCAhACA...hAFA.SAHFFFEE,2,-17,-15,2
BTMEOVFCNDUWLfSZcYGbAaRQeHgXIKdJP,QCCBeFBBHCCGXBABdBHGBGEDEGBEOHEA..CEAHUGFEhAAAfFFBZAEF.GAEDhAAAaEFE.IHAGhABAJBAB.MCAD.FDGCDEEGSFCE.hABA.YHAAACCE.hACA...,2,-22,-4,18
QWAZDcHfPKLUabESRGCFYOXVBJIedNgTM,DHCEHAADKFBGLDEB.UCGEEBCBRAFCCGGBFHBA..XFFEhAAABBFCJCCBeADC.dEGF.hAAA.NCAA.TDAG.hACA...MFIFAFEEfBAA.aDFGhABA......hACA...,2,-31,-29,2
IBWKHQGYZJdFSfERUgVAaDOXPcCeLMTbN,OEACXCBC..CCBHLAECMFEF..TDGD.bFFHBFGEhAAA.KEEBHAEEYGBEhABAZECDFABC.SCGEhAAAEHDERCEEUGGFAIBEPFHF.eCEB.hACAIGAA..hADA...,2,-27,-5,22
RWGLJKPIEFbMHNTAedaXfBZcSYVOQgCDU,eEGHaFAABEDHZCBE..SGCFOGFC.CFDB.DEAC.UAGFGAFAhAAAKBDG.IADD.hAAAFHDGMFFA.NABH.AABFdFAAhACA....cGDH...YDEChAHA...hAFA...,1,-27,-40,13
JESYLPdMgZGTFXVIOKCBADfQWRcaebUHN,DAFBQCBCRDBG.eDEHHAAF.ECGELDHBdGEHMICAZAAEFEFAVGEEhAAA.KEADBAHHAHBH.hABA.fBGHhACAaGBEbADD.NEDE...SGAD...hAEA......hAFA...,2,-19,-13,6
CZgFWDAdKNVYITQRULceSfEabOJHPMBXG,dAFBKCFC...VEABTGAHUEDALECA.eGEESGGHhAAAaABB.JBACMIDABCHDhABAXADCCFHB.FEHDhAAAAHEH.IAGH.QCCBcCEFfACBhAEAEDGF..hAIA...,2,-44,-4,40
YdeGBQHWCNfDcEJgKSLIbVRZOPaUMXATF,FGFCeCCHBDCAHBEB.CCHBDDBFJCFG...KGHDLFBA..IHFHhAAAVABH..OHBAhAAAUGABAEED.dABBQAEFhABANAEF..fDHEEEEESHGAhADA....hAFA...,2,-35,-26,9
KZQPLfXEdYgbeWJGaBFNHVSCOTIcRMDAU,ZBCFQDACLBFAEGDCdCAC....gAACbECC.JFBDhAAABHHEFDDC.NAAFHFAFhAFACFHEOAHD..cGEDhAGAMIEEACCFKEGCXAEC.....hAHA......hAIA...,2,-21,-14,7
YKJgfRcTLdMFWVGXNUOHaPZeIDSBbAQCE,QGAFEEGDKBCE.JACBRCCALFBF.FGHDVAECGAAEXEDHhAAAOHDEHGFAaCHH.hAAAeCEB..DFAHBEAGhABACFEH.fDHA.cCACMADE.hACA......hAHA...,1,-7,-19,12
EJbMXcTfBYRdCeFADKVaNLHSQUWOGZPgI,KEAEVDAGLBBC.HDEESAFDQFCCUEFEOHFAhAAAZABE..IHADhAAAEAGDMACATGDEfEHChABABHHGRAGBCHADACCDDFIHNICF........hABA......hACA...,1,-1,-24,23
FaNHLgIdeOZcEATMbRBPVYKDCQXJWGfUS,MFFFBFDD..VCCCDCEGQGBH..XCGAGDBFSACDhAAAaAADLFBBhAAAdGGGOGFCEAHDAGEHTDGAhABAbAEA..REFEYDADCAFBfADB.hACA......hADA...,1,-11,-23,12
gaHTSPJXZAfGNUQLVcFMBbDEOIWRdCeYK,GAFEUCGCLHAGFFBBBDDCDACG..OBBARGFEdDEE...CGHCeFEDhAAAKFCAHBBE.TAEChAAASCAB.PCHDhABA...ZFFFAABFfDBEhAGANDAE......hAHA...,1,-20,-29,9
FWOENePcXCSUTRVHQJdZALGaKBbgDYMfI,GAEGaEHBBECADAAD.MGBEFAGF...OHCAeAAD...XCBFhABASCEE.RCCEHGFEhABAdAGHAIGCLEEAhACAKHDA.YEADWAHHPFBHcGGACAEF..hADA......hAEA...,2,-24,-20,4
VbWZDNRULgAfOPHaTJQFGMYCEdSeKIXcB,OGEAHDAGJFABFDBFGAAF..CHFGdADGeEHFKDFA..XEDAhAAABFCA.VAFCZBFADFAHhAAAUGEBABAC.aDGG..MIBAhABA...EDDC...SGBGhACA...IHHAhAFA.,2,-44,-5,39
VYdEFcBaQKLeGWZgTNJDUIHPMbfARSXOC,XCCBOFCA..CDDBdCCCEFFHBCGB.KAFCGCGCZEGF.NAEH.JEBFhAAA..DDBD.UGDHhAAAIADG.MABDhACAAGBHSACGFGDB..aDFBeBAF..hABA......hADA...,1,-26,-34,8
NRbeCWKSDFJQPBZMVdfUXALEaIOgHTYGc,LEGHEAFB.aACGIDAEHGAGGCDDRAAC.CDBD.SDHFhAAADEEDQAGDZFEBMFDFhABAfAACAGIHTCDENEIC.hAAAeEBH.FGGDBECHdAHE......hAFA......hAGA...,2,-13,-4,9
eQGRUMcJIbfaDWSgECLPANVKTdYOBZFHX,VDAGTFCE..OGDAZDBEFCBC.HGFEeEEARAEH.UAACMFFA.JAAEhAAA..IHCGhADA.aGHB.DIEEgBGAhAEALAFBPAHBAIDAKGAA.BDDB.QADDhAIA..hBAA...,2,-17,-10,7
bWFHYgTREKdMcXDVCUfQGOZAaeJPLBSNI,eFFBJEEGLACGBEAC..SBBH..NDCA.IBFChAAAFGDBHFGBTGAAKBGFMBIFhAAADGDFCEGE.UECFfDAGhABAODEGaACAbBBC.......hADA......hAEA...,1,-23,-28,5
CMdROFbVGYAWIDXSLNZHBaPKTefcQJgEU,DACBXGGDLEAEZCADBDGAKDGD..eAAFQFDA.EHCEhAAAUGCGdADH.FBGG.VBDBhAAAAFCCSGBFhABAHFABTFGEJCDACAHB.MCIF......hACA......hAEA...,1,-18,-21,3
DWJQKaYBUdfGMTCAESVgbZRLOFeNcIHPX,EEHBSCFC..VFACZCBALHDEFEEEeACG.IADAhAAAHBAHDGHBJAFEaAHDBABCdHDBMCDHhAAAAEGARFAA..NFEB.XAFBhABAKGGC.........hAFA......hBAA...,1,-6,-27,21
OVSTGEXWYQMJgZCLdKDHeBUbRfNcIFPaA,ODCHTCCB.GADCEHAC...XGFGQFFDMHACgGDDhAAACDGBKAGDHAACUBFEhABAREFE.fBBHhACAIDAE.aGAGAFED.SAED....hADA......hAFA.YEEE.,2,-11,2,13
dNGCVOIfgQFKLXAUWceDSBZPJERTHMbYa,UCBCeGEABHACZGFE.ECGEHAFE.MFAEaDFDGDABODGF...hAAAIAFD.QAAChACALABEWDDHhAFADICCJCCA.RFCA.YHAECADF....hAHA......hAIA...,2,-29,-9,20
bHcATDgSeLCKGWVOFUdfRZYBMJENXPQaI,TAFBDGHHeEFD.KEADGEGC.ODDAFCBAdFCBRABABEAF.MAIDhAAAECEE..XDGEhAAAQFCDaHDA.IHAAhABA..cCACAIFGSFFDCBHD.hABA......hACA...,1,-11,-39,28
VScGfAFMDWHKdOJPYgLIbEQaeCNXZRUTB,DCHHHDAGKDEHOFAH.JADC..PGCCLEFD.EGCFaACBCBCCZAABhAAARADCBGHA..VEGDhAGASFGF.hAHAGBAEAIDAMDFCWEADYBFG...hAAA......hABA...,2,-43,-2,41
WDXgCaZBVIMGYTcEHNLPSUfQeRObFAKdJ,KEEDJCCH.DADG..CFGCBGBGMHCA..GAFC..TAFDHCADPBBAhAAAUABF.QGGBhABAeFCAOHEEAAHEdBHAhACA..XCFEaECH......hAAA......hACA...,1,-9,-47,38
dYIUHGMWAZeTOPQKDcLXgFESBCRfJNVab,eBDGTDACOCCB.KDEALFEG.FGBDSGAChAAABBAACADGRAFC.fBAAhABAJDCC.NHDD.aHDA.dAABYCHHhACAUDGF.MBFGACFF......hADA......hAEA...,2,-31,-22,9
DgORSfBQeCJGYEMTUaLXAFHWZPKIVbNdc,FCFCHGFGZFGFKCHB...IFEEVCBGdFBBDABE..OACGRCBFBBFBhAAA.CHBG.JHBEGADEhAFA.EEHDTAAF.hAGA.aGDHAEEF..PAHD...cGEAhAAA...fAFFhBEA,1,-27,-30,3
GIMHBRONXPaECFbcdgZKLQDJYAVSUWTfe,UCCBTCBCeFEE.GAEBMBAGHEFEBAACRFAGXBFE.EAFAhAAACHADFDABdHGBZEDDKEGCLHDGhACADCADAFAGSECHhABA..fACFNAIE.aDFG..hAFA......hAHA...,2,-20,1,21
BJZTGLCXHQEbNIPWDFeOAfgYKSVMaURdc,...fHBHKGFCMBIBRBCFdEAEBGDGZFFCLABFHEBD.EAHBIAGGhAAADEEEFHFAAIEASFHHhABAUADC.JABBCGDE.hAAA....XEECbCEA.NEAA..WHFGhADA...gBEBhAEA,1,-19,-25,6
PTRSFZBYDCVGQfcAKXUbJdEOHagMIWeNL,KEHBXCGCUDBC.dFHEHFEA..aHECMDEGeFBBLHAC.hAAARADAFABGBAHF.CEDEGCADhABA.fACGhADA.ABIHbBEBOEEAIFFFNAAE.SGADhAEADBID..hAFA...,2,-24,-19,5
ESGOHDafMLAVcUQRebBdWTYJZNCIXPFKg,UFDHRADGBGEEdFBA....TGCHJCDFZAAHCCGA.....XGFHhACAFGGEKCCDEHAE.OAFAhAAAHAFDDBIH.aEHHhADAMBADAIAG.QDEGeBEB.bDAD.NIEF.hABA......hACA...,2,-26,-22,4
aIBXLZPFMWKSdYcNTEgUbOCHVJfAGeQRD,GDDCQAEGaBBFBHHEZDFGFFGC..KDBDdHDB....NAAC.TCAEhAAAEHBC.UAGEOBHHhABACEDDHABE..JAFFhACAAHHG.DGAA.XFGCMDDE.SHFGhADA.....hABA...,1,-18,-20,2
XIPMZbfANSacgJYODLCTBEQFWdKHVUGeR,SAFBaHBG..JBAEOAAACFDB.BAEDEEAF.QFCDhAHAdCFAKEHHHBDBGEFERFFB.hAAAXDCCMAEG.fBHAhAIAABGA.NDBG.......hBAA......hBBA...,1,-26,-30,4
DPEMASQGaZIOLVBNHgFdWcKfCRYUXJebT,QBCBaCAHZEFA.LCFCBCEHHDCBdAGFKDEDRABGUCGBeFAE.DEHDhAAAMHBCAFFFGGEF.hAAA.IAFCODACNABFhBAAFGGB...fAHA.CHEA.JHBChBBA......hBDA...,1,-8,-18,10
XWMaFPgDBEcHeCRLfITVNSZdUKYOAJGbQ,GECFQCGCMHCAFDBCDBCDBAGFHAEHRFBELHFE..fHGHhAAAVBCE.ZAGHhABAKABFAGCAJEAH.WBBDhACAaEEFEHBE.CAEBNAAESFGA.YADFhAEA....hAIA...,2,-19,-15,4
AZDKcXJHfdPEbUgIYeNWMaQRGLBOTSCFV,DGDEXGBCHAFAdDBB.ECEBUABE...IFGBeEHBNAAF.aAFEhAAAREFB.BFCA.SEEHhAEACHAEAFCEKBBE.fDBEhAFAPHCE.gCDH.MIDGhAGA......hAIA...,1,-21,-35,14
OCbIfEJePaWQKHALNUdVSTBZGgMFDcRXY,LDACdGFCSEDHZBECMBIFDAAE..RBEA.OEGF..IEAAhADAfABD.JGBGhAAAeBBD.aDHB.KHBEhAEANIABTEAFBDDF.FFFHYEHBCBBGEEDA..hAFA......hAGA...,1,-10,-34,24
OWEQNAZaVfTIdgcRPBMFHCDGUeYLSXKJb,aDAFTFDH..dCHCREAABHBEHGAGCECDGCDBeGEALAAEKFHH.hAAA.OAHFQCCFhAEAACCAfGFCIAGDhAFAPADAFEECDIDASBAC...hAIA......hBBA...,1,-13,-18,5
CgOEKWPBDYVLfHdMcGNITAFbXSRaeQUZJ,XGBCSEHBRDEH.QEDEZDGB.CFBE.OCBAKHBE.BDBChAAAVAABHEAG.MBAGhABAGGEFTAGEFAEDaAGBhAAAeGDG...........hACA......hADA...,1,-10,-25,15
PYJFKUbGaDIOEZdHQgVXCABfLSRTWceMN,BAFBSDCDRFBD..TBDAeBCCMDIF....PAAChAAAFAGAKEGFUFFGaHGADGDFhAAA.OBADdDFB.QDDBhABA.VFADADAG.....hADA.LEADWHEG.hACANIDD...,2,-31,-21,10
KZaQHNXRUYCWBMdAfSeEbVOGIJFPTLgcD,eCCHECFC.OEFGGAACFAHDLGEC.DICEaACEQGAGhAAAHFDBRAEHCGHHBBAEMADDfEFFhACASGAAbDABhAAAIFCA.PAEB.....hABA......hACA...,2,-18,-7,11
ObeRgScaMPWXIABYLEKZFVDCfdHQJNTGU,BAFBEDCDKGDFZDEE.DDDCdACDHFFF..JBGFGABAUEEC.OHAChAAARBAF...SCGChABAMAFC.XEAChADAAFCHFGHBCBHB.fEHA.TADG.hAAA......hABA...,1,-8,-40,32
TKUGIHWcgLXBDbVZEaNOQCfPMYRAdSJFe,dEEDSEEDeBBDKBFDGAACHECF.....gCFEhAAAXABFDGIBZFFFEADBaHAGOHEEhAAAfAHGMBIBAIEEFFBHhACAIAGD.cADBBAFANEDA.CDCCPFHDhAEA....hAFA...,2,-11,-9,2
aCAOfGMFKLQSbeZcINJBVTPHdgWXYREDU,GECFKHBGLDEGQBGFeAACZFAC..cCDFJFHB.BAHChAAA.TBADPAEEdFHGhABA.XFADECFCDFCEaDBBhAAAAIDCMDAB.SGGDNCBB...hAEA......hAHA...,1,-1,-25,24
VcXMYKUPFfdgaHBIGbOWZNSCeEAJTQRLD,JDCHQCCBLHDEDCFD....XBDCMGBCKGEB.FAFEdAGAhAAAHCABGEGEODHHhAAANBAA.SEEAhABACGBF.ACIBTACAcEEE.......hABA......hACA...,2,-33,-16,17
dPTNbeYfKAEJXIBDHVUFcgWCQROGZLSMa,EGDDJDACBHEADDCC..HDAAUCGAFEEC.......gACAhAAACAGERFCAGACHSCFAhABAMIAG.dGGB.hAAAPAFETGGAeFABKCFDAFFA...XFAFhABA....hACA...,1,-15,-37,22
dZMfOUKPEAacJXQDCYeBLWHbVRINTGSFg,JCCHQGCE.CCEABCAFLEED.HAAEREAC.TCGFFBBAZFEHhAAAMDAF.UGBDKHGEAAIFhABAaHGEDCGB.eBHD.hAAA............hACA.WFFCIAEFhACA.SGADdBEH,1,-17,-28,11
CTNMWOZafJRAEgHPSVYDeKLGdbFUcXBIQ,ECFCHAAD.SGFEDFCFeEHFGCDGdFBBFEEBUADEBHBD..CACGMIDEhAAAOBHH.aAHFJAEAADDC.hAAA....PDAAhABA.KFFFLHFA.cGAH.hADA......hAHA...,2,-28,-13,15
dHDLXCeJYZEGfASWPVNTQFMOIcbgUKRaB,SHBGVAAD.QAGEOAGF..IGFC..hAAAgEGBKEDDBBEEDIAChACACAAAeCABJGAAZEGFGEDChAAAADCH.WBCF.NDDH.MIEAbFFD.aADHdAEE.hAEA......hAFA...,1,0,-30,30
fCTQEXPgSZRJdbFKUeAYcWIGaLHNODBMV,......YFCAWGFAGAFA.LCDBOBCFMFIHhAAACHDAQAACECHHPEAFhABAZEBBdDAE.KFEAAAIFIEFHhACA.aGGHNAIADDHFVAEF...hACA......hADA...,1,-17,-21,4
GLEBSWdNIFRcaHXeVOTDJKYAfMCUPQgbZ,MBFHUGGGQEBBZAGBGEGGLEBABACBdEFHFGDCRBAEHGAE.XGEChAAAeAFHOCBEhAAADABE.JAHFAGCACAEC...hABA............hAEA......hAFA...,1,-9,-30,21
WgQUMYDXcBVIdLPHAJNaeGOKRZCTSFEfb,aDCDOHDAZAEA...TDAHFHGE..EAAB..bBGFQEFHhABA.UCAFDAFABABEhAAAIHAHLCDAhADAAFABJHDG.NCIEKFCF.SGFE.fEFDhAEAMCIFcGCB.hAIA...,1,-20,-33,13
YEWgdTKLSOZGXDHRbFBAaQeMfICUNcVJP,aGDDeAEH.MGEECGAA.UDFA..VCACJBBH.EDHB..dAHALBFChAAA.ZGFADEIFREEEBABAhABAQGBC.hADAIEAGNAEC.PHEEWFAE.KACE.ODDBhAAA....hABA...,1,-18,-27,9
dLJgZTUXNCOeKSEIFcGRBWYQHMDafVAPb,dHBHLEEGZAEFUEEEXEAB..CBBHKFHHEBBHFFCD..RDBBBAHAhAAAQGGH.MAGBhAAADHFC.aADHAAGB.PAHFhABA..JBDB........hABA.NIEBeCHHcGEB.hACAYFAF.,2,-36,-12,24
RSZaUFAeXMEDQPGJHOfWVcKgYdbIBNLTC,XAFHDCHHGDEEHFFDOEBB..VFBGKBCFdHGFBEAALADEhAAACABCZBDFFCBAMCIF.EBAFhABA...QFCDhACA..........hAHA......hAIA...,2,-35,-18,17
AeEXQFWOdHaYJZDICcGSRPTLfKBNgbVUM,EAADXFCAFDCA.dAFBHBFC..aBAAZFABCEEB.SHEG.hAAARFGDLADCBCEAbCADMGFAhABAABEDQFDDhABA.OCABYHFADDID.cBGE..hACA......hADA...,1,-2,-36,34
SLeQaDbZCgPWFUIVHKGRMXABcfNYOJdET,BFDG..NDHCOEAGdGGASGAC.QBFDDHBECBBE.hAAA.PFDEFBAGVDAAhAAAKBAFRAFDAFFG.....hABAfCDBEHECTADF......hACA......hADA...,1,-29,-43,14
ERcHagbGSTNCYZALDfKUFOVPdeMJWBXQI,LFCHDGHHUBBC.OEEEdBFC..eDGHMAIHBHBGQGGGhAAA.EAGDHEBB.aGEDhAAAbACESEDEhABACDAEZBAAACEFFHAG..PDAB...WAHB.hABA......hACA...,1,-15,-25,10
FXcDVKedNWUPECBgZLMGHQRbJOAYfTIaS,TCBCaAFB..SCAAFGCDDBAA.eEDGdFAHUFGA.CGEG.gABEhAAALBEEMADAhAAAGGCB.RBGD.ODFGhABAAHHDIEAG.XFGAcEECNIEF..hACA......hAHA...,2,-26,-14,12
dBWReHSFLcDbGJaAfPINTYMXgKOZCVEUQ,..IFDGTABDMBGDKAAD.ZFFD.CHDC.VAFG..QDCGhAAAdDCHRFADeDHFSAFFhABALHDADBDDJFHBAHBGfCAAhABA.NCFA.YDAH.OAHBhADA.BFDA.hACA...,2,-24,-11,13
PVKdgONaZUFCDMfRAXQTBLIGHeYJEcbSW,TCCBBAFBGDGG.eBHBJAAF..EGECSCFF.VFBAhAAAKFDDOBEGZDBGFABHCCADhACADGHH.fHADhABAAHAB.QEAG.HCGHcGEEhADA......hAEA...,1,-19,-23,4
FSZAXdCDHMcWEYLJeTfNKOBUPgQGVbRIa,XGAFdFGEDGDAHAAB.MBIFEDFGLDHB.JAABfADEhAAAOHCABCDEUGAGQAEEhAAAbDECRAFF.aEEFhACA.FDBHAIHACHDC.cCBD.....hADA......hAEA...,2,-20,-10,10
aZgfWUIRNHTKJeYGPDBSLCcbEAVFXdMOQ,XCCBOECCZBFG......fCAAIHFDRGAGNFCHHGAEhAAAKAFE..eCAD.hABAGAAFPHFGDDCCSAFDhACACHDHEEGEAHID.dAGBaFEEWFEA...hAAA......hABA...,1,-14,-21,7
WbSJZDUGNaReEPdOTVIHXAfMLQBYFcgCK,LCHDBHHGFBFH.CEEAKFCF..SFGCDCCCGCAARDAB..eDFAhAAAdGHAOAFF..hAAAIABFAFAFQGFGhABAgAGDJACE.NDEEEBCF.....hACA......hAHA...,1,-27,-32,5
CYBPMacEOVXUHTfAINDKeZSJGRLFbWgQd,DACBKDBDeGEAZACBGGAHRAAC.FBGH....bFCF...QCDDhAAACFAEBAACMDFHaAGFECHHhABA.....hAFA............hAGA......hAHA...,2,-54,-26,28
VOfDCTJdQHScAKUeXMZgLaNWbEPGYFRBI,KGDDUDCHMEACLGFC..aCAG..NDAE.EHEAGBDFREGF.BHDChAAAOCFEDIEACBBDJAFEHDFEhABAAFCEZABA....hAAAbFADFEED.IFACfACF...hACA......hADA...,2,-25,-16,9
MgPKbUGFWBVROSdcCQEAJfXLYaIDeHTNZ,JDACXDACLGDG..aHACeBFHHEDAZFGBMIFAKBAG.UBFCFBHBBFFChAAAOCCA..dFCBhABACGGFAIDA...IABAhAAANIAF.PFAC..WAFCSFHBhADA....hAEA...,2,-29,-18,11
POeTVNcSEbWJgDZAFLKYURGBXHQafdCMI,FEEDKDCDRADABDGDHFFA..aBEDdDAE.CEEF.MDDD..OAHD.hAAAeABCTDAD.NBAH.hABASBAG.hACAEHBAWFHHDEGCAAHHLHCC...YAHHhADA.XGABhAEAfHDH,2,-42,-26,16
gGePAYQWJfKESUVdHOBbIMCaDFLXRcNTZ,QCBCJGEA.EGBDUBBAHDGDBAGAMCFFDDFDLEDH.hAAARACATAGFZFCBeCEEAHHA.hAAA.fGFEhABASDAGODAHCGAGFEHF......cFAAhABA...NACF..hACA...,1,0,-40,40
VELKCHGdbRFUITWBDZYcAXfMSPOageQJN,MFFFOCCH..aCCHQBFG.VEGDEGBALBDChAAA.CABDdGGAFFAHTAADhAAADFADZCAFAGEBfADFhACA.SDDHeDDENAIG.KDAB.bFCA.hACA......hADA...,2,-26,-10,16
DRgMIaPCQYUKABZcFHSVObNfedTXWLJEG,ZDBHFCFCHFFBOBGD....NEAG..dABCTACBLEDBEGADRDEF.hAAAMAAFaEBDCHBH.QADBhAEAUGGEAEDDBAFASDGAhAGA.........hABA......hACA...,2,-31,-15,16
LfYEDOHBVAGJgPacIUdQZbWCNRFTXSKMe,JFEFaHBG..UDACdCCHZBED..CFDB.RDAG.FHGA..SCGBhAAAKAADLBGB..fGAGhABADIEEBAEBACBEGDFEhACA...cFAAIFHE.QCEFhABANCIAXABA..hAEA...,1,-30,-43,13
BMZPFKLbEVCNegYIfDWUASadOQXJGTHRc,dDABODCHJDED.GEFGHAFBBHEFMBAEFBECLABC..EAHFCECH.hAAAeEAH..IHGAhAFADDIHAHHD...aFBHhAHAXDEFRDGF..cBCFKAFE...hAAA.NEEEfCAAhABA..,2,-33,-14,19
LNGbgOXQUdHATWFMVJcEDKeZSCIaRBfYP,FGFCJAAB.ECFBDDGB..eAFCZDGD...SFABCCEF.aDBCBBDFhAAA...PDAChACANBAD..GDDEhAAAOFEDXDGD.dGCAAEIFTGAHMBIF.hABAKHCAICCARAFE.hADA...,1,-7,-44,37
CSRfJYdIKGQDFWZHUgMaBbLOEceNVTXPA,SGFHRFDF..fCEAJBEE.dAGEGCBCDBECZDAGHEDEhAAAUFFEMABBBACG.hACAOAAHeCHBNEHCTFAEhABAADDCIADA.FFAB...aGDCbDFA.hAFA......hAGA...,1,-13,-21,8
DHYWfdXVZJMaOPbLKRIEBNUcQFSCGTgAe,DAADHAAD...fHADdCDDVGFCZEAFJGEA....OEDBhAAALFFCKCFCEADFUCGDFDAHhACACEEFGECEADIHeEHD..hABA.XADBaAGA.......hADA......hAFA...,2,-23,-16,7
MQCSJdEPIgaebNTBcAORUZVHFDWLKfXYG,RAEGZABHHDGFFFBHDGEGKHCE....XAAFMAIH.QDDDhADASGAD.dFHEPDBFhAEAaECA..eHDE.TAEAhAAAcGEE.AIHGOCCGVCFF.fHABhAGACBDDEDAF....hAHA...,2,-15,-12,3
gNGBOKaeJDcSbXQELUMVCfTRPAIFZdHYW,FCFCdDAFHFAB....gEAGBBBHKGFHaFDBDFIF..SAHFhAAAQAFFEBDCLABChAAAMEEA.CDDFRCGFICBChABA..WEHH.....hACA.OFGHcFEBbGAEhADA...,2,-39,-20,19
QVWKgcaFCbRXNOSIJDHdEGfUATLYPMeBZ,TDACLGEA.MDAFBDDBZGAEQGEG.KAFAgCDChAAAFABECFAG.RABCNBGGIHCEhAAADFIH.dDGGECAEfFCFhABAAFBD........hAEA......hAFA...,2,-33,-23,10
ELQbCUReVAIgBOaMPTHZYDXWfNFcSJKdG,BFDGMEGFHEAFZCFHDGGG..XABA..NBDF.SAHDhAAAKAAEGDAEEDHF.QGDEhABACHDA.eECEhACAAECEIHHHaDDAPFHD.TAEAfDHEhADA.FCCA.dHAD.hAEA...,2,-36,-2,34
SJDRKIBVEUPbagZHATeWMfCYGXFLcdONQ,TDACMDEB..CHACGCBAFCCGdBHG..QGDADHFARAACBAGEEADGUDFEhAAA..aGGCZBFAACFFeEFAhAAA..fEAEhABALFAAOBAGNEIE.JHAA.KEDC.hADA......hAEA...,1,1,-30,31
YcXWgGUTQdNEJMCSLZfFRObIDAVeKBHaP,VDEDBDGFaGHD......PDBAXCCFGACBQAFAhAAAdFABJHDE.SFFAhABAfGCFFEDDOBABhAAADICEAEHEeDBDKGABcGGEWHBC.....hACA......hADA...,1,-13,-32,19
MSeRQCOJDbGfFYaTLVAHPNgBWEXcKIZUd,HAAD..PFFGNAEDBFBGEAHD..KHEEZGCAdCECSDEGhAAA.eADFRCFACDCFDFGAfCEBhABA.FBBB.hAAAaDAC.LFABACAFgGGB.cGCBhACA...MBEEhADA...,2,-41,-6,35
SANJDYdWgaPEFOXCeUQILfBHZRGMcVKTb,JFCHDGHHdADE..aFFEEDED..FBEACFCH..UBGALDAH.HDCChAAAGBAAMCBAKEGASHEEhABAACFD.NAHG.hACAgGEE.......hADA......hAEA...,1,-30,-43,13
bCERSNDMeAGOKTLFIPfHJBZQUWYVgdXca,OCDGKGDDLFBHFFGE.....fGEBJEAFBHCBUBADhAAAVCCD.dHEH..aEABEDGChABASBAF.hACAMEIDAAIFIHHEHBGF.ZDEBYBDChAAA.gEFEhABA...,2,-33,-24,9
RQbWgUACPIdJTONSDaFBLfHMEVXecYKZG,CFDGdHBH.OFABDBFGBBBCLBBGHFAB.EDBAeDAC..KHGEZDCEQFDAhAAA..hABAgFFFAFCEJBFC.hACANADFFCGCfDEB.MADE...hAAA......hABA...,2,-38,-17,21
ePcTZHLAFENIKRaWXCOfDdJVSGYQMbBgU,FAFBEHBGKECERDCB....aBACCCCFDBED..JHFGGBFA.MEHHhAAABHDB.eCFC.TEGEhAAAZDAHLACEhABA.IAHEOHACdADEVFEF....hAGA......hBAA...,2,-33,-24,9
UDPGZXMVadgSFNcKBYAEJfILWQTRHCObe,JCCHLGEA.TECCHFDF...CHCE.bCFADEIFGADHZCEGMBCFhAAAdHGBSAAChADA..cADAKFGGAAHGIGAEhAEA..WFAH....hABA.OCAB..hACA...,1,-17,-37,20
XfJIbUcAMWYLCdFSTNQHGZVDEOagKRPBe,MCCALGEAdEFHFHCESABD.QDFDHDACZAFHEFDGOACFhAAA.KFAEBDDB.hACAfAAGIAGGcFCBhAEAAAHGCADG.NIEHDCEFaHGA.....PBHDhAFAXFBG..hABA...,2,-30,-10,20
AZUXHdVLSPbQNfODKcEJWRMFeTCBagGIY,UDCBdDAFLFFD.SCFEQFDFOAFCKFBFJAEHMIAEhAAAFDHD...CGGABBABhABAaABD.GACEAIHAZAGB.XFAFhACA.PEDDNAAEDGGG...WCHHhAEA......hAFA...,2,-36,-19,17
CYLDKaRdQFGOHeUIZbMScXVNEBAJgWfPT,JGEA..fGFCCBAB.DAIDRACCFEFEHDDG.eHAEZDAD.SCAAhAAA.cACChABANDDDAECC...PAGHhADATGCDLDHF.KEBFaHAC.QAFChAAA...hAEA...,2,-41,-14,27
baeXJYWNIPBQMZFEAGSDTOLKfCUcgdRHV,SACADECDODDGLABAKEDA.UEFGdGAHRCAC.HCFF.aGHDhAAAXGCE.JCAGhAAANICHBGGHZAFA.AECF.fGAEhACACBAB..cAFA...hADA......hAGA...,1,-25,-33,8
bFSBfZCVHTDaUJMOQeWdNgIcARYKGLPXE,RDAGGEAHLFDFEGGAFBDHBFFFZGBE..CBBBHFAFDDAAUAGD..OEGDhAAAeDEAdAAC..hACAgBCHAAEBKFFE.hADAXAFF.fGEE..hABA......hACA...,2,-32,-21,11
ePVNfKJYSgEaFLHMUCBOQcRAdTXIDWGbZ,dEHATCGCDGCGGCDH.ZACGVAAD.KFCHJDAH..SBEChAAAEFFHLABDMGECBECBhAAAODCE.cFABhACAAIAGIHHEeHFE...PHBA.fAGChADAaHAE..hAEA...,2,-30,-12,18
FOUEDBYdWQPNbVJcSRIKATfLCaXgGZHeM,TDACLAFB.XBCGZFFEMBAG..OFEHEDFHBHEDdAAEQGFGhACA.bFBFhADAVGAA.SAGGhAAAIHADKDDACEDCGBCBFDHBDBDE....hAEA......hAHA...,2,-17,-14,3
eLaXgQRKDGPEbNJcYCBfWIZSUTdMFOAHV,HDBGLFFCXAGFQGBGKBFFGEFCEBFH.JAAFCCDCBAAC.hABA.IGBESGGGhACAdHDFMAEFAAHDaDEEDBCEhADANCIC.fEAB.WHEG...hACA......hADA...,1,-15,-22,7
PfdVQgEbBXRUCZFJcWAeYaGIDTLKMHSON,aDCDGDCC.DAHDLBBDHBADOHFA..PFFCdAEHQEEChAAAbAFF.RFAHCCEHFHCAhAAA.JADFAFAB.eAHFIEHGhABAMCADSFBG..NICF.fEEFhABA..hACA...,2,-22,-9,13
SdBYZXGWPMVcJKTLFQACaINUbOfeHREgD,aEGDUCBC.ODGDeCBBEBEG..SAAEBHBFZDEBGACEhAAAMAGFJFCHLHDG.hADAAAGAIFADfEEEhAEA.HGECDAIF.........hABA......hACA...,1,-21,-27,6
AFfTUYNJMRHcWGdPaeKBSXIDbVOLCgQEZ,TGBCUCBC..JGDGMDADHEFCGFDH.dDBBeAHHKCEGBBAAhAAAIAGGDIGE..OAHHhABACACGEFBF.AECB..fEFBhACANEAE..cBDEaEHF....hAAA.SEEChABA...,1,-16,-36,20
YXNTQHEdSPBCfILZMGJbKDAcgOaRWeFUV,OGEAaCFC.RDCB.eFEEFHAG.UGCE..XAFATAAEEADCdCCFBFHEhAAA..CCCGLHFEhAAAMACE.bDACDBBGhABAABHD.gCFE..WFBFNICF.SAGFhACAfEEB.hADA...,2,-25,-24,1
LRPYXBAdMCZgTcDKEIVGNeaUSQFHOfbJW,CBGETFDHKDEE...ECCFGCAE.eAAESEABHFGFOECDhADAbABALHFE.hAEAPAFGXGEHBDEEhAAAAICAdEEDMFCH.cDFEDAGAICCF.hABAaEHF.....hACA...,1,-13,-20,7
FEDcWVMNOHSZIKABeLGdRTUCbJYfQgPaX,BECDGGCBREEDUAAFCBBA..JAHF..QDGEaGAH.FGDHDBGFhAAA...VADFMBEDhABAHEEASAGEhADAKDABAIHE.LFAF.dDBB.....hABA......hACA...,1,-25,-33,8
DSGWQKcBfTYEgPXCFVURLdNIbHAeOMZaJ,MBEAZDEDDBDGGBACKGGH.BCCE..TBAGEEHB..XGFEhAAACAFE.FGAEUCGERCEF.hABALEDDNIBB.HEABhAAAAAIFeEDBaHACSDCF...hACA......hADA...,1,-17,-27,10
bVAcdDgCSGXPKTfWUaNHMeFEZLJQRYIOB,dHFHDAEDCBFAGDCD.KBGD..TDFFUACGHBABeCBDZGAALFCAhAAAQEDCRGAEOEHDhABABACBAIDG.SGHFhAAA..fAGBNAIA.MAFFEFAE.hABA......hAFA...,1,-2,-31,29
UIDBJLVedaMQfHGANFOYbWKgcZTXSCRPE,OCCH..WFFCKCGDZBED..SCFBCAACRFFG.UEAChAAADIAEBAGELBBGeACChACAaEEB.MAHD.QGGChABAfDHAADDFNIAH....YEBFhAIA....hBBA...,2,-47,-23,24
MRDCBOfUWFLJeTgEaAdGQbSZHPVcXKIYN,GBDBSGFCZDGBHAAC..VCFCKGBHIEADMCBCRFBHCDDBBAEGhAAAOFED...fEDAhAAAFDABeHFAEAHBhABAABID...bEFA........hACA......hADA...,2,-23,-17,6
IJBcKFSgHPdeAVDNWQfMbZXLOGCaREUYT,DHCEQCBCMFECZAEGOBGD.GGABaCFG.RFFBUADF..hAAATAACBFDHKEADSCCBhAAA.PCABhACAAFID...NIBD.fECFbDFA.CABC.hAEAIGGF.cEAEhADA.,2,-40,-20,20
DZEUSfGgHYTeVJLcINWdMPXOaQKBACRbF,RDBHFHFGEBBFUEBB.GBDHHEEDeAEE.LAAE.IHCFhAHAdABGMHAA.PEHFhAAAaEGFBHHEAHEH.DGGHSACAhADAfFDEgDDB..hAFA......hAGA...,1,-11,-34,23
ZdWHVKYEaCeOFIJTXfMSGLgPBcNRbAQUD,UGCEZEEEHFCBKCHF.aAGB..eAAEFAAD..JFHBTDAE.MADEhAHASBDC.GDAGhAAAPFFABCEFRCCBAHBAdCFEhAIA...........hACA......hADA...,1,-23,-29,6
aPKGOVCXAeQULRNDYfBcMSEIWdJgHFZTb,eDCHQDCHRFFA.DDFABBCD.MBGBEADCdFGGHCADFHBGZAGFaCACKCEFhAAA......hABA.OFEHCHEHUAGGYEAFhACA.........hAAA.fABEhACA.SFBG.,1,-17,-31,14
JaFcHMfCNbVWeYQOZILREXdSBGgPTADKU,UCBFJEGH.FFHFMCAD..CCFH...VCDFeCED..OAGFhAAALFAAEEBG.dHCHSBCFhABABAACGADFTGDEhACADGFHKGGDHFAD.NAIE.......hADA......hAEA...,2,-34,-19,15
XADbdRBeKaZVJfMTYgLSCHGWNcUPFEIQO,DGHHdCFCRBGHKDBGZAAF....JEFHMDDF....TGCHLAFChACACAHD..GAFChAAANAEAUFGDEBCG..IGBFhADAQFAGAFFHBHHDaBAB......hBAA......hBCA...,2,-34,-30,4
PgLbXSRFKaOVJYHfINBGUWZdCcEeTDMQA,LGEASGFCFFBDKDBDOCAD..VECDJACG.HAFF.IEHAhAAABFDCGAFEhAAAZCCCCACD.ECDHDIGEAFFE.PHAChABA...XADFaCCBNIEBdDHE...hAHA......hAIA...,2,-21,-19,2
HANDUZXYIfKeMRWLTQOPdaFSECJbVGgcB,DAFBZCDB..XBGE..YHDEKBCBRFFALGAAODCAdEFDhAAAaABB.EGBF..CEABJAFEhAAAbCAD....VAGHhABA.....cACEBEGCAHHBNGDFIHHChACAeDAE....hADA...,2,-26,-23,3
bdUCTDYSWZcKMAeBLgHQOJVIfRPXNEFGa,eEGHBAFBHFFBQEBBVEBD.RAED..XAGEFBABGCCF.dEFFhAAACBBGDIEGSBHBhABAZDDFMDAF.AHDD..OABGhAAAIHDD.fBEB...hAGA.EHAA.aDGG..hAHA...,1,-13,-16,3
FRNHETSUXCOdQIJgAGPMDLeWaVcYBbfKZ,MEAEDIBGeGEG..aHDG..VBBCBAFDKAGCFEFGHCEFEGGFUBADhAAAOGBC..QBGHhABAIAEG.AFCCGBDAhACAPDAH...cGAGbDGB..fAAFhAAANEIE....hADA...,1,-12,-24,12
EVMSgICLQdBbeNUacWJHRZTPXDFAOfGKY,GECFKAFBEBCC.SGHB.CGEAdCCHeEHBUCGBaECB..JDFDRAEAZAAChABA..XFDDhAAADADCAIFA...fHGDhABAMHAAICACBCHBbCBGNIAF...WACChAHA.....hACA...,1,-19,-24,5
MBHQXTLebVZARdacSgCJYfUEIGKNOWFDP,RFEEdAFB.aAAASCCD.CABC.fDBHEFAC.KGBDOAHBhAAAFGHHDFDBBEFBHBDDTADDhADAbBFD.AIAC.JHDEIGCDhAFA.NICB.MDAFLFHBZEFE.YAFBhAIA...hADA...,2,-14,-14,0
MLQEKWUIZPfHDCFRBAgJOceTdXSGbVYNa,JEEGOEEG..eBAAXGCAGEBG..VACGaBEA..MAFGhAAAEBHDKGFD..UGGChABAIGABPCDCDFACFHDGhACABBACADAG...cGGASBHH.hAAA.NDDFQCAEhABAfEAA..,2,-25,-17,8
ADHUTZbgdYOBaQPXLECVNfRGSJFIKWcMe,DEFAUDCBZCCFdEGCBCED..aGCDQGCFLAHH..CAEC.VBFChAAARAFD.GBAEFAAFKDAFMABEhAFAHFEB..TFGFhAGA...........hACA......hADA...,1,-21,-29,8
OXTGVFJRPKCHZMbeEBNQcIYLfdWDASUag,UFCEOCCHGCBBFGFA.REAB.CDFE.ZADC..MAEHEBAFBABB..hAAAQGCE.hAEAIACGfGGEhAFADAHDAHFBSEEHaFAB.XAGF.hAAA.JBAFKHEAeBHHNBIE.hBAALEFG.,1,-10,-21,11
KOIGFLQVAYTfJDWXdBCaSZgbHeMEURcPN,TCBCJFCH..DGIBdEDDBAGDCCGD.ZBBAHABC.EHEAUGEB..hAAAPFABODFAIHHFhAAALDAB.AAEF.fEGHhABA.WFBBSFFCeAEHMGEEhACA.....hABA...,1,-2,-52,50
UVJbOFHLAeYcIGWBPSdNfgCMXTKaRQEDZ,eGEA..IFDGGCDEBHHESCCHdFAB..fDAHhAAAMAIBXBEGKHAGRBGBDIEAhABAZBABJHDEOACAHFBBhAAAAFFH.WFFG.NADHCBGBaAHF.EBBE....hAGA......hBAA...,2,-14,-13,1
VecIOMQZBTPaDRHbgWSUdKJECXLAYFNfG,FHBGGAFEeFFFOEFBZDEGBFBG..aADFDADGRAAFHFAC...hAAAgDCESBAAhABAKGGECBECAAHF..NBIEfHDBhAAAIHHETDBH.....hACA......hAFA...,2,-42,-13,29
CLRbSNTVKQMAOdJWXaIBDFgPZeHcEGfUY,dGDBJDAC.aEHBBBAA..FAFDZBFEHBBHGFADUDEDLEEGREAB.hAAA.SACEhABATGECKHGAABIHOHCE.hAAAXGGEIAFG.DGGG.eDFC.EABEhADA.CHAA.....hAEA...,1,-14,-21,7
dcLNgaYICJTVPASWUEHbDFGKOXBZReMQf,UGBCECFCDICEFDAH.GDEAKBAHBAEA.ZFECeEHF..MEAGdCCBLAAEhAEA.aAGDhAFACAHBJGAG....hAAA............hABA.PDHDSHEAhAGAWCCC..,1,-26,-57,31
GHQUPZCdTfBeMbVRNaIEFAOJDYXKLWcgS,JBFDDAFBKBBALBHF......gDEGGECCHABDhAAAQDAEUGGHCAEDdGAEhABABHHEMCEFRFDG..ICHEhAAAAAFA.XGBGSFFC..hADA......hAHA...,1,-21,-40,19
HdUQFbRcTNYAaIGVKPLEgSeCZOJfBWXDM,GEAHVDAG.KHBCECHFeAEF.ZFGBOAAHBGEF.DGFCdBGA.UABDhAAAQGCF.bEFAhABARDEE..NAIE.AGAAIHHEhACA...gAFBCGAC.fDDDhADAXCAG.MBBAhAEA..,2,-24,-10,14
CecPZULRGKAHbJdSDMEXVWIQBFYaTgfNO,HFDFdDCDMBEAXAFE..IGHCQCEGBHCHaFGGTFDAhAAAfDBG..hAAACCCBeBAFcABCZFFHRFAEAADGhACASGAFEHGA.VCGDYBHB.hABA......hACA...,1,11,-24,35
XgVQHKEWfOBMabINTeZDJSdGALcYRUPFC,LGEARAADFDEB.CACG...XAEAQFAFHGEGKAEEEBHHODFFhAAAMACA...IAHAhABATFCDeHBGDIEESCCChADAAHIB.YCHHgDBFfEEEhBAA.BDDFhBBAaFGA...,2,-36,-7,29
DLORKAdCXbgBYFUEGHJcPfSTMIeNaQWVZ,dFFBXGGGBFAEUFCHHBBB....PFEDSAAF.MCIFhACAIFAB.NBEAaHBChAAAQADF.hABAVBBFLCHD.OAEAAGIHCAGC..YDEEhAEAFFCF...hACA...,2,-31,-15,16
LUNeFHdfJQWEBMCbYZRKXPgVISaGOTcAD,DECDLDACeEFEFBBEdEFGJGAG..EEDDMCCC..CHABZGFAKCFG..hAAA.XBGF.hAAA.gAGEhABAIEADaCACOEHBAFFGNABF.fACDBGCA.YHCGhAEA...hAGA...,2,-32,-30,2
JBgFWEfIRMKDCbadLUHTcZPQeAYONGSVX,OGEASGAH..XGDGBBFHFDBHEAHHRCGBDCCE..aCAALFFBhAAAUCEGHEAE.hABAZADEPEDBAHAE.NBBB.hACAJCHB....WAHBMIFG..CGEA.dAAFhADA......hAEA...,1,-10,-29,19
GefKSBVWOZFYELgNbdHJaMTCIQAUXRDcP,XCCBDHCEGBBGKGEEBBAH..OAHBFFADEADBLAAC.hAAA.NCIE.HEBE.MFABhAEACFFCAEFEUAFFcDGDeCGBhABASGCH.WAEHgGGEhACAdBBC......hAEA...,1,-7,-30,23
LeINVAWBODHbdCFSZGMKgXEUTPfQRcJYa,BAFBDAADHDAGCDFHZBAAGFED.KHDEEADB.UFGATFAA.QADChABAJEAF.LEFEhACAeEDF.IBBDhAFAAFFB.OAFDdCHGMIDAPAHBfCEFhAAA.....hAIA...,2,-36,-6,30
JGQfETYcgeSHbNODIRCdMFBPZULKXVWaA,JDACQAGH.EEDHTBFA..gADDSGECHGAAhAAAOAHFDGEHCFGCdAAFBBBFhABAZEFAUFACLDDEhACAXDDBaFAGADIHfGHAeBCCNIEF.MFFFhAFA......hAGA...,2,-14,-10,4
LBZGgQYUFXdHTDeRNPbECMcJOKWIVASaf,SAFBLCCHZFECQCBFFAEFdHBBDIEGeBFD.RECA....hAAAPHECCEHC.MAIFhAAAJDAHKABGVEGFADGEBCEDhABAgACE..UAGFHEAB.NBAEEHCA.hADA......hAHA...,1,19,-35,54
GNcJDHBVAZEYMQdRgWUXOTPKbICeaLfSF,ZDAGEGFH.MCDERCBH.UEGGOEDA..KHBECCACLGAAFABH.GAEDhAAAJHDEBFBFAABC..hAAA.dADDgBDGhADA.TEGEIEEDfFABSCAGhACADIAA...YAHFhAEA.,2,-44,-9,35
JZcaeXFOQfDBgCSLNWAYdHUbMKIPTGREV,dCFCUFDHMCDBKCHD.....IEHATCECECBFZAEC..eCBHhAAAFEHDQGAEhAAABBADSFFDLADGADHCHGAAhABA...........hABA......hACA...,1,-25,-33,8
LFZRJHPGQOBXETfdbVKgCDWSUeYMcANaI,aHBGFDCDZEEGHCCCGBCBOCADBHCG..TGED..dHGDKAGEhAAACBGEDADESACGhABAeBACMBIDAFEBNBGE..IHHAhADA..........hAEA......hAFA...,1,-23,-40,17
CNHDZefXRUaKgMPEWFTJQASLOYcGbVdBI,LFFBOGEAGACGdCDHBACGCGCD.DGBEeDFC.RBAB.aAEG.MDABhAAAEEDF...FCHHTAFGhAAAAFBC.SFADhABA..cGCDIHEENABE..fAHEhADA.KFHB.hACA...,2,-32,-25,7
bWAYUdILERJceXaCKVZQMOTDHGfFNBgSP,dGFCEDCDRAABeBAB.CECC.KHBEZBGH..QEECMFEE.DEABHFAHhAAAFHECBBFDSAEFhABA..PCGFAHGCIGDGhACALADDXBBBaEBHTGGG.fAHEhAAA..hACA...,1,-18,-25,7
fVLADRaJdBHWFSecbZIQXGgPUKTYCOMEN,REEEaEEDdCBEHFCBFAGB.eCFCZGEG...QBACGABF.UGAAKFCHCBHAhAAAODBE.NAED..hABAVGFEDFIHBFAG.hAAASDECcACF.......hABA......hBCA...,2,-37,-3,34
IWcFadPGNAbZBfgKUHTEJXReDYLVMQCSO,BFDDKHBGUCGHECCBRFGH..DCCFLFEH.MACCSFCAhAAA.OFGDIHABhAAAFAEFdGFCGAEF.AHDHfDBGhABAHDABXABAeCHDQDDDhABACBCB.aAHB...hAHA...,2,-22,-17,5
ZafIGFUWgYTeLANDCHJSKMEVObdcPQXRB,DAEDCEFAHFDHKBBA...MAAAEFDF...OAEGdBACQGABhAAABBCD.aCEEIHGHhAIA.FHBCUGFD.WBFEhABAYDBH.TBFHAGIBSDDGhACA.cDFDPDHFXDBDhADA,1,-24,-40,16
NGXWUIRZJcfDSgaHTEdPOKLQCeMVFYbBA,XAGHUCBCRCGFZABA..JGAGDBFE..aBCGHFED.dHGBKHGELFCFhAAAeFDEFDCCBCADAAEA.hAAA.....WDHDhABAIFAC..fBECSDDEhACAECAF.....hADA...,2,-31,-30,1
ASTWEZDCYRbOILVFfgcJGKQMPadUeHXNB,TGBCECFCDICE..READ.OACBLEEC.FAEHfEEF.hAAAJFHDKFGD.MACHaAHBeCEGhAAA.HDAANBIAAIHG.hABA.SGADCAFGIGFD....cDCGhADA....hAFA...,1,-12,-36,24
ZBKeMRICLDfQcOUdJGHgTYAEPWFabXSNV,EHBGFHBG..aDGDSFFDZABG.BFAEMCCGCEDDDDGB..QAGAhAAAUBDG.GGEBhABAHBAFgGGBhAAAAEEH.PAHBWDDCNGAF.KDAA....hACA......hADA...,1,-23,-26,3
NaecfIMbYCRFZLWJADVOHdBEUXTPgKQGS,DGADVDBGdFFA.UFCB..TFGCKCCE.QBFBGAFG.SBAFhAAAaAAC.fFABhABAMIBGCCACFDHDLHDGhACA.AGFBBFECPDACNAIAIHAAhADA.....hABA...,2,-40,-4,36
VMAdWTNEgRZDfLKJGHcaYFObQCIeSXUBP,TGBCEHBGZBBBLBFA.KAACJDAGGEBBHAFHaEGH..OEHBhADACDECSBAGhAAABBDAMIEAAADFdFEG.WEAAhABANEACDFGB....YHEG...hAEA......hAFA...,1,-19,-23,4
QfVXPUTMdJZHaRgeEBLSGYCObAINcDFWK,..IFDGDGEGKDCGQAEG..fGAH.hAAAXAFHPHBGMCBDhABAZADBaFHFeBGHEABESHEGhAAACABAAAGE.cFFAFGHD.VDAE.hADA......hAIA...,1,-13,-39,26
QFLTAHDMPcWIOKadCUXYgZeGSfENbRBJV,DCCDMCCA....PFDBIFHB.KDFGdAFBUEAH..gEAGhAAAZFDAeCAGSHBAhAAAEGFDRBDHBEFCJBAFhABA.FCHDAEDA..WADACHHE......hABA.YAHH.hACANIEB...,2,-30,-25,5
ZKSJFfBRgLIPeVCEGOQTbNWYUcdHaDMAX,KDAFSEEDFHACBBDDRDFALCCH.eFAFVFCCGACF.hAAATCAG..NEDHUBGGhABAdGGDDGDFAGIH...hACA.XGGDJCEEfAAF..IBBGhADACFHC.EGFH.hAAA...,2,-39,-12,27
NVJfPDUEKGaOeQHBMLXTbFcRdISCAZYWg,ZAAD..gCBCJCEHDIGA.KHGEGEBAaHBC...OAFEhAAAHAAAMEFDLEHFXCEAhAAATGEBFECGdFACCEGHAAFGhACA.NAIE....fEAG.EHDEhADABDCB.cACEhADA...,2,-31,-3,28
HIMTYZbgVXABfcSaeQKFRdNLCUJOPDEGW,BFDGSHBGeDCFFAGGREBHLGDE.CEHA.OEFH.DACGEAABhABAGBABHBFEIHEFhACAMIFEZBFE...VACChAFAAHEDaADEKDEBdDHE........hAAA......hABA...,2,-27,-10,17
eaFbKcBSTLRUWXVOdHfECQPDGNMYAIJgZ,JGEAZFDFeFAD.FCBGKAFEBDEBLEFA.UBAHVFFEHEBH.hAAACDGD.DCGG.GACFhABAMBDDADHG..IDHEhACAaHBC...SDAGWBEA..dEAChAAAEFCB.....hABA...,2,-32,-19,13
YWNCPdXAgUEceHGTVaMSRObDfBKLFQJIZ,EGFCeFBBGDCH..VEGHSAGCOAGDDBEHKGCDLAABhACA..FGDFIBHFhADAZAACYDDGCEHCdEAC.hAEAACCH....cCACaBFHMFIF..fAFAhABABCCC.WFFDhACANIDF..,1,-17,-24,7
OQgfcaYGXEZPSMNCTbDBFeHAKIVRJWLdU,KCFCVGFGRDBGLHAG..UDGGOGECQDCA..hAAAfADAaGAGGADHhABAEGBASEEBhACACBBF.DGEFFEGHACCEIHCBdAFB...cDABhADA....hAEA...,2,-29,-25,4
RcgXWIJYBVbNMLOFEfCZKSdeHUGAQTPDa,QCGCTAFB.aGGHRDBF....gABEXDCBJACGVFEDhAAAMCCG..ODFAhADAfAAFCHHGZFCBdAHAhAEAUGBA.AHAHDGFHWBEDIEEH.BHHBhAAA......hAGA...,2,-26,-6,20
ZfGaRBFVUPQWKNgIecCLSHMdEbDTAYXJO,XDACZFBGaCAE.BCDDUCED..QGBBKGGH..IHDGhAAAcAAG.LAFChABASAGBdEAHDFFGYFFBhAAAJABE.OBFFfCHEFECEPEHBhADA.NAIA.....hAEA...,1,-21,-27,6
NgLZeRIGKFEfMXUVODdQbYSPBJCHWAcTa,aGFCLGEAZDAF.eCFFGAAFECAE..MIDGVEFA..DEBGQDCFhAAASAHBPAFGhABACDHHHAEA.AFGDTGADhAAA...........hADA......hAEA.gGCCIABC,2,-14,-14,0
LXbgPZRaGSdIDKEfMFeYONBcHTUJACWQV,QGGGLBDGXFEC..PACGaGACGDGASECHhAAADIDEKCBAMEFE.FHAAhABAOAAHBBBEHBFGhAGATEAFACDBCGDH..WEDC......hABA......hACA...,1,-18,-29,11
HLPbRJcWFdTKDSIGEYBOQXVCZUfgaNAMe,eGACHFDFLCEERBAE.JBCBFGEBKDGFDIBC.GBFABGBBOAEAhAAAQDAG.CDDH.fGHChABAaHGE.AEEEMBIHhACAPDHD..WCBDdAEGIGGEhAAA.EAGE....hABA...,1,-16,-24,8
HTYbNACaBfEMPOWZFVIXcDLJUReKQdSGg,aBEEEEGD..MHEAOEBCFHAC....XAGBDAAFUEGC.KAECQDDBhAAASHDAGBCFhABAHBAB.TEABhACANDDFCHBA.PCHF........hADA......hAEA...,2,-34,-14,20
bFVdBAgOfYPLIJSCDTRcNXWGHMKUaZQeE,OGEA..YFFBLCBC.JBGDCAAEDACFRDBB...XBDGhADAGGBFMFIB.hAEAaACEeCFCFEECBGAChAAAADHEgFAG.IAHHcAFB.NEDDKEHBhAFA......hAGA...,1,-18,-40,22
VLGYWaJESFNXAMHPZTdDbeCfIgKcQORUB,MECGHGFGZEBFDCFC.eAAF.CBDA...IHGDKDDGQAFFhAAAUBDCBCADLDFBGFADhAAAaGAFSBBGhABA.XGDAAEHE.PFFG...hACA......hADA...,2,-27,-22,5
BAcOTSYCbFdDRKUgLGaQIMPEXZWHeNJVf,ODACSGFC.CCBA.FGEA.dBFEKDFBLHAAGDCA.QFAFhAAAIAAD.EEHFXBEGhACAHBCAeABC.JEEEhABAfAGEAIHA.TFAD.DGIB.hAFA......hAGA...,1,-9,-29,20
YCTFUZcEWKebLXJMOGPISafQVBdNgAHDR,RBCFTGGGUBGCZGCA..EEACKGHBLFFE.JADGMFDCGCDGhAAA.SCAAhABAaAACQDACBCGGNIBBACAEDEEChABACHACFFCH...cBGAbAEB.....hACA......hADA...,2,-32,-3,29
IbWcCSKRZBAFULHVfEgQOJdaNGDMXPeTY,FGDDLADGHDABEGGDQFEB.JDHDaEEFGEAGMBIFXACHhAAAeDDE....hABA.IDGGWBAFSHCChAAAKAECBAHFACGEfCFB..hABA......hACA...,1,-21,-27,6
GJTgeLOFUBQCIDHKdZXNRabEASfMYVcPW,SGFHMCCA..VCFG..cEBBGEDA.TGGGhAAALBEEFAHFBGBDIBABhAAADBBEKEBGXFDBhABANDAB.aDHD.ECDBAAEF.fDAC.PHAChACA....hADA...,2,-28,-23,5
KMcgAfSVYHbOQGICdeNaFRXWUJTBEZPDL,SCFCVGFG.HECCOCAAQABGGFBHdBHEaGACFDGDXAFHhAAAUGGHBAFC.hABAPDAFDDABKHACgGDAhAAAADBHfDED.bEFACDCB...NBBF..hADA......hAEA...,1,-9,-10,1
HfaFWQXKYIAPOUNVdEGBSgceMCZbTRLDJ,ODACVEFH.dFAHBEBD..SEEBeCAFCHAAZCDDRGFELABAhAAA.DCAAHGCAfEGDhACAWAHD.XBFDhADAIDCEABHBNIABEACB......cFCEhAFAMAGF....hAGA...,2,-25,-24,1
RMUONGLdgWKIAfcaHSJFZQTVePbBXYCED,aHBGHDED.FBHDQFGHeEHHBFBDCBCAEDDGDCBD..UACGGBFEdHEH.hAAAKABFAABF.SAGBhAAAZGAA.VEBAXAFBhAIAMCIB.LDDFIAEE.fCAEhACA.....hBAA...,1,2,-17,19
QGIgPBfYNdSEVCZaKcJHbRFeDXMUWOTLA,QFGHGAFE..IEABBCBAfGCEdHBFSADGhAAAEHEGZDDCKECDHAEGREEDFBAGeAAHhAAADIGG.MBIDOCCChABATEACAAIB..YEHFCFDB....hACA......hAEA...,1,-2,-20,18
dbFKLMQOgaXRSHAYBTZNGIUEDCPJfVceW,TGGGZEBHGBDC.EHGACHFD....JAHHfFEHeDEA.dAHChAAAKFAEMFABOEDBXDGAhABASBABACBBNIBB.hACADAGB.VACC........hAAA......hABA...,2,-34,-12,22
dUWKMHDLARSGPJNTaXQgBOEVCZYfFbeIc,SBBDJFEF..aABHXFBCBAEG.OGCEEGGFZCFEFAEC.hAAAeCFCdGACUDAHKFGCDBAHhAAAACGA.RDDE....NIBD.hABA.....gGGACACFfBDGhAFA......hAGA...,1,-13,-44,31
LcAXfGZJESBaPbgDRQNFKeMIdVWUHTYOC,XFGHGEDHZAFE.EGHHBFAF..aCDFbADEDAAB..RCDHQAAFhABAKFAAeBBB.IHBDhADAdCHE..WHAEhABATDFFCEAC.AEAGfAHESGEANADF..hACA......hBCA...,1,-18,-22,4
QFaOMEAHZTBdYcPWUILRKDbfSCNgJVGXe,ZBCDTGAFBCGE.dFHC....PBBAIGACLBFG.hAAAKFHFDEGFSGEFhAAACDAH.JDDAXFCBhABAeEAAFDHFaACGOBAHMBFH.AAGH.....hABA......hACA...,2,-46,-16,30
ZgUMPXRSeDAEIWdTbfQOHBaCYcGJNKLFV,EHBGdHBH..TFGFQGDBHCDABEAFCGGEGAAFJAAB.LAEHhAAA.FEEAZFEHUAGCXCGFhAAASECFAGACIFCAhACAWDAD..........hADA......hAEA...,1,-10,-28,18
RUdaDEYBcXPgIVFZGCbNQASMJWLOTeHKf,JECCLEEG.eHBCKGDHUAADDCCFBAHA....XBEChABAIADGFHFCZCFCGCGChADACGEB..QFAFhAAAAIAESBGE.MDBH...OAEGhAIATGGC.fBAAhABA.,1,-28,-41,13
RfTbXOZAEPYcCUaMdJNLBIFQWKegDVGSH,EHBG..PGEACHFDUBADMEBB..dBFGJAGHBEDD.FEBBQBBBhAAA.KDFGeFEChAAADICGSFDChABARAGF.fAEATGGC.OEHFAGADaDGENAEEhABAIDDA..hACA...,1,-25,-34,9
WQMYeSDIdVBHgZNEGfbcFLAaTXUPRCKJO,aEHBUCCB.CAFG.KGBB..OEHBQEDD.MFAFSAAChADAdCBCBHHHHGACZCFEEGFFhAAAfFFGFADC.AAIFTEABhAEA.XAGD...RFDBWDFEhAGADBGCIABFhAFA.NCDF..,2,-28,-13,15
NgHTYeIEDPUcMZVFLOWfRGJASQCdKBXba,SFFBQGAFKAEEBECA..aABCHCAEeDFFDFHF.UAEFMCDEhAAA.FFHHOBGDRCACAHDFdHEBhACANEIE....TFAChAAAEEDB..ZBGFVFDF.fABFhABA.CCEA.....hAFA...,2,-23,-6,17
FdKORPTNUEaLWSXAcVHgIfeJBbQMDZGYC,VGFGHAAD..IHACeABCBBEEMCEDDAFCGGCF.CHHDKFGEOEEChAAAREAA...NAIC..hAAAUDBFEAGDaCCF.SAEBhACAAHCD.cCGEfGDG.hADAJBGB.QBCDhABA..,2,-23,-11,12
IBdceXWUESQHFMYbgJNORAfLVTCGaPDZK,LFBBTADC.aBGDZFFEBAADeBAB.UCGDSCECHGBGFAGAMAFEhABA..bCEDgFDEhACAOFAGAAAECCCEDIGE.hACAIDAC.XDDAEHFA.JACB.hADANDIE......hAFA...,2,-17,-3,14
HMTEePcaDYfgdFVSLJNGICAWQURbXOKBZ,QCGCREFHODEHBAHAHFCA.EEDE.eBDAaGAB.DADA...gBADhAAAFCBDLHCEhAAAJFHB.ICGHAIBE.hABAUADHKAGC.MEIB.......hACA......hBCA...,1,-15,-30,15
ETHMbCZQRIdLDGYSgBWAeaXOVUPJNfKFc,aAADOADG.UDDGJFFC..KFBD...EGDBMFBB.CDGFRGFAdBEADABBhAAASDAE.hACABAGGABDHeAHD.XEGAhAIAPDFCNEAAFCBD.....cGCGhBAAbCCF.....hAAA...,2,-41,-26,15
UNCRXKTVDWLISAeOYaMFJgbBGPdcfHEZQ,eEEGaDCD.FCHH..JBAEBCAFdHGFHFAHEECDZFAHQGCD.hAAAUEECNBAFRGCA.KDAG.DAHFhAAAIGGAAAID.MIFGhABAbADB...cAEDCAFA...XCDChACA....hADA...,2,-27,-15,12
IPOWAGQTcLZJaMdVXHFDSCERKBgYUNebf,QCBHTDAC.LAFGJDDH.aCEGMACFdHEHHFEEFAHFSCGBhAAAEADHBBACgGAGhAAAUADCeFFGfGABhABAIDHG.PHFAADFG.....hABA......hACA...,1,-13,-17,4
MHLgJQPKRSOADZETGWacFCYVXNBUdIefb,ZEEETBCBaAAE..FDECCFAG.....XGAFNEGABAAE..UFBAhACAeHDA.MAIFHAEHJBEAhAAAQGDC.hABAKEDCOBCFDCIHEDAGcDAB...dGGEhADAIHHA..hADA...,1,-14,-28,14
IOXSZFGCKEbMLdYaBNHWTePfRQUAgVJcD,VFDFJFCH..DGIBODADZDFF..GBBBCHBH.KAGHEHGE.MAAEhAEALDAH.aABGBCDHhAFA.NBBHHDFG.hAAAeAHDfDEG......hAEA......hAFA...,1,-20,-41,21
UFcHJZgbPfBITVdeWKALXGMSODENCRaQY,LDACMGCEDBGH.CAFCRGFA.....aGBBQABC.FECGhAAAHABCJFADZGEEPAHFhAAABDAGVEDCeEFEABAHSCEEhABAECHB........hACA......hAEA...,1,-22,-32,10
ZWAgDCKMeOFVIdGTXaPcfSRYJELNHQUBb,DAEDMAEEOEDAFCBE..dFBCGEGA.aHBEPFFA..SBFHhAAAJCEGLEEDhAAANACCHDABBBEF.ZDAAAADFCAGBhABAKABG..eAHHIDHFcFBD...hABA......hADA...,1,-12,-30,18
VbNJIdEOUWZfYFCAeTaHMBcLgKPSDRQGX,TAADHGCCMBEA.LADDKBFFDCADQDBFXDFC..VAAFhAAAJEEGdBHCEHGCOFAFhACAZGDG.FECCCGAHACCFBCGGhAFA...gFGC....hAGA......hAHA...,2,-37,0,37
DVdcXWBZCLeAMYHFgUaTbRPEGNOQfISJK,MECGHDAGFFAHUBAAaEEC..RFCEGBEB..OBDG.IFHGhAAAKAECdHDDXFFBhAAAZGDECDFDeACD.AABF..hABA..gCGE.....hACA......hADA...,2,-34,-17,17
fXWBLScUQEYTNRbCZVdJMFHeaOPADIKGg,DGHHGEAH..XAGEBHEHSAEH.QFEHhAAATEABRFCGZFFBJBAFFGADeABHhAAAOCHHADEDKAEEfCEDhABALDDAEAGCNADE.CGCHMBBE..aEFG.hABAPHAE...hACA...,2,-13,-13,0
ZScAICfMUBTebPaEgLKdNJOVQFXDYHGWR,CFDGUFDBBEFEeBAD..aAFBLCCA.dBGH.OFAHFBDDXABGhAAADAAEGDEBZEABAIAAhACAMBCG..TAGChADAEGGAKHDA..JHEA.QFGA.hADA......hAEA...,2,-32,-18,14
XGFaPNcKJgTOYWBDfZMHQebLCSEURIdVA,GCEBFAFB.aDBD..NDBC.KAED..JEGFOEECBGDD.DIBAZAAEMDABhAAAHCDB..eABHhABACHEH.SGHBhADARAGF.IGBBAICA.PHEE...hAAA......hABA...,1,-15,-43,28
DBMNfRaTSceXYGAVPJLZUHIbFEKOQCdWg,VFDFJEEGLADG.ZCBGHCBE.IHHBEGGA.KADECAHGdAAChACADIBABBGA.MBAFhAAAfFAGRDEA.aHCAhAEASGFH.XFBBAFCA..hABA......hACA...,1,-27,-34,7
ZWdbSXLCMEJeVGPAIHRYBNKfDcgaOFQTU,HGFGBFDDKBFHDCGDaDDDFEAC...UEAAZFEDdDCB..SADDhAAALHAACBBAMAIF..hABAECHBeHBG.PCAChACAIHHG.....NABD....hAEA..fAGBhAAAcFEB..,1,-28,-40,12
SBNECRGdWbUFPXfQOIALKZaeTHVDcgMJY,LDCHKEHBeCAHHAAGVADB.DCEH..MAIBJAGH.BFAB.EEGBCCFDGDCEhAAA.dFFAUGGBhAAA.FABFPFBBhABAfFEG.OAGBAIHE.....hADA.aGEHgDAEhADA.SHAC,1,-13,-22,9
ANFYaSWOcDgVTBeGbXRQIfdKJLZMPEUHC,FHBGaAFB.OFFFDBBC....TFFCeACFXBGBQFDEdEAHhAAAKDFELFHHMEAGEAHDhAAACDDDABAG...SFEDhABAWCAC.gBEBBCDA...hABA......hACA...,1,-20,-34,14
fOMQUGeLBXANYdRCIDWVgcHJaKFSTbZPE,dHBHCFDDDGHF..VCCCHFEBKEGAFCEF....TBABZAFHEBAGMAEAhAAAGEAG.BACEXGEChABAACDF.RBFCIFBEhACA..WCHHcGGASAHFhAAA......hABA...,1,-18,-37,19
cYUaLMgRIeXWfECSDZOdHBKQVFJbAGNPT,GAFETCBC.UGFGMFCHRACD.....XAABEDHBSEEFhAAADFIBdADEKFGBFFBEAEBCNEEA..hABA....PAGHhAFAaHAAIAEEeDFACGFD.......hAHA......hAIA...,1,-24,-25,1
MAKCYBDWZFEIbdeUGNPOcHXfTQLgRSaJV,CFEDBAEDDCDG.FAAB..EAABdGCD.GBFE.OCBHXCEA.hACATGGELHFASDAHhABAaCDBMCIDKCCD.hADAZFAEeHAG..NAIGPHAC.fHDBhACARFFAAEEB...hAFA...,2,-24,-18,6
RWXNLgaIPcTUfDJCbEdBKVQMHeYAZSGFO,SBBDFCCGODFC.REDC.....XFFFgGBF.aGABhAAAIAGD.TGCEhAAAfHGBDFIHJABChAEAbAEH.EEAEBBHHQGEEeFAHACFAWDEFhAFAPDHBCHHD.KACGMBBF.hABA...,1,-19,-20,1
eUFdcPGAaWSCHNbJZQgXODRLVMfEKTYBI,aAFBCFEDHBFA..JFFDZDEA.QFBDOEAHLBDBMDAEKGGDBBBGhAAAeABCFFDD.dDFB.hAAA....cCAChABAACCGWFAD.SEHHNDIA....hABA......hAFA...,2,-31,-24,7
GVOeESAYUCLHRFWKPQMJBaDXbIcfdZTNg,CHHGLDACHFBDFDEBKGDC.MBHHBFFB.DAFA..XGGE.hAAA.IBEGdBEFNIBB.hAAAVBBFeEDA.AHAE.RGDE.hABAQABCaBHH.cFAFfEAAhACA......hADA...,2,-34,-18,16
AWJfEMaTULYOdFBQZPVKGCNHIbRDXSgce,JGEAEGFH..MDCCUEBELDAB.OECEBAGDQBDChAAAZAAEKFGEGAEFCHDFHBAAICHChAAADHAC..SFFEhABA.eDFEAHABaGDF.....hACA......hADA...,2,-36,-14,22
KRaBDUQSEOFdLeXTAINGZfMgJWbCPVcHY,GAFEZFACMBBEJDBA..CGEF...VFDFHCEAKBCGaEAA.BHCGDFIF.hAAAQGGGEEBD.hABAdCDC.eBFGABBCfFFBhACAbEFE.PHACYAAF..SEADhADA.LAHBhAEA,1,-15,-21,6
ZFSNJUQPAVfHgReGDBOCdEWKYcLITXaMb,VGFGHAADeEAA.BEGDOECDCCHF.dBFHEFCCKHAELADD.hAAATBEDaEFGMAIDZGBGFGHDhAAASDCC.hACAUABAAGGCfAGF.....hAEA......hAFA...,2,-33,-5,28
aKUSOcCfVBIXbRJPWNHgQFAYLZEDdeGMT,LFBBEGGEdEAAGEDDMACGKDCHUACB..SFEECBAABGDF..hAAA.IHGCRCFGJAFE.hAAA..PBEC.hABANABE..QDGAAIGG.DAGEeHCATGDFhBAA.....hADA.cDCB.,1,-15,-24,9
OUgGXbDHaFMVNBKPTdEIWQAeRcYJSCLfZ,eFBBRAAD..JBEFSDCFLDHBZFBFUGDAGDFEDCCCHGFGFAEA.hAAAVDFEBACC.KBGGPCABhAAA..EDBAIAGAhABAAIHA.CEDA.OEEH....hAHA......hAIA...,1,-13,-23,10
gQdGMREIWOVLaUAHYTBKDJZcCFSfbePNX,TFDHBFEAJCDD..ZCADFHEA..SDEB.eACCNEBC.hAAAQGGEMDABRBAC.hABAIHAF.WECFhAAALCFEAHFFKAGBDDHDfGGD.XDGChACA...hABA...,1,-24,-41,17
gLPRBYQfAUHaVeMXKWJFZNcOIGCESbTDd,aDAFMAGD.KHACFAFFZDGB..ODGBGECECHFA.EBBA...SEAFhAAADCCCLFHF.hABAPFEBBEEEfCDBhACAAEDEHEBBeABC...JAHFNEIEcGFChADA......hAEA...,1,-20,-27,7
aPbISOGgKYLUVecAJQWfNXdRBTCFEMZDH,JDACQCBC....fBAFNFADdACFBHBECGFF.FGGBMFDGhAAADEEAHAGB..aGAEhABAbAEDSBGFhACA.OEHB.KCCC.LHDAeGBEAAIDWAADhABAXEAC..hADA...,2,-34,-16,18
QOdIYRHcVEZJFUXWBLMGePfDaKCAbNgST,...NCCA.gFCA.QBEEIEHGRAAFHCACEHCEZDDGhAAAUGFGBHHEMEIDeADChACADAEGCHEC.AHAHSABAhAAATAGCdFFA..........hABA......hACA...,2,-18,-18,0
OLdCgAPfKTHBJeXNcFQaDIVZEGMSUbYRW,KHBGTGDCHFCE.eDAD..NDBH.QBCDaCGG.VAGDZAFGMIFAhAAASDEAUABCbEAFhAEARAAFOGFE.CEHEACFHhAAABGGG.XDFEDFFC.EECF...hACA......hADA...,1,-6,-7,1
VgTEYWSHGXMJNBZKabFfCIQULDcPeOARd,dDAFTFDHEAAD...SFFEXGDAMIBEBCEDKCGH.aGGEbDDAhABA..CAGG.UAGBLACBhAAADFCHeEAH..hACA.RACGgGGGHEAAJHAANIEHfBAAhABA.IAEAhAHA...,1,-1,-23,22
SOHdXABDbKfaYcIWQEZRVPJgLeCNGUMTF,BAEDDGHHKACGaGEE......IHCFEDBGVCFD..JFAAeFCDhAAACAGF.GBBFUFEAFCEAhAAASEDH.hABAdAHAbCAAfDAG.WFGH..hABA......hACA...,1,-22,-47,25
gWHSCGOVLMBQKEDPfTXYURZIJcAeFadbN,eEGHdDAB....bGECNDBHHFCBGAGELBFHMBEF.QACHhAAADABH.TEAFhABAUGAERDFBJBHFAFAAaACFSGFDhACAOFCD.BHAF.......hAAA......hAEA...,1,2,-20,22
NMUGJHaFILWfQCYEebgTdXBcADSKRVPZO,KGCDRGFGZBABMEHFUCEAGBAE..aHBALCEA.QAGHhAAAEEBCeAFE.TDCFhABABEGAADGESACDhADA.PEFDNAAF.FGAFICCCfAEHhAEAbFBE......hAIA...,1,-7,-28,21
CcTbXFAUeRNfIEHVMBaYWKLOJdGgPZDQS,eADGRAAD..IHACEBHHMEFGBHHG..aFFFKAEDLFAGhAAAdFFCGFABZBADDIACCEDD.TCDFhABAXAFFAIHANHBD.HCEAhAAA...WDHH.OHCC..hACA......hADA...,1,-14,-22,8
eUIgEVZdJbPHODXSYaBWFRNAfGcMCKLQT,GAFEMBFHLCACeCBFUEDCECGG.dHBDJHBCHACG.DEHF.SAADhABAaEAEFEGDAAGHCAAC..hACA.QEDChADA.IAHEZFFFOFABBGHA....hAEA......hAFA...,1,-11,-25,14
ZJBUcRPFLeSKfGOgXWTIDQAdHEVbCaMYN,dEHAEDAF.CAFE.MCHDZBCCBEBAUCEB...RGFG.FBBCLHBGeFEEKFCA.hAAAGADFOEDBXGAGhAAA..IDAGhABADIGEAABE...bAGD......hACA.aEEFNCIC....hADA...,2,-35,-16,19
WNRJXbdPICMfDEcLTFKSgaAUQBVZYGeOH,BCAHVGFG.GEDHHAABRDCGJHCE..dAGACDDH.MFAA..EFBGTGBEhAAAFACE..KAGDaGDDAIGC.hAAAUDGF...QAEChACAeAHHOFAB...XGGAhABA.....hADA...,2,-29,-7,22
ESceJUXdYDTWGHfFNBRKOQLCbVIgMZaPA,EAFBeCCHUGAAdHGBDHBCGGEBHEDF..FBCDBAAEKFDC.OCGDLCFAhAAACFAG...IABEhADAMAIBaBEBAECESEEEhAEAJBFB..YACDfHCB.hAEA......hAFA...,1,-19,-29,10
HagCAFdGVecYXSTUNBOIbPJWKQfERZMDL,GACBVFDF.eDEG..XBAAUGGGBHFFOBGD..IGDFhAAAbBDG.JDACQGGAhAAAEBGA.ZFAHhABADFFAaADAgFAFFDEF...YBAAhABANAIEKEBE.MAFE.hACA...,2,-15,-9,6
AeKIHVJfMTNRSFDQbYEZWdOPcLBaCGgUX,KDCDHGFG.JBFBTAFFRFAD.FFCDQCAG.EECCdADAODHDhAAAPEFHBDGHGAAEhAAA.XEGBACEDVABAMAFEhABADICA..YFAF...cBGEhACA.CDDB...hAFA...,2,-26,-7,19
eQPRUIZOKYcVJWfGLCASaFHTDgMEXbdBN,FDABHFEEDFGBEBEF.dEEBBCGFQBBARFCC.UGAEZDFEKHDA..hAAA..cEBAJCCE.hABAfCHCCBCC.hACAAACGaAABTGAC..MEID....hAEA.bAFBeEBAOHFChAIA...,2,-42,-3,39
TcOgLCPRFGQENaBVIAKXeMSZWJDUbdfHY,KGDDeAEHZEGBDHGAUEABdEBH...HBAH..TFDDOADFLAABhACACHBH.RCGDQGBHhADAEFEDBBGGAHIBMCDHhAAASAGC.........hABA......hACA...,2,-35,-22,13
SINYZFKgAecTbaQCHfLUBJORDPMdGXVEW,eDACTCBCQAAB.CFFA.HFDFLCEGJBFHDGHHMHAAXEAHhAAAEHEA..SFCAhABANCIGZFFDKHBAADEBaBFGBAFEhABAOEEGdACB.........hAHA......hAIA...,1,-13,-17,4
ZEXQbKTJGSLYDFBIfHCaeUARPVcdNMgOW,RGFGVAADdGBH..MAIHOFCAZFDF...QGFEKAABGCBESEAFhAAALFFCFBFBIDHAhACACFAC..aAEGABFGPDDAhADA.cGCCNAHEEBDB...XGADhAEA....hAFA...,1,-11,-29,18
SXQYgVWfGUDdHCOcTAZLNRaeFbPEIKJBM,ZFDFLFBBaAAF.eACDFFHF.EGGHKGBF.BDCASADE.XAFHhAAAQBFEVDFAhABA.GEDEDCAFCHHDOFFDhACAABBD...NAIE......bBDBhADAIAHFMFAF..hBAA...,2,-26,-18,8
EQfSNPdTBGgDKIZCWVXabOJUcAYFeHLMR,eCCHMAGDREBCQFCE..fCADSCAHdAHEBEGAhAAADAFFZGFACADGVBFDaABCODHFhAAAJHAAAHIH..FFFH.hACAEABBNDAC....PHBE....hADA......hAEA...,1,-17,-20,3
KFXeVJBCIdcSNHYafLOQRGPMUbDETWgZA,FFAAeADGBACGdHED..SAACHBEFaGHBLAHFQFCCREFHGAAEhAAAUEFGECGC.TFAEhAFAZECBACDCKGAD..JCBEhAGAIHEENDIE..fCEF.hADAMIAE.DBBE..hAHA...,2,-9,-9,0
JbcPGVCKMFfZQNgROUSdXYaWLBDAITEeH,EGFCJFFC.....bBEDGCCH.KEBHfCGEQABFRDABSGAAhAAAdHEF.hAAAaCAAWDFALADChABADAGBAIBA.IHHC.......hACA.eEAD.PAHBhAEAMDDHNICB.,1,-20,-27,7
CTABVYNgIEZWQbRLfOSKPaUdXcJFMGHDe,VDBH..gABDEADE.QAEHREFCODDG.SGAEhAAAaGED.dEGEJAACMIFAhADADAGFCHBBTGDD.hAFAADGCBDEFIHGCWAHB.fDBChAEA.KFCCPAHF.hAGA...,2,-27,-17,10
HNeTFBPGCALEMZdSKfbXIcJUROWQVDYag,MEGFZFEESCDGKDBB..XBGGJEBDRABH.OHDE.QFCAhAAADIGAaDABHAGBhAAATBDABBEC.GDEBhABACHAEEEABdDDD.IBAAWFCH....hABA......hACA...,2,-24,-18,6
CcUWSPROEQBKVfTaGbgdZAHIYXeMNLFJD,HAADXCBCMEAAFEFADIDE.UGAH..SHCCRFGD.QBGGhAAAVBFDaCCA.bFAChABAZEBEAAEG.eADALDEDhACACDHA.cGGD.OBBAEFEF.BECAhADA......hAGA...,1,-6,-16,10
RcbCYZJKafXdLFTGIBAMPeQWgSDEOUHVN,eCHDQCBC.SACCDGHBOAAHUBGEVCBDRFEE..CEDAZFADhAAAJFED..KHBE..aBDGhABAdGAG.LBFChABATGCEBHEAAEEDMBBA.....gDFDhACA.NAEF...hADA...,2,-20,-16,4
dWcCgXBTOJNbfAPDUEMSeHGYZQLRVFIaK,DAFBEBDH.eDAGGGEFZGDELCGDFFBBKAAFdDEF..CFDEBGBHOAFE.hAAA.JCBA..fCHChABAAAGC.MADAhACASEAD..YFFC.RFCF.hAIA......hBCA.IDBAWABA,2,-46,-7,39
ZSbRTVLgXYHEGDCNWMdOQeFAJcIPUaBfK,JGEA..IAFBUEBEBHBFZEDDREAB.LCDG..XDDHhAAAEABEDIAE..CFGGMIFAhAAAQAFG.eACEhABA.AICC.aECFfBBCSAHH..hADA......hAEA...,2,-44,-31,13
cgJMRPATKBUVdDEaCbXNHZWIfQSOGFYeL,TGAFKFFBUGAD..dFCDDAAFCDAG....XCBBHAEDZDEA..hABAIHGHQDABhACASAGBOBCFFHDChADALGFC.JAAEMBIFRDDGADHGBBFHEBGFaHGE.hAAA......hAEA...,2,-23,-14,9
ZHDKWUATXcOJIYeVSPBNbLGMECdFRQafg,TCGCXDAC..JEDBeGCA..SGFGPEEC.BBCHhAAANIDH.GBAA.ECEChABAdCDGQGAEhACAaAAEfGAFZAEEKEHBAGGFOCFE.IBFAhAAA.....hADA...,2,-17,-17,0
YCRDdBPMOeTQKgHaSELfAcUVIJXWNFZbG,VEFHJDAC....XEEGFAAFZBDGGEAGRAEB.DGDHBHEF.hACAMCHFeHEGKAGAaDBFLAAAhABAAAIH.UGGAhACAIDEH.NAHC.CEADdGAF..OADAhBCA......hBDA...,1,-22,-26,4
fPLdebCZGNYFIHVEQOTKBaWSRJUgXDMAc,...PCCHdGDBCAABZAGDGBECFDCBHAED..VGAEOEECBEHChAAA.SABGhACAJCABUACE.DHGAAGGD..LHEAhAGAbAGFIEAC.......hBAA......hBCA...,2,-25,-19,6
fYUHXTcaOKWLDZeRgFSNIEdVMJCGQAPBb,BFDG..bDAGUBDHHABG..XCAFTGAAaHGGOEHFKDFEDGFDhAAAREEB.FAGF.SEEGhABANAAF.dEHEMBHHhAFACFBBACCH.PGAC.fHGB.hACA......hAEA...,2,-30,-13,17
DISZKRBcTEUeHFJMNOCbQWXgLdGVPfAaY,aHFGDACBZACBBHBD..ECEAHCGF.MAAFCGHD.QAEF.hAAAXDDBgECGhABAdGCFGCAEfAGFhAFAACDGIFFFKHEE..cEEF.eCHDhAGA......hBAA...,1,-8,-40,32
IJFSQGTAYaeMXHVUgZBKDfNERCcdbLPOW,eCCHMEIBHFEDUGFGBCHGDDHF..EFADRAADdBEHLFDD.PBAAhAAAIGAG..SCGEhABATDFDAHHC.XDAAhACA.gBDCKACCfFDAhAAACHBA.OHBCFDEG..hAFA...,2,-35,1,36
GOgSKIXMCFeZQHANRdJUafLEPWbVcTDYB,RDAGdGDDUFGCLDFE.ECBG..PFDEVAFC.DIBEBBDC.OEAAhAAAKCGGMBAG.CAHF.hAAAFFAHZADFABBE..JHFEaAFFhABA....fEGA...hACA.cFBH..hBFA...,2,-36,-26,10
HbSAfBVIdQKCDXFPeEMZORJNcLgYaTWUG,VDBHQGBC.CHFH.FFFC.EGDHZBFHRAFF.JDCELAAF..hACAaBBBTBCFUACEHFFChAAAAIHABAEF.KHFCDFEEXDGAhADAMBAF..OBHD....hABA......hAFA...,1,-16,-22,6
SbCTZLEBGNMgXWFaUHVIPJAcfRYdKQeDO,RAADdAFBQGEBDFGD..OBEESDCGCAAEZDBE.BBFB.NEBG.hAAAMADD..XAGBhACAFFHD.aFDBVFDFhACAIADCABCB.fCHAKDFE...hAEA......hAIA...,1,-20,-40,20
aFgKZAdVLRQTCXJcOYfISHEDbMBPNeGUW,dDBDVDBGQEGE.CAHD.XACG.JAFFOFEB.hAAAfABCIGFHEHGAhABAMADCBEHD.PHAChADANBFG..........hAEA......hAGA...,2,-38,-36,2
XdfAbLgNceBPGMCRJTSKZDWHYFVQOEaIU,LGEA..gBFGNCAF.eDDFPBFFCCAD.JDDBKGAFhAAA.DEIDHFABFABCOFEGhADAaFGAUDAF.dAABAEBHBGGHhAEAMICC.SBGEWAGB....hAFA......hAGA...,1,-11,-37,26
QbVFeWMfIcGHRgUCDBOSdYaPJEATXZNLK,XCCBZFDFKFAH..QCCD.FBECWBFF..ICAFhAAAGDGAHFAF.hABAgBADDAFCSGGAhACAaCGBEADATDGDNIEFVEDB.MAAEfAHAhADA....hAEA...,1,2,-36,38
YLAJMQKEXCcgeDUPdTWOaBfGRNSIZFHVb,MAFHKFHBEDGF..CBHD.eAACDIFG..dFGGTECH..aEBBBAEAhAAARDDF..SBBFhAAAIHADFHFAHACB.VGBAhABALCBCAIAA.JBFG.cFDD.UEAAhAEAOFHF...hAGA...,2,-18,-18,0
PQYWeTGHSKZdMDRAVEOCIfJbLNcBFaXgU,VDEDCDGF..JEAHLFAHBDCH.FABH..aFGGUAGB.QBDGhAAAeFEDGABHSDHHhACAKFCFdAACDIAAEHGAODCBhADA.IGDFfAHE..hACA......hAEA...,1,-12,-45,33
JCEWLUAdKNSITMQeZcgDYROFabGVBPXfH,dAFBKAFB.SFFEMEAFZFDH.DIACRDBF..FGGEGDBC.BBAGXDGBhAAAJBGF..EGEALCAEhABAAEIB.IFFDhACA..........hADA.eHAAYADHhAAAaBDF...,2,-49,-19,30
SICMVKTgeJaYcOADRBGWULHdfFZbQXPEN,DFCFRCBFBHGCUFDHdFACZAFE..QAEE..EEHBSFFFhAAAIDDH.CDECMBIFhABAKCAF..eFADaHDC.OBAGhAAAAFEBLDGBFGGB.XACB..hAHA......hAIA...,2,-36,-24,12
PREQOIbXGYZLdWeNBVHfAgFMaUCScTKDJ,FGFHaAGD.CHDF...TDDADFBB..RCFA.EEBH..QDDHhAAAOACGIDHDGBAFZAFAhABALGFA.eBBHhAAANEIABDADfGDAMFCHSGGBcGBBKFFChABA......hAGA...,2,-22,-21,1
BZONSLWfbeHAaDXMVYKgRdCJGcPIQFEUT,XCBFMECGKHAC.RBFG.dFBHGECD..IEGFEGEAUGABBHDDhAAAZABAODHFLABC.hAAA.fEAEhACAeCDEaCCCDGHD..........hAFA.VAGHCHFH.PFFBhAGA..,1,-16,-20,4
aXfHNAPGcVQWCLYMSgFJKbedETRBZOUDI,GAFEQFDHLABFMEIH.FCCAKDEBdADFRCGHBAGAUFFFDIDA..hAAAaBCD.HDAEADHH.PAAAhAEA..WBHBhAHASGAE..JEBEEHGE....hAFA......hAGA...,2,-31,-17,14
aWTMPOCFSfJLgVbRBUGdANZKXEIQDHcYe,ZDAGXFCEEFFC.DHGAHFCD.eADG.TABAMBFHCCDF.SHAEhAAAfFAHLDHHhABA.VCAFBEEFhAAA.dHGFAEDGKABHIAHFYAGDaCHB...hABA......hAFA...,1,-12,-24,12
SCbNZgLMOKXEGQJRAIDfVYBcUTadHFWPe,DACBVAADBHAG.UFFCdHDBFCGB..eBABCGGAZEBELFCD.hAAAKCDFEAEG.QEGDhACAJADC.AIAAICDDhADA...fAHEcAGEHFDDhAAA.SCEBhABA...,2,-43,-23,20
eTVGCBdKPLWHcEFNAbZUaQJROXfgYSDIM,UFDHaGDD.QCBCRDFF..fGHESGGDMACDTBFFhAAACHFGdFADLFBFhABAHAEFEDDDAAEGJADFOBAB.hACA............hAGA......hAHA.YEHFeBHD,2,-18,-9,9
CcXDBKNdPHMVRaLEGbOQJfIYAUeSFZgWT,UGGDeEGHZGCA..TAADCBHHDBDD.BFEEKBFF.dEACHAAF.MEDGhAAARCDCEGEB...OHBEhAAAfHADADCB.FAFAhACAgDGC.XACFNDIEaDAH..hAFA......hAGA...,2,-30,-19,11
ePWKdCZcTJVbMDEUBXFRfYgOHANIaQSLG,aHBGQGGDGBAB.eDACKDGFZFGB..JAHFMAFGDDEBBFGC.hAAARGCA.gFEEhABAABAA.IEACSBCAhAAA...........hACA......hADA.WDDFCBFE,1,-23,-44,21
ecOWNJYBTPHfXLGaKDUdFgASMVQRICbZE,MFCFQBBHRBAE.CGBGZEBAeAFD..OAEFJHDABAHEHAGFLADBhAAAKGFGDDIF.FFEAAGIHSDEGhAAA..hABAIHHG.cEGANEAE....hABA......hACA...,2,-38,-22,16
SGabfUEeLDFVROTdYJANcIPMXQBWCKgHZ,..IFDGMAFHBAGBKAAD.HBACGBFC..fEEChAAAEEACDBCEFAHDOHCAdCDEAGAC.NAIC.hABA..XFGEhABACECCZDAFbFGFLHEA.......hACA......hADA...,1,-20,-22,2
gPOWfDHRcbBLQUNECKYIdASTGFaMVJeZX,TBCBaDAF..MDDBJFEH.ZBGB..XGGEOFFCDIFE.RACABBBDhAAALAHB.UEAGhAAAEGADKCFFIABChADA.SCFB......hAEA......hAFA.FHBGgGCA,1,-27,-32,5
cAGfDdKSZHaVgbUOQRYMCPNJWXTIFeLEB,GDCCDGHHKECHZAEDHEAF.aAFC...bEGDQBGC.MEGDhAAAPCDA.JAAHTCBEhABAIADFeEHBLEEBhABABACGAEAHSEEH...hACA......hAGA...,1,-10,-32,22
QNLgCKXbRaBdGeWFSMATcPEZVDfHOJYUI,TCBCEHBGDFFC..HEBGOFEBUBAC..QGAHLHEGKCEDhAAARAFHaHFCBCGEGABHFACAAGGChABA.ZAFEJEEA.IGHDhAAACDHA.XEAC.....hAFA......hAGA...,1,-4,-23,19
aCeFGLQBHVNTEcAYUMdgfPDXRIJZObSWK,MFFFdHBH....gDDBDCFEXFAERADEZAAF..OBBBhAAASEGFaDDAFGDHGFAFhACABADAHEGF.NAIEEAFAhABAAAHDfHFB.JEHBKECE.CHBD..hADA......hAFA...,1,-12,-23,11
dYKbWFRNOLDUIJXPeMHfEagGTcQCBSVZA,dAFBKHBGFEGDRDBHLDFC.UFFEXCFB.eBBAHBDEaDAHTAAHhAAA..QDDDhAAACDAFSGEDABBA.hABA.YGAE.NEIEDHDA....hACA......hADA...,1,-23,-31,8
VCQdXRYEUSATLfaNDBGKPOZgWeJHcFbMI,TDACaDCDBGFA.GAFGKAAFZEEH..eEEFJADCHGAAFBCB.MICAhABACHABdCAC..RCFBUGGAhACAAICA..NIEB.DCDDODHHhAAA..cFCA......hAGA......hAHA...,1,-14,-30,16
GPdBJQFTWKMYaHbORgNcfDAXESIeCZUVL,EFHBeCCHZBCELBABGGABBAGGFHACKHCCMDBFHDFD.RADA...NIEF.hAAA..DAAGAACGXDEGhABACGHAUAGEdFDF...hAEA............hAFA......hAHA...,2,-32,-20,12
cYdaUCSAgGJEeOIQNRWTKPHXFBVLZDfMb,JFEFeFFB.ODDDQCGBRGCE.KCBFXAEHFFBC..LABGhAAADAGEMBBD..bCCBhACAdBHAUAFFAHHAECCB.IADFhAAANDAE..TGGABGBC....hADA......hAGA...,2,-21,-20,1
QdICAKgEcPWNOeRDGHbYJVLZXFMUTaSfB,KAFBEHBG.....PHFANACG..ODDHDCBBHABE.JCHBLCFEhAAAZECH.FFGBUEEHhAAAaAGGBHEEdFAAADCE.gEAEhABA.cADB....hADA......hBAA...,1,-31,-34,3
IGDTYFBaWXCdLNbJAUKMeQEHZgOcSPRVf,KBDHMIFGeFGDHCADZEAEOEEC..SAAFRCFE.VCGHhACAfABG.IHCChAAAGGBDDBCFYFAGhACABFEHaDACCAFH........hADA......hAEA...,2,-28,-20,8
ePQCUHJEITSRdFYfKXcNVDGABZMLbWOga,BECDLAABOCCCaEAA...QGDAHGDCIBGDSGBChAAARACBFFCEKHGAXEFAhABAVDEE.AEBDMADC.WAGHhACAeFAH.CCHA.JBDC.......hACA......hAEA...,2,-22,-12,10
fWGZFRdPNebJcHMIDCVaSTKOUXAQYLBEg,QDACLAFBBBACEGDC....fBGAGDDGZGFAFGAAPCCBhAAA..eEEEhAAAJHAEMIEAICCDCAHB.hABAaAECTDGEUGGHABID.WBACdEAA.NIAF.cADFhACADEDB.....hABA...,2,-17,-10,7
LYWgOQSVeABZHKGMJTIXFdEDUCbNPfRca,ZCDHKBBDMFHHJFAB.....XAGFFABHDDAGUGFACDGH...hAAA.NEDG.RAECLCHDhAAA..YACAhABA.OEFBQGCFeCEFAGBBBDFB.hAEA......hAFA...,1,-36,-37,1
NebKCSDgWLZfJBXQRVcMaIFETPYOHUAdG,GEAHeGEAKECGCFFBDBADLADA.ZEADBHHGRBBE.MDIHFCGA.EHAG.hAAA...PHBChABAHBBAdBGDSDGGhACA..fGDE.JDDE...hAEA......hAFA...,2,-28,-24,4
FSaHLOgTXBPEReZcNJdADGWCbIMVQYUfK,DCECGGDHCDAA.MEEE.QADAUFEE.KAAEaDGF.LDCDhAAATGAGBFBBEGADeABGhADANDIG..ACBH..bAGFIDEDhAEA.fAFFFDCF...hADA......hBAA...,2,-35,-18,17
aKPUfZOYXSRFBNQACIWbELHeMVTdDGcgJ,CFDG..bDBHHBEG.eEAHVFEFDDBC.GDCHJBCC.KGFGUAAEOACEhAAASCHD.hABABDFENIAFAFGG.EHBEMCADhACATDDDdEHA..aBHFPAFA...fDAAhADA..hAEA...,1,-8,-25,17
TcBVIadgeSGACKLObHYUQMXNWfEFPDRZJ,LCAFOFBBHDFEUGBEQCDGMEDC.XFGA..hAAAfFFEECAHDACAJHCChABATABEVAGBaCBDgAGFhAAASFFDADFACEHDKBDGNBBB.....hAFA......hAGA...,2,-27,1,28
DHMeYaQbPNCBRLATGISOJWcZFEgKfVUXd,TFGHSGAH.OCFBJBGHZBAC.FGAEKCBD.UFGHdADDDIAGMAFChAAA..eFEDQADGhABA..NEDECCEBBHEChACAAEAF.IDDD.EDGAfAGBhAAA.....hBAA...,1,-29,-30,1
KLGfPHUbOVTeCMYNQIDAdcBEFXSZaJRWg,BFEDFFAAZAGBRFAAKDCEGDDE.HBBBOAHD..eFHFCHDF.MIDChAAAQCECAGADdCACEGCF.hAAA.XGGGSFGFhABA....JBAA.WFFE...hACA......hADA...,2,-40,-10,30
REQYILZXacOSJFAfbgWeGBdCUKTDVMPNH,...fCFCgFDHGAAHCBHE.KHDGTBCAMFGBHECBhAAAEEBCQDFEIHHDXAEFhABAOADAJHEEAEEBWBGHhADAdBACDGCF.NDIE........hAHA......hAIA...,1,-10,-15,5
TOAfJbaHYdSZcWKLBVFPQXDGMUeERNCgI,JGEAaCFCHFBB.dHEFSCCHZDDC.KGCBBAGD.FDAGXBADhAAADACGMBBC..EEEAhABARFGBCBAG..TEAGhACAAFBF.fCGF.cGAC.WHFAhADA...VAEEhAEA...,2,-34,-29,5
gLaYZGBXWHAFbCSJKDTPIEfQMdUReVNcO,CFEDSEEDDBCH...TCGFEFCDMFABUABH.RFFF.eBDDVEAFhAAAOBFA.aFHB.hACAZDFE...BADBhAAAHFCFACAHJHDEICEH.fAEFhAEA.NEIE.....hAHA...,2,-32,-18,14
XZJKfFGPAEBNDSabIcUQHCTROMdWegYLV,BFEDDGHH.SCBEaFCB..IDCBUAGGCDAE.RAAB.dGBEeBFFhAAALEDFZAGFKHEE.FEGGhACAAFABEHEC..NDAG.bABAhAAAHACA.MGDEWBFF.....YFFChABA...hAEA...,2,-26,-16,10
CAaHJcQfNGEBgSdVUKOZFDeLPXRWMITbY,aDBDHFDF.JEAEQDEBGDGEBAACdABGUGGFKACF.FHBADGBE.LAEDhADARACGMGCATAGFhAAACHCG..AGGH.NEAA.EAGChAGA............hBBA......hBFA...,1,-14,-30,16
bdOgfYVeUFRESWQMXKPLACcIaJGNZHDTB,CFDGaHBGGGEFHBFFBAAAdAAC..OBGB..YCADeFBFUBDDhACAEEHD.QDAFhADAKGGDADEHJDCH.DGAB.TEEChAEAfAHE........hAAA......hACA...,1,-13,-34,21
UMWJeAGFZbIRSQgaENODKVXPBHCdfLcTY,FCAHZAADRDCCQCCD..EGDCOGBAKCGF..VEAHXAFDhAAABHAGdGHGLABEhAFA.cFGHTACFMAIFhAHAeEFAAFHC..IHEGaAEFNICF.PDFChBAACCHB......hBCA...,2,-17,-15,2
HGSZaRecAPUFVTEJgKdfQOMbLIYCBXWDN,FGFCEDAFKEDAQBBF..MFBFLEADCCHGBHFDDCEAHBCDSEHDhAAAZEGHeAAFAEDCUGBChABATCECJADA.dDFEfGCAhAAA.IAGF...hACA......hAGA...,2,-26,-15,11
RTFEVAYZIMKPeLNWbgcUCQdGJSXHaOBfD,ZAADMHFGKHAALCDF..NCDA...gCEACEEAGGEH.SBDEhAAAHAEDOAHDhAAADBGERBADEFGEAGEA..PCHHhABAeEAH...cGAE.dEADaHDCBGAChACAfCGG..hADA...,2,-23,-8,15
WZXaPgScIJMTNEbfYOHLFeRdDBQVUAGCK,CBCCKCFCZDCC..aGHD..SHFAJDBD.MHBEEHFA....hAAAbAACfBEChABA.OAHFLEFGhABAeGFCRECHDAGCBCGHQBDAAFDE.WFADhACAPCAD..cGEBhADAIEGC.,2,-29,-21,8
RdbIUWafVDGKXOJMQAeBcZECYSPNFgLHT,eAFBZDBHEEGBCCED...SAACFEAAHAAAdHEFUGGF..aGADVACBhAEADDIDKEEG..ODEGhAFAMCDHAHCFBGBG.PAHDhAGANAHE..TFGGIBFF...hAAA......hACA...,2,-26,-18,8
LTYIHDPJfQegcRCSWbEVOAKNUXdFBMZGa,UGBCdFHABCAGMAIBZAFGLEEC..ICDFDDEA..PBEChAAAQGAB.hABAeDEFgDAChACACHECSGFHbFFA.EBAEAFFEXBBAaEAC..hADA......hAEA...,1,-26,-31,5
cWTCebMHYNVPAOKLFIGEQJgZBUXSafDRd,KGDBFDCDEGDGQABE.ZGFAXFGF.aCHDfCEGhAAA.dFACTGAEhAAAbEFAMFCDNBEAAHIHLABFhADA.IAFCgAEGBEADDAIHWHDAhAEACDGF......hAHA...,1,-11,-26,15
VgOMGXeEZSfKFaIAHLWBYQbUJDRCdcNTP,HFDFLAFBBAHDQDBCUDGGDHGGdFADTACG...VFGHhAAAMCDAGDDEEBAE..hABA.fCHGhACAaADEAEEA.YHACbDAA.......hAAA......hABA...,2,-33,-1,32
ebHABGRcFTUgLVaEXdfIKPOQCJNSZMDYW,BBGFGEDHFGACUGCCLEDGEGAH..dADAKADAOCFE.QBAGhAAACCBESCEGMBFChABADFHD....WEHHhACA...HDBAAABAcDAF...hAFA......hAGA...,2,-58,-10,48
MHCgbZVFTeLOdIWEAaPDBNKRUJQYcXGSf,aHFGDAEDKDDB..JADCQBGG..XDFASBBGhAAAHCBHCGEEZDAFFHCAeAHDhAAAdGHEEDHHBFCH..NHAD.hABA............hACA......hADA...,2,-38,-34,4
WJCNPIHDcfbRSFLXgMEeAVTYOUKZGdBQa,TFDHODACKFEE.ZAAEBDHE.QCAHaAFE.JBFBCCCA..hAAA.IFABDGCF.hAAAfACFSGGBhABAFGHFgCFDEHCEAIAC...YAHBhACAdAHE.PFABcDCDhABA.bFFF.,1,-23,-31,8
SZNcQEYTaOeFJVdfIGUWBDgCKXPRbALHM,MAGDSCFCZFGF.QAAEEAAB.aGEAeEBB.JEDEVEBGhAAAdCCG.GACFUBDEBCAGhABACHBDKAHB...PBHDhACAAIDGNDAG....YDHH.FEEAWHBAhADA.DFAD...hADA...,2,-19,-14,5
NfXFbKARadOVLWgGcYJCMUHQSTZIDEBeP,RFEEaEEDdDDDLAAEGEAE...JBDEMAEGHBGHSDGAZFAG.hAEADHDCBHHD.eCBBhAFANCBD.fHAFhAGA..FAAEADDBOEHF.gGEAhAHACHCD.....hAAA...,2,-35,-3,32
MXNTCRWDfVQedOSaHUIEZKcbBJPAgFYGL,FHBGLFEFMDEC.TCAGRGFE..DAHHQGFEdAEG.aAFCIEFAhAAAKABEBDEAAAGFGBBGhABACECC..fDHAhAAAeCAD.........hACA......hADA...,2,-34,-30,4
OWbUJTGaVYMIdNfLgEQCFXHPZAKBceRSD,BFEDeFBBDFCCODHBUGDFGCBE..aCEFMBDG.dHCBLCAEhAAAEEEG.FABGXAAFhADAHAGHAHGFREGB.SEAChAEAbBFAJFAB.........hAEA......hAFA...,2,-24,-18,6
QfMUPBcNYJTeKLFbOZaXdCDSEGgRVWHAI,QCBCUFDBBCHB.....NDFCJBDATCAF.LFAFhAAAFCHDOHBAaECG..XACEhABADGAESDGDhAAA..EGBD.gEFBWABCIAHDhAFA.fGGHhAGAMIFE...,2,-43,-25,18
FBZcKdSfODXRaUEYgWMIbAJLPNQGTHCeV,JEEGLGEA.QDBBTGBF.HBFGCAAF.eEFCBGHEKGBBSFDGhACAOABGDIGCaCCBhADAEEDF...YBBGhAAAgAGD.ICFEAAFC.PHDChAEA...NBBC..hAHA...,2,-33,-16,17
WJdeDGLAXbagCcSfIPTQRBHEZFNUMYVOK,aGFCCFDG..SAGE..fHBFTEEGBAEDECGHFAFHhAAAMDDCOABD.KECDhABAdDBEDDAFLBAAhAAAADDBbEFA.cBGF.IEHC.PHDGhABA.....hADA...,2,-34,-23,11
IRCLAeVUNFSbETaBHGcgKfJZWXMPYQdOD,VAEGFGFCEHDE..BDAHGCDGKDHF.ZBGD.MDBHQGFG.hAAADABARABGCCFGAECB.eFADSFDDhAAAaGCH.HCDAhAEA..fAEBXBBBdHAFOFFA.hAHA......hAIA...,2,-26,-7,19
VTSFeDdPBGQbRMgOKNWJEIfXYcULAaCHZ,CHCHZBDB.SAAFeECCDEGHBABEGBGC.RGCE..MGFGKCDEJFAFEDBH.hACA....XBFBhAAAUGAAAFEHaBBC..hADAHFGB.FDACdCFCQFDA..hADA......hAEA...,2,-37,-7,30
FeGULQCYNgSbaOHXfIEAZcMKdTDPRJVBW,ZFACMHFGKBDEdFCHDIGARBDB..BAHAFEHH..GCDHUAAFLDADhABA..CBHG...NCIC.hADA...SFFEhAEAOAAAfHABAHABTBFA.JBBF.eEAGhAEAYHDA.aDFEXEEAhAFA,1,-32,-33,1
RNCKAEabTMOIgPVGWLHfdZeBJcQYUFXSD,EAFBTGBC..MEBBOACB..IEDDVFEFLBGDhAAAdADABCAAQDAGhABAFHGAXAGFDAEDNAIA.AEECaGAHhADAbFCCGCDF.fHEB.JDHBhAAA......hABA...,2,-21,-9,12
VUBLGcWSAEfRPbOJFKTadXMeIgHNCYQZD,ECFCRAADOAEGFGBF..KDAEdBEH..MBIB..IDFBHDDECHFDZFGFhAAADFGDBDCGLBAChABA....WDADhAAAABFE.....fCHG.PEEBhACA.JFHFaAEH.hADA...,1,-25,-46,21
dUQLKaWfIYRAgOeGHBbFCSENMPcXZDTJV,OEEGeEGHHADFBFDDCEFE..EHDEMAAC..XAACDEAB.JCCFhABAVBCBdFABLAHFhACAKGHDaGBD.IDAFhADARGDCABBF............hAFA......hAGA...,2,-43,-12,31
ebPENgOGfdVHUaSIACTJKXZDWBMRQcLYF,TEBEKAADDDGBBGBG..QGFFLDCCFGGCPDDE.EAEFhAAAOAHBdBGHUABB.hABAIGDFCHFGZCADRFCG.eEFAhACA.NEAE...gADC..hACA......hADA...,1,0,-40,40
EGDeObATJPYCUKcHZMaVNdfBSIFgQWLRX,TDACJGEA..CBAB.UFGEKBEE.ZABG.MAHF..aECAdDEFBHEDhAAA.FDADQGCEhAAA..LBHHhABAXCCBEHAEDGBBeCGFAAIB...PACFhACA.....HFAChAEANEFE..,2,-29,-24,5
JFYTSUCMEAGbKRIeNcXDdWgHLaBZVQOfP,KGAHRFDFeDAD..XCCBdDEHHAACBEBHQAGB.OFHBhAAAfHCBFDCHSCHHhABACHHFAAEHGFEBIBEFhADANBAE.DGCF.LFFBZDFAPAAG.hAEAYAGD.MAIFhAFA.EFCA,2,-18,-4,14
SfebXTVWOdEBCaDFHcAPULKMYQZIGJNgR,UDACMEGFZDCHGDCF..JCHBRACDeAGB..TAGAVFGDdAAChACACEBG.DICGHAAG.AEECKGCDhAAAIGDC.SCHHhAEAfCEH.......hAFA......hAHA...,1,-18,-32,14
cCaeSGAIdPFMNRZbXBQVHJWOELKUTDfYg,dHBHFGFHRAGHZDCFBABDQBDA.HFGBOBEBKBAHDFEC...hAAA.gFAHhACAaBFEeDAD.AEAD.PCHFMIAEXDGGhADA.JCCFWAACEFDF....hAEA......hAFA...,1,-18,-27,9
EbNUHORGFeXaYVZIAdWgCQDMBTKfcLJSP,dHBHCFDGDGHFMCGD.KBADLCBA..JAFCSBGD.hAAAEBHBUCDBHGAAREACeFGFhABAaACHZEFCAFFH...gEAChAAABCHD.cGEENBBF...OADAhABA....hAHA...,2,-36,-22,14
dBNGbLKOaSMADURECIHcWfPTQYgFZJXVe,DEFAEDAFHDDB..fEAATABDQFBHFBCFZGBA.JHFCeHFAhAAABFGHGAEFKHDGaBFDhAAAMFDCACDH.CHAGICADhABAWAHH..gADB...hACA......hADA...,2,-29,-6,23
FWCeaRXMEGSIYZNABJTLQdVfDHKcUgObP,JEBETDCHLHBE..dHEFDGBEKBHFUFGHOFEG.FGBGCAAC.eBAAhAAARAFH...EDACSHFAhACAZAFBAFBABDHH.hADA.VBBAfGGB.gADBhABA.....hAEA.WEFC.,2,-36,-9,27
UNEbWgfYMOZSJTXcRDQFGdCKVaLHIeABP,UGGGEHBG....bDBDfGDA.MFCHODEC.JHFEhAAAXCBCDAGGFAFHCBCBKDGEhAAALCABeEDCAAHANCEH.hABA.gFFCSGAB.TACD.hACA......hADA...,1,-19,-27,8
WbOTceZLMYIPXSJDgBfAUdKVHFNQGaECR,dFHAVBCFFGEA.GEBDCBEE.RBEH.OGAA..TGBEZFEDMAAChAEA..IAGGhAAASDHHDBABBBBAAGGGKHAAQCFAhAFA.WBBD....hAGA......hAHA...,2,-34,-30,4
GNIWfJYLQDOeSdBHVCFERaMgPAKTXZbUc,KEHBXCCBZBCEUGDHGGAH...IEFFJBAHLDEE.hAAA.DIGCOFABeDABSABChAEA.hAAAHAFFCHBGFGGBRFDGMBIFAFEG....TEBAhABA.NAEF.fCBGhAFA.,2,-32,-17,15
fRQOdeUWgAHbYNPEKMcVXLaZCIGTBDSFJ,HAAD..NCCAKAHHMHAA.XCFHLBEDCDECGACEDAACFFFA..hAAA.JFHFRGDEdHAFUEAEAFAA.hADA..PAFE.hAEAEFFB.aHDEIDGFSFCE...hAFA......hAGA...,1,3,-42,45
EXKQPBFRNdTLZMHVGAbeOJYgDUCafIcWS,eEEGOEEG..JCCADECFUFAFCGAF....aHBE..IAADhACASACGKHDGBADAhADAFBFBRGFG.dHGF.LBFEhAFAZBAAMAEC..........hAAA......hABA...,1,-34,-41,7
QCJAMUEcWLgBRfKSVeNOPTXbYZIHDaGdF,UAGDEHBGLFADBACGKCDCeFEB..OFDCTBCD...XBGGhAAAZGEEHBAHaBBBFCGDhAAACDEGMFFE..cFAAhABAWEAE..fHGFSADENABF..hAHA......hBAA...,2,-37,-6,31
PJcbaBALfOKQRSTENHYFWVegXCGMZUdDI,LEEGKDCDQFEARCBDEADE.HAEH.FCADVGCGeDFC..CDFAZAAChABAdAABIHHE.hACAJGAEcAGBBCCB.AGGCSFADhAFANIAF.......hADA......hAEA...,2,-19,-18,1
JYZFHfRLGQeTCXNAWaKDOIMdSPEcgBUVb,aAFBOEAC.dBBAEEEDBADGUAAF..JFGFFDGG..HFDDRDAAQGBBhABACEEB.XBDHhADAACACKBHBDDHH.SGAFhAAAgGFA....bAEF.fDCFhABA...hAEA...,1,-27,-32,5
RPQfcTCAHVYOXdbGWUZLeBKSMgIJDFENa,HGFGVFDF.XACCGEAAUAAELBFDKDDF.MDDD..ICHChADADIACEDHBaFAB.PBAFhAAAQADE.hABATGGHCCDEAFGFdGCD........hADA......hAEA...,1,-7,-23,16
VAIHESZWYdfaKcPeJNGDMTQCUbXRLBgOF,HDAGEEHBZCCDdGDH.KCCCeADGGCGEDCAC.MBCCQGDD.CABA.hAAAbFFDLAGBBBGFOFAFhAAAAGFA..SGCFhABAWAFE.fHGDaEDE.PCEDhAFA.....hABA...,2,-20,-15,5
AEGZIQTaJVcLbNHXeRfCgWKBYUPMDdSOF,EGFHGEDHZDDH.QGAF.aADDJBAGLDAEHFADXBEBhAAAfABECEHFKDCFBAFDhAAA.UGGHMAHFdGDGSDAFhABAACIBICFF.......hACA......hADA...,2,-28,-3,25
MTHVdfWbKXDUEQIGNCgRAFPaLeBSZYJOc,FAFBLCCHBCADZEBHJBHF...ODFAMFFGHAEF.dAGF..hAAAbABFKGEG.DBBHEEHFGEAAhABACFED.AGDDaACAeFFHhAAA.SBGA..cGGEfDDAhAEA.WHBG.hBAA...,2,-27,-21,6
MCcJaUHeFDTRVEBIGZdfSAOXQLbWgYKNP,ODCHXDCHLAGB..bAEA..gGGGKGGCMCAGJEADhAAAaBADUEFFHGCGDBAAhABARGCEBAEFIDGDGACEhAAAdCEGADIB...WHFA......hACA......hADA...,1,-13,-17,4
JCfLFOIYXDMgZbVdQAceGPWNSTUEBHKaR,GECF..PCAFSHEAEFEHBACGKHCERBCH..CCHGLFHDhAAAFBGCOFAB.IDGDhAAAXAFC.DIEAMBAFhABAbDEC.dBEAAGCEeHAENBBA..TFGA.hABA......hADA...,1,-8,-32,24
CbQSceUALRVIMDfYNPJBOKWdEHGaZgTXF,LDACRGFGMDCC.DHGA....NADDBCGCKAGBECEGHEBFZFAF..TEGChAAACHBD..QEFDhAAAeEDFABAD.fBAHhABAPBBA.WAFA...aEEBFGEF.hACA......hBAA...,1,-23,-30,7
PFSYDEeXBaOKWMGbdCLAIfNRUQcJgVHZT,..IFDGfBFCRAFE.QFFG.JBAEHFFBZFBAFDCChAAADDEAXEAGBAFFOHFEhABAMHAE.dCBFADIFNIAF.hAAA............hABA......hACA...,2,-37,-21,16
GYWFeKSbJCVLDBOcPZIXMUNdQRETfagAH,HEBHGAFEFCBCSDHHJDHF.CHDHLFAABAAAOACEZCBDXGGDhAAAMAGD.dHAHQEEChAAARDDBEGFF.fGHEhACAADHBeABE.KAHF.DIAA....hADA......hAFA...,2,-29,2,31
HDUgCNJZWeAEGPFbIVYaLKRScQfBOTdXM,GEAHFHBG..IBDEaBECKHGE..SGBAQFEDBAAChACAOCDEdEGBHBCBDAGEUBAAhAAACFGAJAHBeFHD.ABGDEFBAhABAPFED.........hACA......hADA...,1,-17,-30,13
KBfMSXVRAUFLbaeIEJcQCTNHDYZGPdgOW,UGGDLCCHeCDFJCAB..CDHFHACEDAGGZGCEdFEA..OCGHBHBG.hAAA.SDGDhABARFAFFHGA.IAGFEEEF.hAAATCACNBAD...YFAA..hACA......hAEA...,1,-25,-31,6
OWGFNAecBfCEKgXVPaHQSYbITMURdJLZD,eAFBBFDGCEEBKEGB....VCAEaGGCSFCA..bAFGhAAAMDBHdACDZGCADIFGOBCBhAAA.FAGAAAGAfFGGhABAEADB.PCFC....hADA......hAIA...,1,-31,-39,8
NVMRgWCODYSLcHbaEPTfQXedFIZBAUGKJ,GCEBJCCH.MAACRGDG.CAFA.DBIBLEHDHADBEGBF..TDCHhAEAQEFAeDBDFHBCBCAEhAAAAEFBKBCD..NEIC..hAFA....WAFBSGFHaABE.fAHEhAIA..hBAA...,1,-21,-27,6
NfbJLeQOaKMGcYCZBHPXDIUFWEdVRATSg,SGFC..fBGAJBGHLABGeFEAOEDHaBCEMDBGhAAAGCACCHGHBDHG.hAAAHFCBDCFBIHBHhACAFFADEEEAdABBAHAB..........hAEA......hAFA...,2,-29,-21,8
DeTKHcdBNCPLUGXQZEOAYfaWMgFRbVISJ,aHBGMCCA.FFEERCCC....VCGHSAABDCBC.KCGDdAEBCAEBLCHBhACAUGFB.QDBAhADAOAAG.AHBE.fEFEhAHA.bFBEIAHG.eHEEhAGA.....hAIA...,2,-31,-25,6
CeSVOJRBFXGaIHMbUDcQLWfgKdNYTZPEA,SDABJFFCBDDG.FGBGGAFGHAGFMIACUCAG...QEFGhAAALHEA...WCCFhABAfHAHKDHBdDDENBCHhACAZAAAAAEE.CFAE..OAHFRGDEIHHG..hADADADA.cFEC.hAGA...,1,-4,-27,23
ORYcXIWLSKfAeDdQVaPJgZTBEbFCGMHNU,dEGCaDAF.JAFCZGAG.BCCBFBDC.GEFAHFBEUBADRAFB....XCDDhAAALEACSEHBhABAAFHCDAAE.PACAhAHAEEEBMIEG...NHDH......hAIA......hBAA...,2,-26,-26,0
HfTCRPNADSZeXMLbKVQWUBOFgIYcJdEaG,SEAEeBDGLFACKBAF.QGEHUBFEBHGFFEEE...IHAFhAAAJFCEdBBAEGEHaDCAHBAAhABA.CHHHNAEFAIBGZDDChAAAMCID....WAFEOEGD.cGBFhACA.....hABA...,2,-41,8,49
CJgeHBSADIRUVWNEcfQGXYOPTbMLdKZFa,RFDGVEFHEBCH...QDCAGAECOBAF..TFBBLBHHhAAAZAAAaBHHJGACeEBChABASAHBIGHHWHEGhABANIAF.....fADB.XCAGhACA...hACA...,2,-16,-11,5
RJafQGPLTKBIgSYDeAFNUZMWbVXcdECOH,UGBCZFACMBBE..VCBBdGGECBHHHAGH..JDDFaGEA.GABFhAAALCCCBEEF.IFHHhABASHDA.DACEhAAAAEHC.FHAA..NCAE.bBFB...EEHB.fBAEhABA..hAFA...,1,-18,-30,12
JYHGOeWdTRLFcbCVDMaNSEUBAfXgIKPZQ,XCBCKHBGQCGEHFDFGCEA.eHAETEBDFFAECAACDGGFMAFChACAaDAG..EEFHAHHB.IDEAhAAAZAEAODGDdACGRAFAhABA.LFHF.......hADA......hBBA...,2,-8,-8,0
VWERYPSdJXHcbeTANOULIFMGBZfgQCKaD,ODACUDACFGEGBCCFZACF...QGBBCBBC.DAAAEHGARADA..hAAASGFBJBGFHGAA.hABAeFHHAFDDLCEBhAEAGDDEKAHH.VCGB.......hAFA......hAGA...,1,-10,-29,19
LFHSfUJQCMXdZNYRaAWIPOcGbVEBgTeDK,..IFDGPEEGGACG..VADABAGFeCGHLGCGhAAAFBAEHDAFfCAAhABAJFHHMHACdHGB.NIBBaBFEABIFODCAhAAAEEAF.DIAE.SFFDCABA..hABA......hACA...,2,-18,-7,11
CJKVUTYDMAaIEZSdXGBLWFcgfHONPebQR,aAFBECFCdECCBHFGLAFC.FFFB..fAHAHCADOABGhAAAeEEHRDDFCHDBJADF.KBBF.hBAAUDGHDFIDAHGF..IEAChAAASHBGXGBC...cGGFhABA....hACA...,2,-39,-14,25
BNIbPCReVAULXFKTQgOYJdcGMHEfWaZSD,UDCHXAADFGEG.KGBF..QBDH.OBGDJEGFdFDFMFABhAAAHCFG.fEABhAAAaGCFDBAH.IBDFhACACHHHeFFEADBBTAFE..cAEFWDAEBAHBhADANBIE.....hABA...,2,-29,-14,15
QgFWPSKURfdYbBXVLeNZTHcCEDJOMAGIa,aGAHFGFC..SDAGRDAEdDFHBBAALDCH.eAFGTGGGHBDDhAAAEGCEDICG.MFIBAFFFQADDhAAAPABGfEGGhAHAXABF.........hAFA......hAGA...,2,-32,-9,23
SgXEaPYHeUIMNOKTCBDVLGdAQRfFZWbJc,REFHFCFCZCFA..JDBHSCCC..EHGEaAAFHEFA.IEDAhAAAMDEBODAF.hABAKAHFBHAFDACELGAGhAFAABBCfCCH.bAFA......hACA......hADA...,1,-28,-40,12
CWPQJRFAcfHOSeEIVKGLbZBdTXaNgUDMY,HAADSGDBEECAKADCLDAABAHB.dHGFaGECUAGD.DFFFCCEAQCGBhAAARDFC.AGFEOHBChACAVABEZCDBNFEB.MFAFhAAA...YFBF....hABA......hAEA...,2,-23,-16,7
SUeKMGRVLfXOIaYdZFCNTcJPHAEbQBWDg,QGBCBAEDDDDHUGFGeCBB.GEEBLCADOAFB.aHGAdBGChAAACHAC.TABF..hABAcAAFJHAE.AEHC.EEFAhADA..gAGBSEEFMIDG.fADGhACA.IDDFhAEA,1,-2,-42,40
feQgPNaJYdKLZCGIbUAFWcSDMHVTRXOEB,FHBGSHBGHAEARBAA.EGDABDFD..eCGDQGDC..hAAANAACaGGGJFGFKCGELEBChABACECB.bBBC.AHHHDDDGhACAMFIBXFAEODAB.fAFC.hABA......hACA...,2,-27,-5,22
VTfLFaJGHbUAYSKgBXdeNMCEcWIQZPORD,SAFBBFEDeGAECABEEEBG.....IEFEZCFGODBGDGGB.hAAAVAFATBAA.LDHHhABAJFHH.bFBEADAHKBCAhAAAdADGMDDE.WHCA.....hADA......hAEA...,1,-9,-40,31
KIDWGUXfPSVZdJFRMCYbETQgacHOLANBe,BAFBKDCDDFBFGDBD.UGFEXFEE..PCHBSBEBhAAAdGDARABD.MHCC.CBACEAGGhABA..gADGhAAAaCGAODGFAHAE.IHHGfHBF..hABAJCAB.....hAEA...,2,-30,-26,4
eWdCKMbNgTORJLcfaIDYXPHAZVGSBQUEF,VCADSBCG.BAFEQFBAUEGBFCADdDGG.MIFE..hAAAbFCGNCIG...OHAChAAARACHLHBA.fDEEhABAaHDAIEEDXAFAAABBGAGG.hACA......hAEA...,1,-15,-22,7
IeBNXcJHGKSRaOgWVbTUdEMYZFCfQPALD,LFCHDEFHBBBF.XDACHADGKEAB.RDCB.OCHF..VCGDhAAAUAAG.dCDEMBABFGFBQGAFhADAAFIF.hABAIHHH.cBFE...SBDEhAEA.aEFEhAFA...,1,-22,-43,21
MJSKOGNLFIWReYVdbCDQcBTHgaXAEZUPf,UCCBMCCAKEEGOEFDLBAB..FGCHRFBA.eADAdFHEDAGBBAGHHGDChAAA..aFHHEADCZCFAhAAA.JCADSAHFhABA.NDED.IABF.....hACA......hADA...,2,-33,-20,13
AYOdJagLPBXeHQRVEUGKFMcDfZTSICNWb,dDCDaDCDLEHDBFADeGFAHFEB.RBBCEAFGKFCEMBDA..DCAFZBAAhAAAIAAFCHCH..hACA.bBEDACGBOCHFhABA..JHAG.XBGA....hADA......hAEA...,2,-45,-11,34
DEBGcWeQJIUAfXPSbNZOVFHdMTRKgCYLa,XCBCSHBGZFGFOFFGHFEH..MCCCKAGGCCEFLFAA.hAAAaBHDBCHC.WDAHhABAJAAGIHAG.hACAfCFAPACEVDCH.TGEH.hAAA......hAEA...,1,-18,-29,11
EUDIcWgJHXPbRZTeaGdfKALOMVBFSNQYC,MBEAFBBDQEAG..EGDADHAEIFAB..gFFAhAAAJAAFHCCAXGGHhABAbCEGZADE.aAHFdGCAAFECLFCFhACABFECNBIACBAC.WADC...PDGBhBCA.....hABA...,1,-8,-25,17
WLOYNPZQXRVbETIdKJHDFSGcMefgAUaCB,UGAFCCEALDAAOFEA......PBACXCAERFGDEBFGdAEGhAAA.JDDADGABGGDFhABAMHDC.eBGDABHE..BEGChAAANBIE.ZECE.........hACA......hADA...,1,-24,-31,7
SBUPTdZHcGaYOIQNVLMgJWAeFEfbXCRKD,eEGHFAFBEHAC..XGAFREDH..KEADSBDAUBACdHGFHDFHhAAAaDBGOCFD.NEDC.hAAAMCIB.JDCBAEIBCABBDACEhABAPEEH.........hAHA......hAIA...,2,-24,-23,1
FWMcgXRAIbTCNLOPBQHeEaZSdfYDVKUGJ,TCBCCAFBLFEC.BACGHFEC.aHDGdDGFDDGCKFCDGAEA.FAGEhAAAMAAFXEBEAHHD.hABAIACHOHCEeEAFhADASGAF.YBADJDCG..WBCAhAEA.....hABA...,1,-14,-35,21
DZOSbCFWgHdXBNaMGULcPIVJTYeKQAfER,ECFCZBCFOGEE..CACAFGAAHEDGBEABMCEAUGGDLDAH.hAAAIHBGJBDB..hAAATBACKAFEAGIBDIDASHDGhABAbCFA.....gEEChACANCCAaACA.PAFE.hABA...,2,-32,-15,17
UXgeMKRHYfWLJPTCFNEIcZbBdVOGAaDSQ,SGCDXCCB.eDFGRBGFHGEA..fAFCLAFCPFCBhAAATBCE.CDBCFABCEDAHIAHGhAAAZEEABADB..hABA.OHFAAEIDDGBF.QEDA.MFFEhACA.KFAB...hBAA...,1,-1,-15,14
UGaFICXEDJOfVBPNYSLbgcTQedHZMRWAK,UBCBFDAFCEGE.EFBC..OAFBBFFF......NHEHLDGBhAAAbEDF...TDAHhABAeFHFHAGFMADGAEFCaBCChAAADAHFVGAE.SABFgGBA..hACA......hAIA...,2,-33,-20,13
bUQRMLPNDIBHJTaCGXAeYOVdFgcSEKWfZ,eEEGOFBBdCCFFDCF..SBACEAAF.KHBEZBED.QGFGhAAARFCGLBFGDBEFIDAGhAAABEFAJCHD.CAHCAEAHgGGEhABA.fFAA.MDIDhACA.....hACA...,1,-13,-37,24
CWcETJSKGReaOZXYIVgfDPUAdBbHNMFQL,BFEDHAADMGBCLACGCGHD.ECCE..JCDGGAGEeAGBZEEH..hAAAIHFD.fAAGhABAPEAEAICGNIEBWEHHhADA..SCHHaGAGXFCD.gCEBhAEA.DFFEhAGAdADB..,2,-28,-13,15
WICPdULYfgRKeZaXOQBVSbMAHNDFJGTEc,DHCEFHAEGBBAEFBH....IAADdCGEUFEGLFEE.hAAA....gAGDhACAeADCXGGHhABAOADDBBEHSCBHAGDENCAE.JDEE.WFHHhADACDEDfAHGKHEA.hAFA...,2,-34,-29,5
PKVUETQBSaFWegAICNfDMGbHRXJYLcOdZ,CFDGDACBGGEFHBDGJDACLBFG..dDGAKFAFEAHFQACBhAAABGHFFFED.eDAE.ADHC.IHAEhAAAMFEA...hABA..bFAA.........hADA......hAFA...,1,-29,-33,4
bQZTGWNdYKJDaUEefgFIBMOCAcHXLRVSP,XFDHLDACSHDA.QFGBGABGWADEdCGHJEEDhAAAaCGF..UEBHEFADeFCHhABAFGGEBAACOBCChACAAAHCRBDF............hADA......hAEA...,2,-24,-18,6
NZFegWCMSQUXcOETVJYGBAbIKPLfHdRaD,KHBGLGEAdDDCDBEAZCGB.eEDC..CGAH.QBABUDAF.OEABhAAAECGG.JCDEGEEChAAAAGDB..IGBEhABAfDGE.aACDNADF...FBAFMIBESAGEhABA...hACA...,2,-33,-21,12
FSbJIaMTgZKNDXVfQEGdPOBYAUWecHLCR,UDACeGEAHAFELCEGFCCC..SEFCJGAA.MEAATGEEhAAAKFAADIEA..VABGhABAEABCdCFDBHHGAHAFCBAGIEGEhAEA...aHAC......hAFA......hAGA...,2,-32,-19,13
EdUXeIJSBgQYKMZTCbPHRAFNcGDLfaOWV,FHBGGAFEDGDGLDBFaFEC..OEBAEHGE.UBAFeAHHIDHHhAAABADAQEFFhAAA.MAGHCBDHHGFGhABAAAFF.cFBCfABEWFFE.dDDE...hACA......hADA...,1,-18,-24,6
fWCKLRUPIJHeMaAETXbQGZgBNdcOSFDVY,EEHBTCGC..QDBGZCBBBAHDdFDGOFEEDBAG...fAEGhAAACGFCKGBDLADHhAAAPBHF.HBBCMIECADFEXGBFhABA..gEGGNDAGFEDE.hACA......hADA...,1,-11,-31,20
LEcKIfQXTDZBCJASdgHOYMabVRGWPUFeN,SAFBdCFCOCCB.MCDH..aFFGVFDCRAFE...GBAGhAAAPFAHFAHBLBAChAAAKHGEICEAXGGGDIEACDHGhABAAGDE.....YEBBWDHB.NEAEEACEhAEAfDAE..hABA...,1,-5,-35,30
BCXKUaDHbPZYgAOVcLWENIJQTMdeFSRfG,OFBBVFDF.LDGDEAFB...ICAAJAAFMEDE.FHGAfDCBhAAABHBC.CABCKBEHhADADEAA.HGCAZADF.AHHBNAEFhBAATCGA.SGAC...hBCA......hBDA...,1,-26,-29,3
fVdUAYBbIDMHgTOLeNFcRCGQPaZKSWEXJ,BFDGDACBMDFDHAFA.TBAGLFCD.FBADCFGDQDDAhAAAZGFG..SAEDhAAAEADA.JCDFdCHAAHDG..hABAIAHHgGDAOBGB.eFABNECA.hACA......hADA...,1,-21,-24,3
OBYWCQGFVUDLSbHeXEdgIPAJZRfTKacNM,JDACZGFGRCCC.KCGH..aDGB..MHBGBEHD.CHGG.QEFChAAAGAAFFFAADIAE.LADAhABASAEH.eFEFhAAAdFCFIFACAHAE.fCAAcAGD.hABA......hADA...,2,-42,-21,21
GfcZdRXVNCeDJEWHKaLASIbBTMFPOQUgY,SHBGBFDGFCEC.QAFCUAGGGABAZDFBRCCG...NBAC.DFEEhAAA.EEAFKHEAAHID...hABAIFBHMEHDOHDEhADAfGHEdGBECAEA.WAHB.LBBEhAAA......hABA...,1,-23,-29,6
dPWGZVNIUabeKAMfTcCJLXDOBgESQHRYF,TFDBCAFBLFEC.DGCFBBBA.ECDHSFBFRAEGdHGBGDACZBBF.hAAA..IDFDhAAA..bADHAHCEMICEhABAJHEE..OAHF.......hACA......hADA...,1,-24,-36,12
bDPFaIZdHTRWUGAcQCBeYfOMSJENgXVLK,CHHGBAFB.eEACODDGMAABEGAE....XBDEKBAGDBDAaEHBhAAAdDHEHGEE.RDFF.UFEFhABAACCFQGCAhABASECF...........hACA......hADA...,2,-44,-21,23
fGFbdaeWEBVRQOPUZcHJgXCKILSNYMTDA,FGAHdAFBeEFCBFGGRCBBQAAB.OEDFUAFCHGEA.JAAChADACCDCKEAALDFC.hABA.NIDDMAIFAHIB.fGHEhADAaFBC.EDBG......hAEA......hBDA...,2,-35,-24,11
OdcJgZSICVYQPEFGXeUBKHDLbfWMaRNAT,TGGDdDCDJCHH..ZCFFSCBF.CECE.QFAHFBFB.hAAAeADFBHECDGHDLEEEhABA.WADBaAAHAFEAhABAOHAAIAFFPFACEFDB.....hACA......hADA...,1,-25,-36,11
WXJEfFBcdOTGaHCLMDPgIZbSAVQNYKURe,QFDHKHBGUEBB.eEBB..JHFEfAAFFEEG.BDAChAAAdBHGOBBAaBHHHBCDLAADhACAMEHFDBGF.IGAGhADAZAEFADDE.NIBBWAFCEEGC.....hADA......hAGA...,1,-3,-34,31
PNOUFTEBeMGQKcSIdRVCXAgJDfZbYaHLW,JFCHZFDGaAAFHAAF.LBEG..NBDCUCEBEFFEBDEG.MCIDhAAAQDAG.SHGEhACAdEACCHEGADFGDCDFfHABhADA.WCHD.....hACA......hADA.FHACTAEC,2,-27,-24,3
DVAJYLHKNTGebMBfUWICadRXEcPQSOgFZ,JEEGLFBBHADAKBACGAAC.MDFFBCHDUDGBCFHG.RADD..EGGGQDAAhAAA.SGAFhABAFAGBDAIBAAAFNEEATGCHhACA...fCEAIHFH.XGGChADA...hACA...,2,-24,-23,1
BgYUMNXHVbFKWLPGfJOREdSDaAQIeCTZc,QDACeAFBCCDE.ZACEBGHDUGDFMFECHAGFFBHFKDFG.LCDFhAAAGGAHOABGdGGHDGAFaEGEhABAACCD....IEBChAAA.cGEE...NEEF..hACA......hADA...,1,-14,-29,15
CFQdWJcRNZfULIEMAaePYTBKVbDSXOHGg,eCCHTCBCKEEC.DGCBSFCA.OFBHGEGA.gAGFhAAACAAFFGFFQCFAhACAJFDF.NCIE.ZABCfAEEhADAIDADEFAFAHDDaFFABGFD....hACA......hADA...,2,-27,-14,13
VPUKfXFEYgLQdHRWDGcCABNTeaJISOZMb,TGGGaGDB..SFGAMDEC..PBADUCBHKAFG.FCEDhAAAEGBFLFAFQAGGhAAAdACDHCGFDFFECGEFACEABHHDhABAJABC.ZECAfDCA.YFADhAEA.WEFE.NICF.hAFA...,2,-20,-12,8
aREZUOcDAYgKJeGIWSPQXFNCMHBbVdTLf,KHBGGGCB.SBAAXDCG.FADACGHAHEFFBEEBdDDCLAFHhAAAaAHDZDBFOEBH.AFEAJABChAEAIAAA.PBFDhACANIEH..MAHFbFGF.fDHAhAIAEGAFDGIF......hBAA...,2,-25,-3,22
WfSLdUVcaIMYZQGFHOEbgTDKJeRBXCNPA,SHBGdAADUFCB...aBFDIHFDZABGFCHDHEDG.EBEHbBEEhABADGGA..eBDDRDAABHFAhAAACFGCAEABLDFAhADAMFAD.....YHAA...hABA......hACA...,1,-19,-25,6
NefWFYIGaLTcHZVBAdMECOUSJXDPbgKRQ,EHBGOEBEUAAD..SDGDDHDC....bDDHRAGFQGGDhAAAeAFFFEBG.ICBDhABAGDFG....hACA.TAEFcAGDHGAEBFADAEAHCHEEXADBhABA.....hADA.KDDC.,1,-15,-22,7
WTOESgNPdeDIaHRXCBbQYJcZUfVFGAMLK,KFAGTDACEADE...SEED..NBDAdEECIEHBRGFECDGC.hAAAQGGG.hABAYAGDZBEEfCBAhACA.FHAEMCAE.WHCEODHF.hAAA.eFAADAFA...hAIA...,2,-27,-16,11
KHOEVYDRPXAZSWTBfGMJNQUgaCIFLdbec,ZDAGTGBCBAGC.MCHDQADF.UFEE.CEDF.FFGHdBGEeBCChAAAKCBD.OFEBEGGE.hAAADFIBXDGAAICG.hABASGADfABFNBAE.IFCE.hABA......hACA...,2,-40,-19,21
VPKGagTHELbRXCZYDdNfOUcWSIFQBAeJM,MBEAVDAG.GDDG..aDDFTFAFLDFERCFEZACDdABG.OEHHhAAAUGFC...SADBhAFAIBABBHADhAAAeFCFKGFH.EAGDCFHB........hAHA......hAIA.DGEF.,2,-18,-18,0
MdTBFSgbYWNHVfELRJQOaKePXAZcGDICU,ZEBHGDCCCDFG.UAFEdADGBBFBFGFC..SCAD..bCAChAAA..NBAB.HEFGEFBBLHBAhAAAQGDCKEGGhABAXBGDDIGEMAIFYFAFfCEE.hABA......hACA...,2,-32,-12,20
eWfNRUGCXdEBQZMKSaVLJDHcYIgTObAPF,eCCH..NDHCGDEACBGHdAAFBHDAZBAGMEIBKFAG....VEFFhADADBAEHFAB.IAEChAAATAED.ACIBFAGD.hAEARECBEDAASFHH.JEDB....hAGA......hAHA...,2,-37,-9,28
DEYGROdHJFQKWMTLeXPgbUfcIZaVCNSBA,DGHHGEAHdHDBHBAHFGGDQBADKDDF.MDDCeEBH..XGEFhAAAPAEH..UAGChAAAfABDZEFECDGABFDAhABAEBDCOCHD.JHACLFADgAGAhADA......hAEA...,2,-13,-12,1
DNQZIbfMCgdSBXUKeFPWTVGOYAcLaRJHE,aDCDRDBGEBDF..DCCDQABFZAAG..IDHEMGCEdGHABFEChAAAKBFAFDHF..TBFEhABAOFEAAAFGLHFEhACAJHAE..NAAECAGEXFBC.PHBChAEA......hAHA...,2,-34,-16,18
LBOVGUJAfgcIWZFKYMaQdSXRNTPCeHEDb,...fHBHIHHGZCCEKBCC.MBIHaFAC.QEEFdGFF.hAAASFAHXEDBTDGGhABAeBBAEDAHDCADBHCFhAAAOCEG.........hABA......hACA...,2,-27,-26,1
TaCKGADRPQXfFWbLBcgZHJdYeMVESUNOI,RFDGQCGCFAFBLDCABAHDZAGDHBCH.dFADMBAGECAHUFGD.hAAAOFDBTEABCBFCKAADhABAAFFEDCCE...fHGFhABA.........hACA......hADA...,2,-29,-23,6
ZeXARHTYPECJDWNfKOBUIbGgLFaMSVdcQ,HBCDTCBCEEBH.DEHH....fDEFOBHFBBAHIADGhAAAbGAE.GGAFLAEHhAAAaGEFMFFCSGGAhABAcBEBeEEDAIGE.PDFDWFACKGGEFDAB.QBGAhABA..hACA...,1,1,-15,16
JXHBNIbMKTASCVFdDeUZWaPGOcgfRYLQE,CHCHVFEEDCAF..ZFGF..aGAFGBBC..OBAF.fADDhAAARFABLABCJCHBBGEGhAAA.IAHHhAFAMCCEAFAASDECFDEG.dGCAUCGA..hAGA......hBAA...,2,-26,-25,1
MGKLSYJQPgdRDcOFZEHUTAVWfBIXeNbaC,VAADBFDGeBAD..aFBAMHDELDAGSFGGQGDDhAAAdHAFRAEE.DAGHFDEDHEFGADCF.hAAAIHBE.NAFACGGDhACAKCGB....YAHFPBBCcEAHhABA.....hADA...,1,-15,-26,11
KJLXSAUfZBNPVWcOTeEbdgMRCQHGIFaDY,ZEFHBFDG..VGAEOBAD.ECGCdABGRACC.CFHEHAFAGDEGFCDBDIBGKHDAhAAA...LEBAhADAXGAGAGDA.UCCF.hAEA..PHFE...WDHH.eBFChAAA.MAFE..hABA...,2,-24,-19,5
FMcXEQeVIdOAGSUTaBgWNbKZDfRLHJCPY,SEABUFCABHBG.....NAAFKFFADBDALBABHCCF.JAFChAAACEHCFGBE.MIFEXCCBhABAQCFC.hACAIBBEAGGAaGFC..bCGBRADA.....hAGA.YAHHEEEE.hADA...,1,-10,-41,31
YNGRUECAbdgFcDHWMOVeLPfSJTaBZIXKQ,dHBHFHBGHFEHOCFD.LAEGSDAH.TDDBaGGCZCBAKAEGQECGhAAAGBAHEDGECABBACFDhADA....cAGAhAAADEHDMAIF.........hABA......hACA...,2,-23,-21,2
LdUYGBEHRaKVAPSbMFfTNWJcDIZQCOgeX,SHBGMHFGFAEH...TDDGJACFDAADQEAB.OGCChAAAXDECdEGDYBDAhABAGBGGEGAG.aDAGhABAAIHEfAGE.WCAGcGCFCGHBeFFBhACABFFC....hADA...,1,0,-38,38
VgKZSRNcUYdWLeBbJQEAaHCTPFfIOMDGX,CCAHFGFC.OFCDMBIBDAFEGCBH....VCDBZBFDSAAFhACA.REAFNCIEcBEFhAAA.dGBGeADCBABChADAbEEEEHEG.HEGD.fDBA.hADA......hAHA...,2,-26,-14,12
WNHDAJIEgCVFQTRLMBUeYXGbafPKcSdOZ,EDCDVDBH..FGFAREDHLHFCMFEH.BGAFeHAAGADD..hAAAbAACaCBGKDGA.dBECOBHFhABAZDAF..WFHBhABADDADJHAG.CACC.UAGGfFGF..hAEA......hAGA...,1,-13,-17,4
OcJMfBUGDPKZFWHeSXbNgQaCLEYAVdITR,VDAGTGBC..OFEAMAAGBCEA.DHGEKFCGZBCHFAFF.eBHFhAAASBGF.XDGAhAEA.NFAF.gABChABA.CCCBLHAEABIBIFFDcFGDhAEAJBBFfAEFhAHA..,2,-37,-21,16
NFeUAEJGIQXaVTCRDHLYcKgMOdZPSbBfW,EHAEGECF.QAABaEGF.CAECDIDALECEKAGB.MAADZGCESGGChABABHDAfAEChABA..NDBDeBFBhADAAGDBICBA.TBGE.YFHBhACA.....hAGA...,1,-22,-25,3
XWYASDbQLVZEIGNHKfPBUFeMCacRTdgOJ,SHFGDAFBQGECZBCHGAAEKDGG.BFEBFDADeBCFMFAHaCFEhAAARECFdBGB...OFFAhAAAXEGFABBD.bAECEDDEhABAHFCF..fGACCGHA...hACA......hADA...,1,-12,-19,7
ZaBMINAXTLWdQebGSEKRJCUVcPDYOfgFH,XDCHTDAC.dCGCQBCDGAACEGBHRFFDCAAD..UFFF..hAAAPAFADGADOADDhACAfEECFAFC.aFHFBHDDhADAIFCEAHIF.WHCA.....hAHA......hAIA...,2,-19,-18,1
eRTCHXNAISGKadEDJYVFPUbWBZLfQgOcM,GEAHdDABDACB.JAABFGEC..UGDABCGHLBGF..fAAEhABAOBDH.MDIBhADA...RGAACEDFXGAHhAAA.AHHDSCHBEAGA.PFFAhACAWAFFQEFEhAEA..,2,-37,-36,1
eHPFLRVXYJIQfMACDBgabTSGdWNUKOcZE,BAAHaHBG.SBCGGCDHdGFGUDGGOFAAZFCEHAEAFADALEHFhAAA.RBAB.XGEEhAAA.IDADhACAQAGCAIAGCEDADAGE........hADA......hAEA...,2,-28,-14,14
dXaOPYbDWVSUAMefBRQJEZFcCHgKINTLG,eCHDRDBHQGEFZFAGFBEHHFEBKACG...TDBGdFDBOBHH.hAAA.PABGDBGDSHAChAAAABFEMAIDBGGEJDDCCBAChABA............hACA.IHHF.hAFANAEF...,1,-24,-25,1
XALOSZRMFIEfCBVHbdWNcgQJUPKDGeaYT,SAABMGCEFBAA.EBFFBHDH.HDFDdFBD....NEBFQGDDhACAJBEEKHAADDCDaDAHXFGEhADA.AEADLAHHhAEAODHD.IBDAfDDACCCD.WAAEhAEAcGAC....hAFA...,1,-23,-35,12
dLWUSJbMGgQYOHKIZETBFeADXVfPRNcaC,DEFAVEFHRFAB....aDDFLDFE.UAACJAFDGABGQEAFhADAOHDEKAGFECDDBAHEhAAAAIGA....XECDhAEAfFFE.PEHDCBEGWHCG.SFHHhAFAMBAF...hABA...,2,-38,-13,25
ZXEAgJLBCFTNafQcIUGMbKOdHVPDYeRWS,JEEGLFCABEBG.TBFE..aGGEQCDGUGBH.MFAFhAAAKBAHdADAHCAB.DDIFRAFEZCCEhAAAAHBFCGHGFGFD.NABF..hABA.fFGF......hACA......hAFA...,2,-38,-13,25
SGNADMadPgJBcWOEQfYLRUXCKeHTFVIZb,aCBDdHBHJCEBBGFA...OGBAQGEDLBAEUEGC.CADE.eDEBhAAAHBBBFCFFZAFA..hAAASEHFACGDDGAG.hABAgAGD.EAEF.....hACA......hAGA...,1,-24,-30,6
XKLJHAOWCZefaGYBIQPgcSEUFRVdMTbND,OAFBZDBHaDFH.GEGABEGE.QGDD..PAABSADHhAAAFAEBdAGCbDAEDHDCKHAGhABA.JAHBADDC.CACAfEEGhACAIGHF.........hABA......hACA...,1,-3,-48,45
RKeAIGaUPJbSWYVgNTXOCLdMcFDEfHZQB,aGAHUDAC...JFFCSDBB.VGFETFCC.CBBCLHEGhAAAMCHBDFDEfEAGhAAAQAEHBCEAhABAKBEBABAA...IHBEPACF...YAHFhACAXGDF...hADA.dCCAEGCB,1,-22,-33,11
aTfYIRdLXFgZbWeKEOMPcGJHAQVSDBCUN,SDAFCAAHUEAG...aCFFTGFG..IFHDdGDGXDDAhAAAFFDFZACG.bEADeCAChACAKHCA.OAFC.hAAAMFIBcAGHJCFAAEHDDECBBCDAfGFChABA.RDEB.....hACA...,2,-20,-20,0
BPVbcSgMQNeOGaLUJfCHZFAKdETYWXDIR,EDABTCBC..XCCDDGDABHFD..VDFCSGGG.hAAAQCGAeGBCaACAJHCGhABAHGBAAHGEdAGEIACGhAAA.PBEB.cAEAMFCE...hAFA......hAIA...,2,-24,-17,7
RXCPEKAIQdDVbeWMfLZaFSJBNUYOgTGcH,dGFCVFDGeFBH.MAABZBCEFBHB.BDFGUCDE.OFDHGCAEHAGBhABACGHB.EEADABAGDGAD.hACA.fEFFhADA.SGHD......hAEA......hAFA...,1,-15,-49,34
EGSbYVQFNKHZOgRBMaAXWCTUdLfDIJecP,CHHGTFCAUGAC..LAABDHGA..IAEHeFEF..EAFDGCEEhAAA.SBGChABAbDFE.QCADhACAKAHFODDHBGADAHFA.WHEGdEAH.fCHEhADAcACE....hAGA...,1,-24,-30,6
TNBOPIecFMgQLZbCARJHXEdDWVSGUYfKa,RDBGHAEGEBHH.dDDE.VBABSADH.UGEBfFEC.hAAAaDGFTABEBECFIGHEhAAAFAFCMCGBLHAAhABACEAGAIBADDIH...YDAFKABC.NCFE..hAEA......hAFA...,1,-10,-24,14
TKDMLBJFOWaSCEIAGQcbeZfUdXVNPRgYH,QAGHeGEAUAAFdECD..NCCE.RGAEHAEAKGGADDGCBEGE.OBDBhABAaABC..CFAEEBDFADGG.hADAGDEE.bFCDfFEFhAEA..XGAC..hAAA......hACA...,2,-25,-24,1
WNMHCPYaQDgISGTARcXLJKeEOFVdUbBZf,XFDHKAABEFCG.FABDUACA.BHAHZAFB....fDBHhAAAMDIFCFFD.aEDBQDEDhAAADFGHSHBGAFHHLHEGhAFAeAEHODAHdAGB.NCHA.HBGD..hBCA......hBEA...,1,-14,-20,6
CHDWZdOQgNVIfKbLXRaAUFGBMecPTEYSJ,FCBBBBFDMCGHeEGF...TABGEFDASHGGCHDH.DDHHdEDAhAAA.OEABQGBHhAAA.VADGIHHChABAfDDHKECDbADFXFGAACHG...hAGA......hAHA...,1,-19,-33,14
EIYWNHAFLegdKDMTfQXcZbSBOGCRaVUPJ,LFFBdDCDMEGF.QCACZGAABFEFGADDaDFA..UGBAEABB.hAAAIAGD..hAAAWHEAAEDBeFHB.gABEhADATCGAfEHAbEDDCBFD.RDAB..hAEA......hAFA...,1,-16,-19,3
NEMJQHLXeWdVcFGKRgTafYOUBSPAZIDCb,DHCECFDG.EFBHMACB.HAFDLDEF.eAFDVEFFFABHREAB.aGHHOADDhAAA.BHDGABDEIDCGhAAAJCHF.QAGEhACA.WFFB...dDAEKBAFTDGAhADAfDEA.hAEASHAG.,1,-8,-24,16
fFMaIBTQSDReAUOEcWbJCPXZNYgdVLHKG,UGGDEDCD....bEGBCBGCZDFC....gFAHdCCELFBChAAAKAFBFHCAaABCBBHAhACASDDBeHAAAAFDcAAHhABA...JFFF.XACBNDAG..hAFA......hAHA...,2,-34,-24,10
USMAHeKLbDgNWVFOXTYZIPdJBaRCGQcEf,HDEDKGDBLCCEDDAA..NABD.FHAC.OEDEXGBGZAGHdGHAJFHF.hAAABAEG..RBFA.CDAC.hAAAQCCG.hABAfHEFSCGD.ADDDgABChAFAWEBG.....hAGA...,2,-30,-29,1
RgNEWbJQaTFAGVPBHZUdXcfYLMSIKCDOe,GEDHBFDDZBAFUACBdFAE...XGEC..fADDhAAALAAFIBGChADAKHGEDBIDOCGFRFBHEDDA.JDDAaAFBhAHAAIFA....PHBC.....hAIA......hBBA...,1,-17,-40,23
MceKOVRPJNYEgLXabZGQIWTCDUfAdFSHB,SDABHFBHBHFHMBFHKEFC.RABD...PBCEJFHF..EAHBXGDHhAAAZAFFGDDEIABGhADACADA..DDIBUFAFhAEAAAAFFDAFeDHH.NDDE..gGGGhAFA......hAGA...,2,-24,-15,9
OMFHdWISCREXQLVcTeJKNbaUfZPDAYgGB,GAFEMIAGFGEDHAAF.IEDHSDBDEEGALHDA.hAAATFEHKAGFaDGBUEAHhAAAfEDGDAIDAHAFBADChACAOBAGCHBE.QGGE.eCCC.hAFANCAA......hAHA...,1,-4,-19,15
YEXaUGDRCZNMfSBJFWgAdecQTILHPbVOK,eCCHQCGCLAHBHFAF..VEGDOCEHEACE.aAAAGAAAhAAACGDEZFFGMCDDBGCE.FDAEAIHATBFAhAEA.bEEBKAGChADA.XADEDGAB.NICB.SFABhAFA.WHBA...hAEA...,1,5,-11,16
ZFADHecLdVEXTWOgGfRMCbIJQYSaNUKPB,DGADHFDFLBACECFG..XGFBOCEFGEFCRBAFCDDF.IHCGhAAAQGBA.YBFChAAANEEE.KEAFPDAAhABABACAAHHC.cDFCTAFG.fECAhACA.MBIB.hABA...,1,-14,-17,3
YAVWFJQbEcLOIgCTZPdSUDBNXGaReKMfH,VDAGJCCH..EHEGLGAC..OCFHIGEACAAEZAECdGGFDDHDhACABBBB.GADChAAAaGHF.RAFCKCHDMIBAfDFEhABAAGDB..WCBD...FGAB.hACA......hADA...,1,-19,-37,18
bIeTafKMWLBOCGFVQYAUXJgZdDRHPENcS,UDCHXDACZBCADAAHHACB...EGGASAGCeHAG..fAGBhAAAKBHFLGDEhABACHECFEFCQFAChACAABBCJCFGdFCE...PEHB.NIBF....IAEEhADAaEDFMIFE.BBADhABA..,2,-33,3,36
WbJcDUGKPNQYFgSdHVOafeLEIMTZRABCX,BFFGXGGGJBEE.DBFDGBBC..KFGCQCGEFEBFdAAFOEDBhADAeBAFLEDBhAAA.EFHDTAGFAIAACFAG.hABAbBBE...cGAANIDF...gGDHhAEA...hACA...,2,-25,-23,2
ZcBPMGeafIdTUAYJRNHOEVXCLQgSDKWFb,JFBBRGFGHCDA.OADAEAAD..CDCF.QGCGDGAD.FBBHZDECBCHBhAAAMFFDeEFC..hABAaDADIAHB.hABAdEBFAHHBNCIC.LADCKGBF...WCCEhACA......hAHA...,2,-43,-5,38
fYHCWEGaRbIKNJZMSAPQdVeFgXUBDOcLT,dGFCVDEDeFBF.FDFBUCBHBAAEDAAC.LFAA..fCAFhACACACAGAEFRGDEIHHGhADA..KCHFNCIAZECFhAEAAAHE...gAGF.OBEBhAFAcGGE....hAEA...,1,-20,-35,15
LSbaUgRQeVKdZCIYAWDGfOXEBTNJcFPMH,DCECOFEFEDGG.BAGC..JBAEFDGGHEBALCBB..aAGCRFCD.hAAAQFFFKDDBCAEFAHIH.hABAfDDD.hACANDAG.cGGB.MDAD.UBDFeHCE.hADA......hAIA...,1,-20,-30,10
RdcYBOefAQWGgTMNHSbELZXUCFaKJIDPV,QFGHGAFEMBCHSGFDEHBE.ZBGBCDAGKDEFDBAE.RFDCdHGFBDBFhAAA.eAECAHFB.gDDBhABANAAF.bEACLAHBhAFA.FFBGaGDB......hACA......hADA...,2,-20,-16,4
PRIYZEDOeaFfBNdMgCbQVLASJKTHXWcUG,SEEDKAADHFCG..XAFGUBGFRDBDZGFGDECG...eAEHaHGEBGGAhABAMHAA.CDABQDFAhACAAAAAJABE.TBCFhADA...WGAGPFFA....hAGA......hAHA...,2,-30,-21,9
PdSNOVBaWFHEDXbeRCYTLGgUIMKZfAQJc,QDACJGEA.dABCOAHBBAEBaCFCFAEDHDEE.DADBXGFFhAAARCAD..CABHLGAEhAAAUAGAKDDDfGBEhADAAHIB.SEFG...hABA......hAEA...,1,-25,-38,13
MVfIcBCeJgSdOQEUNAXKRPWDHZbGaFLYT,RBCFDACBHGBEZADBGDADFFEC.LBFHTCEAMEIB..fGFHhAAABEBCCGAF..gDGFhAAAdHBFEBAFNGAFAFGAKBABhABA...PAEAaAHH......hACA......hADA...,1,-17,-19,2
GdPOTBcbgZVaYXFALERJKIWeNMCfQHDUS,LDCHEDBDRGEA.JACGKCGE..eFEGCFAEHADHDEGCGAAEdAGB.OBFEhAAATEEG.BFDDhAAA..gGADhACAaCCFFHBEAABC.IHFDMEIF.fCEEhAGA......hAHA...,2,-26,-17,9
TAZDWPCSUdecLFfaHJMQbEXGNORYgKBVI,DHCECFDGUEFEdDDCLBFD.FFABHCAG.MICGQFGAhAAAEGBGGACDOACHRBFAKAADBCGDhABA..IHAFhABAAFFE..WADCSHFE...hAHA......hAIA...,2,-39,-16,23
dTSYbgaEXWUHVDeQLBAOPINMGCfRKFJZc,OGEA..IFFFMAEGGDDHCDBCKGACZCCDdDAG..SCBEhAAA..YAFFhAAAaBGDEECB..XGBChABAHDGDDIDALHFAAADCPBAAfABFhAIAJAHF..bEDD..hABA...,1,-3,-35,32
JOZKRNeUBQIAPdTXMcgFWbSGHfLYDEaVC,TGBCMFFFFDCC..SBFGGCGEHACELFAFDGCC.EBBGCCAAJFAHhAAAZDEEKADB.RFGHeDAChAAABGGD.AGFE..XGDDhABAgBFF........hABA......hACA...,1,-4,-33,29
NHKePIMVYaUBGJRATZSFbXWCOgDfcLdEQ,SDAFXGBC.CGHF.OEBA.DDGALCDEdHEF.NDEEHEBFhAAAeBFCMEAB.aACChAAABHDGREFEZBBAWFGD.hABAfACH.cAGFKFDA...hADA......hAEA...,2,-27,-17,10
cMNQgGPCXJEOYfaBDULdSWZVRHIeFATbK,KGFCMCCAQFDEGEEHCHAC...ECACOCAHaEAG.BGHADBHDdGAEhAAASDDE.VGDAhAAAIABD.AHIDTDFAhADAcDBFPFAEJCDG...YABEhAFA...fCHEhAGA,2,-35,-15,20
gTFPLOcUaAJBDdXQWKCIGVSHEfbMNeYRZ,DGGDdEHAQFCBCFEA.GCBBVEAHHCCGEHAE..MBFG.hAAAeBAAZDGFgACHhABAFHFAODABaEEFAAHBXFCDhACAKHDAICHD.......hAFA......hAGA...,2,-32,1,33
HEeSYAGdacDRgBIbVPJMZKWFXUNfLTQOC,aDAFRFDGBCGA..VBBAMDBH.ZACFFEDG.UGFELAEE.QAAGhAIACDGEHFBBSAEEhAAAAHGAdCEADBIF...hBAAIAHGPEHDKGBGNEIA......hBFA......hBGA...,2,-25,-22,3
KCVYAdaRPTQgXGSUNeZJILWFEfMbDBcOH,dEHAaCFC.RCCG..QGCFGFBHUGGEZFAFLACEEAEA.MAAFhABABDBAHBEGCBCGAICETAGFhAAASHFG.eAHBhAGAIEEFfFFGDCAFKHEC.....hAIA......hBBA...,1,-2,-28,26
MKLNcPCZeadSIRGTXUHfVbBgFYWJADEOQ,OEACMBDHLACE..NDBD.CAHGZEBGeHDGdCHARGFE.GFEH.hAAA.XACCHBADbGAEhAAAgGAG.hABAFFGAYCEHAFEBDECAECGC.KAEC.aDGESHFAhAGA...hABA...,2,-19,1,20
CUNaKfZJPbTOEHIdYgcGQSDWMVFBXARLe,eFFCUGGGKFAGZCFA..JAEA..TCCFHDDBdBBF....gFDEhAAAQDACSABBhADA.DAFGhAEAWHEAFDHHAHCBLHAECBEHfAHC.OCFDhBAA....hBBA...,1,-21,-32,11
RUHdJNXWQDGYgIKZaOLBVAMcbPFeSECTf,MCCA..bFDFeAHDCAHG.RDDDHFBFdDHGJEBH..XGEEDGHFGAFGhAAAIDGAZADHODCChABABCAGABEE..FCAAEFGGhAAA.fDBF......hABA.NEAE.....hACA...,1,-17,-24,7
MCZPGQcWRFAdNfUJDeYaVgOEbKSLHIXTB,dHBHUCBCDFEBeFAA..aDFC..OEEBEECB.SBDBhAAALAHBXBBDBDHHCAEBZGFAhABAQADGRAFFAIGA.hACAfHGHJHAE.YFFG.gFAEhAAA..hABA...,2,-33,-23,10
INaAYQfOeSbMCPdgRBTZVFEGHWKXDUcJL,QCBCOEEG.SEGACEHAdACBBGBAZECDFDCFEFED..HAGHhAAAKBFEXGABDIDA.hABAUGGDLGFAaBBAAAAC.hACAfBFG.MBBDgCFAhADA......hAEA...,1,-16,-31,15
JDdcWYPHeNOKXSTAUGFIBaZVLREfgbCMQ,GCEBBFEDaDDELCBB.EHEE..gFFBMHAADACEdEEGhAAA....YABHhAAAeBAD.KDGASGHDhABAAFCCFGAFZBDGfADFbAFACFCA...hAFA......hAGA...,1,-17,-34,17
GAKeRVFXbOBCQDNZgTJEPLWScUHdafYIM,KDBDeDACFADDOEFABHHG.DIGAZDEG..JGFCLCHB..SHDAhAAAUGAHdAFF.aGADhABA....ICFFhAAAGABHAAHC.RBFAVECCCGHB..NBAAECBE.hACA....WFFFhABA...,2,-42,-13,29
CYGMIJEUfFAbKeOSRTLPNcQHgXdBVZDWa,eCCHODCHRGFELEAD..NBEHHGDEXEGFdDEHBFACZACCaBGHhAAACACG..MCID.EAADhABAfBAC.hADAAHCCKEFFSGGH.TGACcECD.hAEA......hAFA...,1,-13,-28,15
FXGTaKBJZUDCgPVbLWNeOISEfMcHdQYRA,XBCBTECB.BCFGUGCD.DFADCGHD....VFEBLACGhAAA.eBAFIFBHhAAAEFHBfBFFMDADHCDBhABAdCCFQDGEAFFE.FAHFKGGDZGAE.PBBHhACANEEBcBGD..hABA...,1,-1,-23,22
ZbJDEKIWLfOSCcYBFNQPAdTeagVUGMRHX,dGDDTGGDeDEG..aEBEVDBD..MBECHACBZDDDJAADDCIDKHGELABBhAAA.SADChAGACAECBHAGFBGHNIAHADHD.hAAA............hACA......hAGA...,2,-29,-24,5
UDKgNbCMQGELFZOBSXAaPHefVITdYRWcJ,aCFCHFDF.eGAC.VBEGdHEBRABA.JCDDDHGG.KBBA....bGAAhAAAMEBG.EAAFLFEGhABAZDFGSHAAhAAAXEABAFGDfAGBTAGE.WEAG..hACA......hADA...,2,-22,-12,10
RSDEGMCcIbNLefVPBYQOWKFgdAZTHUJaX,TBBHUBDG..aGEGRFFBDDIFGCBG..CAEF...IAGGhAAALAAEeBHFVBFCBHGFhABAOFBFKDFBFFABAIHAZECH.hACAXDDBMEIFNIAB.fGAE..hAGA......hAHA...,2,-22,-17,5
fTgCAdHOPKGebaWUMEBRZQLYFXVDcSJNI,dDBDHFDFOCFFKACBeBFD..aACBMFIFBHHHRAGHLCABFHAG.hAAADGGDJFAC..NECG.TEDHhABAAABA.GADFhAEA..WDDFEHFAYDHF...hAAA......hAEA...,1,-17,-26,9
KUeGOZLdFMJHIVgSNCfTWYXEBabQcDAPR,RDAGKGDDUGEBOBDDLBFG..FDAHHDFG..VAGFSADFhAAACFFD.TFADhABAXACFBBBH.aDDFQAAHhAAAAAFE........hAFA.PFBD..hAGA...,1,-17,-42,25
DQBNVLKdEWFbGIHAJgUfMYXTRaPOSCceZ,JDACUCBC.MIFA..TCGDRFBB.OGAASFDC.CFHCZBFEhAAABAEH.LEEDhAAAEACAFGEC.IGHFhABA.gBCE.fFFFhACAaAFC.eBFCDCAHNEEF..hABA...,1,-23,-31,8
NPXcgHUCJTGZWIDSbfLMVRFABdKEOYaeQ,BEFAEDAB.aCAGeHDE.QCEG.XFAAgCGGhAAACABBGBCEZEAEIGGEhABASFGELHCEhACAMBHD.FAEHKBBFNGBBcCDC.....hAAA......hADA...,2,-20,-17,3
YVfBGgCcWTEdeNXUPHDbaLOFKJMIARQZS,QBBHZDAGSABE..fDFHGFEHCBGG.TGFHECDGeHDEhAAAUFCFDFBHLAFGhAAA.KECCMIBGAFFAYEADhABABFCEcAGFNEIA......hAEA......hAFA...,1,-5,-24,19
gKIYSbEJXDLPdQaCMWRNfAUeHcOFTGBVZ,eADGHFDFFCDGBABEZDABKGEC..SFGDEAADDAFC.LCHDhAAAdECHCHDF.MADARCDE.fDEFhABAAIEGUCGE.OHAChACA...........hAIA......hBDA...,2,-42,-13,29
AFegQEKPIWUDcBSJNaGfdRbOCYVHMZXLT,eCCHEGFCKAGA..ICBCUCDBBFAH..SDFF.hAAAaCHHfCGEhABAdAFA.OCAHCAHFHFBCMECHhACAXGGEACIFQEEBDEABNAAD.bABA..hADA......hAFA...,1,-19,-30,11
WLMIKJGBCfDPdXQNZSRAUOHYgFceEaTbV,OADGHAADFHGE.EAGGaEDE....TECHVBCHLGFChAAAKHECJCGF.BEGGDEBBdAECXAGHhABAQCCDZCFASCBDhACAAIDE.gGBG..hAIA......hBAA...,2,-22,-21,1
HDdVceBfYSIWLGTCgFREPbKNaJXAOQMUZ,QAFHMEIBUEBBHEEADCCAdEEF..VACBBFAH.SCHHhAAALHEGGAGCCHHE.hABAFGAHEHDEPAAFKCAHJHAChACAAGGF.....cFFD.eACCIAFEhAAAWDDD....hACA...,2,-20,-11,9
cAPdEDfNGWBMZSTaIROJbeYXFKUgHQVLC,dAFBEHFGDHBGGCGE.MCFFZEGH..aBGFRGDAOABD..bEACeDDHhAAAFBCC.KDBFHFDA.hABAQDEACGBE.hADAAABENIBBBADH.........hAAA.SBBDhADA...,2,-25,-20,5
GUKeSLgJaBYIFHEDMQTXVbRdPfOWcNCZA,UECBKEEDeFAFLDGB..aBECBHCGFGGEDCBGMCDG..QGEAhAAAXABCRCAAdHBH.hAAA...fGAChACAOACGNBAEAEDH.SCHFYBFCIHHChADA.EGEH..hAEA...,2,-32,-26,6
FQWELNRZCaKUAHgPdIJMOfXcYTGbBSeVD,HAADdHBHJDEGODDA...XAFCTABGBFADSECGhAAADDAEFFCEQEGGhACA.EGCDLHFEhAAANEBACHHGaCCGAAGA...........hABA......hADA...,1,-3,-51,48
DRfYIgAGZCaWPUNbEMdTJOBcKLVFSXeQH,GCCFaBBD.UFBGEEFBdHBHOFFDBAGGKBGEFFCB....SACHhAAAeACGDIEARFGFIAEAhABAAFAHZBFE..CBAF.NIAF.hACAMDED..TDGC.....hAAA......hABA...,1,-26,-28,2
TUBOaMNQLHeJEIfcWZAPFCKbVSGXYDdgR,CFEDKCFC..SDFDGGAHDEGCdCHERBCBBEEGMBDA.LHFGHDAEEAAChAAA....IFGEhAAAWHBAZFAEFBAGXCCEhADA..TEAHOFHFNAEB....hAEA......hAFA...,1,-18,-29,11
OYAIQdKWRgMFPBcNZHVDGSUXbEfTaLeJC,dGFCKCFCRDBGFGDBBBDEZEEAHAAF.GAFC.UDAFEFEGTFAHhAAA.eCCGCHHHAHBA...hAAAICAG..hABA.gDGAMAIF.NHDFDFIDSDDFhACAfABF.LAFAhAEA.,1,-22,-30,8
aFbIfdKDGXZBgOcPLJeHYCAWRNSMQTUVE,RAADSGFHMDDC.QGAGUAFG.EEBDFGGA...fEEAhAAADFHHXFDBBEHEhACAgAEFOHDCLEAChADAeAAECDDDADGHTADGaAHFIDHAKAHB.hBCA......hCAA...,2,-24,-12,12
KbIYdWAPBCNgfVOTcJUZFRXGEMeLDHaSQ,CBBD..fFAFOFFC..JBDCFDFHGGBHeGBCLFHHhAAA.DCDFSDFChAAAQAFEKCDFYBBDhABAAEEBBAHGNEAE..........hABA......hACA...,2,-45,-18,27
dReEaKBPTFUZVMQSXbNYIgAGJHWCOfLcD,GGDHJFBBHDEHCBDHLAFEdAAC..EADCKDDABHFBFBFDZBAH..hAAAMFIBSDGAhABA..NDHC.IACFhAEAAGDHfAHADGIBaHBCPCBC....hACA......hADA...,1,-21,-37,16
CATUgdPEOQZYbMJfNRBIKcaeSDHXGFLVW,TCGCdGFCOCEA.ZACHMDFF..JEBCfBEHBHBD.KFAAhAAAeEEGSBABhABADBCH.XDAC.hAAAGDCELEHBCHBFgGGEEAEGYGAChABA......hAGA...,1,-9,-35,26
GPAEHWRfXKScbVTeagUQJYZLOIFMBDCNd,ECFCHGFGRBBC.KFCF.SAAC..cDFDTCBB.aAGFUGAAhAAA.JEACZDEFOHFGhABAIBFDBAFGCHDEdFAAhADAAFIB.fADFXEDF......hAIA......hBBA...,2,-28,-19,9
fHLgQcZCYDGNURBXSAIMKVdWEeFJbaOTP,MHFGKEHBdFDA..EEFHeCDAFABH...JEAFODCA..TBAHhAAAfHCFLAHFhABAQFAA.ZAEAhAAADECANAIE.BGFEADAE.WADEaEGD.....hACA......hADA...,1,-24,-38,14
QIPGDBfOTMbZCSKeVYEFUWaLgHRAcXdNJ,dGFCJDAC.QBEEGECDDAFGODDH.MIBACDGEKGCD..eBBFhAAAEEHH.UFAG.aADGHGEGhAAAAEGF.XBGAhABA.IBBEfAGBbAEC.ZEGB...hACA......hADA...,1,-10,-27,17
RcLMbCFWTXfeQJPYOEZUGSDIaNKAgHVdB,HGFGBCAHREBEMADDFGFB...TAACeCDC.QCFB.JAFChAAAPAAEOEDFEHGAZEAFhACAUGAH...DEHBhAAAIFFFaAFC.AIDA.......hAEA......hAIA...,1,-13,-34,21
LUcaYOJgNXAPKZQRFEHIeCMSbWDBGfTVd,KCFCQBBHEHGE.eHBESDDHDFFBBEBDGGBF.TDAFhAAAVEGBdADHLBAAhABAaAGEODEAJFFG.XECFhAAAAAGF..........hABA......hACA...,1,-22,-25,3
RJZIMaTYVeDBSdQFNKUXLECHWcgfbGPOA,RDBGJFBBMFAH..aDGB..VFFFBBDDdACDFAAF..UGCELFHBhACACBAE.HAED..hADA.gFEEhAEAbBFB.OCBC.AHEE.ICHF..hAAAeAHDDCFH....hAGA...,2,-30,-25,5
eUKQgEYMfcGTDAVPJFZWBHIadLXSNOCRb,VFDFFDCDBGCD.HBCCaDEA.dEGGLFAF..NACB.CBDAeABDhAAAKCBF.EGGCMFFH..hAAAfBHGTAGFAIAG.hABAPFBD..WFDHIDAD.SACChAFA..hAGA...,1,-26,-32,6
fVBFgNbIRXaHEKYQPLcDdZeSWAGTCJMUO,TGDHMIAGUDDG..OAEGBHHGFCAB..gFGChAAA.ICCHaGDAKAAGQAFFhAAAPBADcEBEhABADGGBeEBB.ACCACDHAfDGC.hACANAIE......hADA...,1,-15,-37,22
RBOMWNeGHYUZKAJFCSIdQPDacVLTfgEXb,CDGFSAFBdEAD.DGHDaGFALDAD..fAGBhAAAEEFERECB.BFDHOACCNICF.hABAHCDAUBBBKAADAIAGFDEFhACAIAHC.PFFB.....hADA......hAEA...,2,-40,-14,26
XFATVQGcSJbKUaYNDLeBOMZPRfIWECHgd,VCDBQFGH.SAGEKDGGUGAD.aCFGDBCC.BHFGZEACRCBA.hAAA..IGEAhAAACGHAHBFEdAFBACABTABC.hABA.JCAEYEFEeFFA.MBEA..fEAHhACA..hADA...,2,-30,-5,25
KLNCAbJMfYUdeZTXSQcORIaVFWPBgEHDG,MDEBUCBCeEDAZAAB..SBGGQEGDRFFA.aHGEFHDC.BAHFhAAAHFAEGEACLADAhAAAAHHH.JHCG.fAHEhABAYCFF.dCFFTACC...OCCBhAEA.....hACA...,2,-12,-7,5
bJBfEXcZRGWPVeIOAQNaSCdKTgMYUHDFL,aGFCSEHB.KBCFTAFE.MDBCHADDFFCFJEEF.BBAHhAAAXFADZDFFRAGF.PEHDhAAAIDAA.QGAEhABACBEGdBBDUEEFDDDF.......hABA......hACA...,2,-23,-18,5
UeOJVQTAXYdfLcGCNEPaHBSgIFZDKRbWM,dGFCLGEAGDDHEAECaGBFBDAD..SDBHFCHDKCBC.RBBG.MDDHhAAAeAEE..JCFH.hAAAQGBGADACfACBhABACAHE.NAIE..........hABA......hACA...,1,-16,-37,21
BZSbCKDdVJQYPaTHUfMWLAIXGcNRgEFeO,XFGHGAFERABGFFGEBEAAZFBA..CAHAdGACQCDD..aCCHhAAAUDAFMFCHAFFB...hAAANEFE.eHBG.SBAGhABADEGCJAEG..PFDB...fBDEhABAIAHH..hACA...,2,-41,-14,27
ZcJCeVHQNKTafbBMEXIDgWSFPdULOYGAR,RGFGZFDFCCBA.eCBHHDDEKGFH..aACCBBHA.EABADGBE...SEAChAAAFAFBUDGEOADDhAAAAAGCJCFC....NIAB.hABAfHBBMBFEXEGA..IHHHhABA....hAHA...,1,-24,-37,13
NHQOUIbdSJRGDKCfPLFTeEZWABcMgXVaY,BBFDMCCA...VCDHaEEGHDAD.OGBEIAGDdGGE.RCADGDFGhAAACAFFLABC.TAGAhAAAEHDAACID..XABEhABANIAF.UFABSFFDDIGE...hACA......hAEA...,2,-23,-12,11
YDHVIXbdJOQcgUaKNfBFeMCTWSPZLGERA,HFDGXFDHJCHB..OACGQAGF.UCGHKHAABDCHFCBHMGFAhAAACGAF..SHGEhAAAZEACGABBECFA.ACCBDIFGhABAIDEDdFCCaEEA...eAFCPHFChABA......hACA...,2,-16,-14,2
GCPabTADZUOcKEMLfgBRIVeNXFJWdYSHQ,DEFAUBDGKAGALHDCBHHG.RDAA...eBBBXBGBFBDA..dGAFhAAAHEGFGDDCCBAFaGAEAIFA.hABA..OFCAMIAG.hACA...IFHH.....hAAA.NADF.WCFA..hADA...,2,-42,-19,23
UXRKYMWJcdOVLfHZTFbPBSNDgEGACIeaQ,CAFBaDCDUCAA..RABFMCIF..JGFCOFBBLCFFZAEDFGDFBAHAhAAA..DCHDEGDDAHIH..hABAeFFEKHAG....hAAA....YEBGWBAD...dADEhACAfAGFHCGF.hAHA...,2,-34,-30,4
bfgHWTcGNAKFJdQPRXeIULaECYVMSDZOB,KEEDFEEDQDBHRFCB..ICAEaBBECDHD.MIFADHACBHCAhAAA..bBFEHAFETGAEhAAANBAA..AIGAJGFEdCCDXABEhABA.eGFG.EEAGSFAAhABA....hACA...,1,-10,-30,20
OKEWFMaJCGgUXcHYSfDeVBQNLTIPdARZb,RGFGZFDFKCDHFCBG..MDFFaCFH..GAGGUFADHAAF..fFAGhAAAeDHDBHAALFBBhABATAEF.dHGHAGDBEDCBhAAAWDAG..CDAD.........hACA......hADA...,2,-23,-22,1
gMeGBFPLCbZOHIJdYVNDSEKXcRUAfQTaW,QCGCaGFC.MDEBeCBBBAEHFFDDLEABCBBC.bAFDHFEFhAAA.dGAF.YEAChABADIEEKABCXADEhAAA..cGGEAGGEfDDAWHAA..hAEA......hAHA...,1,-20,-30,10
RcEeWITfgSNVHQDBAaPXZJdKUbLOMYFGC,XGBCZDEDdDACKCDELFFA..MEIBFCEDRDBBEGBB..IBAFhAAA..TAAFhAAAfHFB.SDAFhABANBEBVDBEDFHHBEHF..AAHGaHDGJAGD.hACA......hADA...,2,-27,-27,0
HAeLWSPTgEUcQVfNdZOBXCbGaRFDIJKYM,eEEGSDCD..PEAATFGFEGGAQDEA.fAHGhAAAdAACOBDECGAGaGEBhABADBBEJGDGKACH.MDAAhACAAFBBgAECUGABcBGA...NIEFBDGAhADAXCGD...hAEA...,2,-18,-9,9
ZBCQTUYJAeNMgXFREWLSDcHVGfPadbIOK,MDEBFGFCRBCELCGFDDHFHGFEGBDH..fGBBaEHD.hAAAdACBOCACZBAFBFEChAAACABCUEBAAHAH..eAFEhABAXAGASHEG......hAIA......hBFA...,1,-18,-24,6
LBJFCUTXNGWZQVSObaKHMAIefYgRdEcDP,eGEA..gGBCRAEAECCA.DBGHBABACGGEUACGTDEA.GEABhAAAZDEESAHDhAAA..aHAGKAEBAICCfDGDhABAdBBCcGFC.......hABA......hAGA...,1,-19,-31,12
ERBaODCQATeIHFGcWgYVNJSZKbXMULPdf,TDACeFBBHCFA.FBCHGDEG..gAGENIAFZDCB.XGFGhAAAUAAFdAGDfBEChABABGGCOCHDCDAAIEEEhACAcFAH.YEHH....hADA......hAEA...,1,-16,-18,2
LMKbefDQCgHVJBRTNEAaFXdYIOUGSPWZc,FFAAdGFCOFBHUBDAGEEH..SDDFZBADLAGFKHGCeDHFhAAADICA.QAGChABACHHE.HADCBBHFNEEGaBCChACA...XDAE....hADA......hAEA...,2,-44,-11,33
HNAWMRISgKZaTEeUCGQFPBXfYJLdDbOVc,MECGRDAG..IGEDKFBGZBCG..EEHDCGADQCGDBHAA..hAAAXABGJAFADBBEOEDChABAHGFAAACCSAFBhAAA.aEABUGGGFAHFPHCCfFBGhACA......hADA.LCCA.,1,-11,-15,4
KGFEQbHSZAaeBIUPOcdNCTXLgMWVfJDYR,BDGFUCBCODGDdEADCAAD.LHAC..MIBE..fDFAhAAADFFGKCDBFFEHbDDBHADChABA.ABHD.eADG.hACAIFCG.NBAGXAGB.WEHHhABA.....hADA...,2,-54,-12,42
JGBCOdRNTfLHAFIVYcXgUQaDPEbZSWeMK,FCFCVAAD..XCDHUFDD.DBBAEAGAZDAH..eBEGMICAGDCFhAAACEGB.dHGBRFFB.fFAEhACAAIHE..IAFHhAAA.........hADA.cEAFaDCHSCHBhABA,2,-35,-30,5
aTORDINcEZHWUALPfeSXMCQYKBFbGdJgV,LGEAeGEAMDCCCDFBKFCBBFCH.GDEHdAEA..JAACaACH.OHCChAAADIBC...IAGAhABAEEEEHDAEAFADSCFEhADA..XGAG...hAEA......hAFA.FEBBgBGB,2,-35,-22,13
CVZFSDMTbYRIegOadLQJBfHcXWNGKEAPU,CHHGZDDFDHCAMBAH....TBEERBGHeHFA.aFAFdBBC.LDGBhAAAQBEFBHBDfDCEhAAAXEDCNAEDEFFE.hABAABCC............hACA......hADA...,2,-44,-18,26
OcQfFKSMLNWUYXCgeVaTGZIdAJDBHbPER,BGHDHAADEHAC.REEF.OBABQEAFKHBALFDGUAGF.CBFA.eDDFhAAA.TCGCGCCFhAAAIBEBABDCDFAH.PEHDhACAfBHAMADF.NIEF....YEFChABA....hACA...,2,-44,13,57
ZbNfTRWXJYLagPQKDCAEHFBcUdOGMeISV,EEHBBCAHdDGBOFEAGACG..eFBESAGAZBEE..bAACTGAFhAAA.XFDEhABALHEAaAFBPGAChABADCGEACABFEBCMBIDIHGE.....hACA......hADA...,1,-3,-28,25
HQKPZLbMAOYIEBNWfdFUTaeRGScXDgJVC,OGEAEHBGBHFD....NCAA.dCAF.FDGCaCBD.GBGCSAEDhAAADABB.JFBCHGCAKABGLFFAhABAAFBHIBDC.hADAfDDCTAFFRDCE.......hAFA......hAHA...,2,-25,-23,2
RPYUMFfdcaJgASWLEVNeIKGQCZXDOBHTb,LCCHECFC.eBABKEDACCDBZCGBDIGABGBGHCAARADG..UGECMHDG.hAAAFAEG...dBHEaGCFhABAAGBE.SDADhACA..NIABIABAXCEA.OFEE.hADA......hAFA...,1,-22,-28,6
fcOZGLHXCQeKEJVAgTUFdYRaNIDPWSBbM,TCGCFFHBRDFF...aEBCDHCC...SAHBBAACMICEOFBAhAAALCCC.HFFHhACACDDDeBBBJAEGAEEB.dGCBNIDH.hABAWDAF..bBEE.....fGAAhACA.ZADE.hADA...,2,-24,-23,1
cJFgPaNVBLCESdbYfRIKXMWTGAeOUDHQZ,eFCAOEGHDDCDZBDAFGGH..aDHFBHAA.LDHFCEDHdHAH...hAAA.fFAEhABARADCKCAHMAACTDAGACCC..hACAUAGE..cCBAPDDENADB..SHFAhAIA...hAEA...,2,-34,-20,14
VLMKZeRBXgCTHIJafUAObEQYdPFGDcWSN,EDCDdGFCFAEADDGD...SAACLAHDMAAFKCDB.RFAD.BCBACBBDHFGBhABA..JDFGfAFAhACAAHGE.OBEHhADAbFCH.QGCC..PEBFhADAWFFD......hAHA...,1,-6,-49,43
gGSPVaLfeFXUHbcBWDCTENMAIQORdKYZJ,QDACODCHdBEAKAHHJHAG..GAEG..PEGHaHEEeFFGhAAAUGDAHAGHBHCCCACEEGDGhABAAGAE..RAAF...ZCCFhAEASDDG.fDAE.hAGAbAFBDDIF....hAIA...,1,-2,-28,26
ABeOdaIcHXFSbNGVYRgJUTfDMLQCWPKZE,BECDdAABaFGEHBBE.XAEASGABGEFCRDBH..UDDADCADLBHFhAAAQAEGCHAHKEEDhABAEHDA.ADDB.eGCCIFAEhACAFAHF..........hADA......hAEA...,2,-24,-15,9
IcfKUTJFgZYPHSMABNedDEbQGaLXRWOVC,BAFBdDCDEDGFGDFGLHFERADB..OCHFCGDF..IHAGhAAAKCAHTDCHJAGB..FABCZFBAhAAAHEAAAAIBDBAEQBDDhADA..aHBEWFFG.....hABA......hACA...,2,-30,-11,19
LYbSRfUKgPaQdHWNZAXEVDMcJIBFCGeOT,VBCFMCHF....JFAABAHAFGEC.eFGBLDDASEAC.hAAAUFCAPCAGdAACHBFDhACAZADAAGIF.DGAG.CHFEOHAChADA..........hAEA......hAFA...,1,-18,-43,25
WgTfEGRZbQCAHdMaVUBSXeJIKYOPFDNLc,dHDDaFEFBGGGSAFE..eABFJEBHKFFBOCCC.DICELCCChAAA....hABA.WEHFTBFEGDDAhACARFAHbDFEAAIHMBBEXDAC.....hADA......hAEA...,2,-30,-27,3
DPZfGUeOHNIBLaTQgMWJAcYdbERKXVCSF,dHBHECFCKDGBCAFE..FEDFDCCGZDBD..GDBEUFFF.eAECHACCBHGGhAAALAHDaGFG.QBAChAAA.MFIDhABAAFEBYBAD........hABA......hACA...,1,-20,-39,19
IXcVTLAgQYaJFUeNDRfBMbKZdPSOGECWH,QCBCJCCH.FEFBeBDBDGIF.BCGFMAFAZBAD.dHBH..SFBBhAAAOFECCAFC.IHGGhABA.XACFhBAA..cDGBVBGFAIEEaHFA...hBBA......hBCA...,1,-30,-46,16
MZIFaeYJRQEVXCAUdOBPSNLWKfgTHbcDG,UGGDBDGFSHGELBGHKEAD..TAACHCCBDIDAGAEFZAAFFBEFhACAeDCF.REEFEBDBVGAEhADACCHB..AFDB.dFEEOEAFhAAA..NAIE.fEHE...hAEA......hAFA...,2,-14,-11,3
QCcfWAFBVPOGLDTMNIKdURJbXZHaegSYE,BHCHVFDF.OCHHLACADGGA...TGGCMFBA..KAEAdAGHRDDE.hAAAJBBFZBAGHCGH.eECFhAAASGADEDDECEAA.hABA..fCEBAADC.FGFH...hAHA......hBAA...,2,-34,-8,26
RUAgZBEITNOYFGbDeWcLXCSaMQfKdVJHP,BFDDTGBCOBAD.FFGGGACG.eAADLFBDCCFFMFFEKAGHhAAAJDFGHACC.RDDEAHEEEEBEhABA.IHHG.hABANEAC.DCCB.WAHH.....SGHHhACA.fGCGhADA,1,-27,-30,3
CUMXYILKgVJFbQfSNPcRADOBWHedaZEGT,BGHDHFDFaBAAZGCEEEBDCDBG..UCGB..MIFE..XGGHhAAAIADEKGBD.gADBhABAFDGGQCCChAAASCDDPFABAAGF.OFFGdFAB.GAEEhABALFFC....hACA...,1,-14,-16,2
JbDORcVIUXYNfKESFGdLeQWBgMPATZHaC,ZABHCCAHDDGHRAGF....VFDDUECC....XFAG..hAAAYHEEKBEBFHGEdEBBhADAQAFCBAECMCIFhAGAAEFDaHAG..JFFAbABF.....IDHGhAAA.fEAGhAEA.,1,-19,-55,36
YUXPVHKZgcdSACIJWbFNLGDMQRfOBEaeT,CAFBJGEAFHGELDAH.GDCEMEBARGDABHAF..aAABeBCAUCGFhACA..XGBDhAAAHBCAKHAEZAFFdDACAEHAIACEhABA..NFEBDGGEOCEF....hAEA......hAHA...,2,-24,-20,4
UZgaeMTFdDNSAWLIJbRfcEXHBYKCVOQGP,LGEAJGEA.RCEGEECCBCFF.CBHH...QCAAGEBGUBBGhAAAaGCFMAEAdEEF.SBHBhAAAAAFC.IACChABAfADB..XEFCKDHBOHDChABA......hACA...,1,-13,-44,31
VSAWcJNZGedHMfROTbFKaUBIEXYPQgLCD,JGEAZEBHdFGGHCAFMAGHRCFD...OEABFFCFUADEBACG..EABEXDGAhAAA.QFDAhABACGADDBGGAAAF.NIAD..hAGAGADE.fCCEKEHBaHAEIDDFhAHA.....hADA...,2,-26,-22,4
CNSELBFVeJOWbGgDcQPfMTXHURAZdIaKY,ZDAGdAFBKFFECCDB..EGBBFAAC...eFHFOAAGGACEDEID.QGBChACAMFEA.TCFGhAEAUGDEAAIH..aHEANBCH.hAEA.LCFABEBA.......hAIA......hBEA...,2,-34,-24,10
aEQIOTRLgHVBdXfKJDcebSAYUWGMCNPFZ,UCBCMEAE.CHGE.FCFAZBGF..aFDB..QEFHOFFDLBBChAAAHADDBFAGdHAHKAFGDBADeFDDhAAAAIDE..WCAAhABA.....NEEFEFACICFF..hABA......hACA...,2,-36,-22,14
RgaNHOGYdIJVeMULCKZfFDWSBTXcPQAEb,ECFCRAAD..aGAAOEADdDEE...JCCGMEHHCAHB.ZDACDCADBGED.hAAA.TEGFXGCDhAAAQABFAIFA.bEEFhACAHBFH.IHAAUGGFKCHBFACCSHBAhAEA....hAFA...,2,-19,-18,1
UMHVGPXLgbOKFCEZfaDcBTWIAeQRJNdYS,QAEGRFDFdABCUGGG.MIDCHBDGGEEHLEAEODCGFAGCZFABaDABBBABhAAA..TDGFhAAAIGADAICA.NHDBSACFhABA.XCGEKADCCDDB.EEBE.hAIADGCC.....hBAA...,1,0,-14,14
LENAORaTFIQPMJBKeYdXfWbGCUVDcSgHZ,ODCHTCCB.FAHHQDAD.MBFGKEEBdEGG.XBDHhAAAfABC.bFFBCADCDIEAhABA.SGDGhACAZGCAEADBADGGIHHHBGACeBBFWFAH...hAFA......hAGA...,2,-36,-6,30
PdbCSIeAcYWZURMDHGNQEXFfVJBKTaOgL,......cFCAZFBGUCDE.MBAHDBIBHBEHGGEFEFGEFEBChAAAJDAFKCHH..aACD.hABALABDdAFHSHCGhACAADHH..WGAG......hAAA......hAEA...,2,-35,-30,5
YVFUERcLIGeNXdKfDQTHWOMCASaBbPgJZ,SEHBBFED..bCFHJACGZACD.FCHHEECF.RCAG.LAAFhACAGGEBeHCGdGHADECFTEEChAAAHGBGOBEFAGAE.hABA.PAFC..YFAD..hAFA......hAGA...,1,-11,-21,10
ZcTeXPBDISJQHUfaMbYFCREGVAdWgOKNL,dHBHOGEALCFEZFAD.eDBBBABCDDAFJCBEUFFH..MAGFFBCARDFAhAAA..EADAABAGKAGE.hAAA.NICD....TDEChADAIEDE.SGDBfAHAaGHDhABACEHG......hACA...,1,-27,-31,4
BgIfFHZTSNLaDdKREPeQMCOYJXUVbAWGc,GAFEBFDG..IHACfDBC.FFFBTBCA.LHCAhAAADFEBRAAFEDDCeBGFCHBFOHFChAAAJFECUBAEAHDB..hABAgADFSAEGNAIE.aDHB.dFAF.KGHBhACAMDAF....hACA...,2,-19,-8,11
EfYLDHWaICSFUQOTcbdXNJPKVZgeBGAMR,EAABLGEADGEH.HBAH.aDFGIFAH.FCGAOBFE.hABAcEDFXDFHPDHFhAAAKDDFZGAE.BHGAhACAAGBFMAFEfBEECFBBSABE...hADA......hAEA...,2,-38,-12,26
OaZBgTdFXDAEGbJURcfVLKPQeWSYHMCIN,GEAHJDAC.UAADRAEG...VFEDLFEGKDGH.QAAFhABA.SGAAhADAMEIBCGAFNBDH.OEEGBCDE.hABAdHDFDICAAFCAEEAB.fGHA..hAEA......hAGA...,2,-34,-24,10
RNdKEaOMVCQZHTSLYfPAJUgFXGWDBcebI,JDACFGFCGEAFBHEA.eGBARFAB..dEFEaAGD..OBAGMBDAQDEEhAAAZAFA.TBABhABALDHD.fFCHhAAAAIBC........hABA......hACA...,2,-43,-18,25
UHBTLVFgERcZfQWNGdXPAIOMDJCSabKeY,MDEBCGHD..aDBBeGCGUACGHCFH.TGAEFGCBRCEA.ZCCB.QBAChAAAGEEFdAHAAFIBDAIBhABASBAFKAFEBAED.hAAAgGGBEAFH.fDBAWFADNIDB.hABA......hAFA...,1,3,-26,29
fgIZLAHGEOQRMYTJCeDXWKSaBbFUdVcPN,GBCHEGDDRDAB.MAAC..TFGAJGECDDHFKCDGBDBCUAAE.dEGF.hAEA.VFAC..PHAEhADA...gAFGhAEAIDFGAHIBOFEFCAFFeHBASCGAhAGAaAHF..cDDHhBAA..,2,-28,-21,7
fTQdNFcMIEBRPUDJKCGbVWLZSeAYgaOHX,aHBGHAEG.TDABQAACFDFB.MCFEEDCEBHCDUEFGDBEDKGGHCFHEGCCEhACA..bFAELHFAhADA.SFAGhAEAAHAH.........hAAA.YBAA.hAFA...,1,-20,-24,4
HegZBCXSaMfIVDLQKEWJTUAOcYRPGNdbF,OGEARAADGAECdAEDHEBDZDBFBHCHCGGG..aDGBMEFA..IACAhAAADACHKFAF..EEDEJCDFhAEA.AFFF....YHCGhAGANAAAFBHF.XAGASHFA..hABA......hADA...,2,-38,-12,26
edScafMJAHLEPTYbNZQGBVFIXWRUDKOgC,HDEDEDCD.TBDH..NHEHZAGBBEHEFEFCIHHE.RDADDABChAAAKABDOBDG..hAAACGCGSBHFhAEAfEAAMADCAGHEYFAFbDDB.QGDChAFA......hAGA...,1,-19,-27,8
fBIFQLHbTWOgKYZCNdXESUcGMAeDRJaVP,DAADRDED..JCBBVDFABFCE..FFDELADHHCBD...TGGGhAAAgADC.KBGChABACACDdAGHEFHF.UCGCMIAAhACAAHAH.....PDABfGDC.hADA......hAGA...,1,-24,-35,11
CXUQcVKAGMRbBSZTaOIYHPDLNWeEFJfgd,RGDASEGDZCAF.OACDIAGE.HCDALAGB.NABA.hAAAeCHFFFBG.fGGBhAAACHFFUEDE.QABAhABAKAEGAEHCMAIFBHCD.aAFHDCAF....hACA......hAEA...,1,-9,-27,18
JWKFOAbTYeRfXUEIZCBVSMcHDPadQGLgN,TCBCeFBBRCCG..UGFEZAEHCGEBBEGH..VGBGMDAB..DBGCdCBGhAAALFFH.JAAChADAKGDDADED...YAHDhABAXEBC.IHHA..cDEDhACA.aACE...hAGA...,2,-32,-29,3
TJPBGaUgfZSACecbdDOHVMREYLFXQNIKW,CAFBeGEAdGEEHEAHREDGLACGFAAB...XCCBQCDB.KCGGhACAJBFGBEHAaBADUEAFhAAAZEFFACBGDGIFOHAA.MFIHhABAEECE...NIDF.TGCE....hADA......hAEA...,2,-23,-6,17
HgdZeWPAVUQKbYTXBJSOLFRCIMcNfEGDa,UDCBKGFC..TABEBHAHOAFGLEAGRGFE.CHAC...MGCAfBGFhAAADICG.HBDDhABAZBFA.eHDEADFDQABDhAAAXDGCSGBHFEHBIDAF...hADA......hAEA...,2,-28,-19,9
ADZcGPSRdXFfUHWKeOBIgaNVJLYQMETCb,ZFDGGAFESBFHRAAFdHEBFDDDUFAE.KADFBFFG...IADFhAAANIEB..LEHFhAAAMAIB.EBACTEGChACAAEFHDIBA..XAEBWFBB.OCDD.hAFA......hAHA...,1,-20,-35,15
XPeQZJYSLRVGNgDIafBOFcHCAWTEbdKMU,EGFCdAFBKBCAUBDD..eGFEZAAB...SEGGVEDGGEAADIBE.hAAA..aCHFBABB.hAAAFFCCCDGFAAIFTCEDMCCDXGCDhADAJDAE.....LAEChBAANIEDIDHGOHFE.hADA...,1,3,-41,44
HBcbVXZJLaMdPKIYGQAfWEFOUDNRTSgeC,EHBGFGDDOAEDUDAC..DIEGRGFE...SFFAeAGDHCCDBHADhAAAVAAFZDDELEABhAAA.dEEDIABHhADA.QAGCAIAG.fFDChAEA.NHEHCCEG....hAFA...,2,-34,-13,21
HcJAgWeMLTXDNSBGVEPKOUbIfZdCRYFQa,eGEAMIFGLDCBDCBABBFEGEAAEAAE.KEEDUFFE...bBDEhACAfAADdHCF.hADACECEFAHFaBHHJADE.AIAA.hAHAgCFA.XCAC.NEIG.hACASEEF.hADA...,2,-32,-14,18
MZCHIKNURYbcEOfTBLgJXSAdQGFDVPeaW,QBCBFACADFGB.eHDAMBFCHDEB.IGCAKGDGUCCGRBFD..hAAA..bFABEGABfCABhAAALDFEJBABSEHFhABAAHHE.dAHA.......hABA......hAFA...,1,9,-44,53
STedIgMXRCHVaAEDJKFBPbQLGUZfOYNcW,JEACKEHBBBAE..QGEDUCEFZDAD.ODGH....hAAANIDF.SHBAhABAdFFG.IHHHMAFERFBHCADDhAAAVCCE.EADEDACFPAHF....hACA......hAFA...,1,-30,-43,13
dLUfaXeCDWNISPHVTGORBJbEZcAMgFYQK,MHFGFHBGQCCELDADUDGE..XAGCDHBC.IHEAhAAAPBCEHDEDGDFChABABABGEEAFABDAKAHBfABHhAEA.CCEASFBAOFBG..hAFA......hAHA...,2,-27,-21,6
dKLVEQRMAfcBPOgFIDaUeNWJbCHGYZXST,BFDGOGEAFCABDAGCUFAH..eCGF.JHBECFGDHABA.ZBFFTCAAhAAALFHH.QDDFhAAAMAFFAIHAPECEhABAaBHF...NEAE...WHDE..YACHhAEA.SBGChBAA,2,-36,-25,11
BbAWHXZPYVFLNfJGURKDMcCIQaSgOEdTe,XFDHZAAD..VBEHFFADLCBA.JFFARCCBDEAA.MICChAAACFCAQADHhAAAaFGEOAHFTCFG.BHHAhABAAGAB...WDAGPGBG.fACChAEAKAFC.SFFFhAFAdCHA,1,-25,-36,11
XWfRFEaKLCgSDQUHZNMdYTPVbAOecIBJG,OEEGeGEABDDGGACG..XDFDRFAAFAHBEBAFaCFB..CGHHDGFAhAAAUABD.ZAGFdHDBPGBAhAAAAEAB...IEBGhACAWCHH.KAEF........hAFA......hAIA...,2,-30,-26,4
TPIFAOMKXbSWRNgeBCaGcDHUdZJLYfQEV,KFAGSGFCRBEH.eFABBGFBGECEDACGdEHGJAADLAHD.hAAA.QDAAhACAEBAH.PHFEAGEBOEBGhAAAbEFA..NCCD.CBDAaGDH.......hADA......hAEA...,2,-40,-13,27
COBZGFgbQAaYPXTMIJURWKVDHESLNefdc,aHBGXCBC..TCAFMGDA..UADDKGGFDDEDHEACLBGFhAAAfBGHdEADOBAAhABAGDEBFHAE.QAADhAAAAHIHIFHEWFHB.SHDEhACAcFDCCFFCBGAC...hAEA...,2,-23,-9,14
cSOdaMPDAZQGETWgNHLVIKRFbXCefJUBY,QBCFEEAB..TEGH..gEEFHCBALHBEhAAAIBHGFCGEXAGChABAfGGAUGGFBHEDhAAASADAaEACDAGCAEDEWABDKFDECACC.JDHF.cGBAhACA....hADA...,2,-34,-5,29
CWFTJBUNfLePaMXQAgdRGVHOKEZIbDcYS,dCFCGCBDOCCBEBEAZABEDIGA...SDFACAED.FHACBBDGhAAAUFGF..NBHELGAGhABAaCAHXBGAAGFH..hAAA............hABA......hACA...,2,-55,-21,34
fCATFceOWNVSPDGZUILQXYMbdEKJgBHRa,FGFCeEEGOFCD..VFDHDBHDZEEAUBGDLDDCQACG.hAAAMIFEdFAHECAA.KEAChABABHAAHACAaFAGCHAHAIHA.hAAA............hABA.cCBCSEHBhACAIGGF.,1,-17,-26,9
RaUMcEVFWOCQITgbGYAeSZXPdfJLNHDKB,eDCHXCCBdAHGLBAFHADGDEGB.KBFDaGCAUFED..EGHHFDGFOHBChAAA..ICBAhAAATCAH..GBGAhABAADIHSGBAPEAHfEDFBFABMFIF.hABA......hACA...,2,-31,2,33
IaZQENeWOBbYSXfLUdKMTJRGVPACcDFHg,CAEDDGHHFABDHGDA.aCCFEGEH....eGAABGBHSAAFhACALDHFKFDEMBFARDAGGAFEhAAAAFFEIFAG.NAEB..hABA.WDCEOCEHXGGCfDAH.hADAdCFF.....hAFA...,2,-32,-8,24
CDdfHBKXNFMGRQVOIWYULbESJeaAZgPcT,ZAAD..gDACTAEECFDD.DFBGHCDEBHBEKDBAFGHFREFF...QABDhAAAIHBGUAGEhAAAECGBeDDGAHEH.dGFGNEAA.hADAMFFA.OFDFLDHBSAHBhABA.PADA..hBAA...,1,-6,-15,9
KWIPGYFOHBLERXZgSbcMdNJUCfQeTaAVD,DGDEKHBG....IGEGPFBH..GDDFFFABBEDDRAAD.ZAEDSAFGhAAA..hACAcDGANEAC.JFFCfHGFhADA.eCEEaBADABEHYDHBhAEAOCCBLAAC.hAGA...,1,-26,-33,7
MYUCceEXDSdafVOTAGbZPLFJWHQRgNBIK,GEDHZAADLEEHJBCHHADDREAGBAHE.KBGFUGEF.CDHF.ECHHDBGHdHGBhAAA..aHBGOAEDhADAAGAA.FDCGQDAGhAAA.IBAEcACD.SAHFhABAfGAA.....hACA...,2,-23,-17,6
EefCbZAIYQHUJXcdLVKDGPgaTBSOMNFWR,QCBCUBDG.JFACXAAF.LEGBDDIBGGEFaGCCBFEAhADAMDEA..NABHRAEAeAFGhAEA.CCCCAEEC..IFEHhAAA.YHAC....hAHA......hAIA...,1,-29,-39,10
WEgFLafZcYVGNHQIeJUbOCTPSKRdBAXMD,DIBGEHBGFBFHLDCB.ZEEFVDCBHAFE.QEGH.JBBChAAAOHEA.CAGFTBBHhAAAKCAFBEBDADAGMEADhABAWABE.aFEE...fDHA..hACA......hADA...,1,-25,-34,9
dALgSaMEHTDPNKWceORbFVQCZfJGBXUYI,SDCDEHBGDIEC.KFGFeCBD.RGFEFFDEQACD.CGCBJAFHhAAAGADG.BGAFXEDBhABA..IABHhAAALFHBaEHBMBBBPAFEcGAH.bBGDhACAfCGA.hAEA...,2,-28,-24,4
aQXeDPAVOLESCfJRKGcIZYMgTbdBHNUFW,LFFCEEHB.CHDARFACKBBE.GEDGZCCC.MFAB..TGGBhAAABAECHGFGUAEFaCABXCEBhAAADIAA.ADACSBHDhABAJAHF.IDCDbDBG.FFBB..hACA......hADA...,1,-19,-22,3
VLdMbYEUDgBcGJIefNKCRWHPATZSXQOaF,SDAFXDCH.OGFCaFHF..LBAAdGBHMDDCEGAGDBCCBBFBhAAAGAGE.eECChAAANAECCHGFRFEA...PAHFhABAADIDQEFD.......hACA......hADA.FHDC.,2,-20,-19,1
ODSgKdWFAIMPZcYLfERUVBGeHbTaJCXNQ,MCCAZAADLFDBRAGF.UGGEBAAEGACCeFFEHFBE.aADGJCGHhAAA.CAFA.QCAGhACADGFBKFAC.dDDHAHCE.IHHDhAGA..PCEDfHEB..hAIA......hBAA...,1,-19,-30,11
GTRBIUKcfDeJSMANaFQOHbVCXdZYgPLWE,aAFBFGDDHCCH.CFGD.XEGFdDGFZABC.....PDCCEAGFRFBFUCAEhAAAKCAHDFGF.SCGChAAAABIFOHFE...hACA............hADA......hAEA...,2,-46,-21,25
RFVAQfJDPbEKCYeSULXIWOZGdgTcBaHMN,QDACJFCH.DGFFEFEFKCGACAEC...eEHBLDEC.XCAHhAAAIAAFOBFEhABAdCDFTFBFBGAEMIFAhACAFAEEfFFD.YHAASFHBhADAZEDB.cBBFaBCB.hACA...,1,-19,-30,11
eTbNEdXIHCQRMGUcAPYafSVWBJLFDZgOK,aHBGSCFCBEDCLEHDZCBFKGAB..eEEF..bBAGdGFDHAEChAAAQDGDMDGF..hAAA..cDAGAIHGYCAFhABAWCEH.DIDAOHDCNBBFEAGE.CFAA....hACA......hADA...,1,-11,-21,10
SRJTXIfHMFbOQYZGDUBWagANVCPKeLdEc,CFDDeCCHdHAD.EEFARDAG...JAHB..TABC..IGAFhAAAMGFCOEEEQEDAhABAZADFGAGEUGGCBBBFhACA..aAAHgBEBABFF.NADF.KFAG.hBAA......hBDA.SDHH.,2,-17,-7,10
YBKFOSeZIdCgVcUDHPEJXNaQGMTRAfbWL,...fCFCbFDFLAFABEAHKDAHOBAAeAAEZCCCdDCFVEFChAAADHGGHCGF..PHBEhABAEGCHXGAB.hACAaGFGMAHFACFC.FFBECECC.cADE.NAIE..hADA......hAEA...,1,-6,-11,5
BZgGeLTJfXCQPaKAEIVdDRYcFHMUONWbS,ECFCVDAGDDBF..RGFE.FECEUGCC..OADC..bBBEBDHGhAAAZAGH.eAFELACEhAAATGFEJEEA..fFGDhABACEHB.aCCBAIAA.......hABA......hAIA...,2,-34,-21,13
degcSXDaBTWJKYQGELMNFCAfOPRUIVZHb,OGEAUFDHZAEFHBEDdABA.eEHB..SHAGDDBHBBHEJGBAKBHBGDAChAAAEAAB.MEDAhADAFCDHAAGB...fACChABAIGHG.........hAGA......hAHA...,1,-26,-35,9
KMLDARGEWVITBOgSfJbacZQFCNUeYPXdH,GBCHECFC..IHEFBACHSEEA.JAAFbAAFZGDACEBGeECHhADA..YHAAhABAdGGAMEFG.DIAEAFAB.hACARAEC.TCGFfCCBaFBG....FFGEhAEA......hAFA...,2,-24,-15,9
SYLEfNODeVZIPCaTUJQgAMRFKcGBWXdbH,FAABGEAHBGHDdFFCHCECSCCGLGAGEBACOHCE.DFBGVADEhAAAZAEA.CDGA..aAGFUCBEhACA.JEFFAGGGKEHH.hADAXGCE........hABA......hACA...,2,-25,-22,3
cSZbKIVCYJHPFEXMBfLUadReADNQTOgGW,DAFBQCGCOHFAGCEDSFDB.KDCDCBHDHDAHFAEF.MHAEhAAABDAHUABGaFGFdGBEAAGG.hAEATABE...hAIA..gAGEZECEIEHFJFFHEDDE.hBAA......hBBA...,2,-22,-10,12
HAdLFMWQGeYfbRUVBIOcDCaENJZTKSPXg,dEEDMEGFGGDF.eACBfBFHUGADBEAFOBAG.CCAGEHEEhAAAJCECKAAB..PCCHhABA.HFAB.FDGAhACA.QEDEYCCF......hADA......hAEA...,2,-36,-13,23
eICDdcPSLBAZXgRbGFQJWKMEaUVOYNHTf,XFDHRAADFADE..QFGEKFFA.EDGEUCDG.OAFEhAAAHGCEeDCGDDIHdBBESHAGhAAAADGAZEAC...hABA............hACA......hADA...,2,-40,-24,16
SLaQgXBOKHWJRZfGeDUVdAbcTNPYIMCEF,TCBC..NCAF...ICGHEDAALEFGaADE.QGCFhAAABGAAHGFERBFGfGGChABADEFEVECGAFGCcBABhAAAMAFGCHEHSDDH.OABEWHAA.hABA......hACA...,2,-26,-10,16
ReLaEgQcACdSXBDFUKYfGNMJWHPIbVTZO,CEFASFAADFAH.FGFCUBCB.KHBCGBDB.MAABJHFG.HCABhABA.IAHChACA.bEDGTBFD.hADAOFBGeDDGaEHDECAF.......hAAA.cEGEAHDDXBBBhAEABBAF..,2,-59,7,66
NOGFHAVeKUZMXgJcaLYQIRbWTECPBdfSD,VDEDKAADMCDD..JDBBLGAC.QBECRACC.TGFAhABAEFHHCGDGBCGE.hACASGBHDDAAOBHDhADAFHEEAEGDeFEFUAAE....gAGEhADA.....hAEA...,2,-27,-26,1
aZLeRVbdUQSWEAXgPHfYDNCBcJGTFKOMI,XCBCHAADDFDHBAFDGDGCKDBB..MFDBZDDAeEADRAEE.dAHEUEEGhAAA.QGAAhABASHFEEACAAFIBPADDhAAANIEBCCEC...........hACA......hAGA...,1,-12,-28,16
bOKdUFXaeRDPgAHMVESJTZQBcWNLfCIGY,VFBGEEED..SGFAZGFEBAGF...NAGALDCECAHAGBBHOEDGhAAAKECBdBAHFDAD.aHCAhAAADADE.ADIH.MDIFJFFE.hABATADF..WCADIHAB..hABA..bCEE...hACA...,2,-26,-17,9
OIcXWGRgTNPSBbMLefdAFHKYDVUZCJaQE,FEHBHDAGDCBFZEEF.aGCAEDFB..ODFG..IHCCXAGEhAAAGEAFRACH.TABChAAA...SCDChABABHCDMFAHfGHAAFIDKBAB...hABA......hACA...,2,-34,-21,13
dMYWLEINGQKTZCbJcAfBHPSeOXDFURVag,HDBHeCCHOCGFDAGHFEEGUACGRBEH..aCAGMIDELHBG.EGFGhAAAIFAC.QDGGhAAAKFAF.TGGChABACAEF..........hAFA......hAHA.cFDCBABC,1,-21,-27,6
LPXcAJGYEDHUFTQKbVMOBISfNCWegZaRd,GECFEHFGDBFD.HACBUEEDFBGC.QBAEKDGE.MHDABGACSAEChAAACAEC.eDGBhABAaCAEdECAPHACAIBA.hAAA.JHCA..........hABA......hACA...,1,1,-49,50
bXVdETCQLeSRPfMWJANcHYDOKGBZaFIgU,HAADDEFHKADFBADEZEFB.FAGE.UDEG..VEAHEGHH...QBAHhAAASGCDRFCF.MCCEhAAAAHHA....NBIG.hABAcGEB.OCAHIDDAXDGAhACAdAEACHAD.PFAD..hAFA...,1,-25,-27,2
QGNaVgLRYHWfOZXSFDJcUTPCbMdBKAIeE,EDCDQFGHGBEC.aAGDLCAB.RDGHHGBAfAABZAAAFAGBhABADADBJGEATFCA.hACAbEEBMAIFBCEGAIHG.IAFDhACA.NEAC........hADA......hAEA...,1,-4,-15,11
dReSOWGXIBMFPNVZJQgUabLTHKCEfcADY,DGHHdCFCSFGDGEBCBDDAFEBD..VDFAJHBC....UBABhAAAaAGDLBADKEEF.hABA.CFHAEAGBADCGeBCCOBDHhACAXFDF.MAAE.....hADA......hAEA.NAIE..,1,-23,-32,9
PGcLMdFaXNYREeHOBKJDVTZQCfUgAIWbS,..IFDGbDAG.GGEBMEFCFCGE..aCBEXFGDRAFF.hAAAEFDDOHAGBFBGKAAChADADAIFTDEBCFFBUBCFAHAASFAGhABA.cACAdAGF....hAEA......hAFA...,2,-26,-17,9
JBHIYMELgKbRcVaSFQTZGONXWADPdCUef,DGHHCFEDUCFFeEFD.BADEHCBF..MDDCLFABKAHB.RACGaFHBSHAGhAAA.FCAHQGCChAAAGGBHOFBGhABANAEFADDG.dAGG.IEGEYBAD.bFFDVABFhAFA.....hABA...,1,-9,-21,12
GNKCOcVbBeMdSTHWIafPEgAXUYLJRFZQD,XCGCUDACLHBERFFB.QAGFDDCCKBAE.ODDB..hAAAVEBGBFFFMFABTABGhABA..IBEHhAAAfGGBEHBCAADHFCEG.NCIECEGBeEHD.SCADhABA...hADA...,1,-20,-23,3
eAOXYNIPTDgEUWMHbVdCBfRGLcFKaZQJS,ODACXCBC....IBGADHFGUDECMADCHGBE.dEADCEFGBGGChAAAGAGAFGDEaACFJACHhABAAAAE....NDIE.PFBFhAHA...EDGE......hAIA......hBAA...,2,-37,-23,14
EKRZYWQgVTMfGALbPUdaBNcIJHeCODSFX,LGEAUCBCdFCCBAAB..IFBFeGDGDIGESDGFhAAA.FCBGEFAFKACCZAFAQAEEhABATEEDMDIBhACAAEFFPHAG.NAIC.cBDACDDF....hADA......hAEA...,1,-20,-34,14
bFZMgVLNUTOHERKdXYcfWAPCBSGaeIQDJ,BBBDaDAF.QDEGDAHFFGCG.ZDBH.MIDGVABALCHH.hAAAUADFHDDCKAGCdGHG.hAAAXAEF.fGFAhABAAIBACHHBeGCAIEAC...hAIA......hBAA...,1,-20,-32,12
DNFLXCeSHWYURdgJOVAfPcIaKBQETbZGM,...PCCHaEGDQCDG.EDBBbFDHGFBDDAIDLEAHhAAACCHFHAAA.UDGDdHAFgAFHhAAAJAGHAIHA.IAEHhACAKBAFBGHFMIFE.NDIE.XBDBhABA......hACA...,1,8,-27,35
WYZRgDKFTVGeXcNHQCfOaMSEbBIdJAPUL,UDACLGEAZGDGRDCDKEFE.FDBBGAGE..eAFH..NCAB.CBBCaAAGhADA..SAAGhABABHCAdDDGACCG..WAEBhACADEIHXFAA......hAEA......hAFA...,1,-33,-37,4
KIeZYDCRLNcMJWEXfadOSGbFPTUABHQVg,BFFCQBBHKAGAZGCACDGCLFAC.MEHFEBFBaDAD.dCDGGAEBhAAA.FDEHUGGGhAAAAIDG.HABE...hABA............hACA......hADA...,2,-38,-34,4
UFcQHXEeZaJWDKIfGObPVTRdCBMANgYSL,...NDDG.SGFCLBBGFHGEHADH.EAGDaBHDDGCA.KDFCGEAEhAAAOCDH..PFFGhABAVDAFTAACCGEC.hACAACID.gAFB......hADA......hAEA...,1,-21,-25,4
WFMZfYXHQaNgJVdIRLPEDcKbATBeUGCSO,BFEEeDACCAAHOEGH.FHBCMGEG.ZDEC..XDDGaHDAJFAA.hAAAdABALACEEEAHDAHFKHEGhAAAAHBA...TAEFhADASAGH..fGCB.hAGA......hAIA...,1,-31,-36,5
XQJDKLHFMGfSVAbTPWEcBeYRagdNUCZIO,TCBCEHBGBHFD.RAAB.aDFE..dDEGUFAGZDBD.OHFAQEGChAAADCIDKAACHAFB.MFAHhACAfGCBABEA.PFFGhADA...cBEE...eACAhAGA.....hADA...,1,-15,-25,10
RMBAPUYWbeQOELHZVfJdTGcSaXKDCNIFg,UCBC..bAADQFGAOGDALACCHCFCZGAAJDEGdFECGGAFhAAASAAEKAGCDFIFCDDEFAEGhADAMIEEBBGC.AFCD.hAHAYEBA........hBAA......hBDA...,2,-19,-19,0
TBOfSCYEMgLbdWNRPGZaAXKIJFQDHecUV,KGFCFDCDQFADDGBHHCFDUCAFBGHA.OBCACHFD..EABELGDAhAAAdDDC.RBABGAFEhABAACIBJAFE.eEFA..hACA....cFCC...fEAAhAAAMICA...hADA...,2,-37,-16,21
BQIOREMUTPNXWGDebCHKfcFdYAaLSJZVg,aEEDSGDBZFCF.BEBCQBADRADA.EGBBMCAE.TDEEhAAAXBFH.DFHBCHCAKBGHhABAfAHCdGHAAGFELDAEhACA.gGAFIBEHOAAAhAEA.....hADA...,1,-21,-26,5
RBGUCfMScOQEadXIFALDZTgKYbVeHWJPN,DAADTFDHKECG.....VABGHFFEJCEHPBDF..BHAAhAAACCBG.MHFGSGDGhABAOBAHQBGChABAaGBFXAFAAEIB.LFADYEAGWADC..hACANIDF......hAIA...,2,-32,-17,15
TfBaCOJQbcASdFHRYKIeDGPVgWNUEXMLZ,FDABHGFGRFFF.KCHBDBFEGABG...PFDEVEBE.....hAAAgFAHNCIG.hABAXAFBLACHfBEChAAACHHGOHAA........hABA......hADA...,2,-40,-24,16
SfUKNRQZdIBCOAPLHFbaWYeDgGXMETVcJ,LFBBHDAGFFGFaGDCeEDB.GBEE.EBAETFAD.JCCCfGAChAAAKBAD.NEIGRAGBhABAQAFCZCAE.hACABHCDAGHDWFGDDGIBMAIH.SEFChAAA.....hADA...,1,-8,-17,9
bYJUIVdWZFDcNeEMATGOaLSKBXgHRfCPQ,TDACOCDGLBBB.BAFHHDDHCEEE.QFBE.hAAAYABAIDHHWHFAhAAAFHGADGFA.NDAG.eHCAhADAAHBE.SAHBKFDH.RFFGfDGDhAEA.bBCA..hAFA...,1,-5,-43,38
DPREcKALdWFgJUVaCYBMTZSGeHINQObfX,dDCDFHBGUDACaCAF.BFDBZABC..GFDDHACDQCECOAEG.hAAA.fAHAhACADHECRAGFKGGCAFGGLDFA.hAAAWFCF..........hADA......hBAA...,1,-23,-35,12
BEICNFGfAVRJdYOUeLPSgWTDbQKZcXaMH,VDBGRDEDdBEBUFAA..LAGF.SHCATCAHDAGAKABEhAAAZDGDaBHFBABA..hAAAIAEFFGDHAAEE.OBCChAIA.eHFA.gFEBQCCChABA......hADA...,1,-15,-34,19
LEaGPgQAReIJfNMSKDWXOHTdbCUFZcBVY,RFDFeEEG..IACGJCCA..MGAEDAGGODFDdHADUAFDFEAEBABGhAAALBHD.EGHFhAAAaCABGADEQGEEhACAABGD.SDHBKBAD.XDBChADA......hAEA...,1,-21,-26,5
dKVGYJcTaURXCBEHALIOfDeSPQMgbZFNW,LEEGOGEADAGCeCCH.QAEEMBDAZBFEFEDAdBHCKDAH.VGDGhAAAJEAD...aBBFRBACBEHBhAAAAHHB..SHAAhABA..PHDE....hABA.NECE.....hACA...,1,-14,-37,23
GacHLNUEVdFBeSRIYZfKDXgMJAPbQWOTC,QCBCODACGGAHHCFELACEUGFEdFACFFDABEHHeAGDSAEChAAARCCE.IHCEhABAfDGE.DIEChAAAgECFAAIFPGFC.......hABA......hAHA...,2,-17,-15,2
UecDWZSFdgGQHbMaECROKfAJXIYPTVBLN,JDACXCBC....IGHETABCBFGGUGBF.DBHHZFFDFGBChAAAdAGEQGEGhABAHEDDaAEF.CEFCKFCCABCA.PAEFhADA..NAIA.WAHBSCCE..hAAA......hABA...,2,-31,-20,11
AXDfVNOSYCFERWUcPdZKgMTBaLIeJbHGQ,XAFBVFDG..OCHDCCHA..RFCAUDAAdHAFKFBC..TGFHhAAABHHELDBEhAAA.IACDJBBC.hABAGAFEDIBENEICFDFDEBAE....cADDhABA......hAEA...,2,-29,-25,4
SAEbDFOdMCZGBgJfQKVIPRUHYcLWTNeXa,EHFGDGHHdEDFZEDBBFCG..JHBEKBAB....VBAHRAGDUAEGHFAEhAAALDAA..hAAATAFAeFFGaABAAIEE.hABA.FEGEMIAECCEB........hAIA......hBAA...,1,-25,-35,10
gBVcaUeTEGQRKbHAZdCJDWLNfMYPXSIFO,CCAHJFCHDECDLBFC..MFFB..XCBASBFHOHEAhAAABHBH..aEFDeDDGhAAAEABF.REGHHACGAAHA.hABAdAHANEBE...PFABFCEH.....hADA......hAEA...,1,-27,-32,5
gKFTdXWeBMRHcfPGVOAbCNJYSEQaZLDIU,CFDGJGEA..EGAFQDDBLDAA.UDACKBBCFAFEdHBB...eEEAhAAAMCACRBDE.HAEE.PDGDhAAAOHDA.NCIC.aABAhAEADACC.....IHHH..hABA......hAFA...,2,-29,-17,12
OMFQdaZEbJBeIDCcGKLSPUXfWTHRgAVNY,VAADOGEA.FAEDQEBBZBGB.EGADBHHE.DFFACAEEKGFHLCAFhAAAUCED..XDGDhAAATGCGHCBH.hACAAIEAMAGD.dABFJHCAIEDESBGEhADA......hAGA...,2,-24,-17,7
aMQXIZbPOCYTFJSVdLAcGNgUeHWKfERBD,GAFEUCBCHFDGKDCGEACBBBGG.MHBC..IHGEZAEFOAHFhAAATEGHFHGA..SGAChABALFBHAAAB.NDFGeBAFhABAfACBDBED.......hADA......hAEA...,2,-22,-21,1
LMIONGXSedCZDPQYaWVEfARbKUcJFgHTB,RDAGUGBCFGAAHFFHBGEHLCED..OEHFGAEDeAHFCAADDIEGhABAQCDA.hACAaBAAEDFDAAFBKFDFJCCDMCBFhADANAAF...XGGAZAFB....hAEA.YDHD.hBDA...,1,-13,-22,9
MYgQReKLCWaPObfSJDZBIAEHUNdcVTXFG,UCCBdHBH..VACGXDFHFFDE..MBGFQGBF.KBFChAAALCHFCHGE.aHGAhAAAOFEBSEDChABADABGIEAEAGABECAA.NAIE.......hAEA......hAFA...,2,-39,-26,13
aZTDQGOJCFSRgIMdYLHKUbBAPWfNVXceE,...fDCDXEBHEDAFZGBEDGACGEDBCHGG.FABDRDFB.MBIHLCFChAAAKBFEBHGFAADG.PHCChAAANFBB..eCAFhABA.aCCA...OFHFJCDCIADGhABA......hAFA...,2,-21,-15,6
JDcTCbFfMVQKXLBaZYOWdUgeGHAINRSEP,RAADSAFBEHGE.DBBCTDGH.FAHBVCDG.KBAFBFBDZFGH.hAAAODDDdGEGUEBEeACChAAAACCH...PAFFhACACHBEMAHFXFFC.......hABA......hACA...,1,-16,-32,16
QbeUSNWLZPgfJYOBIEDMFCKGXTVHRcAad,dFAAQDACeACBUCEASEEHLFHDZCCB....fAEFhAAAYAHFOEHBhAAAEDGGMICCFACE.KGAC.hABAXGEETAGARDAEAIEEbAEDPFFFBBAA.DIAAhABA......hACA...,1,-3,-12,9
dHGOaZWNKDETVQXYMRUFfbIegPLJcASBC,BCEAdGFHGFAFZBGBKFEEEDDE..QAAFMIDGUAFHFEAH..IDBAhAAAeADG.LABEhAGAAHGBCGCGHCCBaBHDDGGETEFAhAIA..YHAA....hABA......hAFA...,2,-32,-7,25
QgdDecALMIUWVBfGHbZJTYXESFRaCPOKN,MDEBUCBCBHGEHCFBJBAD..TGDA..EBEASFAGhAAAFHGAaBHH.CDGF.KCCFQADEhABADHACAFAGLFFAhAAAIBHA..fABBGEDF.YFAGhADA....hAEA...,1,-26,-28,2
GgJMPBOYfFHUaXALIdbSeERZWKDTVQNcC,dDCDeCCHRACAKGHBDCAC..QGBC.CFDF.JGCCBFEHOHACFAECHAGBhAAAUGFG..AFDG.IABBhADA.EEHBTBFGhAAA..cGGAMBAH....YDABhABA.fCHAhACA,2,-37,-36,1
dbAPJeMfDSWFQBEITZCOVNHXaRGKYcgLU,JEEGMDEB.DDHFFABCBDCB..EHAGZBAH..CDDG.OAFAHGDEaAEBhAAARADG..KDFF...hADA.gAGHhAGAdGCEAHHE.fFBFSACFQGGChBAA......hBFA...,1,-28,-43,15
DUVXgNTWSBJHeCaMYZAGLPbdFKcEIfRQO,LFEFdHBHKGFA.EAEDRECCDCGBUCBC.....XAFBTCBABAGChAAAeCHHCAAF..MIEAhABAAACC.GABFFHGGIHBDhAIAOAHFNCAASDDE..aEHHhACA......hAEA...,1,-24,-28,4
TVIBaNbAWdCGUPQJDZSYHREfXgKLFcMeO,CFEDUAGH.QCDEDBDBZCAFHGFERFDF.EGCH..XGFDKAFBLAEDhAAAMDIB..TEAAhAAAIAHBBBDFaCGDAHCBdBAHhABA.JDGFSEHH.fABGhACA....hADA...,2,-31,-12,19
WSKDOPfIgBVHZMGJQeRFEbCYANaXdcTUL,XGBCTGBC.LFFAKDGHDDBF..OEEBIBDE.BHFBhAAAVAACZBFD.MBAFJFGHQAFBhAAAeCBHFFCECDDDACIHhABAdCDF....WAFFSGAD.hACA......hADA...,1,-22,-23,1
LPKSGAUJCcEFIVXfOTRQaBWdZgYeMDbNH,JGFAEEGDFDAF....XGDCTDCGRAFGBAEEZAAE...eBADhAAADHECHFACKCEDACHCCGAFIFEDhAAA..fGBChABAaCDA...dEGDMCIBNBCE.SHAGhABA...hACA...,2,-45,-10,35
AUQODdcSPZRXEIeTBMafVYKbNFLGJCWgH,UDCHQEGDOHDCDFCF.dBFH..SGEERBBDEEDD.TAEDhAAAMEAH..aGEDfDAChABA.KCGDFHGGhAAALCACCADHWHAAABAFcGAH...PFHBhACA....hADA...,2,-31,-23,8
AXVNHTeBEUZSKWDgJcCFdfRMIGYLPQbaO,VEFHTFDH..eAAFBHGBZGCAKEBG.DGCBJDCF..CAHD.FAGHRAACGBDDhAAALBEF...hABA.PEEGaCBBAEIH..hADA.NDIE...........hAEA......hAFA.EGABSFAF,2,-29,-28,1
PXDKFLYcVHeMGfRgUbZBQTaIEdONWSAJC,JAFBXGGG.KBCGFECA.LHBG..VDAGeCAAfEEChAAAUFAHZDGFBABHhAAAaBHBdAFAOFGH..hABASEHHCGEEDAEF.cBABMAIF.gGDAhABA...hADA...,2,-28,-21,7
LMUHZcDaKNFRBeOfJdQTAYPCEVgbSWXGI,CFDGECFC....VCCCSEBCGAACLFGFMEFGUABEHAGDhAAADHDGKGGFFGACBADF.hAAAeAFDOAFEdFEAAIAEgGAAhAEA........hAFA......hAGA...,1,-13,-37,24
UFHaCJBOPMWdDYEKfQNLVbITRcAGeSZXg,eCDGXCCBFGCAHCBB..aFBCBADDMBIBDBBFKHACQFGBhAAA.LBFGhABAIEFGTGAAAHGFSEEDhAAAZEEFCAGA.PBAB.YAFBNCAE.hACA......hAEA...,1,-8,-28,20
RVKcHCIDASFMQPfbdYBZTXWeNOLGgUJEa,MIAGQCBC..bDADBFDG.ZAAEXEECeFFCOAHFhAAALAEAGAFAJGEEaABBhAAAKHDGCAEFDADDFHAA..PCCBhAFA.dDFD........hAGA.WCHH...hABA...,1,-10,-25,15
GRQTEJCBcPaAIObUNKXFfLdVgHSMWDeZY,OGEAUCBCKGECFAEDLCFF..VDAAHADA.MCAHDDFHeFHHhAAAZFAG.GAGE.hAAAQABAEEHBBHHGaHCChABAAAGF.IBHCNIABdDDA......hACA......hADA...,1,-14,-22,8
RKGfNAOZIHLBSYaPbXUdQECMcJWgFeVDT,OFBBZGFGHDFEBDCFaECH.....bDEAUBFF.dBDGCAGFMFDDhAAAJDAFFBAG..DCBF.RABEKCFChABA.....hAAANEAGLFFAPHAAEFGA......hABA......hACA...,2,-28,-24,4
NgaHAcEZWdQOJBfeKYDSITXUCbMRFPLVG,ECFCZDAGdGFD.QBFCBHEAKGACDIGA..SBBA.hAAAIAACXFEEUEGDhACACEHAMFBCFHDCLAHBhADANEBH..aABBAHIFcEDBJACD.fGAHhAEAeAEH...hAEA...,2,-43,-8,35
feCVQgTbMYXEOKZNJIAPFGcLaHWDSdRUB,GEAHaDCDHAACSACHRAFGBHDH.CHFGQBEF.TAAChAAAbADFMCID.XGFEhAAAKCADJFEGAIHEFDGDLDDGhACADGCFdEEE.fHAD....hAEA......hAFA...,2,-14,-14,0
YKINGfBJACbgZTaVHOWREFUdPecMQXSDL,CFDGZAAD.aDCAHFGB.RAEAEDEDdFGEeGDA.QACDDABGKEAHGBBEhAAAJFBE.ACGC...TBFGhAAAOBHD.FHACPCHDhAEAXGEDSGAD.YAFChBAA.....hAEA...,2,-23,-3,20
AIPCHSUbWfYLTRGaBcFgOeJNEKdMQXVDZ,CFDGUCCB....fCCBLAACGDGEBEHFFGBCOFBGhAEAeDEC.EHACKGFGQAGBhAFADIDGADAE..HAEAhAAASGHH..YEADTGDAcBEAhAHAJABGMAIF...hBBA...,2,-26,-22,4
ICWQbTXcKDgJZdVaAeSNYMELPfOBRUFGH,SDCDMCCALDEGOBCEBAHB.RGAGUBACFGBDHAGH.CFAHQAAFhABATFGD.KFFFhADADFDCJEFCZDAE.aBFAAGHHNEEEhAEAEGDE...fACB...hAFA......hAGA...,2,-19,-17,2
ZFGXYdMKRQbSgTJPOaBHCIUcVDAEWLNfe,LCCHeGEAFCHHGCAFXGDD..dBFAKAGHQECE.hAAASGAFJHFAOGAChABABABGCFFCICAHhACA.UCGBDAEEABEHNBEA.ZEFC.MICE..gDAAhADAaHBG..hAEA...,2,-28,-10,18
ZQPIDdAHEOXcfKRbBUWNJSVMGTYFCeLag,HDEDEGDD.OCBD..XDFCKHAEBGGBNAAG.SADEhAAAGBCFTFAAFBGFeBAHaFHDZAFAhABAQGDCDDDDAHCD.hACAcABAfDBE.UGFE...hAGA......hAHA...,2,-23,1,24
EHLXUROJgTDCaQfVBNbIWFKMAdceSYPGZ,eCCHSHBGGBECZAEDEAGALABC.RDGH.gGGGhAAADCCGCAHA.QGAGhABABDBHIHHEKCAEAGFFYDHDhACAHFEBXBGC.......hADA.UGCE...hAAA.JDDFfADF,1,6,-23,29
VJPcgWFDMaLdfZTKSUQIeRXBEbGAOHYNC,OFBBHAADCFCE..JGFC..PBAD....gDDBhAAADHCAaEDGdCCDTADGUGFHeAEGhAAABBGGEFAG.ABHENICBhACAcABF..FEGCLCFBfHAFhADASAHH..hADA...,2,-28,-13,15
OWZQAceYGTVPNbRdMXDIELfUCJHKSaBgF,eGEATAGH..VBAE..PDGHRFBGMDIDDDEB.LGCAhAAAUDFGCBHA.KHGABEDCOACAhABAQAFBAFBD..hAAAGBBHNDAE.........hABA......hACA...,2,-25,-22,3
GTaMReCZEIDUcNLbAHBXgWVJSPdYQFKfO,BADCXCBC..VAAFSCGGdFGFFHDE.KGABGDCB..hAAAaBFBeEBDZGFGEEDGDCFG.hACAUACE..cAEBhAHANAAAAAFA...........hABA......hAHA...,1,-30,-31,1
aGeNQRTWDHLfSbAYUMXKEIFcBZPVOJdgC,MFFFKFHBFCCHZEFH..OFEFdABFCFCB..GGABeBDG..RGBADEEALAEBhAAA.SAGHhAGAAHHHUBGE.ECBEBBAGhAAA...PEAH......hABA......hACA...,1,-25,-38,13
UXRNJYaOELQSebBKfIAMVTGgCDFcHdWPZ,MEIBTBCFGCBG.CHGC.DDAAHBGDdDGAZFAARFDF.JGEEaBBB.EGAGLBFGhAAA.eEDChABABAEDKEACAHFD....hACA............hADA......hAEA...,1,-26,-30,4
NDeCfKHcOLAWBgRSMYXTPFVGbUEQZIdJa,BFDGRDAGMAHF..XAEAFFFCGBAD.UGAHZCECJCAH.DIGECAFCHFDBhAAALEFBAHIB..hAAA.SBBChABAPDDA.EAHFIADAdCCANCIC.KHFAOHAE.hABA......hACA...,2,-20,-16,4
QRVLefCHUOEYNWJZbXMSAFTDdgKBaGPcI,DDFFdAFBBBBDGGCH....PFGDIBGFREAG.eBDBHFDDOBCHhAAAEACA..NBGAZCAEhAAAMAFE.ADGF..TFGFhABAaCHH.QEACfCEECCAH....hABA......hACA...,1,-16,-19,3
BUPRDQNEOgMHAVGcXZWJCSfaLbYFIKeTd,VEBHXAGH.ZDGFCAGB....aACBLFAFFFEH.eCAEdAAAUCDGhAEAPEFDDFAHQECEhAAA..NEIGEHFChAFAOBDA.MABEAAIF......hAFA......hAGA...,2,-33,-19,14
CfUIBEegcbFSXOaWDNTQAZRHYPKdLGMVJ,RBDBHAADKCGAGFCHJBEAUDCGBGHE..EHECeDBH....gGGHhAAAFABH.OFABhACADIFEQAGHhAAAADIF.YDADdDGAMADE.CHBCcFDDhAHA......hAIA...,2,-27,-20,7
NbTSZDRVaGeFOYUQcfXPdWLMIBJCHKAEg,EHBG..bDDDZCBGDAHDaCGDGACG.OCHDQGFH.XAAChABAdAFGLBBFhAAAMEEBBGAFCHHBAHDA.NEIA.SGBFhABAVAEC.FDFD......hACA......hAEA...,1,-15,-20,5
PVHXbENBAeDZGLYcfMOCgUJdRaKSWFQTI,DAADZFBHLDDH..fECGCHFGUACBRDFF.aBDG..KAFHFCGAhABA.QFFAhACA.IEEBPBHDHBABhAAAECCDBEAHADFF.YAECOFAH...hABA......hADA...,2,-27,-25,2
YMZGEPOTCaQWNAUJBFKdLIRgSHcXDfebV,JGFABEFA.FHBALBCFRACG.HEDEDDEC.eFBD..VCADMBBFhAAAZBGFGAFG.OADDhABACAADQFGEhABAADHDKEHB.dEECIAHH..SGADhACA.....hACA...,1,-16,-31,15
AISYfVbgGeWLXQOJPMKcRTDCBNUaFEHdZ,SHBGVAAD.GBEHeCDDLAGF.XEAFhAAAOFFEPBCDKGFHREGBCADEBFCDhACANAEHaEGG.FAHDHFBEAAFH.hBDAIAAC.YCAF.fHDBhACA...hCEA...,1,-6,-20,14
QKfPVUYMAdRCSODJZcFaEITHLbeWBGXNg,CCAHDFDCZAACFDCC..EGEEHGBG.eBAABBHDGFEB..NHAH.KCGFhAAA...fAFHhABAVCDGMIBAADAGSEADhACAJFBE.aHFCIAEC...hADA......hAEA...,2,-43,-21,22
DEcTRBIedMQabUKPZOVJSgYfAFGCNXLHW,FGACGGDHCEAG.LCGDDIAC.TADGBCBDdCEEQGAF.hAAAaCCHKGGCOCAFSCCBhABAfDDBAEIDHGDAhACAEABA......cCGEIFDAhAAA.MEIB...hADA.PADC.,2,-40,6,46
EQGDMJPIVSCXHLbcaWgUYOFTAKdBNZfRe,KEHBBFEDZFAFRDAF..eHDEECCCGGEF.DFDFMAEA.JAACVAGDhAAA..XDGEhADAHDEHLACCaGGA.WBAFhABAgCCB.OCFGAFCB.NIAB..hAGA......hAIA...,1,-15,-24,9
fTSEVIZLCKaOBXFQNYGARJeHUbgPcWDMd,eFFCUFDH.....PACADIGEMAFEdGCH.SCFBEEDCZCFCCDCA.hAAAKACBBHAB.XBADhABANCIA..AHCFHCAGhAAAbAFA...........hAGA......hAHA...,1,-23,-44,21
fMFNLPaSbTZYEVQcCAIBKXWgDHeJRGdUO,KEGDXCBCDGDGHBFARFDF.UBDA..MCHF.LBFHSACChAAAZABCEGGHVGAG.CGHHBCCFhABAeHAEJFAA..hAAAOHECNAEF.aFAG.......hACA......hADA...,2,-25,-17,8
OcbQYDAWFNZVMEgKLUPRaBJdXfTGIeCSH,FHBGZGFGMDDDEAHB.LBGBRCCCBHHE..dADBTBAHGCGC..IFBFhAAACBAAHEEB.OAEDhABAQEBGADCD.NIDF.hAAAKHAA.PFEG.......hABA......hACA...,1,-17,-20,3
AcgJRBEFbDGWCNKZVQaeXPdLHMUTIYOSf,JGEAEBBDFDGEGACG..CFABZEDBQFBD.eEHDdFGCLFCFhAAAHBEBUAGATBEEhABAOBBHSAEEhACAAEIB............hADA......hAHA...,1,-16,-32,16
FSBLgRPIcMUNbWEKQdJfGXYeVTaDZHCOA,FEHBLCAFRFCE...PEDDICACMBGFUCDD..bAAAEAGAhAAA..KDHBdHDHJBEF.hABA.fGAGhACA.XBGAeHCGaGGGDEACCAHDAHHB..BHHAhADANCCA.WFFB...hAAA...,1,-20,-25,5
PVYCZGFXcaLKIfNADbWOgRJQMEUSeTBdH,DACBOGEARADB..MIAGSECG.BCGEdEGHHGDC..hAAAPBBHVDCFCBHHFAGGaFABhABAIHHG.NAAH.hAFAAGID............hBAA......hBCA...,1,-32,-47,15
acOYfdZeERXPgVHBbCWGMNQSKUTDAIFLJ,LCCHaDCD.ODADdDHEeHBCRDGD.XFFH..PEEHhAAAVAAFHAFGBHAACGCDMADAhAAASABCKCEHDEEHAIHGhACAJAHF...fAEC.ECEA.hAIAbGFA.....hBDA...,2,-20,-16,4
DGTQgXMYIRLCfaScEdWUOVeANKFBJPHZb,KAFBJCAFHCCCZEBCGCEC..QGDFMIFERCGBLABAaEGBEAFBdHGFhAAAOFABAHBH.BHBEhAAAbAGD.DCCB..gABHhABAIGGECDDFcEBD.....hACA......hADA...,2,-22,-3,19
aFYCTLKJMVUNdWZQGebDHSAcOERIPBfXg,EDCDRAADBFEH..XBGGFCEG..CBGBKDHFMAFE.UBDHdFBEZDAAhAAAQEFD.eHEAhAAADGGAAHHEOABH.hACAIDHF.fDAGaGDCTACAJHBEhACA....NICH..hADA...,1,-18,-43,25
HVeLYFcAOPfdMQgGZXJEKDTBbCRSaWUIN,OGEAdHBHQCECZAGD.EEGDDACH.BDDECEACRCCF...aAEBIADGhAAAHGCALDBHhAAA.FAFDAGBCfAHGhABAMIFAXDFCKABHSHEANBIC..hAFA......hAGA.eFHHPDAH,1,-10,-12,2
bKPJWSAVENHBaeFdXgZDIMCYfcLGRTOUQ,VDAGECFCBBBC.FADAdAAE.ZGEADCCG..CDHF.....fEDDhAAAGADCOFEGhACAUGFFQDGAhABAbGAG.JFCFAGBAHAFA.......hACA.aAGE....hAGA...,1,-16,-37,21
SPfRXBCUJAFecEVMZaKLTdDgWGNYIHQbO,eCCHECFCZBBCLBFE.DIEGGDGE.NIEFHFBGOFHHSFAFhAAARGAECADBADIF.FHAEVAAChAAAMDAGKDFEdACF..hABA..gEEDWEFD.....hAFA......hAGA...,2,-22,-8,14
MIPEYRJBGCWHVLcKUdgOAbeFaXTDfNZQS,FDCDaEHB.DBIFZFCE..MEEGEBFH..RCBFBADACHGE.HGECLFFAhAAAUDEHdAACAGBA..eABChABAXGAD..TAEFhAGAfAGBQGDDSFAF.hAHA......hAIA...,2,-38,-9,29
CDVORBfGZaQUKWMJIXFHALeNdgYEbTPcS,LEEGdDCDEAED.TBDHSAAE.CGEB.VFBHBHAFZAFAUGBChADAKBBFMAAC.XGGGhAEAFGGHADHAeCFC..hAFAYDFEbBBC.DDDFfAGF.hAGAaEHH.....hAHA...,2,-20,-18,2
DeMCKPJaTgFYUIZbcWGEHAVfQdXNRBOLS,QFDHXGBCREBA.OCGHLCEA.eFFFCHGBJBCG..aBBDFGAHhAAA.UDABZADEbEGF.hABA....cAABhAAAEDEBAICAfABABAHCMFAB.....hADA......hAEA...,2,-30,-12,18
UBfARNcbHTFagOVDMPCYeXKLWIdGZSQJE,RAAD..bCAATEBE.FEHHaEEC..OHBAMDIDCABC..XAFBhAAAKFBBLGEE.hACAIDGFGEEAQCDBhADAEBEBfACAAIHENAIE.cAFA..hAAA......hAEA...,1,-11,-31,20
HGLfETSUIKYdDAWcOQVZXCPJBbMegRFaN,OGEAVABH.ZFADCFDG.BABC..MBEERAEGFFCDHFGF.GDDDhAAAEDEH.UFAFKHDADFFCADAH.hABA..QCBChAAAPBHD.eFHHgGDANDAE..fBDEhADA...hADA...,2,-19,-16,3
KUYXNLDMRWOHIEeTfVgCFAdJaQGcSPZbB,dEEDaAADGDBCSBEDZDDBBHFGKAEC.UFGE..XGDHhAAADBHHRADE.HBAC.EFCHeFADhAAAfBGHCDAAADDD.hACAcGGH.bDAGNAIE.LDHF..hABA......hACA...,1,-14,-22,8
NHQCKLZTgfcaDUbMYVGXEdRASWeBPOFIJ,eCCHBAFBFEFE..NCAE.HDCE.QBGECGFELBEAZGDGTGDGhAAA..cACChAAADIFEMDFGVBAF.EHAEAICASFBGhABA.OEFCIHHDKBBHfHAFhACAbFCC.hABA...,2,-19,-16,3
aCGEZSXDbJKFIfYMBeUVPQWORdLHANgcT,...NDDG.gCGC..aCGECBFDGEGAECEDZAFEDGCDJEAHFECEhAAA..IBBAhAAAMIBEUACFQGEFhABAOBBHdFFCLEEAAAIH.SGAH.hABAKEAF.BACB..hAEA...,1,-12,-25,13
PGbKNUHIRMWYgOJeEDZXfdcCSAVQBaTLF,QADCBFCFLHBEFGGGGCBGKEEFHGFAMHCC....gCCHhAAAeEFGDDDCfAFDhAAACDGHAAEA..hABATAGFNCAG.IDAG.RABF.WBFAhACA......hAHA...,2,-25,-24,1
EMUdFaLIfXTeAOcQSKBHDRPNGgJCYWbZV,ODACSGFCBBFGDIFERDGF.GABG.CADC...bFDGECFAMFAFhAAAFEDCLBHH.hABAXFBHAIFEKBGCPDDAhACANIAH..JAEEYBBG..WBADhAAA......hABA...,2,-30,-23,7
gGbFPXTVdBfaQIJcWEKCUDeNAOLZSRHYM,ZFBGRBCFMBABGDDH.FHGA..TFGGBBCE.aBGDJBEG..EGEGKDAEhAAADFCGAIFE.LHAAhAAA.SEEEhABA..YDHBPEAD.dABCfCEFhACAIHCFCAHBNIEF....hADA...,2,-40,-4,36
OZcDRAHJbEMWFafGQIVCTLBKdUSXePYNg,HFDFEDCD.MBBEFCFCGAACQDAE.CBGHLDGBKHFEdEGAXEDDhAAAeGAA..NBIGODDEhAAADFBBJHBE....hABAaAEGIAFEBAGA.......hACA......hADA...,1,-6,-30,24
AFNcXeIdKGfDECVBSHQWgOYbJUZRLPTMa,FHBGXCBCeCBFKFGGGAGA..ECFDBADFHAGFQGADhAAA.OFFAbABAJHEAUECChABARDCF.TAEEABADNDAE.hAAAcGEB.IHHCDDIBCFFF...WCADhACA.....hABA...,2,-15,-3,12
BefHabINQPZWcAJKRDOXUYdVGCMLEFSTg,JDCHRFFADCEH..UBGEdEAEGBBELFGH..FADE..SEEChAAABDHFeFCAaGAE..hABAIHHGQABEhAEA.PFFB.cBDEAAHEKAADOHBChABA.YAFB.hAFA.MDBB.,1,-17,-27,10
XIgaSAWbMCeLZGROUEKBHfPcdVYQFNTDJ,MCCACECDZGBEGDGARFAE..EHCABBFFHFEE...fEBBhAAAPBAEdAHAVAFEFEAFDEFBhAAAIACC.SEFEhABAAIDGeADCOCDCKDDE......hABA......hACA...,1,-5,-26,21
SXHgVCLGfecJROINWPZTMKFBbQAEYDUda,EHFGDAFBUEAAdEHA..SCEFHBBACHDALABEeCFA..RFADOFEBhAAA..IDHDhAAANBDCZBAB.KDDDBHHBhABAbEFG.AACGXAFB..gGGGhAGA.fGCAhAHA..,1,-19,-25,6
VcEQFdIUROePgSCafNHBDMKGATYLXWJbZ,TDACLDAC.JFHFZGBE.EFHDQGDF.FBGFUAFAeFAFhAAASGFH.hABAfDDABBEEMACAhAGAKBCAACCGXECC.WFFBcBAB.hAHAdDGF.....hAIA...,1,-20,-27,7
EHUIVMaeZNPRJLYfWcbSAKFOCTgDQGXBd,KEEDCDGFDCCAQAGC.BGFCdAEFEDBCUBBD..MFDHeEABZGFAhAAARCEELECB.hABA.fHAHhACA.bBFEAIFA...TEGA....hADA......hAHA...,1,-34,-37,3
RTbJDUeWQFgLNXZaIMdPGHESCfcOYVKBA,TFDHJFCH..UDDCeBGHFABHLHFA.ZFBFMFHHGBADhAAAEADG.CHAC...OCABhAAAKAECAHGEDGGA.WDAFhABANAHG...aDHDdGFESDBA..hACA......hADA...,1,-12,-42,30
TcINOdBQPAMGKSafbeEgUDCZXWVLHYJFR,MEIBSDAF..fBBEEFEADCCCCHGG.ZFAE...XEFAhAAAVBFEHEABFBFBRGDAIACHhAAAdBHCBACAPDDChABAKEAEaEEB.eBDH.......hAEA......hAFA...,1,-8,-30,22
BQURMJedcgSfLCbOGXFaYVNIHAKWDTPEZ,KHFGDAFBEBBABBHE.UFDAMDAB..dFABSDEGLCCA.OHFEhAAAGDGC..aFDDVACEhAAAHCFG.AAIFTFFFhABAQGADREBF.....JBAB...hACA......hADA...,2,-22,-21,1
efNTcAXQEMJWgHCUBVPIYDaZOGbSLKRFd,XFCAEBDH..MFAAJHAE.HGDABACGPEECDCFC..aFHBZAAEhAAA.OBGFGDABbAEFhABAKFAD.dBAG..NAIEAIHEhACAQDFBCGGBUGBE.......hAHA......hBGA...,2,-31,-1,30
XEAGHSbLOUaVWZgdeNPQfCcTJBIKFRMDY,HCCHLCCHOBECUDGEaBAFZAAE.dBFFeEFA.QGEHhAAACFAH.JEBFIHHGhAAAFADGDIBEEAGASHAAhABA.VFDC.....NAEE.fGGBhABATCAC.BEECMAFEhACAAFIF...,1,-2,-25,23
HdMTBYSACbgJXeNOcDUZIWPaFEQKLRGVf,CFDGJGEA..eBADOCBHDGBHZBFG....IACGaGHH.FDHFhAAAKAEAGGAFHCDFMBCHhAAABFDCAFFC..bGDAXBGChABA.NAEC......WAFFhAHA......hAIA...,1,-29,-39,10
XRUEITgaJVQBZHDCAOGMcNSYbKfdLPWFe,OHEAMEAE..SHACKAGDdFEHLFBHFCGCRBBE.UAAE.EAEHhADATEGH.gEDFhAAA.aAGGQDGFhAEAHGEGAIHEcADA...NIBFfFAFhABAeDBA..hACA...,2,-27,-20,7
ZLKObVMaJPXRHBTfFGCcdWAgIQYEeDNSU,QCBCeCCHDCACUFDHLFDC.KCGHVAGBJEHD...RADBBEHFhAAAFABACAHE..dHBBAEEG..hAAA.IAFAEFAHSDAFhABAOBDCMEDCXGGE....hACA......hADA...,1,-23,-32,9
fUeXPdQaAHSCJLKcMGVZDFTBbREOWNYIg,CCAHKAABGDFCZFDAFFAABBGH..ECEBOGBC....NACC.gCDGhAAAUADF.XDBHhABAdFHCaHBGACIFJAEELAGFhAAAMIFG..DAIB......hACA......hADA...,2,-32,-30,2
cIWeBPSAVYRagJbUXKHFCdDNfMEQZOGLT,VGFGRDAG..JBFFUBDDHABD.dEECDAGG..MHEAECBFZGBALCHDhAAA..TDFGhAAAIAHABACC.ACIFaEAChABAbFAAKBADFEDD...CFFB.......hABA......hADA...,2,-25,-21,4
ELHPGeCAQOYbNFBRZfIXTadMSUcVDgJWK,QDACOGEA....NADBBDDGfDGC.TGBFhAAAdABAMCDGSFDBhABAUFBCDFIHgFGFhACAKHDAEBGE.LAEC.GCCHCEFHADBB.FBBE.hAAA......hAIA...,1,8,-41,49
fHgbZLJFTKNXaBYGdPCIWVcUAOeQRDMSE,OFCAQAEGDGDH.SDACHAAFZAFGFGFEKFEB....aHCABFAGhAAAdAAACGAEIDDEhACA..cDEFACHEMAEGhADAfCGB.gGGG.hBAALCCBJCGF..hACA...,1,-26,-29,3
aWdbXTDZfVgLAHPYMNROSJUeCKQGBcEFI,HAADMCCARAGFSFHB.UFEEeDDFQCDGBGFCEDAEIBAFhAAAaCGBdAGH.XEFAhABADFBEfACBhAAA.LHAEAAEFNICBCFBEKGAA......hACA......hADA...,1,-5,-28,23
PAWOIGbZfKceEVNQTYDCFaHBLUSJXMgdR,OGEAGAFEZECGKGBH.eFAD..VCCGTFGDDEIF...FBBGBHHGhAAASGFDJAFG.hABAXBDDdACHAHDF.WDABhAAAIDGF..fDHEEDAB.hADANABF.CBBD.....hAFA...,2,-39,-8,31
HNFUCMVAPSEZcQJaXgRWIGKdBTbOLYDef,SAFBECFCZBBC.QEBBXFAARFFCGFDBBDAG.OCAAhAAADEFA.eCHH..NBIACHDChAAAAABCcADC.JHAAhAEA.aDDFIACF.KAFG....hABA......hAEA...,1,-4,-37,33
DWXLNaYbMVgKJECAOSfPZBIdTGUHRQFec,SDCDZAADdGEHGDEBHBGBQGAGeAEFDBAALFHB.hAAAaCCFbCCDMGAAKCEECEBCAGFDOCAFhAAABAFD.IGGGhABA..........hACA......hADA...,1,-16,-26,10
ETJOMQLXUBdVCDeZbfIYSWAGcKPRFgHNa,KGAHRDAGFHFAHEGF.aGEDJCGB....OCCFMBBALBFEhAAAUCEDdDAEDHCAZGAE...IABAhAAASEEHAEFH.hADA..PEHDNAEF.EFAE...TCDChABA.BCCC..hACA...,2,-26,-26,0
aQIGJdEPTcLgfOWAKMVBYNUeSHXZDRbFC,MFCFBFDDUBDHHBAEDFHBRCAH.FFDE..aAGAGAGC.ECEG..hAAAPHECLEADOHBGhAAAAEDE..YADAhABAeEFGSBGGXGFD.CHHB.....hABA......hACA...,1,-4,-39,35
WATCZfJSGdUeMVYgDPEbHOcBRQKaILNFX,TGDCZDBHSADE.dFHGUACB.eFBAMFGDVFGHDACFEBHHhAAAOAFHBGEF...hAAA.KCDDLDDAhABANAIGFBADAAHB.CBGFfGAD.....hABA......hADA...,1,-23,-26,3
CLYSKNVgIGdPbWBTaMFUHDREcAXQOJZfe,XDCHQFCAZAEAeACBLGDCKGAA..VFFAGBAE.dCGDhAAAPCECBGAEMAFAhABAHAABDEECEEHBAEEGJADACACF.NIEF.hAAAICEF........hBAA......hBDA...,2,-16,-8,8
FWEcaRTbLfJMXQSINeHDAZVPgKYGOUdBC,ZGFGVAADKGBC.GEEBdEFGFCFA..EEAGRFBCLHFAMBBE..SCEEhAAAeDBCAADG.PCAAhABAOEHH.BAHEhAAA.CAFG.aDDA.fAHA...hACA......hAGA...,1,-18,-27,9
NCQeAfHcLDdIVaOPEBKXTGMgYFJSWZRUb,HAADLFCHDFDHdACEVEEFOEAG.BGGFKCEAGEAG.MCAEhAAAFCFBSHDAhAAAZAFA.RAGBUFAFCABAAEHFIHHHhABAEEEB..gEGE..hAEA......hAFA...,1,-19,-24,5
QUAeRHTNbSdfVDZBMaIXcCgOWJKEYFPLG,eDACHBCDTFAF..SGCEdAEFDGEDMAABaHAA..IDHChAAACDFEOEDCKGFFFDAELBFChABAQFGEAGGAbDCEhACAfAHEBHHHgACFEGCF...hABA......hACA...,2,-16,-14,2
JZSCeBNVLbdHXMEfFTUgDcOPQAaKYWRIG,aAFBKHBGRBFAGGCFZFEB...eAADBDACVCFELCDB.dGGFMECChABAFABA.TEAC.hAAADGFCOCCHAIFA..hAEAICDGSFAGCHHG......hAFA......hAGA...,1,-14,-37,23
eVXAQEWSLGMJbaUFRHOKYCZgNBDfIPdcT,EGFCLCCHGCDBJBEEUBACHEED..KGBBCHABZBAHBEHE.DFAA..hAAAfACFdGECeAEAAACEhABASHGE.hAEAMDHF.FHCAOEEE.....hAAA......hABA...,1,-26,-27,1
ZYOgSLHIRfJePGFaDXMBNTVQKAcWdbUEC,dHBHEGFCZDAFOBEHLAFAHBGBRCAD..eBAGFGEEDIEAMCFG.BFDChAAA..TFBHQDEEhABAABAG..bEFACHEDSHAAhACAJACF..aAGANDIA...cAEAhAAA....hABA...,2,-20,-11,9
XYZNdcOaEbTRIMWCLfFeUJDBVQGgAKPHS,KCFCHDAG.SBABZABFdFGFOHBAEGAATGCC..MEAGCFHEFACGhAAAJAFADGHD.BFFEQADChAAAABIH.XEDAhAIANEEFbAGF..IBFAfDGF..hBAA......hBBA...,2,-35,-9,26
UIdPfZcQaSDWCKXRVAbgEGeLNYMBHTFOJ,EHBGLHDA.MFHDTDEBFCGC.UBGGdDAAZCCBQEAH.hAAASDCBCAHFXFEGhABARADDAIAE.GEGEeACA.hACABBBHHCEB.JGAEIAAC...hADA......hAGA...,1,-10,-11,1
eFRacDKUOTHZgJbPSILYQfNXECVMAdGWB,GEAHBAFBRFCCDBHHKDHBOEGH..HAADJADB.SCCFhAAALAAFQGDGhACA.XGAGCADEADFEeCADhACA.aHEA..cBGGZDEAPHAEIDEDhADA.fBBGhAFA...,2,-28,-25,3
PJIDTRbKgXCUBQVSZdLaOMcGFHWEYfNAe,eEEGJGEA.DEBCRCAF.KFAD..CEDBBDGD..QBCDZGAELACGhAAAOHAE.MAAChAEAFBGA.EBHH..NCCH.IBFBhAFA.TGDD.XFGAhAGASDFD.aHGE..hABA...,1,-19,-45,26
aeTZEWMbBXQgCGPDJKVANUcOHfFIYdLSR,UCBCOFBBFDGFdCCFLHACRDFB..eAAFEEEB.MFFBBAFEQGCEhAAA..CGFADFBChAAAVAEAAIFAHADD.hACAIABFaAHFZDBA.XBGA...hADA......hAEA...,2,-31,-12,19
CYPKSQNgXWHFeGadbBRVZAOILfUEcDMTJ,OEEGLGEAUDBGDGAEMIFA..JBECCEDG.KHDC..SCCChAAAQACE..XCFAhABA.WAHBhACAeHFAGADF.dDAA.BBBC...hAAA......hABA...,2,-50,-20,30
ARIcBLHCQYENefMJKSOdFgWDXTZaGbUVP,RAADBFDGCAGA.QACG.EDHHfBEGKAGE.SGGFhAAAdFABFAADDGHBXCGGhACAaEECGAEEVEDFAEAE.cGABhADALHCA........hAAA......hAEA...,2,-23,-22,1
TeIWHNYUMGfZcLVEPSgOaCBQFRXKADdbJ,DGHHJCCH.eEFDHGDGUBGGGACD.ZFABLFBBEEFE..SBAFhAAAaBCDBHAFQBAChAAAXCGAAHIFdGCC.hABA............hACA......hADA...,2,-41,-14,27
ELgGUcTeXPBNVDMfbYFRKQAHZdOJWISCa,ZDDFOFFBJECB...SDAFCAAF.LGBCUFFAeDHBBECEhAAADIDEMDDA.fDHGhABAFBBFKAEF.ABCEdAHGhACA.aGAHGAFA.TDAANCCF...hADA......hAEA...,2,-34,-27,7
HYfNeJaCbTQIVdKWELOXUPcSgRGBAMDFZ,FCBDZGFGHCCC..NEDD.eAGB.JAAFaDAHCEBE...QFGFhAAAdHAHKFAG.EAHFOEFEhABAUGCFSGADhABA.RACDAHFADGDF.fADAbCFA...hACA......hAEA...,1,-19,-28,9
LaARDEFCBGScYHUKVIPfJXeWgdQZNbTOM,DGDEEEHBFEAEGEEB..SEDGHBEGKDAFVABF..ICDAhAAAJHEE.eGDA.hAAAgBAEdDDHNHAF.hABA............hADA......hAEA...,1,-25,-37,12
DZfWSeIFbJcRMHQBTOPKUNAgELdXYVGaC,LCCHXGBCGBBGDEIBZBEC...SAGFIEEEFHFAJHDERDFGhAAAHDAHBCAF.OAEFhABAKHAAAFAHdEGC.aADGCHHDfEAAhACA.bEDCcAAEMAIF..hAAA......hABA...,2,-28,-3,25
afGHPgCcXONbBYLURVMdZIWSADQETJeKF,EDABTFCAKECC..FFGEaHGE..HGDE.CCDH.OEEEBDGCUAFGhAAAMAFAZCCG.SHCAhAAAAHBBQBBGJBADfBGEhABA.gFGANAIE..hACA......hADA...,2,-31,-24,7
OXZWUIJgDSbVCYdFEeTfHRGMLKQcABaNP,aEGDOGEAZAAE.UEBE..JHBEDDDC..SAFGCAFA.FFDAhAAAEHEG.eDFCHBCCMHAChAAAQEAHACBH.hABABGAHXBBF.IHHHbGFA.dADAhACAfDEF.hAFA...,1,-18,-34,16
eAJHRLTfVcGaNUEgYXdMBZIbFSCWKQPOD,JDACHDBGLGDGTDGH....VAACGCGGaHGC.EGBD.XAEHhAAAdBFABHAA.IHCGhAAASDFDCCDEKFEGPBAGhABADFAFAAEH..........hACA......hADA...,2,-30,-15,15
VBaIfEMJNXKDPWTFcbAeRQdYOgUGZLCHS,RAEGdGFCOFFAUACBLAFBHDCEBAAC..aBAHEEAF...MICChACAXEDCDADF..PGAChAEAFDHFAHIHeFBH.hAGA.QGGB......hAHA......hAIA...,1,-21,-36,15
SQPIAeLbRKEgdGVDCNcaJZUMBXOWFfTHY,eEEGLFBBRDBB.EFDAdCHGGADGCAHD.aAFEZGCE.MIDEBAAC.ODHDhACAFAEHHAAA.SGGChAAAIHEHAADFKCADhACADFABJFAFXCBC.fFGEhAFA......hAGA...,1,-11,-26,15
PXfLJEaNKDQOSeTFAWYcdHMgIZGBRUbVC,......WFCAcAAD.HADCMFBCZCFEBHDERECGUFGFCGGB.hAAA..XEADhAAAJADDEBGB.aHCCKCACDCCHOFABhABA...eDEEAEHA.....dDAHhACAIAHF..hABA...,2,-32,-23,9
gPVcZCbUMRDGKSBHNfdYTFELOeXJIQaWA,VAADCFDDUBDH..MFCCDIGG..GCGGKCGHBGCHHGBA..dCEGFEEChAAAEAGC.LHFEhAAAOAHFXBADQFAChACAAEAA....cFAB.....hADA......hAEA...,2,-29,-25,4
BUKNFXRMQTfaPeAbgLCEWVcYDJOISHGZd,LGEAEEGD.VDCBDADGOEBC.HBDCGAADZGAEdBAGUAFChAAA.NAIC.RFEBMIBC.hABATAGEfFFHhADA.eFBBAHHHCDDA.........hAAA......hABA...,1,-15,-19,4
dYGLJTeEACVMbgWIHUOKFXRDfQZBSNaPc,CECDVFAC..MHFC....gGEDIDHEHACBUBBBKBEFhAAAFAAFDFFAZEFHSAFGhABAaAFGdHCHGEAALDHBhACA..........hADA......hAEA...,2,-28,-23,5
gBcCXTRfOdQKNWbMaFJYHIEPAVULeDSZG,UBDGeBFDZEAFBEGGCDBE.RFAF...OAAGdHCBKBCF....NDDG.MDAHhAAAFGFA.HFEA..hABAIEHHABBDDDGC.SEEGhAEA.gAFB.XBCAhAHA...hACA...,2,-44,-26,18
FADCGBIJQdKeLaEcXVYTNRMWPfHSUgOZb,CGDHGGDHBEDA.JFAFdEACLDDA..aADGECBC...XADAhAAAVBFG..TGGGhAAAMFFE...PABFhABAfCHC..SFGCOABG.hAGAFHAAAIHGDGGAQBDAhAGAcECC..,1,-27,-32,5
geQKZFUdEfIDXCRJMGHbVYNSTBcAaPLOW,LCCHOGEA.eGDGZDAAFBHDEAEF.DHBECBAA..RAGH.GACDHEFAVGAEhAAASABC.BDDBhAAAAEEA...PCFBhAFAWDAFKCEAdGACIEHHMABE....hAGA......hAHA...,1,-7,-29,22
URDAbWVFLaKXPdfZYSIQgCNJEHTcMBGeO,VAADFEEDKBHD..dBGAZGEE..SHEAQGBGCEDG.EEAHHAEFhAAAMAEGBEAA.eEGBhACAOCCEDDIDADCDLAAFhACAaGAF.PBBG..fFEChADA......hAEA...,2,-26,-18,8
HRTBVUeIcSLQKbaGgEJMDdNPAOZXfWFYC,ZAEGXCBCFDCFHFFFBHEFUGCH..eBGHSAHHKADEGEGAhAAAEABH.MBAE.DDIDPFAFhAAAAEFBOECB..hABAfCFGCGAC.......hACA......hAGA...,1,-21,-30,9
GAOLcdHITMZJeYaKCDFbfUSERXNPQVgWB,OEEGdDCDHAEA.TDGDJFBG..eABDaEAB.CHAB.FBAC...UGGHhAAASEACRFDH.hABANDDB.QGAAhACA..VACE.BHGEABDD.IAGAhAAAMAIF.KFGA.DGFD.bBFAhACA...,2,-33,-4,29
YAaNVLXZTURQOKceDIJMSWdHfBEgFbPCG,aCFCVFDFZFAC..RAFH.QCCCKAAB.DBCEMDID.dDCFfFFAhAAABACCFFAC.CHGFAACE.hAAALBHHXGGHOBABhABAeDFB.SHAEEADF....hAEA......hAFA...,2,-26,-23,3
LXWZBCOTNREIbYGSVKeUPAMQFcdHfJDag,QAGDFAFBdCCHHEBFJDDCDFEG.LGEEZFCFBHEE..OHEEhAAATACGEABE..bEGDSDHDhADA.KEADhAEAUAAAAAHA.MFAB.......hBAA......hBBA...,2,-25,-22,3
cdSIVFAQRbYMZHUfLePgaKXJTCGDEOWNB,REFHMCCAZBFEUGBELDEG.eFDG.aAEEKACG.JHDCGCAC.hAAAEGDDOECCBBHDdFHGhAAA.SABEhAEAFAFAAHIH..QBAG.....hAFA......hAHA...,2,-38,-15,23
XKHcGYbPVWTfRJeaBdQUIFSCZMLAgDENO,DGHHOCCHKDEHHABDGAEG....bGCEPGDE..TAFGhAAAfGGBRDCD.eCGFhAAAdEGDIDAFhABAFGAHSBABMIBAgFAANIDBXDDDYACHhABA....hAEA...,1,-10,-21,11
UXKHCYMQZOADfLbVaGRFSPNBgIcTdWJEe,DEFHLGEA.VEBBaCHBREBF..FDEHSADDBAEG..ICCAhAAAdBEAEHFAeAAFhAAAKDHDHBECMDID..OBABhABAAFAF..fEGE...hACA......hADA...,2,-31,-30,1
QfRXVAJcBOCTPbSMKDaLIZGeEgHFUYWdN,JAFBBAFB.CGHE...TCBASBCG.DAAFaADH.LEEChAAAGBGCEEBEFFFHUEBFhABAdFEHQGCGXGDDADHChACAOBFBMEAFIHHGeDAD....hAEA......hAFA...,1,-24,-25,1
GBJgEVbLPTHIYdAROUQCDWZfXFMKNecSa,OBDGCCAHDCCA.ZGDEFGHBKFEC....eFBFaCEDGEAABDDH.EHGAhAAALFFB.HBFBhAAAICAGAHEH.RCCFQDGEhABAfABFMAIDNAEB.SAEBhABA....hAGA...,1,-9,-41,32
WTDgGXbMcPfdJSNUIAaVCHOYZFQEKBLRe,CCAHHFDFZAAC.EAHFLHDAeCDCDFGBGCDC.MFAAPFAB.dACDhAAASGAEUDFFAGIDVBAHhABAFBHBBFGC.RAEB.hABA...WFHHXGBD....hADA......hAFA...,2,-18,-9,9
JLZEcHVDPAWMOICdSNReGUKgFbXTBaYQf,OCHDdEGDSACBRDDHGBADKFCC..FAEA..XAAGBEBBaGGChAAAQBEDLDADEHAEhABAHEAB.DFFHADDFIGCChACANAHE..UGGF.....hADA......hAHA...,2,-22,-17,5
GDHMVBSUbNPQZgWaXeIOfYCdKELRTFJcA,DDGBVFBGBDDG.UCAF..NAFG.ZAGH..aAGEeEHF..IFHBhAAAOFBGCAAFEEFH.hACARBAH.FBEAABAF..MEAHhABASFAD.....bFEDPCDDhACA.WHEE..hADA...,2,-36,-33,3
ZIFdHbKfeNEJBUWGRTPASMCgYQDXOcLaV,CBGEQCBCDIBG.ODHHaAGA.ZGDEFBCFHFAC.KAFHeAACEAAEUADAhACAGFCH.TCFGhAAAAAIFSDEE.hAEAMIEEYCHB.XFAD..hAFA......hBEA.cGFDIFEE,2,-23,-6,17
BYPCacGVTUbfZMENFgRIJQDeOXAWSKHdL,SAFBKEHBdEEGBCDDCEGE.GCBA..UDBBZACA.MABEFHGERAGFQFFHhAAA.eHBAhAHAAIDELDADaCHFTBBFhAIAEAAF...IEEGDFDH.XFCGhBAA.....hAAA...,1,-10,-31,21
fAcFTDdSQNULRaHGJWPYeEOgbCXMZBVIK,TGBCSGCD.UBEBaACGGDBD.JGDCPFGH.eFABhAAAOCCACBBB.MBDChAAAZDAAIEHFAIHEDABBdAHA.hAFAQFDENDIEHCFD.YAHB.ECAEhABA......hACA...,1,-3,-21,18
ZRKQUEIJVDPaeABXLgbFHWYSGMNcTdCOf,XEBELGEAFFAAHGFE..SEEAMBAGTBEDCAGAZAACKBHBECABhABAJEEB..DDDC.aDGAhACAABGEBCCB.WCAFhAAANIADdAEEOGAC........hABA......hACA...,2,-23,-23,0
OEVfBNJRbYLGeHdcFKgWaCAZPSMUDQXIT,ZDAGSGFHUACDDCFEQEEC..XFBDTCGDVAEEhAAABGEA.RDAG.LDGDhAAA.....hABA............hACA.HBBAdBAC.FHAEKEEFhABAaFHBCAGFMFID.,2,-35,-5,30
ScWJRYaCOgdTFbBKeZGNHUQELDXAVIMfP,VFACMCCA....SEEGJDHH.aGBAOAFH.dABCFEHFhAAABDBAeDAFZEDANACFQBFChABADAHHADAD.IHBHhAHA.fGHGcGEH.WHDAhAIACHHE......hBAA...,2,-43,-29,14
aJQZTScfdYAGODeKXCFURNLEBIPbMWHVg,GDGGDBEDKHCE.FGCEUFGERCBHLBDB.BAFC..PFDChAAAMEABHBFA..VCBBhABAaBBBZFEFSAFHhACA.dAHAAIAG.XFAC.CDFBNIEF..hADA......hAEA...,1,-15,-33,18
bFNZJOKCfYTEXWgdLBeDUPIASHcMQaVGR,SCFCHFACQEEBGGBHFAAFZEFHODFACCDE...fACChACATBAGEDBAgAEAhAEABAHFDEEBPADGhAAAIHFA.AHIBaAHD.......hABA......hACA...,2,-28,-8,20
deHEVWBbJSDCPFKGUYIALQTRgcOMZfNaX,LDCHTCCB.RGFAOEEHZBAH..NAGG.aGBCdFAG.HDGB..hAAAVBECBFBH.JACCDADEhAAACFFGKHCAUCAE.AABB..hABA...cFDHMIAE......hAFA......hAHA...,2,-27,-22,5
PUYDWeLQcEbSaKZGgFRXdNVCMfABOIJTH,BAFBOEEGJADBHEAG.UACGDAADLEHF..QAGAhAAAECBF.SGHHhABAKEFDZBFA.gGAGhAFAFGEHdDEB.NDDFCFGAAAHC........hAGA......hBAA...,2,-44,-18,26
ceBHWCdgJIQYbXVFZLfDSPNEGOTaRMUAK,eCCHHDBHdGBD.JAAFQGDF.XADAVAEDLAHBhABADACBSGBDEDDETFGAhACAaAHHUEGE.AAGHKDAEhAAAWFFFIBAG.FEEC....hABA......hADA...,2,-18,-16,2
XBfKMeFIJTSVbQRLGNZCWaYUOHDAcdPEg,dHBHEHBGBHFDMBEFFEGF..TAEF..SBAGQEFGhAAALFBGGABCCDACaCFEhAAAUAGEHFEBAHEDcFDGhABAgCBA.KAHHJEAB......hADA......hAEA...,2,-19,-17,2
VFTgYNHBMJWfbISCKZaDGQAUPOXcLRdeE,UDACODACLHBEdBCB.EBCAFFHB...TFED..YEFBhAAAHGAGBFAGMCIHhABAJCFG...fBAAhAAAIAGHCECBKFCCDIGAAABE.XAED.hADAcEDE...hAEA...,1,-26,-31,5
VdUWeSYTJNFBMEbRZXIOfPADKCcaQHgLG,DFEACFED.QCBCLCEAdDBBUEGCeHBA..TBGHJACCFBACEGDAhAAAZDFE..OFAFhABAAHHBKFAB.aAFB....hACA.gBDD......hADA......hAEA...,1,-23,-41,18
efGVEUZPYBDFKRTACJcQXWHgLSONbMadI,CAFBJDAC..QFDDHAEGSGGEODECMDCBdBAB..eEEGhAAAVBCGUGDFZAGBBAAChACADCIHKFAGAEAC....XGGHhADA.WFFE.....NIBF.hAEAaHAC.fDFBhABA..,2,-25,-24,1
EeQJdXHTRCOAFLIBGabScDPgUZMYfKWVN,LCCHBECDaHEG.SAGDDDBF.UEGHZAFBMFIHKHDA...hAAAVACBNBEG..eFABhABAJEFG.HCAB.CHHEACIHFAAFhACA.ICHD.....cFAChAEA.....hACA...,1,-28,-34,6
VOdBMDSHcJbNLWXIgPZfEUQeYFRGaAKTC,KFFBTGDCCAGD..dCGABHAE.DFDCHBEB.JEBFLBFA.hAAAXEAAPFHBEBAFhABAUCBD.eDGD.FACGhAAAaECAAIHE.MAIBSGGANEAA.IAGGhABA.....hACA.fCBF.,2,-23,-17,6
MXfYFVEPUdBAeZaDCHbgLOGQcJWTSNRKI,eDCHaGGEHGCALGDGGCFAJCAG..TCDDSFADKFACMACDhAAA..fEFBhAAAFGAHPBAFUBGA.AHIDCEABhABAOAEA..WBBENIEF.....hABA......hADA...,2,-25,-7,18
OUFHNAfXcBKCMRPSbdWEJIaYeTDQZVGLg,XCBCKEGDMGCG.RFDF...SDCEdAFAEAAC...JBHDaFFFeACChAAADDIF.ZCABLDEEhAAAOFHD.HACAABGGBHAGhABACHHCWEAD..IECA....hACA......hAGA...,1,-15,-35,20
fXTGKSBOEgLMWeaPHUDACZRbNFQJVYcId,ZCDHRAADFEFGQBFC..JHDCVCBF..ICDHdFGATGAAhAAAKHGC.BFCA..hABAEBFG.MEAEaEGAPACAhAGADAFGAAID.CBBCNIDH..fFCB.hAHASFGA.hAIA...,1,-13,-44,31
LgRfJIaVZNOdUeXWEKSPTYAbDMGHCBFQc,MCHFGCCFBGAGQACGLGDERFBHJAAF..ICDEZEGBdHDBeAGBhABAEAFG.KEAHPAAEhAAA...AICGDEAChADACAHB.FDFB..........hAEA......hAHA...,2,-37,-15,22
IAOeTgLFSbGQEHRJDYKCWdMcNBXUaVZPf,OFCAeDACLECCFBCHGGEFECHHHAFC.JEGHKCEC.dDGGNBAB.XDBGhAAA.aAEGPFCChAAA.AGAESGHHhABAQAGADEIH.CBAD.MIAA...hABA......hACA...,2,-26,-6,20
DdJUbRWeZNaSAcBEfGKQMPCXOTYHIgVFL,EEGDKGAHQCDE..PAFHCFAFOCGHTACB.IAAGhACAFFHBDFFDdCBG..hAAAJEAERACAZFDFSHEEhAEABBAFMAIF.........hAGA......hAHA.XEDH.,2,-25,-24,1
HOVSMfLcPdbeCUGXZRYaETNJIFQAKgBDW,BFEDHFDGOBAASBFHLAEAdCHCeFFHCHDFUCFBZEBB...aDCGhAAAEACG..JDADIBAGhAAAACAHDGHD.MCCG.hABAfDDB.......hACA......hADA...,1,-26,-29,3
HTgefEOKQRGbJPXcYdMaBWIFLNZUVACDS,CFEASEAEHFBD.eEHBEAACKGAFGGBB.JEFFXCBF.hAAAdAFFBBGAFGHFZEFBADFEgABHhABAQBDCRBDF.hAEA............hAFA......hAGA...,1,-20,-25,5
DXWGVQIeFYgOKdaEJRAbNfLZHPCUSTBcM,...bBGFLHFC.ZEFACDCFSDEBBHBGMDAADCEFGABBhAAAQAACIHADFBGAhACAOGEAdFDE.aCABEEBHhADAAIDGNCIE.HECD........hABA......hACA...,2,-28,-14,14
SMTgKDVHaLBdJWEAbRcXGPZNOUfFeCQIY,RAADXFGHGACFZGFAUCGEFDHF...eDCCIDDC.MEBBhAAAKFCGDAHHHFEHBEEHJBABAIBEhABA....PFABhAAAfFCGCDAD.SAFF..hACA......hADA...,2,-29,-29,0
JOdPHBFfQAKRYMWaVCESbeTZUGLNgXcID,KCFCRFACMBAE..aFFFEEFC..eCACUCCHGEDCLHFG..hAAAXEAADICEdBFBBGGDhABAfDHAADAC.YABChAAACEABSFDHTGAANACF.IAGFhAFA.OFHD..hAIA...,2,-26,-22,4
LBRDTUYIEgcSGJXMHKfePdQCOFbVNZWaA,LFCABFCFRDDBDGFBUBEF.EBBB...SGABXGBEKABEhAAA..PHCACEBCFAFG.hAEA..NEEFZDAEAHGE.IACAhAAA.gGGGJEHFMAIFfBDChBAA...hABA...,1,-25,-46,21
GWfPLAcOKJNgIEbXUTSeQCdBMZaYHFRVD,KDCDJGEA.....NDFG.EEAA.UDGFeCGBdADABCABZCBC.HADHRFAA.hAAADICC...fGGAhAAAAICAOBAA.bGBCSHCEhABA.CAHC.MAFE.FDAH..hABA......hACA...,1,-29,-32,3
CFAYQPNMBJLXODdefEWVaTHGRgKIbScZU,QCBCMCCALEEEDHGAdABBEBGH..aFFFHGAG.GDEBKBAFSHDChAAAZFDFFAFDAFADNAAEBDBAhABA.OEAH.hAEAfGBF.......hAFA......hAHA...,1,-19,-23,4
bPeHKVdLJETaRCFfUZXWQOSDINcGABYMg,BBFDMCCA.....PCBGeEFFHEBBdEBDLFEBEGHDaDAGCGADFDHDhAAAZAFA..QGGGhABAOHEESDEChAAADAIBIAGB.NCAEACHBbABC..KGDD...hACA......hADA...,2,-23,-14,9
gbZNGMOJUSEeRKTPDAFHCLXQaBdfVWIYc,CCAHLDCH.aBABBEDD.dGFA.VBEHICFE...hAAAgGGEbBGB.hABAGDAAJACBUEACSCHHhAAAeEHHKHAAPEEBAAHC.FHBE.HAGDhABA.XBCA.hACA...,2,-33,0,33
cDHgWQPIKOYGRZdVEbFBUefMLJXATCaNS,TGAFaEGD..SDDAHCAAQGDFKAAEGEBCZEDAdCFEEBEGBHHGhADAfAAALAHBhAEAAIFENDIE.DBCF.WFFDhAFAIAED.RAGB.FGDD......hAGA......hBAA...,1,2,-22,24
ZCSKWFbdcERQBfMVOIaGXeNUAPDHTgLYJ,HFDGTDACLCDG.ZDBCKEEEFAEFbBCAdCHG.EGBGBHHE.MFADhAAAIACDGBGE.hAAAXGFFNIAF.ABBCDACChABA...JEDFWBAFcGBAfAGFhABA.....hAFA...,1,-12,-21,9
IRQCMEZeNcLFUabYVTJAOdHDPWBgGfSKX,ODCHHFFADECFBAHDGAEHKAAB.RFDB..MDBAZFFHeACGLCAFFDGA.hAAAUDFF..aGEB.hAAA.YHAAJFHFAHCEdEAEhAEA..gABB..fDEDhAFAIHHG.CDDDNCCF..hAGA...,2,-29,-2,27
UGTNaDJgeKcBAfIbHSMQVLPYXRCZdWEOF,..IFDGHDDFQEAELBFC.XADDCBDFdDDF.EHEEOAAFhAAAFAAFUFGGGCGEaAHBDICAhACAeHAGBGCHAIFASFGDhACAMAGF.YCBBWDAE....hADA.NAEF.....hBCA...,2,-20,-6,14
KRbJCXYWMaDAGBIPdSgZQcVTEFfeOLHNU,GGDHBFDGdCABSCHDQEFE..TBCGFEBB.OEDGhAAAHAFHKHFAJFAB.CAAC.XBAHhABAMBBAADEH...PFFGhACA.ZAEFECHB.LHAA..hACA......hADA...,1,-5,-29,24
ePaMBTcbICOKERGfWQUVXNFDYLHgSJAdZ,dDBDZFDFaCEFBFAE...TGFG..bGFACADE.KBAARAAE.GBGGhAAAQFCCUEBC..NABH.hAGADAGCLHAASFFEhAAAAFGDMDBEICGE......hACA......hAFA.fCDB.,2,-30,-9,21
gSGOCKDAIZVQJHWENeUbcLXBTMaFRYfPd,ZGFGQBDGHFAEECBHUGDALAFHBEFBMBCFFEGC...REAE.PACEhAAAdGHG.GDDEhABAOBAH.DBGGICHEhACAJCHFeHAC..........hAAA......hABA...,1,-5,-24,19
HeJPbaGYMXfUQZgWLTcIARFEDNCOBSKdV,RFEEDGGDOAFDKEFFHEAH..JHDAaCDF.GAAFMEEC...XGDDhAAAUEAEQBBDhAAAZAEFLDAC.TDGDhABAcACFAGCEEAGEBBAC.......hADA......hAIA...,2,-32,-7,25
HgARfCSNMYZLDWTUBXKaPcEGeFdJVQbOI,CFDDSGFH.MAGBLCAG.DGGGUEAGKGEHaAHBEEDCFHAChAAAdDEH.QDGAhABA.IBDDADHHfGAEhAAA...NBCD......WEFAhABAXBBD.cFDDhACA.,2,-45,-36,9
CDQBHENfdFSZPLbKOWVGXceJUAIgYMaRT,..IFDGMCCARGFECHEGBGFB.HBFAEDDFdAAFSCAEZBGD.LAEFhAAAKFBDOAEGWHAAhABA..XDAAhADA.JFDEAIGCaGAA.DFIDNCIE.fEEBhACA......hADA...,2,-31,-19,12
cCafGZTAVeQRDdSHOKYMJFEbPIXLNWUBg,eBDGQFCARFAB.dBBDOFDEMBHDEHAE..PBADLDEHhAAAUDCCBEBD.CHHAfHFFhABAGCGEAAECDAIHSAGChACAKAFA.FAEBIHHA.WAAChAHAaDAG.....hADA...,2,-19,-17,2
fOAXEcRJQPKaDSLICVgWTHZBGFMedNUbY,EGFCRFDFQAAEKAGA.DCDDSEBD.CABA.gADGhAAAHADBBCFAFBGAdCHAUFFChAEAbEEC.OFACADBG.XCEAhAFA.PHACIHDG...hAGA......hAHA...,2,-30,-16,14
KEFWXRVLeQICaTGMZbONYHcDdPfAgBUSJ,UGGGSEEDKGCA.EDBHFDAB..RDFCeCACCCCE.GAEDMEDEZAGHhAAAOAAE.HFCBDIBGdABFhAEAfGHABCFG.hAFAXFAC........hAAA......hABA...,2,-48,-7,41
YRCFgLEADHcGZKPbeWIXdVaJBMQTfNSOU,HFDGGEDHKBDHeFHH..XBACVABHBBFCQDAD.hAAAfBGBSFAAhABAUGAHYHCACEHD.hAAALAEEEDFADDDH........hADA.ZCEE....hAIA...,1,-14,-15,1
aSEYfgCBcXJZMLeTGAUVRIPDdOFNQKHbW,VABHRAADDAGC..FEBCKBEC.HGFE..aGGEEDDC.....gBGFhAAACFFGBHFGXDEAhAAAMEABeFEF.ADAC.hABAUGCG.dADH...NCAE....QBGEhACAWECDSGAHhADAfCDA,1,-26,-33,7
AGSJNFMBEgbTWfdaQOHPIYXRceKZVULDC,SCCGFDCDBGDC.EEFB..TADAdHEFOACGHBAD..IEHChAAAXBGG..eFFGhABAZGACVEBEDAGACCHGAEEDJAAFhABAMBGF..bEGFaFAD......hACA......hADA...,1,-9,-29,20
RbgGXJYKfLESaMNBcUZIHdVDeAPCTWOFQ,TGGGFDCDRBEAGEED..JDGBKHEALCDE.EDEFMCAABAABhACAZEAFdAEFeADCCDBHQFBAhADA...hAAA............hABA......hACA...,1,-27,-36,9
CUgAYQabKcSHZVFeTPERdIOXBGJfNMWDL,aGFCKHBGHBFAZDAF.FECHeCFC..ECAGdDHCOEGFBAGEGABEhAAA.JDDHMAED.LFEFhAAACAECAIHG...hABA............hADA......hAIA...,1,-33,-34,1
RebfXDAdgaEPFSJBKUQcMIZLYNOGTHCVW,dAFBaAFB.EFHDFBCCBDGB..KFFDUBAG..MDACZDDFLHCEhAAA.OCFHGDEFhAAACEAD.REAEfFDAhABAAEIB.PHAESECDcBGA.IHGHhACA....hADA...,2,-32,-31,1
MJFEKRCIdYSBWOVAPQgNDGfceXaTZLUbH,QCBCDACBGDFCeDCDaACE.ZADFUDFHHFABFHBEKAFB..RBFCCHHCdBAChAAA.BHHGOFBGAICA.hABA...PFEBhAFANBAAXGFB.........hAHA......hAIA...,2,-24,-17,7
TUAOBSCZgFEKcaGRHJPfdbYVMeDQNWLXI,SDABZDBHEDDG.KBAAaEHBGDDFHBFBJABEdAGB....bFCDMHAAhAAA.QGFGhABALFHBIAEBhAAAAIBACFAH.FABAcAEBfGGA.eCFE.hAHADECH.....hAIA...,1,-1,-18,17
QFfINXJWRZaLMEKgTbSBAHUPVeYcdCGDO,UFDHVFDF.eBAD.dBCFCDFBGBBC.QAGAICGCJEHFhAAARFAFZFFF..LDCEhABAEADBKAAB.TFAFBAFCAEABhAAA..PAFADDIF.fGGG.hACA......hAEA...,2,-17,-16,1
TCgOGUWPSZBaIXAQeFVcdKYEJRNbfMLHD,QGGDeDCHFHGAdHBFECCA..RFDC...bAFDLADG.HCEEhAAADGEBCADD.GEEBhAAAUCAGSBGAhABAaFACADIDKHBANBBA.MFAB.........hABA......hACA...,2,-21,-13,8
VGYNDaZedXBgObPfACTKRHFUcIEQWLJMS,CFCFRBCFHFAGFEED.UFFE..EAABLAEE.SHCAhAAAVBGFGADGDFIBeDFCdGGHBAGFhABAOCAD.fABEhACAACAFKDAA..cFAC....hACA......hADA...,2,-37,-10,27
USEVQdgATWBRFeJHbfKLGDOaYIPCcZNXM,BHHGRDEDFEAEHBBAKDGFDCEF..aCHB....IGBCCGGCZGAAMBDGhAAAUBAD...EEHF.hABA.dFHAAEBH.eEDDJFDFLAFChAAA........hABA......hACA...,2,-50,-21,29
aGVbMWBQgcLIZHfUETJPAKYeOSFdCRXDN,eCCHOEGHdAHGREAF.DGAFGBAH..VEFFMFDBBABG...hAAAQAEB.hABALEEDZADAfHEDhACAECAC.TCGAAAAFSDFEFEEHCAHCNEIE.aGCDhACA......hADA...,2,-28,-11,17
EUFcWGRZXeabTICLVNdfAHYgPQKOBMSDJ,HAAD..gDACQFCCKFFDBAEADIEAEAGDFDEGGEAAhAAA.RFGDeACHaDFGIFCAhAAACAHC.LABEhAFANICBAHEG...........hACA......hAEA...,1,-15,-33,18
aLGcUDBETRedHZOKVIgNPYCWfAbJFMSQX,FDCDSAGDQAFELACBUEFEBHHGTFCD..dBBDHFFFhAAAOHBEKCED..IAEChABA..NBECPDABhAAACAHGWCBDAIHE.MDIH.aEFGDFIB.eGDGhABA......hACA...,2,-28,-11,17
IPHXFbGZSfOCULgAVEJNaBQWdDYKeMTcR,VDEDJCCHBFGC..dHCFDFCFKGGB...eAHBMIDERBCH.HADE.hAAAFFEFGCAEZAGB.SADEhABA.OAGHhACACAACLFADABBEaFCC.WDHH....hACA......hADA...,1,-13,-41,28
UcVfMBQSYOKdZFHJXDgebPGaWARICELNT,CFDDLCCHUBDH.VFDEBHED...QDABODBBKHGEFHGAHAEHhAAA.DEAHeEDEGCGEhABAaBGF.AHBDEABA..hAEATGAEMAID.SBAA...hAGA......hAHA...,2,-37,-11,26
UESFcTLaWbXPdYRCVJGODHeNAgQIMKfBZ,QCBCMHFGBEFGUBDBEDFB..FFAHLFAFaHGE..bBFAXBGEhAAA.dGBDCADEGGDHhAAADBBBHDACeECFhABANGED.gEGHKADC.fBDEhACA......hAFA...,1,-10,-22,12
bBaGSRTDLJfYgHZNIcFQVMKPEWCUdOAeX,eDACBHHGaEFGGCFG.SGBCRAAFDGDFLCCEJADA....hAAAgAAFZEAE.hACANBIC.FADG.MGFGPFHBhAAACAHBdGBCAGAD..TEDEYCHHIHCEhAGA......hAHA...,1,-18,-26,8
dEHDSZJQVfbXcCAPBIRgMGLYeKFaTWOUN,BFDGRAADGDGELAEAKFAC.FDBG..aADFTDEDUGAD..EFFDDHFEhAAA.ZBBA..JCEG.hABA.QGADhACA.fDHGXDBAAGEDIFGHMBIF.hAAA......hACA...,1,-26,-29,3
HLJRUABeZfCWMTNODcPaGIXbQKYFEdVSg,BEFAeFBBZDCFCHFD.MCFFODAE..DAFA..aGCDXAGEhAAA.QACAhABAFBFHVACFHEGBLHDEJAAFAEEBhABA.....fAGBWFGBNCAE.PFADhACA....hAEA...,2,-35,-17,18
RFBKJcVgYfOLDWQAETXZMeadSNHCPbIUG,EEHBXCCBZCCD..aADAdEEB.HCFG.CAHA.IGCAUFACRFGHBACAhAAAJBBH....VFEBhAAAfCAADIAAAHIBMBGHhABANICB....bFCAFBHF.....hABA......hACA...,2,-24,-19,5
SNgbCWRKLMVZDPIeOcadJTBYGQUfEAHXF,FDAFSHBG..NBBH.CEFDRAFEKCDA.LHDEMBCBZFAE.DAAFeGBChAAA..aEGDTFGAhABABHHFQADAhABAUBGAAFFA.XDDB.bGCAWDCG..hACAPCAD...hADA...,2,-36,-10,26
DXPJMBNUcHLATgVebCQfOSZRYIdKFGaWE,VEFHeAFBCCEG..OBFHZEBGRFGF...dFABKFEGFCCGGAAF.EHEGhAAADEID.XGADhAAA.JABENIAF...HGCEhABALAHFAEDB.bDAG......hABA......hADA...,2,-25,-17,8
HaYFELJcgOINVGBACdXZQeRfUMWDbPTSK,CFCFZBCFRAFA.UFAG.DHEA..TCAGKAEG.HFFHFCGC.LAAEhAEA.JCEBOFGF.hAFA.IGAH.hAAANDICBGDEAABCdEGFXEDAfBBBMIACWHCGhAGASDAA.hAIAEAGG..,1,-26,-38,12
DCOMHYIdZWgKLURbTGXBAQNEeaVJfPFcS,EGFCeDCH..JFCBFHGA.SHBC.CAGF.OEAGHACCdCABhAAAZABGKBGCRDGD.TCFDhAAABEFDAICCQEEChABA.NDAF.fFAADAGAIHHEgGDBhABA.....hACA...,2,-30,-15,15
NDXTYSMBHKPEOFcJbCLAfdGZIQaWgRUVe,GEAHQFDHaAACRFFAeBFD.DIGA..TDEGSADHHBCFEAGDhABAFAGDJAACCBEF.LDAFhADAACAAfDGBdEDBIGGEhAFAgGCFNCCGMCIH.BHED..hAGA......hAIA...,1,-1,-12,11
agRDQXBSMUGdHTAcOCEFbefINZPKWVYLJ,OAFBCEFAFAGE...eCBA..fHEFIGDAZGFEKAAC..hAAAVCBGJEAHRDFB.DCIHBGDBhADA.UFABdABCAIBEEBEGhAEA..bDBA.NAHE.WDFE.....hADA......hAEA...,1,-20,-34,14
ROdXEHTYAQeBSMFgLWNbJCDfIcZGaPVUK,eGFAMAEELGDA..WCHHJEBBCFEBDDAA....IDADhAAAZGAEPBFD.KHDAhAAARBCDdEGBEBAA..TEEGhABAAHIDSHFAFFAGNAEG.fABA.hACAaAGE.....hADA...,1,-23,-28,5
IBWSPFUTHeXEYQVZJNGbOKCMRcALfDgda,LFCHDACBdGHABEDCSAAF.FBDETFECHCAF..EFFEVBEBhAAAJHFE...GBAEhABAKFADCEGBMBIHAEHC.aCCChACAIAGC..WEEDUFAD...hADA......hAEA...,1,-20,-31,11
OFTcWGIfCVbAZHEPUQBdMSLNDJYKReXga,HDDFUGBCBGFBdFGFSAEHLEFADBECJCAG...KDBBeAGF.hAAAaHCAOFDD.FDDBhABAWABGGAGE.CHGH.hACAVEAF.AHHB.EACHMAIF..NEAE...hAEA......hAFA...,1,-14,-27,13
RgObNIaYCFUDQJTWdcVLHKSeMEXGBfZPA,RFDFOGEA..IDDDCACEDFDF..QAEBTDAF.dEFHVABBhAAAKHDA...SGBChABAEAABBCDF.PAFBhADAABIF...bDFAYFAD.FCGBJHFEhAEA......hAGA.WHAG.,1,-12,-37,25
VOJLURQaeYbNZBMEcFXgdSIHGDAWKCPTf,CFEDTCBC..VDBHJFFG.LAFG.UFFGaCGEeECH.hAAA..NBEEBEAEEHDEFABChADAdAGEIDGGDAAAAHED.hADAKGAAPFABOBDF.......hAEA......hAFA...,1,-26,-31,5
bFSZOLXGIUcfCMYARNHDEeVdgPWQKaJTB,RGFGDHCEeBEBdGFB......PCBAQBGGKDFD.TDCChAAAFEBHZAFAOHAALAAAhABAXBBCUDGECEDAMIDGhABA..AAHA.EACA.WFBABCAD....hACA......hAEA...,1,-8,-31,23
WFgGaOScUNJQMLXPIbARBTZVDYefEHKCd,BADCZABHDFCGeGEAHFAFdBEFFADHGFAF.OHACSGFC.hAAAUCGGNABE.MIFA.hACA.PEDAAAAH..hAFARCEF............hAGA......hAHA...,2,-32,-30,2
SHPYKMGFTWDcZRfJgAXEVUINbQdOBeLCa,VBCFUCBC....IFDGQDFCBGFACEBCHGCA.KCGEMBBGhAAAFAEADIAAZAEFRBGDJAAEAHAA.hABA.EEEEdFCB..eHAAhACAaGGA.SHFA...YDAFhADA....hAGA...,1,-19,-28,9
JgRNbFLYUZKEBVMGfcaCOdeQAPHTXDWSI,TFDHXAFB.DFCFSFFE.JDAGNGDHLDEC.hAAAZDABKBAAEBAFBECAMIFEhAAAcADG.aGAACEFDeBHBhABAABHG..WHDG.....IBFChABA...hACA...,2,-33,-28,5
dPbCBaMEQIDFSLVgHOWKUNfJGRXZTcAYe,dDCDCFDGBEFEaFEG...EACBDICE.LBCAHDAGOEHHKBGE.UAGFhAAAJAAFGEAERFAH.ZDFAhABAADAGeHDA..PFHBhACA...bGDAMDDC.IBAHhABASAEC...hADA...,1,-12,-27,15
CSRdWcKbNEeVJFPXDaTOUMGIBgAHfYLQZ,HAADLGEAQFDCZADHSCGERAEBdGGFKDGHEEFEeEAF.FDDCDAAEhAFA.aCBGUGBAGDBEhAGABBHAAEEHCDGE....hAHA............hAIA......hBAA...,1,-16,-25,9
cWNDVBRKZIPLEJMSGbYfgQOHaCXdUeFTA,...NDDG.DFCFBBHCZFDFLAAC.EAEFSCEGGCBD.hAEAfFGBQGGFhAGAaAAECDGCdAHEFGGHAAAE.VDAFhADAKFGC...IFEG.JHAA.bADEhAEA......hAFA...,1,-21,-31,10
RDEQGNKTZcaHMVbFfSLYXUegWIPdJABOC,BEFAOFCACHFE.DGDHGFBH..TGEGaCCF.HAGB.MDDChAAAbBEG.FCADLFADhAAAUACCeFBB..IABHhADA.JEHBAIGAEGABNAEBKHDA.....hABA......hAFA...,2,-23,-19,4
cDCAKGVBdUbLTRNPgXIYJFEWfeSMaOHQZ,KGFHGCCFdDFFUDBHLFEA.REBF....PBAFXAACJAEA.hAAAEAEA..eHCAaGCE.hABAOBHFQEFDhACADIGAACCABDGA..NCDBIHAE..hADA......hAEA...,2,-35,-15,20
FaGAQEeOLVWKCJUTBPdZRcXgbSDYHNIMf,QGGDeFFBOCDHLCDFKBFH.UDAGTEABBGEG.dBHERGAC.hAAAXAEFSCAAhABADBBG.NAED.MCGH.aHAChAAAAACBVDGFCFFG.........hABA......hACA...,2,-24,-16,8
ATHJXQRaOMPbFLIEeZWScUYBfNDGKCVgd,HADGJDCH.XGCFQEEARFEH..aAABMAEAFCDB.EBACZAGFSGCDhAAA.UBEDhABABDAADHGAKHGA.CEFE.dDAChACAAFDA.ODHH........hADA......hAIA...,2,-26,-21,5
LTABeKNHMCQRWDJFgbPGfcUXSEdYaIVZO,KDABHFACMCBARBDEDHEA.FDBB....gAFDGEDDUAACEEGE.hAAAdBHC..aHBAIDDDhADAVFECZDBD.OABEhABAAAFFBHGHCHHE..........hAEA......hAGA...,1,-18,-26,8
CdPQgUeEZGaLIJATYKBNHVcOWfDXFSMbR,KGFCHDBHOHECDEGGFGDD..MCGFCBHF.dDHAQBBD.UFFHhAAAZDBAaHBCLADAhABAIACGAEEGBHAE..hACANAFG....cEAC...fAAEhABA.SAGEhAEA,1,-31,-38,7
JSgQCLIaEAPDYFNZeWGdMHVTcKRbXBUfO,DACBFHBGZACBeBDCdFCHHGDG....TGEGKHAGXEEABBEAUAGFhAAAODAF.JCHFSBAHhABA.CHGHLDEAhACAaGCGADFGNADBMAAF......hABA......hAIA...,1,-25,-30,5
dbUJgcMYVEXQAfTGDPZeHRNKIFCBWaLOS,TFGHGDCCDAHB.eHEARDEAKAGF..FBDACAAFBECGLBBH.SGCDhAAAdHDBUACCJFAFhAFAMABE.EEHHADDF.fFFChAFA.........hAHA......hAIA...,2,-42,-16,26
JfcbOPUVYWBCHeaTDEAQXdSIGFMLKRNZg,QFCAdFHAGDDDMBEERBABZDEB...JDAH..fBGEhAAAOCDGUBBG..WFBDhABACHDGeGDEDHFCAFAB.IADAhACAKHAA..NAAF.cDCB....hAFA......hAGA...,2,-32,-23,9
fbLVQGWTNJHIcMCSPdYKBgAaOFZUXDeER,aEEDODCHZFCF.UAEADAIB...EDEFRAEGLABHGBGG..TAAChAAAJEHD.HFFHMCEHPHAEhACAKHAEBGFA.AADE.hAAAFDAB....fCGA..hAGA......hAHA...,2,-36,-7,29
PUaKMBTXeZQSYcRCfHJFOgWIGDEANbLVd,LGEAVDAG.UADDMDDEBBHA.eDFEQGEC.SHAAhAAARBADCFFDHDDAOHBChAAAIHHEDEABAADDdBGDhABAaGBA.XFBA.YEFE.fABAhAEA..hAFA...,1,-22,-29,7
QdeRXJHNaWDVCcTAIBLGgUSfZMKEObYPF,BAFBGECFSCECMCAHOGAE..bBACFHGE.dCDHRGEAHFBGhAAAaBGC.DDBHCCBF.AIBGLDDAhABA..fAAFhAAAEFGEPAHBQDGE...hACA......hADA...,1,-17,-23,6
CRHMagOFeAVSLXDQEGJdYBcfUKZPbITNW,VDEDSGDD.DFGHGBAH.JDADBGEFUGBDZCEB.IABBhAAA..NIEHCADFMBDGhADA.OCCFAGGALAHFhAAAQCGHdFHA.cAGF.fFAAhAEA.KFHB.hABA...,2,-29,-24,5
gGCeWfKYSXFcVALPTJDIEdROZaNMQBbHU,LDACTDAC.JAGFEGAH..OGEEZAAEaEEH..QFBChAAABGCGUAFHCBAE.eHFAfEEHhABASFFHFBEDAEIHhACAICDA..NIBD.MBIFgACFhAFAKDGB.....hAAA...,1,-16,-21,5
APTKbJEYgafMcWLICNRHSZedQUVOFBDXG,KGFCEDCD...aDDDMDHBLCBHCBCD.HAGBSAADeADCdEGBUBGBhABAOAAGDGIFXDAHhACAAHHF..TGDAhAIA..bFFH.YGACfBEFWAEDhADA...IFEDhAFA.NIAF,1,-26,-34,8
CeYWEADJfOVNHbBZXdGgMUIRTaSLKQPFc,DEFHJEEG.ODBBHADABCABZGCA.dFACGAAFUGDE.RAFA...aCFESHGAhAAA.KDFEhABAFCCHCEDD.eAAA.EGHBhAAAAADEVEGB.NIAF........hABA......hAFA...,1,-17,-30,13
HTPCGQNWgeDXMLFKaABRUVYSEcbIdfOJZ,BFFCUBBH.SHEAEGDC..IAECOAEBHBAGCCEE.GCGEhAAAQEFB.hABANAAE.eFHHDFIDXBGDhABAFGBDADFGYDAH.cAGGfHAFhACA......hADA...,1,-10,-38,28
SVLcYOfEMAPeRbTBaDCQHNFZUWgJIGKdX,eFBBTFDHDEFF.HACDZBBFUFAA..gCECJFHDGBDFdFHGhAAA.SGGDhABAVDFC.LAHDOBAHMAAGhAEAACADRECBBHEHCAGGNIAF.IAFE.XCADhACA....hAEA...,2,-10,-8,2
gfKQVWBDOJHSAdRFYNLXZPITbMeaEcGUC,dEHARDAGFGAALABEZGDE...TCDGMEFCEAFCUFEH..CBCH.fGCAhAAAKADE.QCFGhAFABCDHJAHBACADNBCA.hAGA.XAGA.IHAFaAAC..hAHAgFGB.hBAADFDCSHFG.,1,0,-34,34
CIcVTSaEgFHAOfQRdbeXZNWULYBKPDJGM,ODACREFHeAFBZDCAUBCELFCDBBFA.DACGMHCA..CGAA...hAAAVEGFTBAC.SBEDhABAEEEHFBHDACAFdAFFhAAA..XAGB..NIEH.KDHB..hBAA......hBCA...,2,-29,-22,7
KGZDBNAVFLaHbITJdOCYUfWcSgRXMQeEP,VDEDFEEDLAAC.HCCDIEBHdBFFOHFECHDH..UAAChADA..fFAHhAEASBHHgGCBhAFAXGGBeAEFPCHDZDCFBHAEAIAGaGAG...hAGA......hAHA...,2,-17,-16,1
AWVZJPfEDeRLQgGOXBMSCTHFcUaNKdYIb,VGFGZFDFJBAA..EAGADGGG..LADDGEBEBHFBMEEHCCHEHBFDhAAAUAACKBDE..dEBB.hABA.IAHCAGCF.hAFA.fCFBeDACgDED..hACA......hADA...,1,-25,-27,2
NTKRCUAGcVDQFLYEbdXgIMHeafJZBWPSO,GEDHDHCELCDGEGGHdAAB..XECAMGBCHBFFeFAFaDAEJFHDBHBFhADA.SBBAhAEAOBCAKFFBCAFC.AAEEQBAGhAAA.YBHFIDDE.fAHAhAHA...hABA...,1,-8,-29,21
OKMXTCZFLIcGPAfeSbEdRYWHJUQDVNgaB,SDCDEAFBdDAB.RAACHAEDQBCA.DCHBNEACBHDHMDIFCGDGZGFEhAAALHFEGCGCAEEEeEAFhAAA...YDFBhABAWGDC..........hACA......hADA...,1,-19,-24,5
ANbVUXMKeHIgfdTWPDcJEaQROBFYGCZSL,VAADXGFB.KDAGeHBA.HEAG..gCFDfADFhAAAdAAETFFADEEDEADAaDEAhACAOBHFBAHDFCHDCAGHLFBDhACAAAGFNCDF.........hADA......hAIA...,1,-9,-24,15
WgBKOQfLUZVPeaRbIXYNJTCAMSFcHGdDE,FHBGHEBHDAGGEGDCBACGKFHH..QAGEUCDG.ZABDeFFFRADFXGADhAAA..NFAB.TDEDhABAAHHB..MBEChAAAcDGDdGDA......gCGHhABAfGGGPDAA.hAFA...,2,-36,-7,29
BXJDHWEdIgZPVYaTcFMUGbSeALNKOQCfR,KDCDQGDERFGDBDFE.JCFEHFCD..dBBHZACG..VEAFaFFBFAGGhAAAMADC.GEEFeBAFAABEhADAOECG.CAHEDAAAhBAAEEAF..ICHC......hAEA......hBAA...,2,-23,-18,5
fTEBOILdMCSPaGFKQXDWJVNZRYbHUcgeA,EGFCBAFBLBEEMBCB.CFEF.aFGDGCEB.FAAFKGDH.DAAHJFAGZBEGhABA.RFBFHDEDUCAFeHAChACAABIH..OEABhACASEHB.........hADA......hAEA...,1,-19,-30,11
SeGWTKQIdAMcCPUOVHXDYEFbaLRfNBgJZ,MBFHCFDGUBDHHEAH.DDIBEEHDFGED..LBAFRCBEBACDZCGBGGADhAAAKBAF.QFFChABA.IFAAAGHHOHAEhAAA....YCBHaAGC.NAIESEEChACA...hABA...,2,-30,-12,18
eAPHOcaNLKVgWUESQbGTRMfBXZDCYJIdF,HFDFaDCDLEHDKCBC..VBFDUGCBSABEGAEGMABHBAEDhAAADAIHCHGF...IACBhAAAeFAEAIHCOHAChAFA..NEACEEFFbFFAfAHE..hAGA......hAIA...,2,-20,-20,0
LbeJcAGCUOaYSDBKfZEPNITXgdWFQMVRH,CFFHUGGD..ODHHSECABADHZCAGEGBE.....IFBAhAAATCCHdBAH.FAGBhAAAQAFFMIBAVDGFhABALHCAeBEBAFAHaAHDKBACPEDG.NAIE.hABA......hACA...,2,-36,-7,29
GgYVFZRPaUISNXcWfHECLDeOBMAJbQKTd,JDACKGFCGCDD..VGFEZGCAaBBE.UDAASGBA.hAAA.NEIG.XEEGhAAA..fBGFhABAHACHLAFFDAEHOEEEACAATAGC..dGAEhACAFEAH.....hADA...,1,-18,-21,3
YdJLGSNCUERPQgVMKcFWIaBTOeZHAbDfX,DACBXCBCdGHAGAFC..CGDCRBGBQFAAMIFE.FDDEIABDhAAABHFGeBAH.ADCC.hAAAfHAFLHAA.hABASAEGEEGA.gEDE.hADAcFAB.aGGA.hAEATCEH.,1,-12,-24,12
gXSVYZOAedHWRfcUMGILCBPJFQbEaDNTK,eDCHdCFCRACCUAAEMAGBLEED.BAAEJAHBFGGBEDAE..DEIBKGDAhADA..XFAHhACA.VACGOCDFAFGD.hAFA.fDGFIGADCFFCbFGD..aHAE.hAHA......hAIA.NIBF..,1,-12,-42,30
PWSeAUQIHJOKdTbMBYLCgNGFfVDRaEZcX,UCGCHEFHKACEdBBE.MEBGLEDF.CFGB.NIEB.GADF..FCGEhAAADAGCaHAGZEAF..XBABhABASAAFeFAGhAFAAECH.ICCB..OFFBBCFCYAEGhAIA.fFHAhBIA,2,-40,-12,28
HabJVCQeXfGOEFRDNdBAPYKcTLIMWgUSZ,KHBGTDACLBEE.MGAAUDDC.SADEaACG.JGFECHEHeCCHhAAAGBABFEEEDIFEBBBGhABAACFE...PDHBhAFAIAHA.ZGBG.HCGB....hAAA......hABA...,2,-30,-19,11
cRXLTWPgaKYOSMHEUVGBbCDJedANIZFQf,ZAADQGBCRDCCLAHH..TDGA..gEFAhAAAKCAGSGDEHFABECCCGAEDhAAACGHDeGCGAGHBFEAGfCFGhADAXCCF.aAFFMBACBEACDACGNIEF.IEEChABA....hAFA...,1,6,-22,28
MRPEZUgCKBOLTFcSIVJXaAWeYNbDdfHQG,eGEA..bCAAdAEAQFGGRDAFEGCD.UBEFKDFABAHFLHAAhAAAFEDD.SEABhABA.ICHDXAAFhADAAGEENACFDIFA.fBHAMEFC....hAGA......hBAA...,2,-34,-9,25
HWLIOZKYTRecgMEDGSVbCFfQAJUaXPdNB,UAADXGBCdGBFBBFALECGZFDB...KAGCRDFA.eHFE.MGCChAAADDECGDAF..hABASCBGVFGFFAHF.hADAAAEGaBEH.NCAGWBFA...OEHFhABATADCEBBE.CHED...hACA...,2,-23,-19,4
NgMeXWEZLHKYcFQDUCJOVSaPIGdRAfBbT,BFDGTCBCMDBB..XDFHEHEALAAEKGGHFHDCUAFA.JEDAhAEASAEA.hAIAICHEdDHGAGGCfBCGhBBAbFAFeABCWGCC..YFBBhBEADAAF.CCED.....hBFA...,2,-28,-17,11
ZNQfaRgeCUWODIJYdcXBAKbGTFMLSHEPV,GEAHFBDHLFCHSBGAHDEFEGGDZGEAQBCFRFAH.eADEhAAAWAACOFFC.hAEADCAHJAGBdGAABHEBADEDKDHFhABAMEIB...PBBF.fCHAhAFACAHC....hAGA...,1,-4,-18,14
eQcFONdRIEfCXKDHAZSPUBgWVGJTLbMaY,ZDAGUGBCBCDB..VCBBTEFGLFFF..aADCeDHBFAGFOGDChAAARAEBEHGG.CEEC.KABAhAAADABFAEEB...SFCFhACAgAGB..WFAH....hAEA......hAFA...,2,-40,-18,22
VLeQKYUSTBfdCGIWOgRaJNDPZHEbcFMAX,VADGLFCA.eDDAKBGGUEFHBCBFCFHEGBAA..OADDhAAAaDDB.JFAFDFIHZEFBHGAAhAAAEDBA.FHDE..AADB..hABA............hACA......hADA...,1,-25,-36,11
gFYVZEcbBSUIGLKNOJPQHXdeCMTfRaAWD,DACBFHBGZDCFEGHB.BBCDUGAALFFB..OAFBQCGEhAAAdGDBCBAA.MDBBRDBG.AGAD..hAAA....YFHFhABAbCFD.GADFNIDBJADB....PAHFhABA.....hACA...,1,-22,-28,6
STBVQbGKXHYFORfMPIeUWNAEDZcgdCJLa,DEFEZAADdEFBLBFA..TGBHQDBCGACBXGFFhAAAFAHBODAEMAEG.IHDDhABA.UDDEWFGDhAAAAACHEADBCHDA..SGAFBGBH.KDDC.hAIA......hBAA...,1,-22,-23,1
JULATOWfMKRdIFGbPDVcgQNEeZYHBaSXC,TDACOGEA..MDAFKBBBRDDG..FCCHGGDBDDBF...VAGDhAAAQGCGEFAD.ZDFEhAAABACBSGAHhABACFDG.LFHBAIGC.fACF.hABAIAHEcADDNDIEYCFEhACA,2,-32,-21,11
WBMdPSZKNAQEIXYJgDeCLHTbFaRUcOfGV,EGFCXCBC..JBDDDGFHCEAG.HDFF.FABERAGBOAABGEBEBHGGhAAAdFDDZGAAADHGQAFEhABA.IDEFhAEAeEFE.LFADaCBD......hAFA......hAIA...,2,-34,-10,24
dPOVBYaGERNeHFJScbWUQfCZTgKIXADML,MFECdDCDOHEABGHCGGCBRBFF.HBEGJEAB.SHAG.hAAA.bABEQFABhAAAZFBBKEFFACAC.LBCFhABA..PDHFaADANBBG.......hACA......hAGA...,1,-11,-30,19
QINHCVKJWcZfDFGYgObMTPaAedXUSLREB,dAADXFCALFCARCDA.EEFEBABE.QAGFIADDCBHBJHACZGDEhABA..FDAA..gBDAhAFAOFFGbEACMEIHhAGA.aHAEAHGFSBCA...hAHA......hAIA...,2,-24,-22,2
WdPVFDOfTHbLacCUegRMZNJEGQSAYBKIX,KEGDXCBCdGHCFCDBDFGB....OFEHTADGLCFA.hAAACHBG.eGCC.MFCGhABAJACC.EEHB.QAGDhACASAGDBHHAPABBfFAB.hAAA.bFAA....hAFA...,2,-40,-18,22
VEbNJFcYGMCHKAWIPdRgBQaLeTZfDUOXS,..IFDGPDCHRAAABAGC.LDAFeAGBZFECDBIHOBFH.hAAASAEFEGCDJCCBFBFHhABA.GGEFCGCHAIFEdDAE.hACAaFHFfACA......hAEA......hAFA...,2,-28,-18,10
BLDHWcMSTCAOaUNXbeJFdfQYIRGgPVZEK,aAADUCGC...XEBAJFFCdCHA..QBDCRFECGABA...hAAAVGDGEGAABADC.hAAADGIBHAFEMDDETFAGhACACAGBAEFD.bDACFBEGfDFF...hABA......hAFA...,1,-7,-25,18
HEDgeMSTbOWacLQRZNGCAXFVJUYIfBdPK,VBCFJDAC..UFGB..IHEABHAEKAFHDDAB...MFBGhAAASGDF..hAAATEGHOHFEWGAChABA.LBBDZABECEECAFAF..XCGDFGGHdBHAEHAAhACA.....hABA...,1,-14,-49,35
HQPgfAbMIDEcRYJGUeXZFBaVONCTLKSdW,MCCADGHHEDEHRAGF..GEGAeGCGZCBBBEBF..OAEECAEFLFFFhAAAdEGB.QGBHhABA..PBADfEDEhACAAHCBIHAA.YAAC..hAEA......hAFA...,1,-19,-35,16
QKCbAfXOZLJcdTESRPIMBHFgGVDNaYeUW,XDACLFFCdAEC.EAAFRECDMEIBBCBCFFDFGACB.DAAFaBFFUGFEhABA.KBGACHDGAAGC.ZBGBhAAA....TGAEhACASHGAICCFHDBA.NDAE.YEEEhADA.....hACA...,1,-10,-24,14
RSMVOPIgbDUBaYAdEWNHGTZcefJFXCKQL,dAFBEHBGHAFBZABG.eDAHFCGFKEHBLCCH.RFDFMBIDOFEF..hAAAIACDDCCCBEDHaEEAhAAAAHGEGDAE..hABAfHGHCDDC.SGGC.hACA......hADA...,2,-42,0,42
GcBMfAVPOTUeERHZFSLYCIJgQNdaKXbDW,VFDFODAC.UBCEEAFA.HEFBZBCF.LAFCCHBF..JBAFNDIC.KGGGhAAADHCA..GBGEhABABCGHMAAF.AGCG.PFAAhACA.RCEB.FEEB.SHFA.hADA......hAEA...,1,-18,-22,4
GeLITPXbdFBfaOUWAQDgYRMSZNJEcVHCK,QAFBDACBRADBZFDH.JDDE..EAFEHGACKDGC.GAAELDCDIHGGhAAA..PFFGhAAAdEGG.BHHEfEBChACAOBAD.AAID.MFBFNDIACADA......hABA......hADA...,1,-6,-32,26
CMZNJPBIcbSYUOaWgHFRLdKAGefEQXDVT,eFEFQGBCDBGH.CECCZFGHJEBG..BBAE..ICAB.hAAASGEBUADDaHBCHCGBhABALAGBACADEGFHTAEGhAAA.MBAA.cEDBOEAH.FHGEhACAdCCFKCDA....hAEA...,2,-24,-11,13
efSgYCaETQBNPFUOKRVADMbXGZcJHLWdI,MCHFXFGHZCCCHFADdGCF..eAFASGEACCCB.EAACTDADhAAABAHFFEEHOEEFKACGAAEEhAAADEIH...cABGhABA.LCFEWFCBIHHCfECFhAEA......hAFA.aGADNCIE,2,-28,-22,6
DFYNSIZWCQeGJKXELHgVfcUdPRbTBaOAM,FCBDSHBGZFGF.QCCHJGAA.EFEBLAHFHACGVBFEhAAAUGEHRDAB.BBFF.AFIF.hAAADABG.IHHHhAFACDGGKEEH.fDFEdABF....bEAAaEHBhAGA......hAHAMAED.,2,-38,8,46
LXOTZbWeUFGVQdNKcYHRCBAgISaDfJMPE,SHBGaHFG.DHEGJAFG.ECCBODFHZDGH.eADAUFAHGBGGhAAAQAAFKECBHBBBhABABFDBAIEA..IEAFhACAfBDE.MBIFXGGF...hABA......hADA...,1,-10,-34,24
VBfEgCRcQObAaWTMdZGPDKIXLUHeNJYSF,TGBCdFEFGDBB.DAGGXDFAHBACJADAFCAB.BBGE.EEBCCCHCQDGBhAAAAIDE.hAAAaGHBMGFAZGCE.PABEhABA.IFDA......hAEA......hAFA.eBEF.,1,-16,-19,3
UfPQcXeDBWCSJGOdaRTgFNHKYMIAVLEZb,VDEDLDCH.ZEEGUCBHQAEG.eGEABAHD.CHDDJGAGhAAAdBAGRCFC.FGAFKGGGIHHEhAAAABFC..EEHB.hABA....fABH...hACAXEACDEIH.SCEChABA,2,-43,-22,21
ZQGJdDRfCAIePOYXNEKaBSWUHFLcMgVTb,eGEAOGEA..XFBFEDDGBAFC.UBGHLAAF.gEDBhACAbAAG.QDGDhADAJEBDdHDHDDAFfBGBhAEAAEHB.IHAD....hAFA.NBBHKCDEaHAE...hABA...,1,-6,-39,33
aTHSRfDgYUIbeVPZXQdBCcAJKNEMGOLWF,KDCDEGFHGBBGOCGBLHCEFAEBHFCASAADDDFD.UBGEhABAIAADeDEG.VADAhACAPEHD..XEGHhADAQGAGCBHE.ADAH.NGAD..MCBF..hAGA......hAHA...,2,-32,6,38
SJVLMBdRNAbHXQeFDcGUgWfZKPTIEaYCO,XFDHQGGDDEBDGAEA.UBAG..gAEHhAAAZEFGTEBGIDCDEHBGCAHB.hAAAOFGBSEADhABALBHBBACBdABCAEEB........hADA......hAEA...,2,-35,-9,26
LZeVHfUCMSANdIQKaOcGWEFDXgPJRbTBY,dHBHKGFCOHECGCBFFCGH.DAFE..PBABRADEBBAC..LFABhAAA.ZCEHeECAhAAAfGCAMIFAACHGQFFFhABAaEBFEAHH.JDAFYCDF..hABA......hACA...,1,-21,-30,9
UeWXcCGHdZNaQIVFDKJfRMBYbEgSPLTOA,UDACeDAC...XGEDCAFAdDHEZEBD.QDFGFGCCDBBA.KGGGRCCFBGGAhAAA..bEDHSBHDhABALBAAABIH.hACA....WFAFcAEC..NAAF.aEGBhADA.IGAE.hAFA...,2,-34,-27,7
ULDdFPEHJaIGTgRQeCYVSBXcKNfAMZbOW,MECGZFDFOAGDUFGHLCAADGBG.FABBEFFG.HADD.aCBHTAFBhAAA.REAHCFDGSFADhAAABCHC...hADA...XGDAKDEGAACGdFHA....hABA......hAFA...,1,-26,-28,2
bCIdRDgNeTZfcaFLGWKVXYEAUBSJMPOHQ,UGAFJCAF.OFGBQAGB..IDGBREFBDHAC..eCEEhAAATEDCZDCG..aBBFLAEGhAAAGFBBKHEAXCEFhABAAEHABHHCPCAA.CHHENBIE...fABFhAFA..hAGA...,2,-30,-16,14
bJXDLKGSEcegHVNIafYWPUTFdBRAOCQMZ,CFFEQFCAZCAG.JAFEDHAG.KBFEGADC.SCBBhAAAeACCHEBCVEGHaFHH...hAAA..WFABTCEFhABABACHAIEGMDIFbCFAXGEDEGEE....hABA......hACA...,2,-24,-15,9
LGFKCBYWNMXDRVbPHdgTJaIOZEfUcQASe,eFFBGAEGKAHBBEAA....NCCGDDHFVEFC.HDCFdEDA.TGABhAAAJADG...IBCAhABAEHCA..fAAChAAAcAGF.AHAHFDAFWHDAMDDC...hACA......hADA...,2,-32,-27,5
DQXgREFSAbdZMNBKUTJGcVCfOeYIHPLaW,dCFCZFACBBAHUABAGEDCCGFH..eCDDHGFALCFBaEAA.DBIFhAAAQGBG.hABAXBDFEAEAAAHCMCCBhACAKAAFJAFA..fDAE.YEHHhADA....hAEA...,1,-11,-42,31
NRaPcKSWLYJACDEMGdbVeIQBHfOXZFUgT,CFEAMBHHGAEGdCCB..eAEBBADCHFGFOCAAFABCUGEG..NAHC.hAAAaAHFKGGCLDADhAAA.AGDHDCGFEDDFIGBHhABAXGAA...gGDG..hACA......hAGA...,2,-41,-8,33
YTZIXNDQgFOGVcPMaRUHECAdbLKSWfeBJ,LCCHKAFB.SAGDfHBFeGDCBHGE..JFHBZBAG.hAAAIEGBDFFC.FEDEhAAAOBABGDAEVFAFhABAMAIBRBEBEHEAAGDC..dAEC.WDDC...hACA......hADA...,1,-19,-22,3
RTLASHEFYIXaPZeNJcMQGVKCfWUOdbgBD,SEHBHFEEFDCF..IDHDXGBBZBFEJDFF..MIFAVAFDhAAACHBEUABE.OADEhAAAdCBDBEBB.DAEDTEAAhAEAAFAGaHGG..eEDB......hABA......hACA...,2,-28,-17,11
CKIRAPVLObScBdQgGTYMaEFUeWJZDHNXf,VFDFLEEG.OGBASDDFdDAEGBADMCCB.FCHF.eAEChAAAZDAHHAFD.fBHAhAAAIHHEADEGbABG.hABABHACgGECaGGHWEEEDDDF.CCFB...hACA......hADA...,1,-6,-18,12
eGKcIPVTCNOgFMLdQJXWDfBHEZYabUSAR,RFBHGAEGKFEH...PABHCEFB..OACHMGFALBHFhAAAdEAG.XEEGDDEFBHDAhAAAEHFAaBABUDAF.AIHEeGAEhACAVBFE.NIAF.....gGGChABA.....hADA...,2,-38,-7,31
cVKXeZEWUHRYbaCgLQNAIfTMdBJOSGFPD,TCBCBBGEJABH..SFEFGGABDEBGKFHD.ZAAEUBDFHAFF.hAAARFAAaGEDCEEC..LFAEhACANEED.AAEB.MIAAhAAAFGHD......PEGB...hABA......hACA...,1,-15,-37,22
dgTIcSRWbPXEOUYNAaJFHKZBfMGLQDeVC,aEEDJDCHHEFEBHFGGAAFDBIF..CHDA.dBFA...TDACSHGEhAAARECF..PCHBhAAAOCAF.NAEEFGBDfCDHhABAQAFHeFADIABFcGGF..hADA......hAFA...,1,-8,-33,25
FQJAZcSYMBeEUTgCfNDWGOLHVXRdKIabP,ZDAGSHBGBGBEEBDCUBAB..CGEF.DHDCGDFAHDCA..VAEChAAAdAAFaBHDFGFA..AGDAMFFEhABA..gAGFhADANIEF.LFDDXEAHKGAF.IHHAhAEA....hAFA...,2,-25,-17,8
RTHOGYXQFCZbedDLgfNIJKBMaVcWPSEAU,RCDBHADGOAFGXDEB.CCBE.ZFGH.dACALAAF.fDHAhACAIDHGJHCGBGEChADAMGDAaEAG..cGFGhAEASCBDAGACGDCEFAABDFIHKAHF....hAEA.WCFC...hAGA...,2,-28,-10,18
QSHFDJAfILYGcRBOVWZUagbETedCNMPKX,LGEAGAFERECDOBEHZCCEUBGF..aHGEEDAH.dFBA..MBIBhAAAXABHSHAChABA.FFGDAGIHIADFhAAABDADgABH.eFEHNIABQEFGhABA.....hAEA...,1,-16,-18,2
ATLDQWGdPSbNeHfCKXcMgVYURFBEIaOZJ,TEGDLEGH.QCBEGGEFdBCHSGDAeFCFCDBB.KHAGXBFChAAAMEAH..gEEEhAAA.VBFGhABA.RFBAFADAIEEH.aEAH.OAHFhABAAGIDDIDA.....hACA...,2,-16,-8,8
eMVQJHUdLSICFXBKZOEaAfWNGTPDYgRbc,...NDHC.GDDC.PHFADCBERBDFeHACQAEDHAFDLFDGhAAACHCCBCAGKBHHEDBEAGFE..hABA..TEAE.hACAbABBMIFA.JEABdDGASHCAIHAH.hAAA......hAEA...,2,-19,-11,8
JdMQTYHZegXaBSLFKOcACIVGbUNfWPDRE,VDBHUAGH......fGHCPAEGDFFEJCCA..dABDTFFDhAAAZGEGeCCE.aDGGhAAASFBFFCAB.hACAKHCGAEECCHCAIEHD.bBAD...NABFECGFhAHA.MEEF..hBAA...,1,-21,-27,6
LdEVKPeWfYJaNZgIHFTGROMAcDBQCSXbU,DAEDBFFGCFBB.SDDF.UGABLBHDdHGF.EGEFKHDEeDAGhAAA....YABEhAAAJEDGNDCF..IACFhABAHCFAFBGA..TGGAODBBAFIHQGBFhAFAXEGA...hAFA...,1,-26,-31,5
RAHDZVMaEGXNfIdTbBWYPgcQOLJKFeSUC,ZBCFaAABGBFA..XFCD.IFAFTADAbFGHBHBGhAAA....WFEDhACAgEGGOBBFLFCHhADAJBEFeAEGCBAAACHGDEDCECGCdDAF...YFFFhABAPFAF...hAFA...,1,-16,-19,3
QTgUFLcKPEGaWDOBVHXNJYMAbefICSdRZ,eGEACFDGdAEAZFGHQAFB.UGAGLEBEKEAGGCCEaHAGDGAABCHChAAAHGDCJABF.AIHA.ICCGhAAA.RCFAFABChADAEDHF..OADF.......hAGA......hAHA...,1,-15,-22,7
cJZWfCNebOPMGBFDKHXLASgdYTVRaEQIU,SAFBdHBH..TACGVCADEHEAQGFD.UECBhAAAZCFCfAAFhAAAeFAFbAFB.PEDHBCHCKEHFhABAHACCABBBRCCAIFFC.WEHD.CBHFMIAAhADADGIF.....hACA...,1,2,-14,16
KHgBTFbdefDNGRQEJCAYcXVZMSPLaUOIW,XCBCMGCELAABUFAF.OACC.KEHBHFGHBHEDTACChAAAFCDH.eEDEDAIFRGFAEBFHAFEG.hACAVGDEZEAB..aHBE.hABA.WBHDdCFC.NAEF........hAEA......hAFA...,1,0,-20,20
bOFafMcHBTUVINKPYLZRgJSXEWdGADQeC,DECDeGFAOCDEFDDF..aAABMDAF.BGGFVCFC..KBFCLFBBhACAZDEE.RADEJFEGSABDhAAA..EAHDhADAdHABAIEECBCGfACE.....hAFA......hAGA...,2,-41,-20,21
UABXbDcJQaIYGdMWHPVLTgfENSRFKOZeC,XGGGDACBQEBE..IACEdGHGMAIDHFBFLBEDhAAAfBGESHCGhABAFCEHKDGFODFDCEAFAGAHbAADaADGhAGA....WDDD......hAAA......hAEA...,2,-26,-22,4
ZAJaNLOREdSQWITHYeXgMGcFBfbKDUPCV,aDCDLEEG.ECBFSDGG.QAEFIAFFTGDBhAAAeBAGXFEGhAAAMCAHFGHDfEEDhABADBCECFCDACHCJHAA...OCECdHAHWHDG.YFAAhACA....hADA...,2,-25,-21,4
UGcRCEFMWSHKdZJLOPIDVQBYTXfeabANg,UCBCGEDHCGEG.FBGH.MBBCHDFD.dAFAJFHBLAHH.OADFhAAADIEEQCAAhAAABHFA.XFAEaFDAAHHA.hABANACD.RFBFSDAD..KCDG.IAHFhABA...hACA...,2,-23,-22,1
JEQYbBGKWfVgOZdDHUaeCTXRMNIAFcPLS,FHBGLGEAEDAE.QDBBBAGEKEHB...fFAAOFECDABBhAAAaBHB..CAEERCCDIGCGhAAA.AACGSFGChABA.bAFBVCFAZBCG.....hAEA......hAIA...,2,-44,-20,24
WILObAKHFeTRcaPVfgNUMEGJQYXZDdCBS,KEHBHDEDeADGRAAA..aGGH..VBBE..NCIGUAFFEFDDGCFAhAAAQEBA.XGAChAAAdHBBBCAG.IFAGhABA.OAHHAADEFCCCTGDAfCEAhACA.MFFF...hABA...,1,-9,-16,7
EdMNbCgFQUGDLAcWaTfISROZPKeHXYVJB,aHBGTCBC..SHGEOAEFZFGDKFDHeADDHAEA..XEEAhAAAJBCBEAAC.dAHGMDAHhAAACCGGQGBEDFFEAICC.hADAfBAAICGC.YEAANAIE..hABA......hACA...,2,-20,-15,5
VWabXTKMRgYdFPcJfAUGeLSBZQEOCINHD,UDACLHDABGCBQADC.CHHGHFAGDBAEaGEA..XDDBhAAAKACCMCHDRBFDdBBCFDEF.hAAAJAHFGAEFZFFA..hABA...EHACNBAA........hAFA......hAHA...,2,-40,-2,38
eICFNHYacOSUJKBWdbMPTEDfVAXLZgGRQ,LADGZEBHGBBBQEEHeFFCFAHHHDEAaBHH..OFABSGADhAAAJCCFBGHEdAEBMIDAhABAEGCBDIFAAGHB...gCFDhAAACACC...NBBC.....hABA......hACA...,2,-23,-9,14
JBCYVOMALfQcWPGHdSFXUaIKDgEZNTReb,LDACQCBC..PHDEHGFAdHAHFGHB.UAFGKCFA.EDFHZEBANAAC.hABARAAE...eBHHBGBBhAAACEDFOFDDAAHG.fBDEhACA........hADA......hAEA...,2,-39,-7,32
bBOSJfcDRHgPeMWEaXGNLAQIFKZYdVUCT,FGFCKCFCZFFDdBFHUGAH..CEDABAAC..SFECJFAD.hACADEBFHCBC.eAFEhADAECDB.GACFADHHQACDhAAA...ICADYFHB..hAIA......hBBA...,2,-41,-35,6
XdcGSZKICbgRJODHfeQVBPAaTFYLUMNWE,TFCELCCH.MFFEECFE.dGHCGACGZAEBKGBECGAFRGFG..DEGGeAADhABABHBDaCHF..FABENFEB.hACA..XAGAhAAASEAG..........hAEA......hAFA...,1,-14,-37,23
MdGYTXREHJecZbQFSgfABLVCaOUDPNWKI,BEFALFCACDCH.UAFCDEAF.....NAEA.KBCDdGGFGEGC.hAAA.TCBHEFCDJHDGeEFEhABAZBEA.FHDA.fABAhADAAABDOFAD...WDFEMAAH...hAIA......hBAA...,2,-41,-26,15
gfeJNHKBUFWGOVCaXQIDETZdAbLcPSYRM,LGEASHBGREAAMIDEeEFHHCDE.UFAHFDGDOACECCAB.hAAAaAGDXABE.hAAADAIDTDDFAEBF.cGBBhABAPEHH.gAEDNCIEBCAB...hACA......hADA...,2,-23,-14,9
fdYNcLPKaICREAFGebSQUVZMWTJHXBODg,FHAEeFEFQBABZDCGMHFE...JEDAXBFFDBFE..dFAD.hAAA.NAIELABChAFAKDGCCGHAACEB......hAGA............hAHA.SCCGhBAA.WDBDBEBF,2,-52,-26,26
SIbgANKOTFVQMEfDWXGeUdCZRYHaLcJBP,OCCHVBCF..EBGDDAIH.GGCBdFGHCBHB.RFGBHAAELDFGBEFB.hAAASDFE.hABA.ICAHAAFHKCAFFEADhAAAQFBCMDIFfEDAeHFA...hACA......hADA...,1,-13,-29,16
ecfMdbYCUSaXJFHPLADVOTNRQgZIBGEKW,DGADOBDGRABDZEFDBDDD.GEADECEF.eFFBMGBA..dCADCHDG.aGCEhAAAFAECLAHB.hAAAAHHE.TDAC..hABANABFIFHFKBHF.fGAAbFGD.hADA......hAGA...,2,-31,-16,15
SPKBIYbVCcdfFMeRaAGgOTEJUWXZLQDHN,OFEFTGGD.UCFFZEAHDDDHHGAA..SAACKACGBHGG...hAAAIAGGVDCHCBACdAFBhABAMCEG.RFEF.AIDGECAAJEFCXADChAEA.NBCC.YEHB..hACA......hAEA...,2,-23,-16,7
GIXTYSUcbRfHBZMWOCePFAaNKQLVJdDgE,aAFBQGBCLDDCdBFDDHAEEFGG..GFEHTDCCUABA.RBGDBEBBhAAAMIFACDAE.FFECAEIHKEADhAEAVAAE..IEEFhAHASBHH.fCDB.WFAFhAAAeHFA.NIAF...hAIA...,2,-19,-8,11
BQJFAYWCaeKPROfIMbVZLGgUEDXcHSNTd,CFDGaEEDKBFH..RAAF..OHFAMFBDZEEF.GCBEEEBHDAEG.HAGBhAAASBCBdFDCBDECFCHFhAAA.AAEG...WCCChACAfBAA.IAHF...hADA......hAIA...,2,-34,-31,3
QEVCYJBXNdgcLPIaMSeURAWKZObTHGFfD,KCFCZFDFOAGDHDBGFFAGDBED..QGFD.CFGEBDACNDBEdBAB.hAAALAAEaFHB.eFEFhAEAAGAH...WBBAhAFAbBCD....fAFAEGBH.JFFH.hAGA......hAHA...,1,-21,-33,12
SXaBFONVgHKbJARDQCZUTMPdGeLEYIWcf,RFEEDEFAZDEAUBEF..TFBHdAHELFGD..IHHGhAAA..fCAGhAAAaBBGBAECNCIEHGAE.KFDChABAABHGMCABeDCFEBBEYCCESFHH.hABA.OHCC..hACA...,2,-29,-18,11
BLQNUXJdSfFEKCDgePTZMWGYVRAOIcHab,OGEAHAADaGAGBHAFLDFDUBAA.dHFBFCFBECCE..DDDHeAEEZAEE.hAAAMAIF.GDAFhAAARFAEACIF.IEGC.hABAcFCENEIE.SEHHfHDDCHAH..hACA......hADA...,2,-42,14,56
ORdUVKELSWBXfJHcCGgTMAZQPNYebFIaD,QFDH..PCAFeEBBIGGADDFAOFCE.UFFEhAAAEBGASDFAhAAABAFDJDCAHABEGADC.MIAEhABAAAGC.ZBBFNDICFAHD.......hACA.aDAB....hADA...,1,-11,-29,18
MgSXDRCEOdZVeFWcUAGTIabQPLHKNJBfY,TAGHaHBG..QFDELEEEKCDABAHDMEACSADHhAAA.DFGARFAACACDEABFOAAFhAAAdCGGVDBDFGDE..UGGEhADAAAFBIGHD.......hAEA......hAFA...,2,-22,-21,1
gNESYUMObXIdcFTHKfRPDaQAZeWCGBLVJ,ZFDFeAFBCBHHGACGLFDB.JDCAEHBC.UGGHMEBH...XGFGhAAAIAFA.FAABKACHhABA.RDGBDFCHaCFCAAED.BCBGhACANEAA...OEEG.....hACA......hAEA...,1,-22,-26,4
gdMQZacTeHKELUIRGbVNFDCXPJWAOSfBY,SDCDBFDGdCABQEAHZEFC..aHDEeCECEBDCLEDBhAAAUEFC.RBFFGEAEhABA.NADD.DAEG.PHBChAAAAHHAfABAMBAAcDDCKCHB...IHFEhABA...hAIA...,1,-9,-28,19
FDHdLOcWbQNZfYSCTeURIKGgVMABJXaPE,JEBEaGFC..FEEEHAGHLDCFOHFA.....bGAEZADASFFEhAAACEHCeBBFRGAEKAACGABFhABAMAIHAEAGBGEC.hAEAPCACDDFG.........hAFA......hAGA...,1,-12,-28,16
cVJAHDQUOLCSPMdgIRKEYWbBTFNfZaXGe,HFEEQECEOHAECBCH.MDBGdHEF..RCEEKGCDEABG....WBBGhAAATCAG..FAFFfFAAhAAAaFDBeBHBVEAFhADADEFD.SHEGIHHEBABGXDEAhAEAGAEFAAHE....hACA...,1,9,-25,34
NFcEaUCdIRLHTSOVPMBXWYQfDgAeGbJZK,GECFJFBBZDCF.KBHD.FGHFEGGE..CEAF.dBACLAAGHBEA.OFADhABAMFEABEAF.XGDAhAAA...hACA.QCDH.fGEChAEAAAGENAIE.aGCD....hAFA...,2,-35,-27,8
bYQSWZcAOFXLIaEVMPGCJfNHeDBRUdKgT,FAADXDACLEAE.EEFFMAID.CBAG.JCCGHDDCBHFGdFGFKGCATGDGhAAA..QGGEhAAASBGFZAGBAGABIHGChABAaGAG.PCBC.fFCAhACADBDC....hADA...,2,-28,-21,7
CLUEdHJBDRTfGNPXZAecabQgKOMYWSFVI,aDCDQCBC.ODEFMDGBSEEH.FGAGIDGChAAAUABCECHBdGAEJBEDDAFGhABA.fHGFhACA.PAEHAEHF.cGFBKGCG....hADA......hAIA...,2,-34,-34,0
LbGKYRJNaQXTcOSDEAgeWMBZPIdVCUHFf,eGEAMBFHBAAFZCAGdDEAUFGCFEBF..LHAGGBBGKADERAFE..JBAGhAAAaCAB...QEDChACAXEGA.OHAGhAGADDGEAABA...WBGB......hAHA......hAIA...,1,-24,-32,8
KCQJPIXMZOcAERbYLGSTdBHfUFVNWageD,ECFCRAADLFGFGGEFdECBHADEFBAB..NHBH.aHBC..eDCFDBDEKFCGhAAACFAA..QEDEhAAA.IAHEhACAMAEAODAFAIEASDGEfFGD...hADA......hAFA...,2,-26,-14,12
VTfPcbJDLWEagYRHKFGAIeCZOMXNSUdQB,eAFBCEFAZFEC.MABE..XAGFSAGBdDCDBFAG..TCDAhAAA.PDCHhAIAcAABDBCE.LFEEhBAAEBDF.aCHDRFBFFBFDAIBAIHHDNIEF.QGEEhBBA...hAAA...,1,-1,-36,35
UPRLWZTFKebXNVQBMgcJdHCIOGYfEaASD,UCBFRFDFZBGDKBCAeHAG.....XGFGQFAAMACEJAAEHEBAhAAA.CEHHGAEFhABAEFFGAFDHDEDCLDGD.hAAA.FAFF..........hAEA......hAHA...,1,-9,-39,30
GFIPENbZXDVSeAROafHcCgQBWdUKYTLJM,RDEDaDCDHCAG.CBHABAAEUABDKEFG.LDHBMAECGECEFGCB.EHGGhACAZBFE.DGAB..eBEAhADAAEACOAFA..hAAA............hACA......hAEA...,1,-25,-38,13
RISCfPJELcHdKQDXeAOYZGFBTWaVbNUgM,OFBBZEBHFABFBBGD..aEEG..VADFNIEH..UBEERFDC.CHCA.hAAA..JHFALGFEhABA.HABFKAHBDIDEhAAAAFFCGAGE.WDAFMDAG.IDFFhADA.SGAHhAFAEECB...,1,-10,-42,32
IUYdWVbDCPMJXZELOQGeTHSNaBcRAFgfK,FHBGKHBGUCBBdHEB....VDCBCFEB..JDFAZAAE.LAHHhAAAGACDHGFAaFGA.BFCEhAAARAEDAIHE....fCAAhABAIBHD....WBAFDCCEMGEEhACAEFAB......hAEA...,1,-22,-35,13
BMeKfgRDHNcOVXQULEbTJWdPYCASGaFZI,aDAFFCFCZECDBEGHKDAB..RFEFHAFH.OHAAVACF..UGACLABChAAA.EFCATFGGhAAAdDDHCHHE...AIHGSGEFhABAMCBE.eAHDDBID.....hAFA......hAHA...,1,-18,-31,13
JAeNSZbLPfHFEXgcGCUQIMDWOTRKYVBad,SDCDZFDFLFFGHAACEBHF...gGBCCHHGUDAB.QBFGhAAADCGDOBBATFFFhABAKHBABDDEdADEAFHCeFAHhAAAPEDA..fDHCcAGAIHHGhAFA.MIDE..hAIA...,1,-8,-26,18
HQIDMYCeWgcBaOZUfSTJGbARdKFPEVLXN,RFEEFDABECGCLFCB.HFFDIHHBMEEBCAACeCCF....hAAAgBGDBBEEaDAFZGCAhABA.SDEFhACATCEHJBBGAGBDKAFEPFBBXDGADACG.cACBhAIA.....hAFA...,1,-11,-19,8
fDRBEPCaOZMdUcSWFJHeXLgQIYKVGTbNA,RFDGEEGDCCGA.ZGBE..MCCCUCAC...SFDEFGABeDBELAAEhAEAQAFAKAFAVCDEhAAA....TEBChAFAAHIDDBACPFACaHEC.OHECWDHH...hAHA......hAIA...,2,-32,-14,18
NYLBDZHJaXeEgbcIVUGCSfQWROTPMdKFA,LGEABFCFHFDAXEBCeAEDEGHD....bDECIBHHhAAA.GBAAfCAAhAAAWFFE.TAGFdGAAAEDCDAFAhABAZGAGaFFG.VACECDHHSACF.hABA......hACA...,2,-13,-7,6
GANKORSITEMDcbfUPZdWXHaLeBgCFVQJY,OCCHRDAG..IFHDTGDB..DBGC..fFCFhAAAUCGAdHGBHAAEeAFCCFFGQGAEhAAAJHDGADDA.KEDGMCAChABAbADF.ZBGB..aFGEBADF....hACA......hAFA...,1,-7,-29,22
AVfGbFQaUXTOJSgIDKPcCMWYNRBLEHZed,VEBHGAFE.FGGEUBEEOEFB..JABGSADD.DAAFhABAPFHB.MEFBhAAAWFDB...REABBAEChACAHAGFdEGBABBF.fCCHaAHFXCCC.hABA......hAFA...,2,-31,-21,10
KUaOEAPDfeBLXRTWgSJNbZMcGVCQYIFdH,DACBeAFBBDECLDDDRAFA...TBBGSHCEJEHBZEAHMGDAhAAAGCEE.CBAF.IHHGhABAFHDGdAHE...UEAChADAaGFDAAAAXBDC...NFEB...hAEA......hAFA...,2,-41,-6,35
ZQdXISHeARNBGLaEbCYMUDVJfWTFPKgOc,BFDDLCDGEGAF.CHBEUBAGDHGC....JHDATEBGKDAF.OFFDhAAAZFBFdEFE...SCEGhAAAeEHHAAGENBEF.GABChABA..aEAHbAGBMEEB..WBDEhADA......hAEA...,2,-32,-25,7
aRVAUfgXEdPOKJMGLbFTCBYQIZeScWDNH,UCBCXCBCdGECKGFHGDGC.LGACFAEFBDGCQGEGhAAA.ZAFDeAHBSADChABADBAGHGAAaEEGAAAA.fEBHhACA.EBHBPEDCMIAE.CCAD..hAIA......hBAA...,2,-39,1,40
bRAaOLHgZcSJKVGIDTWdQCfEUMNPBeXFY,OFFBLFBBZCCAJFGBGDAG..TCCBdAGFCCHH..UECAMAAFhABABAEHFEFG..RAFDHFDBhACASAAHKAHBDFIB.hAAA.fHBFEDAF.NEIC.....hACA......hADA...,2,-29,-14,15
eROUTWDabCXKIfQBSHJcGVNYMLPdZgFAE,EDBDOFFCUCDDDAGC..CFAG.KECB..QFGBSGCGHCGHhAAAGCAE..VGCChABAMACBdCABFEEB.RADGaBHBhAAAIAEDBHEA.........hABA......hADA...,1,-20,-30,10
TBJeRMKcOgIfWYEdDLQVNCaXUGZbASHFP,SEHBHDAGTFCAeBECKAGE...OEEFIHGC..fCAHhAAAEBCBLEEEhAAAQGAECADHUBGHZFFAhABAAHDBBHHGMAFFcDDB.WAFEDBBF.NDGGXDAAhABA...hACA...,2,-13,-6,7
bWGdBUPRFaCNfOKHgSeXIQTMAZcVEYJLD,ZGFGVDAGEBEA.LAACDDFBGGBBUCGDFGGB..aCBG..CEGDOACChAAAHDEFSAGBhAEA.eFAAXAFFhABA.QCGAAEDC.....hAFA......hAIA...,1,-16,-26,10
MLaVgfXQBdRZEDeSNYOFKbJPUGcIHCWAT,MAEHLDCH.aHDGVGDE...XBAGQAFE.dFGEhAAARAFDDDCDSCCEhABAOCHFKEEAJFAD.UGGEGCEEhACAIAHCCDAGABBC.TFACBCHA...EDAFhAAA......hABA...,2,-20,-15,5
KdZUVBQgFTMGcERASYJXHOPCbeNDWLfaI,JCCHHADG.CGEE.eHAGDIGALBAH..aHECdDHCZBFFBEEDFABEMFHBhAAAECCBAAIH..SGADhAAAXEEDOAFAhABA..PECB......hABA......hACA...,1,-31,-34,3
NgdMCGBTfaIWEDOcSHJbKPQLFXVAYeZRU,eFBBRBCDUFGBdGDAGEABBAAD....aDFAIBABDCBD.OAEGhAAASCDH.JFGBhABAKDGELAFEVGCAAAIF.hABA....YCCD...NDACMEFFhACACBHGfDAFhACAEBHB...,1,-20,-30,10
YaUCZMbdILGKgJAXcFVOSeNDfRQEWBTPH,FGFCVDEDeAAC.DBEAQDBF.EEHHBDDF.TFAChAAAPADFaEGFZAFE.dGAGLCCFhAEAKABDACGC.XGCHhAFASGDB.NAAA..fGGEhACAWCHB......hADA...,2,-29,-18,11
KIbZPMdAcDVaCHRGBeLOQgFXUTSYNJWfE,VFDGCHCHGCGA.BFAHLCCF.OBECFCBGUECD..SDDGhAAAJADC.fHFHhABAIAAFZDEFhACAdGBGABDEDFIHaCAH.........hAGA......hAHA...,1,-25,-41,16
ZKgIcRQGLEdPYFNHUbCBeaOMSDTWJVAXf,ZEFHKHBG...IHBARCCCQEFBGEBDdABBFADAHAFHUCCHCHHDBFADhAAAOHDE..DEAATCGHhAAAJHDA..AHAH.XBAFhABA.fAHG...hAEA......hAFA...,1,-12,-34,22
FNUWXgdEaeVODfAYbTHMSQKBZLCJcPGRI,TCBCSAAB.BCFECFGH..JAFEGEDHREBC.FHACUABFXEBFhACAdFFG..EFADaEGAhADAeHDGDHGCAHDE.HADAhAFAMAAFKAGCLAED..PCBCIHHHhACANIDF.....hBAA...,1,-13,-17,4
FHNcPQMVbRSDeLYafAZdJECOTXWgUGIBK,ZDEDdEEDEBFBCACG..OHAC..TDAD.XFACUFABIBAAhAAAFGGFHABH..hAAA..NHED.PCHHhABAMDHBRBDFDICG..eDAGaADFfHAFhAFAACCF.WEDDBBFB..hABA...,2,-34,-4,30
INgSCBDLJFfEGOdAcQZYPMbaVWTRUKXHe,ZEFHMCCAaBED..VDDARCAD..UAADHCAE.eFAC..NEEG.SHDAhAAABAFB.DEHFhABALCHHfCGHhACAEHBAdDCAAEAF..cGGE.PGCA.hABA......hADA...,2,-32,-7,25
cQXgOKZVdbWHeJDaINRUGCBfPLATYMEFS,MFFFSDAB.QFGHXDFAKCCEdCFDHDCCeEBBDAAHaAAD.hAAARAED.CBHBBAECLDADhABATGABEGDD.FGEHcGGChACA...OBHF.....hACA......hADA...,1,-12,-20,8
MIHFZUSWJEYGXdaVNCLbRBgOTPKecfDQA,MECGHDAGZADGUBAASHEE.JDHBEFAF.GAEDdEFGaGCBCFHDRFFBhAAA.BCCB.OHCAhABAKBAAfFAAhAAA.DDDCAFDB..WCFA......hACA......hADA...,2,-32,-24,8
KRACELNYfGHedPaSWJDZIgbTUFVBOMcQX,LCAF..fHGDGBDGHDGBPDFDSCFBhAAA.DGBEgAEFhAAAUGGBBABBMFDDQAGAhADARBBFCFHAEBGGNBAEdCCC.JFEBIDDHFGAH..hABA......hACA...,1,5,-28,33
eZRCGcaQAKWDYSBJHfEVTNXgFdMPbUOIL,KHFGDACBBHAGHBFAEBAE..TDFG..gEFBdAEAMDDFUDADhAAAIEBGZGCACBAEaDABhAAA.QGAChABAAHGA.SCDBVAGFNDIE.PFDF.LACEhAGA...hABA...,1,4,-31,35
VIOUgAESMHDJLdacZfWeKPYBQNRXGbCFT,MIAGDAGDLEECdAGCZDCG.eACGKGHB.BHBHRABH.GCBGFDHD...hAAATAAFOGEAAHHFSBGHhAAAaHDA.fFAAhAEAPAEBQFAGNEIGCGFG...hAFA......hAHA...,1,-22,-24,2
BLOTbacdRfCYWQMPeAJGXVZIKNDgUEHFS,JDACXCCFZAFA.KGEEDEGC..UGAEFBCA.BEFALGCE..hAAAOADA..TGGChABAbCAHdAAFCHCH...hACA..WDHHPEABAHED.ICFFECEASAHFhBBA..aEDEhADA...,2,-41,-26,15
MBaNYHcZeDLdQJbAPEWCRGOgUKfSFXIVT,EHBGRDBHOAFDUCBE..KFDFFHAC....VEFBMCAE.BFHH.hAAAaEFHHADD.cCFGhABADDHBQADFhAAA.AFDH....WDDBCHHBfABFhAFA.IAHGNIED.hABA...,1,-25,-40,15
NXfKbgMIZVSeUYaTHGBLFcEADPORJdWCQ,DEFHOFBBdAEG..QBAEXGGEKBEA..MIFEZEDBSABBhAAAeGFCUFBFaAHHGBCAhADABCCEFFFC.AAIBPCHFhAEARCFECAFA..NDAE.fAGE..hAFA......hAHA...,2,-22,-21,1
BWSEbgOCPZGDYRULcVJeIadHfFNMXTAQK,QGAFBFEDEDFC.OCAHZGACDBEE.UFFGLBCG.JEEBaCDGhAAAHCFD.FGGAMBIFhABAABDGKHCG.SAABhACACHEDGCAE...cBGAeACC.IDDFhADA......hAEA...,1,-18,-28,10
CRTZQSUgGPbYHELfIaXcBDVdAKWFOeMNJ,KAFBOCCHeDED..JADDRABDZFAC..SEGGUGGC.GFBDhAAA..bCFAEGHD.hAAALBAHIEGHaHEEhABABAEFDFADAFEAMIBACACFTBFFQDBB.hAFA.YBHB.hABAfHBB.,2,-16,-13,3
HVURSOaWPFebEGcACTgXDYKdMZQfJNBLI,TGGGXAFB.DHDEKCFC.dEDFZFFA.QCDGJCAFBGEHHBBDhAAAREAH..aFCE.FCABbGAGhABAECHBAFID...CDFHMBAGhAAANIBBLAFE........hACA......hADA...,2,-21,-17,4
VCWJaLgdTMIPZNSFRHQUXDGBcYEOAebfK,eGEAKHBGCCDA...aCGCLFFFdAAE.MABGIAFG.ZDBFSAGFhAAAFHBAHEDEXCCBhACABFCAEEBCAEIFfAHAhADA..JBBE.TGGCNEAA..hAFA......hAIA...,1,-6,-43,37
GgCeOVNdQXMJEKZDbLIaBSHWAcfFPUTRY,FHBGUCGCRCCCGAFECCCA..eDABOEHBdHGF..MFFGKDABDBBCLBDBhAAABAHE.HGBAAGFA.hAAA..fBBAhABA.PAFEYFAG.NEEC....hACA......hADA...,2,-35,-20,15
aNUSOYBQcLRfMEZJgWKVTIGeFAdHXbPDC,XCCBDACBCHAG.UDAGOAEF..BGGDQEGBRGCE.MDCHhAAAJACEKEGG..IHDGhABA.FFEFAHBDbAGBhAAAaBGC.SEEHLDABfGGGhADAECEF.....hABA...,2,-36,-25,11
MSXVQfCZLPWIegbUTBNKGAdHaFJOEYDRc,dEHAHFEEJDACOACD.DDEHRFDE..MDFAXCGC..QACHhAAACBAALFBHIHAAhABAgAFC..hAAAUAFFNIEHKFADAICG.........hACA......hAEA.aGCCEEHD,2,-36,-15,21
NIGCTeQWPOdZcSJaAMbXUHYFfRKgEBLDV,XFDBHEFHFCFGKAGEBBGHDDDF....VACGGABA.TGBGhAAAeFAHQGGEhAAA.ODECdEAESADAhABAAIFEUCAHfFCGEFEBNDIG.CCHA..hADA......hAEA...,1,-17,-22,5
QfKXVLPUJRAYOeTgIZdFcbDMBaHEWSNCG,OEEGeDAC..IHDHFFGADHCCBAFB.HBBBEDED..SFBAhAAACFBA.QEGDhABAfDAGKACBXAGHhAAALFAD.PCFCRFDE.ABBF...hACA......hAEA...,2,-35,-26,9
ZVdJFHUBfeOQNAEMXKTaWcbCILPRSYGgD,MAEDXFCAKHAC...aABE....bBBBLDFERGEA.YBEGhAAADAAEZDDAJFBAFHFABEBEhABAeAFC.OFFChACAAGIDEBGA.TCCF.CGAHIAECSDHF.hAGA......hAHA...,2,-24,-21,3
OCbPSDHUfKQWBJLcegEYGMTaNXdRVFIZA,OAFBCFDG..SAGEUGDAQCBEBDADLDCAeDHFEEDAhAAAMFBB..TEADhABAXBCA.dAAFFADFhACAAIHEDEHFKGADWCGFJFFF.gGGGaCGE.hADA......hAEA...,1,-4,-38,34
JUMYbEQFPeKATDVHaZfXOGdINcSBRCLgW,TFCAHBCFaEGA.ZFABOBFCGFDB.dBEFICBE.SADBhAAACBADLHDGJGEEMAAEhAEAEHBG.FAGAKAGCAHCDDDFAhAFAXDDFBEEC.........hBBA......hBCA...,2,-25,-8,17
VNGCBRYJPMDSfOHLQUaZAWTbEXcgeFIKd,TCBCXGBC..eEHDFCDAdGGDGBFGCAHB.BEECREAE.JFFFDDIDOFCFhAAALFFD.QABGhAAAaEABAHCHEABEIBHEhADAKADC.........hAGA.NEEE.....hBAA...,1,-13,-28,15
abNEefMVTCgAGIXJZKWSYRUcdFBHLQDPO,XAGHJDCHZGFA.KGGB.....SCDDRAFEdHAFBHDCQDFGhAAADFEA.aDAHEBEBhAAAMCCBCBAE.AEIDIBEAhABA.UGAFFDAF.PHDCNEEF.eABAhACA......hAFA...,1,-18,-46,28
CfTLFZRUWMIYQVGBKOPEHDacSbXAgNJde,JGEACDGFLBBHZCAF.UFEHMDHD..QGAEBAHGKCCE.OBFChAAAHAEDDGIB..aDDBhABASEDAAFHE.hACA.NAEH.dABH.fGAEFHGEIBDG.hAAA......hACA...,2,-41,-23,18
WbRSEPgdaJFGZIXDCUBYAKTcMONVQHLef,TGBCOCHD..QAEDeEDC..fCAGRCBDSAAFhACAEBFBdGGFFFEAZGEADAFEBAAFhACAABHBMDAHNIDD..LCBBhADA.PAHDaGAEJDDAIEHCCBCB.hADA......hAEA...,1,-3,-18,15
VgGXZEIUYaJcWMRQDeKOTdNfCHLSbBAFP,FCFCVAADGGEB.EBHBUGGE..aAABJBFE..MIBEDDFDKFAFhAAAdDAACBCCLCDH.hACABADCADEBXFBEhADAZEBF.IDCF..cDGC..hACA......hAFA...,1,-22,-38,16
HCWMJAcUdOLgaFfEXRDbTIQeVKNBSGZYP,dGFCOEEGLDCH.FABBXADHRAEE.TFDGeEFEKHGEBAFGhAAAZCEGHCAH.CHHDMIAAhABAAGAA.UAGEaAHFDEAAhAAAIFHE.........hADA......hAEA...,2,-30,-17,13
eCYRfgbTFWaAEDIXKMZLPUVGONQdHSBJc,EHFGDAFBKBBAZCCELEHH.UACBOEFGdHABBHDEJHAA..CEBC.hAAARAFC....fEEChAAATFGFFHDA.AABF.hACAMBBFGBDE.QAGC.SDAFhADAYFAAWDFHhABA..,1,-19,-40,21
WESGcdUgVJBIPQFaYCbNTAMeOZHDKLXRf,OAFEDDGBKBEBLADERAAC..EECGSCBCdCGEUADEJFEBBHEFhAAA...QFFBhABAFHGCCCCD.TDDEhACAADIHMIACeHAE.HBGDfGAFcEBF..hAAA......hABA...,2,-34,-11,23
GPeCfOZXbAUTDYRIEVLHagdFBWNJQKMcS,TGCERFDGEBCH..HAFGdBGHFGGEBAAC.JEADMFBD.GDBBCHGH.hACAOAEDZADFADIHDICAIBAHhAAALDDA..hAFAWFFF...NDAE.cGAD.eEHDhAGAfEGB..hABA...,2,-30,-15,15
LeHdZPKbAYREUBCGQVMTSfDFgJaOcWXIN,RDAGEFFBBHGAGADA.QCFDTGBFDEECJCAF....aCCGOFABhAAA.XABFhAFAIEHHNDIG.eFFHHGBAhAGAdAHE.KBAEAFHDCHHGSBGD...hAHA......hAIA...,2,-34,-5,29
NSBbfITMWPKQGdRcCFeUXgVAJOLaYZEDH,LAABaCFCZEEB.HBEHBAHE..bAGDTACGMDDF..KGFFdBACCCCFFGAHhACAUGCA..VEGFhADAJEADEGGADEBH..SAEChAIAIECE......WHFA.hBAA......hBCA...,1,-10,-29,19
FQXOVgaAMWKHULBEYTJRZfDPGCeIdNbSc,MHFGKCFCLEBFBBBA.EHEEJEBG..ZDFGDGBBCBAF...eFFEdEDESFGEhAAAFDGG.hAAAQBCHXBDH.hABA..OAEGgGCFAHGC.HAFE.hABA......hACA...,2,-29,-27,2
gfDOIAPbQZMcNBYeKJXUWTdEaVGCFRHLS,QCBCZFACMBBEBGEFKEGAUGDH.dAHAVDFGGABF.CCFF.HCCEhAAA.SCAChABADDEFAIGA.PBEE.hAAANAEF.eFAF..XGGAEDFHFGGC...hABA......hACA...,2,-21,-15,6
EPCafbBKHeNZMDRJTIcAUGdOVSgYLFWQX,GCEBdDBDOCFFSDBDLGBCFABEQBBBEAGG.aDHDfEHGhAAA.KGFDhABANAEDDGGFTAEFAHCE.UECGhAEA..YEEH.....hAIA......hBAA...,1,-17,-27,10
EQFNWKVfABDOeYCaPUcJLdRTbZHGMXgIS,OFEDeAFBCCED.UAFCLAAC..TAABHEFGMHCC.IHAGhAEAEECCFEGCKEACAGAGBGHAhAGA.DIEEaDDAJFCCdGDGhAAARBBF............hACA......hADA...,2,-35,-16,19
UYMDdKacEHNIGLfBCFOgWXVAebJPTZSQR,eEEGJGEAZCAFQDBA.UGBHMHBGDGAB.KGEHECCA.HAGFhAAAGACHBEDFFCGGOABEhABAXBAGAEFH..bAEFhACA.....SDGG..hAIA......hBAA...,1,-23,-27,4
adUWNbEJVMOgQDZGSRLPfXYeIBTKcHFCA,dFAAUCBC....bECAEAEC.MEEFQADADFGFGCGASEHHhAAALAAGXCDChABAIAHETCAC.hABAHCGHACIBaGBCNIBFOGCC.gGGGhACA.....hACA...,1,14,-34,48
TJYQDXIFdgLfNOVAZECbeRWUMBGScHPaK,CCAHeFBBREBE.MGFCBBEFGDCHHFFA..KCCHJCFA.DAAFFHAC.dEAC.hABALAAEOHFEAHEAZGCAhAEAEADC...bBBC.hAFA....WAFA......hACA......hADA...,2,-32,-26,6
CSbWNDHeLJZFQKIfMVOETPUcgRaAXdYBG,dGFCBECDCCDD.SAGE..bBEFDBBALAGBJFGD.FDAGKCHDhAAAMEHDODAG.EBFDhABATFAD.PECChAAAUGBDRDEF.AAEC.........hACA......hADA...,1,-27,-35,8
PgEScXOCKFfLYDRdJBeUTZbVAGINHaQMW,GAFEHAADaFFCMDDF....gAFDSHEEODHFhAAACCAGKGGELBBGDDCEdECEBHDGhACAUFAFTEACZEFEAIBA.hAAAIHHENABF.WEEF.EADB...hAHA......hAIA...,2,-21,-3,18
gcSeCKNJZXQfEFGdBDYIWAPbTRHaOUVML,TCBCHDDFOBBD.MAIFLCHH.gCFGSADChAAAeDADKGGHZGAEQGBDhAAAFHDEBCFBIAHAhABAAABEbBGD.UEDACFBA.JABGEAFADBEH.PGFChAFA......hAGA...,1,-1,-9,8
JWdcUNEfZVASMQBTCDgLaXGIHePbROKFY,MAEDTABHDFGB.LAGBaDED..ICHHeAADRFAH..OFCDhABAFAFAJGEA..dCCEUEBBhAAAEHGAZEEBSCDChABABCFCCDAD.XGCG......hADA......hAEA...,1,-17,-29,12
ZDCUefSOAWaBYPLGKXNRMJgdHcQVIbETF,BFEDLGEAKCGHRFBDJAFD.HDDA..VAEBEBBCFHAG..CDAB.eFAChAAA..OAAEhAAAABAAaDHB.....GGEBhABAXDAGMBIF.......hABA......hACA...,2,-40,-25,15
YLMGgETbcZWdNQRSBFXVCPaIefHOKDAUJ,UDACJEEGLAFAMAIFGDGC..TBCBZEEHdGCF.RAAEBBGGhAAAFFCBCHFH....aGAHfDCHhACAKDAA.AHIBEAEChADA..cEGE.NAAF.SHBGhAEA.....hAGA...,1,-10,-43,33
TfcdOLbZCASMWVUNgJPYaBRXGEDIKFQHe,SGFHMECGUBAA...JEEFaBGCBCHCGFADDFBC...IAHHhAAAQGBC.TBADhAAAfHED.hABAdDFEOEHF.ZAEEABEH.NEAE.PDHBXCDEhACAKAEE.....hABA...,1,-19,-27,8
UQGAJcgLdKWOBZNHEPRVXfaSMbYFTIDeC,JGEALGEA.KAADBDDGZBCAHDBDEHDERBBF...VEEE.aGBEMACEhAAA.FBGEDBFGUBEAhABAAEIDdDAC..ODGFhAGANICB.....fHABSGAF.hAHA......hAIA...,2,-38,-16,22
TacJQLRegIdGZNCVKfMAFPBHbWDYXOUES,BFEDHAADDFDHODHBUBED..SCBAaAGF.QGBEhAAAREFAIEAHGAFA.hAAACBBBKEAHMFEFFGGHWDCFhACAEECATADA........hABA......hACA...,1,-20,-31,11
UALaFebVJXfDYcNTKOWZBQHIgESRPdCMG,LEGHaEED.FGCFeHAC.JDCFDECE...NCAF.TAFE.hAAAODAFBDAEIHAGhABAEBBERGFE.dGFGMICAhAAAAFEB.VCGFXCFCfADEKFACZAEA..hACA......hADA...,2,-33,-9,24
fcRHgDAITZFbdKBNOVEXQCaJSUPYWGLMe,ZEFHFAFBdFDHKGBDBABE..OFHDEFDB.CDHA...aBFAJBACUCCDhAAA....PHBGhAAA..WDHBLEFHhABAMEAH.eDABfADFRCDFDDBAACGC...hACA......hADA...,2,-41,-28,13
cOBdPWJDNRESFHAZQMbUaLCYTGKVgIefX,ZFEEMFFFaABALCBC.CABE.TCEEGDEBKFAF..VEBHeHEAhAAA.XGBABHAEPAFBhAAADECEEBBFFGGHAAIDQCGChAEA........hAFA......hAGA...,1,-20,-23,3
cDZeCORYLfbJVTAdFHGNKBaUPWIEgXMSQ,dEHAFGFHHCBFKGFBBDCCUFBD.....IAFBEBGHMABGSBBFhAAADEFBZGBG.OHAEhABARAEFLCBD..hAAAJADBAIHEaBBAgEEE.XEGBhACA.eAHFCEDA...hAGA...,2,-33,-7,26
GUKfRTPNHBaDXFcLIgOeEJdZbWVAYMCQS,MBFHCFCFGACGUBAAKGHH..RGDC...TFEDHEECDAGF.XFAFhAAAFAFALAAF.hABAIDHGOCCDEAHHhACAJHCCdEAA..........hACA......hAEA...,1,-24,-30,6
bBgOIZVNSfKGFPUHeQCDMYdcARXJWELTa,XBDGEDCDLEEG..aEAFBABC.OFCBIAHAZAFESGAFhAAAKAFHFDFG.UGGDhADAQEGADBCCMDDChAEA............hAFA......hAGA...,2,-42,-26,16
LTeQOcZHfRgJIMFWNbdBXSDPAYGVUKECa,GEDHKDAFCEDH.aGDCLFBF..TBGDQACHZDADfAFHhAAARGFE.IGGFhABAMAGDNCHA.BACADCDBAFFDhAAAUCCE..eBBD......hABA......hACA...,1,-16,-34,18
DXIKWYMcLCOENZbRGeSdPUgfQVHaATFJB,TGGDBDGFDCCA.KGFEMFCB.LAFAEFCAZACA.RAACGDDF.hAAASGFDdGAC.hABAPEABfEHGhADAHBDAAADCFHBAIGDG..WBBDCHAA..hAEA.NIEBeEDE..hAFA...,1,6,-38,44
VWEBMSQTDNIUCJfFgRLHPOZXecdGYaAbK,KCFCVDAGBADH..SCGEDDDHUFAF.CFGB...FGFELGBChAAAHBAFZEDB....hAAA.....XDGAhABAcGGCYACEAAIB.bBBAMICAhACANDFEfHBF.hADAPAFE.,2,-36,-25,11
gDMWaYBHcPIbKSZLNVGUTdOAefQJRCEXF,eDACQDACRDEE.EHBGXGBD.DCFCaDGHBHGBHBCG.IGGHhAAASFAHNDFEGAGEhABATGDBOFAEhACAAAGECBCFFAAFMEEF..WAFA.....hADA......hAEA...,2,-28,-5,23
JCKgVaLNOABZHDRPcWGfETbSIQYUeFXMd,ZCDHRBCF....PHAGGBFG.TCBASDAHQEADhAAAUEFBFCFFXADA.hAAAJFHDKAGBaHEE.OGAChABAAAECDGACfABEEABF...IHHAhACAMAIF.CHDA...hADA...,1,3,-38,41
LQcgEdXHTROSWUZaKYPfDNbIGBMJAVeFC,VDEDCDGFLBBH..QGBCEEEE.HABG.OAHBhAAAWHBAUBDDaGGAKCAB.PCCBhABADHBG..IFAChAAA.MGCAAHFHcAEAXGGH.SACEhABA..hAFA...,1,-9,-43,34
gJLAKCcFDEQNOeVMSdUYPHbTBZGRaIXfW,CFEDFHFGDECHEEGB...OBEBeAEC..SBBGUCBDHGBABHEFhAAARCFE..XAAEhAAA..gDEBhABAAAHEKFEANEAE.dGHA.bBEA.ZDABaBFAIACChAEA.fHFFhAIA...,2,-37,-11,26
gGcEAKSJWCUePVdfRQBMaHZILOXNFYDTb,KEEDJCCH.UGAD..eBEFdHEFRCBDMBBG.ZFDEOBEE..NIAH.hAAAFAEG..DDAD..hABATDFDGAGEAFID.SHFAhACACACG.fEHABAAHaDAH.IGAGhADA...hAAA...,2,-41,-23,18
cfbMBUYARPgVZOeIKEQDHGJdSFNWXTaCL,RAADVAADeEBE..EHBGQDGA.DHCCGAEDdAEF.SGFGhAAAFGGF.XDAEhACAaAHBLCDG.hADAfFBABDEGYDGDAEEG....hAEA......hAFA.ZFDFIACG,1,-19,-24,5
WcYNHFBVDRPdIObQKeGCSXgaAJLfEZUMT,JEEGEDCDUBFD..TBDG....cCCFHDAGBFGHhAAADAFGdFGAOABH.bGBEhACAKDAB.CGBASGEDhAAAaGAGAICALAFAMBBCYFHBNBIC...hABA......hACA...,1,-13,-35,22
cHRLDMgTIBGCSWYbXKQfeNFUZaEJAdVPO,dCFCVFDFOHDE.RAAE.MCBE..TCGGBCGHCFAF..SDCFhAAA..bDAEhAAAXAECfFBAhABAFFFCaHBGEHGEAGGC.PACGLCABDFFE.IEDEhACAYAHH...hADA...,1,-25,-26,1
FQKAJfaXdeRZVbSUYOWDNBHCGcLIPMEgT,aDCDXGGD.RBCF.VFGD..SBHFOADCDGAFHDFDCHBB.hAAAGGAFLCADMAFFhAAATGDAFCAGAIAAdEAGeCCEhABA.UCGA.........hABA......hACA...,2,-18,-13,5
GeEJIHMFLRbNSKBgWOUQPYdAfcaVCZXTD,aHBGCEGHZAAE..DAFEECGEHAAE.FDFGRFAA...SAGAKAFEBHHEOHBChAAAQGFHdDEF.hABAfCCD.hACAXEBGeCCCIEAHMCECLFFChAAA.NDAC.gFEBhAEA..,1,-18,-27,9
aZOCYXcPRSBQJbWVGHAMfTdLFNeDEUKIg,TFDBdEEDFABDDDAB..UBDFKGDB...aAFAOEBDCBAC..XCGChAAA.RGFEBEAChABAJHFEVAGFAIAC..fEBAhACAeCDF.IHCE...hAAA......hABA...,1,-25,-47,22
TAfMLKYHSEDQCFBOUWdZIPGNaXbVJRgce,LCHDKCFCHDBGECAGDFDGFDBHBFBE..OAFEdHEFZAFCGGEB.hAAA.XEGCVGAGJAAChADARABEeHAE.AGAC.MEDAhAEA.SCDE.....hABA......hADA...,1,-19,-21,2
bfeUEDOMRFJGNPBSZQHdgcCLVTWIAKaXY,aFAAXCBC....fADGUFGAOHAGREDFGCABBDGFQEDGhAAAdGGDCBAELHCAhAAAVAEGIGAAhABAKACDeHEGEDHBDECHMAEENBAE.......hABA......hADA...,1,-4,-20,16
dSBPVJDGcXQeaZgIMOWRFAfCbKYNTEHLU,CFDGKHBG...TDDGLCECUAAFSABDBCEE.JEHHDBHHGEAAhAAAQGDEZGDEMAFChACAREAEFHGEAEED...bADAhABAEDBE.HACEdDGD....cFFD.hAEAaDAG.....hBAA...,2,-16,-9,7
SYbCRWAKJNLIVaTPFXeBEdgcUMQOGHDZf,JCCHLGEA.VEBBTFAC..FBEABGFHEDDE.dGDA.UEFBhAAAOAHHGABFHEFADAEEhABAfCBC.hACASADFCCFAAIBAIHHGaAAC...eAHHhAHA......hBAA...,2,-28,-12,16
cDfLSXKgPBCGAdQTEYbNMFWHZOJaeVIRU,dEHAQFCAEDAC....NAFE.FBBBZGEAJAEB.eDECRGAADIDASGEHhAAAKECA.BDADhABACBAEADDG.TEGD.MAIBhACAHAGFaGAFIADDUGGB....fDCAhADA..hAEA...,2,-30,-17,13
LIWGbFdaOfAZJHMUTXYENVBcDRSPeKgQC,ZDBGMAGDUAFA..TFBBEHEEBFGB..DGGBRABF.SFFEhAAAKAED.CABALHBAhABA.IDBFhADAWDFDFDGAdDDFOHBCAEAHJAHBXADE..hAEANDAA......hAHA...,2,-36,-22,14
YKMTadVbQIeEXUfDRLGSCgNFZcHOWPBJA,KGFHTAGDdGBH..QBFGEDCF.UDAAfDGE.LBAAhAAASBCGCBEDFFDFhABAHEFCOHDEBHHGAFBDMFAFhACAaGAHIDDC.DIDAgGGBhADANABD.....hAAA...,2,-29,-8,21
AcfZGQaHEDCIBKgTWNOYdPbFMXJRSULVe,ZAADQECBHEDDEBGFDDIHBHEAKAAC...TDGHOADB.dBFAFCCAhAAAMHDCJEBF...SEGBhAEAUGGBeAFCfGAFhAFACACA.IFFDNEAA.bAGF.hAEA......hAFA...,1,-12,-23,11
ZQGXVaUbBWSNMgJcOAdFICHfPEDLTKRYe,dAFBCFEDHBFAEECHLHDGKFAE.RCEG.ZCBEQBBHGAAFaEHFBFFChAAA..SHAEhAAAMFHBJEABAIBAIHDHhABA.fGGDDAEH.TDEC..hADA......hAEA...,2,-23,-20,3
QKaLdHCTJFBDMgebYGXSfPcRIVOAZENWU,ZDAGEHBGUAADKGBFLBFCHDCA..CADBFGFBBCGG.MIFE.eGFEhAAA..bDGF.XFCAhABASDFD.fABChABARBECIHHHACCH....NADFWEDHhAIAaDBHdGAC.....hBAA...,2,-36,-6,30
bMKOeBgVNHWADaGQZFXJRdILPUCTcEYSf,DEFAGBDBQEABFDBGREFGLGDEUBCC..CHFG.EEDA..SFFEhAAAMAEEKHEGBACGhAAAVAGFHFCE.ABAB..hABA.aGBDXGGAdBHA......hABA......hACA...,2,-27,-16,11
SPUZcXYOBWgDHIRfaTCJLFKeGNbQAMEdV,dHBHVDAGSGFE.ZBAEXFAGBECFDAGAHGDC.IEEEhAAARBFH..aAAGJCHFhABAKHEEeBCG.NACFAAIBMEIHhADAEGGE...cFAAOHAE..WBEFhAEA......hAFA...,2,-40,-6,34
beMVgGdBSOWDXfKJYNLHZTIAQUFCPRcaE,QFCAUGAFFCAG.CFAD.RDFA...EFGAeFHFMEECGBEHBAHEOACGhAAADDDD..KFDGJBAAhABALAAEZBEE.IHFDhAEAAHIBaGFH.........hAGA......hBEA...,1,-27,-28,1
TgYBMfaLXWIPGAUVJbZFDdCRQSeNcOHKE,VADGJFBBZDCF..FGDDdAAG..RFGB.eGDAODCHKBEA...EEED.hACA.TAGFBDGAaBAFhAAA..LEEEhADA..XGAGIHHAAIFGDCAHSBBEhAEANBIE.....hABA...,2,-33,-26,7
CcSGdXDRaYBMgTLZKJUbHNOEPAfQIFVeW,QCBCFCFCeHEA.CFGCGGDFdCBDDHBCREBGBEDH..MBADLADChAAAKAFA.JAHFUEGBHFBHhABA.OBFHAHAF..hACAfDEE.......hAIA......hBAA...,1,-18,-36,18
FJGUaMIVWbCBcNAfHDRgYPEXedSQTZLOK,DHCERAAD....PBEFeBEHSBHB.ZDCHOGDEhAAAFFFDUAAEMCAH.VBGHhACACCGDBAFEAEBGHEEGEDBDdADEhAHAQFAAKHGA.aHAC.WDCHNIAF...hAIA......hBAA...,2,-23,-9,14
JHgWIRTPDUNLSdMKQcCGEaFZBbeVXOYAf,JFBBHAAD...IFAGTGFH.UEDDLDEAdAEHKGHB.CAHA.EDBFhAAAZGCABAFH.eBAEhABAXCEGAIHE..fBDDhACAgEGF.......hADA.PEHDDCADSDCFhAAA,2,-41,-18,23
LdbMADCWBFVIfQYZTOPKUHGEgXSaRJNce,DAEDBBBDFHAC..IHFDQEGB.ZCACODAE.UDDEhAAAEABGSFDGhAAAREGD.JAFCeGCCLCFEhADAdAGEABFCCACA...fFAEYHEC..hABA......hACA...,1,-22,-39,17
GdaAcQVDBJbUeXKNCMYgHSOLZWfTFIREP,VEFHJFED..UBECeBAD..KAGCCFDE..MIFEHBBF.OEAHhAAAZCFC....fBFBhAAAIDHEEGCDPEBFhABAdHGBACAFDCDH.BHECNABF.SGADhACA.LAECTECH.hBAA...,1,-13,-32,19
WTSXZYbMNeCIfGcBVPADRLdHQKEOUgJaF,DGADRDEDLDBFdGECHECAKDCHOAFF.UGGGaBCGFAGB...SGGAhAAAXACDZBGBhAAAMFABCEAA...IEHDhABAfCAABHDEAICGEDDE.....hACA......hADA...,1,-18,-37,19
gFUDCKVeYAaNcBXfZTMSEOGRLQHdIWJPb,aHBGBFDGZDCFMEAD..ECAHOFHBLBACdCDG...JCEDPABAhAAAFAFEDHGC..CCGEeFBFhAFAAFFF..XCGDhAAASHEEQEAEIFFF...bBEBhAGA.KDHB.NBBE...hAHA...,1,-21,-29,8
PDaQJcVGeABEHKdONCMWfIZUFXSgLbTYR,EGFHHFEEKDDDdAHG.ODFGCEBD..MABGIBEHFBGE..SDHFhAAALCBB...hAAATBBAPGBCDGAEaEABhABAJAEE.....cEDE...hACA.eBDDAGIFBCEFNIBHfGHChADA,2,-44,-11,33
LSFYQUDKdNMbXfHOaTZCGJBIPVEAWRgec,RAADeGEALFGFFAEFUGBDDFBF..dAHE..MDAC..fBEHhAAAaABCZEFA.CEDHBHEChACAIAHAEDBC..AADC..hAAA.gCGCSFDAKCEDNDEF....hACA......hADA...,1,-27,-31,4
NdKPaTfUYBQObHFLDIRcAVGMCJEgXZWSe,MIDAEDABZBDG..SBGCdDGEKAGC.aAEGUGGE.BFDFOEFFhAAAHABHFDDGDEEGRBBCVFBDhABA..CFBH..JHCEWCADhACA...eEHFNBIE......hADA......hAHA...,1,-19,-31,12
OHRNAKJLTPBSfYdbXWFZIeGcVaCDEQgMU,JFFBLDACBAGC.SHGA.dDFFbCAAFAGF.ZFBGGBGChAAA.aGCFCBFGQFFChAAA..MFAEhABAOBBCRBEHABCCKHGAPEAC.YABC.hACA......hADA...,2,-33,-12,21
DERMBWGNJOfKSQUFdgCcVeXTYbPLAHIaZ,HDAGaCFCZEEBRDFABBCB.GFBDOGAASGGBFCCGdGGA.CBAD.eCAHhAAA..TBFHhAAAPADAIHFE.hABADAGGMDID..WFADNIBDfAHEhACAKDDC......hAIA...,1,-13,-26,13
TVbBLJGcgHWURIQDZYPdONKFESeCfXaMA,VEFHBAFBLEEF.JHAGGGBB.HEBARAAEQADGhAAADABEPAHF.dCDA.KCBFhAAA.EADACAHEaCAB.MCFEhACAAIEA.TFFD.gDGE.hAGAWDDF....hBHA...,1,-15,-30,15
LRcCEUFKgZPeJWTYMNDXabOGISBHdfAVQ,QBDGLFBBCDADFAGCKGEFZCBD..eAFDTEFB..NIEB.DFDDhAAA.aBABOACD.hABASFHBdBGAfHGFhACAAGGFREDG..EBAAgGAC..hADA......hAEA...,1,-23,-28,5
eJBfIcDTEXdGZSVAOFgRCbMHYUNPQKLaW,FDCDCFDDHAFAUGEG..QDBGKAGDLDADeEHBBHHG..IADHhAAADACG.EEECXCDFhAAAZGDGAABGRBBE.MBBAhABAPFAB..JDHFfCHEdHAB..hAFA......hAHA...,2,-34,-11,23
JKgQYRLScGMOCZPXAHadTVUFNeIBbEDWf,HFEEdFAAUCAEFDDDeACGBFED.DBBB..JAAEQGAC.LHEGhAAASGCBGAFEhABACHGEZCDGADIFaEAE..hAEATADCIAHFEFHB.KCCCRDFA....MAIFhAAA.....hAFA...,1,-7,-29,22
WIVSMPbFDBTRfcUAHOeCLEKQgXYaZJNdG,eFFCEDABKECCQDBB..XGEGaBHDJACC.dAHAGAFEhAAAIHHF....hAAA.MDCAPHACFBAEDGCHhABABGHDTEFGcECEAAGHCDHGYBAA.hACA.WBDG...hABA...,1,-21,-22,1
MEgADeNTaHCBfJVdILRZUGXQcYFPWKSbO,DEFHeDAC..TCGGCGFABAGE..JEAFVFCHdBBBLADB.hAAARFCF.UDEDGGEFXFAFhABA.QABEhAEAFAHF.KHGASCCD.MAAFhABAAECCNBICHADG...hACA...,2,-23,-13,10
CXVgDKfFaNYSBPcHEQRWTebZMUOGJAdLI,LCCHXGGGDAFEFBFF..aEEF..SCDEBHGGHEGFREFEeDADhAAAMCBFOAHBACHC.hABACGEDKACCNBCE..cCGChACAQGAE..TDDG.ZGBE.hAAA......hABA...,2,-25,-14,11
bKICAfOEGHBadLSZMDYJRUNPTQWcXFgVe,EDCDGCCFBCABaGAFLAEAZAAC..MFHHDIFARFAEUGEE..TGDGhAAAQGCC.hABAXDACFBHDeFFEIEFHhABAAEEDfBBBdCHA.SCFFhACANACB......hADA...,2,-27,-4,23
dUNKQWLTBCMGHREeZaXFOJIPYgbfcSDVA,UGBCQGBCLFEACEEFHAGDRBAHZAFA..aDABFDEG..OACEhAAA.IFGFgACDhAAAbCCF.SHEAhABA.DAGEABBFKHEGBEBAMDIBeDHB...hABA......hACA...,1,-16,-18,2
aMSPJXKeGWRLbcAgVDTQIfOUBEYCFZdNH,DHCETCGCQEEG..OHAAEADCCDAAZAGFdDAAHCDB.aCBFhAAAPFHBKACBeFGDRCCF.hAAALAEAAFBA.IGEEhABAfBAC.......hACA......hAFA.BCFCNICB,2,-34,-2,32
QDRVSLUPCJHeZKcAOXGIadYTfgFMEBNbW,ODACXFGHGGAHdAGA...TACGFDAEMFADBAFA.bDFEDIGEhAAA.SBAFhABAUGFHCEEGeAAHKGEBACBE.IEFDhACAaFAG..fBGANEDA...hADA......hAEA...,1,-9,-36,27
LMZKcFeYSUdITDgVQXOfCGNBWbPHJaERA,MHACZDAGKCGEFBAD..eFCFUEFFdGGB.DIDGQBFH.OFBEhAAAfGAG.hABACABABDHHbDBA.JBCEaGGEhACA.ACCDLAFC..YEFAhAAA.SFDHhABA...,1,-16,-44,28
ZaHOCGVTUJLMFNDYIgdScEbRAKfPXQWeB,KHBGXCBCQAFEBCHDHFGDGGEFUAECJCEH.LHBA.hAAAMEDCDABHIACChAEAdFFCSABEEDCDAFADfDHGhAFAPGBA........hAIA......hBAA...,2,-29,-13,16
SWgJCcEYKIMNDURPXFGfdeLBOZATaHVQb,HBCFQFDHSCFFJDBB.CEAD..EAACIDDFDGHF.RABAFDFFhAAAfHED.LHAEhAAABAHFAABAaCHHbCGH.hADA.gECAKGGBMICC.NBEF.UAEA..hBAA......hBGA...,1,-2,-25,23
QIRZEVebLHKDMaGUYWBXOJPcATSfNFgdC,SGFCFHBGdFFF.CHHC.RBCCEEDH..VDADeEAHHADB.DAIFaBBBhAAAGGABUCGFBHEChABAJAAAAAGC....fDGEhADA.QDDBIAFF...hACA......hADA...,1,-13,-35,22
FYgcMeSDdVTbAGKWIQBHCUNOaJXZEPRfL,KGAHQCBCHEBCCCCF.OGEA..XFFAEAEHRAGHLHFGhAAAFAAC....gCADhACAcEDBMCIDDFIDVAFBhADAAGBEIABFBHDCaDDA.....hADA......hAEA...,2,-22,-22,0
IGWCadPQSfHERYFLKBMZUXDJAbcOVNeTg,OGEAVFDF..eDADTDFBGAAC.CHBF.aCCA.dDBBQCDGhAAASAEEHAGFEAACFGCFhAAAKGGGBFCCZBFADFDCADIH.hACA..NDAE..WFHB......hADA......hAHA...,2,-20,-12,8
fHTLVFdESNUWCDeAQXPbMBaKGgRZcIJYO,QCGCXCBC.MDEBBGHC.KGBBRFGBZFCH..IACGhAAAOABDTAEDFHEGdEEFSBFBhABANEAE.CFCEAGAFhAEAaADH...........hAFA......hAGA...,1,-19,-42,23
QIgCMcYVRHSGUdEPLKJDfBOeNWFAXaTbZ,XFCATGBC.ZEAHQABE.CAEG.MCDG.VFFCHEFEhAAASDDCdGHEEBGELFADhABADAABBCBAeCEFhAFAFADGaAHDIHEH..cDFG..hABA......hACA...,2,-29,-2,27
feUaKZTQBDXARcMJELOIFbVCPdWYHGSgN,RFACJCHDOFFA..FFEDCCCC.dEADHGEEGBAH..SDDChAAA..NBDFUDEFhAAAKADCTBFCBHGFDADCAAHBMABFhACAEGCD....IGAF...hAGA......hAIA...,1,-30,-35,5
TQdZWIADGMXPOVNeFLHfaBYKRgCJcEUbS,GGBDXFDBOAAE.eDAEFHBCLAGHaCFH.BGGHKGHBCEEDhAAAEDAAUBGASECFhAAATEAC.dBBH.WACChABAAAEGMIEA..NEEF.fCCB.gEGFhABA..hADA...,1,-19,-25,6
PJHZDEaNFBVScLdReYOAWKCUTgIfMbXQG,CFEDUCGC..TDGB..fEAFMAABQGFHJFDGDBAG.hAAAaGACBAEF.SDDChABAcBFBLEDFhABARFBD.eCBCAGHAKCAFIEBC...hACA......hADA...,1,-12,-42,30
JfDSGQVbdXYZBFHMRPgcEWAeKNUaTOLIC,KDCDaGFCLACBCEHC.DDEBSAFB.GBEAQEGHhAAAdGEAZBACFBGAMIAEgFBDhABAEGGC.AECEeAEDhAFANDAC.OHDC..ICHEfBBAhAGA.....hAAA...,2,-34,-11,23
JgFQDOCKNdBaWbTSUfXcGMEeYARLZIPHV,RDBGLFBBZAAGHBCCJCABQFBC.CDHE.dGHEBHHEaABATGDHhAAAUFEG...XDEHhAEAMFAFEEGG.AAAA.PAHHhAFAFBGBDGGGKCDENAEF...SDGGhAGA.fHFFhAIA.eCCB.,1,-7,-10,3
PGWIMSDEOKQNRJLXZceCabBfFUdHYTgAV,VEBHGAFE.MBCHEGGA.QFGD.REAHLAAHZACDCAHABEHGhAAAUEDCdEEBTAEFhABAAHEAIDHGSHDEhACA.DCIH..........hAGA.KBBDNIBDXACBhAFA..,2,-28,-7,21
DNeCQMEVdJbRcOGBWFSIKYfHTaZLAgUPX,UCBCXAFBDADG...eHCCMDGFdAACRFBH.OEBBBEEE..FGHHKGHFhACA.HDECZAGFAIAAgCCHhADA.CADAECHBhAIA.JFDAbFDD.....cBDF.hBBA....WBAFhAAA...,2,-48,-1,47
EVUMBSfLbeKNZJCHRQTYDdgFcPGAIOXaW,ODACaGFC..VDBEMFCH.BGABLAGFeAFAZFDECACHHEFARABH.hAAAQBACDGHH.hABAFHCGPDFAAEAH.XADFhAGA.EEDASFAH..hAAA......hABA...,1,-17,-24,7
PfHKZOIQeGVFXDcUALCBgaETWSdYbJRMN,LFCABBBDaAGG.EGFH..SEDCdAFAJADB.RACD.MEFA..hAAAfEGGHBAFKHGGOHBAhABAQBGHeAHFhACAGFCD.FFAB.cCAHCHAG.WFHHhAAA.NIBB.....hABA...,1,-12,-25,13
NMRVTEOeYaHdfZQAgcJBKSLPXWGCbIFUD,JGEABEFALEDF..XFCECABG.FABHDCFGRCEC.EEBFOAFGhAAA..aFAHdDAAQADBhAAAAIFGKECE.PCAEhACA..WHBGbEFA...IGGDhACAMIAE.....hAEA...,1,-31,-40,9
YKGMHaSPfeWCVOBDQRLJFcAEgUIbTNZXd,UGBCTCBCZCFC.dEBBKAAFHFEB..SEHBeCAF.CHGCBGDChABAQEGDRAGBLFEHhACAFABAAHIHEAGC.ICCFhAAAbEAHXADC.MCGB....hAEA......hAFA...,1,-13,-23,10
UcHCZVLOYWSXMbaPEBgQGDFKAITRdJNfe,REFHJCCHeDEHHGDGZDBDLBFB..OBDGSACCMADEaHEChAAAEFADBHHG.QEGEhAAAFBADACHC.dHAHfFHAhABA.CAHC.YBAB..hABA......hAFA...,2,-25,-22,3
UgfEJPbWOFVIaAeZQNCTSLYMXHGBDcRdK,ZAEGCHHGLAHBMCAAGEAHDEEH..dBCDUGDG.EAAEJBFH...hACA.bGACFHEA.aBADAGHGeDBEhADA..QFAFhAAATGFEXBGEBDBAKFFA...fHCBhABA..hACA...,1,-1,-43,42
bFTCELaHcdRNZfUKQSBJOPgWVDYIGMXAe,FDCDTGAFCHEH..LGBGaCGG.HCGHdGEHZACFKBBABEFEJAEHOBBDhAAA....gBEFhAAADDHFIBAFhABAXFGEAAIHEEFFNDIEfADF.SAHBhABA.PDABhACAYFAC.,2,-23,-18,5
ZPQOJWNfCeXUIVaTHGMRYADcdSBKbLgFE,DGHHdAFBKCAALAEDFFDD.ZAAH..ODDCJGBC.....NCEF.hAAACGEEXAGC.hABA.IGBCTDCGMIDGhACAAACABGHC.bFFBEEFE......hADA......hAHA...,1,-37,-45,8
LaNgEMBFSbGJWYIXPZKcAfDQTUHOdVeCR,DAFBUCCBOHCCdFBD..eHEACGBH.RAFGLAAF..NCEEMEHDhAAAFEHFGDEE.JHAEhACAIGFE.XBGEhABA.KEAFAHID...fCCEhACA.TACAaCFF.hADABDFC.,2,-49,-17,32
GcJdIgCUbXVeWNTKDZHAQFOfYEMSBRaPL,QGGDOCCH.EEBEBBHD.aHEELCHBGGBFdFEFCFFFbFDHeBDChAAA...NEEH.TGBFhAAADDFC.AAGAFBDFfABChABAMBFGPEAHJDAF.ICBH.hADA......hAEA...,1,-4,-25,21
RKESHZJaNOUcCdTPeAYBQDIfWgGLXVMFb,QGGGDACB..fGFCGCAGVAFGMCFDFGDC.KCHBEFAHhAAAZADBaECDUAAF.dEFHhABAPBHHAFCG.BADAhABA.IAFC.......hADA......hAIA...,1,-14,-35,21
IMPTUgVSZadJKcDGBebAHNCXWRfYELFOQ,CFDDREFHEFHFFCAH...OAEGQFFE..MCACUBFH.SBCFhAAAdHDFKECFDEBBBGAFhABAADAGHCDA..NECH.fCHEhAAA..YHAGIHBA.hACA......hADA...,2,-45,-23,22
SIMRGJDFXQWLNcObdUEgZeaAKTBPfCHYV,KFFBBHHGCCGD.HBBA.SBFBMEBDGADCDFEBFEBE..XAGBhAAALFFE.NEAA.bFDFhABAdCHA..EFHFeAAChAAAABIBTABF..fADF.YHBAhAGA...hADA...,2,-32,-16,16
cVgYHBKNZbIMJaWLRPedXQCEUSDAFfOGT,OCCHTAGH...VGACHEFF.BEBBKGGCZBFBIGDD.MCABhAAAaAAARADFdCGD.XDDGhABA.CBCESGAAhACAAIFAfFDG........hADA......hAFA...,2,-41,-16,25
NdWbGJQYeMfOUPRTgHAEaVSCBKcFZIDLX,EEHBaEHB...CACEBGAFFAHDZDAALAFCdGDHGBAD..QGGGhAAAMIFAUEEFRCEEgCCDhABAABAE.KHCADBDEhAAA.XFAFNBBE..WFFF...hABA......hACA...,1,-18,-27,9
BdfVJgbKOEFcHUZGDTNAILCSeMaPWYXRQ,LAFBeCAFMFEFaDAA.....PBBEXGAA.BHFGhAAAVEECJBGDKHGEEDCDHEAAhAAAUACCDHBAABAG.CAED.SFFEhABA.WBFF......hAFA......hAGA...,1,-26,-31,5
XCaAIWGPDbNVYQZeRgfBOdEMJLKUHcFTS,GAFEDACB..VECFQBCGZAEF.RFDABHGHOADHEEBBMCIFhAAALAAF.KFADUFFFhABAFHBASFHBhACAXBGFAIAA.IDEE..WEBFNAIE..hAGA......hAHA...,1,-4,-36,32
PYHJUGSgbFVTEcBadNWAXLQZODMCfKRIe,XDCHQAEGDEGGMFEG..CFGDKCAFIDFH..eBCEhAAAHEBFGGCBSACGhAAAFBFAEHAEaEHD.NDAHAIHG.hABALHDGOFAC.fGAE..hABA......hADA...,2,-27,-18,9
bOFCMYPdBADUfRGaXSHVTEWegZLJIQKcN,DAFBREFHGCAG..aDFCHFDBEAAC.eADELADFJCDEKAHH..bEBFhAAAFGAH.MIFEdGFBBAGBhAIAUAAF.SHCAhBCA...........hABA......hAGA...,2,-30,-15,15
dfbPGQeYcJEBFIMUDXKANgLCRVHSOaTZW,LGEARCDHHGDGODAAZECCdCDH....PAACQABB.hAAAeFABJDGBEFBCIAEEhAAADIGAADID.CCAG.SAHDhADAWCGD.fAFEYDHHBAHFMEAB.hAEA......hAGA...,2,-19,-16,3
gKEVIGCcafBAUebNYDFSOZQXWMHLJPTRd,UDACeGEA....bCDCDGBD.FEFAZDBHQFCHMAAF.HAAEhAAAJBFG.RAEC.KFAB.IAEHhABACCCB...fEFAhACAAHHGSHGGWHAG...PDHDhADA.....hACA...,2,-39,-15,24
EZHOUfITPNbDQeAgVLSXJFKYcCadBGRMW,VFDFSAAD.FBDCKAFB.CGHE.BHEFRDFB.MFBAZAACHCAA.hABAOAHBIBHG.hABAPGFGDIFGAEDALFABhACAXDAG..cDDAaCHD.dHAB.EDGE.hADA......hAEA...,1,-18,-24,6
NFZBQWgdRbfGJHcUYeaEDPTASIVCKLOXM,SCFCCFDDKBEB.LBBDOEEE.MEEBFDCEBHDD..WFGFhAAAdBAARBGD..fGABhABAGEAE.cDGAhACAUGGF...eACHEACFDAECAHHFIAFDhAEA.NEDE.....hAHA...,1,-29,-32,3
UNVdRCXYGIMOJLAfcZKHTDbQEFeWPBSga,ZAADTCCBQGED.FEBEeAFGBGBGaEFAUBEHdGHGCBBF.GEAHhAAAMFIHLAHBhAAAADID.KEFCDIAA.EGFDSGGBhADANHAB........hAEA......hAFA...,2,-26,-21,5
ZaRSFLYVUbJIAKDNeCMEcWQXPBTdGgfOH,KHFGDEFHCBBFMEED..ECCHQBGF.BBAHGADH.fHDHhAAAHFBBZCDAaFGFhAAAFGAFLDGF.hABAVECFJADGNEIEeCADcDAB.....hABA......hACA...,1,-16,-25,9
PARODZdVcTCYNQgKXEUHfaSeLMGWBFbJI,OAGHZEEEdHGB...TDGCCBFDQBCA.KHBCUCBH.aEFHhAAASBAD.hABAeEAGMFDHBHADbGFAIHAChACAAAFGDIDA.YAEHXAABfACAhAHA...hADA...,1,-20,-38,18
SCNITOUgeAKJXHEbRZQPaWGYLVFDcdMBf,KGDDXAEGEFBH.ZFGHQCEG..PHCGGABAVBAFhAAAFADADIAC.MHFEBDEChABASAGBNFAH.hACAOBAHeGACAIBCJFFC.......hADA......hAFA...,1,-16,-27,11
SKNdLTOVYRAXQbCBDPUEGcWMIeFJaHZgf,XCGCCHHGDEIH.UCCDGBBG..MEBFFBEDHFFDZAFA.SGBGhAAAKEHFdFEBOHCGhAAAVAGF.AADBBHHH.EABFhABAcDED.IHED...eBAFhABA.....hAEA...,2,-29,-16,13
RJCATIDELNWFHYGBVfcUaMgPebSQKXZOd,TAFBDGHHEDDD..LHBEFAADGEGCBBGF..VFCEUDADMECEhAAAeBBC..SEAFhACAKDFHZFAGOFFHJCDAIHAGhADA..NDIG.WHCGfAAFhAAA......hADA...,1,-9,-29,20
PfDQJXNaKMSVAFdUTLReYOBWEGCbZHgcI,dFAAUDCHLCGHRBCC.OHBCBGBDEGCGGACGZAFB.HCEH.IHGAhAAADIGEQEGHhAAAXBABKBAC.SDADhABAAAGG.........hABA......hACA...,1,-22,-34,12
cECTHGfYeLIRUdgAJaFXVODBPbSKMNZWQ,JEGHFFAAODEFBBAB....SEDBKAACMEAEZGEE..QGBEhAAACEGFHACC.fBEAhABAeAHDRFCF.dAEFhACAAIBA.XDBFDDCG.NAHCEDAB....hADA......hAIA...,2,-33,-25,8
eJFVHbOGdBMSaLWRYcCEgUfNZQTIDPAXK,XGGDeFFBFGBGHABAGBBABCDE.MEFASEFD..hAAALAHHYFBGEDAHhAAAgAFH.hABAfHEHNEEEQBFFDIBAKDAFJFHF.OACGhABA.dDEF.aDHD.hADA...,1,3,-16,19
GfQAXbOBgWdRSYLVHZCFcNTDUaePIJEMK,XDACOAFBBCGDdGEE.RGAG.LABBZEGH.FHAG..TEDHhAAADBGHeFFEJCAD.KDEDQCCFhABAACFD..bFAEhAAASACC.......hADA......hAEA...,2,-31,-28,3
NfFYbBWPRMJGZKeDHCAVETUOXScdLQIga,TCCBUDCHOFFC..SGHBdCHGLBAAIAGC.hAAAaGFCNIAD.FDGFBGACREBDMCIFhAAAJAFA.ZFDD.DACECADBADFFhABAEAEF.QBAF..fGEEhACA....hAIA...,1,1,-39,40
fVRUEMBNdaPQJXHeYCAITSKZbWcLFOgDG,SGFCKCFCZDBE....bFAGLEEEFHDA.DAFAGACHhAAARCBAUACHEFGHBHCDdBAGaDFHhABAPBHD...JDAHhAAA............hABA......hADA...,2,-35,-23,12
JUYHNEObMCXSGaAIDVLeFKBdTWQZPRgcf,VFDGFAABBFEA.dHGBQEABZCEE.RBBA.....fGCEhACAJHFGHDFEEAHFOADBhAEAMABC.SHAGhAAAAFHBDBIHeBEA.KFAD.......hAFA......hAGA...,1,-18,-39,21
dKQGcRYeLFAOfMSXTgUHDPaZNWVCBbEJI,MDEBSEHB..TBGDUACGDGDDaEBD.ZAEB...VFEGhAAACAAFEFFG.dFAGKEBGQACChAEARAGFLBAFAIFCOBEFhAFA.fGEA....hAGA......hAHA...,1,-25,-28,3
fJCPRNTZgcIVOGBDaeASWbdKEHUMLFXYQ,SHBGdHBHKFFGUCECFFCH...QAAEJEBF.RDEBZBEC.hAAA.IHEH.hAAAOACFBDABaGEHAEAB.hABAEGGBMAHHXAGECHHE.NEAA...cCAFhACADDCCWFHB...hAEA...,1,-12,-50,38
ZMSVTYJROUfaNQBEXbKLgIDCWcGHAdFeP,dEEDeCCHZGDGMBED..VFAEJAAB..RGCC.OAFAUGAA...aDAChAAABDBC.EFGCXABFhAEAKFEELBFADDEACHHE.hBAA....WDFCcBDBAIHG..PAFGhAAA.....hBBA...,2,-36,-18,18
NgPHFYJMbOdZQELKUCcaGTDSeBAWfXIRV,XCBCRGFG..VCDF..PEEGHBBDFGDFJFBC.MBGDdGHCECHDhAAAKBHDUFAF.CAAF.hACAcGAC.GACHhABA.DGGHBDAEACADfCEFIAEC..hACA......hADA...,1,-21,-26,5
gGQAZPIcdMXLBDbCUYVaEWKRSTHJNOfeF,ZAAD..PAFBIFEGdHDFLAGBBDHADIBA.CGHG.UAEC..hAAAaFEAECGFKDCC.REAC.TEBChADAJBBA..NEEF..hAHA.fGGF.FCDH....hAIA......hBAA...,2,-33,-29,4
JBGPVbIcLCadWUMXDEKgYRHQeSNOFZfTA,GACBVAAD...IHGHCHABdDDF.MDFBDHDEKEGG..gBBGhAAARBFGHEAA.SBHHhABAFADH.fGAFhACAAAIDBGGF.bEDD.aCFF.XDAChADA......hAFA...,1,-21,-39,18
BfgdINHZURDXEFCAQbYKVLcSJaWOPMGTe,QCBCKHBGLDAGSGDB.aAGBOAAD.MFCEhAAATGGHBHHEdADFIAFBhACAHBDHREFCXCGAhAAAFGEFAIGE..VBGF.....WCCChADA......hAEA...,1,-5,-39,34
FBCHfJbMRcVXKdIETWZOYLGeQaDUANPSg,SHBGBFEDHCFEJAEAMACG..RBDF.XCFDdCAG..IEHGhAAAEFHBZAAFOFCChAGA.LAHFQGGHhABAaDDGABFHNHAHFDCH.CABA.fEBA.hADAcGGC...hAHA...,1,-11,-25,14
cRIBNVWfXPAJZgDYTKebaQEHCLGFdUSOM,JFBBDHCEKFBG..eBDDQCEGHFEFLDFEdCAA.UAACOFFChAAAMCEERABGBHFE.hADA.NBED...fHABhABAXEGGAHADgAFD...hAEA......hAFA...,1,-24,-34,10
XESKCQWADLgIHNFRaBcGMfdUOYZPVJebT,DEFHLGEAHAFEREAABDCEGGEHMAFC.dCEBOCBAZAAG..JEBFTCGGhAAA..EBHDCEGDAEEBhABA..IEFEhAAAaACE...fCAF....hABA......hACA...,1,-21,-36,15
FgaPBQJEWIGLOSZNUTcYAeRVbfMKCXDdH,eDACRGFG..VAABMBGBKFADCGFD...dAEGFFCF..aDEABBCC.hAAAEEFBGDBBLAFChAAAOFFASCHHhABAZGBE.NCEE.cCGAAIHE.......hACA......hADA...,2,-34,-16,18
gJQNbcRYAdBHITeDOZVUMKWaCPfLSFGEX,BHCHTFDHDEIF.ZBABMBED..KBGGCFHGLAFCGDDG.XAAFhADAJDGH...bBFHhAEAREBBAAIBdCCEHADA.OFABhAAAWDBF..aFFDSGGG.ECCDhABANICF......hACA...,2,-26,-10,16
aGgFZefcCWKDVNOQBHRYJAMPISUEbLXdT,MCCASHBGUDBALHACdBAFGBCAFDGDeCGD..CACDDGDGOAEChAAA.QEEGhABABBGH.HDAB.YAHBhACAAAAGPAEAIGGFEHGA....hADA......hAEA...,2,-42,-6,36
VFRTBEMQegUHJdWXPYfCGDKNOSIbZacAL,LDCHFDAFBGBC.MEECQECFUFFAHBAAdHGB.....PAFGhAAACEHFDBCAOFFBhAAA..ICEDhABAaCDGAIBGRAFA.eDAB.WHCGfBABNBIA.SHCEhABA..hACA...,1,-13,-38,25
HITKYeZGEQCBaMRAfFSdLNgWPVcbDOJXU,FAFBSEEDdHFDLECD..NDAF...PFDCVBFDDIEEODAHhAAAUFAB.HAAEIEHChABAKHAAeEHH.EAEAhAAACCDHMAHBAEHD.gACC...hACA......hADA...,2,-26,-17,9
eOWXVcSAMJEUHbaDTBgPfdRYFNCLGZIQK,EFAGHEFHDECETFCB.BBCD..PGEAfBFDRAAC..hAAAFHCCNDAFLEADhABAZEFAIAEC...eAGFhAAAOHEC.XCFCSCDGACIF.MAIBhABA.....hACA...,2,-23,-21,2
cdGFNMZOeYHTBCVgDWaKXPIfSERJbLQUA,GEAHFGFHMBBEeDGBHCACCCAE..DIGEKGCA...XDEBIHBBhAAA.EHDEJAFGLAEBhABAAFADdCGAOFADTABCBGGBhAAAgAGEaFCA.SFHH.hABAQEECNCIE.hACA...,1,0,-20,20
NafWDTPdXHAZBCKYeIRVcOEJbGMLgQSUF,CDCFeCCHRBAA.OEFG..JDFAGAABLGBCQGGCUAEF.hAAAFBHF.aGDADFAGPDADhAAAdHGBAAHBBHCG..hABAIHAGEFEE..MAIF....hACA......hADA...,2,-36,-12,24
GCSPHBITUeQFWKZfMROXELDaANcVYJdgb,VAADdDCDGBBF.CAGFHEFDTEAG.eAEHFFAF.ZGAGMFDB.OAAAhAEAXDEELHEAhAFADIFGAFDE...NCIG.cAGHhAAA...gFGC..hACA......hADA...,2,-26,-14,12
TXZNQRcAUegHJBfdSIDMFWOLPCbYEVGKa,UDACeFBBHCCGBHEFdGBFDIEAFDGELAAE..PBABCHHG.EBBEhAAAGDFC.TDCGhAEANBEBRFGF...AAID.fEFGhABASAGBWFAD..YAEBhBBA.aCHDXGDChACA..,2,-34,-4,30
aJKCQHeONMRWUFVGPLTXYBcdfAZgSDIbE,ZDAGSHFGDGFF.EADEaEGG..KDFCCHAHHABGOECH..RECA.FDDHhAAA.GBACTGGHBAGChABAdHCHAFBBIFFGhACA.bEGDQAGH..NBIAMIAGhAFA......hAIA...,2,-24,-15,9
fPBOVLFAYSXHQUMICJbeEcDgdaRTGNKZW,XGBCQDCBUABECFDA..eAFADCEEdHEHRGEAGCGAZDGB...hAAAfCAEBEEFOEAChAEAFABFSFAGhAAAMBDE..IAHF.....hADA......hAEA...,2,-33,-20,13
MFVcABSQWCdafZIGLgJROYPNTUXKeEbDH,BFCFQGBCdADEZFDDLAECRCAC.OCEE..NEDBUAGAhAAAKDCAeAAF.EHFEDHGGMAIDhAAAFBAG.AEFCCFFE.IEHGhACAJFAF...YCBE...hABA......hACA...,2,-41,-10,31
QMVCFdUgSceKaZJHbARETLfWYDIPBGOXN,TCCBLGEA...fCABDAGGBGDAXGEDMIAG.CHHA.hAAAFGAEUDFD.SDADhABAKAAEJEFEHAEEAECHEGGAhACAWEAA..IBHEPCEB.GACFhADA......hAFA...,2,-26,-19,7
ZSHUJEOXPcMeVdRgNKWfaLbFBAQIDGYTC,QAFBDCECGGBHCAFBHCBA.JEEFOEFA..PFCDMDDGeDBFhAAAdAACREAF.KGFCfGGDhACAaBAB..FAHHhABAAAIHIADF.......hACA......hADA...,1,-11,-32,21
bJYGaBcROeDFAVQPEdSWMXgKNHLUITfCZ,QFDHEAFBdBBE.SFBBXCEGKHBCHBDHLGFAUBGDICBFhAAACEGDZBCB.JDFF.hAAAaAFAREAGDACA.AAIB.WHDAhABAMIFE..NDAC........hABA......hAGA...,1,-8,-23,15
MXfCIDUgWHVEJdRTNOcFSPAbeGBLQYZKa,GECFLEBEQBDAKCFHMBBE.CGGBUAGGHGAGEFFARFAG..TCADhAAAOHEA..SGDAhABAPCAAAEIDeAEHhAAABBBE.ZAGF..........hABA......hACA...,2,-18,-13,5
aRUScgLZKDOXeEGFMTWVfIJHCYbQNdAPB,aEGDSDAFLBADZCECDCFD..OGEGEHDEGDBGFBHF.MAAEhAEATFAC..fGAAhAFAIEFFJBCBHAFDhAHACAAF....YACC...NEIEABBFhAGABHHDUFCEcBCFhAIA...,2,-20,-12,8
FCTBSNEOUJdHfMacDbRKZAWPQXLVIgYGe,QCBCLADGVFGF..IHEAGCBDeFAFCADBBACGEGCCJEFGhAAAHDFA.MCECDBFCRGAChABAAICAXAAAFEDG.hAFASEACOCFCdGGFaBHD.....hAGA......hAHA...,2,-25,10,35
ZINOFecXUJQMfDgHdTLCKRESGbAWVaPYB,VDAGaHBGBEDC.ZACGODGD..FEAGeHBEUDGHQABGhAAA.DCGB.dADATFEAhAAACFADKEED.SAHHhABA.ADDCPHFENCIEXGGC..MCDEhACA.....hAFA...,1,-26,-30,4
TBcWEPKLfYSOARdQabNGCFHMeVZIXJUgD,QCCBaHBGGAFAHDAGeCHHZFFF.JFDHDBAA.BFEC..EBAAhAAAPFHHKADGLAGBhABASFAGADABRFAB.NICBCAHH.hACA..FADBMFIFICAF....hAAA......hABA...,1,-8,-23,15
gBUWFedYRaDTIMKCNfPAQZEScJHVbGOXL,EDAFJCCHHGDGGFDDLBFBBHDBUBGA.FDEBdGAC.RAAF.DGIHIEAHhAAAKADD..CABH..hACA.NCIE.ABADQGAEhAAAZEEA..SADD...hABA......hAEA...,2,-34,-17,17
FeRDQCPaSNZMWfHBLKGgYTEOdXUAIJcbV,JGEAVAAD..FDDFDGAC..CCAC...aHAEZCBB..MEFCHGBGBDCGhAAAGBEF..gAFGhACAEABCODFEXFGDhADAAAIF.........hAAA......hABA...,1,-34,-38,4
CeLIdBgMDFWASXQHGbYKNPJEORZUcaVfT,SEHBQCCBGFCHKBHH..JACBRAFCZEABUCECaDFD.TAAFhAAACHHALHAA.BGFAhAAADIACFFHHAGAG..XGDBhABAYHDGEEBC.......hACA......hADA.cADBfAEF,2,-32,-3,29
INXgaAEFUBGRMOcTVYKWZeHCPSbQfdJLD,FFAABDHHRACD.OHBA..TDECKAADeBDECAEG....SHFAhAAAfCCCdAGDDBGEhABAXBAGAFHCGEFAVGCAhABAZDAFHECE........hACA......hADA...,2,-27,-24,3
UMFAgBEQOTXPIWJbdeYDVcHRNSGLfaZCK,EEGDQDCH.OAGBTDAH.XGAEIFFF.JCHHeDCGhAAA.VFDCHAACSBCAhABAfGHACGHAUBGHhACAFBDEBAHB.WFABdAFBDBBENICF.aHDCKFDDhAAAACFD......hABA...,1,3,-19,22
QZJRKAEYbdTIgOMcDUNSVBLfFPCGHWaXe,EHBGdHBH..TFGFODBCDIFEUDFH..SBDGBADAFGFHCHADHBABhAAA.XEBEhABAeAGHQAAFZBGHKEFD.hACAAEIH..IFAFMAIH.....cAEDhABA....hADA...,2,-36,-12,24
BLdJTIVQSHWZYgNKDOPXeFRMaECAbUcGf,UCBCGAFEBGEGJBCG.....TBFCIBAGQGAAhAAAHEAGZGFG...YCHBhAAANIEDKACADEFC.OBAHhABAeEDHMDAAEFGDCFAFAFDC.......hABA......hACA...,2,-25,-21,4
PBISKWYfXUAcTHOdFJNRVGbLZEaDQgCeM,HEFHOEGHdEBAFAEDJCCA..RGACGCADLBFC.aEHDQFDEhAAA.CEAG.MFEFIACEhABAKABAfBAEhAAA.AFAF.NDIEVAGBbGAADADE.....hAEA......hAGA...,1,-14,-18,4
UBDYMbcaJTHOVIAGRXQNgLPfSECWKedZF,RCDFXCGCQBACLAAC..SCGACDCDeFEEZAEDFGEEDHCGhAEAMFFG..aHFEJACEhAAATAGCOHBEIBBChAIAAGCH...NEIG.gAFFEEBB.hBEAdDCC.BBHC..hABA...,2,-23,-7,16
BFZTXfEJWSAGDcUNILRVQKCaPbdMgYOeH,GDCCDAFBUGGELAFG.REGDKCHHaABBdCDAMACD..OAGFhAAABDAHZEEB..XDAFhADAfAAEEGAFJGDAhAEAAGAH..IADF.CCEC.PEFG.hABA......hAGA...,1,-25,-29,4
dYHVDAIFWBfZgOJXcRNbTSGUPMEKaLQCe,FHBGBFDGZDCFOCFE..JCFHREED....TDADSGHHhAAAGADBMEADEBBEaEHHCGGB.hABA.dADAHGAEACBD.IDDChAAA..fBGG..hACA......hAFA...,2,-48,-14,34
fOJTbERHSYQGFcLCXUVAeBgPIMNDKdWZa,eAFBBFDG...ICHCDCEGKAGAdDHC.ZDBBOEDE.bADHHFEBhAAA.SACDhABAGEGCLAAG.hADACGEHXGAFAAFGgGGBMCACNIAH..aEAB.hABA..fDEChAEA..,1,-21,-26,5
HPTBdfUGbFISOeQYJXEKRAaDMZNcCWVgL,MBHHZAADCAHE...VEBFHDCC.BFHBUAAHFGFC..SDBEhABAeAEEQCFAJHFEKBEEAAHGhADAaCDG..DFFHNICD..hAEA...gEGGPFBB.fGDAhAFA....hAGA...,2,-30,-21,9
KMeTGXSYcOILNgPUHWfEBCDJZdabVQRFA,eECCGABH.SDGGOADHLHFE..gAGGhAAAPFFAHGBAEFFCBFAAhABADABDdBFBaDDA.QCADhACAAAHEMFAB.XFCDcCAE.IHAFhAEA.NIDFfGHEhAFACDGA..,2,-23,6,29
KMeZHEPDcVSCXIYNBRQfdaWAgbJUFOLTG,JGEAUGGDLEDFKGDBZCDE.HEAB..DFBGSAFB.CEFC.hAAAIHBEBBAERACCdCFDhABAABCAFCAHOCAE.MIFAhACAEAGE....PEEA...XFAChAAANIABaAHF.WBBAhABA...,1,-6,-53,47
HNIPgTcXGOBYLDfFaKCVEARWJMUZdebQS,RFDFMDEBdFBD..eCDGSBGFHAAF..IHBATGFHGDAEhAAABAFALAHFDDHDfACHhABAaGHHCHFH.AAGEJFCBhACAUDABZCEF..NEEF.cBBH....hAFA......hAIA...,1,-9,-19,10
CdgXfSaYKZAcVBHEFTLJDROUWbPNIGQMe,BFDDHFEEFGCCJEBH.OBCB..UFGB..PHFCGAFGMEBHhAAAeCBCdAFA.XDDFhABASHFG.aAAChABAKADHAHDF.VDFELBHBDBIDWHAGIDDDhACACCAA.fADFhADA...,2,-37,-2,35
SJMLcPBEQOHaReTXNWYgVKCADbUGfIdZF,DAFBUFGHGGAFdBFHFDEBMDFG..LEBHBEDHEFFHOBCF.hAAARAAF.XAGC.hAAANIEH.gGDHhACA.CFAFADHBIACB.JBAH.cCCEhABA......hAEA...,2,-33,-29,4
eQEMgFHTXVDOCJKRLGcdfNYSZUaBIPAWb,eGEAEBDHFDABHCAD.VECDDHGG..CABH.RAEGLAAEGFAH.dCHE.hAAA.NIEB.SGAFhAEAZBFCBDFHAEDCQCEChAGA.MFIDXEFA.KHAGfBBBhAHA....hAIA...,1,1,-32,33
LMYODSJHEecKQCRINVFAbWXZgdPafBUTG,XCBCZDAGdACB..aFFBUFFFLBFF..MFEHDEEDJAABEFCFKCFBhAAA.CABF.RBGB.VACEhAFAAIAE.....bAGBhBAAPFACBDHA.........hBGA......hBIA...,1,-25,-37,12
ERXVdZbaOCSMFGLQeBNADHPUKIWJcTYfg,HFDGKGFC.JCBATABE....fACDEBGFXEAEdBGGZGAChAAAaHDE.OFAG.hAAAMEECLDACBBEAAIBGhABAPEEGIHGE.......hABA......hADA...,1,-20,-33,13
OTWMcLYUJHSeVAIKfFgaPXZQbDNdRCBGE,KHBGFHBG..aDGDXGFCZABG.DAGAdGHCBEEFOEDF..MADFhAAALBFHUEBEHAEEhABASCDEADHE.IAHFhAAAfEGD.PABFbDAC...NEAECFFBhAEAEFAF.....hBAA...,2,-29,-20,9
CXBGcMIOPAHFEbRZWKNLSQTeVfdaYDgJU,HFEEFAFBEECFZFAB.KAFELHDGQDGGeBBEdCABDEABUBDC.CHCB.hAAABBHD.MDAGOAHFhABAAFFCRCEA.SEEChACA..fEHCaGHD....hAAA......hABA...,1,-9,-35,26
EdOQfcWMXKGPUVFSAZTaegNYLbDIHCJBR,aDAFeGEA.....gCGHLEFEDGGBHAEGBAGEdAAFfDABhADAMCFCXDCFhAAAKECA.GEBA.PBCGhABAFCDGAAEENIAD.IHHGCHDDEFGE....hAHA......hAIA...,2,-20,-18,2
ZBHIDFWRNQgMTCePEdVcAOaGKJfXYUbLS,aAEGKCCG..JAAC..XBGAUFGB.LFBDBEEDHFBHDFIHRFCE.hADAQCAEMIEECAEF.hAGAECDAdAHEAHABGDEFhAAA.fGGASBFDIACD.hBAA......hBGA...,1,-3,-41,38
bBKVacfgLFEdeTYAWIQDCHZNMPUSOJXGR,QCBCDFCFCACG.ZBFEMFHFUFEF.OBBAJBEC..GDEGhAAABDGGaAFG..fCCFhABALDHHdHFHTDAGhADA..ADADIGBGNAIE.SEDChAAAXGDD....hABA...,1,-25,-34,9
BaFODPcWIefEKNQMGASgRXbZHVUYTJLdC,SCFCXFDHHEBHUEAC..JBACCDFABHHGODEF..DIAE.hAAA.PADG.IHHGhABAfEEEEHAGQDGEhACAAAFEbABH.YBEGTEGAaAAHhABA.WBHB.KHDAMDBEhAHARECB..,2,-37,2,39
UHaQgDXVNCJGBScWZfbETdIPeFLAMRYKO,MECGRDAGKAGEHABB..aFBFQDFCDAAD..NAIC.JHDESADAhABAZADCEEDH.dGGEeFABhAAAFGEDLEADhACA.ADGDOCDGUGGE.......hABA......hAEA...,2,-26,-11,15
ZYWTJCeONAMcHUKfgadFQIDLSRPVGbXEB,MECGUFDHKCHD..aAFEQCDADFAB.RABA.GEGC.XGDDhAAABHHDZCAHTABChABACAFDeEADADAGHCFEdHAD.hAAAIFCA..PEHDECDAWFAHNCGE.hABA......hACA...,1,-9,-23,14
GBVMKPeLRHCTZJEYdfDAXgSbOQNWUaFcI,SGFCODAC.QGCEUBCEaCFCFGAEGAAF.MBFCKAGDLFFAhAAAHEADCCDBJCGFEBAGhABAdDDDAIBE....XGEChACANADF..IHHGBHHAeECA.hAAA......hABA...,1,-12,-18,6
MDLQGZFBcSRNCdWAOeVaYTEXJfKgbPHUI,VFBGTGBC..EAACJAFB..KCEC....gFGChAAAHFGHIAHHDEFHGBBGhABABADHSEFFhAAANIDB.CDAHAIEAaCAH.fDGC.PEDDhACAMBCF.....hADA...,2,-35,-15,20
PCOaSFeKVWTfHbGIAdMUYDXNBZRQcgJLE,MAEDUAFBDEAABAFGZFGDRGFE....QDGDJGCE.EABFCDDF.aHAChAAAFADH..KDAB.TDCFhABAHAAFGCFEhAAA.ACIBdGAEYFCG.XAGF.hACA......hAEA...,1,-11,-31,20
ELGURPVDTYMXWfHKIdAgQaJecOSCZFNbB,aGFCJEEG...eCAAOCCBCFBA.ZACCFABEBHBBLBFF..RGDGDEIBhAAAMEIH....hAAA.fHBFhABAIDAFADECcAGA.NDECEEAF.....hABA......hADA...,1,-17,-55,38
dVCfcBLbUHNeSMOPARJXWaDYQgTGEIKFZ,JBDGaGFC..DBBAQEACGCCC.KHEEZBFEdHBFCAEB.BDGDLDHDhAAAHFGD..eFDC.MAAChAEAPCAFABBB.RGAE.XDDChAFA.........hABA......hACA...,1,-18,-30,12
AdRQgSYXCVFMGfDJeBWbHcUTOPaKELIZN,QCCBSHBGCEFDMBCA.GAFEDDAABDCAHFDFUAFDOHFEhAAAKHFA.EEAGZDGHAFADdFGDRAAE.hAAA..YHAAhABAFFDCeEBD...........hACA......hADA...,1,-4,-34,30
KBVNDgUREHAeSfXPCYLWbZMJOTIaQcdFG,SDCDXCBC.CGBG.LECCZAEA.OCGDTGEBQADDhAAAFABFKCGD.BGFCDDAHUGGEhAAAEGABAICGeGBE.hADA............hAFA......hAGA...,2,-38,-22,16
dPCRSeINfQELWgYOGATBJUVKFHMXZbaDc,BFEEUAEGKFDEMBEEZBABDCDH..dHEDRAAC...eCCF..IDHAhAAAQDGDLHFGhABA..gGBHhAAAOCFDGGAFAHHATAGAFDAG.....hADA......hAEA...,2,-32,-25,7
QfNPUEMbWgVeBDJAHCSaFKRZGLTYcOIdX,SBBDKDABGCFALCHH..TEEHOHBAXAGDhAAA.NDDB.UBCBbEGH.hABA.....VFCHhACABBAAAAECCBEAFAFAYEBEIHGDdGAEPFCAhAAAEACF.MABE..hAIA...,1,1,-34,35
EgcIdXCNQSJfTZAGDBaPbVLMWFRUeHKOY,BCAHaHBG...VDCCLEEF.FAACeCFGOADAEAEG...hAAAIGHBdGAGCHEFSHGAhABATCACZBGDAGFCDEGAhACAbCCF.MBBA.........hACA......hAHA...,2,-32,-29,3
WADZHEYRCcbFSfaXUBLJVgIQMNTedOPKG,HBCFECFCRBBC.CGBGFAGB..aHAGBDHGLEFH..VEECQFCEhAAAMIBA.NCIGeEAAhABAOABBKAGAAIHAZEAA..hAAAcADASFHHfHGF...hACA......hADA...,2,-30,-4,26
VFMTdbKfCUHEOAeLNJXIQcgWDPYGRSZBa,eEEGLEEG.JAAFQAEB..gAFHPDBDRAGHBBDDhAAAFGGDdDCEKGGCCHDBUEAEhABAEGDBADAB...ICHEhACADFABSBAB..aADHMDDC.hAEA......hAFA...,1,-17,-30,13
NgMbETDGSLQFVPKJfdIWOeCUAacXZBYRH,XGBCBFDDRDAAHGBE.MCBCTFFH.SEAFFAGEKEFFdABDOCAChAAA.CHHGAFIFaCFAZBFHhABA....YHFAhAAAbFDFDCFFQABE....hAEA......hAFA...,1,-16,-30,14
ENDQaOPfZGXRBeWAFcHUgCSTbdKYVMLJI,FCFCUFDHCFBC...TBDHdACBKBHB..MIFELEEF..EDBFhAAADGGCOAGHZBAF.XEFBhABAeAFAAHIBHGAChAAAgFAG.SADEbDCB.JABB.hABANBIE.aHFE....hAFA...,2,-25,-13,12
MHdNILJAgObPKGUSWfeYXcFCTaZQDVERB,OGEAKHBGUCBB..SCABeADB..XEFGFDCHCBFBZAGBDDGChAAARAAEBHEEHAFEdFCHLAEDhAAAAIFE..gGGEhABAbGAA.PFABWEFG.....hACA......hADA...,2,-28,-18,10
XYUaGcIbDNdgeCLTERJVSMOZAWQFfPBHK,FGFCBFDGHBCEKBFHUAAFaCAD..GCGC..ICDCDAFEdAAHCHBAhABALFAHEDEF.JHDChABASGBC.hADAMIDGABEEQEEAXBFB.bCGD...hADA......hAEA...,1,-15,-35,20
NDcbfLVESeXTCMJYUOHaAIZgdBWPFQKRG,ZAADBFEDFDCDRBFAGBAGDCGH.....bFAAfFDF.hAAAEGGHXGGE.hAAAMIEEJHBEOEAHhADAAIBEIAFGdBEE.QACANAIC.cDDAhABASFHBCEHA...hACA...,2,-30,-23,7
JSIBaENfeVPCKHRLZgWXOQTYFADMGdcUb,MEDBdGAHUBED..SACABHDGEAAB.eHFE.CCHC.KFHHHAAFhAAARDCG.LCDGZEAA.hABAXEFGQCAFhACAFFBHDIEEbFFB.aHAC.fAFB..hACA......hADA...,1,-17,-25,8
aXNDGdQPKbBMIYEgVSAWcRUFOZCJeLfTH,RAADUGGDFGHHZECHCEAG..LGAGHAFF..XFAADADGdEDHKCABMAIDhAAA....ECFBSEGEhACAAIEA.OHAChADAeBGBaAAEGEEA.bADDBDCF..hAAA......hABA...,1,2,-41,43
gQXCdAIYfcTDBaWNMSROZEFPHLKGVbUJe,..IFDGfHBHDFAB.BHFD.aDBBMIFA.RCBHZBGDFAEHLEGDhAAAGACDUFFFgDEFhABACBAD.dBBDADIH.hAAATAGFSGCGEEHF.KHAA....hABA......hACA...,2,-24,-14,10
bXAPZFHCEeOSfWDgMUTVJKYdGLNcQIaBR,ZDAGCCAH.eHAEOBEA..SDFDDDHDUFAB.JFBGdGEDLBFAhAAA.QBAGhABABDFERDCBXABBAIAGFGGHEDHBhACA...fAGFMEIBKBHB....hADA......hAEA...,1,-13,-42,29
SeZHXDOKJVdfgbPAFWCMEQcGTIUBRaLNY,CFEDEAGDGACGUBDEBGDBLBFF..SHGAeBAHHEAGODFEhAAAKDGE...JEAHfGGFhAAA.PHCAhABAAFGBFGCHQABAIBHD.aFFH..hABA......hAEA...,1,-10,-33,23
gXMUKbROVYGLBASWQadcTZHIePfNJFDEC,QGBCaAFB.dCBBZEBCHBFBeEHD..fADHJHCCDEDCCBCF.hAAAXEGEKCGA.OEEDhAAA.GDAFhABABHAHWCAAIBHAFGFF.MIDA....hACA......hADA...,1,-5,-42,37
fZOEMWJKCUgGLVQPdbANXSHRFYTIcDBea,SGFCRDDFFBGF..TGGEDCBABEBH.aBEGOFFB.EAADhABAMEEBKDCF.CABGGCDBhAAAQACAdHBFACABNCAAHGAAhACAIAHF.eHFAfEHE..hAFAWFFE....hACA...,2,-36,-7,29
WBeVOKJUfXcYHAFgPSTNZaCEDRGLdIQbM,FHBGSHBGZDCF.EEDEDAHD.LAABdAHGQDAHMCEFBAEAhACAOGAA.KBCAJCFBfHEBhAAA.XGGEhABAYFGF.AEAG.TDFGCEHB...hADA......hAEA...,2,-44,-11,33
GLQCPZXOMBKAIEFTWfdHcDJSegaUbNYRV,EAFBTGBCdBBEHEGF.DEECJHFE..SAAFaCCHUDGA...hAAAbEBBREDHGBDF.hACACCAC.PADF.OGDEhADABHAGIABFFBHBfFDFcAGANIAB.hAGAYFAE..hADA...,1,0,-29,29
ZYSOfcBVaFWTdPCEAJUGIeLXNMRKgHQDb,JDACUFGHGECDLFAE.MBBGKCGDQBCADEGA.ZFACSBEHhAAA.OHCChABABFGHaAHBFBGBdFEAhACA.ECCAeHEE.NABH.gGAF.hAAA......hAGA...,2,-30,-17,13
SfALIFXeRUJMKVPdZQCcEaYNTHOgBbDWG,FDCDeADGRFAE.UFEEKEGC.dCGCZFEC..CFAC...aAFH..TAAChAAAOAHDBDCB.DEIHGBAHhAAASHAGAHDH.hABAXGGD.MCCC.....hACA......hADA...,2,-39,-30,9
PbBGKUYZXMcQfWLNRADCeTEIVSJaHdFgO,eFEDEGFC..SAGAaEEFdGBB.FGCAOABHBFAAKBDFZBECMDDGhAAAQCEHLADCADIDDFGEhAAACGHE.....ICBDhABA.JHAA.......hACA......hAHA...,2,-32,-31,1
JBeAgRPGDQEXUdaVTHcSFZKLWCIMbYNOf,RAADGDCCDAHH.EBEAUEEHdHGF....aACBVFAE..HEABFAECLHFAhAAACAAGMICAbEEB.hACA.OCDABAHFAAFA.hADAgEGF.......hAGA......hAIA...,2,-37,-6,31
FGXbNODECSJULAdBePKZcfRHWMQTYgVIa,eCAFKCFCZDBEREDCHCCC.QACGTGGE..VABAFGHBXBGEhAAAODFE.CFBHUGDHhABAAAGAdGFCBFAG..cGAChAEAMAIB..YFDB...aAAHhABA......hAEA...,1,-1,-30,29
JKTINegdLWOUfbaQCMAHGcERVPXZFSBDY,HEBHEGAHREGF.VAGFZCEEBBFGDGFC..KABA..TAACeBEHLEFAhAAAODBD...fBDAhABAbFEF.CDACAGADhADAcGBDXGEGYAEC...IDADhAAA.dACE.hAEA...,2,-20,-11,9
JaLUeFXOfPZMYWNQHSDbIECdGcAKTBRVg,KFFBTGDCRCCE...JCBCUBGA.FGACXGFD..OEHBhAAAZCGDMBFC..NACB.hABAQEADHEBE.hAHADFDA.EBDE.dHABABCBBBEHaAAB....hAIA......hBAA...,2,-37,-14,23
cVJRYASUbWTOFQHCZEPMBNLKaDfgIXGed,UGBCTCBCOAFB.HGFECAEAEECABGDALEFGDAIH...IHDAhAAAeEFCdBCDJABGAEEHSBADhAAAFGGCZAGBNGBF.hABAaAGD...gDBCcBED...hAGA......hBAA...,1,-20,-21,1
STNQgaKDbdBAXfGZWFCERMHULIOceJVPY,XFGHGEDHFBFDRDAA.MBCEHAAB.LADCOHEA.eCHD.JDDChAAAPAAH.TCCEhABAgGCA.KAHBhACADHBEBFCFAIBAfEABCFFA.EAHH..hACA......hADA...,1,-3,-26,23
VLEGKcRFJaNIOeDfdWCSXZBPQMgbAHTUY,TDCBVEFH..EDAAKACE.FFEC..aBBEOGAADAAB..dHDFCGHEZBBChAAABHBH.MCEGAAFGHBFAhABALDEC.GEAFhABAJHDA..........hACA......hADA.IAHHfHAD,2,-27,-17,10
PDMYaQTOFHdICKRBNVJecSWZLXGgbfAUE,EGFCMCHF..QDCETABD.FBFBdDECKBCFBAEB..VFAEhAAAeDCHSHCAhABALGFGgGCChAAAAADBDEGCaEEF..IAHDCBHENIDBWDAD.....hACA......hAEA...,2,-25,-19,6
GRDHYTUWdJSOKZcLIPCAVMgXFQeNEabBf,VFACXFDB.FABDeEGH..EDACBBBAGDEFDEECHADCUFADdBHEhAAASAAFKFHFZADF.hABAIDCGAIHGMIAE.NIEH.hACA..fBFD..YAHFhADA.....hAFA...,2,-21,-12,9
bVOGWcLCdTDYQERJfBNFUHAeMIKZgSaXP,MDEBKCFCZDBE..aGGH..XFFC..bAFFOBAEGCBChAAALHEGCFHCdHCBDAIHQDFBhAAARDFABBACFBDAAICEIAGEhABASEAD.......hACA......hADA.PFBC.,1,-14,-22,8
ZPVHJNcQgbaBRFUIDeGdAYMLEOXWTSKCf,LCHDEGDD.OFACTGAGKDFFZBFAHACBJADB...QAAFhABAaFGGFBAB.UGGGDDEEeEEBhAAAAIBEMAFC.SAEGhBHACFAC.fGDA...hABA......hACA...,1,-10,-32,22
VIAgMFSaGNPQcKCeLHdUJOfRWZXbTDYBE,MHFGaDABGDEF..QECGKAHFLECDdFGBOBCGRFGBZFDF.hAAAXAAFTBBGDBFFhABABFEA.EDAAADDGFGAFNICBCAGA.hADA.HCFE.fGAC...hACA......hADA...,1,-8,-15,7
bcHORZaETdWUGINeXSfLJYDCBQFPAVKgM,VDAGKGFHMGBC.HBFAZADBEHEE..TABCUAGFGDGG.hAAAeFBASHDGhABALAAEYEFA.hAHABFAF.QDCFAHCC.cBDBhADA.aHAEdEEAIHHChAEA..,2,-15,-4,11
RHOaJbCDQAefNGcKdLZVPUWgBEYXTSMFI,eGEAGAFEdACBZBCDUGCEBHGG.EEAB..XDEHSHBEMDBDhAAARFDBHAAB.JFFACECEDAFAhABAAIBG...cCFFhAIALAHB.........hBAA......hBBA.WCHH.,2,-31,-11,20
gEVKNOZYRJDCFBUadWfPXLcQeMGbTSHAI,EHBGVDAGKECE..ZACGRBGF.DCGDBEGD.dACC....fHGHhAAALAEB.eGBCGBAEhAAASFFHAEIH.hABAIHDHNEFA.OAHDCGGCaGBA.XEDAhABA.....hAGA...,2,-30,-20,10
SPYOUbeHGMANJXdRaBVITZQLcfWECFKgD,JDACRBCFBFDG....IDGBQBGDLHBE..WABChAAAFBBGKAGG.SAEHhAAAOEHHeFCDMGFAhABANEFCdBEA..TEDGcGACEHFG.DACA.hAFA......hAGA...,1,-29,-34,5
CLEIJBHYZMUPASFXKcGNTgVRDaWdeObfQ,FFAAKGFCGEBB..gCCDDCBDdAHEeADBOABA.QGFEhAAAEBBGBHDHHAFDhAAAMAGFAFDF...SHAAhAFA.XEGAcFACNEEFRFDFaBHHWHFAhABACBEB......hACA...,1,-12,-30,18
QaEGIVgfJLcXSOHWFDZMUCBbNKeRTYdAP,aGFCGEAH..VBFGJAEELHEA.SGDCHGAEFEGFDCAGhAAAMCHDBCEG.KADAhABARBCGdFFAAFAF.QAAFhABAgDDGfDEF..XDAFhACA....hADA...,2,-33,-8,25
ANGeHJUDKPLgObCMXZTWRSaVcFfIdBEYQ,eFEFJBDG.DGGFKFEBLBHF..OCGDMDCCZFAGRBBB.aEBGFAGAhAAA.dHGBBCAA.EACChAAAAGCFGDAA..hABA............hACA......hADA...,1,-36,-42,6
JcGEATgHbFPDZOLBYQXNfSWCVIeUdMRaK,HEFHFHBGZCFBOCCDBABH.QBEA.XFAGfHGBhAAACBHG.eAECMBAGRBCDaBGAhABAJHDCECAF.AEEH.gDAHhADADIBA.LFDBNACH.SGGEhAEA....hAIA...,1,-9,-23,14
MacfLWNPeJdIQGOHUEKDgbXBRCZTYAVSF,VFEEMIAG....aBFHLCBA..NAAC.JFACQCCHhABAOAEEEHACKECH.DGGFXCEDhAAABBHGCEHGZGBCAHDD.hABASFAFFACD.fBBA.hACA......hAEA.WAHB.,1,-24,-26,2
fEHJIRMULdNgbDWGXZKQaeYPVFABCTcOS,BFFGTGGGOACG..SECFEAAEHGBERBDBLCDB.hAGAdBFDNAHE.DGFH.XCAGhAAAQEGBaGDBeFAHhABA.PCHDAIAACBFCfGHAIBBGMAFEhACA.....hAIA...,2,-32,-1,31
MYNDCZAXGVbEKHWagLFOcSfeRITJdQUBP,GACFVDAG.EEHBKEGAHDCC..aHGAFGFF.SGDFeADBTGAFhAAAdBAAUGAC.MCFAhAAADIEECDFGAAHG..WDFEhABA............hACA......hADA...,1,-11,-42,31
QOAKLeXEZYHWJIcSbGRNDCPBVadMfTUFg,LFFBXAADZADBHDBF.JADC..SFEHRFDDCGAA.BFDEhAAAdDDDTABAFGHBOBGFhACAAAGGKCHBeDBF.EAFFIHCFhAAA.........hADA......hAHA...,1,-23,-31,8
DGgOUYBSAXZHILJMbNVaPWfFdRCQEeKTc,ZABHHFDFJFACMBEA...VBBCaHEE.....fGAFhAAAFAHFCHHGEBDD.eEAE.TDGDhABADHDG..OFFAhAAABCHBXGGGLDFANEAF.....hACAWADEQDEAhADA...,2,-35,-10,25
WAEPJfbSUaLRYDgKQHZdVFGTNMeOICBcX,JCCHSHBGLBEGDGEE..KGGAHFAGdHDFGEACTBACeAEChAAA.CDFGBHGEXAAFhADAACEAEDCB..fEGFhAEA..........hAFA.aDGGYFFChABA...,1,-24,-34,10
gWXVZfaJUTFKbCEcPRLdIYGNMHQODSeAB,BFDGXCBCZAFA..aCFHJFEH..FCADCADE...EDHFRDFCLAFFhAAA.dBAFGGDBhAAAMHAAQAGEhABAOBBGDIACAHIB..gDCAfDCFTGGDhACAKGAE......hBDA...,2,-31,-16,15
XTCDUNgMPJQcARHIbLSfFGBVKeZYOadEW,RGFGHAADLFCFFEDEBFBBeDEHZFDG..aDGGEBEH....XCCHhAAADADGUAGFMBAHJHFA.hAAAAEHESAGAhABA..fCHG.KCCFOBBHhACA.WFABCHADNCAE...hACA...,1,-16,-28,12
KCDIQARFeXdgNZPHYSEJaMOWBUbVcGTfL,RDEDFGDDdAECZDBGHAAC.EAGDaCAA...ODFABDAGVGCGGADDLFBDhAAACHAA.DAIFIGGEhAAAAHID.XFEBhABAgGGF..NDAE.SDCBhABA..MIFG..hACA...,1,-9,-31,22
WUbIaZXRLJgGDBYSdNCeAQKVfFPcHMOTE,VBCFFHBGHCCC.MADEEFGE..UFAF..bCFBaAEEZAAC.LCABhABAJGEC.DGHHBAAFhACAdHEBCFEDAEAE.KAHB..fEEHhADA.OBHD...WHAAhAEA.....hACA...,2,-29,-19,10
NZUafQTJMgLFEDcIVAGOYKPRSebBHWCdX,OFEFKHBGRBFA..eBCFHCBA.CFAFdGHGZEAGUGGGQAAF.JAEChABALEFA.DCBFhAAAIDGDAGEA.PECDhADABAEG..XDDFaHAAfBEEhAHA......hAIA.MBIFEHDE,1,-7,-31,24
DgEVFKZeScaBfQNTOIMYUHJdGbCXPRALW,LFCHDACBEGHB.KEFAZFBDeBEE..SEGFBCDAQCADhAAAOAGF.MAFAHBEDGEAGhABAXGDEAACCgFEGhAEAFDBGaAAF.fDEHIFAC...hADA......hAEA...,1,-10,-27,17
aZMYFKHGOLETDBQUNbSIJCeXPVfWcdRAg,aCFCZFACFBFHGGEFLBAFDDBE.BDDGUEAD..SEHHhAAACEEE.eHFAPEDH.hABAVAAEfEGChACA..dAHEAHADMCCBKADCEHBE.....hADA......hAEA...,1,-19,-32,13
WFYGLTOJNBXKZcIegaHQSRAMUDbPCdEfV,DIBGCFDGdCABEDGF....VBFCFABELAFH.OECGNEAAKHGA.hAAAZBCE.eFFDHEFASEAGhAAAABBAUBDA.fAHChABA...WEHH...hABA......hACA...,1,-18,-39,21
gTYeXSABfbOPGZFVDCMcIREdLUJNaQHWK,BFDGOGEAZAFGDCAGCEFG...MFDGRCBHLFAHUCGE...aDEAQEAAhAAA.KDDEhABATFGHeBDASHAAhACAACIF.fAGBbGCGFCABIAAFhACA.....hADA...,1,-28,-35,7
QCRKYMgXAdceTISDLGHafOPUBFNZWVEbJ,eCCHSGFCLFGDGEACaBFH..ODABBHDCFEDDZBDHEGBDJABFRCEGhAAA..KAHHMBDHAIEAdBABhAAA..IAEFhACADDIFPGCA..WCHH......hADA......hAGA...,1,-12,-31,19
WOKUaYGNHLQgSZcdDFPbJMeEVRBfAICXT,XGGGTDAC.KAHHaCFB..GFBFLAFESBAAdGFEFBCFJHBEhAAAMEBG..EEGEVCFChAAABHHHAFAHCFHH.OHAChABA...NDABQAEFcECBDBAB..hACA......hADA...,1,-12,-23,11
DKICERLPbcgBWJYGSZNfQMXOeUAaHdVTF,aEHBdDAFFACG.DEFGKGBB.CCCH.LFAH..PACG..hAAAbBEABABG.JBFBSGFBhAAAZECA.fEDChABAXGGG........hAFA......hAGA...,1,-45,-46,1
QaWCTJeBIgFALcKdDUPXSGNMYERVObHZf,KDCDUCBF..XGADGEDCMHFGRGFE.OBFFHAGBQFDFhAAA.aACHTADAhAAABADGFAFBAHAEdFABDBBHSCHDhABAYEEC.EFFE......hACA......hADA...,1,-11,-28,17
gPbBHEJDcdSRXTVAGIMQZOLeNfYFUKaCW,MEAEZADGeHDC....NFAB.FFECKBGACFAA........hAAAgBAFBGDAHACEhABADIGAdFGDSCCGhAAAXCCEAIDAICHAOGAA.LECBYHFAhACAaCFB.....hAEA...,2,-34,-27,7
VDBJFcObGQHegYUCNMXfZaAWTLRdPSEIK,TDACLDCH.RFFEdACGEFHF.KHFADFAF.FEFHOBECGAAF.QCGGhAAAeHBG.UDCEhABACAACXFDHaGBC.ABDG.hAEA.....SAGABGDB.bCFAhAFA......hAGA...,1,-13,-28,15
MALNGXVZJRWbQEcSTeaCBKYIFfPgUHdDO,GECFVABH.JCADRDAB...QAGDSGECeFAHCBHC.BCDGhAAAKECEFHGG..fHCDhABAUDGBDHAAMAABhABANHEFZACAECGF..aAFF.......hADA......hAEA...,1,-17,-28,11
DLPHNUZVABdEeTcOgMGCaRbQYKSIFfXWJ,BEFAdEEDEDCDeHDA.OBFCMAADGAEC.RFGB.bABDKBHHFGAG.hABA.XGBCJADHLBAFhAAA.HFDAUBBBhACAAIHE.cGDF.CEAB.......hADA......hAEA...,2,-20,-15,5
AIOKSMFQeVCfXHcLURYJZEPdWDaTNgGbB,KDCDFHBGQEEBCEGE.HDBBLAFDUABARAEHJAAFZAGBdFGHDGIB.hABA.aHAE....hACA.TBGE..hADA.NIDF..GDDEAHGBSEHFMEAFfADAhAHA...hAAA...,1,-19,-30,11
GCRNDefbPcMAJSYBLOaKTgFIZUHWQdEVX,SDCDBAFBLBEDOFEEaFFC..KAACFCHBZFDHUAAF.QDEChABAdDGGEEAG.XBEAhADACHBFDCDH..eAHDhADAfFAD.bGAEMBCFAHFB..YAEEhAIA....hBDA...,1,-25,-28,3
WTMCKVSDgRcYNPIAFJebBXLdHZQGaOUEf,JFFBeAFBBAGCdEAAHEFF.ZCCHaCDHUBAE..EFDB..fCHGhAAAMBCBKAADDBEF.hABA.RGAANICFAFEA..FBHD.hACALEADOFHD.CGCD.SCEF.hABA.cCFH..hACA...,2,-45,-2,43
XWReGUQETMLVYfdSbJZIgDacPAFKNBHCO,FAFBBFEDOCFFRBFAUCAB..EFEGLFBH..fCAAhAAASHEAJEBFZDDADFIFaFAHhAAAAICE....HACBhABACHHFeDHB.GABFMDHDdEDC.IBHEhACA.....hABA...,1,-16,-21,5
ZFAdOWJNacMBUCRSXLeQHTgVfGYIbDPKE,OCCHJGEA..aCFHMAAC.UAGBCFAF.RFDE.LHAA.HACHhAAAgDFBGBGEbECChABAKHGEFHCC.AHAHdBDChAEANAEFBCAA..SEHH...hACA......hBAA...,2,-24,-22,2
daOBSIJMHFeNUcEgXYLWATVfCQPGDKbZR,VEFHQGGG.DFEGKAHDRAFG.OADGBFCF...SDHBhAAAJCAFHGDCFDGEUBAEEHAEXGBChABALBBGAGCGCECA.hAAA.PDDA..bFDD.aCEHMABE.hACA......hAIA...,2,-26,-8,18
CALVFMZdOIGJESQTYHUKDaRgfbeXNcPWB,LDCHFHDCMDFGZDBHOBCA.GGEFEGFB.SGABQACGhAAATCFDHDDFDIAAaAEARBAFhAAAfFAE.hABAXAEFNCIC.cGGABHCECFECABABdAHE.hACA......hADA...,2,-12,0,12
YMecLdSOWHEJKaDfVTQPNRgGXFUbZACBI,BBBDMCCALDEGdDFFOABGEGBC..KFFCDBCE...TFFEhAAAQDCHRCAG.GADFhAAAFAFAbEAGAHAACGHA.eGAEhAGASHFA.JHCEfGEC.hABA......hACA...,2,-31,-14,17
WOPCUZfSNbHYLJRcdMFAXGIDeBKTQgaVE,XFGHGDCCDGEDKBGCQBGA..gDGEEFFC.hAAAOFCBCAGFfDBAhABANDAEHBCGLFEFhAAARBCEMIFGAHHABABAaDBG.WEAD......hADA......hAEA...,1,-14,-21,7
VcEPbFBDWHYefNSJORIAgLZCTUXMGQKda,LFBBCADCUCAA.XGEDGCDG..dBFCVDFC..EFAEFBEBBCHBhAAADAABHBBHeEHDSHAAhABAOFABAHHA.TGEGhACAMDDHaFDD........hABA......hACA...,1,-19,-23,4
YIfdUgPTObCBWGZXDNFSHKQMAacLVJReE,LCCHVDBG.JHFGEFHB....IDHEUAGHTAAC.hAAA.CHAGGBEHDADGNIDBHFDAhAAAKDBDQEEBhABA.ADAHaACCcFBH......hACA......hAHA...,2,-27,-25,2
aFOSgQcPbJMWeDRTGYZEAKfVHCdLXIBNU,KCFCVGFGdFFA.LEDFBEACUBAAFHBC...OHBEQBCGhAAA....bDEGMFIBhABA.eAHBDBGAGFAHhAAAEAEEACAD..HDAH.CBBD.XACFhABAaHFE......hAFA...,1,-7,-34,27
TcbWgOKRMLQAeDZfBVJEHXICaYUPFSdNG,DAADBFDDEECGHAFA.CDHDUAAFFDAGdGFB.GBBH..bFADOGBGhABAMEBE.AGAB.ZADFJBHFaGGDhABA....SEEEhACANHCH...WHEGKEFA...LAFEhADA...hAFA...,1,-22,-25,3
CUaVONgPBJXLYTeEcGKFWADdZRIfbSQMH,dEAEZGFGRCCC..IFFBSHAEHFCDUCGHOADF...NBHGBCADhAAAXEAD.LFEGhAAAeBBBEHGEcABChACAKAFBAGIFDEEE.fHAFMAEACDAC...hADA......hAIA...,1,-14,-27,13
bWfKZLcVAUMIXTDREGdBeNOSHJagYQFPC,MFFFXCGCRDAC.dABHBAAC..OCDHSAGGJHAG.aFCAQGFEhAAA.CFBB.hACAfDGCZAFGLAEDhAGAcACBAEHA.IGHHDFED....hACA......hAFA.eHAE.,2,-31,-16,15
NXbaESeDHUGTCAZQPJRYIOBWLKVfcFgdM,QFDHJFBB.RAAB.IDAEOCEFBGGDKFFF...fBHEhAAAFCCHMFDF.XAEAhACAaAFB..EAGFDECChADAHAAAGEAGAEFC.YEHHLEHF..hAAA......hACA...,1,-11,-34,23
WZJOFQTfIcGSeDagBbXMLdKCUVAPNEHRY,EHBGHGFGRAFB.ZDDH.OCFFQBCC..TAAFIDEASEBBhAAADGIFBCAGbGBCLHEEhAAAKAEG.VEAChABAAAHGNCAE.....WDGH.....hACA......hADA...,1,-19,-21,2
CNfUPceYAaZMIVESHQOFgWDXTJBLGdbRK,ZGCCMECGEACGHFAA.FCFADCBH..JGFGLDDGdBCE.REGFCBFBUAAEhADA..eFABAAFA.IAAAhAEASFDHOFDAhAFA..WAEGBAHC......hAGA......hBCA...,1,-29,-31,2
gKMZELcJSDCIOFfWHBQUTVaReYdXNbGAP,KHBGEAABLAEG..JAGHCHEAFFCCHEEFBEEAUADH.aHGAeFGHhABAdDDG...XGAChACAGAAEAGDDMBIB.ZCEChADADEIFfDCB......hAFA......hAGA...,2,-35,-21,14
PVKHNBgaDYRMOILSQZbXJAcGdfWFeUCET,dGAHFHBGCACEECAC.....VCDBHDDCBDBAaHFGDBCDRDGH..MGDGhAAAOBFALBFAZBAF.hAAAJABEACFE....cDGEhABAfGHA..WFAC...hABA......hAFA...,1,-27,-34,7
MaFNXOHBCUWLEZAgIcTJPfQKRbGYDSVde,..IFDGTDACJDDA..QBAAREGFGBAD.SFBFhAAAdGDFeAFGFHAAOBEBCAAH.hAAAWEHDEADE.AIAEPHDAhABA.KDADDIDAaCGENFCFXCGABHCD..hACA......hAHA...,2,-17,-10,7
ZVOdPcYKCWFebJXDTGEfQLaIASMHgNRBU,MFCFHAADRDCCUBABOAHB.dADD..PAEBKHFAFFFE..eGDGhAAAXGCBGBFC.fDAChABAQGACIBHEhACAAEHASBFHBHAAZFGB.cEEChADACEAA......hAFA...,2,-16,-14,2
TNLbSXQYCcURBPWOFgAaZeIEKfGMJHDdV,aDBDZFDFeFGF.EDEDGGAF.MGFEJDAEHBFAdADF..VDEAhAAATGABLCAC.hAAASBGAQACHhABACEDD.cFBABABCPHFEWFHH....hAGA......hAHA...,2,-18,-7,11
EROWNbcFJdeHIfKDUQTAPaMgXVZBLYSCG,aGFHXFDBBHCFLCFF..CHCEEEAFOAAF..NDDHFGHFhAAAdBGEHEAG.KGGCDIAChABATCCEAEIDMCCEZACE.hACASGAFGAEFbDBD.eEEEIEHAhAAAfHEF...hACA...,2,-19,-13,6
cVeWGUOZfBNKMLSJICTARYQDEXbHPdgFa,QFDHXCBFHGBEdEBFFAHH..aGDAeCFGGADDOCBGfDDGhAAABADAMAAFJDABCAHEhABAAIAGDDDE..bFFB.hABA.cGGEVCFE.UFAFNEIE.KEEC.IEHGhACA....hADA...,2,-18,9,27
HLcIBFCJATgYPEfOSeVWMXGDbNQZURadK,TCBC..gFCAEAAD.SGAHVBEGMBIFDDBCQEEBhABAZFFGRDFE.aGAAhACAHAGBLHDAIECGhAAACHAG.YABGPFHBfEABhADAOBABeBEH.....hAEA...,2,-9,-5,4
LRVBAXWKGEbOgPceaFDHNZfITCYMSJdQU,KGFCEGAH.OHEC..PECAeDCHDBCEHAFCZEEE..TABBhAAACBAF.SGDAhABAQBGDREGFBADEXCADhAAAbCDAaFCC..FHAENICF.IAFD..hABA......hACA...,2,-31,3,34
gbeWHdUBOXQMVcAYDfCRSITGaLZEPFNKJ,DACBRDBH..TBEHLCFBZEEG.FDABKHCAJFBD..eCHBdAHCBBAEhAAAXBAF..MIDChABAAIHECAHAGGEF.ECCEhAAA.....NCAA.......hABA......hACA...,2,-55,-13,42
LTSWFIYOQMfcDNHeadGZbCgABJERVPXKU,EDABRGFG..XBEDLGFC.TFBHSDCDFAFA.OABEhAAAfDCEDAIFHFAHdABCZBDHhAAACEHBAABEBGCHJEFEPHCChADAWAHD....IEEC...hAEA......hAIA...,1,-12,-21,9
WXUZfLCaBgAFYRHSPDEdMJbOTGeVcQIKN,FCFCRGFGHDDHDCBG.dBGH.MHBGJEFB....OHBCTBBH.VDABhAAAQDDC.KAHHhAAAWFFEZDAH..LABEhAFA.BEHFADGHSADCEAFA..hABA......hACA...,2,-30,-23,7
ILdQEbMJUVKafWcXNRYeACZgTOGPHFBSD,ZDBHTDACOFEE.GBGEFFFGBACG.SHBGIAEBLAAEhAGAdCFGECDD.MIAChAHAJFBGKADEaEEG..fBBBhAIAXAADNAIC.eAGBADECCGBD.....hBGA......hBIA...,2,-20,-18,2
BDWZcASXJRYeQUITCdOEMKFVafNbGHgLP,SGDDJADG.RDFF.eCBCUFAHCHBEdGDG..EDCDMCFHKCACFBEHhAAA..aDDH..fHGDhABAGBGCHGFGhAAALEEDDBAH.WADCAIFG......hACA......hAHA...,2,-29,-27,2
TKgSRLafUWNYQFXEIABdZGPVHCMDcJbOe,dGFHZEBHGBDCHBFGCEFFDGBEJFGD....eAFDKCAFRAAELABH.hAAAaAHBfEBHhACA..NBICFFEDICDGhADAAAAFBDGAMIFAOEAHSFAD.YFDBhAEA...hADA...,2,-21,-20,1
WVeCSgMLFDOEJAcZbPXQKHTRUIdYBNfGa,ZAADXCBCHDCCRGEGdDEDBEADGEGA...aAEFVAGH.SFBHhAAALAACDAHB.hADAEBBGAFDD.PHDGKCCEUEGEhAEANGBH....WECGCGACMIAEOCHF.hAFA......hAGA...,2,-16,-5,11
fDNOUGgTeLVKRJFHZWcMEABCdYISQXPab,CBEAdHBH.SAEHQEFD..aEGEDDDCUGGGTGBGLEFDhAAAKACGRBGD.JEBCHCAH..hAAAZAGBMEEDBBBBXGGAhABAfADAOEAHeDAD.....hACA......hAEA...,2,-16,-15,1
FTRVbANJOXdeHBICcZGDSKaUWEfMPgQYL,JEEGXAADHADABFDG..IHDHZGCEDDIF.KEAAUABA..hAAAEFCFMDDAQBGGhAAAFGAH.VFFGAHGBOCFAhAFACADESCDH.aGAH.WEFCgGGBhAGA....hAHA...,2,-28,-14,14
YSLVACKZDONaWGFPJeHdRQbEgcMTXIfUB,KGFHDAGDODCH..aECEFCHFJCBDHFEA.QADDEAAF.hAAAMIFEIAEGBFABLDDEhAAAACGAZFGFGGAFhACAeHAAdAGBRBAF..........hADA......hBCA...,2,-32,-9,23
aeFXQPEUTHRIfbGdVScgJBDMCNOYLAZWK,ZDAGKAFBFADGQFDH.UBCHTGEA.HEEGICHBGECGhAAASGAGJCHHBAHGCABHhABAOBFGAGIF.WAADhABAXCCA..EEEE......hACA......hADA...,2,-30,-22,8
LGEHJCadIKfTQPNZOYgBVXASMbFURWcDe,SGFHMHFGFEFH.UAAFRFCF..DAHHeEFEGABFHECC.CCDBdAEBhABAKDDCQEAChAAAZBFA..OHBABCGDAIBAhABAcDAE.........hACA.EEHF....hAEA...,1,-15,-31,16
SOIRMFAECBbdJWPaTYUVfGXcHgLeDKQNZ,CCEAdEGD.JEDDaAHF..UGAHGDCC.HAACeCCEDDIF.KEECQAAFhABAZAFF.ODBHhADAMGFE...EFFD.hAAABAEAPEAF.YHFE.fBDFhABA...hAEA...,1,-16,-38,22
URFbKdQYeaDLOfWBJPAGEgNTIcXMCVHSZ,EGAHTCBC..XBECCFAGHADAZFEC.FDEGbGDC..QCGChAAAaCBFDEFDLAFChAAAOFCHBBBFADAC..gGGBhABAIAHDMFIB.....hACA.SCHHhADA.REAE..,2,-20,-11,9
WaLMOUPJSfdIbVKcBCTQFDNYeXZAgGRHE,GEDHHDDFaHACMCCGOBHDUDAH..SDBFdBHA.IFGGhAAAKAAGCDECTGBD.hABADGGENADBeFCDAHEA.ECEEhACA.LHEAPACA.fBBB.hAAA......hAGA...,2,-31,1,32
RdFMfceSaUBbKPTQENYGVWAOCgHXJIZDL,OAFBHDBHXGAHZGDELCDHFFGA.MCCDeCAF.aABCBCHBKEDBQGEAhAAAEFEAGEAEAEAHhAAACHHAJBFADIFC..dABBSDGChACA........hADA......hAEA...,2,-22,-10,12
aSDYVbJKXWBAULgeZRHfNQEdIMPcGCOFT,UDACLEEGeEEEZAEARABC.HCAD.QGCDEGCFdAEA.MAIBGAGEhAAACACBFCFCSFFDhABADIGE...bFDHKFAFhAAABGABfDCF.IGHGcGGE.hACAaGEA.....hAGA...,2,-15,-5,10
OQgFKXCABHIVMSUJeLTcYGRfdENPDWbaZ,HDBHVFAC.SFFC.UADDLBCGTAACGEDH.hAAAfGDANAICDHGAaHCAZBFBhACAQCAC.hAEAKAFCCFDD.AHIHMDDAcGAHYAAE.EAHHhAEA.WHEA...hAGA...,2,-13,-6,7
FdZSLbeNOUKPDIcBWJGCXHMfEAQYVRagT,VEFHRDAG..TCDGFEBFZAEDLHFA.eDFHUBABKAFFDEIDBADAhAAA.GGABCHHDMAAChAEAfABH.hAHAABADQAGCgBGASDDDhAIAOEGD.IBDH.hABAcGBE.,2,-32,3,35
UKTWVXcIJCdOMYQbRHNZfPSLeFGDEABga,aEGDUFCA.KCAC..VDEH..XCDHJAAC.dBHGMGAAQEAAhAAAHAFB..fDAEhADAPFFB.SHBAhAEAeAEADBAAAEGHBCDH.WEHHIHHChABAOAHF....hAFA...,2,-28,-23,5
GVANDUEYeWIOTBSfdRHKJXPbLZMgcQaFC,DAFBEGFC.eHFAOAAFBCCHdDCEHEDE.KAAFJADA....PDAHhABALCEF.gCGDhAAAQCFD.CHBEABCFhACANIAH....YGAAIAHG.SEBHhADA.fEHAhAEA,1,-25,-43,18
GYWHZcIMebFgUSKOfEaQBCLDVRJdNPXAT,TFGHGAFEHABG.ICABMCABFEFGSEFAODBBaFDDQGGGhAAABAHA.DEAFhABARCCGdHABNDDEAAHC.ZABE.eCFGhAAAbFDH....KFBF.fCEEhACACAGC......hAEA...,2,-11,-6,5
PdTWbJgXcFKNSUZMBeYfHRCEIaDAGLQOV,GDDCLFCAOACFdBCC..TAECJHBA..XGFEFHGANBBE.hAAASCADUDEHBCHDhABAeAFD.HCGBCAGBIHEAhACAAIFEQEBA.WABF.cAGFhAAAMDAF.....hADA...,1,-1,-29,28
NJFWVOYBQdKDCAHcbLXgZTRfUEGSPeaIM,HAADLGEAXEAEZAFERABA.EDDCGDCF.SAAFaHBGMFGBFCCGhAAAOFAEQBGGhACADDHHAFIF.bEGF.fADHhADAeHACJCAB.YFEFBCDC.CGAC...hAGA......hAHA...,1,3,-13,16
KZWDEeGgNcUAFXPdYSfJIbLOBMCaHQTRV,XGBCdHBHSAEH..IBAHLCAHBEBEaCGHQGGFhAAAVFFCZDFA.EEDBeBFChAAA.GDDEgCDGhABANICFABDHFAEGfAHE.OBBGhACAMDAFCCCD.....hADA...,1,-3,-16,13
FdUATXRNVKGfJDZPbQIcMWLOgEaCeSHBY,XCCBRGFGKFDGGAAFDCFH.ZCEC..QAGAMADE.ODHDhAAAaDCH.SGCChABABGCDdBGFAAAENBBF....fCAChACA.bGFCIHACWCFHEEAFeEEGhAHA.....hADA...,1,-23,-25,2
DfUZbeRaCBSAJYFMGKNOEIQTLPcgHdXVW,FDCDMEIBKGDG..EHGEQADALBGH....PBBCHEFAdBAGhAAAXDAGDAHFUGBAhABAeDEBaGHFCGCEAIBG...hACAYAAEOBHD.IGAA...hADA......hAGA...,2,-23,-16,7
IUYLWGKMVSAeXBbfZHdFcOaEgQRDJPNTC,XGDEBFDGZAFAHBBFdCHG.FEFFOAFE.EECHRGDADIAG..JDDChAAATCGFCABB..IDABhADALABCKHGEMAAFhAGA.AEEB.fFAA.cBCBhAEA......hAFA...,2,-32,-26,6
AgeObMcDaVNfUPXBYWKHFIEJdZSRLCQGT,eEEGMDEBDDHF..NDDE.UACGBAHE.KEBBFGFE...JFAFdGHGZFBFhAAASAAB.hABACGEBGACFADFH.OBHBhACAcCBH.aDFDfDAF.XGAHhADA...hAFA.WAEA.,1,-22,-42,20
HKLGAFXMbWTPYaDNJcBUROVZECIQdfSeg,XAEDMCCA..TDEHaDFH..DHBCJAFABBAARGFA.ZABFCDHBdABHhAAAeAHBHFBGGCGG.hACAAHHEFEAE..WEAFhAEANGAB.....OHCEIADGSFGChAIA....hBAA...,1,-21,-22,1
TJGaKEZMAOdfUFCQLgDIBYeXHcSVRNbWP,dDCDFGFCLABDDEIFBFEE.eFCFHBFF..SEABRDAB..hAAANCAH.bCEA..TFCGhAAAaEECKAFD..EHEGAAIFfADAhADACADH..IHAG.hAGAcGGFPEHD..hAHA...,2,-32,-24,8
RZbeKUgXEHCfaPcDTYNJdWAQLIFOSVGBM,QDACFDCDOEEGGBEDBAHBZEGH.eFCHUFGF..EACGCHDC.aEDFhAAADACG...TBAFhAAAYCDE.NIDF.dFAChABAAFGH.SHFA......hAFA......hAGA...,1,-21,-31,10
WEFHTIGeXRVMNYLSKZJACDBbQaUgPdfcO,BAAHaGFC.UEAGdDDFOAECFFEG..HCBGGGAHeFHHREFGMBCHhAAALAFAZCAF.AICGCHFCDIGG.hAAA...QCFAhACAfDGD..cADC...EHAAhAEA......hAGA...,2,-23,-22,1
XNGPaEOHgCDBZVAeLMFWcJKSbITYUfRQd,MBEAFHBG..JBAESADF..bFDFTCGG.UAAFhABAQAFAdCFGGEDAhAFAEFGAHBDFCAHBBGGAAAEGeDAEhAAAcGAEKGHH.IDGF....hABA......hACA...,1,-17,-25,8
bfNLZSECOgcPKHQBVAURITJaXWMdDYeGF,REFHTDAC..aEABMCCGDCAGGABF.FEDCfDDFhAAA.ZFFESEHHhAAACDFAgDGHKGCFBAHHhABAAGBCJHAEdAHAeBGBLABEECEG.....hACA......hAEA...,2,-28,-9,19
DfeRAICTFcLNMPYWVZEgXJGbaKdHSUOQB,TGGGLCCH.MGEE..PDAC..WCGFEHCCgAFHhAAAJHFA.GEEDhABAbAFCdGAEHABE.OFADhADADBCCfCABADFACCHE.....hAEA......hAFA...,1,-6,-33,27
aHYFVXdbOgZBRWfIMPAcDEGJKSQUCNLTe,DGHHEHAEKFEAUCFE.LADAeDBDHAEH.FDDHdCBE.OFAEBACARBGDhAAA...IHHEhABAAAHHJFDA.CFHA..NCAC..hAAA.aDHD...YHDEbGDC..WBBGhACAfDDF.hAEA...,2,-40,-17,23
ZCHOVFTKaUfcEgRWYLIeASJQBXMNGdbDP,SGDDQGDEBEFBMAID.dCCF.DBHFZDDEHDBGFGGHKAACUGADEBFEhADA...RCBFLAEChBAAABBANADF...PEHDhBCACCFDOHFA........hAAA......hABA...,1,-15,-32,17
BcNCIZLOAFaXSfJKUVTYdgWPHeDGQMEbR,aFAASGFC.KHFAVDEH.dABG..gAFBHGDEGAGEhAAAMEBHEAEBRBDBBHDAhAAACDDCIDBDOCCBAIAGXGGFhADAUDGG..TFCH.PABAhAHADDIFcGBC...hAIA...,1,-4,-21,17
ZYXRFgcGKTQPedbEHafUMCILSVDWANBJO,BAFBZFBGRAACFDAEGCFC.KBDFQBFEdBAEHFGFUEBF..CHAGSGFEhAAADHAGAFIH.hAAAJHECOEEB..hABAXCCB.cDFH....hABA......hADA...,1,-33,-34,1
BMSXaOEWTCPNGfAKFQdZgDRYcJUbHeLVI,FFAAZBCFRDFH..JEEHHBEELBBCBFEDMIBA..aBHHOCABhAAAEEHH.CFHE.GCAF.hABAAEAEQGCDhAAADHGA.UGGFbEBDIAGEWACE..TDFChABA.....hACA...,1,-10,-32,22
aUMZPbTIBFSHgeKVOALCYDJQGXdfcNERW,LAFBCAEDDDDH.GCABdDGB...fABDEGAG.RFCEaHGAhAAAMIAC.ZBAH.TEEChAAABHAHSDHHhADA..eHFA.OBFEAIGGYEEEhAEAXACDWHCG...hABA...,1,-15,-41,26
NKOdeSEBARIcMFUQPgZLfGWJTCHYbVaXD,RAADMCCAQFDEZGDEGEAD..TCFBCEGHHAGF..VDBBDEDCKABGhAAAOADDeADGBHHAhAAAAFFFFGAHPFAH.fGFBhACA.YDHB...hABA......hAFA...,1,-3,-24,21
EgURQJbINTBecVFMHKaXCADLdOfZSWGYP,dEGCOFBBZDCEGBED.EEAFUADD.RCAGJFFG..NHBHBAAFhACAeAHDFEDAMBCC.aDAGAHHGDGDDhAAA....fCCBhADA.WHFAPHEE...hAEA......hAFA...,1,-26,-39,13
IQSEAXCYWBTURLbJfgFaVGOdDcNKHeMPZ,CHHGBFDGRFDD.JEBHFEAH..GDCBDEDE.KHEGHAAC..MACCZCGFSCDChAAAABDG.hAAA.XBAFTFFFLHAAhABAfFFE.VAGBcDAA..hADAPEHB.ICCChABA.,1,-18,-42,24
GFUEYfISTAWegbVDRNPcMJdXKOZQCHBaL,eGEAVAAD.RCDA......NDBG.MFHHdAFHKAACQGAH.hADACGEDaEFGLECBGAEHhAAAFEFGEEAE..fCGDhAEASCDCACBC.WHDADGID.....hAGA......hAIA...,2,-31,-16,15
SMXRdNKcegFBbVEHOGAPQfCaWDLYUZIJT,QCBCaEGDLBADZAFE..JAFCSEEERDDF.dHCBKHDEgGGEhAAABGHAEEBCOCBAhAAAAADECGAGDEDD..IBDEhABAMCGF...XCFA...hABA......hACA...,1,-17,-34,17
BSFWNZTRAaCJfGcLbXDQKUEgYIMHOePVd,JCAFGAFELDEHDIACQDBC.EABGgDCG.hAAAMIFAeFFA.PHEChADABGADSBGBhAAAFFDDWEADZBBAAHFCfGCA....hABA.cBBF.KEHFhACA...,2,-40,-9,31
eCAfMaDcdSOKbTHRBFZLJGPUXgNQEVIWY,MHFGaHFG.DFADdGBA.KEBCHCDEBDGBFFCFLAECGABDUEFE.hAAA.XDDBQBGEhAAAEBAC.VCAF..hABAYFFGCGBDAIAG.SCCC.OBHFhABA....hACA...,1,-8,-35,27
NTJbfIeEZcKaDVdMQLUFHRPXgYSOBGWAC,TGGGJGEA....IBHCECABKEBGDDDGdDCELAACFHAC.hAAAHGAEREEEXBGFhABA.SGEDhACAGCEFCEHAbBBGfAEEeAFCaHECMDIB.PBBChADA.....hAEA...,1,-8,-17,9
UdHDaAPLZceQWbVIJMNfGgTKXRSOYFCEB,LFBBZFDFQCBBVCBE.MAEEGGEFKHGA.RADC...ODHFhAAACABGEAGGBDGDdHBHaCGBAAAF..hABA....cFDBhACAeBEBIGFH.NCAATFBESFGEhADA.....hACA...,2,-17,-15,2
NULTaGeDVSbHAOZFWIKYPEcXQJdgMRfCB,ODCHZDAGFBGFKEGC..EBEE.QGFGdDFCMADA.CBAABGBDLBBChAAAGDEBDFBG.SFAFhAAAAIFA.WFHHhABAIGGC..YFDB.cBDChACAJHAG.....hABA...,1,-16,-43,27
ZMTaGYCRHdgIePSKQBbFNEDWXVLAJOcfU,JEEGOGEA.UEBEMAADGBBD.RAGB.dCEF.eHCCKCAFBEHGhAAAFGGAEAEEDDFB..XCBBhABAAHHD..fGAEhABAaDBHCAHD..gGAF.ICHAhACA...hACA...,1,-24,-41,17
SZWgXQbdPMBKEJHfIRYGeAcDTVLCaOFNU,DAFBVADGCEFG...FGEGUABGZDAF.....XGCFdEEDBHAEKCHBhAAAEGHH.HAGBRCDFGGEFhAEAADIB.LEBDhAGAOABFNEDCSAHF......hBAA......hBBA...,2,-30,-24,6
fcFIeUbRVXAJgYLHdPKDCZSOWNGBTaQME,JGEALGEAHCAFKDEEDCAFCBCE..ZACA..OCHBGCGCBFBGTGADhAAAMCCF..EECFFDEFhAAAUAGBRAFF..ABIHdHAFhABASEEG.NIDF....fCCFhABA....hADA...,1,-12,-38,26
OASbXJEBZGLgVCDFWIUMRHdPNKTQYecfa,XGBCBDGFZGAALDED..CHFGFABHUDAAMFCGHGFAdBFGKBGGhAAAQDGH.hABAeBDHaACDSAEEhACAEGHFgDAFDDDFIEHGNACB..cAGEhAAAABBH....hAHA...,2,-23,-23,0
TPcdNVOKQGJLWRZFMDAHaUSXeBYCfIEgb,UCCBSGDDeDHHBDFDCGAA..EACG..TAGGdCBCOFHDhAAAQGAHGAECJAACRDFFMEEHhABAACGF.aEACfFCDhADA.IHDFgAGE..hAEAbGFA.....hAIA...,2,-23,-16,7
EPMLZSgNDfCaQJTOUBAVKGcIYeFbRHWXd,KBBDGAFE..IHACFDHFHFDA.XACBEAECLCDEZCBCSHGGhAAADGFC.CBHEaBAGhABAJFDHTDBH.hAFABHHEAFHBYEBHeEEAWCHHMIAE..NCAAOABGhAAA...hAHA...,2,-20,-10,10
EdZCDbHRAgLaVNIKBSGYJXfQcMUOWeTPF,aDCDVAAD..KAADBEHDGGCB..JEBBXEFC.QCGEhABAMDFDODDBTDAEhACAEHCA.ZBCGDDAF.HAGFhAAAABGF...gGFFIAHFfFAEhADA...hACA...,1,-12,-37,25
NVILHMWTDPYCAgFacSdEQeGZfBXRbOUJK,FAFBaAFB.dGEE..eFDBZEFFBDHARDDC.UDBAKEAH..VGFGLAAEhAEAHAAFMAHBDIGE..hAAA.CADF.AGDB....hACA..SBCA.EAHF.fHABhAHAODHDNECC...hAIA...,2,-38,-20,18
HZfbSAcOJKgFTPQUaYEVBdINDeMWCGXLR,OEEGKDCD..FFABTGGHUGDA..EDFCVBAB..BFHCIHAFhAAADGCD..eAAFhAAACAEDXEGEHBDC.ZFCDhABA.SAGEABCF.gBFChACAaGGCdAEBNAIE......hADA...,1,-23,-28,5
RCAVdWMZEBUIOGSfYaJcPFQXLDegHKbNT,VDAGdGFHZAEH.BCBHOADDGDDC..SEEHaCAH.JBGHhAAAFGBH.QABDhAAALFHFDIDGeDGHKFCBNEIG.hABACACDAHBE.MAIHUAGE..IBAC.hADA......hBAA...,2,-26,-13,13
CYXZbWGfVMKUORNIcdEQeFSgADHPTaJLB,HFDGaGFCBEAEXAAHZADA.GBFG.VDBCMEEC.OHAGhAAAIBDHEBAD..FCCCAHHEDIFGhAAAJFFA.LHBChACA.CAFC.WFAAfAHE....hADA......hAEA...,1,-8,-35,27
eBgWJaINSTEdYULMCfbOVAFcPQGXHZRKD,FHBGQCBCHCEGKBDGDEDDBFFB..JHDGaHFA..SHBChAAAdAHCUDAH.MAIB.CBDHOAFFhABAABCG.PEGFhACAXAAB.ZFAEgEEFIEHCNEEEEEABhADA......hAEA...,1,-24,-27,3
FZSebHdfUPROMCIXDgAWaKQEcGBLJYVTN,aAFBQFCEGGCFBAACLDDE.VFEEFDFDZDGB.eBCDbBCCHEADhAAAdDAC..fEDAhACAPAHFOHAEhABAIBHFDBDCAIEA.........hADA......hAEA...,2,-27,2,29
WRgSDIBXQaPYeKfNGEOVZUbMJHTFCdcLA,RAADSHFGBFDD.QCBBaDAE.eGBAKGFBGAGC.hAAAEFGGZDEAUFAEMFBGHACDhAAAFABFdAFDAIBA.DICAIDEChACAXFGC.fCGF.NDAA.hADA......hAEA...,2,-21,-16,5
ADBRMXVLNEQZfHOISUWeTKYGcCFgPdabJ,DFCFBECDMBAALAAC.EAGBZADBHDDGOAHHUGCA..eHEEhAAAKHFAGBCFCFGD.PFAFhAEAaDEDADGD..XCADhABA...NEIC.IFHHSGBDhACA......hADA...,2,-36,-15,21
RHYOPcfGEKTbQgXJDaeCWIZMVdFBUANSL,LCCHRGFGHCDAOABA..fAGFKAEAQEGBXCGChAAAaFCD.CCEDZEAFdBHEBFEChAAAUBAGAHHHSBBFhAGA..cFEC.EEEE.....hAHA......hAIA...,2,-19,-19,0
PNVQXdJABgGTIcSCebYMLKRZaUFfEODHW,BECDTAGHSAGE..CABHeGECMGBEKBFDaBDG..UDEDhAAAEBBCDEEEHEAD.NIEB.VFFChAAAdDHAAADE..IHDChABA..cGCBYEAD...hABA......hAFA...,2,-34,-22,12
UDYdPTZNaeKFEWbHIJMRCLVGQOBAXfgSc,XCBCSHBGDBBGdBAF.ZDAE..eFCAFFDDEDFBHGFE.MCCAhAAALAGHVBGHOEAHhABABBDCfHGFhAAA...gFGCYADCPHAChACANAIAKFBB.WEDC...hABA...,1,-6,-21,15
ZDSeETWVGCQUfXFKMBbPgAYOaJRNHILdc,aDCDJFBBHDEHLEHDdGGHZADDDFFD...eBFATGBEGAAE.CAGC.hAAAUBAC.FAFGBGDHhACAPCEGADAB....hAAA.OEABNICBSDGHWEEF..fACBhABA.MAIBhAEA...,2,-29,-15,14
XIUQLeYPgRAMEZOGdCacBVKbHfDNSWTJF,EFEFZFBHdDCB.CEFA.BHHG.VCDCKGDCHABADBEG....SDHDhAAATBEGFBHHIFADhABALHFE.eFABhAAAPDAEAIGA..MBAHaACDfGCChACA.JAHF....hAEA...,2,-36,-19,17
HADYKLQePOdJRNWISfbFaMcVZEXgUBCTG,DGHHLCCHeABBdCEHREEF....NBAA.IBHE..fHAFhAAAaGBD.VBFEhABAXFFBBGHCCHEDHEBChAAAABCCKDHBQAEB.ODABSEBFhACAMIDE.....hACA...,2,-26,-25,1
CNBGTfKDIdLQPZSXgFMAEWbcHaOJYRUVe,EHBG..bAADHFDFOEECJCDERCBB..VAFHCAFABGFB..TDCChAAADADGdAACLEHHhACAZAGB.gFAAhADAMFFCAEEC.WGECaEBH.eACA.NIBD.KHGA...hAHA......hAIA...,2,-19,-6,13
SGRFJIgYfPBVOWKaEeTHDcbCdAUNZLMQX,ZEFHMAFHQDCHGGEFRCCD.FGCH..IHCE..YAABhAAABCBCOAHHKCDCaBFFhACAEDAD.eEBHDFABCHEGAGEGNAGGhAAALFHH.JBHBPABA.WFEEhAIA......hBAA...,2,-18,-18,0
WXATVGBRfdCOIbEeMaHPcKFQSULYJNDZg,VACFGCCF.RAACdHAHCHCB...OHDAECAGeCFAMFBEHGFE.KEAFhAAASEGCLEFENDEEhABADGAG.ZAEA.XDAChAAAAFGGBFCFfHAB..aGGA.hACA......hAEA...,2,-15,-15,0
dLYeFRfMUaSbOZWKCBTGAVPINcJHQEDXg,VAAD..IFFF.JFBAHEBGDGHD.dGHALABAFAGGMBIBhAAAaCCGOHEA.KCEAhACABHCFAAEG.PBGDhAAANDAE.ECEHXEEFeFABfCAEbCGD.hADACEHH......hBDA...,1,-14,-23,9
ANJaLKgeZfPVFUbYXWDMTBQSCIOEcHGRd,aDCDKDCDZACE..VGDGFFECUGBE..XBFGDDHD.BHAFhAAACEAC.EHGAHBFEGABEhABAAAAG.LEFAeEHH.hACAfADG.......hADA......hAEA...,1,-15,-43,28
dRBOIXCTQfAgDcMULKZWESNHbGJYeVaFP,DACBUFDBZDCFEBHDHCFDGBAHeAFC..aDAFFBAF.dFABBGGB.ODEEhAAAIHBA.CHGF.hAAATAECAIDA.MEADhABAKFHBSADD.NEFE.....hABA......hAEA...,1,-24,-25,1
fcgHbdJXIFTELRYWSPMOAKZBUGVCeQNDa,BCAHGACFCBAC.QFFGDEIF.aHEC....fAEFhAAAHBFCJDDBIDADhAAAEBFCRDAC.YHAGSDFAhABAMCAGODDG.AHGEKFFE....hACA......hADA...,2,-44,-4,40
KVGbTZCdXJSYBLIEcNgfUHePRMDFWaAQO,QGGDODCHKAFEGADCZDCFCAFE..JDAFBEFF.EHCE..NHAB.hAAAUGFCHEEGRBGHFBACaBAA.hABAAIBA.....bCFChACA...XBDB.....hAAA.LDABgAGHhADA..,1,-5,-29,24
ScZWFQBAONEgRCLVMHDGdfUbJKPeTXYaI,EDCDCFDDLAFCHAABdCFCUGGGKCGH...eCDCXFAG.aFHFIHCEhAAAZADE.QCAChABAADIHOHBAgGFDhAAAMEFCDBHH.fEAB...hACA.PBBASEEGhACA..,1,-3,-35,32
JHPCcLdUaBbfeQMZGRDAEKgTFWVYSXOIN,EAFBTGBCFABD.....VDAFSBDHOFFE.JHFAHACDCHBA.hAAALFEFdFEBBFCDfAGChAAAMAIB.ZDFAhABADGAFAAIF.KHDA.gDAF.XDFAhABA....hADA...,2,-35,-7,28
KLbdWPUBVEFIYDaAZeTMGfQSCOHgRJcNX,eBDGGEDCQFFBSEACOCADRACEJBFG...XFBAhAAALFHBbCFEdCAH.PHAAhAAABHEFEDCCFFAEDABDACCEMADChABACDFH....cGFB....hACA......hAEA...,1,-8,-13,5
KYHgbePMTfQXBJaCSFNIAGULDZEcRdVWO,GDDCUEGDDACGEBGG.RCBF.dFAF..OACAKAEHHDDBeDGD..TCBHhAAAQGAC.hABABDHCJHDECHCCSBDGhAAAFBGE.NBAEAIHE........hABA......hAGA...,1,-14,-35,21
ZYbOfgNQaDLdWKVCeHEJRXBMGFcATPIUS,TCBCUCBCZGFE..OEHD..NBGE.aACAdHCFKFCA..CFAFHACChAAAEAFERCFHBHAC.FHCGhAAAACABSDDHhABA..fHFBDBIB.....hACA......hADA...,1,-26,-39,13
XUdVEGfegbAQaDPILRYZOSFHCMcJWBKNT,DDFFLGEAZBBEFEHFMIFA...JAFCKGHF...TEAEXDEEhAAAdGDE.VCBB.EBAFhABAfGAG.hACAeAEEABFBPDHD.......hAAA.IGFBOEAHSFDFhADA,2,-51,-12,39
TNVPdMfZeYDRXWUIKHcbOaFJAgBQESGLC,QGGGGACBCGCD...TGBEVEEEMDDCZDAAeFAF.DDGHRAGFUAAEhADAKAAF..bBDFFHGEhAFAACFHBCBBEGAH.NEFA..hAGA....fAFB...hAIA......hBAA...,1,-13,-22,9
fbgWEPBSJUKNVXMAGHTIcLRFOCZDadeYQ,HCDFTCBCLBDC.ODHBDEDFeACAQBAD.bEAGhAAAEHEABAHASAGChAAAUGDCVGAAXGGHhABAAGGD.cGDBCABB.dCFA.fBHEhACA.PFBB..hADA...,1,1,-27,28
MLXCKIUBVZgfeSJETHdAcRFWaQPONDYbG,RDAGFAFBQDFAOECD.DBAAGBAG.MDDACGHEKACEBBHAZBCG.eGFGhAAAEGCA...dHABAIFAaAHHhAAA..PHDEhABA.NEEF.YFAF.XDDBIACFhAEA......hAHA...,2,-23,-22,1
PAfIbDYJCXGLKaFVUEWBgReHOMcSdZQNT,..IFDGDHCEJEDEGACBLEEB.FDHDUDAGBCBF..eFHDhAAAOHAC.MEAASGFHhABAZABAQAGFhAAANIAH.AFAF..fGGDYBHBCAHCKFBBEDCAhACAWCDG....hACA...,2,-27,-26,1
ZEcBNTKWXbGQFedALOPSfVMgDJRCYIUHa,LEEGSDCDVAAFDEIF..RAFB..CBBD.IHHDHFFFZFDBBCHAhAAAKBED...XFBGhACAbDAD.FCDCAAHA.fAGAhADAMBAF.JGEG.aADEECHF.NAAF.WEAFhAEA......hAGA...,2,-26,-15,11
CgYMFQDXRHTVOBWaLIEeNcbZGPdfSJAUK,UGAFCFED.MAADQGGA.DEEARCDGTFGDBAHCLFABhAAA.EBBBNAEB.ZFCFGCAEhABAdADBJCEAAEIFKHEA.FFCAhACA............hADA......hBBA...,1,-25,-31,6
HYKBEUFGdISWXgafRTcbCJPADNZMQVOeL,ZFDGMEIBQCAF.eBFFLHDEKGAFBAEDFADFdBBA.IHBDhAAASHFEXCFBhABAaAAFRCGB..TDCAhACACFGFADEHDAFE.OAHFEFAG.....WFBEhACA.....hADA...,1,-20,-28,8
KdbBfAaMXPVZFOeNDSYGEgLUWIQcHCTJR,MAEDVEFH.ZEEH.FGAHOBEC..eDFGSAGGEFCF.LCAEhAAAIDBFHDBAhABAJBFE.KDHBBABBfHDBhACAAGGGaHDC.PEAHDDAF......hADA......hAEA...,2,-30,-17,13
NdWCOJSFAeGQaVKBIMfPZcLUEHgYDXRbT,eDACQECBKAFDBDGHMFBDZFEDLBEC.HAAGDEDDXGADhAAATGEHdCGD.CCDG.SBCGhABAAEAAVEGB.IHHEhACA.fCFF.cEGDhADA...EAHB.hAAA...,2,-30,-14,16
gQXDJPENOCeYaILdZBHAKWFMfRTVSGbcU,KAFBFGFHRAGH..TBCBGGABUGEB..QBBHDABC.JEBChAAANCIG...CAEAaEEALEDAhAAA.BHHAAABAMDAFhADASCFA..cGGAgFAChAEA.PHAC.hAEAOBBH.,2,-23,-22,1
VIXdgJLebZTAYBMHfUcKNODCQRWFEGaSP,BBFDMECGHBEAUGBAKDCADGHFRAAC..FBCGEGDH.GDAE..aDFDhAAASDGC.hABAIHFHdHEDJAFALDHDhACAZEFE.AIHG....fDAEhADANADBCCCA.....hAAA...,2,-39,-13,26
QYTKHCLBbJUeZfaDEAOGVNdIRPSgFcMWX,OEGHGEDHdAHGREAF.SCDHFBDH.MHDCXGDD.QAAChACATAABCAFEBHHAhAAAJAEAZCGFaBEF.DEAEAHHB.hADAICCF...cCGCWDFF.KGGChACA......hADA...,2,-25,-23,2
aXGdTgLDYbJONCeQPRSfIZcKFEUMVBWAH,XCCBdEABLDDEDCFH.JACD..CGEA.eHEAREFD....IAHGhAAAKDHFEAAAUFBHBADGADGGhABAHEEFGEAB.TCAFhACAgAGH..YHCA.hAAA......hAEA...,2,-26,-22,4
EUFGCAfONRKYaHMbWcZePLgVSIQXBTJDd,OGEARDAGKGHHHABB..MDAF..bDDDZFCDLFFBSCCAhAAAQBGDBAHFDCAA.hAAAEBEGGGABAIHE.NADFaDFChABAcBGE.eDBB......hABA......hACA...,2,-36,2,38
GUKcOPWYMDgJRfVQLXEdBCNFSbaHATeZI,eADGZEBHUEEBKCHF..OFAF..PHEAMEDF..DDCGJAABRBAA.hAAA..QCDHhAAAEGHFdGEEBEECFGAHaAEC.hABAAFAE.IAHFGBGE.......hACA......hADA...,2,-28,-25,3
JQZLVEOYDaGdMXTKCHSNfUPBARWgbFeIc,RAAD..bAADFHFC.eDEDJGCA.LCFC..OAEHaAEAdFBATDCDhAAAKEGH.HCFBSDBAhAAAfGHCBHDGhACAAGAHIHBE.cAFA...hADA......hAHA...,2,-30,-16,14
ELeHfVAXIPBgRcZTMUCJSOdbGaDQKWFNY,XCBCBFDGRAFAZDEGUFAF..JABGdHEF.GAAFDFGC.KDGBFHGEEEDDhAAA..LCCAhAAAHBFAACED..IFFFhABA..PFAF.....cGDEhABAMADECHHH.OHAChAHAaCHFNECE...,1,-11,-37,26
AJXGNebPMLgOFZDRKHcSCVdUWITEafBQY,JDACXFGHGECD..eHCGMAFCLDBCFHCG.DEGHRAACKCGDHFCGhAAA.CAGEdABC.UADChAIATGGG.EAEB..hAAA.fCCDBFBF.AIFG.NBIA....hABA......hADA...,2,-27,-13,14
UJfIPNcdZCVWObQDXYSaMRKGAgFeELBHT,eCCHBDGFHBBFUGFG.JAHF....fGBEIFBF...hAAAPAHBdGFFCAEC.OABDhAAADDEH...SADChABAMFDBKDADABABFFDHEEHBNFEHZBEB....hAGA......hAIA...,1,-21,-37,16
aBDbXYMLIAPHVKSCENFeOQWdcTGgJRUZf,HGFGVFEE.SFCD.CFGC.NDICOCGFdCDCGAED.RAAGZDFEhAAABBCBDICAXCEDhAAALDADABBFEGAE.FEBC.hACAQCCBTFDG.JADA.aGCD...hADA......hAEA...,1,-4,-14,10
DYXOeUCgHIdEZMVGSKAJcNPFQLBRTfWba,JGEA..NDEH.FGAFBAFA.RFFB...TAFA..bDACDCBEOECEhAAAeDEA..CBEDHDAEhAAAIBHDdCHEEABEMABBhACA.SGCDAIHA.PACD.fEGBhAEAWFDC..hAFA...,1,-30,-36,6
gfCWGNKIVQFODaBUPdTARMeLSZcJEXbHY,eAABLDCHZECHEGFDXAGD..HAFD..fBDEhAAACDDBGCGEKDAFQDAChABADFEEBACGUEEEdHAFAIHASGADhACA.JEHH......hADA......hAEA...,1,-21,-22,1
OCcdQDAJPELUIgeYZVbFXKSHRGaNBWMfT,EDCDLDACUAFA.eFFAZDGD.FBEDKGFDHAGBGBDABFAG.MEEHOBAFhAAACEBF..QABHhAAADGDBAGED.JHEEPEABhABA..gGBC....hABA......hADA...,2,-29,-13,16
fGPbMJWYFZXKIaNETSCUADgedQVRcLOBH,DEFHdDCDRGAGOCCCHAEHGCGC..MFAHJFFFFDAFKBAH..aCEAEAGEhAAA..CHGH.ABBDQACAhABALHCGBEGE.hACA..PEBG.bFBA...YADAhAAAXGDD..IBHChABA,2,-30,-19,11
CPJYBTNHILKGaXMeRFdgfSWZcQVEUAODb,OFCHDAEDCBFA...JAFCBGGFHFEBKEEAGAAC..MCADRDFEFEDHhAAAdHBF..SGGBhACAZFAEQCBCECDAADAD.hADA....YAAA...IHHHhACA.aEGA.hAEA...,1,-18,-44,26
DRXTcWVKOMPbFICZEaJAGHgSefNYdUQBL,GEDHHDAGeHDG..NICH.dAHABCHDRDFCXAAB..cACBhAAAKADCMFBB.bFCECCDEEBFHhABA.AHGC..fFBChACAQGGADAIDTAFCOFHFFBDHIGDFhAFA.aGAH..hAGA...,2,-33,7,40
MZQOfTVNPaWHUbSIGCXRDJgBYFeEALcdK,dDCDMFCFOGEA..VEFEaGBC.HABCUAACSGDBGAEHCBDD.hADADBHB.BHHGFDGEAFDGKBEHhAAA.ZEAD.QDDChABANEAC..WHFAICAA...hAEA......hAFA...,2,-33,-11,22
XSUcEdOLYaHZIBeJVWRAMbKPfNgTDCFQG,MHFGKHBG....NABB.TEGD.FGBCQDDAGCCAUAEEhAAAEHDEdAHGLFEFHCFFBFGAhAAAeAHDJBBBRCBFABBHfAFChBAADIBECACB........hBCA......hBDA...,1,-11,-24,13
MHVZCJQWeaFDNPUXAKbLBOcdEITfgRYGS,LCCHBAFBdHDBECCHTBGG..RCFFGEAAMFIFHCEBZFFA.CGBHQBAAhAAAeAEB.FGDChABADACDUGFEADEDKECHOADAhACA..IBAG.fAHEhAAA.....hAHA...,1,-9,-21,12
KMPFCIOYVEUScaDRbZfAeGQdHTLXJBWgN,eDACQECBHAFHXAADBCBH..gGFEKEDEFDHFCHGB.ODHBhAAAEHCG.UAGDaFAGDFFGhAAARBED...fADGhACAdACDJHCANBAEPFAD.....hAEA......hAFA...,2,-21,-7,14
cdIMBXUGWTaLgJNHKAPbFSefQDRECVYZO,FHBGeCCHDFAFCHHG.ZAAEdBAB.BEHEGEEF..aGEFJCFC..KBGBABEG.hAAA..SADChAAARDCAECAF.OEDCMGBE.hABAUGBELHEEHCADfAFF.hACA......hAEA...,2,-26,-20,6
FgRUEPWSKZTCDLBbQAceMOdHNXVYfGaIJ,MDEBODCHdECEHAFC..VACBGBCF.IACHFGFARAGHEHEGSAADhABA.KEEAhAEACAFHLAADBFACAHECNICBXEGDhAFAaCHDJEAB........hAGA......hAIA...,2,-21,-16,5
GVXHNPReSbJMWQZOYDfCUFBALcgEIdKaT,LGEAEHBGKACF.GAAAHEGHRBABeAHB.SAFDJCEG.QDCEhAAAOEAHfECHhAAA.CEFF..hACA............hADA.BADAAGGHgADHhABA.,1,-24,-36,12
FRNdcIYHeAZVKgbLEGQOCDJaBUMTPXWfS,VDDFKHBGLDAG.QFDGOAAFCBFADGHDBBHG.UGGEMFBBhAAA..TCFC.hACAXFBGWECDFHEANACH.hAAAdAHE...IAEDeBDBAEIBgBAEhABAECCAaDGA..SFGChADA,2,-25,-23,2
aQPURDYXAbNFCeJOGKfWgcIEVSTLBdZMH,FHBGCECD.OGEAGBBF.KCHB....gEBFIHGFEEGDhAAASBEDBBGEdFAAMIEAhAAAQGDEUAFHDFFAhABAAEEAeAECJBBB.fCAEWACB...hAEA......hAGA...,2,-32,-22,10
URPJHeKaQXgAdNDSEYTZOfCLcIVWMFBGb,dHFHDGHHEACGZDCFCABB..LEFB..IBFBVAAH.MCEBhAAABHDB.UAGD.RCDFHFBHhAAAeEAFKGFE.aBBEhADA.QCGEAFAF.NIAD....YEBBhAEA...hAEA...,1,-22,-27,5
BUHEWLQdaRCIcKSZJYfbFPgOeNGAVDXTM,VFEEXECE.BEHEECFALAFE.QCBBdBEAaHDECCHFKFFChAAASHBCZFAFJABE.hABAfEBG.hAFAbABAFGHBOEFA.NDAAAEDGDCCDMAAE..hBAA......hBGA...,1,-8,-33,25
BYKDMCcdSTRPUfegbGVIONQAXaEWFJZLH,aFHBEAFBFABDLGAA.BAACDGDEMAID.dBDCTEAC.REEDUCGGhACAfDEH.hADAeCHDbCCFGADFhAEAOEAAAAGE.XGGB.JHBE....hAAA......hABA...,1,-10,-27,17
WBFTPGfgJEUdXRNIbCYeKcADVMZSLaOHQ,DIBGZFBGaFEDOEEH.HACGBECD.FGHFGDGE.JFABUBECdCACRCCFhAAA..IACFhAAA.CDHC.YCFDhABA.KAFCAFAHMICGSGHHLBAB.WDDGhABA...fAHEhAEA,1,-22,-35,13
UZGOJcIYgFBDPNAHMdERCVTfaXLQWSKeb,dAABCCAH...VFCDaECALAAC.QBFAKAFDbEEFUAGEhADAGGAH.OFFBhAEAICCDFEGEDGIB.AGACMDCGhAFAEEAD..fGGB...hAGA......hAHA...,2,-30,-22,8
JETQLcDYbGZgdPNXAKMHWIeFBfCVUaSOR,MFCFHAADeGEABAGH.CECBUAGHOHEA.RAAF.EFAFLCEH.DEBBhAAAbADDGCCEdFCD..hACAXEEBAAFDKDHBIADHhAGA..........hAIA......hBAA...,2,-28,-19,9
GceSVMOQFKgNTLDHAEYdXPUJBWfbIRZCa,EAFBXGBCUGAABGDH....fGFERBACCEAB.GAEGhAAASAHFOCAEKFEChAAA.....NIEHDFHBhABAACIB...dCEEWEHD.IAGHhABAaDGA.eEBGMDDF..hACA...,2,-33,-28,5
VMDJWCLBURbTeZcaIHPOKQNgYGFASEXfd,EFAAdGFCDGBH..CHFDUEDGRDBC..TBBDeCACZABA..IGHDhAAAOHBEKHGE.QCGAhAAAgCGGFAEAhACAADFHSFCH.XAFA.hADAMFFAWFFEbADB..hABA...,1,-21,-34,13
ZIaHdcULgGBPQXWYeVOMSDCTEJARNbKfF,RAADKHBGZFGDHBFAUDDGGEAB.BDADQGDB..YHFAhAAAeBECVEAF.MAEEhAAADACHEBDA.JDGB.hACAAEDG....NDBF........hADA......hAIA...,2,-24,-24,0
OgIELCYQBMHAFfcPSZUbVDaKXGWJTdReN,FHBG..PCCHZCACUAFGDEBB.KHEGGABF.JHBGdEAA.eBAGhAAAOHFA..EFECLEFEhAAA.QAGEhABABEHBAECHSDGC.aGGAWCAFhACA......hAEA...,2,-34,-30,4
RZEgTBHYNGAadXOQUfbJceVWCPSKILDMF,dFAAXDCHUFEG...JBBCeHAA.CDDF.KGGEDEGAFAFB.ZGDAECEGBCHEhAAA.HCABGAAChAAAACGH.QGGGhACA.fAGB...cADBhADAPHAC.IAHGhABA...,1,-16,-41,25
JXQFYCWKEULSdINHTgVPGaDMBefARcObZ,RFDFOGEAZEAA..JBHDXACB.QBAECDEGKBCG.EGCHLHFGhAAAdBECHFAD.VDFAhAAAaBAHBGBFAGIB..hABAcAFE..YAGD.SFFEhACANIDF...hABA...,2,-39,-11,28
ReDWANZBMQbCJFdOHcKIaEfGgYSUPLTVX,BFDDQFDBJCED.FHAAHGBAKDAC..EAEAGCAG.SACFhAAAUAACTCGFRAGHDFAHAIHAMCEHhADAdHFBOFFA.hAEAaBABfAGF.PGFC..hBAA......hBCA...,1,-17,-23,6
gVaISMQcPdOWfJGXADebKTUZFEHCRLNYB,DEFHKDCDZAFEFGBAHACDLHFABHEG..VEGDSAGC.QGFAhAAAPBAAdGAFOBHFhABA..fEEEhAAAJBEBAEGGeEAEbADFECAACGDG......hACA......hAEA...,1,-20,-21,1
BHfWNRbCFXSZDcedIMQYgOGEaLJVTUPAK,BHCHHAAD....NECBRGCAbDED..FGGASDBDDIAE.dCGFIADDhAAAQBCBOAFHhACAEFHH.LAGBhAIATGAGAAFCKCCEfFCHCGBC.ZAFEMIFAYBADhAAA....hABA...,2,-22,-14,8
SJIGKYQMHcXEeTAfZgbWLNaPCDFRBdUVO,ZAAD..bEFHLFDB.aFFCDBEEFBGHBBHBdEBG.UEAF.SDEDhAAAIDDDKHFEhAAAMDDHHACEEEHFTBAAhABAACFH..WFADCHCA.ODHF...hACA......hADA...,1,-16,-35,19
LPcQXUKEINWbTBHVaCZfMSGOeJRgDAYdF,dAFBLCCHQCGBXDGCUFCG.KBCHEHDE....IHGBhAAAbFFEBGADHFEACAAEMACGhAGAOEAF.eABChABAgBGEDFIFAIBC.YCEB...hAIA......hBAA...,2,-19,-19,0
GTZQNHFScWgbUdMVACfYOERPaKeLBDJIX,CFDGOGEARAFA.KGBHBFHC.DAACJDAC.GAEFZACBHCED..FAAFhACASEBF.hADA.WEEA..bGFAhAFAMEIHACBF.ECFBaHCAIFAE...hAGA......hAIA...,2,-38,-33,5
UIfLNOYGKQCAcPEbSTFHJBXVdeMWaRDgZ,EHBGTGBCHCCC.JACGBEAC.dBBHMAAFRFDCDDIFUGGG.LBGHhABAODEGKHGAQFCEhACAAEED....PBFAhAAASGAD..XADF.hAGA......hAHA...,1,-16,-34,18
BLdcPXZaYCeGKRIOJUVgNbEQAFMfWTDHS,FGFHMCCA..TCGESDHHBEEELEABdAAE..XAGDhACAZCCGCBAAKAFCODDBhADAUGCE.NHEB.EADFAIGAfGBEhAEADABC..PEHD....hAAA......hAIA...,1,-26,-30,4
WGVeFHaRXdCZJIMTUgKfEQLSAbcYPNDBO,...bAADPGEA.BCBAGAEFFHAGRDCBdDDA.CEHBZGEC.MIAEhAAATEACKACD..ECGCLAEAhAAAAFFA.cCGBhABA.DIGAWECF.eEAFaABE....hADA......hAEA...,2,-25,-17,8
IPQWEVHbGegSYZaMXODBLUCKJRfTFNdAc,..IFDGPDAC..EEFGHGDC.bBAFGGAH.SBGHhAAAaAFAOCCEBACGCFBFKFFChAAAfEEEFCGEAHHCQADDhABAeCCEgGGBMCAF.DAFE..hABA......hADA...,1,-5,-21,16
efRDESbFQBdgKYMcTGNZCLPWUVJIHAXaO,XGGDOFFBRCAF.DGCG..EEFGFEDCBGAAdBBE.KCHD..MICAGADGhAAACCEALADGUAGFJFDFhABAAHBF..eCAD.SCHHhAAA.gCFH..hABA......hACA...,1,-29,-32,3
MfCHVAZEKTBdOYUNSabeRFWPJDILcQXGg,ZFEEKFAABEGCdCCHUGBA..SHCCeAAFFAEF...JBHFDEIBLBCAhAAA.QFFFhABAgDBGCDECAAEGEAGHhAAA..OBBH.....aDDHWHEAhACAIHAF..hACA...,1,-33,-42,9
AeSKbDdZcQGUJFCNaMXVTBEYIPWgLOHRf,eEGHSAFBDBDDZCFCQGGDGEBEFAFEaDCC....MCBBhAAAXBBGBHHGEEDGPAEBhAAA.LBHDhABAOACAfGEAKFDCcDACUGDFCBAC...hABA......hAIA...,2,-24,-1,23
ECAfdbUJPXZKcegYFVDIBNHWMLRGaTOQS,dHBHUDACJCEBZGDG.KDED..eBBEFABD.DEACBGCFHGFG.LAHDhAAAGBGE.OGAA.hAAAECCBCAECAIFA..fAFEhABA.XEGA....hACA......hADA...,1,-20,-54,34
dWISUXLCATHKaVDgQfcBePNMYJRZEFGbO,KDAFVFFAQGFF.BBGANABH.MCBERGCEFDCD..GDDFhAAAOBFBdFCA..IGADhAAASBHH.UGAEhABACBCFTCGGDACG........hAGA......hAHA...,1,-22,-37,15
KLVPUAXdTJEeIHGDNbMaSOYFZBcQRCfWg,XFCAdGDDEBGBHCCDGBAGDEFE...MIFEaDAC..OFBDZDEFBAGEhAAAQGGGCHDD.hABAfABFKAEGLCHHhACA.UCCAAAACeFAFIGHCNBIESBDEhAEAcCFF.....hADA...,2,-21,-1,20
BKFeDXfQUAWdPTZHGLYIRNSaMbVgJOcEC,dHBHZEFHLEBGRBAH.aDHFVFDA.OACEEADGKGCD..DAHBQBAFhAAAADDG.PAGBhABATCFC...hACA.YHEASAACMFAH....hAFA......hAHA...,2,-42,-18,24
NcIQUTWGgCaHAXdSfDBYKZREPeJbMFVOL,dFHASHFGBGFEKAAFEDDB..eHAG..MDIFFDFELDBEhABA..ICEGhAAATECB.gDFFhABACAGDABCEDIEA.REBFPADC.JCADOBCEcGAChACA......hADA...,2,-35,-24,11
BeWMAHGFPOaYdfKJSVZDIgQRCLcTNXEbU,GBCHOCCHdAGBKAAF..SEEEDGGC.QFAFCEEHLAEFhAAATGGEEDHFBCAAMHCEhABAFHBEaFDG..fCGChABAJAHBVCAF.ZGFA.......hACA......hADA...,1,-11,-31,20
FWXIVBQPYMGfEHDZAedgSRcNbLKTaOUCJ,dDCDSCFCRAEA....NAACLGDAKFGFaEBAUFAGFCGB...hABAICDBBFGEQEADhACAMIDAGAAFfBBChADADDACAAIDeDHB.......hAEA......hAFA...,2,-34,-24,10
CLEeZgDdFBOHcTSfKXWJaPMVYNQbGRUAI,CAFBEGDBZDACdDCABEHCHEAB...TEFDKCGA.JFHBMABB..NCCB.hAAAQFFD.hABARACCAEECeADA.DAIHFGCBhAAASEED.fABFaGEH.hACA......hADA...,2,-41,-10,31
PKDdVMUHfNJSEZcRWBTCXLAFYgbQeIaGO,FHBG..bEFHQEEBeAFCGBACKGGFdAGBMDECHCEE.JBBFSACAhAAA.ZCCHhABAcDAHBFADCHCCAIDC.IBHGhACAaEHBDDDFVACENIEBWFCA.....hAAA......hABA...,2,-18,-2,16
geVGSHEbYBdLNCQTADIKaJcfZORMFWUPX,DGHHKAFB..JECFZGDA.RDBAFGBBUGEH......XAAChABAeADFSFAFEEFF.hACABCAHdBFECFAFAACHaEEE.hADA...OBCEPHAE.GBGEYAHFhAEA.NEIE.IDEEhAAA.MFIF,2,-30,-28,2
ZdLgYbORCNeTVHDQMGWXPcKIfAESBUFJa,EEHBSFFBFABH.ZCGFLCFG..gDBDbEBB.hAAACGEHeACBTADFDAEDGEFAhACAXAFCKHAAIFAGhADAAHHAUGAAaAABOEDD.....hADA......hAGA...,1,-7,-25,18
NcIOfYSDCQLgaGJEbHTRKWABFeXMPdUVZ,eCAFMFFFdGHAZDDE....IAACOFBASBDDDAIFLFFChACAaAFBEHDEHBGB.TAAChAAAKFBGACHBFCDC.XGGChADAPHACNDAGfAGA.CGAD..hACA......hADA...,1,-15,-21,6
LJOSKdNaTVeUDAYgMZRcHEGXWIQPbFCBf,MCCAZGFGHCBCGEEHXEFAQGCF.FEAFBBFFLAAChAEASBAFdDDFaAGCeHBEhAAAAHGA.RAGF.EDGEPFAAhABACHAB.OGDG........hACA......hADA...,1,-9,-14,5
AfbSNagMdDPJRGVEIQKTFLOHWUceXYBCZ,SHBGaHBG.dBDCJCFGGGEBEFFDKECDLGAC.HAFChAAAUAACXDFEBCDCAIHE.hADAfDAH.hAEANACHDBAFPAFG.IEGAFEEH.ODEBhBAA...eEHHhBCA.CDBC..,1,2,-36,38
geQbVFDXJfSBAEITLCPNdZYcUKOMaGWHR,TGBCLAFB.CHEAdDBAZDBGUGFH.ODGHMFGHGCGE.hAAAHFBGRABCQBGAhABAVACFDHAA.fAFFhACAADEFEAAC.PFCA.......hAAA......hAEA...,1,-8,-19,11
NRGEIdcPaOFDXfMBeSZACWgHLJVKUTbYQ,CFDGHAADLAFCVDEAKGCEUGGG....TGAAQCFCGACEhAAAdCABaAEEFHBG.XDDFhAAABFACeHFE..hACASDAHAIFG.JABANDIA.EHEA.IEHAhAEA....hBAA...,2,-24,-4,20
PBXJQaCFSbRAedYTMZgDKUELGfOHIcWNV,dDCDMFFFDHGAKCCHUBFBLAAB..ODHDHFAB....IHHHhACA.NCEDBFDHhADAQGDA.aBBBhAAASAEAAICEeEAHTDFAEEHBfDFGhAEA.....hABA.cADG.,2,-36,-19,17
RBXcDUACNVdYLJOIfEbaZgHKGMFWTQPSe,VDBHLCCH.JBHFOHFA..ECEEZAGFHFFDKABDFDDAQFADhAAA.eACABEGEhAAADFEFCCAGdAEEIBAFhABAaFGC..MIAEWFHH.SDAEXGDBACCChACANIAB......hADA...,2,-28,-3,25
bZJHDPASCBKFcXUNYOdfgTWGRIQaLMEVe,CCEABEFAFECG.UDBB..OABHdAEA..TBBDGAED.QFFDhAAAaEHH.ECGHeGCGhAAA.JCFEDIDASHAChABAKEAHXACBNIEB......fAGBhACAWHAC..hADA...,1,-29,-38,9
XaLYfZEDIFHQUAGPVdJMeSbCWgcBROTKN,GEDHVDAG.dHBHeADDCACE......gGGABEGGOFEDhAAAKAEA.aHAGLDDChAAAfGHADCEGFCHHQCGAhABAPBAHMGAESFAG.cDDDhACA.....hABA...,2,-25,-22,3
TQIXaULfBbPcHGCNgJdKSEVAOMDZReFYW,DACGZDBGRGFCFEFG....TGBHQBAG.aBGBfBBChAAA.BBACbDBDPBEBhAAAHAFDCEHBJDFF.KADEhABASAHBAIDA.OEHF...hACA......hAHA...,2,-28,-23,5
fHXBMOdabGgWSJePINYEKLZcTURVACDQF,CEFAFDABHFDHMDFFdAFCGBCH..SAABJDGB.eBHBIACGhAAANBDE..KFHFLFBFhABAZEAH.TAGEhAEA...........hACA......hADA...,2,-32,-29,3
eQFXVWHcTZLJGaONbfEDBSgRMCKdIAUYP,UCBCeGEA.FCHB..VBECHEFHZFABLFAHGCCE.OBDD.hAAA.fAHEhABAEAAEBCAGSFCChACAMACGCBBCIEFFAAHDQGCEWHEA.JFHBaDHFbAEB.hAGA......hAIA...,1,-2,-19,17
aeVdTPSFUWCZDBcRKOGAMHIbXgNQEJYfL,MECGHAADXCCA.QFCBEAAFfFCCeAFEVDFEhAAAdEACSADDFEAB.hACACGGFDIAGRADEKGHHAFIDIGEDhAAANIAF.LAHFaGGB.PCAC.hADAZCFF.....hAIA...,2,-11,5,16
WgZQcDMHEICRGFPfSAVKeUdOJNaYTBXLb,VDEDKGDDdFAA..OBFCaCEH..BDCCLEBB..bADEgBCFhAAA.QGGEhABAMBIDHAADIHEGhACAGDFEFFHD.SFCFADHDeFAFNADF.hAIA......hBAA...,1,-19,-22,3
eOWSgaDJIRYEBNQCKHUTGLdZVPXAbFfcM,FHBGMCCAOGEA..SEEGDGAF.JAAFRCGBBBDA.CBACHEAAhAAAGAEFZCEBPHAAhABAADAH...cGEHhACA.eDFCgCBGaGGCIEACNIDF.hABA......hACA...,2,-32,-18,14
EBAgJFXNYZGHDRMQUPCSVaIKTWLfbOecd,FDCDXCBCZAFGDEEDRFDF...UCGDCHAC..aADAKGAD..LFFHhAAA..bBBCcEBEhABAdFHABHGD.AAFG.gDGBhACA.NCCD...YHCEhAAAMBBESAGEIADD.hABA...,2,-46,-14,32
CKbMaLNHGYVWTIXEUDdORAgfcQJBSZePF,...fHBHQDACBHFDeFHHCFGGKBEAaEDGHFDA.GCGGhAAAVBAB.IHAHhABAUEDADGADRAEHAICG.JABEPDFAhAAA.FBGA.MABE.....NEIE.hAFA......hAGA...,1,-1,-28,27
gRWNJcAdDVYQSbOKPXTMGFaIBZEfeHCLU,DEFEQFDHOFDH.KBEA....PBEHXCBB.TGGAhAAAMADEFHGABACAEHAEHDFChABALDBD.RAAAJFFAhAAAAAHCYHBA.SEBGbAFA.hABAaGABfDCAhAHACDDC...,2,-23,-12,11
eNVfCGaUXQcOWZEYHATPMRDKSgBdIJFbL,MFFFDGDEKDAFBCGD.dEDGFCDDLBEE..eBHB.VBAChAAAfBBFGBFEUFBEhABAXDAH.QGAFhAAAOFHBEHEEACDFTGGFSGAFIEHAhABA.NACF....hACA...,1,-17,-26,9
DfVKFAICYJZHScNTOMGgXULEWBaRQebdP,CFDGJFBBZDAGHDEH..SGAD..TAFCMEIDGGDHhAAAgCBBLCFEhABAEHFGaDAHRADCQEFFhACA..dGDE.fACBKBBHAADE..hAAA.YDHF.hAGA...,1,-16,-18,2
RVbHNCWPgaFYQGMEeBSADTcJIOXdZKULf,DAFBTDAC..IEFGdAAEKHFALAFA.RFECHCFCNDBDCAAC.hACA..PHAEaHBEFBHHhADAGDCAeFHBABGHOCDGhACAZEAC....fHEB..hAEA......hAGA...,2,-41,1,42
WDdJNFECPZXQRcfAgLabIUBYOHeVGMKTS,aDCDUCBCBGFAHBGDGAFGKAFE..SGEEDAADdHBF.FABACADGZFGBhABARBDFAEIF.LBBB.hAAA.bFBBOAHF.hAEAMEEBWHFA.EGDBXFAC..fEFBhAIA..hBAA...,1,-20,-22,2
FIbaNWDMCLUQTJRYegVdPcXOBHSfZGEAK,KAFBFHBG..aDGDDEDGLDEDQBAA.RFCH.eDAE.dAFHXEAAhAAABEAGSHGAhAAAGGEBAAHE...IBAGhABAWDDE.CGHF.........hACA......hADA...,2,-35,-35,0
GLEQWAFObUVBSXZaJdPRIMCcKDfYTeNHg,OCCHVEFH.BFEGZFBGdDCFRAFH...CHCA.KGHBDADA..TACFhAAAeCFAHABALHDAEAGG.hAAAQDGHAEIH.hABAFFAHSHEG......hAIA......hBAA...,2,-29,-25,4
TSZDULgbJOfREeXCMHFBWcVdKPGNAIaQY,QGBCSGFCDEBCLCBC.JEHBfBGERFEF.EGDFhAAACAGEMABGFDFH.BFAChAAAVACFdDDDKHFG.PFAEhABAAEBGIDGF..aCAC.YCHBhACA......hAEA...,2,-27,-24,3
YcTBDagESOVKUMJICfRHdGXLbFNWePAQZ,ZEFHTCBCaGCD...SFHFKAAGUBGF.MEEE..CHEGHEABhAAAXBFAFCDA.eHAAAFHH.hACAQADCBAEDEDDB.hADAJFFF.fABA.dAGB.LFAAhAAA.WBAD.hAFA...,2,-34,5,39
CREcQGDdXUBASWbFNMJOgeHLZPfaTKYVI,SHBGFHBGMDEC.OEFHHGFEZABH.aAECTAEG.KBBFIFCAhAAARCDF.EEGDQCGBhAAADAGG.dEAEhABABFEGAIFGWEHHJDAB.LACB.fEGEhAEA...hADA...,1,-7,-28,21
YVFBZJQINOLdCASGRXgHMDabWfKeUTEcP,SGFHRCDFHGDGDAFD...aFAC..fBBAKCBDUDGAEAEF.hAAA.PCHFFAHBBHHDhAAAQEAGOGCEdEDHhABAAGCGXACBMADF.eHAG.....hACA......hAEA...,2,-26,-14,12
JfbRcIGaANQPMFeWEXOKdBDUSZHLTVgCY,QCBCMHFGFAEH.eEDEEGAE.KGCBBCGBDACAZBDAHEFA..LFBDhAAAVDCE.CEHHJAHFfDAFhAAA...hABAcABDIAFCABAD.PHEGWHAA...hABA......hACA...,1,-19,-29,10
HcQZgIBVeELFCSPKbDdAGfWMTJNURaYXO,GAFEMCCA.JDBAUFBA.RBAD.aHEG..OGFGQABBZAEABEFEhAAAEFDA.LDEEhABAFHBGCFBGKAHBDAFE.AIAE.fFGBhAAA..NICB.......hACA......hADA...,1,-23,-31,8
eVfGQOIJNHdZCgWLMFAYSTaDBEPXUcbKR,TGBCaFGEBAAC..EDECUBDD..KBGCREBC.VDAEQGDAhACA.OBHFIABChAAAJBBF.NDIAdADF.CGGFLHEAhAGAMEAHAHHGDDGH...XGAD.hAHA......hAIA...,1,-21,-24,3
DJeQACLbdFPEfNRgOXMGIcKSUBTHVaWZY,CAFBdDCDFHGEEAED..RAAB.OAHHGEBE..KABGBFDEHFGF.aBACZBEFhAAADDGF...eGAGhAAAABHGLADD.fHEHhACAgFDEMFFAcDAC.SHEGhABA...hAHA...,2,-36,-13,23
YXIUMeJPQSZDVOfAWGgNELabFCBTcHdKR,GAFEEHBGLFADaDDFFFGCCFCC..BGDFHEAGKAABXADB.MAADhABAJEDAQADGhAAA.SHFAhACA.VBGHAHEA.gFGCNIDFTBBFdHABhACAIDBG...hAHA...,1,-14,-16,2
RTBVIQNbWcedZKJUSGYEHDMLXfACagPOF,aEGDOGEA.FBDDTBEDBABE...VGDCQDAB..hAAAbABBeCFDKFABJEDASAGDhADA.ECHFDAAFhAEAMIEGfAHEAGDH.CHCG.PHAC.hAFA......hAGA...,2,-29,-23,6
OHTUeQXWEKfDCSMRbLYNPagFAJIcZBGVd,JGEAZAADBAGEGACGdFFEHCGDUEAF..XAGAKACG..DBIBCBBFRFBFhAAALDDF..hAAAPEABFDHH.ADFD..hAEA.IHCCOEDC.QBEE.hABA..fHGFhAFAMFIB..,1,-20,-32,12
WZRYSbCHTODLdQUNeJEAPfaIgBKMcFXVG,aHBGBFDG.KAACMDEHFHGA.GAACZCCG.RAEA...SADDhAEACCGG.HGBEDHGGdDCAQAGEhAFANEACEFFG.ABEC.IHEEhAAAXFFC...YEEC.hACA......hADA...,2,-27,-24,3
FAOQTVCKdSafUeWZINEHcbLPJgGRMXBDY,ODCHTCCB.KBEEdFGF...aAAEeHFEZFBE.EAGEHAEBLCAFhAAAJHEA.RFDAMEIDDAHFACIHCHDDSEEEhABA.fBBBhACA.IHCEcDAAgDFChAAA.BHHBhABA...,1,-11,-28,17
dTaNEBbPOMgJWVLfeKRXYHUDAQGZSCIFc,GACFCCAHFEFE.dFGF.aAHHEGBF.BCCD..PCCHMDEE.JGAALFCHhAAA.eAEGhABAXEDDHABCDECEAHIH.hAAASGGCIBAFNIAB.ODFEWFED..hABA......hACA...,2,-26,-23,3
ZORCeNGKBUbYEJcTSgLWHXPfADIFMdaVQ,DGHHFGFHdDFBQBDARAAE..eHBEGFCBBEACUFAE.EAABJDCDhAAASAGDLBFEHEFAhACAXCBHAAHAMADEhBEAaDFD............hCAA......hCBA...,1,-20,-23,3
KJXUGQVWBfgeEZIFTLHAYCNdaPOScDMbR,CFDGdAFB.aFFESEEB.DIGEbEADKEBFUACG.GCDFQBADhAAABABDeEFCECEEIHBFhABAFHCE.HCGFhACAACGENAAA.OAHFMAIF........hADA......hAEA...,2,-27,-10,17
bYABUZTKFODJgQMfNVERGaeXCdPSILcHW,BFFCZCDBFHGAJHDA..MCHF..VCDAEHACGABF.eAFEhAAAdBBGSABEhAAA.LFBHcEAFHFDChABAbAGF.AIFGKCAEDEADQGGA.hACA......hAEA...,2,-28,-14,14
NcdFYEfReMZUVQCHKTOIDJgXWLSaBGbPA,dHBHFAFBEHACRBDHZCAB..UBBGCABB.HEBGKHGA.OCGF..DDFAXGEGhAAALEFHBFFGhABAGFAFAAHF..NAEE..hAAA.fAHAMDIB......hADA......hAEA...,2,-38,-19,19
OKYNVUGWZEJcSTIAXRBgbaDfdMFHQCLPe,XGDCBFDDaAGE.dBCBFBCDHBFG.LEEGeAEDKGAE..VEAChAAAGGEFECAF..SHAAhABAIBACAEDE.REFEDCHHhAAAMIFG.CGHGYDDC.NACF...hAHA......hAIA...,1,-4,-33,29
ODUTEJQRaMfgHWFNXYAZGSCcKILbBVPde,GBCHCFEDKBFG.LAABBHAE.VCGHdAABDDGCEHAE...RADF.fAEBhACAHGFE.FFDEXDBEhADAADDH..SHGEhADA..cFAA.IEHAhAFA....hAGA...,1,-15,-50,35
KMFfEZBcPUWDXeSGTJdRVgCLIHbaQAONY,OGEAKHBGFDGHZCCHBAGC.UCGFDFBD...eCEBGAEE.dABBRBACCFHBhAAALAHBHEAD..hAAA.aEABAIHCMABE.hAEAfHCD.EAHFcGGH..hAGAXADA..hBAA...,1,-25,-30,5
RcUeOLEXGTJACgWPZKYNHDSMdaIVBFbQf,CFDG..PGEAKCCBHEEDDDEC.dAAC..VGBEFCGG..QGGEhACARAGHeAADLECAEFABGADFhADAAIHE...WHAGhAEAYFAD.MEIH.IBEEBEHC.hAGAfBBB.hAHA...,2,-19,-17,2
BDaefbNJcRIOMgdYKVWSHFAPXGECLUQTZ,XFGHEBCGUGFHZCAFBCHC..DDGFeFCE.....NABHRBCHMAIBhAAAdGAB.KHAA.SADEhABAABHACBFEQCEDhAAATFCG..fHEB..bCCE.hAGA......hAHA...,1,-28,-32,4
eLDECJHgVFZSGTaBbQWYdNPOKARMcfIUX,RFACMCCA..IHEFeFFEECFFHCEE.FDCCGBAEBAACQACFhADAdBHAPHEAAGEAfEGEhAFAXGBGLACAhAAADIGAJAHF..........hABA......hADA...,2,-18,-16,2
JBfLgXNSUeKYGFRVdCOIaHAbEZQPDTMcW,ECFCQFDHDFCF.MBEAJFGD.BACGLBAC..XGGBhAAASGADeBBDKDDFFGAAhABAdAFDIEHGACCF.hAAAZBFGPFEDWEDCNADFGCAECHDA.aDGE..hABA......hACA...,2,-25,-8,17
eCNRDSYIObfUWdGMJPQAHEZFVBLKXTcag,EDAFFDAFLGDGKEDA..TBBG..gCDGCEGADGDB.hAAAIBGBOBFHUGEEhABAGAAHMAIDQECHhAAAACGAHFAFBHHEaFFGNIEBSGABYADE.hACAWAFC....hABA...,1,-14,-24,10
deIEbgaWTcVMHFPNRDfSJQYXACOGLKUBZ,GACBKAADUFADdDAB.eFHFECAC...aAHF..TGFHMEDGHFAFhAAAFCEDRDAA.SDHFhABA.QGDHhACAAIHACDGHBFFCIBHF.....WDHHhABA...cGDChACANFCFDDDA..,1,-10,-36,26
PTcQWIEJLFMaBYRSAGHZDOfUgeNVXbCdK,HDAHDAGDOBHFUFEFeABG..XEEGCCCFKDGA...PAADhAAAQGBA.IDDHhAAAJHDGMFBFBFHGhADASDCBADFAZAFE.gADF.NDAEbFGDhACA...TCEAhADA..,2,-27,-15,12
AfFNCDSUcHOVYWgGQePRIJXETMBbKZdLa,FHBGCAEDDDHHUDAC.HEFDOFCE..VACF......hAAAgBACeCEF.hABAIDCDXAGBTBFChAAAMDIFBHHCKAHBLHAGAHEAfAEBhACANDBE..cGGB.hBAA...,1,-25,-36,11
WHJVFSTODICMUKeYRdAXaBNPGcZEgLQbf,XGAFBFEDGACGZBAFLACBQCAC....bDEDWHBAhAAAJAFC..FEHFOBGHhABADGHFMCFEeDHH.dFCGADGBaHDEhAAANAFEEAHBHECD..SGGDCEAD.hABA......hAEA...,1,-6,-9,3
LEMfPZWIRFYbVKQJCUXAgSHONDedBcaTG,SCFCHFDFODADDDGHeDCCBAHB..aFGBGACGEAAH.MCAFhAAAfCHCZEADREDFFDHBbADEhAAAKGGG..CBCDAHHF.dHAFhACA............hADA......hAEA...,2,-30,-9,21
RIaZMWQdJYfDVSBbGUCeFcKNALEHOXPgT,LDCHEDBDHEFFOADEXGDE..TCDHRAAFZAGB..MDIBdHCFfBAFhAAADEADBGGHGADEhAAACBHBeGACKEFGAGIH..hACA............hADA......hAFA...,2,-22,-13,9
OWDdEcbFYRgGeKLTMIVZQHJUPCBfSANaX,XGBCOFCHdADC..EDECFGEF.RAAFGEEHeDAAKGGA.LAAChAEAMFBFZAGFJAGF.CEGGBCBChAFAAHGB..aCEEWFCAhAHADBEG............hAIA......hBBA...,2,-29,-27,2
JVaQHdSgOZEMDLGcXBUeAPbFfNYTRKCWI,FHBG..NDHC.RFEBCBCF..JFBD..QCDGHAEDdABDOAHFhAAAMCFEDGGALGDAGBAEBEHGhAAAAGID..PDDFhACAfAFF.KFAD.....IHHGhABA...hAEA.SCCC.,2,-24,-23,1
QBRTGYgENdISJZKVCXbaMcHWOFeAUfPDL,UCBCDACBQBGAREEGGAGC...EFABdGDESFFEKABG.CGGD.hAAA...XGEHhABAbFADaDAB.MEFG.cBDAhADAOFHFAFBAfEDGBAAC.gGBHhAEA...hADA...,2,-32,-12,20
UNXBCKQbdfcgVeJTIFDHYMRaLOEWSAPZG,ZEBHUAGHBHHGQBCEdBGH....fDDGgFDCeFFFhAAAJEHF..FFADDADGMIEEhAAAaDFGLCBChABA.EEGGABAANEABCACD.KCFD.......hAGA......hAHA...,2,-30,-23,7
baALBCKZePVOEJFWgNHTGSDcfURQYMdIX,LFCACBEAKEEA.eCDHOCDHFCAF......gBGEhAAATDAASGEAhAAADFHDfHEBUCGCRABFMEFChABAIAGHXAEBAADABFADPBBA...hABA......hAFA...,1,-14,-38,24
fEJAFTgYaPRcbULNQXMCKBDVHSOGIdWeZ,TGBCaHBG..RCCCUFEHQFGC.CCBCDEACHAEG.SACFhAAAOCDGdDFBeBADZAFAEGEFhAAAFDGGPEABLABEhAGAMFIFKDDD.BFCA.......hAHA......hAIA...,2,-14,-9,5
TSKEcAYPeNGQJgfFLaWOHbIdVCMZBRXUD,eGEAQAGH.JGAGfFDC.aBGEHBAG.IADEhAAAVEAHMBCEZFEBBDEAhABAXAABDDHFTGGFhACAEDFGAFIHNADH....FCDH.OHFE.CHBA.hAIASFAC.hBAAcECA.,1,2,-23,25
LGUYZagbFIdBQKXWHEPfSJATDCVNMcOeR,TFCADFCFCCBA...MBAAOFGFLBFDUBFE.aFAF..FBABBAGBhAAAKEFE.XDCAhABAHDBCEFABSFFBhACA.AEHGNIAFeHCA..YFHH..hADA......hAEA...,1,-21,-38,17
KUEHDaZGPFCBdgAObYcSXIeNJVQWfTMLR,OGEA..YBDGXDFD.eAFGJDBD...QAAFhABAfEGETDBAhADAMDEDLAAFKHAAHGCADBFHhAEA...........hACA......hADA...,1,-8,-51,43
cFIAfQbVLPJMUNaTBKeCgZOGSWRHEYDXd,QCBCVFDF.LEDHMBIFUEAFaHDEKAAF..CGBDZADAGCFEhABARBAHHCDEEFBGDFADdGGG.hAAAIGHAAAHF.PADAhACA...JBHFBHHB....hABA......hACA...,1,-4,-21,17
NKWAbCXBJcLaIOQTDfREgVFUZMPSGHdeY,XGGGBAFBJCGB.LCHB..IFCATDBC..fFDChAAARFDF.EGBFFCBDhAAAMBABGADAHAFE.hABAdDFBNCIAKGGFAFACcBCFaCABDBBE.....hABA......hACA...,1,-8,-35,27
bAOQBZDWKEXSeCFdJRfIYUaGVgNMHTcLP,QGDEBFCFDDBFKAHHECAB...eBBEFAEDRGFA..IGAChAAAUDGD.aDFF.GAEFhABA.gDDDhACAHEDBTABGLCHHADAHZGAASDDECHGFfFCAhADA......hAEA...,1,-2,-35,33
NQSbefWGVFRagXLEUTCBcMOHKDZYdAIPJ,JGEASGFC.eFABGACG.VDGHFBBEaEFALAFD.hAAAUBACTGCABCHEMCEGhABAKEAG.DEACdHBBPADAhACA...bDDB.fGHA.hAAA......hABA...,2,-31,-10,21
EVRgQWUeYHDbAfXLJTacCIMGSZBFKOdNP,XDACLFCAaCCF..CBBCGDECBADEKGHDOHDCdBFF.EGHFRGAEQBAEhAAAUBGF.hAAAeEFEDHACbDCBAABE.fBDBhABA........hACA......hADA...,1,-20,-29,9
CADZIHbRaeNJUSQVFfKdYPEOMcTXGBgWL,ZFDGHAADRCAD.eEFEUBGDSADC.QGCFfDDCKAGAhAAAdACGEGFF.MDDGXGAEhAAAGEBFBHEAWCCChACACAEAAEHGIGAC..aCFH....hABA......hAEA...,2,-35,8,43
AVFbBTeMLUDfHOdQEWPgCKIaZGYSXNJcR,VDAGBFEDMAEE.DDGCOFEA.EHAG..PABBCCAC.KBGChAAAICGCGDDBSDBHhACAXABFNDIA.JHFAhADA.AIEG...TFCE.eHEAfBEChAIA.dGCEgAFChAAA,1,-21,-35,14
SIgLABPTQGEUDdFeKMVcWXfOCaJRNbZHY,TGGGGCEBDCDA.FBABMHAC..VFBHXEBB.OBABhAAACEBFREEBZAFASBFEhABA.IDGDhACAAHHFBEHD.QBDD.dFGBcCCC.hADAaGAHJEEFNAAF....hAEA...,1,-14,-27,13
YVgQHZeNfTEAaISBcDMPGOKRJFWXULCdb,aAFBBFED.DCECGDDGKBAC.FDBGUBGEdHAB....VBGDHDBHeAAGhACATGFEAHGE...hADASDADMEIF.hAEAOFFA.RGAEJDDAXGEHCBDC...hAAA......hABA...,1,-16,-29,13
QRTNcKFXZUSPJaGLVfMObYEAHdgeBWCID,HDAGeCCHCFGBDGFA.RADC...TGDHKAAFFHDEZAGDUDDC..SBBFhAAA.JAEHaCGChABALFAAVGAE.MIFEhABA...YEEEAAGCBEGG....hACA......hADA...,2,-31,-26,5
RcAVLKaMUJSZbEeDPWgGBHICfYTNdFXOQ,VDEDLEGH.MDFGSGAGZACG.eBBGDEAC...PAFGhAAAGDDA.BDCBICGAhABACBABTGAE.dGFGhAAAXEAAOBFC.cADAAADGaAGA.bEGD..hACA.WDDF...hABA...,1,-12,-22,10
NGgLEFKOecUaVBdMCbJSWXITfQZYRDHPA,GAFEEDCDFFHF.KHAE.eEGFaEED.BEBD.dBAGCGCG..SBEBhAAA..WEEDTEAGhABAZDCBDEIBAAGCLBHHhACA.OADH.cGGCMBCD...hAAA......hABA...,2,-37,-21,16
PLOeIEYAFRXNWMDSfgCbBHadTKVJcGZQU,XCCBMCCADFGB...SBHHCEBBBHEAHEDFaGHH...KHBEVAEEhAAAGAGCZBAFQEDDhABALADAOFABhAAAEHAAAHEENCAA..fBAAdEGB....hABA......hACA...,1,-2,-29,27
AIgZCeGcYUQEFSWRXBLHVOfbMPKaTJNDd,ZAADGACBUGACFBHFRACB.BDAGHEFE..OHFAMBEC.KGDE..aGCEhAAAJCFBDCFF..dDCEADEDCDGBhAEAeDHD...QFAChAAAEHGGSCCD...WFAEhAFA......hAGA...,1,-25,-28,3
IPNafbWQFYgLeOAGMCVJDKBETcUSXRZHd,MBFHCEFADCBA.BEDC..EFGCUAGA.REAHHFFHdAHA..IBFAhAAAaAAF...fABDhADA.QEADhAEAFHDCYACEgDDFeFHHAIBG.JHEA.hBAAKHBESDGBhBEA...,2,-29,-27,2
ANgTYGOIWLJQRVdMbKcPDSEHBCUafZeXF,TCBCOFEFLCHD.QBCFREFEVAEFMBHHKGADDDEG.hAAASAFDBABHCHHHaEAFhABAZDBH.XGGGhAAAADEBgGDAIBAFdHAB.......hADA......hAEA...,2,-24,-16,8
XaOMbNIHPecADUYLVFWRGTfKJQCBgZdSE,DAFBUDACLBGHFGDHGBGGKDBC...QGGACGFABGDBZAAEEDDA.hAAA.OEDE..hABAbACE..IGAFhACAHFEDcAABAHIB....WFGHfGAEhAAA....hADA...,2,-44,-18,26
faJbRWAEXIGDSeVYZCFQNOdTKHUgMPcLB,XGBCGDCCSFGB.eCABZDEEFBFFOCDGKECBHACHhAAAMAFELAAEBHGHaFGEJBABhABAbBGFABCD..DFFGCFEANEAGhAEAdAHE...........hBBA......hBEA...,2,-24,-10,14
XcYUHgVATZJQGIdOeDBbCWRLMKPFEfNSa,ZADGJDACGECDdGGDeFEBBHDA..CHBDLFAEMCCG.KCEFFAAB.hAAAEGBESABDhACA.aGCCXAFAhACA..YDAAgGGGADIDTBGFIFHDhADA.DIAA.WDDEhAEA...,1,-17,-37,20
aMGKNRBfHOWCZAJeLSgTDUEXYQbIdVPcF,LAABTGBC.EBGAQABEdFAG.VDDFFFGDMACC.KCEGhAGANDGARAEEBEEE.OHEChAHACGAFAHFFSEHHhAAADDIH..XGBFIEAGPCCFaBAH..hAIA......hBAA...,2,-26,-11,15
YAWVcHgTIbQfKdNJCESaXRMBLDZUeOGFP,VAADHAADTAEE.QGDFdECEJADF.EDCFaFEERBGB..MDADhAAADDHFUFAGGEEHFAGBABIB.hACA.gGAAhADA.IGHCfGHGCCDB.....hAEA......hAGA...,2,-41,11,52
SVcJeIAXgGTKBNHbFWQYPLDfCMRZEadOU,XFGHTAGH.BCFAHEFF.FGCGQGAALHFADCEBCACBZBADdCBGhAAAOEDDSADEhABAJAFEADDG.KCFA..NIDF..hACA....WCCFfGAA.MFCEhAGAEFFFaDFE...hAIA...,2,-20,-19,1
NWdDGQOKIeZYHXCLUfaVcEFbATPBgMJSR,BHHGJCHD.RGBCdGFEDGIDGFDF..ODFCeACEZAFDHBACLFADhAAAUBDA..fEADhAAAaDCG.EAGFABHAPBAHhABA.MFCHSGAF.WEEGhABA.....hAFA...,1,-25,-26,1
KXVSNTfcaFQBEdeLgWPIAZGMHbRUJYCDO,MIDAHGFGUAAG.CCDD.DHDGKDFFVFGD..SEAG.hAAA.fBFFhABAaGCCBHBDeAGHgGAHhACAIDBGZCDAGEBD.RABCOAHDXADEhADA.NAIA.....hAEA...,1,-6,-31,25
PEWXBSgFbKAVRHdYNCZUOIMDQefaTGLcJ,RBDBHDAGdGDH.CEFAZBCAUGAD..MEEBDBCH.QAGH.eHEAhAAAfAAG.aBFFhABATGAB.LDGBhABAPFFA.WADCBHHB.SDDDhACA......hADA...,2,-45,-7,38
gJOcTRNUHGWDAIKSMBfYeFPQdbCZLEVXa,KAFBBBGEeCDGFEEFdDBEZFEBLAAC..XBEHJEBE..hAAAODGFTABCUGGFhAEAGGEBABBF.MEAD.hAFAfDGA.QGCACAHCaFCE.hBCA......hBEA...,2,-28,-23,5
LNOJFfBMHGRVCdXeISYKgQUEZDaWPTbcA,LEEGOEEG.JAFEFGDEBGDHHBFE.VABBCHCG..dABA..IHAAhAAASDAFKEAAQGGGhABAECGC.hAAAaFBETGGEAADE.MEBF.XCDAhADAeBDH......hAEA...,2,-38,-9,29
VBINETAKfbXDULcZWRFdQSHMJGPYagOeC,KHBGXCBCLECEZFGF.FBADdGEHHFCAGAFG..aBEDOACEhAAAeBGHCHGEIFAB.hAAAEECFABGDDEBH..WHAEhABASFADMAIF.......hACA......hADA...,2,-29,-18,11
SaZfXDKMLgcQPJFRNWeTEAYUBHVICdGOb,BHHGHGFGCGAFdAHEGADAOABH..SEGFZEEGDBFA.KABCLECHhAAAQAFEFGAH.NCICeFDBhAAAAIFE....hAFA..YDCCIDBFaFGE...fACHhACAMIAE..hAFA...,2,-43,-3,40
KdRWQaNHYJbOGCBfcFVIDMZAgPeXSLUET,eGEAXGGDLCFAUCBB.KGBG.dEFDQGBBHADH.JCFBODDBhAAABAEC.FFAGDGFHMABFhACAZAGHAEHASCCFhADA..EACF........hAAA.WCEFNIAF...hAFA...,1,-15,-30,15
KNcLRUafTgeIGCPdFEZMWYDABSXVOHQbJ,BFCFVBCF.QADE.KFDBNDGGLHACUFGB..TCAAhAAAIEBAGBGCCAABdAEHhACA.FEEBEDDE.MIEChABADIGAABIFOHAE..JEHFaAGA.fBBBhACA....hADA...,1,-15,-29,14
aMGdJKeEZVYIcDCBfHUXRWPNSTbQgOAFL,FEEDMEGFGAAFKCAAZCGF....IHEFDBEECFAD.BBHAHFCFUFBAhAAARACB...NDAE.SEDBhAAA.TCEAhABAbDGHQCEDAIHAaEAA.....hACA......hAEA...,1,-25,-28,3
WOgGPBMYKSaDcZUdfHXAQVLTJENIeFCRb,VADGLFCA.ECCHeCGFFGHH.RCCH..OBAFGDEB.BBGHKAGEDHEAhAAAZADHUAAFHFFCAGCFJFABhABACEEB......hAFA.WHDEMDAH.aABFfAFF.hADA......hBAA...,2,-21,-17,4
McNRVQbSIdDBFJXfGHTWZCAKgUeLOPYEa,UGBCOAABEFGE..aCFCMAAC..RECFQEGBSCFAdBEBhAEAFCBG..JHEEXDBFhAFAGAEFHFABTEDCCDDBAIHEhABAKGAF...LHEA....hAGA......hAHA...,2,-20,-11,9
RUCFKSgdVQfeYIcDOEGBNTMAHXZaPJLWb,XBBHZDAGaGEB.LAAEREFB..CHHBKCDESHCE.VEBAhAEAfGAF.hAFAeDFEIGHEDACBOAAFhAAAEAFFGAGEBADCMBFAAIBAPFFD..hAIA......hBBA...,1,-16,-28,12
dXDEaJHPASYOBKNCGLbTVMIQRfFeZgcUW,OCCHKEGDCFCG.GBFGLHAE..bDDDMAFA..QGGBhAAARABDeDBAZBFCUABFdEHEDFFHhAAAEEHFaAHD.HEABhACAAIBASDADBHBA...NEEE.IAEFhAGA.FHEC...hABA...,1,14,-28,42
PDabdUKXOgEFVSfZWMcJHeBNTLAICGRQY,CECDRCDFQBACDGHF.dDGCXFEB..EEADSEBDhAAAZFCFMBECJFHBBBBE.NBIC.hABAADCD.GAFAaCHDUGAFhAAA.KFEBgACB.fHBFhAEA.....hABA...,2,-29,-15,14
VHceNaGLbBQKRfOZDgWASYCXTFMEIdUJP,CFEDXFCAFAEF..EBHFdDCF.UGFE..JCAEHGAA.eAAChAAAaDBELEHHBAGBRADEODFChAFADHBAAGAA..SCFHhAAAMCBB...IACE..hABA.cGFB.NIAF.hAGA...,2,-48,-14,34
WMFRUQIVXcKeCbLODGTNaBESHAJYgPfdZ,JGEA..gDACdFACZAEG.MDDHRCEA.UGFBQDBB.hAAA.IHCG.hAAAcCFDeABALEEGhABADGIDGBCDNDIGBCCFEBAAHFADACHC.fEGFhABA.WAHBXFCHhACACADC,2,-27,-16,11
aVXgNMUWbZBDHECRJcIGdTOLFYQfKeSPA,XCCBMCCAUDBAZAADHGAG..CHEARBEHJGFGGGAH....hAAA......hADA......hAEA.TFGAFDGCfAGHSEGEaABE.hAFANFEBBDEEcAGC.IEBHhAHA,1,-26,-52,26
PIZcYeBUREOGCbJaXgQMSDTAdHKVWNFfL,dEHAKDAF...VAACFHACLCEFZBEE.eBFHUFEFRAAC.GEBEhAAACHHG.JAEE..aHDAXDDAhADAMDID.DIDAACDH.hAAA...NCHA.IEAGBFAH....hAEA......hAIA...,1,-24,-32,8
cNKfbEIPdZQMTFYaBRegXUDACHWVLSGOJ,HDBHVFDF.LCAFGEAA.OABC.JEEGKCEF.EHGA.PCAChAAAdBGHZFGB.QGAGhAAAFAHDBAFAeABAUGDGCDDBhABASFFE.fCFB.hADAMDIB....hABA...,1,-6,-19,13
XQAcCeMFVBbfODUWIdTPSaRGJLEYHNZgK,CAFBFFAGBAACOEDC..DACCUGDHdBBH...SHGARFBFLFGDhAHAEBHHHFDF.ZBFGKCEAhAAAAEDA.MBEE.fDBBhABA.IBBAaBDDYDFG.hACA......hADA.XEGF.,2,-31,-23,8
QKXCWAacRSOeFBHIZVbgJMULPGdYEfTND,aCFCRDAGOFDABFHGZFBD....VADCJEDCLABDGGAHdHGD.hAAAEAAF..TADFhADADEEGKGGCCAHFAAFEeCBG.FAGAhAAAbGEC...MIFE......hBAA......hBCA...,2,-31,-11,20
CEHbFMWPXIKAcadVLYDgUZSGRONTJQfBe,aAFBdDBDLDFC.DGCFZEBFGAEFNBGG.QFGAeBACCAHHEFDEhAAAFHEE...MDABhAAAXGGHAAHE.VCCEhABAYBAGSHDAOFCA.....hACA......hADA...,2,-25,-15,10
MAHYKXQGLgBWcDCeVJdNaRTIFPESZfObU,HDAGXGBCQFDGLCFGBBHG.DEIDCCCFJCAFaAAB..IHFGhACAEFFDZABE..OECAhAAAUGAGAGGCKEHBGBBDhADA.gDGFcAGD......hAEA......hAFA.dBFA.,1,-5,-24,19
CNFdLPXTVBUQAIgODbMRcfaWeSYHJEKZG,OGEAMCHFRCCC...aCABSGFAHFABJCEA.EBFCZABB..CFFBFGADhAAAdEFFLAFE.hABAXDCEBADEQABDhAFAIAAADFIDcGDCeHCA....hAEA......hBDA...,1,-12,-28,16
QCBMTbfYZEHUXFLegPOVIWDcSAGdKJaRN,KDAFJDCH.RAAB...QAEACBHEBCDC.MIDE..TGFG.hAAA.bEGBZFDBUFEHXGAHhAAAFCAFeAHD.ODDAhABAIBFDDBBEAIHAaDFGNEAE.EACA...gDGAhACA..hAFA...,2,-39,-11,28
aODSANbYdcPIBEKZMeCQUgFfLHGRJWVTX,...bCAAdHBH.ICDGKEFEZCEG..MBBGCAEHUDGF..FFCBLEAAhAAAHFGDJBEETCAHhABA...OFHHhACADIEGAICANAAF..........hAFA......hAGA...,2,-37,-27,10
QTPVRbcdBZDGOfNAIKCULEWaeMHYJXFgS,CFEDUGGDLCAFEGCE..eFADMBHHHACG.JDFEFGBA.QDBBhAAATEDB.RABEdDFGBCAHhAAADGGCODAEABID.IBGFhABAKHFCaGAH.........hABA......hADA...,2,-25,-15,10
TUHdWVOMbDYIBZaCQREFcGSPgAeLJfKXN,JAABXGBC.UABEdGCGODFH.DECEBCFH.ZEEDCCDC.EAFAhAAAFEABSFAChAEA.AGIBeDDFfGGFhAAAKHFGTEGAHBGFMBDE..IDBGhAFA.....hACA...,2,-45,-14,31
XAaMRNbGBCOQIdTKJFWPLeEZHDVcgYSUf,MFCFRAADGAECBEGHOEAHdAGF..KDFFFFGHLDBEZEDFHACDDIGA.hAAA.VCGF..gGDEhAAASHBEXAEHhABAAIHA.aBBA.CGGE......hACA......hAEA...,2,-33,-13,20
HBGCQOcAdUWfXTMIPDbZLJYESNeRKFgaV,UGBCXCBCMFCEDFGBZAED..LHFA.JAEESBADhAAA.NEAH.eABAKFHHFHFGhABAaDEBBHDGGAGEOAHFhAAA.AGCEfDFFPCBG...hACA......hADA...,1,-24,-30,6
HADadRcgGICQLTBOXWfNYZMUeFPSVJEKb,dGCDRAADGAECCGFELAFEBAHG..OHDA..XDAF.hAAA.NEIGMGDCeCFBPECAhAAASEBBEBACKFHBhABAAIAAaDDB...ICHGWHBG..ZBGFFEFEhACA......hADA...,1,-16,-28,12
YSgDXQaHGIWTLZMcdeRJfCBENUFVPbKOA,SHBGDAFBQGDDGDEH..TCAGMBCCeFFDRABA.CFDFEAGHhAAAFDEEVAGF.KHGGhAAAACCBXEAAHDCBIFGDhABA..........hACA......hAEA...,2,-26,-15,11
aMBDOQJCPXKEeWZGfbYUAdSRNILcVgTHF,dEHASCFCRCCGLAAF..VGAEHGAGMCBGDEBGJGDC..PGFEhAAAKBGH..EFACeEEAhABA.GDBB.hACAbAFEACBANBBDIACF......hAEA......hAFA...,2,-27,-15,12
RTDJeLBOUaWYGdgMENQCfKcFISbAXHPVZ,HEFHVGFG.RCEADAIHLHBABAGC.UBFC..aABDGADCdEAEMEEFhAAAEBAEQDBDhAAA.CDACKEFEIFCAhABAAFAD.XBDC.PHBC...hABA......hACA...,2,-23,-17,6
URHcLVJOAZCEMbGgNKYXIfeWDTBSFQdaP,EBBDGBGAKEDE...IGBGeDADDGADSFDGdBHA.aACGRFDCHGFGhAAALECE.OADEhAAAABEACACBMCEE..hABAbBBC.NIBF.fDFBBGGD.QGBHhAEA....hAFA...,2,-18,-12,6
OWcbZMAGaECBLJeDXFUHNfPdTSIRVgYQK,EDAFCEFABBHELDDG.DGGDFDDEHAGH....fAEHhAAAdGCDICEFRGBA.VAAEhAAAQEACKFHH.OHFGhABAcGACZBDCMADEAACFaEGD.eBBBNFBF..hADA......hAEA...,1,-5,-27,22
AHDGJLYMWZeIBabPTQdNXOVgRKFEcSCfU,DCHDLHDAMFFFZDBGeDEH.BAFE.aCEBTGAA..NCAA.XBBGhAAA.OAEGhABA.RFCB.EHAE.cBCBhAAACCFDAACC.JFHB.YBGBIGGAQFBBhABA...hAIA...,2,-35,-18,17
FWAaSMKVRXYCefTGgUJZBbQLIHEcNdPOD,MIAGVBCF.RCAD...CDAC.eAGFGAFEUDCEBEBCLFGDHEFCEHDGhAAAdAAFDHDAAACA..KFADXAEBhADA..fFDDhABA........hAEA......hAFA...,1,-28,-29,1
HQVFNWTSKAICEJUBRGDLbeXcdZPYaOfgM,EEGDUGDEGBAEDACGLBAEeAEG..XECAZBFB..aGGC.hAAA.gGAGhABAMCCF.HGDGFCHHNFDHWDEEhACA.TACHSBDHAHHF.IGAGhAAA......hABA...,1,4,-38,42
OGIFNWECXLMcQBfUSPVARTHeDdbaZgJKY,TBBHeAGHDHEG.dAABZAFD.KFGCOEEEGDDAFGABEFAC..LADBhAFAMACEBBEGUGGESBHHhAAAADBDRDBF.aHBEhABA.....gGGGIDHGNIBFCHEA.hAIA......hBAA...,1,-16,-24,8
KdJTUEeIQMHBGNFfbZYPcOCVLRaWgXSAD,dGCDJDCH.EBED..QAFABDCCFGGEZEFG....PFEChAAACBCCLEAHaBBG..XFAChABAADACDAIHKAFHeHFGhACA.MCCC.NCIGfDAEcDCD.OHBAhADA.WEEEgAAFhAAA,2,-39,-28,11
bEWYCcBMRFHPKdXgALJUaONVDefTIGZQS,LFCAUAADOADFDBFGeBBB..TGFBZFAHSDDAhAAA.EHGEWGBC.CDACBHDChABAMDHHFADDHAFFPHCAhABAXDEDAAGANAIA......fCAEhACAIDCA...hADA...,1,-9,-39,30
cSdBVTaPGZWHeEOUFCXQJfbAMINgYDLRK,MCCA..gEDCLFAGKAAFdAAGBEABaHGE.GGCFZBFDeDHDhABAEHGAFBHD.CADCJFAFhACAABIDIDDG.DADEhACASBBH..TFFCWDDC.OHCAhAGA....hAHA...,2,-26,-20,6
HMcCSLIfZaFWbJeUOAdVDgKXBTQGPENYR,VFFADGHHKACG.BEAAGADC..EAACRAACHDAC.CAHCLFEDhAAAZGDEaDDA.FCGC.JFABOCFAhAAAADAC.dAGF.XDFDhAEA.TFBE...NEIE.MFDFhABASCCF.hADA...,1,-13,-28,15
LFGSOYdKaUeAQEVXPDRfHZWNIbMTBCcgJ,VBCFXAFB.DGFDRDFFZGCE....NBAE.MCFEBCCHCDAH...hAAAJECFLFADGBEEOEHHhAAAKABD.aHCEAIFAEFBHhACA...PADAWCHB...IGHEhAHAcBBB....hAIA...,1,-27,-31,4
PAWdgLSZecbKfCTMBEXYIURVOQFaHJGDN,dHBHSDCDZCADeFDCKFGF..CBGEBECDECAF..XCGHUAEGRABE.hAAAOEEF.aGDDGGEBhABADBFCAEBF.LAHBhADAfABGMDDEVGAG......hAAA......hACA...,1,-15,-30,15
UgKaCbQcPLJXTHYOARSZVIWdeDGBNMFfE,SDAFZGFG..IABBdDFGDAIDBFHGMDAEFBGEEDCBUGAEhAAAKCED..CFBA.QGEGhABALFAD.JBCGXFCHhAAA.HEFEACAE.......hACA......hADA...,2,-34,-27,7
cJKQVEHXTDAFaCbBOLINUYgSePGfdMZRW,FEHBCFEDBECALGBG.UCDASCADGAEHdFDBZGDARBGF..JABHhAAAKEEE..EDBBTGAEhAAADFAF..AHHFaGFDbBDG.hABA.....NEIAeABHfCGF.hADA.MAFE...hACA...,2,-26,-19,7
HOLCPQfaFdNSMDUZgEXYAWBGbcKReVTJI,BECDGAFEKBFHeGFG.JBBCOCAH.CAAA.QEBD.hAAAFDEHSEEHhACADIAC.ZGFGEAHBAIBEbBDFcDABhAAA....VDGHIHEE..hABALGAAfDHChACAaBCHMAIF.,2,-25,-15,10
eGLVSZWTcBMEHKOJdbRYDAFaQUNICgPXf,aFAAQCGC.UECFCCDB..XAGEeAACLBCCZFEGTAAChAAAMEIDHDBGKFAFJFGBhAAAdGAC.RGBA.DGIFAGFD.FGCD.hAEANACF.ICDH..fEFFhAHA......hBDA...,2,-18,-12,6
gMYbTVfZJcWdEQKSABHeOFGaUIRCXDPNL,BEFAOFFCGDCCUAFC.RBACDEIDLHFE.MDCFTBEH.ZAGFhAAAJEAFdDADKFDBHFAFeBDHhAAAFHFA.CFGA...PBAGhABANABF..........hACA......hADA...,1,-11,-30,19
TNScfEZGRPaYOIVbKDdCgXAHMFUQeJBLW,FAABUDCHQEDGeHCABAACLBDC..TBFDSHGEhACAEBDFZDAFREABaDHF.IHCEhADAKGHDCDHAABIFMEADhACAJCFF....WHEGfBBF.YDFFhADAOCBFDAIB.hAEA...,1,-7,-32,25
bDRfCJSdTFQYUgAELGaIPXMWBOVKHZceN,EHAEGAEG.aAACXBEEBDDA..ODABVBAGZEFF.eFDFhAAADAIBRCGF.JGBGSEADhABA.FEHFUFGHhABAAFBE.LCCDMFFBKADANIEBCCAB.....hACA......hADA...,1,-15,-18,3
ZYeJSKBaLGIdNAWVRDHPbcOQgTMXCUEfF,VGFGHBCF....bBFHOCAA.QFDGMABDCGFCEBEBZADCJFBFhAAABDEHLAFCdFACACECDIBAhAAA..PHFChACATCGE...........hADA.XEGA.hABA...,2,-32,-7,25
JYLFUPTGdQXbZNVWBfHCODcaSeEKgIMRA,JEEGFDCDUGEGGDAA..dAFEQBCDZEEA..VABDBHFBHEABhAAACHDFDAEA..aGHDSCHBhAAA.KABEhAHAIHCEMDDFAAIH...YAHF.hBAA......hBBA...,2,-35,-23,12
SNCIbQZFEMeXWHODGRLfcAKPTdgUJaYBV,TGBCUGBC..JBDDaGHHBGFD..VBAB..CAHG.QFEBhAAAEEHB.MEIFeHDGhAAAHDDCOCFBDBIDLAEEhABAAABF.KBGFPEAEdHED...SADEhACA.ICBFhAGA,1,-7,-43,36
WIOCJDHKfcgGFdTYXERAPeQLaVUMSBNbZ,eDACQGGDLECCUDACMBGHBABCZFGHOAEBCGAF..DHCCKDCGhAAA....cABDhAAAgGAF.FEFAhADAYBHFXFDBAIAA.aCHFSADHhABA......hACA...,2,-33,-22,11
bZJFSVTDAEIPKXOBRLGdeWNCgYQaHfUMc,EHBGKHBGBDBFREAC.GEFCeACH..CEEC.QFBDHAEGMIFAZBCFFCADhAAA..SFEFhAAADAIFAABB.XAGBhABAOEGBLDHBNCAE..aBFH....hACA......hADA...,1,-14,-26,12
CVZAePMfSdWEFHTRXQBaJGbDKNcLIYOgU,MDEBSAFBdFBHFDAARCFCBGGC..JABAGCCG.KABDLCFChAAAOEAH.CHHGAAEEeFEDhAAA....fGEAhAGAEADDXFBDaHAADFIBNIAD.....hACA......hAEA...,2,-41,-22,19
OVPYZCbfBNGaKQHASXeEUJIMDFdcWTRLg,SGDDXGGDUCBBMAID..FGDEdCCB...TGEBLDFGhAAAOBAGPABGCEEEBHHEhAAAaAHDKAEGHEAEeCEEhAGAEGBHDEGE.RAEC.........hABA......hACA...,1,-14,-21,7
gRZFcSXaQDMABdJTNYWGIUOHVCebLEKfP,JCAFTCBC......NCCAGGBBOEGHHBEC.CAHBeADChAAAEEEH.PEEHRAFEZDFBSDDFhAAAQFBHMIEEhABABABE.dCACIHGE....hADA......hAEA...,2,-33,-2,31
cfeMLPgBQRNTEVHdIFWDbYKJaXSCGUOZA,eGEALCHDBDDGREDHEBACdDGCFBDE..DDBCKGAF..aBEGCHBHGBAChAAAUGGHAAEG...MAEAhABAQCEA.TGAAhAAAIBGF..bDAG.....hACA......hADA...,2,-40,-15,25
FNcEXeLaUMGTYdKAWBJfPbCVZDOgSRHIQ,BAFBJGEA.....fECGCCEHZAAFOCGDSBAE.hACARDDCHFGDFHBAEEEELCDChAAAMAFG.GEAEhABAdEBEKAEFACAFPAHFDDDD.IHDF..hACANDAC......hADA...,1,-14,-36,22
UILfaRJNTSAXYHZBCPbWdEKVGQFDgOcMe,HEFHCDCF...bBABdGCH.EBBGKCFCQGFGDCCC.OBFChAAAeDDBLADA.hABAfFAHJEEASDADhACAAIGCYHBABHAGWFHHFFHD....hADA......hAEA...,1,-12,-35,23
QDEMaZHFWXBgKJbCVYSNIdTGROfPULeAc,QAFBMBHHZBAGHEEHFDEEBBDDKAFH.CFGG.SHGA.dAEGhAAARGAEOBBF.fFCFhAAAPDAEeHAAhABAAHECDBAHEEHF.aGDFXEAC....hABA......hACA...,2,-39,-7,32
GAbHIcQNFJCZVLPfXSeRTdaBODgMUWKYE,HAADQCBCJFBGZEGBLHDE.XDFGeAFERADB..TGDBhAAAaGBGOAHB.MDEBhAAAKCCFEDABACIF.ICHFhACAcACACGGE.PAFDSEEBDIAGWEAGhABA......hAEA...,1,-12,-20,8
JXAEFbgBGCSMQZHaVdcKeRLfPNOIYUWDT,EAFBFHBGBEDCGGAF.MEEGHFDD.aAFEdAADKCECeDBC.RFFELAGBhABA..PCADhAAANIDBOFCAICCGhABA.UFFEDDAB.JABEAAIBCBCAQCGA.hADA......hAEA...,1,-6,-19,13
PVBXHKfQWCSRZdOYMcEUbeGNaJIFTADLg,DEFHLGEA.VDCBHDAC.QDGC.CCAHRACAZADGdGBCMCHBhAAAEGHF.bBAFGGCFhAAAJHBAFFABAEEH....PAFAhABA..........hACA......hADA...,1,-14,-27,13
QFUEMLBXAKIYJHdGCSceRWNTVZODfgaPb,KHBGJGEAGCDFCCDA..eABBRFAB...TGFGVABAZECF.DIGEhAAAaCAF...QCGDhAAAFEFEMICG.BAFEhACAAHAHHAFEdEEGSEBH.cAEChADAOBABfEHEhAHA...,2,-35,-11,24
JVHgadWBXKQecDbGfUPCITNOMZRLAEYFS,EAFBFAFB..SCHFHEACdDECBGHEKBBG.QBBGeDBHDFDCGGCDhAAAfAGDUGGECGFG.hAAA..IHAEhABANIEFMABGLCHFADAHJDDE.......hACA......hADA...,1,-8,-25,17
FWBRQTegZfOcGUSYLdHJAPVIDEXNbCKaM,VAADDGHHEACG....XDBACBFDKDGE.MCFAFFDBBAHE..hAAAQGDBeFABZBAC.hABAfADBOEAG.hAEAUEEHLHCAdFABAGBHIAHAbFFB.aGHBhAAA......hACA...,1,-22,-23,1
TOHYRcMKBCEQGDAILPdUJFbWXVNSagfZe,LGEAUGBCFBCB.XBAD..SFGGaDDG.ZBFBOFAGhAAAHEDHRDAEKACDEDHBDDIFhABAAGAB.dAGE.JEEAbADFNIAF.hADA....fBAA...hAEA......hAFA...,2,-27,-20,7
AVRZSKgBNMDeILJQXPGOaEUYTCbWcHfdF,RBDBZFEEKCGABBHC.DECFeAFGLFDD..QGEAGDEFEBAGhAAATDAD.CBBE.bADFhABAHEGD.FFCH.SABEhAAAMFBFIHHC.....hAEA......hAHA...,1,-23,-24,1
IWCKeVfSLaFMBgXdYEZJGDQNcUROTAbPH,HAADCFDGKBFH.VFDELABGFAFA.BAHAdDCDEADBGEFA..DDHBQCAFhAAAUFBE.OHCAhACAAAIFIHGE.hADA.fFAGSEAFMCIH.gDDDhAFA...hAAA...,2,-27,-18,9
MPFWTXdKaQeUZEADIRbCSgHNVOfJcGYLB,RFDGSEGDHDAEOABG..JDBDGBBDBDAFMCBCFDFB..TAGHhAAAdAGHaFHDUGAEEGCF.hAAADHGA.CHED...VDDFhABA...YACAWDHB.KHEA.QCGEhAEA.AHAE.hAFA...,1,-11,-22,11
PMeFUfTcVbEYQgCJRINDGOWAHZBaLSKdX,ZFGHLCAFSEAFdCFGMAIFUGDE..TDCG..bABEEAAChAAAQDDCCGDG.hADAIHBEDHGGOFFAhAEAADHEBCAHaHAGKBDBXBGG.....hAFA......hAGA...,1,-22,-24,2
IaXQGAUTdcMJDFgbLfNPRVYKZOeECSHBW,UFCAdGFCMCACFDBCLAFH..fAAFRACA.KAFFOBHHhAAAEGAGHDEEBGFHaHAChAAAXEEBQECGhADAABIH............hAEA......hAGA...,2,-42,-24,18
VWNHCJOgAIQGTFaZRbSBDMefUYKPLEdXc,QFGHTECB.FDFGZGDERGAG.SACBBAFEDDIF.eCEB.UEAGhAAAKAAFECBFdAFCXBAFhABA..WADHhABACAHFOBHF.IEGC....hAEA......hBEA...,2,-44,-15,29
fFVULcbdgeBAXNQWYCGTEZPHIaDMJSKOR,XCGCQCBC.CFGCGGDFEAEAZEEHHBBFDCAF.MDAFKEEFOCFEhAAAFFCHLAAE.dAHAhAEABHAHAGBH.NABFTBDEhAGA...aGCHSGGB.fEGFhBBA..hBGA...,1,-16,-22,6
ERAdWacTKSMHBUDXQbgJOeYGFNCfZPIVL,dAFBaHBG.KHGEHCCCBBADDGFC..QEGHJBGH..eFBAGCDFhAAAFBBACHFAZGCG.IECAhABAEEAGAICA....hACAWAFCcDAG.MGBA.....hAAA......hABA...,1,-22,-36,14
eRZSLEDYJOBaXUVfdKWMgFAHPNIbTQGcC,HAAD..IAAFbEEDGDBGeCCHRAEHZEGHEAFADGEF..OEAHhAAAaADFUCGCdBHAMIFEhACAAHGA..TFAG.hADACCAD.SCCBJFFABCBEfEDFhACA......hAFA...,1,3,-28,31
ObRaKVHfMDTLFBEXCPAINZJcdSYQGWUge,ZAADdDCDSGCEGCCCUCGC..OHFEaFAFHAEADADGLCAFhAAABAHBCGFD.ABGE..IEFGhABANFEB...JCHDhACA.QGACeACFKGGCMIDAEBDG..cBBAhAGA....hAHA...,1,-14,-25,11
YUDSQRJMKZPNCaFIWTEAeGcgbfXLVHdOB,GECF..gCCBfDGBVEBFODAG.BBHGDABHQEFChAAAMIBEKACGZBBAhAAACAGHaHEEFFGE..IFABhABAEADEAHDBeFHF.XCACHGEA.YFAFhACA....hAFA...,1,-7,-24,17
SJXLaKefCVADcYMFUTWdNPRQBOgGIHEZb,DACBMCCAFCEEUDBA..dEECREEDBDAGGDAAHAFAZDGD...JABAaDCFhAAA.KADCCDGG..AHGA..hABA.....YHCEhAGANIEBOCHFIHHEEHCA...XAGAhAHA...hAAA.fFAE.,2,-27,-26,1
NgbSDHWdMaKRcZFUeQVOICXPJYEAfTLGB,TDACBDHB....NGAD.SEEDDAFEHGFE.MIAGKCDAZAAHeCHBhAAA.QDFHhABAOEEACHBE.XBCF.hACA...YBECEHGGAGAA.fACFhAIA.....hACA...,1,-25,-33,8
MbVgOfJBTWaFPISQDCKELAUedGcZHRNXY,UGGDdAEGZGFEREAB...XDDFMDCE....VADCOBHHBHDHhAAAaFBCFDGD..SCBBhAAADAHBKBAF.ABBE.eFEBhABA..cFEB......hABA.NDAG.....hACA...,1,-34,-38,4
cQKYEWBOLRSJPgbMCNVHTZfIUaFeXGDAd,QGBCKAFBEBCC.BHDHOCGDRADB..SAADJFED..hABAPEAFMFFHCHGGHCDAhAAAZCAEUBFGeFCDDABBAAHGdEGAhACA....cGGH...WAHBhACA......hADA...,1,-20,-32,12
HZdMSELFBWOPNcXRKCTgAfVUaDJGIeQbY,UFDHJEACGGAHQEAAHBCGZGFEdCDEEHAEFAGA..BFAG..PCHDhAAA..cDGDhAAAKACETAEF.fBAGhABADADA........hAGA......hAHA.IGGCeDEC,1,-13,-24,11
aDYOEBcLUZgeJCPVFIHAKRNWbQXMdSGTf,KCFCRAAD....bGDGXBAD.MEEDdFFHSDDChAAAGACCaGGE.OBFABHBELAEEhAAAgACGJDHBCCGDFFAChADAAGFA...NEIA........hABA......hACA...,2,-32,-18,14
NFCXdVOUeAHMaKGQcYILbJTZgBSEDPRfW,aAABGBDB.QFEE..YECELEEC.JCBHTEFDhACABHBDDFABRFAENDBD.FADGhAAA.dGGEOHDAABBCMEIFhABAIHHA.bAFESDDFEADH.hADAfGDE.hAFACGBB...,2,-26,-11,15
fNbdWcOMSEYQgLKHIJPTBUDaRCeAGZXFV,ZCDFVBCF....NEIC.dFCF.OHDEMCGHEEAFQGGE.hAAALAFCIGBDTDAFhAAABCABaHDECDGBAFGF.XADEhABAFGBH.fAHGcABB.SDHFhACA.KGGF.hABAPCCBDEEE,2,-20,-20,0
DIcBSLGZXOHbgEKCNARPfUdMYJTaWQVeF,RAADUCBCdFBB.MIFA..TADBQAGEeAHH.FFEGDDCABAEFGGCBhAAAZFCF.HFFCEAAEKGAEhACACAGBAACC....fEEBhAFAJEHB..WBFD.....hBCA......hBGA...,1,-18,-24,6
YVAReMTUDXgBZPHFfNcJLCbEaQIOdSGKW,MAGDUGCEDFFFBADGHACCFFCE.......NBACLBGBhAAAEDDEIBBCOCCBGGEFhAAAKGGG.....YFABhABAAAGEeFAF.........hABA......hACA...,2,-38,-31,7
bDYBdTOSLCUHMXPKgGNAaeEfIZcFVWJRQ,aEEDEDCDZEGB..VGAGJBFB...RAAFDDIDBGEA.OHAGLAFGhAAAHACAMEHBKEAA.GCCBhACAAEEH..eAAFfEABhADA.FGFDbAGB......hAAA......hACA...,1,-12,-29,17
DOZPXRFbTGUcMaKedNgHVEIYCWBAQSJLf,QGGDJFFBLAFCDCFCZFCDRFAH...FEBGTDBEGBGE.UBCEhAAAMABE.eCCGdBAA.NEEH.hAAA.....gAEChAHAEHGACEEBABGDOEAHPGDA....hAIA......hBAA...,2,-19,-18,1
RgULSXKGPOeCAcFVDWQdbMNaJBZYITEfH,FCFCDHCEQAFEMFBE..aDBAZEEC.TBBGEFHDRABE..LFFDhAAAKFAAOGDAAIBA..hAAA...WEAENDAEBGBAhABAIHHDfGGEgCFGSDGAhADAPACA....hABA.CBHB..,1,-20,-29,9
ZHCIDRXOTdMKgPEVcJLfaQBFbSNUGWAeY,eFBBZGFGHAAADEFFRACDTFAE..MAEEKEGCEEDF..JEDDaCECBHGHhAAAFDAE...SCAAhABANACF..WHAGhAAAADECIBHG.dGGBPFEC..hAHAcCFA...hAIA...,2,-34,-18,16
bAHOUCcXJNdgZQIKVMPBfTaESLRYDWFGe,OBDGCHHG..JFABdGHGZBBAQCFC.KHEEVFDABDEF.hAAAaEAFSDFBhABA.RDBGDDIHFABGeHBEhAAAACGCHAEAcDCC.NAIA.MDHB..fFFFhAEA...hACA...,1,-19,-32,13
bYfOETJNUZGSeDBadRVcMFPWCHXAQgKIL,KGFCLGEA..bACGfGBB.OADHTCDGJAAFZDAAhAAAGEEBSBGEhABABGADaEAERFAAMDIB..hADAWDECCEFCAAHCIHCA.EHEENAEFDBEA.hAEA......hAFA...,2,-18,-18,0
gfRaUcPVLZOBSHEIJKMCeTNWQdDYbXFAG,GAFERAADUGGE...PHFGZADBBCGG.HGBGEAACKBDB.eFFAhAAATDBDQFBHhADA.DDBGXFEBhAAAAAFBaFEBLEACIAHHCAHCNIBFWBFD...YDAFhACA...hAEA...,1,-8,-21,13
MLVIPGJEXBQYSedHUZARFcTKDgfaObNWC,RDAGTGBCKGHD..DEEAaBFG.....NDIG.MAACLADF.hAEAVAAFGBCD.JGBAhAFAEHEAXAGABDEHSGGHhAAAdGFA.UEBFAHAD.FEGB...hAGA......hAHA...,2,-38,-6,32
OAICYKHdcXVRSUNBEWTFMeLDPaQgfGbJZ,CFDGKCFCHAEAdFHG...XDEBREEDUFBHBACGEDCG..FCAGLAEGhAAADICA..aBBAQCCBhABAGEACZGFAAGEB.ICHFhAAA..cDAFSEHF.hADA.NIEHMBID..hAFA...,1,-8,-34,26
UeCEVXAbYaBHfMPdLSOJFNGQRZDIgKcWT,aHBGHDBH.MDAFdACGLBEFJGEA..FDHFGEFCQGCDhAAADFIDIFDE.KCGEhAAATBDGCHEG.XABGhACAABADBGAC..SDBD.NAEF.RBFF.hADA......hAEA...,2,-26,-19,7
WBCLIcVDHbfdNRgFaUZeXYQJSMTEOKPGA,CBBDLGEA.VDCBHECB.bAGFdBEGRFFE.FBAEUADC..eFAFhAAAXCACJHBA.MEFChAAATCGCKGBD..ACIBBEEDhABADDAF..NABBaFGG.......hACA......hBAA...,2,-21,-17,4
XYEOBRUDcJGQWgeMCSFfKHZTIPLdNVbaA,EGFCOFCARCCE.DCBHGEAA..QABFeBCECCAD.SGCDhAAAKEFGHAFA.IHGEhACAdHCBNAAF.aAFEAGIH.XDGChAEA.BCEF.JFAFMIFEFFHFfHDBhAFA...hAFA...,2,-18,-12,6
UNMRGYZgBCXeAaPWFVcDEbfQJdHLTOSKI,aHBGFHBGDCCA..EDAEQEEDdEGFLDEH.OAFAKAGEUEBHhAAARABH....YDCBhAAAgAEG.BGHAhABACGGEAGIB.VCGF...fABAhADAHBFA......hAFA...,1,-13,-35,22
CAfeTESJXZODNYIMBKgVRFGLUQWPcHbda,eDACEFHB..SDDFJFGHZFBH.OEEGDEFG...IFBBhAAABGAEKAFGRGCALBDEhABAUABHQFDBWAHD.hACA.PBBF.cGFAbCECaAHDAAFA...hADA......hAEA...,2,-31,-16,15
RAOcYHbVUJCdKFXMeIZaLENgPQGfSBDTW,OGEAHAADUDGGdAEDKAAFFEBA..eADBZDEALHCEEGEE..PAFChAAAGDAG.BFDChABADICCTFACADAD..hACAYBCD.JAHBCHGAICCF.hACA......hADA...,2,-27,-13,14
ILSZQGaJBCEfVdUAHcPRODTFWKMYNbXge,HAADRAADDFCG.FFEAKACBMACC.....NIED.bAFA..eEHBSFFAhAAAQFBDJHCG.hACABDDH.EAFCdGAAACHDOCDAhAAATCEDXDGA...IEAFhAEA...hAIA...,1,-21,-27,6
gGAJDRFEQbdXHLYeWMNPSafBOcKVTCUZI,DAADRFEEQAEFdFBFLADG..eFABMIBESHFABEAFOBHFhABAVCDB.UDGEZCEFGEGChACAADAHFBBC.EDCAXDBDhAAA.YGCANHBFfBBEKAHF.hABACCGD......hACA...,2,-15,-7,8
JSLcNQWEHMATZbgBeCXUGIVOPFDdRYfKa,ZEFHBFDGCBCEGEAHOBADDECC..RBGDKGAD..SAFChAAA.LDHHNIEHEBECABAG.hAAATGEG..eCAEhABAUCFE.IACCFGDE.dGBC.fCCDhABA...hACA...,2,-28,-27,1
JeGOUBNaZKMAbSYTDXWHdfgIQLFECRcPV,SHBGTAFB.DHEGHEAG.dBBAIEGFFHGECHAEREFB...VFBEhAAAeHCA..OCEAhABABDHDaDDGMBBFACAB.XGGBhACA.fDCD.gACFhAFA.LAHBhAGA.,2,-30,-23,7
TBAKLPNbSCDMcfeVaFJgRIWUQXEOGYHdZ,LCCH..bDEGDEIBMGCEeACCFBDERBFAUEEC..XAGChAAAEBAH.OBBHhABAHGAAdHEDBEADAEBB.NDIACHGG.hAAA....fHDB...hABA......hACA...,1,-24,-30,6
gFJETYOeKNIaPdWDBCcXARSGLZUfbHVMQ,SBBDGGDHLCGFZBEEUDFBHDBH.MBDEFEAF.TAAFeDCFKGHHhAAAIFABdADHDGFBBFDFhAAA.CAHCACCE.fDDBhACAbGAE.........hABA......hACA...,2,-28,-5,23
fCHUKQXNceARBYZIDLPGVTFSaWbOdEgJM,BFDDZAADDHDGLDBHGDGGFAHDaAEF..OFHDdBFE..JFAHMFGFhAAAHECGKDHF..XACAhAAAeHCGAEEARABE..ICCFhADAPAHD.........hABA.SGADhADA.WDDE.,1,-19,-22,3
YRaZGOHFLNIcQVDUbBSAgfJKEXTdeMWCP,JGEAEFAAdAFE..MDCACDGA..RACGGFDBHAGBFEFELHBE.hAAA.ICACVDCADAAChAEAUEABBGHAABBGfBEFhABAKAHB.XGAD....hACA......hADA...,2,-35,-20,15
NMIZPeWCBLadARfUYVTKFEOHbGXDQSgcJ,UFDHTFDHFBGB.HAACGEAA.QAEESCFDJACHMFABhAAAZDFEeFHBBGGCdFBAfAAGhABA.KCEDEDAGhABAOHCCDGIDNIBBICDDCAHEADAG....hADA......hAEA...,2,-26,3,29
XeCTYHJZfFcIQEWBADURKabPMVNOLdGSg,DEFAKDAF..aBCCMDDF.OCAHdEDEGGEB.SGCDhAAAeAHHCABCHFFBJBFF.ZFDD.FCBGhAAAIBHHEGBFAFBF.UDBEhABA...PDHB...NACF.XCEGhADA.fAGChAEA,1,-19,-30,11
GaQLWVIDTcEYdgBKOSbfHMFeZUNACRPXJ,RDBHXDACGAGEQAACLDCB..IHEATEDBEBEBdEGABBHEhAAAKGGC.OBAAhABASGABHBDA.MIDGhACAeHAA...........hADA......hAEA...,2,-20,-16,4
OEgdFGPJDCTYfXNaIKMSRbeWcHUQABVZL,VCDHOFFC.dAHCFBBDGEBF..DFACCHEH...TDGGXAEGhAAAaFGC.KBAH.SGAFhABARAEA.eDBChACAHGDAACCCBDHALAAC.EHAE....hAEA......hAFA...,2,-22,-22,0
PNGcSXAZLQIKVEDBYbRdTWUHCOJFefagM,LBDGKGFCEFDH.BFAGRAAC.dCAGUAGCODEFFDAE...eDGDaDDB.hAAAMBHD...PHAChAAANDIG.GBBEhABASFBDAEDB.QADCDGIF.YHEAhABA...WFADhAFACGGD.JEEA,2,-23,-20,3
DVLPROacWfgKQHYTebBCXdIJNMZASGFEU,FDAFDDFFLAACOBHF...aEAE..fBBDKCCBQBGEhAEATDDBBHEA.CEHGdGAChAFAIFFDMFGFABCDSFHDhAAAEEDH.VGBA.....hAGA.cBEBgCFEhABA.eACE,1,-18,-32,14
GRAYSEaXWgLTIQVKcdeBJNFPbfODMCZUH,SAFBaFAA..XEDBLHFATFFBQABE.hAAAKDDAeBHFNAIC.PAEEhABAfFCBDIGACCDGUCAEhACAHFFCACEG.EHCEWHAE......hADA......hAEA...,1,-14,-25,11
PZCTJabBEegNKDVWALSHUcdFfXYIGRQOM,LDCHUCCBdEFCFHACXGDE..GAEHQEAFODFAMAABhABAZFCF.CAGB..JBHBBDAEhAAAeBBEKABDDEEEAHIB.SHGAhACA.cBEEIHGE..hACA......hADA...,1,-13,-36,23
WdGSbPDBAJcIRHXFaEMQgTfLUOeNYZVCK,JGEARAADHFFD.FECFaECH..MEID.QGAATDEBLBABhAAAOBFE.eHCGZADG.KAFBhABA.GBGAPDDAAADBICCChACAEDAB.fFAE..hAEA......hAFA...,2,-23,-8,15
AIDQKOMJCRYZafNXLHcdPeVTEgFbSBUWG,DAFBQGGDMBDH.RAFAZFAB..aEAFXBAELABB.dHGBeFDEhAAAVAGHEDGC.FDEGSFDFhAAAUADGAFHGIHCFhABAOFFBCEHG.fGAE.NECE..hACA......hAGA...,2,-20,-11,9
OVPbEgTLSHWCXAGceJFBafNURMKZIdQYD,eFEFBDGFaHGEUBFC.RGAC.ZGCE.dDDFDGGF..OAFC..VCBHhAAAEEAA.LBAEhABAHEGFXAADAAGCJFHB.NFCF.hAAA..MAEFKADB...IFAA.hACAPEFG...hADA...,1,-19,-23,4
NOSTDEWeCbPKFUaBQMfIHAgGYRZXJVLdc,GAFERGFGZBAB.JDBALCCA.dDHENAAE.OGCA..SEGAhABAEADG.eBBChACAbBFH.FGGFBHBEQFAAhADAMFAF.fFDAAFFA....hAEA......hAFA...,2,-26,-24,2
WSBgJDUQOcGILbaAZNVKPYedCEMfXTRHF,ZGFGVDAGKGBC..eDGDdEFGMCEH..XGBFRCACHCFCFBFGSAAChADABGAG..DBCEhAAAQADH.hABAcDDA.IDHD.aGGCAACENIAHCAHA.hAFAfEHAgFDBhAGA...,2,-29,-27,2
OJMbNEKCRWPHFUYIBcGVLafgXQZdAeTDS,eEGHSDABOEEFMAAG..EEBBCHDCRDDGHBBB.UAECBBCE.hAAAGAEFLHBEgGGGhAEAXBGBdCHEAHHHDGIHhABAJFCA.NCAA..........hAFA.KHAA....hAHA...,1,-7,-22,15
OVEgJNWYBTZcQGKadCSbADFIMXLHRePUf,DGHHFGFHMBFHHFEFeCDF.UDGAOEGD.EGAHJCAD....hAAANCIABDCAZCBB.QABHhAAAaGADCACHAAHG.XGBHhABA.LAGHfFDAWEDA..hADA......hAEA...,2,-31,-26,5
JQMeCAdXYRTSFGVEacHIBWOUKPZLDfbNg,XGBCTFDH.GBBAaGGA.HDGDBBCAOACGUGAFKBEE.LDEEhAAADAAFfBFAhABA..gBAFhABAJDEFMIFCAHABdHFHSGGGFEAC.EGDE.hACA......hADA...,1,-3,-22,19
XDYCfVBIRJcENaTFebKGHWSMPOQgAZULd,UBDGdAADDBDECFCB.BEFE..REEF.EECA..aHBAeBHDGAFGHFDD.hAAAMDDAQBAChABAZDAFLFHFXEAFfHABhABAIGGG.NAIE.......hACA......hADA...,2,-26,-17,9
gIQGTfNaMRcBeDYUVPLJEbKSACZdWXFHO,dBBDFGFCOEBFQEAGGAFG..NHCB.MDAGBCAD..DAAGVDFFhAAALDHF.EEDChADAKDDESAEFhAHAAAIFCAFA..XECDIBBF.....hABA......hACA...,2,-37,-21,16
FGOaYSdbcePTRIDgVUNBWHfZKXCELJAQM,MBDHFHAEGECF.OBFBSCGC.dHEFeHDCTDGAICDHhAAAVDAB.BBBGfABGhAAAXEABLHAEhACAQGGCaFEE.bAGD...PACAhABADFIFNADBZCDD....hAIA...,2,-9,-5,4
MTcEVDQgdaZRCSIGXJKFfALeOHYNBPUbW,OAABHAADBFCEUFCBMACE..EGGGVFGHDGAD..dEDBZBFECCDA.SCDFhAAAGAEFKHFAAEHALHAChAGA.eFEBhAHANCIE....PDAD....hABA......hACA...,2,-32,-13,19
aNTPMObDHXVUBfgQFeRSAIWGKdYZJECLc,GAFEKAFBdGDEZCGBCEHHLAAB..aABHTFFH..MEAEhAAAOACBDEFFHBDDUFDGBBEFhADAQFAFREABAHHBIDDEhAEA.....WHAG..hAFA......hAHA...,1,-19,-35,16
FMRHaNIDQTUGXWJSZbEdKAcBVOeYLfCgP,VDBHOEEG.LEBDCAAD.FACGRFEBHAFH..IAFGhAAADGIHQBDCUGCAXGGEhABAJDHB.ZBBAdHCFACFBBHAGhAHAeCAF...fFGFMACE..hAIA......hBAA...,1,-16,-25,9
VMFaRbKQdUZgOJYfWCBPHTLeNAEcDSIXG,EHFGDGHH..SFCBGDDFMFIHFHAAREEHQABC.dDAEZCBEhAAAJAEBfACDhABABCGETGAE..eBFGhAEAAAAHXGDFaHECKBBA........hADA......hAEA...,1,-18,-24,6
FgTHEXQCbNeSKPUcaJGfRdDILBVAZMWYO,ZFACMCCAOAABFGDCHEBA..XFFFCCAE.eAHHSBGBhAAAKHAA.UFGCJCEBRBCFDFAFhABALAEEAIDE..hABAYABGTDAAEFHFNAIE.aGEDGDDF.hACA......hADA...,1,-9,-14,5
DQHJbdOYeSNGaVEfPcRLAKUCgXTWFMBZI,KFFBCHHG...XEADFFGEMCBFBHFDZABC.QBCEHFBCdDCFeHBGhAAASHAEGAFEECFChAAA....fGFEhACAcABBAECF.........hABA......hAEA...,2,-41,-17,24
IfVCDGgPbcLWJReEFTABMQOaSHXZYUKNd,QEBCOEGHHEAFZCDEKAEGdHAF..ICDDCAFBDAACGEED.hAAA.PFDFLBCChADAJBADeCFGEHEGAHHG.aAHB.hAEA..SABB.....hAHA......hAIA...,2,-24,-16,8
MKBQXgNGSJfOCcVdARHUbWDLYTeZaEPFI,HBCDUCBCDAIBTDGDZEFB.EBAA..FHBAIEAABABA...QAGFhAAA.gFDChABANBDF.SGHFhACAJFCCCHHHdGACAIFEWFCF..eEHFMIDEhADAKDDCfCEFhAEA...,1,-13,-41,28
PcefaIFMDULTCBVgKGQAONXWEHdYRZJbS,ODACXCBCHFDGdAGEZABCSFAD.eDDEfFBBhAAAFBBEDCFELDHHBFGEKFFFGDCFhACAAACEEFBA.JFAFPHFChAAA.aHBEIDHCMBFE.CGDA...hADA......hAEA...,1,3,-24,27
MFaYUKOWTPQZgcEVBANeJLHIdGfCRSXDb,eEEGHFBGdHFHCBEH.XCAGDEBE..FAHHaBEBKBAA...OGEAhAAAPCHDZFAE..gBFHhAAAEADABHHEADDEJBAChABA.IHAE.REFFMAFEWHDG.cDDChACA.....hABA...,2,-46,5,51
WXTVSOGgYcHKJBaFINADMZLbQedPfCREU,DIBGLAABQGGDeECAdDGA..CDGGEBCHXGGG.TGAAhACAVEEHOCAH.hADA....gBGBhAAAYBEGcCBDKBAEBECHIGEAhAEA.AAIFMCIF..hAFA...,2,-28,-28,0
gZYERAOJTIfDdcWLUNaBCFQVPbeMHSXGK,OFCAJDAC...TBGFIHHD.dGEFLAAF.NIAHBFABhACACBADQGBHhAAA.VDGBPCCGMAEDhABAHGEG.SDGGKBFGYFAD.AFEGDBBAhACAWAEC.aFGA..hADA...,2,-27,-23,4
RHTDdaKcMAJbELIgNeOBVGUYPXCFWZfQS,EDCDLGEA..NDAC.eEABBGDDGDDFUACG.PACG.CCDBFFCBhAAAZFFESCGFhAAA..HBAHDIBGKEBDhABAACIFIAHEOEEC.......hAFA......hAGA...,2,-37,-14,23
cRVFOZADafgeBPJWIEdSLUNHQMCYKGXTb,DGHHaHBG.eEFDBEDC..JDBGEHGA.LAEGHAGDQACGhAAACBCC.KGDDXCGChAAA.TDAHcEAHFEHDhABAAABB.fFED..WCHH.ICFChAEASCDA.hAFAMFAD.,1,-23,-33,10
cCGPfUFDXOagebALdYKRBSENIVJQTWHZM,dDCDKCFCBFGCEEFG....IHBDQDEGHBFCZBBDMGACCAACGECEhACAUABFDHGE.aFGEhAAAbFAHAAEC.LAFChADA..SFDHNIEB.....hAEA......hBBA...,1,-20,-23,3
LEDCVJeXPKWHIBOGUFARgaSMQdTcZNfYb,RDAGaAFBQEEA.dACGZEBC.NAHE...bDGFEFHB.DIBEVADChAAAeCEB..KGADIABChAAABDDE.GGDFhADAABACSGCAMCGBfDCBCHHE...hABA......hAGA...,2,-23,-16,7
XMCcDAaGeNdHgUVYJTZLRWfBEFOPKQbSI,aHAEeFEFHFEDUBFC..JBAGZAACLCFGREACBHGF.EEABFCAC..OBEAhAAA.KHGAbDECSCDDhABA.MEIBhACADBIHADDF..NADF.dAEC......hABA......hACA...,1,-7,-32,25
UbPOVNCgWTRDaKFJMLQSBGZdEIeAHcXYf,XFDHUCBCODGD..VAAFCEDA...TAGAaGCE.KDCFMIFAhAAAQFFFBBHBdFAAhABAeFADHACC..fFBEhAAANCFE........hACA......hADA.gBEDDDIB,1,-9,-29,20
JeSUbDadTEPcVFLfMYgZABONXWIGRQHKC,BAFBODAC..XACGGGAHREFBHBABKBAF.eDDBUBFGDGHFdCCFEGCGhAAA.....PAHFhABAFFCAfAADhACAMEADgDFDAHHD.......hADA......hAEA...,1,-14,-29,15
cZGWRLaKMOJDCbYVQSXfdNIFPHEAUgeBT,UDACeAFBBCEDZGDGRACG.LHAA.aEGEMBID.DDFACEAE...hAAA.VBAGSHGAhAAAdGECFHGA.EDDFAEFA.TEGFhABA..WAGBKHAGOGAA..YFCEhABA...hACA...,2,-31,-23,8
NBaWFbAUSKRgGfPZVTcJXeCMEHILQOYdD,SFHBKCFCGDDEZDBD..VDBHJDHF.CBHAHBCELAEE.QAAChACAdBGGBHEGaEFHhAAA.FGABAIACUGFC.hABAfDAEcABBMAFA.EHGE...hADA......hAIA...,1,-9,-24,15
fMBRICKXYWbdGLegFUAZQJSDEVcTHNaOP,QBDGDFDCEHGE...TDAGaHCCOAEHMEFGBFDB.CBHBKFADhAAAXCBB.bFAFhAAALFFE.FBAGhABAZDDAVGBGcDGFNADFfGGBIACDdAGEhABA......hAFA...,1,-7,-25,18
GKSFECRXPQIOeMbNLgfDUcAYWTHZaVJBd,TCBCZDDFJBBC..BDFCKBFHFBHH..CGCD.RFDE..QAAFhABAeFAH.MIAALHFEhAAADFIBUFAFAAFCHAGBdADCSHEGhAFAEDAH.PEEAIEHA..hABA......hACA...,1,-6,-37,31
LaVCeBMOcZIdbFSTXJNEDWQgAPHURGYfK,UFDHREBHGBCFKCHDLCBGCAGG..BAADODAHZFEFdDGG.SDDGhABATABCJCFFDACGhAFA...QGGEhAHAAIGA..........hAIA......hBCA...,2,-47,-28,19
cLQVCTPNAXFKJUYZMaDdbIEGfSgRHeOWB,FFHBKGDDUBEEZCEHDBAE..dGFG..EGEBSAFERCAE.HDBAhAAAeFBCBBCFLBHDhAAACEFE...NACH.AHIHXCGBhABAJHAE..aGGH......hABA......hAHA...,1,-26,-40,14
GCbYUMRZFgBXEQNHIcDeKPOaSTfWAVdJL,VDEDJFFBLFBF.GBDBCBHCUCBBRCBE.FDHDBACG..QFBChAAAHDGDDIGEKAAHOABEhABA..aAFASGGFhACA.fHDB.ACEF..hAAAdAFAMEAF...hAEA...,2,-31,-21,10
TReMPZJANFBOKQIEVXgbSHUCYcfWadGDL,BFEDKAADEAFH..XAEG..SGEECABA.fDFHhABAaEDADDBGLFAChAAATECDRFABMDIB.PHCAhABAABDHNEIGFCBD.IAHGbCEA....hACA......hADA...,2,-33,-33,0
QHKXPDgZNYcLaeFbBIUCJdGTSMOVEWRfA,KDAFXAFBDGHFZEEB......NBFGLADFaDCAFACD.BGHGhAAACDGB.dECGGEBEMAIFOCABhABAEGAB.fGDFhACA.AHFE.PBFAYHBAbAAB..hBAA......hBBA...,2,-33,-28,5
ZFSgMLWXNQCTOUJPAVERKfBIeGYdaHbDc,EDAFRDAGBGACGFDDdFDCHCDGDFBBZAAE..FFHDSCGDLFGD..hAAA.XCCFCAAGOAFGhABAPHCCAHCB.KAGCIADHhACA.aBHB.......hABA......hACA...,2,-27,-24,3
GVbEPQZeDcBAORTgLdMXIJUHaCFNWYfSK,RAEGTDACdFFH..MEIDJDDA.HCBF.CFDG.FHCE....NBAA.fGFDhAAAGGAFEAAEZAFFhABA.DCAAADDG..OHEChACAXECDaEEA.SADD.KAHF.hADA......hAEA...,1,-16,-29,13
bSHXFUGeOAZcPQgEdKVDfWaBLYMRTJICN,ZAADQCBCdECEDFEG.aACEBHAC.LAECRGAGJDGF...CHCD.SGHHhAAAFFHF.GEDGhABAeCFG.AEDFcCGFhACA..EGECfAGBWDCE..MIEEhAAA.....hADA...,2,-36,-26,10
CULfBYXOGIZFQJKMadAVTgSeENHWPbcRD,TFDHeCCHEFBD.HEDB..PAACRADACAAALFHHBCDHOAFEhAAAGAGEFFHDKDAEdGAGACBE..hADA.SDFAhAEANEAE.WHCGDACGfDFEICFGQEBBhAFAMIDG.aFFF..hAGA...,2,-19,0,19
EXbPVBfgFKRTWMAOHYJNIGdaSeUDCcLZQ,OFBBHFDFJBGHGGCFdEAF.eFDEUBDBDDCHLFGB.EFFBPBAGhAAA.BAEA.hAAAfAHGFABBTGAHhADAACAFIDEDaEDBCAGE.cDGC.XAFDhABA....hACA...,2,-29,-13,16
SQXLaRBdUgJAMTcNOHFEfCIeKYPDbWZVG,TFDBOGEAHBED.FDGBECBE.CABDKGGADBAEZACFGADCQEBFhAAAaFAH.dAEBUBGHACHEMHAChABA..fHBFhAAAIHHA.YDAH.....hAHA......hAIA...,1,-14,-20,6
NYKUcHTEZSbCVIFPDaQeGAJXMRgWfOBLd,XAFHMECGRFAA......fAFELECCdDAAKAACHEGHhADAEHFCSCDGhAAACGEA.FEHFDDFEeHBAAIECJAHFhAEAOBCABCBF.NGDHcBAF....hABA......hACA...,1,-21,-29,8
eYBJEIKLbTXGSfOMgPAFHVRcUaZdWDNCQ,HBCFVGFG.UFGCZDAF.dBFDDBAGQFAE.eFDDJCDEKAGBLAAFhACA..XGDFhAAASEEC.MIAAhADAAEEEFACAaAEGCCCC.BBBAECHF....bGAC.hAHA......hAIA...,1,-7,-32,25
XRZKNIJBCfLPdSOQaWgGVbTeFEMDHAUcY,UCBCXCBCZGCAKDGC..JFCABFFGLEHF.dHBBSAFBhAAAQAFE..aACChABAgABG.hADAVCEB..........hAAA......hACA...,2,-55,-25,30
eCFOQSDdMgPEZGaRNLcAKHfBYIWXUVbTJ,KCFCBFDD...IHACXBCG.UFGD..VACGJDDBFCABhAAASBGA.MEHFhAAAPFBHGCEAaFED.hABANIEBAGAC...HCAHYAFGWHDC...hABA......hACA...,2,-36,-27,9
TVKZeEbCdSQfcRIFMPJGYDaAWgNLOBXUH,...NDDG.LEGHBBHCHADCTFBBZFEC.EFEGdCAEQACDhAAARABB.FHDCPCHDJAFD.hABADIGGAIHAOCABUCEFKGAChAAACHABfDCB..MIAE..hABA......hADA...,1,-11,-16,5
VOQTULRGbcfWSPMZIaHDKCeBJYdgAFEXN,EFAAVEFH..QFFGUGCGGBBG..cCDGSAADhABAMEIDZACGaBEF.DFDFKBHFeAABhABABEADJAHF.dGEGAEEHFGADhACAXGBH........hACA......hADA...,1,-9,-24,15
XMCKabdeAcNHPfLDWGTJIQFUYEBgROSZV,HAADLGEADCDFGGAHTCFA.QGGE.FBFGEEFBBFFFhAAAgADHSFAChACAVDBGXCECCAHGKBAEdGBHhAAAAEIB.NIAF.fDGF.WADC..hAHA......hAIA...,2,-15,-12,3
LNOHYIGXSAcJdZWBVUaegDCRMETFKbfQP,dDCDBFDDUFDAeDBCDIGAMIAG..FABBKAFA..QCFFhAAALCHHHCFFGAEFAFADJAAFhABA..ZEAFaGGACGHG.EADAhACA.....fHDBNCIA..hADA......hAHA...,2,-30,-23,7
YKfTISWRNgHXeQAOBCULFZJdcGDPEbaMV,OFCABFFGUCFCFBGGZDGHdGAHGBDC..DICEEAACaCEB..MBCDhAAAKGEG....IFAFhAAARDAB.HACHhABA.XCACAIHELAFE.JHDA...hACA......hAEA...,2,-34,-23,11
eZDVYTUdacFbWERfQCNKIAGXMBHJPgLSO,MGCEBEFAJHDGLAAB.eDCEZCEGDDBB..VAEBUAACaGHB.hADAFBHDEAEH..fEAGhACACGCA.KAGEIGAAhAEAAIEAGDFAHFGD.....gAFHhAIA..hBAA...,1,-6,-44,38
IKMVSOCDEaTRcAPeNBfYdJLUbFGWQXZHg,eGEABFDGdCABLCFAFCFGGDCHQACGHGFE.KFAC.MECGSABGhAAACHBCDAHF.aBGATAAChAAAREAH.AGEGNEIAfEHAhACA.........hAEA......hAFA...,2,-24,-19,5
JNXWgLZaUdKBCOYeIGVEbRDMSfcHQTAPF,JCCHXCBCLBEGUDGCBBAC..OEBCeGFEGDAE.hAAAEEFARACGDAFC.SGCGhABAfFDAHFEAhACAABCGFHFC...NADD.gAGA.aGHDhAEAKCHBCDEF.....hBAA...,1,-18,-23,5
NFGcOgaCSALJDTYVXPfeMRHIQEUbdKZWB,JBFDDAFB....TDBHVCBH...XABGeEHBHACE.EHBEhAAAdGAAKGFDBGFD.FDHBhAAAOAHDaDDDCGCAAGIBLFAAhABA..fFFB.IAHEhACAUEEF....hADA...,1,-10,-46,36
JPVHOLQKUFEINTXcYdeAZaMGgCRSBfbDW,aHDCGBGA.RFECBDDBDAFE..JBDFHAACLCFCKBEGEDAC..TDFGhAAAXGBG.dFABhAAAABBFMACHCHHA.bFFE.hABA....PEAG.....hADA......hAEA...,2,-31,-21,10
IgXaPEKbMFYLHOUNZSVTGWADfQRdCcJBe,DAFBREFHCAEA.BBDA..eECG..ICAAaFHD.EGCFKAADMDEEhAAALCBD.HCDChABAOEFAZGCCSBGBhACATAGHAIAGQFFDdGAA.....hADA......hAEA...,2,-36,-16,20
MTFIDWVSdZfXYbRcLKgNaOQEGeUJBCPAH,HFEETAGDDIBG.SECFZEAF..XEEGRAEDLAABgBCHhAAAaBHB.EHEGUACAhAGACHGB.AGBHIHHHhAHAdABEfDHC.bFCDKDGDNAFE.QDDGhAIA.....hADA...,1,-4,-19,15
eJOPfIFEGCNQWYRXdSKZaVHcDMLgbATUB,BCAHOAAB..IAGEFEGACCFH..QGBBRDFGdECDZGFAHFAFhAAADGHF.LCCAABEE.hABA.UFEAJACEEHCANAED.hACA...XCCDKCGE...cDABhADA.MIDE..hBCA...,1,-18,-38,20
RaWfIAgPQVUYNBJObLMdeSHFEDCTZcGKX,QCBCUFDHBCHB.OFFALADG.dCECHBGFFCCF.DCFFZBAHKAAFhABA.XEBERFAB.hAAAfGAFAIHA.hABAPAEANCGEMCAFSGEBEEHF.CDAFcGGEhACA..WHDAhACA...,1,-7,-31,24
XDbVdfEMWYIgPHSGZBJRQNaTeLcFOAUKC,UGAFKFFBDEEGdBEA..MHCC..IBCCHBAGZDAHBFHDRAFE.aCFDhAAALCFA.OECChAAAAADACGFF..XECFhABAfHGFEBGE...YFAFPCAFSHEAhACA.hABA...,2,-32,-28,4
RYKBIGeJWAEdOXQCMVPTfLaHgSNUDbcFZ,EEEDdGDDOAFE..QGBHCEDF.MCCEPEGFLABChAAAHABH.SDBGhAFADIACFCFHZEADKAFABCHGeGFAhAHAAAFE.XDFE.fFDENBAA.hAAA......hABA...,1,-10,-30,20
bgXIDHKcQaeEZMGORdTfYPJWLFCVABSNU,SEGDUCBC..XBGCDCDEKEEFQDADeGEGZGAGOFFGhAAAdHFB..TGCGhAAAPFAGLADA.hABACBBABHAGNAEA.IBHEaHEC.MDEEfAGBhACA...hABA...,2,-29,-20,9
TVBLGHCaFUgfZPXWSIdRcYNAKMOEebJQD,OECCeCCHQEDADEGGBDAB.LABCHGFACGDD.aGCD.FHGEUACGhAAAZCGF..XAGAhAAASCEHICBFdGAF.hABAcGAGAIDAEFGGTAFE.....hAFA......hAGA...,2,-24,-11,13
YSbaeRTUcPQOAJDEGHKZNWfLdgBFCVXMI,EEGCHCCHZDEF..NDGGLHBEdBHGBCBDCBBBMAAF....SGHFhAAAaCGF.REBAUADChABAcAEE.OBBBhABADBGBKGADfFDH.FEBD.IFHEhACA.....hACA...,2,-36,-6,30
YbLgJdZHMaAUFKCVESeXRINfDOWQTPBcG,FFHBCHCH.EAHHSFBB.RFDB.fDFBDCAH.QBCChAAAPBCD.BGCHGBEDhAAAYFAELFFAhABAdBAEMFFFAHAFKHFA.eACENEEB......hABA......hAFA...,1,-21,-23,2
PcSebFaKUZEfMACXDTGWBOLgIRYQNHJdV,CEFADFEEGCCHBGGDLBDHRFCF..QEAAHGCCdEAFVBAGhAAASBBF.FAGEKBFBhABAUADFEHAEAAIB..WHFGhAAA..ODFEIEHHNADF....hABA......hACA...,2,-29,-20,9
HGJIOcYbCFQKPWXURdSZLDTMeVgBANfaE,aHBGEGFHHDEDGAFAJCBD..ODCG..bADCFDAB.KGFHPCHHhAAAUACE..SFBChAAALGAE.MFFA.hABA.eEDBBFEDACADfHAHIBAHCHED..hACA......hAEA...,2,-19,-17,2
EQfJLcbKRTZNMSUBOPYVAeadgIWDFHCGX,eEGHaAFB.dCAB..IHACDEBDFCFBHECCCHFB.GABFQCFAhAAAJHBC.LEBChABAKAGA......hACA.TBCBNEAE.SEHHBHHF..hADA......hAEA...,1,-25,-37,12
afcDVXOJEdMNUFSgZCYTQbAeGHRILKPBW,eEGHHDAHLHAGKEFDBAGD.aAAEDFIF..OCCEdBDGUCAGFFEC.ZBFEhAAACAFAQCGAhAAA.AHFE.IFBAhABA..fADAXGDGEHAAMFIF.SHFAhABA..hADA...,2,-32,-20,12
XPfbMaLHDSegCcTYOEdQBZUNWAIFJVGKR,JCCHGBCH.RFAC...XBAB..fEFCaAEBHFEESBGFhAAAeAFACCACTGDEhAAAEGAGBHHGUDBDAIBG.hABAFGGDKEHBMABEDIBCcCGEYCHF...hACA......hADA...,2,-29,-7,22
DUVCNRBPbMeSJTZXfQHEKgdLYWIaAOGFc,GAEGFHFGDEAG.UBGE.CEHF.RCCGBFAF..MDBBSCHBhAAAZGAGQGGGKGDH.dGEChAAALADG.ICAHhABAADDHVABHNBAE........hABA......hADA...,1,-18,-49,31
gZFCRIcEfTPObdXKAaJUVYHeNSMGDBLWQ,aGDDUAEGHAACeEFHMCGHBEHC.LEBF..QFAGhAAAFABERDCF.IDAEhABAEGHB.fDCChADAOAGFbBACKFGBABIB.YEEH.....hAAA......hABA...,1,-10,-24,14
SKZePdTGcUOfaEVMJYACXBHRDQgFLbNWI,CFFGXGDCBAEAHBCDDBCC.FEABLBGF....NAHE.SCAGhAAAeHFAdFCA.TEAGhABAUBAE.aGACMFEHADFFgFGEhACA.IDDGKCEG...hAAA......hABA...,2,-30,-22,8
fXPOdKWHUVLDRJEcbMIGgaeQZTAFYNBCS,FHBGBFDGCEDC.SAGE..XAFEdGGEKDBGHABAUEFEDECFhAAAEEEEMCFEGBAFaHDC.hABAZFAFAGDA...NAAE.OHFAhACA.LDAF.....hABA......hADA...,2,-30,-24,6
QBIRNAcYVZDJPTMbOSLWXaGEdFfeUCgKH,VAADDAGD..TEGEMFHH...SHCAXEAE.aABDEDDGFEBDhAAAUADCCADC..HBDHhABAQGEGIDFBAGIFZAGFhAAAJBHH.ODFD..WFFD...hACA......hAIA...,2,-18,-18,0
CMXSgYQAeDbEGWIHOdTNBVPLfUcJZFKRa,eFCHDGHHECACGCBH.HAFBTDFCBFEELHBEUEABZEGDFBECaCAGhAAAMFIF..SABAhABAgDCCAIHAIAHFhACANAAB.fGEEJFDCCGAF...hAFA......hAGA...,1,-3,-25,22
XWIfOGCLMKZJDYbHaEBFPTANQRgedSVUc,REFHdDCDUBDH..XCFG..IAGGOCAGCGFELBBBhAAAKAFAZEAA.DEDCHEGDECAFFFAFhABAAIEA...QGCBhACASCGE.WHAAfFHAMABC.hAAA......hAFA...,1,-25,-32,7
TXedNUKRAbIScWVgYFfaEMBLHOZGCDQPJ,SHBGVAAD.FDEHEFBABDFELBEDZFGBGBBADAID.QFBBhAAAPAGD.JADAeFGDhAAA.UGDGAAHHIDHDhABAgGAG.fFHG.MADAhACA.CDCA....hACA...,2,-30,-4,26
MWcEYZLXSePfRNVOBICUTFgGJbadKADQH,DEFAQFCAMCDB.EHGAZFCELAAB.SAEHfDBAhAAAVCFEBCFH.IGGChABACACCTCCCFGADgEAChAEAGACFaCABKGAAAEEF.cFFBeHDENCIE..hACA......hADA...,2,-22,2,24
WaXQAefENZSUCdcLHbOJBIgMFRGYDPTVK,EDCDZDAGCBGEdFFBHEDF..OHCEBCAHMIDARBGFDABA....TBEHhAAAKFHBXFAE.hAEAAFFC.NCBAUGGFLDFAhAAA.JACGIHAC......hAFA......hAGA...,2,-29,-28,1
BYWEATOgdHDLcJISRKGMefPCFQXUZbVaN,TDACdDCDLEHB.JAFAICDD.KABAMGDC.eCFFhAAACADBQDEAUABFZFBB.hACAaAGDBHDEECHFAIEE.HFAChAAA.SFGH.fGEFhABAPEAB.....hAEA...,1,-8,-29,21
ObSIUTfgMVCEJAaRWdcYLHKDZBPGXeNFQ,aCFCRDAGdGDHLEGBDBIF.BCDGGAAF.eBFHFAAFOFBF.hAAASDAAICDFTEGFhABAMIFE.CEEGAAFGcEEFhACAKGGD..PHACQAGH.fACFhAFA..hAGA...,2,-34,-19,15
GIcJPSKgQbeMfVEUaCdFYOLDHBNXRAWTZ,ZEFHGAFEJAAE.KFBH.QADBMCIF.ECBAaGCH..dEDDFBGBOAHFhAAADDBG.BHFH.hAAAXEGAAEHFTEAFIHHEhABASAEFeHAGVFDDCBBC....hAGA......hAHA...,2,-35,-6,29
OcIRZMeXfYgTHaNUCDFdPKJQSBbWVEALG,OHDARAADMFCB...eFDA..XEAFfBHCTGEBHBCBhAAAUDDCCBECDGABdAHAJEAASADHhAAABHBA..hACAWBGFAHHHcDGE.IAFCgGGBhABAaGGA......hACA...,2,-30,-9,21
cWeENdPOCBMRGILFSgDVfAaYKHUZTQbXJ,aAFBKCFCZCCA..TGEEQFAF..XBAEJFFF.eEDEhAAAdAEHCDHABCHERAAFLHAAhAAAgGCD.DEAFhABAfEGGAIHAHBFB.......hACA......hADA.cDBCNEEE,1,-12,-33,21
ASPHacJUgYIZVEBFTbXLCWKGNORDQfMde,SCFCHDAGaGGGUBDG..ICCHEABCFGCF...TEBAhAAALBHHKAGEODGBhABADEFDMAADAGHHJHDGZFAFBGEGhABACEEBNBCH............hAEA......hAFA...,2,-28,-17,11
HAbFMBXJQRZCGISWUYgEfDLaeTcKdNVPO,FGFHXEBCQDDFRADE.GAGE.SDBFUGGEEDECLHCEhAAATABB.cCAFhABAdAEFNEIE...OAHBhACAAHHDMDAFBEGECGDEWFCDfGAE.DDAHhADAaDFDKCCE....hAFA...,1,-5,-18,13
CQGaWKUEXTbLRdNYAMHfecOBgFZPDIVJS,MECGHFDFeBFCBHACFBGFDEDC..JBBA..CHHEGFDBKFBGUGFAEBBD.hAAA...TDAGhABAbEAC.LCHFRACC.hAAAdHABNIDDACAD...ODHD....hABA......hACA...,2,-25,-16,9
DJQdLCVPEcbeHgMRfFNSWZBATXOUGYaIK,TDCHXDCH.UBABGFDH..aDHFKGBA.QAFFhAAACCED.EDADbFFCHCFGRAEAFEAGhAAAWBAEAIBG..IGDGhABADCAAdGAC...PHFCeHFC....hACA......hADA...,1,3,-25,28
fNaLXWEOQVMIAbcHRgYePTSDFBdCZJUGK,HAADRAADeAEGTDEB.DFIDdGEGZDACUDCFGGBFKGGG...fAFGhAAAaDFALCHBXAGFhACAEGAB.OCCGhADA.MBIBIACCcGGHPFCFBFGB.CFFB.hAAA......hAGA...,1,10,-24,34
fXAgPFNacOLVQCdWGEYIHMRTJDSBZUKeb,FHBGaHBGLABCQBGDdAFBGGEB.ECBCHBFA.MAAFJAEFBACGhAAAUEEDKDBDeEEGbDCBhAIAAAGF....PDABhABAOHFA.CBCC.YDDF....hADA......hAFA...,2,-18,-9,9
RVfDUgaNXcMQSBHGOCKFLAZJIYPdbEWeT,ZFDFJGEA...IBHCdFACEBGH...TDBGRBAEDIGE...aGAG.hAAA.XDFCQAAEhAAASADGHFGDOBDAhADACCHHKGBC.AAFCYDDC.WHAA.hABAfGFGNEADMEIF.hACA...,1,-6,-37,31
YSPgACMEeHLbTVaOIBcJdUfFQWGKRZNXD,EAGELFFC.TGBCOBBG.BCGFJAAC.UEGAFAGG.QDCChAAAGADEKDFCRFABXBDEhABADBIF..PHEEhADAAACCMFEDeDDD........hAFA......hBAA...,2,-23,-23,0
CbaHMgVZFJEGQeXdDfcWYKITRBAULSONP,UGGDSGDB.ODFHNDDB..CFFFHECBMCBCZAGB.FACGEGAGhAAA.GACBXFAAhAAADBAH...fAFAhABAYBFG.IHGFTDACAEFCPDHD.hABAaDDF.....hACA...,2,-28,-11,17
YJaUcGBSDQPEAZVXTdNLeRIWgMObFKfCH,VBCDXFCA.dAFBeBFF.RFBD...ICCHMFFHFGGECECCHFFChAAA..aDGEcADHhABABBAEDAFE.ECABABGHNIAFhACA.....WDFA.OEAFKAHB.hAAA......hABA...,2,-29,-18,11
SBHCJPNZIUTgDRGdKeEbMWYXAcfQLFOVa,QCBCFGDBODBB.aCGGBHBC.HDEACAHA..JFABZCCH.IFGHhAAAUGFGDCAF.dAADEACEhABAMFFE..YAGBhAEAAHDH..fEDGSFHHNEEF..hAFA..TBDC.hAGA...,1,-26,-29,3
YRUGZCBOdVfgNaDePTLSHKJQXcAMbWIFE,MCCA..IFDDFEBDEGDE.RAFEUFAHZEECBCBDdACE....fGHGhAAANAEF.DFGFhABA...eCDAPAAEhAAASEHBJDFEXGGAAIAAWBBFCDDF.OHDEhAEAaHBC.....hADA...,2,-35,-18,17
ZFfTSEcUgWKIeDYabdBJORCVGMQLNXPAH,ZDDFTGBCSACD.UEBEKDECDFBA.aEGABFAF.OAHFhAAARFFBCDBGGACDLHAGhABAXAAFAGHGFADAEDFC.hADA.gCCDeHFE.dAHEMFFE..hAGA......hAHA...,2,-19,-15,4
BACZcKTGLRWVQIJdMOfeYbHaEPSFXNUgD,ZDBHTGBCLEDG.RBEG.VDAAQAACJFGH.MICGeBGHHEGBhACA.aDDAEBCDSFAHhADAXEDENAAFDBIBBFHBhAFAAHIDCAEC.KHEA..IAGG...hAGA......hAHA...,1,0,-23,23
PdWSMgVBbQXcRETHUKeIfZCGLDNOFYaJA,dHBHSGFHMDDGBBCAQEEC.RACG.EAEDUGBEeBABZAAFCHEGDBGEhAAAOFHB.aAHFJGFEhABAADDH....gCFDhACAbCGD.cAFATECC.KFAAIEAChAEA....hBAA...,2,-26,-18,8
aFJNOCXAfUdEcIRKVBYHMDeZSQgWGPbLT,dGFCEHBGRAFBKFDC.BHBHMFECZBDB....SDCGQCAFGAAFhAAALAHHFGGDOFAChABAXEAGADAHfDHEhADAUABF.IAHGYEHB.DGBA.hAEA......hAFA...,2,-26,-23,3
fLZNPUHCAFdWOEMYGaRBJcgVeXIDQTbSK,FAFBOCCHMEFEGAEGBACG...JEAH..VDCFeAHF.DABATGDFhAAAKGFFZEEE.UGGEhAAAAIFAEFGB...aBAB.hAEAREAB.XGBD..ICHASBBFhAGA.....hABA...,2,-35,-14,21
QCDRIXSBbAVPKGNZHFUWedgJaOcEMLTYf,VDAGGEAH.ZABCFFEAeCHF.dGFDJHECOAEA..MBHDLCCGhAAA..fFCChAAADGIBXGCESACDhABAAHBBKCAF.HADD.WAFB.aHACcBGBhACA....hADA...,2,-27,-20,7
EdGRBLCQKIXHUNTYAeZVPagOJfbMDFWcS,eDACZGFGaHCEOEFA..JCHHMHCC.FFFCSCFDdEDABFACCCGFhAAAKHAC.HDAGUACETAAChAAAABHE....hACA............hADA.PBDD..hAEA...,2,-39,-32,7
QZHFIPDNCafUAdGLSYbBecRTgKEXVJMOW,dHAFLCDGSCBCBHBERFCCKADE..EFAFJCEC..MHEG..hAAAOEDHQAFDhABAZEEDIHHEDADECBBHfDBEhACAAGBA.bDFAcAGF...XAAChABA...hAHA...,2,-34,-27,7
KcLeUJNTIVadRObBQZDMXPSFYEgHCWfGA,LCCHeFCAUFACJBAB....IHFDVCGD.RABFBCEAQEEChAAAMCIF.SBEHhABAEADEHAGD.CGCFfFAChACAAFGDKECE.NIAH.aBAHdGGC.OFHD.hAAADAFE.....hABA...,1,-6,-21,15
FKOPVWfBZDRNJASUYdIXHbQeCgEGLTMac,UGBCdHBHHBAHQCBFCBGGGADELAFA.aAACFGED.PEFAhAAA..fEGEhABADDFERFAEAHHE.IHEAhACAeDDDEAHBMBEH.KCFC.WEAA.BDADhADA......hAEA...,2,-21,-11,10
eBbKYVGMEQDCIaTXLWZgUAfPNcSJdOHRF,...NIED.JCCHHFCBREGHBGBCKFGBGCCH.MDBHDBAHaAFD.LAHBhAAAZADEACGG..fABAhAAASEFF.hABAFHCAeAHB.YFAFEBDBIEAE.hADA.WEFC...hABA...,2,-45,-3,42
MEJXFNBARSZDbHPfLQgeGVTKOWUaCdYIc,SDAFDHCEHEFALDFEeGFCGDDHKBGAOEAFaBGC..CEBGdABGhAAA..IGHBhAAAMIAEJGAAFBCBADCBRACC..bDDHhABA.QAEF......hACA......hADA...,1,-14,-21,7
fGEFDXKSZAdILgHMRJQOeUBaNcTYWCPVb,LCCHHFACRCCCOCADBBHFaEDD..NEFE...TGBACBBB.VCADhAAAGADF.DIBGKGFBhABAAHHEdDHA.MAACeAFFhACA............hADA.YEHH.hAEA...,1,-24,-26,2
IbGcMZBFgHWVSQPUYCKTfReNDEJLdaOAX,XCBCGAFEMAAFFBGF.HGFA..SFFFUEDBCAEBKDHBTECEhAAAeCBEDEBDLABEhAFAOHBAAGHE..IEHFhAGA...........hABA......hACA...,2,-29,-24,5
WKYdcETXLeHAUZaDQMNIbRJFCOgVBPfGS,aDAFMIAG....IAHCJFGBFBFH.OFCDBCCHGEBF.hAAAKABDdGFF.EDCELEADhAAAAACGDGAFQCEFhABA.RCGFCBCDPACAfAEESHCEhAGA.cCGD..hAHA...,1,-19,-38,19
NTLQMEecDPdbaSXZRBJOGfKYFUIVgWCHA,TDACQAFH.MCCHEAAFDFCB.dGFFaHDGZFDFRDDCBFGAGAGCKACAhAAA.FEAFIAFDhAAA.VBCFCHAEACIHNIEH..hABA.....cDGASEEE.hACA......hAEA...,1,-12,-30,18
gaGFeDfOZMVbPKUSHAXdCcLJITEQNBRYW,XGAFCFEDLCAF..JGCGEFBC.BBHGRACG.....gDGAhAAAaBADFCFHDGIBODCAhABAMFHF...VABEhAEAKAHFHCCHdHAF..IHHHNICF.YHDEhAFA...eCEEhAGAfEAF.,2,-26,-9,17
HIUCSOJEMKbRcQVYTZWLBdgeGFaAPDNfX,DACBXCBCUDAF...ODFFMAHBREGHQBGB.TEDDhAAAZFEHBBAA.eBDDhAAAFDHDPHBAHGBASGHHhABAKFAFVADB.LBFFdBAB....hADA......hAEA...,2,-23,-3,20
XaIcBLYgZMTVFKNEWObDCAfdSRPHQUeGJ,dAFBSCFCRGCCHAABUDGDeAEFGAAE.aGEEIHHC.hAAALDCDYDDFMAEHhAAAFAGGKFGEEDEFODAHhACADDAHCHHDAIDC.QFFBXEEBBCHA..hACA......hADA...,1,-1,-14,13
EdZQHSMPBafOATDFILXbKRJNYeWCGgUVc,FDABLDACKCFH.JHAGeBCHGBFG.UABFEFBBZFEB.HECDSAHHhAAABHHGOAHBhAAAAHHADDID...IBBGhABAbFCA...NACFCEHCgEAA.dHEDhACAMIAE.aGGGfEDFhAEA,2,-23,-15,8
SeVHPGLJfKZDTQOIcNREdFYUabXWMgBCA,SDBDeDACHFGFLADEKCGDZBCC.DFFDQFFFOCFAIBBDhAAARDDFEAGC..dABF.hABA.FHAAaHCGXGDHhACAgGAFBEBACHHFAAEEGDEB....hAHA......hAIA...,2,-13,-7,6
VULMBJceWZCGdTQIDKHAfESYFXRgbOPNa,EAFBSAFBFABD.REAB.OGDA..aFDHLBHDMCIDBHHEhAAAJBEF.eDEFCDBDGGAFhAAAdBDAIABDDHGAAIDA.fHFBhADAXDFD..bEAGNCHE.....hAEA......hAHA...,1,-17,-26,9
WNSTGRcQXCLAMYEHUagPfFbKedDJZBVOI,MHFGECFCUDAD..aDBD....fFFAbAAA.KABDDAHBhAAAZACHOEDG.IGBFhABAWFBA.SDHHhACA.RAEFcGDBCAHDAIDCYDHB.hAEA......hAGA...,1,-31,-38,7
BbKLOZVFTQUMIAXfHgaJedDGRSWEPcYNC,HEFHJCCH.eCBBdEHGGEDESCGG.EFBB..PAGD.hAAA.NIBFCABCBAFCLDEFhADAOGFCZAFGFEBH.TAAChAAAMDDDIHHC.AHAA.XADDhACAaAEGDCCE.....hAHA...,1,-5,-24,19
BaIJGOEZMgWdKNeQFTPcCLXRAVbYUHfDS,VAADUCBCDGCC.BFBFaHAE..GFBDZAFC.MDCCdEFBKGHF..hAAANEEH...FHAAPADChAAALABA.AACA.HGFGhACA.IBHHOHDE.WDAG...hAGA......hAHA...,1,-7,-43,36
SVcBNgITFHCPObJRGQfYAXZMUKWaEdeDL,XFCAZFEEUGBAKBHD..aBGEdABGLACG.SHGEhAAABBFB.IFFDhABAHCDCCEAHOHECRDAGGCDD.hAAAfAGHACDGMAEC.EDHF.DIFA.cGAFhADA.....hADA...,1,5,-41,46
CGaKTeLPYQOdZHJEWbSNXUIfBAcDFVMRg,DGHHVGCCRBCAGDBG..TABCLBHFQBFAdEEFHGDAJECAhAAAEGAF..SFGChABAXBAF.IGAChADAAACGMAFA.CAFFKGHH.eDDE.....hAAA......hABA...,2,-16,-10,6
JTOELQUNVZaHKXBReCDfcMWgPYIdGbSAF,FGDDJFCA.EEFGLADE.UBFFZCDGKABABABACCHB..DGID..MAAFhABA....PFFBhAAAICCFGDAAhABAAEBCQGFAaGAH.XDEAfAEAhADAWHAE.....hAEA...,1,-35,-36,1
DVBcSfaXdYQANIFOMEUHbGeRgWJZLCPKT,FHBGEFAGHCAGeECCRCGHJAGF..LCBGKFCCDAEF.BHHE..SFGHhAAAXFFCdEAAQDEAhABAAAFH.NHAH.IABHhAAA.MIEAUGEE.....hADA......hAEA...,2,-31,-20,11
LNKZQdJaWHMPEYXOgIFTceVRBAbfSGDUC,SHBGUCCBCCFA.LEDAKGEFZEFE.dADC.JAADHGAA.MBABhAAAEBEEOCBC.FGDEhAAA.eCHBBAGGAGBE.fHGFhABADIGAaAGC...WBCE...hACAXDAHIGGF.hACA...,1,-13,-44,31
RKCJeTPBVWDFdaNcZAfbLMOXgYQESGHIU,LGEAMIFG.OCBHXDCC.QGCCEGBBSAAFhACAGAACHAFGRFFACGACTADGhAAABDDBDDFE.FEFGaCHFNCCFABBEhADAfDFG.gAFH.hAEA......hAFA...,2,-24,-1,23
JODHIMdKXaRSELYPTGNCWUfQZcFBgeVAb,JEEGDAADMEAA..XCABREFHLFCB..TGCHCBGC.UADChAAAQBBGFGABBABChAGAVFABOHFEHADD.hAHAIHHGKCFGEFGF........hABA......hACA...,2,-25,-24,1
VCZKBRFHTGSAgILePdWMcbDNYQaJfOEXU,LGEAdDCDMFEFDDBFQDBB.aAAFOBCA.UAAGVDFEhACACBHE.BAEGHGFASGCDhADAAHAB.IGAEhAFAPDFH..bDGBNCCFfEEE.hADA.EFCB....hAEA...,1,-17,-29,12
KHCMdJWeIDUfEYZOaTbgXFGPSBQLRcAVN,VDAGKCFCMBDD..dFEGeEABDGGC..EGBDOBEH..aDHDTCADhAAA..XADAhAAAPEGBBAGF.hABALACCAHDDNAGEJAHBIBBFfHED..hABA......hAIA...,1,-30,-32,2
JRYGgNPKbMOcdfXFSHQeAZWVIDaTUCBEL,ZGFGVAADaDFF..UGFFEHAA.LEBG.RGBG.GFBH.PBDEhAAAMDDEdAFDFDBESBABhABAeDGFAIBEDCDCCADCBADChACA.JAFA.........hAAA......hACA...,1,-16,-26,10
ZSObYKgAENdRCDaFeXHcUfVQMWGPTIJBL,EAFBdCFCDGFFFABD.HEAEUGDFQADG.MBHHGDBA.IEFChAAABABA.SHGAhABAYHAGAEIBCGGDeDAFhADAfBAG.WDDHPAHB..TGGAhAAA....hABA...,1,-20,-30,10
UQdBZceLASWIHDKPYRMfXNJVbFEGOgCTa,SHBGHAADKDDARGFE.MFEB..XADBJDBH..FACGOBGDhAAACDEGUFFFBGEC.ZGAChACALAGBICCHDAIFhAAAfAFA.NCIA.EAFB.gBCAhABA.aGHD..hBAA...,2,-29,-14,15
NdTKHMVQXbRcBGOUAZCPLEJYgFfaDISWe,CFDDEDCD..JCBC...FGGEfAHC.IHEAeFBBdEFBhAAAKFGFMEABQBEBhAAARACEBDHB.UGAE.AEFGLCAChABAaCFGDBAD.NDIA.......hACA......hADA...,2,-42,-21,21
JRYgQFSBHcfDObVIMALPdEWZXaTNGeUCK,dDCDECFCZBBCaAAD.GDGEUGEG.KAGA..RAEC.QDBH.FGEEhAAABEFDHFBAfDGBhAAADEEC.VEAFAIHEPADGhABA..TGCENIADCCAD.....hACA......hAIA...,2,-31,-5,26
aSTQZLUKNdVfBMOgEDRCGeYIbJHXPcAFW,FAFBaAFB.QEACZCABKDEC.dDFEBDHD..OHFADHGCRGBA.CCDDeDHDhAAA..IFGAhAAAHECFPABCAHAH.SHAGhABATACC........hAEA......hAHA...,1,-18,-46,28
ZcgXRPJbFEIAUCOYDafKQNGHdMLTBWeSV,CFEEOFCHDCGD.KAFEGDGAHFECLEAEBFBB.eBGFSCDAhAAAZBBA...XABChACAPABAFHECAECAaAEGNBFCMAIDhAAA..WHCA.....cDABhADA....hAHA...,2,-51,-5,46
KLZXEFVMAdNBUIGaRgTObQJHYSDWcPefC,BFEDUFGHGEBFaDDE.RBGB.OECH.QBDBJAEHHBBFDICAhAAA..PFABCGAGKBAD.hABALHDGEGDA.MAAEhAEAAAFE.ICBF......hAFA......hAGA...,2,-33,-25,8
DVTHBRWFdeUIQAZPNGOKMCSfJYXcaLbEg,ZAADGAFEMDHHSHBE..fGGGJBAA.XGAHhAAAcACFLFEEhAAA.EDDHDFEG.TBEGhADABHEHFEAGdGECeAFEIHHGADCAOEAAhAEACAHD......hAIA...,2,-26,-15,11
ELaGHcFNeBWbOPKCYUSQTIJZDfAXMVRgd,XFCARFBGdCHALACGGBEEFEEABACB..OCCCCCDCUFACQFGEhAAA.JBABDBCFhAAA.fFGGhABAAAGC.MIBAEEAA.cAGGNIAF.eHFG..hAEA.PDHD..hAFA...,2,-26,-21,5
XgWbIBYcECKUGFSTDNdLQJVMZRaPOAfHe,HFDFeDAC.XAFC..gBFB.IAAChACABCGDEDAECFEDKADCFABDDDIBNECE.hAGAdHAB.JFFCMHEGZEAC.hAAAPEEAAGAEfCDCWBHB....cBCAhAHA....hAIA...,1,-17,-31,14
OUCNXSGZEgMDBAJTVRFbcdfPLHKWeaQIY,TAEGRDDFFBGF..dABGLDCCKGHF.eDFHQFBCOHFACCBF.hAAA.SADBhAFAEEHFMAAGDBBAAHFD...bGAGhAEAfDBH.WHAA...IFFGhAGANEEEXCGB.hAHA...,1,-8,-43,35
ZeGISBcDYLUgfHVWaTNPbMKAXFQJCROdE,XFCAFGDDQEBERDBA.dCBDEBHHZDFGeGFGGAAFBHFD.DBFGUAGAhAAAHAACaHGA..PEAHhAAAMAFF.AFFGJDHBIFHHhABA...SGBDYCDC..hADA......hAEA...,1,-9,-14,5
HeEDOKCSLNcQAVfgaYJMGWRIUPFBXbTdZ,VAADaHBG..MGFCREEG.UBAAFBGFBADC..XAFFdEHEeHAEhAAADEEC.KHEACCECLAFChACAQECG.fEAAhAAAJDCBGGDFIEHF....hABA......hACA.PAHD.,1,-16,-20,4
ReVYbCEAZcKdMaUgJBIQWDHfOLPNSFXTG,ZDAGKAFBMDAAaDGD..UFBFBHEF...QEAADGIFHABD.LFEEhAAASGADFCHFXABChACATFEAeADGhAAA............hABA......hAFA...,1,-29,-38,9
VLJRQZTMISGEaYPOcNfdUgHXDACWBKebF,BBBDeCCHFBFHLEADRBAH.QCEAZBGFMGEA.GGDB.ECGAhAAAaHAEOADG.NDIE.hABAdHFHHDCBDAABAFECCFFB.KFAAhABA............hACA......hADA...,1,-7,-33,26
GMgRZdHBQJfcPaTFUCVEbONDWeYISKLAX,MGCERGFGHDBBBEEBQDGF..fFAHPHBE.aBAFUAFAhAAA.EADGOEHHhAAANDECDCCG.eCCG.SCADhABAABAD.GAFG.dHAB.JHDE.hABA......hACA...,1,-13,-15,2
DOaFILXCQPgUKMbBTGVWEYRfNHeASZdJc,SEHBZDEDJCBG.OACGFEBFLADG..CDDFQFBFhAAA.PFEEhABAKABDBFHFVBEEEBGCfHFHhAGANIED.AAHADHDGaHDG.ICBD.hAAA......hACA...,1,-13,-45,32
BeCfTLIHdUVcaPZFSYgOMQbEWDGNXKJRA,BEFAeAFBCCEDLEDD.dAHAUEED.aDBEZAAF.FHFE.SAEBhACAOACHMFHDEHBG.hADADIDA.GGAFKCCCAEIH.hAGAIADC........hAAA......hABA...,2,-36,-36,0
egINMOVKFRbTXPDaZHJBGfEUdYLQSWAcC,CAFBeGEA...IECBOCAGKBHF.REFE.TBGCDEDG.aDAFZADFhAAABGBAGDBE.EGGDhABAdCDB.LEEGhAAA.WACEAGDDNIBF.........hACA......hAHA...,2,-34,-27,7
CJcVTXFdWDGAfPUMgYbReBZQKOHNEIaSL,UCBCMCCA.....bGFERFFDZDBG.KDFGHBFCEHBA.SFDHhAAALACGCBHEJADA.VDFFhABAFAAHDGBGAGAE..PHAEhACA..eFHBBDDB......hAGA......hAHA...,1,-16,-29,13
NeXBbGPgfAZdLcFRJaODWTIMCUEVSHYQK,ZDEDLCCHFHBEREBE.aEFD..DBDE..TBEECDAF.UEAGEBGBHBAChAAAKDHH..eHFABGHGhABAPHBEADEHdHEFOFABhACAMABASEDH.YAHD.hADA......hAEA...,2,-28,-11,17
eRYIEZBSbTCGJPdDcWVaMOHQFNALXUKfg,LDCHXFCAUAEGKGDHeGFC..RCCHEGGFBCFF.SBAAhAAA.CADDGBGEhABAdHADDFGGcAACaGAB..hABAMAEEHDAB.FACCAEEG.fAGF.hACAIDHG..hBIA...,1,-21,-23,2
fOBNEDJXcWPeCbgQGUMYHFITVZAaLdKSR,aEEDLEGH.SCDFRAAFOADBEDHFJGCE.....XBGGhAAAPAAC..CEAHQBGGhAAAMFBDHGEGFEDBhACAIEED.........hAEA......hAFA...,1,-24,-34,10
RWDKJIgfGFLdCeScEPabTXAZMNUHQYVOB,ZFACUFDBQEFHOAEDBAABDBHH..JCAA....fHABhACALABGdHEBSHGEhADAPHAE.TCCEhAEAAFEHMFIBHCGH.YEBHRBED.KAGD..hAHA......hAIA...,1,-20,-24,4
JZXLAFBMPCcIDRQfdHSOWTbUaVGYKeENg,MAEECFDGDGHF.RDGH..dECEHAAF.OFBD..bCDBaFGAGBAGhAAAKEAF.EACE..JHDELHCAhABAAAHHFDEH.cCFGhAIAQADC.SBGGUGGF..hAAA......hACA...,1,-1,-35,34
YUEbSgLeBDCRNKIaOfJdMQWcHTFAXGZPV,GACFZGFG..PAAFVDDDUCGG..EEHHSBBDhAAALFDHBCDDDAFARFGBKFCDaEAAOGAEhAAA.fBGFhACAMCAH.cDGBFGFHAAID...XADAhADA....hAEA...,1,-19,-29,10
BWCDgadRHOALPUFISYXecGZETbNKQMfVJ,LDACFGFC.SHGAXCBEGFABZABCEFCG...NAIA.MICEhAAA..JBFHCEAHaAHDhACAHABAAHAFUEFCeAEE..hADA...bGBCfHDBBCEAWAGDDFFE.hAEA......hAFA...,1,-14,-22,8
EWDFRZcebYGUMVgNCLPQTSHAOfdJaKIBX,dDCDJEGH.KFEABBAB..EBGDFEAFRFBD.ZFBD..eBFDGEDGUABD.hAAA.MAHF..NHEB.hAAALADF..hABA............hACA......hAFA...,2,-43,-42,1
ZCDTAcIWRKfNQXJEMSLHOPUYdGVebgaBF,..IFDGRDAGKGHHQGBH..EFFGMAAFSDDChAAAHBBCOAGHPABEUDFFhABAGEAEeFAFaAEFFGFDDIEGhABAAAFF.WEHB.fAHENEEE...hACA......hADA...,2,-18,-9,9
KQfGbVMdaNZOEcXegPDSHJWCUFYBTILAR,QCCBGAFEMBCHdDFHZEGDEHCA..eBADDFBFHAAECEDD.FAGDBAEAhAAATGGHAEAFKFEB..hABAfAEEaHBC.hACAcFFB.........hADA......hAEA...,1,-10,-33,23
fLQMBUcHgSXAJNaZDYPWeRTEbIdFGKOCV,aDCDDHCE......PBDDeAEHTDAEEHEA.dGGHKAECOAABhABACFEBLAHFQDGEhACAUCAHHCFBSGAFhADAABCG.JEEF.NICHWAFHIFCE.FGGAfBCFhAEABAAB..hAHA...,1,-17,-22,5
HZKMTCPNgYIWLJAReVFDQfdXGBcaSOEbU,RDBGeDCHFHCC.QGDAdGAGGBCHBGFA.SBGBEFGCHAAEZCFEhAAAKEEGMBBECHHE.NCIA.IAFFhACA.JHEAAAACfCADhACA.aAFH.OEAB.hADA......hAEA...,1,-13,-15,2
GHQYWNASKIJMREdDPcLFbegOZTUVXfaBC,SAFBJCCH.RFDE.DHDELCFAFBEA.eBBHZDGBUABF.hAAA....XAGFhAAAaABBBECEGEAEhACAQADG.NEIGAHAEIHHBMEEEEHCG..hAHAdEEC.....hAIA...,1,-21,-34,13
bgTSVaLfFZDCMQUREIWXNGeAHYBcdJKOP,BFDDJCCH.OBGF..PAEG..bACDSEHHhAAALBAHFGBCCCGC.MCIBRFEDEABHhABAXDEHGDAEAEED.hAAA...YGEGcCGDKHBA...hABA......hACA...,2,-32,-22,10
QLHIaebAGPdDJNFVfgCKYUMcSBTZREOXW,dGAHDEFHFDDB..fCEDCHCD.UDCEMEBHBFABRGFA.EGGAOBBGhAAA..XAEAhAAAQEGHLFFDhABA..aAGHAHIDJABENEAG.KDGGSCFGhABA.....hAFA...,1,-28,-35,7
DQYeXbGHRUdgELVNKaSPFWMZABTcJfCIO,TGGGJGEA..CBAB.DEDG..QDGHeCBBGADDRAFC.gFDChAAAECABLCCGNIBB.hABAKHCG..SGAGhACAFFAE.ZCGBAAFGBECBcEACIEEHhAAA......hABA...,1,-3,-34,31
AQcOdUKBgGPNSIbMfaELWFYXCHDTJVeRZ,QDACdDCDUGFCKBGHBEHD.GGCB.SACHMFAHEFBELEFChAAAFDDACGAFHAEEDIBAhABATAAF..JADGhACARFFEADIH...OECC.....hADA......hAHA...,1,-2,-40,38
EINAaUQFMRcTdLCKDYJbHXBfPOgSZVWGe,aEHBUFCA.FGFEMBEB.RGBC.dCGHLDBHCFAA.DABHJBBHHAGH.hAAABEAHOEDAZAEH..hABA...VACEWEFBhAAA............hACA.EACFAHBB....hAGA...,1,-22,-47,25
JcUVMYeDabXPICZWBOANRgGSEfFTdQKHL,RAADSGAHFEFG.QAEELDHBJCDCUDAC..MDDHDEDAXAADhAAA.CAHEBFHGhACAACGAGGABEGFEdFDAhADAKDBB....cGGC.eAEAaDGB.IACFhAAA...hAEA...,2,-25,-23,2
deCQNAIaZfYBGEMFSKOgbVRUDJTXPLHWc,aCFCZAADBAHEGFBDFFHBKHAA..OECH..VBCHDAGB.JCAB.hAAA.TCCALACChAAAHGDAdAHACEFG.AAGFIGGGhABAEFAB..MDFESEEE..hBAA......hBBA...,1,-22,-31,9
MIUNRFcAfBLWDYZdGgJTCObXVPSKaeHEQ,BAFBLFCHDBAEdFGHJBBB...ODFB..XFFG.hAAASAFBaECCECGCMHBChABANAAH.FDAGAEHCfHAFhAHA.ZDDAGBCHCHHE.PHFAhACA......hADA...,2,-33,-31,2
dcZWbeTYFNRXLOMafQAEICJHPgVUSGBDK,CFEDJFBBHBFA...VEAAUFDD.SEBCGABDKGHDZBCE.eABFhAAATCDC.FDHFNDIG.hABALFFB.MIAAhAAAfEFBAHAAEAGEICACBGGEDFAD.dAEBhADA......hAHA...,1,1,-30,31
GdZTXAKQYBPHbcaOCILgDWEVJMURefNFS,QGBCBFDGHAFAaEFDCBBDLFEH.DBABVBCC.MIAGUAFHhAAAeDHHFBDFGDGEhABAdAACXEAHAAIFKDEA.PHEAhACAOEAB..IEEH....hADA......hAEA...,2,-19,-16,3
bYCEINRGAaXWfHePOKgFdScBLDVTQZUMJ,XGBCHAADOGFCKCDA.FHAC.dEDBBAHEDDCD.QABAUBGB.hAAAJFEECFDA..EFGENEAA.ABFH.hACA...aDAHeBEEhAAASCCELEHB.TDBB...hADA......hAEA...,1,-22,-24,2
cUMTJHQLXWVSgRCEfadYBGZIDAOKPNbFe,KDCD..bDEGFGEBUGAAMBHFHGCC.LAFC..XAFFhAAA.SBAEhABAgBBGEBDGfCAGhAAAaEFFdHGFBCACICFBAAID.OEAEhABANCIG.TGGG..hACA...,2,-30,-20,10
XOaJCVFQAfNERKgSDGBTWMHZUYdIbLePc,EHBGRDAGKGHHDAFEGGBH.BGFBTCGH.MAAFZACEdAAG.LDFAhACAPAEB..OBCDhABAaDDF.JDADCCGF.VFDDhACAAHAF.....fEEBSBGEUGGGhADA.....hADA...,1,-6,-31,25
JLAXRIWbESQUFYHCBNadKgMPDZcVTOGef,REFH..bDBHSGBH.QCDFUAACFHBACFGHaDADKGEGMAIHhAAAZBDB....TBFChADAOADA.fBBEhABAAEFCIEAE.EAHBBGDE.NIEB....hAEA......hAFA...,1,-14,-32,18
EACcegOYMWaFNHTKSdUPLIfbBDJZRXVQG,CAFBeGEA.ODEHMFGDFACBHAAF.KDCFdECBLAHB.IGCAhAAABBAEJCDG.ZEAFXAFGhACAGCGAAIBAgDFDhADA.WHEAaGDE.SGAFhAEA......hAGA...,2,-41,-14,27
NaGbgFMdKTcILXePfODWCESUAYJRBVHZQ,JFBBBEGHHBAEZBEDQAAFGEDE.FGDDKBEH...IGHAhAAALEAF.eCHBfAFBhABADFFFCEBA.EEAHACGB.hABARDFFaDDBMCDF.dHGB.......hACA......hADA...,1,-18,-25,7
bUQJXKeLcVfZMABGCdPFNIHWRSgTOaEYD,CFDGdAFBFCABHAAC.RFFF..SDHDOAFGEGHDDGDF..UCFDXBEGhAAALBBH..hAAAfDDGAFGEBFFD.hABAGDAENBIA.........hACA......hADA...,2,-42,-17,25
AVeQOgMTaBHPfJLdUcYSIDFRXZWNGKEbC,eBDGQDACMAAFBCCDHGBEJAEGLDGBdDDGUCFC..SGBBhABADIDCRBAGZFFE.WFEFhACAKAHB..CAAC.AHHFOAHFhADA.aBBB.fDFE.cEABhAEA.....hACA...,1,-18,-20,2
QcBIYAUSDdTMJXVbeGNPRWgFLHEafZCKO,DDFFTAEDMDCD..JAAB..XEGG.eHAGGCFARACDFEADhAAAHEAA.fHDBhAAAKHGEQAEABDDFAICAhACAdGDBbFGDNAIE...WBHBEBAB.CHAA....hABA......hACA...,2,-15,-12,3
gWKQIbRSVXfEJAPaGTDLdZHYcUCMBOeFN,GEAHTEGD.DGFFLFCEZBEAHGAAUBCFMAAAeHAA..NDGC.KAFBhAAA..QBBAhAEAIHHASDGChABA.fAHGAAGBdEHACEEB.BFAH.OCAHhACA....hADA...,1,-14,-20,6
SKEYAOQgbFRMCBJLWGafXedVPNcIHTUDZ,ODACQCBCFGHB.CHHGLFDEGBBH..aBGGeADA.dCGHPEEEhAAAIAAC..hACATFBCDAHFKFHBAHDE.bGBEhADABAFC.fHABNEAA....hABA......hACA...,2,-31,-13,18
UMBSZFaADLcdCVeHQERKWfXPNIOgYJTGb,DEFHdDCDCBHBeECBHABARFAF.KDAF....XBEE..IFHGhAAAOAAC.JFCBbCAEUGEGhABABHFFFGAF.AFFCLBFFhADAVEGFEAGE....fCHEhAAA.NEEE.....hACA...,1,-23,-26,3
MLSPgeJNdVAFXTWYIDEUKfHZcGOQaBRbC,FEHBXCGC..TEEB..WAEADBHBKGAH.HEBDZCDFGCAGhAAAQBAGBACAhABACDCBMAAEPEHFJAFFVFCBhACAAHHB.EGABUGEFfHEH...hAEA.aBEH....hAGA...,2,-19,-9,10
ADgcOeLFXEIWPHKCJBTURSdfGaQbNMVZY,DACBOGEAeAEDLBCAFFBE.EEBG..IDDHHAGFJFABBAFEhAAAUDEGdEGG.GBAEhABAaGBD.QGDEhADAMEID.....YAGBAEHHcAABWFHHhAIACADA......hBAA...,2,-29,-13,16
QcLXWeRFOHSJCTKYZfVIadbGDUEANBMgP,BBFDMCCA.QEEDLDEGeFDGOCAGSDBBCGBD.KAGEhAAAfAGEaGBA.hABAdDHCDFFGUEABACADNBCD.PAAGhAEA..WHCA.FHGETCDE.hACAZGEE.....hADA...,1,-12,-25,13
FKPJAVBUIOSYTLWcHaRZbgDCdeXMfNGQE,BADCUDACOGDGSEFALCGDHGEEaCBBZAEB..DGHBCCFGeECHhAAA..XDDGhAAAMCEHNBIE.EHEA..FBFAKBAEhABAABADIGAE..TGBF.cACAhAEA....hAHA...,1,-18,-28,10
OSefDMRVWZAGNFPJIHKBaTgYECLdcbQXU,FGAHJGEAHCAFBFGG...aCFHTEAB..EBHFCACGLEFChAAAdACHQCCAOECDfGDEhAAADAEARBDB...hABA............hADA.WHFEACGHNDIEIAGGhABAKCCD,2,-43,-32,11
SeKacNGIWMZRdLBPCOQTUDfgVEYHbAXFJ,XGGDFEEDeFADKAAC..aDEDGDBA.MFIBdDCFPGAGhAAA.CEGD.OBCGUABHDFAGhACAfHEHEHEAHAEEhAEAAICAJDGDNBIE...ZBEELHAABDAC..hAGA......hAHA...,1,-5,-17,12
IFXYRPHNTZOWJDcQfaGSbBgedKCVLMEUA,XGBCRAADHDBDZDFC.OEABJGFG..QABDaGFG.GAEChAAASBHHBAHHdDDEhABAVADAEEAE.ADGCIEGChADAFGHDPHCC..NICF.TEDH...hAEA......hAGA.DCCFfHAF,2,-18,-1,17
OZJdLFbUcKaMXGfDSHNWeRgEBYIVPCAQT,QDCHOADGZDBDdGGCFBGCUEGF.KBAGXAGE.DFDCNIDB.hAAARBAH.BCDE..IHADhAAACADHADFC.TDGFhABAJDAF.LHCEaFEDMHAESBFGhACA......hAHA...,2,-32,-24,8
DYCTIWagVJSPGQdNfFOMEZXebULBAcHRK,HGFGKGGEDAFBTDEB..aABEJADCGCEHQCCFdEBD.FAACMFFChAAAEGAFZAGF.XFCDhACAeCACUGAC.AEEH.hABAcEGBCHCB.........hACA......hAEA...,1,0,-31,31
OUIZVLNdFbYcXEPBTCJRKHaSGfQWDAegM,MDEBODACZACALFCHFCGG...bEGBXGAD.BAGChAAACCCFKCGGHBADaAFASEFDhAAAfFGHDIDAAGBEeABAhABAUEAF..IBFCNDFA....hACA......hAIA...,1,-19,-28,9
AfPFGWQVaTSKHcXdNORZMBIbJLEYCDgeU,FHBGQAGH.aHGEKFAD.HEEGdDDHRFAGMAACBBCEJBDHLBAHhAAA.EFGHDDID.eCFChAEAfGEAGCBE.hAFA..WCCDSGHF....hAGA......hAHA...,2,-29,-16,13
GAQWETHICdZgVcPaJMbBfXFDROKUNLeYS,EGFCHEFHdDDFVBAC..aBAHMIDABAECFAGBDCCHKFBH..UFCELDEFhAAA.eEHHSEGAhAAAADHBQADEhABATCGDCBHAZDAE..cAFE....hABA......hACA...,2,-44,3,47
CBNGIeVKWgXcZaHJOTMDRUQAFSPfLdYEb,FAFBSHBGLGCAdFDFEBBABDAB.GCCHVEGF.KEHB..XDEFhAAAaFABHAEETDAAhABARAAEAHDA...PAHFhACAfGGECECA.ICHHWHAG...hADA......hAEA...,2,-22,-16,6
ESZbPGQOHXVcCDKJTUaYBAFLfgNRMdIWe,LCCH..NACERCFDdEFH.IGBDEBDGZFGDGEACOFDCHCEGhAAA..XDCDhAAACBBFKAGETAECaBADYAHBhABAFFHDMCAD.eHCC......hABA......hACA...,1,-11,-17,6
HQZbFDTaUGYLVNKMOPISECcJXeRfAdWBg,BFEDQFDHZCFHDAHBUADELBCBKCHF..MIFGOBBB..hAAASCBFCFAB.hABAXBFFfHGFhACAAGAAdGGD.HDDCFAECaGAEYAADNIBF.IHADhACA....hAGA...,2,-33,-23,10
OLdAfIPTXWVNbJQYCBZMeHSREcFUgKDaG,..IFDGPDCH....XBAGVADAJCFEQFFHhAAA.CEHCBGAFMBCFeAAChAAARAFEEEEH.UGFFDGDFaGHDhABALHBEABBA.WDEGbBDG......hAGA......hAHA...,2,-30,-9,21
HDAMQGSFgLERKUbNJedaPZWCTVfBIcOXY,GEDCSAFBLBEAREAG.UDAHJABGdCDEaFHHZACH..TFEChAAABBABOFAFHDGBDHCAhABAAICGFDFGKGHB..NICB..hAAA..eBHB.CCCD.......hAHA......hAIA...,2,-24,-15,9
VSYHBRJgdAKOfaWZQEbXUFCTIcDLeGMPN,OCCHaHBGZDCF...QFAGEEED.UEGDCEAF..TABEhAAADACCLFDHMADAPHDChABASABG.BAGEhAAAgBGFAHHEfDDB.XBEAhAFAIHHC....hAHA...,1,-22,-33,11
QefXHcbMIWBVDJKFRNZdTSLCYgOAUaGEP,aCBBEGAH..eECBHFBFMDEBBACB.DBFAJBAGKEGB.FFEFZBFC.SFGAhAAACEDF.OHDChABAGCEF.fAABhAEA.XGGEIEAC..WFAFhAFANADF......hAGA...,2,-31,-24,7
QMGUXIHAOFDZYgEKbPcWVTNSCLBJedRfa,DFDCZAADEEFGKHGE.......PFBAVACG.SHBEhAAACEGEBCAE.JCCGeAFG.dGDAhAAAfAHG.hABAMEAHGCDFIGHD.AFFFOHEChADA......hAEA...,2,-44,-27,17
SJWYdfEBAFZeVRODIHNXPCUGKcLgTQMba,FDBDZDBGeHCARBDB.ODFGDHCGHFFE..XBBBCHHGKBAG.LAEAhAAAQAGFMCFA.hAAAaGAHSADEhABA.JDFEYFEG.fCAAhABABHACAFHGNICF......hACA...,2,-24,-24,0
UIebGMONCTRHVaXWQYfLKFPcBEJdgASDZ,DEFEUFDHeFDHMAED..OAAFCAAC.HFBDaDBB.QCCBhAAALHEGFACBBACF.dGFHAIBGSCHFhAFAIAGBNEAA.hAEATAFF..XBFCfDCA.hAFA......hAIA...,1,-19,-30,11
bAEQcVZYIOSeFPaUNHdRLWGXCfgTKMJDB,QGBCVGFG.ZDEAOABCFAGB.UCEGdDADRAACLDCH.hAAA.XGGECFFC.hAAATFDEJCHDDEACBBHAhABAAAHGEHCE...IFAE...SBAGhABA..hADA...,1,-23,-34,11
cEYaHCABPeOWLQKFXMIGTgfUSNdVbDZRJ,BAFBeEEGLHCAKBBGFGDH.MCDGGCGG..fAAFhAAAUEAGdHAHDDBGZAFCJDAD.EHGAhADA.aCFECBHBADFD..WDDFhAEAQGFG...IADFhAAASGAH.NBCE...hAGA...,2,-38,-12,26
DXVJONMYSeFURbKcIPTEACHZBadLGWfQg,HCDHaBBDGAEBQBACDGHF.JAEE.MGEASHAE.UFDAhAAAKHFAIEHChAAAEFAAADDGBCACLHBG.hABAfEAAgDGAXCGCNEAF..hABA......hACA.FFCF.,1,-14,-21,7
XSdUAVWROYIacKgPQbGNTfZEeMDJFLHBC,VGFGRFDFODAD..aAGDKHBA...QGFEGCEETEBDhAAAZABAeCFBDBEBFABCBAHESGBAhADAADDE.ICCEhAEA.........hAAA......hACA...,1,-19,-40,21
PJXDdaeAYbfRNQcBHUVZCGTKLFWOMEIgS,...bDAGfBFC.QEGABHDHVEFCZAAFCFDDKBFBFFADMIFAhACA.EEEDICDEhAAASACA.XGEChADADAGCeFBBAECD.YACENDDA.cBAFhABA.....hAFA...,1,-16,-30,14
TdbZfXRQcBeJOHaFgGVDCMIYLSWNKEPUA,dGFCZAADRDCCQEBEBBHC.eBHHJEFG.aACCGFAH..CGACMAFGhAAALAFF...hABA.WCCAKHGEECCCAHHEbEEChADA..fACA.OHDE.hAEA......hBAA...,1,-25,-26,1
WPAMHFdQJXTfbURYILNBeaKOEcSCGZVDg,FAABdGDDJFBD..TAFHUADA...REEBLEDFBEDBKAAC.EHGE.hAGA.CCCD.ZDBD.DADC.hAHA..PBHDADFAQEGEhAIA..fCAA.IEGGhACANICF.eHAGhAHAaBFA...,1,-26,-49,23
gMGFJLEHZIaVSYPfBCTUAcbNWORQdDeXK,...NCCA.OFBB.RFDDdDFFXBGEMEBCFBBHJEDD..LCABhAAAEFGAHADHaFGG.SHGEhABAPAHD.BHAGhACACHHEADAB.bAEBDABG..eBBE.KHDA...hAAA......hAFA...,2,-23,-11,12
CcIbDgKaOLJNSZEYXVPQeWFAfRMUBTGHd,RFACBFECGADECADA.....IBAEbCAAKAAB.OEGHLDFBhAAASCCDEHBC.VAFAhAAAQAFFFHDCAGIHMDFBhABA...........hACA......hADA...,1,-14,-43,29
JYRWNPBGTEbXcIDgdQCUeVafOLFKAZHSM,HDDFJECC.RFGD....PACGBHEAEGDA..XBFBDAHHQEAHhAAAeHAEaCBAOBCChABA.LDGBhACAAGAASGEHMBIHNDAF........hADA......hAEA...,1,-20,-37,17
ZYfNRMgcAQePHUKTdSWBDJCGLEObFaIVX,QDACeFBBHAEGKCDFSFHBDDFBGEGAOFEBFCAF..VGDGhAAAXGAH.fDGBhAAAMABCAAHE.UDDHhABAWCCDCGCDEACC.IAHH....hACA.NCDB.....hAFA...,2,-19,-14,5
gKDBLSCbUVGfZIYPRaEFcJNWHdQAXOeMT,XFCAMBEAKCBBLDFA..bGFEGECAZACG..IDAEhAAAPHFC.RCFBaCEHFEADJAAChADAHGAA.ACIHTAGEhABADFFCBCFECDCC...fHAB..hAEA......hAFA...,1,-5,-29,24
VLaJWZbcPegTCFNHIGfBKYSEDXAdOMRUQ,MEGFUDCBQADELBAD..JGBCZAFB...PHBGeAHFCHHGhAAAFBBBHBCFGDGCBCFAhABASCADEFHDDEFFAEID.hACAdGEAOFAHaFBC.bEBA......hADA......hAEA...,2,-13,-8,5
dHEcASYaTDRbCZOGQILNXUFeVMWBJKPfg,SAFBTGBC.RFDHZACDOEFE.GDCDLFFBUAEHVEBBhAAABAAAKFHF..PCAHhAAAdBADEAHBABIFDCBA.QGDGhACAXBED........hADA......hAFA.FHGAMIAG,1,-10,-17,7
MIVAdUJXgQWPZYOfLGSECeRbBKNaTDHcF,dGDDUDCHJBFCQGDF.ZBFFOEAGLDAHSGGGhAAA.EBBFCACG....hABA.eDFEBGGDNACDDFEAhAHA.....FCDFMAEEAIBE.WCHB.hAIAfHBB.hBAA...,1,-31,-39,8
CcPXYLgAaQBUdDJOWTGbINKFZSHMVefER,aFFBUABH.DGEHOHBAGBGG....bCCEKGHHZFAEMFDC..hAAAeABGEFAH..CAFF.cAEAhAAA..YHAGhACAAFIDBDAEdEGA..JCDEIHHGSEAEhAEA.....hADA...,2,-27,-27,0
aBIRcgeGDHWQNETUOAYFCZKdbJLfMPXVS,CFEDZFEEdDACLAAB.MEBCVDEGBHADRACC...eBGHDHGGQAGChAAAEGBDUACFAIHEKAFChADA..JECB..fFCEhAIAXCCCIHDH...hBAA......hBFA...,2,-34,-26,8
YcTJRGBIVNFUfDdLPWabSZEeOgHAKQXMC,KEHBXGFBCDCH....TEEFRBBGGBFEBACGIHEG.hAAAFFCHfFBAhABADACEdAHALBADaAFEZBFE.eFAFhAAAODABAIHEQEDBMHDE....hABA......hAFA...,2,-34,-6,28
KPfSdIXYLDceONUTVJbZGHQWFaBECAgMR,MECGRDAGKGHH...SAFEdDDA..XEGFLBFAeGAAhAAAOADFUAFHJCAHZBAGQGGGhAAA.FABDhABABGFGAGDCPDHDIABGDFFHNIAF....hADA......hAIA...,1,-18,-32,14
DPJGATEIcYFaZXLCSRMeKVOQNHgBfWUdb,EGFC..IFDGFDAGZECHLAAERAGHKCAH.OCFHQCEHhAAAHAFDBCHGUFGDdGABDHAC.hAEAJABCABID....YCBChAFAaCCDCAFAMIEENIEB.......hAHA......hAIA...,1,-20,-21,1
VEXLMDCRdfOGKgFAZNebcWHaYTBSPUQJI,ZFDFeGEA....bEBHHCAD.aGBDTGFHBACBUDEA.IGAGhAAAXBAEMEIFhABARDGFfAFHGCCEFAFEhAEAAADG.NIDF...cBGGSCFEPBDF.hAFA......hAIA...,2,-17,-7,10
eEUKSQcOMLCdGPJfAbDXRVBWgFIYHZaTN,DAFBRABHBBEEFHACHDBFZGAC...aBGDTGFE..eABEECGESEEAhAAAOEDDMFFCdDAGhABAJCCAADFD...XGEDhAAA..........hAEA......hAGA...,1,-27,-35,8
ZcXWDFbINHOgJUCYTPfRAEKQGLdeVSaMB,KFAAQDACdGHA.eAHFaDDDBCBHZABG..XFCGFBEE.IHFBhAAAOAAEUGDEhAAACDDC..TEEA.hABAfEHEEHBALAHBMCDADEBE.HFFBhADAYHAAAAEC...hAGA...,2,-24,-8,16
WNIebXQaTMcOJEHKZGASRYgBfCVdPDLUF,SCFCRAADBFEH.CFHG.VCFB..DHECLEAGFDFE..NBDE.hAAAIBEH.eHAEhAAAbGAC..QCADhABAaADBMIFG.OAFCEAGAKEHBAIDAfFABhACA.....hACA...,1,-26,-28,2
ZXAUIYCBfEbPOSMKNVWaQRFgGTHcdJDLe,UCBCCFDGBEFEEFCF..OCDCKAHB....VGFEaAGC..FHGATAEDhAAAHDAEdABG.DHAAhAAAeDHBAIDA...fDDBhABASDHBMEAH.....hADA......hAEA.WFFGRFDF,1,-26,-38,12
YEDNgRHceKWCGJASTafVOMUBdIXLPbZFQ,TFCEaCFC..VFEDMAID.BHEFdECHLAFGZCAAFBGB.QBBFhAAADEBDRAAEHEFGKGCHCHHEAEEEhAAASHGA.hACA.fAEEIGAE.PHAC..hADA......hAFA...,1,-17,-23,6
EgNOWbHaZfFGTRQVcMLdBKJACIYDXeUSP,CFDGDACBUBDHEGHB....ODCAHAAFaEEEFFBGGAFG.QFEEhAAAMIFABAHGAABB.IHDAhAAAeFAD.SGGEhACANCIA.bFADfDAB..hADATCGA...hAEA...,2,-26,-26,0
bHATURPNLgCVFadQXfcYWOGJKeBIZDMES,UCCBRAADLFGFCFGC.FACCdGEC..QCDA..cCFEhAAAOAFA.KFDBBAGGhABADEADSGBFhAAAAICE.PCHFgFBF.....hAEA......hBFA.aGEDYEAD,2,-52,-24,28
bHFUCVdRIAcYSaeXKDGELQPTNWgBfMJOZ,SHBGaGDD.KGDAEBEDLCBEQGAB.TGFH.hAAA.WCHFBEFFfBFChABAMBDBODHF.hACAbCBHFEBACCAG.dGAFAEAB.cGGD....hADA.eAECXBGBhAAAPEFDNABF..,1,-15,-22,7
JMgVZBPSFEdDTNXUQLKHWbOYRfaCGAIec,eGEAMDEBZAABBDDGFBECDFBD....TFFGXGCF.LACChAAAHGBEODFERAGBaEFCGBCFhABAIDCF..hAAA..gDBDSAGC.NIDFKACB.hAGAYEAACHHCAEIH..hAEA...,1,-11,-24,13
XHVeKgDdUCQLPBGJcYMFNOEZSTfAIaWRb,aHBGRAADHDBD.KDGCdDFFUEEDLAFG.BGEDGAEHJDCH.MHAChAAAODABEFHH..SACBhAEATAAB.AFAE.bFGFhAAA.....XACB...hAFA......hAHA...,2,-25,-21,4
gVaXHUBYEQNCIcJSdeOPfDFKTZMGbLWAR,RGFGVDAGHDDH.BGBCQFGHCBFG..JADBdHBF.OBBGDHCCFCAEhAAAKAFC.MCGHLAHBhABAACIH..aAAHXDGChACAEHEE..IEECSGADfAHChABA....hACA...,2,-29,-26,3
PHWBUIZXFKcORLAfeEbgQTVYDMNSCJadG,EDCDQCBC..VGAGDICGMDGHCFGFdAFEHABGBBFGZEEF.XBGFhAAAKGHFOEEBAHHCeACChABA...TECGhACAYCAHSGABaAAG.WCHHFDGC..hAGA......hAHA...,1,-18,-22,4
GdKeNbOPTAaIJSEgFfWHBXUDYZMCLcVRQ,JCCHSAFB.EDBAFHEA.HEEEBHEEXABCUEDHDEGFMAIFhAAACBAC..LAHFhAAARGAGdAEBKDGAeAEB..NCAA.hACAODAHACFE.IBCG...fHGHhABA..hACA...,1,-22,-35,13
VAbLTJECQfUcIPWNdaeKORDgFMSGZHBYX,LDACTGGD.CGFEUGCE..IGEH..PBEEhAAA.dDFFaCABeBAGODCFhAAADIGEMFADSDBDhABAZEEABACCYEFAABHAEEBG.QAFDhACA.fCDBhADA.WHAA.,1,-16,-22,6
JHXBMDURPCGLaTYFbQefZWSOIgdNKVAEc,JCCHXADCBFGC.UCGG..REAFGAEBLHAE.aHGAFFEFeFEEhAAAZAAC..OCABdCBGNCAA.hABAKDGAAFDH..HCDEMFIFhABADBGE.CFHB..........hACA......hADA...,2,-34,-6,28
JXbRVgHFZCGAKfBQUDYENaISMPLOWcTed,BFEDUGCEDBDEEBFG....aCDHSHEELFFBOEHD.hAAA.cCECeBEDdDAChAAAXDCDVGAE.FBBCCBBBAAIFhABAKFFG..fDGGYBHB..MCAHhABA.TBFE.bEADhACA...,1,-11,-35,24
SDWHAGRYIadQBeNJcTLFOKZUfgCbMXVPE,GEDHRAAD.aGGHBFHD.JHCATCDAFCDD.ZCBBUGAECAHG..MAGBhAAA..XADAhAAAEFHFSHDEDACEADFG.hAGAIADFdEGB.NBAE.OAHHfCHGhABA......hACA...,1,-18,-40,22
fDRBVSIOAMFdUGQXLNTJbPWYCKEZcaHge,dHBHGABHLDDHJFFB.....bDFFPCGD..CBECEBADhAAAaAFDHDDHeHFADFCHBHBGhAAASFEHACCBFFAG.hABAXDACNDIC.TAGCWFDD....hABA......hACA...,2,-24,-20,4
BTAeGVMcZOREdSFfUKJYaNbLPXIHWCDQg,eEGHMIDAZACBEBBEFEBAKEBC.....aFADLFHD.IGAGhAAACBDBDEABBCHEGAEChABAVFDFREDEdCHA.fBBAhACA..YCDG.NABD..hAGA......hAHA...,2,-34,-19,15
gDQUaCHTMScKEBNGYFPJRdVIOWZfbXALe,LEEGeFCHDEBBUCFFaAFBHBBD..MBADSGBA.KACEhAAAEDDDBDFFGGEF.hABAPBBFdAHE.IAGFhAAAWGEAfECA.ABEF.CFGB.NEIC..hABA......hACA...,1,-16,-31,15
WYCFMZXdPTOSNLaHbDIQJVEfRAgcGBeKU,GAFEKDABUFEBCCCHFAAFZDCG...dADDOAAHLEAF.HDGBDDHDQAFChABAJFDA.hACAECCGADEFBGHA.eHBAhAEAMBIB..........hACA......hADA...,1,-20,-40,20
WbFOXAMdIQUfNDYHRgCBcKJZGTeELVSPa,MHFGQGBCUDAC.DCADHDGHREEH.BBBGKCEEGABCEGBC.SHGAhAAAaAGFFGDD.ADEFdAHGhABAIACC..fDGEhADAgEEBCEBG.JAEF.....hAEA......hAFA...,1,-18,-24,6
OSUMcKeYGQbWJIRECANDVLdTFfPaZBHXg,VFDGdAADFFHF...aAFFBAGC.HCEEOFCFUABC.KFBCGDEDhABA.QDAChADAJDBAIBHDCCHHDDDG..hAEALEADfGGEPHFCgBCChAHAMDID......hAIA...,1,-20,-25,5
IROeEgQGAPaLNdXWDKMYcTUCHJSfFBbZV,LCCHXGBCDIDGKFGAMAGB..TABECHDHHCAD..JEDEFCEHhAAABAEAZBGB.RAGBEHGA.hABA.gGFGhACAACDD.aHAENAAEdCEF...cEGEfAEEhADA.....hABA...,1,-11,-33,22
PRcLVDaeKZWJbSANfOTUIMBQHgFYXGEdC,OGEATCGC.UEBEMEEHBAHB..QBEFHBAA.gGAAhAAAXAEEEDFBCGHEREAALADFhABAaHBG.KCAChACAWHEAbFFHAFFB..NAAF.FAGA....dDDEhAFA......hBAA...,2,-27,8,35
JGIaeTBUOLWESPKbRXgZAdMYcfDVQFNCH,dGFHMCCA....fHDBVCFHFGGGHEBEGACF.eCCHBDAAhAAALCGBSACEhABAKDAHXFACAEDEDICANBIC.hAFAIBAE........hAAA......hABA...,1,-26,-28,2
HVTBaXfIYLeGKCgbESAWJRDZcMUFONdQP,JFBBZBCFMDGF.UAFDFGGHOBAA..dABGHBEABHFGXDGGhAAA..IEADhAAAeCDDKAFCCGHAECHFAFHFDIDGhABA..QFDFVCAF.aGAA...hACA......hADA...,1,-23,-32,9
IZEURgLSePVGDJNQHTFbdKAMWBfcOaXYC,MBFHBFDGOBAD..aDACCAFCZCFDRDDDLACB.eCHH.hAAAVGBCDFCFNIDD.QCDBhABAFAACdAGCAHGAfFAFhAEA.XGEDIGHE.EDHF.hAFASACE.hAIA...,1,-13,-42,29
ceXNZURgOaFDLBEIbHPMGKTfWASdVJYQC,SEHBdDBDJFAC.QGDDCFFG.eAGDZADA.RDDA.aBAAFHAABEHGhAAAEAAFHADF.PDBBhAAAKDFE..fGAGhABAAIHA.........hACA......hADA...,1,-10,-54,44
XgTKeGHNBOfCaZYWdIAUcMSVRJLEQDPFb,MFFFVBCF.LCAH.DCCFPEAD.FFDFXECA.hAAAKGGCHAEGBAHACDHAYFGDhABAdADGIHADACACSHAGhACAEDHBQGCCgCFA..hADA......hAEA...,2,-24,-24,0
ZVdcGQLYXgeJFDWOUSAIENTbMKHPBRCaf,EHBGTCBCKECE..BHGHCFBHZFDD..dEAGQGFGLFEG.XBEAhAAAJBFC..DADAODHFhABAAEHA..IBCGhAAAMEDARABEfAHAGCDF....hADA......hAEA.gGAGWABD,2,-37,-3,34
FcEdOYCQJDeRHGbSKZIXMLTfBUANVWgaP,VAADaHBG..FFDAdECE..CCDD.DIACHBGB.SADCZEEGMHACLCFGhAAABAGFAACB..hACANBBC.PGEE.EEAFhADAQGFE..eAEF...hAAA......hABA...,1,-16,-39,23
ODFJPaeRKSdBTCEWcXMNZQHbLIGAVYfgU,VAAD..gGBCDFFA.FEBEJEADeFGDKDEE.BAEG.EFEFhAAAXGEEMDBCQBGEhABAHAECLDCHhAAAAIFAfACCOCHDaHCCdCACWEEC.NEIE..hACA......hADA...,2,-28,-3,25
HUMVCgbDRSNYXZAGQFOfWJTLcedaIPKEB,QECBOCCH.JCDCLBFE.dDFAIHFEEBAHHGCCMAFGhAAACFADDGGFRCAC..SBGChABANAEE.ZFGFAHHE.hAAAFHCC...........hABA.fHABhACA.cCGF.,1,-22,-26,4
aQZPGfcYNWHBTOXFdLSeIRJMDbAEVUKgC,UCCBCFEDZBFAGCAH..fCGA..YFHHhAAAHAAETFDDFGFDdGAGSFBChAAAeAFERDEA.DBIHABBDKACAhABAaHBGQAFC.NIEHBFHBOEAChACAIDAG..hACA...,2,-23,-8,15
cBHdTONXfEaFLPDMWRZAVgUYSeQGCKJbI,UFDHeCCHQBEGKCAE..JEHFIEEABBEEHDBEdFGCOACGhAAA..fGBGhAAAaGEDLHAEDADBMBIFhABAZAGFACCH.....gBFHhACASEGECEFB.cBAB.hAEA...,2,-41,-6,35
PNGedAFDfREZCTYKXgMWBIVUOQSbJaLcH,FHFGRFDGECFHZAAA..CGAH.KCAB..MCDDBHADUBABQDGC.hAAA.JDHHLECGhABAHAFC.GAEFAIDADECHfDAAhABATCDC..gFAEIHGF.hACA......hADA...,1,-22,-29,7
MCfYSGDgcKeLQPTFbdaEUBOZRHAWVNIJX,VAADJGEA..CDCH...SFBADAGA.KFFBQABAhAAAFCDCdAGGUDAFOEHD.ZAEChABAADHC....IFHAhAAAfDFF.gGCBeHBG.LEEAhAFA...hACA...,2,-36,-31,5
YTRbaCdWJBeGMfUHONXEPDZcSKVFAgQLI,QDACLGEATECCRCCE..CGEAJACCBCDA.MFIBHDGDXACFhAAADIBE..SFAAhAAAVBFHAHBC.IBAGhABAaCBHdBAB.eEFBfAHG.NIDFEDHFhABAZGAE.KFAF....hAFA...,2,-13,-13,0
ZfLeJNUOPBEWgcKRbASaMTDXIQFdVGYCH,MIAGDFEEQCBCdEECGDFAHFCELAEDJHDE.ODCDBHGHECHDhAAA....WBBBhAAAKAEEABDC.aHAGTBGBhABAIABD..YGBACDEBeBFC.NIEBPCAFhACA.....hADA...,1,-5,-25,20
SJPbRONGMWcKXVICagQHdTLZBFAYeUEfD,eDACEGFCDBBA..SGEE.JDEERDEDGDCC.MEAHhAAAKFBCIADGCBGFQADChABATAFFBCHCAICG.fCAEhACA........hAFA.OEHFWEHB.XGADhAGA,2,-57,-14,43
OaJMVZKFcNXSDQAHbUedLRGTgfCIWPEBY,UFDHdGDBLCHHRABDGBFG..TBBGCEDB...IDFFhAAAEDADOBHFMEAEKHGAFAGB.hAAAXFAD.SHGChABAABAFeEBHWHAGBADH.....hABA......hADA...,2,-31,-18,13
dTMQWEVcGJbKSCZAYHRfBFeUOIgXPNLDa,HGFGBFDDFDHHOCGH..XGFGLBBGdDBBMDEF.EGAHGAEEhAAAKEHBSBFFhAAACHCBAADC.fHCFhABAIABA.gDADDAGGaGGA.WAGB..hACAJEBB.....hADA...,1,-13,-33,20
IcdFgBUSMeGbLNVDXPECYQARKfJHaWOZT,RDAGJCCHHADC..aGEHZCDA.TGFAdGBHFGFEBAAC.UGAEMCAFeEFAhACAGBFELAHFhADADCIH.EBBBCEEC.AFIBKGCAOAAEhAAA...IAHF...SGADhABA..hADA...,1,0,-38,38
YSbXBfZDRTdOAFcKLQMIgPeaVUJEWNCHG,FAFBLCCHMBBF...ICADeEDCUGCAEFEH...CBHH.HBFHhAAA.SAHBhABABCCCDGIFdEAHOCEBAACCKGFEQGFHhACA..aDDGVGAC.NEIA..hAAA......hABA...,2,-42,-1,41
KTCfJIWRQYBbHDNGUaPFMZeLEOAdSXcVg,SFAAVEFH.KBAFCGBF....JCBHIBECRACC.BHFDhAAADAACUAFCaDBE.FDDEMAEChABA.ZFECEHBAAHIBXDFChACA.cGBDfHEB..hADAQBBC.hAIA...,1,-20,-43,23
XEfJQIHDLKFBCWZgRVdOPTSbNYeMAGaUc,aEABUCGC.EFHFQABCHDCFLBCGBEHACHEDZEADRDED...OAFAhAAASBGF.NEDA.hAAAYCAD.AHFF.hABAXGGEfGDFDCHH.WFFBdADAPFBFhAFA.....hACA...,1,-16,-18,2
HLbKaBGYUWDeESZgfIcOPRTXJVCFQMNAd,dDBDHFDFLHAAKCACaDGD.GAEG.UBGEDAACSECBhADAZGFG..fFFBhAAAIGADPAEHXBAChABACHHHMAIHNEEEAEAB.BGGF.eCFF.cAFAhAHAOGAG....hACA...,2,-16,-14,2
XBFfaIWURVgOZNMJDTLdbHGScKAQeEYCP,QGGDEDCD.CAACBEDCaHGAUCGH.RACF.ODABZFDB.MFEBhACADAAAdFAGGBBEKFBG.AIBGeCHHhADA..XAEBhAHAICGA.WBFC......hAEA......hAFA...,1,-30,-32,2
VDJOaUCdRbTNHMAGXKfIcQYEPLZBWgSFe,XECBKHBG..IGHFQBFGEHFE.LFECBEGC.gFABhAAASFCAFBBGhABADBDEaAEGUCBCCHEEbCACTBFDhAAA..MIBGAFFHfAGBcGGE.hACAPFABeAHB...hADA...,1,-4,-33,29
aTCFXVMIgKLPSYJbBNGdDOeZRQfAcWUEH,UCBCEEHBHDEDCHGE.FAGF..MEIDKGCHSBHH.JDAHbFDHhAAA.BCFBdDDGDIAA.hABAOAADZFAGRAFGADABaHGA.hACA............hADA......hAEA.XEEB.,2,-33,-23,10
IAeOZMYHCSDUcNLFbKGQVgXBdWETaPfJR,ZFBGMECGCACA.UFFFLAGF.KHEAVEABBAACdGDC...ECDAaCAFhACA..JCHFAEEEOAHFhAEAHABEDDAE..FGFA.hAAAQCCF.......hABA......hADA...,2,-34,-29,5
ZGLQgJXTfcSVaCEbFNWKYdPHRIeBMUODA,ZFBHGDDCLBABJABC...TCECSBEACBHG.FFADNDDA.KCHDhAAA.dHGB..PHEAhAAAIDCDBFFAMAFGhAEAOACHDIBG.AAFDXEGFfFGF...hABA......hADA.aGAF.,2,-28,-26,2
gHLJEMGdXKRWVNIZFYBPcUSaObDQAeTCf,TGDECFDGHAFALAED.MBAHXCECKAAE.VCAFZDBABGGEhADAUAADSEFAhABAOHEEDFFDeCHDfGGBhADAJHAEdBCENCIAFHAC.cAFE...aFAChAEA.ACHF.....hAFA...,2,-11,-8,3
WVGQJHCgbMLeNYOcEfZSKdaUITRDFXBPA,VEBHGDDC.JFBHCBCG...MDAALAAH.eCDCOCFDEHEEZDEGhACAdHDDUAFD.IHGBhAAADGFC...hADA............hAEA.XAGEAIAAQABGhADA.,1,-29,-33,4
LcIEbVdCZMPXAHDWTOJYgUeKaQFGSRNBf,DHCETDACOBGH..JDDAUABG.KBEFFGDC.SBCEhAAABHFDLFFGECFG.dDBHMABGhAFAAEAF.HEFC.gFBFhAGAeBHB.aAHHRFAANIAFcGGE..hAIA......hBAA...,2,-32,-16,16
fFXYMAbRDVWHBLJINgcKSEUOePGdTZaCQ,DHCEVGFGHAAC.BFHCJBAD.....NEBB.KCCDUADEeHCEdGAEaAGDhAAA..QCFEhAAAFFBEMEDC.AHHD....hABA..WAFAIAFGSGFH..hABA......hAGA...,2,-35,-35,0
cfVZDLNTEdJXMeISBRYbaQWUKGFPOHAgC,CFDGVAADLACG..TECGdCHEMABDeAGBBHBH..bFADQFFEhAAA.KEEChADAPFFCAIHA.cCEGhAAAZAFB.DIDAJEAGSEAF.aCHD.hAEA......hAIA...,2,-30,-12,18
aGRXNDOSIYefTBUCVEWcKMgbAFQPJZdHL,QGBCJFBBZBAE.dEEGLEFDRCFD.DAFGIACD.eEAAhAAABBFDCCCF.VEGFEHDCKAEFhABA...MAHFhAFAAIHAHDAAaHGE..NAIE.SHCA.fEDAhAAA.WAHHhABA..,1,-18,-35,17
KSIHcZBFQLAYMGPaWNRdXbEVOegfUJTDC,GBGAaHBG.RDBBdAAFXFEB..bFDEOBEF..fAEChADATCBFCBABIAHAhAAAHDDABHHE.FHAAACIFMDAFhABA...WEGBEEAB.eEBAUBBFDBGFhACASAGF.hADA...,1,1,-30,31
CQaASRBdbeKVGLFOWNIcHgfDMTXUYZPJE,BCAHeCCHGFEHODDA...IAFCHEAGfAECDBCF.hAAAMIBC.UAGE.hABAZFFEPAHDCABHADHCdEEDKBEDhACAFHFEcGDC.XEAD.YEFChADA.EHAA..hAEA...,1,-15,-26,11
QgdACfGFMDXBLVZWbcHEeKUIaOPTYRJSN,CECDFGAHDGHFBCHC.ZDFG....bAEAEECCUEEA..aGHHOACGhAAA..TAAGhAAARBBEJGAC.SBEChACA.gEADAIFGMIBAXDGFVGDAWCDGhADA......hAEA...,2,-33,-30,3
FURTDGNKIMJHVXSEceZOLBgYdbPWQaCAf,UGBCRFEEDAEAGAGEKAED..JBFDHFBF.XDBCEBAG.eDDEhAAALFFGBCBB.dHFHPABChABAaDAC..AHAG..hAIA....fEGHNEICMIDE.SDDBhAAA...hBAA...,2,-40,-12,28
GbeXMVfWHSFcaCREDKdNQPIBLJAgUOTZY,UDACTAEGGECE.eBHHXCAF.MEECfGFFhAAAHDCF.SCBEhABAcFFCaAAEECEHKHDG.dCGBNAEDIHHEhACABHBHACDGOEAHZEFA.....hADA......hBAA...,2,-12,-3,9
GQRPBVUfXCgFZTLabAWcEJHSINMYdeDOK,EHBGJDCHHEFE..IBDGMABG.eCCBKBCHRAFBBBFF.VDGFhAAA..XFAGhAAAFEABTFEBLHBC.hABAABBBcFEHSAHDNAIE.DACE....hAFA......hAGA...,2,-28,-18,10
XFOgMcNRZBTPeVDUaJEWGYLdKbQCHIfAS,XFCEOCCH..MABERDBABHCE.eFAHVBDC.DHAEUAEHEHCC.hAAAGDFELEEAdAACKBBChACACGGG...IHHChADASBBF.gAGE..hAFA......hAIA...,1,-19,-34,15
ZaWbLEQFdKTHIDOgcNMPYXJBAUeGfVSRC,UDACGECF.SCADZAEAaGAE.LGCGFGDE.TCCADDFGOHFEhAAANAIE..MFAFhAAA.XGGHABBGVEFECEEFhABAEDGB.KCEEHBCA.......hABA.gABAhACA...,2,-26,-10,16
fONMeXGKWEdFYUgbJLDVZHBAQIScPRaTC,SGFCRAADCFEH.OFABMHDGGDAH.KBFGEAEA.dCFB.hAAAUBBBbADH.DFFCHDFDhACABAAFAAHDQFAGhADAPEDD.fHGFNEIC..WECD.hAFA......hAGA...,2,-27,-13,14
KPbOVEAXegCQdFMJRSfNUBZWDGaTcILHY,XDACeAFBCCEG.FEFARCAG....SFGEUGCHBCFADGHDTECGhAAALAAE.KCHHOABGhAFAAFFDQEAGhAEAMFFHNAIA..ZBBAaHEEIGAAPHAEEBBE..hAGA......hAHA...,2,-19,-19,0
QDEYITOBWdPeVXNHMJKSaLcfCARbGgFZU,REBHGAFEFGFHZCDFDHAG.EECF....IAACBDACdBCG.eHDChAAA..XAEEhACAMABAKEEHSEHFhADAaEBBLDHFCHBGAHIB..gCBE...hAFA......hAHA...,2,-35,-25,10
eEGaIYJVPcAdZgQBKFSDXNMROWHbLCTfU,dCFCQFDHFHGADAAD.MBEA..RECGHGBGLBAC.CHGHUGAEhAAAGBGGaGGGJDAG..PDDEhABAAAGGBBBF.KFAGNCEH.hACA..OADE..WDAC...hABA......hACA...,2,-29,-15,14
cCTYMARKbNWSQfeJGUDdOEagFBHXLIPZV,RDAGKHBG....NIEF.QFEE.JAEEGABDDIEG.dGFDOCAEhAAAaGCHFDGHBECDHCDDhAAA.XAGH.hABALFAFPDHD........hABA......hACA...,1,-16,-49,33
gWOLMQVARHSCUGdfbZDeFPJBYXcITEKNa,HDDFSFFBUFGGdECCZCGFDCCAeBFE.FHDCBAGA...XFCDhAAAIADAKAEHaGABOEAFhABALCAA..hAAAQDDFABBB.CBBF......hABA......hACA...,1,-24,-34,10
DUWfgTdOQaPEFJVSIcGAYBNHLeZKXCbMR,BFDGHFDFeBGFKCCB.CDADRBDBDGAC.UBFD..fGHGdGFE.hAAAaGAEEACF.FCADSBBChAAA.cEADhABAAIAGLEFCZFFFMAIH..WFHD..hABA......hACA...,2,-50,-3,47
XLMTJaYWQGbDIRgcNUdSEBKZAOeHVFPfC,HFBGVDAG.FCBC.CHBELFFBMDGH..aEDEQBEFGAAFDGAGhAAA.RAFE.NDAA.dHDFBEHDhAAAAHAHOFGDeACC...hABAfCHAXDEC.......hACA......hAGA...,2,-20,-16,4
gaVMSNUXILDEGPBFefAbJKOWQHRTZYcCd,KDCDODACQFEARBAEZADH...CGCCdBGHaGGC...MFAHSFEFhAAAUGGALCBEhAAADAGEEDGGBFBGFDFGAEHFJABA.hABA.WHCG.........hAEA......hAFA...,1,-26,-32,6
SHCAZXcNeLTVgIdfEbOPDMFWaUGRJBKYQ,XFDHeGEALCBC..TFBDIHAFEDEA.ODFBMDIHFCCDhAAAUEAEGACFBDHHQFCChAAACBHCAIAG.hABAcAFFNDAGdFGE.fADBDBBB.aABC.hACA......hADA...,2,-12,-10,2
CgbPZAEFaGUYTDNMWeILXRcKOfJQHVBdS,aDABUAGH.DEGGMHFC..eDBDLBECRFEB.KDHHJHAAHDBGBACDhAAAdABH...SAHBhAAACFAG.PFDEhACAACCEFDDH.TCFH..IAEFcGAB.hAEAfCED.hAFA..gGGB,1,-16,-43,27
LbVQJOCFcNPaUDZIRAfMKXeTGHdSWBEYg,MHFGKGDDeACBHCEGdBGEBFAA.EADALFBDQBADCGFCFBAH..hAAANAIE.aHGAZGBE.IFCDhAAAAAHG..XCEDhABA.SCCDYFFE....hADA......hAEA...,1,-13,-34,21
aYSXeVQRIWADTJUMFcPHfZEgbdOLCGNKB,DECDTDCHMAHB..FEADHAEBZFFA.EGDBdDHCCBCA.KAHFBBAE..SGCFhAAAVFFG.QBAGhABAIDAAAGBBJACEhACA..PDEBfCFA.bGEG..hAGA......hAIA...,2,-28,-16,12
gKUEcReFVLSQCXGNJAHbIYadZMWDBOPTf,HAAD..IFDDdEDEZCCCMHCABGFBTAEGKGHFUAEA.RCGF.eDDAhAAAFDAH.SBHFhABA.CCBGXACBhAGANIAFAFGH...YHAADBGE.ODHFhAHA......hAIA...,1,-22,-31,9
CXHMZcgRKNdFOQEVPJaYBDTWLAeUbIGfS,eDACUCBCGGCBCFAG.MFBEZEDGRGDA.KAHBFBGA..QCFDhAAAEADAJDDC.BADGDBAGLDADhAAAAFIB.IFGDhABASGGB.XBAC.gGAAhABA...hACA...,1,-26,-28,2
AJfOMUTGdeYLZWBKbVPQFIaXEDRCNcSgH,JEEGMDEBGDAAdFBHLAAFBCCA..KCGGVAFA..QAEEhAAAFBBE.aAHFEHEECGHH.hABASEACAHGD.hACAfGHCOECD.TFFF.ZCFE.hADA......hAEA...,2,-35,-12,23
XPbJBOeTQYHgfSCZLMGacVIKWFRDEdNAU,UCGCXCBC..JEBHOACG.QGEDHBBESDEFhAAALFBDaAGGVEGBKGGC.hABARECFDAAFEGDB.AGABBCHGhABAeFAD.TAFF.gCEBfADH.hAHAMIFE....hACA...,2,-29,2,31
MBOXQADVWcgULPEINaRSbfHYdZKCeTJFG,VFDG..gCBCUDBDLAEGEADEaEFARGAE....SCDEhAAAbAFDHGFAdHBDCCGH.hABATECEFBBFBHFH.hAAA............hABA.QFADhACADEID...,2,-29,-11,18
dVLOIWgQKHTCGaAfZcUJReDNPXMYEFSBb,ZAADUDACeDHFDCHH...XDFFEFDDBAHEdGBHLFFG..hAAAWBFCKGAHHACH.hAAACEDEACEDJDBE.RFEBNIADMICAhABA.....FHFA.bAEBOEAB.hACAIHHF.QACDhAEA,1,-11,-28,17
MaNYBIOeCTDHPFdERWGZUAXgQcbJfVKLS,XCGCQCBC.JFACKAAD.LCEF.aAGABAAC.IHCChACACDAEDEABFHBEEEFARGFAZCBBhABAADFB....bAEEhADAfFDEMBIBOFHB.eEDB..hAEA......hAFA...,1,-22,-29,7
gLXaObYJPWdRMZTUCEcGIDANBSQKeHfVF,SEGDQGGDeBAFHDCFFHBELBGBaBFB.OBFH.bDBDhAAAJABA.dFAAZGAACHEGEAGEhAAAIEDCAFHABCGF.KFEBhAEAfFFC.XABF..hAEA......hAFA...,2,-22,-11,11
ECUTgNfbXdIADHaVOMcFPeKQYSLBWRGZJ,HEEEaDBD.OCBBFDEFKCAHSGGE.BCECGFCDZAAECAFEgACBhAAA..hABAfGDBdFHGIGABhAEAAHCFDBIDMAIDeAGHQAFFWEAD.EHEAhAGATDCC.NIEF..hBAA...,1,-14,-19,5
bNPYSHAGFgecOaTUBKLDVZWEfJQCIMdRX,FGAHeGEAODDBUBADLFDFZGFE.EHAAJCHH...QABDhAAAMBDGdEAGRDEE.XCGAhAAANCCG..SBFBhABA.ABEDgEFEaECBBHHADAHBWAEEhADA.....hABA...,2,-26,-18,8
bTIKOJARCQEdDFLWeXMGSUZPYcfaNVgBH,CADCEFHBFBBBLEDB.eEBHXGFCGCDFUAFDZAEE..PABHhAAA..fFDChAAANIAFBADC.HDFE.hACAIDDG.JEBBAIFCdFFADCAFMIBG.hAFA.SCHHhAGA...,2,-24,-8,16
GRJPXLFTgCcDYfAUBHbESIWZaOQMNeVdK,UGDCHDBHEFGH.SAGDZEABQGFEMFAH.eBBAdAAEKEEEJDDCLAGBhAAAFHEC.CHHB.hABADFDHAAIF.BCCE.IAEFhACAODHF.NBIE........hACA......hADA...,2,-25,-18,7
HbMSQOEePDWKZTcBVXYNCRaUgGILdJAFf,FCFCHAADMFIFOHFA.EFEFeDBB.DAACZGAEBEDGXBEG.hADACAFFRDCEaGAC.UFFFIEAEhAAAJAFG..ACCD.fBGBhACASAEFWDFB.....hBAA......hBBA...,2,-40,-8,32
KgHJCITUWYcPBOdDZNSEVQfRMAXbaeFGL,aGFCFAEGLDCBHDAFCFEF.UFFE......WAECPCHDhAAAdECADBBESCAFhABA.EBFFfHCFhAAAAIBCeDAHKABGICDH.YBHDBBHF.hADANIEF......hAHA...,2,-26,-25,1
ZTYAJUHMOdIEGgNPDcfQBaLCeSFKWRbVX,UAEGOAABECGCGDBC....PFEEfHCFBHEGCADGFFEEhABA.KHGARABD...bAEFhACAXDDFZBDHABIH.MAAHhABAgDGBDGIDaGBA..SHBGhAHA......hAIA...,2,-32,-11,21
EgdIFOUPaDKbXNSeVcQAZMCfWGLBJRYHT,ZFBHMBFHCBHHGCDBBEDCRGEA.HFFC..EAHDdADDFEGGUCAD.DABBKEBDhAAA...XCAEhABASGAFeACA..hACA...cGAEAHEF......hADA......hAGA...,2,-31,-31,0
JUAHGfTRBVYOgXFLaeZcMSWKIDPbdQCNE,HEBHTAGHBHHC.OAHDXEFDFBBCLAAEaFHD.eGDGhAEAZEBCSBDAhAAAKEEA.ICABDAGHPBEBhAFAdHEFCDEB.ECHFAAHHfFGFYABCgGAEhAFA.WBBBhAGA...,1,-19,-22,3
GCOYHSDWdXRPEVfQFNJTbeIZLKcMAgBUa,UGGGaGACGDAFOFEFHBFC.DGEFdABERFFH.EDAC..QACBhAAAFHAG..JADATBAChABAeDFGZECHLDFAhADAKCGCAEEGBAGBCHHD.........hAFA.SGBEhAGA...,2,-28,-5,23
BRNOVYbHUZgIeXcKEFSMQWGAdCfTJaPLD,CFEDTDAC..JCDGLEEFBGGG.OFFG..bGBCZFAE.hAAA.eCBDcADEKAHHEAEGhABASHBG.hACAQCFAADGHfFHGDHGCVAAA..hAAA......hADA...,2,-40,-15,25
dXUBQPZcRCSfaNVIMFKHOYTDegWEAGLbJ,LFEFdDCDUFDGBFGBZAGDCFHF....aEBFVBEA..MBCCFEAFHAAFhAAAODAH.DDDAeHBGhACAEBBD.AHAB...bGFAhAAA...QGBBcADBSGGAhADANABF.KDGA...hAGA...,2,-21,-20,1
eHWPaBKZNMVEdGcJYLDFOTRXSUgQAIfCb,CFDGeFBBHAFA..aDCFBHFBZBBA.MECCdGGFGADF..cBBFhAAAJFEBDDHH..TEFBhABASAACUDAEAIDC.hADA.IHACfCGF.WAEDKCFB..hACA......hADA...,2,-32,-21,11
MUKHZNaRTGgXeLSYbDVCOAQEBWdPcJIfF,QGAFBFEDdHAD.JACBFHEA.UCADHEFFZCFERAFGGCAC.XDEFhAAALBECSGCHhABADABECHHE.AFHGEECAhACA....WFFEIHEF..fEAChAAA.MDDFhAEA..,1,-10,-44,34
LMbEHcPJXQCBUOKFYedADGRIgZSafNVWT,GACBRAADZDEB.SEHBaECH..VADHLAGB.EDFDHBGHhAAAPFCEXGEEhACACGGHBBAB.KDADFGBHeFAFhAAAAFAHDEIHICCCfDDENIBF.....hABA......hACA...,2,-14,-14,0
AYXZDcRGIEPBNWJaMdSeFCgUQOKTbHVfL,ZEFHRFDGGGABEEDDBBHB..JCADdABFFCEGCFHG...QDFEhAAAKGACHAEBLCBBAABF.hACADIFAICCA.hAAA.WHAGSBGE.eHEA.OACEhADA....hAFA...,2,-32,-23,9
JbDGgdeQNHZWCLFKcSaIVRXYBMTOAPEUf,UGBCJGEAGACGdFGB..QDCGZEEALBGFKBBA...SABFhAAAIDHCRGEGBFBAhAEA.OAEFABHGEBEDDCADhAAANDIA.CAGF.FGAH....aFAB....hABA......hACA...,2,-30,-21,9
gXLdPONaScBVIJFQbHYZTURMDWEGAfKCe,CFEDeDACLCAFdFCHOFHB..SDEGBAGE.JHBGbBFGHABAhAAAZBBC.RDGHDGGBGDEFhAAAABHEKDCFXGBC.hABANABH...aCGG.IGAGYFFFMFIFhADA.fBEFhAEA...,2,-26,-7,19
BQICKMAaeULTJHSWROcbdfGPFDVNZXgYE,aGDDeFCALHFAHCADRGEAOBBAdFACGBGCDICAZAEF..XCABhAAAEHACBECFQADDhABA.KECHAAGDTBGFhAAA.SDHHcFFFfABFhAFA.FCEH....hAGA...,1,-9,-12,3
GPYIKcLaMWTeZUHEAXQfNDRgVBCSOdJFb,XCGCQCBCDCBCRABGBEDH..ODBGFCGAGFDH..hAAAYAEEIFBELGFEhAAAMAEGeDEEZEEGEHCAhABAAHBH.NDAC.CHFASDAF...hACA......hADA...,2,-28,-15,13
STXgDBKdZIbQeGfcJaVNWUMYFPAREOLCH,RDEDOFFBHADB..TGDADDIFdBCF.ZCAHQBGBGAFE.JHFEaDCEhAAA..VCAF.UFADhAAAFFDFAIHCCACE..XDGEhABABAHGKFAD.........hAFA......hAGA...,1,-5,-35,30
OZPIgHKCEFMVSLcUDaAWQdXYfeGTRbNBJ,dGFCXCBCeFBHRBEBBCHDZEGF.....IHGHKCCGECABMDIBhAAASHAA.LFCAhAAADBBAaAGH.AABCYAEChADA..fEAE...hAIA......hBAA...,1,-28,-45,17
dgeSbFZQGBXMIRKEYOTPJDVLcaCNfHUWA,eCCHSAFBFAAFZBFEBEDH..MFEDRAAAEFBBOFFG..PFGBhAAAVGAE.LDCChABACADE...NDIGfGDBhADAWDFAAGHF.dAHEQCAFXADD.hBFA......hBHA...,2,-24,-19,5
TUQGdaeLcMHPFXSKRJgBDAWbCVZIOEfNY,CFDGVGFGZAFA...ODECEBDD......fDAChAAATAGGUADGdEFFLHAEhABAMDBGFGDFXAAChABAKABBRGFE............hACA......hAGA.BCHAACGF,2,-35,-20,15
PNfTGgAQabWESBZJdMCFLYVcHXIDUOKRe,aGFCEHBGBGCEZDAF.dACGFAFBLBEE..VBCFHFFBDAHFKCFDRDFG.hAAAeDED...fEAChAAAgGCAAHIB.hABA....WAHH.MFDAcDBAIABFhADA....hAEA...,2,-35,-18,17
fYWVFUOSCMbNQZBXLgaJERIHGTecDKPAd,dHBH..fHBHVCCCUGGGOCDH.MGDAQBGEhAAABBBGLFHFJFEF.ICEGhAAATDAHDGBAAEFFFCGChABACCAC.ZEAD.aADEEABC.HDFA...cAFGhABAKAGA....hAEA...,2,-18,-11,7
eVdaCUMOXIJBEDTSKfQbgGFYHNARZLPcW,RDBGZFDFLHBE..PBAAeAAFdGFGaFFA.UAGC..XCAChAAABEGCEEABDFAATBDGhAAASGGA.KDDEhABA.QBGF.bGAE....hACA......hADA...,2,-27,-27,0
gOJKNYcEMFdPbQDAZSBRIfGaTXCUHVLWe,BCAHRAADGAECaGEE.CFHC.UAFCLEDB..eDFAODBDKEDF..hAAA...NDGCEHAEMBEHhAAAdEACQEAHhABA.DFIBAAIDIHHEXBBB.WACBYHBAhACAFCHF.ZFGF...hAEA...,1,-15,-19,4
VQYaeNZDfRcGTBJIXSgALKHEbOPdWUMCF,LDCHKEHBHBFAOCBAdAACUCED.FEHHQGFC.aEBCZADEhACADCAFfEAGhADA..cFDBBCHBIHHFhAEAgGAEAGFFEHAAWAAGCAHH...eAFEhABA.NEDF....hAFA...,2,-29,-7,22
ZNUgeJfHIFLAKcGbXCBRSDaMdWTQVPYOE,GEAHCHHGBCEB.RDGHDCABdABC...QAGF..PHDGhAAAECDEUGGBJEDAHAFDLABAhAAAKEAE.XGCEhACAMCID...WEEBTACC.OHAC.hADAZFAE.....hAFA...,1,-13,-22,9
TLMRYZOWJdCEUaDPNIVAFeKQcXfbGBSHg,FEEDKAADQBFB..fCHEBGFD.HEBFgDABhABALABARCCEOFEAhACAWCAGCFHC.aDGEDIGEIGBGhADAADEHeBFB..cGAC.....hAEA......hAFA...,1,-25,-29,4
BgcRFHGAEKIDOZfUMYbLCaXNJSPTVQdWe,EAFBKHFGOBAHZCFE..UBAGMBHHLEBB.CFFE.aEBG.JBBChAAASACH.hABA.TEFGdHGB.WFCDhACABFHG..RFDBFGAFAEGCfAGBXCDANAIEhADAPDDF...hAEA...,2,-29,-23,6
dVbGLAUgJWcQCfTXPeOIZMNDRSaFBHYEK,UDACJGEA.QBGACBAB..XDEAeAAGOEGDZDABDDDFSGDFhACABHDC.HDDGhADAEAHHdAEE...hAEA............hAFA......hAGA...,1,-26,-52,26
FMKdTbYfHaXERIGSeLVDAWgJZQPUCOBNc,JGEAQFDH.UEAECGCFBECDFHGAdABH..TBGD..hAAAfDEFaACE.hABAECCERCDHSFAHhACALAFAAHEH...........hAAA.WFFEPEHDOHAEhACAMIDG.,2,-49,-19,30
DYJQgLObNSaIRKZAdCfTEXHPUWcBVGFeM,CFEDEGFCHBFAUBDDBBBAGEAFFBDD...DGEFQGFELHAGOBBHhAAASFAC.aHBGhAAAIDGHZDFA.dBGDhABAfCAE.......hACA......hADA...,1,-24,-27,3
QUEFWRHBVZYMbAcfIGOXSdPLNCDKaegJT,..IFDGGDDCOAAAdCFELCHBCDCGKGAC.eAAF..TADBhAFAQCBAFGFEHBFChAGABHHE.VGAGMIBEAEBHXGFBhAAASDGDDEAB......hACA......hADA...,2,-19,-19,0
ADIWZSaGYETgOQNCbHXecKVMdRLUBJFPf,DACBZAADGCCCEGHB.OAEDQDCC.CBGDHGDGXGFEeADBhAAAKEBFdGAELAGDhAAABFFBFBABAGIDSFEAhADA..TDGGNIAB......hABA......hAEA...,2,-20,-18,2
ZebfcTOaHFGKXJYWQVMBLUNDSCgPIRAdE,dEHAEDBDZFDFeCED.....fBCHTDGBaBFFFGFHKFAAJCBFQFFChAAABAFCLHBAhAAADHAECACD...gBFChABAIDEGAICGOEAB.....hABA.XADFWDGF.hACAMAIF.,1,-15,-29,14
BUGFTeLgXHZKScCPdbOIEWQNYfJDRAVaM,aHDCUEBCGCGEFAAFLHACHAABZAFD.KFBDCCCC.dADC..OFFFhACAIDDC..EEHDQFEChAAA.fFCBhACARAFBAFABBEEGgADD..hAFA......hAHA...,1,-5,-37,32
VPfZXEAGbCJSdIgTLeNRHMOaYUWFDcBQK,GGDHCAFBdGEE...TEAFeEDERCAAHDFD.aBCBUCGFDCIDBAAFhACAKBCE...VAEFfAAAhAAAXAGBEFBGADAGSDDDhADALHAEMEHF.....hAEA......hBBA...,1,-11,-26,15
PLUTKCAeBSDEVOcNHJgdbGIRZaQYFMWfX,SDABEEAE..OBCDHDDFdHCFIFDGZACD..aAACQFFBhAAAFBGFMAIBfHGHhABAXBGAUGAHhABACGFEAFAFBAEADIGENADD.gDGGRCEE...hACA......hAIA...,1,-9,-21,12
STgaAWIHLDFbcEJCPdGUVReBYOKQMfXZN,HAADFEGCEBCECGDCdDDC.GBEFUDDDRGDEBAHA.KGGDMBAB..ZFBFhAAASAFE.hACATEADAEBEIFHChADADDGG.JADE...eFEH.....hAAA.QGGChABANEEF.aGCH.,1,-13,-32,19
ZdFXHECBVPKeSJODIbNMYgUWAGRfLcQTa,GEDHRFDFLBHDQGAFZAAFdAEBHGFEEDBFCGGCBAEFKDEH..JHAAIBBBhAAA.NICH.MDADhACA..UBDFAECCfBEAhADAaEGA........hAHA......hAIA...,1,-17,-21,4
CLWfURXIYPMGaegSdVKObATFHZQcBJEDN,HBCFQFDHJBHBDABECDBALAHB.UACGXAED..hAAAPAECMDGHeHAAhAEAdGHCKDFGAFEEFHGEBHFHEEHHfAAEhABA..IEBGaHCCSDDFhBCA....hCAA...,2,-25,-22,3
NATBfJRXHIPeabLQOdYSCDUZVWEKGgcMF,BHHGJFBBHDEHeDDGLBACQDAF..dHEHSFCAhAAADDAFZAGDECDHKGAAGEGEMFFEAICAhABA.RAGD....ICFGhACA.PBBG.aHEE...hAAA......hABA...,1,-12,-25,13
XEbeFUJTGVYIHgBMNdZLARQOaCcDPfSKW,QBDGCDGFDCCA.SHGAKGFE.EEGCFGCF.JEBEGFADhAAA.IABGBBHDdBAGhAAALEEBAFHE.OAFChADAaFEH.cDCC.fHABhAEAXAFF......hAFA...,1,-13,-60,47
HfNgPdIVQDJScaRFKXELObMYZAWBeTUGC,BAFBeDCHUAADCEHEHCCB.....NEFA.gFAD.dEGFhABAIACBQAEGhADAJCFC.aHDCKFBHLFEGhAGAMABBAGGF...........hAAA......hAEA...,2,-49,-16,33
EPUaCbHRDeMgGTKdAXBcQJSIfFLYVWNOZ,BHHGQDACSAGBFBCHLFCH..VAABOEFFPDHHhAAACAAFRAEEDDEC.eBHHhACAgFBCKFED.XEEAhACAIHACWDCGNEIE.EGDFaHFE..MFAHhADA.TAEFAAGE.hADA...,1,-13,-16,3
AaFYVDWKCBGOXSZNMIcLJfEdHTePRgQUb,aAFBFCFCDCBG..KFFBCAHA.BDDBGDBB..SACBMHCCLFGBhAAAEDGEHGBA.TECHhAAAPFADRBAFQAGEhABAAEIB..YACCOFHD.NBAE..hAEA......hBAA...,1,-17,-32,15
ZKQFYgSDaJbCecXPHLOMAdTWNVIEBRUGf,TGBCVAAD..BCHCRFGHGAFCKCEC..FDCFSACG.hAAAJBBFCGGCXGDChACALDEDMBIBAFEC.WEAGhAAAEGAG.....fHEBYADGDEEEhADA.aFGA....hAEA...,1,-11,-42,31
TPHCLSBYdEWNaOFfbJGIZVQADRXMKUegc,DEFARFEEKEFEUBDH..eAFE..TGDHCCFFBBCHdABE..EDDFaEDBhAAA.FFAH..JEAHZFFAhADAAACA.MCIB..PAAFhAAALAEC.SHFANECG..hAIAOFHD.fHDBhAEA,1,-31,-37,6
YGAHIadbRWJEFTVUcfNQOKeXCZDPLBMgS,HDAGaAFB.dGGDRCAE.JADCFFEG...UGGE..fCCDhAAAOHBEeDECXGDCZAAEDAIFhAAAPCHBBHFFMAEFhABASAGE.ACGBIHBBEGBA.TEEChABA.....hACA...,1,-15,-23,8
bXRSBdHTQgIZaFKMUVNAJWGEOCceLfYPD,GECFCDGFLBBH..PAFDDFBARFEDBAHBHFAFQFGAhAAA.ZDAEaGBCKCAEMBDChAAANICBAHEG.ECAF..eABGhADA.fDGFXGGBdDDF....hABA......hACA...,1,5,-37,42
AMXcHSGBQEIJeDbYVKTZUOCPgRfNLdFWa,XFDBHDAGBFDG.EBHBJCAFDFFC....VAGFKBDBUGGE.hAAAOHAECBAERFACLHFEhABAFBBGAFAA...SCEHhACAIGAF.YDHBTGEA...gCCFhADANACBaCGH.MIAEhAEA..,1,-13,-32,19
dFGADLIJZUWaPMYEeXVcRObfNCHBgTKQS,DEFHLEEGZBGBUGCGaBAA....MBFAECCB.eBED..XAAFhADAVGAGOHDE.hAEA.NDBCBECGTDAFKGGHhAFAdGHAAHFB........WADA.hAAA......hABA...,2,-39,-21,18
dbUaBYRgEMVCPZGAHLJNcTXIKOWQeFDSf,JFFCTCBC..KAHDOFHB..eBEDDCFCSGEEhAAAdGCFUAACBDAFRGBAMDAF.CEFBZABEhABAADIFHEADLDEChACA.NAIE.IDCG......hADA......hAEA...,2,-45,-9,36
AIbPfBQKCFRGLTOcgWHEJaYSXZeVUMDNd,..IFDGbDED.BAGCCDCCRBAH.LFHH.OAABgAFDhAAAHCFDaBCESDGFhABAXDADZEBG.eFHHhACAMHBCDIAGNAIE.AHBAfAHEKFFD.TACEhAEA.EHEA...hABA...,2,-23,0,23
PMeNTLOYUBFaVcQCfRbAGIZDJWXSdgKHE,GEDHDHCE.JCBFSFFB.dAEAgBGFEDDB.MAAChAEAeAGDLGBEhAFAOAAFBACHFGGB.aCAH.hAGAQEBDCDDF.fFHCAAHEWFHH.hBAAXGEDPBBA.NAIE.hAAA...,1,-16,-34,18
PNHDfbIKZcYLQROAGECeMVagJdUTSWFXB,EBCGMIAG..aEFGdGBHUGADSDDD.FGEEXBFGBEGEHBEEhAAADEIH...fDAAhABAbBADKGHFZDDFLAHBhACAOHDEAACGCADG.........hAEA......hAFA...,1,-22,-26,4
CgDZOETaSBHRQMPWYLdFJUfVIAcebXNGK,eGEAXCBCKAAGDDEEZFGF....OCFBEGCH.SFAGhAAABEGGRECEQBGFMFBAPHDAhABA.LACEhAGAFACAJFAF.fAHEABFD.NDIECHCD....hAIA......hBAA...,2,-35,-14,21
WREePILKJMDbOHTSYdANfXFUGBcCagZQV,XCBCUBCBBFDD..aFFGZGFA.QDEHRFDBeBFHLHAGhAAAKGADDBIF.HACA.SFAGhABAAAAEFEHDGCAECGHAWBHDhACAEHCE....ICGA.MACAhAGA......hAHA...,1,-6,-28,22
WEFIHeTcNQSCRfJBZALOVUPXgMadGKDYb,VFBGUCGC....XEBAaAFHGDCDDIAE.....WBAFhAAAEFFGHACE.eGAEhAAATAGCNCEC.CFFDJEHBAHHFLBABhABAOHECMCBA......hABA......hACA...,2,-24,-21,3
PVUNagJeTMKYLcESdGWDCAROQBIfbFZXH,OBDGBHHG..IGBAFABFZFCFHDEF.UGACaAED..eAAHhAAAMCHFKAHHLDAEhAAA.SHGGhADAWFDHADBGRDBCQFFFfAHE.XDFB.hAEANEAE......hAFA...,1,-18,-25,7
DGHRgSaPVWLNdXQeIZETOAcCMKBYJUbFf,CBFDBBGEUGBAFHEA.DCDDHGDA.RDED...SDFFaCCC..hAAA.VGAGNBAF.dECHXGGHhAAA.IEAAhABATFGEAFAG.MBAD.KBBDJAHF...hABA......hACA...,1,-25,-43,18
MYLAaNCXgQITWfUKBdeRZcFGHJEbDSOPV,CFEDXCGC..IBDH..TAGBUEAHKEECBDCFRAAFZGAEhAAAFFCCJHFE.EBAGSFHBhACA.OHCEhADAMFFAAAEG.NIABQBDAdGGE..hAAAcBGE...hABA...,1,-28,-34,6
gPIKXQdTNDcURFHGYbAMVLCSJOeBZEfaW,LAABJCAFBCHD.EHAC...aCBD..PGFEXBGD.QEFGhACAdDDGDAGEUFAFhAAAHEBCGABCAGAFMAECCDGD.hABAOHEG..eFDA.....hADA......hAIA...,1,-15,-35,20
KCZMNERBeQJfOSAVTgLIYWUDGaHXdbPcF,TFDHLGEA...IGCAUDAFDCHDGCBHaBBG.HBGDdGGB.hAAAbEBC..FDEEZACAMIEEhABANAAEBHAG...hACA.JHAGSEEEAFFAYBDG....hADA......hAEA...,2,-30,-5,25
LbYSaOgQeGUdcWFZfDNAVPCKHBRJTXEIM,CFDDBCAHRAFA.JACC..EEBDLFFB..bAAFaECH..OCEChADAeHAAUCDBdEEHFFHD.hAAADCCEAAFCKBGD..TGAAhAEAMDIF...YHCG...hABA.SEEDhAHA...,1,-22,-41,19
HDESNRVQZWKLbYFMagTOCUeIGPBfXAdcJ,JCCHDGDEEDAF..RADBZGDCKCEFLFCD.FAHDaBAB..OEFAhAAACEGFeFAD..IBBGhABABHHGAFFBdBGA..hAAASHGA.NACF.WFBB.MAIFhABAgGFC..hAHA...,1,-37,-41,4
dEgcbRHXDUPWeNJMGBYOfSVIQTZKaCLFA,dAFBEHBG.....gFDARBBFDEHHUEEAeADFMAECBDAG.OECGhAAASCFG.hABA.IHFETECAKBFEhAAACGBFABBEHBFD.PCHDWCAD.NIAF...hACA......hADA...,1,-21,-33,12
gcYUCWTSZMIGdeLJFKPAQNHaRfXVDbOBE,HEFHaCFC.XGBGDFEFBDHHEFHF.....gCGDhAAAUGGGTFBDZABFMDEBGACGhAAALEAEKAFAAICAQCAChABANIDDfADHOFAHCAHESBFChADAeEEE......hAGA...,1,-1,-18,17
FVcUNdKSQgACMOZIGJTfbDRPLYEWeBXaH,OHAGZEBHJFAB...TAADDABELBBG..ECGHeCDAaCFBHEBGhAAAFFGG.VEGFUGDEhAAANBDF.KAEE..QCAFhACAAIHA.MAFGIEEC...hADA......hAEA...,1,-9,-36,27
JTBGHedUKaNROFIcYWASCMQPgbXVDfELZ,MAEEQCBC..PHBEXEDCDDGGLFFETBGAGGEFhAAAdEBGUBAGaFAFOAEAhABAFGGF.IBDEhACA.WDHHSEDDCDAC.bAFAECFBBCCBhAAA......hABA...,2,-27,5,32
LGXfYabWRcTCMdBQSJAVNDgIOUEeFPZKH,DHCEOGEAEGGF.FAEDKEBHGAGA..XAEAaEAH..RGBECAAFBBADhAAA.SFDChABAADFBVCBD...IBHChACA.eDDE.......hACA......hADA...,2,-40,-36,4
MXZHTVBcDSQfbJLRAEWUFaNCIYdGeKOPg,UGBCFAFBCEDA.dEEFGAACKAFA...OHDCMDAHZBBAHGFG.TCGGhAAABHEF...DGCHSGGHhAAAQEABJACEhABALADF.AHAEaFEENAIE....ICFHhACA...hACA...,2,-38,-13,25
XAWSGHdJZgEOLBKRUcFCYVNPbDIfQTaeM,GEAHHDEDJHBAECAABCAERAGB..FGFGCECA...VBED..PEHBhAAADIDAQGAChAAA.aDHDMGAG.ABFFSCCAhABA.ZAFH.OAHDKABA.hABA......hADA...,1,-17,-30,13
RZgbCOcaQIBMKXNGLVWPeAdFfEHJUYTDS,dAFBFAFBEECFHFFC.JBAGUFFD..DDGC.RBDH.ZBGD.CACD.aDAABAABhADAKHEA..GEAELDDHhAEA...WEBDhAHAAHIBfGCF.SDEH.hAIA......hBAA...,1,-22,-42,20
cWaMeHSXQEAFYLgbOCBTZNRfJdDKVGPIU,LCCHOGEABAGCZCGBRGBAdFACDCEDGCEB.UBBEaEFBHAFA.hAAAQGGEAECGFFBE.hABA..gBADhAAACHHGNFEF.fFABJHCAKAEB.....hACA......hADA...,1,-7,-28,21
LQGOaWAbcFHfReVECXMNBUTKYSJIgZPdD,FHBGHGFGRACD.EEGG.CDDD.MFFBBDBD..KAEESCAC.JAFBhAAAIEHDZEAC.DGGDhAAALABE.OAHBhAFAAGDGfEBAXFECUDED.gCAHhABA.PAHBhACA..,2,-34,-22,12
CIOeHJbEdASYPMRaKLcXBDWGNfQZgUFVT,SHBGMCCARDBC.KEAALEHFBHGEGCEGQAAFZDCFFDHDVGCGhABA..CAHBeACChAAAHEDGEAFDABGD..aBBCDDAEhADA............hAEA.fAHGhAGA...,2,-30,-17,13
FXPbHLINeRAZBKJDGYSTMgfWVUCOcaQdE,KBBDJDCHGEEA..TCFAMCHB...fHAHVBCECHBD.hAAAaAGFdAFF..FEDFXEADhABAHACANIEFAABGBGHGhACADGGGSFAC......hAAA......hAEA...,2,-30,-28,2
HdMKCYFaQGLcPNABIObDTXVRWgSfUeZEJ,BAFBOGEADBAE..XADFREBC..SCAEUBGEeCCBZGDGhAAAEGABdADCKHEGFEGCQAAFhABAGBEALAHFhABA..cFBAAHHB.IEEC.hACA......hBEA...,2,-28,-16,12
bOTdDPIHgfBRLYGaZAWUcMKXVFCeQJESN,UCBCMHFGKEGG..XGADCADG.QEFEECAF.SAGEhAAAOAFBDIGEIABFhADAHGAABCDF.REAE.hAAALCFCaEEFADIF........hAEA.WFEDcAGE.hAFA.FHFA.,2,-32,-30,2
BLRbIMQVTDHZOcUWFgEGeYJPdXfKSAaNC,CFEDBEFARBFA.MDDG..QAAFDEABZEBAUABAFGHDGDBB.hAAAeFAEJHDGdAHEKHEAaAEGhABALDHF...hADA..VGAA.TADFOFFA.cBDChAHA.EGBB...hAFA...,1,-11,-30,19
eJLKOTgBYfHXVRUGAZEQdbDIaNWPMScFC,QCCBdHFHDBBA.aHGA..PBEF..MFEBSDGGhAAAFGCBeAECKFABTBGGhAAABFGGHCAEXEAF.hABAVDFF.UABFACCGEGCC.IAHC.hACANACFCEED.....hAEA...,1,-8,-26,18
LOMURBHFGKdVaTQEcWPfYbNeCSDgAZJIX,ZFDFJDACLGDGUBFGRCBA.BFACFADF...KBCGdGAG...aGFGQCGGhAAA.EAEBhABA....cDGEhAAAfEDH.NEIGCHBASABF.hACA......hADA...,2,-42,-41,1
RHXKCBUPOdDFaYSGVAMNJbWZfcEIQLeTg,JCHDZAADEEFGLFCF..TEBAHABBKFGFUAEDOBFF.dEEGhAAAaGGH.SAHDhAAAAEAHMFBB.bEDD.fACAhAFA.........hABA......hADA.IAHF.,2,-30,-15,15
XQSPUfCagdLeTVBcNGbRFMDOKJZAHWIYE,HAAD..IFDGEAFESECCUAFACCHHdBAETEGABCDAGEAGhAAAFEEA.MFEDKHGEAFHEXACFhAHA.fGGEhAIA.LCCAeEBD....hBEA......hBFA...,1,-2,-50,48
YWXMZHVcDPbeSGCaARBQfLgIJNTOUEKdF,BADCQDACLCCHJCBA.OAAF.KCECFGDA.XACAhAAAMFFHHGBEDBGC..PGAEhABASEEC.aBGFhAAARCFDfHGBIHGHNCAGEEGF....hACA......hAFA...,2,-24,-24,0
OBdPWUaFQXeTJKEHLGYVbRfIDASgNMcCZ,SHBGMCCAZGDEdAHCUBAB..aGBGFHFE.eEFEKEFDLCABhAAAGBDE..VAGHfDDAhABAAGDC.NBBF.CFFEOEAHhAAABEGB.........hACA......hADA...,1,-19,-32,13
DZFbLHfcOIMSPGBQATaEXKRVJWgYCedNU,aFHBXFCE.RBDE.VCCH..JFFF....gADDhAAACAAFdFAEDCCDZAGFFGBAbAFDLACChAIAHFEB..fBAHhABAODFC.SHAGBEDCAFID.KBHB.hBBA......hBDA...,1,-6,-29,23
KPFeWROHLDVAUYNQECJcaIBdXTgGZfSbM,UCBCQCBCCGEG.aACEBFDF.dABDTGEDZAEF...SDGHhAAAKBGEFEEA.WEDChABARGAC.HFAADGID.AIGGNEIC.hAAA.EFGAJAFA.IHCA.GBDBhACAMICC......hADA...,2,-41,-6,35
OHeRWNGdKYfTFaIULSbZDcCJEMXPVQBAg,OFBBHDBGRADGGEGGdCBGKCDE...TGDAaHGE.UGAFLDDGhAAAbCFA.DDHF..CABFMAAFhADAXAFA.PACGhABABFFCAIFE..gFDC...hAFA.WCBENCIC...hAGA...,2,-33,-1,32
NOXcbCBREUDfWeJdFIMSPQATLKGYaHZVg,TGGDKAEGGFCD.HDAAZCGB..VDBBNCHE.OAAC..XABGhAAACGDABCAAEGAGDDIBfAHEhACAeCCG.hAAAFDDAMIAGQGACYAFEaDFD..bFEDhACA......hADA...,2,-16,-6,10
cfYDdeNOGVXELRCgPABQaHZbTWJUMKSFI,BFCFHBCFZDGB.TGEEJCDAUFFE..KGCEFBHB..IABGhAAA..fCBBhAAADIGANDACOBFA..hADA............hAEA......hAFA...,2,-66,-28,38
gIQZRFVGfdCYacTMSNXHDKJebBAWOPULE,OGEAUDACEBAE..QCAFRFEFGBGCdCEAaHCG...MEDDNFAFHABChAAADHGG...JDECeHAEhAAAABGGLFHB.hABA.IACGFGAGCDDD.cAEFXAEF.hAGA......hAHA...,1,-7,-21,14
AUNgBTEWMaZFLcCHbdPSXDYKfORGIeVJQ,UCBCBFDGEBFHMIFAZBAALAEEHFAF.dHCFXCGA.DAAEfCFHhAAARFFE.IFFDhABAeDBG...hADA.JHCEAACBNDAGWAFCaFHFFFCA...cCGDhADA.....hAEA.CHFA..,1,-17,-20,3
fGaVQWMCITDPHKZXYNSgUbRAEFeLdcBOJ,EEEDeFFBdACGODHFGCDH..aCEDQEGFMIBA.CHACTEBChAAADAHFKABGZBAC.XGAGhAAANIDBUAEF..ABBB.FFBEhABABFAGfAEH.IEAE.hABA......hAFA...,2,-16,-14,2
JBfXCSPaQbFeHALVYKWcRODTUgZdINEMG,LFBBVDAG.KGDARGFEDAABUGFE.ZACDdHCF..EEEAJAFC.BBCBhABACCED....SBAEhAAAaEGC.QBGFhABAFEEFAGCA.cDGD...OFAHhACA.....hACA...,1,-20,-46,26
IGVbaROAfETSJecgBWMXQYLNUPFZDdKCH,TGBCJFFB..eECGBEAC.MFHBQBEELFFFUGCGFECFDABAhAAAKAGCHFABGAGCaCAGhAAAOADDEDAC...hABASEEFWEHB.XBBFPABECHGA.hAFA......hAGA...,2,-22,-5,17
FaXIDcEKfTBZARCbWdJMePVNHgOQSGYLU,CFDDdHBH.eDCB..PCHFHBEDQFGF.SEAFhAAAGEACYGFAhAAAUABFaCHBDCCEEGEBKAEBBAHGhACAACAHRDDEJHCA...MABC.....hAEA......hAFA...,2,-26,-10,16
FeOLDPSHfRYJQMGWZCTKgINVbaAdcEBUX,dAFBBFEDFGDEeEHBDDDC.HDCA.RAEH.JEEEMCAF.ZGDECCBA...KAHHhAAA....NIAF.aDGAhABA.EGAEUGGD.LEBFhAAA...SBAF.hACA..fCFBhABA..,2,-46,-25,21
LgGRCAeQZUaMHSKDcVITNWdEOBbYJXfPF,QAEGaDAFHDDFDIEG..VFDA..NBHE.dAADBHHG.JAAEfDHAhABA.FDFGhADAgCCFCHHGeHACZDBGhAGASHAEIAHEEBCFYGDG.XAEEhAAA...hBEA...,1,-12,-25,13
UTfdKPHeFcQJSGVWgARMZODEaNLCXBYbI,ZFBGEEGCLFBFBFHF..IECCUAGCTDDCdCCDHGEE.FBFHhAAAJHDE.GABD.hABAVCAEABCEMAIBDIGA.CEAB.hACA............hADA......hAEA...,2,-36,-17,19
VQXBRILJcWbdDHYZUfOEaFgTKPCMNGASe,SDBDVAEG.QFFCBGHDLBBBJDCA...bDDHdAAFhADADCIBHFCF..ZFFHhAAAOAEGEEHDFHACKEGCMBAFhABAACCGeCEE.IBHG....hAIA......hBBA...,1,-20,-21,1
PMAdCJLGEKIfFWRBbagSTQYXeOHNVDUZc,JCAFGAEG.KBCEFCGDBGGF..aBCCTCAE..QGGFhAAAeEDGOCHDHEDHVGAEhAAAZGAEPAFC.hABAAGFHCFADIHHE..WABCgGDHhACASDDC.NICF..hADA...,1,-17,-24,7
fgINcaQFWHUYDTJARKVMGLCZbeXdPSBEO,KDAFGGCBZGFA.eCGDdGAABDHFOAEB...IHAHaAAB.FGGAhAAAUFCGDCAG.AAHFRBDBMFDAhABA.CDBD....XABAhACAEFFG.fAGHNICF...hACA......hADA...,2,-42,-15,27
ePdFCDYaMEAXJTcBKURHWZfgOSLINGbVQ,XDCHJDACBHEA.UFGCHFAB.ZDFB..OBFELFCHGGBBhAAAQBCFdBAGCEAADGABMAAAhAEAAGEAKBCDRAFE....hABAfEHA.IEEENEEBeAEF..hAFA......hAHA...,1,-18,-21,3
CJAINMFZgPHSKDTdfWUYGVEaLcbeRXBQO,MCCAFCFCZFGFHAGFDDCA.dEFF.UFADGAACEAAC.LHCE.eFBFhAAABDBA.QFGFhAAACFEHAFAB.IGDEhADANEEH.SAEA.KDDDTADChACA.fAHEhADA...,1,-11,-33,22
dHbTFZOPNVYLQecRIGXWBKAfDUaMJECgS,DAFBaBDH.MGDC..CAHCdAEDHACHFGGAOEDC...VBGHQFEEhAAAREAD.ICHAhABAWFHH.KGDDAAGDUCADhAAAEDAC.SHAGZFABNECD.....hACA......hADA...,1,-14,-31,17
ORWAUeSXTIJFaDZKMPbcdNBEYCgQVfGLH,UGGDSAAD..XFCETDFGFHAGDDBEKDEH..MDDHhABA..bFAFdADBEBAGCGHCgBGEhACA.hAAAfCDDHADGWAHDeBBHaDAC.PEEBhAGA.BEBH...hABA...,2,-35,-5,30
PbVDTSACHWUKaeBMfQdRXEZOYcFLNGIgJ,HDBHKGFCBHEGMHBEdAEDEBAAZDBF..OAECFDDE.LFDCGAGE.hAAAJHFE...PCCAhAAADADFABBDCFAGaEGF.fEAEhABA..XEGA...hACA......hADA...,1,-13,-47,34
UEgVXODHbCQIALGdFZSeMYWTcJfNPBKaR,GAEGdEHAZFCAMDAG..TEBB.JFFCPACEKDCC.aHBAEHEEhAAA...XGBAhABAHEECCCEDAAGCSAGBhACAeBAG.WBBFfBFFNDAG.BFAF.hADA......hAEA...,2,-22,-18,4
aCJRHYfQcPEWIbDLMBeXgAUVZFGKSTOdN,VABHFBBDKEFD..OEFGdGAH..CDHFHADFQGGE.EFBEIHGAhAAALEADeDADhABAAICGUBGC.ZADF..hAAA.SEEDaHCERDBAcEGD....hACA......hADA...,1,-11,-31,20
eJbTNROSGBDZVCAdfcHYQIaMXPUgWLEKF,dHBHHAADQAEDaEGAMACE.UFGFLEEFKBAF.eGFE.TEBFhAAANDFC.RCCA.SDGEhAAADAGCCBGDABEE...YDDBhABAIHBAXDAD....hACA......hADA...,2,-33,-5,28
TUARGabMCWceQJNBZVDXgLPFYOIKdHESf,GBCHaGFH.MDIBCGAA.eHCAJBFD.BDGHDECB.LFAG.FDBGhAAA.OFEAIHCHhAAAKAHHdABFEEDG..TBBAhABAAEEA...REGHbAGB.....WACEhBAA.....hAEA...,1,-22,-32,10
NGdRSaQfCKFWJbYLDVIEcgZHAMBeTOPUX,eHAGTDACODFC.UDAFGFEH.RACESGADaCCA.hAAACCGGFDDEJEEHLABEhAFADIFEEHCA.gGGGhAGAACCDBBHH...........hAAA.XDGA.hAHA.QBGEKAFE,1,-13,-16,3
gNLAOeUHWPIbDFSQdRJKZYGETMCcBfXaV,OFCAUAEGHEDE..IBHCDFHHSCHHRADHZBAB.GDAEhAAATGGDMDDC.CHDDBACGhABAaDHD..VFAF.hADAgCEHAHAB.PHDCQGEAhAHAKCCD......hAIA...,1,-7,-21,14
DULeScYOWfERNVHbagGAPBXMCIZdKTJFQ,XGGGMBFHZAGBdACBKAHH...FGFGUCFFLCDBeFAB..SACHhAAAOFAC.EGCANCIA.hAAAHBAB..gBADhABAAFIHCABEJECCDAEG....WHEG..hAFA......hAGA...,1,-16,-31,15
WPUHIceDLfdMBCaGEKJXQRgTZOSANVFYb,VDAGFHBG....bDCFUFFE.HBCGeAGFDHCGLEFDdAGEMEEAhAAACEAE..EHGAKABGQADFhAAA.TEGEhABAZFBEAAID...YCAE....hACA......hAEA...,2,-28,-20,8
EKIaeUWYdJXTLNVFgSPCHMBQZDAfGORcb,OFEFRAADEHGE.KGGBeEAC..UBDHdGDD..XCDBLCAFFACEhAAASCGDHCFDBHADhACADEIHAEIH.GCBE.hAFAIAHHaAGE........hAAA.YABENICF.hAGAgGAECFBA,2,-27,-14,13
EWXPSeQHFKAVgTaRBCcbLdZYGONJfUDIM,TFDHBCAHCGEGLEAD.ZBFEGCBH.JAFGDECBMICCEFFA.hAAAXCFB.PFAAhAAAeDEAFCCF.ABACaHGAhABAcACBdACFOHBCfBAA.WDHBhABA.HGFE...hAFA...,1,-2,-29,27
eAHUXNcMgLFDPCBYWdIfVEGaRQZbOTSJK,UDCBXCBCMCGFFEFA..CFEH.BCHB.dFAFVADEGADF.aEDBhAAAZAAB...OHBAhAAATGGHSGGAhADAeABCAIEA..NHAB.LAHFDBAF....hAGA......hBAA...,2,-32,-15,17
HAPKUfeWQMFbSLZEgBIcdNCJGaVRDOYXT,UGBCeGEAMAECFBCBLAFGZDDGBEBD.dDHCCEAB.GABH.RFCA.ODHHhAAA..XAGAhAAAAEFFKCECQGEDhABAEBABICEF.NIEF........hACA.aDDHDCCF...hADA...,2,-40,-4,36
OANWBRDZLgYEaIQbVScMKHdefPJCXUTFG,BFDGZBCFLBFAEBFH.aHFAQABA.SGHBhAAAMABDKEGHeECBJBHHUFEETGAHhAAAFGAAAEEA..NACFDFEDhAHAIEAC.........hAIA......hBAA...,2,-30,-27,3
SfLDBXOAEaTeIKbVFRgZNGUQPcWCHJMdY,aFAATDAC..eABHKAADFCDFRBECZDAA.UGFEQCGF..hABAPDHDCHACJFDGMIEAhACAdGAE..SDCEhAAADFCBXGGAEGDGIAHF....hABA......hADA...,1,-19,-29,10
WPcdTAGYXMaRQZFSNLHfJKVDBCOIEUbeg,XAGHaFEFZCEE.FHGELEAE.JBDCDEDD.BBCB.IBAFhAAAbGBE..eCAGhAAA..gDDBhABAPHFCdAGFAGGCMECD.SGDAfFAAhABACBEBODAFEBBE.cEGAhACA.,2,-46,-8,38
bDgCecaEYWQKJXINAdOFRUZTVSPHMGLBf,dEEDODCHUAEGZGFE..SAACMBDHBBFFDDGC..CAAFeGAGhACAaHCA...EFEFQFGHhADAKDAH.JBBHIDGDhADAAAHC.FAHF.......hBCA......hBDA...,2,-44,-30,14
aVEPDINWUKAQMFLcZgdTCXYfHReOSbGJB,MBDHLCCHZGBEdDGCCHED....XAFCHAAFeCECOEEASFAAhAAAJFFFBCEDEHGADCIDhAAA..IAEChACAUEACKABGAAIH.FHAAgFEB....hADA......hAGA...,1,-17,-30,13
PMfTZbEBgaWeGLRSVFKQIUOXDAYcCNJdH,CFDGdDCDHAFAMFEFZAAFBBCA..aHACeDFBRACD.FFBCQGFGhACA.UDEHDCBBADHB.NABB.hAAAfDHE.hAGAEHCGWHFASEBBKAGG.....hAIA......hBAA...,1,-5,-44,39
ePRaIGQYBEcFJdgAUCNVLDbSOZfHWKTMX,CHHGVFDFLEBE.DAHDOFBD.ZABEHGBCKCCH.TADE.hAAAMGEGeBEC.aGGFQAAEhAAABDAEFDFGdGAChABAAFIFbDFG...WDAC......hADA......hAFA...,1,-24,-26,2
fAXPDFgJMNLTUWeGRcKQBZOYHCVSbdaIE,XAFBDGHHFDEH..MBADLBHH.TFDEUAGCGFAFhAAA.KGEABCDFZBBE.YDBBhAAACBFC.SABBhADAdDHAaDBE.fGFHABBE.gDEBhAEA.WHDGhAIA...,2,-41,-30,11
SQMGYfETBbILRKOAVCZUJgHNaFcdXPWeD,CEGHUBDGHDBHFEAGdDAG....XCFBeABCQGAGGEGGEGAEhAAABHGHLHDAOFEBhAAAABCF.ZBACJEEFaAHH..hABA.WDHHMABCfDFF...hAFA......hAGA...,1,-7,-24,17
IQcJdYafCUOEMHDLVBgGXWTePbKARNZFS,RGFGZDAGFAHHQCFG.dHADaGCB.UAAHOFBGHDFCDFGFBAFGhABAGABD..TDBFhADA.eEADKHEASBHBhAAAIBDC.cFDD.fCABhABAMDDE....hACA...,1,-18,-28,10
dYWBGJDEQbIeUAcTgKXPONaZLfVMCRHFS,TCBCXGBC..OEHDaABH.LBEBMAIHHFDDFAACSADDhACAdADBBHHGDGAFQGBDhAEAIDCBeDFGhAAAAGGHKFACZAGFfFFBCEDDWFFF......hACA.EEBB....hAGA...,1,-8,-19,11
FLEHXNRfKYVBScCQIMOGTZWUAbPDdgaJe,DACBdAFBJDDCeAED.LDGFHGCCRDAG..KBCFBEEH.CEHF.MDIFGDAFhAAA.ZGCAAAAB...hABAPAFCaGGCEADB.XCGBhACANIAF..fBAA.SFADhABA..hADA...,2,-29,-24,5
dSNBbLeYcXagZMFCHQWOVKDEAfRPIGTUJ,RAADGAFEUGGE.dFFFBEEFLBDB.eBAGXBEBZFAB.FGCCCGGD.hAAA..HBGB.OEAFhAAADCIHADFBIHEHhABA.SDAFNADH.....hACA.cDCG.MICAhAIA..,1,-24,-30,6
baEGRAQWdeTXcILgUZKDYHfOSMPFCVNJB,dGFCeDCH..TBCAXDGALDHFZBEDDDAGHFBE.OAFHhAAASHCEMBAHCEEGNAEHBBBGhAAAEHAEAAIB...QFGHhABAIHHE.KACA.fBGFFAGF.hABA......hACA...,1,-12,-21,9
EBWePGDHdNbMafTFcKRQJXILUSYCZVOAg,BFEDeGEAGBGCDGIDdCFC.MAAC..TFBGKGCBRCBE..QADEhAGAJCBG..IACChAAASFEC..hAHACHDBZAGHAIHAEFBF..HFFB.NBAE....hAIA......hBAA...,2,-35,-17,18
RAQONaUTMWcYHVIGXPeBLfJbgEDCSdZKF,QDACaDCD.UAGGTFFF.MBAA..WGDEHAEAGBADhAAAXCGBBGBEfCEGhAAAJEHDEHEGCDFH.SDAHhABAdDDAKAEGAIHA.OEEB.YHAChACA.....hABA...,2,-21,-5,16
MeKZTcRXUdEDOWVCfAgFJaHbGYIQPNBSL,JCCHaCFCGGEF..QGDABABDSFACLAFDeEFGhAAAKGGF.ZFBERDABdEFDDDDBOAEGhACACGCFAAHGHABC..IBDAhADAMDIF.........hAAA......hABA...,2,-25,-20,5
DVRPEFWfQcBIUGMSXYZaOeHbTdgLCNAJK,DFDCVGFGEFAH..FDAGQCEBBDHG.GAAHMECH..SBFChAAAXGBDaDHHOBBEhABA.HEDA.dAHEhACACEACADAAKDEEPGFG..WFAF...hAAA......hABA...,2,-30,-18,12
GgFKBJSVXDHYWNbACTQLEdZPcIMafRUeO,QABHLEGHEBEAdECGZFEF....IHFDaCEEUAAGOBEHhAAAFEBEKGAAJBFC.XFFAhABADICE...HFABhADANBIEAIHG.TDFGMAFAeDAFBDHB....hADA......hAEA...,1,-10,-21,11
EGgFALbIJcCPeMTKZNOHXRaWBYVUQdfDS,LGEAJGEA.CBHC.MDCAZDFEHACDREBE.BCFC.UGBHfACChAAAEEAE.FGAAAFGC.IHDGhABAeAABKECCXBEAhACA..WAFC......hABA......hACA...,1,-26,-36,10
GUfabePHJDVYSBcMdZQLEFgOWITNRAKXC,KFFBCDHHGEEFUAFC...aEBFeAAC.HDCEJBAC.DGDB..VAEBhAAABHHG.dFBEZGACECDEFGDAhABA....OAHFhAAAIHGG.NDAFABIHfEGD..hAEA......hBCA...,2,-34,-24,10
RKSOEHBCgdPITQDYWXVZUGeLJfFNaAbcM,MCCARFEEKECD...EAGABDAHdDBD...TAFGQFBE.DGEGhAAAXDGAZGEEeEECJACDhAAAfADD.hABAaABCAHFH.SDGECDDCIHDEWCAF..hACA......hAFA...,1,-19,-46,27
UYFXdSHAaJIQbCcTZWGeVDfPERNOLgMKB,JCCHQCBC.CFGCZGCEeBDE.DBGGEBHHOGAGLAAD.KEDAhACABHHBFCFB.SDAFhAAAAGHH.aEHFbFBCTGEEhABA.....WHAAfAEChADAPEEC.NDIEMEAF.hACA...,2,-43,-11,32
JcWGUaFKANOICMLZDRXTVbEgPYBeSfdHQ,OGEACBFDLDECDAAE.RBAC.....XFAHTEBA..VFFHhAAAEBDA....PBBBhADABHBHfAHAhABAdDDGJAFA....cCGB....hAEA......hAIA...,2,-42,-33,9
IAQVTgRZGJKdcNeXCfESYBHPaWFUDbOML,VCDBREFHGADG.KHGGdFCG.eBCFCDAA.EEGEBFBC.HAFH.aFDDhAAAFAAF.UGGEDCAGMICGhABAAAGEQBFE.hACA............hADA......hAFA...,1,-28,-31,3
PQBMJYDSCFRXadGLOVIUTbgZHNEKcAfWe,eGEABHHGMGEEDCBAFFBARDCB...dEEBGADGLDAAOHDA.UAAChADATAGDZBFDHFAFhAFAKAACAAFC....fCHChADA.........hAGA......hAHA...,2,-35,-20,15
YgTPHQKFbUVWdJCOBfacLRGDMSZXIEANe,eGEATCBCQBCF.KBFFbDFFUBGEVFCEdDAB..CAHBBHBEhAAAaEFGREAG.DCFGZGAEIABGhADAAEID..NABH..hAEA.PFHB..WHFAfAFBhBAA......hBDA...,1,-13,-28,15
SMUBIDWGOZREHgeLcJaKdPYTFQNAXCfbV,CHHGVAADUGEG..DDIHGACGZFBC.HCGDeECELEBF.aEEGhAAAdADG.PHEEFAFFACAH.hABA..XAFAhAAA..fAHE.....hACA......hAFA.MIAA.,1,-20,-25,5
LcOCKXYJWUgZeIVGNHDdEaARTFSfBQMPb,FDAFBFEDQDFDMBFHLAHB.OAACXAGH.JFGHUFAEhAAAeAAGGCCCHEDBDDDChACAaFFAAHHDTGBG.hACAfAFAPAGB.CDCD..WFAD..hADA......hAEA...,1,-14,-22,8
gCdNAUXVDTHJMcGQaFORPeWZESILBKYbf,XCCBVFEE.DAAFJAEF..GGAHFAGB.RFGB.eCHDZAFGSEADhABABCBHKFAG...hAAAfEBB.hABACFEEAEEGTDDDMBBCaEGAOHFE.WACB.hACA......hADA...,1,-20,-35,15
MBQJVfUKOLWAcSHCGbeTRNEPDaYXdFIZg,SCFCHCBFCEHDGFBHeEFARADC...EBBAaGEEdCDCZBFGBGAH.QGDFhAAAfHGHOEBFhABAAABF..cGAChAAANCAEDIGGFGGEMCAF........hACA......hADA...,1,-15,-16,1
PHAZCOFXYMDQKRGJdLfIWTVagBebESUNc,ZFEEFDABMFEFKCBDRADA.GACFLGAG....fBHEhAAATBGC.VFAAaDCEeHEAhAAASFFB.NEDD.cBBAhABAAIFA..OCDE.DABA...hACA......hADA...,2,-28,-15,13
EFJgDfeUHSBLGKXVQIMTWYCcRdNbaZPAO,OEGHEEEDFCGF.DAGCUCBFHFCC.LEADGADBKGGGQCCDhAAA.MEID.TADFhABACAADcGAFdBGBaCFEAEGH.hABA.JFDF..........hACA......hADA...,1,-6,-36,30
IaGQUKcWgZMLTOEYdfeFHNPDbXSACVRBJ,VCDHRFEEBDGC...aBHFUGAG.KEAC....gEAEhAAAZABGMIDEOAHDEEDFdBBFeGAGhABAHFGFDABA.XDGGhAAAACCB.........hACA.CEHBICEGhADAQAFFWHFA.,1,-15,-27,12
ceHZfYGCKbRQdLNOSJDUEXAFTMWVIaPgB,TAEDMECG..VACGaEAG..BEFEHFFAZBAEGAGGKDHB.QFCDhAAAdGDELHFGSBAGhABADBAGUGADADIHWFAHhACAIEDD.....cBGEfCFGhAFACFGHNAAF....hAGA...,1,-14,-15,1
gVWADQFfMdLcZHUONSReaGYbTKIPJBXCE,FDABMHFGdDDALCBHZGAEHFECUGCB.OAFBRBFFeACH..aBHB.hAAAGDEF..YHEAhABAKGAHJAAECFFD.EBDBhAAA............hAEA......hAGA...,2,-28,-18,10
RUVBQSbLOaWcTdMCFHNfIZYeAEJXKDgPG,EGDDXAADDAGE.GGAFUABFBCAD..SBFDODFB.hAAAaHEE.TEFACCHBFGFEHEAGhACANADCZAGF.AEAGKCDBREAA.hAAA............hACA......hAEA...,2,-38,-15,23
BZTWaFPCIKcYOHMXRGUdSgDJLEbeAfQNV,QCBCBFDDZAFA.aACEFGAF.CABD.KEFD.OHEAHBCGMHFA.hAAAREFC.dGBB.DEEFJEAGLCHHhABA..EHCGhAAA.AADG.NIBH..........hACA......hAGA...,1,-29,-35,6
FeZPBAYXKJbcVUHdCSgOWIDNMRLEfGTQa,KGFCJGEA...VCAGUCCFHDFGdDFH...CHBD.SEAHOAEDDBAGhAAARAEC..LAAFhACAGEBBaACF.FAHHeHAGhADABGDAAIEA....bEFA......hAEA......hAFA...,1,-20,-29,9
QZVLFKYbRDBWdNTcOEaIMPHUfCJGgXeSA,ZABHVDEDLAEH.KHBGRADADAIFBHEGdHCH....TDFGhAAAEAAAMEAAHAGF.CBDCJFGBhADA..XBFAhAAAAGBEQECAFCBC..WFHBNBBE.OGAG.hAGAaGGF.....hAIA...,1,-19,-21,2
deWSXRZLMEYJPDOGACTcBHNUFbgVfKIQa,TGGGHDBHUGEB.FADAVEAFKCAD...aCCDdABC.eEFE..hAAAWCHDSAGEhBAA.XGBARAEEMDGHEFEHhAAA.PBAGDDFG.AAHCBEEC.NIBB.fEEEhBCA.IBGFhBDA,2,-25,-18,7
HeBAPSVGWbTLZIFUaOKXRfCNdQJgEMDcY,SCFCVEBH.GGBHTDDBLACBFAEF.OFGBKBBEXFGBhAAAfDFFCGEHdCAEhABAQEAF.hACAEBAEDIGG.HAGBAHIH.......hAAA......hABA...,2,-21,-18,3
dNRPKYMGUHQIWSbfLBATgOcFeVDJCZaXE,TDACOGEAFAED..DFFCCGCG.ZGDA.EEDAdAAC.RDEA.KGBFGCADhACAQBAH.IAFChAAAbEAGBHAE..AICGeAGHhABAaBGC.XGGBNDIE.MAIF..hACA......hADA...,1,-19,-24,5
WBSReEOIfHJTVcgaMYPdKUFCLXbNZQGAD,DAEDSEGDEEFG.OACDHFDHJDBD..VBGDaCAB...PEABhAAAUGGGCAGC.LAAAhABANIEFGGBBACHABDHGhACAIABD..fDDHcCDE.MIAGhAFA......hAIA...,2,-26,-16,10
YQOMgVTASZHWbPUeJLXRCENdcKBIGFafD,ZBCFHAAD...PFDDJFFBLEAD.CHCF.EAFEdEHEBDEBFCFA.hAAADCDC.OFHFMADC.hABA......hACA.gECGAACESFGF.UEAH.hAHA......hAIA...,2,-38,-30,8
IJXPWSBTOCeZHUaKDLAEbfMGVdRQFYNgc,EHBGMCCAdFAFFABG......gDDHIEGA.JBBEXGCHhAAASEGGBEEB.hAAAOAGBCDHDHGDEUDBFhAEAKAHBAIHE.fAEB.....hAFA......hAHA...,1,-17,-44,27
AeOQKZWbVPXTNdfEacBCSDFRIYLMUGHgJ,eFCAQAADKACBZBEF..VADB..XFGCdGAAEDGFBAHGhAAADBHHRBAFLFABMDACHFDChACAADEB..OHECPHCChADA.NFAF...........hAFA......hAGA...,2,-31,-9,22
gQcBfWXaYERNKIGDbUdLHTACZSOVMJPeF,SBBDMAGD.eBGFQFGFBFDB.XBCAaBEG.EGEHhAAARDBCKFHFDDAF.dHEHTFBEhABACFFBOGAAJAHH...hACAFABA...fHABNBBAGDDB...hADA......hAEA...,2,-24,-16,8
ScfAWGdYPTaFKREOBbIQeLVXZCgDJUHMN,dGAHTCBCKAFARFDH..EBFGBCCD..bGEAeHFA.LAAChAEAZGAECFAFJDEBHDGF.SBGAhAFAABCE..WABChAAA..YCEHaFGG.OCBH.hAFA......hAGA...,1,-15,-32,17
UYZKVcGDbLCAORWEgSHTXfdeNQBPIFMJa,OFBBRDAGEGHH.HDFE..TFFDdCBGQAFGBEFFFABDaFCDUDCEhAAA.ZFFAKCGC..VACEhABAGADCLHDAhACAAGBDSAFC.fHEB.NIAFMAAFhABA....hADA...,1,-2,-22,20
QaWMVgfGSPFBECHUbTXLOcDRJNIAeYZdK,eFBBZDAGKEGCQFDH.MDFCgFBGSAEHBAHEEAGChAAACGFHHADHUBAAXGGHhABALFDHDBBHRACF..hAAA............hABA......hACA...,1,-6,-37,31
fSPgecUTGJRbIMBWHCYdZDANLKaFOQVXE,KDCDaEED.OCGD..VAEBEAFE...SAHBeDAFUACGTCADhAAAJFDG...REAAMFIHhABABHGECHAEdHCBDDIHADGH.hACAFAABQGFE.fACHhAGAcGCC......hBAA...,2,-33,-16,17
NCFJKLDaSEcdbVXOYUTIAQRBGMZPfeWHg,QGDCRCBFBAGFZEFH.eCFAHECF..CCECKGBDDGIH..aBDFSBBGhAAAdHCD.VEFBOFABhAAATEBHAABC.MAFEhABAPBHF...fEEENCAA..hADA......hAEA...,1,-12,-30,18
OCfWVEcTIZBHUeQaGNYLFSbKPdAgJRMDX,JFBBMCDD.DEFGCEDC.....VBEGTBADBEAFUEGB..QFFFhAAAGAEBLHEAhAAAbEBD.KDAFAADCXACGhABA.OFHDfFDH.ECDAhABAcAGA...hACA...,2,-34,-24,10
FeAdKPIBfLHQDOJEWaUMXgTVSNbYGZRCc,dAFBKHBGBCDAHEDDQDAHDAGE.OAAHEEBAUFEA..MIAGhABA.XFGFhACAVAAA.NCCF.GBGE.hADACHGHeADGIDHF..LFAAaGBG.hAEA......hAIA.SGGD.,1,0,-29,29
aTPfFAObMRDXUJZCWdEYHKLBegGIQSNVc,MDEBRFEEDCBH.UCFBZDCE..dHADHFFDLEHBBAEHGABA.QGBFhAAASACHNBIG.hABAaHDC...fBGBhAAAAGAHXDAHCFCAEAEC......hABA......hACA...,1,-14,-34,20
gQcRFPWYDGEOUXKaHedNMVfCJSBATZILb,ZEFHLGEAQAAEFCFG....PHBCDFDBEADF.UBGFKDBDaBBEhAAAdFBAMCEB.CHEGBDAFhAAATEFB...hADA............hAFA......hAGA...,1,-31,-43,12
baVEWfANHGeSOUPQMTYdgFcLBJZXDKRCI,HEBHeCDGOFFDUBCAMAHFdABG..FGAFBGABZDAC.KHGERAFE..CHHG.aEGBhAAA..EFCBAABFSEEFhACA.QBEAhADA.........hAAA......hADA...,1,-27,-36,9
gSWcJOMfPXAFCETUVYGaNRLBdQKIeDZHb,FEHBCFCFUBDHGBCC.RFEDBAFDQGFD.KDAHDDAH.ZEBHHDGFhAAA.SAGDhABAJAAGMIBA.XDEC.hAAAEBBD..TBGCaACGNIAH.IGAG.hAFA......hAHA...,2,-31,-21,10
CMWcNfgSVQPOEHdGDbaXeTYRLZAKFJUIB,KEEDFGDDUGGECGFG..MBCH....NCDG.SGGE.hAAAQFBBEDAHHABDDCFEhABAXCFEeCEDTFAChADALABCAFGEBHADWBHB....gBDAhAAAOCHD...hAEA...,2,-32,-27,5
KQHZIEbMYBSeGLWgUXROJDdfacPATVNCF,VEFHFEGDKAFB.HCACZBAF..EADGMIAC.BBAEeDHBLEABhAAAUFCF.REDHDEIDdBGDaHBCAIHE.hABACFAA.QACEhACA..ICDASDFC....hAFA......hAHA...,2,-25,-18,7
cMgQbfCaOXdIGTBePRUJFVESHZADKNLWY,DGHHLCCH......YDFCcAAB.MBBCQADEhAAACFBD.aGFEdDABIEFDhADAGDCCTAFFhAAAPHAARAFGFHAA.EFFBSEEDAEGH.NIDHgDGBhAHA.hABAOCBBBHFD,2,-21,0,21
KeAOQGSFEXZdLCDJNbagcWPfTBUYIVMHR,ODACGCEBEDBDdFAGDGIF..JHEA.aACD....gCFAhAAAPHBE.BCCHIFEAhAAAMFGFKGCC.AABCFACEhAFALCADCEHD..NAIE.cAGA.fGGDhABA..hACA...,2,-33,-32,1
dBOVbHGTDEIKLYSWfPNQAeMXJgFZcRCUa,MAFHXDACFDABZGFARFBF..UGGGBCGB..OBCEHEBBDEDCKBGFLDFGhAAASBCG.hABA.fABFhAEAQEFAADDHJHDECAAGaDHDbEECEAGA......hABA......hACA...,2,-26,-10,16
KAOecURYGTPLSfbJgFXIZWCMDNBVQHEda,OEEGeDACRCECGGEFLEBD..SFAEfAFEJADGFAAEZECBhAAACAHH.MCIFBGGHQEFDhABAdADAAHDE...hAAAYBBAbCFA.IAHF.DGBF.hAGA......hAHA...,2,-34,5,39
LMJXZFcAUTeOWGbIBHfPQEgdaRNYKDSCV,UDCHTFCAeGCG.GBDDBBHCHGFE.fFAHEHAEdAGBRFFCKABAhAAACEFHLAAE.hABAMAFG.XBBHhAEA.FEHBADABOCHDICEG....hBBA......hBEA...,2,-23,-17,6
BZLWgCIdFAVEJGRfOQMTYXaNSKebDPHcU,VDEDEHAEGBEH.ODFBTCGC..XDCFSFCHKDABeAAChAAADAACHADEBHFFZFAHhADALAFCCHGFICBBhAFAAHDEfBCF.MEIDYFHHaGGD.hAEA......hBCA...,2,-13,-10,3
cIaKLfDQHNBeCbTFPROdJVSWZgGAYUXME,UCGCMBDH.EFHF..ICBDLHACQFCEBAAHCCCG.FCHBOAFChAAAdCFG..JAFASEDChACAZEAFAIHA.XGFDhADAaFGDDFFFeAACTEAB.RFDB..gBDEhAEA...hAAA...,1,-12,-24,12
RdGTODLfQPHIcEKYgFVMbWNJXSCUAZaeB,ZDEDBDGFdADDOCBHDHFELCBF..fGFBHCGBEGADKECChAAAFFAHMIAC..NBAE.hABASEFGACDG.hACAaACF.eAEG.TECCQGCGIAAFhAGA.YHEAhAHA...,1,-19,-37,18
RFWBbfYAVdSZLaUCIEeTMQNGKHOgJPXcD,VFEEdEHALDAD.CACA.EAFD.eBBCQAAAKDCGHEAAOEBGhAAA..PCGFhAAADEFFFHCAbGAGAGGBZBFE.aDGHhAEA.....IHAE...hABA.NIEF.....hACA...,1,-17,-23,6
IPYKEMRdcNeGJTDACHLSfgZaQbVOFBXUW,CEFAHDEDLEDDSHGEZAEG.QGCAOCBBFAACXBEGhAAA.UDBEIHFBhACAYBAAECGARFGBdAHCeFABhADA............hAEA......hAFA...,2,-25,-7,18
dJKbBaWIeFcOUXQEYMDfPLZVTSRANGgHC,GAFECFDDKCAE.aHBE..eFFDOADHUFAEQEDC.MGFEhAAADEDCLEHHhAAAZBAFSFBBAAIF.NAIE.gAGDhABAdHFDBAEC.ICDD...hABA......hACA...,1,-11,-44,33
NGAKcJPgVRfQFTSUXEIMaCeWdYDLZBHbO,JCCHVAAD..QBGEFHDA.UGFEIEBG..CAEHeFDFhAAAdAFGDDAFBACCHFECOEEAhABAAFEAKDGA..PAHDhAAAfEAE.SGADEDDEaECD..hAEA......hAGA...,2,-36,-19,17
ObRgUaeLMAGKWQSHECcDNXVJZTYBfPFId,KGAHSGFCCGEF.DCBA..VAEBZFDHBAFCFAAF.dCFFRDGF.aGBGLCCHhACA.AGGH.QDBFhAAA.EAHBhABAXDABJEEA..fABF.hADA......hAEA...,2,-45,-26,19
dPDaSRTVFEWXAKHgGBfMZQLeOIJNCcUbY,KCFCHEBHBACAMAAFLHFEeBHH..IHGGCDHA..UEADhAAAdGAADDDCaABH.RBEEFGEDEBDA.hACAAFEE.GEDB.ZGAEhAEA............hAFA......hAGA...,2,-29,-26,3
QKDGFcLMRVAOSIBNbagXTfUHPWYeECZJd,SDCDBFDGaAGE...TAEDUACGHFGF..PCADhAAAeEFFEAADCBHCdFHCDCFFFGAAMDIBhABAAEFDOGDA.IACGhABANICH..gFAEfHDD.hAFAYDDE..hAEA...,2,-30,-20,10
QGNMKRCHeILOPDbAUJZFEgWSTBfVYcaXd,JADGZFEEECCG..SDEEBBHH..fAAB..hACAYABFXBEEQFFFhAAAMEBEKGADCEFGIHCFhACAODHFbFBBABGFgECF.WFEDhADA.....hADA...,2,-36,-31,5
fXdSgZUCEKAQRGePHTWNOLYIJBMFaVbDc,RACFeFEFHFGD..TDGBOFCBLAAC.JBBFBCBG.aAGHhAAAbFCBDIEA.XEDEhABAdAEESBGCZCEAEFAHACAHhACA............hAEA......hAFA...,1,-22,-23,1
JDFPXOCYVRQHKIAETZBdNgMcbGSaLeWfU,ZBCFdEGDMDBCGDGCLAFEeHCEUCAB.FAGFXEBA.OHBAhAAACEAHRFDEKAABAEAHEFEEBCFChAAA....cCEDhABAaFAE...fADEDCIH.YHEGhACA....hAEA...,1,-22,-33,11
XOCVNZBcEQgYMedWDKHIGaUPSfRATLJbF,TFCALEEG.JAFEFGGB..CAAF.ZAEGBEBDEGEH..QDDFhAAAMDCCdBBD.DBBEKBHBIEAFhABAUGGE..SADBhACAAIBC.OGDCNDIAcBGD.eCAAhACA..WFAG..hAFA...,1,-10,-41,31
UcOHJdDfCKIYMWgebRaZTSLXBQNAEVGFP,EGFHGBCHUBCEHEAC.DBGCKEGCMEIF.eDGBaEABZGBGLDAEhAAABFCHAHHFVFEF..FBAHhAAAOHAAdBFH.fABChABACEEF..WCFA.....hADA......hAEA...,2,-38,-5,33
KOXRFaUeIJHBDTLGVSfZQMdCbgWNYcEPA,KGDDXAEGFAGH.UDBHeBBH.HEAGDBCHGEEC..fHGFhAAAZBGDdGAFCEHH.gEEBhABA.NCIA..hAAA.EHGAAIBGRADFIBAEBAHB.....hACA......hADA...,1,-22,-27,5
MDaEKIVYZQgcfFSdWHJPGNRUBOXLACebT,CAFBeDAC.MBGBDCEHKAAA..VEDHZCGD.QADH..hAAAgGEGfCEGhABASCFBdDHG.hACAHDBDJHAGNIEBBHHGXFACAADBaFGEECAFIGGHhADA..YHAChAAA..,2,-31,-11,20
GHKRgYJVNdXeEcMPTAOFLQUIWSDCZfBba,FGDBLDCHUBGG.SFFHZABCBHAH.aCEDHFFF..RAAFJADEdCDDEEAEhAAA..MCHFAAGC.hACAIHHEDEFG.CAHA.hAAA...fGDC....hACA......hADA.KHAA.,2,-39,-28,11
EJTVCOKAWXgZFdLbSGIeQBaMDNUHRcfYP,XCBCZDAGdHADLADEGDGC.eEHFBEFFMBFBDAGEHFCD.RADB.hAAAfBGCEBGC.hABA.JFAFCHEEACAA.FEDDSGGDhACAaFFF..cABC...hADA......hAFA...,1,-17,-18,1
DYaOTdWKAbMFJBCEQZRINLXSfgGeVPHcU,MHFGBDGFQEAFRCBC.LABAfCGGGEDCeGAAHCCHhAAADAEAaDFHTGBGdABHAIAChAAAbFFFCEHA.EAGC.IHHEhACANGEH..XAGA....hACA......hAHA...,2,-25,7,32
BgJbcSRZOXMFKNeTELVCIDAfPQdYaHGWU,QCBCdAFBaFEA.HBFEUDAGBHHB.JFEESAAFZECB.hAAAOBHDFHEEKBDHTGDEhACAEFADCFBB..DBAGAIGCfBBFhADA.PCEA....hAEA......hAIA...,1,-25,-34,9
JPSMOIFRXgTVAcDYEdZBNLUWfbaeQHGCK,DACBEAFBdBADBGFHLGDGUDBF.....bBDDaAAD.HDGBKFGCJAHFhAAAMGBG..OFCAhABAIAHGRDAF.TAEEhAAAACDB..cGAENICB....WGAGhADA.eCFFCADC...hACA...,2,-25,-18,7
CdYLKFABDNgEOVfRGJWSUQbcHaXeZIPMT,BAEDDACBEGHBOABF.REEH.GEEA.SADDQAGDHEBEhAAAaFCDZDAGIBGAhABAMIEGdEHCLDDC.hAAAKDHFAADBgFAFJHAAWAFE.....hAEA......hBAA...,2,-20,-16,4
OQWGadSCUINYebTLFEcDfgJZVPMHRXKBA,ODACQFGHGGAHaEAB.dFFC.UBCHIHBF..eEFEhAAALCEHEAGG.DAIBgBFGhABAZBFFMAAGXEBEhAEAAIGACFDA.YCBA.FHDEfFAFhACA...hAFA...,1,-15,-21,6
fOLMHUGBVESAFaebdZWcgTJCYXDRQNKPI,FEEDeCCHdGAFZGFE......gAEFCCHCDBEGQFDGhAAAKBAC..IDDDhAAAfFFDOEHBMGACGBFAhABABCAAEHACSEACAAECWABB....hACA......hADA...,2,-31,-25,6
fcLAEdKeSPDJCYRXHVTZWaBbIGgMNUOQF,KDABSDCDDAHF.CGBG.REFHHECCZAEA.BHGHGEFC.MEEBOCHDhAAAFAAD.LACEhABAAADFeDHD.JCDE..XGCDhAAATGAE.aFAB..IHDH..hAGA......hAIA...,2,-31,-19,12
LUEeMHNTQgSKJPIBZAXCGadVfRcYWbFOD,CDHHdDAFRACB.......YEDDFEECDEBAEAAFHFEH.QCGHhAAAKHAC.IGBChABAADFGaHDA...fAFHhACA.cBCHOBFGeBEBTGGEhAAASHGEBFCG..hADA...,2,-46,-22,24
ACSWZVdPFHXUcJTLKGEgQBNMeObaIfYDR,SEGDZGFGdFAFFBAAHDGHUFDA...JAEHKBBG.EDBGBDCC..hAAANIEF.MFED.OHAAhABAaBFG..IAAChACADBGDAEDE.CADC..PEBB...cDGAhAFA.....hACA...,1,-28,-36,8
HJbIReYfTGCMEABFKLUVXNZQPdDacOSgW,BEFAFEEDUABB..NADB.QGFE.DBGEaHBA.OCAChAAASBEFHBGHJFCARCFA.hAAAeBBE...TGGHhABACGAEAAHCKEHH.LEAEXBEF...hACA.dGCA....hAEA...,1,-23,-26,3
YPBgIWGQfFREcOJKAHSaMdCVZXTbUeDLN,HFEEMIAGdAGCVEAFZDCG....TACCeDFHLBBE.hAAA.NDIEBDGAIEADhAAAQCADREGFEFCAJHDAAEEFCAHEhABA............hACA......hAEA...,2,-26,-18,8
UaVHLIDfMPJKYGNXdTgCeESAObBRWZQFc,OAFBRDBHQEGHUDAEHGDADHCA..MBDCKEDEGAAF.dAGAhAAAgFDEeDFHAIHABGGBhABAFBADaAGD...hADA............hAEA......hAIA...,1,-20,-34,14
aSgWMKBZJXFNTHDCcLYVIdOQfePbEGARU,aDAFSHBG.MFEBBEDG.ZBCEFAADHCGFCCFF.LHBAhAAA.IAHDdDHGfAEFhAAAeFFFEBACAFGBgCCDhACAKGBE.JDAF.XAGADIGG.hABA.cDDA..hACA...,1,-23,-26,3
NCVJZcPdKbIgFRGYeAHUfSOTWDaLEMXBQ,UFDHOCCHDIGELCHB.EFFBMEEABDDECCCAZBECdHBB..KAEH.hAAA...IGHBhABAFAACGBFAAFBA.fDAChACASGAGWHEAaADG..XCAFhACA.NBIC.....hAGA...,2,-43,-21,22
RgVQPDdXTBJMSafIGHeYOWLZKcUNFACbE,EEGDRGFGQCGEdFDGBCEE...SCAHaEABGBBAeFBD.OECEhAAA.LDCEhABAKFFFNBIGAEEACAAC....hACA.gGACPBBGDACE.XAFFhAIA.MIDE.fFGBhBAA,2,-43,0,43
fEJIAUPDRcQCXSGLdYegMNKHOFZTBVabW,UAFBRFDGQFBECHEF.GAEHdGCCeHFAMIFAKFGGHCDA.ZAAEBEEFhAAAaCCH....fCAAhAAAECAEAIAADDEC.SHAGhABALCCH.NDIE.......hACA......hAEA...,2,-44,1,45
GAEUDeVPOTFbfYJIcCZadXHQKWMBSNgLR,DDFFeFBBOCCGFAED......fDDAJEBACBGHZGFG.aBCHdAAChACAHFEF.KDGBBGDAhADASAGBLAHBAADCECADhAAAUGAF...PDGB....hAEA......hAFA...,2,-34,-23,11
BFcHAMXVOYRCSPLbDfIEGKdZaegWUJNTQ,MEIBVADG.RFED...SGCGLCEEDEHDEFEC.GBBEZCDCeDADhAAAUFBF..JBBHNAAFBAFAhAFAFAHDAFHC....XGGChABA.CHAA.fDEA.IAHChBAA...hACA...,2,-25,-22,3
FQBXMRWCdZTKSYfgJVDeUIAONbcHaLEGP,OGEA..cEBHHECDLCAD.EBGEGEEEQCDBhAAAMEHDRAFECGAB.dBDEZABChACASCAGYFHBJCGFhADADGIBeHAAADID..NIAB......hAAA.aABB.BHDA.hAEAWDFE.,1,9,-30,39
UNYRFAPWOHaVeKQLTBXEdGCgfcSDIMZbJ,OGEAaDAF.KGBHLEFGBAAD.dGCGCDBH...fAFFhAAADDDBZBAG.JBCAUAFA..hABANDEAFGGHAHED...HCFAhABAeEEA..........hACA......hADA...,2,-51,-20,31
cZfHQKeWJbMLCdPgTRFBGASVEUYaDXNOI,SEHBUCCBDBAD.OFEHZGFEHDGH..QDAFKBHHeDFD.hAAAJAFELAEAdCBFTFFEhAAAFGAAAFAEEGCB.XCFFhABANIAF..IGDCfACH.MFABhACA.CHHE....hABA...,1,-4,-26,22
IOWaELUbgAKMdXfRJcDGTCHYePBFSQNZV,dHBHREFHDBGHCGHHHBAB..eFCAFGEG.QBCBZCGDOECHEAACLBFBhAAAUDACAHAD..KHDCMAEAhABA..XAEBhAAAfACCJBHF...cDDG...hADA......hAHA...,1,-17,-22,5
DfZbVQRYSLFUOeGNgdBHAIWPCKEcTaMJX,..IFDGPAFBKABC..EAAF.aEAAJEHD.DEBCZAGD.QGEHhAAASGEBFGBDODFDhAAANBFA.BDDEAFAGCGACMFIBhACAXBBC.VGAG.....hADA.YCBG.hAEA...,1,-14,-39,25
fTUILadgHbcDBONCGAEVJXKWZFRSPQMYe,EDBDJBDG.KCGFFEAG..RGAE...QFFCMIFGeBBCUAGALGFGhAAAdEECHAACDFEABBFChABACHEGAGDH.XCDC.hAAASAGEYDEC.fEHAIHHH.hABA......hADA...,1,-16,-30,14
TEJeUGbXDLgcYdBSRCFaQOWZAVNHMKfIP,VGFGHFACMCAA.KBFA..PEDGEADCUFDAGACDDDDE.LGAAhAAA..cFGFhAAABEGASDAEhABAFABGOBHDAGGDNCIAfFAD....hACA......hADA...,2,-23,-22,1
CgLYNSTWBcFZPKAUadHXDJfRIMOQbGVEe,aFHBXCCB.DCFHRAABMECF..QEGGVFDH.CEEDLEADhAAASAGCBCAGhABAFACEKFAFdCGDJABEODDGhAAAEFBEeHCE.........hACA......hAFA...,2,-32,-18,14
KQRPfbMcgEVFXGUCAdTIWYNBeSJDOLZHa,TGBC..IECD..WEBEBHDH.JCBADCFHLAEAhAAAaHEA.RDGH.PACBhAAAMBAEEGHHFAGAUDGHhABACFFDAIAG.dFBB.eAEFZDAF.HFFC....hADA......hAEA...,1,-12,-33,21
RDfJPaWIYeAQdLbOFTGMBZKScUHNXEVCg,QGGDLCCHFEFCMBBABHGCZECAKAACUGBAHGCE..EBHHVAGFhADARDEEDAGH...JCAAPEABhAEA..WEAFhAAAIDBB.ABCA........hABA......hACA...,1,-24,-26,2
CHfMPeGRKZdNWJYFULXTgDQVcbBSIAOaE,OEGHaEHBHFCE.MBGDGACG.KFACdABDJHAEFEAF.LHCGhAAA.TCDEDAEEQAAFhABA.cAGBhBEABBHBIHHC.ADCHEEFBPEED.hACA......hAEA...,2,-31,-16,15
SPDWbOcIJVCHgEaNLAGZBUdXfQeTMYFKR,GCCFBADCdDEBQAFGMFEC.KHGESBECDFFCOBAG.JEAHhAAAVBAH..CGEHEDAEhABAaGACAGCE...XGGEhAAAfHCB..TBGDFDGE.WHEGhABA......hACA...,1,-16,-41,25
LQAEIfYMBVUPbJagKDdOHGRZNeTCXSWFc,EHBG..fEGDBDGFUECFJAFBKHEEOECCGABB..ZCADeAHBhAAACABA..SHCAhAAA.FHGAQFGEhABAAADBMHAE.PCADaCGEDBABdAFANAEA...hABA......hAFA...,1,-21,-24,3
PbOFUNGKEeAJIWVgcDMafXYZTHRSLdCBQ,JGEAVAAD..DAGCMDEB..aABC..XBEAZDGHREBD.LFFGhAAABEDB.QGAEhACAOBEAFCCGNIEBKDCFADAH.hAAAIAEF.gDGAfFAE.hADA......hAGA...,2,-45,-19,26
cMSKLWOUEPNACeaDZgGQVYRTJHBfbFIXd,aDABZFDGQCDC.RCGBHEAHBGCEbGEEFABDdDAB..MFBDhAAAKAGDOHAEECHDABCEDEFG.hAAAGBCF...hABA............hADA......hAEA...,2,-38,-19,19
dZJAEDQHgBSYWKOcbaXIMGfePNURLVFCT,QCBFBFDDSAGEKFGF..OAEEaABH.MIDGeHFEUCFEhAAARCDBFFADCEAG.ZCFC.EEHBDABEhAEAHDAC..YDEFhAFAWHBA..cADBIHAG.PECDhAHA.NCIE....hAAA...,1,-17,-19,2
aGJZXfYAORIVdLcebWPEDNUHgSCBQTFMK,OFBBRGFGdGBHLDAE..bCAAEBAADICEHBFA.CEHB.QCEBhAAAMAAEGEAFJAFEfGFEhABAAFGA.IEHBhACAeEEHWBEFNFCF.SHAGBHHBKACA.hAEA......hAFA...,2,-24,-2,22
KgOUQECIGSaLJHYZDTXVfRbWePBNMcFdA,OCCHUFCACCDA.GAEGLBFBHCGH.DBCE..XACBVGAARGFAeBABhAAABAAF..MDIHhAFA.dAHCADADKEDH..hABAgGFFEAGE.SEBC.hACAaBBB.....hADA...,1,-7,-29,22
SeBKMUIZcVNYHgGJCbAfEaOXPFTQDWdRL,EAFBaGDD...OBBEFDACDDFHRGFELEEEBAHB.UEAHZEBE..VGFGhAAAHGAA..JAGFAIFAfCAEhAAA.hABA.PBBE........hACA.WCHHdGDAKABCMFAFhADANCIC...,1,-6,-41,35
MgJaUOGTdLQYbSfXPFcEHWCVRZNAeBIDK,eAFBBAEDKEFDMFIF..JFDHaCHB..GCBBLFDH.bCCGSAABhACA..hADAfAGBXGGGFAGBhAFAEEEECCAARCGFAECDIHGBDAIF.OEBB.hBAAdABB.....hBCA...,1,-4,-34,30
GKJBZAdCEaHIMXVFNcDOPUWbfQTYLSegR,dEHACEFAHFDHMDECFHBEDAAD..UCCA....bDCHTBFCLAFGhABAeHFEGGEHKAGCBACGhAAAAHCDEDBF..aFBBXEFChACA.NCBF.cDAB..WDAFhADAfBAA..hABA...,1,-10,-33,23
GRJFYabQMHTCcfLSAIDZOBWXdVEUPgeNK,ZFDGOAFBBBHCdBDEEAACUEFB..eEFEGGAHFDAB...aBBBMBCAhAAAHDACCHHA..LCDChADA.AAGCDIAEXAGFhAAA..gFAANIDB...hABA......hACA...,2,-28,-26,2
BRHSXQJeYVDUMWKPgcLGANIdCaFTZObfE,dHBHCEFAFAGEZFGH.OBDH..EGGDRAFGHFEBSCCB.QFADhAAAJBBHeEAGDDGGMBCChABAKADC....cGDEhACAAEGCaAAG...fCEEBFDA.XDAEhADA.YDHFhAEA.,1,-19,-43,24
YNBVWefCEUMTJKFAaLGQdSDbHOZgIPRXc,aHAELDACGCBGdGEFDGFCHCGH.OFABZAEA..IHHEhAAAXFBB...YCEHhAAANDDFBFHEeEECCACDEFHFMIBChABAKFABABAESAHB....hABA......hACA...,2,-26,-9,17
IfeBHQALXKPTGFUbgNESJaRDdcMOZCVWY,XAADTGBC.GAFCFCDDUGEB..bFAEEEAB...SBAAhAAARADHdHEFOBHDCAGC.hABA.VCFFIEEFhAAABHHHAEBEPHAE.gDBHNBICDFCA.cGGFhACA....hADA...,1,-13,-21,8
WcKfLRXZBCTJOeMgGAabIEPUFHdYDQNVS,aHBGEHBGUDFBHCCCDFHF..QCCB.SGGEhAAAWFCAKACGRBGBBAGC.TDAFhABAODFFMIFEAIHA.IACAhAEAdEAGNICF.fFCBLAAFCBBD..hACA......hAEA...,2,-20,-17,3
FYAHaIdBKLEGRWNUCTZMbXgVPSJecODfQ,HDAGaAFBBEGEKFDBECGGGFDH..RFFCUGAHZBAFMCIH..bDFGVCDBhAAA...JHACOBAChAAADBGB.FADCADAH..hABA..IHHE.....dACHhABA......hADA...,1,-20,-22,2
PcJQWXZLVURODaMAKCfYIFTEgNSdBHeGb,CFED..IFEDFCFH.EBCESAAC.BDACHDABeCCFhADAPHFE.QBADhAAAXAFALFHFhAEAUCGDOFCFaGCHMBBCfHAF.TAEGhABAdFFA.....hAFA...,2,-33,-5,28
aPcZfYOCeJILNWHRBUQSXKGEAgdTDVMFb,TGBCDIBGMGFG..aFFDZCEG...OAAFCDACeABBLBHBhAAAHBFCRDBCBAFASAEDhACAKGDCAIFC.dDCEFDFC..cGCAhADA...YHFEIHHE..hAAA......hACA...,2,-24,-22,2
XaDfITJHUFNEeGZdCWKQMSAOBbcPLgYVR,OAFBBFDG....PCECLDGF.VDDBaCBCDAAC..hADAfAACTAGGJBBAhAEAFAHB.eDBDdFFGCGAEQGCDhAAAMEHF.AFIBcBCB...hAFA......hAGA...,1,-15,-39,24
WZcSYXEFNDRUVegIJaALHbdKCQBOfTPGM,LFBBHDAGdFHECGBBBDAH.OFGBTFFHGBBFMFED.ZDFASBFBhAAAEAAE..DIDEhACAUBBFVAFEIAHFhABAAGDCKEDA.fGAE.....hADA......hAEA...,2,-22,-14,8
DGAFKTMcgdRXPUSEJICYBbWNVeaQZfHLO,KFAAMFFFdHADRCFC.UFGA..SFCC.JAEBCCAHBCCC.hAAA.NADG.VAEF..hAAAQBAGZDDELBHFhABADEADFHGA.gGCHEACA.IHAAhABA....hACA...,2,-36,-33,3
aQgeLYVFPfIBHJTNCGAUMXESRKcbWdZOD,MGECEFHBRACG.KDAF......bFADdGCGDAGHQBFELDDBFCHHhAAAIBBBBCACTGEChABACGAAAEDF..XBDFhAAASCCFZGFEOEFGaDFB....hABA......hACA...,2,-33,-15,18
XOEWfJRVTCgQFGbANHaLZDKIBcUedYMSP,HDAGaDBDZFBEDGDH.KEGGBAFCUAFDdFHC...SAHBOBAGEGADhAAA..JDDARFEBCBDAFFFF.hABAAIDG..LHCChAAAeDFC.MEABXGGBVABE......hACA......hADA...,2,-22,-20,2
QGUdTgOKWRZcSMXFDCVJEeYLNfIBPbaHA,GABHUFCAdAABOGEAKCGE.ZECF..MIFEFCADDFAE..JDECEDDGhAAALGFA..hADANBGEBBHEaCDG.AFHGQGAFhABA..WADA.RFAFSEAChAEACHEA...hACA...,1,-26,-32,6
NBdKEgATIZFXaVceWPfCObGSHQDYJMRUL,ZEFHXFCEaBED..eABD..PFABCHAHGDCGHBCE.DBAGMACGhAAALDECdCHEEFHBAIFGTGGHhAAAFAGC...hAIA.WDBDfCAASGDHYBFChABA......hACA...,1,-11,-23,12
caOCMZEQdNYDALXePTFVJSfKUGgRHIbBW,LFCAXDAC.eBADFCHF...SBGEKGEDGEDFHCDEBACGhAAAaDHFCCFEZBBGEHAAdHFDDFIFAAIFhABAPBBA..VGAAhADA...........hAAA......hABA...,1,-17,-26,9
UIYcMRGJTWadPFgQCDHeONbVELSAKXfZB,XGBCBFDDUBDH....ICAHMDHFJEFHaFHF..dDABFFDAhAAA.CCCCDICEOHCAVCFEhABAEAFE..AGGFKAED.hAAAZDBEREAF....WAHBgAGE.hABA......hACA...,1,-16,-41,25
OENSMfeLIAYbBKgXGFCTJPcWRDHdUQVaZ,BFDGXGBCCEHB...JHFA..PHCERAFEdCCC.UEAF..aBEChAAAOCDCEDGH.MFHFhAAAeBACLACGAICAKDAFFEEDhABATBGDDEID.HBAD.QEEEhABA......hADA...,2,-22,-20,2
GYXAOfKSHbgQWNcJIPZTLEVBReUdCDaFM,KDCDSCFCHFDGQAEG..NFEFJHBGIGAB.TBAGhAAALBBA.EABGhAAABHHFRDACdGEEDEIDaDGEMIAEhABAXFACfCHA.WADD.cDFChACA....hAGA...,2,-26,-21,5
fHYWMdVPceaOSUDTBZEFIGQCNAgXRKLbJ,REFHLCCH.JEFDfDECHBFE.MDBBdDHEVCAF.eHAChAAAOGBE.DACABACGhABAEAAFIECAhAAACHHHAAFC.XAGAbFBA.PBCE.cCGFhAFA.....hADA...,2,-20,-18,2
DCGcTABfdFWJaVgRYNQOEXeZKPSHbLMIU,dEGDJCCH.aHCARGDG...QAFEEBDC.eABCKEFHHDABLFAAhAAAMIBAUCCFDAHHCEECTFEFhABA.AGHCBBDCFAAH.hABA....WCFGYBHB...hAFA......hAIA...,1,-18,-32,14
VRPDgdICYUMbGJSfBNTQWLaKOZEXAeHFc,eDCHHDAGVFFADBBFdGDB..CHAA.UACBGDDA.JAABBGGE.TAFChAAA..LAFEhAAAKDAFOHCEXGCDhACAAEFD....RCEEPFADgBGGMAIFhABAfBDA.hADA...,2,-26,-11,15
PIUOJbFEXRVfHKDCWNMAYBGgTcadeQLZS,BECDTAGHdBGF.QGEHSFFEUBADOAAC..JBDDEGHHhAAA.XCCERGAEHEECCEAChAAAMFBD.AFADgGEEhACA.aDGE.ZAEF.IGCAhADA......hAGA...,2,-33,-13,20
YTDLHEGCRXSVAWbNQUFMZPfgBOIKdaecJ,...NCCA.QFCA.MCFFPHFEfGGAODDFKAEHhAAAeAAD.JBGHDBHDECCDCACHSGBDhABAAHID.hABAUDGFFGAHBADGaFED.TEAGLCAF.hACA......hAEA...,1,-21,-22,1
MEDPVBcLHXIQFfYgaZSbKdJWCONRUGTeA,DCHHBFDDHEBFQAACFGEF...fBFHaAABSCDHhACAKFAEdHCHJADC..CGHHODHHhACAUGGEeBBHACDBPDEDhADALHAA.IDFF....hAGA......hAHA...,1,-22,-30,8
OXRIdGZHgaYKSNWDBbFLEJCMfVQeAUcTP,UCGCTCBCOAAC..XGDBRCCAGGDHHAEE.aGGGKHBGSDFHhAAADFCABCAAFAFChAAALBAC.EEAFCHACMFFEhACAfCGB.QGADAIHG.hADA.cEAG..hAEA...,2,-31,2,33
WbdHGMYcDeQSAFULTIZBKaNOCXRJfgVPE,FGDDUDCHLDGDZBCABEACKAAE..OFEDCHFB..RACB..JEAAVCGHhAAA..EBGEdGGG.hAEAMBDGDIAG..eGAAhAFAAICEaAGA.....NABF......hAGA......hAHA...,2,-38,-31,7
feSDAYQPKICWJVZdMENgBbROTFHXLGaUc,QCBCKHBGCCDA.JFACdFGB.EEBHBEEE.OGFEFBADLEEBhAAAUEGH.eAFEDBDAAIDE.hABA.IHHEZAGFMAAChAEA..NEAE....gCGG.hAFA......hAIA...,2,-37,-26,11
ODHgcCNIUaBFbPGERdLWVAeSXMfQYKZJT,SAADMFFF.QGAEKHCGJCFHDECFHDFE.CHFD.UGGGBHDChABAFBAFGBDB.dEBDhACALBHBADAGfGHEhADATCCCcEEC.IAGHaEAHEADA..hAEA......hAFA...,1,-10,-35,25
fcDZUYJVCKRGdMXgaPTFLHWAObQNESBeI,ODACQCBC.SGBDBEGBeAGF..IABEfBCGhAAAZEFCUADFJFFBKEEDdAGHhAAAMIBE...XFBFhABAaHDA.........hAEA......hAHA...,2,-32,-29,3
RLcOXgYNQTKWMeVEPDfaSGJCIUbAFZHdB,ZBCFBCAHRBEELFDBOCHF....XAAENEBE.KGDGMDHHhAAAeDCCEFFB..DFGBaCAGhABASFAF.hACAGAEFCHHAIAGFAHIBdEFBcFCB..hAAA......hABA...,1,-25,-32,7
KJOBASVFULCTHPaMGRIfegWEDcbdXNYQZ,SEHBUCCBLEFCCBFG.HEAH.MGFARCDGeHAE.EHGADABAdCCGhAAAXGBDQAGEhABA.KABGBFDHFEACaGFGhADAIAEH.fAHCWGAE.bAACNEEE.hAEA......hAFA...,1,-11,-22,11
DIUaSVOYQNBbPLdJgfMeTRXZHAcCFGWKE,FEGDKGAHEECADBDE..UDDH..SBDE.OAGFQAAChACABCAELGDEhAAAdDAEfHDBMEFG.eHAEhADA.RAGF..........hABA.XDACAAEACHHEWDCDhAGA...,2,-36,-35,1
HeSKIXGPTcNbMAZfaYLCDWgdJRQVEBUOF,ZDAGaHBGLABCCFHG.DDDBdCGH.JEEEQCEDBHCH.UGGDhAAAHAACeCBCKAGE.IAFChAHA..GADEhAAATEGENGBB.AEFBfBGF...hABA......hADA...,2,-38,-14,24
TWSDQEYFbeVAXLBfaGgRMdJUPKZIcNCHO,LGFAaEGDGFBFMCCFUDCBZBAB....IHBHCHCGHBFCOFADhAAASBAFDFEAEADHhABAFAGHeBCEAFDBBGDA..hACA.fAFF......hADA......hAFA...,1,-22,-29,7
ZQRBDcJASOFbTUPeGIYgWVXLHNadCEMfK,SEEDFDCDUGEGGCGA..IFAB..gAAFhAAAVGBELCDAaDADEAEFhADAMAADZGAABEFDDHFAAIFGODFEhABA.PDAC.eBBC.WAHBhACA.....hAEA...,1,-12,-27,15
NKDEgPGLAZYcUVQaTRHMfdIeFJCWBSObX,ZAADUCBCQECGRBFHHFEC.MCCG.dEAEIHDHFHEC.CAABBGAChACAOCFF..XADAhADAKFGGEAFE..PACChAAAAIAC...cDDAaCHDfDDBhAEA.WFHBSBHHhAHA.DIAE,1,-8,-38,30
KePQLVfIcJEOBSgdWHZYUaGNXRMCbTFDA,eCCHQDACLAHB..IGCDEFDHOHFGBAHEdGADHFEChAAAUACFNABF.MBAH.TBFAhAAAAGAGKBBH...fEHAhABAcCFDgAEAYDFF.XDDBhBAACFABDBBF....hBBA...,1,2,-30,32
CbXaQUIKYZNRVFEcHJATdLWPeDOSfBgMG,TGGDLCCH.eGDGSCBDBGCDMFADGCDE.CCCGaDGFUCEHhAAA.KEFDZGCGRADEFBHDHABGhAAAAHIB.dGAC.DIEE.fAFBhABAXBAB........hACA......hAEA...,1,-9,-26,17
SJfbFAYKPEOMDLUdcIXTGVHgNZBeWCaQR,KHBGOCCHDABALFFAdBFD..IGADGBBHHEBGZBADBFDHhAAACHDBQAGBSGFBhABAJHFAFADH.ADDEEDHDMEEAhAAA.XFAC.......hACA......hAEA...,1,-12,-36,24
LdYNHSGRAeUfCcEaTJKVgXDPFbBMIWQOZ,eDACCHHG.EAFDaGDCKEBG....XAEDDAGGFBAGBHCBMDEBQCGDhAAAOEEG.LDAHhABAdHGB.NICFHBBHhACASBHBAAEBUFGF.......hAAA......hABA...,2,-44,-5,39
KGVLgfHSUPXTIDdJWAMQceZCREBaFbNYO,QFDBeFBBZACBEDECFGFD.....bADENIEH..KGFAGCAAhAAALBHBfABGhACA.UCDA.PAHFhADAIBEF.dABAAIHGMFAHcEGC.CHADBAGFhAAAODHB....hAEA...,1,-7,-22,15
HISOcLMCWKFGEYgadXDRQUAVTeBPfJbNZ,TBDGeAFBBCED..JFFBZGFEHCAHSBBFLHBAMAADCHHHKFBBhAAAGCGG.gEBChABAdDHEDEFGQAFFhABAAEEF.fABFNHABIFFAcFDGhAEAEAGG......hAGA...,2,-14,-12,2
SbRGOEPFDLeJcYTagVZCXMfNQHKdUIAWB,SEGDREBHOADH.FCECDEEALHFE.eACHJAFF..TGGGhAAAaAGEZGAG..CCAC.fABAhAAAQFDAKEAChABAdBHEAAGGBDDDEABB.YFED.XCGFhAEAMIAC....hAFA...,1,-18,-27,9
YdQaLgPWCcAEOSXNDGReZbVUIHTBfJMKF,EEEDSAADDADG.eDDAZDBBUBFHHDAFBAEB.MBBCKACDdGHEhAAAQGGH.aAGFhABAPBAFCCEFOGCAGGBBhABAbEFA...IEGFfCHA..hACA......hADA...,2,-30,-9,21
GIMLHBdbcEgPOVJYQNSDeFRZfAWaXTCKU,XGBCTGAF.KGGBGDDH.MAEDLFEBdBBDEAFCOECGhAAAVGDA.QCGBhABA.NAEHDACFRBFAAACB.aCDGIHHHhAAABDAA.cDAF.....hADA......hBAA...,2,-28,-5,23
PEgfTYAQCScVIdBHeGOJFNUZMKbRaWDXL,QGAFSEGD...IFGGBFHEGFAHJAEG.FDEBUCAGhAAAZBECKACERDDDDDFG..PABBhAAAEBGC..fHEFhABAAIDACHHEdAFFOFFHMDIFaADH...LFCBhACA...hAIA...,1,-5,-26,21
UWfSVgbYBCAdXQePIcaNEJFLTHRGODZKM,dEHAXDCHeCDG....IBGEaAAFEFGCLGBCHEEAREBF.OBFGhACADBBAMIBCUADEfCADhAAASGEH.hABA............hACA......hADA...,2,-26,-25,1
GBRFLXTSCUDfcNVdHbaAJKgYIPeOEMZQW,KDCD..IHHGeBFHEFGEQCAABBCBFFAH.LHBE.hAAAXFFCSAEChABADABENDDDVEDFdAFGaECDAHDDJCHFhACA..PEAB.ZAAA.WEFE..hAEA......hAHA...,2,-31,-12,19
TbGDQXMafKeEBdFZHUSNYRIPgWAcVLCJO,VFDFLEGH.CFBB.ODFGGCDA.DCBBXGAD.aDBFeAFChAAA.EBGFFADHZACBSAADhABANCIC.IAHChACA.........hABA.PFABAFFATGGEhAEAMFDBBFAF.,2,-21,-20,1
TScUeOQBVARWGCfbIFEDKdZNPgHJYLXaM,REBHGGDHCHEF...ICFHDDAGdDHCZAEA..NCHE.HFFELFBGhAAAaABH.SDBAhABA.eADAOHAChAAABHBGAEEBfDEBEAHB...gACDhAFA...hACA.XBBC.,2,-27,-12,15
bAWfQBKUHERYJXgGLIDFeNSaCTMVdPOcZ,QCBCBFCFHAFARFFDJFACGCAF.LHAAIHDEDAEHFBDAeDEFhAAA..aFHBCBABTDGChABAMAIBdFFG.ODFEhAAA...........hACA......hADA...,2,-29,-18,11
ZFaRQVJYBHGTgWUNMfKIAEOPCbLcSdDeX,OCCHCFDGLAFCdAGBDBDEZBCA..RFFD...QGEDJAAF.BCGEhAAAHDBDGEAE.hABATEDDgBGEhACAUDGFMABCIEHGAIHE.EEAB.....hAFA......hBAA...,2,-24,-20,4
cGXIgWCNUEMKeLFTbHJBOdAYPRZDSaQVf,RAADDGDEQGDD..fDACGEDBIHAFCDHFUGAEMCEGhAAAKCHFFGGG.HADHOACBhABAAFCDZDAE.SBGFhAAAcFFA..gDCC.NEIE..hACA......hADA...,1,-6,-33,27
OdNQcbMRJXWLTKafEAUPGFVYICDSgHeZB,UFGHFGAH..VBEDCECDDCIFHEBG.BAFBdBCD..QGDGhAAAMHFGRBBD..JCHFLDDAhABAKAAE.aEADADAH...hADAPAEAIFFF.......hACA......hADA.SCGB.,2,-28,-26,2
LWXJdUIeRYVNEZBACPafKDFTOGScMgQbH,aEGDKHFGFEAAGFBF..MCDGQAEFLDHHJBBAUEDH.RAAC.hAAA..NDICBFAFCHCCDAGA.hABAOHDC.gDEEhAAA.WDAAIBHG..YAHDhABAEEGFAHHEfADBhAFA.,1,-12,-41,29
MOQTLPZSHgbVIfUYRBWdeFNAJKcDEXaCG,KDCDDGHHEACGCEHC..GFCBQBFGLAFDZECFHEEE.VAAFhAAAIBHD.UABDhAAABHACdGHCNAEDAIFE..JEABhACAaDCAMIACOHBC.......hAEA......hAHA...,2,-28,-7,21
KDeVYAEXWJdgCQbSLBGOZMINHFRTacUfP,XGBCdDCDCGFB..SGEDGBBGZGFG.MAAFHFAFRDFFaEDHfBBBhAAA.DGDFYAEGhABAAACA.EEAFJFHHhABA.QAFH.BADH.NAIETDFEhAFA....hAHA...,1,-13,-25,12
YORKTEMQgcSJNAIPdGWZfHBUCLVFDXeba,dHBHGEDHZDCFHAACCHHEFBGF.eFHF..aABGOFED.KAGGMICAhAAAQEAGSCBFhAEAACHA...IGDDhAFAfCECBHAA........hAGA......hAHA...,1,-20,-40,20
OBaDbeGAKdCJcPMRILXSZWEfHgVFUYNTQ,KEHBJCAF.MHCCLFGFZCDG...EHBEHECCFCGF.UAAC.TGGEhADABAFCDDCA.eABChAAAACIBCGAD.RECG...IBEDhAEAXCED.fBCF...hAFA......hAGA...,2,-33,-29,4
eIHBQXPGDZNTfRbaJCOdFWALgVKYEUSMc,LFBBVDAG.EFDAMFFE..eAEHBACHXCBFGADEDGCEhAAAZAFBTGEDRGEA.bBGDhAAACHCAOAHF.dGAGhABAAADAKABASDFGcGGE.IAFA.hABA......hAIA...,1,-10,-18,8
HeOaVBYXfSbWcAMDGQLRPNJdCTEZgUKIF,DFCBGDDCRCAC.JEAGdGGD..EAEFZAFG.UABFKGBBHAAE.eAHDhAAAaDFCBHAC...hACA.YDGDSDHBhAAAWDACMEEB..LHFCCHFD..hADA......hAEA...,2,-40,-15,25
AVSKWQgYefGUJTbBZMRCaPFNOHEIcDdLX,VFEESAFB.KCHFQDAC.eBBGGFEDUGBHbBDBhAAAMCFECHFG.FDDCHDAEhABAEAEADDFCXFCB.hAAAACDD.YEHHfAHGBAHBaACG.NIAF..hABA......hACA...,2,-16,-6,10
IHcSPZbCFEgQLMdKeaNXDUBfOTRJAGWVY,GEDHVAAD.HGBG.SEAHZCEAFBHFQFEDdBBAeCEANCIEUFAFhAAABECC..TAEChACAAAFCIAHF..hAAAcDCACHHHEADB.MIFEaGGB.DIAA...fFHAhADA..hAEA...,1,-1,-24,23
RXdgOeSaTIKAGZHDFBfWMCNbEcUQYVLPJ,ZDAHDGDEFCGCBGGF.MCDDCBHE....EDFDUAEH.QCEHhAAALACDJDBHdABGeBHHhADA..SADHhAAAaHAE.IEDFAFHGfFEENEIG..cGAChABA...PHEEhAFA.,1,-24,-49,25
CIWYSPKMOcGDAHabeNLQVTfFBRdJEZXUg,HDAGeCCHLDGDQEFC.VBCATGADFBGEdGDGJBFGZABG..hAAAXGABCCAG.IAAChACAWFDD.SGHHhADAKEEFMFIH.OHEADCIBAEHF.....hABA......hACA...,1,-1,-23,22
UGgFRVaJfdSCXABNDMeWYPIETOKbLQHZc,BAEDMCHF.eABF..PEFHTFEDOBAGKGBELCCB.hAAAZAFBUGAD.FEDHaCEHhAAAJCDASHGEhABACGHCAEIBDACE.IDHDEAFA.......hABA......hAFA...,1,-21,-33,12
ITHfPWNSaeZKgdLCVMDEXcUAGJFbBOQYR,JCDGBFED.OHBARFFFHACE....PBDESGAE.aAHFhAAAKAAHLEAECDDDDDGFEGHFhAAAXEEB.AHDA.hABAFAHH.QEAGICAFWBHDNACC..hACA......hAEA...,1,-25,-35,10
HBDTOQdVXWAcLUaPRCYbEeFKGNZMISfgJ,LDACaGFC.CAAC.EAGDKGAAZDDD..SCFCJFAGDEAE.QGDAhACA.dFHAVAAFhAAAAEFH.PDHB.hADA............hAEA.YBBEFADAMIDAhACAIAFFfHAF,2,-39,-27,12
VINfRZTDCSecKHGgdbUPYEBLWQXFMaJOA,VAAD..NHBFZBBCCEAH...SHEAeCEEKAHDHGAEdDFFUAGAhAAAEEEALHFAQFGAhABAMADHaADC.AGHFIEHDhAAAfDDE.DCAD.......hACA......hAEA...,2,-21,-19,2
SXBFDYAdENaZLIGPUfgWKeVCRJOMcQTbH,dAFBEAFBZDDCLEDHGEAFUDGH..fHGBKHGACGCC.RFDAMDHBhAAAQDAC..hAAATCAE.HABChABABCCHDEIDAGGEIABGWHAG.eHDA..hADA......hAEA...,2,-37,3,40
UVZgHMDQPXdfYSbTcGAIFJOWeaECLBRNK,JCCHOEEG..aADBCFAGLCHB.BEBFNCFG.KBCDZCGDHGFGhAAAMEBBDABC..XBAFhAAAdFCFSGDDhAEA..bGEGTAEFAIFCFGCDEAFC....hABA......hACA...,2,-31,-25,6
KOBPMLbcRYEGVaTASXCUdgHfDZIeQNFWJ,SFFBUABHdGBDHGFEDFEHZABG..IAGGQCGE.FDCAhAAAKEGGOFAHBAEELCFChAAARDABEFHB.aEEDAABE.hADACHDH.fFCA.NIDD.JEBEMCCEcCADhACA.....hAFA...,1,-16,-23,7
ZgOQTeGAaFYSDCMWILbXVcRPUBKdJNfEH,aAFBFAFBDCGH..CGFC.MDBGLEHF..XGFHVBCFREAEBFEFhAAAdBAF..JHCEEHDGZEBAhAAA...OBHDhABAeBGFABAHSADF......hACA......hAHA.WFFEIHAA,2,-29,-29,0
HRWJMdOeYcafGSEbUNVBLDPTCQAZKgXIF,ZDAGXGBCHGBEJBFHdDCF...eFFEaCFGGDFCEABD.UABEBFEDhAAADGADCHHGACACKECG.FAEBMIDAhACA..OHDEhAAAfAHANCIA.PADD.....hAGA......hAHA...,1,-18,-19,1
QRHLFcfOMVgXNYIdJGZbAWeDCBKPaETSU,eFCHBAAHaDCDEAFEUGEGHAFELHDA.FADGOAAH.gEAGhABAXEGBICBHhAAAGDEFAHIFCHAGTCEGhACARCCAMBBE..........hACA......hADA...,1,-14,-22,8
KEJHWGbfDCZIBXcYOaPMNTQVUdgRLSeAF,EDABJFBBGADGDAFG.ZEFDBCGG...XFDCOCABMFIHhAAAQACBdABGLAHDhADAABGAKEECHGFA..WDFFhAFAfCCG.ICEEaGCD.NCIA.hAAA......hABA...,2,-35,-18,17
eTYbGIMUJBKQPWSNgaXALcFHdVOfRDECZ,FDCDdDAFOBHFRAEE.DGEGEFEF.ZGAE..TFBAGBAB..MFIHhAAABGHHKDDBQCGEhAAASACHaGGBAHFBHBEDhABAfDAEeHBAIAGF...hABA......hACA...,2,-25,-18,7
DIANFfeBLZCTRMYSQKcGJOXVgWEaUPHbd,FHBGeAFBBABHZBBHREGB..MAFCQGEHGGEB.OCAH..hAAAVDFCEBDEUDDEHDCBDIDEhAAAABHBLAHBTBEFSEADhABAKGAC.cBCB...hABA......hACA...,2,-12,-10,2
VWDQaAXHMeYENIUcSTLbBfdPRCFGKOZgJ,XFCAeAABEHEAUBGA..SDFDLEACBEEGdAFEPFHDhAAACACDKFGEZCCC..JCCDhABADIGEAIDA.MIAGIACChAEA.bBGDFGCAOHAAgFAF..hABA......hADA...,1,-15,-20,5
XHfgBaILGSUbAZOcPMVWTJNCDeFdYQRKE,ZFDFOGEAMAIH..TCECCCDB..FHGAQCBCKFABHAACBCGHhAAAIADCGDDFSBAFhAAAAAFB.PFBAhABAJFCF.DAGBeDAAYAHHEFGE...fFAGhACAaHAC.LFHBhAFA,2,-21,-8,13
KTFLSBANbIDEGUJeHVQfWMCdPZgcYaXOR,..IFDGDEFAGABEUAFAJADE.HGFEQDEAMDDD.dACHZBEEhAAA....YEHHhAAAOHAEKDADLDAEhABAAIEAbEEC.EHBC.fHDFCDHB.cGGHhADA.....hABA...,1,-14,-20,6
cGOXEBQLdaVHZKTfAPJDNWbUYCSRFgIMe,JFCHDACB......NDFA.UDEA.SEHFFGAGMAEGeDBChAAAGABD..EDGALFABhAAAdGGH.VCAEKGDDAFBChABA..PAHBbAFACBDA.IHHG.cGEFhABA....hACA...,2,-31,-28,3
HBGeRAgTUIcbPJZNWXaMdLKCDfYFOESQV,TCGCUCBC....IDHC..PDBAZFFH.WFFHhAAAaGDCMIBC.LAAFhACAKADGCBCDDEFFFAFGOAFGhABA.EFDDQDDCBCACeHBEAGEC...hADA......hAEA...,1,-25,-30,5
fMRIVPdFcLeDXgbGAJCUHaKYSOTWZBEQN,CFFEaDAFKHEA....SGEFOAFCZCDBEECD..QEADhAAAMFHDRBCF..IAEGhAAAPCHF.FHBELHAEhABAXBGDbBBFAHAG.........hABA......hACA...,1,-24,-31,7
NFYGSJCEVWDHQgBLfZPXAOTdKcURIaMbe,TAADdAFBUEDE.RAAC.MFAF..eEHBFADCSFCGCCGA.hAAAEBFCDICA.HDADBCCAhAAAfGFFXDFCAFHBhACAKCCAIEDC.NDIAGGDF..hAFA......hAGA...,1,-18,-31,13
SNUOFJARdZBecKXgYCTDfWVHabQLMIPEG,dDAFZFEEBGCHeFHHKAHD..XBEECGCE.DDFDVDFAHDAC.aFABhAAA...LABEhAFAIBFFEBHBSABDhAAANIBH.FFABADDG.RDDBgACEfGHC.hAGA......hAHA...,2,-23,-23,0
bODFCJIWVPdSeELgYTBAcUGKaRZMXNHQf,UFGHaDAFZGAGMAID.HEAFQEDB.OCDAFCBAIHCDhAAAVAAE.SCEEhABALFHFTCGEBEDDAGEAKAEChACANAEFDGFH..WHEG......hADA......hAHA...,2,-29,-10,19
IMZJdTFgYfUKEcQCeBbWSNGRaOPVDLHAX,MFFFZDEDdDCGFDCC....fGCDKFCFQADFCBHE.BHGEhAAASAFCRAFH.ODAFhAAADFEDAIDAJEAB..hABATGFB.gABFECAAeBHF.NDIE..hACA......hAEA...,2,-30,-27,3
cICNEQDBbKdHZGLFRSXgeVPaTWMOfUYAJ,JGEACFDG..EACGDBDGKFBFHDCH.ZAAFFBAE.RBEB...SBGAhACAeHFE.aHAEMEAHOEABhADAUDCF.ADIF.NIEHBHDChAEAdFFF...........hAAA......hABA...,1,-28,-34,6
QDMOBCfRKJSXYIdgULNaHFeZEGWPcTbAV,VFEEMIAGBEHF.RDCB.JBGD...SFBEIEAGUADFhAAALBCDHAGFFGADZFFEEBAFhAAA.GBDE..hABAPGAC.cBAFAAGF.....hACA......hADA...,2,-27,-22,5
DIGJKgQYNCLWdBceHAUSFfPORbETZaXVM,SFHBFHBGOFFF.EBBFZEGF...aFEBMDFG.DDDHGAEHhAAAKEBH.QCDFhABACADCLEFHBECEHGAAfCAHhACAPEEHTAEDIEAEYAAD.hADA......hAEA...,1,-10,-26,16
TUGQcKWEegfYNVOCbdIDAPLaXFSRBZMJH,aDCDFFHBRAAABGEFZFDD.HADCGEBE..KHEAEEAFeHAA...fDGEhAAANEDB.CBGAdGHGhABADFGDACDBLBBBhACA.MGAAJAHDUAEEWAHB......hAAA......hABA...,1,-10,-27,17
CERDSJKaYQPgTIcNdFAXOBZUbVWfMeGHL,OGFABFFCUCAD..VCAGMBEAHBFALEGBCDGH..DBAGKBAChAAAaFEBQGDHhABA...TEAFhACAIHBCNDED.FFBGADDHXGAEWAAEeAFE..hAEA......hAIA...,2,-31,-21,10
IYLgVCWGSUNbQAMXRDcfZFKJHOTEPeBad,MEIBXFCADAIBZFBBKGGF..HBFA.OAAFEBEGBGFE.dCACLEAChAAACHAF.SHBEhACAUBBEQDEFhAAAcFABJACEeFDHYDCC....hAGA......hAHA...,2,-28,-21,7
DMJBFSCeTdPIXGKHEWbOARaYVZNfQUcLg,RDAGaCFCZBAA..QAAELGFCDICEMADFBADDCEEE..dFBA.IAFGhAAAKFBFEAFFOEEAhAAAAHGG..NIEHUEGEhAEAJAHF.SGCH.eEBEXFDBhABA......hACA...,2,-35,-9,26
HLZUODFGeEdcYQXTPfVAMKCBIWabgSNRJ,CBGEBFDG.aAGESHGE.RCFGLFFDZDBEDFGAGBBDdAEAQCBAhAAAXCACTCGFhAAAVGAE..KBACIHHEhABA.WHAA.....NEFAUFAFhACAeCADcEDGhABA...,2,-23,-14,9
LfKNCYUWABGXDegSMEOdRZaTbJFQIPcHV,GCEHXEGDeBAB.MFEFOAHHZFFC.TCEA..JFADQDBDhAAAIDCH.HGCEhABALAEANIEFCBBBUAEDhACAAICEDAAAEEFFaADH.FFCBcFAD....hADA......hAFA...,2,-12,-5,7
NLZXDeEIcKQORCTMaUgWfGABSdbHYVFPJ,BEFASAFBdFDAHAAFFBCC...JEABZGFEDECCeEFA.EFCF.KHCAhAAAOHBC.TCGBhAAAMAIHaBGD..UAEEhACAWFBFADAD..VFGBPBAF...XEDBhABA...hADA...,2,-29,-13,16
IZOcNWEHYCGfVSLgMabJTFDPXRBUKAdeQ,dGDDeDACZBBDOEFA..NAAF.EBAAHDDHGADC...SGGFhAAAgCGAbGAEJFBDhAFADFAA.RAGF.KBDGAGFB.IGHGhAGA.........hABA......hACA...,2,-26,-19,7
UcgFOREZBCLfGVMbQAYHKIPWeXNJDdaST,HDAGKHBG...IHGHPDEG..eAHDNBGG..DDHDdEADaFDESBAFhAAA.UCBHhABAgABHOFFGEGCGhACABBHHCGAC.fFBGMIEEAGHE.WHAA.hADAXBDH..hAAA...,2,-39,-14,25
UEIGXQBJASRZHgFDaCTMYVLdcNebWKfPO,RBCFZGFGFDHHaFCE..CAHA.MAACLBFB..dAFGeBAFKFFG.ODADhAAAIAHE.QCDChAEABABEAHCBHGFETCBGhBAA..cFDBbDFE.fGAEhADAEHCA......hAEA...,2,-28,-13,15
CdRZbBIXPYWfVeSKcgLFEUJAMaOGDHTQN,OECCDDGBHFBH.QEDBCAACZBBDBHDA..IADE.XAFDhAAAPFHH.fFGHhABASBFFKHDCLGDChACAFCBGEGHFAIAEMCGHaBHFNCAEbAGB...VFABhADA.....hACA...,2,-20,-12,8
CFHRQeYTOEgISLKPNDbAGadXBcWZVfMJU,dDAFBHHGZFDFMEACCAHD.RFDE...QGGCeDFEOBACEGAD..SFCDhAAAKFBDDBDGAEEC.XBEAhABA.VABEhAEAUAGEHDEA.........hAAA......hABA...,1,-6,-43,37
XNcTegWaKBSJPdFUDYAREVMGHCIOfZQbL,EDAFGGCBHDDBODBCQGFGLADGXGBG..cEFAhAAAeEHBaBBEKCFGJBACFAGCDCFEhAAAADDE..RFAFCHHEIABChADA.fEBFNAIE....hAEA......hAFA...,1,-8,-17,9
eZJfcDgCUNQbSLHaIRPBKOWAMFEXGYVTd,EHBGXFGHGCGE...TECCZFBGJCEEDDCCCAFB.UABA.QAEAhAAALCAFIECAhAAA.BCCBKEAHAFIDhAEAMICAFFFD.dABF.fAHE.cEEAhAEA....hAIA...,1,-16,-36,20
WeIgEPfcRSLaGDQXFTNBZCJbHMKYVAOUd,UAADeCCHEEFA....PFACRAACaDABQBFFFEFDBHABZCEACGBAHFDAhAAA.KGHDAHIDdAEHhABA...IDBAhADA...........hABA......hADA...,2,-42,-22,20
UHKNaTWMIAQESXeCdZfbJgRGDBcLFOVPY,EFHBSGDD.eBHFdFBDZDBC.fDHGJEECGBBCDHCABGHEhAAAFAED.VFAF.UAEEhABAKAHBaABH.TFEChAAAMIFEACAF.CFDB.bCDE.......hACA......hADA...,2,-21,-18,3
cDHgCXAZGNUFJMEQfBbVOeTSKdaIPRLWY,ZEBHUAGHMADGQCAFBBHH..OFFFSFFDKDDH.aHCERABFLFHFhAAA..hABAYDDAHBFF.CFAGXABAhAAAAHAH.FFDB.ECHDfBDFhAHAeFBHIHHE.WAEBhABADIDE..,2,-27,-8,19
aOCZJbDTANXIHEdFSWYgPMGLQfcURKBVe,XCBCHDAGdAHCFAAF..SGEE..gADAhACAMGAELDEEQDGChADAUAFEBHHGaFDDCGGC.ZAAEhAAADIGEAAIDIHBEEGAG.WFFE.PEBEhABAfDDB..hAEA...,1,-13,-26,13
ebgKZaBGAEVROJLcUMfPIXDNTFHYQdCWS,VBCFJFFCLFCB..MBAF..IBEENAAF.HBAGhAAAQGAEdDAECHEE.SAFFhAHAeDEFKGBDBCGBhABAGBFEAAHC.OEEF.fHGBhAIA.DIEG.FDHD.WBBFhBEA..,1,-8,-33,25
LJacYOHKDAfSMQNIPdBeERgGTbZFVUXCW,SGFHQFDB....ICHDBHBFeCEDEACGGDCBhAAATCADZAFFFBBBUGGDCFBAJHCG.hAAAaAGEOAHDDEABAFBDMCDEhABAdEGBRABA...bFBH.......hABA......hACA...,2,-19,0,19
JUDLFeWXCRBPSEGAYdKbMVTgQHZIafNcO,dAFBKGFHMGBC..TDFDHBFAZCBB.aADAfFDB.hAAAOFHDJEFADBAFeBAHhAAACAHFBEDB...SBCEhABAABIHVACFIHDENIBF.cCGAhABA......hACA...,2,-32,-27,5
PfSVALYeBQHGbgJRMNWdKFDZXIOECUaTc,LEEGeAFBQAAHHAADGECA.bFABRFEAMAIB.dDABDADGhAAAIFCCOCECCAHBaEADhAAATGEC.cCCBhACASHAA.AEECYHEGBHHANCIE..hACA......hADA...,1,5,-22,27
gUIXLGbCTecEFZNOWHYQfdKAPaRJVBSDM,aCFCRDBGBEFA.DAIBUEED.LADACHHG.eBAGFACHZFAD..hAAANHBFHEAEQGCChABAdHGHAIAC...JAEASAHBhAAA.MDIFIHFEbCAC.EFGA.hABA......hACA...,1,-12,-41,29
MNfCYIKXDgOeTdWcZaHVPEUABGbLRQJFS,BECDLFEFJFHH.FAAF.MCCDCDCB..KAHBDCHF...eADBdEFCZBEChAAAaGAAHAFE.EHGGhACAAADARGDE..SFHBhAEA.NDDA.IFAA.OBAAhABA......hACA...,2,-53,-10,43
dKWDOJIQcHNPTeaEUbMBAGVYgZFfLCSRX,GEDHVAAD.ZABAFDGGCCEA..RAFC.KDAD.DECHJCAB....QEDDhAAAHFAFTGDEaAGE.hACAEDGCUCDFBCCFAHHA..hAAA.fGGFSGCA.XGADhADA.WHFG...hACA...,1,-20,-24,4
HYCEReKAaUXfPZDbIOFSJNdTGMBgWVQcL,aEHBUCGC...XEBAZFCEDAIBOAAC.FAGFJHBA.TCEEhAAAMCCABDDH..hAAAVBAEQGFHhACALFGFCEAERCFHAFFB..fADE.IAFDhABASFADNEAE..hADA...,2,-31,-22,9
DbPIaRGWdQYVKOXCMgFHTfSLAeZcNEBJU,eFBBZAADEEFGBAFE.DCDH..bAGF..IDADGCCBQGCGhAAAKFFE.XGGAhADACBHCFABHHFDBSFBDhAEAAIGA.NBIE.PDFAWFCE.....hAFA......hBAA...,2,-41,-10,31
IXcUOFSYPBGZAgDVbJHfEMNCdaRTLKeWQ,VFDGJFBBHDEH..EBFHMHDG..dDBFRBFELABGKABHeBGHQFAGhAAA.IGHBhABAcDAGOEGDhAAASCHHBECBAIFGgADFfCCDCAGEWHAAhADA.....hACA...,1,-10,-29,19
TDfGNcKdBFPXOSQURVCAYWJeIEZgLMHab,JGEAEDCDZBAALEDFHFCC..aBFADCFE.GEAAKGGAFHAA..OBBEhAAAQCFG..hAAA......hABA............hACA......hADA...,2,-54,-28,26
gcIKEaDGUPZOMQJbFeTXAVNLYSBWHfdCR,VFDFLGEA.BDCEHAABdAEARBFB...IDGBEDEDaFBBDIGAUAGBhAAAZDAE..MCBH.hAAAQABEFADH.hACATEEEAICC.NDIC.SCHBCHAF.KGGAhAEAGEBE...hAFA...,2,-15,-10,5
BJMFKgabXNERGeQfPZOdWDcVSHAYILCUT,LGEATABH.JDDDFBHH.KGCD..aFAH..XBEEEAABGCFChABAeFFAQGBChACAZDDBdEAGDIGASDAEhADAABAFIHAABEAB..MCDD....hAAA......hABA...,1,-18,-26,8
CUDILaOeYPQVFdHNSGBXTMJZgbfKEWRAc,UGGGDEFHLCCCOCDF.eABF..QAABdBGASEDHhAAAGBFCBHGGXFBAhABAJHAAZDAE..fDAHhADAKFBEEDHHAFIF.IHBEPADA.FADE.NAIAMFFFhAGA.....hABA...,1,-4,-23,19
bgeFZfcQCXJLMOBWKdNIVaRTESYGDAPUH,HEFHeGEAZGAAQAABCBBE.LFCFBEEBdFCBIDCCRCAF.hAAASADCDDGEAHHEUADFhABAFBFD.fAHAhABA...........hACA......hAEA...,1,-12,-43,31
BCcNJQYHKdLPVGfZXSEFADOIWUTbeMRag,DEFHOGEAUAAC..eCBCMCDERDDCBFBG..CEDC.JAACQDGBhADAKAGG.dGAALHEAhADAVGFE.ZGAEEEBBAEBA.hAEA....WHCGaCFA.....NDBB.hAEA.HAFC...hAFA...,1,-15,-31,16
ULNZTKXQafgdDCcJGORPWFBYeHAEbMISV,EGFHMCCA..SFEFLEEEZAFHKBCHaGAEdGGBDCBB..CBEFGCAChAAAREBHFACEBHHG.eHCAhAAAADEAVDGF.NADF..hABA..XGCDfAHEcAGE..hABA......hACA...,1,-20,-23,3
QWYJBMIFDRPELgZaGCKTeHUXfVcdSbANO,ODACQCBC.JFACBHFA.MEHDDDECEEFEZACHCCGB..KBHHHFBFhAAAUAEE..fAHGhABAdGGFAHDG.NDIA.IABFhAAARFDG..LBFDaHBC...hADA......hAHA...,1,-16,-35,19
YGNQXEJgAUPTcRFKLeCVObSDdMafWBHIZ,UCGCTCBCFDED.LABACGBE..bBECdECC...aHAAfAAChAAAHFGFZAFE.NHED.XDAFhAAA..gEGHhACAAAGA.cDFB.KDAF.OHAChADADIDABGDA..hACA...,2,-22,-16,6
ceKSNZPCEIaYObDgFRfAGdVJMWLBQTXHU,dCAHMAGDLBFABADG.QDEGHCACeFGBSEBFZFCFCHABEDEG.hAAAaAAE...OECFhAAADAFDFEAHAAGAJFGD.XGDDhABAKBACNAIE.IHBH....hADA......hAEA...,1,-21,-22,1
PcGTCOJVDLZMFRBXUAKNWEegfYabQSIdH,KHBGEHBG.eAFE..fECEaBAG.SDABHBCEGDFGhAAAOACDDGCCMIFEFAGGRFFFXFAChAAAAHHGNEAB.WEEChABA...bAEDIDHA...hACA......hAEA...,2,-21,-19,2
YHeaOMRcFdQGBWXAbPfTJELIZKVNgDCUS,...bDEDfAAD.ECCGLDBDZCGFKGGG.VADDDECFUEEHhACAHAGHeEHDMICERFADFAAGhADAdAEHBDDDAAHE...hADA............hAFA......hBAA...,2,-20,-18,2
BIeJTUHLEfcCGKaRQXWbFPMDOZYgAVSNd,VDAGSAFB.BBBHJEFGHFBCLEEGEAAC.CDFGGEAG.hAAAaAHBXFGE.hAAAFHBCDIEEZBCAADAENCDEIAGBhADA..eFHHfDDBcGDBKAEDhABA......hACA...,1,-14,-25,11
USMbFBTPGZfaDJEYRCKVOWcXQgHLNAdIe,eCCHSBDHMFFHBHBAGEFAZADCDGAG.EDCBCAAG..KCAH..OAEGhAAA.XBBGhABAgCGCNCIE.AGIFdFAEhABA...IFDDFHBEfBFC.hACA.aHGCYFEFhACA...,2,-28,-27,1
ZYfBMSXGTKORdNbeIJLaHFcPVgUCQEDAW,ZAADBFDGSDFBGGEFOAFBREDF.dCDAeACFLDBBFHEE..hAAAVAGHCBBADIDA.AIBA.fGABhAAAMAIB.KECFhAEAIADGaGGA.....cEFAhABA......hACA...,1,-14,-35,21
XeQAIFRJCbSBTcYHGWgMUdfZOPKEVNaLD,FCFCRFEECDGC.BFBC....TBAGHGBEGDBBMADG.dGGCOCDGhAAAKBADEAEA..aHAGDIDAhAAAQDBAACCD.hABAbAFASFHB.YAHHWHFAfABBhAHA..hBAA...,1,-24,-32,8
eCdLIRacPSTFMbJNYOZEUQfXVKABWDgGH,BAEDDACBHFCDdHGBRDEAaBEC....SCBFMDAD..JEECOFCEhAAAZFADUGGHQGAChABAXCDCKHDEADBA.gDBHhACACHEELAHFIAHC...hAAA......hABA...,2,-25,-21,4
MgdAbNROIcGBWKLfDFXUQTVESYCHeaJZP,RAADOGEAGAECBAHALFGBDCCF.UEBAQDGE.EDDGCAHCaCHFhAAA.ZACFMFAE.hAEAAFFC.IHDCKCAHFAACXGADhACASGADeAEDPFFB..dAGChADA.NIEF.....hAFA...,1,-11,-20,9
fHGRQPXWJKIedTcVUZaYCOFAENBMbSLgD,BFEDMHFGLCDFDECHHAACGAEBRCAH.QDFDXEEDKDGAhAAAeGFAdHAB...TAFDhABAcCDB.ZEAFYABGhACACHADAIEA.ECEF.SFAG.hAAA......hABA...,2,-20,-8,12
UYJbcITFWENaLMSDQVHABCegPOdKfRXZG,BEFACAFB.eHDAOEACKGAH.RGFEGDDFUADA...JGCE..IDEChAAAFBBD.EDBBaBHBhAAALAGFDCAH.QBBEhABAAFIBdCEB.XGGF...hABA......hACA...,1,-26,-33,7
gVKLABRNMfDQHECZOGdFPYITUScXJabeW,RDBHMCCAQACHHAGFZAABdCACFAEA....IFHGTEECSGHBhAAAJDFA.bEBDhADAeHCC.gAFChAAA.KEEBADIFBEDFfGGECEGB..hABA......hACA...,2,-25,-13,12
dYRfIZGFBODXgMCAENPcbVHTaKJeQUWSL,EHBG..NDEH...PCAEVADA..HFGDKAGGQEEAhAAAUDABSFEDdHGFRCGBfEBDhABA.IFAGhACAFAAADIBEMEEAAEDEcAEG...aGCAWGAChADA.....hADA...,1,-20,-25,5
GbCUMKgfadYEDJQTBcIVXeHPFSOALNRWZ,LFBBRAADZACCGCFECGFBUBCAKGHD....aGAFEBEA.DAEA..TDCFhAAABABC..IHHHhAAAeAHBFEAC.AHCG..hADA.NAIC.bFDD.MADEfGDA.JEEEhAHA......hBAA...,2,-42,-7,35
BRAOYgPFHdTUMecDKWNQaVLZbSIGEXfJC,OGEA..YFCAFAEDdGBDUDCA..MCIHDABAKHDAQBEEhAAA.aADGVAGFhAAAbFFB..GABEhABAEBBE.JHCGCHHDBEAAAEEH.......hAGA......hAHA...,2,-38,-21,17
fEUTXJAcDLVQSaHKeFIgOPZbYMGCWdNBR,DEFHVAEGQCBC.HGCCKGDAFDGGOADFZDADMAACGBGAdFGDhAEABFAD.EFBGXDDEhAHAABBESGGF.hAIAIHHE........hAAA......hABA...,1,-20,-36,16
OeUEAYMaVdRfTJLWHFPQIgDGcCKBZNXSb,MHFGaEHB.dEEDRFCE...JCEALCAC.FAEFQCBHhAAADECCCHHAZCFE.SFBGhABA.eADGABGC.fHABhACATGAC..WAAEPDHD...hAGA......hAHA...,1,-23,-41,18
OUaYHKRQCIGBfLSFdZPgVNcEXMTAbeWDJ,eGEADEFHUEBDHCAD.RFBHCBGHBBDA.LEHDdDECZAAA...VAAChAAAEDFCMAFA..AIDEJCEEhADAOEAH.aACAQGEBhAEA.IAGF...hABA......hBFA...,1,-17,-36,19
DPdAXRYSOWbVcZNJGCEaFfeHITKQMLBgU,REFHOCCH..VAECZAEAGFEF.aAAHeAHHHFAETCBChAAAMDFGLEFCBDEEUABBhACAdHADAEHCSGDBhAEA..bBDC........hABA......hACA...,2,-26,-8,18
EgSNYMbAJIfWTCXRKVaGeLDdQZPBUOFcH,JGEA..fEGDCBAB.KFFFVCDDeBADLCGFDCIBZBBCBHBDhAAAFEAE.EGHF.SAGEhABAMAIFAIHA.TFBHhACAaGAHdGBFQDDB.OHDCcACEhAAANEAA......hABA...,2,-39,0,39
WdDecUQZaPgSMTCbIOYNBXJRELAHFfGVK,HDAGGEAHKFDGdCADDIFGeFHFUAACZABA...aGEFSAGGhADA.CHDC.IDHChAAA.NIAHBDDHJDDCEGGEAFFCFAGGhACAVFAF...QADE..hAHA......hAIA...,2,-25,-19,6
IHVXGQZBEcADRNLPCgfbKOUYMWFaedTJS,RFDGLGEACCGA...bDFAKACB.OBBBUFADMCBCFCED.eCDAhAAAdGHA...SDBGhABAHGAEXAGE.hACA............hADA......hAEA...,2,-41,-29,12
EcFMDGAgZVJNbIdfXSWOBYLeRCKQHUPaT,ZGFGVFDFJCHB......NBAA.dGAH.SBBDBCGHLBDGhAAACADA.KGGHQCEEhAAAUGAHTDEHFGDFDCCGhABA.ABFE.ICBC..fDDEhACA.....hABA...,1,-34,-37,3
ZGNJKWRCODfFdaIcQBLXMEeHYVAPSbUTg,SHBGUCGCZCDBGEBCKACG..RECAOCADDIDGFBBH...aBGGQFEAhAAABDHC.MFAFhABAeEHHHACEAHADTGEEhAAA..NAEBCHGAICCF....hABA......hACA...,2,-36,-13,23
KEOfPLHAQbcUNCIJXFRGWeBTZVDYgaMSd,QCBCUCBCCHGE.JFACFGEF.GEEBBEEEZDFH.DIGAaGBFdBDFKADBhAAA....fAGAhAAAHCFGAAFG..NBAA.hABAIHEB...WCHF...hACA......hADA...,2,-37,-33,4
HQPeDbSAcYdIWULECMBXKNgOFRJVTaGZf,dHBHUCBCEACBBHGE.KCGHOFAA.FAAFJFEF..aDAGZFBDQFFHhADA.DCHFSAFFhAAAAFIH..hABAICEACHAFMCAH.NAIG.......hAEA......hAFA...,1,-34,-54,20
fQDVAecEgKaJLNTZBdCUbSPWFHGOMXRIY,EDCDKAFBLEBFZEGBBABE.CFEA.UGDA..SCFDFFADHBDHMAADhADARGFA....fBCGhAAADAFAAEFDeCGFaHDChABA.JAHF..........hACA.TECG..hADA...,1,-27,-37,10
gMGTYHOVFRXNEZKcSdaeIfWUDPAQJCLbB,JGFACAFBBCFGGEBBHEFG.FAABRBGB...EDCDZBBC.SEADhAAAdGGDeBDD....IHBFhACAfGBC.DABEhAEAAIEAbDADMIFA..OAHF....hADA......hAEA...,2,-28,-26,2
HUdCBVAREDZfKgGSJFTNPMbOLeaQcXIYW,EGGEZFDGKABEGCAGFBDG...TGDHMIFALAGBaCFH..QDCGhAAA.IABGhADAWEHF.dCGBBBBGhAAAAFAHDCCCSGBD.NEAB.PHAChAEAeBFF.YADG.hAEACAHC...,1,2,-40,42
MdbVcBZWGAPENTgYKeOSHILfXJQDRCaUF,EHBGTCBCKECE...OFFASBDDHGEELFAD.XBEDhAAAJDABDEHFCFBHFGBCdGDDhAAAbABEBAHC.ZFFF.hABAABAC.NEEF.eADG........hABA......hACA...,2,-35,-3,32
HSfDMcKJECaAPNeGBVWTXRQLdZUOYgIbF,eGEAGCCFBDDG..TAGGXDGELFBGUBAA.OHFAhAAA.IBADFCECfGBDhAAADFAFKEHFCFFEAACAPAGDhABA..NIAF.WFECQADD.hAEAYDAA..hABA...,2,-28,-22,6
LJDFKfGYBRATMgVHQZeCPObUdXIWENaSc,MFFFVGFG.HAAFZDAF.eEHB..CGDDOAEBUGCFdDDA...IGAFhAAAEDFG.aCFFSBCHhAAALAFGDADHhACAKHAAfABEBGGEAEBC.TAGC..hACA......hADA...,1,-10,-36,26
SgdZPLQMIFbRUCAXWaKBTYEHNceJGDOfV,aGFCKFFBBCGD..TCACEAAFHCCC.eHAEJDDHDHAG.OAFDhAAASAECZACELDHBhABAIFHH.FFCAUEAFhACACBCD.AFFC.XAFA.YDADhAAANIAF......hACA...,1,-18,-28,10
MBTOeIbAcEGCPHJaKUXRDSNQFfVZWgdYL,GEAHHDBHKDHBUAADRDDFDBHDQFGC.FCDDfFGEhAAAZAGHdADF.MAFBOHECICAAhABAAGBHCGEC....hACA.JEAHSDGGNIAF..WHFA.hABA......hAIA...,2,-21,-19,2
BKeSTAIYNOCRPWQZUELdVMHJbXgaFcfGD,..IFDGNDEH.RGDA.QFBAZAEF.LCAHMECFJBCFXGEEhAAA.aEGFFAGGhAAAGABFBDABSHFAhABAAHHDCAHA.WEEEdEEA......hACA......hADA...,2,-39,-16,23
LObTVfaJEXecUCPYAQdgSWGBIDFZMHRNK,dGFCSHBGGDDHDECBZEFERAFALCDE.ODABVDCDaABDEHGE.hAAA..eHEACHAFACBF.QFADhAAABHDHFABEMBFEhABA...NCIE.TBDG.fDAFhABA....hADA...,1,-18,-19,1
FIRbAJVaYGeUdCPEDWMHTXQKBLZfScNgO,JDCHVDAGGEEA..dBGGCAAF.DFIFHBFCQFCDKGBBBAFALEFHhAAAZADB..SBBChACANBBH.FHGAIGAChABAACCA..aDAFeCCGEEHB.MAID.hADA......hAHA...,2,-21,-20,1
GVPQCUHKgDReIdMTZLWaYSfEFJBNAbXcO,XCBCGECFQAABHEBCDDAH.RGAGeGEAMGFALAHH.hABAaHCAYCGH.hAAASCCDEABGBEGDABGDhADAOAECCHHGKCEGIGAAdDAA....hAEA......hAFA...,2,-19,-5,14
BcWPXUgfTZIVNHEOKbdGFCRYDMJLSaQAe,eAFBBFDG....PCBCgEAB.ZGFEVCFCHABDOFFBhAAAdBHGCEFFDBAFLADAhABAaFDBAEDE.XEAF.hAAAfHGBNIAHKEHD.FAHF.MEIFQBDDhABA....hADA...,1,-9,-17,8
CFOGLIcAHYVWXZSbNQDEPfaBdeJUMTgRK,HGFGVAAD.ZFAE.SHBAQAFBEEFGaGAABCDE..dDGFUBAEhAAAMEEBRCFEKEEFFHFAOEAChAAALAEAAADCXCDEhACADEID...fFFD..hAGA......hAIA...,1,-14,-21,7
TRFSfDOcWIBYCPaGMHVeJXZNdgKbUQEAL,TAEGRFEEFCCF..DABEOAAC...IGEBBBFGCEHHGEAChAAAMDADHDEA.JAHHXCEChAEAZCCHdGCEgGGAhAAAKAHB.........hAFA......hAGA...,1,-6,-50,44
bQLeMTYVGXDOWBCAZKRNcadUgPEJfHISF,KDAFRAAD..aGAAdDFAUGDFEEDCHAGH.FCCGQDDFLEHDMAAGhAEAVAFA...XGCDhAFA..WACChAAAAFCBNBBF...gGGCfGACIEGHhAIA.SEBGhBDA..,2,-24,-18,6
fBIbDPFSJdLTNeGZUaVQHOcXERKgMYACW,CFDGBFDGDGHF.SADBLCBA...eBHDUFEEaGBDHGAE.XAFAhAAAEAAFKGGDMFEAhAAAAGIH...IAFChACA.FCCCTABG.ZDCEODBHcCGEhABA......hADA...,2,-28,-22,6
ebFZEIWKHUYOfJMRGXVgLNBaSTdCQADPc,DACBeGEAFDDDZCCH.ECHDKGGA.HBGFUEAE..OBDCMAAHRAFFGFABhAAA..XEEBhABALAFCaBBBdDAAAICA..hABA............hADA......hAEA...,2,-29,-21,8
VacNLIAJUCGYdDHKSbgEWQTPXfReOBMFZ,UGDECECDdEEGHDGHKCGC...SBFHEAACQGGG..TGAEhAAAXCBGeCBFMFBFhAAA.FEEGVACAaADDLAFDhADAAHHHYAFC.DCAH.WHCAfAGFhBCA.BDHA.hABA...,1,-10,-20,10
CdGLJPceXSHZYBbADUMRgTFQVNfaWOIKE,MIAGTFDHFFDG..QCBA..NAFE.fBFBhAAAOGFGKDABEEAGdBHCLAHHhABAJAAC....eGAGhADASGAA.YHFAADCCDCGH.gDFBhACAWHEACECC.cDDAhADA.,2,-34,-27,7
SaEJZYFeUQVKODfAWXLbIGMPTHRdcNgCB,XDACLGEAGADA.MFAATBBFdBCG...NEEHBHFGhAAAaBHFEEFFZFFAFHACUGAA.hAAAKBFFDIFAAHDA.ICAFhABA...........hABA......hACA.PAHFRCGB,2,-25,-18,7
UeTVHdMGNRLgacbIfWDPKOFSACQJZYEXB,QEBEJFBBZDCF.EFGBBACG.UBFDVABA.dHCFGAAELAHDhAAA.aDDF.IGAChABADAFEKFHDOFFFhAAA.ACIB.CEGBXAEB.....hADA......hAEA...,1,-8,-44,36
IKBJgZVNEabXFeAGOLTMUdfDYRCWScPQH,LHDAMGECdGCCDAADRAACCBGF.....SDFCQEBCKBCCBDEChAAA.JFEAVDAHEDGB.hABAaBHFFAEH..eCDHhABAAAHGOCHF..fGHA.WADEhACA...PEFChAHA..,2,-33,-24,9
CAbBJZFGdWaLTOENKPMXecSHIDYgUfQRV,BAFBJDCHGEAAdEDFLADF..OACCKCFAMIBGeEHFHFCChAAADAHFUEEHRBAF.AAIDZBAChAAAaCHD..EGFH..NIDD.hABA............hACA......hAEA...,1,-27,-28,1
FcHCdBQKgZIDAVaTSUWYNbfOELXeRMGPJ,TCCBUGBC....NCAG.OEHDLFFGeBGDRBCA.MBCAGBFEhAAAFEACCGEGBDBF.KBAEIBHFhAAAAFEB.SFFChABA.YHAAfHEHECAA.JAHFhABA......hACA...,1,-16,-30,14
UJFDfdBaNOEecSbGCgPXAWZMIRQVTKYHL,ZFACMECGQEFHKHACLACGFACH..DICCBEGF.OBBBEBEAeBHFhAAA..SFDAhAAAbDAA.CCGFPHFEhABAAHHBIBAE.........hADA......hAEA...,1,-24,-42,18
gedYRTHNEPcDGAMfFbZWBSUKQVXaOIJLC,MHFGFHBGZDCFBBBAUADEKFCF....QCGEVDFD.OFGBhAAALFAD.CADCdCDAhAAATBAGEBGB..DDIDAFFD.hABA....WBAF.....SFDHhABAIHHH..hACA...,2,-39,-37,2
RYeSCcbHWOZEMaDAQLTJfgdKUIVNGFBPX,QDCHLFCAJBBAdGDH.KCAFUGGE..IBHHGCAEFEDGhAAABAAFRAFC.eBFB.CGHC.hACA....bGACOHAChADAMACGAHFEfEAA.NIEFXBBFhAEA....hAFA...,2,-28,-23,5
WfCIUVRZdHGgcaYJKLMFNBbAQDSTeEPXO,SDABTGGD.EEFCXEBB.OAEHfGBD.hAAAUABHVFDBRCDAdGGCgAFGhABAaAECKAHDMFEHhAAABHAGAADDeCCDCCBFIDFC.....hACA......hAFA...,1,-14,-18,4
VbIMXJBHOEQYZPRUSWaLNFADcgTGdfCeK,DACBTCBCGADF.dEGHeEFEKHGA...IAEBMICEBEAEOFDChAAA.EGAHQGAGhAAAZAGB.UDDGaBEE.hABANGDD..ACGE......fBAEhABACHHG.....hACA...,1,-23,-29,6
NOeVDaMZJGKWPFRfYTAdbHUBLIQXSCcEg,dCFCUFDHBCAEQBBDCEBH..EAEGOBFHDDAF.MAAFZDCDKHAChAAAFGACRDAA....TEGAhABAAGGFHCGB.IHHAhABASCCC..NIAFaAFAJGDG....hACA......hADA...,2,-40,-14,26
HMOINDJYgQXVSfEZFdUWcBaKCTbeARGLP,RFBHLFEFMDAC.OCHDDBIB...JDCGQAAF.XEEEhABAVAAFSGHDhAAAECEHdGHEUAEFBHCBCHADeHDEhADAAGBFPBEC.NEAG......fADAhACAWAGH..hADA...,1,-13,-36,23
NCbGUQWcLFAHXZgPdJMTISYDBeEVRKafO,XBBHZAADdEFBMBIB..TGAH.SBFCBCDDeEBCVEDEhAAAaGCCOFGH.hABACEACGACFQGGFhACA....cGACAHDEHCGD.JADFDDFAEEAEhAEA......hAFA...,1,-8,-23,15
OdabFSQXJYVEUMHNeGBRZcLfWDPKgAITC,CHHGOEGHdFDG.FAEDQBFG..JDHFEEAGMAIHHCACGCCAhAAABBADZDEALDAHhABADGGF.KABGIGAHhAAA..TGBFaAFASHDAYFEB.NAIE.hABA......hACA...,2,-21,-21,0
UDCaBIfcFEgTeJWVdNLOYRMbHGXAKPSZQ,KAFBSCFCUFCE.CDAG.BCEB..IHEFFGFH..EBBATCCDhAAA..eCADhAAAJFBCVEEELABCOHAAhABAMAHB.HEGBAHGFPAFEDDCA....hACA.aBBBfFAEhAFA..,1,-27,-30,3
aJONdCZMTbUKSPgGFVBHLEIeRQXcAYfWD,...fHBHDGHHaGCD.OBCFdAAACDFAZAFCMCEG..UECBKFHHSAAFhACAGCBFBGFAhACAHFDALEAFeDADXAGAhADAAFFH.JDFENEIE......hAEA......hAFA...,2,-29,-14,15
TMYOCRDFNWIbKeSZUcEJQagGfLBHAPdVX,dCFCXDCBMABE..CHBG.RADCDEGD..FECA..IBHAeCBGSEHBhAAAZGDAUEABEBBEhAAAaHGAGFAFBHHHAHAE..hAFA............hAGA.PAHF.YFFDhAHA,1,-22,-42,20
cXZfgaAbRVBLUEJdMQGWTPHCFDeKNOYIS,RGFGVFEEBCAF.UCDGEACG...dABDMABDGCGC..TGCEhAAAHGAACAFHDGID.KAEEOFDGhAAASCEA.cCCChAHAXEAE..ZBGF.aHFEACCD...hACA......hAEA...,2,-27,-11,16
fMQTbJHdcRSIKNGUCAEOZaegDWLPVBYFX,EDBDODCHZFDF..eAAHDGFFLABABDHG.FAHHMFGF.TFAHhAAAJEHBdDDF..SCCBhACAKGAHUEEFAIHCgAFAhADA..WCAD.....hAEA......hAFA...,1,-29,-40,11
VUFYcHOKNbfPJgDeWELGQBCXdMIAZSRTa,SDAFaDAF.UECAFAFFHBBG.KHEEfACEJCED.hAAADBGEeCHHEBFBQFGFhAAAXGGBMEAFACHFTGEGhABA..YHAGNIABgFAF.hABA......hACA...,1,-13,-30,17
bIKeONWYGAdHgJRXBDcPSEVMLFCUQZaTf,dCFCHFDFJBAGBGGE.DDAG..SFBFEBBCMBEBLCHBhAAAFCHHCHGH.QCFDhABAZAEEaEDF.fHADhACAKFFFeDAF.OEAG........hADA......hAEA...,2,-40,-18,22
GYIHAXJBPeOEQSDRUdTgWcLVbKFMafNCZ,JGFABAFB.eDCHEEFA.QACBDCAA.REFH.dDBE...TBEHhAAAgGDELHCGhABAVBAFFAFA.MBIDaAHDCEEChAAAZEDB..IHADAADG.OCECWDCH.hACA......hAIA...,2,-26,-10,16
geRUSOIJMaYFZCTEBDQAcKHGXLWbVdfNP,KCFCGBDFLFHB..bEEEVFBAdCAC....NGAB.eBBASAAChADAIAGE..hAAA.JEDA.MBIDYHDChAEAZGEETDAGDCIHADBCXDDC.PAFAhBBA....hBCA...,1,-15,-24,9
fYOJGSLZDURNCBXgbWIPaQMTdHVFcAEeK,EEEDKDCDOEDCGBFCZDCB.DAGARAEHBBBD..XDAA.hAAA.WEAHPBBCQGCChABAdHBHFAABAGGDeHFAhACAfHEB.SCHHUAGGCFHF.IFAFhACATACE...hAEA...,1,-8,-31,23
MQdbTcOVCgBYPLUaEfHFNIXGJDWKARSeZ,RDEDSDBDZBACdHAF...TAFCOAFDCACGBGHHLHFA.aEDHhAAAfDFA.hABANDDE.IHDHGADEDIDChAAAKADHAGGF.eDAFMAIF.QGFAhABAcCGD.YFAF.hACAEEGA..,2,-25,-6,19
TLNVWEIeUPRMXYCBZcbSGdHJfDAOgKQaF,KDCDaFHBLDAE..NBEA.EFABeBHFRCEE.MFFECBCCBFFB.ZEBFhAAASCAFdAHA.hABAfGEFAEEDOHEE.hACAgGAG.TABH.IDFDhAAA.PAFAhABA.XGCB.,1,-17,-23,6
SfIcRQEGJCALZUYFabKMTXODdegWBVNPH,ZAEGFGFCKHDAMCAA..OCBCdCHAeFHB.BAAC..NEBGHCFHhAAASGEF.IDEDhACAQECD.EABEhADACGCAAFFCLAEEaEAFXDBBDCIH....hADA......hAEA...,2,-34,-23,11
WTUdSKIMgHYZVEFfbcaONQLDJeAXGRBPC,GACFBFDDCEFE.UGEGKDCC.MAIFHCAF.ZGCEECAD..FHGA..fAAGhABA.aAGDhACAQFABDHGE.hADAAIFERACCWDEEdAHESABCgGAGbFCB.hAAA..ODCC.hAFA...,1,-5,-32,27
gAQKFVINTcJPEOUdDSCRZbXaYBeMWGfHL,KFHBFCFC...VGEATFBG..JCFAOFFE.DCIFSDBEhAAARCAGZAEA.aBABBEDDhAAAeBEDMEEGGEACLFADhABAAEAD..IBCE....hABA......hACA...,2,-32,-28,4
gNbLMOcVTWSAYfDdICHeUEXQKRGaPZBJF,DACBCFEDUBFDECEE..KAAFGBAB.ZEAGBGGB.JDAFFEHF...hABA..bGEEODDFhADA.TGEEAEBGdGBBIAAChACAXGCDaAGD..NADF.MAIF..hAEAcEEASBCHhAFA.fGBA.,2,-29,-24,5
MVHbGBcNUFIXeTgESaYCJRLKDdQWAPOZf,OFBBZFACMBBEHDFEBEDEUCCD.FBAGeBFD.EEGHaHDG.JBEA.hAAA.LCACDIFGdFFHAFDEhAAAfHGB.hABA............hACA......hADA...,1,-30,-36,6
EKGPQMJNHAUcWSbRfaCDVIYTXeFOgLBZd,UCBCSHBGRBFH.CEFD.DFFG....VEAAIABG..hAAAXDDB.FACFhAAAOFCCLAEEdGGFKGABhADAGEGEMIFGHGDAADDG......hABA......hAIA...,2,-43,-20,23
WOGXHJSBbDCRcELPVKNUYFAdfTZgeQMIa,TGBCZFDFQCBB.MAEEIBFGOFGFHEEA.JBDHbFBDhAAADIEA.CBAF.RDEEEABGLDAFhAAAKBFE..NAIA..hABA............hACA......hADA...,2,-34,-10,24
aHDJFOGbcIdPBNEeQTUVRLMXYgWZACSfK,SEGDKAFBDGDG..OCACGADA.bDBFdAHC.BABG.eFHDhAAAUGDGLDEEhACAMCHDgABAAIFA.hADAaAGCFEBCPHAA.NAAE.EFAB....hAEA......hAFA...,1,-4,-37,33
UZEJQCgdDYPfGNMLHTbFaSRWXIBVAOeKc,KAABZEFHQDBCdEFGDCDH.....PACDfACCGBEHhAAALEHFHEDF.FBEEhAAAaFAHREBF.IFHHhABAAHDFeAFEEEAFCDHCNIAFMAEE..SGDBhACA......hAEA...,2,-30,4,34
eTORVEBbAWCKDNdgFPILUGMZYcXfaQSHJ,KEGDDGHHdADEFCABLEBAGEEFZCAD....XAFFaEDGHAGFJCCChAAATGBE.OAAEhAAAEGDFBABCAGAH.CCHD..hABA..NEIE.gGDBIHBF.MDDE.hADA.fHEFhAEA...,2,-42,-2,40
FbaXgTNVJWLUCHRSZIQKMYDcfGAEOBedP,BDGFdDCDFDFCaHGE....TFFEVFCDLCBGUGCHHEAHZBEDKAEEhAAADEBBGBBF.AIACOAHHhABAPGFGXABBhAAA..NDIECACCSAGB.MEABhAEA.....hAIA...,2,-20,-15,5
QPVAFKScNbOHGaCeUJIXMZYDWEgfLdBRT,SDAB..bDDDHCDECECCUAEGIFFGZGFG.DCBGEHACLHCAhAAABABF.TDGDhABAQDFDAIHEFACCNAEHaDBGhAAA.JAHF..MCFA.WFBAfBCFhADA.....hBAA...,2,-21,-21,0
aULAQegHGSPWOXKdBFMbDcIZEJfTRVNYC,QDACeFBBGDECSEEHOECFKBAAdHEHBAGDFGAE..DCFCZBDChAAAEAAFJHFE..TDGHhAAA.RBCF.NDAFaAHFAGDHPAEEhACAMDID...cGGA....hADA......hAEA...,1,-15,-19,4
HDcWaYgQPKfJSEbGAMFBTCZReUILNVdXO,BBGETGDCCGFHZBEF..eDAHLBAFdBGCHCDFDEIH.aGGC.QABDhAAAKECC.SFBAhABA.EAEAAHAFRFAChAAAIHACXGDDWFFC..YCBEhABA.fHGFhACA..,2,-40,-13,27
HXTDQfUJgIMAaKZROSLPFeYBcVdWNCGbE,aEHBZBCFOECBLGBCFEGCBABC..dGHECDEDGADHEFAF.HCFDhAAATFDCDIDGUCBC.hAAA.JCADIHHChADAABABKHCASBHFeHAA.......hAEA......hAGA...,1,-16,-28,12
FNESMVbKACgXJfDBaHPYLQReGcTdOWZUI,XGGGJFCHBBHC.HCBFLFEHRFAB.GCADTFCC..dDFHOEFBhAAAZFAHFACGEBDB.SAFFhABAMAGF.KAHFhACAAHAFCGGDDEHF..aAAB.......hADA......hAEA...,1,-13,-29,16
HTMCRDJXVcGSaOIbZQYUFEfBNeKAgdLPW,LCCHHAADCFFBDEBFJFFA....VGBEGACF.aCHD.OGDEhAAAIDEEZBAFUGAEhABAfAGBBHHE.eCCDhAAAAAHE.dHGF...TAEGMCAFcBFDhACAbACB......hADA...,2,-19,-13,6
aUZdSJRGNEOIHDCFMLAKgcWQVBbYPXefT,KHBG..gCBCQBDABFHB..bAFFPFBE.eDEGhAAAfDABUAFDdHDDhABASFEG.hACAJBHFNAIAIHGECFHB.MDABADDDWAACXACEhADAaHEE....hAGA...,2,-25,-18,7
PTYLCDgcHUJKZXBdAeFORSVMNGIfWEQab,FGDBODCHRCEG..MEFFGADC...fDGCQEBCaGGAhAAA..bADE.TBADhAAACGACgGDE.hABA.cGFD........hACA......hADA...,1,-31,-34,3
BAbVRfaGJcUEXCYDPOeZIWHTgMKLdFSQN,VGFGRDAGGDFC.UBCHECCH...CAGC.DHAC.OABEZFAA.HEDEhAAA.MCFAKBHDdAACSDGAhABABBFGADID.bCAFaEEHhACA..JAFA.........hADA......hAEA...,1,-12,-34,22
cSCWRJOGPaYAQDTUFXVefNBgIZEKHbMdL,DFEETFCAFCAD...eBFCBCCEZDEEEFBDKEBCHAGHdACGLAAFhAEA.CHAC.RDFEOABEhAAA.aGGGAGIFXGGHhAFA..NIDFIECGMFFEWHCA...hABA......hACA...,2,-35,-14,21
DbVQEOKRXUALaCdTfgPSYWIJFeZHBGNcM,CDGFTGBC....fABDSBFG.IHEFJFBAeHAEhAAAZADFHBDBBAAENBIC.DGIBhACA.VEECQAFFhADAEBCH.OEFBKDDD.XGGGAGAHaCBH.dEAChAEAYAFC..hBAA...,1,-5,-23,18
aNBdOHEFRDGeMIALQSZTcXCUfYbgKWJPV,QAADTCCB.CHFD.UEEF..bCAEKBHB.JFHH..PGAChAAAaGBABHDHHAECEAGAFDGDhACA.DDIHGAACeFCGAIHAhADASADB.XGACfEAFhAEAWAFD.....hAFA...,1,-15,-21,6
GAUIbeNgMYJQERXcZTCWVOPaDBFHSKdfL,UCBCeGEAMDCCQFGCRECH.ZEACCBDE.OHDEDICEBEAH.FEGA.hAAA.KEEHdAGAGGABhABAACAF.IAGG.hAAAbACA...NDDD........hABA.JABD.EEEE..hADA...,1,-9,-37,28
bAfPWEdZMaIeRYSTNQKHDGCFOgXcVBJLU,...PCCHEAFBMCBG.eHDESGHBQDEGHEEGCHABOCHHhAAAcAGA..VBEChAAAJABEUEBAADAFdHEBIDHChABA.RABETFAEDGHH.....hABA......hAGA...,2,-25,5,30
PCZRMbUXIVALYWFSONBfTDdEKaHgJGQec,LGEAFHBGOFFFBBHC.DAGAKDEGHEBFGCAEeAFD..CECAMAFEhAAAXCDD.ICABhAAAACGFSABC.hABA.NCIETABF.EEFAJFHF....hAEA......hBAA...,1,-12,-41,29
WAbJLSBFGeRZDgKVXUdNCMHfPcTEYQaIO,JEEGBDGFGDAAeFAGDFGG..KHDGUCBEdGHG..CACB.MAAFHAEA.hABA...PBDGhACATDCH.ECGEaAGFIBADhAAAAIHASFEB.FGGB.....hABA......hAEA...,1,-29,-31,2
HXSFeAMQIEfPLKgZNGDWJbRadYUOcBCTV,QFDBEHBGLFADKAHBZGDADHFG..JCGFRDEGdADAUCCABAFB..hAAACHHFHAAEFCAHADDC.MDFFhAAA..IHCEhABA..PAEA..NCCE.....hACA......hAHA...,2,-38,-18,20
VBaGXLEUTcPNYMFeRKIgCDbAZOWHfdJSQ,ZFDFOFBBHFAGdCCFJBED..QGDABDHGGAAFEABG.UFGE.hAAA.TAGD.PADAhAIAMIAAeDAGKDFFIFHChBAACBHADAEEAAHH.fDDE...hAAA......hABA...,2,-23,-13,10
OMNKIefgPZQEFCbULYBXHAGRTaVWdcJDS,RCDFVBCFdAGBDABE..OFBGKHCE...eAFG..fDFAhAAAZFDEFHEA.CGHFLFAFhAEABEEBAIHAaHCC.JAAENBCE.hAFA....IHAH....hAAA......hAEA...,2,-41,-33,8
JMOBFCNVegfSdUPWaQEcYLXTDHIbAGKZR,KCAHZDBGMBCABAFGFECG..CHBH..eDGHSGFCUAAA..aFEDhADAQGAB.hAEAEGDBLGAEDDIHHACBhAAAAIFG............hABA......hACA...,2,-43,-36,7
LeYODEIBZFTGSdJPMbaXRVfgUWAcNCHKQ,CFDGQCCBLAFC.eFFGDDIBBGHCZAADFFBFGBCHdHFF..MEABhAAAaGBF.RDFE...VCAFhAAA...UFEEABHENEEAHACAhAEAKACEODEC.......hAFA......hAGA...,2,-24,-10,14
SJMPTRDWEbOHdaAFegIVZGYCKfXNcQLBU,eCCHVAAD.ZDFHGECECAAF.KAEG..XBFEQCEBBEEFSAHBhAAAMIBG.RFGF.hACAEAEEOBHHaBCGAEHDFDABhACAgGAG.IEAH...hADA......hAGA.fGHAcGEB,2,-26,-3,23
ANTXVLCIYRbKHgQJaFEPcUSeDMdOGBZWf,TCGCVADG..CGFH.RCCGKGFHHDEE..JFBBaCAG..FBBB..PAAAhAGA...SCGAhAHAMAADdBEHBEGGhABAfDCCAEAHNEIE.XGCBIAHGbFGH.hACAEBGA.....hADA...,2,-35,-9,26
NYIAbeHOaLJDVfgcPMCTEFZdQGKXBRSWU,eFBBHDEDaBGDDGIH...VFCH..fDGE..gBBChAAAMBBEEDAGZFFHhAAAdAFGQEABhABAKCCCRAGFSFDDNIEBAHHA.LDED....hABA......hACA...,2,-22,-12,10
TDUSRZbLYGBCHcEJINKfeAVgMOQWPaXFd,VFACOCHD..QGEDaDDH.dBAAUFFEZEDCLAEAhAAABHDGHFBEECCGJBAF.KAGEAIBAMDIBhABA..XAEGhAAA..........hABA......hACA...,1,-18,-38,20
dZgGDJSYCTAHQILOEWKBFcaRVfeMNPUbX,QFDHLEEGOGBAECAHBFBFFAHDRAACeCDH..MADEUAGBdGGChAAAZACGDCEGSAAFhACA..CEBBAHHAIHGDhADAKCCGaHAG.NEIEPHAC.....hABA......hAHA...,1,-8,-31,23
abEgNIedURQfOJGPMZBXFHVCScDLWKAYT,aGFCEHBG....IAFEUFAGQAGD.OCCEJEGDGDAFhAAAZFCBBAEGXBGAhABAFBACCDAFDEGALCBEhACAAIHA.YFEH.......hAAA......hABA...,2,-34,-20,14
NXMRSPTdbgBcfCUeOWLGVFIQKZHDAaEJY,aEEDJCCH.....XAABSEEAdEAHBADCCHAC.UAGCeGCChAAALDGFGBGEIACGhABAKHFGDEIDADEDECBHNIBF.hAEA.RAEF...PGBCTGGF....hAGA......hAHA...,1,-26,-27,1
CfRSNEgUGHOTLebFIWBYcAQPaJdKXDVZM,aGFCJEGH..KEBADBBA.ZADD..CEEE.RDFF..EHAGGGAF.HCBGhAAALDHBFADCBHEHAIHAQCAFhAAAdAGF.XFBBhABAfDGBSAGD.NEEE.OCAHhABA....hACA...,1,-17,-35,18
aXZgMFeWYCdAJGcLfDUPNbSEIRKBTHOVQ,GECFLGEAUAAH..NAED.EBECRAAFBCHCOEBH..QDEDhAAAZDGFMIFGFAHFeFCFCDBE.hABAABECJCCBDDAD..SDDChADAKDAD.TGCAaDHD.....hACA......hADA...,1,-12,-25,13
DWFZbeHaAPMOUYTgRfQCBNcdEJLGXVKSI,OCHDUCGC..TBACRDDHCGAG..BACBdDEALHAEGGEBKFCFDADAhAAAZAFFHGFG.AIFEMEBEhABA..fBBChAAA.NBAEEFGEJFBASFGC.hABAIAGF..hACA...,1,-24,-26,2
ZVQgKUbdLFJBaTNMAHRDXeEOcSCYIWGfP,DDGBXGGDeCAF..EAAESADG.CBBG.IHBCGGABZECChAAAQCCAKBGDbCAC.hABAdEBGFAGAaHEA.MCFDhACAAHFAODEC..WAHD.fGGBhADA.....hACA...,2,-20,-17,3
dHVeDWTZfOMAYKNJBRLGbCIEFQcSgaXPU,KHBGJAFBBACGRDBDGGEB..CAEF.EDEB.FBAHQDGC..hAAASBGAaECA.hABAXAFGUGGCdDAGHDGFhAAADIDE....ZBBAfEAEAIBANHAF.hADA......hAHA...,1,-17,-33,16
HLERPCBfgZKSGNJaIdbVTceWYQDMAFUXO,FEHBUDCHOCCGEFBB..RADEBGGFZBABKFEA.GDBG..NIBF.JHDChAAAdDGG...VAAFhAAATAGH...eFABhABAQFDBAEEA.XAGFPADACGHA.hACASDGFaFAH.hADA...,1,-15,-26,11
OLQTSZMPXEgJbCWBNYGVcRDaKfIUeFdHA,OFCALDCH.TFGHZCCEMAIB.EABGJHEA...CAGFBDHFhAAAGGBBREAF.DHGCKCAEIFGAhAAA.UAEFdABBAHCAhAEA.SEEAPDABXCGDgCEFhAFA.NIAF.....hAIA...,1,-13,-26,13
ARFWbYJZcaCfGSedMQTPXNOUBEHKDLVIg,RDAGFHBG....bBAAJEAD.ZEFB..CHCAGEEFSAAFdFAEMBIFhAAA..TECGhACAXADFOCEGBGHFKAEGhADADAGCVBBFAFDB.........hABA......hACA...,1,-29,-30,1
ERTHbIBGaMSDWNKfZXLUeOJAVPFgQCYdc,VDAGFHBGQBGD.dFFGEEGAHCADBDGCaEHHDBIH.KACD.ZGCAhAAALABCUDDA.eDDFhAAAAIAA.CAFE....hABA............hADA......hAEA...,2,-44,-18,26
DgbNQfPMcITdWSRAYeKLOXaHJEGFVUCBZ,KDCDLFCAOEDCHCAAGGBBUAFE.CHDBDEEG..NAFC..QGGGhAAAMIFE.TBCBhABASACB.AICAeBHHhAAAJCABFCGHBFHBgAGEfEAE.hACAPGFC...hADA...,2,-20,-20,0
faFYCDTGLIPONJQWKUbRVEegdBcHSZMAX,aGFCCFEDDFBELDBE..OCDGQEGEKHCA.RBFHEHBGdAADHDDChABAMCAFAHDGFAGC.GDGEhADAPFBE..NEAE.UABEhAAA...........hAEA......hAFA...,1,-9,-34,25
ZFcKWAUOYCDfETJBQeHMRSVXIPLaGdbNg,UDACOAFBDEIF..EDCCBDDFHFFFRAAE.SDBF.XACGhAAAIAEFLFEDhABAdGFH.NAIG.FGBGKGCDAEECCHEGhAAAfDFF..JAHFMEAFaEGB..hADA......hAEA...,2,-44,-11,33
EgMIHdNJUSeaPfFALGBTDbQXORVCKWYcZ,BDHBTAFBDCCH..QFABRFDEKAEE.......WGFChAAAZDEA.EDEAMCABHABChABANIAB....SCGChAAAPCACAIACLCHBXABE.CEAEYHDAhACAIGBF..dEBD.hAEA...,2,-41,-17,24
MNVFUCHXfZOYDQRbJAPSIWGBacTgKELde,SHBGGAFEaHBE...TDDGKBCCLABFMBAE.FFFACCAFHAEEhAAAXDDBZFDAOCGBhABADFAHQFBFJFHBAIEAPEABhACABAEEEHEA..NAIC..fCCFhADA.....hAAA...,1,5,-23,28
LaMCYWEgNceQHVJOAKZRTFUIbSXfBDdGP,ZBCFFDAFUGCASAEABACB.GFDFLEHDCDFE..EHAA...hAAA.gAGHhABAeAHDQBACHBBEJCFHAIGEKHDAhAAA.TEAHIEDG.fFAEhAEADACE.aFFH.MIFEhAFA...,1,-8,-26,18
SIGYdAPZMQaBfJRKeNHDLXFUEgVCObcTW,ZFACQAGDBBDARFFD.KGGDHCECDFCA.FABHUBBE..EHAECEGB.OAEAhAAA..TFAGhAAASDBCIAEC.hACAdGDEAFBEMFIB..fDEE.hADANBAA.LFED.hABA...,1,-13,-38,25
BMcDSARPEaVLCWYXZQIUdeHJFbOGgNTfK,RDAGEAFBLFDF.CFFF.XEBBZCDA.QFFEdAFFeAAHFGGDhAAAGADC.NEIGKBBEBCHAhACAMAIFSGBBhADAAHEEaDAG....WHBGIEHG...hAAA......hABA...,2,-25,-23,2
RWfGMHdVNeCbUQPAgaXDKLFSBJOITEcZY,XGBCLEACBCDE.OGAAEDGGZEEARCFAGAAFMBAEdAFCeFEGhAAACGEEUDAE..AEHGDIGEhABAFAHBSDDChAAA..IBFE..cGGEWGFAfHABhADANCAF.hABA...,2,-23,-22,1
TALMSFdEXUgKBJfHRIcCZGaVODYWQePbN,SFAGEDABUBDDBBHAHDDF.RGCG..CAHEZBCAaFGE..DABGQGGGhAAA..eAADhAEAbCAGAABCFDHB.dFEEXCFDhADAKDFBIHAG.....cGCGhAFA.....hAEA...,1,-16,-32,16
XKHWAaPFGCYJBgDQdZRNSIcfMTbeELOVU,aAFBGEAH.JAEEDHGAZBABRFDC....SBCB..fGDChAAAMCCBeDABODGDhABAXDFEKCCAAIFCCEDCBHCGhAAAQGGBdAHENIEF.IHBD.cBGBhACA...TDEAhADALABC,1,-15,-33,18
EPfYGCcRNbIadQAWZTHBDgSeVKOUMXJLF,TFDHBAAFSHGE.KHEAUBFE.XGGGFDAHEBHD.PCAHhAAAGCCD.CFGCRGBENDCA.hABA..aBBAAFFEZBBADCAC.hACAeDHH.OHACMEFEfFCBhADA......hAEA...,1,-12,-26,14
HYAfTabgVdGWNDeZIBcLMESFUKRPJXCQO,aGFCVAADGECC.DFAGZEEA.BGEGLAEGMECH.EEHHUBEARCEE.hAAA.JBAHCDCEHBGD.hABAAIFA....fHABhAAATGAFgBBBNAEB.IEEAhACAFDAHXGGA..hACA...,1,-6,-24,18
WATdNKXSZOQUeabDHLPgJFVMGfRYCBIEc,dGFCXGBCZBBEQEGAUABE..eDEEDBGCHDBGLFEAJBFFFFAEhAAAVDBG..MAFChABAfBFDCHHH.IHHChAAA.EBDGAFEA.NCIGKAGCSHCAhACA......hADA...,2,-22,-6,16
dJfVScQGYDIKgCNXaERBWAeOZFbMPTHUL,ZFBGFGFHMBFHHAACdDAD.JDHDSDCB.QFAGhAAADCFGIAHGCABH..XGGFhABAEDFCBFAFAICCbCFDTGFChAAALAEC.fCHAcDCD..hADA.KBCG.NEEE...hAIA...,2,-27,-17,10
LFAVbKCPUJdYMfTSGIORaEQWXZHecBDNg,VDAGCFEDUCFF..dAAE..MDCFSGCEGABH.OAFDRGAG.hAAAaADCEGHD..XEDEhACA...eHFAhAEADCAANBIG.gGEAAFABKHAAPAHFfAFBhABA.IDDFhACA..,2,-24,-20,4
RSQYEdIVfgULbHNZcWTaCKXBJOMGFDAPe,eFBBQCCBEEFBdBHE..VEGHUBCFLEEHHFDDZAEF..TAGGhAAAaAGBKAABBFCBMIFAhAAAFADCDHGEAFAFSGAAhABA.ICACfDAANICDCDHB...hACA......hAFA...,1,-10,-16,6
HOTBVFQAZXYdGNbWPKafLIMScEJURCgDe,XFDHGEAH..NDAF.....WBABaACDLAEE.hAAAMIAG.EHEARAEHDBIFhABA.OFFFTDEGBHHDhACAQDGCADGH.dGBDKEBGIBAFhAAAcGAECGAF.gCCDhADA..,2,-30,-16,14
PGeHIcYERMAQbZKJLDUfSXNagFOVTWdCB,ZEFHJFFBLAFCUCCF..SGDB..aDBFFBADODAHhAAATCGECEDDBBCG.hAAA.PFADeHBGIDHAhABAEFHBAEAAKAFADFFFfBEE..NABF.hAHA......hAIA...,1,-27,-38,11
MTXIOaHcZKPfSYEbFWNBRVdDgGUCLQAeJ,MBEATCGC..OCBHaGEA.HDGFZAACKCAASABA.EDFFhAAAbBEHFCDGBHAB.dFAFhABAgGCFCBGCAHFB.hACAJFAHIHHAfGHANAEBDEBG....hADA......hBEA...,1,-10,-24,14
QILAHDTeNgWOfdbCUKFaBRVSJYEGcMPXZ,HFEEDECDeBAD..NEDA.OBFDdAFE.CFFD.FHAGBHEGRACB..SEAEhAAAJCCE.ECAGMAIFhAAAZBGB.LHAAhABAAHHB...TEGH.fGABhACA.KBBC...aAFGhADA...,1,-24,-32,8
aTWRFDSLgNAObIVJXfZecMPKYCHEBUGdQ,OGEAVAAD...XBFFeFBAMCDEKCHFHFAEBAFBdHEF.aHBAhAAARCCCDGIH.SACBhAAANGEF.IBBBhABAJAHF..fEAF.ZDEA..hACA......hADA...,2,-24,-21,3
ageFXTGVYPILUdNSWbQKDBAHfRZEcMJOC,HGFGRGFGEDBE.JFCF..CEFF.eAHHFGBH.GCDA..VAEHIGAHhAAAdBBH.SADChABAQCGAKCCDAHAHfEABhAAAZBFFMCBHaFGA........hACA......hAGA...,1,-6,-28,22
FBIEWCcGNKDVZUJbdfAMQOYaeLPgXTSHR,MIFGQDAC.OAHFaCGCeBBALAAC..PFCFhAAAgEDDTCDFSHDEhAEAFEGBBABBEBGGcBBChAFANAEBDHGGZCFF.UGBGdDAAAFEF.....hAGA......hAHA...,1,-9,-13,4
RMSfWYaTVNQUZbHXKIJBAeOgLCFcPdDEG,eEEGOEEGCFDD..FGAAdDAE.DDCHRCAH...SHCA..hAAAfDHGaGGE.hABAVADFUAGGZGDEXACAhACAIHHFAGGEcFBDEABAMAAF..WHFGhADA......hAFA...,1,-22,-41,19
DebUZfcXEMOTKBHLICQSRVGaWdFAJgPYN,JGEA..gDAC..NEAHeCHHZFBCXDDH.OAABhABABCGBHFAGCHDGRGFEaCHFhACAdABF.AHACDBCD.fAFFhAAAcCFHMBCETBDFIHBE.hAEASCCB.hAFA...,2,-38,-7,31
BdUIWfVLTZDHgJKEFMSYOPcQXGaCRAbeN,eGEAdEGDUCBC..IGBG..fBGBVDDDZAADHAFEhAAAJFCA.FDGBMADCOACFhAEAQBDC.hAFAaHGGAHIBNICHBHDE........hAAA.WFBDDCCF.ECGB.hAHASBAF.,1,-7,-28,21
dXTSbVYfEIKGORFQMWJgNeHAZBLCPDacU,ZFEEBEFACDBG.aDEGdHDD....XBABTAAB....VCDFhAAAEGGAGACEFCGF.QAGFhAAAMBIH.WHAGhABAJFABeACHAFAADIFA.SAFG..hACA......hAEA...,1,-25,-26,1
CTIZfVHEWJdDcgMOABaXeFLbYQSUPRKNG,BFCFaGDD.FHCELHFA.QCGHPDACRFFE.KFGCGADBhAAAICDDZBBA.HAECEGAE.hABAdCACDEEGMCFDAHAD.XFABhAAA.eABC.SHAAhABACFDA......hAFA...,2,-28,-5,23
dWBVegFSZGbYECDXLQIJMAUNTROHcafKP,UCGCREFHOEABHFAF.aHFAKCDE..dABGBEECeAEBFGBEGECE.hAAAEAGADIEALFFAhAAAJFHB.AECB...NBCH.cDABhADA..fBAC.VBGFhABA......hACA...,1,2,-44,46
DHIdOMbeVXQKAWGZgaFCTNYUSLPfREBJc,GEDHZDAGFHAC.CAHD...TBAAUGGGSGBELEEC.RCAHBECFhAAADFCFdBGB.MABGeAGDhABAQGDDAICC.hACAaHGAPACEEFFE..cADDOCCG..hAFA......hAIA...,2,-24,-11,13
LCHIRcQXONWUBdaGAMJfDESZgFVebKYPT,JCHDDGHHEDEHZEAB...FACBeHCA..KGAC..TFCBCHCBHAFCRACB.hAAAQEGD.hABAOBDCNCACBEFF.aHGGhACAACIFMFAGSDECgBAD...hAEA......hAFA...,2,-29,-25,4
acPgRJMAWIEFdQDZCGOfBLeHXTUYNKbVS,EHBGdFAAZGFAGCGEOECFBCCAHBAFUECD.KAEHSEFC.hAAAaCGEPDAH.JABBhABAACGGIAEA.hADADIFEfGFAXABBNIAB...cEGDhAAAMAIF...FAGGCHAD.hAEA...,2,-28,-6,22
SGgAIKMBDVNYcEJHTLaCOZUXeWfRbFdQP,KGFHBFGADCBA..VAAB....NEDB.EGAFHADALDEE.hAAACEADUFEAeFCERAGFFAGHdDAGhABA.SFFEhACAACIF.MICAJDCBTADFaGAE.....hADA......hAFA...,1,-25,-32,7
aJACQIbFOTdcLUNDPZWXYSeRgHEBGMfKV,QGGGFHBGOCBF.dGAAUADADIDEZDCA....XABGhAAASGCGRFDCHGFCBBAGMDDAhACAKBECaDFACEEC.IDAEhAAATAGC...cBBA...NCIA.hABA.....YAFChACA,1,-20,-28,8
PXTbLCYDgIcGQdVWSKNRJfOAHBUFZaMeE,BADCZBCFeGDCEBED...XDAGLHAGCFHG.DGGA...gEEChAAAIHBBQAAAhAAAVCAH.WCFChADASCHH.RDCFJHFGAIEA.FAFEPFAChAEA.bDFEcFAC.hAFAKABB..,1,-10,-27,17
eYfcgAOJZGaBWDKSIFbEQMPTVNLXdUCRH,ZFBGaBCGBFADKAHDFBAF..QDCE.MABGVADH.LHDGhAAAUFFECBHCHCFAeFFC.hABA..fFBDhAAAAFAEGDABDIAGIHAAECHF.NEIE.....hAFA......hAGA...,1,-21,-23,2
bVNSFgJXHILcKOQUYMCWPDdBTGReAEZfa,ECFCZDAGaABE..VEGFFEHF....XGBELDCB.KEEFUEEFhAAAMBCCCBAG.DCCCBFBFhABARGAGAAAC....NACH.SCCChACA.gAGC.IHGFhAEAQGED.hAFA...,1,-26,-38,12
ZHaEDXfcIegPdUBRJFCGKNTWObVYMQLAS,ZBCFHFEEaBBHEFAH.DDAA..XBFG..fDHEhAAAeHDAdHABUEAGBCEGRAFHFDGDKABDhACA.NICF.OFEC.hADAYAFCMEBAAEAHcACD...IHHHhAFA...hAAA...,2,-24,-13,11
LCSEUcATBVOWMdZYaRHGIQFPfgbDKNeJX,TGDCBEFAOHDA.dFAAZAAF.REFCGACGFAAH...fGABhACAgAGGKCGCeCBAhABALBFD.CAHA.hAEASDGBEGHFAEBD.WDBA.aGGD.IAEDhACA.bFCCDAFEhBAANDIE...,1,-14,-24,10
PXbJaYBdZKVOUITHSRDNFCQAMeWgLEcGf,eCHDLGEAECDCGDADXBAD..aHGAdBHAKGDEUGAE.TAEAhAAASFBD.NFDFFACHhAAAQCEF.hABAWEAAfAGF..PACD.hADAYEFG..hABA...,1,-12,-27,15
NVLYfbOKPDaXUEAQWZIMGHFgcBCTRJdSe,ZEFHGBGAHAFEFABEBBBACHGA.RDBEdFAB..eFBELAEF..hAAAbEEBKCADDDCCXGDHhABAAGBBQAEAMCID..hAAA............hABA......hAEA...,1,-19,-36,17
OMEIcLNXedTVWRPSfUFaJgZGCDKABbHYQ,HDBHQDACMBAGEGDBLFFB.XAAFTDFARAEA.SHGGhAAAFGDBJBHBGCCBhADADFFFKBHHAAECBAGCODAHIHBDhAIAcEGDNCAFdFHE......PHAChABAaFCG.CEDA...hACA...,2,-5,-5,0
gLDHGVbTFZMNPfIBRcEKSOUYJeQWACXad,CFCFaFHBdBGELDAEGAAH.....VCFEFGFEZEABMFCE..NAED.hAAAIAGGBEHAREDF.KAADhABA.SGGDhACA.OCCAJCDE........hADA......hAEA.QFAHAIHA,2,-37,-10,27
TcYRNMEOHDLPBKQbAZFXWSICJVGfaedgU,XCCBSHBG.CEFD.JCAHGBED.eEHDdHEHUGAG.TDFHhAAARDABEABFDGEG.PCCFhAAABFGAQFDHhABA.AAHDFAFFWAFEIHHEaDHF.cABGhAEA.MDIF.hABA...,1,-14,-25,11
PNbAQUFGKdHIVTLJagYOZEWBeMcXDSCfR,QFCAFCBBKGBBHGDG..VBADJAGH.aAEF..OBBAZDDABHFGhAAAMFDGDHGA..SAHBhAAAfAHE.PCFChABANCAE..AHHFUEGEdGAA.IDDDhABAgEGH....hACA...,1,-19,-21,2
ICQNGEfVHbKMgWARYBPeXJcUaFDOdLSZT,BFDDeDAC.JCBCUACD.DAIBOFABLCGFZCFH...CAACQFBBhADAEDBB.HEEBhAFAMHDCAHDE.RADA..PDEDhAAAaGHDFAFE.SHEANIEF..fBHAhABA.KHBA.hBBA...,2,-28,-18,10
IWVbaZcPUefRGdQLgXTACDMJSKBFOENHY,DEEASFAGBHEBFBFHOGDC..EGADHAAC...ICEAhAAAbBBC.ZEEAUEBHhAAAeBFEREGBdACFQDAEhABA.XDGEACHFMCIF.NIBB.....hADA......hAEA...,2,-36,-12,24
aJBdNfFXKUOPgADLIcRHTMVSQGebWECZY,DEFHLGEARAFEHGFATCGH..SDGGeBAAEAGE.CFAHZCAGJCDDBFBDhAAAdFCGFCEG.KABFODABhABAAIDA.MIAE.hAAA............hACA......hADA...,2,-30,-23,7
RaZCQAYUXTFOgKSVGcWLbJeMPIBNHdEDf,UCGCXFCAFDAF.KABEGCCD..LBBAeFGB.MAHFIAAEhACABHGGHCDC.hADADGFBaGAGCGACADBDOFEFhAEASFFE..WAFG.....hAAA......hAEA...,1,-27,-36,9
JFYHDWQbaOMSgcERLAUCTfVdXINBZeKPG,TABHVDAG..dAAE..XGFBBBHBKGDGJBGFHADF.DHGAQDAAhAAA.aDDBhABAMGAGSHBGhADAEHAAAFEACDFE.NEIAZFAA.........hACA......hADA...,1,-12,-39,27
HaRYDBZgeOWQFdPUIXANTGKVCbfcLSJME,TFGHKCAHCHAC.......fDBELEEEJCEAHAECaAEChAAADFEG.ZBBC.eHDChAAA.WHACdHGFPFAGhABAIDFFAGFA...NBAC.bBBBMCID..YHCAhACAOFAC...hABA...,1,-13,-36,23
RXJLefFYBdIHKVGZOabWNPgUMQCTcSAED,DEFEXBDGeCADFHDAdEAEHGDA.GCGGaCFE....NDIC.gEDEhAAA.MCCDhABACFCESBABhAAAAAHEEAFE.JCCGfABFBAHBIHGB.ZEEAhABA...WFAD.hAEA...,2,-30,-13,17
RQgAFcHENfLGUJZPObSeYMBXTVWKCIdDa,FCFCHDAGEECALGAC.JDFDOEAB.SACGMFIBBBCDhAAAVBADKDDEdHFF.DBIDhABAaHEEQADBhACAAIHE.NIAB.UEGB.PGBC....hAAA......hABA...,2,-30,-16,14
LDKWCAPUEfTYMegIGVFQOJSHRNBadXcbZ,EGFCTCBC..eABHGEFGQCDDOAAHHBEEBGDAaCGFXEBAhABA..cADFhAAALHBADAGCKEFACAHCAAECPDHDhACAfHBBMBBE.IEEFFFABRDBBNBIE.hABA......hAFA...,2,-14,6,20
OHEgSIKYPbeABWcRfUJNTDQaVdFXGMCLZ,BFDGRAADUGGEJCBC..DEBF..aEFCdGAHGAGCLEDF.ZCFBEACAhAAA...SEBHhABAKADC..bAFAAHGFfGEFhACA.......hAAA......hACA...,1,-37,-40,3
MHRfIYcebCPaXKVJSNUWQOBFTgDZEALGd,GAEGMFCFRFFG...IHEFeCED.CGGC.XGDGKAHB.VAFChAAASGBE.UBBEhAAAQBBHBHAGFEAAhABADEBGAGEALEEAdFAAfACB.cDFFhABA.....hACA...,2,-30,-11,19
TRXfDBgZUVSaMFCWcebKLHGOPQEIYJNAd,RBCFXAFBDGAHBBACUDBB....aFCEFFGF.CBAC.eFGHKDHBLBCEhAAAOCFH.QGEGhABAEBGA.IHBGhACA...JAHBdAEF.fCAHhAAA..ZCDHMEIFhABA.cGDD.,2,-35,-14,21
aUbfJEWCKDOQRcgYdPLZVFHNSIBGXTMeA,UGBCJGEA.ECBECDFE...DIGGODAB..QCEDRAAC.hAAA..gFEHhAAAdCCGLHBEZEAGFADCSBFAhABAIAHDXEFA.MDIHAACBaDHBhABAfDDB.hAFA...,1,-27,-36,9
RXOaTWQMNHCAZFULEecDbgBYVPSKJdfIG,UCCBEGDBDGBFBFGC....VDDFSAAFKBAF.dFDHGBEFhAAARBGHOHAGaGHDTGFGhABAMDBF..HAEDCAECAAGEFCBDhACAeFHH..........hACA......hADA...,2,-27,-21,6
CADSFbQgcTJPZKBeRGEXWaOUVNIMfLHdY,FGCDQCBC..TBDDZGAGKGFFRDFEEFBAaBGE..UDEF..hAAAIBBFMABELEHFhAFAHFFBCDBADEAHSAGChBAA..cDDCBFCCXBDEhBBAOBFANABD......hBCA...,2,-20,-17,3
PUGDFcegBQWOREJINHTVaLZbCXYMfASdK,KDABUFGHDFHDFGDE..eEFDQEBC.RAAC.EECG.JAFHHAEGhAAA.aCCA.LDAChABACBAAMDIHADDCdAHAGGAFhAAABFACIDGE.......hABA......hACA...,2,-44,-8,36
TPcAHDGKJLWYFVfIegCXMaRNSQEBbdOZU,DCHDKCCGLAABFAGE..VDBCeHAG.CFGA.MIFERDEH..SHEAhACAEEFHBFHDOAEDhAAATEBB...AEIHJGCChABAfGDD.XAEH...hACA.aDABQAGBhADAdBBB..,2,-34,-16,18
ZfAOSUKNQJDHeELaTCbFgBIPRVYGXcdWM,SAADKGFCQFDEHEFHLCEGCAHD.FCAGIFCDRAEA.hAAAVBECXABE.hABAdEACMEBEAIDCOHAGhABANDAADDCCEHEEbDFA..BDDD......hACA......hAEA...,2,-20,-10,10
IBAaKZGLJgTDRUQVOEWFMXeHcYSNdfPCb,aEHBKGFHLCHH..gGACRDDAQEAEOFDAEGCFMDBEhAAAHBDHSDBDhAAA.NAEHdBAHfADGhABAbGEGAGIB..........hACA......hAEA...,1,-8,-30,22
FVAcKZaBbWJQXIERSgMYfdNODePCUGLTH,KCFCBCAH.JACCQGFF.ECCESDGEMGAC.dGGDNBCF.hAAAOCBDDFDG.eFCAhAAAPHBE..CFADLHAAhABAHDAAAAIH.ZDDAaAFA.XEGE.hAFA......hAGA...,1,-11,-35,24
AUZNHGVJMeDLfbSQOICRcgEaPdFXBKTYW,ZEFHHEBHJCAHMDHH.eACBDAHFLDCB..bADFOBCChAAAIAGD.CGEBRBABEEEDaGGEhAAAFHDC.BGAHKDEH..hABA.....YAFHAIFGNAIEfHCFhABASHGA...hBAA...,2,-35,-11,24
cRLeZXSCgODaHQBKEIVUTGPdAbYJFWNMf,JGEAFHBGMDEC..RCAFeEFGZAAF..XEEDCACE..DCHFQADGhACABBAFEHBEUAGFhAAAPFAE..ACFF.bGFAhAFA......WEDFfAHAhAGA.SEHFhAHAaFAE.KDDD.,2,-42,-24,18
cFIEDNHYAVKPBTXZJWUMeCdaSLQROGgfb,VDAGBFEDZBFA.UEAHCFDG..dAFALCACQGEDOHDAGAAFhAAA...fAHEhABAFDGHEAAEDIGGNCHE.AAHCKGAAhACA..XEEAMBEF.....hADA......hAEA...,1,-18,-33,15
UBcdYDFKIEWQaTePgGbSOMfCZHRALVJNX,JFFCXCGCBDDG.dFHE..DHBGKCDG.EGBDQCEB..hAAAaEBEeHEAGABDSFAAhABAfEEGCCBFRAFE.hACAAGGH............hADA......hAEA...,2,-43,-31,12
QRYEXDdABUHfVeLWabJgCcNZSOIKGMTFP,BFFCHEFHVADHLGBA.aBAFJGBG.CCAF.ZACC.ODDAKDAH.MFHBhAAATAGF.FABGRDAAXAGAhABADFAB.AIDA.hADAeEHH..gECASHDA..hAAA......hAFA...,1,-17,-27,10
KHDAFIXGaRbgVfPWTOcYBEUJNCMZSLdeQ,XGBCaCAH.RDEH.VCEH....fBAFTFAHOCBGhAAABHFDEDBGUGFECAHC.MAIHhABAZBFCSEAGhAAAdHAH.QEGADAFCIEHCgADFhABA.....hACA.WDDD.,1,-9,-20,11
bQgSLBfFMIGXVCTNRcPZDdeOEYHWAaJKU,aEEDKAADUBDE..QBDHLFABFCFAIHCDGEEDCGAGRDBEZDAAhABA..DFAE.dBAEEHGEhACAHDGB.AAAEgGGAhACABAGAfHEBMAEEXBGE.hADA......hAEA...,1,-5,-28,23
fLbEKTXUIVDBgAMCHFecZdQNJWORYPSaG,MEEDFBBDZDBEdCHE..QCGDJHAA.OFCARFFG..PABDhAAASHFE.aAFFhAAAfDEBLABCEHAGhAHATAFF.UEBDDFIFBFGCAADC...hABA......hAFA...,2,-32,-17,15
gDJOIaYNRHfABZMQdeWXSFECTcVLKUGPb,BECDZFEEdDDBeCCC..XBBCEFEC.CAHA.TGCELHDGKGHFUAAChADAGBEH...hAEAgGAEDAHFIDEEhAFANACH.fCGEAIHGMAAFQDGDhABA.WEBASGABhAGA..,2,-23,-19,4
dKeOLHZXETUJfBQWDGYRSMPFcIgbAaCNV,CFEDVDAGKDCA..LAEAZFFH..TAFGJDHF.BGDGDIBGGAAEhAAASBAA.MBIDhAAAFFAD....IHHEhACAAFIBNDDBOFAB.XADFfGFH.hABA..WCFC..hADA...,2,-48,-18,30
XMOgYZIWCeVdcbERABTafUPHGQDLJSKNF,BFCFaGFC.UBDHGBGEDAAF.SAFF.FBABMEHB.OAHHhABAZGBAIFDFhAAA.CDDBdCCCEGEEABBGfDAAhABAPDAE..HGAA.....hACA......hADA...,2,-41,-23,18
SRgafQFGLAXdEMOYTHcbJPUZCWDKBVIeN,dFHAOECCHBAH.JFADZACC.DEAAKGDABCCB..eFDESGCAhAAAaCEE.QBGHhABALADEACHHMEIH.TFAFhADAbFBDCDCC...IHGH...hAAA......hABA...,1,-26,-27,1
UgCRaAGVEXHfQYeZBLNSDbMTPOJFWcKdI,VCCHHBCFQGFG.eBHHBAHBLHBCNGBH.SBBFhAAADAAFMHECTBEHhABAJFCEcDAC.IAFFhABACAECAIHAECHD..XEFAfFHGZGAAOCADhACAKCEE....hADA...,2,-29,5,34
YTHBXNVOeSfLDIRMJKWUCbAPFaEcGQgZd,FAFBaAFBGGCFZDDCdDHAHEADBCDD....XDAAOGDGeCDGhAAALCGBDABC.MBIDKBBECHHEhAEAABBEEDEC...cACAhAAA..YHCA....hAHA......hAIA...,2,-29,-20,9
LEXZgKRTIeOaPSWQbYNUcAfBCVGMDdFJH,CBBDMIDADFGH.dAGFHEAALDHHZDEB..KHBETBDG...eEGFhAAAaCDDSADEhAAAQEAA....NHBHAGEEhABABCGEFCACEDEAXDGE.IAHGhABA.OFHB.bCAChACA...,2,-34,-7,27
eESFKVMIDcABZaYfTgdOXURJHPNWLQCGb,aBBDTCBC..dAEBUDFCJHCC.HGAA...NIEB.QDCDhAAAGADEeCADFGGGMCIDhABADBBAAGGF.BFCA.fFEFhACAXAGGWEHHbBEA.SAAChADAKHAA......hAFA...,2,-22,-14,8
EaAWXQbHeGCNfcOUIdJYgTSDFMVBKRLPZ,XCGCHEFHCFDG....NCDD.OEAG.IFHCJBBD.TFCDhAAAFFBBBAFA.KDHBhAAARAFEPACDaHGE.QGFGhABAeHBA.fEEB.dHABhACASACEDBBF.hAEAMDDC.,1,1,-41,42
XMYcFgKUfIJDENSPBVaCZTWLbRHeQGAdO,dGDDXAFHMCGFFHAAKAAF...UDAH..JEHFEABCSECEhABA.BAHGCGGCTEDHhAAAbFBC.RBCD.HCAAQAGEhABAAFAHOFFB........hACA......hADA...,1,-24,-30,6
FRbBYTIHWQeXafLUZEVDGcNMOSJACKdPg,CEFAKAFBdAHCFABDBBAA....IEGGHADDeBGD..fCDEhAAAZFEADCCD.GEBBhABAMIBAOFACJHBGAGIH.hADA...PAHB......hAEA......hAFA...,2,-38,-37,1
GMHLBCSTQJaKOWFNVUEbDfZYARedPXcgI,RDEDdDCD..XEAHIAGCHABGLCHBCGDF.SBDEhAAAQAFEaGHBKFHF.WAADhABAFEAHNGCH...EHEGDCIHhACA.fCDHAEFF.eHDA...hABA.cBBAMCCFBAHAhAEATCFH.,1,-1,-32,31
LPCaGBFZbDUOdTNYJXgcEeIKHAMVfQRWS,MECGQFDHRFAA.LADECAHGBDABZACFDFFEOHBC.dCBFTGFAhAAAJCFE..XEBChAAAEAEAKDHDHBFE.hABA.ABHEfGGFSGEDaBBF...hACA......hAHA...,1,-19,-28,9
JCYSLTHKFIVOEWRcGgdQUBbZePXANaMfD,aGFHDDGGCDAALBDD.KFBBVAAA..OBHFEBFA.REGHGAAEhAAAdDDGQFAFUAEEBHAEhACAeFFF.AHHAMEEChAAAJFDBSDFHFHCA.......hADA......hAEA...,1,-13,-30,17
MbgXdfRAEOHKaQCeZWVGJUBIYTLNSPDcF,EDBDODCHHGEAKBEEQDECZFFD.VAAEUAGE.BHHG..hAAATCGASEADhABAcGACMEEB.XABEhACAfFCA.AAEBaDAHCDGH....WDHHhAEA.....hAAA...,1,-16,-32,16
NILBcUaEeRPTfYCdgOJDWQMAGVHFKZbSX,VDAHHFEEKCFD.SBCH..XFEGLFBDBAADhABAaECFECHBPACG.TAGChAGACBACdAFDJHFE.DAIHhAAAWCHHADAE.GDDH.bGFANAEE...cGCChAIA....hBCA.eCDCfGCE,1,-4,-11,7
UFGICMXSEKecRBbVQPHJYNZgLdAOWaDTf,aDCDDAFBUGGEGEED..CGEG.SCGE.eBEHBECAbABAQGBGhAAA.HBAGhABAYCAFZBDFdDGEAEHEWHDChAAAFAGG...MGBEKBHB.....hACA......hADA...,1,-9,-30,21
LaKReFBXVcNDCgJYTGfHOUSEZPIQdWMbA,LEGHaEHB.eCCDBBGG.VBCGDIGACHDB..JDABGADA.hAAAOAFFEFBHZDFBIBAHhAAAQFDA.MIFAhABAAFFGRFDGFHAC.XFAANACB....hABA......hACA...,1,-21,-23,2
dXNUYILQgJRScTeWOVCDbPKMBHFAZGEaf,GBCHEAFBdBBE.UFBGLBHFQFEBREBA..SFFFhAAAeAGBODACDHACKHGAMBIBBGDBhABAACAC..fHGBhAAANCAG..ICEAJEHFWHAGCGHB...hACA......hADA...,1,-7,-31,24
FcVLNeRaYUHXIQMJZAdEfgOCBTKWPbDGS,dAFBEHBG.OGCACAFB.BBBEKDGB......PFDDDEIDSEDGhAAAFDBFLGFARBFEaEAEhABAUABA..ICAChACAJDDGAFFE..fBGHTGFC..WCDGhADA.....hAAA...,1,-34,-39,5
REdMAIfaYLZTPKDgOeVUSGXBNbcHJQWFC,aHBGLFBBZDCF.KGGBDADHODFE.UDDGXGFG.BAEGhAAA..NBDFHBACQBGChABAFGDGCAAF.EFAGAECA.YEFGhACA.gCEDSAGE..hACA......hADA...,1,-21,-32,11
YKTJAcOWRHeSBIgQMXZaDUFNGVbPfdCEL,OGEARGFGHCDABGAG.QFCHMAIHZDABUDFEGCAE..bFCBhAAAdACA.CDHC.LADFhABATAFGABAGeFHH.IHEHhACA.gAFH.DECENIABfEFChAAA.hAFA...,2,-17,-12,5
GCAcNaYOJLUMgfSBQZEeIKVbdWFHTDRXP,aHBGOEEGLABCUDBG...MAAFSACBBCBEQECHhAFAeGCGKAFGdFGDFCEFTGGFhAGADIBA.RAFA.XBGAhAAACDBGAICA.NBAE...YFFEfBEEIHEEhAIA....hBCA...,1,-18,-22,4
JVFGeZQUNbLDBAXYSOPTcaHMKRfgWdCEI,SGFCODAC..TFAFHEDARADD...fBHChAAAgDGGdABEEBBBVDAFeFGDhAAAZGAENADBLHCAhABABHHFAIFG.PAHDaAGBKEHHCEDA.......hACA......hBAA...,1,-1,-13,12
YGWEMVLHTefcDKOUPgCdaINRQAbXBSJFZ,BHHGSEEDJEHH.FAABGDEG..MFIFLBEAeBDHDCGDhACAKCAFUFAACHFG.dAGFIEAChADARBBB.ACHGZGBChAEA.EAGE..........hAFA......hAIA...,2,-37,-31,6
bRDGHfUWFOaJVETXCPdeYBMQgKZNcLAIS,SHBGDHCEGEBHHAFBUBAB.FBCG.OGFAaBFH..EFHBCAAHdCAGhAAABEDG.MFAFKHEA.ZBGBhAAALBHBAEAGREEF.fDDBhACAJGBA........hADA......hAEA...,2,-23,-20,3
BQKaCMLEdAORbVYgUfJeNXTDISWPGHFZc,OFBBRGFG..bAFEVCCG..UDACJHCG.eGAE..TFGGhAAAIEGD.SBAAhAAAPAEA.FEDBBCHBhABAaEHD.MBBH.dEGBAAEAYHAAfCFDhACADABE.HCEE..hAGA...,2,-21,-15,6
IeWGYSgPUNbTcDAHJZLQBKEMFfROVadXC,HDBGLFFCKDHBEGDBMFDH.FCABOFFE.dFBGCGEGeCDAGADDSHGAhAAAUAAC.TAGAhABAAFED...ZEADhACAfCGFRABAaDEEIGGH....hAEA......hAFA...,2,-20,-12,8
UVIBRFWTeYZbSPJdHEaNXQMKfOCLcgDAG,UCCFBFDDFCHFeFEEZADA..SGDGdHEHHDEB.EDAB..aBAHXCGFhAAAKGAA.CABE..hAAA...gBBGhABADIFGAEIDIAFC.WHAGYFHB.hADAJEAE.NAEF....hAEA...,2,-37,-19,18
VBdfHMCQObLRcaXAGJTePESKYDgUFNIWZ,GDDCJFCA.eFHBEEAH.SBGFDCEC.FBAC..ICAGhAAAVEAFdCHGHCCA.MFFAhABA.CBHC.bCAARGBEXGGAhACAAIFEPAED...KAEAgGFEhAAANEEFBHAD......hABA...,1,-10,-16,6
fgFREOdHSYeXcUCTKNZPWMVDAIBGQJabL,BECDGDDCJADALDBH..FEFAEGCFOAGDSGFD.hAAAXADCUGACCCAE.TBFGhAAA.KHGCZFFAWBAFhABAMDED.DIFGAAIDIHAC..aBAAhABA.fGDEhACA...,2,-48,-9,39
FPXYceLJNfadOgIHEZBWUSbQKCVRGATMD,DIBGXGBCeFBCLCCC..fDADaHCA.OABGhAAAIGFHHFDABAFHhAAAUCDA.bAEEQEGEhABA.CACARCABACIFMHFGFBHHcDDFJDFA.NEAE.hACAEBBB.SFAFhAFA..,2,-21,-1,20
PFQUfNLVHEMgXeKSbZYOdAGBTWDCcRJaI,BFFHTAFBCHHG..RCAG.aCGE..FFCCUEDCLFADEADF..MHEAhAAAeAECKECDZBEG.dACGAHADDEIHhABA.JBBB..IDHHhAAAfFFB..NICF....gDEFhABASHCG.hAEAODAH.,2,-25,-18,7
cfaYVeDZgWBQOKdEHNMbCPRJLIUATGSFX,GCEBFFAA..XEFDfAEA.aGBFVAAF.ZDCCgBAGhAAABHDEKBEDEHAEHFEChABA.NEAD...MAIDhAAACGAG.JAEAIEHD.AFEGSFCBhACAeHFADDFC.....hACA...,1,-3,-25,22
dePWKSDILGagOUBJQXREYcZTbFCVAMHNf,MECGHAADdHGF.eCCFKHACSDHFLEEGaCGGOAAFBEAFJFBFhAAAQAEG.EGHDhAAA.ZFDCbFDG.CDEB.AACCfBGFhAGAPADADDIF.......hACA......hAHA...,2,-21,-12,9
FOCQKfSZGbBVgDRcUWJMNATPadXIEeHYL,aGFCXGBC..eCGDLECGCFCA.KBEFSAFGZCAGBHFGDICEhAAARBAAUDAFMEGDAABGdGAAhAAAEABCHAFDFHDC..QDDAhADAfEHA.......hAEA......hAGA...,2,-22,-16,6
PYTNfbKFBAcQEaSJIHdUWGXZDLgCORVeM,EGFCaEED...JFCBHCFA.dHABGBEGDEBGLABCOABBeBGBhAAAMFHD...TDBFhACAfAGBKEAFBBHBQFCAhAAASADCWCBE......hAFA......hAIA...,1,-19,-28,9
dgaHCFXTRKEDGUeLOYQBcJINfVSbPMWAZ,ZDAGdAFBaFEACCBD..FFGERGDE..DCACUFDF.LAHFOEAGBBDChAAA..JACG..IABFhADA.VCDEhAEAPFBB.AGAB.XCGBKEFCEAAF....hAIA......hBAA...,2,-39,-36,3
HOCIDRcNZBPgJdEaXFSTQMbKVGLfAUWYe,UCBCeGEAOBAHCGHD.RCCE.ZBGFBBEE..JFBBdAGD.EGCAFAEDQCGChAAAKACE..hABAGDDEAECA..YFAFhACADICA.NFED.aDGH...XAAChABAMIEE.....hADA...,2,-39,-19,20
GFNaBEgReXVYcdQJPZCHAKMDUOWSTfbLI,DCHHUDACOCBG..SAGG.TABGfDDGhAAALHFEGADFFGDGaCEFhAAAEHFGRGAC.VDAFdHABQEFEhABAJFFCCBAF.AEEDKCGAMAIF....hABA......hACA...,2,-19,-14,5
MNOSDagJFHKEBRAUYICcfWTQXdPLbeVZG,UCBCCFDG....fBFHTDGAdFGHLEEAeHACZAFCMFIBhAAAOCABDCCC..JHAGFFDEhAAAKABABABH.AFCE.IAEChABA.cCGG...QDAEhADA...hABA...,2,-33,-27,6
RNITKMdAaZWXBEfGDVeYFbCgJUHLSQOPc,aCFCXFDHBFHGGCCEDBGH..eDCCFHEA.CCBC.UGAHHEAELADEhAAASHFA.QFFFhAAAPCAF.NDIAKACGhABAABACEEFA..YAHD....hACA......hAEA...,2,-26,-19,7
CaHVfIBUWZJEYGRDNebTXPOFcdSLgMQAK,KEHBaGFHHAAC..ICFFUBEBZGAEEGBCREFBDFEB..eCCF.hAAATGGEODAFdEEF.hABALAEAMAFEADDD.CACDBFAEhAAA..........hABA......hADA...,2,-32,-25,7
RfXePaHdDcWSENGLATVObCMZFQYUKIJBg,VADGOAFB..CDCE.ZDDC.QEACKGHBBHBC.RBAC..eGDAHFEGhAAAdGHEDAIFSABEhAAAEHDEGBGEAAIFMCIB.hABAFHAC...ICGGfEEH.PCADhACA.WGAC.hAEA...,2,-23,-15,8
DYRKMUTJaINAPdLVOFESBecZgXGfWHCQb,LCCHVDED.EBGFSDGEBACBZFEDGEACHFBHCDCG..QAGFhAAADAAFKAECUEGE.hABA.JHEC.IBCAhACAAAIH.dDAGeCEHXBEC....hADA......hAEA...,2,-26,-15,11
XbRNFaBcDeYSPIJAZUHdgGLETCOQKMVWf,UBBHHDAGGBDEEGEC.CFCHKAGCMCFG..VFEFXAEC.RDGDFFAAhAAABADC.DCHDSCADhABAPAAF.IHHGhACAAEIDdFAA..........hADA......hAFA...,2,-30,-24,6
XQPaOGAZKHMCDLdUYfBVEbNSeJWRTgcIF,KDAFHFBHCBGH.dAAG.UDFDBFBHEGFH..SEEE..WCCChACARABH...TAFHhADA..cEGDhAAA.XGAGaEAGAIDADAIBfHEHNDEE.hAEAgFDF.hAFA...,2,-46,-26,20
VDdEbJCBSXQHgKLaOAPFfcGUZeINRTYWM,FHBGGAFEeCDBRABG....TECGMCECDBBCEGHF.CFEH.BHEG.SFBDhAAAHGFEKDFBOAFEhAAAfDHCZEAEIDADhABANDAB.........hABA......hADA...,1,-25,-27,2
gHUPJeIRMOSKEXYFAZVBWQDLcGNdbTCfa,VFGHQGGG.LEFFGCDFdAEBTCAACEFH..aHAEgGBGhAAAUAAH.JAFHeDAEhABAREBA.OAHFKEGAXAGFhABAAFBABEHB.cCCF...NEAE.fGCBhADAPABCMBIFhAEA...,2,-17,-6,11
UJfLVbRdYMGEgFeQKZXHBNDICPTWSAcaO,OCCHUDACLHBERAEC.MBBEEDFBeAADZEEEBGGFDFID..CDAD..hAAA.TBGDAGDE.aCEHhABAfHDF.hACAdFAA...YCGH...FGGHhABAKDCBNAIA.PAEGSDDHhACA.,2,-29,-24,5
SLQaUDGTOPFXZHeWMVIRgNBbCAEdfYJKc,EAFBdHBHJCEBKBCC..LGFCUGFH.GGAF.OBBHFCHHHDADhAAAMDFARACDBGDE.AGAB.hABAcEDE.SHEAhAAAaAFADAIF.XEAC..WFFEhACA......hAEA...,1,-14,-37,23
CBXLWRJgaAVGQDFEcSYbNdZTOUeIHfMPK,GBDFFDABECFH.SAAB..bEBAdEFHZFFGTGAF.ODBEhACAICHBMFIBKGABhAAACADGBGGDXACG.hAEA.WAFE.........hABA......hADA...,1,-18,-39,21
WRHCALMBKgYEePZJdTVIOQaGNUXcbFSDf,BHFDKHBGEACGeABD.ZFCEdDGA...ICCGaADBGAEC.UBGEhAAAXEDHFGAHDEBFRCEBAIHEhAAALEHF.MCAFhACAYEAB.JAFE.OBAH..hABA......hAEA...,1,-16,-31,15
ScgdPNGWeVFfIAJELMZYBaCQKRTHODbXU,EGDBMHACZAFEBADG..aFGHCCCG..KBABRCEAOBCD..XGEGhAAASGADdEFB.GCAChAAAeFAAFCEGABBG.JAEAhABA...QGGCDGIH....hACA......hAHA...,1,-25,-32,7
SYZfHMQTRXDgbKPFNdOLVUcaAeCIWEBJG,eAFBCFDG.EFGHBDCGGDCESCBFZFEDMBIFRCGH...DIGAKBFDFHAChAAAOACFLBAHUFGDhAAAAADH....ICEChABAJGAA..YAEC....hABA......hACA...,1,-13,-44,31
MCNEGcAXKTIUYdSbJBOFRDgVWZHQfaePL,XFCATGBC.UBAGdAAC..SDDABFHHREAA.DADB.VEFDhACAHDDC.aBHDeAFGLHAChAAANDIG.EAEAAHHBKBEAhAEAIHFD..JCBBFCCA.....hAHA......hAIA...,1,-11,-19,8
EaeNCUHKVgBPRLQFWIcfJTMdSADGXOYbZ,XCCBOGEAZFAD..eDBDCAHAHBBEKHBGBFADRGCGLADEFABA..hAAA..IDFAhAAAfDDGTGGDdCGHAEBGDFFDhAEA.GAEF.EDHHNCAA......hAFA......hAHA...,2,-22,-14,8
bKFQWHCZGMAODaeBNVEIPTLUSdfcRXYJg,aEGCeAFBBEBGEFGH....TBAALDDBdADARGAGJBHD.KGBHFFDGHFEBhAAACDEE.ZACEAEHC.DCEANIDF.hAAA....IAGChABASDBH..XGGBbAGF..hACA......hADA...,2,-30,-12,18
SJGQZDIdOEXMbBPHfNTCKVcFUeALaWgRY,aDCDRAAD..SHEEGEGGDHCCOAEA.ECDGMCDE.BAHFhAAAHEBEfGAAhABACGGEKDAFFBGEeDHDLACC.hAAAgEEFQEEGZCEE.....hACA......hADA...,2,-15,-13,2
dCFBXfVDcKGeaTNAZIUMLEHbWSQgYOPJR,UFDHEFAGHCDG.SEFAQCDHOACBJABG..CAHEBFBEhAAAXFGE.DHBAGBGEhABAeAHHaBAFAEBEMICAWAEEhAAA....gGGCRGEEdECB.fAFEhAGA...hABA...,2,-30,-6,24
IJGEAKPVNadeUTRcFHBMCSfWYZgDXOLbQ,KCFCVAADdFHG.UFEFRDGFHADF.BAHGCHAC...SFHHhAAA..fEAGhAAAZFBADDDFLFEBQCCEhABAIAFFJACCADHHaCBB.....cGBDhAFAMIAE....hAGA...,2,-44,-14,30
cXFeRgHQSdDaNZCUbPMEGYWAOLTKfBIVJ,OFCATAAD.BHFD..IHCHJEHF.FFEFeACGHAFHSGBAhAAADFAGZDEACCEBUCAFhAAAMBGHGBACAHGHKBHB..hABA.fGFB.cCCAgGGBhACAaAHFNEAE.....hAEA...,2,-30,-12,18
SCMWIZXcfYBFRHKUaQDAGTPdNeEVOLJgb,TAGHdHBHEGHBLDCH..gGFASEFDCCBBMAAFhABAZAEGXEGA..hAAAYCEHBEAHFACBKDBFhACA.aFAHAGEDGCEFNEICeGCC.OHECWCGDIAEFhADAfBAE..hABA...,1,-7,-16,9
dLRZOIYacNBDUeWETPSHbGVgfCMXAFJKQ,FEEDKAADLAGBOFAD...aFHHBGCHDFBG.UCBD.EACASBEDhABAGAFE.fGEFhACACAAFMFHB.AEIHJGBGhADAdHEF...RDCEIBCFNCAC....hAEA......hAFA...,1,-29,-34,5
GKSWbIXMfNFcTYeOURVgDBdCJPAQEaZHL,EFHBZBCFLFBHKFCE.SBAB..bBCBXAGEhAAAMIACFFFFTEFDOBGBVGDAhABADHBECAACAAFG.HCAFICEEhACANIEB..YAFC....hACA......hADA...,2,-24,-14,10
GDFgbKROWUPAeVHBcXdSYaCEMfJLQTNZI,eDACHFGHXFBEdEFG..SGAHCGEGECFA.MICGJBACTDAAhAAAIGDF.DBFHFAFChABAKCGBRCDB.UAAA.AAFEBHFBhADA...aAGEfACB.hAEANICB......hAHA...,2,-30,-10,20
UACbOfGFPJMDTSVYRcXWgEaBNKZQLIHde,CAFBOGEAGCAEFAED..MFHHDBIH...TECHSCGH.hAAARAAC.XGDHEEEGBCDDhAAAKCGEZDAAIHAFhABAdHBFAAHE.fABH.PCCA.YFFHhAEAWHFAaGABNEEF..hABA...,1,-10,-34,24
VcfLKEZRIMYQeWJgNGHPbFCDOBSXaUATd,VBCFLGEA.ZABDMEBFeFAA..JHFAGAEAHAFG.FDCEDEEHBHAAhAAA.SDGFhABAaGCCABAGdFGFKCADEAHBIEAFhAEAQCFG..NEIECFFD......hAGA......hAIA...,2,-22,-13,9
ANfPOFZJcGbRKWHUdXaLBIVQDTCMgYSEe,...PHFCODCHFECHJAFG.GBCFRADGKDDH.UGEB..aAFALDAFhAAABHDG.IEFDhABAQBAC.CGEAMCHBhAAASBHHAIBG..NAIE.fABAhADA.....hABA...,1,-25,-33,8
FOSYedPRAJCEgTLZXUGKHfMBDQWVIbNac,EDABTDACLBDC.UEFFHEFBBAABQGAH.WCCHhAAAICBE.aGADOADFhABAeDDH.PAFChACAAAHCCGEG.XFDDKCGAMFIFbCGF..NICDSFCDhACA...hADA...,2,-19,-13,6
BTKScQRaedGFPCLWEbDOYXfUVJgHIAZMN,ZFACMBFHBHEAKFGF.QBAERGAE.dDEHFDADLFGBEBAA.OAEAhAAAXEDD.UCGEhAAAJBHB...gCCChABAAHBANCCH.SHFAaEBE...hABA......hACA...,2,-28,-25,3
SZWTKeRLHBMDPNAVEUXYIQcGaJOFCfbdg,UCCBXCBCQGEGGDGC...OAEAfAFGdCGB.SGAEhAAAZDAFTDGGKEDFhABAeFFGRGDGBFFD.DEEAhACAAIAAYBAEIHAHaADH.CBBB....hAAA......hABA...,2,-21,-8,13
EQLUgdGOfJaMWDXKFVTBcASCIeNHRYPbZ,CFEDeGEARAGB.....PFADZBBEEGGHUCDEdFCCGBEE.ODBChAAAaDGGDFFA.XCAHhAAAKACEFGAFBHEEAEIDIADAhABA.HAFE.......hABA......hAFA...,2,-27,-21,6
ZKFXPNCIfUSRcHVdBeMYALgQbaJEODWGT,LDACQCBCaDFEEDGB..DGGGGAEGZAAEKHBGFABA...XGBAhAAACBEAUAGC.SGHDhAEAHGDGBHHHeFFBhAGAMGBEAEEFJAHB.........hAAA......hABA...,2,-32,-7,25
fARFgaYeGLQPHSBbDJKVdcWOTZMINECUX,RDAGFAFB..aACBeBHBGDGELCBAHAFHSEEDDCGFKGGF..hAAAVEAHdFAEOADDhABAZEECMBABEHCA.CDFD...hAFAfAABAGGD...YHAGhACABFCA......hADA...,1,-3,-28,25
JSfBFEgPUZGMTCdINabYceRAWKDOHLVQX,KHFGDGADOBEHLEHF.QGDB..JCBHBBFFEGEGUGGGhAAAMCGBCBAGdAFB.aHCGbADFhAAA....eEFChABAAAHAHDBBSBGDfBHAPACD..hACA......hAEA...,1,-18,-30,12
GbONcWAKSUDELMBeVXaRITgFCfQYHdZJP,SFAAEDABBHFD.eEEGaDFD...TGCACBAC..QCDBhAAAdAFEPCBEOCBFhABANIEB.AIAEDGGEMCIBRAFEIGCGhACAFADCfHAB.YCAF.hADA......hAEA...,1,-7,-33,26
aScQfPCDTAJWOYBgEFNGMRbdUXeZKHIVL,JEEGOGEABEBGFAED.GAAERGBA..dAFCUCGGZCEEHABFLEAGhAAA.aGBA....hACAQGGGfGAGhADADDIBAEEC...WBAF.EAHBMDCG..hAEA......hAGA...,2,-31,-22,9
MHPbRLODIBKEeFcfJaCXUgQSWGATNVZYd,VEFHZDAGdGGG.MFIDHCCF.RBEALGAEDCGBKAAG.EABDFGAA...hAAA.fCAGhACACEEHUACE.SHAAhADAAHDE..NAIC..........hAEA.PHDC.OAFAhBAABEGA,1,-10,-48,38
THUPdeYMRfVIaJgNXEZKCLDAWBFbOQGcS,FEGDODACQFCAGGAH..SDGHHBBAdAHCeCADMBAAVCDAhAAAaDEFJFAF..XGEBhABAECFECAAH.AGHBBAGChACA............hADA......hAEA...,1,-17,-23,6
QSfMdINKAWRJBeZDcOGPLbEYgaUVHFTXC,RFDFJEGHBECHZCBF.DAIBGABF..LACDEGDB.aHAGHFAHFCEE.hAAACDEE..SCHHhAAAMABFdEBGKHGGAEAEeEEDOEEAhAEAbAFB.....gAFE.hABA......hACA...,2,-25,-15,10
UWaVdIXZQSRAKfLgNPTDHeGOJbcMECBYF,LCCH..gFFGNHAF.DIBGGFEFJBFA.MACEhAAACCBHBABDUBEE.aCGDIDGDhAAAZBAF.SEAEhACAAGAA.fDDH...hABA......hAGA...,1,-29,-49,20
DIOFKSYWHfEgGMUPTZCJbRcdANQBaVXLe,BHHGXCCBLECCDCFH.FBGBKAAB..SDGAHGDCECABMFFGhAAA.UGGGTACEhAAAJAEG.bFBAdGCC.QBGEhACAaGFHIBAAOEAHWHAE...fEAChABA..hACA...,2,-38,-3,35
BfaOdYJFLUWgNIQCbRDTVcXSHZGeEKAPM,MBFHaEGD.dEACFDBDUDBC....gEDEQGCECAFB.DGIFhAAA....TADAhAAAVGEEXABChACAZAGBeCACAGEBBHAG.fEDD...hABA......hACA...,1,-25,-38,13
aXVbBfgJHNEZRKUOWCcFTYQSGDMAdPLIe,LCCHaDCD.XGECVEEHBABD..JBEAHADCZDGDUEAAhAAACCHAFGHH..QDAChAAADABGABBBdEEF.eGAE..hACAfAHENIBFECDEKEHB.......hADA......hAEA...,2,-30,-10,20
DHfGSWIbTXFeYaABdVPcJMNOLQERZKgUC,dGFHVAADJHBE..MFHHLCGD.RBBG.KHAE.CFAEHFEBGADFSDAGhAAA..hACAWAHHbFCB..TCGHhADAFEDCeDAFADDHBAGANAAF.ECDE.....hAGA......hAHA...,2,-28,-8,20
TBXaWMCZGIHFJEPgdbAefDcSQVUOYNRLK,eFCHDACBQEBEOAAHRDAA.KBHFBFHC..XADFaGEE.CGGEGDDGhAAAFAGGECFEdBDEAIDG.hABASFAA.hAGA............hAHA......hAIA...,1,-28,-41,13
eAXIUNDGWKCJMEZPHBcLgdFQaYOfbTVRS,XCGCUCBCGGAFKAAD.MADEZBDB..BEGALFGBFFCE.aAFEOHAAhABA..TCFFhAAASCBAAFEADBBC.CBGEJFFFhACAEFCE...........hABA......hACA...,2,-36,-27,9
HGVTZXOUICYJAFEaRWQefcbNKSdgBDPLM,aDABQFDH.eEBBfACG..bCCEKCGEdBAFDGBCPBGFhAAAHGFEVEDC.hABAZGAAUGGHIEBDhAAA...CEHHAHEB.EBAEWDAF.NIAHSAHBhACALDDC.MFFEhADA...,1,-4,-17,13
gJYRIOAENQfBXSWbFHGVTcZMDdPKCeLaU,QGBCXGGG.SAHDFGCEGDBB..VACBZAFEMACGhAAAdAAECHHGLCFDUBCFJBABRCFChABAAFIBEGEABHEA..WEAChACA..HEFCDFBE.KHAGaEGF....hAEA......hAFA...,2,-17,1,18
JNYDSFgGeWVLUTaQHRZCEBMXAIKdfPOcb,KAFBdHBHOBEH..JDECDFFFSBAEFCHHGCBE..eCAHhAAA.LFHDaGGGQAGHhAAAHDCBRFAFCCHFBCAAhABAAADB.IACCfFFE.....hAEA......hAFA...,1,-22,-33,11
FeOPgTaNADMRdCISLQGZEfcVBWKUYXHbJ,DIBGdAABCFHHLDCBZDEF.EAGF..VADEKCEGUAACHBGB..JDCDFADFhAFA...OEFGhAGATGAFAFBCRFGB..IDAHhADASEED...fHDBhAIAcGECBCCC....hAGA...,1,-22,-31,9
SVfGLAcKPeBMFabTZDOWXgHCQNUIEYJdR,KHBGeAFBBBCDFHGA...aFFCTBDC.ZEAADAEH.ODAE.hAAA.WDEHHFDBCHAEQABFhACAUAGAEHFCdABBSHDChAEAVDFE.fCHGAIHEMAFD..hAGA......hAHA...,1,-19,-27,8
ILPbQBENRVecTKWMGJDCYZSgXFaOAUfdH,dGFCHFDFLHBAQAGFBDDCEHGEREGB.eABDKFACGACDCDAEZFAFSDGDhAAAFBAC.ADFBIAEFhACA.PDCDhADA...NDIA.cDFG.WAHB.hAHADDAG...gFCFhAAA,2,-32,-8,24
MDGXWNFBPaAURZHScQKOCbfYTdgeIJEVL,RABHHDDFQFADCBEA..fHADdEGHeEEHEGGCLABE.hAAAMDHDXAEAFGEEPCFFhAAAACFFSECEhABAKFAEOBCF..........hAFA......hAGA...,2,-20,-20,0
PYfcBKURSbIDMaCeEFJgQZVTLGdXAOWNH,OGEAHAAD..fAGFBAHAUDBCRFBF..SGGCDFIDMBEB.hAAAaFEHCABF...FBEDJFAFhADAgCCDZCGB.hAEAVDFE..........hAAA......hACA...,2,-47,-15,32
MJLaPGROVZeFdcfSIDBNWTECAQbgHXYUK,QCBCHAADXAFCKEFGLHCEGFEHVEBCZFAGFAAA.dADCfHEBhAAADGHBBAFD.TGAEhACAAEID..gCFChAGAMEEGPADF.......hAHA......hAIA...,2,-29,7,36
dXbDecTHBSCNLMPYAUGEWFVQOgJIRKfaZ,GCEBEAFBFABD.QBAC.OGFAIFECKHAAZFCHdAHCDDDAhAAAeAFCHDAFSFEChAAACDHEMFIF.AFHCUEAE.hABAgACEfHFHaHEAcGAEBDDD.NECF.hADA......hAEA...,1,9,-31,40
PMYefDKJRTAbFNWLZSOXcgaCHEBdIUVGQ,FHBGLGEAZACB.OEDE..gCEBCBECEAGD.BAFEdCBEUCGFhAAAQGFEMABEeHAAhAFADCAGJAHDAFID...hAHAbFBESDDC..aAAA...hAIA......hBAA...,2,-26,-23,3
MRVKbGOHTPcNLUSdeJFIfYQCaDXgZAEWB,BFEDVFBG.GAABHACG...TGFH..cEFBLAFAhAAAUGGHeEACFCAGfBFAhAAACDGDDFIFXGAGAABGEAHBhADARFCBKCDCOFAH........hAFA......hAGA...,1,-14,-15,1
BOTJGMgdNCZQUVAIfRXKcPWHeDSFaEbLY,RAADKGFC....PBEFeCEFFEAA.EHBELHDEBGDF.TEAGhAAAMAID.dAHAZAACQEFEhACAAGIH.IHBGhADAfAGA.XADBWDCHDEEHSHFAhABAaAEG.bCGD.hBCA...,1,-23,-29,6
KUMGSbXaWcJDCAHVIFRLEgOTPBQZefNYd,HGFGVDAG.RDADECCE..TGDGBFEGZCGDeBHH....YADEhAAAKAABGEFE.SHAGhAAAXGCGWCEBhABADGAACAFGADFH.IHHH.....hACA......hAHA...,2,-26,-19,7
RdSGBJOPcXgbLUeFQYfCVDaAINZKTHEWM,ZAADHBCFMDCEdAGFSEGGBFBF.OBFEXAEB.LGFChAAAFABBQFEGhAAACDGGaHAE.AIHCIFBBhADAKHFATAGFEDGE..GECA.....hAEA......hAFA...,1,-20,-21,1
dOQCZPRSATcBYHXIabVUfLKJFNWgDeMGE,BHHGXFDHaDGF.UBFCLAAF.FEBA..NCIG.DCBE.MEGBhACAGEAA.dBDGQGAEhADACHHBZAAFSFFChACAAFAFTCDD...YBFC.IFEBhAEAfECGKGCA..hADA...,1,-21,-32,11
KWFOTbUNSfVcZLCBQADYaPdGMEeJIRXHg,DGHHaHBGGAFAEGBF..JDDARABAHDEB.KGGAOCAFUEACSAAFhACA..cAAGhAAACHEBACID.dGDC.MCCChADAICDG..gAFE.hAEA......hAFA...,2,-39,-20,19
TLIfNbMUHeZJaFdPgcKWQSVADYECGBXRO,DGHHCFEDGCFABEAGRDFDLAEA....fBHCMCDFeDBBhAAAZCBHaDHDdGAE..gGABhABAKAADQEDChABASGHBAADFEBEE........hACA.OHDAIHEFhACA.NDIE..,2,-36,-12,24
cBeVgNGDEIaMSAFUdKRXCPLHfZJYTQWbO,UFCEdEHAKCEECAEA.LEACHCGHZDAG..JCAEQAAC.OFFHhACA..cGBFhAAABGAHeBFC..hADAVFEH...gAGEDIGAECDE.IHHHhABAaGGAAEIF...hAEA...,1,-18,-37,19
JgcUOTSdWCeaMRLGFHXKIVEbDBYQfZNAP,JGEAUCBC.ODGDdFAC..eBEAMACALEDCHAFEKHCE.EEEBDBBEhAAA.BHDB.QCAAhABANIEBAFCD...hAAA.cBDFTFBFCGHAaBAH.....hACA......hADA...,2,-38,-19,19
gXJceSKAECUbGVfTIZaQdOFMWPNHBDRLY,EFFBUGGGGADA..TGDEaGCC.OBCCMBFG....NDICBCBChAAADEAALBHBhAAA.XDDGeHAGAAGACFAGhABAfFAGIDFAQDABWFBB.hABA......hACA...,1,-14,-40,26
KOXFEaHJbRgAVZYTWBcGNeIDdMQLUPSCf,VGFGTFDH..BEACGEAA.eDHFIBDEDGIDMCDG.LAEChAAASCCDCCAGfGFChABAKDFAFAABaAGEHDDChACAREDGAHAA..ZFBAcBBCdDHA.....hACA......hADA...,2,-25,4,29
QGbYALNMVaSIKTDHRJWePfOCBXEUcZFgd,MDEBVFEE...SGGHKCCFDAGG.RBFH.eEDFOCACBABGEAAHUADChAAAZEAC...dCAAQGAChAAAGBGEAFBC.LFFChACA.IHEH....hADA......hAEA...,1,-19,-34,15
YOUFIdXKEWNLQcSeCTDfMgaPbVJZRGHBA,ODACFGFCdBFHKGDB..EGCDLFAGQDGH.eACADACEMFIBhAAAaFEF..VAFCJCDFZBABhABAGCCB.BAAFhACAAICG.IGHG.......hAFA......hAGA...,1,-5,-42,37
VYWXbRdHMagJcTZBDEIUNPSOCLAfKFQGe,KAFBQBCBeDEC...VCABXACGREFBHGCEMIFA.JEFGZCGHhAAABDAGDBGAIGABhABA..NHABSGGEhAAALDEFAAFE.fFAF.FBAF.hACAWDDD....hABA...,2,-38,-5,33
KYUHEbPfBaecXJNZFCDgSRAQTdIOLVMGW,QFCAdGFCOCBHLHBAGDAHKAFAUAGEHBCE.EEGD..PADDhAAABHABeFHH.hABA.JEEANABHCHCDDDADRFEBAAAFIFCHhACAMAIF.....YDHHhADA.aGHH....hAFA...,1,2,-27,29
IVFTRCSYdZgLWKcAQeUbPfOMaBJGDEHNX,QDCHeDACUFAF.....bFCEfDGFaAEHBBHFDBBGEHGGHACAhAAA..IHAGhAAATFDHCDEDSBAGhABA.dHGFgBFAKAFCADAHMICANIABFBABhABA......hACA...,1,-15,-18,3
EBKfIgLbHRMaAPTWVZXGNCDQedUOJYcSF,TCBCVGFG..GBADDEDFdEFAUDFF..OCFCJEAF.SEHBhAAAEHCABDDDKADAIABDhADA.LHFAhAEA.HAFC.RGACAGHBPAHD...hAFA......hAGA...,1,-15,-33,18
DSTdZKRLFMAWBXQVOJEaGIfCgYHPUcNeb,XGGGVADG..JHBEEGEH.GCEB.CAGFHFAGUDGHeEFDhAAADAIFdCBAZCBCKACHLBADhABAAEFDBAACOCABaGAG.hACA.fHGF......hADA......hAGA...,1,-16,-24,8
ZdJBDbSaARPcCfITNKWXFMYQEOGVLUgHe,RAADCFDG...TADEKBFHFEAC..MDABECACGEEFUGFEHDFE.dFCGhAAABHDFSGBDhACAABAC.fDCBhADAIGAB..NIEB.WAHFXCDDOFDFLACChAAA.....hAFA...,1,-8,-32,24
VHSUeFdLCNBPXgQMGDJREbcIOfKaAZWYT,ZAADTCBCHDFE.eHCGLHFECHHF.BAFEXFCEQDEEhAAADFAARACC.EAED..IDDGhAAAfFGF.AHBAVECFhABA.SCAFdAHAgGADMBIH.hACAbFFCKBGB.aHAC..hADA...,1,-7,-8,1
fCIDaNPKbYLcSFEMVGURJQdTBHZeXWAgO,OGEACFDGDGHF...aCABKBAALAFEFGAE.MCCGGBDA.UAGAhAAAREACdDBBBEADeHEG.hABAXCGFAFGF.fEEFhAAAIHFE.NEIA....PABEhABAcDAAEHBA....hAEA...,1,-7,-51,44
BARefQcZaYWPLKCdVUTbOFNMgSDXJHIEG,RFDFeDACQAAEZGDE..aCFH..PCHFCFACdACGUBGC..hAAAbADHOFBDFHACMHFGhAAA.DCGH.HDAGIHHBhABABEEBAAFH.........hAEA.fFGBhAFA.WCEDKAGA,1,-6,-31,25
bWQYKHcRfTMLGNXIVPeAaBJdCSDUEZOFg,JCAFdEHADDGAZEFF.FFAE......bDCDQACG.KHBAhAAARBBAMFABLFDAXBGEhAAAVAFE..ABBGCDECEHDEhABA....OHFAYFHH.fABFhAEANBAE.IHBAhAFA.,2,-39,-28,11
PBIfUCTJKgVdaRcQSWAOEYZGNFXDLMbHe,EDCDZEBHFADHLBBEHFDDBGAGUFCF..CCAG.KABBdBHGRGFA...SGFDhAAAOBGB.GBEEhABADDDAMAFGeFAH.IHHGhACA..fEAE..hAAA......hABA...,1,-14,-37,23
DSJKcQUEYBeFTIPACOZHXVaGMLbdfNWRg,CEFAODACHEDB..aAFCGFCF.MBFAdDFB....NEBGRCCHSHGEhAAAKHGE.cCDAhABAEACCBHCEFACATGAChAFAAAAG.ZCFF.........hACA......hAGA...,2,-35,-14,21
bGBRCHeKYFEfIZWQXaSNOPTVJMULgDdcA,GGDHCDCFHFFGKGBEEADCZFBG..QAACaCEF.ODFEPAADhAAATEDCJCCHLAGFhACADAFGdBDDABIFBCHB.YFFChADA.........hACA......hADA.fEAC.,1,-5,-23,18
OSZDJAEWeXMCIYgNGUPbQFfLVBRacdHTK,eCCHCFEC...ICBCNCCC..UGFHQGBCLAHBBEFEhAAAaAEH.dACDHDFATGGGhABASDDCJAHHAFACEFDBhADAMFAB..gBEAPBAHFGBH.fBFBhAAA..hABA...,1,-13,-28,15
XPbSgRALJVZEYdNKQHGfIMOWCFTaecUDB,VFBGZDAGEDFE..dBHEKGCAHAABGADF.MCIHCDDEaBEG..eHAGhAAADIGEBFHF.XDEDhAAASFFG.ABBG.hABALFADNCAB.fGEFIHHH.WDAGhACA.....hACA...,1,-19,-28,9
ceRTabfFZKWJGDBNMPSQAdOUEgYVLHXIC,dGDDUAADEEAF..VECFHCCH.CGGF.RAGH.aGBDFGGG..KCADGADEhABABEGE.MIFGQBGAhAAAAFHC.OABA.hADA.LFAB.IDBA.eFEHhAFAbCED.....hAFA...,2,-26,-13,13
SEacUMTRLXCgJYPINBAWHfbeQDdGFKZOV,HAADeGEAdBECKEBHOADFEEEG..UBBCREEBCBHG...JBGF..IHHAhAAAAAEE..bGAAhAAADGDDZDAAaAGB.MCDHhACA...TEGC......hADA......hAFA...,1,-28,-32,4
DfKWQIceFNUGaPTSERbALdZVMXBJCgHOY,LDCHZBCFMCEABHEDCCEHHEFB.DAIBKFFC..QABA.hAAA.IDHFFEBBNBAA.hAAAaDAHSDHDhABA.EHACABACXEBD.OHAAfGDChAEAcFDF...hAFA...,1,-23,-43,20
RNXegHfBQdSPTUAWVIOFDCKJYbcZGLMaE,VAADFDCDDCBA..KBFA..JAAC....bFFFZBGFGEAAMICCRFCChADAeCDD..HBEHhAEAQGDESFHFhAFAPFHDAAGE.IAEH.CCED..LAHBhAAANEBE....hACA...,1,-11,-30,19
LadgOTQPUBKZERHIGMFcfACeSXDbVWJNY,SDABXAFBDFCF..VBBA..NEBA.LHBC.aEEGhAAAgEECOFDETCGHhABAPCBAKHFAEACCHAEAhACAMFHH.FHEAAAHACFHCWAHH...dBAGBHHBhADA.....hAAA...,1,-1,-30,29
ONEYPdAQLUTMcbJZRCaeHKSFgXIVBWGDf,QDCHLDCHUACGMBAD..JAHDCGGDeGBCHFEEFBAD..gAFDhAAA.IBBHhABAWBFDDGBDODHHhACA.EGEHPHFCACIHTBDF....hADA......hAEA...,1,-18,-34,16
FMTANeERUZXVPfHgJYBIaSdCLQbcGODKW,EDCDUBBHZEGB..VEFAHADC.JBADBCHC..aBHFCFAELAEDhAAA..cGABhAAAOHAADAGCFGDAAFECeHCAhABA..XDAAPDDAfGCFhACA..IAGGhABA...,1,-6,-43,37
FNAZLEWUaSefJCGbRdOYcVMIXgDBTHKPQ,ZDEDEDCDUAFASECH..eEFCCHFGGAAFdGGFOCBA..hAAAVAFEMBAA.XEAGhABADCDEBGHHKHDEFEACABIFaEEBhACAfDHA.......hADA......hAEA...,2,-30,-22,8
CRJMOAVWTKXeQaIUbGDgLdHNZYfcBSPFE,TFDHKGDDQFGH.UDAFDDBFdGGDHACHZDEC...fACDhAAASGBDEAFARBFAMDFDhAAAACFC..WCCHhABAaEGAIBAF.......hAEA......hAFA...,2,-41,-15,26
FMVPEACTbSHQKYfWXBecLgUZNRdGOaJID,TGGGSCFC.QEEAKEAC..fACBBBBDLAEGhAAAUDFHREDBOHFAhABAIBBAMAIF.PDBChACACFBAbAFC.HFAA..YHAEWDHDeADDhAFA......hAGA...,2,-21,-11,10
YGFZAEDKXBPLefgISaJQUdOTCRHWMcNbV,KGCDBHHGeFGD..fEHASECCQEDBOBGFRACEHBAEhAAAMCFE...NAEF.YAFAhAAA.ZCAEAABEEGDGhBAADBBEPEAF.IHEHaDFB..hABA......hACA...,1,-14,-31,17
SBWROfTMQPAbgFECLGKNXZIVYdDJUeaHc,FHBGLCAFKBCAZFGHVEDB..DEFCUGGGHEAEBAAB..OEEHhAAAMIAEAAHG..ECGAGBEDhACA..NDIE.XCBEhADAdAGFeABC.aDDG.....SBADhABAfGAF.hAFA...,1,-24,-26,2
OBNCSJYVcQgWZHIEaKXeMGDdTLRFfAbPU,UCBCOAFBCCHB...SDCA.JABAVFBB.QADEhAAAZDFGEGHDKHFAeAGFDAAFLEAFhAEAFHGAAIAGBFED.hAGA..NCAC.cBGD.HGCAaEEA...hABA......hACA...,2,-31,-13,18
OWBGSJcULbRaIeYFNDCTKAdZPVQMXfEgH,dCFCZGFGQEBBMABE.EBHFHBGF.BHHGGAEGSDCGhAAAUAADRGBCaEGGIBCHhAFA.eGAENDABCAGGAAEBXFGEhAGA.OFFH.WHAG...hABA......hADA...,1,-12,-14,2
KHEbTJOfXAgCIGdMQaLcRZYSDNUWFVBPe,CFDGdGAH.MABHaFFCLAFEZAEA..DEGGUCBFFCDHBDFCKAADHGBAhABA..EFHD.JDBBOBFChACA.XEAChADAAGGD.IHFF......hAEA......hBCA...,1,-25,-51,26
TMWILQYNSEKJHaPUFXRedDBbfGgAOVcCZ,OFBBCFDDZAFA..MCGFLDGD.QBEFSDBDJHFEaGHFhAAAFAHF..RGAA.dHCDBBBBhABAGCCEAEAD.TBAEhAAA..WFEHIFECEDCA.KAEC..hABA......hACA...,1,-16,-36,20
ZKGXFcCLaJATIQVMWESYPeOdbRHgUfBND,TCGCVEFH..EDDESEBC.eADDdACDRCFGUEGDBDAADICGhAAAKAGGFABHLFABhAAA.AGAHMICGWCFFOGBChACAHECF..fBBENAEB...hBAA......hBEA...,2,-25,-15,10
MBGOZXdLbEVCRcJTKgAFaeQNDPISfYWUH,FEEDaGDD.eBDHDECH...SEAB..WBCAHCGHBHAAhAAAOFHDdGFHLDFAhABAEAGHCACGRBAEJFCFTCAG.hAAAKBGCAGAD...NACF.fGFFMFFA..hABA......hADA...,1,-18,-30,12
EMBSXVPGfbCZTgRJFAWYUNDaeQLHIOcKd,UCBCDGHHQABGLCFFOAABdCGHBGBH..SGEAhABA..PEFBGCGChACAfAFACGDCTGAGgAEChADAJDADAIFA.NIDFaEACIAHH.hAEAEECBMAIFXCDChAAA...,1,3,-41,44
NdMYFWaLBOJbXZVSPDTCKGAfRgHIecEUQ,RAADHAADeAEGUGCH.dBEFMGEAFGGDLEFEBGAFOEHF..JDCFhAAAXCFBZAGB.SDCEhAAADFAHCADCAHFB.fEBFhACA.IHEAECCE...hACA......hAFA...,2,-25,-22,3
RQLXdEaGFWNDKCcMPAYZfJOBHSeUTVbIg,ZAADJEEGBHDFeBEAUGFH....TEBAVCCF....IGDAhAAARAFALDAEEEAH.hADAaGGGFCGDDACG.CAAH.MDIDhAEAACBC..OCHFSFBHQGAGhAAA......hAFA...,1,-18,-36,18
fZALRObBUacTJVWKQHSICDgeGEPFdNXMY,OFFCUGGG..aEGETAAF..JFDDKGACHBFACDCG.DEAGGAEEhAAAFCAG.dHFB.MCHFhACAZABALFBBBDAH.hADA.cCCA..WDCEIAHEEHEA.hAAA......hACA...,1,-21,-29,8
FfgXOLPBeICRJWVYSHdZNaTMDKbEAGUQc,UCBHFGFC..XABELBFABBHACGHCRGAA...JDDD..VEDDhAAASFAA.dAFHhAAAaBAAMIEE.KCACAAGA.hABAQEGEfHFBgGCA.hACAeCEE....hABA...,2,-35,-27,8
YBUNKLJAEeOIbaWHScZFDRPGgVdXQCMfT,eFFBOGEA..aCFDSFBGZEAD.DIGAPCCCGDCBdCHAXACGhAAACACC.TAFHhABABAEBKFCALCFAhADAABACIHHH..WEHBFHDE.....hAAA......hABA...,2,-32,-17,15
VgSWDZcfQTYMNLIABRJFGeXCKOabEdUHP,BEFARDEDGEGGeAGHCGDA.OBCG..EBCAdCAHUDACHGBG..VAGFhAAAgDDF.hABASFACDIEE.hACAfHGHQGAFMAIF.IAAEhACAACEF.XEGHhADAaAEF...,2,-24,-18,6
CBKQEGPNRJXgIfLbZUdFaHDecWATMSYOV,MBDHOCCHBHACKCGDGEGCREDH..JBFH..IFAHLCHHhAAAUABHFGGDDEAF..hABA.eABHAAAFSBEHhACACHDD.EHCCNADB.fHAFdEBE..hAEA.aAHF.cECDhAFA.WFFF.,2,-27,-20,7
MdTCJDKZNfRGbWFHEcSUBaPXgVLAQeIYO,QDACeGEAODEHMFHHdDCA...TECEDAFBKAGEZAAERABG.GCDFhAAAFCGCHEABSFFBhABABHHF.XAGBhACA.gGBDAFIFCDAC.fAEAhAEA.EHEE....hBGA...,1,-3,-30,27
DeMRTdZKgEPSJLHCbXYQFcIWfUaBVGAON,OFCHDEFHMBIDRBEDZDBC..EFCC..SGHHLDDCCHCC..hAAAXBGEFFHH.IHABhAAAfAFG.hABAUABCBBCCABDCeHDAKGFBPDGDJEAB...hAEA......hAGA...,1,-26,-27,1
dXbDZgEWMSIFeQLNcYfVBTKUaCJHOGARP,RDAGXGBCDIFGZABC...EDECMHFE..IHGEeFDGLAHFhAAA..NCDHcDGBhAAAfDGE.BGAFhACATABBKCCGCGCEOFFEAAFB.dDAD....hABA......hADA...,1,-26,-29,3
MAWYSCIcgOKHEUXQBFeTZbdPGaLfVRNDJ,SHBGCFDG..IHBDOEFHECCEQAADFCGG.eBDFhAAAbEBC.GCGELABGhAAAVDAHREGBJAFGAGFD..hACAYAGD.KGGD......hACA......hADA...,1,-15,-24,9
MPLZWCdfcaTQFABIVbGKSUeENHgJOXRDY,VDBHKGAHUGGD..EEFEHDBF.ODABXAAFDBBG..MEEHhAAALAEE.CHDAdGGDhADAfDGAaCHH..hABA............hACA......hADA...,1,-32,-42,10
MCfUEZKPOJHDWGQgdeVTNRcFbLAXBYSIa,BHHGSHBGaDAD.CCBD.UFDBZDGH..KBEBJBCCHDCC.GFADhAAAdGBEeAAH..NIEFRABE.hAAAFAHDLDEE.hABAADDHIAGDfFFC.OAEADGGC..hADA......hBAA...,2,-37,-8,29
AdURYaCDTeSKOPEWZgMNbHcLBQXFIGVJf,RBCFCFEDDECHeDGD..KAGFEAEC.ZGCG..MDACHBFGBBHAFEACVAAFhAAA..ADEAdDGEUGGF.hAAAaEEBOACA..hABA.....gGGA.NHAD.hAHA......hAIA...,1,-7,-57,50
ATMZbUaecWGKJPFCOdDIYNEQLXBgRSHfV,TFCAMECGUGED..aBDDeBHBGDABKCCG.FBFDdFDFDFFB...hAAAIGGDNBBA.LCHFhAAABHAESADBhABAfHBDADHBZAFBcACG.....hACA......hAFA...,1,-16,-30,14
CHOADXcBZWFedVYLRTKfSaIgbGNPJEQUM,DAFBBHHGFHACdBFELCGHKFFE..SEECaBAD..IGHBhAAAGCBAJBAB.QGAHhAAAMGDECDEDHDBBhABAAAFE.XACC..cABA.WEHBhADA.eHDE..hAEA...,1,-29,-35,6
NbZaDAfJMGdFOEHQWLeXBKCTUSRgPIVYc,MDEBFDAFHCGBLCCDBCEEKAGACHAA..SBACRFBF..gFFGhAAAVGFA..hABANDAAZBEFDACHAFEDGBGEhAAAECDB.QGCG......hABA......hACA...,1,-13,-35,22
CYFOefBgAWcSKHaZdDNbJVXLRIPEUMTQG,SHBGKEHBHCDAaGFHdBCC.DEFG..JADALDHHRGAG.IBFDhAAAUAAFMAIF.QDBGhABAGEBBCCAFYHFEhABA.FAHDfDGCAFAF..hAGAWAEFcGGF..hAHA...,1,-20,-27,7
WIHagZVJcBFDMNAbEYCTfSKPdUQeXLOGR,EHBGTGGGKECE..UBDGeDAE.LHCEGFEBRAAFHBFHZAGH.cEGBhAAADDAB..AAIFCEHHfACGhABA.SEAFhADAdCFA.OFBBaEAD.gEDAhAEABHEG.....hAAA...,2,-27,9,36
INXOCKTacQLMHFZBgAPeYEDbJVUdSfGWR,eGEAEHFGDHBG..JCCCUCBHdAACGDBG..RCGBXECChAAACHBD.KAFFaAGC.LDADhACA.MEFG.hABA.FABEBHDDAGAE.bEEGfGGBIHHCNBBFhADA......hAEA...,1,-19,-39,20
QNJUebfYaCgDEXTSHMRIZBOAFGVKLdWcP,FGFHVCCHdADE......PGACNCCG.eAFD..fDFGhAAACFHCDAAC.EDHBSHEEhADAMBAA.IFFChAEAZGBAAHABKAGAWBBCcGGAQAGEhAGA......hBAA...,1,-32,-34,2
aBHDKegcWYJOLIRfTXdCMFSVAZNUEGQbP,UFDHGBDBQCDHaAABDEDF.KFAE..eEHH....gCABhAAAWDAB.OAGHhABALFFFRABEfEHChADAXCCGCHBBMIDC......hAEA.FHAGABCEEAHBBGHA.hACA...,1,-9,-33,24
cKHPdNRLSXWgefCJQBVZTUIOYGEFDMAab,aHBGKHBGdDDCLABC..XAGDeDDACGECBHGHZAACUDGG..hABAIAGAOCEDEGGAhACADDCBAIEEHDABRCGH.SAEAhADAfBCE........hAAA......hAFA...,2,-38,-16,22
NJSeRHMUZFOEPATVQLICYXgKdGcDbaWBf,VCDBQDAC.LAEGCCAG.XFFCKHDCdGAGDAFG..hAAAbDEABBAB.JCHDSBBChAAAHDBB.ZFCBhABAEHGEADCETGAC.IHHAgAEGhABAaCGA.fHBBhACA.NGEH..,2,-37,-2,35
VOWcUAIBLRJfYKCgGETQMFSaPZNeXHDbd,BAFBJFFC.KBCHCDCH.GEDE..EDFAMDFCFFAB....SAABhACAPHAA.ZCDDXGGEhAAADIBC.dEBGOCHDhADAUBAEAIFGLBDEfFFB...hAEA......hAFA...,1,-26,-39,13
NSFegULOXHQMfaAJcTKIWGCZVPDYBRbEd,JDACKGFCGEBBZAFA.DGCFBBAG.REDH.EBGH.dDADFGGA..eACGhAAAUCFCLEHHHGAE.hAAAMAFGAHFC...IHDEhABACCCB.........hABA......hACA...,2,-41,-24,17
FHZAdVGXbLEYUegfPCNcOBDMITSQWaRJK,dGFHGBDFLBADEFEGeAAA..PBDDCHEFODBCBFDC.MCIFhAAASEAG.aGABhAAAJAFEKDGFZFABAGHHXGBEhABAYCGB..fGCEDBIH...hAEA......hAFA...,2,-25,-19,6
ITZNAcCQXVJaOBKeUDRGHPESFLWgMdYfb,QGGGVADG.aEGCKEEC.DDHFHEAH.SDFFLCAEMHAGhAAAfHDF.hABAbBDBIFDCZCCFAIBGXAGEhAAA.BDHEUAGA.PDACEABF.hABAFGGFdDAFNDIE..CABA..hADA...,1,6,-21,27
fZEXGYIUadTJKAFVPRSWebNDMLcHBgOCQ,FCFCVGFGRFFB...eABCDBDDLFBFHBGBBCCE.OEEECEDDZABD.GFBBhAAA..IHEGhAAAaCEF...dAEFhABAKDBAAHIF.SGAG.NBAEMIACgEGBhAHA.EAHF..hBAA...,2,-35,-1,34
OBRTDdfPKeNVZagCGAYLbMUcEJSFXIWHQ,LGEAUFDBEBHD.FBBG...XFBBIBACQDEBhAAABHHADBGBdEHGKHCAeAGDZFBH.hAAA.CDCFAAFCMEAC..hABAJBEDSFGC..ODABfADBhACA.NAIAaFAH.hABA...,1,-5,-36,31
HPLcGDNIVdWFZMYgQaCUfbEeTXSOAJBRK,JFCAKBBDLDHFGBDD.DEBG..VBAHFFAGZFCE..MHDAQADHhAAACGACUGGEEDEB.hABA.TCDD..hACAOAAAABIFBDFAPCHD...IHBEhAEAdHBD....hAFA...,2,-27,-26,1
cLIWdABUeNVPDXKCfaETSZQHOYGMJFRgb,UEBEeFBB...VBBEDFEGCDFB...aCAGSFHDZBDD.OAEAhAAAGAGE.FABGbEEFhABAIDBE.AHFHBHHEhAAANAIEKGDH...fFCBEHBE..hAEA......hAFA...,1,-25,-36,11
OQRJagVeAcGfZHKMNBXPbFWCUDdTELSIY,GAFEZGFGHAFEKEBEBABE..XBCGFCCACADAUDAHDAADdFGF.EFEDhABASHAA.hACAODEFRFAHaDABeHEAhADAAHDA.fDDBMDGF.NAIE.....hAEA......hAFA...,1,-12,-33,21
ZdUNAfYCeaXEHVbPGQDTLJIgKcBFMORWS,CFDGaAADHAFA..VBEGGDCB.DHGCJEEAKACGBCHHFFAD..OCHFhAAARDADZCCF..dHADAEHD.eHEEhAAA..bCAC..hABA.PHCE........hACA......hAEA...,1,-23,-32,9
EKMCHYWdfQcJLOVBSXaeUZFgRbPANDTIG,DAFBTFGHGGBD.KFEGMBFHHDFEdCGAQDBBJDCB.OAHFhAAASEEG.XDAFhAAAaHGGeADBUABFhACAFEAHbBACAAGGIHBD.CGDE.....hAEA......hAFA...,1,-1,-27,26
SYBeMEgGRJNWTVHPIdaXAZFQKfLbDOCUc,QCCBLCCHOGEACHHF.UBFDSFCCBABA.EEGARGBE.JADChAAA....NAEH.TFEBhABA..PDADhAAAIHCCaHFCABIFFBHFKDGDDBBB.YCAFhACAeADBMEIF....hABA...,1,-15,-24,9
YgWRQFDULcKZfOdXeMbaANISCVPTHBGEJ,SHBGVDBH.HBDHECAA...gEGAQDGADCCDUGDChAAAKGEGZCAFdAEEXBGGhABAMDFAAHAF.CGHHBACAhACA.....YGAA...hAAA.FBGEcEFHOABGhAFA.eAFC.,1,-8,-15,7
LRfQDKSIXOTUCHNBYMdbaEGeFWcPgJVZA,LFBBQFDHDDCEKFAF..SAACODACCBHEBBBBdFDAEBGF.hAAAGCECeFFEFCFEPBBGhADAJADG..ACAF.fHFHhAEAXGBD.........hABA......hACA...,1,-20,-33,13
aLMEUHBVAFGCZTdWQDJPgbecOIRXSNYfK,FGACGCCFCAFE.dEHCDEFGJHBE.......bFFDeCAD.IFDAhAAAXEABSCCChABA..fAGGhAAALFHBMIBAEACGBAHEAGGDZCEETBAHhABAPABC....hAEA...,2,-39,-20,19
AXYaOHCRKPgWVZfSbQJFdUTeILNGBEcMD,aGFCOFCAHDAFRCCC.KCDG.....PAACVAFGSCHHhAAA.QGDFhABAFAEEUDGCeDCBNCBG.BHBGhAAAEADCDIGEAAHBCEEE.........hADA......hAEA...,2,-26,-21,5
bUEGLYSDTaZCVXdBFQcPIKReMgNHOfJAW,UCBCEHAEGECELCFCDBEAZEEACEHD..dGHGQDAG..hAAAIEEFeCFENACDOCBGhABAJHBGAFAA....hAHA.WEHHSADBTGEF.aABC.BGFGhAAA.cGAB.KAGEhACAMDDE.,2,-32,-12,20
XdfUGKeVZMCIBWFROgQTSJbPaYcNDEHLA,dGFCUFGHGEBCeCDDZGAACCDCBEDD..FCGCOEABQABB.hAAA.SACChABA.JBHHbAFC.YCAHhAAADBECHEGDAHHBKDFDMBBF......hAFA......hAGA...,2,-28,-20,8
HeaYXWATLQNgfMcSZBUFVRIOdKPEGbDCJ,TDCHLDAC.QEAH..fEBGSBGABBGFhAAAVGDEOGDAKBCEECEFhAAADIEECGGEHDFEYBCChABAAHAGNABF.gGAB.MFFC...hAGA......hAHA...,2,-25,-13,12
KWROdGVLBNIQXACFDEcfJMZSabYTgeUHP,CFEAEGCD..JBADSBEH..aFAFTBCHUDGE.HEFFKEDE.hAAAOAGDGGEFBCBGhAAA.IHHEACEGFGCFDIAAhABAMEAA.ZFAB.YFEFeBEE.WACChABAdDCC.NCIE.....hAGA...,2,-31,-12,19
RXUGIWBMQDZOCLTYVKAJcdafPeEgbHSNF,dDCDaHBG.eBDE.EEFCHCCC.FFGAUAAHIAEHBAHCDICG.ZFADhABACFFDLBAB.hADATBGBKCGGJFHB..hAEA.....cFDF....hAFA......hAGA...,1,-31,-34,3
TIGZHaRXbPCJcMEBSDAVWNeOLKFdQYfUg,VAADeGEALCCG.dEFBfDEBUBGG..TFAGhAAAIGBB.GECBhAAAaDAC.XADECBBFMABAEGCHhAFASGGFABDD.WEHBNEIAFECEYEAEhACA.gGDAhADA.ZAGF,1,0,-14,14
JbdPGBOMVIXDNTRaHYEWFACUeQKLZfcSg,UEBEQAADZCDB.SGEEJCHH.dADCBBHBMFAA.XAGDhAAADFFGRAACHGCC..hAAAEEEE.FCADCHABKADCcGAChACA...PEHB.....hABA......hAGA...,2,-42,-8,34
FBDWXfcSHUIdPRJGZOgMYbeTENLKaQVAC,FBEEBAEDDDAC..XDCD..SEADHGFEdBBGPCHBhAAARDCGGCGC.OFFFhAAAMGBCeHBAEHBG.KEEC.hABAaFABABBDCAHA...cGDF...IHHAhACA.gACAhADA,1,-25,-34,9
fbDeTOFUaPWYgXIMLHNdRJBAQGcESKVCZ,QFGHEGAHKCCC.ZBCGDEGCOEBHFGFD.UGDH..aEBE..hAAAPAHF..gCAGhABAIEFGMBAHhAAANFEFRAFD.AEED..........hACA.SHBAhADACAGC...,1,-23,-42,19
gNRbdcDMeUSLOYHZQfCVXTAJEBaIPWKFG,BDGFaHBG...IGHCKDAEFHEAGBCH.RDEG.bBACDICEUEAAhAAALAGHHCDFfFDGhABACFBE.XFFBhACAAHIHJAAEEFGA..WCFC.dAFF.MIDAhADASEAD..hAAA...,1,-8,-30,22
cMETWNUYgLRDFOfCKXbIGAVQSZJedBHaP,SDAFeFFCBHBHHDCD..aFGFMEBHTBGBUACGLBAGhAAARAFHDEGG.FEBACHGEKBABXDGEhABA.GEDEhACAAFAH.QGACJHDA.PCDC..hADA......hAEA...,1,-6,-29,23
XgYfbHOCdLKEWVUZaJAQIRNPBGeMFTSDc,REFHBFDGMACCSADB.DAADXGAB..fDEEhABAOBDFLBAFhAAAKFGGVAFGaAFEACCE.IHCBhABANHDFGCAEeDEH.cCBA...bBFAhAGACCHAWFAD...hAIA...,1,-19,-26,7
HZaOPGYdAVBXEbWNRUMKSCfIeJQDTFcgL,BADCEGFC....NEBH.RBAGKFAG.SFGHIHCG..JAECDGFDhAAA.FCEFLACFhAAAHAFAOHAAPFCEdDGBAIAGVCFAhABA..WDDDMIEC.CBDG....hABA......hACA...,2,-35,-18,17
DXZSGacBFPIMVUJbCQKOAgYfWTHdREeNL,...fHBHHEFHREAHEAFELEHFZCECaCAABHCGIFAF.VDBGhAAAJABC..CFCHKFHHgBAHhABA.TGEEhACAdEECNAIE.DBHD.SAEH.FEFF.hAAAMAIF....hADA...,2,-19,-13,6
ObZdEYSacPgFTRGBCAfIDeQLVKMXHWJNU,DACBeFCALFEGMEIHHFAF..JAFEUBDDOHDAdDABEGFD..hAAASCHDaAGD.hABA.gABFhAEATCDEGDBEAHHBfHDBIADFKDFANAAE...hABA......hAFA...,2,-36,3,39
DdZcaGeEgMPVWTNYHFJbCXfOALKRBSQUI,LDCHBCAHSFFFQAGAUECDDDHDdHGHZAACGAEB.eDHFhAAAMBFD.VDAFTCCFhABAHGFAFGDHCEEGXGCEhABAAHACKABG..IEAF....hADA......hAEA...,1,-11,-19,8
BMSLYfOgGeRZDHWXCPNcEUJaATdbQFVIK,dGFCFGFCKHDAMIBGLAHD..OBBBeFCAZDDEDHAGHBFE.hAAAXECGPAEDEBBAhABAaGHDADDB..QDAFhACAIADGBFAHSGBDgDGF.hADAWAFE...NAAA.hABA...,2,-32,-10,22
JQAdICKDYRSVTONUGHbcLfWBMgXeZFPEa,CFEDKHFGDCDGRBFA....SBACOGEEUDAGHDAC.LGBAhAAABAEA.XDGDFBHD.hAAAaBDHAEIBdDFE..IAFHhABATABH.NDFE...bGAEfGGDhACA.MIBE..hADA...,2,-44,-18,26
ebPGSWRLTDKJOdcQMYZfFCVEAXIBNUaHg,BHHGaGFCHDAFeDDGGAGGRABALFAHKCEFdCCG..QECGhAAAMADC.ZFFAFABCCBAGAIFEXEGAhAAAUAEE..bCFASGBAhAIA.DGEFOHCA.fAHAhABA...hBAA...,1,-5,-17,12
YOMHbJFVACZEPQDScXeTIGNBdLRWfaKgU,EBBDQAFBDDAB.SEDAeDFDGACFdECCLGFERGEG.hAAAaGDDUGCEOHFCbBGHFGADhABACCDCZABE..XDCEhACATGACBDHH.KDADMFIF...hAAA......hABA...,1,-4,-12,8
GQdHJZPXDFUcMKABaLYNgRSIOEWTebfVC,LCAF..YFFGRFCDSGGCOBEHEHAE..eGBAhAAAVDEEQBGGhABAHCBGJAAEZBEAPACBDIEAFAGEhAAAUEAC.KHEAAHHD.aEFG.NADF......hAEA......hAFA...,1,-4,-9,5
ECTgHbfDFORBYWdZIaMcXUQVJNGKALPeS,LEEGSDCDTBFDHAACDFBB.RBDEBDDAdADAaDBG..MEFEhAAAXAACUGDGQGGFhABAJGEGKFAHAHIB.EHBCCCHH.hABA...fDEBYAHDIAFFhADA.NEAE.eAFE.hAEA...,2,-15,-14,1
UFYSWOGECDIgXdMRePNHJQVKaAcbLTZfB,LGEAZEFHBCEHFABDSCHHGAEF.DGID....XFAHhAAAMFBCRAFCeBBDHECEJHCEhABAQGABaDBG.cADHhAAATCGA..fEEB.WDDEhABA.....hADA...,1,-15,-21,6
XOYPMRWFUEgQIcCLfZSJGNbDVedAKaTBH,aFAATGDCBCDH.HAEDODFF..MFHBFBABEEDGQABDhAAA.CFEDLAHHhABAZFBHGBDFDFIHeAFEKGCHXGADhADARFGF.WFFHIDBG..SCCDhAEA.NEEF.hAGA...,2,-16,-13,3
aHDIALFUSeZJOYdNMTRKCbgcXPVQGfEWB,FAADUGGDeAFDOHCAdHEF...MBEARCBFKAHB..CAAB.....hACAgEFHPDEAGEAAhADAEHAABFDEDAEAACDBSDEBhAAAZECA..NAIE......hACA......hADA...,2,-34,-23,11
YDJabAfcRWELSQUKNdgGMXFVPZIHeCBTO,RAADLCCHQDFFKGDHdGFGGGABFCHDZBAHeFGH.BEDH.TEADhAAAOAGH.DFBB..hAAA.aAEHfAGFhACA.ECDFNCAEMFEEXADA..IGHEhABA.CAHC...hACA...,1,-3,-33,30
eGHTdULfMBRNEXDQgISWOZFVCbaJKYPAc,GECFdDAFLDEABAHGRGAAEGDBDCBG..QECH.SGFBhAAAOFHDFAEAbABCKBEFhAAA.AICAeDGBUAFGMFFGhACA..gDACIHBH....hABA......hACA...,2,-34,-9,25
BKgfcIYRMDJTSPNCbWEQZHULOGVeaXAFd,FEHBdEHAKGAA....fBACIAADRGDAMGAC..JDBHTAEBhAAA..SEDHhACANDCHCGFE.EBCDQDADhABA........hACA......hADA...,1,-39,-48,9
LeRZGVUPCOAIYKMNbXfBcaHSFWDdTEJQg,KHBGMCCA..XDCBBAGCaFBF..FGGEDIDCdBCB.EEAAJAAEQEFChAAALDHHeEADhAAARFAC.ZGEA.GDBFhAEA............hAFA......hAIA...,2,-33,-26,7
YdeJGgURZNAEICWfDQPMOVbKLFcXBTHSa,CFEDDACB.MDCEODHB.KFAHFCGD.BGABHCBA..SADGhAAAaGGE.eGFEGAFGhAAARGCAAIAG.IABB.hABAfEEBQECG......hAEA......hAFA...,1,-30,-38,8
IDLEebYCBSNcJXfgHMAWZUadVQOPGFRTK,UFDHaEHB.dGACQABDGDAB.FEEBRADCKGGCLCEG.EEBBeBAGhAAACBHEBGHA.SHAAhAAANBHE.XAEEhABA..........hADA......hAEA...,2,-38,-26,12
RIUSMAfXOTCPLHeQdcVKbEgFDWJYBaZNG,XDACTGDE.LDCBQFFA.dBHCVABGEGAA.DCFCJCCGBAGBhAAAZAFDREBEUGGG.AEFGCEHGhABAeAAB.KACDbGBG.hABA....WCFANEEF.....SFFDhAEAMFIHODABhADA...,2,-19,-3,16
QOXfYAGDZKFcNJbPTgWIHEMBaUSCLeRdV,DDGBZFEEFCBG..JEHH..TGBE..IBEHMACEUDEAhAAACEACLAACdBFF.OCCHhAEA..YHDGhABAAGGDKCGE..NIED......gFDGhAFAEEBA.aHAA.hAGASDDB.,2,-40,-27,13
ZgdKfRDIQMCLBHaTWcAPXSUGeEVOJYNbF,SGFCUDACEFHF.OFAB..JDEE..bADGFGCD.dAADKHBChAAADGBDMFEHBHEATCBBhABAACEH.GDEF.hABAYCFCgAGHfHFFQAEBhADACABA......hAFA...,1,-4,-41,37
