MPVNADKIOBZWaEfLeCdTUcQbXGHSRJYgF,DGAGODECZAFC..EHDCeABC.CCDE.dCBFUFBFQCEHGAEBHGFGhAAARECE..JHFGFCCHMAAAhAEANICF..AHAFKBADIFGFhAGABCHA..fFFH...hAHA......hAIA...,2,-30,-11,19
WGMSEUCcdBfObRNDVPgeFHQaTKLIAXYJZ,JCBFGEFA.SFDHUGFCdEFBBGAG..fGADhAAARACD.VAECeFAGFCDBaHCAhAAALFHH.ACBEXDBDhABAZAECEEDDOFHDDICE..PCABhACA...QCGAhADA.,2,-29,-5,24
AZERHOTKGdVJBWgPLDNeYXQUfSMcabFCI,EDDHOFHFGGEDdDDEBGDF..PAAHDCEA.eBFGQAAAhAAASDHDMFFDaAEBFAHBhADACAHCACCHREAH.HGAG.TDAGhABA.JFDEWADA.....gCGAhAEA..hAFA...,1,6,-36,42
RZVFPXESaOLHINMWKAJgUCGfDbQcTdBeY,UEFAGAEFDFDHQABE.dHEFBDADRDFGZEAEFBCFECDCSGAChAAAaFGC.HAFANAAGKFDGhABAACHDCBAG.....hAEAbFDHeHAE..PHFA...XCEGhABAIDBFWCHHhACA...,2,-40,3,43
ZLRCPXANBMcbOSDTHFfJIaQWGdKeYEgUV,BABFMEGF.OHEGDIAAHCCAFAGD...IEACaDGF..GDBAhAAAeFBCEADCUEDCLAGDhAAACDADAFFC...cABGhABATBCBJEHD.dEEE.KHCCYFAFhADA......hAEA...,2,-36,-3,33
cbYRJEfegUIWBCPNFTVDSZdXGMLaAOHQK,OCBBQACFKBGA.....bFECJDDHEBGBeCEBUFBABDHBCGHAFDABhAAADIGE...dGAFXCEChABALABAADDB..hAAAcDGEfGDGIAHF..WGFEhACANICD.SAFFhADA.MIACaGAH,2,-29,-4,25
DNEgXYfZHLUAIMaJBVPOecTbSdQCKWRGF,aGFBJBACBGDG..VAFF..OCFBeCBE...TGAFhAAASHAGdDBFKEGDGDAChAAADCAH.EGHF.YFDBhABAHAFG.AAEHIACDMFIHPHEE.bEBEhABAWDFA....hAFA...,2,-28,-21,7
gfDcdYIVGeBCPNTXJOQaFRLEMUWAHbZKS,HDBCKDAF.SGADDFIFdAGF...VFFBeGDGCBBG...TDDBhAAAJCFBOAFGFCGFEACFMCHFhAAA.ABDFZFBC..hABAfFFD..cADAIFBHhABABBHENICFaCDA...hACA...,1,-18,-30,12
NWIBZgJMeRYbfEKGLcadPCQDSTXOVAUHF,FHEE..IAFFZDADJBCG.eAHB.RDCD.....fCGHhAAAEGGEGADELFEAhABAdDAACHDDSAAChADAOHBAAHAHHDDGWCHDBGEGYAECKCFHaBBFDDAH..hAIA......hBDA...,2,-21,-15,6
ZJILDVKgYcHEebGCNXAdBMfTRQFaPSOWU,MFBATDEEFGBA..SGADUAFHZGFCLAAAKEHF..YCCEhAAAHCACEEEEGCAGhABAXEGHAACFBGCD.hABAfGGGaEAB.PBHFODEAJADCDBIHhACAcGDF.CEDD.NIAF.hAEA...,2,-9,-7,2
LFKRBHTQMbGNgYSCDcAdJOUWfEPVXeIZa,OCHDUCGEEHGE..XFBFeFDCZCBAFGGHBAFHHBCG...TAFFhAAAMEAG.GDEGhABANBAF.gCBGhACACFHH..AIACdFCGJFAFfACHIFAG.KHCGhAFA......hAHA...,1,-3,-31,28
eAHEGQRfWYSXKPDUMbdZJFIgBVcLaTNOC,GEECQCDDRGAE....fBCGSACBKEDFUFGBMABBhAAAdAGEFCGAIDHEhAAABCEDLEHDNEBC.CBEBAAFEhACAEFCGXDAGDICGJABH.......hAEA......hAFA...,1,-12,-25,13
BMWHLcOdXCeQNZbJaTEVfDSgGPFURAKYI,KFABBAECHDFAOCFBdHCHCADA..QCBAZBBF.aHEAVFGDDCHFGFBHhAAAFEEH.ABAEMDADhABALCFE.eAFGhAAANCIA.JBAFEGGE.fHAD.SDDBhACA...hABA...,2,-18,-12,6
UEgdRAFfGPVbSMJcXWBDKIaTHCYLZQeNO,FGEEGAAD..VBDHbCDC...MFFEJGCA....XGADhAAADABAIBHCaDACTAFDhABACCBCLFAFZEEA.QGBAhAAANEIGECHF........hAEA......hAFA...,2,-39,-2,37
gCGeBONIREVaJfQYDHFMWcLXPdKSAbTUZ,TDDCZDGDGEBA.OBDERACGEGBA..JHFEQEDB.DABBhAAAFEHBMADALFAFhAAAdAHCSGFDACFCbDFFCBAGeCCFhABABDBC.NCAEaGHDfBGB..WDDEhACA.....hACA...,2,-17,-6,11
ISMYfBFePOaAEWRQCcTGKDHJULZgXdbNV,EECERDAGCEGD.GAFAHFDHLAFHZGFGdCCH..VFAESACE.hAAAMAIDfFFHhABABCDCFFBHeABFaAAHAHDFWAHBhADAQGGE.KBBC.DAHDgADChBAA.....hABA...,1,0,-15,15
TOdBCAcQRFWSVUHLDZeGaKIfMJgXbYEPN,RFDFFFCD..SGHHHCDBDICAeABEGEBCKGGBMABD..JAGHgBEGhAAA.bDDGhACAEEAC.TBBHBHFACAGFhADAAEHGQGEA.WAADLBHFhAEAZAEFaAHFfFFBhAFA...,2,-14,-8,6
NIbRYCHOFWgPaQMUJXTLZdecEfBAKSDVG,KEBGSBCHDBBCGBED..IGGHRDDCHEGHFGAC..WAHHhAAAaHDA...UFBHTCADhAAALECC.dAFHhABAeAECfABABFFGAIHA.NEAACGEA...gBEGhADAMABA..hAEA.XEGEECCE,1,-8,-9,1
YCNEOKHTcZUdBDRQWeXAgaGFJISPVLbfM,aDDEFGAE..JDDC..SGBFLHDG.MCBCCAFF...NDGE.KBBGhAAAHAEGZBECBDAFDEIHQDAFhAAA..hABAXAGEAFCGIHEGPFFCfCHChACA.EACAOEACcFCDhAFA...,1,-25,-39,14
HMKZPYLRDVcBUaGOdFWeNQESAXfCgbJTI,CEHAJGCGHCCHZBCE.LHEG.RAEH.DBBFBADHGBGEOEEFFGFD.eAHHhAAAQEAD.hABAAADE.XGAE.hAAAgDABIEFCMIAEKABH....hABA......hACA...,1,-9,-40,31
PVJOGQdSRTbBFWZHAafNcYEDIKXCegLMU,aBDF..NDIA.EFFBDAECKGBH..CEDA.LAABUBEE.JAFAGACChAAAdDDHREGD.BEGFZEAAAIDG..hACA..fFFGhABA.IHAHeHDE.MBBF.OHFEhACA.TGCF.hADAFBGE..,2,-23,-20,3
TDVNJHGUdcLRBgbKQWYIfaPEOSFXMeACZ,TCECDABE..JFBFGAADUFDD.LBHBBHAG.KGAD.QGCGhAAA.WFBEhABAfHFF.EAGEhAAASFGBMBDACCCHZCEGNEABcAFH..hADAgEFBYFFF.hAEAIBBG.,1,-1,-45,44
AVeaNJfZSRXDWcCQgGdUOHYTKMBEIFPLb,eCDAaDGA...JDAAZAEERGBG.DAEA.CHGCGCBCUACDHEGF.KEEEMFDBhAAABGFGFGEHLFAEhAAAAAIB..VEEENIEB.hABASBBF..cBGA..hADA......hAFA...,1,-21,-28,7
FJIdMcTBeCQaNRDKZGYSfEOHbWXALUPgV,LHCCUBBC.VDBDFEAHJHCC..MFGDBEFC..QBCFhAAARDGFZFCC.SBGBhABAEGHH.OFAHhACAHADF.XDGEAABG.IEEBdAHG..hADA......hAEA...,1,-21,-34,13
OceCNMLbRSQEPKZBJWadUYVTFfGIADHgX,HFBBOHEAeEHB.CEAALAHDRCEGQCBFKEFBZACCJFAB..aACCdCDAhAAA..UGCATBAHhABAFAFF.fFDEhADAAAAB.DIEGgEFG.NBIE.MAGHSECAhABAEHGE.BEAChADA...,1,5,-22,27
YbKfVHQcNXRTPLMUFgaGeDASZJdOCBIWE,SHAEJEAD.CFGA.BCCD.EGCBKCDCHFFAQABC.hAAAXCGGTAEHLEFEhABAMEIFFEAEaDDHDBBAdCEHhACAOHEEIHHHWAEG.fBHGhADA..NGAF....hAEA...,1,-20,-28,8
KQcSadCXZfUbEOVBHNWIPeJAFDgRGYLTM,FFDGRFDDLEACMECG.KGAGQGGF..SFGDhAAACHAEZBGBUBABbABD..OAFHhAAABBAEHCGD.NADD.hABAPDADAIGEDCFD.gGDA...hAIA......hBDA...,1,-22,-24,2
BRaOPNbUKVJZEeYfTDSGcHFLXMAICgQWd,CBDBQBECdEADBFFF.aCHB..ODDF..NCAHKDBAZDFAEAACeHBGhAAA....TAGGhAAADGBCSEGDhABAHGAEFCBCMHFCAADGIAHC.WFAF.PEEHhACA.....hADA...,2,-30,-19,11
VfTNQXcYaHJCDdFSPeZKIWMbRUEABgOGL,OADBVDBG...TGBEXBAF..aFFAJBHBDBBH.FEDBSAFBhAAAZBGB.IFEFhABAMAEGRBEHAAADBHGGhACA.LHBCNCAAQGGFcGGA.CFBDPAEHhADA..eCBHhABA...,2,-17,-16,1
LgVcJNOQBFYDUAHKCRdeaEXZWMPbSITGf,HGBGREFDdAFG.eFHFEDAGZABGMCDB...SBGBTGDE.LFFDhAAAVCCC.NCEGBDABhABADHAGADGEKAGAaCFF..PABFhADAIHHF..fFAD..hAEA......hAFA...,1,-12,-26,14
QaCbLTDMOWPEHgKcIUYBGSNdfVZXFAeRJ,eFFFJGEG.QAAFCEDB.LBHDTAEEDACHMBFD.OEADhABAEHBAHBAFKCCEUGCBhADABAAFSCGHhADAfEDBXAFBAFDBaCECPEABIHHG..hAEANIEH......hAIA...,1,-9,-23,14
DfCaTMPgZHVJUWGLdIcXBbYKENRSAFOQe,QCDDeBEEDADC.aAFBMCCC.ZGAGVAACUGEGLGEG.hAAAdEBGXDFEBCHHKDGDhAAAEABFSHBAhADAADIB.fAGCCDDAPDBD......hAEA......hAIA...,1,-20,-26,6
PMQWXLVHAZGDUJfFYNdSOBbTCgaKcEeIR,ZEAFUBCHJCEC..FFAGdCCEBAAF..CGGG.KGFE..eAACRDEE.QEDDhAAALCHBAIGEDDIHhAEA....fHDBhACASAGEOAEG...gGBFhADA.aDDHEEGBhAFAMBBH.,1,-35,-45,10
cCSTZHYXfeMWOQNVIPJEBaGdUDAKgbLFR,KDDGLACHFBCD.REABCAAEZFFB.HFBC..XDFBMADA.OAEChAEAQAAC.IBHEhACAEFGFaFEHdCEGAAHG.hBAA...gBEDSAGEfGEChBGAWHCG...NDIE.hCGA...,1,-25,-26,1
CAJMNZKgFBeGfHIVbDQdacSOLWXYTPERU,MBHBKGCEBDCG.GCFCHDCCIFFB.DHFCdDDA.aAAFSGCAhAAALEAHXACDhACATBECECBFCGHAACFHNBADFFAHhABA..eAFG.fHFD.hACA......hADA...,1,-23,-26,3
NFXEDVWJHOMBZQTUgcYaIePfbCKARdSGL,dHFHGEEFFFGCDEEEJAGBHBAD.BEADQBAEUECA....hAAA.gFAChABAaHDGIHGEeEDD.PADEhACACGAAAIBGLADBEHACOCEAMAIF....hAAA.cABFfCCDhADA.KDHB,1,-9,-26,17
CSPGTeDNZROJAdQUXVHIfWYcKEMBgFbLa,dFGGXEEGHCED..IHBH..YFCDKEBEBABAFCBCLAFEhAAASBFCTBCChABAeHFCDEGAZABCOGBAhADAABIB...........hAAA......hACA...,1,-22,-37,15
GRfeZWbXLFKJUHgVBSOMcCENITYaPQAdD,GACFRAEAeDGHZFEF..bGDELFAE.FCAAKCEAUCEDVDGFBDADhAAAMGAC.EHAE.TCAFhAAAPHAG.AABDDAIFhACAWCCB...........hADA......hAEA...,1,-13,-24,11
HZCXgNMVFKWAQeJEDSdcGPaYLfbOITBRU,QCCEJDHB.DACCdACBGFDBaCCALFAFOAGFBBBEHDBECHDAhAAA..XGAHhAAAMFDCKGBEAFABEEFE.SBDEhABA.YHEGIBHC...hAFA..UGGH..hABANDIA...,1,-10,-29,19
ULOEeQHNSgRCaKfIWTGMcJdPZBDAbYVFX,VGFEFBCGUBFE.LFEAeABCHECC.SAGCCBAE.KCCBhAAAIEAHGBGAMBFBhABAJFCF.dEBGBHADDIBAAEIDhAFA..XDDC.EHEC...NADDaEHFhAAA.....hBAA...,1,-9,-32,23
ZDKETabVFMWLNdgIcRfCeYSGHAQXUOPBJ,UACDBGGCDGDCKDHB...aAAHFAFA.LFDFdAEB....IDAGhABARFGDCCGF.SDFEhACAAEEGOAADZDAGTDDEhADA..MFCHNCCA...fGFEhAAAeFBDYHFG..hAHA...,1,-30,-46,16
OKaILJQDeMPUgdTFbYfXWGHcSECBVNZAR,OCEDaCACLECHDGDF..MDAGUGGFdGGHFBGD....fACBhAAAXGAFHABChAAASBACEEECCFGEBAFHhABAVCGDAIFEIEAD..QGAGhABA.PAFG.gEAEhAEA,1,-17,-28,11
LOMIQAYTCRPbWdFefXZNDHgESKcaVBGUJ,CDFARECG......PCHBdEHGfBCDZAFADACG.ECECKCEAaAAFBCCDhAAA.GGADLHCAhACAMBBBIAGBhADA.YEBCbGFG.eFAENBAGSEEEhABA..cGGChAEA...,2,-30,-15,15
QZRWgDYfUXbceTEMSGaBKHCFPOLIJdNAV,ZACDRCAADAGAUDGF....XFGBeCADEFCHMFDB..SHGAhAAABACGKEEDHCEEhAAAFBGEOAFGLFADICEBhABAdHEFAECD..QAEDYEEF.fBHEhABA...hACA...,2,-33,-15,18
gLGPBbCEfAeJMDdQZRFXSONVUYWcKHIaT,eHAEMCGBdDDEQADAZACC.RFDD.FBACXCFAOHEC..UEABhAAA..YCAGhAAAKGBFHFFCTFFELAHHhABABAGFCEHEACDADABB.NBIA..WHFA.aDEC..hACA......hADA...,1,-12,-16,4
eMKQZcdYFJOgAUWTENXHGPIRaCDfSVLBb,UDEGEFGDHABDGACEREDDDDGG..SFGABDEEeBABMAID.KBAFhAAAQAFFZGCCdFBFFAFEhABAgEAGAHHD.hACANEIA....XADHaEAGCEGB.LHCAhAAA.....hAEA...,2,-18,2,20
ORTBACYSHJXQUZEgcaNGIbFKVdLWMfeDP,CDHGHBFD.QFAGEGEB.aAAHNFAHGAEBFHDGdBEGLFGFhABA.MADGfDDFhAAADIAG.OBBCBBBBSDBGhACAXFFAgCAGIFED.KHAGhABA......hACA...,2,-31,-4,27
QLJZGfMReKSOXDFWcTAEHUIYBNdVPbCga,UBAABBCEdFED..VDEHCHGG..QEADJEAD.ZECHMCHBhAAAKBBF..OAECFECH.hABA.TAEHAHAAEFHFHCDGhAAA..IHHCNIBD.PHBGaCHH.hABAGACG...hACA...,1,-21,-22,1
eMLDVOagZUGBYETQFNfPXHAWRJICbcdSK,JDDCCCHCdDBD..eEBFMGFEDAAF...OHCAZABGBCFC.EHBCFGGBhABA....PHEAhAAAAFIDIBBC.SBEGhACAKAFALEEAaCGE.gFAHhABA..YAFEhADANCAC.fEGH.,2,-37,-25,12
gOKYWUAGBIMSaQLDFVTdJZbHPEeRCfXNc,BCAHMIEC.aGAGDDHF.FBFCdFCE.ZBBHHCDE.ECAGCAFE...XFEAhAAA..gFGHhAAAOEBHKADEUEEEhABAACIF.IHEBSAGELBHDJHBEeBAEhABAfBFE.cACAhAEA.,2,-45,-10,35
XOePNbCABaGHRcVJDTQILZWYdKfUMgEFS,GDDFRCCH.JAHBDDGH.QCAGLACCZGFGdADHKHBEUFCBEEEFFAABhAGA...OBCChAHAeHDA....NEHACAGHBFGAhBEA.aGBH..cAAA....hACA......hAEA...,1,-19,-36,17
RIYeVaQgBFKDbXJGTdMLWUSNHCAZcEOfP,ZACFEHGC.OEHDRBAF..eFDAQAFAFCFEDACC.JCBBdFAD.MIAChAAALHDC.SDFGhAAANHAD.AFCCfBAHhABAIDCGaAEEKEED.....bFAGhAEA......hAFA...,1,-23,-28,5
ARgCfBGLZMcQFEaIeDKUPYbSNHXTJOVdW,CGCBBBFGZBEA.MDEHFEGF...EDFEeFFB.DDCHKABC.UGGH..hAAA..bEDBSHCGhAEAHBAAJAFC.dAGFAIDA.gDBBhAFA.fEHALEABaFHDhAAA.PABANEBATBCChBAA.WFFF.,1,-16,-20,4
WfJRFbeLPQgNSMUDCYOZGdKVAXBacIEHT,BACBaAGG.ECGFHBCB.TFDBJFCA.RAAFFCGGeBBB.LFAHhAAA.QBDDhABASAEDDGGECFHCZDFEdAGDKHEGhAEAXFAGIEHEfGHA.PHBEhAAA.gDAGhACA..,2,-28,3,31
XOEIGRCgYDJfWTcKLNPZSeBdbaQMFUHVA,ODEEECCCRCEF..CACH.DCCA...JAEGTDGCLDADZBAFBCHBhAAAdFFE..aBAGQGGBhABAFHDC.HFAFXDBEhAAAIAGG..YCFC.fHGHhABAKGCENCAA..hACA...,2,-41,-9,32
TWMbSAFZXfecQYBaJKRIVGLEdNUHCDOPg,ZCDBXGAFeBCDQGBDBDHE.KEACICFHGBGGLAABhACAEGFEdDBFHAACDHGCOFEEhADATEGB.MIFAAAHHfAEDhAAAaAFF.RECC..NICD..CGEG...hABA......hADA...,1,-3,-14,11
aZLeTGbgdIRMFBfJQPOKSHDcVEAXUYNCW,XBGEUAAFCDBC.ZBABLDDDGDDGdHGHRAEH.BDCH..JHDGOADAhAAAHFGDDBHDEFGAAHAA.hABA.....NBICeEABhADAgCFG.MIACQEEFhAEAKGBC.SGADhAGA...,1,-11,-22,11
UYLKTZgXeRDVAfQOdGENcCMSFJbaWIBHP,QADFOFDGGCGGEGFD.CGAB.FBGH..aCEABFCDHCBCUAAGKAFCZFBHhAAAXDDADGIHAADFdBABhABAMHBE...SGADhAEA...JEGH.....hACA......hAEA...,2,-22,-21,1
GeFfcNBLPgKXWITDQdCSREOHMJaYbAZVU,UDEEeCAFFGAH....fBGGBFEALAAAKHBE.XCFChABAIGHADCGEdAECCDDC.hACASFBCREBF.hAEAHBABaHECACDC.ZEFBcGEANBEB.PACDhAAA.WAHB...hAFA...,1,-20,-22,2
AXINGOfSMVFJPdaUeDETHLCcWgRKBbQZY,XEGFGEBDSGFBFBGC.dAEEUDDAeHCEDBBGEBGFLGFAhAAACABB...gFABhABAKAAFBADGZEGFIHDChACAfGAA.MCIF..PADGhAHAaCDC.....hAGA...,2,-25,-17,8
aDWNLcPEVdACbKZIQGfMROUJBgYeFTHSX,CAHCKEGFZDAGQBFGGEDE.RDBG.OBDEBHGD..eGAEFGFDHCGBhAAAaACD.DBBCLFEHhAAA.EBADADAAIGBDhABAMBID...........hABA......hACA...,2,-29,-23,6
fCQPUcIBMJOYbTFESGgWVdZDLNHAaRKeX,aEAGKFEFeBFH..XGCFCHFG.UACHBACC.OCCF.hAAA.YHEATFBDFAEBhAAAEEFGSCFEhABA..WDHFdDECDHACLHAAABGEfGGFhADAPBADIHHHhABAMBIF..,1,-27,-29,2
UeJXWHafQIVAgELDNMTRPOcBCKFSGYbdZ,LEAGMBBCREAG.OEEDCHHC.KABAFAHDGBGEdCDEZGDE..UGBAhAAAeEFEJBAHHCAC.aHAAhAAAIGGD.AGIBECCEhABADDGENACH..........hABA......hAHA...,2,-24,-19,5
ZQRSGHXNYeWPCETaVbUOLABdfFDIJgcKM,dHDFFADFDHDGJBBH...KFECMACEZDDG...RBECHEGB..NAIG.eFBDhAAA.CAHE.EGBBaDCDUBFDhAAA.LABBhAFAAFEFBDGC....fEEBIHHE...hAGA......hAHA...,1,-27,-41,14
DKfGVJNbIeLRSFMTHZXaWgcPAEBOQCYUd,EGDAOCAE..QADECGECUFAC.DGHHGAGGJDFH...IDEFhAAARDAFSFHBhAAAMFFEZACCaDCF..gAGChABAABADBHGF.KGAFNIAB.LHCA.TCGHhACA....hADAWECB.,1,-3,-40,37
RHGZcUTWQgeOfIdYCFNAbVMXBSEKaDPJL,MCAFBHABSDDBKEEG.DEAFJECFLFFFRCCGGEGEZEGBUBGAhAAAQGCD.eCBDhAAAIBEDdADBCBGDAAIFXFADhABAEABD.aABD.....cGEHhADAWDFC.....hACA...,1,-21,-25,4
UOSCdMTgPYFWDHLQfNAREeBcaIZKJbGVX,RABBBCFA.aAEGKFDGGBAFUDDB..CHAG.MEGD....TGFDhAAAPDHB..FEAHHFCBhAAALCEEfDABhABAEDHH.IAHAZEBHJADC.bFED.XEDBhACA.dGBC...hABA...,2,-29,5,34
ZcRVSTJFLDYNOBfWbegGICPAQHUXdEMaK,HFBFUDGFEBDHKDGERCAH...SHFGJDEFFFCB.DDDA..OBABhAAABABA....fAHEhAAAbAFC.gEEEhABACHAHAHFEdBBAaGGAcADF....hAFA......hAGA...,2,-35,-32,3
VCLaKdeXHQOIbWGDEAfBFgSTRMNPYZUcJ,BFEGFDAF.SCCFTGAFRBCE...MEEC..NCIAZDEEJCADCHDDLFFHhAAA.KGCEdBGHhAAAeAFAXGGD.hABAQGAD.OACEIHHBWFFEhABA.DDEEAACFfCFFhADA.,2,-28,-26,2
XaVGSWZJPCgBENUcMKFfHYQTbODdARILe,RDECLGEAeHAA.XDCCaFGH..GBBGSAHDZFBEJAFDCDHGBDAFhAAA.UGBAMCAHhAAAKAFDFHDEHBBG.TEFGhABADIGAABBBIAHB...WABEhAFAEEAFfABHhAEA...,1,-14,-22,8
UYEgfaRGXIeZVONbWKPLBHDMJSdAQFcCT,FHBGTAGEUBBB..EGCD..aCGARFEHGABF.eAADOFCEhAAA..NCIEKEDFBFHHDCEDhABAJDEEAIHC.CAGC...fEABhACAXFFDIAECbEGH..PFAHhAEAMBAB..SHEGhABA,2,-40,-13,27
ASVcReJPLHWQgCENDdTMKbBUGaOfIFXYZ,SCDDRFFEeBCALFABHAAAQBFE.CHEHDFDAdAAGKGCHhACABHGEaDDHODHDIAHEhADAFFAFXADFhAAAAAEA..cCGDWFBHECADMAGF....hBBA......hBCA...,1,-8,-26,18
KBdMVWDPJNEeYGbaCSFHgITfROAcUZLXQ,ZDEGXCAAQAEEKFDC.BHBHdGBHMAFHDEDH..JGFA..eAHHhAAAGABCCHGDFACCIBHGhAAA..fGEAhABAAAHGLEABWDDANIDD.EAGFaEGE..SEAFhAEA..hAGA...,1,-19,-34,15
BYQVGfZEKTPXHONWbcUMJdagFeLADICRS,DFFECHHGBDAHQGGBGFCHZBFDKGDH....XAEHHBAGNAIE..hAAA...bCFAMDHBhAAAJBAEdDDAaABG.FDACAFFCSEAAhAEA.fHAFTAGA.OHCChAFAUGAF....hAGA...,1,-11,-23,12
UIKFLcbBWMZPHfdGAXQJaeTOSRECNYgVD,JAFBTAFC..OAACEEDH..CBHA.....gCDDhAAAUGGHKEAFLBBFhAAABHAFMFIDHCDGdEGCADIDaACAeFAGhACASHACRGDC..YDAADFFEIHEFhABA...FDHFhAFAWAGH.,2,-36,-6,30
gSYdFOEQMNVBRZaPLUGcCDHAWXbKTeJIf,XBFDTFFE..eDEEJFEG...IECASADD.FCAAhAAAEBABMDDDBBEAaHECUGAEhAAAGEACCHHCACCBKHCCfGHAhABAdAHG.OAEG...NAIC..hABA......hACA...,1,-12,-28,16
bHKNPgSdWDYeVcMQIfRTAECBFGJXUOZaL,BABFJDFA.OFBAZEEFLAFGKGAC......gGGChAAAdHADDGCAeBDHMADGQDAGhAAAICDAfHDBhAHAAIHACBADFGGA.GCEE.XCBDhAIA.aCHB.NBDFSEGAhBAA,1,-11,-40,29
TfQJHDgXFGAeYSOCEMLcIVZKaPBdRWbNU,eAGDOCDHCACA.LAAB..IFDHKDGBaFBDBGDHdFFCREAD..hACA..NIDF.TAEAhADAJCCB.DAGCFAEHAIDGSGGBhAEAMAAD..cGGF..ZFEHWCHHhABAfDBC.hACAQBGD.,2,-23,-17,6
cEIbQdaCYASROJKXVPFGeZgTDHBNWMLUf,RDFC.KBAHPDAA.FEGCZCBB.DAAABGAG.MAAELBEA.hAEAUDDCEAFDQGDBhAGACGAD.AFEFODEGhAHAXGBBeBBCHGDGfGGAIAFH.aFCBhAIASHGA.hBAA...,2,-30,-22,8
YWVNKSCbQecUaHGdEOLTPMgfFJRAXBDZI,DDACZGCE....IECHVFEFKAGD..CBGB.QFADUBCGGAAEhAAAECEE..LBAAhAAAPCGB...fEFDhABAFHGEAGGFBEEENCIAeDDHaAFGODAHMIAG..hACA......hADA...,1,-15,-27,12
NCgPOJcWFAaYXMbEZLKfQVRTSUeIDGBdH,aEFFMCCFZADDKEHH..QFBERAEB.UBAGIEDGBAGEdEHChAAACBAD..OHBCJHDEFBFFhABAAGFF....XEADhAAAEBHF.LAHHfFDFSEGFhABADIAG.....hACA...,1,-24,-31,7
ObKIcfYCEBHRDASLZPXaTUJWgdGNMFQeV,SGGBZDCGaHAA.UBEFJHDG...dBACGBBHFDGE.eDADVGAChAAAKFFA...IHHBhAAAfDCD.EFEAhABABBACDFBCAFAFPDHD.TAGD..hABAWAEE....hACA.MFIF.,2,-22,-17,5
QBdUWLMaISDeVGHZEgPfJCYXKONbRcFTA,BFEAUBGBMFEDaDDG..DADGeADDHAFFEEAB....fACGhAAACCAGKGAD.OCHFhABANDFC.bEBCFHGE.AGGCQAABhABAdGHAIHBHSCCD..hAEA.ZFBDPHEG.hAFAJBBF.YEEC,1,-4,-20,16
RIOCaeGWKdTHXUfFNMSgQZJBPbLVDYEcA,OBDGeGDGGAFGdGADHDFFUDDHFHDA..MBCCQDDFBFAELAHHhAAADACHEEAGAIBECHHCaEAAhABAKHGA....fAAGhABASCAE...JHBC....hACA......hADA...,2,-20,-19,1
AVZKYDFaRTMHWNQPOIbdSXJCcBEgefLGU,KHEADDDFFHAERDEGHCAA..QFDDOHAEdBGG..JBFGBFCBeCBBhAAAGABF.AAEEZFFAhAAA.aAHFMFFE.NIEF.hABAIGABXACFCEHH.EAEC...fGGHhAHA...hABA...,1,-17,-26,9
WJHQMDgFNaBIdeTfKEbSVGCAUcXYPORLZ,UEEDXCBHODAGZAABHDGD..QFACDCFGFFEHBHHHdDHEeAEFhAAAKAFA.EAGDSAHBhAAACCFGABBA.PFABhADA.LAEDMIBEaBACfEEBhBAAbGCE......hBCA...,1,-14,-19,5
JKgBHTbZeDdMAQRaYNWOVIGScPLUXCfFE,aDDF..NAFG.OACGGBAC..SEBDLHEGXACAhAAACHGBEFEFKDHB.HGAGZFCFDCDGhAAAMDIFRAFB.VDCD.cAGAhABAfBAE.FHACBFGBeFHBAACEYBGFhAIA...hABA.WBBB.,2,-8,6,14
KJXLHQVgdGNMWSAFCYReTDZOPbUfaEBcI,FDCFCHBCREEC.DIDGZFCH..OHAGUEAG...EFFDBAHA.KBDELBCChAAA.QBGAhABAdGGGMCIF.ADABeEFGhACA.TEAHfBAAIHHHHCDG..hAAA......hABA...,1,-20,-38,18
fWBaGFHMQRLZNScCYKgUVbedXIPJAOETD,TCGFDEFFBGHD.GBEHHBBDRDDEZEFD..SAECCBCE.KFBDhAAAUEBBeEHFdHBHIAHAhABAAABB.EBECfADDhAAAFDABLFDB..NCAA.cGFH.hACA......hAFA...,1,8,-43,51
PQeADdcaFGHCRSZJNXMOEgTLbfYVUKBWI,DBDHdHABFBEDGDGGRGDG.ZBEE..JBAFMACD.EGDALBGD.hAAA.fAEHhABAVDCHBFGDIHAH.hAAAeDAGAGIBaBBFSGHH.NICBXEAChADA....hAEA...,1,-18,-38,20
VIeQLfSbcaDNCFWHZgOUXGPdYBTREKJAM,VCEFeEDGLABA.SHGCbEGHDBFC.FDADZFAGUGAHXCAEhAAAdCDDBECD.TBGDhAAAEHCGABIFMABG.hACA.IGDBfBCB.aGFHCFHG...hADA......hAFA...,1,-15,-20,5
LKZGBNEIVMTdYHcDCfWeSFbXgROUPaAQJ,QECBKFBHZBAABFEBEEHB..MEHHdGFBHACC.DHCACDAGeCEChAAASBAG.XBGChAAAOAFAaGECAIBELDAChABA.IFAB.....hABA......hACA...,1,-7,-50,43
aJdFUVWAfYLOHRbXKBDNQScZTMPgeCGEI,LDFAHBEEXBAGKBFABDBADFID..SEGCTEDF.MFHHhAAAeCACEDBE..IGABhAAAaFEBdFAHFAHFUFGBAEACfDDDhABAOABANIAD......cFBFhAFAZGAG.CHFD...hAGA...,2,-31,4,35
MVRFHAWIegaLKESfPZXQdDNcOTYJbGBUC,eEFCaBGGLFBDEGDA..SBGDZBAHdFFADDECODAA.JABChAAABDHGCHCG.RACHAGEBIFHFhAEAKFCH..fHGFhAAAXFBGNAFE.....YAHHhAGA.....hABA...,1,-14,-39,25
LFfbcDJYESeVTUOARGHgQINPMaZBKdCWX,GGEHHCCBQBFH..IACCPFFCMIBGZAFCBDDGhAAACGAELBAHfCEFhABADACD.JCGBSGEGhAAAeEBF.TADDAHAH.NAIAaEFGKBBF..WDHHhAEA......hAGA...,2,-29,4,33
VYWLBTJOPNGUEbIRHeKSFgfZQcaMXACDd,CAGHDIAGdEHA..VCDFLDCCBHFB...JDADODCHGFCBEBFBRAAE.hAAA.HGAEKDAHFBBEZCFBQADChACA.hAAAMHFAYCHF.PAFANIDH.IHHChABA...SGEFhACA,1,-9,-30,21
KTAdacOJHGfXRZCIMbPSYFQVeBgNLWEUD,aFAGOCFHHCDAGACARAEGZBBF.CHCA...MHCGSFAHFFGF.eBBDhAAABAACLFHFhABAEHAEDAIBAEAEdHEB.JAGDXCGHhACAIAEB..PFCC....hADA......hAEA...,2,-16,-15,1
FHBZLWdPCYISRXegaTMVQUbNEJfKOGcAD,HDGFLGECdDCHCADDSBFDRAAF.eACBaGGE..MHAEUEBFECFChAAAJBAB.KCGCGFCBhACAAAHHDIGE.FEABZEFA...hAEA....WFAD......hAAA......hABA...,1,-14,-32,18
YVXNEWFUHBagPDGALfJTZcdQKOMSIeRbC,JBFFZBGBQABD.KFEAODHB.SEEBRDAGCAFF.hAAAVABCNIDF..EEDAFECFhAAABGHAaAGG.DGCFAHCG.LCCAhABATGFAMEAF...eBAD.hADA..bFAD..WGDGhAEA..,2,-28,-22,6
deHXCaUfJgWbTMFNIRLADSKcOZBVQGPYE,DGGHSFAGKDDFZEFE.BCEBGFAF..EEDGeAEBCGDG..UEGAhAAAJBAF.....WBBHhABAMAAC.FAHDIAEBhACAADHH..OHACPAHDdCCFaHAGbAFB.hADA......hAGA...,1,-20,-42,22
NAMCbPQZgTIfFGVYSRXcUdaBDLWeKOJHE,CBFDQFDGZDFG..TCBAIAAFFGDG.GAEH.VCBDhACASEAGRGFA.XAABhADAdDGGBADCDHGGWFAGhAFAeAHFOHAEEGAGAEDHMIFC....hAEA......hAFA...,2,-30,-6,24
FAYCKITOVEHGSLUJecbZgaMDRNXfPBWQd,CHFHKCEA.OAAGEGBBHAGBLCBHUABC..eFDEZDGDMFIB.DEEEhAEAXCEDBGBHdAHCAIAGTADBhAAA.SEHBhAFAcGFC.aFHHfAFGQGDCIBDHhAGA...hAGA...,1,-15,-28,13
CIgLRYXBQSPKDUFNOZfVGETaHcWJMeAbd,dGACCDBELAHBREFHBCFD...SBFCKEAEUBCC.OHCEZAFC.GECHhAAA.EABFaGCCHACFhABA.JEAFADAG.IGGAhAEAXAAFDIGGFFHDfDED..hAFATECF.WHCAhADA...,2,-44,0,44
BfFRaecYALIOgXDWbVEUTGMCJSPZdNHQK,ODDBDDCF..VFFGUEAAGBDGMFEE..CAFA.JGBE..SBADhAAAdABGQBGHhAAABBCHFHGAaDAH..eHEGhADAAIDAIHBE.XCFBWHAG.EDHB.hAEA......hAFA...,2,-34,-23,11
XGSWEPVQbKTNMfOJdgZReLFCcaDBAYUHI,UAAEXBGHGFEF.ECEFVEBH.KFGGTEAG..MICGhAAAJBHHZGAGLBCA.hADACEDEDCADAHFDIAEChAGASEGEQDFDfFEAgDCDhAHAeABEaDDA.BHHC.YFAFhAEA,2,-19,-9,10
dTSLRbZAGJFBPYEVOCXcfaWgIUDeMNKHQ,JCAAFFBFBDCC..ECEAOBDE..CFAE..XDGFaDFC.hAAA.IAGFDFGBMIBChAAAKHGCdECALEDBhABA.ZABEAEEHPADE..YFFDhACAfFEAWDAFeFHFNAIE.hADA...,1,-32,-37,5
IfJdVTULZBSDCYFNeOMRHPbXQgWGEAKca,KBGGaEFA...JACFTGFEZCEA..DFFHCEBBFABD..eGAGRGAEHADEhAAA..XEBAhAAAQDDA.gAGHhABAEGGHAAEB..IAFCdDAG.LBADhABABGDENEIG.MDIB.WEEFhADA..,2,-30,-10,20
XLFdPSRUeWGIOVJYcQbaCNBMEDHTKAgfZ,ZFDCXACDdDDDREFG.UFCDGEAE..VDFGJBBG....QAFGhAAACGHHBDEFDIDCKCHFAHAGLAAFhACA..hAEASAHBIAGB.OCABbBFA.MIEGhABAEFFD......hACA...,2,-23,-21,2
AfFgWNCOTQEUPJdBRbLKHeYaZGMSVDXIc,FCGG..gGFFCACE.OEDAEGEBUCBDdAABRFBDKGBDHAGB.hAAAaAFBGCEE.MAEFhABADDBEXGDFhADAAAGD.NEAG.TGGF.PDHDBCEGeBBAhAEASFAFIHHE.hAFA...,2,-35,4,39
cPWXBeKOgLdHaDbGUASMTZINERYCfVJFQ,SDCAMBHDZDCE.EFHDCGCC....VAAAQBBB.PBFBhAAABEAFKGFBLDADhABAdAGBDCIFUGEAAFFG.NAHARGBGhACAJFAD...FBDEWEBG..XGDDhAAA.....hADA...,1,-12,-31,19
GOgPENcfWIFAUdbHQDVZMTSKBJeCXRYLa,dGFGQFBGDFDBZAFH.MFHDKDCF.BDCA.CBCG.RAADLCHBGEEEOBAHhAAA..EACCNEIG.hABA....WBEFhAAAIBEH.AGADHBGBSGHD..hACAXAFBaHAE..hACA...,2,-35,-21,14
RSHTOfYWNXaQEMPcVCeBZgdFILUJDbAGK,KEBCSDDBHACAOGAA..fFCC..YEHFhAAAWDBF..NAIAaHGGhAAAMIBA.VFEDBBCHgBAEhABAdFFHFCFGIHAFJBFBAEAH....hABA......hACA...,1,-15,-34,19
CHEYMORaUKbLASPIWTNJBDVdFGecQZgXf,SFCH..IHEFTFFGJBEEBGHD.dDAFGEAAhAAAeFAEQAAAhAAAZDCCXGDDCEEHEBGHMADEaEGEKBAChABAAIAC.NCICDCAHFGACfACF.OBEBhAFA.....hACA...,1,-13,-20,7
PLYdfESbCDRXWgKBJNOGIcTVHUQeFaMZA,LBCEdGBFSHFADCEFRDFE....XGFCgABF.BEEAhAAAJCADGDCE.hABATGACVAFCUEGChAEAFCGAaAAGACFFYEBE.EBDBCAGC.NIAD...hAFA......hAIA...,1,-18,-19,1
LaUeQMRIKdAGbfNBcXSgVHWFCOPTDJEYZ,GCBE..fHCFBADGXDGESFCAHGFGCAEBPBAFhAAADAABEFFA..LCEAhABAUAGGeFDFREACdAEFAIBCNDDBhABAgEEB.WFHF.FAHF..hACA......hADA...,1,-11,-20,9
LJcPCTZaXWROgSVAFfBGUENHbeQIMDdYK,FEBGBFCFUGEEHFEB.eCDBMAEGDBFE.dABHKBDDLCAH.JDGDhAAACEEDaCGC..XCEFhACAOEHF..SGBGhAAAAAEAEHAE.QBAFIHHH...hAGA......hAHA...,2,-40,-23,17
WePRAacgXFIGbBLMDZCUdVTSfKENQHJYO,aDBEXFCAGDGALADFDIGA.ZFFBdHBF.SEEBEBABHCBFOBFEhAAAeBAHACCCFFABIDFFhABABCFG.CFHHTGAEhACANAAB..QGEFWAFC....hAFA......hAGA...,2,-22,-1,21
TLXVFZAagfYSRbQBPUCWHNMJGEdcKIeOD,aBBF..gEEH..SBFEbEBFBEHC.CAACNFABMADHhAAAGFEBEGHH..KBBFIHDGhACADICALGDGhABAFGADAHFFRCEEQBFE.WCADdADE..ODBEhAFA....hAGA...,2,-22,-8,14
ABfKIQTNeGLHFPWOMCdYVcbEaRDSUZgXJ,BACFKBGFQCDCeBCHLCFFHGAEFFECOEHDCGHF..dABAVFBChAAAEAED..DFAGZAEAJHEAADED.hABA.TGEE..hAFA.NIAH.WAAD...MAIB...hAGA......hAHA...,2,-21,-20,1
KHZafENeBPOYdUGTFgLIbMXAJWCVSQcDR,CAGGVDAA..SBDHDHCAHEFHZABEEFDEBABA..OBHDhAAAUFADFGGAIFDHMBAHACCChAAAQAFAKBHB.hABAaFHDeDEC.dHED.......hABA......hACA...,2,-25,-24,1
NcfgMSEDWQTOaAKBHYLXCVRGUZFeIdJPb,HBBBXAFBCBEHRCFHZFFGFCCA...dHBF..PEEF..NCAA..hAAA.gDGEhABASABEDBDCQEDGhAAAaFCDKCBFBHHBLHEAUEADIBHCJAHFfEBGhAEAMIDCEABA..hAEA...,1,-4,-20,16
QdNVPfgaTMSOZXbUCHJYFcBIEWLeAKRDG,DFDFQDGDdACD..VDEF..fCFC.aGACSAHBhAAAZBCGUFFHCBAGJBBFhABAFDDFBAFEEEACLAEChAAAKHBARBEGGEGE..NIAF...PDABhADA....MGBEhABA...,2,-22,-14,8
CVHSEAacTOZDLGMfBJPYRgeKFXNIdQbUW,TACCZDDGDCDGLFGH.GGAFMGEABFBB.JDDBRAGFeACGhAAAXAFEdBABQEAFhABAUCAGCHHH.HFDChAEAADIHaGAC.OHEG.......hAFAfAAH.hAGA...,2,-29,-5,24
PASOfGRJdCTFQEZWUKacbLHVBNXegIDYM,OBBARFCBCAEF.FFAHECEDZCEE..KFGA..aGFELACDBDAE.eBHFhAAADGED..MFBCAGBDSGEHhABA.JAFGhBAAdFGF.QAEC.WAACbDBC.NAIE.hAGAIHHB..hBBAfCCG.,2,-29,-21,8
WgUdBAaIHEcYNeXVMOJZFPfRCGKbTQSDL,aEGEEABD......NACD.eBDC.MDAGZFFGFCEBRCEECHBC.KHAGQAGGhAAASGCCLHEAhABAUDBCBHDAABBBIACBhAEAHBGB...cFABYHFGOFEChAFAfEFB..hAAA...,1,-9,-32,23
geBbGUWZRAYSLEJNaPVcICFMOdDQHXKTf,LCCAJEFE.aADFVFBF..CAHCMHFADIDEHADD..XEFAhAAAKAFC..fDCGhAAAgGCGBHGFhABAUBGFZBFGAAFCEABF.NBAC.cBBAOFBAdDAG.hABAeEEDWDBGSGGEhACA.,1,-10,-24,14
MQGIVYOeNBdDcHASTUZXEafCLWbFRKPgJ,TGBAZFBDECBD..CFHC.LAGH.FEGDRGDAKADEJEBC.MBHFGBBHhAAA..VDDEeACEBBFAhAAADEIDAGEH.SBAChABAaGAB..fABEWFADbEEB...hAFA......hAIA...,1,-13,-31,18
FegQKMDXfLOTaZIPHNcVWdRCJGUBAbESY,EHGEFEGGQEBEKFEE.DCDALADH.TFCAIBHHhAAAHAGFVBAHdGAAJCAEBDFChABAAAAGSEHFhACAeHDAMEEBXAFBOBFH.ZFFC...NEAC..hAFA......hAGA...,2,-18,-7,11
ESZFfNgJMPbHBIWLQXAcUVRODYdCaeGTK,UCCAVEGF.REGF..DABCdDBB.CCHD.GFAD.KBFAEADC.FFBA..hAAA..NIEH.MAGB.hAAAPHBGBEFFIAHBhAEALEFDABCF..OBBHaBABSCEFhABA....fAEFhBAA,2,-37,-32,5
gJDYHPNcOWRdCFZTfLESeMGKBbUVaQXIA,DIAEHEFA...NBDD.OCGFdCBGZCFALBAF.EDFBSGHFhAAAMECDBCCEbEACUGGEhAAAaHCC.QAFBhABAACGG.JEEFcFEH.CHACFCDH.fABFhABA..eBCEhACA...,2,-25,-1,24
cCMEdPfgeWBSTOJUXRFQZGbYHDaKILNVA,MDEDdAFD....gDBCeFAASHACOAAD.JCBGXFDBhAAAFHDCZFFFGAEBhAAA..bCFCDACEIHGBhACANCIEADGE.EFHBfBAAWEADBGCE..hADA......hAEA...,1,-15,-29,14
YFXaLcVbCGIeBRJAHQOTfMZKNUDdgPWES,QBFEOFFA.MGAEKFDFUCED.DABBPFFA.SHAChAAAFAHBLFBBVCDBhABACDAC.eBBDBGAAACCCfGEAhACAdACH.WEAGEHEC..aCCF..hAAA.cGGEIHHEhADA.JADE.,1,-16,-33,17
cHRgZeJKXBaGbIQCWVNTdMUDYEAOSLFfP,SAEDFBEA..PAAEHAFEZFABKHCABAHGaDDFGGEF.hAAAICAACEHF.VDGHhAAANDEEdFAHDBAG.AHCE..hADAODAELGFG.fDCE.hABA......hACA...,1,-9,-41,32
WXRcFPAVMdCeZgTQODaSYHKNbGBIUJEfL,VBGHMABBdECC.ZAFGQFEB.DAEFSEAB.hAAAKFEEbFBBBHGFJBABEABEhADAfADALDCGXDFAhAAAFGHDAAIDCGAD.TGDEaAFG.HCCC.NCIGIHADhACA..hADA...,1,-8,-26,18
EdgaWJIfGOHBAPLbcVRUMDTZeFSYXCNKQ,LAEDVABE.MGDCDEDG.ZCGBeHBE.FEADSAGE.hAAAXDCGNEGAKAECdAHGaCADhAAA..JCDE..IHBGhABAOBABBHHEAHGDPFHF.bBFBcDGFhABATABG....hADA..CFHD,1,-22,-32,10
gUaFOdcENHebVPGKTXJDYfARMBIQLCZSW,BHDGLDBAZCAG.SHCCUFEBFBEG.OAGB..dHAHNCBH.HDGDhAAA.eCFC..hABAPAAETFAEDIECAACHMIFChADAQFAC.CGFEaFHBEDEB.bDFC.KADEhAAA..YAFChAEA...,2,-20,-11,9
LeRPbZFSGQfOVTDUNXMcadBgWICYEHKJA,LAABeCAGREFEZFAHSGGFGAAF.OBFHDEDAUGDG..XCCGhACAaAED.BHEEhADAIAGBEBGDKECAADFGFCGAhAAAfHBF.TFABcGGEdEGDCDAG.YAFChAEA...hABA...,1,-9,-20,11
WZEOTaHSKCDgGLBQeXMRYUbFVPJfNIcdA,EAGCOAEDHBDCKACBDHDGLEDFBCBH..XEEHRBGFUGFFFBABJDAF.hAAA....IHAHhAAAADIHZCGDaGAC.CHGD.QEAEhABAMABA.bEFA..fDDGhAFA.NIBB..WBBChAGASAGE.,1,-12,-18,6
EYfgaHGXTOdLFPKJZRSebNCBUVDQAIMcW,MCHHEFCH....fAGGaGBDHECGXAADOADBLGEAhAAAFCDAKAEEZBFDeCFGCDAGBGGChAAADFBBQEEBhABAADIB.ICBA.WHAAYFHB.hACA......hAEA...,1,-20,-22,2
geRBUSOLZANTaHEbPcFDfWMVYIdQKGJXC,aAGHEEEG......bFBFPFEF.FDCAfDGB.hAAAVBBHYBAFdAEFKAAChADAXCGEeHFEBAHBhBAASGHBOFDFAHBFHEAGWBEAIBBFhABA.JEFCCFGA....hACA...,2,-26,-3,23
VbOAfSZCTFYGUDgENcBaPRXdLKWHJIQeM,SDCGTBEH.FABAUBAE.EFGBBBEHRGDELAHBHDGDJGBGeEBHhAAAMAID..ODDHhABAfEAACAGGDIGCNEAAPEFHhAAA..XEEFKBBDIBGAQACGhAEAAHHB....hAFA...,2,-21,-3,18
LRQYgHfEJMZOCTeGVaFcWPbBXDAIdUNSK,dBBBSAGERFDE.QCGCHBFAEAEFMEDCCBDGGDDEFEAE...hAAAPFHHBHHBAEIDNBBG.KHAChABA.LHDG.hAAAfAGBJFAHOAECeFFEaGFHWFCDDACC.hAIA......hBAA...,2,-11,-8,3
PJDOUGXfKLIZYgEAMNceVQWCHFbaRSdTB,MECCeCEDQACGHFDGFCBG.RAAH.dAFEBGAHDBHDOADFUFGCXAGFhAAAKEHFLFBH.hAEA.IBFB.hAAAgCGAEABAAHAFNIDH.WFDBCGHAaDFF...hAFA......hBAA...,1,-12,-22,10
JVZYSgDWPceMHaQOULfBXdbCFTKAIEGNR,EADHGEBARCDH.ZCCA.SCAHDGDC..PBGFMDIDHAGHhAAAaFAB.QADDhABAUGGABDADXGECdBBAFHAEABAFhAAAIHHE........hACA......hADA...,2,-31,-13,18
adLIYERKPbCTZUJFeWfAgDVONBSXGcHMQ,DBBEOAEBBGABGCEEHDEG.QABEdGCHLCDDECHD.KHGCPDBBhAAA..CCAEUBFHhAAAFGCFfGFAAFHA.hABANBAG.XFFG.MICAaAGBIHHBhABA.....hACA...,2,-34,2,36
EfPgJBDUOTcXLVKHadRCQGeZMNIWFYSbA,EEHB..gFDDBEFAUGDHODDG..TDAHLAHBhAAAVABCaBCA.dGACCBGDQGABhAAAeHBGMABDIAFDhACAFDEBSGGBACFGJFGBcDAHKBAF..hADA......hAEA...,2,-19,-12,7
CDTcSBdNWQZgJLUXMHeKEPaFbIRYOVAGf,CHCADHCG..SBBEdDAHQCFBZDAHLEECUEFDHEBCKBHBEHGAhAAAaBCG...FFFBIAFAhAAARCCA..YFAFhABAABBHfAHG.BHHBNAED....hABA......hACA...,1,-18,-30,12
HYJNEURgAVGTMCLaBKDePfSbQWFIcXZdO,GAAHCEGFBAGE.KHDADEBBeFCE...SBEHQCCCFGCB.hAAA.IFHDZEADOAGDhAAAJEED.EGHB.RDEAAEAFMBDEhABAaCDB...fGCGWADE.XGGChACA.dCFDNAIA..hADA...,1,-2,-48,46
AJMeaVNFgDTUSQHEOWXBYCGcbdRfKZPIL,eCFEVADG.FHBC.DGGFUBAB.HAGBOBDGBEDEGDEE..hAAAbFEARDCHKEHHZDFCLGAGhAAAABAHMDAB.aDADTBBAhABASGHH..EAHD.....hABA......hACA...,2,-15,-14,1
dQCNYLSaDWFTeKAMEZcJRPOBUIXbGgfVH,EDDBJAGF.RFEG.BABB..XCAEGDCH...VBFDQFFEhAAACFADLAAEaAEFDCIHFHAEKAEChAHAAAIHZDAB..OHFEhAIAIGDB.fHABNDIESEBGTBCGhADA.MFIF..hAHA...,1,-8,-31,23
dcYgaOQJLCISWEBXNRAHeKbDfUVMZGTPF,HEEGKFAFDGIDUBCDZDFC.GGAB.FCABdHDH.....gBCAhAAAaHGGJAGBCEAH..SABEhAAAEDBBBFGBREDHABIF.hAEAeBFC..fFCDMBAA..cGADhABA.OAEGhACA...,1,-21,-31,10
eIAHKGXgDYFSdaRPLUbMcWJZTVQEfOCNB,KGCDGDFGDEFA.FADCdDCARECBLDCE.UAFEbBCE...MCBAhAAAJDAH..ZFGB.QAAGhACAEHBECAHHBCADADIFHEDBhADA...XAGDSEHHaGAH.WHEAhABAfGFA.hACA...,1,-16,-26,10
dKLQGFEYSICBXgbUTDAOeJNWMaHVRZcPf,eEFFJEGB.MCDAHACCZEBA....PGAEdBHCKAAEGCAFEFAB.hADASFDEBDDFXGBHhAEA.UGGBAIHEOHDChAAAaADE.RCFAcAGFfEHC...hABAFCBF..CFAC...hACA...,1,-8,-20,12
bWZQNIUaAJMgCHPRfEdLVKSceTXGOYBDF,JEEBMCCBHADERDGB.dCFHLGDC.KFAHSABD.TGFDhAAAOACGBHBDFEDGbBDEhAAAZDAD...IBAGhABAADIHCAHHEDDH..cGCCeHCA..YAHHhAGADDAD.....hACA...,2,-26,-13,13
dDCfBAHcPbEKNIaFRJTMOUGYSLeWVQZXg,HBDB..PCDBKBFEaDBDJBFB..TGAHMBCHGEGGLFFAhAAAeADCQGDGhABAZFBEdBAEDIBGBHHFADHCEGFBFABDOCGFhADA..SAHB..hAAAWAFE....hAEA...,2,-16,-11,5
LCUeKWIAbSZMadJYVHcERNFOGfTPBQgXD,SBCHaADE.dGFAVCEHHDAHRAGDFGCBGDGA...TAABhAAABAACXCCBhACACEFFKGCGACAHZAFDMFGH.JDAFEBHBhACA.NIAF...OFHFfECH..hADA......hAEA...,1,-6,-27,21
FSaeAGCXTcYUOLEKVRbdDfZWQPIgBHMNJ,CDHBTACCUAEC..LFDDKBGHREED..dGDCDGFCZAEF..QACChAAAIHAC.BHBDMEHDhAAAJHFGFCAE..aBADAGIF.hABAGDDD.XAGEcECB....hABA......hAHA...,2,-29,-24,5
bFaDUSBVfeNPMYTEZHcIWKCXQJLGROgdA,FCFBUCGABDAHeFDC..MCIBEAGEHBBF..IDDBCAEC.hAAAQGEFLFBBOFGFhABAADHHDACA..SAABhAFANDAE.TAGAcBEGKFBFXGDEhACA....hADA...,2,-38,-20,18
JdSQfCbYAEDgZRWBFTMNGXIcOeLUPHVaK,EDEGDICERBBGFBHH..MBADGBAB...IHFAOGEELDEChAAAUFCHHADGaAGAJEAFSEBBhABAQFGECGCHABFFhACA.ZEFCBFFC...NAAF.cBGA.hAGAeFAD....hADAKDDF..,1,-2,-24,22
UReXcdaVDCbfLIgEWSFQGMNZTYJPHOABK,BBHDKDCCUDGAeAFH.dFBFDBBC..CEFBLDHFEEEH..FGEEQGDEhAAAMFCD.ZDAEhABAJAEFHACA.ACAEXGGGhACAaAAB.fHAFIHHHSFAHhACA.TAGDhADA..,1,-20,-41,21
cZHUNQMPeYOXWDTfCBSJFaKbRdVGAgILE,LEBAEEHHHFCEQCCCeGECOCAAXGEEDBAG..fDGEhAAABGAHFAFBKABDdAHGAADAhABAIADAUGADMEIHhACAWEECCCEH...aCAH.bAGHRADC.....hAGA......hBIA...,2,-14,-3,11
LcVEKHSFZbWUPgYOaCJXIQBedDTNGRfAM,MGFELEHF.EADCSADHZCCF.UDGEPCFHOEDDCBHB.hAAAJDACQDAAhABA.BGAGdFCCDBAANIDF.hACAfBGDAHDA.KBFD.FGAFWGCE.hAAAaHAEIHHF.hADA...,2,-25,-24,1
bBKJMaODLAZHNdEVeYTPXFIWGfURgCQSc,ZFDCdHFDeECC..PCBBFAHDGACH.UDGCRCFFCHHD..QAGBhAAASAABBDDGhABAKCCFaDABDHAAACCA.EABCTGADhACA..IAEAfFDA..hADA......hAFA...,2,-33,-22,11
MeNEJQIKYCROdfHDZLbPWAgXTBGaFVScU,TDCFaDCD..VFADSFAF.MHBEEGDFQBCDhAAA.KFGGCGFEdAEHfDAChABAZBCCLFHDhAAAbCEDADGFBHHAFDGEeBADNAIG..JHEG...YACChAGA...hABA...,2,-22,-2,20
dbOYcMHRfZeGEPJKDSVUWXaBFLgNQCITA,dCGEOCFDMIDAHECGZDBHGACCJFBH.DFBFVADE..UFEHXBABhAAABAADFAFE.LFHBhABANHDH.CDFF.AEIHbAGBhABA.....YDCE..hACA......hADA...,2,-26,-20,6
DPMgHQVaKUJOFXLCWAESGIBNYbTdZfceR,GCAABAAH...bDFBTFFG.dDFHfDHCeGAADACEMBCFhAAAHABD..VECDUAGEhAFAFAFECEDB.ABABEFHF..hAAAIBDGZADD........hBFA......hBGA...,1,4,-39,43
AZHNLeKgWEdGDfTUCFbSPIMQOaVBXcYJR,ZFBCLEEBeFFGKBEDEFDFdHADGAAA.DDCFUACA.FEBB.SHFAhAAAICHGMAEGhAAAaBBB.BDFH..XCGFhABAJHBCAHFD.NDIA...WAFAfAFAhAFA..CHHD...hACA...,2,-32,-16,16
aRQKfdGZAMEeXWOYDSHTLNPICFVbUcJgB,eGDGXBCAOCAHDAGD.HABCLFFC..PCGFCFCCFFAHUBAEhAAAJFABBFEE.aDDERFDBKGGDhABAdFCGAGIFMAIB.EHBChACA..SCEC.NIBH.bBEH..hADA......hAEA...,1,-12,-15,3
dMVUbIYXFHRfTaBDKeLZgCNAESWOPcJQG,SCGAOBDA..JEAFdDDCUFEC..IDADFBCHHEGFTAFEhAAABCFAKCABZCEFNEHEACHH.hAAA...EECFPABGhAFA...GEBGMIAG..YAHHhABAfGEGDIEE...hACA...,1,-15,-29,14
FQVOLRPgcBKEfTJYNUbWZDaGHXeIdAMCS,SDDAFGFEQABCODHDRFBF.....PAEEgBEAhAAABHAEKCGFEFEAfHDDhADAJCAC.NEAF.UFCHhAAAZAGFDEFCHFFFIFAHAFFDCABH..cEAGhABA.....hAEA...,2,-19,-17,2
FKIgbDXSaYLRedVBHMTQNPEZWfcOJGAUC,CFCHFFEBKDCC....bBCGDFHD...SHBEaDHFLEAGRAFC.hAAAdBACBCAGMHFEQABFhACAEGBG.ZFEBWAGFhAAA.OEEAAAFEIEAD...XCFEhAEA...hABA...,2,-37,-28,9
BOSWDLgIJdfFQYUNTPaeEcCRMbXZHAKVG,KAAFVACHGEGE.OHDESEFC.LAHFIFDBdFDChAAAFFAFQFABhABAUCCB.TCADaADBECFFCHGG.hACAMAHDXAEFAIBA.DICAfCAChABAYFHH.NAIC.....hACA...,2,-24,-3,21
ReZDEaSUGWfKHFJMLNdAXOcgbBICYVPQT,XABGODBD....bAGFBDDB.IBGEVEEH.TGDDhAAAeACADIBA.SHFAhAAAUEAAfDGBhACAHBDGJEHHLFDENCAAAEDGCGBD.YHFG.hABAPADA...hACA...,2,-16,-13,3
KHdUEgVBeSOIQCJWMLTZNfARacPDYFbXG,aGBDDBBGFFFGGADFHFADdAAAUCFC..EFHH.BCCCeDDD.OCABhAAAIFDD.CGEHMIDChACA..LAHBhABATEAHZDDCABEE..PFHF..bCEA.hACAKGADSCCChADA...,1,-7,-28,21
HgDZAXYeaGdLTbBIQUWPMCNROEFKSVfcJ,eFFGdAAELAFCBHHAUAAFMEFC..RFCEFAHFKCFA..SCCChACA..VCFCcEAGhADAJDADDEDE.ACDA.aFFChAEA.TFCCQGADCDDHEBHD.HADCZGFG..hABA......hADA...,2,-20,-7,13
VIPEabNAgWHFTBfKQcOXGCdDMJRYSeZLU,HCCATEDAKHFG.OFBCCHHH..DACDMBAHJAFF.REEC...eEADhAAALFAD.IHCBhAAAaDBEAADHFCHDBHEFQFGGhABAXBEAdHCHYBBESAHF.hABA......hACA...,2,-24,-24,0
VKdUTgOQNDcYMPIXGESCFZBafeJRbWHLA,KBBAdEFHUEBAOHBEDCAG..MHFG..XAFDGAGACEFDBGHFhAAAeEAB..REDDHADHhABAAEEHTADF..NIDF..hAAA.cFCF.PDAGIAHC.SFADhACAaDEA..hADAfFGF.,1,-16,-28,12
XaMbJAYUHBCWLNZgIPTGfOdFSRQDKeEcV,UEBCCAFALCEAZCAG....IAFHGDADfHEDhAAAdDFF.SFFGhABADHCAKACDEHGGVABGMAIHAGCBBEGEhAEA.NDIC.TEDBOFAFFFGA....hAAA...eHAG.hAFAaAGDbFCH.,2,-18,-16,2
OWDXZJQSCeYTaUGLdgIABfRVHcPNKEFMb,BCCFVBFC.HDFE...NFBD.KFFB.FACCOAFCDIEAZGAG..JHDEhAAACDEA.eAED.aCAHGAAGhAAA.dEHEADDARFGDEEABhAEAMABF..XDCHSHAA..hACA......hADA...,1,-23,-26,3
AHQCPIGecZUOLdKbaETJSBNfVWXYRgMFD,CCEHGEBAZABCLAHBKDFCEGGF....SCAGBGHGVGBCXAGGhAAARCAH..FEFDDDIDhABA.QBCFhACAIAFHeHFGcEFEOCCDbEDFaFAH....hADA......hAEA...,2,-24,-15,9
RgJPMHZfeLBAVDWXNGQIFaOCUbKYcEdTS,VFFAXGDE.GCBDFEAG..OBDACBFGKDFG.EDFAdABH.SEAChAAARDCH.JFADPHAChAAAHECC.eABCBCHGhACAAGADDCGANEIC.aHEC...bBAC....hABA......hAFA...,2,-16,-14,2
caQOWdfFgSBYHRLbDTeKNPAEUJMVXGICZ,EDHBMBBEGFABZDFE.QGGFOEDFdAHAFBBFBCAGHBDELEABhAAADDADTEEBKHGEACDAJAHF.hABA..XDBChAAACGCCaFGE....fAFGSABE..hAEAbCCG..NIAH...hAFA...,1,-1,-23,22
TgCFNbIKZOaQSAMELePcdfUDBJGVRHWXY,MADHeEGBdBAGDFEGBEBGGDBD.HBGF.XAEHTGGDCCBFFGAA.hAAA....NIADKFFDhAAAaAFBACHDEBCALDFAhABA.fGDD...JHAG..hACA......hAEA...,2,-41,-8,33
cGfeUOaAWLITHPMXYBRCQbJdKZFgVDSEN,LHDCHGEEXCCBBBDE.RFAG.CCHA..JCACKBAH.FABADEDCEEFGGAFAhAAAeAFD..OBHHhAAAaEAE.AEAH..TEDDhAEAMFIF...YHAAdHABgFFE.hAGANABB......hAHA...,2,-29,-2,27
YFgWSVTDLMEHZJRBeOUabGNdACcXPKIfQ,XCDEKGFDQBGDFEGD...SDAATGAELBBGhAAAHFABRADFBFCEeFBEOAFFhABAaEGEbAAB..GDDDhADAAIDCCACFIHHBfHGHWDHBMAFGEEEB...hAEA......hAFA...,2,-21,10,31
NURaMHgXPJcCeFIYKADfLOZdQEVTBbSGW,LFEBdGHEECDBBFBDSHBEGCFCUBAFaACA..HCDA.XAFBhAAAJHACeAEEIFCBhABAKBEBAIEA.OBBHhAIA.QEGE......hBAA......hBCA...,1,-15,-35,20
BdaDJWVTbENePSILcKYOMHQfGRFZUgCAX,dHGFJEAC...TAAGEHEC.eFAE.SAGHIHCHLEEEhAAAKDBCOEEEMBBEHADDhAAAQAGERGAGFHDE.hACAUGGAAGGABDADDADEWCAGNAIG...cGAGhABAfDEH..hADA...,1,-8,-23,15
dWGbXTDOIBYeFAQCRJUSLZcHMgEfVNKaP,CBHHJBCFLAFDZAAD.HCAEMFAA...EEFEfFGG.hAAAKAAGdGCHGEBEbAGFDIBChADAOEEGBCEFFHGGAFIFQACChAAA.SHFGcEECgAEEhBAANEAA...hAEA..WBHH,1,-16,-22,6
RUJfOeXCKGgbVdLBFcDZYASPTaMHWQINE,TGCCMBAHHBFD.QDCDEDCHUDFGOCAACHFAKFFC....hAAAgBBAdAGGFHGGZFAFhABAAEIBaHBGIBEC.hAAANAIA.fAHG.eEAF...hACA......hADA...,2,-20,-9,11
bAJEDIZTRQcUCWKgaNXfBHdPGVSYLeOMF,DBDHTFGGQGBD.UAEDCDECKDCH.aAHD..XGGBhAAAHAAHdHAHGBGESEAFhAAAeCBHFFEBAHIDJHEAICAEhABAZBFFRFCC..cADC..WEDC.hACAfABH.hAEABAHE.,2,-26,-1,25
eAHTRLfCWYbcSdaZDFIOKQgNVGXPBJMEU,RECFCHDC.....bFFCSEEE.ZAEBFHAAOACBKBFDQDAEhAAA.NADD.XBGGhAAABEGH.JFHDEACBhABAAFFDHEBB..fBGDYBAD..hAIAaHACIHHE.hABA...,1,-24,-36,12
FaWNBLCJZHeDVOPKYdIUgSbRcTEGMXAfQ,QABFaCABBBGHLGDAJEED..HFAEDGAB.VBECODCEKCAAdGHEhAAAUBDH..SDHBhACAREFGEABA.MAFGhAEAAIBA.FDCDCGBG.eHEAIHHC....hAAA......hABA...,1,0,-36,36
DZFBEbcgLfQSNMaTGOeWXIHAVCPJdRUYK,VCDACAFHdHAH..UBBCKACEZFFC..BHEEEHBC......bAEAhAAALDEA.SAGHhAAAMIDCTFABhABAeEADIEGEHECDAHGCPFFGRBBHDAID...hAFA..cBEC.hAGA...,1,-17,-30,13
LNOKEMAfTaUXbHBZJdScCReIPDYgWFGQV,TBCAaBAA..UGDFHCFBBEFGdFBCCCEHeEBEDFAF......hAAA.gCGFhABAFAABQGGFLAEANIBBKADChACAACDCXGACJEEH.SDACcCBC.hAGAIHHD..hACA...,1,-13,-36,23
bBdGXDgHEIOVLFZRNAQSJTeYaPUfCKWMc,SEDGJDAG.eDAHaGDDUEFC..CEHGKGDB.MACABHFAhAAAdBAFDGAFEGAHOFHDhABALCFAFADHZCFAAGGB..hACAYAEG..fFBCWDCD.hAAAbAFE...XEDChAEAIHHA,1,-19,-40,21
XVRScZOaQBWMTdYFNGCJPKeAgDHUfILbE,HBBGUGCDLCECEEDDRBGDZFFD.QDFDBEEBMEBBdBBF.FEADCCADKAEChAAAAIFC..DDID..fFHAhABAXGGASCCDhAAAaAHF..WFCDYAEA.hACA......hADA...,2,-22,-21,1
FYWLNCUgfXdaHbJGZSDMRIQcAPeBTKVOE,BFAHTDDDOBHH.FFCDLBBH.UCGBXADFdAEGaFDEhAAAJABHSHBChABA.MHEAQFFAhAAAAAGGKFBC.EDEBNCAGfAHAbFDHDCAF..cAFGhACA....hAIA...,2,-37,-11,26
HFeTdXbRPcKfIOZMBYESQACWUNVLGDgJa,UDAGVFEB.DHCA..JAAAFDFG..dEAHRFFE.KBGE..OHECBHAC.hADA.EBDFAGAA..CBBDLAEChAAAaDEB.HDDFhABAeFCH...XCGA....hAEAcACCIHHCMAIBhADA...,2,-38,-32,6
TaRLWVBJeFIPHKGXNgAdEcMCbZSUDYQOf,EDCHMCDFZBFADBDC..QGBGOCAB.aGEEREFBLFHB.hAAABDHGFBDFHBABKBFGGEDAhAAANABBAAHHCFEB.UGACfEGHhAGA..WCBH.eAHBIHHBhAIA.....hABA...,1,-8,-22,14
ZWMYeNdGERAOUcCBfbLIFSgTXVPJQaDHK,UBGHCDACBECHLFEB.FCEBSBFH..XAABhADAPHDC.aEGHKGHFMCCDhAEAeEEGdHBFRBCC.ADDD.OGAChAAA..fFACIABH....hAFA....gCGHhADA,2,-37,-35,2
QUKLVdRAFWYHNMSbPBZGXCgEJTDcfaIeO,FBCFHEFAMEIFSCDBBEDG.ZBABGCFCXGCECFBB..EHBEDFAAhAAA.aAGDOAEDKHGEdDFFhABAAGAF....NABA.gGADhACA.JCCHfHGDIADC.hAFAeHDG....hAAA...,2,-38,1,39
TPOXHGDVZMcWaLEeBNRfdKSbFIQCJAYUg,UGBCTCCAOEDC.HBBFDGCFMBAE.aAFGEADD.BFHHRBGFdFGChAAAKGGFFEABCAAC..JAHDAEFE.hABA...PFDBhACAXCFD.ZAEDWFHHLEAF..eEEBhADA.....hACA...,2,-21,-12,9
UJgGMKaSDLVcXReNHWIATQYPCfOEFBZbd,TFGGQEAE.CACE.EBDFBHACdBBGJAFFGCFC.KEHHDHDALEDDhAAA..cEDBhAAAeAECHBAAACHH.fHGBhABAFHAEUEAHMABAaCDESAGAhAEA......hBAA...,2,-25,-12,13
TafcgPROeJdSZKbXUIBDHYMQEWNGVLFCA,TADHaECC....fEGF..PBAFRAEBJCBCZAGFhAAAKGGGXEGCBACGDIFGHEAFhABAQBGCEGDH.hADANIEHLDDBAHHE.OFABSDEAhAEAbGCC..YCCFhAAAWFFG...,2,-24,-10,14
RNcfdYMLOBXaDWTQZVGKbCgIFESeAHPUJ,UFGHJEEC.RACE.....NGCB.dCGALAEEOHACBDCCDDEG..hAAAQAACZEAAKCAC.hABACHDAFFHDSEEDhACA.AGAB.PDAE.fBFBMIECXDEBhAEA..aADH.hAFAWBHH.,1,-26,-47,21
ZMRaCFAQDYgKWJSGVEeNPUBXIcLTOdHbf,DIDGKGHB..SFFFGAFAeDADUCEABAHE..XGDHhAAAIDDFLAFAOFDCdBBFhAAAfDBFMECDaEHFhABAAGAHQACF.WCHBEHGC.cGAEhABA.....hACA...,2,-26,-18,8
YGBWVLRZDISNXeETdFOKQbaPMJCcUAgfH,HABCGGBHBHDGLBEDZAFHDGFCSCBA.XCGAhAAATFBFFCEBKFGGQEAEhABAaHFGJCAB.CHAGAFFAfEFDhAAAWAEE.IHADeHEAEFDE...hABA......hACA...,2,-32,2,34
MbeKZATXcfGQYWaLRNgESVPCOHDUdBIJF,TCFEXDDC.GCAGQGGD.aBCFNDGA...EEADSBAChAAACFEDDAABBBEEJHACMBBDhABAeAFGAHEG..fHBHhACALDHDRADH.VFDDOFFG.dAGBIHHFhABAKECB...hADA...,2,-15,1,16
aZCPKLRASGbQVJMefTBUOWdYNFcEHDIgX,GDECVCEB.eBCCBHGDOEHFdBHE.FGDDEBBHDEAA...XAGChAAACAEAKGCCAEHB..QEAChAAAJECBMFAH..fCADhABA..WGFEcGGHIHAChABA.aHCC.LACHhAEA.,1,-12,-36,24
cZQGXdLIHODPRMCTfUNWBaAgJbeEVFYSK,JAEFeBCG.FEBBKGFGZGBGGBGGLDAC..HDDBDDFDRCGDCGCHUGAEhAAABBAF..AAAG.EBAC..hABASGFAQDAEhACAdAGDOAFGMIFA..fEDCNADGaHGE.hBAA......hBIA...,1,-10,-22,12
DRMJCFdcOZVeEbBAYGKWfLNXISgHPaTQU,KABGLDCH.XEAGIHFB.HBCGaGGH.QEEDhAAADBGHMFIH.FBGGdBEAODAChABAeHACBABFAFAHGGAFfDABhAAANDIC.SGEF...hADAgACF.hAEA..PEFA,2,-19,-13,6
AObLgGSWUXJfZdTBaREPQcYIDKNFeCVMH,OAFFLEAHGFDDUBBC..JCFCdBBCBGGDaHECREBC...QACGhAAA.IHCGhABADADEKEFGNEDG.CBAD.MBIFhAEA.ADDG.SCEDfFAGEAFC..hAAAYEEC..hAFAFHEC..,1,-20,-37,17
ZNVAgeWKXISLMORcQbGUCJaHDdfPTBYEF,eADFXEEFLGCERABH.QAFGGFADUADCCEEHHCFCDHEAdGGAhAAAfCACBEDGFDHBNACG.hAAAAICA.KHAG..SBFBhABAcGGB..aFBG......hABA......hADA...,1,-9,-23,14
TWRGYUFcZPIeLHDQgMbVBXKJNOECfdSAa,aFBDTEDBGCAA.FAFCZEAH.eCGHHABADBDHQFGAMACDBCFDhAAAXEEBKAGA.NICD.hAAACGHDSADBhABAAADA..YCDD..cGCFIDHBhABA.....hAFA...,1,1,-35,36
GcPIZMYdCNQgTBUWfJOKAVReaHEbXLSDF,eHAAHBEAEAAGLABHDEFEFHDCGAFE.IFHGZDBGMDAHdEDDCCHH.hACAQADFBHGGUFFDhADAfEAEKBCH.hAEAAEHCaGFHSGBF..YAHHhAAA.gGGGhAEA...,1,-12,-19,7
WFZYNPACUTOVdLRbGISgefMHXDBKEcJQa,CFHAUEBH.ODHDLEBCGGDBSBHF.eFEHMDCGDGCDhAAABEEAKBBC.JBDCaBDEFCABhAAAZAFB...NDAFAHHAdAHEhABA.IHBB.fBBDXGFDEDHHhABA.WFAD..hACA...,2,-26,-23,3
agTCRAMdDKGVOFSQEfJXYLZIPUeNHWcBb,DCAHGEEGODDDQABD.EBFGJAFHXCCEZABEUFFFeDHBhAAAHDABBEBG.aHGGCHCAMIEChAAAdGACKADC.FFCDSBHBhABA...fGAGhACA.ICCANBAA.hABAWEHB.,2,-39,5,44
SQcPZNdfGWgLeIRDUaAVOMFBJbTKHYCEX,MEABBACCJAECKDHHHBBF..EDEBQGDAZEGD.dDEBGECChAAALABCeBAFDBHBAECHFBHDhABATGFA.XGBDhAAA.SFBC..NEBEWCCEhAHA...gGEFhAIA,1,-21,-29,8
MURIWSNGBXHafAQVedYCLZKOgTJDcFbPE,QECEdFGBLEACKBECOFCH..TGEEJFED.DCGCFAGHEHAGhAAAUADARBBG..IDADhABASDGCBFAEaDDAhAAAADHGVEFE.CACB.cBAG...MFBBhABA.....hAEA...,2,-23,-23,0
bNLGQFKcDRHBIfOWAdeJXVPEYTgUZMSaC,JDAAXBGB..VFCAEFAB....TEBGZACASCCEhAAA.CGHC.NFEDQGGGhAAAKGBDDFAG.RACGBDDBhABAOEEAdCAGeAEEPGDC....YHFAhABAMICEaDGELAHBhADA.,2,-31,-2,29
fBFWYPbXCOdEJIKcZLaVgGQDSTHMANUeR,UFCDRBGBFHFC.....PBBACBACECBH.KGHFLGEC..aDFBhAAAVADGGCAC.DABGhAEASDDGMAFCADIBeCDHhBAABGAH..WBHFXDFD.OAAAhAGAIHFA...hAHA...,1,-22,-33,11
TRNAOMDFYGBPZKJWVSXcEIeLgdaUQbCfH,MAHHFGEFBACDKGBE...JECBSECE.EEHFIHGDhAAA.LBEEdAFAaCACbBBAhAAACGAAHEEG.TCEChABAAHEBDIBGPDFD..WDHB.XDAChADAeEAG...gBBGhAEA,2,-31,-25,6
LWVZgcBFKdPaCRNMUISXGJEebYfDHOTQA,VBBCZCBABGFE.dEBDCAHD.RABC.UEAC..SHAEGDEBEGHH.hAAA.eDHD..fFGChAAADDGHOFEHAIFCLCFChABA.WEDDcBGAKADCNIAFXCEFhABA....hACA...,1,-15,-39,24
BRPbZGcWLJQdVefHEUAaTOFCXSYgIKNMD,TBAAOCCEFGDA..SAFA..YDADKEFBDEBCRCFGhAAAZDFGGADGLBAGhAAAJGACdFHCfGGDhABAEABEAICC.CHBBXBFFNIEF.BHDGcFEH.hACA..WFAEeAHHaAHDhADAMIFG.,1,0,-22,22
QVHDYWefBZJUcMCGTgPNKaOIXSAERdbFL,EBCBdEFBLAHHHBEDDHCE.eFGDBDBBUDAGMFAFGBCD..gCGHhAAAKGDAaGAAOABGhAAASGFD.AFFA.hABAFDDH..YAECWHBG.fGHGhACA.cEBE.hAFACADD...,1,-13,-19,6
GAUXLSgRCPQcYEBfOMFeHJaWIVTNKdZbD,UEEBXBABLFHDREEE.QAFGEGCABHGG.MDCGeFAF.aHDEhAAAIHEA.TBABhAAANEADdBHEDCGBGEAGhABASADBCDHC.YAFEfADEFCCCWEHHhABA....hACA...,1,-8,-17,9
ZeCDMUKVQgTBYIOfGJSREFLadHPWbcAXN,XECAeAAFCEEC.DCBEUGFH..KBGCQDBEBEAH.OBFAhAAAfABBGGADRFFEEHEChAAAFEGAdBCD..PGAEhADA...cDGCAAFA.ZAEDMDEAhACA......hADA...,2,-21,-21,0
AZOeYTPaUbHEVCWdSFNcGMLRgDXJKfIBQ,eDBCTDDDUGFD.HFAFCBFHdFGDFCFCGDAGLBBADACF..KHBGBACGhAAAAADHZAGHOFFG.hAAAaHCEEGDD.SHFGhABAMBAHRAFE...gADH.fDFDhAIA..hBAA...,1,-10,-24,14
HgeVDAcMXYNSBROaCFEJKUIZGfTPdbWQL,MACHXADB..SDBDREDB.aGAHCHGBEDBB.KCGEZADA.hAAAfFFFdBCCQGBFhABAHCEHeBHDDGGEAAHFNBFChACABAAH.FHEA.IHHD.GECGhAAA.....hAGA...,1,0,-29,29
aQfEXMHbKLPASCTdIWUeBDROGZFcJYVgN,CCAEdBBBUEEEBGDF.DHFCRAEE.ZEFG..FFCG..JFBD.....hAAA.gGADhABAaAHDQDDGEHCEHGFCKAFE.hAAALADDAIGG.IEHAeEAC...hABAOABFcAEC..hACA...,1,-18,-44,26
AHGQfDMPOXCcZYLdVEJBeURbKWaTSgFNI,HEDEQEDDMHDCOAABCAHAZCBB.LCHFdCHCEGBF.BBFD.RFAAKDBChABAaACE..SGDHhAAAFAFAACCADIBA.XGGHhABA.VBEF.eCAHUGGE...WAEDhACA.....hACA...,2,-12,-12,0
caBWVITKdGbeOFQZXECADUMJYLHgPNSfR,DBGBUEBAMDFHLABHHEBD.....PGFAfBCA.hAAAaGHFVBFGKFAFdDHEeADAhADAOBADFDFH.XGFDhAAACHAFAFHC.JAEBNEEG...SHCAhABABEAD...IBHGhACA..,1,-6,-28,22
BIWOZSLFDHdPQbGKTEcJAYgRMUCefaNVX,RCEHCEGE.eCAE..aGGF..XECDBCDHOFBFZEFDFADHHAFDdEABQAGBhAAAKFEE.hAAAEFAHABCBMEBA.fADAhABAIHDDWFGHDEIBPFDH..hACA......hADA...,1,-10,-38,28
fHecQAdWVRYZgbEJGDLNXBFKOUSCIPaMT,dEDGVBCBZCAH.ECEEDCBBLEFFBFBE.FBBAOBGD..SBGChAAACAHE.IDHDhABAPFHD..TAEEhAAAfADBHFDDQGADAGIB..hABAWFADYFFB.hACA...,2,-36,-22,14
KPYfVQdbUFODeAIMCERgTLcSWZaNXBJGH,CHDHEFBHRCEC.LHCA..SFGEZBADaBFBBDGDGFAFHCCDKBAHhAAA..fAGBhAAAVADGdCCCFHGEDGFAAFEBIBHAhABAMFFG.....cEEHNABD..hACA......hADA...,2,-24,-12,12
BQabUGPeMLENOIRdWgJfHFTVcZYXACSKD,KBDHQGDDUCAAGDFEMDABLEEE.OCBGdGAAJFHDFGADhAAA..VGCCZBFAXGGBhABAAFDG.DBBEBAHAhAAAaEBG.eAFHNDDH...IABC.hACA......hADA...,2,-30,-12,18
WMPXUgREVbdGBQOfHcTCeYDaSLFJNKAZI,ZFCFMFFEUBGERBED..EBBEdCCH.BEEE..fGBFHFAFCCAEDEGBhAAAaDDH.LHAGhAAAFABC.KGGGADAH...IFAFhABA.XDAA.gGEFhACA..bEGH.hADAOAFH.,2,-39,-7,32
NSIUfPRaYGdZOgCDAMXBJHVbKELTFQWec,MEHBXGFCBFFBHCDDKBAB.LBAD.TGBEQAEChAAAeAFCSEGGhAAAUEBAPAHBRBGFaFABGGCFdCCC.hABAZABH...CDFCDIGGAIHC......hADA......hAGA...,2,-24,9,33
BDfLIAePOGJTdQCYZFSRVaUXbMcNKHEgW,OBFFGBEBdCCA.QEEGZABDFHFCSGAGaAFA..XBAFhAAAMEHDKAECEEABBFFFhAAADGHDLHDChABAADED.eFBHTECHCADC.....YBADhABA....hAHA...,2,-42,-3,39
VNCcKDZTSbJARBgLQWfUOaGeYEIdMFXPH,RAFHBHECLGEGQGAGUCCHGABDECCFMFEAFCAF..HADCCFAH.hAAAKDGEDIEETBAA.hABASGGFbEFC.hACAADEHWAACOBHFYEAAdHAD...XGCBhAEA...hAEA...,2,-15,-2,13
gNJWYTIdeFGBLAKEPZCOfSRaVDUcQbMXH,EDEECAAD..OCECSGDDRCBH.DCCFUEFHQCGB.MBEAhAAAHGAG.JACCYEADhABAIBGB.dGGDFFGChACABFABKECGfACF..aAGAcGAEhAFA....hAGA...,1,-24,-31,7
LPSfOTFUXMeAVKYNDaQGBICJdEHZgcbWR,VBBCKAECDAAG.GEBHCHCD..dEDEZEGF....bGFELHDAhADA.SCGEhAHAOAEEFFAHMDDAAAACaCFGBGFChAIAEFFEHDFCgBBF..cCAHhACA......hADA...,1,-21,-23,2
XEJdQCTeYfZgWbDPLaONIVGASMUKHRBcF,MIDEKCAHHCFCBCDHFECC..EACAdGCB.QFFFCFFD.eAEEhAAAfDHCZABA.bEBChAAADIFG.LHAGhACA.NEIC.IAHGADCG.SGHBhABA.cGBG.JAFHhACA...,2,-44,-8,36
ePQcBIKOUXHEbSANZLdgFWGRafTCVMJYD,ZCFAdBGFFBBF.GDFAfGEC.CBGA.MDBH.DDDDQBCDhAAABADEKCED.OCAFhABAHGAGSFEDhAAANGAHLHACREFDaAFG..JAEE.eHFAIHHF.hACA.EDDBAIEC....hADA...,1,-5,-22,17
IFNWTcXVZPEKBDagGMAUHCdfOQSRbLJeY,CFFCdEGE.OBFERAAALEHD..JBAEeFABFDAA...TAEEhAAAXGACZCCDEDAG.DGDBhABAaDEBMAHDABFA.UGEFhADAQGDCSEECIHHB.NAED..hAEA....cEBDhAAA..,1,-10,-34,24
HRWXSPZEBFgOdVLNYGACDafUIcbKJMTeQ,aFHBUCDE....IHBGKFGHJBAD.eDDBHAFD.READ...SAAEhADAEFDFBEHBFABAhAAAgCFE.dEBChAEANIDD.AGFHDCCA...bFFHMAIBTAGC.hAEA......hAFA.WCCD.,1,-15,-27,12
QMREPBXbZUJLFfSgeHKIdWYVGDCATOaNc,aDCAQFAG.MAAGEGGCBCHFZDEELFGDFAAA..SBEEhADAgAEEKFDHdGDHhAGAVFAFDDBCAFCG.OCCAhAHANDFA....cDBC....hAEA......hAFA...,2,-40,-14,26
bOQFZEHITUWSGPgdDVNaeMAcLCYXRKJfB,LFGHCADBRAFH.KAEABCCDQFDDEEEHHFBDUAAHGGEH.dDHChAAANDAB...aAHDMCIFhABAAFAC...XGAGhADAfACGFDFATEACPBAHDCEF...hAEA......hAGA...,2,-21,-14,7
TWAHSBFPRINKGaQceZbgOUXLJVEfDdYMC,SECFBCECRCGBKFAC.GBDH..aCBCQDFHZFFF.bABChAAAOHAAUGGHLFAHhACAEFDG.DDIFMAEChAAA.CACFAEEAFAGA.PEDD..NBED...hABAeDAC....hADA...,1,-3,-36,33
fYVXdZDRIOPWJTeaHSgGNcMEUCFBKQALb,LBEA..YDFGVEDEZDGBRADE.OCCB..JGFCaGBChAAASCEA.hABANDCG.MAEA.CHHBBCAFhACAABAHfAADDDBB.WDAD...eHCChACA.....hADA...,2,-31,-31,0
UdWDAHCbgLNcMSeXGaIYPBEQJTKVFZOfR,HEECCECBLDAHMCABSDCFGEGA.aHEGIHDH.BEFEhAAAEAGHJBBAKHAGFAFEfHGFhAAARBCG.dBEEDACEhABAAHCBNAICeFFD.PCFC....TFAGhABA....hACA...,1,-15,-16,1
gOQeNbcWPEHMJAfXUKBZSDTCFVdRIYGaL,XDDAKFEDZDBEDICEFBCA..dCFARBFD.GDGALHEA..QBBEhAAANEAC..bAABhADAPAEAHFBGAHBEBHBFhABA.SAHHCGGF......hACA......hADA...,1,-18,-31,13
QafDKHCVYGSJecdMTNUBgEXWRFLObPIZA,aGAEDIFECGAEGCDE..JBEEeEAE.dBBFMBACUGFE.BADBEEGG.hAAARBGHFAFFLAHB.hAAAODEF...hABAIDAAACCH.KCCD.HEBC.SHCEhABANDIEWHAA...hACA...,1,-24,-29,5
OBaCEAZSeXLgdDFUIQPRcWHGTfMbYNVJK,eFEDLHDAdBECDIGEUBAC.QCFBREAHHFFAGABGMGFA...hAAANBAC.JEBFBCHHCAFBAAHDZACFhABASGBH..hAAAgECBIAHDWEEEfEEB.hABA......hADA...,2,-18,-16,2
bafJLZWXUPOgCNeIYTdAKcREVQGSHDMFB,RFGDEBCDGDEDHEEEDHDABCEF..aGBFJFBBLEAGZABD.UGGBOFDDhAAACAGH..eCEGTAGFhABAABABKGAD....hAAA..cADGSBBDMDDB.fADBhABAWFFD.XDGAhACA..,2,-33,-2,31
EcbROUDWFYANJdfIaZXCPBTMHegVSGKQL,JGDGdDEFaFAGZCAD...CHEH.BHGGHFCF.eDAESDGGGFEBQAAChACALABEEFBAbAEAhADA..ODCGDCCCFGADhAEAAIAA.IHHC..XAGGMCIF.hAFAKEEG.....hAGA...,2,-36,5,41
gPdCfYOMbIGREQTFBDNWVSXKHAeaLJcUZ,aDCBJAGBZDBG..dFDH.CDAH.OEFE..MBIDGGABRDEEEHCAQABAhAAABGAG.DIGAhABAVAFHKFCCAGEGLABGhAAA.UGGBfAEC.IGGBhAEA..NCAD.SHDAhAGA,2,-27,-22,5
ZGNYXbOWDKSCdMgaQEeLATPIfUFHJBVcR,TCGH..PADAUBACHEEEBDDDRBGDZDAGGFEB..XGEEhAAAOBBEKGBBdGABMFIDhABAaBAH.EACGAHAFIHHFhAAAfBFCFGDH.......hAEA......hAFA...,1,-12,-26,14
IdGaMbUcROFTQVDENSLeBWAJYKPHfZXgC,KBBCHDCFZDACXFGB.CCAD.IFHGGEEAMIBAUCFDOFBDhAAAQABH.VAEGhAAAEAFCLFFFBDHDAIGAPEABhABAfBDA.aFAB.....hADAcBAH...hAEA...,2,-25,-3,22
bDTdGNZXYUSBKROECIPWVgacAeJLQFHMf,LFCHHDACMAFFDGFBGGDHZAEGUEEBBCAF.OAGBEDAH.CAAE..hAAA.IACGVEFEaHAAhACAeEHB.FCGCfEDAhADAdGAA.NAIESBDH..hAEAKBAA.WDCEAHIB..hABA...,2,-26,0,26
QReSYcTFCLfJUHNIEAbBgZMVXGaWDPKdO,BFFHZAEFMDAEGCGADDHF.KEDE.dGCCOEDA..eABASBCGhAAATGDCLAFChAAAUGBEIHHBEBDFAIFG..hABAVCADaGFGQAGH....hACA...YEBAhADACCFC..,2,-19,-15,4
eSQJPaMbVXNWfFHgEcAIUDGOZBTKRLdYC,DEABZFDEKCACRDCFLBFHdCDE..CCHA.QAAA..JFBHPDHBhAAAMFHD...VGAGhADAXADA..hAAAfADFFDFBEHEGAABDUDAFBGHHeFFF.hACAaCDANEIC.....hADA.gAGC.,1,-8,-21,13
GbBQYOAXCFUNgdeHRLEafIPVWKZSTMJDc,FBEEUDAHdEBEeFDFHGFELDECEADC..aFDF..fGGHhAAA.VACGKAADSHDGhABAMBIFDDDHbFEDBHBGhACA.YAHDAAGCCHBG.NEEFRCBEIBAFhABA..WFFC..hADA...,2,-21,-7,14
dDIcMReUEPNBVTaHQfAWFSXCYZJKLgGbO,SAEACBFFZGEELDBCGEGE.dDBADEGDMEDAUAGE..NIBH.BECEhAAA..aFDFHFAGhABAABBFFAHFJBBAKABC..ODHDhACAIGCG.eFFD...ECCE.hADA..PFAB.hAEA...,1,-5,-32,27
JecKSEGfOTNdUZMFBgRaQPCLbWIAHVYDX,VGEAXGCF..JEDAKCCH.GDAE.ODFAdCEDMFCFFEFDBFHChAAAaDAC..QAGBhAAACCACLABAbABFIAHFhACAHDGH.DGAH.SCED.hAEAEGHFfFAGhAFA...,2,-25,-14,11
PWXgbKFUNMafLQCScGeJATVIDRdEHYOZB,VFFARDEGECDF..HEBAZDFGBFAC..XBBFKBCDFAHF.MIFGLFDFhAAACBHEGGCD.ABGFIHADhAAADEBEdADHODDGhABAPCAB....gGAFNDIAaFFE.hABAfCAC.hACASCFE.,2,-24,8,32
ROEFJZBDSgXAdfPbLeCUcVKaYQHTNIGMW,dHDF..fBDGLFDEeCGDUGCHVAAHaBACHAFG.IDDHhAAAGBGEMBFH.hABAOFGBEGHDZEAHDFFBSDAEhACAAEBAPFADCDDGYBBCNAEH...hAAA....WFADhADA...,2,-14,-6,8
JSGPQDLIZaAgcFNObHBWUMTVfEXdRCYKe,FEBHOCAFHBDDBHCFMDAD....fDGDdGGHRFDBCCCG.eAFEhAAAJCHD.GFDDDBAA.LCDBhABAaHBA.ACFANBBD.hAAA...WDFF.......hACA......hADA...,1,-30,-31,1
cDBSJOPTQFMNgZGYRWeAECaHIdVbXKLfU,EDGEHBFDdGEEVEDC.KACFLBDE.UAADDIECSGADhAAAJCDB.OFBFPHAChABAFDAHMDABZDGB.REFEACFBIDCChABA.fBDFBHHC...hADA......hAEA...,2,-24,-14,10
GQPHXbRBOeDcETVJdZFgfNaAMUKICLYSW,MEFEUFAFKAEDLADC..SDGGQEBAHDBCRFFEOHCGhAAADFFAEHGEVBAEZAAEFHDChAAA..NDDFABEACFEG...hABA..YAHHWBFA......hABA......hACA...,1,-15,-24,9
fOEPHVSJdACDXKgaGbcMIRZTBFQUWYeNL,DBGDXEGCKDHHGBAH..MFBCRDEBBAAAUCCC.eHCALEAGhAAAOGAAEGGFHBAFSAHDhACAdGHEAFFBCACAaAFD.hADA.IGAFFBHF.......hAAA......hABA...,2,-28,-13,15
AeVfFgabDBYIUOZJRKcTXMHLWGNQdSCEP,VCCFFDFF..aCCGBBGCUFBAZGFG..KBGE..XEFFMEEFLBBFhAAAGAAHQFAAhAAACFAG.AAFFfFDFhABAbFFGDIDA.IDAAJADG...hABA......hACA...,1,-19,-32,13
WQFeaEDSBXMZNPcKGATOLVCdJYUfIRgHb,OGBCCBAGdGBG.UCCDRECAHCAG..QEFAFGEB.aEAHEBEGDBDAhAAABGGDZBFE...PDHBhAAAKCABAFHE...TAGHhABA..........hACA......hADA...,2,-37,-31,6
LXDFNQSUKATbdBcERWVaJfHgCZMeGOIYP,dBGGBCEGEBDCRDCF...aFFGJFFD.HAAFZDDBMDIFGADD..OCABhAAA..IEHFhAAALHEADIAAQGAFhABAKGACAADC.TABEWFEF....fHGHhACACHCH.YAHBhAGA.,1,-9,-41,32
URPVEJOBCIKFMGNWHbeSLQfTDZYdgAaXc,XACEUFBFRBEH..ECHFBBAD.KFCGMFGHGBGEHDAC.SABHhAAAQGFHDGEHZDABhAAAdHADaDEB...cAFBhABAPADB.JFHFCFFFNIADeAFE..fDCChACA...hABA...,1,-11,-13,2
NMeYKUbCPHRISBLdOgcAWaGVDXZETFfJQ,GFDBXECAECGBFBDAQDAH.MBBGKABDCHBH.HFFDIDDDhAAALFHBdGAAOEHFhABAAGACaCDCDCGHZBCEJBHHNADB.hACAUCAB..PHCE.SAHHhBAABEAH.....hAAA...,1,12,-23,35
KJfWYEeZLROUGaANBMXHdTCVQbDSgIcPF,MFBGHFAATDCE.CCCC.QACF.SBEAhAAAIAFAFGGGfHABhABAEEFCZCFEOBAFUEECGBGEhADAAHIFBAAFXCCCbGCADAED...gGFAhAFAKAHD.WGAE.hACA...,1,-3,-10,7
eaJUdBPMKFDZEIGcORHTbVfSXALQYWCgN,LAABQGGCCHBF.eCCGUCDAdADDBCGDMEAA..KACDDFECZFDHGGADhAAA.OBFFhABATEAEfHEHhACA.ABIF.YFFE..WAGBaAEGFAHBhADA.IHHH.hAEA...,2,-29,-18,11
JCcGQAWRINVMSTKXFeEOYbPDULZadfHgB,RDAAVBBEMDID..KHBGFAAA..eEFHOGBC....YEAAhAAAPEEFLADHhAFA.aAFDdHEHfGGDhAHAgBGEBDGBCDEFcDGFAICE.IGAGhABA.NACH...hAHA...,1,-21,-35,14
AYHRXBgDZVEOFSaUQKMPedbIJcTLGWfCN,HCDHXDEDDGEFEGFCFHDA....UAAHMBCDeFBEdBAA..IDGBhAAATGGGLAHDhABAGEACCCHEAAHDBAEA.gDAChADAOACAaFCDQGAH..hAEA..KAFB...hAGA...,1,-12,-17,5
RAVebgIESLfGQHKOdCMZNUXcPYaWJFDTB,eABH..bGCGIADFEBECLABG.QEGCOEDHCHHBMDIFhAAAUEDFXCAFhAAA.PFAHWCECFGFHhABADDCCBHHARFABAAHASEFA.fAFBhBAA..KCFGhACA...,2,-23,-8,15
HMcOEVNFgJbIQGSKXDAWCdUfTPaBLZReY,CAFHdAFHUABG..TCCABEHDLCECZCEDeHCEHEGF.MAAHhABAOGEC.EAHDNAIEFEAChACA....JDBAIGABhADAGFADKDFDDBCGABBFfADFaGDA.hAEA......hAGA...,2,-32,-9,23
NYHQPJGXefObgRCFdABVEWLTDaKZMUcIS,EDGATAECDDBB...aDFHMCEH..IGCESAAC.HAEHhADAJHDGeBHHOFEFRDAACHADhAAAFBBFdBABACGDBGAF.hABALHBC.UGGGcGGAYDCBhAEA......hAGA...,1,-15,-20,5
LeafZMQVTEUPbcJASNKOFRHDgBYWXGdIC,KADFOHFERFBFHBEEBGBA....XBBHGCCFIEADhAAALEAEaGFEMFECQEFChAAAEBBEUAGA..PADChABA..cAGAAACEFGEBDIBGWDHBCDHA.fFAChABA...hBAA...,1,-5,-21,16
ZfMVQbPcdRUTgAOHIENLGWKCeFYXSaJDB,OAHDEGEAGAFCKFBA.FCCB..SCBFDEAHBDHGZAAEMFADQEDBhAAA..bEFBhAAAdHGBUADFAIAEHFBBNIEHCFHH.hABAeAHB.aBEHfEEE.cGCEhACA.....hABA...,2,-23,-7,16
cITRZJKPYaAOVgGDFEMNCSdHeUQfXLWbB,VAAHDCBEFADF..MBFDCFBE..dEEDHECA.QGEALAGFBFHHhAAAIADHZCACKHCEhABAaCGHAHCD..OHFEhACAEAGE..SGHBeFAB.fFADhAAA..WFDG.hACA...,1,-20,-35,15
FOQYIEMNCWfXdRGegJKLaHTScDVZPBAUb,UBEDOCCEQGEE..ECAFMBIHCGFFXGDDdABEREAFGDDHhAAAeFCFKAGELHAAhADAaBGHHACASGHHhAEA.DAFCZEFAADCC.YFAB.IHHBhAAA.....hAIA...,2,-11,-9,2
gZVIeKOJAEWLRDCFSXNfYbdUHPBTQcGMa,LEBARBCDCHHB.FBGASFCA..fFFHdAADHBFEBFGAhABAQBDCMIBCaADFhAFAVAAFKDHBAFIFDHDE.hAGANEAE...bEEF........hAHA......hAIA...,2,-30,-22,8
KbNVFWaZAEPHfDGQJMSdIXBeCOYLRgcUT,EADCHGEAGCGCMECBSDGGdCEFBAFHODCFLFAF.RCCC.UDAGhAAAKBBF..VAECaEEBAHBHhABAfACEDFIB.hACA.IGFAXEEGCBBE......hAAAYAHH..hADA...,2,-28,-1,27
IXTENKfFWDRbeVcYdSOAUJMCBGQgaHLPZ,MFAFBBDCGFBD.QCECaCDFHCAGLFEGZBBF.XFBEhAAAEAHDKHFCFEHBWCFAhABADADE..eBEGYCADhAAASHEG.ABHGCHHBgGAGhABAIACH..NAEB.fBFDhACA.,1,-4,-26,22
AGHXagYPVMdDBWCRTObceNUSZQKLJEfIF,GADEaFCB...PDFDMCBCdHBH.BDGGCAFHOHEAeAHDSFGGhAAAQDBBKFDDhAAAEFDCFDAEAICAHFAB.XCGBhABAYFADDFIH.RABH.bADE....hABA.NIEB.....hACA...,1,0,-23,23
DQOSITARZbGeaLHEcPgMfUJWFYdBVNXKC,ZBBFeGEEaAEBLEAD.ECGA..PBFHMCCBUBDAFHDCBHHAhAAAXAAFDHAG.QFCEhADAOFGB.SEEEhAEAAGACRCGHHDDBfDAEYFHHNIBBCBGC..hAFA......hAGA...,2,-22,-9,13
VGROSYNceZFMfBATXbHPIaQEULDCJWKdg,TEAFXFCF.HBFFaGCD.UCBGLHECDGFC.CDFH.KFAAdCAD.VAGBhAAAOHFA.NADF.ZEDAhABA.MFIDBACDACEDbAEBhACAIAAG.EBHBWBBC..RBDH..SEHBhAIA..hBFA...,1,-1,-21,20
IRWKdNBSEMgeJUbFOcQPZLVDXTfGaACHY,CCAGHFFFRCGH.KBEGdDDGSCBB.EDDDeAFH.JBACFFAG.QCGEhAAALEEBDFIBhAAAfACDAAIF.WHBAhABANECC..BGGEMDFF......hAEA......hAFA...,2,-43,-22,21
ATDJbeRVZCIdHFEWUfKMBYPXLcSaNGQOg,DCFDeDCEZECBCCFA.HAECFHFC.EAAB...UEABMGAGBFGA..PACAhAAALHEA.SACFhABAaDHBQBABhABAABDH.JHBA.RAFGdFGDfBHAKECG.cEFGhAEA.OHAChAFA...,2,-28,-10,18
RQIXCGfKeHZNBWSUDAOLgYTPJaVbcFEMd,OAAGLBGB.TADBaGGC...VCBBFEHDMCEA.QDCBhAEAXGGDfAAAhAAAHGAABFAFSAEAhAFADAGGgEDAJFEF.cGCCEBCDIDGChAHACFACKGFDNCICAIBC....hACA...,1,-9,-20,11
eKZNXgWOYVLAMbHdCUTPQfESFRcIJDaGB,MAFAdDEHUEBC..QDGDSADHRDCDJBBADBBC..BGFDZEAF.hAAA.XGGGODAHLHBChAAAADACCCFH.TEGHhABAPHCE..fCAB.FAHDhACAaEEDKFDCWABE..hBAA...,2,-28,-21,7
eTMZWYdQUFHEXRIaCBLPAOGKJbcNfVDgS,GCAGJFDA...NIAH.DGBG.SBFAMGEGZCGDdDEAFDCG.EAFCRAAG.hAAA..CCDC.BHDFAGCCOAAChAAAKDAD..fCHAhACAeFHH.......YFHDhADA....hAEA...,1,-19,-52,33
cMBVNePDCbaAZEdKGRTOIXYWFJQSgfUHL,dDDDRFACOBAD..XAFBFDDF.SHDAUGGGLDFGhAAABCHFeBCGCHCG.bFBBAAIHKACChABA..GEGChAAAIAFGJBAH..fGDHMCCG.NEAG.DGFHhAHA......hBAA...,1,-13,-34,21
MZRKAbCgEUacHLQPfeXJTIFWYODNdSVBG,CGDHUDCDHACELEGD.QAFDeEFAJAGHFEDGOFEFdCAEBGGGhAAAMCIDZEAFAFAG.EBDFaAHFhABA....fACChAAAXCCG.WFADDIGASGEHhACA.....RFAA.hAEAKBAB.cGCA,2,-19,-9,10
IeTVBGcUJEXfNMHaYLSWKCFOAZDPgRdbQ,DGCHREADQGFDeCFGBBBAUBBG..EFDB..XDGFMADDaGHHhAAASEEA.hABAKAGEOEDGACFAZDCGdHCBhAAAIAGC.TEAC..cADDhABAfFFC.YAEDhACACCAF,2,-48,-22,26
NfHMIcYSeLbKaEVQFgUZdJBOGRATDCWPX,CBAAXBACHCGD..MFCD..IECCSFDBLGEGhAAAaBEE.ECHDFADGZBDHJFFFBHBGhABAODCEAFIBDCGF.WAFChACA..fGACcEFD.eCBFbDAD.hADAKAGC.....hAEA...,1,-15,-24,9
UMDgCIOfXSVaZEKJdYHTARQGWFcebBNPL,QBFFFGCHeFEBBHACLGBG.DCBACAFHOCDESFHFZBBE.hAAAKGFHdGGHHDBD.AFAGGBDGhAAA.cDFEhABANEEHMEAC..IACAfFAF.aABEhABA......hACA...,1,-6,-37,31
WHRNdTfXAIDVOEeCUFbZcBLKgYJSQGaMP,VCFDEAGCUGGC.ZEEBLEAE.KADCJABAQGBCGEAAMDCAhAAAHABH.dAGBXDGHhAEAAHGFIHHD.DGGGhAAACECEFHCCBEED.gBDAaAFH...hAGA.WBBG...hABA...,2,-18,-14,4
ZJDQaAKeXOBFSWNgPHUcMCYdITbGVLERf,XBCAOECGFFGH..SEAC..gBGDhAAAHEEFMAADdFBAICHBhABAGABFEEGEZFABDGIFAGDAeCAFhABABAGCNIAF.cDFA.TGCBLCCAfDDEhACA..aAHFhACA...,1,-6,-14,8
FJTeNadAWZRMLVCUOQbIYXKfPBgHDGSEc,RAEGVACEOAAH..QDDD..bDGHXFAFKDFFBEADhABADAGCEGDDFCAC.eHCEhAAAdCDCAFCAMGDGLBBHhACAUCGGIHHAfGAH.gGFGhADA.SHAAhAEA...,2,-22,-13,9
EXZCIUQAVbSfGgdcWDTOYaHJLeNBKMRFP,VDFASBGA.GDCCdBBHDGBA.OHCCHACALFFGhAAA.NBAEBHEEKBEFRAFEFEEHhAAAXGABCEAH.QCEChABAAACF..fHGDWBBDaEGG.MDAEhABA.EHACIHHHhACA..,2,-37,4,41
dYFLEgBXDKcMOZaVQGCfUITJeWPRAHNbS,HFEHSBBCFFBDEHGCBCGD.KEFAMBFCZEDB.aAAEGEBG.CHAG.hAAAUDGC.IDBChAAAeAEE.RDDAACCCNEIEdDAG.hABALCCADAEE.OHECfHCF.hABA......hACA...,1,-12,-17,5
ZCBMcNVfETdXPWLRYJGQaAUgbDeOSKHFI,UBFADBGCeGFCOEABKDED.HABDZCAH.BEGC..MICC..VFEFhAAAEFDBdCCA.XCGAhAAAPDDHLEBHhABA..JABEaHGEAFGGSFAGCBDANCIE.hADA.WHAARAED...hABA...,1,-9,-24,15
WBFYgIacLMGfONRCbUSVDPAZQHKJEXTed,HBABECEB.TFAGdFFDBAEHFACH...IBAAaGEEMEFC..ODABhAAANIAH.RBFBCDBBSFFChAAA.DAEDADIBKHBGhABA.eDCHWAFDYHEC..LAHBhABAfGAC.hADA...,1,-18,-27,9
dPTaBJKHZOFUbVAEQWLeIDCRNMSfgcXGY,EBGDLFHHDGAA.RCCDMDGH..fAAD..gEAHhAAAcFFG.XACEhABAdHABTBCCBFEBKCAGhACAOAFHbDFCAIHAWEBGCGBHSDAF.YAHFhACAaGDH...hADA..JHEE,2,-27,-14,13
FSZCdXTVRMYWbLGgaNEQBADKHJcUeOPIf,DGGBKADCHECGUFDG.OCEC..IGAESAAGZACACDCBdAGH.hAAA..XDBChABARCGFMAEA.bGCE..LBAFhABAaBCDEGGDACGEeCCEfHAD...hADA......hAIA...,2,-32,-7,25
aDeZbKcJAQBRTSYPWUfFgLGNOIdCHVXME,BCCHSAGH..PEABUFABFABELHCEGDGG.OFEBhAAAdFDFCCEEHBAD.MEGHhAAAEDEDaCCGDADGeBHHhABAZAEF.KHGGAEBG..........hACA......hAGA...,2,-25,-21,4
YSAVBOcbDdZERUPIWQNTeLaCXgKfHFJGM,VDCBOABB.DEGDdBGCZFCEUGFC....IHDBQGAFhAAAeCDACBAGKCDCHADAFAEGMBIFhAAA.AHIHBFAFEEGC.hABA...PDAFNBHAaGHB.fHCFhACAGDAFSHAG.hADA...,2,-23,-8,15
cMFUgAQBOJYWaZHREbCGTefXPKILVDdSN,BFCDOBHHJFFD..aGDHHCAF.RCDG.CAFCeDBH..XABAhAAAKBAFLEFBdAHASHBGhABAMAEFFEHDAGCB..hAAAQAFGZCCHEDAF.bEGB..fHABhABA...IHHFhACA,2,-30,-13,17
RYKTcNEbHfAGJMUaODgCWPXSQdFVLIeZB,MICEUEFCDGCF..CBDF...XBBFdCEAFAFFLDDFZFDFBEBDKBGChAAATCGD.EEAHHBDFhABAGGEFaFHDOAEGhACA..gBAHSDGEIHAGhAAA...REFG.NDAGAIAChADA...,1,-6,-27,21
PSTVZMCcQagJWfBDRIKAXeLdUYGNFEbOH,eGECdEHGGDAEFFBG.EDEAHAFH.SCBGZFFHMIBC.CBACaDECJGCEBADDhAAA..DCIHIABAhAEAAAEHLHAGUAGGhAFAbDACOCCF..PHFE...hBAA......hBFA...,1,-11,-16,5
PYUdbReLABHDGXZMScKFaICVNQfgTOJEW,BCGBGBCHMBCAKHEGFEGF..CEDF.QDAB..TCEBhAAAEBAB..PAFAhAAAUGGERDAFAHDADDIDSEFAhABAaDFB.IHBAfDDGOAHF.YCAChACA...hABAdGEC..,1,-23,-26,3
ORVFHaNZPIfKBCeWTUMJbEdScLADXYGQg,XGFHGCADOHECFGCA.HDEAZCBH.IACDBEEFCAHB..eAEFhAAATGAA.UAFEJCHDEGAHhABASGGE.hACAAICEQECHgBFCaDAHNAIAfAAGhABA.KAEFMBDF.hBHA...,2,-17,-3,14
XSUfRPZgBeOEVQWDJYICFbGLadKcTMANH,HBGDXAEESGGFUBBC.RBAGZEBCBFCBeFABOFEF.EGHFQCEDhAAA.DDIFhABAJEFA.CHBFFFABLADChACAdAAGKCEF..MFFF.AHHA.NAIE....hAHAfHCH.hAIA...,1,-5,-25,20
FQRAHSJXEeOfPIWUaVKBMcZNYLGCTDbdg,SEHBXCEH.OCDH..IEBGUBFCKFFHBBAHMABDhAAANADF.GFAH.CEBFDADGhACAdGGEgCGGhAAA.QGBGAHFHEHGAeHAGWCCB.aFFGhABA......hACA...,1,-18,-35,17
UbZRBCceQLVYNIFfMgEOdJAXTKWDPGHSa,KBHDDCFEGDCGHGCASHGEUBAAZEADBHFACCAB..eCDGLEHBhAAAVEAC...NAEF.fADDhAAA.EEGGhABAJFEDAEFF.XGBDTABHaHAC..cACFhABA.....hAFA...,1,-15,-24,9
GAeWBbCYVTSFfQHPNLJKcRdaEDXgOMIUZ,BADBCFDB..VFFCSCHH.FEEAfGAFHFCFLBAGhAAAJBDA.KFACdHCBDGGAODABhAAAMIFEZCBEABABeDEEhABA....YAHDTCBCNBICaGAH..hABA......hACA...,2,-24,-22,2
OIVFHPQUSTLbcJNBYeCdfDARGZEWaKXgM,RDGHZCCEEAEGKGHD..MCBFOFFF..VGACFGAGHECC.QDGEhAAATGEHLCCFhAAAJBCEBHCFCDEADAGA.ABBEaABAhBAAIEAG.SABCcGGD..hAEA......hAFA...,1,-13,-29,16
YPUEIHKJgZdCDMFNRBQOfTeGbXVAaWSLc,aCBGSDGDLAHF....PBBGIEBAKFFDZEAFDAAEFGEHhADABEDA.QCDHhAAAOGAATDDGGAGCXGGBhAEAAGAHWEHHcCAFEAEFgDFB.hABA...MIBE.hAGAfFCG.,2,-12,-8,4
LVUDgKWIbNRaGSAJFfcEMXCZYdBQPTHeO,JADEFBGGEGDH..MBGDZGFGdBAABHBE..QCDHHAABLFFChAAADCCBKFGC..IGGEhACARACA.aCDHAGAHfDGHhAAACFDE.PFAGeAHHODABhADA......hAHA...,2,-28,-21,7
IUSJcfXARBaMgEWPTQNGFHDYKZdCbLVOe,aGEBEBCG....TFGDGCBAHFDBDHBAKEDGCBBDLBHBeADEUGGDhAAASEAC.JFBBhAAAXAGHADGAMEDAPADGhABAQDGE.FBAF...dGAG..hABA.ODDAfBFAhACA.BFFC,2,-15,0,15
YCVTaHBMQbfKGdNJSXFULOPReEcZIgDAW,CBGH..VECDaEBFBAABMHFA....QACBKFFHGBCCJBGDFEHFhACALBAHRFAD.eHAEhAAAEFDFZAEHDIEEAAFF.TCDAhABAfHDF..SEHDhADA......hAGA...,2,-28,-19,9
ZfMUCBOGDFVTXJYRaLdQbgPSNKAIHceWE,HBEFeFCDEDEFMCHBBBACDFADFFFC..VAGBJBBH...RGFAaBDGLADEhAAA.dHBFQCBHhAAA.PDGBhABASDDDACEH.cEBCWDAD.ZGEC..hABA......hACA...,2,-25,-14,11
ZPVLEOgJAXMFDRbGKUSfITWHBYadeNCcQ,.MBEDDBFEREFEKFBFUFAH..SCBC..TABFBHEHaGDGhAAAdEDCeAADCEFF..hABAQAFGPHDCECEGhADAOEAAAAEH.FCHFfGGGIACHYEHFhABA..NAIE.hAFA...,2,-30,-27,3
dYFRLDNWBaMTJCKXPQGISZEcAeHVOUbfg,HGDGOEDAUBEA....gGDDFBAFDIBEBAHAMDFATDCDhAAAJBAHKBFA..QFAAhABASAHBEDGHAEAHVFAHhAAAdADC.RGFENBBBCFECXGGD..ICDAhABA...hACA...,2,-22,-11,11
PUHWbaGTMZNYEIdXALcgJSfeBKOVQDRFC,LCHHJDCF.SDEBBCGHOEEHDCCBFADAUAEB..HGAChAAA.aHDEMBAHZBADEGHBhABAXFADACAF..gAGChACAeCCGKGFG.RDCHCGFEPDHF.bAAF.hAGA....NIBB..hBAA...,1,-5,-28,23
gPTAHBUGYOEQZNCKWFLIJVfacMDSXdReb,HECEUDFAOGAGZADBCGGFFAGELBAD..VAAAaAFE..MCCGhAAAXDAB.eEEEhAAAPHEAAHEG.BHCDECHHQGADhADAKDDB.IHHG..hAGA......hBFAfCBGDEIB,1,-11,-33,22
EbOFQKPYCZVASXDHJLTgeaNdBIMWUfGcR,XABFDBGDLAHB.eFGHaGBEBFFG.MDBFfBCBhAAA.RDAFEEEBFCDAPCGDhAAACHBHACAFHFCDJADE..NABBdDDFhAGAIGHC.WHAG.....hBAA..cAGG.hBBAOFEH.,2,-26,-2,24
OLbYGSJFaNZAdgHUIVCEMTDceKRfPXQBW,dDBAUBEACGCC.ECBADEIF..eFEBKDED...RCGF...XAEDhAAAQFADBHFDLBAFhAAAGDFGFHACNDDAAGGE.HACHhABAMIBC..TAGCfEED.WEHHhABA.OAFASCADhACA..,2,-23,-18,5
DWUPKSBLNYEbcTHVQgMeFAGJOdIZfRaCX,ODFGdEFGZCAERBGF..XAEEDGAG.UDBCSCECBDADLFFEhAAA..EHGCTGGDhABAHAAE.QACEhACAeACEAHAGIFHDaHBCWEEDNIBB...bFAGgFDDhAAA.MAFChBGA..,2,-21,-12,9
CEObSDNUYPAFGceJIXBKWadRTMgZVfLQH,GAFAeDFH.JBBFIGBHBAED..KFEDdBBA.MFIHZFABLHFAhAAACAHC..OAEHhAAADDDF.NIBD..PDDHhABAAEIB..FACFWEGHaGGG.....gDAGhACAfAHGEAFBhADASDGH.,2,-34,-16,18
PXRecZMHIBVKEODdQALGWUCFfSTJbgaYN,GGBHCAHFFFBE.SDDH..JBBBbBFFaEDF....PAAHhABAeADAMFFABECCEGFGhACAdGHEAEAFLAHHhADA.WFFEfGEAgEADNDDB.XBDChAEA..cAABhAAA..,1,-12,-41,29
CaLSfTIWDVeYUHBJXcANQFRMbKZdPGOgE,FBECMDFGKCCGZECFGFAH..OAAGEABALGFGSFFB.hAAATGAFIDHDDIGCeCDBhAEAHEECBAFE.hAFAXDBCAAGGNBEH........hABA..bEGFdAHACCBGWHCAhAIA..,2,-17,-15,2
MBcRbNDFPGACeLOadSXHfWgJQKEYUZVIT,CGADeCECLCDAdBCCHECF....fHGHgGGEJEGBEHAGhAAAZCBH...IACGhAAAMFEEBAEB.RDAFDCADhABAFGEFAEEDOCHF.aAGCSAEBhABAWHEG.YCHH.hACAUGBA.,2,-34,3,37
QKfHVUOFBLYNIaGCSePJTAXZWRgdDEcMb,ZDBERDAGdBFCDHFE..MEFFKAAAHGBE.OBGFFHBGBBAC.LAHBhAAA..IEFFhAAACHGDeEHD.JCAEACCA.XAEBhACAEADD....bFAGfFGFhADA.....hABA...,1,-31,-32,1
XWLHDOTFVGRaCdQfbUPeSIJZANBgEYKcM,BFEAEGGCKAEGMHAA.LFHBHABDOCEEFCFEGBBEaFEA.CADE.QDAChAAA.fAHEhABAPHEAeFAGhAAASGAGIEDAAEHFNDDEgAEHXGEHDIAChADA.....hABA...,2,-29,0,29
FHTUdZbIBOLANWJRPScMGQgeEXKaDfYCV,JEBDRCBA..SGEFMCDBGFDDQAAA.EBHHaHFEDGIHCHCAFAGHhAAAUGAGZABEBDFBAFAH.hABA..PBEAeCHHXCAGhACAKDAD.fBECYFEC..hADA......hAFA...,2,-21,-16,5
LAKQXCPHbMBRTZFDSdIeWcaJEOgYfVGUN,KFEDCHHCHDFDBBEDZBCBFHAADHCA..dAFD..eEAG..aDAGECAAOCFFhAAA..fAFBhAAAUGGFAGAE.XFDAhABAMBAE.SAHHIDHH.WHAG.hABA.JDCB....hACA...,2,-42,-21,21
DSfRCGHTcJWAQaMEgOUdeLBKNFbYPIZVX,MDACEDDEUCAGLFAGBGHC.KGFD..FAGG..bDCA..IFCFhAAAXAAE.SEHHhAAACHCAHEFA.JAEAAFAEaBGEhABAdHCFeBHF..PHEEDBEB.GABDhACAWCFB.....hABA...,2,-20,-19,1
GefWJQCEgTFBNMZLbdVIcAPKDRYXSUaHO,DBEFRFDH..SBBFaBBCGFBBeCCC.JDFECHFBEEAF..FEBAMICChAAAZFFFLAEEhAAAdEFD..IHAFhABAAFHBYDAFXCFF.OCHFfGBChABAWCAG..gGGBhACABACB.NAED,2,-28,-24,4
DLINOFfbAYMgVeKXGJQHTRdCUaSPBWEcZ,MCIBeFGFKGCAGBDBHCCGdABGUGAC..SDDDBAFBEEFFDEIBhAAALGFE.OHFChAAAFACFAIHC.VFAFJEAEQBAGhABACDAFPEEG.....WAHFIGDBhADAfAEEYAFChAEA..,1,-2,-25,23
ORFWLYIXHCUbdBgAcaZJENfGKSPDTVQeM,ZGCAJFFE.EDGFGACF.KGEDDDEB.QBAEeFAG.OBFAhAAAFDDHLBAFXFAFHCEDhAAACHAGdGGCBCHCAAEAaFDCSHAEhABA..PADHMCCF...hACA......hADA...,1,-15,-19,4
bgZTcEPLQaYRJSOGedDACWKHfFUVXMNBI,CEEDKFGEFGHBUFDC..MDBEBAAE.....IBEGbEBFZACA.hAAA.EAGFLBCHhACA.QBGDhADAaGFFJBHDSEGAeHAGAAECfGGENBAG..hAGAcGDH...hAHAPFAD.,1,-20,-31,11
dBbWPKHJeTSQfMFRacIgYVULGXONADZCE,DHDAZGDCCAFEEBFCBCDC......PFAGJBFF..eFEGSBCEhAAAMDIH.FGHHaHAAhAAAIDEC.VCAEhABAUCAELFFHOABGAEEGWCHB.KHAC.hAHA......hAIA...,1,-19,-40,21
DNWfQPYISZReCAKOXFUJGgHVbEMTdcLBa,OCHFFFHFGBFAHCABECAFMEEC..dEDBBABAaCDG.DAFC...hAAANDDA.fHEHhABA.QGAEhACAYFHFIGFBRABCAAGGKHCE.JFBD.VADB.bFDDhAAAcEAG...hABA...,2,-20,-5,15
UfWPXaFZMdLIcHTOgDGYeNCbKQBVSRAEJ,EDCGJDDA.UDGD....PGCAFDACMICELAAEHAGFOBBEhAAADCEE.GFABeEAGNAIAhAEAKFGA.BAFDRFFFAAGH..hABA.XFEDaHCCIHAC...TBBEhAFACHHG....hAHA...,1,-8,-29,21
DGcgdIKfLOYXSVNPMRBQUaCEAZTWJeFHb,TCAEeECGFHFA.HADFGFABdCAG.KGFGOGDGSDHF.VDEDhAAANBIA..MAGBQACGhABACHCHABAE.JBFEDHAChAAAIHAC..fFAH.hAEA....YEEChABA.,1,-8,-33,25
eFJEAfYWPBZSdbUNcHLTXQRGaOVDCgIKM,...fEGFPABCZGBGdAEBUFGEHFDFLCFATBCDXCEDhAAAGDCFOAFGDDGGIHBEhABAKBADFFBGAEACBGGGhACASCCCNDAG..cCBH.aFBG.hAAA.CFFGMIEA..hABA...,2,-12,1,13
AQUSbOCfFWRDIEMJgLBcKZXadGeTYPHVN,QFECSCEFCBBBFBEE.DCBC..MEIDLEAFKDCDZFFFdDGAeFEBhAAATEBHHAGDACIBOHBEhAAAREABEBAB..BADFhABAaABE...YFDF..PDDEhABA......hACA...,2,-24,-6,18
YBgcEQXSFJbDaNZOTCKPfdGWeALHUVIRM,HCBFVEEB.RCGDBFDH.EHBASFBF.FAEDbFFGDCGFaBCAZDCDhAAA.OCHB.CHGA.hABAfFAEdHAHGABAhADAABBDIAHCMEIF..cAGAJDDANABB..hAEA......hAIA...,2,-13,-13,0
VJLcNFbQXHSUWRTBCeGYfDaOdKEMgIZPA,LDABFDCFQACAHCFBSHBCUCGHRFDC.BCCACHAC.GEDGhAAADEBFdFHEMAEG.IBAGhABAABAGJAFE.cFFEhACA...NDICbAFEWHCG.....hADAYCAD.aHGChAAAKECD..,1,8,-39,47
FfGUBZbYgQAVWMaDXNcTLJReSHPdEIKCO,MECHDIDG..XFCDTBGE.LBFH.RBDBHBAHPFADIFHGhAAAOFHFFFDD.hABAfACEBBHBbFAF.hACAgDFEAADEaFGH...NAECeFFD.hAFASBAG.hAGAEAFH.CDAD,2,-23,-16,7
SPGRFgdaNUeDWbHMKfJBVOTQAIcYLECZX,..ICGALGFEZBAFSBDEGADCFGACaBAF.UDCCDEGFHFDDhAAAKGDBBAGEOACBACHBEDABhAAACGHC.....XGBFhABAPAFA.dACCNBIA.WFADfHFDhABA......hADA..JEEC,2,-17,-14,3
FcXZabCAMeBdSHEQUTLJfYVGKIDWNOPgR,eFFHBEGCdDCGHBABQBAGTACF.LBFAJFDF..fCEBhAAAVGDG.IGBGhABADGBFOBEHRAFCcDDAhACAaEABADGE..MAACSEAG.EHGCUGGChAEA.....hAEA...,1,-11,-15,4
abKCAeORUIFdGgfQNHMJDXTSVPYELcZWB,OBHHUBGBFFAAdBBCGDDG..QGCCMABH.DHAAXGGHhAAATFFF..SDEChAAAVACG.YFAEhABAEGAB.LHFA.ZADGBFHE.hACAKDGAAFEB.IGFDhACA.fCCE.,1,-8,-19,11
bBVZQOEWcXadDIGFUSfJRYgACTMKHNLeP,MEEBHCEBLDHB.eBAABCGAQEBEEFFAXBCHDHBGIAAAhACAUFBH.JAFGhADARAEEADAECHHE.KBAG.NAAD..hAEA.PHEE........hAFA......hBEA...,2,-38,-13,25
UgBKQdOSIfaAFNYMRcHEPbeVLWTDZGCJX,FGDHMEEHHFFB.EABEeBBCLECADDHDCFFC.UAFAKBFA...OBDDhAAASFBB.aHBEhAAAAEADNBBE.....hABAcEGAPCAB.WCDF...TGGBhACA.....hADA...,1,-26,-32,6
FfVIUJQTABaCcWEOdbegDHSRXYMNZPGLK,aGBBCBHG..EAEBdEHE.eADCHFAC.SEGFREDEMDAE.ZCDFLHCEhAAAfBACUABCTCBEhAAABCEGOBFFhAHADHGANIBBKABEFAHD..IFHFAHHF....hAFA.WDFC...hBAA...,2,-17,-6,11
IfKNbOEMPJXTAVLFGeDRSgYZUHdWCcBQa,LBDHFEFFDFBF.SBHDZCEGUAAA.HFCC.CABEBDACaECF.KHAEhAAAODHD..PBFDhADA..TAFBhADAACDDeFHF.REAC.dAECWFFHIHEF.fGHEhAHAEBBD.MIAAhAIA..,1,-20,-31,11
NfLSPZIUaKTcdRWgbCAJOQHDVBeEMGYXF,QGBAHCGDBEBGEBADGBBBFGFB.LAEGZCDHUGACKFGD.dGACRADE.hAAAbCFECHHD...JEEBDFDBhABAMFIF...NBAC.hAAASBBBaHFC.WAFEADED....hACA.OEHD..hADA...,1,2,-22,24
UMNPFcYHJRaESQWdXGVgLObBZeDKICfTA,MDAHFFHDHABBRAAF.aDBEQCEE.dEBGVFDFLFFHBBHBDAEBhAAAKFHDCGDGAHAF..UAFChABA..NAHA...PDFFhADAJDDFSCCC..XFBFhAIA...OHFChBAA..,2,-28,-12,16
FIVeaMLfBNKgCGOJZcUREQHAPYTdDbSXW,TFAEDCCG..XEDDFHEE..ICFFaDBDLHCCBBBFKBDDhAAACADCGAFGZDEGRAFEQFGFhABAACADdDDB.SHAAhACAWBAH.MCCHNAIGOFFG..hAAA...JFAHEDAH.hABA...,1,-10,-23,13
NaMbAZOIcRXBHQgFUWEKdGLCDSYJefTVP,OCABRDDDBHAHHBAGFEBA.UAFCEBGB..dFEGCDBG.DICE..JGFGeBAGhAAA....TDFChAAANEEF..aHAGAHDHZEAAhABAIGGB.......cAGAhABA.....hACA...,1,-30,-35,5
KDWdISLYRAHTJNCEeaUMXcBFVZOQPfGgb,HEBBTFDCCAAA..EHEGUFAE..MFABBAEFZFECODAEQBCEhAAAGBBBKDFHDCIHIBFDhACASCGHLBHDhADAACADeAAC.aGHH.XFFF.FAGA.hAEA......hAFA...,2,-14,-11,3
ZJKageCSVMIUGTXWcBYRfbdANEPFLHODQ,EBDAFCBHHFAEDFAH.JACHKCEA...eCHH.CGGC.SEEDhAAA.MFFEUGCHXAEHhABABEFAfBBGhAAAAGGCNIEB.LADEODFAaAHHIHHF.hADAWBAD....hABA...,2,-43,-19,24
KAgDMVYXLWbZGdOFfUcHPRIaBJTNEQSeC,MHFAXFACLAFCZBAHGFDFODFEFECEUEADHBFH..IEDFhAAAJADBEHFA..SHBGhAAAKGDBAACDDDDG..VBADhABAWEHBdFGH.fBHG...hABAcGBHaACB..BCHHhAFA..,2,-26,2,28
gXFRcNdPObUAEQfMIDSYVTCHeBLWZJaGK,QFCCMEDEDFCC.SAFH..VGCACBCCBEEBZDABaBAAhAAAGGEFKAEB.FCAFRFGFdADChABAbFAH..AIDE.EAHDIDCGhAAA.HCGD.WABCgCGEhACA......hAGA...,1,-7,-24,17
fHgUMGAbNCacBKFOLTVZSDRJYWeIXEQdP,CHFCaDGEKCEALDEB.ZAAGDCCH.RAFA.JAFH..eDFAEGGEdHBFHEAFhAAAUEAFMEID.AACG..hAAA.bCAABEED.OECFhABA..SAHHIBDHXGGHhAEAfHFD..NIAB.hAFA...,2,-34,-17,17
NAXIDFKSLWdPQVOTRHagZUbMcEGJfeBCY,XECAFDABLFHHdAED.QBGF.ODDCHDGFaBABZFDAUGAFhAAAMAIFGGEDhAAA..eABBBHCGCHEEAECHhACAIHACDBFD.WCCG.TDAH.hADA......hAEA...,1,-13,-19,6
XEATcSIVZbRDBYFOLJQGfeNKMWUPdgHaC,SGFGZCBDDACGBGGHFAFGLAFFGBCAeCAB..KCHFMCGDhAAAUGCCdHCBHEFECBBGAEEB..hAAA.IBAC.hABA....bBDHOAHDQAGHWCEBaGGAhACA.XEBHhADA...,2,-22,-22,0
cfCIgKQbSDWaUPRLEYMJeVGZOHNATdBXF,dGEEBBCDFBDHCCGH.KCBD..QFFGDAIF.UGABREEELFABhAAA..EEABMADEeFCGhAAAZCFCOBEDAHHC.TCAHhABAXGCG..IHHHSAGHhABA.aHGCPACA.hACA...,2,-31,-24,7
aMDSTOUYIFLZVRecHbJfEPXNQGAKCBdWg,BFHGdAAHaBGDMAFB.DGAFOEEB.UEBAFABDLECBZADH.hABARFEFHCFBJFHD.ECDB.hAFA.PHAAQDAEhAAAAFGFKAFH.CADBSBHD.IHHAhABA.....hAHA...,1,-10,-34,24
gFSETXIZQVeWHADJfRYUCNBMOPbacGKdL,JBCDRBADCADD.BGBB..MEDG..OFDDaFBG.KAHDLFFGhAAA.FGBDSFAChAAA.TFGHIDHGhABAQBECWAFEAHFCDCEAfDFF.hACAYFFFNEAGPFDFbBABhABA...,2,-49,-25,24
VbOIEBCgQWYNfMPKZHTGeJcDdSAFaXURL,XEGBUCGHLDAA.OHEEICCDBAGEQGDChAAA.NEBB.fFAHhAAA.MABHPACChABAKFDGHGBEeAHHcFABDGGEAFHAFACHaAFA.RFFB.EEEEhADA.CHHB.YCADhACA.TGBA.,1,4,-10,14
EFXJAeYBHGNUPLdDRagSKcMWQfTVCbOIZ,eBCABABEGBECUFGHLDDCdGAEDDDFRDGD..SCGEKDBF.hAAAMCBHQGFChADA.VGCGOHBEEAHH.hAEAJGAGACCG...NBAAaFEH...WAAECAFE.hAHAIAGE..hAEA...,2,-30,-16,14
JbECAdOUGgLWVXTZSFRQIBfYNMeaDcPHK,UACBLBDC.VDAHZAFFSFFD.FEDGRCGBBEEE.hAAANGEF.MIBEDCAEHGAGhAAAKEHBEDABAABF.dAHA..ODDHhACA..WDCC.TFBAIHHGhADAfHGHaAGA..hABA...,2,-36,-17,19
WPVQBbLaeEfITMCcOHUNYDSGgFJXKRdAZ,ZCFCVEAGQEGG.LBBGaHCGEDGD.TDDEMADCCGGAOABGhAAAHAAH.UAGEDDDESEEDhAAAFGHDKGFDdDBCAIBCBHABhACAeGBEfAGC.NIDB....hAFA......hBAA...,1,-2,-13,11
KJYAgebVHdTWDXPCaMOGIRZScfQELBNFU,eABEVDFF.HBGB.dEACTEBBDFCC.CBDB.aCEBGCBDRFED.SHDChAAAQBBGBHGBhABANEIE.KCHHAHAB..gGCGhAAAXGADMAEE...IBBBhACA.cAGD.hAEA...,2,-18,-12,6
VRBWXKGefTEIgbHYAJDFaMNCPcQZLOUdS,DFCBMIDGCEDC...QGAFOFFA.dEBBRAECBHEFKBADGFDH.hAAATAFDEFAD.ICDDhAAAHABDAEGGJBAH.FGHDhABAaCFH.PDHDLAHB.SDDEhADAXBBB.....hABA...,2,-22,-16,6
TVZUMBYEeXSAgPfNdWCRQHbacOLFKJDGI,...PGDEdDECCHCBQFAFHDBA..aBBCOACCKCGBDBFGTBAChAAAZFAFMIDE.BAAChACAeFEAAEFF..fADHhADAWHEG.cFCBFDFEIDCD.hAGA..YAHHhABAXGGBSFHHNAIG,1,-19,-23,4
YVWMJfXUZgLFaRIQDHPNCOGcKEBbSdTAe,eDBHVDGD.MBEG..XCCGUDEDLHAGFFFH.RBACDHEGNABF.hAAAGEGGKBDC.BBHHhAAASAHHADAH.JGAChAGA..fFCAaFDFICFC...hABA......hACA...,1,-23,-26,3
ZJDWNHRUdMaLfbYIGKVEPAcTSeOCQBXgF,SCBECEHBBECG.FAABJEFB..DGBAHAADUCFEdDDHLGFGhACA..fHCFhAAA..bDAGIBFAhACAKHDGPHAAAAHCTGAGOFFA.XECEhADAgACH.WHFAhAFAMBFGaCGE.,1,-13,-48,35
NGDBUHIRTdXYSfaEMFOCWbLJQPgKZAecV,eACFVFBG.DAAEBDBBHCFF.RFFC.dACH..SBEDaFFH.MIFEhAEACFACLDEC.hAFAJEHDQFCEhAGAKHAAAEFE.NAIGIHBE.XAFEfBEFhAAAEDCH.WBAD..hABA.PAHD.,1,-1,-31,30
VJDHXBfELKWUOGTadbQIASZMgNecPYCRF,SBBDZDCHMIDG.eHBC..PCEACEEGFDFE.DDHFBAFFLAEGhAAAKACCUGFBOCAD.hAAATEEFdAHCQCCChABAABBG..gGAHNEIE.cGGHhABA.....hBAA...,2,-28,-18,10
FRNIaKGHfeVOdMTbEXJAWUBPYLZCQScDg,BAAFLBEFQCEASBBCDIGGFDBERGCA..aCFAKHDA.HADAhACAeCADdFFFMAID.ECCBhAAAAAHCUGAGZFGDCHBDNABDfDGDhADA......OEFDhAGAXBBG.WFAE.hAHA...,2,-21,-11,10
fROLMUQCdaSeYTcDKVPZJbABIEGXWHgNF,BFFHGCBGHAGBFFEARAFHMBEF.UBAACHCCdBAC..eGBE..TDGHhAAADHGEKEGC.ZDAGAFABEBCEhABAXGAC..hAAA.NFBD.OAHD.aFAD.SHGGhACA.cFDC.hABA...,2,-25,-16,9
AEBSNDWKfXQOCYcTGULVMdgPeFZabJHIR,BHCBSEDHDECHKBGBQGEE.CHBD.TEDEGAGEUABAhAAAMCAH.dABFeGFG.hAAAaAEDJCBC.IHHGhAEAADGFEGAH.fEBBOHEC.LBFFhAFA......hAGA...,2,-37,-12,25
eTQgBNCYOHdbFWDRcfZJAGaPMKXLIVUSE,aCBCMAAALEFBUBFE..ECDBeDFE.TAEBBBBECHAE.OECFhAEAHEDFFGAD.WEAEhAAADEFHRGFG....cACGhABAfFADAAGEKHCGIHHCSEGG.hACANAIEdHCD....hAFA...,1,0,-33,33
PIDZMRdeONfTSLWaXUbQKJBEgVcYGCAFH,HBGHDIAAMDCDRBADdFGD.OCEB..NFEH.SGAGLBDHaEAHhAAAUGDH.KADEBBHGEDFF.hAAAVGEE..cAFBhABACABBAADAFDFA..IHHD...fDCChACAXGBE..hAIA...,1,-20,-31,11
PVTUNDMRXfOKcebZJHadYgCLAEWSBGIQF,SFAHGBBHFFAF...VEGBTGEBDEFB.MIAERADG..OBAFhAAAKDACeDFAZECHJCFGdAAHCFDAhABA.AFFCBGCD.IAEHhADA.QGGGNIDFfCCF.hAGA......hAHA...,2,-26,-15,11
JGUgWHPOICMcXQfEdaVReZKBNASFbDTYL,SFEGDACFLDHDUAGCHEBB.OBAFCDBH.MAEDQGBAhAAAEAHF.dHGBREEDKAFHBBBAhABAAEGDFHACTDEE.JDHFhACA.....gADBIHHBfDCBhAAA.aDAHhABA...,1,-21,-22,1
OVFTSbZIWRYQMAKfPdCHecJEaUDgXBGNL,KCHFdGBGeHFAEEFG.UDDDDDDHBAABLABB.FGCESAGEhACA.ZDBHRADHQBFAhAAAAEAACHHB..JADHaEFDhADAGGCDNAIC.OAFB.....hAFA......hAGA...,2,-33,-17,16
cQeEKYRUHaJANMCLGVSPBWOTXdFgDfZbI,CCEBLEFDGABB.VGAGBGEG...TEAAFAEFDBBH.ZDGF..hAAAICAEQDCHhABAEFGGKAHHUAGA.aCCAJDEFhAAAAIEG.MAEE.SGGDODAB.dCGGfFDEhACAcGBEeCCBhABA...,2,-25,-12,13
SNJMFAYLcVIgEDUBQKOPdbXHWRGaZCTfe,LCAHVDAC.EDCGDDFCBGGFKEED..dGAAXADAHACE.GEDDhAAAaHFC.CAGC.eDHFSFHHhABAJAFA.AIEGICGBhACAUAAGQGCGOHBA.....hADA......hAEA...,2,-26,-13,13
bLYAHgUNdRKMOFQeaSVEJWIcPfCDZBGTX,UAEDdFFCRAFGKEHHOHEE..eABE..SGDEJEDF.IDFEhAAA..PCCAhAAAfDAADIDEBCGGhAEAXCCH.bEFEAHAGNBBEMBAA.FHBGaFAEhAFAEFAHCHHA.....hAHA...,1,-17,-36,19
JXRTSDPHFOGaWgMKfEZbAQNcCBIULYVde,QBGCCCHCBDEDLABFdEGDeAEF.RDCHDAGEFGDEOFBD.GAEBhAAAaBAAMAAC.KGHBhAEAEGHBAEFH...NADEUDGBhAEAJHECSGCD....WFAFhAFAfDBA..hBDA...,2,-25,-24,1
HJZPfcDYUeCTIMBQAbaFXWEdSKLRVGNgO,FCDHEEADKBAHLBFG.GEGCODBEJDBHZFCE.....PBHDhAAAfGBGDCFBUGGDhABACAGDMACDAHEG.aFDGdADEhACARGDE...NIAB......cAGBhAFAeAAHBAEF...hAGA...,1,-14,-24,10
dRYVFPHBfWbDTJCXZcgUNeaGISOKALMEQ,EFABRDEBFAABHGFCBHDF....fFBBDBED.CCDHZAAHUFAENBEH.hACAeAEG.GEGChACASGDHKCGELBCHhADAMADAdEED.PCHD......hAHA......hAIA...,1,-12,-31,19
XFYcaETNAKJdgCHMVLSObZPRIBeWQUDfG,JCHFdDDDCDGAHFEELBAA..OBBCZEBARGCEBCGFQEBF.hAAADIBCXAGAFACAaCDE.hAAAEAECAHIB..KAFGMEABhABASFAD..IHHEeEEEfGDEhABAcFGG...hACA...,1,-13,-34,21
CAaVcYRBEgTOKJLbHQDWUINGSFdeMXPfZ,aBCCVAAB..RDEBBAAGEBFG...OGACLDEHHDGDDCDHUGGHhABAIEHFGAEBSFCFhAAAdDBBMCAFXGDHhACAfHGBAFCC.YADE...gGDGhACA.KAHBhAHA...,1,-4,-34,30
FNEDRLXHacfVOSTJUAgCbdQGMeYKZBWPI,CBECQCBEGCFC.MDIHeDCDZABEBAFB..IGGHEEDGDIACREABhAAAXGAA.aDDFhAAAfBBBOBFGSGDDhABAJHDCAIHEdAHCKBAF..PFEDNDIA.hABAcDAC.TDFDhACA..,2,-19,-2,17
SOVYfABJcLPQWNTCegHdKDXIEMUZFaRGb,BBAELCGFQGABTFEE.eCDGHACHKHGADAAD.EHBGZBGHFEABaEEFhAAARECF...SDADhABAOHEE.VCBFAAHFJBBFhABAPACGNBIE.CEGG....XGCHhAGA.MAIB...hACA...,1,3,-11,14
YBVJLaOegKdAXUWHPTQbcDfGSNREFMIZC,UAGHHCCHTABDQDEDDDAHGFEBRBBF.MIBECHEDBEAELAGHhAAAeCHBKGHBAEHB..XFBChABA.WCEHhADAPAAB...bFCG.SDDFhABANAIG.IHAF.hAEA...,2,-21,-9,12
dGIMULZHcfQBNFgAKEJabeYDPRWVXCTOS,JAAEeEDC.DAEARGDC.....XEBDTDCCdFAAGAGCUCFAZAAAhABAHADDQFFHhACABAGE.NDAGAIGGEGGG.aGBDPCDChADACFDH...OEHFMIFA....hAIA......hBEA...,2,-18,-10,8
FeYTUCJWINRMEVbSZcdPaXLAfDKOgHGBQ,DECGKBCBOBEBHFBBBBDA.FHFEeEFA.UEACCDBF..JAFDIGEBhAAA..MFEBhAAAEAHD.SAHDhABAdBAEXGGGABBG..gDFAYHCATCFGhABANDIC.....hACA...,2,-44,-19,25
NUYABgbZCXIfEHcOeDWRPFQTLVGdKMSaJ,BCEBZGAACGHF...IGHBEGFHHBGB.eADBDCGFRBCD..QCAFhAAALFACdCHEKFDASDCHhABAaACG.NBFGAGBGhACAbAAD...XEFCOAEA.FAEE..hAAA......hAHA...,2,-34,-5,29
BfQXEIUKedaFNVATMHYWJCZPDOSbGgRLc,MGCEHFEBJCBCZFAHDDAC..SBFCGACFLEEGBEBCQCFHhAAAECEAKCHH.dHADFHCAhAAANAEH.ABBD....TGGDhABACECAODHD.gGGBfAHC.hABA.IACAeCCH.hACA...,2,-17,-14,3
VHRLBWbfUZCFQXNKJgYAcMdSPOaTEDGIe,MFEGSBCH.OFFDaGHDDBDD.GAAEVAEB.HCFGBHHH.hAAA.fFBDhACACBHBFAABQDGFNDAE.gDADhACAAHGDdGEEEHBA.IEEH.eHCGhADA....WEDChADAUGAA..,2,-21,-6,15
AFcXRYeJbOLfCKZQHDPGNIdBVUWTaMEgS,XEAEeFDBOCBDLDBEKADE.HGAADBHDGDEBdHGFBFFBUGAEhAAATABF..EGGBgAGFhAAAAABE.FEHFhABAYFHHbAEB.CBFC..PBDH..hAGAIGEEaAHFSBBFhBAA.,1,2,-21,23
OLEHCQWRcDNIaegYSTGVfZUFXbPdBKJMA,OGECHCFHQECGRDBF.DCAEaHACeAACSAEAGEGAZADBhAAAFBAH.XAGFdGDCBBGHhAAAMIBALDFECFBC.hBCA.WEEHcCCF.......hBDA......hBFA...,2,-25,-3,22
ODMGUdCXVWHZTRQJIBAbafgcESeLYKPNF,aAAB..gCGBEFGGLBDHKDDBFAECDHDGUGBEdABA..XGGBhAAAVAGH.HGDERCAGJFDAhACABAHH.ADFBfDAAhADASAFFeEAFNECEMFFCCHHD.....hADA......hAEA...,2,-13,-11,2
eWZRXFIODHLaTCEgUJdcPMQNKfAbVGSBY,VCCGBGFBeAHB.ZADBXAEAFBGH.DDAFaBAC..EABCUFBChAAAdGDCMBIBKEEF.AFGFGEAEhAAASFHD..hABAWFFDIDBD.OHEC...hABA......hAEA...,1,-27,-28,1
RUgEOAXINPBKJSbVaDCZcYdTeLfMWQHGF,XCEA..IHBCBHEEKFCBJECG..SGFEhAAAaDGHCCCAZAEA.dDAFLDADhAAAMABGHAGHFHEERFDCEEGCAHHF.PFAHhAFADABG...cDDC.eBBC.hAFA.fBBFhAGA.WDHB.,1,-5,-29,24
cMWDPSOTLACXKEFeJUabYfHZdVgIBNQRG,KGAHEDBEFGEEeBFF.UGEF..aCFF....bDBGHACC.dEFDhAAAICCCBHBHNIDBRFACMAIHhAAADAHF...OADAhABAAABDCAFE..XDDB..JEFGfDAEhACA...hACA...,2,-33,-17,16
bGDJFQZdUVMSgPAeNIOfRCHBYWLcTKXEa,eHEEOBDFREEABAAHLFDD.KGFBaCABDHACFCCGZDEB..dFBDMABGhAAA..SAGBhAAAAAFE.ICFHhACAHAFGWBBB...cCGEEDBD....hAIA.JEHD....hBAA...,2,-29,-27,2
JODAdbWXfMPRaQBYICTEUKSeNZgcFVHLG,dECCXDCBMABARAEGBGGD..CDFA.UGBBKEDH.eBBAZFGD..FGADLCFFhAAA.OABGhAFADFGBACBE...fAGHhAGAaHDG.YHEAICHGSEGBhBAA.NCIC.gBDGhAAA,2,-41,-33,8
ZOXgUGIbVPFdMaNDKWHeEQLCTfcASBJYR,JEBBZCCDOHEA.UBFHIDFC..VCADFGHDdAED.MCADhAAAaEFH..KFADHEDBhABAEAAF.QBBBhACA.CAHA.fEGHAHFDSFFBBGDCYHAGhADAXGBD...hAFA...,2,-29,-26,3
OebAISDZVgCGKNQRULPHXMaJEdYFcBTfW,SEAGVACB.CDCF.KGDF.REFALAADHFEBaEDHdAHCFGBDBFABhACATGBB..OAGFhAEAAAAGDCCCZABG..NIEH.PEFAhACA.MAGBEEDAfCFEeBEHIHHChADA.....hAFA...,1,2,-30,32
EJDbFKfUVOPXINTgQBGcaLWAZRMYedHCS,RGACeEBDdCAFHBDDECCGDAADFFGE..KEGHUAGH..VGEGODFC.hABA.IBHDTDADBHDAhAAAaEEGLHAAhACAAABCMFFH.SCEE.fADBhAFA...NEIC..gDBBhAGA,2,-30,-6,24
FBZOSfHMYUNedVQTDKgcWRXLbaJEIPCAG,FDCHZBBCOBFEHFAFMABCUEGB..eBCEdDBC.QGEBDDDD.hAAAKDGD...gAGAhAAAWHACLEEFhABAaHGEIEEACHHEBACHSAFC..hACAfCCBNIDF.hAEA...,1,-9,-35,26
dJXTbPHLBefCgMEWGDAVZNIOaUcSQRFYK,VACBZCGBODFB.UGGBSFEF.FBHHdCDE.TGCGhAAAPFCHHBAD.BAFDhABACGHCEBAFDIAGAHIB.aGAGRBEH.KEBAhACAJFAF.LFGD......hAAA......hABA...,2,-22,-16,6
XGOWbBAcdDVZMHeYJRfSEQTFKgIaLCNPU,dEAHVFDAHGDC.eCACRCDE.EDFGFCBH.KHBGaAACLACC..hAAANBIAUGGGOBHFBEDBhABADAGE.MACC.JHAAfGHEhABASBEF.gAGFCBGF.hBAA......hBBA...,1,1,-34,35
OMRIGWLeFaAbKJZXTNQgdCSUHfEDcBVYP,KAEEJECBZBDF..TEFD..QBBHdCGFSECGHGEGDIDEhAAABAHEVAFDOBAHhAAAMCAFRBCAGGBBLDHDhABAFHGCAFFB....bFAD......hACA......hADA...,2,-22,-11,11
IdESefaTPCcYVKXROFLAGBbHMZJgQDUWN,BFHEHBCBMABBJCCD.DCFBUBFF..IGAEdGGG..EGBASFGGhAAA.fGEChACAaADFCFEA.YAFAhADAKAACOAFGAECBbCGF......hAEA......hAHA...,2,-51,-28,23
aKQCUHDbXWGTfJYLZOFNAIcgeVPSdREMB,..IBAFeCCASFEBRGDE.BGDCKCHBQAGBhAAAHFADXDEETCCA.JBDChABAZAEAFEAEAICGgBAHhAAA.dHGDaHACDAFGWDFFfCHChABA......hACA...,2,-22,-17,5
QDVOXgKdUHYGAZLeCJIWSEPNRacfBTMbF,LBBHJFDG.SBHDECBERFAF.aFGHBECB.MICAQECEhAAADHEE.XBDChABAdAAHUBEAGGABACHB.hABAZFEFCHHG.IFAD.NEICcAEFfDAChADAFCAB.OCHD.hACAKAGC..,1,-3,-29,26
RHCLETYPBKdVSbgFDJeaOfMXWQAIcUZNG,UEDBGEBDCHCF.EGEH...TBDHBAAEKDBBdBHA..SBADhAAAFBHBDIDC.eGAG.fHGDhABAMCCE.QEGGhACAIHAHZEGD..RBBDLAFBhADA..YCADhACA..,2,-53,6,59
SDEBPRbFYINTeZVWXcMOJLQgfGUHAadKC,aDBGCCABDGDCBCEH..RGEC.FBAB....IEFEeHFCZDEE.XEAChAAAOCDFJAFHLFFAhABA..fAAFhAAAGECEAIBESAHFEDCB..PHAGhADA.bAGB.TEAGhAEA.,1,-19,-45,26
BLfaJCcdQEZgNWIYObGURAeSTHMKVXDFP,SCBEMHEEKAFH.DCFHBFFGLGBC..fACHhAAACFGAdCHAEEFFZDBG..gCAFhABAIABAOBDGhAAAbFABUDGBAGAB.HFCD.XCDBFHBEaAFA..hACA.JAHB....hAFA...,1,-17,-18,1
KWIgeBaDAMVGcYJHFZPdTRLNEbXOfQSUC,GDBHJAGBHCBHFBBGZABEdHFHLFGB..NAEB.EDEF..OGFGhAAASDADCEGC.KFFFhAAAIGBFBGAHAEIBMIBAhABAVBFA...cCGEPFDD..TFCHhACAXCACfBEAhADA..,2,-32,-5,27
UeMHdFfRQEKNISaCbABVLOXDJWYgcGTZP,VABEXBGH.DECAJCHH......gBBFTGFFUCEDhAAAHEABdEABRFFAEAFDKGBA.hABAIEFCCEFDBFAH.OFDDhAAA..YDDFZADHMCAF..fAHGhAEASHAGAIAG.hAFA...,2,-36,-1,35
NIXeSRZgWfBdcVMHaDbAYKFLCGQJUOTPE,KEAFFDGFCBBAGBBD.QEFAUADE.OHDCTFDC..ECHBhAAA..IAGGhAAASBADRDBCZGFGfGBHhABABBAF...cFDFMIACaBGEAHAH..hABA......hACA...,1,-14,-34,20
eBagPbRFUDVWMZfHIcOAEJYNCSXdLQGKT,EECCJFCF...CCAHdFFAQBCGGABBKGAFBDAB...aEDE..hAAAgGCDRAFDDGGCMCIBhABAHBGH.OEHDhAAA.ACEFSHFALFAFeHEGFEAG...hABA......hACA...,1,-15,-28,13
dZaQcgTKCBILSOUPbNfHEXMReJDAVYWGF,VBDCGEGG.dAGHQFEF..gCBBCGBBBBHDSGDDhAAAUFDC..NEBAEAAGhACAMDADRCFH.DDBEAAEEFADHhAHAaBAAKEHBOFCB..fHGF.hBAAeDFA....hABA...,2,-32,-7,25
PHcYRaCOTXFfbgQNMGVdBUAISEKLZDJeW,EEEAZGEAJDBD..eHCGHAFARBDG..CGFG.TDDEFAGC....bEAChAAAQCGA.hABANAACGBBDBEHGABCCKCAHhACADGGG...cCCHaFAHOHAEXGGF.hABAfCGFMFFG.hACA...,2,-19,-11,8
KZSUNfWFQCeOcEgLIYbXHTGARVMaPDBdJ,MEDAaFBHBHDGKAHHZGDC..UABB....fCFFhAAAQEGECHAH.OFCCECCHLABChAFAbBDDHGECAEIHREGDVAFDhAAADFCFSCBFFCAH.....hACAcAED...hAEA...,2,-18,-14,4
eZEGBDWNaMJPFHUAgIbYOVTXSKRdCLQcf,..IBADbACE..VDEFSHEC.KDABCCAELHAAhAAA.QAGBhABAcCCHZDFGBEHFDGGAaCFEhAAAPDCFFGBCAECFgGGATADGdAGFeDADWFADhABA.MIFE...hACA...,1,-10,-15,5
HMEFVJPCUeXcKdGZOSDTbAWLRafgIQBYN,RAADaBEH....fGAFIBGBBDCHHFDEMEACFFGC.VDFEhAAACCCCUFCC..eCDAhACAXAAGKADHdAGDOEADhABADICCAHCG...WAFC......hACA.gCGAhADAYFHB.NIBB..,1,-6,-41,35
gBTSaKVPUbAGMHeRQENIDOCJWLfYdFXcZ,GDCCMEHFREDB.QDAB.EHFAIBFBDFAFOEHFCACDLAEChAAAdBDFFABDZBGDBCDFaAABhADAKCGG....PHAChAEAABADeDAHJFEBWFFH......hABA.fBBGhADA...,1,6,-44,50
WEMQNLXPcbZTGORBJeAaUfVdSCFKDYgIH,UCBGVAAC.dGFE.FCGDKAFB.DFEH....IAGDHDCHECHD.hAAAQGFFLFBBXACEhABA..hACAbDAFTEDDOCFBBHHEAAHBSFADhAAACDAF..YDHBhADAMIBC.NAFE..,2,-34,-12,22
RJEPZbKTfIHMAWQGdUFVeYaCSNcgODXBL,QBGDdEDHUGAFFBEDeDFD..CACF.NHDD...OFGFBBBARADE.hAAAJCAHEBGA..ZFAGKAFChABA..fEGDhAAAMDIHABBH...WCDBVGDC.aDBFSHAAhABADEBH....hACA...,1,-24,-27,3
VUALXEQJZYMFDOKPfHdWIeTRNCaGgSBcb,LBDHEDBHZDFC.MBABFHAEDBGGKBGC..HFEAdGGG.eFBBRACC.CCCG.GEDEhAAABHDD..VDFChAAAADDBJCFC...OBABhABAfGHA.IHAAaGAG.SBBFhABA...hACA...,1,-14,-24,10
TSHfYcNPGKFIMOELJDdaRbAUQZWgVCeXB,ZAEDVBGFCGGCBBHC..TFFDHDFE.....fADAhAAANBAHKEAB.FBAGOGCGhAAAEDABJDDHDIGARCED.UCCEQGBBhABAeHAE.SHFG...hABA....YAFEhACA.,2,-28,-19,9
dVWSMfaNBCcXLIEgFQRAUJTKbPHYGeDZO,JGEEKFBFHDCFGBAFeGCAZFCH.dCCB..SAGFaFFFBBAHCDADLEBDhAAA..EFHDFEGChABAAAFHUAGATDDA.PAHFhACADAACOHDE..MAFBNEEH.IHHBhADA....hAEA...,2,-17,-17,0
ENHXRWeOCZBLYMAUQDgaSGPTKdFVcfJIb,UEGCDFAG..aGCASBGEGEFE.KDAEdACE.FBHH..fHCFhAAAICEDEGAHHCCBhABA.RAEDeEABCBBF.BHADhACA.MEFBAIHG.gABA..hAEAPAEG.cDDHhAAA.NIBH,1,-20,-44,24
AgMFUPKNQELWaXBJDecRdHZbCTYGIOVfS,FBCBKEAFEFCBLGFC..XGGABHCDJAFBDCAC..eEAERBDCdEEAhAAAZAGDCCHB...TFAEhAAAIABC..fBAGhABAAAHHMDAGNIAH.aDEC....bDFFOHEEhACASEHF.hADA...,2,-28,-22,6
RJQfPgWETNcaZXGBDedVKYOLFSAIMCbHU,CAEGUEEGRDBF.QEBB..PAAEEADC..TAFAaDGCZGFAhAAABGDDDGAD.eBBGKAFELDDBhADASHGAIHBGhAIAMAAAJBHD.fHAFNIDH..hAHAXBGA..hBHA...,2,-29,-10,19
XeKSEbUTdOICZgBNAaDMRHcVJFWYQGPLf,aGBBDGHDMGCCHEEB..JDCHFCEH...QCBGLDHHeADBhAAASAACEAEEUAGEOAGFhADACABHBHHBABIB..RGAE.hAEA..WBAD..GDFA.fHEBhAFAKHFA.dBDF.hABA...,2,-18,-14,4
FDJbYaWQgGXUZRNeETfMLIdKSCBPAHVOc,HECGVEGH.FAGD.DAAGJCFA..aCDE..QDAGGDGCUGDFhADARGBGEABAMFBB.dBCFSAEAhAAABEAFAAID.bCCDhABA.....WFEH.....hAEA......hAFA...,2,-24,-20,4
cOBMYUSVXFEDGWZgCAJQTHNaefKPbdRLI,JABFQCBGHEFC.eBFGKGEBdCEALFCH.OGEABDAGMACEhAAA.UGBBSABGhAAAFAHB.DAGC.GADEhACAgDCFAHEHNDAAPEFG.IHHFhADAcGGD..XCGEhAGA.WBDC,2,-24,-13,11
YQCfHTaIXPGBbMUOVgAFcSeEWZKJDRNdL,FFCBSEGBEGGD.ZBDBDAGBdFCBLBDD.CBHE.fFAGhAAAHEFGaGEF.IHCChABAGBACMABGUGGHVCAChACAAHAAeCEGJBFB..NIAF.YAHF.XABAhAEA.BFFF.hAAA...,2,-14,0,14
KfJbLDCPGTNgcVBXYAIZMOUSRQdEaHFeW,MFCCUBCHQFDEdCDCHCGFFGHFKAAC..JGDELCHH.CDFDGDAGhADATGAH..NACB.hAAAgAEBBDBHACGBOBAAhABAEGGBaHBE.fAGBDIDC...hAHA......hAIA...,2,-24,-8,16
OKCAHRULBGWFYNbMDVZdfITXQSJgEcaPe,HCBCRFFFUCEGLBGFBBGE.FBAC...bEADVBBBZFDA..dHDB.hAAA.IEAEXADFhAAAQGAASEEGhABAEEHBaAGA..eABECHGAACFH.....YEDFhAEANCIC.DAGA.hACA...,1,-4,-23,19
gaNDZcIXQRFTEVOGBKbWMHLSJePfUYCdA,aDDDZAEC..XCAAQCBHRFFH.EDHDOBHDBFACKGBD.MDGHhAAASEDC.eAAChAAAPABCUGAACHFCAIHGDFAGhAFAIAHATFDE.GAEC....hABAWDDE....hAGA...,1,-12,-22,10
PUAOBTJeSCgHQWFaIXdVZbLRKYfcNGMED,TEFCeDEBCCGG..HDAAFACF...aHAEdFAFZFDHLBEBKAHD.fGDAhAAAGACDMCAGhAAADCCDABACJGFGQBGHhABA.IHHAXDGE.bFAG...hAEA......hAFA...,2,-28,-1,27
NIVefFQXgRBbHGTLScWACdPDEZYKOUaJM,CCFBDDFFZBGHKCGG..UGABMEDB....VAAAFGAAQBCFhAAA.REGFBEAEGDDAhAAALAFASFGDhADAAIGEdABFEEBHOEEHaADDNIDD......IFHBhAFA...hAEA...,1,-21,-30,9
UBDKZGcNFROCMeQETPHLgaXJYdIVWfbSA,BECCKBEDZAFHGBDFFABD.CBAH....MEEHeGEC.EDBAHEABLHAChAAAaADG..JDFBIEFDhABA..fDHAhAAAAADEDIEE.cGGENBIAOFBG..hAHA..PHBE.hAIA...,1,-24,-30,6
MTgaBGPUdYSHAOWCFJINQbRVLEeKfXZcD,OAEECGFGFACG...JFAA..IEDCQFFGRBEA.LBBFhAAAKFBFZEGH.MCCA.aGDDhABABHAD.GAAGhAAAdHABYDEEAIEG..WAFCNBIE....hBAA.EGDF..eHFAhACA...,1,-18,-32,14
VfJYWUONELRKZSCMPaHBbgDXTFGcIQdeA,VAECJBDB..UFAHEBAB.LGEEZFFC..CDCA.MAACHEAABEFAhAEADHEAFDHH..IBBGhAFAeAAGAGDH..fHABhACAOHACKDBDaCCAXDGB...hADA......hAEA...,1,-21,-36,15
OaJSCZIUHcLbBgeMGRKEDdWQYNXAPFfVT,FDBAVFFAOBBE..aHCCCGDC.ZCFEHGEELBEGBAHB..MFCEhAAAKCCAdEAG.QAADhAAANCAE.ABFA.PCGFhABA..fHEDTGAHSBFFhACAIHAF.....hACA...,1,-24,-25,1
JBEOQLPWYfCVebaIFcZXNKAgRUdMSHTGD,RFBEUDFCMABHHFBC.DICGEDEFLCAB..PBHD..hAAAYCDECFGEeHEAaDCGhACAFGGCZAECKGAD.ABAGSAHBhAAAJACEBBFE..WFHHfGAE.hAGA......hAHA...,2,-24,-18,6
fHIWASTJZaOXgBVDGLPeFKURQCdMcNEYb,TACAJFADZFCH...OGEABBBHDHFELEAD.FCDDUDEGQDGHhAAAdEGA.MBFGhABA.EHCEfDAHhAAA.HAFEAFEESHFAXACB.gCAEhACA...hABA...,1,-9,-43,34
UHWOLPKbcZRfEVdDgTJICeAQYFNBMGaSX,QEGEFDCHBCAHGAFEaGEA..UDAGHACHOACGLFBGKGDFZDDEhAAARFFDEAAF..DBGGJHBChAAACBAGAHAAMFIF.SEHFhACAPCCG...fAHG.hABA......hAGA...,2,-28,-5,23
WZUHDbOMYfcRVaPITdAXLEgKeFQGBSJNC,EDDDKBEGFEDFBHEH...SFCHCGDGUBBD.HCFEDIFG.MDCH.hAAA..fADEhAAARFFAaEAB.IBAHhABAAICELBGBQAGF.JFEGNABF.bFAHOEBDhAGAYEHB...hAHA...,1,2,-43,45
gDWBGQKaCdOUYHXLSePERJbIZcMTANfFV,FEEEDACFBHDBQBABKDCB.dBGEUEGBHFCE.SHGA.hAAAEGAHRBDEIBHChABAZAEBMADFABEH...NIBD.gGAFhADAaEAG.CHHB.OCHD..XEAGhAEA.eFEBhAFA...,1,3,-46,49
WgOSTMAePYJUVLdGXHQcZFfCbDaKEIBNR,eGFEJEBBLDEEGCBEHAFHZDCF.CACDaAHDEGGG..BHCDRFCF..OEEEhAAASBEEAADE.hABA..UABAdHEHQBDDhAFAfEFCDAEEIHAC..NBIAWAADhAHA....hAIA...,1,2,-36,38
QDgJaVSdFMIUEbPGBAKWfLOeNYcTCZHRX,KDCBLCDFOAFHeGDA....NDAA.TCEDZABD.RAFCDBABJFEE.hAAASEAH.hABAMEIHIHCCECBBPAAAhAEAAEIB..fGHECCHAXGAEgCGChAEAaEGF.FHEC.hAFA...,2,-36,-14,22
bLFcESBdAVYCRDNTGeHKPZMUXgJfQOWaI,CDAEDBBBGEBDHDEBKCCGZACG.UCGA..JHAEQGAB.OAAAhAEAIGFF.LEHHhAAAFAFCEFHDBHHGhAHAAIDCRAGD.eEBCXCEEgGDBaABG..SGAChAEA..hAGA...,2,-28,-9,19
SCdgKfGJNDBWZQTAeUPXHcMEbRYaIVLFO,UEFBHFDEMAAERACD.aAEHLFBC.FGBDCDCAKHCAGGEHDFAEBFHGhAFAQBADAHHB.eAFDhAAAXCGB.EGAHhAGAIAGHSDFF.fCBHhAHANAIG..WEAC..hABA...,2,-21,-21,0
cHXEeZCPIfVBJdGagDRbWMYUNAKSQTLFO,QEEGTDDB.LDHDFDFAHFFEeCCCZADCCEAE..IHCAhAAABBCDJAAFdCBGGGABhABADCAHRAFGMBAC.NIEBAHAFSHFGhACA.cECCPFAA.aGEEgAGBhAEA..hAFA...,1,-1,-18,17
eQRgLEONPIJZfXdMSHYbTGFUWaBcKCADV,eEDGQDGARBAALCEEOHBA..IAHFJACGZECG..dBFAMEBFhAAAHBAE..TGEChABAUGGAaCDDBAFHCAHDAGACDICAhACA.EDHH...NEAAXGGDSAAC.hADA......hAEA...,2,-16,-12,4
NAXSDMYGUCFBHEePJLKVQaORZWITgfbcd,SCGGMDCDUFEGBDDHEFBF...eABGPEDGLDHB.hAAAQBEEOHFEZBAGhABA.IAHHfEAEhAAAbFDAdBEEABBBDGABCEAFFHCEKGCB..aHFE...hACA......hADA...,1,-14,-18,4
bLCUDGePHZKNIMQdSBVOEaYTFRJfcWXAg,LAHDCAEDDEFA.GDCHHEDFZCBHKBDFMFDDdGGABACA..EBFHaFHFhAAAFADA.RFFG..JBAD.hABA.fAHAhACA.XBFHAGAHgGAHeGAG.IHEChAAASHAG...hABA...,1,-21,-23,2
ZQbgNfSYDFHeaAPRCWIMXOKcJdBVTELGU,CAACMHBAKFFG.dFFGBAHE..TCFFGAFCZBAG..QBCGhACA..NBEESAHFhAAADFBCFHEEaDEFAAEAWHEAhABAODHD..cEACEDAF.....hADA.....bFBEhBBAfABF.,1,-22,-30,8
fNXISbEWcQPRaTHKZJgVGAdCeMBYDOUFL,CECDMAHDBDDCDDBG..UBGGFFGGLAFH..NBAD.SFBEhAAA.EABHQEGDhAAAaGECHADHKEEEZGECJGAAhABA...GAECAIHA.dCAFODABhABAIEAFWBHH...hACA...,2,-35,-13,22
HgVYUISdaDOKTJFEQMCZeNGPXLWcARbfB,RBBCBHGBHAEC..VDCFIFDF.dGFBaCBBDHCAKGDB..FFAGMBADhAAACDDD.ZAFG.eFAFhABAPBHFLFFA.hAAAAICC.fABHUCGCSBBEOHACTCEChABA....hAEA...,2,-24,-17,7
JcgTUAdeWVEIFZRfSOGCLbXDPNaBMYHKQ,dDFFeHDAEBDEFBBHZFBCREAG...OCAECGAH.LEAEDAGD.aHFEBFFGhAAA.MDEFKAHFQFFFhAAAJABA..hABATDGBAEIB.IHHAfGAG..hACASHAA.hADA...,1,-24,-39,15
NKLRScVbPOgWEYeGAUQdJZfTXHFDIaMCB,dAGEJBBGZDAH..XDAGHGCCDDIF..MDGHCAFE.BEEAKGGBLCFBhAAASCDD.VGBAhAAA..PDDHhABAgBABEBHF.GACFAHAB.fGHEhABA.IHFEhACA.NAIAcFAG.,1,-10,-29,19
fTaLBYUGPFWgSZDdKJeHOVIXNMCEbQcRA,aAACBCHAGCEEFGAE..SAFBdGGGKDCBeAFCHEEF..IBDFhABAXABE.NIAD.CHDCEFAFhACA..QCAAhAAAAHBGfCGF..YEHD.PAEHhABAWFHBDADAODDHhACA...,1,-18,-27,9
eVaFLNbYZUQRWJfBEPOGdgTDMSICcAKHX,KFFDXDACeHAAFECELBAG....bACCUFGA.QBFGhAAAJAADBCDEODADhAAAGFAHTDDB.hADAMBIFCGHFADGGaAGHYHAA.WFFDEEGC..hABA......hACA...,2,-28,-14,14
AJScQIMVgYLOHNRXDUEWeaCbFTfdPKGZB,SADDQCFEMBFG..VAFGLEAAHEACXEEHhAAADCCCEFEBeFFGaFHHFDHFdGAFPAABhABAKBBBBDDBACIHIHHBhACA.YDBENICHWBAF...CHAAfHDDhADA.hABA...,2,-21,1,22
SMBLdGgXKfeTQRJWIZUEOPYVCHDabNAcF,FBCEBGEBLFGHdEHG.GDDFKHBAeCDHRAGF..JEABZAFD.EBHBOADAhAAA..PDBDhAAACABEDEIB...aFFFAIAEMGDChAIA..XBAB.fADDhABATGBG....hACA.IHHD.,1,-22,-26,4
NOgYWZPQXIcDeGHdBKSMVFARUfLbJaCET,RAEBUAEHLHAA..bACHCHGB..EDCDODHF....YEFGhAAAZEFHPBABXBAFhABADBHBHFCA.dFAChAAAKCCEMIAEFCGEAEAF.fGBHaHFC.NGED.hACA......hADA...,2,-27,-8,19
BfUHYEaIJgKLOeZDcSFdNbXAPTMGVRQCW,MCDFGAEGRAGB.QEDCBGFHHBEFEDHH.aDBFJABGLHCEZGAGDIGC.hAAASEAF.hABAdABBXEGEAGHHPAHBhAAACFAA.fGAF......hAEA......hAGA...,2,-32,-4,28
RZKFBSTfGMQIUbVdDXgaPWLNHCJeAEOcY,OEBFRBGHZEBFBFAC..TADGMDFH.UEEFdBBD.DGIH..aGADLBAFhAAAHGEC.CAHBAFAHEDDBhAAAKGABFAEHGCBH.hABAQGDB.IHGB..hABAXCAC.gEGGhACA,2,-26,-18,8
AQfTdJbFOCGeXKgSERVZcHNUWMDaPILYB,QBDHdAAHJDHD.FFBACGEE.GAAC.KEFFSBFCRGCA.hAAAZGACNDAE.UDCADEIBaHEEhACALFFB.ADGA.fBGAhADAODBBeADCgGGB..hAEA......hAFA...,1,-18,-32,14
QXDJaYVWPGeLObUdCAEfNMBgSHKcTIZFR,EBDBMCFHBAECHBCHKBBD..ICAARFCD.DIBGaEFD..VGDChAAAGDADLDGFOAGHhAAA.dFHEfFAGhABASHACTEBCFHEE...JAEA...hABAWAHB....hACA...,2,-19,-16,3
HAeECQNDXdYPbWfJIGFgMTOKcLaRSBZVU,EGGHQCGDDBDD.dEDG....bAGDJBAHFEAGMCCF.KFFALFCHhAAARAEDBAHEZGACUBAAhABAAIHG.CFFB..XGAGhACA..PAAAfEGBIHEC.hADA......hAEA...,2,-30,-24,6
dPTecaIKVDFMHLBfCNbZWSAYRgQJUOXEG,RCDHJBHBUGEG..OFECGABE.dCGAeCCC..aAEAKEAGDFBHFABChAAALBADBHFACHBE.ZFBBhAAA.AHIB.QDEHhADA.....XGDCEAHD..hAEA.PAEE.IHHDhAHA,1,-29,-30,1
XVeNBIHMKTgWADYcQbJEGdPRaSOZLFfCU,DIEGQDGHEGAH.dEBBRCAD.OGAAZDFHFFCGCAFA...UACGeAAGBHCAhAAAMCCC.KFGG.TGDAhACAAABD..bAFGPDDGhADALEEH..fHAB.hAGA......hAHA...,2,-32,-11,21
VGXIPQcKSNOCMEHTdeaDUFbWLgYZJfBRA,GCFAXEFHQBAFKCAB.ODEHCBGDHEAGeHBGDIDGUACFhAAAFADBLHFAZAEBBHBHAAHHIFBEhAAA.SAEHhABANHEDEDDD..aDHF..WAHH.hABA....JEHB.hADA...,1,3,-25,28
cdQaYVENKCJIOWTDZBGeLPHRbgAMUfSXF,MDEGUDFD..SAHDFEABQGBF...aACDEABGCBAD.IHHAhAAAOEGFDDDFZCCHGEBGhADALEEFRGDAAFIHfAHAhAAAXBEGYEADNEIG...hABA......hACA...,2,-28,-9,19
gSKEDTfNLFQHUYGWceIAMJZBORbCVPXad,MBAFBFGBOHDCRBDE..VGDAaFAGdGBAKDGG...DBCC..TFBGhAAALDCEFDDHUGGAhABAGBEF.eAAHADBBJAHFhACACFFGXDGA..SCBBhADANAEB.....YFAFhAEA,1,-15,-32,17
TIJHdAcZSCLPWfGEDQbNBXFKURaeMgYOV,SGHHLBGH..PGDAGGAHQDAGNBGA.XGABhAAAFABGKCCEaFFC.MAIHhAAAgAEFODBBIAEChAGAdDFGAEDGCCCDWBACDHFGBDEHeDHH...hABA......hACA...,1,-16,-17,1
MLHDYbeROAaGFTIXNEQfgWPcKSJCVZBUd,aDFFGGEB.FHCCTCAG..NGBB.EEADQDBE..hAAAWCEDKAFGCEEFBFCAMCBGhABAHACDDACG.eBHDABDC.hAFAfHFH.cGAHJBHD.ZFEE.hAHA......hAIA...,1,-10,-27,17
EKPWQLYbJZUMRcCeAgGSTXdaNBVODfIHF,GCBFSCECdAAEBDGADDCFHCGDFHACKFCBQGGC.LABChAAAJFEFZFFH.MGAECAEF.hACAADDHTEEB.aCBGhAFAODABEAFA.PBFGYHBG...hADA......hAGA...,2,-35,3,38
fQFZPeUHadILBCSRMAcVEXWgYDJbTKGON,VFCBXAAG......gAEDJEBHKDDHGAFCODAAhAAAQGGBFFGBeFHHaAGEhABAIHAA.BEHGhABA.SFDDAEEEEACDYDECDCCAbFEDfGAChADA..hAGA...,2,-24,-19,5
DBVEYbRdJCNWSfUeAZGTOPXHIcaKMLQgF,ZCDDOCGFHAAG.aDGFLDBF.QAEHDEIFEGGHRAFEdGCHNICB.hAAA..SGFFhAAAUFEAABABGCCGTEAFIHHAhABAMDACBHADbGAGCBBE......hACA......hADA...,1,-8,-16,8
gSRQBbJLWKFcCITDMeYAdZfXUONaVHEPG,dDCDZGFEUADAOFEE..aEDDEAEG..GAGGSAGBRCAE.QCFHhAAABFBAJDFHKAAChAGAFBAECFCF.DEID.MIAChABAAEIF....NIAD.PADB.LHFGhACA.....hAIA...,1,-9,-33,24
UBRPZYAfGTQaFbOdcCeHXSELVINJDMKgW,TDDCFGFGOADE..dCGFCCGD.eHDGHDAESEGHEGAH.IADEhAAADFEGMABAKBAG.hAAAUFAFRBBGZDFCAGFBfGHAhABAaHBEXFCC........hAGA......hAHA...,2,-19,-17,2
AUFfWPQXDMTJgLSVEdeYcNBOIKZGCabHR,UAAEFEFA....PAAEQDGE.DDBFTGGCLDFDhADASCEGVFBBEAGBdEAFhAAA.eGCE.NCICBBGChADAIDDAKHAECDCEbGFAAAGC.XAEH.MEADhAEA.....hAEA...,1,-11,-27,16
ZMYFBPLEeXGKDCQUWObJHVAdaTIRNgSfc,TFCHRABD..SBDBZADCFCBEBEHGECFHGGBHKBHH.DEIFCGGHUFAGhAAAOCGD.JBAHAEDEdEFChABA..aHGE.IAGDhAAAfCEBMAID.LFBC.hACA......hAEA...,2,-36,-10,26
SPXZNfeaOHFYBgcKJRDEbIAMVQWCdLUGT,VGCGQFAD.CEGBLCBEUBFGGEAH.SBABhAAAXAEEZDACeACHOHDGhAAAHFFEFGADBACBKBEFDAIF.hABAEFECACAHMCIBdGGANDICaBAG......hABAYHFG..hACA...,2,-9,-3,6
bTPSaGfKegCRBQdYLMJZDVOFWUcINHEXA,TABASBED.GAGCeBECCHFDRGFCQABCLDFEZEBHDDCHFEFDhAAAUGAE..IHAAhABAEGDAADIF.aDDBKFFEBHHDhADAdDAGMDDHJEHF......WAEChAIA.NEEA.....hBAA...,2,-16,-8,8
WgLbFIdAQHJBeUaORGcMEKZYSVNTfPXCD,JACEBFFG.eHFCOCHDRFAH.GGEDMDHDKFDFZFBH....SEDFhAAAVCDF.TAFGhABAfDBE.XACChAAAWCCE.bAFFIFEHAICG...hABAQCAHaCHF.hADA...,1,-20,-25,5
KbUIDfPHgBMFXLTNaEQVecASRJGOCWZdY,JBGHCBFBZEGH..dCCCKDAFUFEA..DIGCHFACBAAHFBEHLHCChAAA..aCADQCCEhACAeAAAAIBC.REDAOFAEhADA..WAFEIHAB..fHGHhAAA.MDIDhABA...,2,-38,-32,6
JfRCaBLKWQADeNZHdIGFgbTYXSUMVEcPO,eAFGHDAEGABFFACE.TGEFSECDMCGB.EGEFOAHD.hAAARCDDaFAHBGGB.LCAAhABAKFCFAHHGDIGANFEFIDEGhACAgEGH..YFBF..XBAChAAA...hAHA...,2,-33,8,41
NOBYJIHdgLcKfZPGQaUXAbTVMWRESFeDC,TBEBVEDD..RABF.FFFDDCHF..CCCFODDFBBAC..JAFAdGBCLFHHhAAAKEACZAAE.GDAEhABAaEHH..AIEG.MAEBhADASDGC.eAFG.IHHFhAAAcGFBfGCEhAIA...,1,-20,-33,13
BGNPOSJTXZEdIAYQbFDaLcfHVWgKeRUMC,QDDGFEEELBDBHGCA..VAFBgACCeEAD.MAHDhAAABGHCGEGEOBBDTCAAhABAEDHDAICG.DGBH.aFABhACAfAAFWCFH.KHFA.CHAG.NAIASAEHhAGAJFDF...hAAA...,1,15,-23,38
ULSCGZKbVaTAYgRBXFdEJQfOMcWPIeHND,RBAEBDEFFHAE.EECH..JFHHQCAA.MBAE..PEBAhAAAIGDGHFCCUGGEhAAALBGDCHAAGAFCZFFFKADEhABAaFFBAAED...YCHBdHDH.fFAChABAcBDEeAHH.hACA...,1,-11,-23,12
DAEOQXfVRHSPgLKZNMGcdebYUBJICTFWa,EBACQAFA..VEBESDGBLBHFZDCHGCCBdFEAeDBBhAAAbGBCBGHCIGHFhABACGFFFADBDAEB.ABCBOFADhACAfAFA.........hADA......hAFA...,1,-14,-22,8
DFfZaENOSXcgRIYLHKdTCBJPbGQUeMVWA,DIEAZDCEEHAAOEHH..SABE..gCFAhAAARGFCLFBAdGCHBCCEJFAFGADEhABAUBEHMBBFACBDfDBChACAaAHB.NAIA.IHDDKFFB.CFFG..hADA......hAFA...,2,-27,-18,9
TRXENSYPFMGKObQBaHeVLADUcJWZdgIfC,DBBAUEEG..JGBAZBBC.dAGA....ICCEfDAACEAD.hAAARGBA...EEFCSADEhAAAFHGCKFHB.bCFEaHBChABAHEBELCEG.ADAE.cGFD.WFHBhABAgAGE.hACA...,2,-39,-24,15
STBEOYXWJAdNGeKgLfQCIDFUPZbMaVHcR,dGFDeDBEKDFFLEGF.CHBD.IECBUBFGZEACMIAA.HACAhAAASADFBGACOBEEhABAXAABAIEE.NEIE.fCADhACA.DGIFFFEDaDHH....hAEA......hAFA...,2,-31,-23,8
CPWOLZaUBDVTGEJYcebIgHfMKQRSFdAXN,CBFAOCCGZFDEBADEDCGFGDBE..EHDAJFFE..eDBA..hAAAIAAGHCGHMAFChABAKADGQAGFhACAFHGGABCGXFBB..WFEDaCCG......hADA......hAFA...,1,-23,-41,18
GSdXAcPVOJRFHQfENUWaIYBMZTDebCKgL,VCFGOBBH.RFAAHEEGQFGE.EEBDUAFG.aHEABAFFMDDGhAAADCAE.CHBBLAAEhAEAdACCAAIF.JFEDNCIG.ICDFhAHATADD..KHBA..SAGAhBBA......hBCA...,2,-27,-10,17
DcOZdECbIagHKGYXNAeRFSLJfQBPUTWVM,RBCGFAHBLEFHQGFEUFAE....VADHMDIFDCBDOBAHhAAAEGBE.CEEG...aFDFHAGFhABAKAAFGDEDXFDChACAAIDCSCCDBHHF...WFAD.hADA......hAEA...,2,-21,-16,5
FDLXGHBWOMIKfVSdAcPaNeCbTUQRYJEZg,aCDAeAFG.CEDH.UFEBRBCG...JEBEECFAZAADFEBB.LAAHGAGAHGAGhAAAOHEEMFHFKHAC.hACA..SACAhADAAHDDPDGD.NEIG...TFEH....hADA......hAEA...,1,-12,-22,10
HKaVXPEGOMCJRgTQfbNWdBDLeUYZAIcSF,SDCDFCAGKABC..aGFHXGDG.GAECOAFDCHBDREGBQECHhAAA..hAEAbBACdAHABDDBeBEDZAGDhAAAIFAAcEAH.PEHFMIEE...JHBChAFAfFFE.hBAADBBE..,1,-3,-26,23
ZJNIHbSLBcDKfTgYQUFEdRWOCeAVGXMaP,XBBDaBDAZBGB...JHBEHCAF.bDCHSFEG.BBABhAAADIAATGGGQAFAhABAEEFDdAAHODEGACCFMADChABAIGHD.KEACgGDAUADCWHFGhACACCFA......hAIA...,2,-28,-2,26
cYDEaTOfdSNFKILQXeJgCBHPGAWMZbRVU,MBHHRDGHUAAGDBDC..EBDHOCFH.dCAGSFBB.FAGHhADAIHHBLGDAXCCAhAAAJDEFBHAAPGDChABAAICEZAEF...cGAEaAHF....fDBDhBAAKAFCeABC.CHHE.hBCA...,2,-25,-22,3
MBECHdFgQIUaWOVcXefTZbYKJLGRADNSP,DFADSDBAMEBABHDDCAFH..FFGD..QCFAaEEH.VAADhAAAXABC.eGCGhAAAfADGTBGBZADHhACAKFGDJFBALFADAHHBNBIE.EDFF....hAFA..dFEA...hAHAIHBA.,2,-23,-5,18
XeBUKQCgVFAITHPZSWbEOJcLNDaGMdfRY,TGCFHCBGSCHD.EGBGOBCDLCFBaCEFdHFDRFDDeFADhAAAKAGFCFFCFAEEAFAC.ZFGBJAAHDBAFhABAGCGEMAIDfBBHhACABHAA..QEBC.IAEEhABA.WAHBhACA...,2,-28,11,39
BWRJQDKNLYPMGIfeVcdAZUFECXTbOHaSg,FFEGXFBGOAACHCEA..SCDGBACHRGFGDIBEKDGHLABDhAAAMFAHGAEBeEEAdEABhAEAAFIDEGGBTAGA.aCCFhAFAJFCD.QCAG....YDHBhAGA...hAAA...,2,-26,3,29
ZQfTOgHEcaePJUCdbWNFXIKMYLDSBGRVA,ZBAEQDEHOHEAHEACaDAH...eEECJAAEUBGDdAHC..NAAH.hAFAFBDGKBEBMFIH.DCCBhAAABDDFGGADAIDCgGABhAGAEFFBCFCE.XFGA....hBAA......hBBA...,2,-18,-17,1
ZfMUPHNcAFYGSOKEQgLbWDeTIBCXRJdVa,GEEASBEHOAEFEDHD.QCBBLDBDDACHeCADBFEFCHCGJABEhAAAaGGB.ZDDGUCGCHGCAhAAAAAGBKHGC..gAGBhABATECD.IADD....hAFA......hAIA...,1,-10,-19,9
BGEJTPNdcFgVDeHCOYfKSMWUQZaLXIAbR,RGCABCEGEFEG.JFFE....TBAHdAFAFEABDFAHHDCA..CCGGODBChAAAKHDG..SBGHhAAAMBFG.QBAGhABAZFADLDFAAHHD.bADBNAIE.cGFE.hACA.eFBH.fACHhAHA,2,-27,-25,2
DgBacWGbPQMCeHSVXRIFZUTYNJKEdOfAL,LEEDBAHDaGEHGEBEQCCG.eAEAVEECRBGFZAAG.UGFChAAATBEB..JEABdBBChAAAAGCBDIBG..WADChABAMFFGCGHA....SCCB.IDHChACA...hABA...,1,-18,-21,3
YWCMdTDOAHFKfBbNPgZcUeJSaEVGXRILQ,HECAFDCGBDHF..bAAD....PGBEZBFAeGEG.SAFEhAAAaAFCGDFCIEHGhACALBABQACHhAEACACFMICEdGAGDIGEAHHG.fGBGNCCH..hAIAcFDFJDDCEHDG..hBAA...,1,-4,-24,20
PfFgcWOGCNBZMEIQHXKeAabdYSJVTURDL,aCBAdAABSFAF..TFGHUECCREFCPFDFFBGC...hADA..gFAHhAAAOAEHNIDDBBBGZAEGEEEG.hAFAICHE.XCEEAIAE...hAGAJDACDHDAfABBhADA..,1,-7,-35,28
cKSeZAQBEITWPOVJYdFGfabDgRCNUXLMH,EFDGTBEB..OAHFJABE.FCFBGGDH.aGAEDFID.RCBFCHCEXBGDhAAAHDGHKADBZEBAACACBAAEhACAIDCG.PEEAhABAdGAC....bFFHNIABMAFCSDADhADA.....hBAA...,2,-16,-13,3
HfVFTXeSZEKAcUdILJQGRObBDPNagMCYW,UEFAdHBDJGFGGCAG.OADHDAAC..aDGFMAHF..CCBDHEDAhADAFAABeFCFZAFAACEAICFHhACA..REBDBEAFhAEANDIE....YFAFfBBB.hAEA......hAFA...,1,-26,-34,8
NeTBgALfIDEQMZSRCFJXWVOcKbdYPGUHa,LCFFDEDCMCIDZBBBRADHCAHC...FGDF..XCACOAFFKBAHdGGGGGBHhAAA.aCGDNFCB.hAAABBBD...gFAChABAAIACIAHF.SHGAJDDH.hACA..WADB.cFAChABA.,1,-11,-54,43
bdeLRFCWGEIUgKOYAPcDfNJVZSTQaHBXM,DGCBJBHBZACHQFDB.BCCFMGAGeFAHREEH..CHHA.EHFC.UCEAhAAA.KBABOBAFhAAAABIF...fHBHhABASAEAaBFGbAGDdEADLFHHFEHD.WEAChABA.....hAEA...,1,-14,-31,17
fLPWJdaDQRBAIETZgMbFXNUGCHSYOVKec,TFGHMDFEFEEE..UBGGHFCB.OADEVFBC.KCCD..fADChAAALAADJEAFDBCDBEFGhABAAEDCEGHD.ZDAE.XGEDhACACAHH.eHAG....PHEChACA.....hADA..aHAC,2,-21,-16,5
SeAYdCRVQaJcEUHLIWXFbDMgPNGBfKOTZ,dEAFVCCEJFHH..EEABUCDD..HDGFLAAHIFCB.XGDAhAAAFGCCDDIF.MBAEhABA....gBGChACANAGAfHAH.OAHDSFFDhADAAIGCCCACaGGEcGAH..hAEA...,2,-49,1,50
FafDJUVLTAWPBYGgIKbcHXECdSNeRZQMO,BDAHGCAEKHGCHGEE.EAAGdDCGeEDFQFDHMACAFCGHDEHBJAFGUCGFhAAALCCE.AIBA.hBAAPBBG..YFFChBDAIGAA.XAFG.CCACSDEBhABA.NIAD.hACA...,2,-38,3,41
DOAGCMLUYgRHQKEIJVbeNTPdBZFSfXaWc,CBBHLBCCUEAG.RDFDKAGB..EEEH..ICDFJHAG.eDAGhAAATBDEBHHC..FDGBhAAAXGCA.aGAGhABADGGGAHGH.MHFA.gAFG..hABA......hACA...,2,-44,-31,13
STRUMcbaIPVOFJXYHfCAeLZBEdWDNGgQK,ZCAFBDFGEEGEDIBAGADBKCDC.RGFG.UFAE..MCDD..aEFEIHABhAAA.PFDFhABAOABH.FAGDXBGAhACAHDBCCACALDHH.dGDD.NAAG..hADA.SGAEhAEA..cGGH,1,-19,-28,9
gfSGCFBbUPHLRKAYdNZOXTMWJDIQeEacV,dBAFOADEMBEEDDAF..eFAEEGGB...aGEBVCGF..gGGChAAASGCBCGADFDEFhABABCDA.UAAFLCHBhACAAFFDZEAB.XDBA.WCDE...hABA......hADA...,1,-12,-35,23
VBWLNOQKHdaXefIEbZRGJFUPYDgSAMTcC,TBDCVCBE..BCFHLFHD.QBGDKFFAdFBDaABGfFDFhAAA.IGBFhABAbAFGZGAC.GBBChACAFHEE.YHDGDAEFACIHCFEFOAAH...hADA.eDFBEEHD...hAGA...,1,4,-26,30
cZfVPedgKUSADBTHRQLbFJXYGNIaECMWO,DEFBTBBBRBAGLGEG..FCHD.XGEBGEAEaBDF.EDDBhAAAMAAD.OECAhABAfHCBVFBBeBFAhACAgDGGSAEEAAFCBFCB.bAFE..JDABhADA.IGHCCABB.hADA..WDDE,2,-19,-7,12
LGDVMRPZIOTeHUASWaBJfEXgYNQFbcKCd,aEDCJEFC...ECHB..XACC..NABEFCECKFCACFBCLHBEhAAADGAF.MHFGZAFEOGDEhAAAeACDAAGHBAEC.hABAgEGEQCDGbDBHcGGA.dDABhADA......hAEA...,1,-11,-35,24
TaMNeJdgGQVAEYScbCFZHBPXDRIfWUKLO,SECCCHHBFDHB.BEHGDHAGRGDC..IFDBUDED..KADBTADHhAAA..MFAEhAAANBBCdHGD.GGAFABCH.hABAECCE..bCAEHAGF.fFFDhABA.WDADaBGC...hACA...,1,-6,-48,42
MEHQfdYUBRPNLObVKGFCSWATcXaDJZgeI,TBGBaBGEZEEH...eAADMDBBHDEF.QFAAdDHGUADGBHAAhAAANAEELGEAOBABKDHBhABACHGA.AAFCXBBFhACADEGD..JEDH.IAGG....hABA......hACA...,1,1,-34,35
THeCBPSJYILWEXAMDGQbfNZgOdFUaKcRV,DBGDQCBF..bADBZEEG.OECDFCBAKDHBRBEBHABABABA.SFHHhAAA.ICHBhABAWFEB.ABHGMAEChADAfHCHdGGCaGBHTGGGCGEH...PGAGhAAA.JAHD.EDBBhABA...,2,-44,6,50
CKHAaTBOFeQMSDXJbVUNPfgcRdIWYEGLZ,BEFEOHDAQCCGDAEG..XGBBbAAB.UAAH..hABANHCH...gBFDhADAcBFD.IECBhAHAWFAFGEGGCCDDAEFDTFGAMFCEVADE..hADAfAHA.hAGA...,1,-21,-25,4
RMAbSWKDINGVCFPHQLXTdgOBUZcJaYfEe,SGDEDCEGGCBEFGHHHBEFLFDGdDAHBACBZAFAaBHF..ECHBMDHHhAAAAEFC.KBAC.IFAFhABACCACQGAG.hAEAXABA..gECC.hAAAcGGCfEHGhABAeHCG...,1,-13,-28,15
DITfecSJZdNFQgBMLbAOYRHPWVEKGaCUX,OEADRCDCHBBD..VFBHKDBECHHD..DEHF..TFEGeACGSAHFhAAAZAFDdEEB.FHDEBHCChAAAMEGFABCG....hABAPEHDWFAD.EBAH.aAHDIFEH.hABA.fECChACA.JAED.,2,-30,-12,18
dMQRKFeLINEAPUOWbgZfVcBDSXJaGYCHT,OCGD..gADFZABA..fHABBBGDDAABSFBBhABAXAGGaDADGGDBhACACFHA.TEDFhADAMACAKGDAFDGEeBCDLFDEIAHHECDDACFF..hAGA.WBBD...hAAA...,2,-28,-16,12
PNXHVZaMgbYOAUKfRdFQcBEITGCeSLJWD,KHGCdEEBFEHHBACC..EBAAGBEE.SAGBJFCDDDBH...hAAAXEFDZAGFMADD.hAAA.bGBAOFFB.hABAABGH.UEBH.fADC...hABAcBBCCCECWFADNCIG.aCCHhACA...,1,-22,-41,19
CFdOXLVaGZYNgEWBAPbTHDcQeUKMSfJRI,TCEFHGCCQCFB.UACFKEGBfGEAIHADdDDGOAGFhAAALDAFGECAhABAZFGHNDIGgDADhACABAAAAGGFDDCFMBCG.SGGDCBFB.XGAChADAaEEF.EBBD..hAEA...,2,-16,1,17
LKWHcbMJFUDQTeXIGfAdBPVCZYaSOERgN,BBCEVCEE.CGHGZECH..aFGD..EAEFRFAGLEAEHCAH.MBCAhAAAJCFFDEIF..eEEBhABAXBGAfHABhACAAAHAdGAA.SCCC.NIDFKDHBcAAG.hADAFEEH.....hAEA...,2,-27,-14,13
TJdSYCZBEPRgKbMeDaAQGfLFXUHONVWcI,GGEBLHAEUDAFHAEFOGBAVABH....IGFGTACHSAAChAEACDADBEGBEEDG.hAAAPDEGKAGA.bEFADGAEhABA.AIEE.QAGE.XGAChAFANCIE......hAGA...,1,-11,-17,6
eNZWYRVacKXHGbECfQSTBOdAMIULgPDFJ,UFDFLEFBDAEH.FGAD.eFCB.ZAEDRDCGVBADKDAC..GACGhAAACBGF.SCHHhABABFBBdGACAHIHMFID.gAGAhACAJCHH.NEEA.aHFE......hAAA.....cABAhADA.,2,-49,-3,46
bIYGQUFCTAJgWPcHdDONMZeaSEBfRLVXK,JCEF..PFGBdFHCDCAFMFBF..ZBFAaBAHBHBALBCE.hAAAKAFC..ICCFhABAYDDCUGEA.CFAG.hACAAEAE..WDCDOEBEeGCA.SFHBhAAAEDGF.fAHAhABA..,2,-44,-14,30
VBfOcTFWHXQbeZLdNaJGUgSDKRPAMCIEY,MGFGEABCBDFG..OBCFFDBGHGDCQAEAeCHHdFAAaDHHGECHhAAASDFFDGGGRAEGAAIDIBAEhAAA.fGBAhABA.WDAFZBAG...JHCG.KAHFhACA.CHHAcECC.hABA...,1,-7,-13,6
QHNDbREUeOZIcSLVFdYGAgWMBJPCaKTfX,MFADBHDECFDDKBAG....TAGDQADFDCBC.RFDCUCGDZCEA.hAAASHGAFFHFdACFABFD.hABAJDCB..aDBBfHEFhAAA.XGBGbEEFEGAH....hABA......hACA...,1,-28,-32,4
OTeVSGJAMUWBcKFCLHaDXENIRgdQZYfPb,UBGABCCHFFDBCHHA.LFABHCBHDGAH..EFGHRFBC..dAABQAGGhAAAZAEB...fABChABA.PHDChADATEEDeBEBSGEAAHID.MICEhADA.KADBaCHD.NEAB..hAHA...,2,-31,-13,18
QMdZSGBPVTcIeKEDUaHNACLYORgfbWXFJ,CBGBOAAERBAC.....fBHCXCDHFHDGQFBGhAAAdGGAZFAFBDFBPFDA.VCCChABA..IADDhAAAEHFADAECaDHDAAGGLFFE.gFCChABAWBGDMDAD.SHBAhADA.,2,-24,-17,7
DQYJMEcBSPgZCfOFbdHVUIeGKLaNWXART,DDFAJACE.MDBBBGAF....SAGGZCDBCGGG.FABEHBFFVEDEhAAAeCCF.KEHBaHCA.hAAA..XAEDhABAAHCHTBAEEGHB..PFEDOCCH....hAEA......hAHA...,1,-29,-35,6
fNIUaDAeFHBOTEXPKYSGJgRCcZVLQMdbW,FEABBECDOEECECGDKCADGBBC..JFFFCBGBZADHLCCA.dAHChAAA..fGEDhAAAUGBCAGEB.eEHH.TGAEhABAPABC..SGCH.cCGDhACAMEIFWFAF.hAFAaEEA..,1,-26,-31,5
RBGNVgYKUALMaFTeQCbHcZfIDXdESPJWO,LAABFGEHeBAF.CGCEHBGBZEDADCCGdFBC.EAFD..SHGAhAAA.JAHBODCE.hABABFFEVGAAgACGhADAKAFEADID.aAGATCEBcFDA..IDBDhACAWHFANEAC....hADA...,1,-11,-30,19
KcWQGAeSEYXZURTObCPLDdIFJNVHgMBfa,ECBCXEAHZGCE.REFH.OACC..bFCFCGADDGID..dCCGFCFEVAEHhAAAHEEGBCHEKAADQEABhABAAAIBeFHH.SEDDhACAYCAD..PABGIHGG.hAGA..NBIEfDDDhAEAcDDF,2,-24,-21,3
AGeSPQIfgFMWYNHBaVCObEcdRLUTJXKDZ,eDCAQBAD..IABGFCGAMFGD..NHEH.aGBH.CEBGOFEBhAAAEBGFREAHLEFChAAA.TFCFKCEBABDGPAFAhABAfAEH.WHAGBHHH.bECB..hACAdADG.....hADA...,1,-8,-24,16
OLZbTYHcJCVEaKUDNWfReAgIMBFGSQXPd,MEFAFEADGBCG.QEFAdDDGLBDCZGCE.bABFHAAF.JCFChAAAEGAFKAEGDIDC.fFHChAAAAAHE.IFFEhAEASEEF.OHFCYECFCBHEaECHNBBGWAFEhBAA....hBHA...,2,-27,-5,22
BbeRWVcNZLfgMDFOJTKPdGHASQCEYIXaU,QGFCCFEC.EEHBIDEC.aCAFUAEA.BBCBRGFE.hAAAVCAAZEAALBGHhABAMIAGFDFFJBHH.KAAFPGAEhACAGEBFAIAGSBBBbGBA.cADAhAFA...fEHChAGA,1,-14,-26,12
YKLPIHOCMTeJaGFgBNdQAUEcbDSZWfXVR,UADBEFEFDICAZEDE....XBFEVBGF.RCBHLHFEHEAHCCAAMECGhAAAJEAF..GABBhAAAFFGDBCDHdEEBADFE.SAHBhABA.fDHAKABBOHAEeECHhACANEIC......hAEA...,2,-20,-10,10
aSLAPQTMKDVYdXIHReOJEZbNCfUGFcWgB,TADEKAGFDHDA..dDGEHDEA.OAADECCCZAADCHDEUGGAGCEAFCGG.hAAA....WGAChAAAgFBH.SGGGhADAAFCEMAFCXCCCeACANIDBBHAGaDAH.hACA......hADA...,2,-20,-17,3
VOSMQXYWFeZDNGEAHUJRbTPagfCBIKdLc,UGCHJDFH.RAAC...TGBFaEFD..CCCA.BEAD.KDACdBHELAHBhAAAOADG..MCEChAAAQGDG.XBBEhABAFHGADGBHNFBHAEDDbFGH....fDEHhABAIBGC..SGAFhACA,2,-44,-24,20
dRYCODFJBGINWVKaLMXgEecPHTZbfUQAS,dFEACBADDEGEBGHA.GACE..IGFDVGAC.KFBELCADhAAAMIFC.EDFE..PFAHhAAAHAGD...TDDEhABAfFCBACCBSADF.YCEChACA..OHFChABANBEFaFFA..,1,-12,-50,38
YcfAeUSVbWHNdGBgXTJRMKLPaIDEFZCOQ,SFFEVDAH.HGCAdDDDBAGE..gADBXGDCJACGhAAAMEDG.LBAFhAAAaHGA.DCIDFCGECAGCYBCDhABAABABUEGF.NFAD........hABA......hACA...,1,-10,-34,24
TLaNWfKGOSHJBQcedIZMYADXVFbPEgUCR,DCEBFEEEEHBAUFBD..CFAG.RAFGLFEB..aGHB...NEAD.hAAAKCBEGBCDOABCSDGBhABABDAAeCHFIACAhAEAMAAFAHAH..XGGEPAHFgFDGhAFA..WCFBhABA..,1,-31,-34,3
YdSaLZJKeHOfUGXCBVgDcbAFNITRMQEPW,FDEGTBCCQEGF..PFCBdCBFSHAGLGFEJDFGhAAAKBEGHEBFOBAFfABDhAAAUAFCXFDFhABABHDGDHEEAHHD.IBHBMDAB.WADE..hAHA......hAIA...,2,-24,-11,13
efAPQdOXLaUFHBRgGKbDEZCNISWJVcMYT,QGFEOGECLEFGaCEE.UBGCFBBFBFBDRDBDGBDEDGEHCAHG..hAAASBAA.hABAJFABMFEE.TAEFhACAAIHEXGCHKCHBbGAGEAAC.NAED.IDAChADA.WDDG...hAAA...,2,-20,-15,5
YOBPFHEKeNGXgSWCcaIAbDRMUZLJfQTdV,REEGZBFDLBAFQFFFdFBC.OGACBGEEFCBCKDAHGAAF.SECChAAACDGFaAFH.IHHFhABADGHHMICCfFDEhADA..TAGE...YAAChAEA..ECDAhAEAXECB.,2,-31,-7,24
dacIPGAXHNRDTEKbWQLUMSYeJgfVZOCBF,HDAFDAFEKHBGQECGLCBD.MCCC.SAGCeEGBJFDH.fGFAhAAAOAEHCCGC.BGDHhABA.FEEAaFFHIACHhAEAABHCRDCE.ECHBbAACWHBG.....hABA......hACA...,1,-1,-31,30
eCEGMNFBYIbOSUKRgVADdWafPLTJQcXZH,dCCHaBGELFHDJAEA..QAACZAAGHAEHCGDBEGDDGDEF.hACAMCDFFCFABFFA.hAAAIEBASGAHhABAKDFF.VCAHAIAGDADHPFFB.....hAHA......hAIA...,2,-40,4,44
WLTJZVIgGRSCHdQPEOUaNfbKDFMcAXYeB,XBAGeBCGLFAFZBGH...IHGAGEDECFHHQFEGhAAAECDCaDAD.fCGGhABA.KFBHDHFGMCIBhACAcGAFBDAFJDFFgDDCSBBE..hAAA......hABA...,2,-28,-7,21
AdRENceKBGIWgVMPHSCfYXbDTZFJULOQa,dBCDEGEH.eDGFKBBEBGGAGBAC...IHFGVDDBHBFC.SGAChAAACAAF.XDGGhABADGDGFDDEUFAFhACAOADAaHBCADCH.NEIG.gGBAfAEDYCAFhACA....hAHA...,1,-18,-24,6
AYgRNHFVeDTcUOQPaGMZCdEbKISBfXWLJ,RCCEHFCEeCFHTAFD.OCACaGGCGEAAMIAGZCEHEAFH..KAAFBEBHhAAA.XGGDhABA.JBHBAECGYDHFhABAFACBDEAH.cCAB.PHCACEDB.IAHBhACA....hADA..SFHB,2,-20,0,20
CLGUJRYfQNMWFIeZEDXdSbTcHgBaKOAVP,CAGGUGGARCDG.QCBB..MDBBIHEHZEGFDACH.dHAHTADChAAAHFCABAAE.hABAaFFDKDGA.ABIDLCFFhACA.JFAHfADAFEDFEDAD.SCFEhADA...hADA...,2,-33,-18,15
GcEQTODKSAFgdfIBUJVbYeZWCNMaPRLXH,FGBHdEFFBCECUFGD...JDAA..VDDGeAECZDBF..CCGH.aAADLGBAhAAA.HGFGhABAEAGFOADHDBBE.ADID.hAAA.....fEAAbEAGNAIA.PHDEhACA.XAEFhAIA..,1,-20,-36,16
VZFaJYDCIOWQSdgMbPGBNULKEXTefAcHR,RBEGFBAD..aBBAJAFHDFIF..OFEG..SEDGMECD.hAAAGGAFBBHFLGEAhABAEFGHTDAAeDDEfAFBhAAAACDA..cGACZCCACGEB...IDHChACAWHEAgDGChABA.,1,-25,-36,11
TWaJDOLNEFBYHXKgcQVUZfPGAbCMdeRIS,MAIHdFGFeGBCREDB...SBEHTBFD.aDAEDHBA.OCCChAAALAHDEEAGBHFAXBBChAAAKFHDQADFhABAZFEFfADFAIHACCAE...WDDA...FGHHhABA......hACA...,2,-20,-18,2
KbgONPVCcULGdRWTaZJDFXIHSfBYAQEMe,ECHBMDCGKAEG..OBHF..PCEHVAEA.UFFGGGDDdHBFRBADhAAAaACDZEAE..DCAHXABBhAEAIEEESGEDhAGABECBAIHGQEGC.eHAG.hAHANCBCCABF.....hAIA...,2,-19,-6,13
MRNQeJFSAZgBXYECObTaDUfWVIHPcLGKd,BBBAEACE.OBEHaEDCUAGD..VAFEHFBELEFHKCEHdGGFMCBEhAAAQDBD.FGDGhAAAAFAFXGDECABF.hADADBADWHFAIHAC..PCHD.hABAcFAE.NIAB..hAEA...,1,-17,-22,5
VFeBLYWNUEIaAZJObKSDdTgGfXcPCRHMQ,OCCGKDCHDCBE.dCGAGGAD..XABCCABEHADD.QFAEhAAAFEEEBGGGLDAFhAAA..NCIAUFEFaBFEAEIF.hADAJAFASHFGfDEE.PCABMAIF.hAFAeHFA.WFDDZDGF.hAGA...,1,-6,-15,9
CAbGJXTSUPFaWMdQVgNHEIBfcDOZeLYRK,GEBGTCCE.SDHHFGCA.MAHDVGFEHCAEBBGHDAABOCADhAAAZEFFLFDH.hABAKBBCAAFHXGAGhACAaHGEWAEDdFAGNFCH..fADE...hABA......hACA...,1,-4,-26,22
cLWQEXAKaBbIFfUMgGHVTCDNJReYOPSdZ,BEHBFFGBUCBFGAADHFAFCFCF..DBHHRADE..OGCGdAGBLCEHhAAA.QGGChABAACEDaAAE..fHDHhAAAMDAEgGCFVCFA.NEAD.YAFC.hADA.SFAFhAEA...,2,-25,-14,11
HINYKTbcRWMZLXSCDEFVeaJOdUBGAQfPg,QDBE..PHCEIHDDKCFCTAADREFBZFBELACGhAAASGAACCHH.DDFHFAGAhABAeEGFaBFDOFHDhADAdBDEUDAGACCE...fAGB..NEAE.hAEAYFHB.WACEhAAA..,1,-12,-22,10
gHYBZaIdfMASNTJeODRCFLPGXbKUVEWQc,TBAEeFFGRAFFLAAF.GFADbFAEKHFGUCCBEEGD..QDDEhAAAHGEEBBHAaCDGIEAAhACAMBIDAAFGJHACDIACCDFDhADAXBFB.cDAH....hABA......hACA...,2,-12,-8,4
XEDOcGSBAUMYWdNbCVIQeZFPaLgJTHfRK,MEAGdBCACFAC...VBBEeBEA.FEGGLFGH.JHBAHBAHKAGC.hAAADADAGEECBCGHAIHGUBGDhABA..NEFEQFBEhAAAaFBC...fGGA.hACAEHAE.SEDBhABAWFAD..,2,-24,-22,2
GAYPRTCNafcIbEBUVJSMgFKLDQOeZXdWH,RFADTADHCCEH...aCGC..fGDE..cGBHhAAAIEEHBEHGUGGDJBBHSGFAhABAFDCHKFGCQAADhAAAZDDBdAHG.WAFCAAFENIEFEDAD..gCGBhACADDDB.eADHhADA...,2,-30,-8,22
BEQAKWCGFJMeXORgYZPVDScHIUdbfaNLT,KDBBGBFGFGHH.MBCF.OFGDRFCDZDEADAABHFBD.dBDE..aCBGLBHBhAAA.EGABAGGHCCHDhABAeEED.XAEBhABA.PCAHSAEA.IHAGhACA...fEAGhADA,2,-50,-4,46
XdMCSHGEbYBOWfAgPDIZQULFNJceRKaTV,DAGDQFEFUBAALHCCJCDC..RGAEKDGG..TCEAdCAFCAEC.hAAASEEDGDBFEGHFhABA...BAGDfFBBhAAAAIDG.IHHA.NBHC..aDBEhABA.MEAD.YACChAHA.,2,-42,-25,17
IVJbEKDQeOafXZGFHRScMTUBAPdWNgCYL,dGHE..NEHC.CDHHLGAC..JAFCEACAQDDC.hAAAeCBFfECDhABAGGCDFAABRCCGSGEEhACAMIAABDGCAIAGPAFAgADBIBEB.hACAKBBFDCGGaCFD...hAIA...,1,-14,-23,9
HKWBZSFOPgNEUaDJRXcMYCdeIVATbQfLG,QGBDLDAGKAGBZDFAOFDD..gGFBEGGH.aAAHhABADEEGREDH.XGAHhAAA.MABFCADHIAHBhACAAFAGfACEWBFGFDAFNDIC.JCCBdDGAeFHB.hADA......hAEA...,1,0,-28,28
ZUKXNgGJIWMEOPbdfDQRYTaVFSeHCcALB,BHCDKDDB..XGFCGCDAJAAB..MGBGEBFA.OBAAdFACQFGAhAAATAFFFHAEeHDEhACACECGLCAGZDBH.hADANEIG.IAED..WAHBfDFBhAGADAACYEAD.SFFEhADA,2,-25,-14,11
fJRVSeTEFOZGPdBDMcWAKaCXYNIbHLUQg,KEBDaEFA.CHCB...XCDC..IDFHHEAALBCEhAAAUBAH.gAGEhABAREGH.eGDCEEDEOAEAhAAAZGFGdDAFMACCABDG.NIAD.fBHESCGGhAIA....FGFH.hBAABCEC.,2,-47,17,64
bfJcEMFSeZaRTHYWLINVUOCPQABXdDKgG,BGFCXDCGKCAFGAFE..fDGAEEEH.FGGGeHBChAAAaGCFRABATABGHAFDLFAFhAAAVEAH.CCHEADFDDHGChABAJBAHSDGH.YAHHWHFA.hABAICDH.NIEF.hADA...,2,-25,-2,23
fHRTeUBSYDQJWVgcZKAEPFCGadMbLOXIN,FBHFCACBdGAHMEEFLCBA..OAED..NHDFHDFCeABDSDGHhAAAQEBHVAFAhAAAgEAC.KGBEhACAAICEEBBEaHGE..IADEfEEE..hABA......hAEA...,2,-24,-20,4
IFaLYbMZUSDOJRTfHBdKAeQEGgWNXVcPC,eFCAQEGGEGGDGAFC..gBBGXADC.VAEDCAHEaBBDhAAALAGH.YCAFhAAAMFIHZEAHDFEFOHDChABA..........hACA......hAEA...,1,-15,-18,3
bOLTEJCKAYFVPGHRWDXUagNcfZQBMSeId,FEADVBABHGAC.RCFADEDDaAEC......NHDF.fDDBhAAABCGGMFFAeFFH.IBCBhABAODEBLFCFhAAA.EGADCAEDACEE.YEHDWAFE.XCAChACA..cABAhADA.SHGA,2,-29,-22,7
cRJHdXQaYOVSgGKDNMEbefLUPZIAFCWBT,FFEFCDAABCGHRAGFHDAB.dHEDQCDE.OBACVACGSGGBhAAAKGAF.DGDDNIDD.hAAAMEDAeGFG.LFBAhABAZCCEABAA.TAFDXGAAaDHD....hABA......hACA...,1,-16,-22,6
HYOKJEdQRNFfXaZSBATMbLeDWCUVgGIPc,TAGDMFGHLEBD.eADCDIAGUECHGEDE..IGHAhAAAPCAAHCGHKBACJCHDEAGAhAAAdBEC.RGDC.FABGaFAFBDEEhBAA.AIBECFHH....cCAE.OACGhABA..fECChBFA,2,-31,2,33
VcdGMJPLZQeKFgHSBbWXNTOaRAYDEIfCU,EDAFCEFCUAEAdFHCGDBG..MDADLADFQGBDKHAAFGDHHAAChAAABFFA..bDGDXAADhAAA..ODDBhABAAAGEIEEFcGFCZBGBSEBFhADA.NAIA.....hAHA...,1,-14,-21,7
HRebYcVFBEOANgdSWZMUaTCJGPLIKXQfD,dEEGSEBEMBDCUCAACHCE..GFDHLCHDKCGD.QGCHhAAADEADeAHB...cGAGhABABAAFAGBA..gGGAhACAaBBFPACAXDCB..fHFHhAGA...hADA...,1,-24,-31,7
bOZdVfLJUcCaYSgPIQHDGFNWBRAKMXTEe,XGFFEDAB..OBBGZDFGdHDDLBHBUCBH.CDFA.aFADSFFHhAAA.ICDFhABADDADFAACNACFBHDBACEAKCGEhAHAMFCH.eAFFfFDG..JFAHhACA.YHFG.hAIA...,2,-32,-16,16
EDGPgQbfFOdaRWHTLCXNIecAZSUVKMBJY,ZFFDUCFDMEDHBBCA..JABAEAAH.GAEFQCFEFDAD.dFBGaEEHhAAA..RCDD...TGFEhACALAFC.NDIEeAADhAEAAEIHSECF.....YHAAhADADCCB...hBBA...,1,-20,-24,4
RYbMDSJCWfQOgTNXGKBcZAdPVILFeEHaU,dGBGVFGDFGEF.HACCUBBGRDFH...MDABDEDCCAHF..QFCHhAAA.OBFDTCAGhAAANACF.KGHDBEBFAABAICHDhADAEHAE..aDEH.SGFDfCCBhAFA.XFCB.hABA...,1,-23,-24,1
egHIfMaUYXTAKZBRLDcOGQdVCNbPJEWSF,ZBACBABGLEHHOEGFdFBHCEED......bAEHJBHF.SFFDhAAAeHAEHEACMCCDhACAaGFFXAGF.hADAABEFDBIBcBDF........hAEA......hAFA...,1,-15,-50,35
ZaJVKOTWNYGQIFbCDMgHRdXSfLecPAEBU,EGHDBDGHUCCAZACH..JFCCKGBA...OAAE..TBFEhAAA..NBEHGCFAhAAAQBAAFEACDADAgGAAhABAdGACSHFGeFFGAAGEaHFC..YFDHhABACFAH.MDIF.hAEA...,1,-14,-31,17
cVZXGUadRLSgYKHOEFTBINAWDfCPQbeMJ,DDGACHGG.QEDGeDDHMAFH..JEACZEGHUGAARDAFLAGB.hAAA.SBDBhABAKCBCOAABEHGCBGFCAEHAfCAHhACA.bGCAXGCA...hADA.aGGG.YAFDhAEA.FAHD,1,-8,-34,26
aLKUIcfbNTHSeDJBCgWAOFEQRdXZPYVGM,OAEEQCEGRDDBZGDE..VGCCGDBCMAACKABG..UBBA.hAAA.fBAGhABATFGEHBGDDCCECDGBABFEFFAH.hADAEEBEdEAG...XFGB.aAHD.hAEAIHAB..hAEA.NIED..,2,-19,-6,13
JVHCIgfQUDNXKYBETecRAPSLFdWZOabGM,SHEEFBBEZAFE.OFCFGEED.MDDAVACHHGAC.CHEC.IAADhACAQEAGNAHE.hAEAKGHFBBFDEAAH.eDEDhAFAADIF.dGAAaADF.........hAGA.gEGGhAIADAFC...,2,-26,-9,17
beIdYXaBcLJUWDAMfSKgGCOENTRZFHVPQ,MABCSABDKAHHGBCEOGDG..EFBERGAAHCFF.QDBAhAAAIFHHdGEGaADFBGHGhACALHAGUAFHDCECAAIDCDEFhAGATGFG.FAEE...PAAHYHFAhBAAJEEG..fCHGhAHANCIC,2,-16,-12,4
GZfYTABXRLDQJagecEPNSUFCdOHIWKbMV,BECHRAFHQEGHaCGD..eEEGECCBSFADFGCAdAFGHCAGKHDGMEAHhAAAZAAG...fGGDhABAYFBEAIAEDBGC.hAAAJABGgADH..NCICOHAChAHAWEEB......hAIA...,2,-14,-10,4
fLYeQMNVIPRUXgJOHTcbSaBECDdZFAWKG,KGHHGCADLCCHeACCMFFD..IBAEUDGBJGBEHFEC.hAAATAGDSHGChABAEHDEDAFBFBFEABDA..fDAAhAAA.QDGBNIAB...hACAPCEBXEBGOGAGhABA..,1,-5,-25,20
bUXcVdGPJgFfIDRHaWKBeQSYLEAMCZTNO,MFHBZCDHOBBGUBGE.....XFGGdEFEJBCHFBEBDDAERAFFHFDFhAAAKFAFBHDD.eDFAhAAAQDACLHFGAABBCHAHhACA..NABB..bFBB.......hADA......hAEA...,2,-31,-12,19
YHUcOfbdBTWALKaDNIePQFgJMZGRXCESV,KACDDEEAeACBFEGF..MDCBGGDD.CEBB.SEABHAGBOEAHhAAAdHBFBBDHABBBLFDEhABAaEEB...NIAH.IAGAhAAAPADA...gGGA..hABA......hADA...,2,-48,-10,38
WLRdgeXIKEGFcSTHYbPfVBCJMDZNAOQaU,aFCBUBAALCABdGBC..eEDHKAGCFADCSAHFHDGB..bGDChAAAVGFA..CCDCMIEEhABADDIDAFFA..OAEFhAAAQEEARCCH.XBGA.ECEF..hACA......hAFA...,1,-9,-27,18
IBLgCNfJeTcZVUGFYbQdRAWDaXKSPMHEO,DDGAXFCBKABH..MIBAOEHF.BCGELGFCCAFE.JEBHeABHhAAAZDDC.UGFCGADHhAAAFDCCQADDhABAAEAB.SGDHEFDAIEHBfHABhADA..cBAC.hAHA...,2,-30,-26,4
ZSQBRgJcbHLdMaWXFTeAYPVCEINDGfKOU,VCCFCAEG..EDAEDIGAKEFEZFDDBDDB..RAEB...JHAGHCGDdBAH.hAAAaBBGFECDeGFC.AHBG.hAAA..IHHFhABA..NDAA.OAFASBGEQBFHhACA...cGDDhADAMABC...,1,-16,-42,26
ebHcVLUWNCPSMRJQFgKfaDGEZOIBYXTAd,dAAGeFBEHCGBLFEHUDCECBEFSADC.MAAHRFFHFEAGKCDADGAHhACAEAFHZGBABGGG.XCBBhABAAGDG.VCGDhACANADF.JHBG....fBBB.hAHA..aEEF.IHHHhAIA.,2,-33,-3,30
fCEgKbRWQVGPTeXLSHFAMaZJUBIDcNdYO,MEFFJDGFBHDFDIDG..dFDC..OBFACBED.KEBARCBA..QGGFhAAAGEEC.eBFELADHhAAAFABAAAHAZFABUBAG.hAEAIHAB..YCGFEGHH..hAFA..WFAG..hABA...,1,-17,-39,22
TVLNbZJUEMRAgfWFDGSPcQYBKCdIOXaHe,...fAGGDAFGSEGDQCBDKACDdCDEOAEDHGDCeCFEhAAATEDHLEBFhABAZDGBEABFAIBG.FADB.GGDDhAAA...........hADA......hAEA...,2,-36,-1,35
aCTQMgRSNHZdBGDEVbFfWUAPcXOeKLYJI,XCDHKCBCLEHF..JEHDCAEG..QGDBMADDRCAD.SGAEhAAAHCFABFBHGBEFhABADFFHEAECFEECUAADAACA.hAFAOHACIAHATAGGgDBAdHED.hABA......hAEA...,1,-10,-17,7
PbXEQIZHVeMACJODKRagLTWFcfNYdBGUS,CFEDOHCEKCEG.RABELAGDFHGE......NADEBHEGUEAGSHGAhAAA.hAAAXBAGQFAAhABAIEGF.HEEFMEEEAFCCDDEHaHAC.WBHBhABAfABA.YAFChAEA,2,-51,-30,21
VKdfbGMRPagcIAWNUCDBSHeTXQOZEFJLY,UFAEDIDGHBFBeFEEQFBBZDAC.FFGEJAAHLEDHKHFG.dBAEhAAAGCCFMAFCRACAaAGF.hABA.IHHDAEHD.hABACBHASCCGXGCFOFHDEGFB.fGEChACA...hACA...,2,-20,-6,14
YcSJBHZfANaGDTPFVgWbIMEXeLUCQRKdO,aCCBTABC..VEGB..bCDC.EAFHeBFCLEEDCEAE.QFGHhAAAKADAODDFSHBGhABAHFEBAACDDDGAgDAFhADAIGAEMAFAXDGEdAAG.YECFhAEABHCC...fAHChAFA,2,-26,8,34
UZNOXgSKBVbWHICDARfEGedJTLYQaPMcF,EBECeFBCdDEALACG.aDABPBBD.FGHHNDCD...XEGAhAAAKDGHBFFA.bGBEIGAChABA..DGHHhAAAfCGATAGCMFIDcGCGOBACSADChACA..WECEhABAAIAC..,2,-38,-12,26
fQXPcWeBUaYENGLDbOZHdMVgJCATFSIRK,FBAHRFCHQDAE..XDGD..PBCEeECDUAEBhAAAaBHBEBACNIDF.GEFGhAAADFAHOEDFdGBGMADE.hABAgDDBABBGIGHDKEHHfFFGhACABHEC.bCCE....hADA...,2,-31,5,36
gCDNGZURHIfKbaVBLFWEPScAdQOTeXJMY,OCCBeEFEMDDA..CBGHDGGDGAACZEGHHFADKAFEaFCEBDEG.FAEAhAAAEGFG.SHDGhAAAAFDCdGDG.XADGhACAJBAD.YAHB.NEAAIECGfABDhADA.LAHH.hAEAcBEH.,2,-26,3,29
DdfRUGIXZePFONcWLbMYCgSaAHJBTKQEV,JGAETFBD..QACEDEBAdBDH.UAAEXDFEZAGD.eFFDhAAAFBEA..OFHD.hABA.NADDLHBAhACAMFEGCHEH.SCBGAEGABEDC.EGGG....hAIA......hBAA...,2,-34,-22,12
GOETRVMCUNcfaBHKZPdWSeFLAYJbXDQgI,JFFAXCDH.DGCGQAEB.GDBBOCFARFDDCBCDNHAH..hAAA..aABDBBHFKFGEZADEhAAAPBABdDAFSHEAhABALHAC.AFDC.bCFEIHHGEFAG.TEAGhADAMIFA....hAEA...,1,-8,-27,19
EUGCITKVNLHPdJSWRgQOAYcbXFefDBaMZ,...bCFHFGDC.DCGHBCBGZABDEAGDCCHF..KACALFFAdHGB.SBHHhAAARFAAODCEAGGA.hABA.XADAaFDFMBFEhAAAIDDH.NIAD....HEAAWCADhABA...YHAGhACAfHFF.,1,-19,-26,7
eRbKNVQcYXFdSOfULMgBATZHGPIECDaJW,HADDGBGAEBGCCCEDDGCAJHFE...RGFA.KAAG..QGADXGBBSDFAhAAAOADBLBAFhAAAMCAEADIFZEAEaFGE.hABAeDDD...NDAC.cEEF...hACAFCBF.....hADA...,2,-17,-12,5
DNPedZEURJCTfOISQcbWBaLVYMXAKFGHg,KEAEGADDHFDHDGEEeCCEdECAZGFGUCFA.RGFC.CCCA...OAAHSHCChAAAQGBD.hABA.cDACBAFAaAHFhABA..LAHBMFFCADBA.FEEC....hACA......hADA...,1,-9,-27,18
bTJdXaYKDWAeNCIRcELFZVSgfGPUOHMQB,CEECRAGBEGAFZDCH....SFFEGADCUFFEHCFABFBB.TBAFhAAAJAFAdHEF..aDGCDCCEhAAAAFAH.eFBF.IEAHhABAFFDDfDBF.MIFG...hACA......hADA...,2,-32,-14,18
NgJBeDfHFLIXYaWGScETPCOZQbMVRdAKU,UBADJBGHBFDFeGEA.DFEAFBBH..LCHB..IEAGhAAAaBGBGDBBEHFCCFHFOGAAhAAA.QBDAhABAMABCVGACAIBE..NAED.HDED..WHEA.hAFA.cAGF..hAIA...,1,-8,-39,31
bPLXRZNWaJSHDIGEgfVYQeBKdCOMFUTcA,LFBHRFGDZAFB.aDGDHBBGGGEDEDED..VFCBQCBF.hAAABABCCABBOFAHMAEGFFDEhAAATDAAAADFXAGAhBAANBIC.SBEHDGFD..fADDhAFA....hAIA...,1,-8,-14,6
GZIaJQOgFbVXRNYCEDWSdPKUMfAcTLeHB,LFABHBFHBFEBZFCAJDBGQBBA.FCEFXGGERAEE.hAAACHECDCAESAHBhABA.dHGDPGAGKCADfEHChACAAABGTADEIDHC.aAHFODFDhADA....hAEA...,1,-13,-32,19
XSQbNBIHgZDaCYJWGROKMUePEfVAdLFcT,LCCATBAE.SFADQBGDBAABHDBHDEBFaGGA.CAACJADBhACAGFED.KCHHeEDFhADAEADFAFEEdHFHFGCHXGAGhAFA.IEHC....YHEAhACA.WECCMBFBhAGA...,2,-31,-3,28
RaMBXGJDUQfbeASFZIECcONPdKTHLVgYW,FFFA.ZFABICDE.CDHE.NDBH.KFAELBBG...VFCChAAAgCAB.hABARABCBFGDJAFGDICCfGCFhAAAAADEECHH.OEEF.dAGE.YHEGhABAMFIF....hACA...,1,-28,-40,12
KOIbCZfLGUMDeRSTYFBHEWJPVgdcaXQAN,KAHHOCBBCCEF.LCED.MICGDDAESHCAFFGEBCGFEADF.hAAA.JDHH..gAAChAAAdEEEaFBA.AGBD..hABAIDHEfBCGeAFGRGFEHGAE.PAEGhACAcGFC.NDAA..hADA...,2,-33,-16,17
FbCVTOKHJSLcYdfDNZQAXGIgPRUaMeEBW,XBEHGAFC..PEAEaGBG..EDCDFDEF.CBCD.OHEC.hAAAJFECLHBCdABBDAGFQBCFhAAAAFGHIHGE.hABA............hACA......hADA...,1,-26,-40,14
RfLcQHNCWaKbgXAVUEGBDFOMIYJZPdSTe,VGEGEFEGGBBG.DHAEFDAA.MAGF..IDFBJECB.dAFHhAAAeBBELHDE.hAAA.cEFANCIEaACAKBAFhABA..bDDBAGCABEDFOFAF.PAHD.hAGA..SAEBhABA..,1,-13,-23,10
ASIORZdfcMJTEbYWUaFNKGHPeLBgVQDXC,SACBOCDAZFABdFGEMDFF..EAEC..bGBGUEDF.aEABNCIAHCBFhAAA.LCGHhABABHEAQBBAhAAACGGCAAFFIAHAfCHA..cECE.hABA......hACA...,1,-9,-29,20
XJFYaQWAdPgbSeUBZLOVcDCIHfNMTGKRE,dCDH..gACFSEBBeBAFBEEFLEECVFFC.CAHFICGDhAAAHGBGMFAHGFBHhABAEAACFADAaFFDAIHAUBGAhAAAOEHDDEGAfAFA.KCDG...hAGA......hAHA...,2,-16,1,17
IQARTaFEWNMGgYVdCfDOBJcUHLZbKPeXS,TADAFEDCEFBF...MEEGGBEF.VABCCDAFOCFE.BCCGhAAAUGGBHFFGLHAGhAAAKHAEPAFASAGEhABAAFCFaBAG.gDGH.fEAAhAEADICGJEDF......hAFA...,1,-14,-16,2
JgCZRMaFANTXYLbQVUfOdWBSPHGIKecDE,XECGLCGDVAAFUGEC...dGGBSBEBGFBHKBEBDIAEEDEDhAAACHGE..ZAAGRDAAaAHFFBHDACCHhAAA....NIEF.TGCFhABA.QDEFOADGBHBGIEAFhACA.....hACAcAGB.,2,-17,-3,14
NSVBUOMFQcEIaHZbWRTXCJKdGegYPDALf,LFBFSDCDBGCEUACBFCBF..QFFEEEHBHFECZAEBRBFBCBHH.hAAAdAHAGGAH.eDEFhABAYADDAGAA..hAAANEIAOAFAIEEF.aHDE...WBADhABA......hACA...,2,-22,-8,14
TDBHefNQICAWbXERPLVZMUFagSdYJcKGO,XEDHECBAREEG.LBDCZEADFAAD...SHEEdGCEJADA.KGAFhAAAOHECBDHGfCAEhABA.NECCCHHDAAIBPCFGhAAA..MAFCaHGA.cCBFDDDE.hACAeDFD....hACA...,2,-28,-25,3
KaQVeWIPDdfcRSYLNZJbAUMOGCFTgBEXH,OCBHCDGHFFAE.BAHGHCCEKFAF..aFEEQDEH.eGDGhAAAWCHH..DFCDdHCFRABDLDHBhABAJCAD.AAEB.hADAMBAE..gAEHEHGAIHAE.hAIA......hBAA...,1,-27,-32,5
CZJIFbReQNEVdPfXgMSLAUaBDcWGKOYTH,BBCDDDHDGGEBKEHF.OACGHEACZDEF.JAABFDDD.eAFA.EGCChAAAdAEE.XGAHhAAAMCIHSBAHLAHBAAGHhACAUGACaDBA...cBEHTGCHCCCE.IHHFhADA....hBDA...,2,-23,-12,11
LVGHbWBEfXSUReQDNAgIZJMTFdPKCYacO,ZDCAMDGFFFCCdAGCKEAF..CHFF...aGDEOAAGLCHBGFADHBCEhAAABAED.EDBASBGChABA.UGGBhACAeBHHNADB.AIHEIBCF.PEHD.hAIA..YHBGhAFA.cEDAWBBF,1,-16,-20,4
YIJSTLHDNXKRafGcZOQBFWbPgUVCMEdAe,eCBGJEBFLBDEDGCAKFFF...RDDAGDGAOHBEBBGCFGDF...hAAA..PEAEUBAECBHEhABAEEHBACEG..SGHHhACANABH.aHACcDEG.ZAAA.WAHHhAGA......hAHA...,2,-37,-19,18
WMRXEJFfGDHNAVLYKCPOaSdcBTUIeZbgQ,VAFAKDHDOECE..aADFdGBFBFAEUFGBZEDE..QAAChACAMBDHRGDA.EAGGFBACDBEHAGGG.hAAALHCGCCHA.SDAGhADATCEEIHHCeBFG..WFADhAEA.fCCEhAFA...,2,-25,-23,2
gPIRHKfJAYFeOWECVSaQNDcBdZUGLMbTX,eCBEOCCDEBED..SABHaEGH.DCIBBHDEZFBCLHAAhAAAMEACTFAF.XAFBhAAAPEFHHAEAKABEAICCFAHDhAEACGHDQCFAdEEA......hABA......hADA...,1,-12,-20,8
WQLJUSBIbGHFMRfdODAEaNcgKVPXCZeYT,EFDHaHCE.....NCBE.KDEH.XBBDeCHD..TADELAHBhAAASCCGBEGFbFBGhABAFGGDMCAHfGEAhAAADFHFAGAF.gCEHCEDD.YHAAhABAWCEC...JAFC..hACA...,1,-17,-26,9
HGUDLBVNQSbeJfYMKFIWdgTcXOCaPEZAR,HDGHUGDGDCDHVEAE..QBAGSBDB.JEEHMDHH.FBEBhAAAIHAFdBGB.TAGGhAAAXEEA.CACCaFAEhABAEBAGAIDC.LCAA.BHHG.bAEBhABAfDBCKGCG.hACAWHAC.,1,8,-42,50
QSbKADITdcFXCJNPRHWEgGMfaVLUZYBeO,DADDTEFEdEFHFEAE..XGAE.CAAG.PHCGHACDEAFD.hAAAMDECaDDHLAEHhABAZEAEBGHGOHECSGBDhACAAFEHICADJAGHNGEB......WAHBhBAA...fBBEhBCA,2,-26,-24,2
JXHKeLWMONQEaTZdYBRUFfcPDAGCIbSVg,CCHFSFDB..JEDDHGFCLCBHMICCOAAGEADHZGEEBAGBhAAAFDDE..fGBBhAEADGCDAFIBGBEEIHAAhAFA.gAGFKFAD.WBCCaCAH.YFFEhAGA...hABA...,2,-36,-4,32
fUPWIbdTOSLMBAEaHJQFgXGZVcNRYKDeC,aFHDJDBB..FFDHGDDA.ZBGD..VDEDNAAH..KFCFCCHA.UGFGhAFA....IGGEhAAAdCCGTBEFLCAChABAMBBEEHAGQAFA.....hAGA......hAHA...,1,-15,-42,27
eGBaVXIYbgHEZfCKWNAPMcLOFDTQRUSdJ,MEDHLGEGDADA.RDCEdBEEGBDDBHBD..aEGG..VBGB..hAAAICBC.gGGGhAAAHDAFEBCEfBBGhABACAGC.NADFAIFCOFEBFFFG...hACA......hAIA...,2,-33,-16,17
cZbBAaJYNFeRKPUgfMQdWVLCOITEHXGSD,JEFCFFEFKDEE..UAEDMECFdFCH.LABBCBBC..OBDAhAAAEBHBHDBCGDGC.DGGDhABAbFFGBBHC.AAFG.aHAChAAAeEAF..gFADfDCB..hACA..WHDG.IHHDhADA,1,-14,-44,30
gCKGLdcEXPZFBfQVYSOTIDJaMbHUNAReW,eDCBCGBALAHDdCHEEAEBZEBG.BFHB..fFFHQGGHSBAEhAAAOCBGDGFDMIAAhABAHADGAHAC..WBFHhACAKAAFXCEEFFAA..YFHB.hABAJHDCaDAC....hACAbDDF..,1,-4,-23,19
cYfLbAMWPBXCaIKRSeJNgVUZHQGEOdFDT,MAAABEDBCCBAKGBH..eFBF..JDHD..VDFHHBFHGABDhAAAECBHFEBEDEAG..TEEAhAEA..YFHBhABALAFEAIDG.PHDAaAGD.IHHGSHDEhACA.NAIE.gBCBhBAA.,2,-25,-22,3
CdNagYMLWOKVcAfBQbGUJIDEXFHTRPeZS,BCFAQEDAUCACDEIBEBDHHBFB.TEACeGEAZDDH.dAGDNABB.hAAA...aFFAMFAEhAAAOHCEKHCG.AAIBfDBBhAGAGABF.XGGGRCGHCHHC....hAHA......hBAA...,2,-26,-9,17
UEKVBDcMOPQbWNFCAgfGeRaZXITHSLdYJ,GAEAeDGFRBAFZDED..XBBCHGBGSAAELHFGdDGHUDCDhADAKFGADIFGMEAC.QGBAhAAAbAFG.FEEHhABAAHHGaEAHIAHA.......hAEA......hAGA...,1,-10,-14,4
TSCgLFJOQDIPMEUGVKHcRAaXdebZfBYWN,aGDAeGECZBABBBBH.....NICD.SACECFCB.FDCAOBFHhAAAQCFGDEBHMBDBhABAEFBBUGGCKEGGHAGDhACAAFDEdAGD...YHAAWDAF..gGAAhADAIEHG...hAAA...,2,-29,-26,3
EbFTaAXcONJPDIVMHRWUQeKYfgBSCdZGL,OHDGJFCE.DBEGMAEGHBAH..RABAUGFHQEEH.KCDA.hAAA.fCFDhABASCFBCEHGGCACbEAEFHAAAGAGhAAAXCDH..NAIGIHHBeHBABBHFhACA......hAIA...,1,-12,-24,12
TeYZACMcXKVNWPOSGfaERdDFIJLBHgQbU,CDFGXFEAKCHF....VBBG..NIBDOAHDGEBDaGBHEDCCDBAFhAAA..FGGAIAEGhABABAEDQAGHhAAA..TBBGeDAFAEIFWEFEfGFGhABAdFCGJDAB.....hACA...,1,-20,-30,10
XOWQFCHDAEeRNLadbZVGcJUKIBSfgMYTP,RDDGLHEGdGGHZDBBGAGCUABHBBEG..SBBGMEAE..hAAAPCHDODAHFFEGDIFGhABAAHCE.EGDA..aFABbACAhACA....cBGG...KHAA.hADAfDDD.hAEA...,1,-18,-33,15
HFMCYWDcZRJLXNSgeOabQfAUBEKTPGdIV,UEAAEGGGKFDAGABB.dEFCVCFBFDDF...CBBA.DAFEZAEGLFCHhAAA..NAAHSFCFhAFAOHFGaEHB...hABAfGAEBCHDICAGMDBB..YHCGhAGA....hAIA...,1,-25,-37,12
EeVCATJZcWURbKSXQNPgFDdMYfGOIaHLB,TADFJGBCZCEC...UFGERFFH.KCFEQAEB..PGBChAAADEFDMICEGDCFOCCHhAAAIABHLBAFhABABAHFeAHBAAFG..cDAHWFAF.SHDAhADA....hBAA...,2,-32,-16,16
ECKFQZAHfWOegTJPBVRMcGDdNYbUISaXL,HEGBOCDCTCFEBFHCRGBEMBIF..DEGCdFAC...NBBDUEDGhAAAIAGA..SDAGhABALFBEKBBBFHCGAIFEhACAfFFC.eACGJCCG....hAAA......hABA...,1,-5,-45,40
YfFBCZAPEJTOedcQSDHIgKbGUMLRWVaXN,JDBATGBG..dEFESGECDIAGHFACKHGGGABD.MCEHLBFAhAAAVDGF..aCAHXABAhABA..YAFChAAABEAGAFHHOGDCeCCDIHHC.hACA......hAEA...,2,-35,-3,32
WJVDNQgOGIRBPcUeTFHZdYEAKfCLbSaXM,KFGCCDCCLCFC..bCEBSFBG.MEEHVEAGQFFBhAAAGGEDIAGHhAAABCADUABDeDBEFHBGdACHhABAABECaAGCJBHDDIAG..NIEHRDFC.....hADA......hAFA...,2,-17,-9,8
WFIaXNHdJScefGCAVEULbgKQYMPBTZORD,EAEFLAAGKDFD.MEDEBFGFZFGDREDD..DGIHFCAG...aFCBHBGHhAAASAFEeACDCGADABADUBEHhABA.QFDEhACA..PFCBWAHHIEAFXDBGNIDHhABA......hADA...,2,-30,-13,17
KaJfYESONHcGFBILRdVMgWPAQXCeUTZDb,QDEDXBGDUAEDZEABKAEC..JDBGECAA..OHFCHGCGFHGGhAAABACFIABEhADAdHAFMFFG..gAGFhBAAAFAECHEFDEGE.fFGHSAAFcCDGhBDA....RFCC..hBEA...,1,-10,-27,17
cOWQLPZVMaKdFBEHbSTARXCgfDJGNeYIU,CCGDDACCGCBFeECGUGBD..OEADLCCEVFCBMEIF.dFABhAAAEGGFHFEG.SBADhABAAGFFRADGXAAAJAHF.hAFAIAHF..WEEEPEEEaAEEBBBChAIA.....hAAA...,2,-26,-2,24
NTgYDcBUafWCXPIRVQAEKHOJMbGSZFdLe,HFFEJEGDGEABZCFGdBDGLHCEeCBD..TGACDDEAUAGA..hAAAaAGACHHB...IHEDhAAAQBADABFCKABHMBDFhABASGCH..FAEHNBAG....hACA......hADA...,1,-9,-26,17
XDWJEZdMBbTYUCcOKGAegVfIFRPaQSLHN,eDGDVAEH.FEDC.RAAB.aCAELBEC.HFACDBIFEEDHdGGHMIBEhAAABBCE..TGFDCCEAKEAEAAHGhACA..IAAGhACA.QGAG.SHCAhADA.WDHDZACD..YBHBhAFA,1,-8,-40,32
KWNIEeUTfgbHSMQDAPadVRLXcGFZBOJYC,aGHDRADCLEFFGADGFDBBOFDB..CBBCKHBA..IGABhAAAUFED...fBBEhABAHAGBMFABAAIBdCGBXDGEhAAABDCAJEHH.YCAFNDDEEFBH...hABA......hACA...,1,-17,-19,2
SLCgXBWNfZdGVMFTAEcbIDKOQHUaJYPeR,EGEH..IFHEDEDHOEFFQCFA.UFAEaFAGJBBEPFCChAAARCDC..LDHFhAAAgBCDXGAHhABANIEHdCAG.MADEAGGH..KAGE......hABA......hACA...,2,-23,-22,1
OPGIfgeCTSaEZFNXdJYWLHKAQDMBRUVbc,QABEMAFGBGDARDEFUEGG...VAFGOCEAGGDB..hAAAIACEeAEDCFAATEDBhABAaAABZEAB..NIDH.JDBEhAFA....YDDD...WFBHhAEA.KBBFADGADIAAbGFE.hBEA...,1,-4,-35,31
VLfDdcKbGaNHITMZAPRBJegEQWYUOXFCS,BFCDJCAA.eCDGEDEE.QAFGUAGD.ODBECECCLFBG.hAAADHGEKGEA.aABFHABChAAAIADAMIDGAFGHPCHHhAHA...gGGBWFADFEHHSAEBhABA.fCHGhACA,2,-37,-23,14
YPVJTGaXAEgfCWZDFIdcBSMeKHQNOLbUR,EBHDCDAEDGCEFBBB..dGFDBEEC..MCDEHFAA.OACGLDEEhAAAUGECREAC...PCDAhAAAJHACaAGG..AAIF..hABAfGHEZEFCIAEGSDHDeACF.hACANBAE....YHAGhABA.,2,-33,-20,13
WaHbROZAGEDYLVBUFPJcgMXKdICeSfTQN,DECBVDDCBHBB.UEGFFAFA....JBAHMBCGdCGH...eCCEhAAASFGE.QGGHhAAAaFEFHBAFOAGBhABAGDBAEHCALAHHPBBA....hABAXDDGCHEHNEAE.WFADhACA..,2,-24,-19,5
KLHXDQVSNRWCUOIJTdGZbPMFfAYcgeEBa,....gEBHBCCGaHFGKBHBLACCHDCGDGGESGGChAAA.RFDHCDGCIEHBhAAAdCHAGBBFZDAFMAGHAEEEYHAAhABAeHAEQACA....hABAWHFA..JFDH.hAGA...,2,-17,-15,2
WIKCgfDYFBGaLZUbAVNecJOXRSPTEQHdM,VDEBeECGOCCE.RBFG.SCGE.EEHDHDABdECAMDBAhAAAWHEGKBAG.CEGGDGDChAAAFHDGBHBD.LADEhABAbGACAGGC.NCBHcGGHJABA.....hAEA......hAFA...,1,-15,-20,5
AgOVUJKYQPZDNTFdEIfGHXSWLRbeBcCaM,VCEFUDDDKGBF..QAGAZBABDBFC.FFBGdDGA..EADDGFCFhAAASBBFRADD.BDHHhAAACAHB.aFGDABAF.OHDEhABA..JFHDYFAF..NICH.ICCFhACA.fGCAhAEA,1,-13,-41,28
HKWcRaAJIUQZgTLbYGCSXNDMFfBdEOePV,JCABQCCBZCEG.LADCGEGCCABESHFA.DEGBMFCFhAAAFEHFBGDEOBFGPFBFhAAAKGEH..RACHaGABhAEAABIDIABC.gBEB.YEEHhAHAfECB.hAIA...,1,-29,-30,1
JGKUWOYBQDTafVHCFSbgdIeMZNEPXcALR,LHFEJBEEGDBDKGBB.OECGBBABQGDFDDBH..TACAhAAAaEGAHFAFFAFBSDGDhABAdGGDMADENCAC.EFDHhACA...XBGAABDCWCFA.fBBEhAEA.CHAD....hAAA...,1,-16,-22,6
ZfCVUOBJTEQXNKbSRFDeALYIPgaGWMHdc,LCAA..ICEEPCEDGFBFHFBDdAGCZAFCCFGCOABHhAAABFHCEABHQGDAhACA.KDBGSGGDhAAADEAFAIAEaADG.MEABfDFA...hABA..JFHBNIADFEBGYBHBhAIA.,1,-8,-27,19
WCTcNgEUMVPDeObQLSHXfaARBKIdYFZJG,RDEFBGEEdHDDZDAGGACB.CDEH...TADB..gGGChAAAUGAEMAADDDAG.eCFGhABAOCHDQFABhACASGGGfHCHaCBGAAHBKBFAIAHF.hABAJEFG.WCCB..hADA...,1,-16,-28,12
EVTeHDMRINLJFdCZgSUBcAYXOWGKafPbQ,XAGBODAHKHFE..aDCF....PFDDEBFHeHDAHCFCDBAEhAAARBDALBBBFFBFdFEHCCABSDHBhABABFFCAICC.hAAA...WABEfHGFbDDG...hAFATADEIHAENDAA.hACA...,2,-25,-14,11
ZTgOUfcKGaeWPEDJRACNIMdYLBbSVXQFH,CFAGMEBHdFCBBAEB..bAEB..SHDCQFGCZBBHOBBDhAAAUGGA.KGDGGBFAhAAAaCGGeDFAEBDG.DADDABHA.NBAC.hABALCHHFECE........hABA......hACA...,2,-27,-9,18
QXHVNUDOLBgcSJWIMfRKeGCaYdFAZPbET,ZBDBEAAC.QFADHFGFUGAHLGDGBAEHSEFFJCAG.MDEAhAAAREFGKABAGDADCHHFaCFB.hAAAFBFE.ABCG...PAFAhABA..........hADA......hAEA...,2,-22,-19,3
NCGPbAfMUDSLdaZVEgeRYJKWQFITOBcHX,MHECSDAHLCDCdAAHZCDGEFEC..eAEGRFEGKDHBFAAB..TGBDhABABBHAXDBGhACA.CDHB.PAECAEFADFIB.hADAaCCGVGAC....YHFG.hAGA......hAHA...,1,-18,-21,3
BFSMPTCDGRdZVXEQIKcUYbgWONJLAHfae,HDDFaHFCBEACSGFA.MDCFCADFGCABZEAFEADEQBFAhAAA.KFGFYAAHhACA.WCCENEIAAAHCfECHhABAPAHDDGAFdDGGIGAG.cFDGhACA.....hAFA...,1,-10,-26,16
VBCSabGPRYZIcMONLeDfETKJdWHQFXUAg,VEFECFCF..aAFDGCCCRDGB.ZAFCMDAHOAADLABE.DDEHhAAAfEBEKHCC.hAFAdHAFQCBDhAHAXGDEAGACBFFESAEDPAHDIHHHhBAA.eGDEEGHF...hAAA..WFBD,2,-19,-13,6
BabgHIOLVMAeRPFXDcNSTYZWdEJCKUGQf,eDECFEGDDGAH..SFGFZCBAdGCE.CHCFGABHQABEBCEF.hAAAaFAGHFEF.LFBChABAMGBAAFFHRCAAXAFBhAEANIDD...WBHBJAHFfFHAhAAA..gBEDhAIA..,2,-24,-12,12
DUbMGTdeLHCXEgPASWKOYBNaZVJfcRIFQ,KGGHBCEBZEABJHBARBCC...FEBADEEB..UABFMCAB..GAEBhAAAeCGBLAACHEEBCFAF.hACAEGECAIGG...SHAAhAEAOEHD.NEDA.aCGD....cAGFhAFA.....hAEA...,1,-23,-34,11
PZCbDIRdVJWLEMOTKegNYSXfAGHBacFUQ,BBCHFAHBUEDDZAEHCBGF..DABAdCHE....JCBGLABD.hAAAEFFAMEBHKEDD.eEHFhAEA....gGEGhAAANEGA.XGAAACIHaAFDQGDDhAFA..IHHDhADAWFBH..,1,-37,-46,9
LJEdRFbWCSgcUZIKTfYNBOaAGMVPQXDeH,GADDMCCC.QDFBeEBDLAGBJFGBdECDRGEAFCAC..CCBHSCGChAAAUEDHKDHB.TGAEhABANIAD.BEABAEAB.hAAA.PABADFIH....EABH...hAFA......hAIA...,1,-15,-22,7
USVHAMZPIKgQDaRGLYTWBcbXJeOFdNfEC,MAIFZFGBKEECDGBHRCAG.GEEDLFDG..TBDGBCFC...XCAAhAAAeABAFGBDdAGAEAGChAAACACHUGDF.SFAChABAAHDB.IGHCaHEGcFAG..hABA......hACA...,1,-16,-32,16
GafgWXDHQILYVTUFCZNKRbdOEBJecSPAM,MABCaBFA.....fFAFgGCADFDAQBCChAAALBCGVCGDFGFHCBAFNEAAKHAG.hABAdFGHBDEGeDBCSEBGhACAAAHH.GDGC..WGCG.hADAIHHF..hAAA...,2,-29,-11,18
MFTRPBbKfdOHUEgCGVcQDNAaLSJXIYWZe,SCFGXFDA....IEBCZEEHFBCERDACBCCEKGCGdGBGOEHHhAAAEAAG.CADFGAEEhABA.QCGDhACAACAHLAFGJHBEeHFAMIFCTEGAfAHG.hACA......hADA...,2,-20,-10,10
eZBdNSKcRXaTUJCfOVFGMgLYEWbQPHAID,DFFBBHFBdECCSGCCKHBA.RDAA.aDFFUABE..CAFD.ODFFhAAAFBDHGAAGLEHB.hAAAEAGHQGGEhACAACIFZADBXGADJAHF.fEEGMEEH..WEADhADA.....hAGA...,2,-27,-23,4
QPRagWVJObfcZLHUBDEXdFKAYCISTeNMG,CDDGSABA.eEFGMHACGGBDRFECaDFA...VAGDOBBGhAAA..fCCAhAAAZEACUAGABHHEDHGAEBADFBAHhABAABEEIFAG.QECH.hACA..WFFGcBEGhADA...,2,-35,-3,32
LGeHROVJBaUDbXSNKCTfdZgMEYFAcWPQI,...PBBFIHCDGFBBeAAAHDECOEDABFHFDFBESHBGhAAAKDGC.CADAfBFDhABAgAFCEHFGAGGB.hACAQFGELAHB.JADDaFABbFAGNIEB...hADA......hAFA...,2,-14,-7,7
UTBfKVJPHMZeFESGQRAYbdCLgDXcWIaON,dCFCCBHGDDHB..XECB..IDBFaCCGUGGCBHGG.KFEEhAAAPACAHGBCMBABhABAFDHHEAGAGBBD.AFBELAFBhACAWCBD.NEIG.TGDC.fAAChAAA...hADA...,1,-19,-29,10
LcMZAEPKJUYbDINCFSWQfOHTXgaedVGRB,KGEDJGFA.UFBBDAFC...CAHC.FCBB..QCBDOABE.HEEGhAAA..TFBGaGHDeABAhABAdEDHGBFGBCHEMAFBhACAACEG..EEHD...PAHF..hAAA......hABA...,1,-25,-35,10
SYEVWaMNLdRPgZAJeCcGTFfQOBXKUIHDb,CHEEGGADFCED.OBBABFFB.UFFADFBH...SAFFEGHF.hAAAaDFELADA.hAAARCACZCGHAACEeBAB.cBGBhABAfBAHKECBHCCGVECHMDIB..hAEANAIGdHAH....hABA...,2,-27,1,28
HSZKNfAFJXMGDBOTEQRWcgUaICPYLbdVe,FGDAJFGBGEBCDDDBBGBG..OBAB..EAHFQBDHhAAARBCG....WBFBhAAAgAFG.aGDDhABACDHELBBDbDFE.dHGB.eEEG.SFAFhABAKEDG.AAEAMICGhACA.,2,-38,-14,24
gFEJcKHZCOIedVfPXaMBDLNQSRYWbTUAG,FHBAECDCKABAZBGB..CAFG.OCHH..eBDDdEBF...VFGBPGEGhAAA..MFDABAHDhABADAACQGCHhADARDAA...WFAD.......hADA......hAEA...,2,-41,-31,10
KRVcgYNGbaCTQSAJDHIBEOeLMXFUfPZWd,JFECHADBBDBCeEED.XDAAFGAC.UAAHZDFCdHDBRGBA..VBGDhABA....gDCHhAAAYFADNIEHGABFhABA..CGGA.SCGEDDFH.IHHEhACA.OAEAhAIA...,2,-40,0,40
LbRSKdfWJQeXIFaDCYPVZgMUHNEOcGBAT,TCEBREFGdBHG..JFCBeFAG.FADCCGAF...VFGDZBEDUGGF.hAAA.EAGAGABABBCDAEHChABALBAFSEEAhACA.WGCAIHEFDECA......hAAA......hABA...,1,-18,-32,14
RAQSFVMJcZbCUTBOWPEfLDGdIYgHNaKXe,SCADMCGFZBAHUDDFBGHD...OFCHECHDDGBGdEEE...hAAAIAHAHADEaGGBXDGGhAAAAAHAFHBE.JBCDCHHH.hABA.....WACFfGAE.hAFALABE..hAFA.YHDG.,2,-26,-23,3
BNJXPcUeAZWaTEMKLCHYDOSGIFbRgQfVd,aBCHMFBELFFFHFDCDIAEGAGGFCGH.RFAD.QBACdAEABDEFJBABhAAAXACB..PEHDhABAeHFAAEDA.WBEChAAAKGDFCDFH..OAHDSEBBIGAF.hACA.fGGGhADA...,2,-18,-10,8
CAQLYdNbHDGKUcMJRgfVIeaXFZBOWTEPS,LFHHdBBDHGECKDGAUBGDMFCAREBH....VBACaHAAFDAEZADDBFEEhAAAOAFF..EHDCSDDEhAAAAHAB.NABH.hAHADAGE....cFGA..fDGAhABA.IGGAhACA.,2,-37,-18,19
PcNKEfXJdFbTMYGVAIgaCOQRHSeBZULWD,aBADOAAHHACABDEEUBGADBIF....PECBKGECEDCG..JHEEhAAAFGBF..MDEFVAFHhABAAAFECEAC..RDGFZEAALHAGhABA...WEHBfGHAdFFF.hACAYBBC..hACA...,1,-8,-36,28
cCMIWEgXKYaDSRPLUJbOdZfFVBNTGQAHe,eCDFMADF.EGDCKGDCDBFBRCGB..LFBBUABA..OAHFZFFHFCEBBGBFhAAAGAAAAIHAHDGFCAED.hAAA..IEEAhAEAXAGEaHAESFAD.PFHFdAGC.hAFA.....fDBGhBAA,1,-12,-22,10
INgdLZXSYCWcPAbJRaFOQVBHfDeKTGUEM,JACEFCHBOBDBBHEH.HEECDDCB...KBFBGBEEMEIH....hAAAIGACNCAE.LBAFhAAASGHDCHGFPFDHhABAAGFCaBHD..VGAAfCBG..hACAeBAG....hABA.EDDBdAFF,2,-38,-8,30
ZRHFeTXKDSdCGYBfANIVLEJWPObgcaUMQ,VDAGEAAE..JFBDOEFG....gFFGUAAGMEEDZDCFhACAFADHeADGKBHDDGGGCEFEBHEDhAFA.AEEF.LAFEhAEA.PHFEaDHFQAGGTGBH.SCCEhAIA..hBAA...,1,-17,-28,11
gIEfYJeUBXCAQaSGdDLbRFNcPKOHMZVTW,SEAEdFHALBBGRFBC.FEDD....NFEF.KBGBHADFMDABZCAA.hAAATABDIHEAEHCA.hAAAJFBHBGAG.CHGFAIEAaDBEhABADBIH...cAFCOFGB...WAHBhACA.fACHhAFA..,1,-21,-26,5
WOKdTQUGNcFPYefDaEVXISJZRMbBgALCH,LABCCDDHHCFHKBECQBDFGEAE.FBGCeBCHDGFF...aGHBVGAGhAAA..IBAHhAAASGHBZFEHMAIBhABAgEECAADGdHCD...NBCC....YDFChAFA.fGGEhAGA.,2,-32,-7,25
HgFBeTXEfWGbNPIDYLKRaZCMQJAdOUcSV,OEGHSHAEHFAFBCBCeCEG..TEFCECBDGDDE.NCAE.hAAAIECBDIFA.LBEFhAAAKABH.aBGFMCIHhABAACDDdHED...cEAC.FFHDWBEEhADAYACECGCB...hAEAQFDH.,1,-4,-14,10
fPINRVLcaWDHGUKXQbBFdAYEJZSTgCeMO,EEDEJBDBZGCC..SEHF.TFAGeAADOFFF.hAAA.fCCChABANAGC.LFCBaAHHDFDC.hABAUBEGQEAFFGFHAAHFCBBFIHHH.hACA......hADA...,1,-14,-40,26
SGMUdfQIDCTZBNLgKWAHJYXFaEbVPOcRe,HEDGJABH.FCFGEFEB..VBCHOGAG.RBEF.SGGDGDFEMADChAAAdBACQGBChAAA.CFHABEHCNAHCKDBDACAFhACAaAFE...cEAB..eEHHfHDFhABADBID...hAIA...,1,-10,-21,11
GUVCZfJWgFYHQeOaKRcLdBAETSMbNPIDX,EHDCTCEE..SFCDMAFG..bBAAIDGC.DGGHhAAAUEAAZBAE.fHDHhAAAJBEHFAGFHDADOEFDhABAaEGEKEEFLCHFAHIDNABB.XECA.CHHAgGBAhACA.hAIAeADG.,1,-10,-11,1
WAfLeHcDSFbQPaEBdTIGORgMCUXKZYJNV,LBGDeDHFDCAEFDECQBAF.aEABBHAF.dDBAGADChAAARADECBGH.UFGAKFFDZFACJHAGNFBFhABA..AIFE...fHDHhACASAAE.EGHHOAHD..hADAMIBG....hADA...,1,-2,-36,34
EZKMXLRPCADJQBWGbUIOcHdeaSFYgNVTf,DEADJBABBAFDGFDH.UFBA..OFFEdABBeCEGFCCB....hAAA.NIDB.TCGEZDDCKBGEhAEAXEEG.REAEAAADhABA..WEHH.ICBAaHBCSGAFhACA.....hAFA...,1,-29,-33,4
XHIVFDbNPWgBdUSCTQJaKceLMOERfGAZY,XCBBVFDB.DHEA....bAAF..PAFHBAGDSCDHhADACDDG.JCHBKADHhAAALEABEDADfFFDhABAAFABZFBDIHGBFHAAWEFE.dGDCQADHhAFAaHFEMAIB....hAHA...,1,-17,-20,3
XMAdKNHeRZTaOWbPBJVSfYUIEDGgQLCcF,dFAGHDAARGCEZECGaABDOCFD....PBAFVFCF..SHGAhAAAUGFEECDFGBGChAAAgFFG.LADChABACAEH.FAHDADCDKABETCDF.BHAE.hAEA......hAGA...,2,-24,3,27
MABJaeYQCLZINGDfVWKEOdSgPUcXRTbFH,JBCGaEDG...eHBACAABLBDCZFEDGBGCDBHF.....fEAHhAAAVDAFEHGASEFHhACAUGGCRDDCFGAAMDAChABABHEG..IHAE.NADB.WACCKCDGODHDhAIA...gFCAhBAA,2,-20,-15,5
DZYJTbLaeVHQEPMNGIBgcFKRWXCOSfUdA,DGEEJFFHLCGBeCAFHDCE..EGDBMBIFGBCEBBGH.FFBHKAABRACE.hAAACFBF.OHEGUGAFABIB.hABAZAEF....YFFChACAaDAB.........hAAA......hACA...,1,-20,-26,6
PMOFbCcBaefJYDHTGNdLIQAgUKWERZSVX,UEBFEDEDRFAB.ZCEB..SGFA..XGFAOACHCAEEaBBDhAAAeCFC..fCGAhABADBBBTDGHdADAIAHEhAAAAGFCKGBB.VECBFAHFBEHB...hABA......hADA...,2,-30,-22,8
FTOgVSGaBNQECYLbHcKIdeJXWUAfMZRDP,ZCADRCABDCCEFEDF..OEDFSAGE.BHECEHCGLCFEhAAAHACGKGBEdCDHJAEG..UFFChABAADIBMIFG...TFFHhAAA...gCFHaACGCDGC..hABA......hACA...,1,-26,-33,7
JYgCfHXLabPEZVQTcBAFSeNRUdKDWGIOM,FFEASAFFeDFARCBG.dGDE.DDCCGACD.MIFAJAAD..CEFFHAGDhAAAaGCE..EDABQGGHhACABFHEACGGKGABOEABhADA..fAAFLECF....hAAA......hADA...,2,-23,-21,2
XFaIPHbeQENUBcdGZYWOKLMRDgCVfTASJ,JHEGFCEB..aGBCHBDH.eEFAEFGCBAABdGAGZCAH..OAFFKGBGRAFEDDDBhAAACEBF....fADChACASABAPHEGhADA..NGDH.cDGG...WDDDhAFA.MIAA..hAHA...,1,-21,-40,19
dKYUBSDTgZEIVfAGReaFQPbcWCOMNLJHX,eDDHFBEGQEGG..cBAEOEDFLACBHCAGKAGCBHDDhAAATEAAZAEHIGFFhABAAICAaBHD..bDEFCHADMEHDhAGAJAAG.dEBCSGHHDGIBEBHFfAGChAIA....hBAA...,2,-15,-4,11
cRXfEeUSWVPIQCZNODATKbGaJHBgFdYML,KBADGGEFHECGBBCCdBGDMHAELABD.REAAECGCeCCG.UGFASEEHhAAA.VAEBhADAQDGBZGAC.OEAGhAAAAFIHaDGEFDDF........hAEA......hAGA...,2,-22,-6,16
ONAGFQVbUBZLMRcaeCSDKIPJfTEdWYXHg,FCFBVAFDBGFG..LAHBMCAG.aGEBeFAA.DGIFKFFC.JDBFhAAAEFFE..dHGFXDAChAAAHABHODEC.hABAADDE.QDGA.bCBA.ZGBECFAGSADBhABAIAHD..hAFAPABE.,2,-16,-14,2
aHDgXJdIVYFMOCNRATLEKSQfPZGecUBbW,EEEEKDEHQCBHZGCGGBBDUEBFBAAC..aADHDAAC...JADAdAEFhACA.IFHFFCGECAHB.hAGAAGDE.LEGBSGEHhAHA.fHBB.eAHF.cGGHhBBA...WCFBhBCA..,2,-31,-19,12
CMRVPWDJdageTQNbSLYGIBKEUZAfcXFHO,XECDODBHRADG.....VCFDDEHBaGCFeFHB..QDDGhAAAbFADLDBEGGEFhABAIAAFEHAAAFADFAHHHACChACACABH.MHCA.WAFE..dCCGNIDFBFFGhADA......hBGA...,1,-4,-12,8
TMEQCXGBbOPUFLfcVYaWgeANHJRIKSDZd,HBEGRFEDKFBBZECFMFDG.QGEEGBCBBDACOBCG.UFAFLAFAhAAAVCAH.aGAHeDHBhAAAAEIB.JDDCDACA.EGGGCHGE.hABA....XABC....hAGA...FEFA..hAHA...,1,-1,-22,21
bYMLDREPQcWfJaZGXVBNIAFCgdTeUOHKS,FAGFCHGGdECBUBBGHFCH.KFGB..SAEB.MFDBLADDhAAADDEH.PABHQCFHhAAAfAFHZFFF.hABAXFADBGEGNAIAABEHgBEGeCAD.YFEBhACA...hACA...,2,-26,-15,11
VHSQDZBFAeYWfORTbgdPGJLKEMUaICXcN,eDEA..fCAHTCAH.dGADJGAGKGHFUGFDaBED..CHDD.XACEhAAA..NAIEHEFAhAAAQAFFDFAGBEEFhABAAICGOFCARABG..PBGDEDHH.MDDFhADA......hAEA...,2,-17,-17,0
RUYJNfVgPXWaGHFOecMTIdKSbLZEADBCQ,BDHERCFBUECFJDCE....VAAG..PFGH..aGACFAAFhACAeEHH..MBEEhADAIAFA.KBDALFAEhAEAAEAEDIDG.CHCD.NDAD.XGDE.WBDGhAFA.....hAAA...,2,-41,-37,4
cQDIABEVOZeMTLSgWFNKRCdbGYfUPaHXJ,VACBeHEEMCDD.LBBCSCFDFCGARGAGCHDEGFAF.UGFGhAAAaFFE.HAFDJAFEDDAHhAAAAAIDEEDGOCFHZBAF..hABA..WCADNCCC.dFHA...fHADhABA....hACA...,1,-3,-16,13
CSGVgeLEcXBFWOZaNYQbPUMdTAKRIJfHD,RABGJFGBHCDB.DHCEGADA.eFBBEEGAXAFBBBAFFFDGZCFGaDGG.hAAA..QAGChAAAUGGDTEAHAGFDKCABCBHESFDGhABA........hADA......hAEA...,1,-16,-29,13
NOAQEFecLGXTYIPSdZRHWgMJDCBVafKUb,QCFEeBFELEBAGBBE..XFEETGBH..IAEEhAAAPAABdAECHEEHgGDGhABAMBADDGHHCAGABDCFhACAaGAH.KCGFNDIAAEDEFHAC.SDEB.hABA.WHDA...hADA...,1,2,-18,20
BbgRZOIJHfDeTSVdMFUXKLWEGNQaCYcAP,BEFGREAHZDCD.JHECDFID...eFFBSBFBdACD.UDCGKBBDLAFEhAAAGCAC.aCEFCBBEAGAFhAAA....PHCChABAOADG.HCGB.fHAFMCHH.hADAFGGA.....hBAA...,1,-23,-26,3
IfESZKAYXJdUbOPQFVCGcBHLeWgNDRTMa,JHBEUGFG.OCBDQEAB.FDDHCEDCBEAGLHFE.eACFhAAA..NHBBDBBFRCGDaBEC.hAAA.EBGBKCAH.AGFCdAGHhABAVADD.......cEGF.hACA..WGAC.MAIHhABA..,1,-19,-36,17
DAJFdcKHURMZWXVNfbBISYTgPOeLEaCQG,dGACKGDBRDFDZCDF...VAFF..NAIGBDBH..SEHDhAAA.TABGPAAAhAEAOHDCeEBAaHGCCFDGDBABhABAADDGFAEEHDAC.MCIBfHAFIHHH.hAHA......hBAA...,1,-10,-42,32
fcgWCJPNBFMUEVXeIOQdbGTYKSARLDZaH,DGCCHFEB...fCDG..gBDBCACEJAFD.BCHEhAAAMAIDVDAAeEGDQEEAhABAdBBCTFAGKAFAhACAAAHDLEACaHAC..WHEANEIA.FFHFEHCGhAAA..IBBFhADA...,2,-38,1,39
XVPGeEHWFaCZfNRJDBQUbScYTAdMILKOg,dBADMBCCKECF..XGEHGBFAEAEF.FEEHaCGB.ZCCGRGAGDGHDQECEhAAA.SGHHhABA.cGAChACAAHECIEAGLEFAgAGBeDADCCHA.NDICBDDFhAAAbBBC....hABA...,2,-34,5,39
TacCZVNLWFeYbRMgAGKPQdJXOESIHDfUB,KFAFdCADOAEDECCD.HFFEUAEEBEEC..aEHBCBHBZDCDLHBEhAAAFEAD.eDBBRGCC.AFFGQGGFhABAXABEDAAGfABChADA...cEDBNIEH..hAHA......hAIA...,2,-23,-23,0
UAHVgNTOEPZYfLWMGbQJaRCSdKXeBIDcF,VBGFTAGD..OFFHEEFGZACH..LCBEMGDEGEACQFBChAAAJFHBRAAF.CDBHdEGDeHDGhAAADIACFECGAFAHHAEH.hAEANEEA.fCHA.WAFFSHGAhABA.BACE..hAEA...,2,-12,5,17
gcGSFDKUYNedJMEWLQaAXCHIBVPbOZTfR,HEECVECB.OABBZCEE.RFBHGAEGDABA.KGHFUAEA.eBBDMDIDhAAALHEAAGAHCGDA.BHBAhAAATDCB.fADChACASFGEFBGA...YHDGhADANAIG..EFFB...hAGA...,1,-8,-23,15
BbcCHLSFEPAgQDTZIaJWfVeMUORKGXdYN,QEEBDAFEZEAF.aCCEJDGD....VEAHMCAARAAF.KDDHGAEHhAAA.dCHCBGHBCHFCSGGEhACAFABAEGDAAIDA.IGDEhADA.WHAGfAHA.OCFBhAAA....hAEA...,1,-3,-51,48
SKdUBcQgHVOfAXbEDPTZLYNIGRJaFeMCW,EAFCTGBDZDDGLEBH..NCFAREGFFCDA.CACE.SCAEhAAAdEHGBBAH.QDCDhABAHFFFOEABAAIDDAHB.PDAFhACAIHDBaGHDMIDAKBGG.gADFhADA...fGDDhAGA.,2,-19,-16,3
BgEHbNLedZUJAYGSKFQMafcCIRVDTOWPX,GFADKEAAMHBCaDAF..CBGH.RABADGGG..ODDC..XAEFhAAABCDCHDGBLAHFhABAdAADJAEGAEHDFECAQGGFhABAICDD.TGEAPFCE....hADA......hAEA...,1,-17,-29,12
eMUaVDIGXfdBLFHRQJCSWbZPNcEOTKAYg,eBDHUCECDBHHGFBB.dABCBFFBFHGCRAGHCDBD.....SCFDhAAAZEAE..NBIG.EDAAhADAKHECAAFBMEIH.IHEFhAEALHAC.QABC.JAEGhAAAWEEG..bFGHcGAChAGA.,1,-23,-37,14
MgOTcQJFVCUXGdLHSafINeKADZBEbPYRW,DBCGEABF.....PFDDRDFDMFCF.OAFGQGGBFCDHUFDEhAAAGAEAHBGHaGAA.IBAHhAAAeAEBAHGGBDAFhABAbDAE....YAHH...WFFFhABA..cDAEhADACCCF...,1,-14,-21,7
NJdWfgSQOTCGeBaPAIUKLVERDZMHbcXYF,KGADEBGEDHAGHDCF...XGFCFEFD.JCEGdCBD...fFABhAAAQACBOADGhABATBAGCHGG.BEEEAFDCLDHHhACAZAFCMEIH.cDADYBEB.gGDEhAHASEGH.hAIA...,1,-10,-36,26
dEOZDcRfNVKegXAYWCQMTUGJIFabHPBSL,CBDFTGFGUCFF..GBACFCFBHABC.BFAGSGEDdCAEEEEDDAAChAEARGAE....fGFGhAAANDICKAHF..eCCDhAFAXAGGAFBCQGBDJDDBIHHDaGEHPDGFhAGAOABG...hAIA...,2,-21,-3,18
QPeATJIfSUWXgEOMaHBbCLYKGZFNcdRDV,JABASBCF.UDGAXAFF.OHDAaBAH..BBHHhAAACFDCKCDEFGEE.dDEERCGHQFGBhAAAAGIDTGBC..hAEAfFAFEFBBMIAC.LAEGZDEDDBBFPCCBhAIA....hBAA...,1,-17,-25,8
GaYMKgOZQBTJSXWECebcNDAdPUVIHRFLf,UEFBHDABRDGBLACCGACBMCAAOBDBBAHC..SFCEhAAAEDDACGFGeFCA..NEBEAIEA.hAAAdGCEIHHC.hABAFHCAfAGHKBHB.QCEHhAGA.JBBH.XGGChBAAcGACDABCaCHF,2,-5,-4,1
VWOSGUeAaLMJYPNZcTgIbHEKFRCDdfXQB,LFABMIAA.JEHB..PCGHZBCD..TFEDIFEAEHCA.hAAAKFAG.FCACCCFHDACAdAFDXDBEhAAABBBD.OABAhAGASAGAeBBGAIGAaBAHNEIE...cDGGhABA.....hAIAgECA.,2,-24,-10,14
JCMEKOSLDaIebYPXQNfAVUGdHgZcBRTFW,UAECHCABZEGDBGHFFAHD.CBAC.EEBG..KCCASGECDGDD.eBBAhAAA..bADEPEFGhABAQEEA.ADFA.hAAAdAHC...gGBGcFAH.WCAGhACAMIFAaDEH....hADA...,2,-34,-23,11
QUaTKNbEfZGPHdcMDBVAXYLFROSJCgWeI,XAFFLBDCRCDB.OHAASEED.JBEFCBBCeHDA.UEAGhAAAaDHFKCBE.bFFDfEHChABA.PDFAhACAdHCHMBAC.BCADAFCC.FEAEIFFAhADANAADEDGD.....hAIA...,2,-20,-15,5
GWgDAMHQNPVKJOUFLYXbIfZBSaecRCEdT,MEFHQGEF..VBCDOABBFHBGLBFEXCGGIFBHhAAABEGGeEAE.CGHEdAAAhACATDDF.GADHhACADDIBAAHG.PHAAKCGH....YFAAhADAZFGBaEAG..ECCAWFDH.hADA...,2,-18,-6,12
ZSMBGPdRebTLcKYFJODfVWIHUAgECaQXN,CBCCaCCG..QFFFZDAGBHFHdACFRCAE..TGADKBGDFHAE..OBEAhAAADFHB...fDGHhABAIBAFHEDDhAAAgFDDEFBESAGEMEIB.eDHBhABAcEAA....hACA...,2,-31,-21,10
LZgEQCIXTGaJMAUBHdKNeRFcYWfODPVbS,BAEGdFDBeEACFAGG.......YACFfDBB.DCFGhAAAbBGBLEEC.hAAAZFABgGGGhABACACE.IHAGXGFHGAECMCBCADGGKGEFcFDDhABAWDHH...PFHFhAFASGAE,2,-43,-9,34
IcCUgfLOAVdJDePKMWbESBZHGQYNaRXFT,dGAHJADD.DFBAKABH..MHFA..EGAGBAFBGEEGQCBChAAA..NBIARDAAXEGAhABAFDGB.TFDECAAFUAFBhADAfACGAGHC.eDEE...WHAAhADASGCH.hAEA...,2,-33,-28,5
LcGNYbPZERKVQXJSCHTaWBgOIfDUMAdFe,FECCeCFGGBAA..bEFBEGAH.KCGDXDAH..CAFHaHGAhAAABCDG.OFDDDICGAFIFLAEDhABAcACAPFHFhAAAREEFJACF...SGAH.TAGHhABA.IBBDhAEA.MFFHdCHE,2,-15,-7,8
IeJMATFZWbSCRVGEgfYNHXQdKUOBPcDLa,FGFEZEFGSCEARCBAGAGG..EACH..fECDHGAGdDFAOBABhAAABBEHDABA.IEAHhAAAMFEHAEBD..WHFAhABACHDBgBGB.XBBGKAFD..hAEA.UGAF.cGGHhAFA..,1,-15,-20,5
WgYZKdVULBGbQNHaIRAfTJeSFCEXDPcOM,TFDDSHAE.FDEGECAH.DGAFOFAEMCDB.....WHDChAAAgGGC.hABAZBEHKCBAdBGALAFEhACABAAFbFAFNGEBaBBGAEIFfACFCHHHPBFEcDFDhADA...YEAEhAEA.,1,-13,-31,18
KeSVJdaPbHATMRFONUWcQBZIGCgDYXEfL,TFDEFEAFOEGF..UCAFQFCDBDHBZBFGCAGA.DBBE.EHAEKCDEhAAA.SEEChABAdFHGaAFE.HABAADEH.MFIHhADARDFH.NAIE.IFAG....YHDGhAEA.fCFHhAFAeECF,2,-29,-26,3
SLbGdVUIZXcOeQEAMCRTHaDBfYgNPFJKW,RAGBHBDGDCDFBDAC..YFAB..NBBH.JDGD.KGDHLCEFhAAAGBBAdAGDUFAEIGHDhAAAZFDA.OACGhABAeFHHAHEDCHCD..fEEG...hABA......hACA...,2,-40,-9,31
gJFdCTNVOHBeWUZADLSbQaYKcMGXfPIER,SGBAQGCDKAEEMBCAGDDD..XDDDIAACEHGAhAAARFGFFBDDCFGF..NAEHHCFChABABAHFeDBD.UBGDhACAABGDDDCH.bCAFaBCBfGED..hACA......hADA...,2,-20,-8,12
EdfVKCbaYUZFGIWScBOQHNLDTJAXRMPeg,MBGDeAEHEGHBdGFDKDBH..aEAFZFCDGDEG.SBBDhAAABEGAQBDGLHAGDGIHhAAAAGDCPCHD.fAGEhABACBABbAGBFFBH.WCCH..OCABhABA.NBIA.XACGhADA...,2,-21,-12,9
fNRJZPSDCbTXGWaMVYgOdLEBQHeKUFAIc,..IGHCNAAD.RBCD.JHBAZDAH..SEHHCEEC..XGFHhAAAaCEE.VAFFhABAgGEDdHADBGEFQBCFhAFAeBHH.KFBEAEID.fAGBhAIADFFE.TEFFWFDDMACEhAHAOBBH.,1,-13,-38,25
gJOcdWXSPVUGRMZLfCaQbKTeNYEFAIBHD,BECGDCEBOCADdEFH..SBFGUGDARAFD.LEDB.CEAG.hAAAaHBGQBAEhABAKCCBeDFD.EGGFFGHFAAHEIADDhACAHAAC..cCGEXGAG...hAAA......hABA...,1,-25,-30,5
bgOIBfdYNGQLKZMECaVSTFXRJeWcADUHP,UGACHCEH....PDAEOEDBBGAHdAFDGCABLHDAZFEGEACDhAAAaABGSAGGhABA.FEGBJHEGeFBEACHHDDIHhAAAIHHF.fADBYCFHKBCEhAEACCGB......hAGA...,2,-26,-4,22
FgfVaUBSYDWIOcCLZGXEJebdTMRQPKHNA,FBGHVDFDUEBC.BEDASGCC.DBCFOBABLBAFGGEHhAAAJAHB.dHBH.MCCGhABAREAAKBDF.AHGH..aHACIEGBhACA.CAFCEAHDeFHH.....hADA......hAEA...,2,-32,-24,8
VYJBRDPeFNAOGWZdECQgHKSfLIUcbMaXT,ODFHGBACdGBG.CFHAHEDHSBADLAACUGGFMDDG.aAEGhAHATAGE.JDBEDGGBhAIAeGAAAHCCEDGHKAEHIHHAhBCAXECABECFFBBCNAAF......hAGA......hAIA...,2,-23,-5,18
ITSaHNEOJRYeXZcKMCdLgQWfPVBFADbGU,DDEBUBGA..TCBBSCDFHGFGOFDHRGCE..XGFBhAAAZFABMAGHCFAALACEhABAQAAG.fEGDhACABDBGFEFGAFCGIBEEEHAG.JAHD...hAGA......hAHA...,1,-1,-28,27
DPFUKTXVSNARYdJBQZWGLebEIMCHcafOg,dCHCBBDBQEBFGAFCeEAFEFFH..MDACCDCGHFDC..fAFBhAAADCIFFHAEUAAHTGCAhABASHGCAHAE.hACA.RCEBJHFE.WBBCIHDH..aEAHhADA....gDDHhABA,1,-18,-22,4
YdWebMTSgEVXcQNAHLaGDIfROCFUKPBZJ,HBBHaDFAGGEBDBFBRDECFGGHUBAE..BGABZEDGdGAB..eADBMECAhAAASGCEEBEA.hABA..XAFBhAAANAIEAEAC.fFHECHAAKHCAPACAYBAF.hAGAWAHH....hABA...,2,-32,-6,26
EJLWfODPCReZbAXHBcFVYNUSIQdKagTMG,XAGBBAFAFGFB....VDFCUBDD.IBACdAHEKABG.aGEF.hAAA.MCCBGEBGLADHhABAfDACDEEDCFCH.hAFAeEFG.AEEDcGGHSHBE...hAAA......hABA...,1,-28,-36,8
ceOWSdQNaAYLGPgMJXCTDZRUfIEBKFHVb,GBFCMDFG.JEBGCEFDZABA..UGGAEHGCFAEAHFCC...VADHhAAAeEDB.ODADSCAGhABAdHBDaAAHADIFLHAChACAXCCC.DAFEIAHGBHFF.KFGA..hACA......hADA...,1,-10,-22,12
ScLageUBGPNXKJYQHbTAOEMWIFfRCZdVD,EGHFMEAGFGDERGCE..dCABDBCGLBDC..aFBBUDFDBDGG.GBDHhAAAXGFBKCHHJEDAhABAQFAF..hAAAbCACOAHF.WABCCAGB.SDDHhAFA.....hACA...,2,-35,-11,24
FfPSVXUMNJbKAHeBZDWYROLICaQEcdgGT,BAGHDCIHRDEDLFHFCDHC..aEDBEGDDdCBDGBBFFFGH...SGBDhAAAXGDHMEFBhAAAbAGF..ABEEeCABhABAZEABOABA.ICFB...cAEBhAIAfEDG.hBAA...,2,-42,-13,29
IZGbTKXJUPcNHVQRCDdWEYSMAFfBgOLea,FCDHBFAFOCGBLFEG.aEDGZEAF.GACDKFCDUBBA..NIBFHFFGhAAAQBEH.hABADABAEFDHMBIDAFCCfBBEhACAeHCC.IAHB....hADA......hAFA...,1,-20,-31,11
SNYRcQMXAWeFCVIPbfgUODJdBGHTaZELK,FFDGVDEG....bFGFUFBC.OCAEdDAHGBBDHABCaAFDEGAGKCGFhAAA..SGHHhAAANACF..YHCGhABAcFGBMFAB.ACEFCAEEIAHE.hABA...fHDHhACADGIH,2,-32,-23,9
eDTLAXcCMPZYgGNafJFUVWbEIKQHOBSRd,XEGAMCCFZFDA.GBEH..NHBF.aFDEFACGUDBG..VAFChAAAEDEFQACChAAABEEDdDDBDBAFAAHGCHBA...gGGDhABAfFAAWHDGIHHGOEAHSCGAhABA..hAFA...,1,-1,-36,35
dZXaCcgWDMFBKEYJTAQRSVfULeGINOHbP,QEEHSECFUBCFLCFAGEEHICBCOAGB.HFABhAAAPEHBdCAG..aHGC.hAAACHDA.gAGHhABADCIB.MEABBFDDEADB.JGBAAFAF...fDCAhACANABF.XGEDhAEA.,2,-21,-10,11
AKFQaHdMbZVfGgLeEUDIXRPYOBNTJWcCS,QCCDaBBCHEDFMIEGZFADGGED.LEFAUDBDDHBCXAFGhAAAPCFG.BFDAJABC.hAAACHDDSCGBhABAAGGH.FABEdAGH...fFHA.hAEA......hAGA...,1,-15,-21,6
eSFPYdHEcXCRZIAMTJDNaGWbLVgBKOfQU,TEGGDEEAGGBB.LAEHBECHKGGDOAAAQGCC.eEEDhAAAPGFGHBBBXAGEhAGACBHGIGAB.JBFHhABAaBBH.bCGD.gDBAfADGSHAGhAHA...hACA...,2,-23,-7,16
OLSTGWVfDZNQPKMHbBCIAgaFdJRcUeEXY,FDEHRCADeDEFEGCD...OFGHSEHHGAFC..VAABZABCPDHHhAAAMFBDBECD.AAFHdAGHhAAAUFADLHFChACATCCFDBIDKDGBCADG.aCDG.......hACAXGDBYHBGNEAC.hAEA...,2,-15,-2,13
CNIRUHaOZFXLWcPTdfVMAeKDBJYgSbEQG,KBBCDEIBBHCA..JECDSCAFQEECGFCD.CHEH.NEIC.hAAAUBEDHAFC.OHEGhABAZAGFFAAGLDAHhACA.PCECfDBDAIAG.eFAB.gDFGhADA.IHHBhAEA,2,-29,-22,7
dUCGLPWSNBRHFeEfZDIaYXVcKgOTMbQJA,UAGBCCGHLHBC..PFADSBCGBFFCHACCFADA.EEHHZBAFhAAA.DAIB..IDDFhAAAaHFG..XEDHhABAKFDBOBBBMCAHJHEEABGAdDDF.NDICfFFDhACA..cCFEhABA.,2,-35,-15,20
HBZJNOcXFUQTPSVegGIRKMAYdaLEbWDCf,aGDCECDHDGCGHEEC.BAGBZEBE..OAAHFCADUCDH..TAFAhABASACGeFFEICHAhACAKHGEACHFdFAF.LEADhADACAAA..fGBEJHEEXBBB..hAEA......hAFA...,2,-27,-15,12
edGDKSPRMZfgJCITQHVcOULaYBEbFNAXW,XEBCeHAEGABADDEA.KDDD.RFDB.MFIHZBFB...JEGBCAAGQFFEhABAHBACOAEGaBEBEGBChAAA.FEEGAHIF..SDADhADAfBDB.gAGAIDHE..hABA......hACA...,2,-23,-12,11
BKWOSbcDLNaPYQFZgCTeIMXJfGHUVEARd,dHDHKBHHOAECSAEC.DADDaDCF..QCDEZEFCCHGG.eAHBhAAAMCCA..fFDFhABAGEDAVDABECBFACADhACABAAG..bDFBcGAENEHAFGBF...IACHhABA...hAIA...,1,-18,-22,4
HPgORUeYAEJVKTIBdfNCZbaScFGDQXMLW,VDAEKEGCBDBB.dADHCHGDZADG..aGGGFDHDGDEC..XGDEhAAAMIDEHAFF.OEADhAAAeDDEEFAB.IABEhADAfECHSAHFDCAD..WCBEhABA..gFCChAEA.,2,-34,-20,14
SYJMETUeVALGIdgQbfWNCKaHXPFOBZcDR,LEHFdCEHQFEB..bFAD..NDDAKCBBXBDB.ODEFhAAABHHFDADESCAFhABAMFBHEAGEUAGDABAFGCGEhAAAICCF.fHDFaBBG.FFCAhACA......hADA...,1,-19,-23,4
fZRNABacgWdVHEXbDLKJYUOeCSMTGQIPF,BFFBaFDH.....gDBFdCGCEAAHDAEFKDFCUCDH.CFHH.TADBhAAAGDAC..IBADhABAFGFC.fGCAhACANIEHAAHA.WEHF...XAGFhADAbEEG.LEEFhAFA...,2,-38,-27,11
PQdCMSAbJeHERFNVTgKDZIcOYBfXLGaWU,eFEDHCCFEGEDFAEG...TBGBKDBFZCDEOEFFBDHFLHAAhAAAGACBaBAFUGGCdGAB.MCAEhABAADADJDHB...NIADDAAAhADAIBHE...fABH.hAFAXEEF..hAHA...,2,-32,3,35
EdIVfJNOMDaLGRYgcbPCTZWHAQSUFKeXB,UCEEeBCCEHGEdAGD....VFFBJAHFOFDH..aGDFLEEAhAAARFAH..gBBGhAAAPEAACABETGAEhADAZDAAACIBFABAKCGF.XFGEIHCD.MFIHhAEADBBF......hAFA...,2,-21,-12,9
eUOMGEQZNgYTJVdXBHfDRKbaCILASFPWc,SGDGFFFC..PBCBeAGDMEGDQGBCZDCE..gCAChAAAJACAdAFABHFAhAAADEIDKHAAaAHB.CFAFIACChABAAEHF..WBAB.OFEHEHGCYAHHhAEA....hAFA...,1,-25,-30,5
IaDUORFMPdWQSTGeJYZHXCcKNgELVBbAf,aDBHDHBCODDH..FCGDdGEGQAEHGAEAeDBBJFHHHFDEhAAACFFE.KGAAEAGDBDEBAEAFUBADhAAARABHMICA.SBAFhABA.TDCGYFHD..cAGAhADANAIA....hAEA...,1,-15,-21,6
GXAOLCdJbfRHPeMQKUWSINgBYVFDEcTZa,LADGJDBE.RGEGeBHFKHFCUDFA..SEAG.IGCAhAAANBAGBFCHFBDGEEDAZBBChABA...aEGCAEEFCAGBhAAAfHABHFABMEIFWCAG....hACA......hAEA...,1,-19,-46,27
fAFedPURcDGIJBgZMSTVbKNQLEXOCYHaW,eHACUAAEREGHDCDAGDDABAAAZDFH..TBGFKCAHLFBA.hADA.XDBCCAGE.hAAAaGAHfACHhACAFGFHdAECIGBFMFIHSEDC.NIDDEAFBhAIA...OCCBhBEA...,2,-28,-14,14
OJcHXDTFBMgKESNZdPLAfReQYaCVbWUIG,eFEDQCCACHCA...VAGDUGGAGAAHJBAAHAEADFIHBDFBhAAAKDFD.EEAGZDBDLFEDhABAACAH.RGAGaGGBIHAEhAAAOADA..cDGE...FDAD.hAIASAGE.hCAA...,2,-21,-4,17
eZEVTdbQSIGFAKXOMJCfaDLcUWBPRNgYH,KGDEOHBEMIBG..JCDACFHD...DCHBLEFEUFAE.BDAGRAAF.hAAA....gFBDhAAAeGFGEADGdEEDbABE.hABAQAGD.IFHGABHDfDDEhACA.WAFH..hADA...,2,-47,-25,22
ZKSUaVDMBdXYLCQWHRNPETeIOFGAbgfJc,...bDAHJEDF.KEABSCDDUADG.DFGDdABELAEG.hAAACCEEQBADhAAAHCFGNIBD.ECHHeGFCOEHDhABAAIHG.fHCFaAGGMFFE.BFEB.WHFGhACA......hADA...,2,-32,-18,14
cLPBGaSbNZJCgODXeQdTHIKAVFWfRYEMU,FEDGRFEFMAAFLAAB.BEHBSDHDZGDE.CEAF.DAGC.QBGGhACAdBCFHDCEKGHBADDC.hADAfFCEEAEF.hAEAPFADaGCB...NAIG.JDBB.gFGBhBAA....hBCA...,2,-26,-18,8
ADMUNVLaSKTERdXPeQHJfOIbWZFYcBGgC,MBBEVFAF.LFCH.KEHDRACFXGGB.eEDEQEEGhAAA.JAGDfDGEhAAAbEAHFCAGBCDCgBEAhABAAAFCDGIH.NAIGSCBDEGGB.dHDBhACA.....OAEGhBAA.,2,-19,-17,2
EagVcNdRUWfZFDbBKSeLPOTYIMXHGQCJA,aBAAVDAE..dAFHRFCD.UDFBZBGD..FADFDADFBAAEKECE..LGCAhAAAOGFA...TGGChABAMAFH.HCAEQGADhACAAIBCEGAF...NFED.bBFASAGFhAIA.....eCBEhBAA..,2,-21,-11,10
TZJMNWAFBSgHDUOaXVQdYfcCRLPKeGEIb,SGHBDAAGUDDB.OGAA..aGDBQAFHdFGA.fDDAhAAACFBHLAHBKCBAhABAeADCIHACZBFHMIFGhADAAGECBADHHBBAVCFF.YCAF.hBAAcABB...hBBA...,1,-10,-25,15
CNSDVFXLgYWEMfIaZJHGeOdQKRcAUPbBT,UCDFBCEBCCABDFFC..FAAALBEE....gFABhADAECACMICG..aCGCHGFChAEAeHACQDEFhAFAKGECAEAG.PAHH.TDBFSFAGXAEAhAIAfACHIEHAhBAA...,2,-33,-30,3
YJBFEbaSMcIGTKCQWdNfZVDLPeORUXgHA,BCAGFBBCEEBBaEGD..MAEEGBEG.KGCHCEFGdDHAZCCFLAAAhABA.OAFGXGDHhAAAAFID.JDBCSEAFhACA.TGEDNBAGfGCADECDeBHBgBGChABA...hAEA...,1,-15,-31,16
OSCQUBEVbTRJZcIXAgPdKGfDNLYWHeaMF,dDGHKBFADCADLGCEHFFD.MIFCOHAC..QCDGBFDBVBCFhAAARAFEJCBD.ZEFCIDHFhABAAHGG..gAAChAAAfFAHNEAG...eABFSADChAHACFHE.....hADA...,1,-7,-33,26
UFETPHeXNadKBCWgSLVJGMcIDfQAZRbYO,RAFEOCEGEDBB.HABEeGDCaFGBBBCB..CFBB.SHFAJEEB.hAAAGDDBIHBBQFADhAAAABGCZDAC.bADBFDGChABAXBACKFAF.WFHB.....hADA......hAEA...,1,-4,-25,21
FZPeTdRaSOQMcVBgbDLUEGJYfWHCIXNAK,FBEHeCDHRBBH.OADC..MBAFBFFFDEEALHFEUGDA.JBHB.hAAA...fAGGhABACABHIHBCABBHKGGFZFAATDABhAAAaCGE.SBAGVEAF..bEFAhACAECFF.....hADA...,2,-27,-19,8
QBNTfHAILaZPUSMFGJRYbCWKcVgdeEXDO,LHBCaDAAZDDB.UFGDMDHBFBBB.GCEARFFD..CAFDKHAA..hAAAgAGEdACAeEBBDFIDhABAQADBBBBC.hAEAfDCGADIHSAHHYCGH.cEAHhAAA..EDFH.hABA...,2,-26,-20,6
MWSLDJAXBNTdUcYgVZfbQFRGeaCIPOKHE,BCDETDCDdDGF.UFBG....YFBBVFEG.ZBEFQAAAhAAARGFGeDAH.CBGF.PAABhABA.KDHHEDAE.hACASEADDFFAAAIFXGDFNIBF.fBGChADA..FACEaCCAhAEAIHHH.,2,-28,1,29
ecdDFfWPNgOBZIAHMCSVJUQYXbGEKLTRa,CCCCJCCEUEEF..QEBA..XGABEEGHLGBAhAAARAEGeABADEEE.FBAG..hABAfDHCNBEB.hACABCEAADBBMIFESCAD.YHDChAAAKFHHaFDAWADC..hAHA...,2,-33,-27,6
RNeLcTgCdbYPUAWVKDMOEFZIJSQXHfBaG,VECBMAABFDFD.ZFGBSADA.HBAGfFDDBEABaGABhAAARCCALEBD.hABATAEACHEEdFFHYBHBhACAUAGCKHDCDCBCOAFD.IHBD.hABAJDDC.....hACA...,1,-7,-19,12
RaDfbcVJgYQGdCNBEPXSeZFLWMKIUATHO,HCFDRFBEDHEE...fBAC.VECFYFFG.dDECCHEHBGGHhAAA.EHBGXACDhAAASEACeHBGFCBEhABALBFAMBFCIEHAAAFCTCAB..aGABhACAJDFG.....hADA...,1,-17,-22,5
HFWCASUPLXMgNQGIEOZBVbJaYKcdDefRT,UGDALAAFMBBFQBEFGDCF.EEAFBAFD..JHBEKAHHdGGEhACADCHDeAHBRFFFHACDFDCDCFFChADAACFD...SEGEhAEAXEAC.IBBHOHAA.ZFBG...hAAA......hABA...,2,-23,0,23
SEMVCeDbRXAFIUHKfgdBGNacPTOJYZQLW,FADCHFBHKGFFdABCBBBDaDEC......PBECOAFDZFGHLEDGhAAAEDBA.CCDADBIHRGDCAIAC.hAAA.IADBUFACGEGAhABANDIG..cAGF..YHBGhACASFAD...hAFA...,2,-37,-4,33
CKRAJNLXVZOdbfaYeUHSBGcQPTFgIWEMD,JEFDXCDAZGBG.dBAC..aFABeDHB.SCCDBBGEGBBDhAAAQFBFFHGA.IBHDhAAAECGDDICECDAAAGFFNEEC.hABALEADOADG.fFFB.YHFGhABAcEDG.PBCAhACA..,2,-38,1,39
KNPBMECDcJLIUWSZVdbHQgaFAYOXTRfGe,XBDARGDEeABA.KDGABAFC.CGBC.DGCBLDEAUGDCZBBH.dBGDHCADhAAA.aFGFAACCODBHhAAATECC....NCIG.hABAMAFCEAHH.JFHDSCEE..QDDGhABA..hAEA...,2,-28,-9,19
JVeAGHZLcNKaOPTWECDFUQfSMYXRgdIbB,GBEBZCDHLBHDKFDDOEAB..PBBHEADE.DIFAFCBEUFBHhAAASGHF.MFEAhAAAXADAdHEFBABEhAFAeGFAAEEG.NIAB.aGADCACC....fCFChABA.....hAGA...,2,-24,-19,5
WbPRcDNGfMKOHBCTgZeVXYAJQdLFSaUEI,QAGCdCABLGAESDEDUAEG.EAADIBHA..hAAAPEAADDDDGEGEhABAMDHFODFFBEFECEEGTDAFhACAgACD.VGBCAIDGaBBA....hADAWFAD....hABA...,2,-23,-18,5
eWQECVSYXdKRNgMUPLfJFbADcIGTBOZaH,DHFEGEBGOEAHZAAAaDADHDBC...QCFCCEGE.SACEhAAAdGFDRAGHNIEB.UBAAhABALAEHFGBEAGIBIFGChAFABGDHEEEG.........YBFChAGAKGAFMDIH.fCCEhABA,2,-29,-12,17
MFdbXGZECOcWNHUgeJaPISfRVLYBKTQDA,FABCdDBBGFEHEFFA.CCFB.ODAE..NBAA.HFBC.eBFGaECE.hAAAPBDF.IHGGhAAAfGBG.RCGFLBBAhABABHBEKCFDDGADAIAGMBFG....hACA......hADA...,1,-17,-26,9
GDIMcHQWKYAOFRfEZgaVPLSbNUBTJXCde,OAFARFGBEDCF.ZFBC..aEADLFGB.SADHNAHCBBCC.hAAAJDEACGCDdAEEGDAHMCIFhABAQABC.hACAKFFFAFFGgGDHPBHF.....hAAA......hADA...,1,-16,-29,13
SJTFOEZcGBIgVDCXHaKQbeWUMRLAdYNfP,dAFF..fBGCJECEFGHB.ZFABBABFVFCG..DBIHCHGEaBAD.hAAA.KDGG..QACDhAAAeACHUBEHLAFEhABA.AEDCNCIEPEADSFFE..hACAEFFF.....hAEAIHCBXCDA,2,-44,-3,41
NdaZbgKDIFXCLOceMRHPSJWAGVBYETfQU,BFEAEHAA.QAEBdBDCaGHD.ZCAHKFFCFCDBLFBA.ODAEhAAAMEFEHGFC.SBHBhAAAAHDCVAGDfBAFhABANHAFDBBCCFDF.eHEC......hACA......hADA...,2,-23,-22,1
JLWbQCgcXIZFYUVOESGPBMRHDATeNdfKa,eEEEdFDHaAGGLGAG.QAEACFHB.XDBFFDEBVBBGhAAAEABCGEACBHEBMEIBhAAADCIHAHCC.TCGAKHDA.hABAbBAC..IAEG.....hABA......hAEA...,1,-9,-33,24
JVTDeYRQGgaMFIfcbAUKCOLBHXZNPSWdE,CBEBBBEBZEGB.SEFHdFAF..JDEETABB..DBIDRDCHGGADhAAAMACA.FHFA..hABA.fBGDhADAAAACUBBCKGCAOCEELFFFXEAF.NEIC.EGAHhAGA......hAHA...,2,-41,-8,33
IdYaLJQEFPceOTRNGbXMAHSfVKCUZBWDg,HADHSBAEKFGEUBGGZDBDDAFFdHEDLBBD..QAGBhAAAEFCFFEED.eHECOHAChAAANEDHXFGAACFB.hABACDAFBEAH.WHAEIFAH.aCCFcACFhABA.TFDHhAEA...,1,-17,-28,11
efHLcDBZVEKNJQIagPWdTSUbXMRFGYAOC,OECDeBCCHEGDDAADBBBFEBHBKBAB..QADEaEEH..PEADhAAATGAH.SEFChABAbECHMIBARCECFAGGAADGCAHEhABALGFG.cDAD...NIDFJCFEhACA.....hACAgEGA.,2,-12,3,15
MIUCNZRSVbDWJBXTOgHLfcdQPGAKYeEaF,KGDBeEGDFAGCMDEH.UAFHCFAHZDDE..SDCDDIAA.BACChAAAOAAEHGAELAEDhAAAdCGDPHEEACGE.EBAEaFFDhABA..IBDF..NDCE....hABAbFGDWEHB...hADA...,2,-42,-6,36
cMYEQUXCGWTadHJBSNVeIFODAZgRfKbPL,RFABKHEELHFCMCEE.QEFFUEEBGCAE..TBBAaACCdDHChAAABCFB.SFDGhAAANCDE.IAEFhABADICEABAEZAFCbDAG.PAHH..EGADXDDFhACACHHB.WDHH.hABA...,1,2,-22,24
KOVGfgCPQEBUJNbDHSIAdeTWFYaXZLRcM,TBAAFCAE..XGBHLBFB.MDEFOEDF.GCEFhAAACGFCPAHHBEBE.UFGBhABAJGAEDEHBIAFBdCDB.hAAAeABAaEAC..........hACA......hAHA...,1,-24,-29,5
QWHgTFDcIECLPbOVNdRAaJSKUBXZYfeMG,aFFBSCHBBCFDZAAFeEBB.GEDHQECGHGDAFBBCDAFEEDHFhACALAFH.OEAHhAAAdBGDAHHCKACAXGGHhABAMFBD.gADBIHDCCEACPDBG..hACA......hAHA...,2,-25,4,29
KMaYDJOPVEfBeZRFgTNAdLQcIXUWbCGHS,QAGBXBEGUGDHCFCBGGDB.HBAGSEECMEBGDICCJCABhAAAODDA.VEFChAAABDCE.RFABFGGA.NACFAHABhABAcFAH.IADFKCGB...aAEDhABA......hACA..EBBE,1,-8,-23,15
CARFPBODeIcQETKdVHUXZWSNJaGMLfbYg,FFADODAGDDAB...eACCQAACEFEHKBFDHAGDUDFBZEBF..hACANEDFGEBEMIACLGFEhADA..fGFHhAAAgDCBAHHEBBAAIBDF...hABA......hACA...,2,-23,-19,4
bAfeFYKUTEaMQOCNcDGHVISLWJgBZXRPd,FFGFUEAGEAEFMACA..CDGG.DIGAGDBEHDFE..SBCHhAAALAAFJHCGZGCGRAFAdAHGAGHH.eAFHhACAKEDH..QBAFhABAODDF..NEACIBCG...hAGA......hAIA...,1,-14,-16,2
eRaHObFWDcQgANCZUEXITLBVdMfKGPYSJ,CHBFZCCAUCABEEFF....TFCBBFDEdCGEMBDGKFBG..GDAAhAAA.SGGDhABAeBEDaFFC.OFHDFHFEDBFGQAGGhACA.AHFBNIABIAAGfCHChADA......hAEA...,2,-51,-7,44
IQYVMeFgDKdOAcESGPJRUHfZLNBCXbWaT,SDGFGBBHRFABUFGDZCAHBGCD.CADC.XDAG.aCGATCDGhAAA.QFEHhABAMEFHeHDGFHACDAADKBGEhACAADGGEEDHPFHB.fAEH..hAHA......hAIA...,2,-26,-19,7
aZWUSFAXDfRJHQgcTEIeGbVMBYKPNOCdL,DBCCRCAAHBGBQFEH..TAAHEDFDeEAFbGAC.BBGA.KFCDhAAANCEEdAFGZBBC..SHGAhABAFEBDAICGXFGChAAAfDHG.........hACA......hADA...,2,-24,-14,10
cAIbaNQSMVYPWfGTeXRgEHCUBZOdDFJLK,aCADQBGG.MAFEVEEE....PFDFfEBFhAAAGBBHXGBAEEBHUGGChAAAOAHBDFFBFDAGJCDCKDEGhABAAAFCIACFSACEYHEC..hABA......hAEA...,2,-31,-3,28
TIEVHDKAFBJgMGfcRPQUCWSXLbOYeNZad,FEEBJEDEGEGARADF..UGBHCHDB...SGHBXFAGLCEEhAAA.OBCFhABAeABBaCFAdCAAIHBDhACAEHFGDFAAAHEFBAHC.MCIHfADBhAFA....cDFAhAAA.WDAA,2,-33,-31,2
FbBLEfaTVNDWegIMPXQSHAZYUGRdOCcJK,ZFCCGBCGOHFECABEKEEHBBHE.LDAEEEGE..aGCG..VBEChAAADBEGeCFEMAFEQEFEhABAABBDUGGBdEABFGABhAAAfBBB.NEBG.WHBA..IHDHhACA....hADA...,2,-24,-19,5
AgNSLCWRZHeBFbaXEKIQYfPJGOdVcMTUD,SGAGCFDERADE.eECGFHBA..aGFHEBDB.QGEA.hAAA.YCCDfBFDhAAAJDAF.OCAF.hABAdEGHMEECDABGAHHENAIGLAGHWHAABDGEKHGC.hAEAPFFG.cABBhAFA..,1,-21,-22,1
JgWOEYUMXDbVBQGTKPLNRHSAefCIFcaZd,CCCCFFGCZEGHdBGF...JACEOHAC.EDAFMIDG..DFEDBGAAhAAAQFADGCEG.KDDDhAAALABFHADGABAA.eCHBhAGAIFFEaEDH....WHEEYCFGhABA.....hAHA...,1,-21,-32,11
AaFDZNKXgeOCdMGVRQTfYWJIPUBEbLHcS,DIBEZGEEKFAFeBFAdCCBGCDE..QDDBTABB...fDHAhAAAJHFEUDFCEEBDhAAAHEBDAAGD.aDGBFADANBEH..hABAOBAHCHEFMHAC........hAHA......hAIA...,2,-17,-16,1
KJNCcVMaERHAZTGBYOgSFQUdDWeLXbPfI,TAEBGDEDBABF.OECDSFHFQAFBUDEHdABCDEAALCCGhAAAXAGD..hADAfEAFIBDCKFHHhAEANIBHCGAB.MIBCRACBAGIFgFDAWHFG..hAAA..eAHH..hAGA...,1,-6,-19,13
VaCKcLTRUPIbXOZMfdFYSgWEHDeJQGNAB,BGAGCBGDKGED.LDED.UAEAIHAGOEBFZBCF..MFFChAAAFHGE..SDAAhAAAEHECeBAC.JCHBQBGChABAAABB.aGGFTFFB.RFBD.bCAAdAFBWDFAhACADFDC.....hACA...,1,-6,-31,25
DdMfUFQYPEAeNKCZGJcSaXOVWLTRHgbIB,KAEECEBDZDCCGGBF..SGBHOCFALCDHRBDEHGFE.IEGFhAAAdDHAMAAB.FBBGQCAFhABAEGDH.AHHGeFFBhACANEAG..aBGA.......hADA...WBBC.hABA...,1,-17,-20,3
GEeVPXfdNMBQHFLASYZWTcOCbUJRgKIDa,ZFFGTAAGCECG..UAEHRFFHKEBG..DBDBaBDFGBGE..EDEAeFDHhAAA..XGCHhAAAdBAHMIEGBCHFHFABAGEGYADChACAODAB..gDEGIHHFfHAFhAHA.hABAFEHF..,2,-18,-14,4
KJDeaXVPOAZBRfYTILgFNEUdGcQHSbWCM,BGDCRCBF..TEGEIBDGFAEG..ECHBdEFFGECGQBFChAAASAABCHAB.MEFBhACADFIHaDDD..PBFDhADAADACfGGA..gGGGhAHAUEADcBAF...WACChABAKAHHeBDB.,2,-32,6,38
HbCcYXASPTfeDdgFVKMLZEUIOaRQGNJWB,SEAHTABG.DAEHdDDG.FHAGMABFEDAA.UDEC..IBFHhAAAOHCCQFCDhAAAGGDHJCGBBADECAHCXDCChACAAIHEeFAGKFGBaAGA.NDIA...WBHH.hABA....cAFChADA..,2,-21,-16,5
aHPNXLBDIWACbEZMGJVKOYQFTRdcgeUfS,EFCFZCFBJAEDKAAA....QDCD.FDHHTDABRFEC.dFDEhAAAeBEESBAFhABAaHBCHCAHXGGABHHEDACEhAAAIHADCAHHMFAB.OCHF..YCCChAFAcCBFfAGHhACA.,1,-2,-43,41
dTNKRgCSeIYEQWOcZVAPHJDfUbMXBFGLa,HEABJCDB.DDDHUAFAMEFCBGDDLABB.dGDBKGHDRADH..CGHC.SAAFhACA..hADAeAFGEFBD.OHFChAAAZEFAABDF.fCFHFBBFaEAG...NIAF.gGEHhAEA...hADA..YBHB,1,-18,-31,13
MIJOYLKbRFCgPecfANDTXVSGEWQHadUBZ,TBCDSEEH.EBDHQGFA.aGBFdHAHUGDABEDEMAIBhAAAOAFHLAFHhABAKDGFFBGAgDFAhACAPFHDeCAFfEACAACGXAAG...WHDEhABAIEDGJDBD..hADA...,2,-15,-13,2
cPSNKELabWZBgVeUCIRHMfQYdFXDOAGJT,GADCTBFD.SBHBKBAFLHFA..bGBCZFACBCGBeEAECGHBRFFDhAAAMFFA.QBBChAAAdDAGXDBEAIAAJDDAPABFhABAaGGG..WAHHgDGG..hADA......hAFA...,2,-12,-5,7
PbNQfBJeLSDcXEYCGaUTAMRIdWHZgKFOV,REDCdEFDZDBGFHDE..OHBA..VAEB..bABHQCBEhAAA.JEDBSDGBhAAADAGAEABF.GAEHhABAUGGHABIHIHGDHEAHKCGGNDACBFHA...hABA......hADA...,2,-18,-15,3
QJFRfcSXYPeMWDTbLGNOCHAgUZaKIdBEV,UAFHZAFCKEHBBCBG..VBACQDEF.RABE.SEEHhAAA.XECChABAeFGDDDDFTGFCLGAAhAAANDDF.CFHFAHEF.aDAHEADB.FHAA...fEAChACA...hABA...,2,-34,-15,19
BLVPaKHMdAQZIeUOWJCfGSEFTDcgYNXbR,ZCDHeHBAODFFCDGC.GCBESFGB.FCDADEAH...gBGGhAAAXEAFRAABBCAAhABALADAaHEGMFIDhACAAFFHIAHFJHAE.fHEF.EDDDhAAAYABG..hAFA...,2,-27,-19,8
gRCPISJbdKBONFATQLHMEVaDYfUcZeWGX,LAACMEDF.EGFCVADADEAB...UGFBZGBGeCEAGEEBXCCBhAEACBGA..SDAEhAAAdEFDKEBDBHHBFGAGACIHhABA.QABAaBBHfFCH.WAHHhAFAPDDA....hAGA...,1,-15,-23,8
IaRBWMbFOVTLfGCdegAEYZJUDPSKNcQHX,ECEDJBFH.DEGBKFGC..QBBGHECF..XCAGaEHDBGCCMIBAhAAAOAECLABAhACACGDAeBHFAAGCUFAG.SGGGhADANAAH.IEEFRDBAFHFGfGAGhAGA....hAHA...,2,-21,-18,3
CBNJMUQTFZEHPIaWGegXcDOLYfKVARbSd,SCFFBCCHMEBHUEGEFADHHDGF.aFBAeABF...XECDhAAADACBLAFG.hABAYEEFVAEDAAHDdFFGhADA.CCHC.NAAEQGAE...EGGDhABAIHHA..hAEA..WBBD,1,-6,-34,28
RQMFeLHEIdXfDcOCSYPGVWgBKabUNZATJ,REBBMCBFFBBHHEFHdDEGDDGA..CBEE...SGGBGAGC..gACDhAAAaACHUAGGAHEEQGDHhABALFCFEADBhAAAIDDF.fHGHYEAF.WEADhAEABHFH...NEIA..hAFA...,1,-21,-23,2
eHFdaMAfQGXNCOWIEJYRBZbTVDLcPKSUg,QFFDGAEDCCDE.OEBFECBH..REFHBEHETCCEDDFCLACEhAAAKFAA.SDHHhABAeHAGFFCAdAAGaHECAFEE.fBDBhAGA.XAGAIHHCYHAAhAHA....hBAA...,1,-18,-29,11
ZOgJedIPAfcMXTbKEGBQCFRNYHLVDWaUS,MADDTAEEKAGB.BFBBQGGB.FHDGRFFEHAAFDAAF.aFEBUDGEhABAZAEH.OCEB.hAAAJBCFIHFDAHBB.hACAXCDDEDABCGCC.NIABLGAGSAHF.hACA......hAGA...,2,-20,-16,4
CQaMNJFSAfXVYUEeKPbRTDWLZgBHdGIOc,XGGGUACDeAFBKCGHRFFB...DFDDZFDDHBCBdGAGGCGG.ODAChAAACAAHMBFH.JEBHAIHE.hABA....fEGEhAAAEFCF.PEEHWDCEBBHBQAGDhACA.aADF.SGADhAFA,1,-15,-25,10
SEBYGcVQXIRfHbgJWZKUNFLMDaedOPTCA,BCFFGADAQACERGDAHBGH..JAAGKGGGFFFAMEEB.DDIBdFADOAEEhAAACDBDAIBC..SHAChAAAEBHH..YCCFhABA.cFACIFDD.fCCGhAFAWFEH.NDIC.aCADhACA...,2,-40,-19,21
IOBQNgXAYTCSeLWbKfUdRcZFHMPVDEJGa,CDDDSDFELCEGKBBDUFEF..RFAGZFFHMACD.DEDH..GAEFhAAAaADHBBHC.QFADhAAAXDACAFIBTAEGhABA..bEGFfFHGFACF..PFEHhABAEDDE.IHAAhAEANICB..,1,-10,-34,24
LDUagTZGKCBVOQHdcFIWMSNPYeXbfERAJ,LDAGUEAC.aHACTEECZEFB.GABBBABGOBDFHCCGFBHDMBFBhAAASGCH.hACAPHEEXGCAfCAFhAAAAIHEgAGGCHAHdEGE.IFAG.hABANDIE.bAFB....hACA...,2,-18,-3,15
QDReUKIECAXFWSaOdMgLYJZGbHPTVNcfB,XGEFFFAC..aGCEMEBGLAACZBCEHCFA..VAEEfAGDhAAABCBDQDFEhAEADGHFeBACUGBEKGGFIEDAhAHAAFEESFACOAHDYEHH.hBBA...JCCA..hBCA...,1,-2,-22,20
UKGDaSIPZCQHXAWBLRYgOFeMJfbTdEcVN,LBAFREFGODDB.FDCB.MCGDJACD.....TEDCEFEBVGAAhAAAKBCADAIB..aAFAIGBFhAAAZBECHCABAAGEBHEEhABA..gGGGfHGH.dBFBNAIGSBAFhABACDHGWFAD.hACA...,2,-34,-3,31
EGfTZJDWgdUKVOAHYLQBSIbPNFMXaeCcR,HGCAQCCGBBCDSAFD..PEHHMEBDeEDChAAARGCGEAGEGEAEZCEADFGCdGHAhABAKADEABCEICAAFCFEaBADCEEFhAAATAGB..WFFH.....hACA......hADA...,2,-18,-11,7
abPLHWeMCBGVUIRJFTfdQNgKcAXSYEOZD,SACCEFDADFIB..aBFCLBAA.HFEHeDAEBDDGUGFHhAAAJAEEFEAHTCFEdACAQGBDhABANECE.KAHBhAEAAHHE.XDFBODHD.......hAAA......hABA...,2,-27,-15,12
YgQODEPZbKCIAWUBcXSNFRVadTHJefGLM,BEEGSAAEFCDGRDGB.dCGEHGBC..eEBALAADMIFEQFEBhADADCGAZBBFKFAGAGIHUGAFhAEA.XBEH.hACANDIE.TGFHJBBHfAFB...hADA.YAEA.hAHA...,2,-25,-17,8
NIVLCHfZRTaWSgdbcOJPUKGEQBYXADMeF,MDDCeBAHFGHF..IHEBCHBFZCFF.REAE...aEBESGAGhAAA.dAECODCAhAAAUEFAKBGGEAGDBABEAIHEVABDhABAfFEE..WDHBbFAC..cACDhADA....hAFA...,1,-19,-34,15
WTCOaHULgIFbEXNDKYeAJQPBRVSMdcGfZ,QBBDBGBHSEGEdEDDGBEFZAAFCACE.aEAALCFA.FGFChAEAXFAD.KGHHhAAAABEGPAFGMDHDcGEBhABATECDOADG.......hBAA......hBCA...,1,-8,-37,29
HANgECOcTdGXWVYaRPIUKbFBefMZDQLJS,EAEACHCH..OHFAdFCEGCAD..VBAERFEEUBGCFEGF.BEADeAHHhAAAZAAGLECC.hAAASBFHAIGGNIAH.hABATFAE.XADAaEEAIEHFKDAD.hABA......hACA...,1,-19,-24,5
eRbLVNCWgMGOfJZDFSIaBPdHTYXAcUQKE,QFFBeFAHLDHBCDBD.MCCDOAEHZGCGFDEE..aHDCdDDGHCFHhAAATACHACBEKFAEEAAC.hABARAFC...NCICWEEFhACAfEGC..DCDD.BHBA.XAGFhADA....hAFA...,2,-22,-6,16
GWIVQRZEBHbaCcFYOSLTDdNMPUeKAXgJf,JAGFGBAF...IHGFRBDFBABGHDFHCEGD.FFDEOFBHLEAEhAAAdADH..MICGeFHDhACAAFEGXFGA.hADAfCFFQFAEEAAA.aAGASAHBhAEANEABKFCH....hAFA...,2,-25,-9,16
KXUbCVFcLAJTgOSDGRNYdIEHQBfMPWaeZ,JACDTFCB..OFCFSDEEGBFGRADAdHGBHCABBBAB.MCHDhAAAPEHF.aFFHKEAFhABA.bFEFCABC..FAHBACFGDCIDhACAIDDEEHBEfDAD.eDCGhADAXGAD...hAEA...,2,-17,-10,7
NcDdGeaOFAIKCRHXbVgJQULSfPBTYZEWM,CDCCHFBD.VBCHJADHLCBF..SFFGBFAGZEGD.MAFDhAAADFDEGGABOAGDABAFhABAKAADRDFEXCAHhACA.bGFE..UGEAfGAEPAEA..hADA..EDEANIDB...hAEA...,2,-29,-6,23
bYVXRTMBfIWcJdFEOZPeGUgSKNDaAQLCH,LDDDHCDCVCAFXCGAREFD..BGAB..fADChAAAIAAGJHCCdGBGFBFCOACEhACAPFFF.eABBhACAgCGB.KAFCNEHCAAHGCHHHTECB.hADA.MFAH...hADA..EEEC,1,-4,-17,13
TYHNcZWISMUeOXDJQAgdGLPBCfVEKaFbR,GDFCBFDBCFBH.EACHKBHDFAFD..RFEH.HBABZBAH.IAHF.SHCGhAAAMEADOCCAhAAAJEDFABAHdGHCLFAFhABA.fDDBaADGbDDA.YFHB.hABA.cGBD..hACA..eEBH,1,12,-40,52
MZOUEYQXBLVaefCAPDNTbIKWJHdSFGgcR,DGEHTGBAKAFEHFFE.dDBHSFGBGABFRCGD.MEBAZCDD.UACAhAAAEHBC.XAFCBHHE.hAAALAHBaCAB.fHEBhABACAHAAABA.NEICIFEH.FDFChAGA......hBAA...,1,-15,-16,1
eDbTaCcVdBQgHMGUOFPLSfKYNAIRXJZEW,XCEEJDADZECE...EFCFeEGD.DGIDaABF.CDCB.dBGEBFEDHGCGhAAAMHEEOADALEAFhAAAKABD.ADIBRADA..TCDFhACAcEEF.........hAHA......hAIA...,1,-22,-28,6
gPAWUFQLVYDadbGOESJTefKZIHBRXNcCM,FFAHLGEGDACH.aCGGGGDB..SFGEeBBDZEBCBDDDhAAAXDDCCAEG..MBAHhABAPGAA.AAFGQAAAhAAAdGCGEFFG.fDAC.HADHhADANEIA.WHAG...hADA...,2,-29,-12,17
NeBYfHaAcRWLTXFKGSPJbVQZgOdMECIUD,RBGFLDFHFBBHGEFGJADD...QFBAOAFGdHFBCBFC.DEDGBDEDhAAAHDAHAAHE...TFCFhAAAKADHSFHBhABA..bABF..ZFDBMEIBEGAD.IHBAhBAAeCAD...aCFA.hACA...,2,-15,-11,4
CJeKIXZbNAUaLGSBMETRYPVfgcFDHdQWO,aEBCSBEHBEFA.MAFEEBAB...TBCBRAFG..VFDDfGFHhAAAFCEADEAHQCCChAAACFECKCABZBGFAHHCGEBEhABA..PHFE......hABA......hACA...,2,-28,-17,11
cKSeQGdXUZfLAMVaYPCOBTbgRJHNDEWFI,aGBBCAAABEFE..TCFERCCCHFCD..DFEFECHBFDBG..KFADQGGAhAAAdGGBUCAELADChAAAAHAHMAEF..YFCBhABAOHFE...JAFEIHBESACDhADAeEEBZFEDfBFEhACA..,2,-23,-11,12
bJaLNGKPZOQgHXTfcDBEYRdSFVUAeWICM,eDAECCFC.MEEBJGAELAAHGCGCZACG.QGBGHDBG.XGFDhAAAfAEDBAGDhABARFEDSAGBhACAFEABADFH.IEHBaFFB.NIAFKHGG....hADA......hAIA...,1,-5,-27,22
YVSZRaAJfMQLHcDCPgEXWbTIeOdGNUFBK,JACAMFAFLDFGDFCF..CFDA.EAAH..XADE..TGBDhAAAODHHdAGDUCEDhAAABHHAKCAGSCBBhAFAZFEBAEAA.QGFC.HECAgABDhADAIFHBeBHB.hAHAFGHD..,2,-24,-19,5
NPdMAVaOTBQJGLUCEDeIbSWfgcHFYXRZK,VCEGOFBD.BBFDGEGCLBBAUABBDCCFeEHF...IEEChAAASGAE..hAAAgGDBFHCEXAEChACAKDAGdAHAAFFBaAFA.JDDHEAFE.fACFhABA...YDEChACA.,1,-16,-31,15
SIAefMEgWJHQdGNXCTBRPcLVKDUZFabYO,eBAEMDAG.EGGA..JHECdAEAGCFACCHC.BABDRCAHLHBADAHHZFBD.hAAAaAGB..OACGhAGASEGCAHHE.gDDDhAAAQEDGXFDG..cBEBhAIA.....hABA...,1,-23,-28,5
HAUJcQFSICRWMXdZgOLfGPbEaVYKNTDeB,UDCFQDFAFCAH.SHBGCEGA.RBAE.XGCFdDDEZFAAOFHDhAAAGAAF..EBGGaCHFhABAKGGATBEE.DFFBhACAeFBD.AIFE.IDACWAFD....hADA......hAEA...,2,-33,-13,20
GKSdaUVQJATZFceEOPMWIXNLfbDBHRgYC,FBEEeCEDEHEAMBBA....IDBBXGABLDDBDBFCHEGDhAAARAAECHCFSDADhABA.UGDHQDFGhAAAACHATCFBcGABPCCBWFGHNACDBAHB..hBAA..YAFChACA.KEAF.,2,-29,5,34
SePKCFVUbHfLIJGMaOYDTWcRXQZgNBAdE,SCAEeFFACFAD.UDDGHAAALEHFJHEAGDCEMCEC.aHAGOAHFhAAA.DBEHTDAGhAAARBFDQCAFZFACNBBBBGFBhABAAEEGdHADKHDA.........hACA......hADA...,2,-12,-9,3
SGdKQbFOMRCgaWHfNEJZADcLTIYBVUPeX,DFDBLCBB.TGAAIBFA.BDABUADB.eEEGSGFDhAAAKGEBFGGERECFCHABaDCA.hAAAHABGNCAA.ZEFCABBC..hABA...cEAE.....YAFChACA.XCGHhAEA.,2,-37,-22,15
UQXbFIMGRKPDOgVcfYTeZdSWLCBNJEAaH,HEEBUEDBQCAHFBFF.GAGGKEDFDDDAOEHDVABC...hAAAfGDCeHAEdHGFSEHBhABACBEHJEBF.hAAAAAGGXEACIACCMDDC.PHFChABA.YFAF.hAEA...,2,-26,-2,24
OWHVdRMPbNQJUTADFZESaXgIcGYKefCLB,ZDBBSBAFaGDG...XFDBIDAHGBDDeAGDCDFFBGFGhAAAHAAARDGDMDBG.NIAH.hABAJEHDAAHE.EHAC..cEBChACAKGFBOCCA.WAHBdAEB....hAAA......hACA...,2,-20,-8,12
CYQRJgSLMBZTEDUdfXHNIPcaeAWGbVOFK,GFBHOACAFCBBCBFHRBCB.....SCEHBEECEHAEdCAGHGEE.hAAANDIE...IHHEhABAPFBA.eCFAAABBVAGDhAAAKEHBQFFG.LAFE.hAGAMIDEDFFAfDCHhAIA.,1,-5,-27,22
AONfBYUSIWHeFQJEMCXGZVcgTbaPDRdKL,OBGDBFBBUGEB..SDDDHACHFBBHEBEHMIBE.GAEGhAAAZGAC.VBAGTDGAaABADFGFhAEAdBGBAEEC..NHAH.IHHChAAAeFHB.CFDF.XEBD...hABA......hACA...,1,-5,-24,19
bWePFEBKfYNQZHIaLTVgXUCJcMdGDOSRA,eAFBEHDAKBCG....fACCQFAAZEBFHFFCaEFBTCDGhAAAXCAD.CEEHMCIFhAAAdAHGDBBDRAFEAGDH..bGFEFABGhAEANBAG.IDDH..gGADhABA.cEGBSHAGhAFA.PCGB,2,-18,2,20
acSIRBZHgQLOYNVCbPGAfDWJKdEUFXMeT,DGBFJHFC.KDAFUCBH..FAGB..MAIBaGFA...SAEHhAAARCBGBCHHHGDAQGBDhABAOFBG.VDGD.CEED.hACAbACEAGDAdEAH.EAGFXAAFeABA.cDGChADA.....hAGA...,2,-28,-16,12
UFMXaeOLfNYQgHTKERGVbIdZCWcSJBPDA,FBEFaBEDLEAD..fGGAQFGEHEDAKBCAEHCEGBAChAAA.IGAGhABACCGASAAGBDHBADGHMDAGhABAeHCENEFC.YAFC.gACFhACATEBA......hBAA...,2,-18,-15,3
UMLFfKcHgReZXNOVYAbaPGTJDBdQIWECS,aFGBTEABBEBE..QAEEEDFE.SDECLACAFGADhAAAfCCHHDDHeBFAhABAZEFFNAADOHDE.AHDEbBBChADAJEHFDBHD.IHABCHHFMCID.KBBF..hAHA......hAIA...,1,-3,-19,16
dHBcPSVeFZJgKGWCLDbUTNEXMQOfYIARa,dGCCHABGBGGFSDHBeBBGZAFHJBEG.KEAECEDC.LGAC.DEFGhAAAUDAD.EEGGMIBEhABAOFEBIGFE.hAAAADFEaDDHPAHD.FACAWHFA..NBFE.fCAHhACA..hAEA...,1,-24,-26,2
ALSHbTJVdcYEMGFNaRgfODCBWZeXPIUQK,SBEFHBBHTAEHdDAFEFEEFFEB..aHGARAFF..OFABCHDEBAHCeGFAhAAAXCGF.PDDAhAAAUABDKDGH.ADID.hACAJEAD.....cEGHYHCAMBABhABA......hACA...,2,-21,-13,8
MVCGbKIfPXdBWcYFLSZHOaJeNgDEAUQRT,UDAGQDGCRDDD.MECECHECGAAF..KBFG.IABGhAAAXGBGBBDE...hAAAWHBAcFGGLFFGhADASAGAHFACaAHFeCGHDAEEADIBbAEF..hABAfCCD.hADA...,2,-24,-13,11
dAfZRBLCNEPYWIOHgDSFVUeTcJGbMXKQa,RCFEBDDECFFE.EFDG......PCCFIAEDOEBHHAFBDGABhAAASCBD.hABAFGGDeGEGTDGAGADDhACAXABBKHCAaBBBAFIDLHBAWHFA..hAAA......hAHA...,1,-23,-26,3
LcIUGdWFEBObDVRYSgfXZAPMCJHNTQaKe,MBIFHFGBQBDEKDGBLCACUDAA.dEGFEBECBBHFDHCGRFFHSGCDhAAA.fABFhABAAEEECHABTEABeFEBhAEA.IHAHFFDC..OAAG..hAEA......hAFA...,2,-31,-7,24
cSZLVJIUNdFQaTCeBKGDYAWPRXEHgOfbM,RAAFHEGHOCDGMHDCZGAELAFG.IDADUEGHFDED.QEBChAAAaHAEeCEBKAADDAGG.hACAADGC..XCCHhABAEHEE.fGAH.SBCChACA.NIDH.dADF.CCCGBHGEhBAAWCFE..,2,-17,-16,1
BcbRdNMUeVFZEYCXJSgALDTfaKOIGQPWH,LBEADEDH.aFHDIEGCGEEAQFAAHAADBHBERBFGdBCCMIFEhAAAeFDD.FCABECCGCAAC.hACA.SDCAhADAAEIBKGDHOFAB..cCGE..NADFZEEHYAFEhAEA....hBBA...,1,-10,-18,8
NfMDKdLTIGOJQWAZXVPBcHYRCUSgaFeEb,VECABFDBHAFF.RFAFCABEUBAH..SEACaHAEFBFG.ECHH.hAAA...fGGAhABAMIFCDCCGKAAF.TFGGhADAIHDG.JDADAFFBZDDCcBGE..hACA.eDDE.dFGF.hAEA...,1,-14,-24,10
XPMcaDbJQVWTHRegEFdGSBLZAIYCNfKOU,CFFBKFEFUFAFMBBF..DCBAQGBB..TAEBeAEAFDDBhAAAdDEHBBACLCFHAEIF.hAAANBAG.OFDH..hABAPAHDaHFE.JHFE..HDAA.EFHD.hABASBHDIFHB.hACA...,2,-29,-22,7
CfgTMbKSXEUHIDNFJWAPVGYZcRBQaLeOd,GEEDZDDARFABBCBDQDACLAAAdGAA.CHED....TCCDhAAAMAHBSCEGhABAUAEBDDFEFABHAHHD...YFCDhACAaGCAeFFD.fAFGKGHH.EEBGIAHFhADANAIE...hACA...,1,-4,-31,27
AQOIZbVCTDWFfLgPGdJUMNXKaeRESBYcH,QCBAOACBZFDE.CAEE.DDAFFAAHLBFD.GBGAJFCFUFFChABAMABDKBHF..eFAHhAAASAGCBEBB..hACAYFHBADFF.IEDH...hADA......hBCA...,2,-44,-17,27
gPUMCRSGKeALZdNQOcTEaWIBFHVXYJDbf,dCDGQFEBOHBG.EGHH..aCBHBAHBFDFBHAFGXCBF.DDEAhAAAfFGEUCGAMHBGhABASAECKEAHLADAhACANDAE..TABEIFCEYFCA.hAEA......hAFA...,1,-11,-20,9
FIWAXLUEVJSRbfHMGPKegdBYQCaDNZcOT,XACDUGDGEEDA...JAFBRBEAHABE.MDAEKAAGeFEBBHFBCFBGaEHFhAAA.ZEAF..OFFGhAAAIGGGAAHD.LHAGhACASGAD..fDDD.hABAgCGC.hADA.dEAFDFFE,1,-16,-23,7
OPMIAZQafGYHSJWBeLcdUbTgXVKCNEFRD,aGDDGFBHHAGFJEHHBGACLCADUCDG....TDAAXCDDhAAAKAAH.ECBHDFDA.OADAhAAAPABGAACH.ZCFAQGGBhAIAfAHESDGAcGGH.gGBAhBDACHCD...hAFA...,1,-9,-19,10
HASCOgLcRYBZEbTWUPFGJIKeaNdVMfQDX,CAFDODBCLEFERFEEBHCAZFDC....TCAAUABAFBHH.GAEChAAAICHB.eCEFhAAAaFHDdGAAMBAG.DFHBAIEC.hAEASEAG.cGAEEDGD...hAGA......hAHA...,1,-22,-27,5
UHDIPFGKgSaEYbfOQVZBNRLceWXJMACTd,dAEFHCEBDDGCFECBKGECaEHB....EECC..fBBCQABDhAAABBHDLHBCeHAAJADBhAAAMBFBAIFGCFAA.IGFGhABAPHFESDAG.OFFAhABAZAFH.cAGD..hADA...,2,-29,-14,15
UWAOcgNHPSFYTDBQLfaJIeMECGRbZXdKV,ODGH..NBIGHDBFFGCCDICEBBEGLBEAJBGB...IGABhAAAEFEBCDEF..RGBCZAAGhAAAKBBCUDDGAHHA...hABAPFHFSCAHQDAGfAFFhACAMABG.XFFF.hAFA...,2,-32,-19,13
ZOCLHABINMebYSWgTadGUEFfPRXDcVJQK,BCDHMEGH.eHAG..bAEBSBCF..TGDAdFGDGAFAhAAAFAHBfBBDhAAAPDAHDBBBJEBCZDCECHHBAFIDIHFEhABANBAC..gGBFaDHBRFBC.cDDFhABA....hACA...,1,-5,-26,21
bHgDWEQBRSfZeacYCJAUGOIVdKMFPLXNT,OFEAdHBDKAEEFFEBLHAG...XAFHTCAHHCCFDDDAECAGhAAABCHD.RCFDZAAGaFBECEBGhABAAHGD.GABF.MEEGhACANEIA.....WEHHfAGFhAAA......hABA...,1,-14,-29,15
UDKNcLbJSIWZEMVeaATYgdGCfBQOPRXHF,TGAGdBDHCCGFBAHD..ODBERFAD.HBAGDACG.KEFALFEGhAAA..JHDESDDFhABAWADB.MHEEaFDBAIGGhAAA.GAGGQDGD.FBBBNAFGcGGFhABA.....hAFA...,1,-10,-36,26
QbgNLcIPUYSOTRGCZdDeMaHJEfWBVKFAX,QDDF..bGBGLHEA.IAAGYBCBOBDGhACATEGDCHCBZAGBDEAFeAAChAAAMFAA.aCFHEEGAWAHDhAEABDAG.FGAGAIECgGGGNGEH..hAFA.PFBASCBBhADAdBEF..,1,-5,-21,16
VMHEcGAbKNSQadUTJWIgLeBXYRZOCPFDf,KBAEQDABUGAG.JFFF....IEDFLAFBBFHGXCGDhAAARAFB.CDEDDACGMHEAhAAAHBCDGCAHAABDSFCGhAHAaHDC.dHBFWAHH...eBEBhABA...OACGhAHA...,2,-31,-16,15
OUCSZXbVYaMcHTKgRQWIdFLPABNDGefJE,BEHFDCEAeCADECECUGBBZGDA....XBBCVCAD..aFEGHEDEhAAA.KHAGQAAHhAAAIAGGFCHBLAFChACAAHIB.GGEDJABASDDC..hAEAbDDC.....hAFA...,1,-8,-25,17
BbcJIMZXSKHGWFOEgQCUPaYdeDfNTVARL,LGBCBHHEJCCH.MAFBZGAA.KCDHGEDE..ODHBQAEDhAAACEBBUAGG..aGGBdACEhAAADACGTGFDAIBG..hABAbBAFIEFE.SBBDHCGD.hABA.WCFD...hAEA...,2,-31,-15,16
LNWHJOZfMaRXGSYIbCKgUEQVPdFAeTcDB,TCABDBHBLFFD.HEAEODDGZCBCaADERECESABA.hAAA.IHAECGHCKBGHEDHFhAAAQDGBdGAHAICA.hABABGGG.NCCBJFDDfAEGMBAD.XGEHhACA....hAFA...,2,-27,-9,18
RNaIcXMLdZBbSQPeGfYCgKEJUTWHVFOAD,DDCHRFAC..aDBAXBCFLBFBBHBD.QCGHGADGCCHDEBBAhAAAUAAGHFFEFGFHODEBhADAAHIH..NICHMCADhABAdAGFbFAG...SGGBfAHEKBEB.hACA....WFFEhAEAIEHC.,2,-13,-5,8
ZfWFRHSCQJMBTGPOENgVebLKaXDAYIUdc,UBCBdDCHZCFFFGDGRFDBHADE..CADC.QFAFMIAG.BHCFGCFGhAAAECAC...NABC.gGGChAAA.eAHDhABAKHGADFIFAIAC.IGACfABF..hAFA..SBFChACA..,2,-41,-11,30
deBHFOLJXbQPaCYSMEUGRAcIWKZTVfgND,..ICEFKCCCTCFB..VDBC..NADDDFBGBBAF.FHCEJEDAhAAAQAGC.hABACCAASGGDhAAAEFGAUGBEAHHFZACCdFAGOEFCXAGAaAECMBBD..hBAA......hCAA...,1,-19,-24,5
bRgBeYMTFVHNGWIJZOaUAcEKdXLCQDSPf,KFADdCDELGDGCBAC.DBFHSFGA..fAFDhAAARADBBHFFMHBEFABHNDIGGCCAhAAA..JEBDaBFDAHADEDAChACAXEFG..QEFHPCADgCGHhABA..hACA...,2,-33,-24,9
AOUVfQdIDLYeBFKNgEcZMXbaPTHSJCGRW,UCEDQFBCDABFLACBeBEHKHFG.EAAGMHDE...aFBHTEFDhACA.JCCHGEGGhAAAABIBOFHFdAEHBFCHhAFANADDZBGH...PAHHCBDC......hAIA......hBAA...,2,-29,-9,20
HTNQZVCOJRcdWEFDXLfKAeaUgGMBbSIYP,UFDCMGEABCGH..bCBFSEBB..IADEhAAAHBCCNHEHZDDAOAGB.JHAAhABAdFAGECADDAIBLFGFhACAKBABaHAE...YAEBPAEA....hAHA......hAIA...,2,-26,-18,8
HZDPCFTBISOfXWeMKaLYGEAVgJRdNQbcU,VDAHRFCCdEHE..QBDFUFEEHGAGZEAFCGGB.BAHH..SACGhAAAXABB.MEIHaBBHLAFHhAAAGCDHAADEgAGAhABANIDH.DCCC..FEEA...hAFA......hAGA...,2,-14,-12,2
ZaUgcTCLAYKSeXNfPBdIJWHbFEDRGQOMV,KADDXEFB..fGHCdDAF..IFDFJBEBHFAHEFHHhAAADFFCRBBEGGABMBBBaGEHhAAAUAFC.TEAEhABAAACHSDDDNDEBBHFHFACAOAHF...ZAFFhABA.CHCG.....hAEA...,2,-22,3,25
BRaIcQgUFWSdDEJVNLXAPTfZKbOCYHMGe,TEGBKAFECAED..HECCMABFBFHB.RABF.aAFA.QFDBhAAAFAHDdHGF.DGIBEDGFJEBFLGCAhAAA..XCEFhACAAIEAZDAG.OHDE.eAHH...hABA..IDDDhADA.cACD.,1,-11,-23,12
EdKRAGLbeITCcXPgUWQVZDFBMHYNOfJSa,GEBFLCAAeACHCDEH...XCEDUGDHQEACDBEGBHBHMIDGhAAAHAFHOAAChAAA.JEFGaBBBKGGCAABCICGEhAEA.TFGF.cAGAWAHHFHAEhACAfFAEEEDB.hADA...,1,-14,-16,2
AGRIMfJSLNCVEdXcQHTZBFUObYPgeaWDK,RGBCMDDE..SGFGCDAFdGGD.QDBFTEEA.ZABCBBAAhAAAOBGF..PFAFhABAeEEEDCAAKAFAIECEhACAfFAD.NBIEXAEFFCHFUGCC...hADA......hAEA...,1,-12,-30,18
gPCEYNLIOeRaMcUfGbBWSQHAVKFZDXJTd,FBEBDGAH..JDAFTGCG.dBGHCHCC...EEGALBCC.eHFChAAAaFAGMCDDUDGHGEDGhABABHHBQAAGhACA.AEFDKGAHXDCFgGEHNACF.IDAHhADA...hAHA...,1,-14,-35,21
MeONgLdHTCFAZVfWGUBYDcIQRJXSPKbaE,VCAEGCBC.BDGHDFGC.QGGGRAEF.SDDHKGCDEGGFMEDAhAAAeAAE.OFEDhADALAHFdAGECFADAAED.WCHHhAEAUGDC...IGAG..XBDEhAFAaABG.NIAB...hAIA...,2,-24,-16,8
LdJTRZMPHWCbSfQcXGABaDYKNgEVFIeUO,aFCEDIFEKBEF..EFGDFFDEUDAALBAB..JDDARBFFZFAFHACE.hAAACAAC....fGADhACAXACBBAHChABANIDF...IDHGdDHCMCEC..WHFEhAFASAHB..hAEAcCCCAFFF,1,-26,-37,11
GLCESVBfcAaHWYOFbPTXdUJDKgeRNZIQM,HEDAOCEDFHAG..TBAHXCGH.dBBEUAGADEBF.KDGGeDCChAAAZEBCMFAHGAEDCADE.VFGBhABABFHCAICC..aADHbGDAhAAA.....gGBFNCAGQGDFhACASDCC.fABBhAFA,1,-3,-18,15
HWRUBGVJcANLZCTMbPEYXKeDaOQFfSdIg,ZFEBMHDGEAAFKAEH..DECHQDDFFBGD.dAGGHBCEUDAGBGBDhAAAGDGEJCADAIGGLAAEhAEA.CBBF.bEDF..hACAYHBAXGGEaCCASAGC.hAIA......hBHA...,2,-21,-15,6
HdZWMERGXPJKeUafYQCNLIgSDbAVTOBcF,OBDHFEDHHCDAdCGHZDAD.MIEGECBBGEGC..PADEKHCEaADAhAAAQAAF.hABACGFELHAAIFDADGBFhACAACHHBEHAWFFF...XAGF.hABA......hADA...,2,-19,-19,0
DdHfKBSPLWGAbYUaRXcgIJMVEOTCZFNeQ,UGEGaABG.RBGH...XFEF..ICDCVBFD.EDAAOCCBhAAAZGAA.eEHBDFBAdAFEhAAAfGADBBBE.hABASGGFPEEC.GECEAIAG.bBDFYEHBhACA...hAEA...,2,-27,-18,9
TNQWMKDdECXZARSOPcbFJHaGLfBUVeYIg,OEEF..PCEEFCBDHCGHLABHBAGHUAECeHAEIAFEhAAA..TAAFhAAANEFE.MIFGdEBGEGGDhADACGGHADEDSACBJEHF..fDDEhAEA..gEBAhAIA.,2,-34,-15,19
BYNUIAaKObfGPSgcWRVeJLMFDXTQZdHEC,aDECOEHDGGCD..SGEG..cADEVAFDeCDDhAAAMAAHDDDHQBAEhABAdBGACBBBBDBDNIAD.UGGChABAAGFAKEAFfGACPECBWAHH....hACA......hADA...,2,-19,-18,1
EVSfBQACcIYRUGTgaNLJMPZDXKWeFdbOH,CCHD..IEEAREDCUBCA.GGCF.TACGaGGCLBAB.hAAA.PAFADIGEKGAFFFBChABAdECGODEAHAFESEHDhAAAfBBEBBEHAICA.cGGE.hABANBIGMEAH..XGDEhACA,1,-20,-24,4
TUgBJCPEFbNDIceYdHXQAMWfKaSVZOGLR,MCHBKDCA..SHACOADEGFDBLCGBUBAFJBEF.CGDE.PHBEhAAAFDAG..DFIHICEGhABAeAAE.dEEFXFFChADAACGBaDCDZEAB....gAGEhAEAEAGG.NFAF....hACA...,1,-11,-21,10
EafAUJHTPWBeNSVZLGCRcXFOMgbIKYdDQ,JECDHFBA.TCAEBHAF.eAEH..VCAHLAGBGEEGCABEXEFGhAAAFAFG.MEAFhADAIHGHdEHEDGGHEACBAICGWCCBhAEAZBGD....ODDG.KAAD.hAIA....YDHBhABA.,2,-34,3,37
TbfVgaCdSBNMGFeRXOQPUDKZWYLHAEIcJ,EFFDJGAE.....bACEVDFF..CHAGBHCFMEIBGAEFFECGRDGD.hAAAQCAFDIDEZCCALBAFhABAAAEE.IBGGhACAfFDB.dHDFNGAD.eDCC.OAAAhAHA...KHGA.hADA...,2,-22,-8,14
EfHUMbQARDLZGNaSeVJCTKgXFdYPWIOcB,DDEFGEEA.SBFFJGDEKHAE.FHCAdCBG....PCGFhAAAOCDABHGCHDFEMDAFhABAAAFBZEACeBBE.TEBBhACA..gAGD.XAAGhABAIDDEEHFCfHABhADA.,2,-28,-26,2
LSVGTHAdQWKIDfXcMUagbCNeYRBZOFPEJ,QDGBKEFEDIEC...XFEBUDCAaBAFCBBF..eCDHBHHCOCAEhAAAFAHD.EAEELADEhAAASHAGGFDHhABAABAFIHHCMFBH.bAGFNCAC...YEBHhABA.....hACA...,1,-2,-36,34
BeQcfaLOMgVKWFXRHGdPENSZJUYDATbCI,TCAACHCDBBCC...QEBAaAGE.MAFDKGAHFDFDHFFCdGGCNIDBZAAEhAAA..UDCFACHAIEEFhABAeAAB.fGAEhACAOGCA....gADHhABA..WBGD..hAEA...,1,-15,-38,23
fONJBReEHCWGdSaDVTLFYPUIAbcQZMKXg,QGFAZFEEKCGE..XBDBOEBFJEDBBABDRCDG.HEAGGAEHhAAAdAGFDADALEAD.hAAAFCAEPEEAACIFMFFA.hACAfACHeFHHEHBCCCCA..aHCE...hBAA......hBHA...,1,-1,-20,19
OPBMCKJQDTdNRFeVGHZWUEYcIXAbgSfLa,SCFFaBBBBGEB.KFFHQGBH.DAFFNIDBFBAEGDBDHDDFhAAAZAFDUGADEGHD..IADChAAAADHB.bEFEgADFhABA.fEHCPAHDMCABhABACFBCdDAB.RAFG.WHEG.hACA...,2,-17,-2,15
AEZbdTPDSLGIBeQaRJCNgFKcfVXWOMHUY,EEFDdDCDDCADGCBCBHBFeABC..RFGH.CBFHFHDEKGDG.....fBAGhAAAXCGCMBAChAAAHDGDADDG.ZGAGTEAEhABASAFE.IHHCaFDAJBDGNICD..hACA.....cAGAhADA.,1,-5,-41,36
XYaGNQTZJFKgcbHWLfRMDIESVPeBOAdUC,dAGBXEFEaADH.GABHQDGHZCDBFHDAKCBG....bAFDLFABhAAA.MEAAhABADEAAIFABVFCFBHHGhACAAGIFCAAFNCFE...JCAA.cGGCfFHEhAEAEHBESAHH.hAFA...,2,-20,-9,11
RVaCASIeFgXEfWUYdPZTHBQDGbcLOMJNK,SBBHFDADEECB.UBGAdHEBZAACBEHEQDECDBFH.GBGChABALDAA.OECEhAAAMIAEJADAKGGCaGABCCCGAFGH.hACAeGCC..fGAHPACG...hABA......hAGA...,2,-32,-14,18
EIZWgfMFdUYKVQABDJbeTHRSNGOXaCcLP,DGCFeCFCRBADGDEBOCAG..CAGC.LAHD.EDCCIFGDhAAAZFGD...fECHhABAMFAFFAEBUFDEKDHBAFEFJHDGhACA.HADDSAACNDAAaHBG....hADA......hAGA...,2,-17,-12,5
UBZMgObHCeQALEVKNDSTcGWFPJfIRYdaX,LAAFEBBAKAFF.SBEEGEFGFEDHJCDA..RCEAdEAGUFEBBHHAhAAAMAIH..OHBEhABACFACADHH.DAHD..TDBBhACA..WDCFIHCFaEHF....hADA.....gGAFhAEA,1,-29,-32,3
JPMTVfHOdWFSgYXAUEbBDGeQcCRaLZNIK,UDCCBDBGGDGAeAHF.CBFGLCDFZAABKGCF..MCCG..TABGhAAAHFEBdEAESGBBhABAXEGAAHAEDFAEQGGChAAAaGEF.IAFE....hADA......hAEA...,1,-17,-32,15
TCdBbXAgGFWcDNHfUEIKZLeQJOPaVRSMY,FBDFDEAAHEDHEHFA.ZACAeCHBQFAG.OAGFVAAHMDFHhAAA.CGCF.dFGEBFBFACCAgBADhAAA..hABAWEACNCIC..fDEBIEGAKGDG.hADA......hAEA...,2,-32,-19,13
EMgJHebNFSTKdWDGIXOcCYQRVUAPLaZBf,aFGAZFCABAAH.MDFAJEAGHAAE.eAHDFBDGKAGGdFDHGGEHhAAA.OADDCFACRGAGAACFLEEAhAAAEGBH..NEEFSCAAhACADDAC..IHGB.hADA......hAFA...,1,-8,-43,35
WKeCaHYOPNdVFMADBfXSEGZQgLIJTcRUb,DABFBABE.SGGFZGAEQDBDLFCE.JCHDRACFUGEF.hAAAKCFAaDCCHAFCOAGBhADAdEEDMCIFAGEDEBEH..IFAHhAEA.........hAAA......hACA...,1,-24,-29,5
TBdZVcgUPRKJEYNCaHefLIGWXDSQbMFAO,BDFCZFBF..VFDDUGBAKGAFJBDH..ECEA..CHEGHAFGLDAEhAAAGEFEDACB..QBGGhABAMAAFAFCC.dHGB.hABA.PDHFNEEB.aCBDeFFG..WFAFhACASAFC..hADA...,2,-27,-17,10
KfQJOgHaGePXbNWEYMCTdIcFSDVRUBLAZ,ZAFEKCDBQCGDJEAC.HCBFeHCCXAGA..WCBEhAAAEHFCCACA..dFEFIFHEhAAASFADRFCALFABhABAAACBOCGDaCAB........hACA......hAEA...,2,-42,-8,34
IWXNLaPeHAbfMTZRJDYgSUVCcOBQGFEKd,MADFZEAGRDGDDICG..SCGGUGGD.VFGHOBAF.BGBAhAAAFHCEKEEF.dEAF..hAAAXGDAaAHBeDEGABIF.hABAfCAD.TFAFYADE.hABACBGEGCCF..hACA...,1,-12,-35,23
fJGMVBTFSQLdHEgbXYADPcRKZaUeCIOWN,DGBDRBCDKABFUCEE..CFFA.OFFC....NFAHGBGGMBBEBDAFhAAAFBEG.LAHDhABAHGAAEDAEXCCG.hAAAAHIDZFBHeGCE.IHGAJHEG...SAGEhACA..hADA...,2,-29,-25,4
WLXKYFIQTPMOfedaHCVEJGRNDUBcSgbZA,XBDAFEBEQEEH..MIDAeBBGdEEECGAD.JEHHRBGD..DADGUEADhAAABHGCSBGAhABA.ZABGWFHHKGAA.hACATCAF.fGBDaCCC.EAFFNDGC.hADA....cGDEhAAAAHHB..,1,-21,-23,2
JSdMXaIfUCAPYTcNKGBFQZROWEgeLVHDb,TCDGKDCHFGBGZBDC..RFEHOCFD.ECAFeAFC.VEGBbAGB.hAAA..JAAGMFAG.hAAAIHGACEBDAEFG.cACDhABA..BEEDgGBADIBE..hACA..SHDEhAEA..,1,-20,-39,19
ZCRWEfLNFDaYAKHgUIdSGeXcJOVTPbBMQ,HBAAUBFDdABFeFDB.JAEFOFHH..TCGDBFFHMAEFZFFBCBGFRDBFhAAA..ECBBLHAEhABADFEDAAID.IHHChACA.XEEBPFAF..bDDGWDADFHEEKDHHhAAA......hAFA...,1,5,-30,35
bKIZVaHcYUeSTDfPLREGMJCOWBFgQdNAX,XFEGKAFBZDCDHFFEUBEEeDAH..SDHHDABHLEEDEGHD.hAAAMCHDOBAEBHAHQDBGhABAAIEG.IGAAhACAaAEH.cDFEYAHH..fGCEhADA..hAEAPACH.,1,-13,-19,6
LDNacdbPREHYOIVMZBfTGASFgWeKXCQUJ,FFDHeDECCABE.UADDLBEBDDID...aAGFdHAB.RFFDHEAG.OABFhAAAIGHD..hAAAMBADfCGGhADAAFHF.gFAHXAGH.NICB....PBDBhAEAEGEB...YBBFhAFA,1,-25,-26,1
FHRQCXNUDaGMEYALfWedVSPcbKTJOgIZB,LFAAeFAHdGGH.SHFC..PBAHKCDCODHDZCDDBDCHhAAARFDFCAAA.XGDBhABA.DCGBMIAAAFAH.WADChAAAbFBD...gBFBIDHAFBBANACGaEEAhAHA......hAIA...,2,-30,-18,12
bAZCXNEKGJQOIMSYFfURHTLgcDWPVdBae,CDBHEABAKHEEGEAA.OHDGMFAG..FEEBRBDBHDFDLHACDAFF..hAAA..PAHFdADBBCAFhABAbFGD.ACIDZDGH.JBDBhACASBAG.fDBBTAGB.hAGA......hAIA...,2,-32,0,32
QTSGbCEABKHaNgFIOUPfcZXLeVWMdRDJY,BHDCHBEHaEGCFEEAUGGC..fHGDZFBBLBDEVGBC.dCBHhAAADADEJEAD..QCADhAAASACACBBB.AEDHNAIChABA.OFFB..PBHB.eGDEhABA.MDDC...hACA...,2,-26,-11,15
OJIcNEbCYMZPUHRLTBXegfDAVadFQWKGS,VECAaFGB..dAHGFADDQGDDGGDH.OCCBJAGD...IBDChAAAEDAGCGAH.ZBFHUAAAhADALEADBCHA.eFCFhABADIGCAIAGKEDE.NEIC.MAFD.....hACA......hADA...,2,-26,-12,14
UKDBWGHCTdEJIAOQLXFPaeVbcgZRSYMfN,QFAHLBFEFBAAaCCGeDDA..VFFC..bACHZAECSGHBhAAA.fGAAhABANEDBKBAHBFCBHEAChACAdAAFIHDCOGCC.PCEC..cGFFhAEA....hAFA...,2,-17,-16,1
EXaDFKYfPTRUOCdSbWAVBLgMQHJcZeGIN,BADEMFAFHGFAJHEE.ZEFCGAFCECDH.DDIFKBHB.....PGBChAAATEDEOBFDhABASBCGAEEFLACChAGAQFBHIEBDXDBCFBBH...fAAGhABA.CAHAWFADhACA.,2,-48,0,48
daUKbZgCcAMHJXSfBGOYFIRNVQWTeLDPE,JEAGXBGCBDFD.GDBD..FCHFIHACRAAA..QFCHhAAATGFALCBChAAADGGCdAEA.KEHFZGFACFAHABAEMFFChABASAFF.fFDANIBB.hADA.eAGFEACG.aDCA.hABA...,1,-21,-22,1
RSNDbLPaABcMEXUZQeFCOVgHITWdYGKfJ,MFAFUBCCQEFGFCHF..VCDDIAHAdABHKEBA.RGFC.DBFDhAAALGBCAHDBBDAFEBGBhABAeAEE..CGAAHECChACATCAE...YFFEfEAC.SHEChADA.NCIG.hAEA...,1,-14,-29,15
SBbJdOHKTWGgDMQPaLXVYcNCFEZUfRIAe,eCHFBAFBJBEFHCAB.KAFBGDGGDHAE..QFDCaHCC.VGFEhAAA..NGCFCAAGECCGUDBBhABA..fADFhABAAIHGdAHE.TDEAMCAF......hACA......hADA...,1,-12,-36,24
ENCUZOQFDAgfPYKLTGSdaVRBMIXbeHJcW,...PEFEKFDALHDAGCBG.dBGEVBDCBDCH.MACF..hAAAIHGGXAEBeHBGhAAAHDAF.JEHDEGDECBAD.hABAOFABDHAE.ABAEfCAASDFG..hABA.aGGA....hACA...,2,-24,-19,5
DIKEXCPFWgbOLeUQYNHaAfSZcVGTMdRBJ,ZCDHGCBBMHCGBEEDDFBG.EFBG..CBGH.FDHD.....bABEeAADhABAUAGGNAIC..AGHH.SHGChAAA.TGDGhABAdDAHIGADKDFHPFABWDGF.OHEEhACA...YAFDhADAaCAH,2,-46,-22,24
VaXZBJFcNYDAOKUERCGbefLWdSHMgTQIP,KEHBUCAFEGHDCHAG..GFAHeEDGLBEA.dBAFHBEE.MFHFhAAAQFADIDHGhABAaGGHBFFCJDFENIBBABBB..hAAAbDDC..SADF..PAFGhACAXFDGZGDE...hADA..FCAD,1,-2,-17,15
aCLIJFMDPAXHEYVWBcRgfQGZdONTKSebU,EGAFVAAGBBCG.RCDH.QCFDGAFEdDABOFAE..NEIG.SDCEhAAA.eFFEhADAUGFBCHHGLHBChAEAFACADFBGAIBG.YAHH.gGEBhAFAfAAA..KBDAIHDEhAAA.,2,-35,3,38
VOJYfaQGECPWSeKXNBLFHgDMbRTIUZdAc,ODFCJBFF..aGGFEFFC...CADH.SBDFKAAFBDDHHCAEhABAMDAB.RFDB.UAAEAAFD..hADAVAGHQFEAhAEA.PAHBXGAEFECGDEIDIHGGdGBB.hAFA......hAGA...,1,-22,-23,1
WKJPgfYVERNGAXIQTbFSBOLDceCaZHMUd,QCCGTEGH.FEABOFDHLAAGDBFFCADEZFCD.HCFCUCAGKEEChABA.JFGB..fGAChAAAEFBH.NIEDACDGICAHhACA.BHAGeCFHMFIF..WAGBhABA...YDDHhACA.,1,-4,-43,39
QbJKXHEeNfLagFOUWMCZDVRcAITdSYPBG,TCGGdAAESEGF.BEBAGGEFQBDGbBDCKHBGEEADeHBChACALAAFFAGG.OEEEhACAMFIDCHGHDAGGRFEBAFABIDEBhADA..PBHDXCBHfCBFhADA...aFBEhAEA...,1,-1,-19,18
RYcEXAgbaSfFPTOKHWeDUdILQGMBNCZVJ,aDDDFFGGODDGHADGeBAD..dECEQFFHMAAHBCHECBGAJCCDRFAB.hABAEGAHACBB...SHDGhAAATGED.DAGGIBEGhACANBIC.......YAEChADA...XBBBhAIA,1,-21,-29,8
GaMDJeKWZEPcOHIQYXdFgVbfSBRCNTULA,MABHDCGBKFDAZACH..EFHBOEFC.HFDHQCAAdAEEFGGF.VGAAhAAASEBB.hABACHAEUAGDAACCJAEGPHEGhAEA..YDFCgCDBBHCDNAIC..hAAA......hAHA...,1,-17,-23,6
QLHeOaWGTRXEcAJdBSNZCFUIgDbMPVKYf,BGBDSDGHZDECCFCB.UDCA..DCGEMCBFKACC...QCEGhAAAHAABeAEAaAEC.TABFhABAEHDGADCG.dGGHFFFBIGAHhADA.gGCG...hAAA......hAFA...,2,-44,-9,35
AVTZPbCgQfNLEOcFdXRKUHYDGWBeSaMIJ,TFFGZFABCCCF..QECCLCEFEDFCFFHD.RBACHEABGACHeAEGhAAAMHCGAICE.....hABAPEEGfDHAhACANABE.dAHEKAHFDDAH..WHDABHHA.aFDH.hAAA......hACA...,1,7,-26,33
aBZeMgFKDCdSTLUQRfYVcWPEHNGXIOAbJ,aGGCeDDH.MGFAFCECDHDAdCCELBGD.QBAERFAEVABD.hAAA..PHDEEAHDHEFChABAXFABIDAFhADAAAHCJADEBAFEKCHHCHHGSDDG...hAAA......hABA...,2,-19,-11,8
cFPgBDVRMJUZdAXOIEWQSYHGeabLfCKNT,OHDCEECH..SEFAGAFEaFDBLGBGCADE.KABCNCBC.TCDChAAA..PAAEhAAABCCCDDGCRFEG.MEIFhAEAJCCBdFHAIAFD.WBFA..YFAFhAFA....hAHA...,1,-23,-26,3
KXGBMaHPOECZJLfgbDNTcIdQAUeRWVFYS,UDDBeBEERCDFFHDE..SFCBGAAABFAGMEIBHBFH.EFGEJBBBhAAA.LEGF.hAAAfHDHDHAE.hACATFAAIDHDAAHA.WADCKACEaBABCHHD..hABA......hAFA...,2,-29,-17,12
TOPfGZBcXNYSIgdWEbAMJLQUaVCKeHDRF,MCIDQBDCUBAG.aHECKFAC..DFGBFFGCOCBDGGBB.BAHHhAAAXCGE.NBAA.SAEFhABA.dEDDhACAEAGBAHHC.VFAFCDDB.eEEC.....hADA......hAGA...,2,-33,-15,18
ALZGWSaYFUPCdIEDOcHTfXBRgVKbeQNJM,ZBECSBBAFHAGUBBGCBHG...dFHEEEGA.OHDAHDEE..XDAGhAAABEAERDDHKAFC.eAAAhAAAQGDEMECBAHIDLFFGhABA..aAGA.YFBEhABADIBG.fGFHhACA...,2,-27,-16,11
BJZDEUdOGbVYgQAWfcaXSCTIeLKHPMFNR,...fBFGaAGGSGDACAGD.eCCDLFDFHACAMCADhAAAFGHBRBCDJFFFEHFA..dDGFODAFhAAAGEAG.YFFChABAAGEHXADB.IABDKDDE.BHAEhAHADBBB...bCGH..hAIA...,1,6,-23,29
BZQYPSLKRAUfCHDgIOGVJcTedFMXEbNaW,UDCGHAFEDFDAOFHHJBBA...eDABdGDEMEAHEFFF...aGFGBAADhABA.QGCHhACA.SAFAhADARCEGACAECHCFIEBBcCGFFHFENCBB......hAAAYFAFKADC..hAEA...,2,-26,-25,1
QWTYLeVdAUaKNEMSJHBOgRcbGIfXPCFZD,aDEAKCAEMBBCHDCDBCBD.REAB.GBEB.IFAEPDHDCACAZDAChAAA.DFFCQAEHhAAA.TGGHYHDEhABA.eDDEAAGCEFECSFBHJHCC.cGGAhACA....hADAfAHA.,1,-6,-15,9
AdBORPHMUbfDNSEGFTWgKZJLeXIVYQaCc,BHFGOFAERCECHEAAUBAF.DAAF..EEECFADD..TFGHKGGBLBHBhABAeAEA..XBFEhAAAIHCEQGDDhABACEGD.ADFGMBDFNEEE.WBHHJBBF.aDAD.hACA......hADA...,2,-31,-6,25
SWXIFaUBLdVNTeREQKAGbfOPHYJgcDMCZ,GBEBOBFFHCBGJEFE.DGHFCAHD.ZFAF..SBAAXFDHaACChAAABEDC.dGGB..NDIE.hABAREAHEAEAAFFC..fAGDhADAPHDC......YAAEhAEAMECH..WHDA.hAIA...,2,-31,-15,16
YJNFEUKGPACeZbQOWBgTMSfRXDHIVaLdc,eDEFQEBBOAFCBCHE.MHDCSDBFRBBGHEFG.aCEGLAFDhAAAdFGCJHAG.FHACEBBGKCAFhABAAIDC.CAGH.ZFAG...hACAWAAF.......fHEDhACADIEAIHHB..hADA...,1,-13,-19,6
WFdOQNZKJAcYEaVIeLgSbXPfGDUHCBTMR,EDAFVCGDLFCA..SGAEXAACGBFGHDCFBCAAhAAARDCCFEHBdHBHOHAAZGFCAACFaBEEhABAICCDeAECgDAAhADAfADGDIDECEEE.MAIB.QGGBhABAKAHH...hAEA...,1,9,-7,16
LGbdCHXFVYEfOcKQTUSDNaZPJWBAeMRIg,eACFMAFCREEELDFB..GCAFdAFDXDCHVBFE.EBHFfGHAhAAAKHGA.QFBAhABATBDHSGCGhAAADBBCNEAE..aEGAJEAHAACA.ICAFhABACBEF......hACA.FFHF.,2,-15,-6,9
VNGUcRHWdESPJTgIBbKQMAFDXCOaYfLeZ,XFBFOFEE..aDCALBDEZCFE.GEGGRACAHBAHdBAAEGAFPAHFhAAA..JBFGgCDAhABAIHHGKECHhAAAAHDCCFEAeHAG.NACH........hABA......hACA...,1,-2,-23,21
gIeGWNMcVJCZYDRESdXfaOFKPTULQAHBb,HGEABFAG...gAAAIBAEGCAHMCFE...VECEhAAACAEDDEEARGEA.EDCH.SGBHhAAAXCGBOHAAhABAFFDGKAFEPDABTAEF...LDHBhABAAEID.eCCEcFGA.hADA...,1,-6,-17,11
QWLZEeBMXPaSIDYKcgJVCFNTHfGUdORAb,QGDAZCBHEDGFBEEAMCBG..aFHHDBIHKEAFJBGH..FHBATEBHhAAAHBEA...fACHhABAdACHAGBELAAFhADAeHFGXDEHIDDC.cGAFCHAD..NIEB.hAFAOCAB...hAGA...,1,-11,-18,7
NLHSDcdGXATJeKZIYRFBWaEMbQVUgCfPO,JDBBZBEDREGFBFHD..EBAD..MBCAQFAAUDED.CGEFODDHhAAALBHH.DAAAdDADADAE.hADAeAHD..IHHHhAEAYBBC..FHDAaGHD....bCCBhAFA...fHAHhAGANIAD,2,-45,-24,21
cVAWPQNaJRSZfEHLeGdTMIYBFgUCOKbXD,QBEBJBACZFGF.HDDBLAEDdADBTAAFMGDG.BFHD.FAHFhAAACGBCKDFADIFC..ACCF..hAAA.PBFGNHEB.aDAAhABASGDD.fCAEeHDA.hACAIGAC..hACA...,1,-25,-29,4
JODGWFBUZaAdPMgRCbNKXeIfSVcTHYLQE,MEFCCCGDKCCA...eECG..IHGBSBFC.TGGBhAAALHACJGCCDDCCGCAAhAAAFBCCBHAGaECEdEGDPCABhABARADEbDED...fBHCcAGA.QFAAhACA..EABDhACA...,1,-9,-23,14
TCUHPFVKedOBcRJZEMbGLfDIWaSQXNAgY,TEGAUGGDFDDE..eDEHBFCERBBG.ZGBEMHCALCAA..fAGBhAAADFGE.IFCChABASBGDNDACAGGBCDBAhACAHABA.KEACOBFFEAHB.bFADaGED..hAAA.XFAG.hADA...,1,-16,-21,5
gBAYfHeXdIcOEaGJZQRCMFDKNPLTSVUbW,HECGeCCCdHEBOGAEEAAC.JBCFZEEE..QFGERFADFAHH.DAFBKAEGhAAALCAD.SDGFhAAAbDAGBCGGAFDDfCEEhABA.IBGCaGGACHHG.MIAEhACA.NIEB.....hADA...,1,-18,-19,1
eYPVLHgOIRCMFGNcSaZBTbWKDEdXfAJUQ,QDGEeFCD..PCCFLACHOFFGCAFFMEEFGADFSECBhAAAaDGCBHGETGBBhABAKBAAEDAHdGHE.fGFChAEAAEEC.YCFEHFDDIHAAhAAA..NCBA....hABA...,1,-7,-16,9
DVgBbfXOCNSWPMRLQYKeUJTFaIEZAdHGc,GADHDCAEBHFH..XCBECFFC.SGEGMFCF.QEADhAAAKAEGJEDH.FABHECEFhAAAAHCCHEEC.cCEDhACAVBGB...fHABNEIE.WHEAhADALDAH.eABChABA.aGGF.,1,-3,-41,38
fQDWEPAMBTFYcSUIKZNHaXGVJCdLReObg,TDCCFCAF..SECCKGFGHGBGGAAFJEGH.CCGCLBFDhAAAeGAGOCDA..fFABhABADIACEGDEPAAAhAEAAHIHMBIF.BDAC..YAFG.hADA......hAEA...,1,-16,-30,14
PJMadQVKScWRUfCgEBGAFNOHbITZeYLDX,FFECHGBE.TEDEeABEDAAH..JBFDdAFGQBAESGBBRDGFCEAChAAAEHFEAIAE...ODFEhAEAIADALCCFhAHAXGGAMCBBaCCAKBHHWAHBfDDF.hABABGDG....hAIA...,2,-24,-4,20
WTJEZDCHQIaNKcbdgfMSYLURABFVPeOXG,BHAGFGGAeBDFOGEEGGAB..JDFCEACCZBDFDCFDHCBD.QAGGhAAAaEDDKCAA.dEAEMIEGhAAALFFEAFFC.PFCFhABATAGA.CFAH.....cABGhAEA......hAFA...,1,-15,-22,7
GAOHcUSIMJTbCNdLVZBQXDKEWafPRFegY,HACGUCEEMACFJAGB..CFCHLEFCZGFEBHCADABFKDDB...ECGAaCAHhAAA..REAG.FFGH.eHDGhABA..gEGHhAAAADCHSBHHTGAGbFAD.dADB..XBBChACAfDCF..hAGA...,1,-10,-30,20
GIJUKcOYZABECdQgWeTfRMbVXLaHPDFSN,EFCACGAGdEGA..QDBFeCCA.RFGBMHDGXGDBHBGF.PFAFhAAASACG.IAFGhAAAKBADOAEBAICCBEFGhABAgEEH..WBBD.TBGBhADAfBBBLEAGhAEADAFANICF..,1,6,-37,43
PTJZbfNCUBLgYVIOeMWaDKXAHSGREQFcd,HAEHSEGFEHECFEAEdECH..JEDEZBDA...NCAE.CFGFBHAELHDGhAAA..VBCBOBBHhABAMABADDDGKGDCAFFFQGAEhACA.PFHHTCGA.fAGDhAAAYCHH...hADAIHHD.,2,-23,-10,13
eKELfgFNSHYGZMRdVBUAbIaXWCJTcOPDQ,aDBGCGBB..JEFBOCEE.DIDAeCBB.EDEHLAAA.fGBAhABANBIC.SECAhACAHADHZAGDMBAHhAAAdFFEBEAG.AAHGXEGBWFCH..PHFChABA.KGAFgADHhAGA,1,-22,-34,12
gILYJEDFXAGVbTKPCRHZaMecQfOUBWNSd,VEBFKFDFCHAD..HCBGMAEB..QBFGUFEDBGAGSHFAhAAA.dACDIDHFhAAALFFCECADXBAChABAACCDTAFF...ZBCHcAGAWHFA.NECE..hABA......hACA...,2,-31,-8,23
EAHUQaWeDIbVPCONJXSgRYZKFcdfMGTLB,UCFHaEHB.eBACDDFD....VFCGOECE.JHAEXAFChAAA.SBAFhABARCAAKEAFdGHAMFGHTBCBBAHHhAAAAIDAHCAB.IGAA.CGFH.NABD...hAGA......hAHA.YGCC.,2,-22,-15,7
SKFgPIfQXGdVacYDONJRAeBTbUCMWEHZL,BDBCTAAACHFH...EDFCHCFCLHEASEEFFBDB..PGAGhAAAQFAD.dACChAAAaAFHDAFBOFHFNDDGAFGE.hABAUCAFZFFG.gEEGIHHH.fAHEhACA....hADA...,2,-21,-12,9
IGSPFLOQUEKeZCJaAWMTdDXfVRgBYcbHN,TCGHDFAB..VFEABGCE...bEAFIEDG.GADHhAAASBAALBABhABAUADEECFAKEDECCDCAADGMFIFhAAAdDHA.XGFC.fAGBYHAGNCCChACAFFFA.....hAGA...,1,-17,-23,6
KVJNZbSfLIGDEeHYaCBcPTAWgFRMXQUOd,FFBARDAFMAGHUGEE..dBBFKAFD..JEFEZCAE...SDHHhAAALDDHIHCAhAAADAHFHCEG.CAEEBBHG..hABAPABAACFF.XGAHQGGDOECAhAGA......hAIA...,1,-30,-31,1
XBUYQERTbSWJFNDadgCGLVZHIcePAKfMO,MIBABFHFQBCFRDDF..TDGESFBHFCCFDAABaGGHdAGGhABACDAA.GCAELFEBhAAAHGFGIFAD.hACAeDFCAAFFKAHHOABA...YEDFhAFAWBBE.....hADA...,2,-19,-14,5
XaeYUAZTfMEQDbWNVLJSRdgFHIKGPcCBO,ZCBAMGDCEAGADADF......NFCDLACESBFBdGEEHAAFhAAAKGGC.PEFGCGCA.XEAHhACAaEBBUCGFACFBfHGFhAEA.WAHH...JHAAFAABhAGAIECA.BDDBhAFA..,2,-28,-13,15
dYCcUJAKFMOIHReaDgBNLEXGSZTQbWVPf,MGBEOAFGHCDGRFGB.DAFEBACALBAFGDDEZECAQCFHhAAA..WHECVFBBfAHChAAACCAC.JBCEhABAAABBFCCGeCHHaGED.NEACSEBC.hACA......hADA...,2,-18,-7,11
VcPWJaNfDFKYICOHZGgTeQBEdSbLMUXRA,VABB..PDAE.aADGfCFH.DHBAKDHFCFFCHDDHhAAAZFECgGCGhAAAQEAEBAHFSGGEhABAMBFDXBGAAIAGJHFAFAGEYBAAOADG..hABATDGGdGAE...hACA...,1,2,-24,26
TZIRbYCfgEMBQXUdcLHPeNFAVaOWSDJKG,aGGDOEGH.DEIHKADBZFCFRDCB....CFBH.EABGMBBFBBHA.UGADhAAALHCAHCEEeDAAhADAAEGGSBFE..hAAATAFBIFFBbBBC.fGAG.hAEAXABBdHFH.NAIG.hAFA...,2,-42,-4,38
bRBKZVNJfLTDAEFGQYcHUXdIOeWaCMSgP,EEFBGBGA.QGEBHBCEUEAFdDBFeDEECBCHMBFDSCABhAAA..PEABBABGKHBGhACANACB.JHFG.fBGFhADADICAABBAFGBE.YEEFIHHC.WAAFhAHAaDHD.REDE.....hAIA...,1,-7,-13,6
QGcTVWHCbAfEYeMNKJZLSFPgOIBURDaXd,EEFBMDAHKCEFLDEB.FGBEOBADBABGUBGDDFBEdCCC.QAEBhAAAGACC.VGDGhABACEBBAHAFeFHD.ZEFDSBGAhACA.IHBG.XFAGhADAWHBAfCABhAAAYDGH..,2,-31,-20,11
CHWXcMPNUTIAGYbQgDFdBVSfEOJeLZKaR,GADHQFBEDFDEdCDASBCC.EHFEOGFALFFAKAAACBHHhAAAXDGG.MAAHhABAUCADAECG.bEAHBFAFhACAJHDE.aBDE..RCFH.WAEE.NIAD..YAHBhADA.FDDAfDHChACA,2,-22,-16,6
gZadfcCBOAPFEbVRJLTMeYHISDUQKXWNG,FDCGVFDELHDE.MBGBeACD.HAFASACGQEBFhAAAKFAF.NCICZCECdFFBCFCFBHADhABAAADE.EADCRBAH..JCHFIHHHhADADIAC.....WHCG.aBBHhAHA..OAED.hAIA...,2,-25,-5,20
XTRSUZJfWgLEDaeCQcNGVPIYdMHOBFbKA,RCFDZEFH.JCDD..fGGCLDHHDHBCCAGE....QCBGhAAAGAEB.VFCAIHEEhAAAdABDMDIDBBAHFEAHhACAADBD.XADHSHAGWHCAEFAA.eFCAhABA......hACA...,1,-8,-32,24
BFTUDQCcfSAdHIVEgWNJXPYKGbRaLOZeM,dGBFVFGDECBD......NDAE.PEDAGBBCaHCCLDEDhAAA.eBEEMCFGBCHHhABATEGADIAGCHEHSACChAAAABBDHDFE.IAGB.WBAFYECBhACAKCCC.....hABA...,2,-30,-5,25
TUPSdDRKCZYfWEFgGOLceVJBIAabQHXNM,QBFBXFFG.MCAEUAGD.dBAHRDACKEHFCFAB.ZDDF....hAAAfDGFEGGBFGAEOABGhAFAeBDDBDACADFBaAGA.hBAAbECD...NIEHSHAGDCIDWHDG.gBEDhAAA..hABA...,1,-10,-30,20
JKTYbPdeGOWgRSVHXZQDALIcUfFCBENaM,LGCGUFBHFDECBBCBEADE..MEGDKAFA...TEDA..hAAAPFGBeAGHOCBHhABARCAC.SCDEhACA.XGADDIBGAACEICHDCHGHNDIEaBBF..hAAA......hABA.YEHH.,1,0,-49,49
WMINOQfYCDEaFKBdTgbGUJVXLAcPeSHZR,eAGBZBEFMIFGOGEG..QDBCCADF.EGAEFDCGdFGATFBAhAAAGEDE.UAACXDFGhABAACGHSHBAhADA..WCBFNAED.fGHA.DBIBhACA.aAED...BHFAhAHA..,2,-22,-16,6
RcPSFaHdKENTYXDOUIQbBJAZMegWGVfLC,ZGDGMGECeDADGDCELACFCCEB.RCED.SHFCFAGEHDGBEECFTCAAhAAA..DABBOEABhABAIBDDQBGBhACABHHGAGAF.WEEE.fHAH.cACEhADAaEEH.NDIA...hAFA...,1,-11,-21,10
aICANdYRXZFUQBMEKGSfWcDPJeOVbLgHT,dFAARADEFGAABEDG.KBCGGFEF..SEHF..fBCEhAAADIFGeCFGOBAHhAAAVDAGLDFGhABAHFDCTAGAaHACIHDBABBH..NIAF..ZEBHhABA..MIFCEDDE..hACA.WAFE.,1,-11,-15,4
YbaeKJDCGBQHRPNgAVSEFWIOdTZLfcUMX,VDAAFECEOEHH.ZACCLBGF.UACEMICA..bEDHeAGFhAAA.JBAHCAADBFCAhABAQGAGHFGFPHAChAFAAHDASAHH.IFFD.dCCD.hAGA......hAHA...,2,-22,-19,3
UCSVTGQRDfXWFNMEbaKBPIZJgALceYdHO,eDAAdFEAODGHUGGA..CADH.SEABGAFEDEEB..XAFFhAAAFAAC.MEIFaFAHBHDChACAIHGBZFBDAHFCcBBDhABA...YECD....hACA......hADA...,1,-32,-35,3
AfFgHdeIQBONWXCKTMUEGcJDbSRYaVZPL,FFFFHEGDeAADQEBBBEGE.OGAC.XBDBKDDAMFIFEEEAhAAAJAGFSACDhABA..aHACZAGBAFAGdADDhABANIBF.CFDB...........hACA......hAEA...,2,-44,-2,42
RaIdYZDQSEWAKCPXbONfVJHGUMBLecFTg,CCHCXEAG..NAEA.JADCHBBD.UFFFBDGFLFBGeHEAFDDBhAAARAFF.dFECDIAC.ECADAACFKBAFhABA.OHAE.hAAA.fDFEMCEG....cFGAhAGAaGHD.IDBAhAHA...,1,-21,-34,13
AIaZXdNRbfFYDBMegTPGCVEUScKOHLQWJ,aABAZFFDdBCF..RGCCFEABBEFC.eCDB..PECEVAFGUFADhAAAKCGG..HBBALBABhABA.JFDHIHGAhAAA.NEIG.fFHCDAIB.MIAAgGAFhAEA.CCEH..hACA...,1,-19,-21,2
dJeXEKaLPQfBTbDgCWYSRHZUFIMVGAONc,OGCCdHCBJDGF...EECFKBDGLBEH.QABHTFACDEDEhAAACHGG..SBGEhAAARFDEUCAG.IHABhABAMIFAADDE.NAEHeDAB.aFFGBAFF....hABA.WAHD...hADA...,1,-18,-37,19
HTBaQbLOgIfMCZXGJRDSUAKcPdYVNeFWE,KFGDdGDE..VCEFFBDAEGAGBGAB...QFGCODDG..IABFhAAACBDAZBABGEAHhAAADFFBAICE....PAHHhADAYAHH.eCHDHEACaADGLHEGhAEA.fDHAhAFA...,2,-34,-11,23
DHfGTFOeLUVCQbJZScEPXdWBRNMYgIAaK,aFADKHEGHFEGGAEDOEDAUGEH...QEBDJCDHZCGD.SAABhACAEDAE.dHADBBCFhAAAMADFIHHDhABAABEGfCBAeFCBCDFEcAGC...WEHBhAEA......hAFA...,1,-18,-26,8
VHLBJecAYSRWNOGQUEKZbMPCfdXgDTIaF,RADAOBCHQDEHKAGEZFFB..MFIF.CBBH.dDFBDACEaEDF.HEAAhAAALHAABCABeADEhABAADDCSHEE..hAAANDIAEGEFbCGB..XFCCIHCF...hABA......hAGA...,2,-27,-16,11
RYdHAWXcaSKLTgDePfOCbBZIVFUNJQMGE,XFGBaHGGLECEDBIH...eHCCOAEBBFDEZDBCFCGEUABDQAEFhAAAEHEA.dACAAGEBSAGBhAAAKFGC.hABAPFAHCHAEIFAAJDFCMFCH....hACA......hAFA...,2,-21,-20,1
UMgPYITRDZVcCbJGEHBLWAfNedXaSQKOF,eABGaAED.QGBEFGGBUEAH.MEEE....PCDBIBFHhAAADBAGZGCEVGFACAHE.JCCBhADAHBGDBAHC.AFFANEAAdCADhAAAKEHBOEFC........hABA......hACA...,1,-11,-22,11
eICdcMHZfgGXFSaDWVKURLAYJQTBOPNEb,JAAHTFAEBGCE..OCBD..ECEBIAEFdEBBHAGFZFEBGEFGhABASBDDDGBFKEHBhACALEHHAAFE.PFDHhAAANEAC.CAHBfCAAFADCaGDD.WAFHhABA......hACA...,1,-20,-27,7
HVLEJUbWMCgaADKQSTYcedOGXPBRZIfFN,KDBEQDGH.SECATGDEeDADdCEHGABABGGHZCFBfGBEhAAAFBAA.VFEBhABAEAGGJBEFUAFBMIAEhAAACHHDABDADAIBOCHF..PDAB...hABA......hACA...,2,-28,5,33
faUQFWIbGCegKANTYERMPcHSVLZOXdBJD,TFAGEFEHRBFB..MIAAHEFD.LAAAZBAAOFBGdAFFDCEA.fEDChABAaFAHFGGC.IHDDhACACDBBKADH.ACHGNDDF.hAAA.PDHDSHGABDAG.....hABA......hACA...,1,-8,-24,16
dCbFLOagWIRKJNSXBQfcTMZHVDEGPYUeA,CACDLCAF.aGCAIFDA.KGGASHFABAFG.fHABhAAAMCDAHDAHDFEAhABAECGHGBEHUGAHAIEGFFHFhACAOAAHRABCXCDC..cDDA.hAEA......hAFA...,2,-30,-16,14
VXWQPEIgCASHFJeTdbfcOLZKaRYGBUNMD,HCFDFFDDeBAHdAFD....bCCHOHACLAABKCGBRCEDBEAD.NHEB.hACADBGE...XDBHhAAAWGAG.QACBhABAEFGACEEBAIDG.TFGCfACHaGAG...hADA......hAFA...,1,-13,-23,10
NTAOIMVBGQREecgfJHWbPSLCZKDYdaUXF,MEFHBBFGQEBGRCCF.EADAeAAD.fGHAJHBEHEEB.hAAA.PCCESCGDhABACBHBDIGG.YAFEhACAdDGBaABD.FHCEAEED.ODABIGHFcEGE..hADA..WBAF..hABA...,1,-9,-21,12
SLTJQUXHRFeBdNZDOMfGIWgVEPYcCKaAb,LFBGQACEHBBCFAFFdEBFDHCGMCAHGGEB....IAAHhACAgBABEDFDPHEEhADACEGGAGDF..SDDEhAAAJBEAXFFABAHFNAIAOHACfCGHhABA.WFCD...hAEA...,1,-13,-17,4
NDYgEVTFGRMQZIHLaCdPcbOAUBeXWfKSJ,UFFFXGDCKECA...JCEFDDCC..EEAEFGAGGABC.MAIFhAAAZADALCAB.hABACDGAdHCFcFGE.AADCBGBChAFAeBBG.fAGGSCEH...hAHANBIC.gEFHhBAA...,2,-36,-26,10
UNaWEZFJdISAKYQHbTgPVXMGCcfBeRDLO,QFBGHBDDTDGB..VAGBMBAGCADHBHFDDFECLFAF.hAAANGDB.aCBCZGBCdEEAAEACKCCFhAAA..gGGBhABA.XBEHcCFGeADEODHDWFHHhABAEECE.ICAHSACDhADA..,1,-8,-13,5
PgQSAZJURbDcCIKTXWLYedFEBMNOaGVfH,JDEDUAAF.RFEF.DGIH..CEAB.KAGD....TFBHXDBDLADHhABAdBCHBCGH..hAAAMEFEOBAB.aGFGhABAfBHC.PAFDSCHHhACAAHBBcDCCYFAFFHGA.hAFA..EHFC,2,-38,-36,2
RXQgUBPbCGaMeYKWDfLFcZOTIJdAVSEHN,VCBFEEGFHDCC.RAEE.QGCABHGC.CHGAGBFCMDFAKABFDABHLCAAhAAAZFAF.OEHDhACATACGdGACAEFHXAEBhAAA..gFCDPAHDaGGAWHCGhADA......hAEA...,1,-5,-18,13
fcLUeadRMHgCVAIBKOFXQWZENSGJPDYbT,KEBGFCFEQFBDEGAE.GEEFDGCETBDGLAAA.aCABdEEHhAAAMECACGGBABIB..BAFAhABAOAFE..XCABhACAWCCCSHEAJDHF..PHCChADAfEAC...hAEA...,2,-36,-11,25
RZYGebaNJXAPTFICKUSdcWHgMLQVDfBEO,TBCBFCAHKFEE..UAFEdHGHHFDA.MIBCLFHDDAAEBBFCEBCEZCFEhAAAeAFE..aFBDNDAAABBDhADA....CGED.cCEDhAEA..gCCGQEBC.fCHAhAIA.OFFAhBAA.,1,-15,-36,21
ReFXZUOTSbKVPDYMWENAJQHdcLBaICGfg,JCCDQDCDHEFDdFDEBGDD.CDAA.GAECRABG.FCGEUDFEOHEChAAASGACKBAH.DGGDhAAAMDAF.EGAANDIEABABaHAEhABA....IBFD.eAFE.hACA......hADA...,1,-14,-29,15
DSaTFcYEfgJLMdRKPNbHXUCeOQGBWVAIZ,DCDHSAEBFCFA.EEFAJADA..dDDBKDHB....NABEXGCAhAAACFGB..ODFBhAAABBGBAGHEZBABTACBhACA.fHFBMICC..RGAAPEDFhABAUGAAQECF.hACAWAHHaGHD,2,-42,-25,17
cKgLICSMPWFGJAYDUedZBXOQbHEVRaNTf,DFAEUADDZEEBBFFC..QCBEEAGG.RGAE.TAACKEGBLABEhAAACDFD..MHFAhAAA.FCDDAGCEdDDEOEADhACAVBEAaGCC..NIED.gEGH..hAEA....SGGGhAFA,1,-20,-39,19
VNCZAKLdXGPDMbQOJHaBUfFeRIgSYTcWE,dGCFXEFBGCDDDAAFMFBD..OAEGJABHBFHHUFDE.FDADeHEChAAARCDA...SAEChACATBGB.EDAHCBCEADIFhABAKFFC...PAHDbFGDaGBG..IECAhADA....hAHA...,2,-26,-19,7
AOMfZNaHGVPDQgSRLbTWUdCJBcKEXYeFI,MDAAZCBFaHGCHCEE.GACDDGAA.QGCHSGDGLFGBhAAA.TFABdFGDBAAGhABAEEEDeAHBABEEOADHhACAfBABPBFCbDEG...CHAC...hAEA......hAFA...,1,14,-33,47
MYOZFaLUXgdcEeVACNWBKRSHTDIbQGPJf,CHADBBAFRFDC.SAFBDDHB..QDCBJEBE.MBECOEGHhAAAFBBELAAFhACAUBDAdHDBECBFACGBKFAB.HGFGhADAbAGD.......fHCBhAEAYFCGaEAH....hABA...,1,-17,-33,16
YGTgNfDeLIKQJZcESRXFaPBbAHWOMUVdC,OCCAMFHHUFBHdEAGGGBD..TCDE..fCBEhAAADEAGLAHFKFGBQBFChABAZEFDECAG.SACChAFAFAFDBADDACCCWAHBCFEBNIBF.IEEHhAGA......hBAA...,2,-27,-22,5
JgOIaEFZMDRSCWBQdKcUVLeGfbNAHTXPY,XDFGJBBD..OABAaCBB.ZFEEMCFGRCEB...CDCGBGGFhAAAKECEUGAAeAFCGAEFhAAANIDB.ACHH.HFAH.YADDhABAIHHGFGDADDIDSECA.hAFA....dDHA.hAHA...,1,-1,-32,31
CdWRTFKUcOeAVYaQGPEBgNIXSLZbDJfMH,VEAEaAGCGAAD.BDHF..ICDBXFEBZGCG.DBHFMAFDhAAACACCdBACRDAA..FHGCUDGHhAAAOHACAAHG..QGGChABAEGCCSCGFJDEB.fDDBhABATAEBKGAF....hAEA...,2,-18,-7,11
eZVAYWRSgcOTabUFfENMJPdICHLQBKGXD,RAAESGFEOEDD...aBBDFGAE.EGHBMIEA.dAEFCGFFQADGhAAAGCEHDDADVFBGhAAAADHA....gBFFhACAcDDC.........hABA......hACA...,2,-35,-28,7
ERXCaAJHYgbNIcOfMPZDKQGBVdeSULWFT,HGDG..gDFHNCBB.OAFBfDDEZBACKGABBFABhAAAeDAFUCGFFECCEGGHCAECaAHBhABAAIDA....JGCEIDBFhACA.PFFADFID...QGBAhADA...hAAA...,1,-13,-26,13
NCeTWXQSRIPKbLafUAgGYDdEMFJcVOBHZ,GAEADICCdEEHFHFGJBAH....OEFEBBABZDCFCHCA...eAFFhAAAXEAGRBGB.KGAHaBDFhABAACDH....gGEBhAAAMCAFHEAFNAIG........hACA..WBBB.SGGBhABA,1,-29,-34,5
bdENfTBGHOZeSKaICWJcVgQLPYURDMXFA,dBFCEFAD...TGFDHEECeCADKAGC.IBBACHDG..JEEBgDCChAAAQBACPHEEhABAREBDMCDD.AHIB.fDHGhACABACD.GBDFOEAHaHACWBHHhAAA..cGDG.hABA...,2,-30,8,38
dNTSQBKJUgFGPeOXfVICaAEWDRHbLMYZc,DDCFHEFALDDEZEBDdBGGSBCBBBHCKABF.UAACFGGDGFBFhAAA..OBEB.hACAXFDHIEACAAECEDABhADAbADA.MIDG..YEFGNAIG.JHAChADA......hAEA...,2,-31,-7,24
QZTJVHACbNdYWSfFcKMeRUPGBEIgDOLaX,CEEEdDBA.SEFDFFCFKHEG.RGCG.GBDFBGBC..EAEBDBCA.LAADhACAaEGFZBBC..TAGFhAAAHFGDAAGH..NBAE.fCHAhADA.eFAFIHHEXCCChAEAJDDF......hAFA...,2,-27,-15,12
bTOcKRVEdCXIfaYgDJZUWAMLNSFHeBQGP,MCDGSEHDFCHBHDEDBFAHGEBE..PBDFOAABKCBBEGFFhABACCHE...XEGEhACAIACBfDAChADA.aDDHDHBG.JHDE.WFDGAAHFNBCH.bAFG.hAEARCFHdAAG....hAEA...,1,8,-33,41
HVGFScPbUILBYWgZJNTfaCdERKDOXeQMA,GCBDFEED.SGBB..bBCFLEAFBDGF.gFFAhAAAJHAC.fADGhABAdEHAKAGG.XDGChACAMBABAFCE.HBFGPHFEIEEFZBFANBBE.aFBAhAEA.CHHDDIDA...hAAA...,1,9,-40,49
fPFXQSHgIGAZeKCLMRWBUTVYEbONDdacJ,eCDELHDERAAGBGEDUBAC...VEBBEGHFOFAHDEEF.dAEDaBHFhAAA..JCHFFBEFQEEBhAAASCCBHDAChACA..gFGGAIBGCGCD.MAEA..hABA......hACA...,1,-13,-29,16
abcANTSICGZMLEgUKJPfdFYeWBOXHDVQR,TDAFSACE.GCCCZAFDEEFCKAFEJFHDdEHA.FFEB..eADBhAAABHFBXFBHDAAHRBEB.hABAaFECABHGCCBALCAEhABA.PAHDfHCBOHDC....hACA......hAEA...,1,-7,-29,22
IQZOgBFPcGNHALKVERbYXdaCJeMDWUSfT,LEBEEGABRFEE.XCGFaAAA..CADE.eBCCDICE.UFFB.SFCBhAAATCEHIDBBhAFAOFABBHBG.hAGAFBADcDGENIEH.AHDCKFBH..YAEChABAMIFEWAFAfCDHhACAZCCH..,1,-7,-31,24
ECePYGSgXFLaVKZIBMHfTJRbWUDdQcNAO,ECCFCBFD..eDEAGFDB.SBABXECHFGGAaAFEZDECBAHBMFAFhAAAHDAF.JBCBWFCFhABADDIDdAAD..NIDFAADBOHCEhABA..gBGALAEFKGAD.hACAfGFE.hAEA...,2,-18,-11,7
AgOEBTGMLSNDHZRJfKUbQFePCcIYWaXdV,OFFHTECH.GEGGLFADDDGCZCBDRFEAKHCGUGBE..QBEHhAAAeDDB.CACDICCAhABAaAGDdAECAACGBAAC.hADASBBFHCGB..fGHChAEA......hAFA...,2,-20,-17,3
DFVCTNWbOBPRIaZGKYfAdHUcMJegSQEXL,UABHJCDC.eDFHQEBDLBHHDACHFGGH..CHHG...NDDG.OHCGhAAABAFD.RAGDaGEAKGAFAEBGhAAA..dDBF.MFAHhABASAED.XCACWFEE..IADEhAFA...hACA.YFHH.,2,-28,-25,3
GCUdDfRaMPSWZFeYQBLOETNbKAcJgHIXV,JGCGHABD.XDDFCFHH.DEHFRCCH..MBFDSGDA.FAFBhAAAeAHHBGHAEABETEBHhABAKAGFAHAF...IBHHhADAGEAAdHFFPHAC.WEAFYAAFhADALFFHOEEE..hAEA...,2,-27,-4,23
QXAMDKVNFLgIGHcCPZJBdSEaTROeWfYbU,DDFBVDAFFDGF.LBADGGCHHEFE.CAHGZCCFBBDD.SHBGhAAAEAAHRADB.OFHFhABAfHGFUAGFAHCCMIAGhAAAKCBB...ICGHcEDH....dFABhACA.TGFB..hADA...,2,-29,-1,28
OQAaHbPMESCdRIKJLNWXUGZYVgBcefDFT,aCDEHDGH.MBFDCCBA.RCACKEDHLBGF..XFAFUFFHZFBE.hAAA..VACABCGCeHCEhAAADBBGFAGGOBABAFFFEGFHhABASGADIHHG.NDIC...WAEF.hABA......hACA...,2,-19,-18,1
DKbZIfMWAHQOGNRdCTBFVaPeYgcLJEXSU,QDFGODDAREFC.CBBCBEECFAHB..aDBFeHFA.....hAAAgFAGLBAAEHGChABAXADCDGBDKGEBIHDDhAAAfAEGAHFENBIC.dGCE.PDAHJCCHSBADhABA.bBEAhACA.MAEE.,1,-8,-17,9
PgRcYFIGCBSdJZKVaOEbeHQLDWUMNfXTA,RAFGFDDECHGC.dACCZDBFKDBB....aCAGOFFF..EFGAeCGBLFDBhAAADGBGUAFHMBAA.hAAA..XFAHhABAAAEH.PDDGYBADBDHGJFHB...bGAChABA..WFFF..hACA...,2,-27,-26,1
AQbgWNUdHaXFeIVBOTGMLRfcYDPEZKJSC,QDDF..WAHFdHADXGEFFDGH.eBGDBEDHTADGhAAALABBRFACfDAAhABADGHBEGAFZAEDSBBGhACAbGCA.NDIE.aADHIHGD..hADAOAAH.MEAGhAEA...,1,6,-36,42
VOLAgMQbWdHfXGFScIERPTZCeUaNBYDJK,QDFHdFFBHACEXCEDGCAHFGAB.SFGGEGBDRBAHZEACCAGHaEBEhAAABHEF..DIEGKCGAhAAALBACMFIF.fGCEhABA.IAFB.TFDGhACA.NBIA....hABA...,1,-2,-22,20
YBPUHNeFJMDOdaGREQTbZWIfcgLVKSXCA,BHDAHAFCeGAGFEFDDBAAaBDD.GCBGRBDE.EFHBQCGEZFEH.hAAA.IDGC.hAAAfCAAcGACLHFAhABAKABECFDGACIB.PDBFNIAD.OADA.hAEAdEDC.....hAFA..WCAF,2,-23,-1,22
NCTbSdYZcfEVRJaDXPBUMLQKOFHgeIAWG,GCCDCFHA.SACEZFBBEBFGRFDC.DFEFBDECMCBHLCAG.hAAAKEAFOCGD.HGFEhABAIAHFAHAF..hAAATFBGdABH.fAFEaHFEPEFAFAGA.hACAWDHH....hBAA...,1,-23,-24,1
CDEMYOHJdUGSVIgKQLPZXRfFaNcebBATW,CHACMAEHHAEHUDGAGCFA..SHAEVBADKHCELDDBhAAAZDAARBAAFAFB.aHGG..NEEE.bAGFhABABGCE..AIEA.DIGGhAAAOEAEdABF.IFHDgFFG..hAHA......hAIA...,1,3,-23,26
PVJLeKBQdIcOTgDENRWCSFfXMAbYUGaZH,UCGBaBGHZACEHEEE.JAAAKFGA.BDEAdGAC..OAFADICAREAA...hAAACADB.SAHHhABAFHCA.MDACACCD..bDCHhBAA..PHEAeBEHIHGA..hBGAcGAE.EEFC.hBIA...,1,-24,-31,7
HMLUVYcafGTgNPOBJQSXIRWDeAKbFZECd,FEBDCABGHCDBLABGUFBB...VAFCaCHBGAEB..NCIEBCCChAAASGGA.XACBhAAAIDEGDGEDKFGHhACAEFFHdFFGMIAE..fHDB.hAFA......hAHA...,2,-31,-18,13
QGdYPOZgaMNcTDIWCLeSFBXEfJVbHKURA,QCABdBCGOGCGZAFHMFEF...TGGBDBAHCHHFLDFGhAAA.FEAFXAEHhAAA.EDCAfGFChABAJEAHVCGFKFFFAHCD.YHAGaBDEIBHGSBBChABABHAD....hACA...,1,-15,-28,13
PfHgFLBdRbZNSCXAWecOUKTaGJIYDMVEQ,eDAAOECBKGHBGBEA..IAFADBCGVGEEQGDGhAAA.HDFDFBADBBHAhAAAdBBFZEAGSGAFhABAAABE.WDHDTBGD.aHAEYAECEEEB.hADA..fCCHhACA..,1,-11,-23,12
DSVCgPTKYFUZbaeNWOEXRQGfBcdJLHMIA,VBFCCCAC..TBGBKADD.FCBEUEFC.ZDDDaCEH..eBBFOGBEhAAARFAD.QFGDhABABECFJHFE.LAFEhACA.MFFFIAAHACFBSEAH.YABGhBAA..NAEB.hACA...,2,-32,-11,21
cPQEUIXSFfDAJegMYZdHNaBTGRbOCKVWL,eDBBMBFFdCBCHFDCBFFHRAAECAEH...KAACVCDELHCG.QEDGhADAIAHGSAGDhAAAFAGFADCA.JEHBZFADhAEA.aCGE..........hAFA......hAIA...,1,-21,-28,7
QagUJYbTIGZDBMOANReEdVHXLPfFcSWKC,RFBEeADDEEDA.dFFEHADHLBAFFFGA..SBBFKAGECCGF.QDAFhAAAUFAGJFDD.TAGHhABAZFGDDDDHOHEG.hAAAAHIFNIAHXCEH..fCHChACA...aFAH..hADA...,1,-5,-27,22
BXSVgTCcGDNAQRPHfZLebWaJOdFYKMIUE,RCECHDFGZEGHLGAEeAEDaABB.dAEAKGFD.UAGBBBHE...SHAAhAAATEDBCFBHDDBGACBFQDCChABA..hACAfHCFJFFBOBBGMAABEDAB.gGGHhADA....hAFA...,1,-13,-22,9
TWFbOaDXeCgLdVSZPcHMARBEYQJfIGUKN,EDDDJHBCGAABKEGG....TABBFBGAaEHHDAID...XGCFhAAAeEDCLDAChAAAdHADSAEGZFCC.HCEDhABAAHADBHHGQGGCIFABUDAC..hADAWCEGCAGE....hABA...,1,-1,-31,30
bWgRIcKOJUfMaCFdBXEGAPZeHDYVLQSTN,ZBBDHADADGGALCCF.SCADTGDA...NAHE.gDCHhAAAIGFHKGCGUDGAhABAaGAHCGBCdAGCBEECEADGPAAAhAFAeCAF...QEGB..hAGA.WDDC...hACA...,2,-28,-3,25
TMKOdVILSCFbDABEJafPNXWHRQUegcZGY,BFFEEDEF.JAAGaBFC.......NBBEHGDGUAEGeCDDZCCBGDGChAAATCGEKACCOHBAhAAAIAGH.CFADDCCDhABAABDEXFGD.....WCCD.hAFA......hAIA...,2,-40,-17,23
JbNefGTKROVAPIYHFWXQaCgEcSBLdZUDM,..IFGEHACFFEAD.QCFACAAB.EHFABDFFdFFFDCIHJBDFeADGhACAGGBFKGHHOABBhAAAAGEH...YAEGhACAXGAD.aHDESFCCUAGAMFAA.hAEAfDGF.hAFA...,2,-33,-10,23
PNCDbAWEYQBVTgaSHULGKFMXOcfeIJZdR,ECDFQFFDBFDE...TAFDaCBGUAGEGDAFKFAC.FBDCMHEAhAAAOHAC.eEHBIAEChABAJAAFdFDG.NIEDCFADDCAHhACA.AGGA....WHFAgCGCHCEFXDGDhADA.fGBChBAA,2,-22,-12,10
WFQHOTUPZfbKcJCXgGBDSVIMEdNRaALYe,eADBFEDHHCGDUEFFZBBBKCFECGBE..GAEABCBDDAEC..SHGAhAAAMHAA.EBADRDCFAHHGLFFAhABA.WHAAhACAOAAB...fGEG..hABAcAGAXAGE.hADA...,2,-38,-17,21
WNYCeHBXFcEPGJDIMZVATdgKLRaObUfQS,TEDAKHGGREEE..ODBAUACF..QAGC.SCFGhAAAWFDD.CBADeFBBhABABBEEFAAAEDAAJFHDMBHHADIBdHEBhADAaEAF...fDCFNADH...hAIA..YFAFhAFA...,1,-11,-43,32
LAEWJBRQOTUNdHCGfaSIDeXgYKbZcFMPV,EHECBBCBRFAG.QFGE.OAFGTBCAdEECGBEC.aDHBhAAADAAEXDAGKHCGbBFCZEBDhADAMACC.LGEEhABAABBF.WHAANEAGfDGBSAHF..hAGA......hBAA...,1,-9,-22,13
FCbJGEWURBeOAKcDfaXNHdMLgPZTQYSVI,DECAaHAGHBCELBAGZBAD.QAEE..YEFAVCGHCGBEGFDHhAAAEADGUAGFBCDAhABAAGIFKHEC..XDADhACAMFDDTCGGIAHCFFAGWDEF...hADA......hAEA...,2,-19,-1,18
KeHFTZDEILAacGWbdVSfPYJNCORBgXUMQ,aFBFGADH.dDAGSFHB..fFEBJAEC.CHFDRDFAhAAABDCFUCCGKBDAFHACDABEhAAAEBAALEDF.hABAACBFbFEB..YFDFOAHDXGGDhAHA.....hACA.eCFC.,2,-26,-11,15
PbNcDRIBGSdQEeJaVAZHCMLfgFXTUWYOK,CHHELABEFEDF.TBEHUAAE...OEDCKFGD...NDIE.DAIBhADABCCEdHCHEFBH..hAEAeFAD.JHFCAAFCMCEGhAHAXGDF...PDBDRCBASDHDhBAA..aBGF..hAAA...,2,-37,-27,10
LJHUPZYefGNgVScROAdFKWQaBCXITbDME,dBAFKEGFQBCCaAGB.BHEDIDCHDFBDLFCHUEFFZGDEeAFHhAAAGDAG..NAIC.hABASDGE.hACAcECD.AGIHFAHDWEEBCADC...bDAGMIFGhAAAEHGG.PAEF.hADA...,1,-4,-32,28
aNPTVRcbYDgdICSeKHBXUJLZGEMWFOQfA,aBCFTDDG..REGH.....bDBBDFBEdAFGSFAGeGFGBBGBhAAAJAAFLBAEZAEGMHDEhABAWDGB..FDEGOEAFhABAAGIF.NAIGcFDCICHE.CEFH...hACA......hADA...,2,-37,-4,33
dYBGWXebOHcJIDfMQPgESKUAZCFRNLVaT,CBCFRAFCLDFD..aDECdECHBGCBGAAAeFFFHDGF.IHHChAAADBFHQBGGhAAA.EGHFSGEDhACAAECDFGAH.VGAGTCAFXADF...hABA.OACA..hAGA.fEHC.,2,-25,-1,24
cObAGFDBLQTUSKePVZXNfWagEdIRMYHJC,DEEGBEEFQFGHSGCBKCCG..eAFFZEAF...XFADhAAANAHE.aEGFEFCEdDBHICADhAAAMDAFJFFFCAFFOABAhAIAACIHFBBA...LFFD...hABA......hACA...,1,-22,-27,5
XdeSARHJQVZCGbDTFfcgMOKIELBYaWNUP,HBAAQCBGCCDHDBGB..FHFA..gFGAOFDF.KFDBEAHFLBFDhAAABFFG.YAGBhABAaDHB.UFAHXEBGhAAAeADBAACBRGAC....JABC....hAEA......hAFA...,2,-26,-10,16
DKdMRGaZbCAVgJNWeXSYFIPQOBcELHfTU,VGDAJACC..eFEA..SDCGFDEBQBFEBFDFLCBEhAAAHFAHUBAFKBFFMIFEhAAAaAEAZAGDAAHG..NDIE.WBAFhABA...XGGBYECHOEBHhACA......hADA...,2,-25,-15,10
WOeNFJEGLARIdCQcbDXMBHZfSKTPYVaUg,RDCGdHCBCGAA.QDDC.DBECBAFFZAGDKACCTGFH..VBAEhAAAUDGB.OBBGFHFCEEGChABAAGCB....ICADhAAAXGAFHBFGSGGEaEAC..gFDAhABA.NIBD.hACA...,2,-33,-17,16
XFRGTVDEbYWgfANQeJKUMLZCcdaIBHOPS,eFGFUADFZECGdBBABEBAHBAH..OHAESEEDRGDE.GAEDhAAATCDGDDGB.EDHB..hABAbDGBgFAGhACA.AADGJHCEMEIFCHAGIHHAFAGC.WDDFhAFAfEAG..hAAA...,1,-6,-19,13
WcZTMJSHVDPEbKABYQLgeGUaFINdORfCX,QEBCLCEGGCCAUGEFFDEAdFGDOBAFRAGD..CFAC.XGAAhAAAZFGFMBBAHAFEDIBA.hAAAEHFAACDG.BFAE.eFEHhABAICAHfDHA..cCCHhABA.SAEBhACA...,2,-30,2,32
HKEMLVFNYZeUdDRcGXgJbaOITWSACPBfQ,CECHBAACHCECKDFDLHAEFACC.ZDADeAEEUADCDCDBRFFF...GFBHhAHAJAAB..OAFChAAAIFHG..SFEFhACAAIBGQBEDMFIBNIDB....YBBFhAIA...dCHGhBIA...,1,-12,-33,21
DRfNUEbZTYeCLISFJHWKBgMPaQXAVdGcO,GAEFDEEFRBEE.UDCB.EDABTCCH.CFAD.IHAB.JAAAhADAKHGA.MIBA.QAAHhAAAAHIDdDFAOFCFhAEAbDFAZGAELHEE.FCHFBGFHaEGD.XCAHhACA.fADFhADA.,1,-8,-29,21
dIYeQLTNacDVUGCOXPSRZgKbAWJfFEMHB,JGBEFEGDHBBCBCAB.dGBD.eCFFLBBB..TGEGaBGDDFEGUEAFhAAAGGEDOADA.hAAASAHHZEAEKAEFADDC.hABA..ECADMEEEIEDH.NEIACABG..hACA......hAHA...,2,-32,-8,24
fZKCRFOdJLcATeaMbIUXEPYBGNSDQHVgW,eACCMCIFUCCEEFFGBEDDGEGE..SGHHHGCA.VCFEhAAAgBGFZFBC.CADAFAADhAAAdAGFJCAGAAFH.aHBCbDAHhACA..IBEH..XEDEhADA......hAGA...,2,-15,-12,3
fHeVLTKOABdEbGIYPcUaWSXDRNZCJgMFQ,dBEEEEHDGBDD..IBAE..YEAFUGGASADFhAAADACCZEDHJCBFMEEBhABAFAACQGFGhAFAeBGBLFAE.KHBEADGBBHBAcCAE...WFEHhACANAIECHDG.....hAGAfAHE.,2,-22,-7,15
WQRYBfSZVDCGeEaMJcAPONbIdgHTFULKX,ODCF..bGBGdAEBHCCHFGHHUBADKBBDQFFBBAHE.SFCAhAAADFFFGBDHaBEChABAMEEHJAFE...AIFG.hAAANEIG..IEAB....gCGAhABAXCFEWACChBAARDAB..fHBF,2,-24,-20,4
SBWeCHfKXYbORDadPUGETcIZQLgAFNJMV,JCAAVCABBGGB..eFBAHCFGKBHD..XEADOFFDaGCEUADAhAAA.GEDC.EABGhAGAcAAF.IHHChACALHFG.FHBGMIBCCAHF.fDDFhADA.YAFEhAEADFFA.dCFA.,1,-9,-28,19
UfeXgcbHRYaLBJFTPVKdZSEWDAQGCOINM,CAGBOAGD..MFBHUGEHeHEG..XBCH..cFFAhAAAHEABaAEBBFDCFABGhAAATCGCKDFGSFCBhAGADBADGBCFIHHCfAEBbEFE.RDAG..hAIA......hBAA...,2,-22,-18,4
NKPBVQGMbAdgCJZDfeaTIEFOcLHYURWXS,CBBGDGBC.eFFFaGFA...EHCGFDABLBEHUDDG.RBBC...SGBEhAAAPAHD.BAGGhABAQDADMDIHAHEBdACDhADAJEHFfAAB.IHAFcCFEWHFGhAFANADD...KHAEhAHA...,2,-39,-8,31
VTfEXBNQKcDUbAedRMSGZJOLHPCIYagFW,eBCBREAGMEFCZDGH.OGBAHBDCCHFC..aFEFFAHH....VCABhAAAEGAEXBAGBAHEQAFChABAKDDHDGIFAFFESGGDhACA....JAAA.IGDDhADAWHCGfDFEhADA...,2,-30,-20,10
eTUELbAHdYWOMPfDQRCNXFBgcIVKGSaJZ,HBEDdGFFOCHDMEDFDEHDRADH...CHABFAAGBFDF...ICBHhAAAVGEAKCBAGAFG.hADAaCAHeACA.ECGHAABD.hACA.PHBENCIC.XFAGSAGE.hADA......hAFA...,1,-18,-27,9
NaRGeMTWAgJIVSDcdFEXZUHYKPCLBQbfO,JHCESGEF.DCDHdAHA.EADHUACHHFGFKFBDCECH.BAFC..hAAA.QAGHhABAOAABRCDAMFABADIH..IHHHhADAFCBHXFBCPDGFfEFHhABA..aDFB.eFCHhAIA...,1,-17,-36,19
RNEHGbYBVOPfIDMCTXacAdSJgWULQFKZe,dHCFSBBAJCEB.UECAQBCFZGFGRAGB.HCGDGDAABHAHOACAhAAA..IDBEhAAAMEFACCDH.TGGChABAaFFAABAC.LEAG.KAHBNIAB.EFFF.YADChACA....hAHA...,2,-18,-13,5
aCPDVHYBfIMFTXEeWbgRLKGZUQSAJONdc,OCBAdCBFCEEH.DFDBHEBHBEFFMIBG.FGDAEFAH...eAAF.hAAA.bAFHLHFEhAAAZABCSGGDJAECaFGE.PFABhACAfCGE.TDBG..WDHHhADAKHAA.....hACA...,2,-30,-14,16
geTLDfPEFMCHdISVRJXQYaABObcGZWNKU,OHBAGDGEZFEFKDCF.eCBDDIFA...EACEFFDACCCD.dFHA..IAFChAAASAGD..hAAARFCHJEAHXABB.hABAaBDFABBEBDED..WFAFNAIG....hAEA.gDGChAFA...,2,-46,-16,30
SVRLHFXeNWEaGPIKfCOAdQbUBTJZcDgYM,dHCBUDABJCDHDDIB...MICCSCAH.RDGF.HAAD.eFDGhAAAEAGAGAADKGADCCGHOEEAhACAACGABGAE...hADAZFDA.gCEBYFHFFGBAXEAAhAAANCCD.aADA.IHHHhABA..,1,-7,-26,19
RGXEIBYgOZFLbQdSJCaMAePHWUNTVDcKf,eHBGHBCBUGEF..VCABDCBBKAHDGFEFEDFG.BDDC.OAFBhAAAFGAALFFEdAHGSBAEhABACAFGACEC.NEEF.fAAFhAAA.REBG.XACB.IHHFhAGA...hADA...,1,-12,-27,15
VIDNMdOXZWFSTbHLJEUARBQYgeKPGfCca,QFACeBAHGDEGCAEE.aECDDHCG..MBGDdCDFOBBBZGAA.FHGAhAAASGGDHEDAEACEUAGAhABABFBFgACEhAAA.KEHDcDGAICCCNIBD.WAFChABA......hAEA...,1,-10,-19,9
YQOReFKJEDbaGdNHXBcMgSIAPZLWVCTfU,ZGBEVEDFCACC..UCDEOCFF..eFAAJBAE.DAHFGDAC.dAEFhAAAXAADBDHAMIFChABA..SFHBhAAAAIAE.LFFFfCDFYADGFHCCKGGChACAaGHH.NAIG....hADA...,2,-23,-20,3
TdUSLOHKDFINgXQGYBcfWbEaCReJAVZPM,ZADCMGBEdGDDLGFGKGGG.FDCD..IFAHXAAF.GACFhADABBHH...WEFGhAFAaAAGCDCH..RAGFAEHATEFHhAEA...SBCGDICG.NIAB..hAGA......hAIAYDFC.,2,-42,-16,26
SabPQDXKFZRIJfHTedALgOCcGEVWMYUBN,OFFGCDFFGGAB..ECAAMAACUFBDBADA..aCDCQFGBhAFA.XECFhAGAFABAZGECJAFCTBBFdCHGAGIB.hAHA.cBGC.WHFGNIAFSEAFhAAADEGC......hAEA...,2,-28,-13,15
TGAMVOcEQCNHSfgeULDXYIWJbdFPRKZBa,MEEAVBBA...OBHFEDAG..CGGCHGAESFCC.eFGHhAAADBFFIEHHJBBH.hABAdAGHPAEAKEEABEADhAAAaADH.AEDFQGDG.fCGDhABAUGDA.....hACA...,2,-30,-14,16
KRENaIcMJDCWgBHOPTFfVbYZGSUQeLdAX,RBBGaFABMDGD..CHBEBDCDOEBC..FBAD..VAFGZGFGUBGAhAAALHFCAEGC.KEHDEFCD.hAAA.IHDHDDFF.hABA.....WBEFPCAH.fDEGhABA...hACA...,1,-23,-50,27
SYEFHafcOTNIMQGXRPbLKdCWUJAZDVBeg,DEFGBHFEeGAGSCCCFHFC.HDEE.aBEAOEEH.IBAEhAAAQFAH.XDAChAAAPCDELAHHhABACFGDWACCAEID.ZCBB.YAEAfBAGNEIC.hACAMAIH.bFCBKDAD.hABA...,1,-13,-25,12
DLMAdOUVRHfXWIKQaCFNSEecZgPYJbTGB,dBCEVFCARGAAHEEH..XCFFKEGECADE.FABA..SGGHhAAAEHGGeEBFZBBE..YAFGhABAJFFC.GCAAhACABDEADIBGAFDBOCFAfAGD.WEAFhAAAaDEG......hAEA...,1,-9,-27,18
ZJeODfLSbYCPIVHcaAXgRNWMEGBTKQUdF,XGEERCGDMBDD.BBBGKAAB..UGACFFAFeCED..OEDEhAAADIBGSGDCCCEF.hACAVAEG..cGEEhADAAFIF..NAAHEDCBTGCHZCGD.LAFGhAEA...PCBDhAGAIHHB.,2,-31,-20,11
GbCcIfRgOJBNeESKUMALQdZHYWaDPFXVT,dDACZECGHBFBaDHB.DCIFFBAG..TBCFCEBE....IGDAhAAAREGDJDAB.BAHGEHBCSADEhAAAKCCHUGGDAGBELHCAhABA.......QEEBhACA...hABA...,1,-28,-29,1
WJBLCdFVgScRKHeQbMADTIPUXEGZOfNYa,DFCETEEHUBEF.GEACOHBA.....fCCHhAAAaGHHBBCBCAADdCGE.FGGDSHEChABAcDBH.KEGEeAEEhABAMCAHAIBEIACD..EAHBNEIGWFBGhAHA.....hACA...,2,-42,-8,34
IfHbBecLOCXMJQFKGYPdNDZRSWEUTgAaV,VEGDHCBHBBHH.LBBCXBBEQGACKAHDGDAHdEDHDDFEhAAARDGFEAFAUGCH.ABAH.fGEBhAAAeADE.CHHDMBAFhABAFGADNEFA...SGCB..hACA......hADA...,2,-15,-10,5
RAJMKEcCWZIdLOaHYfVNbUBPgGSeDFTQX,KDHBCAHGZFBBdBADLDAHHEDA..VADEUFEHBGAHGAFA.DGIFFGGAhAAA.QGCChABAACDE.EDEEIACAhAAA.aBACYDAC.fHFBhACANIDH.bAGBSDHFhABA.XDDA,1,-16,-21,5
TPDJULBbNZeEfaRgMICYQdFAHKcOVGXSW,HADBOEBAVDGDGAAF..SFDETGDADCHFUAAABDAFZDBDhADAEAGFRGDEMAGF.CAHEdFAGhAFAKFABXGGEhAAA...PCDC.LEFA.hBAAbFBH.....hBCA...,2,-9,-3,6
RHeAQSGXJKbTIafZYMUENCPcWDFVBgdOL,SECHXDBDKEGF..TBAC.aEGAZAAB.UGAE.CFEA.hAAAcBFCFDDFBAFCdFGAOADBhAAALEHHeAEEhABAAHDFQBEFbFDD.ICHBfHABhACAEACA.WEEB...hAHADIGG..,1,0,-28,28
JOIgZPKeSdTWQcMCDYbEUHGNRaVFLfXBA,OCFCZCCEKFEFdFAD..QADFCACD.DCACEDHDHGFARDFB.aGABhAAALHCGBHCFAFCFIEAAhABAeAAH.SEHHhACA.TDCFMAECYBFChAAA......hADA...,1,-18,-34,16
QacgPMGJDYfBeTCSNOAdRLVIZbUKWEFHX,REEAVBDFZBCEUEBG..KGGE.EHCCFHAAHDFC..XAFFhAAAaEAF..PAAFMABDDIDChACABHAE.CAFCOCCHhAAAAHEEdHGHLDFC.IADGWFFF..hAIAQAGD.hBAA...,2,-25,-11,14
TUcVFHSBJfLZOMYCPXDbEeKaNAQGRIgWd,REBG..IBAAdCGAUADHFFDABGGDLADBZGAA.OHAE.MFHBhAAACFHDDBGE..EDBFeABHhAAAKHECABGH.GDEDhABA..TCDE....cFAEhACASGFDYAFC.hABA...,2,-45,-10,35
bPXcZNIHLQAVKUgSeFCGMBWJEDadRYTOf,VDCCUAAFeDFH.FGCEGAAB.MHECBFBEEBGEaBED.dGGCTEAHhAAA..OAFAhABAbFFE...PBHDhADAZGAANIEDIDGHHDBGABDFSFHBCDACDIAG.hABAYEAF..hAEA...,1,3,-25,28
DFcTEYVSPKdXCNZJQgeGAIfBWUbORaLMH,BCDEUEEGODAHRGCGLAEAHACCDFGE..TBGDECGA..SBBChAAAKGBCCEHBZBAHJHFEQDAChABA.eFDGhACAAAAAICCD....fGAChADAWHAA.aHGA.cCCChAFA..,1,-17,-30,13
McWDdZNfPaYVXeTKHgRBUACOLIEGFbSJQ,OFDHLEEAGBAEFBAH..SBBBMAFBDAHHdACDZEAH..NIDD.hAAAfGFC.hABAaCCDYGDC.hAAAeAHBKEEGgCGABDDFCCGDIAFCEGAB.hABA......hADA...,2,-21,-20,1
cPTNdQCGVgKDYUFBLJfOESXaAMbRZeWHI,RBAHeACAHEDF..IFCATBGF..QDFDGFEHKAFADFAGFDAFhAAABDDCJCDH.EGGDaCEAAIAGMEIHhAAA..WHFGhABAPABA..CHCA.YGAAfCHCSAEHhAGA...hACA...,1,-1,-32,31
aXUGdPEBZNfgSVHDMILKTYRObFCAcJeWQ,JFAAQDDG.UBGHdFFCBDFCZBCA....fFFChAAAVABGMIAGKFAH.TDBBhABA.OEHHCHGHeEHDhAAAaCABXAEFEHDESHAGIAHC.LEDBhABA.YCHHhBAA.,2,-42,-5,37
ASKQXDZBIWCgONfbUFPLHEeMaVcJRdTGY,QABHDDBDZAEFBHCACGEA...ODCB..fDAEhAAAFGAHLHFEEECAeEGB.hAAAMBIFaBCG.JAFDTBGDhABAAHCESCCGKEGE.IHACgEEBhACA......hADA...,1,-20,-36,16
HWNOQFVEKTMGRPJCZgdXILBUceSAfDabY,aAAEHDDC.ODBDFBEAKGDBGAAC.JCHHCGHDZCCAdFGCLHAGhAAABFHB.eAEHAAAGDGGF..hADA..YADDhACAQEEBEAGE.TGAA.MAEE.gDBGhAIAXGDB...hAIA...,2,-32,-3,29
ZQYcbJLTDPAUaXNfORgdFMEHeSKIVWCBG,UGABaBFB...XEDDOCHDdGFG.EBDFSDEE.hAAAKACGIAHBCEHC.hAAABCBBQAFBhABAbDADTGCADCCDAIDEREDCFABCMCAF.eFFG.WHDEhACA......hAEA...,2,-34,-15,19
BHRTKMcYdQFXUSagfLIeNDWVOJZAECbPG,CDFCGBBBHEAEKBHDMEFB.dHGFFGGAUDAB..aBDBLAHH.hAAAIBGDNIBB.DFDBhAAAOGBEAGGA.EBAEBABFhADA.TFAFQEEF.XAEFhABASEDBeHFG..hACA...,2,-23,-17,6
OadBVKNSYPgcbHQAMEXJDRCTfeGIFZWLU,MACHXEACDDHD.REFA...CDBG.eGBCFFCDLHBGaDDE.BADGhAAAVCAG.KABA.SBGHhAAAPFFD.bGEEADEFEAGChABA...fFAC.GAEEhAEAWAHB.....hABA...,2,-28,-25,3
CfeQOGMXKWERPANdbIVFZLTJaDBcUYgHS,dEDGVCDGFACA.LFBH..JEFBaGGCBHBA.UBAAHAFFCHGE.hAAAfBAF.hABAeEFAQBGFhACAOCCEMIFAKFBAEEHFAAAGIHDGDIDC.YAHHhAFASEBE.WAEChADA..,1,-20,-33,13
CfQcZgFWGJeIUVMOBXLRNPTHYAbdEaKDS,dAGDKCGCCBBAQACD.ZCEGFDGHGEFAeEBCUGBEMDDFBHEGhAAALADARBAB..TFAGhABAAIGE.EDHF.aHACfCDBhAAA...gFGAhABAIHHC.OFAH.XCAChACA,1,-12,-31,19
OaQbCfReFXVAdUPSKNGcYLMTDJBZIWHgE,UCDBKFEBGBEDLGCGDEDBBDAHZAEGHEFG.OAAAaGAB.QEAFhAEACACA..fDDBhAAAFGHDADBE.SHEAhABANICFMBIF.JDHH...IHBEhACAEGAD.eBBB.dAFBhAEA...,1,-3,-31,28
cLeKWDVbUJPCSaZQYHEXMNIfRgdTOABFG,FCDEGCBBeHDGKAGFDEGGUGGH..CEAEZADGHCGF.MFAG..IBABhAAARACGdFEEAAABBAHBhABALFEC....hABA.WFAD.........hACA......hAEA...,2,-42,-27,15
RWfJBCTKPFAMNOgLbdVSDYcEaGUXIQHZe,MDECOFHFLGECdCBFDAAE.EDCFGAEC.UFFAIEAB.hADAHACAeEBE.RAGDJGAGhAEACHCDKAGA.AEEGNIED.bAAB.hAGA.SGDH..aCGA.ZFAG.hAIABEFH....hAEA...,1,-9,-17,8
cXfBaWLeFUASbVNIdMQJGEPOZYRTCKDHg,SBBDVADD.dADDMGECGCCE.EGGCZFAH.RDDCCGCGDFEH.HAGHhAAAXCADBGFCaGAEhABALEHB.FHFCAIDEIEAGhACAQAAHOCFHYAHHKDHB..hAAA......hACA...,1,-6,-18,12
OWNIcVYZgLdfBUeDGJTMHaQbAFCXKERPS,CBHHKAFHRGAC.OBCD....IBAEVFGFZFAFdDBGBAHBUEGEDDIHhAAAGEDA.JAFHHFCFhABA.aCFCACCEEADBSCBDhACA.NEFG........hAAA......hABA...,2,-36,-21,15
LeXFEgVROdZCcYMJfTKWIPHNbGDAUBQSa,BCBGaAFDLBHHFBFE..EHECREDFdADDZEEE.CGFG.MECH..TAAHhAAAKACG...PEABhACA..NCICDIAAACHFSDCBhAEA.gGGH.cCEChAHAfHGF.hAIAIDDA.,2,-53,-10,43
AFVYBdSMLJEXCgZPDIbcNGeWQaRUfKOTH,FAEFBEHCMDGFEEDH..CAAG.ZECA.DIAG..IBCB..NADAGGBHhAAAQGGBaHGG.hABAfCED.hACAKHDEHAGBAAGDdFADSBBDJAHFPDAG..hABA......hACA...,1,-23,-34,11
TOdGSZUCQDFbANPXeBVKcfJYIWMRLHagE,XCBHVDFC.KAEAJACH....IAADMECDLHAAhAAA.HBEEEFCAdCFESGHBhABACHAHDGFFADIHNEHEPDADhADABHDC...fEDERACDaCABOAHH.hAEA......hAFA...,1,-22,-25,3
XRPSETfgUMJbQIaFOVLGdZDcWBHKYCNeA,XFACRDFBEDBD....TEDBUFGHMCACQAAHFBHBOEBChAAALAEDZBEHDIEEcGAChAAABGDGHAFC.CHHAAEIFhACASDBC.JABEIHEGaHAE.hABA......hAFA...,2,-25,-2,23
RLOJZdfPabUNFYgTDGQIACXWcMVeKSHEB,XAFFMFAAKFGGHBAFRCEG.LAEFOFBHdBBA..aHBCNEIC.FGEHhAAA...TEEFhABADGHDQFEGADGECDDD.hACAWABEcAGC.SACHEECDBHCH..hAHAfAHC.hAIA...,2,-22,-17,5
agYOeMQNUCbZRKIBHSTXdPFVDWELcJGfA,aBAFOEDB..QEGACAHDZFAB.KACFBHHEHAGBSABBhAAAdFBEVDDA.EGEC.JCEEAAEGeGDAhAAA.MDAD.hADANIDD...RADCTEGB..FBEGWBBDhAEA......hAGA...,1,-1,-36,35
EBedNIGUcgQLXPKbaDHZVYSOACWfTMRFJ,CGAHTCBHFDCF..BCABdAHGGGCH.UEDFQFEHLFBDhAAAKAACDIFCHAFDZABC.SBEDhADAACACMFAHECGBIFHFhAEAXAEFaCGD.OHAEfGGDhACA......hADA..eFAE,2,-23,-7,16
gTXdBWOPRIDFMKQEYLSCHZefANUbJcaVG,UFBBJFDE...VAGDGBBD...XFBFdFFFOBBGRGEADAAGhADAMBAD..EDEGSCDDhAAAZAFAAGAC.NEIG.hABAaDHBBGEG.ICEFFHAC...KGGFhACA......hADA...,2,-32,-24,8
FEALCgbZIQNBdDPOWeJGXcTUYKSMHRaVf,CEEEZCBF.QAFHdCDDDDGH.OFEGeDHBGDBA..cGEHhAAATABE..UCGHhABASHAGMDBBaABEfAFBhAAAEGGGAFAFLHAEIGGCBDDFJBAH.hACAKAEF.....hAEA...,2,-21,-10,11
TAQRdaILYgfXVbWMUJHDPSeKcEZCGONBF,RABEdAEELFGH..fGAHXCDA.VABFMGBG.UDAFhAAAHDEBDAHDeFHF.KHDAhAAAZGACCDHE.NAIG.BDACAGGDaGEDhABA..IDDC.gAGHhABA....WBFBhADA...,2,-25,-13,12
YJNfVdSLBOKCcTbIHRaQMgAEGFWZUPDXe,FBCBUGCFDGEBeFAC..JFAC..VBEEdGFABAGACHAD..TAAChAAAHCEB...aEFFMBAHhAAAAIFA.EFHHZDAE.XFGDhACA.NADHLBHHOAHDKDHF.bGAGhABA......hACA...,2,-35,-7,28
GXdWFbVNTgRPBHYEOaIJQSKMAeUZLDCcf,eADHLAGFDEDA.CFDCGAACdAFEFGGC...VADH..NAHERDBDBFAFhAAA.EEGDOABH.hACA.aHEAJFDDKDHBMFBDhAAAADAB....cFAEXGEH.WCHHhACAbDEH..PHBE.hADAIHHB.,2,-23,-11,12
UJGNgcfbFdaYBTQPWAZCDSEIXReVOHLMK,ZGDASBCCEAGF.REDF.eCGHHCGDKCDAUGGAGCBG..gGADhAAAfFGHFDCFdAAChACABDAEQGAChADAAABADAEEIBFCXADE.......hADA......hAHA...,1,-5,-24,19
PDUdRNOLGgECYJBeXcbVIWMZFSTAfHQKa,QACEKGGDDFAE.dGFCOECALEEAGAEBECGH..CGHFBGCHhAAAeBBG...XFAFhABAbFCD.IAGFhACAMDAESCHHAEBG.fGEGaDDG.hAFA......hAIA...,1,-23,-30,7
EZSfURDcJQONBPVCTFWeILHdXKgaGAbMY,MAAHZCDGUEGEDCFA...JABBODBA.BFBECHBH.FGGHeEAFLDHDhABAdADD..KFCAaGEFhACAAHID...EEEASGFDhAAARGAG..NAEFPBBC...hABA......hAEA...,1,-20,-46,26
gAJdXOLWCPNacHUIFYeBGVMSKQDTEZfbR,JEEDOEEALCGB..CBGHaBAFUBDAFFDDBHAH.GCAGMIEAKEBHhAAADBAC.ZADH.RFFC.AGGCdFCAhAAA.....hABAXAGAPACBcAFGIHHB...hAFA......hAIA...,2,-33,-30,3
BVdKfYbWCINRFaTgJAceGDLMOQHXESUPZ,GECADAHDLFCGMBAAODAFQBAEEEEG.UADDBAGD.KCHH.hAAA.fHDFhABA.bDECCCDGIHHEhAAA.FEHHTGGFAAIDcGEBeEAD.XBFDhACASHAE.PCEAhABA.,2,-32,-6,26
OEXCLHJDbMGKFYfIgARUaZPBQVedWScNT,RCABaEEEBEHF..eAABSCDD..cBFDOCFAXEABhABACGDGHGFE..DIBEbACFhAFAMFDAGGAB.YHFEhAGAIACEADEFZDGBPAFC.QFABhAAA.WAEF.hAHA...,2,-19,-11,8
LcPaBRGbfTQZIAOEKWNCMgJXeVUHFYdSD,OBBCEFFCKBBF...CAGE.JFCHeGEG.UEBAFBFHdBHALFAF.hAAA.aDAHBCHGGCDEhABATEFEZGEGAAGB.MACAhAHAXCAG.YAAEDIGG..cCBEhAIA....PDDAhAEA.,2,-36,-18,18
VOgXPbZRLAeEKYBdCHacISFMUfQJTNDGW,KEDFBBGBCHBG.HDDH.aBAGSBEE.FAGAfDGDhAAA.TGAFDDAAGCEAhAAAVGECOAEGPBBCREGHhABAADACEEBEdEAE.MFFCJHDE.gBCFXCGE.hACA......hADA...,2,-23,-1,22
SLYDbAOCJUNHEgfIGdXaFRQVeKTcPMZWB,OCAHCGCAUCCB.HEDE.EABE..IGGBdDHAFGBHQBDAhAAAKAGG.TBFEPEAFhAAAMHEABBAHSBBDhADADCFAJDFG.fAHEXFDF.aHGEeABEhAEA.....WFHHhAFA..,1,-4,-35,31
XENTfRYgUcSIPeLDHMQZObKGCdAVaBWJF,BGADFGFHEDAE..TACDRAAE..UAGFSCACeDECLEHHhAAADICGQAFCOFCBKEAFhACACEDDdFHCADDG..aFFAXFEAhAAA.NAIC..fFBE.hADA..cDDFIHAGhAEA..,2,-42,-14,28
fBESFIAOQPbKcXTJReHgdZYCDGLUVNaMW,OEGDQCBHKFCA...XGACRBFHHBADZFAHDEGGUGGF.VADDhAAAMIDG.BCECFFDAABGChABAPADA.TEEFhAAAeDADdCGB.CHDA.NAICaDCB..EABHSGHHhABA...hADA...,1,-7,-13,6
NKgETPAHfZMdeJcCQWbVYDXaORFSLUGBI,ZAFFdGGAJAEDCCAA..QFDD..bEEBDCIH..OCHFhAAAREAFLCCGUGACBCAFhABAKGGFEAHHAGDGHDAC..hACAMABG.eEHB......cBFDhADA..WHAGhAAA.YBBC.,1,-21,-28,7
BgSLMXAYWUdfbcJeZQNDIVRTOHaCKEFGP,UCDAdDBB....bFGFJAAAZCEGDGHB..RFBDHACCKDGHGGBDBBBDSBHBhAAALDAFAFID.hADA..fGEBhABAeAHD.NCAE.TEBECHEG.EFFB....hAEA......hAFA...,2,-30,-10,20
PALgVHGFXdQTeIWNEBUDKaSJZcOMRYfCb,LDFCHCEAFGCCdDBDeBEE....NIDHBBCHKDCAaBAC.ZFCCOFHFhAAAMIACREFA..CFAHAABA.hAAAGECDXDABQAFFhADA..IGHC.EAHDDBIBhAEASBBE.hAGAcFAH.,2,-16,-15,1
JQdVMCARfLYIeFgGXKbWSPBHDUOETNacZ,LABGeFCDGFEDKAFA.SDCEHEEBDGHHODDBECAC.aDAFZACChAAA.QBGHhABAdCGDCCEAAHCE.YHEAFHAC.hAAA....bEAFBEHBUDFBNCCG....hADA......hAEA...,2,-23,1,24
GbDQHSNXeMAYLaPdWfTJOVIcBZECgURFK,aBFBdAFB..TGDBOABF....IDFGBDDEZFEB.gGGFhAAAUBBCFECBKEAFDEACQGAFhABA.hAAANFAH.XBEG.AEEBYFFEWBGHfADHhADAcGBHCHGC..hABA...,1,-23,-38,15
bfIUdLQGDASCKXRcMeBVHFgPZYJEOWNTa,KDDCXDFAMDGHBHDEHEAGFGDB..ZEAEEHGEOADG..NAEF.hAAAaCGA..IBADhABAdFHEQAAHDBEBCGFCeCDDhACA...gBGCPHAC..YFEHhAAA.TCAFhACAfGBG.,2,-23,-11,12
EcZPfBCMFDHWAaVbYedOLSgXKTGQNIRJU,aAHBVAAG..eCFFOEFBLABA.XFGHKDADQGGFhAAARGBGECDD.ZEBGBFAFCEHHMAGFhADADCIHAEGGdBHG.SHAChAEATECDICABJBDD...cAEEhAAA.....hAFA...,1,-10,-18,8
WHfMQZFeIPVLCBbNROAcgaJSEXUGDYKdT,aFCHJFBE...EFEGUBAFDIFE.KBDG..TEGHHDAE..MFADQAFChAAAFGDD.eACEhABAVFFABBDG.bCCGOBHFhAAAABBFSBHH.XGEG.hABAYHAAfDDDhACA.IHBD.,1,-6,-26,20
ScaeCKIQTPfRHAYJVgZUbDBdEOLMXNFGW,JAGFVFGFZABA..UGBDBHGG..dABHEFAAMFDE..FFDBSAGHhAAA.aDEACCDGKGGChAAA..QAEFhACATCABRCEF.ACCD.........hAFAYCHBDECB.OHAChACANAIE,2,-44,-31,13
OeAHQYSRfCaVEGPgDbFJXdUTMLcBWKZNI,HAFBQBBCSACAREFH.CEHE.VAEDEBAGGDDGDHCC.JFBHUEAChAAALHFEBFEFKDGChABANCAC.eFHFAECH.aAHH.hAAA............hABA......hACA...,1,-18,-21,3
JMVfUDSAHaQWXTRZIcKECGYBgNLbPFOde,QADFXDGFREED.ZDEE.KDCBCACC.BHHELBDD.FHBEeFCDhAAAMAAHVBAB..fAEBhABADBGBABIBHFFEaAHDhAGAIGAB..cECC.EGHF.hABA......hACA...,2,-23,-18,5
cOfgUDaGVJIAWFeQdbXSNMYEBTLZRCHPK,eFBAQGGHdCAH.SHCCMEBABHFELBHFZCFCRAAC.CEFCKCEGhAAAOAECUEAFGEGGhAAAIHACAGAFFHCA..bBAGhABA.....NBBDEDDD.....hABA......hADA...,2,-21,-8,13
VbGDXeECSaPHAgWUFOBdQJfZYIRMcLNKT,UAECFDGDdAFCQCADZFFG.RDFA.MCBHLFHBKCDA...bFDChAAADABE.EHAG.CHCE.PABChABA.ADDDOAHFhAHABDCD..fADCIGBB.TAGEhAAA......hAIA...,1,-9,-43,34
JABQNKIVdRYFTLSGgeDbEWUPXOCMZcfHa,BFGCQCGCKACAdGAFFBBCLEAAGEADDICA..ECEEUFGBOFEDhAAACDAEZAEB..HBAEhABAAGDB..IAHBhAAA....YBHFSHFG.eABEhAEAWDDB.MIAGfFEChBAA,2,-43,-15,28
IeNPLTbYUHdVZRcKWEMFQXSGBgCJAfaOD,aCBAOAHH.DBBAeDBHLCCF..bEEDUGAAdCGHZEGHKEDC.EAGEhAAAQGECGACFCDAHAIEEhABA..IHHBhAAA.TAEHHFCH.......cDGHhABAMFAH.SDAFhACA.,1,1,-36,37
LPNgDIAOTcCKXRYfdbQSVMWUaBJeFHGEZ,OEBHTGFH.KDCBRCAB..dGAEQBDE.MFIFaDCFBDGBhAAAeFGFFAGEGABB.EEFHhABAPGCCDFEFAFCBCAHEXCFDhAAA..fAFDSABEWHCGhACA......hAEA...,1,-18,-28,10
CWSBMLIUdNVJcXKRbYfADgaeEQGPZHFTO,DGBHeAAFGCCCZFEHFBHDOBFB..SEBDMEIBLABBhAAAUAEHdEGDJFGF.KBCHRCGF..hAAA...fGGGhACAAFAGaAGCQGDDHFCFCAHCBDEDIADD.hADA.cCBC.YFAFhAFA,2,-26,-6,20
dIQYTCUBJHWcSDNFLeMaAbRKPGXEOVfZg,RGCEKBAEGEEHODBAZBBF.dAGBQGEF.CDGC.BHBGHFBDSBEBhAAADFFAFHGELAEChAAAaCAFAGHG..PFAAhABA..EBFGfDDBYCAF...hABA......hACA...,2,-24,-23,1
XabKTgUILGMEYcSfHeJVdDBROPAQWFZCN,QDDAFCCCCGCC.aDBDKGGA.UCFCLGEG.MCIDEHDE.SACBhAAAeBAD.VAFAhABADDIFOAFAACBDZDFBbFAGhAEA..IECC.....cEEChAAA.JEAFBBEGhAFA..WBBE,1,-7,-37,30
XMeaIPDfQANSKOGcJVUgYTCWLdHERBZbF,KAFAOADAGEAH..JBDBVEGHUGEB....TGEACAGHdFCAHCGBhAAABBCDFDDA.eBAHhAAAIDBGDAIDADGESBEGhABA..YBADLHAGEEEEhABA......hACA...,1,-11,-38,27
IXfEcSBJNATWUdOPHMeRbVaZDQCgLKGYF,TCCAdCAFHFAD.eFFBRBFG..aEGBQGDGCHBD.KCHDFGDEIAHEhAAAEABGBEEFABECUDEBhABAMIDC.ZBDGLFAAhAAA.XADFfABHSGHHhAGAWEAE......hAHA...,2,-22,-1,21
aBOMWXfJUgDZRKGbTVdCeEHLYIQSPAcNF,FGDCBEEAMEBC..fHEBUAGCZDFDGABH..TDCEhAAAdHGFCFAA.EEGCLCCAhAAAQFAAAABC.NBEDaGHFhABAXGBHDCGB..KBCD.eCAF...hAEA......hAFA...,2,-23,-18,5
gdKFLHXMRCcQEGUVZeATBONPWfYSDIaJb,TBEDBEHEOECH....PEEGfADGDADF.aGGGJFHBhAAA.dBGEFFABHCAHXFDFhAAAMAIFRGAG.CABGEEDBhACAUBAF.eAEGAAGE.NIAHSDEGIHFE.hAEAKBHH...LHFAhABA.,1,-3,-21,18
BOFGENHXWDCZTagPYIcMdfSRbLeQKAUJV,UCDEBHAEGECHHCACDDFCCAGEZFAA..TGFB..aDAA..hAAAgGCAPHFA.hABAIFBAMAEDdCHCfAEDhAAASBFBbEFEQABEABID.hABA.OABCEFGA.XAGFhADA,1,-7,-27,20
TJUCScVdZPeGWIQNXEabBMHKDgAOfFYRL,FAGERBDDLBHHUDCA.CHCH...VGCAdFGDZBAHGEAA..QGEHhAAAEHGABGGFKAEEACCBOGAAhABA..TABDhAAASAFDeEEGNCEFaEAC....MBAFhABADDDBfACHhACA...,1,-11,-29,18
ZXNYaFESLfcUbTVHABDIeWdPGCJMKOgRQ,DEDHeEBEdABBCACF.KCBHRFGH..ZAED....XBGAaDGC.FGEGLHAEhAAA.fBDAhABAbBEDHEFGBGHAhAAA..IFFEPHBCMFAFgBGDhAEAYADBEBBB....hAFA...,2,-33,-16,17
TRZSDEKINHcaVgWbBfLFYGMXQJdOCAUPe,UADHeDAHRGCADBCD..KBBBHAGF..aFCGVFEC....gBGHhAAABDFAFDHDMDDBhAAAJADGdGGGCBAG..AGAE.PCEFhABA..SGAAIHAG.NIBD.cDGEhACA....hADAfEAB.,2,-33,-17,16
IQKLgJXDbSFAcEeTMWYdNVOZUHaRPGfBC,eGECMABFdDEAOHFCZEBBHBFDRCFE.GEGGBEEFQFAChAAAKADDLAFEJBCBDIEC.SCADhAAAAFCEEABA..TAGBhABA..WHDCYAED.NIAFaEGEhAGACCCG......hAIA...,2,-17,-9,8
aTEUJcGFAbNZeSKHMWfdIOLYRBPgQCVDX,ZGBESBADKDBBHAEFMFDHdFFHLDEA.BBBHgGFFhAAACEAG.DDEBXAGBhAAATBFBUGAG.cCBFhABAADDDbGFEeABE..WAHB.OEHFhACA...YBBChADA.,1,-13,-31,18
PURIHXTJSABLZMENKgceYaVDWGfOFdQbC,LAEDMHFEKDHH.eGCA..VADCDBBDGCFAFCAH.dGAGQEDEhAAACDCG.UABChAGAIBHAHCECJHCCBHFHhAAAEAHDNFBF......YFHDaFFA.hAIAWBAD...fAFChABA,2,-24,-16,8
RJZTgPfMQEdHKUCWGDNVaFSBOIeLXYcAb,JFCETFEH......fFHAEEDAKGBFUCGBGACBNBCF.hAAAaAGDBCEDODDCLCAFhABAXCACACDD.RGDCZFADhAAAMEHDdABCCAHBDIFGSCHH..eFCBhACA.....hADA...,1,-14,-16,2
QCJcMUFIPEYfbSeDZBRHGAaXdLNKVTWgO,dDCAKAFB...TAAGOFDDQGBHCABB.JEFEMDFE.UDBGhAAAPAHBEFFF...hADAfBECSEDEhAEADFIFBAHFHFDEAIFEaGHDNACH.....gFAGhAFAIHGFeBFHhAAAZBBA..,1,-1,-33,32
PIaQBKXcCNOMDTHLVZUSfYFWeERbJdAGg,GCAH..PFEEIEAFBGBEKAACCABD...MIBGDDBBHBCAhAAAZCFCUGFCSBHFhACAFGAGEGCA.JAEEAAIFaACE.hADA.QDGB.cEDBNFEB.OFHDhAEA....hAIA...,1,-16,-31,15
YacNTOSHEgCbeGKUdXLAWfRFZQIBPJDMV,RCEHFFGDZCABQGAGBGHB.DFFHMBBG..VBCGaHFE...TCAGhAAASGCF.hABAEDHHCEFBeAHFKCDFdAGGXAFFhACAAAEA.IFDC....hADA..YHDEhAAANCIC...,2,-39,-12,27
NVdSQaAKbBGfcMePHgFCWDIUOYJZETLXR,BEEAGABHMCECeEDEHDADCCFE.DABHOHCAZGAGLACAREAE.dFGChAAAaAGFAIEE.KCAC...hADAfFGFPDCGFAGEhAEA..IHHC.YBHB.hAGA......hBAA...,2,-21,-17,4
RedTLcZWfACFDIGEOPHXSYKUMbgJVNQaB,DCEBGDBEECGC.OBHHHFBA...XBDBSGFDKHFAUEEFhAAAMDAFJCBBQBAGhABA.BHABeACAdGDDcEFAhAAAWAGF.ABHGCHAH.FGHD.IBAG.hACA......hADA...,1,-15,-17,2
QXTEDBHbFMSNRGYcaVKLCgUAPWJdZOfIe,JEEGdDEBZFAD.OAGFeGAC..QAFBEBABDHEA.BCCGFAEB.MCIBhAAARFGB...GGDDhABAaFCD.KECCLDAAhAAACDAHACFB.fBBBIACE.....hAEA......hAGA...,2,-30,-21,9
OMYVAFKgbZIWedCaSQfNUDRXEPJHcGBTL,FDACKAFDZDFAeFFEdBHE..SCCAQGDGUAGBDBED..EHFAJFBGhAAA.GGDHLAAHhACAOABAMDCBAHAD.IEADhADACBBG..NAFC.RGAGPFFCBCHD...hAHA......hBAA...,2,-23,-10,13
BbDPQYUXdRecaMSJLGHZATEIFVWCNfgKO,EADBFFEACGBE....fFDDKDCHBCBF.DHEG..QAGChAAAUCBGdGADRBGDeBEDMDGFSFHDhABALAAF.HGDAhACAAHHEIAFE.NIED.OEAB..hADA......hAEA...,1,-16,-33,17
PODCIQeNMTJSGUAHVbFfZWKgLBcaXdRYE,HFDBFHGGZFEDKEAEBAEHaBAB...dCGDEDEEDEAHCFGG....QAFDhAAAMECH.SBCBhABAAGBD.fECHhACALAAFRDDFOFAHIBCG..NDIC..hACA......hADA...,1,-5,-48,43
MENdKRgCFIQBDefVaTObUZSJWLAcXPHGY,XCCDGEAHEBCAdBGARAEF..FFHHQEGB.DADGfGCChAAATFDF.OBABhABAUFBESHEAhAAAJBHHAHACHEEFMIFCNBBDCHHFBCAD.aGAH.....hACA......hADA...,2,-11,-9,2
MKbUHedTEZIcaVXNCFJLgGPDSWfBYROAQ,MDDBUBADdAEHZBBE...aHEEXGCG.FGGCLFEGGCEHSAHBhAAAfDDABFAChAAAOEEDQBGDhABAbEAF.eECDIACG.cAFFhABACHHGJHAADBDD....hACA.WEHBAFIF,2,-19,-13,6
AOCKFTgIQPXdMVWNbRBaGcYfEJLZUHDeS,CBFFFGFH...TEFGQEDEdGCG.MAADVBDE....NDDFBAHDhABAaAHFGBAA.hACAfAFDEFFGJFADZBBEhADADFEBAGCBKHFEIHHFPDHFWEAD.cACBhAAA.LDHHhABA...,2,-23,-17,6
ZaHVSbCQKGfgWUdPAJFTeNYDMXOIBERLc,FBHDeCAGDGIBOEACBFAB.LHDCZECD.aDGHHACG..SDEFhAAACGFFKDAA.GAGGhABA.fGBFhACAgBBGdAEGABADNIAHXFGA.EBBGcGFDhAAA...bCFD.hADA...,2,-35,-8,27
XGNQHOgIBJeFDVTMEWLRadfZbACUcPYKS,CDABUCGH....PCEGKGHBGGAF.HABAOACGBDEGFGFAhAAADDDFMEFALDABhAAAaDCDZGAGADCBSHEAhABA...XFDENIBDIAGEeAFGEBBBhABA...WFFE.hADA...,2,-27,-22,5
LMAJdTeEPRBUbZHQXWOSYgaVFCfcDKIGN,dCGDeAEBEAAGBDGCZDBBHFFFQBCD.OAFGSFDG.hAAAaAEGFDDHCBDG.DEIBIEEChACALFFH.JCAFTAGChADAUGCFXBGA..YEHHhAIAfABA...hBAA...,2,-20,-14,6
KZfCcRBHFGTdaMDNIbYOSWUQLeVEAgXPJ,XGBHJABFZBEF...CHGHBGDDHECEFCGAdDAA.MADGDCDG....hAAA.IGGGOFECSAAHhAAAQGDEeHAGhACAEDDDABGBKDFE.fAHC..hACA......hADA...,2,-44,-22,22
XUbYdEgfHTNDCLGABOZIJQVeKcWRaSFPM,BGFDZECBQBEAKHGARAEB.FBHBMBBD..XDADUECHdHCDEFGFhAAAHBGFDABC.GACChAAAAEIBJFEB.eFFE.aAHFPBCBhAEA...gGADNCAGCABB.IHHDhAFA...hAEA...,2,-13,-13,0
KLNMIDfcWPJGROAgZSeFbdBaXUYHVCEQT,SGBDeCHDFFDCdACFBCCF.UGDGHAAF.EAGEQAFDhAAAKGFBLECDMDECDFBBfBAHhABA.PEEAhACARBEHAIHC...ZEBHaFFA..YFHHhADACCDCNIAD.WAHB.OEABhAEA..,1,-3,-18,15
HNAdCVXKDMPWRfUgEBYaLOFZbTJGQcSeI,CHHFKFBADCBAMEGF..RDAE.UCBHBEEBLADAZCGB...JHDAGFBHhAAA.SGAGhABAeCEDIHBGAADFdBFA.hACAXAAC.fFDBECDA.OAHDhABA....hACA...,2,-35,-34,1
APGagdRfXJYEUZBQcNFHOVWbKeSDTIMLC,GBAFdAFGRDAA.JEECUFEABHCG..QACGFAHHHFDH.OBHDhAAA..bADASGDDhABADGHHMDDC.AIFGaGGAXEAGhAAAEAGC..cDFF.....hABA.....WDHBhACA.eDAG,1,-12,-28,16
OaMdPICfbTEALgWFUeGHQVcKBZRYJSXND,LDAHFEGDGDCAVDCDBBGC.ZAEBRACG...JHACXCGC.hAAADEIBaBADdHFH.CAAC.TACGhABAAAIB..gGAAhACA.eAEEHGEAKFFANEIGMAIF.hAHAIEAAEBBB..hACA...,1,-7,-25,18
SRYKXUHAaTZWNdOBQFECeMPLVbJDIcgGf,aHCAZAFAdADGBECHQDDF.FEBFCGGDMCAHLFGB.JHDEIAGHhAAA.GABFhABAfCHESCGBhACARGAGKABD.HEEDACAB...TCDD.NAIEeFAHhAEA....hAFA...,2,-21,-18,3
GNMfbaSPQVTEeCHADWgcYBZIJdLKFRXUO,DAHB..gGFABCGD.ZDBAdBCFFAFBRDDAUFBGOAAAGEGChAAAMEAD...aAEAQBCAhAEA.EEGECCAFAIEEhABAYHBEJDAE.LDFE.NGCHSBGAhAHA..hAIA...,2,-38,-12,26
bGUCPYLXfMTIKgHVAEZSJQRcWOdeFBNaD,ZEEBQEDCRFBG.ODFCeACGBEDG.DBCBGBAHUGGC.CAECLBFChAAA.fFGEhABAIAHAKBFAhAAA..HDAHAAFGECHFJHAG.WHFGFBAFNEAC..hABA...aCEC..hAEA...,2,-29,-6,23
GeHTcNOfFZEDKMIYVCJUdQPgWXSBAbaRL,RAACeDGFHDDD..TDAEOHEAZEDHDCIFKABHMFBH...VBEEhAAACBGHUGBF.QADGhAAAPFFE.XCDEhABABAGE.AIFAaHGALDCDNCIA.FDAB...hAFA......hAGA...,1,-10,-14,4
DSRgVHXcOaYZPBAQGUbCEFWdfKMTNeIJL,GEGCCHFDFHAE.dBFFKAAGMEDH..eEDFLCADDEAA.RCCGHFEBhAAAOFGFaEBF..ZBGFBABBhADAAFFC.QGADhAEAECFF..TBDBNBIG.SFAEhAAA......hACA...,1,2,-41,43
MHQfVaNJGdcRTIPbDFBeXAgZCOYSELUKW,CFEFOCAF..EFGDKCEDHDADQFGH..aBCEJFCBdDFDRACC.hAAAIFCBDAGBBEFEXAFAhAAAAHAGZAGD.SHFGhABALHEAMCCBfACH.NCIGcGAChACA....hAFA...,2,-32,-23,9
IaYDJBOfbVPTNeMRdUEHZLSgKcFWCXAGQ,QBGDaCFH.JEBBBBBH.OHCGVFDH.TGGA.MAGHhAAARADBdAGBHDBFSHGGhAAAKADGFFAHCDACAHHGICCGhABADDEF...fEED.NDAAEABHhADAgEGC.hAFA...,2,-22,-22,0
LRgWdIAZMKODfSCTEeYFGHNJBVXbcQPUa,MBEHKFADOACFDDBA..CACF.eEBAGCGEHGFCBGCB..XAADhAAAQGADaBHDLBEChACARAFFdAAGZGFA.fEGFhAEAEEAC.FGCBNIDD.bFDD.....hAEA......hAFA...,2,-21,0,21
YMFOZRbKSBdALQeUHXcPgJfDGWaCVENIT,QAGFeDBEHAEDXBAG..cCAHJGDGDEIDGDEFhAAAaGAA.CGGEEFAC.IHAGhABAMBHHOEDERCCASBCChACAACED.PFCDfHAB..hAAAWFFDNIDFFEAA...hADA...,2,-17,-8,9
WFTUIDBJPdKAHLCZfNERQYbOVMXcSgaGe,CCHAZAAG.EAHFRBBF..QFEBOCDE..VFFAMHBA..SAFBhAAAaECDGBECFEAFIHGFhAAABCCFdECAAAHBLABChAFANIDD..YHAE.cEEBhABA.....hAGA...,2,-27,-14,13
WcNPQbdTIZGDUgMAJaVBFXSeYHCRKfELO,JFABaAACBCDB..FGECeEFHHAFE.KCAFEAFFLCFG.OEDEhAAANBHAQFAGhABA.dDBHZBBADIFGMABGhAFAAAECSGDFCGGERDBC.fCFC.hAHAWEHH....hACA...,1,-17,-34,17
BaXKREGSMCTVdWcNDfeZPAOYFbgHIJQUL,FEFFHEEAQGCCUGGGBHBAKACGRBGFGDAE..SCCEhAAACACCdCCB.NBBG.DGEDeBHBhABAAAEGODDB..YAFDhACA.IHHAaAAHXAEAMEAH.hAEA......hAHA...,2,-29,-18,11
EgaFYZISfdNbDAQWCeRBTLMXVJUOHKGcP,QBEFCEAARCFA.LBHDXCDDUFEBKFFH.GDBA.EBBChAAAaGBEFGADZAAE.SBGEhAAANACFDIGG.ADCGeCAChABABDDFMICE.OBAHPEHHIFHBhABAdGAGWAEC....hACA...,1,1,-28,29
LVJNKPXMRQcgIbEAGTOfZYSaFWBdDHeCU,OADFZCGDaGAE.BHCEdCEEHBAAUAAD.LDAG..NEHGKGECXGEFhAAA.MFBEQBFAhABAIAFHAFBETDEGhADAfGHA.SGDDDEIHCDCF.PABGhAHAcGAC...hAIA...,2,-35,-13,22
YdIVOUQRAFWcZKSGBCLEMNDeTHJbaPgfX,FGEAZDAGSBBEGBEACHCG.LEGD.MHCEeCCHHFADaAAD.hAAA..fCADhAAAXAGFIDAHhACAOAHHRECCAABAKDHBNDIGDADGTFAG......hADA......hAEA...,2,-28,1,29
edOTHAWNVaDEUMGcIPgCJBKRSQFfYbLZX,VEFCaDFG..DCGEEBDEUEAB..GEDE..IEDGhAAACCBCBHAHKAAFSBADhABAFAFE..fEAAhABAbBBEXFFBdCGHODCGABGCNIAF..MIFG.hACA......hADA...,1,-24,-25,1
fAdTPYMDaSNcbJVQRgGIHWFeBEKLZXUOC,dDBETCBCMFAH.DBIFSFEA..NBAB.JEHD.REAGGAGGhAAAHEFBFFDGEADBLEHHhAAAUGBFCDEE.AGCHaHCE.VBEEhABAIBAC..BDDD..XAEFhABA....hACA...,1,-16,-17,1
VaQAEWLFCYfdIGNRMcPeKXZHgSDbUBTOJ,LCEDFBGACCEB.dABAGBBEMBGD..eEHFXGFGZFBDHDAEDGEFBACBhAAAJAHF...aHAGhABAAAFBEGFF..fDEEhAEAIADA.NDIG......PDGBhAFAKAADSGAFhAGA...,1,-17,-29,12
ePUSbcEIKdTHaWVRNZLADQBYJgCOMGFXf,BEBFJABC.OEECFDFH..eDDFUAED..SBGCEBHDKHDGHAAChAAA..aHECRCDA.LCHBhAAADGGG.QEADhAEAgFAACGHBMCCGfGEDPHAEIHHBhABA...hAFA...,1,-22,-28,6
ZKJTOBPLaSbIHEDdAcXMVYUNWfQGRegCF,MFHHVBGF.UECF....NFBB.QAAFRCBE.CGFBZAGFJEGHOAEGhAAALBDGaABCIFAAhABA.DIBGAIGCXGBEhACA..WDDE.fHEDhADA..eBEBhADA...,1,-22,-33,11
JYSaDdKcgObMRAXCZTNEILQeUHfWFPGBV,ZCDFEADGLDBFUGFDHEAFFFGEBCHE..JAADSCAEdECD.hAAAKDGDOBHD.MHAChACAXGCHCHHB.NBAB.hAAAeDEG..PAFEYHCGDCFH.cAFAhAHA.....hABA...,2,-31,-17,14
EfVcYBDNOMGICgSWQRAKHeJPFZaUXdTbL,KEBBJAEEZCBCUBCD..dEGELFFD.ECHHVEAB.BFFFOAAGhAEAGGCF..IGGGhAFACACA.SFDFhAGA.WHAGAIAG..PAHF.hAHAFAAGaDDCXCEBhAEAfBGHDIFA,2,-43,-33,10
YEVIMLdSJGDZXOCBfWUgbRePQKANTFcaH,FHAEHCEEEEBHMHCG.LFFGJFDC.GBAFDEEGZABBOEAGBHFA.hAAAfADDUBEH.hABAgAGCeEHDKAEEAAHHhAIA..NICBaFAC.IAACSDHBCEGE.hACA......hAFA...,2,-33,-4,29
gZMRXbLQeDIEHOWAFJdPfVCaKTSBYGNcU,dABCVFFFCAHG..KFAFBCEC.GAGCUGCHZFFFRFBELBAH.DADBhAAAEAEEHDDGAFDF.FGAH.hAAA.JBDF...aDAGhADA.....TCFANACCMEIH...hAGA......hAIA...,2,-41,-11,30
ZMIEBaYegJfDWLUXGbAdKTNSCPFRVOQcH,KFDFTEEACGBG..RFFC.QGBGHCDCZABC.EEGEBHEE..eADGhAAAJEAE.fCDFhABA.DCAGLAHDhAAAUGGFbCFEAAGB.SDBDPCAA.OFAHIHHAhACA.aADA...hACA...,2,-23,-7,16
aUJKBLAWVTFRfdPQIEGeZcHNbXMCYDOgS,TACBREDHdCFG..QEAHGEAHeFFBHABAXAEFMFHBCCDE.DHDChAAA.SAHFhABAaBAHKBHDADDD.FCAF.IDDFhACAEGAH.NBIEODGD......hBAA......hBBA...,1,-6,-22,16
FKCXMgOIGSYeEbWDfJTVPBNALcQRHadZU,QDBHaAGHZDFG.KHCCCCDE...MABHOFGHGDGC.SEEChAAAECCDDICC.fGAHhACAVFACBBAHADDCRAEHdAAFhADAFADB..IAEHeFFB...WFHHhAHA......hAIA...,1,-5,-36,31
MdINSZYTHQfOKAWCgeDPbcLVaJFRBXGUE,CGHDDFFB.....PAEELBEG.aHFCJCDHBGBGGEAAEDHFdDEAhAAA..IDFFhAAASEAGTGGAfBAEhABAABAH.eADEcDGEFCCH.XCAAhABAMEGFNIAB.YHCAhACA...,1,-20,-38,18
WCXQFPVNbTgLDASYGBZRaHfOJKeEUcdMI,SBFBBHFBaDDAHAFFOBCH..JFAEEHBAdEGH..MEFECHDFFABDhAAAVFGH..TADGhABADEDHAABBZCAF.fAHAhAAAKDAGeAHBIHHEWEED..XADBhACA....hAGA...,2,-26,-22,4
CVaIQOATZcXKNbYgDGfFSHRdPeBWJUMLE,ZBECXEGHKEDD......NBAG.gAAFDIBGGEECFGBDRCBF.hAAAdEEBBGHAJDBBMIEGhAAALBHB..EAGFCGAC.hABAaADH.OGDCABBF.bAEB..SHGGhACAeAHH....hADAWDDF.,2,-26,-19,7
WDGbegZMHYXaEdCIcKFLPQRBUOTfASVJN,SHEGJCEE.DFFHeADHZAEF.MGFCHBAB..XBAHhAAAEHGGCBHFKHACLFAC.hAAAPHFGBDEDTEBBhABAAGBB.VACDNAICWFED..gEGBhACAdHAHIACH...hAGA..FEEA,2,-18,-12,6
cFIbYHNDJgaLTfREXBVZWdPSKQOGeAMUC,CBCBFAEH....IDABbDFE..HABHDDFC.aFHHLGBAhAAA.TGFDRAGFEFFFBFDGhAAAZCDDdAHEKGBAOFFAhABAAEDAcDAA..NCCCfAFEWFAD..hACA......hADA.SDGA.,2,-17,-16,1
AdeEcgRTJXZFIaSfWVPLGUHYbNKBDCMQO,EGFBRFEH..JAGHZBCF.FHAE..aDDDSABF..fDHAhAAAPAFDGDGAhAAAUBBGHEAF.NABBBGHAhAHACEAHOFAE..AEGD.dAHG.eEDA..hADA......hAEA...,1,-14,-30,16
JDSTgIOURBNfGYAHWZaLCEMebXcFPdQVK,ZBEBLEFBECBE.MFCHeEGF...XDAGPACA..dFDDVGAAhAAADBAF..SBHDhAAAIGEGOABGhAFABDEFfCCEAEDFaAGACBDHFHGEKHGG.JEHH...hBAAgAFF.hBBANBBC...,1,-14,-17,3
RTFBYabCDVWfAQUIEdZXJNOcGgeSKPMHL,QAFBEEBAdGDDZAAD.JADB..OEEEGEFGeCCESEDChAAA.KGAFPHACMHCARCABhABAFACEBHHDaHGCDBGHfCGHhACAAFAH..IAHENDIE...hADA......hAGA...,1,-14,-21,7
XOLKcAQJSMRNVECZFHbgDadBfTWGUIPYe,SAEHMGCCRBAA.EEGEFBFE.HADDDFDDdBBEBDHG...fFHAhAAAGFEFIEBHhAAAeGAGOEFFKEDEAAIDQBGHhABANICB.CADFgGACaDAHWAHB.hABAPHDEXDDC.hACA...,2,-22,-6,16
eWKLFRTQXCOJHDdUBafZESPNMAgGbYcVI,GBDB..YAHBVEDH..eHAEKEDALCBCFFAARBADQGGFhAAAOFABJGFEdAGHBDHBhABAZBFBEABG.SADEhAAA.NIEBACFH.....bEBHIADDhACA...hAGA...,1,-12,-23,11
RagAfGYTQXcCePJDMKHSOUZVIFELNBbWd,GDAGTBDB.QDFACCBB.eCCCPFFCDBADKGGB.OGCEhAAAUDBFZGBEFAGEEAECBCGDhAAAdDEGaGABABCD...fAFFhABA.....YHEGhACA.XDGEhADAMICC..SCGE,1,-5,-30,25
cTKUaJOVIMASBRFgYHfZEdDQPeLXGWbCN,RDADFAHFHCDHEFBA.dAHEDEFCQFED.eACHLACB.XCEChAAAbFCD.CFGB.cCGHhAAAKEACUGGB.aAGHhABAOFHF.IABEAHDBBBBC.fAFBhAEA....hBAA...,1,-9,-31,22
XOKdeAEWaCcfJTGHDbLVZBQIPSgNFUMRY,EBEGCAFF..JCCAHEED.DDGALABABDBGQAAA.ICDEhAAASHCAFFAHMFDFhADAXDGE.KGBDhAAAeHFCAFCGaFGF.TCAA.GEEG.hAEAVAGFgEGBhAFA...,2,-22,-20,2
XLcZWYQMBHGNKadbFSDTJEgVCURefIAOP,XCBAZBCGQFEGBCGHGGCHKAHF.dEAGFHGGDIBAECAB.CDHD.RADEeFFGhAAAAGCC.LBHHhABA..WDDE.hACAMFADaECCSHFA..JAAA.hADAgGBG.hAFAfEBFIBBB,1,-3,-28,25
TdYUXgOcQWMFRCEVBbNPfHLSAGaeDJIKZ,aCEAeBFA.DDCAKCDDZFFFdFDE..UAAHOGFG..QFBBhABAFDAGCGAHBABD..NADFHFDBhAIAAHFF..JAFEYBDEhCBA..gDGAMFIFEDEA...hCIAPACG.SHCGhAAA,2,-40,-19,21
dDIPfAWQVLHNBYMXZKCcESOgGTJFbReUa,VDBELAAC.BAHEMDIDKEEA..CEGG.EAFFOAAFGCCHFBFFeFABhAEA.UGGBDCAH..hAFAIHEBACCAQEBBhBBA.NCHE.ZFAHSGEFTGGAbAGB..hAAA.aFEC..fGCChBCA,2,-34,-7,27
VCEafbMSHBXUTOIJDRGWceKAdQgLPYNZF,QBGFLBEE..PDEAZFGFCECHEBAA..aGFGMFBDBFCCUGEGhAAAOACFDCDARCACGBAGhAAA...eHFChABAAAFAdDGDgGAGNEAC.fDHAhACASABEXEECIEEAhAEA...,2,-20,-5,15
baJKSFADRTPcHNYfLOZBGVMXQWUgIeCEd,DCBHRAAF..TEGEHEDF..fCFBODEGBGCGMFHFQGEGhAAAUGACeACGCAHEdECHaAHDSDCDhAAAABHF.hACANDICLFFBZFAHVADG.WBAFIHHG.hABAECCBKCCC...FAFAhAEA...,1,0,-3,3
OKfNdJgDUbAVZTIGSaLXQFHBcMWCREYeP,VCCAZAAFGBFA.aACEQGEB.BCGCMHAACDABEEBHPDEHhACA..OBHDhAAANIAH.dAFDDGIBABCASFGEhABAFGGB.cFCBWDCHeAFE.KDAFhADAfHGF.hAIA...,2,-22,-19,3
dTHQPXWGaNRSgMbKZeCOBfDcJAUIFELVY,FDEDVACEdDGD.HADDQCEA..XAGEaHBG.RGFAMHAChAAAbGFCZAGF..eCBDhABAOFABDDADAFGEEEGCLACDhAFATBAH..WDDDNGCDSHCACEEDBAAC.hACA......hAFA...,1,-4,-12,8
cgfBZAYXbEDeHaSIOVGJLPCUNRQKMdWTF,XCDHDCAAeCHHHFFH..IFDCGAFCJEAFCFAF.RABEMDEBhAAATGFE.FCAA..fECAhABAZADAACHGEHACaEAAhAAASHDEODHF.PDAG....hADA.NIAD.KHDG.dFFF.hAEA...,1,-8,-9,1
LfQNGAYWDdMgCIFPTJbEXOBHeaRUVZcSK,DFCDMBBACBHG.FFFE....TDGGJEDB..EFABBADCHBEFaAEEUCAEhAAAZECF.KGHHLCCAhAAAQCGCAGHDdFEH..hABAIAHBPFAD.XGBDOCAH..eABFhAFA.....hABA...,1,-16,-24,8
OYVKJBZcWNEHXRbPaCLGSeTUDfQIdAgFM,FCBCMBGHOAEAKCAHBDCBZFCH.......NFDF.EAAAHGAEbFEF.hAAACFCDLHEEGEGCTCEEhADADBFF..IACHhAAAABHG..YFBF..cAGAhABA.WAEF..hAIA.XFGA.,1,-15,-28,13
RIgYWbCaKNPAOJeMBQSUHZVETcGXDfFLd,OEDAMAHDBEEDUDACZFCA..EEGAGCBFDGIH.FGHHdAAERAAC...hAAA..IGAAhACA..YEAHhABACHDDaGGFKCCEAIBEeCHH.SGFHTAECfGDBhADAWADE...hAIA...,2,-30,-28,2
IAdXeCbGKODNUSZFWVLcBMaRfTPEQgHYJ,eEFECCCHGGDFOADGDCID.UBBAZAEG..FGADLCFA.MHBChAAAaEDCRCFF..TAGFhABAEAAHHCAFIHGG.hAAAACAGdFBBXFCCKEEDSGFF..hACA..WADC..hACA...,1,-6,-24,18
fKNdPTZCBgbGcUIJWeYAHVEFXMDRSLOQa,VEBDXBEB.DEHDLAEF.QAABaGEGKDDF.dHFFTBGHhAAABAHBGAFGhABA.UEFB.WDAFhADAAACHHFAH.MEIHSCDDNADFCCCFbBADIEFHhABAYHBG....hAIA...,1,-7,-28,21
EXQJDTLcZfgBRUWHbYGSIPFCAKeaMdOVN,KCDAeFDEdBFBOCAE..EGEAQAGFDACALHAGZABABFHEhAAARCBDHEFCbCFG..SEEFhAAAIFAFFHEGAGCHaBBAhABAMEAA.XFBD.....hAFA......hAGA...,2,-27,-4,23
RdPDZQLXBWHKENSegcTUfOCVYMaJAFbIG,FDBEGFCBRBDD.DDFFZFAGLAGFBHBGHFEFKBDE..EAAHSGGHhAAA.eABCTDAHhAAAUCFECGHA.MAFGABCHIHFChACAdDHE..XBACNBIE..fCDEhADA.OHBEhAEA.aFAH,2,-15,-14,1
QMbIAdPDSfNKCOZLGWReUYHcJVBTEXgFa,DBAHSEHDKFAHZEGF.GBFE.RBCEeBABUCDFHAFG.JGCCVFBBhAAA.BHHBEDBDFBBFhAAAMIEG.AAECdFEE.fAGDhABANIEF.CDDGODAH...hABA......hACA...,2,-35,0,35
GBOQVKHNPgWAbUSYMTRaIZcEdfCJDFeLX,SAFCTECH.RDEGZABDdGGFJEAH.FAHFLBEA.GEAAhAAAOCGDQGDEhABAKACEHBAE.NDIE..WBCHhAEAAIFGYBEH.aGCHEGGFCHHG...DAIHBFFChAAA.....hBAA...,1,-10,-18,8
HNMRWaTQIdfCKYEBgXLJcZOSVGFPADbUe,UCEGHFDHMBCGRFGB.aGHDQGAH.dABECHADKCFEBEAELFFBhAAAZGDA.VCCCFDCHDBIHhAAAeGAE...TBADhABAIAFG.EADHJAFA.SEAEhACAAIEC..WAGH.hADA.YDFG.,2,-26,6,32
cFOYBDLUJQgebAXVECPWfRINGZMTSdaHK,EAEHCGGH.....fBHCNAIEZBCF.MCABdFDBKBEF.FBGFBFGAhAAA.DBBDUDAEJFCCeGAGhABAAEGG.XCDAhACA.PHEAIAAD.TGADaCBD.hADA....OAEGhACA.LFHH,1,-24,-28,4
TDMSZdRafUYVKCANPgQbLEJeGcHWXBFIO,...PDHFgDCC.QGGBECAHGDDEHGAGBHHAOCBBhAAAMBGBSAGBhAAAZAFBdAECaACD.fFADhABAYEFECABENICHJACA.cCCB.FGFG.hAIADCFD.....hBAA...,2,-7,1,8
YfPBFeGRSbDAVLKdWCXgOMIQcUTENJZHa,LEFHKFBDdAEA.XBGBMBCF..QGDFTGAH.JAHFZECFhAAA.HBDA.fABChABABHGGFEFAeAAChAAA.SGADAEAFCHHFOADAIEDEEEEBaDBB.hAHA......hAIA...,1,-10,-32,22
GZbUOCFLEBSKMJfDdTcXNIPAQHYgVRWea,HDADVFDE.RDFGeADCZBBF.OHCGCHGB.LFDCBFBBKAEA..MIFChAAADEAFdHABXCCAhABA.IHAFADIHQDFFhAAAYCFCaBDC........hACA......hADA...,1,-8,-39,31
DgQOIXTGNWKdPLFZRMbUeHASYEfCcaBVJ,SDEBEBGD.CFCF.BBBG.JCDHDGGHOGDA..IAAEhACATGAC.GAGChADAKAEDdDAHFGADZDFGMEAAeHFAhAAAABFBfFHG.aBCA.QGDEhAEAWAFE....hAFA...,2,-30,-29,1
ZYERLcWQPBdfMeCKUTVGgOHJbXFaSNDAI,ZAEERAAELBGFQGDHBGGBdFGC..eECEUDADGGAHOABHHADFhAAAJEDG.FCAH.NBIC.DIAGhAAA.ADDH.EGFB..PCHFhACACFAB...TFAD....hADA......hAEA...,2,-23,-10,13
ZHWDMKOTCGXVENbefSRFdUcaAJQPBLYgI,QADGBHGCLADE..ICABHCDCMIBCKFFGCHCBXEBGhAAAEDDE.eCHDSFDBhAAAdABEaGEFAAIFJAHB.PBFDhABAZEEC.DHFC.OCBD.TFAFhACANHAF..fBDHhAHA..,2,-22,-3,19
KJVDOTeFbBPdSRAGgYXQIWaLCUZMENcHf,GDEGXDEEQEAA.aAGCLBEACCDFZEGB.MFHDEAAGHFCBhACAfGBHKAEBDDAEhADAODBHFHAC.PAEAhAAA.SACBAEDC.gBBDhABA.IDHGhAIA.UFDG.,1,-3,-5,2
BQgAGdCUaWNKbEILYOHRJSFTXfMPDecVZ,CBEDUAAB..aHCAKFDE.ECDHLEGF.OFAGJGAEFDBHTBBHhAAA..XGGEhABAfEEAMAFFDBHHeAGFhADA....cAEABFGAAHEGdBACNBIA.IHADhABA.YFHHhACASEEE,2,-40,-28,12
QBSbWFYaTIDNdcRfVLOUMEAZCXPgeJGHK,XFABeDBAGAEAKEHB.BAGF..SECEFHCCaACD.TCGEhAAADGFFdDGE.RAAH.VBCChABA.UGCDAIAECEAG.JGFCQGGEhAAA..WBBF.IAHChACA.fDFEhADAOEEBEBHB.,1,-14,-20,6
FJHfIOeANZKEcDCLadbRVXYSUMTBgQPWG,ZBDFECCEDFECLFHF.aBFFdFAA.RACE...VCABSFCFhAAA.UGDDBAADQCAGhABAWFDGGGADFAGEJDEGhACA.HEGBfHEF.OAFAhABAAIHA......hACA...,2,-26,-8,18
KCZWRJENMTaQbAYVgcXOfPSHDdBIGLUeF,VEBDXFFB..OEEHSAFGHAACDFHHdGDCBBACLAFFhAAAFCDHCADCRAGHEHEC.MDIFhABATCFF.QGADhAAAABEH.gCAHfDACIHHDhABA.....hADA...,2,-18,-14,4
WBOIQbeDgXHPfRTNKFMcEUZVGSJCdaYLA,BCAGQEFAeEDHDAGEHFDD.RCCGKEBHMBECUAEGZFGFGBBD.hAAACEAD.aHFCLDFAhAAAOBBGICAD.hABAXBGBPFFHfCGHFHAC.EABAhAEA.SFAAhAFA...,2,-22,-4,18
VDLgMEFOTCeKQJfaRGSBPUHIZcbXNWYAd,VGDEDDGFMFAA..FEBAOBBE..eEEEKGAF.QABDhAAA.aBFARFDHSAAEhADABFABUGAHZADHcCGFhAEAXGGF.NBICADGEgGGE.hABATAEE.CDDC..hAFA...,1,-13,-33,20
NVdMCDeQbAKcSLTJRgGYBPEfHaIUXWZOF,SCDGLCCAREGHGFAHBCGB..EAAGaADEUGGEZFEB..FAAHdGBEhACACAHB.eBEC.ABDETDABhADAJBHH..PECGhABAfEFD.HGDCIDAGWAHBOFAHhAEA....hAFA...,1,-16,-17,1
HOZGWEFPfJCeRVcbKSgLBdMDXIQaYTANU,HFDDZBDGEABBFFBF.JCDAeDHF.RCAH...VGFGKGDHLFDEhAAABDBEDDHH.XGAD.hAAAaACATABH.AAEGODABhABAPDEGCHHBSAHFMAFA...hBAA......hBDA...,2,-28,-13,15
KMNfLcgRSJFZQaCYdBGUTOIWeVPbHDEAX,XFDHKEEGMBCHLHECRCCF..SBGHZADCCCHH.BDBFhAAATFADIGBD.hAAAeFFCPBABDIBGAAECfHBHhABAJAFBFABHaHGCdDEFOEEG.WCADhACA......hADA...,2,-23,-22,1
VSXDEQWBFfbIHKTAeRLdZUcaYNPJGMCOg,eFBCLAEGUGEAaFGF.....PGACJHAGGDDH.CCABOAHFhAAAVCBHDBAFEGHFQGEBhAAA.WDFGhABABFAF.bABBKEDGACEGZADENIAD..SBBEhACAfEHC...hADA...,1,-14,-22,8
LeZARXHQgETMcYUWKfJNFGCadIbDSVBPO,HFBAECEB.MDHFUBACKCDF..JFFBFFFHGFABdAAFDCEABAEBLAFChADAAHAH..RAFHQACGhAAA...hAEA....cDDHfHCHCEHC.IDBEhBBASHCA.hBDA...,2,-39,-25,14
dIbAHgZJGKSFcVWReELBTaOCXNUfDPMQY,ZGCCKFDAFCAG..VABGeBEEBAFF..aGAACDDE..UFGEDIACMBAGhAAA..dEAHAGHDHCEEhABAJAHH...SHEEhACARDEFEBAD.LEAG.OFFGhADANIAD.fAHGhAEA...,2,-33,-27,6
QRbdfXFAMOGSHZPgeBcKVUDYEaNIWCJTL,GBFGZDBDeDGDBAHBKEED.UDCBDGAB...EGGHaAAB....IBCEhAAAJBFELCBEhACARFBCdHBHFDADAICE..SDHBhADA.PHEEgADB.YFEBhABACEAF...hAEA...,1,-20,-34,14
cRKYGAeEUBgMVOTSaQILCWNHDJPdfFbZX,eCABEABFBBFHMAEE..ODCGSEFBQECFCFHBHCCEDEIFJGDChAAAdBHGFBHFZFFB.RFADKGDAhAAAABCG....gGBBhABATADE.aHGEIHHF.WBADhABAfCFB..hACA...,2,-25,-14,11
UdALaEMGPCWRfFIbTZSgDHBQXNcKYJOVe,EGGBGAAC.CEFCRBGBFFBB...IDGHZDBDDGDFBGHHQAFHhAAA.XDCAKFGEOADEhAAAeFECAEDE.aACFMIEChACAfBAA.TGCGSGADNCIG.hABA......hAEA..cFDA,1,-18,-34,16
fdLGZKeIJYAOQSRbUBCVcDEHXgaMNFPTW,QDCDSFDBRGAAUDGFBBDG..CDAHDGGEHBFE.aCBCMCBCFHGC.hAAA..TGCAdFFBLACEhABAKADGeBFCIDEFhAGAAACAOAAB.bFEDEEBC.NDIG...fFAGhABA...hAHA...,2,-14,-14,0
ZbUBOXRGEKJdcHLMPIgNSYQAFTefWDaVC,eHCADHFECGCA.UCCBBAHARAGD..GDFAKFFC.dFBDLFDB..hAAAMBBE..PCAAhABAICAG.SGAGhAAAAGADTBECaGBHbAEB..ODHFEEAG..hABA..cCGD.hACANADFFDDCfHGF,1,-5,-46,41
LBEKJYVdcIXRGDgUfHTPCNWOSbZeMQAFa,aGEHEEGEKGHD..JBDAdDDD....XDGERABCDAFBUGBHHBAF.hAAACHGH.OBABZDEHeAHFhAAAMAIHFDCD.BABB.hABAVGAGIGFC.fAGC.hADA....PEAEhACASGHBAIEC,1,-11,-37,26
QdVUAfWRZIBXgFONDGHSKCbcLaMePJTYE,REDHZEGFBAAAFACGDCEDGBGE.KHGECGAE..LFDEeBCE..TDAFhAAAEBFG..dHDFAIAA..hAAA..IGAFhACAXBAGNICH.SAHB.bCFGMDCG.hABAYADC..hAHA...,2,-30,-27,3
FJcIOCgKXPQYBdeSUGAHDRNWaTEVMLfbZ,DCAARAEH..aFECEGCGLBBFZBEHFECG...JEAFOGFC.CCHC.KDHDhAAA.QDCChABABFGBSFABAIACHGFCNICB.hAAA....WAHBMABE.fAGAhAFA.ICDFhAGAXACB..,2,-48,-13,35
VUBSZaROfGJCFeWDQMYAcgKXbIEdPTLHN,KGGFXADFEDGF.dEGFLCHBHCAF.UEDBBHGEZBDCRGBEOFDEhAAAGAAECAECFDDF.DBGA.MCFEhABAAHBE.....hAAA............hACA......hADA...,2,-35,-22,13
TeVUPIQCANWGLDcSOabYZJHXBfEMdKgFR,GCDGDEAEOFFDaCGFZAABHAAHBCCH..MDCEdGDHFAFBRBFG.eEAFhAAAVECF..UGGDIAHGhAAAAHBD.LFABhACASDFHJEHFXEEFfACCEADH..hADA......hAFA...,2,-18,-8,10
HUTNbQJcIDAdgfMELPXFBeWCSaYGOKVZR,dGEHMDAALCCBFAFFBFCFCADH....SBBFaGHFGDEFKHAARFDFHAAChAAAUBFH...NEAA.hABAQFAH.hADAJEFEICHHDIFAAEEC.EHFAXDAG.hAEA..WAAC..hAFA...,2,-34,-10,24
KQbeDPgcNUGAIWdSHREXVMFBYTfJZCOaL,dABHSFEEHAFAEEBFMADBFGFE..BEAFTAFFZCDH...OEBFhAAAaDGEKFCBeHEC.DDFEhABA.PCAHNICF.AIGCIHAGhACA.WDHH.....hAAAXCDHfCCEhACACBBD...,2,-35,-9,26
JERQBIFYgaANUZOWKPHCbeDGMVTdSLcXf,UFGFZDDDKGBFCCGE.DAHFGCEC..MABHdEBFLBBC..hAAAXGGGEHAABDACFAEBhAAAaAGAAFHBOACD.hABAHDFEeGBESHDEfCCB...hACA......hAGA...,1,-21,-35,14
DFMYdeNASURgOHacTbJEXCPIfZLGQKVWB,RDGDODABHEDE..aFAETFEB..JCDGXBGDCHBE..IBBHhAAAZBBALFBHhAAAKDAEBAHFDIGCMDDH.hABAeACCSGDGcEFAEGAHfAEFhACA...QGGFhADA.,2,-31,-6,25
HbCdSQRMaWYXDZTfJOFgeKBGLAUPENIcV,EFDA..NBBH...ICGHVDGF.CEBB.SDEBRABC.MECDhAAAaEDG..XGGBhAAATBFG.OHBAFFAFKCCEhABABHFBABID.PBABcGGHdCDD.WAFADCAD.hACAfFACeEEDLHAAhADA.,1,-16,-19,3
POcTREeYMUQabZLdfgGADIXFBHSVJWNKC,DGCAFABABEFGHBECJFADKECG....CGHA.OCBF.RFGB.eBFCMADEhAAAUGAG..QEEBhABAaDGFZBBG..dGEGhAAA..fHBHAAHG.SDDFhACA.WHDA.NBBH.hAHA...,1,-29,-43,14
PLEBDOHVJKQXGWbdeFANaScfTIRCMZgUY,aCGESGFD..TDEBCBFDZBCDUDFHLCBFBABBHGCEKEAB.hAAAQAEAGGADdAGHhADAeABAABBF.cFGEhAAA.IHAEgGGEEAGCDIEE...hAEA..OCDBXECAhAFA..,1,-7,-17,10
QAUScBLFZNGbDKPdeJWTEOgCIVMaRXHYf,SEGBLADDFHEGZAFBGDGGKFEF.eAECJABE...EFDAOEBDhAAACDFE..VBAFaGFDHBCChABAQGBDAFAEBBHDhAFADCFE.dAAF.WECCIHHEMAIF.XDDGhAIA....hBAA...,2,-29,2,31
ebNUZKBWfdaPQFXEGgHVJYICADcSMTROL,DCGGSFGFMECD.RCDBLAHHeBDH.UGAABACD.dFEEaAEAFAGChAAAGABHHDFGVBABhABAICFAAGIH..OEAHhADANEICKHEA....fCADXGGD..hAAA......hABA...,1,-15,-20,5
cEgAGJUKIOXQNbfLHYedMBDCSaZFRPVTW,UGEDKGGFOCFAQEBH....fCAFHADEdCGDBCADhAAACFEFZACF.PDEF.hAAATBBEcEABADDGIHBBhABAXGAENEEBYAFCDGFHFAEG....hACA..WFDD..hABA...,1,-7,-37,30
bFePTOCXEKIdaHUJBfSZcGgVLRYDNQWAM,MCIDeFEGODEC..CHHAECGHdCAAHFBAJBED.BHADZEAGGGBFhAAALHFEDBBHQBFBhAAAAGHC.FCDBTACChABAIADA.aBBFfGFBSBHH.hACA......hAEA...,2,-35,-4,31
ZKVIGNcfOYeBFMTDXCQJWbLdRSaEAPgHU,HBBDKBECGDAG..fEEGOFEGeDFEBGHHFGHHTAFChAAADCCF.CDFBQFABhABA.bFCHdAAE.aECDhACAEBDEAIDGUAGCIEHCcGECMACE.WAHBhBAASADFgGFFhBBA...,1,-10,-19,9
WecIERVSHMPDQLTAYdKCgZGBFNfUXObJa,dEDFKHCGCGGEZCCG.BFAFFCAA.UDGG..OCFC..aGGGeECAhAAAEACG.READ.HGCA.DBAEhAAAQAEFABGE.hABA.gGAFfAHE.JHECIHHEhAEAMADB..LFFChABA..,2,-31,-20,11
gEOPMZFDaScQbJGTHIAKUeWRfNBdYCVLX,eBCGRDGBBDDBCEAE.LCAH..EDHDMBBEDIDCSBADhAAA.QEEGhABAJECBHFDBAAIFKAGHUGGH.NADF.hAAAdGHC.XGEAOCDA.FFBE..cBGFhABAbGAG.....hACA...,2,-21,-20,1
MaEdcgVSGARWZIQPKHTNLFeJfDCUBOXbY,ZEDBQGECHBDGLDGFFDAH.eEACJAHFDGBBBDAF.OGAGhAAAXDEBMHFC.EABDdGCChAAA.VBAGACAG..WAHBhACAIHHG.KEHFNIEFCHBH....YABChAFA.aECG.hADA...,1,-13,-18,5
aUDVILQNZbGeRdMOBKcYPEAJgFTHSCfXW,FCGHTACBHGAG.SCEFCFFB..XCCEaFFC.DIACIBCFhAAALCHHQDAAhABAbAAFGFBFdAFDBHHAhAEAKFDBYHFAAAGCJBFHfHEB..hAFA......hAIA...,1,-11,-21,10
EAJBHKgNLaTUSDXdMFPZCGfeOWQYVIbcR,BDFEKFFELAADaFCE.UBCGSABH.dHBHFFCFZBDGCCHCeCEHhACAQDBH.IFFBhAAAbEAF.EADAAFIDJAFAhADA.HGEANIEHDAHHMIAEfEHC.hAEAWDAF....hABA...,2,-30,-13,17
TQKEfLCJeYPUMIObSdcBDZRXaVGHAFgNW,FAEC..NDDB.TFGDQAEHKDGD.LABBeDCBUABH.MHDAhAAAIHBB.SEAAhAAABHBDDCFF.ZDFEhADAaAHDHFGFADIBECADCGAC..PFCEdGAB...hACA......hAGA...,2,-22,-9,13
RaAIKOEJGFZfNgDPWQdeSCMLTXVHYUbBc,KGADOCGBEEDH.GCAFZEGB.....gFAEPCDEdGBEeACChAAAMCCB..XEGHhABAHAECUABHBFEEaGFHhAAAAIFAIAHGJCAF.fBEEDEGB.hACA......hAEA...,1,-13,-18,5
KVJLWPaATYOedfMgZNEQXcGCBFHUbRDIS,TGDGeCGHdGGH.MEDHZBDGQGGB.GDEDCEADBCEHFAHBhAAAHCBHUCAFDADHSEBGhABAKAGGJFEB.WFADhACAACAB..fABA.EGAB...hADA......hAEA...,1,-13,-28,15
CSDNYgXRMOLbGTAZdfBcFJPIUVQKHeaEW,dDACBCGEJECAUDEF.KHAAeCGH..ECBGSBCB.DIEEhAAANABB....XEBHhAAAOGBALABEhAFA.TGGHAGIFZAFEfFGA.hAGA.PBEFIHEAhAGAQAGDaCHD,1,-19,-50,31
JcZGLaVUNgIBEHTWSdXPAfFbDYQOKeRCM,FHBGDCGFQBBHOABD.KFCECAFE..MDEAJFGH..GGADLFHHhAAAUAFD..gFFEhABABEAH.EHECWDEHhAAASECA.dDBHAABE.fEAEhADAeADB.cAGE.hAEAaDGE..,1,-14,-33,19
TdObJYSReBfcZHKUADMXgENPaGQFCILVW,DFHFXCFAEAHB...aECCFGDB.CCFCLFBHVADH..TGEHhAAAdCBGOCDH..hAAAYABFSFEEhABABFAD.fEGGHADEAGIFNIEH.PHACIGAFhACA..WAHB.hADA...,2,-25,-17,8
GWVONSdfCRbXEecMHKTJFQDPaIgLBYAZU,ZFBBUDDDGEEBOGCEdACH.CGAC.RAFH..EFGAMBHH.HBAHKBAEFEBHhAAADIDC....aCDBIBDGhABABGDEAFAA...hAAANICH.fHGB.bAEDeBHF..hACA......hADA...,1,-13,-32,19
GDHPIUXBQJTKMYLRdbfNFWEaZCOcgVAeS,eEEGGABBDACGHDDDUGGCXFFF.BHEAQCBHKHGAMFAEhAAARAECdCHG..fGAEhABAFGCEEBCGCAAAOFAGhAAAcBGBAEHE..IHADJGBATCAG..hACA......hAEA...,2,-18,-12,6
dgSXCceOBPZVKDTGYUREbaFWQJLHMANfI,..IDAGSACB.CGDD.eAAGBHBEZGAADGGBGCDAUBGFRAAHaFFEhACA.QBGDhADAHEEEADDBdGACXEAA.hAAAPHEGKEBBEAEH.FFHD......hAEA......hAGA...,1,-5,-23,18
LeZUERXNScKHMCVabWQJPDAGYOBIfgdFT,GCDDBDFD..IGGGfGEE.dACFTADGeDBBEFGHRCAD.hAAA.SFAAhABAKAHDCBAEaFAD.QEDDhACADIGAAAFA.gAFB.FHDE.LAHHhADAXGCDcBBA.hAAA...,2,-27,-7,20
GfLcUWSEaZCTMDOBeIYgRPKJdXHAbFVNQ,VDCHQAEE.LACFUCGFEGGHZGEA.CDFADIBGOCAG.BEAEhAAAeAAB..IHAFhABAYDHBRADBKHCGXBGFhABAAFGC.FEAGfAGGSFDCTFEHhACAMHAE.....hAEA...,1,-19,-20,1
EdAPNHTgFGZReVSKQBcbWIMYJXLaDfUCO,HFABFDCFZFGBVADHKEFB.BEFH.....bAFHMAFF.JADHaHGChAAADBGECFHG...OHAChAAAACIDTCAG..RGDCQCGBhABAWHCA..XABBLCABhACAfDDEdGAF.hAEA...,1,-14,-22,8
NbFWAYgRDMIULHOBdSeTJXKfZcCaEGVQP,RFADDECBUECCLAHHHGEGBDHFeDDD..JHCCKADD.ZCCA..CBCDEGHHhAAAGBEB..VAEGhABAQAAC.bEFEhACAFDAF.AFFAMEEEOAEGSGGF.hAIA......hBAA...,1,-9,-23,14
bfAYDGXLdKeRcSJEgTCUaFWNMPVIQBHOZ,GBDBXFEDLEDAdBEE.RCAC.SEAFEAACCHAF.aCGAFCHDMEEChAAA..PFHFhAAAQBBCOFAEfGAChABAABCEDAFEKGDG.JECF.UGGENIBBBEAD..hADA......hAEA...,2,-11,-9,2
fbALaKPBUWHdDOZQCgXNeMcSJEFIYTGRV,aEEFKBGFUBDGHDAADHAGZFCF...CCFB...XGFBMDCE..SABEhAAAJABH.FGGGhAEAIEGF..hAAATDGHRFAB.bFAAACABBDAHdBCHgAFEhAHANAIGeEEF....YFHBhACA,1,-24,-27,3
LBeFaEfSVbJGTPcYOQWCRMAHINDZdKXgU,HDAHDGACKAHBUGCALEDEBEDAFGFH..aBBGEAGF...VBCChAAAJEHFGBDH..hAAAPCHDOFFHCBAAAAIDIGDHhABA.NADD...XGGB.hACA....fGAGhABA,1,-23,-41,18
AcfPYMaTLXQZDbNFUWHRIeVBJgdCGESKO,...fBEFPDDHMAGDLAEE.QFFBDCHDFACGUGFFhAAAHDADRBAG.eEDFBCEDhABAdCGFEAHBODCGAGIBaFCH.hAFATAAC..XEGGNIBB.WFBDhAIAIHHA...hBAA...,2,-25,5,30
VHDbREINJWaUgQATYXCZSGdKMePLOFBcf,TCBECCGGGDDB.KGBBMFDC.LBGHOEHFBBGB..VGCGhAAADBDAECBENBAF..aFABhABAQGFEAHHDZAEDSCADhACAeEAFFAABfFGHbFCF...hACA......hADA...,1,-6,-24,18
gBHfUcXdbNFIWRLJZSQDGOTMaEAPYKVCe,KEEGVEDACGHB..BCHGHFAE.UAACdHAH.FCDGRDBE.LCHFZADH.DEBAhADAOBFF..MIEEhAEAACAC.eAEA.fGGDhAFA..cFBF.NIED..hAIA...JHBESABGhAAA,2,-50,-15,35
HFXGfNVYEDcOZUSLBCATKaJbegMRdPQIW,TBEAaAGD..eFDEMBAARBAB..dHGFIEHCHFAHGDEF.hAAAVADFDDGGOHAChABA.SDCBhACABHDGAAFAKABCbFEB.PFAEWAHH.FHGG.NADF...hAIA......hBEA...,2,-18,-8,10
bRcYXSOFedWBCAKDEVJLMGTfaQNgHIPZU,EABALFHFGCDBaBCFQGGHHBAHZGCARAEB..XGABFHACeEFBhAAABAFBKBGE.DFBAMABEhAGAfBDF.NEAH.hAAAIEDAUEGHYHCESDGE..hAHAOAHF.CBADAHAF.hAIA...,1,4,-9,13
KDUfaHCcWQAOINBeLEdXgGVRTYMFPJZSb,OBCHBBFAECABdDHEGEBGRGAA..MBEGFBCHZGFEKGDC.DAFG.UDEBhAAAaEDEHDAB.CGGA..hABA...cFDDhACAAICEeADDLBHHXAAF......hAEA......hAFA...,2,-23,-20,3
GaFRDETIYPZBJHAdKSOUcNMebXCVQWfgL,SGBBOEFGUGCAMACB..eBBECEBF.QDDA.hAAA.fGEChABALEBDFAEEDAIHEAEHIAHHhAAAPDGFBHFBADFFdDDAKBADNDIAXAFDWCFEaGGA.hABA......hACA...,2,-21,-20,1
JeIcXKSfaHbYFZCETQVOMLgdABPNRWUGD,BGGBREFCUBFHDEEC..eDDH..IAEDKCCD..SEBDhAAAaBGHHDAAFGAACHHHEBADVABFhAAALADE.AIAG.hABAPFDFGGDDJAHF...fGFGhABA.....hACA...,1,-22,-23,1
QOWAGZgPbUJSVaTCKEBDYLcfHRINXMFde,ZDDG..gECEUBABSFHB..aDGDCFAGBGFDDIFELAFChAAAHAEDRGAC.ICAChABAMICE.eDDGOAAGhAEAAHCBGEAA.JABEKDBFcGDDXGGHhAGAdGGBWCCC...hAHA...,2,-22,-2,20
OPCJHEGebUgQWIRcaZTLFXSAYfNBdVDKM,...NDAF.VEBC.KBDDMEAF..CHBDHFEEEDEAGEBEeHCGUAAAhADAQEFARAFE.ZABEhAAAFEHFSHFEhABAAHHEBFAGDEEGJBFG...WHDG.....hAEA......hAFA...,2,-22,-12,10
CLIOUQDVPcFTXMZfaeBAKbWSNdHJgGEYR,KEGBSEBFHFCBJCDGECDG..RBBF.LFFG.OAHBDEIBVEADhAAAFEGGMIAAZFEH.fGCFhAAABAHBAAEE.NACHdBBChABA..gGGGCDDG..IHHEhAIA....hBAA...,2,-27,-18,9
IZgRLdfKbQPEOFUMeJTAXGBNYcCSHaVWD,BBFE..NBDGCAEAaFGE.DHBEZEEG.LHCEKABF..QEBFhAAAOCFGUBABeEECAHIB.hAAAXCCAGEAG.SHFAhACA.WAFEIHGG..hABA..gACHhBAA.fGDB,1,-27,-35,8
cOIdQWNTfeXBJbAKLZPDVGaHYCMESgURF,KFCFLCCCDDBDGAFEaBAFHEGH..CAEB.SHDCRBBE.OEDAhAAAQFFF.hABANIDF.TBGC.XGAChACABEDAADHH.PADEMBAD.EDADFAHF..hAAA......hABA...,2,-35,-3,32
WLAJNdKfXaESUgYMHeCbTVFBIDcRPQOZG,dBEGXCBEEGGG.UAGAMADE.HFCA.CEHC.VFAHFCAF.DFIHRBFG.OEEFhAAAZBBFLHBGhAAA.AEED.KDFC.aADC.hABASEHF.eBAFBAHF..cFCAhABA....hACA...,1,-13,-31,18
TcDCfaEMSQWRHBObPKJFGZLAINYXVUged,..IDDDNBHC..VFAHUABH.eDHHdACGDEIF..fGBFhAAAaGFA.SGFHhACAQBEBWFAFhAEABAAD.OEDFKAEHFCFELAFCAFEB.XDBBhABA...hAGA...,2,-34,-23,11
NTaGCdRYWPcefKgAHOFUIQVSZbMBJEXLD,FACEQFCGZDFGBGBGJAADLCCD..TDEACGDC.dHGBRAGD.hAAA..PEADeFGBKDDEhABAAHEBOBDE.IFHBhAAASCAFMDBGEBFBDIAAaFHF..YAEChACA...hACAfCGH.,2,-24,-14,10
UCdORYWKaMAfDXPBJgIcTNGeQLHEbSZFV,DCBGXBAHBECG...JABA..IAFB..NECAGDFGhAAALEAFEBGDSFEAhAAAFEADCHHH.OFHBhABA.WBGHMFEHABID.fCCBPDDGcADHhACAeAHBbAEF...hAEA...,2,-48,-13,35
LbKXWYZHAFQIGEVCfMOSdBaDRJgUNPcTe,FDECQBBAGABECBEGOEHB.BEEGaAFE.DAEGRFFG...UBGChAAA..NEAG.TBEChABAeGCELAAFKGEA.hACA.YDAHACIFEHCEMIFAJHAC.....hADA......hAHA...,1,-18,-26,8
HFDfLRbNUJQgBZVMdKcIaWYGTSXPAeOCE,OBDECCCDHAFFDICALHEA.RCAH.UEFFJFAH.BFACZDEB.MEBAKFHH.hAAA..aBBG.GGEFhAAASDDHADAE.FCHFhABANABB...gACCVFBCdBHE..IHAHhAHA....hAIA...,2,-21,-17,4
efOIcZHbFGaPEMJLDRdWYVBgQSCXNTUAK,KEAHeAFBOAGFZCCGHAAFGDCCEEHD..MIAGDAAFdGEE..VGEGhAAABGGEQEAHhACACCAA.XEEGNBBB.hABAABHGICHGFEHFaCCB.......hACA......hADA...,2,-38,5,43
YgecBbJCRfOKFSHVXdAZEUPaIWDQNMTLG,EAGCUBBF..aCDADCGA.QGGCMIBCGEFG.eBBDBFCHCHHEREABhAAAODEF.KGDGFDHDhABASGBDHDDDdACDAGDBhADAZAEE...WEAF.....NACB.hAAA......hABA...,1,2,-40,42
YJZUXBeMcHAfKCIEDNaGSOPWdTVQFbRLg,CDAHDAEBGCCEODBCdHDH..QAFGFEFELCFE..gAADhACAJABHZFAH.BGEBhADAeADBMFFAAIHA.KDGGEAGAhAAASHAC.TGGBbFEC.YFBEhAHA...cGDChAIA.,1,-14,-37,23
deAUCFSQNXIWBLKHYaJcPTgVObRDZEMfG,UFDHFGDBQBGC..XAECBEFHKFHBaBBC..PDBGhAAATDBH..OFAHhABADGHDMFADdACB.ACIDCCGFNIEBLFBBhAFAJEFC........hAGA......hAHA...,2,-39,-25,14
ceFZfVMCNOQLaKGSITbURWPXgHYAEBdJD,BCDHJCGF.DEFBeDEDFGEH.ZBCA..MACBOFAGLHAA.GAFChAAAIGHE.TCAChAAAUEABRDGF..PHBChABAXGGG.gADCAHAGdAEDfGFChACACDAE.NAIG...hADA...,1,-19,-25,6
gaABOFMeSQYfCLUERXHDKNbGcWJdVTIZP,FGCFeCBHQCAHCCHA.LFECRFBADAGBKGFHGBEF.JHEGTDDChAAAZDFC..aABGABCCOAEDhABASDDF.hACAfHABEEHF..NDAE.cACEdHBHIHHBhADABAGB...hAAA...,1,-15,-23,8
MQOTdbWUScaAPegYEHDfXZFKIJCGNRLBV,eAGBEBCCHFFDDCEAZCAEKEAF..CHAC.GFDFLDEABACFMFDHOEADhAAAdGBEUBAC.SCFChAAAAEECPHFE...hABA.fDHAIHHFNACB.....hAEA......hAFA...,2,-32,-9,23
dBaNIScMPeYfOFXREgAVJQTbHGKCLZWUD,JDAATGACHFBB.KFGBZCCD.UFGGdBCHBBAF..NABE..SFCAhAAAMAEGeBFGOBFBhACAFDFDRFDB.AIEA..bAGD.hAAA.CAHADGIF..IADF...hABA......hACA...,2,-27,-21,6
UHNeYSPCcTfIaZBAVDGWMFdRJKQXOLgbE,DHBEMBEFRBED.KFEE..OABFLHDA.ECFCHCGB.eDDFSBGEhAAACEAF.TDGChABAaGGEABGH.GBBEdAAGXFFChADAgGAHNICF.PDAH.IHHEhACABAHG..FEBD.hADA...,1,-14,-20,6
daXJMLTWZNQcFeHKgOPbfRVAYIUCSBEDG,UCGGCCBFBEEDGEBF.dADGaABA..MHAGLAGBZAFG.QFBHhAAAFCBHeHFCKAAC.hAEA.gFGGhAFA.OBEDPDDAfHEFAAGCSFGEhAFADBIB......hBAA...,1,-21,-30,9
LRFWONEcZdaCUIfXQVSGbTPgAKYDeHBJM,KEDDDGGDeBHFBADALBAFFBEE..ODBEEEHHZCCAdABB.CGAG.UBGBhAAA...IHADhABAfFHC.QGDEhAAAGGEH...PFAAAFAGYFCFhACAMAEG.....hAIA...,1,-23,-38,15
eNYOIUTCDcKbWgJFXVGSZAfBLHMdPERQa,BEHFLCABHFBBMEFDEBDFRFEE..eCFBOBABTGBC.DGIFKCBHhAAA...bBFBJCDHFEDGhABAVAGH.ZEGBAFIBfFAChACAQADFaABFNIDF......hAAA......hAEA...,1,-10,-11,1
DIKETaMcUGPLQeXdbZSWOCYfNJVFBHAgR,REECKAGCEDEAMDDB.GBCDQEBF.dGHESFGHOABFCGAE.hAAA..NICH.JAEABEAChAAAAHCDDBABaACG.UEEB.hABAeCHDbBDC...WDBHYHDCFBAH..hADA......hAHA...,2,-21,-14,7
ECeZBDKSHVcbdUYTGOAXFRLWMIQJNafgP,XDGALFHDMABA..QDDHJCBD.aFGD.gCAFhAAAPDFDeFCHDAIFSHDEhABA.hAAAHAFDbBCBYFAFOACGACHBFEBDRBGBNEEE.CHACBFDAhAHAcAEEdCDF...hAFA...,1,12,-24,36
CZTWREbUNGKAJeVHXdQPcFgLIfMYOaBDS,eDAFXCEHdDCGQGFCFDBF.LDEEIFAG.MBIDhAAAaDHDDBFCZGFC.RGCAEABFbGBA.hABAUADGGACH.AIGEJFFChACA...........hAAA......hABA...,2,-18,-12,6
gGSHVBcaUeORbCKFLTdfQAJYZMIWNDPEX,JEBDMAFB.....NECA.PBAD..EDFHGAEBSBDFhAAAHGDCBEFDaDAGUGGFhABARCCDKDGATEGCQGGChAAAAGAHIBGADEAHXABB..cABBhAEA.bEDHCCHBdHAH.hAGA...,1,-3,-26,23
YGNXOJRCQAMBUVaZcdfSKEbPeTFIWHDLg,UAADZEBBdGDGKAFHEAEG..eDAFFCABHEFCLFCCGAAF.ODDGhAAACCEFAHDGBGGH..aGGChABASBCH.hADATDGHWBFADIAC..NIAH....JAHHhABA.MIFG.fDEFhADA,2,-25,-20,5
KZbEAFGRWSMdOPQLVaHfNBgITXcUJYCeD,RDFFMFADdAFB..QDAHVFEC.HBAGBFBBTDDGUAAHCBHADIFEZCDBhABAAHHA..FHCE.SFDGhAAALAEGNADEIGBHhABA..JDHHKBFGEGDD....WAHHhACA.....hAFA..aADF,1,1,-28,29
AJSYPaXDRUMBeLZgFOfQGCWEdcKVHTIbN,SBBFaFBG.DHCEMDDGBAFAZDGBFEBAQAAC.CHACEAFFhACAKFABHFFB.TCDBhAAAIDADAEGE.YGCAhADAXCGAeECEOACA.fAHAhABA.WFCA.hAEA...,1,-24,-28,4
GHNIEaBYSRUdLXfMeTZFcPJbQOKWDCgAV,VCBHHCDDEEGH.BGDDSABGUBGCdAAGLDHD.MHCEhAAAZBBBFFBG.JFHBQAEBhACAOFEF.DFDAAAHC.hACAIBHEaFAH.XFACfAEHcGGChADA.KHAGCDAF...hADA...,1,-14,-18,4
NcbWdECABROUXZJMfPegIaDSKQYHLVGTF,RBDGXCGAMDHD..eFAEaGAD...KHBGHEGHLEDHVDACGAAFhAAAFAEA..NAAE.bGCAhABAEBBCAHIDBAGA..hADAZGFEJEDEPAHFDGGFSAFD..hAEAYDFB..hABA...,2,-21,6,27
WNMbHPBLUQgVKDdaTZOXEIGAcRSfeFCYJ,SDFGeFFAFCBD.CEHA.JBHB..MBEBHDCFBCHGUGCD.QAEEhAAAKGGDdDBAaAFAOBAGhABAEGBF..ADDBRAAG..hAAAfGHA.NDAA.bFCH....hACA......hADA...,2,-30,-14,16
BJgaVQGZMXPOTRYKWcbUILHACDSNfEdFe,SFFFEGEGFGDH.BFAHJBBH...aAHHQFAHGABCMIAChAAAOEECRDFE..KFCDbBEChAAAUAEE.LBAFhABAAIBGNAEH.fHDB.gGGGhADAXGGFYACHhABAIDDHCFDBdBHE.,1,3,-27,30
MbePCDAZgBYFGKLfcRHIEVdWQaUSOXTNJ,ZAGDBGCCFGEHKEEALBDDRGDG.HEABEBDAdCAHaAAB...OFADhAAATEFB..MEAGeCAFhACACHHD.AHID.GAGG.hADA.IHGB.WFCHSFGAhABA..NBIA.JABGDCFD.hAFA.fCFG.,1,-6,-20,14
UVTOQIMCEWgDHKZAJfaRSLFeYcXNGbBPd,aADBSGGDLCBBFABG..eEEH.XBDHbDCCBBGBdGGFUFDAhAAAOHAE.IBHChAAACHAFEADADFGEZFAEABIHJBFHhAGAfAFG...YBAF.hAHANIEF......hAIA...,1,0,-33,33
KQbPVDYRAWcfIUHMBZNOLeEXGgCTFdJaS,...fCFEHDFFBGCBOFGHeDBHEADAGBBCCHHGdDDF.aAGAKEHHhAAA.bGBEDBHB.AEIF.IBGFhABAMBBD.LBEFhACAXABBFEABSHEE...hADA......hAEA...,2,-22,-14,8
YAZHVbNdJaKgQCXFRPeDcWUEBGfOSLMIT,VEADdFGFaCDG..QADBFGDD.eHBADCCFUFAABEGBOFEEhAAAMAID...TCEFhABAAEEDZBAB.HBBDJAGD.KCAFhACACHHG.PAHF.EDDBSAAFIHHG.hAEAbDFC.....hAGA...,1,-2,-32,30
YSTZPCRBGXHMeadKIcOQEAWbUVNJFDgfL,UDGDJBDD.FDEBDGGELCCH..SGBEZABCRGAG.GBAEhAAAMFHB.dAGFKCAHOEEDhABAAFAD...VCFChACAfAEB..PHFCCCGB.BACAhAEAeFFBIHBD.hAAA...,2,-33,-24,9
NEJQgfXORGUIPKFDTAeCZdSWVaBYHbcLM,ZDADdGEHSGCHaABF.BCDDHFFELAFBMFCCEADG.JHAGQDAAhAAA.fBAHhABAOAAHRCEEIHEChAFAFBHDDHAGAEEACHHA..WAHBbEFE..gADDhACA...hAGA...,2,-23,-11,12
KbRXYceLJCFaQNVWEUIGdgOHPBZSAfTDM,TDAEMAEBRDFC.....XEFBeAHBCHCFQDADVFCF.hAAAEFDBICCF.hAAAgBGDOFBBBHGFhABAAFFDfABCKFHHcCCCLFHDaAGH.hACAWAFE..dBBF.hABA.HADD.,1,0,-6,6
feRgMXIYDaQCKHLSGAZBbNcOVFTWUEPJd,ZEDABCHA....bFAHODFB.VCAAFDHHUCEB.EAABdABDhAAARCAA.XGCA.hABADIFCQAEBhACAHAEGLFAEAHGH.cGGFWHCEfAHAhADAeHAG.IHHAhAFACFHB...,2,-26,-14,12
MCgDFeHTPBAbZNKWVYOaJLUGfQEXcdRIS,ZGEEKFCB...VAFCaCDALCABUBCG.GEEBQEAA.hAAAEDGHdBGE.SHEGhABAMACGDGDHFBAHHABHBDFChAAAAHHHWAHBOECCXGAC.IDDDhADA.CGHB....hABA...,2,-22,-6,16
HZNCXOfBKgFWJUGTPQcRVELdYeIADaMSb,aBCGSBBEZEGH.CDAF.OBFCBHDBFEGGUDDG.GGAB.QEABhAAAREAEEEEDdGAEeCDAhAAADGFBMABF..NABBKHGChAGA....WACEPAHD...hAGA......hAHA...,2,-24,-22,2
MbZHfGeCYgIDBEVTFNJSOAXLPKdcWRQaU,LGFEKFAFdHBFRBCE.QCCG.aGBDbFDBHADA.GBAChAAACAAC.IDFGDHFGBCGBhACAEBHHFAEE..NEECOAFAhABAAGID..XCBCWFCBMFFC..hACA..fDGEhADA..,1,0,-43,43
WefFbGEUOHYNIBKSXTZadcRJVPMAgDLQC,DCBCLDEHCAHB.eDAFFEDCGBFAOBCBHBFH...NAICKGGChAAASDBH.XAEFhAAATECBaHEC.hABAdHAFJHBEMABGAHFCQGGG.fBHGhACA.EDAH.hAFA...,2,-30,-13,17
ECeRDAKBTNacQfHGgUOVJLPIXFbdMWYSZ,TFAGaEFG..QBDHHCBCUGGGJEDDLCHD.XAEDhAAAFBBBMFID.SBHFhAAAEFEF.CGBGDADEhABABBBA.NBACcEBFfGGA.OAFFhACAIAHBWHAG...hABA...,1,-19,-22,3
FWcZRdOXYPDJgBNTEIUfHQGbACSMaLVKe,SBEELBADVBFGFFGFZGAA..dEGAOCBH..XEDDhAAADEDBBCDFECEBUAAFhABAfFBCQCFBhADAAHHFaCBGKHEC.eAFEWAFE......hABA......hACA...,1,-20,-31,11
WNUcfeFHPDTJSCBVaEYMGKAQgOILZbdRX,OBGHZAFFRFEB...XFADUCDGeEBBFFDEHBDFDEHH..JAACCGGHBABAhAAA.EDCDMDAAhADAAFIB....IDAHhABAdHBDNEAE...PHCE.SAFFhADA....hAEA...,1,-28,-34,6
CBMAVfPNgeRaJIDZSUOTKXYbGLWdEFcHQ,VDEF..fDBH..gFCEaFGCJCHHDGBBUBBGhAAAKAGC...XBEChABAbBBALEAGEFHDFDAHQFDHhAAACCHHAAGCeHCG.IHHCSGGDOABGhAFA.....hACA...,2,-22,-14,8
cTGbafNLPKVHeSEDQFRMIUCBgdZAYXOWJ,XCDDJCABGACD..aGBELEEF.KCGCHDBB.eHCAhAAASGFHDGGAFAHDMAEAhABACDCBBHBEZACAADIFOFFAhAAA..cEFBfAGBNDAAPHFCEDFEIHHDhABA.gFAChACA,1,-17,-22,5
EAHMPfDNCTdIUXbcZGWeQYRJgFVBKLaSO,HDBCMDDHDCIHCFADdHAB.UEFH..XAECZADEGGEDeBGFQAAHhAAARBADFFEHBGGDKGCELHAAhAAA.OFFAhABAAEIHPCFE..fFAD..hACA......hADA...,1,-12,-26,14
UacRKfOQFAXYLVJECeSHgBIGdDPZTNWMb,XCCDVAED..EABASFBFBFECdDHAZGAE..NADHMHEAhAAAaHEA.KHCA..fDBHhAAAFDGCAFEEJBAECFGDHDFDhABA.IHHFDIFAPBEDbEAC.....hAEAcAGE...hAGA...,2,-23,-17,6
IPEMNZSBVJTgGCHOcXfYAKaFeRLWdbQDU,aABBeFAALBDCdGGDDADG.UECH..ICCEMEADZGFG.BFFEhAAATEGCGCDF.CBHA.hADAOCAF.XEDBhAAAAIAAKEHFFHBARCEGQGCDECBH.VAFEhABA......hACA...,1,-11,-19,8
daTPAbLCHJSNDEgQWfcFBOIeZYUVKGMRX,LCHBCFEDHAGB.SEAFDDDHQGAF..fFDBhAAABHGFeCBCZCAC.YCFFhABAKABEMFFGdGGFPADEhAAAACCGbEBD.EGDB..gABCcCFH.IHEAhAEA...hAGA...,1,-5,-26,21
bLTBcPfXOJEDYZeKMAHadGICgQRUNSWVF,HDBBaFDBGCBFCGFCRDDA.UFAH..SAFGFBHFLBBEBGDD.hAAAfHGBJFEEDBABeHEAhABAMDIB.ADBFIACHhAAANEEF..WFHHTGAF.XBAGhABAEAEG.KEGB...hACA...,1,-12,-18,6
WYNgXQBVUMdGZCTPHLFKJeRObEDaAfScI,SFFD..ICFB.NCBC.XBDCBDEDMACHhAAAdFDGZFBH.PABBhAAAFHGEKECDeEGDOHCADEBEAAGFhACA.fBHG.WEADQEFAhABA.....hADA...,1,-29,-41,12
fdUDQRMOZPKVCcbXSJGHeWLgBAIFYETNa,FGBBTEGA..aDFDdEDCUBABRACGZCDC.KBGCCEBG.....XFAHhAAASDDBHBAFeHEEhAAA.LAHFhABAAGGDIHDEEAEFDFDFMAFC..OEGD..hACA......hADA...,2,-31,-15,16
bCHLPBfDMXEgNWRVOJSQdYcKTZUeGFIaA,HEDDBBGDMFCCXGFB.ECAF..NDGA.RBEEOHAC.QABFhAAAdBDDKDHDTBAEhAAAeGAEIEBDAAECCHBC.hABAfDEBDDDE.WFHBJFHDSEBFhACA..YAFChACA.,1,-11,-37,26
CVBKGLHQUeYcJFgWNPDEAOZXbMRfIaSTd,XCBDRCFA..aAAFdFFDCBEDBHFDLHEGHFBHeDDH.JAFGFCCDhACA....WACChAAADFFEAAFDZCFEMDAD.IGHBhADASEGE.KBADQEDAhAEAYFCF......hAGA...,1,-13,-35,22
BcHfLZOMGKbJTaUASgeVFDQYEdRPWIXCN,eDECVGDG.DEGD..EADCdDAH.RAAC...PAGFXGBE.BAFBhAAAfDCDLBFGhABAOBACKGHB.TGAGhAAAAAHFSHFGFHGEWECAIEHECDAE.cEBEhADAMDIBJDGH..hABAaCCA..,1,-19,-20,1
HBGIgSCVKNbcYTLWQJMZeXOAaEURPDFdf,ECGBRAEEDABDdGACBHGEGFCB...SAECVEDB.KECC..hAAA.bCAGTCBELFHBhABAJEAHZCFAOBEFAAHA.hAAAaBBA.FBHFIHCBCHGF.....hACAcACH.YFHHhADA.,1,6,-48,54
MPJDaGWfgcVLYHXBZKbEANCIUFSROdTQe,CCGBFFEGRFEC.ODDB..TDBCMADADIFCGBBB....fHBBhAAAgGBHVBEAhABALAFE.XAAGhABABBCBKEBFAGIFNEEFSFHFdDAC.QCAHhACA.eAHBhAIAPHFCaHEG,1,-7,-14,7
MZPAWOBacbEUeVJCSdYRIKNgfTDHLFQXG,OCEFBFFAaDGG..EGDEUFCH..JADBdAFCRAAD.KCBC....hAAAgGBDDIFEFHACGDBFhABAMAIBAHGE...hACA.bABECFACSHGA.NAHGfFGHhAAATAGA.HDAChACALDAF.,1,-14,-20,6
RHJcELbfPFYWXaTMDdeOGBAgCVSIUQKZN,CEHHVACEUDBF..QGDBKGEA.RCFEHCAEJCDC.LFCDhAAA..PAGDFHGCXAGFhABA.aEGETFBHhAAA.MICEDFAH.eFEEODEHBGAGAGBH.hACASACE.hAFAIBBF.,2,-41,9,50
DPUHcTSWdAgGLOYJMQEVFeCKXbaIRBZNf,GDBGOAAA.MEDAQCCAEHDA.eEAHKBBDaDHDRFEC..BHHHhAEAZFFCDAEEHGBG.TCEGhAFASBGGABBB.YACHhAAAFAFECCGE.IBEGNBICfHFF.hABA......hAHA...,2,-26,-2,24
DZESfeMILFGHgJQVOUBNXTRYabPAKWCdc,CECCdFFCDBIFSABD..MDBGFEBCGADCJFHF.OCHFhAAABBGD...XGBBhACATGACRACCaGDD.AGIFKAGBhADAZFEBEFDF..eFADIBAA...hAFA......hAGA...,2,-43,-16,27
PebRKLCGaAFBMDNTVcHdSYfOQZJWXEgIU,MDFEDEEE..TFCCHDCGSEGA.OABAQADDhAAAJFBBEBDFUGGH.bAGBhABAKAFDLCAFCAGBAAIBBBBDhAAANIBFVCBFdGHE.fEHAXGEHgGCHhBAA...hACA...,1,-7,-18,11
XIdSCOfNLBFRDYKgbZEQeMVATPcJGHUaW,TEABJDFBHFAE.UAFFaEGD....IAHDdBCGCDAD..OEHHhAAALFEBBBAGFCDDDIAAhABAgBAF.hACAEDFBMCEHAHHDGGAFSHDANDIE.KCHHQAEFhAAA..hABA...,1,-11,-29,18
eFKHcDYVNOWbgLJBfAdQZSIaGMCXPREUT,ZBGBaDFAGABHCABG.RGCC.TADH.KEHBDGAF.VEFH.OCADhAAAbFED..LDAFhAAABHBDAFCAdAFESCCDhACAMECG.PHAG.EGHD.FCFB...hABAYDDBNEIE..hADA...,2,-21,-16,5
ZJVeFdIMafCLSUXNWPBDHcROTYbEgQKAG,JCBEFFHBdCBE..aEAECEFCLHAG..XAEE..hAAAPAECBEEBDABEHCFChAAAOGDETECFEDGAKGFHhABAABBAZFAGeBBE.MDADfHBB..hAEA.UGGE...hACA...,2,-28,-22,6
CJXUSZHVNEMYOcALDRIgGQaKWefTdbFBP,DGAFRCACGAGEQEFAKGHB..eDFDdCDFFEACBABHCACF.UGBDHGDC.hAAAEGBAOEEHLAABhAEAaEBE.TBGD..hAFAJAEBXEDB..SHFGhABANEICMIBGACCB......hADA...,1,5,-24,29
cdJWYAbRgECBQTVHaNMeSOIUZPfFLDGXK,RDCEEBCGBHEA..VFEEHGAE.MFACOEHFZBBAFAGEDFBAGCDFhAAA.KCACdEGG..JAHFhABAAACACAECaHECSCGChAAA..IAFA.fGCEhACA.....hABAXDAG.,2,-29,-12,17
cgVJfQYXBAMDPFLCGbOHZNWSKaERdIUTe,DCHDFEAHCEEFOADA.ZFEGSCFE.KEGGaDEC.EDCFRGACdCCBhAAAUGBF..eABCVBADhAAAQGGHBBFAAFID.hABAMBDA...PGDA....hABA......hAFA...,2,-33,-28,5
DdMAOUXYFHECGZbfITRQgcNBePJLaKWSV,OCBGUBEFFFDBHDFCGABAZGDE....fADHTDEEQFAAhAAA..cGADhAAABFGDeHFGJFCCaDDGhABASAHFDAHBMCABAGAG.EABCCADCIEHBhABA.NIBD.KHGG..hAGA...,2,-13,-11,2
XgEOeaVKIbUQfJWHTZMNScBAPLdRDCFYG,dEFBCCCFGEBCEFBD..OCBDeDEFKGGD.UAEHQGGF.hAAAJAFG.HABCMCBDNDDABCAFhAAAAIDAPAHF.DDABhABAFHDE..XDFDaEEH.IACGhAFAfBHAWEHB.SDDFhAHA,2,-25,-16,9
DQAUcgBXbCHaTVJdIOPMEYKNWGLfRSeZF,UEFABDCBCFACHBCA.aFHFJCFD..dBHE.OFAFEAAE..KDHBGGCBhAAARFGD.SEBEhABAeFCBDADB.ACGGcABGhAEA..gCAF.TGADhACAIAFAMCEH...hAHA...,1,-19,-36,17
dMJFTKefAaNZECBDYHObIGXQVcLUgPRSW,aBEFEFGCBBFHHFABOACGGDEE...QGFDLCAFPBDFhAAASDDD.dCGAMHBGhABAFCBGKGDHADBACAHADIDGIAADhAGAXCGE..cFGF...hACA......hADA...,1,-8,-28,20
AXYafWJeSZTMRQLcEDGKPBUbNFHVdgOCI,XAAAaBHH..JEABeFFAZCCF.RFAAQAFGEGFH.DEAEKCFFhAAAUDDBFACAdBAG.CFFF.hABAAIGAfHCFhAAA.SADBMECFLEHH.cGCDhAFABCHCbGFE...hAGA...,1,-8,-32,24
HgCeNYZWcPJRQMGbfSaDdBETKUXFLVIOA,CDEDeECHZEAF.....PCEGRDGBMGDGGEEG..SADDhAAADDCCEADHKDHHFAFALBBFhAAAOCBFAFFE..NIAB.hABA...YAFCcBABJHCE.fGHAhABABHHE...hACA...,2,-31,-19,12
LOcNbESVDAeHMfXZaJYdFCBGRUKTgIQWP,MBDDXEFDZCFE...JBECFGHB.BHADREABKDEF..TGED.hAAAQCAELCACcFDChABAEAFEDFFCAEIDeABAhACAHFBBaDHDCBFD......gAAChAAAIHHAWHDANAEE.SGADhAFA,2,-22,-16,6
EZaKTWCDfVSORFcbAegUdIYXHJGBMNQPL,eBEHUAFGdAAF..IACAHEABJDECBHHB.MIDEQGFFhADAEBABZCGD.KECH.TADBhAIADEBFSDDDhAAA.OGEAFCCBAHDCXEGANEAEaECHCHBC...hABA......hAEA...,2,-24,-16,8
EZACabXdWLFMOgeBGIcTJQHYPKfURNVSD,CCGBaDGCdFFBLECF.FBCFMCDH.OABHeAHDBBEDGEBATEEGhAAAHAEAKEAD.RGEC.hAAANDAG.DACAAIGC....hAGAbFADWBHH.IHABcGGF..JHDG.hAHAYBAH..hABA...,1,-15,-23,8
IdfabCMPFRgYcOQDZWTLASXHEBNGUJeKV,XFBDEFAABEDDGCCFUAAE..KADEdBBH.aFEEMFEB.RDCA..hAAA.gGBFhABAOBFADGGHTAEDADBC.SAHFhACAHDGD.eHFCIHHHfDABhADACFFF.FDHH...hAGA...,2,-31,2,33
dYMfSVPWbJRDcOAELaIZQXgUKHeGFTNCB,aDBAZCFEQAFB.UEBHHGACeHFAFABDCCFDBDBEdEEBMDIBhAAA.SAGHhABAPEFDJBBGDHFE.AADBIFABhAEAKGAF..NAAHfEHA..hAGAWHEGbEDH.cEBAhAFA...,2,-37,-10,27
DAVfGTWUgMBbdELHJIcNKaQeZYRXOSPFC,VCCBTBDF..UEFFMEFBBABC..bDBBEAFA..LAGDhAAAHCFEJEBHIACGhABA.KGHFeACARFABSEGFhAEACHBDADAC.fHCHWFHH...hAAA......hADA...,2,-32,-7,25
MVcgIQZHTPbRGXYNJUAfeSaBELDFKdWCO,eBEGSFCEBCDAEFDHFCBG..KGGHdCBG.OABGMAAG..VCEHhAEA..IFABhAAAHGBAPAFEbGFA..RDEGXGAEhAFANEIAAFGH.fEHCDFABWBBECHEH.hAGA......hAHA...,2,-22,-13,9
JLfNEcRSFHIXPAQZdWaVbYeCGTgOUMDKB,ZEGFaGBE...VBFCeHEG.CCGA.GEAG.TBAFUCDADABBBFDGhAAAJEFELECC.hAAAEAEHSEAEhACAFABAIGFEAAIFdADD...WHAG....hAEA.gGGEhAGAMDID.fAGA.,1,-7,-29,22
ONTJGdYABMCceQHDZEVWKaLgXISURfPbF,BAABMAEB.CACH.eFAGDHAE.ECFC..KAFCaHAGLDFE..IEEGhAAAUGFC.RCACfAGHhABAFCAB.NEIG.hACAGECFAHFA.QCCG...hADA......hAFA...,2,-44,-25,19
MUcadBFHQJODSWEXVRegZITLCbYAPNfKG,...fEDAGBAEMHECUFAHaCGHdBDGBAGHQGGCDGFCSEGAhAAAEBAFRBFH.eEBHhABAIHECCACD.AAIFPDAEhAAAKEDHFAEBOHCC..XABFhAEA......hAFA...,2,-19,-15,4
ZNFEeLCGBXUQAWcRDbHMIKOJdSaYVTgfP,REECHGAGMEBHOGDA.dAFEaGHD..TCDH..fBDFhAAANIEB.eBAHCEHGBEBChAAAUAFEAAEDDBCFKHBGSDEChABAgBGHFBAHEACA......hABA......hACA...,1,-18,-24,6
NFHZTQUeYAMWGXdgIJLEbfaDSCOcRPKVB,MDEBGAEDdCADJFEBLBGF..fDFBaHAC.DEDAOFCFhAAARCAF.KEADBGGGhAAAFFHBZCEHUACAABEGXABAhABAIHAA...SCHBCCHA..hACAcFCB...hAEA...,1,-23,-31,8
DFBKRIgbaLceVSMTNfZPdGOHCJAWQUEXY,QDBFUAFDEEEG.DGACKGDCRAEH.....IBAFaGDFLBHFhAAAeDAG.SFGBhABA.MIFANBIGfGHGhAAAdBBBOHACCHDGAGGH..WEEBFCCGBGAAhABA.bEAG....hACA...,1,-12,-30,18
GKDMYPSZTWREeLFAOCVdaNbUQJcgIfHBX,OFCBCFFAdDAB...aBGDUCGF.QAAGJEHF..IAFFhAAABFBBKFHDDBBHMEEHhACASCCHZGAG.TFEHhABAEAGGeBEBLEAHAHIB.NAIC..cACGhACAfCCB..hADA...,1,-25,-32,7
GRCZJVBFUAXfWabSHdOPKgMLcENDeQYIT,XFFDaAHBHAEDdHFHKBDA.LCCH.EDACDDGC.eCADQGAFhAAATAFGGEDAhAAACEGDJEEDBBAAACHA..fHADhABASGDDOCBFMCID.cABG.hABA......hACA...,2,-17,-10,7
DXUSAKcMYfRIQeENgOJHVbaPWdLZCTGFB,KECAMHECRFFH...QECAEHAG.OBAEJDHHHACA.aAFAdBFBhAAA.LEFGZCABCHHF.hAAATFAEGCEGBBDBhABADIDGSGCEcDABfCHC.NIBD.hACA......hADA...,1,-15,-23,8
EZgIONVWRfLBYTbdQaSPUJKMXHceDGAFC,CBHCEACEZBEF..OFFD..NIDD.REDDBFBH..TCCEQDGEhAAASEHBJBFDMCBEhABAXGAGeHAGAHCGFAAGhADAIEADVEAAfGFH...hAEAbEECaAGA....hAFA...,1,-17,-21,4
ZcdAEaVGXDfeWMISRBHNUOKFPQTYLJbgC,EDGFaHGGGADADGDE..eEHHMCCDRDAEBBCCUBGCFFDH..QAFDhAAATGAE.LHAEhABAbFFG.CCDH.cAABhAAAAFAFfHFB.IEEDSDAFhADA.OEFG..hAFAKADC..,2,-19,-15,4
VJcQESeaUYCFORbdPIZLXBTKNHWfDAMGg,GDDAJGDA.EHBCeEBHUEAHFDHB..OHECdADCZAFABCCH.KABHhAAA.HBEDDIFGAHHGMAHDhABA..VBAFSDGAhADAaAAG.CGAHPGFGXDDD....hAGA.NIAH...fADHhAGA,1,-4,-40,36
DAGCZfTINEBMUFHLVWQOgcKRSPXadbJeY,CDCEZDDE...IFBDEBEBBGDDFAGEHGFE.LCHBVADBOGFChAAAKBBGSFBChAAA.aGBDdHCF.eABHhABADCAHAAHHTEGFMEEE.WFAD.....hABA......hACA...,2,-31,-18,13
ceBNYHTgUGfLaDSWdJQIMVAKbPOXCRFEZ,KEDHOCHHCEBE.RBCCZEDGBGCA.HABBUEACLEHH..SGGHhAAAdAHEJBDC.IDEFhABAAAFC..bFFFPHBAhACA..EEABeABA.TAFBfDEBhAAADBIDMFIDFHDE..hAFA...,2,-23,-22,1
QfeZBUXIPHDSdWMRLJKNaAbOVYCGgTFcE,OCCHCGGDGCBDFAAF..EEGDQDGDZAEAUAAF...XGBDhACAHFCHDGADdGGHMEFHRAFHLADHhAFA.KFEDAADFbFAFhABA...........hAHA......hAIA...,2,-21,-16,5
NYVEdBIJAFOfbPQSagHWeUZCcKLMGRTXD,FGEDOHDC....fDACbBEF.QCGCSDGHhAAAHADBeECHCBBFKAHHMADDhABATGGAXFFCDDFHNDDAhAAAEAHFBGADIFAFAFBFaHAE.WABH...hABA......hACA...,2,-19,-14,5
JZGIQTVLWKYHAPFRODSUgNdBfMXabCeEc,RFEGSGFEUAFA.dAHCBAAB.MBCCbCCH...CECE.ECBFZEAFGBFEhAAA.QGAAhABATDGALCAAhACAKADB.AICC.FHEADAIBfABFaFHD..cGDHhADA....hAEA...,2,-34,-6,28
ZcSFbDdBJeRHAOaUNQXMILfPGKVTWCEYg,UFFCXEEFMDCELFBFGBEF..KAAEVACF..CDAEEFAGZAGFFGCChAAA.dFHCBGADJAFFeBADhABAADHFOAEG.aHGEhADANIEH....fEDEPHBC...hAIA...WEEF.hACA...,2,-23,-13,10
VKbNQdMgeFTEaUYODWLZIAHPRJSfBcCXG,HABBJAEHBACCXBFD.KGFDQEFF.dFAFgGAEhAAAFCCD.EDEDaGDHOAFAhABADIFELAAHhAFAAGEBSAEDCGHC.bDAAMAHHUGGG..YEEFhAGA....hAIA...,1,1,-37,38
UJPYaMEIVBZFDCcKdHfeQWRgGTSOALNXb,XAFAUADF..JHDAaDFC..MDGBVABEFCHF..DFAFCEDE.dFFBhAAAHAABQFCGhABA..REAB.gCDFhAEASGHFAIFANDIE.bFAHEAGFBGGDKCDA.fHDHhAFA...hAAA...,1,2,-35,37
FOcDgBQXUYIeaZHVSKPfEMACJRTdWNbGL,JCAGdFCA....NBFE.LEBD.FFCGDBAFBABCUAGC.eAAGhACAaGEFHDEGKDDH.EAGHMGEChADA..AHHACHDGREAB..hAAA..bGFEOAEB..gBCAhAEA.....hADA...,2,-37,-21,16
YRSJNWLTXaMbAVBcPDdZUgKFQfEIeHOCG,BCCGDEIBdCGEZFAAKGHFFBAG...ECEDeFBFHEGDCAGE.GADH.RDAG.hAAASACA.hABAJCAFNAIE.LGDEhAAAaGHD.AABA.PHDEQCCCIHAGOAFBhADA.....YEEAhAIA,1,-18,-25,7
PeYZfWFUGNgaQMbEScHRAKIBJdTDXLOCV,KFAEBFEDdBDEDADALGDE..VCGFeEFEZBBBFCAAUGGD.GGBBhAAAaAAA..MIDGhADAEBFF.SAGFhAEA..cBDBAHHCJAHD...OBABCEED.hAFAfEED.hBAA...,2,-27,-26,1
aBSGgLOdZDCWMYUKNHefERQVXATPcJFIb,TBFCJBCD..FFFCaGHDBFDE.GAEBLHDCZDAF.DDBC.MGAGhAAAKAAFHCFCEEAEQABBhACAAAEE.cEFFhAEASHAAdAFFWCEDNEIE...eBHHfHFHhABA...hAIA...,1,-11,-30,19
VPMGIRCgHSDEWLbNQdJeXTcBYAZUfKaFO,ZFDDKEDCOBEEMBDGGCAA..CGEDHEBHEBBG.LHAGQGFEhAAAJAAB.TDGGBDAHUGGGhAAAaCGAFDDE.IHAGhABASBHBDFCBNACHdDGE.....eCCGhACA.....hAHA...,1,-8,-16,8
EFBHZKPeCAgGRJDIdaLScNfVYUOXQbWMT,RCFFDHGEdCABLDDA..SBFC..NAAFVAEAUGAFODBEhAAAQBCHMFIBhABAFFDABFGAKHAEeDGHhAHAAFDFJABE.aEHD..fHEH..YHCGhAIA.WCBDhBAA...,2,-32,-28,4
VYWZFfgeRTONcBPUadSXHEMGKAIJDLCbQ,DGCECGEA.QCAF..YDCBZECAFHAEeHFCOBDABHEChAAAaGGG.dDDHHBGBGBGEhABAABAGJHAE.LEFGhAAA.bDAFWAFE...fABHhAEA......hBAA...,2,-23,-17,6
FgdJEDLYXfIRABGcQVTWHeOabCMNUZSKP,BBHDQDBF..TBAAeGBAaBGCMFDCUDFHZADA..SCDBhAAAFGHDJBACLAFChAAAXGEB..fACBhABAACFHGEAGWEHFOEAHCHDG.KGFB...hABA......hACA...,2,-33,-7,26
JHAYfGebIZVDgFNdBPcMCWLQOKTSURaEX,GFCDeAEFZGBCDCBEFAHFBCHH..MHFECAABLDBAQCAEKFAH.hACASFDARAEE.hADAEABC.HDECAHGFfHCBhAEA.IHHENEAGdDCEcCGA.hAGA.....ODFChAHAaAAB,2,-38,-11,27
JcIgTeKBCGdRXfFVAYLHESDaPbZOQNUMW,LCEBHCFFDFFFaAAEZGCEQEBH.MBEGJEBD..IHHAhAAATCCAKBHBBAEFGAAGhAAAdDDERAGB.FEGAAIEAEDAHhABASGGD..bBCANAEB...cEGEhADACCGG.....hACA...,1,-9,-16,7
JKNTeAEaWPXgbcZYfDQOdLSMBHURVGCIF,aFADXFFD....gDFDZBCCDEIHOGBEdDAFMIBEBAGBhAAARAFCCACFFDBD.KBABTBCFhAAAAAEE..ECGCPEDBhABA..bDECcGGA...YCHHhAEA.fHEDhAFASADG,1,-26,-31,5
IgKEBSXcQFbTRHfPWGJdLZDMCeAaOVYUN,aADCOACD.UEFA..NCDH.KGCHBAGA..XEBFQGAChAAAFGAF.TDDBHAEF.hAAAPEHBJHFCLABDhAEAMBCHeFFFAEIH.IBAD.SDGChABA.cEAAhACA.fFDE.,1,-9,-22,13
JIVLOcYbZXDeQFNRgTWPKHUfEadCMABGS,GCACSDBDJEGDLABAODDE....bFFAXCCEhAAA.eFADNBCFRAGFTFCEhAAAKCGFUFCH..fCDHhABAaFHDMFFDADIHIHEA.YFAFhACADAIF.....hACA...,2,-17,-10,7
GRTdELDOJfcKPgBAFIaVWbNYQSeUXMZCH,FFEBaFGG...VCFD..bBGFQAGF.eFHBXBCFhAAACCCGHEAGGCEEdAABDCIBhADAOEABJHAA.KEDFBBEChAEAACIBWABDSGGDMECDRGDEEHGA...hAFA......hAHA...,2,-10,-5,5
KFUfMXDaPSNCYLRGTVAdOcBWbeJEgQIHZ,ODBEBDDGeHEC.EBDCIFDA.KACEUAFA.XDABhAAAaHCE.SEGDhABACHACLAFCTABEAGFFdGGAbBGDhAAAgFDHZBCAFBAHMFFGDBIF..NEAA..hABA......hBBA...,2,-18,-13,5
IfEcCANPaeZYOWXGJSFUbdgKMTHVDBRLQ,aDBHeCFBZGCCODAD.GBCEJDED.UAAHdBHAMAGHHFBBDEHFRAAE.hAAAQGGB.hACAIAGCcFGCADDBNAIG.hABA....YEAFWFFDXADBhBFA..FADA.KCDEBHDAhCBA..,2,-30,11,41
SgXVEMNHDYZPaTFfKRJWQALCBGOIdeUbc,LDEACCFC.BAFGOADFeEBDUFGESBCG..gFBHhAAAEHGCHFDDDABChAAAZBADaEEFfGFAhAEA.KHAARAFE..WHAAAFCEdAHE....cGEChABAMDID....hACA...,1,-6,-41,35
gdJBeXQaFSHMVLcUTGZbPDKNOfIAECWRY,EDHFCDAGRCFE.dGDABABE..eECG.QACFaECCHBCGLGFEhAAAUAFCTBACZGBGDBFCNDAE.hAAAOHFEAIAG..WGFAhABA...YDDC..JEECFFBHhADAMGAG....hADA...,1,0,-26,26
RSeDZFKNAHMTEJOUYBbLWdCcXIQPVfGag,MAAFEEFHUDBHBCDDLAFDdAFD..CEAH...IEHHQEGGhABA.VFCFfACDhAAAaGFH.SBAEhABADGAFZCFEFBBGAHDFTGGD.YFEFhAEA.WAHH.XGBFhAHA.,1,-25,-31,6
VTaDbASIKcEFPeLHGRZQMgXBUYOdCWJfN,KFHHEHDGFDFELBFE.RGCAZCCHMBEG.BGFCUEADOCAE.CHAD.hAAAJAAF....fECChABANEED.aEEChACAbFFDAHGB...IADCcFAH..eBBEhADA......hAEA...,1,-31,-35,4
KMNdOXFAVTfbUagWeBcJIHRLEQYPZCDGS,VDBDTAEA..UFECaDDC...eFABBGHG.JEFBRBCGLCHHhAAA.QGGChABAYAHBCHFHDBBBKBBANACB.dEADhAAA.FGADADGB..fGCAWFDH.IAHBhBAA..ECAB.hBCA...,1,-18,-24,6
VgPEedFNcSWQOCUXLRDKGIaJBYAZTMfbH,MAHDHAAFVDBE..EDCBeEFGdGECFCFDSBHDQGFACADALFAHhAAARBDHDCAH.KGDFIFADhAAABHEHAFFHTGGDhACA..fDHAbAEH.gGAAhABA.cABGhAEA...,2,-28,-1,27
XEbSWBcFNUTJRZfGHOMCKVLaDgYAdPIeQ,dADGeCEEQFDDEAGC..SFGGBBGEFFAFUBAFJFABZCAAHDFHhAAAOFDHCHDHLAHHhABAaEAADIEC.ADEA..IGHHhACAXABA.WEEB.....NBIC.hAAAfEBD.hABAKHFA..,1,-13,-24,11
RWBfIFacVXUTDdeJHNEQASZgGPKCObYLM,SCFAZFBEGDAFCFACODCCLHFE.RABA.BFGC.FAGAaEHDVFBDhAAAUDFE..DBEGdAHChAAAJCAEEBAB..AHIBKHEChABAMIBA....IEAG...hABA......hACA...,2,-35,-14,21
WYKNUIXLgCZQJTADROdGHVbFMaecPSfEB,DABARBECdDAHGDFAHEDHFDGAeCCH...SBEAEGFGBACFKFBDUFBBhAAALBAACBCF..hAAAJFHBAAFBOHAEMBBHaHEChAEA..fAGB..WAGBIFHDhABA....hAEA...,1,-22,-23,1
BbUgTWFADdfeRIXKYQGHZaNSPMOCVEJLc,DEGAdHBHeDDDRFCD.KDGGGBBBHBBAZAFB..aHAGSGFFhAAAOAFECEAG.JACCBACC.UFGEhAAA..WFAFAEBE.hABAIHGF..YDEH..hAEA......hAFA...,2,-36,-21,15
cHMZBbOJDgaVWYUEXANSLQIeFTPfdKRGC,SDDDLCEDeEGBFGCG...TGBAdEHGGAADCBBFHAGDZEEBBAEGhAAAODABDCDHgDADhABAaCEG..WCFAhAAAEHEE.ADCD.NDIG.IHHD.KHAGMGDGhACA......hADA...,2,-19,-11,8
KAXGWCadVgEYbJNDZUIMFHPcBOLRefSQT,GAACaECC.dFHGEAFFJHCGDDBA..ZDDCMHCAHADDBFAFLFABhAAAREGB.SGCChACAKDEGABHECABE.VAGH..gCGEhAAA...NICB..FADB..hAFA......hAHA...,1,-8,-34,26
ZCDRASeWfdHTJaVUFIGEBOQgcNLPXbYMK,eABGdHAHJEDGUECA.FAFHECDF..BCHAOFHD..QFFFhAAA..cBADhAAANDAHLHBE.XEAGhADAbAGDKGAECGFDDIGAABFHSACB.hAEAfEAF.hAGAaAEGIAHHgEGF,1,-19,-26,7
CcVZMQXWUSJILROgGAfNKdTEPDFHaYeBb,KGCGEBAFFCDBHDFE.aGAGBHFG..CBBFZAFGMEEB..QDBFhAAAUAFFSEAFLFFAhABAODFDACCBdADADAFEeABGhAAA...VGAAJHFG.IGHA..hADA......hAEA...,1,-12,-28,16
XdfECORJQKbNZBVYeUHcWGAgDFPMITaLS,DBEEMDFH..TDBAaAABLFADdCBB.CBGF.OFAH.REDFJFHDhAAAQGGE.KEBChACANACHBDFHeADAcGDFhADAACIHFGFB...SBHHXBFA.bBCG.hABA......hAHA...,2,-30,-15,15
ICdZYNBfTScWeLOEaAVRbQGHXKPDJFgUM,VBDEQBGF.HFCEXDGFKEAHJFHHUCAH..CHACdBBBZFAHBEEBhAAA.SGFFhABAeCCALEFEaHGEAEIF.hACA............hADA......hAEA...,2,-30,-26,4
ILadQNRcSbFfZYVUXBKMPAgCGDWJOeEHT,CADEDBFG.OCEDEABEHBFELECDdGGF.RAAG.SDCB.FEGChAAAfEGBZEDDUFAHBCEDhAFAMIAEAFAH.gGGAhAAA.JCAH.....ICDChACANIBH...cGDFhADA.,1,-20,-39,19
PQSNZTdXGILUfOBVWYaeAMKDCEbFcJgHR,KFBCEGBCFABA..JABARGEG...QGEHZEEEdAGAGADALDCGhAAAOCCBVAGH.aGACADIHMFAFhAAA..DEGFCDFH.hAFAbBBC...........hAIA......hBAA...,2,-26,-23,3
MFGOPCRZgcUJDEQAYKfHXLVSNbTIedWaB,KEEHHDEBLCBCSGCC..TCGFdHDDaDAAFHFCOACGRFBFZDAEUEGBhAAADGHDAHAH..fAGHhAAAXAGG.NBIE.IACAhABABDDDGBCBCFAH......hABA......hAGA...,1,-14,-15,1
QCMRGgWadTNBAYVSLKOUfXZbHFcDEeJIP,VEFBSHAE.KHGEUDAEZAGD.FHBEEECD..eBAA.JBGFIBCGhAAA.CEFEMDADhABARDCE.GBDAaGAGNIEH.hAAAAEIDOFFE.fHEDXAEF..hACA..cFDH.hADADABC..,1,-20,-25,5
QDabCUMXKgdBYfNSFWLeJZGcTRAIPHVOE,HECDEFBEDEADCEHDUBGB..KEGDBGEE..fHCDSAAGhABAFEDAeACGZACCTBGAhAAAAHHH..IFAHhAEAPBAD.OCCA.aFFFMFIFXGAEhAFAdCCHWHEE....hABA...,1,-18,-30,12
RGMfEUHXaNLPcbYZBDFVSAgOCQWdJIeKT,CAFBQDECdEBB.eHFATABHRBAG.GCFCMBFAUFAEHFDDaBAHhAAALDHF.bDAAYAHBhABABGFG.FCDFSADChAAAAHAFOHFEIHBCfGCB.NIAB.hABA......hACA...,1,-5,-10,5
TDOJIQAFcYKLdEfCBPZMaHGWNgUbXeVSR,FHDAKCFFdAAECHHH.BADGZCDCHBGDGCBE......gABChAAAbBGF.eFEGSFGHhACARFBFDBABOEAGhABAIFFGACCF.LFABEAFFMFADWEED.NIDB.hAEAXEGE..hAEA...,1,-10,-25,15
bSXEgfQBTaOVLZIKCdYRNHUJFceMADGPW,GAFC..WEFESECD.XBACfGBBQFGDhAAATGGHOFDChAAALDEBKCDCCHADdDBFYAFHhABANBBDJHBAFEAH.MIFADIDAECBFBEHEZEAE.hABAIHAD..hACA...,1,6,-32,38
DKUgHLFGCfRdTOIABXYQbeVESNcWZJPMa,BCHDQFBAeFEGEABASDGD..NAED.ZDCA.JHDGMBGFhAAAaCAD.DCCAKADGHFBDLBHBhAAACEHCdBEA.OFAHhABAAHHEXDBA.........hACA.....YCCChADA,2,-34,-15,19
KcSINEZMeFgHQTXPaVYULAbfRJOCGdWDB,RBCAJAEEGCGG.dFABDDEHKGFG..SCBAEFDH.ZCGBMIFChAAAFGCEHEAGQGAHhABAXGEHaBBB...VAAAhAAALADEAAID.fDEHCHBGBGGBNDIE..hACA......hAHA...,1,-15,-19,4
CHTgLSNEOdbGFaUYKVABJWRZcfDIXQPeM,JGCAZBEBDGEF..QDECMDAHHAAALDAFEFFF.dBADFDCFaGHDhAAAKDHD.AHCH.BHAERFAH.hAAA..fEBBhABAIGHC.XBFFCBDA.SFGFhACANACF.OCHF..hADA...,2,-27,-20,7
XQMYNDKHFJgWOLbVBcURISPAGafEZCdTe,aBDBZCBDdGEG.eEFEMBGDDIBEKBAG..FAAFJHDG..OGAELFBChAAABACEUGGE.SGAGhABAGBDCEGGBCDEB.hACAQAFE.NAIG.gDGHhADA.WAFC...hAEA...,2,-25,-23,2
XdAebcUBYITHPMEJLWNKZVaCRgQFDSOfG,eCEDUDGBBEBF..TAAHHBBCEBGELHECKGGD.aCHDCHDC.RAGFFCCBhAAADACA...fFDAhACAXFACAABFcFAHhADA..IDEGMIAC.JFCCWADANAAA.hAFA..gFGEhAEASHAA.,1,2,-38,40
XGUDLEfCKNeaPMSgZAQFbJWVIdBOYcRHT,QGGGFBBD.JCFCVFBG.dEFCOAFCRADEHGFC.GAGChAAAUCBALFEBEDDA.hABAKABGNDAG.aFAE.MFDBhAAA.SHAEAIAG.IEHFBEHH.hACA......hADA...,2,-18,-13,5
JLCTZYAeQUgGBDXHVWfSRaMbKdNPcEOIF,UEDCBCBCDGECHDAD...VGFASHDAMAIF.KFAFdABG..hAAA..PACAECDGOACEhADAFEDECBAF.TGBFhAFAZCFHABHB.gAFH.XDFHfDCChAAAaEHF.NAIAIGHGhABA..,1,-5,-38,33
CaOYIfRTbPSDKAVLHXcBZQGeJWUFMdEgN,LCBAXBBCBAGFQEEBGECDJGCC..FGGCdCFHEADCCADG.OBHBhAAA..IHGAhAAAfDEBRFADTAFEhABAbDACDDIBABBG...cGCHeEAEMCIB.hABAaGGASHFGhACA...,1,-8,-22,14
dSaHRfJecCVPYXDONLMATIbBgEUQGZKWF,TBAABEFHEBAG.UAEHGFAB.ZFFGKEDCFBFFdCHA.HFAFRDBEeAFEhAAACACG....VFGHhAAAYADB.DABCODAAhABANIAF.AHDCIFCH....hADA......hAFA...,1,-11,-27,16
QYXgNCZAHLGaMVBUJKSFWbTdcIfeEOPDR,GCCGMCBCBHDAKAEAFFGD..TCEFdBAG....fGDFhAAAOABGPFAFDEABQCFHhABAXGFBCEGFABIFaHAAhACAJDBA...WFHHIAFG.ECHB.hADAYFHB.NAAC.hAHA...,1,-20,-34,14
QWSZXRaEegYPKDTdVJUfFMHcbOGBCNAIL,QEBBSCGCRBDFaBAG..ECAA.eEHDPAEF..DFGBTEGDhAAAdAFFJHDCUGDFMGBGhAAAbAGDBACG.CHHDAFEAIEEFhABALEACWEAD.XGGA.hABAKCAA.fCCBhACA..,1,2,-22,24
dHQPaOKVYZLRSEIMcBNCGDJTFXWfebAUg,dBCFHECEQFADOAEEKHCGZEFDLAAAREDF.EHACIBHDhAAABGFECCEDGCGEDGIBFDCF.XFAChABAeAFDAADA.PCADhACAaBAB...YFHBSDHH.NIAH.hABA......hACA...,2,-18,2,20
bSEXBAVNGHQIJDcPFLMeUfgRYCTWZadOK,VDBGGCAG.HDFEQFGBDAGAFDCAMCCCeBHF..UABGRFDFCHFBZAFAhAAAOHFC..SABEhAEABFACNHBD.IHHHhBAAPAEC..fFDF...hBBA......hBCA...,2,-16,-16,0
AVGMQKXIfPbBLHeSFOCRTEgWJDdZYacNU,MHACXDGF..IFEF..bFAELAAFSDBEhAAACAEATGGCEGFD.JDGDDGGChABAZEAEaADF..NICBABCCQAFFhACA.KEEEfCEGBBCG.hAGAFCCBOHCE..hAIAgBGC.,2,-17,-7,10
SACeEJHcNOgfFWaLQZMXDRPUdKIVGBTbY,CEFEJDFEHBAE..OFCCFFCELCHBZEEC.DFAGUACHKHGGGAEHhAAABDCF...TCDFhABASHBA.ABABeAFHhAAAEHDC...NDAG.....WFFGhACAMIFG....PHAAhADAdFBC,1,-24,-39,15
JcQSZGKNMHgVURdLWYeXBAIbCOEDFTfaP,CDDGDGCHFAGH..TDBF..aHEGJFHFQDGFGAEF.KECDHACFhAAA.UGEHdAAALDADhACAeDFABHAFACCGOHAChADAEBAAfEEESBEFMFDHRFFE...hAEA......hAFA...,2,-24,-4,20
QAgcIZEMKdDTSLRFGWNUPVBaYXfOHbeCJ,..IBEDZBDAMFABdEAFDDIHLGCGREFF.FBGDGCAH.UGBDhAAAPCAEBEBGaGFDXFDFhABAHEFC.CHHC.AGADEDEEhAAA.KHAG.WBACNACD......hABA......hACA...,1,-18,-25,7
OSZgFbCTWRPdNEHaeIMBKYUQGJDXAfLcV,LDDFOACBZEAAFBGF.CDBC.RDCEdCGHHFFG.eEABMFFFBBCC.KEFEhAAAUEGB.QGBGhAAADIECAECB..fBAChABASHGC.gADBWHAG..hABA.EAGGaAGA...hAFA...,2,-25,-21,4
dPXAESfYcgGCRBTZDWOabFQLJeUMKHIVN,SDGG..YBCEGEBECEECBDDDDBFD.aFACQBAChAAALEHFeAEEMHDCIAHDhABANFCF.dFAGhACAAHAGEAABgFFETGEGOCEAJACGKDCE..hABA......hACA...,1,-2,-27,25
VbMEPSRgIeUXQaBdYNCKAHTLJODZGFWcf,TFEHJFEGZCBG..GAEFFCDA....fADBMEFE.EBAEhAAASCGARBGH.hABAIHGBeFAEXGAChACABBADdHCBCHGAKDBCAEAFOAAADIDAcEFF.hAEA.PFAE..hAFA...,1,-8,-31,23
NMPDXcZTJafIFHRQAYOBgWCKbdUGeLEVS,BFABCBGAKEGF.dFGDGBEGEDHH....SHBCMHDCDGBAZDAEaFCE.hAAAFABCHBBG.QAGEhABAAHHDOCHF.WBEHhACAeAAD...NADB.XGEH.cDAAhADA.....hAIA...,1,-15,-35,20
GDJSAEcKCQaTUWFfHRLXBVbOIdgYeMNPZ,EGHBCFGB..aDAFUEGD.FHAERAEGLCCCBFAG.OGEEdBDFeAEEhAAAMIBEZDEB.GBBGhABADEEBADDBKAAH...QCGEhAAAfHDF.XCGBIGACYEDDhACA...hACA...,1,-11,-34,23
gaIQRSBGcFVJYWEXCfbOMePTHNZDLdUAK,aAFFQCDGBGDGGBAAFCBC..JFBFEFFB..CDGD.OCHB.hAAAMEIHeAHHHDDENBAGLHFEhABA.AFFAKFEDhACAIHAG.SAAC..YDHBhADAfCEDPBEAhAEADEAH..,2,-33,-19,14
SPIaVACJTgdcBbUHeLDOfMKYFRQGWXNEZ,CHGCJCDEdBAHBABGHFBH.DAID..MEFDFEFGGADH..XDCChAAAECDEZDAG..SHDEhAAAaDGCAIGG..gGBBhACA.bAEE.....eDAHhADAfFGFKGGG.hAEA...,1,-24,-39,15
DFPGJWLNbadOfUMgReSYVBQcXIHATZCKE,CAAFKEGGDEADFGGG.GDCALHCA..aACBdCFA.OBBDMBDGRCEF.hACA.eEHB.VECAhADAQFAD..hAAAXGGHABAFEGEHWBBDNAIE....fADFhAGASBHDBGFEhAHA...,2,-32,-21,11
CFIUegQaMSKLbdAJZEWYDTOBXVfGNcRPH,EDCFDGIBBGCF..VBEGGCBHREDA.CGGH.UBAB..QAAGhACAMAEGLHFEADHEJBECZFAFhADATDGC..XEEEhAEAfDAC.NIAF.cAGA..hAFA.FHEC....hAIA...,1,-15,-28,13
TFEZBMSdVGKcANaLfJgPbRQWYXDeIOUHC,aDCGLAEF.JDHH..PGECQEEB..XCGDhAAAeAHBUCBDCFCBEBBGBFCChAAASADBdHCDKACDAAGBgGAFhABA.bAFGWBAFDICGOFFAhACAFGGBMFBDcDEB..hAGA...,2,-24,-15,9
dNYJVFZCXTPLAMBaegHQIfODRUKbEGcWS,MCDHBGFFaCCAHGAC.QEAGOHFEDADGUFFF.EBBBGAGChAAASDGCdFBEJDEDVADGhAAACCAF......hABAPEHDAACH.eABG...fAFChAIAbFDH.NDDG...hBAA...,1,-2,-27,25
cWAJCXNKVDfBYRaMQIeSZEbPgLOTFHGUd,CDHEKCACDBDFBFBA.RDGB.QFDB..SAEFZBEEEBAA.hAAA..PDDGODEChABAFAAEUDAGdFFCACHGNICF..hAAA...fDAEaFHDIAEFeAFAgGAChACATGCHcDCChADA..,2,-32,-27,5
IbDaCUBEfXRePHGZgdAVSJLNYFMcOTQWK,SDCEJCHFLEAFFEGC..MDAAOFCE.QGADhAAAKEEDDGHFCHFA.BCFB.EADCRACCeFCHhAAAHBAE.ZBFBdAGDACFF.hABANHDF....cDAH.....hACA......hADA...,1,-10,-32,22
gNADUHfEGXLSZbYJKCTdWBFMIaPeRVQcO,DDDGUADEECGCLAGF.ZCBFJGEGKHBACEAA...dFEFBADGFGHB.MECAhAAA..aHEGeABBhACA.RFCH...cAAGhAAAOAEG.AHHG.fDEDSAGA.bEFEhBAAWBHB....hAIA...,1,-28,-40,12
cWFgRVaAbUIZMKNfQEdHeYOCLGTDSPJBX,UDDAZFFHMCBEKADG...QGCBHBAHOGCALBEHDCEC.SAHDhAAABAFE.XFABhABAFHGARBGHAFHE.IFHDhACAEHAC.dDDCCAAF........hADA......hAEA...,2,-35,-21,14
LVgRIBKJWFMQCbEGZSHdPXOfUNTDceaYA,VADEREGDKFFF..FGAGCGFH..GDGEZACBHCAFdCBG...OEDDUGCEDDEBhAAAeAFGADCG.LHDAhAAABABC.MDFCEAGESCHBhADA..fABE.hAIA......hBAA...,2,-31,-13,18
PSQVGIKfWRBUMOYgNbAEcLTFdaDeHZCJX,EGAGTGDCFFBA..dAFGeCEAHEEDZDCA.CGGG.JBCF..SGAHhAAAQGGHGABHKACC.hAAAfDGABEHDOHCChABANCAGAIFALFCFDBIF..XCEChAHAIAHB....WBBDhAIA..,1,-11,-16,5
QCDKEIHeLGRaUcSBWfNdFOZXPMYgVbTAJ,JFCFCGGCKBDAHFEC.LABGGAAERCFE..aDACUGBBBDED...hAAA..fCABhAAAdEEAFAGCOEABZAFBMIEAhACA...YBHH...bFADAEDHDADChACAeEHBSHFGhAIAXCCB..,1,-12,-31,19
TPCAeNZBEaDILHWYXGMfOdcURFgJbVKQS,eGCGBAFCaBCGLBEBHGBC...XBCDMDAGdCGDREAHFHGC.JFFAhAAAVEGF.KEDASBAHhABACCEHAACG.NAHGDACAhAFAIBAE.....YEAEhAAAfECDcGEF..hABA...,1,-12,-33,21
QdJKgfLDYeSPEFbBIONWVZHTcAURMaXGC,UCFFaHFAGFABCHGD.dBADKCBGLBFC.eBDHSGBBhAAA.EEDDBHEG.OHAChAAANDAG.ZEEATFGBhABAAAHAMADA..QABDfDBCDFFBPDFAhABAIEBG.WBHBhADA..,2,-35,-15,20
OfYRHJdAENKXWFTSIVcUbGQBeaDPgMCLZ,EFCGKGGEFBFA..TBFC..IABBVAAH.UGABQEFFhAAAeEEH.aEABDEACMHDAhACALCDDOFBBfDGEhAAAYADB........hADA......hAEA...,1,-7,-43,36
YZEXCHIbgAeJBVdUcFQGaKfNOSMWRDLTP,BHFBUAFFFEBHaDAH..KGCFODDF..SEDGRDFELBBG.hAAA.TBGA.ZBAFhABACHHCHFFE.IHDEhAAAADDAJDGHdACH..cGACfGAA.hABAWEHHDAIB..EACC.hADAXCAG.,2,-28,-17,11
VBEdfWgDaGXJHTILSFOcRbMNQUAZYKCeP,ZEDAKEEGCGBDeEHD.BBECdBDE.....fAAGDIDCXCGAhAAAJGCE.HFCALEAHhABAFCBDOFHBRAGHMIFEQAFFhABAAFCH..YACD.EDDGaDAHhACA......hADA...,1,-15,-31,16
CLMGXVHEPebRKFJDOBfdSTZIANUcgaYWQ,UFDFaEAH.QAAHCHFAGCAD.HBDD.eBFERGCCJBFDDDBH.BGADhAAASEBAZDBDAGGH..hAAANIAH...gFFEhABA.LBHBMEFE.EACC.KHAAOHFEhACA....hADA...,2,-16,-12,4
LVBHecWDUYRaAdfEZONCKgTPbSMFJXGIQ,dBGBZGFEOBABKBDF..TEADSFECFGHH.GCCBLFFFhAAAHEBDeABBDAFCRBGBAADCEEGGhACACEHA....PAAGhAEAMEEHIHAA.BCHDWBDCaFCDNIAD.hAIAbAED.....hBIA...,1,-9,-14,5
PLHVWIgGBCUNKZEOMQaRebSFDfTYXJcAd,dAEFLEGDHBACVDAH..gBGDBGHDUDFBZDAF.OABFhAAAaGGH.eEEDFAHHDEIHhAAAfCEE.YHAEhABAcGDCAADDPDCF.IAEBhADACDDE.NEIAMICE..hAGA...,2,-23,-12,11
RcFHBUOTLPCaDegVXGMKAWNYdJQZbIESf,...NEBC.JFCCZFDGEBGB..RADGHCCEBCCEOEBHLHEG.aCGEDGHHhAAA..eAFE..hAAAXCEGMBAHAHFGdEFBhABAICAGSGCDfAHG.FABC.hACAPDHDCCBC.gGEAhADA,2,-38,-10,28
MCDIeHNVBcLQbgTZYRWSdfKAPXaJEUGFO,XDFDaEAD.UCACFEDCCHFE..DAFGeBCAHECHBCAHLADBhAAAQDGCTBGD..hABARGAASGEDhAAAfFHAAGGBJABGEHEG.MBFBIHHCNIAH.cAFDhABA.....hACA...,1,-12,-24,12
OTVbUBAafFQeKHGESgZPIWNJXcLDCYMdR,FFCCeHECHFEFGAGGSADFZEBE..PFFA..NECDXBFHhAAADIGCCCBFdABHODDAhAAATGAH.UGAHAAGAQCABhABAKAEC.IHHH.JDHB..hACA......hAFA...,2,-19,-14,5
RWeYPQGBgdKSZbMECFTfaLDHcJVONUIAX,XGGBRACBeAFH..QEBDBBHGKDECZAAFEAAH.FGBC..aAHBDACBhADAHFEG.JCABNEEA.AEEH.hAAA....PEAEhAEAdDHAMICE.CHHH.TAEE.LFFFhAGA.....hACA...,2,-25,-11,14
DZYKdaLMCOATfJRINePWQBHXUgbGcFSVE,JDHBREFAeCAH..QGEEHECHUACGGBEDFHAA..SAGEhAAADFEGZGAEKCBEdBFGaEBACBGAAIGEhABA....fAEHhAAAIGHC.NCAABABHXGEG...hABA......hADA...,2,-30,-12,18
ZIeFVgfJNAGXEaQSOcbCdKPLYRTDHBUWM,GEBDXCAHaEHF..SCGHOBAHCBEH.KCCCLGEARFEH.hAAADCGBHFACBHBAMBFBhABAIBHCFHGAfAFBhACAABCHEDDE..cGAG.....hADA......hAEA...,2,-25,-21,4
KXTZJCQbRYeSHUaFMNELcDWOBgPGIVdfA,TCEGJBFA..QCDDRBCF.eABBHEEC.aBHBMHFCEFAFDAAEhADABDAEGGCFdEHAAGABKEBAhAAACAFCSEAEhAEAFGDF.NDIC...WAFE..OHAC.hACAIBBCfEEGhADA...,1,2,-38,40
NLVReSPHcEdbBfFXYCQWAJOMDUTgKGZIa,JAEADEDEUADC..TEFCKBHDZGFE..aCDELBBD.REFA.hAAAPAAB.EGDAdFBEhABA.BAHBFDBDCHEAAFDGMAGFhACAIHGE.eHAE.SCGBhABA...cECDhACA...,1,-35,-36,1
TVaAHRWDKGdfeNJYPCSQgMUBIFLXcbZEO,REAFDDGAKFGDGGAH.dDABeBDF..JDDFCFEHQDGEUACA.hAAABCGCFAGALFHDhABA..XAAAhAAA.ZAFEEFACOHAEaGFHABEC.fEDFhABA.NADD....hAFA.SFFBIHHF,1,-18,-22,4
EGWTCLNPRXMaUdIFSYAZbfVKgcJQeDOBH,ZBBGVABEKFDD...JHFCeEAE.BBFFEAAF.GEEF.TGDGhAAACAHBLCHD.RFAD.hAAAaAHDdDEFFFADACFG.fCGEhABA.QCDHDGFGHDBDWADEhACA......hBCA...,2,-29,-10,19
gIWAVeGZXBUEMdOfFKQRNYHTSaJCcPLDb,eFCDGDGEBADBUBGFMBGFdBECFFCA..RCCEHFEB..aHAGCCACLAHHhAAADAEE.IHHGhABAABBEXGEEOFAFhACAKDBG.QEGA..NCAESHBAhAAAcECF...hAFA...,1,-17,-30,13
VZPdDAQGHEBOUgcMaXCTYNISefLJWKFRb,HABGBABFODEEUBGFMFFA..CBHD.TGGA..NGCBeHDAhAAAJHAAKGEH..RBCAZFAHDECGAGAChAAAEDBE..aCFHIHHDhADASFAE.fBAGLDHH.WAEEhABA....FAEAhAHA...,1,-17,-24,7
NUYecBCAbFdEJPQHMaZOfDGLSXIgRKTWV,FEEHECFG.QACEHBAFaACHZFBADGDF..GCFGLEFG.SAFEhAAAIGBCKHFGTGGEhABAVCAG..NIAH.eFHDhAAACDDHAFDC.JAFEMEAH.......hABA......hACA...,2,-20,-2,18
TLScRAbXCBDGHEMJeKZagdWYfOUIPFNQV,CHEEBGABHAEFEACG..MBABKFGHZBFAdEFD......fGGFhAAAUEDEIHEGFHCCQEBFhABALHAARCBCAHAGDBIHhACAeAAHaBCB..gDFHYAGH.OAEAhAAA....hAIA...,1,-11,-24,13
EZIeMAHbNBKVUaCQSfPTdgJYRODLcFWXG,HDBABAEGUECCCGHC..SEAD.TACCJCACOBGHhAAADFGDLBFDFGAB.XGCGhAAAZGFCMICGAAHEKBABhABAaABE.PBHF..dCHE...YAFChABAWHFA...EFFEhACA...,1,-12,-37,25
ZNUFGWLgQDPXbAOBTKcICRYJefdaHVSEM,BBAHKHFCCDGC.JDDC..eHACdBDBHGFA..ECAHMDABZACDFEDBLHAEhAAADAFE...bABBhAEAAEBAOFFE..hAAAcBGFIFBEfEGHSABB.hAFA......hAGA...,1,-30,-38,8
ETKYWBGSVRaCgbUAIJOXdZFcPDLfeNQMH,JABAOECHZDCE.FGGC..DGEAeEEH.MBCAHGBA.KFAFBGAHGDGGhAAASAACRBFA.hAEACDAHUAFCADCG.dDDC.hAFA....PDHFNIDB...EBBB.hAGAWHDGaBBC....hADA...,1,-25,-30,5
EfMbcUHdaTICGVgQYFLNRBeJOADWSPXKZ,SEHFKADCEFCH.MDFEUBBH.dFEBaDBH..CBGHGGDFQAGBhAAAFDEG.LBCEhABABABB.JFAHAICEDIGGPECAhACA.fFFA.cGCCIGADhAAA......hAGA...,1,-5,-41,36
OLIWTMacVNBPCGEbSQUZAXHKFeDfJRYdg,XDCGFDFFeGCADCAARDGB..dAGFLFAH..IFFGhAAATADHaDCBVBEH.BCBFhABACGGEEHFESADChACAZCGFADAEKAGG...JHBGOAAAMEBBNIEH....hBAA......hBBA...,2,-19,-15,4
EaIHVcXGOCASQfRMKdZNUTLFbeJDBWgYP,SFEAQBBFRGBGdDBEZAEDUACCLEFCFBGB.eFHBBGHH..hAAA..gBGEhAAAPDDBaHDEIECEhABA.cGFAOCHFAAEFfDAANHAB.hABA......hAFA...,2,-34,1,35
fUWQaLDHCBeTKJYgdRbPVSNXcZFGOEIMA,UDEEaGEDLACDHACDBBADKFBF...JFAFdEDCRGCA...VCECSGGHhAAA..NBDHXGGGhAAAFBFEEFBGAFIF..hABA.fEHCDAEGeCCD.YHAG.hABA......hACA...,2,-25,-18,7
aPMYANgRHGcKdVZIBXObfEWQLDSeCUFJT,RAAHGDCCdGADZEDGBBHC.OFHHEEHHLAFCeFBB.UDAFFADDJBAHhAAA..aHEC.MDDAhAAAAAHCHFED.KCEBIBGHhACAfGAGDCCACHHH....YAFHhABA.....hADA...,2,-22,-13,9
gfdPEaQXJIDNRCSBYWGbUHFOVAeKMLTcZ,KEEBTBEDZEABdFHA..aFABQBDB..IFEFhAAADCADCCHEBAGCGEBC.HBAFhABAFHEAOABDAGGBMEEELFHHhACA.gACAEDFGNIAH.SBHDhADAWDDD..hAFA...,2,-33,-13,20
XIcPNUFeVSJaEHABZbgDLGTORMCKfdYWQ,ZBDGDFGCGACFOABHRGFEKHAG..dDHAQCAH..IHCDhAAAPEDB.FEEESHDAhAAAEADEBFDDLFAHhACACAHHfCFG.XGGDcAGA.UFABhABA......hACA...,2,-23,-23,0
fVEROeZBAXJNGaQMYgTLIdDFSHKcWCbPU,XGDBJABHGDDC..aCBGMIEC..TAFDLAHH.dDBDhAAASDECKFBFCFGAUCFChACAEHAE.OFFDZGFABAFFhADAAACAYDHDDAEFFHBE.WEBB...fAADhAEA..hAFA...,2,-35,-10,25
cEXaHCDKUMdNBASfFOGVPTRQbgYLIZJWe,FCGFVAFDRACB...QEGF..gGEELDAAJHDEhAAAeCAHECDEHEFE.DBIDhAAAMFAHBDEGSBAChABAOEBD..........hACA......hADA...,2,-31,-26,5
RdTJDVQUYcMWgeZaILABFfNKOSbEGHCXP,BBGHFBEBKFEDOFBE..ECGGCBDB.RBAH.dBAGDIACUEFD..MHAChAAAeHDEZDCCLAFFhAAA.ACCB.fGFAhABA.SEAD.bACBXEAChABAJDGH.QGGFhACA.YHAA,1,-26,-30,4
VUBZHDFXMePcSfAIJLbOEQaTdWNRGKgYC,LBBFECBA.aADDTFEB.dAFGRDDGKGCCCHGEBDHHDABC..FBGFMICEhAAA..eHEESGBFhABAAAHCJFAD.OEBAhACAQFGBNDAG..YABG..hAHA......hAIA...,1,-29,-31,2
fHJRZVbUgceSEdNXPMYGIOALaBDKQTFCW,aEDFKDDFQBGC.FCADCHFAHAFH.JCCGZFCEUEAAeGEAEBAChAAAXFAB.MIAChAAAIHDBAABABEFEDBIFhABATACARDGD.........hACA......hADA...,2,-30,-19,11
SWMRHAGTIOXBagQDCbYPKJNecEfZUdLFV,GAFCTDAA.OAAGBHAE.QFABDACDCGBB....bFFGPBDDhAEA.KEHBNAFC.EGGEhAFAZAGDLFEH.hAAAFDBBSADH.WHFAMIAAAIDCIEDHhABAaAHF.gDGAhADA,1,-15,-30,15
cLTDbKeJGQMWYECPgUVIdaRZABSOFXNHf,OAHFFBBF.HFEBLFEDDCECKDAFJBFCGAAF..MECEEDHDCEGDhAAAUFAF.dDGDaFBEABEFBGFDhAAA..SDEChABAXACF.fHCB.cGAHhADA..eBAD.hAEA.QGGGWHAA,1,-6,-33,27
WZBYJGbNSAIMPfaFTKEeLHQXOVcdRCDgU,MICGaEGC.FAFHEGDCLACHHFAH..XCAAODEH.dDFFDGHBUAEFhAAABGDD.GBGEhAAANAIGSGGDAECA.fEDBhABAKGADeBAF.cABBCGFA...WHCAhAFAJEBF.....hABA...,2,-24,0,24
SMFeODPfIYGWXKCTBUgQcdaJLVNAZEbHR,ZBDBHCFGSEFDFAEFDFFB....IGCEGDAAKEHFBEDDUABAhAAAQAAEdDGFaFDFLHAGhAEAADBAEGHF..hAFAMIAC.ODABfAGGXEGGCHHG.hAHA......hAIA...,1,-18,-22,4
QfYBCKGVHNOAJPMLZIaRESgbDecTWXUFd,MIFCLHEGZEDGRCEAECEF...SDGBDCBHeEBC...TBCDhAAAXADFUGAFdHCFQDABhABABGGBKBHB.HEFFhACAAAHE.IBGFaABF..cGAGWAFE.hADAfAFACBBFNDIA.hAEA..OAAB,2,-17,-7,10
fWcSKgbVHRJOaMZUDPTXQdBeFEAGNCYLI,CCHCLBAE..fCAFSDGDKBFFVFCEHEEH.OHBAhAAAaDDEMIFGDGGEXDBAhABABGHGECAFAAGH.NIAF.IACDhAEA.WAFEgEAA.bBEChAAA..JHFGPCHDhABAdDGD...,1,-15,-20,5
DABHaJGgFSbKcILRVZONXPeQEdWfMTUYC,BDCEHCCEaEABGECDFAHD.KHDCLHDERACC.ZAADXGABQFGFhAAAdCAE.MGBAUGGACHADDCEChADAAAIH..SCEGhAAAIEEA.OAHHeACA......hABA......hACA...,2,-26,0,26
LKWXFAZGPUTfQbdRCEOHYaSBJIgNDeMcV,GAEHTEFG.QGGFdBBHREAF.CHADEBADHFCE.aAEHBECF.JCCAhAAANIAH.DEFE..MAADhABALHCCKAHHFHGCZEFEPDDAhACAfEAA..OEHDSFCAhABAgAFD..hADA...,2,-8,-7,1
FHdOULYbVJGeCISWZcQNRMPDAKBTXagEf,KHAGXBCAEEGF.FCFFOEHD..LCHD.VEABeBFGhAAASAAGZBCBNACFMCBDhABADGGABHDHaHAEfAEDhABAUFDH.JDBCCAHHWCFGQFEA.hAHAAIDA......hBAA...,2,-26,-8,18
UBgIFKbSdZCOJHVDGXMWQYeALaEPcRTNf,LCDGEEFARABA.TABBUAFBBGHA.FDCFbGFG..dGGCCFAHJECEhAAAHEDB.DCAHGGAHhABA.MBIHQGAAhAAAeBECAIGC..aDAANAIA.IEGF..SHDAhABA..hACA...,1,-2,-24,22
PVNUJHdRTCXGAMZeIfcDbYKEFaWOSgQLB,MAEAZDBAeCHF..IFCGDCACKGDDFHAAOBDA...SEEAhAAAQGFEBGHFhABAVADBNDEF..HCABdAAHCAGChABAAGGFfAHA.YGCGaDAHWCFHhADA..gCCDhACA..,1,-13,-30,17
NGWQBLMPFTIXCVZgUdbYDASeJfRcKOHEa,eBHBRCECKGFBHBAEEFHHGDCEBECFLHBA.FAGETACA.hAAACGBHVCECZFAGdCHADAECAHIDSADEhABAJCAF.hAAAOEFCWHEGMIAC.IFFA.hACA......hAGA...,1,-7,-17,10
BDKVWLRPdcYSMEafZTFJHeQCXNgUAbIGO,GBDFBDCDKDFHLGAGdACF.SHFCaEDDZGBC.FCBHHBEACEEA.hAAA.XFGEUFFFAAHE.hAAAIADADGAB..hABARBAH.cCGEMFIFfAFDJAFCNIAF..hABA......hBAA...,1,-7,-26,19
RNGTYKHJgCDSEUVfBAWePQMacZLXbOdFI,eDDGQDCAMBCFZCGBLBCG.XFACOGDAFAGC.REBA.hAAANDIAGCFCKBDE.JCAHhAAADDABEHGE..fHGBhABAACHEaHDG.........hABA......hACA...,2,-28,-15,13
GDbAIdLOQYTPZCFScWMKUeHJEgNfRaXBV,dFFCLCFDOFAEQBCF.TDBDPDHF.FCCDSFHFhAAAMAFH.UGBGhABAeABAEAEE..fGDAhAAAaAHFBEDADIGCICAGCCAAKGDB...JAHBhABA.NBEE..XGGHhACA..,1,-16,-18,2
ZKTLNMbWcIGXBHAfFaVDgUJYEOReCQdSP,FCEBDGFFUECFEBBC..RDGH.CAFG.dDAGZACHLGDA..MCHH.hAAA...cGAAhABAXBAGAIGGaDCD.JAHHeAHBhAAA.QGCDSACEKGGE.NEAA..hAFA......hAGA.IFEF.,1,-13,-33,20
LQGCDNBHROIWXcfAKYEdTPMJeSaZgFUVb,ECGHdFHGMFDA..SEBCaDAE.ZFGDFBDAUADDLAFHhAAAQGBFCHDCBBBBHECGhAAAOAHDXBAFAABCKHEG.hADAYAHH........hABA......hACA...,1,-18,-36,18
NSWKVfZAQHTJCbdOMUELaBIYcDFGXPgeR,HDGDJAAA.CAHEdADCUDDDLGBGBFAH.....IFCBhAAADGEGFDGFGGABXBAA.hADAeEEBSBDAhAEAKCEBfAFGAIHC.QGGBOGFEMBIBhAFAaGAH......hAGA...,1,-4,-43,39
BLZUXYJaMOEIKdGHRbceDFTPNSQACWVgf,VCFFBEDFUGEH..JAFGaCAH..MABHEFBB...KADCHCBHhAAAREDF.eABGFCCH.TAFAhADASCHBADHB.CHFD.hAAAfEFALFCDXGGAIHHA..hACAdAHA.....hBAA...,2,-29,-14,15
eOcZPXbVDQMIBNgJWGERdTHFaCUSAKYLf,LEBHeEHHOBFGZDFC..XCDBDBCGMFCDBAHB..JDADEAGBhAAAREECHCDGFCAAUGFHSAAChADAKGDF.fHEDhAEAPABC.bECBIFAH..WBBGhAFA.....hABA...,2,-27,-6,21
MePIFWfLBdOYJEVCZcAGgQDaXTbRSUKNH,QEFFXFFDRABE.SCAG.UGAHNCCCHEDH.MFADhAAAICFEFBFFLDHBhABAOAAAJAFECDAAABHCDADGbDBEKGEDhAEAeDEG..fGHABHCF.YBBGhAFA....hBAA...,2,-25,-6,19
eRKcbCDAHZFPTXYJaOdISMVGLQEUgBfWN,FCCHTEAD..XBEEaGGE..dGFGMAAHVBDCLHFGhABA.UFBBBGDFfGFDhACAeHBGKCGGcBBGhAAADAIBAAHDZEFA..YEECIAEC.SBBEhADAEAHDNACB.CHDH..hABA...,1,-16,-24,8
GaMYPWKgOINVTRCJEfcAeHSLFdXQbZUDB,SGBCLEBBXDEFZDBCBFFG.GBABMACG...PHEGhAAAgAGB.IEHChAAANEIERBFF.EBBBADABeAHBhABAFGHFdHDF.bBDGDFBC.aGAH...KEGHhACA..OEFDCAFF.hADA...,2,-10,-5,5
KIUYgNcPTaZWGEMXSbABQdHLCFVDOfJeR,dGBBCEHDDCADJGFC..RABB.KBFD..UFEE....NCEE.TEBFhAAAZCAGGAAD..ECHDhABAMICEXGAG.hAAAADDDQBEDFAFAVDFAeEAAIHHB.hABAYAFC..hADA...,1,-17,-38,21
XDWSLVGeCPUQREOcHIaMYdFTZKAgNbJBf,...NDBG.JBAEBGFADGGGLFABGAEH..CEGE.QDFHhAAARECA.OHCEHAAAIHCEhAAAMCEDFDAAZAEAKCDCAFABhACA...fHGFWAHBeFCGECCB.aCGEhADA......hAEA...,1,-21,-22,1
aGZLFbCMPVERfTBNOgHUXJeDdIYSKAWQc,.QEFEaECFGEEFFAEBCCBF...MEEDEBEARFAFBABC.OACDhAAAHACHJHECdGAB..IHHEhAGASAAFAIBEZCFEbCFEhACA..PCBB......fHCBhAEANEDE.gAGHhAFA,1,-5,-27,22
fFcEVdATHNJbDUIBRMQOWPgCXKZSGLaeY,TAFGJFEB..DAGDBGEG.MFDFQDAGOABH...gECAhAAAKFFBZADBGDAHhAAALAHHeAHHFGGBEHGChACAdBCGAFEE.NABF.IHAE.....hBAA......hBBA...,1,-9,-33,24
MaUcINWYBDCRbdXJZVGTLfFHPSAQegEOK,QEECEACFKHAA.aAHDUBGD..IDAE..YECAhAAACFAGRGEAdCCEZBFHGGEDhABALFCFFBDDHCAHSACGhAAAAEAHeEEEMGAANEIEBBAH..DEIF..hACA......hAEA...,1,-9,-13,4
MLJHXdUDSZaEGPIbOKfecATQFWYBRCNgV,QGEFFBFFBEGDRFEG.CDBD.....VDBDJAEAdDEG.DGDBaHDAEAABhABA..GBDE.hACA.bDFEOHACKCCB.hADAeAHFAAIF.TBACWFGB.NDAA.MCFALAAChAEA.....hAHA...,2,-32,-7,25
CVFfZPgKdDNYOWSTBHULGEQRXAcJIaMeb,JCAGaFEF...eFFCCBHBFBABZAGF..KGGDdEAD.DBGFOBDD..hAAASGHBBGDBUFAFhABALEEFEBFH.RACGADDBhAAAMDIF..fFCAPDAC.NIBB..hACA.TDFF..hADA...,1,-25,-35,10
JGBbdHNDcMgRZWOVLSTUFeQAXaYKECfPI,aBEDKDDECEAC....IHCCBBHDHABDDGBF.MIACZABD..VDFAhAAATDGB..FHGCQFFGhAAAAFAFEDDD.fGCDhABAJEAAdAHEgADFWADE.OGCAhABASFBF..hAHA...,1,-11,-40,29
IRefbQWVENKAUOdPTcBLFaZYDXMJgGCHS,dDFDTGBBLHAA.aEHDDBCF.MAECGFCBSEGERDBA.hAAAeAAFfBCChABAQFDEEGAEAHFAOBDBhAAABHHEFAEDYBFC.gCEFCABA.hADAIFGG.WDAHhACA..,2,-17,-7,10
LEgeUVJIABabGCRDFTcdKNXfHOYSPZMWQ,BABCaFDBGACHRACBFCGG.dGAH..KFGC..fDEGOFCC.SGHBhAAAMEAE.LHEChABAEHAGUGGDICAHhACAAAFH.DIBENEEH.HBFG.YDAGhADA..WAADgEGChAFA.,2,-41,-10,31
bEHWaZPgIcGLUAXOdSKQNTeJRYMVCfDBF,OCFHKBDFQAFG..TBCCJEHFRBAH.MFAF.CAAGDBGEFGFCEDEHhAAAHCGDZEAE..IGGBhABALHAEAGCAXCAGhACANIEB.eGCAfCGHWFBFaEBA.hABA......hACA...,1,-12,-22,10
SCfVMEaRbTeXQAgPILdcBYJHGZFWNDKOU,..IGDDLBHHdFFGBAEBHBCAFAACDEIFKCFFUAGHCHHA..MCEBhACAEDACRFAB...TCGAhAAAQDBD.ABDD.hADAcGGFJHCAZFFGWABESGAD..hAGAfEDFaGBG.hAHA...,1,-11,-30,19
LOVRZdPWYeKHTFDQAIMEJNbXGCcfgaUSB,EFGHJEFD.....bEBDCBDE.....fCAHaGBDBHHEOEAChAAAVBFBZAAA.PEDChABAeCDDKGDF.FCEEABIFMEIDhACA.NIABcAEGSBHB..dEAChADAWACE...YABFhAGA,1,-10,-47,37
VYPbeZMdOCIBHgJRTXaLcGDKESUQNFWAf,VBAE..bDAHZDDFMCAD..dAGDIHBBHDFFJHCA.REAB.TDGAhAAALAAEDCCCEFDHhABASCFCQGFEhACAFAEBAIGGfDEF.eABABGHDaDDB.hAHAKAHDNCIC.....hDAA...,2,-10,3,13
aBUWbFQMgcIPLAZeVfRKJDCTESdNYGOHX,VBADKAEACAHB...EGGAdEED.GDBAHDFHXDDFBBGH.UGBFhAAAFDHDMAAG..cBFFhABALCBEAAFE.eHDGhAEAfEBHDHGA.SAHBNGDB.hAGA....aHFC.hBAA...,1,-6,-31,25
ELAVJISHWfNUPcDMRYFgdbaKTXeCZBGOQ,JFCESAAEHABD.....NDFEUDAAPHBA.DDDAMCCGFFHD.hAAAdHGFKEADeAGD.CHBEBEHFhADAGBEF.OHFChABAEAHDAEGH.IAHC.fADDhAFAcGDHYDDH..hAEAbDEA..,1,-12,-31,19
PcTVLIYfHCaDOSGMAZNbdgQJBFUeXEKWR,ZCDGdFEAQCDEFDHDUABH.EACGKGAD..RCFC....TFAEhAAAIGEEHBBD.DHGGSCAAhAAAMIBAAEAEgEGAhABABEFFeEBDPAFE..cAFBhACA.LHDG.hAEACAECaECC.,2,-37,7,44
PZGagYMNBHWVLdAbKSIJEOfQCFUTcDXeR,SGFHEFDB.OAFGCFFDFHGEUCFD.DBCHXCAC.hAAAeDEEZADBGDAAhABAaDBEMCFGBAHCHFBA.LFFEhAAAAEIFKGCF.IHHB.fABChABA....hADA...,1,-16,-38,22
ILGADaVZfgCcPBNeKSYRTWQEXbHFMOJdU,DGCBZBFHCBAFBDEH.KAHBSFEG.RFAE.TADC.ECAAHCAGhAAA.OHDCdGGHUDGAhAAAIDECAAGC.aBCAhABAfDCE..PAHHeFAH.YFHFhACA..WFFDhABA..,2,-37,-30,7
PXeFYKACEBWDQTVSRZaIbHgNOdGJUMcLf,BFEAQDCESEBCaGCF.HFCF.OEEAJFEBMDBHLBBGhAAAXADDFHGEABGCEAFDDAEGhABARAAAZCFG..IHAChACA.bCFAgGGANDAF.dHAB.hADA......hAHA...,2,-17,-6,11
KbZQcJgCOHBSGLUMPdXFfYIEVATaNWReD,aBEDRBDEDDAFZGAA..QFFC..JDACCGADBCBCLFFDUBGAhAAAdAAH.FGGA.IEHDhABAEEGGAEDD..TFBDhABAeBGFKBCH...bEBEOEEH..hACASAEEMIAE.hADA.fDBA.,1,-19,-24,5
NcBOEdYKVgFJbUZPIGTfCHLRXMaWSDAeQ,QDGFBGHGdDCHKHFGFDCG.UGBAZBFAGEAG..CHDBRAAAaCBGSFFBhAAA.AAHA.hABA.eBEANBAGOFDEhAAAEEAH...VDFA....JFHBIAHEhABAfBHA..hADA...,2,-26,-26,0
YEIVFRZTMcdKNJCAWgaDGHXOQSLeUfbPB,aADFDCFHGEGEHEDFODFCQGBC.LEAAUGAA..bCBBhAAABCBAEAFG.FAAATGGHhABAdADDKGEF..CHDGAACDXAGAhAEASBEHfEEGYAHB..hAHA......hBAA...,1,-11,-19,8
DGbgUReaEZQKPLAdVYXfTIMSWBONCFcHJ,dCABVCAE..XDDB..fHGHTDGB.MDEEBFGDhAAANGAF.FAFDHEFCJHAADIGAhABAGAEHUEBEeHCEaFED.hACAZAAEKEADAEEDSHAG..CGHH..hAAAbABE.....hABA...,2,-14,-4,10
PUSMXLDRecNIFEWZKgCAQfHOYbTVdaBGJ,QDBGHECHOCBE..TAFEdBFEaHFGGFEFUACD.MICEDBHHeFFChAAANCAB..IDFHhAAAEGAEKEEEAAIH..fABDhADA.YFAFBHAG.JCHFSHGAhABAXDDH..hADA...,1,1,-21,22
VXARMPOHDgKdICeTafWbUSZFYcJQLBNGE,MECFOCEADBAEdAGD..CAFH.aBBA......fFFHhAAAbFDASBADFCCFJDAHBDDHhAAAEAHB.AGIBREAFHGDAIAEGhABA..WDFAUDFF....cACFhABANICH....hAEA...,2,-40,-14,26
BNVdLIbOJYTUHXFGSEPCKcDfMQgAeRZWa,ZEECBCEDdCDFLAHHOAHF.JDBBUFBB.HBABFGBEGAFG.hAAAEBBEKACA.DIEAMHEEhAAAAHHAeCHDREEE..aBAHNAGA.hABA....IAEH....hABA......hACA...,1,-24,-27,3
LZSdCAKUOaPNVQfJeBHcgRGTEFYIbWMXD,ODEHaCFG..VBBBJDFGHAEA.RDAHGBADEDGAFFAA....hAAAIFEGMFIBXGAChABADICCZAEGdFHEAGFFKHCGNABF.hAAA...QGFABADCgGFHhACAbGACSEDC..hAGA...,1,-6,-15,9
IOYQSAeGLWPXMaUZCBdVFJNfDHREKcgTb,LEAEXBCGUDGGCDHDBCFG..dEBGJGCEDIBC.HFDAKCCE...hAAATAGEOEECQDDDhAAAAHAA.eADAhABAPBFAMIECZABGNCAEfGHEEGGD..hACA......hADA...,2,-39,-8,31
baLFMTWJgRXeHGQPYVKBUCIAZSfEdONcD,SGDGdEDDODCADAFBLEGD.MBECTGCG..gCCGhAAAeCADHGFAPDBBhABAVCGDBAAB.CBDGAIBEhACAfFDDEGAH.NCIEaAGAFAGE.JABG..hAFA......hBAA...,2,-22,-9,13
MKWUFRcfXJDeTdIGBNLaVSOgQZbHECPYA,MDFCUEBEFAGBRGFA....XGCBJGEC.DBGAdCBFBFADLEFChAAA..aAEHOHCChABAZBAFEHACCAED.AEEAKFFC.hACA...fBHCIACC...NDACSHGAhADA.hAAA.bCCD.,2,-34,-32,2
ScPRIJXaWFgVGKTeMLHDECUBfOQAdNbZY,dDDEZAAGSFCCRGCE..IBDGaCEBFGHBGGBBKFAD.MCIHhAAADADECCFCBCCA.OEABhABA.ABEC.bFGFPBGHhACAJAAD..gCGHeEGF.EFFD.hAEA....fCBChAAA,2,-38,-17,21
JcHNRWfeAGTbdYLCFQOIMZSgXKDPaBVUE,TCFAdCAGCHCF..QFDBODAFZFEE..SFACXEDGDADGhAAABFHCEABBHBDERGAAeHEChACAAAAHGDEF.bBBBhABAFAGFMAHBgBCH..aGBB.UGGBhACANDIA.....hAIA...,2,-7,3,10
dVLHYReEJTWIAQKGDUMOZXbcFagPBCfNS,KGGBGEGEDCFC.UBBEZCAE...XEDFFGBH..aABHBHAG.hAAACBFHSBGHhAAAdFAFHDFBREDBeBEDEGEF..WEAGhABAADHHMDIB.OACGcGAA...fADDhACA..hAFA...,1,-18,-35,17
gNVaILYKfWEOBXDFUPdJHMZQceGbACRTS,CGFDSFFF..gBAGaABGLCFEKDHB.EEBGBAGFFEHFdAGBhAAAMEDCQBCDhAEAGEAGAHDHRADBVFAF.fGGDhAFAOFDGDAAG.UGGC.JAHBcGDHhBAA.....hADAeDEA.,2,-15,-6,9
EKgfGSdPYCUaLDAJONHbMcWBRXVZTQIFe,OCBEHFCBMCAHBHCDRAGHZFFE..QCGDFDBGEEDE.KGFEGABHhAAAdAFHCEFDLEBAhAAAAABG.JABGcGAC.hABA.XGAFIEGDeHFA.fEHEhAGA....hAIA...,2,-23,-7,16
USFMYADEWQbNXaKdVfZCTLJIgPORBGeHc,DBAGEEEA.QCCA..XACCKHFAdFCEZCADTFCHLAEBhAAAgBGDOEHHBHAFhAAAeAGDUGFBMCIHAECCWCDGhABAaGDD..CAHGIFFBPDAF...hADA......hAEA...,1,-9,-26,17
FDWdHaAeVSNQcGEBCUMKfJXPLYRbZgOTI,SBGHQFGBGBAGBBAHUFBCMHBAKFEAJAEE..LEEEhAAARCGHZFCCOECGFCCADDAEdACGhAAAAIFE....NEIG.CAHA.hABA....XAFB...PABAhAIA....hBAA...,2,-37,-10,27
gYPZLaOVRQfTeIWMACKXFUGNBHdEDJScb,XGFDUGBBGBDBBBFHECAD..DDAASABG..bEGBhAAA..gEGHhAAAZFACLABEVDDBfECDhAFATGEC.WHAGAAHHCAEFKCCFFBHDdEEE.JCCAhAGA......hAHA...,2,-21,-7,14
bgWKeSRHIZAXMEPCVcJTGYUBLaDONfFQd,EGGFVEGF..JFCGGCAABFAA.DEEH..OBBHFACEdHCD...hAAA.bAEFKAFA.SBHHhAAAIDDDAAHGPCCChABACHBB....cGDD..YFFFhACAaACDNBAE.fFCGhAFA.,1,-34,-35,1
GBIEVYNgXFWaOKeSfQCDAHbcJZPdLRUMT,HBAGJHFCZBFBdGFB.UCGFGABDBBED.EDDC..VFAD..NFED.hAAAXDGD.aCAGhAAAeEAB.SHAGhABAQECAAADGcDBHPHCCMAFA.ICEAhABA..FAGEhACAWFFGKHCC,1,-20,-26,6
WCZdXHDEaUTMONfgSIBbPLQKJVYAFcGeR,FBHDGDCAeGBECAFGdCGFDACG...EHECUFGA..TDABMBBEOECAhAAA..NCAFSHAAhAAABHBALCDAhABAKFGAJABAAFBE..cAFB.....hAEA....WFFDhAFAXEEF.,2,-31,-20,11
MSDZGTYWdcRgAQUPEbeBKLXNaOVCFHfIJ,QGGBEBCABAHCLABFaHAA..CEGHHCDCJFDG.MBBDDAGFGEAEhAAATAFD.dDEBgACFhAAAAIGG.UECGhABAPEHHKFAE..NBIAFHDCIHCB.SAEHhADA...hACA...,1,-2,-27,25
JHOYWcGIadQFbCMVETLgKAUXNBSPfZRDe,UFAAXGCCBGEF..SBAHZBCADIBGHGFEOECA...hAAA..cABFGAEBhABAaDGCdDBHQFFDhAAACEECECGC.gAGGAIEGfDHCJFAHIAEHhADAMACC.LCCGhAHA.KHFG,2,-30,7,37
ZRKWEbfdABICYacUJTHGeDOPMQLgVNXSF,CHEAaEBAUDBAHAFH.DBDF..MBHBQBADLFEE..gGEDhAAAVACG.NEICFEEChABAKGDFEGGD..dHABAGAFBDEChAAAcCGE...JFACeBAFOAEH.hABA.SAFHhACA...,2,-33,6,39
ZPdGKLWfcIYeBXVTNbCFHMSOURQAgDaEJ,DBFGJHFAZFAEdDFFKCAG..LCCC..fFFB.hAAA.ICAHeFACVACHhAAA..NDICCABBMAFEhABAOEEHQGCCAFFE.EGEGWEACBHHGbBFHhADASEAC.hAEA...,1,-20,-43,23
IZGfMgFEATQdaVRPKJCBXNOcLWeSUYbDH,dFEEVDACRDBBKACD..CGCEBEFG..OAFDLAFAeHFCUAAAhADADDABZDECGADC.MHEEhAGAEAHBAHDD..aCHB.hAAA.JFADXFGE.NIED....WHAGhAHASBAB.hBAA...,2,-32,-22,10
GNSaLcFMVCEXDfQbIgTKeBAUdWOHYPJZR,dFCFHCCCJADFRAAAGGDB.aCGAFAFH.CHDD.DGAG.QDGChAAA..bCACIDADhABAKAGCBEHCAIHCOFCAhADAZGFALDGDMIBAEAFF..fEAFhAAA......hABA...,2,-42,6,48
ELHKYTOJWaecPbQfIASBZXdRgGNMFCDUV,SBFBBDDCZEBCRGBGGACDFEDD..CCBBDBAHEFFC.LEADHAABKGHBhAAAODHB.aAAAeAHBhACA.PHEEQGFDhADAAGAA.dDDBgDGEMIBA...hAEA......hAFA...,2,-27,-4,23
BFDJNfLHgYZKbTWeaGXIOCQcESRAdMVPU,MHFCVDDG.BCDA.DBFCJGAE.LAFCHCGHZFAEKABB..TACAhAAAaEHH.GCEC.hAAAXGCEIHHHCCAGEEAGhABAADHAUDAA.NICF.fBBG..hACAYGDGWAFE..hABA.OCEA.,1,-5,-21,16
RbXcLeVUZgKTYHQNDJWFCaGEdIPAfOSBM,OHAASHDERBED...XEAALGEEUAABKBAFHDABDEGDFAGGhABACHFHEBBEdAEA..IEDDhADAAAIBBEDB..MAAEhAEAeCHFZCGD..........hAFA......hAGA...,1,-20,-28,8
KeMRIPfBXZHCYNLcQFDaTJESUdAbgVGOW,VECDGAFE.KDCHeCAERFFF....ICAFBBEAHFAB.CAABLAGDhACAFEADDHAGaABEJFFAhADA.EHEGdEECAHID.OEHFhAAAMEEG...fCDB...hAEAYHBG..hABANAIA...,1,-12,-34,22
VKLRDeHOFUdEJgABQTGSCMPZIWacYXfNb,BHCCGBGGCHGAZBCFaFAF....XEEF..fECEhAAAVBACKADGDEDBHBADOEHDhAAAFAGEdCGCECECAEABSFGChABAMECD.IGABWHAA...YFEFhACA...hABANBFEbADF.,2,-35,-9,26
VNJBHAQUPbDEZICYedRTacWfMKSFgLGOX,QAEHUAFEDEEAZEGDCDGF..dDDDRAAD...TFFG..aEAB.hAAA.fABEhACAMFDBSACBLDBD.hAAAOHAA.NBICBHEDAFBBECDHIHBEhAEA...eFFFKFCC.hADA...,1,-22,-30,8
RXILWNdTDbJfMGSAcCKVgBeHFZPaQYUEO,CABEKEHHBFCEFEEHZBDC..QFGBUFBA.OADFRGFELDAChAAAdDDDDAFE...JBHBMABAhAFAGGCHABGC...hAGA..gDAC.....hAHAPAABYAHBIBFGhADA.,2,-38,-35,3
WdCVeUcLNMQETZKFHIgOAfRPbYXSBGaDJ,REAG..bDGBSHEE.GBBHaABHJFDFdDHCCAFA.UDEALEFDhAAAMHAG.EFAEKAAGIADBhACAAHID..fADBhAAAXAGDDDCEWGEEcGGE..NIBFTAGFhACA...hAFA...,1,-10,-28,18
GVdZIcNfEKMaOgDJXBReTHWAFUPYLSbQC,FEGCUBGHLEBDQBDGCBBB.GDABZBDB...IFEBhAAA..cAGDNHBDEGGEMCAEhABAaGDADIGE.BHDHhAAARDFC....eFAFWFCCAAFB...SGGEhABA.bACBfABHhAEA,2,-48,0,48
aPCFBgVXMQISHWORKDZLbdATYcEeJNGfU,TABHEDAH..eCEEJECF.GEFG.aCCCPDEHBBHHXABAhAAAMFAH..QGEEhAAAHEBEOHBEKBADDHGChABALEHBAICENBHGCBEE...FGAB....hABA......hACA...,2,-24,-5,19
PFTWABdDRKLGMQXfCJeUYaEbgNZOHISVc,BBHFDGGFKEEGGDEE.QBBBCAHAUAAC.aAEA..EEBG..hADAbFBGZEGF.OAEFhAEASGHH.cCAHhAAATGDG.ACDAdGABMEHD.fDDAhABA.eCFGNCIA..IDDEhAGA,1,-25,-33,8
UfXeEJdAOMDZHIaWTKCSVFbNBRgYQLcGP,MCBHDGCGHDBE.aBDGKFBA.SCDAFGFBBAGA.REFF...QDFBhAAALHAEPBBAhAAAfGAGEFHHAFEHIHCFhABATAGG..CEEENCAGYEHB.cABBhAEA...XBGAhAFAeHEG,1,-23,-36,13
MEJcQTKIYbfReZBSWFOLgAGHaCPdNXUDV,HABEaEDA.dGFGUBDADFACMDDC..JDABQAGCKFGD..hAAAIBBEbDFA.eHBAhAAAZFAESDAEhABA..WAHHFGHBOEEBAGCACGAH.NIADEAEEhADAcEGA....hABA...,1,9,-51,60
bNCcGUdXEKJWHSIeMfZTgRQLPVYODFBaA,CEHBGGBDUAGF.ECDH.KDAFHAAB.eEACMCCHZFBGRCGBLBDEhAAA..YFHFhAAADGIFBGGEaHCGABBH..NACDdEEChABAXADH.WEEBIAHB...hACA......hADA...,2,-26,-14,12
FWScaPUXYMQVDHOAKdGgZeENfLbTCBIRJ,KCGFdFACZGDEeBBGEEFHLFGF..CECHBCBEJEBG.FBDH..SFEBhAAAaBEA.UGBFhABAMBIBDGAFADAF.NBDB..hAAA.fABF.IHHFcDAGYEHBhACA..hADA...,1,-35,-38,3
GbKSMBUeZHJFLaCAdWIcTEfRgNPDXQOVY,dHEF..IFCGTEBDRAEF....gAGBPBBBQEFFhAAAVCDCGGCBKCHBBHCBhABAZAACFEABCADCADGHcGGAhABAEAGEDDED..XCAE.OEFChACA.SGBDhADAMFIF...,1,-13,-14,1
TUeGcPMHaOQRFDZJESdVNYALBCXfbgKIW,CDABXAEF..fBHCKDEH..IGHEUEGDeAEAhAAAGDCGMACHaACBQFABhABAFGFHJBGD.SEEDhADANBBCABAH.bECHgGBDTCEH..hAAAPHEE...hABA...,1,-9,-29,20
NDcEMQLFeXRbYPTfVdZGJagWOCSAHIKUB,HBFHKGEABGGEDDABMFGBFDGF..RFAE...PCDB..fAHChAAAZFBAJABC..aHBAhAAAOBBGAFHH.IECEhABANCIG..EBBDeAFF.XEEGhACA.YHAA.hAEA...,1,-28,-34,6
fQOSHRKcEdJMGaZNLYgVFXPeABDUICbTW,UBCHCEBG..TGAAQFEFHFDFRABHKFAFEDGGdDHC.GDBHZDEHLAEEhAAA..gBFChAAA.FBAFhABAeBDADIEA.IHGHWFBB.ODDBSADChACAMFIDaBAH..hABA...,2,-15,-6,9
FTIMZgSBOYdfXKGEQADceRUJWVCNaPbHL,DFAEeFGBRBCH.UFBH..JGBCCCFE....aBBAHAGH.FDFFMADAhAAASACFOCAHdDDBhABAKGAFGEGAAIEC..hAAA..cEGFNICBLBABIAHGBEDAfEEEhACA..hBAA.ECHD.,1,-18,-35,17
MLUgdfFBKHRIcPCaDZXOAeWYQNSTEJbVG,eFBFQCED.SGABTDCDJACCGACALHEGdAEHfGGChAAAFDGGKABDHFFAIABEhAFACFDHDCDC.XGCFhAHA.AFEEWCHDEAGA.MAIFBHCGcFEDhBAAaFAB.....hAAA...,2,-19,1,20
geWNJZRcOMfbHCYGLaSUDdBEIKXATPQFV,QBGFFAEHeAGB.JABFRDBD..MIFGHECHGEEFLHEC.aADEhAAAUAAGBGAGKHAEAEABTCEAhACA...PFFGhADAWDAD..cGDE...fDDDhADACHBA.DHGG.hAEA...,1,-16,-21,5
OHfRIbGcXNCFMBaDUdEKLeVQYWASJgTPZ,SEDDTAAG.ZCBAHACFRAEA.GBFG.NHBH.CCHEBHFGDCAHdHGFhAAAEGFGLAFEeEFAQFADhAAAAEBDJDEH.OHAChABAIFCFXACB.FCFDMICA.hAFAaEGD.....hAHA...,2,-14,2,16
gcJQYXdaALIFOEUKBGfebHWNSMRDPZVTC,FBBHEFECKHACBAHD.GGCDeACBHBGF.SGHDMBGHDFAHZADFhAAACFCE..JCEDQGGChABAXBAD.AEFFIFCFhACAfAEA.NICH........hAFA......hAGA...,2,-35,-16,19
MegBcRSDUPEITFbHadWVAfNQYOJXCZKLG,QCDHOECA.CEFHLFBAMADHBGFBRABF.DIGCUGGE.EAECFBAAhAAA.aGDBdHAH.AHFH..hABA.fAGChACAJCFCKAADeEAESEAF.PDFGIEHDhABAbFBF......hADA...,1,-14,-28,14
bGHUNfSQPICYMOEARBTXcLKWadgJZDVFe,TDEBXFEG.LBEBaAFB..dHBHZCGDVACBFGCDeDBH.hAAAGAAANGDH.fGHEhAAAPHFA.CHAHOAGBhACAAEHFRCABKBGH..WAHBDADG......hABA......hACA...,2,-21,-5,16
aeNbdQUMJDSFcPBIRLYHXZACEKfgTVGOW,EDCCKBBF....TGCDGBFE.aGGHeECCdBAAMIAGDDCC.SFEFhAAAFAEHBFFDIBHHhAAALGAGXACChABA.AEEECFBHfFACOFHDWAFCNBAAQEGAhABA...hADA...,1,-13,-31,18
XLCbEdPZSeTWVJIAQNFUGgRKaOfYDMcBH,FAEDUFFHGEFEKDBG.ODADDADEBHDB..HGCELFBDCDDHEBAAdDCGhAAAZAEE...SAGEhABAeAAD..TCGAhABAJBHFACCG.QDDG....hACA......hAGA...,1,-16,-36,20
QfULHXGBAVRTbPCdcJWeFYODMaKNISZgE,TBBFCHDGdCDC...JHFAFFAC.OEFEDDDGKFCC....IBAFhAAASBFA.EFFAhAAAQGGALABEHFAFhAFAXGEBADBDRDEA.cCAD..eAFChBAAMAIDNCICfHDBhBDABCFG..,1,-1,-47,46
YdZKSgOaBJRbfQLAGCNFEcIVTHUWMXeDP,CGCAEBAF....IHHCTAGFHDCA.MHDCXDCADFIBdGGAhAAAZBFHSFDAhABAaBBFJFED.bAEHQFAChAAALDBFAIEENAEF.FGAH..cACA...hACA......hADA...,2,-26,-2,24
RPBLCGgFVOaNWZTKQUEbMJceIAdSDfYHX,DDAEHADDRACCBHHDCEEBFGHB....OCHHaDFFZGCCKAAG..UAGAECAB.hAAA.MHBGeAACdGFE.hAAA.SEEFhAFAXAGALDCF..gFGChBGA.WDDF...hACA...,2,-30,-23,7
ASQOcPWZCdYIbJHReFBfDaELTKXgMUVGN,SGDGQDBCOEEF..PAFCCBAAdDGE...IADGhAAAHADHeAFGBFDEDDAFhAAAECEFKFCAMCCBUGGFNICDAABEhAFAWCHBZFGH..JCHHfHAD.aABFhADA......hAHA...,2,-21,-15,6
FOTKWcJIYALdeRbVGUXaCHDfSMZgQPNEB,eAEGRGACGDCDUGFECFBC..HAFESGAFZABE.QCDChAAAEEGHOEHDTGCEKDAF.JBAHhABAICCCLCFHdFDHhAAAbBBFaHCEDBIH.MEIH......hACA......hADA...,2,-6,-4,2
KgbWSOJTaMUZBNcLDGXIYAdRPEHfQCFeV,dBHERAFDHCBCCEFC.eFEHKEDB.....gFCCSAAFJDAFaADAhACAZABE.BBHELBBAhAGAXGGFAFGFEGCDFDHB.hAHA...bFGHWHAATDBCMAAG...hAIA......hBCA...,2,-32,-3,29
VFKSRYAbHgdWaTEXDPGCZUcIJNMQBLefO,HFCEdFGGaBBHEBGC.DCFDCHAE.ZBCB..UBFBJCHB...MICEQAAAhAAALDDBeFFGVEAEhAAAKGAG.SEAGhADAAADB....WDHH.....hAEA......hAFA...,1,-17,-35,18
BXEYeKaGTLgSIFfZMWPRAObQcJDNHUCVd,QDCHJFGHHAGBUEDACDFEBDAG..EBEBKBCAGDBGLBFC.hAAASFHDIBAEFGABhABAMHAA.RAAHAIEEODHFhACADGCA.NIBH..dADB..XFED.hAGA......hAIA...,2,-27,-8,19
fKTVHIbLOWEPXZJdRGgeDQANCFMBcSUYa,FEBEBFCEUGFDaBDA..KBACHCGH.LCBCOBFD.EAEBZEGDJHAGdEAChAAA.RCDB..GGABhABADFADAEEEMAAF.SBGChABAfFFC........hACA......hADA...,1,-24,-29,5
GPAKFCTVDQaEJNZeRdcBbULYSWfgHXOIM,CHHGDEIH.QCEEaEBE..JHBCZGBCdEACBGFBLEFASDBEhAAA...gABAhABAHAAFOADEMAIDhACAPAHDADGCFAFGTEBDEGDEeCEF..bEEE.hAAA....WEAFhAEA..fCGE,1,-16,-26,10
CLdOUAFKfTPNEZbacWQIHReDgVJXGBYMS,KDEBTCFAEACD..ZCFHaCBD..QFAEHEGBDGADJEDBBAHAMABDhAAASBBDLADHUGGHhAAAFGBF...PADAhABANIEB..bAFEWHAA.eDDD..XFEDhACACHEDACED...hAHA...,2,-21,1,22
DIBPgJdQRKCTYbeWEUAZVHacMOXSFfLGN,VAEDHEFBMCIB.OEDBFEDHLBBFGBDFDBGEBACE.JDHFREADCADDhAAA...TCBAhABAeGDAEGHDAACFaHEC.SHAAhAEAfAHEIHHCgGAF.KCCAhAAA.....WHCGhABA..,2,-20,-10,10
YLTPQRNObKUFZeAdMfWBIJcaEDSGgXCVH,dCEFMFFCBFBD..IACDaCHB.DBGFSFGFGCDECHECHEBBhAAALADC.TDCEhAAAPBHFRBAF...bBAChABAFGEBAAFC.JHACEGGB........hAEA......hAHA...,2,-27,-18,9
IbgSHPXRQEdGFVaYBNUDeZMOfALcTWCJK,LFAFTCGA.CDCCKEFB..IFAF.SDDDhAAAHEDFXBBGQFFHhABAGBEBaACFNEIA.DEEAMAAFhABAABIHJCBH.gGCAEHBGdHFD.VAECBAEE.hAEA......hAHA...,1,-10,-14,4
BIeZGXQHfCYNJgTMEOLUaPScWdbRDVFKA,BDBBZCCHQADACHBG..JABCTAGB.OFFBUGGHaEEHhAAASGAG.dAABhADARDGFDCFEKGCEAHGF.GCEFhAGAHFAC.NEHAMBBHEDEGLAFA...hAIAWCCB....hAEA...,2,-39,6,45
aOMbDgABUIPedSXfJLZVYERGNFKHcCWTQ,BDEAUADAeBHBdGBD..XACCJBAF.LBFGZGCEEDDGRDBFFEGH.hAAAKEAGHEFG.CBBB..hAAA.QDCEhABAMBGHDAGG.AAHAPHEASGHH.....hADA......hAEA...,2,-33,-13,20
YLAdfCbQVUeRZcWGFJEIPDgSHONaKBTXM,dFBACDAB.QCBFeBGBREDFZGFGGADD.EHFCDBFHHEEEOBCFaDGGBDEChAAA..XFABhAAAMBAFAHAH..fHCFhABAbDFH..cABBWFHH...IAHHhABASAGE.hAEA...,1,1,-37,38
KLFCAYZbafGIgEHVOMeSQDPUWBdXNTcRJ,ZDEEaDCFGBEBEACBHFCE.MCIDeAEC.DFIBUDAGBEHFdHAB.XGGHhAAATFEBRAAB.JHBAKAEHhABA.CDDFABGF..fEAHhAAA.IACH....hAEA......hAIA...,1,-16,-25,9
VBeTFAIPcNGfKEXUCDRSbWOaZQJYdHgLM,..ICBDPCDGGEBFKEGC..XGBFDBECSGAAhAAA.OCAHQGDAhAAAJEHBdABHgDDBhABAMICCBGECeAEAACCDcBGEfACF.CGHFWCADhACAaGGH...YCFGhAFA,1,-19,-26,7
KGFTDCZSeAPOXbLBYdRcIgVNQHaWEJMfU,XDACBHEFdGAFREGF....IBCCVAABHEDAEBAB..MAIFhAAAUBFHGDEBDCDBCEBE.eGBEhABA.OHBCLADChAAAcFFE.gCDCNAICaGHD.WFBEhACA.JAGHKHAG...hADA...,1,-10,-14,4
JXYZIbTDeCWNVdBAMRHGcOUFSKaQPLgEf,RBDHHFDBOGBEFBBAKBEF..aFGFQAGD.LDFAhAAAfFDBXDAHIBBChAAATFGEDDAFeDBDhABACGACNABHBCGHADIHGAGE.SGAF.hAGA......hAIA...,2,-15,-15,0
dOMWVECeKFXbGUBfZgaJcLRSTYPQHNDAI,dBCAOAAAMHAG..EEFHCHDH.FAGDGECH.BEAFZFAAaAEGLABEhAAASBDG.TGGGhAIA..PCEChAFAHDDHAHEAIAGCeDFEKCCFXFGE.hBAAfHFB.hBBA...,2,-27,-13,14
dOVLXbZFSTRfaDGUCJcEKWHBMQgAINePY,eDFHdECFLBFCZACAFEHB.SDGBREAF.DGAECBAGEECGHBAGBGCChAAAMAAE.AEBH..IGEEhAEAPHCE..OAHHhABAXGGH.fGCCaGGH...hADAJDFFKCCG....hAEA...,2,-24,-14,10
VCAHgQfFZBKWTDaOEMNLISXPbeRYcGUdJ,QEFBZBFCKGFCDHAA.EAGDLDBA..XBCCeHEGRABE.GCAEhAAAdDFG.CGHAACAH.fGDHhABAFAGGBFAETDGGhAAAaDEBNAIC..IFCC.SHGGhACA...YFAFhADA,1,-3,-36,33
NIDUZAOJTMfdLXcFbeBWaHRSVQCYPKEgG,JFAHMCAFLBEFFEBBBAHAHDFF..SFDBQCAACGCB.KGCAhAAAGCDDDIFCAFDCOBFChABAdHAF..XBBChAAAbACF.aGED.YFFCEFHF...IHHChABA...hAFA...,1,-20,-22,2
eHIbSAaEcMLRUJGTFVKWQNZODfPYBdCXg,aHAGEEGDLBAE.RECBGCAGTGFFVDEHKCHB..QGGBhAAAOBDCDBCH.fDAAhAAAPCDCdAGGCGDFeFAChABAIHBDAEHF.MFAH..FCGEWFEHNADD.hACABEEC....hABA...,2,-12,-6,6
KbcXWgQYDOMTZdeSLNVJaBCGIERFPAfUH,HFDDKGBH.XBEBQACC.DCECTABEdDEHeAHBSHBChAAALGFCVDFHBHFACAGBIDAHhABAEAAEFFDBAEIF.fECHhADA.cCGAgEAFMFABJFHDhAEAaAEA.....hAIA...,1,13,-26,39
OQTJVRcYBgWNMEUHIdaFPZKGLSDCAfXbe,XBDDODEC..QAADJEFE.RDAGBCHF..gBFGhAAAMIAEEFBBIFGDhAAAaDBHFBACKGBF.SGHHhABACHHHAIFGeADBTAFCYAFC...NICF.hACAHGDEdEEG....hACA...,2,-18,-16,2
GabdIZTQXUWKDEOLfPHVYMRJcABSNFgCe,BEACFGBACAHF.eDFAGBEBdBAFZBDC..QDEDUGFAKAGC.DDCCLFDDhAAAHBADMFAA.hABAJHFEAFHCSFBBhACA.aDAAIEHH.WFFGEDDC.OABAhAAA.fHDHhAFA.,1,-20,-26,6
LKQfOeHMACEWdaFbTYSJXIGVRgZBPDUNc,EGECdFAHFCDA..TDFDJEFD.GBACRAAD.BDHBDIEE.UDDGLBHBhAAAKAFFQGAAhAAA.OHFEeCADAHDChACACGCHaABASHGE.IHAGgAGBhAEA..PDDHhADA...,1,-1,-40,39
dRUPISDTXeYAKcgfHCMJGBFEOWNVLaZbQ,KFGF..gCDACHEFGAAGBGBGFHECODHF..VECGaADAQABHhAAAUBFE.hAAAIFFBDFIFeADFYAGHhABAABID.fECEMAFAEDHHNDAC..hACA......hADA...,2,-28,-16,12
GeYAbCNUBOQRMSHTVJfaFXPWcgdLDKIZE,CDDBBDGDRFED.HFGD.VECCaCGB..FGBF..XBAF..hAAAPBBA..WBEChABAdEHGDFBAKCGEEHAAeBEChAAAAACEUEAGMACEJBAH..fCCBhAEALAHHIHHH.hAFA...,1,-22,-25,3
aSQTMDPIAHXLGRUKJFgcBfCVZdNWYOeEb,HFCBXECARBACUCGGKGCD.FGFHBCDG..CHHEZAEFdFFA....NBEB.hAAAOCEH.EGAAaBADhABA.TDGFDGGEAEBALAAEhAGAJEAB..cACGfAGH.hACA......hAFA...,1,-15,-38,23
EWJDabgILUTZGPXCRVdAQNKFcBYMSeHfO,QCFFFFHFBFEG.MBEGHBBF.ODGBJAADDCED..aAHF..hAAAIDBHLHBGTFGFhAAAPBEH.CFADdCAGhABAAFFDNICH.KBFE..cEAH...SHAChACAECHB.WDDDhADA...,2,-42,-14,28
efgGNMPHUIdbYXKVSCETFWQcJLDBROZAa,aGFFeCCCGCCDMFDAHDGHUGAB.dAFD..XBBCSBGACADE.hAAAFBBBQAFFhABAJGAADEAABADCOFEHAGID.NDIA.hACA..IDEFKDGH.EGDG....hAAAWFCBcGGC..hABA...,1,-10,-21,11
DMZIYPRTbWeLCdaQGOAJEVKFBSHgNfUcX,VABHBBGHSDDD.HEEBfEEEXGAHMBHFZCBD.hAAAIBFGRDGF.TEBHhAAAWACE.eFHHCBDEdAGBhABAQGDGAFIHEGDD.gGAD.hBAANBAADDEE....hABA...,2,-18,-7,11
LWNGJbHZQdUAEKVRYXePBDSMcFOTgCfaI,VEDDRCDBeEAH.BAFEDAGH...MGDAFHFAOBHH..CBCGaHGChAAALBCFGCGGHDAFhAAAdDAFABIFEHAA.KADEPHAChABASCAF........hABA......hACA...,2,-27,-23,4
GPFIDYUVSKZXTfONbCRcegAMJLQaEBHWd,MBABLEHH.QADEEAHDHCCDdGCCFDCDDEECUGEF.KBFHZGAC.hAAAXBFHTEEBOBCAhABACFGFRBAD.eDAHAFBF.hAAAaDHBBABB.....WFFDIHHChACA.SGAHhADA..,1,5,-30,35
fOdPQeNYZEVLHGJASWDXUMKgFcICaTRbB,DAAEMFBAFEEE..CCHBRBEDBDBD.dCDCQGCA.eDAFNIAF.hADAEAACHAEEAAHG.SGGChAEAUFGFKCDFIADBhAAAaHDA..fCGE.PGAGhAGA.....hAFA...,2,-35,-27,8
QNDPbXWdeORSfMLIaEBHYAcZCFVUGKgJT,CHBAFDFBUFFBKECB....JACHQADF.DBCBXFGGhAAA.eBBDRBFFMBADaEBH.hABAEAGGBHFDAGIDZFCHGAEFhADA..NDEA.PCHF.dHCDSAABhACAIHAE.YEABhAEA..,1,-20,-30,10
PcTDYNJILOEbMaRBFWXGZeVUfSAQKgHCd,KBBDHACBdHBDTEDBDIEE...JHFAOBEEEAGC..MDHHBFFEXCEAhAAAeFBC.fFCGhABAABECCDGC.cFAChACANAIG..LDCEaHCEWBBF....hAEA......hAFA...,2,-48,-11,37
aIGXCWYLEbcSPJZeOgDTVFRAQKdUNfMBH,KCGDUFEHMBDEBAGDHBADGBCF..XECACCHFLCAD..hAAAEHGGSFBHhABAZCEHeFABDEIFFDEEAFHEdHCHaDBGWAAChAEA...YAHH....hAFA......hAGA...,1,-16,-34,18
XUAedbORFZIJTVHLNBYaMfQSGEgKDCcWP,dBBHRFBAZBAEJFBHHFGH.BAAHMEIF..SCFBEGDB.DCIHCEGB.hAAA....PHDEhAAAXCECABEB.OFGBhABAFAFETEEDLAFC.NEAEaCACfDDHhACA.gDAFhADAKFEHWCFEeEBG.,2,-18,-11,7
NPWISVUbQFcMDaROYECfTBKJLGeHXZAgd,dBBH..PGAEIDGCUAFFFAGH.DEEDOAAB..CHAFBCEAhAAAKDFGGEDAHEAAXGFAhABAAGGG..NDICVBCBhABAbCAG.QDAHMIDEaFFG.EHFE..hACA......hADA...,2,-20,-15,5
NCBLDPgXFOKZUGMHRJcITSfQebVaAEdYW,dFDG..NACFBCBGDBFH..XBCCOCEEKGGDUFAH.HEEFRFBD.hAAAJAAH..IHAChABASDAGeEFFaHGCAECCEBEChAHA..CDDELBHBFEHBMFEB..cBBFhAIA.....hABA...,2,-29,-19,10
UORbLITCeEcVBGSAQJZDNgWdMFPfaYHKX,QAACDFDC..NABA.dFFDFHEEaAGA.HFAGKAEA.ODBEREGFLHAChAAATADE.CDFBEHDAhACABCFGACIH.ZACB.MEDEhACAfBFH..UAGEIHHH.hBAA......hBCA..eDHB,1,3,-31,34
HNKIDJFVGOTEdQRcSeUgZWfYBAaCMXLPb,aFECMHBGLDFGHEACKBACDCFGFEEA..GEAGOADHdDCE.QABGhAAASAEBeAFChADAZFGD..fBGBhAAAAFHCCHHDbGDC.NDEB..........hAEA......hAFA...,1,-15,-18,3
XACgEZPHdSWVDefNQLIBObYFMUTcaKGRJ,EFCDHBACdEGASFGH.DGCFfCDEQBDCLFFDhAAABDFEOEFBFAEDMBAGhABATAGHKGAHJCAHAIHEgEAAhAAAZAGB.WABC.eDHBIHHHhACA......hADA...,2,-19,-5,14
OaVIgdTFSREABLbQeUZNPDXKJfCGYWHcM,BDAGLGDEQEEFUAEFZCEEDIAGKACBCCBB.GCACHFBG..MBBEhAAAaAAB....IAHHhACAdAFGSEHDhABA.AHHBeHDCNCIC.JBHHWEHDcDCG..hACA....OFAHhAFA..,2,-22,-19,3
egUNTSRZEOIYQFPMLfXJbAdBWKCDcHVaG,BEHECFHEDGFH.HCCD.aGDAeECB.UAAHSACFZAGD.EBFAODBAhABAQGGD.hADAMAADfBEDhAEAJFBDAEECKEFGVFAD..NBBCIHDAFHGEXEEAhAFAWAEC.....hAGA...,1,-11,-25,14
KMFEdHeaQRSJCfWYLBZPIbGXcNTAgOUVD,UCDCKEFGMBADFGBCHBBF..aDCHQFFARGDC.CHEG.fCGFhAAALABEBCFAhAAAIBBCXAGA.hABANFAB.AEDGgGAC.OBEDDIGEEDGChAFAdGGE.JAFCWHAG.hACA...,1,-9,-26,17
XYdDeQcUBCEgAOPaRWJFNKIZVfTGHMbSL,aDFBRCBGFCHF..KDHBZACC....TFAFMDABLFDHdADCQAAGhACAUGGEBGCFEEDDgGFBhAFAABHG.OGCChAGAPCFD..WBEEIAAG.fGAAhADA..hAEA...,1,-10,-39,29
ZEDFHBSXReWNGfcKOALJCVIgMbPdTaQUY,CEAFVDED..MDIBdBDA.QGCDUDAEZGBA.EBBEDABG..BEEAhAAARAGB.eAHFGEGAfGGBhABAKBBG.LADGhACA.IHFD.gFAFhAEA.TCDB.hAAA..YCGF,1,-1,-33,32
KTbIGRFVWaDALgHePMBCOdJXESfQNUYZc,LDFHHCCFMBHDOEDBdBADEGCH..SBGGQFEAUBABhAAAZDAFKAEB..IEHFhABAFEHDaAGGAHHEeEBDCAAB.hACAfHABNEAG.TBDC...hADA......hAEA...,2,-22,-7,15
RSLXZBAYIfPJgFCNaVEKWGDMbQTeHdUcO,..IGADfDAF..JGEEFADBCDAE.aAAE.KFEAGACC.hAAAMIDAQFAHhABAHEBAUDGDcDGGSAADhABAXCEBAAIBYAEANIEDEFHFDDDFeAFA.hACA......hAGA...,2,-23,-4,19
PNOSFLHEgVcaICRTKJebDGdQZYUfMABWX,BFHDXGGAOABAFBDH.HBEE..EHDEVGEC..ICHDhAAACEBAKCBE.eBADDDIBdEEDhAAAQEFFUGAFADGA.WFBHhABA.SAFHLDDDaBGAJFABZBBHMAFEhBAA....gFDEhACA,2,-21,-2,19
cgUZaTYOHPXEVLfKIFBWRGbMDCNSAQdJe,QEEFdEACJACE.eBDAUFDEZGDA.aABBOABH..HEGFhAAAEHGE.fDBFhADA.IFAGBCFCWHAGhAAAbCFADAEC.CHBDACGC..gDGAhACA.PDCE..hAGA.XFGE.,1,3,-34,37
UYcHCTbJGLMgAPeSQdXDNFBWKEZOVafRI,SAGBdDGHDEAABCCFKBECZFAF..OHEA..VDDDRCAAIFGFhAAAUAGH..HACGhAAATFAG.GDCHhABAMHCCAHHBQACEFBABaGFF.cDGF.CGCA.hACA......hAFA...,1,-18,-26,8
PTNaCbfURdVHcKeOJYZWIEBSAGMgLFXDQ,MDHHLBEBDDCF.QCAG.TGCDCEEFUBEE.dABEHFAHhAAAeGAEOAHHZGFEEDAFSGGChABA.ACEDFEGGhACAPAHFaCCD.fHAD...hADA......hAEA...,2,-32,-11,21
fFEIbZRVdMgLaCDeAWNJGBOKUXcSPQTYH,JHACBCFD.KGEDUAGB..SCDHQDCAHFAFFGFH.EFEEZABAhAAARAFE.dDGFLDHHhAAA.DADDeCAAACBCNBAC..hACA.OFFG.cFBFPHFC.fEBDhABAIHHD..MAFHhADA.aEAB,1,-13,-29,16
dPCHLGcDNWIJEgfZUYXBVbKMTFOQAaRSe,SAGGdEEDCBCGGBEHDEAC....IAACEGEHZEFHUBBG.hACABCFBKGAEFGGBAHAEaCHFeDAGhADA.LAFEhAEA.NEIA.WHAA.fEDD.YFBAhAAA.XADFhABAMFDH,2,-45,-29,16
cUfTNSFOMReWXdPAKVaGBIbLDgQEZCYJH,KBDBaECFGBFGBHBCLCFHDBAF..EEHHZDAD.CHDD.HEEB.fDAAhAAASHFGOHEEhABAMEHF.RBCCXAGFhACAAFDG.IFBBgABH...hADAJAEC.....hAEA...,2,-42,-7,35
GQOFHTcUgCbDEIaRVNfXLSeZBdKAYMPWJ,MCAAJEFCGEDEFGHFHBEF..UAGACEHBDGCFEEAH..REFH...VBBAhAAAXDABLAEHhABAeDDDdGHAAAID....hACAPFAHQGBCOHDC.....hADA......hBAA...,2,-19,-14,5
RWTJeUNPKBHLYFSMcIQOgAEXZGVadfbDC,XDABVEAB.dHEHDAAB.RBCA...JAGDeFFHUACGKEGCBBABLDEBhABAFFGE..MDFBhAAAIHHB.OAEGhACAAHDBGFAF.aDDBfGCC.CHDAWAHHhADANAIG....hBBA...,1,-24,-31,7
PgaXJKHCBTOVQIeSNdAMYbfcFZGWDLURE,MIEE..fGCHFFEAZCBGDBBGRCCBEGGF..aDHFXAGDhAAA.KDBFBFDDOBBGhABAIGHBNCFA.dAEHAHEHcFAEhACALHAC.UCFC.....hADA......hAEA...,2,-32,-22,10
fBDRMKTgFAQUeaOVbIGcXdCNHSLPZWJEY,eEFFOACC..IFAEGGCHdAGG.CEDGHCEALDAAZAAHEHGChACAfHGFBEADDIBGKBCChAAAFFGAAHCBQCGAhABA..aECHcECD.NACH.WBHH.hAHA......hAIA...,2,-29,-11,18
fdDUIQOAeGVXCETFHZBKcYbJPgaLWRMNS,GDBDXECDEAHBFBCFHFAH.BCCCKFAE...bAACJEFC.aGGBLFHFhABA.RFDHSDGEhACADAEBIHBGADAEeAEFhADACCABZAED...YFFBPAGDMAAGhAIA.....fEEGhBAA,1,-3,-28,25
KCILPHRAgQMFaYcZfJEVOdWUeDSGBbXNT,QBBFaABCZEFD.JBGDEAFD..dDDCeBDFDIDAGFAHBAHBXEAEhAAAKHAALACC.hACAHFFEAIGGFGAD.fGDAhADAWAAD..SDHHNCICCFEB.IHHGhABA...hAEA...,1,-10,-28,18
eJTROMYHGQBSKbPWECFIaNgUcVXDdfALZ,LBHFZEABJADE.OFBHHEEABFCGKBAF......WEAEhAAAEABHIHEE.hABAaHAEUBDG.cFGBhACAVAGDDDADADGB.eCDEMIDCQGGHhAAASAFBCDDF.gFCGhADA.dBBE,1,-19,-20,1
HJbcTRZSEFLQfNOeWgdAYUPMGXICVBDaK,UADHMEAEGBFACDFG.BHGBDHAEKDDDHFCC.JHAE...TBBFhAAAZDGDSBAEhAAA.EGFBFACA.fFAChABAeECDdCAEAAGA..YAFCXAGAIFHGhBAAaGDD.cBDEhBBA..,2,-39,-10,29
YUFGCJAHTdQbPaeINKBWVEgDXLSMOfRZc,HDDBdEEBQBAAaDBBeAFD.KEBHBBHA.EAAGXGDELGAE.hAAAOGFCZAEHUGGBGACGhACAAHAGTBGDIHBFhAEANADG.WHEGDIAE.SFGE...hABA......hACA...,1,6,-22,28
fHOIMbedACBENSGZRKWPaFcLQYDTgXUVJ,CHGHBFBH.EFEEGADEZBBG.KAAH..aDDELEFADFHH.TFAAhAAAXBFAUCAFJHACOCFChACA..IGDDhAAAbAFA.AIGESADEPHCA.FABC.hADA.YDDFfHEHhAGA.MAID,1,-23,-27,4
RNLIFMKCfaeBdZWOgAEQbYDXGTcJVHUSP,EFGDQABBDAEH.GDDFJAAF.UAGFRAGDLEEDFGGFKFCGCCDE..hAAAeCCDdFAC.ZFADOHDEhACAAAFG..XGCDhABA...........hAEA......hAFA...,2,-29,-27,2
YGfdAKCSeVLFDQcPEUbaWXTNRIOgZJMHB,CGDEVCDDLAHF.FGHFDHAE.QFGB.ECFGaDCG.XADBhAAATBBFIFAFhAAAOEFAZGAA.MCAHhABABGEG.YADGdGFGABIHKBFBSHEAhABAeABH.cDAF..hACA...,1,-13,-30,17
DMaAWIYKgJEHPQNLVFdcfXSGCbRUBeOTZ,..ICBDKGBCJBEHHCAC..QFBCLAAEFAGGfFEAhAAAGDFE.CBGGRDFAeFHHhAEAZADHDAGCADHE...WHFChABAEHEENFAF..........hAFA......hBBA...,2,-23,-20,3
ZCXefPUaWgIDQEdSBFKLAYcTOHVRGJbNM,TFFHODFHRGDE.GEAAJDBE...MCFGCBBFeBFB..PABHhAAAUGBGaBHF..gDCHhACADFAHEADFBDHDhAAAKAEEADGFHECG..NDIA..XGGDIHHDhABA....SADDhAHA,2,-29,-9,20
OPQJBEcHIdZKLfTVUYNRGgASCXaWMFeDb,SCGFXEGB.MHBEDBBF..OCAHQCBEEDCA.IGFChAAAKGDELHCG.hABAfFAATEGCYFADhACANAAF.GACHACFHaCGEFGGHeDDH..hADA......hAFA...,1,-17,-19,2
QJNRgeVACfPSIbWOZGHcdXFaUKTMYELBD,CACESFDC..IGFFOCBCHAFAdAGAFBEBaEHH.TEAGhAAAMEFGLGBChAAABADCDIFGJHAARBAAeEAC.AGIH.hABAPGECZEEA.cCEA.KBAC...hAEA......hAFA...,2,-25,-9,16
CIQEKLUDWHTdZPXNbJFYgScafVReAMBGO,MDCGBEDHOEAF..CHDDEECAKGDCDCGDHAEGZBCA..XBAChAAA.JGFGgGGEhAAASCHFaBABfFEChABAeAEGAFHE.GEAELHAAWHFAPDBGhABA.FCHH...hACA...,2,-22,-18,4
cDQbCSELBXZVKYMGOPRdfWFTaHgAJUIeN,JABBeECB.DEIHQCGD..SFEGBFHEZDCGKADGGADAhAAARGBGdGFDfCGEhABA.TAGEaHACABGF.hAAAIHGHNBAC.CACDEDAD.XFAChADA.MICG...hABA...,2,-33,-8,25
BcPDfdKCRHJQbOFGEWINZMAgeUTVaYLSX,eABAUDBC..aGBALEEABEEF.DBGFdBABCCEBHCAH..bFGBFHAGhAAA.GGEH..hABAECHHNGAHADIFTAFD.hACASADBcDCBKHCAQGEA.hAFAOHAE...hAGA...,1,-14,-21,7
ZcgNKHBEbLCXQRPTWeaJFIdfMVSUAOGYD,ODFDDFHBZBEA.....NEAH.BFEBLAACCDDBQAADRGAG.hAEA.PCBGeEAAaAGGhAAAIFCC.MEHHhAFASGHHUAGDAFIB.YHBAKHDAEFED.TCAFhACA.FDFF.fHEDhADA,1,-23,-27,4
FKHBYIdXCeTZUaGbJNQgcSMVPOEDfRWLA,KFFGBHEDdACECFECZADFGEAE...JEDEQGGF.SBGFhAAAPAFC.DBDFRGDGAHHHhAAAHCBB..ICFBhABAXFBG.eDHHaBDD.NCAG.MCHHOABBhACAfCBEWHAA..hAEA...,2,-35,-16,19
dUaJVeATSfgHGRPLDZIEXNCcWOYMQFKBb,SFEGHCAARBGFDGACZGAEEFCB...CACA.ODCA.MBBCQFEDhAAABCHDdAFEJAEDAAIB..hABAfEACPFHDLEAGhACAIGHBNIBD.WAAD.KDFBaEEGeHFGhABA......hACA...,2,-29,-4,25
bLZOMdgQKaFBUIXfANVRHYWPCEcDTGJSe,VDBFHFDA....PHFEEBBEDEEEGACA.eBFCZGDCMDIDhAAAQDFHFAEFBBHDIHCAhAAAABAHRFGB.CGAFcCAChABASBGD..OAEGKHAGaAGAfABChAIANDAC....hBAA...,2,-18,-7,11
KPWDLTSCNGdbVYQJBegAXZIOfMFHRacEU,ZFEFOADHMEAERGEA...aABDEBBB..UAGCKBGCDGIBLDGH.hAAACFDGGADEVDEFJDHD.hAAABHDDAFAC..XGBHhABAFFBH..PCAB..WEHH.hABA.SGADhACA...,1,-19,-31,12
JDeUCRFTcLHVGXMEdIAgOSbNZfaYKBWQP,OABASGCAZGBG...aAFDBHHH.QEFHJFFBeFABRDBDTECDhAAALABC..hAAAVAFEXCCFdCEEIBBDhAFAAIDAbDGF..fAHAKGGDDDCG.CHHF.hAFA.FEEG....hAHA...,2,-16,-12,4
bCZXODcUFRYNgWMKJBQEPVdIHGfaLSAeT,TFADZCCFDEEEFGHF..RCDH....gDGGKAFHBHEDQCGAhAAAECAEdABFGGCBLEBBhABAeBEECGGB.OAHFhAAA..cFFG...NDACMIAGhACA.JACG....hAHA...,1,-5,-33,28
WJYOeTADFUZfRCQcHVSdaPMXIEgGBLbNK,DCFBUDDERABE.CHGE.HGFG.dEEHMAAH..XGBCEAFDBHAHLFAChAAAKHCA..JCGBODAAhABA.AHADfCGHhADAVDAB.aAEAIBBD...hAHA......hAIA...,1,-21,-46,25
WcOYfZQNIATUJGaLVPeEDXFBHSRgbMCKd,UDFBGAFALADAeEABDADCBECARCBH.MDIHKBDBdAAH..OEADhAAAZFEG..IAHDhABATGGG.aHDCECCEFCHDSBBDhABACFDC.WGCA..fEEBhBDAACAH....hBFA...,2,-27,-16,11
RefYAdUNQIMgFXLcVPWBZDCKHGTaJEObS,UCFAQFBGMGAG.FCEBLEBA..PCAAZBCDCHGGKBBDTAFHhAAA..EHDAOFFFhABASAACeEHDAHDGdAFDhADAIADF..gFGEcBGDBEFFhACADCIH...aDDH.hAEA...,2,-27,-9,18
ALYCNEQSKgVRUOGeZFITbHWMcXJDPBafd,CDGHEBEDKFDDRGBC..GDEDZBEE.FFHF..TDAGHAAEMDAE.XEABhAAADEFHBADCdAHGAABALFHDhAAA.QGAEhAFASGGD..gBBBhAGA......hAHA...,2,-41,-7,34
KWFRLONdSQYcIeMTGUVEHbfaBXPJCDZgA,FACARBABLEGFdFFC.QDDE..cABHMECBUGDHhAAAEDGGHFBHaAEC.BDDEJFAFDAIHhABAABHEKAFD..NCCB.IHHAhAAA.........hACAeFDH....hAGA...,2,-36,-15,21
YJBbGgWfODVcHPELdTZRIeAUKCFSXaNQM,UBACKDHDCGGA.FGHF....XEEGQAFA.MFDDBHCEGCEEhAAA..gAGAhAAAfEADDGABHACFhABALBCCdHEH.RBABAAFESCGAaECH.hABAJFAFODDAcEGG.hACA.EEAB.,1,0,-35,35
UJRcDHdKCSEPZeLTAfXFbMNOQVgGIaWBY,XEEEMEGH..QCBGGBGGIECFBBHCJHDC.DAEDHCAAhAAAKEEF.SFHHhABAZAEB.TGCBAABAfHAFhAAAFACCNAFC..gGAFaBGH..hAEAWDAF....hADA...,1,3,-43,46
OSWPYFMNdZUKaXLHbDRgVTfcQCeGAEJBI,EEGHBEHD.SCCA..WFCAFEEFdGBEZDCEUAFGKEACLAAHhACADAABRBAH...VAFHhADA..fEAEhABACHGDADIF.OHBCMFAHaEGH....hAEAbGEAcFDH..hAFA...,1,-24,-31,7
KBfdGeDAMPYaUHQLXINWSJFcTgObVZREC,MFBAaDCBHFEELDHH..NEDA.SBADFBDE.TCEBhAAAOBGDVGECEBABCHFABBCAhABAdGACDAFGAGABUGCE.IBGBhACA.cAEB.ZDAEfEFBhAAA....hABA...,1,2,-31,33
LAMcIHUKSOebWYNEZBJDCGdfQVaXPTRFg,MEIHHABBUFGAKGBH.OECDeEDE.....bADDNCACBHGA.hAAADCDACBFBdHAD.fDAAhABAaGDH.PFEDhADAFBGDAEBHIAAB.SCBBhACA.EGEC..JBHB.hADA...,2,-41,-9,32
RHdDUKBVFNPGEfOMLbAQYTZcIXSCegWJa,QFFEZAAF..IACEXGBHSDDGCDGH.eGEChAEAJBFBaDBFRCFCHFCDDAAGBAHEhADAFHACGAEDOFAHhAEAMEIFAGIDTEDG.gBCBWHEA.hAFA......hAHA...,2,-18,-11,7
TUaWbZGKcJCSgIfBMPRFdNVLEeAHDOYXQ,DDECOGCAQECGUAED...aDAHZBAEKBCBJHFA..CGAB.SCFAhAAA..fFGDhAAABDDHMEIDFGEDhABAdFAELAHBAICE.YBECTEFC.WACChAGA.....hABAcGGH.,1,-27,-30,3
AeMVcTGYWFaSRZfXPbOLNDJgCKQdEUIBH,eDBCMHDA...VFCHTDDGGDEG.FBHDSADGZADE.hAAAfEGGXBABbFADhABAOBAD.DDCDCHFHKGGChACAdBHEIFAAACFG.WFDG.aAAB.hADA..PHAC.hAEANCCF...,1,-8,-14,6
MgDARfXFBNGcPOTYZSeaHULQKbJVIEdCW,XEFHBBFAGDFG.ODCCTFBBZBBGSBBCHFACLBHFhAAAQCDHKFHHJABGIHFDhAAACHAG.MIAChABADAFCAHHFFCAH.cAGH.YEHH.hABAaCCBbFDDEBFD...hAIAdFAC..,1,11,-14,25
GXOTLdFEgQYPWSfKUcRNADCMVbJIaBZeH,DDGCVACA..JGCCBGBFZEAH.GAGE.ODDBTCCB.dAFFECAHhAAA..QAAGhACA..WEFHSCEBhADAfHGFKEFAcGGDAAGFbFDH..aDHDhABA.....HCEHhACA.LFAF,2,-41,5,46
DCTVWAGOBcaQEKPSUeIbLHfJRdXgYMFZN,OBAABAFAaEECKBEA..UEAAeFFDLHBAHDAHRDFB.dACG..XAGBhAAAMFHDFDGCDFDDCDDC.hAAA....WEDBhABAAHABQFCCECHF.IBADfGBChACA......hADA...,1,-24,-28,4
LPdYafRBDASXTOEJZQMIKHGWeNCgUcFVb,SEACXFBD.EGAGJDCC..ZABAMACAHDCFGBGAeDHFCHCH.hAAAUEEAFBBALFDHhABAdBFGaAHDBCABAGGFTBEBhAGAIHHG..WFHH....NADH..hAHA......hAIA...,1,-4,-22,18
KMWTIcEHUFRVbYLAZJOQCXgdNGPDSBaef,OEACQBGB.CCAF.XAAHdFHEGDEFSFFFBEAHeGAGhAAAKDEEMHBG.IBGChAAAHABGFFCE..bEGHhACAACECJFFF.NAEDDIDGaDAGWAHHECCB....hADA......hAEA...,2,-32,-1,31
DOXfVAFYTEJBdbeWGHKgURNaPSIcLQMCZ,TFFGBBACeBDA.HFEBKHBAUDDCRCAE..aGAHSDGEhAAALCGFCEAFDEAH.OBADhABAfDHGFAHFEGAHbEBEGACFhACA..NAAFIHHAMCCF...hADA......hAFA...,2,-16,-9,7
KHNdDcBIROSEXJbAFgMfCGQVLZPTaUWYe,MDCDCFBBGADHLABGZFFE...TGEE.UDGFWCBAKAGHHGAAhAAAdFAGBDEBOHFCSAADhACAJEFG.AAIDFGCDhADAfBAF..QGGGhAFAaDACNEEE.DEED....hAGA...,1,-14,-16,2
LPNIEcQHXTDfYdbZAgSaMRVJFUGeWBOKC,aCABMBDF.RAFE.FAGDUCGFGAAB.BCDEKEHDLFCG..hAAAIGDHECBBHFAFTGAEhAAADBABdAEGZFGDAFDGSGHHhABAeCEHCEAH..PFFH...hACANAIG......hADA...,1,-15,-17,2
AEbWNVDfLYUCXePJMaQgFBKcTIGZSOHdR,EFCB..bGAG..NDAH.DCFALGFACAFH.eBFCJEFG..MEBGhAAAQABCBADDKGHBIGAEhAAAGBADZCFESDFFhADA.OCHDdGGCAAEC.fECBhAEA.....hABA...,1,-12,-29,17
KfEPVXAacHeYFDWLTgNSMIOBQGURZdbCJ,HCEFFBFCDDBATGAD..SHBAMCAGIDHFQACAhAAAGGDBUFACdDAHCFBBJDGHEAAAhAAA.XAGAaGGEeEDBhABALDDD..NIEDBFFG...hADA......hAEA...,1,0,-23,23
HWUbeENDXgGBZcIJLROfdAQCPSFKVaYMT,CDCGSCAFKDDC..aFBCMHAE.HFDCUACDeDDEDGIFGGCFhAAABEAHIABB.hABARBGBdAGBACFEFHAC.TEFEhADAWEHHEECH.NICH.XAGE...hAAA......hADA...,2,-34,-14,20
MHECeONIbfPDZVUFgdAQSLWYTaBcKRJXG,QEEHSEFCLEDB.TBGDaHACBDHB.KBCEJBBGhAAAXAFHMBAHEGGHCFBHOFHDhAAA.bECFfCDHhABAZCAD.FFBHAHBGcGDD..hABA......hACA...,2,-26,-20,6
PXOKYFaMNbHdLgISWfRUcCVGBTDeZQAJE,ECBCXFEBKGEC.FADDMBFD..HAGHLCGDSDFGREADCHAGBHGAhAAADIEAQFCHhAAA.AIAEPBBHhABAOECENADFgFAF.IGHBfHDBhABA.....hACA...,2,-30,-18,12
UefVXcTWIYBARadNQEPLZKDOFJMHbSGgC,RDBDaEDFdFAC..EDFELGFAKECF.DDDAOABAFEFC.HFFD.SHAGhAAACACGUADG.eHCEhAFA.XAGDhAGATGCA.YBBDBBGBAAIDQBAC.hAIA......hBAA...,2,-32,-15,17
DZVeRWJGBaATQFUdPEbMKLgHXfCIONYcS,TBBEFBAEUCEF..EHCAKEAHLFCAHEGF.CAED.OBHD..hAAAYCEASGBAhABADAFCeGFCJAEEBGFGaAGEQDAGhAAAdDABMFCA.XDDCNIAF..hABA......hACA...,1,-16,-18,2
EFcQfUaVXbdICTLOgPDWBKJAYMNSRGHZe,MAAHSBCCHCECEFFHFCFB...QECFaEDB.XAFEhABAIGFHCGAEOBBChACADCIBBDAGAEACNDIEZGAA..fHGBhADAbBGBdAAGgEGG...hAEAKFAE.....hAFA...,1,-8,-22,14
fBPVSKMdeOaTXQbJCLWRcAHYDUgZGNEIF,HGFGUEGBZAAGGCBH.EGCGFGDHBEAE.VDFDMBFG.OFEFhAAATAGA..QFAAhABACADBRAAEAGACDCIB..NIAD.ICEFhACA.fHGHSEEDKDCAaAFHhAAAXCGF..hAEA...,1,3,-33,36
NbOPgEBcFICXZLSQDGaKUMAWHdVReYfTJ,HFBCRFFEeDFATAFB..JFBHODEF.EEHBBHFHFACBIEAChAAACCEGLCCH.DAIBKGGHhABAMBABAHAAdHCH.fDCChAEA.NAIE.gAFB.ZAAHhACASBBDaGDC.hADA...,1,1,-34,35
gPcBIXQWLCHNaFSEAYebdUJTGZKMOVDRf,eAGFdAHAUECHGFEBKGEB.MCBC..OADEDCADREAB....gEDChAAABACFQGGGhAAACHFD.aBAHEHCAACDH.hABA..YCHBTDGFfGAGhAEAPDBGIHHHXDEBWABChAFA...,1,-23,-26,3
RdKWVCGPYTagIBXNbeUJZfLcMAOQDHSEF,OCAFQBGFDHEEHECHEEAD..RBBHdDDCKFGCCAHBGEGG.TADHhAAAICCCBBAH.XEEBhABAeACAZCECLHBEhACAAICGSEEH.FGAA.....hADA....WAAChAGA...,2,-35,3,38
aeBMJQcLKVUdNACZWETbHXIPYgDGROfFS,ZAEGTECHHBCB.XFGB..IAHF..YDAHhAAAgGFCDCIFOHDEhABASBBCBBBAMBEHhAAAJGCEQCFDcEAHLFFCKGAD.dHCDhABAAAFECFCF..EGAD..hACA.PDAA.,2,-6,-5,1
LDVKQNTGacYdegZFJfHWSBXbCMRUEIOPA,VAFDKFBCQBEB.GEFEaBCFdEFAeDACFGHHHFAHBBCDCEDBRECAECAGhAAA..OBHFhAAAAFHGDHDE.NADH....TGDGhABA..........hACA......hAIA...,2,-25,-22,3
DaTgFVJcAZfUGPbLXCIQMWOSdEBNHYReK,ZDCDUCBBGEEDLFEGCBBB.MAEEOBDGdCEDBHCGHBGHRDAF.DCFBaGHDhAAA..FHGG.JHAGAHEB.hABA...fABFhAIAXGDH.IDHCSAAFEFCB.NADD..hBAA.KBGC....hBDA...,1,-9,-27,18
LbBIVRJESHNXKZAGcDdMFCWQYUgePaTfO,DDBCFCFACHHFQEFE.UEAGeFFF.aAHFOBAEBAABRDBEEGHF.hACAHGDEKGAH.ZCFEAGHCGACBhADAMIAA..gADEhAAA.TECCfEGBIAHGhABAJFDDSFAEhAFA...,1,2,-35,37
YQOWGBPJKDMRbLdXVUNcSeTHAgCZIafFE,CBHCaAAFFGGH..EEAA..OFDDBGFBJCBGDBGF...RCFFLFHFhACAdABBUDFB...NADD.SEAHhAAAHEDHAIBA.ZCCDhAEAIGBC.fAHC..hBAAWHAGKHEA.MFIF.hBCA...,2,-41,-21,20
BbJYWcCeIGSPOTMXAERZLadDfNFVgQUKH,ZCAAdGDHDDFBFCFB..QEGFUEGHKFAA.HAGDBCBG..JEBF..hAAA.....cEEChABAIECB.SBHHhAAATABHAICELHEAaCAH.fAEHhADANIAH..VABChABA.bAFF,1,-24,-40,16
RPfNGLXYeZMWBHcICUJadAVEFKDOQSgTb,FHDEDAGEQBDF..TEDAREBE.NDHA.LFFD.hAAAeBGBMCAGBGGBIFAEhABAJAAFaDHDAECGEAHFOEAHhABASHAA.bBEFPHBG.fCCGhACAYDAEWFGDhACACADB..,2,-26,-24,2
RWIBXFEgYcOdKZVJQTbHSUMAPNaGDCfLe,aCEGGADH.DIBACAFALHBCeFED.RDAEBAHBFGGGEDAB....hAAA.gCDGhABAOAACdDFAKDHBZDGBJECDbFAGSACChAGAAIGG.fBHAICCC..hAHAcFEC...hAIA...,2,-24,-21,3
LOMPGZfbgNTRCcBdFWJHIaKEYASDXUeQV,SEABXABDUFBEeADA.LCGH.MDIFZEEDfGGDhAAA.gBEHhABATDCBCABDBCAAhAAAdDBDFAHFWGBA.IHHHKADHADGGDEIBOCFHhACA......hADA...,2,-30,-18,12
gdIPWYOSEKNZAFRaCHLDJXceTUbfGBMVQ,aGABCEGBLAAA.DEAGJBCF.eGDCUFDDGBFCBHGD...MIDChAAAQGAGdCACIGHDhABA..YBFAhABAEECBZBDFAHFCHBDB.....cGGAhACAfBHG..hACA...,1,-23,-31,8
NCEZAPKfFbWOcaUYBMLVTDHdGRXgSIJeQ,KFDAFBGAOFBGUCCGBEABLDEE.DIEGHCGB.dHGHGAAGhAAARAAF.XGAGSAFHhAAAeADCQFBAhACAEFHDAGGH..fFEF..cFFAhADAMCDA.....hACA...,2,-26,-20,6
fXIAHEMKDCFdWbaORYPSNUZTLBQVgeGcJ,MDBGCFFBFDAD.dFBA...aAAFRFCC..SAGDUGFHZADABEFD.hAAA.VABGeEHBJHDEXECBhACAAAHG.EGDFDDDChABA.ODEE..NAICLAGH.hAEA......hAFA...,1,-12,-40,28
QKfSbcIWOBaPRdDeGTYgLENCAFUVMJZXH,VEAHZFGDQDFB.KEAASAAC.IFDFhADAOABFaBHFRADHeBCDTGCFhAAALFGDEAECABGDFDDHMDIHhAFA.XEEBfHADWHBAPFFHDAID.hAGA......hAHA...,2,-17,-8,9
YHSXDIQaNeZPKAcTFRVdGfLCMBUWbgOJE,FCEFRCGFGDBCCBCB.BAAGUAGB....bFECOGFC.EDHDSAFEhABA.DGBHhACAIEBCQADChAIAaFFGZCAAABCD..cDDFdHCHMABG.WFAGhAAA..YFHBhBDA.NICH..,2,-31,-28,3
GQDISMbfWAXVeHFPLERdCagTJOZYcNUBK,eCDFHBBELHCAdEHGCFDH.TFFFZGCC...NBEH.KBGAGDDChAAAIHHDMDAB.fCFGhABAAEADFACD..EBAHhAAAaCGAJFABcDBE.BHACDGGFSEEBhABA.XBEBhACA..,2,-23,-6,17
eIHDaKWRCOVLJTNPdcSMbXQGEfZYgABFU,FBAFUBCDeGFCHEAFDEFHKAAB.RDEA...CCDDLAFBJHCC..TGGGhAAAdECGMIEG..hAAAXAFEEDHFZEAFAAIFIFDEhACAaADC....OAHHNBIE..hABASADC.hACA...,2,-23,-19,4
CgKXOeaVPFSYfNAQTHBDEJGRbUcZMIWdL,TGCGBADDDCBF.GGAHUEFFZACB.MEBEdFFGCBFB..KCAEeCCFhAAA..aAHBFAGASBGDhAAA.fFAEhABAADFDEGGE.JAEBcEGAIHHA..hACAWCAD....hABA...,1,-16,-48,32
FGdObMIAYEQVLcBRDgKJXPSeWTUHCfNZa,EEEFLEADRCAA.KEDHJBCA..SADF.eBFFTAGChAAACFBEZBGDaEHFFGGGdFAHMIAEhAAAAHGAQGEEBCBADBAC.hABAXDFB.WEDFfGDG.hABA.NACF.....hAIA...,2,-24,-23,1
DFLHQaIGJPbKfNXORBZYAEdWeCTVgScUM,EDEHeEEH.CDAG...TDBFSHBGUADFFBGCHDGB.QBFChAAAaGDDGDGAJDCFKCAFfBDBhABAOGAABBBDhAAAAGIDdACC...WAFE...cGEDhAEADIAC..PFFB.hBAA...,1,-14,-16,2
LTBXSYaDeRfdCAKGNWMgEVbFQZcUOHPIJ,KGCHGCDGMFBFECBA.FDGCQBDEZGAG.OFFBIFFALBAHhAAABEAD..SHFAhAAADACCeEHDfCCEhABAABECNABH.gAGCcAGE...hAGA......hAHA...,1,-18,-31,13
gGcRDJIAPYLfQVeBdSHTWKMEUXbCNOFaZ,LHCCQABBBAFESEGEHACGTDDHMFAB..UGCHCBAAFDAHhAAAaCFGGDFA.DDIDhABAIAEFAIGG.fFFBhAAAdDCGEAHB.XDCG...hACAOHFE...hADA...,1,-14,-16,2
QMHLSefPZFBUbaWDdKXYOcJIgNERVTAGC,GCGEQBADMBBBHFABLGAESEFCeACGZCDDBHHEaGGHdAGDhAAAKHBAXDCA.hAAAOHDAICCENCIEEFCGhABA.RAEBAEAGCAFB..fFEH...hACA......hADA...,2,-13,-3,10
LWZDORXcHfINKeTUdBMPbJSaEYQgAGVFC,FDFHCEEBZFGHOHDG..RAAFHBFA..fDCDKCCAUFBFMEIBhAAAJAAA..EAEBQGEFhACAAAIDLDGBDAGGXFAChADA.IHBC..NDAC..hAFA......hAGA...,2,-37,-23,14
DAgBVKeTYWMRSHXPIdCLaZJQOGcENfFbU,VDDATAGC..MICCRBCFHGAA..XBFFdHEDCFCCLEFChAAA.aBABJCAB.OAAAhAEAEEACFFHHDAGCBGFFeFGHhAFA.SCHBIAEC.ZFCA.cCCBhBAA......hBBA...,2,-22,-6,16
VWCEJXOdYHcBQNgTSfKPeUaZFIDLMAGRb,GAACVDBG.EGFAOBHHdAGEHDCH.QFAETEFA.fDHChAAAKBCEUGBFaABHFADBIHHAhACADAGC.AAFD.hAIAbAEDCEFDXGDDBGHDNIED....SFEDhAAA...hBAA...,1,-1,-17,16
SfdcEYXKBLaJDegHNCTWMFGARUPbVZOIQ,RFAHUGBG..VACDOCEB..QEDCSBAGdGFAEGFCXAFFhAAABBHA.aCHFDEBEhAAAeFHBHAFH.CHHBMDABhABAACAC.ZDFEIDFBfHDDKHDE...hABA......hACA...,1,-17,-20,3
IEHQDcZUJgaPbNdTYGeXCVBFOKLSfMWAR,EEBBHBEFDBIDZCAG.UGFA..aAHB..NBIG.TGCGGEBHCDCCBABGhAAAKGACLABG.hACASHAAfHGDhADAAHDD.QEGH.cAEDPAFGdDEDhAEA.eFAB...hAAAFFDA..,1,-7,-18,11
aHBfeRLPVKSONbFMJXYZUdCQTGWIDcEgA,aBEFBADG.eGEALDBAKCEC.SAGFOCABFFBCMABC.JFAChAAAXEECUFEDdCHCCABA.hAAAQBCC.hABA.TCCDIHBBDBIBEDHDABBBfDFAhAFAPHAG.NIDH....hAEA.YHFGWFHB,1,-2,-21,19
cgZIfTLEeGCabYFRHOAKNDdBPUWMXSQVJ,KHFAdBGBUEADMBFC...SFDFQFAE.JBCDZABF.TBDDhAAAEFEA..CDHGaAEGFHGAHEEFhADA.OCHHhAEANIABDABBBCGC.XDEC....hAAA.cGGFIHADhAFAfCAG.,2,-27,-15,12
bRHYDVLGQeZCONgTMJFdIXBUSfWPKAcEa,aGFGRFBHHBCA.DAEAVCCDLEHD.eFFDOBAB..NAAC.MAAGhAEA.FDGGdAHEIBEBhAFABDEGSEBFhABA.fHDBKGHHEGBAbFDH.QAGFhAHACFDB....hBBA...,2,-22,-13,9
UZPBbTYOKfeaIQCRFXdDAHNGVJWLcMgSE,GBDBVDBC.LEGHMBHH.EGAAZFBCBHDE..TADFOABDhAAAKGGFfEAFhABAeEFGIAAGQDDGhADACDACFHAAdACGAIBCNAIG..WFFFSAGE..hAFA......hBGA...,1,-6,-18,12
NCFGWOUPHVTSKXcfebgLMQRYIZaDdBEJA,FAGHGBGGUBAGHFEC.TCCEKFBD.XGBEeFEALDEAhAAA.MFABYAABhAAAZAEHDIECBAGC.AAEACCEBOECFhABA...SACHfFBH.hACA......hAHA...,2,-29,-11,18
DeMaSPJbgGOLBfXFZTNcUKRQAWYIVCdHE,..IGDHCFABEAACDGEG..MBAB.aFDASAGF.JCCGhAAAgAGCLHEABHCDhADAFFADNICH.UDGCKGGGACHChAAA.VBCHeDBBbBEDfAHC.ZACEhAEA.TDEC..hCAA...,1,-13,-23,10
OKQYHWdNPBbRfaELFcGATZDeXJSIUVMCg,DCBBXACD..SFDFUGBC.VABACBAHKEAC.HEGHdGFHBCFGhAAARGDCEDFC.FDDCAHABeAFHhAAAMICC...ODEHhABAQFAB.WAHF...NBIG..hACA....fEGAhABA,2,-31,-24,7
BHPUDTXZWIfRgdaJKLMAGCVbEScFeONQY,VGCESBGA.eACGQCFFHEAFUCDGTDCAZDFHIHEAhAAARABCdGHGKAFE..MFEChAAAAHABCAFEEBBFFCAB..NAIABFBHhABADBAD..fGHC.aDHF..hABA......hAEA...,1,-8,-12,4
GHTODVUZBFEeLIJgWaCPfYKRQXcbSdMAN,GEGCTFFB.OEBCDFADZDAHBBEH.eCAGJDDD...aEEDCBHA..hAAA...PGAChABAfABEKABHQAGFhADAXACF.SDECAHHCVAEDFEGAEHDALHBEhAAA....hAGA...,1,-3,-28,25
JAVRfPDFMNdOebaILHCGZEYBSKWgTUQcX,VFCCREBBDICC..FEFAdDBC...OAHFeCCA..aHGALFHHhAAA.CGAEZACHEBAGBFHAhAAASCHDKAFC.TDEBhABAUFDGXACFABBB.MBIFIAFBhAEA......hAHA...,2,-26,-26,0
WGJUfAcPObCXYLeRHNIBZgMFKEdSaDTQV,OFBBCDBHLAFGRACCHCDGBEEAZFFB..FBCGdAHEDIGEQBAChAAA.GDABJGFEAHCG.PFHDhABA..XAABhADA.eCFCIDHEKHAAEDGFTGCHhACA....WGAChAEA..fAFB,1,11,-48,59
OQVJEeGWBLaTYXdfRNHMgKDIAScCbPFZU,SDBCCCCHFGGF.ZBGFUEDF..VEBBEBFGGEACBFEDLACEhAAA..aBAAXGFHhABAdHDB.fFHChAGANCICMAEF.KDECADAH.PBCCOAFAeHAGhAHA....WAAEhBIA...,1,-7,-36,29
HKfaWNYCTgAQcJOPdLeVSEMZBDXbFIURG,JHBCOHEGLBED..eFAGEGHFBHEBbCAG..UBEAHBFBaAAEhAAA..NGAD..CBCGADBCPBHBhABA.dEGHMAAHhABADECCIFEFKAHF.fGAE.hACA.WFGF.gDBAhADA,1,-25,-29,4
cKUDQJfREXLdFgNbMPBOHVeTGYaWACSIZ,SHGCZDDCUAFFDICAQFAG.RBDFLFFGdEAEFBCC..hAAA.gCFChABAMHFEBADEVABBeGDCYAEChADAAAAC..CCACKCHHfEGF.EGEDhAIA......hBAA...,1,-7,-44,37
DGZLcTPfXaWgAEUCbFHVKdIMeQNOYJRSB,UFEGFHDAKEADMEAG..eBCCOCCGRCEHBHBCDFAF..ZEGFLAABhACA..TBGDhAAAXDGHaABEAFBG.CCAFHFBGhABAIGGG.NAIA....SDDFhADAPHAE.....hACA...,1,-22,-29,7
NDdJGgbYVAQaCKSIfFWTcULPeZMEHXRBO,aFAFCBCBKGDC....IDFGFEDA..TGFBUAAFLCHDhABA.eDCBEGBBRBAFBBDEhADADBIDdAECgGCGhAEA.VGFGAIHGfAFHcAGGZDDFMDDGhAAA.OCGD..hABA...,1,0,-41,41
YIBDfgcQHAdNEUVCaMRXZKPbLSOGTJWFe,dEAHEACAUFBACAHH..RBEGKBBBLFHF.GDDBJHEA.FAAF.eAEAhACABDDEDIBC...hAAA.fDHAhABAgBGAHGAAACCHaGFH..MGEG.XACBhAFA.....hAFA...,2,-34,-19,15
fTQcGKDBbRZJdAYVHNCSgaPEWLXeIMFOU,HEBGCAHA.SDAAaFED.EEGEXCECeADFMIAEUDABTGFDhAAAGAAHBBHHRGAAdGGEAABC.hADA.NHAB.PEFA.hAFAIBFDfAFA...KBBFDFIH.hAHA......hAIA...,1,-7,-17,10
OYKEDdXFAfTCVPUgcaWbeHZINRSLBGMJQ,CFBGUADD..aCEAeDFAZADE.REDDLHCGBGFFGDDB..JAGBOAHDhAAAEGGD.DACFXBADhAAAAHGD..fHBBhABAPEAD...gDACcCCE.hABA.....WFFEhACA..,2,-44,-15,29
PBKGOWHFdCJEYVTAXIeQRDagfbSLNMcUZ,eGDEQFBBDDCH.aFFE....bBGHNDAH.UADCBECC.KBCAOGAEhAAAHAECFAAEdBACCEDFEHAEhAAA.....YHDEhADAABCGIHHEfEEAMIBGZAFD.WFEEhABA.....hAEA...,1,-19,-23,4
dcPTZBFGJfMIASKQaYHbRCEeUWXLOgNDV,KAGGaHGCHEGBRECE.eCCBUBAGLDAB.OEEFNHCH.DAFHdBEChAAA..TCFCBFAFGCGGhABAJHBGMBBCAIHASACHhACA..YBHHCGAH..hAAA......hABA...,2,-35,-12,23
NJLTQFBEDRcOVbCfePSWGXZYadHMIKAUg,UAAFJACELDEGQCEDBGBEDGAG.RFEB.OBAF..CEHG.eEHHhAAASADGGDCAXFFFhABAaBHFHDCBKHGGhABAAAGE..TBFHFHAEEEAA......hAEA......hAFA...,1,-16,-21,5
ZHdIPYVfNLbaSXOeRMBGECWcFKgDTJQAU,UCFDZFACHBBBdGHA...PEHHVEDDLAFC..SGFDhAAAOCBH.RAEBBAHBhABACDDFFAAG.DEGD.TEDAhACAABGC.fHBBaCCGMCIDEHFA.KACA.hADA......hAEA...,1,-20,-22,2
YIdafeDVUPbWZCcEORFABXKSNJGQTMLgH,XFCBSCBEGCDDMCAD.LFGHHEECdHAHaABDDDEG.UEBDhAAAPDABZABAEHEC.OEHDhACAAHBCNCIG..QGEGhAAATAGG.IBGB.fBDHhABA.eDBG.hADA...,1,4,-11,15
bIPHYcWVJANTdMBCGeFfZOLKgURXSaEQD,dFFCMAFDBHCFGDCFeAFHFEHFZBCFLCAD.KHBCRFAHSAEFhAAA.ECACDBIF.hABAIFFCHDGHWFEDhACAAAHGCHHAOAAG.XGDHaDAE...hADA....PAGHhAEA..,1,-20,-21,1
EBCDGeXZPdbMRVOKFUSQgJLIfaHTcNYAW,EDGGBFCFDACGGEEE.ZAABdGFGMIBAODBHUAFHQEDChAAA.JBACIGHFhAAA.aDGHTAFF.hADANIAHAHHFCDCAXACA.PCHD.bGAChAGAKBHH.gCEDhABA..,1,-19,-22,3
UMbBOJdcCNFWPeKDIAEgXSGHTYRfLVaZQ,XEEASDGFHCBEREBDLCBCZAEF.MHEABBHD.OHDGhAAAJAFGdAADCBBFFGAB.eABEhAGADGIHAAEH.EDDB..gECFhAHA..YFAFfHGFhAIAaDHD......hBAA...,1,-18,-22,4
KBVEHIZLQXSNagMbDAOGPcTFWfRdYUJeC,GCCATEFE.FFGBRGAE.UBAG..JDCFKGBAEBABZBEC.LEHHhAAA..SADBhAAAaEAHMIDE.AGHGPFEBhABA.fAGHeAHBCEFFBACBICGA.hABANAFGDBBC...cCCFhACA.,1,-13,-34,21
XTYDNRWgFBJbUaOCeQPLcfAZSMEKIGHdV,MCBDEEEFKGCGHGCG.dBGB..XCADTDCGDHGARFGBFFBBBEFDUAAFhABAaDGC..eADFQGAEhAAALDECAADGZACEhABAIAGC.........hACA......hAGA...,1,-16,-19,3
EYHQeVSfIgLMCXDTZaJdGRNFUbBPWAcOK,ODEFKGDFEEED.HFAE.eBAAVBFE..IHFALEADXAEFhAAATCBBZAAA.JHFChABAdEGD.NAHAFDAEBFBCAIBA.hABAQEGCgGGBMACACDDCaGCE...hAGA......hAHA...,1,4,-16,20
ODUIEdGbNRJLAHZWXCKBQYPagVFeTcfSM,HADHZEDCCBBHBAGCQGAE.aDCHFCHBTFDE..SFBFhAAAMIDEDFFCEDHDdGDGGAEEhABAbBAB.JEHBAEECWAGFhAAAKACC...gGGE...hAIA......hBAA...,1,7,-38,45
eTUJNPMIXBGRLaQCOcWHAYVFKbgSDEfdZ,FECDKEAF..SGEAEAADZEEFUADG..JBAAMIFABHAC.RFCALCFBhAAAaHAG.CCHG.OBFGhABAHDBGAHHB..YEHDhACA..bADBfDBA.hABA..eFDHNEIA..hAGA...,2,-29,-21,8
ROTDPcCMSLIebVHgJdGZYaEXUNWBAKQFf,FAHFOFAFDIDA...CHFBLBAHeEFEHFCCdCCFZADA.EAABUGDEBFABhABAQAFBRCBH.hACATCGEPGFCSEFBhAAA.IADBbGAC....hABA......hACA...,1,-12,-30,18
gdBHMZfQcAEbLTDJRICYeWXVUaFOPKSNG,EGAELDCDDABA.JAAHCDCF...eFFF..VFCAFGBHOAHBhABAKDEAGAEFBEFFHGFCMDADhACAZAAA..QBEDhADAAIDG.bEGHIEAF..WFDHhAEAaHAC......hAFA...,2,-22,-21,1
AQEFCVYcLWOZafgedRBPSGbXIKNTDUJMH,EAFDCCHG....VACDLEFEZFFE.fDBGeCGDBEAGSHBGhAAAGFAH.XCDGhABAIAAB.KDEHTGFHhACA.DBBCMIEEAGAHQFCAFHAC.hACA....cBGEhADA.aAEH,1,-11,-31,20
FDSHNdcOEXbfBQCgeTJUWPVZKYRIAMGLa,GCGEaFHD.FCEEDEAFHBBGdDDG.OEBFEBCF...XGAHhAAABGFDCBHGeCFDJAFA.UGCHhAAAPEEBKABC...IDAHhABAADIDMFBBLDGBSGGG.NIDDfABFhAEA..hAIA...,1,-15,-27,12
bUWXVSOJFMDAfQPKZCeLEaYHRIdgGNcTB,QFDCKDGHCCFH.LCADEFBGHFEBIHAFGCAD..TAGDhAAABCHBUFFG.XCFGhAAASBBCFABEACCChABAfHGHZBDBaBGG.dGACNEIG.WDHHOFAEhAEADAED......hAFA...,1,-7,-12,5
SVeFLBcZNAHPXdfbgTQaMCUGDKJOIWRYE,XEGCdBBE..bDFGQDDE.MAABCGFBUGADKGCFOAGHhABAIECGRCBFEAEBSGDFhAAA.FBFCBGHChACAZADBADABPFAF.fBCDaFHFDBIB.hABAYHDG..hADA...,1,-20,-23,3
cEHYeZBJdOVMaPSDbNWfAKUFQRgXILTGC,UDBFQFADRADD...IFEAGGADEAADeCDCBAGEdGHEOABHhAAAMGFG..aHFGSGDGhACADBGD.NADHADCHhAIAFEFGXDEECCCC.YBHF..hBAA......hBCA...,2,-32,-18,14
GaeISFDUHMcdVQZEWKTLbPBOfgJCRNYXA,GBAHeHDCFFEEDEGGHACEdAGBZFCFKGBC.LFHBBCEA..OBADhAAAJDAHREED...XEAChABAACHG.aBHDIAAFhACASCCDMDDC.....cGFDhADAEHAG....WEEChACA...,1,-16,-28,12
CBADPKYdFSIHaJVGfUOcEeLgXbQWNMZRT,DAACKDCGdAHEFCGBHEEA..aEHDJEABGBFC.OACEEHECLDAChADA..bFCBNCBFZFBBhAEACDAABBAC.AAAG.SEHHhAFA.IHHEVFABcFFChACA......hADA...,1,-19,-28,9
ZKLCXcOEBTaDHAgbfPSIJYRQNeMFVGdUW,...bDCCfBBB.SGEBIBGHJEADQFBBhAAAMBBEFGFFdAGB.ZDBCKCAFhAAAXFFFEFDFBHHCDCFDhABAADIH.YAEDNIBH.eDHBUDFCCHHF.OCCAhABAaHBE.....hACA...,1,-9,-11,2
QDIJFGcdKafTUEbCVXMSgLBZPOWNHYARe,RGCCQCFADDAF.FFCAGBCEdDBB.aEEETFAC..bCGBCABDMHFEhAAA..gFGAhAAABFGHOAEENBBG.hABAACECIHDD..cGAHKCHBEEEEXEBDhACASHAG.hADA...,2,-30,-16,14
LCKGBSNFMOJfEYUPRDVIHWAcbXTaZQdeg,XFDCZFFAQGCBdGHELBEACCDG.BHFGFEAFODFE.hAAAEABBPCCB.DDIDhABAIBHDAHEF.TECHhAAAaEEGeAFCKADESHFGJFABfACEhADA......hAEA...,2,-25,-21,4
XAUeDBfOWQFSGTJHMPEdKRaCYbVcLZNgI,eHECBCFFOFBCFCCEGCEAHEFA..ECADKAAEREBG.aHAA..CCHH.VACHhAEALHAC.NBBD.hAAAXAFA.DGHHhAFAfEHCSGDAMAEA....hABA......hACA...,1,-19,-24,5
WHfFDRIgOZEPCTJGLaQBMeUdXVSAbNKYc,KCGG....cDBHfEAG.FBDBIGHEZBEB.CDGEGEDGhAAALEGHaAFCMFFFhAAAeADBdGCE.SABFhADAAACDYHAEDGIHgBAEEAHDPCBF.hABA......hAEA...,1,-15,-31,16
aRQIOMCcdeGFLTKPWBbfHgXSJDZYUVNEA,RCECOEADMAAC.dAAFFHEAKEGC..BBHDHCDG.SAFAZEBDUBBA.hAEAEFGBABFD...QECChADACFGA.eHCAhAEALHAAWBBG.fEFC...hAFA......hAGA...,2,-39,-19,20
ZJCMAVSXTdYbBKQHGefFDcaLOPUWRENIg,VAFBTDEA..dCCCBCDBKACE.GAGA.FBADDBBHLAAEhAEAUEFFRFAG.IHGGZFDH.hAAACGBHAIAASFHHhABA..YCCF.QGDHhAFAfHABcFGAaGGHOBEHhAFA..,1,-21,-26,5
gCYHXfAdTQWKZFMJISNUVERLebBDcGPOa,TGGGQGBF.KDEFMACH..IEHDSCHD.NECG.hAAAEBCARAED.LAGFhAAABHAGDFGAPBABaEDHCEEH.XFFGhABAABDHdBAEFEAHJEAE..eGDA...hACA......hADA...,1,-9,-25,16
TZCbNQEUAdVDJSYHRWGMcBaKXeIPgfOLF,DFBFJGBGHDCCRBEGGEDBBABD..KDAEeBEE....PBAEhAAAfGFELHEAFEAFTBCChAAACDDG.NBIA.EAGEhABA.ADHBdGGF..SCFGMFAHXGBHhACAICAD.OEHHhACA..,2,-19,-16,3
FLCIORQPadSWMVAXTeGbUDKHEgcZYNBJf,TFECGDCHDFHF.HFAEEBFAZDAABDHEJHAGLAEA.CFFHRCACQCGEhAAA.PACAhABAaGDDdAACMFIBAIAEeCFChACAbCBE..KHFG...cEFF.fBBBhAGA.IFBBhAHA,1,2,-24,26
HBRMOQPLdaNGTUcJFEVWeSXYDZAKCbIgf,CGCH..bEFH..IGADHDCGBHAE.OADBQDACdCGFaABBhAAAGBCH.cGFHhAAAEFBBeHDG.XAEBhAHAZFDFgCGCfCBAMABE.PFFAhAFA.....hAIA...,2,-13,-13,0
EQFOWaKCSXDVeRbYJNLUBfgPdGZcHTIMA,EEAEFDDHOAHFKGCG..SDEEDGAD.eABHRBECJFEDLFFAhAAABCBA...gADChABAdEBE.ZAGHTGGEhAAAAIEEaGBBCHHC.XDDGbABC..NADH.fEGFhADA..hAIAPDGB.,1,-3,-33,30
DMYQOPBEgWaUIAXVFeSCbRLGZHKcfJNdT,FBBEeFBCCDEB.RCEALBBAHAEEKGEB...JFFBdCGEDDBDMFFC..OBHFhAAABHGEEECD..hAAAaGBEADAG.SAEEhABAGEAA.ZEGHNAIE.........hABA......hACA...,2,-26,-21,5
UNYEeHLDSKJZgTVWPRBAXIMdGQfFbaCOc,XBACdDAFQAFDFHGG.CHED.UEDD..EECCeEBHLAAChAEAKEGGZBFGTEFA.PCHFhAFABAFCMEAD.hAHAfBDAaCBANEBADGCFSHGG.hAAA.JHBG....hABA...,2,-28,-3,25
EMRQPHgDVFCNUIcOeGaXBJZSLWbYfKTAd,EEHFMFFFRGDA.HAAG.DDCHVAGBFFDF..CBDA.UBAH..OEADhAAAaEDFBDFEJCHH.ZEAFSAFGhABA.LDDAhADAWFAD..fBDBAGIBdGGA...hAEA......hAGA...,2,-30,-20,10
JCeKaBUWTYQbPAXMEGHVgSFdNIZfRODcL,EGFBHFEH.VEBGFFFAdCBAZACE.RBFB.DEECLDDD..JBAHeHAGhAAAaCHFBAGA..WBAEhABATGAE...hACA.YDAFPCDEAGIHMEIFSHGGhAAA.IHDB.hADA...,2,-26,-14,12
CJBSeQMOWKRbDUgXcTYVPdIAGEfHNZLFa,GDEHHCEHZEAHFHGGJADCeAEF..MGFAKFDBDACFUCCA...XDGHhAAATGBA..PEAHhAAAIBAE.ADIHEGEDhABANADG.LHAABBAG..SHDAhABAQAGGOCFA.hACA...,2,-16,-11,5
MZHAQGfOYLTScFgdDUJBWPeXKVCaNERbI,QEGGOAEFLFGDSGBFFCBFDCGGUADGBABC..eFFDhAAAKDDD.CBBGEDBCRGBE.IHHDhABAMAAHAEAH...YFDDhACA.TAGBdAGDWEFF...hAGA......hAIA...,1,-19,-36,17
geHKIdGWOFUScXaMVDLbYJPTQAZNERfBC,ZBEEEDCHBBBBCEABHGBGKFCBdFFH.GABHFBDA..UBGGSGHHhAAA.aBACMICC.DEGEhAAAbDDCJEEB...QGGChABANBIA.RFADeCAH..WFADhABA......hACA...,1,-16,-23,7
TbPCSeEHMBWdGYAJQOgRcLDIZKNVUfXFa,QGGAOBECRFFDLDBHDCHBKBFE..UCDCFFHF....aEDHTGDDhAAACBAH..SAAChADAeDACMBBG.BGADhABAdHAFAEAAJFACIDHEZEFGNACB.fAFDhAEA.XDDBhAHA...,1,-12,-31,19
TCeZXSFLRDEIfdMYgUPaWAcOVHJGNbQBK,ODEBHEEEJACAGADF.QGGAKDHBCGGCZBAA.FABGDGBB..ICCGhAAAMFAA.gGCDhAEAaGDB.AHECNAIEBDEChAAA.XAGHRCFBfGAE...hABA......hAFA...,1,-3,-38,35
ZTCaHcAWMYQbOLPJeGgFdKNfSIVBRXUDE,MEBAQGFGLEFEJCGB.eBAGGAABdHGDKGBD..SDCAhAAAICFG.BAGARADCDEAFhAAAEFCF.ZFDDCGGBaHCEAFBFYDADhABA.OCDA..PAHDhABANAIA..fFHEhADA..,2,-24,-2,22
eAEfDPRKGHdQUOVNBXTIgaLbcFJYWMCZS,ECGEDFAFKBGAdGDD..OCBDBFHB....TBCCIACH.LAFEhAAAFGFF.JDEDMBFFhAAACBAE.SACEhABAADDE.RGBG.QGGG.NEAAaGBHbEDG.hAFA.YCBF.hABA...,1,-28,-35,7
JgKYZDaSFOTLGREPQUHdBMcNCbAeIVXWf,eGFCVCDH...XGCEJAFH..KDBDZABHDGIDaAEC..FFGBOFADhAAALABAEDGFUEDFhADABBHH.MCFE.CHHBAAFChAHAfGEESCEG..TGAE.hAIA......hBAA...,1,-13,-41,28
RVGbDTKIUQFcgOWLZSHXPMYaCENBAJfde,dDCEVFFBGBCH.DIGCTBAFUEAG.QCEEFGDF.OHBGhAAALGFGZFAGSECEhABAXEEE.MAEChACAaACGEAHBAIAC..fDAG..eAAFhAAAbAFE.KCHF.IAFChAIA.,2,-23,-3,20
OEYfIBecHZFgKbTXQPGJaAMNSWDURdVCL,SHEGDDGDUAGF.dEECCBBA.LCAE.EGGBIHHDBECGeHAEhAAAZDAG.KCGC.XAFGhABAGEDGaACA.AGGCMFCHhAAAWAED..ODAFfCDBFDHD..hABA......hAFA...,1,-9,-42,33
SXFWBcbPVAeYKTQUfRDHIGdNJaEgCOMZL,eCCAKBCCUFFARAAGHDGHGFBHdAHE....JCADaBFACFED.ZCCALGDAhAAAFEAE.BFBB..hACAbAAFAIFETGAF.hADADDFHEHAGMAGH..SHEG.hADA......hAEA...,1,-12,-24,12
TYIFALJbePdQCfKWaODcNHVXERgZSUBGM,LFEFJHFC.eFACdADHCDGDKDGA..OFFADGFCHADC.ECDBZGAAhAAABHBEMCCB..IBBChAAAFBAHADDB.PAHFhABAQBGE..WGFAaFEC...cCAChACA....hADA...,1,-28,-37,9
fZeaPIVOWRNKQbHMABSEdLGCcDFXYJgUT,EGFAdAGFLEEFGABCCAAC.DFAH.FCHB..JDECUFGAZGAA..eADEhAGAaABA...VECARBDAKAADhAEAQBGAHEBHAFFDBCBBhAFASHFA.......hBCA......hBEA...,1,-11,-23,12
ZcBXMDKOJfYIPFeVLSQCgNRabWUHEAdTG,GCCAZDACBHADMHDCDEHH.KEFE..OBCCJBBB....fAFFhAAAIFAFeEFFhAAASCGC.CFAGRFGBbFDHhABA.UGGHAFCBdABFTGBG..YAEFhAFAFDDA.....hACA...,1,-15,-31,16
UMdcFaQbRWLJgBNXTKSPefAICYOZEDGHV,CECAOEBDDDHD.HDDAUFEHdBAC.FAHH.QGDERFABLBDEJFFCBAABhACA....TBEAhAAASCEGeFADAIHEhABA.IBCEEFHFMICAaAEG....WAHBhADA...XCBGhAEAfDGD,2,-48,-3,45
BLXIHVEFcWSfCRMUeJDATZKYPabOdNQGg,KAFHaBGC.OABAdGHAGAAEBFHA.LEDFHCDHEGECFHAG..SFCDhAAACADHMIDE.JFABDEFDhAAAZBBH...PHFEhAFAbAEH...QDFHIEGDWDADhACA......hADA...,1,-12,-27,15
YGKTJbQeRdVBCDXZSFEAgLOIUMfNWcaHP,LAGHOECEUGAEMEFA.....NADA.aACHHFDAGAEDJFAH.hAAAQDABeCBBdFHCBBEEhABACGDEDDIHZGFCEGCBAAIHIBAEhAAA.fHCB.PDEGhABAKABH.....hAEA...,2,-16,-12,4
GXMFURKdOVBgfJAHEcaLbPDWINSCeYZTQ,EBAFaEFALEDDDECD....IDHBCBFFZABEGDAEFGGCKFADOFFDhAAABDEB..JEEHADCGbAGHhABA...NIBB.eHAAhAAA.QAEF.MIFE.dDBBhABA......hACA...,2,-29,-18,11
cSVFCAQYHRZEaKNPgDMOTWdGLeBJUIbfX,HEDCZCAGKEHH..NCED.DAFB..OCBHdGBBeAGHBGAE.UGGG.hAAA.fEAHhABASDCEFGECAHFGQACChAAARDEGaGGF.PAFGMIDGTABAWBAF..hADA......hAEA...,1,-16,-25,9
aHDAQMGOKNbWYSUVFIdRXfcegLBZTEJPC,MHDGGDCFKBDB..bAAC..SEFDFGGDdGBERBFE...fBGChAAAeAECBAHAEEAHCDAEDFIBhABAACBGODGD.NIDB.hABAWGDC..YADCIHEG.XEAGhACALDBH...hADAJDDF.aHAG,1,-12,-21,9
SDOURbAFPfJVQHLZKXBTgYIeGEacdCNWM,FCDAJEGBHCEGKGDEBADD..TCBG..IEEHEABEdGBFCBEA.hAAA.MFACDAHBOEEDhAAAUGACAGGC...fEABhADAQCBG.LCHD...hAEAZGFE.YAEChABA...,2,-37,-21,16
IHPdUOfXNMKWAQgLZYeCSBEGJFDRTVbca,LAEGeBEEBFHAECBEGGAFDFCD.RCDG...TFECVBAC.aCEEHFFFhAAA.dEADOBHDhAAAfEEENDAC.MAIDhABAABAGZDBASADCFHGAIACC...XGAHhABAKDGG...hACA...,2,-10,-4,6
QSfCBOHZFMIadbAUYLJDcWNVRXGKETPge,LDEAJEGF.DDIF..NIAH.XBBAGEADKCDHEAAG..TAFDhACAeAHF..QAEEhAAACECDHFAFMFGBaBBBAADFcGDFhADARFEB..SCHHBHHA.OGBEhABA.....hAEA...,2,-21,-11,10
FMVgQHZPTIaWEYAbOLdNfRGSDKJeXCcUB,LCFGdEGDRAFCDGGD.eBAG.CAEH.UFAGBFFDFCCF..MHFC.QECAhAAAHAAHTGDDhAAAaEFA.ECEDAACA..NDBA.SAEChACAKAGB..cGCH...hADA......hAIA...,1,-23,-28,5
VSMBZKJYegFOdcHREPQXTWLCDbAfUaGIN,aEGHGACE..VFAESFDB.BFGDKDHHeCBEFEBHOAFFhAAAdBEFHFDFRCEB.EDECPDHFhABAXDAG.LAAEhAEACHHAABHB.IAHGMHACYCADhACA......hAEA...,1,-6,-24,18
TEADVUCXQZRLBaWSFGbKJIYcMPNOHgfde,VECEXBBB.RBDG.BHDF..aHFGFBADGEDGKAHB..JAEFIDHHhAAA.MAEEhABAOHEEHDAFdGFBEGBFABGBCGAFhAAA...ZABHSFFE..bCGHhADA......hAFA...,2,-34,-6,28
DRIUMbacWVEHBCANgQPSYTLdfXGKOFZJe,QGGBSACALCFFdDCAGBCDKDAGFAFGeHEGDIBG..UDGChAAAaAGG....WDHBhAAAHDADBGGBACAHNEFA.PDDFhABAfABD..ZFBFIBHCMCAC.hACA......hADA...,1,-8,-21,13
FcSAYMUaTWXCNEQgfGOZKDVBdRbPJeLIH,MCHHTACC..CACH.QAFDGFEHKFBBDFGHBEAFdFADRCAE.JEEHeCEDhAAA.LHAGhABAFDFEABID.aCAA..NHAHEAAAhAAAfAGB..OHFE...hACA......hAEA...,2,-32,-14,18
PcSbfeaKGZIVANHTdDECMLXOQJRFgWBYU,TCEHDCECEEBD..LCHHQAAA.FGGCBHGBUECESFEEhAAAeBFEKEADZACBACAGdGDGCFFF.hAAAMEDGODHDRABB..hAFAgGAGPHAEfHEBaAEE..hAGA......hAHA...,1,-8,-21,13
MPfOZedSKGacACWEBTXHJRFQbNLVYIUgD,CBBEEFGFBADHHDDG.FCCBQEFALHCA..VEADUDAB.DDGAMBCAhAAA.OAHBdGCDKAGDhAAAaBAFAIEA...WEHBhABA..JFAD..NACB.IEDHfGDHhAIASFHB..hABA...,2,-50,5,55
XHCeWNaJfMYBTRLIPQEcGSAgdbZOVFKUD,dBCEZGBCFEFFDEECHFAA.CHDD.eCCC.aDAHMBABBAHG..LAFChAAAQAADEFFGSECGhABAAGIBOHFCKCGGUBEDhACA..XEDDNHEHJCHB.fDBGhAAA.....hADA...,1,-17,-23,6
THOJFNGASBXELdQPfVgYbDacCUZKRMWeI,BADBEADBLEDGdFABQEEH..fEHC.gAFDhAAAbBDEDCBBCCHHKEHBhAAAMIAA.eBAEHABHFCAHhABAABHHPHEEVGDGaDDA.cGGEZGAGIDDChABAOAHF.....hACA...,2,-13,-6,7
fPcDWBabJIORNHSGFQgXZUVKATYdCELMe,TCEACFGDLBFC..eECE..fGCEPFAB.DDDHBCAChAAA.bGCEIFEFhAAANEGE.SADBhABAFCCGXCGFVABFAIDAdABHECFC.cEAAaFHDOFABhAFA.....hACA...,1,-16,-18,2
TECVOSgAUbWJQNKeMfIHdYBFcGRXDZaPL,UBGCJBAB.KEEDMAFCHBADBGHE..GEBADCEBZCCFLFHDhAAA.CHEGOEABACHFQGBGhAAAeABEdDDFFEAERFEH.hAEA.aGFFEABG.SEGA...hAFA......hAGA...,1,-10,-30,20
IbXLYCEAKDUfaSTPMGeHgRFBJVWcNZQdO,DBEFaBDC...TEGCGEBGHFDHREEABAEFJBAH...VAGF..hAAAcDFBZABHdDAEIFADhAAAXGGB.CGADABBFKCCBhABA.UGGD.SCHBMIDA.gGAAhACAFDEG.WAEBhADA...,2,-27,-8,19
GbTERgaUPFKfAIVJQcMWDdYOXLHSBZCNe,JDFAMIDA.DCCFOACCLEEHBHGG.ZGAACDGDGABF.EECHRFEHaBGAhAAA..FBHFKEDFAAGCQGGEhAAAdEABHBAE.hABASEGAeCDC.bFAD.....hACAgBEA.hAEAPBAH.,2,-16,-6,10
NdZCaFAHYGIOEVBbJfUWKTLPSQgReDcMX,GACAEEHBBGGFJAFHUBEC..KFDFLDBFQAAGeBAFDBIBMHBEhAAA..dGGBCAHFADDDHEAFhACA.IEFDhAEAOFEFfABD..WHBASEEChADA....hAEA...,1,-22,-30,8
JBNPOYMXAagcIKTbCeDRFGZSQdfEWHULV,aEDD..IEHBKECD.CACC.RGEEZBGHdFDCECEFUADD.LHAEhAAABFAFOHDE.MECDhAAAADEA..TBACDABDFBGFhAEASEABQGGFfFFD.hAFA......hAGA...,1,-25,-33,8
fWNASYHadGKXCOPEcZTDIBUeQFgVRMbJL,HEAHaHECGBGECFDG..OFFHEBAEZCDBTCGADADHBGBE.eEAChAAAQBDG.FEHDhAAAgFGAMBAHLDCAhABAfFEFABBDSHAGKGADPAEGIAGChACA....hADA...,2,-19,-7,12
YgREcKGVMfdHXbeCBWPADZTaOSNFLJUIQ,TCAAODBEFGGE.LAEBJAEC.UABCQDGH.RCCHKFEBhAAAGGABMICAHAGHhAAAXACCCFECBHFGAGIBaGCChABASCFH..IHAA..hADA.EHGEcDGDfCFFhAHA.,2,-22,-20,2
FfWNZOCBaLIGcVJdEQKUgAMRHeTYXPSbD,HAEEeDBA.XDBESEHHDEID.FFED..fBCBZADCCHHCaABDLAHFhAAAIFEHVCFHhAAA.dHFHKEAFAIBAMGAAhABATDFE.PGAENHAH.BBAFcCAG.hABA......hAEA...,1,0,-17,17
aHGPKWMfNCBVARSOTDELQgFcdYIXZbeUJ,OBCDTFBF.DBIBQACD.FHFEdEGE.XCEGeDEFaAAFhACAHGCAKBHB.MFAECHBDAAGAEDHBhAEALBAH.cGAGhAAAIBFF.bDFHJAGF.WACCBDCESGHHhABA..hAHA...,2,-24,-5,19
GTecEOAIURMfagNLBZDKWHCQVdSXYJPbF,RECFaAGELCCGBHDBZDGHDFAA.HFEF.QABHVADH.SAEGhAAAJGAGFDDH.TBGGhABAEABH..AFGDMCIDhAAAgEGE.KGAFCDAC.XGGD..hADA......hAFA...,1,-9,-36,27
EFfPWCYDQNMKRBIGLAcSOeJTHVZgUaXbd,SAFGeCDAHECAZAECUCDAaDAE..dCAHFGEB....WCHBhAAADBIDMIFG.RAAHBGAFhAAAIGFAAGGAJDHHTEBBhABA...XGCAfHAFCAHENEACKABAhADA......hAEA...,2,-35,-13,22
RQVKTELABeUgXSZGMfdCaOYHJPDbNWIFc,BBCCeFEEUBGGSEHDGECGdFCA.CFFE.aCADHAGF..PHFGhAAADAAA...NCCB.WBEFhADA...IFAHhAEAFFAD...RGEG.KADE.EABGADCF...hAFA......hAGA...,2,-37,-17,20
IbSJaWTAVLMgNGYDHRcBKdZfPeQEXFCOU,MABAGADBHBDFBEGAdAHEZDCHeHBGQDAGEGDG.CHCH.OAFFhAAAUABE.IHHA.hAAASEFFaGGFTGEBhAEAABBGgDBGNAIA.DGGBcGAEKDHHXFAChAFAJCFB...hAGA...,1,7,-15,22
EYOJLVKCbIBafFAePcDZQUXHGgNSWTMdR,eDFDDEGCQDBBUGCFGADC..SFEBMDAAdFHAEBGCJHBCKADFhAAA..CDGFBBBFhAAAFAFDAGDGZAGB..gFAFhABANEAG.WAFCYABH.OHFEhAEA.....hACA...,2,-26,-22,4
QGEJVKBUYCSNXWgRLaFIcfTeMdAPObZHD,OAACHGBGQDCHGBGGEECCKADA.UABCCEAA.SGGDhAAA.XBGEWCCCRFECaAEChAAAFFHH..IFABhAFATGADMIFCAAHAPDFBDEIBBEFF...hAGA....gGCBhACA,1,-12,-15,3
PXGMJTLeRBVSFfHdUaEWOgYNCKADQcbZI,QGCEZADA..XFAEJBAHLBFGBEDFSCCChAAAFGGFdAEBaCCF.EDGA.OEHDhABANDFA.AIBEDAEG.IBHFhACA.MGDEeDBH.fHABhAAAHCEHWBBDCEHD.KHFA..hAHA...,1,-19,-23,4
XHDRWBKAZgLeOMdJIQCbaTNSYEFcPGUfV,ZABALCFFMGEAdGBHQDCA.CEAC.aDEF..SHGAhAAAFCGDGEADVFAADDIBBHHChAAAABCHeGEEOAEA.hABAJCACTADG.YHBG.PAHFhACA.....hACA...,2,-30,-5,25
NHaOSceLKJgRdMAGQPBUECYbVZXWITfDF,QFEAUEBDECGC.CBHH...VACAZEBGXADG..TEEAhAAAFBBFaHDCSFHFhABAeEHFLAGFJHBGdCAHhACAAIHGBCEF.WEAFDDDANIEH.OFAH.hAAA......hABA...,2,-23,-12,11
ZgHDUYWOIRdAKaSeBJFENMbPXcLVGTQCf,SFBEBEAAEBCE.MAED..PDEELDACGAEDCGGGZFEFDCCFhAAAUGAEOHCEdAHGKABGhAAAaFCCFGGC..NEIG.bEFEhABA..XCED......hABA......hADA...,2,-22,-18,4
EfHYVcFXDbZIdMTRLeNQKWagSJOGBAPUC,CCAAHDBG.VFADXGCHZEFH.dEAERBCEeADEKAAC....aGHBJDHHhAAAOCHDAACFUGDCEEEC.hABA...fCFFhAGAYCCD.DAIFMDEA.TAFG..hADA......hAEA...,2,-35,-5,30
WGHIXgCdYSRcPBVUeJONQZFaKTEMfADLb,DGFCLGDAGECBXECCCDDC..dBBBSBCBRAGBBAEHUEAAhAAAOBAF.QBFGhAAAaHEG.EEGEAIGE.WFADhABA..gDGGcDEHeHBGZGAE.FHGEhACAMABA....hAGA...,2,-27,1,28
YAZagXKVFJbUHLIRCNcQWOBGTfePMDEdS,.ZDGFaEDHKGBBFFBDUACCHFGH.LBEBRGEC..CBFB.QBCGhAAABDEFGEBBfEAChABA.MIDCEBACdAHChAAAAAHA............hABA......hAFA...,1,-14,-36,22
WNOGdSARIaLCFeZMXDfYgEJcQHTKUBbPV,aEFFLCHF.CDCEFFEBZDAGMBDA.DGAH..fGBBhAAAEHFEJCAG.HADFKDHBBBHHhAAAbBFF....WHAGhABANACFdGCDADFB..RGFGIACG....hAFA......hAGA...,2,-35,-23,12
EOgCPZLVXRaYMUSABbQFIeGHJDWKTcdfN,QEBHFEGCeCDHHAACJHBG.DFBB..KGFGdAHGEBDHOADA.CGCG.hAAAPAGHZFEH..XCFGhABAaBEDMFFCSGGChBEAABCEBAAH.IHHAWDAF....hBGAcCGD.NIEB..hBIA...,2,-25,-18,7
TJgfUCSMLYeDRBVFNIdbcWOQHPXEaKZAG,TBECJEBG..UGBDMDDDLFFA.DHFABCBF.NIBHdFEChAAA..bABGOACGhABAHAFEEDAFaAHHZEBF.AGHG.hAGAGCDBCHHE.SGED..YEEChAIA...hAAA...,1,-19,-26,7
IWPMTZAKYENVaLBdFgJGfQDXOSUbHCcRe,KBDCEEEF...aBGHBCCDdFEH.JBFEGBAE.DACCSFAGhAAAHGAERDCA.eCBD.PCHFhABAMIDAAHEE..VACEhACAFGHFfAGDOGFACHFF..IHABhAFA.WEDD...hAAA...,2,-23,-17,6
fdEWYePGNSQFRbCVDUOcTIKBXMJHgLAZa,aFBEdFBEEDGE..eABDGBDGQEGHFAAGCGEE.DBFBUAGB..hADATGDBKGHBBCBDXACEhAAAMFFG.JCAHLEAEhAEAADIBfDCC.PAGHSGGFhAFA......hAHA...,1,-13,-23,10
LXMHcfRUPOWBYGITDgJVAbEeSQadCKFNZ,EFEDSFGEdEBA.CAAH.FGGBLACHMBDCHAAHRBGF.UDDFOGAAhAAABCDEGEECDAFC.gAEChAEAAAIBQDGEhAAANIAF.XGCD..fCEFhAHA.WCBD.IHHAhAIA.,1,-16,-24,8
bUcOgCNXfBIadPKVAFQeZLTJYDEWGRHMS,QBEDZEFBLCEDJCBFDBEC.GGAFRGAAHAGHMBBFUEGB.OFEDhAAACACF..XBGHhAAABADDaCCFKHGG.ADCBFEAHhABA............hAEA......hAFA...,1,-23,-25,2
OAcURNeYbLaXBCSfMHGDWdETIZgFPJQKV,RCCDeECCLBFGBBECCDAHMFHD..DEGBEGDAZGAE..FDGBQAAHhAAAOBAF.AHFBUAGChACANABD...aEHBfCEEhAAA.HEBB.WHAGIFAHhADA......hAEA...,1,-14,-37,23
dFQZgNHaMPYWBLfOEKbRIDTVAeUGJcCSX,GEDHCBBDdDAEZFDGHCCA.MABA...PHAGBCGEfAEFhAAA.OECGhABAbGEGRBGHDIFGAEID.eFAGJFHHSGBBhACAXAEEgAAGaCDC..hAFAWHEGEDBD.KAHB.IHABhADA,1,-5,-29,24
aRPIMLKCEAQbcgDJTXdHSWYOFfBVGNZUe,QBDA..cCEADFAFJBBDTDACdGFBHFCH.SCHFhAAAOBCDBDHF.hABANGAFUAADaEFC.IBHHhABAMEIFCACEAHBA..bGCEWAEEFGGA..fHABhADA...hAIA...,2,-27,-17,10
UKGDaCROcBESFXfAYQNgMWVLTeZdIPHJb,QFBGMEDGLDHBeEGHZGCEdFDEHEAAUCBCKBDADICARCAEBABB.hAAAFAHBfAGDhABA.AAEF.YHEGhAAA..WFFF.IHHB.JAFFaEFEhADACCAGEABASGADhAEA...,1,-13,-17,4
BcWNIMZJQRgXEYCbKDHfPUaVSOdGeAFLT,LHBGTAEB.BBGG..NGAB.ZDEFRGFE.XECDCDEF.DGIBHABDhAAAUBBHSBHBhABA.OHACdACFABAHFHFChAAAcEFFMFAFQDACECHF.KECG.hABAaCHH.....hAFA...,2,-27,-2,25
GedKULMfcabYFgHTQACBPOWIZRJXNDSEV,CAHCBEEH.OHACZDGDRBDB...JGEADAFD.EAADeBEH..dDBHUAAGhADAMFED..fCGAhAEAaGBD..bEAGhABAFEHF.TEBHACAB.IBDFSFFDhACAKAGD......hADA...,2,-36,-27,9
LPdSGNRgFDZIcMafXQbCeBYEUTKVJHOAW,LCHHSDAGGEBHRGDA.FCEGDDDAZBBDMBBC..aGFAQGAAhAAACHABBAEH.EEGCKAAChADAJAFHOHDG.AGIDdAGBhAEAIEEG.cAGA...bEAAhABA.UGGC...hBAA...,2,-23,-9,14
YQALgUZJKHcVDNWFIEbGTRdfaCXMeSBOP,LAFCUDFDKBAGHDBFVGBC...DIGAFBAC.EEGAGGCH.dAHGhAAAaFFCCAFB.MBEHBBEFOEAChAAAQFGBAADB.hABA.gBGB...ZCAENEAAIDDHhABA...hACA...,1,-17,-23,6
gREdZTcWCKILMGBADbHXYFUSNafPJVQeO,DCFBXADHFGEB.UFFD..aGCB..JDADQCBH.hAAAOBHFEBAAdDDATEFChAAACAHEKFBAMICGBGHBABAD.hABAHAFD.SADBPCHF.eFABZGBG.hACA......hADA...,1,-17,-25,8
dgTcYVGDfLSZaAIHEFeNWJMPKBRUXQCOb,EBEDFDEAeCAH..JCAEMDHBBDGC.REEG.QFCF.CAAAdADBhAAAgAGA.hACATGACYFFFDBBGLHEAhAAAaGADAHHG.NEAFKFHBXAGA.OCDHhAGAcFBF...hAHA...,2,-23,-22,1
ICcPbDVKgHEBWRSafXQFZTJMLUAGOeYNd,GBDAeDEDdGDACGDH.....PAHDDGGCVAGBHCAABFBBRGACSCFBhAAA.fABGhACAFAAATDFBLEAAhADAADCHOHFGIHGAKDAFEGAB.WFHB..hAEAaACD.....hAFA...,2,-26,-8,18
YSDJPXGNfUKQITZOBCgWEcHbMdeFAaVLR,VAEGRFCADCAD....JHACXCEG.GBAGUBGHKDBD..hAAATFFBBCDF.CABEEDCFhAAAHABDdHAFADEHLEHHhABA..SDFA.NIEB.fDFGhADA.IHFGhAEA.,1,-12,-46,34
VPUXGBdMOcZDQKSeTNJaHgYWRFCfbEIAL,LHDAUCFHBHBCMGAAZBCB.KEEB..eFBGJBAE.HEEG...hAAA.gGGBhABARAFCFABHCGHHEDAAAHAC.....hACA.VBFG.PDAC.XEGAhADAOFABDDIFSHAAhAEANICD.aAFG.,2,-26,-19,7
RAdNEPFMOCWTXHIKJGbBYQZLgcDfSUVae,dDGFEECGFGBFOECD..CAEC...XBCGKDGEGBAGBCACQAGDhAAAZFFFLAFEDFFAUGEBhABAeABEAICE.MEEFhAAA.HEADJCCA...YFHH.fCEHhAEA..hBAASGAD.,1,-3,-26,23
BHRgCEXQVFecMINSTOWaGfYUKPdLJAZbD,DAFHHBFDREEG.EHEC.QDCGFHAA.eAADIGHG..SGAEhABAODBHaDEAfFEBhACA.KBBEhADALABGAHAHBHHCCAEFXAGFMDID.NIDHTDCBhAAA...WCAChACA..,2,-32,-15,17
UTNOVFabHDcEfXePLMBWdgISQZCGAYKRJ,KBHFJEEF.UFBC..OBGBFGEGHBCBDAAA...EAEBeHDGLAAHhACABECCdFAG.SBBChADAZAFBCFADAIHEREFE...hADATGGFNIBH.aBDE.....fCHChAEA.MIAEhAFA...,1,-14,-44,30
XGSKAHeDEMdbTLZcBRPOfYNUJFCWgaQIV,DGDFMAFBdEEFLFHFBBDB.RABC.OHEC..NCAA.FBFC..CBHGaHEGhAAAQCAD.hABA.IGCFXGGAhAAASEEBKEAGACIDEFGC..TGAC..hABAcDCBfABFhAEAYBGFWCCB,1,-27,-46,19
BUEYOVDgKCHZbILReQPNXJSTFfdaGcMAW,BGGFUFEFEFBCOAHD.DGEFKCBB.ZAFALEEGRAAC..eDGBhAAAQCAF.PFCBhAAAJBEFFGCD..aABAhAEAMEAFAEDD..VAEDCHHF.IGAC.hABASFHH.hADA...,1,-22,-28,6
QfPFeWgIUBZCDXJATVSOERNYKLabcMGdH,TCEHODBDRBEH..KEGFLHEA.aDGBbDAA.GACHdBBDQGADhAAAFFAEeHAAIBHChAAABDDGDFFBAAGBSEEDhABAEDAH.NDIEMCACfDHC.WACChABA.....hACA...,1,-15,-17,2
JOVRbXHCALgQITUESfdGMPDKeYFZcBaWN,LGAGQDDDUGEBEAHB.dDFDGCGEDACB.eEAFFDCCBAFB.hAAA.WGDCOBADVBAGhABA.RADA...XFGBhAAAAGCFICFE.SFHHfEAEMIAEhACAKCFE.....hABA...,2,-42,8,50
JSdYPZbfRFaGNcHUTXDCgeQKWLOAMVIBE,MBEEVADG.BFAC..EDCGSCCAdGGFZDFERGAE.FGADGAACHBADXGDBhAAADGFB.eDHBhABAKFDBLAGBhAAAAICA..IDFD.YHFE.hACAfFFDaDAH.hADANADD...,1,-13,-14,1
HeORALaIVUSWZdbfNBMGJYFcCTQXEKPDg,aBFGUEACZCFBdGHA......fECBMAFGGDDDJEHFFBAEhAAACBHHQABCKFAD.hABADDAEgCDEhACAHGDAeCFGAADHLHDASHBGNAEBBCHH.cEBChBAA....hBEA...,2,-19,-15,4
McFaAfQGEHeYSWCKBDdRLgOVIUPTZNJXb,GCBBEHEEHEFHSABCKFDFBDCC.dHCBRBCELABEOEABUEEAZFAH.hAAA..JHFAMEIDFBEGACBAhAAAfCGE.hAEAQAGEWCGBCBHEDFIB......hAFA......hAGA...,2,-21,-6,15
TSbIJEYXQNFGcRUaCVHKdfWZALgBeOPMD,BEEEOBBEDIGC..SEEDJBCA.ECEAQAGDGGEFRCGHUEAHhAAACFGB.HGAEdGAHZGDGhAAAAACHeADGMADE..hABA.TCAD...IFDG.hABANDDD......hAFA...,2,-32,-10,22
GXeBDLCRZTIVOEcWFSNgQKfHaJdAPUbMY,UAACMDCHGAAFeHFCLCFECHGG.REBFZCDFIEAB.EHCEFEHDhADA.SFADhAEAQDFFKDGDfEDBhAAA.aFHFABFCYHBGDBIF..OBDEhABA.NGDH....hAFA...,2,-24,-7,17
UQTRHDcSIOGEdZPMBabfgJXFNAYWKVLCe,KCBBVFEHLBFB.UGGATCBAHEDHDEDH..SADDhAAAOCGBEDHFdGAEZAEABFCDhABAaGAB.fCHAhACA..XABCAFHCCEAHeHCGcDAH.IHHChAAAMAEA...hAIA...,1,-15,-17,2
ZCEVegfXBcKdWbYIHSaMUGDAQNRPFOTJL,QDCBRAEEOEEELBBBEAGE..eEHB.XGFAKFCGdCHA.hAAA.bGDAIACBhAAA.aHDCMIBCDGCHAGBFNDAAFDDAhABAJBFFCBBD...fEADBHHA.cFEBhABA...WFADhAEASACB.,1,-8,-16,8
FOPCeMGUWLSHJEYKTbNVAcRdDXBQfgIaZ,dCFDBAGAQCBC..fFBGaGGHFAEC.CHDDGCCHhAAAUGAASFEDEGEBKFFHTABDhABA..bDFEAEFHDEAChADAgAACOBHDeFADWEDF....hAEA......hAFA...,1,-17,-23,6
bFgAXCQRYEeJLScTaOKIBNMVDZHGUWdPf,XABGRGCEECBB.LEHHSBGE..TFCGKBFDBHGGMFABhAAADFAEGEFCdEDH.fBEEhACAFBBAAIAACHHEQEGFhAAAeDACaEDAIHBA..NAEH..hADA......hAEA...,1,-13,-28,15
DZHcSgNBOeQFIVMWabCXKTLEGfPdYAURJ,JFGHHBBF.SBHHBDHD.OFDAFGCGMCCEaBFH...CBAD.TGABhAAALBFHGGEHhABAdEBH.AAFGDCAD.gEGBhACANAED..IBHB..WBEDhADAKAACfEEGhADAUGCG..,2,-44,-5,39
BdYDeTIUcARgfWFSZNOGEVJKMCaXbHQPL,RFDF..fGGASGGAOBHDEAGBKDAGaFDCHFAC.LABEhAAABHAADCEBeCCAUBAEADFEFFFAhAFANACB..GCFGhAAAMEECCBCFXEBB.PHCA.dBFBIHAAhAHA...hABA...,1,-2,-14,12
QLGVBJaeMYfgDScXIRZKOWENTFdUbCHAP,QEBEGEBEBABCJEHDeGFE..MFEB..fDHChAAASAAHXCDHhADAZAFGODDANAGC.TGADhAAAdBDFCCBCAIFEPFFHLFDHYADEDAHDIEAAhAEAWABH.....hAHA...,2,-24,-5,19
fHZGXWbORQSMcEBYdNLVCTIeAJPgFaKUD,JHCAFGEFUFACHEDAZCBDGCEF....bAEARDBGMBBE.BCADhAAANDDD...CHCH.eFHBhAAAAEFH.aGABKGGCDCAB.XBAFhABAQAGBSGGD...hABA......hACA...,1,-11,-33,22
RKaWALYQFGbCIXMTBVfHUdSJPZONDcEeg,QBDCFBCGCDEC.MIDGBBFHHBABdGFD.SDFFZAADDEIB.eDHDhAAAKDFA.ACGCLAFEhABAGEAE.XEAAhACA.fGHEPAHHOECFEGBDaGEA..hADA......hAEA...,1,2,-42,44
LJKWAMGacfEIdbPROVeZDUCHSYXgBNFTQ,aFCEEBAAdCDF..RCEHeBAGZDBADEGHHEAA.SEHDXGCHBAHAhAAAFADGQGFHhAAAKCGGAHHG.MCIH.fHADhABAIHAAPAEA...OFEDhABACHDBgAGA.hACA...,1,3,-39,42
ZRGANOcJeXSMdfIUFLBDKEYQbCaPWVHTg,OCHDJCAE..SEGCdGEAUCEALHACBEBE.DBDHKGBC.hAAAEEDEQCAChABA.CBBB.PHDEHEAGTGGEhACAZAEHAAGGeAAAfAGEFGGGaBHF...hAAA......hABA...,1,-11,-32,21
VGSUEWRFXfCKLBNPZDeOHJbAgaIdcYMQT,aHGCdEDFMADF..QAEHGGABECEAFDAF.CFEALHBChAAABDGBZAEGDAIFeCAEOABBhAAAJAHDAFDA...IHFHhACATCEESABG..UEGBXDGEhACAKEAE....hADA...,2,-22,-13,9
PUXdaHfFEcGACIYBDMRTbLQNeOJgKSWZV,CAEBBHFARFDA.LEEF.eECBJDAHKABAZAAFUBGF..dDEFaCAHhACAFHFG.GAGEAHHFDHAC.hADA.MEIFQGBDhAAAOCCA.SCCC....WAFChAEA.....hABA...,2,-38,-24,14
DNSIABTWLJfQRgKHdaXCGVZOPUEMFecbY,TBDALCEA.JHBCQGCD.RDAAHCGDdFBDaAAFCHAEZAFAUEGBhACAFHGGeAEA..bFEFhAAADEFD.SCBHhADABACGfBAGKAHH.......hAEA......hAFA...,1,0,-31,31
IFadNJbAWGKQcURTSZPHVgMeYDBLOEfCX,KDGCQCBHUDBB.SFGBZEEFHGBEMAFBeDFADAFG.OFCChAAAEBGC..CBAHFGGAaCECJACAhABAAHAB...cAGEhBAA..PADF..gGBGhBBABAGFXABFNEIE..hAAA...,2,-29,-6,23
GWROFdVYgTAMDPeSUEHBQILfaCKbZXcJN,MDDFDBGAeCCCUAAGBFEALAGH..CGHAZGDGJDAH.GDEH.hADAOFBGdGFB..YCEDhAEAAAEEEBBA.HFBFhAFAIHAHaGHD..KEGG..XDAChAAAWBDC......hABA...,1,-13,-35,22
EDTCIXLPYQZfKSUgRMAVHJNaecdWBbOGF,VCFBHCEEaCBA.eDABdGGFBFCHGEGGEBDCCAFALHCC.QECEhAAAfCAFSFADhABARGAGAABD.JABEhAFAcDBG.ODEHDAIF.TAGE.hAHAIACF..hAAA...,2,-35,9,44
LDYNFcESdTgJeQUWRZMbHVAaXCBPIfGOK,CGCCBAAD...IHEHOABFLGEG.DCEFFCHDSDCHhAAAdDFATDCHJDHFeBCEhABA.QFGHhACARAFHZEABMDADbFABAFFG.XAGC..fBAEhABA..KDAChADANIBD...,2,-26,-25,1
XBKGWYPbgSJRaHLQcIFfVOEZDMeCTdAUN,XAFBGDDA..PAABSEGD.aEDFHAGH.cFGGhABAIFCA.fHDHhAAAVFAEEAEBDCIHMCAChABACHHGAECCNDBDBABHKHEA.YDAF.JCHH.hACA......hADA...,2,-14,-13,1
HZPCgQDJLfNYRBcISaEdOebMWUVFXGTKA,ZEEBCGGBDEIHJCCE..LCFC..NDHA.BDBF..SEAFhAAAEDCAeBAG.MDIBVGAGhAAA..FFDBGACFhABATBADAFEC.HFAFQGECfCFH.YADAhABAIDGB..hACAaGFD..,1,-18,-28,10
BbGIKNHTfScgOLFJeaXWARZQUPYVMDEdC,ZFEBQBDCUADE...VDEGEHGCdDDFCBAHBGGEGDBC.KDGCHEAFhAAA.SHDAhABAOCAHLHAAFAFGaDABADCFhACAPABHDIGG.IBHBfGCH..hADA..cEGEeAHH.hAEA...,2,-14,-14,0
IEDBbPMHCcUaKRdNgSeGVJAfFTOWYLXZQ,TAAGOCECLFAE.QACDIFFFDDGCBGHCPFHDhAAAMBBFCBGH..UAEEhACAKFFBdHADSDCGhADAeDCG.JEBHFEGAXAGA.EHCA...hAAA......hABA...,1,-14,-22,8
HOaceFLKCUMADXWPGYdgfBNZbESIRTVQJ,DCCAXGCGGFBBdCABBCHFZCFC...EEBCREEGQAEHHGFE.hAAAOAAAeEEEKHAGCDDCAHHB.hAEAPBAH...hAGAYCDG.NBBF.IAHC..hBAA..JAFAaHEE.cDBHhBBA.,1,-8,-30,22
JegHENQCLISGaPOVfcBDUKZRMdAXYFTWb,FGFETCAC..JHCCeHCGHCBC..NEEH.CAEDLCADGABDaCFAOEFChAAA..fGHEhAAABFCHDEEBKABAZEAGMAEGhABAAHAE..XBGHWGBCEFFD.SCEGhACA...hABA...,2,-38,3,41
LGaZTYDKAORMbWIcJSdQCfPNUEHgBVXeF,OFFEMFGB....bCFAIDGC.SDAFdFAFQBCEhAAACFAH.fFHEhABAPEDCUABEEABFBAEEhADAXBECeHBAFHCGaEEGTDBDKAHDAGBB...hAGA..WBHB..hAAA...,2,-35,0,35
QfLXYVFbCeWREZIGaPASOMdKBUTgNJDcH,MFFGKCGABBCHUGGD....TFDAJAEDHCAFLEAB.XCDDhAAAVGBCCFDBRBGFEHGEZABFhAAA..aGCHAGAG.SBBFhABA.OACA.gAFFhAIADEEC.fFFDhBAA..,2,-27,-13,14
TMGVCRXOeSPcWNaYFfKLADUQgZdJHEIBb,DIBCUEEAZCAFdAEEHAEGBHCDMHDEGAGC..CDGERDEDOCCB..hAAASAHH.hABA.cGABNAAF.aCAHhACAfEDEABDD.gGGBIHHG.hADAbFAC...XBBFhAFAeDHH,1,-28,-35,7
MUPVXgZJOWTfbaDGBACFEdRIKHYSNQLec,FCHDdDGFKEDAHEBH.SFEFQABEeAFAMBDG..UFGDXFEAhAAAJABA..TCCAhAAAaEAABFADAGAG.EFHF.hAEARGAC.NIBD.LHFA.cCDG..hABA......hAEA...,1,-17,-19,2
KZYVWeLdHITSCUgfXRaOJNDFPQBEbcGAM,MHCCKDECZEBE..VADGeBCA.HFFB.SAAEUAADXCDChABAOGCADIFC.QFGEhADAEAGF.GAGEhAGAAAIDWDAAIEEACHCDfDHE.aFAHNIAD.hAIABADF....hAFA...,1,-9,-25,16
MIJTSEDBUNQVgOdKAbHWYZaePFRXGCfcL,HFCGZCFGaGGCeAFF.FHGGRDCHGACDCADE.LFFCIAHGTBADhAAASBAD.ECCGhAAADDAFBBBCNIAH.QDFEhABAOGCEACGA.YFABfGAFMDIF.hABA......hACA...,1,-7,-16,9
SMHdRNKBDAIcVCZPOXTUYbgeJfEQWGFLa,VFACZDEFOHEC.UGAD..bAFAeBECECBEGGDBLBACaDEChAAAMBID..RABGBEAFhABAAGDBCDAG.PFFG.hAAA.TEGHYCECJCCH.WHAG...hABA......hACA...,1,4,-24,28
RXMJHDGBAZOEbaUfcVeQTWFgPYKNILCSd,ZBDHEAGGUDBH..fGGAeBBE.QCGCTFEGFDGC.hAAA.PFBDKAEBIGBBhAAALCAH.SFDChABAdHGFMABEDICGBAGAAEEH.aGAH.WBBB.hAIAgGDA.hBAACAEEXEGA.,1,-5,-16,11
RcKXCHaJNMAfbZIFSQGVYdDOgeTWLPUBE,ZAFDSHEAQECHGAAHdFAEDEIB..eFACLFGFBHCHRBEEhAAAXABHaBHFMAFCABID.hAAAIEFAFADFOHCChABAgDAC.WEHBEDDGCDGHHFDE..hABA.fDDHhADA...,2,-13,-11,2
dIUReYJQTGfSBCZNOPEXbMKcaFDLVgHAW,dDAFUCAARAGF.eBFCQBEAGEEDBABCZEDDOBCF..PGDChAAAEFHB..MACCKHGAaDDEhADAFGFBDABHLFBFhAEA..gEBGAAFHICHATGAECCDD.hAGA......hAHA...,1,-6,-20,14
fNXOTZSYQIJbCVgeLWDcGAadFKMURBHPE,FHDAUBBABACDEHFE.....XAFCZEBHQBGG.JFAFhAAACEDHeBABDFEC.ACEFKCGAhAAAMBFDHFGH.NDCE.SEHFhABA.bADB..gGADhABA...WDEHhADAaGEH...,2,-41,-20,21
cLNRTIVeGJOSZCMEdfbYaPAgKWHXFUQBD,KHBEHAFGUBDDQEBGBEDC.DBAA.LFEERCGD.VBCBeFGBhAAA.OFEFCDHCMIFAdCABhABAfCAA.hACAaGACAGCEXAGGFGDHNAAD.TEAE..hADA......hAEA...,2,-34,2,36
DUWJBRSTLeaHEGfVMFdYOIQbPNcXACKZg,KBADDBGCUFFABHHBRFDGLBCC..eAEDEEAC.GCGC.MBFAhAAAFAABOEEH.hABAQCGCbDAH.hACANDAB.AEDECHAGZGAG....WCCDSFAAhACAaBBA.....hADA...,2,-31,-20,11
fgXGPQSDcOFMUCWJbVBRdTNAEKIaLZYHe,EEDGKGCHLDCCHBBCeAEE..XBEAQFBDDADE.OFHFhAAAMFFBUAAACHADJDFABBEEhABAREGDdEBD.ADAAaFGH.fABFhAHAgAGBSHFG...hAIA......hBAA...,1,3,-28,31
YLbEFBaNAOWHcTdPUZeXKGMSgCDIVQfJR,HCCBTECDdBAD.UGDFeEBDKFAGGAAD.SDCECDACDCIB.hAAAVFFEJAFH.RAFFLHAGhAAAEGHF.aADAAAHAOEFFhABAWBHH....cGEH...hACA......hADA...,2,-36,10,46
ORWYBJDPUSXcfZIVHFaEGLACMNdTgQbeK,MHFCTBGC..QAGCeBAFRDDD.BCEDDDBGUFAGSABFhAAA.XGDFfDHChAAAIEACFGFBEDFDADIDCFCChADANABF.dEEHKGDFOADC.WDHD...hAGA......hAHA...,1,-17,-19,2
UAcYbgXHIWOBFGMLTVPSRQEKeCNdaJZDf,...bAFAgCAD.HBFFIEBFOFFHGCBFLFAChAAAVGFASHCGhABA.EDDEKACACBBEaGGFhACADGEDAFFGcGABXAADBEHBTDGC.QGAChAAAdAEA.ZFCDhACA...,1,10,-11,21
KWaeTcOHMIbLfEFUCPRZdGVYgNXBQSJDA,KBGDeAEDOABDMIBGLFBG.EGFEUGFA.CBDBREABGDBFhAAA.VBAE.NHABBAGDhABAQEDC.SDHHhAAAAFHF.aBAB......hABA.cAGF.IHDChADA,2,-37,-22,15
MeaTQUGHLZKRgNFXDYWdOJcASfbPBEVIC,SFFC..fEHGBDGFEDDGCAGEeFFH.TFABhAAAUAABHFCFLCFEKAEBRDAHhABAFBBHDGGCWDAGdADCOAHDhBGAAHDCPABA.IFEFMIFA.aAFG..hAIA......hBAA...,1,-12,-24,12
PMAaTRecCQbGfgELKBOVXYWSNFHDUdIJZ,TEDGeFDGQDAE.GBCHfCEEEHDGKGBEOGAAhAAAVDEA.XBAD.hAAASGGDFAFCDBBAIGHDhABAZAECAEIFaAHFCHFELAHBBHDGWCFB..hABA......hACA...,2,-23,4,27
GOPHDJZLUdfVXbBCcSeRFWMIgKQTAEYNa,EABDaAGHGCBDHCFFJDAAZFCA.LACAdAEB..VFBEBHAHSHGChAAAFDHHMICEIHGEhAAAKEHHAIAC..OAHHhACAPEAHDBFF.fEEECBADeFEE...hABA......hADA...,2,-14,-14,0
HBOMDdfLcICgXRPTEVSFNGKAaUbYJZWeQ,UEABJHEAZDCGeEDA.HGDAOBBADCBHLBAC...IHAEhAAACHCARFABEDAHSCGDhAAAFDDGKFGC.aBACbBGFhABA....QFGFMADE.fFCFhABAcGGE.PAHHhACA..,1,-20,-25,5
EeLcRdCfYgABXaPbWQSUDVOHJFZGINKMT,BHEBXGGAaFGE.......bCCBSHACDEEGHFADFHDChAAAIHHDKCFC.ECADeACGhABARDCDdCFCfFDFhAEA.AFHDPCHDUBGCOBCA...hAFA......hAGA.JCBHNAAF,2,-37,-7,30
MDWfFLdZNGSEVPcBIbKTeaJgURHOCQXYA,MFHFDACAFCGALFBEZCBB.GBEFEEGD.VABFBBEF.KDDAeFFDhAAA.aDACJHBG..RDEGCHAChABAQGGFAHDC.hADA..dFDDNEIASAGEIAHF..gBAFhAAA.OFAHhABA.,1,1,-39,40
abFTJYIeAGUZCMXgBOHLDQdKWNSEcRVPf,UGCAZCCHCHBE.MAEBBFBCLFFG.dBGFKBEC.SEGAhAAAEDFERABF....fCHGhAAAFCGCTFEGIFAGhABAADAF..gCABHDCEWHFE..hADA....cAGFhABA.aHGG,1,-20,-44,24
QSLDZCVFTIGAfeadKNbWgUYEPXJMOHRcB,aCGHdFBHKAFA....NECG...bBCFUGGHEFFH...XDDDhAAAJCFCHBABBCCALEEEhAAACBHAFADA.IGHDhABAAFGAeBAB.....YHAC.MIEEhACA......hADA...,2,-38,-18,20
NIAeMQPXTCbaZgLHYGDKVEFJWdOUfBScR,eGFEQACC..TAEAaFCHLFHBHDECDBDFKEECECADFEDHdHDFhAAAOAGFBBBFSBHBhABARBADABIHMIAA.CGACbECGhACAgGFA.....YAFFhAAA.....hADA..JEAF,2,-17,1,18
bCfKFOJYcATQXUgeSPWDMVdEGNZHIaRLB,XCFCeDBD..PEDBDBBGdGFH.EHCCGCEC.ZAFAaEGEBHCGhAAACEDA.FBAB.JHEEAHAHUCABhAAASCCEMGBCVAFChABAIEHC........hABA......hACA...,2,-24,-24,0
LQEJPBUSTXGRANODaeCdFVfYgHWbMZIcK,OCCCeEBCFAGC..VFCC..fABGHDECMABFZGEAKBGHECADhAAABHAHSDFFhACAGACDAICGNCHA.DFAE.dHGDWFAGhADAIFHH..cBCE...hAAA......hACA...,2,-19,-14,5
XFKbIcDdULaOGZQHTYMgWRNPfCVBJeASE,XADFFDCDKADA.....IDDADABBdHDBUGADaDFG.ZEEATFBBhAAA..MCCEhAAARBAHPFFC.fHEFhABACBGDBCADAGID.EACB.cAFD.OAHDhAGA.....hACA...,1,-2,-53,51
GJSRKbcMHWaDNUTAfQYXEOPeFdLCIZBgV,QFFDEACB.OCACFCECLHECZCECBGCCVFBEGABBJEEA.hAAASBHBKEAC.hABAbFABMIAA..WFEFhAAADFADNADB..AGAF.fBHE.XFGEhAIA...hABA...,2,-23,-18,5
XSdAMNYZFBRIeCUbEPfGJQgOHKLcTaWDV,MAEGZFAEFEEHRBGD...CBFC.EFDEGGEB..QCCFHCBALDHFhAAAaAABDIBCSDADhABAADAEBEEBeEHF.bGDAhACAfHAH.OHCCTFBGWACChAGA..XBEBhADA.dBBB.,2,-13,-12,1
VYIMQJCEGUXDFeaRbWSdLfAOcHPTBZgKN,HCDETCDDBEBE.KFAFVGAGMBHD..QBBBEADCGGEHUGDAhAAAFGCHRBACSEBChABA.fAGEhACAAFFAOAAG.PFHHNAICIBFACCFBDEADaADA.bDFAhAHA.WFFB...hAGA...,2,-19,11,30
cQFAPZfJDBCdUHWYOVNMXIgaESeTRGKLb,ZDCCDDEBBBAHUDGFHFBB..OAFCMBFA...ICFAhAAAaGHDeBCGRDGBLCCBhABAQAAEAADG.JFGBdGFE.VFADhACANADDEHDA.......SFDGhAAA....hAIAKHCG..,1,-8,-27,19
RMeIZdfXHgOFWbKTCSUaYPAQDcJBLVNEG,DDEEBGHCLACGEGDHGBDAMEAEZBAH.dAGHHDGD.FBAHKDGACHAAUGGDhAAAaFFD..AADCQFAEhAAAJAHH..VFCGhABA.eCCC.fEED..hADAOACH...hAEAWHFA.,1,-5,-34,29
OXWHMUKaCRFgJbTBNQYLGSDAfPVZecEdI,VDCHZCFFeCAD.EAGGdGGD.OHCCHEBFMFIBKEGA.RDDH.FAEAJHECBCGDhAAA..QBCChAAALBBADFFFAABF..hABA.fAHG.IACE.hACA.....WFADhADA.CDHG,2,-39,-15,24
IJKVYAMXDLQROTPeGbFCEZcSWaBgNdfHU,MABDXDGBDFACLCDDRBCC..PHAAeGDCFBGD.CFHG.ZFDFhAAA.SFAAhABABBEEdGBG.fDBAhACA.IHHHKHEAAGABOEEGTAFGEACCWDEBhADANAIE......hAEA...,2,-27,-26,1
CADOcMVWfTNLZeXFRIUYKHJGdaEbgSQPB,ODBEVABB...TCFEZBEFFCGC.RGAG.UFGHHFFAdAEC.EAAFSDDBhAAABHEB.CHHFAAIBhABAMGAC..fAFDhADAeBFEIFEGJEAEaHEC..gCAChAAA.DHAA.NIAF.hACA...,2,-24,-10,14
bBXcSWPLfKZQAFNJaTgMUYROGeCEVHDdI,FHAAaGAB.MFDHRBEE.GCEACGEG..HDCEdDBCBHEASDACLADDhAAAKFFHAGIBJBGH.UGGEhABAOBAG.eDHFDAGA.hACAIHBE.cEBH..fAEAhBAANAAD..YAFChBEA,2,-32,-14,18
EIXaRGAJMQNFZefPdVKDLgOBHWcSbCYTU,QDEEZCCFeEGFdGDHDCBBLBADBGGHHFAB..SGBFhAAACCCBTAFE.IAFDhABA.aDBFACEFMIDGFAHF.hACAfAAB.KFCE.OACAWHCG.hADAYEHH.EGEAhAHA...,2,-29,-15,14
YLHZKNOWFJPIaQcEeTDSMbAGUfXRBdCVg,GDBBXBBBBBFDdDFE.CBAD....VFFFgGCG.LDDHhAAAKAGBOFAEFEBCJFAHhABAaCCG.QGGChACA.eAEEDIAESAECAHFCfBDHYBHBhAAANCIE.WFDHhABA...,2,-47,1,48
gNYaALDIRGQPTVZeCWcEFOJMBdKfbXSHU,LCHHDACARDGFGGDFTACFZDCH...CFEE.EHBEFDFF..MBCGBHAGhAAAKBGDXFAEHCEB.hAAAUAECNABC.ADHBQGGFhABA.VCADcAGFdEDC...SFAChAFA..hAIA.aCCA.,1,-7,-17,10
RaUWPQAYEIVKFXbfTZJHBMeNLdcDgSOGC,EHCEKFDBFAAB..XBDC..bBGHZGEABAHBeDEB.dFBHDBEGhACASCAEGCBHaDAChADAPAHF.AEBAIABChAAAfGFAJADAMFAA.LFFChAEAcGAC.CHGAUGAB..hAFA...,1,-8,-21,13
bCRHAZQFWLgOdTYXcISDJBeUNEaMVfGPK,ZFBDQCBBLBCDOEEGdFFD..TAFBXBGH.SADAhAAABAEFeEDHUGCChABANABC.aHFAMIFE..hAAAfGADPBHF.KEHH.CFGDADAHWHECgBEAhACAYDDCDAIB.hACA...,2,-26,-6,20
eZPHFVJgcBbfRTXIQaSLAUKGDNMdCYWEO,KCDDGBECDFEG.MCABdEGA.CECD...EBFDOAAEZCADHGACFAGF..JGEChAAABGHH..RDGF.TAGChAAAXCCF.aGCFhABAABAGNIEH...eACAPFAD..cFDChABA.....hADA...,1,-21,-22,1
FHEgXGaYTKNJdDRAMZcPIWSLOfQVeUBbC,MAFAZCED..IEBCLABE.QGBAeHCGUFGBBDCAFCGEHBCFhAAAgFEB.hABAXCDBaGABKBBDdAFHhACAABGE..WDHDSADBfCFCCEHC.ECBHhAAA......hBAA...,2,-29,-6,23
ZTdSJfaYAEGUObQKLgBFeXRCVDcPINMWH,EFDEGEGCUBFBOFCE.QCACKFFELDBABGAHFBCCeBBEhAAACDGD.DDDH..IHGHhAAANAFEMCIH..HAGDhABATFAE...dAEF..SEAAhACAaABGAAIH.....hAHA...,2,-33,-3,30
UQcdYRPFWXHbLTKOJSfBDgMVeGICEZNaA,UACCdAFCRDAEFGEDHEDG.LCHFKDFC.SBBFDABB.MIEEhAAAeHAEGEBGEACCZCDFAGGHQAFBhABA.hAAAYDDEPEGFXAGA...hAGA......hAIA...,1,-9,-30,21
PVbZdODBARNTEGMWYgFJQXKSCUaeLHfcI,RACGTDCGMBAH.......gGECFBHFQGDHXBABhAAACHAHeDCGfEFFhABAIFCCPCFE.hAAAVGAAZEFGDIGGABEHNADDWBFEKBFBSGGGhABA..aHGEcEABhACAOCAH..,2,-26,8,34
QfcNRJLATBMYVdXebOPDgUIGZKaWHFSEC,BHBHMEAGdDGFeCBH.OEEFDAAFUFEA.ZFBBKAAD.HAFAFBFB.EDDHhABA.CHHG.QBBChABA..fADEhACANADBREGF.AFCHVDGH.XGDD.hACA....PFABhAEAIBHA.,1,-9,-27,18
ZbXLfWEMKOHBDeQYTUgRCVdaAGJNFScIP,GACBFBFD.SFGDIHFA.ZAAHLACGEFAGKCFC.BHCCeFEFhACAQEGD.hADATDDHRDCFdDHGAICCJDAG.hAFA....NAIEPAAHfHAF..hAGAWGAC....hABA...,1,-7,-36,29
OAXBPQKYGgULJHRTSfcCMaDNZIbFEVWed,XGBABBAHQECDGADELBCDRCAC.SFFFhAAAfAGDCFAFMIEEDFHHIHCGhAAAECFFeBABdGFGPAHDhABAKAEBUCEHJEHB.....cABA.hACANEIE......hADAFEAH..,1,-4,-10,6
OaZdKPWELBFRfAHSTIeDUgJcGVCQbXNMY,TFDBDAFCUGBF..JAGFGEGG.QAAFXFFDMACHhAAAOACDZEAF..KDFEEDCAhABAFEAAABDF..SHAGhADAgEDECDFBNDIGaCGA.......hAEA......hAFAWAFABFCC,1,-12,-37,25
faHSJAZXCUbTGcgdRLQIEYBMVeOWNDKPF,XFCFUBFBGDFAdBCELFFGQGBDEBFHMABF..eDAFhAAAOAFGDBABKCGGFCDDaEAEhAAASEGCACCC.CAHHTGAChABA.........hACA......hADA...,1,-15,-27,12
AZMNYeBIFLcTXCRgaHfGbdJKODSEUWVQP,MCIBeDAABAFALBFF..XFDARBBDaHFAHEDDGBCB.dHGBhAAAJDAFDIAAEAAFUFAHQAGGhAAAAEEGZDFH.NIAHFBDFhACACACH..fDHE.KBAHWDHD.hABA......hACA...,1,3,-17,20
EKOVeMbNdaAIQWPJHYZSLDRUCFTcBgGXf,QGBCJEDBHBEGZBAHSDDALACCUGAHCHFG..FDAGBGGAhAAAXDFHEDEG.KAFGeEHBhABAMAAGdGFCAFAHIBBAhAEA...WCECDCDF.REBG..gGGBhAFA...hAGAOBHD.,1,-8,-12,4
IgZGRAVLJbcaMdUNTWOCPQBHfKeSFYEXD,VBEDJCCE....aHBEdHGF.UGAC..TFFEOCHBCDAGBFAChAAAHBBHeAFG.SGEFhAAAEACCDIFCIEEChABAGEBHADBHLAHDMABG.NEIA..PFBChACA.....hAHA..KBBF,1,-13,-24,11
bQadMEAeYZfWVCcXNLTROGIKJSDFBHgUP,eFHBZFDD..VFAHCBAD..XGAFLAEDOGDCKDFGDGGCFBEABHHEhAAAUDDE..QBAGhABAMAIHACHH.fDCGhACANADB.RAFA.JCBBSGFD.hAAA......hABA...,2,-30,-17,13
GXMNKbfdCZPHJVEULWcDSBARFTgYOQaIe,FAADTBGEOBFD..QBCFeFFHMDBFKHFG.dEGEZFBBHFDDhAAAEAHFLADFDDIBABFBgGADhABAaCCH.XCAHhACAfHGFCEEB.PEEB.JDHBWADChAHABAFC.....hAIA...,1,-5,-16,11
DaNGUROXSCedEWYKLMAFVfcBJbgPZHITQ,FBEDVFBGBCCG..JAAB....gGBEHGECQCDGhAAADAIHGEEFOAGFCAEF.hAAAeEFAEACD.KDABAGIF.fGAGhACA..cDAF.PHEChABA.ZAGHaAFH..hADA...,2,-26,-19,7
JXPICecVUbaARNQZLTSWMDYGFfKgEBdHO,RAGDZDEALECESGFEDCBFGABFKCGA.BGCDHCAD.XGCEhAAACHGG.eACBUDGFAAHBQAEEhABAMIBGFEAHEFHBhAAAdECC....JCDG......hABA......hACA...,2,-21,-9,12
IAQPCZJYEcdDgReXBVaSNMfGWKHFUbTLO,CHAHZGCC.JBBGECDE.dGCFREEE.BCBG..SAFFMEAC.GDAChAAAHEFHFBFG.TABFhAAAOAHB.ADEA.PFHFhABADABAXECF.aGHHNICHKFAC.LAHBhADA....hAEA...,1,-16,-27,11
DAYEfNCeUaMZHbJSdPLFQcVWXKgBTRIOG,EGEHCEGAUCDAZDCDHEFH..SABBdAFDLCFAFDAC.QBAHhAAA.VDAHXGDEhAAABHHDIHCBhABADHAEAEID.fGAEaCGEMFBA..JAFC.cGGChADA....hAEA...,1,6,-45,51
QSbOeFVPLaIMYgCWcKDTUBHAXZRfNJGEd,ZGCCRBAF.JBEFGEDE.dFAFSBBDOCHHFHACLAHB.hAAAMFAACHHHKCEB.UAEDhABABFGGAHGH.XCCHhAAA.EEGG.eADEaDCFIACF..hAFAgGADcFFF.hAHADCAF..,1,-18,-28,10
aITVSYBQgMNDPFXfcWJCKEHZUAORGdbLe,OABFRCCFGEGCdAGCeHDE..TGEG..SBGChAAABDEAQEBCMACDNBBEDEAFhABAFHBAXADG.hADAfBAGJADGKHACZCFEUEGA.ABIH.LFCGhAHAIHHC...hAIA...,2,-17,-6,11
cOZRPTbeLDCMAUHdgXKSJEIafYFVBNQGW,HEDAdGAAKFBCSCBB.EAECICCGaHBE.FGGHBBHHQBEEhAAA.GEDGhABAOEADZABETCFHhAAAeCHBDFFEMADDAAHFXDACfFGA.NIEHWBAFhABA.....hACA...,1,-10,-21,11
XZCFcGEaQJDYINKPMUVfeHTAbRgdWBSOL,RBBDdDEDBGHELFDAZDED.FBGGEBDG..JCCDDAGC....IHHGhAAAKGCAMCIH..UGADhABAeFBFAADF...bEFHhAAASHEA.CCAEaDHDNEAC..fBFBhABAgAEF..hACA...,1,-28,-38,10
aGHgdYObUAFTMDKSIXcQZCfPeRJWNBLEV,MEEFDFBCKBDH..SDFG..IBGBQCBGCDHA.hAAAeGAAJHFC.BGFEEFGE.hABAGAEFHABDdEAGYDAFhAAAOFDFAFHCXABA..cGAEhADA.fDEHhAEAWHAANIEF..,1,-29,-32,3
WDgBOMZKbfNIGCFaUeJXVASLHdEYcTRQP,HEFBECED.TEBERFBFQACCDBCHBAHGMEIDKBEF....fGAAhAAANAHEGGDBCAAFaHCEUEEHhAEA..XDDEhABAAFBFSBBDdDHGcAFCPAFFOCAH.hAFAIHHA..hACA...,2,-20,-3,17
SMDEIQeOgNGKJHaWCUXRAdBLPTZFcbYfV,BEBALDCFZBAAFHFC..bBEH..VEFGMGFG.DGAD.EADCQAEEhAAA.OEDDhABAgBGEKGBHHAGHhACACEHFRAABAHDFdEAC.........hAAA......hACA...,1,-19,-30,11
GdXSZcEPLHgKMINJVOeRCATWUFbBYQafD,TDBDFBCBBHHA..aCGGGBDC.dAGHSAGGZEAG.EHEEhAAALGDAHEGHMBCChABAIEGFJCCCOFADhACACAABAIDE.bFCH.QEEADCIHXCAD..hACA......hADA...,1,10,-36,46
RXEBYFNgOJPSTeMAVCILbQHZdWDKUcaGf,VCFACBHGLDBG.HFDGdAEGDEDDKACHUAEGGEEE.RGAE.BHDHFDAH.hAAAODFG..SCBBhABAMFIBAGBFQBADhAAA..WEHHaGBDEHFC..YACHhAGA...hABA...,2,-27,-21,6
YULaKAHBFScNGPJdIgQbTCWODEfZVRXMe,BBHHFEAD.SBFHGDDHdABD.QGBETEBC.CGFCOAAHhACAEABHZGECRADB..MIEAhAEAeHAGLCCFaEFDKDHDADCAhAAAHAEC.NBIAIGHCWAFCDBAF....hAFA..fDAChABA..,2,-12,-8,4
gQSRIADeXWJPcGZOBNFEYHTKfLdCaUVbM,XFBBJFDHGACABHFH..FAGHEBDBHEFDKDEBLACCCHAD.hAAAaAGEVEAB.MIFAhABASGDCAACF.DGGAhAAAeCEF..PBAFOCHD..YHAAhABA.fCCGhAGA.,2,-37,-15,22
NQJDgOFdeGVTCPBIHSZfbLUYARcKaWMXE,RDGBaCBCMBAF..XEECQEBE.DDCEFABAGBDDCDGCBAEASGGDhAAAZFCFLFHHhAAAAGACKHBGEGGH..NEEAOBBBhABAdAGCeEAD..PAFGfCEG.hACA......hADA...,1,-15,-16,1
EDQfUSKgJMVXZFTNcYBPaIHWLCeObARdG,RADDdEDBDCBCQGED.UBEFKHGEMCHBZBAAFFAG....NGBH.hAAABHHC.aHACIABGhADALBHD.CAABOADAhACAAGAFECFH..fHAFgEGGJAFA.hAHAXEEE..hAIA...,2,-48,-11,37
QHUFfYaAEdNXSLKcCRMbIDPTWVZGJBgOe,EDFDdAFFSABBKGCD.RFCF.ICBE.DIFATDEBZFABBAHBhAAAeDADUAEFFDCGaFGFhAAAABAFLDDHMCFAPHEEhADA...WEHBJFHHODAB.fFFEhABA..hACA...,2,-31,-10,21
GAZEHCWOBaPXeJcVULTgbFIDfdRKNSMQY,ZBEECGAEBAFAaDCF...eEECJEAD...UBCFLGEA.TDGBhAAAFBAFDCFA.dGHARFBFSACChABAMGDG..hAFA..........YEAChAAAAHIF.EHDEWADAhAHAOHAE.,1,-27,-50,23
XSKfLHUaVFeRAYZTWgcPGDMIEBJOCQdbN,TDDG..gABHGEGEDADBEEFFJBFA..OAEHdGDF.hAAAXBGBSCAHhABAKGCGLFABUFAEaAGAeCEGhACAAIDGWHFCMIDEBBAFCCCD.bDCC...NCIE.hAAA......hABA...,1,-5,-24,19
fJOGaIdLRcECASFUTgWbZKNPDeYQXVHMB,SBFGFBDHUAGE...TCAE..bGFGZDFBKDFGDIEE.eHAChAAAQFAAHACHBFHChABAJBBF.OFAE.hAAAaECAIHDA.LACCEAHBCGHAAHEE.NFDD.hABA......hBAA...,1,-5,-32,27
bRKNcZEWIDSaJXLQUCOFdYeVHGBMPAgfT,TADGKCFCZDAF..EACEDFHD...JEDHLHDEUCAG.CDDAdFGDeAGFhAAAHBAGBABGAIHG...hAAA..fEEDhACANEAE.ICHCaECCOBHDFFAD....hABAYFCF.MIEChADA..,1,-22,-26,4
EBSQaCDGbHPVAgFfWceJTUNMIOZYKXRLd,FDDD..fHEFeEAHJADC.UEEB.MAADOHAEKDBELDFEhABABGEAQEGDhAAADBEAHGACACDG...WBBGhACATABBZEAE.RCFCEFCBCHHHPEHB....hADAcBAC.IHGEhABA.,2,-34,-3,31
NObBRZTHfFdMYWIPCgDEXacVQULKeSAGJ,GCGCOCHDRAFCZCBGHGACdFECMFAD..IDFDCHBG.DAABaFCDhAAAQFFHLACEeBFHhABASDCDACCANIDF.hAGABFAGFEBD.PBDFEGFE.cCAG..hABA.KHFA....hACA...,1,-3,-20,17
RZafNYVgTWOMIGLHeJFbSECAQBUcKPDdX,UFEBKBECDCGBdGCEZBBA..aABE......fGABhAAANCHC..VAECTDBEhABAMECGIFECHEAAeCAEhAAAJDHHFHGC.SHAGAGIBBAHE...hABA......hACA...,1,-23,-33,10
ZcHXLTCPIedDUFSQORWKBbGNaMfJEYAgV,VEFBHBBDTFAE.CFGD.eCCF.UBGDFEDHQAFDhAAAOBABKHAEBEDFNICD.MAFChAAAfADG.YBAFhABAABEDZFBA.cDDF...LEHHhACAIHHADHDE.SAHBhAEA,2,-39,9,48
gWMCIPFUAOYbXBDQNfKLaEJcdSVGeTHZR,OEHHXGFFDCIB..QCCDKEEGLAEDJFAE.dGCGGAAChAAAHDACZAGDRAFBMEID.IAHGhACAPACFABACBGEGhADAaGEB.EDGA.SDEH....hAEA......hAFA...,2,-23,-8,15
EFPMWaUBfbNCcVXTHJdYZAgOLeSQRKDIG,OFHHSBBAKGAGGAADFFBE..MAADUECGBHBF..fHDHhAAACDED.VAFDhABATGDF.dHGHAGGHeDDEhADADCEAIAECEEAGaDHF.NAICHFFG..hABA.ZDAE.LAGHhACA..,2,-18,-6,12
ZeVWdUYQTSXPCagDOKBLAFfHbJcIMEGNR,HBGDJGCA.MEADEGGHGCFCZGFEeDCA.dABHQDCB.TADEhAAAXDFD.aGBHhAAADAGC.KBACACCCfEBGhACAICHDRDAB.WFEGSHBG..hABA...CCCE.OFCDhAEA..,1,-6,-20,14
PgLZdOQfYSITWBRAUCcJbNMaXGFVHEeDK,CGHEJEAB..MFEGGCEGHBACDFHBKGBDLBHHdAEA..OAGDhAAA.QDAHhABAYABASGCChAAAIHEGBDFHADDH..cAEFbFDGNAIA.aECC.XGFDhADAEDDA.eHCA.hACA...,2,-16,-15,1
WHICVFeBcDTGOKLPXfMQUZNabRdgSAYJE,JDBEEACFHFFB.CHEG.FFHBBCAEDAEEGEEELCDH...XAFChAAAMHAAZBFE.aBCCdCHGhABA.AIBEIEAEhACA.eCFFOAABKGAC.fAGH.hAEA......hAGA...,2,-38,-15,23
KGVgcQUeCBELIdTbFYDXSfJAaHONMPWRZ,aEFFHCBE.MCFBRECEZGCAKEGCGACH..VGDAQBADUAEHBCHChAAAEFAFdHGFFFADDIGGSAFEhAAAABAH.NDDH..hABA......WBHH....hABA......hACA...,1,-13,-32,19
eYLCXKJEGNRZHfIbWFBdPTgcDOVUAaQSM,aGAEQDCE.eHCCCCCEKGEAGFADRAFHHDGD..fAHChAAA.IBBFhABAWAAHBFAGTBEDDFDFOACEhAAAAGIBMIFCXFFEEDEF.NACBFEEA..hAHA......hBAA...,2,-33,1,34
dWQXOZBYbJcKPFeEANaLUDRICTGgSMVHf,aFAAUBBG.RGCC.CHHDGACD..SFFEHFEAdEEBQGAHhAAAODFGBBFBJCAEKGHHFEHFhABAEECDAEDFDBIB..IFAHhAAAMDDG.fHABWAGB...hACAXADB..hABA...,1,-4,-43,39
aHINCZMWSGcdQRBTPFeAOXVEfJYLgUDKb,VACGJGCELABC..DGACKHAGaGEAHCDF..CCAFZCEGSCGGhAAAGGBBdAFABCCBFHGEhAAAAFBFEAHB..fEFFhABAUFFGIDBHMCIB...WAFFcCAEhACA.....hAIA...,1,-16,-29,13
ZagRbCUcTNJKeDWASBGYMFfLPHOIQdVXE,SGEEBAAFMAEELDFFHBDCQGACdDDG.VDBAXGBDhACAEAAFZCGDaBGA.RACGCEGAcGDHhAAA..JBBHDAEEhACAAEIFFHGC...fHDBIAHA..hAIA......hCAA...,1,1,-23,24
YTJKgUfRNFHAZBDSQWIGOEMPbcCeVXLda,BBAGDGDFQAAFGDBHMBBE..bBGBCBFD..eHEELFEFhABAdFAG.TBDAKDGBUGBChAAAfDBGRFFE.FFGEhADAAAIBSCAAIFAHEDFD.cGAEaAEA.hABA......hACA...,2,-20,-2,18
LOGXMQBUSDTeHZVaWPdcKAbNgYIJREfFC,...bAEDgABD..IAAAEAFDCCHHGEEEQGEChACABHHDDEBFTGBGeECBhAAAVDAAaDDGdEHCKFFCAADFNDAE.hADAYAHB.fBCGLHBG.OEHDhAEA.MEEE.hAEASGAD.,2,-2,6,8
GCVUeXJcLdPbRHBWTfDAEQYFKOZgSMNaI,QACCKGBEOACCZBBAMFDD...IHABCDDGUFFD...eGFChAAAJAHH.dCGE.bAED.hAAABEABTDFCAECCFAGGSCAGhABAaEED.XEAC.LHDAhACA....hAEA...,1,-14,-32,18
MFKdfSECXRLZPUWaVIeOYJDbcGHQNBAgT,MDBGdGDGEBHDREAF.LEFCUGFG...aDBAeDEH.OAAEJFBBDFGBhAAAGAFE..QBEEhABAACIFFDHHKADECAHAXABHhADAZECD.PFHB.IEAEhAEA......hAFA...,1,-16,-24,8
FJBDZeKfUGCHWYTNMgdIRXAbEcLaOSQVP,EBBFLABG.OEFEQAGHFCGBBDEEZDCHKFFAGDCGCHFEHGAChAAA..TGGAMFIHIADDhABAXCADACCBbCFGhACAaFAC...SAHB...hAFA......hAGA...,1,-17,-20,3
CTSFaEPdHWcGDOeJVfZBLKUAXMgbQYNRI,XBGAMIEC..QEAERFEF.CFFGFADGEABBdEGDHDGDGDAChAAADAACOCBGVCDHfADDhACALEEFKHBCAGHD.hAFA..gAGF..bFCD.IAGDhAIAaGAHWDDF..hAGA...,1,-2,-20,18
SaVXKcPeQFLIEDUNAMGgbOBdCWZJHYTRf,GFCHOAHHdEAECAAHZBFBHDCD.RGFG.SCCC..aEFBVDAHhAAAKBBBeAFBFACEEHFE.hAAADGADAHEDMIAA.BBAChABA.JADHYDHF..TEGFhACAfDDF...hAEA...,2,-19,-13,6
KeGEJFHCWZTNARXSMbadcBUOfgQDYLVIP,XGEEMBBCdGAEUFCE..OBGB.QDDBLBFGIFGDhAAAPABDKADDeEAChABAJEACFGABCGEEZCDANCIC.AHHB.hACA.SHEA..aAABBEEEDFFC.hAEAYAECEHBC..hADAWAFE.,2,-23,-14,9
dACPMJFSBbgQKWVZXRGEOUHacDNfTeYLI,MEGHSCHFBEEB.QFBHKDAHZACAGBGGOBBC.HGFCaECH.hAAADCAH.TDEGLHAAhABAAAIBCDBGFAAG.gAFHhADAXCDGEHGAcEDHfBBG.hAEA......hAFA...,2,-20,-13,7
NdRTYVbGLBKgHIQaWDCUeFSOZEMcfPJAX,XFGGRFDH..VGFAGDDHKCBCHAFBICHG..aABEDBCEhAAAUFADeAFD.SHBAhABAZDFEEDDF.MDCDhACAfCAEAAIDdDAEYHFGBAAF....hADA......hAEA...,2,-20,-16,4
ZHSLOVKcQeDXdMbCBJTgGUNPRIYaAEWFf,FDFDZEDFLDCEOEBB.KFADeFGHdCHA.MABHBAEH...JFCFTCCEhAAAGAAGUAECRFFG.hAAA..IACDhAHAAIFEEBFC.fHDF..SADDhACAcGBEDAIF.CFDB...hBAA...,2,-27,-21,6
YUcAMWFDTRIPJXEBdGKSQZHaCLgbOfNeV,MAABFBABDIDARCCH....JCFEBDGB.GCCEQGFAZFFHCFHC.LEEChABA.OBBGhACANAIG.eDAHUAFCABGETFBAhADA.IHACPDAFEFEB.KHBChAAASAEB.hABA...,1,-10,-36,26
FTLBfceYXdHUPbaJIMRQGDVgEZKCNAWSO,SDHDTBDE.BBCBeDHFdGDBUFEC.aHDCICFA.hAAAMIBGRFBFDIGE.EAFECEECAAHDhAAAOBBBLCADfDEFhABAXFAEPEABQCCF.gGGEhABAKACE.NAIC.hACA...,2,-31,-5,26
MFWHeEVUSDdaOQACgXNKRBYbJPIZGTfLc,CAGFXAGHKCGH.BEBE..JDFHZDDBGDBALFHB.MFAFhAAAFBCCeHFAEFFH..VABEhABADDIHOFABAHGH.hAEA.gDFC.RGBG.....hAFAYBAH.IDDBhAAA,2,-45,-17,28
dZQRYTFJOaDMeAXGcSWBVKgPULfHEbICN,XDADGDAHSAGBBBCD.KFCAUFEDHGECEDECCFADZBFF.RAACFBDDhAAAOADA.MBIHhAAAADHE....WEFGhABAgGBC.fAGCNIBD.YHFGhABA.aCABDADEhAIAcCDG.,2,-26,-5,21
GTKXIAZVNBHeCJMaYQdPREgbcSFULDfWO,VBCGBCCEHDGF.JGCAaBAF..dAFEEGGG....bDACSHAChAAAFDFBLFBFDDFHfGEGhABAOAADKAHFAGGDhAAANAGA..MCIH.QEAH..hACA......hADA...,2,-29,-21,8
OPLKcNITFAJRUgfSHVabCeDZQXYBWdEMG,RABBUDCC..SGACHAFBaGGC.eADCDHBCZCABXEEEBEHHdADAhAAAMBIB.GGDFLFFFhABAKBEG..IHBChAAAAAHCfDGHbDAACBAD........hACAWDGB....hABA...,1,-14,-22,8
JPcQFbVeIDLMaHREYZCNdXBfWUGKSAOgT,TEFBJEFG..QFAFFCAC.eBCBIGHDLHCCHFBFhAAAEBEHCDDCdBFEBBAEfBBDhABA..WAEEhAAAKHEEACEC.OAHDcGGEDFAFMGDCaEBB.YAHBhABA.XCAGhACASEED,1,-10,-34,24
fZYCbARKTdcgOLWIGaeSBUJEXDFVPNMQH,REGFdHCBOBCBLAEAGEACeCFD.BABHJFDG.DDAG..FHCCVDCDhAAAMDFG..HFGBZAFGCADDhAAAACCEKFAA....hABA............hADA......hAFA...,2,-33,-28,5
ZLbcSFXAMBIeEUQYGJNDCagOfKdVRHWPT,BGHFECBFUEDCQEECGBFG.DBDF.CGBH.OHCG.dFAFVAFEhAAAHADF...TAABhAAAbEACFBADAIEAMBID.hABAIGHEeHFGNIAF.fHADKDHHRCEG..hACA......hADA...,2,-13,-13,0
UNAGPOgfVRIJFBELCZdXKDSHQWbYeTcaM,OECAVBBB.RCFC.FFGCLFACZFBH.dGGDKGEDDBGEHAEE.QDEGhAAA..YACChAAAeEADaDHFNIADGBBFhABA...fEHABADFCHHESBAFhABAWFFF...hAGA...,2,-31,-10,21
YQeEZcAgOSaXfHMGVJCNIRTBdFKWDbULP,OBEAXGADHFABGCCDCCEH..REEGBBABdEABFADBKHEADBAG.LEFHhAAAQCCAeHCEEGDFhAAAAHIF..aAGGMCIH.hABANACD.WFGH.bBFE.......hABA......hAHA...,2,-23,-5,18
XZAaQOLeUKfbDYWTBSHECGJVcdNFRIPMg,QBCGeECCUCGGKFFGDFBA....TDECBFAESAAHhAAAHAFHCHFDJDHB.dCCH.FHFCIHHEhAAAMIBC.ZFACADAFaFCEhACAfBHA.WBABEAGE....hABA......hACA...,1,-23,-26,3
DgWQLcPeVINZTaFBfEGUJOdXKbYRSHACM,DEDFQCGGLCEEeBEH..IGEHNADE.ZCAEFAADEDHFJGBChAAAdACFKFGG..bAFESAHBhACA.AIHCMEABhAEAcFAB.TGGEaEBCBHBD.fGFGhAFA..OHAEhAAA.,2,-28,-14,14
FEYNJOfAVdTKGQXBMPcbeDaLgZHUWIRCS,dCCDGCAHBHFCMFBA....PABAbFEADICCLEHB.hAAAZBFCUAFFRGBEFFDCEABG.hAAANAIA.OEBGACGD.KAGAhAFA..QGAF.eHDEaGAB.HDEEhADACFFB.....hAGA...,2,-22,3,25
OBDCIEbVaGNdLHYUWcJTXfSZegQPFMRAK,KDBCBBHCDEBDEGAC...aBFHdFCF.LEHD.HAAEUDAEJAFGhAAAXFEB.fBBBhAAASFFBZDEAhABAQGCDMEIFAAGECHDCIHGBbADB..hACANCAC.WDDD...hACA.eDEA.,1,-13,-21,8
eHNSTfMDQGBJPVXEKAgIbcZUWCdaLRYOF,..IFBGbACE.ZDBACHCFdAGBLAEB.OHAAFDDFHCADSBCGhAAATDGCMABGhAAAQFGGBFFGPFHFhBAAEGEFAIHAUAGE.aDGEeFDBDDAH.....hABA......hACA...,2,-14,-9,5
WNAgXdOeaLDRGBHMKTUVfIbYEFCPQScZJ,dEHCeCBFLCFHGEBGBAGEHCBBKBGEUEGA..IGAAEBHFFACGCEEFhAAASADA.hABAZDDFJAEDADAFOABGhAAADIDA.MFDBfGFE.....hAGA......hAHA...,1,-19,-24,5
QTDYdaFKefGAURBCMZXcHVgPSWbONIEJL,BFAFMFAGZAACHADF.VAADSGGD.ODHDEGFBQGADhAAADGDEdCCD.KHDAeAEGhABAAHIFCEGD.XGAF.hACAPHCGNDDC.ICAHTCGB.FEEAfEEChADA...hACA...,1,-14,-21,7
VPJgEUBIYNFaXLQWKHDTMGdfZCSecbAOR,OFDERCDG..VFCGJCCF.UGGEBHAD.....IAGEhAAANBBA.FABEaAGEQCGFhABAKDCDDIDC.MFIBhAEAdADFCGAFeHCC.ACFHEFAB.LBEDWCHB.hAAA......hABA...,1,-17,-38,21
YHAVJKWFUbTcEBQPOLdfgDIGSRZeXNaMC,JACHFGBCUDCF..TEFEBFHF..OBAHdAFHDIDE.GBAChAAAZFED.eCEFaDFE.MBIDhABAHAFGADHH.KBBE...hADA.cGACEBEB.LECBIHHHSHGChAEANAAB.CCGF..hAFA...,1,-8,-34,26
RNZFPYcaWJXgCfHALIDVQebdKUGOSETMB,DDBEVBDFQFCG.dFGFGGAH.SGGCEBCEBGAHZEEDhAAAPDBBaCABJBFGXAFAhAAA..fHGDhABAAIAALEFEeEACKBACOACGMICG.NIDD.hABA......hAGA...,1,-15,-16,1
IcSYALGMZTHWCBOUXNKDeRgaJdVPEQbfF,LFBDMAFGZFDDHBDDBFEFUCAEKCHH.eAAAaDAG...dFGCEAAFQCDHhAAAFGBG.SCGAhABAGCFAWFHFhAAACEHEOAFCDBFE.RFCB.gDBA..hACA......hADA...,1,-14,-16,2
gJcNEKUCGPQOYfeFAWSVRdLbITHDaMBXZ,VFGBRFBFdAAFLFGF..bAEDHBFCMHAABCCD.XCEGhADAJAGHEEBD.CADA.GAABhAAAOAFGeDCBAEIB.IEFAhABADGEFaFEF..........hADA......hAEA...,1,-16,-19,3
NVODfSCRdGHagQLXZYKIJUPcbAMTeBEFW,TCDAEGEDFBCE.....VGFGDGHDCHDGGBGAHAFE.QDAFhAAAZEAAKDDB.UFAF.cFEBhABAMACEBGFE.hACAOAAHfBCHdHADaCGDXGCH.hABA......hAHA...,1,3,-27,30
HEgJVecPOdZXWGLTBNMCAKIfFYQaRbUSD,KBAGFGCGQBFBREFH.UBCBHAEF.gDCDJFFA.eAGBhAAAODAC.dGAGWEHBhABALDFA.NADB.hAAACAHBAADG.IGDB.fEBGhACAaABBDICA......hBAA...,2,-30,-20,10
OATScHKbfYDPLRZCaIFWUGJBMeXEQgNVd,SBDBHDDCKHFE....bABHfEAGDAFFREAF.CFGGFFDAUDGEhAAA.BGCBeBADEAHFNIEBOCCBhAAAAIHG.TDGBhABAPADFaFHD.IHABWBAF.MHCC.hABAQAGCdHAD.hADA...,1,-1,-16,15
bXORNFYHSKWQGfdBVPEZcUaIeATJMDgCL,JBEGDDBBCHDELHEE..XCFEOFADFEEEHEEF.KBBAQDAHhAAAdAECBHADEGHHUBAFhABA.eDDCMCAB.RFBH.hAAANCIC.SAGF...fDDEhABA....hACA...,1,-22,-26,4
WFIDTbYXKdPGQgVABCLeUHEfSRZOcJMNa,BHGDLDCDUCFEEADHRDBG.ZFEG..OAADJAAH..MAGB..hABAaGBCFFAFDICG..bDEGhACAXFFG.dAGBhAAAPAHD..gADAAHDHeFHH..hACASHAANEAA.hADA.WEHH.,2,-30,-11,19
HOQEYJTRUgGAbadPfKeWCIFDLNcMSVXZB,aDAGdDHGKBEH..CFBCDGCHLHCA.MBAHXEEEBAAEHEDHhACAOAHB..EEBBJCCCTCCHhADAUGDH..AHGA.fAGEhAEAeACEFGAHSAFHQGGH..hAAA...YBAEhABA..,2,-24,-23,1
CcDGJXfbEdKSgTZBFLRNWOYPVaMQeAHUI,UGDGCCHCDABC.GCGA..XEGHEEFBdAGDKCAG..SEDDhAAAZAAABEBCFDDHRADGOGEChAFA...YBBBhAGAaAEBMFCF.AHAFIHHAfDDB..hAHA......hAIA...,1,-22,-44,22
WaPSDgGNRQOFJbZVYCHdIKTcfeMXALBUE,LFAHUCAFEFFD.aCACDFBBGGCF.REEG.OFDBFAEH.ZBEBVCFAhAAACFHE..dCGCKAGA..hABATAACeCBEAGIFBHHDhAAASABA....NAIG....hACA......hAFA...,1,-12,-33,21
IaOPXABfcgTUZbYGKHQEFdVSNWRJeCLMD,BCBA..fBBFTGDBZCFAGBFEHAFEFEBHdEDDNCIA.JEAHCGHCDEFAhAAA..OHEAhAAAAEDAUABHbFBD...KBEFhABAEFFDSCAG....WADHhACA.eFADIAHEhACA...,2,-21,-17,4
SOCVAFPadDfBbQILegMcHGTNYXZWJKURE,aABAdAAGDGGGBGHD..QDDCeFBA.MIBEGCDD.TAGEhAAAXBFG.JDABKBCFhAEARGEE.SGEAhAFA.CFFCAEBGfGBHbGAC.IEGHhACAcEGANICDYADE.hAGAWAHH.,1,-6,-42,36
YJXAQZLHSUaMPDKgTGdFBVOEcbCNIfReW,QGBGLDEEUCADMAEBDGFA..KFFAGEBFFAAFBDBAEABGCHBF.hACA.IEEARAFG.hAAAeHECJHFAAGEHHCFA.hADASDAFaDHD...gAGGhADA.....hAEA...,1,-11,-27,16
RXbYDUeaFPSTVfJHAOcZMGIKWBEgCLNdQ,ZBFDGBAEKDCFBBDACCFAdEGE..REEH...XAAFDIFCUGBG..eHEAhADAFAFA...TEGDhAEAJACF.ACIF.MEABEFCCLAFEhBAA.NDBA......YHCEhBCA..SCEFhAAA,1,-34,-35,1
ReNJMYBcETCPKXdOgIfFULVGSbADHQWaZ,QGFHaDADZECD.RDFA.eAEEMBDCBHAHEBGA.CGGH...KDCAOEFBhAAA..fCBFhAAAUBCFVCGFbGAAAGIHDBAFhABA..NACH..YFCC....hABA......hAHA...,1,-20,-29,9
NgeXWaUcbfCIKSDZTRPLQdFGAOEVHYBMJ,EGDBHGDCBCDFMCAE.JFBCeAFE..aAEBUDEB...fFBHhAAAIAHGKGAASCAFhABATCEFLDAEhAAAFCHDAGGBOBBG.YFHBNDIEXEEE.hACA.cEAGDAGF..hADA...,2,-32,-11,21
HVfgRIMAGJdUXeSQCKZYDPTLEBFWacNOb,dBFDUDFBeECDCHCC.KACBDBAALGFA.BAECFFAG..aAECODDEhAAAHGFA...VBABhABAREDDAAIHGCAB.SCGEhAAAQGAH...PFFG.hABA..WHEG..hACA...,2,-27,-27,0
GdKDPXUIMAWbZNTeSJFLcHQBYVEOaCRfg,ZDCDTAAHeGFA.FABDLHCGHCEBBHDEEGHHCFCH..RAGHGDAAhAAADCCGUCFAAIHA...NDEG.SADHhABA..hADAcDAA.YFAHaCHD...fFFFhAAA.KACEhAFA.IAHBMIAG,1,-7,-17,10
NaTZePADEfQKYFXJSCLHbUMgcIRGWOdBV,EFAHQFAGKCBD.FEEBJHFELCBA.HABCMDEG..gGGDhAAAIAFGRACBOHAEhABAdFEBBBACaDGBTAGHhACAeBHBAFCA.DFIHfEHGSFDDCGCB.bAEBhAIA......hBAA...,2,-30,0,30
FBRUETPfbSQMIgDONCWYVdHLcAaJKGeXZ,JAABKADHeHAEZGFE.RFCG.UEEF..EDDA...TAGE..hAAAPAGBSCCFhABAMDBBDDCDCGGH..YDABhACAdDHCLHAEAEFHaDHH.XCCBBBBC.fAEEhAAA..hACA...,2,-40,-16,24
OIgWACRcbFDHBSPJZKNEQTYMVLedGXfUa,CFCHRGAAFDEDDEBG.HFGFBEFH..JADHKBGA..EGEH..QBDDhAAA.MDIFVAFHeABAhABAdEAEfCAHhAAA..aFADIABCAAFESHGENCIA.hAEATGDD...hAFAYCAD.,2,-38,-10,28
LFGQBfEVbJXHIgUaCKMZRTAWYdNcePSDO,dGHGeFFFDHDCLECGFDEG.BDDAEBBE.VABA..XFAHhAAAHGAEUAFBCAGH.MCIDTDBChABAAHGF...NCAA.SBADhAAA.OEHHfEGAIEAHhABAKBDCWHDA.cCGFhACA.,2,-46,-5,41
VRZbTQUYIJWHKEXLMGadBFfPgOAceDSCN,DECECCDERFFF.ZFEA..QGCAUBCH..JAGFKBAALAACGAFCBDBGhAAA.FADC..hABAgFBHAHAAeFACSDEHhACA.NAIC.......hAFA......hAHA...,2,-52,-22,30
KbXgYVESGPMUZQfWeRdHFTJODNIBLacCA,XGBGVGFE.GDBDMEAGZAGB..QEGCeBDBHFBBJABChAAAOFDFDBBBBFBELABDhAAACAGAAICAKAEE..YAFDhADASFDA.PCDGWDFA...hAEA......hBAA..FGHD,2,-14,-12,2
JUQNKCSTaAGYVMDfXPFcIREgZbeLOHWdB,GDCEMACGDFDB..PBCAFEGB..RAGDZBAELCGBHBEHBDDDhAAAUAAAKGAG.CEAGSGHHhADAaGAEAABH.VGEAhAEA..fFHC.cGDDIAGChAFAEEBF.....hAGA...,1,-12,-31,19
egFPEMHXcIOaTZBfNRQWJGKVUDYCdbSAL,LDADFCEEEADF.HFCE.XCBDOCADTGECBHHDRCFAQABDhAAAJBHB.KHEEDEEChAAACFFE.SGBChABAACFE.PCCHIAHGaGAH.fDDBhABA..NEICWAFC.hADA...,1,-20,-21,1
HadGXYfSAWZMQEJLNPTDFICUcROKbeVBg,MHFCQCEELABF..PDDBDDIBCEGEUAGGOBBD.eFAFhAAABACAaGFBdECD.GEAAhAAAfAFBAIGEZDEHEAEBhAFANCICFADH...IBACKCCC.bFBDgGDDhBAA...hABA...,1,-11,-15,4
HKMNSdgRTAOFIXZeaEPYCBbfJLVcDWQUG,FAAAXEDEZEGB..aFCCEACF...CAEGBDCBJBEHLHBCDCAFQEGGhAAAUBGB.HFAAhABAKDBD.MAIF.NHDD.SACHhAEAdCFB.....gEEGhAFAAHAB..OHBChACA..,2,-38,-9,29
ZYEGLTVgCOXJPWBdbUKRMcAefHNDSIFQa,eBBBHECGDABGFCFFZEBGGGBHLFHB..TGGGCCHG.XBFChAAAJFFHBAACUBCDRACD.hACAAGFASGAChAEAQGBDaAHF..EAFGOAECdDBHMAID..hAHANEAA......hBAA...,2,-11,-7,4
RYXcFCDbZJGVLgSMaUQHPKEdOAWBefTIN,BFHDeDBB...TAEFIFFA.RABF.XBAGCHHC.ZGDEJDDBhAAAGDBHLAGFSCGDhAAAMBFH.aAHBHFAFhABAKFDGEGAHAHFBfEGDcBDC.DADG..hAIA......hBAA...,1,-15,-20,5
JEISQWXAZMGdBbPLFCVKgNTYUDHfaOecR,MADCdGDEBBGHLEGFCFBD.KACD..TDBDDBGCHECD.aCHFeADFhAAARCDA.EHAA.SGHDhABA.QEFBhACAAHAFZAAF.bAEHPHDE.FFBH..hAHA..NCIC....hAIA..fBBC,2,-19,-18,1
XDJNRLcAKPGIZVSgFMUbHdWaTQeBOYfEC,GECBVCEF.FDAGMHDCHBFE.dHAF.aHGAQAAB.BFGAhABAfCEGXGAHhADADAFAJFBALBAGhAAAAAEFKDBAZAGHSHDC...bDGHWHEAhAFA......hAIA...,1,-4,-26,22
IREWZcHfUBCeTYXLDGVgMJSQNAOaKbFPd,aGBGKEACFFHD..dADAEGECZCEG.HAFAUGBABCBH.eGFE.XAAFhAFADDAGVACCMDIHhAHAQAGHAEHH.ODEHhAAAIEFA.cDBDCBABTDFF..hABA......hACA...,1,-12,-31,19
LSJANaQCeFOKEBYDIPbGcTMHVfWdUZXRg,aBFHeBCD.FAADOGCCKFEB.BDAHDAEF.....IAAEhACAGDGGMFDHHEEAfGGEhADAdAGCUFAB.RBGDgDCAhAEASGHHAEEHCFADPCBGbAED..TDAFhAAAWHAG....hACA...,1,-8,-23,15
KOLVMUgDAZSFRXNfYBedPTIGJHWEQcaCb,SEAGFHBERDFG..XAGG..NEFABDDDdGGB.PBCEhAAAIFBA.HFDHhAAAQGGBCCBHKAEDOCAHhABALCGB.MBIHDIFGABBEfBAFhABATDCH.WHBC.EDAE.hACAaFBE..,1,-20,-23,3
XWAfERgHTDLPQOZNcSCUGKJIFMebYaBdV,EDFBHFBEDADFQBBB.OEDCZABHSHCAGCEDIHFChAAAMDEBeHACaGGFdAEChABAXGGFAICGRAFGLDAGhACANBEH.CHAG.JFAGYEHHBHFCfAAEhAEA.gDGBhAFA..,2,-14,8,22
EIGTbNadHfgQMWFKCBXDSLJVPRZYUAcOe,ODDCeHAEEAAHGFDH..TFGHaAEHdAAHHEBAQDAGhABAFBEFCDAADGEBJHAGRDEAZAGF.ADDF.hAAAICGE.fGHChADAMIFABCCF.SADC.hAFA......hAGA...,2,-23,-2,21
eWYNXaKHZCgAGFbfEPULdOJQDMTVSIBRc,FACAECCHLCGBOEGD.QGBHMCCH.SDADBHAEeBFFhAAA..NAIA.XGDHhABAaEEDKBBCCECHAAID..fEDAhAFAdHGHDBEC.ICHHWAAC....hAGA......hAHA...,2,-41,-13,28
QOGZNWVYBJHFeLPacDEgKCSIbMRdUfXAT,TGFHOCEBZGFC..VCEDBEAD.FGAFeEACLAAA..hABAcABGDEGHEEBGKGCACEHG.hACAIAHH.MCIHhAAAdHCHXCGAABDBQGAA....hABA......hAEA...,1,-21,-30,9
LYJNMVHceaCDKfGWEBSIUgRTOXFbZdQAP,LAECJEDB.MCIHVCFDHCAH.aECGCBCD..DEBBGGED.hAAABCGBSAGChABAIGBDUFFDTABEFADCdHCHhACAAFDFNIBFKEGH..fCDC.EBHBhAFAODDA...hBAA...,1,1,-35,36
VXLWMEDFIPSdbARfHYCZNaUJBcGgQOTKe,RDAGHCADCBGB.aDEFUFBFBAHD.GACF.OFAHKBBCeFGFLHFGhAAAMAFH.FHCA.PEGBhABASEEG.ADDE.hAAAfCGB.ZCCFNAIC....cGDEhABA....hACA...,2,-47,4,51
VWJYTgKPNZBXEMdGCDLIfUebSAOFcRHQa,OGDERAFHQCCC..aDCDJABE..TEFAKEBDZGEGBHBDEEFC.hAAAGABGLCHBIAHGhAAAeHAAAIGEHAEH.hABAYDAD.NIDFdCGDCAEHDEEH....hAHA......hAIA...,1,-6,-17,11
JWcOLTYXRBVZPKGDFeSfIdMAUgCHaEQbN,CHGHaCFB..QAFG..NBEBJHCGOEEDLCAC..hAAAYEAHBHGAZECC.hAAAKCGHFBBASEAHhABAdDDAAIBAUDGGEABA..cBAC..XEGGhAEA....hAFA...,1,-26,-31,5
bDJRIcfXWEHUSCYdQaPLOMKNTGFZVeAgB,BFAEDAFBRDAC...IDEE..XCGCHGACCCAH.dGGBaFHBOAAFhAAA.KAGBNAGAFAAEhAAAeGAE..AFCAJHECfACHhACA.EFEDYACBLHEGMEAChAEA......hAFA...,2,-37,-23,14
NJBdOUZXRVGPCYaTHLbEcFfSeKDQWgMAI,JDAFOBCDZECE.RBFHGECB..CBAD.aCAGLBDC.ECHFfFAEhAAA.SCHHhABAeGDADCEBQEGFhAAAgGGCAAIDBHAEdHDBXAEBhACA......hADA...,2,-38,-18,20
HSJOWQNZUEAKgBeLaRPfVYXbTIDdFMGCc,KEBBBDCDeEFHLHCERADD...VEGFXGCA..IBFGhAAADDABMAGFGEAChABACCCB.SACEhAFAOBHF.QEDDZAAHAEFFaHBCfHGHhACATBCCdAHE......hADA...,2,-30,-8,22
OIBSZDAbMEFdKgcLXJHQUCWfVaePGNYTR,EEECFECGKCABLBBAHABGUGFFCFGC..VGAEeBHB.GCDH.hAAA.NIEHRDAABFAB.SGBHhAAAAHGAMDIHdAFBXEGGhABAJCFE.fAED..PABGhAIA....hBAA...,2,-19,-13,6
FdfRUTPINKXSZDCOVcHbAGgMBYEWaQLeJ,GADAMFAEBAHEEGGHQFABLBAAFDDFdABD.RCAG.UGEE..hAAAIEFHKADCZBGFDGDHhABAVFDB..HBEDADFCWAHDhAAAaHGA..eFFE.fGAG.hACA......hAFA...,2,-15,-10,5
YEfAaeHcZVWXIbLFCGRUTMNQdSOKDgBPJ,eFBBHFCAZABH.XDAGbCDC..CHAGGAAARBDEMIDG.dAFHOFHHhAAAKFFFDFEBBHBF.JAHDhADAfGHGAEFD.hAEA..aDHBWEFHIADB....hAAA......hACA...,2,-28,-14,14
AWbaPEJecNTGBKYVfUHOdIRSDLXMQZCFg,aGAGEGDG..eEAB..NCFA.TACHBEGGKACH..fCCGhAAAHGCAOEBEICGHhABASABDDCEHMIFGCGHCFAEEhAAAWFFE..PBHHcCAH...YHAGhACA.dAGFXCAChACA,2,-23,-23,0
UFSYKIRPdLDVZTGWAbHCBMafXeQJNgOEc,HBBGBGDEaGGCXFEH.eCGBQCGGJHBC.ODAHUAFDSDAEhAAAKGAHRCCGLFCFhAAAZEBE.TBAFAABGCHHCNEAA.hADAEBEA.FFGA.YABC....hAFA......hAGA...,1,-8,-13,5
SUZeJHCXRVTBPYIgEMcbKFGOdLQADaNfW,aEGH..fDEFUAEFZBCFHCEDCFFG.RBAFBFACIAFB.EABFhAAAMIBAKEHFGGCBhABAdAHGAFIBDHEASDBFhADA.JADB.TBGA...YHAAhAHAcFADFDHB...hAIA...,2,-21,-17,4
HONUMSYBDQXLTVgCbEdFcPAJWZeGKRafI,ZDEFeFDGKAGHRCGF...aADGHBDG.OCAEUCBH.MICCBDHFDAABLFBFhAAA..gEAEhABACHGEEGCC.dHGFhACAFABFAGBH..WBBCIFHESAHB.hAGA......hAIA...,2,-39,-8,31
XdEQcaBeIAbGRWPVgNMJUCDHSZKOfTFYL,GGCHRFAH..VADGMDCCUEDHDBDCSACDZGEA.KFAFODAGhAAAFHGE.LDHHhABAdDGDQECFBBBAIHCHhACAAAEE..WBAHgAGHCAAF.hADA.fFGHhAGA.XBFA.,1,-17,-20,3
SAJReMcZfbLBXHFVWQYNUDKaOITEdGCPg,RCDCMCAGZFBGLCAFBADHFCHF...QAGDUGCBKDDH.aCCH.ODHFhAAAECFDGDAA.hABACHGA.PHFA.ACHFJABEhAFAfFFE.XAGC..hAAA......hABA...,1,-10,-38,28
cXRObVCBgMYJdfLAGEeHPUaNZSKTDIFQW,GCABHEFFaCCDSDEAKAGH.DIFGIABEFFGH..QAFAhAAAXGCGOHDEhAAAbEAGCFHB.BFAB.MBIBhADAJABGLBHHAAEEEFCEeBEFNIABTFDD.hAGA......hAIA...,1,-2,-19,17
MUdZbFNcJLIBVPKTReGfSWgCHYOQEXADa,DDGCUAAFdGBCFGBE..JBCBBEAE.KAGHREGF..GECD..SGGDhABACCAHHAEHQGEHhAAAEDCH.ABBC.MCIBhADA.ZFDB.bBDBNEAC.....cDFFhAEA.....hABA...,1,-30,-33,3
cHWTEBLdZDPCfbNKXOeFAQaMRSVgGYIUJ,MCFESGEHGDAEUBADHEFD.EDCGLCFGDAAH.CEEG.fBBFhABAKGBEeEACAHIDaFDHRAEG.hAAA....YFHBhACAcEGD.BAEF.dAGH.ZCEA...hABA......hACA...,1,6,-33,39
UDLVMdNgfEbHWJQcRYGTOePBFAXSKCZIa,SDDEZCCBUGBDDHFCLGAC.MIDAdBAC....fAEFhAAAEABGHAFFWBBDhAAAQEGERFFG.TCEBhABAPCHD.AHBDCGEG.IAEAaCBFNEEA...hACA.JAHD....hADA...,1,-8,-28,20
fUaIbSFVHDEZJKAWNOgCGMXTdYeQLPcBR,OEDBCDBAGBDF..MAFGdGFFeHAELCHFBFAHUBBE.aBEFIACHhAAA.SDGEhABAHGFCDEECEGBHZEEGAGIBhAEANAAA...XDDGTEAB.PAFA.hABA......hACA...,2,-21,-14,7
YdGReFWAQJXZNHfbKVUOCgMTDIBSacLEP,JHBCZFBHHBCA.KHDEUEEACEFB.MHFADBGCBADB..aBFDEEDDdGAGhAAA.RBBG.FBAD.AIFC.QDAHhABA.XADEhACAfFGF.bCEA..gDGHhADASGAD...hAEA...,1,-26,-33,7
CUFHEbJOLVTaIYBQeNKMAWfXGgdcPZSDR,XFDBdGCGZGEGRACG.FFHBHCCD..EAFCOBGFLCFA.VBBBhAAATEAF..IADEhABABHAHeAAFMEDEAGAFfFEFhAAAgFABcGFHDIFE.CHCA..hACA......hAEA...,1,-7,-20,13
gVRPFSdTIDEQaUXOCHKJAcNbWZBfLeMYG,...bBCHBBGA..LAGHeAEDMEHFGFEDRDAAFHDCSHFGhAAAdEEHDIAG.aBEBOACDhAAAHGBAJABB.cFABhABANGAF.ZDFG..fBAF..hABA.YAFE.hADA...,2,-31,-2,29
OTIGdQMJLYRZCWBDSAVeKNXPgfcbUaHFE,VFFEKFCG..XGEE..gAGC..fFAGhAAAbABCUFAHFHDGTEEFhABAdDECMACGLDAChACAZDCFCBEADCFEACCG.PBBC.aDHD.EAHB.IEBFhADA...hAAA...,1,-15,-16,1
IUTVJWFPAHLGgBYRSdNcEfOCXMabZDeKQ,LEBEBFHBSDGEdAFAEDGG...OCDHMBBEZFDEDEGFeBAFhAAAKBHH.UFADJCAAFHGGAICEHBEAhABA.....hAAAYHEENDAGCFHC..aFBDIFED.hABAWABH....hADA...,1,-20,-33,13
KWJgePCVSZDMEGTdOfRAHcLINYFbUaXQB,HBAALGBG..NGDDFAECaCBCBABH.JFHFeCHF.CCFFSEDGhAAAMAIHGADHdHAHRCFBACCChAAA..IHHFhABAUEDDXDACQDAB.KAGE..WHAGhABA......hADA...,1,-13,-23,10
JAFPIcfaNLGYCQdXgVKHbeWTODMBUESRZ,FFBB..PDDA..ICBDaDAFGGEHQEECdAGCXECHhAAAKHCEeCEA.OFHFhAAAMACDBHBHEADBSBAChABAREFGABHAfAEENEAGCGGG.....hACA......hAEA...,2,-27,-12,15
QcUPGTfdVWKIHFgZSLBEYXOMARbNeCDaJ,REDFeEEADBEH.QABAUAAE.GEAEdGHAKDAGIHHF.HCDGhAAAFFAHZDFCSAEChABABHDD.EGCA.OAHDhAHAAFGACCGE.cDBF.fFGF.hADA.WBFCYHDGhBAAMCDH...,2,-47,1,48
QFgGZfKJDTPHBdbELUVecCaWYMRXIASNO,SECBOFCEFBHDZEAFKEEC..DEIFHABFBBEGdGGELBAG.hAAAeEAHCEHAaDFB..MFGHhAAAIHEBQCGFhABAfAFFJHBEPAFAbADF.....hABA......hAIA...,1,-19,-25,6
ZBeCGWAVDIYMSaQgKdUNJPFOHTRbXELfc,VEBEDECBMHDG..QAGFKACB.dBCCUEEH.JAEHPHAEhAAAHAGH.RAEB..EGFALCADhAAA.fGAEhABABEGCCBAHAHDAIHHGaCCC..NEIC..hABA.ODAB..hACA...,1,-22,-26,4
SeULWFIdVYbZaJgNBcOPQECXHKMTAGDfR,DEGHRDDEeDBHLEBH.FAEAIBDD.dGDHbAAAZCGB.JAAGBAHFhAAA.OBDDEHGACAFH.hAAAKGDGAIAC...SGHDhABA.WDFFaGCH.....NCIA.hACA......hBIA...,2,-38,-27,11
NWEYeZDKIAOHLXFBcgMRaTQPCVfJGSdUb,HBFDLCCDFFDDBEAHMAABRBECQAAG.CCHH.JDADGCAHhACAUEEB....NHBD.EHFChADAeHEAKAECIHAChAHA.AIHAOFFGXCGEcEBDaHAC..hAIA......hBAA...,1,-11,-25,14
JFVTMDGQOAPISBXNEKefRHbYgdCZLaUcW,SFAHBFGCEEDFKGBGRBAHHFDD....bCBGgAFBhAAA.ZCEFLBGHhAAAaGGE.cFGEJABATDCChAEAMIECDGAD.QADB.ABABICFGhABANAIE.eEAAhACA.fBBBCFHC,1,-12,-14,2
cRgKfVIMdCBHTNYQLUXbJAFGZSEPaOeWD,GABBZCCFEFAG.OAEADBCA.RFFD.KGEB..VECEMADABCGHHDGF.hAAA.TCAAQCEFhAAALBHBXGGChABAABAHFFHFSCEBaHCCeAHDgCAEfGCEhABA......hACA...,2,-13,-1,12
WbSVMBLNfARPOaHQcGdTEFZIgDXUJeYKC,OCHBHFECGAEGdFEDFFBFZBGD.DBAHUABEeFHH.KBCDCAHA...SGAGhAAABAFDLHAGhAAAAEBHaGDH.QCEDhAEA.EFHHIEDB..gDBEhAGA....hAHA...,2,-28,-16,12
HOaQXRWcZMABLYbUdgJPeTCSDINVGfKFE,LCDHUBEHdBAD.JDHBeFBB..SBFDDFHF..IDCHhAAANAAEGGEF.FDBEEDHBhABAOHACQGEBhACAXAGB..WDAFcFABAIACBBHH..hADAYBBEPDFBCAHFfFEFhABA,1,-15,-36,21
ILbKCPdVGfaSUcXOJDBAWZeHgTYRNQFEM,ZAEBHCBC.TFEGRDECQGFHFEHH.MEAEbFAA...KADFCEEFVAEDhAAA..fCAHhAAASAHBUGCFOHDChABABBGGAHHEeABANBIEIABHdCAC..aBHHcFGFhAEA....hAHA...,2,-26,12,38
UeFVWdBSQXNIfRbOTJDHMLCcYKGaAEPgZ,EAGCZFDEeCAGFFCC.dBGGBEEE..SDAGXFAD...IHFDhAAARCEGOACAJFAEDBIBhAAAHDEACBBA.KBHHaGGEAHAF.hABA.PBBG........hACA......hADA...,2,-40,-18,22
eJSMXKUZEgIHLCdcOTYDVafGFQbWNABRP,RFDCeDHDMFHDKGGF.UCCCEDEG..HACBLHCACAFD.OBAHDGIDaAGDhAAAFBFE..QCAChABA..WFAChAAAAEEBBHDDJFDG.SGAH.XCGEhACA..IHABhABATEBB..,1,-18,-31,13
gLFWPYEAbNaGRSQMdeBVOIJUTDZXHfKCc,aBGAREBCMBCBBCFG..OGBEUDAAZEFH.HGAGCADELAHF.hAAAFGGHPACCADDA.GDDAhABASAFHdCCAIFHDhACAJCADDFGAXEEBKHEG...cAABhAAA....hAFA...,1,-8,-34,26
eBJDaLRHOEAKMNXPTdFcYWSIbUVfgGQZC,KFDEXFGGdCCDFBAB......YDAHSCGD.UGBDhAAAgDDEZAFCeEAFhABADBBGLHFEOCFGADHDhAAAMGFENHBF....PAFEWDCA.IHHDhABA.fFDDhACACBDF,1,-33,-38,5
JYfPGUSQeMdCDHLOgNXBTAVIWERabFcZK,VEAAEAGERGDA...FAGAKCFG...JCAA..PCDGGEBBSFEHhAAAMFAH.dBACDABChAAALEECOEGDXAEChAFAADIFIAEHaCHF....cGGAhABA.fCCEhACA.eGBA.,1,-14,-22,8
LCHgDPdGSWObQTKJeZaAVRFIEXYfNBcUM,RFDBFDEEEBAD..XCCB..fCFDBAFAMFFGCFGFDAAAdCHGSGGGhAAAODAETAGGhADAKCBDZFAA.AHBF.IGAHhAEA.NDIG.LABCPBBAbFBFeFCEhAFAaGHH...cDDFhAFA..,1,-7,-26,19
ZBNEGROHQLKScITXeAVDJYgPfUMaWFdCb,DEGAJCCF.....PFDGUFEAMACA.FBFEdBGE.CBEGBCCEhAAAEBDB.RDAD.HDGDKHFA.SAADhABA.TFBChAGAABIDgGAG.aABC...WAFChACANIDH.....hAHAOFHF.,2,-36,-22,14
CDFYSJgfeBUcILGMXVPbTNARHQZOaWKdE,QBDGaEAG.KFBGEDGGFFEASGAD.JBAAgDFEhAAABEECUFBELHCEhABAMEGF.VAGH.PDAChACANICDAIHGRADDZCACdFAGCHHBDFFFfBBD.hAAA.cBGF..hABA...,1,-1,-21,20
BTRQVPAEHLOIMgJWDbKUecFYSfNCaGXdZ,LBFAMAAE.JDFGDAED.KCDFeCBAFDBD...SABDhAAACFGDGGCBdCGGZGBEBEAE.hAFATFGAQGAEhAGAAGAHEGFDOAFGIBBFgEBH..hACAWHFA.bAFA..hAHA...,1,-10,-35,25
WIQfgFXPDASeMBNOGUZHcaKdCTbRLYEJV,MEFDBHGCGFADUABHHGBGKBAEdDEH..CBEERCDHEEHD...JBDGIAGChAAA.QEGBhACAfDAAFFAGDDDFhAAAAAIBSCGGeHCAOAHF..aGHD..hAEA......hAFA...,1,-18,-28,10
FKEVMGWOCDJTcBAQXeSLRaHZNgIfPYdUb,XEEDSHECLAAFHCAEZDFF..IFBCPCHDdCEGFEDBKAEChACAEACCGEBD.hADACBGDDIBAJCCEBBHFAIHEeAFEhAAANIAB....fEHG.bGEA.hABAMHAA....hAHA.OBBG.,2,-11,2,13
JOWDMHUSbQKTVFYPCfeLEZaAcGXRNIgdB,GCDDREBC..NAFA.dAGCBHHEOEHD.MBCESBBBKHBAFECE.hAAACFFC.LABDZGAAAGEB.hAAAXGFC.IEAAhADAWADDHDGD.UBGH....hABA......hACA...,1,-18,-33,15
BJOPLTYXECQaDIMFgAURfKHdVNSZWcebG,RBAEKAGGdCFA..SBDAZFAHeFDEBCEGODEELHFG..hAAAYFDCEDBD.QBAFhAAADABEMDIBFAGEhAEAAGADfEBC.NEIAbGCC....hABA......hACA...,1,-23,-32,9
PNMbJYFSQKCLZBdWgHVADeUfOaTXGcRIE,UGBEOEBA..aAAHTBBBGBEF.RDAG.EBFA..MIFAJFBFFFFChAAAKGADZEFCBABF.dHEFHFDBhABADDID.XADChACA.IGGCNDACSBDHCDDE....hADAWAFEAGDCcCFD.hAEA...,1,-10,-23,13
ZTBHQLfFNPRaDXKGbgAMWdUSYCIOJEVec,dDBGUCAHCGFE.OEDA..EGCFeGBAZAEGBEDHLAACFHEC.RAFADIDChAEAKCGG.....gGGAhAFAABBH.MCIBhAGASCCB.IGABcBEC.TEGHhAAA.QCEEhABA.,2,-47,-16,31
PKXeMbRVYdaBOTCgDWGJUAQLSHIcEfNFZ,LGAAHAFHEDBDFHFCKEDGeCBBRDEG..dBCGaCGDBFAC.CHCEDAEDJAAEQFGAhAAA.hAAASCCEfEDEhABAZAFCMEIB.YAHBgGDH..hAEA......hAGA...,2,-23,-20,3
ALESNMDfBeCdcTIKGORbHPXgYaZUQFWJV,EGBDMEBGBCEBdEFC....TGADKBBFOFHBRCFGHADD..XDCAhAAAaHFAQBBHhAAA.FHCEWAFBAABHNCACDFCChACAeABG.CFFA..IAHC...bDFEhADA.PHDA.YEAAhAEA,2,-25,-14,11
QJXKcUMfVYeDZdRTWCHOGEgbPABSaILFN,SABGLEFAFCBCQCEAKHDE.MFAGVBEG..DHCEdEDGhAAARDGHCBHHOEAH.EGGFhABAPCAEBADG.IAGEhAAA...NIABXGGAfHBBeECEhACA.....hACA...,1,-9,-36,27
dBZfDIReHgFCGQXNYPAOUTbMKcELJVaWS,OAEBUBABMHDAKHAELAAA..aGAFSEHDdEEHZAFDDGGEhAAAeAFGFEBE.GCCAhABA.QFEDhACANAIC.ACGAbCFEEBDE..WHCGIHHF..hAHA......hAIA...,1,-13,-32,19
XEPfaYGVACQIRSZBKeWOHbFMLdcDJgUNT,QAADSGGGBHABeFEGHAFGFEACLCEEDCEFJGCA..UDBBhAAAXACBEGAD.aFDFVCFDhACAAIDA..RAADZDDAKGHH.hADAODHFMCIFcADB..gAGEhAAA....hAFA...,1,7,-22,29
ABaDdcRMKUfNSYOVZFJWLIeHEQPGTCgXb,BHAGDGHHdAGCRDDBKGFCUEGH....SAFFOCAGZEBAFCHDLDEEhAAAHGBA..EDAHQADFhABAGAADCDFB.XFEHhACAAFHGaAGD.MICG..fECEhAAA..NEAE...hAEA...,1,-17,-26,9
GAEDFVNYbcTBeUOZaLRISPdMfWgJHKXCQ,EDFEFCBH....VAGFNBDA......bGAETDFCBAGEUAAHhABAaABFRFDG...IGHHhADAdFBEMFAF.fGHAhAAAgFEGKADGCCEFABEGDDDFeEEG...hADA......hAFA...,1,-22,-26,4
MKbCRIBgdUYGAEHFQaOWeDTXPLZSJcNVf,FGCDQGGBOFAH.DGBH....TFFGLAHFZBEASDEGhAAAJFCBVBDF.MDCBhABAKCABCACEBCAEdFEG...hAAA..YFHBAFBGEABBaAFFeDDD.XABAhACANEAC.fHEDhAEA.,2,-29,-17,12
YDFUHNALQaBKOIdEbVWRcZPfMTJegSXCG,aEECKEBDOFGH..EDHB..VABERCCHZFBC.MADCJFCG.SHGEhAAACAFD.DICEHCEChAAAABEBBCFAdAHCbGAC.hABA.PBBH.fAHEeFHB..hACA......hAIA...,2,-30,-22,8
XbQFDCBfUKHGIVcadWZSPTAgOeNJEMLRY,eDBDJAFALGEARDGH..XGDHFABEDCCG.BEEA.KAHFHDDAhAAAGABGVEABdGAE.SADGhAAAAICCOBAHMCHFhABAQGGB.CAFEIDDHaFCD..hABA......hAEA...,1,-18,-22,4
EbDXFJMPOeBYWNTGALcRHZKfSdUQgIVCa,RBFAKHDCdHGHQEFF..gBBECADEEHGA.DHDEFDBDMBDEhAAAOBGBBEFE..NCIG.hAAAAGADHEGBZDDD.fEDChABAICAHaFACXEAEeHAE....hACATABC...hADA...,2,-29,-11,18
GdKXcSWJDZILQRbAMYTEgVaHOeUfPNBCF,TCDBVBEA..OEEBUEBD....NDAA.CDBHdHFF.KFGEXFFFhAAA..SGAChAAADIEEIBAFRACFAABEMIAChAEAEBHBaGCC.fCBFBDHC...hAFA....FFHD.hAGA...,1,-21,-35,14
DSEgdAWcFXQRZGeMLTPbBNKaVCOfHUYIJ,FCDDRCAEZFDCMDCBLHBC..TBGDBEAFKBBECEFC.HCFGUGDAJEEAhAAADEAH...SGAHhAAAEHGAAABC.XADGhABA..QAGDeABFPHFGaGAB.hADAODHF...hAEA...,1,-17,-22,5
RXMeECdHYQSDOZfAVJaUIbFKTPWGgBLcN,aBFDUDFG.FFCHKFAG....TDCEGFEBLHEANAIC.MBBBhAAAEBDCdHDHHADGQABChAAADDIH.ODAChADAAAHAIBHC..WCHDBGAG..cDDFhAEA..XABBhAEACHHB,2,-30,-30,0
dOPRDHMTQAKYegWbNEZIJXfcLaVFCSGUB,KADEeAFD....bCDBEGFF.ZEFG.JHBGXCAFLCADVGBGhAAAFBDDGCBE.dAGDhAAARFFGHDFGMEEGAFDFgBFHhABA.WAHBIABGaFBG.SHGAhADABABHDGAB...hAGA...,2,-15,-6,9
FJVXUODKMIWBPCHYcfZRAdbeLgEQSaNGT,dFBCLFCCEEEA.SGGCaCAD.GBCFFGFHJCEAUBAG.OHBChAAAMCDHBACBHDECfEAGhABAABBC.hAAA.gEGCQAGBTAGEDACA.WFADhABAYHFG..hAFA...,2,-30,-9,21
AUPIMHgYQfaEFBWCNZVSXdJKcOLGTbeRD,UGBGMGDCHADEQAGHaHAA.FDCGBHGD.CDCAZDABXEGH.hAAAdAAAKCGALAFDhACA.bEACDACB.IBAChABAgGEDfEDH.EEHF.WAFEhADASADH.hBHA...,1,-8,-31,23
YZTdbPDWVHUBXJgQFcCMNARaELKGefISO,RDECEBBHLCCBKDDE.GBAAeAFD..SEGEOGFCZAEEdGGCDAIFhAAAHGAGBCHDJEAGFGCCCAGGACAFhAAA..aGAD..fFEGhABAIACF........hACA......hADA...,1,-20,-26,6
KODbGRFUaJEZcgBTQfdANVYeSWMHILCXP,VCBGSCGA.HDBHCBGAKEGGDDFD.GGCDRGDA.FAGBJEAHEADGZFBBhAAABFGG..QBEAhABAdAAFAHIBeFAFMBBEhACAXBBG.........hADA......hAEA...,2,-33,-10,23
WYXKMCdNaVSLHDBefQREcOJZTIbFUGgAP,...PFAGXBCCKBCF.dEGE.aAECLHAGDHAGBDAHQGFChAAAECGG.JDDEZGFAICHChABAFFAAGDDCAAGAMBBBhACANICD.HADEeAAFfEGG..hADAcAGF...hAFA...,1,-10,-17,7
SeDQHYAZNTbUcafGCXVRBdEFgJMLWOIKP,TBABUGFF..aAAECBED..REFB.BGDG.dADEEAGBFDFAMDIB.LFAEhAAAOFBBKCCFeHDEhABAHAFAAEAEZCDE.NIAB..hAAA.fEDB...XEGAhABA.....hACA...,1,-19,-26,7
AVNSdEPcIGUXTLZeKYWDHfBJCaQFgRObM,SAHFdDHGEEAD....PHCCGDEHUBDCXDAELEFBhAAAeGAEKCBCDBDDBABEhADAJADCQBAChAAAFAGBOFCAAGIFNIDDTFGG.......hAEA......hAFA...,1,-8,-23,15
MEDXWJfUZOVQFTAHbcNRdCKLYgGIPBaeS,HAFF..bAFENAAF.CDDFLCGFGBDCBHHFeFAAMCCB.DIAEXACAhAAA.JHDCfGFChAFA.OBHDhAHAFDAGAFEHdGHAKEGGgFBAaBACSHAChABAEFEHWBBF...hACA...,1,-8,-18,10
ENBfUOcFbMGSDLQeJXWAgTCZPYRdIKaVH,TCCCCHGFZCBC..RBEE.dAHAKEAFHCFE.EFHFBADDOABAFFDE.MFFHhAAAGGAFDBBH..eHBEhAFA.XECEAHIH.hAAAgAEAIFHHaABF...NAIC..hBAA......hBCA..fDFE,1,-6,-38,32
ALVFZCWXPJIbcdMUEROTYeHQafKgDGSNB,VBBHFHDCCCGD.....XGACJFAE....ICDFhAAAbFBEMIEARFFH...OFFAhAAAeADAHCEBaEBEfBEGhABADACASHAEADHHLAFCPBBHdGGH.hABA......hAHA...,1,-3,-34,31
aPZdTMKgCJQWHUXRcIeGYESVbBDNLAfFO,FAEEaEEEZCAEdCAGKGFG..CCFE...JDDBQAAC.HECFhACAXAGH.RABD.eAGBhADA.EEBF.SBEFhAEABFEHDECBADHHOCHDMIFC.gGGHhAFA...WHAGhAHA...,2,-50,-19,31
cBDNHXAfPWCIEMRKFUQLeObVdaYTSJGZg,...fFFDPCGHCGBF.MBAB.KCFFUGGELFHBeFBEOBDAhAAAdBCATGCB.GEADhAAAgCBFBAHCDGBDhABANACDHFEBABBF.IBAHEGEE.FDEB..hABA......hAHA...,2,-18,-6,12
DOfbCQVYgZFUMRLeAJINBHXWcdKETaGPS,JCDDBFGCHFEF..XAFBdCHAKCFH.aECEGEAA.DADCbCEE.hAAA.CABB...QACFhAAA.gGEDhABAUGGGMBDCLDADeBBBIAHHhAGANEIEECCBSHBC.hBAA...,2,-24,-14,10
CWcHgGBfDLVQKYUAOFMPSeTaJNRXZEbdI,FFGBMCEHeBAG..aGCEJCFERAAG..ZBFFEFEBdFAD...CFFDHDAEhAAABHBEDGAGLAHHKECBABFC.hAAASHGC.hABANACH.IEAG.gACE.hBEAfDDD.hBHA...,2,-42,-17,25
CBTVIJOGFefgZXaSMWdKPEDLARcHYbNQU,HFBH..NAACQFAGCAGATEFA..JHEEFHCC.eFFDZAEHSBCBhAAAMDCEdDGFEFCGAEDGRCADhABA....YBCEhABABGADIDHCOEHBgAGEhACA.WBBDDAID...hACA...,2,-25,-5,20
gFVTDCNeZdfYRJQXKUMBGIcEASLbPHWaO,SCCALFHHHBFCOAGBFGBEDIBA.eCCGdBAFRFEB.QFBBhAAAXCAH.MFAHIADDhAAAAHIB..WDAGhABAVFEECEHG...fFAF.KAFEBHCHhACA.EBHFaBAG.NEEF.hABA...,1,-15,-16,1
EHWZRXATVKgcOGCaUSNJIYMedQPDbfBFL,TGEDKFGBOBBB.GADCUCCD..JFBDMBFCdAAD..DDGCBHEGhAAALADAEDHBZGACAEGH..hABA...gCFFhACACAHBSFAFNFADeFFD..bFCH.HEGFhABA......hAEA...,2,-25,-9,16
CHADPKFIROfUJNEYBZLVQgeWSbTGaMXcd,KCDBFDAEOFABUABH..EFHBBBHE.LFCEQFEH.eBFEhAAASDGDGEAAaDFAhACAMADFdFCECHCDDGGC.hAEA..IHED.fBFBhAAANIEB......hABA...,1,-12,-48,36
NMZBaYfAcEWVDHUgPRLQOCSXTFKIeGdJb,EGEHVBEGHBAA.UAEDRABGLHFE.QEAGCDGESFCAhAAAFHBEKFGGeEEG.dFAAJCCHhAAAMIAGBEFGaGGCABABDEEBhABA..ODAE..XDGE.hABAIAHB..hADA...,1,-8,-22,14
DgbaeANTORIHfMdLQVPUFYJEcZWSGBKXC,TFEGRFACHFFFMAAF.LBBDQBFEUAFEFDBB.JACHZFDDSHFAhAAAKDDACDHA.DAEBhABAaCCGAICAODHD.hABAIEDE.dFAD...YHAEhADAEHBA.....hACA...,1,-9,-18,9
WeSJbZUVNcDagIEHTFGPOLRdBKQYCAXMf,XEFAMFBC..eHAESAFAJABEZAGB.UDCA..NAAE.DBCGhAAA.aGAEEGCGHCAFFGFE.hABAOGDCdCEGKAFBCBAFACID.hAFA...fEGDWCCE..cGGEhABAICCB...hACA...,2,-29,-19,10
ATDKSdFJUVWQLcNaZXbReOEfIYMPBCHgG,DEHFdFFGJFCFUCCG...QGCALEEEaCBBZCFD..RFAF.EACD.hAAA...IADEhABAPAFCBAAHCABA..hAAAgGGGAIGCKCECSFADFAGG.cGGFhADANAFG.....hBAA...,1,-28,-31,3
XGfKbVJaIFRTCcSLBdAHPYegMUWZDENQO,HBFBeFFBUGBBZFFEDHBE.ECABQAFG.GAAFfBCChAAAKDDBJDFEaECA.FABGTDAFhAAACFAALAFCBFHBAIHAhABA..YHEG.MAEF...hADA......hAEA...,1,-5,-21,16
FJNWXDSbGcVaUeMRLHYOZdEfBKPgATQCI,CHAGJFEA....XBBBDGCBGDAG..aECFeHFGLBFEhAAAHDCEOAHBECADBHDCKAAChADAAIFAQFFDhABAFEGA.NEEB.SAEH.cGDCMAFE.hACA......hADA...,2,-30,-20,10
IEUZYCNTBbQDOFWfRgGPSJeKcdLHMXaVA,UEBGCABEBBECQAEG.FFFHREFEGDBA.JBHBKDFBLHAAhAAAMIDCaABG.AHIBZAGFhAAA..NEEA.DEHBODDAhADA..fBCA.SFDBhAIAcAFEXGGAhAEA.EFAB.,1,-21,-38,17
eZFTLdKXSOGAVCHBRPIgYEUbMcDWJQfNa,VDFBBBCDREDG.....IHHAEHGEUCCF.MAHHDABAJAGHQGABhAAA.aACEeAEFhAAAZCAF.FEAFLFDFhABAXDBBSAFF.AAIBCFHAgGDDhAEA.YCHBhAHA..,1,-13,-32,19
HDRcBOMPZKeVNLCIfGUYbXaFWQAgdJSET,dCBGEAHHDDGCBFDG.MAFFZEAFKECC..eHCALGEA.CCCGGACDhAAAUBGAXEFAhAAA.aACAFEFE.AGCASHAGhABATGADHCDB.cGGE...hACA......hADA...,1,-16,-32,16
eOUZCYcgFNWALXSfKJbdQVMTEDIPaHGBR,LGBAXBFCKDCBJFHB..dFDF..MIAAEADH.DEIH..aDAEHAAEhAAABBFHeGFGZAABCAHBgEAGhACA..hADA.FHECWDDAAHAAfDGG...hAAA......hADA...,2,-42,-15,27
GNUSWReTgcZMJIEaHXYLBAQPfFKbDOCdV,QBAEFCCBKHFE.DGFHCEFEGFBBUDGBREDF...eADC..TADHhAAAZCFAJCABEGHF.aFADhABA.HAGHXAGAhAAABFCFAGGG..fHAFbDAC.OHCEhABANIAHSDDE..hACA...,1,-9,-21,12
HBeIPgAMUECVQFbdDYSfLKWROGXJcNZTa,MDDFCCECFCBE.DAEB....SFGAKBADOFFCGGDH.JAEGhAAAZCFEHCFDIHBGhAAAAEAAEBAH.QAGGhABA.bGEGYEAG.fHBDhABAWDBDXBBFNAIA.BEEDhACA...,2,-33,-15,18
NeCTEJPMbgBaDRdXFZIWKfQLVUcASOYGH,SDDDGDGCHBEECCFA.TAAF.EHBCMEAFBCADDGFE.RCADFHEChAAAZEEDKEDHLBHDUEAAAAHEhAAAOABF..eAFGhACAJFCF...........hABA......hADA...,2,-34,-3,31
deWIYAOBFgHENCbRcTaVSQfGKMJPZDULX,OFDBBDECFBAEHBCB.CAFG.RFFC..aDBBQAAG.KGFAPHAChAAADGCDLEFChACA.eAHHIBGGhABAADAGEBEB.NDAA.bEAF..TGDDfFGBJDFE.hACA.XDCH.hADA...,1,-13,-28,15
ESdfXUcIbDAOKeJRBGTLYaCWFNVPZMQHg,eGCCRGEAGACFLAGBCCCH.FABG..VDAHZEDAMBFBHGAGSFFEhAAAdEAE.XAGHhABAcCCBDDID.AAIHKGHDhAAABFDE.aDEENICF........hACA......hADA...,2,-19,-17,2
GBOMEAeJWXKFLbUDVTaQSdHgfPCZYNRcI,eGACXCBCKDAFFCBCLFFH..DCFFaBFAdFGCHCEG.PFAEhAAACDHCZECARGCA..IHHBhABAOBFA.MAFAABAH.hAAAWDHH...UACA.....hABA......hACA...,2,-39,-2,37
BSYAOWcdHVJgKNDfXLTUMeCZFabGERPIQ,OFHBdGEFHDGB.JEAAKHEE.DDECLBDB.UBAAMAHDCAHAZGAChAAAFEBGGACD.EAADhABAIHHCQGAEhACABEFFSEEAAIEG.WDAFcAFGNAIA.hADA...fGCHhAFA.,2,-28,-22,6
TBcfKSRaJWNVQXIELCdeODYAHMFgZUPGb,FDBCZFBEGCEDBHACKBFCSBCF.RFFA.aGEB..JEAGVEFEhAAAQAEC.EHBAhAAACBACOFACAABF.HBCAhABAMIEC...gAGB..hACA..bCFAfEEDhADA.,2,-35,-18,17
ceWaIFBHNgZOTKEJPLbQDdXYSVfUGMACR,CGADeEBB..aBGDIBHHFBCB..BGCBHCDBZADDOGEEKEEB.hAAAEAEGLEGBDFDBXAADhAAASBAB.hACA.fGAAMEIDABFB.cEGHNIDF..hADAJDAF.....hAGA...,2,-30,-25,5
STfIbDOaRAKYBLVeZFPdHQCEWgUMcJGNX,BCDGVABG.FECAHAFD.CHFD.EABE.UBGFMDFDGDAE..NDEA.hAAASEGG.hABA.IEAGDAAF.hADAaDHDACCBKGGF.eAEDPECHdHDB.QGGBhAEA...WHAGhAFA..,2,-32,-14,18
aGZbKVPOYdXDTIHQUBLfAWScFCJMNeREg,SACBFGEDCHCG.MDDCeBGB.RDAD.aFEFZDCB..KECDODHDhAAAdHABDBEAHABDUEGABHGFhABAAEAF..JAADEEEG..hADA.gADHbBEE......hAGA......hAHA...,2,-29,-18,11
HDdcYKWSTUaRBJGXgFbQNVCLOeMIPZEAf,DFBAdFBCKCDG..SBEDUGEERDEC.BAEB.GCGGXBBChAAAFACBQFEFhAAA.CHHELHBEhABAOACGMCIDIDCHEGHHAAGDfGCD.hAGA.cAGGWBADaHAChABA...,1,-23,-39,16
FVcHOWbZDMgXJIEUQKPfTdSGARLNYeBCa,RCFALFAEeGAGBGFCFHFCHDDC.OBCGZBCHMFAC..JCACUCABhAAAKAAC...fBEAhABAdAHESEHDhADAAHEHCHHF.aHBA..WFEEDEAC.....IAHHhACA...hAEA...,2,-29,-25,4
GWSCFKUDMeBZYLRTaOIPXgQAVcfbNJHEd,VFDG..fDFB.JFEAEFBHdEBBGAABCHFD.KDEADDIFhAAABCDDLAEGaAFFIEAFhAAAPBACQFABhABAAIGG.cGCBNDHESAHB.hACAMEIDeAHH..YHCAhABA,1,-22,-29,7
SHeLIYJERKCPZNTUaMBDQdFGVgXAbWOfc,ODDHSGEBLBEF..IEFHJBAGEFAH.CECDZAEG.UABHhAAABEHEDIGEFHGEVGAEhACAABHH..fDAAhAAA.HGBAeEHFYGFEKDGC.TCFFhABAaEAB.MADG..hACA...,2,-22,-19,3
gSKVYZHJTQIaMGABPUfdNbWOCFReLDXcE,BDAGUBFHdHAH..NCCB.OADF.RBAG.eFEELDAHDCIBECBBKEFDhAAAZGAE...TGEBhAAAQGGB.MEEDhABAAAGGfFBFCDGG.FABA....hAEA...cEGAhAFASDHHYDEE,1,-25,-26,1
PIOHgRTUbVXaGWFZQLcSYJKNMAEDBCedf,DBGBCDAFdGCG....PBDHOCEB.HFEEREABUGFA..XAADhAAAaAAD.FAFALCHHhAAASFBCKHDCAFCCBDHFhACAeFDCIDCG..bAEF..WEHHhADA.cBEF.hACA...,2,-29,-26,3
VaELUPYdOAMcFSbGHDgeBJRITXCQZKWfN,MCCGSDCFGBACDBGDBGAF.RGFA.XGEACCGC.ZCADKEGF.hAAA...NAHEEFCFPHBEhAAAODHDFFDA.bADFeACChABA.JAFEQEEB.WBAFfDDBhACA.aEHF.hABA...,1,-16,-24,8
ILeEaTHYDQXPAdgbOfRWNKUSCFMZcBGVJ,dEGHOBAFRAFDKBAAUGDC..FHAGZADDBFDBGBGG...IGBBhAAAEHECHBDD.QGGGhAAAAHIB..fGGHhABASABECEFHMDAFJEAG.aDCH.DAIHhACA......hADA...,1,-25,-29,4
FfaDZEHLKQgUXbYIAPOeMTWGRNBdCcVSJ,OBDHMIAAGAEBBBFDdHDFCHHC...SABFJEADFECH.DFEEZEFDhAAAHEAGKEEF..QBAAhABAUBGAXGAChAAA.IHHAAIECPCCAeEGH..WDHBhACA..NADH....hADA..fCBC,1,-14,-25,11
XQMdGFSbaUIfgNYRBTPHLWKDJVeCZAcEO,EFADXBEDdEFCGCBFFFGB...aFCCIEBB..NEIGBHEGhAAATABFLAEAhABA.DAIBJFEBCACDAHGAQBGFhAAAMDHD.bGAC..fDAEhADAgDCB.....hAFAPBAH.,1,-12,-18,6
TRDEdJCKIYAbOcHSQUFZfXgVNMeBPLGWa,ODDBHBCBQDGCZBFE.XFDDVBADMFEABAEG.GAAGhAAATGACDCFD.dGGACGGGKGEBhAAAAGCASFABhACAFAEA.NIAH..PAHFWDHHEABE....hADA......hAHA...,2,-27,5,32
OWcfXASYMdbBGEJTHgKNaZLIRCePQUDVF,SFDFMFFBdDFDBAGBECCE.HCAB.KGBCZBGHLCDFCFHAeACEUCEChAAADFAF.OFAD.hAAA.cACGAHHA..hABAbFFFTGGBaDBCIBAE....hABA......hAFA...,1,-20,-24,4
MKYFGHPOTgdRbeLVIDBWSQEcNACaXfZJU,XABHZADBMGEAFDADHFEC...OHBCdAADRAGFLFCDDDEEBEACSDBHhAAAEGDB.hABAABGGaDGEJHFGKDEG..hADAYHFG.TADEbEFAIGAChAGA..WGAC..hABA.cDDCCBCH,1,-15,-18,3
XZKAJYPCMIURFdgVGfcBHEaNDQLbOWeST,JBEBCEFHUCBD..FCGEdFBHGFEDBBAC.HBAB..EHFGDACGLDHFhAAAOEBF..eFABhAAASAGG.XADAhABAADDDMIFCIAHG..gGCAhACA.cCEDhADAaGCD.NEAE,1,-32,-46,14
FCfEJLIadNUXDgSGHKZbTVPecOMRQAWYB,BHFGFGCHCBBD.JDBBLEEA..aGAHdCFHUADDDABCGGEF.hAAAKDBHZEFA.TBADhABAeAEF.MDFEAGAA...hAAA.fAHEIDDCXGCD.hAEASHGE.hAGA...,1,-31,-35,4
ZcdIKLbaJRUWGHDSEQNCAOYPBfMgeVFXT,OACHBBCHMFEH..VDFGFAFHZDDC.dEAEIFBELHACaDBEhAAAUGGB..HFDAhABADBAD.SAGAhADAQCGAAHHAfAEAeBBD...XGAGhAEA.KHCG..hAGA...,2,-23,-23,0
SUEXOBKNIMWaQLJgdGDPVHcCfeFTRYbZA,SEFDEHEEBHBHKAEGMFHH..QECBJCBAGGCHDGAGHFADhAAACAHE.eDFERAABZBEEABECOAFGhABA..IEAFhAAAaACGgDBGdFGE......hBAA......hBBA...,1,-9,-31,22
MLVSKXFUOdEIJGDPQNTRacYeBAfZCWgHb,ZDDHCBDGHGDCLGAGKCFB.FCAFOEBEdBGB..EGFFJHACGAAD.hAAADFFC..QCABhABARCFCaEAE.eAGBBHHDhAAAAGGCfABA.WFAGMEIFSEGAhADAXAEF.IHHAhAEA.,1,-10,-33,23
CVbBIKdHfMcOgAYRaeFLPZJXQESGNWUDT,aFFHLHDAZBGD.JFHDQECDGECBUBBDDIEA....CDABBABGhAAAICEHKFABdAFAMGAGhAAAODDA.AGGE.YAEAhABAeACE.FHAAEBCH..NAIG...WHAAhAHAbDAG..fGEHhACA.,1,-19,-22,3
TQfAVdWeLbcJKEaXUNCOZBIRDgSMGPYHF,dCCDeDDELGFC.JAGHaCFA.UGGFCFCF.BCBERDEG.SEAFhAAAMBBE.GECFhABAHDAHFGDHfGAAhACAAACE.VACC.cGDHKHAAEHFC....hAAANBIE......hABA...,2,-27,-5,22
OVRHGJYNISXdMcPgeTDafULWBCKAQZEbF,QFGAZDCAEBGF.FCGEVFCCRCDB..GDBGJHEE...IBCBhAAAdACHMABB..PBAFhABATGAHDIAEaCCAfHEDhACA.WAEEBAFA.AGGAODAHhAAA.NAIA...SFDAhADA,1,-11,-27,16
fZRGVgAEWeNFcYLMPUJKXOdBHICSDTQba,eBCCFFBELBEEMAFGUCGFKCCF..dGFDHFFA.SDEBhAAADADDQDEEaHBCZDAG..hABA..RAAH.gFCChACAACIBNEAE....YEHH.XGCAhAAABHHDCEHD...hADA...,1,-10,-27,17
feLACHVRKScbIFOaXTNYDdQJPEUMBGgWZ,HDDCKFAD.SFCD..cBABFAHDOHDEaFDE.NCBB.DHEGhAAAdBACJCFH..PEHDhAAAUDBFMIDGBFAA.GAEFhABAZAFHfDBFACIDCHAA.....hACA......hADA...,1,-8,-30,22
KZFaXEgRTbJCMBLNfeGPdVQWOYHIDScUA,ZEDDXDDAREAH..JAAFBBGGLFFCeCACGEGA.dHDFQAFDhABAOAHFIACFhAAADGCDSDGGhACAAABHKHAAFEBFaAHFEAEH..gGGBCGAC.MADHhAEA.....hAEA...,2,-18,-17,1
FHIcePQLdKAbDWOZSXMfNgTRBCJaGUVYE,DIECOEEEZFDE..MDCG..NBDG.RDAFBHGBJAGH..UFAD..hAAAEGBHFCEFHABG.IAHBhAAAeHECQBAGhABAdEFBAICE.SEHHgAEBCGDEaACG.hABA......hACA...,2,-29,-22,7
gJEKACFUfGRNOcMTeYBWdDbIHZSVXaPLQ,UFGA.GEEGNBADODGFMBAB..eCAABBDADFAHHBBF.SFBDhAAAXGCGLFFFhAAAQAFDJDDHAGDDCEDEhABARAEH.TCFBdGGDIBHAaHAC.EEAG..hABA......hACA...,1,-5,-18,13
JQgMYKAVEIBNOeZfUTPCbSGRFHacLXdDW,EBDDBDHG.eBCAUGAGCDEH.GDEAHFACLCAFDFAG..JDHBMBAEhAAAAGDD...IGEEhABAZDAAPAAASEDGhACAaAHH.dGHGQGGBKHAGOAHD..hADA......hAEA...,2,-22,-16,6
UMGABDYSdVTNCOeJRcEKXHLZbgQIfFPaW,BFGHDDAGdEBA..VBGHCGEB..OAFGeCACRECF..ECCGKFADHDGBhAAALAAGZFCD.QAEChABAIBAGFBHFaGEHMIAAhACAABFB..TDED..JDDAcGGEhABAbGFE.....hAGA...,1,-14,-21,7
dRIeNPFQCHXGTMOgJSBbVDZLYAWaKcfEU,KFCCEDHBRADCeAEC.FDBEHGCE.GEABOCHBSCAABABCDDAFLGEChAAAACIBaHGE..hADAcAADdHBH.IFGAhAAANCBB.CHADXDDEMCGD....hABA...gAGHhADA.,2,-31,-11,20
cIdOaPGNXbSHgMBFfYZRVCAWUDELKQeTJ,DFGDKCBHQEAHeDCG..TFDG.JCHHIADB.hAAAaGDCPAEDGDFEXABGhACASAAHMAGDhADAFBHFZEABCEDAAIECEFHB..cGBHNIBB.HAEBhAAA.BDDF.fHGFhACA,2,-24,-8,16
SZGBCFKJbTDHfVOgWUEdaYQeIRNMcAXLP,XCFBLAACSBEBBBBB.FGBFJEAGDFHHHFDE.OADHhAAAUFECEDFAdDHCQGAEhABAeBBFRECD.NIEHAEEAPAHFhAEA..CGHCKAECfCDE..hAFA......hAGA...,1,-16,-22,6
XIdQcFUBSVKGTJbRYDaNCMEAOHfgLZWeP,OCABHDDGLFBCZEDC.eDBCXGBBICACdAHGFHFGBDGBKBEEhAAATFGH.RGBGaGFHhAAACBBDAEHE....fCFChABAgAGG.PABEcCBDSHAGhABA....hAEA...,2,-31,-5,26
gOMaePLFNdGBKDRSbYAVcfJCWIHETUXZQ,VBFFJHEE..CBAB.HEEA.UACGQAFAOHAA.MCAD.eCFDhAAALBAB.NBIEdHEFhAAAKCCEDDIF.SEBHhABAAAFFfDDCWEDH..IHHHhABAEHBGZFFA......hAGAaDBB..,1,-19,-20,1
AOBNSbETQgGCeDdPLZMVFYHJRKacIWUXf,BBDBSGBEEHGG.QFGGGDAFDCGBLBAFMFFF.FAFDJFADhAAAKHDA.aDFG.IAHFhAAAXABD.AICAODHDhABATCBECBCBeFDD.dAFDPECC..hABA...YFAFhACA..,2,-26,-4,22
dHVbQJRDFIAKSaPZYNCUBWegLEGMTfXcO,SHAGaABBZFCA.CAGE.UBFABDEG..eCDFLDCFMEFE.TGEDhAAA..fHGDhAAAXAEHOCHBhABAdHAHbEAF.JCAFFADGAIGEKBCCPFFANEIE...ECBAhAGAcFFA...hAHA...,2,-19,-14,5
bKFVTRJdgOCWDefLIUENHBGMAYcaXPSQZ,aCGHSDDBZAFG.KHDCFGGF.RDAH.dABE.CHBH.DGADLDGBUBADHECGhAAABBFH.MAIFACIB.hABA..XEBAhAAAPHDC.QADB......hAEA......hAGA...,1,-27,-34,7
IfAQEDVCHLXBRGNTaePJOdFUYgKcbZSWM,EBFCDACCCBEELDEG.RBBEGFAFaECF.eGFAOHFA.FGBFgDAHhAAAKEGG..hABAZCBGMFFAAHDAQAGChAAA...XABCNIDFPACGUEEChAFA.bCFAIHABhAGA...,1,-11,-21,10
VQdNfgJZHKbEeTPGMULCSDYXFBOAWcRIa,RDDDVECFdBCA......fBFBZEABHBBGEHGCeHBEGAEHhAAAMADGLGFGDGGAFEEAAEIB.hABAIAHG.aDFAhAAANIAHKHECTBAG.CECGSEBDBCHGOCABhACA......hADA...,1,-7,-8,1
deGZSJHUEYPQVKNCcBMfTLFDAgObRXIaW,OEDCRGBC..XDDAaBBE.dBGAGGDHZACHHAAFUEAGEFBCQEGGhAAAKGGG.CHBFMAFFhABAfEGHLAHBhACAAEAA...........hAAA......hAEA...,1,-16,-27,11
fJXAZdWMPSUgTLYOFKREDaGeVHQcIBCNb,dACDMCBFSDADUGCCLDECFGAA.KGADEDCD.GBEEHGFGQAEGhAAABHDCCHFE.fACGhABAACIDZBAC.PFEAhADATDGG..OCCHDIAGaGGF...hAGA......hAHA...,2,-19,-12,7
GdTcVKbMAQSHDICYBfOFXNPURgEWJLaZe,QGEGHFDGDDEECBAABCCCFEFA....XGAAUFACEEHBJEBEZAEAhAAAdABE...TAGChAAAKABEAICC..SDDGhAFAIBEFOEHD.NDDF.....hADA......hAEA...,1,-27,-35,8
JaFBNZLXEbPSdWRHgDTYGCcVIAefQOUKM,QCEBOBAFKFGD.MBADFCEA.BCCEZGBGLCCHEFBE..SGGEhAAARCGFDFFF.YHEEhABACAGC.IAHDhACAAEIFeABE..fEAGaCBHbGAGdEED..hADA......hAEA...,1,-18,-33,15
KfRXWNFTCeEGIaOgbBSYcQHUVdJLZDMPA,RAECXDBHFFDB..eCADGFCB.ICHAaCCA..OHEGhAAABACHSCAHhAAAQFAB.HDDCdABBLFFEhAEADIBGAGIHfGACWDDG.CCCBEAFD..hABAYAHBcGFE..hAFA...,2,-26,-8,18
ALFMGNfVIZJXbBYSWcTHeKPQagEdCRDOU,FEGEMDACGCED..fACEVFBAZDBA.JFFCBADH..SHDChAAATBBBKGGFaBFChABAdAGDDEDF..AAADLFADhABANEBEXCGA.YHEGWFEH.cCEHhADA.eAFE..hAEA...,1,-13,-30,17
DOUXaAdKEefMPJGVTbWCLZSgBIYQHNcRF,KBBBeDGFMIAGGBBE...TAFGCCHGLEEDSHGABBDBQGGBhAAANBAE.hAAAREAHDIECXFCA.hABAAFHHfHADJAFD.WEEBIAHFhACA.cDGC..hADAFBEHaDDBEHCE,2,-35,-2,33
IEfKCFLHZdQAgNeDPYRSUBTVcJOMXGWab,eCEEDEBERFECBFAG..TFDH.JABDOADDGDBC.aGABECHHhAAA.KGDDCAFC.LBFHhABAdHFHAFFA...gGAAhACAPDHFSDDC..UBBEhADAMBABWHFAIBHChAAA...,1,-24,-28,4
aQGBOfAZEIUFbMWDXKdPCgeSNHTcJLVRY,EDDFFFGDMACGDEFD..KDGGdEDF..CEBE.SBACHBAG.JCEGVAEEhAAA.RFDB.QFBDhAAAODAH.AFIFIAHEhABAUGGE...XGEHeHAA.cBDGhAGAaAHDBABF...hBDA.fCHC.,1,-12,-24,12
aEHGWcJRLMebVgTdIZFDPABQSfYNKXUOC,SADD..fGGEKGAGOEHDCDEEEGEDHEBAGBAAhAAAJAFBLHDEeCEEbGAGTBABhAAAdAFHFABAADDC.BEEDhAEAQEECXEBDaDGGWCCB...MCIBhAGA.....hABA...,2,-18,3,21
CSNgBLMVHKabJWYXAePRQIfcZTOFGUDdE,eFGHQCFD..fBBDZACATGGFOAEDGBAEDHACdECEhAAASGCEBHFDMBIFhABAVDBCaHAE..WDDBhADAADHCPBAB.IFFEFFAH.CAGFNIBHLFFChAEA..KBGA.hAFA...,2,-13,0,13
EdPYcFNRKBLIQbaTJASgOGfeDCXZWUMHV,SHDAGBDBeDBDCFBE.ZGBA.UBABMEGBEDFCdDEA...PADAhAAAFAGEKFFA.BHHHQBGChABAaAEG.AIGAfHABhACADEEB.HBCA...YEHFhAHANCIGIHFBJGCGOBBHhAIAWDDF,1,-16,-30,14
AeXbJGIBFHROWQNEagKcLPSfUMTZVDdYC,eAFBJCEABFEFFDDHRADD....OGFGQDAH.aABGKACGLFFDhAAASDCCMAIFhAGAZGAEDCBACFBB.AHIFGCGGhAHAHBAHEAGA..PHBAfHEB..hAAA......hABA...,1,1,-41,42
AIYOQWGVfDaXEBLKFSdeMCRgZbJcNPHUT,ODHBQCEHGBAADAAD.EGDHBBDB.LHAESDFHdHGDCEABhABAZFAE.JAFD.NABH.PAGFhACAHDCG.AIEC.IHBBhAAAVBBB..fFGGKGHB.MBIFhADA.bFBE....hAEA...,1,-4,-23,19
VKOHRPYgSCBDFXTecMIaWbJQfNLdEGZUA,KEGBHCDD.RFED...PDDGSAGH.BAECXECCeCAFMEIHhAAAaGEG..bAADJFBDhABA.fACEhADAdFACEACEUAEEACIBODGDCCHBDAAHFGHD...cGBEhAHAWFCH.....hAGA...,1,-11,-20,9
TgcMZSWOYNaBLDXJIHRFKEbdfAGCPVQeU,CEHBQBECUGEG...TBAFMAGDZEDGSFHB..hAAAOCABaHCCLEEHhABAJCCEREAF.KAGEEBAGfDCEhACAAAHG.VEAD...cGGChADAYAACBDHHIHCDhAEA..,2,-35,-13,22
TZCSQORYKNdbGPgLeMIFaUAHWDBVcJXEf,HDECDGCFBECEJAEB..EHACZBGD.CEEA...QAAHOCAD.RFDDKDADhAAAdCCBGGDDLAHHhACAeFABIBGB.hAAAUGGGAADF..cEGEfDBB.SGAChADA..hAEA...,1,-10,-39,29
SLPYXgHIRCWZbOFdcKQNfDTJEMGaBVeUA,LDHFXFBHHCEGRBCDCACF.ZBBBFFAE..dFFEKGFHQADChAAA.DIAGEGDBaAHBBBAChAAAeBAFAFEESEEEhABA..YDDFIAFDWEHFOCEGhAEANIDBfFACJHAC.hAHA...,2,-33,3,36
NVDRbBUeTFKPXELcHfCSJQdMagIOWAGYZ,ZEDHDDFEREDFBCGB.eCCGKEAD..EADCHACG.CFGA.QGGAhAAAMBIF.aBDEOFAG.hABAABBH.NIBF.UGABFAHHLBBBhACA.SDHHgCAG.WAAChAFA.....hADAYHEG.,2,-22,-18,4
JOLWGSVQNgbeEFTUHaBdXMPRcCAKIDZfY,KAEDDHAEZEDE..JHEELACHGABG.QAGD..NGBDeDFGhAAAEGGCFBADHBFGBBEChAAAXDDGMEACRCGDAIFAIDAHhABA.OHAESFAG..hABA......hAEA...,1,-18,-26,8
QGbPFMIJSVNBYHRfaLZKdATUCgcOWeXDE,CBCGOEEA..eFCBEGDCGACGFAAH.JFADVDEB.BBEGHAFChAAARDAF.aBABLCHFhABAdGCCAEIFUGGD..gGGChACA..XCAHDDDBPAEGMFCGhABAIHBF..hADA...,2,-30,-4,26
ACLcQTVfSbOZWFXNBJaDMPgGURIdeHYKE,LAEDQFDFVDBHSDBE.OBAEFEECBGED.DGIBhAAAMCHBGAFAIHAChAAAdACCeHBGKBEHCAEFfBAEhABAZBFB.NBIG.aHGA.PDAH..hABA......hACA...,1,-15,-21,6
HgGDNYcPKOWeLTZUXQEAbFIBSdaVRfCJM,FEGFBFHEdFCFRBFC..CABB.JAFFHGFE.GFABDIAA.....NAAC.hADAPABHKDCH..eAFChAEAZADFUGGBEEFCACCH..hAAA.SAGE.aHCAMBED..hAFA....cDBBhACA..,2,-38,-22,16
FdaIPOKLBHSANRJgXcfQWCVZUYMbDEeGT,RFDGXGDGQCFA..VCEHUAAAMBBHDDDHGADH.FEADhADAaGAC.OBFABDHEAHAFhAEANAEB.JHFE..cACHhAAACCDB.ZEGDEEEETEBH.....hAGA......hAHA...,2,-20,-11,9
OBAVINDPWdGJYETaQZCKXcLMSRFHbgUfe,VFFDDCFFdCGD.GEEBEBGC...QGAECDDFKACALECGSBAChAAAFGBGHBAFUDBAeEHBhAAAAAGCIADG.hABANIEF...PAEGWAFG......hACA......hAIA...,1,-17,-18,1
UTIWKEdbBaHQZFMYfeGJOAVDXSCgRNcPL,XBABSGEBRACF.....NBCHLEEGUECHTGADKGGCECFGhAAAdAGGBFGEHEABFCCCMCIDhAAAeCAFODEGAACCDCIFCBEH.hABA..PHBEIHEBaAHB.QGGBhACAfECE....hABA...,1,-7,-10,3
NQcCWKRAVHfEZJaGYLBSDTeIMgPFUbOXd,VEFHEHDEZDBC.GAEFLABEBFHDDDEGeHAG..MAHFFDGCUAAHhABAODCFdFAH.QFEAhADACCBFKFAHACIF..fBEFhAAAaCDA...SEHBhAFA.IHHD.hAEAbGCG..,2,-25,-11,14
ALCfaSUMVEIBNYJKZGTQXRDFeHPgcOWdb,LDCDaACA.UGGFEBGABBCB.JFDGZDEB.TBAGRCEE.DFBDhAAA.FCHHeABDHAEEPFAGhAAAOHAE..bGAChAFACAHEMABC.IEDEKGGG....hAGA......hBAA...,1,-17,-24,7
NZgXadYbeKLARTfQCEUScJODFGPWHIMVB,TABGQAAE.CCFD.SBFF.OFAGDECBFBDHGEFEhAAAHGCEIFGEhAAAMIBEBCDANIEH.XCGAhABA.dDADYBFCeGAAAFEFfAGBhADAEDAD..JFAFWFHBgEEFhADA,2,-17,-16,1
fALZUIKPJNTBSbFXeEGcaWMHYVQgOdDCR,ZDCAUFACKBEF..JDGBBHAG.FGGCEDCDGFBD..aACEMAAEhAEAHFDB.QAGEhAAAdBBDDAGB.RBEHABAGLHCGhAFAICAG..PBHDSHGA..hABA......hACA...,2,-28,-24,4
DfVRXKcPAWLeNIGFCSEdZHBMagOUJYQbT,eAEBGEDFFFACSGDGdCHEHGEGBDBEMAGDaADEUAAD..JBHHQEDGhABADEAF.RCFFKHBGhADAcCDB.ABAGLCBHhAAACAHD.gGGE.OHAEhABA.....hAFA...,2,-18,-5,13
dPRCWNQaHbfBYEUXFeTIgSKLOVcJADGMZ,MDEAZGDERCBB..CABD.QFGAHBGDBAEGEGBB.FABFeFAD..TEEEhAAASEEFLBDDhADA.OAEG.hAAAcGEHADGBdFFBNIEBaAGEYADFIFCEKGBCDCEGhBAA......hCAA...,1,-14,-18,4
KVSZDBGOJbYXFALaRCQPIEWegfdHNcUTM,LDAGCAEA.QGACEAGAeBDBdFEDHAFFUEADTGFC.KACDhAAASDFCZDFABBAGGECFhABAOBBBJHCEYAHHhADAAHHC.aHDC........hAEA......hAFA...,1,3,-37,40
HSFdZMCeafUGTgJRKNBOAQEVDLYWbXPcI,QCGDEEACLCDG....bBBHPFEHHFADdGFBZFFBMBADhAAAaBDF.UGAGTAFEJCHH.hABANABHAGIBDBBC..WFCHhAAAIHHBFEEB.CAHB..eECC....hACA......hADA...,1,1,-14,15
BRNCOALbVcZDdJaEKFUYIMTGXQSPWHegf,LFDAVBGD.DIFAJBCBEACC..FGHFUFAB..MFBFGBEDhAAA.SHEChABAHEDCfAEABCABNEDDOHAChACAAHFBZBADdAGB.aFCHICCB...hAAA......hABA...,1,-17,-23,6
GERWfQBUZTMaAVIYOKNFSdbeHgcXDCLPJ,VCEBOFBG.FDEAdEBFHABE..XAAHCHGGLEHDGGABEAFF.hAAARGFGQAGFhAAABAHGZDAGaHDGADAFKBDE.SCBAhACA.......gDGHhADADBAB...hABA...,1,-3,-27,24
XfWBGAJLdSKYMRZQFPNTcgHVeaCOEUIbD,dBDASCADKBHHREED.FEEC....TAFFHFCAVBBD.CHHFOBGFhAAAIABCDCIHXEABhAAABHAAABAELAFDhABAMIECZEGF..PFCFgGEAEHAE..hACA......hADA...,2,-20,-20,0
GUaOYZebfHKEPIWXFLVQAJgcMdSBTRDCN,JFDAMAEGBCCERFGB..DBBBGCGA.UFAEaEFBZDBD..eBBDhAAAHFDFKBEAEBFA.IACFhAAAFGHD..LADChABAACIDdBEGCHCD...NICF.......hACA......hAHA...,2,-31,-21,10
NQIAdXEUPHfVGKZeaOLcFBSbCTgDMRWYJ,dECDEEBCHBEEGBFCZFAEaADDOEHD.FGEGSGAC.TABDhAAADBCGMIAG.RAABJEEGhAAAIFHCAAEC.XDABhABAfHFHKHECLAFEBCHACDAD.YHBAhADA...hACA...,1,-7,-15,8
CWMKXAfYGdPVDIZHEbaQSFJTLNRBUgeOc,GACFVEBC.ZCFAHBBGaCCC.FAHHLFHDBGBGUBEAeDAF.OEEGhAAACFHA.KGFDADABdAABDCGCEHBGhABAQGFH.hACASEEB...NIAF....hADA......hAFA...,1,-15,-19,4
AXFbSDcefaNZRJYUVGWMKgLQBPdOITEHC,FABBSBDADCDH.eCABaGBD.ZFEB.RDDC.UAGGGBGGKGEFLDADhAAAQGGF.PABGhAAAOEBC..EHAEAHDD.hADA.XFGEfGBBJBEF.WCCDBDGC.hAFA.dAGF....hBAA...,2,-32,0,32
COaXABdIKDQWLNVcgMRJYbETUPZefFHSG,dGFGKGBAQDAHLBGH..VCBBMEGHRACC.JBBC..EFAHUEDEhAAAZEDDFAABGAGG.CHHHOCDEhABAAIHADCIB..NIAD.hACA....YADC....hACA......hAIA...,1,-21,-24,3
cXHAbBCFONWLEeYJRKfdMSPDUQVgTaIGZ,CADAFCFE.OABELEHF.eCDDRGBGKFGEdFCG.MAFCDBIF..QECEhAAAVBFF..aBHFhAAAZBAAHDAHAAEEBFFGEABBJFFBhACASBFC...PHEC.hADA......hBAA...,1,-10,-29,19
YGDASRHdMObIfJVeQaFWEcTZLgCPXBUKN,SGGCdAAEMAFF.OEBG..bDACJCBE..eCGDFGAFEDGBhAAATGBELGCA.hACACFDHBAFANEICDGFEAEEFIABHhADA..fCCFaBFE.cAGHhADA.....hAEAPHDE.,2,-24,-21,3
DfROPIZMYHUJNacXKFeTEAWCVQSgGBLdb,VGBGQCEA.SDAFBBDBdEFHDDEHOGAAZABHHCFE.hAAA.NBAH..aCAAKAFEFHEGhABAeEACAHHHCDCH..LBHBhACAfGHAIFFHMAAF...YHAAhADA....hAEA...,2,-25,-20,5
QCUaJPMDVbILfZTcSXgHRGeBWdYEAFOKN,OCCBQAAGUGEBaFFB..MCADDEDF....IGHEhACALFFEZBEATFADSFBDhADAXAAB..hADA.HBDCeDBCBDHFWAFCdDEDAEEB.FHBENBIACHED.hAEA......hAFA...,1,-12,-18,6
GVfYHSKLJFNEIeAPcOUDTaQgCZMBdWbXR,OACGDDEFQEBFZGCABECAdDGD...XFFDGBADfHADhAAASBCFKAGALBFFhABAFAAD.EHGGAHCGPAEFhAAAUAGEaFFC.gDGBMFIH.WDDHhBAA......hBBA...,1,-16,-23,7
dZTNBgScGYMHWbOLPVQUKCEAJFXfIaDeR,XFBEaGFG.DGEDeAAH.RBDAZGBABDEG.SFGEGEBHMIAEhAAAHACGOAHDLBHDhAAA.PBAH.hACAQGGDKEGGECBFAIGG.FHACIAGF.hABA.NAGEcDAD.hADA...,1,-5,-17,12
RcaAFBdDgEbVGTOJIXSWLNfMZPYHKUeQC,BGEADHCCEHGAGBBA.JAGHSDGA.LECAMFIBZEDEhAAAHFADeADDRABHAGFDFHFEdAFGhAAA..VFABIDAHhABA.NDDH.fAEEKAHFCGGF.aCAH..hABA......hACA...,2,-21,-8,13
OHZaEPcMUDNGBXQALYbSTFWfCVIJeKgRd,LEGFSAFBTGDDFDFE..CFGF.JCBAeEAF..REAHOACEhAAAaACH..EADBMIFChABADAAHBHBGADIF.bFCGWCEHhACA...fAFBIDDDKFHHdAHE.hADA......hBAA...,1,-25,-29,4
VTPSIeEcHORbLCNYUXFfGWMDBAgKaQJZd,KGHBJADHZFBGdBAF....TDGBSFGD..IBFBhAAAEHDEOAHDLADB.hAAACFFCUGADfBFAhABAMDBDBDFFaAFGQCAHeDCD...RDEA.hACANEEE..YAFChABAFFHFDDDDABBC..,2,-27,-5,22
DVEUZKPBbWCOfGSdALRFMYIeQXaHTNcJg,LABEFEEEMICG.eAGH.QFCEHAAFTFGAJFFF.DEBGEBECKBHBhAAABCCH..CAGFOEABhACASDBDAGCEICFChADANCIE..cFAHgADAZEGH.WHDEhAEA.....hAAA...,2,-22,-17,5
PMfWRLcQTDXZeKEaGYHSOdbVIJAFNUCBg,FEDFUBBBBGFCMFADREBD.LBEC..TACHDHECZDEF.EGCCaAGChAAA.HBEBdDAD.VBABhABAACIDCHHF.....fHFFhACA.WDHFcCGC..eFABhAEAKABESFCChAAA..,1,-23,-27,4
XNUVWJESQfbPLTODFeMHcdACRIYZGgKBa,CAEGRACEZFFFGEFCKBAD.BHHB..aEDGUAAC..JGBCSFAChADA..fEGBhAAAbBGBLDBADBIDFCFChABAMCIBdEAFACDG..IGDC..XAGBhACANIABEGAC....hAEA...,1,-16,-33,17
gOWdPfDUEeXBJYaSMCKTFbIHLQNGAVZRc,ZEFFRBDAOAACdFCEDIGA..eFGDBHAH..aHDASADD.hAAAKBBBFDAD.HCGBLBAFhAAAGEBAAAHB.cDDChACA..gBGAfAGDECEH.XFAGhABA.YEHHhACACDFF,2,-43,-23,20
cJdfbSPTeGLXAQVCOUWKZYaFEgMDNIBHR,VAGBCDEDUFGH..KABFZEBB..FGAHMDBFDCDH.BACAHFFD.RCEH.dAHChAAA..SDADhAAAeFDFLHEAAEID.OBAChABAaBEBEGEB.NCCE.JAEH......hACA......hAFA...,1,-19,-27,8
VGJZHPXaAFCLgUBIWSfQYKEDMTbROdNec,CFDCLFFHBEHD.SCHBQAFDEEDCDGIH..MBAARFEHdADAeDAGhAAAGBAAHFBD.aEHHhABAAEDCFHAE..UAEGhACA.IGEHfABBKAGG.bCFANDCF...hADA......hAIA...,2,-25,-2,23
LKQHgOFZTIABEUXVGPMabeNDSRYfCWcdJ,BABDEFEBUCFHGDAG.MCDFeAAA.DIFESEFDRFAD.CHBHdAHEhAAAKEBCQBCDhAAAHGDAFDGBZAEDAAHG..XGCDhABAaCAB..YHFGfAEF.JEHBhAEA......hBGA...,1,-9,-23,14
eVZgYAUKNPDbGLEOJcHSRWfMFQCTBXaId,KBEHDGFCLBBHOGFEHEDCRADD..MHCCCGCEBADB..aAGFdAHAeFBGhAAAZBAHACDBUDFF..hABA..NAGC....hACAbFABEDDB.SGBDfEHGFGHD..hADA......hAFA...,2,-28,-18,10
AQJUGYDNVIfHXOSBZKECbMdTaPegFWRLc,JEEAUFEHGCAFDEDE....VFAGHFBF.SBFABBDEEDHB.hAAAMHEG.dEAETBAAhABAaACFeDFE.FBAG.hACALAFCQAFHNIDF.IHHEXFGAhAAAZCDA.CHFG....hABA...,1,0,-24,24
gDaGRZNAfLVUCEMKQTXYcWeOJPIHdBFSb,VFDCUABCCHFG..KAGH..QECH..TDACXFGAhAAA..cCDAhAAAWDDE.eABE.OGAChAEAIAGHBCFESBEGDCIFaHGC...hAFA....ZEAFABBBfCCEhAGA,1,-19,-47,28
ABOIFgCSLaRHbGNUPVeKcfEWJYDMTdQXZ,BCBHFHFACBAG.aAAHHAGHGEFAUCEF..eFBCKFCD...EGDHJFADDCHHhABA.MECCdCCGQEGAhAAAAHFHOAEG..IHHGhACALFEDNCIE...cADA..hABA..fBFAhADA.WBBE,1,-16,-28,12
IGRaeOYgWHCLBUKPSJAVbfXMEDQTdZcFN,VABHXADE.DGCEdAEF.ZDEDFAAGGAGARCCF.OHFA..hAAAgFFFCDDHBECGKEHHhABA..PBHHABFDMIAGhADAEGAD.TEAD.NEIE....IEEEhADA....hAEA...,1,-23,-30,7
fWIODMCHUTKAGJQZNgREBLbceXPaYVFdS,QCAGZFAERGDCLCDCeFBG..aBAGFEFDdCHASHCE.hAAAIAGDOHACDEEGhABAMAACCHHGUDABAFDAGADChAFAJFFA.NBICBHHC........hAIA......hBAA...,1,-18,-22,4
KZENOfWXHcMFTYLdAPQgBDRUeSJGIbVaC,QFFABGABRCDBUCGBeFAC.GBDG.VGBCaAFECFCE..KCBHhAAAZGFGOAFD.XABEhABAMBBAFDADLAHDhACAAFFDDAAA.SEGE..IHCBhADA.EEGH..hAEA...,1,7,-44,51
KGcEUAYCaXBbJegSDMHTIVZPWLNQdFOfR,aFGEXAGFBADB...eBDHSDEEDCAEMBAEHEEH.IHCGhAAAZFEHLDHH.hABAdFBGFAHBfAEBhAAAKCCEcDBCEDAAACADCHHFgGGGTFAH...hACAPFDB.WEEEhABA...,1,-18,-19,1
BIZUOAWCgGFNTSdLVKYaJHceRMEbXQPfD,CEBFFBFE..SAGDdFGGLAHBKFHH.aAAGHAAB.RFCG.ECCAQCDDhAAADAEEBDEGUEBAhADAABHE....WHDGhACANIEF.TEFC.JFAHcGDB.MBCAhBBA..XADGhAEA.fCHA.,1,-10,-26,16
UEBKRWgMaJOdefITLQDNXGACcFPHZbSYV,CFGGFFBDZFCH..SBEGUABDBEDBRFDHMDBC..aBGHdACG.eAHFhAAA..TGEHhAAADAFEXGGBAAGC.PDEEhABAHFABbCCC.EAEBKEAC.....hACA......hAFA...,2,-31,-17,14
gFUfVQOKIYGWCMNEDdTZAHRXaJPBebcLS,RCFHJCAABFCF..eAGDLADFFEEE.UAAHQEBBKAHD.GABHhAAAMEHD.DEIHZGBGACEEHGDEhABA..aAEEPHAChACASGGD..fGGBhAEAIFAFCEEG..EAHD..hAFA...,2,-32,-14,18
eZgTAVQWGbIdPaDLRBXNMFKOEUcCHJSfY,VAEDQDGB.GFAFdDCADEEERCBEBHAGMDHH.FAAD..KCABEGFAhAAACACH.HBED.fADFhACAZGFAAAAB.IHHBhADALGAEOHDC......hAGA......hAHA...,2,-43,-5,38
HJYIDQaSBLKMbdFAGXTcWPEVORZUfCeNg,XGGBTCCC......PCADOGBAUECBCCEAeCFHHGFAhAAAJBBEIHADDAAFSAGGhABA.KHEAdAGGhABAACIDGDAHEDGCZACCfEHC..hADAYHAABFAGMICGhAEA...,2,-23,-8,15
aPfSdFDeOMWgNHRVUJGcZACXYTQKIEbBL,XEBBTGBG.KBCDEEFH.BCAFLFFA.aHAESECAhAAA.DIGGeADEOABAhAFAWAAFHBDAUAGCcBGFhAGACGEGQBDG.IHHHfHEFhAHAMFDDREGHJCBDABBD..hAIAPEFG.,2,-8,1,9
BCPOMGSdQNcFHKbJAaLVXgTIfRDZeEUWY,LCBEXAFE.TAEERGFCZDDG...EHGAUABHBGFGCCEF..OGAChAAAMBAGdCHE.NFDHHGAChAAAKCADAAIB...aDEEIFFEhACADCAB..eEAC....WFDHhAEA.....hABA...,1,-14,-31,17
IGUeYZgdfEJKRCbFBVPWMOXNaQTAHSLcD,SGBADEHHUCGBZEADdABG...EDEDJDEHKEGF.REBA.FBCGBAED.hAAA..VAGFMAFFODAGhAAA..aBADAHHC.hADALHCAIHED.......hABA......hACA...,1,-23,-46,23
LOUKecBAgCHPfRYIZJFVQaSWEDGNMbXTd,HAABRGCCZCAAFHGCQGFH.aEEBEEFCDHBGMBFH..TBFGhAAAdFAEOBAAeFAGAGIB..hACACCGD.YADF.hAAAIEHGSAGANAEF.XFGE.hBAAKECFBHDH.fEBDhBCA,1,4,-36,40
dUFAXGRJeWEIBMZgTYVKLCSbDQcPONHfa,XEGHJCFD..eACBEDFHBCCHZFGH..TDAHKBEECAABDGCHQGBGhAAA.OBHBhABANIDFHCABdAGBAFDARAGHMDIBhADA....YFAFSEDB..hAEAcACGaFAH...hAFA...,2,-26,-18,8
edcVbTGZLXUWYOKFgJCSfRADMIEaPBHNQ,MBBCECBCBEGCHCGF.eFDCdFBE...VCAFTFEAZGCELAFDhAAAUAGFOCEHKGGFFAHFCHDD.hAAASDDFACAC.hABADGBFaEAG.....NBBB.....hACA......hADA...,1,-3,-35,32
LMCgaAIVJDFOeYZdScUNPXEHfRBKWTGbQ,JECEOCBGZDGD.dCHG.UGBH..XAFHHEDEBDAE.KACATABEhAAAGGEFLDADhABACAFF.ABEGDHBAFCFBSEAGhAAANIEH..fGDB.hABAWCDG.MIAGaAGE.hACAIAHB.,2,-26,-16,10
MZFVYAOLRKbBHCQJTEaPUeXgNGcdWIfSD,LAFCKHBEHEECCADCJBBC..EABFUDDB..eFCG..XGEChAAANCEB.GEAAhABAdGHEfCDESDGHhACAMBABFGCDAEAB..OAFABHHEaCFFPHDEhAAA......hABA...,1,-19,-21,2
VJCOAFUcPYdTWaBQDINGLEeZRgMKbfHSX,UGAC..PEECTBAGaGAE..DAHBGCCFLEDHEHEAeBEGhAAARCFBKDBH.HBAD.XEAGhABACGGBAAED.FDHF.hAAA.cABAWADCQGGC..hACAIHFE..hADA.NEICgAEHMIAE,2,-26,17,43
SHWVgPcZFJNLUECbDRIdBYXKOeGAQfMTa,QBEGMDHB.SBBBVABD..PFDAFHCELFEGhAAAUAGG.CHHDRFADBDAEXDGGhABAKFCFOAFBAEECfAHChACAaEAH..HGECWEAE....hADA......hAEA...,2,-21,-21,0
HFdLUJbQRGTVAISNeZCYEaKWOMDBcPgXf,SHACeAGHCGBG.EAECaBBG..KGFBOFEAMAAE.BHHB..hAAAPCEDXECBHDGDhAEAdBEAJBBHRCAC.GECAhAHAAIACIHDD.NCIG........hAIA......hBAA...,1,-18,-25,7
EKPOBIURaZMcYHSgLAFGdTefNWJVQDXCb,GEBCTFCA.eEFB....NACAJBFFDBFHCCDD.EDAAKHBABHHARFEFZBDHhAAAMFAF.HAAASDABhABAADIHFHDE.fHGHhADA...WAHHXADB.hAEA.PFAHOBHB.hAFA..aEEH,1,-12,-27,15
adARNDYJgOXZVMPcWfCQLUFeTSbHIBKGE,DABGJDAH.OECHZBDG..MFDG..PBFH..fDHEhAAAQGGEUGEEeCBFhAAATABASDDDhAEAIHCGBGEE.EAGGABHF.NICB......hABAYFAF..hAFA...,2,-34,-33,1
fKPaGTeIWcZLUSbQAYdBFCgVDORJEHNMX,BDFGCEADDDDG.JGCCHECA..MDBBKHEGGADF..IFGFhAAAZAAFLEGBUADASABHhABAAIHEdGAGFCGG.VAFAhAIA...EDDDNDIG...PCHDaACG.hAGA......hAHA...,2,-27,-19,8
cVXOeYPKFMWGUgTRbAQdJDaZESCILHfNB,dFFHaHGAZEAHEAGF..CDEA.LFEAHEBHBBAH..XCGCeAEHKGDDhAAAFCAEMADDGABF.hABAgECFbGFE.hACA.AEAHDEGEfAGGcGAH.YCEHhAAA.WHAA...hAEA...,2,-21,-6,15
PgUbWJQeZafcCOXVIREYGMNSHABFKdLTD,KACGdACFDEGDUGEG..JFADZEAG...aBEDCDHG....OAADhAAAXCACRFCE..EGHFMBHHhAAA.HGBCADCEBHCAhAFAFGHBLEFA..PAFCWAHBeBAGhABAfCFA.IHFEhAIA,1,-23,-44,21
gABZLECXGNDKHRIaSUYTcJfFQPbdMeOVW,LGEACHFFGDGEDAFDRBFF..SEBHUGCC...TADDhAAAJEAGFACEQBBGhABA.bGAGeCAGOCAHhACAgAGFAHIFBEDAEFFAXEDENCIG.KGAH.hADAaAAG.....hAFA...,1,-4,-27,23
eDEZJFgfALURMXSCaTcOPIYGNWHbKBdQV,LAGBRCGHMHBG.CBBD...TEDCOFBD...IEDAhAAANADDHCADBFHHQEGAhABADFGDEAAFFBDBADEC.UGEESEBHhAAAaDAF....PAFB..hACAWAFA...KCCChACA...,1,-16,-26,10
PVERcLIJMYFHOedQBUNCWXGATSgaKbDZf,SAACaBBA.DDCAZGEC.VFAAEEACLEEFMEAE.HFFGhADAdAFBBCAACAHBGACDADFDKDHHhAAAPGAGREEC.ICFFhAFA.FDHFeCDCNICD.WHDG..XBBChAGA...hABA...,1,7,-28,35
FXQTgDJGEISAdBWfZNHKcePMYCULVObaR,BDHCZEFCKBBCeBEE.MECCCGCDLHEG..bFDDRBDDFBFA..hAAATCACDEAB.EHACAGGGdDGDhABA..NAEFPFFAhAAA...YBACODDHXDABhACA.....hABA...,1,-28,-32,4
QNDUCWRPgbBALIGFXfdTecVZaJYHMEOSK,LCCDGABAFGACdBDEeFEEZFGF..aGBBJBDCHGDG..MIDAOBAFhAAAKDFEDAEECBFA..RDEA.hABA...PAHFhACAgDADADAB.IDDA...fEHEhAAA..hABA...,1,-9,-40,31
SQdeUbDGNOYAPTLVHfBcgRJKXWZaFIECM,TBEGLBEB.VEFCBEFD.RGAG.KCGGZCBBFGCDCDGH....MDIHhAAAQABHdAGB.bEAFhAAADABB.OCABAEDB.hABAHEDBfAGAJHFG.aGAHSDDFhACA.....hADA...,1,-11,-27,16
cXBgYeMHbWRNIFfaZASdUGKPVELJOQDCT,SCDGGEDCKAFDEDCFLFFB.QFBBDHAGCBDC.XCBDhAAABAAFeCBFHAFGRBGHFGGChACAaGDDAIHE.dABB.PDHBhAEA.OFAH....cDFHhADA.MIAA..hAEA...,1,5,-35,40
DKPdSVXOGQRcAaLHCUJeFNTZBEMWIfYgb,HFEBJEBE.FFAEZAACEGGG..MAFB..fBEC..hAAAbGDCDGDHdGAGSBADhABAXFFE..OCGBhABAQDFBADDALBHHCDCDeAEEBCAH..hACAIHACKGBH.PBBAhACA.,2,-25,-19,6
cPHagYJBFRVfZTbDSdQIGLKeUMOAWCXNE,XFFEECDGHFFGaCHH..JAHHRDAH.ZCDGDBCAdGBFGGBBLCBHKEEEUAGBhAAAABAF..NEAC..hABA...cBBHhACAPBDGBAEBFEEA..fAADSFCEeHDAhACA.MADACHAD..hAIA...,2,-21,1,22
WMRBdEfGKUDQHeJSAFcONCaPIZXbTLYVg,FDBBOFECCAEF...aGADZDGH...TAAELBEE.gDCGhAAAMEEFRGAA.dDGAGACEhAAAKEAADICEeCFDAADB.hABAPAFEIBBC.YGCABHHCfFFEhACA...hACA...,1,-15,-34,19
BCNTGVXPFWLOJKaHRQYbMIfSEUgcdZeDA,BFDGCDAFGCBG..VDAGFEGGLACCKBAEHBGH.QBGHhAAA.MFIFfHADhAAAEFEEUGBHgADAhABA.ZEEAADDG.NIDBPGEE...ODDAhACAaAGA....hADA...,2,-19,-15,4
XgUHeRDYWZQKBLVJSMIcCfaENPAdbGFOT,dGAFFFABOBCE..TDGAUFEEHDBGRAEHDCAEZAAAKDHH.BHGGLAAGhABA..SEEFhABAICGFCHHEfDAHhACAECAH.AIBCXGDAgGBFYEAGhADA....hAEA...,2,-38,-20,18
ESVgZRCcOKbANfMBdWJDXUaITePFGYQHL,MGCGBAEGJCFCUBDC....aABFTEFE.FDAFGFEBHAGBEHGEhAAASDAG.hABA.gDCGhACARECHOEEGKHAAAAIDNDIAdGAADAFEIHHA.eAADhADA......hAIA...,1,-3,-32,29
KDONXBQbSWUaVLHMCeGAfPIEdJRTcFYZg,..IBGHJGDCRAED.FHDGZGAC.KBAHDDDD...OCEHBEABQDDHhAAASFFEaCBFhAAAHBGF..CAECAFBEfHGFhABAdHAB....cDGF.YDADhABA.XABEhACAWADF,1,-43,-45,2
OFeDaEMcdXVYTZLURNPGCKHQIAWJbgBSf,JFEFBEGB.SHGAOBBC.DBIHMCFCdFDA.....VDGHhAAATBAGUDBCRBEBGEAEhAAACHHDHGAA.AFFD..gGFChABAFADGaAGG.XDCCLBAFKAFCIDEEhABAfADC..hACA...,1,-11,-27,16
JUFIcKaWOCMXTLDAgEVeHBfYdZSPQNRbG,ECFDeAABBHHCdBFFZFAE..QDCDRFGHGEEAFDCBKHDCOEADhAAA.CAFE.MIACLFFChABADADAAEBH.VABA.fCHGhAEASCHH.......hAHA......hAIA...,1,-23,-25,2
WNISeFJRfPQVbCLTgAKcaGUDEBdYXOMHZ,aDEHUAEDBHDHdGFD..OEEEHBFFZAAC...IEAHFDBGRAAG.hAAAQGFACBHALFCFhACAADDHKCAEDFIB.EBHDMIEChADASGAH.JECHfFACPADG.hABA......hACA...,1,-15,-30,15
GcdfXbTRHSJaOCANZeILUVgEFQPWYDBKM,eEEGUADAEAFAFGCE..QBDA..WABFDDDBMIAA.hAAAdGGCfDFDhAIA.XEDDRDAHSGEHhAAAaCBDAGHAZGCAIBHEgGGGPABAKBHDhBAAcCGH...hBCA...,1,-14,-27,13
BXCHEeLKaDRJdWbgcIFVTSNQfUGAZYOPM,OAEGMGFGBEFDHDFCLBGDKBBFDFGFRECDdCCC.....bEBGIHBHhAAA.FACFSAAAhAAAQBEBfHFHhABAAIFA.ZGAC.YAEDCHHDEEED.hABA.aAHD....hBAA...,2,-21,-21,0
UEVBdeMIDAPQCJLHOgYfGRKWFXcNbaTSZ,QAFBLFCEOBCG..gDFC.GGADhAAAKEGAFEAGNEAD.aBADSGFHhABAECHBBGGHMHBAAEIBCCDCHABEhADA.fFDBWDDGXAGE..hAAA......hABA...,1,2,-38,40
HKTCBESbcYXaUAfQFVdLZOGIgRPeMWNJD,QAEBdFGFLAFCGFDHRFCE.MEDCJCBAKEBCBEHB.ECBD.SBBEhAAA.bFADhABAcBFD.aABGAHIHFAHFhACA.ODAB.IHDHeHEADAADCCGE.hADAXGBGfHFHhAFA...,1,-7,-32,25
WEdcQDHFNBeXOJUISAZGaCPTYfRgKMLVb,aHDCCAHD....TEDCRCFHMGBCLCHF..VDAGEBDHdADFhAAADHFGFABGBGGG.XBAEhABAJAFE.UGADAFDCPEHDhAAAfGEA.KBFHbADH....hAFAcDEF...hBAA...,2,-28,-16,12
WKBAbXSERfMcHaJYLIeNgODUQFGPdVZCT,SGCDRFBEMFFH.HDEDaCDD.LDAA.IABHNDIE.hAAADFHBFDAHGAGAdBBDCAGFKBHDhABAAIHEEGFH.JBDGeACEhAFAgFAF....ODFF.hAAA......hADA...,1,-12,-25,13
FGgMNZCfQdUPIeDcaVBTHYLERXbKSAWJO,JFAGOAGDGDDF..MEBECHFD.dAADUBBHeHFG.DGFC..aHBGhAAABEHAHFGHEDFBRAECKABChAEAAFAGFAEG.ZFCB...hAFAQBCD.IGBC..hABA......hADA...,2,-27,-25,2
QUBdAVCfgWFJDMOGXaIbEZSeHRcLNKYPT,VECFCGBC....fGCCFFFGDBGGGBBD..XAGDhAAAaACG.bDECSCHDhAAAeADCHBBDRFADNICDKHFA.hABAYFFG.QBEA.BDAAhABAAGHGgCEAhAFA...,2,-29,-2,27
OXRCYfEBIUcPKZJeWdTbGgLDAVNaQHFMS,VDCHQECC.MEGHOFHD.CFAB.EHBGUACDKGDAZAEE.eEAHhAAAdGFCGBEEDBAEAADFHCFChABASHAA.hACAXAGAfHGFIEGH.PAAFhAAA.....hAEA...,2,-17,-17,0
daPWABIOUKcRDTFNESCZGXYeVHJMQbgfL,OAEBUCCCRDAB.DGFDFDHB..EDAAZGAC.GEFGeAGDHFAA.MIAAhAAAQAFG.hABA.fBBHhACAaFEHAADDBBAAIEHG.KGGH.TDEFCHHB.hAAA....XDCDhADA.,1,-22,-26,4
TdXDQNPgebLfaSGOVEMYRIFHKUBCJZAcW,TGBEDEBDQCCF..PAFCeCFFLEGDaEAC.SCHBhAAAODCEMFHFhAAAYHBARFDDHABDKAEHUADAhABACAGH.AFFC.dABHNDICfDFBECAFBFHG..hAIA......hBAA...,1,-6,-10,4
PSegICcZORbdUFNJVBDTXMLQHEKWGAfYa,aCGBSEGB.eCABCFHDOCHD.RDAD.UFCCFAFE.JCDEBFFChAAAXFFHLBACEABGKBHDhAAAAADG...fAFFhADAPDDD..IHDF.cGGHhABAZDCANIEFDDIB.MFADhAEAWFAD..,2,-33,-17,16
LadNAMGEQgBHJCSfecFDVKRXbZUOPTYWI,MEAGEGBGBCEBHBDD.SHEEeBBCDFEGKGAFRCFCZFAD..UGGGOFFGhAAA..TGEFhAAAWABH.LBADdGCCAIHEQAGDhABACDDGFDGE..VAFA....hABA......hACA...,1,-4,-20,16
PBOFKGcDbdSYXHeQJCaRNfAWMEIUZLVTg,EFBGZBECLCCB..VEEHTGEHBCBGFFBHKDHDDEGDdAED.SABGhAAA.HCCBhACAeAFAJHCCCABFNDACAAHFMDAHhADA..IHHE.gEDHhAAAOAHD.....hAFA...,1,-20,-23,3
PTBEKfRGbFIWcMHAUXCOagLQSdVNDJYeZ,UFEBXFGACDAA...OCFALCEGSDDCdAGFDEEG.eFAHhAAAZFAGBHGHKHFAGABAhABAFBAA.IAFF.hAAAcGDBACDFaADG.QDGBJDHB.YECGhADAEEBA..fHBDhABA,2,-33,-22,11
GHELOBbgCAYcXdPIKZUSaDQFNTVWMRJfe,XGAAdEEHKCGHUBDADCDB...FBBB..VBEEREAG...eAABhABAEHFGBGACCGEAAGGF...hACA.PEAE.SEEGhADANADHMAIH.fHGFHGBC.ODHDhAEA..bFEAcAGAhAFA.,2,-36,-29,7
AbgSeRYKQMGXNdcHFTfEJZOCIWaDLBVPU,SHDEeBAAKGAFGBGGdEBHFAEA..EFEDZBAA.CDAC.aDCFBFGEUAEEhAAAAAAA.RDAD...MIAGhACANEIE.HBGH.JCEHIGGAhABADGGH.........hADA......hAHA...,2,-31,-16,15
BYQACWUKRHEXSNDeOGVLgcFMIfaTZbPJd,CDFCKHAERABB.EDBH....XECGSCGGDAEA.eBAA.VFEChAAALHEG.FGEAMICGhABAIHCGaAEHTDDDhACAZADCJBAHBAFB.ADAF.HDGFOEHF..hADA......hAHA...,2,-23,-17,6
EIUfTHbXNZDMCSYaWBcGegKRPVAFOdLQJ,FCDFdGCEQBFBEEGE.UEGGHEBB.XAGEDGFHCADD.SGFBhAAAaEDC.BACChABAGCAHeBEGKGAGPBBBhAEAAFAF.OHACIAAFTGDDNAEF.MFDAhAFA......hAGA...,1,-10,-26,16
CfMJdSNXQRFcaeBOVPbTLGgYIAEUKWHZD,EFFGUBDCHFBECGGH.JHDCdGAD....XBEFQCAB.FFEEhAAAeDCGBFCE.OHCEhABAbBAHLBHD.hACAYHAAIBGGAHIBWADCZDEGDAEE.MBIHhADASABB..hAAA...,1,-18,-25,7
BITZecXCGfHJEUVWSNQMLKgOAYRPaFdDb,RBGFaEFAFBEG..DDEDBEAGZBFG...eDCECBADHDBDUFGC..VFFFhAAA..NADD.MBBCLGCChAAAKEADAHAE.dBAD..hABAIHDC..cDBH...hABA......hACA...,1,-30,-33,3
ZUEBMYFNcAXbVTLOgGJCIdQDKHfaWRePS,XEECTGAF.LHEAGABDCHEA.dEGHDDHHKAGFHBCE.fBAGhAAAaDEHRCAB.SEBEhABAEGGHBFCBFCGEcAGAhACAABAF.OFAH.IAEB.QGBGhADA.eBFHhAIA..,1,8,-27,35
aKUTfeSHAgBDFQPOVXGNMZCREWbcLYdJI,DBCHFHBGOBBHGBEGMADEZDGF..RAFC.EBAH.....bBGDLECChAAA.dGFAIHABhAAAKACHfFCHhABAeEBGAFGHBHHG.VGCCNCAGCGEG.....hACAWBDD....hABA...,2,-26,-22,4
WVSBeHObPgLfcCXYJaUFdAGEIMRZNKTQD,EACDMBDFREDB.KFDE..QFBDDAAB.SGGDBDGBOBEChABA..bBEGLDAHhACAfAAGCFGEJHAGFAGGAAHBGGEHhADANIBH..WEAFeBBBPCHD.hAEA......hAFA...,1,-5,-29,24
DNQUVEaMKOYIHdePASTbWFJfXBLgRCGcZ,SBACTAAA.FBEDJFECBGAFLHFCREFC.GAFEDEECUGCBhAAAEHBAMDBD.OECGhAAAIHHFeAEFABDH.fEHGhACACDAC.NAIC.aEBG.KAFC.dBHGWEADhADA.....hABA...,2,-36,5,41
KYdgCIGeWMbJBONALcTQFHPZESVDRfUXa,TAGCQBAA.FDECHDDCZAEA.SACFRFCFUGGF.KDBEdFABgGAGhAAACHAE.IAEHhABA..WAAEhAFAbGFABEHCAEHG...cGDB..hAGA.ECFGDCEG.aCCD.hAIA...,1,-13,-28,15
eTCHDIPEbUXaZYJQMVKRSAONGFgLcWBdf,GFEHFEADLFFBBFBBeADECBBE.DBCBEHCEUAGCZADH...JBAHMAABhABA.RDCD.AGDBOEDGhAAA..NEHC...hACA...cCFDfHDFIHAB.hABA......hACA...,2,-42,-23,19
CaIbKDAcUPTOQHYWLSXJGVEfdMZgFNeRB,UACAOGBGQFFBHBCHLAHF.JFFGEFBBdCFCMEFCZAAFFEAAhACARCDCCBHC....IAFGhAAADICGAIGG...cBAHhABAPADG....YHDA.hBAAWFHH...SHAGhAHA,1,-15,-25,10
UATBgNLRObPFDMQdEHcZYfWIGVSKJXeCa,BFFALHBEOCEGFGFGMBECdAGDHFBG.ZAAF..fCFDhAAA.GABEKEECeACAhACAUDDAAIDENDAGPDAFhABADGIFEHEE..cDGE.IHHC.hADA.SCCBhAHACAHEaADG...,2,-26,-1,25
VBObPcHXAeNYaIWTdLDKgJCUQfSZERGFM,eFACaBCA...IBDEdEGBKEEFCBFD..QBAEZFADRAGD.MBIBhAAAOFGD..cDEDhABAHCAGAIDC..NAEDTEGChACADDEG.gGCFfAAASBEHhADA.EGGD.hAAA...,1,-5,-37,32
VDNWfJTgQMAaPZURSOdecIbLHYKECXGFB,aGHFUFBF.OAGHeCHB....ICCBLFGBKHEGCDDBFAEBDGBE.hAAA....NAIC.fEGAhABA.TDAEhACAMBBBACFBRADDSHBCdGECbABF.EFDGBEFChAAA..WAGF.hAHA...,1,-16,-33,17
AHMgGSJKdUFCNbDBcEfWYeaZOTILRXQPV,MGCGGEDFKBDBdDBE.FHAGCEEC.DEAHBCFB..EBBC....fEAFhAAAeHEEaDGEOHCChAAATBAB.LABEhAFAXGGAVBEAAADCSAHF.NBIGbGBGhABA..cGGA.hACA...,2,-45,-5,40
CTJZbRPWaFIgUcQHeOEMVYGSKLXfADNBd,DCGHBEHCCCAE.JDFBZFAG..RDCD...aGGAFBGE..UCCGQGBGhAAAHAED..OBHDhAAAMIDGGBACKFEHLHEAhABAAIHE.dHBBPACGIEAAeAFF.EFHHSABAhACA..hAEA...,2,-22,-18,4
JZDdSgGAfHbLKFQcRONPMaVEYITBXCWUe,HDDHKHDCFEBGQACF.OCGHPBBAMDIB.EAADIGHAhAAABHHACHCFUAFFZDFDSDDHhABAAGGC..hACALDADNEAA.YHDGWGBCDDAE.dCHAhADAfECE.hAEA...,1,-4,-33,29
SVYdegXRcGZEFafHIPUAQKJWBLbMTDNCO,KHBEBEFALBFHMHAEDBCBOCAC..SECBdAABeFFHRECEGBDDhAAAFEHH..aAHFfAGBhABA.IDAEhACAAAFCJEAB.WFHDNAEECHHC.....gFEGhADA..hAEA.XCGA.,1,-19,-26,7
aNSUEVYZbTWBIAJOcgeDRPCQXfLdHKGMF,JFFCOFCE..eAECDDAECACF..QCDBLHAEHBFGMIEAFDAHhAAASFHFEGBG.hABAZFFHTECABEAGIDEBhAAAgBBF.XAGAKCCCaAGG...hABA..NHED....hAEA...,1,-7,-27,20
STFBACKZcYPbUOGaMIJEgXLWeDNfHRQdV,CDHGKCDAZFAC....PGCGUDDBOADA.GBCFMFBGIHGGhAAA.EDBGgGDHhAAALACCDHAAhABAfHAFQBGDSDBHFFHFBAGCAAHAcBAGhABA.aGHB.hAIA...,1,-23,-29,6
TLADBQJKFbGCNecSOPRWMfdgUZHEVXYIa,DIDABEHDKEDFFABBGBFC..eFDAOBHFRGACMFAEdAAEZFEE.HFBBhACAXADA.aDDAhAAAAEABQADHhADA.CCDHSFHHfGGDEBGD.IDAGhADA..JCBBNAIG.hAEA...,1,-6,-36,30
aATVCEcLbMQXWSPFUGBYeKONfRZdIHDJg,VFCACEBELDGB..MIBCQDDG.SAAHhAAAUBECBBGAKEAFfGGGhAAARGAAIGEBDAEE.aABAAFIBEBDAhACAXBBHFBGE.eBHHNIDH.....hADA......hAEA...,2,-27,-19,8
KZIgWbAdCBJPTMQaNHEDRVGcXSYOeLfUF,BBACTGACQFAE.HGFCRCAAVFEBGADH.SDGFhAAAOECDeCFBLEAChABAfABCKCBEgDDBhACAAEEDdEAHPAGDNBIEDGCC......hADA......hAEA...,1,-5,-14,9
DMACIUOLVeXQWTgbaZYJcNEBRHPFfGSdK,CFCDUEEALBACeGFA..QCAG..gFGChAAAaAFCJCEG.ECDFHECDFBGBSDAHhABADBBAIHAAOBHDhACA.XCEDWABE.TGAA.hAAAYAEEBEHB..hADA...,2,-28,-16,12
BfEHILRgPeNAFTKabdXDQcOCYMVGUWSZJ,FGBGTBDFKFGG..dBEBDEFC..OBAGMAECUDBBZDDH.BBAGEDFE.hAAAHGBCLFADRFFAeCFChAAAAHHF.aEEC..QCABhABACHHE...YHCGWDAD..hACA...SDHBhADA.,2,-29,-14,15
gJVPfbASEZGIeBdaNQHDMLOWRUCKTYXcF,ZBAHGFABBEGAaCCA.HEEEMFCBLAHDRAGH.KADAXEEHhAAAFFHDJAAH...VCCGbGDA.hABAEACHdDAH..DGHFOBFDhACACFAH..TAEH...cGDHhABA.....hADA...,2,-21,-3,18
WaTPRMfYZCLSIFbgQOGVAXKUecHENBdJD,XDABeFCGHBEGBEEBJHEG..DCBD..aCGDREFC.MECFZGAACABBSGAFhAAA.IBBDhABAFADGQCCGhAAA..OGFAAEFG.UAEA.NICBWACBhAHA.PEDB..hAIA...,2,-29,-22,7
ELYZcgHJQTaCRPVOMKdFIfSWGUBDXebNA,LGCAZEBCHDGBTACBCECCRABF..ODFEMFABKGCDdBFH..FGHBIBAEhAAA.SDEGhABAUDDADICC.XAEBhACAeFADAAADEDAB..YFFF.gBGEhAHA..hAIAaGFD..,2,-23,-19,4
YLSEXHZDaMBPVeANTRJdIgCfGQcbKWOFU,RAEDdGGBCDDH.GACC.QGDCKEHFOAHHFHAALEAB..hAAAEBAAHGDADBGHBFAHhAAAeDFHAHHHNCFA...JACDIDHFhABA..fBAGWAFC.SGBHhABAaEAGMIFG..hACA...,2,-31,-14,17
KfHNVgdQDGcLMeITBSFXUaJPCbZOEARWY,RGECKGGAHCCD..VCBEdDGEQFCFGAEHLFDCMACAeAHBhAAABDADFHCAaAGH..CDBD.OABGhAAAAFFH..fBBHhABAgCGCDIGGIFAH.SHAGhAFA...hAIA...,1,-15,-19,4
EbdGNfQAYZFcKaIJHBgSWMPRXOUVeCTDL,FCECaBFGHBAFBADC...SFEBMFADRGBG.UCCCCCBD.DGHFEBGDdGCFhAAA..GCCCQDFAhABAABABZFEC.IACDhAEA.JFAHWHFG..OHCC..hAFA..eAEC..hAAA...,2,-34,-1,33
ABGWXDRSIFZLaYfNPbeVEJQTCcKUHgOdM,BAGDGADADDIFRCFCFHGALCCD..aGAF....NDDHeBDGhAAAECBBTFEC.CACAKAFHhAAAgFGD.dFEEhABAMFACABBA.SBAFIEAC...fEHEhABAPHAG..hACA...,2,-33,-27,6
ZfJdUGFALcCeEINDBWXQbOHVPKMagRTYS,LGCACCBE.EABEIFDHBEBD.QGAFOAGHHDDHKGEH.hAAAaDGDRBFE...TGGEhAAASBDBZBBEfAHGhADAdDAGFGGDAEIFeEEEDIDGWFAD....hAEA......hAFA...,1,-15,-27,12
WQDbIMGegUTaScVLONdPZYCBRfFHJEKAX,XFFGDAEEMEEAGACCUFCC...aBHFSBFC.LDBDhAAAdFCEZFGHBHAGhAAAFADHEBAEAABAQBFGhAHA.eBBDcGAC.NDIGCDDG.fHFFhABAJHDE.WAFE.hAIAIEGD.,2,-15,-12,3
PYTFBSMgbEdKQJNHAORIDWLfCeZVaUcXG,OBCARAGFDDACLFDE..eBBBZBBCUFAGGCGA.PFCAhAAAFACGBHEGMICA.EBFHdDDDhAAAKGAB.QGGFhABA.JCAHAIHGfFHGaAGA...hACAcGEF.TAEChABASGDA.,1,3,-31,34
ASfFBdGDLVCTgNPWZOKbHJYXaecQREMUI,FBHBGDBBLFHDCGBD..TDGC..PDBCZBCCOAEEhAAAKEFDJBBAaGFG..eEADhAAA.RFCB.EBAF.MIDGhABAAHADBCFADFAB...NACF.......hABA......hAHA...,2,-31,-20,11
QKOFaUcWYVDHLIbTfGAZEMXBNRdeJSgCP,EGGABDGDRBBD.JCAB..CEFG.KGBDFADH..UCCF......hAAAcCFFVFFELFDDhABATEAA.GABFhACAMHACXGEHdAGD.SAGG.hAEAPEDF.OAABhABAYCFCDIAC,1,-19,-29,10
XQLgfaJOEKbeIFGCPWNMScVZYHDUdTRBA,LCAEaEED.OHFAEBBDKBEF..eBEFFGCHCHFD....NIBFSEBFhAAAVAGFZEACDABChAAAdCGABEHHAAHHQFDGhABA.fFFBIGGG...WEADhACAMBDDYABGhAFA...,1,-25,-34,9
bMDWVCILfJAFNcETOGSUgKeHRZaQPBdYX,FEADECCGGAECUFEG.eFGDZGAG..QCBBBHABdDAA..bABCMACChAAA.DICECFHGIDGChAAALDEAAFCB...hACANBBH.TAGB.SEEDKHGA.aGAAhADA......hAEA...,2,-27,-16,11
HCIPRAJYfWSZaVXOEeNLUQdKDbgMcFBTG,JDEA..fGCGZAFG.aFFHXGFFECDGLDAFQGCFhAAADEGEMFBEBCAAGAAHhAAACDCBRECAACCC.SAHDhABA..eFADdGGA.KABE.....hADA......hAEA...,2,-27,-13,14
aUMcKESdbXAReIQBCTfOVJZHNFWGYLDgP,eCDGBGHFCCDGOGBAZBFF.HCACFDBD.GEEBLHBADAEG..aBHFMBAGhAAAKAAHdHGH.AIEE.RECHQFEAhABA.hAAA.fHADJAHH..NCAA...gBFEhACA..hADA...,1,-17,-27,10
MUGBLHKQCaDPcefRASNFWgYbOIXVZdEJT,SCDHFDDC..gFBCOFDEXGBCdEGA.JAAGUAFFhAAAGAGALCAFhABAHEBAKBEECBDHDGAFeHFAAFIB.hACANEAG.bGCE..IFHEZBBBMBIBBDBF.hADA......hAEA...,1,-3,-16,13
DSYMVCKEOdAQZRJPIUfcbGHNTXLWFagBe,ZCBFJBDC.UADD....fDHEGEGATBGALGDCaFDD.hAAABHBA.SAAEhADAMFFHCDECKHAAdCCCABBG.QEAChAEA.IEECcEAH...hABANIDBFAHHDDIFECAD..hACA...,2,-24,-19,5
MfDNERZcOKVaPJdSLTgHWUYeFGbCQBAXI,XBDGMFEDDEDC.REDB.ZCAE..KFAH..aDFDdAFFLBCEHCBBUDGFhAAAeFAGFGCDGAGGhAAACHHFADAD.IHHE.hABANACD.cFFD..ODHD...hACA......hADA...,2,-23,-13,10
OPRbGeaUYEKWTIfBACLJXdVMgZQSHcDNF,LGAAJHFC.VDEFMDID.ZBADHCBDDAIF.OAEE.REGHeBAFhAAAUFCGEDCGKABE..ICGBhAEABAGECAFGdCGC.hAFA.SGHHFADD..PFEE.hAHAaAAG.....hAIA...,1,-9,-31,22
LUKHTcRVaMYFdJPQfCgNDbEIeBAGSXOWZ,XAGEZCEHLAAAHBBGREAA..MCHBdFFFJFAC..QGDHhABACDFDDEIH.EHGGBDAAAGABSHAAhACAOHAGKHEETCCGhAEAaBAGFEDF..PAEENADF..IHHEhAAA....hABA...,2,-25,-4,21
UPHENLfRCXbagAQBGeIFKOSTVWYMDcdJZ,QAAHBEFHeHEAKFDGODCD..TGBAVFAF...MBEBhAAADEFFJBEEUABFHGDALDFChACACHGHaEAG.AGGCIAFAhAEASGGE.cADGdAHCEEHD..NAIE..hBAA.fCCEhBIA...,1,-10,-23,13
OHeKPLRNaBdSTUMcDYCGXfgJEZVWFAQbI,QDCEOGBEKCFGLFEBaCGD.BDCGdGFE..SFAGhAAAMBBADFAHGEGEgGCAhABAECAC.ZBCEFBGAICABhACAeBEF.NAED.cEAACEEEJFHFAHBB....hADA......hBAA...,1,-11,-18,7
eTMPRHcDEQXCUOaZIbVAJBSYdgWNLKFfG,SADAdCFH..NHEDFADCGAFA.MCDHHEFEDAAAECAGCCBHOFHHhADAaDCE..IAAHhACAAFIDBCED..YEADhAEAgGAA.KFACTEEF.PHBGhAHAcAGG....hAFA...,1,-19,-33,14
BVgRcfFTIPKSZNLWEXdQUMeGJbHYACOaD,ODHHBFHHRDCEFAHF..IBCHKBBB.ZFDCLDAH.EHDGhAAAdDEC.MBBHGAFChABAJAEC.HGFAAGCFaAAGDFFA.hADA..gACBfEBHSFBHhAEANICFXBGE....hAHA...,2,-33,-10,23
SERGNfAHIdCePMLKacWDOFgBXbUTJVZQY,HBDBCDFA.MFEBaCHBDFHDFFBHBDHC.UCBAVCCAZCFF..SBGChAAAEACA.GEBEhABAfAAHADAG.dAHEhAAALACE.WFFDgGGH.hAGA......hAHA...,1,-14,-37,23
SbfCBMLWGIYUDNRJVZcdaXKgPeOHEQTFA,SBGCCGDCBCAALFBFGCDD.UEGGDABGRDEBZDAB.dECBKCCHeABAhAAAHAEA..EHCAFEHBAAFCMIFChABA..ICHFhAAANCAH....cFBDXGGC.hACA......hAHA...,1,-10,-36,26
OGLeZYDFCEWgSaBUTIRcbXHfdPKVNQMJA,OBFEeDAADGABFDFC..CBBH.EDCF..SDGCUABDREDD...hAAAXAFCdFFEVGAGMEDFhAAAABEFLAFEZFGFgFEDhABABHHE.IADH..cCAEhACA.....hACA...,1,-16,-39,23
ARQPgfHEYCLZaSGNDUXcWTFOJKMbVeIBd,RACBQBCC..fHGFEEDHCCAEZDEH.aCFBGAED.DEGEhAAAUGAA.XDGChAAATGDHFFADJAHFKCABMFCDhABAeEDBBGHEABAFgFGC...hACA......hADA...,1,-17,-18,1
DYJbHCaOLXfKWgIMGdBUQNPSTAFRVeZcE,REAEeECBZAGFDABE..bBBAHDEC..CHBHOFHDLBCF.KHFGICGFhAAAGGBDBAADhAEAUGEBQEEFhABASBDH.FABE.EAFCYFFGaEAF..WBHHhAEA.MFAB...hAFA...,2,-24,1,25
QLeRZCGAWKfDBNcEgdHSYJFVOTIaXMbUP,KAGDBDFHECDCHCDH.SFHHFCHF.OADAICAB.MEEAhAAAbBFA..UBACPFBHhABAeFGF.CAGHAEHADEBC.hAAA.gEBHdFFDVABEaGDF....hAEA......hAFA...,2,-28,-11,17
GPBKHQJdfZWRCTNUXFAMOgEIYaLVSDbce,OBDBEEEC..aAGCVGACDDGG...eGEEBACCKAGCQEGDhAAA.dCCEZDFCRFBCCHABUCAAhAAAAICA.MCFE.IABDhADASADA...cBAC.hAEA.PHDEfHGDhABAWEBA..,2,-31,-26,5
dEWGNfARVXILcFMCPUZTQgaKJYebHODBS,REGBXDAHLFADFDHDCFEH..ZAAC..TACFQGCD.KCGEhABAeGAEHCDCDDFFBBEChACASEDDdDAH.WHAGhAAA.GEFEAGBA.IHHGMIFA.UCCBhABA.aAEF...hADA...,2,-18,-6,12
DQBKPbEZfWdMCGcaVNYALUHTRJOXSIgFe,UEFFRFCBOBFA..IABAeHFABEGBKDAA...EABHZAFFdCECCFDBGGEHhAAA..aEAEhAAAVBCHADACTGAA.hADAXFGCSBHBDCIH.bFBDfCCEhABA.WAEC..hADA...,1,-20,-25,5
NJKELDbOCZYISVcPRaAgUFdGWeTHXfQMB,FFDFdFDGeAABHFFBQADHBGFEKHGG.EBABDGBD..ODDGCEGAZADB.hABASHBA.hACA.PAHDACCDUFAFGCBGhADAWBHF..fAABMBFBLAGDhBCA......hBDA...,1,-12,-23,11
YXVaULWGbfPROINDdKBEeZSMTCgQcAHFJ,HBBEFBHF.JEBEXFGB.UACHLAEEGDABbFFA.RGCGOBHDhAAADABHBFAC.eDFEhAAAMBGFCHAC....gFCAhADAAFECYDADaGEDPHFC...hAFA....dABB.hAGA...,1,2,-25,27
WLXgcGHBRbQVNZIACOdEMPUJYSKTafeFD,OBBHEBCHUGBE..JFHFKFFF...aDDHFEDD.DBGELAGHhAAA..XACAhAAAGAEEHCAFBCHAQGEDhABANEIAAACFCHGG.PCFDSBAFeHACgFAChACA..hADA...,2,-38,-13,25
EFHIQfDNVSWTgeJALKOZRMBdaPGXYbCUc,LCEAKHFGRBAEBFDCaDAB.GDBG..XCEACHGCUEEEFABDHEGHhAAA.QADEhABADAGDSEHFTGABeHBAhAAAAAGAODABMFID...dEEA.....hABA.YAHHEHCANAIE.hACA...,1,-13,-16,3
WMcZXAFRHBOGEbNCDfQKIVUTYPSedagJL,FBFHBAAEGDBHEAFD.CBBB.QEFD.KGDDIFACUCAD.hACATFGGSDCHhADAeHCGdAHCaBHF.LADChAAAMFIDXEADAEGGOBABDHAEfGFEhABAPHEC......hACA...,2,-20,-14,6
BGfARVHQNgLZMPeWSaDXJbUTcOIEYKCFd,RCDGQDDELDAHZEEAMCAG..eABBaFBADFGAJBHF...UAFEhAAATGCDOHBG.EADGhABAKAEHdHGDBHAHADBC..hAAANGEH.gGGA.SGEHhACAXCGE......hADA...,2,-23,-12,11
fcKYISeUACMFQLRTPbXDEaNBJZgVWOGHd,CCFAFGBDRFCC...TACF..bBDFDDGG.ECEFBABEZGFE...VDAHhAAAOFABdGHAKGFGIEGAhAAA..SAGGhADAUCABMFBGPHACaFFC...gBBGhAEA.WDFAhAFA...,2,-36,-20,16
RYMTVBaUXgDIKcdNSGWLEHFeOQPfJZACb,RACCTCGGBEGHUGDA..DBCBKFABdGCB.SFFHGCABLDHHhAAAFDCDeFAF.OBEFhAAAQAFG..hABAfADAAIBACECH.MEIDaGGHIEEBhACANICB..ECAB..hABA.JAFA.,2,-22,-20,2
GgDHbNAcMRQfILTFWdSYBPOXVCaEeZKUJ,RDEHQDFBLFAEFCCBSAGDBBHF.ODEHCAEE..EGCBeDAHhAAAZEGB.KGGG.GABEhABADAAF.NIBDADADMBEBTFBGhADA......YBAB.hAEAXGADaGDE..hABA...,2,-40,-1,39
fIEdMabSZGNcLDVFXPHYQUKORBgTAWJCe,CDAAeFCH.EFBHaFBEZACDGAFALDEC.DAAHXGGGHFEGUAGFhABAOHAGBHAGACDBJAACdHFHMDIBhACA..SEHFhADANBBGFAED.PEEF.KHDG...hAHA......hBCA...,2,-25,1,26
SXQbgJGWRFEPeDBLacNTZAHKfOYMdVCUI,KAAFOECAdEEAUADB..IGDH.SBFAQDGEhABAJCBCRGACEEAC.DBCFaFGHhAAA.TFAHADDEHGFGfADGhABAMAGBCECH...XGEH.hACA......hAEAbCFA.WHAG,2,-24,-21,3
WGaUQJVbZCLfNIMPdFSgEDBKTHeXAORcY,RACE......WHBEUGDH.QBGCVBDA.CDDALAAHhACAIAHD.MEGFdHGHSEAChAAADIGEBCCF.hAEAKFGBTGABeEEAXBBFAFABOFCA.cFABhABA.aGDA...hAFA...,2,-27,-23,4
JSKaQcVXedLRUYIgTACWPGHNZBFEObfDM,CDFHGAEGZBAHBFCEEBAFOHFE..DHDEMGFAKAHH...QGBDhAAA.XCCDhABAdAFGREGBIGBChAAAAEGFWEBGHAGHFADF.fGDBaDCA...hABA.eFFB...hACA...,2,-40,-15,25
aPIVeSKMcDWGZJdYAOCFQbgTELRfXBUNH,OEEGCDAAFGCB...QBCH.TFDGEGFBLBBAhAAA.XCFDBDACUBFEhAAA.NCIAHGACIAGChABASHGGcEGDDADG.ZFDDdEBBYAHBhACAABBB...gDBHhBAA,2,-23,-22,1
AQMVfHNEWgReXPaTISUZbCcFGJLKBYODd,VCCFHGDGEDFG.RCAA.eABH..aEDCIHHCSHAA.ZAFChAAACHCEFFECJABCBEAGDCFBdAGGhAAAAHIBMGAG..NDAG.hABAgEGATDGGbFAHLCEE..hAEA......hAGA...,2,-18,-4,14
RLNAfCaDgFQIGVKTWYUMPEeHcBOZdSXbJ,aDABFCDEQFBGGABEKECG....TFFEUEEFEHEA.eAEEhAAABBGFOACCSCHDhAAAJDHHLHAAfGDDhABACCAGDABHVGAE.MIFC.PBEH.hACA......hAHA...,1,-6,-18,12
TRdCADNeLBOKYbfGHUPcZWgMSEJFQaVXI,DCHHeHDGLBCFOCGBKEEF....bFFDHFACUAGHZBBEMBFDhAAAEGGCFAFC.QDAFhAAAaEAF.IHABhABAdGDEABAEBCAG..fABF..hAEAPHAA...hAHAWFHBSDDF,2,-40,3,43
dLRGJfFDgBTWeIKScVNQXZPbAaCOHUYME,CGAAODDFUCGF...MCFAEECC.RFAC.GBBDFDFBBHAD..eAFChAAAKGGA.SEGHhABA.VFDHNBADQCABhAAAPCAB.AFGGaAFA.dHDDfGHAhACADIGC......hADA...,1,-22,-24,2
PYMFDKfXBaVcGANHJIgLdUSZQRbCTOWeE,HFDEJHCALDDASBACZFAH.QDAG.CHCBODCAhAAAEBCCPAABMBGD.DIAEKGGFhABAfBHCBFHBaECCGAGEhACAIAEDgAEHdHFF...hABA......hACA...,1,-14,-15,1
ZNVDAQIJKPBEXHeLRUYMdCFaWTOfcgSGb,QCCHKAFDEBCD.eDABREDAUCGHdGGBCBBD..FCAD..TFDEhAAAOGAA..fBHGhABASCDHbFBHVFGFhAAADGAFAACD.IDFHBAHCLABCMFFA..hAGAaBDAWHCA...hADA...,1,-12,-19,7
UVYNBCGLZFbHOTIdcfAXDSEMgJRaeKWQP,XACHSEBF.MDAEJHFC...aAGFeDEE.QAGBhAAAUACDVEEBBHDCLEHHhAAAbBADHFBEIBAChABAcEFHfFCG.AIDCDDEE.EAFDKDDDhABA.YFAFCHFA.hADA...,1,-3,-17,14
fbCUDeQPAIWOaRKJZFXTGHVgLSEdBcNMY,OCHDRCAGKAFCZFCGFBFC.GAAEHCFBLFBD.dBEABGADMABAhAAAfHFF.hAIACEDHDGFGQGGFhBAAAIAGaHDG.JBBC..XADF...gDBHhAAASDHH.hACA..EHDA,2,-41,-5,36
NBfXgcRDCYSLTAEdbOWeZGVIQaUHFKJPM,EACCOCCCZCDGGECH..IFEBaBDEHGAGFFADKCACMDHHBHGAhAAA..XDAChAAARDGDDAFGCBGE.SGGGhABAAEBC.WACC.eHCA......hAGA......hAHA...,1,-17,-35,18
CWNYHfADeZgcLMKPTSbBaVOXQJIRFGUEd,DCBBZDDFLDAFKCHD.SDFCBDDHOGAEQGBE.hAAARAAAFBEGGGEH.EADBhABACDCD..NBIE.HAFHAHAB.hAAAcDFCTGGGbEAGaHEC......hABA......hADA...,2,-28,-14,14
ZdfAFgEMLCXeHOBcTGWYDSUQIKRJbaPNV,FCFAEDGALEDBeFBGBGGAGCAE.DICAUCBEKADE.JADA..aHGGhAAA..VEEGdCCHfAFHhABAABAD.MFFGhACACHAHOHEC..cCFB..YAHHhAAASBBE.hABAIFCE.,2,-36,-10,26
HORNGUdSceEKVaYCfAITZDBbJQPXMLgWF,ZEEFDAGABHDBJACH...QCDFMADCLCEEFDFDHFGH..hAAAOGBERADCGEAASBAHhAAAECHFaDAGCBBEAHHATEGBhABA...XEBB.WAHBhBAA.....NIEB.hBEA...,2,-34,-16,18
PESUVAMOcRWdCbKeGfXaYTBDQZHLJNgIF,MBEHOHAARAAB.dCCAKFCEGBEA..XFAHTEGD..BAGAhAAADAEEHAFGLEBGNICB.hAAAIACBFFGF.SBAFhABAAHIBCDCDeACBfCGGaGGC..hADA....YGCChAEA.,1,-16,-29,13
HRXgGUbTcQfZIFeBOAKESDJCaPMNWLYdV,KBCAEBADDEGHCABB...MICALEFE.dBEEVDCFRFGFGGBB.hAAAUBGGbGAC..QADDhABAZEAGFDAGBAADOAFAhACAAGFE.aCGA.NHEF........hADA......hAEA...,2,-24,-13,11
VNFXdJSEDcfYgLUBCReKIWAaPTQbOZHGM,aAGCQGCDZCDF.GECFMFAD.FAEAdFBCSGHHEGGC.DBDDhAAAfBAGLAHFBGGHhABACEHBRDFD.ICBEhACAPHDE.ODAHHFCANAABXCEA..hADA......hBAA...,1,-6,-14,8
aSegUNQcZJLdAYHfXGICEKDRPTbVFOWBM,HFBCXCCEGDAH.CBFFEHFGKDAADEGF.RBFA.TACCFHEA.BAADhABASABGeEHDUAGChACAQFBF.JADChAAAAFGH.....fGAG.IDHBhACA...hAEA...,1,-18,-27,9
JfDcALgUFOXQBKbSWIeYVNEMZdGaTHPCR,LEEDUAGGFGGC.XBCFKCAC...SBFGeEBB.VDADhAAAEEDEdGDG.aABEPFFEhABA.CAGBfDHEhACADDFGAIBCOFABBGBH.IHHFMIFATAEHhAAA....hABA...,1,-16,-34,18
TYJVSORBNIbMQKWLZUPXAdgHcGfFDeEaC,dGBCHEFEGACCDGDAaCDECHEE....JAGDVBAH..SAEChAAABAED..IBHBhAAAQEGDKHGAWFAFhABALBBD.ZFCFPHDGAIHAfEEFEECC.hACA......hADA...,1,-20,-29,9
HPRDBICSbMVNTdcfUXOAEJQFYLZKGgeWa,QFGHFHEGZEGFGBEBeBHHHCAEDBEDCGDHMABA....TAAHhAAA.dEACUEDAAACAJHAChAEALFBD.KBBChAAAgCCD.aGEDBAGBbCEH...hAFA......hAGA...,2,-19,-17,2
fUOCGZHNePKaWcLDdSYRBgbTMVIAFEJXQ,EFDCQBADUGADGCEFHEDAeEBH.aAHBLBBFdBFC.SGHDhAAABDHGTGCFhAAAIHFEFHGCfBDGhABAOBFANBAE.KFHBDEIDYEADgCCD.hACA......hADA...,2,-12,-2,10
fCNLABWeZPFgVYOSdbEMGcRHQTaXKUJID,BCDGeHDEFBBE..VFABSAFFdCFH.MDAERECAQGEGhAAA..aAAGKCADIFFGhADADABECAFBLBCFhAEAAAHGZCEAgEAD.YBHHEGGE.hAHA......hAIA...,2,-26,-18,8
DPBLJVCFZeGbfQcgMOKdUaTARXNSEHWYI,XFCDSGBCHDED..ICCCBAAGJCBCFGECZFADGADFhAAAQAEGMEAGdDFETGFFhABAADIFEHGA.DBACLAGBhACACEEFeHAA...fEGH.ODAChADAaAGA....hAIA...,2,-12,-10,2
ScZaOLQeHXCWgYURAbfFVPDdKMINJEBTG,FEFFDCFEMBDC..IHBBEFDD.GAAEZDAFOBCHLAGDhAAAeFFACFHE....gEBAhACAYEFEAGAHfADHhADAdHDHKAAFBHHBTCDEaDEB....hAIA......hBAA...,2,-30,-19,11
aQUfdZOJYLTFHgWACKSBMcIDEeNbRVPXG,KFHBSFCAMFBF.DFIBEDCG..eCFDRAEA...XCAGhAAAaDFBUGECdCHGZBAEJEBGTGCBhAAAFHACHAFH.AABEBBBBhADANABF.PFGFQCGC....hAHA......hAIA...,2,-17,-10,7
OdXCSIRZMaeAFENKTBcPbLQVJGWHYDfUg,EGHDKABFBCGE..PBDEQAEF.GDCFHDDGfABGhAAAUGDCdCAD.SHEGhACARFAHaGGA.eDAAhADAAFHE.FHBG.NFABTAGC.cDGE.hAAA......hACA...,1,1,-31,32
cLICEMZedYQPbJaBFGNVOUSRTfDXKHWAg,LAHBEACAZDDB.dGGEQBGFJCBA.aFAHFADA.GGBD.hAAAOAACRDFH.DCFCKGHFhABAAEGC.IHFF.hAAACCABMECFeECAPCAHBBED..NIAD.SGAFhACA.XEGAhAGAWCCB,1,-27,-29,2
fbNUQISTaZMVLROdDBFKJWXCgPAcYGHEe,GEFCeCED...NCAD.UGBA.SFACaCGEZDBBLFDBhAAARBAHdEGCFAEGKHAC..JHFEXAGChABACHAC.AFHE.HFDFhAAAfEAAIDCEMBBGDDFA.BHHH.hABAWAEH....hACA...,2,-22,-13,9
YDANPaZICSWXBTQLFJGHKEcgMdOVfeRUb,aGHHCFDF..SBFBBCDCLAHHFBBCGEACKBFH..EGEEMFFGhAAAOEDAeDEG.UGGDhABADACFABAD.ZDAHIAHChACA.XADFJHBG......hAGA......hBAA...,2,-36,-21,15
XVKeGMYCdWBPFQcEfNTbOLZHaRUDJIAgS,XFBAKCDAeFFBGBAG..CHHGBBHDQFBEEFGH.TAFAhAAAOBEFLFHFhABAaAAFUCABDDGDAGIB..SHAGhACAMIBGdACA.FGEBNAIE.ZAFF.....hAEA......hAFA...,2,-22,-9,13
WQVXBgMUIKRYbZafNPFdAHcOETDCJGeLS,OEBGTEGB.DHCGGEEGLABA..QECGBGACUEGHIABBhAAARFEDZBFA.fAGEhADAFCCGAFAA.cBDHhAEACDFC.JHAEeAADSAHB...hACA.WHBG...hAFA...,2,-26,-22,4
EWcACeaJgFTZMUQSDBdVPNXKYbIROGLfH,eEEAaGEC.FHDEZBBAUBEEDCIFBAHA..VFAH..XGBFhAAAKBBG...IEBEhABAOABALDHHhAAAEAFCAADDCEEF.gECDMIFAQFGBSGGDhAFANCAG.....hACA...,1,-19,-34,15
OAXZUgKIBVceSfbRCYQNHLdWGaEPMTDJF,UFDAKFGBBGEDeCDE..SBDHRFAH..CDDCQDGAhAAALBBBdGCCaGHFMCFGDDAEFBAEhABAAADG.ZAEAIEFBhAAA..fGFBYDFC.NICFWAFEhACAEAGGPBAH.OFAGhABA..,1,-20,-24,4
IXOHeWQcbgDZGaMJBYFPRLNCTUSEdKVfA,OCEFeHCAQFAF..bBFBZDCHMIBCBGGFFFACLAADhACACHGD.UAEHdABGfECGhAAAAAHDIBBGHEEEhADAgADFDAIHJCHHPCHF...TFGHhADAKCEG.WEED.hAFA..aHAG,2,-9,-5,4
HWCZNfRDKaVbFYIJSOQMBXAPLTdEcUGeg,TBEHdEAAUDGE.GBCHeCCFHEGBZAFC.REDEKGBC..aGGE.FFDEhAAAJAAA.OAEABABFAADEhAGAEHDC...WDAFhADANIAB.DIAE..bDDCYBHH..SDBBhAHAMIFC..hAIA...,1,0,-27,27
WUFaABVdfQXLgECSIZMGcPHYRbDeJOKNT,BBGFdAEGQCAALFDDCDDDZDFAGBEGHFFARFBHDAAAeAAE.OAGFhADAKFGH..TFADhADAFDDB.aGHDABIF...fBBGhAEA.EDBDSGAFMCIF.hAFA.cGEHYHFGhAGA...,2,-16,-13,3
LAUTOSIGeJYVKNDgRbcCdWXMFPHEaQfZB,OGFAGAACJHAEKCHF..DFDHRFDE...CCFC.XADA.MEIHhAAAPBAC..HCFChACAQEABBHGFAFFGUEAFhADAIHBDeDCGNAAF......cEEGhAFAdBGB.EHFG.fAGBhAIA,2,-39,-12,27
HWFJVDKOCfQZXTNcEPMSIdUeBGRgYLAba,HAABFGCFDEFDKGFG.OGCGCCCE.ZEAH..TCAGEDEH..SEHFhAAAUAEDBGGF.GBGAhAAARADCLAHFAACC.hABAWCFHJFAD...fDCHNEEG.MFIFhACAIHHE..hAFA...,1,-5,-42,37
ZASEdBKRTHDgeOWQUYaIVLJGCFNPcfXMb,SGCFEEDHBGFAKAECRDFAHCAB..DDIBeFABODABQFGEhAAAUAAG.IADGhABALCDACCDBFAHB.NIDF.PHBAhADAXFDBMAHHACCH.dDBE.....hACAWFGH....hAIA...,1,5,-35,40
RMIeJTNUfKOHXgZGCDdEFSYLBQWPbcAVa,RBGHMAECeAFH..JGBGUFAB.KHGGOGFEHABFZDBCDCDC..EEBHSFEHhAAABEEA..hABAQBBE.hADAPAHFAAIDaEGEIAECNCAA..fDFBhAAA...hAHA...,1,-23,-33,10
SRFgXUZBcPQVOACMeEHYINadGfWKTDJbL,CHDFEBEGHCCG..IAADdDACGFEF.KGAETDEDDCIFLACEhAAAFBHHUGGABDFH..hABAcBCA.QGAGhACAAAHDMFCC.eFAEaHFE.JDAG.SGDHhADA....hAEA...,2,-23,-17,6
PfdAcQHgNDOSGYJKETFVZXULbMIaBWeCR,QAECHEFHDBBEODDDSGGBGEAGKDGHFBDEZDEDLDAEhAAA.MIECIBCFhAAAaCHHBCFAeHAC.CCACfDAAhABAAAIH.NDIEEEDH.XAGBhACA......hADA...,2,-18,-17,1
ceFJRDdYQUSaIVWALGOfBCHPZbMXNTKEg,GFAFOCBBBCEACDCEZFFH...MDAD..XBFBTDFCEAHDhAAAeBBG.FHDERDCBdACE.hAAAUFFHIADGABABLGBAhABAPCAD.NEEBKBHB..cCGADAFE.hABASGHH.hACA...,2,-21,-9,12
OVHRAXeIPBadQbLKNcSFGMCYgEfTJWDZU,eCDEBEGAaDCGdAGFQEFCLBBG.KHDCSHAEGDAGMDDHhAAACAEB..EGEH.TCFEhAAA..DCGEUGGAhABAOBBGHDABAFIF.IACD.NBIA...hAGAFHGAfAGHhBAA.JFCG.,2,-18,-13,5
EePYKfBadXAgUcFHQDZNSLMIGRVWJbCTO,UDADFDFGDGGAZAAGLECDGECC..REFE.JBEG..CHHC...EBBFeAGHhAAAKGAF.BFAH.aHEEhABAAACAHEDA.NIBH.MAIBhACA...WCCEOHFG.fADFhAAA....hABA...,1,-23,-36,13
gJZNeWSMVGBIUKXDPQdTEfALCbHcRaYFO,CDGGHDAFRFAA.aCDFFADBOBAA..JCBBZFEB.eAHB..MDIHhAAABGDBKABDDDDH.dCGEEDDBhACAADAB..bGAG...hAFAgGGENIAH..SFGHhAGA.IAHA.hAAAPFEF.,2,-39,-6,33
dDVgLcaJSfZHEKQWNTRFCbMBGUPAeXOYI,OGDEdAGBDABFLDDH..aDEHJFBHfCCHHDFG.KACAhAAAQGGH.hABATADDFAGECEAGMGAEhACABDAD.UCFFAGFBeCFCIHHH....hAEA.gEGAhAFASCCD..,2,-34,-18,16
dJNcQLDVOgYaBPRCAIFKHTGWUSXEbMZef,KCDDHCBGGBGEUGEGEDFHZABAdCAB..JBAGQEAHDIAC.OAEAhAAAaGBGBAFC.CEBF.hAAAIEEBFAHH.SGFDhACAMDHB.fHGBNDIC..hADA...cGCDhAIA...,2,-28,-27,1
BgXKbCcSUeGRFJTMWaOLfEDQHNIdAZYPV,ZAFAVGFABGEB.KDACCAEE..UCDHeCFFGDAEFABH...JEFGMIEGhAAA..OBBGhAAALEHHDBIF.QDCAhACA.IHCBdGDGAFIFPAGHXGABhADASHAA..hABA...,1,-21,-30,9
IYabLQdROgWKBfVXECSHGANFJDTMeUcZP,JDGFDFCBeCEBZFDF.....IHAFaAFEQACAOFHDKEAChAAABCFF...VGAAhAAAEHCASDBEhABAADDH.FAFDMDIHPBBAYCAHLDGF.hABA.gGGGhACAfHEHCEEE..,2,-34,-16,18
aAFXeYIHSBDGVNbLJCRWgKcfZdUOETMPQ,XBEBeCCEHAEGDCEBVDGH..LACHJHCC.RDFHKBAGZDABdAAChACAEHCG.MEFD.aFCGABIHIGHBhAAABBHA.bEAFhABACHAD....cGGEfFEG..hAEA...OAFAhBAA...,2,-25,-8,17
UMSWZPdYCRATgOKcLfaIFJGXBebHQENDV,TCEHOHFGKBGC.LACGaAHF.FDGFJECC.BGEGHBAEEABFDEFFhAAAUFGGMDAF.SDDBhABAZADGdCGECDAFAIEA..hAAAgGAF.fECGXFAA.hABA......hADA...,2,-25,-16,9
fKdNOWbcXRgAVDPQEITHZSGJFUYeaLMBC,DIBEQDCBEBFH.HGFCSCHHFBGBeEAFLCAAMBADBBCHhAAACGFFKHGCOBHD.bFBDhABARECBABEG.VAAA.TFAGhAAAJFDGaBBB..dEEF.NAEF.....hADA......hBHA...,2,-16,1,17
JfSNWTARLCPMDVUYFOaGXZEcKHBgbQIde,CEHADIEGUACGFGBDGAAG.ZFGFKGDF.BGHAQDDAdGBC.eBFEhAAAJCFD...NDIG.ACHALAABhAFA..hAGAMCDEOEBGEGDF..cFAB..gGFFhAHAIADDSDFAhACA,2,-55,-10,45
YfKgPVaADJZeNSRdbcFELWICOMHUQGBTX,ZDAASGDARFDAdHDH.FCBELBAG.CAHE.MBAHHBGDUDGGGBDEhAAABGAG.TEBFhAAAfGBGKDEG..PBEGhABAaGHDAFAF.DIAE.NIED....EGGA..hACA...WAFE.hABA...,2,-19,-16,3
dSCPKceEaVULXQHYbAZNDGgRWTBMIFOJf,ZBDBDBBHGDBDRFFEBDGE.FDHH..JABBdFBC.CAFG.KHCA..eGFG.hAAAEACEaFDF.LEAFhABAXFDD...QAGGhAAAbDBH.NICH.gBFCMBADfCDBhABASHFG.hAEA...,2,-30,-23,7
DaAKUNOgRWZMfeLcVTFbHYQIdXGJCBPSE,KBEFOEBHREEEZBAH..eFGHLAFE..VEDBFHGCHCFAQAGDhAAAdHCH.GBBEhABACACHBBGBEADEDAAEADEANEICMDDDhAEA..fHCD.....hCAA......hCCA...,2,-25,-6,19
UbDIeCWYHNLTJAdKfMGOEBFZSaQcRVPXg,KGFDMEECEEBHFEBG.ZADFQACB.RCGH.XBGHUDDEDGADCAHBHAAGhAAALHBAAGGBdGCFOBABhAAABFAD..aFHHPAFGhABA...IGCH..WFFDhABA.....hADA...,1,-21,-26,5
TAOgZbMCNVLIcaeXdJHEGYRWUKQfBDPSF,ZDBCMDIHCAFFLBBG..aAABdCHEHDDCEGFD.GADD.RBBGKEAEhACAfHAFDGHHPGAGhADATFCD.AGGCOAAAhAEAgGDA..bCFD.IHHHhAHAeEGF.XCDE.hAEA...,1,-9,-12,3
DVONCRYTbXcEZeGSHUMAQJBdKgFfIPWaL,JCDAKCFHFDCA....ICBEaHFCLAAEDAEG...OFCDhAEACHEARFBB...bCGHEEGBhAAAZFAHSABGhACA.MDABACBFBAHCgDDGfGHEPAHBhADAWFEF....hAFANDIA...,1,-29,-38,9
EcLaYgFUfHORXWbeKJZCIQNMTdDPAGSBV,GBBBSCFHBEHEEBAELFBH.aDFFFAHFHEDBOEDFXCAGhAAAeDAGZFGF.IFBHhAAAQBGFMAFFhABADFHHAGGH...YABEfCHE..hACAWAFCKGADCCDHNIDD.TACHhAEA..,2,-20,-6,14
RNQVBPHUdTMeJbLAaZCDfFgYXSWIcEGKO,ZGDGCFFEFBCD..XBDH..IHGCEAHBKFAGRBBHQCGHhAAA.BDAAPDFEhAAAdBGFeECA.JHAEACAHDIFGhABA.YFFCSACCcAEFOFAChABA......hAFA...,1,-20,-32,12
EXQDLIASHCVWTZbUceJGYPBRdOMgFNKaf,SFFBHDCACHCA..TBBCZBGDUGBAJFAB.GAEEBGHCdCGDOFHHhAAAFAAG.KGDA.aCAHEGFDhADA.DBEHAAGE..VCCFhABAbAFG...eABHREFA.......hAEA......hAGA...,1,-8,-17,9
QGgSJaREIbFUWeZdDHANCBLXfPcKVTOMY,CDHGXGFA..fBAEKEBC.OBFGMCGBQFAHhAAA.SAFChABAaADGRFCA.EDHBbFFBUBCHhACAWDDEdFDA.ABBBBBHELCCD.PHAEhAAA.....hADA...,2,-25,-20,5
QMceSAOKLZHNIfaPDgYBdRbVUTCWJFEXG,LHFAHFFD..NBFC.fBFHDBBDBAGFdCCBRCDEUABA.CDBF.JEBBhAAAFEGH..EGCCXFBHhAAAMABC..SAHHhAFAAIBAKAEEaEHFPEEH..YFHBhBAA.....hAHA...,1,-22,-25,3
KNCVcSQFRbTJgWaYBPLXGUeEOZfdAIDHM,DDFCKBECCFFG..SHEGFDAD.RFBC.JFDBaCAE..BHHELBCBhAAAGCGGeFHH.EAFAhABAZABHAICEHEFDMAIH.NBEG.hACAQCEB..bBFETGAB.hADA.YEAD.hAAA...,1,5,-40,45
DURLQOWZJAgdGXfFaIYbKeMcNPSTCVHBE,dEGHGDEGFBFH.aACB....IHEDKAEDMBAH...NDDG.TCAAhAAAHCGBBDBDDDDBRABCQGGAhABAOAHFZFAFAGAHhAAAXFAD.fFEB.YAEChACAcGGBCCFB..hABA...,1,-20,-21,1
JCeOAdXNBUFTKPVgEcSRLIDWHfQYaZGMb,XFFABECGFBBCKEGC..VBED.EAHFSFEC.LAEGhAAADICAHEBFQGGChABAaACDMIFACABHACHH.NEAE.hAAAUGDD...TCDEcBACIGAGhACAfDDE...hADA...,1,-13,-37,24
KSVFgcQXPfORGaCBMHYDJNTeLIEZWdUAb,SGAFVEFA.FGGEQAEA.XDDGODDFaHDGhAAAMBIDHDBFDHBGTFDBhAAAIACCZCABUAEHKAGH.hABAPBHHfACHCBACBFFCYHDG.hABAeCDG....hACA...,2,-16,-10,6
WFTESfMZCJdXeRgGPNBcDaILKHVOUAYQb,QCGDFADDEEHB.MCAFCFDE..dCAFXBCERFAEGCEHBEEDDAAE.hADAaFDHLEEHHFECVFADhAAAAHGE...WABFhADASAHD..fDBF.hAFA..eFHHNIAH..hAEA.KHEG.,1,-10,-23,13
CFSUOTBPKZENJcDVgLQGRAXbIMeYHaWdf,XFADMBGDHFAAdCECCAEF..UGFDOCABBDAAZBBH..EDDANDIE.DIBGhAAALHDCGABGAHEDeAGDhAAA..aAHHWDFHhABASEFA..KFDC.....hABA......hADA...,1,-16,-23,7
IGXHQgJCRKbAaDLSYMOBfeNPcFZEWdTUV,aDAGSFFD.MEDCBDHH.eABC..PACFZDEFdFBFUGCGhAAAIHBFGBAEXAGDhAAAgAECJFHBCBEAhABAKBGA.AIAELEHF.OEAHfHDBhAFA....hAGA...,2,-33,-3,30
OdLgeVYEaAbIBDJKTGScRMHCPUWfFXZNQ,BFBDKBEDGABCSEHFMEEA.HCAC.CHDBUAGDFBHDZGDC.ODAFhAAAdCFDeEDG.EACCAEIDDAFGhABA.JFFC..cGGEhAAA...PHAEXGBD..hADA......hAEA...,1,-15,-31,16
VEODHPTYWIXRfJLdgUCSeGBcKbFZMAaQN,aHEAQDFC.EBDFOBDGHFAATCAAIHHH..fCHGhAAAJEFCLGAEgFGFhABASCBEeHAAhACABCFHKAFDbEDBMAIBAAHHDIGAWFFG.RDAAdAADCBBB.hADAFHBC.NADB....hAEA...,2,-8,9,17
ZUbKFLCQYNAVSfPJTDXROBMegGdcWaEHI,VCAFSDGA..JAFGXCAHBHFD.eHBGdCGH..aECDIBFGhAAA.bABFFGHBhAAACHFH.QACFhABA.AEEE.fDDBDGEAMFFE.cADBEHCG.hADAHECHKFAD.LAGBhAIA.YGFC,2,-28,2,30
MRgbQSWZcLDJIfVHPUNGaAOeETXCFKYBd,eHBAEGAA.CFDD.KGFCdEFHMCCG..RAFHQDAFZDECDDFA..IABBhAAAHAAFUGGBaFAG.hADAAAIHXFAABHBHSAEGhAFA...WEHH...cDBAhAGAfDDE.hAHA.NIDF..,1,-19,-39,20
OAVPQGSXDZKJHTFYdecENgWRaLMbBUICf,VACCQGAA.GDBHXGEFKEGBHAFH.FAABdABGEBCFNAICRBFDhAAAMFID..BDEFhAFACGGDACHEDFFBJHBE....hACAeFFE..WAEDaGAB......hADA......hAFA...,2,-21,-18,3
LHaYGfSPUcTCeKRNQFMbdOWZBDEVIAXJg,JDGFLDFFHBBFGGBHSGCF.UACCCEABeADBRBAD..FHDCMAIDhAAAOFAHBAGCDHFAIBAGhABAAIGE.aFCGPAEEhAAA..KFAFbBFEdEEE...EGHFXEGEhABA...hACAfDDG.,1,-4,-13,9
DVPLGOQEUZeaITNYAWCfRMgdHKFSBJbXc,CAEDMCEAdCBAHGBEKCADBAAG..XCFDDHFCLHBGOFGHUDGFhABAeBDD...IFDFhAAATDDA.AABGfAGBhADAFFBGSCBH.JAFA..cFABhAFA......hAIA...,1,-26,-32,6
LOfMGgUeIXTSQBPcaZYDANFEHbRJVdWCK,FHBEEBAEHFAHREFE.JCFDdECD.CHHF.KHCALAEH..MCEDGAGChAAAeEHD.TACChAAABDAGaBCDDGGBAEAA.bAFGOGAGhABA..fCHEIBBD...hACASCAG.hADA...,2,-31,-9,22
QeYHAFETbBdRCOMcLaJNXSDgPGKWIUfZV,EGABTCAEdDCG..REFH.CCEE...MCIBaGGE..JEEAXGCB.hAAADABBgACHhABAKEAHUAEG.VBGFQACGhAAAeGBEADDBBAGCODEGNIEF.SHGA.hACA.WFAFIHEAhAHA...,2,-20,-14,6
McUdZaIPCbHXTeKfGEADRWVYNSLJQBFgO,DHAEVABF..SBEBLDAGBHHFFCBHOEGFMBGH..UFABhAAAaEEB...CHFCHFDEhABATABCKDHHEBGFAIAG...hADA..YHDGNBFE...JFAC..hAAA......hABA...,2,-35,-20,15
eCYBKQAgMcESZOIbDGLaJFUPdHNXTRWfV,MEEDECDGZDAG..ODCHDIEEGEGELBFGFBGF.dBACHGAC.XEEGhAAATGAAfDHGhAAACCBEBFAH.KGGBAAIBSABChAEA.aBDAJCCA.NAEHWFFDhABA......hACA...,2,-28,-10,18
HIfTaEQFAgUVKOcbeNLPMWZRJBXDSCYGd,UGAEKFDAOAGFeAHFLAEF.MIEARCDGXBAG.DEAEhAAASGGEGGAFHGFAhABAIDAEaAFB.EAAFhAAAADIF.VDCF.cAFB...PGDEhACAZEAE..CBDFYFFChACAfBCC,1,-10,-19,9
DAfLYEGaMUCBOdXgeHVQcJPZRNTIWKbFS,LBADEEGAGCABaFCDMIAABCCG..XGGEeBDBHFEE.QCFBhAAAJAFCRFCG.IFAHhABAWBAC.KAHBbBEDhAAASHAGDEBF.AHHC......hABAfEHGCCHE.hACA...,1,-11,-17,6
XMKaYHSEdIfcZUNDCAeLgVOJTbPQBGRFW,eCDCLHECOBAHJEDB.....PEFBBBCHFFAF.MAEDhAAAaDGASFBDhAAAdFFD.IBBAZCAADCFCCCHHhABAAGEHgEBB.TAGFbFBH..hABA......hACA...,1,-29,-34,5
HMVSEDegNKOcaGBJXfIWYPLbZFARdCQUT,RDEHQECEUGGAHCCFSAFGDBAE.eABBKHBAOBEGGGEFXGAHhAAA.WCAFhACAYAHB.LCABhAAAbEFEFCGDdBDACGAG..MADC.EEGCcGCHhADABGDB....hAEA...,2,-14,-4,10
DBdeJMORaGCFSNIgQPEXYAUTbZHfLKWcV,UGDDTCBGHBCC.KHAAVFBFDGHH..BFBCeHFE.MBIFRDEC.CDFGFABAhAAASAAA.hAEA.gBFEhAFAECHDAAFAZDAC.WFFE.cEDCOAFE....hAAAaHEC.....hABA...,2,-28,-7,21
PTIHSNbMKFUAfecZLJGdOECQBYgXDaRVW,eCABLACFdFDHEEHHQFFE.BECFXBGDDEGARAEB.VBBEhAAA..TAGCHGBASCFFhABANEEG.hAAAKFADABAFfGAEZEFDJAEECEDE.gEADhABA.....hACA..aHGE,1,-3,-15,12
RDMEeIZTVKUBJOHfbGACaWPgcXFLdSYQN,CDADaHEE......PBAAgEEFFFADLDDHSBBDhAAAQGEEDIBEMAFFeAFAhAAAIEHCZCFDKDHHUBGHhABABHGEJECBODCHfDAEAAFC.XACHhACA....hAEA...,1,-16,-26,10
PTNOBQYHFUZADIVGXfMCdcJKWeRLSgbaE,DBECVFFAGBBC.MIBECEBHdAGB..JBHFKCGA.RBCA.LFGFhAAA.SADChABAaDFCEBAD.TFCFBHBAHEDDhAAAZEEDADEB..XGACWFAG.eCAD..hACA......hAGA...,1,-11,-29,18
aEfLGQKgdYASBFCUTHPecDVMbWIXORNJZ,SECHFEGACGFF.UBEBHEAG.eBEBDFHFMHDE..IBBDhAAA.OADAhABANEAAZBGDEDAGLAHHKABHdEEChAAABHBE.cDCAWACH.....XGDDhACA.aGHF.hABAfBGA.,2,-26,-14,12
UFaeQAEHRDKJNbWZcOfGXLISBVYPCdTgM,EEDGHCAEKDFGJEED......bBAFZGACOCDAXBFC.SHGChAAABHBFVGFCCABA.hABAdADFTDGFMAHD.FECGhADAaGAGAAEFDBGE..NCIG.fFAB.hAAA......hABA...,2,-23,-15,8
JdEgcGMOYFSHVWQaKLNXIZUCPefBDbTRA,JDAAEECDGCCD.MFBFOAHD.SGGBHABEQEGGhAAAKEEHLBBANADBZFEHCHCFeGCEhAAABAHADFAG...hABATGAGAIHEcCGFFAGBaHEE...XDFBhABA.IACBhAEA..,2,-16,-8,8
cKaOTbfWXUVNBCLQEIMYDgeGJZdAHSFPR,FDFHRBFFKACGOEBG..TCAH..fAAAUFCGBDEDCHAALAFGhAAAEFGD.IFHFhACADAFFeAHBGGDHhADAdGAEAABE.SCGEaGHDXCCBVBCEMFFBhAAA......hAEA...,1,-13,-23,10
bAEXgZaHfTJVOMRKDFUcGWSYNPCILeQBd,EFBGXEAHZFEHHAFF..TEGHOEHBMEDAKBCGFDDBGBBCSAAHhAAA..PADAhAAACHDALDAFBCHDABHChABAaBHFfGCA.JFDCDEGBWCAFIHAGhACA....hADA...,2,-16,-10,6
BacVfFbAGONdUYEMLZTCIWPeHgJDXKSRQ,OEBHUCFDMDBBZACE..CEDF.....IBCFeDGFJFDDXFGBhAAAKFHB..SBBDhAAAQAFBaAHDcGEHhABA..fCEBAIDAdGADEDDB.WFFDhABA......hACA...,2,-45,-22,23
PFgcGadQfUOTCZJXNLbMSDVKWREYeIHAB,BBCAFADAGECEdAAEUFEFCHHD.ZBFG..XBCGLFAE..MFEChAAADEIFKGABRCFC..EHEAhABAeCEDADDA..PDBBhACAaDAE..OHFE.JADCSAFHhAHA.WEHB.IHBAhAIA,2,-37,-15,22
cNgLMJKEUAaRIDYWCTPXeBOfFdZGHSbQV,aBEHDBDHCGFG....TEEFeADEBGAG.FFCAZEAG.SHEGhAAAQCAENABCMCIDhACAKDHH.AHFERGAA..IHCDhAAAPAEG..fBGHdDEDHBFGcFFFhABAJACDEDGD.....hAIAWHFAXGGF,1,4,-43,47
SVfNAcHLdPGBEJCRUQegZDbOYMaIXWKFT,LGFAdHCDGDDFBEGFCBBE.RAACUAFHQEBCZEBG.DGFB.OAEAhAAAMAIH...XBCHhABAKGAFTCCE..hAAASGGB.NAIAACAEcEGE.EGDDhABA..gBFGhACA.aDAB,2,-32,-12,20
CPXLTdNVbZFOQSefgWGaARYDUHcJMBKIE,RAGHUBCBHABCMEEHBGFB.KAFFCHHD.LEAE.dCCDbBGBZFDBOAAGhAEA..SFHBhAAAeFAG..gFFAhAFAWGAGACAC.DDIH.IDFB.EGABhAGA...XDBAhAHA.NICD,2,-30,-26,4
fTOMIeXNZbBWELJAVDQHdgKcGPSURaFCY,DGEGdGDDKBBEGAEBUDCEFDBE...CBBG...TFACMAAFeHCChABAZFFHBCHHLCFG.hAAAJFAGAEIHVAEG..hABAgEFESEGBaHAGOCAH.NIBF.hACA....EGHH.hADA...,1,-17,-28,11
CXMeLgHFKOQPfdSTIYNabZVUWEBcJGRDA,MAFHeDDBHFFGKGFG.QCGDdBDA.SABBIEHGaHCGhAAAVFBF.EDBFBEFAJAEFDFAFhAAACBAFLDADFHEE.hADAODCH.PAHD.....hAFA......hAGA...,2,-32,-5,27
VSagWZDMAQcHCXTEeONdIPUBLJfYFKGbR,QDDDHBBFTEDBEADDeFGH..OHCEdAEFICFBBAFCLBHDhAAAJHBGFBHDKFBDGEAEhABA.RBBHaGFC.WCAFhACADABHMCAB.AGFBCAHF.NEIC.fCFEhAEA.....hAAA...,1,-1,-11,10
JGWOBUPLeRKQCadSADNTEfcZgIbVYMFHX,DFDETCDHEHFG..ZCAG..IHFB..bBECVEBDFDGCHFBFhAAAJACBGAGEBDEHLAFEhABAKAABaEGH.ABBDfFGEhACAcGDB.MFIBXAEF..hAAA...OCAHhACAeEAHCACANEIG..,1,-3,-14,11
GYeVLUPfDXbAdZOECWgcSIHKJBaFTNMQR,ZDAHOGAACCCD.......gAAHSGEFHCDFBDGFhAAAFCFFMEDFREGHeAFEUAFFhABAfDAEDGGDAACCdEFH.hAEAEHDE....IHHEaBDG.NAIE..hAAA....YBBChAGA.,2,-47,-4,43
WAJPKBSUIZNMdGQcLOFHXVfbYaETRCeDg,KCGBSFDBUCDHZFFCMIDA..dGBHGBABLAEGFGBCVCEChAAA....fCAFhAAAaGHDTAGGCHFADGEDhABAAIACJDABBACAQFFEOFAA.....hACA......hAFA...,2,-38,-4,34
AYSVdREDUIcPGgKOWBCMbXFfeQZLaNTHJ,VCCDEEGHDBGD..UEGD..IBCEGAEAKGABBDDB.MABHhAAAFAGAeCABZFCGLEAChACAaCGEHAAEAFBAdGAC.PHDGhADAOFFH.CHCFfHGFNCIE..hAAA......hACA...,1,-12,-18,6
ENJAWKZYdTgBfLaUIMOVXQCPRHFGceSDb,KABHdACFBBEHLBGDUDGBMAEH..OHFCQDBD.CFHBHFDDhAAAGFAF.SEFDhAAADHGGNAIE.AHDCZDBEhABA..gGABaAHB..ICCAhAFAPBABcEEFEFHB.hAGAWAFF.,2,-31,-21,10
PCEBdRZKTMNUHAIabLfSgXVQYJeWcDGOF,aCHDLDDG.SEGHXFCHQCCDeCADDBBB.FCAHCCEGEFABhAAAdFEDRBFB.ZABCKGFFTFABhAAAMCCFUGCD.hACAAAHB.IFHG..fABBhADAYAFCWHCAOAHDBHHDhADA...,1,-13,-16,3
YOZBASMTcGCFebaVQLEPUdIJfXHDRWNKg,TEAHCAAGFACH...aDDHQFEB.EDHDdBAG.IBHHhAAAXBEEDAGH.NHEBKDGHhABAOEADBAECAEEASGHBhABAMCCEeFFG..LHAEPADGfHFHhAHA...hACAWEDD.,1,-12,-45,33
PGBYUHEdFMZSCNcAfROTbVLaWJDIXQgKe,RGAAODBG..VEDEaGBC.DAFD..XGGDKCFGGAAEBAEFUGGChAAAdFECFAAA.ZCGHCDDCAAGChACA....fFBBhADA.bBCAWDAD..IAHChAGA..eHCA.hBAA...,2,-31,-31,0
JgVHIfYNLCdPWGbODZFEcaQMeKBXRTUAS,JDECVBEEHDBC....IEFF..NDIEdADGGCADDGCDEAAGhACAaFHFeEADBGGGRAGBABBCSGGFhAAA.hAFAYABCCGAE.WHAG...OEEHhAFA...FCHD.hAGA.MFFF.,2,-31,-3,28
THWCbOUDRLYQZAcNFaGEJePSgKXdIMBVf,FGAHaHFEGFCDeFFD..SFCBKCEBdCHEMBBCBDCH..TDCAhAAAHAFDCBDC.UAABDBGERDABhABA.LHACZDAHAEEFEGGGhABA.JCHB..........hADA......hAEA...,2,-19,-16,3
JGAWMfcPSRHVEULYaeFZbdTNKgOQXCDIB,MBEA..fEABSFCCHBCGEEGGLHAEeEFBFGEHbCGFhAAAdGGAKCBDOHAG.CACCBAFHhABAAIBEPCEG.UAAHhABA.aEEDNDIA.........hAEA......hAFA...,2,-16,-15,1
SGEABVXcZNHFOJKLQaPDTUdgbeIMWCYfR,XCADZEGBHBECFEBFKFBD.LCAC.aEEBTEFH.UADAhAAAdHBBeAAEMDEECAHGfFFAhADASGHDAAIDBAEBhAGANDDG..OHCE......hABA......hACA...,2,-31,-13,18
UVIbHgMfEDXRKaQABOSNTJFPeCGLdZWcY,BACESABFJFCE.FFAB..eFHHGCCBdGFEZCEE..YCHBhAAA..ICBChAAAgFCAMFAFfGFGhADAEHBADBAFKAEAAFCGOHAC.PAEChAEACHECWEABcFFA.hABA...,2,-41,-10,31
XDaVRfSAcUGJYLeCgdBFNbTZPMEKIHQOW,UFFEJGDALBFBCBCG.BAAHFDAB....TCEAMFABEDCHKGAH.hAAAHCAH..OEBEhABADCIBaBHBRAGD..AGCB..hAAA.cACA..eACGNAEFZEEA.IHHAhBCAWHEG..XDGAhAEA.,2,-42,-12,30
adbYfJCURSMLAGIcDBFXVOWTEgHQKPeNZ,GAGEDIGGBDHEFGDA.OBEHEDECHGAC.QCCFKAEEeCBFaFFFhAAAdFHE....fAEDhAAACGBEUABHMEIDAHEGXABChACA.WDAH.....TFFBhADA.PFCAhAGANCAA...,1,-22,-24,2
VNEbgXMKaSBYHOFADWGRIUPeZfcLdCJTQ,DFDCRBDFUGGAeADFZGAGLGDA..JBGHQAFE.EAAHhAAAbCAHMEDG.KDABSCCDhAAABCEEOHBChACAAHFF.IHHD.fFAECFEFNACDaBAB.hABA..FEGE.WCBBhADAcDFC.,1,-6,-42,36
ZcegDEUVGTJIOYaRNLHbQfBASKMWPFdCX,SFFCMDBFFGCF.dBGECEEH.ZDBB..eACBDDAHUAACGEGA.JAFChAAAOFEH.aGGGNBAE.hABALBEDHCEC..hADAfBBEAAGEKGCB..WBHH...hADA......hAEA...,2,-24,-24,0
RELbIaPFCDXTVNcKGWfQgHeJYdMZOBUSA,LGECaBHD.FCFEDIFC..XACBTCDB..VFFAKDDDGBAChAAAQBAAeAFAJFCHhAAAMFAHOAGBBHFDAFABEADAhABAbEBDCEFF..WFEF......hACA...fHADhADA.,1,-13,-24,11
WHOUfCbXVPLABDSKGgRaNdQcJFYIEZMeT,DGGFSDCDKGCFGEDDRABA..dGBAQAGFJHEG.FACEEAGCMDEGhAAAeDGBHCAH.OFAHhABAfDEGCHEBXDGAhACAPBHFBHHGaFDD.NCCF.ICAG.hAFATBED.WEADhAAA...,1,1,-30,31
YcPQEbaLTBOCNfURZAJdgHXWVeMDFIKSG,dCHGHCCH.XBGGVDDADABCKEFH.GAAG..PGBCEADEaHFEhAAABGHHCDHD.UDBAAEEAJFAAhACAeBCAFHAE..IFHFhAFASAGG.QGFE.bAAChAEA.OFABRFDF..hAFA...,2,-23,6,29
RCMbFATXOEcSgKNHJPIYVQUGaZdBDfWeL,XAEHOFAD..EDFGSBBDKEEH.HEFDIAEEQEBFhAAAaCBB.BGAGDEIBeHCGhAAARFDFMDIBABAATGFAhABANBAC..PDDAUAGAdCDGfHGFhABACFCC.....FBGAhACA...,1,-5,-14,9
WbcGFVNPMeagLYZUEBfCIKDHJdOSRAQTX,TEBEXEEA......bBEGFHDCVDGFPBAH.aCCGgCAChAAALDDFZAFHhAAAEGAFBAFFCAHCDCIFJEBBOEEBhABAAIBC.cGBD.MIDEYFHBIACAhAEA.KAGA...hABASGHH.,1,10,-15,25
geHMKfIFJEZDYPNTWSdXACOBRbVGcQUaL,CFBAOAFFBGHD.RABHGEFCUAFF..LEAEHDCAMAIDKGDC.FHBCZABChAAADEAD...NAHC.SEFEhACA.AIDE.hADAcEBHaEEC.fAAAECCG.TBDGhAAAXGAG...hADA...,2,-33,-19,14
CHJLUeTgVEAGYSdKZRfQBOXDaNPcFIWMb,SBHDKEFDZABARFCD.QBABBAGG.OCFHaCCD...PHAAhAAAFEAFMEIFHDBALEGHhAAAeEHFTADDhABA.EGFBAIBCdCFDDAFE.ICAAWGBE.CHAC..hACA......hADA...,1,-5,-31,26
HbFPgAELBXNIcfJMVeGOQdZTaUDCWYKRS,LBBGBFHB.XEFCIAFD..JFBGVCCDGAGE.dGGAhAAAaBFEDBFF..CCHAKGFHhAAASGEDFBAE.PDAGhABAAHAA..cFEBMEAFeACCZDAF..hACA....WHAAhABA...,1,-6,-46,40
dgJWNPAfODEbTaKBZCceURHGXYILMQVSF,DDFBTDDFBAGE.ZDGHeEAHHFCE.GCADIHHCLEAD.hAAAMIAESBBBhABA.FBDBJAACNBHGADAAEGFHbGCAhACACHHE.....cAEF..XBGEhADA....hAEA...,2,-21,-15,6
RaOMdXNDceLYHUSFTgfGKJEVBCIQPAbZW,ZBEGRECHMDCAdBAHDICA.LAHBUGGEFEAG....TEGBGABDhAAAEFDGCAHFQCFChABA.AGAF.aEBDNIBD.cGGHhAAA.HDDGSFFFfADHKCACBEHGhACAIDAE.bGAChABA...,2,-23,-13,10
AOWMJXLFaGbCcUBVTIDRfdYNPeHgEZSQK,OAADJGEALECHFAGAGGCD..CHEGUBAHBDGF....IADDhAAARBDEdGAA...hAAAPFBAeAFEHCGFhABAECCDSGBDADBF.MFFGaHGEcDDFhACATBEFfGGBhACA...,2,-33,-16,17
cSBGEQMNeFKVgZCYALJWHDbUdIPOafRTX,JFEBDCAHdAAF..OBFGaEBG..RFCA...XCAEBAHAEGHFQGGBhAAA.MDDAhABANCCHKGBDZGAC.AEADLEBAhACAHDFD.bCGDIAFA.fEHChADASABAeHCAhAEA...,1,-14,-38,24
NDeKcOYIQgMLEAFZCWHPBRfbGVaTXUSJd,ZCFBCDBHHFGFRGACGCDC..TFDBSEAFdGACDHBAKBCC.OFHFhAAAQCFFLHEGhABAFBAFBDEG.bAFEaFBAhACAJADDNADBeBBD........hAIA......hBAA...,1,-7,-18,11
LESZMUHXYOaVPAdQfeWcKIJDBNGTbRCFg,QDGGeAFHKEACDFGCBEBG.GBAHRFBEFCHH.EDEBZACGUGCH.HADGhAAA.ODDHaBADAICCdGHGhAAAfAHA.hABAIGAETDDDCFFDSABC.XFGAhAEA...hACA...,1,6,-32,38
LaKBVfYeFUgPdEOSXWcQZTACGNIRHMJDb,GBADREFAHCCBMBGHDIFELADABGAH..VFDDeEAG.FEDAUAAEhADAdGCBOAHH..hAAASEAGXFGA.hABAQADEADDENIAH.IHGF.bAGFhBAAfFAE.hBCA...,1,-14,-17,3
WcJQaXSHTbNPEeCMVfUOKdZgFRABIYGDL,BDBAGFBBDDGHLBBE.JCHHXAFCHBEB..TGFDhAAANDHE.eCCFCAAC.MCAFhABAUGCHKGADdGAEZEEAFEDCAIHC.hACA..IBBEWHBA.aEAC...bACFhAGA......hAHA...,2,-40,9,49
VaDUTLcHGWgCFJSOARefYIKbEdNPMXQZB,RAGHeAEF..ICBFKDFGdDAHMFDBZDAEBFGEDAGE.LFEHHAAA.hAAAGADCCHBAFGGESEEGhACAAHHA..bFAEhAAAEBGGNCIG...........hABA......hACA...,2,-25,-24,1
ZIaTPcXNJFVAbfKSCEHRYMdgLeQGUDOBW,KDHHSDEECBFH.EFEFHCDA.RDBHMBBAdGACLBHB.eCAAhAAAQFEHDGIBOBEChABABHHFIACChAEAPCABXGADJEBEAGGE.fAHEYHDG.hAFA......hAGA...,2,-23,-18,5
HRDGNYXfKOWEZVQegaCAIbPJFcUMLBdST,..IAGHPHEEFCGEUGGC..BAECdEAEHDDBRCCHGGAD..hAAANBCC.XBABOADHEBAFhAAAQEFH.hABAaBEEAAIDcDGCSCADDGFDKGCF...hABA......hACA...,1,-13,-20,7
STNZOReGJBCQdULMaYVHDIfEgbKAWXPcF,XCFFFHCE..TBEFZCBDeEEDBFEACBAB.QDCFLEHBMFABhAAAaAHB.HADDIDGAhAAAfGBA.hABAEHDEKGBFADDD.PBBASFFBNEAAOGFE.hABA......hACA...,1,-11,-19,8
bXYBSZIQaFcUTOdCJARDfWMLgPHeKNVGE,RCBFDEAGMICCLGBC.HCFHKCGCGDECEHEA..XGGFhAAABACHSGGGICDEaABGhAEAFAAHTFCHCCBA.hAFAAEHE.WBCEeBDCNAIE.YFAH...hAGA......hAHA...,1,-18,-19,1
VZNUdIQSFeYCKgPEcbDHfBGJTWAMXLORa,LGBCOGDARBBAZAECdACHSFEB.FBAHeHAG.KCFHPHBEhAAAEDDGDEIH.BHGBhAAATAFFMCAB.aDHBUCCGhABA.IGHG.CHFAbDFFfABFhABAWFAF.AFFEXFAEhAFA..,2,-22,-17,5
CYOIbMGSTRNeUWDfPVZJQdgKAEaBXFHLc,BHCDHBCCCAGFOBFE..IGHGGABETFEBeFDEDCIH..hAAAVDFGJDABdDGC.AHEDEABEhADAaGAHFHGA.LADAhAAAbFBH.MFAESDDA...hABA......hAEA...,2,-18,-16,2
ZAaMRefSIQgLBCKTGcOHUDJXEWdYPFVbN,RCGFSDBCQCBCBGDAKDED.GACFHFACDADCEEED.dGGBFDGC..hAAA.VFAHNICFZAFGaBACMCAFhAAA..eFHFfGDFhABAIHFDCHADOABC....hAGA......hAHA...,1,-7,-15,8
HaJOBScdVbZAQEgPMRNXYeIWTfFLUDCGK,EDEHMCEBRBCF...XGACeABF..IEAATFCH..FFGHUGBBhAAACBCFHBAFaGEFBHHFhABAdAFHZCFEAADE.QEABhAAA.NIEF.fAGC.DEID.GDFChAFA.OAHDhAGASEHB.,2,-6,-2,4
aSPWDBYgdAGFbONTVJeEcQCRZMLUXIfHK,FGEGOCFA..TACGJGAA..EECDCGHERCDBLEEE.UACFhAAAIFCGKDCC.aBAHSGHBhABA.DIEAhADAgBGDAHHD.bAEFeAFA...hAAA......hABA...,2,-42,-24,18
GOCTSXYRLJVcDAUbFWEadfKeQHgNZPMBI,UBAGFFEEEFAAdEEE.KBGBeADC.HBAFZCCDBFBGGCGG.CGBHSCEHhAAARGEALAFC...hAAA.JDGFDACD.AAHBaGHDhABA.QDCE.NIBDMAIB..hADA......hBAA...,2,-44,-2,42
VMdHcDENTaYKXeLGUORFgQbBAZfCWJSIP,ZGDACDDE.JEFGSCAC..VEABdFDFDAFF.EABCTDCHhAAAKEHHLGEAGBDHUBAAhABAOHAEFAHF..QBGFhAAABHHDAFEBfACBIEBFMEAFhABA......hAEA...,1,-17,-30,13
NBcZUgHYOMXVdTPSJCLQGaKWfebAFEIDR,FHFCDBGDRECDBBDDZABD.UGBFHGEA...OBEFMFBA..dBAHSAABhAEALEHDQEEGhAAAaAHB.KCEGWCHHhAFA..eAEGEGAC.NDAC......hAGA......hBAA...,1,-26,-30,4
ODSHaBZFIcWfbKTdAGRJCXLYEQPNgUVeM,JFHDLDHH.EABGQDAB..gDCDeHAADAFCSACFhAAABHEHZFDGFGBFhAAAIEDGfCFChADAKBDGTFEFAAGHCEAF.PBHF....hABA...NBGE.MCCAhAEAaHEE...,1,-17,-30,13
BZeOSIRFLVGAcYXEUJWfbagTCdHMQDKNP,XCEHUBFF..JEEH....WCCFaDDB..CBDE.dGGCHBAChAAADEABKAAFBDHAZADBOEABhABASGAA.FGDGhABAVGBEABGC...EHFC..gBGAhACA.MEIF.NIAD.hADA...,1,-30,-31,1
WKDcbMPBERAUNaLOXIGdVJgHTeQZCYfFS,aAACXCABGCCBdGAA..JGFAHABG.eDFHCBCAFBGCKHFA.DICGMAFEhABABECH.AAFELEHDhAAAODFE..gEBGhACAZEDDSBFF.WAHD...hADA......hAEA...,2,-35,-10,25
IcEdBOfaegXDYUPbAMZWSNQTCRHKJGFLV,MHBASABA.QCFDCFFBKCDAFCAALAHF..VFFAhAAAEFACBAAGaBCEXGBFhABADADH.UAFHAGCCZEGBhABAWEAE..TAEA.....hACA......hAEA...,2,-36,-26,10
WUTeRGbHgIFSZPNACOQKacXBLVMdDYfJE,QACBKBDF.aDEGXCAB.LCFEMEFEDBBDfGDEhAAAEAGBUFFDRECDHDFFhABAFFAC..SDAAhAAAZEBDAGIFCAHFBFAEdHAH.JADAWHDA....eFEBhACA.....hABA...,2,-17,-11,6
LfWdXSFcIJEHGDUAOQYPBTRMbNKVgaZeC,OBBAQDAFBAFDMFGBKHEE...aFEBCFGCLFDDdDFD.FBHFhAAAIBAG.EGBAhAAADGCDAFHG.TCAFRBDFNIBB.hABAZCECeAFC.fBGCXEAGSEEBhABA...hACA...,2,-31,-18,13
OFADXIQcLMEJCTHSVPZWfYUdKRBeNaGgb,DGEFQAFELFCHMDCECHBC.HDGF.VDAFZBCH...fFEChAAAdHGHKGGCeBEGNIDF.hABAaBGA.GBAGOBBEhACAAAHE.IHBGJEFGSEAD...hADA..WCEG..hAAA...,2,-28,0,28
OHAVTcPfULQegdXYGCDSENKJbBMWaFZIR,TBBC..fEEHQDADdBFDGEGCCAHEDADC.SGBBhAAAEBDF.JBFBMEHDhAAAaADEZDDFIGBCOAHFhABAABAAVCAH.PHDELHDC..XFDGhABAKGAD.BACDhAGA...,1,9,-32,41
LPKVMfYRNTBIZdGgEUCbQJSeHFaAODWXc,DGHHXAGHLADCKBDG.MBCF..RDEBBDBAZCAHdEDGEBBHUCGDCAAA.hAAA..JHBESFAFhACAFFFH.AGEBODDHhADA...PFHBfAHCTGBCIAAChACA...hAEA...,2,-33,-30,3
BcZgEODTJYSaQIHFWCAXLGfbMKRdUeNVP,LDCHGDBCMIDCdBAFUGEEeCAH..VEFBBCFD.ZEFC.OAFEhAAADCCAJBHB..aHCGIAGAhAAAHCAB.CACCAFEFXADFhABAKDDE.........hABA......hAEA...,1,-20,-26,6
PTCSFVDHRMWZcQBEgfJKeAbGXYaNILOdU,XAGCaAFDLCHFUCCC..CBBE.FABCDGGBRGDE.ZECFBBEE..EDAChAAAJFFGADIH...GEAAhAAAIFECdDFF.TADEhABASDAF..VFAB.MDDE.hADA......hAEA...,2,-27,-19,8
OVJAHMXKZSagbGLPTeCNRBYWQfDFdcUEI,MCBCKEHHZAEE..SDGHaBAC.GGEFLDEGeEBBRDAABHCChAAAQAGCDBIBFGFGdBAChAAA.UEDF.ECEFICFFhABAOEAHAIAG..XFAC..hACA......hADA...,1,-3,-37,34
gOFcdXCPUSJeDabLQKBMRVITWNAGfZYEH,GBADZDCHEAFDHEEGFGCFdEEBCDAD.UAFA..SAAGDHGALAAChAEABBCA.MFCF.IGHDhABANCIAAHBB.fCEGhACAOFFB.XAGF...eHEGhADAaDFAKEBA...hAEA...,2,-24,-20,4
eCXVfFNGcPMHJZDTgLESAbdWIaQYUOBRK,dDBHaDCD.QADCUBFBBHACKBBH..eFEACHFA....fAGEhAAAFDAHGABGMEIBhABAZGEGDAGALFAAAEEH.hAAAIEGEODHFXGBHNCFEHGCG...hACA......hAFA...,1,-21,-22,1
QeBJDMWcfYdaKUSbRHEFAZIGOTVCLPXgN,GEDAOADG.CCEBLAAG..gDGEeCGDDFIHMEAEhABAfDDB.dHCFaCCChACAKHGCSBHFhAEARDBDHAADAGGEIBGATFAGXGGHBHFDWCAD.hAFA...YHAGhAGA.EGFH,1,-1,-28,27
PIeLQJUSCTaZBAOfbXMFVRNDdGYcgEWHK,OFBCXGAFFGFARFFE...dBCFGADH....gDAFhAAAECDHKBCFICHEhAAAQDDCSGDBhABAaGACAIDCMBIHDEAG..WDFGeDHDLHFACBAG.hABABAHE....hACA...,1,-17,-20,3
IPgFReJYSaXUBGMZTHOADKfNbQWCdEVcL,KDBD..bFCFCHDBdCFFECDA.LFGF..gFGHeDED.hAAASBAFaHAEBABHMDDBhABAZAECHFED.DCGHhAAAfAHGNCBCWFAD.IGAGFCHD.JBCGhADA......hAEA...,2,-34,1,35
XcbZTCLWGBYAOMERHSdFPDfKQVeUJNaIg,EGGDSEDBFFHF.DABHQCEB.UFBANDCD..aFBHIDBBhAAA.XADChABAbGFACBDEGAGCBAGEAHEEhACAMADCdEEH.KCADeAHHJFFE..ZFCFWFAD.hAAA......hACA...,1,-12,-20,8
LWeDJNaFPcMRKCgTBfIHEbVSYAXdOGUZQ,XCBCOBFAUACCLBAE..eBAFDGBAaGEDFDGC..MICAhAAAKAGECDEBBFEFHEGHEFAHSDADhAAA.AGGFdECHhABAQGGH.WGCAPBHF.cGCDhACAgCDA.hADAfEBD.,1,-7,-27,20
DSPUEHTAJZWLNaRdQIgCBfeKGOcYMbVXF,JFAGLGEC.RACGdDHAQDGA.CABEBBCAeDCAKHCG.OBFChAAAMFFB..XCEBhAAAFCAE..SGAChABAEHAEAAIB.NFABaGHDIGHE.fAFBhADA.YDDHhAEADAEA,2,-54,-30,24
BOaNgTedFSAVHWCJRMEDQcKIXfZPUGLbY,HBBDCECDRBBG.DDDAKFGE..IGDAZGAEGBEALABEBAGD.aGHB.hAAA...TGEHhABAeHAEdAGHAIDC.VDFGMDABhACAcEEH.XAEDUCGA.ODBHhAAA......hAHA...,1,-10,-26,16
WSQEfcDXINeZbYKBMGAVFdCPLHUOaTRJg,VGCCdGCDCBGEHGFG.UCBCOBHF.RAEH.JDFH..SAABhACA.EDBEfADGhAAAXFFA.eEABYEADhADAMBIHAEEH..FDFEaBAH...WHAGhABAcACDDAGC....hAGA...,2,-27,-20,7
bNMHZRWQcaYJKVPEBFDUSgeALfIOdXGCT,LCCHOACAdEFDCEAG....TFEBMCCDHBFDRCGH.QGADhAAAaCBHKGHF.PDDHhABABAHADBBESBBEhAGAAGBFXGBHNDIE.ZADHWHDE....cGDChAAA.....hAHA...,2,-23,-17,6
dKLGBJPRfeOICSVDTAMFEWQHZbNgYUXac,EBEAHDGHZCBA..NEBG.UDFE..aAGFKEBBLCCEBAEFRGCG.fBAGhAAA.eDDFhABACHABDGIFAGFCMDABQAADhAAAgGCG.YFHBdAGE...hACA......hADA...,2,-33,-2,31
eaEfAZKBFUSLCGVbgOIJXDPNWHcRdMYTQ,ZECHBHFEFCGBLBBCGBAB...VDGBOFBH..XGDHhAAADFIH..PAFGhAAANCAGHCEHdFEHMFBH.QDCDhABAEHGGAHFFKDDCCADBIHHF.JAHF.hABA......hACA...,2,-25,-5,20
bUZFQKARSeTNfgBCHLdcIYJVXPaMOWDEG,RDDBSCGAeBCC..TBGG..fEGFBAADCDFHdGHCIFDGhAAA.YCAHhABAXCBG.PGAChABAaGEDMCFBDAFCEHEAbAEAUGGH.QCCBhACAAACA.NEAE...hADA...,2,-23,-18,5
IDRHNTUKaFBEeObCLQXYJWVSGPcfdMZAg,DBEDRFEFHDBBUEGFKAFCBHEG..eBCE.ODABLADE.XBADhAAAJAHBSEFEhAAAGCCA...fHGDhABAdBHCMBFBAFFFIDDEaHAEFHGA.CGDC...hACA......hADA...,2,-25,-25,0
NeYCZKfTbBaAGWRcdUHVXFLEMJSPOgQDI,GDDDRDFGdBDGHAGHFHGGEFCGMACA...JFCASBEE.OABBhAAAQFFCDAEAIFHAhACANBBA.eCCChADACAAFfGADBHDHACHH......WAHBhBAA.....hAGA...,1,-18,-30,12
dHZgIEaRDLfcXSNFCPYbMQGBTKUVWAeJO,JFFHOBFCHGBGZFFE..EDDADDDGLABH..fHAFhAAAXBGCSADBhAAAFBAEPEFA.MFAABEBDTEGAhAFAKHDGUECCAHHHdGACIHHE.aABA.hAGA....NAEB..hAHA...,1,-10,-21,11
LbBSCfFADVgYQWPTOMUdJIXKGaHReNcEZ,DBACVDCGQEEA..TBEGMCFGJDACXBGD.KAAEhADAaAGCHEGHRFBB.eFADhAEANDDB.EEBBLHEEhAAABCCF.SACBfFFGAEAB.....hABA......hAEA...,2,-26,-6,20
FHKgESeMBVNRICPTGdWLZabYODfcUXQAJ,FGBCHCAGKHGCEFCC.MFIFBAEH.RDDE.CBBFGBECLCFCZBGF.aABAOACHhAAA..DAGAUGDGhABAAGHHSFAChAAA..eDAHIGED.....hADA......hAEA...,2,-39,-11,28
HcOQZGNYMRWIfJFAEDSdaCUBKegVXTbPL,EADDSAHDdEGH.UBCBeDDC..VFADXFAE.TAFFhAAAPEFEHBBF.QGGChABAZGDANAAH.MAIBhACAICFCfFECAEEFCHHCBAFAbFCD.cDBHhAFA.....hAEA...,1,-3,-21,18
TUaDdZJXPKObfGQgYVNWcBFELSMHRACeI,CECGeCBEUCDEDIDE.ZEEE..JFGFKAHH...OAAAGAEDQCFChAEA..YHCEhAAAVFAH...hAFANCBE.BECHLACDSGGAMEADAGDEIDBHhAGAaCGE....hAHA...,1,-31,-32,1
GeLNDOXWAPKZcQVYRdgHBMIUfbEFTCSaJ,ZGEEQBEDREBAHBAFBEGFMFHH.UACG..ECCHCAFG.JACELGAGhAAAODEDAHDHKCEB...hAAA...cGBBhABA.dGEHgBGFbAGBSCAD..hACA......hBAA...,2,-26,-19,7
WFTMZfSBYPEGLJRcOIQUgDebHdCKXAaVN,VFFGFFHDZADE.BECGEBCC.LFFD..RFBAOBBHQCDAhAAADADAHDEAKDGB.ACEAaBFAhAAATCAF..MIAEhABAfABGSAHBPHBGJHDC...IFAChACA...hACAeAHBCDDF,1,-16,-30,14
RYcgKOQWeZbBEXfJdVLFGPAMUDaSITCHN,UGAFaGGF...SHFCTFBFHAGFRCDB.....gABFhAAAOBABeBEEBBEGhABAXEGEdDBBFEFBAEIBDAFChAAACEDANEAAKBBEQGDD..ZFCF.EEAAhABA......hACA...,2,-24,-4,20
CJaUBeAIKZGXdLTYPgQFSfcDRHMENbWVO,ZGBAXDDAdGGGLAGF..TGAD..PBABQAEDhAAAFECDSCDEhAAAfGDCREEFMAIHEFCANEICbCAGhABA.OFGDCDDBaBBFBEBCIBCF..hACA.KAGC.gEAChADADFIF,2,-24,-8,16
MXUbGgRPQFfLTCScdVOIKBHJEaAZYWeDN,ZABBeAADDBGFMCECUGEBGFEH..RDEGFAEBLEAD.TDCEhABASHAAdDGBOADAhACABEDG.EGBEAIHE.NIAB..hAAAXBBF..PAHBfHEDhAHACGADIBAH...hAIA...,2,-44,-2,42
cgIBWDMTXOJRHKdQfNFELaSGAVbPCZUeY,VAADCBHBUGFE..eHBG......gDDEBFGDDHFCTDDEhAAAJBAH.KEADdFAChAAA.QGCFhABANGBF.EDGESADBACCG.PDHDcAEBhACAIAHHWFHB.OCFAhACA.,2,-37,-28,9
FVBdJXbZRDGfPIAEHONTQYLMSeUacgWKC,OEDGQDFELEHFSCDCeBFCaEAH....WAEGhAAACCBCBEBCdGAD.JADDXGCDhABARGDEDAAF.GCAChACA.IHGBAHAGNIABMDFG..cEDA.hABAKBBC.....hACA...,2,-25,-9,16
YQZASMPONURBcEWdfLJIGTHXKaCbeDVFg,MEIFOFECRBEG.BBHA..EEAFdHFBLDCFJDAC.GAABHACEKFCEhAAAaHACCCHHDFAH.FGCHQGEGhAAA.ADFDNEHChABA..cBFG.IBACbEDEeAEE.hABA.....YEHHhACA,1,-7,-32,25
TdKRDJcWLVaCXYUfIQbOSFZHBNegEMPGA,KHDEJEBHLFFFCFDF..XCFBUACD..QCEAhAAASGFBFAHHBGAD.NACH.hAAAeCDD.MABDAFBATCBEhABADDHD...cBCAaGDFIGGGhADA.OFAH..hAFAHEGD.,2,-44,-13,31
ERKOgCTcDeYMNBUJXZIFVPGQWdHSabfAL,RAFDKAGBCDAE.DGGF..MHDGUACB.ZDDDFECB.GAAHdDHAHDAA..hAAAaFECAHEFLFCFhABA.EFABOEAH.hADAgCDE.eHBGBHHCXDGHhAAA.IHHHhABA...,2,-29,-28,1
SfIKXUOYdRcBAZHaFNJGECbTeMLPgWQDV,aFAEFAFCGEEA.CBCG.eFFGLEAH..WABAQCFFhAAASDHBKECD.XDCBhAAAODBAdHGHRCABAHEHHAEBhABANCIA.EHFAMIAEgGBADACGfBAChABA..IAHHhACA..,1,-5,-17,12
FfRaeOEJVgQPdLbNcKBUIHGXYSCDZTMWA,FCAFaHDG.eFHH..ECFFJECHQEGH.LACGbAGFKFAHBAFDhAAAIBHG.GEAFhAAAXDDFSGBDhABADGFEMCCGfCCFOABC....hADA....gGEGhABA,2,-26,-24,2
DgYWKeHGQEVXIPdabNSJBfORMAZCTFcLU,ZCBHTEBAFGFELADC.DAABgBEA.KEFAeBDFhABAQAAGEFDF.VGDGhACAIBHHaDAGSBHFhADABHACOCGHAIAEcGGEWHFA....hAEA......hAFA...,2,-31,-19,12
gYDEVGKWPfbMRdHICeUFXcBaSNJQZATLO,TAEFOAECDHCE.GDGGKEFH..PHCGMDDAHEAC.CABGFCAFhAAABBBC.NBICJEADAEFC.hACALCDFEFFD..hAAAWAHBfHFF.dDAFIGAAhADAXCFAaCCG..SABEhAEA,1,-15,-28,13
WDaINVSAZEeXCfRHGFKBMQOJUbLYgTcPd,eDACXBBARDFAGACFBGFA...OFCBJHACLDAD..hAAATGDEdDFGDEHFIGAGhAAAVECHZBECEBAFCABC.fGGGhABA...FCEEMAID..hADA......hAEA...,1,-7,-27,20
AObcCdVQTZJgKLMYENUWeaSGRFHBXIDfP,OAGDCGHAdGED..QGAHJDCFLGBA..MEDAEACAUFGGhAAAeBAAGEAFRBAH.FAAGhADABEECXDGHDFFFADIH.hABAVBEGTAEG..KAGENICD....aGAHhACA......hAGA...,2,-21,-7,14
KDEBOAIgXVLYUdbHTGeFcRfQMNWSaPCZJ,XAFCLDCHdHDBHFGFeBBAFDEC.REAH.QGDDMCEA.SBBGhAAACEGFKFGGBDAFACHGVDABhABA.UGAFbAFA..hACA.cDGFfABFaDDH.....hADA......hAEA...,1,-3,-23,20
WVEQSLbUDJCcXAdGIKTFOBZPRegaHYNMf,dDBAGCAEKDGCFABHBFFF.RCDG..eADEaGFBHDDAMEIB...VGAGhAAAEHBCQAGGhAAA.SGEGhABAUAEECHHEXAGEAIDGIFCHOCAHPACH..hAIAYFFC.fFDEhACA,1,-16,-18,2
eWLYEgDVSNOHJPdGRbZABcCQMaITFUfKX,CCHEMACH..aEEFFGCDUBDAKFAA...eHAGLECG.EGFGDAGGhAAA.SGGFhABAOADHHAEDJCAFGABAhADA.ZFACAEAABAAG.IAHAfEGDhAEAXEGE...hAFAYHEA.,1,-15,-27,12
dUANRYHESVJTCZQeWGfMgIDBFLcaPXKbO,RADGHBCHEEHD.SAEE.JGCCTCDECGGD.ZBAFeDFGGGAFhAAAMCBDDFAEBFEBFFFHaDGGhABAKBHBOAAGACCA.NIAH.hAHAQAGG...fHGFhACA.....hAIA...,1,-4,-26,22
OYENITUAcXPDebLKBdaCFQMVZSRGfHgWJ,XGFDDCCFLGBAKADA.BGFH.dEEFFAAD.QBGHZAAERCGDHADBhAAAJFEB..EAGGTFADhAAAACID..eCAFaCDAMAFAhACA.GDAH.WEFENIADIHHAhABA..cGBEhADA.CHHB.fFBB,2,-19,-11,8
FbCHMIWGYNULaXPeAdTBQRZJSgKDEfVcO,TEDEQFDD.RBABZAFESADA.KGAGEGAH.VDFEOEAGhAAACADAHCCFIGGBhABA.GAGAUGGCaABFhAAAXBBCACIBdHCHBFACDIBAfGDG.hADAFCDE.MFIH..hACA...,2,-20,6,26
CIWAeNMSUJOGgaVYBbTLfQKDXZFdRcHEP,eBAGMCGBUADDOFEGGFDF..gBGHaEAE.VGAChAAABEDD.TGBELEHHhABAKCBGDAACXCEFhACAZBGHdGACRDBCEADCCGHAABBE.NIDDSGEA..hADA......hAGA...,1,-2,-18,16
RVXIaGTfNJSMEbgBZLFKdWOAQDYCePUHc,QEBCDHBACAFF.UCDHHEEGRFFF...IEADTGCEJAHFSDDChAAA.EADD.hAAABABGFAFFKACD.OBABhABAAIHEPAGF.XGDHfEGDMBIDhACA......hAEA...,1,-19,-38,19
XIePESdJfLQbAKYUNMZDTWGcVFRBagCHO,KCAAUAGHZCEBDBBCGBGG.FFAHBFEF.aCCCCABAHDBG.OGEEhAAAeFCHEEBF.dHEFJAEEhABALAAFAAID.MEABhACA...TFGB.....hADAWDEA....hADA.cBEH.,2,-27,-26,1
OXIGeTMJZUSYEcdFWRALfgHDbPVNCBaKQ,LCEHHDAADFEC.VAFCCHBHBBCC..aACGKAGA..OFGHGEGAhAAAeDBBTCDFZDCHSAADhABAEDFA.dFAGhAFAWCFEACCG..gGDAPFAB.NCIE.IBAEhABA.MADAhACA...,1,-3,-30,27
CeDUMYFKLVGbQOfHWdPTSBZIEAcagXNJR,aBEGXCDE.RDBH.CCEHeGDE..MCIBKHBALEFCGGCBOFGFhAAAHDBHdABFSABGhACABCBFEFAHAEAEgAFGhADADAECFBHFQGGCfGAA...hAAA......hAHA...,2,-14,-12,2
DWVFCYQLgdeEJAHTRNXcPaMbZISfOBUKG,RGAGXGAG..aECAMBABZBAC..SADBBGGDKDCHGBGAhAAADAFBFHGG.CDBCLAFEhABA.eBCEEFFGAFDFTFDDhACANBIA..PAGH...IGEAhAAAOFHF....hABA...,2,-39,-11,28
ESBFOLUAeQKRDIJfbcCNgdPXYHGMZTWVa,KCEGDDGH..JHCA..bGEE..CAFE.dDBH...XGBFHCCHGDAAhAAAZAAC.VFGBaAFAEDHFhABAFABALAHBhAEAAGID.eEEBIEEH.fBFDhACA...NEAA...hADA...,2,-29,-19,10
LgAJEVFTWeYfHBONZcaPbRQDXCUKMSdGI,VCDATGGH..eAABHCABBBHBOGCAZEAD.aBAGREFB...XCFDhAAACGCGKHDG.dADCLACEhABAAAHAFGAD..fDDGhABA.cAFA.....hAGA......hAHA...,2,-35,-6,29
OLJTBSINDXaQKEMHPbdRYgGeVACWFUfcZ,FEABUFBF.ZBDBLBBABCAD.SCDADHEA.QDGBhAAAMAFAHCFEdGGGRFFEGABGhAAAABGFfACH.JHBAhABANICH.aCAC...EFEB.PAHH..hACA......hAFA...,1,-14,-27,13
gZVWHfGaeYFdNEQPDMCRTcUKIJOABLbSX,BDBBLEHBSFFBZCDBHDAAGFAFaFFAFBCGdDDB.QBFAhAAADCGECAAE.RACA.UFAHIFHAhABAJHDG.ADIFXGEDhACA..WACEYHAA...hAGA..EDADMGDG.hADAKHAA..,2,-15,-15,0
BWgafKPCRbDMTHYGUSFdEANcJVZQeILXO,JAACZEFEQGCHLDFFBEDG..aFADKHFCCEBE..RCDC.MECBHACEhAAAGBCHFGGEdCGAABHC..hABA.NCAG.VDGH.eEABhADA...OHCCfBBGDGAD..hACA......hAEA...,2,-20,-16,4
ARFZONKgeUHXaDLEYVcSPTMJdBGIfCWQb,RADAZEFBOCBCKBGHUCDGHFDE..DBAELBHF.EEAHVGAASAAGhABA.TDEHhACAJADEdFDFBFHA.fGCGhADACDAG...WHFGAFIDNIDFeCAEhAAAXGAH....hAEA...,1,-13,-35,22
UGgZWbKCaIMNFSJXeELPVBAcORdfTHQDY,RGAATBBHQBCH.DGEEUEDF.GBGCZBFEKBAHaGEH.MDABhAAAFAECSGHBhAAA.JHDEeACE.EGCDhABALDDABGAHAHGDcBED.fFHAhAFAgDGH.CABBXDAGhADA,1,-15,-26,11
GeAOCXHQgNJcfdWESKRIMFVaDYULZTbBP,XFECQCBF.JBEFdCFD.EGAGRGBEFBGDDDBBLBBC.ZDEChAAABFHFeFHHCABDHGFAhAAA..NIAF.fEEEhACASCCBKEAGMCAFaDGE......hABA.YAHH.hADA...,1,-8,-27,19
OPRCcfWQgdaTYLJZNHBGKIUDAbeSFEVMX,eDADSAHHFCDD.EDDGMIAC..XGAAOBHFRFEE.CBCE.fHGDhAAA.gAEHhABAaEBFLHFAhAAAJFFEHABCBDGDIBADAIDAVCAHPDFA.hABA.cAGB.WGAAhACA..,2,-23,-11,12
bZTDWUNFfBHRCEVKLSdaXYIeQcgGPAJMO,MADEOAAAZFBGDFCFUCFD..FCCBHCAFCAHG.EGFALEEH.hAAAdDHEaBBF.XAGEhABAIGAF...QGGHhAEAgDCHAGDFbBFCNIEDBEHH...hAFA......hAGA...,1,-7,-37,30
cENUfXGJdFaQHPCDRMOZgIWTKYBLbAVSe,VCDFeCACEEAG..UDGEGGABdGGAFGBGQEGA.CAFCMDFDhAAAOACCZAGD.IABGhADATAGDBBAFLDDHhAEAAFFD..SEAAfGGG..XGEGhAAA.aGAHDCEChBAAgCAF.,2,-24,7,31
IgVFWYeCQEBdPDTfJXHUOZANbKaLRScGM,KFABLBHHRAEFGBCGMFHD....IDAFFHAGeACA.EDFHdFFHhAAADECGJHBE..HBDChAAAUCGAZDABAHHF.NBACaHDGSABChAEA.........hABA......hACA...,2,-29,-16,13
ecIPRgBOdYCALGZTKbEUaQSfDWVXNJHFM,LECEGGABZADHKAABUAABQDGHDGFA...XBDDhAAAJDFEMDDBeGDC.IGBChACA.RAFBOHFEhADACHFGAFFAEAFG.aHACSBGA..fCBHhAEA..NEIEFDBDhABA..,1,-17,-25,8
TBKMgXLFRSJHWcbAYPedCfVEDUOZGNaIQ,eCGDdFCECEGF.ECBGDGHBUEDB..GCAA..NBAE.aCDD.QAFChAAATGFGBAGAMIDGhABAXFAH.LDHHhAAAFACDSBHHWBDBACFH.fHADhACA...OEFHhAEA.KEHH,2,-30,-13,17
cgKRbTGYBOAWdHPfJQZVCMEUeaDSFILXN,dCBFHCCGJEFFZEGH.MGBGUECHDEID..FHCGLADC.XAAEhAAA..NEIAKBFDhAAAbGCA.GBGGBAHGAFFE.hABA..fBEDCABAEADC...SGGDhABAIGAH...hADA...,2,-42,-11,31
RODPBfICMULFgcZWJaHXVESGeKNYQdATb,TEFBRCBHDGADBHHH..CGCHLEAGFEFG.ZAGHJABGHBCE.EAAChAAAeFDDKFEF..NIAH.dBGChAAAAEBC.OBAB..hABAIHHGMAFE....gFGChBEAaADA.SFBDhBFA..,1,-21,-30,9
GPQFMWXLbgVKCJTYeSDBdROIAUNZcfaHE,ZEGFaAFEGACEFDCG..XFCDLGFG.VFAFCEAG..TBEHhAAAeDFASAAGhABA.BEEDdGACIBAFhABAAGDAcCACEEHHQEECMICG.WADChACA.KCGGDAIF...hAHA...,2,-35,1,36
gSfeFYTPRMcJOIENDLXHBCaUVZWKAGdbQ,dFEFQBBBSFAHFFAE....PCEFMBIHJHBE.EDGDNADB.hAAALBAFBEHACECBUGEEhABAZBCGAFAD...bAFAgDDChAAA.fHGHTGCAOCABhACADBCE.aGHH...hABA...,2,-27,-8,19
OgFLATYKZSQdeRMfXcVUHbGCDaWJBPIEN,KCEESDAFeFEGRFAH.MABG...XGACVABFHDFA.CHDCDAABhABAJCDFBBBE.IHFEhAAAOEBGLAFChADAACEEZCFBQFGEfGHAcEBH..hAFA......hAGA...,1,-13,-30,17
GeIACEQgPaNVWBFLHMXUKOScdfRJbDTZY,EGCAQFFB.aCAFVBFB.FFGEMFDBKACC.OBFDdEBBRAAH.DGAAhAAAZGFAeADB.IABHhAEAAAHDCCDC...NIEBBDCDhAFAXGAD..SFHH.hAAAfHAF.hAFAJAHB..,2,-31,-9,22
eHAJRVfTgYZMKNPcabDEGXSBIFdCLOUQW,JAFHRFFE..TAFGZBDFKEAD....NEBD.aGFEDIDA..GABAhAAABFCCdBBGOFDFQDGFhAAAeCGH.AABAfBHAhADAMAIB.bFAHSHBE.CBAF.hABA..WCCE..hAEA...,1,-25,-30,5
FPAaECfQOSGgdVMBYRWeNJDcXKUHLZbIT,EGDACAGD..OHEGSADAdEDCBEBARAGBeBAD.DGGCKCBA.LABGhAAAZEDETCDFAICA.QEABhAAAGCGAVBEHhACAMHFA.NIED..XGAA....hABA......hACA...,1,-7,-34,27
bYICKATeVgGPDacBdJELUSRHQfWXZNOMF,VBDBGGAD.aFEAdFHCLADERFBD.HCABQFEE.XAGBhAAANBIAFCDD..IDGEhAAACDBCABCH.gABDhAHADFAFBACEEBAF.SDGEfHGBhAIA..WHEG..hABA...,2,-31,-4,27
EDVCYdgLGAQRfKJBeUMFWIbaOHTZNXPcS,RBDDJBEAeFCE..UGDFMDIDFBCF....IEACOAABZEAGhABAXBAG.SHDAhAAADIGECEEE.YCGBhABAdGGHLBHH.AEAEQGADhACAfGBDBGGDaCEC...hADA...,1,-21,-29,8
JcETALQbVGRXOKgIYSPafNHeFWBZdDMCU,QAGGVBGH.RBAAKFAF..gGFESEDCaBBAHFFBhAAAeEBAFEHFBCADDABGMFCHhAEACHACJAEF...ECDCAGIHLEFAhAAAbFDD.XGBB...hAFAOAFG...hAIA...,2,-12,-11,1
MNAeLcJIPfSOaXdYBbWQCUGTDEHZVgKFR,LCGDJGEE...IEACSFBHOABAdDGEBABG.hAAAQCDHUEDDDIDCEGAHhAFAZAFC.KHGGFDAENDCGACIB.hAAA....eDHBcACE.aGAHbBCACCAC.hACA......hADA...,1,-17,-36,19
AMbdTXSQWeKgLOHEIRYFZGDUcVJafCBPN,MDBDTFBH..SGFCeAAEKDDBLHEEOHEEHCGBRAFBZDFEDAFHhAAAUADCJBAG..CGADBECBhABAAAIB.dADAXFGAhAHAQGCGEBBD.IEEF....hACA......hAGA...,2,-22,-8,14
cDJLadHgKAFWYTSNbOBfEUXGQCIVeMRPZ,FFCBTCAA..SAEBOHDABFBGEBCDGEGGCHBC.eFEFhAAAPABEDEBH..LAHFhABAdEEBKAECABAF.NCEB.fCAAhACA..QGGGMAGBcDEAhADAaFDEgDCFhAAA..,2,-26,-20,6
PUaDBOMXWCAeRVJNGISdYEZKTbgFfHLQc,VCCBGCBE.dFDBEFDAKGFG....TCGGbADA..FHCCLACChAAAQEGFUGAGBFAChAAAXFGDCBHE.ADBBeCFDhABANABH.IAHFSBBF...hAGA......hBAA...,1,-18,-21,3
eaQUbHfSJgXDWYEdONZRFKPVMIcTLGABC,CGFEaCAAUGBAHDFG...JHBADBCC..EFAHdDCCZDCBRAEH..KEECVBEAhAAA..MABG..hAAATGFDAFHDBHHEeABAhABA.fEEESHEG.....hACAXAGBOAFA.NBBEFDHFhBAA..,2,-37,-10,27
NJUbeBOXGCSAMdDFLPcEZIHYfWQRVTgKa,DGDFLFFDEBEC.ZCDBHCAG..fGAEREEDTGAH.KFBGaEHHJBABhAAA.UEGGBACDOABGhAFACCGAAHIFFAAD..IHDChAGAQEAD.NAIE.....eBFHhAHASAECdCCG..hAAA...,2,-21,-7,14
IVcabMedgCRHWfKBYTUDZQOPNJFXALGES,GGCBSBFE..IBFFaFDC.eBBDdBCGCCFGRCGFHFAAKEAFBHEBhAAATEEFDADEODHHhABAJADHAAFE.LECFhACAEAHD..cGGEMIAE.WAAFfEFEhAGA......hAHA...,1,3,-32,35
DBZbCMdSXLPOgJGHKTNWcafAREFIVYeQU,RFAEECCHFDAC....IFEBVEDG.eDGBUABFDBBABFHE.ZGEEhAAACBEGdFBB.LHCEhAAAOBHH...gAGBhABAJAFHKHAA.NCACaGGHAHIF..QCCBhACAMDIF.SAHBhAEA..,1,-17,-27,10
PQSFcfDJZKRMObYIXeBEaNTVALCWUgGHd,LGCGCCDGUEAG.GCBBHFEDdACBSEFEFGHB.DGGFKBHFMICEhAAA.OAFD.IAEDhABAXGBEBBBEhACAaBAH.NDAA.AEHF..PCFFQECF.JBHHhADA......hAHA...,1,-11,-35,24
JAYZcOGRIWgEPVfQNHDXbKaTFLSCUBdMe,ZEBAOCCBGDEBRDFA...IGAEEBEB..PBAFQABChAAADGGEKGAGaGCD.TAFHhADAFEDBCAFDBCGCeADHAGHF.hAAA..YFFF..WHAA..hABA.fHFFhACA...,1,-4,-41,37
XZQAPIHMYGFRfODeETBCcgbNJSVKWULda,HABHGAFERAECOFAADDDGEEEE.BFHE.CDAC...gAAFhAAA.JHDESEGFhAAA.KDEFUEAFaHGCQGCHhABAAADAMBIDfCBC.cADDhAHANAIA...WFGHhAIA...,1,-22,-36,14
AaIDBcROUZPESLGHJQCWMeXKFgNbYVdfT,aEFDBAAH.RBDBUFEFEHEELCEE.GFAHHBFECFHGeBCFKCCF.FGHHhAAA....NIBD.YAEAhABA.fDAChACAAFBHIHHFDCID.OHACSCAFhAAA..QDDBhADAMAFCXFBD.,1,9,-36,45
eaTgPBcLMKbNSDUVQRECWdZFIYOXGfHAJ,eFECaDFB...TBFABDADLFAF.MCIDNAAEDDCGVABDhAAAQGAF.CHHHdEBHhABAIHHGOBBEfDGChABAABBEJHDA.cGBFKGGESAFEhACARBDHEFGF.FDGE...hADA...,1,-5,-29,24
CVQOfRcBJegIKDNATXFZPdUHGabWELYMS,XEAFFFGEZADAUFACGBCH...aHFCECBDLHBC.SEFGhAAACGEFVDDG.fAFDhABABAACeHDAIDGChACAKCGGACAF.dBBG.WDDDMAEGOAHDhADA.cFGEDCCE..hAEA...,1,-13,-30,17
TfcbFHZQPRAdOegCXBUMVGDNSWIaKEYLJ,OEDFeCDDCHHA.UEBAGBFC..SDHBaEBB.EABHLCHBhAAAJBFF.TBABhABAfFGDFFFHZFCFPADBhAAAAAIDdHADgAEF.MDABDFFHNIAH.hACA..KAGA...hADAcGGH.,2,-23,9,32
NWOYdARacZgfPFHebKTMCVQSXLJDEIBGU,aACEZEBA....PFFCeFEAKCAC.MCEDCBDA..QGABhAAALFCHDBFGBDEHNAIG.OHCChABAAAAG.RAFFfCAFhACAFGAA..bGEE..SABAhAEA.EDGCIDCGhACA..,1,-26,-28,2
WGCIdUeHcFSEABZMTONJabVYKLXRPDfQg,ZAABOFAGaGBF...VCGDLCFG.XCCFDHGCQCBHhAAAGEEDCHGAUADD.eGBAhABAFAFEAAIFBAHCMEADTEEAhACA..JACE...KHEE...hAEA......hAGA...,1,-15,-25,10
aFYMKLRTZbgSdHJGCPBcVNIAOWfXEQeDU,OFDHXFFB..QGGCeBGHUECEFAFHKADCLCHHZGCE.hAAASCCBJCCG.hABACHADBCAHNIEDAAGG.EABGDFBHhACAaCEHMAIBREAD.........hAAA......hADA...,2,-23,-23,0
LAMgUNDRJcISTOXPGKZdWeHfYFVBaCEbQ,MCAAUFEFDECAREFA....JEDDSBFB.OCHFXEABhAAAKGACZBAEeAGH.fBDDhABAFDADBABCCHCHEHGChACALHFAAIAC..NDADIAFE.hAAATGEE...hADA...,1,-16,-37,21
ZeCPDUTIXgAdNBEQFGJcbSKHMWLaOVfRY,BDFFQCFGFADBGGCDJECH...SECHHBAGMEAFLAHHhAAAaGGHOHCERCACeEFAhABADFHBUBDE.IBHFhAAAAAFHEBFAKGGE.fABCCABCXEEGdGAA.hADA......hAEA...,1,-9,-16,7
PdLGaTbgWNFHcEKUJIYDBMQVRZefSCAXO,OBDDLCHDGGBDaDCD...TDBDbBAF....gAFHhAAANDAAHDFEEBBCKFDBIGGDhAAADIACMGFGQBFHhABAZADFfFAAAAID......hABA......hACA...,1,-2,-23,21
MaNFVAfeLOJKZbHGDYBIXdEQURgCcTPSW,eFEDOAGHZAAHHDABDFAHBGBFdDHGQDEH.RABG.CGGCTCEBhACASCCD.MIEGhAAAFAEEAAIBJFCBKDHF.GACChAEAIGGG..XGCH...hABA.....EAHBhADA...,2,-28,-12,16
eUCWHfVILMKEbRgSXGZcBTAQaPFJNDdYO,aCFHFFFDDDAA..dGCGeAAECHACHBBB..VECBLBAD.EFGAhAAARAGHSCEDhADAZEDFBFFFAFACQAGDhABAJEAD..NICD..OEHBWHEAIDHBhACAKAEH......hADA...,1,-17,-25,8
bHKCJOPRYTgFXSEUBZdVWcAaNILDQfGMe,aDGALCEB.DGEBGECCeDGFHCBGCFGAOCBAREAE...TEABhAAAFFHDEGBBBABGdAAA.VAEEhACAAAEHIHFD.hADAQAGFfGHC.KGEA.PEEGhAEA......hAHA...,2,-20,-7,13
HZAWdXgLSbCfQIRJOeTFKUGMDaNcVYPBE,XGDBLCFHCHHE..QADCRFDE.JABDeADH.KBGCUDEEhAAAMIEGDGGB.NBAG.VDBHhAAABHBEECHHHCGFAHAHdBADhABASAGG.IHHHFEHDcFAChACAPDBF....hABA...,2,-22,-8,14
BcfQKdLPYUbNHJXZERgGTIOASDeCWFaMV,DIFCeBAGCEHG.FEGF..MBEGBCFH.QGBELEFFUCBAHCDBJFFHhAAAZAAG.EAECRFAC.TDAFhABAAFAG..SHCGhAAAaBGA..fHDBKDDC..dAHAhABA......hACA...,2,-29,-7,22
TRaCZILNYWebcdMUPKQXSJGfOEDABVFHg,FEBAHCDCRBFGZGEALADC...NCHEeBBFdADDMEEAUFBDKCDGSGFBhAAA..fBBGhAAADBIFBHHD.TGADhABAaEECCBAC..WHAGPFFE....hACA......hAEA...,2,-35,-13,22
DOTKcQdWbPLYICARNeUHgfZaMXJBFVEGS,eABAUAEAHFEGZBEBMGECBDDC.EACFDCGDKEBDdCCA.....PCAFhAAAIDFH.CDHCAABFhAAANHBF....fAHChABAaHAEFAHF.SHAGOEHFQCADhACAWEFA..LFAGhACA.,2,-31,-17,14
SgeTDCZEIARFcLYMQKafBGUXPOJbNWdHV,RFFAFDHHLFDFMAED.KABFBGBBGAGEUAGA..OADF.JFADhAAANDGCHCCB.SAAAhAAATDEADDAECFED.EDCHhACAAIBE....QDAEaGBDfAFChADA......hAFA...,1,-17,-31,14
NQCUafAOXPTFGVHDREgLMcBbJIdYZWSKe,XFEAFCEAHDCAEDAHLABFBCAC...ICEEdGEDZFABKDGGQDCHhAAACAGF.UGABhADAAFIDOAACTAFHDICAMEIHhAEA.bDGF..WFGB.....hAFA..SAHHhAAA..,1,-14,-27,13
MYfgGABUDLKPdREcWISOFHaCJVTXZNQeb,DGECLABHKEBE.RCEBEAAB..IFABFDAHHBGB..CBHE.TGBAhADAZFCDQBCFhAAA.MACEgFGBhAEAAHFEBHGHdEHESDDDaGAE..XBADhABANIED.....hAFAeEEE.,2,-31,-5,26
BeQafdgHTMLUbJWIGVYERNCZFDcOPSAXK,XFCCeCGHQACBdDEGHAAELFCG.JFHHIFAGhAAAGAEEEGBDRCAACFGBDFIFODAAhAAASAEHBHADaABHfGEAhACA.MAIB..bGDEWHAAhADA.NAHAFGGHAIDEKAGA..hADA...,2,-1,0,1
GPTZFfMDRUCYBOEeNgVHJXcKbLWAIQdSa,QGGGdBCDGGEFZFAEMCDDDACE..UDAGCHCFBEGEEGEE..eEEGhAAA..VAFHXAGDhABAKDBFLDEHIGAHhACA..SBAFTAEDfDHGhADA..OBHDNIBD.hAEA...,1,-13,-24,11
GMDbNJIROHTgeSZVfCAQdUEKFPcaWYBXL,UABGKABHFFGB..aECHBAGHLEDAGFBHDAID..JCFARCDCHFGHhAAA..eDDGSHBGhAEAVDAA.ADBAEAEH.hAAA..PAGDcADE.XGAC.hAGAMEIBIHED.hABA.OHEC.,1,-11,-18,7
ACbDBKRegSQdJUZYIGFNOWLMfTHcXVaEP,DHEGRBECeBCFQGCA.UDCBZGEAIAADFBDB..OAAFhAAAMFEGHFAG.XDDGhACAaBGEAFIDBAGCKDHBdHBDhADAJDFHGEAENAEF...LACChAIA.fHGHhBHA...,2,-22,-7,15
MbCdZOHLUTFABKQNDfXeIERgcJSPWVYaG,QEFCDCCHeDHDRACD.JEDD....SGEAVABHGAGAMAABhABAdGHGHFBGUEABAHAAKAEBhACAXADFEEEE..gAGFhAEA..WDDCaHGE.CGBD..LAAFhAGA...hAGA...,1,-5,-19,14
ZAdPbIMHCgKVNOaYDFfEJSGLBUWRXTcQe,dDCH..IGGHMFDBCBCA.KFBC..OEADaFFBDHBCFHGE..JADAhAAASAAHLCEGBHEGhABAUFEDRAEH..TBBBhACAeCHBAAHB.........hAGA......hAHA...,1,-30,-42,12
SCcGRNMUKIgDQLeZEJBbVTfWPYHXaOAdF,dHEFCFGBRBBG.MDAG.KBACDBHD.LAFBZBFFBECC....TDBAhAAA..WCHHHFCEhABAODFHAGIHSEEChACAGEAEUACCIHACeAHFJHEE..fGGBhAAA.YFCBhABAaDAB,1,-32,-33,1
DgLYHJWZMPINbdXECTaQKVBRecAGfUFOS,UEGHOFBHDCEGLEAEHBAGZFAFMCCE....IAHAhAAANDIAdEEGCHDD.QGDGhABABAHAeCGDABEEFEDC.SEAEhACAYADEPAABECGCaHGC...KGGF.hADA......hAEA...,2,-17,-17,0
ARfDKHFScNXdTVEgQZPBaJLObUeIMWCGY,DADHHDAGFFBGSGCD..NEBH.dAGC.TAAAEFFEZAFFPFFFhAAABHBALCBAhAAA.OHFCeDHFWEDHhACACHAF.ACCGKDFF.cBDEXFDD..hABA......hACA...,2,-38,-6,32
GFOgCURcMaZWPVdAHSEQKfXIBeNJDTYLb,SDBBQBECKCCF..IGAFeHEEDCABLAECFDGBCHBA.hAAAUEFGRECC.MDEFaAHD.hABAZBAE...WHDGhAAAPFAHdBFCADDHEGGGfCGDBBBC...hACA......hADA...,1,-17,-22,5
LMOUZdPEebBFJDRNVIAWcYTGCaQfKHgXS,......YAHFTGBBGEEG.CEDCaBDBfAAFhAAAKBGHHAADXGEBhADAMAEC.UDBBPEHBEGCGBGHFhAEADDAHNAIG.IEFHACEH.cAEESBFDhAAAOFAH...hACA...,2,-16,-16,0
MJYeRZVLUAFSOHcGEbPIWKNBCfQTDdagX,SCFCOBDEHGDCEDCA..IABFKABBBAFFCGAG...TDGBhAAAaEFGMDEC.JDAGYGDAhABAeADC.REAB..hAAA.LCHHAAHB.cGGAbECENIDBDAIDXGBHhADA....hAHA...,2,-16,-16,0
MAQfBGRPOaUTIbYWCeXcdNSFEgVZDLHKJ,QADFGDDDREADOFCDaGAA..UCBD..bFGDCFEH..eGEAhAAAXACCdBAFFBFEVAGHhAAADGIDKHAGADDC.BEADIBAGhABA..YEFC...NIDFEEDFhABA.LAHHhACAMADC...,2,-12,-10,2
LZbUaHcNVBYdKWXIeRJFgOQCGAPMSfETD,SCAFECAHDECE.LDFHZFEEUFAEHEDD.VFAEBAAGdAHGXBEBhABAeDHDFHGCOCGBhACACAFHAAAH..MDBC.hADA.fCCDaBBANIBB.KAGE.IHHGhAEA.....hABA...,1,-6,-28,22
YcfDEdTLOHKgbRPSFNUAIVQaWZGXCBJMe,VCAAQBBF.aCHBGEDF.BBGCJHFGMDDEeAAC..fFAFhAAADEBBEEEDdEGDLGEAhAEAHAFAKFCDbACASDAFhAAAFHACAFIB.WACCCDHB.....hAGAYHAA..hABA...,1,-6,-20,14
GPTSCfDIYgeWMFdAcUQXNRKbEBaJLHOZV,UGAGQEFCRDDH.EAEHBFFALHAAOCBHZCBFGADH..hAAATBGBSHEChABACABBfHEDDGDD.IHHChAAAeABCMFIHADBDNADGaGAA..VCFC.hAEA......hAGA...,1,-15,-16,1
NcTUVJagYPEKdfeHRMDWGbZLFAICQBSXO,QCDGBAHGSEBAOAHB..TEGDVGDA...aABCPFAGhAAAKCDA..dGBDeABGhADAHGEEMFEADIAGWACEhAAA.GAFE.......hAEA......hAFA...,2,-28,-16,12
NTRFOEbJWMVgIaGDUBYLAXCHedfSZPcKQ,XBADCHCEdCGCZCAF.KGBE..QADERDEG.FGFGEFGF.bDAAMCIHhAAA...IABAhADAaAGGDIBGBABE.hAGAABFBfGDFSDDENEEAOBHD..hAAAWHFAgACHhAFA.YFHB.,1,-13,-28,15
REbXONfaeDWTKBYHLVPGUSMCFZAJIcdQg,JAGBdBEFQFGE.RFDH.XCBC.OGAAfAAEhABAaCEF.DEAHKGEFYAHFhACAVEFC..PAAChAAAGDBH.SACHCAFCADHC.cGABhAEA.ECFBeEBA..hADA...,2,-33,-2,31
RbSECJDAcLFTXVfBNWQaMOIdeYGZHPKUg,LBEBTAED.XBBDBBGHQAAC.OEHHIHCAhAAAdGDDeEACGAGAZCDHhACAPFAGKGAG.gFFFhABASCGACGADDEACAHID......hACA.FHGENIBBMEGF.hADA...,2,-20,-6,14
EOMSBRZAWFaXTdbVDQecHUGYNfCgKIJPL,FHAGXBCEdFADDHFC..eBFBHEEGUEADGCCD....NBHCCABDhAAAIAACLGFAMICGhACABFEFADAC.aGBEbACE.hACA............hADA......hAEA...,1,-26,-32,6
PNZEbXfRTBcQDWALYJIdOegSHUGaKMVFC,JCDFdBHAeDAAHFCAUDAEGFBB.KABBFBAC..CGHDZFFFEHAA....hAAAXAGFTADBBAGFhABADGGHAFIB.LEEChADA.OFAH.SHCGaCEFMAACNEHEfCFFhAFA..hAIAcAEF.,2,-27,-3,24
SIfKCEdaNATgBeLHRZObQPcJXVUYWGDFM,TBBBBHFGeBBF.LGBGZEBEOHFEQDEBJGCE.UADAhAAAGCGAMBIHSDDEhAAA.KAFCEFGFaACAhABAABABgAGF.HDBF...hAIA......hBAA...,2,-24,-8,16
IcKNJgVAMQHPaOZDbdXERTeGUYBSfLCWF,MHDGQEGDHCDDOBBGZDCDDHBC..dABCRDAEeAHFUBGBBAHCLFFGhAAAFAEH.IGAHhABA.KBFHNDAG..JEEBACAD.hACA...aEGGEGHDYHFGCDBG..WHDAhAAA.....hADA...,1,-8,-24,16
QMgBKEaVNWPedRZGYIbJCTfUHLDOAXScF,XFEEFFGHQFAHBFBA.KADG..VACC..NCIE.eHEGdCECRFDDhAAAZCDGGABG..hABAYEFCIDAHCHBHTCADhAAA.fAGD..LAFBhADAADHGMFAD.aBHB.hABAWHAA.,1,-12,-21,9
dNRcbLCBfIAVPTGESHUDaeJFOKMZXQYWg,VFFHTBAB..GACHSGBCDDIF.aECCFAAG.KFCFZDEC.QGDDhAAA.gAEChABANBHARDDHLDAFhADACAHHBHHDICCAPDABEHAGHFFH.eCHBhACA......hADA...,2,-18,0,18
EIQXRDcJPbYfgCVLZSAFBHWKeMOUdTaNG,FHBCHDAGeDDGMEFHUBAHdGHE..aCGEGAEBEABD.QFDBhAAADIEEJFBH....PBDEhAAAYDHH.CEADLHFEhABASAGGADBFBECFOFDH.IEGAhACA.XDDBhADA...,1,-10,-18,8
gBdfGYNbQXTCAePWEKacRFLDHIVJOSMUZ,eBFBEFAAKBABRFDELHEG.HCCHJADEOHEESEABZABFBBHHhAAAdBCB.GCEBNAAHXGBHhAFACEHF..AECGaHAEhADAFAGGDBBH.IDHEMEFH.fEEBhBAAQFCE....hAHA...,1,9,-25,34
bJdeUIgGTBVLQEHDKcaXSWPNYCfZRFAMO,MAFFJFFA.dBGDUEAFGDCFBHAELABB.QFGBhAAAHBEDDBCGaHECSADDhAEA.PGAACCHERBAFADGD.eHEGhAGA.IDHA..gDCBhAAA...EDHB.hAHA...,1,-8,-36,28
RNgIEbZaXLecBJPWdMAUCSFKVTfDQHYGO,CFHDSAABFHCC.KECA..TCGBDAGGQCGHHACAOEADhAAAREEF...IEEDhABAEADCbCCG.aGEELHEAhACABAHHPCAEdDAAABIHUGBEfECA..hACA......hAEA...,2,-27,-5,22
FaQdcEbDGJgeSKBUPMYCfVNAZITXHLOWR,TGEBLDGD.OBDFRBBFFEGG.dHBD.EAHDDGCH.GADD.JDAHhAAAeDBBBEEDMACACECH.hABAfBADADHA.hACAXAFHaGGA.cFDFSAGEKEHHYHEGhAAA...hADA...,2,-30,-10,20
OcXKDMQSNfVAJRBEbaHFgUGTWZdIYCePL,BDBDEGEEHCDCFDFFUAFFGDBC.ZAEGdGHECAAGLDHB.OCABhABAXACBDFFESHEGhACA.fGAChADAACIHRECGgAADIHHCeGAG.PHDEhAGA.KCDH...hAEA...,2,-29,-9,20
SbgYFGeLEMBIJWNHRfTOVUdcXCPDKaZQA,SDBH..YFDAGDDGeBEAMCHDBDBHJHAAHACHhAAARBDDOABAdGFHCABCDAFAaCFDZAFAhAAAADGDFDHH..IHGEhAGA...WHAG...fBBAhAHA...hAEA...,1,-22,-23,1
WHaMeCRXKIbUQGPBgdfFEZJTAVDYcOLSN,DEDGOBHDLGAG..NBBD.HDAH.aFGBeHBACAAA.KHGEUBCChAAAGDAA.BCEFfAFFhACAFFGC.ZCFCAAHEYFEHhAAASGEDMADCIHHD..hADA..bDDG...hAEA...,2,-25,-19,6
UcTNGCgSdfQERBaeZVYKJIOLXWAPDHbMF,DBBDHCDFMDDAFGGEUBGA..TFBGCDACdDCC.EEAFBBAB.ZGCAKGFEhAAA.OEEGLFADhAAAAHFF..PACC.hABANIAH.SBEB.fACHhACAaBHDeCCD.YFFEIHHBhABA.XEGA.,1,-12,-20,8
fBgNGVMFcPYXSZLRJCIUAHKEWdbQDaOTe,EHBCdGCHQABDDABH.OCCHeEDCBCCHGBGEFBFA..PEFHhAAAXEABZADH.RFGHCACHhAAAAEEHKHAA..bCFEaGHBhABA.fAFA......hAFA......hAHA...,2,-33,-12,21
dAOGRUbMYQCVcNZPSDBTKgWJEafeLHIXF,GAABRECGUGGB.MGEC.CBHG.VBDHZEAHDAFHBCHF..KHEE..JDADhAAAEDHB..eGBEIEFHhAAAFBBF..AIAE.OEDBhABA..YADCNDAFSGAD.hABAWAFHfHBDhACA...,1,-21,-40,19
TERfYFQeOaGPMZNSLCVDUJAWKbXdIcHBg,KDCGdBHAHFEDBBGC.EGBDRGAG.FCFH..QBDEOAEGGAABMFFAZFCChAAALDAEDABHUGGGhACAAEHDXECC.IHGGhAAAgDAF...fACChAEA.aDFENEIE.SAGEhAFA,1,-15,-17,2
CVGAPFDfaTRYQEIUXMZKHSbgWBLONeJdc,DDHDTDBGQGGG.UAADMBFAHBDESHGA.bDFDhAAA.BCHBOFEFNABB.hAGAeGAGdBDE.cDADhABACBBGAHDHFEEBfAHA.aADAEHEAXDDGhAGAKHAC.....hAHAWHAG.,2,-22,-7,15
DXfAIFeWLYSRUagEdPVcTBbNZHGKOMJQC,FDBGeBFALAFGRFDH.UEDEEAECdDBE..VCGFBBBG.NAAF.ZBBChAAAHDEEKGAH..MDAHhABACFHCDIGA.ADIB...IACDhAEASHAAaGFE......cGCChAGA....hAHA...,2,-27,-27,0
FVMIPEUeaZNTHAYKBgbWLfdCQDXOGJcSR,BBCC..bCFDLFHBCAFC.XGDGOBBEGEAA.hAAASCAGREAHFECAMADEhABAIHECPBDEEAHBhACAaCHBNDIEADDE..KGFCWDDHfCHGDGGH..hAIAJAAE.....hBAA...,2,-24,-15,9
HdQMLbRacYVKFWIESTXADNUPZfJCGgOBe,UBGHZCDBCDAEGDGGBFCGHBAC.dBEAMIEALEFFREBB..aACBVEGFhAAAKAHF...FHBGEGADhAAA..SAFEhABAAGGDDBGD...NDAEJDDHOBCD....hABA......hAEA...,1,-13,-27,14
DYPVFKdcRXACHJafBLNMOZUWeSQIGTEbg,HDCHaBCDBDGAMEBBZFBEUFEH..eHCGSAEEQDACTCFBhAAAEFGD..DAGHPFHFhABAKABCdEDFRABB.AAIHCHAGfBDBhADALAEH.NIABOAHF..WFHHhAAA......hAHA...,1,3,-21,24
WdJVBgXTfcYSAIZbDKFPRQNLCMGHUEeOa,ZDFFKCFFFEGFQGBFLBAGCHDA.GAEDHCCFEEBD..OECChAAAdBADBFEATDAE..hABAcAEHAADCDIDANHDBMAHFhAAA.aFHDJFAF.........hABA......hACA...,1,-17,-20,3
DCgXOcPZAHWbVYNaEMRTBfdQISJGUKFeL,HFBGVCDD.aCAF.MFIHRABCBFFA..QGFDSEACGADBhAAAFHFALDHFCAHBODEEhABAZGBGADCF.....hACAWBGFNDAGfCCB..IFBHhAAAKCHHDFFE.cBAC.hADA...,1,-6,-25,19
ROAEULHZfPBaVcGISQgDTWKbdJCNeFYXM,ECDGUAAEHFFBZGAGBEDCaFAH.GCGA..SBCCDFGF.hADAKFEDdDBCCDFAFGCFMIBGACAHLBFGhAAA.VDAChABAcAGF.QAEG.WFFDhAIANEIE......hBAA...,1,-8,-36,28
BWgXfOdUJHMRQICESYFDAGKLbcaZNTPeV,KCDCLBHH.aAABTCGD..eGCEBHAFXBDBdFGGUEAFhAAAHCBHQFDGhABAEFGESAGDDCAGAFIB.cFEAhACANADB...PEAFWDDG.fDFFhADA.MIAACBGC.hACA...,2,-38,6,44
UGZaOdWIXLEBFDVTcfHYKgPSeCNQJRMbA,GAACZEBEOAADdAFC..XDDCBCHGDAGG..TGGBHGFGKDAFhAAASEGEeHBECDCB.QGBBhAAARCED.ABIHaFFGhACAIEHFFADH..fAGH.hACAPHDCNGCB...hADA..MEAD,1,5,-29,34
cRPBGJELUKgSZHdXVDIQNbaAfFMCeTYWO,FFAEeDFH..TABHODDFRAFC.GDBGLFHFUGGBKGEAZAGFHCEDhAAAdBBFDAAG..IDAChABAQAECaDCFAAFECHEG.hADA......cDGGBFHC.EHCESGCHhAIA..hBAA...,1,-8,-18,10
VWFbTaJGPHYCgBdXcZAIRDeQLOESUKfMN,DDGEQACDOGEA.SGACKAFH.MEAGVAAB..bFDHJHBChAAAHCFF..CADABCEFhACAcGGCZDAE.AEEC.IBABhAAALFHB.EEFCUAFB.WDHHFAHHaFAEhADA.....hABA...,2,-19,-14,5
HXYKQOAZfMbePdNILTVcRJFGDEWgaUSBC,ZAFGMDEGeFGHdFFDLAFE..TCADRECDFBCGGCAEEDHDaACCBGDDhAAACHEH.HDDGKEFCAADEhAAAbFAB....IHHAhABA.........hABA......hADA...,1,-21,-25,4
LJAFQeKHZSBPgWbYOUdcVDGEXICfMRaNT,FFGCKFEEZFADBGDG......gAFEbCEF.ODHFhAAAdEBDDCCBEBCBCBCB..MBHHhAAAaAHFLBAH.hABAACGBHECBSHACYHFGcGEAXCEDhABAICAA.NAED..hACA...,2,-42,-14,28
OWBEACHbYVecZJTQMFfRPaLGXUSKdDgIN,CEBAHDBD.VFGDeBDDZFAHJEFB..MBACRAEHLAHBUGDF.dGHGICHEhAAA.OAEChABAEBAEADAE...cDDDhACAQGAF.fGDEaAGASEGEhADADACC.NCCF.BBGA.hAEA...,2,-25,-7,18
eAEcLVgGTOZDNadJbYSIMUPCKFBfHXQRW,EAFEVDCEGFBB.OCEEDBIDdGEE..JCCDSAGF.hAAAMBBACBECBHEGHEABXBAGhABAQCFFeFHDhACAACAEgGGCNEED.aAAGIHAChADAKFFCfHBHWFFB..hADA...,1,-16,-22,6
MBcNCdFDKXbVfTZUAISHRLeWaPOgQEGJY,SECBLFCAaBHDOHDE..EAAAJBCCMECGBAFB.CEAA.FEAHhAAA.DADEKDDC..XBDGhAGAVBGBZEFGIHFHhAHAeHAA..gAAF..YHBChAIAdGGDfFBAhAAAAFDG..,1,-15,-37,22
XUBMEDScVGCITAYFQdHJNOPKgZfeLRbWa,FGHFdEGBHADCOCDDKFDGZFCCeDEC.LEABRABE..aAFHBBBGhAAADHBE.SGGAhABAGDFETDAAAAIDJHCGNDAH..hACAfAHC.XBAG.MIEChAAA.....hADA...,1,-12,-22,10
XIJEMgbWQPFHTVRGAZKDYeUNaBScdfLOC,DAIHUBFFBDGBdFAFLECB..OCCGCGFA.JACAECBG.MACGhAAA..bGBEQEGAhABAHFFHRAAH.AIBCKBDHhAGANDIE...SEFFfEDFIHHChAHAWHAG....FFAAhAAA...,2,-38,-19,19
edMLOQRWGZIUCafPcgFXEKHbSBYVDAJTN,TEGDdCCHLAFF.OAGDQABCGEGGUFDG.fEAFhAAAgABEFBGDKGEAhAAASAEDBDAHDFEAAGBChADANAIAeDDGMIDEZEAGIHHEaGBE.XGADhADA.....hAEA...,1,-2,-13,11
FCVbRedJHPBcNZOgLGKMYaUXDSQWTfIAE,CEADRECCdGGFHFDABAFFZAAFLCCBGBEH.MADEUBAB..DBEASHAGhAAAQCGA..hACATDAAfHBFhAHAEHEEFEGEeFHF.cCEG.....hABA......hACA...,1,-7,-27,20
RVPQGNYcBIJKDXZALgdbFeHaUSfEWMOCT,LDEGdACHeDCDHFEASHBGEFAB.MACAOBED.RCGFQBAChAAANCCBBFGC.IHHHhABAKHGGZEBAADBA.FAGAaHBEhADA.fDDETAAF......hAFA......hAGA...,2,-27,-4,23
MXLdCEBaRbOQITcFfUSNKAHPgGDWYZVeJ,HDFFGCAFDHBAZFBDeBABMGEALDCE.EAHFaBEG.OEEEhAAAIFCHFFAFUABD.hAAAKAHDPHDC.gADGhABAWEHB..YHDEXAFBBHHDhACA.....hACA...,2,-19,-12,7
XEaQCAeLfRZFdBSPTYVMgIUWJNKHcDOGb,LCDDRBCEdGGGBCHBSFEA..PEAEVFAG..IDAFhAAAJGCC..KCAAHCEDhABADABAGDDHXACGhADAQGAGAAIFeFHFfAFBFAECMFIH.WHDGhAEA.....hAAA...,1,-4,-28,24
MYPaGgOCZbcEWQJRUBKfAISDFXdVHNeTL,DAHDFBCBdFFHHEFA.eEACMEBH..aCDEOFCFCGAA.ZADDEGCG.JADAhAAABHAD.AFED.XBAFhABA..NEEBLCFAhAAAYHDG.PAFC...bGFE.hACA......hAGAWABF.,1,-16,-39,23
gLTZQNEOXIKMcWCAFbUPYBJadGfVRSDHe,FBCDUGABBECGdGEEGCCHRDEG.HACEeFABLCABQAAFOFCGhAAAKCHH...MAEAhABACGDHABFA...PDHDhACAaAEBSFFGTBGDEGHBIAHF..hABA.WFHB...hAIA...,2,-32,-2,30
HTbgQZYVdJLIaGBSUXFPOfDNCKMReWAcE,HDFGTFDHQCAE.VAECLCGHGDCCBADAUGFAXCDEhAAAFHACOAAEDBBDCFBBhABAKEADMIBCeCDGAGGBEAGAhACA...ZDAC...YGAA.hAAAJFHD.aCCGSFHHhABA.,1,1,-7,8
QRKFAEVPSJDdfUZBYHeWaOTNCLbgXcGIM,EGGFSGCADDFB.dBEDZAFABEDHHBADeAFEaDHF...OABFhAAACGCDLAAE.XDCDhAEAIDGB.MADDhABA.KHGEFGEGAIAEVEADfGAE.WCEChAGAbFFG......hAHA...,2,-26,-17,9
XPQfNMVWbLRFJUKYHGZSEdATICgcDBaeO,TCAACFEBDFAG..BFCAaEGA...ODHBQFGH.MFAGhAAAVBDGLAGB.hAAAJBBAKDBCHGBASACFhABAAFFEIDEEeHBEfAEDbGFAFAHF..hABA......hACA...,1,-16,-33,17
DPJbcYZgHdfeWIACUTSRXVKOEaNMBLGFQ,UADDSDEFRFDA.KHBGaCCEBFCG.FAAFDGIB...JDFC..hAAAbEAFZCAHHGFCdAHA.eFEChACAAIFC.CACH..XADHhAFAEGBHMEAFLAHF.....hABA......hACA...,2,-36,-12,24
eYEfgTGbZNOFSVLJQRCDHAXdKUIWMBcPa,XECEUAGAMDHHBCGE..aADCEDBC...TAEHZDDGOGBGhAAAFGFFLAAARBBFDFFFACAE.hABAIHHC.WEADhABA..cGGDYDHBfEAAhACA..gDEBhACANIBF..,1,-14,-33,19
ZXbgcEIBAGdNKDJYOPFTeHLaRQfVMUCSW,dBECKEGBDEEEOABH.FGCCHBAG.LAFBaBGH.QECDhAAAMFHHCFFF.SADGhABAZEAG.bEAHEAHHAIECNBIG.hAAA...YACHeFFDfHCHhACAWHAG..cGEE.hAEABEEF.,2,-37,0,37
gfeSMERLdcCbNGBUQXVHJaFPYZDIWKATO,OBEAeCDBMCHHRFCELECCdGCE..CGEEGAAHBHAEQBBEhAAAHFABaEAGFGGAZGFGDDHHKDFDAADGhAAA..fDAAhABA.EHCGNAIA.........hABA......hAFA...,2,-18,-14,4
IFUXfaPYdEBGOMSAQHZTcLCVDgeWJKNbR,ZCECLCEGCDBB.VFAEDEEH..eAFAKGGHRBADFFFF..UEEH..hAAAaGCCdAEFBBBDMIAEAADE.hAAA......hABA............hACA......hAFA...,2,-56,-34,22
CNRPTQdFXKBIVOYeWMAagDfGHSZbEUJLc,DCCGHDAFZCAAEDDEUFDALEHB.CGFBRABAQAFB.dDGHFHAChAAABFGBOAEG.eHCGhABAAIHAaAAFfEGGhACA.SCEEbEAHNICB.XAGEhBAAKCEB.IFDD.hACA...,2,-35,7,42
AJVHBTXaECFIZKeUGdMcPSgLbYfRQDWNO,VCECTDAF..EEGHFCFG.ZADGUCADGEDEdFBE.MAAC.SDHBhAEALAACfEEEhAEADGGGOHACAHFBBHHHhAFACHHFeFAAPHCC.bAFAQCCF.hAGA...WDDD.hAFA...,2,-11,-10,1
NWeTdHOPQGBDRaELcZXFCUIfKYgbJVMAS,SBEDeDACHEFCQAGEGAAADIDCRDCFEFDHLFHHZABGFBFHCGAFUEFAhAAAKHDA...gBFBhACA.JGAAMFAAhAAAAAHH.NECH..dGGDBADCcGAD...hAFA......hAGA...,2,-16,4,20
FcKHMdJEGTSXNURIZPVDCAaLeYBQWOgfb,aBBFLFFFBEGC.QDGB.OGAEfGCEFACGKFAEHDCFhAAAdCCEGAEGSBGDhABAXBADNDBEUFFFIHHBhAAAVADHDIGECEDAAAGBWCAF.....hABAcAGAMIAC...hAHA...,2,-11,-11,0
XTIQMBLgAfbFaCPdOHJYEWRUKNDGSVeZc,FDDGCGAHdCEBOBBCHCAF..EEFBUFGD.DDHBSBBB.eEHDhAAAZGCCXBFBhAAAQFDHMBIDBAGDAEAH.aACFhABAJFCA..WFBHKGAB.NAIG.....cCAHhABA....hACA...,2,-36,-6,30
RcMfDUEASVgbXeFCWJZaLYdKOPQNIBTGH,SBGHVDAF..XAGFeCCDFHGGCEFE.JFACLGCC.hAAAdBCGKGEEOACAQBDChABABEHG.HEFCMDFGhAAADIAAAIEE...WHAEaBAB.NACH.IEDDhABA...TGGEhBFA...,1,-16,-24,8
bXMJgRYLAIFScQVDHTBaUeZPEOKGfCdWN,SEFHQAFCDBEBHECGBADFeFAHZDFGEAABGFBHdDAF..NBEH.hABAXCAA.MIFEhAAAJHEERACDAABA.FCGC..hACA............hAEA......hAFA...,1,-11,-32,21
cUTCZdAVgJLIGaYfSMDePXOBNFQRKbEHW,JFGDGCDB.aFFDSDBADEEH..eFABOCFBBAEGFFBEKABBhAAAHBBA.UAGFCHHEAAIHVDAAhABALHCG.IADGhAAAMICG.NBAA........hADA......hAFA...,1,-21,-31,10
adBFNDQUIHXgRbVfCeOGSWJZAEKYcMPTL,EFFDKEAEMADALDEABDHGFGDB..DHGAUDBEHDDHRAEA...VFBBhAAACHHFeABA..SBBAhABA..WFADhAAAAHAHPFFCdCACIFHDXAFA...hABA......hACA...,2,-27,-27,0
OTRQdCcBgHPDVAbLWEJZFfMNXKeGISYaU,LEECEEAFZGDC.FCBHMBDBKGAFGAED..SAEFhAAAaFGCOFCDRDFAQBADhABA.CAHFBCFDHACFDFAAhAAAAHCF.WFFDfFBH.eFFAIABFhAEA....hAFA...,2,-26,-13,13
bSUMRCEKNVLBYcFXOHQaGAgeDTIfZWdJP,DHBCTGFEZBBFdCFC..JEEC..SBFEUCBDCBFH.KGDE.LCABhAAABEAGFGAGXFFBhABAOABAHFDH.hACAaHAEAICG..IADCfDHEPFHDMAAHhAFANAIA......hAGA...,1,-23,-30,7
ZFQGPdINMfabRJUHBYeOSWLKEcVgCTDAX,ZCDGGDCCdHGDMIAAaEBBRAEA.HAAFBCHH..eAFESACBKGGCECHD.hAAA..VFFACFCEDFEAAIBEFAABhAEAQADD.hAFAIGBCfHEB......hAHA......hAIA...,1,-11,-25,14
cBENUKVSRYMaGTCZbFJeDPQOfgHXLWAId,dEECEDGHKCBESGAC.RBCH.MBEFGBFGCEAAFFDEDABA...OBBBhAAAHGAEXAEBhAAAAGIHBBHB.UGGAaHEAZEAAhAEAeHCA.QAGDfHAF..WBAChABA......hACA...,1,-14,-18,4
eIESFOCgdLBaAQPKcNbVXMYRGDUfHTWZJ,KECE..bCGFXBCBRADDGFADDFFC.UCGDTCBA..JHBEeFGDhAAA.SDEHhABACCAFdFAHBAHBAHADPAFEhACA.NDIG...MABE.fFEGhAAA.ZAEDFGEDOHEEhBAA.aGGA.,2,-33,9,42
RaUbgSMPEGOTYIdfDcBZNFLQAWCeJXHKV,eCFBXGFGKACF.RDDE.UGCA..SACCEAEHGDADOHBGhAAA.TAECdCHAfAAAhAAADDCFBGACNBICFHGGACGCCBAChABA............hAGA......hAHA...,1,-26,-28,2
PfHSLNRdBWObAZaUDVTGYQCgeXEIKMcJF,UCGGDEAGGEBHQGDACDHB..eAADXAEGEGGE..MBBGhABAFGAEHDCFLCCEdDAABEEEhAAAOAFCAGGCaCAATGDHhACAIABDKHAC.JHFA..SCGDhADA.....hADA...,2,-17,-8,9
TJeHEfRUGdbIKgPFOQaBXANWLVYcSZCMD,LCEEVEGD.SBGEZFCGCDDE.DAAFJCAEHFAE.RDEAdEABKHDEFEAEhAAAQFGF.hABAaBBDAICA...NIAD..hACA.cAGGMADEEHFE.fFDBhABAbABAIGAB....hADA.ODFG.,1,5,-28,33
FDeaGOLKNWcTHJEbZCYQUgVPfIdMBAXSR,RCDFDCBBGBACLFDDKAEC.....NBIA.TFFEHCDG..EBFGCCGCQGBChAAAUFFC.hAAA.gFAChABAfACDMBBGAFCCSFHB.aHECWAEEhACA......hADA...,1,-17,-27,10
gORdGNLBIDceWFQVHAJTEZfXMaPCUKSbY,JDDAEEBDZEFA..MFFDaHCC...UGAGSAGD..gADEhAAAODAAREDDdGGGhAAAGABELABEBBAFIEHDhABADCBAeAHBFFAHHECHADEA.XGGAhAFAKDGA.YAHF.hAFA...,2,-15,-7,8
NcEZfIaKDLdgCOVWeQBbRXMTAUJSGYPHF,SACFGEDCHBFAFHACEGFCZFDE..aDACDEHHLFBBdDCA.OABAhAAAVADG.eCBEBAAGhABAbDFG.MFIHACHH..hAFA..YFHB.....cCEEhAGAIGAE..hAGA...,2,-32,-1,31
YAZgKTPaRHQMfdLVBFceIbOCUWNSEGJXD,ZEEGKGHD.aFBAQCAE.dFFABDEHFDEE.eACHODHFCHHAUAFDhAAA..SAHFhAAAJBADDIAG.ABFGTFCHhABAHGEEMDIFfCDF.cGAAIGADhABAWACCEGCB....hACA...,2,-25,-17,8
TOHJEZNBabKFWeYPGDLgRSVAdXICQcMfU,XBFHQAFD.MEHFUBBBHFDGZEFFBBHDaABA.KGAGeCCEGEDGhAAADAIDLEBChAAA.gFAGhAEASEACADHECHAGfDHAOCFDNEIC.WABE..hAFA......hAGA...,2,-34,11,45
GQJDRASEYOHMFgeKNWdbPTBCVULZfcIaX,SCGAEDCHHFFFFAAGeDCAKFEF...dFBETBFHCHEELABG.hADAZFCDIHAEaEGGXFGDhAAAJCHBAAGA..OCBGhAEANCDD...WACAbCACBAGG...hAIA......hBHA...,1,-7,-25,18
BLIDNVMdPAWQSRCeTKZEHFaOXGUJgYcbf,SFCBCBCGKCHH.EAHFaFBG..GBAAUEFF.JFED....hAAA.gAFFhABAbBEGBGGDDDAENDIA.dAFDAEADRDEGZDAGhAAAFACFOFDFXGGH.cCCEIBAHhABA.MIAG...hAEA..WGAG,1,-10,-26,16
IaYGMLEFdAUfgBZeJNPQTODVKbXWCHRSc,UAAABECGeGEA..PDEHQBBEDGIH.VAFHKGDD...hADAXEEGCBFAREAC.SDABhAAAaGFCGCGGMICAhABAEAEA.FDHBADDH.fDED.gFAGhACA...hAEA...,2,-34,-8,26
HIadAgTQSWfLPZYJUNCDKMVEBeORFbcXG,QCDFSCGBLAEHZFAEUEGHDAEBKDBCMFEDBDBE..OHEEhAAAFAAC..XGAChACAHAFDaABBADGDTGGChADA.PECD.NCIACFGFEACF.eHCC..hAFA......hAHA...,2,-19,-11,8
dbEQKVOUMHJGfDTYLBZcRFgSAeICaNXPW,CHFFXDBHdAGH..EDECQBEC.VCGHOABF.MBABhAAAJAFCDBDHLFADhABABDAFREEBSHCGhADAAHHD.IHHBNICF.PEFEKABE.GFBFhAEAfAAGYCFChAFA.FBDDaGHF,2,-19,-18,1
JHMAEZLPdNITgRQVfFaSXeDbBYcCKOWGU,LAECdAEG.TFEAgAAE.QEEBFHDCaDBHXCEHhAAADDGCBDAC.CHGDKGCHhACAOCDBUAGAJCHHADCBEGGEhADANBAG....IBBBfFBCSGBFhABA....hACA...,2,-25,-23,2
bSTNYPJZCIVcEgQdFaXOefBALGMDWUHKR,MAFEDDHFUAFHHFDA.RAAC...TEEF..PHBEZGDACCCC.IBHHhAAAEBAC.dDDFXDBEhAAAfEAHAABALDAFhADAKFHHNBGE..YHFAcGAEgGGBhAEA..aCCGhABA.BADB.,1,0,-20,20
OHCKcRYFLgEBPUVMJNQWadTXfGDZIbeSA,HBCFCHECKCHB.RFEHFCHHLDEBBBHE..UFBGJAFC...QCAEhAAAdCGC..XDBAhAAADEADIABHSHGAhABA.AAEBOCAA..gEGGhADAVFBFMDABNIAH..aEEBfGGFhACA,2,-30,-22,8
IBFbGEYVafTQXgdCLDKUHAOeMJWNcPZRS,MBCEJACB.....NEDA.ZAGH.SFBCFCAEECEE.aGFAQEEFhAAAdGDCDAAC.UEAHhABAAAEEeCED..PEHDhACABHFD...YBGHfEHGTGAHhADAXBEFCHHG...hAEA...,1,-22,-36,14
MBfNHQYTeVJARZScUdIaGXKFEgODPCbLW,SGDFdHABaFAC.KACEFDGG..EFFBDAAFCAAD.LCCCBBFEHCBAhABAQDDDeCGHAIGGREBCZFGDhABA...IAEFhACAgGADOCBHWFHB...MAFEfGFAhADA...hBCA...,2,-23,-20,3
egLIOYBJCUbSRWZTPHMFdQaGKDENVfXcA,eAGBLBABOEFABDGEUABDSDDA.RFBCZADGHFCGMFHFhAAAFBEBaGGA.KEAENICF..hAAA.fCCGhACAAHAE.IHAHCFFBbBFA..WACC...hAEA..dCCD..DIFAhAFA...,2,-20,-14,6
NaPLKdeOBSXVfTYIGURgMDCcFbHQZWJAE,aFHDKADFeFCGBEGC...SFAB..XCAETCDGGCGEhAAAgGBHDIGGCBBBhABAbAFAZGDG.ACADEAEGNDEFLBBEhAAAdHAD.fEAA.IHFChABA.MFCGcAGAhACA..,2,-36,-9,27
YQaAFUfRSgXWcVIbTZGHKJOEDeLNBMCPd,FEDCREAF..SGGDXBDC...VCCHIHCAZAFCHEGHKCGGEAGGhAAADDGCLABGhAAA.MIAACGHFPBBFhABAQFDHABGBUGEHfCAAWFAH...hACA......hADA...,2,-32,-1,31
ZBDWCAYNdIOXSfVJQRLMebcgEFaHGPKUT,dDDAXAEHSAAC..JGFCQFFHRDAFLCCBMBCEeFDFhAAAbBGH..EAGDaAGB.hABAGDAGKABG...hADA............hAEA......hAHA...,1,-17,-30,13
aPLJFOfSgVAQcCGETdBHRbDNWUXYZKeMI,CAGFTCAAHABGDGCC..UAFDZDDEKEAGMCEH...aEBDLFFEhAAAFGFEOABASCHBhABAADHEQDFCECAABGGEhACANDDG.XAEH.IHBHfGAEhAAA......hAGA...,1,-19,-26,7
bPOSfMQKTVJIEWGeZXCdLcAgBaRFYUNDH,aEHHFFECUCFHHACHOAFE..SCCDQCEDKGCFTGCDhAAAJAEE...IFFChABAEAAGeEADCECC...hACALFHDAGAGBEAENIEDDIDAfCGDMADFWCABhACA......hAEA...,1,-7,-34,27
CgDWNFXcdeGfOEHUPVMZBTJbLASIQRaKY,QBBHRABCKDCF.CEEH.DFBBFGDHdFHG.GAGGOEAGHFDC..hAAAPAGDMCABBDFBhABATGFC...bADFAEEGaGBDhACA....gEGBNIEDeBDA.EAAFhAAA.UGAF...hAEA...,1,-7,-19,12
MHcFeXRCfWLDBSOJEYKbdZGNAIPQaTgVU,QGCATEAG.UAFAMIDEFDAHRDGFCAHELEHB.BGFFSACGhAAAOBDBEBADbDDBZECHhABA..ABBEIDFEhAAAgAEB.cFFHfFBHDBBFKGADdBHAhABA......hACA...,2,-24,-7,17
gYMJSOZFHdfQVLeRIUNPABcaDWGTKCXEb,aDAHDFEEGCCH.KDGHEDGH...bDBAMFAB.OEBBFAGGHACFhAAAdAEH.QFDBhABAeFHFUGCAAIDEBHCF.hAAAWHFACCADgABASGGC.fCADhACA.LCFChAEA..,1,5,-28,33
KOTEMFZYVDeUAdfJRcSBCbagIXWNHQLGP,dCAFREFEBEDDaCGD.....IFAFXGGDHABCLFBEGGABhAAAPAECKCADOGDAhABAMHACFCED.ZAACVBEGhACADEAGAIECfGHA.SCCGhAEACFGC...WHDANAIG.hABA...,2,-21,-3,18
fLJBQYCAMDTEPcbNeFGKVOSIZaHXRdUWg,DIGAECEB.....bABDFAGD.KDGG.SDBHaAGFREAD.dFFGUDEBhAAA...fADChABALACABAAChADACGGCMBIBcGAF.NEEEeHFAOECF.IHEEhADAXBBC...hAFA...,2,-34,-23,11
EcRbQaGAFOWgMTDKdefUJYVSXNBLHCIPZ,FCFGOCHF..MHFCTCEDdCADUFBD..JHEE..SEGDhAAAXACANBBCBEEEhABAHGBECABHZAFC.EEHBRDCBaGAHhAAA.ACCEDBGC.fEGC..hABA......hACA...,2,-38,-20,18
DBYTKVbCLfNdFMXRPAGZSgUcWJIHQOEea,SEECUFAB..JBFEQEGAEDAE.eACEDDFDBFGChAAAKGGFCCEDLGCCdGEAFEDB.hABAMBCDRACD.ADHC..ZFABhAAA.cAGCIHHBOBABaEHD....hABA..YAEEhACA...,1,-4,-41,37
OFLZAXYIPNJbBaTcECReWSMVQHfdGKgDU,XACF..IBGHJHEG.BFDGaBEA.EFAHRGAC.eBEBMCBHhAAAQFFDHEFC.hABAdABFgCDFhAFADIACOBCBLAGHAEAG.NAIGTFDHWHEGSCHHhAAA.fDDGhAEA,1,-15,-28,13
GWZeUbgaEfTONDJCQYKVdFISHcMXARPBL,BHEBLDCCZAADeEDGUAGG..aBCCEGGC..ODABDDIH.JGEGQBGBhAAA.KDBBhADAFFCBHGAAMDIFAHIFRACCPACAhAAA..WDDEbEEC......hAFA....fBAEhABA,2,-27,-21,6
beYNDBGJLWOEdScIfPFCRHKXQgaZMUVAT,eEGFDBFCGCDALFDFOADBSBEE..fGDGhAAACEAGHCAAKFHHXGFHhABAQGAEaBBBMCIBABBGTCEBhAAANAEFBFCFECHBIGEGFFHH....hABA......hACA...,1,-12,-13,1
IeaGTODLcKRXFMbfYUPAHWVgdSCEJNBZQ,HDBGVCEH.SABD.CAGG..JFEEBFABZGCC.eCAGGBDDhAAADGCFKFGFFFAF.MBIFfACDhAEAUAEHAHAHdHFDNDIA.hAFAaBAA...........hAHA......hAIA...,1,-14,-36,22
PQILEDWfBNHSAbGdKMZRegTacOVXFJCYU,dBACMCHHeGFE..TABEaBCC..VCGFXGDB.JCFDUFDEhAAA.QEAChABALHAAEGGAfAFBhACABGBASDAGAHACKDDC.ZAFA.cBCDhAAAOHAECEDB.....hABA...,1,-8,-21,13
GdfYIgRHEQDaSKVbTZeFBMOcAWNULJCPX,UGCECEAEGBCEdCCG.....IHCCREFDQAEADADA.aEADKBABhAAA...TEFEhABAeAAHMAHDOBHDADFCLEHBhAAAPCEA.fDDDYHEAEAGCSHFGhACAZFBEBGHF..hACA...,1,-16,-20,4
KMRabfEPLeSAHZWOXdVJIQYCgcGDNTFBU,HBAGZGAAOAAEdAFHJHCE..QDCECFGF.GGEDTDEGBDAGhAAAKGAGRADDaCFH.fEGFhABAEGHH.eBCAhADAAAIFXCGFICGEgDAGDIAENGBB.FAAGhADA.MDDHPAFA.hAGA...,2,-16,4,20
FZOYWCgHKcbeEXLBMQUAdTRaJNVSPGfDI,TAFEaACB..VFCCSEHH.GDABDBDHFBFBZBBGOFHDhAAACCGHKFFE..eFCFLAEChABABAAFMAIFQGFAhAIAAACFdFAGNHEBICHC.gDEGhBAA.....hADA...,1,-13,-16,3
ISEdZVfPWYQcAUHbNOCMGBJeFaRTXDLKg,UAGDHFDDOACEGCDGeDFGRCAFDAAH.LDADKAFC..SDEAhABAZACEfHCB.hACA.PBHBQFGDhAAAAHGE.CHAHMFFDBDCAaFCB.....hABA......hACA...,1,-11,-24,13
cCMGVSfHTbZaUOXANRLQYJdgEPWBKIDFe,RAEGLBEDQAAEdFGFEHBCBGAF..DCFGFDDBCBHB.MFECGABA.hAAA.SHEAhADATFDAaDBHOBHD.NGEH.hAEAJDFA.PFABIDBFeAAFfHAFhAGA.....hAAA...,2,-16,-16,0
gOaTYFJAIfWCdNeZVQBbMcHPDERUKGLSX,..IGECfDFFdDBGZBCHBADG.MBCBHGAEDFHDEDGF.UAFGhAAAKEDFGGAHLABEXAFBhAAAaHGG.FBAFAAIHCDFFhBAANIED........eBEF.QEAChABA..hACA...,1,-12,-19,7
EMLeDGWIaPTBZNcfUFbSROQYKVdAXCHgJ,XABGCBBCHEAD..JFDFMFFCLDEGGCED..aDAATGGFhAAABGGGZEFEfDCChACA.UFBBSAEEhAAAQAGFYAHHdEECAADEEHEEDABA.IBEHhAFANCCB.....hBAA...,1,12,-27,39
GZHCERPNWLTABbFaDYSQeJXKcMOUfdVIg,BEADaHDA.SBEAQDDF.eGACJFDFKFGCOAGF.fDADhAAAdACD.IBCBhABAGAACCDCDRFGFWCFHhACAAHAGbCFE...FAEGDEFG.XGGEMIAC..hAAA......hADA...,2,-37,2,39
SPJdRFKUBgeWaZcIMbVHENQYCGTfLDXOA,SEDHdGCAFFFDKBBA.UCACBAED..eHECZCFA.MFAH.HBGHhAAAQDBCCGBEGABHLFEDhAAADGIBAIBCRCDEaFFAIGABhABA...EAFG......hACA......hADA...,1,-6,-38,32
BHPdTQRCSAVNULZYKDacIGbMXegOWEFJf,UAGGZBBFDBEA..aGEAGFDB.MFACXCCC..gGABhAAAEHGAFFBEBDEHdCGH.hABARADAAAAHLEEE.hABAKBDDIHEC.OCAHfCAAhACAPDHHCHHE..SAHFhADA.,2,-26,-24,2
dCSIPTYMZRLQaeKHUGJcXfEVWBgFAbODN,OBDEDAEEdEDE..CEBC.SHEE..TCGCZDGBLAAGhABAQAAAeFACKGCFUDEBhACAGGEDJAFCfCCEhAEAEAGHBBDGADAGNCFEIHHG.MICA.hAAA....aFDE.hADA...,1,-6,-34,28
KfIARJdLUWYZeMFVNHGQObPacEBgDSXCT,dCCHLBCAUEAEZEFHeCHF.FGDBHFDFGDADOAFB..aGGCBCAHhAAADFFFCFAAKACG.AABG.JAAHhABAMAID..NIEB..hAEA...PHACEHAESAFBfDGDhAGAIADH.YDDChACA,2,-31,-14,17
OTCWKLVdGPEIXfHSYZMUgQeBNJFAabDcR,aFCBDGACRDCH..CADBLFGFdCCFGEGE..EGEB..IHBBhAAAHAGFSABFMAFGUBFFhABAgCCFBADDFCAHAFFEhACAcGAH.WBFFKGDA.....XDGAhAAA.fEEEhAFA,1,-11,-31,20
ANWcVbTMOCQYXIRSeBKHfaEZgLDGFUJdP,...NCEE.VGDG.MEEACHCH..QDAEXFBG.SDGAhAAAeCFABCDAKAGEfABAhAAAEBBGLHFCDAGEFADBhABAdFFHAGCB....bAFCOFAHIHHHhBAAaABAgBGAhAEAJFFC..WCCD,1,-8,-24,16
WQcKOJFGYeTECdLbINMUBHZfgVRaPSADX,DGHHXFDDQCBAKCED.FAEAGCBC.eACAEGEAdEFBLFFEhAAA.IHAFhABAMAAEBGCFfBFBhACAgBGA.aECEAICCWDADOHACTGGFCBBCNEIG.hAHA......hAIA...,2,-24,-4,20
BKUgECAMWQLTJXGZdOebHIFcfDNRaYPSV,QFFDJFDDGADEZFGFdBBFeEAA.HDFCFAADDCIDaAEA..SHAAhAAAKCGDUFAB.CFDAACADLDAEhAAAOBEBIAHBhABA..NDFA........hACA......hADA...,1,-15,-32,17
SZeXBTNYGbWdaOHKCDPLAMEFRgJUVfQIc,FCEDRCDCUEBAQGBC..IGHHSADCZAAEBAEH.hAAA.YHFEGGCHdAGDhAAAOBCHCFFHDDIDAGFCMBFEhABAEHAE.gEGB.fCAAhACAcCAB.XEBEhAGA...,2,-25,-22,3
NGaKUHdJZYIeEgOTFCDWfcAVRXBbSPQLM,VFDEBCHGSCAH.LFFAGACAaBHDKCDGHFBBJEBHZAABhAAAIAAAEHFC.OACHhADATAFBCHEFfADHhAGAAHAD.XDEAQCEHMBFANEIG.hAEAYHFG..hAHA...,1,-8,-23,15
GDFWEYNZfITMVLdPQRaBSbXUJHAOcKCeg,OHEGCDFBGDDCDHAGFFBH..EEBAZCAE....IBBDMIBALHFEhAAAQBDDBABAhABASCADXAFG.hADAUEFEAIGGeDHHgBGH.NABFTEDDhAAA.dGCEaAGA..hAEA...,1,-7,-22,15
GcgOeNBPdITVQEWKFRfSCDaJbUXZYMALH,HBFBGDECOBABBACCdAGE..ICCBTEAE.QFAAhAAAKCDC.RFFBCBEFDDDDJEHHbAAHhAAAXEDB.MIAGhABAAAEFLDGHeAFE.NIAHPGBC.EGHHhAFA......hAIA...,1,2,-20,22
XUOFaLfVgNYWcASHDJEBTIdKGQeCMbZPR,DBECJGECBBCGdGGDGCAF..CEBFZCFHRGCEOAHD..FAFALCFFhAAA..fECFhAAAVEAH..NABH.hAGA....YADHAEEBSBBE.hABAEEGGICAA.hAHAKHCE.MIFA,1,-20,-50,30
aJHdQZEWXRCIMTVFgBecNbYPKUfGASOLD,OGAEDHGCHFAFdDDDQAFFZDAB.ECABRAACMIEE..FGEDBFCBhAAANFED...bAFGKABFhAAA.fCDFhACAACIHLEGBJDCH.CDHE.IFFH....hABA......hADA...,2,-30,-15,15
eGRbCZJdNcWQDTYPIAMSBFafELOUHKVgX,BAEGaFADLDHBHFFFKFCD...VBBCgAEBGCEGCHEDJHFC.hAAA.dBGC..cDAFhAAADAIHTDAH..hABAIEFDSDHHFHCAOCDDXGAHRABH.hABA......hADA...,1,-10,-22,12
KSORGQHNdCJebAgTWLDPIYBEFZMafcUVX,TDFCDEDG..IFFCBAFAECBB.FDDDZAFD.MBIH..fGGAhAAAVDAB.XACFhABASGEGOFAEhAFAGABHNEIA.CHCG.bBEAAIHE.LHAGYDHFhAAA.aBACKFFF...hABA...,1,-2,-31,29
LKCBMGRWVbfNSPTFdeaQEHYJXgIAZcUDO,ZDBFDAGBKGGGMIDCGDDEREDA....VBCE..NCBG..SFCDhAAAPFHD.TDGHhABAeBGFEAAH.JEAFXCCFhACAAIBC.OAHFCDHABAHBfACHhAFAaADA.YHAAhAHA...,1,-13,-35,22
CYNLWdPFfVbMOGHDBUEeSJXQagTZIAcRK,RAEBKBEBCHAC.LEBE.dBCCFCHD..VGDAMBCF.OGDGHCGHBHHGhAAA.UGAASAADhABAJAFA.QEADhACAaBAF.gDDD.IHHEhADAACAB...NIBH.hAEAfFFBDBGE,2,-41,-21,20
WebYaJECZBXVGDHLdAKQTNMfSPOIRgUFc,QFBBTFAH.MEDGSFHD.OCDBIABCUGDDhAAAFFFAeBADaDAECHDABCHEhABAXCFEDBCFLAFBhACAKAHB.NEGE.fBDA....hAAA......hADA...,2,-33,-14,19
TROgcYPMbJBFILaQGSfCZAUHDWVXeNEKd,UCEFDEFA..VCCFeGBG.EFFAdCFB.ODAD..gBBGhAAA..cGBEhAAAYHAA.PDABhABAMFFFBHGEFHGGIACCQACDSFCEhAEAfAEDAFIH.WAHBhABA.KGAD,1,-26,-32,6
LNGYOIMedCERTfQgWFUacXDBSJVAKbPZH,KFADZFAFHGEGLBCEGBBCOFFHMAEFdDCGCDEA..RAGH.QCGAhAAA.FBADUDGDaGCBDAEAhABABBAG..SEGDhACAAADB.NDEA.YFCG..IHHBhADA...hAAA...,1,-15,-26,11
PLBaNfGcQMRHWFTeXVdDIZgKEbAYSUCOJ,UGGEODDHLFCEBFGG..aAAFGAAG.MHDGRBFGHDAHTBGGhAAAeADD.XGEChACAdDGDDFBHZAEBEHAAAFABCDCG.NEEB.hAEAfADC..WHFA...hACAIAHE..hAFA...,1,-10,-20,10
PXYJIMTOLZfbKAgSGFDRBHNCcaEQVdUWe,GBEBFDECBEHDHFDA.CDABEABEQGCD.UBGFeFAH.XCCDhAAAIECAOFHHhADALAAEfHEFhAEAACBGDGGCREAD.aAFGdAEG..YDFGMFFH..hAIA......hBAA...,1,-6,-24,18
EAaMSTdZfLYcUNQCHKRVgODXIeBFJbGPW,MDFCTGCAdADH.LEGBUCGH..CAFEKCEHRBBGOGCA.DIFEeBBHhAAABBGCJFFH.GEAHhABAEHACAFCA...aADHSEAFhAAA.fEDD.NEIG.hABAHEGH....hACA...,1,-22,-23,1
egAVJfRCGBUbLPEIdXHDZNKTcMOQaSYWF,VGEGREBBBDFC.UGEHLEBG..EAGHIAFBHABBZEEAKDHH.hAAA.MBADOAEHaBDD.hABASBAE.hADAFCGGAFAHCDHCPHAADAIB.NADE....cEGChAAA.QCAHhABA..,1,-8,-28,20
UQaHNRXEIAWeFObdMcVGCDgYTBPSLJfKZ,FBABOCFEMECBGGEH.DDCFTBDFBDABLEFAKEEGZBGHQGEFhAAAaCBA..NEAE.hAAAEGADABGF...eCCBhABAdABFCFBD..PDAFSFCHfHGFhACA......hADA...,1,-17,-26,9
cHNeITVbDQRUYfAaPJFSdgLBMEOGXZKWC,JHAAFCFDdDCALEFFBFHC...EBGFGCACKEBA.CABFHADG.eHCGhAAAIDAB.TBCBhAAADIAGQGGFhADA...YEEFAAGBSACEOAHFhAEAZDGD...NIEH..hAGA...,2,-29,-18,11
HBPCZTDMgIQXSKRFfbecJVaGNUOAWdELY,EADDHBDGBFCGCFADDEIF..MCIBQBAA.KEGBFDCA.eABFhAAAJEDBGGEHOFEEAEABdBHAhAAALAGD.PHEGhABAZEBBIADG.SHAGhABAfHBF.....hACA...,2,-25,-16,9
NCXIcHeOTdBbaRAVMLYKGJfWEQUFPSgDZ,VFDHMGDELAEA.GBBBJACBEDFDQFAF.PDEAhAAADAECCBAD..IFBAhAAAeEHHdHEBBCECaCAHABBAhABAKHAE.UGGDSAHH..gAGAhABA...hACA...,2,-37,-7,30
gNPcdXaZKTLOIEHGAeBRDYCMJFSbUWQfV,RDCACFBHFBAEUABD...QGAC..fGDE.hAAAVDFEPGFA.dGDGhACAXBDGaAEGZCFCKAHBhAHATDAELHFAOAHFEBFEAHABBHHG.DFFHhAAAMFFAJADAWDEF.hBAA...,1,-8,-26,18
YFLbgXTIaCcHWMGAPZVOQDNKefEBdJRUS,VEAEQEEG.KBFHEBAHdHDDRGFG..UAECFGHDLBAG.hAAAXGAAIEFEaFAGhAAAHCBG.MBHHAEBAZADHhABANCIEBABB.SGBAbBGH.CHADWFDHhADAODDH.DAIH..hACA...,1,-9,-12,3
PKCbfWAOYgSRZJNELFQUBMaHVITdecDGX,OFDESBDCZGAC.ECGBFEHD.BDCHHFGH.IEFHeDFAGACDhAAAXCCEKDABCHHFfCAGhAAA.AIFEgGBEhABARBAE.LFAEMAFEaCGGdAHADFCGhABA......hACA...,2,-21,4,25
LCGOXTQHZFWNecMdEfAIaVYKbJgRUSDBP,aFHDKEFD..JEACUGDC.BECHCGBG.GAFA..OABCQACDhAAA.FHACNHDF.eBAHhABAMAGDEGFA.ADDCIDHHhACAVCCA.gFAEDAHB...hAAA.XDGA.hAEA...,1,-15,-48,33
CAcMLIDWPgROQdKBbFNfJTHGYZEXVSaeU,LCDADGDF..PBGBOGBA.dHABBABDFFFH..JEFAHADBhAAAZAFE.EDBA.SFGDhACAaAADUDAA.CFBBAGIFMIEChAAAIFEC.gGAE.KHEA.hACA.fECBhADAYAFC...,2,-29,-23,6
VDIeaYQONRFMcbLSHfGJUAKdPEBWCXTZg,KFCAdBCFBHFACHDF.ZGACDEAC..aDCDOABF..FFFAMEDCLBAHhAAAHBGF.GEDGhABAADDEEGBB.TAFG..hACAgGFAIHHBQCGHRADESAADhABAfFAD.hADA...,2,-35,-11,24
STVWfZcNJRdAbCOGaMHEBgPDeILUYKXQF,OCBEaABBHEECBFDFDBDGLDCCUBGH.KHGEFGHB...SAFEhAAAVFCDZFAFJAHHREAHAHFH.hABA.GCEAMAABECFGhADAeEGF...IBBF....hACA......hADA...,2,-29,-10,19
YLaUCfTKGdJIcFAbSZEDNgOBQXVeWMRHP,ZBEHDFGFOEAGBGGDQDAB..eABFMGBCHGCGLBHDhAAACDFGKADGJAGHFHAGSBAEhABAEFAD.gDCHhACAXCCAWFGH..YFFChADA.aAFF....hAEA...,1,-22,-31,9
XRZWIbLgNJSaUAKYVMQCHfFTdecBGOPDE,VDBHQGGG.CCDCHAAHFCCAeAFFBHAAGEEHOFAADBBCRCEGZADAhAAA..IHCGhAAALFFCJAHDaAGA.ACCDMEAAhACAfHEBdCHA.ECAF..WEEDNABDKGHD.hAEA......hAFA...,2,-11,0,11
TZEMRPHaIVSXDdKWGgBeUAfFbOQCJLYNc,FCAFODGBQGGDLECB...NICD.TFBAZCCC.EAEARAECHAAEhAAAaHBE...IGHAhACASCCFDEEDKCGChADAWFDEBEAHeBHBAHACCEHAJBFD.MEAF.PAAGhAEA.dGEC...hAEA...,1,3,-16,19
XGQeWFAIbNSREJVgDfUBOTPacHCMdKYLZ,..IGDHNHDD.RDDG.JAHH..DDBGBDCCOBHH..aEEDCAGFdFAGhAAALDECGABFeDBDhAAAAHFE.EGBB.VABEhABAfHGF....UAEA..hAIA......hBAA...,2,-34,-25,9
BZKTGXRaISePVUYMWONCJDbdEcALgHFfQ,HFAGFCBDBGFDKHCGGABHRADF..SEGDeDDCUFFG.MAFEhAAAOCHFCBHE.DHBGdCAGAFEHLAAChAFA.QAGChAIA.XDDEaHGE.IHHGhBBA..YDFGhABA.,2,-27,-26,1
XFPSgcOVHNQWYEJLaKMGTDURZeBfbAdIC,CEHFXCGAFBHB...SFCCOBAGHDEFQAAFEBEELFADhAAAMFFHDCDFUCAHeFAHhABABHHGAFAHdADB.gGCFhAGA.cGGGWDCH.aBEHTGDGhABA.fGBEhACA..,2,-21,-19,2
YLfBAGOIHNVQdSKRPebcMXFDCUgZaJTEW,ODCEHAEEQFEBKAHH.RDABeCHFMGFCFBGHDIEACGDGUDAA.ZFBGhAAAaCBA.EAAALABChAFABDECAHAF...IHEGhAGA..dGHCbBCA......hAHA......hBAA...,2,-26,-12,14
FLfUQSXEGHMbCZVYdRAKWTOJaecgNIDPB,TCEHJCFB..eEAH..NEIA.DHBGBFBDLDACUEEFQAGGhAAAEGGEHFCC.MICChABACBCEZAFGdDBBAIGC.KACF.aFGDhADAIBABFAEB...SHDAhAAA......hABA...,1,-13,-30,17
PHTQYSbZaVKEJANdcDLfIOWFXCRMgBGeU,dFGCDIGELBACOFEFFDAFCFFB...RBGBBBCFUECEHCDG.QEAGhAAASDDEZGCEKECGhAAAAHAE....fAFGhABAXGBBMFAH......hABA......hACA...,2,-42,-24,18
HDRPdgEZNKBWUScYfQVTIJXbaMCeOALGF,GADEHCDEDEFAdFBFEGFDKABDBHHDUFEF..SACF..hAAAfCCETAEFXBADhABAMFHDCHCAAIEALEABhAEAFAHH.gGCGZAFHNDAG...cEGDhAGA....hAHA...,2,-23,-20,3
OJgEAWVQSGYPTaKcBLHMefDbZCURXFNdI,VDGFSCBB.GDGGTAECKGAFBACFLDDAHFDEMIDGhAAADGGHCFDD.UDBDFGCHdBGHIHAAhABAOABG.EBDCAAGEQBGHhAEA.aBBE.fGHChAIA.....hAAA...,1,1,-27,28
cCIDOYFfHaBgWSRdbTNQeUELMKZJXGPAV,CCHBDIFGFGDDHADG.aEFABFAA...SAEEbECC..TGDFhAAAQGGHeBAFECHBhABAKDBEZDEFJEABXCCBhACAABAE..IDGGfGGBRACE..hADAdHAB.....hAEA...,2,-34,-11,23
QDFbVJCOXSUGKdLTcYIEaZeWNgRfHBAMP,QFCFDIGEFCBD.JEAFOAED.UFEHKCCCLHFG.hAAATFFFIBAEECEAeBAChAAA..gGCDhABAfDADABGFbBGHCAHASCHF.hACAdHAHaEAHNABFBEHAMADF.hAEA...,1,-1,-42,41
gFXJWZaGUcIOQAfMTPVNRHdEKYbDeCBLS,MCEGVCEG.HCBH.KGABDIDCBHFELGBEFDHB.JDBCZABE.aGDDUFFGhAAA..OEDBhAAAAHIH..fABFhABA.TAGANCAAEFFG...bEACCHHA.gADFhAGAWBFE...hABA...,2,-27,-17,10
QaOEZLPgbWXKUHMDfNSFVJBCYeRcGAITd,dAFCOBACZBGHLGFE..PBHD..gEDFhAAAXDFCKGBEMBBDNFAFFFGBhAAABCDH.CADDeEABRAECADBCTGDChABAaHAEEHFC..WDBADDCDSABBhAEA.....hACA...,1,-9,-27,18
KUYcOAMJNGgfEWTCbaXeLDHQVRPZISFBd,MDHDGCDC.EAFDCGAH...XAGBDDDBQBACREAHZAAG.FGHDBHDEhAAAKAGG.UDGA.OCAChABANAFC..fEEEhAAAWFFD.aGDB.eEBB....hABA......hACA...,2,-39,-12,27
JBVUCeHgAYXKMOdcLDRQSTaNZbPfGFWEI,KDDHdGEHLCBADBGE.SDFEaGEDZBDC.....PEADhAAAFBAGEEGDBEFFUEABCBBEHAEEhABAADFB.MAIFOHAGhAAA.RCAA.NEIGfGCE.WFGBhACAIHHG...hADA...,2,-35,-25,10
TcFXQGYAaBCgNbdSWePDZLEJVOUHRfIMK,aFABCHGB......gCFFbDGB.dAABeFDCDECCEHACOAADhAAA.HGEERFCGMEABhADATCDCFDHH.XADChACAGBBBABGCSHCG.WAEE..hAIA......hBAA...,1,-15,-24,9
bFMDLcIKZYQdJHTSfANCaXOVWEPgeBURG,CDGGaDCE..ODCFEBCE..eAEBUAFDGDAAFEACLABBKGGCQGCEhAAAHEEE.SEFGhABAfAAEAIHENAICVGAAhADA..PAGHBGGAMFIHDCAC...hACA......hADA...,2,-16,-11,5
GMZXUWPfVSYgKQCEdRTObANBDFJHIeLac,BFHHFBFAHEGDeBEEaFEHMBBH..ZDAAUGED..PAADSEFAhAAAKCFD.CHAAdDDBRFAE.hAAAOFACAIEGDAIH.IHHAhABALHAA.XCCAfAHG.YACDhAEAEFFD...hACA...,2,-22,-14,8
RIYOVBFNGLaZbJQcHgXWSUKTCMdfEPADe,RCGBOADEBDDDFFAALACD.ZGDAJBEFQDFG.HAGFhAAAXABDSGAHhABAKGFF.MECHdHAHEAAFAEAEDEIHhAEA.IHHC..NAEBaGGFgEDDhAGA.....hAAA...,2,-45,4,49
eFZbGARLKMNCYDWfgTaVXBUHJPOSIEdQc,REDFMBBDCAEG.DGDF......fBAFTACA.aCDAXBGAhAAAHFGBJHACODFHhABAEBGHdDBHQEAFhACA.FDDBbDFAAHEEKGGDWAACBHBESAGEhAFAIAGH.cEGA.hBDA...,2,-20,-18,2
RLGFfeDZYAQVTdOINbCgPMSXUBWKJaEHc,QBGFVDGH.dFCDOFDE..NCBH.CBFCMBBDUDBHBAEGhAAAKCCD.EGGDHGAA.LAEDhAAAFABEDGABAEEGIACFhABA..PHBCSCGEJEHFaFFB.hAGA......hAHA...,1,-19,-28,9
UCLSYKNZdbWgJXeMARDcQPOTVFaHfBIGE,REFHQFEHOCDE.FCEDHGACBFBAGAABUCBHLCHDSEAEhAAAKAFHdAGH...WHEGhABAJABAMAAHAAFB.DDGHhAEA..PFHDaHBEIHHB.CAHF..hADA......hAEA...,1,-15,-21,6
HEPXKbLFCMcNGIVURfOAgSYaZdDBeTJWQ,SBGAaFBGZGFC.dFAEDGCHBFCH.eACHJAAHHBED.EAGBPEEChAAA..bEEACHECMBEHhABA..cCCChABAIGHH.........hACA......hADA...,2,-36,-33,3
WZXASbBOQGVceDEPLagdKIRCTMUHJFfNY,SHEEOAABGFCHeBEGDAIDLBHH.dBCAKDBGCEDGMBAHhAAAJDHFFAEA....fGGDhABANCCH.WFFChACAAHADBHBA..cGAAEDDE.aCEHIHHEhABA....hACA...,1,-13,-42,29
DMPabSXeJBKWgOLHGfRCdEUTYANFIQcVZ,FCDCQAGBZBFHDEBC.aADB....SFCDeEDBBGGFKEEDgCFDhAAALABCHFGFhAAAfCAGCHAA.EFAChABA.UCCHADIFIFAGMICG.PHDC.hACA..JAHDODHDhAFA...,2,-22,-13,9
TLbXZeMRJIECKVaYPBQUSHDfdONFAWcGg,GCABLFBDZFACMBCBJCFH...CADEKEHDaBFA.BAHE..SACGhAAADEDDdGGH.FHACABBB.hAAA....WFHDhABATGDD.eAGDIHEEEEEG...PECChADAUBDD..fCAEhABA,2,-42,-26,16
ERCPSfDLIXJOcFgUVWHMQZBeTGYbKaANd,EHCGCAHH..SEACDGFDLAEE.JFBGOCCG.FFGAVCEGhAAAMDEDBDCDGGEDKCCE.hABAACGDdBAAREGH...fFBGhAAAIACD.cGAH...WACEhABA.ZDFE...hAIA...,2,-36,-13,23
FVDdCHgYOIRUTcWNZaQEXASLbJePBfGMK,LAHFeEEDBCHFGDBDKBBC.DCDCHAEHOGDCUGGE..TFAHhAAANIBH.ZFGHQCAChAAAAAFF.JECBMEIBhABAFDHDCAHCIBBE.....WAFHhACAEGAF.SDAChADA...,2,-28,-14,14
cCJTRIUBNQeXaEFAgZYDfLGdKVSMHPWOb,ZAECDBEFLEGHKCHB.MFBEHDAG.PGAAOGCE..CHFHRAAEBAGChAAA.eBAGEEEAAAHEfBGFhABAdFHC.SFADhACA.WDAC..cGCDhAAAIFFD.NIEFaCGE.hACA...,2,-30,-21,9
ZRYLeTHPbGNAFXUVDgMfcKaOJdIWSBQEC,FBHFUCBEDDFAMGBC..KFCEOFHHdCAH...SAHHhAAAQFADCGADZEEDRGEGLBBChAAAHADD...PDCEhABANBAAABBC...gEGA.fAFAhACAaDHFICFGBEAChADAEHBC..,2,-32,-18,14
EVJcFDbMZLXfNPeCORKdSIQYHBAUTGWag,GBBAaCGH.EBFAJADCFADG..DCAAZGEGLHBE..fEDAhAAAeHFACEFD.RCGBSGAFhABAQDCDBABEhAAAABBD..WDEBgAGB.cBDChAIAMFIH.....hACA...,1,-24,-31,7
WPBIfUJTZRdNSGDHAbKVOEQecgLCMXYFa,VBCBOADH..QEGAeHDGLEBDMFFD.FBAH..aAHBBFHGhAAAUEAHJDEAZAABRAEASFFBhABADGDDABGD..hACAKGABECGECHHD..YDFEIHHG...hAAA......hADA...,2,-23,-18,5
VbaSfRIQHBLMEcZeXYPWCDNGOFKTJgAUd,VDGFaGDE..RAEEHCCEBACFLEAG.EAGCeDGF.XBAGhAAA..WAABhAEACHHBDEAEOGCCFFCCTGAEhABAACGAdEECSCDGIEEGMIDC..cGGHhAFA....hAGA...,2,-36,-10,26
ZRAdGBETcMJeUFgHNPaWVDObfLQSCYIKX,GFDFBFAEEBHBMBAEUEEEFBEF.HEAH.aCGFDCCE.OACALDDAhAAACHEF.ICADhABAKABDZDGH.AEIDdAGD.JHFENDBH.hAAA....WHAAfGCE.SAGChBAA..hBDA...,1,0,-45,45
ASODXeRYTCEMgWLVGHIKJPFbQBdaUZNcf,DBFGRBBHCAEB.MFEGLFFFHABF..KFAAFHCGBDHFUEGEZFCF....hAAA..NDEF.ADBBSCEFhABAOEBE.XFGEhADATAGD.EHAA...gGEDhAEAWCAFIAAA...hAFA...,1,-29,-34,5
QMJEVDWHaScFRCZeXOIgUGbfYBPKLTdAN,QACEEDBBDICG.aEGASEGD.RDDDZADCOFEF.UAFGhAAAGBADfCAChABABHFELFAHAAIHMFBBWEBEhACAFCGE..CAAEIEHEgGGG..hBAA.YFDFKAGC.hACANDDF...,1,-7,-21,14
FNCAGXdWUOHBfYaMJKDPecbTVRISEQgZL,XGEAdHCBOCBAHCBHBEAG..aDHFKEEEDCAB..eEBG..hAAAcGAHVBGDSGGEhABAEFAGQBEDLADGhACACHHDABBGUEFDMIFA.......hAAA......hABA...,1,-17,-23,6
aNEYBcVHKAOLPGCZJQTFfbDeWdSXMUgRI,OADFGBGEZEEH.JFCDTEGD.FCBBDCBEdGBBMDBD.UAEChAAAIAAH.aEEDEABGhADABFAC.HCFAAGEBCHHG.hAHAQDCD.fGHC.hAIA..WHBA.SAHBhACA,1,-11,-39,28
XJfeEWUGSZcKgDRLFBMPaCYdNIHVTObQA,XBDHJBHH..EGAFGBGAZCBF.KAFFRGCGBGGGaCAD..CABCdGCGhAAAHAED.OAAAQGGBhADAAEEG.fEFAhAEAeCGDSEAFDEEDMCCFPBDBIGAEhAGA......hAHA...,1,-15,-20,5
ULQbDICRKVMgTSEWOfaFGcAYNXHBdeZPJ,XDEGBEAFeFBFZAACUDDCLAFF.QDAAIHCHRBBFMIEChABA..SGGEhAAAOBHDaFGBFHFEAAHCHGBEhACAdBFHPACADDDDCFHH.KEGA......hABA......hAGA...,1,-1,-25,24
cPLKNFOXMgVZQRTBYWCfEDHJaAeGSdbIU,GGBFSGGCdCEDUABDLACAKEGC.FDFG.MBAFZAECQGGBhAAA.BCCGYBHHhAAACHADDFCA.HECCAFFF.hACAbBBC.IHEF.cGBE.OEADhABA....hADA...,2,-29,-18,11
gFbIKZQUEJACBSaHWfeVYPONXRdTcGDLM,BFFCHCBGeACA.VFBHODCA.XAEBTFGHGCEEhAAALDGBMIECFABDIEBHhAAAKAGA...ZGBChABA.EADBAABAaDAH..fAGC.hADANDIG......hAGA...,2,-23,-9,14
JUfOHBeGdKXPWRbZaFNMITVgYCcLEAQSD,DEDDJCED.OEBBBGDAGAEH..KBDE.XCGARCGBZABHFFACMDCEhAAA...IHCDhABATGFE...gEEAhACACHADEECDAADE.SGHF.fBBChADAeAAB.dHEBhAEA.WAFE.,1,-26,-27,1
TCbGeNJOUXMDERISWAgFPYHLZaQdVKBcf,FFCHHADH.LDAAZAAEaFFH.dDGABEDFTFEAGCEFeFAA.OAAGhAFAMFAB.EAHBRCAF.IHCEhAGAAFID..gADHhAAA.QGGCKGHBCHGG.NIBF..hAIA......hBAA...,2,-18,-6,12
VTELeGPOgAIZXCRQMfSKHJBFUDYNcdWab,XFDFCBBGRGCG..QDCEMCDC.KHGCHGFCBEAHFBHFUGAGhAAADAECNABG..dEEEaDGC.hABA.TADAEEBFeHAAhAAAOAHHAACEZCCA..SDAC.cCFHhACA....hADA...,1,-8,-31,23
JdIcbQOESKfHNADLeUaVCFXGRBZMgTYPW,eCBHaFCF.FACCRCEHBBDGZFDD..MAID..TAGB..WDEEhAAAdEAAIABFhAAA.QFGFhADASFGEKHFAfHBHAGCHDGEF.UAEACAFC.gGGDhABA.YDCBhAHA,1,-22,-36,14
EdUJSPcMQGFORDLANKfITeZVXBHWagYbC,KGEBTFGDeFDC.ZBGDBCGFHBBD..aGAH..bFAHCBBAdCDF.SFABhAAAPACGMDDChAAAQEDEFGHB.DABChAEAADIBfECFXEBBWHDAEBEA..cGCHhABAOCHF.NBDD...hAFA...,1,3,-28,31
fJEICVXROPFKUTcNagQDbLHBAZWGeSMdY,ZBBHGDBHMBABdBBD.JBFGCGAH..RFDD.FGDFUGGF....TGAFhAAAaDFA.DGIDLBFGhAAAAGFF.SGBHhABAEEFCIGGCXEEF.KAGCcAEB.hACANCAE....bCFABBDBhADA.eDHH,1,-7,-35,28
XHgKdRbcDVFGfeYJSMZWBUCLAaEPTQION,aEGATEDF..OAEHHCEGKDHHRDBF.DHFAFGDGeAAD..SGHBhAAAMHBCBAGECAFCEHAChABAIEBA.NIAFdADChABAcBGB..fFGBYACHZFFBWFAGhACAAEEB......hAFA...,1,-19,-23,4
EYJNgMFcDHaZVIedUSBOKAGTXQWbRCLPf,GDBCQBDARBBECGFC.LACF.EAFEJDEGMFCBDIBGHAEA.hAAAZEGBIDGFdABBBBHAhAAAOFHFAAGE.XGFDhABA.bBFEYEAFNBBCFFEDaEAH...hAEA......hAIA...,2,-26,6,32
VPERXIGOKWCJQZcADegTaYFSBHUNMdLbf,DCDAeCCH..aAHFFAGBHFEBMBBBLGAG..bACCVDBHEDHHRFEChAAAXAAE.IAFAhAAAKFAGCEEGJHCCQEGAhABAAFDB.YDDCBHHG..NBACfBHAhABA..hADA...,1,-5,-23,18
SecdfKTFCLOMDGHAXYRgbaPNWBJQZUVEI,RGDCaCGG....NBIC.BCCEZEAB.EFED.SGBFeDDBdDGGKAFACADGLECHhAAA.DBFFADFHXAAHhAAA..hACAYAECPADDQGGGIABCfGGBhAIAOHAEMDAB.hBAA...,1,-11,-47,36
YPCOSWJFERdLMecaIVQXDGNgZHfBKUbAT,TACGCGAH..ODFAJFDF.FEDBdCECLGEGMCCH..eGFChAAAaBDC.QCGChABADAFEGCABZAFCBBBFKEABADDFSHCGhAAAECAF.IFFGXGAC..hACA..NBEB..fEAAhABA,1,-18,-31,13
ZIEUMWRcVPdGDCQXNbTFAOKJaSLgfeHBY,JCAHSACELDDAeFBABCHAZGBE.EEEEMHBA..RAFCVBAChAAAdAGGDFFH...QABBhAAANIEDFFGD.KCDEaFABhABA..HEGHICEHWFBA.....hACA......hAEA...,2,-32,-5,27
AgGSFHZOQPbJRdVcBDLaNIfUeCEMTKYWX,GGDBFCCAOEEDQCBD.JBGFdBAGBBAEDGGCaGAA..fEEFhAAAeBFA.CFBHMAFGhABATDGG.KGDFWBHBhACAABFCSEAE..PADD.hAAA......hABA...,1,-17,-39,22
CHMeRUIDWEdSPFZYbAOQafBgcKTVXNJGL,QDDHBDHBKAAH...VFGBXAGEGEBGLDEFCBBF.hAAAMFBHRBFDIBHFhABADFAHdACBFGCFZACBAAFA.aGFH.hAAA.gGFANCAA.eCFH.ECCASFDHhACA..hAHA...,1,-10,-21,11
IWCZYbVSNMEdgGcKQAXJfLHUFTaPOReBD,XFCCLFDDUGAEFADB...TDBEOAAFBEGADGFACCCGZAEB.hAAA..VFEFMAFDEADFhAAAdGAE.GDEHKABEAGIFJAHBhAHAaAHBeHFE.YCAF.NICB..hBAA......hBBA...,1,-10,-17,7
LbfINBcZOJWKaGRMXVUEAFTDSQCeYPdHg,TDEHDBCACHED...eHDGdGHGLCEA..IHBFhAAABEAEZGAGWBEGKAAEREEGVCAAhABA.AAGG.FDCF..QFGEhACAHAFE.fFBBcGEFaFAEMAIFhADA...EEDD.hADA..SAFG,1,-3,-32,29
TSgBMPFZIHDNEeGJObaYVQdCfWcXALKUR,KEDGTCBCBBCH.FBEEHBFE.EGADeCFAJEGD...aCACQECAhAAAdFGH.CADBfFBEhABAXGEHAAHELGAGhAAASEFFMABGIHDDDEBA.OAFAhACA.YFHB.hAFAcBCF.,2,-30,1,31
MfKBGFARIgeQDOUXTLWbHZJYaSNdEcPVC,RCAFeACCOFBCUCECLAGHHGAGZDGH..aFHFSCAA.hAAAEAGGVDDG.fABFhABABAACAGGFIHHAhACADFGDTADCJEBC.NIEH........hAIA......hBBA...,1,-16,-20,4
JfEDKNcTGQRMCaeHSVPABOWXgdbUFZLYI,BHDDOAAG..XAEHdEBEFGFCLHBG..JDGFDDEGKCCDhAAATDGDQFDAhABACAFAHBCASEBDhACA.AFIB..bAGFYAHH.fEEDhAEANEAAcGGHMBBG.hAFAaEDG..,1,-22,-32,10
FTXAbIUMBDPfSeLgGdRWOJCEcHYKNVaZQ,UFBADBIH..SBDALCBEGDEARDDDOFGDCAGAHDGH.KABAhAAANCBC..ZAAGQGGFhABAFGCFAHED.MAIHPAFGhAAAfADD.dGAGEDFA....hABA......hACA...,1,-2,-30,28
UPgGeFBAIbHQXYRWZKJcETNOCDfVMSdLa,HBFGXEBDRABAZGAAKBHFEEAG....TFGCOHFA.DEDAMADGhAAAdEGDLCAGUDDBPBCChABA...eHAGhACAAAIHIFDBQGDAWFFGNBBA.CCEG..SAAChAEA.aAFG.hAHA...,1,-8,-18,10
IUBTWedFHZKPMJgNRbOAQfYCXELcGVaSD,QGGCCHEALEHHGCCGaBEB..SDDDDBAFBBHGeBDEhAAAdBABHGCA.KCFDPGAChABAJAHDREAHAADE..fFEFhACAXEGEECAHICBD....hADA.WAFE.FEAC.hAAA...,1,-13,-19,6
MURASXVPLOdCFeDQGJHKcaBTIZEWNYbfg,SADEVGAC.ODBBdCBFFDEB.QAEHJAACHDFFKFCGBEHDhAAAZGAA..EGFHNBIA..hABA.fAGDhACAUCDEAGHB.XDACCCCDDGIFaHEEIHHC..hADA......hAEA...,1,-16,-27,11
RCJLgZEOXMcUYGSPKHBVDfNQAbIeFaWTd,eBCHaGCG.dFGACHGALEEBEABC..XGDHMIAG..UAADhABASGAHKAGEHDAABCHBhAAADDHBQADFhAEAAAGBIEEHTCFF...gFBBhABA.OAEB.hBGA.YCFH.,1,-13,-17,4
gXdfbcFEZHGTNPJQeADWKVRBYSIMaOLCU,KAGHRCABBFFG..SEBFaAGA.ODGDCCGHUFCF..dDDG.hAAA..fBADhAAAbCCFFACCZGFEGGCD.hABATACCPFAH.eDHHDIFAWAFF..hABA......hACA...,2,-34,-21,13
WCSVKfYQdNHJBLbXgPUaRATZDMEIceOFG,ZGDGEBCF.eEAAFDGAGCAECCBF..KCGAQGAFdGBAHAEBLFEEhAAAXGEF..UAFEhAAAAIEADIGGMFDDOBBAWEDEhABASAHB.fDDB.hACA......hADA...,1,-17,-21,4
BXYOSAbIfPCQFVTJDGeEgaHLMZdWRNcUK,..IEBACBDFFFHB..JCFGeEFA.aBGDHFAELABFMECAdCABhAAARACAUGAEBFFH..XFDGhAAAOAFGAHEAPDDEhADA.QGGHDIDGEHBA.WAHBKABESFCEhAEA..hBAA.fBEC.,1,1,-26,27
HJGWXFOBfTdLUMEZbAcaYCgSDNKPIReVQ,aAGGCEHGDGAB..KBHFRGEC...QFDGGDCHFBBEODBDBFCA.TABBhAAAdBHA..UAEGhAAAEGFFAEDA...gADHhABASDAFNDIGeDGB.....hABA......hACA...,1,-11,-42,31
ESGZIdHCgefXTKYFNALaBRJMUDVWPcbOQ,aGCBBCEF.MFGHDDBA....VACC..WEBD..PEGFhAAAOFHB..QGEChABAECFHSADEhAAAZCEGdCACgDCEeFAHXAGGKBCCFAHBAFAF.JBADhABA.cCGE..hACA...,1,-13,-35,22
fOceLXDTJWCAPgHQbNEIURSdBFaYKGMVZ,HDCEQADAEFHFRFDDdDAAaCAE.GACHZFBBOEEGLCGB.DBIDJBFAhAAACHBB.ADEA...gBAEhAAAIGHBSHFGhABABAHF.YGDE...KGAFhACAfCFG.hADA..eFFB,1,1,-28,29
QBHNYceXUPbgZIRWDTGVfOKCMSdJLFAaE,QFACHEBA..YBBDeABFUEGF..PHDAbAEDZCCBhAAAIDEGDEFFGGCHhABAOADBCADHSAGChADAJCHDLAFGAIBEEHGCBGGB...NBAGXGADhAAA....hABA...,1,6,-16,22
BYZUXLEeFDSQbIJWKfPVAMaOTNdRGgHcC,OEBFTADG.dAEERFDAHDECBABAZFDGLHAG.eDAFFDECDDDHSCCBhAAA.IBABhABAKHDA..fDAChAAAPHFGAFDGaCGAGBGGCGBD.XBAGhABA...EHGA..hADA...,2,-35,5,40
QDKbTCeUMPGEVfSZgLNdHABFRYOcIXJWa,BDBCRBCBOEFG..XCEE.JFFGaECE.QDAGhAAADADEKAHF.TAEHUGBFGAABhAAAfABCZECELHEEhABANHBBdAHEHFGFACEG........hABA......hADA...,2,-27,-14,13
VeFDGWNdBcJYaRPESQCZMLAXfTgbKIUHO,TBADKGAFHBGF.eAAHFAEBDCGEGCCE.dDBGBGFF.JDDGaFFBREGB.hAAASAEBZGAG.hABAAIFEXGCC.hACAgGGGUDAHWHBA......hADA......hAGA...,2,-34,-6,28
NIegHGLYZDfWOUbTJVMAKFdPXRQcSBaEC,dDABXBACQBFCBHBF.CEFD...IDGGHAAGGEAC.hAAALEGBDFBCOHFAhABATECHJBDDMICCADDGKAHHFHDEhAAAPAFCSDHBNEAE..eEEF.hABAYDHB..hACA...,1,2,-32,34
MCORcSQGbDZVAEUJPeIFBdHWXgLTfNYaK,UFECeCBEBDBHHADA..XCDGLAEA.TCGB..NBHGaFCFhAAACABBREFE..QGAEhAAADGCFACBGJFAD.IHHGhADAFHGEdDAD.fFDCMAFCSABC.hAFA......hAGA...,1,-11,-23,12
LMRJKCUTNAVSIbfGZdOYFeDWagPQXHcEB,VBCBSFGB....bCEHZBDDdBGGFFCGDHAGaCHD..QGEGhAAAXBBFEGDFBHHHhABARBFHKEAEUEAE.AICEICAFhACAfHAFOEHBeAADPFFB.hADA.LAFCCAHANADH.hABA...,1,-5,-15,10
LcRWGJISEZdeVHQMFUCDNTgbBaAPOKYXf,OAFAXGDDLDDFRFFD.GGDDSDDEdEBCeABAHEBFQCFChAAAFADFDDHDTAAEhAAABBAD.AHBDKFHH.fAGGhACAWEEG..EBDCMAIBNCIG.aAFH.hABA......hACA...,2,-13,-3,10
BRSZTDFHVIgXGQbCJMfEdYLUecAOPKWNa,OCAFKGAG..aACDRAEAZACHDCGD.HCFH..VEEHXFAE.hAAAQGGCCECHMEIDECBBhABAdAHA.LFEFhAAAUAFDAHDH.WECBBHGCSBAEIEAG..bADDhACA......hAGA...,1,1,-34,35
FReZfPbELMIUSKNYgHCWcDaXJVQBAGdOT,GBDFTFAA.FFHFeAAFZCAD.....bCCFEDDFLFEHMHAGUFEFhAAASCFEKACG.hABANDGG...gAGEhACACAFDWEHDDAID.JHBEBDGCAEAH...OFAEhAEAfDBG..hAAA...,1,-11,-21,10
ZXYNVEJDCTFQOHASdGBfMcbgWUPLRaeIK,GBAGBFAGMCGF..gGCHUCDHLFHHaAFC.KEBAZEEA.hAAAXCFF.NEAG.hAAAJAEEDDDBCHCBFABG.OHEGhAEASACE.fCEE.hAIAWFHHeBHHYBHBhABAEEEB..,1,-7,-33,26
QVXOTbSacEgNGKIdAeRDYLHCZUBPWfFMJ,RGECDDFBHDAFCHCE.BCAF....fDBCJFDEQAGEOABGhAAASDEEaFGD.hAFAEAEFNBICGAFEKDHBACCGLAAAhABAPDDHWBBGMIBGXGAC.hAHA......hAIA...,1,-6,-34,28
NRJWAfHQBKTDLaIZMSgVCYEbUOXPeFdGc,HAGHKCAEDDDDaBBDZAGDMCIH....VFDFECFDOADB.XGABhAAAFGGFdBEBGEAAhAAARECBAABCBHEF.LFGBhAEAIABHgEED.CAFC.YEEChADA.....hAIA...,1,-4,-32,28
GcdYUgKHPeFXVbaOfMLIZNREWDCQASJBT,BCDFTGGDGEAG.dAHCUBABHAAFeFCBFFGE...VAFBaHDGMDEFhAAALFABZAFHEAEDhACADDDGAEFD.SFGChAAA..YHEGKGEB.PDFB.hABA.OEBA.IBDAhACA,2,-15,-12,3
fELJZYINeGFgSabAPUcVOQRTXCBHDdKWM,UABFVCAB.RAED...CBHFHAAGKHAG..MEAELGEEZFEF.NFDH.FGGGhAAA....SCFGhAAAAIDCOAHDQDGGhACABHEADIGAfHABJGBC.IDDFhABAeDDG.aFAE...hAEA...,2,-25,-17,8
dQVbLMOSCefUXPGIYgHRaFZEWTKNJDcBA,QAFHLDCAOBEESBBA.CDAA.UFGDGDECIHAFhAAAHEBFFGGAEHDGTACFhABANABBDBIHBEDC.ADDCdHEDhAAAMBBFeHAGXFAE...YAFChACAaDHH.KDGE...hAHA...,1,-4,-8,4
QRFYWGTMKVDbHCeIOZXgEcadBPNJULSAf,REECFGDHGBADKBHF.DGAFHABC.CFBH.eHEEZEFF.EDADdCADBDHC..hAAAJAFHSAFBhABA.AIBEQFCGhACATEDGMEACIDEEOFHFXGAGaBDANEIA.hADA......hAEA...,1,-13,-23,10
NKgbdVcaLAUIGDQYfCRMeWPJSXBZHOFET,GEBAQDAACHEDRBEF.MADA..eADFJCEGBHBCODFD.FGHFEFFAhAAAKGAFdHED..VBABhAAAaBCELAHH.hABAACAHIEEADAFAfHFDSFHH.hACA..XABChACA.HFBGNBIA,2,-20,-3,17
VYKgEUdNPLJSZIXCDebHMaQWBRfGAFOTc,FFHBTFED..VECDKFBFUADC.dAHGLBEFZDDC.CBCDDBABhAAAHABD.MBAHaDAEBBHEhABA.RBFF.ADGGYFDFhAAAEFAB..JHDGSHFA..hABAIFFF..hACA...,2,-33,-15,18
LeQCNFabWVPOXIMAUSGcfREYJdgTHDKZB,GCABRBEHECBF.dFGGHEBEKAAFBEAHLHFC.CHAHFGDBaFED....hAAAVAGDOAHH.IFGEhABAMEECAIFEUGAChABAfACEJBCC.DEAHeFDF...NEIE..hADA......hAEA...,1,-13,-21,8
MbSVFGZYaHdKgWQRTUPfCOIXBceAJNEDL,EABEDDEGLCCF.MFGHbEDDFBGF.ZDAEHGAAdFGH.KAGBQFADhAAATADC.fBBEhADACBADOFCEIFHFhAAAXADHeDFFAIDCNAIE.SHFA.hABA.....YDADhACA,2,-18,-17,1
EYLBXJRASfQVdDeCZHWKFUObGPaMgITcN,SECAQDBDDAEAZBGFKGCEFABH..UBDBOABFGBGE.MIBChAAATFFE.NAAA.EFEDhACABHAHJGBA..AHABdGHChADAeBFDCEEB...WHFA.aEAD...IBDDhABA...hAHA...,2,-23,-16,7
dfHPAOBNSgQRMEaeXCLGUYDFTJKWVIcZb,BEECSDABRCBE.EHGCaEAG...CHBDLDHHUACAFFGGTGEAhAAAKFCH...IGBDhABAZAAGdGECHBFEAFDBNAHC.hAFAMHFE.eFAFXEDB.DGAD.WCDAhAGAcADD...hAIA...,1,-17,-29,12
DZWCbTaKYBAeFgOScGUIEXJMRLNQfPHVd,eFDHOBCHGAAFUCGH.EGFE..MFDERBECQDDHHADADABECFHBaDAAhAAABHCBAIGG..gEABhABASAGBIDGDhADAXFAC.LHEEfAGB..hAEAPAAB...hAFA...,1,-9,-21,12
JYeHPagRMQBTFGbCVdLIZEcANfWUDSKOX,...fFAFDHFGSBCGKGCA.JAFHeCDF.HFEC.PBBAhAAAgDGARAFBMIAAhABAQDDFBBHETCADhACAFCADCBHCLEEEEAAFAFIDNIAD.WFHH..OEBDhAAA.aFFC..hACA...,2,-31,9,40
UTVQHAGXYZcJRWgLKCSEBdFIfDOabePNM,XEGGZBAGRAEDLDEAKFBC...CGHABFGEIAAB..OHAGhAAAeACFMIBCUGDE.TAFFhACAQEAGAHCGGBDChAEA.JGDCSABC..FHGEDGGHhAEAaBHDNAIC.....hAGA...,1,-7,-26,19
NZCLBfDMcTJVUXHEKdWPOFAGYaIbegQSR,aBEFeBHD.QDBDRDFBZGBEBABGMFIH.JADHUCCG.HAGDdGEBOFABhAAAAIGC.ICFBhABAbDAF..NDIA.CCAEDICAhACA...cGBB.....hAAAXEFEKACC.FAEAhAHA...,2,-22,-16,6
cFAJIUGNMYKXgHbBaLVeDCQfOPZWRSdET,UCFEMIAGKCACHABGBCHHaGFE..LFAHDBED.CHDC.OFBCZDDH.hAAARAFB.EAHDFFFFAEAA.GDBDhAAA..NCCC.XABEhABA..........hACA......hAEA...,1,-23,-36,13
JYBPAZKgVTNGWMFURXaHEceSLbfQOIdDC,KEDATAEBGFAH.MEHDREDDHCFG.EGAHeBHBLBCBQAAGhACAOBABDHDCJFHFBEAFhADAAGCAZFFFNCCB.....hAEAFHBEaHACSDAHfDEB.CGFBYADGhAHA....hAIA...,2,-18,1,19
FGPaCQHcTJVLYWZBdUOAMbeIfNXRKDSEg,MBBAeGBG....IAAGfGDHRAEEKBDDECHD.GCAA.hACACAHGQDFHhAAATDAGLFGHZCCDdHGFADFDNIBDDBADhABASDGCFGAHaAFH...cEDF.hACA......hADA...,1,-3,-20,17
YTGSHPWVUAXDJKgCBOELabcefNIRMdZQF,JCACCEAFBGCDLGFE..aBFBeEAF....NEDF.RDFCdHCFZABHFBHDhAAATAEH.SECFhAAAHFFF.PABGhAGAUGDGAHBB.DBBHKFDCEEBHfHFFMADE.hAHAQBGH.hAIA...,1,-5,-29,24
AgCcOXdWJBPeZRMGFbKEQHVDISafNYLUT,CAAAOGFCdGCCBAGEZAFHRACC..FEDGKBAG.HECFDGFF.....SCEHhAAAaGGC.NICB.hABAUBCB.ADAH.gDADhACA.XEFEPCFAGDAChAAA.EEGDIHAHhADA...,2,-41,-25,16
VAaeWPHFSdDcOfJCEGQMUKYbIZLNXTgBR,aBFGeAAHHDBHFAHBdAEGDDAF...OEHDJEFAGEDAUDFH..KDDBIGHHhAAALGAEXBDHhABABBFEACIB..SDBDhAAAfFAACGFD.EABC.MIAA...hACA......hADA...,1,-10,-30,20
WZIYXBbVGNCOLREJaKfFQeMPSHgdTDUcA,ZCEBXCEDBDGHGACH..NBBHCCCALAAD.JFGBaDHDFCCFhACAeGFE..MAIDhADASGACdHCF.DGDHhAAAAAGE.ICAD.YECAbFAF.OBHBhABA.KAFC..hACA...,1,-23,-33,10
QTNULSOYMEaeJCgXAGHDPZfKBVcIbRWdF,DIECZFGHKCCBBACB....VADGIDHDREEB.dEABFAAC..QBDAhAAAUGAALCABhACASFEGMEIDECFAhADAeEEE.CBFAABAF.GGAHfHDB..hAGAWFHHOAHFaBCHXAGBhABA,1,-22,-23,1
dKBITQfSeNHFVUGbZcLgMWOYaRCEDAJPX,XFDBKDAGBADD..QFFEeDCGHFGFUFDAZAEBLAAFhACA.gBGAhADAMCAAOBFEaGBGCAHCDFBH.AIGEdHAHhAAAIBCASDDAFEAA.....hAEA......hBBA...,1,-2,-36,34
YBUAJCXdKDVWNQGSEcfZTLFaMIOgHeRbP,CDHEXEGCDCBA....VGEGQBAAGEAC.EGBHZCAAFAEG.hAAAMECCOAEGeCFARCED.hABAPHEC.BCCBhAAAACHCdGDGKAGASECAfFCBaABE...hABA......hACA...,2,-18,-15,3
HFRdYfgGILbPBJOKAeDVXUCESMQTZWacN,VBFEXACG.UGGAEAAD....SEBFTCFDZECAaHEGHGAGhAAAFACH.dBFF.fCDGhABAIEDEbFGDBEAHhADAKHAEDAIF.CHEDMAEEWDAF...cDGDhBAANDIG......hBBA...,2,-21,-8,13
GDWUIaJeYSLfdNgVKZQMOCXERFAPHbTcB,HDABTAEHBEGE.DACEUDFD..aGFGeCCHLCDDdAAENIED.KAHDhAAAZDADOCEF.CGDH.hABAEGFEABBE...PAHFhACAbADA.GGAD..IHHBSEDHhADA.....hAFA...,2,-33,-2,31
fgLSERKMIcJHXQVdeNbFCZaUAGOBDTWPY,BHHEDBEE..TGDH..YEFCLCBERAAG.MFDG.IGHHhAAAJCFGHEAHQCGGhABAeFCCFCABCGGFZFAHADCH.hAAAODBF.WACCfHBFEAHBKHFA..hACA......hADA...,2,-31,-5,26
FcQeCdKSTZDYHgVBUEGRMIaNOJWXLAbPf,...fAEGFDCGeAAFCDHHdEGC.KEHHSGDHZDDHDIDC.HEFDhAAABDBEEGBERFAA..MAHDhAAANAEF.OCAH.XABAhABAAFDBPBEG........hACA......hADA...,2,-33,-22,11
RcDFXbLgOEWKSUZdQHfeNJBGMIYTVaAPC,RAEAFDGELAADEHFA.KCDBZABHHFACeEAGBHEAMGBC...TBDAhAAAaGGFCEGC..DFEBXAFFhADAODHD..UCBEhACAdFFBfDEA...JHBAIHAFhADAAIAA....hAEA...,2,-28,-7,21
IHACBEXLGfPSNdDaFTcZJOgUYRWKMQbVe,EFAELADBGGDFSHBEDADE.FDGBZBDG.ODFDUAGCRCADMBCGhAAAQFECeDEFAHBABAHBhABAXFAG.fABGhAAANEIGdCAB.aHGC......hACA......hAFA...,1,-14,-20,6
ZTMfEBaHCbWFcVedSAYXRNgQLDJPOGUKI,XAEGRAGFQGGCDFIH...OEABGDEHKGBDZABF.MFCCfCCEhAAAaGAFHGCECACGFEHFhABAeBFA.AAFA..NBBEJFGBhAAAIEED.BBEA.cDAA.SGDHhADA..hAEA...,1,-1,-30,29
eZJCDSLcPNMVFEQUfgIAHdXKTOWaRYbGB,dEDCXFCFKEAG..OHBGaHEA..RFAFGADCZADHCHFE.DACFLAHDhAAA..NBAGMCHBhAAAEEFBQBADhABAUAGBIDBFAEID...WGFEBHHC.SGADhACA...hABA...,2,-27,-25,2
PaHAUbLQfdTINRWXecJCSKgBMGEVFYODZ,UAEGQEFBdFGG...TDAFIGEDRFCBeACE..CDHASCABhAAAKBBHBAGGEBHFFDCChABADGIDZAGDaHAAHABEAFAFLDEDhAAA..NIBD....WDAD.hABA......hAFA...,2,-22,-14,8
LTCDNaRBXbQeMgHPGJfAcWOYVFZUIEKSd,OAECVFGF.UFFFKBBHLECF.DDIHRDCFXBGA.hAAAeAAEgAGEhABAGGADJDAFAEEB..cAEHhACAFCECEBBD.dEGFCHEABDAD.MIAA.fDFChADA..hAFAWHDA.,1,-18,-22,4
dMJDbHKGASPfIWUTVCRLaXeBNgZOYQEFc,SDAD..IEGETFEBRBBEXACEBDHBZFAGQAAAhAAAFHBEdBEE.MDEEhADADFIDHCFBAGAE.fAAFhAAAVAFCCFEAaFCHeDBGNEIAOCDHEHFA...hADA......hAEA...,1,-6,-19,13
JMLZPeCFNHGSAQYRUVObIDKWgdafBXTEc,QGFFUEDAOECBDAGB.KEDCdCDB.BEHEEHAE...MABAPDBBhAAACAAG..HFFBAHIHVABChABA..IGAFhAFAaAED.TAFELCHF.FGDDNIBDYCBDhAHA....hAIAWDFB.,2,-26,-18,8
PbHFWZGEcIUdAXYgTVSMKaNDOBLCQRefJ,XBFHTEGC..MBFFaBCB...DAAELECCRGBC.eEGFhAAAfDAEPFHFFDAFhABAZBBFECGGUGAFAIGG.YACChAGASFAA.KEDBBGEBCBDCJAFC...hAHA......hAIA...,1,-14,-15,1
DHSQEeNUgfLPACKWTMVXZdBaFGIJYObcR,CCFDKFBG.MEGHZCADBGGFGACG..JHDCOAEC..RAEGDDDBHCEAhAAA.SEEDhABA.ECAFUGAELFHDhACAAABB.WHCCTDGHdAHAaGAHFFEG....hAEAIACA..hAAA...,2,-51,7,58
LWACdQcXGKSZDgBVFOaYRNITbMfHUeEJP,dEBDQDBFGABEKFHHSGAGDFGF.BGHHFHCA.OAAARADE.hAAATDFEMAFC.HEDDhAEAEDGDLDDHACCDCBGCZAEDaDHFhAHA..NDAE.IHFD..fCGDhABA....hADA...,2,-24,-3,21
EMCSBWRAVGPTXUdNZDbYFOeLJQHIcaKfg,VFGDGADA...TFFEXBBCdAADDEFGFBEDLBGHHDAGIHDDhABAaEED..fADFhAAAEGADMFIFSCGGhADABHABADDDUDABbAFEOGCCeFAG....hABA......hACA...,2,-20,7,27
UcCRWBLJPaHTbOIFVEdSAGDYeMKgZXfQN,DFIFMCIBZCCE..XACDQABB.UEFCRFABBFEDLFBBhAAAJHDAHBEFOAGBFCACEHGGhAAAdHFHAAEG..eFFEfBHChACACAEFaCGF..IABD...hAHA......hAIA...,2,-28,-8,20
GWafIKDSVHbdZCLNJXFTYUegEcOMPRBAQ,GBEEaEAB.KBGCSDGGHEBAdHDBCHAGLHAG..JEGDXEDGhAAAFABE.UADChABAECCCOBABMBCDBGGHhACAAHHG.fBGDDIGA......hAGA......hAHA...,1,-25,-30,5
AgLSKGNXDUCPVTbYOBMRaeJEZWQfIcFHd,LFCFKFBGGADCXCDGUFDC..CAHH.TAEG..bAAHBAHEhAAA.RDAHJFFBEHAAZFGFhAAAQBAH.fEEHhABAFACBAIEGSAFBDEIBPBHB..hACA......hADA...,1,-17,-23,6
OFPUCBIbeRdKJEXYGNHWfLTZADcQSgMaV,QGEASHCCMDBBaBGA..FACDUGGDBDFAeEDGKDHFEEBFXCFBhAAA..NBACHBDBhAAALBAAZGAGAIHCDFAF.hABAcAEBOBBHCBHE.IGHB...hABA......hACA...,1,-7,-27,20
WFJCSDcbLRgPaGEINMfTZVdQKUXeOABHY,BEDGHCEGFGFBCGEE.DGIFLBFGRDBA..aCAGEGBH..MIAGTCAHhAAAZAEEdCHA.KFCBUDGEhABA.XGGDhACAAABFJEAH.SAFE.cCCA.bABEhADA......hAIA...,2,-30,-24,6
OLbfFeaGKXWTPUBHJdCVRQADZMYgSNEIc,DBIFMAFG..SADBEDFD.ODCALBBCFFFH.aBHBXFAGhAAATGBHBGGH.hABAdEAHRDGBACAAZCCF.NIDH.IGDFhACA.fBBD.KDBDWFHBhAAAPHAC...hABA...,1,-23,-28,5
OVbeLABCKRQDFEGZPcgHNTIXfSYMWUJda,BECGKAFHDDBAGEEGZFFB.....PBDFHEDBIHHFhAAA..SHCAhAAAMDFAUEAFdCACaABA.OHAGhAEAeGAAAAFE.QBGBFBBC.EHGG.hAFA......hAHA...,2,-26,-24,2
YdXEcFHMBIUVJGTNReAZLCQSWOaKfbgDP,LFFBSAGEOCGFKGEG....bCAFDDBD.dABB.EGCHFDDFhAAABAGAVCGBGADEhAAATGBGeFBFZADCCABDaDDH.hACA..PFHD..cGGE.MEAHhAEAIGEE.NAIEACCBhAFAWCFD.,1,-9,-25,16
RTfaAgKGFPEMdDSJBZceONXYHQCULbVIW,GBBHEGBDdAAF.JCFBZDFD..eEBBOEBC..XGGGQBDBhADACBHDLHAAIFHChAEATEGBAHHAKAGAPHEChAFADBAESEDBBGCB.NAAF......hAGAYAFE..hBEA...,2,-24,-15,9
PcLYVeEUGQSJAdWfKFMNTZCIBaRbHXDgO,dHCDKBAEFADEMEFAZBEGBBEH..RFDCHDAGDDED..ODCFLHAEhAAAeAHHEDFEGEAC.hABAJGFAAHHDNEIG..CBBC.IHFFhACAaDAB....gACHhAAA......hABA...,2,-30,-18,12
SXeNMdgBFUZLAKOfHcDIGPRJbaWCTEYQV,OAAAHCBCDAEEGEFEJHAC...aHCCTEECQEBD.XCDFhAEAeEGHMAIDBHHChAFAUAAHAFEFKAGF.IDHGhAHAPAGFRFBECBHHEBBBSDAD.NEIE..hAIAgBED.hBAA...,2,-16,-5,11
JLNKAHObRcdaMfXgDIWQVZGCBPUEeSFTY,OFAGRBCAdGAH..MDHBXCCG.DBAFIEDE.QDABhAAAGGABPEEDhAAAEABEFAFGTBED.LAGHhABAAIAGbFFD.fGHCgCFF.WEHHhADACDAHBBBC.SGFHhACA,1,-11,-32,21
NUAJOSMVQYbdFLWaXPfIZEcRgHDGBeTKC,OEAGMDDB..QEAFdBDGLFFHaACE.XAGE..hAAAfBADECFDRFBGDFAHeABDhACACFHAAGFEJEEC.SCGAhAAAYCHFFHAEIAHG.gBEAhABABHHANADB.UGAH.hBAAWHEE.,1,0,-32,32
SgcdNOUBYPJVTEFDRWebKLaIQGAMCXZHf,XGEHZDDGSCBBdCFC.UFGHBBBB.JBHHEBFF..FGBADBEDRDAG.hAAAeFBDLADB.hAAAQGGFAABBMAHFCHEFfACHhACA..cGAHNAIA..hABAOHFE..YAFEhACA,1,-20,-30,10
VJZIKAEOMecWYbgNaLBdFGSQPCXTfRUDH,MFGBeADD........cAAAbDEEaACFLCFFBAADGEAEhABAQGDHCFCBXFDDhAEAREAHDBIBHDGD.hAFAJAEAZCCGAHIDWCAFNAIESAEAPDDHfGGEhACA..IHHEhAHA,1,-12,-14,2
SeOQRBLTJaCXIVcbKZDUfAMPgFNGWYHEd,MFFBFGDGGCEDHFAAECCBeAFC..OBABBBBCJFHHCEHG..XCFChAAA..IECBhAAAVAFCKGGGDIFGfEBBhABAAFEE.NEEG.YFAHSBBE.hABA.LACH.hACAaAEB..,1,-14,-28,14
gDfJUNcFHXKCTSBVdQWMRIGEaPAbLYZOe,LFBBZEDGOEHDeBABDGBB.UDFC.FAGAXBEB.KDBFSDDFhAAABAHD.QGGBhABARBAEEGDF.AADDgAEDhACAfCGBJHEENEEE.CAAC....hBBA......hBCA...,1,-23,-29,6
OJcSPIAfKBbDLQWHGTRCFEadZXUeYgMVN,BBFADGEBLCEAHDBAGGDFCGGF.FEAHaBCHZDFC.eBCA.MIAEhAAANBIA...OAHBhABAJACC.SACChAFAAHAFKGBHQEEF.....WBBDEFFG.hAGAXAFB.YHFGhAAA,1,-14,-37,23
ZMdBGQScVHFJNaIAYULfTgEePWKCDOXbR,LEAHTCFA.eBCFKEBGDBAEOAAG.RDDGZGFCMHBA.dFGEBFDDhAEAGADCQCGBhAFA.SHCEhAGAcAGA.HAFGNEIEAEFDfCCE.PCAHhAAA.CHEH....hAIA...,1,-10,-17,7
YSURTbALDNIgECBdPfWMGQKZJcaHFeVOX,DGCA..gFDFBEFEdCFF...fCFAGGDBZACBaDCCFAAChACAOAEC.SDAFhAAAUFAC.bFGBAAGENBIChAFAIABF.CCHCMFCFJECA...eEAHhADA.XGEDhAEA.RBCG..,2,-36,-8,28
HMbBUPeFSAWQYVNgcKCfEadLGIDJROTXZ,QGDFVBAA....NCGC.gAGBCHDF.EACCaCEHdCDDhAAALAEAIBAFDAAChADAJCGHOFCAZFAHMECFhABABCHAUGGBeFGHAEEEcCAEfGAC..hAFA......hAGA...,1,5,-34,39
dTVbUNDSFcLAXHCQZRJBeWagKMGOfYPEI,HABEZDACJFDGeDEF.aBDEKGBFGCGC.ODAC..fDHChAAAPHAE.dAGCbGFGhAAADHGAFFABABDF..CFHABHDGhABAWADE...MDDGEGCG.....ICBHhACA...hABA...,1,-1,-46,45
fbUGCYBAeKXVMSFNdaOcJEZHRgDTWLPIQ,XBBFSFDHdEGBOBBA..EBHDZCADRGBGDFHHLGFC.hAAAQDFAUBEECEAGAECBeEEDhABAMIDEFGAF.NACFaCDEhAAA...JECD.......hACA......hADA...,2,-33,-7,26
IdWOCEHSGRTZcVbANgUKePBJYFXMfDaLQ,UFEDKCBFBHHCFDAA...MABAaBHF.LFFFdACA..OBGBhAAACDEEHEBFRFBHZAED..bAGFhAAAAEAH..eFHBJAFH..hABAXEGD.DEEHWHEASBBEhBAA......hBEA...,1,-26,-28,2
eEAfXCIFZJSQYacGUWKbHPgMRNVDOLdTB,CCABZGBE.QEBCaHEGGDGEKBBA.HFFDMEDARBFDDEDCLDCF.hAAABBEFAICAXADBhABAFGBHSAAA.UAGDhAAAWAHB.....bCACNDAG.dFHAeFDGhABA......hADA...,2,-18,-4,14
dHCgMPQTSVUJIWYfeBLNEAaFDbcRXZOGK,DGCCRGFEZBBAODABdBFDHDAD..MFFFQGDA..TBCGhAAAVDEG.UGGEJHAA.IHDGhABA.fCFFhACABADBNAIGAACHaDDHFEFAXFADCAGF.SBBDhADA..hAEAWAAF.,2,-20,-17,3
FHEWZPAbROaKVLdSJgTNCBUeQGfIYDMXc,OCAAKDBGdFAD...SEDHJHCG..TEDABHFFUBFAhAAAGAEDIFGE.hAAA.MACGFADGWEHHhABAABABaCHH..LFGF.CBCBeDDEQGAEhACADBBB.....hABA...,2,-32,-25,7
GVFXLSCbPWDeNRBTZKaQcIYdAJOEMgfUH,OBDFEBGF..MCABUFAGHFBGFGEALAGBCCCD..WEHDhAAADABEeDHFBGADTGEChABAaFDB...QABDhADAIBBCdDBBADEFfEBH.XBEBhAEA...hAAA.SAEBNBIA,2,-27,-26,1
VJDKTXeMZfYIbNHSgGLRdUOFBWQCcEPAa,JHCADCEFKAAD..eFCAZFCD.....IEBDbFFD.HBDAhAAASCFBLBHDdCBBhABAUFGEFEAEBCHFCAFFEHAGAABBhACA..aGAGXDDGfHAF.NADF..hADA......hAEA...,1,-21,-31,10
BRbLOHVTZcMSUaeIAgJDXfdYGNCQPWFKE,DGIF.dDDAGEAD.NDAB.CCBAQFFCFDGFBGAGLBCAHBGBVADEhAAAZFEB..MBIDSGCDhABAaGGE.AIFG.JHBGhAAAXDAG.fGAGYABC..hACA......hADA...,2,-27,-17,10
gZDXHIUcfeGKLWEBbPaOMRNTdYQSCFJVA,ZBAHXDEFUGAA..eFDHGAAELACABHDFaFGARDDG..dGHAQCGGhAAA.CAEEFECDhACAJCFAAADGDHAG.IAGChADAKGGFEAHD..........hAIA......hBAA...,1,-25,-27,2
cbCZSYLNaKRQBMJEfIGHUFWXODdPAgTeV,eCCGVEEF.CHBC.ZACDLEFE..KEBCQGDCJAFH.IAEFhAAAGCGGFAAAXBGEhABADFDDABIF...cCBHhACASGAH..aGHDMIDGEGGHfDAEhADA..hAGA...,1,-25,-33,8
ecRYGaKOXUISMVNbCdWATgDEJZPQBHFLf,DFHDZAGDQAAHBAHBLCAAeDBF.RFDEGADCaEEE..XGBEhAAASGAD.MIDEhAAAbCFE.CAFEdEHE.ACIDEDFBhACAJBEG....FEAA.fABFhABA.KFAFIHHFhADAWHEG...,2,-27,-6,21
faMdNUIKJXQOVHPFZSCbgeREcYBWATGDL,DBFHLHAGMIDA.dCAEUFFEJCFE...OABHHGEGFGAA.CECH.eFAChAAARADD.ECGFBAAFABHGGCDChACA..NEEFKAFGhACAXAFB.........hADA......hAFA...,1,-25,-29,4
ZRfgUaKXFJcLNMOHETVACSbWePDBIYGQd,CDFCSEFC.eDAHDFHDIBEGGACHdCFBRGAC.UGDF.XCCHhAAAJFFDLEAGhAAAMBIBEGAHAAGH..bBGHBGHAhABA..QBAHfBBE..KABChAEA.NEEE.....hAFA...,2,-32,-5,27
ZQFMLHXfOPcAYDKNebWaVgIGJUSBECTRd,DACDKABCeECG..bFFHaBGA....VGBCIEHCGBEDSGFEhAAACAFF.TGDHhAEAZEAEFEEDLDBDhAFAHBAFfFHE..cCCFAAHA.hAAAWHAG.JCFFBDDEhABA...,2,-17,-15,2
MEQgYdbcZKRfUOLXFeJVHIPNDaSBGTWCA,MFFDECFH..QFCGdBEDZCAEKGGARFFEUBCGLFBDeCABHDFE.hAAA.IAHFDHCESAGEhAAABGAF.TABGhABACHECAIHGgAEH...cCGEhABA..fEDGhADA..,1,-18,-21,3
YGWEPTSDFcgICVKJMebXNdfOaBZHAQLUR,QGDCREACGAGAEGBCSADE.FDEEgCDE.hAAAVGEGKAGFMFIF.hAAAXBBCNDICdCABaAEGHDBHhABAAFFG.LFFB.YDHD.hABAWCADDIBGCABHJHAG..hACA...,2,-14,-4,10
PMgYKXNLWbEfUOFQAVSeHTJBCacdDIZGR,eEDEJBEBBHEHCHFH..dCAFDGGFGCGG.MIBEKDAHLBHBhAAA..EGCAOGAGhABAAGAESECGHABBaFEGIAFFhAAAZAFH.gBDD.YFHBhABAWHAG...fAHGhACA,1,-17,-44,27
DXSRVeEgGPWKNMQdAUOLCZbHBIcaJYfTF,.LFAGCEDDZAAHHCFCBGGD.aDEEJADE....TAEHFEEASGHBhACAeDHBEHBCGCBHhAAAKHFE.QABChADAACEAUGBFODABIAHB.fEADhAEADAIH......hAGA...,2,-28,-13,15
CgOAZHKNBfePWEaUGSFVRcJMbYXQTdIDL,KCEABGDEeCBFEBCDUCGAFGEB..RABG...MBFG..bBGHXEBFhAAAdGCGDHGG.LFGDhABACAFG.ABDCHFAF.hAAANCAC.WEAD.aDDHSEEB..hACAJFFC.....hADA...,2,-25,-25,0
PDOMNaZHGcIeLTKXJgfdESUWCQBRbAVFY,FHAADFEBMBEBZACGHFFEGCFCeDFE.LEDHKFCB..JHFGfCAChAAAECCH.SEAAhABAUAABCBFCBAGEADCG.hACA...YHFGPEAHOBHD.hADANIAF.aCGA.IAGHhAEA..,1,2,-33,35
HcFAQEUYOKIRgCdfTGVNMSeJPXLDZabBW,QDBHEEBBUBCE.OFBFKEEH..RAFDdGEHTEGBGDGE..hAAAMAHDeCAFJGDCLHAChABADAIBZADCBCAD.hACAcGGEAIHE.gAADCECE.NEAGSDDEhACA..hAEA...,2,-21,-16,5
gBdFQRPDNLfbICUWGYcEaVASeJZHXTMOK,SCGGeCGFZCAAHFBGMDDHKBEH.BEECFBEGRGECDEAELBAH.hAAA.fGAGhABAIEEDCEGAUFFF..YFABhAAAaEHFABCHJAFAOAFA.dACCNIDH...hACA......hADA...,1,-15,-16,1
JZdRfAFbPcaeWIBHXOGSQTKgCDLNMUEYV,FEHF..PDFFeEEDBCAFOGAEQBGBKECA.CDCCDGAALHFChAAA.MIBGEHBAJBBChAAAZBBAdBGD.fDAFhABAAAHBaDFF.IEHB..XDADhABASADETGGEhACA...,2,-33,-18,15
daOTDbLGHKSIeBEfFCVJXWNPgYQRcMAUZ,dCFHTGFADFHHLBAA.HGBEICEABGFAFEAFJADAXBAChAAA..NEDD.gDCDhABAQAGHcCGGhACAAGADaDAA...OFFAKAAE.EGACCFFC.WHBAhAGA.....hADA...,2,-27,-12,15
cHCgOdEKSDRGBfYITWeMZbaPQVUALXFNJ,LCHBFFCB.JEAACCCGdBED.EGFCKHEA.RACGBHHA..fAHGhAAA.TDEEhABAMGDCbAFD.aBADPFADhACA...QGDAABHENEDD..hADAcFAH...hAEA...,1,-34,-37,3
OReZgPFGJKfdbcUYSXBAIHDMNVaQLTCEW,HEACMCDA.VAGFQCACLEFGEEFFOBCCeHEEZEAE.FCHHJHEAhAAAKADEdDEBUGBC.SAAAhAAAAHHEDABBaCACTGAHhACACAHA......WDDB..hABA......hAGA...,1,-9,-12,3
SLNDWAfgXYHKICbBOGZFeadUMEQTcPJRV,XBBAHACFKEHFCFDCBABDZFAB...FDAFeCGFUGEA..MAFCQGBChAAA.TECBhACAcCDE.RAAHSGGDhAAALAGHNEHADFAD.AEEG.gGCGhACA..ICEHhADAOFEFaBEA.,1,-17,-19,2
JMSaRdXPbKIAcOVWYCgFBHNLeTQDUGfEZ,VDAECCDCBGDD.LBEBQBCFGAACZGCA..MDFGSAGAhAAAaAGD.REFEdGGD.XCGBhACAKFEAACADOEFGhAAA.WABCFHAGNADDDAIFEEDD....PFABhAFA.IGHBhAGA...,2,-23,-9,14
KQSdITgVeMaHcRfJBXFEbOAPYGUCWLNDZ,GCCBUFDACFGD.LGAAZAFB.KGFAQABESEBGdBHATAAHhAAAeEBFHADD..hAAAfEFC.hABAJACAFHFEEAFEAEEC.WCGBNEIEDIAC.....hAHA......hAIA...,2,-23,-14,9
gZdeLCPbYFAIREKaVTQHSfGMOBcJUNDWX,RCFDKGDA..TEAEQCGGHACAGEECBACBJFFCDBHH..XEAHhAAAdAAECFCH..bGAGACDAaDDEhABASGHB.hAEAMCIFOAEEUCCDNIEF....gBBDhAFA.eHAG.hACA...,1,-3,-17,14
LVeDNCGUJZcRgFKaQBEWAOSfXPbYHITdM,SEAAXDDF.....bFDFHFCFdHFFLADFeADCCAABUCBEhACAZAEGRGAEKGFFaBBHECFGODEEhAAA..fAGFhADAIFGBMBIBNCIEJEGFFFBBBCGB.ACAF..hBAA......hBCA...,1,0,-13,13
DgNcXHMJQRAFeYOSGCKLUPbWBaZfVEIdT,FGFEOEHHCBDD.UDCB....bFBCaAEFZCFE..EAAG.dHBHDIBAhAAA...NEAGHCBHhABAJDFDQAGHAIGE.hACASCABLEDAPBEG.BEHDhADAfADG..hACA...,1,-16,-40,24
gaOZBRedYFGIcUbVEHPTKSNXfACLWQJMD,CEFDQGFDDGEE.OCBDBAAGeFCF.dEADFDEDGBAHIDHHhAAAUAGCEAGD.HADHhABAKFHF.XGDBAGBBLHDEhABAMDAH.aAHF.YFABcADA...hACA......hAFA...,2,-33,0,33
QdELGDAMTWeNUYICZacHFVSRgXJKPBOfb,MBBDeBBCUDGF..CDFHaGAAHEAD.FAAGSAFBRFEG.JCCAhAAABGCA.OHFEhADAfHDBQAGDhAEALBHBDDDBADCHTGGEWAEH.IADH.hAGAcFFG...hAIA...,2,-27,-19,8
OHDFSNgWafdUQReBIGMLYbKVZATCEPXJc,CFEHXCBA..JAFEOCEEDABE.FAEA..SCEHhAAA..WAACdHGBUCGDhAEAQFFGBEBGGBCEhAFAMDIDLHBGKEHFACBFEHCAcEBA..hAHA......hAIA...,1,-34,-35,1
QHWYKJXRLBZfaNMOCcIVdSTDePEAGgbFU,GGBFFACBQEDDHCDCKHFGRCDE.LCBFBBGCZAAHaBGE..OHFGhAEACACCVEFCdGAB.DEGFPAFGhAAAAFAE....hABA.gDCGWDHB......hAEA......hBAA...,1,-7,-31,24
cQPEMUHYJIAdSRLFGBbZgVCKaNTDOfeWX,SGCBFCAEBACCZEAFCHFG...KFEA..aHACDIECOEAE.eACGhAAAXAGF..hAAAcDEHECFEHDCAIBBDhABAABABLFHDGBEB.gGGGhAEA......hAFA...,1,-27,-34,7
HgaOGWeLAVDZIPUTbdNBXYSMKJfCRFEQc,VDBEDIBEZBBF.UBDEdEGABFEC..SCHHJBDC.RGDG.QAADhAAAHEEG.aBGFhACAOCAF...hADAWAHFAEADIGAE.bGFGXFAChAAAKGDD.CHHA.....hABA...,1,-25,-32,7
gXdHFVBQMJGEZKaeNbAULWSPCfDcORYTI,LHAASDCCCCDADGFHOGAC..RBBH.TBAB..IBAGhAAAdAGEHFEBBAEBQEGGhAAAJCFE.EEAGaFEAhABANAFAADGGUEBD..fADE..hABAYEHD.FAGEhACAMIBC.,2,-29,-17,12
AXJgUKVbeCORDGSHdWEcILMPBYQaFTfZN,JFAAUBGE.KDEDeCHH.RGEA.DIFEGCCHdAFG..ECAHLACEhAAA.BHDDaFGAFACGTAGEhABA..ZEBDABDBXGAChAGA....gFDAhAAA.CCDFSHAGhABAWBBDIEFF.,1,-17,-34,17
AeBETKbHSCaPcNYdMfXGQOZFWVLgJIRUD,BEEHEDFDKAAGHDBA.SADGCDAD.aGFFPFAC..NIAF.hAAAdAFE.MEIHGBGGhABAOHCGFGBCLCAFhACA.JCCAICCCDFIBAGAB.TEDC.hAEAYAHDfGEEhAFA..XGGD,1,-12,-28,16
aRVdeEXfWQNHcYKUTZLBSIPbOMgGFJCAD,RCGFeEGHEBFA...XEBGQDABHBCGKDEFTFDCLGAESHBGhAAA.bAFDOGFEhAAAMIFA.FBCEABBDDCAFhABAaBBBfHAHNAIA......hABA......hACA...,2,-24,1,25
ZMKVEGTcOPXbaLSWUQDBNgfJeRFHdYCAI,MHEAVEAH.GCDC.OBAFXADELBHBUGFCBCCC.hAAA.fCFHhABAJAAGFGDDdEFHCAFGAHIDKCHBEGAF.TEBDhACA...PFFA.aADBSDDHhAAADAGC...hBAA...,1,-10,-33,23
IGNTRBcLWCHfMVPJeZFUOSQXbdEADKagY,aCDD..IFGBGEAERDGFBFBFLFDFCBEDHFDDMBAE.VAFChAAAPAHH.ZACFFGEEOBBBhAAAXCAG..hABAEGABDGIFKGHB.NBACTDEBfCFG..hACA......hADA...,1,-10,-14,4
EgRSZVDCdFNUTXcaLMQHIPfGKJAbOeYWB,OECDeFBFBCCDRFADZAEHCBBF...FGFCUFDC....XBCHhAAALAAEMEIFIBFChAEA.GDEFABCFYEEDhABAgGGH.DAHDNAHCaCAF...hAFA......hAGA...,1,-22,-33,11
ePMdaDJgIQScYLEGVKTXFRCBNWUfbHAOZ,ZGCAeFCAMACAdFHCDBHB..JDCGQABG..SDGHhAAALEADECDGKBAFFBEChABABAADUGGBfADBhAFAABIHaBBA.IHEA.GDEHXAGFhBGA.CFEF.WHAA..hAGA...,2,-26,-21,5
QaUEdVfAGHCFJbLcWMNRIDXOeKYBSZTPg,CDGHJABGLCBC..MFEAREBHDBEGeBFCBEFDZCFE...TFBDhAAA..PDAHhAAAaGGCEHCAVFDB.AFIHFAHHhABAbCCF....NIEF.IHGDOFAHSEGEhABA...hACA...,2,-39,-10,29
EYSJAXGVQCdHcLbaeWgNUfZIFBPKTMRDO,XACDQDFEHFDGLCAA.aHEAeDDA.NEAC.ZABEBEBHhAAAKCEETFAHDCBDEEHHJHCAhABAAFIFCAHDdEDC..cBGFhACA..WHCGfGHCIHHE..hAAA......hABA...,1,-11,-23,12
RVZgLbIPWQaNOEfCXTMADedGFJHBcYKUS,DCGDdBAAJCCBBHHF.KABEUFEC..REABZBCDLDHB....hAAAIEEHQAFGhABA.OBEHCBBG.MFBFhACAAHABFEGE.HFCFSGDD..gAGEhAAAWEAFEACF..hAEA...,2,-46,-24,22
FXURJTDCLGEHIMgVQBcSAYKdWOPNbZeaf,KCFGOGDG....bCCHaAAE.FCDGXGEBRGAC..DBGBCAGDLHAAhAAAEEAB.IHGBhABAgDFGBBBAhACASGHFAEBAdADDWBHHPEBG.NAICfADBhAAAJEAH..hABA...,1,-21,-36,15
VcMaNXQZKDYbISFfATHegREdCLGWBPUOJ,HEACRCEBCGAE.LBABBEAA.OGFE.JCCAVECH..MDIHhAAAaEHH.XGAHKBBGDICC.hAAAIGDG.fEFHhABAAAEHeFGDdDAFWACG.UAGBNBIA..hADA......hAEA...,1,-14,-38,24
ZcIBeQXDJPHEUdbSRCFTgGYKOLNfWAaVM,MAFCZBGBBAAA.eBDCQFBE.DCDFHGCCdEGHRFEECDABFEDAGBAAhAAAOEABLCEAhABA.NEAC.AGHEaGGH.IACAhAAAJACC.ECEASBHB.YHEAhBAAKHAG..WCCDhAEA..,1,-15,-21,6
IDRTZJBeHXNLGQUaFMVKfWdcECbgPYOAS,DFBARCCGZGCABDHCHBAHLFFDQEGG.UAEBaGHD..FABBKBHFdCDHhAAACFAG.....PADEhADAAHIBIHAH.hAGAeAAEXGCCMFCG.fBGC.hADA..cEGD.hAFA...,2,-33,-15,18
BdIYcRNJOHUeMPZQSEVGbDTXgafLCFKAW,dBAG..IHFGRDEGJBEA.HFCBUGGEPFAH..SDHBhAAAEEFHGBEBDAIHgCCGhAAALGAAKEACBEBEhABA.cEGEeDCHMFFDQABD..hADA......hAEA...,2,-28,-9,19
AgYdefSJLaTOGZDKBMHWEIPXRcVUNQCFb,dDHCeDDCSHBALFBAaAFBGFEF.KDEFBCBDHEBBEHBGIAGHhAAARFFBUAAD..NEAC.QABChADA.FBFHhAEAAIHGYDHD.fADAOFAHDIEGhAFA...WCDF.hABA...,1,1,-24,25
THeDbXLBWFJgSZQRIGPfVCYdEacANMKOU,KDGDTAFCDCACLCEH.BGBEJHEGSAADZAEA.IDFAhABA.GEBEhACAPFHHCEDBdFFDEDAHADIHMDIDhADAOEDHeCBA..XABEWFAF.FHAChAAA......hABA...,2,-37,-11,26
JXGFQKgcRdDaUeHEWMOBINTbSfZLCAPYV,VFDDGFEB.KCGARBEG.DEBEUDBCHACB.EBACOBAG..IFAChAAA..TGGChAAAfGCDLDEAhABACAEDACFAJEDEXGAF.FAHF.....hABA......hACA...,1,-19,-28,9
SDFVWCLKZbTQJXAdNMPeEUIcRHafGOYgB,dBCFMFCHEFHFUBGB..RFCAHBGBGACEOFBHBDFDDAGEFDDGCFFBKHDA.hAAAZEEE..QCAChABAAGIF.eHFGaAAB.hACAfAFESFAD.LBBF.hACA......hADA...,1,-11,-26,15
aDGQWdANUVFIHbYJfRCKOcMPBZELTeSgX,UDFBVBAC.FBCEHDDA..JEAECEHCKBGA..MAIHZAEHLGAEhAAA.SGFEhABAaCACQGFFAIFE.IHCChAAAfHDHOEDF.BAGFEADD.eABChABADIAG.....hACA...,2,-29,-19,10
TaJWUKLEfDQMgNYIBFXScZOGHeARbdVCP,dGABVFEDCFEH....aDAAUDBD.LCCEDEFG.MDIH..hAAANBBBBGHHSGCHhABAOHFCeFAB.AIHEPACGhAGATECA.KAHDEHCAfEFDQAFG.hAIAIEAE.FCCAhAAA...,2,-43,-9,34
NXACVgdYaLQSJPEWcKIZOTFUGbBDefHMR,VFFFdEBHaACE..QDDA..JHBCEFBGKGGF.ZBBCOAABhABAUCGCBAHEDBDDfDAHhACAHFCCRCEH.ACHHCAGALDADhAAASGAH.cEGFIFHH.hADA.....FGDDhAEA...,2,-23,-18,5
MWFEUGSPbfeYKVCNRJZAXIOQcgDLBaHTd,OAADQFEFDGEBBAHBaHCA..dADFMCFDEDFCGBAC.SAGFhAAAfHBHKHFAhABACECARCGBADDG..XEBDhACAICDF.LEAHWBHH.FGGF.PADEhAAA.....hAIA...,2,-27,-16,11
aNCHGWPIDTKgOAdbfUBcMQEFeRZLJYVXS,dDEFUBDE.BCHCQECHFBAF.eACEZGCGLEABJHAC..hAAAVFFGSEGAhABACCBGHAGB.....PFCGhACAIFAHDAGC.gABGADCB.fHEBhAAAEHGC..hAFA...,1,-24,-32,8
NbdOZWgXVfaBeEFcSLYATCHIGMJUKQDRP,CHACGDACUFFD.DCDA.REEF.....PADEdDGHOAGD.ZACGhAAAXAGBaDDF.eDDAhAAAEGHHFBABLCCDhABAAIAA.IGCD.MDAH.KHDGNICB.WBBFhACA.....hABA...,2,-24,-24,0
JNFEOTQaABbHMVWSGdUZfDgRPcIYeXCLK,BCDEMDGB.SGFBGEAAUBBDDDFDRFCH..IHGH.eFDHhAAAXDAHKECBJAECEGAAhAAA.TAGBAHFB.bABBhAEA..WCEEdEHCfAEH..hAIA......hBAA...,2,-27,-26,1
XcMBCJDYSKAQbFOEIRfaLZHGdgWUVTNPe,FABAEGDDRAGHLEFH.ZEAGdEFCUGBGTEBB.eCAGMCCECADADGBFhAAAKBHB..AEAG..OEEHhAAAIABB.aFHH.hAEA....gBEFNEIC...hAFA......hAGA...,2,-35,-21,14
ZSXJYIAWeQbVaEDMUdHLPRKFcfTOgNCGB,eBADQFBF.aEGAEBHB.UDDGdCFBLBCFKFGAFGDA.TFGDhAAAOCCH..NDACCEEHBFAEhAAA.SHAChABA.JBCAABAEWBEFDIBGMCGHRGDA...fDHGhACA..hADA...,2,-29,-16,13
DSQJHOFdYTGeBKECfIbLPVWAgcUaZRXNM,UACEZFDDREBD.MAIFDAAA...QEFBJFHF.OEBGdDFDGBBDhADAKHAE..CFAC..IBAChAAALEAF..hAEAPFDFAEDGaBGBNBIASBGB.FGHH.hAFAeAECBGFA...hABA.bCDA.,1,-21,-25,4
IBKdQeGPFbAXgYWVCDafTENLUcSOHJRZM,XDBA..WCCCCBGB..DBBGaADCECFBLEHH.UGDDhAAAOFAHRBFH.MEIBhAAABAHAKGFGdEDBQADChABAGEACFBADAGCHgGCH...hABAfCAH.hACATEEG.,2,-23,-17,6
TNSVEPaHIeXFbBfOZUCJYGdKWMQRDgLAc,TECFVCEE..EEBGaCHB..HACD.XEGHBFACZBAACAGAGGADhAAAKGBHQAEAhAAA.RFFBDCEFAIEGNBAGSBBDhABAIDACFEHDfEEE...hABA......hACA...,2,-25,-6,19
OPGJTAaQcWMdebgSYLUIXRfVFDNBZKECH,aFBDQBEC.MHCCeDEH.SAEBLACFXEFBhAAAVBAGDGGABDHBEEACHECGhABAPAGBTAGE.AHGBcGAChAEAWHFA..dEBF......hAAA......hABA...,2,-30,3,33
cKHUPQYgBZDFTaVNAGWEfbdORXSIMeJCL,EHCEdAEBOFFEREFF..XCCDSABCMACCeFCB.CDCHKDFAhAAAPBBB..QBDBhAHABGAAFFBAVAFBhAAAAAIBfBHEIHHA.......hBAA......hBCA...,1,-18,-34,16
NcdSGIOVXELZQbJYPRTUHKWeafMFBACDg,DIGE..gEDFdAEBSFDHGBDB.ODABEFBHLBCAhAAAQABFJCABRCECHGFChAAAKFFD.WAHB.eGBGhACAMIAEBFFEAAHE.CEBA.IGHD...hAEAXDGA..hABA...,2,-31,3,34
NFYKVRLGSHeaXfJOEgcCDbdPBAITQMUWZ,QCCCMBFEZDEBFCHFKAEF.LFEGGAAEHEBCaHAE..JFACEGAFhAAA.CCDBDDADdAGFABCGUGGChACA..NHDD..RBADXDFBhAAAfGCE........hADA......hAEA...,2,-16,-16,0
WENXbQIYHgZJLaFVcGCfKeRMOBdSUAPDT,TDDCEGGF..XCFDQBFEHCACJDBDFGBEGFDFCABF.KBCBhAAAeBEHMIDEBACASBAFhABAAAHHDDID..NIBB.hAAAIEHH.gGAGLEAGaFFGhAEAfAEA..hACA...,2,-22,-12,10
CDHPJUfIRVcQbSeBdOGXFMNLWZKaEgATY,CCFDHBFEUAEBREAGQACG.eEHHBDBHOHAGFHAAMHFCLFGFhAAAZAAD.aGEHAFEDDIDChAAAJDDA..IBABhABA..bBGDSAGEdFFF..NDDGEACHhAFA......hAHA...,2,-37,10,47
gMCeUXGdOEfQNBJFLTSaRcPVKAHbWYIZD,HEBE..bGFEICAFDGBD..MFDHCDHFeHAAGABEdAHEEFFFhAAAfDAABCDDFAFDSFEAhAAAaABE.PAGFhABAAGDC.ZADB.gDECOEHD.NAIC.hADATDED...hAGA...,2,-14,-14,0
QDLOBZYGTUcVCPeIRbWHEJKgAdaMSfFXN,dEBGMICCFCHB..XDGHQABC.OGDABBAFGAEChAAA.TCBDVAEHCDFAPEDHhABAeHFA.READbGEAEEDEKAGChAAA.AEID.SADFDDAB....hACA.YAHH.hADA...,2,-25,0,25
TMWQJcSEBIgODbGZaLeCRFAUfHPKdYXVN,UBFFHCDBdAAB.VEBHMEHD.QBAA..SAFGhADAEGBDBFFBOADGhAAADCIBZFFGaGAHCCCEAECH.fADChAGAKGEHXEDB.NBIE.WHEA.IEGEhAHA.....hABA...,2,-31,-11,20
DYKcOXPVETQBZRadeMUFNALWSIgfbHGCJ,LBCGSCDH..fHADHAEHCEGFDGIFKEHFOCBD..hAAAPACGTBGCZEDGdGAEhABAMAGBFGGHAGDG.IACAhAEAbAAHJHCC..cGGHXGDA..EDDEhAAA..BAHB..hAGA...,1,-8,-20,12
OIbaKMXSEfPWJNYZFGVgUeBCRdDcAHLQT,QEADOBEB.aGDHXDBA.SGABECEG..hAAAWFGDNHEH.FFEHGCFAhABAUBBGBHBHdACGAFIHLAHBhAEAIAHHKAEGMIEAfGAA.hAFAYDFGZFBF..hAAAgFDCCHHB,2,-33,1,34
HcMRadPIbCUAZTDLNgVeBfSKFWQXOJYGE,DFGBLEDH.VACGBCEE.KAGE.QGBBJAFCGCEDEEACHGFGhAAA.MABDRDFGaACCIFFFhACA.CFCE.ADEHTBAFhAAA.eDDDSHCGFFHDOHDChABA...cAEAhADA...,2,-28,-11,17
cBNKJfTHMLCbIQPXUeDEAdVgFOWYZSaRG,dDADFECDOCDCZDFDRBBGBFEC..JHFCHFCBLAHDCBFC..QFABhAAAUEFBDDAGAFBF..hAAA....WHFGhABAaABC....NACBKBEEMAIF.IDEChACA....XGCEhBAA.,1,-24,-41,17
BbUKNPXcgLdODeSEfIAHVYZTMCRQFWGaJ,VFEGZEBGMICA.RAGH.QCEBGFDHBDCAKEAG....XGAFhAAALEHBDCIHeCAFhAAASHCAIABCAABEHACDhAEACGBAFCDA.aBBH........hAFA......hAGA...,2,-24,-17,7
EfGePYSdTNDFgOBQbaJHIRUWKVLAMcCZX,CHFGEDAFGEAA..PDGBdCHCDEFF.FGGEBGBE.aAGBHCBAUDDGhAAAKAAEADHG.ZADE.eFDBhADATADH..OCFFhAEAbBAG..JFHDIAHF..WHBAhABA......hACA...,1,-16,-30,14
bHMIRfVGSPaKWeTZDXgJLBdcAFCNEOUQY,FCCHCCFE.OGAAQGAHHBEB.MIEEREFF.GDBBSAEEKABD.hAAAeDHBDBDEJDHBBBDFACDC.hACAEAHB....YAGHhADAIDADfFDHaAAAWEED.XGGEhAEA.dFAFNIAB..hAFA...,1,-11,-21,10
SbAaFHPIWeRBEKJTQdYgLUCZDMNGVXcfO,FGBCHBAC...PAHFICEG.eAGDEFGCJAEH..QEGEhAAAdGAELDDFCDAHDFEDhABANIEB.GCCA.XACGhADAfEEFSHAGAHDEaDAC.BFAFhAEAYAAE.ZAFHMIFAhAFA..,1,-13,-16,3
AcEDTGJgFIVZdfSHUCLKYOBeaWXNMPQRb,EECGGDDBFAFA.ZFGFdBBHSDCDHGDELDAHKBAFBAAEeCFE.aACGhAAAXFAC.MEIDhACAQFGBADBF.hADATCDGgAEB.IGDF.hABAfBHEYFBB.hAIANIAB...,1,-10,-16,6
SUOBQGdJaNEYTAgLeMcVHWCRKZFbXDfPI,eCBFMGCEHCBHRAFAZBCD.FEFFDAEC....fAACSGECUAFFhAAABEEHdDHC.NBEC.EHFChAAAAIEA.LCFG.hACA.cGAFCBADKFHH........hADA......hAEA...,2,-29,-23,6
GRAeSbTcfMgVUDOBaCLWHKJZYFQXNdPIE,SDACTFGC.MBCGVAFF..DGDAaDBALBHFHEDHJABGZCEHhAAAFHACXGGF.hAAAdGAAEHEARCCFABACeECDbAFB.hABAfCHA.......hACAOBABBHFACEAA..hADA...,2,-11,0,11
BWDfRXaZdeVLHgEcTPObNFJGAKUSICMYQ,SHEECBEF.QCFEBHAFfBGCaFBG.dHDHeACHhAAAHDAHEGGGTAAFOCEHhABAFDGEAHDFKCABUDDDMAIDhACADGGGXFCC.LADEPAECNEAAIHHChAAA..WFCAhAEA..,1,-2,-21,19
WDJLISCUPbAHNOcGKQERYefTVFdaZBgMX,HBEDODEHKDDBRGBE.eBAB..TDGCdDCCBADFMBCDDHEE.JFFCLBEGhAAA.IHHGhABAUBGCAIHA...NBDAQEAChACAEFAB..fBBBhAAAaFGE......hABA...,2,-34,-10,24
gXLQFDMVSPTUcABZKCeHbdaGJENfIYOWR,BHEEKBBAeAACHABBdCFEGDEB.JECHEBHF....IADEhAAAOFDCRDBBLBADhABADHECMFIDSGBDhAFAUBDGAHBA.CCHEaFGD..NEAA.fBFA.hAAA.WHEA...hAGA...,1,-22,-24,2
IRNEFbXfYgAGUCTSKOVdBDPLWJaeQHMZc,CBGCTGEBKECB..dBDFDEAHLFFH..aDFBeEHBHBDDMACEhAAAIDBH.EHBCFBAGhABAXAAA.fBFBhAAAAIDGSDDEBGGEPBHDQDGHhABAcGAANADF...YEEFhAGA,2,-29,-24,5
PIbYSFJKXRZdONUQfTWVEcDaeGMACHBLg,CGHEBCDFLCCB..PEDB..ICEFSAFBFAGHJFAFhAAAKEBHZAAG.dHGDOACAhABAUFFB.QGEHhAHATCACECHHDDIDeHAEABCE..bEEC...hAAAYBBF..hAIA...,2,-32,-18,14
TBOXaHESMCGePRQgZIcWUYDJFAdKbfLNV,KEEHLEEA.TCFEBGEGXCAH.EDHBSBBChAAA.CHGBeGAGPABAhAAAQEBFICDHUBGDhAFAYACCFHBGAGIHfCDHOHFEMGAGhAGA......hAHA...,2,-28,-19,9
XEfNIgCcDKGbBJWdZHTYVMQSeRPAaFUOL,FCEBOFFDEAEA.....fAEFIBCACDHBDBIH.GEAChAAABHABJHFGZCCFTGCGhABA.MEIDQFEGhAAARCEBABBBaDAA.LBAF...XGBBhABANAHCKACE.WBFH..hACA...,2,-38,2,40
VMDCUWeAHITKXSNfgEdRbBQFGaLOYJZcP,TGCCXGDA..SDDB..fDBBdAGCRBAEBECEhAAAQDGHFHGGaBHFOAEFhABAYFADZFEDVEAFhACACHBFeBEBAGGE.KAACEEGGLADC.cBCHhAHA.DGHD...hADA...,1,-4,-13,9
UgJVWRdDPZLNKaFOMcCefBEAHQSTXbGIY,SAFGTACD.GBDCUCCF..VFECRGFCDICALFAGKCABFGAF.hAAAMBBBCCGE.BCHHEFCDAABChADAXBFC.IAHHhAAAJFEG.WHEG....dCCG.hABANAIA...aAEA..hACA.eEFE.,2,-18,-4,14
THYWVMQbdeCXGgBIOANRLPaKUfDSEZJcF,LEGBaAFA.KCBDDEBAZAEDFAAEHACB..VEDBMIAC.dGBFCFBEGCDBhAAABABGAHIDRFEHUGGBhADAEAHD...JDHD..hAEA....YEAGWHCG.eCHBgBCChAIA..NAAASEEFhACA,1,-2,-35,33
PbcWJFVRBAUDMSOQXaGTHILgKZNYdEfCe,DFBDSGEBOBBH.QCDCGFDBHCECLEHHZAEEdCHEfFCFhAAACAAF.bAFEJDCDhACAFBAEBHHG.MEABhADATGAD.gCFHNIAH.EFFE..hABA.cDAC..hACA...,2,-16,-11,5
FZOQUKADNSRLMcBbEYWPCIeVGdafHJXgT,SGCFREDGMDBC.BEDFECGD.....PCBDIADFGBGEhAAAdAHGaGHB.JFAAgGGDhABAZGBG.QADHhACAAGGDDIDALBAFYFEDCCEE.fFAGhADA...hAAA...,1,-17,-22,5
IeANgUXJHOKZQbSTaFWRYCPLMGcdVEBfD,UDEEXCBAOFHHZGFE...QEACSEECFBDARAFACACAMDIFhAAAdFAFBCHA.DEHFIBBDhABAAABF.NICH.JFDHhAAAHDCHKGAH..aAEBWGBA...PAHHhACA.....hACA...,1,-10,-27,17
ZbKUDHeNTdJBLYVfOXCSMQcRGPWgIAaFE,aCFCZFEGUBGHHFEGeADGdABFLDEG..fDBGCGAA.hAAAMHAGQEBAhAEAGBADPDDBICBFAHEAFFAChAAAEBEDDAGCNIBBBHHHOHBE...SGHHhAFA...hABA...,1,-5,-18,13
MUHPaQACFELReDXNKBdJbTIOVcGgWfYZS,FAFERBBFeEFFDDBB..KDEABABC.dBGG..TGCCVFAC..GEGGhAAA..fDCHhAAASADGUFFCHDDHhAEAaACCAIDGCHADXFAG.bBAG...OCFAhABAWAFE.MEIF.hBAA...,1,-19,-20,1
dbNOEeGQCAMSWYFfJPLIKVBRUXZTHgaDc,MEBDSGAEFHGA...JEDDLAAB.KAGFRACAXGFGhAAAHDDDaHCC.DIBAdAHAOCEChABAEEHBQACFhADAAAHE.fFCEIBHCUCAAZDFD...hAFA......hBAA...,1,-6,-30,24
TKeMgXUabRVEZCWIGQHdNODSfBcALYJPF,LCFAJHEC.TFEGMCFGUBAA..aGBCRDDAZDGFCCBC.GEAGhAAAdEBFDBAH.BHEGAAFE.hABAFGHDKACCeAEE..hAAA.......gCDDhABA......hACA...,1,-30,-37,7
dZONcQTgMRACVFJeIYbWDLPfaGKEXBUHS,FBAGeHEG...IFFBbCEH..DIAELEAD.PBFGhAAAaADHEBHFBACFUFBBHBDBhABAdGEAOAEGQDGFhAEATGGGgBBAAEDCCCCD.YFCBhAFA.fGHGhAGA..KEHB,2,-20,-14,6
bGORFIKdVTXeAMgYUJDZNSfPaLWHcQBCE,MFCBUFCCDBGEZFDE....SDFAaDDCHGFABADGEBFCGACAhAAAFCGD.KCAAdBBE...hABATFAEAIECYFHFhACA.fFAALFFCWAEHCHAHOAEG.hAAA......hABA...,1,-6,-32,26
fTIaDESFbJGUOZWXHcgPYQeCLNBKdAMRV,RABHTCDGDFCF..EAEFFAAC.GBGGZFEFHBFC....cFFChACAPDAD..eHAGhADACDDELHAAKDCDAEBFfADChAFAaGHDJDGH.WFED..YAADhADABGCH.dAGF....hAEA...,1,-12,-15,3
DTKWIUFHYRVJZGBgfcCAOXaPeLdENMQbS,OBABXDBE..aGBDLFHF.EAGHMFECQAAEhAAADBECKGHFUCEF.FAAAHADDhADARDAF.VEEFZDCHBDHHhADAfHCFAHDAdAHASHDAIFABJBHB.hAEAcGADCGAG...hAFA...,2,-18,4,22
HCaVMQeUPfbGAFdOJEKRBYITLWgNDZScX,dGDCEFBHBABF..IEBCLCHD...NBCH.SCGAhAAAHDDDaDAE.VGFG.QBAFhABAeFFFfGHEhAAAbAEFAAHEOCDBKGDDYAFCWEFC.DCCA.hACA......hADA...,2,-28,-9,19
bFDCRaUdHWcNEZMPgeAGILBJKXSQOVfTY,GBDFLBHHJFFHSGGF.ODDDfADF.TBAFhAAAFCAEDIAG.aDBEUGABhABAdAEEHBFB.NBAHMAAAhAGAPDGF.ABGCIGDABHCE.XDAAhACA.QDDGhADAYFEB,2,-25,-25,0
GYVegTMIKWObdNEHfLaUPJcAQCFDSXBZR,FADCDGBDBDFFGDGE.eFACMCCF..KCECOAFEdCCAHEEFLEDHhAAAUBAA..JHCCAACCCFGG.hAAAZABE.RCGH...YBHHhABA.........hABA......hAFA...,1,-12,-44,32
NQKPSCUDAcfITLbgYJVaXRHFBdeGMWEOZ,..ICDFLBBB.bAFGJDAB..VEGFaFGA..HABAdGAHMBABhAAAOFFHZEEDKDFESECAhABADBIHAHAC..fFCBhAAAgBDDYHAGXGCHBHHBhABA.....eADEhAGA..,1,-15,-16,1
beXQMaITLROFZdDfcEgHUCNWBSVGPKAYJ,JECEXAAH..MGAEaEDG.LACA.FFGAdGED.fGAEhAAAECDAUGEGCCCFWDBDhACA..BBADGAFGhADAKBHHAHBBbFGB.eADFIEAA....hAAA......hABA...,2,-40,-9,31
HQOeNXSWRULbFdGJfIKAVagDcBYZMPETC,aFGEDFGHBDEDZBDG..MHCEECGHHFAF.eFDHXAAD.SAGEhAAARAEHUCAALABGhAAAbDFG.FFHFdDAH.hACAJFADKAGEAFGA....cEDCYDCB.hACACHEA.NIDDfCGHhADA..,1,-7,-17,10
BZdDMFTCLgfOSNVaKWHPAcQIXJRGbEeYU,QGFDXFAERAFA.GBBE.EBAHeCDBBGBFDFIFMEEACABELFDAhAAAOAFF..SFDAhAAANBBE.KHCAPHCChADAAFDGJAHB..YEADdAEG.FEHDfHFBhAGA..aABAhAEA...,1,-10,-19,9
BANbgYMfeQCPFWVaJEDXRHKZLIUGOTdcS,...NECG.gECB.MHEAfEFFCCGD.FBAEaACDDCDHhAAAXEEBKAFCZBDFLFHFhABAICAFOFAFhAAATGDHSBFAAIDAeAFEWDHHJEADEAEB..hABA......hACA...,2,-23,-17,6
OQcISLTaAfYGRJVFePdXKbWgNBECUHDZM,GDFAJFHB.FAEFdABCKGCG....bFEF..gDCBhAAABDHGCFBD.DIBCZGAC.QAEAhAAAIACATBAEhABAAEECRCBC.eBHF.PFHD....hAGA......hAHA...,1,-27,-36,9
WATSYRVMLOGPBCIQEbNfdZaHFeUXcDKgJ,TBBEREEFLFAA.GBCHCEHF..IBFHEDBE..NADDdHEHhAAAaABAHEDC.UFAEhAAAXGGBKDDCJHDCADHFSBFEhABAMAIBBAGEfGHAeCADDBBCWCHHhACA......hAIA...,2,-16,-14,2
TKIQUbNPERCcdZLFXOGSfDaJABgHWYeVM,BAFCHBEGeEFEMFDEKDBAUDBD...NHDF.EAAA.RDGD.dAAELHBGhAAAOADG.GADCDGGEAICA.hACA..gGGAhADA...WAHBTFBCIGCE.hAHA......hAIA...,1,-17,-29,12
MYQOLTJaZdcHBGWgAVPFbIeRNEUSXKfCD,VCDCFBBFeFFG.RDCE.EEBF..UGADKBCCDACC..QAEFhAAALFFBTDGHZGEAdDHCBDFEhABAGGBBAIECIDAFhACASAGE.CBADMFABOFAG....hADA....aCGA.hAFA...,1,-14,-16,2
IWZFNVTCbSBHUDOaYgceQGMREKLXPfJdA,ZADHFGFG...VDBCTDGB..SGEHHAAHDICEOEAHhAAAaGCG....cBBGhAAAeCCBMAIBKBGEXGGGhABAJCEFAGIFIEBDCHDCBHAE.UADH.gGBChACA..REFEEBFDhACA..,1,-9,-19,10
INBWgeOEHJfbPLZFMKcXTGYdRQDUCAVaS,VGECSFFE.BGEBeFCHHDAF.JAACfABHLAEBMIEEhADAXAEBGGAHhAGARBCDDEGEACCBaEEG.NBIG.OAGFhAAA.EEEGZAGBFBAHKGHH....YEBDhABA...hBAA...,2,-8,-3,5
ACTRYPfKINZBSXMeFgHGVUWcaJODLbQdE,TDDDRDED..PACAKGCEZCFD.BAFDSCCG.MBGBhAAAFHFEGBBD.UDABhAAAWHEEaBHF.DHACQGAEhABAdEHEAGAA.CECAICHFNIAD.XEGDhAGA...hABA...,1,-20,-25,5
SLGAFZHcQYdBDWfNOXCgKIPEbJUaTVMRe,FCEHHAEBQGFDdEABBGAGDDED..NBIG.CHDAKAAC..EADFUEGGhADAVFCC..MFFBSFFEhAAAADGC.YAGHhABAOBCD..IHHAPBBD..aFAHeHAAhAEA.....hACA...,1,-24,-30,6
SeCdKagQEBZfDMGPIVLROYXHAWNcbUFJT,...NECE.bDFD.UEAEJFEB...eACACGAB.dCABKDGB..gAFAhAAABBDGDIFGGAAGhAAAVDDHLHFE.hACA.RAFG.OCHDXDDGAHDH.FGGGaABG..hAGA......hAIA...,1,-6,-36,30
XZMJaYPbLcQDAGgRIOeCKHSEdUNFTBfWV,RBEDeCBHHDAEEAEFUCGAFEFB.BAHC..VBGFMAAG...aFFDbAAAhAAALFAA.DBCEhAEAGGAB.gGGChABAOHFECCCBKEEDSEDH.dAGB.hAFANCAA......hAGA...,2,-22,1,23
VUaBeCTLNQOIdSPfYFgGDRAZJbHXWcKEM,JBGDHBED.XEBBKCCC.MFHDaABEBHECeEFCLCAG.hAAANBAD.IEDC.hAAASFGAPHAAfAGDhABAFGADDEAGAFGAZFBFcGDAEAFH.CFAA...hACA......hADA...,2,-39,-8,31
fQgcBbGSEKWLPIMOYFDHeXRdNCVUATZaJ,TACBJBAF..QAGDBEDDGGDHEECE.LBFH.IFAAhAAAOCCAYFGBhAAADCCFeBADdHAH.CBHEAFCBhABAfHDF.cDGF.SFAAhABAWDGHMDIFFAEG.hACAXEEHNAEF,2,-21,-21,0
FcERSCWgMbOAYPeHfKDQXaNVLJZUTIGdB,eCBBHDDDDDABQGDEaBBF.LAFCZCGBUGAGIEABBGHHEBDHhAAASBHD.hABAWFHDMIEC.OBFFhACAADDGfEEBKDBDXFFCJAACdGBE...hADA......hAEA...,1,-6,-19,13
ZQbaCXINYTAMdRGUWVFJgLceBPKEHODfS,MDDGdGEGGDGCUFEA.FECALCBBBFBE.KGCDHBEA.OFAHhAAADDIDSAAAQABHhABACBHH.IDAF.hAAA.TAEFAIBE.WEEE.....hADA..gGGBhABA.eEAD,2,-25,-24,1
WOICefTPaFQgAHZMBSEbVYDXcNRJUGdKL,MEFHEGAD...VADEDDDHXAFD.RGDEGABCKFDHOHAEhAAACAEF.TBAGFDGDAHHHBFBEhAAASAGE.bDFFhABANCICdBACLDAA.eDHFfFEBhABAaGHD......hADA...,1,-4,-24,20
JXOAHPEcQDNUBeGdILaCWfbZVRgMFYTKS,EADDDDAHBEFGdAGDLEAD..CECC...fEEFbEDD.hAAARGDAMCHDTCGAKAAASBBFhABAODCDAHHEPCAAhAAAQGAC.UACE.IBFDhAFAaBFH.VFGF.FAHF.hACA...,2,-17,-15,2
SYZfPHBeWMOKJgLNRFCbVIQdDEAacTGUX,aCFDTBDEGDGC.UAAHXGFG.ZBGHHFCHBEFEMBEEJCBBLAFChAAAFDBGCEEG.IABHhADAdADGADECSCHBhABAfDDEeFAHKGCENEAE......hAEA......hBAA...,1,-6,-21,15
DPTQUfBJGRaYNAFcWHKELSeZVOXbgICdM,FCEAHCAGKBGELGEAZEEG.OBED.XACBbACC.IAHGhAAACAABDDAF..QDCFhADAUEBBBBADRGEG.NAGEAFFAhABAEHACeFAD.dCHEMCIB...fFAFhAEA.aHDCWHFAhAFA..,2,-33,2,35
WOgQCGTIaFeDLdNMBHUVKXbRcSfAEJYPZ,ECDAJDEGZGCG..OADG.CBGD.IHGCeHBALCBDdAGGBADAhAAAHDGDUCBFKGGFREFC.fFDBhAAA.AHAB.hABAPFABQDEAaACBDFBCMFIH...hABA......hAFA...,1,-4,-33,29
KXHRabeYPUJVMQCSTONfcdgBFAZIWDLGE,ZGFGDIDAEEFBKFAHRFCD..eCCHUCCE..VAFF..CBAF..OAEChAAAfACA.dAAAhACABEFFAGEDLFAFhAEA.XDGEaDAGPCHHJHFASBEDhAFA.....hABA...,2,-48,-6,42
XaAcDOFTGLQSWfIbCeRgEHVNJYMZUdPKB,DCEEODAEFBCHLFHB..QAAGSBHHfFFFhACACHBA.gCFHhADAEBADHDEHJAFEMHBEdGDAhAAAKFBAXEAEADIHTBDEIADDeHEC..hABA......hACA...,2,-25,-8,17
acKDHgWTQVPeXCNdMGfIERFOULYbASJBZ,JADGaECF..KAFCHCDB...TBAFVBEDeHBCCBHA..dFFBMCBHhAAAICFBFFFHOBHHhABAUGBGLEHBhAAAACDB.BAHFDEIBWEADXGEG.NDAE.EEGB.hABARABA.SDCFhACA...,2,-16,-15,1
RSEeVGBZCgPbUMOFNaLfdIHTDKcXYJAQW,RECDSECAEGBD.eFGFBEEBZCEACAFE.....PHCGUABDFGHFhAAAaAAELEADhAAAdHEBHCGDDEACXADGAGFG.hACAWBFA..gBDHMFIF.fAHGhAEAKCCF...hABA...,2,-26,-16,10
eCUYXgZcdWDEILRSTJaQVMONPHFbBGAKf,eCEBCHBA.UBBAXCCEZBFH.dFAAEEBHRFCB...JBHHaCAG.QCFAhAAAMABC.OFHFhABAPHAGFFEC.BDBDhACAGFCBKAEA..fAGDYFHHWAFEhAAADIECSBBE.hBAA...,2,-24,-10,14
JPgeUbWcCZfBKXORLGHdNYMDEVFQaIATS,SBHFJEFD.eBDFUGBA....bFBDCEABBACD.KAGBhAAARFEELAACdCDD.hABAYEECEDHFFECG.IEAFhAEAADAA.gGDG..WFEDhADAfBBE.hAEA.OFAH.,1,-10,-45,35
KZSNeBMCRdUYLabfFEJAVWQGOIXDcHPgT,QBEBOABCDHBCHCDE..PCCBKHFAZEACSGGBhAAABFHAMAAFCHDBdCHC.LBAFhABAaHAC.fFEHhACAFGEBEBGEADCF.WFAGXEFB....hABA......hADA...,1,-13,-27,14
eACPFNZcSIVaDgXKEOLRUJBdYbQWHMGfT,FFBEZGBASECF..ICBADABEKDFBLAHFJGDGdACHQDDAhAAAMAFBGEGGhAAAeHFAAEEHCCDF..NBIG.aCBBhAEAEHAAOFFH..BBFE.WBAF.hAGA......hBAA...,2,-27,-21,6
CYADNUTaJHfROSbQdVXgGIMEPcLKZeBFW,UEEAaDDHHACAODHHQGGG.dGACXADFGGCFECGBLFBBhAAAKAAFBEAFCHHGDGDHJCEHhABARAFG...SBHBhACAgCAC.MDDA......hABA......hACA...,2,-32,0,32
fINadCWTXGDLgUHKBOPYJQAcRMESeVbZF,MHDESAEG.eGAGZACFIDGB.dAFAWDDGGBAChAAADCCGLFHBHFFGBEEFhABAOAHBPECHQFFChAAAAHIBEBHD.FDAANIBDCAEGTFDD.XABChACA....hADA...,1,-1,-22,21
GHRQVXaNdSeCIFBEcJfgDWbAYLPTKMUZO,LFDFTCEB.UAFFOBADRCAA..QEAFVEFA.aEDASFAChAAA.CGCDBAEHhABAEFHBJABGDCCFAIFCKGEGhAAAMAHD...........hABA......hAGA...,1,-27,-33,6
XcfPOeNAaEDIFLZgVTYGMJCRKSQHdWUbB,aAHDEBFFDFFGLGCC.ZACHVFBBGAEE.CEAB.KBADHEFAUDBBBABDhAAA..XGEBhAAAfHGDeAHDAEEFFGABhAEA....YBBCMIDE.SGADhABAWCCD....hACA...,1,-5,-34,29
gMDIQZEULFTBNJWaGcCAedORHPXfYbSVK,eECCRBAAHEAF..XEAD..YFDFSEGDKEFEDADGhAAAZAEEEGDEFGGE.BCAHJCEE.hABAaABE.CGHA.AIFEdECFPCHFhAAA..bAFAMDDA.IHCB.hACA......hAGA...,1,-14,-21,7
UINfQHcVJOELPgZXGCbBFdATDSaReWMKY,SBADRDCHeHCE.KEGHUFGC..IBBGQFAG.VABDhAAAOFDELAEBhABAPAEEZAGHGCEDBDABAGEAhADAaEAGMEFE..NICFfHAH.hAIAJECG.EGHF.CAHB..hBAA...,2,-11,-8,3
BEIHSOcPYVZWCLQAGfNMDRbXUaedgJFTK,GAEBMFBADIGEREFAUECC..aBACdACGFFGDBHACHBEG..SHGEhAAAOHAA..PDCGhAAAZCFCLHCAhABAAEGC.fFAFNBBH..eFEF..hABA......hACA...,1,-18,-27,9
agYZNbVCHMdcKERALfeWDSPFJGXOQTBIU,eEAESCHFFBAEGDDHQBAABAGFUGDDaCEF..ZEAD.VFFBhAAAMBIB.dGHEEEDDADDGLAAEhAEADFID.XFAChAFAOADAIGCBNCDF..CHBE.cCCAhABA.fAGAhACA.,1,-10,-25,15
PMedRGBHTUQFNXWcLIVbCSJOgYDfEKaZA,MDEGeACDdDEFBEABUGGFFECC.....XAFDLHFC.IGBChAAAVEBH.CFEH.SHDAhAAAOBACDAHBKBDEhABAADAE.PDHB........hADA......hAEA...,2,-48,-26,22
PgXVfWcaQSGBdYROebNICLHJDTAKUFZEM,FDGAMIFG..XADHVCAB.....fCAHaFFDQFCAhAAASDEHBCFEYDDAhABARFBCOHFANIAFCAGCLACGhADAJBFC.ACHBKHBAZAAEEFGC.WAFEhAAA......hABA...,2,-18,-14,4
VeWZAOHKfDQRJTagGNUSPLFbBEdMXCcIY,KGBADBECQDCDRFFD..JBCBaAFAGAEDUDGDLHCEhAAAFDGABEEA...dDACMAAEhAEACACEIHHE.eAHHhABAADEFOFAGHBBAfFFG..hAEANIABSBBFhAFA.EGEB.,2,-40,-1,39
CQfLHeYNdTcBOMgPGUZbKaXEAWIFDJSVR,FFGCSCGFRAAD.CDHF.LAFCHDCCeCACdCFBBGBC.MDADhAAAPGAAZFEH.KGFEEEBEIBEHhAAA.DGIB.hACAJABEfDCB.TACHOAFA.hAEA......hBGA...,2,-28,-17,11
YLAgUPBbQNeVXIHfOSFDTCGdaEKZJcRWM,UGDHBEACQDEEeAAC..IDCAOBDAFHCGCEBG.dEGEEEFEhAAAJAAFRAFE...MADChABAACBE..PFAB.hACA.NBIGHDCFDGGAaCGCKBGB..cADG.hAHA......hAIA...,2,-22,-21,1
AEXHbCDRgBVcOZfYUKWSLTQGNaFMPdIeJ,HEDHCGHARBCF.VBAHZDFG.UFGEKFCG..LBABQAGA.aFBDFAGChAAA.MIAGdDDFIDGFhAAAAHFD..EFGFDAEBhABABCFE....fFACSFBDhABANIBH......hACA...,1,-7,-38,31
DNCOIPVBGZYFLgQJafSdRMKcWUXEbHAeT,eCCBDEAEOFDC..PBHHGBDHFABAQAAD.aDEEhAAASGGE.hACAdEGDMIBAcEAEWADEhAHAEBECAEDFCEHBBHAD.ZGCGYHDC..hAIAJAAH.fFDFhAEA..,1,-12,-31,19
KQHAWBSaXcNRLOMfEIPGYJDedTFVZgbUC,SEGFXCEARFAB.LDAB.OHACfGFD.IDHAhAAAGDDAJAAGDECFdCAHhABATBCAFAFGZEFAgAEBhAAACBBCKAHBAEEFBEAFaGHFMAHFPHCE..hACA......hADA...,1,-10,-14,4
IRbZeGQWUDTcFPMSXJgOaEdLKNACYfHBV,CGEBHFDCBCCGRADHeCAHGACBQAGE.DCFBTDEFFHGCSBAEhAAAJDAB.aGAAEBHBhAAAKDHDAIGA..VGAE.hABA..IBAB.ZDGHcDBE.hABAMIBE....hACA...,2,-21,-12,9
geANVQIFPLMEWZdGJTSHDBXKCfYObacUR,QEDEFCAFMHBCZEAAJAFA..HEGDDCCCKDGECFEC..OAGD.hAAA.aGCBUCCCRFFFADDE.IAAEhACAEDAH..dACFhABASGADBHHHXBFC....hAIA......hBAA...,2,-29,-25,4
BLHbYCXRMVNAFQWgOedZfGcPUTJDSKIEa,QACCOABHdEEDGACFUDEGDIEE.KEAAaDHD.BFCCLHAEhAAAHGCACHHFMBIB.AAGFFEHHhABAeFAFZGEC..fDCHhAAA..cCBH....hAEA......hAFA...,2,-26,-21,5
QSbRTZfeCJWKIVBUAEMXHGLFcdONYPgaD,MADDXFAEHDGFLHEEFGEGdCFA..OCBH..PAEEhAAADHBASCDHbCAEZEECCACGJDFAhABAKGHH..BAHDEHAG.hADANICF.aCEG....QAAH.hAEAfAED.hAHA...,2,-18,-12,6
OARZYDPdcfUKegWGMCTVEbBHIaFJSNQXL,ZFGHDBAFdCCFUAFBKFBH..eGAGGAGA..CEEDECFFBDFF.HDBGhAAAaECF.JFFD..QBBFhAAAOEAB.AEAH..hABAPHDCfHGHMCIB......hACA......hADA...,1,-23,-35,12
HaVTYbEXPZSIWDcCLdNFfReUgMOKAQBJG,BHDFJBCGGEEBHEABTBBC..EFAHXFFESHGEDDFHCCHDhAAALHBC.FAAGhADAfACBUAFAMAIDhAEAKAFHACBH.aECC......YDDDhBCAPHECIDDBhABA.dHAD.,2,-26,-12,14
CHQKSEDPgUNdWJbAYceTaOMBGLIRfFXZV,eEAEOBEGMACHBEHAGGBHRDDH..FEAAXAFBZAABHACBSEEFhAAADIGC.UFGAhABAdGFFJCGBAAIFTCGDLHAGhAAAfBDACFAG.......hAEA......hAFA...,1,-6,-20,14
bFEdMTDIXROWSNJAgKCPaecQUYfGVLBHZ,KFEBCDEB.eBFFUBBHGACABECHZFCE..ECGHdBFFDCBB...XGGChAAAOEAD.SHBGhABAJFHB.AIECPEAHhACAaAEB...cDGEfHED.hAEALHAG..hAAA...,1,-14,-47,33
aAbgKIJHEFGXMLfVBcCTQSOWYZdDNRPUe,KBAFHEAGEDDAFGEG.MBHHLGDABBBE.CBDD.QADG.ODDGhAAAWEAH.ZGAGdAEDDBABhABARCGB.eEFGACFA.IHHChACAGBBC..fEFA...hAFA......hAGA...,2,-29,-15,14
fCJODQaVGLMPHINBegZdbSWFAYERUKTXc,EGHHKEAF....XCEFCFAAOBHB.DFDAVCBDLCCG.MAAAhAEAPCGD.HGFAhAAAIFGBBHBEeADEhABAdGCBSADAADIFRABG....TEDBhAGAfHADaAHF.NECF..hBAA...,2,-30,-13,17
bVUCegFBZHGcaSQPOYTAdRKWEfXLMDNIJ,KFDAEECBLGCGDCGF..JCDBVAAA.CAED.FBHHZCDEHCAB.GAADhAAASGAD.hABAOEGFAFCFRGAE.WAFEhAAAMHEE....NEIG.IAFBeDADBEEBhADAaHGEPFFA..hADA...,2,-30,-8,22
SCWGfZgNFYKIbABTEUJHdDPXLMeRacOQV,BCAEUABDdGGEDIGGLCGDRCEG..aGBDQDBE.CEEBGFCFhAAAfEEDZAEDFHAAhABAKFACAHAH..TABGhADAHCAGXAGD.MFIBODHFSAEChAAA...hAEA...,2,-22,-22,0
aPQXYNFZUWAVGRcOHCSJKdgTebDMfLIEB,GCDDRECDOBFBCDAGKFBE..dEEH.eHFEDHCCMHFCLAAB.BAEFhACAaBAF.QCGAhADA.XGBDhAGANACGFFGCUAGH.AAFF...cCBESEGEhAAA......hABA...,2,-37,-12,25
FJAYdSGIKaLcNEZgTUeQMBOCHVWfbRDXP,SDFGGBDEaBAGLDGDEHGA..ZAAEUFAEQFBDhAAAMIAECGHHHFCAVAFDfCDChABADAGHXCADFFFCAHECdADBhAAAKHDGNBIG...TCABOHFC..WFAFhACA.....hABA...,1,3,-5,8
OWEMaDRFXTNYcPfAgeQbZLVHSUBCJIGKd,QAEFZCFALFAGHFEBBHAHJBDFKAAAdDAH..OHEAMAHHaDFChAAADCAB..FCCH..NFAB.hABA....cEEFhAAAAGDGeDHH.SABHCEGE.IHHChADAEBDD.....hACA...,1,-4,-44,40
adEYPAUZcMVKeDCfJTGFWIHSXRbNOQBLg,UBCAMHAAKBCACCGF....JHFAGEEH.IFBGSBAHhAAARAFH..OHCEBFBALFDBhABAdAAFEHGEPDAGhADAZDGDeAFF.DEEA.FHBG...WEAChACA......hADA...,2,-34,-17,17
NBaeYUGbPHETAVRLSQZFfgMOKcWJdIXDC,VCAALCDB.QEAEZFBCFAHF.MAAAOEFEKGHB..JAEEdABDhAAA.DIEACHBC.BEDGaDGE.hAEAUAEH..bFED.hACAEBBFTGGD.SCFDcAGDIGDEhBAA.XCFChBBAeFAD..,2,-27,-8,19
aQdHWMfeILPcYEKZJGVUTRXACBSOFgDNb,CFDCSDDFFHCE.DEEGaFGBHACG.MABDeCEGLHEG.hAAA.PDCEEBGFZFCCJAFAhABA.GABDTGAHRCAHACAFhACAODHH.NCAC.dCHA.IHHE.hAAA......hACA...,2,-15,-13,2
CUVAQcMbRfXYIeFWEOTHdGBJSKLDZPaNg,QBBDMHACRABG...XFFBeAADFEEBOFHFHAFABHFDhABASBFFDFGCaEAHCEAHAEDA.hADA..bGAGfCDHhAEAIAAAECGHTCGDJFEFKADE....hACA......hAGA...,2,-18,-12,6
LgBWGFXeHUcbVDPRNAZOMQaEYfdTJCKSI,OACGMHDG..aBAEECDG.dFFHCDAF..KEGFLFBABDBH.FHEGeHAEhAAAUAGA..VECChABADIBG.RAFB.NBCC..AEEG..hACA....YAADfHGH..hADASDHBIFAB.hAEA...,1,-28,-37,9
MJSeRFZVOgKWcDGbHYBaQCXPULdTEAIfN,..IEDBNFDD..SDBGFBFGZFGHOADGKBHFDIAE.HABBhAAABDBHCFCD.UBBFLAEBhABAECHDAFIH.MFIH.eGDChADAgGEA..WBFH...hAAA......hABA...,2,-38,-19,19
SNCbAKOEFWUcIBZgdeLYPDHGXafRMQJTV,EGHBFFCCUCDFBDHEZECD..dFHGLCBGDFFDGACBaCFB..MACGhAAAQCAC..hAAAJEFDTBGDSAGBhABACHABAEHE.OBBA.IFBA..hAIA......hBAA...,1,-28,-33,5
eWDQaXSIKJTNBLFdYOcHMUEGPVbARZgfC,ZCFHCBHHDGBDQGBG..aGDCSEHHKABC.JDDHTFFBhAAABCDEFCAF.OAFAhAAAMBEAECFD.VDBBhAEAAHHEfFFG.eABEIHHCdEADYHEAhAEAcCCA...hAFA...,1,-8,-47,39
MFaPQVAEDXdZLYJUICNWfeGBSObRKHcgT,DCEBXEGHdCGFLFEDUADD...CAFE...fAAAhAAAeGFGBDBBSEDAhACAOEBBKACAHAGD.gGEDhAEAMDHFaBAB.QGADAAAGEFCH.ZCDEIAHEhACANCCG...hAGA...,2,-29,-12,17
MKXNBTfUCAWbELZDIdScQPGYJFRVgOaHe,EDHFLABCDGDA.dECCQAGDGGCFFFEARBDH.OBFHHDBDMBAAhAAAKAGDBAHBUGGC.ACHDZGAAhABASCBF..hAAAcCAGJFABaHFENACDCDFEICDE...hAIA......hBFA...,1,-6,-18,12
WFeCBPUdRIZSENgTKMbaVJcQDYfLHGAOX,XCDGeBGHCHFE.BAAFUECG..dHGBZCAEEEGD....gAADhACAKAEFMBIBaGDDJDHB.hADADGCF.LFAFhACAAAHEOGACFCBDRBEH.SBGH.NEFC...hADA......hAFA...,1,-22,-27,5
GYfLIWCXPFKJTUdeQgSabOZNHVEMcDRBA,GEBFLBGDCCAHFCDEJFBE..UACHdGEF..eCHDQDAF.hAAA.SHFAhABAOHAGZFGBNBGEHACEMAFBDFFHhAAAAAHB..fGAEIBAF.....hABA......hADA...,1,-16,-27,11
KMSVLgdDJOACRPYHEBWabUfGNTZeXIFQc,RFBFHAFEBDHGaBEHUCBAGDFC.ZDBHeEFFFHECKAAD..MAFHSBCBhABALAAEDDIHOBDDhAEAAEAH.CHGGEBGGWHAGhACA....fGGB.XGDHhAGAIHHD...hAHA...,2,-30,-16,14
AOcNUJELQbIYSCGdZTKfBeHXMVPgFDaRW,OEBGUABGLFEC.QEBBbFGHSBFAdAGFKBHFBDGAhAAAeDDEMCBE.PGBAhABADDIDaAEF.AHED.NCICEACChACACHHG.......ZFEBfGCAhAAA.....hAFA...,2,-21,-21,0
LMVWEaDCHBdAKTGPRJYbXfeNSIZgFQcOU,GABAJBCG...XEADeAHHSEHFZGECQEFDOCABhAAAMIAAEGBD.CAAAHAEGhAAAAGDAKEEB.TDDHRGEC.YCFGhADAfAGCNEIC.IDDG.FABBhADA......hAEA...,1,9,-27,36
TIbeXYJdGaKVSMLWHDBUOCRgNEcAFQPfZ,FDAAQEABZDED..TAGGIEGB.eEDBJGAGGGEDhAAAKBBDMAGFHACDBHHDCBBD.NAIA.hAAAAICE....fDHEhABAbFEHXADFaAEDLEAADAHHODCA.hACAEABG.....hAEA...,2,-13,-3,10
VXGHMdcQCSBKfEIFOgZLUWNaeJPbYTDRA,GEEDHAFDMBEDQCCHCDCHBHHC.KAEGEHDCFGAE.OABHZBABLFAChAAAUCFF..aHGAPEFAhABA...YAHBhACADEAHAICG.dHAF.fFFGIACH.hAAA...NAIG.eACHhAEA...,2,-17,-9,8
HQKOJMYNSFPEfbcLaGWAgVTeBCZDdXRUI,TDFGCBBAdEBG..UGGHQEAH.OAHFJHCG..MCFEhAAANDBDFBBA..EEEFfAEChAAALADDaDFAWFFAhABA..AAGB...eHFABFGEDACEIAHBhABAKGAHPGCC...hACA...,1,-4,-41,37
AMIJeHRYbKBUcLSWXNDZCVEaOPGgFdTfQ,JBDGeAAHHFAERAEE.KDADBCCH.LDEF.SHFGhAAAXEEFDDFCZEAHCGHEaEHHOAHDhACAGBBE.dABFTDGHhADAAIBCMHCA..IFCBYAHH.cGGChAAAWHAG.....hAEAEEDD..,1,-10,-25,15
BKDdbGSVgIZYHFOXCcaJRAPEMfUTNeLQW,EDCEMGACUFEA..TBEHLADEBCHBDGDFdHDHGCAC.SCFFhAAAIABDHDBGhAAAOCGFCFEFaEACABAC.fGGBhADANCIA.eADCKHAG..gGGBhABAFHAG....hACA...,2,-20,-10,10
FUAKHMVaLTJCcYbgeGQPXEOdIWSRNDfBZ,KGDGVAEGLEBH.CDFG...bECEGBCCQDACEAGBdFGFIHEChAAA.SABDhACANIDBBAEEFBAAUEGDhADAADGC.aHGE.TCGG.JHAEYDAFhAAAPDCA......hABA.WAHB.,2,-25,9,34
NURFBLGHJAMdZcKVXfISgQCYbaWPDeEOT,MDDHdBDDZEFFKEHD..XBGG..fACGSEEDCFFA.hAAAaAGADICE..eEHDhAAAOAHFUFAABFAELBBHhABAJAEFADAC.ICAGgGEG.QGAFhABAYFDF...hACA...,2,-34,-22,12
KAeZTMHLbFSDRUcfJNOCEGYVXdWQaPBgI,TCEALACB.SDGFDCBFREFF.UFBEJCCB...ODEHhAAAEABGGGABXAFEdAEFaAGDhAAABCBC.KEHFAHIFMDAHhADA....FGHDNIDFCFHAWFAD...hAIA......hBAA...,1,-16,-27,11
RACPSeKcZLdODNFJUEfYIXBaQbgMVHWGT,CFHFSABHKDAH.LDHHOEDDDGGBFECEUEAA..EDCBIEGFhAAABBGB.QGDDhABAMABGHCFETBDDhADAAIHGeHACZAFCdBBDfHAFaFAC...hAAAgGGGWFFF.hAFA...,2,-35,-5,30
FYXcaQgUCLJHBOfDWTebRSAMZdKEGINPV,dBBCEDCDGAAE..PFBGFAGG..XAEHaFFDUAEDCFGHLHDGhAAABDCADDHDeHCEhAAASCHD.AAEHKEFFhACAIAHE.NDIE.YDAF...hABA......hACA...,2,-40,-17,23
IaLfJOUGeKWHTXSDbMcdPZBCRgNYEVFQA,LEBGOEHDGBCAKFFAHCEE..XGBHDADHMACHdBAGBAHFhAAACDGARAEC....NEEG.EAFBhABAFFFBIHCD.hAAAfHEHeEAHSHFA.cCFGhABAgGAF.YEHHhAEA,1,-23,-25,2
FAGaCJWEUBISZHDXOcKfNYbMVQTRLgdPe,CFDAJEGDUAECBFEC..ZBAGHDAB.DADDODEE..KCEH..hAAA..NBIA.MDIDQDADhAAALHAEdGGHeBBBhABAAFFC.aAGAEHDGIHHGSGBF..hABAfCGF.hACAbAEG..,2,-36,-26,10
STPMWRJXZVNDOgAFbfLceQIBUCaYKdGEH,FCAHLGCCeDDABCBEaECC..dBEFHGBCSEABMAAGRFFHZBFC.hAAADEGEAFAB....cCDHhABAIHHAUGGBKFAGhAEAEACC...PDHH.JAHF.NIAB..hAFA.OBBAfCABhACACAHB..,2,-21,-8,13
YcegGdbDMBFaKJSLEXONAUZRTPCfIWVQH,ZADBREBC.CBAA...ICHDQEEHHBACeFHBdFHCDAFGBCFAaCEAKAFAhAAA.LABH.hAAAOHEEAEHAPFEF.hADAfDDD.WAEGYAHB.hABAcFCH...hACA...,1,-24,-32,8
SQRIEFAXPLOWgGDTMNVHdfKabceCBUZYJ,LGAEOAFHGDFAMBDBHEEGKBDD.aBFCeDAFBBAEZCBH.SBGEhAAAIEAFAIGGXGAEhABA..WCEGhAAADDEHNDIEdEHA..fHDBCADEYHBA..hABA......hACA...,2,-27,-13,14
MQAWdNCaVRXSePGJTObHUZFgIEfKLDBYc,dCBBCCBHREAD.SFFBGDFG..OFEHHBEHFGDH.EGBFKDCHBEABhAAAMADGAAGB..aFHBVAGHhAAA..eABC.JAHBhABAbABGgEDD..IHHHhACADIGE......hAIA...,1,-5,-28,23
ENDIMgFUYeSObadVHKTBcZfGPCLJRQWXA,EEFFDBIBMIAGUFCD...eFHDSADF.OBADdAAHVDAEhABAKGGABGAGZFACGADAhADACDHERAEC.QDFBhAFAADFF..IDDCYFFFaAAB....hACA......hAFA...,2,-35,-5,30
QOdJFALaCIVXYNgMSfKTEUDGRPeWbBcZH,CCCCXCCF..NBGA.SAHD.KGGAEECGUDFERGACeAAHhAAABAEFHEEFOFBBFBEBAFIBhACAaCAB...IABEhAAAYAFCMIDEDHGE.PGCC..WDAHhADAcDBH...hAEA...,2,-30,-19,11
RQZVdXHMDWBAPJObLSaeNIEGFTfYCgcKU,JCDCLEBE.eFECEFEFFFAD..fGAGCADF.KGHHQAAGhACAdAECMAAABHGGhAGAAIEGOAFESCFHhAHAaFHH.IHCA.TBBGcCGAZBGHhAIA..XEBFhAFADDDG.WEFH.,2,-37,-2,35
GRUgPMQESAWNCZBfDXKYdLFbOJaceHTIV,CDHEBCDCDDGD.KEHHLAEHFEEH..OAAFaGHB.HBGD..IHBChAAAGEBGRGFEUAGBhABAMBFFQDCChACAAEDD.ZBBEfACAXFEG...dFAG.hADA......hAHA...,2,-27,-19,8
eGEYAUKPXIfRJLcbBaZSgOMHFNQdWCVDT,UAEDKDHD..XGGERAADLHEABCGCZFAAOHBAHEFAFCHH.dDCDhAAAVEAA..DCFFTACDhAAAEACD.ADDDIAGHhABAJHAC..aGHFgCAC.MEFBhACA.....hADA...,1,-14,-22,8
PJWcTCIRDQXdNVEfLBGSAbFgZMYUaHOKe,FDDEMDHHUGGGHEDA.OAEFeCAG...JCBATFACRGDC.DCHDXGAGhAAA.dCGFVGCChAAAEDAEBABCAHAH..hADAbCFH.ZABAaEACPAFEcGGD..CEAF..hAEA......hAGA...,2,-14,-12,2
YcITBMUVXAgGQfFdZaKWPReDbHJSNLCEO,QBDHFFEGdCFFKDCB.RDBBDADAHGAA..JEEBLBAD.OHEAhAAAIHFGBCBCMBIHhAAA.UGBHAIEC..fDGGhABAaAGG.eFAESGGE.hACACABF.EAGG....hADA...,2,-27,-26,1
cdUNfRQPIaLMGYAZeBFgXKCOTVEJSbHDW,BCAEXAEHOEBD..EADHSDFEHGAGDBGCdDDCUGFHfCAChAAAQAEDaGFELEDEhAAAMACH.AAHEeABChABAgFECCHBD.TDGH....hABA......hADA...,2,-25,-14,11
HAbGSaFJOZBMfgRVdUPceKXELYDTQIWNC,GEDDSGCFaGHBFHBGOFFG..BCCGMBEFRACGdHEHUAFDeBAFhAAAKDBELDFE.hABADBACIDGFCHHF.hAAAAAHEbBFAJEAF..fGEEgEAC..hACA......hAEA...,1,-17,-27,10
JVfIRPOASEcMZNHUeKXGgBQFaTCDbWLdY,SBBBMCHFZDAHHFDFKADFGFBHBHAFFAACCEEB...DDGFLAGHhAAAdAEE.JEAGVCCFIEHAhABA...RAEHAHGEhACAEGGE.NBIC..........hAEA......hAIA...,2,-26,-23,3
UKZGSXOEHdQRacFAVYJWPgTLbNBICMDfe,VABAJDCB......PDGFLCHBBHAAIHEA.hAAAMEGFDHCCeACFUGADKAFEhAAASBECEFDAdEAHRCDChABAaAHFAHID.....gFEB.hAEANABCCEAG...fBGAhACA,1,-21,-37,16
MdDCSJIAWfQLZReHgNBXEbTYPVUOFGKac,QGBBZDCEeACGHGBGBGHGEFFB..TDCBVBAB.FGEDGBGEhAAAaBEB.MFAFDBIFJABHAIFA.hABALCFH..hAAANEIE.XEAC.......hAEA......hAFA...,2,-23,-7,16
VKUZBAdbWEQOaeTMGfSNLCYDJcIHPFXRg,dGGHEDFD.QCDBeEHBMACDGEAG.SDGGLBDEDHCEhAAAIHCHPEAFFBBDXECDhABARAEEKFEDBBAFACEEOFFHhADAaAHF..NAAHCECCJAHF......hAEA......hAFA...,1,-4,-16,12
RAHIdUJaZcgVQeBFDPOMELKfXTYSbCNWG,HGACdEDDUBCFaGFGZBAH..VFBFQCFHBAAE.DAGG.MIFAhAAALHEEKEED.TDAAhACAbEAE..CADGNBIERAGFADIB.hABA...JCCEgFGEeAEG.OAFBhADA.....hACA...,1,-2,-21,19
fdKIRGWaMQFDNLPACXUbHEYJgeZTVSBcO,CCEFXFAFUDAB.HAEC..EAGGJFECeGCAZAAH....SDFGhACAOGFCdDFAIDDFhADARACCaGBB.QGDChAEADICG.NCICACCEgAADBCGAfHFHhAFA.....hACA.KDDF.,2,-31,-3,28
UFJcEbOWKdHNPDYCSQXeVgTGIAafZRBML,aDGGZFECRABCLAFGUBFH.FEDA..JHAEECCC...OABEdEAE.hAAAHEGDDIEECCDAQGADhAAA.eFCBTDFChABAACAEfEAHBCAE.MIEE..WFHBhACA...KDCF.hABA...,1,-8,-38,30
YVMGFUWeQJIOLRBgDENaTbfKHdSZCAXcP,XGFA..PHBEMHAEGBEDUCFBeACGQAAEhAAA.IEFHOAAHLFAGhABAREDDDDBDaAEGfDCHhADAKCDDSFFBAAIF.YCBB.hAHAFFHB.BHAFNDIC..hAEA...,1,3,-29,32
UdXEaTPAVHSBNcIeGCRZLJFfgQDYWObKM,HFDBSFECBACA..IGHACGCGRBEH.ZBDDJABDFAAB..QAGEhAAADDFBOEAFMHFChABAdHAHEDGF..TDGFhADAAAGB..NCCEeAGHfADA.YFAHhAFAKHFA.aECG..hAGA...,1,-11,-34,23
eNfICXHdBAETUKRLGQcJVZbPMYaFSgWOD,UEFEKDGHGCBAQGCA..VGFAZABDMCIBFBFE..SADDhAAAODDGeAGDIFEAhABAXECG.BBAGhAAAAEAFRGAE.LFAH.JHFEPDDAgADChABANAIEfABAhAEACAHC...,1,5,-28,33
NQHPGZdfSFBVAOaMgRCcWLTUXDeKYJbIE,OFGBMDCBRDED...CFAELACDUABGDIGA.eDFGKBEC...JADEEEADhAAAHDCCZGDG.dFCCFAHHBBAEhAAA.ACIF.aDGG..hAEAgAGH..cGAC.WDDFhAFA....YFHBhABA,1,-19,-38,19
UEHTWPVKNSLXYZFQcafAJeIBDGdbRgCOM,JDFABCEBGACGdACHRGCE...OHCGEAGEHCGB..TFFH.hAAA.PDCHKAFESAAFhACA.YFBEhAEAQFGF.aABHAHIDIBHCDDAHCFEAWFAHhADA....LBBDhAIA.,2,-29,-21,8
HbSDZOfACdREPMaVGgIBYWKFeUXcTNLJQ,dGFBEBCB.aAEEGDEA.BCAFKAACeEAGUFBB...TCCEJHFGQAEHhAAASGCGOEAAhABACBHCMDID.IDGGhADAFAGANCHG...LCEBDCIBAGED...hACAPFAB...hADA...,1,-14,-18,4
ARVUQNeKfEDFPCXGTYMSBHIObWcLJdZga,RCFGUADCeFFBKHCG..EEBFDFEH..FBDG.CCBE.XGFFGGBBMDADhAAABCBGHAGD.ODEChAAA....hABAcEFAJFBDdFHEaABGADDC..NCAG.fEDGhAEA..TABHhAGAIAHB.,2,-32,-20,12
CWARaLNEMJeYFVfcUTGXSDgIPdOHBQbZK,aACFLDDG.MGFEJFBFFDGB..fACDUAEDGFDFDCFG.hAAA...IBBHhABAdDDDHBAFBHAG.ZFDHhAEACAHAAIFC.EGHHYECF.cAGF.hAAASFAB.hABAOHFG.,2,-21,-15,6
WTfRUeFQHODaMXGIgNSPcbLBdEKJVYCZA,TEEDRFFGUEAB..FBBDHGCE.DCFCMHCCXEBFGBEF..IABChAAASACBbEGDBADGhAEAdDDEKGAB..YFABhAFAAEIDeAAFaHEENDDF..PAFEEDGC.CCCC.hAIA......hBAA...,1,-11,-12,1
GLcJCdNFbgQSYDKfMAVeaPHBXRWZEUITO,aFCCHDBGBEEGXBFAZBDC.UACH.OFAFLEAC.JBHHNDIE.hAAAFBAB..QGDFhABASGADDBBHKFHDAGHHeEFBhADA..WCCG..IAFAhAHA..TGEB.hAIAcGBH.,2,-38,-1,37
NQSIefWHLEXAFZcaPOYUbKTRCBJVDdGgM,ZAAGaCCA.OCAEUDAH.KHGARDFB..BHDFDHDGGBGE..NBBB.QAEAhAAA.SDEGhABAIHADfHGDhAAALEAGXGBBACHEFAGB..cDDChABA....YFFAhACA,1,-16,-52,36
PdUQISbCGAKaLTXYRHNFVBOWgMceZEfJD,KGCAaADALBBD..TFGERDEDFBHFBEHEOBBE.MFFHeCDChAAAEDDDDFHH..PCEEhAAAdHDHUGAC..SFAEhABACDGCAGID.XGAHHEBGNBAC.WAEEhACA......hADA...,2,-37,-10,27
cSAFJEZeOXgRBHVCWIYQNLbGDTPKMUdfa,JCEDeFFF.OCFCREGBBAGGHACC..CHDC.IAAD.QDABhACALCADDCGFPAFGhADAKECHdHAF..fHCBhBIA.SDEGEBBE.ZCCHhCAA......hCBA...,2,-54,-9,45
TaKYHFRUJQdXDWBLMSAZeOgIPVcCfNGEb,OCEF..ICFGVEAE.CDHBGEEBEEGG..aGHHKBDHHAAChAAAFHBGRDAHUAGD.JHAEhABAdHGFDCDH.BAEDMABAhAAAADACeHDCgBBD.fAGDhAFA......hAIA...,1,-9,-32,23
IGdWKgUcCLDAZNRHMFaSTPQOYeXVfEJBb,RBFEFHFA..TEEBQBDH.eCAHfBBBBDGBGEDGhAAAKDBFUGAECFBBACIBHGAA.hAAAaFFAOACA.XGDChABAJABEdAGD.gGGEDFIH.MIEChAGASCCDYDDE.hABAEEGE.IAHF,1,-5,-9,4
VZEKRCgMaOBcASGLQbFNfdJYXDTePUIHW,SFHHQGEGFDFCdCCE...JEAFDBGB.TFDEeBEGUCCBhAAAHDFCZFBHKEHB.CABGMACAhAAABABFAHDALFFH.hADAfAGDYAHHIHHFEBEB..hAEA.aGBD....hAFA...,1,-5,-29,24
VcCaEdSHZKBXTLFPYMUDGAQRObWefJINg,OEBHeEBF..JACH..IFGG..gCGAhAAA.VFCDCEEGaBBFSADBhABAKAFGXGCALGFAhAFA.FAGDMCEADEDCAIACbDFEWEFAfDCHhAAA.NABB..EGHHhAHA...,2,-40,-15,25
PcAdXeBKaOFGVSENWLMCIYJgDRfbQHZTU,eAGBBFHBaDEGOEFBGACF..EECBLBHHCGGD..IEAEhAAAJGEERDAE.QADGhABATFCDUAAEAEGGdCABFFAHhADANAIGMEEBDFEA.fHAD...hAFA......hAGA...,1,-13,-18,5
bRCHDQGFIKcNVegUPJSZTEXOWALYfaMBd,LEEBaHAABGHC.dEBB.RAEBDCCEQCCA.FFEAICHDhAAAKEBA..VAECUEGBJHDAhAAASHBAZBAD.hABAECAGXDGAABBC.fCGFCHHA.hABA.cGAG.eHEAhACA..,1,-19,-27,8
PWDRYQUMZSfAgOBJbXGeKcdTLNHaFECVI,BFDEXBFGKGHDdAFELGDCHCCA..FDACCDAE....IFHChAAADHBCQDGFMCCBfDFHhABAAFGH.gFAEhACAbFEDGAAFTACAEAHD...WHAGhAEA.YHEAhAFASFBGOEDC,2,-28,-5,23
ELMTPIDOgAGRQXYKVUJfeBNHCaSdbWZcF,GCEBRBEBQGFCKABHUFEE..JEBFBBHBCBDC.dAAGZAGHFGAAEAAELEAAhADA..PEFEhACADDBGABEF....hADAXEGHYEDD.eFAD..NIEFSHAGhAEA..hAFA...,2,-31,-16,15
dfcAMGCWZITNXeaQVBURgbFSYOKDHPJLE,GBEFCBBHZEFA...NACB.aEACBEDC.UBBHRFCFFBGF...OBDDhAAADFFBJDHBLHEEhABA.ECADfHBDhAAA.AHHEMBADIHAAXEBD..hABA.....eHDGhAHA..,1,-22,-37,15
NVTLXFPSDGJgAHQKOZaefRMIcBWEYdUCb,QGEEOHEEZDFF.aCGBRBAC....MFBGIDHCBEACEAACUEAAhAAA.CDEC...VADGhAAATABFLEEBFBDEPAFAhABAGAGGABIHKGHFfGAH..YDDFhADANDICDIBA...hADA...,1,-11,-14,3
FSIABEGLPJWfCHcXMNZgTOYRQKeDUabdV,BGHEEBDGGGDFLEAB.JFFDCBGCHDGD.MAACZCAAOBBAhAAARFBFeDDCDBBHUCFH.dAFDSAFChAEAAICG..hAIAPECBcCBD....NAIA....hBAA......hBCA...,2,-29,-11,18
eUZGdDAWKXPcMIEFLYCRfBTgOSQHVbaJN,XEFHMCADFGECLBFARGBG..BHEHOGAAQCCEhAAAHCCFaBEHNAIA.ZABBGBEAhABADGGCAAAC.KABA..IEFDhAEACDAEfAGC.SGAF.hAFA......hAGA...,1,-14,-24,10
SbFgQYCTeBWaIDcGAJVPfZMNRdUXOHKLE,VEFBZCCBMCHB.dACHOCCHHGDGLAAF.EFADFAGHQEEDhADACCAGBGDCaAEFIHHFhAFADBCCAGID..JHAANBIA.hAGA.XCEEKDDCSABC...hAHA......hAIA..YHEA,2,-38,-2,36
ZdAFTLgGcDafYSIXVNKQEURHWJPOBeMbC,FFBDTFDEGEDG.DBBAaGAD...SHGEXCDGKADEQCBAhAAARGFG.WBADhABAOFFABBFGeAHFCDFCAFHBLAHHhACAfBAEIHCCNAGG.EAGD.hAAA......hABA...,2,-27,-12,15
OeYHQBXKEPILTgdWCRZfJUFMSANVGcabD,VDBBGCAB.aGCBOAFDHAEHBGFB.EEGCIHHHLEABdEHChAAACABFRAGFZADB.UEEBMFEFhAAAAHCD....bBAGDIGChADA..eHDA...YAHBKEEE.hAEA......hAGA...,2,-11,-8,3
JEgLUYROXQVCDKePZFTNBdacWHSGIbMAf,JCBELCEC.UBADOGECQFFEDIEE.eDEFZDGHFAFA.hAAABHCDaFAHHEBDGEAHhAAAMIAAAEGH.fGDEhABAEABF.YAEE..XBGAhABACDAHKFHB.....hACA...,2,-35,-2,33
VgGKSOQBPdbcfIUeTDaHFRNEAXZWLCJYM,XDFBLAAFCCHA..JBAHMEAA.GDDASFHHBBHCdHGBhACA..fFBHhAAAUGACDCBCaFGERAFGAAHAYEEHhABAKGCB..PCFDcCDB.eCHHFAFB.hADAEGCC.WBBB.OFAHhACA.,2,-26,-13,13
YdCOceaHSKLERWUZMXNTbPQGDFAVfBgIJ,BEDCJCAH.CBFA.eFCHHBAFKCCDLDGB.RACEZGFGXEFE.hAAA.TFAEQBGHhAAADGEBACID.VGEE.fABFhABA.IAFFOHAESDDEhABA..EDEEhAEAWAEEMEID,2,-34,-15,19
AKUVJSDXEBTZGfdMQLWOgNPFYIRcabCeH,KBFFJEAE.DCHHBEEFZEBA.GDFG..MBIFQBACLGDAOACAhAAA..NIAFFCDBhAAAIBHA.aHDGeEEEhABAAGBH.SDAC.EABAdCDHPAFAhAEA.....hABA...,1,-22,-36,14
OSgGQIVdEURbWCALXfYaBKDeMZNJcPTHF,LFACXGEH.aACEDCFBZEGF...JFFFTCGH.FAFFSGBFhAAAGEBEQGGEhAAAdCAAUCDG.bCBEAICGBAHAhABAKABCMFFE.NEAC....cACDOCHFhACA......hADA...,2,-27,2,29
VXFEKTRgeAbYSWcGOHfDBPZLCUNIQdJaM,SEBAGAAAOCFFDAEBBDBALFEHUGGFQAGA.hAAAdDCDJBGBMGAAFACFKGAFhABATGGARFCC.ADHFWEAGhAAA..fAFF.CDDB.aADF..hACA..EEHH...hAFA...,2,-32,-12,20
IMCDBJbXYfeTLcOEZdHQNWaRUAgFVSPGK,VDDHSBHH.KAABMADFBCFF..XGGBeAFALFAFhAAAEAAGHFAGQGFChACA.aEHHAAEFgAFHhACAFBDBIEFCDCCHJEDFfHEFOCBF.hADANBIA......hAEA...,2,-16,-15,1
FHGDUYZeWQVTXOPCSBIbLJKdEacfNARMg,MEBAFEGHGDDEDAADZFEHeDAD..QAEEXBCC.ODGHhABACHCBBHHALHAA.hAAAJCBEKAGEEAGCfBEDhABAAGHG..gEAGHCFG.YBHBhACAWBBD....hADA...,2,-23,-18,5
cSXWgDaZUVCMGBPfeJHTEQNdYAKIObFRL,KDGFOHCCFDAELHAE..SABD.gFAAhAAADHFAUAGCCAABGBFEhACABADGeECCHDCCQADChAFAdFFDABCF.IFHDbFBE.XGGChAGA.aDBBMIFG.hAHA...,2,-33,-12,21
cDegMRaALfbEVOIPdZHJWUFQKCSTGBNXY,LFCBEEFC.VADGPDCB..HGEGJAGD.FDEBKHDECFFFGABAhAAABAAG...XCGChABADBIBMDBFAHIBODABhADAIGGEdAHAZDDD.QACGTGAG.cGAHhABA....hAEA...,1,4,-37,41
JFfLXbKENQcUeMIHROVTgaGZACYWPDBdS,CADH..PAFFdFFCFBAELEFB.KCADQGCEUEBA.eAGBhAAAIAHBODAHTAAFhAAAaDDC..ACGBDGIDhABABEHA.SCDBXECGEHAGMICE..hACA......hADA...,1,-24,-30,6
fYCMLFKHaceDbNIBWAUgXGEPQTSOdJRZV,XDCGGCDAEAGD.QFFDSCBEODAGdFEEZBFE.VDGFhAAAfABB.CHDCFFAChAAAaGAEDIGE.IFAChABABDGDACFD...PACG....hAGA......hAHA...,2,-24,-19,5
YPJBgELbMTRSVGaIHeOWXQCdZFNcDfUAK,KEFBJAEDBHHFEBFA..MCCHRCGH..GDCCaGDD.HDAD.eABDhAAAXADFdEEAZAFBNCHE.DGGEhACAADEC....PDDBhAAA.LBACSHBGIGAF.hADAWFHHCAHA.FCAD..hABA...,2,-30,-11,19
UGDHJFdSKMILAXCTEBQfRNVeZYcOgWPba,CGABEGBCBAEFREDB..eACGZDAA..OFEB..PCCGUBFGDIFAhAAAFAGDKDHF.LBBFhAAAAHGA.TGGDQBBBhABAfEAG.NIBB.YEEC.hABA..WDHH.aHAChACA.JFCFMAIH,2,-43,-2,41
FNUXMZRgTHSDWGdeJBIALfKYQVCacOEbP,LFFCKADFQGBDaDGA..OCCFEFEDFECGUGBFZAED..RBAD.HAABhAAADDGGdGGGBEBGAHAH.fGGChACACHEG.bAEEhADAXAGA.MFFCSEEF.hAAA......hABA...,1,-11,-22,11
fcJTUbOSQRGNYeXBDgaEMWIKHVZdLPFAC,CDHBJCCHUEEH..SFBBRGAE.GADDeADBDCFG..aEFAhAAAEBBDMFIB.KFFHZEAAhAAAdGDCFGHHAGAG...fHEHhABAbBAF..OBHF...hACA......hAEA...,2,-37,-21,16
dOAKRcgNPbFGaQYVWeUXJIZHDTfBLCEMS,KFGHRFDH....NEEF.FCCDGADHaBFD..QABC..hAAAWBBDXDGAZFFDDCGAhAAABFEDCHAE.SAGBhADA.AIAAgFAFbABFeECHIHHBhAEAfEEDMDDGOHDAhAEA..,1,-26,-29,3
HNJVOYKWARCLeIZdUGMXcBFPTaDbEQgfS,CEGFeDCCZFGBGBDAMAEABGCF..FFCBaBFCDCCD..QGFChAAA.SDAFhABANDBAVAFC.ODHBKGDHAAAD.hABARBBAIEFG.XAGAPFFBEACDhADAfGDA..hACA...,2,-25,-22,3
DcEPFIeUdRHMSNWLCOgGbXVQfKZYaTAJB,JADDDBBFEFEA..FAAEUDCHdCGGHFCF..SAHDLFEGCGHAhAAAGGEB.bGAGVDAFhADA.KHAAZDFCaAGCAAFGBBFFhAAA.IADFMIFE.NIBF..OCAHhABA.....hAFA...,2,-25,-10,15
EKHcVSbBAUOMPWTaQZCGJeDdRINfYLFXg,MDFATBEBZAAC.GFEDeEHFdGFA.RGAE.IGCC..NBAGLCCHhAAAXBECKCADhABAHAGHSFADhACAABDA.OEFAPEEGWFBCaBBBQGDChABADIBGfCCG...hACA...,2,-15,-4,11
IfHVEaDYSKLcgNMBXWPGUbTFQCJORZeAd,dHCFHCBAaCEDSGAA.LAFANEGEBDDF.PFFBUAEHFBAFhAAAJAAAZCFG..AFAE.fEABhADADFIHKAHF.gEGGhAEAMDCF.WHAAbDGB.CHHH....hABA......hACA...,2,-37,3,40
KRfVQUdGEeYJLDMbgaIcOPCZHATFXBWNS,FADEBEEB.SCCGKGGHRBFC..QEEBdEACGBDDEDCCJABCMCBFhAAA..aEGBIGBAhABAOHBGCHHC.AIEA..hACA.WHDG.NDAA.fAAG..hAEAeBBGDGDE....hADA...,1,-27,-30,3
JIRLXgHFGEcAKedTBZWCObNDVSMUQfPYa,dBABZBAGOFDHDEDA..MEBFUGGA.QGEG..YGDAhAAAaHAG.JBDEIDDBhAAARCFA.LBEAhABAgFGGFEABEABCKAHHBHAG.WDAFhABANBIAfEFH.hACA...,2,-42,-11,31
OgITVAMPXJeBaKUbGWNFdYZEcfCSLHQRD,XAAHJGAABGFC.KDGDGBBA..FAFBdCACZEDB.EHAGCEFFHAFDhAAAQGGEDGID.ODBBhAAA..IHGChABAACHBMAIDeADFaDEB.WFFDNBIG.....hACAfECC.hADA.SDGH.,1,-12,-24,12
XTREYeAfIdcDQaGLSMKFPONJHZCgUVbWB,dGDGQCGBaAEC.GEDHSFHBFHBCOAFBHBCFCBHB.UGFFhAAAbABD.BHAG.TDAFhABAEGHDAAHE..IAAAhADADFDEKCFE.JEAD.gGEAXFAE.eECDhAEAfABC.MEEChADA..,2,-10,-9,1
dPaUeMZJFGKNcIgTAQDXBWOVECYLRSfbH,XEGEBDHEOHFG..EAAALFFERBEE.SBEFhAAAfFEDdCBBaEBHMCAHJHEEKADDhAAAIFDBABHE.QGAEhABADAECCCBAHGBCUCFCFDDA...cAGFhACA.TDBC.hAHA...,2,-13,-9,4
YMFHScKLEOXAUBTZCQNVfIdgRGPDeJabW,UCCBTFDGCBFG...QCFB.VDBCfDGB.hAAAdFFDRGACDAFAeHBGaGGB.hAAAbABCMFAH.SEBAhABAKBFEODAHAEAGNACFIHHF...hAHA.....gGEGhAIA,2,-30,-19,11
gCLNZaQMSKUVYAcGJIBDRPHFbXdeTOEWf,JCHDDBIFREEHHEBA.FGHHdADB.eEBB..OABDEDFG...fDEDhAAACDDBLHBGaBAHhABAMCBE.KGGEYBEAhADAAGAE..cAFDIFFGBABHXGBAhAEA.WFADNAAC.hABA...,1,-19,-34,15
AVdWLSCRDZFOfbQMNBYeXcUKHJEaGgPTI,dHCHSEFACGHFZDEF.FFCD..OAAGQAACBHFH.eAEDUCBDhAEAJAFGGAGA..hAFATDDDAGDC.WCCFhACADGBFMFBG..XBGA.KGEGaDHDhAGAIHHF.LDADhADA,2,-38,-7,31
LKZNTbaUBfXdSEPFYIJgHcGRDOMWVCeAQ,KEGBTBGGUDCA.BCAGdCEAEGAC..FABGJBAFHAECGEFC.DDCEhAAA..OFFBMFIFCAFDhABAACCALHACZEAE.hACAaEAHSGDH.PBBGIHHBhAAA.cCGG..hAEA...,2,-41,-5,36
PUDQEMSWFGJHaeZYVfNRbcCALXBdKgITO,XEFGBFDFKAHH....TFEAUECGDIGA.EFAFMDCG.SHAChAAAFACFJBADaHBEeDEAhABA.ZCAB.fADGhACAbCFEAGHG.LEHBIHEE.OBEEhAAAPHCC..WAFChABA...,2,-35,-16,19
VUWKEGcYHFXOLQJSMgIDaNfeZCPbRBTdA,UFAGEHAEGCGGHEEFFBCFOAFGLCEG.QAGHJFFBMBBCDDCDhAAAaAAH...fCAChABACAEERFCBBHHEdDAHAFDEKCCEhACA.....XGCESHEAIDEChADA....hAEA...,1,-8,-26,18
FAYSWRMCcBQEXegaPfdGLIKbHVUJOTNZD,SBCFRDBACAGH.BEDDQGFH.EBACXFDA.hAAAeBFGaGAAdDHELAEEhAAAbFDFHADHJDAHNIADDIBGAABFMDHFhACA...gCEB.fGHAhADAKDGD..hAIA...,2,-29,-14,15
eZbTPEAIHgVJFKQMUOXcfYSCdGDaBNWLR,HDFHJCHB.FGBFQCEAUDAB..XAGG..cBCDhAAASCCEdCACaAHBNIED.hAAALGBAZABG.PFFBhABAIFHHKBBCMFABfFDCCFBEDIBEBHHDhACA.....hABA...,2,-30,-8,22
CSGcXZYLPFTBRaWHVUgeNOADIEQKfMdbJ,EFGAQCCHKBEA.MIECdBHCCADCGEBD.ZAGHLCCFFEGGTABHhAAARDDBaGAH..HGBAhABAUGDBNEAA.ACAG.DGGC.fBEGhADASAAC...cFAF.hAEA......hAFA...,2,-28,0,28
LVXPNfRMATCSdQGOUDbgaJEeBIKYWZFHc,TBAFCHGGdFFHGGBB..DBFG.aDDBJEAEBCHCKBAC.ZGAEHCCCLHEGhAAA..XAEAhAAAfEAFMEIFSEEChABAOBGD.gEGF.ICFHhACAWAHB.cADBhADA..,1,-19,-33,14
ICWeAFROKZUcHXaVQEdBbfJSgLNPYGTMD,RFAHZBFGUGDHHFFH.XCAAQCEC.dACCBFAE.JDHFLBABhAAA..YDDHhAAATEGEDDDF.CCHCAAFChABAFHBG.OAECKAGGaGGCEABF.fDFAhABA.....hAEA...,2,-24,-14,10
FAcKIJWYNVOdQUfgeaPZEbDMBCTRXHLGS,KGCCJFBB.....NCBG.VACA..QFFCUGFB.eABGhAAAZDEEECAAMAEEBEHACECARCCE.hADAHAFBLHBGFAAGAAHH.hAFAICHHOFDB........hAIA......hBAA...,2,-28,-23,5
VFbfRTCLQgcHaMGSeKIXYBDOZNPJEWdUA,VDEAFBABRGDCLBGB..QBAEHDBFaEGEGAEEKCGEIHHBhAAABEEDOEAHhAAAZADGJFAFdECG..ADBBfHGHhABACGGCMABG...SHAAhACA......hADA...,2,-23,-12,11
LAJaSDbTWXdeKPZcVMGRYONBFfHCgEQUI,SBEETGAF.dCCEKCAHZEGFMGFGGEACRCCF.OGDCBHECHBFDhAAACFCB.EEGCQBAAhAAAIACHLAEChABAAEEGDDAH..WHCGeFDFPAHH...hAIA......hBAA...,1,-11,-12,1
bBPIXQTadeMFGfOSZWLAJcCgKNYDURHVE,CFEDKBHDDECFHDAA.EGFGBCBC....XFCFaHGEdBGGFABAfCDGhAAA.SEHDhABAZAEDAHEG.gAFFhACANEBG...YFAF.RABA.hAEAbDFE.IHCBhAAA.eADHMIFA,2,-44,1,45
gNQBePOEbCfWLVIMRKYaXUTADcdZJFGHS,dAABFBEGGDGCSGCCQCCCBAEDeFGFEABF...CDEBLFABhADAIAHC.KECGaFAGUBBBhAFADIGGZGCAHAGFPFDChAAA..fGEC.MDIDXGADhABAAIHA....hADA...,1,-9,-17,8
XKVGNSRDMFeUgQLBPfWIOAYCZcEbHJTda,ZACDEECFHBGHJCAF.aGAHKECD..GGEFRFDB.FDAEUAFCLAFDhAAABGGG.fACChABA.OADDAAABCFFC.bEFEhACAdBHE..XGBASDEEDEEH.MFIBhABA......hACA...,2,-47,20,67
CZTcVUSAJBgebGEdKYOIaFNXLQDfRMPHW,JAFGBDFG.eBACECFE.KHFE..OFDEFBDELAHHQDADDABE.hAAAMIFEHGACZGEETEGDhAEAVBCH...AGDA.bDFEhAAAdDDC..aBAGfBGARFAB.CFAG..hABA......hACA...,1,-6,-19,13
ZORYJIgCaPBUTHVFWQcAMGDXEdSbeKLfN,DCBCECHDdDEHeDDBLFDCZACC.RBDE.JDAFCAFC.BDHCHCAC..FAHBQAABhABA.AFHBMHBEhADASDFHKAHHfHEFhAEANEIE.IHHBaGGFTGBDWHAGhAHA......hBDA...,2,-39,-9,30
VFfcERHCOPTSgAYJZeIWXDKBGNLQdUaMb,ZBEFeFHB..IGCBXEDGBHACLADBUCCH.MABFFCAH.EGAHhAAACBCE.OBFG.TGFAhACAABBHJEHF.DAGCKFFFQGDAhAFAdAGA.bCFEfFAH.hBAA......hBCA...,2,-39,-4,35
DcHKaAfNIVCbQeSPMJFGETZUBLgROdXYW,..IFBGbADB..QFEGeDEBSGHHJDBBFGHHECHFZBDEUAABhABABGCD.LHCEhADARAFDOBAAXEGFhAEA.WAGHDCABKDDDAGADfAEHCHAFMIBC..hAIA.gDBEhBDA..dEGD,2,-17,-4,13
HGLYUcRXaAMDNfgFZVQEdTOKIBeSWJPbC,MDAFDFBA....NDHC.FEGFZBDCQFBH.TBDGOHCChAAABHDAeDAGSAABhACAJAEECABG..HFDEhACALDFD.cBFAaDDAACCH.fACChAEAEBHB.dHAH.KGHB.hADA.WFHH.,1,-7,-24,17
fMbWZCgOdFJLXSGRATIQPKaDYcNBeUVHE,TGADQFED.aAFADGFH...NCAA.UCABHDFGMDDFZBAHCDEFOEEAhAAA.dGBGFCCGLBBChABAXFCBSBFFhACAAGHEKBFGBHHHEFHH.fHCBWFFB.hAAA......hABA...,2,-26,-6,20
JHKXAgZGRTSOfeDEaUVLFYMIQcWNBbCdP,GDBCSBHFOFEHeFDADGID..UDBBVBCAFAEF..MAHHhAAAQAAB.NICDBGBHhABAdGAEHDEH.AEABgGFHhABATGGGaCCALEECcDGECCAH..hADA......hAGA...,1,-6,-18,12
VKaNEZHMUTACRQDYGfJcdbSOLBeFPXIgW,RCABQFBADFIDGAGGJAFD..dFCA.OCDFeABAFHEE.XEGFhAAA..WGEAhAAAKEEBaBDDZAEHHABD.hABAUGAEABHCCHHH..fCAESFEABHABhACA......hAFA...,1,-13,-29,16
PGaRHcZKfEUYdOeAJMQDVTSgNLBXFCWbI,QCDGVDDC.SGHHLABFXADEFGCE.CAHB.WAFAhAAA..IDHEhAAAaFAAREFAHCACKGGHUGAGhADAYHDGeHCG.AFGC.MACEDGDG.NBAB.BEAG.hABA......hAGA...,1,-13,-17,4
dIPTWACEabBKXZFQJDVOfLRgSMYUeNHGc,aFEHBGABZBFHJFCF..DICE..OFEFLDAERBFF.MIFCUBAGeGAAhAAAGDBBdFGETABHhABAAGGH..EEHDKEABFAEHhAAA..fCECSHGANAIC...IAHChABACECD...hADA...,1,-17,-26,9
GDcUAaXNSdCgPTBHJRKOQefZIEbVWMFYL,XGEDSCCDdACCCGDC.....PDEAHEABJEHF.KAFDQFAGhAAAZDFBEBDB.bAEEhABAMBIFFGHBGECBhAEADDFHAABDaHACNBIEBDBC..eAADfGCAhAFA......hAGA...,1,-8,-18,10
aSIdQfbBTUHPNLZDeWXJKEVRMOYACGgcF,CBADGAEDFGHH.aFFFdGAF..QECABEBDHDDGLBAFDAEA.hAAAXFAGEDHH.MFIFhAAAAFIHSCBAhABAfCCFUGDGNDHCeHCGKGFBOAFE...hABA......hACAYCEC.,2,-27,7,34
OQVAILfdCHSEBGcXeDPKgUbWNaTFJMYRZ,LAGFCBFEHDDCBHHFGDDB.eCAEDAAEKEBHUADB...bEADaGDDhADA.FGFDMGFGZABE.OHCEhAAAAAHH..dCCFSDHHhABAECHD.cECCgGAG.hACA......hAEA...,1,-13,-29,16
IdDKGHYJLgWOBcSfTVFbXARNaUEeCZQPM,RACBaDHHeGCCZAFD...QBGAMAIF.dEACDDBAKFHHGADGHAAFLBFDhAAAOFEESABDhAAAfHFHVFABhACAFEDCAHED.EHAECACHIHHB.JHCGBEBAhACA......hAEA...,1,-1,-12,11
ZIDagPNAUYVCOcXGbMLSeKFWEHdQBJRTf,UBFFVGCG.OBAHGAABLGBCKGAH.FEBGHBED.dGHGJFGBfFFHhAAAZCDF.DCDHhABAaBBG...NIAB.YEAAhADA.cAGFMFIHSAGEhAAA..ECGFBCCGhABA.TDFD.,2,-16,-2,14
EKeDCJOFLUHVANPMbITgQdWaZcXSGBYfR,MAFDTGBHdCHA.ZDCBSCEBBAHG.REFHKBADeFEF.DAAACHEAFDCGhAAALBBF.HGAEhADAAGDANFAH...IGGBhAEAgBGCaFHF.........hAGA......hAIA...,1,-22,-30,8
aVcXPeRNSCHWgdEFMfKGTQLDBZObIYJAU,aBGAXBDA.RDBG.SDECHBGH.dACDFGDFMGFGKEFHQAADhAAADIFABHCFZDACIFHEhACAAAFB.UGAGcDGEhAAAeADC.CHHH.gBAG.fGAEhABA...hADA...,2,-29,-11,18
OCXIELZfDeUSbWgGFJBKNYdPcHRTQaMVA,CDFHXDFFLDBDDDDFUGGD....SAEC.bBBGhAAAgBBE.hABAFEDCJAHHBBHHKFBDNHEDPAFHhAAA.RDGFaHBGAIECEFGC.fEEEhACAeABE......hADA...,1,-21,-34,13
DGQHTEJdaCcPNgKMLbVIefBUYXOAWRFSZ,RFDAFCBHDCIFHGCA.EAFEaCBE..CEEH.....PGACNCAC.KHGAhAAAMAAGLBEF.hAEA.ICGFBACFXBFDhABAOEGHAFCBSFAC...hAHA......hAIA...,1,-34,-37,3
CNUIgWdSVORXGHJMfcTKLBPFDAbZEQYae,ZDFAQFBAeAACUCBB..IBEHdAEEOGAERBACGAGA.hAAAMGFETBGHBDDCDAGEhBCAEEEGCHHC...NIDDgDAAhAAASGGFXEECfGDDcGDDhBDAKGAFLADCAIBC.hBEA...,2,-27,7,34
NQRBSVPegXMLHIUKTCEZDbWadJcGAOYFf,FEDGQAFDBBBA.SDAGeDAD.MEEHLFFBHBAGIGCEhAAAKGDDCCDCDEGA.aDFEdAHChAAAJFGBACGB...YFAFhABA..NABF....PFHD.hACAUGAH.EDBBWFFFhADA...,2,-26,-21,5
TKFLHXYNgbEVBIcUdWDfaZAJRPSGCMOQe,RFBASEFBGCEHCHGB.OBBB..TCBBKGAHLFDFHAEEXAAChABA..YACAhAAAgEFGbBFEBCDChABA.UEAFDGIHaEABAFIDMFFBFHCE.EHGCIHAEhACAWDEE...hAEA...,1,-1,-22,21
aPMZeWCHGJbEFYBfdgDTINRAXLcQVOKUS,LCFGVBBH.KGCHSFBFMAEA.ZFFDCBDAGCAF.EEEBhAAABAGD.dCHADGBDNAAHAIHAhAFAXEGE.OHEGhABAaEDDPBEF.eHAA....hAHA....WAFAhACA...,2,-34,-20,14
QJEVRDWGafAICUNXKbFSYeZMgPLcOTHBd,CHFGUBBAKECE.FCEF..eCFDMFFALACA..OHBGBGAEdCGDhAAAEGGEDBAHaHBEADDG..hABAXBGE.SEAAhAAAgFGFPAEE..cDABhADAQGEC..hABA...,1,-35,-36,1
WFGbXYHJAOfSTBDECNgedMZIRcUQVLKaP,SCBGBHBEEAAE.CHFE.eDDFZFGF.RCADUAGHLEBB.KAHHaGGAFDEDhAAAGGDF..XAEEhABAJAEHAHAB.fBBDhACADDIDdEFH..ICCGcGDBPEAHhADA.....hACA...,1,-19,-22,3
LVSEBARIOKfUPFNTHCceYGMbZdDWaXgQJ,RGFGKBCHUFBDFAACHFAF..CAAC.eEGFMBDFZBEC.DIGG..aGEBQEDGhACALAGFEBBDhACAIDFB.OEHDhADANAEA...YAFEdCHEWFAD.gDAEhADASEAEAFIBfEFDhAFA,1,-20,-28,8
KNBaSgAdZFMGVHCfWYJRcTPXUQEbeIODL,FDGHMDEFHCCF.CHHA...fCCAJFCH.TADEUAEHQFEDhAAAEFFHeDHFIGCBhAAALAHFBDFGaABCAEIHhACAZAFF.GDAC.YBADPDAF..hABA...OHCEhACA.DAHF.,2,-19,-5,14
XCNHLIDfAESOcWZMQdKFUgPeJbGBTVYRa,OHDCZGCGdACCUDBF..eBBCGCGCBECH.VEGFaAEGCFEFLDDHhAAA.DCGHAGBDSAFAhAAAMAIHKDAHFGAH.hABA...gGGG....hAIA......hBAA...,1,-29,-32,3
UMNITOEYDRCegGVaHWJZcPdfBLKFSQXAb,UFFCMCBD...TDBEOGDC.EDFADGDGeADBGBBFHFBDZBGDdFFHhAAABDFFKAFFFBHF.SCCHhABAACAFIAEGCHHCaGAHhACAJGAC....fAAF..hAAA......hADA...,2,-36,-4,32
WDNTMUbSfRdAPVFEeHGOgBZJcLXaIKYQC,FDDFHBCDOFCHBBEBJAABLFAB..XCFHaGFF.KEACCAADDDIFhABA..TGFDhAAAMAEGUDFFSEEGhACAdBEFAACE.PAFG.eDHHgCBFIHCEhADAQGDG.hAEA...,1,-19,-24,5
DUAgFIeWVXMYKCBETZSQfPNRJbaHdGcOL,FHBEeBDG..XBDEKEDDCFFABHCHZGFCQEFB..NBIERCAFhAAAaEBA.dABF.OEAHhAAADBHFAAFD...gCGChAEAIGBGMEEGECBESEHH.hABA.fGHAhACA...,1,-7,-54,47
EXUbgMOBCYWeLHQRNdTSVfFKIDZAPcJaG,JEBBaFAEGFEH.UBAGMHDG.OCCFCBEG..eEDAHBEHQAFFhAAANCIE.SHCChABAfAAFKBHBhACAIDAEAEIDEDDA.XEEABDGBLHFGhADATAGADGDE.cACGhAAA.YHFG,2,-21,-8,13
WCOSKNaeRGQXDYIVETPcBFAULZgdfMJbH,UFBEZFDGdEBGMEEBHCDA.CADG.KGGC..eCHFGBAHDGAH...IADBhAAAEBAF..PFHFhAAABAHFAHIFLAFEhABAJCEEOFABaHCC.XDGD...YFFFhABA...hACA...,2,-26,-19,7
SgGTIKbfCZYXWBeUdJaMVODEPRNQLHAcF,SDGBGCACKGFBCDHEZBCG....XAFBBGGHeFDF.JABGhAAAaDEHODDCDADDRFBH.QFAHhABAAEGA.FFFBhAFAIAAF.fGDC.WFGBhACAMIEC.EBHB..hAGA...,1,-23,-34,11
HZDORUVXEAaQgBfbdYTPIeKCGNcLSFJWM,QAAEBEFBdBCG..TGABIDABKGDH.CFAFGDDGLAAHFGAEhAAAMIFEZFGDDCDB.RACEUCFEhAEAEDGGAAEE..aFDAfGFAhAFA..bBFG.....hAGAYEBENAIESHBAhAHA..,1,6,-38,44
NOLMbRfUFVgHSGJZeaWAdBIDcCQKYTXEP,dBBDDCBECEDFKFCF.....TDEGXCGFEGFH.OEHFLBFGhAAARGBG.FDAAHFEC.SBEChAAAJFAHZFGBeEDBhABAABAEBDBEIDHHQEAGNACH.MDDA.hAHAfACH.hAIA...,1,-14,-20,6
XCPWRONEZBJaAfScYIUbFHVGgMTDdLeKQ,SHCC..IHGCFGAFHEBCVDCBMABFDGEAdACDLAEEhAAAeFFFKCGDQBAGhABACHGBRAFG.EGBFBCEChAAAAFIFfHDB.YBFF..hACA......hADA...,1,-19,-31,12
QRcYABfDaVEFKCIegJGNXPbWTdSMULZOH,BEECDDEGECCHFHCA.KFADCDAE....eFCCJCCA.GACD.XGFChAAA..WAAHhAAASEGD.MBHDhABAZCGBOGEAQGADRAEAAACB.aFAG..IHHBhADANBIA.PDBFhAEA..,2,-43,-22,21
NPQfOVLCIDgaeMUWcbZJXBGdTSFRAKEHY,HBDH..NDEDQGBGOBAFVCFHCAAB.DIFA..eACAMHCEUGGBhACA..bEAAXAGEhADABFGHdAHCSEEDhAGAAEIDKGHHEGAA.fCCGLAAEaAEA..hBCA......hBFA...,1,-4,-20,16
AUKSWYdbBDXIcNMOEgaLFJZVefCGHRTQP,SCCEdAFADDBE..XGGG..cFBDMDFCOHCAhAAAaACCLBFCZEBAeHAGhABACFHARFDFQDAChAAAAFFB.KHFGWBBCBDDG.NAEH..gCFFhABA.....hACA...,1,-5,-38,33
GMdQEabHcRXDAIeTKBYSPJNOZCFLfgWUV,TCECBECGSAEH..PFGHJDEBZFGHCCBAFGBGLBGBhAAA..gADAhAAAUGADMCBDEEAHHABEcGCEhABADDAHACDHKAHD.NEIA.fGDE..hABA......hADA...,1,-15,-24,9
aMfcPXTVIdODKQgEUAebJNZCFYHLGSBRW,eDHBJGAEZFDBFGDG.LCDHBFGH..RAFD.aHFE..MBBD..hAAAPDAD.TAAChAAAICDDDACCKCFBEGFDAAEEhABACGBHGADH.SHAGWACF.fFFDhAGAXCEDODHFhAHA.,1,-7,-47,40
KEdeXFcIDUHJSRbYQMTOaVgGLZWNCPfBA,dDACFDDGDGEGJBCB...REAE.QDED..OAGHaEGDGBEFhAAALHAA.ZABCCFBABHDChABAADAAKHEE.eABCXEFAhAAAIHBA...SEDDhAFAMCAG......hAGA...,1,-27,-36,9
VAYWNdJTaLHXCcgZOSQPbIKMfREFGDBeU,...NBCA.TBEDHEEECBABZEDH.SDAH.QGBChAAAIGAEMIFGfAHAhABAFGCDBBEAeACDAAFCYGEGhAAAJDFEaGGC.XCGGOFFAKADCECABDDDFhABA......hACA...,1,4,-28,32
EUGcNITLSVdOWDFCgZMBPQAeKbHafRJYX,eHAAHGFAaEDERFAA..JEGBEBFH.UGADGCED..IDABhAAALCDFdABEDAFCCDHE.MBBAhAAABGDGAEAE.KEGA.fDCHhADAcBAH.SAFEOFHDFAHD..hABA.PFED..hACA...,2,-15,-14,1
KVUEJQZHabXfNDIGLdReYFBSPWcOMgCTA,VEAFUDACEDDH.ZDGFHDDH.aDAA..XGBHDCCELDGFhAAAdEFAeABEBHAG.SHFAhABAPAHD.WACGhADAOAED.CHHGAGBHKHCC.......hAAA......hAEA...,1,-20,-25,5
TfYZUJbWIONaLRSEXBQKACgeFVdcGDMHP,CADBFCCEdEEDDAFDHCAH....TEABZCGFJGBG....IDHEhAAANICD.LEFBhABASAAEEGDAXACChADABGHAAHABeCCH..cAGHMBIBfAFChAFAYHAA..WHFAhAEA..,2,-36,-27,9
dePAUgGCDVfTSRBOKZMNFYJLaEbQcIWXH,GEEBDECG..VAEBTACEBHBCKAAFZFEBMHEC..FDHDJGAALBAAhAAA.EAHHQCDEhABA.WAFHhACAdHGBADGHCEAH.SEABOAHDaCCH...hABA......hACA...,1,-15,-35,20
KREXIYGFDbUcZQSfMBHaTNgPeLdVWOAJC,KGGHXGFDGDEAFGADDBDE..UBBEQGBF.MAEGaGDHTAFChAAA..PCBDhAAAeEBBdDEEVBFEAEHCCBADhABAIABH.YEHHcEGCSAEFhACABDDANDAE...hADA...,2,-21,-17,4
FPEHbAWYdNLCOKITZgeBRSVaGDMJcUQXf,dGGDLEDCKCCEZBEDeFHBBDAGRACF....VAFEDAHB..MIDGJEAFUGDAhAAA..QFAHhAAAFCECECAE.AEDF..hABA..NAIA.CABHIDHBSACAaGGHXEFAhABA...fGDDhACA,2,-38,-20,18
OFDAWRMfLUTIaYeXSQGPdcCbHENBKgZJV,RCAALECBUAGG.aAEGeBCE..SABDGEEBdFBGCFBDEGFGBDGBhAAAZCBGOEDH.AABA.hADAMBIF.fGEEhAAAIHGB.XCFH.....hAEA......hAFA...,2,-31,-18,13
NCOIYGFBEMULaXAHDgZRcfTdbVJSPQKWe,DABDZGECRAFF..TAFGdAAA..VEBCSGEF.KBDGeEADhACACGGFODBE..IFFHhADAFFAHBDHBMIDGhAEA.aDHHACCH.HCCGfEFH...hAFA......hAHA...,2,-41,-18,23
NWDVLUMBRSJXePdOaYIGQAFCbfgETcZKH,CAHB..bCBCEBFF.ZECGKEGBHBBBDBGB.LHFEMAIF.BGECREBC.SADChAAAJAAA.eDGFhABAOHDCaHBA.IHBChADAAEBD...FFFH.fAEEhAFA......hAGA...,1,-16,-34,18
eZXSMBCdNVYfOPaRQIbGDTLgUHWKEAJcF,FBCDeEFEZEFFMABHdECH.....VDBBOAHDaHGA.QAAChACAGFDDDIBCLFAHhADAHAEGKDDCECGBAAHEXACBhAAACEHH.fBHCIAGGbFCE...hAFA......hBAA...,2,-15,-5,10
GSdKTOgCJLFQRUAfPHYXbaVEWDMINcZeB,HGAGXFFBaDGCEFGFDBGC....MGCGNCBH.eCEHBEDGGCADhAAAKEAEOABECHCEFABEREAFAGFF..hABA...fAEFhAEAPAGF...YFHB..WAAFhACAIHEAcDDF.hAHA...,2,-25,-18,7
WRODPTeFHEUBLKAQfcVJdaMIGXCbgYNSZ,QEEDVEEA.aFHFMBED.GGABXBGBCDAH...bABDhAAANACHZCBB..WADBhABADIDCeAAGHFBHBGEHhAFAKHGAAIAA.JBFFdBGEIHGD...SGADhAGA...hAHA...,1,0,-21,21
HNAJUPLETeSZKbYRfVaIWdDXMgCcQGOFB,JEBFUBCFLDFBEHFG..SFADZAAAKAED.REFE...aHEEIFBGhAAADDAA.MFDFhABACAFEGDDEBEEFAAECeFHDhABA..fCHEdBHG.cCAC.hACA.OHAC..hADA...,1,-23,-25,2
TVbOBGXIFKMDWNecAfPQJSCLEgHURYadZ,QAEGJBBGLFBBEEBAHAGF..UDGGaGEFZDAGTFEA.OCAAhAAABGGAGEEDhAAAFHGCMHAENACD.AFDF..SEEChABACDHA.gAGHYFDFdBAC.hACA......hADA...,2,-17,-7,10
cNSVHbIFJQgWPfYdULEGTBXaeRZDKMAOC,CGHBSBAHHDEFFCAE.QDBH..gAFG.hAAA.WEFDfHEDhAAAdEHEECFGBAGCeHAGREBFDABChAEAKDHHACHEcCCFbABAIDDHPHBA...hABA....YHFGhAFA.,1,-5,-35,30
REOdCTXLUAJWgIPfcYFZaVMNHSKeDGBbQ,JEEG..gFDG..fHGDFBHBZCAFaAEDMCFCSFEEhAAAKAAHGFAFBADEhABARACGOHACCHHBLDCChACAACCFIEACPHAG...YDHBNAGEDIDCEBBGhAHATDCC...hAIA..XGDE,2,-12,-11,1
HINMYPfCcLdgVFOUeTABaGSRWXQZDEJbK,BHBEaBDCGDDCRBCD..QAGDEEAB.JFFDKAGD.IDGChAAAMBAD...fCBBhABACHDDdDFBFFBEOCBHhAAAUGGBAEBASACC.WHCADIGE..hAFA.NBIAYHAEhAHAPEHF...,2,-29,-22,7
aTNeYWCKEQFOHVgLJScBdDIfbZPXMRUGA,TEDEeHAGCCDB..KCFBFDAA.HGCALFFCSCCBdAFFDFCDIBAChAAAZCAB..MABAhAAAUGGCAHHD.NAEF..ECFDOHDGhAIAJBHDBBGF.fFBAXDDG..hABA......hACA...,1,-13,-27,14
dIgEeKHDfNUWPRLaTXYcAOZSBQCVJbGMF,SHBECBDE..JCFEMECGFBAGdDDEEACHKFDEHDAE..DBFHUGEAhAAARFGFLABD.hABAaEADXGACAFGF.hAAABEHGQCGH..bAFGIHEAhAEAfGHCPAFG.hACA...,1,-10,-39,29
HVGNeRfZbXUcSFLWODgBMIQCYAKJEPaTd,EGCFTEGEdAGFGABH.REFC.ZFDH.XDEBSCEAFBHBOBADhAAABCCGMBAH.IECGhAAACACAAAFBJEAFaECGNIDF.hABA..eHAA.UGGHcFEHDCCC.YFABhACA....hAEA...,2,-22,-10,12
OEfRKVUaTbSdQeZPFNLcDJHYAGgCIBXMW,CBDGBGCE.MFEGOFAGRCFA.UBAE..TACFSHEC.hAAAeHAEZCAFNIADLDEAhAAADEAF.JFFEAHHCIDDEhABA..EAEBKAHB.aGGB..dAGD.hACA......hAEA...,1,-25,-33,8
fdIDMSAZNKHbFCVJRUYQBEXGWacTPegLO,KBDBFAEFCEEEREAF..UEECBGFE.GCBD..aGCC..TAABhAAAeFHDOAFHdGDEDFIFAGCHHAAHhAAA...JAHDEAGEhACA.XBGG.PDAHfCCGhACASDHFNIDH...hADA...,2,-28,-24,4
ZQTVePIUKdSHDCXbgLRaWFAfOcMBGYNEJ,OGACBDEDGCAA.EDFGZEEB.QAFCTGGB.eABBIHCEhAAAdECFDEAD.XGGChAAALACCaADBACDFfBHEhABAMIBA.YFCENAIG...hACA......hAHA...,1,-19,-20,1
LXgPOKBbANcdRCHYIeFSTJDGfEUWVMQaZ,dGABRCBCCAHC.HDEH.eBAGSAAADAEC.GCFAEDBCUGGC.MCIBhAAAaFDCLFHHhAAA.XADBgGDEhABAPGACBACEAGHBNICHcBFF....hAHA......hAIA...,2,-20,-16,4
PcBXOTeMdLHIaWJFUDKVZQRASNgfCbYGE,SCDF..NADGCAEFGFDD.EFBCPBFABBFETAAAhAAAdFDHHGFA..WHAChACAFBAFKCFD.QGAFhAAAAHEHfDAD.YAFCODHHeCBHhABAMFIBaEEADCID....hADA...,2,-28,-13,15
HcfCMeZDbKRWAUOBdVQGPJLTFYEXgSNIa,OFFDdADDQGECGDDDLADHFECB.XGCESDGAhAAAaBHDHAAE.fHADhAAAMABBeHACDGAERCDCAFEAhACAUAFABHHEJCAFEBGGIHHB..CAHBKEABhAEAWCCF....hACA...,1,-3,-11,8
AcUTHBKPIfGRgWFbQaOeXdNZDLEJCSMVY,TCGEKGCA..IBGCGEBARCAC.FAEAaADA..eFFHdGGCDDDHhAAAJAAC..MEIHAFHAHABBhABABEDD..fCEDhAGAWFGH.bFEBXEEBNEEDLAHBCAHB.YEBDhBAA...hADA...,2,-20,-8,12
SXeOVdBfLZWYPGQMbIKNAUgHEcFCDTaRJ,UEFDHFBCFGHDDCIB.aCEHREBB.....SEAFOCDABEDELBDChAAAZACG...WFFHhABAGGEB.bAAHKCAAhACA.ABHAECFD.CCHEJHAAeAGB.dEAG.fHABhAAA...hADA...,2,-20,-20,0
IaGHBQXYDPTVAMZUgSbceRJfELWOKCFNd,ZDGDSFCBeFCCRAAD.EGGALBFF.KGAGFEAH.IHEEhAAAHACHBHHBXBBGDEIDTGDGhAAAVBEAAACD.MFFAhABAUAGG..bDBAfEAHCADEaAHF...hAFA......hAGA...,1,-8,-15,7
LEOTgdCeKFcBSRXIPQfJWbHMGUANaVDZY,aDHFDIGALDGB.EEAHgAEG.CGDD.eBAGKEFEFDBBhAAASCEC.IEFAhAAAQDDAWEEDhABAMCAHGEBAAICCVFGBYADCOBAAdAHCBGAEhABAXCACfAHAhACA..,1,-13,-24,11
OWDPGbTZdaALNefBJFKRHVEcCXYIUgQMS,eDGDBBHGJFEAFCCEHEAD..EADBCHAG....IAABQBAHhAAAOHEEDBFBbEAGTAEAhACA..dHDBADHFfFDGhADAKDGC.cAGAXGAE..hABA....YEEHhAEAMEDC,1,-32,-39,7
eALUWbcRaEZTMKHDBXJGCQgYSOPNdFVfI,LCEAUFBC...bCCHRBDDaBAA.EFFFMBFE.KGCBBDBBXBAChAAACDGD..QBGBhAAAgGADSGHFhABAOFEDdHGB.fEAHADDB.cEGHhABA....hACA...,1,-23,-38,15
TbZfCHLegNGcYKSAdOXDRaWJBQIVMFUPE,dFFADGBCREECJCECBHBH..QCCH..MCFEFFBGEEHBTCDFhAAAZAAD.HBAE.LEAFhABAeHAA.NHDF.YACGhAAAAADE.aAGC...IHHChADA......hAHA...,1,-26,-32,6
JHSXgUefAFWLdCVcRKPMZYBGDNQaTIEOb,LABECCHDRBDA.MEFEBCBFDFFEQGAH..TGAGhAAAIADEEDDAOHDAhAFA.HAFHgEEFhAAAfBCAAHGBFGGAdFCB.KGGCYFDFaCBH.hAHASAGG.hAIAeCAD.,1,1,-41,42
INLFGaEcRJBVWQXDCSTUfeZAHKYbOPMdg,HEACKCBDOFFCdBAC..NIEF.FGBGGCDB.EBCFRBFEBFEC.QACChAAADHBGCAEAUFGF.hABA.ZEAGAAAA..YEEFhACAPHEGMDDC.IAHBaHAC..hAEAcAGE..WEEEhAFA..,2,-22,-22,0
PUMeSHFVbgAEGYIcQDLCTZOaKfXJRdBNW,EEBCGCBE..IFEBQAFG.LDFHCACBOFABaHCGKHEEhAAAJFHDBAEF..PABGhAAAMBBBSDFAhABAFBHDgDDBADCADIBG.fBHE.hAHAXGGD.NCCF.hAGA...,2,-40,-9,31
ASeCaIJPNYBVEQbfLgMUDXGOKZHFRWcdT,SBEBeEFGCHEH..JFBF..PEEABDHB.ECBCQCBBhAAALGBCMAEEDEEBOADAhABAZFGDFAAA..RBECdHGDhACAACHCNIADbDAE..fAHG...hADA......hAIA...,1,-14,-27,13
ceUZFXgIHQOLSPKaNVJAGYEWCbRfMDdTB,EGAECDBFRDDB.DDIBBABG..UBAHFAHD...XEDEHGBCQGGAhAAALAEFKDCA.aHEGhAAANACFAECD..GEGChABA.bCFBfBFC.TBCG.hACAZDFD..IAHFhADASHAG.,1,-10,-19,9
KTeZBPFfbDJUdVWEgAXCMaLOHQRYGcNSI,XEDDCBBDLDCDHBGFRADH.GEAE.SABBTGACeEHFhAAABGHDFAGDDBDH.dAFEEEFChABAAFFCaGGHOHDG..hACAcCEHIDAAKEHBPAABfDEA.hADA......hAEA...,1,-11,-15,4
eObgWQPHJVfEDINKGAYZBCdMFXTUSRLac,BGEAMFEDFCCAUAEHLCGF..eBBDOHAC..bDEAQEAAhAAAHFAC.fAGHhABADHGCKHAGADDECACBXCAGhACASAHDaGHFWBCE...PFFHhADAEFFG.IDHChAEA..,2,-39,-6,33
XTDICBHGAKFJObVLcedQZEfPRWMSaUYgN,KACFJBBB.OAFCLADB.dFCAQEBHZDEE.EGHHRBFASGAChAAAUCGD..gFDHhAAATGFECAFABFGBhABAAEEAbADB....cBAC.eHAG.hACAfGFCMEIH.hAFA.NIAD..,1,-9,-26,17
bgCUFRGQaDIedVJNAcBOTfMYEPXLZHWKS,BAAHODAFMDFA..EECHLFEAHABDKHDESGCDCAFA.hAAAFCCHGCEGDAFEeADDhAAAVEGFAEHE.fAHGhABA.XADFWEAFbGFE.....hAIA......hBAA...,2,-30,-15,15
cgYGTIWRFZEAbODKXBPJCQNfadLMVSeUH,DCFHBDAGCGBG.QEFE..fFHEaBCAdGABLCCFhAAAMEAAeGCEUGDCHAAE.hABAgAGETDDHRAFHFHFAhACAEGFGAFAH.OCDFKBHB......hAAA......hACA...,2,-26,-7,19
HXEaDeFASTZPgYUOBNLWdbIRJGVCKfcMQ,TAECZDFH..PBAFUBAEBGCC.LFGHdGACREBEGAEFhAAAKDCBMBHFXFEH.hAAAaCDFDIBA.AEAGSFEBhABAOHFE..NCIGbABFIGAH.CACEfCFChAEA.hAEA...,2,-28,-13,15
EJTHKfPeFMVYZgINULOSbGDCXQdcRaAWB,EABDTACEKDAB...eDDBMEEDZDFG...IFCGNADA.OHAChAAAbDFH.DAFGXFAEhAAAQGGEdDHARAFGABADBCAHhABAJHEG.PCECYHAAgEAFhACA.SHCEhAEACCEF.aFGG.,1,-12,-13,1
WfgNKHaQYVbSRTGBCeUAIcOPLZMEDJdXF,OFAELGFCZAEBDAAAdAAHFBGF......fCCEhABAgEADKBHDQBCBhADA..bEGDTEDDhAEABGFFCEFGAHHBPHAAEHAGXGDH..NAIAaHEChAFASDABeCFB.hAGA...,2,-22,-19,3
CTeHIUdNLAaFbGXZOVBYDPRcfJEWgMKQS,aCFDFDEEGEBFZFBF.OGFCBDHBDFAD.RFFE.JCAB..EDDHMCHHhAAAKAEC...CHAFeACDhABAHBAHdCDFABGH....hAAA............hABA......hACA...,1,-34,-38,4
bIgAGRFXBQPYUfNVKSHJEdZDWaCeMLcTO,FDDGQDGDUDGG...VBDDKAFBHEBBEAEEZCAFDIEE..CHBGeGCEhAAAMACALBADhAAA.OCBGIGHFhABAAAHGRFEE.PAHF.NDAC.SHBG.hACA.WBBB...hABAcFEF.,2,-21,-8,13
VgEISQJaUTPNHdOABfWZDRKGMXLecFYCb,BEBGZCDCRFAEKEGAGDFA.LDDFFAEF.CACD...VFEHEHGAQAFAhAAAUCAF.TBAChABAHAAAOBHDhAAAACIFDIAEeHBE..YHAA...IHHGhACAaCEFNDAG...hADA.dEHE.,1,-10,-19,9
NTJUDSYcPRVQHfCWFZIbEGgKMAaLBeOXd,BBGDOBGDdBBG..TGGDJFBE..DHBCSDHH..hAAAPFFERCEBQCBEhABAHCEA.fEAGhACACAEHFGEHZDAE.EADCKAGEaHAE.XECE..hADAUACE..cGCAhAGAIHHD.,2,-31,-2,29
PcIWbFOEDUXYQVadALRNGJgTMeKSHBfCZ,LHDCRCBAGFCD.JECCMDID..SAFEBHBCZAFC..IHGAhAAAbABE..OAHDhAAADGABUDFFQCFChABAaABDAAEF.NEIGeCADKDAFCBAF.PFBD...hABAFFGFEECCYCCAhACA...,1,-12,-14,2
NDTJLZceAOVCQRGbBgFMHWKPIUEYfXSda,OAEBVFAA.RCFGGCBEBDEFFCAH..HEEFKAFC.UABD.EBGEXEGAhAAAdFAC.aGGFDIEChAAA.JEHBLHDChABAZFCBAIAACCAG.QBBE.MCEC.IFEFhACA.SDFAhADA.,1,-3,-31,28
CbOBEZaTXGPWSgNRIKdecYQHADVJLFMUf,VEDCJECHLCAC..FBABUAEECCCCBGBGZEDF....XGGHhAAAGBEDSHFChAAA..NBAFIBHEhABAKDAAeDHHcFBF..YDABhACAAAHADGIDMFADfFFHhADA.EHAA,2,-35,-23,12
JdFZagOfICcbDXPQURKGNWYBSeVTMAELH,EGEGJHFCZGAG..aBFF..OCFDCGAE.DFIFQDDF.hAAAUACAGACE.NFADBCAAhABASHGA.hACAeAAHMAEGAIBCdCHC.fFFDbBGB.hAIAPFCD...hBAA..WAFE,1,-20,-34,14
QfGSITdPFYNMecJOEKUgALVaBWHXbCRZD,aEDBBDFAHGECCBAEZGCGQBFE.SBCBTDAA.FCAHMAFAhAAAeHAG..JACFEFGEhAAAKHFAACEDLAFChABA..VECGWEFCXBGBDCCD.fADDhABA...hACA...,1,-6,-35,29
bOPaFHJeMSIRgfQKCGZWYAELcNBUVdXDT,EAAHLAFABCHAdDCCDEAAOGEE.FCAEJEFD.eDAF.MIAEhAAASFDA.RCFDQACFhAAAKBCACAHFZEDDAHHH.hACAUGAF.TDDEaBFHIGBD..hADA......hAEA...,2,-32,-18,14
LMbKOQagZDNcVFWXIRGBdeCSAfHUYJEPT,HFBAUABCEFFGLBED.MFFGKFDBaDHBDDBE..VBFEFHAG...hAAAIBBARDBBBDEAdAGFhAEASEAFABDC.fHGHhAAA.JGEE......hABA......hACA...,1,-20,-41,21
TgLbHcDEOfFYBMNQIWeGZPUVAXCdRSaJK,CEABSBECKECA.LDADHDGDEACGFFCEBHHGQCBG.hAAAeFFEPGAEADHBdHCFaCEHhABAJAAC....gAFFhAEADCFBOBHFMFGDIHAB..hADAWHBA....hAFA...,2,-36,-12,24
EYdFgcbUafCLROJAZXIDSKMHWQVeBPTGN,ZBCHXEGFDAGDKHCAHAFE..QFEHBADFTFEB.EBBBFFAGhAAA...bCEEaFDBCCACLFHFhABAOBEHIFAEhAAAMBIF.eBAD.NIDBdHADcFBEfCGHhABAAEAC....hACA...,2,-20,-8,12
UQKHLZXOYdCIbGRFfcNgDAVSBTPEWMJea,BBGFTGCAEDDB..JGFCaBAB..UDCHQEBCLAAAZGAG.hABAOAEBCBFEGBGERGECFEGChAAA..fCAEhACA.NIEH.DAGCAAIBSGABMBIB.eAEDhAFAKCBC.....hABA...,2,-22,-6,16
AMcZRdFIVEJNfbaXUCHLSGeWDgOTPKQBY,MDIDZFFFFCGB..VBBFJAAH.......NBFA.bDCBUGBDLADChABAeCGH..DBEDOHBAhACAKHFCBAGGAEBGdFHGEDADhAAAaEEH..CFGASABE...hAHA.WCCE...hAEA...,2,-31,-25,6
XeVYFQCdTIPDENHSLKBMJgRGcbaZUAfOW,OHCEXECC..eBFHFGABdAFE..IFADDGDAEBACHGEGhAAALABCMDAEJAHBRDEE.GBCAhAAAaHCC.UEGBAFIH.hABAfGHE.WECD....hAFA......hAGA...,2,-23,-17,6
JEeDdQIUfcXgTGKHRYWCLZAMOBaPSFVNb,MCACaFEE.FCEC..VDCD..JFBAeBBGQFFHUAGG..hAAAXGBGTBGCKEHBhABAHAEH.RCAFCEHEAADFBGBGhACASFHDNIBD.DAADIAEC.fEEHhAGA...hABA...,2,-26,-18,8
JTXAPBWFdGZQHgIORaEYcefNUKVDMLCbS,BFBDFFBDdADAZABDHDBCODHFEFHB...eBEBUAAD.DGGBCHFF...hAAAJAFAAGFAGDDA.hABAQAGDIHDBaEGAhAIAfDCCKBFDMEFHbGAC...SDGFhABA...hBDA...,1,-17,-24,7
DRYNWSKHQOVPaAUBJCMdXIfEbgcLTGZFe,UCCGJGCA.CEGE.dGFE....XBFHICHE..EAGE..hAAAbEAHLFCCGDDBeAEAhAAADEBBNEIA.KBCHOHCChABAaBAHAHHCBECDMEADfADH.TGFFhACA....hADA...,2,-29,-23,6
VPEBUGMYgWIDcARaeJTXZLNQKSFbCfOdH,aAEAeAEB...TBAFLFCG.KAHFbBGHODCA.dCAAHDBEhAAAECHHBABEMGBCWFADhABADIAGAFHB.RGFCZEFC..hACAQGFHSADDCBFGfECBhAAA......hADA...,2,-33,4,37
FIPWVHNcTYRbQGaUgDLZfXKBeSAOJMdCE,MFBEdDAHCFHE.FABE....IFBCVAFDHGFG..TGEBhAAAbDED.GABFUCCGDAABhABAfDDFKDGBBAEFeHBGhABAAIBA...EDFFWAHBNAHA.....hACA...cGGAhAEA...,1,-17,-27,10
aNCgKFSREcHIbBfOULYdAQVZGMJXTPDWe,QCBBVACD.MAFCTEGF.DEFFeFGB.CCFBKHDGFHCAREAFHECGhAAABAHEUACBLABDhAAAAFHGJFBH.XAFChAEA.aCGBNDACEDEE..IFDC..hAGA.fGGGhBAA...,1,-9,-24,15
HeMdgSQcFLGXJRAWKIaZVfNPEObTDBYUC,KDDBZBBC..VFBC..fCCF.EFBHbEEHBDFECAGCMCAFhAAASFGD.QBAFhAAALEBCJABChAEAAHDDaAFCNBHG.OCHHDGGA.YFEB..hABA.eEAF...hAFA...,1,-15,-27,12
TgJAVeMaPFbcKQfYHULNORCEXWSBIDdZG,MCEGFEDGKDBB..QCCHHDGHUAEFLCABRGDG.CHEGEGEEXABHhAAABAAD..DAEAdHADhABATEFHAFFC.aAGE.hADA...cGGDfDHGOFACIHAChABA....hACA...,2,-34,-19,15
GFcERYaBKZQVLUTIOdNDMgbHJXeSCAWPf,...fBGCFHDAEEBBRADABAHDZFBHLHEC.TDDBICCEhAAAdABCMADBHDEEeBAFhABAAAEFPFFE..cGGFhACAKFAF.QGAH....hADAOAEDDFGC...hAEA...,2,-20,-8,12
beNdcPIXCfTBGMUVKZFDaYRQESAWHOLJg,HABBJBHH.eBEBdEBD...IHAAXBCBCDDCBAGDGGAFMFFGhAAAKBBFFCEADBAF..RGDGECGDhABAAFHCLGFA..hAAAbEACNAEB...cGGEfEED..hABA......hACA...,1,-8,-30,22
BWNfbRYDQUEJIcSVLTaZegMHXdPCAOFKG,OHFAKGCHBDBE....fHCHRFEAQBGEEDBH..IEDEhAAAVACFLHEAhAAAZBDGMAFAdEDBCBCCGCGAhABA.NEAGDBBHcAFBaACA.eEAF..HFBEhBAAACAC......hBFA...,1,-3,-18,15
adDJIWBbGFZUfXCTMYROHAeEVPgKSNcLQ,EACEVAABKCGC....SECGLDFFdBACJDGB.BFCAGADEhAAAZFABXGFEMBIBOHBAhACAeCCC..gAFEhADANEIA.aFHDDEEHbFEDFAFE..CHAG..hAAA......hABA...,2,-23,-3,20
dDgUBRJNKGTeSYPVbIXCZEaHLWQcOfFMA,dFBCDIEEBACCREFEKCAG.GDDA..TBEFeBEB...SABBhAAAPEAB..IBAGhAAACAGHZDAGEGHF.LHDEhADAQGBHfEDAAHFGJDGBNCIA..YCCDhABAXCGA...hAEA..aGAH,1,-8,-32,24
fgeWHcCOYPVJXIQKDGFMUaTAdRSBELZNb,RDCHSBECLEFGZACC....NIEB.fAGBeFAEHFEEOBGHhAAAPCDB.JCHHQGGChABAGAAGFHBAaHCEhADAAAHAEEFEbEAF..WBBG..CGHA....hAEA......hAFA...,2,-16,-2,14
ZLIKUeFWQAcSfCMTPYGJgdNXRBHEVaODb,SCADCEBA.MDIBTAAC.GDEEJDFDdFDCRAFHBCDCHAGDaGGChAAAODHDZFADKDDCeFADhAAAQABBAHGD.hACAfBDHYEDF.NICH.EADCDFAFIDADhADA.WHCG.cGGFhAHA.,1,1,-29,30
PAVaBCLISMGYEbfZWKQXOJcdRHNDUFegT,BDDGLFADSCCFMBACGBDG.EGCGZFGF.KAEDQFGFhAAAXCFG.JCHBdGBHNACD.hABADABHFDCHeCAB.PFFBhAAAABHHaFFHCGBD..IAHD...hAHA......hAIA...,2,-28,-8,20
ENWCaTFgXQIBYJfKMASdbeZHGDLOUPRcV,SEDAeACHZDFEDHGAOEAH..UBFGRACBEFGBCBHA..FGAEQCEHhAAABDDG.JHCEKBAFhAAAMBIBAFCE.dBAG..hABA.bEBF..........hACA......hAEA...,1,-14,-53,39
FRXAgNeVJLbZCSIPMdEWYOfDUcKGHTQBa,eADAJADAZCDCCHHE....SHBAMBBFdFFG.EECC..OHAAhAAADDGGUCABKEHDHDBBBGEHFBGAhAAAAHHG...gEGAhABANBAC.bEAH..WAGB..cEDDhACA....hADA...,1,-29,-31,2
GCgJcNRWaVeBbXMQPYDHOIUAdZFLESfKT,dFDBFAFHEBDHSEGB.KCGECDBD..JGDARCDC....aEBDVDFChAAABBDD.MBBFQGABhABADAGAHGFAOHCChACAADIHLHBC.fADDgGGHNBAE.eABAhAGA.....hAAA...,2,-23,-19,4
aKXUHQGOVZfbBTERFDALgYJdeMcSCWNIP,LCACJHBC.eECBMDCACGEF.....IGFHaHGGKAEFUAGBhAAAGAADZEECBAFGECGF.hABADFIBABBC.dCFA.SECFhAAAPHAC.XEEC.ODAHhABAfFAD...hADA...,1,-20,-37,17
dDQcBAeZVbPgCGOSJHXYUTNMWfKEIaRFL,VEGF..bECACDEG.GAGC.OCBAJEBDHAGD.UACDNEGGMIBChAAAKGEA...aDEGLAABhADADDAGBGBHAICCeAFDhAGAgEAF.SAEBYDDF.WDHHhABA.IHHAhACA...,1,-19,-23,4
aUcTALPBSGYERdWfKMQbgCFOJDNIHZVeX,BCCBSGCDGGDFRDDE.dDGEKCBBQFBC.CEED.OAFGhAAADAFEHADEeHEEUBAGcFGHhABAAACG...LCAFhACAEAHFMDIDgBED.NBHE...hADA......hAEA...,1,-16,-21,5
DIfFJARPTaVCEGWKQLZegSHXMcdNBUYOb,RAEDaDFFEGDAGBCD.KBACLEFG.eACFHEGBMIAEdADFBCHDhAAAOGAADBGEFDCEAIFGPCAHhABATGGB..CEAC.ZEEHhACASAAHXGABNDDCYAHH..hAAA......hACA...,2,-17,-4,13
LadbUgYGPEDZWcBSfHOCFXRQVMJTKANeI,eDFHLCFEdEAGUDBGGCBE.EFEFDHDAZAEGBADE.HEGBFGABQGGEhAAAMCCE.KDFGhABAAAIDaBAG....hAAAYACE..cGADOHDECEDB..hAGA......hAIA...,2,-29,-14,15
YARSbIXgDLJPWaZEKQTfNCdHVeBOMFGUc,SDFBXADHDFACLEBC.JABGaFFDZBGHEDEA..TFCHhAAACDBAdHBBHDGD.BHHGhAAAOFEDFACBUAGDhABAYBCGAFFH..bFBAIHHC.gGAGhABA.WAFEhBAA...,2,-34,-10,24
ZNVBGLMJabgXfdcPHeCQTKDUORIEAYWFS,FBBGSECBZDFBBFHFMBED..aBFGXEGB..fGAGhAAAdDAEHGDACAHCKECFDFCDhAAARCDB.AACG...NIEB.LBAAhABA.gBGAcDAG..eHCChABA.....hAEA...,2,-29,-25,4
RdEHMAPQFXYgILCOeUGNfTDVWJbcZKaSB,FBAHXAGD..IAHCODFHGABD..NIEHDHGAJGAE.hAAAZGCEaDDHBECGRCABEGDHABGB.hAAA..QGGChABALDDACAEGfHEH..TEGFhABA.WFAH.KBBCSAEEhACA,2,-45,-1,44
gbAFDNKTPLRZSeIdUQWCMcBOGEHVXfJYa,DAGEKCADLFCBRBBFZCFB.eBBEdGGFUGBF..QEFGhAAA.CGAFMABCBDDCGADHhAAAHBFAfFHAhAFAJFEF.aCCHAABHFEABNIED..SDDBhAGA......hAHA...,2,-37,-12,25
EgHIZCLecDaJNbQYXdAPWGBSfVURMKOFT,GBDGBEECSCDEUEADKAHB.FFBD..TABFHFFACCBD.eAAAhAAAaHCE...JHDANCHC.QDGEhABAdGBH.ADDH.hAEAWAAFVAFC.MIAAEGFG...IHHDhAFA.....hADA...,2,-32,-3,29
aRUWNPQfXLeTYVBbMZdgCSHJEAKcIGDFO,KDGGGDEGDCBE.FDBBRCEH.UAGC......NGAB.fACAhAAALAAFeGFCTFCGBAHEhACAMCAFdEBHCGHGSGBDhABAJHBC.AIDAIEHDaAEB...hADA.WHFA...hACA...,2,-31,-29,2
ZcCKeVMSFNDREagdWPITXUHLfBAbOGQJY,GBBCJAEDZFDH.CFHHKCGD..MCBBFFEF.DAIFRAEC....EEAHaAGFdHEHhAAA....IFGEhAAAXACBHABHBHAFhABAAHHHOEAH.QGBHcDGE.eDDAhABASECH.hADA...,1,-25,-28,3
aMAOcNUHgKRQJWTPEBGXfeIdCYVFbZSDL,OCBDUDFCKCCERAAC...QFAEJEHH..TAFDBACBXGGFhAAAeEFB.CEHE.FHDGhAAAZAFADADGLEEFhABAMDEFABIF...NEDG.WDFEECBD.....fBDAhABA.dHADhAHA...,2,-29,-20,9
eVCGFNYZcWOEDAQJHBfPbLagSIdTXKMUR,JCDCHCBCBGBF..fCEBLEBC.SGEHdABGKHFE.UGAAhAAAeDHBCGGAGAEHhABA.FCHBNAEBZFEE.OACChAAAAHIDQEEH.aEAGIHCAhBAA..TABA.hBGA...,2,-35,3,38
TENBSWORCQKeUDPFIXgMdVYLAHabZGfJc,aAFHGGAF.JFEGTECHBEBF...OAACQADDKCAADGFBFAGDhAAA....IEHChAAAMDDGdHGFLAHFhACAbABB.fGGAEECANAIC.SEAFhADACDGA.eGBG.XCEChAEA,1,-14,-26,12
KFaSbICeMYAWgdODUVLQcXPGEHZJRfNTB,dDAHOGBEUCFDLDFD.QBGAPAFCHGEEZGFERAAHTABChAAABAECFDDH.SEGBhAAACEFHeFAFACIDDIGG.hACAXGCDEBEAfDAEaEDF.MIAE.hABAWCCF....hADA...,1,-10,-12,2
SAcXWfZbDGUPONMBQVgETJIHeKCaRYdFL,XECFZEEDDDIFUAGE..OFEBBCDG.QGBH.EBFDhAAAIHHBKFHDRACDFEADAADD.hAAA....fAHGhABAGBAGMIBEgCACJAEFeEGHCFFE.dGBDhABA......hACA...,1,-10,-32,22
AKeENdVDMSCBOYLJURPTXQfcIbgZFaGWH,eGFAdBDBDEGBCBDE.BHHDLFAD..UEAETCEFQEDAhAAA..fHBDhAAA.IFFChABAZCACaDGAHGBCACACNCCCMDDBSAFBOADARBGDXABFhAEA....hAHA...,1,-7,-34,27
CJbgcOXFYAfTHBdNSMUGWKREDLaQZVIeP,HEBDBBAASDAHMDEFUACDKDGFRDGH.LHDCQGCBZAGHeAADhABACGAD...JFAFbCDHhAAA.OAEE.XCFBhABAADDFTFGENADEEGGDDAIB......hACA......hAEA...,1,-9,-22,13
YBJUIEdWNgSCcfaAMXGPFZbOHKeLVDRQT,XDADGAFCFBCGZCDEHCDHLBAADGIBQFEEBCHGUGGAEDAEdGBBhAAA....gFBGhAAACAGBaEEBAFFD.MIBAhABA.OFAHKAEA.eEHF.....hABA......hACA...,2,-30,3,33
GXNDMJLYAVHFURKCbTOSfZdEgQaBWPIec,FEDAKGECCAACOACH.ZBFHdDEF.EDBG..aHGGBHAA..IFGGhAAAeEHFGACD.hABADAFAMIAALCAEhACAYAHFACGEUFCA..bFCGSGHHhADA..fBEEhADAWAHH.cEAB,1,-26,-29,3
fDdYTFAKPWeOJbXNSaBVERCUIQMHGcZgL,KEFGeBHHOBEA..XEEG.SFCHBAAAEGHDUFAHhAAAIAABQCCEhACAHAFDGGEHZFCBfDAGhADADEBFTCBFFHECAAHEJADHNAIE.aCFH..CHAA.hAEAMCAF....hACA...,2,-15,-10,5
ZDbJYeHOEdGBCcaXWRSNLKTFgIUVfMQPA,ZBDADFFA.JFAEeDBF.OADHEFEG..BHFFaGGH.RAAD.LGAGhAAA.KCGCFEHH.IAHBhAAAfAFA.QEDAhABAAAEE.YEHBdDDFCHDE.WCAFhACA.SDEEhAEA.NIBF..,2,-42,-28,14
efCOASJGIRVgZXcbQKFHETdPDMYWBaNUL,SEDDJDCFGEAA.RBFFZGAA..XFEAQADDFACHHAEFhAAAEFGAdCBGDHDA..MEFHhAAA.BABFNDIAeAHHfFADhADACEEGAABD.IHHA....hAFA......hAGA...,2,-22,-19,3
GFJeDaMPdBKIgbCTHfAVcEWXLSYRNUQOZ,EBFAXDFHLCEGRBEH.UFGEZDAE.GAAFJFHD.DEAD..aACEMEEHhAAAdGBBBCHCKFBE..hAAAIHACCCAG.fDABhABAAHEG..WHAGSGEHhADA......hAEA...,1,-23,-37,14
NEBHDMAIURKLZGYdCSQTOXfcegJVbFWPa,UECDKACFLDCEZDADGAAHdBHG..CBFB.QDGC.OFFBhAAAfHFF.eAADhABAJAECFHAEaEEEBGABhADADHGCAIGG.RECB..SADH.XFGEhAFA.cGDD.hABA...,2,-29,-15,14
DLdMBgOFKcYVZHNEGIQJXTWeAbfaSURCP,aFFFUBAD.RDCH.DHBCdFFCBBGC..OAFDFCCDKFCA....VFAHhAAAZAEBEBBCGEGE.hAAAQBDETEAGAHEA.hABASHCACCAD.MAIFYEFC.hABANIDF......hACA...,2,-33,-18,15
fEJYSWcLNMeTHVUKXZGFQDBdgIROAaPCb,aBCFCFAC..EDCB..SBGELFEEMHEETFDGHAEC.KDGGhAAAGDAFDACAdHAFIDHGhAAAABCD.fGABhABAJBDF.cFFANIDHeBAFXADB.hABA..FCAGBCFGOBFHhACA..,1,-2,-19,17
gNKJLGVYaHZPQCWcRdbfAUSMOBeIEXDTF,MIFEBFDDeCCF.EAEEXDFA.DEDHTAAGFAEB.KGHDLCBBhAAAGDEEVGAChAAAaDABZGBCCBED.RFFGdABH.ABIHSHAGhACAIEHFNCAG.JAGB.....hACA......hADA...,1,-8,-22,14
ZbRgeSBVJXDIPQLfAOaGMHCcFUETKWNdY,GADCCDHFUFGB.KDFC.dFEAZFBCRFAA...eBBBSABGBADH..hAAAJAFBDBIH.QAFEhACAAAHD.aDAAMICAhAAAFGHH.ECAB..NIAD...gDDDhABAXEGE......hACA...,1,-9,-44,35
IgVLPGHDSMQTcdXUEaNFCAebJYBKZWfRO,eACDJBDABDEHKFEHZECD..REAE.OAAF..IFFGLAGBhAAAHAABDDABMDIB.hAAATGGFdHGDEAHF.aGAFhACACFBFAEHF...bBEFfDGH..hADA...gGDDhAEA.,1,-18,-36,18
ZcAMVHDNOFUWPKJfRGTdQgXLIESbYCaeB,HDFGDAHBFDHBUDBD.KADGJFBCGFDF.dBGFQBDFLHACEBAChAAA..SGAHhAAACHHDBCFDACCE.MADG.hABAOFHF.PBBB.RGEC..XDEEhABA....hACA...,1,-18,-34,16
VcORSLFEZJAQgTWIKYedbGUBNfXHPCDaM,QEAETCGG.KDDDeBDDdHCFGFEHUFAGBCAF..XBAGhAAAPFFB.CDGHMCFDhABA..cGCDOHFEhACASAEFEAGBAIAEWAHBbBBH.NEIE..fEFBhAAADAEBaBBA...hADA...,1,-13,-14,1
eFTcbBGPAYKXfWEJMHLZUSgaORVQDCINd,KBDGXBCFEGHB.HGCEUGCD..aDAARDAADABCCFCC..dDEAFBGHTBGHhAAABGFE.GEGG.hAAAPFADAAHA.fAEDhABAMEEGSBHB...OFAHhAEA.IBBEhAFA.NFDB..,2,-41,0,41
UEVMKXdQSYTHWRFJGBbDNIfOcCaZPeALg,LABCEBBDKFEE.dCBFQAEBSGDDHBGHFHGE.BGGBDAAF.IDDHhAAAOCFFCEEGaDAHZFADhAFAAIBE....gGDEhABAMAHHXEGD......hAGA......hAIA...,2,-28,-20,8
YQKFTMgOZeBAHSEXbRILWUGVCDJcafdNP,EDBCXAEBRFBD.LCGFGEDHCBDF.DBFEJFEH...aEBDdDGB.hAAA..NBAC.QBBBhABAFGGD.MEIFOAAAhAEABDEGAIAGSAHBIHACWCAD.cGGHhACA.fAGHhADA.,1,-25,-32,7
DZAPaYGNBTcgWSbLQfRUeFEJHXKVOMCId,aBAEGBBFBHCE..TFFG..gEFGSCGCQEBHhAAAfEDDUAGAhABAEEADXDFAVBDDODABhACACHAGDIEEAHHC.NHBHcDAF.LACChAAA..FGEHKAGE.MDIBhABA.IHHB,2,-24,11,35
YbJFOIBCLEegVNXdSacPHWUAKTZGMDQfR,ZEFAGABBMGCEDGEHRBDE...JDHHFFAHBFFGLBBH..eFCHhAAA..gGEAhAAAXAGHaFAE.HGFGhABAAIBCKCHFTCDHfDDAOCABCACEEBAB.NAEBSHGAhABA.hACAWBFE.,2,-26,-12,14
XGLVZfDBCUaTPbQNcdFYSWJKgAHReIMOE,eEAAOCAFGBDFLFFEZFGHBGBFCECH.UGDEaAAE...TAADhAAAQBGE.NIEDFAFBhAAASCHH.hABAWDACKGDDAEGE.IGGFEDFFfACDhAEADDCGcACDdHAD....hADA...,1,-5,-32,27
eCSLTOFfAQKdJBYcIDPVbaXMNWZERgHGU,dHFBJABABHCA....YDFEDFGD..VCCAaBCFXEBChAAA..MEIBhAAANEICZEEGECGE..HAEEhABAeFBACHCDSDAELHEGFAFEABIFcGCFhACAIEADWEAD...hAEA...,1,-5,-40,35
DbGdYaZMCfOXeJAVTPEFUNSgHWQLIBcRK,TEAGFCGEUAAC..SECBHAEGQFECLCHBBHAFKBBCDAEFhAAAGFADdGGAaGBDCCEEOEAGhADAJFED..AAHAECDBhABANIBD....IHHC...cCDHhAEA....hAFA...,1,-20,-21,1
TXdCWagBYAMSbZfPFRVGOQHDLeJUNKIEc,SBDEZFFBFABDRECF.OCGBHAEHDEAB.LHBAeHAEUEDDKDBF.hAAAEGHF...TCDDhAAACAHBaADB.BHFD.MBBFhABAfBGAPAFGQEABJFHB.hABAIEHEXEEBWACFhAEAADDA..,1,-4,-22,18
DPeHBdfQIaSNXYbGTMAZJCcKLRUVFgOWE,JADD..CEEEKDBFLBGHUACA.FEEC..OHBCEAAE..DGDFeBHFhAAAdCAC..QGAFhACAIGFB.aAFBSEGAhABAXGGF.bCDA....MCIHABBGRAEA.hAFA......hAHAWCCDBHGA,2,-33,-26,7
cZNYIgOaMBRDUHXFLdefAVTCKPWEQSJGb,CBEGKCGG.EECCSBCB.GCFCZBEFIDAGaFDA.MAFEhAAABHHC.DHACHFFALAABhACAdABEAGCG.TAGDhADAPHBEQEAG.JHDE.NCIE.OHFEhADA.....hAEA...,1,-17,-19,2
eBYVWFXgaGLJDbUEQROHAMcNTSCIZPdKf,MCBBTBFH..SDEACEBGZDEG.KGFEBGFC...VABBhAAAWABGFHAG..aHDALAFChABADIBG.EHGGODDHhAAAAFIH.NCEDIAHCdECE...fGABhACA.YADChBAA,2,-34,-31,3
TegRVBEfOKWFCQALNIDZMPcSdYbXJHUGa,LGBGDEBHMFHF.SHFCdDFA..XECDUBFCaBBHeCHBhAAAREFCBBED..fBAEhABAOEDGKACFCAEEAGGDNIAH.hAAAZGCE...PCCAcDAH....hABA......hADA...,2,-27,-26,1
WLUPGBYNaOXVSAbIJERHfMQDdKFegcTCZ,JDDCHDEG.QAGDKHAE.FEAAeCFETFDACACDLAAFGAAFBCDHhAAA.aAFBOEHFhADASFHBAFFHEEAAMHEChAEA..dHDHgAEC...hABA.cGGC..hADA...,2,-32,-8,24
QFSNCPaEDMgYbBeLfWKVIAJZOcdHXRUGT,OFHBHADDUDAEGBDHQFEBFDFE.CGAB.aEDFDCGG..MABAhAAA....gABDhAAABGFHeFACWDDGhADAKBBCAAFG.JHBEdDHC.RFCBNIEHEAHB.....hAFA......hAGA...,2,-20,-17,3
MIVNaBGRcSWCgHQdJDALKPfeFXTOZEYbU,LFAHKAEGeABAFDDCOHDC.ZADFEFDHUCBG..MCFA.VGEGhAAAaDHFBGFE..hAAARCABSGADhABACEGGQAGADDIFAGDD.XDFB.....hABA......hACA...,2,-34,-15,19
ULCWJFaOXgIbQAEKPDMNfGcHRZYTSdeBV,KBFFMBCCGGBDREFE.ZDCASHCCBDADUFGALCEA.CCCCFFAAhAAAaCGD..OBAChAAAICACABDG..EAHBDGIBhABA.fAGD....cFABhABAYDDF.eHEAhACA...,1,-31,-32,1
YPVdNTSbWOcRfIAKJLMgQCHEFBGaXDeUZ,KAEDLEDEQDGBEACGFCHFGDCC.aCBFeBEA.ZGDGVFAHhAAATEAA..SAFEhABAOBAC.fHGHhACAAIGE.JHDEgGAGCDAHXABEDDDChAAAPFEENAEF...hABA...,1,1,-23,24
GDQSZUdObgIcfMVPJBANFLRHeCXWaKEYT,FDEFLFAHHAAFeGFCCABH..XGCHKHBGEAEAGDCCDFDGZDECdCDFhAAAOCGF..gBAGhABAIEAGMAIFhAAAJAGBAIGE.....NIEDaADHYADE.SFGGhAIA..hBFA...,1,-3,-29,26
WBARKIYCbeSOVZMTFQDdfENLgGUacJXHP,KCCBCDCG.eDADOFEAZDFB.FAGBDAGB..dDGBEHFCLBBC.UFAHhAAAJACEHFDBBHGFAFDDIBHBhAAA..SDABhABAMFCD.fHCHNABCaCED..hACA...cCCFhADA...,1,-19,-43,24
ICGbAFLaXeODcKNHJESMPBVgdTQUYRZWf,LAFHaAHH.XGGADAEBKDGAHFBH.JCDFEABG.MIAEBHFFhAAAdFCFQFGBhABARDAHZDECIBHGCCBA.ADABeHDGhAAAOAFBSCCC..PDAHhACA.....gGDFhADA,1,-18,-21,3
OdLIHPJXFMWbCRNfQBYeTUZDEgSGaKcVA,LABHHCAAJHCAFFAFMCHD...CGBFRECDQFEFBAFH.TACChAAAUGGDDCEG.EDDGSGHDhABA.aCFDhACAKADCACFF.OAAH.IAHBWAHHfAEDhAGA...hBBA...,2,-38,-17,21
TLeSPDOXGHKbVFEJdYcBRIaMACUNWQgZf,UCFHQGDGZDABLHAAeBHHDGGEGEFGKBCF.FEDFEBEB.dDAEBADEhAAAREEA.MFIBAGABCACB..hABA...NCAH.WFBHhAAATAFA..SDDG.PAEGhABA.....hACA...,2,-24,-17,7
RYOPTZgXESBHbJeLVcUDIaKFAWNfCGMdQ,...fECHGDBCMABCQDGAOEFDTBECXCBFBEEEhAAAHFCCJDHDeBDELHAAhAFAcAFADBDDIABEhAAAKAGHAHHECBBF.dGHA.PEAFgGDBSFFBhADA....hAEA...,2,-11,-2,9
YdHKVWTEXCbeJNPGZgROIQUcASLDFBaMf,DAGDFHBCBHFBMICG.dCABKEGA....TEFECBAF..JCCA.GFBBhAAAZDBEOAFE.hABAUCFHAHACSDBHhACALFAAaABG.fBDAYDADHGEChADA.ECHB..eEHHhAAA...,1,-25,-28,3
XLZCIVGdgAHWDPQNFBcKOUJfEYSRbMTea,HFABDGHHQFCBFFHBBDDBKEFHUCEH..EACDSDBC.hAAAMBFAaEAAXGDChABAZBAGCCHA.VAGHdAAHAGGB.hADAPFAHNAFE.OFEDfBBG..hAEA......hAGA...,2,-22,-18,4
gfHeQXNcLGPZVWdJUBEKaTDOMRCbYFAIS,SCEBHBFAXEDFLFACZFBBdAADBHHDaHEC.OBAA.CBGFFGDEhAAAAEBCIAEF.hABAfCCHNIAHGEEFPADAhACAJDGDEAGEKFHB.DFFB...MDAFhABAYAHB...hADA...,2,-15,-8,7
QUHeJWZRaVPcOfSTDEKAdYNbXILBFMCgG,dEFA..bAFGXGAEBFDBFEADCACE..QAFDeDCEZGFCaCGE.hAAA.PFHF.OBBFhABAfHAHDFDHAAIDIHEDhAEAgABFGBDAJFFA..WAAFhAEA.cGCFEFAC..hAGA...,1,-8,-29,21
EQIVDbSMBLcKRAXNGCPZFHYfUdJgeWOaT,XGBDGDCFCBBAZAFBFGGC.HFAA..UFDCdHDFeDACOABHEADGQAGFhAAADGIH.SDGChACABFFELCHDhAAARDAAADDE..PFAH.fADFhADA......hAHA...,2,-20,-13,7
ENLKCMPfJGadXIHZbTUDSBQcRVYAeOgWF,eFCFODFGFBBHLACGKFHD.CHCF.MACC..JFHDdDEDHCCBTBGAhAAADDAHBBAH..hAAA.RFEDABIB.EBFAfGAAhABAaEAD.IHEH.ZFFF.SBFFhAGA.cDBEhAHA.,2,-37,-23,14
UJaSAYKNeGMDRIXZOdWFfTLcbBVCQPgHE,KGBBeEHBMCFBDGBHRDCDZACF..dBBAFDHBLCFCBAGC...CAHBQEAHhAAAHGDAEEAAJABFAIEG.hABA....NAAE.XGFBhACA.OADCTECC...cGGEhAEA....hAFA...,2,-33,-20,13
DGVYBILERKdeAcMFTZUPbgOJNQWSCaXHf,MBEDTBDAUFEB....PEFCOBABJFBFQBFFhAAA.CGACHDBDDBBHYEEFhAAABHDDLFHFhABARAGDdGHEAADB.ZDFE..NACGSGDDfHAH..hABA......hAEA...,1,-9,-27,18
GKgfObHDWceXZAVSaQBNTdCEJYRFMIPUL,SHFEQBFCBAHFdEFD.EEHBJBAAREAA.FFAE..MGEGUAFAGACChAAAKDAA.OBADhABADAAE..eCDFAGAFNIEBCEFF.hADA.IHBF.....LDHBhAEA.fGDGhAIAWHDC,2,-34,-28,6
TgHBZAYVMbaLIJedOfXWQNKFUcERGCSPD,VAGDMHDALFFC.eEBHfFADQBAEKAAHUGGHhAAARDDACHAD.DGDFHAGFAADCaCCBIBEAhAAA.ODABhABANDEEEDFB.SGGB..gGAGhACABCCE...bACAhAGA...,2,-27,4,31
NQJTRAGdIUacKSBLOXVHfgFMDZEePYCWb,dGBGUCFCKAGCBFADLACA..XABCVCFB.HFGHFCCFDGGFhAAA..ZADB.EFDCeFHDhABAPHBGCDAA.NBIE.TEDFhADAGDAB.aGFHSHCE..hAEA......hBAA...,2,-28,-9,19
eKBMGXYRgWTbLaECUfVDJZdcQOFPSHNIA,BFCCMDEAGECERFFG..TDGBLFFBCFAB.fAEChAAADDBAdBEH.OEHDFAAG.SABGhACA.IBGDhADAAHABKHBEXAGF.gEDHhADAaEADEGEF.....hAEA...,2,-37,-19,18
QYUWBORgdGaeIAMcZVXDfTENKLCSFPJbH,MDEDZFCEDAGH..TBEHKGHDLDAG.FAAHbDGB.HDACQCFBhABAUABBBGFCODHDhACAdHBBaAFA.IHHFhAAAABHGXFAF.EBDDCCADSAHHhACA......hAEA...,1,-13,-27,14
gCYUSBVJKFbEINRQfedGPLWHOcDZAaXTM,aBCAMFIF..CGHA.UEFHBCCCKDAA..EBHDRBFA..QBCChAAAeAABdDFHLFBGOEDHDIDChABAAEDG....gGDAhABASFBBFHAENACF.fAFC.hAHAPFFGHGEC.XDAGhACA.,2,-31,-15,16
cbLPRNgEaAVeSIZXOFGTQBKdYCHfMJWDU,VBDEeCCHZBEE.FFHDQBAHBDFC.KGFGCBBHHEFD.MBIHhAAADGBFUEAF.LFFEhAAANDBC.EDGCAIACSAFChABAXDDCOABGdHDH.fAHGhAFA.JHCC...hACA...,1,-6,-27,21
AJXYPRZOIVDbSUQaWNTMgGCFdKHLEecBf,JHBEXFDD.RBEE.OCEC.DFAGUFAB.aBHD..TGFGhAAAMDAECBBFKBGC.EACDBGHFhAAA.AEEAZFFD..hABAIAEASEBENFEH.gACHhACAdECAHBAH......hAFA...,2,-30,-26,4
HUITbDBKgNSOYWGcVaJXMPfEFdQZeCRAL,UEDGTDBHDDCB.BGAGKDDE....NBCF.OCGHGGAH.aEFBMCIFhAAA..EBGCFAFEdHFDhAAAeHDGAFACHBAE.gDGHhABASHGE...cADH.hACAJBAD.....hADAfCCBCGGF,2,-38,-9,29
YRdAGaSTMBPIeVFDbUZCKHEJQWNcfXLOg,SCFFTFDB.MGFEBHFC.eABHFBCEUEAFZFBHCBGFHADH.hAAAEDCBQDGFhABA.cGBCfFFBhAAALEDHOBHFYCAAAIGCaGAD.IAHHhACADAFC..KDAD..hABA.WEEE.,2,-12,-2,10
ZePIdFCLTHfGDgMJWKASBXROVNaUcQEbY,XEAAVCFF.UBAEEFAAZAEE..eHBGdCAACFHDHEGD.DDGEJABGhAAAAFEEBEDC.OAEAhAAAaEDCQCCDhABA..YBEAFHCG.TGEDgGGGhAFAKAHHSDDEhABANBIA...,2,-23,-9,14
UJCDBfdZeNMKGIASRWQTEFOHbVYacLPXg,SBGARDFHQFCEFCBBHAFA..VGAEaACFLFAD.hAAAXAACJDDH.DDDChABAdFFHNIEF.KCFF.AAFGTACFhABAOEAA..cFGDPHDCCHCG.BHHA.hAEA..fAGHhACA..,2,-24,-9,15
bDSKYaTZNHAJLFQEWROUVBgeGPCfdIcXM,LCDHFFCGEDAH.OEBFUBFABFHHGFDD.CBAB.dCCE..IBGEhAAAMBIHDHCG.KFFDaAFGhABA.ZCAAAADB..QAAFhABAWEAD.......gGADhAEAfHFF..hACA...,2,-34,-34,0
gDTMfVHQEAIKPSJOUaFCdNZeYRXcGBLWb,KCBDSCFBOFDH.FHGAdGFFZDCF..eCEHRABAGGAHBBHGLFBHhAAA..WEFAhAAADAECMIFCHAGHAFAHIABGhADAPCEH..JBAFCAHBXCCF.gEGEhBAA..hBDA...,2,-33,-9,24
NUbeODAFZBWfLIGYEgKSCdRMTcVHQaXPJ,FHGGZEECBDFGLDABGAGCEDEE.KBAD..SFFECEAB.dCCChAAATCBGHFBBXAFDhABAJAAA.UGDGbECH.hADADBCA.AAIH...IHHF.gGADhAEAMACC...hAHA...,1,-15,-29,14
HBXWNcUVTCPMeQZbfKGAdgYOJIFDSRELa,dHFFOGFEFEBFRDDFLBBE.BAHHXDGD..NGBBUDDDhAAACBDBMFAFZAFF..KAAFAHAHJDABhABADGIH...aHCGHGBChABA...cBGA...PCAChACA...bAEF.hACA...,1,-18,-34,16
daBEPMCcJZbXOFYLQgVITeSNHDGAWUfKR,UGGHKEADRCCEBFEFMBDF....JHACZACC.OCHHLABD.QCEEhAAA.VEAGhADATGGF.SGCDhAAADFGCADHBdAEF.EBAB.CAHA.cGDHXGDEhABAFEEH.IHAC.hAHA.NAIE..,1,-17,-34,17
GWJXLSHIcCdYDQTRMEKbaUAfeBPOZVgNF,BDDBOGDCZGEA..VBEDFBCBGEBF..JFAESAFChAAAHBAFIHBHdBHADEADTACFhAAAEGBF..aFGEAFGFfDDGhABA.eAFGPBADNEIEWFGHhACA..cCEF.hAEACBGG...,2,-22,-19,3
gHeSdOCAGfaVRFXbQYZEDWPKJBNTIMLUc,aDDEFCHHQGGHZAFC.DAEEKGAF.JHFCBCFA...IGEHhAAALDGH.UFCAhAAA.HBDEdDBAAGBCfABDhADAXADCEBACPBBHMICA.eEDACEAD.hAEA......hAGA...,1,-24,-27,3
JVEWQZaFSeDdKgNUHLABGTRYICcObXfPM,BDBBTFAGRAFA..CGGD.OADD..XACCMDHHEGGB.ZBADFHDChAAASFDGdGAH.hABAKEECNEEH.LAAChAFA.YHAGIFDBfAHA.hADAJAFDWFHBaCCHDIEE.hAEA...,2,-51,6,57
YSKQDEZgPULdNJcIMVTfCXAHeRFaBWGOb,HBCEeDDDRFBFaHBABHDCOHFC..SBABQEDDZFFDPCFFhAAAdAEFJCEG..IFHEhABAMDAD..fACEhAAACFADAADAFCBH.bEEFDBIF.EAEALAHBhABANAHE......hADA...,1,-1,-16,15
LETMSbDfdUQKRZegPFIBXGCcOAVYaNWHJ,aDEEHCBELDBDMAABDFFHUFDHKAGH..RDGDZFAFeACB.FAEBBBCBCGHB.hAAAADIB....VECDhABANIDH..EAGB.SBAGhABAfAEAdHAHQGGBIEHC..hACA......hADA...,1,-14,-22,8
YTcCNXMbWQeGFIUgDfEOPRdKJAVHLBaZS,VDECHCDGBABG.aGFFSGCE..TGCDCFHBMBCHQDAEhAAAFCABUAFGDIBEhAAAfEGH.OAFChACAPEADKADCADDALABEYFHB.cGGAhAIA.....hAHA...,1,-20,-25,5
QJVOPDWLbKTXgYfFCMRBIAZGNdaeUEcHS,GABGdBDCaEGE.eFAGUGEAHEGB.SDDEQFCEOHBChAAADACBLAFBKBDEXAGChABA.gGEGhADAFBHDRBABAAADNDAG.EEEB.........hABA......hADA...,1,11,-26,37
WafdcLQGbPHUMYJeTBZVDFEOKNRSgCXIA,aACFdBBGLEFDGFAFHAFBUGBD..MFGDJADCBEHEDEDCFCBF.ODHDhAAAKCGE..RDBC.CAHFAABBhAEA....fGGBhAAA.........hAFA......hBAA...,1,-27,-43,16
UJTLXPeHaDZfRQAMEYFcOKVNGgBSICbWd,MCDAEEDHFFEDKHEA.GDBCBGGF..CECC.dBHEUBAALFFC.eBAAhAAAHFADDFEFRAEEAAIFODEChABA..NIEB.IAEBhACAJCHF..XACBaHGA..fHADhADA..YDDChAAA,2,-27,-27,0
FRAKZSbfcEeWVHXGLYUBOdNaMgJTQCIDP,KAEFSDBF..fGGBEFFC.eEDDHBBCLDBEhAAAUFCFOAGBaAGDMBIDhABATDEFCACFDFGGPFHFhAAAAGABZFAH.WABE..XCFCBHAENICD...hAFA......hAHA...,2,-17,-16,1
IRPODUcVAgNMXZdSFBYbKEfGJQLTCWaeH,MICAdADGBBGCKEAFGABAQGGF.LGAECCGH..eEHBhAAARBAFDAABUFCHAAIB.NBEF.ZCEGhABA.FGEFEDFD..fEFDhACAJFFH.aAFB..IDDDhABAOHAE......hADA...,2,-28,-14,14
IeWNTaOSYBfLQMbXgUPAdCZKHRJGEVcDF,CDCHKECDHGFERBAHGGBB..ECHBDEFHeECA.TABAaAGB.SGABhAAABEGBLFADhAAAMFFGXGCEUGGEAAEFZACHhABAcAEA.IDADOAED...fAHEhABAgBGHJCDChADA...,1,-13,-15,2
JZOEFYLPVRKQHIdbSCGcgNMTaXWfUABeD,BGFCJBABZBFHOAAF.FGBFLEEH.REBHKCDGHDCB.bCEGCHGC.hAAAGADD...hABANEAG.MBIB.aAFAfEHChAAAACCB.DCCH.EGHF....hACA......hADA...,1,-21,-42,21
OBNIVLDSAbFGYECJdfMQPeZTXgWUKcHaR,FBGCGCBAECEE.CCAFdHCH..MIFCeBFCZDGD..XDGBUEBHKBAGhAAAaGADBEEG..NAEBLAAChBBADDADSBDFhABAAFEDJDFF.QGAF..gBDFhBCAWEHH.cFGDhCHA...,2,-26,-16,10
VHAPWQTbZCeKdMLUOBDENIYfXGRgcaJFS,QAACZBFHCGHH.eFEAMCBFLDCCBCDEDFCHEEAB...IBHChACAXAGFRGAAgADChADA.cDGAhAGAFDEDSBAC.AGGCWEADKECAdGHAhAHANIBH....fCCGhAAA,1,-6,-47,41
SQAgEHZDXIRbPBJCKMOGWedaNLcFfTVYU,EEDHZFAEDBDARBEA.BDEBKHAAGBAG.dHFHaCADLACEFGFD..hAAA.TFFBUCCEABHBXCGEhABA.IAHChAGAbFGB..JHAG.CAAF....OAFDhACAeEHBfCCBhBAA.SEBH,1,6,-45,51
eTDGfCBXINPWMHKScOaAbERgUQZYLJFVd,REEGQCFDLFAGFBAAeDBDGGCDBBCA..XFFE..hAAAIBEDPAFAMDDFhABASDCAOHCGADBF.hAAAEAEBgBFH.ZACD.YHAAhABAdEEDDIGANCICKHGAaCAB..hACA...,1,-6,-9,3
bcLWFOeDAHYSEPRUQTCadXKBfIgGZJVNM,HADFEHFEREBH.TFEB.dDDHXABAKFBEBCBC..IEAChAAAZBGFJHAG.MDGHLAAGhABAOCAEDIFCADHF.SCADhACAPHCCCEDE..fAHE...hAFA......hAGA...,1,-16,-22,6
UWbJKFSAPeHRCfaTcIXMgDLdEBZNVQGOY,eBAHHGEARADFCFCG...TABF..IBHAMAFEDCFGEGFHBGBAhAAAZGAAQEGFhAAAODAFUDFFJCEDFDDHADDBaAFF.hABA....XABB..dGDC.hAEANBIC......hAHA...,2,-28,-8,20
dNELDKUHRfbQFYOgWSXacICJPAZVTGMBe,TCFDGBCCMAAA.BGEBdCBHEGAHKBECUGAFHEEERECD.QAGAhAAAOCFF.SAFFhABAXGGE.IGHHhACACCBCJDHB.AEIHeADBDAEE.FHEA.....hAHA...YHDAhAIAaEAB..,1,4,-24,28
TVEXRSPYQgfbZCBacdeGLMIOWDFUJNKAH,TGFEEBBARDCA...SGEFQCGE...bGEGZAABBDAAhAAAaFBAeAEHLAFCIGBFhAAADHBAFFFEUAGB.hABAKCCHACDA.XEFE.gACChAHACFCGcBFGMIFEWDHB...hBAA...,2,-17,-9,8
CaRfGJUSBFKWOgATMdcPQEXeDVLZbYHIN,MAIFdBDGQEAC.EGFGeABF.LFACZDGHHCEFIFHChAAANHADRAFC.JAECBBBDhAAAFDDGKFFHOABGAEFATGDHhABA..XECHDADH..YCEChAHA.CHHG....hAFA...,2,-16,-10,6
DJXOMKGETNWSbgBFPcQfLIdCRUYaZHAeV,VDAAJEGF..MFAHKGEDGBGG..NADA.SEFDBAECFHBE.hAAAQGBALBBHCHEFhABARACFaGAH..ZBFCAGHE.hAAADDFBEAFA........WGBChACA......hAGA...,1,-13,-42,29
EZaOgXGNTBcFCSMfAdUHbYJLIKQeVPWRD,UAFGHFBEJBBAKCAC...eAAD..VEAHRBFFZEFC..OADBhAAAXDAGGEEDBHGHCGHG.hABAMIAEADHH.dBHELECHhACAIDDE..WHBADAGAaHEG...hAEA...NAIA...hBAA...,2,-29,-9,20
EXeKQLaJcNBTPZCOfAVYUGHdbgIWMSRDF,VDDHUDGHdCCF....IBBASACEFBHB.EGBFKGCBQGGEhAAALFBFaGFHJBAFBEEGhABAZACB..CAFBAHEDHAFGhAFA....gBEDMICADDDD.XGGBhAAA.NBAA..hAGA...,1,-17,-21,4
XRYNgSeLVKFHaDGUAJfdMQWOZTCPbIBEc,dEBDMEFGOCCCZFCC..CFAE...IAGEBHADEBEFRFEG....hAAANIDH.SBAEhABALAAGFAEBDACGAAGHQCGBhABAPDBC..XGGGYCAD.eEFGhACAKHBCHAGFaHCG...hAIA...,1,-14,-23,9
CcLWNSbfXgVEGTKPOFYedIBJaQUMZHRDA,CFGGLEEF.SCECXBDHEGDCKEBGFAAG..eDBGBHGChADAQDGFMEAFHDGFhAEAACADNICB..fHAHhAFAVAGHGEAEOBCFIBCCaGBA...hAGA......hAHA...,1,-13,-20,7
PMQbUZHEaJXIYGcdNKWSfFRAeDVgTLCOB,eDADDBHH..TFFFOAHHBBAAQDFHUDAA.EBCB.aGGEXDEBhAAAGFCFdBEHKAEFSAGFhABAFGAHABBHLDBAhAAACHEHMIAC.HDCD.IHHFNIEDWACE.hABAfEGB.hAGA...,1,0,-20,20
bDVNGBfQeUOTJXECIMaKcLWSYRFZdPgHA,VCABGDGA.BGDAQGBBeBCBUAGCOEEF..TEBBhAAAEHGECBBE.MBDG.aCACLCFGhAAA.SAGDhABAFEEFPFAHAACGDFAFNIBH.fEGEhAEA.IDDB.hABAWEHB.,2,-33,-8,25
YBWUSbeCXDLdTAGaPJFVHIQNgcKfEZORM,aDAHJFCBHBGH..QCGF..gDEEfFCEhAAAOBABMBAABHGFhABAUGGGeAFCCEEEDHAEdDDGAIDCGDAAhAAAFGEGIAGGKBBE.ZBCE....hACA......hADA...,2,-19,-13,6
VRPAeSaIJDgMYUCONZQfGdWTKEFBHbcXL,SEBFJCEE.DCHDMIAC.CFFFZBAAQGGC.dAFCKDBAhAAAECDHBDACHFDF.bAAEhAAALFAE.PHFChABAAICGIDFB.gCACODHDNHAD.hACAfGBC.hADAWFFE.,1,-29,-33,4
gYXFCNLJRAIWaTGESdQeOcMbHDBVUKZfP,aCCAGDEB.EHFGQGAFeBBH.MFGFbBFE.HDAHBADDKABDZFDDhAAA..PADCXGAGhABACDGBJFHHIECBhACA..SCFFcEAHDDDAfEEEhAAAFGGA.NAICACAF...hAEAWHCA.,2,-24,10,34
VJRacYbXeOKAGTCgfMWdESBQPDIUZLFHN,CHCDMBAHdDECBDBDDCHHZECF..LEGBHDABJBCGRBFC....aADF.hAAA.bFFG..XABGhAAAKAHBAAGC.GFBDhACAfHFHSFACPDDGIHAFFGBD.hABANEIG......hACA...,1,-21,-23,2
FfVRCEBJQLeWgSIAGadZTDNUPKcObXHMY,aFBHdEHEZFBA.DDCEUCFG.KADGOAHHHFFEMCAAFADE..RAAD.CABCBDAFhAAALHFE..hAAAeFDFSCFDhACAADEENAIC...bDAGfECAEGAB.WFADhADAIFFF...hAFA...,2,-33,-18,15
gHFQabXUMTJYOeEKZANVSIcdDRGfLBWCP,SHCEdBGGDECAGAADBFGG..CFAHHGAGFEEGaABCUGEF..TEBFhAAAJEFA..OAEGhAAAKBEGAGAC...ICDChABAfAHE.LCAE.WHFEhACA.gDGBhADA...,2,-41,-27,14
IHDQXBCEgAFNOKeJScPZaRLMTfUGdVbYW,ODCHJDEF..SDGDZBFAaDGF.LGAEMIAE..UACEhAAAVAAE...bAEFYFHBhABA.IFFBhAFADEBABGHA.CHEHACHANCBG.KHAAeDDG...hAAARFDDfAGHhAGAWDAC...,1,-21,-30,9
LCFHZbgDfXGVNKEYTAReQWScPBMIdOUJa,RDEBQDBG.SAHBBGBBIBHFdGHAOBEDJBAFLFAEhAAAFBGFZBACDAECGEGEhABAKGDDEHEAAAEB...eAAGhACAcGCEUEEHCCDG....bBBB...hADAgAEH.hBEA...,2,-19,-7,12
fdCBDcGAHTFgXbJKPSVIEeORWZaLUQNYM,TEEFXDDG.KGBCSBAC.EHCGOADCZDCH.aFGCUBFFhAAAQGDEMFHDCEBBBBDFhABADAHBABAFFCEAJEAF.IDAAhAAA.eBBBWAHBNAIE...fHEDhACAcGAC...hABA...,1,-15,-30,15
OeQBEWdDLKYGbAZfVCPNMXcIFSHRgaTUJ,VDDHCADD..MFIB..IHCFFEEEHCAARFAA.aFDCUACE.OGFAhAAABHCCEBBG.DHEEhAAAKAHDGBGEABEAZBAF.fFBAhABANIEB.SAFH..hACA......hAEA...,2,-25,-25,0
aWSPTDNdLBQgKEMRbXIVZOGHeUCcFJfYA,SDCGTEDF.DFHFLCBGBCGCKFEFRCFGXGEA.ZFADhAAAGACDeAFGCADBJDFFAEIF.hABAaHBE...PGAAhAAANCAG...QBAGMICGIHHBhACAOHEC.....hAHA...,2,-27,-14,13
RaYXHZTIUGKdJgDQLCfASBPNFVMebOEcW,SABABEACFEEC.MEAHeACB..OCECEBFFRCGD...XEFAhAAATFAE.UECCdGEHDGIFhAAACHHHAIFC...NEDE.bGBChABA.aBFA..YAHHHCAA...IBAEhABA...hACA..KADC,1,-20,-21,1
gDPMSbOQKXZGYFRVIfTUBHCEaLJcedANW,...NDGC.gDAF.DFGHSCCDQAADZBECFAHHRDADfEHEhAAABGACCADBaGEFLDHBhAAAJFDHdADBAHHBMEFHhABAKDFDXFBD..YHAAIHHGhACA.HDCDEABHcAGAhAIA..,2,-15,-12,3
NSVPEGRdUQDIXJaTOWCgYebZKAcfLBFMH,LDEFBEFHFFBGHBAEVBBA.GCDC.dHEDUFAGDAGD.XAGChAAA.JHEEaDHHODFFhABACHBHeAEBZDACADIBMFAFhAAASEHD..EGGE.IBHFWACE.hAHA......hAIA...,2,-20,-15,5
egDMHaFKURbcEIXOPTVYNGLAdZJfSQWCB,JAAFQBFABADG.DAEGHEAHKHCG.REFC.EEFF..OHDG..hABAPEBBTDDCVBBBhAAA.GEGCdHADfAGEhACACABCMAIHFEDHcCEA...ICCBhAEANDAEAIFG.SHGAhAFA.,2,-32,-6,26
COXAKefLIEQBFRVHMZaPNGdUcWTSDYgJb,KGGELBBDEGAF.QGCGRDBEHFDBZFBHaHEEGBCB..dAFDUDGEhAAATDFBSAFEhABADCCCJFHHCCHAAADCeCAF.hAAA.BADA.MDED.NDAC.....hABA......hACA...,1,-3,-22,19
ZMCPgXLcWIVDSBKUHdFeJQRTabGYONAfE,ZCBEMCDGCHBH...XFBBLADG...IGHFSBBHhAAABCFCKEGEUGEAdGDCeFHFhABAREAA.aAGFGDEDhAAANEAHADDC.PAHF..WFFHDCBE.JACA..hAFA......hAIA...,1,-21,-24,3
XecRVGEgPJKSLQdUfCaHIBOMbFATYWDNZ,TCADDGBDZDAA..eBCCREACGDEA.EGCGJAAELBAEUFFG.aEGAhAAABDHG..MAIBhABAAHCE.NAEC.XAGAhAAA..gGAGKFEDSCFDdGGFCHHD..hAEA......hAFA...,1,9,-44,53
MBOAgXNbUfLZYEVJFGaDeWITRSQCPcdKH,XAGFUFDBLAFHZBED.EADGFCCB.DGCBeBCH...IGHEhAAATAABQGEGhAAA.CEDGdEACKCHFMCBFhABAAHIB.NICFfEFDYDHF...hACA......hADA...,2,-29,-24,5
NWJfCDSZQLXOeGcABVIPgYUbERaMHTFdK,BGHGVCBF...IGAD..YGAGEGEC..RFCFMBIDhAAATAEFKCBC.JAFECBCESGEBhAAA.hABAQAGGLECEOCAHeEHBAEFAgGGDhABAaCGH.FEAHdBDEhACA..NIAB,2,-27,-25,2
aZITBNGgVWDCYPAKbSRJEdXLOQHcUefMF,KEEFRBBBEGDDdFBG.LBEEHGFEeBEHFDHBZABBBCGD.GEAC..hAAAVGFADEFACFFFAGAB.SADBhABA.OCABhACAcGCAMDID.aAHBIBAC..hAAA.TCED.WEAEhABA..,2,-29,-9,20
cHAGLPfKTNFYgaJVOeXBSRdIWEMbZUQCD,GCEFLAABKECETEGDFGBB...aFBDJCAD..OCEHBEGAdGGAhAAAEFAHZAFHCHCH.DIACHACChABAADCH...fFEChACANDDGVGEG.SAGEIACF.MEIHhADA......hAFA...,2,-29,-11,18
bGTDVRYJLdacOFIWBKCeNUEPHZQgfSXAM,MFCBTAGFDEEG..REAGLDEDdAAH.OAAAIADEBGABCDCC.hABAUDGD.HBBCQGFHhAFAfHDFXBEAhAGAAIGG.....bEFA...YAHHhBFAaAEGFGGC.KFDA.hAIA.EGCF.,2,-26,-10,16
eTEYFQcIOLDJUBRfZNVASGXKPMWgbdHaC,XDBGMDGF....bBFEdCFHHEBGaFEAeACDEAAGFCDC.QGABhACAODHFDAIDJHDCBADBhAAAZEGBAAFCGFBH.hADAWHBGCDBA...YHFALAEAfAFGhABASEEH..hAIA...,2,-15,-2,13
aBRVbDAcJIXSgYTMdCFUOGHNWePfQEKZL,JBCASHCG..TCGBdDABCFCEUGGHOBAHGEAG.HABAhAAAeGBGQDDEhABAKFGFaDDFRAFA.DFGAAGADXAAFhADAMAHHNAIG..fGDHLFHHBFDDhAEA.bFEDIAFAhADA...,1,-9,-13,4
gMRZACOdSFWaQcXeVYNTEfbKGHDLIJBUP,dBDCFDGEQGBAeAFD..NAIA.EEDBKDEBHFFHLCBFBBFGPABFhAAARGEEZGAA..AFIHCABFSAGGhABA.cFAGhADAXECH..YADB..hAFA......hAHA...,2,-27,-18,9
SOMTAGCBUaKdPNIcebfVWEJLDFHZgXYQR,BBCAKFBEdAAG..IAHEeFDH..VBDFJFFA..LEAAhAAADGFFHAGDZADH..XGADhACARGCESGAH.hADAMEFCADGFCGHCaFFF..NABG.fCBChAEAECGG.YCHB.hACA...,2,-32,-16,16
fZDaVGLIJSQCMNPBdUgFWXYOKAETHcRbe,TEBEHACCRGCAeEEC.ZDAAaDDELAHD.SFAHhAAACGHFPABEdBHCFHGC..XBBChABAKGDAEBEH..cGBChAAADFGCICFGMBADBCCC.gEFHhABA.OAFGADDE.hACA...,1,-7,-8,1
BFWQAKSHCGgTfdacJYZVIDLXMEOReNbPU,KEGCCEFAGBDG..fBEHaFAH..JHDEVFAGDAIBLAAGhABAMADC..ECCERFBBeCABhACA..bGFABHHAhAEAFAHHAFEGSCCDTCAGcGCDZDGD.OAAChAAA....hACA...,2,-24,-12,12
cWCXIfKGUVTHYSZFDMQBOaLNbARgPJdeE,RDCDJFAHeCFB..EFDBCAAH.....IFGAKDADUAGD.HFAFhAAASCBHFDHDDBCGBCCChACAaDEBLACG.hADAAHIDdCGBXGGG..fDHEhAAA......hABA...,1,-27,-43,16
ZYETeHQfgMVGCNdDUPSJBFWaXOLRcbAKI,KDGFZAGDEFFFeEBEHCCF.QFAEMIFECCDE.DBCCUGBC..JEHFhAAAFAFDXCACLAAHhACA.RFEGABHGTBEB.hADAfBAD.......hAEA......hAFA...,2,-33,-6,27
DeMbNSAKgRQJLHXBUaYCZEIFfPVGcTWOd,KFDHQFDBHBBEBDFFUGACCGHE.ZDBA.FCFB....PEADhAAAVGFGGAAF..hAAAcFFBOAEADCGE.hABAMIAASDADACAHJAECaABGICHB.hAHA.....WHEAhAIA.dFCC,2,-20,-19,1
IFXTDPcQOgNVZMWUSBdefRGHKCbLaJAEY,EGDGFAGGDEGB..QADAOEAA.VCBDZACFUGCHBCHBdAAA.hAAAeCGBRFGFKBFFLHAEhACA.AEEE.IBBHhABATFFB..PAFE.NEIC.MBIH.fEEEhAEA.CFAE.hAFA...,1,0,-39,39
EcSfVMHFGaAQUYJdBTegPXbWIDROKCLZN,QFBFJBDBBHFF.eFEF..XGGHIAFARCFG..OFBHhAAALAAD.ZCCAECAAhABAcAGE.SAEDhACAMFFGFAFCAEFEdGGGgFCDWHAGCBBCfDHEhADA...hACA...,1,-4,-37,33
dNUKACBaELFSZIceJPTMVDOGXWQbfYRgH,aGAAFGCAZCFD..eEDAJADF.MGFG.OADHGBAG.QGGEhAAA..YBHHhAAAgGAGHAEHdAFHhABAUBAEAIDGBHFDLHAGSDDAPHEADFCGhACA..XDGDhABA.fEABNAIE,1,1,-22,23
PZBKRWUSEcOXgefGJNFbIDaQdYMVHTCAL,LCBABHADKFFDRBAHSEEC.EACGXCEF.eDHFhAAAfGCFGEAHJAEEhABANEHCFCGA..DGEDdAFHMIFChACATEAD.AFFBWAAF..OACFhAEA.IBHAaGAH.hAEA...,2,-27,-20,7
fTUbZXKcMGONEBaDLPdJCegRIYQSVAWHF,HFDHFEDAUDAEZDCEXCGD..KGBDMADCGAAB.EEGHaCAFhAAADGEFLFHF.hAAAJCCGCHHCRAGBIGBGhABA.SFFBAGDH.fAGHhACAbAED.OBBG..hBAA..BFHA,1,-11,-32,21
WgTQNKJXRDZLaUIMYEfFeVHcdACBSGPOb,CHHAGDDF.OGFG..WBEBQBCGKGCG.XGBAhAAAZDBCaHFG.IBFDhABA.EAHBFABFeHFAcBGDhAAAAAFCBDAC.SEAHbACH..gFAAhAEA.NGEBDAFAhAIA.MFFC,2,-26,-16,10
KeYfEZIFLUMAcBbgTaJSQGVRCHPdXNOWD,BBBATFDASBGB.GDFGCGFHPDHBdFDAODAD.hAAAKDDEeFAC.YBCHhABAfFHAZBEBFHBAhACAUGABMAIHAECA.bADFaAEB......hAAA......hABA...,2,-28,-9,19
dfBUVSeIZQCFNMRKEgGbJcDHYaTLOWXAP,dGHAUGEHeBFEQCGBFACG.RABG.KBAHEEAAGCFC..JCDDDIBGhAAAHFACaDHF.OAEAhAAAAHFCBAHESFGEhABAZFCECCEF.MIAC..bEBC.....cCCHhABA....hAFA...,2,-25,-7,18
QVKHbJNLcXEBfYagMTICUZOSeFdRAWPGD,GAABQEFEKDCBHEEHJCAE.LCFE.EGGABHBD.YFAChAAAgGAHMAEEhABACDAHOAFCFCEC.ADGFDDHHhAAANBBB....fBGF.aHDChACA.IHHGSFAChABA..,1,-6,-40,34
CdQfTMUSRKPELeBHDJAgXbaYGVFZcNOWI,XGFFaACAGBFCFFCEZBAA...OHFCCDAEdBCB.QGABhAAAMBFGRCFF.EGGGBHCFDCIDJFEBhABAADIH....gFAFhAAAbDBC...YFHB.NACH.hABAWFCB..IDDFhAHA.,2,-38,-5,33
EPKFIgTfeGbNRQCDYOcMHadXUSWBJZLVA,EBGFFDFF....IAEFTGGAGCBD.RFCBCAHBOCFA.hAAAMIBCdABBSEFBhAEAJFFFLAAEAEBHgGABhAFAeDHFQBBHDEIFcAEEaECE.WFFDhBAABHAF.....hBCAPGBG.,1,-1,-20,19
fgaOVPIMAcbJQLWXFHNKGUDZYRECBdeTS,JFAHQDCALADAFAECHCDFKBHB.GABGZFEBREGF.BCGD.TFCFhAAASCBF.aHBAhAAAVFFF.MEIBAIGC.hABA.WDAD.XCFGDICGCBACfEADhABA..gACDhAGA.,1,-2,-29,27
OXRLGVNHFbPQTBKMWdIJUSEgCDaYcZAfe,eDBERDEAGBAFHBFAFFCD..QGGCBBHFMFABIFDB.hAAAUAABEHFGCGGEDEIDaFBBYFEBhABA.AAIHOEBHhADAXBEBLAECNABD.....hAGA......hAHA...,1,3,-31,34
QCMgcZUGBRTVYDKedJfaINLSXHFOAbWPE,...PEHHEFBAMEEHZDBBBHAARACA..TDABDAADKGED.dDAEaHBChAAALAGFHDGHAAIDbFEDhABACEDF...UAFG.hABA.YBCCfCDAIFFD.SCHBhACAXGGA..hADA...,1,3,-38,41
fXHIMKgGOVAbSLECRDNaUPQJZTBcYdFWe,SHCALBCAEEGGDAAFUGAH..QAGEZFEDBGDHdGGHeCEDhABAHDBAMAFBKBGEgDAGhACAOAAB.bGFCCEADaDFGhABA..TDGB.FBBC.fGAEhADA.IGCGhAEAADDE..,1,2,-19,21
GVHEOJAPdNQXbgCZRafWDSTKeUYBLcMIF,dEEFXAEGCCFDZGAG.RBAD.....aGGGfBHEDBDD.TFAAhAAAeDAEUAGF.BABChAAAcFEHFEAB...hADAHDCDEHDAAIFCNIEHQCFG...hAEA..WEHF..hABA...,2,-32,-21,11
gYRHQIWLdBNMSVDCcAaGJZEXeTPFbOfUK,aFADZEAFeAFD.FGHDOGEG.KAEBRDEEQBBCLAAAdDFABAHDhAAAMDCBDDIB.ADDF.ECHHhABA..XECGhABATAGDfDDC.YHFGIHDEhACAWCACSFFGhADACEHH...,1,-13,-31,18
GSeLCNfQdREVBPOZDWAcbTKgJXHIaMFYU,TFCDJCDEHFAE..MCCGUEFEGCEHLACGCHGB.QBADhAAAdEFDRDBCEAFABFHAOHFCZAAEhAAAAEAGKEHH..IHBAhABAFHCASAHBeFAFfCAADEEF.hABA......hADA...,1,2,-14,16
fgYSBATURXbIZOaFQMDCGdHNeLcJVKWEP,TBCCRAGD..IEGDaHFE..MHACGEBBHAEDLBAChAAAJBGBKBAC.EGGC.fCEChABAYEDHAGGCXGAFhACAZDAB.FDAGDAIDCGDHNIDH..cDGE.hADA......hAEA...,1,-11,-15,4
MdUgWaBLQAZHeVbOXTcYFEGDKNCSRPIJf,ZDEHeCGHOBCE..XBBH.TAFGYCHDGFCHhAAAKFHB.CEABRADD..IDABhAAAMFHHdHADUGBF.hABAaDDH.BAFHADID.bGECEDEADABA...SFAFhAEAfFAE.hAFA...,2,-30,-6,24
JBDGQcKOPXFHWMbUfYLeSRETgdICANZaV,aGBHVCEDBBDE.GCBAKAEF..OEHHFHFEHEEHMAAAUAGALFAGhAFAeBAF..EEHBdDBGhAGAAFAA.JAHFDABE..PHDChAIAXFCD..WBCH....hBAA......hBBA...,1,-13,-25,12
RPANBLgKWXIVCYcMOHTESFJbdUQfGeDZa,BEEGLDBEKCAG.XFAHCEHG..MHAAHGEA.TEGCFAFAdEAGhAAAQAEBGABBDGCEhABAaDFG.ABBA..gAGHhAAAIGGC.VECBOCFGSCAFhABA......hACA...,2,-42,-4,38
DBNZeIYdUMbgTJHCPFQVXOcfAaLEGRKWS,aCCGLGDAGEECKDFBDBHFBEAG.ZACAeFBCdCCF.MDDC..TGADhAAACDBDQAEFhAAA.OEHFfDABhABAEABGSDADNIED.IHAC.hADA.UAGE.JDDHFHGChADA...,1,-14,-17,3
AMYNeIXDFVBSfQWRbZcgTLEdHCOKGaPJU,MCAGeFAEDDBCBEHF..QCECRDEBZFBA..TAFFLHBAhAAAEHGE.HFGD.KACBaHAEhAAAPAGDAEAD.IAEEhABAFABESDDD.WAHHcEFGCFHA.hABA......hAEA...,2,-28,-12,16
ODFXMTLIJZdfBESVPQUcYCKeWRGgaANHb,HDCHDGABFEBDXGACLCAAZCGDBEGD..SAACQFDChAAAUAECCGGG.KBBFRABAGAEChABAAGHAbGEC..MIFGhADAIHBGfFEDEDGG......hAHA......hAIA...,1,-13,-22,9
aLCWGYNQOJSUbdKHTBPVgcADMFIeZEfXR,DAIFFCADeACHEEEB.RECE.CGHF.GDGG..QBCEJAFB.UBFBhAAA.KGDGBABBVDAEhABAcFAH.AAHBZGDChAAAXDGC.aGBH.......hAEAWACCNAIA...SGGDhAGA,1,-24,-31,7
FRIabVfeHZGdESUcQTMgLXCDWJKNYOBAP,FFFGRCBB..aAAGVCBBHDGDGGBBdBFB.UAGGQFAG.MFIDhADALACCDIAEKGDCNEEFBHGEhAAAAFDA..bFFHeBAFhABAZADB....SBBE..hAGA......hAHA...,2,-21,-8,13
ZSaTeYQgRdOXFIELVNBGUMHfbKAcDWPJC,DEEEJGECZAFB..aCGG..eEACQADEdDHCFEEE.LFFHhAAABAEDGBBHMBCDbCADADAB.hAAA....WHAGhABACHBHSFAA..gFDGhACA.ODHDIABAhADAEGAE.NIEF..,1,-12,-37,25
MgDdUNCeWLASHQfBaOXbKGIEYcPZVRFJT,SFABHDEBQGEBBGDD.aAEAOFEGKFBBECAE...PCCGhAAARCCDFAADMAEG.DGIFhAAANIAHCDHCeCFA.AHHD.fAHAhABAXGBHIBEAZDAC...hACA......hADA...,2,-26,-7,19
NXKZFTfLOGcAQPIdJgDeYSRBMUECVHabW,QCDDdGBHDFIB.SGAABCDFEFEGHDBAaHEA....NIBDZEAAhAAAFHGCTDFBLADChABAOAHBAHHGJDHFeAGHhACAMBDCCAAG....WBBHKEAF.fFFBhAIAcBAE.....hABA...,1,0,-30,30
LEKfdbQTPXBSMaCgHYAcVIJNOUGWZDFRe,VABFJCHB..UFEFZFFEFBFDLBBD..KDEDdAEDQEAAhAAA..PFABhAAASCHFaGCFHCCHADAENIDF.hABAOCFB.DGIHeHAA.EAEC...hABA......hACA...,1,-18,-26,8
ABTeKcPXVLDFEGCRdJHfONUIWgMZSQbaY,TCEEKCEE..XBAEDIBEGACE.dGHCJDDHOBAFUGAB..hAAA.IGFAMIFCSGGAhAAAaAGEBGADeEEAhABAVDAFLADECCGBRFBGfAEFNBIE..WDGBhABA.....hACAgFEH.,1,-1,-18,17
eUCfPbHFZWNEXBgRTVYLGKJAIaOdQMSDc,OGFEQFCDDICA.UFGC..CBCB...fBHCHDACFEGBZADHhAAAEADGBAGCTAFHLAAFhACAKFEDAAHC.IBCEhAFAaFABdABC.MDDESBHHcEEC...hAIA......hBBA...,1,-20,-26,6
HEPWNTbSfIAVOULZCXdFRJKcBgaYDeMGQ,VGFAUACHZDFB.dDEEJEDCBBFA..aFAFDAGC..GAEHHFBCEDABhAAA..PCAAhAAA.TFCASGHFhABAAFIFCABGRCEG.KHEC.YFAFMICE....hADA.WCHH.fDCBhAFA,2,-26,-25,1
ZVRCGJcWIeAYabSFENKQOUXDfMdPBTHLg,aCABSCGE.FGFBEGEE.KAHBQDABOFAD.DCBEdDFFTDFFhAAALAACZGACCFDBJFCBhAEA...IBEAhAFAAIBEYAFEUDCDMBAGBHHBHBDF...hAGA......hAHA...,2,-24,-8,16
gKIfCaMeVTdZXYLFOPGUAbSRJQDWHBcNE,RBACJDDAQECAHBAABBGH..EHBCKFHBCEHF...MGAGeAGDdFFGZADFhAAALEAAFEFFOFHDhABA..PADA.hACAAEHEDAIHcGDE.IFAD.fDBFhAFAaAAAXGDH.hAHAYHAE.,1,-3,-23,20
IYTSUcfeVAgaKGXZHDMLPNFQWRBOECJbd,KFCCGGCHHCCGDAHBLAFCFEFH.RAABBHGFEDCH..JDADdEGA.TGDBhAAAUABB..eGAChAAAAADCaCGAMIFC..NCAA.hACAODFA.CEDH.IHBH...hACA....SEBChBCA,1,-14,-33,19
aBCVHRPfeSgdIGKFZMEWUJLNAOQYcXbDT,QEECXECDDCEEBCEF.CBHH.RFFCeBHFdGGEGDACZAAH.EBBGJAFEhACALAEE.ADHBODDHhAAAbEAH.aCABPACDhAEA...SEEGKEHHMIAG..hAFAWGCGNIDD....hABA...,2,-17,-12,5
GPDMbYFVCZBJTQdcKRfWHUAXISeLNaEOg,SEEAeCGHLBCCEHGA.OECEGABEDIDGMDFCFHAC.ZGAEBCDBhAAATAFDdBGBKEHB.RDAA.hABAHDABAIHG.NAAAaEGD.hACA.PGDA..YHCGCHGF..hABA......hADA...,1,-6,-16,10
aDSdefWCHVFKAcLGBXRPbIQEYgTUZMNJO,GCBEXCAERAEF....IAABQBGDEDHF.TECFZGDCMCABhACANEHC..OHDGhAAADEGHdBDGfGABhABACGAAFEEHACHEBHHGPAED.bACB.UEEGaAGA...hADAWHAGKHBG....hAGA...,1,-4,-9,5
AKGISgPZcWbRfOLQXaVTdMHBEUYFNJeCD,KCCBSFGGZBAF....bEBAfCCGLACC.XFDAhAAA.TCEBHFFHBHDChAAAEGACFAGCJAGFCEAHDDHFhABAAHHFIHADgABCWFHBOHCE.aCHFhAEAdDGD.....hAFA...,2,-18,-12,6
MDJBNeWKLdQIEbZFUPGgVfCXaOHRYASTc,SFGCMCGBDCDABAHAeBDH.LFBEdDDC.EDAEZAAG.FHEAPAGDhAAAGCAE..fABGhACACCHFOHACREGFAGDH.hADA.cGAH.WEEBKAFC...bAEB.hAAA......hABA...,1,-3,-29,26
YOJSUTMIFNAEKfQLXdgCVHBPaGeRDWcZb,KGCDQDGCLCFDdACCCAFA.BCDA.aGCGeCBD.DIDAZFEHOABChAAASGBD.TGGFhAAAMBHFFFHH.ADDFEGEAhABAfAFD.gDBBPFABWCDBhADAbBED..YBADhABA..,2,-35,-7,28
dUQbDYKARTcSVFCMgaXOENIGZeWBfHPLJ,TFGCSCCA.FGAGCFEH..MIFC..aEFDXCDCOBAFEDHDhAAAGADFZBFCeFDDhABAWDAD.BHBHHGCEJFHHQCGChAAADADBAEED.cBACNAEB.fHABhABA.dECD..hACA...,1,-8,-15,7
MUbfKEBGPSNeVZRDHFITQWACJadgYcOXL,CGHHJHEAdDAC........gEEGOEDCLABEhAAAUBFHKBCAECFHBEBASCDFhAFAeGAGRBAD.DHACFEGATGEDhAGAAAFE..aAAGXDGAMDDH.bDBD.hADAfAGHNIAH.hAEA...,1,-22,-25,3
gJaGbEceRFQTdOPIHNCXASYBWULZMVKfD,SAGDBACDUFAGZCCEKECH..DEGH..aGDGECAG..REFBFAGFdAAFOHDEhADA.IFEAhAEACHHFAEEBLAAB.hAFA.MDDA.fDHC...hADAJFBHcCGH..hAEA...,1,-27,-46,19
FbGSUdceRWZAXfVOLgQBaPKHINMETJCYD,XDDCVBEB.LBAABHBEKEEFHFCG.MEBDEBCD..CFAGFFHBhAAASDHH.cADFhAAAeEAG.RFFFAICEfHEFhABAQCFEICAGJAFC.DAHF..hACA......hADA...,1,4,-42,46
TdMgXfSYUCBVAePOcHLKNWREbaZQDIJFG,eAADOCHDHAFELCECKFFFRCDB.ECBFZFACDGGEFEGFGFAF.MADAhAAAXGDD.SADChABACDFGBCACAFGANBBBbCBD.hABA.aGDE..IHAGTDCC.fCHEhACA..YHAAhACA.,1,-2,-23,21
ASeXEJMWFLIUbDPYCaTNVcgQGKZBHROdf,XEAGEAFD..JDFFFGHFUCCBDBEH..CCCG.aGDA....VGBGhAAAQEBBKFECZBGBBDFFhABAHABCdGHA.SCAFhAAAMIEELACCIHBB.YAHHhABA....hACA...,2,-27,-27,0
gXaNBROcfSWKdMVADFZEIUYJPeGTCHLbQ,DDEHEDHFUBAE..PAAGeAFFGACE.CEFA.bAEE.QFABhAEAaGDBBHGFREAEfGGBhAFAKHAA.dDHAMAHDhAAAADCHFDFH.ZGCE........hAGA......hAIA...,2,-22,-20,2
YaDVMUSbcAQGIWCHfXKFLOBNZPTRdEJeg,GBDECAABHFGBKDDCFDGFBAGFZBEA.RDAE.dFEC..JGFGeACC.aCCHDBIBhAAA.UGCH..bFBFhACAAABF.....IGAAhAGAfFAGXDGEOACB...hAHA......hAIA...,2,-36,-22,14
ATZQfRIVaUWBFGOSegKNcYXCdHLbDPEJM,QBFDRFFE.aFEDUAEC.BCHEFCCDOFAFeBAAKEDG..hAAANIEH.XEBDHDFEDACGhAAAEDAFADBFZACG.IBAGhABA..WHBAgECACCDD.dGGHhAGALHFA..hABA...,1,3,-39,42
bMPOUZJQISECTNeFVYgWXGdARDcHKfaBL,RFBCHACHKBCCBBHDLFHH.MCGBOADAUCACZEECQFBFhAAA.EEEDTCFCFHDC.hABAVCAHgAGDhACA..XGGGAGHHDFAD.fAAHhAAA.aEHF....hAHA...,2,-34,2,36
NXdcRZYWaJDHCfbBQALOVMGUPISegETFK,LBAFMBCBGFDHUBFH..SAFDeDDFEGDFKGBHdDHGREAEZEFFaABBhAAADDCBHGAA.fDDFhADABBDFAFHEOFABhAAAIAGD.FGHDNIEH........hAEA......hAIA...,2,-24,-5,19
KeCaVMcUAgJdHNEZXLfWRYbFQOGBTISDP,JBBDdHEDHBEEZGCE.LDACRDEA.FEBHGAEFBEFG..SGDFhAAADAADKGHB.CFHAaHAAMFABhABA.AFCE.EACE.XAGEhABA..YADF....hACA......hAEA...,2,-44,-16,28
TedNFDEBGJScZVCUYaAbMOHWKfLXPgQRI,OBAEKFAFLHBC..XEACQCBHRDGFeGEEFCEHBGGBhAAAJDDBZADACABBUDGD.AAIBHBFChADAfHCH.hAEAgGAAIHFGTEBGDAAEECEG.SADAhAGA...hAEA...,2,-22,-10,12
MPcYBdXNDfFbVKQJAEeSCUGWOZRagHLIT,EEBDCBECGCDFZAGH.RAAE.HFCBLHAGMGFC....PDDCBHFEXEGDhAAADIEEFBAH.KCAFhACAAFHCeCCCSAFEhADA.OEAEIAEEYGBEfAABhACA....QEEBhAEA,2,-27,-9,18
PWBSQHMDEFGCKNcAeZaUOYVgfILdRXbTJ,ZAABaFGB.OHEG..VDAG..gCCALGAEXADHhAAAJCFA.BCHCSGGEhAAAMAFEEBAHFEEGCFEAKABEhBAAABIDeHAA.YFACfFHC.IHEHhBDAdAED...hADA...,2,-28,-18,10
AUTbSFKfNePEQVYaCLcJWMBDGHIRdXgOZ,UBBCTBFEFEHH..KDDCeEBF...EFECVEGH.CBBCLEBFhAAAJBEGBCHDGGEDhAAARFEDdADFOECDADGF.SGADhABANABH....YEDDaCCGMCABhACADIAE.....hAGA...,2,-26,-15,11
adfACBUOgVLJMHYIZecDQNGPbREKTWFSX,CBFCUFAC.OFEHVDCALCGFHAAEZCEGDAIHGDAC...RBAEKGGEhAAAFFFFaCDGADHB.JAEEMIAEhABA..eHFANIED.hACAEDHF..SAEFXCACBGCEIAHAhADA.cFDD.hAAA...,1,-9,-16,7
WMDTVbZdHgCIOXFecEfLQABaNRSPUKJGY,BCEAaBGH.SFACKAHHGCAE..MIECDIFA...TCBChAAAZGAEdFGDCGGA.IFEAhAAAFEFEEBACQADFhABARCCG.PGBAJABCWHEC......hAEA......hAFA...,1,-20,-28,8
YeEHBOaTXUZIKQNgDcFbMWVSCPdGfLJRA,EGGFHFDHBAGCaABBUFBAKBGH...QAGDDEAEFDEG.MAEFSFBDhAAACGGGGDDBLACEhABAADBGOACDZFCANDIE..hAIA.bBBG..WHFGPDHFdGAC....hBAA......hBDA...,2,-29,4,33
ZWVLTQNRaDIKPXUOGbMeJcAfHdCEBSgFY,dBFGCAGBBFEHSFGB.FHCEZCCB.LBFGQEAGaAAFDDGChACAKCAAUCCG.OABGhAAAGGBD.MEAFJBHDAFEChAFAEGHB...WDBDNGCB..IHAHhAGA..bEFB.fACHhAFA,2,-29,-27,2
OXYAfQTcFIWbPgJeUZKBSHERdNGVCaDML,TFACFECD..IHGE..bFEEJBCDUDDE.KAFHBHDDhAAAEGDD.dAHAGBABCCAGDBFD.hABALAHB.YDAAhAAAQEEEWABCPEAD.eAEEhACASGHH..hAFA...,1,-17,-35,18
OUFKCVGHQEWfZYgINAadTJebRXBDPLSMc,dFEFTFGHJDEG...eCAERCBFBBHBLHDA.MBAEOHCAKBEBCBHFhAAAHFAA..QEBBhABAEHFAZAAB.IEEBhACAADIHXAEASAEE.FCHDWHAGhAAA..fHABhADA..,2,-34,-4,30
cVOMfgJEGKBTZCSAQWbDYXUPNFIaRdeLH,QFAEDDADUGCE.FHDCRBGDLAACHCBCOHFA..MFGHfEGChAAAECDE.BFDGhABACHACAAGA.bBEB..XBBHhAEANADHaAHD.dFHA.eDFF.....hACAgEBCKBBE.hBAA...,1,-10,-20,10
HZLSaEFIYQfKJXRUAGODWdTeVbNgMPcCB,DBGAdDGGeHBC..bFCFMCDD..CCGAZBCHaGGHFBBB..IGFDhAAAQAFB.JEBDhAAAXGAFAEIF.OCAFhABAWFEB.TEGDNDAA.PAEBBHHESACEhABA..hAGA...,1,-26,-27,1
CONRTgYDHeZKbJBQGFPaIUVMdSWLEXcAf,CEBHOFCBRDEE...TAFFDBCCeFAD.KGHHJAAE.GCEEFCDB.hAAAaGGCUBGA.dFFHSFAHhAAALBAH.cBCGhAEAACAD...fEHCgFCCYHEAhAFA...hABA...,2,-35,-16,19
KbFDXeUHJcWVGgaSZBRLAOCQNYMdTIfPE,CDBFQEEF.MFIFTFEF..PBADbBBA..DAHFXFBGhAAAHCFE.JAHBcFCBhAAAVAEF..aDCBSEHDhABABGGBAGABOHAENIEBIACBKHFA.FAFBhAEA......hAIA...,2,-26,-6,20
eWUdCNcaIFbDQgXYMEZAOGTVPHSBJKRfL,OBGFVEBC.HDCBBHCGKCAFLAADUGFCdGBGCGHC....aAEFFAAEhAAA.DBEHQGEFhACA.XAGEhADAMFAHADCFTGDAPBBCSGABfEEBWCHHhADAIDHA.YDDChAGA.,1,-20,-33,13
UZFTPHAXIMVcRWLKNfgYaOSBCeEQDbdJG,MEDHVBGF.RCAG.LFDCKCFF.....gBDGOAHDSGFDhAAACHAA.QFADhABAbEBBdABAJFHHZEGBhACAPADAHABGIAFGNAAG.aEECEGEDDGEDhAEA......hAHA...,2,-16,-6,10
ZASBMaPeXHDVJgNTCRIYGKEfLWFUObQcd,MDGHaBBA..eDGDHFCEDAGBVAAF..JFCDTEAARFEF.GADHhAAAECCBLDAFFHFGOHAChACA.QCDGhADAdAHGAEIBBBEFPCHHNABFIHHH...fCEAhAAA..hBAA...,1,12,-28,40
JKPAeSEdfIUXYFOTWaVcRDbNgGBHCMLZQ,EAABdHCHUBDDFEBB..OHEEaGHH..REEA.DCDG....bDAFNDDGBACFhABA..CDHFMABAhAAAZEFCJAGF..ACGDSAGAhAFA.IHAHYFAF.WEEDhAEA.....hAGA..cGGA,1,-36,-38,2
UEPBKIOcMSgQYefXDLGWHNAVadTZFbJCR,aFFETAEEZFDF..FAEECFFE..UGCFBAADKBCF..ODBA.MCIHhABAQBGA.hACAfDDDDEABLCFFhADAGCAGNAHCAHHH.dHFF..bEADEDGD..IBCDhAEASABCeECDhAIA...,2,-23,-17,6
GbQTUWEcKaAFPRBYMdIfDNXZSgOVCeHLJ,RCGBMBBAdEBDDAFDZFDA..ODEE..eEEBJAFC.QAGHhAAA.UBCEEHGAKHCCAHHGBBAFhABAIDAG.XCCGhAAASGAGCFBB.......hABA......hACA...,1,-35,-39,4
gcaEAKMHfJXGNTUIZVOSeQBbdDFYPLRWC,MAIFJADCGDGAUCCAZFCB..OFCD.QCBFdFABDABBFEGEhAAALDEHCHAH.aBFEhAAAEGGAAABHKHAA..fGEGhACANCAE.TAEBSGEA.hADABAHE....hACA...,2,-30,-22,8
KTRIVQMZONcbeDJEfAPUaYGBHgLWXCFdS,aCFGBHHELECDCDCE.FFHDdDHC.KABFRABD..QFEHOBFC.hAAA....NAIEeEAFhAAAEDABAAHBUFDBHADDXDFEhABASGAH...IBDD.hADAMACA....hAGA...,1,-1,-52,51
OfdEDBFPIaJXZVUCGHKWNTRSAYMLgQbec,LCBFQBBDeGFGOAEEdCDGDAECBCEGFAHD..aAHDZGBACGHBKFFFhAAA..TDGFRDBFAEIB.hABAMBBG..cDGGhACAfFCF..EHAG.PHFC.hAAAIGDG..hADA...,1,-23,-28,5
QASHJUbVcgdINWYTMRBXeaCPZKOfLDGEF,SGCBUBAG..VFBFdGHE..ICFF..WDEAhAAATEEHBAHG.eFFHhABAaAACCGAHZDAEOADH.hACADHFAEFDGFAEAAHHF.HCABbBFG.NAIAMCHF..hABAXACD.fEHAhAEA,2,-23,-21,2
SeAdLEXRJZQDGTIFVCBMPYKfNabcUWHgO,LBEGXDGHZEADDIAEGCBD.FGEFCAGHBGCB.MBCA.hAAAKDEBfACHhABA.bGAAcGGFHDFGSHGChACAdCCFEGEDJAAF.IFBC..hAFA......hAGA...,1,-18,-29,11
JWDQScLFPfaMKdONgGeYAVIZBHUbRCXTE,VBAHZDCFBAFG.HBDARGCG.CCAG.EDEG.DFFESHBALFAFFECEhAAA..aHFAMCEEKEEGdABAhAAAOAEGGCGEAGBCUGGDhABAXEAH..WBHH....hACA......hADA...,1,-17,-19,2
QfAPSdDUNCbWZBOJHEVMeaGTYLcFKIXRg,SDACUEFDCCHB.ZEBCBCEGHCEF.VACHaBDG..GGEBLHCChAAAFGCH.XBGHhABA.QGGBhACAfFCBAHADDGBH.WAFCECAHeABC.YAGDhAAAKFGE.IFAEhABA..,1,-5,-28,23
AIHVfCFZMPUbcLDBRGKdeWgTaXJYSONEQ,VDEHFDFDMFDF..UDAALBAGBBAAKGDDdBHAeFAB..TGAChAAAJCDG..SGGAhAAAEAGAAEDB.IEBBhABAfHFH.CCGF.PADADEIF.WEEDhACAaCCAXAEB.hAHA...,1,-29,-31,2
JNCTVZdBHMYLODAXGRSPWaKUbeQFgEcfI,XCBBSHBE..aDBHKECE.UGEBeCGDQEADEHGE.hAAA.IHDCJBAACAHFZAEBhAAABDECHEFCLAEAhABAAACG.PFECFBGH.fFCA.hABANCIAdGAAMBIFDBBE..hACA...,2,-15,-12,3
HBacFLGKURANIfOMZDXSdPVYbQCTEgeJW,..IAFAMDEAZEFFDCGASBAD.dAHGPDBB.VEFHhAAAbBCG..QFBAhAAAECCAJFCB.BAECFBABLDEChABAKFHBAGABODBECHAAeFHHaHFC....hACA......hADA...,2,-19,-12,7
dDCZUWReXENVagMbGSQFLBYIcfKOPTHAJ,dEGDDHAGCFACUGGH.RFAD.eCBB..EEDCaAEC..MAIHGEECQACGhAAABAAB..ICGHhACAKCFEOBBHPCCGhADAAAEG.....JEHFXFDANAIA.hAFA......hAGA...,1,-23,-34,11
fEIYgXKQaCPdeTZHWcUOSbGRNMFAVLJBD,JBHHDCDEEDAD....IBBGXGFBKBEBCEHB...dEEEZABHHDCFhAAAUGCEOAFG.hAAASFHHRCFFFGADAFABBHHBhADA..fHFB.gDAFhABAaEDC.eCGD.hAEA...,1,-17,-31,14
faeBNLERTSVCIFPQAOGMdDbKcHWUJZgXY,GFADDFFDKEAHHCCDJBEDZBAE....XCGGaGGHBHDCLAABhACARDFG.TGGCSABChAAAIHBGFBHDAEBHdAGDhADA.bACE..WFFFgEGC.eFDFhAEANAEFCHBD.....hBAA...,2,-29,5,34
KAIgZbQNSTVXBCWUPfJFadLEHYMcGRDOe,ZGACQBCFSDCG..TCABBCFACDAFUFEC.JDEEdFEGEFCHhAAAMAIBGEGEOACFhAAAAAFG..IAHChABA.NEAG.XAFA.fFGAhABAaFBB.HEAA...hACA...,2,-24,-13,11
YIXABCHeGQMfaPUbSLEOZWDgTcRVFKJNd,CHHHHFFEGEAEQECG.aAEBbDFHEBABOCEFDDHD..TAFEhAAARACFKDHFdHCB.XAAChABAACCGBDDEMCFB.hACAfHAFPAHDSECEWAHB.cAEFhAGAJDAHNIED....hAHAeHCC.,1,-2,-8,6
DECTVPRZSbNaXKMIWfBcFGHgLQJUAOedY,dCCBEFDH.CAGD...TBDDRDAGZFFG...SGEAaFAF.MDAFhAAA..IDHChAAABHBDFBGAHFCHLABHhADAJHFGOACGeDFADDDFPEECNEICKFBH..fBAChABA...hAEA...,2,-20,-20,0
dHXBcGeMRKfQOZSbPTAVLUNWECFDIYJga,VACGUBBBEAGB..CGDH.DEIF..JBHFaDFHHEFB.BGABeCDHKCEBhAAAQGDA.hABAOACASCCDhACATFBEAIAALHFAFGGFIHABdGCC...cBFChAAAMAFE....hABA...,1,-21,-27,6
NFdPSeORfZbVBYIHMXJEAGLKTgCWQUaDc,LBEDTCCH.CGBEUAGHaHFA..DFBAFBAEdBCF..eEFFRGAGZDGBBFDFhAAAHAFF.JEEDAHIDKHCGhABA...QDBChACAcCAH.SEAFfAAE..YEHDhADA..MEIHhABA..,2,-33,-10,23
SdUGeBOPfcaLZYKANbVTJMQXIREWDFHCg,VBBBMEDE..QFCBRADG.DAFAFHFAHCAFSBGAdEHCeADFhAAABEGHOHBC.fBHChABAaDECZFFCAIAATFAAhAAAXGFD.WACFCHDC......hAIA......hBAA...,2,-28,-12,16
YVdOMAfREUJXQPFKbZGLIgDBSWTHeaCcN,EEBGUAEA.QGGGKGFAGCDDLDFCDAEHBCABSAAChADAHGBACBBE...NEBGVDCFhAHAMFABAIFC.REEA..XBGAhAAAFHCAICBE.WFFFaABA...cEGAhAIA.OBBAhBGA...,2,-17,-14,3
YVGUCZLdITAHEMeWNOJFbDXaQRfPcSKgB,HCFBeFAGOCHDJECHFAEG.DHAE..QCDBRBCH..fGGFhAAAPFGD.SBBFhABABBCC.YCFHhACAGBAECBHA..dAEDAIFGMDIH.WHAGhAAAXEDE.KHCG.hABA...,2,-24,-16,8
RMSFeAgVaLHUcZfQWTDGYPNOBIXdEKJCb,aFGEHACAZDCFQEDA.DHFEPAFGOCGHBDHAdBAEEBGGKBEF.hAAACAHB.MIBC.SABHhABAAHDELCCGfGFGhADATEABNIEB.IEAHXGAA..bCFDhAEA......hBAA.FFBD.,2,-26,-2,24
ICOXdbGfBKAeTDMaZHYFNWREJcPgULSVQ,DGDFMEAHHGEEFACA.RDDE..EAEGJFDD......PAHHUCBCSEEEhAAAQABDCECDhAAAXGGGdDAE.GBGEhABAfGAEAGCDaGAD.NEIE.....cBDDhAFA....hAGA...,1,-11,-34,23
GEaFLbZcVMRDgeOSQUIWKTAPdJNHCXYfB,dHBBJDFGHFCECFFB....XFAGBEAFaBDBLBFDZEEA.MBAFhAAADBAGeHBG.SBFEhAAAIBCCTECAhABAACAD...NCIAfHEBFGGHcFAB.hABA......hACA...,1,-29,-30,1
JeSYVXPgNdGFacDfRWATIKbHMZOQCBLEU,KGHHMGCCQDFABFAFUCFF..JCBEeCAG..SEADhAAA.VFDDXGGDhAAA.PHBGNABDdAHCaBEAhAGADAIHfABFAIFA.bEFAZDBECECEEAEChABA......hAEA...,1,-13,-29,16
fVHUJQXRSLNOKcEBZFWaDTYeAdPbIMCGg,dCFD..ICCHCAFEGCBC..VADEUGGCQDFGRADHLEEChAAAKGGABHAAZBAHaHACDFFB.hABAeFEBADAF..MCIHhACAfGAD....XGCHhADASEDC.cGCFhAAA.WCAD.,2,-22,-12,10
ETeIWLBMDXObGPCgRcSHQVZFNKfJYadUA,EAHBTGAA..IGAFBEHHDEFD.OACGGABH.CCGERDDFSCBEhAAAQGGFVAFDhABAFEACKGDD..YFDHhAHAaCCHAFFFeAAD..MAID.XGGBhBAA.....hABA...,1,-18,-20,2
MFbZLIJGHgVKTSWNdcYOBCfUDQaeEXPRA,MBCHFHCELADAGEEEHBFDKCHD..SBBFNAAE.dFGDYHBGhABABEDF.fBDChACADBAHaFAH.eAHBhADAEGEE.PFAAACEAZCDCIHHG...hAEA..gEABhAAA..,1,-12,-23,11
APRJgQEWKOBTYeMGVDXSaZLFdHfNIUCbc,JADHEFHFKAAEBHEC..eAEAGDDD.DGGEXDAC.aCFFFAAHhABAHECE..fFBDhACAIHFACCBAAHCBRAFFQACEhAFA.WHBCOHFCMAIFSEGAhAEA.LAHBhAFA.,2,-37,-8,29
aecQADIZMTFYdfLEWUKNCPVRSGHXOBgbJ,ZFFAMHBEFADDdBEFLBFDUAAA.KGCD..CGACRDGFGDAD.OBHHhAAABEAFJDDF..aGADhABAeFFDACAC..DIEETCEBhADAEABC....WAFENIBF....hBAASDBB.hCCA...,1,-25,-30,5
GcaHbYSUVLNAEMPWFBeZOKgdTCQIRXDfJ,ECBGMAEDFAEGBGEB.ZDGBODED.dEGFCCGCQFADRDAH.hAAADAIBJAHFGCCEaGGDHECBhABASCAB.hACALAAAAGGDeBBEKHDAIHHEfCFBhADAcAFB.....hAIAYHBG.,1,-3,-22,19
VQPgBKGRdYLUAMCXOTIfabNeWSJEHZFcD,CCCFODDG..TDFGaBBD..eAEESECEHGFCFEGEDBAD.hAAAQGADBEBCGFBDhABARAEAdFHCLAHHhACAUFDFMIECfADG.WHCGJDAD..EAAEhACA...cCGFhADA...,2,-20,-4,16
COLgSPXGKHbeZAIEcTFDJfBMWVQRUdaYN,EEGETCCGFAFA..DBBGBHEH.MGBEQGGGRACG.dEAFNCFCLCADhAAASBFGXGAChABAKEDHHGDG..eEHBhACAACIBcBCEfGGC....WAADhABAaHBE.CDEE....hAEA...,1,-16,-19,3
AbGVRKOSXdNUefBQaHCDYEMFTLIZJPWcg,VEDHKCDAODGB..SCFAdHDBUABDBHADQACF.hAAAaGBCCBFDDIGC..EBBBhAAAFFAAIGHAZAGF.hACAPHEC.WHAGAHHA.RAFCeDAGfEEChAEA.MEBE..hAFA...,1,-2,-40,38
AUZIWTcSGNdObHeFYXPLagQfMJCBEKVDR,UBDFZDFG..TFAHGEBHOABGeEGFFGBF..XDCFhAAAaBADQAGDMIAECAFEEHFEhAHADACHAGIH...IHDBhAAASGFE.dCFB.bBBG....hAIA......hBAA...,2,-25,-15,10
BWCIKDXaJHFbUSRATEVZLYMeNdOfGPcQg,VAAHLGDG.MBEAdBFHOGDAGDBBQABBBEBA.CHHAKCGAhAAADDDBJHAGHEGHFEEGUGADhACA.AAFGEEABZADHeHFChAAAPCDA....WAHH...aEHHhACA...SGAChAFA.,2,-29,7,36
RLdIJWNXGSEYPDagFTQMBOVZfeCcUbKAH,HEGBLCFEJCAF.XDGDEABC..DDDGaBCAFDFD..QCABhAAABDHBZEBBCAHEUGGGAHIB.hAAAIGBA.WFEDhABANCDB..SEEDgDCAMFAFOAFAhACA.....hABA.eHBAKEAD,2,-20,-4,16
PCEcRfYNXZdTKLSVMAabOBJGUQgWHDeFI,aFACOFBDBGEEUAEG..QDFBHDADDDGDFAAGCGGA..EBFCRCCG.hADA....YAAAhACAXFEGZCDHdHFFKHCChADASAHFAIHA.JDHDWAHB.IAEBhAGA.PCCBhCAA...,2,-32,-18,14
QMXDWZEHJfTCgbNAScaFYRLIGOdPBeKVU,SAACaAEE.FEAHRFDELFCFGADBdEEEBFAAKCCF.QDEAhAAAMHFA.DACDEDGBJBHFhABACGCE....NIEDAAIDIHADhADA.PBDHeCHB.....hADA......hAEA...,2,-25,-25,0
aSeYFMEVgIHOBDUbQLZGcCJRfWPXNAdKT,KAAFTFBFeFHF.FCDEMEEF..EADHIAEEHGDCBAHD.DFEGhABAbFFDZDAAGBBH.hACAJDFCfGAHhADA.XDGBAACDdAGASAAF.YDAAhADA.OFHDhAIA..,2,-25,-5,20
XfLSJeEDBadTNAFcIUQRZgWGbMVPOYCHK,FBBCUCDCQFDBZCAHGGCB..MEFAOADGHAFC.KEAHXDFHhAAASBDB.EGHFhAAADGIHBHFFaAFEdGGANACFACFA.hABA..IABA.gCGBhAIA..WCFA..hAIA...,2,-24,-15,9
JNEbdFegBYfWAKaIXHcGQDSVZMTORUCPL,aDCBXDEGGEAEDBGHZAFE...OEEGCBDFLHFAECHB.FAGAeFGHhAAA.BACH.fGCChABAKCBDIHDBhAAA.HEGDSFDBMBABRFAH.....hABA......hACA...,1,-12,-27,15
eNRXTfOCUZVBWYDHIEbgLPaAGKQcJMFSd,KGEDJFFH.FDEFdFDG..eCBCRDAE....TCDACBBCZCGFBAHB.hAAADGAFIFAC.hAAAEHBELFBD.hABAPADEaCGHACAGGADBQGGBMFIB.NAIAfABHhAEAOFCDWDAAhABA...,2,-39,-15,24
TBDEIVcLZUYKFGObaHgPRJXdSeQNACWfM,CDGHMBFEBBEDDCCF..ECCD..VDGBZAABKGCHFDDH..GEAG.hAAAOAACaAHBHFEFRGCAdADEhAAAQGAE.hACAAIGG.fCFFIEAC.UGGDgEGAhADA.....hAFA...,2,-23,-14,9
USVAOdLBIXaPWcbefZgTJYRGEMNKCDFHQ,LDCCBGBEaEAA...PDHH..bADGZAFC.JAAEGFDBhAAAMCGF.NEIE...KBCADIAAhABAQGAHUDEFAHHFOAHFhACAdGGDIEAC.XFCEWHDAfCBDhAEA..hAFA...,1,-14,-29,15
NaGHUTFMOZKeEDCWLIbQdBfASRgJcXPYV,SCCAJCFG..XDBFVEABGDFAUABB.FADEZEDAEAHHDBEHhAAALFDB.IAAEhACAdHBFABGCRFGH.PFHDhADAaEAD..MCAHeHAACHED.WDCABAHB..hACA......hAEA...,1,2,-28,30
TQCOgNWVAdLSEUKbePGcMYHfRDIFXJZaB,LFBGUDDCeEACGAEA.MEIHHFBHDGFDXACEZBAFBAGBCHEBOAHFhAAA..WAAEhAEAAHDFSGHDhABA.KEGFcDFEfCACIHGHaAGB.gCCDhAIA..hBCA.dHCB.,2,-28,-10,18
PNCXDbfWRdBZTcIUAMFKOVgeEHLQYaJGS,KGDAOEDCeABDLDBB.QGDDaBGCJDEAGEAESAGChAAACAFC.DCAF.WABEhAFABAHC.ZEEA.TACEhAAAUGGEABHFMDIBVBEFEGGDYBHB..hBAA.XBBAfECEhACA..,2,-15,-14,1
cQVYTXUAadRFHfNSWeZPDIKMgGLEbJBCO,aAGBdAGDRCEGHEDH..SBBFZBBFDAAEMHFGLDAG.EFFFJCHBhADABHCFCFBC..OAEDhAEAQFAG.YEHHhAAA.XECEAFGFfHCBeABEIHGHhAEA..hAFA...,2,-30,-22,8
JVeLdYZDGAHPUQCBTOEcFafbWIKMSRgNX,HCEAUFGFQBBHTFGDODBFFDFE.aAAG....fAAChAAAIBGEMBDDRGAGXAGChACAJEEFeHACdECEDIEGhADAABBFCAEDBHEDEBEB.WAFEKEAFSEEDhAEA..NDAA....hAFA...,1,-2,-10,8
gDPVfSJACTReGObaQZKYdBIUEXHcFWLNM,RFCFGEFEOCDAaGCAZABBKABB..dHEFBDCEUGAGHADB.FGAFLEFChAAAMBAF.DGGAfDBEhAAAAEBD.CDHAeAFEhABAbAEA....IBABEBFGWFHH..hADA......hAIA...,2,-27,-13,14
KAQdUXJRWBEPGMfDHgbLVcaIZSCONYFeT,dDFFUEGEJBECBHAF.GEAHDBDDHFFH.LECDaAGDZAAD.CGAE.OAEFhAAA..NAAF.FHDChADA.eEDEAHAH..REDFECBFhAFA..fCCD....hAEA......hAGA...,2,-31,-26,5
LBZYHCeAWVSOgPNDXRaTGKIbJUcEQMdFf,SFEFOEFD....gGBFNBACDEBE.RBCHGBEEhAAAKGGHJCFC.EDABdGBHFAGBBFBBhAAA.ZCCCCBBCeHEGAGAB.hABA..PDHHaBBG.......hACA......hADA...,2,-38,-7,31
gGDaPdYIRScbHVeLXCTfFAZOQWUMEJBKN,ZEEEOFCAUEBH..EADCKBCGGBFGDIBG.dHABRAFG...SAAFhACAHGECLAADTCCFhADAABBC.MGACBCEHNBIEaCBHhAGA.....IHFD...hACA..cGGA.hADA...,2,-40,-2,38
EDNCQFMZbTRVcXgJPWdHeIKLBGSUafYAO,OFFCEADCDGAH...CDEHFAAEMFDB.ZCBDREAA.....VFFGXADDhAAAJAFD.dGDAeEEFhAAAKGCFBBHH.SDAChADAfDAAADDB.NIEFQCGA.hAFA...cAGGhAGA.WHFGIHBD,2,-34,-15,19
eDNFGfXILTZWgAVHcBaOPSKYJREMdUbCQ,HCEHBDEAOEDHKGFHJCBF.RBFE...EBFGMEHFdHAB..UAABCAADDHAEGDGAhABA..IFFEhABALAEC..TDAHhACAWDAD..AEEDaGEBSAFC.QACHhAEANDDA..hAIA...,1,-6,-44,38
ETeaPcDMQVIYSWBGbJCKHRFdgNZUXfAOL,EHCGaEDG.DBCD..MAGDQBFD..IFHASHFChAAABAABJEAGHDAHFADDdEEFhABAgBCEUGAEAIGEOEHDhACALHBA.eFFH.PAHDYAHHhADA..bFCGCFFG.KADE.hAFA...,2,-15,-6,9
KAWIecXNRMPgUdfTFBaObLGSQVYCZHJED,eBEAXDBEMIAGUGEBdEHA..FDEEBBAD.OAEBLBACQGAHhAAACHFAZEBBEADEDADHAFAA.hAAA....IEEDhABAcCAB.RBFBfDHC.aFAGSAHBhABA..hACA...,2,-26,-22,4
McYETIUAbDKOeBQaLdXFfCPgJHSRNGWZV,DFIDKHFAeAFABGDALCFDFBBC..CDDD.JEBHHEAC.RGAEGDGGhAAAZACFMEAH..EGEHUBAFhAAAABID..OBAHhABAdDGD.XBECfHFH.SHBGhABA.....hACA...,2,-32,-15,17
ENATgKOCMZGaFXQIVUDdYPRcHBWfJebSL,KFFDODDGCFDD.ZFFDFBAE..QAGAUDAH.dACDRBDGBHDE.hAAA.fGCDhABA.eDAFSBGHhAAANCCFAGEGMEIFaGHD.XGAEDFBD....hABA.PEFA..hACA...,2,-49,-15,34
MTbGHaNVKfAWJOeXcBUZYLCFdDRESPgQI,JFHBOEEF..eDBDBHGBUACHLAHF.dAEHRDCBEAGASDCDhAAA.QGCBhABAMIBGGEEENCCFKCAHfCHAhAAAABBE.XGAGZFAFCDDBDIEGIBAGhABA.bAEDaDGH.hADA...,2,-23,-10,13
bgEYMIJWNSUFPXTCadfBHDKZcAGRQOLVe,RGEGQCEGLDDAeBACEFFG..MEACJFBF.SDHHFFCA.hAAAXBBCaDACBDHAKHBGhAAAAAHAGBDBOAFGgGEBhABA.YFBEWABE.PACChACACAFEfFFDDBHH.hBAA...,2,-22,-13,9
acfKLPURTFZNOGdWXSbCDABYgMEIJHVQe,BHBBMDGH.EBGFHEBD.QBCDeFBEaCAH.KBGHUABCFCABOFDFhAAAdEFF..XGGAhAAACDHADHGEAFHC...IAFBhAEAcAFBLABC..TCDChAHA.NIDBSDHBhAIAYFAF..,1,-14,-22,8
IdZaBQHWYePbJOgcVMKNGTUCAXRFfLESD,XAADRBBBLFDDDEBEZDEC.BCFHHBFH.eCHFJDAD.OEAB.hAAAVFDEMADC.KHGATCDBhAAAACHC.EHGASBAFhABAdADH.aFFCYHAG...hACA.PFBF..hAHA...,1,3,-34,37
INEOFAUBVLRJfDKPGeZTSdcXMgbCaHWYQ,BCDAVCCA.LABG.JBHBKGBB.eDHDZFECdAFGMIEC.CDAF.aEEAhAAAHEAE..QDABhACAEAABAFFCUAGCDGBD.hABA.PACCSFDDgFEG..hACAWHFA....hADA...,2,-38,-7,31
XAYVTZdEJPRINSFcUGDbMKBWLeCfQOgHa,TBBAdHADEDCG..RAFG.SCGBUGDG.DAFEKCFGLFED.hAAAeECFCEFAQADAhABAHADAAAAGVGFEJDAB.IDABhACAFABD....cGGGMDIBBHBGhADA.ODDAaDHD..hAIA...,1,-6,-21,15
FNBYQIgDMHCAdcafTWSZebVOPGKULJERX,dBFEaBCE...TFFGSFGAZDBG.eDEHVABHGGBDLCHDhAAAEBFAFACGBAHF.QFCChABAIFBADAIBCHHHAAEH.hADAfAAG.OHFCKGAB...hAFA......hAGA...,2,-16,-14,2
UMQZYePXOWcbESJRdBACGTHFINKgLafVD,CAGDHFDHFEAG.KGGALBACaEBG..DIGEQDDGZABB.eFFChAAAPAEC..OBHDhABAbDFF.EGCB.SHEGhACAdHAFAEEGIAAAfADDMDIH.XCFFhAFA....hAHA...,2,-27,-17,10
SegXFYLAbZdWaKIHUOVQRCBTMPNDcfGEJ,ZDBHaFEGHGCAUABF.QADDBEHH.MBBHDAAFGBFA.EFAFhACAJBHD.eBFHFHCAAIAEdHGDhAAA.IECARDDB.hAEATFGH.NBAAfFACSGHB.XCCAhABAYAFC..hBEA...,2,-36,10,46
eBVWQGXNHgYAaIMSdZbTKfRDFUEOJcLPC,aCCHMGAEZFCFKDBG..DAEDUFEG..EEEHJHAELAAH.eHFAhACABAFE..QCGGhADAXBBCHBFGhAAAgFADIADBSGGCdEGE.bAEHfDDDhABAFAHF..hACA...,1,-4,-40,36
TfQOBNSaUgbCcKHEeZVGPLMdYAFIXDJRW,FCGGXDCFDEFC.RCAD...TADAQFBHBGHG.SAAFhACAUCAE.CHHEHFEDEHBCeCDBhAAAVAEELFAEhABAMCIDAAIFJBBAfHFBaEEG...cGAGhACA...KFFC..hADA...,2,-26,6,32
LOKDAbQVWTZSeUPXMcdaRBYfFNgGEJCHI,QEEFTFFC.eGCEUCDH.MBCEdHGFaBBGBHEAFHBAGCAAhAAACCDCLAFEOBHBAEDD.bGAChABAZDAB...XCFEhAAAcECD..........hABA......hACA...,2,-18,-14,4
YDIVaJOSNQEHgdbcMRCGFWLTBPAefKZUX,KEGFXDBADDBE...aGEHJFDH..OCFAQBGAHAACbFFEhAAARAEF..FGADLEEChABABHHH.eAEFUABCIHBEhADA.SGACEEDG..cEAGhAAA.CGHF...hAEA...,2,-42,2,44
WaQHCVXBeUdLIfKFgJcYPOEbSZTRADGMN,GADFMDCH.aEGHCHFFBCBCdDCELCHF.KGDFJBFD....hAAAPCAFOEEBSGAChAAARDGHDEBBQACEhABA...XGACeBBGIHHHhABA.fFEGhACA..cGGD,1,-25,-39,14
fSZDMOFGXHVYATaJKWdQEcgRCbBPeILUN,aCDEKHBCQBAC..EGAFRCDBBAEGeAEELHDGUGFD.hAAASEEBMDCBOBFChABAXEGH.HABFhAAAADGE.TDABdGAGCEGHIACFfCHEDGIHhAFAFECD.....hAGA...,1,-3,-27,24
gUOVHdJLCTMfPXDeAQGSZacEKbBFIWNYR,SADCZCDHEHBCBFCEFAHF....IDABNGDB..RCAHODEAhAAAVFGD.dEFDCBFHMABChAAAXGBG.AABAaHCEhAGAbAGB....YBBEUCCA...JFADhAFA.fGEGhBAADCFGeFHH...,1,-10,-31,21
WYAXcFJgNITfHPRUGDOZBaeLKQSbdMVEC,XGDGJDAF....IEGEHCEDPAECRBBHGFDDZEAGBGGFhAAAeHCELAHBhAAASDAEdDDEMFIDECFCCACEABBEFCHHhABA.TBCBfGAGDIAG.KGHB..hABA......hAEA...,1,-4,-13,9
TQKAXfCNVIBWHSEGMaZODeLYJPdcUbRgF,CDAFVADHBEDA.HFFFEEFH.GBCFZGAE.ODHHDFEFLABB.hAAAJFHHdFAA.bFBDRAGDFDAHhAAA..TAGGAIEG.hADAfDBF.NABDIGDFSDDAhAFA.aGGH....hAGA...,1,-5,-21,16
XAfDZVUFPJCRBSgOdaTYHNKeMEWbQGLIc,ZFAEFGDFCEBBRFEABDEE..OACGdBDD..aAACHDEB.KABFEHDGQGGHhAAALCAB.XAGChAHAAHHFDADA...hABAPCHHJBHB.gBDF...hACA......hAGA...,2,-36,-20,16
BEPgCOAIcSWQHaRMfYeDNXKUGZdFTLVJb,SFCHHAAEMECBeDEBDDBF.KDGAZFEGdCDFFAGELAFC.JHCGhAAAECCA.CGHAAACD..IEAHhACAQGAAfBGChADAXDEETGGGBBBGPADA.hAEAOCFA...hBEAaHEE.NAAG,2,-31,-13,18
TKQPDcBYCJIRUOANaefSLHdVgXEZGFWbM,eCCFSEEDLEAHdCHC...XCGDEADAFHBA.MACCKAAGDCDChAAABDEG.CGHFRGCGOFHBhACAADFAaABH.HAFDZFFH.bDADTAFGhAAA....PCCH.JDFH.hAHA......hAIA...,2,-14,-8,6
MBEgZeQXTbCUFdWHJcLPKADYVfaIORSGN,DCEHVEEB..aBBARABG.GFEFBAGBZDAH..eEBEQGCHhAAA..XBAChAAACBADdGHAJCCFcBFG.KDGGhABAAIAE.IAEBOCFAMEAHEGAH..gGDGhACA...hABA...,1,-14,-24,10
ARXSEdYMeDBZVPIgHKFOUbLNcQCfaWTJG,SEHHdGBCeFDDBEAHZEFB....IECFHBDBOFHHLBCEhAAANBCG.CCDH..aHACTAGBhAAAAHBG.EFFHDDAAPCHFhABAFFACUGDG..cDEDWABC...hAFA......hAGA...,2,-28,-10,18
UaBCMKXLWbSZFdeETRJPQgVNOGcDHIYfA,UCADBBDFCEGGMHFALBBD..SBGEdDFBEGAG.JFAAQECAhAAA..NIEBODEEhAAADGGDHAFAfFGBhABAAACCKHCA.XABEWEHH.FBEB.eDDDhACA...PHAChAEA..,1,-12,-35,23
VPHXBFMCbATYEGcQOKUDWIfZNgJaLdeRS,EADDGBCH.QDGBKGBHDEAB...IAGFNDED.gDBDhAAALFEFdBAESAHHhABAPBFAHGFEhAAAFFFCMHDAADDB.TFAE.YACEOACHfFGDhABAaDDE.hBAA...,2,-22,-11,11
dLNWBcTIPgRZGYaVMOXJSfCUAQeEbHDFK,EGGGDICAKBBCLFCBBCHA...TBCH..PDDBRCEAZEABaBBHhAAA.MAIHOFFESGEBhABACHAGAAGG.QAEBhACAeAFDFDAEdAAG..WEEAIGBEhACA.....gGEGhADA,1,-14,-38,24
MJXSIRFKLOQCeGdBcNETPZAgaHDUYVWfb,aDDADFHBUFDG..VFBH....fCEAMEHHSCAAhAAAFCGGKEBB.QAEHhABAGBABBADFNBIEEFFFTGAHhAAAAEAG.........YAEGhABAJABEXGDHhAGA...,1,-22,-35,13
bVdYgCEFaSNZLBWOeXGfHUIRTKMADQPJc,DCCBQGCG.JGFEVAFB.dEEFCBFCFEED..aAHFZAAFBACChAAAeBHHGEGCHCCF.REABMBDHhABAAFAH..cBFEhACA..YHDCEEAGSADBLAEDhBAAWHFA...fGAAhAFA,2,-25,-11,14
bUHeZCBLISFKDGPEVMdAXYfJRagNWOQTc,XGGDJFBA.RDBC.aAHB....NDFG.QCDC.TEFChAAAcACCHBAHeAFDhAAABHEESAGAhABAKDHBPAFDMDAHdGHAYCHDfADHOHAChADA......hAEA...,2,-25,-15,10
QRPJKSdTZfNbCMHgALVIDOUXFWYGcaEeB,LBGDDGFAODAEXGAG..FFCAGAAGaABGBCGDQGGDhAAARADA.PDCBhACASFHBTADG.fEFEhADACAHGMIEGACBFVGAEIHDB.WDDHhAFAECCGKEEENBIC....hAAA...,1,7,-33,40
fWZHaJSTGgCEXdYRBcMVbFKPIDAQNUeLO,QEEHUDCEeHEELBFBOHAEZFAAHFAH..SAADhABATEGFCBBBdCACRADDMAHD.hAAAFGHDICHFAHEH.hACANABF.fCBFaBDC......hADA......hAFA...,2,-22,-6,16
EBWSLZPTJgUdCVGFYeNfIXDHcQaAOKbMR,OCEDKBGHRCCFBGBHLCCH.ZBADJEFHdBGA.CFHC.FDHD..eEFHhAAA....NAEH.fHAHhABA.IFAAhACAHABDaGDDAHEHEADAPBAH....hAAA.gBEDhABA...,1,-20,-45,25
CRKgabIUEQfLMDWBHSAGFdYZPecNOTJXV,GDEFFCGBdDCHZFCFeFBG.OCAH.JABHCADAKGFB...aGBHIHDChAAA.EHAALAABhACAMIFCBAHHAAHC.hADAPBDHTEGFXFFCRAEH....hACA.gBGGhADA...,1,-19,-34,15
bFZJTGOfUdPKNIHgDBEeQWCALcVMXYSRa,LHAAVBBD.MAEDSAEERFDD.FCGFJDCDGEDEUBAHdAFDhAAAKFFCHFBFBGHA.EDEEeFGFhABACFHH..AAAH...hABAXEEBaDAH.....ZBFEfACDhAHA.NAIG..hACAIHHHDDBH,2,-17,-7,10
ERTJdGHaCULPMZYAfXFDSQNVKbeOgIBcW,FFDHQEADKBBE.OCBABEFEEDAC..RGDEJBHDdGABHAFA.hAAACHHALDEEZEFAfHGFhABADCIB.SHAAhACA.NAEHeCEFcFGEWADGaACAMAAFhABAABBC......hAFA...,2,-33,-3,30
QFPgXdCTHIcOJSLVMbfeZADBERYWUNaKG,EGCDRCBCUAGAKECA.GEAEFABC....XBDDdFGCCFED..TAEHhAAAHBGFOFEF.hABASHGEMFIDfDFChACAeFABAIGGDAECBBBANAACaAHF....hADAPHDCIBFG.hADA...,1,-11,-27,16
AZgKWfJNQXcTYSVeaLdFbDEHOMRPBUCGI,ZBABKHEA.JACAQAFC..XDFHTEBE...SGGEhAAAeBDDdEAGFGGEDGAFOCHDhABAPAAGBEFBhAEACGCFADEB.fHAF.cGDBYCCEhAFALAHHEHCC...hAGA...,2,-41,-5,36
UaCMJBcLPRIgVAXdNbSETDQHfeFWKOZGY,XEDBdCCHSEEFDCAH.HAFGFFCHKHAGOFCD.ZFFCGAAFhAAAaFAD.MBGDBBAHLAHFhABAIADGAHHFEFGAfHEDhAAAeDAH.WCGDCHEC......hABA......hACA...,1,-16,-25,9
XSeGPDTdMHYEKWaNQZFRfIgALBJCVObUc,BBDFCEHG.OECAUGDD..SAABGGCFTFAFdCFHHACCECBF.hAAAKDDF..aFFGNEGG.FDGEhABA.RAFG...fDAHhACAAFIB.JAFCcGGA...eABChAFADGCF.WHAGIHHGhADA..,1,-19,-25,6
DMFQgdBUNfJaRSHVEATIKOcXYPeWbLZGC,TBGAKBCGOEDF..XFBGeAGBLHAGCBAE.FEBDdGFAUGFDhAAAJADHSAEBhAAAHBEBABBE.IFHChABA..YDADPCCH.WBHHZDFEMCAFhACABBAG.NEEGaAGG...hABA...,1,-1,-23,22
eCWNbTRYKZLVDaEfPSUBdHFQJcgXAIOMG,MEAGCBAF....NCBG.bBCE..RGDAKCEHLEHF.aAACECHBSFAGhABABAFCHDFFJHAAhACA..XDCHhAAAAEFHGEDAeGBCYADEDIAAfAGA.hAHAdADE.FHGE...hAIA...,2,-17,-13,4
WbEKSTQHXLfeZMUcAgNDOYVPFdGBICaRJ,DBBGOEBD..VDFDdDAABEHF.aDDCJCAA....EAGFKFBGhAAAQGGFXAFELEBEhABAZBCGMIDEAAAD.hACA.NIEH.FFDH.CACA.RGCCbADFSFFF.hAGAfBHCcFGD.hAIA...,2,-28,-20,8
DAHLgRWZOBMFIEPGVQJdeCcUYNTfaKXbS,HDCBREFAZAFDBDACMICAFGHH..EFACGBCH.QCAHhAAAJHCGeCDF.CEHHUEEG.NABD.hAGAaFCEKCGASABHhAAA.AHBG.WBFEIHGH...PAHFhABA....hADA...,1,-4,-36,32
aMSHNePdDQFYbEBfWLIXGACZJVRKTOgcU,JEEBKEADOEGB..UDAEMBHHHGFE..eBDDDBGEFDGBEGCHBHAGhAAALCHBGCBChABAAEDACCEA...ZFEHTBCEhAAAcADF..SABFNEIC.dHAB.hACA..bFAA.IAEDhADA.,2,-30,-12,18
MBXePCaSIAGYcQFKVHODRNdTgfbJLZEUW,GAAAQBAGKEGDHECARCFHdEBF...TGBF..bFBDJHEEEAGEhAAAMEAFBGHD.eFFDhABAaBFESADDhAAAIACDAAFHFCDGDDDE..NBIA.fDHA..hAEA......hAIA...,1,-12,-15,3
GcZOSDgEVWQLRTfKCPIdHeXMJYUaABFbN,FBBCGADDOHEESBBH.DGDBEAFHQEEAREDEKHCC.IHEGhAAAeFAHMDDCJDAFUGAHhABAAGCGBFHF..NDDBZEGDhACA..gCAG....hAAA.WABE..fECFhADA,2,-41,-5,36
VNEHPfDRYaTSUbgWdZeCcAKFQOIMGBJXL,KABCFBBHQGADOFBGGFDFBACA.LDFBECDDHAFEDAAGaCCHUECChAEA....WCHBhAAAdBFDCHGG.AAFA.IHAEhAEAMDHB...JHFENEIC.fBEGhAFA......hAHA...,1,-20,-28,8
PQgTVDeSZOaXBbEdIWfGcHALFYJKCRNMU,LBDBJEBE.KGEGCFEHRBGBUDFC..QGGD..TGAAhAAADFAHZACFaBACBBAChAAAEDAFdAGB..fGDEhABAHFCHAIEG.FAEEMCFE...gGGHhABAeEFGOHAE.hACA..ICBA,1,-22,-26,4
DMJKfVEdNbGaAIFgReTUXBcSHQOYPLWCZ,FDHFeGFAUGAFBBAHHECAODFDLAAF.ZGFCMDBE.KAHDEDBAhACAdADA.GGAHAIGGRAEG.hADA.XGDDSFDGhAAA.YAFDCBBBDGGCfEAGNIED.hABAaEEA.....hACA...,1,-4,-25,21
OJeVGgSYFUCRbLcPKdABNaWIfQZEHXTMD,BACCaAGG...IAGAZBAEEGDDHFEG.MBIBJGFGGEBDhAAA.SDBChABAFAEFCCGDRDAD.LAEBKHBAADECfEEHhAAAXBGADIEE.OBBEeHFA..hAIA...YEEChBAA..,2,-19,-17,2
CLHDVeafcXYZPNFOIMRBQSGUKJWbEgTAd,LECGHDABDFFBaDFFXGED..ZABCFACAMCIDRAGDBHHBGEGGhAAAUBAAKDDH..JFBHbGAChACA..EEHDAGCGCHDHeBEHhAAA....fAED...hABA......hAFA...,2,-24,-12,12
EXUfQNKOCGIgdSJFaAVDLBePMcRWZYHTb,VBFBDFGDBBHD..MEDDRBCGZGBE.HCFETGFF..ECAEXEEChAAAQEBH.OFHBhAAAIACEdAEB.SFBBhABAaFEFAEID.eBBD.WAHB.YAEDhAGA.fEHGhBAA,1,-17,-27,10
XHVcDZYUGNEQLIbfRdgBSKeMFOCJTPaAW,XEGDHEBFDBEGUDDFGEDA..EGEALBAA..fAHChAAAdBEESEAFhAAAMABGFGAHCHCA..TGADhABAADIF.cCFDNDHEIBCG....hAFA......hAGA...,1,-16,-32,16
CeTaIKMEUYGRdOJZgNADPWXSBfHLbcVQF,DDDDXAGBBDGBLHAG..VCDHQCEACGGF.aFFGhAAAIEBA.MIBEhAAAUACBRABBdDGCJBAFNDCAAFIFSGCGhABA.fAEDcAGAFGHBhABA.KFAH....hADA...,2,-28,-22,6
KXQbfHaGSRPCeMgZUTOAINcYBLVJDEdWF,..IHAFNEAA.BEGFVDEB..DBDEdACEFGDBKBGG..QCAEhAAAHFBBaHGASBAFhAAACCHAMACA.ZCBEODEFhABAAIFCLDGBJHFEEBFA.....WCDFhAGA.....hABA...,2,-29,-19,10
CDPJUVEGeRNadYSOKgHTAFIBLfMWcbQZX,FCBELBFHMFEF...bGACQAGG.CFAF.PABAUFGGEGBChAAAGFDB.NFAHaDCEhAAAdADBOEBA.KCFFhABAgBCAAIGCBDHD.WHBA.ZCGDDCAB.hAFA......hAGA...,2,-20,-12,8
JGMBCODHQKUFXYNefSgZRAWbLIEcTaPVd,LAHDEFFE.aBEFdBFEGGABCEADDGADKAACFGFG.....XDEGhADAeBAFfEDFhAAA.SEGGhABAgFCEAFAHWCBAIHFF.PDHFMIECBHHEhACAQCBE.hADA..YHBA,1,-16,-28,12
ZXDHLWJdBeSGTcQERMFabCUOIYPfKgNAV,VCFHDCGBLAEG.dHEBBFAAGDBCQBCBMBAA.aADGCCCEUEDGhAAA..OHFGhAAA.PCABfGGBhABAKGBHAGGEZFCHXGAHJAHFeDEDSAHHhACA.EDHH.FDAB.hABA...,2,-18,-4,14
KHJcIVTXDNeCYFMbLPaBAZWUdEOQGSgfR,ZEFAdCFDEAECGGDF.SAFGRCBAHFEGJEAF..VCBFDIGCCEEGMAAChAEA..LAAAhABABCHBAHAAOBBAQGCChACAfEDC..IAHFNIABFCGHaAGAWDFAhAEA.....hBAA...,2,-15,-14,1
IMagNOcQVWELbAUGTZBfRSdKCXePJYDHF,TGADBBAGSDCB.dBGHXDBHeFEH.PEFCDDGFFDAHhAAAaAED..OHFChABAQFDDECEHLGAAhACAUGGCfBABREGFCBDA.YAGH.hADAMDAH.NAADWBDDhAIAADIB..KBBE,2,-22,-7,15
LQSceIBHKGfdUZNRTVaOMbFPDCEgYAWXJ,JCEGQGDD.eAFFBBBEHDADGEACUDGEZFGDRABC.aACAMEDChAAAFAFE.DAIB..CEED.EFFDhABAAHDH..LAADhAFAICDEdGEF...NAIG...OFAH.hBDA.PDCD..hCBA...,2,-25,0,25
JCKGUEBTVaDFMcIdXRPbQONgHAWZefSYL,ZCGFeEFCSCCGLECHKBGGUEABBADA..VEEBaDABMIDChAAAdADGRGAG...QFGAhABAOABB.HABFABIDfGHEhAAACCFGEGADFFEHIFBCXBEFNIDF..hACA......hAFA...,2,-18,-1,17
RgZEVNJdAOMeYfaQPKGSTXBIbLcHDFCWU,MEGBeDFH..aCDHKFAHGEBG..TBDBXAGBBHEDICBHhAAALAAG.DCCHCHEDRADAhABAEHGCJDHHAIAG..fCFAhABASEAFHAFGFGHH...WDHF.hACA......hADA...,2,-25,-12,13
YDTfFeaCVMWORcHUALgZQKNXEGbIJBdPS,LBHDZBBFKFGB.EDBEGEAC..IHFCJFCCBAACdGCH.SAAHhAAA.DGADhACATADBFEFCeAFDCAHAMIEGhACAOADH.cGGFADHH...NEBC.PDDAhADA.aHCG..hAFA...,1,-12,-39,27
UMQgPBHDaNCdTYZfbSJIeXVEcFRKAGOLW,LBCCUAAFMAEFQCEBBFGF.aDAGCGEE..dDFFZFFD.SAABhACAJGBC.IHHFhADAXAGB.EDBEcGAHhAEA.RDCFAHDEODAHgCGHDCIF..hAFANIBH....fHGHhABA,1,-21,-38,17
FBDdSXQgeIcCfHaYKVMUTWELAPZRNbOGJ,ZGBARECDOHECGAEFBBEASCED.QABHIADDCEHDaEGBhAAA..KGAGUDACEAAE.hACAAHIF.....bCCChAFADHFAdAGG..eFCCfGGB..hAIA......hBAA...,1,-16,-36,20
DPCdEbXacBIgUJFMAVKfHTeNRYQLZOGWS,KHFEHCEGeDAAREEBQFAHLDECGECGDAEGCDCB.EAAE..bADCaBHFhACABABD..IFGEhADAUCAEFEHBMFIHAGIB.hAAAfADANICD.YFBF.OAFGhBAASFCB.hBFA...,2,-13,-9,4
TeZWEMgXOYJISUDVbLGfKPHQBaCdARFcN,RGEGFHEC..TBDBZEDAMDAB..OCAFJABA.SGAChAAADAABLCDAKBHFHABH.hAEAaGCDABFGeCHHEDFFXEGHhABA.IAFGVGAAfHGDhAFABHAACDDG.NBBE.....hAGA...,1,2,-32,34
PULBXaJOcSFgHCNMWTZeDbYdGARVIKEfQ,RCAFVBACKEGH...QFGHLADHBFEG..aCEBOFBFhAAASBHBFAGHHCEBCHCAMFEBhAAAZGDGDBIFdDFCIHAAhABAEABG.UEAF.JADGNIEF.eBGB..hACA..YFAFhAFAAIFG...,2,-23,2,25
fRUDIBgXMaAOCKNbGQJTcdPZFSVeYELHW,KAFBGBDHQFDHJDFE.dDFEZDBD.SEAFVDAA.EGGGLBHFhAAA.fHGHhABADDEHICAGgBCBhACAMIFEOHBANIAF.TABE..hAAA.FAHF....hABA...,1,-14,-22,8
GCKDfNFIBaJZecYAOHVWXLPRTdMUQSEbg,VABBLADC.TFCGdEEFMEAH.UFDBQEFG.SBABhAAAECGG.gBGChABACEBBDIECFGHDIGBHhAAABCEFJHDGcDDHABFFOADG..WCCFhACA......hAHA...,2,-28,-26,2
fNLKDZCGABEFSPMUOHVagIeTcQbWRXJdY,BBEEFGAAMBBEHGCE.VDAH..ICFGeDEG.QFFHhAAARFGDXABFdCCE.fEDAhABANBIC.DBFGCAGGAFFFhAAAEHDG.SCAGOBCDaHACcEGA.hAEAWAHB....hACA...,1,-9,-30,21
YRcOPJHSXbNWDKQBdFVCLMTEUZfAGIaeg,GAECaGDD.eHEERFADOFFFHEAHSBAD.XDDHhAAANAIGDFDFBABFdCCEFAGGCBCHLADHhAAAEDGBfCHEhABAAHHA.gFGG..PCGDhAFAWBBC.KCBF.MCFB.hACATAFD.,1,21,-25,46
SHNEPQBAgfFceROVYXTKaLJWGDZdCUIbM,FGHBRDABOEHF..VDFB..TGCHKDCALFAHGACBZDDEhAAAUADBMFGDHBABECCFBAAFhACAAHAA...gAGGhAEAcAGE..XBAGJFDFDDID.CHEH..hAHA.SGCDhAIA...,2,-20,-6,14
PCKeVfaMEbWODSZQHUAcITYLBGRgJNdXF,TACHLBCB.RCFC.JGFCdCAD.FGHHKGEF..eFEDaBGF..EGCDOFAChAAAZDDC.HAEEAHAB.hAAAIFFBBEAANCIG.CHAAMABChAGADAEC..SECG.cBAAhABA.....hAHA...,2,-27,-18,9
OfIcEXDgMBHVAeJWLQaGdRbPZTYSFKCNU,eCBALEFCQBGEdHAFRFDEZAAH..SFCCKACGUAGC.IAEDhAAA.EGFBDDDHBEGHhABAAEACaFAEbGAE.TABEhADACHGE.OCED.XGGBMIDE..hAGA......hAHA...,1,-8,-34,26
NHSUJGKDOQMVFcEYZWRTBCbLAgeIPdfaX,eCCFdABHaCABHCGH.UFDAKFFEDAHDMBCG.FFABEGEF..ZAADRGAEBAFDhAAACHGCAFGB....IHBGhAAAfCCHSAEEhADAJDFEGEAB.......hAHA......hAIA...,1,-22,-28,6
AFcSRgeDbBVPQJNXYKTEfIZGLOMWdHUaC,FDEHSEDDeBGHDBAHBBDH..QGFGJDBH..NHBD.KFBFhAAA.EBDGZAEDOEHDhABAdEFBaGHFAEAERBBB..VAAEhAAAXGCH.YAFEIAHD.MEAHhADA......hAEA...,1,-13,-33,20
ZLSUGXWEeKYJNORDBbdafHcMAFTCVIgQP,FBBHTDGFCBGC.....VDCAIFFBQFACZEDDLCEGhAAASAGHUGAGGABBhAAAEACC.KGHH.YGDGhABAJHEGOCHDBCFDaDCDfCAEMAFCACAB.hABA......hACA...,2,-22,-5,17
IScJBZgYPXRNDHEGCMLWbFATOaUeQfdVK,OCDBeAAGQGCEdGDDKAGH...SFGBBGGEZAAG.gFAFhACAXEGEDAIHECCHCCGEhADALCEBFDEF.AFAC.hAAATGEFUGAH.IBEA.JAFA..hAEA......hAIA...,2,-33,-13,20
gFHISCaPRbTGfVBDeWYAEOXJdNUZQMcKL,EHDEXEAGdGBAZDDD..QBGEMACDLBDGFEEEHADD.CCCHaAAChABAPFFF.TDAAhAAAfFHE.DCAEhACAWBHFADAAOFDB..NDIEKBADSHEAhADA.....hABA...,2,-22,-5,17
TfNFMRQEgCbHPZDYASOXWdIVGKecJLaBU,XCEGdFFHGDCBKEGDeCFE.LGBGUAAE..TEBHFFBAMABGhAAARAEE.ECCCCHGG..HGAAhADAPAFADIDCAEFFOBBGhBAA....WEHHIHHG..hBFA......hBIA...,2,-25,-11,14
gUQcdFANGHYCDVREWJXLeMOSBIZTaKfPb,HAFADGBCEBHDJGFE.LCEDeCCG..MEECBBCE.ZDAEaABEKHCG.hAAA...PBAHhABAgDFDUFGHcBEFhACAAADCGFAB.CBAB.WFFD..SCAAhAAA.IHAHhABAfECD.,1,-13,-34,21
UefdAcgHSPJTaBORNZDXQGWEYKLVFCMIb,HBEEJADABABHRFAEZDEG.DBAFGDED..ECCDKGABFGDD..CGCC.MAEChAAAUAGEdGHE.AFFG.SGGDhAAA..hABAaBHFOBDBQDAHLFDB.IFHBhBAA....hBIA..fHFF,1,-13,-39,26
YPeUfJSKagODcQNMTLdWBXEbVGIRCZFAH,HEDAeADEUGAEJCECKGAG..aCCGDIDA..QGFEMHEA.LEFEhAAABEBGEAFAbBADGCAFhAAARBFA.CBAAFDHDPEDHhABA..SABE....hAEA......hAFA...,2,-27,-7,20
AMUaeJGfdVELPHFWKRZBXNcCDQITgSYbO,aAGHJAFAGFEH..VEFHLDBAHBCHFBAFKADGBBBG..hAAAXFBCCCFDDIEC.IAEBhAAA.TGDFhABAYHCEOCHDAABAMEFGeCEF.dDAD..hACAECGEWHAGNDAG...hADA...,1,3,-37,40
UXPdMOBNYEgDeVRAWcbfKHGaQSIZLFTCJ,...bCFBHEEF.QCAFSHDEIFCCFCCBCDEH.UBGHhAAAdBHEMEIDBHDEEBCEeFGHhAAAABBF...fBAChABAKHBAaDEBLAEEJFADXBDBPHFENAEF.DFBHhABA......hACA...,2,-12,-6,6
gLANDdTUGQBPfEHXSORYZFWeMJaICbVKc,DECFUFGDBBDAEAGAHEAB..SHGGOCBEZDFGeFDA.aDBBhAAAIAAG.CHFDKACFhADALCHFAFDG.NBAGdDDGhABATGCBQGAGPCEA.fBBHhACA.....hAEA...,2,-21,-20,1
fJPWGXAMZUTaVONEYKFQSDCHecIgBbLdR,UAGFVEEG.EDCE..KFAEFBAHDIEGHBEB.eGFA..IDDEhAAABDGHdHCHRGAC.JFADGBDDhABAAAEFZECC.aCAA.OABEhACA...NAEDSGHDcAAA..hBAA......hBGA...,1,-18,-24,6
SJPDQEGgBCTdFOLZfeNVAXbcaIHRKUMYW,XBBDaFAAHEFAKACEUCFH..MCEB..SHACDBCHEGABBHCEhAAACAGAFADGOBGFLFFEhAAA.ZECFeGDEABAGIGGChABA..YBAF..WCADhACA.....hABA...,1,-23,-28,5
LXRPVKJQBdSNHbfaAITCeMGDFgEOUWcZY,CDAFGDFADEBF.FHBC.EFCBUDCG.ZAAGXCAC..RAGFKGBHhAAAJDCEBBBFdFHEHCEBaAGB.hAAAAHED...eEAHMFABhABAOFEB.YABC..LGDChACAPFHD....hAEA...,2,-28,-10,18
IDJQBeOELXRTSCgYcWVKdfaNbAUGFZHPM,FBHDHFFHMFCGJEBABDHD..EGFALCAERADG.SGCGhAAACGCB..cCBEhAAAKBFBfAGDaDAH.hABAABAG.GDEHIAEFDIGCQGAGhACA......hADA..OFHD,1,-22,-24,2
ZRNOMQgDLYAaSWXbIBfCGdETKUeFPJVcH,SGFCXBBGBGAGCBBA.GGDBdEDFEDGCUAEF..eFDFFDDAJCHHhAAAHADB.RAFDMFIFhAAADGGGAHID.aDAE..IFCFhABATFAAKAHB....cDAE.hABANIAD......hACA...,1,-10,-25,15
WBFYUaQCXeDLTfJZMHOAEIcVPKRSGbdgN,ECAFVFDCKDCF..GCAGdHAD....NDGG.BAHC.FDDCaFEHCCGGDDIHhAAALBHF.TFAEhAAAfADC.hABAMICCABEDIHHBRGACSHGEbACB.YABHhADAXAFF..eAFFhAFA..,2,-31,-14,17
UXJOeGWbASMKdHBIZCNYVcaDgELPfTFQR,MCFHKEDAdFBGBEDHZABF...CHBB...VFGFaBGC..DEBBLAEBhAAA..fEGGhAAAFHDEQCGHRBACUGDHhABAXAGA.ODACeAFEWADBAAGESADDhBAAIHHA..hACA...,2,-40,-16,24
CSPUOeBZfNWHgFTMLcdKEIbGDXQJRaYVA,CBAASAFEUFAG.eGFABFFBZADF.....NBCC.HCGBFGBCMIEChAAAdADEEDDD.IGHBhAAADFEFJEEA..RBFGaBAHhABAADFAOGCA...fAGB.hACAWABH....hABA...,2,-46,-14,32
PBfIXOWEaTFRCgNVbYHcSZAQMDUeLJGKd,MFFEDAHBUDGDLADEGDCGdHED.BBAC...XCFHhAAAEABETGGCCFDC..VCBGhABAHFADZFBHQBDEhAAA.JFEDfGGBIDADaAFFFAHD..hADA......hAEA...,1,-14,-17,3
AJSVMdgZEIfcbNGTUYXHeLDCBOFRaWQKP,JCCESFEC.MCCGdHBBEBGB..IAGA..bBADhAAATGCGUGGFXEBEhABAeCGBDFAEBGHC.hACARDBEWAADPEEEAAEC...ZACENBIA....hADA.....YAHHhAEA,1,-18,-35,17
aKNGSLBMVTIDgCYQeZUEJHfORcdXPbFWA,KEADSCFDBFEG.MCCH..VGBCDIEECEAFeBCA.ZCFCEDDHHGFChAAARFGB.dABB..PGCEhAAAFAHHAEEA.GACDhABA.TCGDgCBGUGAAfAHEhACA..OFFGhAEA...,2,-21,-3,18
cZgFDVLeYNQCEIaAXdSJfWbUBPOTGMHRK,dDFGSCCBJBAH.....bFEDUGBBBADDOEABMECFRAFEKGGGhAAAZEFF.DFAFeCDCQBAAhAAAEDCB.aDGAAHED.hABA..fEDC..WHFG.hABAPBBA.HCGBhACAFEHH...,2,-33,-2,31
RcZHMUCdFWLaJQEGKfABXYDTbVOINgPeS,XBGEDGBG..VFFDOFEH..ICCG..NBDCPABHhAAAeAFCRAACZCEGHFAEhACACEFF.FGGCLBHBhAAAaFFGQCEDKDAGAHIBBADEYAEG..gGCAhABAMIFGUDAHdFAGhAFAEDHD..,1,11,-18,29
XaGTFIgQWPSOBCcRdMDHYVUfJNAEbKLZe,EDHDLGFGZBDG.eBAEGEBFFDAB.QABFSHBCCGADRFGHDDGF.hAAAHCDH.UAGHNIBHAGEEKCABhACAXEBD.IEHAhAAAWAEC.OHDC.BACBMAIH.hABA......hAEA...,1,-10,-14,4
XHRSGNKWFDfTeAEgbLQaIOBYJVCPdUMcZ,EDCCLCEA.QEEAIABGOHEGBADGJHFG..CDHEdDAGhAAAMBCHZGACHFABRDFFSCDEhADAKAFBDAAHeDHF.hAEAAEAEaFCFPFBC........hAFA......hAGA...,2,-24,-16,8
fCQXaEWSdAJRcNgIHDMUTOeVBbYLZPFKG,RCFE..NECD.HCCF.DBBFMBDAUFFC.eFCBBABFLFADFGCDKFGHCCDBhAAA..XACGhAAA.EBGEdFAFAIEA.gBGChADAOAEG.bFDB.......hABA......hADA...,1,-15,-39,24
NfGFeTUgRXJBZOcEHPISQaYDdCWVAKMLb,MIAG.LDAENCEAFGGD.eCEDUADHRBGHBFHDZEAH..EAGCHGEAhAAA.SGAChABAQCGGDFCGCAAFAIBEKBFFGBBChACAgACAOEHF.IFFF.aGDHhAEA..WAFE..hACA...,2,-18,-10,8
EgJXeFGLUfcOCNYKRaMZVSBWdPDQIHAbT,EAGCJCDH.FHDEUEAB..OBAC.CEFG.KBEB.aGGFZDBF.BEAFhAAAdACHDFGGQGGDhABA.HFABTGABgEDDhACAeFFDGAAA..cADCNAIG.hAAAMCIBSGCHhADAWDDEADHF...,1,-6,-32,26
HLCaPGJAWQDKZOgfYMRScFNbeBITXVEdU,DDDCOFCB....fGCFRBCAFBADeGFCBGGF..TDEEhAAAXACFdAGHLEADhABAPBHHGAAEAEIDKHDG.hACAgGAFSDHFNECB.IHHEEAEACHFGWEFAhAAA.....hADA...,1,-18,-22,4
LHCZXeSYNMBKGPfgJdVAcUDREWITQFOba,UFAHECCE...TGFCQFAG.OADGaDEGHCAFZEFASFDBhAAAMABABHDEKBHDhAAAfDBGJEFA.AHCEDCAFhABAICCAFGGDCDGC.XADENIBD..gAGHhACA..hBAA...,2,-20,-20,0
cHFJMNROTKAYIgUCSQVXDBbEZafGedWLP,..IEFBCFHHSBBC..VFCEBHBEEBEBZCFGGDAGeACELFFBhAAAHAAGFGHHNAEFTCCChABAACIH.UAFCDDCEaHEEhAAAfECG....WCHD.hAIA......hBAA...,1,-5,-26,21
LTOFCRAgEMbcZWefSVNdQDKGPaJIBYUHX,EGBFMDAHZEFE..eEFASAEFdACBDGCFKFDFGDCE..aBGCIHGChAAABDBH.HAGHhABATBAHFBBDAFBH.gCEChACAbCFC..fHGHNDAG.JGEEhAAA...YFABhABA..,1,-14,-18,4
JDXfTWaCUYeNIAdBFMGQRSHPcEgKOZbVL,BFGAMBADRBEEHACF.EFDBKCBAZBFHLHAA.DDFDXDEHhAAA.fEBHhABAaHGACEBEUGEANAEH.AAGG..dEHEFBHFhACA.SBBF....gFAEhAAAOFHD...hBAA...,1,-17,-31,14
VLFaSXTWDgCJfRUGQOHIcEYNKdBPbAMZe,eCHDVCFF.LAEB.SBAFTGBADAFFCCBA.RDBEGAAFhAAAHEBFEGGHKGGHBFEBADIFMFIBhABAaAAAXDEA.hADA..WAHBfAGDOHBE....hAEA......hAIA...,1,-4,-23,19
HUJCLWIFPGZdAMTXSYaKREQbceOVNgBDf,XBBEaBGA.KHECQAAC.eECBOAFG.NBHABFBGhAAADIDEUEGG.CEEFIHHFhACAFFDGZBDBAABHMBIBhACATCCA.RAED.EDAHbEADgFGG.fCFGhADA..hAEA...,2,-30,-13,17
gQCeUEHXFPJbNSVIWcRLaOdYBAfZKGDTM,KDFHTGBGQAEC.UDBEEECEFBDD.JCFASAAAhAAA.VFDGIHFBhAAARGAGOHFEBDAB.AEGFfAGBhABAZAGHDAIFCADD.XEED.PEAHhACA.NEHE..cABDhAEA..,1,-19,-21,2
OgcNQJRAdfCTIKULVSHBabYMXZDeFPWEG,CHCFTBEEUECD..LFAHSEBD.aDGCMEIF.ZAACDDCAFAGEhABAEFFG.OFHD.hACANHCB.JHDE.ADGFdBEAfBAChAAAKFGHBFFFYFAF.XABFhAEAeDAC.....hADA...,2,-26,-12,14
UWOaPBGVedbCHERLcTXgFNDYSAKZIfMQJ,KFFHZDDHMBBGQBACUDAC...aDCAGGADeCFE.dDFHHEBDEGHHLFFBhAAAXGDGNIEHDCAGhABAAGAC...JAGDPAFGhAAA.BAEGCAEE.cDEE.FACFSECBhACA...hABA...,1,-9,-13,4
YFPGTQVSaUXgdAHEWebJNDBRZLCMfOcIK,ECGCeGCG..JCCCBBGCZFAE.MBDH.OFFFKGEFFEFFGBEA.hAAAQDAHSGHDhABAaABGUDACdGAAAHHA..hAAAHAEENCHEDIDECBBFfDHC...hAEA....YHAGhACA.,2,-34,-10,24
EVTRQfWYeUNKMHBbacOXPIJAgCFSDZLGd,CGBGDAGAZGFALDCDGCGA.EDFBRCCA...QGDE..YBAFhAAANBIE.KAFDMFHFhAAABBCEaFAH.XBEAhABAIGDFJABBAAIDSHAGdADFfEDBhBAAWEBA.....hBEA...,2,-32,-17,15
JGXMTACDOHSIEacFRdZbWKUfgQLNePBYV,OAGHSBDC.EAAFFHAG.ZEAGKDDFUFGBQGGELADBeCEChAAABCAF..YHAAhACAGCEAMICA.hADACCCFDHDGaGBAdCBA.fFEEPAAE.XEAChAEAAHHD.IEHHhAFA.,1,-20,-21,1
gWTNKGIBPHeUYADCOSXJdMVZRQFcabfEL,DBAHCFBA.OFDGJAAD..dHCDMECCZEFB.FHGG....aBECEGAHLEAFhAAA..WCHHhAAAKCCGBEEFHBEEeGEChABAAFIB.SBBEXFDG.QDAAhACA.fHBFhADANAIGIHHCYAFC,1,-8,-47,39
DAQXgHMFbYJEUPZNGaTfcBIKVSOWRLdeC,QFDAXCFCHDCDMAAFFACB..JAHHUFFDZBDCGEAA.hAAAaCBCfAGHhABA.cAEGBDEBIAFFhABAKDHHVEAHWHCGdGGGDFIFAHIB.....hAEA......hBAA...,2,-16,-15,1
MagHQXNfRVGCKBPbJUEYZAcFeWOdSLITD,eDCHdEAASBCELABCDIEA..aHECHAGFQGGBXBEHhAAARDDFCBAFBHGE.PEFChAFAUAFCEDHBAGAG.FHBGICBGhAGAMCCD.gGBANAAF...hAIAfFEG.hBFA...,1,-10,-15,5
GDcNUFAMadLJZgSBObKYRPXVWefHEQTIC,aFHHJFCHZEGBBHEC..KCACRAAB....VBGDeBEB.HAGF.EDCChAAAQGBG.hABAIDCGDFBHNDAAAGFGMFIBhACAgACB.SEEF.OFFFhAAA.bAEBXEEChADA.,1,-17,-30,13
bOMREBgDaWICASUZJQdYXHLPeKNGTcfVF,ZABAJDHD.dAHCHEBCeDACKACGGEGG..TGFAVFCA..FGACMCDEhAAARCED.EEEEDFAEaGBFCCAF.hAAA..ABHD..SGADhABA.QCAH.XGDDhACANIBB.fAFFhAEA.,1,-17,-24,7
RDbMNTGVKdPQSXgfYUcOLBAaWFCIZeJHE,aEDGCCDBZBBHHFAA.RFGB.DEEH..MCCHGCFEdCACQAFBhAAASEBD.XBDC.hAAAfABHcAGHOAEFhABABHDBAIAGFHDEJCHFEHGE.NCAC...KGFFYDHBhACA.WHAChADA...,1,5,-32,37
XUCHMdJLgITOAEFWKDVRbZBNQSPecafGY,ECAEFGFDKDCDRFAH.BBHFQFFF.eABAaAACGFBD.UAEChABACGDAdAFF.JCCCLEEGhACATDFH.AEBDDIAE.hAAA............hABA......hACA...,1,-27,-40,13
SLDUPCOXfAcVabNgRBYMQIKETFGWedJHZ,VACGaFEG......gGAAREFFBHCFMCCDKCCGFHGEGDDGhAAAdCAGZGDEDAGCUBGB.hAAAOFABACFCbAFAQEBHhABAEHGA.WABAJBAFSHDAhABA..PDEC.hACA...,2,-17,-8,9
UMYINEaObGKWVDedHBSAgCRJFPfXZLQcT,RCGDFDDF..XFDCLDAF.TGGAMDAF....IDBHhAAAEAAAOBHBGACDKFDFDCCEhAAAdHAFBFFBAIAGCEBHJACEfDEBhABA..cFEDYFHB.hAGA.aHAAWCAE..hACA...,2,-27,-20,7
gUZcAdTVCYOMXFSLNPfKGRJQebDWaBIHE,dGFGTFCDCDEE..MABHSBAD.LBFG.fGFAhAAARADCeHBCbDAGDEEGBDGGhAAAIFAHEGHDUAGGhACAAAEDODAEFFCG.NEIAKCCE.JHAAaEGE...hABA......hACA...,1,-16,-20,4
PbNBGDcAdLJEVYUReFOXKHSTWQCfZIMga,LEHHEGCDUDAE.REBEFFFEKGGH.HBEF..SFDETBCACGADZAAHhACAMAIB...aABBNIBHBEAChADADDEG..AGAGJDGBhAAAeGBG....XCCB.fAEEhADA.IHAGhAFA.,1,-9,-44,35
VFGSBRKQLZCeONdHcfMbEUTgPIWaJAYDX,XDEEGBGGBAFHKDBH.QECBLABGeFBAOBAFHBDCMIFEhAAAEHAGUFGF..gFGFhAAAPABGICCHhAFAaHDEAACCDAGC.FCHFSGCDCFAC.cFDEhAHA.fDEBhAIA.,1,1,-25,26
YRKHUEIODZCJXaFbBWGVgfPLASdTNcMeQ,TFDFMAAC..QCCDKCHFHBEFEGCBOGEADBDB.ZEAG.XCGAhAEAaAGEFHGEBGGC.hAFAGAACfHCHhAGAAAFASEAGNBDFeHFAYBBDIHAFCFHB..hAAAWFFE....hAHA...,1,-8,-20,12
UIDKEPgMVSFeXaWAOYTNHCbZGdRQJfLcB,TEGCHACBZEBC.dAHAJHBELHDC.BCAFIBEHKCEHEFGBMBBHhAAA.FAHDeAEGXGGChABAAABF..NEIECDGDGDCBhACA.fACFUGAD.PFAChAFA......hAGA...,2,-21,-12,9
WGNgDVeKZPJBQMCAbTcLOSHdFIXRaEUfY,TDDBLCHD.OEDFdADHFGCBRFAH..EBAGUGEA...fCFHhAAA.GBBAhABADDCCeADEKGAFJEHHBGGAhAAAMBIHCDBDAGIFcACH.SCFHhABAIEAF.aAGA...WFFFhBEA..,2,-23,-21,2
GSWEYPBIUaLMcOTXbefHdKQRZDgCNAFJV,JABCSGCG.EBGDBGDB.aFDALFEA.MCCEOAFChAAAbDBG.eFHFHAAEKBBDhAEAZDFADFAENEAA.AEDCGCEDhAFAWHBG...IHAC....hAHA......hAIA...,2,-40,-4,36
CAFRfOaGgHINdSZVXUPWbDJcYQELTeBKM,FFEBRFGHODACGCCFHFCGdGADZBAG..UAAC..PBFCDIBAJAHBhADAQGGELAFDBCDBhAEAKEABAEIF..fABFhAAAaEEA.IAEBSHAC..hAHA..WHAA.cDGGhABA.,2,-31,-19,12
EdLYRCcNDbFZWfgVeKJTQXPBMUSIOGAHa,aDEBdGDCRCDH..CEAH.DEAGFADAZGFG......fFFHhAAAVAFCeACAKCGH..JCHBXGAEhABABCAH.SBDGhACA.IBBCAABGEDFH....hAGA.cAGG.NDIAWGEAhBAA.,2,-49,-36,13
HaAFOYBeGDdUTMCPgNZbIRSQKJWfXVcLE,FDEDOAFBeBGDdGHAUACD..CBDE.....NIDH.IEDChAAA.SAHDhABAQGAGKGFAfGFDhAAA.XDAG.LDCBaCBEACABBHDBhACADABHPAHDgGAFhADA.bCFH,1,-28,-33,5
dOcDfYUKSXEegWHAFZbBNVCQGRTMPLaJI,ZBDBBGEHCDADGFEDRFBF..MAFFLABHaAHD.JCFCdDHC.DGGFUGBEhAAA.KDFFECAE.eEAHhAAA.HDDDAEHH.bABAhABANIED............hACA......hADA...,2,-33,-21,12
bOBXEUeJNfSDTPdVFWAIQGHLRcKYCaZgM,QEBHLCHBKFAAaHEEMGEC..OBADBAEEEACHeGFE.JAEAhAAASEDGDFEB.hABATCDEPDDCFBABAFHEIHAFhACAHCFBRGBCCAHA.gCGE.XACDhAHA..fGHAhAAA,2,-25,-11,14
GUXWSATPHeJFcVZKDOIfRBCQaEgYMdbNL,TFEGeFAEFDAC.ZGFCOAHB..IDFABCAFCAEA..EAAAMAIHhAAAdGBCLECBhAAAGACAXGBCAEIFJCDEKGHHfEHChABAQDAEaEEC.....YAGHhACANIDFSEFEhADA...,2,-21,-10,11
IHPMADfOQVTgZNcaRECdbWBSLXKFJGUeY,ODBDQFED..VFFHTEBEZBAC.aHFCCAGG...dAFHBBHHhAAALDECFGCDGAEChABAYBBGHEDHAEAADGABNEAG.hACAEABA.SAAF.KBHH.eEFGhAEAIADHfGCChAGA...,2,-15,-11,4
JKUAbfecOQYVFGgBRMCXaZTdIPDSNHELW,eFCHOBCHQGGGFBEHBBAA.RBAB..MAIFCDAHZBGBdBFH..DAFEHDEHhAAALFEEKGACAAEEfHDFhABA..hACAVFBDXEGEaAAGIHHDSADD.hADA..EEBA...hAEA...,1,9,-41,50
SFTLbgZKfGNCPHDVMaXOIAWUdQYRBEJec,dBGDQBEGRFDEBHHD.EDHH..JEAEeAEE.SCAGFBDELAAGhABAbGDG.ZGACGDBDhAAA.CBAEDHAEaDFEOEHFhACAAFFDUGGG..cCGBKDDC....NAEF..hABA......hACA...,2,-26,-2,24
RHXPKfBQbDZFUOVNGdAeCIJTcYSWgLEMa,CEGDJHCG....TCEHSEEELHCGECAH.RDBAHABA.XGGChAAAKAHHBCCDDBIBFGHHhAAAOFACGEABABAHIAFDhABA..cACCWAHF.MCHFaDAG.hADAfFFG.hAEAQBEC.,1,-3,-28,25
UJSCRLMGKWQZYeNgOfIFcPaAbEBDHXdVT,ECEDBBFFDGEEHGDE.VCDDUABD..CGAHLCABKGDDQFAChAAAZFGF.eCHDOAAAFCAH.hACAaCGAAIAEdAGH.SHGChAEAMCCD....WAECNFCD.IDGBhAIA..cCCChAFA..,1,-17,-27,10
bZdUEAJLBXeTIWYHNGDfQOgPFcCRaKMVS,JGFABAHA.eFEH..IBAFHBDHDCBH.QGGCOBEGFDDEhAAARCFCMFAH.SEGAhAAAdFAGUDGCAGCEXGBAhABATCBE..NIEH.fACF..hACAgGCACFBBaCCH.hAFA...,2,-32,-15,17
BCOVGUXcSRZFEHNIdgDPATLbWaJeKMQYf,LABCaBGF.KDGCQCADBBGG.CGFEOEDFVFAGGCEChAAAUAAB...SGGHhAFAFGAENICD.dCBEDCFBAHAB.hAGA..bCFHeDDDMAIBYHBG..hAHAfFHA.hAIA...,1,-19,-21,2
YZKbEdBHXWeFcOUSAgTICDQaLPfVMJNRG,TGEGCEACDEID..LBFF..fDCAMCEB.NCDHGDGGhAAAZDCFKHGCEHAABDACHAAChAAAXBBBFAHFOHCEhABAAGBEIFDC.aAFG.PHBC..hABA......hACA...,2,-25,-24,1
CcaBReIfXKDQJEFZAbVWdMPLHOSTUGgNY,VGFAMDDELFHF.HBABTBDBUFEHGCBA.gFDHhAAAYFABaCFABDGEhABAeECCIAFD.hAAAKAHBDIDCEHAGACCAWACA....OCABhACACAGA.cDFC.hABA...,1,-5,-19,14
BUeCRgIGOHNKYVFLSacDZJMAXPETfdQbW,XGFHEDHHdAEE..QGGGBEBDCBABRBDE.GDDGHEDF.KAABVDFGhAAASCGC.DGAGhAAAMIBA.ACAFfGABhABAUDACeACDIHAHOAFEFFHDaHDE..hADAJCCH.....hAGA...,1,-6,-13,7
bIOQVgWZdKYTScfPBFXeMUaLAEJHDGRNC,HEDGDFGDRFBA.CAAD..OACDQBDF..VBFCZBAHdEHCKHGG.SAFBhAAA..hABAfEBHBGEHFAHBMACFhADAaEGDAFIBJGAC.NAEG.gDEF.hABA.TCADXEAChAEALAFE.,1,-12,-15,3
LMBeZQGfTSDUVEHAJdYKOcFbaRWIXNCPg,JCCHKCCDFGCG..aGEDREDE.....XCGBCHGCLBFC.MABBhAAAeFBG.GADHhAAASBEDDDABEBACAHIFdFAEhACAOEHD...cGAHIHEE.NAEFBDAGhADAfEFD.hBAA...,1,-23,-37,14
aSdZIYDWgCeMQUXFOGPAcEfHJLbKNBTRV,ECBCJCHHLBCGKGEG.BGECRADD..SAGFdDBHZEDE.DFADCBAH.hAAAQEEHFAGG.hABAODHHAGGFHFAFNAAC.aHGEhACA....IFBG...WHCGhABA.MDDB..hACA...,2,-37,-30,7
PFVNZOcQeMdGHfDWgUBEARYJbTaKIXLCS,RACBJGEA..TEACKCBELCGD..SCGDFEAHZFCF.OHDAhAAAeBED.dAHE.HEDAhABADBIF.UCAHAFIHaABECHBFNDIEhACA..MAAB..WFGHBEEG.EHAA.hAEA......hAFA...,1,-14,-32,18
THIDRXBbgeUWOcEVLGNAMCKFJPdSYaQZf,MIBCFBDCdGGF..SFECQGABZCDAHCBBDECGBHFGeHCCOFDAhAAAEAGG.LBFHhABAAAEACBECKABC....PFGDhAAAaBBB...fGBB.RBFG.hAIA......hBAA...,2,-32,-13,19
RcSCZUKYeJbfEPAXILgHMVBGaTQOdWDFN,XEDCLHAGMCDGGGDH..QGFCdCBBDCFAREAB.CEFAKAFEeAAChAAAJBAFECHF..AFHEHEBHhAAAaCECOAEG..hAIANDECSDGEUEGB...fCCGhABA.IBHBhACABHBH..,1,-9,-10,1
gPeKTbAYDVMSGXdFEaCONBUIQRLcJZWHf,DEIDVCEFMBFE.GEEGdFGGEACG..aCAFCGCABBFE..IFAHhAAARCBBLFADZCEGHDCBhABA..fAADhAEAgADFeBHF..KABBAIDGSEHHhAFAFHGGOHAE....hAGA...,1,-4,-24,20
GFRNadbMASQCPgUDfIVBOWeKYEcHJXZTL,SCDGCGBCUAEB.DCHD..VGECBDAF.OFCCKEEE.EHBCJBBBhAAAZAAE..LDHHhABAFGFDaAFB.dAHC.AFCC.gEAChAAA.fEFBWDDC.eEHHhABA..cFCEhACA...,1,-18,-44,26
TgPOIJBGQNUVaZfFeCdAcLWDbKXRSYHME,LCCCDHFCKDCH.SFHFHAFGMDBHEEFA....TGCBhAAAPAFAJBBABAAFGEEDhABANBBC.aGAHFHDC.CADGAEEEbCFEhACARFBC...OADG......hAIA......hBAA...,2,-25,-10,15
QPVegYKNRSCIDbXMUBGJfcEdLTHWFaZAO,QCEGeGCAKCGDRBAG.SGBE.DEADMFIBBHAFJEAEEAAHdAHChAAAHGFCFEDE.ADBEOHBChAAA..PHEChABAYBFCCGAE..bADBUEGH.fDCChACA.cADG.hACA...,1,-4,-28,24
GIaZCJbWeOVfQHSdRcATLUPXMDYNFBEKg,TCACLGEG.UAGDMFEDDAAG..FFGEBEFHKFAAGCCAZCCBCHAC.hADAJABG..eCEHOAHFhAAA.QCFBhABASCBHdHAHAFAEXDGFEAFBgGFGaBBB.hAEA...WHCG.hAGA...,1,-8,-29,21
WXEdgDbZeBGHfQMFYNaUJCROTSLIcPAVK,KGACXEBHdCCDDFBAZAFE.BEFHGDED..QFDCFGHD.hAAAaCBCCFFGRAEC..OBBGhAAALHDCIHHBhABAADBDEABC...eCHDMAIHNDAC......hABA......hAEA...,2,-32,-17,15
POAWcZFJHMBEDRGYNKQVbfTSaLUIdgCeX,ZAEHJHAABCGDDHAGGBAA.KHDCQBDH..fFGGhAAATEAGLADChAAAdEDAeDFAXFFEOACDABGFhABAFCAGEAGG..NAICbDECSGHH..hACAaGHD.IABBhAHACHFA...,1,-10,-27,17
WYaOPUNZIBfcVQeXJdAEMDLRGCTHKbFSg,DFDEREFHCBEG.KCBC..FCHF..SBEG..gBBFhAAAaFAHOHCAUGAF.ZDCGhABABHHH.fCGAhAAAQAFBeDAG.dFGDAEABEGDEMIAA.LACChABA...hACA...,1,-21,-33,12
QRDMZAJEBLaUXPNFCGcgHTYSdIKbfeVOW,BGBGUCBF...XABEFGCACAFGGAGCHECHSHEA.hAAAdAHEIADE.hAAAKHFGfAEAhABAOFEAQGAHDEHFAGFHLCABNEIE.gCEChACATCEA....hAEA...,2,-26,-26,0
YDBPOFKZGeHdCEULaXbQcJNfSARMWgIVT,RCEBMBAB..IBGHTBCE.DFIDBHEFFADG.KEDCZDGBGDFE.hAAAeAFHdBBECGDHUFBGaCAB.hABAXAAB..hADAQDCDNAIEAIHG.gGFG.hAEAPFBBOFAB..hAFA...,2,-20,-16,4
XfKdUbDCQOIJYTeFGMcNLABPRgVSWEZHa,REEEVACFEHBG..ZADCHBAB..aCABKEDEdECCUFGE.DCGCCFAAOGDChAAA..IHAFhAAAJCCG.eAEEMDFGNIDBAGEAhABABAHD..SFCFWHEA..fABGhACA..hAEA...,2,-31,-21,10
YEeIFRKANHUZBJQMVcdOCgGDTbWXfLSaP,HGBEUCFHBABFJCEF..QGGEMEAFdGEB.CDBFGBGCDBEA..hAAA.TAEBXACDhAAASADFaCBC.EABDhACAFFHFAFGB.ZFABODDHbEDC....fGCGhAEA...hAGA...,1,-12,-26,14
deMSfOEDTZgQKNAWcaLIVGXUJCbRYFPHB,aCEELCDAGAAEUFCA.CAEH.RFEEFFAGBFFBMCHH..SHDAhAAAEHBCZAEE.QGAEhABANCDG.AADGIBBFhACA...XEGBYFHBdAGD.hAAAeDBGDIEG.KGHB..hAHA...,1,-16,-22,6
LbgWaOXYCFRGASHeNZTdUBMJKcDPIfEQV,HAFBeAAAZCDFTFBBUCFFMCDH..KHBADABG...IHHBhAAAQFGDLAEFhAHAbAFA.WEEBOFAHCHBDFEHDhAIAADDD.SCBHBDBAPGCAEHDGaEGB..hBAA......hBBA...,1,-4,-22,18
WVZOLHMdfeSAYCJFDQcXRTbEBaKGUgNIP,JEAGQFBG.RCDB.EGABKGECUEFG..IADH..hAAAWADDZBGDLABFhAFA.dHGFeHCEADIBYAFBhAHACFDFDDIFTAEDaFFA..NIAH.PABDhAAA.OHFA..hABA.fBGA.,2,-29,-5,24
XQOYSULINgdWEcBZTHPbGCRMVaDfeJFAK,QAEGSGBALGFA..gDGHdCABEABEBFAChAAATABAHDDBGEDAhAAARBGFaCFHDIBEJEBDAAGEODAChADAUGGEIDFCNIED.WBAD...cAGDhABA....hADA...,2,-20,-4,16
JAZTgcCFDHIGXKERdWaONYMBUefSPVQbL,TEDDCGGEDDGD..GFAFKCDGdDGC..aDCEOCAD..MCBHhAAABGCFUACCSADGhAAAQAFGJHEAADCHZFEFFFAHhABA..IEHHXFGEEHCANIAH.eAHHfBBDhACA...hABA...,1,-19,-22,3
AGUCLVBPJNXTIZRDdcWQbEHeKgaSFYMOf,GACBUFDDLAAEBHECJCED..XFABZCFBDDID.dBEH.QCBChAEAEAGEHFAHKAADaDEBFHFEhAFA..OEGDhABAACHECEHA...NCDGIDAEWHBA....hACA......hADA...,2,-24,-19,5
FZcXCAbUWIdPMJgRGSBHaENVTLeQDYKOf,UGGDdHGBJBCBRCDBBHCC..aGDD..EBBD..TAEGLDAFhAAAQDFBKCGGFBFB.XGAAhAAAAEBG.bBABIHEBhABA.MFFCSECA.NAICDACEhABAfACGCBGA.hAGA.WFFG.,2,-35,-13,22
JLTHYEdgPZWQKeacUfXRCBGAbVFODNISM,FEGAOCBDDFGF...SFECLCFEHFBGdCGAZADGKABD.eDAEhAAAaGGCUGDDRACF..CEADAAIBhACANEAC...MEFFTAAAhAAAEHAA...PDDA...WCHHhACAfHGFBHBE..hAEA...,2,-27,-15,12
ZGBYCLWQFAINKceUTRVDXEOdMbgfaSPJH,KFHBeGFEUFEGRECF..DCFCEGAGdBHE..MBAG..bBBF..aDDBhAAASDADHBFEBDHChABACEHFLBEFQCAGhACAIGABNADD..cFBAXGDD.hAIAfBAE.hBEA...,2,-23,-20,3
WKVNHMQSCaATdBDUPIYGLeRXFcbJfZEgO,TEGHDDBFUBCF....IHADLGEGeABHFGBF..JAHHfDCFhAAAZDFC.EGBGhABAOAAHKAGFVFDAMFABhABASEAF.AIEEBDFCPDDH..hACA......hADA...,1,-9,-37,28
XIcTGeFOaZWBYCJPHKMLVbdAfUDENgSRQ,DFBGECBC...SGFCQFDC.IBAHTBBDFGBH.aEHFhAAABEAC.JCEHKCGGMBHBhAAALDAAdFBGUGGAhABAREDHXAFC..eADAOHFEWAHBCACB.hABA......hAEA...,2,-21,-16,5
HedBPSMIaGcAbXKNQVFREOgDJUYZfWLCT,XADFQBGERBGH.EEDH..ODBADBBAUADAZFDHLFBFhAAAHFEFdHAFBDEESCAChABAIFBEaFGGAIGCKGGEFGHF.hAAA.gBAGfGCECEGA.eAFH..hACA......hAHA...,1,-9,-11,2
EAaVQIBdSZRTJCFfOYHLMGbKeUXgWcNDP,QAAABFAFSFEDZAGDRFAC...TAEFJDFHFAEG..OABGhAAALHEEMDEGKDDHeDBEhAGA.UGGGXDABhAAAWFFC.DDIB.AICG.IAHE.CBCAYHCAhBAA...hADA...,2,-26,-16,10
VKafCZYSgAJPNeLOWQRFBcbXDIHEUdTGM,JBCCeFAFLEHFOAEGRFGHBCGH..XCEBDADEHDDG.dGCHTDCGhAAA.GGBFhABAKCCFaGBHCCAGSEGFhACAAAHD.NBIGFBBGIBAB.MIFG..hAAA......hABA...,2,-37,1,38
EeaIJLYWHUDNQCdRFMgSBTZcAbPVGXOfK,VABGXCFB.KEEBeFGD...IEEAJECHLAAB.hAAAHACFDDIFCBGEdHADMIBAhABABHEBZECFAHHA..bAFEOAEGhAIAEEGF.aCFF..WAEC....hACA......hBAA...,2,-24,-23,1
cHKEJWCdTfUIGaPQeLZMXSgOVbDBNAYFR,FADARCFBKBDBEECF..CEHH.dCCD.UGDGGDBD.QAGBeAGBMEFEhAAA..SACChAAAOFHFDHAEAIGCHFAF.hABAJHDGWEEGIBAGaCAB.ZFFC....hABA......hAFA...,2,-25,-13,12
gdcPXYbeJFUNOaMLfSCQAWDHZBKTRVGEI,DIFGZECGBBCFRFAAGBEAEFGB...dGGF..XADBeAHFUBAEOAHFhAAAMEBELCAAhABA.CGEHAFBHHGCG.KAFEhAAAIHACcACE.PCEE....hACA......hAGA...,1,-11,-34,23
OXgbACRNESfHZLDVMaYIeTPUWFKGBJdQc,CEBFRDEBECFEHGCA.DBDDMEAG..aECE..eBAGUFGEFEGABAFEdHGDOFBBhAAA.XACAhABAACAHfBHC.hACALABDIHCFWDEHKAGE.....hADA......hAFA...,2,-37,-19,18
gaEDAFBXIPfKWCNGUHZYJLRTSeQcMObVd,BEEEXACA..fGDDCEDAGAFGHFAHZEAELBBARBAE.hAAATCGDeHEAMCIFhABAVFGD.gFGEhACADEAEFHBGKAHB..WDAANAAF.......hAFA......hAGA...,2,-23,0,23
ecZXgMBbEPKJRUWGdOFNTLVHfIADQYCSa,QGEFCFHH.eDCHXGECBCHGEFADJEAH..UDDC.GAAAhAAAFBDGNACDLAAFhAHAHCFBACHDDCIDSFFChAIA.aCBD.ZBFDgADCMIBA.KFCDhACA.WHAA...hBBAOHFEfHGF,1,3,-18,21
SgPeEOBcbaVTHNMDKdYQJIfRCGLXWFUAZ,SBGHeCCHEFCHBAGG..aEBBHFFEDCFFdGGHQACH.hAAAIBAHfBAEhABAGBEGXGCGFEGAADHCPFAHhAAAcEFGTADGMICA.KAFE.JDDFCHHD.hABA...WEED.hACA...,2,-29,9,38
IbEHZGQBFDWOXPCLVYgdJRfMTSAKNUace,KEDEaFCE.eBEG..IAHCEGFGGGBBBAABFDAGDADE..OFAGhAAACHEBLBCC.VCFChACAdABCfACFhAFA.MAIFAAGF.NEIA.cDEH.HFGBhBAAWDDE.....hCAA...,1,-10,-36,26
LCHNJIcOdFBQMXbfYeRgTGVUPaZWDAKES,ECCGLDCDHGCCJAEFOFEE.FBCGBFFB.MAADXBGE.hABA.fCGAhACARFABGBEAPBABaAFADDBHAGHHKHDGhAAASGBCIHHC.......hABA......hACA...,2,-24,-18,6
eKJVAWBdTUDgLSRGbfEQXaZFMONYICcHP,dGGEUECALEBERGECGBBHEAFG..QGAHaCBEZFCG.FDHHMIBChAAAOABG..IBAFhABACAGH..cCFGhAAAHCFHKAEFAEBD.BHFFDGIB.SDHHhACA..fEFChAFANDAG..,2,-16,-16,0
HSAOKCTcLQYMbGPIFeUfZNBWRXJgdaEVD,KCEECDEELAFGMIFGGGABFABD..UDGEZEFHBBGB.RBAG.JEADdEBDhAAA..aFCFEABGDECAAEIF.hADA......hAEATGEH.QGGC.PHAEhAAAfEEG.WDGBhAFAXADH.,1,-27,-28,1
ZPcgNaXdOIWGLYCTASRFBVebUKJEfDQMH,SHBGBFCCeHBEKAEFEGDD...DFIFMDBDZBGD.....PBCHhAAANCAE.aAGHdBCEIHFDhABAGFDDCHHDRDECFAEFhACA...bFGFfCEHQECDcAAChABAOAHF....hADA...,1,-7,-34,27
eHQfJXULMNBDYVSCcdgWOKaGFEPIATRbZ,RCFCeCEHQDBA..fCCEUGBCMADEDHFG.SFBChAAACHHHdFED.OAFAhABAKBFCaBBCFCAB.IDGDhACAAIEC.TGBFbBDDJEHB.LAAFNEIABFGHYBBChADA..hAEA...,1,-9,-22,13
KJBUHFGIOZXSeYTDNcVfACLbQWRaMPgdE,LCBAQBAFaGFBMEAA..dBHAKCGBBEGFFAGGGECHZFAAXACFhAAAeGECDDDC.VFAFhAAAfEHC.hABACHHGRAEBEGHF.UADCIHAD.SHCAhABA..NICH.AEEB.hAGA...,2,-26,2,28
aKPGLWCcVZQFEOSAHNYfRegUIBbXdMTDJ,HBCC..NAHARGFEgGCDBABD.dAAGDFEFKFABLEAF.hACACEBA.cDBFZBDCFDDESAHDhADA.YFHDhAEAUGBAICAHMEFDTCFFaFFA..hAFA......hAGA...,1,-16,-31,15
BWgLRJSDFGfNdHUCPcEOAYbaTIZVKXQeM,aGCBTGCFZBAD..KBGHeBFE.BBEGLECERFEADAAC.FGDDGDCHhADAdFAEHADGCCCB.EFGCAIAC..hAAAIHHDXGFG.hAEAMAIH...WCDGSAGE.hABANCBGcCGC..hAFA...,1,-6,-30,24
ZCSFaTINAPJfELeQgdRKWDGBYUcXbHVOM,JADELADB.eGFEdCBCKBFADBHDBDBAUEFE.....XGBFhAAAVECC.MFAHCABD.hAAAFABC..aCGETDEHhAFAAHAG.EHFE.........hACA......hADA...,2,-51,-26,25
WIJRKLVebQafTNCcGUdBOMPHZDXAEFgYS,EAGAFDGA..SAAEJEBELEFD..eHAGQGABTGFHCBFFhADAUBBCdEBBBEECOAEHhAAAHBBGXEGHAFIDgGCEhAEAIHDBKBGGaCAHfEGE.hABA...cBGEhACAMAFA.DIFC.,2,-21,-4,17
USYaPQdeMFLVZHBfGbRWJgCcNEAKIDOTX,KGCDDCCGOAFHUBAE....SGFFaEECdEAGFAAELBFBhAAA.ZEGBBEGBGCCChABARGDAJBHFCHAHEEABAHHG.IAHBhACA..XDBH...PHAChAAA.MIFAfBEGhADA,1,-19,-43,24
FJcIEeWBPTMSAVUXfHQCLKDGdaOYZbNRg,UFDGXECHHDBHLFBFDIAEdBDC..OBGFZAADREFDFAHD.JBEDEFGGhAAA.BGAH.MAFChABAAFHG..fHEDhAAACHHEaGGH.NEAA..gCBHcABG.IDHBhADA.eACAWBFFhAEA...,2,-33,-6,27
VDXQMNCIaHFdYcTJgUGOPfZRAELSWKbeB,SDACKGDCBHCCDADAQEGG.MAGBIFBAHEBFdHDHhAAA.TABCUDEDGAEHhAAAPEEB.RABFEGGELAHBhABA.WBEBeHFG.NBAC.aFAB.FGHD.hABA......hAHA...,1,17,-34,51
IKdaJbERXOVeYWBNHZcDSfQTMAGgCUFPL,CCEAUGFDLEEFKGCA.dAGC..aAAAEBDHRBDE...OAACeDAFBFBGhADAZFAGDCID..QDFAhAEAMCCHAADE.FDDHPFGFhAAA..IBHAJHBA....hAFA......hAGA...,1,-23,-35,12
RGFcPTJWCQUDSNOAMEaXYZgIKBHdfbVeL,MEBCXGDBZAGFKADDdHFB.....VEGDeEFG.LAADhACAFFDC.PAHDTFABCGAAUCCDhADADBBF.OAEAhBBAAIEGaAAG.ICFDBCFB..fAEBhAIA..bFBH...hBCA...,2,-36,-4,32
YHVSebGCNRBgATZQfWKLDaMEcJOPXUIdF,QGFBKFEDLECCMDIBEHFC...JDECOAFCUADG.FAAEHCBDhAAAeHAECGADBBBC.ABFE.hABAfCDBDGCC.hACAaDHFPHBCdDAC..SCGD.hAGAbFAA.....hAHA...,2,-24,-13,11
MePbKAgdZBXFfWHUYTGOaVERSLcQIJDCN,ZEDAXFADFDGFHACGUEEEGGCH.aAHHVCBG..RAABSFAFhAAAQGCCJAEADDCFCGBFhACAeHFG.KAAHAEEABHHEhADA..YCFA.EADD..cBEEhAFAMCAF....hAGA...,2,-16,-8,8
STaUNKBIfYFMADeLHWZCOPRXcEQGgVJbd,eCDALFGFHBBACEDARCCAEEEG.GEGE.JEBDSBHF.hAAAaGABNAIGKDAFBACGIHDGhABAFDACDFAGZFCE..hAAAOACG.cGEF.....hABA......hADA...,1,-3,-38,35
WQJeaNcIZFfOXRHEDGCVAgSbTYUMBLPKd,SBDFTFBE.UEAGMCEDBBHELBCBKHAE.QFGBhAAA.JBHDaEDENAEBZBFBhABAOABD.HDGBDFFBCCAChACAAHIFgGDD.PAFBWHFAeDAHhADAIAAD...hBAAfGGG.,2,-24,2,26
HFUafPDJVYXQOTWLCZMKESegcNIbBdARG,GDGGHFCGaDBEDIAA..JAEBXABE.OBEFTGGECDDEZGBAhAAAEAGFeAAB.NEEFBEADhABAREAEFCAEUAGG..hABAfHCB.PACHYGDCWFFEhADA.KGAB.SCFAhAEA.,1,-13,-15,2
cVEagMJLdHIBYbQARTFeKPWSZDNUOCfGX,FFGGKBGD..SHGGZCCDDBGCUAAG..ODACGCEH..XABBhAAAEHCG.gADChAGAMEFHLFADhADAdEHAIFFD.YHBCABDG.TCDAhAHAWFBAfGHAhAEAaFCG..,1,-28,-33,5
dDAMSVJKNOUQGXeFILbPZBfCWEaRTgYcH,SEAEKCFCUDBEGFDDeHEELFAH.ZCDHCHBGEBAGRAAETAGDhAAA...gEGGhACAYACGdGABDDGEAICAhADAMIDE..NGCH.OEFA.FGHD..hAAA......hABA...,1,-3,-29,26
IcDKVafURLPXJZeMbTNEYAHGOWdgFCQSB,GBAGOEADdGFDFAGDQGGHBCBE.DECCKDFF.aAEBUGAFLFCDhAAAJDFF..eABEhAAAMIEG..TGDChAEAEDHDADAHHAFA.CABGIDDDfCCB.XDGBhAFA...hACA...,1,-9,-30,21
DFHKVNAZEUQMPRGICdWgOeaBTJfXcSbLY,EBDHMFGHGEEHdBDE.OHACBACF..JFCBXAFE.SAAChADAbBGD.DGAAHBAEhAAAVGDCAFBEZAEF.PEEFhABACBBBeEAE.fDEF...hAGA......hAHA...,1,-7,-29,22
UKDWMSaGNXOLQTcFEgYIPJRBdeVHZfACb,CCBAKEEDDHBAMDIF.GDBCOFFG..LBACQAFEFDGDEBGChAAA..IECDhAAA.JBCCdGGEHEDBfAFFhABAACAE.bGDGWFAFNDAG.XCGEhABA....cBEHhACA..,2,-40,-11,29
ECTaPXdgNRSMYAbWBULcQJfDKZOIeGHVF,BDEFLACAQGDEJECF.DACCODEFeECFGADFFAAH.EGFChAAACCCF..aEGEdCBARAGB.MBAFhABAAIDA.UDGDKDABHGEGhABA...TGAGgGAD..hAGA......hAHA...,1,-14,-20,6
DaHUVZFJPNMIGYWebgQXAOcKESdRCfLTB,OFGFKAHBdCFERFBELEFC.DBGEUCBDFCFG...JFHHMDDDGAABhAAAeHAG...gCAHhAAAAFGDEHEC.fABBhADABEDHaHAA........hAEA......hAFA...,1,-32,-35,3
SVRgGbBPfNLXFJeKQITAEHZdaCWOcMYDU,ECAEHACGZAECdCFF.CDDH.OHFEMABH..DFAEUEED.RGAE.GGDDhAAABFAC...NEIGFGBDJEHFQABBhAAAAEFC.hACA.aDAE..WDFESAGA..hADA....gDCFhACA,1,-25,-30,5
bZBEXVMYSaNfHCWTdIJgReGQPOFcUDKAL,LBAHZFBDBDHDECEGMEHH...SGFHaDAHHAAH.CCGATEBAhAAAdFGCJDBG...gGCHhABAeEEHQAGChAAAFGACDEFFKCDGAIHC.bADCXACF..NBIG.hACA......hAEA...,2,-17,-12,5
ceLFBOaCXSAKUWRPgDYGMbEIfZNdVHQJT,KGBEUBEDRAAH.DHAEGGEH..MGFAEFEAZCDAdDAFHDDG.QAAAhAAAJBFEeFADLDHDhAAABEHECFBD.AEBG.PHFAhADA..YADEbAGB.fECFhACA....NIBD.hAEA...,1,-7,-24,17
GZbKPeRgTVWECYQOcDFLdHUaNBSJfAIXM,MFACZAFCKHGARFDB.....VDBCEBDACDEG..QDGHDIAAdGFEUCGFhAAAaGDF.BDAF..hABAJHACADDD.GBCHeBBB.hACATAACOGAEFFFH...NCAE.IAGEhADA.....hAAA...,2,-22,-17,5
RaGLZHfeYdDcWBMNgTCXQFASOJbUKVIPE,JCBEKBDH....IGECEABGGAEF.HDGHeBFDdGGHDBGCBEAHhAAAMFIH..TGDBhADAXCAEAIAEOFAEUGAERAAAhAAAaEDAZEEC...fHCB.WEAGhABACHCG.FGGH...hAEA...,2,-17,-13,4
QRNFETAbaLBOIDcWCUYSZGgeXMKVfJHdP,LCDGOECADHFECFBCUFGHZABB..GAGAeBHH.MDDGKCBH...hAAAVFBGJEEHHADC.hAAAdCAGPFFEQGAFhABANIBD.FHCEABEDaBABBABA..IEAAhABA......hAEA...,1,-9,-20,11
BUHYJgESdefDVCQPTZXMWINOaRKcALGbF,LAEAGFAFBFFDUCDEJEFAEEHH..dABDDGGH..QCAHhAAAZFAEXAACMAFC..hACAIHCEaDDHKBFAAHBDHCFEhABASHGGeCAFfDBFCHDG.WFFFhACAOBEH...hADA...,2,-20,-17,3
WPKBgeARZFNcQLMSVOIfbdTHCaJUYGDXE,RCDCZCCCFFFBQDGDLECB.MFBF.OABGIGAC.dABECFHDUFCGhAAADDIF..EADEKFFFhAFABBDGAIDESDBGhAGA..fGHEbAEE...aAFAhAAA......hAIA...,2,-38,-15,23
cINMRBfEFbVKHTZDYPdGXgOeQAaJCUWLS,aHACUCAGLDBH..IDHBRBECBHDCEFFGFAHFKHFE.HEDEhAAAZBCFDAADdGBGGABHhABA.OAGHAFHCCDGBSAEChABAMFIB...fGHC.hACA......hAEA...,2,-31,-20,11
UcHPLgSRWbeEdZKGQVfNAIXFBMDOCaYTJ,XBFHBBHEOHFE..CFHF.aADA..JBCAUEDHHDAELCDAhAAASGACRABH.eEFDhAAAdEBCKEGDQBAHhABA.fBHEAIAGMEIHDAGGcGEHPHCGWAFChACA...EEDH.hABA...,1,-6,-25,19
IDHgAfCbYGKJdESNPMXQeaWLTUROcBVZF,CCHGGDCAKEAA.EACB..SFEGMAFFeHEELAAHUGAHOBGHhAAABAGBZGDADBADABBB..hABAfCDDJFEE.hADAdACBNEIE.XGBD.aDDC...WBGDhAFA.....hAEA...,2,-27,-18,9
GWcPFUMSNAIYBXCbTaQKfHeOgJZdRLVDE,BGGHCBDB.aGAEKFAEHAEDOGDEZAGD..dAAELDFEDCED.EAADGDCGhACA..PDAChABAMCIDAFFD..IHAChACAbDAF..fEGCgAGG.VEFAhADA.FEDDSGEDhADA.,2,-24,-20,4
dFWCKcOMfVEUYgbQNPIXaZDGALRBTJeSH,RABCBGEEeGEEdGGF.CDAA.KFCC..OBBCMBFBEGBB...UCGEhAAAbBFC.QCAHhABA..IDGEhAAAaHGEDFAFADDGLFAB.SEDCWFFE.hACAfAGB.hAEAYABC.,1,-12,-42,30
XHCTBaIZbfYKFVSeUgGEMJPODRALcQNdW,LGECQEDBdDDEHAEABAHHZCBB...bBAFfDBBhAAA.KDGHFDHBeAEAUGAEhAAAEBCEJHCCDEIBAHGBcGGFhABAXFAC...CBACICFDSAHH.hABAMCAF..OHCChACA..,2,-16,-10,6
EJNYUXQZBMDPFWeGSbacfKAgVCIRLOdTH,CBDGREFCdAFBHEEA..JBAEUBAG.ZFAGDCGCFEAAGCDD..SGGEhAAA.aCHDcEBAhAAA..ADEHIHCDhABATGBC.EGEDNEEA.QAFHBHHCMABGhAIA......hBAA...,1,-18,-36,18
TZQAbBOfKCaSJXdREDMUGHIFPYegNLcVW,BGFDOABFCGCA...aHCEJAFC..dFDDRDDH.DHGGGEAEHDAFFADG.hAAAeCEHLBCF.hAAAVCFATCGD.AHADKBAFhABASBDAXAGEMIEGIFHE.hABA.YFFC.hAGA...,2,-26,-18,8
aMHSOQDVKbgNcWZEfFTLRUXCdYABGPJIe,BHCHGEBBJHFGeACE.aAGHMADA.HDEDSCEH.DIGAhAAAKEDF..NHEFZBAHfACGhAAALHAGUBGGhABACEGAACCGOCHFQEGEgFAGEEBB..hABAFBBH.....hAFA...,2,-20,-9,11
WgfDJVbBEQNKZGPIAMdOaUcRYFSCeTXHL,OCGHUCCFRFBD.FDDB..SAGGCAAB..eACHHAAELHAEhACAfFFCDEBFVFGBhAEABDFDEEHH.NEAGKHDAhAAAPFEH..ABFHMACAdAGHaAED....hAHA......hBAA...,2,-24,-15,9
ZXIBcMHCgTYGFKPSUDVeWfQAEJLadbRON,JCDAdFGBOBDEZGFC.BFAHMFEAHDDA.CHBD...TFAAFAAAKDBBhADASACG.hAEADCHHeHECQDADhAAAAEHGEGDHaAHBNCIA..IBAH...YHBGhABA...hAFA...,1,-23,-30,7
OeJAYHdWCXfPQRENbDaUVFTcMKBGSLgZI,dBAHCADD...XEAGQFCFEGFHDBGDUCEB.FHECMCIFBBGEGECChAAALFFE.ZAABhAAAIHACOFAHADDBWBDBhABA...PDAANAEDaCBD...cEFAhACAKGHD..SCHHhBAA.,1,-15,-25,10
UcFJeXHgEbCKTIBfQNPROGVMASDWaLdZY,SGAHDGEELBHHdCDGUAEGFDFF..eABAHCAH.EACFCCGBKHFGBDCAhAAA.QGBGhABAREBG.OFHHMDIFACADaDGBhACAZAFC...cGGFgEDC..hAHA......hAIA...,2,-26,-15,11
UCNRSITbAfdJPHGagMBOecEWXYKQVZFDL,JFAFHAFEGBEFaGGCMDCEBFHE...eGEEEFAE..XADFhAAAKCCGQEBFFEHDDBBBCHAFSEEEhAAATEEAAGEFdHDDhABAOADA...YBAD...hACA......hAHA...,2,-24,-13,11
XHJLNKCYZTRVFcQUdBSgAPOEaMeDIfGbW,OHDGEGCG..MCFCDCBDGAEC..XCAAHFGHNGABKACFhAAACGADZFFF.TEACFHBCQDCFhABABABBAFDCeAEGhAAAIAHGfEGD.JDDE....hADA......hAGA...,1,-17,-24,7
ZKDVNcSRETBbMXUCPFWdOAJHLeIaQfgYG,HACELCABaDEAQFGF..fHDBGAAGDGCCVCDEhAAASCHHEFFBTBGEhABAMEFBCADA.PHBAhAAAFFHDdCCGOAFAAGBF.IECCgDGAKHFANEAGhACABAHB.XGBDhACA..,1,-3,-4,1
bKYAZMPQUJTgWEXIBSLGeVHCNFOcadRDf,ZAGBMBFAUFAB..JBBE..TAEDEEFCBEAELDDBGCDDeAAEhADACEHH.FHGGOFABhAAAaDFC.dGGGDGFFKECGAECE.QGCBhABAXBBCSDHHNACB..hAEA.fFFBhAGA...,2,-23,-16,7
EBNPKOXZURadVfgATIQHDJGLScMCFeYWb,QGEFDDDCGABFLAHHSCGFMAGDCHDD..FAAHeFCG.hABA.bDCCBHGG.KGGChAAAOFDAXCAEZAFAaHAAhACAdEEHfFAB.AEACIHEChABAJADH..cEAHhAEA.EHGC.,2,-18,-11,7
NPGJCFKdWEcAVIOUbLZQDHMeXYRSTfBag,OHCGLEBDDCFCMAHD..eFABRCDESABHBHHE.aGFHNCCCGFEHhAAA.CDDE.KEGFhAAA.dFCFEDABAADEIHHEhABAZDFCXBAB.fAHE.PACAhABAWFAD....hAGA...,1,-23,-28,5
LPYAWIHXCGeVBEfKTNdZFbUcaDMOQJSRg,HGCGGCBABFGFEGEBKAEFdBEGFAHF.UCFEDGFAMCIF..JACFSBADhAAALDADAHIFIEFBhABA.CBBCeFAFhACAfEEGZAFH.aAAF..OHBC.hADA......hAEA...,2,-34,-10,24
KQUYXNDHTLJRfaZOVgCAMbWBedSPEIGcF,MHACBEBHSCDE..PBEFICAAFEFEQABBhAAA.UGGCYGAChAAADEBBTDCAJAHBfGFDhABAaCGCOAFACEHDAEDG.eEDAECAH.KABGNIBF.hACA......hAEA...,1,-14,-31,17
AZHXUCdPeQaRWINBLOgGfbMKSJcYFEDTV,HBBBCDGGdGFD.QFDERAEH...WCHBIBCB.BEDFhAAAOADGGBACMBAHKGAAhABASHBG.hACAcDCEEHCADFFEADHFXAABUAGE.eFGHhAHANIEF.fBEFhAIA...,1,-21,-26,5
gHIACOXfKMdNFSYZGUbRQWPVJEcDaeBLT,OBEHKEDAdGFCFFAGZBFAUGAC..QGBH..PFFGhAAAECACDCDBeACFBACBTGDChABAHAEAAHHD.CCED.fCAEhACASDGBYEAG...hAAA......hABA...,1,-20,-35,15
XSCGAYUEBNcaFZWDKORJbeMdPHLTIQgfV,ECFGBABF.aFBHFDBDZFECKFFA..RCDG.eGAEdHEHHACELEHH.TBAEhAAAQDGH.hABAfAGFSDDDhACACFCHAHIFYAFA.NIADDAEHOCCH.MEAHhAAAIHFH..hADA...,2,-24,-10,14
aEgRbcVfLHPeUZCGASFQKNIJOXDYWBTMd,FDFFKACF..JGDADEBD.BBAHdDDF...ECCCRAEC....VEAHLAHFhAAAHDFF.UFCGCCHG.hAAAAGGHQAEAhABA.OHFEYHAG.MABBaDAB...hACA......hADA...,2,-36,-30,6
RKTaMcYXdFNbZgHEIfJUCBPeSDWOQGALV,VEACTFCA..MFIF..XBCHdBCBFHBEZEDFEEBF..JHEECBADBAGBhAAASEEE.hABAOAEFAHHHKDGFaCDENDIGHAAFhAAA.IAHA.fGAEhACAeFGFDDAC.WCHF...hACA...,2,-29,-2,27
BUKNLJAVSOHERXcFIMDfYaebQPGCZTdWg,OECCRBCAFBHF.DBHH..aGBBQACEGBFEZEEFdGBFBBAEKCCDLEGBhAAAAGGE.SAHBhABAEDAH.IBFFhACAMAACfEHE.eEDBCGFFWFADhAFANIEB......hAGA...,2,-33,-17,16
YIOMDGSNWQeAEXRcHFfKBPVLUZgCdbJTa,RCCGHACBFHCCBGDBVFFAUAFF..CBAA.dDGB..JAFAaEAC.OGAChAAADGFC..GEAGhAAANICD..QFDEhABAAIHEEADD.fCADKCFELEFA...hACA......hAEA...,2,-39,-11,28
VQFMeJOPHXIdDgRNCbBYaGSKcLUTEZAfW,VEDCMDCA..OECEHCADdHBBDADH.RAFD.CAFH.BACFGEACKFAFUGGEhAAAEGDD..AHGA..QAADhAAAFDGE.eCEEhACAXCCFIAHC.NDIG....aEGH.hABA......hAEASHFG.,2,-19,-9,10
aCWZQgDOEeHTBNXVIMSRfFYAbcKdUPGLJ,KBHFdEFGUECHGDDELBABCBED.ZBFCQFBC.DGIHOACBhAAAHABFBAFBXGBGhABAIHGDMAFGSHFGhADAFFGGADDF...bADD.JEHBaDAC.hBGAEAAF.NIBH....hBHA...,2,-17,-16,1
GQHdKDARNJcgFIaZPTCWOLfSYBXUEeMbV,RABGJCAAFGFEZCEC..CEGG.LEAH..SECFBHGGEGCE.MFEDhAAAGADDHAGFdFHCADFE.hABA....gEEBhAAAPEADODHFfABF..XAEBhADA...hABA...,1,-25,-33,8
OfQSDIXLMUTFWaBbgcCNdVEJeZPRKAGHY,HAGHOBCFQADCDGBDLDFETCADFEGH.BFDH...gGFAhAAACEAEdFCFECAGJHEAhAAAeDFD.ZFAFRAFCACEGfABEhACA.IEHD..MFAHhABAaCFF......hACA...,1,7,-31,38
WGJSDaYfTVCPKQEFRgXcOMeZdHUBLbANI,..IAAAJBBHDGAA...aDCH..TDFFCADEKAGD...QACBhAAAFFFH.XEDGhABAMCBBeAEHZAEDdGGGhADABEEFACHA.NIEHGCGESHDAfACEhAHAEHAA......hAIA...,2,-32,-21,11
LePETVaINQJGOXcgfCBHFAZSRKYbMDUWd,ZEBHSBDHKDCE.MHEGDBGHdAEG.LAAGEDBD..aAAEQGFDhABAGCGGXGBDhAAA..cDGEhACACBFABEADAAHH.RDEDYAHHbFDF..eAHHhAGA......hBFA...,2,-31,-14,17
MdTIcDgENUfJGAaXLHRZBVFQOSYPWbKCe,LEAGZGBCFCEG.SHAE..WFAFKADHMFFD.TDGBhAAADBBDEGFE.UDGFhAAAJAGDaCAEHDCD..BABFhADAQACCOEDD.YAECCGHG..hABA.....eFHBhAIA..,2,-30,-15,15
gTPHaAKCSdOfBDNJFUMeXLVYbIZcEWQRG,KBHDSABBdGAHBDDDDCED..FEAGeEBELBCC..bGECZEFDhAAAEHBARFDH.GBFE.hABAPAHDACAACHHB.NADD.MIAEhACA..XFGE...IFBEhAAAcCDF..WADEhAHA...,2,-44,-6,38
SUVNXFMcRIefZJYDdBQaCbgWLETGPKHOA,UBDDVCDG.FGEH..MEHFRCFF..eBAHJADE.DHBAdHDF.BAAEQAGEhAAA.CGGC.bCAFhACALEBA..hABATAGG.PDCHKFADAIGANACH..IFFHhADA....hAIA...,1,-23,-37,14
cNgVeKFbPTIJOXfZUBCaYHWLRdSMGAEDQ,DCCFQDEH..gECHKECDFAAF..TCCGJGFAOCAFhAAAZEAFCGHBHADALBGFhABAdHFBSGDHhACAMAEEEABC.NAIC.eHCG...PBHD..hAIA......hBAA...,2,-26,-9,17
LVWSHQIZbDXCcfFEMNaJBdGPOeYgKTARU,UCFCVFGD.HCBGZDDG.DFFB..CCAH.FHBAMFFF..aAFEdFAAOBAAhAAAeAAG..KBEDAACCREAG.hACA.SGCDhADAQGGDICCH.XAGD.EDHBhAEABAEF..PFDFhAFA..,2,-30,-10,20
LcSQedRTXYbEfAJaKOUMWGIFDHgPZCVNB,KEEGMBDFGECGDHGGHEEFZBDG..CBBA.BBFELAHHSEBF.hAAAdDGBTDAE.XFGEhABAYHAGEGABACBEaAAGhADAOADG.IHFDFAGAgECAhAEA......hAFA...,1,-14,-27,13
gAMSOUBDFPTELYKbGWHQcdIeaVXfCJNZR,MGEEUBFCBDCHDAFD.FFCEEGAC..KDHHGAAD.HDEGdAAAeEABhACAaAGC..VDACCBDCZGFAhADAAIGCSDHBhAAA.TGCGLHAAWHFC.....hAEA...cEEFhAFA.fCBA.,1,-3,-33,30
fJCEFNAYeBPSWOcUTHaVgGRdbMDXIQKLZ,eBBESECEOFFFUBEGHBEF..aEGAVEBAGBABdAGGDFHFQAGChAAAKHBGLDAFhAAAfEABCDHB.FFHHAHEHBAHHhABAPFAH.cFEB.....hACA......hADA...,2,-14,-7,7
SLKUJPAZMVRHDaECcbFIeQWXgBTdOYGfN,VEGHDHCEEAGC..CAFB.FGAD..QADH..gBCDhAAAdAAGGCEFSDAAhABAUECBAHAAMHCCHEFC.hACAaFCAIDAHXBFGBBBB..YHDGhACANICD.KADE..hAGA...,1,-14,-26,12
CEgTUPALFBKZIVYaQcSRMbXGHeDJdONWf,LABEBGBEZAAB.VEEDaEBA....SCFGMCDHGAGCDIAC.hAAAOCBF.NEIE.fFHEhADA.CGFAEFEHhAEAUGADAHAE.IHGAQAFA.RCDB.XBEDhAAA...hAFA...,1,-12,-33,21
aLPJgEKBNQMSGTUdHYObeXFfcZWIDCRVA,LAEGJHDA.KCEHQCFDMAAE.SGFETBBBdGEAHDABhAAAODHDeCDFXFAChAFAFACBZAECDAIB.CHAFAHIBhABAPDDH.gFFBBEED...hAFA......hAGA...,1,-16,-18,2
bOCVLNRWYcgDTBHMFIJQGKAXdeSaUEfPZ,XFBHdHBHSAEDUBBG...EAHHZFDDOBAGCFGBLCEC.hAAA.RDAE...WAFChAAAcFFH.DGIBBEBFhABAMBGDFDEEIFDD.JCHDKGHHADCAfFBGhABA...hACA...,2,-34,-15,19
FaLHKNdgQbJRAUYXIDWTeOMSBGPZcfCEV,XDGFDAGEeAAF..OCFAMCEEBBCB.ZBAFCDFHECDFFGAA.HEBAhAAAdGGAQFEAhAAARFDA.ADEB.IGHHhACASAFAPFABfCCEaCBGKAEA.NACF...hABA......hAIA...,2,-22,-12,10
JXVHDWEFYUcOIKMgfPaGCLAbNQSeRBdTZ,QFACeEDBBFHDdDGFZDGF..JFFFHABBDIBG.EDAD.FAGAUACHOAFHhAAAKDDA...fGBEhABAaGEHLBAHAFFDSBDHhADATAGC.XGGC...hAAA......hABA...,2,-29,-10,19
HKTVDRFIWeOgLaQCAJdcBYbUZNfESMPGX,dCGFBFADUEDCZECGEFGG..SCBF.MFFAGBDFKGAD.hAAADGEDRABE.IDHEhAAA.OCBHaAFGADABJHDAhABAbGAA....fGGEXGBHTGGGhADAWBAF....gCCGhABA,2,-33,-25,8
FDgGcVXACJEBLdYeZbKfQWOTUaIPHNSRM,CFCBBGHAdCCBZDAGKGFF..QDFB..TGBGaHCA.HAAAhAAARBBADAGHGEGG.XBGHhACAAACFJFCE.EEFFeEADhAAA...fDABWEEDIBFEhADANBIASAHF..hABA...,1,-12,-40,28
TYOHcfJCNSeUDVQbEGZMAWLKPFdIXaBRg,KCCHdDBHaAEEBCEA.REGF...TFABOHACHFEF..JHDCSCHDhAAA.DABFbECGhAAAEFDFGAEDACDG.LDABhABAIACA.XGGHcABEfCHGhACANIAHeEEE...hAEA...,2,-23,-20,3
PCUWYMbEQTZVSgHXdcfFeALDGBINKORaJ,DFFGBGHGKBAGaDDD..CDFG.UACE..MBDFEGADZCGH..SBGFhAAA.HEBFhABAcFEEeHECABAELAFFhAAANDAA.JCBHWBHH......hACA.YBED.hABA...,1,-35,-38,3
aZgKWcGIUfNLCXFVODTASJdEYeMHbBQPR,SBFDEDEE.eBADHCAHBFHAQACCREBHZEFB.KECDGEDEhAAAIAFBUAGAfGHAhAAACBCA.FGDGOFAHhABAABHCJHAAdFFAMAEBaBAGWHFA....hACA......hADA...,2,-14,-6,8
caWRJLHgeDTSEQbAKPNVfICYGBXUFZOdM,KBAGVBECCGGB..BADGFHDEZCBF..OFBEdAAH..MAIH..hABAaDCGRFFGHFAADBFGEGADAEAC.hADA...fDHEhAEAIEAFGDEDXDEC...WBDFhAFALCFEeHAA.SHFGhAAA,2,-39,-13,26
cZHAVdRKUOSCTWYfMEPGBJFILaQbDeXNg,dAABREBDUFGEOBBH..CAAG...TBFA..fAHAhABAMEFGEHDGBAECJAEEFDDFIHBEhADALDADQECChAGAeGDA.gGGAcDFB.ACCGSFFGhAHAPACH..hAIA...,2,-27,-24,3
ITXNSPWFMCJgQHRBbDeLUdGEcVOAfaYZK,aFGDZBBHKGCH..TCDASHAG.FGGCCHAFQCGGhAAA.HFCDBAAFbDAGLCGHhACAUABAdFEAEEADOBDAhAEAABDHIDFG.XADFNIEF.WDDBhAGA...MIFChAHA...,1,3,-41,44
LYVKFPDcSXMgZdebHIANUBfQRCOJEGWTa,UCCBQDFGOEBEJACBGGDH..TECFLBHF.KABEhAAADBEDSHAGhAEAMHFEgAGAdBDFeFFEIEAEhAAAAIHEBGBBCAGFaDHD.FBAD.XGAChABA......hACA...,1,-13,-25,12
PUORgNQJZDAFSECbTIXWMBYHGdcefKLVa,FBCASGBBCDFE...TCCEIDACMHEEBHGAHAABdFECfAFDhAAALBHFaFABhAAAODGH.RECCNEAEJFBDAADFEDHBhACA..XDDCWBFA...cBAAhABA.KFGF...hAEA...,2,-31,-8,23
OAEDHJMIVPRZbdKWXUTYQaGLcgBNFfCSe,DFGDJCEH.MFBG..VDABRBEHZGAC..KHCAUBAF..QEGGhAAAaFHD.GADHhABALAEEBHABFDGCCCCHeGCEhACAAIBG.EGHH.ICHGdDBHWHFG...hADA......hAEA...,2,-28,-22,6
HWPfSgMQeYUCETBJLdcIZAFbDRNKVaGOX,DDDFKFADGGCFOCGHHFEH..fFFHMBAG.eACCUDABhAAACDEEEEBBBHBBLCDDhAAAIAHCFBACRBDDaHGCWBHHhABA...SAEAYDHB..dGACAHHC.hACANACB......hAHA...,1,-12,-14,2
QCdNZUYfAVDRHEWcFegLIbSaXBMOPJTGK,VEGBHDDFEAFG.FDGGLDAB.SCCDaGFAMBBHJHAGKEDGdGDAhAAAZABH.UAECAECHDIFCRCFC.hABA.eHAA.IAHHhACABFHE..OBFBTACCCADCNAAA...hBAA......hBBA...,1,-10,-17,7
NIfKUZLbdOQJCWHSYGPgXDaTBVceRMAEF,EGDGFDHF....IABDfDDA.KHACZDDHLCDEdFBCOAFEhAAACEAGHABAGGEBXGFFhAAADCDABDFEeADEACGE.hADAbAGF.JBAHSFFE..PEFGhABAaGAH.....hAEA.cDBFMFIH,1,11,-24,35
gIBOUYFJGWCaRZQeLEKbSPXDVMTHNAcdf,dEFB..fFAHIGADBDBHUEGAFCBAGADECAAC.RGCEQGGChAAALHBAEGCCSACFhABADACCMECCHADChAGAADFC.OFFHJBFCWAFEaAHB...eDDD.hBBA......hBCA...,1,-10,-14,4
JMGfgQBXDHNWLAURVYabFIcKSdOTPEZeC,VABDaDBH..FBHHKEDEdAAD..OBFCEGDDZEFC..JEAAGACAhABA.QAEAhAEABFFGDAAFHDGF.NADHLHBEhABAAAID..YGECIHHHSHAAhAHA...hAIA..eDFG,2,-33,-7,26
IFAGcdMVWfSbRPLDKYaECXUgQHTBNeOJZ,GFDHMFAE..VBGHfDFB.SBDBRGBELBEDKDCBhAAAaACHCFBF.UFGGHBAFBAAEhADAOHAE.IAGFhABAAIACdGEE.PHFEDEAA.EBHH....hACA......hADA...,1,-12,-24,12
CHYUOdgKVTcRAFeIZWENPQXbBMJGDLfSa,eDACZEEHEGBGQAGABCDFGADHLDFE.aFADCEACUGGGdEGAKGCGhAAA..TDGAAACAFGHDNIBFhABA..XAAHhAAA.MIBGfBCFSFDBODEH.hACA......hADA...,1,-4,-24,20
DdecVLIbTAHRBOgSJMfEaXYCFPWUZQKNG,HBDBOEHHJAAG..EEBFaEFE..CBEBFDEHUGDGZAAAKFBE..DGAFeFHFhAAA.LAFChAEATGDDAEAHBBGH.SGBGhBDAfCAG.XCGG.WFGDhABA.QGBEhACA..dCCC,1,-13,-37,24
PTYXSQVbHgFLZENUMKCcBeDIGJaRWOAfd,dACATGBBSFAF..bDFGHGFCFGGEZAACNIBB..KFDDCEAHeCDChABADEFEGBDC.JCFAhAAAaCAE.OHDEAHBAfBAAhABAXBGF........hACA......hADA...,1,-16,-19,3
WNacGbLFESUfDBPIYQCAXOHdRMeVZTKgJ,OBDGdBHERCDD..eCAFVFEHKHCG..JCAC..aABFGEAFLEGFhAAA.FFADSDGHhAAADDCHBBEB.IHCDhABACFDGAHID.MEDA.gBGC.NADHEHGChACAfEHA.hAIA...,1,-21,-33,12
MJOFeQfBGTLbaRgISCNKZVUWPHDAEYcdX,EFCDdDABJGBCFEAD....eDDBBBBHLAAFRFED.SDFFhACAKAACZDEEUAFCHBBH.YFGDhADA..MIAAhADA.OAHFfHDH.TAEDhAEAaGGDCEAH.WCHBDDDGAEIF..hAEA...,1,1,-36,37
fPJeXOYNEKDRVQgBCAMaSdHcbIFUTLGZW,aFDCHACF...IABCTCDCZBFC..PBFAJBBB.OHEEhAAAEEFGDADFQEFAhAEABGAHAAAHdGGHFFAE.LEDHhAFAfHDD.eEAANDIAKCEA....hAGA......hAHA...,2,-25,-10,15
VaLFUCeSWJAdPRTcHZfBQYXODEKMNIbGg,dEADRAECHEABBFFBQGEFODHD.EBBGMBDG..NDHG.GGCDhAAAaCACUDDDSAHDhABA.JDEAAAEC...TBBChACAfGCCDIAEIHHF.gECHhADALAACCAHB..hCBA...,2,-17,-10,7
aKYbgDMBELGNPfCceHWdTIVQRJFSXAUZO,OHBCaAFA.KDEB..bFCHDDGC.BFADGCAH...PFGDhAAAfHFBCBGG.eDAEhAAAdACHTDEC.hABAIBADRFCCFBEESEBGAIAE.YACEhAGAMFID.EAHH..hAHA.LEHF.,2,-17,-13,4
JAIGNOCZQTbcXPVfWSadMRBDULHYgeFKE,GGDFCCGHZEDB.QCFC..bADCPDAB..fAGBhAAAaBCCMABADGBDUCAHhABALDDHHFFEeFADhACAEAADAEIBOHFE.XDGEWAHBSHCGhAFABECH...FFFAhAGA...,2,-10,-10,0
ecEZSdGHbQNfIgDKYAORPCVTFBMJWLaUX,OFGDCDDFFDFC.BEDC..MIAEJAEGLCAAUGGH..eFCEhAAAZEAHdGEEHAFA.QBADhABAICFBKAAAAAHGREAB.hACA............hADA....PAHDhAAAWHCEaFFAEDGH,2,-35,-18,17
BRaFMQHCgDLbdJAXGPeYWIfUcSEONKZVT,XDCEGAECeDCF...IFFGfAFFSBBChAAAEBAENDIAZFDABHEE.aEGAFEBHhAAAMAIDCHDHDDABdGBDACHHPACGhABAWEAF...OCDAKEDH....hAIA......hBCA...,2,-17,-13,4
COQeTGWYJSEPIXLdKZaBcFfDRAVUbHNMg,VCBFHDCHMAEF.OCABTFDBGGCF.JBFBSCAFhAAA.EHCGPBHFhAAAIHFDXEFELBHBhABAKABGBHADcDFBDFIBAGBBNBBBCFBB.eAFH..hACA.....WFAFhADA..,1,-2,-15,13
dZWXTaBgSKeHIcDGMQNAUOfVPRbECFLJY,OEEGVECD.RBCF.EGHDFGHF..LCHDdABCZGCA...XCCChAAATBFH.BBED.KCADhABAeAHBHFEBDAECMIBEhACAAIAA.fAGCCFGFJDAB.WFAFSFDGhAAA.....hADA...,2,-21,-17,4
AgFbPLGMDCdEUZaHYBOTVNfJeQKWXScRI,FFBBLFBFMAIH.dBAGZAFBaBCAHEEA.BDDDOFEE..NEIC.JEDGhAAA.KAGE..SCBChAAAIGCAAIEEPABChABACEAC.UGEF..TCCDeFCH.WHFEhABA......hACA...,1,-13,-38,25
QCVJIbTXHeUgcSZWOdRBMaAEPDLFGYNKf,DACBGFADKCDB.QDDD.CBBAJCAFIFFC..XGGHhAAAHAEEUCGD.SDBHhAAAWAHD.dBAAhABABHEAAHHFEHAELAFDFFDH.fEHEhABA.....hADA...,2,-35,-18,17
bYGSXeIZUQcBfAaRgNETMWOCJDVdPFLKH,aBGGRADCECHB..MDGBCHAC.DDCAdFCF.LDCEKGHDHABGGGED.hAAASACDeEAHZECG.hABA.cCABAFGA.NCIG.hACAOAAD.PHBEFHEE....YHAGhAEAIEAGBAFChAHAfAGB.,1,-2,-19,17
KbUYcgAfdXNPLEICFaZeRVMDWSGQJHBOT,dAHEXEFDLDFD.EDGHCGBGFBEBZDAHRDCBDCAD..GACFHAAETAGDhAAAKAAF..bGACUDDBhACA...cCGChADAAFIBNIEH..aFHHMDCH.SHFEhAEA.BFAC...hABA...,2,-13,-11,2
SMACKEHRcLGfUXITbQZdePBaYDWFNJVgO,KDFBHBBGRECBGBAHXCGG...TFCGZBFGdHAHeDAEBFBDDFGDFFHDhAAANCFE...JAFGOFHDhAAA.SAHFhABACHFEEDAF.fFAG.IHEChACA......hADA...,2,-32,-11,21
fCeXEUBRMYDNVOWcPSTgLHJKQAZIdbFaG,ZECEdDGFFAHDaHDC..GAADCGHB..eABBEGGCUAFBMFEA..DAFAODADhAAA..PBDGhAAAgEGC.HCEChABAQGCCAHIH.IDABfDCDhADABHEH...YDCGhACA.,1,-2,-46,44
YNECBXQdAJGcFLHgfeDKTMaOVRPbSIWZU,JECHFBADLEDEHACE.eCEGKFHBMEFG..OEGDRDDD.bABFhAAAIEAF.ZAGBhAAAUAGCEBABBFGF.hAEAdGAEABEEgGBEDIDE.aFFH.SFAChAFA.NIEB.CHHD.hABA...,2,-20,-9,11
FPSdCWBIVNUDZJGHfaXeETLbgROYKAQMc,MEBAFBEBdAHEBCBH..VDACUCFD.DDIFGGEBHACA..aHGEXABBhAAA.TGADhAEAbGBA..OAABhABAAAGFQDGASAGCCEED..WFDDIGFEhACA.NEAGZEDG..hAEA...,2,-19,-15,4
IAaQXYgeVKdWLEBOMTfJFHSRUCGbZPcND,QEDHXACF.eCGHKBED.dEAGEFDFBHFBMCIB..JBBASBBBhAAACHHAZCDE.PAGBhABADFCBABFG...aFAD.hAAAVFFCWHBA..OHDEFAHF.HDEA.hABA......hACA...,2,-30,-1,29
SgQRFDYeBGVPUabXdWKHJIMLNAfEOCZcT,OBEDCAEDZFFF...SABGQDCBDDAABAFBGEEDUAAA.hAAA.bGBCdCFH.KHBEIAGGhACAMDBF.AHGGfCGBhADAEAHB.TDCEFFEH.eFAEaADHXDGEhAIA..hBAA...,1,-9,-28,19
aNYfJXPUbLReQCTZSIDWHVdMOcGEAgFKB,FGCEaCBB.....NDBG.fGCE.JFEHPAEE.UCFAhAAAbDDALAAAhABARABB.CHHHSAFDhACAIDDBDFDG.HFGHdGAEMAHH..OBABhABAEECDACDHKGGDBAHB..hADA.eHDA.,2,-14,-5,9
AFLZTDQNMaOSWHJReUVcYbgCPfXEBIGKd,ZEBCDGBGQEFDMBCF..SGAGJHCARCCB.eDHHUCACVGEAhAAA...bAFBCAFGPAHBhAAA.ECFFBBDDhABA.IDDDKGHHFABA.NIAFaACA.WBGHhAIAcGAH....hAEA...,1,-7,-30,23
UcGPNVRTDFdQEefCZABbKLJMOXaYHIgWS,BEHEKHEELBDAOEBF...aAAGHAAG.IDDFSCCDhADAUADCGFAB.NFDB.hAEARGFCDBIHdAFFEDHBfHCHhAAACBHAABBC.JAGDMDDEYFDEgGGHhAIA......hBEA...,2,-18,-15,3
faBeRFGPdHNUZXMOTQIYAgEJKLDcVbWSC,ECFDLHDCDHGE.VBEA..SDBG.CCHCBAGFeBBCRDGFhAAAFBBFPFADdEHCUFBAhAAAMEDE.ODAGQADChABAIHHEAEFHKFAD..WAFEGEDC.hABA......hACA...,1,-16,-22,6
YPfZCNcUMRgJFBdWDHLEVQIaSeKAbOXTG,XFGGGABD..PGCCCCFF..UBBBMEAHRDFEFEDHdCFADBIBLHAAhAAAQFFF.hABAIHHBaAGGSEBHhACAAECCTCDG.fBAGNAEG...hADA......hAFA...,2,-26,-15,11
RWVUXEZMgaDSACTbdfFGHOPKYIQLJNcBe,TDEFdGBFGABF.OCCEKDCCQAFBLFEB.JCAHBGGGeGFEhAAAVAGFUFCE.ZABGaEHHhAAAAFIF.CCAE.FHEE.HCGDhABAIEAB..cGAHXDEEMCCGSGADhABA..hACA...,1,7,-22,29
eaFUKbcgMdPYIfNXGOLTJZWHECRVQDASB,BDDFeDEFUAFGKBFF......bEBHMCBA.dHEB.IHHHhAAAXEGGGEAAhABATAABJDHBZFEH.EADACACB.hAEAQBGGAFFA.SGHB.hAIAFDAB.....hBAA...,1,-21,-28,7
bYKfCUSDNLWHRZPXAEeGVOdIFQBJagcTM,EFFAGCABdEAF.QGACBBCA.aCGBTCDBMIFA..KDHFUBGDhAAASFEDLHDEHAAEhAAAPADGAFBEeAEDICADhABAFGFAJAFE..gFCC..hACA......hAHA...,2,-28,7,35
dDEgOYGLFZWSfNbPIUCHMJARXKTaceBQV,KEEETAEHeDAA.BFGBQGGD.DEFHEBCGODCHLAFEhAAAFHBGZBABSABFhADA.NDEF.IHEDhAAAHEBCAIHEaEHFVBGHdHCDGACGfBGD..hAEAUEGHCGGD....hABA...,1,-4,-5,1
BfVXTQAUJWRSKeIGEdNHPZgaFDbLcCYOM,JFHFSFBH.eBEAIEFFGCBBdBFDHABAZEAA.aFABDBCCLFFChAAA.CDHHOHCEhABAfDDHXGGHhADAAHEB..RCAENABF.FGAG..cBGEMIACBDHBhAAA....hAGA...,2,-33,10,43
XeNdDCFZUHBaVPKMYJSfGTEbWLOIgQRAc,eADDdFCADGAAZDFDBGHD..aDEDKACC..MAFE..SCEEhAAATFCDECBHLDCAhABAIHBBQGEBhAFA.ABBAXAFACFHGFBFC.....hAAA......hABA...,1,-30,-37,7
TEMYBFZXUWGVePSOKfJgRcDbNQLadHAIC,CHECTADA..MCDEFFGBZBFDUEADGCBE.eAAASABGhAAAKCHB.JBHBREDDDIGEQEEFhACALGAGdDDBAAIB.hAAAEGHBBFAB..XGAHWHCA.PADAhAHA.....hABA...,2,-21,-13,8
HPISJCAaVcMfRgeOYdDFULNQGZKbXWBTE,aCDCMDCE.RAFF.OGFEdAHA.FAEDLEBH.QADFhAAAGEADZGAGXEECTAAHHDEChAAAIBBBCAGFAIEE.fFHChABAgCAADHEANCIEKBGBBHDG.EDGC.hACASEAD.hADA...,2,-6,-5,1
TQLeScVAUMNFBJWHDIdPRgEGXCaZYbfKO,MFIBFFFEBFCFHBCCDFEFdAAB.RDFEGEAA.CFFC.aAHFZFDF...hAAA.bBDFKAFA.OAHDhADAQDABSGGDhAEAAABHJFAF....IHHEEGCFfDBDhAFAeBCB....cDGAhACA.,1,5,-49,54
ZEaFCQJNDMKWcHgXOGUeBLSTbIYVRAPdf,dCBBEAHBFEBCCGAA..QEBADIAG.KGHDHBBG.ODEAUEECeHCChAAALFEH.SGAEhAAAIABBRAFDAHHGfDHChABAaADF.NACF.MAIB...hAIA......hBAA...,1,-23,-28,5
FDKGdSYVHLUMZEQXObaICePWRgcATBNJf,BFGBJFBG.FCFGKBDHdGEF....SFFFVEBH.LBBHhAAAUBAEZAFAQGGAhABA.XAGAhACAODHFaCCACHCFeBFD.WADCgDDGAEEC.hAHANAAH.DDIF..YHAAhAGA.,2,-40,-17,23
TgYZeadbNcMUXBQfKVIEGRSFAOWDPLJCH,OCAHDGHHLBADHFEC..TCBBZGCAeEFAaHDE.dCCE..bBFDMBDGhAAABHBAKCFH.EFAFSAHDhAAA.AIHGJFBEhABAYAFC..cABBXECA.hAEA......hAFA...,1,-16,-22,6
cEaKRTUWLdNAIOBFHDJfVMCSYXQgePGbZ,BFABHDFCDBFEJBAG.MFIB..CHHC...SBAGQDEAeDCFhAAAGFCBZFFFaFDDTAGChAAAUADG.dGACADDBOBDChABA.FDAC...fGAGhACA.YDHF.hABA...,2,-24,-22,2
SJNQWTaHXYEBGCUbFPdVcRgIeDMLZOKAf,SFHFJDFE.QAGDaFHHHFDBEBFABACEGACCUCCEFHEChAAAdEAGRFBFeFDCLAAHhACAOFAGAGGH...NABC..hAEAXCGDCAHB.bGAC......hAEA......hAFA...,2,-16,-10,6
DZCHYTNMIXJSQAgLEKVacPGbdUBOWRFfe,LDAAEFBDKCFH.VDFE..aDCFGEDGdAGHOABBFHBADBCCCHHD.HAABhAAA...TAFDhACAIFHD.SGFDhAAAACFHgGGFPADFBHAD.fFAHhADAeFADNEEC....hAEA...,1,-10,-26,16
IaTKeZXDFgYGJBNdWCcfAObUEPRVMSHLQ,ODGBEDECRFCD..MHFCSCAE.QBDGICDCTBGAhAAAeAFCZDAH.DEEFFABDhABA.GDAGNIDHdFHECABDAGFGPADGhAHA.HEFGKBHFYFAF.hAIABGCH....hAAA...,2,-20,1,21
ANIQLWgMHVeCdEGfFbcXOaRZYSDJBTPKU,QDBALFAEMAAGHFAE.eDEECCGBECCDFBBG...XGGGhAAAaGGBZCEFDBIFBAEAKEHHAFIHIFEEhABA.gAFHhACAdHABfGDF..OHCChADASAEG...hAEA...,1,-10,-28,18
gXONHbKVLWadPZDQBCEcJRfFAMUIYeGTS,UEDGeHDCGAGG.SACEXDFBOBCBHECFKFGBLFHBhAAAaFBBZBEDDDCABFAFCBAAEEFFhAAAJFBDFHCE.ABAG.MFAHhABA..IAEE...YAHHhABA....hACA...,2,-38,1,39
WNeKBbLATXCUEDFadSZgPRYQcJIfMOHGV,CBFEEAEEFCDFdDBG.ZGFCRABA...QABA..JFAFMGAGOHCChAAAVDFC..eEFBhABABCEFAFHD.XGCEhAAADEGC.SBHB..PCADIHADhABAfGDB.hAGA..WCFA,2,-47,-19,28
bSdaecWFXCDVGgKTLAROMZUIBPYfEQJNH,RDFGMBIHUEBABEGH......fBCEQCACHGFChAAASEDBeAEDFBADCAHFVFAEhAAAKAFHAHCA.ZADFIHAEhABAEDFCJFHB..dAFE.aHCEXEECDBBE.hABA......hACA...,2,-18,-16,2
LVOHQNAYcgIfdRTUDJGFCSeaXKbPEWBZM,....gFFEfCCGdCDDRGCADBCEJFAEGGCHSAFCaACA.hAAAXEAG.PAADhAAAEBADBDBH.ZAFChABAMEIDLEECHFFDAHHH.IBHFFHACCBBB.hAGAKCEC.WEEE..hACA...,1,1,-20,21
NVWABfgMcFPEUDXGOHeabRTSLZJQIYCKd,BBFDMIACFFEBEHGCDGEHGCDH..HEADeAHDaCCFRAAC.LDFHhAAAZEAHQGGBCCAA..hAAANAIGAHDHfECHhABA.gADHcACA......hADA......hAGA...,2,-29,-9,20
GOMSKegZJLVNbXfHEAdFPQCBRaWDYTcUI,dHDFFEHBQACCBDDCRAEC.DAAF..TEFGUAGEGFAB.hAAASGGGeDBBJEAHVABFhABAXDEH.EHDChABAAHGACEEFaCEB....YCHHIEAH.hADA......hAEA...,2,-32,-12,20
fMBZaJDLGFecgAKYIHVSQUdCNEPbOXWTR,KDCEHADDQDFBUAGECCAB..EDFAOBBE..TGBCMBAFZFCHhAAAaGGFLFAEhAAAeBFG.AHFB.IHBAhABAdDADbEEC.XGGD.fEEGBCCBDABA.hAFAFAGA.gEAFhACA..,1,-4,-11,7
OKTJRMeUaPZfbADdWYLgBHXCVNQIESGcF,dDFALGEGBDAACBHDQDEE.SBAGFGCAKFHDRCCD.UAEDhAAAZABA.AHCDDDBA...hAAA..gCGHhABAXFAD.IAHGEAFAOHDEMFAD.aFCG.hACAfDAE.hADA..WHFA,2,-41,-14,27
cXeVDSLCaPNRUMgEQOAfHTBKbGdJZIYFW,TFBDBFHAKAAF.GCEFdEFGZCCE.FABG..XAECeDHBDGAHSFEHhABACHFB.aFAEhACAPAFC..UCBGhADAEHCAACCCfEGF.JHAAIEADhAAA..WAFE.hAEA..cGGC,2,-30,-20,10
gDOXJWGURLTVcCFbKZMEfYdQaeBSHAPNI,..IDGDDAEDJDCBGBFARABC..LHFG.VECBFFFHbBABhAAAMAAH..EGAFfBEChABAdAFF.QGADhACAeACHSHEGADCCgFGAWCAD.hABA..TAGB.hACACFAC.KDHBaEEF,1,-1,-25,24
gQTKaLRWZDVBEXUCGHFNSOIdePYJMcAfb,...bCGDTCGG.LGEARAAHDADEEBFFUEACGGAFFBCDSABChAAAOCCD.eAFHhAEAPGEAMIEAAIDCfAGDhAAAQEEAKAHHaBEB.WECHBEEECHAD.IHHAhACA....hAIA...,1,-5,-18,13
WCNbFEgRQVBcPKAaJXdHUDfITGeSOZMYL,aBFBdEFBDGGF..TBCFSAGA.ZBAAMBBHLEBHCHGBFFAGEBHDhAAAQFDD.hABABHHBcFEDAAAEJAEHUGCEhACA.IEDDODAHNCIA.....hADA......hAEA...,2,-26,-23,3
gAfZHLOUDSeBYXCMPKGaERbTFVcJdWIQN,ZEDELACHUDACDACAeAED.BFFG.CBAD.MIDGKGAD.GAEA.hAAAECCEbFBD..FDHHJEHBhABAdAGH..QBGChAFANHAF.AGEHOEDGSHGE.XABGhAAAPHEC....hAHA...,2,-28,-16,12
beYgCGIOHVEUMLFNfDaKcQSWdRZJPXABT,BBHCeDFHCEBAGCEE.OABAHBCAEGAHMAGBFHDA.DCGGKFBHQGGBhAAAdCBHRDGF.JAFAAAFF.hAAA.....YFHBhAHAIBAB........hABA......hACA...,2,-30,-29,1
PUIDJaeMRVTEdABGfCWKFSNcXbHQLYOgZ,BCEDCHCFKFDE.SDBG..XBFAQDGHLAAHhACAOFBGZDAGUAADDFBBaGFFhADAMIBC.RAEG.EFHFAHABfHFHhABAFDGH.NGDF.cCDF...hADAYACG..hAGA...,1,-18,-35,17
eTHgCXdBFJcSAaEbKNGDLQfYWVURZOMIP,EGBFKBAHDFCFLBFE.QFDG..fBEFhAAAVDGFZBBFMAFEPDDHeBADhAAATBGDCGHHBCFA.FEAHhABAJFFAAEEC.aEBB.NDACGGDFWHCA....hABA.OHAC..hACA...,1,2,-30,32
TeSGDWQOYHbLAVIMBUfPgcRJXZNCadFKE,VCBGBAFCUCEH....fHCB..gBBEhAAAJBHHXGAHCDABFGGGTFEAhAAAeEAADIBG.OBHFhABAHADGAHHG.IABHPFED.cDAHhADA......hAEA...,1,-26,-36,10
RDgKBcaASYUZTCPLXFWGOHdEVIfJeMQbN,SACCZCFCCGEGLBECFCHFGECCHDCBdFACEFAF....VAAChAAAJCFBMFHFQGGEhADARBCCDIAGBAFHADCB...hAEA.YEECPBAD.WHAAfHEDhAAA......hABA...,2,-22,-6,16
ZgDIBfVYUbCARcWPSFXdHGLeTMQJNEaOK,REEH..PAGBFHBAdCFFLCAG.MEECJDACEAAD..OFDBhAAAKCCEZEAADAFD.IFHFhABABAGE...fEBChACA.YABGUGGHAIACWACGhABASGFF...hADA...,2,-40,-23,17
VZfKegPYTIGEcLDAWSQbMNXJUBOFRHdaC,SAFEMBEB..JEAABEDFFAAEdHFBaDAGZGBA..KFDHeBAEhAAA....gBGHhAAATCGHIFHDhABAEHACDCDB.AFGFQBEG.XEAAhACAOAFBCFGGfFEGhADAPDHD..,1,-12,-43,31
gUaKdFeSIADWPYRXMcLHBGVbNZOQJfETC,DFCF..PCFHXEEFMFGFLHFE.GABHNDHGZBCDOGBEhAAAfCDC.EFAHhAAAgAGEaDHD.hABAFFACSHBGAIEARBAHBACC.bAFH.TCAEhACAKEDB......hAEA...,2,-12,-11,1
feaSZLYPbcNGKADVMIQJCdEURFgTHOWXB,MDIDQBDGdEABUEECFABHHFFH.XGBCBACFeBDE.aHFGhAAALDFC.PAFGhAAANCDCGGADACABIEAChACACBAGRBGH.OEEB.WFHHSAGEhABAYDCF....hADA...,2,-15,-15,0
HQMOfEeVFXYPDKCIBUWTJLagRANbGZcdS,GAEAZAFAdFGBHEAHQGADMDDE.EBACFABDXEBEDHGE.KHEEBDCDhAAAUGGGJGCALAAChAEA.gCGFhAGANIEH.SDDBeDFAYBDACAGA..hABAWFFCaHAEAFFH...hAIA...,1,-2,-13,11
aHQgAEJKfXIDOFTRSNeGPVZdWcBULbMYC,JADDXDBA.DFGFFCBF.RDFE...eCFFGFDBZBCGdFABBAAALBHFhAAAMFCD.aAEAQAFHhAAAABABKGEF.OFABhACA..SHACNIDF.WBBChABA.bFGHCEDG....hACAEDAD..,1,-22,-26,4
WTGXcDRSUaNZHObPeVQYCgdLFJBMfIAEK,EBGGTFAFGDFC.DEDFSAAE.aEAAZBBDHCDDPBDEhAAAVDFBCHHHdDAGFAHHBHDGhADAMDIBABBBKAFB..XDDFhABAcBBE.UGAEOEHDeHDG....hACA......hADA...,2,-7,-4,3
bUIdMLEWTRVDCNXJAHYOeKSgcBQFZfaPG,HAAEODEAKBGF.SHFABHBBZEEAaACEGEBB.UCAFdAGGLBAFhAAAEFGH.TFCAhABADFADCGEGJBEF.eHAAhAAAgCCF.QGGB.fFAChACA.IHEBhADA,2,-23,-15,8
SAagYELXZdbFKDOBMJIGfRCcVeWQPUTHN,aDBCEGFHLFBAZGDE.dCAAKDFCBCFGMBFEGAAFRFAC..CAAF.eHAEhAAAQBCBTAFASCDDhABAAIGC.hACAgDFAXEGE.DBIHIFED.hADA.fEHAhAEAWADC...,2,-29,-14,15
USWINAcDJMOBeaLRZKYXTdfHbEgVQFGPC,DAEHJACHBAGHLDBC.KGDE..XADFdFADHEFE.EHACQEEDhAAAFABG.PFBDhABACHHAUBFC..IEHFhAGAAAAFMICGOAHDRCEG..YBBFhAIA...fGHGhBAA.,1,-19,-38,19
LJFPEXTaeWKUQVCDAIgBYHNcOfSdMbRGZ,BADDHFCDOEAAdCBDRGDALBGFFAAG..PFAHEFCC..aABF.hADA.KBFFUGGAQGGChAEADEAG.AEFCIBCBhAFANBFC.SCHHMAIB..ZFAD.hAGA......hAHA...,2,-23,-23,0
AKWLOFEDIYaMSgTJebZCGBXHNcQUdfPRV,KDDBOFFEECGC.DCEA..aDBFMEBH..TAEAeHEGZACF.CEFCBDHGhAAAHFGDQGCHhAAA.dADCPAFGhABAABADWFFDIBBDSEGC.gGAFhABA..bFBH.hACANEAAfFDC.,1,-1,-28,27
gFPORWZLDAcfeJYSBEaVIGMbHUNXdCKQT,eEAASFGDEHAC..aGHHGCCD.HGBAXFEHKAGETABBhAAAFBGDOBBBRDAELHFAhABAAFEF.fAFEhADABAEEMIDENBICCEFFPDHD.DDDE.cADHhAAA......hABA...,2,-23,7,30
BfYZbUOFaMJVcdWILDGRNgKEQCSHeXTPA,BCAFZBDGUAAHFFGC..MBIHJDEH...dAECLDHBDDEF.GDBGhABARAAGKBFC...CHFHeADAhADA..TGDEhAAAAHHG..fGDCODFBaDAE..WEADhAEAIGAEEDGD...hAHASDCH.,2,-36,-18,18
PafKLgCFXUYbdDAJOWGIcBVeHNZSRTEQM,OEDDGADBBECGHGACSBDBEAAG.MBCFaCAEKGCHLCADhAAAFGEBUDEHdGGEDFFHAGAH.hACAIAGBeEABZCGFTDFDhABAQGGA.......hACA......hADA...,2,-16,-12,4
cAWCfITeNPHJLbBGDUYQgVZMKRSEXdFOa,CDHCTDEH..eBEAHEBFLGDEBBFHDACAQABDZBAAKFGASBDBhAAAEFAFdDDHaDAAAIBC.hABA...IHEAhAFANIAH.PBHHJFHB.......hAAA......hABA...,2,-27,-18,9
VUEPTLCcOaSHdYRbNeJgKfFQAXDIMWZBG,XCBEMICEZBBABGFHUEFA...EDBATGCDLFAH.CEHA.aAEEhAAAHDEGdAHA.RAECeAHHhAAAKACCFHFCAAEG.DCEA.IBBGhABA..WGCC..PFAGSABEhAHANEIG.fHGFhBAA.,1,-15,-20,5
XIgCbOMScZQWdHRLUeaJFPAYTDKBfVNGE,DHBCBHAE..VCDHEEFC....XBABCACBOBFFSAFHhAAA.QGGDhABAHFFHRBABeFAEFECHACIHYEHHhAAAfDDF.IHDEMICAZAGHWDADhACA......hADA...,1,-14,-37,23
BTEHFXQbSGPRLDgZIUKAfWaeVMcYOJNCd,aGAHeCDD.MBGFOFFD..CCEGdGACBGDGEBAFXBDE.QCBHhAAAGDBEPFGDhAAADABCZBGHKHCGABBBfEBAhAEA..WBHD.cFEG.hAFAYABCTEDH..hAFA...,1,-20,-30,10
UXBeSaVHTJdARYDfZFIOKCPGELgNMQWbc,DIFGFDABOBAECFEA.GDFAEBCHLDGB..MEIFQBEGhAAAbFAA.UGBCBHAEhAAAaFHDTDDHACAC.fBFFhABAIBHDKDDDNICB.XDADSDBHhACA.....hABA...,2,-32,-10,22
HZdFYTIaACPESWXJeNLcVODQfKRGMUgbB,EDBHXBCG..JEDCLEAFOACCDEAHKDEAMHEA.UBGAhAAABFGHHEBHdGEGTCGBhAAAAFFACABC..SADEhAGA.NEIC.QGAA.fBAAhABA...hAHA...,2,-39,-21,18
IKfBcAVHadFSDZLWQEUXeCbgMGOYNPRTJ,aDCBFABDZDABLDAF..QCFDUDEHCGGE.MAABODHF.hABA.NEDG.RABA..TBEDhAAAKGEFBAEDAHAH.HEFAhADADFFFEGBCeAFG.........hABA......hACA...,2,-28,-21,7
RSZcPgJLQCNWDGEFbTfHYBXdVeOIAKMaU,aDBBREDBZCFG......PCFHgDADJHFA.CFHG.DAFGECDHFCHDhAAA....bACATBCDhABAHGFABHBAdEDGeHCGhACAAAHDKAAFSGBFLGAE.NDAG..fFGDhADA...hABA...,1,-15,-16,1
MOaLJXPeKgIAdFCDQNRHYEcUGBWZSfVTb,FAFCDCFCREBCHEEA.EABEUBAHBHCDZGDA..SEAG..hAAAfFAETBDEbGEAhADAOCHF.aFEEXBGAhAEAKBDC.AFDBCDHGNIAD.cBBH..WEEEhAAAMFIF....hAHA...,1,-16,-36,20
bREXAZWafUICSTNKDVdQeGHgBOcLYJPMF,aGGCUFBA.CEGF...TBDADIEA..QBCDGGBBBEFALEEFhAAAJBAFFAHD.RDBHAEEBZBAHhABA...IAGChACANEAAKBBE.dGHG.eAFDODFA....hAAAYAHBMIEE.EFFDhADA...,1,-14,-27,13
KDMHUcdePBZLfCFOGYXbgIASQVRJaENTW,SAHBQGDEJAGDEDGA....TGAHKGGDMFFCHAAEUCAEhAAAeFDGZFBHLDCEhAAA.CBDAOHFGGABFXCDAhABAIDABAFABaDGEDGDDdGAGBEHH.fBFFhACA..hADA...,2,-11,-8,3
YdVLTGgKASOWPIBQefMEUFDZbJcaCHNXR,SADDOBHH..IDCEBGGHeGCAEFGF.FCBBZBED..JAGBhAAACABAHDABREBA.dADETDGFhABAGGABAFIF.WFFDhAAA..fAEFDAIBaBAC.NIDD..YEAFhACA....hAEA...,2,-31,-8,23
DKQZPNJTHBeaIYdSRFbWMcOXVgGEAfCUL,UDAHDCFBZFAF..JGEGBDCA.eGDAaDDB.dAAEFAHB..MIDAOGBGhAAA..XAGGhACAGBFCACBFCDADLCHDhADA.KGHHNIDHIEEASEEA.WBDBhAEAgACD.fGAEhABA,1,-33,-35,2
KBJISTUdQXODFARcMafPVGEgHNYLbZCeW,RCAEaFGA..VEEEEBFHHBAFLEAFZACHCHHFKBFEBFAB...SHCGhAAAdABDXECHOGEGhABAAAIHMICE..fAEChAEAPCHFNHCH.YAHF.WEEChAGAIHHE...hAIA...,1,-18,-24,6
HPcQeKVUaADEgBfFJYGbTdOLWMXNRZSCI,DIAABDBEFCEGJAEEGEBF..dGCDODAGMHFE.RGDG.ZDFH..CAAAHFGHhAAAQABCKGAG.hACA.aBCGAEFHEBHF..hAAAfAFBTECELEADXCGDNIDD..hADA......hAEA...,1,-19,-23,4
GMeWQFNCaAIPLDSbcXfVUKRdZgBEYHTJO,LEEDSAFAXFFFUEAH..dCDFZABEBBBAHAGBOFEAhAAAeECDFFABCHEB.ADFEDIFG.hABA.fDFHhACAKDAEECCG...TGAEMAAANDIAIHHB.hAFA...cAEEhAIA...,1,-13,-30,17
TfDOPceMQXYSCNRUbKWILZdJAHgVEBaFG,VCEFBACFaGGB.GCCEDHAA..OBEAeBGD.MADAQBAChAAA.SHBChABANCICRAAGKGGALCAFZAEBAAHEgEABhAEAFHEC.fFEAXECDCFGFWFHBhBDA.....hAAA...,2,-25,-2,23
NXdVFcfJOCaYGEQZSKbAPMIBUegHLWRTD,MGECUDDFHADFLBABRCADDIDEdGCA.FHEE..JHAGCCFAGDCDZAGF.hAAAKAFAAGCABHGB..hABAeFAF.TACHhAAAXEGCfEHEOABFEAFBSCHBhABA.IHHD.hADA...,1,-6,-27,21
NCVXBcQZfJFWgGMLIYEKTUdReHSPDbaAO,CGBBBEGBZFGH.FFEEGBDGLBBB..IBHGEHAC..TBGAhAAAdADFeBBBHBDFDAAEAABGOFAEhADA.NIEB.XCFDhAGA..fAEDWHAAMEIDKFHHhAGASFFD.hAHA...,2,-24,-24,0
HIbdSCODMPQfJaLKNUBYREVGAcWgFeXZT,....gDAEXGDBZAFEHDEBdGHASDGCCEDBOFADDABHhAAAQGAD.fBCAhAAAaDHF.KFCHhABANCCEBCAGYHFGEGFHADFBFBFA.IEHDhACA..MAEG..hACA...,1,3,-34,37
WbfFXECgDOGYMAUNdeJRcSLIPZKHTBaVQ,dCGBeEBBRGEGLBAEZBBHKAFABGHC..VEFAQDGD..hAAAbFADXADB.hAAACHFCDEFFODDB.MCCFhABAAEEFJFDF..cADFICABPAFAaAHF.hABAfCAC.hACA...,1,-12,-31,19
gBCJKZWDPSYFIGeVXAMOQdTNfaHUcEbRL,MEFAOCDAdCGH..TGDHaFGH..HEBCEBAFLEBBBCCGJAFCKACBhAAADBDASFGGhAAA.IEDFhABAeHCCABABfBEEbAGBCCCGWFAD.YBAB.hACA.FHFE.XDGEhADA..,2,-33,1,34
EHOPIdJcYDgUSBXGMZWaRAfbCTKFVeLNQ,CDGCKFFGFECDLABD.QFAFEEFDHCABOHAAdDGH.JCCEDIAGhAAA.SDDDhADABAFAMIFAaBFE.AIFATADDhAFANDIA...IHDEgAAC.XAGHhAAAWFHB.fADFhADA,1,-24,-37,13
gZFdBcfSeOIGbMATCWVLQJNaKPXEDUYHR,CAEDLECH.JDADKFCF.EDDDUFEDHABBZACHdDFHBAHD..fGFChAAAeABBGCGGhAAAAIGC..TBFBQGAAhAEAPFAHDIGCgFGBSFHHOHBEhABAMCFF.....hAFA...,1,-13,-17,4
MNWCRDUQOPKgfHEIYdJTXecLGAFBZabSV,FHDEZDCDaCFD..VCBBMCBF..CACD.DHDCUDGH..QGGAhAAAOGAA.KAHBHAFEhAAAIADBJFDA.XGAGhABAeAED.LCCEBHHCSBAFhABAWFFC......hADA...,2,-28,-19,9
UWfZSbDeKFXQRMYATgBLVJIOaCcPHdNGE,TGAALDFF.JDCHOEHH..CBGCHEGHdCEBGABAUBBB.ZFDDhAAADABCFEACREAB.AAGDBBAFhABA.IGFCPHCAEAEDhAAASDDG.KADCMBIF...hAHA......hAIA...,1,-17,-20,3
WRcdGPbBaZLfKJIXOESUeQHgVDANCMYTF,MFFHTACCFAHB..RBGDGFABBDHCLCBAKDDA..XEFDhAAAEABBUFBAeCAD.gBABhABAADGHCAFA.YHFAhACAcGGCdEACaAHFfCEBOEHF.hAAA.SADChACA...,2,-33,7,40
FURcKXJbfgWeLSdYQNEOTHDMPaVBGAICZ,CFEHFCEFUAADKEGE....JABF....fAFGeDAFdHDB.QEBEhABAEBGD.TCDChADADAAFMFBB.aHGGhACABGFA.AEADZBGBXDCDWDHHSHFAhAEA.NIAD.PADAhAHAIGAG.,1,-23,-32,9
eSFKVJGXaHEfDULBAbIcYgROPNQWdTCZM,..IHHC..gDGAOBEEQFEEdBCGCAEEMFFFFCAGhAAAJFDHaEAH..ECFFDBAGhABABCAHAIEC..cDDGhACAPAHH..WFBHTGGEeAHBKGAC.XDCEhAAAfDBC.hABAbDGD..,1,-13,-32,19
PJIOMHWUXdSGfFEbCeDRcgAaZBYTVLKQN,BDAEVBCA.LCGB.QBCBNDFC.JFCCIABAhAAA.MGBAHFAFUAGBhADASAFEFHFEEDHFeFADhAEADEDCcGGCAGGA.aEHD......hAAA......hABA...,2,-31,-19,12
BcRgbCZXQJeVDTFAEIYfWLGMONHSaPdUK,EDAD..fCAEGGDFOFBESCGAaHAC.dFGFUAGG.hAAAKCDFcEAERAAF.gFDDhABACEEDXCFCQBCDhACA.eHEADGGCAECDIHCBhADA.LAFA.hAAAHDDG.,2,-15,-5,10
HCPdQUTbDgJIXAMfGcOKLaYSEVBFNRZeW,GAEBOACEKEECLFFB.SBAAEBHBFGFGZECFHDAE.CDHGdFHGhAAATGAEDCDAgFDDhABAXBAG.AIDCMDDGhACAaAGABFACeFADWHEA.....PCDAhAAA....hABA...,1,5,-31,36
TEZBcSDFReVQPgdIKHGfNACOUMWaXLYbJ,CCHCOGFGUEDH...MFFA..aHEELBHD.JBDCTCBEhAAAZDAFBHHESAFAhABARBBDeEDD.VFAH.QACAhACAdHAFKAAC...fEGAhAFAAAGF.WFHH...hADA...,1,-23,-24,1
dNKbWCAPQaMDRcLZITSXeYFBJVgUHGOEf,QGFCaGGG.MDADRBEHZCAC.SGDDXCFD.FBHFBCHEhAAAJEAD.VACDHAAAOFDFhABAEHAAdEGBKHBG.CFBHAAHFDAEDhAAALFHBIHHEeBEH.gCABhACAfEEG....hACA...,1,3,-15,18
BTLWVEOPIXYgRaZSNbJAHMUCFfKdGDeQc,MECEUEFECEADKBDE.GGBHDAGB...QBADBHAELECHhAAAEEGD.OBEB..hABAIHHE.YCFChAAAaBCBNDIE.AGGDHEAAFHFA.fAGFhABAeCFA....WACEhAHA..,1,-24,-36,12
VIRHWJFNUfKCbGaOQXADeLcMgYSZPTBdE,LFCGMEEA.SCAGTEBABCACdDHEEBBERABCHGFC.JFDBFGFEhAAA.UCEBCGAD.aAEGOAFAhAAAAFBF.DDDGeHAAhABA..gBGGZDAEIBHFfFFHhABA.....hACA...,2,-17,-13,4
QdfMAaSVDFLcYPROJBKZHgCbUWXeEGNIT,aGHHSBDE.DIBEFCHBLEAC..PDDERGEAODHHhAAABCBBKBCFHAEA.CFFBbEAHhAAAXGAG.eBGFhABANIBH.IEEFdBACfGCDAHIH..hABA......hACA...,2,-28,-20,8
aKAQEGPCfXTLcJeODWIVBSNYMbFUHRZdg,QCGDEGCGGAAGCHAG..XBDELCFEeDDDOFGFDIAAVFFDhAAABCDGSAFChAAA.MDAFUAGDHDEGhACARBABdFAEaDBDAAEDfEHGcGBH...hADA...WFFD.hABANEIG...,2,-15,5,20
DRLdWAIbEYVUagJfKSPTXNHGMZQCOFecB,EGGEUBGG..JEBESABG..XAAAHDEAZDACCGADFGDHhAAABCCCLEFCAHHH.hAAA.IGCCVAFDaCDChABAKEHB.NIAH.MAIFOFGBDIGA...dAFG.hADA......hAEA...,2,-25,-21,4
WRCBVZfbNFSUXDgeAJIcTGKOadPQMEHLY,JEEATBDGGCAF..aFFFQFDCHBFBLHFGREAHBAAHVDAChAAAZAEF....NICF.SHBAhABADCGC.AADEKEHBhACA.dAHAEGGBYGAECBCE.fBBHhAFA....hAGA...,2,-23,-6,17
bafeUgHTAOSXEZJGPFCDKMcYLIQWRBVNd,XDCFEAACZEDHGDAGFAEG.KCHD..MAAALFFAQFDAhAHABCBEdGCEaFGD.eAEGUCEAhAIATACCSBHHhBAACHHEDGAH.IGBB.WBBD...NIED.hBCAfCEHAFGD.hBDA...,2,-20,-12,8
TEQONFHKSfIZVbeWADPaUMdCGcXBRYgJL,DHACUFGGdDAECFEC.GCDCBDGH.RACF....JDHBEGCG...QAGFhAAAFAGFKGFH.SACFhABAZAEF.eAEBhAFAAHIFMIBC..YBDFTAAC.OHAEhAHA.NIEF.fGCBhAAA..,1,-26,-37,11
WgDcYMfRIOVCNGXAKTaHQbSdeZJPFLEUB,aEAGQEGA.SEFDZCBAFFHDEABGUFCBBGEGDCBG.MDAEhAAARFABOECC.CADE.NCEDAIHAhABA..KHCG.HCGFhAAAdAFDeHDA.JABGWFGD..gGADhAGA..fAHEhAFA,2,-24,-22,2
JfdOBERFYNeASPaMCcXZHLUQGWIKVDgTb,SBCHMGBC.CBBE.XDFDHBFHQEGHGBCGKHAGVGAChAAADAHB..TBAA.hABAJHEEdBEGBAEGEEAGFFEHhACANDIA.AAGGaHGG........cDAChAAA....hABA...,1,-4,-33,29
cfCFWSBgKMUJROXVeDAQGYNaHbZTEdILP,QBGHGCBDaHBGZBFAdDCBLHEC..fDAEhAAAFEGFBBBEKEAHUACHJADGXEGEhABADFCFADAC.HEEFEFDF.hAAAIAGHCHAB...SHGEhADAMFID.OHDC..hAFA...,2,-25,-9,16
ZHIXMGAVDTNPWRfcaLOKCBESUYJeFgbQd,DBAHTDDH....PDBHRFACaABCOBEGBEFGUCGF..eEHFhAAAFFDD.QGEHhACAdFHEZBCHHAEAIDAHhADAMAAEABBDWAFELHCGCDFBSCCF..hAEA......hBAA...,2,-21,-16,5
IZBLVbMYXFDfWaPOHAUQRGgcdJTSKNCEe,QFDHRDEHGBAEdHDBJABCKAGF...CFCF.IBHGZDGD.LFBDhAAAMAAA.FAFDDAFDaDCGhAEA.HDFBAIACUCCC.hAFA............hAHA......hAIA...,1,-25,-35,10
WFVEOSPJegbYaXZICdcTHMGLNfRKAQDBU,DDBHBDDFFHGGOFEA..JAFAeCAB.....gFBChAAAbBAE.aCHFIDHEhAAACBBCdGEGHAEBGEEChABALHAGRFBBAECC.WABEEADE.SFHHhAGA......hAHA...,2,-34,-17,17
LadfSAYRFGcKOUCHeIDgQTPEXWNZVbMJB,RAAHFDDFKEBGCHAE.HAFC.DEEFQGFF.EBDGXDGA.hAAAZFFCbBADMCDEBFAGaCCChAAAdDFE.AAIB.GGAFhACAOCHHIHFDTGCCNADB......hABA......hACA...,1,-10,-25,15
PQIHJWCSNeUDMLARVfXcdOZYKgGaEBFTb,VEDFXCGG.dFBBZDAG.KAAFGABHBCFA.TGBF.QCADhAAAIDHCJCAGCFFCSEDBhABA.eHFGhACAMICAAIEGfGGDOFHFaBFAFGAAPAFAhAEA......hBAA...,2,-33,-4,29
BXATPSaGcOZQIVWREYNFDfedUMJbLKHCg,SHDGGABEZGFCQFBH..WGBCRDEGEEAHFAAGDEIHeBEGhADAMBAFLCDBhAEA.KGGDCAHCBHDHAHADPCCBhAFAcBDD.ICHAYCHB.fAGHhAGA...hAAA...,1,-19,-23,4
fMWeFdZADCLbKIJQOcXgGBYVEHSNPTRaU,DEDHLBGFKCAC.QDBGOEGD.XABBBFEB..EBFGSHDEhAAA.TGGAhAEAUDADMEIBeBEBFGAFhAFAZAACCHBBbEEGJHDA.......cAGAhABAYCHH..hAGANDDHaEEA.,2,-42,3,45
JdgSHBEQVfUGDFWITMZAOaKRNLXcPCebY,KCCGLEEF.XGGBPCAF..CGAA.eAHH..JECFgDAEhAAAHFGHBACGQBBFhABAUAFGFEEG.IGAChACAMIBG.AFACaDFFNAIC.cGBE...hAAA......hABA...,2,-34,-10,24
YBVgKOGZEeHRMaINcAbfTPULDFWdSCQJX,TBABLEBA.DBCBdFBDCGHD.QFFH.JCDGXGAFhAAA.VAEFKABEODEEhAAAEDHHHFEDMAHB.IAFFhAEAABDHPBAHWHFABHCE.....hAIA......hBAA...,2,-29,-21,8
TSRHZYJbFDXfNCEGcdPLIMUOaQBKAgWVe,VDCCeBDARCBH.ZCGF..JBAFDGAB....XAEDCGDHEAAFGDEAhAAAdGABLFHD.hACAIFFGMAFGaDABBHEChAAAAIEG...WBHFSHGA..hADA......hAEA...,2,-34,-25,9
YENSbILFgPKeJUZAVQDWXdfGBCaMTcHOR,VDCCQDFF.DDCBXFFGdHAFGDDGCBCC.MBDHHAGDOBEChAAAECAE..SGCDhAAALDADFGHDKEAGJAEHhABAAFHGBABH.aGGBcDGD.....hABA......hADA...,2,-15,-15,0
WRXedUDaPSNQBfJVAKObLEgFTZMHIcGYC,OHAEECGFFEAH.ZBFCHAAHGFDB..CBEERDCAXBBEdFHE.aEBCSFDHhAAA.BHBAhACAfAADAIEEKFGFLADChAHAMEABIEHA.WBDHDCCENAIA.hACA......hADA...,2,-30,-12,18
NYSbVAaJKDdIgZEMcQWTCHLOGXBPFfUeR,aBGCJBDD..KCHHdFDH.ZBCD..EBFCMBAB.QGAGCCADLGAEhAAAODHDGEEABHEHhAAAFBBGeEAGRBED.SHGEhABAAHGBIHHA.WAFE...XDADhABAfEHG..hACA.NIAH..,1,-13,-32,19
MEcSdJaLAbeXRZVQDTCYONUgKGIHWfBPF,XFGBRFFFQCEBDFEH...CAAG.ODDEUADHKCHDHBAC.BAEAhAAAMCAHSCGEhABA.JDAHaHAEAHBGeECDhACAZEAB.......YFFFNDDGICBAhABAfAGFFAGEdGEC.hACA...,1,-16,-18,2
FGCBHRISPEYDVaTZeWJfdLKUbQXAONMcg,MAHHFCBCBFBGHECFRFEC.SBAH.EGFDVAGDZCCE..eEHDhAAAJABCLECEKFADUACHXEEAhABAAGDF.NIBH.hADA..gGAG.CHHG..IEHHhAAADAIHaBFF...WAFFhAEA..,1,-1,-37,36
UJRaQFfcHMeDgOLdNIbPAVKGCBESWTXZY,KEFECHHFBAABEEDB....SAACXEDHZAFCUAGG..aACGQBCAhADA.FFHHhAEAfCFDMECHDDGGOFABhAFANEBE..IECFAIFG.WFFBhAGA.JHCG...cBDHhAHA.,1,-21,-53,32
gedWaEcDfTMJFOVYbNCIKBSLGZPURQAHX,XDGDdFEBaFAB.DEBFMDCD..FDCAOCHH..VAAH.hAAA.NAEHKBCGBGHDSCAHhABALHBAPAFHhAAARGBAABGC.eFEBEHGEfDEDJAHHCADD..hACA......hADA...,1,-22,-28,6
GBfUELFDZYIAVcNHegTSXQPMaJObRdKCW,VAADHCEDTECC.QGACMEBHaHAC.JACDRCEE...dGFBCFFDBGCHhAAAfAHGLCDDhACADIGGIDHFhAAAAGHBeAFASCGEPCADOHCCKADE..WHFAhAGAEAFD.FEHF....hBDA...,2,-17,9,26
XGQCPDaOSAVgRYIUcTJLbFWNKfedBEHMZ,RFEDUCBF..JBEALADEFEAF.KHEAdABGHCGHZDFFGDCAQEEGhAAA.DFBBSGAGhAAAAFCF..gGGBhABAIHHB.TGCCNADDBDBBECEA.CHAG..hAIA...aEHF..hBAA...,2,-27,-12,15
UJCKIPQLGYeVRbafMXEOHFSNAdBDZgcWT,DBCDZACD......gEGHTDACUCGAJHCG.KGGG.QGADhAAAGBEBVAAFaEEH.hABAMFBB..OADBhACASEEFABBHBGDGCAFCIAHHPAFE..hAAA......hACAeDFDbEBB,2,-31,-24,7
FbfJDOSBIGdVTgLZYeRQcEAWMXNUKHaCP,XAACUGGHHBEA.aGBEFBEH...JHEADACBBCGHGDCB.TEADhAAAZDADRDCGEGCD.AGGE.hABANBICKAGC..CAFA.fBAGhABAIAHGdEGB..gGDHhADA.eADF..hAFA...,2,-28,-10,18
bMIdQPXRAUHWJVOLKeYDgBZECNaGTcFfS,HFAEJACFLBFBeDHDDFCGBFFCZFFF..EABDCHDF.GADB.FDCGSFHBhAAAMAID.dDAHhABA.QGAChADAPHCAADAE.....WEAA.OAHD.hAAAKGGD.....hACA...,1,-13,-30,17
NIESeFcRLOMTXACfHQBYaUVKPGZdgJbDW,CEGHQGDCBECC.aADGKGEH.GBEGdDHEJBFHDABD....IBADhAAAeFAHFGHHRCCHOGFAhABAMAAH..ADBBHAGDhACAVGAA...gGCD.NCIG.EAGEhACA...SEEGhAIA.,2,-26,-18,8
JUDLXKFGTMWCfAIBVPYEeSOQacZNgRdHb,VGBAEFDB..OBAGQCBCZAEGRDCEHCFAUBFBLFFGKHCA.hAAAFHFATFAE.CHGCAEAFhABABEEF.PAAAhAEAeFFEaCAENAIC..dGACDACAMFAA.IBDGhAFASAHH...hAGA...,2,-11,-3,8
CbfKIRFXOVcTLeZYSBPNDEaUdQGMJgAWH,CGADKABEFEGCOFBD....TFDBLEHBeCDFSCDChAAABGBBDAAG.EAEGdBBAMAIFhAGAABIDHAFH..IDEBhAHA.RGDEXDFDcGGH.PBBBhBAA..NIAFaCED..hADA...,2,-36,-11,25
IECeNAXJVDFOZLabWRKYQGgBPHUcdfSMT,VCCBDDGAOBDD.LFDGaDGC.RDAD.KFFDGABABADDUGBGhAAAdAFE.MFEFEEHFCHEGeAGDhABAAHIF..FAHHZCAB..hACA...WAEB..YAADPHFC.hAHA......hAIA...,2,-22,-20,2
OSQeTdaHAfKbIRZPEDWJBGNXYUgMcVLFC,KEAARDCFEGFDDEGE.BGGAGAGA...XABEUAEHMAABLEBFhAAA.CEGG.ODEDhABAQAEBeDBEaGDBABAHfGGDhABAZAGB.WFAD.....hACAYFDB.gCAChACA,2,-48,-2,46
TfbVPYcNLXQKZgCUJEeHOIdWFSARDaBMG,RBAHaAAEBEEGGEDD..TGAH..VFBB..PGFChAAAcAGCLACG.hAAAXCGFQBEDhABAgFCBCGEDUGGFEDCGeCDGIEAAdAGD.hABAFADGDIEG.MDIB.hAHA...,1,-4,-13,9
QJfFDHEXOPMbTdVNYISABLWCcgUKeZRaG,LBAECGCGUABB.ZFABREFH.QGEB.FGCFDIFEHCEHOAEAhAAAMAHFdEDB..YDAChAAASCDA.AIDGBEBGhACAWFGB..KAECaBHH.....fFHAhAIA.EGDGhBAA...,1,-8,-45,37
gZaYCTbAROPBKSNGXJEVIHdFLUQWfcMeD,OFDGBHCCKEDDGBAD.EFCDIHHE.dGEBLBFEhAAA.QGGChABAfAFEMEBGDBIHgEAFhAAAYADECHABACHBPCCCSEHB..hACAXBAB.JEEAhABA..FGED,1,0,-45,45
fFeAdMTDQZJLCbGHPOaRSUWEgNVYcIXBK,TADAQDDA.ZEGHCDCHGAGCOAGFRGCEUGFG..EACDNFAH.VBABhAAA...IFBBhABAXBAEBAFCKEECfGBChAAAAICCMIFADAID.......hADA......hAEA...,2,-26,-13,13
AWNCTHfdPSBeYMcDKXFQaVgOEbZUGJLRI,CBGHTDBFHGEEdCBG.BFBBeHBE.MCCCDEGBKCDHFBFA..QGGBhAAA.aGAHgGADhAAAEEDHZABE.GABFhABALFFDAHDH.NDDBfFABSAEEYCHBhACA..XEGFhABA,2,-43,11,54
WcaZBbKJCFLOAUVTEDHMPXNISdfGQeYgR,TGAFECDADGEH..HEFCMEFA...XAFANACD..SBAChAAAfABGQDBDhABAeFGBRGDCaFCCBHBFhAHAbACBKECCCHHBOBGBAAFG.......hAAA......hAIA...,1,-15,-24,9
CeDGZLSUQPJcbNaTYMOXfgIBKWHdFRAVE,VGEGCDDFDEFB..GGBBLBDF.UGABQDAE.JBAGNAAA.hABA...TBEHhACAMEIDOBGDXBGDfAFGhAAAIBBBWFAEFHFEAAGGEEGB..eEFGhADA..SADBhABA.,1,-12,-30,18
EPGeWTJXLbBgdHNMVfCURSOaIFKYDZQcA,EDCHeFED..JAFHXAEDBFDB.HDFCMBBFCACDRBAH...aGBCFGGFhAAADCDFQDGEhABA.AGFHGGAFWFFATAGDhAAA..gACCNEAC.fCDDhACA.SAGEhBAA,1,-23,-28,5
MIAcCWFaKVYTPXNeEbgZRSDULOQfHGBJd,CBFDaDDGKFHD....TFFG..PDCAXABA.eCFHhAAAEAGDZFAEDHDGLBHHhABA.fFCHhACAHFEFBDABMFBFADHEFAAFNEAE.gACBSBEChAEAOHAE...hAFA...,2,-30,-17,13
BcAJaTSFZHUREgfDPOIXMKLeQGVYbWNCd,JFBBaCAG..FBDHUEEB..EHDADBBB..OAGHMHFA.KFGDLAEDhAAAGFAB..bDFACDCHBAHChABA..ABBCSAAChADAHBFA..fEHGIEAGeHFAhAEA....hAFAYCAF.,2,-40,-11,29
UgRCIDKWPbQLJfZAEcVXSOdMeGHaTNYBF,EBEDVFBH..OBFGeEGDGBACHCGHTDBABDDCFAEF.UAGGhAAAgEEC.CHAFDDAHhAAAKABEPFEBLBAGhABA.fGGFAIGCSDFFMGAANDIA...hBAA......hBDA...,1,-1,-16,15
ZDJHCVGSOLaBQMfTAWbYRXcNUdegFKEPI,...bDCDXBFA.UFGBeCACKEDF.ECBEIEFA.hAAADBIFCBEFSEEHhABAOBEABGAEQEABhACAfFHAABDDRGBEdHDF.FABE.ZCEA....hAAA......hABA...,2,-22,-20,2
bFERLMKeYTPNOdXQagUcJSDIBWGACfHZV,CGBGHBCGZBCB.VEEGFABH.RAFE.LHFG..MFAGKGDB.TGCGhAAAOAFBXCGA.hAAAaDAGUEFG.SAHBhACADABCIGHGBEDHAAHGfHEFhAEAEEAF......hAFA...,2,-33,-13,20
SMBOXcJZEWbdQYPUIfLRVGgFKADeCNHTa,eCFBHAACaFEEBAFHOFDH..JACGZCECEHDGdGHA.QDAGhAAAUEDHLBHH.RCAD.hAAAVAECFHGCACGCCEFCSHAGhABAMIAG.WCHB......hADA......hAEA...,2,-27,-10,17
gQOVDKHLJYfWSETMUAeXadPCGZIBFbRcN,XAACdABFGEEDBBCHFCFERCCH....NDIA.OAFC.DBCHHBFHhABALEAHfHADhACASFCDEFGFTFDEhADAMICCAGHHaDDC.CHDGIFAF...hAAAcAEB...hAEA...,1,-11,-28,17
XaJWPSBVIQNLZUfMKgDdRTeFYAObcEGHC,OFBAEBAHHEGB.aAGFJGEE....SDCEVCEA.QFEAhAAAZBCHMABFDBGGRAEFeDAHhABAABEG.bEBHCDAD.WAHHhACABHHH.LHAC...KEGG..hAAA......hACA...,2,-34,6,40
CYZRScXOFdTJLVDPWHUbgQIKNMABafeEG,BFGHeFBECHECRCFE....SCEFXCDHdCGELFBHDCADHFGDhAAAUCBFQCBFhABAKABAAFED.EGBB.ZAFCcAFFhAAATABB..........hADA......hAEA...,2,-42,-9,33
fGeXCUWgFZLDdANBREYQbaKPJOHIVcMTS,BCFARGEGQCDAKDCC..OHCEHEFGIAHGMFBE.SEBDhAAAeBHDCACF.gACAhABAFBCEDGGG.ADIDEFDHhACAaAGA.JCFG....cEEEfGAEhADAXGBC...WBAHhAAA..,2,-41,-12,29
IBaDdgMLECOZPGAFcHfSbJKTWeXNQUVYR,HEBDSFEEJDEDKCABeCFG..QDGDUDBERGBEBEGEdACAMAEHhAAAEGHFZADFABAA..FAGD.hAAA.fACEhABATFGEXGDA..YAFAIGAFDIEEhAHACAFC......hAIA...,1,-9,-22,13
TcSJgGOfWHEQYNFAVDPBRULdZMeIbaKXC,VCAEDBDFREFBLEED.ZCGHIBFA.aHFEKGBF.CAFH.TGDBhAAA..JCAHOCHHhABA.HEBGEABD.hAAAYAHHAECCBFCBMIEAXACA.cGADhACA.SGGEhADAfAHE.,1,-3,-46,43
FLGMaZEJRgdCSIVfcDXKOPbeYBNUWHAQT,FBGBLCCEGAABaAHHZDEA.REAB.CBAA...SGGGVEAH.DGABhAAAKEEE.OADGeECBBFFChABAUGGCAEHAMAEGEGDGdDDChAAA..fHDH.XBDAhADA.....hABA...,1,-9,-27,18
fMICLYEdHKNPReFQgTOBWJGXbDASUVaZc,UFCAVDDA.ZAGB..MAHBCBAGLFGB..dCBGKGADRACCFGFA.hAAATGBBOCBCBFAAhAAAGAEGDCAD.AIEAaDACIEHChABA..EFFBNIDB.......hACA......hADA...,2,-28,-28,0
XPCFHUbZERMIBAOeTQKGfDcgNJLVYSWda,TCCDQDFB.KAGGGAEHDHFG.NAAA.LADB.SCAFhAAAWCFG.aGCACGGAFFAGhABAHDBEUGEEZFAFMIDChABAIEHBABBEeDHHfEED.JHAA.hACAdCBC.....hAFA...,1,-9,-10,1
aEWdHLCUBNMIcZbgFJPGYQRKSVTDfAeOX,OCDAXGGF..aFAEdGECHDBCCBHE.BBAEMDDDZFFD.FADAJBBBGGBHhAAARADA..KCEHSEFFhABADBABAHDH.eAHFhACAEEFCUGACIHHA......hAGA......hAHA...,1,-11,-30,19
dfWUFRABKQPSTLGeNVCcMEbXaOHDYIZgJ,KGEHQEGE.SCFBLDDHGAAGeAEG.CHAGEBGDaEDEOBDHhAAADAFDZDFFdADCfCAGhABAFGAA.AHAFBBBGhACA.NIDB.MEIF..HEBF...hAAA......hACA...,2,-30,-3,27
PKTOYIBMfWLeVZGXNdcURSCFbEQJAaDHg,DIAAHAGFKGEAODBDBBBE.MCAELCHDZFDBGDEB.dAECRDAESGAChAAACAAAFGHB.EDFFhABAAGAGaGBE..TAFFhACAIDAF..fHGH.eADHhADA.....hAAA...,2,-27,-17,10
aTEWdZMJOeRANKFgXbCLHBfVQYDPcISGU,FGADXCDBLHDGBHGCQCGH.DBEDIHBHGBACaFGChAAAEDBBZFAE.MGFChAAAeCEHAEADKBAECEHGHAFAfEFDhABAPDCDSACCUBFG..WADChACA.....hABA...,1,-7,-20,13
BSLdUIFMHPbfaRYGNOVXeAKWETZQJcgCD,KCECTFCEQDAD..JAFCCFFADBCCSABHLEHHdCDAFGBHhAAAHFGH..fAGHhABAaFFBRDAB.GDDEhACANICDOCHFeHDAAADDEAAHcBBC.BDGC.hAAAMADE....hBAA...,2,-18,-7,11
bIZMVKDeRGEPATUOFCSJdNQafgHLcYWXB,TEAAOEFFFCCH..SGCHdBEH.aCABfABChAAALBDG....WAHBhAAAbFBEMIACDEEGeGFGEFHDAAHHhABACHBCNDDDHCFC.XDAHIHEFKAEC..hADA......hAIA...,2,-17,-16,1
LFKcBRfDJdOXZGYUbWMQENHIVeAgCTSaP,CFDETAEC..SCFHaDFF.FEBBBHFEDACD.dDDEZGACUAAChADA.MCIBEDCEHFFFhAAAIGAEAIHCLAEAhABA.KEHFfDBC.XFFEhAEA.YHAG.hADA...,2,-32,-22,10
RYUPHcOEXQadgWGVbNMLFIKTAJeCSDBfZ,CDFEBFDGZFBG.UBBBHDAG.EADCQAFA.dFHEgABDhAAAGDEA.VGFCMBAFFEHFhADATEAEAAHC.eHDGhAAASHBADIBA.fBFBYBHB.cDDAhAGAaCDD....hBAA...,2,-19,-9,10
EAIXNaDCReTBPVbHSfdgQZcOUJMLWFKYG,XBFGDIDACEGE.RDCE.eAHHBHEA....VCAESFGFhAAA.dFABgFDBhAAAZBABUGBF.MACEFAHF.KGBFhABAEADBICFFaEHF.TGGB...hABA......hACA...,1,-20,-29,9
WKAMYFCLBEeJcfINgQXaDZOHPUTRGSdbV,MCIBCAGDLEFFBDBC..eEDBJFDF.....fFFAhAAAIBBBQCGEhAAADABFOGACUADBTBDGSCFAhACAdFAB.WEEEACAHFHAAEGHDgGGHhABA.ZDBC...hAEA...,2,-33,-10,23
KSbLMPBgJFHEZAGaUIYefRVTDCOXQWNcd,UEDHeDEDRDGHDEAF..OGBCQCFA..NAAC.KABBLBEEhABABBEGFBAHHBBBZGFEAHDGICFDhACA.fFAFhADACHBH.XGGAdBHESDCEhAAAMIDG...gFAHhABA.,2,-39,-2,37
KAXeJUCRdcBWbHIZaGfMFOgPDENVYTQLS,XCFEeEEACGHC.dBCFBBGBHFEHZBCDGDABFBBF.OGACDAAB.EAGHhAAA..VBEF..hABAYEHBQFAAhACASABCAHIF..JHDG.....hAEA......hAFA...,1,-14,-31,17
GSaHLYKZJDCBbAWUPdeMIgFcNVXTREfOQ,UEAFeDCFMCBEFFDD....VBCGXGDC.EDFGOAABhABASDACLBGHYFADhAAAJHFEDCIF.CHAF.BGHEhABA.AFFDPABEdDFG.cGGH.NBIE.hAEA.fEDFhAFA..aFGE,2,-29,-21,8
HUEWCKOIeafZSYGPcVFQJRDgbBNALXMdT,LDDCdABEHGBAEBGBCADDKFEE..eEFFZAAHGFABVDBE..FHGGJEHHhACADAGEBHDEADID..MEAFhAAAUAEEOADD.hAHAaBFH..fBHESEGH...hAIA.cGGH..hBAA...,2,-33,-4,29
KPFZNBfXDcIQOdVMUWTJLHCeYGbASEaRg,SCBBaECD.KEGFFBDBBHCFDBFDQDAGdEDH.MGFEhAAATACALBGDeEAH.hAAA..bGAGEHGGPHFAhABANAEDXCFA.OEHD..WACChAGACBAFAGCA......hAHA...,1,-18,-29,11
bcEAFTDJXUGSHLaCQfNZdIBVMPegRWKOY,DAEBXEGFGCDDHAABCAGE...QAGDZGFGdGBCBEGDVDCFMCABhAAAeGDA.RFAFOAEBhAAA..bBBFAFFCFGHDhACATGCASHCG..fBFBhABA.NAIG....hADA...,2,-22,1,23
LcYQTKOEFUJVSdgZPeIHMRXGBafDNCbAW,LGEAQFAEKAEHECDB..UDBF.SBAGdCGGZABEPFDGhAAAeCFCHGAEMAIBXGGEhABABAGBDFGGNAAHAFHC..hAIA..YDAAFDGEgEEDIAFHaBBAhBGACHDA......hBIA...,2,-16,-6,10
RVXKJfEWPMeUDSOgATNZcGLaBIFCHbQdY,ZEDALBGHaCAH.BFFBFHCCHBFCdFBFRCDHKBCCECBG.....MFAHhAAADAFCSGHDhAAAAFID.TGEGNIDF.IBDFhABACBAE..YDAEXEAE.fEGDhACAeGCA..hADA...,1,-23,-34,11
TfgREAPVeFQCLGZdHWKMSOBUINYJXbacD,eBCCFAFACGCD.ZGBAHCDAMECGBHHH..UGGD..IGGAhAAAJCDE..aDGBDABBTAGHhAAARDABAFFEQACGhAEA.dGEAWCBDKBHBSDFANBAG..hAIA......hBAA...,2,-25,-25,0
JQFKSHcOXZPIBTGYfedRAWMDCbgLVENUa,DCECCEGALDAEEABB.UBEEaGFF...QFABSEGBOFEDhAAAZFBBBCAF.TDDGhAAAfGGGdAFHADBE.MAHDhABA..bEAFNACHKBBCXGDG.IHHEhACA.eAHHgGCFhAIA,2,-26,-20,6
CFBgDNcEXGPbOAJMHeWQYUfTLVZISaKdR,HBDGeGCAQAFBUGAHLBADZCDFaCBBKDGACDDBBGGG..DGFBEFHDhAAAGEBFOEAEAIGAMAFGhAAA..fABHhABAIGGC.SDGFFCBF.NIDDXGAHhAEA....hAGA...,2,-19,-13,6
EDXQSBOfTHcYWbZGFdRKPJUIANeLMaVCg,eCFHMAFH.CFAD.EDADDBFA..SFECBAHB.OAACHABF..hAAA..cGGDbDGDFGBChACARFDGKEHDUAGA.ACEDNIEBaBDDhAAA..XDCCTDAE..YHCAhABA......hADA...,2,-26,-8,18
ebfMVdIZOPLYGRBQSWaCJEAUTFHcKDXgN,UDGDTDGGFCCC.HECAKFFFDEDF..XBFAeBFH..MCCChAAAdGAGZFEGOHAGLBBEhAAAGCAGBDAFSADAhABACAFHAIHA.NICFfABF.IHHHhAEA....hAGA...,1,-23,-24,1
WdANVDGBHaeMUOLISCZgFYEPfbTQXRKcJ,VGDABEHDeEAB.UCDALACA.SCEDZAAEFFFHECFA.hAAA.bDGB..XCAAhAAARDAFKFCEJHACABEADICEaAGDMBAFhABA..IHHDCCCC....hABA.gAGEhACA...,1,-9,-39,30
TZbBWEFMQHgNDVdAJPaXGeIOYfKSCLRcU,aAECeBCG.OHFEKEEGLFCHRDGF.UCBBZGCEBFDG.EBBBQGEFhAAAHEAFDEDEAAEAJAHHhABAGAEF..ICEFhACASBADCHHBTGAE.FCGHMAAChAHA......hAIA...,2,-19,-12,7
KCcfaRMZbVQTIOUJAHePFNWLDdgSBEYGX,HAFAFHBELCCCDDECdFCBBBBHEEGG.GGEHKAGE.CDBD.aFEEZACDQDAGhAAA.OBAGhABAAFADNEEF...gBGAhACA.SGHFYHAAfAAHhAAARFAC.MFFEhAFATDDG.,2,-25,-18,7
daRFQGcBMIJDHTbSgfCENUAPOYXeZVKLW,ODEBXEFCZABHKAHDLBFG.dFFBaGAAFFAAQABGhAAA.BDECIHHDhAAADFIFbFCDSAEChADA.CHBEEHEEAECGYHECeDFG.WBDA.cDAChADAMBBD....hAEA...,1,-14,-34,20
YNbFHSLXgaGdfDJVTQBPRMcIKZeCEAUWO,UCBAODED....NFED.HAFELAFBgBADdGGC.DGHDJABEhAAAQEAHBHDFRFBA.hABAIDDGKHAA.CGDAAADAhAAA....WAHDYCHH.SDGDhABAaBDD.fHEHhACA,2,-42,-17,25
XOcAVNKeJSHIPWCYdfEaMZgbLTBQGFURD,VCDAKAGCeCGD.HEBH..IAACCHGBdAAD.EGGFZADDLHCChACABFEHFBHDDBDE.XDGHhADAAFIHSGBD.hAEA.WBHBaACD.MGAA.gCBFhAFA......hAGA...,1,-26,-28,2
NAdDXBHJOEWFaGYZVRcQgLMIefKTPbUSC,XDDBBEDDODAFFBGB.GGAHZCAB.RAAE.QGECLEGFMFFHhAAAeAAEKFFE.TGAEhADAbCFE..UAFCCECBAAEHDCIHhAFA.EHGAaADF.cCDH..fFCGhAGA...hACA.SHGA.,2,-9,-3,6
KEAUVbXZBQfCYNMcFPdLOeaDgRJSHTGWI,VEFBZFBCBCDG.CBHE.MACG..FFFCdFCCLFHBOHDEDAHBRBEG.hAAAHBDFGDAHKDGEABIH.hABAUCBEXACG.hAAA.fGAE.NBAE.cGAC.hABAaHEE.SDFAhADAWEHHIBFH.,1,-12,-21,9
FafceJEHBQORDTNgVYWAbXGSUCMKIZLdP,GFDDCHEEKBBA.ZCBDdAGAFHCE...aBECeFBFHBGBBCEDRDDC.DDGFTGAGhAAA..VFGHhAAAAHIDSBAC.hABAMDADPDDH.JCAFEHFC....NAIG.hACA......hADA...,1,0,-41,41
bIJTPeDcfYSOWVdANgKFHBEaGCMXRULQZ,KGFHFDBAEFCACAFA..REEA.UGFALBBDZFAB....JBCCTCCHhAAADCAH.....fHBFhABASAHHOAHHhACAdAFFAIDG.HFAEaFHDMAAEXADB.ICFEhAIAPEEG.eEHHhBAA...,1,-21,-29,8
ANgcGHOLJdQbEaRFXWSMfUCDPYeVKBZIT,...NHAD.GCCAHACEOGEAJEADdHGHQGDDEEAF.RCGFFFEAhAAAXDGG.SCAGhAAAfBDDDDFBeAEEhABAKDDHBABFZABDAAID.cBGH.LFHBhAEAaHAE.MICC.CFCA.hAFA...,1,-4,-14,10
eWBRGCdAISKQFNgVMHTUPEDOYcLafXZbJ,SACDKGGAFEEE...VDEATBCFEBFA.DFDH..ODHDhAAALCHDaFAC.ZAEBeEBEhABABHBBCHDFADAFQAABhABA.NIDB.MDBCUDADcGGH.fHABhADA...hADA...,1,-13,-27,14
DOeXcLafETGCMBAWNQRJIVPUHgdFZYSKb,QCDCJHEG..ICGEUFEHdBFBZABGSHDG.hAAADEACeFACLAHHhAAAaHAAEFDACABEAGCGRAEHHCAGFHGEKGAHhADAXFGA.fDHCMFAABFHF.hABA.....WEDEhACA..,2,-24,-10,14
YDMRQFZVfbBWKHSaXGcECOANPULJdgeTI,UEGAdDFAeADE..IBHFDHFCMBCHREDA.FEDBZCDG.....hAAAVEAFfAHAhABABBBGKBDGaEHD.GGAHhACACACAAIAGLAADTBDB.......YHDChACA..WHFAhAGASAEE.,2,-24,-15,9
YXUBIMLJTDbHNWdaAfROVSZQGePKcCgFE,OEEEVCFB.ZCADQABBGCDB.eDCDKAECCGGH..EBEAUGCBhAAABEDELBAEDEIFNIDD.hAAAaECFAEAD...SAHBhABAPAHDFFADIBGFMHFG....hACA......hADA...,2,-24,-12,12
INLObdQKAgDPeBEMJGHUFcXaWTCYfRSVZ,DFDAeDEEEADDMEID.HECEUGDBFAAG..aEGGCCGEREABZCAD..LBCGhADAdGHEAGCBBAHDJHBG.GCDDhAAAXGFF..hAEA...WAHBfGAA.IABGhAEA....hAFA...,2,-37,-8,29
BGPJCDQYebLHaATKUSIOWMfRNdXFVZEcg,KAGHUEAEOEEEMHEG..RDFE.dEHE.FBFHEHBABBBC..JAADDCEH.hAAA.eBDHLFAGhAAAAIHC.SDCFhABAIBHB....fEEGNHDBXACFcAFGhACA.....hAFA...,2,-42,-30,12
eKUPbTVcHRDLAGdOgWaQCXFMfIYJNBZES,dFFHOEECaHAC...QAFHCBFD.XEBBfADCJABHZGDAhAAASEHB.hACAKAAAPFAD..hADATDDA.HCAFDEIFAIDGgGDDhAAAWDDEIHHHBFADeCGFhACA...,2,-28,-20,8
RcDQOFJETCgbfaYWMZBAdUNXGVLIPSeKH,dGFCUFBCGCEBLGFASAGAHBDHDCABOADAFAGC..TDGFhAAACBDB....fBBAhAAAaBBHMFAHAFEAXFCHhABA.IHHFPABG.KEGH.cDDChACA.EHAG..hAHA...,2,-29,-18,11
WNIREGJdSOfcYXMabKZDLTCeAPFUQHBgV,FCDBQCCGBFHD...VBGHICFDRFFAGEACdHBB..OBAAhAAAfAFC.XABGhAAAaACAKAFGZEFFDCADCFDBhACAeFAAAHHD.....PEEH..hABA......hAFA...,2,-33,-10,23
RTEKJNBASZVPgeFMcCYbdQUWIafLXDHOG,SFDEZFBH..VBBBeADBFEEDMHBGCHGB.dDGBUDGA..hAAAaCCDLEADDAHBHGFGhAAAOACATBAE.KAFBhABABBGEAEAAPFAE.......hABA......hAGA...,1,-6,-38,32
bDFYIcLJNKQCHTUVAeEXRWOgaGMZBPfdS,XAFEREBCOEGHGBECZBBFBGDB..dHDFSHDAFCCB..hAAAIACBJEBHKGGACEEETAGEhAAA..ABDBeDHBhABAEGAGaAEBMAIH.fCAAYBAHNEIC.hACA......hADA...,2,-33,-8,25
NZDJLUASdXbKGeEVgaICRfQHMTcPYFBOW,SBFBdGAEKHFCGCEAEAHB...aEGECECAQFFDHCBA.TCDHhAAAPABC.BCHBhAAAODADZEACDGGEUGAHAHEF.hABAeBBCIAHBMIFGFDHH.WABC..hAFA......hAGA...,1,-11,-13,2
FKdXaYLfDATZIRCGgbBUEMVNQeWcSHPJO,TBDEZADERFFEGAGC.BCBFMEAD.QDBAeFCH.SHGGhAAAPDDE.ODHFhABAFAAG.KHCGaFADfABChADAAFCDCHFH.gBFH.bEEF.hADAEHAC.WFBA..hAEA...,1,-21,-23,2
MWGUOCdRILAaHDYPNTBKJSgEecZXQbFfV,aGDBHFFA.DDDF....PCBBNAHEBFBBKCGG..SADFhAAAeFFGXACEQBEEhABAfAFGMAIFWHFGhACAOEDG.CHBCIEHAABBCTGCAEGAB.cEEBhAFA..FAHF.hAGA...,1,-20,-23,3
OgbEYBdCfGFQZVKMLeNWacARSUHDXJPIT,RAADUDEEDGDC...XGCCJAHD....TEFHOAAH.ECBHhABABAFHCGHC.FHGGQAGDhACAKEAGLHAANIDH.hADA.aECFADDC..PECAIFAH.YBBChAEAdEHAfACEhAAA...,2,-40,-19,21
AXZLJVWaRPCNHIFBeYgDGTSEOfbcQKMUd,XGDEJAAD..aFDDCDBCHFACBBGC.eBHBDECD.GDCH.SABChAAAEDDCOCHDbBCAhAEAQGFBKGGG.hAFAMIACAIGC.ZDADWFFERDFB.IHADFAEB.hAAA......hACA...,1,1,-26,27
YcUaFQLgNADJZbVHERfSPWIGKTdeMBOCX,JBHDZFEEHDBD.EAHDSBDA..PBCCGFDHTGABhAAAeEAFBCBF.CDEHXAAGhABAYDFAaGCDhABAFGBCLAECACAADGIB.......hACA......hADA...,2,-25,-20,5
WgKGLBdIQNPJYTXEOcVaebSMADUZHFCRf,DECGUDGGHAABFDAE.RGEA......fCFEKEDDBADCQAAAhAAAJAEC..YEBFhAAAEGEBOBFGaHACeADBhACAMAFAZFFA.CHHG.WDHB....hAHA.LFECIHCFhBCA...,1,-9,-38,29
bMEVCOSIJHeXgNLYdRfKFTZUWPQDAGaBc,aEAEBHBC.MACDEGEF..CEGD.OAFF..SHAGHDDAXFGAhAAALBEAdFDDfEAEhABAKDHHFGGGUAAHPHCChADAAEEBbDCH...JHFANADB...YAHHhAEA.....hABA...,2,-26,-6,20
KSCBVQdIEbXeHTgZLDfNGPUAcJaWFORMY,JEDBFEAAMCGH..KABHBGACdAGG..EGGCeHEG.HABAZDAHDDCHhAAAGECA.AAACaBHFRFEHCAHH.hABAQFGE.hADAIAFG.TCDHfDED.hADA..NEAE..PCHFhAEA..,2,-36,-19,17
SfUBNAWQcdCMXDHObELVPRZTIJagFYeKG,QABDdFAFMBGFDBBCOHEG.LEDEVEGF.RAFFZADF.TFAFhAAAIBED.JEDFhAAAFHCC.KFGGGCAHhABASBADBHAHNIDHAHAFCCCG.......hACA......hADA...,1,-6,-32,26
FGgPaSeJUWEcDXfZQIOKdMYbANCVLBHTR,VFACHEADTFFB.FDDGGEEG.PBDDSFHH.hAAAeADGJABBUAFCECAAXFCAhAAA.fCHAhABAIHDDKHGCMIECABAD.LHAGBADFgDFBhABA..hAIAcACHDCID,2,-26,5,31
QRFMWcBTAIPZaXSJGKCedfYUVHbOgNDLE,ZAADSHFCJAHF.KBDGdGAE.UFGCHCFB.OGBEDHDE.EAADFEBChAAAMDAD.BHADAEFE.hADAIACC.aDDFhABACDEF.eCCD.YFFGgAEF..hAEA...NIEH...hAIA...,2,-48,-8,40
bDNOeBgRPcfAUJIVHFYCSdWEZaGQLTXKM,UFFFJECAHGCAFDAG...SBCFEDGHZACHGEABLABE.KAFChAAADIBAOGEABAAE.RBEE.hAIA..fAHChAEAAEIB..IHHECDEAaGAC.....hAFA......hAGA...,2,-33,-21,12
EWYgRVHJcONQXLUGKZFfSedABaPTMIDCb,aCGAMDCH.DEEHEDGB......gDFFRECDJACFOGFEQGGHhAAALFADKEHHFBEFhAAAeHAAAFFABGBC.IBAHhABAbAEG..YBAH...hADA......hAEA...,2,-29,-24,5
VTKMOJZPfBdXUIQeHNRcYLESgaCbAWGDF,GACCDAFFFGCB.KAHB.OFHDJDED..ZAADBGBD.UGCCeGFCRBFFLAAHhACAEBGD..hAEASACAaFFE.hAFAAGAC..TCCBMFCG...fAHEhAAA.IHHHhADA...,1,-20,-45,25
fceRNXCDGUbaJBVIHPYKFLgSQATWZEMdO,TEBFZEBBdEFCOBEE..fDDGRCAA.CHBADABFGABHhAAAUFFFaHEABAEAHEGHPAHBhAAAKFDFFAGA.SEADhABAADGFEDACMCCG.NIEH.......hACA......hADA...,2,-26,-8,18
BQXUAHEIMdNGYgJZaWKfbSOVeLDFRTPCc,EHCGMDCBdCCBGDEB..JACCaDDGKDFBSAAF.eHBGhACAFGABTGGGCEAE.BFCChAAAXADDAEEDHFDG.hADA.IBGFNCIC.gGGEfBFFhABA...OCBHhAFADGAH...,2,-28,-12,16
YKARSOUBfWdgcLVPHIJGCZaDXETeQNbFM,SCAFUGEGBGCDdDCALDHHHBGBGADEZEABDEGB..EECFeDAFhAAAQGCEFABA.MAFAhAAAAHHGREFGOFAD.hABA.gCCE.PHFACBBD..hACA.aBDA....hADA...,2,-16,-14,2
EASLgNJPdGDOQIXKMUeTfaCHcYbRWFBZV,SHACLAEGJHDCdBFHGDGADFIF..OFECQCEC.hAAAXGAEMDFGUABGhAEAeBAGfEBFhAFACACE..YDDF..WEECBFFGEHFGhAGAAAFENAIC.....hAHA...,2,-35,-9,26
feMHcTXQOLYPaCFWBdAbKSDENIRVJZGUg,KGBDEDHDRFDAZCGF.GECBUCBE...eBCAMCGBHAAH..TGBEhAAAXGGALADGhABAaDDGCEAFBACEACFBDEAFNIDDIAGEhAAA..JAHHfGECQDDC.hAEA......hAFA...,2,-18,-12,6
CRGQJYgSIOEDcUeNPfaLMAWTFdKZVXHbB,TEAGdDHAZEBAHCEB.CGGBGABAJCDG..SFGHOFAHDAEDhAAAeBHD..NHCF.aAAChABAAIBE.FADA.KEEA.VGBAhACABCGC..........hABA......hADA...,1,-23,-28,5
XJYadBZcHgQEIeWSLCbFURVTADMKfONPG,MAAGKDGCOEFFGDDB...JAHFdHCHBGDCZACFHBEE.EAHBIBDEhAEAeEBFLHFAhAAACHHFFCBH.UBAHRFAFAFHFDGFDhAFANEAE.....PAFF....hAIA..aEEB...hBAA...,2,-30,-3,27
TfeGHcNUIKMVAbOaDgFCdWXLQRJYSBZPE,aCGHFGFECFFC..dHDFLBAAREBA..JAFASAFABBAAZABB.EEHDhAAA..eFFAGFABhABAHADFUCEGKGHBACHDDIEA.hAAAXDAB.PBHDfEEB.hACA......hADA...,2,-24,-22,2
TeQOSVPDEbAKXGJLMYRWfaNBdZCgHFIcU,KFEEGBADMDCCRAFC..aHCCdABB.ZFADHEAFFHFG.UDFH.QGGDhAAASGDDDADEAHCHLEAEhAAAfDDGBEHBhAEACGDD...IAGC.eAHH.PBDChAFA....hBAA...,2,-27,-8,19
cTHWQVMOaXEFNKRGeAZfdUDIYbPJLCBSg,dACFUGCEDFGA....IECF..PDCECGGABCDASHBGhAAA.TCGBhABAQBBB.MEAFhAAAaFBEEBCFNABBKBHFeAFAAFEEZBEBfGGBhAFA.YFFFLFHHhAGA...,1,-25,-35,10
dHSGOXLVQINeRabFMDCBZJKWfEAPUcYgT,UDAD..gAGBTDGA.dAAFSDDDXDADLGBAhADAQBFBeDFDaGFDFGBGhAAACAECBGHAZBBEKFHHECDAADGAhAIA..PABAYHFAOEED.NIAH..hBBA......hBDA...,1,-4,-18,14
eBdfMDUTbKGOJQCPIENcYLXVHZaSWFgAR,RCDABFCHMBBGDGFA.UBDGKFGCGEAH..OEAGQGEHhAAACCAF.EAGD...NABFLHAEhAHAXGCAHBGDhAAASDGAFHFGAEFCeABC.dGAG...hAIAbEFAIHHD.hABA...,1,-6,-31,25
YQSVJAbNIDcePRKgWfFMHLCTdZaEXUOGB,..IAGGeFFAKHCA.....gAGBWABD.FEDDLHCEhAAAdAAFZDAFaAFHUGGEhACABHHBSDFHhADA.AFACNCEBcBCBRFACMDEFCECCEHEEOACE..hAFA....YDDChADA.,1,-14,-31,17
OafEVCYLbHSZWINGRJPTBdgAeQUDFMcXK,eAFHQBBCFDBE.MFCFKBCG..OHBGaHFE..EGAHCFHFLFBChAAASEBEZFEBIADEhAAA.GAEEhABAJAHD.BGDBADAHDBBDfAGE.YDHHhACA.WEFHNABF.hAHA...,2,-35,-7,28
IeMgOVJYXBCPNSQRDAHLdcUZEFKfaGbTW,LHAEdACFUCGDZFDGKCGGGEDD..TDCGIBAG.MAFEhAAAOHEC.JEHHXGGEhABABHAB.PDCGhACASBAFDBGGABDDHDADEAFFaFAA..eHEGhADA......hAEA...,1,-10,-30,20
WUfNaGZHOgIBJVFXETbLceASQDCYKdPMR,QGGBCDBGKDCC.dDEERFACUGEE..fDGEGAADZBFBHFCHhAAA.IBFGhABABGHHFDHHXCCD.hAAAEACC.LAHFACIDSDADDFAGMBBHaHAC.hABAgGAE.hADA...,1,6,-37,43
cARLBQXKUfMZOTCVdHNEYaPSbGFIgWJDe,BHDEKHBAMABEZBBHCDAHHBGH..EGHB..aFGH..SHFGhAAAGBBGIFADJAFDDABE.hAEAAIHGRDEHLCHF.hAAAUEECfAEFOFAEdHABPEHF..hAHA.gGDGhAIA...,2,-22,-19,3
gNORBFfAaGHCSMdTQYKIUeEcVWJDPXLZb,HDCCMBBCdBFGQAGEKCDF.UGAHEFAC.VBADDIGELHAChAAAZGDE..bFGDOAFAhABABABBFAEHaGGCGCGAhACASDGCTEEE.IDAHeFDA...hAAA......hADA...,1,1,-8,9
GaKHLTMceFJQVgIBZUDYSEWdAfOCbNXPR,OABCCHDD..XECHGEAHaAGDHABAMDDAeCHF.FAFDQFGChAAA.IGEHhABABFAEDHACECHFADDANAAEKGAAhADATFFH....cAED..hAEA......hAFA...,1,-20,-31,11
KLMTWRQaHNVXPgIDbBeFUEGJCcSfZYdOA,KAABMBCGRAGHHEFH..VBFB..XEBDIDCFDBEDBFGDhAAAFHEC.EEDCCEEC..SFAFhAAAfGACdADBACAGLEHBhABAQCBDNICFPDAH...hACA......hAGA...,2,-25,-18,7
fbFPDEcLGBUWMSOZeJYdNHgAVCXQRaKIT,CGAGQBFCKBBC...TBDCFCGBDCFFLHECBFFE.MEAHhAAAZEBH.eCHFdDACHEDBhAAAAFFBXCAB.IHBHhABAfHEH.EHGAcDBE...hABAWADCSDDFhACA...,2,-45,-8,37
XMHSBIFQOJTUaCdEeVbPGYKLDfAcgZNRW,ZDBFRBBHMDIHHFFH.BFHEFEFD.JAFAUCFF..CADA.eFAE..VDDHhAAAGAEHLCAFhABAAEAG..NHAB.SHCGhACAODDFdHGHEBBE....PAAHKBEADHDGhADA......hAIA...,2,-17,-13,4
QNWafSPbUMJLKGeARZBFOHVEcgCYXDdTI,BHGBOBGBECAE..CBDHDDDDdHCBQDFE..aBAFSABGhAAAUEAFLHFGhAAAeEAFAGBCFFEBHAEH.gECDhACATGAENADD.fEEGMDIB.KFHHhADA......hAEA...,1,-17,-31,14
QMPXVCcHYLDbfOUaSJGNgAdEKBFWIReZT,KBEABDFFFEADRBFGZGAG..MHBA..XDAACEFAHACHLHFGhAAA.DAHFOABEhAAASDFEGEFEAFEHdBAChABAWFHH..eCCDPDDD..cFGGhACAfBAEaAEA.NIBDIFAEhABA,1,-26,-28,2
VbOTWPfCgMBFGRSZaYHLdecEQAIKJNUXD,KCBDUFGBDCHDOAEG..TFGF..fCFDCAFCBFDDFEEGhAAASDEH.hABAaHFCLHBEeEBBEABFhAAAAADDIAHDXCCCWDAFPCCG.MIFGhACA......hAEA...,2,-44,-20,24
AWIOFLERSfQHXPKbZNeJDCdGMUcVagYTB,OFDALDEFRAAD.SHFAHDACKGCCZAFFJAHD...CHCD.dEBDUGGChAAAaHAC....gABHhAAABAHDAEEAFACCEFFG.hAEAQDGF...XAEEhABA......hAEA...,2,-29,-24,5
VYQWDLRedaJAGMNHbETCZIcPSgOBUKXfF,MBEFHEBAEAFEZABH...IHFASHGGBFGGUDGEKACAXEEFhAAAFGEDQFAC.hABADAGAeCHBdADBABIBNCACTCCChACACFDA...cGCEOCFH.fGGBhAAA...hAEA...,2,-19,-19,0
eKCgGfRIOHSMVbDBTNEJUaLcPXYdFWQAZ,eDEHKEEACBBG.GGEB.RBCBHBGBSHEEMFCHDEBBBGGB.EACGaAAEhAAALAFB..hAAAcAFGXEAD.hABAFCHHAFADfFGBOHAEbDCB....NBAG.hABA......hAEA...,1,-4,-30,26
MTJWPcKFbDVaYdGNQCfEHIXSgLBeRAUZO,UBADMHEG...JAEB..PCDDKEAC.FBCGDFHB..aEGEdCGFGFBBhAAA.CCFDHAFGhABAIFEEXDAA.hAAASGADBAHDAGBAOHEC....hABA...cGBEhACA.bDDGNICF,2,-56,-19,37
fCPXgZRMNUEJDSeFIbBOVKHWGTLYAadcQ,dEDGQBFGCDAC..XGAHZDBGMAAGUAAFJCBG..DAFGeFFAhABA.FHDCIHEChAEA.BGHBKAFGGCEFhADATFCAAFFGaAHF.fDBHPCHD...hAIA......hBAA...,1,-22,-32,10
HAfLBKFCdJcGYMgIZNSWTODQVERaXPeUb,BCBEKDFDFHBCdEABGBCBMFFG.ZDAC..SACGOFGH.QDDBhAAAEAAG.aCGFXAGFhACA.eGBEhADAbGAAAHHBCFHH...cAGF...gGEAhABAWFAFDDBC...hAEA...,1,-26,-27,1
MaXFYBeWQZVbOHfRAJCGETPUgIcNdLKDS,CAFETAGEUGGG.....IDDGdDCFKFCEDGFHMCIF..FBDGBFAGhAAA.QFEChABAZBGD.bACCHEAFADGGEDAChADAPAAA..cGCHSHAGaGHHeCFDhAEA.....hAEA...,2,-42,0,42
XGZQVbaUETRSfDMKdcOgPLWAICHeFJNBY,CGBBFCEDBGEFGEBAZAEG.QBBG..bDCGEAFC.RFGFSEFHhAAADDADKHFE.OHDChABALAAGAEAB.eDHHhABAYBHHaAHD..fGAEMACG..hACA.dDFA....hAEA...,2,-34,-5,29
VNgCGSQEAUfaMWcDLBeXZIOJYFRKPTbHd,aEEEMCDE.DEHDeBHDZEEF.OCCE.FHAEKAFA...TEAAhAAAdBDBVEACCFDDGCAB.hAAAEHAGABACfEHGhABALABABHDCXGDGYCHH....hACA......hADA...,1,-18,-23,5
KRWSEHUYdeMaLQIfJCcPVDXBgZFTGNAOb,KCAESBDBEFGB.UGGCeEBGLABD.QBGEhAAAfBGAJFDBCEHB..PFBHhAAADFGCBEAHZEEBFCDBGCEAhADAAIHGOADA.WHDAdGADMAEG.aCCDhAIAIABB..hAHA...,2,-28,-3,25
VfPdSHUCaRQMJOAeGbZcEFYBXWIgDNLTK,eCCEGAECZDDGFGHFBBEB..XEDH..WBACDHDCNBDALHFGhAAA.VEAFhABAdDABHEAF.CBBDaHCChAAAMBIDAABGEAHBIGGEKFFE.fHBFhACA.....SDAChADA,1,-19,-22,3
EIHUeTVMRLJSBNYXafQKDFZObAGcPWdCg,GDBF..PBBGdGEDEGBEHDAEeBCAMAIDRCFALFGBBDFFXFCBhAAAaAHF.fHAFhABAKBACDGAFOACGhAAAAFAHCGEA..UEGF........hACA......hADA...,1,-9,-27,18
UDPKcZHNRGCbSEOeMBYQJXdfagLVTFAIW,UCGFKHECZCADHABDGBGACGHH..EGAEODCD.BADBJEDBdAFBaEEG.hAAALFGF.TDAEhAAAFGAEAEIDDIBE..hABANCFA.SAGE.MGFG.XAEHhACA....hBAA...,1,-20,-29,9
EVFADBdRXaMHSTQYZcJNLICebUWgOKGfP,BGBARFFDMDECSFGH..QEAFZAACJCFFLAEGhABAeBEAUGAHOEEBfABChAAAECDH.AHFBDDBEaCABHDAFhACAcACDCHEA.WEFE..KDHB...hABA......hADA...,1,-12,-24,12
AfObYQMcdCWEIBGHPDXTeZKgLJNSaVURF,OCCBQCEBdFGE.EAEEGEDEHGFGXBBBZBFGLHAA.JABEhAAASDAG.hABAaEGC.VFCA.FHAAhAAAfBDHMAIDCDDDBBADDFIDTFAE.hABAKAFC.....hACA...,2,-16,-1,15
DJKQdVPbINAaOfXgEeBTCGULcHFZSYRMW,OGEAXBDC..EECBBCAAGAACUFDHLAEDHAEC.SGCGhAAAMCCBDEHBKBHBQBFAhACAdEAC.PEEChADAIABGADIFaAGAfHABeFHHCHEA.cGGHhAAA...FDEG.hBAA...,1,-7,-19,12
LFNJTWZecIPHVdSXCRMgBGQOYbADUEKfa,UCAEEBGBKDCGLDDA.FHCETFBDZFFH.eFEC..PCDGhAAAHBEBSCCChAAA.CGGAMCIBBFHFOFADhABAbABCDGAFNADDWADGIHEH..XAGBhACA...hACA...,2,-30,-14,16
VRPaUXIHMcSNfJBTYCQDLbGeAZKWOgdEF,KEABOAEBdCFFFACGRFAG..UCAFHFGD.MDCBSEEA..hAAAfHAFBHGACHAFLAFHhABAeBAHAGDAZDDAEHCAaBBGhACAIAHD.NICB.....YFHHhADADFFF....hAHA...,1,-16,-31,15
DSGdVgYFKZXMWbOPaECALRITfJecUHNBQ,RAAATDFGeEAHHEFA.BHDHDHBAdAGF.VFDAFDGAKGHB.MDAEhAAAODAB.EABE.ACFALCCFhAAAJHAEUAFGSECBhABA..YBDBWAED.aGHFhADA.CFBGfHFHhAEA..,2,-23,-12,11
HeFYIQOEbSDLNKAXVZdBfRUJcCTGWgaPM,VCACdBCGBGCA.RAFF.JFBD..CHHAGEFG..aACAHEACeEHDhAAAFAEBQEDHhABAEBHFDBBDLFEFKAFHAGEDfGFAhAFA...cDEF..WHAGhAAAMCIHIDEBhABASBBE.,2,-32,-17,15
dCDZcYaISPFBfAWNReEUbTHLgXVKMJGOQ,RCECeEDBEGHH.UGGCHDACLCFG..gACAVCAD.MAIHhAAAGACDdEEDDHAAZFEDaGAGhAAASHEEBBHCAABG.hADA.NEEB.TFCG.KBABJHAGCFAF....hAFA......hAGA...,1,-4,-5,1
LaVSPQfNAKODCBcRdGeUMJFEXbWIHgZTY,DBDABHDHdBBGUFGDFGFA...EECD..XCEE..WAGFhAAAHECD.ZEAFLDBChABASAGEQACGhAEANICH.KCHBCEHE.cFAAeEEGMACA..hAAAIFEE..hAFA...,1,-20,-42,22
YUgILbRaFPMWAedOVcZfEJTGNQCDBSKHX,OBGHZAGHEGHFGCAA..CGAHBFCGKDEDHACAXAEF.UBCChAAAIFFELGFChABAaAABMFAHAFDAdCAA.cGBDhACAJHCA....NAICDECCSHEG.hACAgCFD.hADA...,2,-30,-4,26
GABKOIUHaZVdNfbDCYFLMSeWEPgXcRTQJ,BACGOFFFUDEGHABFZFBHdDEF...NEAA.DEHF.CHAE.FGBGLBEGhAAAeECG..EBFG.XADFhAAARBAFQGEFhABAJEHHAIEE.KDDD...IAFCaHBE...hABA......hAGA...,2,-34,-13,21
KBTAfNdIVRJPbGUFWCaESDcMLXYgZOHQe,dAGERFBF.JADCGCDF.FABGaEGHDDBB.LGFE..gECFhAAAZAECOEFEeBCFhABA.KDHBAAIF..NEEE.IHHGhACA.PHDC..WFADCFEASDDEhAIAMAAF..hBAA...,2,-37,-24,13
ODAbBUMYHZGCKPLgNTQecWaJfdESFXRIV,UCEGMBGBHDBEZDCBKHDALABE.TFDGeBCF..aFABJCHHdDHEhAAAFHAA..RGFGOBAFhABADHGGBHFD.CBCDNBFA..hAAA....WAEG..SFAGhAFAXGAHAHCC....hACA...,2,-29,-14,15
ePJBCWAdEgKXSUMbDcIHYLaOQRFTGVNfZ,dGHCECDGKBGCUBBE.DBHFHDBB.LAAAQGECTGGAGADChAAAVEEAZGAG.eCGDJHDACCAEhABAAACE..SDFDhABA.MBIHcAEHIFAFYFAF.hAFAaDGA.....hAGA...,2,-15,0,15
DVcZXNBgTELQIUHCRWGASfdbMPeOaJFKY,dFDEMBACeDAB.OEEAaCEHFAGB..DAADZGEGBBCHEFAA.LAGHhABAUDFGRCAA.AGGD..SFHDhACA..PFCChAAAKCDG....cCBCNDIE...hABAQGBACBHA.hACAfAFG.,2,-26,-18,8
FWgKJcDVRAeCXINMUGBafbdOEQTZLPHYS,eEBDCHHB..XFEAMBDFBDGE.aEHDfEAF.ODCAhAAAQAFEZBBEHAGFhABAFFEEKBAHDGAHVFBBhACAACIHICEFNIDH...bABFEEHFLHFEhAAASADCWHBAcDEEhAGA...,2,-17,-12,5
gGFWaANSMcRfHTIdUCLXPJYbQVEZeODKB,SGEERCBCHCFAdAAHUGGCCAFB.LADG..PEAHJFAA.hABAQCFHEEGA.hAEAeFBHOHAEDCCBBFHDhAAAFFEBAHAE.cABG.IDDE.XADHhABA...hAFAYHCG.,2,-22,-11,11
adAcCLJfUOTRKZDbQNXYegEHBGWPVISMF,LGFCUAFDOEDFKBCDDFDE..QAAH..NGADeBDEhAAAHEBFBHFA.WFGBhAAAIEAHFADDADAGCDHAJHBEhABA...RCFC.XDEFEDDEPHFCMIAEaAHFhACA......hADA...,2,-27,-18,9
ZJKUMcPTGaQHfWYOLbeCEdNSIDXgBRFAV,VDGHZECHUGFB..MAFE..PAAFaFBBHDDD..fBEDhAAAOCDAeHCAEGBDdFEBhACAIACH.gGGAhAAABEACADCCKAHB.TCGAWBBD.LADEhAHANBACDBIB....hBCA...,1,-4,-21,17
LQeYRMKfOgDIcdHUXaANFCBGPJZSWTEVb,FCEBCBEDBAEEGEFAZGCC...TCGFEDGDLCBFeAEG..MACDhAAAKFFH.OFHDDBAFdEDBXGAAhABAACDD.NBDG.SAHHhAAA..WDAB....hADA......hAGA...,1,-19,-45,26
KSaIAfLNdWEGXReDYCMUOJBbVHPQgcFTZ,LGAAdDHEEBGGGFCBREEDDBCA...MCDFOBAFBBBFHAFFQBEChAAAFHGEKCDB.SFAFhABAAEGC.fHGFhACANIADeDAD.CDAHJHAEPDCH.....hADA......hAEA...,2,-19,-11,8
VSDHbeKXUIFdWQCgLPcNMZfORGYAEJBTa,BECAVBEA.SDGEHEDFeABHKCDG.UBAEIDCG.FDHFQAFAhAAACEAB.PFABhABAMAFEOHFChAAA.YHBAAGGGEEEGTGEGDGGA.XACBhAFA.gFCAhAIA..,1,-14,-20,6
CQbJgZVfDANScBILeFKYdOTRPaHMWEGUX,SBDFBHAHLCFEKCEA.dGDHRECF.HDBFEAFD.XADB.CABD.hAAAJHACZEFHDEHF.ACAF.NCAG.hACAeBBF.FGEHODDFhAGAaEAE.MIEEUGGD.....gAGBhAAA.fEEDhABA,1,-19,-24,5
KHUeWVPCZRTJMDfQAONcLXEdFGBYIbgaS,OFAFLBGFdCEEFADCBDHC..IABFaGCF.HCCGeAAHVGAChAAACGGFZAEARFFG..MIEEhAFADIECADCB...XDCDhAAA...EDAF......hACA...YFHBhADASAGE.,2,-25,-20,5
MCZKFSXNcGdIgfaPbYARDEJVeTWHOLQUB,REEFDECHECAAeACC.HEGHOBFALCCABHEGZDBEFAGF...XGADhAAANEEC..dCAEICFAhABAfFFGaGGH.hACA.....PDHFAICE.TACBhAEAWAHH.MAFCKAAE...hBAA...,1,-10,-28,18
RAedXFCGENSZcIVKgUHJbMWYTQfBaODPL,eBCBdFAHCHCBGBADECFAZAAF.....IFGAKFGDUFCH.JAEBMFEHhAAA...TDEEhABABHHHODHDDEDHPBHFhACALHAA.AADB.FBFGSEEBhACA.cAGA..hAEA...,2,-29,-24,5
aFcbZBYGCKVQNWTLegDOJPXMAIEUHfSdR,UDCEHEBFSFFFdEHEFHDE.ZCCABGBECHEGKBFE...QEGChAAATAFFLBAFhAAAeABCDGIHOCEDPBABAAID.hABAEHAE.aAGA..YFAF.NDGE..hABA......hAFAWCBC.,2,-44,5,49
aOJLcYfHKTWgBSbXFPVIdUANDQMeZRECG,DFDGeDDHEBHHCCFF..GCAEOAAELCHB..fFCEhAAATFEEBBBEXEABhABAPADBdEHGAAGG.MDAEaHGCJHBAhAAAcAFD.KGFASAGAFDEE..hABA......hACA...,1,-15,-17,2
IQLUeFcdbZXPTYfEHJAGKWDCNOSRVgMBa,KGGCCECC.OADBSGDB.RABE.MAFBBHCAQGECUDDCFBGA.hAAAdAADZDAF..PAHDhABA..fFHAhABAEECDAHIFGGAFDAFENEAAaEAF.IEEGLHFGhADA......hAEA...,1,-12,-25,13
KOCJREBdfGaZSPQDAXUVYeFLWHbINTMcg,UEAFeCCAFBGCHBDD...ICABTEBCMEFHKCHB..CHBARDFHdBADhAAA.aDGHZFDH.SFGHhAAAPHAAADIBXADGhABA.LHEAWABC.NAEF....hAFA......hAGA...,2,-31,-4,27
DQVPUbJZXCTISdBAFgaWcLMGEfNHKROYe,aCFALABAGEEBEGCHHCABKGFE.RACG..OEDHDCEAQAGBhAAA.UDEEZCCACHHDSCADhACAAAAGFGAD.gFAAhADAMIDAfAFDNIDB..eCCD.hACA......hAEA...,2,-13,-9,4
CBUEQSWIVTFKaLYHPMbZJGfRNOdXcgAeD,CDFHBFAAUACA..SDBA..IHEETAEBFGGEaEBH.hAAAHEEH.MICEZFDEGAGGhABARCGDdCCB.XDDBhAFAAABGDBBC.EHGEWAADKGAD.....YGAGhADA...hAGA...,2,-32,-17,15
QTKAFXJMBVHOEaeWRUfIGcZYgPDNCSLbd,XFABJCDCBCHC.HBCC..aCBDeFEF.UBAGGEEFZDGFPDDBhAAACAGHLHEG.QGAGhAAAAICEMAEEEAHH.hABA.fFBBcGGC.DAEE.SADGhACA....hAIA...,1,0,-33,33
bGfSERMadUAQPTWCDXFBJKgNHYVceOLIZ,QFBFTCFH.DEFDFFHHKBECHBCE.VGAEeCDGLAAHhACAZGFEGDAHSDAAhADAEBAGMIBGaEEFADAC.CEDDXAFAhAEAJAHH..YAACIHEE..fEGChAEA..hAFA...,2,-20,2,22
fAEUgSGCYRcPKZWMNeIOTFLaXHdBbVJQD,UEGGSHECCCCC.RAGF.KFECZBEH..MABFeGAE.OBABLEADhAAAaDDB.dDDBBFGEJADE.hACADCCB.ABDH.GGCFhADAPAAA..NCEF.IHHC.FEEH..hAEA......hAFA...,2,-28,-23,5
aQHSTcBEYeKAGfCbOUgDZMPdFRXNWLJIV,CGBFUBEHZCFF.dGEFRBBB.....XABFLFEF.JFHDaEECHADHhAAASCHBBAFEeHAAhABAAIHAGEAA.fDBBhAAAODAHMAHHFFHBNAEH......hBAA.WFDD...hACA...,2,-24,-15,9
JSYDXFcQfKIGCPNeAULRBbMTWdaEHZVOg,LEDABFAEMCEAdCBGHEFAOAEG..JCCDDBBGFGHHQGDFhAAA.KBHBIACDhAAACHBCeBGD.ADHARGDE.TBAGhABAaCDEEGHF..gGBFSDADYAEGhAEA....hAFAcEGDfEDH,2,-18,-15,3
WLMYIegBRKcJdbFEVPSTZAHUDaOQCfNGX,DAFAOCCGCFEE.GGEBLDEGMAGF.eFBHBFCD.KCEEdCAAFBAHEAAAhAAA...SFDEhADATGGF.AAIBaEGG.hAAA.fAHA.XBBBIFAChAEAgEAF.hAFA...,2,-44,-19,25
MJWEDgZYVAcKQXPObGedUCSRNaLFfBITH,QDAGXEDE.OACCeDBAdAGG.CCFG.NEED.FCBGBAAH.HFCEhAAAMACCEFHBDHECZAGFAFIHKAAGhAAA..PCCChACAbFBH.SGFHLBHHIHHB.hAEA......hAFA...,1,-14,-17,3
EJAIPHfGLUBXKVMcWDRagbTZOQYNSCedF,HABFLHFABGDAKCDCMFHBDGBC.RBGH...aADGTFBAZDFE.ODDChAAAQBFC.SDDDhAAAdBAGFAEEAGGDIEABhABAfHBD.XBAA.cFGDhABA..WFFF.hACAYHAACAGE,1,-16,-35,19
ZJLaVKITGbEUWNBSXfQOdPYDRceCMAHgF,HBCCFBGFLDCGaGGCKGEBGFAHUGEBBCAF..XDFAOGAGdAAFhADADABARDBG..CAEAABDB.hAAA.gAFBhAEA..JDHBIHAC....EEFFhAEANCICSBBFhAHA...,1,-13,-37,24
CQadMRSHZBONgJXUfPbDEFWIKTcLYeGAV,VFFDCBCHdCHA..REDA.HAAABAGDOADG..JEBDUCAB...hAAAPDECDDDCEGGAIBGAhAAA..TCAAhABA..cFCHeHAAAEAHaHACMIFANEIGfEDGhACA..WACEhAHA..,1,-23,-39,16
KRGObedSHUJZPaNTCXAMIfWLQVYgBDEcF,MBAG..IHDHLGFCQBAH.VEFAgCEAhAAABBGFEABGFFCGKCEHGCAAhABAeFBGSBHHhAAAJCHDPHBCaADACGHAAEAGWFADDIFEOCCG..hACA.dAGH....hAHA...,1,-7,-14,7
PDcIVKEJLfFBdNOYaGHAWRQgZeCTXUSbM,QCFCeECCCGGD.UGAEMCIDDADE..VFAFKCBBLFDChAAA.BBAFdAEFNDBBaGHHABCG.hAAA..RAFEZBCHXGDGhABASHEG.PDHDIEGE..hACA......hADA...,1,-13,-36,23
WaTFKARJMPDHeLBIdVcSUGQOXNgECYbfZ,RECCJCEGMAAEHDGH.BACCdBHE....SCCCQFEGXGFChAEAEFAECAAE...fGBEhAFAaBCDKAEFAICCDAGEhAFAeDEG.LBBF.IBFC.hBAAcEGE...hBGA...,1,-15,-36,21
dJTEVIFagUWQDKZBMcXfSCeYAHNbGRPLO,HECAGCBFRFAHOGFCJEFE..EBHFFCBHUECFDAAHBCHF.MBBAhABAXAEF.SAAGhABACEGCAIFA.NIADLGDGhACATAFG.IHHEWDHH..KCCEfAGFhADA..hBDA...,2,-26,-26,0
DCFAfHaVLcMUKXeYBbTSGRIJPNWdQgZOE,aBBHVBGFLBHH.UEEHKBDFeHFA.BFEATBFCRGBG.JECFhAAA..NCAG.dGHCZBEBEGAGhABACAAD.ABEEHACF.MCAFhACAXCBDSHDAIFHG...hAEA..WEFH..hABA...,1,2,-36,38
dZYegDRfOQLVJWUIETMPSAFGcCBNXaKHb,FEAHCHCHBEFD..aFGFKGHHdDCEZCEE..eCHDDGAD.RAAF...OBDAhAAAQEEE.VADFhAAAJCBF..UGEFIAHBhACA..EEADTGBHMBIH.SGHHhADAAHBF.cGDAhAFANADB..XCCB,1,-21,-39,18
NATGFXKEURYWCDLMeQfSZBagIbHPOVcdJ,FGAAXGAGEABG.UCEFREFE..CHHA.DFFALCCD..MDDBhAAAQAFAZAFCBGGHIDDHhAAAHDAFOABChABAdGDBAICGKADEeHCA.aDHF.......hAIA......hBAA...,2,-29,-16,13
GDdcYEaIRfePJCSVNTWgLBAbUKQMFZXHO,KGDDMBHFFFGEZEDDHACDDBEG.dCHC..ECCHaFAAREAG....eFHDCAHH.hAAASGADTBABLDEFhABAADIFQAAEhAAAXAEFOFFF........hADA......hAEA...,2,-22,-22,0
NeQaHSdCPOLTJKfcFZUgVXGEbIMYAWBDR,DBBAeHAEHCCAdDHGOBFAJBAH..KAFDFFEGZGEGUAAG..XEEDhAAAEDBF..MADFhAEAACGFBHBHQGGDhAFA.aDEECGAETDGG.fAHEhABAcFCH.GEAD..hACA...,2,-28,-13,15
fMVeXLCJIEDZTHbGaFdRYNSPAOcWUgKBQ,OEDHUBDGKFCHBGHD..MFFFeAHBLEHFJBCA..EDAEDCFAhAAA.HDAHaCFDdFAARABBSFADhABAAHFH..hADAgEEG.QAAEXDEECHDHhAEAIEHB.bFBHhAAA.FAEA.,2,-27,-18,9
WTPZUeGdcQXaFVCfRbEISgHBOJYDNLAKM,MHBETGEGZDCA.UBFGdGABQCEF.aEBECGAFREGF.EAAHIAABhACAHBCABEACOAFChADADAIB.ADHFKBCF.PFFAhAEA..cGFC.....hAFA......hAHA...,2,-31,-20,11
PSVdefBAGaRHCXcLNQDKOJWbFUTZIYgME,RFBGCAGBLGFGQAAEDBAFKAEB...JBDHFFBF.UCDFZFEH...hAAA.ICHAMIDESBBChAAAdHAHBEABAAGCaFFAhABAHDFD..NBIE...OEHD..hADAWEAD....hACA...,1,-13,-45,32
TDBLeAaQYSWXRGgfbOECIcUVNZMKHJPFd,QBBESFHBRAFAGGCF..fBDEEFBHCCEAUAGCZDEGKAEGhAAAHGACFEFA.DDDDLFFAhABAAGAEaCBB..XGGHhAAAbDAG.IFFA.NABB....hACA......hADA...,2,-13,-9,4
INaWdeYJcDgQRTMCPBbfAUHXLVFZSOGEK,XBGAVBBC.FBCCSGBH.EAGCNFBD..dFGG.eAEChAAAJHFEDDFBRCDC..MIAChABACAAHBGACAIFCLGBChACAOEBGIFGCaDAC....WFHHgDGEhAAA.PADGhACA.bBFE,1,-20,-22,2
bLZfAeMHRBXCQNSgDUTaGJWFEOPYIKdVc,eECBRBBGCFHC.QACB..SBHBDIFCTFFCaGDFGAEAhAAAFAEGEHAGOBAH.hAAAPAHDKFFFVDBDLEHHhABAAEECMDAHXGBH.NEEE.JBGHIGAHhADAdABB.cBBHhAGA..fGHA,1,-2,-14,12
QWTPNRYbcZSHIgCdfAMeGOJUKDXELaVBF,eFDHJDBF.UBAGKBCG.DGBELAFD.BGGDFDCEQAGEhAAA..PDHFhAAANBFE.RAGF...YHFEhABAbGBAZEDE..SBACIEAFCFGAAAEDMDAHhABAOACAaDDC...hAGA...,2,-35,-19,16
GNIFgaWKcSBbdQXRfMTYEeZDAVOJLCHPU,VDDBJFBGLCCE.HGFCUBFE.GGEDFEGE.aDACKBFCBHCEhAAAdFAGQAAFhABARBAG.MEDAEGABDFGEAEACCCHH.hADAPABA...NAIA.IHCF.hAFA......hAGA...,2,-20,-17,3
geDLOHZUCcPKMEABFYRGTfbXQWVSadNJI,BGCHFACAGBAG..bBDHQEFH.SFCAhAAAaFABJHEEeACCLEHHHBAFCCGChAAAcCEGMCIHAEGEYAGHhABA..fFBFXCCF.WFFGhABANIAHDGGBOHAC..hACA...,2,-29,-1,28
dXWDeFVZNfAKUaMbLgQCRBYEGcSHJOTPI,aDGCLBFA.CDHERDBGECAD.GEAHHGEEOAAATBCG..IFHBhAAAXFAH.eADChAHAFBHFNAEDAEFDKBBD.MIAEhAIAQGBFBFDHSHGAdFFEDBAC...hABA......hACA...,2,-13,-8,5
TOZQbdgAHPYaNfMLeRWBJKcIFCXUESGVD,HFAGaDHH.MCBCRAADBFCFJAHD...KBGGFFGBUGFCEDFG..GDDGhAAADFBHZADBdACD.ADIF...hABA.PDACfGDGhAAAeFHH..IBFECEEGSDAAOHAC.hACA......hADA...,1,6,-43,49
SBNRUJcTgPfCEXWQFLeZbMadYHGDVOIKA,BGCEUADD.JAEE..TGFH....fDAFEBGBQECHhAAAFFFFZBBAMFIDdBHC.hAAAGBAGDFCC.OHAChABAIHHBKEEEAAGCSHEGcDGE.CDDGXEGFhABA...hACA...,2,-37,-18,19
TVHKIBLcFfMbRJPEANZOQaeGWgUYDdXCS,ZACAODGHeAFEGDCEUEDH.DHAGdHGD..CBAD.SEGEHADFKDAFBGHChAAALCDAFHEAMAIBhABARDAHEHCG..ABAG.aBBF.hAAA........YAGHhACA......hADA...,1,-21,-24,3
XOATGEdNaIPbMLBYDfVeUcWKSQRHJCFgZ,TCBHEACEdFHC...aFDG..PDFALHEGBBGFDBIB.eBEBhAAAUEAGKEGCSBDAhAAAQFAEJHAECBACgAFBhABAXDDCAGGFIBAEMGFG....hABA......hAEA...,1,-8,-33,25
CLHKFPMEeYgVOWQRJbAXdfcISTNUDZGaB,dDCC..fCBBICHD.SGCBUFGEDCAGGGBBaEAFLFFHhAAAKABC.MEEEEDECeAEEhAAAVADDQAGGhABA.JEHBADBB...cFDANIEFBAHBCABH.hADA......hAFA...,2,-23,-7,16
dSPUIBfVOTWcQJEHFCGaZMKebXgYARNDL,RCGDLADAdEBFUGGBBABD.OCDE..TAFCQGGDhAAAEADDHFACCEFA.ZCBAMDIBhACAKFEB.eFED.gEAFhAEAACABSAAGfHAH..WAHBhABAFAHDaGCF...hACA...,2,-24,-10,14
ZOCcWSTGaLARdgIYVKQJPUFHNEfDBbMeX,dAED..gACFIFFEKCEAQCGHUECF.FFCGHBADEGHDBBFChAAAMAIH.ZFEBCFHCSHBAhAAAGCAAAEDC..hABAYHAGPHECDADH.XFADWAFEaDDAhABA......hACA...,2,-14,-11,3
eOSTcPDdBbHYGfXNKVWJaALMCUEQIgRZF,LDEHCBHGUDCC.QDAARFFH.eHFCSAEF..hAAAcABADHAEBBBDbFCDHBGBhAAAGCEC..fGADhADANCAE.KAFC..WFBGACEGEDDDIHHAhABA.FDHD.hAEA...,1,-9,-34,25
ZNTXIbOCQDFdgBfPLAcSaeMKGUWJYVHER,aAADeBHFGCDCUCEC...JDAEHEAF.EBADRCFAZGCE..TGGEhAAAIFAGCHFGFADCdGGGBFGFhABALADCADIB.MEIFhAAAWDCB...NIAF..OAFGDFFEfAHEhACA...hACA...,1,-11,-18,7
GKSEPCIaJbOXVNYZBgDHMeRTFQUWcALdf,LFBDGAFESFBDEFHD.CGFG.JBCBOACD..VDEHhAAANCIE.BDAHDAEFMDEHhAAATAFHFCAD..QGDChABA.WAHBAAHHdGGAKGGDaBAG...hACAYFDF..hABA...,1,-21,-26,5
cXWZNdRTDFHEOAIQgaBPSbLGMVKUJCefY,QGDGBFCASFHBLCFHGCFGVCCGJBDF..CCHBeHAAhAAA..fAHGhAAA.XBADhABAWDABdAGFDFABFBACHFDBAHGHaGGFMEBD.KHGG..hACA......hADA.YAEH.,2,-13,-6,7
FCYPeKVSAHIfMQDBWTGZaNEOcdRbUgXJL,HABDMFFEBHBFTDAFZBAAEFFB..dFAHRFDDUFAB..XGCDhAAAFADACBHFeDFEVCEAAIHE.QADBhABADAAH.aGHDhACAOHAC.bDDCJAHF.PHEG..hAEA...SEEDhAGA.,1,0,-15,15
VQDPKXEOdBWSLaNYeIMZFgTGJbfUHARcC,CBEADAGHKBGDOCHF.BBDGSCDD.LFAEaFEE.eDHDhAAAICBGZFEBFGAETDDBhAAA..JBBFUFAChABAABAB...cGDHQGGGEGHHWACChAHAMADC.....hAIA...,1,-23,-43,20
OSGUbBDETMWPQfYgJKdVZaINFReHLCXAc,OBEBSECCUFFFBAAA.DDCGEGBB.MDFEQAGD.hAAA.fCABhABAJGDCdAEEVGAAaAGAFDAHHDFCCABHAIFGhADA.GDCGTACC.PCAF...hAEAKHGANEIG...eFFGhAAA...,1,-9,-11,2
TUHOgNfAWKRGdFXISDCZQbPaMVYJecEBL,KCEDdDGHFGGA..SFCACDDGZBCC.QBBD.aAFHMIFAhAAA.JFBFEGHBBAFHhABAUBGAHAGBOFFB.hACAfEAGAFED.WGAGXFEHDACE.hAAA......hABA...,1,-32,-37,5
cPWVISaMdfRTLGNAJgYHOQXKBFbeZEDCU,JCFCHEBF.OACGQCCHBCBEeDFADFGDUFAD..PHCChAAA..IDAHhAAASAHBaACGdFECTBDBhABA.LFFGAIEE.YHFCKHGAZDFCEBAGhABACAGG...WBFE.hBAAMIAEfDDG,2,-26,2,28
OaNUYVFdILDQJcfCHEPWAZRMTXgBKeGbS,ZFAHTDFHBFGH.eDCFGFAF.OBAEaGDA.UGGBFCABLAGDhAAADDIHQADF.hABAJBFEfEEHhACACAAE.EBEHADDAMEACKDHH.SHDGYABG.hAFAIHAE..hACA...,1,-18,-21,3
RACZDTUHKXYBWgJOaGMScbQdNFIPVfLeE,ZCCGTDBCKECBBEHB..JFDBOEEDGADA.SFFChAAAQGACdABHFGGE..VAGFhACAeBEEAIAGDFAHHBAHXGGEhAFA.WDFAMAAE.NICFIAHBhAEA..fFBEhAGA.,1,-16,-21,5
BVUWePIRMHgCZFLXcQOSYEGKdbNJaADfT,DGCDBHHGUDGCeEFC.RBDEHDAEZEDFFDBHLHCA.QEDEhAAAOACAEAGEKBHH.dAFBJABFhAAAAACG....fBBEhABATGGG........WFDDhAIA.....hAEA...,2,-39,-15,24
BGLQADKSVMRdUENfJZbcCIOTgPFWHaeYX,DAIDKCBEMDDDUCDB...EBFAJABA..ZGFC.CCED.ODHD..hAAAPBHFFGFC.aGADXFBFhAEA.BHAChAFAGEEHAFFA.SEBB.dBAGNEECfBGGhAGAIAEGWAAEhAGA..eBBD,2,-38,-32,6
JCcPWfIXdVgeSEGUQMAKBLHRDTabFNZYO,LBCCDCHD.TDADaFCDFBCC.ZBFDJGFE..CGFG.....hAAAcDGA..fCABhABAXFAGdDEGhAAAeCEFSCDFUEAHAAIDKGGCBBAG.RGBCNIDFOHAChACA.WHFA.hABA...,1,-22,-30,8
GcJdTVNEeCSRMgaPOIHLbFABXWfYUZDQK,XGDF..fDBDUCGGDBCBGBECdGBEVDFB.eCBEhAAARFAHMACC..aHDGIBAAhAAALBAFFFHFBGAGhABAZDBAKGFGcAFD.NFAHCHGASAGEhABA......hBDA...,2,-15,-13,2
LMETUdSHPRNGAQKZBCeOcbWFXDaYVfJgI,ZCGHBBAGCAEB.OCCB....bCABFHFEDGBFaGAB...VFDChAAAJDCGLFCA.hABATGFESAEHhACA.PCHBNDAAAIHCeABEcGCH...XDEEhADA.fADAhAGA,2,-40,-27,13
ZHNTKCEFaOJIgQUABWPSdRYGDLfXeMbVc,BABDSCBDRCABGCCBLFFG.XFBBbGAG..ZFGBNCCB.hAAAKGEH.CFCD.EDGBaDFEIGADhABA.QDDFhACAAEADdBGFDACG.fADB.MAIDhAFA......hAGA...,2,-26,-23,3
IcgBMETPXDQfUJSWGdKeAFVYaZHbLNORC,VFECZCGHLAEB.ODAACAFD..IHHFBGAEEGFF..hAAAXCDCDICAQEEBhABAUEADJABGSBBGhACAdDHGAAIFFHAG.aAHF....bFCDRECD.MAABhABAfHGFKBGA..hADA...,1,-14,-20,6
ILYgXCADMTZeEaHdOKBWVcSRQUbGPfNJF,TGBCeABAEEFH.dAGCKFEEBEHE..VADHRCDDUEBCGBBA..hAAA.fAGChABAJHBG.IHFCLAADhACAgDFEADFGDFHDMAIDaGAHOFAHWCADSGGBhACA..hADA...,2,-20,-18,2
LgBeARSVNTCUYQJdDbEPKZHIfGMaOWFcX,VCDDCCADUBEF..QEGHDEFG.EDAHZFDC.HGACGDBCMBCBhAAAaDGA.FADA.XAAChABABFHBAHHE..NIDH.YFFFhACA.dGAAKAEEIHHEfDDGhABAcGCE....hAGA...,1,-8,-37,29
WZYNUJGHLIcSdOebMVDQFEKfXBARTPgCa,RFADTBGBCAEG..ZGFAUCCBGCCCHEFCLBAHSBBF.eGAChAAAMICEQAEFhABAEDHFKAHBBGDHADFC.aAFDNIDDIGEEhACA.cDACOACBDIAAfFFDhAAAXGGA...hADAgCFA.,2,-13,10,23
OSHdVEDaMbTJCgcWeNZIQfPLBRAGYKUFX,GCGCUDBFOFFASDBEHBGH.dFBEEAEDDCEH.MAAE.JFDHCBBH.hAAA...gGBGhABAeFHHIBCD.hACAQAEFfGEABAHAAAFGKGGDFFFHaEEG.hAFA......hAHA...,2,-16,-16,0
DNJKMOFSXeYRaQVBfHALZbIGUdCcWgPTE,ZEBFGBFGUBCFdCCB.CDAF.....gFECPFAA.DGBBJEEDhAAA..KFHDMAIFFCAB.hAAASHFCeAGHaFABBABFhADAAHBFLACG.IBAH..hABAWEFEEHCE.ODDHhAEA...,2,-34,-17,17
NVfMQIAaUEBFcCTXRSDOWdJbePGKZHYLg,UDABFGFDCCHA.RFCE..DEIDOBDG..JEEGeEDC.GEAGKBCGHAGFhAAALAAF..hACA.NEHC.MIBEADCABBBChADATGGFSGDCdACB....bGAGYAFChAEA..fDDHhABA,1,-26,-34,8
gQIFPMDEOeXHBWGRcCSNJZbLUAdKfVTaY,KAAFTGAD..aCBAQGCCFFBG.MFCCDEAFOCEBHCBGBBBGhAAAREGH.CHFHSAGDhABAZGCGLADCAHHAdFGH.hABAYBEHIAHAEEAC.eACC..WHDAhACA..NAIE...hACA...,2,-33,-1,32
YBJWDQSZHeOaAdRNVFTbLgXKCEIfPUcGM,dCADRGDAFBECLHAG.KEEHCCDGEEGH..IBFDUGAAGBAGhAAABEDCDHFA..SAFEhABAHBGBaEHDAEGFNDIE..hAAA.TEAD.XABEcDED.MAEChABA...WHFAeAHHhACA...,1,-17,-30,13
KJdZIMecCbGPaXSYWEQLONAgUHFBfRVTD,HEDEBDHBRGDCTEAGKACC.dBCE.ZAEAMGACCAAFGGEB..aBECXDGEhACA.SCEGhADAEHGAQDEHhAAANIBFAGCB.gDCF.FAHHDAIBICBFhABA.....hAFA...,1,-8,-27,19
JYAPKXUQZNecGRIHWgFDMEVBdbLfaOSTC,KBCGUCDFQDDDZDAH..eDGDRDABHGBCFAFADHEGMFGBBDHGdAGELACChAAA.aFHHhABAOAAACGEE.AGIDXECEhAEANBIA...IHCG.EBBDhAIA......hBAA...,1,-7,-40,33
XBgReHUDYZbdMENCLOScPTKGfFAIVJWQa,JBBAQFGDBDFB.RAFDUDCEDHCE..ZDADMFAD..CCGBLAFEhAAASACE.PBADhAAAKGFC..FEEBAEEGIDHEhABA.aHBEeFHH..bFCANICDOBABhABA....hACA...,2,-43,-11,32
CZePNMTLXWGFaDQIKgEUHBOVbdARSfYcJ,SBFA..cACHCAECZCBFeHACMEBELGDGGEEDDBDDhAAAIAGAKDEC.UDFChAAAOHEGdFAGABIDfCAGhABAJBAD.NGAH.WHEAaHGE.EFBCBABA.hABA......hADA...,1,-12,-26,14
cIDTJVYEPKSaeZWNgLBfGORQCHAbdMFUX,MADEXCFGDCDC...JABEEGEH..SEBHeEGFZEBG...hAAA.NDDFBGBHfEEEhAAARBAHHAFGdEGEFHGEIHCBhABA.TAFD.YCDDaGCD.hABAWGFA.LFAFhAFA..,2,-18,-13,5
fbIUNeCFZJOYHDGTBRgWcEVdPXKQaAMLS,LFCFSBAH..bBDAUGAA.CDEGZBFAOEAFHFDHDDDABGGBhAAARAAC....WEHHhAAAEABEdAEF.XDFHhADAKHECAGEGMAHDfCCGIEFA..eDHBhAHA..FAEG...hAIA...,2,-20,-14,6
TZANdJHGXBECSRWfPbIQDaFMceUKLOVgY,dCGBHDCBBAHASFFGRCCC...fAFAPEGB.IBDAhAAAaEAH.FFABMFCChAAAeHAALBCEOBADgCGGhABATGBDAGIBNACF.XGEG.CBHDWACChAHA.DGIBKBAH.hAIA..YHEA,2,-21,-10,11
YcJUXVHdCGZEWSabgTLDOBKQMFfNPRAeI,eCEF..IHBCJAHBUFBEVBEA.CADH.EACD...SHEChAAAbAABLFHBDGIBOBABhABABFEDMIDAFEGC.hADANHDFADAF..XAFFdDCH..WFACaGGDKFEGhAEAfDGC.hBBA..YAHH,2,-22,-14,8
cFMRIXNfJGVAgQaSCLPTebWUZOKBEdDHY,aFGBCFBDLCCC..TCCBeGDGUAGFKDAFBCEEDIGE.HAGHFEEG.hAAAMDIDRDAG...IABAhAAAXABGfEEFhADAJDHF.VFAFAIDGSHAA.hAEA...WHEA.hACAEGDGcFGC.,1,-10,-23,13
IFTJYBeWNSbGfAaRPLZQgXKVOMEHUCDdc,RDADLACGQEFCKHEAMBABHBCHDIAC.dAAAFFFC..JGCABAGGhAAAeDFESEDHhABA.GEAEAHACaAFE.PDFEhADA.ZBBC........hAEA......hAHA...,2,-23,-23,0
FSeCDTRdfLXIMaHUZJVNEKPgOAWcBQYGb,BCCHGACHFGDHCBADDGEHRAEA..dDFGLGFG.MDGFaFAAHAAFhAAAZFAD..JDAAEFGAKDHDOBHDhACA.ADAD.QAGGhAAASEEDeFCCfGHC.IHAGhADA...hABA...,1,-21,-24,3
AMGFbIdQVEOYDRBNcfSgKZLUaTPHeWJCX,MCDAGEBFFGECdBCE.EFGHODDH.DFAHRAEGBHDA...fAAEhABAgDADKGAChACAZBGHaEGAHABD.WHAAhAAACHHCAAHEQCEG..YHFGhABASDAG...hADA...,2,-30,-13,17
OJQfUGVZHWPYIBAaedbKLNEcFXSDTRCMg,dEBFLGDAEHEA.XAFBSABH.DIBCCCHGMDAA.OFBGhAAAfDGFGABBVADBhAAAZFGHHCEF.WEAChABAIHHDAHBH.eGAAKAHB.cAGA.hACATEEC...hAEA...,2,-18,-7,11
fFKOcYRGVDJCPeBZbHEgMAdSNLWQaUTIX,dEHALFCFaDBD.TFED..IFEBFEHBKBEC.OBBBRBBCDEEC.hAAACAHBBCHEHDAAEBGFMAEDhAAAAHAC...SGBHhABANACH.QGFH.XDFFhACAfGHA...hADA...,2,-31,-18,13
VWPeLXNEQDZGCIAfSTHOdFaUbgYJcKMBR,SGEAOEDCdHGBUEAH..bCFC.JCDDKBBB.MAHDBBABRGAG.hAAAVFBF..eDEGhABANBEH.DGDAZFGF.IDBEhAAAACAB...fACAFBDGaEHD..hABA......hACA...,2,-28,-26,2
COPHDfaNFAYbcBGXWEIgKQLdRTSZVeUMJ,...bEFAGEBB.ECABICDDKBHBLAAEdFAGRAEGZFDFUCEDCBBFHDAGhAAAaGFG..AAFBBEHGhAEAgGGDSGBGhAGAMABEOHAEDIAANIEBFBBCcCGE...hAHA......hAIA...,2,-17,5,22
eOgfIYXdRJKabPZDLCFWVHTENMUAcQGSB,QEDCSCBBeAFDOHBA..IDDAdAHCKBCD..aDFAbBGDhAAADEBD.LAAFhACAFFGDHEAFTGGHEFDGNICFMBAAhABAAFCEBHFD...fAEH..hADA......hAEA...,2,-26,-5,21
IFEDQGeAWaLURBMYVCOfZNdTJgbcXHKSP,LDFDRDDFBABH.MBCBCHFEZBDEdABB...TAEGJHBE....hAAA.gGCDhAEAXDABHDGHKBGASEHDhAGAIBHB.DDED..eEADAIBEaGEC...hAAA......hABA...,1,-15,-40,25
YKeXGBAOUIdbCQJDfPcLNHTRVgaMEZWSF,OACEdHFFQAFBDICC....fBBGPBBDLADDhAAAHECDRCGH.VDEGMFIDEBHFhABASGFGFGAFKEHBXFCHhACAAAAGIGAFCBEG.JCAF.TCEC.hAGAaAFF.....hAIA...,2,-11,-6,5
GRMNcBQEaefZYAXCULWdDKJHVPgOISFbT,XAFBCCDCLAEHDCEDKDAB..HFDC.VCGFOFEG.SBCChAAAbDAH.GGCHhABAMICEBDCCaBGCeGAChACAfBBBAIACdGGAPDFEFACANBAGEHGA...hADA......hAGA...,1,-4,-18,14
HdAabMGfgLXRNSeWZFJYOEKCDIBUPTQVc,aCAGMFCGGBDBLCCCRDDB.eFHDFDGF.ODACCGBB.BAGFUGFBQGCChAAA.VBGFhABAcDAGHFAFAIBG.gGEBhACASAAGZABGEAHBDEEE....hADA......hAFA...,2,-25,8,33
eYcAQNSfBXaLUDdGOMPEVWJTIRCgFbHZK,SHEABHCAaDCFLCBEdEEGGGAD.MBAFEFBE...VCBEhAAATFFGRAFE.FCHFZDGDeABEhAAAAIHE.QGAChAEAXEBGDBBCPAFC.IEEC.CHHC.hAFA......hAIA...,1,-8,-16,8
aLZdATIWgJSDcFXPCYfVReBKQGNOEUMHb,TCED..IEDEJEBC.DCCCXAEECBHB..fHAFhAAAeHFAKBDFNCHAEABC.hAAAUGFBHFAB.aGEBdEABhABAAADE.SCGGFBAD.PADE.YEHHhAGABGFH...hABA...,1,-19,-28,9
QAcLXGeBNCRZIEdfFSVTUgJDPOWHMbaKY,LAFCeGECBFAECFFHRBFDEDCG..dFHGFCFF..SDCEUABDDBEE.hAAAOEABMAEEKECDQEBGhAAA.AHEGXABFhAEANBHA.fBHE...hACA......hAIA...,1,-20,-41,21
LfWYgNAKCeTSDGcEMORIPaXbBVJZUHQFd,KHGGCCHH.eHBGDADEGEBD..MDEHOBDEIBCB.aAAHhABABGBB.JFHDUEBGhACAFBAHdGEFLAGD.hAAAWDFA..YHAAABFHSGFC.hABAEAHFXCCC.hADA...,1,-28,-38,10
ZBeSMHTVRJYbgKIcXaOdUPGWCLfFAQNDE,QDBBDABEEGFA.BAEDeAGBMFABHFCBREFH.JBED....gEDHhAAAKAADXDBFhAEAaADHUBAH.PCHDhABACAHEFEGGAFAGZGBA.TBFD.....hAFA......hBCA...,1,-1,-29,28
cHQIXaLGSUZWPBbMYCNgDdRfAeJTFOKEV,TAGEKHDCEBHH..HAAFQDEB.aBCALDDDGCAGSEHBhAAAWADABEEAMECBhAAANDDGdGFHACAFFGGC.ODABhACAcGAC..IHAH....hADA......hAEA...,1,-6,-26,20
DAQaIGfSHVOUBgRFZWNbKXYMcLeJdPECT,aADGGDAAHCFHODFBBAHCRFGFFFHF.ZBCD....NGAD.KDGEXCDFhAAAMEEHeABC.JFCDhAAAPBAB.CHCGABIFIAHGhABA.SAEH...hABA......hACA...,2,-31,-17,14
cbWKTNIUJYdaSREQXAOMGCPFfVeBLHgDZ,MCCGCFACFAEA...VEBFBEDE.LCBEDEECZABE.....bGFEhAAATFGF.NIBD.IABEhADA.JFCBYAHFhAAAdAHA.aDABEEGFAGADOGDE..hABAfCFE.hACA...,1,-30,-34,4
CbUDeIadZFQOVgWEJLcNBHGRXYKfTPMAS,CBCCDEDB.eHCCaADAZGAGFDBF....QAGEVCAD.EHGEJFHFLADDhAAABBGE.GEEHhABAREEFKDDH.PFAD.hAAAAGIDSCGGbCFA.IBBBdHEH.hABA..OAEF.hACA...,2,-27,3,30
eGIZWPKYXUFNVMESacDHTbgBALRQJOdfC,LFDEJCEE.OGDEdECCeFEBGCDFZEAHKDHFUEAC.FHGEMACGhAAAEHAG....SBAGhAAADBDCHBAGTGGHhABABBDGADIBQAFE.CEGE.WAHB.hABAYHBG..hAGA...,1,-9,-31,22
INDdaTCFfVLRGeXBcKWYMAUbQEZHOgPSJ,QABFEEDCZEGDHABDOCAC..SBGFJHBADGAB.TFBFhAAAFAEELEFGeBDFBDAGhABAKEDFMHECAHDCUGEG.hAAA.gBGFIHAC.aEAFCFAF....hACA...fCEAhAEA.,2,-26,-6,20
XVREfJQCGbKecPNUgaDIALHdFZOBSMYWT,HFADFEGGBHGGMABG...TAEGXBDDEAHD.QBADhAAAGDFEbCCDKGCF..PHCChAAAUAFHDEEHADBE.LEADhABAOFHDSCED....hAGA..YFEBhACA...,1,12,-38,50
FNPeXMBWfEcdOaCVRSgTLIGZHQJUYbKAD,DDCGFGEEeDCCBDFH..EECCdAEB.OFBB..VABESBABhAAALAHDZEGHHFDEJACD.hABAUGADKGCHAAHCXAEDhAAAMCIH...fHGHCCFB...hACA......hBFA...,1,-22,-24,2
CBVILQfJcAKHbRgTOMNYUeXFEZaPSDWGd,HDFBRAEEOBCCMBFC.UDAGeEABFAADZCBC..SGCEDFDHdEHGCGEH.hAAABEDB.LHAAhAAA.fHEFhACAAFEF.KCEBbFFH.NIAD.EHGAaAHD...WABChAGAICHC..hADA...,1,-19,-23,4
gdfFaEADRMTYLJcZWIHUNPXOVQeKBSGCb,DHDETEBGLBDH.ZCAFIBDFHAFGUCGH..NHAHXDDBhAAAOFAHeFCC.SGFBhAAACHGFdEGGFAGGACCDMABChAFAJBAF...WBBB......hAGA......hAIA...,1,-17,-27,10
ZKLQMNCOGPRXVFbSgadYTfeEBHAUcDWIJ,DFCDJCAHLEDEMDEE..OEEEGEBGRBCF.FABG..SHGEhAAAaHDEdAFB..TBCChAAAEBHDAHAB..UCACIGHHhAEAKAFDCABH...PBHD..XGCDhABA....hADAgFDH.,2,-25,-15,10
PcBLfXZUgARETKJQeGINOFbdSDWHYaMVC,ECDAKGBHeEAAGDAA.ODFCFAAAdBDC.DGDCHBBH.MIFECEEABEHEhADAXFFA.gAGAhAAAAGGDRAGH.QFDAhABAIHHG.NACDSHAAaDFF..hAHA..cAEE.hBAA...,1,-1,-43,42
MUcGWgYIPfVdaSZbRDOEJXQFCHBeTKANL,MCEDGEAH.....gDGHPHEEVAFDaADFZBAA.DDEEhAAAEFACQFEHhABACHADHEGFeCCBACHCUGBD.WFHHhACAIACA.dBAESAGFOCHF.hAAA......hABA...,2,-14,-4,10
LNJGWdSITAPEQRFHYVegCKBDUcaOMfXbZ,EFEARADEHFFE.eBHBKDAAUABEOBAE.MFAFXGAB.LHDChAAANDAHGECAdBFHTCFChAAAAHADQDGB.hABAFEDGYHFG.CEEF.DAFE.aGGF..hAEA......hAIA...,2,-21,6,27
MEBKPHgFaJCOLWGfdNRSZQbATeVUcIYDX,VDCGUGBA....ICEEXCFABEHFHBAG.FAEECEAGLCCFhAAAGEAAdGGB.SGCHhAAAZGFEABBHeFEEDIEGMACChABA.KBHBaAHFOBEAWFFC...fGDFhAGA...hABA...,1,-15,-23,8
MKYXPQWBdOfCcVFHAbeLTNSUaZRGJEIDg,LCBGTADC.UFDCZCCEGGCDEBHD.DBABMAAGKFAC..XAGEhAAAPAEG..BGHAhAIAfDGECEBGFDGHAIFE.NDIE.hABAaCED..JFEC...IBBH.hBAAYHAAdGCC..hACAOBBG.,2,-15,-7,8
eTISUCZRMFbGLgaQBWPJNVKDYHcEfAdOX,dAAHXGGGeCFA..SECBCAGGZBAA.REFG.FDGEGBCHLFBChAAAQGGBBCEHJHCCNEEA.hABAKDBADADC...HFBBhAGAfADDABFEIAHCMFABaDBB..WFFChABA.....hBDA...,1,-2,-27,25
KFgEcbNMdGJYVeZQTICBWUHOSfALDRaXP,LBDCaBFG.KEFBEEGC....NAIGGEADJEDGVABE.QGAEhAAATGDH.CGHABHCEhABA..UBADSGDEhAEADAAGPHFE...gGABhADAMDEGdGGG.ZDGF.IDDBhAEA.,2,-21,-18,3
OSQFMJBNTLWIYEGAbDeVXHfZcRUdPKgCa,DAAEVCAAHFAD.ZCEFRAGDUFFCdDCBKHFC..CEDD.OAEA.FHCCJGCGhAAA.BGACLDGBhADA..IAEFhABAEBBGAFID.....XCFHfAHCcACChADA...aHGE.hBAAMIBE.,1,-19,-43,24
fFVcAPNUYZCaWRbEeOTGIMDBgJXLHKSQd,UCCHCCGDREAF.ECAB..eAAGODFEGBDEDFBG.BAFF..JHFGLFGHhACAKAAE.SCCFhADAdGBAFAGFAAIF.NCIEZFCEhAEA....WFDAIHEA..MEAHhADA.....hAHA...,2,-37,-24,13
MWFHcQPNaCgLVXRDKAZfGOUJbTdBYSIEe,GDCDUDEC.JADEdCBDBHDGSBGG..EHFEMIEEFHAAQBABhAAAaEGD.CFFFLCFAhABARABCDFBDKAEEAIBC.hACAZECHfGGBOFHD.TAGHIAHEhAAAWDAD.....hABA...,1,-13,-26,13
GHFZEAfYQKVIaXCOBcSMLgWURbPDNdeJT,QEDEVGBA.aFAFCAHCBDCC..SCCALCFGUABBhAAAbAAA.DFFEdCHAeCADhACATAED.FGDHAFABKGHHhAEAIFHAOHEEMCGD...gCAFhAAAWBDH....hABA...,1,-17,-30,13
ONfeGTKPJWIcLYCXHQZFMgEAdVDRaBSbU,DBGGREBEBADBUBDB..OBACeEFDGFAD.KCAGJBGD...hAAAIGHE.LHAGhAAACEAC.HEEFhABAFEHH.MAFFAICCaHDASCDHfABEWBHHhACA......hAGA...,2,-38,-35,3
EUSXWQdNLbCBRfDJAeHIVGZKTgaFYcPMO,HEABGCBHZGECKEFCTCCBFHFG.....PHBCOFAHUAFAhAAAXADEdECDLBBEhABACABABGCBDBGGeDGH..hACAICHD.aGDDMFIH..WFFAhAAANAIA.....fEADhABA,1,-5,-34,29
XcWPOJELQANbdGTIYZDgSfRBHeaFVUKMC,dHDBGACB..TFBGICCFDBHF.SCGEBGHDHAEBaGDFFEGAhAAA.KFECMBBD.CEFA.hAAAXABE.PCAFhABAEGGCACFFbGAG.YAFCfHAB.hABAeCCB....hACA...,2,-26,-14,12
FCPWQVHdAJNYLUabKSfceOIBGZEgTXDMR,JEDBLBEE.UEEDaEBB.KDBH..SCHFeBCBBAABECAC.hACA.XGCHMAFDCHGF.hAAAQCGBdAGFAFHA.hABANDAA.fHBB.IACGZFGBgGAHhADADGGAFGED...hAEA.WCFH.,2,-26,-14,12
MKJHSGTdaFAOZDNRbUfICcegPBXVLWEYQ,ZAFHDADARGECUECF..CBGH.eCACBFDGLHBC.EFGAMEFAKEAH.hAAAHDBE.SAAChAGAdDDFAIGEOABE..hABAfFBE.gBDHXGFG.hACAWFFCJAHF...aBBEhAHA...,1,-11,-47,36
bLMEYDUcVBZedHFSQGXANJCWgOIPafRKT,CBGHODAA..IAAGaEHD..KABALDCEEFBB.DEEFVDFFhAAABGDDZFCFeDBDFAGH.hABAGACBACCA.NCAC.JBEDhADA....WBHHfHABRFFH.MAIBhAEAYHAA..hACA...,2,-36,-16,20
NFeSbCYEdfRHOPaGLKTQXJZVcBgWIMDUA,FCECeFHBCBCH.dCGAHFGFOABGGEEC.KGAFQFDAZEAA.BFCChAAAIABFDGABAECCSGGDhAFAEHCG.PBBHhAGATBGH.JDAA..gGBGhAHA.WBFC.MDDGhAIA...,1,-16,-27,11
XRKbDQHLNJUgaCeTIdFYOfWMEBGPAZcSV,SCBGRDECDICCHCAALFBEUFCF.CAGC.TBFC..FHFCOFHBhAAA.MDADEABCBCGEhAAAAGGF..cACDhABAKAEBQFGA..NEDFaDHFeCCE.hACA.IAHB.hABA..YFAB,1,-18,-23,5
cMOVPBGWeFHUXRQgaACIKSYZfbJdNDETL,KHBGSAEHZCFH..JCBHdCAC.DEHFEDDELDCE.OHDChAAABABEeADGFHAEXBGChABAQFAC.aHGChAAACGGGIAHE.fEEETFDDMAIDhAFAVABGWAGB..hBAA...,2,-36,-16,20
GSHWAFdIReBacbCEQXVUZLDPKJTgYNMfO,FFFCRCBBBDHE..aGDBCEFB...QBDGUAFFDFFF.JBHB...hAAATBBA..gGGHhABAMAEEOHFGhAAASFDFADFDdDAG.eACBEGBB.ZEAHKEHBNIBH..hABA......hACA...,1,-20,-36,16
CTJgHRDQLYdOVWMaAFPBSGUIcbeXEKfNZ,FABHBBHFUDBG..bCBFEBGH..KFGAZDGD..CFEH.JADERGBADIEELHAGhAAA..ODABhAAAMDED.ABBGGBDEhABA.eBGDNCAEHGEE.......hACA......hADA...,1,-23,-32,9
cXPNGBgCRJKdVWeLZTOSDYFAHIEUbQfMa,EBAEQFDC.MEBCXCDHGAFECGDFKDBEdACGeFAGLGFAhAAAOFHHSAFFhABADBDAAIFE.HEFCIAHBhAAAUCGFfHBDaBAH.PEAHNCIGBGFH.hACA......hADA...,2,-15,-3,12
IZFKBaDXgRbYTLEfOPHGdNeWJcVUSMAQC,QDCACBACFFCC.KFFEBBHBDCDA.RBFB...TGCCEDCA.OFAFhAAAHFEFdFAG.eCBChAAAJBAEVAFEMDIBAGGEaHEE.hABA....XCGAYADEfFHChABA....hACANIAB...,2,-25,-22,3
VPJTIOScHYLFNQEMCRfWBaDdKgbeGAXZU,UGBCVBDD...TCDCSCGH.HDBDFCBFEAECRFEFBABDDABEKEFDhAAAeCAF.AHAHXGCHhAAAZGEEJAHB..OBFFhAEA..cAGG.NBIGCHHBaBBA...hACA......hADA...,2,-25,-15,10
FTJASQKPgZHIOBCRebWDVNUdYLafEXGcM,SECDKHCGZBGBHEDCOACGRAAG..eFBHDBIHUBFGdBEELDAHhAAAaHFA.EGHHGBADhAAAMAEEFDCCAEHDQGADhABA.IEDACGGF...bFFA..hAGA......hAHA...,2,-19,-6,13
EgWBQKRGTNVFDaIXdUcMbPACSJHLefZOY,SHGALFCGZBEGODHFEADEBHHH.KHACTFCG.VEEEhAAADBAHaBCD..IAHDhABAdHEFMCBFACAFCBFAHDFAhAAAfBDH.WDEC...GBBAhACA.FEAH...hABA...,1,-5,-28,23
YLPIbQKERDFUeVAfJOgWaZdTBGSHXCcMN,OEBEaEAHZADH.BGDBGGEHHBEC..XDGACBBFMFAH..LBHBhAAAIBABKHFGDEFBFCCBhABAeFCHAFHH..fFFAhACAJBFEdDBF.SADA...hAAA......hABA...,1,-22,-23,1
ETLZKNQSHDXaMAcWUfbJIOeRBgCGdFPVY,UFAEJHCA.eEEDREBCBFGEGAAE..FCEEVADH..EBAGTAGAhAAALBHF.ZCAENDGC.hACAHACCDIAC..MDIBhADAAHHF..fHADIHDCCHHD....hAFAdEEA.KAFC...hAGA...,1,-14,-17,3
cQaBHNLfDURbOVFAPgKWIGSeYECTMXJdZ,KBFBGDBAeBABEADE.MAIHdCCGQFGH.BBHALAGHhAAADFFFUFADbFECFBBBAHEF.hAAAgDEDSADAhABACHHGXGCDJEDB...aBEE.fFAGhABAOHAC...hACA...,2,-28,3,31
TWebIXBLHgaGYDOJFdQUVfPZRcKMNCEAS,TADBeAAA..IDGGBHCGHGDA.aABHDFFBFBGAQEBGhAAA.UAFCVDCAfGHGhABARFGDMCAFCCFASDGAhAAAXBCDLHBGYGAEOAHFhAEA......hBEA...,1,-5,-21,16
VgOeYQRLXCZfBNAbKGaUSPDWJdETcIMHF,GDBASHBEDCBCdGEEECAF....IAAHFBEEOEEC.eAAAhAAARFDCCCEFZAGBBHDFAHIBaAFFhACAUGGD...JFAHTEAChADAMAEC.HDCE.YFHDLDDC.hAEANAIA...KHEA..hBCA...,2,-12,-11,1
KDVAXcWdaeBLGgJROPSYUQZNTfEHIbMCF,XBEDdFEDaHEG.LDHHGBAGRGAG..OEFB..YDDDhAAAQCBE.TAAChAAAfAEAIHHChACAMAIDFBGGKACFAAHAeADCBCFA.gECAhADASAGBNICH.EHGACEGE..hABA.DEAH.,1,5,-21,26
ZagdEBFcGSbRDAVYMTOJPHQCINWefULXK,VFGHMIEE..OFBBHBFCCAAH....IGEBeEAH.LAAChAEAKDEHaDDBdACDFECGGAGGhAFARGBCADAH.TBBDhAGA.JFFCNCCC..fAFFUBEC.XGEDhAAA....hADA...,2,-20,-6,14
MJKCADVTLEbXPdQUGSRFWeacZOBgYHfIN,TFDFLABH.EDDF..XCDCdHBHUAEDRABAeBHBZEFGBGHFHFABhAAA.IGGDJAHFABBF.hAAADCEA...PBABhABASGDBaHFCgDFANDACKCFD.CAFC..hADA......hAFA...,1,6,-29,35
bBTVfDEPWOKgAMCSYXJINUQdRZLeacFHG,SBBBXEFF..JEHBUEBD.dFHGRAADLBEEeAHBFCEHHGAGhAAABHDG..VFAEDEADPEFFhABAKEDBADDF.CHEG.IACDhAAAQADDaFFH.......hAEA......hAFA...,1,-9,-29,20
COeXMAQVSEgIJDRBaUGFWdcKTNZLHbPYf,SCAHEADC..gFBDJEHDBHDFUDEHFEHFdGFE.KEDGZFABhAAALAGHHADA.bBAGhAAAfABG.hABAOFFBMIAEAHHCIAHGDDDAaDAE...WDCHhACA.....hACA...,2,-22,-18,4
cfWaSXgUKVZIRBPGHJANOeQMbYFLDdETC,eCEDQEBFMICGFGAHLCEB.DBDGEFBECAGE....fDGBhAAAaGHFXAEBKFADZABFhADAIABBRGBABHFAPCCFhAAAJFHDAEGH...OBGH....hADA...dFGG.WCHBhAHA..,1,-9,-24,15
TCSbOQDUYgGALBaFfMPdVIJKNEeXcZWRH,BGEGaCAH.FFGEMAIDdDBA...JDCBKAEH..eABEZAGBHACF.hAAACFEB.bGFCDGBBUEGG.hAAA..GBDHAICCLEDChABAfHAF.IEEENCACEABF..hAEA......hAFA...,2,-30,-22,8
BMUdHaRGFgAcLNKVbZOeJYDPCfSITQEWX,LEECKEEGZBBA.OGBGeGEGDDHH..fBAA.TGGChAAAEACABAHA.dGBFhAAAaBHFFBFFACCG..cCDGhABANCIG..JCAFCHDGIAFA.QDAAhACA.WFFDhADA..MFAF,1,-32,-34,2
AMWcLdRfgEDZTaNQVGHeXYOCBJUPFISKb,MDBDLAACdHEBRDCEEBFC.DHGEZADF..aECHQEGG.HAFDhAAAXDFCCABABHHFJBDDhAEAFHAGSHCChAFAACCA.fGAETFCHNBAE.eBBF...hABA..OHDE.hAFAIFGH.,1,-5,-17,12
VWLEfKYBSXRZaOdFcQPMCIbGNTJAeDUgH,UCDEHGFALCFHECGB.KFBDBHHASAAARFDHZBBDdAGFQADFhAAA.MCDFCFAC.hAAAIDHENCIC.AEAGDICEhABA..gGFHfAHAaABB.FFBDhADA......hAEA...,2,-27,-10,17
LKgBCQWIHGZTUJEXYbNDOSdeAcFPRMfaV,FFEARADCMDEC..aCAHLAABKHBG.BHGEQFBHHEEDTGCChACAUCCB..EBFDXEGFhADA..bGEE.hAEADGIF.SABFADCDfAHECAGC.WCCBhAGA..ZDFA.JAHB.hAIA...,1,-13,-26,13
GCLMcSTeVFOIYdKfgAWEBJDQXRNbHZPUa,EABBJBFF.DGCBRFGD..HBCFZEEFUEGBGCAGLCDA..SAGEhAAAeAFEFCAHOEAEhAAAIHDA.KEEFAHDHBHHDhACANABD...aHECCHBHMBHD....hBAA......hBBA...,1,-22,-24,2
VXcETedDCAZbgFNUBfOMPGQRYLJKaSWIH,ZABDFBADBGBAMEDEGGAFRBFC..LCDDKHGC.aFABIBGEhAAAHFEH...XFDEhABAEGHHdAEHACCD..NDDDOEAEhAEAQDGA..SAGEhAFAWAAE......hBAA...,2,-26,-19,7
PCGdEVJBWXcKOYMTDRbgfLSIAQeHaZNFU,HFEGaHGGZFBGFBCE.CAGBGEACECFB..BEHH..XBAFhAAAKAHHMAEADDFCRCBF...gAEBhABASHDEADDCNEEBhACAUABD.dEDFJHCE..cBFAOHFE.hAAA......hACA...,1,-7,-26,19
KEQPFGcTOMbLBeSVfdNDaXZAYCgRHIWUJ,CEACHEAHUAAAECDD.QGFDFFFG.GCGGOBFELABDhAAABDFB.SADBhAFAdGBEDDDBZEDBAGIHRFCB.IAHEhAGAKGAF......TADEbCEH.eHDAhADA.....hBAAfHGH.,2,-37,18,55
gXLYdfWaUHFQReJbVITcMZEOPSNGDACKB,KBBDXBABdGGH..aGADHACB.FGCHRAEA.eDED..VGCETDFFhAAAZCDG.OEHF.hAAASBHFGCGEADAHCEEFhABALFAE.fHGBQACAIHAEhABA.MEAEhACA...,2,-20,-14,6
HYdBESJILQMfRNCGeKZOVaPgDXcAUWFTb,UFGEFHGCHBBGBAABEEFE..JCFGQFBG.RAEA.CEEHKDBDOEAHhAAA.aEHFDCBEAICA..hACATEDDdGABLHBGhADAMACG.GADDeGDA.......hABA......hAHA...,2,-44,-2,42
cgILNFDSKZBGYJfRUWbVCHOPdQMeAEXaT,EEHFTADC..IACAFHDCDBCB..ZCFEBBAFGEGAJFAEUCEChAAA..VDCFCBHDOFFFhABAdGAFeFFD.AHBBXAFBhAAAaAFG.LCAFNIBFKCDD..fGDDhAEA...hABA...,2,-30,-8,22
UVDfAIaZYSdgPHMQWROTXGLEKFBJCbeNc,aFFGZCFGdFBFHCCGMCCAQFBA.OAADTFGDLAGFhAAAKADGBAHACAEEeHEGUGAFDABHhAAAIGHB.SDADhACAgGEG..PAHD..WDAAhACA.XAFFhADA.EEEB.,1,4,-32,36
VfUeaMNQgLbODZcBTSAEPIXJYGdFKWRHC,EDDCXBBFGCFGFDABKHGE.HBBE.CFCF.UFDH.aGGGMIDEQCEDhAAALAECDCGGBGBGhAAAAECF.PCABJFBFdAGHhABA..WAHH.fEHANIDHOACA..hABA......hACA...,1,-15,-16,1
TPKSWYcIENDXFCOeAUfgJRBLbaHMGQVdZ,UDCAJFEABCAFLBAG.HAFHQAEEVEGD.dBHAZDAHKDBB.hAAA.SCHBhABA..cFDCIHDChACAEAAADIFCXFDECDDHACCC.fHADhADA..gGBDhAAAaAEB.MEIF,1,-12,-33,21
gZAGRfBdbNLXYeCIJDPEKHSMaVUTFWOQc,GCEHRDBGdGCBLFAHeDAECFHE.DBBCKAGG.HFADMFHBUFED.FABFQAGAhAAA.ZAEBhABABHHGXCFHIBEHhAAAECAC.aHCC..WFFD.....hADA......hAEA...,2,-21,-14,7
CVdEBKbLNUJWSRHAYceagQIMDTPGOZfFX,eDBAQAABMFBFDCGHGBEG.ODCHFBAECADH.dFGABGGFLDABhABAUFCG.JHAA.SAEEhADAAHFD..aAGGhAAAIHEG..ZCGDfDDEhAHA.....EDGChAIANAFEWDAF.,2,-38,0,38
WGVaRbgISXNPcYLDUEBJOMeZAQKfFdCTH,KFECdFFHCHABHBFDGBADRBBB....IHBCSEAA.XBEBhAAANIDH..cEAFhAAALDDB.DIFAEGGChABAJBGBMADAAAEC.fAHGWGFA.aBDF.hABA......hACA...,1,-16,-33,17
IdPZEcRHaUXNJWCSgVKLeDMFTBbAQOYfG,QDEDOBAFGCDGdGGFEDBDHCFD.aAEEUABC..XFGEhAAAJHBCCAGF.SHBChABAKGDEDDDDFCGGbFAG.AEHAICCDhACA.PHFCcEAH.RADD...hAAA.....WHFGhAFA..,2,-19,-7,12
SRYIEdFNfOAgKLMPQGJBXCaVUcbHWeDTZ,KGFGMCIBQFACGEDABECA..XDGGCCDCUGGBHAAADECASHAAhAAARGAG.IADBhABAdCGAFAFEfDAGhAAAADCGLFDDaBED.bAGF..TCEAhACAEFEHOBBC...hADA...,1,-7,-13,6
DZcQJIRgTKENCMUebBOdSFWLAHfaPYGVX,HAAAaDGGGDEADFAGZDGB.QGCEJCAB.RCDE.KHCC.EFCECHAHMFFDhAAAUAGCBABG.dGGChAAA.FCDDWDAG.AHHD.hACAPACAXAGD.......hBAA......hBFA...,1,-17,-22,5
VAefONgPcTSFRaMZGDWKHQECIXLdJBYUb,eCCGOFDF....NACF.PDBF..SHGEFACGMBIBDAGHhAAAHECA.CHACLBAHhAAAdGGEBDEF.bBFEAHBFgDFAhABATGDEaGBDWEEEKBBDIHCA.hABA......hAHA...,1,-17,-27,10
HDFbEecZSPgQLROXUCVYBaIdAJKGMfNTW,KACCMEDA..TECCDFFFFBFB..EEHBeECBSCEC.QGAFhAAALHBAXBCHhAAACHDHBCBEaEGHAEAGfHFHhABANAIC.WAHHcAFF.ZEEHgEGAhACA..hADA...,1,-10,-42,32
ATLSJQVFNKegGIWaZUXfMDCdOEcYRPbBH,TFCALBAB.SCCBQCFBFCEGKDEFGBGC.aGGBZFAFhAAA.fBBAhABADGAGOACCEGHD.RADCBDCChACAAEFDNIBD.eFFB.IEHEWEHHMFAGCDADcAGAhADAYEEF...hAEA...,1,-10,-17,7
MSAKfYOLBEdWPeIRTZcGQVbNHaJDUXgFC,KCCGOFECBBFBdAGB..eFEHRADFZCAHGECA.QAABhABAVBGBHABDDGGC..XCEDhAAACHBBAADELAHBEHFG.hABAIEBCbFAG.JEFA......hAFA......hAGA...,2,-26,-4,22
BCZcGMUTLDHIXVNFWAgaEeOPYfdKbRSQJ,aCBEeDEB.OFCF..PABCdBFHRBBEQGAHBBFDCFAC.GGEFhAAA.MADAUFFFhAAADCABIHDD.hABANECEAIFEEDBF.KEGCSBHB.cDEGhABA.....hACA...,2,-39,-11,28
fISAYVPOUDcMHgXKeZCEdRWTQaFJBGLNb,VBBHUGACDDDB.HBFDKEGGZAGD..CABEdFHCRGCG..QEADhAAAFBDFBEAALAHBhAAA..fFEBhABASEEDAEDEOADCMADCXGFDEGHDaGAD.JBBHhBAA......hBFA...,1,-15,-23,8
GXaLCKdNQJSbIRZTBYcHWEADMUPFgVOef,MEHBUGDGFEBF..OAGFeHFEGACALCCF.CAAAdDDHJEFA.SGAEhAAARAEEZAAD.BBDBhACAHGAEAAIFDAEA.VGDAhADA..aAGANCIC........hAAA......hAEA...,2,-21,-16,5
XJgcHeSKTUWCGMZRYANbIFVBPQfLaEdOD,..IHEABFGFQDACLBDFECGEdDGDDBCD..JFBDHAGFhAAASEFDTFCGCBADMADGhAAA.ZCADAAEHFDEFfEGDhABAXGAC.gAEHKAGGWFCH.YFHBhABA.NIBB..hACA...,2,-26,-12,14
fGCSFKOgZBMVEYJHIdaAbLeXNTPWRUcQD,LBDEeDCF.XEGBPDAH..RDFDUAABQEEG.DDFAhAAAfBDDCECCKHAGOGAAhABAZGAGMDIB.EHGAhABAYABBIHEAAGIHNAEBTEDH.WBGBhADASGGD.FDAHhADA...,2,-24,-2,22
BAJPYacLEUHVDFZMRfKWgCNGdXQTOIbeS,JAHHaAGDLACHHDEBDACB.ZCFE..MDAGRFFAKAEC..CBFDGGAHhAAAQGBCOEBGeEEAAIHA.hABAPABBEHEA..UEGChADA.FEAHfECG.NIEF...hAAA......hAIA...,1,-11,-13,2
IRYAQVdDPBMgWHLXOKZfESbFGUNTJcCea,VFAEdAAFBHGF.MHCAHDDD.LABBKEABZECC.EAFD.FFHBUCDDhADAJFFF...CAGD.IADGhAAAAAEA.DBIH..hAGAgDGGXDFBSHBA.hAHA.NIAH..eAHHaAHB.hBAA...,1,-16,-35,19
aBeLKDbORFTPJSgfCGVEQHcAdIWZXNUYM,dBCAZDFEUCADMAAABHBCLAGF..DGDFOHBARCFC..TFGHhAEASHFC.CBEH.hAAAEFAHQEBFhABAAEEA.XDDBNBEDeHEEbECCFFGCJABG...hAFAfAHA.hAGA...,2,-30,-12,18
GLOCecKRQHUBdNAVFIEaMTbfWZSXPJDYg,VDAEEGGD..aGEDMDFE..TABE..fABChAAASDGAJHAEgECBhAAALADACEDAKAGHQFGGhABAUGAFdAEAAHDHbFEHXDAHDGCAOCCGcCDChABABAHG.....hADA...,1,-3,-13,10
dKEfAQUTLOFgcWDIHaZJBNRYMXPVSbCGe,TFEBFDAH....gABBDDBCHCFAaBCCBHDGRGBG..XAFAhAAASEEC.bDGDhAAACHHAeEAH.EEDFfFDEhADAABAH.UBGDcGFEIGAFhAEA...ZGFA.NECC.hAFAMADC.,2,-19,-12,7
EXaJTbgdHWYQGMcSeDOAKULBVICFfPZRN,KEBFBBDHCCDE.FGFDZFFCREGB....EGBDJAEE....TBAAdHDHHDFEhAAAQDDHMABG.hAIASAGCDGCCACCD.hBAALBFA.IHDAfBHEPDBFhAAA.NDAGaDGG..hABA...,2,-40,-23,17
UAMSCbIZcYQRVDNPBFKLeEfdHaJXOWTGg,SEHFCGEBZEAC.QFCDDAACBHFHKBBDLBFC.EEAFHBEFhADAXGADODHDGAADhAAAACDF.ICDAhABARGAG.NIDBFDED.dDAB.aGGETAGE.hADAMEBC.cGGFhAEA...,1,16,-43,59
BeZGQWgUEdILfCVDMaHNKRJXAcFPYbOTS,FEEE..PAAHOAAABHHCZCCEGEAA.QFGDhAEAgBGCEAFEIEEDhABALBBACCDFDFAAaCHDKGCHJGAEADBAhACA.....YGEE.TAEEhADA.SDHBhAEA..,1,-17,-23,6
WUMVIHXLcCANgdaDZQOFPbJETRKYBeGSf,dDBDaGFGZCCBOCHB.FEDEJAAD..RAEGBABCeBHH..GGAB.hAAASCEHfGEChADAMFIDHGAALAEChAAAAGGENCBH.DBGF.PDAFEGHF.KHFG...hAEA......hAGA...,2,-28,-7,21
NXPWEUQSFfHcKCeJObTBARLVZMDYgIaGd,RFCDVBDBDABB......IDDCaCAHdGCA..XFGEEHGGSBHDhAAAFEFGHAFECAEC.eHFGhAAAOFFEBBBCLCFHhACAMCCH.GDAAWFAD.fACChAGAKCHH......hAHA...,2,-27,-8,19
PVbUGSaBCOZYRAEWKFgcHJTQNDeXdMLIf,KEBEFCCBHAAAQEEEeAFEdHEDLHDE..fEEBhAAAVADFGAGGBHHCCBBAZFAGAFDGEAEDhACA....WBAFhAAAJCHBNGBFMEID..PDAH.SDEEhADA....hAIA...,1,-11,-14,3
TJAPbcKadMHBYCZVQURGOeWXfEFIDSgNL,...bGECKBED.aGDBdCGCHCGHBFFDZAADQBDDUGAAGEFCeBBBhAAA...XFBHhABAfAFHIDAHhACASDCFLAHBAHHHMEIBCEDE....OFABhADAEACCFDEDDGID..hAEA...,1,-6,-10,4
AKgfFPHXRGSQdMWcEOBVNZJYIUDeabCTL,KEDHFECGHBDAGEAASFGBdADD.MCBHEHCEOBBD.BDGHhAAANBIGZAAE..IGGDhABAeHAECAFFAGIF.fGDGhAAAPAHF.XGEBWFHB....hABA......hACA...,2,-30,-20,10
FVENgYKBMbcAaOeDCdXIWPZTUJGfSHLRQ,aEDFDAFFCAGF..dGGD...XFBGIEEGZCAEUGGGGAGEHCAChAAALACAREAH.FDFHhAAAEHCGNIED.KCGABBAE.hABAMIAAAGCE.eDHHTGEGSGDAQACEhACA.....hABA...,1,-6,-19,13
bFcUefICJAgHOLDXYEQZGRMWPaTVNSdBK,OFCHXGCC..ECEHQDDGREFF.MIFAaAEC..VCADhAAAdBEDBBABKAHH.bAGDFACDhABAUFFBeFADCACAAEGCLEHBhACADAAGZEAB...PHDC....hAFA......hAGA...,1,-11,-13,2
BeYLXWHOEJUVNPZcAGDdfKSMbaCQRIFTg,dCDGKBGHMBFHCCHB..QGBERECH.FHEGBBBCLAABHFAFOHEEhAAAEDHD.JFHFNFBB.hACAZACDGAEFDBEH.SFGBhADAIGEDeBADWFAD.....hAEA......hAFA...,2,-21,-21,0
IQZgGdKTYMUHcCDbSJVEXBLNWfeAORPFa,RCCAFDAHQBFAZDGDdDEB.KFBBMBDH.HGCGDEFA..SFHBhAAAEAGGBABDLFCChAAA..NADBfBAHhABAAACG.PEEHaGBHIHHETGFF..hAEA......hAFA...,1,-19,-25,6
TKGDbCVdQgNJSRIUaAPcHeELOFZMWBfYX,HECBEBDCLDAEFAHHZCAFBHGE..XFCFTAEG.DIEACHEA.VBFHhAAAdEEF...NHEB.SABEhAAARFAF.aEHBhAEAABAHeFFCMIAEfCCAKAGE...hABA......hACA...,1,-17,-19,2
LSVPCdMTJFYWEBIUgcODGabfAZNHeRXKQ,ZCFBeFGBKHDAQEADLBHB...SBDDCGHDdBBF.MHDEhAAATEAHFGBHEDEFBFDHgAEGhABADAAHGCABaAHFhACAAHAGHAEDXDGB.PBBD...hABA......hACA...,2,-24,6,30
aedHYEGMfZbWRQFPJTOLNAXBUVIKCcDSg,BDFHUBDHKBGBCHGF..DGBD..SAGEeEACdAAGHBDEEGDBGEABhAAAZFDDRDGF.FCAH.JFFHTAGChACA..NEEH.AFIB.hADA.XBBH..IHHB.hAEA..aBBF.MABAhAFA.fGBE.,1,-18,-19,1
YHgAJeLZPTGENaQKOMXcDdIRbWfBUSCFV,LHEEZDEGGAAGEBCAaGDFKAAE...MDACDAEBdGGH.RAFA.bBEHBDCHhAAA.CHCC.FCHHHFADhACAJAFA..eEAG.PFFEhADA..........hAEA......hAIA...,1,-22,-27,5
bZUFOLRDASQPCGBIefENHMVgdYWTacKJX,SCBCCADDBEDF.eBGHEGBDHBAA.MEIBdFBATDDB.hAAAKGFGXGDBZABAOCAHhAAARBFCDGAFAIDGQEGAhACA..IGGDfFDGgEAEhABAaHAC.cCEHhACA...,1,-6,-36,30
ILPgcGRKVbFaTJQAfCMDeBNEYWSHXOdZU,CHADDDBBBFHBEDDC....SCFHHBDGOHCCZBCEUFGFLGBEhAAA...PCAHhABAcAADKBBC.FDDBJBHDAEFGeAGBhACA..NAEFXGBDIHGG...hADA......hAEA...,1,-23,-30,7
EMGReUXcgWfYPKHISNdaZFTOCJbBVLDQA,MBAFRAACeEDAUBEE..XBDH..gGGF.hAAA.fHFBhABAKDCAIFAESDGHhADAdBHGFGEDOEFGCGDDBFABDCCBACCBEGCCcAGA.YFBBhAEAPAAGaHAC.hAFA...,1,-19,-35,16
VGeBHOZfCaDbYPIEKNJRdLTSgMQcWUXAF,FACCeCFGOCDCCCED..DABF....bBFEIAFA.KGFDhAAAJDCFREBD.TEFF.hACAMAADQEFFhADAUGAHABGGBAEEfHADPFEBNBDCSEADhAEA.....hABA..WEHH,2,-31,-25,6
fEZKBaXeFODQRUITMJcSNAbdHgLPYGCVW,dHDHHEEDLBEHGADCCGCH..VBCFEDBBKCGEBEAGeCCBDDGEUGADhAAAMIFC....SBAFhAAAABGF.PFAFhABAfFFHaAFGFGGEOABGIEHH..hACA......hADA...,2,-37,-4,33
PODfJbcXQGBdREYFCaMHTWUZIKSeNLgAV,VFACOAEG.DFCG..JCDD..XFFCBAACRADE.FDAG.MCEGhAAAHFFG.UCAEKCHHeHBAhABALHAAACCC.fHEFhACAbDDA..cABGdEGBCFEC..aAFAWHFAhAIA.SGBChBAA..,2,-21,-18,3
GeQcZdUBDILbaFKXNfCWSJHYEPMRVOTgA,eDFDZGBEUBEGDGABLCHDFACD..KECBXCAE.CBFB.SCGEhAAAHABC.EEFAhABAMIBARCAD.OFAAhAAAAAIB.cFCDBAGBbFGDNAED....fGHAhABA...hACA...,1,-10,-37,27
FeINCPgHWcZKSdGURBQMaLDfObATJVEXY,TBCEVFEE..EDEEFGFC...eABCCEACHFCBZBFEdDGAGBGCUFBAhAAAQBBBMFAHDDIHODEBhABAAFCFJFAD..IHHEhAAA.NACF.PAEC....hAHA......hAIA...,2,-16,-8,8
bdgcaYCKQZAUMOPLWNIHDSfFeTJGBXRVE,MFBGOFEDLGAA..IFCCSCACFABFeDAEJBDGBHGDhAAAXBEH.EGAGhAAAbEGFdGGGaFFBKDHDAABH.PAHFhADA..NDDFDFIF.fDAAhACA......hADA...,2,-30,-17,13
OLUWJBRZCTHYbSDdFcXEPeGfaMQKNVAgI,OADHUECHBBEARDEBZAEAHFGF...SGCHDGHHdBBEFGCBEAAD.hAAAGCBDMFAGKGAFAEIDLFABhABA.JACGCGEG.hABA..TAGA.bFED.....hACA......hAFA...,2,-40,-2,38
GRXPIZFSBaAWbKOeYdDCcMgfQVTENLUHJ,KHAEeBDGdFCBCDFC...MEBGQDAH.EFAFLBFGHDGDJHAGhAAAXABEZDCBBEEDAGHBODGBhAAADACG.fCABhABATBBD.NEIE...UGGF..PHDChACA.IFAAhAEAaBAB..,2,-23,-10,13
cRgYUAFdBSbKQDTZEVWfMXHILCPeaNGOJ,BCEBKCGHQCCFDCIHZCAE..EEEH..fFDGMBHH.IAHHhAAALGAAPGFChABAaAAEOGEE.JEBEhAAAcFBH.YADAABGHSAFCTEEFhACAWHFACGADNCIC....hABA...,2,-38,-10,28
SKRgDcPMNVZOTbWUaLXEYBIefCAHJQdFG,JDBAdEBFFEEHGABDRCDG..DICAMFID.ZGEEOGFC..TBFFhAAAUABFLAFGhAAA..YFAAhABABGCFeDHHAEAESFECKCAF...PHAEhACA.....hACA...,1,-18,-34,16
gGecJbORZfQXALBKdMNFCVDaIWUHYESPT,LDFEdCGFMAEDFBCFVBAH..DEEF..aFCFUFGCHEFG.SGEEhAAA.TAFEhABAGBACeEABcGBHhAAAOHAE..fGECAAHCKDDBIHHDhACAWAFCEFCD....hABA...,1,4,-42,46
LMEaWHRINBJASGCcXYTDVedUbOZfPgQKF,CGFAXFEGDEBE.dBCEUGBCZBFH......PHAAKBFBMFFGhAAAaBAF.HABA..NAICAFHDhAAASBHB.hABA.YFAEeDDEfHDBFCEHLAEEhACAEBADIHHEBDAD.hADA...,2,-35,-16,19
PXfcbSBHMOKNTLFIeGQJdDWgUYCRVEaAZ,ZDFAXFFF..fGDDSBHHBACAMEBHKBHDLBCHhAAAFCCFGCAAJFCDDAFD.hAAA.gEEGhABACBAGECFHaFHDACCBPAFF....cGECOFAHhACA.IHHA.hABA...,1,-14,-28,14
DIMXegaHFCNSRKBbZWEOLdAVfTGJcPQUY,TGDCGBCBJBHH..QBECDBBC.XDAEaGGFHGAENEEF.hAAASDAFBCHFbCCF.hABAZEFA.EDDBdGHAAGEC.fAGHhACA.cGAH...YFFEhADAIHEAeFAGhAEACFBEWAAC.,1,9,-34,43
KBQWdOGXAPHaZIYUfSTMNcgCVJFbEeRLD,HGCGZDAFUDECSCFF.MDCDNHEH.CDGBFFGCEFCG..LAAChAEADCAGKADDBFAAQAGEhAFAODDBADHH..aBBCfAADhACA.cAFF....hAEA......hAHAgGAG.,1,-18,-24,6
fUIHMLKBRZAJQPgTEOGeNVDSWCXbcFaYd,JFCBQDCH..TBCHEGFCOBGDeEFE.DFAH..SCAGhAAACBEHXGCFbBFCaABGhAAA.dAEF..IHHChABALFFEKFAB.BFFDABIF.PAFANDBG.hAHAWHDAFBCB...fABAhADA,2,-22,-18,4
YcDNKUeVIdGgSBfHZaAWTLCEROPXJQbFM,TFGELDCH.CBAHRCFHOECF..JDHDQEEF.FEAHhAAAMHAEDBBGKADEeAEDICGDhABAdAGFSDAHhAAAfCEEaFFHAIGEWBHBXABF..YHAAhACANEEA...hAFA...,1,-19,-27,8
aYVEPQcNODGgJAdHRILbBTMfUSKWCFXeZ,RFBGLGBABBCA.MAACSAGBKBCH.FBEEeCEG.ZEEFVFGDhAAAQAGA.NIDH.hAEADBBF.JDEAAFAG.dEBB.hAFA............hAGA......hBAA...,2,-42,-30,12
bQZNETBWfDVgAJLUOPYIceSRKGaMXHCdF,LFFCUGFHOBEF..IHGDeADCKAADMCDEHDCBdHDF.FAEAhAAAQCGDEHAE.hABABAHGDEBAAGGEPDAFhABASDFEaGCCCEGHNIABfACB.gEDFhAHA...hACAcBBHXCBF,2,-23,-1,22
UTWJfEHgBCNOPXcbdFDaZRYSeLKVGIQAM,UGAATBCG..JCDEEAGABBCF..NEDB...OEFH..hAAAcFFDFEHFDABGaFBBZEBAhAEASEAC.hAFALACC.VFCGIHHGMIFA.fHCBhAGACAAD.bAEAhAIA..YCHH,2,-50,-5,45
LXCDgFAGHYPeKWTaNdcOEfISMRZBVbJUQ,HECEeEBFKBCBTGEFdAGD.EAAG..SEDDMAFBBDBG.bACDQGEHhAAA.CAEDFDAGhABAADHCPHBEaCGAOEEChACAIEGB.........hADA......hAFA...,1,-13,-26,13
SVTOHRMfAdUZaDCGEPFNKgYBbIXcJWLQe,ZAADCECDGBAEFFDAKCFBBDEH....XEAEJFGHLACC.hAAAQBGFSAHFhADAOHAEHGFEMDHFhAEAdGDDaAABPCCA.NIBF......bGAChAFAIGAE.cEGFhAGA.,1,-12,-37,25
bLEQWIYAafNdDJcGOVRUHXFePBTgSZMKC,aFGBdCDFDHFGGAGCRABC.HBCDFDFD.BFCG.SBAHMBID.KEEEhAAACHBALCADEGAG.hABAQFBHIEACAEIFhACAJAGH..cGDDOEDF.....hADAXFGA..hAAA...,1,-7,-34,27
DdGALRHWNXCZgPFMaKUOJQTSIebcYVfBE,LCABRDAHHACF.XECACGCHZFEAFCGG..KHDEODECQGAEhAAA.SCHFhABAIHAHeAECbADB..VFFEhACABBABDAGFAIEAWFFE......hAAA....gBBBhAHA,1,-6,-35,29
TIUVeJWcPCMREDfdYXaSOBLZANGgbKQFH,GECHKFAHFDFDHFCBUAGBeBBG..JAAB..PHAGMAFBECDBhAAADEIFdCAE..aFHHSHGAhAAAODBFBAHFhACAADDHNABB....bCEE...TGEA.hADA......hAEA...,1,-7,-33,26
GTgIcUabXQJWPKAeEDfVLCdSFBMHZORNY,EDBAVEDBdGDH.BAHHHBCEZBCCRBFF..GEAG..ICGBhAAAaAAHXGGGJEAF.PCHDhABAKGGHAIDC..DEGACAEBSDAEhACAFADG..MFEC....hABA......hACA...,2,-38,0,38
RCeHTfIBWEaJMcbFQNUOXYVSZgdPLGKDA,CEBGHCBB.TAECBEGDaCEEMIFE..FGBCUFGF.OBHH.hAAAXABGSCDChABAgFDGdEHEPFFBhACALHAADIBGeADCIEEHEAGCJBBHcEAChAAANEEC......hACA...,2,-23,-8,15
afbXScMLFWeAGONEdHYJPIRTUgQBCVZDK,OFFFEBCDHFAD.JHEARCGDUFDA.BFBGCAHCDCFF..KDCA..fECDhAAASGADMGFChABALCCEFADCADHBdEGDhACAIABG.TAFFQGCA..hAFAaAAH.....hAGA...,2,-31,-20,11
FXKCVaLQPbOBNIGcMJYgTESeHRdDWfAZU,ZAGBFGCFKCFDaFHB.LBHF..PDDFBADCGBADMECDJABF.hAAA.TGGG.SGAFhABARAEDdGAGDIECAAABCEGD.hACAbACFOEBC.IDDCgFEHeAEAhAFA..WBHH..hAGA...,2,-24,-13,11
UKDMLJFHEcGXCgAIYWePBabQZTOSdNfRV,..IHBCeBGBaHFGZAGF..OBAEdFFGRCBEKDAFMFFC.LDBFhAAAFAAC.EADBXFCAhACACDDEAFDD...YBFDhADABAFFbFEC.SHACNIEH...hAEA.fEBAhAFADIBG...,2,-31,-14,17
UcEJMFWgXKRNGCbdYDLOPeBfQTSHAVZaI,aDFGUCCD.EHFAFADF....XEGGRGCCCGGGdFAHLBHBOAFGBBAAhAAA.QFBHhABASBBGADIB.ZEECIADGhACAMFIFKBFA.NAAG.YFEDDDDD.fBFGhBAA...hABA...,2,-25,-19,6
TaLcgfQdBKAHSbPNXeZGWUMJRVIDCOFYE,SFGF..PDDDXBABeAHDZAFFUAEHMCAHVDAFhAAADDDACFEG..FBCDEAHDaFFBhABALEBD.fFCGhAAAdHGDAACGNIABJEHDIHEA.OEEGhABA.....hAFA...,1,-12,-20,8
IfJbEPVNHUWZYBCacMRLOeGDAXgTQSKdF,XDGBTACD.KDDCFBFE...JDEDEBEA...VEBFUAAEZAAAhABACFAHMICAOFFCDECBAAEHQAGGhACA.hAEA.IGGHfDAFPCHFNICB..WGEGhADA.BEFCaDGH..hAFALAFC.,1,-2,-26,24
RMQDUAOWCbeNfBXHcVLYaSFZKEdTGgPIJ,OCBDCBDD..eFFEBHAFHGCCLAEEaCGDZEADKHGA.dDGGTBAEhAAAGDDE..IAFAhABAMDIDDDADADAFNAICXAAFhADA..YDDDEFBB...gGGGhACA..hADA...,2,-25,-24,1
LSDTBVdaZRCIJPNEWFbfQgcGAOeXUMHYK,eGEGXADFHCCFLEHDDGDDBAEB.dBEDaHBGCAHG...JEEDECGCFCFEhAAA..QBABhAAAGBBCAAIFMIFCKFFCSGAHhABA.........hABA......hACA...,1,-21,-29,8
QGPBDVTYIJUHMbCLOFfcgKSXNZAaEWdeR,aHCCdDAFeEEGGCDBBBEGDGAA....VECGTGCC..IHHGhAAAUGEGMFBB.CAHHFAAFhACAgACB.hADAXBACNDDFAHGC.EAHBQAFEPDHDJGEGhABA......hAEA...,1,-17,-21,4
GMUNEKgJXDbFQYLVBOSIPcdRWHfTaeAZC,ZCAFGBCGUDEHEABDKDHH..XBGCDGGB.FFGEQGBAhAAALHBCOEED.SAEChAAAIAEDdAHGhABAHDADTABGAEEFCAHEgDGCJFHF...hADA......hAGA...,2,-33,3,36
eHKWCfSNbBDdOLXMaEZRPFVQGYIJUAcgT,TEFEeBCHKEEG..CBBH...SGEABDADDHGGOHBGXGBEhAAAMGAEaDEAZCAD.RAGF.hABAFCFAQAEFhACAGBDEIAHB.ABDD....cAAGhAAAWFGHfECAhADA.NEIA..,2,-28,-21,7
eTMCNfgIcEAbVQUOLYRJDSPXBGWHZaKdF,QCBELBDAREABDHECSACGBCHBHDGFaGDE...FBBDTDGHhAAACDEB...fBEFhABAIAEBADAHbFAGOAAGhAGAPDDA.WAEEKEEDMIEE.NDDC.gGGDhADA..hAIA...,2,-22,-22,0
EFJObQaTUgNSDRHKcMYIVCZeLWGAXBPdf,XBBEdGHCFDEG..JEACQEBH.aAFBUBAC.SFFFhAAADFGCKFEBMHBC.hABAIDAEVAFE.CACFeDEChAAALHDGAIGGBHHEPFABEAGH...TDGChACANIBF.RACF...hAEA...,1,-11,-23,12
DEUNTOICHgPASRLKMXadFZWJfYcQbBGVe,RDFFKHGGMADEdGEBZAEC..JFBG....fCCHQBBCBACFhAAAeHAEDFFAEFHBUGABhABAOBEH..CHDGHCEGhAFAAIAALCAF.XAGA.aDHFFDBHhAGA......hAHA...,1,-12,-29,17
BNJfRHSedbWMVAcEPXFYODLQUgIaGTCKZ,EFDFXDEAFDAG.DGCAUDDB...aAAFCHDABECF..JAHBfBEDhAAAHACCdGFHMAGFhACAAFDC...PFAFhADALACB.gGADIEHG.TGGEhABA.KFFDNIDB.eAFGhAEA.WDHB.,1,-13,-29,16
FNHedgbZKPIXRGAOMEaBTQVUCLJSWDcfY,OFCBMFGHBDFA..TACDQBCBCFHCLGFASHDGhAAADEEG...fBGEhABAYBHD.FEACeCCAhAAAgFDGKEAF.IHBBXFDBAHABECEHhACAaCAF......hADA...,1,-21,-29,8
DVYILWBGCHFANJQSXbaUKgcOPeTZdRMfE,QCFAXAEFUCBGKFEA..OAAA.eFBCZFGDdGCE.RBGDEGEGhAAADAFGIDBChAEABCADCHAGAEEE.JHFE...aCCAhAIAPABEMBIDfHBD...hABA......hAHA...,1,-19,-29,10
PMFREIeZbSBVYQfDCaNLdcgXOKTWUHJAG,GCFAMACGFDCCEHFAZAFDBHCD..QFCCDDDACFHCLDBBdHEHXEFDhAAAOAEEKBBETBDEhABA....WCADhAAAJBHHACBH..PEEHIHHB..SBHHhABA..hACA...,2,-33,-15,18
dQLZUCGgPMDHeFfEVYWXAKSRTBaIJOcNb,RBABaGGBOFHD....bCEHdFCCZBBBUEFDGGBDMADBDEGEHCEGhAAAFBAD..EBGB...hABA.YBHHAAGGKFBCBAHAhAAA.IDDBNAEBCBFC......hABA......hACA...,1,-19,-22,3
RJWTQBDNSdKLEeOVaMAYUCbcIHGXPFZgf,CHEG..bAEFHACF.XEFAZDCCRACB..TFGCDGGFdGBGLCAFhAAAODEA.aHECMBEEAGBE.hABAUBAEIHBHFFCA.hAAAJAHHBEADKDGF.........hACAeFHH....hABA...,2,-21,-5,16
YaBcfKEXDPQgGeCJRSUTMAWFVHNbIOZLd,FBFAVEEBHFFH...IFAALEHBdCDAaABGBHEFKBEFDBGEQCAFhAAAGGADeCBBhAAACEGERFCF...SEABhAEAMCFDABBC.NIDF..ODFGYABC.fHADhAFA.XCGAhAGA,1,-10,-22,12
EaVXAbQHBPNDRIMOWGcFedUCYfgLSKZTJ,QFBDBGAHDFBCRBAC.ODDAGAEC..eFGDCHHF...YBBChAAALHCE.SCGAhAAAKEHBTDAHaEFEACACbAFGhABA....NEAH.MEEDFAGC.dHAH..hACA......hADA...,1,-11,-33,22
gBXSAeERYTfFGcWZQKNMVOHaDLUCbdPJI,eEEEEAHBRDEH...TAFGFAEAGCACZEBHQBCEKHFA.MFADhAAAVABA.HGCGDADCCHHDdDGEhAAAJFFHBDDA.AHHG.fBAAhABA.NCIGOHCE...hABA....aDFA.hAIA...,1,-4,-16,12
cfOCTdHLWRGYZQKPJEgNeXDFSaUIABMbV,MIAGVDGB...OCDECABGHADBRDBD.ZDBBQACA.KEGAPGDGhAAA.EHAGeGEEhAAAFDADUAGCIBAAADFABEEDhACAfAFB.LAHB.YHCChABANIDB.DIGG.hADASEEC.,1,-8,-9,1
IPAGKfOeUEZFSRBXaVTNYdHcgCJMLbQDW,GDEGOCFCUEEFEHFAZAGD.RFAD.BBDH..XBABaHAE.TADFhAAAdDBBHAAG.CFHFMGAEhAAAbFCHDEHH.IDCEhABAAHEFKAFCFGHD.SAHH...hACA......hADA...,1,-12,-24,12
CZcXKPWMDbALOSFTRIYgGUHJVNdfQeaBE,LAFEFGDARDBE...ICCFGBCBHAFGJDEC.dABF.fHGFhAAAeHFAEEADZAAEKEFBMDHBhAEAAEBEOFCH.SEGAhAAATGAC.YEEF...hAFA......hAGA...,2,-18,-17,1
JBbTEegXPQdHcYRZDLFMNOaGIVKCAfWUS,UBEEBBCBEBECeDDB....XFAEdEHCHGEGREEHLBADhAAAMIBEaADBGAACKGHFABHESDDFhABATFAE.PHCEhACAYAFC..DCCF.FDGAICHBhAAACHAA...fECGhACA.,2,-14,-14,0
VXDdZaKPSTLQRYUGHObCfIeNMBJEcgFWA,VCGFXDGC.dGGCaAAD..KBDD..SADALFADQAEFhAAAUGGAOHBGCCBHIABDhADAeEEDBAGBEHDGhAFAFDAFAFEBDDFDPCCCTBGF.....hAAA......hACA...,2,-25,-15,10
TbFEVULJXfeAcKRHZYGPDWdONCBSagMQI,KDCCZDCCGBFGDGCB.dFBFCBDDBCFB..SBDA.aHCChAAAgEGDQGGBhABA.IBBGFFDFVDAFhAAAJAHF.eDAFAABERAGD.PACA..NIDFMADGhAIAEHEE.....hAGA...,2,-38,-8,30
bcLREIQSKGPOUJCYVgNABHFTWeadZXMfD,BECFHEEBFGHFeEHDdADFMBCCDEBDLHBA.RCCD.QAGChAAAGCEFOAADCEAAVGECAAHD.hAAAaDFF.ZBAC.fGBHhABA.EEEFKHFA......hACA......hAGA...,1,-12,-17,5
AEdRfQeTMJDNGbLYaKcSWIHBgUXCPOFZV,EGADdCEFREEH..eDFHJAEE.GCAELHEGaADBKGGG..SABDhAAAIHCA.BADCXDDBhAAACHCFFBHD.AAIHfAFAhABAMDDH.DGCGNCAE.YHEA..hACA......hAFA...,1,-20,-33,13
UPcTNHLBXebAJSRfIDYEGOgMWZCVdKQaF,SFAHRDGDDACHGDCGMECDZAAH...dDFAQBEDFABHUAFD..hADA.TGAALDDDhAAAXAGFADAAIGGAhACAEFFB.OHDCCHHAKEAEcADGNBICBEEF....hBAA......hBGA...,2,-18,-14,4
PbVNJIFKTRfLcAUeGQCEMdWDOHZgYSXaB,eCHFCDDDdDHA.OHAEZFAE...SDAGXACHBHCF..hAAAbDEHJFEHFBFC.RCCDfGAFhAAAABFAUCFEGBAGhABAMAFADIGCHGFC.aACENAEH.IBAA.hACA.KGGEcGDH.hBAA...,1,7,-24,31
XQeLdcBfKWGFMNEITZDbCPSgJAHaVUORY,VDCBOEGF.RDCF.QADFLBDCdCAABAHDKGEHFGDE..EFABTAAEhAAA..DAAACGHBSCHHhACAAIDCaAHH.hADAXGFDfCEDMCGD.IGADhAEA......hAGA...,1,-26,-30,4
UHNGRXJfVKAdbMSBLYcFCgDTPQIEWOZea,MIEGBBEELHEEFAEE.DDGATDBH.QFEBIFAAEHBAhAAAZAAEaGHFHBCDGBGChAAAXEFBJDDCfEAEhABAAGCCdBBC.SGCFCBHAWADE...hABA..eCAC..hACA...,1,-6,-23,17
OAPFDdUSCTLEYHagRbcJZKGfXQMIWVeNB,FBFGDGBBdFFBCDCA.LBBFHEGHRAAC...JAEDKGDFGGEF..fHAHhAAAMBAB..hABAIHCAeEDCBFAGhADAADDHSAGFECGC.aCFEcEAA..hAEAXDGAWFFD..hAAA...,1,-20,-36,16
cEgQbRXdPWJaSYCGMHefBNAIZDOKVTULF,DDBAKAADUGCELGEG.EACBQBGC.RGEE.dBGG.PFAEhAAAaGAH..CBEEMFDAhABAeEFCBEDH.AICCICEBhABAOCBHFCDFbDAC..WAFESAHHhADA.....hACA..YHAE,1,-16,-34,18
MUBKfLEQIFXYVAGSbRcHCedNgPaTDJOWZ,GDDERDDGCBAE.dDHA....PEBFaAFDDBCH.OBADMBHDBGDBhAAAKFGF.LACAhABAEAHDFAEB.XGGBAHCB.hAAASGADcDBD.eCDE.NICB...hADA......hAEA...,2,-27,-27,0
cLMJdFSCBUePKZVAWYbTRgNXfaEDQGIOH,...bFAHgBDE..fFGAEGEFGBBEICGBhAAAHFADLEFAMEIB.hABAdGGAFDCASGCHhAAACFDCBAHHUCAGKAFAAADGYADGNBAGaAHDDEEFcFEBhACA...eFCD.hABA...,2,-2,-2,0
DTJYdNaOXBKRAIPGfbeZHgQUVMcFCEWLS,GBCBeAEFHDFHUBGCMAHHCEHG.LFHDDCAD.TGABJGEC.dDAChAAAOAAC.BEFGhAAARDCHACAGIABC.hACAbFDHgFBB......hADA.cGAC.EDDBhAEASFFDNIED,2,-41,6,47
FbTWaDcMENOfHKBGPdAZXCSQgLRVeJUIY,CECCSEDELDADRFEAeCBH..UAABIGHEFCGE...TGEFhAAAaHAE.DHAGMCDEhABAOCGBKDDE.BFCEdHEHAEFChADAZAFE.gADF...JBAB.hAEA..WHAANBEB..hABA...,2,-26,-23,3
JYcBTFUCbaPOQeGIRXKHAWEDSdZgfVMNL,EBCEDCCFZFGD..VGBCMADFLFFB..JBFHBDFAFAAGUGADhAEAaAEFQBGFhAAA.IFHGXEDDhAFAABBFSCADdFFA.fCCEhABANCBA.cFDFCHDB..hACA...,1,-28,-34,6
IKdHXQEPcfFNRDSZabgBAYUTWLCVeOJMG,UEDHLDADCFBA.VDEC..OBFCGGCDKHGCHABD.XECChAAAEBBC..PHDChAAAfAHC.FBEGhABADEGDSGGBaCACBHBCAAFE..WHAGMAEBhABA.dDHC....hACA...,2,-37,1,38
DWbGCafXUgeELMRKFAVPBZJIQNYSHdcOT,VAEEZDFAJAHD..QEFH..SDAEHDBGdABBOCBGhAAADDDFGGCHaHEGfCHEhAEAXFBGUGGEhAAAEFDHMIACFABEAAGABBECIHHE..NEAE..hAHA......hAIA...,1,-8,-26,18
KGLaMcYfHUSJVDPdQEOWABbTNgFRIZXeC,TCCFFBBFZFEG..eCFHCBBGLGAG.MFHHfAEE.hAAAUGBBSFDBhABADADFdDDCEAGGAEAFNACBRBFH.IEBAhAHAKHEGaFAA...cEEFYBAF..hAAA......hABA...,1,-17,-24,7
TLMAdHeEDSQVbgJCKBaPGRNcZYXIFUWfO,eCAEEEFADBFHQBFA..bBCBCGHEaFDHGEAG.RFGDZAFHIABBhAAAUAAA..OAHFhADAMIBEAHHFdECHVDABJHCG.hAEABHAF.PEEE.NADB.....hAIA......hBAA...,2,-18,-3,15
STePDZGJXWEAVcFHRKCdBfLaIMYbUgONQ,FBBBHBAHKFEFCBHEdDCEBCFDLGAG.MAFDUFAF...OAEEhAAAQGEH.TEGFhAAADIFAZDFE.JCDBECGHhABA.ABGB....cEAHfGGDIEEHhACA.YADHhAGANIABSABE.,2,-47,-1,46
MPaVdfJGELKSRIQBNcOUXTFHDAeCgZWbY,eADBZBCH....bGDGMBFF.VCGBdBHGGAEGKCCB.IBABhAAABGCGOAAB.hABAXGFDFEGEAHAHgEAHhACAPAFA.aHGEEEAH.SEEDhABANGEH......hACA...,2,-28,-11,17
OfEVYTWRKHcLeZbQgAUPNISXGaCdDFBMJ,UBGA..NDBA.XDEGaCDC..CHDDFECFJBAB....OHAChAAAEADG..TABEhAAAKDCDLFHHZFFEQCGBhABAAGFAIGCDSAHFDAGABEAAMFECfHEBhABA...hAFA...,2,-34,-25,9
fCMXZBAgQFVdaHDRYecIPOUGLNSWbETKJ,QDCBdGGBDCCERFBB.eADA...ICGCUBECLBHHhAAA.SHDAhABAbFFAKAABfCAEMADAXDBEhACAAAHAgGBC.FEFCaEFB..YHEChAAA...hAHA..OEAH,1,-2,-34,32
UGWRSVDbEKTagQOCMYLefAXPIcNHZdBFJ,XEBG..IHHGHDEBBBHAFHAAUCECGBCHRABFDFGDKGGEaDHFhAAA.QGABhABAMADELAADeHFGAEGAPDHBhAHANAEDZCAAdGDC..JFBCSABAhACAEDCC..gGDAhAIA.CBGE,1,7,-26,33
LPEeKcGQdODfFJNVRIaXABZWMSbTgHCYU,BGHBZEEESHGC..gAAECEBDUABDLAFFEAFHeDGHhACAGCAHQGDFhADADGBDFHCCVDCC.aCHFAEADMAIFhAAATEAH.YHAAKGEBOAGF..hACA..fADHhAHA..,1,-3,-18,15
GBbPIacfeCMSVLNKOTDYAHEWQdZRFJXUg,EAGCdDEBFBCDUAECBEBB....IGDHaECD.eDCAMACGSDADhAAALCHDKABDhAAATFFFAAGBHFFHZDFERABBXGCAhAHA.........hABA......hADA...,1,-22,-28,6
fdOGeHQTSCJMEIBXDPWAYRagKZULNFVcb,RBCBKAFGLHBAFEHD...VBFB..bCABdGFEGGCDeAAAQEAChAAACHAC.EDHFhABAXCEADEEH.PECAhAAAAIHC..aAFGgADF..hABA......hACA...,1,-10,-38,28
BbDgYHJOXeKdNQUfFSIEWTAcaVMGRPZLC,VAFGMFBCGBAB.ZGFABEEEDEAHHDGHODHFKDDCQFAEhAAA.FCBBSAAChADAICEC.EGBBAFGHaGEHhABAPAHD.CHAGbADEJACGdHGB..fGDEhAEAWDCH....hAFA...,2,-20,-10,10
IaNSdebVTLKZXRDJcQAYEMPFUCBgGHWfO,EEABMFHDFDEABBGD.GCDBHGFCOCHF.aCBFSFBAhAAA.dBBBVECALHAGhABAKACAXGCChAAADAGAcDACAGFEPBEEUGEB.CHACfAGDhABA..eECE..hACA...,1,-1,-22,21
NHBJaIdEQgSDXfVCceALOPTKZUbRWFGMY,LABFTEAG.UBFCRBCHFGCGMEFC.HFGDaFFG.dEDG..ECEFSGAFhAAADAID.fEBGhADACHAGABACOHDEPADFhAFAKAGF..WACENICFBGFG..QGGAhAAA...hAGA..gBAA,1,-15,-18,3
ZNefDOMQdKEPLgRbaAJXCFSTIWHGBUVYc,XBCASADG...TFEAIABCHEAHUGCD.VEFChAAAZCBANCCD.DGHDMCFCdHCDEAGGhAAALFAHRCGHAABHCDFF.GDADhADA.BAHE.......hACA......hAEA...,2,-12,-11,1
OBGgXKVZDUYQMERfAWTcNHbCPLaIdJFSe,TDEAHDADCADGLFGF.dAFAJHAASEEDOADGBFHHGBAFhAAAKBGADGFFQCGDhABAEDCA.fHBDhACAAGGB.NDDC.PBAAIHEGeFBG.XCAGhAAA....hABA...,2,-37,5,42
FNJdaOfcYURXMGEPQCLgbHeKBTWZDIVSA,FFACdFGEaCEFOFDD......fBFDUBACRCEGMEBAEDGGCHBEhAAALFGB.HACFhAAABDBGZAECDEDDIHAHhABAADDEJACG..cAGF...XGEBhABA..PFFHhACA..,1,-10,-46,36
ULObRNYAdGfDQXCaMBSTKeVIZWHEPJcgF,dBEGDECAQEADaEAF.BHBDSGEEKGGA.eCGBZBGBEADEhAAAPABF..JCDAFEEEhAAALFEFOHAARDCFACBHXBBFhABAMFIFTAGE.WADC...hACA......hAFA...,1,-4,-30,26
QZfJAHdXENBSDgbPYCGVWaTLFKURcMeOI,XCCBEFCDBEFFDBGF....PFDHCHHHGCAAaGGA.LAFEhAAAFCGFKAEERDABMABA.eEGFhBAAOCEF.ZAAGACHBNEEEhBBASBHB..YCCCWHFG.hAAA......hABA...,2,-22,-20,2
OMZSEBfUGHVFecDIdaTCYKRQANgPLbXJW,...NBFA.PEFBLHDG..XDCEJFHF.OACGMBHDZEAGhAAASFCBEHAGBAEChABAUBABGCAHVBFFeGCEhACADICGIHGAaABE.CHADKGAEAEED...hAGAWEHB...fBDChAAA,1,-12,-16,4
egKGMSDEOPANYBFWLbTdUIfVCaZXQJHRc,BDGBLCEGdFHEUCCDVGAA.ZBEF..JAAFRFAB...eCDD.KGFChABASGCHDFFE.hACAOAAHPAFAADBFFAHFhABA..bDFE.IEAFCHGGaAFF....hADAXFFC..hACA...,2,-35,-18,17
HUDNCJBdQebMTEVLAXKcSGZgYRFWIPaOf,KACDSEEHGDDDZBECRFAE.FGBG..PHCEOHFG..HCBFhAAADDID.CGGDdBDDQGDAhAAAMCAHEBHFAAHD..XDAGhABAYABE.aDDF...fDFBhAFA.....hADA...,2,-32,-3,29
ODTYbCWMNLHFUERKcJVBeQZAIdSfXPaGg,dEBDXADBaCBA.GGBDDGCH...TABGCHFHMADCLBFHhAAA.FEGDEFDCKDDCJFHBBAGEhABAeCECAEIHSFCChAIA..fABB.OBHDhAAA.WAEA..hAIA...,2,-45,-14,31
RPNVJgdaEeMHAWIOLfYQUFGCDBKXcbTSZ,OEECLEEA.QBBAUAFACGEE.BDFHKCDF...XFGAhAAATEBF.RGBA..PAEChABA..NEAAJAAFaCFAEEAHhACAMIFEAHHH..IECGfDHG.FADFhABADBIFSGDDhACA...,2,-40,-9,31
JGNLQSCeEFKXcgUOPdBIaDZYRVbTHAWMf,MDDDJDFHGBEHLBCA.CFGH.FCBG..KGADXEAAUFEAdCHABEDDhAAADEEA.ZGAC.RFGF.VDABhAAA.....hABA............hACA......hADA...,2,-39,-36,3
QREUAYNdWTGgVBcMDOLJFXaIZbPeHfKCS,dDCCGBFCBFGGDECGLAAFFBAC..XGAAZAFDeBBA.KGEBQADGhAAAREAD.UGGChABANEIG...WDBChACA..gEDHMAFG.aAEFIEHChBCAPHBC.CFEAABIB...hACA...,2,-28,-15,13
MGBQDSPeNFVEcZaJdfULgTOIAKHWXYbRC,HBFHXCAHRAAGMIDGBFCHDFAA..eCCGFFFE.ECFEZCDF.dDAHUFGChAAALGACOHECAHBA.KAGEhABA...bFADCGHH.SEEFhACANAIA.aADA......hBAA......hBBA...,2,-21,-16,5
UPGJbNLcYCXdMeZKfDTBWSVAQgHOIaRFE,QEABOCAAREDH.ECGGUFBCGDFE.JHACLDAG.CABCdBGEhAAAeABFKFADTCCBhAAABFGB.SFDBhABAAIBC.IADEPHEE...cAGFMAIHfBDBhADADGIFWHEA.hAFA...,1,-15,-26,11
QGSfdNcPVRbOHeDKJIXLCMAZYBaUEFTWg,BBEFaGCH.FFDF..TEACQDABGACDdFFE....PEEGhAAARCFGHBAEKFGGIHHAhAAAXBACCGBEAAIDZAGB.hABAYDCHEAFG.SGADfHADNIEH.hABA......hACA...,2,-21,-15,6
XOMWHGDadVIPBfFENeKJYQgRcbAUTZSCL,TDFBSBCE.CFGE.LFCC..MEDCGBBHDDIFaDAEhAAAdBHCPHAGBBHGEFCBKAEGhAAA.QDAGhABARFABADFCXBBCWFHB.IGGCfGHA.eADEhABA.JHDG...hACA...,1,-17,-18,1
GdTHKCgeZNWASUIacXVDLOBPFQYfJbMER,UFCFaEFD...VAGDOGBA.BCHHQGFBJCCG.EAADdABAhAAAHACGCHAAZEAG.AADF.SDDGhABA.IGAAhACADGHFLAEGFDADfDFDMEIB.hAFA......hAGA...,1,-11,-37,26
YIAKTbUZCEcdROBXFQgVLSNWfeDHaPJMG,TBCEUADBECBG..REEDBAEEQAGGLFCB..SHGEhAAANAHC.eFEAaGHHMCAFhAAAGEADAIEEZDADCDHEdBAGhABAXCEAFDEC.gGAAfGBEDBAEhABA......hACA...,2,-17,-4,13
RCZdIcPYTOgDeWQKGaJALbEfNBVHMXFSU,EABBBBCAHGEEMEAGSGAGUDDA.CCACZBECdAFC....PFHBhAAATDBE.DGDBeHCGhABAKEEEaEGDAHAHLBHBhACA...NEGC.FAFC.cEAH...hADA......hAEA...,1,-12,-31,19
MZPYOTfNDbEIBKAaXHgQRFWSVJLecdCUG,HDCHRDBEFFGD.VEGBLBDCdBBEGBECZFAB.OABA..NDAGDGEBhAAAEHBCKGEB..AIGA.aAGAhAAAQDGHSBGGhAFAJABBCEBG.....MDDC....hABA......hADA...,1,-1,-30,29
fAUYILOEXTFJCaSHbGZcPQgRedNBMKVWD,UCGGLCDBEDDH.FAGB.CEBE.SADBHFEAZFAF.QGBGhAAAeAAFdDGCBHCEKFGFDFFDABCF.IBAEhABA.XGDDhACAaDBA...bAFC...PCBFhAGANEIAMAIH.WHEG.fAEGhAAA,2,-24,-17,7
PNIZFgKBeCfbVYSOdHDULJMTXAcWEGRQa,EBFDREEHQBEE..PFHFZFAGFAABKBHBCHEG...VBAFSBHHhACAOABGHEBAhAAAUDCDMCBFAFFFGGBHaGHB.hADAIEGCBHBHfADHdDDBDIAE...hAFA......hAGA...,1,-8,-15,7
WgZfHMTGXFeVcPBKJaNUSdERYLADCbQIO,CFBBQBFG.OCHDZGDAMBBEGEDFXEFAeEBDPACHhAAAKGAG..JDCAaDABUAEGhAAAdHGDEGAD..RAGBAHHFhABAIBAH.fHDBFCAFBDFENIADSCEFhABADFID..hADA...,2,-22,-8,14
HCeYGRTJbgPKZacFEXfMBdUVNQSADIOWL,DBEAOGEAHEED.eHEARBEB..JGAA..gCCEKBAFZCBDFHECEHAGhAAA...MABHBEDDhAAAUCGD.QEAFhACAIAHA.CFCA.TDGB..aEHH..hADAfDAA.hAEA...,1,-9,-41,32
JELVMbKYSRCHfGXBdFUPWDIZeTQcNAagO,.OFDFLDBB.MHEEKDABSAAECAGH.HFGFXAABhADAFDCHUCGDDDGGeFEChAEATAGBNAFC.AGFH..aFACEDDFhAGA..VADD..YHCAfEEBhADA..BBHA..hAIA...,2,-32,-7,25
NJgHCZSMWOLYGRcfFTdQaPIbKVBEeUADX,XCGCJGFCHEBCZAGH..SGFEOAAGLCDEGECCfAGEhAAAdGBC.QBDEhABAIEHHKADGhAFABEHBEGEBAAEADCADCCBD.WBBD.....hAIAYHFA.FEEChACAaEEA..,2,-23,-13,10
bcNdSWaMQRGfgXJIHeZPCBVFAUOLEDKTY,UDCHEEFFDDADKFFD....TCEA..bGBAdEHC.aBGFRBCC.GECEhAAAXDGAHABBeBAChAAACHAEBEBAFAFAAIAG.OEABhABAcGGH..SHGAMAIF.fCGHhACA..hADA...,2,-28,-8,20
PXNFOZecLbaQWBIHMRTfGUgSVJCdDYAEK,EHCAXGFGFFGA.ZFACeACGLCFB.QBBDIDGDHCCFhAAAMACCRCDHTAGC.hAAAfEAE.hABAUBAHSHCGCFEGDFCHAIEGKGGDNBHG....hABA....OEHDhAGA.aEBC,2,-13,-5,8
VDIXSZTNKQfAbGBEJWFOcYdgHMPeCaLUR,GBCBEFBEFHBG.OABGdDDCHAAHeFADLGEERDBFDEFC...IAEFhAAASHGCZAFBKEEChACAACHHBFGH..WAHHhADAYFDE.MBBHCHFD.aBGA....hAAA.XGDENEIC.hBDA...,1,-12,-16,4
AVDWEOBICJGQSXcNbMfHZKFeLPgaRYUdT,DDFAEDGGBBAECCBE.GBDCQFBA..XAFC..hAAAcGACNDCC.MEDAhAAAfDAEHEGFFBEAeHCAhABA.PFGBaBAGYAFC.TDAEhABAAAID.OFFHSACHhACA.,1,-14,-28,14
PTFaQYVZAfOGICNBXHbEJecMSLWUDgdRK,GDAHCDBDBGBHHEDEEFFDeFHB..MBCESCACLCAEDCGGdHEFhAAARGBEKBDBTAGE..hABAaAACQDGBhACAZAFGAFEBfDFBIFAH...XFGAhADA......hAEA...,1,-10,-17,7
ECYMXZKADJUgadfPOQcGeTSWBFbNLIVHR,UGEBaBHF.dDGDOFAGGEAG..SFGDFAAALDAEHACCCFFC.hADAXGBDZAFC.DCAHhAAAJCEBgBBGhABA..fBCHcEDATDGGBHCBIHHHhAEAECEAKGAFAFIB...hACA...,2,-21,-10,11
dcIXJTaCZPLbFASeGgQfBROYMNDKWUHVE,SHBEeAEHQAAGREEH.OEBHMIECDADBKAGDHDFGdFBD.IHHAhACAJBAH.aFDDZAEAhAAALCCFACEAGCEDBCHEhADA.WFFA..EGGG.cCCCCAHE.hAEA......hBAAFEHF..,2,-11,-6,5
DWSegNYLAOcaPKfHCFZVdMTJGRUXQIBbE,aEEAKFABHDDDZCAF.dHCHMCIDGABA.RCGHUAEHQFCD.BABFhAAADGHDSFFDhAAAeAEDNIBDLAGDADBH.PFGDhADACFCFFAHF...TCCC....hAFA......hAIA...,1,-14,-17,3
WcAgHQBaISTdPYNECfbGMODRLeKJFZUXV,HAABaHCC.SAFHdBBE..PCFHECDBCAEGGDFEMIFGOAEBhAAADFIHeECD.FBHFXEGEhABA.WGBEhACAAEHEBFAG.IHAGTAGENADEfHDHhAAALFAF..KGGA..hAFA...,1,-9,-17,8
eBJOHWTVcPgIYdRNFKbXGQZASDCMLEafU,CGCHMAFGLBEH..fBHCBGHDJEAE.OEDDHBBC.TFGBhAAA..VBGBgBAFhABAdAABFGFB.KEAGXGABhADA..ZDFGDFFAECEAaAEAWCCB.hAHAcGBC...hAIA...,2,-22,-10,12
TFeSfJdPINBOXgRKWVCbAYcHZLGMQDUEa,HFAGGECGQGDHDDDAEGFH.aEDAFADFSBADdAFB.PAHBhAAANBGE..BABEgGGDhABAKAADCEEF.AEIBZCCGhACAMCCDeAFB.IEACOEHH.WBBEYCHHhAIA....hBIA...,1,14,-34,48
JRQdZFBTCPfSIXDUgbWeYMaLVAcKNGEHO,KFFGEBDAHCAFRCDCZAGH.FAHBBGHA..CGDHSFFBDDAE.UGAFhAAA..gACEhAAAeCFGMEECLFBDhABAAHHHNACH.GGCDOFHFdEFFfABE.hAEA......hAFA...,2,-29,-7,22
KHTJZdDCNEABaYPFISOVXQbfGWMcRgUeL,aGGFFFGGOBEB..XADDQCADGCBGMGBEREDCeBFGhAAAKHBCHGEEJHBG.DDDHCAHFAABFBAAChACA...IAFGhADASDGC.fGAAWCFA..hACA....cAGDhAEA..,2,-29,-22,7
OLBgNbcaAJFSQTdCMWPUeKIXGDfRHVYEZ,FAHFTCAFCDHH...MIECUAEG.KCCHXCEC.GFAFhAAARGBCHFECEGFGZEBGBEFG.hAAAgAEB.hABAcABFaHFEABDASACFWDHFeHCCDAHB.hBAA.fCGChBBA...,2,-38,2,40
MNTKbaPgABfdScRJeXIOEVZWGDQYCUFLH,dABDSCDDJEFE.eACFOFDCZBFCDDFF..CFADLCFEhAAAMEIFKEGD...aCDBAHEBfCAGhAAARGAC.IAGGhABAEEAE.VEBHWFHH....YFAFhACA.FHGC.hACA...,2,-41,-9,32
gJPHIFSQUVGYZXAfCEOaLeBdTMWKDNRbc,CBFAEEBBLFBEBABEdDHA..MABGKHCCDGGBRCBC......gGGFhAAAPAFFFCDFSCHDhAFA.UGADhAGAGDEAXEEBfAAEeBBC...hAHANDAG...cGDHhAIAIBHA.,1,-7,-49,42
WUEDLFcSgZQdTORHfMVYIeNbGPaXKABJC,CGAEUAGHDBAD.FHDG....SGDEQEFFOCCAHBBHMFIHhAAA..IDBHhAAAbADDGDAAaDFEACIFBHGAhABAEAHFLAFHgFCCdGHG...fDDEhABA...hACAYHAG.,2,-29,-1,28
ceJLdHaXVTZDYCRAbNMfFSOWKBGEQUPIg,MBAHSEABKCCGBFFAQFCH.UAGDIFAD.eCEGhAAAdCDCaFGC.TABChAAADEFECAHCABCG..NIDFfDHGhABAFGHDOHCAEEBEcADA...LEFDhAFA...hABA...,2,-44,-2,42
YATdLXSDORaZIgceQNFGUbVPKHCWEJfBM,dABHSAAAODFFZFBA..IHBGeAEHQAGGFGGCGADFhAAAUCAAVDFG.HDAHhABACHEAEGHBfEDBhADABEEGADCG.XGCFDIAC.aCCA.....hAAA......hACA...,2,-24,4,28
SFRVTLHJeWKMBPAbXEYNIdcQDZaOCGfgU,XFEBEBFD..NAEC.dBEF.DHCEOFFECGHC.GCAEUEAHFDFAhAAATABFLABBHGBAJHEEhAAAKAHFBDEDAHIH..hADAbDFA...IAHB.ZDCHfGAChAEASGAD..hABA...,2,-35,-5,30
fCHQJINbeSRYMLZgDAPaUcVdFGXWETBKO,aCDCVDGFGEBA..XAGHEAGABEEHKFCCCABG.HCCG.JEAFIGHEhAAA.eBDEhACASCBFMADAZDFBAAADUGGFhABA.dADFWHEGfGDCNBIE..hACA......hAGA...,1,-13,-20,7
GHWZVaeTABIfLNPXKMDCdSEFJRQYUObgc,BCCDLDBG.XDGDKGAGMDHF.DEFHCBGAdAEB..FABCQGDDhAAAOAEC.gFBChABAGEABZGDAaBBAAEGF.hAAA..IHHC.NAICSEFDhACA.....hADA...,2,-47,-10,37
PFZLaUeMVHTEJSRGWQgbNCOABKfXdIYDc,BAFCXDGDdEDEDAAEFAGA.LHEA..eEBDMGFAVFEBHBCGhADAEADERBGF.GDCH.hAEAQAAHNDBG.hAHAAHIBICFHcDFH.ZCAG..aGBD..hAIA......hBAA...,2,-25,-1,24
JFKWbHTCREaPUQBNSgdeAIcDXGfYMOLZV,DFFHGAEEMABCZEGD.JEBEKAHH.HDBERABF.EAEAUGBD.BAGDSHCAhAAA.eHFChAHAACIHXGEHOBFDFBBChBAA.TFCECCGH..aBABPCHH..hBDANEAC......hCAA...,1,-12,-29,17
KEPNDcBAMVXZTUebGOILfCJQWSdHFagRY,VADGXEBH.ZACBeFDHGGEBLCBHCBFC.JHFGQDFDhAAA.dAGEaEDGRBAF.EHAAhAAADICCABBCUDGC.IAHBhABA.SCADgEDDKFFDNAIEMFADhABA....hACA...,1,-11,-13,2
PaLRSZTUKNcDXWCdMgJOIFGbABYQHEfeV,BFCEQDGAHAEDEFFDeDAA..aEAGSFCEUAAD.KHCANHBB.hABADAAE.CAFH.MDACJFAHOFFChADAFAHFAIEA..fCGChADAPBCE.REGD...cBFDXEDFhAEA.dGACIHHGhAEA..,1,-7,-17,10
LBMZQRKVIFCPTeUSAJEGdOHXcDYWbNfag,GAEBdEFDOFAGHEDEDABE..bCDC.aGGDBDBGZCAF.QADAhAAA.KHAGIABChAAAFHDECEDB.TGEEUAGHABCBhAHA..ECHF.YHACfHGHMEIH.hBAA......hBBA...,1,9,-37,46
DcSUFCVaNZYALWJIOXRBPQdTbfEHGgMKe,JFBDOCABBBAFdFGD.....TAGEEHFAHBCCMDEDKEHHDABHUEFEhAAACFCA...aDBBNHEHZGAChAAALAFE..hABAICCCXFDHPCFB...fEBAhACA..hADA...,1,-27,-33,6
QMWcNgHfbReGBILVSDEJFOdKPTZCAXaYU,aBCAQACH.MDCANADB.HCGBRCFDBGBHVFEH..DAIFJAAFFDCChAAAKGADZFFG..AAEEXFBAhABA..YCAEhABAcAFDfHGHeHDG..IHHChACA.SFBEhBAA,2,-29,-24,5
SgFdQHREKJBfVGAXMeOUTIcDWYaCPbNLZ,MDBGOFCHUEBB..TCEGDHEG.aCAACCHA.....PFHHhAAALBBGZAEASHEChABAFHBGdAFHREFAEHGABFAAhACA.fEEGAACCeCEH.WDAANBAG.gDGChADA...hAAA...,2,-27,-12,15
XBRAPgVbcCYHESLNKJOZDGIUWdeQafFTM,VECCCBGBHFBF.LAACKBBBZAFC.DEAAGGDDUFGG.dEAA..QCDChAEAaDDA..fAAHhAAAMEFFBFACAIAG.hADAgBBD..YCECSDGGhAFANDIC.....hAEAOHDC.,2,-15,-12,3
SLbQeAcZYdFRGNWJaMXKIUOEBVTfPCDgH,ZBBBFEAAGFDFJEFA.MABGKDDE..UGGEEHDEBAFC...TBBAhAAACFAFDBIDHGCA.hAHALAEAeBHDAIAGcDFAhAIAdBACRECE..aGADXDDC.IGBEhBAA.fGHAhBBA.,2,-25,-25,0
bcAQKHYVUEXMaDLGdTOIPRNSZfCFWBegJ,KACGHBABUDFEECFAaFHBGBAE..dECFOEHDRFADZAFGFHEC.eACBhAAAJGCG..AIBC..QCCGhAAA...hABAXFAGDAFGIFFHNIDD.CDHF.BBHD.hADA..cAEEMAEF.hBAA...,2,-25,-9,16
eCcRaWSTQgbHVfUXOIAKPENLJMYFdDBZG,EBCBJDBG.FFAAdAGD.BACAZGFAGDEH.eFCHCHABRFEH...SCAHhAAAQDFEHAGDhABA..UGCGICEFhACAACFFKAAH.NIDHMADADCCA..aCHD....hAAA.....WEAGhACA..,1,-10,-39,29
dSZFOYIRTMVADUHGeJLcbCKBfWPXaQgNE,UGDCeHCGLFADCBDD.BGGB..PEDGQCBF.hAAAEAECSCBBhABAFACBIFCEMEAHAGEHDIGAGBGChACAJBGH.KGFB.WEBDgDED..hAAA.NCIC...OADGhAHA..,2,-29,-24,5
edOSaZWbIEYMDKXFRBJLVAPcgCQTGUfNH,...PBGBCBCAQDEAUGFB.HECFeFCFSDAAZCAG.hAAAIBAEMCEHDACHFHAEhAAABAHALHFCABBDTEAGhABAfADBOEHF.aAGDEGADKFAD...hADA......hAEA...,1,-8,-21,13
HXGCUMSVNPBWFeRYKQIdfOEAZTbcLgaJD,TFGALDBA.aGHDJCAHHFCG.GBBFCGBCUBCASAAAhAAA.VCFDBHCGFAGCRCFEKEEGhAAAdFAEEGGHAAFEZAFE..hABA...bECBDADEMIEENIAB..WCHB.hACA......hADA...,2,-25,14,39
MfBcESeCHDIaKVFGXUNJZYRALdTPgbWOQ,LBDCdDEE.TEFDgFBH.OABDMEDFBABB.hAAAEHAEeAFCDIGAIFAChAAAaBGEKHDEFEGFGCDHhADANBAA.JBBH..YBDDACHEWHEC.QGGBhABA....hADASEEDCFAA,1,-13,-22,9
NPCDMQBOJgcTIAaRdZeVXSGKUfLHYbEFW,dDEGVDDBGBBF.KGAALAGHHGDAECGBFEBF....PCAHhAAADIDGMACEBAGGgBCAhAAATFGB.ABCGaGFEhABAeABC.XEBE..SDHHhAIA.fGBEhBAA..,1,-14,-24,10
aUfNWXOERYDcMAJPQdTZCeBbGLKFgISVH,JCGFdAFGZDECBHAGGFDH.FBABSADBHAGDUEAF....hAAAfHBBNBDG.hABAXGGH.RCBBDBBGhAAAMICGAFDG..TFEGCHHE.LAFGhABA.KDDC....hACA...,2,-32,-18,14
THLIVGAMcZOPJEBFedRfSaXWNKYUbgQDC,MIEEOBEH..EDCEBFGCFCFH.eFBC.dACASAGD.hAAAXEBHWHCEKAGEUFGBhAAAQBAETADBLHAEhABAIHHAAICAPCADRBFDaEAG..NBIG..hACA......hADA...,2,-19,-18,1
GFgMbfWPaHQOARdCIYJVUDBeZXNScLKTE,RDCDCEDA...JAACDGADZBEC..XDGD..NIEF.LGDGhAAA.EBEDGEACMBFA.hABAfGDCaCADHABDACHAhADAdGGHIHHB..YEECBDCA.hAEAeAFGSFAEhAFA...,2,-26,-25,1
cTVOSABeLDIENGgHfWRUJZKMXCPFYdQba,LEAADABEEBGB.GEGEHEECRCBCUFEAZAEHKAHHCGDF..FADBdGAGQAGFhAAA.aBBBcFGEhAAA..TCDEhABAOECDSHAGAIDGIBBC...fHEDhAGAMIDAXCGGhACA..,1,-4,-29,25
ALRPbDCYHISKWeENMUVcTXJdgaQBOZGfF,RDAHDBIFCDFC.HCED.SDAHKGED.EEGDMACA.UGGC..hAAATABHJCDD.dHDDQGBDhABABAEHOEEHhAAAGAEHfDCCABBB.bAGB.IHHFhABAWEFA.....hAHA...,2,-38,-7,31
DMHZRBaNCFcdgWSUTeXYVGAfKLOQJbEPI,LEAFQCDAJGCGEFBF..DFFAMAAGHCCDBEAH.CHHCdDHCSCGAhAAAeBCF.VADAhABAAGGAKGDF.OFDG.hACAbAEEIBBA.aGGA.NIAH....hAEA......hAFA...,2,-21,-21,0
MJZBdPVKTNCRfYQDegWUSEGHbaFOcXILA,MCIBZAEABCCEdFBGKEDDCFHD..RDAF...QGEBeAAC.UBAGhAAASHEAECGD.GECBhAAAHACFaGAHOHAGhAFAXAFAADGB...JEEA.....hAGA......hAHA...,1,-10,-35,25
XVRaEDPTWQYbCcUZHBfGgeANMIdLOKSJF,MFAHLEAAKCAB.SADFFDFD.RFEADBBDTFCH..QBGGhAAACHFDUCCA.BHHChABAGAEFeBEFAHGAdAABXGAHhACAaEHD.EDHH....WCHFcGCHhAFA......hAGA...,2,-26,-20,6
TfWdRMBXYIECaUcZLNSgPGAFHQDeJObVK,QFDDDEGHOBCA.KCHF....TCADfBDARFAE.BCBFhAAAXDCAEGABaGGDZAFDhAAASABA.hABAgCEAAEAFeHDCbFGHWFBBMCIDCAFBLEAChABA...NEIG.hACA...,2,-22,-17,5
agKTFIJeYfScRbCADGVZUWBXOLMdPHNQE,GCFEUDAHBCHEOABELFFAdCDCHFAA.EAFGaAABKHGC.FCHFeEDHhACA..SFDBhAAARBCBAIBCDBBBZBFFXCAAhABA.NIBH.TFAHIFHHJHFC....hACA......hAEA...,1,-5,-21,16
baTXNGAIfHcRBgQDLYKUSZFPEOdWJCeMV,HCBERGDGBDADQGCBLBHHUBCGFBHHOFCG.dBEHCECBMCFDhAAAaHFE....NADDAABCICGEhABA..fFGChAAADGAESFGGEDECWFBDJHAAeAFChACA......hADA...,1,-8,-31,23
cgYDQRbCIPSVAJTZOaWeHGBKdENLMXFfU,JCFAODDG..aHACeACE.BBCEdHGBEBAELHDG.MFEGhAAAFDABUEGH..gGGBhABADBFCRCDD.IGBGhAFAPFDHSAGEACFCTAGF.ZEBD.hAGA.WDFA.KBBFNAAD.hAFA..fECG,2,-26,-15,11
PANCYHEQaZDSMGXfdeVFBgURIOcTKJWbL,CDHDHGFA.EDABaBCFDIACGAEBdAFF..eCBGBHGCRCGF.OCABKABE.hAAAJDFDLECA.hAAAACGD.NDEAZFCHSGBEhAEAMFID.fBDD..VFAB.hAIA......hBAA...,2,-21,-14,7
YQXNWMAZUKgCEaORbHSPTdeGVLcFIfJBD,ZECHUCEDKFBBCFEC...OFAHHABE..SAEEdBBHGAEELFCFhAAAFDAF..IFGAhAAABDABDHGG.YAHFhABANIDD..AACGEEEDaEHD......hABA......hAEA...,2,-32,-30,2
bFSEeNCVTRIAcPJBfOLXYZGUHaMKWdgDQ,JECDBCFBLHFCZADHUGGAHBEF..aAACMFFG.KABEdDBCDBBDFHBGhABA..EDBHCEHF.RBGDAEAH.hACA....fHABhAAAOFABXFEH..WGECbDCDSEEEhAFAeADC.hAHA...,1,-22,-30,8
XGfLJYOBQDSePHIFRdMWaZgETNUVACcbK,CFDHKEBDGBBALAGB.OHEEBFHBQGAHDGCF.eBEGhAAAIFHEFHEC.dBCDaGGChABAEEDC..TDFChACANEAE.AAGG..XAGEfGEFSADChBAARCAEWBHH.....hAAA...,1,-9,-38,29
FGZOeJMAYCVEdgfIDSKNLUWcQabRPBTXH,VGDGECBEdHDF.....IEDEDADBSFABLAEEUCAHhAAAQGGERDEABAHGHBEEhABAFCFCOAACMDIHADDFYFBDhAAACHGA.fCAE.WCHBhACAaGAH......hADA...,1,-21,-26,5
HNZLcYOdgTeUJBKRQFSIWXEVbMCPfAGaD,aGAEDDEAHFEFLDDBOBFAdAEB...eFCFUABHBEGGRGECFCFFSGADhAAA.IDCFhABAXCAC.EFGGMACGhAGACFBFAFFB.ZBBG.gGGBKDHH...hAAA..WDHB..hAHA...,1,-21,-25,4
XdbTLEWBQUcHAVfJeDSPIFaGMYZKRCgNO,JCCCSGHB.FCGEaEFCGCCCZDADKAFDCEFD....OBAHhAAAXCGDdFABLHEChABA.BBEHUGDAAGEEeHAEhACAIADDMBBCgAAC.TGGAhAAA.EAHB.cGADhAGA.,2,-44,-10,34
BIMXKTDdOeEJCbaYQNFLfgUZcPVHSAGRW,RAAFBBACMFCGKBFF.DICCeEAB..CHGB.aDHD..QBCChAAAFGEGLBEGUEGAZCCC..hAAA..VFAGSADChACAAGFB.IGHHdAHGEDED.YHAGhAGA.fDGAhAHAcCAB...,1,-22,-37,15
bFcgDLXJNHOYEIVTWKUSRfCeZaAPGQBMd,QBGAMAIHFCAH.DCDFLDDH.JDFBHAAG.EGHBVFAHhAAAWAFC..UABGREDCCDAEeHEEhAAAAHHCBAFD.dHEHcEAHhABA...gGBAODHHIECFhAEASCEF..hADA...,1,-18,-23,5
TDEagfZVMIWPNXHdJSLRYebBCGcKQUOFA,TGFEDDGAEHCE...aGEHZDAF.MFAD..PABEHACDJECGLCCAhAAAeFFHBCEACGAEKAHBOCHHhABAAGEB.gGBHhAEAfAACIEFHNAEF.SAFChBAAbFGH....hBGA...,2,-22,-16,6
YPUIaKLMJSDRQeWGXOHCcgfZbABFdENTV,dDAETDCD..VDGBUBAEKACFLGCA.SBGChAAADAEHQDCAeEADXGGDhABACHCD..cAGEhAAAfDGD.ABFDBFFBEGAFPFEDMACC.hAGA.WHAG...hABA...,2,-43,-7,36
DaWUNAFSGEVBTbfMQgcJCOHPeRLKIXZYd,GFDDEGDDBDCA..bDAFQAGB.JBAAOACG.PCFDhAAALDFFKHAAIHHFhABAZEGDdFBGaADANAHAADIBSBEGhAAA.fCAGcBCHCECG..hABA......hACA...,1,-15,-25,10
ABYDRMQUKWTXagOfdbNFJVHGLcZeICPES,BGAHREDAMDDCUDDH.KCBD..XAAB.aAFBfHGDhAAA.dGCDNHADFHFEVDGHhABAGCGA.cDAEhADAeAEGCADD.EBBGAIBADBGE....WHCAhACAgACA..hAHA..bBFA,1,-23,-25,2
KBSdRYePGLHaEVFDbAXMTgOZQWfcJNCUI,TAAEZDGFQDBC..fHBBJAAECADA.KDFFBFEFdEADeBDChAAALHBEEHFADHDGhACAAFDDMAFGOAGD..hADANCCD.IFGFRGFG.YDDB..hAEA......hAFA...,1,-18,-29,11
NbSTRMOFUQEHedLCcfWGaAXBKYIDZPgVJ,KCBFDCBFZFAA..VFBHJEDG.....SDDBTABBRADH.FAGDhAAA.ECEEdHFH.CBHE..hABA.fGHAhACAaEGEAGGCBCFCIFFC.NDAAMBBG.OHDChADA.....hAAAHDFGeHAE,1,-23,-36,13
EHVRCfdZJGQXUYWbBPATIKMNLeSDgFacO,KDDHMDIDeBHFDBCB.FBCF..OEAFHEAHRGFACDFF.ZCEHGEFC.QEDChAAAXGCH.UAEFhABAbAAD.AADF..NIBB.LAEEhAAA.SGECaCABEAHDdFCC..hACA......hAFA...,1,-4,-14,10
IONYJPCGRUFcXWeBdQVHMDLEaTgSKZbAf,OGCAJGDCGDBCFDBH.....XACCBGFAVACHMEDCDBGDaHGEhAAA....SAGBhAAAZAGFAGBBIBAFhABANEAE..CEEC.RBDCWDAFeBHH.HEFC..EHGAhABA......hACA...,2,-40,-2,38
ZXBVTKMDPdUINSQfeYCgEJcRWHbFGAOaL,aEAGZCDEBBED.KDBDDBDF.dBGCUGBE..IFCDQAAAhAAAeEEG..CFFDEAHBJFHDRFDHhAAA...HFAFbGFA.hADAAACAXBAE.MAIHNEAESEGGhAEA...fHDBhAFA,2,-30,-27,3
QONEXVRcCZSDPdaTWFJHKLgIBeUGYbAfM,MBCFOCHH..EDDDRADHCACBZFFC..DGFGaEBC..FGBDKAFBLBBFhAAABADBeBHDUFDC..hABAbGDCAHID..QAFChAHANBAE..XAAFSDDGdHAHWHEAhAFA...gBDGhAHA,1,-9,-38,29
GbQYCFfUEZPWIegNcdXRDBJLHMaOKSATV,GEBAQDAECEDFFBCEUFFE.ZFAE..IGHAeADC..NICF.hAAAXGEHRCEE.BBHChAAA.JEFEMCBGaCBC.hABASEEFADAB...bAFEEAFCWEHBhABA..dFACDHCA..hACA...,2,-23,-17,6
YHWOFTDVUGPAILKZfEQNXeRdaCMSBJcgb,LBDDKBECEGHD.QFDFeDBE.dGHACFEEMECFBHDG..JABB.hAAA.bBAGHCFF.FBHFhAAADAIHGEAGAHFAZAGFfEGDhABANAEFaHFG.SFAH.gGDDhACA..hADA...,1,-6,-28,22
VfSNJdgIEePXKGMCDOQbUAcLFYTRaZBWH,FHAERDDHBHACHCFA.SBDGdFFHEAEC.eCBFKGBEGACA.DBBDhAAAOFED.bFAEAHHDLCFGhABATEGHZAFC.hACAfAAFJHCE.gGGGIEABMFIDhAEACEEC...cAGBhBAA.,1,4,-29,33
KceSfDdCJHGQFabEPMIBXOVWLZRgUNYTA,KEFBSCEFdAEEHBGDGGAFFGBG..aFHDEBBD.MDDHBAHBOFFDhAAALBDFZADARCFAUAAAhADATEAAAHFG...cAGAhABADIEEQFDG..IHHChACA.....hAGA...,2,-25,3,28
YZFVbMXagQTNfSJGdKHLDEWIAPeRCcBUO,eEEACCCDBBHDUGDAZFGD.FABH..MDBB..XCDDQDEEhAAA..TBGHSHAEhABAdDADKFBBDCEAEHGAAHEFPAEAhACAOBDA........YFAFhAAAaBBGNEDG..fGEDhADA,2,-32,-27,5
FdBTYKDJcZINSLXfPaGHQbCWMeEUROgVA,FDACBCBEKGAADBHBZFFC..SFCDLDEG....XABFhAAAPADFHGECQGDGhAEACDEHMDABUAFD..hAGAgEGBABIBdDCE.YAAE.IBFFhAFA.fHABhAGA,1,-29,-30,1
MLIPUHNdQESgXVGceWAYRFDBZCKObafJT,FDDFDHAEZFDACGCB.KCFE..aHGG..JBACLCFC.UACDdEAC.hAAA.EHDESGAGhAAA..gDDEhABAXEGGVDAFeFHBAECFBBAGOACG..hAGAfFEAMCIB.hAHA...,1,-29,-34,5
VNWMYbQXSZIaTLJfBOdePgFKGCEAUcRHD,RGDEHDCHDEDF.VBFG..MAEFQADBZDAH.aFFELEFChAAABABEeAADFACDCAHAAIBANIED..hAEA..bAFBSFDHhAGA..TFGG.....hAHA......hAIA...,2,-31,-14,17
RecAIBOdMfbQJECHYNWLZFXTUaPKVSgDG,BGBFOHDCMADH..QAEEEEEHHFGB...NDAGZDDFXAEGhAAAaBAC.KAHB.gCADhABARBGFeECFABDFfAABhACACDGFLHCG.FGHB.......hACA......hAFA...,2,-22,-12,10
WHYfXECaIUdBTcOAbJKSMRGgeLPDNZFVQ,JBGBSDEFGADELFHDDEBDZAGF.FDAEQBCB.HGFEhAAAfAADCDBB.hABAUFABTEGAAGFHMFDBhACARGBEgAEB..eEFBNDAE.WBHHhADA..EDFH...hAFA...,2,-26,1,27
dAZeXEaLDIBKfRcgYbCGSVJTUFWQHOPMN,XFCAEFCBDDAH.BDHDRBCB......gEGHbABDGAFChAAASACCJFADFECGHADDhABAMIBCABIDZFFH.aFHFhADAIBEGKHBG.YAGD.CGEA..hAFA......hAHA...,1,-3,-32,29
gILWdACPHZYGBeaSDNUObRTQFXJVMfEcK,HBECZAGFGAAHBFDGSHAADEIFUCEG.OEAHRFAE..FGGBJABEhAAAMIBCEFGH..KDEFLEAEhAAAAIGA.CCDD..hABAeADENDIG..........hABA......hAIA...,2,-30,-20,10
KdGcEDOgMaRZbPHLBFeVIAUXNSYCWQfJT,UGEHXADB..SCHBCFGH.QDAETDDCKBAHGADAhAAAEGAADIFCODGDhABAMCIDRCBFZFAC..PBFDhAAABBBDFHAC.IDFFNHCF..fABBhAGA...hACA...,2,-23,-19,4
APbUafOTKXFVEDLZIWcMGCRHBdJegYQNS,UEBCaECH.OAFDKDAFFEFH..EAHFDDEALCDHZGEE...ICBAhAAAMCDFCGAGHBGDhAAABFGBdABD.eFEFQACDhABAAFIF.fCABXGGCWFADhACA......hAEA...,1,-28,-29,1
VWHXNFSKZPTAgODELYIbReBGcfQMaCJUd,DBBEEFCFLDEH..bAFFeBGFBDCBGACHQEGHaHDEUGGBhAAAdCEAHFBCFCACZFABADAAOGEChAAAIEHHfHBBhABACABF..WAFESEAGKDCA.hADAPAHF...hBAA...,2,-13,-3,10
dDcgVMZGYCfUBOSTeEAQHbNLPXIWRFJaK,HGCCLBAFXEFHRDDAFGBG.KABFDFHF..VDBEGBCB.CFAFBDHFhAAASAHB.EADAhAAAAFFGQGDEhABANBHG..IGAGaGGHdAHC.MBFHfCBEhACAOCAB.....hACA...,2,-18,-15,3
GefSVHdOYBMbWcXNAIJQZFTUgEKRaLCPD,JHAGFDECUFAF..KEFHRBFCLACCDAEAGCAH..eAAH..hAAASBFDHEGBdHDDBCCFhAGAMBBE..bFGDcECFhAHA..AEEHIAHE...hAIA......hBAA...,2,-43,-19,24
gKJcXMHAUaRVYWFPQNEZOIbdeCTGBSLfD,aGFBRDEF..VBFGFDCD..QBEDEDBF.ZAABIADGdEFDCAGEBBHHhAAASABB.hADADEHBKFDBJFAFMIACAAIHUGGFhAAAPEAB..NDDG...eACA.LDHHhAIA...hAFA...,1,-6,-27,21
TXJaHDYUEdNcBCRVbQIeAMGgLFOWKPfZS,GFDDLBBFOACDKFDAZGAC..XBFBHACFDHEAEEDCdDEHBAAChACACHGA.VFAH.IDHDhAEAeCFEAFAGMAAF.hAFAFAEGfHCH.SGHHhAGAJFFAaBGA.....YBBFhAHA,1,-4,-24,20
PcKfebLMWYHaVQUDEFgXBdTCRIJSGANOZ,ZGDEKFGAeBFELCEE.MIFEHBBF.aHACQEBGUFDC.DBBDhAAAEBAFFHAEBEAGdAFHCCCHIHHDhAAAGDEBAACCPBEHhABA..fFDFWHDA..gDGEhACA.RFAA.SACAhABA,1,-9,-19,10
ebgTLJPNdFfRDQOIMBGKUaHVAXEWYcZSC,EDBE....cGDCCBHBeGCC..TBCGLACE.JBEHdGHAhAAAREFGDABDICFC.hAAAGCAAaHACAHEAXGGEhAGAWHAGSEDC.PCHHFCGC.OADGhABABGBC.KGFG..hACA...,1,-19,-22,3
LQUdZYKPbNVAXgTIJEcMfWDBGSCHaReOF,XAGFTDEG..JBECMEDF..DEHHBACCCHBF.RBDBeAAHLAHHhAAAdFGBKGBH..PEAGhABAbFED.ACDHIGFAhACAEAFB..cDBBfBBGSGHDhAAAaADGFGDB....hAGA...,1,-11,-35,24
TcbZSFIXCVdJKUMLeNRQGWgPfDEaHBOAY,TBBBZBABFAFH..CGHF.dGFD.UEGFLDFHeFBC.QEDChAAAGADH..PDABDGAEEAHHhABAaGCDBEHCACHG...hAAAbACHIDDD..JHDCMABG.WHEGhAGAfHAB.hAHA...,1,-16,-22,6
dHabeRTgBCNPEJQZWAKMSfcFDVOUXGILY,SGFHFHCEDBBE.OFDHUFAGGCEG.LCACdBCEaFAFeBABhAAAREGBBCGBCAEAEEED.hAAAQCFHABEAKEDDMAEGhABAfAGH.cEGC.IHHBhABA....hACA...,1,-26,-31,5
ZYEFeHVWSagAPUXdITRLDMNQBCcbfKOJG,XAGEdCEARAEGDADD...MFBCBGAG..CBDG.....fGHAhAAAJEHHGAAGZBBHFGFHhAAAeDHHHGAA.SEDEhACAAEAB.ICGETGEANIABcADAhAFAKEFHOCAF.ECGA.hAGA...,2,-24,-24,0
dEUTcGgbIJMfaOCVPBHFRNXAQKLYWZeDS,QGFCLBFGZEFGSBDDEDGA.UAAATBAAGAFCIDEDhAAAMEBCOFAHhADA.CFBEBEGHHEAEFGGAhABANDIEABID.KGBG.WAECdFDA.gGDBfAEChAEA....aADH.hAHA...,2,-11,-2,9
fGYSDCINUBFMWbRXcZTgJLVPOdQEAaeHK,eCBAHEBBKAAAGEEGDADC.CCGG.UEFCBEDCFBEGMBEG..RDDDZAGBJGAELAAAhABA.OEHBhACAEHFAACCB..aFHFSGHHhAEA.NAIG.WCAF....hAAA.cGAH..hACA...,1,-16,-32,16
AeNbEKDCJFYGcQBIHZWaVMXgTUfdLPSRO,eHEGEADAKGCCDAFF.FFFFGABE.BGHBHGAEZAGBVDCD.MAIDhAAATGFB.UDDFfEGDhABAdGACLBADhAAASCBFABFBCEHF.YAGD...QACBhADA..hBAA...,2,-21,-15,6
gBWScUMNJQOYXbACKRHeVLFfDaZPTIGEd,KFBDHBEFeEBEFADFDCGGZFED.....IGAFdHGDBBDG.SDGGhAAAUEEHJHEAOACHhAAAXAEF..CAFBLDHFhABAaAHB..TGCD.gBAEhABAMIACNDDG....hACA...,2,-34,-20,14
fVdcJgTFMeBHGbCDAKLWIXNZSaOQYREPU,LABBXBGHZEEGSEAB.QDEBEABEUAEGdDCGJAFGFGFEhAAABGBG.HGEGCCHHACFCKHCChADANIBF..ODABhAAAPDCD.....cADBMEDG...hADA......hAHA...,2,-21,-16,5
CGADWTYcKEUaZeOFVSbBPdJXQIfgRLNMH,DDAATDBBKFCG..UFGEaCBA..ZFEHFAGF..SAEABAAE.hACAJCGDQDDFhADA..gGCEhAAALBCGMIBACHBGAHAFWBACEGEAeFAHODAH..hABA......hACA...,2,-31,-29,2
IUOgJaLFMSeVZPWQRKBdXHEcDfNYbCATG,TEGBUBEDOABF..JDAB.LDDHMHFAeHBAZABCQFBAhAAAKAEEBAHHHDEBDBIH.hACA.fGEAhADAbDCHAAAEGDAEIHHAFCHB.SAHF.hADA......hAHA...,2,-14,-12,2
PRgFOfDSHVLKGNBZUAMTXWebQcYdJCIEa,MDAEXDBC..eAEHQEGCdEEDCHGG.aBCFRCFEFACC.DAGEVFBHhAAA.LFDHhABAKHBABBBDAAGAbADF.JAHDIFHDhAAAEGHH.OEADfEED..hACA......hBAA...,2,-35,-7,28
cRaGXEgfYIWdZTOeQFJKPBHVMCDAbUNSL,UAEFSDBELEEERGBGGDGEEBAD.....fABDhAAAIFCEdFFEOAEAFCCFPFAFhAAAHBEBCDADAEEB.NAIC.hADAaCHF..XGED..YHDAhABAWBBG.....hBAA...,2,-18,-13,5
PQFCfDgXVYSdGMeaJOZANbEIHUTBKRWcL,EAFFHDAABCDBRCFGLGECFFEH.CEFH.DGGB..VADGSDHHhAAA.MBCHJAADAFHG.IAHHhAAAKEAH..WHAEhABAPGAG.fCCBXAGDdDFAaGHD.hACAOACANICD...hADA...,2,-31,-17,14
dIeJScUBPWFfLCZGAYHXaRDTMgbEONKQV,XFGEDBDAMCAA...EBHHKEDG.dHEDeCFB.SGAChAAABAGCFABGCHCCACAHHECE.TABGhABAOFHFQAFBhADAJBGB.PHFCLEAH.ZFCCaCEH.hAAA......hAEA...,1,8,-38,46
DAOLVENHYdbBTMPSXUWfaRZgFCJIecGQK,LBAAVFCB.HFFBdGFABFAHMICGXDDAUBAA..aCFAZFBAhAAA.FAFFCEFC.eBHFGACEhAAADEAHAEBA.EHAANCIA..hABA......YAEA..hABA......hACA...,1,-7,-35,28
PDabQZGUATFYMWOISBLJcNdfHKERXegCV,TDDHFBFBMDAB..OHDABABCLHFA..cEAAhAAANDCG.dCBBKEHHEAGDREDC.XFGBhABACGGG.PFABhACAaDGGQBCF......hAAA......hADA...,1,-16,-34,18
OcATQFJNaXPBbEIeGMDdfCKHRgZYUWLVS,FGCAaFCBBFHCEEEB.GDECDDBD..dBBFCDHDHADBRCFCZADB...UAABhABA.LFADSGAFhAAAODBETAFBQBGHhADAXGGBIHHBMCCB..fHEFhABA...hAFA...,2,-20,-17,3
RSQCbNEPVaHBcWJUFTZYLGAedMgfDOXKI,MCACDCAEODBEKBGH..RDFF.CAAA...EFAHaBFHBFEG..JHCGFCEFhAAAZFFHGDAH.AGHGeABGhADAdDAGXCGDhAAA.SHACNIDHHGBE.UAGB.YFAGhACAfAFF..hAEA...,1,-20,-25,5
gQeOXdZYHFGWAcDRJNVfMLBESbCIUTPaK,DHAEJEEH...VFFAMCIHBFBC..SABFCDHE.UGGEhAAATCAEKAHF..QFBEhADAXAAEZAFBFAECAHEBhAGARDDD.LCDCEHCCIAEFaDGD..eCBFhAIA......hBAAOHEC.,2,-26,-11,15
STCAUNJYbLZBMdgHVWIQGFPOKafDXEceR,UBDHJDFCLBBCBAGFdFGH.HCAB..IHBAFGCEKDFA.DAIF.hAAA.EEDGeAEG.SEDHhAAATBGECABDAIAGbCAEhABA.ZFGD..MIECWFEHQFAFhACA......hADA...,2,-24,-24,0
ASCaMZeDcJOHGULIEFRbdgPKWfTNYBQXV,aCBEeBDG.DGFFOFDBUDGE.LCFB.FEHHRDAFdABCKABH.TDDDhAAABBADQFAAhAAA.AAHBCDEBcGAEhADA.JFDH..IAFAgGGC.fAGDhAEANAIAXGGG.hAFA..MEBE,1,-20,-30,10
aCHZGVIPOWUNFDTcgRdSLeABJEKbQYMXf,EFAHQEDA.MDBGfGEGHCFEVEAHOAAD.NAFA.FHGEhAAA.DHEA..cEFEhAAA..gABChABASADFAHCCKFFEXECFaAEBCAHA.IHCDhACAWHAG.UCGF.dHGBhAGA.BBHC.,2,-5,-3,2
dWCSJNbKXQRBZaTVMgDcYHELIPOAUGfeF,GAEBeFEEdGCASECH..NABEKGABREFEBFEGZBFE.TCAChAAAMDAD.DFABHACDEHCGLBAChABAOHFCAEIHFECGCHHAbCFEhACA..aGEB.........hADA......hAEA...,1,-9,-17,8
UQAVgYDEaTHRXcKbJfNBWMLPOSCGZdIeF,VBDEDDHDEAAF..HGFGRCAE.KBBF..JGBCBCHGLBEGSBGEhAAAGEEEZGAAdHGHeEEGhABAFAFGAEIBaDAE..XEAChAAAbEAE..NADD.MIBCCACD...IEDChACA....hADA...,1,-4,-22,18
KLOTWeSRMPdXafbCJGFDgABNcIVUQHYZE,BFAH..IBAGVCCGHFFAEDDGOEFEeBDE.RBFH.MCAFXADDhAAAaGEH..fDHGhAAACCHAJFBG.DABDgGGFhABAAFEE.NDAA.QGBEKCBB.hACA.WHBEdAHE...hACA...,2,-18,-13,5
TaHdJRKgMAEBQCFcGeSNUfDbPOVLZXIYW,BEADQDGBFGFE.GFCBSDGAUCCADGAB..OCEGhAAAZBABIADETDDDaGBEhABAHBFG.RGFCMAAHABCGCDAEeACEhAFAfAFH.bFAB..LFFChAGA.WHAG.dDCChAHA...,2,-24,9,33
fBCJgYAKdNFaObGTWUDRVXPeQMILSEZcH,dDCDaCEGGBAGUCFHRGCG.....XDCHeDADMAACSFFDhAAAZFFBHBBGCEHDJAEA.ADGHKABChAHANDIE..FAGCOHCChAIA...........hAEA......hAFA...,2,-22,-21,1
eJbCRFMOcYKgDIaHZVXGTfPUQELNABWdS,BGACSAAFeBEFCHEFFEAC...OEEGKGGADFFEHGCGZEBAGAAHhAAAPBBF...ECHHNAIGAGGDhACA..dHBDRADHMGAChADA..gAFBaHFE.....hAFA......hAGA...,2,-29,-15,14
QLYOHaDZRTVJWAIcgMfUXeNGdEKFSCPBb,..ICFEMHCCUCED.eFGFGABEEEAE.KCHD.SGEDhAAABHHCLAAGOEDEaAFBhABADDABZCACREAHJFHHAEIH.fHBFhABANGBH.CDDG.PAHB...hADA......hAEA...,2,-23,-15,8
bZOELcaSKfQXDHPJFVAeWdINCTYMUgRGB,eGFAdGADCCAA.MDBAREGH.BHDCZGDALACC..aDFEKDCCfBAFhAAADIDA.PGAGhABAJCFH..AAIH.IEBFhACA..TBGAUADD...bEBA.hAEA.EAHBSAAFhAGAXEEC..,1,-27,-32,5
MPNTRLdQfXJCAFZeSEDOVHWYcUaBGKbgI,FDGEZADASDEADDECHDAF.......WCDFcFFFBFAAhAAAGCCGKHEC.IABGhAAAMAFA..NBAELFFChABAdAHEXGBHABCBEFDHVAECaHGE.PFEHhADA......hAEA...,1,-13,-23,10
THfCWXJURFYQNgEADVaOcLMKPSZIbGdBe,aDDALACC.KDGASBGFZGBEGCCCdHFBBFFEHCAH.fAEEhAAACFHB.XDGAhABAJAGBFAAF.QECBhACANIDD.ABBCVGACMDBF.IFFH.hAGA......hAIA...,1,1,-33,34
LWNPXFMBaObgJfcVAZERHCedKUYSGIDTQ,EAECHBDHdCADKBHF.UAAFSFGHDGEE.QBFDLHFE..hAAA.NIAD.FFACBHEBaDHDOCFDhABAJECH..fEFGhABAAHABCDBA..YADCIEAC.hAHAWAHBMIBCcABGhAEA.ZDDH.,2,-27,-20,7
gCGFTQfLVUIKNdcXZHSMEOebYBaAPRDWJ,RDCADGGD..JACGCAAFGAFE..FFGGQFBFLAGBUGCGhAAAKADEdCDAZBDEHCAA.MICEhACAEGHH..OBBBhABAeDHDBHAFABIF.gFEFTGEE...hACA....IHHFhAHA.,1,-22,-24,2
eWFQIbPTYKMRJHUSLfdCcDGZgaNOVBXEA,eGBGQCFD..IEGETCAHMAEBRBFAUCADLFBDhAAA.CABBDEGDgEDDhAAAOAHDXFCAhADAAIEGFGGGPABCKFHDSCCBdAGF.cAFBhAFAaDDABFAC....hABAWFFD.,1,-10,-19,9
UfeRdENQOXYcaCFPbKgVTBGIJZWLSHAMD,UGCEeABAdEBCEBAE.QAFA.OFHFXBEA.aDBDPEDFhAAAKEFF..TACEhAAAIHBH.ZCCCWEAFhABASCAF.HFFFDAIDfHAFhACANAICCHDD.FDDF.gGGDhAEA,2,-19,-14,5
RbLePJZXBWFAgKIUCDGcMfdQOVESaTNHY,KFAFCEBEDBHBGEBF.MIAGdGCGQBAH..OAEAhAAAVFGB.aGHBHDDGRCCEbBADeAEChAAA.JEAHBEGDAABA.hADAIHEH.fBHAEGDCNAIALBDAhAEAXACG...hBAA...,2,-15,-9,6
TDMJfAVeRUSdQgXaFEbcBHIOKNGYWLZCP,RFBHdHDHQAGHaBEC.FCCHEBBE.BAGGOGFEGEAHLAABhACACFGHDAID.MBEB.ABFDUDFFhADASHAE.XDEAhAAA.cBACKGDBNEAA...WEHHhABA......hACA...,1,-14,-38,24
MOQFDHfcSYdPTIUGgeKEaZCbJVABNWXLR,BCHDXEFBMFBFFCCBDEAD..HFCH.SHFCdBAGTDBHUAGHhAAAeEEGaACCZBCAJBABAHHGLGCChAAARFAB..hABAfEHA.cEDF..IAHEhACA..KBEBhABACEHENICH..,2,-23,-12,11
TMKNIVYOEGbBQcAdePCUJRXSfagFLHWDZ,eAEEUFFCRBFA..XDEC..fGBDFBBCHDAEDHEAMECGhAAAKHGG...ICGFhAAAOCBCGACFhABAQEGAAGEAdCACCADGSHAGaFAH..WEHBhACATFBDNIBB...hADA...,1,-13,-25,12
DZOCbIXaBfKeNQHYVPUGSgdWJRcEMATLF,FDDDZECCOBEDCEGB....IGABBACAKHBA.eAEEQBAHhAAAHEGF.VGDGGBAEhAAAdAEEJDBHECGFAAIFDIBEXCCBhABA.NIEF...YCHHSGCEhACAgGGH.hAHAcABA.,2,-26,-2,24
KTJbGMeOdfUZNVAcWFICXLgaPDERBYSHQ,FECHCGDBLADH..gGEFaAFD.DADBRDEFBHACHDEGKABBhAAAJCBFGBGEOAFAdDHAhABAUAADZBFG.ADDCIGHChAEAEGFA...SBEC..hBAA......hCAA...,1,-19,-29,10
PfJLYgWTcRSUNDQEMOeHGXAFabVIZdKCB,aEDAVAGBZBBC..dGEBCCFA.BACD..JEAFLFAF...hAAA.gEBBhABATCEHSDAADGEEMBDCeHFChACAXAAHFDHFIHCFKADEPFHHfAHChADAWECH...hAAA...,1,-24,-35,11
CScTYFNMIWdJDEKeOZRGVXPaUgbLBAQHf,HAEFCFBD.TCAFFDEBMBHDdFEFDIBG.KAAGOEGHZGAE.GAAHhAAAXCCHUAEG..bGEAhAAAAGID..SHAChABA..NEICIAGFEGDAeDAC.PCGDhACAaHFC.BEAG...hADA...,1,2,-27,29
GbPIegdJYNTKBRWULFVZOQMEDXAcfHSCa,HBDDSBBDaBHDGFDB..bBEBeFBCdEGA.JBAG..NDAEBGCGhAAA.RECG.LEAFhAAAFBHBZGFAMDIDDFIHADAAfBFBhABACACA.PHFE.YHBGhACAKCCC.....hABA...,1,1,-18,19
ZdBcLXCgQVUbKOaTEDSYRfMePWHAJNIGF,JHCCGAAFZCAA.dFFFBFHHLFBH.CHDG.QABFUCEA.KEGEhAAAOFAH.aGHDDFCGhACARDCD.eFABHBGFAAHGFBFEhAEA.....gGFD.bCEGhAFASAEE.hAGAfDAF.,2,-23,-13,10
bAYTceUPIDMKCFdSLEJQGXHaVZWRfOgBN,TFEFUGDBDEAA..KECFFCCCdBHELAGH..QBAEhAAAGECBaGGEVBEC.ZEAFhABARFAFOAFHBDDFAGHHcADBhACAeCHHMBAA.CCAE.EEHD.....hAAA......hABA...,1,-11,-18,7
GYJbHNSeVgaICXBdfZFMTWLcQKDOPAERU,UCCAJACDHFBHeCGB..aBFACGGEBACG.ZGACMFEB.LEDEhAAAKBABDFEA.AHACEEAF.RFFA.hABA...bADDNAIA..hACASDADIHHH.dGECfDHGhAFAFFBE......hAGAWFHH.,2,-45,3,48
WbLOYaPcXQdMHBEeIZATGJRFNDSUVCKfg,GAEBRAFFDBIB.SEHHCHGC.KBDD..fEBH.hAAA.WCBBOADDaGGCXDFDhABAdFDABCAFeFABhAAAACIBJFDHFDABVDGFbFAHLABB...hACA......hADA...,1,-21,-25,4
WKGMBIFZERTfNaYOVQALHcPUJSeCXbgDd,HBCDUBABeBGBCHHE..XDFFDBDBdGFGGDACBEHEZEDD.EGBFTCEGhAAA..NBBCOABGhAAAAAEFLHAA..hABAJFFFSECB..gBGEhAFAKGHHFAGAREFE.aGAB...hACA...,2,-12,-8,4
HXWRNUCOfbEIQegSZBLFTDYcKGdMaPAVJ,VEDBXFEF.RBGF.CHFD...ODAGEFBBeDHBZACABGGHLCCAhAAADEEAKGCBMAEE.AACB.JFAEhAAA..NDAA...fHABhABAIBHDSDBG.TGGFhABA....hADA...,1,-26,-32,6
ZFWKfgNcJUYeHAPBGdVTMXCDaISLQEbRO,GDDCdGCDMBIHCHHDDAAB..SCAELHAGQAGGhABAEDDE.RADEFGFHfAFEhAAA.NBAFUFGH.hACAHECEPDAABEAAXDGEaAHBIGAEhABAOFACWHEA.cCEFhACAYBBAAADE,1,-12,-21,9
KOeLDCZNGbHFdUVMgcYJRAPSTWBQaIXfE,SCDGTEBB.QCFGaBHH..XACHKFBDLFFFhAAADIEACFGAGDEEFEBAdABHMAEGhACAgGADJHBGREGHAAIFhBAABABD.fCAD.EGCC.eAEChAAA.....hBEA...,2,-15,-5,10
HOKYZIfgMRBNaCJUbWdAFGTPDeLEVcSQX,GBFCDFDAeABELHBG.EDDHVCFFSDBBQFAFOCBAhAAA.KAHDIAHGhAAAfEACRFGFBBBDNBAD.hABAaDCAUGGHdAEAAIDEFFEF..cGBDXAEFhACA......hADA...,1,-3,-14,11
HGTSfLOUbANVXQZRcCgaKMWIJEeBPFDdY,XFBBRFGDCAGF.KABGMBEF...JFBHeFDH.BDADDDCDdABBhAAAGBGA.SCDHhAAALFFDODHFhAEAUGGHAFFF..NAFCZBACaFDHEAHHFGAF.....YAFFhBAA.fBCEhCAA,1,-22,-28,6
cNTLOIfAbFEZCGVPeHJKDSMYWBUQaXgRd,FHCECCCDGDEFeFAHKAEGDFBB....MEDHBCGEUAGFaBDH..REEB.dAAHhABA...TADBhADAOABDAGHFZFDB..HEGDhAAA.SECHWFAD.QDAHhABA.cAGFLHFGhAFA..,2,-30,-14,16
ObXdEAMgKZfeRCSIPLNDHGUcYJVTaBQWF,MBBGZACBRFEF..CCHG.SEHHLCABHGAGGEDA.UFBE.JBGBhAAATECCBAFEFBEDbEGH.hAAAdDAF..EAEAACACKFFEhABAIABGDBIH.cCECaHAC.....hACA..QAGDhAIA..,2,-21,1,22
ODLcIbEgHZBNPQGdaYfMSFWATeJKCUXVR,JCFCCAFFUABE..RDCGDCBBLGBG....IEGCEFGGHECAhAAABGBCQBEFhAEAGFDFdBABfAHGhAIAFAGAAFAB.KCGBOADE..cDBB.gGEHhBAANEIG..hBBA...,2,-34,-21,13
AaTHKSQbOEJZXIfFgBULYRDeCcWPMNGdV,HBFDQGGHOHEGEAGFJBDHZACC...XEEHIAHBFBACUCAAhAAALECHDEFFCGAD.PBHDhAAA.GEAAhABAAAFGaDHHKABESDAC..bEAEBHEA.hAEA......hBAA...,2,-26,6,32
cgNLaOBYbPGZSUdVJIfFXHRDTEQACMeWK,CEECMBFCKGED.....NDAF.OBCABCHE.....PEAEhAAAZFADdFFG.JAACFFGDRFCHDEBChADATAGG..EHGAAGCEeCDAhABA..WEEEcCAG...aGAChACA...YDHHhADA..,1,-25,-42,17
JMaCHDdVYERFTIGUefZAWOBXNgcSQbLKP,BEHFXCEB..NGDH.SBCFLCAGKEABMBID.HDCDdBCFEAHHhAAATEFE.IGHGhAAAUGABZAEFAEAGOFBDhABA.gAFE.QGDHhACAPEDEJHDGDBBD...hABA...,2,-29,8,37
fgeMKJASbEYaUCBVPXLRDFIcNGOQWZTHd,SFACEBGDUDCDBDAH..XBDFDGEG.FCBB..IABAhAAAGBGCQGGChAAAZGDCHFAFdADHfDFGhABAMCIBAFFA.aGBACDFH...PHAC.cDDHhACAOCCGWADE.hAEA...,1,-4,-29,25
THGdfKecRMBAaNVUQbPCDYgWZFLXEISOJ,aCFEUGCF.QECBCHGC.DGGH..gEDHZAECLCBGhAAAXADDEGAD.IFBDhAAAOFHDTABDhABA.dFFFeBBF.MDIHNAIC.PHBCFDAH.hADASAGF.hAFA...,2,-28,-5,23
OTNIKbQaXDWUEMAgYSRdFcGeBCZJfLPVH,SCCFdDFGGABGCGHFZAFFLEAFHECATGEBKBGA...aEAHDEEDhAAAEABCAHFCRFBD..FBEHBDGAhABAfHAF.hADA..PDHDOBDAIAHD.QGGGhAAA..hABAWDDF.,1,9,-39,48
QYgEePBDGJcaLfHFAbSWTKXMdUIRNCZOV,SBCCKAAAdDADRCFF.CAHD.ZEBE..QFBAEGBH.eEAFDICEGFDDhAAAaDCGHFFDAHHF.WEFChAAAMAFE..NEEAOBABhABAVBCA...YBDGBEHE.LFHBhACA....hADA...,1,-6,-24,18
JNSQUfgHVMGdWeKIYPCbLOEcXTDRBaZFA,JAFFSGCC.QAFHUGABHCBCMIEGdGHAKDAD..PDAHhAAACEECLFDA.hABAOHDEEDCCXABAhACADCAG.aEHH.AEEANBIAfABB..hAAA......hADAgFFD.,2,-29,-8,21
aHQfEXVCeKTRgAcFINMZSYDWLdPBUObJG,FCAEMADEZDEBDIDCLACGBFED.UEAG..JCEEHECD.EHFECGFAeECHhAAAKAAD...TCAChABAAGGG..NBHGSHAAhABAdEHCOABCaBHF.....fHABhAHA..hAIA...,1,-21,-41,20
JKOYACIHSETXZfbQGcDaLNFMUVPWegdBR,CGHDHBAF.EGDDXGEBZGFGQEEDDCDCLEFCFFAGUCEB..hAAAVGBGeAECdBCCBACChABAKCAHAFBGSCHDhAEA..TAGAfGBAcAAGMAID.hAAAWCCB....hBAA...,2,-27,-3,24
MfTQcbALYGBKRVZFSUgEDOJHCWXIaPeNd,LEDEBEEBKBGHRFCEVFGH..FCDGUAGD.DHCAOAAD.HGFAhAAACADG..XBCGhAAAaFBH.eEAFdAGFMDAFhACAfCAA.TCGF...bFCEhABAAEIB......hACA...,1,-24,-33,9
LXNJAbcCTRKBVDUEOfIFdeYPHWaZQMSGg,CHDGRAFGBBCEUFCB...EHAAOACA..IEGGFCCB.eCDAhAAAHBEEZFAAMFFH.SAABhAGAGBAAXFEChABAAEEA..TGGADCIHdHGD.WECC.hAHAaAEBLBHH.hACA..NDBA,2,-32,-18,14
BZEfKATVHbUSDGcWQFRLdOYNIMPaJeXgC,TACCVFCF..HBCESGADDAGAGDACQFDEFFGDLDEGhAAAOAFH..IAEAhABAaCDDJBABXGGEhAAACABH.BBHF.EDHBAIHE.cGBH.REAE.hABANBIAMFFB...hACA...,1,-9,-10,1
UIMVKZFEDALXcTJbefSYGNWdaCPHRgOQB,LADHXEDB.TABHeCCC...SBGGGCAEdABHCGHAHGDAhAAAOHDGBEEFIBHAhAAAMIACKDGCEDGAAFGAcFABhABAfHAD.WAGFaFFA.....hAFA..gGGHhACA..,2,-23,-5,18
DgQBbdVXLaIUZJcTKPSeRFHfMGAWECOYN,CFDDOBAGDCCH.BHEFdEFALEADUEFD.ZCGFJDCF..KADEeAFFhAAAHAAAGEAE.AGID.hABA..EDDC.NAIA..hACAQGBGbADFaAHB.IHHF..hAAA..cGGCSBFChACA.,2,-28,-23,5
FHfdcUZBPeJKQGDORWVgELXaNMYIbTCAS,SBDFHCBGdGBEUFDGBEAAeAECKHBGDFFAOFGF..RFAC.VAAAhAAALDEG.aGHFNCED.hADA..MABB.IAHDhAAACDGGAEIBfEAHZAEF.....hACA......hADA...,2,-33,-12,21
KEQebfcdZFVNCOMTIADLUgBXJHaSRGYWP,DFAFLDDBBABFHCBESFEHGDEA....PBAAEGGDbFBGhAAAdBED.FGGA.CBHGMIFAhAAAIEHGADHA.XADFhAGAJDAARGAGKDFBeHBC.......hABAfCFD.hACA...,1,-12,-19,7
QDbEcJNHVKdTYFLaPeXUCRGfBIASWZOgM,SDFDZGFAMECHDCDFEGDB....JDAHVEAD.dGGGFAHFaBBEeFFGhAAA..CHHBRAEABDGBhABAACHC.OFDF.QACDhACANAAAKECC........hAEA......hAFA...,1,-25,-34,9
fYGObBgCAPKeWTREQXaZMcVdUFLSDHJIN,eEDDRFCGECFC.QCABZCAA.MAIBdFHELFABDCECHFFAIGAAhAAA..NBABfGFAhAAAOAEEBHCDAFFAKAHHhABAXABA...aDDF..cBEBhACAFCGDSEAAhABA...,1,-11,-24,13
cfGFYHTBSLZCNaQEMDOJVbeIWUgRdPXAK,KDCEGADAHGBABHGFSEADCFBC.QCFBDHDCJBAB.VAAEhAAAeAFE..UFGFdDFEAAAChACAFEEF..LFEAhADAaDAFEAHBMIDGICHA......hAIA...gGBFhBAA.,1,-1,-36,35
efPWGcXdLYABKFEOSCITbUDZMagJQRNVH,BAHFKGBEOCAGCDGG....IFFETCDGDEABZCCG..aGBBJAAChADA.RBFE.HGCG.eBDChAAAPFFB..WCAFhABAXEGAdHGFABBG..SDBDMIAE.hAEA..NCIC...fEBFhAFA,2,-34,-25,9
MAdfTJOZXHKgSIRCaNDBGcWeVUEQbPFYL,dHAFJDDAZFGDHDDE.SBFAREBF.CCDF.DACHBAEAGBAG.eHBAhAAAEFDDQGGEhAAA.FBAHMFABfEABhABATAECKBHBIFFDaFFB.NBIE...hACA......hADA...,1,-21,-24,3
BdPfYWOSeJICFbZMGVARELcHXaNDgQKUT,EEFFLECEHFBBaADDDCADQBFD.KEHFBGGF.fAAFhAAAOFADJABACCBAZAEBhADAMAFCADDFRAGH..XGGChAAANIED.UGDF...dCCDYEHHhAIA.WEEF..hBCA...,2,-20,-16,4
JAWBYRHbGgCOZIaSTQdXVNcEfKePLUMFD,BAAEHDBDGEGACEDAZGFG.aEDD..SGCFTBFEdHBF.VAABhAAAEEHHKCBELADD.hACAMAIDJAFBAAIH.RDABOFAHhADAIFAH.QGEHXACAfGDChAFA...hACA.eAEC.,2,-28,21,49
fWcMHYgILKVNDRPFeTEOUJbBXCZGdaAQS,QFDESCEA.....fCEBWGFG.HDACIHDHhAAAVAADDEIH.FAHFhAAAEAECOFGBUEAHbDFEhABABADHCHBAdBBDAFBDcGCCYDDFKGAF...PAHHhACAeDFA.JFFC..hADA...,1,6,-21,27
XBfMEZGUCJKAdOcILeDVFYSRHgPNWaTQb,dCFHOAACLDCDDAFB.FHAARFFCHCCF..PCAHaBGE.QEGGhAAABHADEEBBZGBACBABADIF.hABA..IDGFhAAAeFFDSCCENCAC.WFED...XAGGhACAMIFE...hACA...,1,-14,-23,9
cfXPbSZYDMgaeHEVNGTdIQOBKWRFJUACL,CHEFLBFC.XEADbCBE..ZBAEMDEHaAGH.HCFD.EGHHhAAANAIA.dADA.QBAGhABABDGBRFAEFGHDAEHBPHAChACADGFAeAAA..........hAAA......hABA...,2,-31,-1,30
OVeFINaHcUTPLfJCQgbXdGWKBMSDZEYRA,VBCEeACAFFGC..aGACHCEF.UGAETCACLCDF.JCHFhAAAQBGD.hABAXGGBdDAGGGCFhACAKAFEMFBCDCCD.EDGHAHHGIAHDNIBFfAABhACA.CHFBgFDAhADA..,1,-2,-13,11
UFEgWIJAVPZcbYTeSMCGfOLNXdKDRBHQa,VECBZEDC....bCGBeCBF..SCBCCAFHOCHBLBAChAAAXGDC.KGFHDAGARCEBBAHGhABAQFADFFAH.hACAECEHIHHHAACB..YAADMICE.hADAfGHG.hAEANBEBaEAA.,1,-9,-34,25
AeWYVZFXOLDGIUEBQMJHRdabSfTCgNPKc,eBDCVCDE.FFDHLHDCDEAH.UABAEGACBBBG..MFIHHGFChAAAdEBDaCHDSGAEhAAA.CBHF.gCFHhABAKEFHAHHB.ZDBA.OACGIAFC..hAEA......hAHA...,1,-14,-29,15
BHMDZVXcRNEQWLageTOPSdfUbIYFJGKAC,CACHHDDEZGFA.XFDARCDE.ECGBQFBE.LCABhAAAeHFCTDAGSAEAhABAfCCHIAHGYHBGhAAAFEHHKEFHACFHDBACNIDB.gAFEdCCC.hACA......hAEA...,2,-14,-1,13
BPNDZIcUTYCSXaeGMWgKfHEFAOLVdbRJQ,OEAEVADH.RAAEBBGGDGIBZGDA..UEEECGAF....aEFGMDAChAAAKHBG.HGAG.FDGAdDAAhAAAJAEF..PABFhABA..IFHC..cCGA.hACASDDD.hADAeFGB.,1,-26,-37,11
CeUMQgWDcYdfJVGbSTRBIANFXEPZHaKOL,FAGGEAGHHDBFKGEBLEFCUEGE..QBDADFAFdCBF.JEEHGDBGhAAASHCEBHHAAAEEPABHhAAAZACA..aBHDCHHBMAIDhACA...WEADfGGH.hADA......hAEA...,2,-31,-12,19
ZQdbTKXEgBeaMVGHUWJIYALCcRONPfFDS,CBCBRDEHOCDB..NDFC.FEHHZGBA..dGBDKBECEBBBBECA..aAEEhAAAGEGGHBFGUEABhABAJAAD.AACE.LAGHhAAA..fGGGDBIBSDDB..hACA.TDAA..hADA...,2,-36,-16,20
fABaSTGYbFUCRLQKEIWPOMJcVgeXHZNDd,BHGATGCAGBEH.FBBCUGGGREDA.KCCCEFAE..IFAGhAAA.ODFCMBABJHBChAAAVAEAeEHBZBADDFDEADDCSAGEhABACHAG........hACA.....WDBGhADA..,1,-21,-31,10
gYRXTMJPHOAQFLaNIKcBSEGfbDWZVdeUC,FHCAaFAC.KGABBAHAGDFADGFE.ZDDB..eCFACCBB.RAAB....MCEBhAAAJAFEOEAGAIFE.hACALAAEIHAEEFHFhAEA..fDAG.bFCDWCFE.hADA.dEGF.YACGhAGA..,2,-34,-18,16
gbfKBDZNLeXYHUEFQMRcCSGAPIJVdWOaT,JCDHVEEC..dBACOFBC..aCHD..TDCD..fFFAhAAABAECDGHBNDIEXGAChABAHBAC.FAEHMHBAhAAACHHAACBC.IAHH.gBEHhABAbAFBKDBH.eDAFEHFC...hACA...,2,-35,-7,28
GMcZfXKTgHODAIaVSCJQbeYRPdWNFELUB,VDEDSFGD.CBGG.QADB.eDCDRECEdCAEFHBEECEBBHAChAAAMADBZCADKHEAHEGBhABAAAAE.aCGEJCHD...hACA..PFADNIED.....LAFEhACAcAGD....hAEA...,1,-4,-29,25
ETYHeRJgcQPDUXbNIOGBfLadMCZWKAFVS,SFGETCDE.HDCDRGAA..JDBBQBGDUAFB.bFEDOBAChAAABBDGLHAAhAAAMICACEFEZFGD..AGHFFDADhABAEDGEeABEgABFDFFD.XFAA.hAEA......hAGA...,1,2,-16,18
bMKEfeSRcVFJDZaIPUGHLYBCWANOdXTQg,OCAATAAD..QBDEMAEDKCFD.EGCEeDHB..RBFEVEEFhAAADIBAaGABUDAC..LFGDhAAABAHAAAGCNEICdABH.hACAbGCESHEAFAFEJDDH......hADA......hAEA...,2,-13,-11,2
TOPGALBXFMZDfQeHRKaSbNCYVWJIUEdgc,BFHAMADADDHFQFCBHEEF.KCEG..aAGDSHAACCEA.hAAAVABBIDBB.hAAAEGHHgAFBhABAOBBGAFBGXGBGfFFA.eEAFNBAE.WDEAhADA.JHFGcECE.hAEA...,2,-23,-20,3
eXPLRbGDOgFVZScTAUdHfNJYMCQKEIBWa,UEEDdHBFHBBD.JAECCCCGKFHHBDED..eBHFLFFBGGDHDEIBFEAEhAAAZEGF...TECHhAAA..fACEhABAMBABEBEB.aFBEXBGARAECOHAE...hABA.SDAHhACAABBD...,1,-19,-20,1
fcJQTIePABDYHdRbGUaNZgWLXMFOEKCVS,DEAAdECHRBGHUCGCZDEHLCAA..FGGCOAAEKEEBCAFG...SFAGhAAA.JEHDhABATBAG.IADEhAAAAIBABBEAHGCC.aAEGNDDG....gGAEhABA.MIDGhACA..,2,-47,-21,26
aTFHOdScCJgUVbZNKRGAfLDYBXQPIEeWM,DHFCXGEHQCFC..EDFCeABHaGCGFAEBdAGDCFFA..UCBFhAAAZFABKEHBABAELBHBhABABDDH.IGHCTADASFDDhAAA..cGAH..hACA......hADA...,1,-25,-29,4
UZBcaTbWHQOGFdIeERVSLCKXfDPYNAMgJ,JAAGUEEEBBEF..aCGE....TFGEHBEEGBCG.hAAAIAGAEEAEREDHSHBGhAEAKBACDFHF.NAGC.AGIHMACChAAAZCCE...WEBDOAHBFHEC...hABA......hAIA...,2,-30,-25,5
LQCfWSMPYUeDEcZFJTHOBRVabIGdgANKX,KCBGQBGDCFBG.SFFGMFFD.UEBEDCFFEHCEZABGFEFAHAFAhAAAOFHDBGHEaECC.hAAA.IHDGdACDADEDLEGDhABAfHAB.YCDH.cAFGhABA....hACA...,2,-30,-25,5
bAIYcgBfdRCWGJUZVeMHPSaOXDFELQNKT,..IFDE..cEBBBHEGdDAGRCAACFGF.JBGHZFCB..MFFEhAAASHEG.aAGGhAAADAIDFCGDEDDA.NBBF.bABChACAACDC....gGAEfFHAUGGAhABAeAEH.OEED.hACA...,2,-36,-10,26
ROPVQUFNZMfAJaGgXDcLTEBWHKYeICdbS,aFFCXGFBLHEEBFCHKECG..eDBGCDAH.SBGFOBBCQBFFhAAAUAAGFEGAMEADhADAAGBB..JCHDDEBHEACEhABAHFDBdHAH.RADF......PHAChAFA......hAGA...,2,-22,-10,12
BNYgSULFDCHEAGRaPOeWcKdfQZIVbTJXM,aFDFOAFG..eBEEKACCQCBCZCFE..IDDChAAATFFFMAAHBAHCgGFAhABALDECDCIDHBBDhACAAGIFPHBAdEACfFFHJFBA.YFCFhADAFBDECHFG..EBGA..hABA...,1,-4,-13,9
SeIMQODbGNXZJCVTYFgBWRUfEPcHALadK,dDCCSAEDMAIFDAEAGFDD.ZBFFJFEACHBF.....TACGhAAAgCBBBBBGUGCEhABAEAHBHDABLHFChACAaBABKGHHeCHDIHDHOBFD.....hAAA......hABA...,2,-22,-15,7
EKTHLbCSAdXOPRNVUJYaBGMDQgcZFfWeI,dHGHXAEHODEHRGEG.UDAC..JCDHBHADGAAFDEHB...QGBGhAAAZBAAFAGB.fFFDhABAeDFCKAEHLECHhAAACAGBADGC..NDIAaDAF.MEAF..hADAWHCA....hABA...,2,-34,-6,28
WUPcQNKgdYVMBHJOIFXCbZRSfEaLGTAeD,eBEDUBEEQGCEKFAFdCBH..MGFCBEFEOHFCFGGHCAADZCABRFCF.hAAA.ECGHGAGA.hABADGAAPEAA..hACANACF...YEFGJECAIFHASADChAGA...aBHFAAID.hABA...,1,-6,-27,21
JTKPCDIOfSgGVXYbQUWENZReHcBLFadAM,TBFDKBBACCGG..DFBGODBG..SFDAGAAFXGGGhAAA.QFAChABAEGBGNEAE.RDGHHDEDBDBEaEHHhAAAMICC..IDDFfAGD..hADAYBEH.WHBGhABA..,1,-4,-51,47
IfVPRZAeYJbNCdHXQWTFLOSDKUEcMagBG,JACECHEEHDFG..QDEDTCDF.OBHDKGCHEGAA..aECBBCCFhAAAGBAAVAFDRFGBAGAEeEAEhABA...bFFEXGCDhAAAFABE.SHEEDIAG.cAFEhABA.....hAEA...,2,-18,-11,7
XeLbFPDUOGIcVYJgQaMKCZRBATNWEdSHf,TFEAEGEBHFGB.eAFFFDGHDDBFGDAH.VABEJCCF...aBHHCHGERAFChAAAADDE..dGCC.SEFHhAAAfGAB.XADFhABAPFAB.IHDD....hACA......hAGA...,2,-41,6,47
SBWdLbTRXaGgEcJfYHIMZFPeKOAVQUCND,UFCCCBFGDHEE.BDECLDBDRADA.GEDBEFEA...JACHHBBHZCEG.hAAAeEAFABHA.VBGFSAEFhABAdHGF..XGADhAAAaGAC..cGGEIFHC.MABAhAGA..KDHH.NIAH.hADA...,1,-6,-30,24
GLHBKFZVISdTJUOfeDcYWQPMgREXaACNb,CBGFGFBFHDACFHDAZCFASDCC.dGGEUAAF.eDDGDAEB.hAAA....WCGHhABAPAFGMDIF.RFBCEGGBhADAaDADAACG.LBACBBDEIHAEOEEA..hAEAYHCG..hABA...,1,-16,-25,9
CDdZNIKMXGOALfceTSUEPRBHVFJWbaYQg,LFAGeCEBUGBDRCFFBHAFFHGA...JABGaACH..QBDEhAAACADHDGEE.dGGGZBAHKCCFGAFChAAAADID..fEHEhABASDDDEHBC.....PEEHhAFAWFAF.....hABA...,1,-19,-36,17
aObcHgfWBYPFLMZNGDJURAQTVIedXKSCE,QCBFTEGC.eEHHdCDAKFEH.CDFF.EAAH.aADGOACCHBEHfCGChAAABAGBFHCAMCFEhAAANHABDFFA..RBADAHHB.hACA.IEDDXFABSEBD.hABAgAGE.hACAPHEE.,1,7,-23,30
KDUbVaYFJLOdeAfBWcHgQGXNCIREZMTPS,BGBEHGEAGCCCCFEH.EBBDZABDMBFDSFCBUEGG..aGBFJAFChAAAOABAAIDE.fAGAhAAA..WEEChABA.QGGD.ICEDhAEA......hAIA...,2,-52,-9,43
YVfKCHOMIBFUaLDeREPbWXcSAGQJZdgTN,GEABQDBDZFFAdAAH..NCAG.VAEDCFHHHGCE..MHDCIBGEhAAABBHEaDGBLFFHhABADADH.eCCGEDDG.bABEhACAXGADAHHD..gGAF.hABA......hAEA...,2,-21,1,22
NOHZBQLCMGSRaIETJFKPXUYWbdefcAgVD,DFBHHABDZCGDQEEBLDBCGFDHaCFEEEHHFFAAKACF..UAEGbECH.hAAA...eADHAEIF.hAAANIBFBAHACAHAMDADIDAFhABA..........hADA......hAFA...,2,-36,-3,33
LbeNPMfGcAJRdZEWYSCXFaIUQOKgBHTDV,JHBAdAEBEEED..SDGACGCD.FADDaHFC.QCFBhAAAKAFHBHFGHCEHDGGELDAFhABAeABB.MIAEGCAGhAAAACDDRABH.ZFGF..YAHHIAHG.OEEHhACA..gECDhADA.,1,-12,-23,11
UTAcEXYKNbPQWCfBaOIHVgMReDSFGdLJZ,XFDFKCFF..NAEE.QBGC.CBCBBDABOAAEVFAFhAAAMFHD.DGCCFDHDGDAChAAAdGGAZCCCAGFD.EAEAPHBChABA..aGCDHAGF.eEFCSECChABA..JCCF..hADA...,1,-5,-23,18
XVOHYcgALSIEPFTGMRZafCQdUBWKbeJND,SHBCEHBAFDGH.MCDHZABECFCE..dEEHBGHCKDBF..eABBDECEOCCGhAAAHAFA..cGGAhAAAAFABLFEH.hACA.TCGDaDAGQBGEWFAGNICD..XADBhAHA...hABA...,1,-2,-38,36
JOfGWYZaQBeKUTCPcISbMRNVALXgHEFDd,XFFCEACDFECD.DIDEdBFF...OBADGDEBZFGDQFAGhAAAKCDBUFED.TCAF.hAAACCEEIHHGMIAGNAEH.hABAAAEFHAGH.WDDFBDHGeBAE...hADA......hBAASGCA.,1,0,-23,23
UFSQgEAJHCLBbaWdYMNPDVRIGfOZcTeKX,JBBCHEDFLAAFBDEBaGCH..dAEHMFIBDFCH.RBCC.GAGCZBABeFFHhAAAUEDGFBGG..QGGBhACAAAGGCDHA...hABAbFADWFAH.........hADA......hAFA...,2,-26,-17,9
PRYVEXMaJOLGTKeBbWFANSDcdZHICQfUg,SGFCDCBAdAFAHEEBQBCGUDGG.RDAE.EDDHMAFB.aACALAAFhACAGGABKAAHBFBFhADAFBGFNHAF....IHGGhAEACDGGfGHC.YEEA.hAHA......hAIA...,1,-3,-29,26
JYaZKUWOdgAICeScDVNfRTMGPHXQbBFEL,CHCAeHCADBIH...VCFARFDGGABEHEDAQGGFBAEC.FCCHJDFAhAAAaEADZBEE...KFBChABAOBDG.dBAGIHGGhADASAHB.NAAH..fFCEhAFATGAGMFIH...hAGA...,2,-31,-6,25
BCVDHeASIOgTcWGKYQbXNdLJfPaZMRFUE,OFDETCDD.GCBFKGDE.QGBD..bGFAdHGHJBFEaAGGhAAAMEAGFEAFEABCBFBDDCEEhABAeBACACID..IHEGhAEAWHAA..NADB.PDFERDFACCCF....hAFASAAC.hBAA...,1,-11,-15,4
LPBHQWCGeVMFKbTgEOAfYXSdRUJDcaZNI,XAEARADHUCGE.DFAEZGFA.LBAHBCBBHDBC.QGGChAAACGDGeFAA.MCHDKCCD.TGDHhABAEHAG.ABDBSBHBhACA.dHAFaEECIEFCPAFG..hADA..WAAE..hBCA...,1,-5,-32,27
BCFAZYaLTKWOdIHENRUMDSQgbGcefPVXJ,aGBFLBGH.KGFCdEAHHBCFEACARDEFMFEDDAGF.QGAFGDGGeCDHhAAA..fABAhAAAXBAHBHAAAFBETBEBhABAOAHDIHHDNIEH.SEAChADAbGDC......hAEA...,1,-2,-16,14
ZWSUaDgKOAPCRfYTLEebFNMcXBVIGHdQJ,RDBCTACBEGFD..eAGDFDDG..MCADBABHGDGGHEFCdDAC.ZFDHhAAASGBDDCIDOBCEhABAAIGEfBABhAAALHAA.bGDG...NCEHXFBFIHHG..hABA......hACA...,1,-7,-19,12
APBSLHFZNCGVIKERagXDbOUWTMdYecfJQ,SBFAFGGAZBFBGFAFKBBA.RACE...aGEDDFDCUDEG..MBAFhAAAeFBD..JDCEQGGAhAAABDHALHAAhABANAEBCEHH.EHFG..XDAE..WCAHhACA....dBAGfBHAhAEA,2,-32,-18,14
bDTfRFaVQdHIZAPeJUEOgYMKGBNXScWLC,JBBDODEA..MHFABACF.SHAGLDEBDEABRFEG.FDDHVDCBhAAAdGBDHBFEZAECAFAF.eABEhAAAEBAB.KHDG..NIEH.hABA.....WEHHCFBE...fGCEhAFAIAHG...hAEA...,2,-30,-19,11
aVKUYEcOTZHAJWGXCgLDedIFfRMSBbQNP,JBEBGACA.CHBCDAECeAGF.dGAGFEGA..MCHFBABA..QGEDhAAAaGDB.VABChABAKGGFEBFG..OEAEhAEATEBHAIHE...XFEFIEFGfAHEhAAASGGEPBABhABA..,2,-33,-31,2
faHeGgFWTCRAUSdXcDEBMQPYNKVLIbJZO,dDCADGFHMCAEQEGC....PEEEKHCAVBFALBHFhAAAJEAFZBBGaGGF..eAAAhAAAGDBAFGFH.TBEDhABAAHAHSEDHEGAH.BHHEIGDF.fDAAhACA..hADA.WABA.,2,-15,-12,3
TcMUYDGEFeCBgQOZbAaPHIfJVSNRWXLKd,HACAJBAH.SEHDREFDLEHBKCAB.dDEDMHCAUGCF.DFAFEBFFCCCG.hAAABHBG..OFDAhABAAEEB.aBHBIFBHhAAA..NAEBXGGCYCCHFAHD.eAEChABA.....hACA...,1,-22,-24,2
WAMSPFaZENLXeKHdGYBRDfJUIQTcgCObV,SBGAFBHDZFEELAEFKECAHFECGCCABACHDFIDUAAC.QCDAhAEATAAH.CHBDOFHDhAFAbBFB..AADDMHAAhAAAEHDEeAEAdCAHfHEHIDGA...hAIA......hBAA...,2,-15,-9,6
PERQBIATZMgfNCaGJHdbKOcVLWFXeDSUY,MGDA..fCEBaCEEHFAD.dFBGKBBCODEHLHFCFGHDXCABhAAAeFFEDDADSDCGhAAAPABE..EFGAhABABHDHAEHATGEEgBDCNCDGJAHH.bDFAcAEFhAGA..WAHF.hAIA...,1,-4,-14,10
KQeJEfHYMCGOPADgbVIdSBUXaFLWZTcRN,DBBEVAFEdFDC.UBFDFDGFLEAB.ZEDBTCAA.RFEB.KAAChADA.QGGAhAEAEHGAHFAHMEEACCDGOCBFADDC.hAAA..IFFEBAHEWCHHNICB....hABAfFCA.hACA...,2,-28,-14,14
EaTgPGNXUQdCBJbecARKHLOMSWDFZIYVf,KEBCLGDEOAGFSFHH.FAGEIHFG.VEFGhAAAECFDTADF.PBBBhAAANCAGUBCB.CDFFBHHChABAeEEGAHCFHGAADCGCfDCHaFCE.gFAAhABA..hACA...,1,-21,-26,5
cOgFYDWPIQdeGbNUZBVJXMfCRHESaLAKT,KABFOCFHFBFH.DFID....IDDAdCBGeECHGDGGUBGHZDDFhAAABADB..JFAFXECGhAAA.CCHERFABSGGHhABAACDE.gACEPCAB.NAEB.fFFEhACA.aGEHhAFA...,2,-36,-26,10
BDZGeUMbcPAERKQOCLdWXJYIgNVFTfHaS,ECCCQACHLHACdFCC..JHFC..IHHBVDFD.FAGFTAEAhAAAaEECBFHG.DDDGhAAAZBABeBHHUAGEMEAHhABAPEDFKGDC.CADC.WFBD.....gCADhACA..hAEA...,1,-12,-25,13
gXHaGPDSfTCRMeEQYVLZdNFcBUIWJbKOA,HBADGADDDAEDSCAACEDG.MEFGEBGAQGDELFHDNDDDBECFhAAAUFAA..IHGEhAAAbGCG.ADDEXDGEhABAfGAG..eFFE..YABEhAGA.dGFA...hACA...,2,-26,0,26
fSbedcGLVQMgYABKJOWaXEPUNCHRZTIFD,KDBGOECB..aAHFEFEDUFGHHBGH.ZAEDFGCGSACC.hAAAeDHHdBGCLFAFhABAQCCEgACChACAAIBCBHHFWFFHXGEDPAAHCDFG.....hAFA......hAGA...,2,-31,-2,29
XIJaEdAFcNPUfWKDLgVHbOGCBeRZQMYST,FACD..PBFGUFEBKDGBDBBCLECFHCAB.OEFBBBGHeFADhAAAZADFQGGHhAAAMDDC.TCAEJECDEHGCAEIF.hABA.fGAE......hACA..WDHH..hABA...,2,-36,-10,26
aUPYTCBJDbgXZQLcSWFNOfEHKedIAGVRM,RDFGMFDBUBDC..TEEBCDAC..DGFHXBFBLCCD..SHGGhAAAFAGE.OCBGhABAEGHHKGAEdACHAHGH.aFAChADA.BCEAJAAE.ZEGFQGCENAICfHAFhAFA......hAGA...,2,-35,-15,20
XZROacKILPVDENMgCJSBeTbFQGHfUdAWY,XBGGZBGDRACE..aABHKDGBLFABDDAB..MFDBCDEBBGHFeCCGhAAAFGDCGEAG.HEEDhABAdDCGAHIHOACG.hAAAIAHGECAD.NIEBSBBF.hACA.bFFFfGGFhAGAWAGF..,1,-2,-33,31
XHKPUcJQTgGFOLYbBAeWZfaEdSCRVMIND,ZBEDaBHH.dBBGRFEF.MIDADCGB.HGFC..KGBHUDGFQBDHGEBHFGAGhAAAODABLADFhABABBBDAHIDeAFE..EDBEhAAASCADCACH..IHGE.hACA..XEGEhABA.JEDD.,1,5,-33,38
JDEAdNMQVHXRbTLBfUFIPgWSZKcGeYOaC,dAEAQGCHHCAGXEEHRDDGLACA.BEAHUGAHFHGE..PHDGhAAASDCDKCFGeEBAhABAOAGF.CBAGDGAGhAAAAIHENDIA.MDIB..TACBIFGB..hABA......hADA...,1,-9,-25,16
gKDRJZNMdSBUAOTHXQIYEGFVefWcLbCPa,TFADXGEH..QADCEAAHGCAAeAAE..fAFChAAALHEGCFHGaGCFKEFHDAHDhACAJDDGMEECBCHEOFFAhADAIAHDYFAFWFCH.bCCF..PBBBhAFAgGGG..hAEA...,2,-13,-7,6
CXDJGWLcSETAQYdBeKMaVRHPgUfOZbFIN,dAHGeCHBKCAAMACAREDD.HBCGUEBGZGDC.FFBF..CBFA.DDBC.JEEGLHFChAAA.EDHFAHAFBABDhAAA.aAFEPACAhABAOFGF......NDDF....hAGAWGAG....hAGA...,2,-40,-18,22
MJLaWYIXTcgdSBfPKNVACEFDQbeGURHOZ,CGBHFGHBDGDCeACC.RCAH.HCADZFEH.MAEHLDFC..aEEEIAHFhAAAXAFH.TABChAAAdEDCSCEChABA.BGBEPDHDKGADAEHDEHGE.....hACA......hAGA...,2,-24,-20,4
SdVLTBeIXcAKPZEYMWOUQGaJHgDbNCRFf,ZCFBECBG.MDHFOCECUCDEGACD.aFFFHEBF.DEABCHHARDAESCAAhAAAdHCBLFAHBBAGhABAeAAC..IHAGhACAAEEFPAHFQFDCbEGB.NBEB..fGHAhADA..hAEA...,2,-26,5,31
HZdFDfSAOEIbCegYMKGaTUBcQJNWRXVPL,EBBCCBGF..eEGFMFHDKBAFGBEG.TFACUCCCBFDD..hAAAJHCERGAG.XDAChAAALFEBdCDGDBFHSAHBhABAAHIH..IEAB....hABA.gCGChACAaCHHNACB...,1,-5,-44,39
MVXPQSZfYeWULEGTNBaIDdJAOHcRbKFgC,OBFFRCBHKEDH.FHAGMIDA....PHDGSADD.ZDEHhAAAfCAAeBFGLGAChABATDBEBHHCIABDhAAADAEEAACD.HDGB.cAGACEHE.XACDhAEA.WDFDEHAC.hAHA...,1,-15,-28,13
TaVIEPQUeZONSbfDFgRLKCdMYBAGXcJHW,GCFEJBBCHFGFaFBH..EDDCUCBCZEBA.ODHD..SFADhAAADGHHFAAERBDH.CDACMBIHhABAAFFF.XGCG.hAAA.cFDC.TAGEIFFF.PBGFhACANDAA....hADA...,1,-17,-25,8
KdASPEYFQUVgNIfJeOMBbLHRWcGZDCaTX,SGBEECAAFDCF.UDAG..VEEC..IFGGeAACOEBHhAAABBBCLDDEhAAARAGDGGCHCAFFaFFH.KAHBAAEB.hAIAQACG.NIEFMCEC...hBCAWEHBDIGG.XGAGhABA..,1,-13,-21,8
BKTIbNXgLGCMdDPUVRQOEfcHWYFeJSZAa,KDAGTCGG..IBGA..XEEAGCDGCFHDdFBEDFGDPACGhAAA.UCCAQFBEhAAAOAFCEFDDcACBhABAHBAF.FGHBSFAFAIECaHACBHFENIDBMAIFhACA.....hABAfDGB.,2,-28,4,32
LDfNAVIaRcYZBWHFGbdXPESMOUgeKTCQJ,VBDDaGEC..RCBBZAGDBAFCHADDFGDD..dCBAXEFD.EABAMGFEhAAA.UDGBKGAHCBAGJHFAhABADCIB.AGCH..IEEGhAAA..WAHFbFCD.OEAB.eABChBAA.....hABA...,2,-27,-18,9
VIcEWBFOXbJgNKdLfAGSQZMDUeaYTCHRP,GGAFZDDFUEBBaABH..CGHAHAEARACB..IAEDEBBDBAHBFDFA.hAAAOFFGJHDG.KBGGLCHDhABAAHGB.MCAFhACADDEFeCAB.........hADA......hAEA...,1,-24,-27,3
VcUbMHKEOfPDBYAZFCWGIaeXQLSNTRgJd,FGBBCCGDGDACeDFELABC..SFHBTGFD.JFCGVECAhAAAUBAHHBCAKAEGODEChAAADFGCAGAFZAFA..aHGChABA.....XAGB...hAGA....NIBHdGFFhACAMCBF.EHCC,1,-3,-26,23
fCLATcSgIFdRJGKBbVYEePQWZXODUMaNH,TGEDSDEC.FAFBJDDFBCHC..VAACeHFE..QGABhAAAZCAEOECDDFFGMEIBhAAAaGGAHBDACFFGLABGhACAgDAAdHAHKEFEEDGC......hADA......hAEA...,2,-16,-15,1
RQFgDJVfHUKZOPLWcSAdYEGTaNMbeCXBI,dDCAEDHHGCBHaEBB.MIBECCAABHAD..IAGEFCGA.DCAFVEEEhAAAHEAA.KGHHOAEEhABA.LHEGhACAcGDAAFEA.NCGC.eABAXAAE....hAAA......hABA...,2,-28,-17,11
RYSMVIQgcFUbEXBaPATDfLdCZNGWKHJOe,DDIBLAFCCHHD.ZEEEGFEDHABHOBEERGBG.MEADQBFFhAAAFDEGEDAE.BBDH.aCADhABATGGFdGAGKDFFJHBASDDBhACA....gEBAhAAAbCBDAHFDfACH.hABAWAFE.,2,-29,0,29
HVdbJFQaeZKBIPWfGAXYLUSCNTEDcMORg,LCAACCGB.TEDDEAEGDDEE..MAIFREFDHABEdABD.FEHFaGFBeFCDhAAAZGAEBAEH..hAAAIAHAPCGDfEAFhACAXGADSDAC.OECGhABA.....hAEA...,2,-24,-19,5
agZbNHPRUBTIXAfMScLDVKYdEOGeFWQJC,SGEEDFDFKGFD.EBDFOBBG.GCAEFDFHQDAEhAAA.aHGEZFDBHFCFUCDHhAAAIBACAFABMBHB.VAFChABAdGGA.JFAFCHAENABBBFHB.XCGE.hAGA......hAHA...,1,6,-30,36
ASeTVLbBaGUQXMfCKIYFNgdODZEJWPHRc,TDAGLBFB.BBHBaHDC.QDBF.MACFCGAAIDFBhAAAFGGGdFDFDADEEACAJFHD.hAAAHAFGAGAAeHDEGFCFhABAfHABKDCCNCCF.OBAB...WCGHhABA.....hACA...,1,-13,-15,2
DHWYRPMFJabBTCALdXScNgIeKGfUOQEZV,dBDHXEABSEBB....cEEAIBHC.eEFGhAAAKABFUFCFEGGFZDDFDIDEHFAFhABARFGFFAHFaAGBBDCEACBDNCAA.hACAfBDE.OAGH.WACEhAAAMFDF.....hBAA...,1,-3,-31,28
WLEYgBZDGHNfCTQdXbMKRcJFePaASOVIU,VBECUEGGECBD.BACHZBCBGGAF.HBAHCAHFQDDChAAAdGHEMFACKDGARFBE..JAFHeFEBhAAAAGFF...OFFGhABAIEAH.....WHCG..hABA......hACA...,1,-5,-40,35
FCDSbOfgAaZGTXWcMeUQVBINLJYKdHPER,ZDFEGAED..XGGAMDDBQFGGBDAGLFADKDBHHFDBhAAAEACEFBBDSEADhABA.fACHhACAAGDDaFCA.WHAGeCECICHBNICH....hAFA.YCCC.hAAA...,2,-33,1,34
XZKESUeFICaHDWcTRLbJMOgQNVfdBGPAY,ZCBDKAFGUEBHeEFGCBEEHAAB..DIAE..TGEERECHLHEE.hAAAMACCQCEDhACA.NDAEdDHGBGAHACDHEFFEhADAICHG.aAACcGCHOAGB...hAEA......hAFA...,2,-29,-18,11
PgaXMOTdUeFBIQAEcWNCYDfGSZHKLbRVJ,EGEA..NDEH.CBECDGIBGDAG.ZBCHKBGDRGCA...JCEDaAAG.MFEAhADAOEAB..UGGFhAEAFABHBDCHAIAC..cAEEhAFA..fEGBSAHDLHDGhAAA....hACA...,2,-52,-13,39
QPDcHebdCJESWaIGgfXLUKNBFYMTAZORV,RCAEQDEEDFFEHGDEdBGHCGCB..EHBE..SHBGaHFEGABEXDEGhAAAKADCFEHFMAADhABAAHADOGAA..PBFGhAGAeABC.JGEGIHHE.gAEFhABAfEDG....hAHA...,1,-10,-15,5
ZcfTNaJbABSYeOdQDUFgIPEHWLMRXVKCG,BGDCSFEGOEFCdAAAUFACFFAG......IEHGhACAEABALCCGMEDAXADGhAEACBDGZAEC..cGDDhAAAfHCH.NDDDbGFEAIAEeBAD.DGGDgGAAhAFA..hAGA...,1,-27,-30,3
FIASWUeGMHPROTJfgXDKdZCVEQNacbLYB,SBDDeBFCMCAFHBCDRBFD..OBAFfFECDEEHKGGFZFABEFGGhAAAQGFD.hABAcDGGLEAGBAAGhABAFHCCIHCEAHIFWGACPADG...hACA......hADA...,2,-19,-12,7
eWScDKZbPYJLHaGVUITRANFQfMdOCgXBE,FEDAMIECOAAH..XBEEeDBD.SBCHKGDFZAGD..hAAA.bFAHJFGFLGFAhABAaAFD.VEFE.ICADhACAAFIHfAECCFDEBDHEECCHDEBC.YAEEhADA....hAIA...,2,-33,-16,17
MSXLWHCYENBZGVTgJbIPFcUORAeQDfaKd,DBEBaGFB.dFBD..MCEHSAEELBFGHCBDEADHBCBEGFEH.hAAATDEFJDGF.IHBFhAAAFHBAODAB.AGBAeFDBhABAfHEDKGHBCAHF.ZAGB.gABChABA.....hACA...,1,-2,-22,20
bDFeGTcCXSIANfPOJRBZWVYaMgdEKQHLU,...fBFEPDDCRAGFZAAF..VDBEaHGC.dEGB.EHFEKEAGQGAAhAAAUACGDFHHeGBGhAFATABD.CHDD.SGDEhAGA.AIDCNCICBFEA.MAFG..hABA......hADA...,1,-17,-20,3
LKRUaDSQBHGcOXICAfJeEbPZFYVTdMWgN,JEAHeEBC.EFFDZFBBFBDB....VCCETCGEdEFG...MBAFhAAA..NAADLHEAhAFARFBADIFEBHAFHDGF.OBDAhAGAIAFBCBBGADIB.fCBC.YEHBhABA..KAHFhAIASHBA.,1,-12,-18,6
KHRMTSWVYFDBPCIOUGLaQEeNdfZcgXAJb,KGHDMFAF..TGCFSFEB..VDBCDBGBBADFCFEH.IBBEhAAAOBHHLAAEhAEAQFBAeAECdHEHfCEEhABAZBBC.gEGDAGBCJBFD.hAIAbCAEWEFHFBHF...hACA...,1,-13,-29,16
OYCRZGKEPJdDBWUbfHaeISNTLXFgAcQVM,VEDDMDHF..OACACFBB.ZFBEEACE.dFHCBCEF.UAGGHCDGaAAHhABAeHAE..SGDAhBBANAEHLAAHFDBFABIB.hBAAQGGF...YDDGhBCAKGFHDCCBbBGH....hBCA...,1,-13,-16,3
NUZDeagWMCQdIHGKBLTSEXPRFJOVbYfcA,UFDDZFDBaAFFMEEE..QAAFdBGCHBBFKEAGLDDC.TEBFhABAXGGFFDHFOHFEhADAVADB...fBDDhAEAcGAHAAIHDDIDeGFCCAACBHFHSAHBhBFA.EHBA...hACA...,2,-23,7,30
SOPUTCZVGaNXJDKRAEQgcLHFdbMfBeIYW,QBFELFEEFCFDdBCAMEBHBFHB.eHEG..ICBBhAAASFAAOHEATEEAhAAAZADGaFCBXBACDCADAIAA.hABAEGHB...cAEGfDHGWEACCHCE.hACANAIG.KAHB....hADA...,1,-4,-28,24
XUAQaJfLceVBHPFNCgTIYdGRMDEOWZKSb,JDHBLDAB.eCEDBEEDHBACFEAF.CGCE...TCFBIAFAhAAAdBDBGCAFMFHFDCFEOGBChAAAZEFBKHAG.bFDDAHIHaACGhABA...fAGE...hABAcGFA.NIBH.YAHHhACA,2,-41,-6,35
KOfSIVLQEdXAUFeCBgDJWaZGRTPYcbNHM,FACDBCFEDEFGaAFAZFBCGCGE..RFFC...TFEA..PHAEhAAAbBBC.HCDDOADChAAASBAF.hABAIAFALDAAdAHEAAIHCGHA.WFDDNIEBMEAAhABA.....fCFDhACA,1,-16,-30,14
HXVCYRKMeOWfaFTQNAGUgPdJZLbBDISEc,UFCFdEHAJDDCZAAF.LAFGBAFE..DHFGSACHHBBE.CHDD.hACAKFBH.OGDG.hAEA.aDFGQBFBhAAAAFGDPFHD.EHAG.XDBGYFFF.MEBGhAGAWABE..FHACNIDH..hAHA...,2,-28,-26,2
KVgSCGOfBdNFAUeZPYaJIHMDRWXcLTbQE,eAFGZECGaBDGHACC.MFGFDGGERCAD..XDGELAGH.QGCDhAAAKAABVFDBCCGBOABFhABABDDFFDAEAAIB..PHFChADAIHAH.WFCF.....hAEA......hAFA...,1,-12,-25,13
WJTSfQXRHgaCVLbMdIZUKEePNFAGYOBcD,GBDCBGBFDGDAJAAA..SBCAQCGCHDAE..CGHAVFEChADAMDHHdAFDZGAEUEAFhAEAEEECeHCC.FAADABGA.OAHDhAAA...WCDA...XGGChACA....hADA...,1,-22,-23,1
cfPeDVIbdXgJLTSWUNKCBMYQEZFAOGHRa,HABGRFFF.aEFA..fHAFDGCH..bFDHXABCLGFGhAAATDDFSCAHhABANCCCBHDDMAHB.ECCBAGAFOAFAhAAAcCEGPFAHeDFEIDAC.hACAdBGD.....hAEA...,1,-11,-12,1
RcJdbWBFeLQOCgIPUMfNETHDaASKYXVZG,SEFFXEFGGAFERAFB..dDADBHGFeBDDOECDCGFA.ICBHhAAAUFCHMIEGEACADDIHhABAAACCKBABZFAF.bDDBFFADhAAA.LDHD.......hACA......hAFA...,1,-18,-20,2
AdUCcGbeBLMQfTOPDFIVNRSXEHaYJWgZK,dFGDCBDCGEFCBAFBMCAB..QAGF.OCDFDDFDFDCGhAAANCBA.RBEEEHDEHFCH.aFHFhAAAJABD.ZEBEAABGbCFGLBHHhABA..fHABIHHH.SCCDhADA..YHAAhADA,2,-25,-21,4
FVBDUEYMRCdaTAINSbfXJLKQWGOgePHcZ,SCEHXBAELCFHQAGDGEDAOAABeADGHFAFFGGFBHFDhAAADGHHUDCCMCHFdGEFhABAABDF.IBCC.hABANEIC.JHAGKCGBgFACcAEB...ECEBhACACEAC.....aAFAhAIA...,1,1,-6,7
dIQXYSAJLaRHWNFTfMGUcBCVDEgZePKOb,aEEHHGDG.FDCEMBFFUGGABCADDFAH.ZCFBKHAGdGBF...QGGAhAAAXAAH.SCCChABAAEGGLBFG.RDAB.NAIE.hACA.fEACCFDEEADF.eABA.OHDChAFA.....hAAA...,1,-3,-27,24
YIEFHZVPfLTQeaMWXRNGJOUcgdCbDBASK,KGDDEEGEHAAGZBDD...VFACLFEB.TABBaADFMFEBRDFGGDAEhAAAJFGHUAFB.dDCDhAAACHBABGGGADFH.IAGGhABA.FCGA........hADA......hAEA...,2,-22,-15,7
ULaVJNdHIEGgSBMTRKZCDcWOPFXfYeAQb,QAFBLEFGJCBBHBDDGDCASGFEBBHH.TGAGKAABZADGhAAACHCADDGH..OHEAhACAXDBCeHBGAAIHaAABhACA.dHEFECGBMDABWDADFBBF...fFDHhADA...hADA...,1,8,-25,33
LQONWEKAPYgIXRSZfMDFGUJHBTCbVeadc,...PFAGIEECRBAC.SCEGZGEADDIHGBEAJAAE.BAAEhACACBHE..eFAFaAHHLDAAhADAOGFEEDBDAAGH.XAFFhAAAMGFCFDGDUEGF.TFCB.dHCDhAEANIAB.KCCH....hAIA...,2,-11,-7,4
BfNHTbQIKdaegOZAcUDCMEXJWLPVGFSRY,DBGAEDAA...XCGHLEDDGFCBFADCSGGGBDAHHBCGQFAGhAAAIGHHaFBGhAAAeBAGOABGAIECUAGHMFADhAFAPCHH.YCFFfDEH..hAGA.NIDB.....hAHA...,2,-17,-8,9
dRQDAKVEbOISHecGBXgWZaMfYJPTCULFN,EDDAOBHBHFFGGCEGBAFD...XGBEZAGBaHEEMAADJDAACABELAFEhAAAFGAFdGCF.QGFDhADAACFEKEFC.bEACeBBAhABA.gDAA..fCCDhAEA...PEHDhBAA.,1,-6,-14,8
gFZaDRPWfHTOXICJLbUeQNBSYEdKcVAMG,MCGBGGAFFACDaBBF.DGFDRDDF......fGHATDACIEEAhAAACBEHLAEEUADAhABAeCHBQDGHhACABAACSCABdBGBKGGHAAGG.PGBCWDDD.OFFHhACA.....hAIA...,2,-16,-15,1
SMIKYXRBJTAdNFWZOEbeaDcfgVQHLGUPC,FBCEOEEEeGDEDDAD......fEHAQBEEHEABhAAAGAAEUCFGCGHCSEDDhAAAKAHHXDDHBHDChACAADHGNADB.EGAH.aCHDcGGEgAGHLABFhBAAMDCF.....hBCA...,1,-16,-18,2
IGHZRCKBMATdbgJFYWaDVfeOEXQNLPcUS,TDEGdFBFJEHD...FFHD..aCAEDGGD.eDCDOEFH.EAFENIABLAFGhAAA.UABDhACAIBEDHCGDCBEGKHAAhAAAADDD...gCGHYEAF.fDCHhABA.XACFhAHA.QGCF,2,-19,-18,1
dALTDNMOESFaQfKUcZJBgHWCXIVeYbPGR,TBEGMEBE..SBCBQDFEUEGAJCAEBHCEHFADCAEG..hAAAIFABeGDGPCFAhABAdGGHDEDF.OACAhAAAEAFGFCAGKBHB.ZDDHXEDE....hACAYHEA..hABA...,2,-23,-5,18
aLeACJFDXVfTbKIOEMZHGUYQBSdWNPgcR,CHEHDEFB...VGBATCDH..KBAGEGAFMAFEHEFC.GADDhAAAQDBGBEAEdABE.hAAANGCD.gBGHhABA.aGGFADCBFHCG.fDFFIEGCOAEBhACA....hADA...,1,-14,-34,20
XGWZKcVMbfeSgaRCDTUOAQJFBdLHYPENI,QEACJCAGBFAF.dABGHECHEFGH...XAEBZAFEKBDDMEEFhAAAeCGD...SCGDhADARFFDCBACDDDG.OCHFhAEAAAHELHBAPHAEICHCWDEB....hAAA......hABA...,1,-8,-31,23
PYBVCMNFbGSeKWATaJRfIXHLZcgDdQEOU,JACFRDAA..XDGHZAGFDGBB.dBGD..OEEHUFAHBFDH.CBBA.hAAAFGGBGGEBKADCAECG.aBDBhABAHDFE.LBAHhAAA...gFBB..EDFFhACA......hADA...,2,-32,-28,4
WQXbUAMaSNLEPZfRcYeJTgKHGdOBFCDIV,SEADLHEAZBDHRFDC.eBHD..TCCBKFAAHEFBdDHCBBAChAAAFCAFCABHDFDB..VBEChABAXAFFABCAMIBCECCBfAHGhACA...YEBH.hAAA..gGFAhADA..,1,-9,-25,16
eUDVbQKIRLFNgXBSHMJCGWZdYAEPTcaOf,TFCBaFFH..eHBGDEAD.QGGGRBEH.LBAEgFFHhAAAXAGCBCBBMABChAFACBEDZDDDAFAFEEBHODAGhAAAfHABbCGDKFBCNEIGSBBE..hAGA......hAHA...,2,-28,1,29
DCKSPHFEMdNYaJOcgLIUbQfVeTWXABRGZ,RBFDZABHCEAD.KFBAHACHFGHH.dGHE....aBFHJEED..OFAHLECBhAAAUFEGQBAGhABA..fBDEhAAAeHAGTGFAAIDEDBID.SDAGMAIF.hACANEEH......hAEA...,1,-12,-34,22
XCPgJHEFAITLZGfbeSWQVYMacRUDdNBKO,TEBFLFEH.ZBBEGDDFeDFG.QBACMABGRAGH.dHCFBGHBhAAAOGFG.XBEChAAAPFBBHDBCADCEfAFFhABA.WHFG.aFAHDGADCACD.EAFH.FGGHhAFASDGE.hAIA...,1,8,-10,18
KOGAVUCYXNZHdRMBIQPacWJEDfebFLTSg,VDCCCCED..XEABHFFBMIAEBBHHQBBF.aAFFcGFGhAAA..EFCBfEGFhABAFEAHLAHFhAAAgABF.OAFAAEHH.UGCD.hABANBDGdCFEIBEE.hAEA...,1,-4,-30,26
JgINTdBKEFcUYLOWQSZfaeHAXGMDbRCPV,XGGDGCCFDCHFRAEE.CCAA.....JDCDIABBdHCDKFEHFBADUFGGhAAA.LGBG.hAAAOFBGSGABhABAaBEAACIH...MEFGbFEH.......hADA......hAEA...,2,-36,-29,7
PBCYJHZFdIXEURSMcaDVeGTfONgAbQWKL,QAGEKCGFLFHDCFCBHBACZEACFCDE..XFFDEACA.RCEAMAAAhAEAaEEB..DICAeDDBhAFAGAACfGAFhAGAOHAGAGFB..PEHFBAGF......hBAA......hBBA...,1,-7,-25,18
QKCOYVBXPIFMcZNTLGHUWAdEbaegDJSRf,EGBCaCEB.DGADRFFB..KCGECGEF....OBCGBEAA..XADGhAAAFDEBMCEA.ZAABLABHhAEAUGGA.AIBGdEFBeCCDJGAEhAFASDHB.fEAEQGDDhAGA......hAHA...,1,-25,-26,1
YUbKWLcJVHRDGEZFBSXfOQAeTCdgNPaIM,CAECdEFA.....PAECIABG.MGFCUCCG.KAAALHBEhAAAJHEA.RCCCGAGAhADAFEACBHCBSEEEhAGA.fDBEAGDEeBHHNEIC.aFBC.WHFChAIA......hBAA...,1,-28,-39,11
WACFKZbGVPTUfQDBMadcgOYNILXHESJeR,KEAFZABFGFDH..TEGGQCGGMEDEdFCDOEAD.IAEGhAAAHCBAEHACJHFEeAAChAAAAEED.CBECFBGA.PHDEhAEADBBFaADH.YFCF..XGGAhAFA.WDFE.hAGA...,1,-5,-25,20
ZgUHfWQIYDPTANOdJGMeERcBKFCXSLaVb,OFEGJFCH.GFABEAEEBEDHCCCB..SBECLBADaEHHZAAHUGGAhACA.HCEGfGEFhAAAIAHEDBDDAHECMEAChADARBFCKHAG..FCBF.......hAEA......hAFA...,1,-14,-31,17
fVcXBAbDeYQLUTWZEKFCHJSMadOgNGIPR,DCACQFFCUFBBZABCFBCE.HDDH.MBFGaGFF.dFAA..OEAAhAAANAAH.GAGERCFG.hAFA.fCBGhAGAXEGEAGAFeHFALAFFEHCACFCF.SFEDhACA.IHHG.hAHAcCDH.,2,-22,6,28
gJGHfFACePNTDMOaWQKIURYSZbcXEBVdL,CHHHeGDG..TDGCDCFCaBABKFAH..UCBDRAEDZBBF...XFEHhAAABFBDdFFD.LHAEhAAAJEDD.fAEChABAABADMADDOHAEIDFASCAH.hACAEAHF.....hADA.gAGE.,1,-18,-22,4
MEKRIcDTfYOZdaCGLAFQbBNgUWJeVPHXS,QFAHBDGAUAGD.eCCEHFBH.MCAGEDBEKAABRGFC.DFHB..TCEBhAAAOHDCZEFEaDGALEBChABAFADC.bABEWAFEhAAA.....JEEG.....hACA......hADA...,2,-19,-13,6
cKLfeEWDGYAdVRITUBSPaNHbOFXJQgCMZ,VBDARBEDUGCD.BDDG..SBBH.aDACbAAG.OFAHhABAJFACQAGAhAAA.CDFHMFGDKFFBeFHDhACADEHBAEIDTDAD.NBIA.FDDH...ZGACLBGHhADA..WABChAFA..,1,-13,-26,13
cRVFUTWNdeBKGJYAbLZHCXSfIaPgDEQOM,LGCECAGE.SAAAaFGHDAAA.OADHMIEC..RBCAFDEDTBGEhAAA.dEACBACAKHFAJCFFhABAAHCDZFBC..fEHGhAEA.PEBCEDHFcAEF..hAIAWHAG....hAFA...,1,-26,-41,15
gSWTbQMfdCKFXDOcBaIYUHAPNVEZRJeGL,VDFDEFDHZEAF..eFCHLFGF.SCBGTAEH.QAGHhAAAfACECDEDFACBhABAXBACDFAHBECBIHHFhAAAHCFCAEIBREAF..JAHF.WEEDMFFF..hAEAKCDGcADD..hAGA...,1,-7,-13,6
RNKCQWOcBDEGAbILPYeSVafdTJgMUHFXZ,LAGFeCFC.SEEEaADAdCDE.JACDMBBB.FFGBZEGBRFCFKGEBhAAAQEBG.OBABhAAADCCDAHIF..IGADhABAVFDCfHBB.....hACAgBDH.hAGA...,1,-12,-35,23
KRTLHPAXEJWYQaCDcgIVbfFNBdSMUGZOe,XFDAJFAG..QBEEaBBD.DCBGIDHA.VGAGhAAAFAABNFEBBBAB.SAEGhABAMEBCGGEDhACAZDAGKHGGLHAEADFH.EDGACCFEcAGAfADFhADA..dGGF..hACA...,2,-19,-18,1
OUSDgWKCFcTPJYQNfMZRGXabLVBAEHIde,HECGdAAGeDDCUBFADICGKFAG.FCBC..TDGF..PGEChAAAJAEC.QADAhABAMFFFRBBH.aCHF.LHAChACAAAIDEFCDIHAE.SGGCWDAG.hADACADG......hAGA...,1,-16,-24,8
KEPBaRAOSfdUFLgGZTIYDCJNeXMHWbcVQ,SCFDUECBLCHBGFAHZCAA...IHEFCABBeHEAMDGHhAAAHABF..bFFB.QAEDhAAAKBEAEFADBBCAADHFfBHEhABAdHAD.FDDBYAECDIAGXDAGhADA.....hADA...,1,11,-26,37
cAKNZbUJCWGSTaHIQBVRXDMgdEFPLeYfO,KDBEZBFEJCDBCCFC..GFBH..aGFHHGFGBDACRACGDAAGdGDAFGAGLBHDhAEA..eFFEhAAAOHAEAEBB.UDEBSBBAhABA...IHHC..hACA......hADA...,1,-23,-43,20
HUgOVSIEfNFGKXQcDbeAMWdPYZLTBCaJR,dGAHZFABBCCBaDAH.REFAHBEHUBDF...OBABSHCA.EHGEhAAAFAHH.XGDBhAAADBBHACCDMGEE..WDBGhABAPEDA...TBGDCHHD....hABA......hACA...,2,-34,-28,6
ILZdMQHSgDCcRNPaXWbJeYBEFAVTOUKGf,VEACOAEH.UFGBKFEGGAEGLCBBdHAFHGAG.DDFECHDFRABG..hAAAaEEF..XBAChABAJAACeAFABHFH.AFHDTAGFhADAfDACIDGEMDDBSHFGhADA..NEIC..hAFA...,1,-12,-19,7
ZIHdJUKcMgLWfSbOQNGBRePVaDFXACTYE,CGBCEGBBHAEBdCDH.UFEAKDGE...MIECLGEE.SAAGhABAOEABGCABBEBARADCPCHFhAAADAIHAHFHZEFA.JCABhACAWABE...fHBF..hAGA......hAHA...,2,-26,-22,4
fIXNTbCSZWJHYGeUOPVMQDLFdRAagKcEB,KABGEADHBFDF..XFBB..TBABCDHFZGDEHBECeFBFOBEChAAAMAFGDBABFFGGADEF.hAAAaDEG...fDAEhABAICCGSFDAJAFA.YHFGhABAPHEA.LEAFhADA..,1,-20,-31,11
IAVRQUWJHacTNCPDXbfLgEFBedZSMYOKG,REEGQFFEUAGAHFAAaBHD....NIDF.PAEB..XDCGhAAALCCFFBDCBAABhACAdABEMHDAOEEGKDFEGGADhADAADAF.WAFH.......hADA......hAEA...,2,-22,-14,8
VGLdUIXPEJaeWbNABTSYOCDRfQZMcgHKF,BCEBTFBCODDF.DBBGQBDB.MEFGHGBAKDACFHFEhAAAVGDALDAFdAAEIHAEhACA.XGGDhADAJFFEaBFFeAHD.WCAEbAGDSAFBhAEA.CEEG...hAIAfEBB.,2,-28,6,34
eEPSMQBLCHDIgWaOAJVRZcFbNKfYUTGdX,VCECZDEFFCGE.KCBHUEBE.GACBdFBD..eEHDEEGH..MCAFhAAABABHLABDCAGD.hAAADFIHIADHaHBGAICC.hADARGCA...NIEH..fAHGXAEHSHAGhABA..hAHA...,1,-7,-40,33
JHWXDVdGIUOKcBYaMgZFNPTLQfEARbeSC,eCBCSGADHFAGXFDDDCGFGABHOABAKCAEBBHB.MHDEhAAAZBFAFDEA.TFFAhAAALEFAfAFDhAHAACEGCDDCJEACdGGA..IHHC..cGBChABAaEBANIAD.....hAIA...,1,-6,-22,16
THNQDcVCGFAdXBILMEePYJgbRWOSUKfZa,BCGHLHBAMIAGeCBC..JHFARDGBSEEGUBBF.KAGAZEEEhAAAHEBBQAEAhABADDDFCACHAGAF.dEAF.EGBCPBFBhAAA...YBADWDHHaAGE..cGGDhABAFDEC....hACA...,1,-19,-22,3
ZgOQfFILYCJNdDbaGRWPcBUKXVSeHTAEM,MEAAZEDCQACFFAFCLGCCCBGD..dFHEDEIBGAAGRAAD...hAAAPFCBBDFDXGGDhACAeFAHADID.OCFAhADAIHEG...JDDANIADaACE..WAFChAAAKFFCSDCEhAHA...,2,-28,-11,17
CQIYPGNLaTSFdHXRKZJEBcMAeUWgDVfbO,eAEHUBCDDAEC..fCFFODGH.QBAB.IGEBhAAAYFBCPEAEhABALAHH.SHGEhAAAdBHAXFFFKHCCECAHBGBDACGA.WEFEbFEDCACEhABANADG..aAGG.FHGE.hBAA.ZBED.,1,4,-26,30
ePLfQKcgGVMZHAdIRJYbCEaXUNTWBODFS,RDAHJDFDCCFE...EFBBUGFE....NCIG.BHHE.OBHHSAGAhAAALEFGQCAHhABAKAAEGBCCMFABAAGH.hADAIHEE.bFCBXFBHTABBDBEDhADA.FGHH....hAEA..fAEC,2,-31,-20,11
bOeHAPVQKdgLDMSTIWXfJFRaUZYcEBNGC,VFDFKCDGdBBC.DFAAMCCB....SAHHTBGC..XAAGhABAJEGD.aBEDUADFhAAAZDAFEDFFBEEACGGBOAEAhACAAGDDQGAA.LAGFWHFA.fGEChABA..hACA...,1,-10,-43,33
PfDGAZWXMQdOFLBcESgbVYaKITHUeNRCJ,XCFGdBADOCECFHAABDHA..EEHDSECD..VDABhAAAKGEBHAFAeBAENIDDCGGFJDAHhAAADEEFZGFC.MEDHhABALBDF..bADFIHADUAGE.fHCDhABAACAB.WFFEhACA..,1,-7,-25,18
KbJNZQGVWfHMDYFdXUBOLISCPeEaAcTRg,RDGHKDHF..JFADQDDDGAED...VABHHFCEDHBAFDCEdEBEBCFGhAAALBFGCEAF.EGFChAAAAEFH..TABD.hABA.NIAFfAGHMIDCXGGEIHHEhADASBAD..aAEBhAGA...,1,-18,-21,3
bBNPdQDUALXJgRWTHMSCOKGeEVZaYFcfI,XFBAJADA.RCEC.HDCH.MBHBCCCAKABEEABHZEFB..FEFB..hAAAIHBHBHFH.dAEBhAAADIACAGIB.LFHFhABA.WDBFOAHD.eECEaGCE.fEHAhAHANCCH....hBAA...,2,-30,-22,8
bfEZAUKdPGYMNQIBDTcSaCJOHRXVFWLge,UCGCdGGBGAAHMBDA.QDECDABE.SFADCDDDHFEGRFCDFEAAhAAALDAA.gDGBhAAAeAFEEBBDAHHBYFCFhABA.BBFCaFHF...XBGAhADA......hAEA...,2,-23,-13,10
gTLAUWReKIYFJQcaPGVCSNXbDHOZBEdfM,REAAeACBKBAD.FHAA..QGFFaGFD.GCBFSFFE.hAAAXGDGbAEGDEGGOGAEhABABHHA..dBAE.hACAgCFBAFEC.IFAB.JAEAhAAA.cEDHCGDENIBH..hABA.ECEBMAIB,1,-14,-28,14
NUPaZLAXBfKSTcJDgMHYGbeQWCdOEFIVR,BAHASADEJFFH.DGECHDFEGBBH.eHEGCBEHEEAC..IEDFhAAARCBGUGBC.ZCGDLAAGhABAAEBCKAGA....hACATGABMEEF.........hAEA......hAFA...,2,-29,-23,6
eWaEUXLbYfGCFODBVMIQTPgJHdARcZNSK,ZDEGSBDAKDBB.eGEAaGBC..UAEBLBHB...bFAAhAAAfAAECACG.hABADIGAMEAE.IEFBhADATFGDJGDAAAHGNDDF.EAHFYHFGOCABBHADhABA.....hAEA...,1,-26,-27,1
LCdMPfgANIWYZUBacGeERVKQOXDJHSTFb,..IHDBZBAEBHEDGCFCeEECRBEC.KFGFXDBF.DAGGHDABhAAASCCEFHAALFHBhABACAECdBFFMAAC.hACAPFHFABBCWDDDaEEHEAGGOBHD...hADA......hAEA...,1,-10,-20,10
AeETIZDYQSUgFGcdJXaWNLOVHCMBfbPKR,TFCFZFFCQBAD.UECGGACGdBDB.JEFC.aGADLHAChAAAHBFGCBAFBGGDPAFAAFBEeAFChAAAEHFADCIH.SCFHhABAcGDD.WDAH......hACA......hADA...,1,-13,-16,3
UcbVfNWQKMJCOEZXagDGIYBTRSeLPdFHA,UGCHVEEF.....NCCD.KEHD.CBCBZBDBaEFG.GGABBHHERCAHLCFEhAAA..dDDCFCAFhABAAGFA....fFAEhAAAMCCFEEADDIGEIADESAGE.hABA.PAHH..hACA...,2,-46,-15,31
IHFYEMUABPQZCfeDTXGKdJScgNbLWROaV,BBHAZAFEeDBEDBEFGCCCKEBF..JEGDSFHB..gACEhAAALHBAOBADhAAAaGCE.HFFDEDFFAGCAhABACAFBTCFE.cFBCNIEH...bABBhAEAWHAG....hAEA...,1,-10,-38,28
ZBcadfLRXYWKMGbNJPFHIEUegCDVTAQOS,SFDCBBFHaBHDLFBGRCAD..XGCAKABHGDFG.JHAChAAAHACF.IHHBhAAAeDACDAFEAACBOCFDhABAdEHE.fAEB.YAHHWECC.hABA......hADA...,1,-15,-30,15
QcdASaNIZKPVWbRHTGLDegOfBJMEUFXYC,SCFGaDBGZDEB.KGEB..VFAERCAEGECBDAHH..OEHFhAAAfGGDBHDCEECEXAGFhAAA..CBCCdAEHhABAAIDGNBBF.IHGF..PFAD.WCHHhABA.....hACA...,1,-17,-33,16
FNQbWJaOIMeSZLHgEAPVUCBcRGYTXKfDd,VFEDCFCBRACH..GEEF..XCBHDEABdCEDFHCAQBDEhAAA.JEAFaHGAMACAeBBDhAAASDHHLBHDEHAGhABAAHHEUCFABFBGcBAB.KAHB...hACA......hAEA...,1,-11,-20,9
UBORDFgPHXAQVJKfYNbaCTLZcEIGdMSeW,VCCDJFFB..KFDE....NHAH.CGAGZDBBEFGB.GAEH..dAFGhAAAMCADSADBhABA.eABFBBCBDIFAFAAGhADAHCFGADEHQDGEfGEBaHCC...hAHA......hAIA...,1,-21,-32,11
JfFKTOABHGWedXYPDSbMULINCEVaQZgcR,GAGAdACB..XBEHDBEBMEEBLECHCGFA.EHGAVDAGaFAFZEFDhAAARGAE..FDFDTBCGhABAAABBBHGAHAGH.eEEHhAFASACH.IAFGNIAD..hAAA......hACA...,2,-34,5,39
XILWGNPKbQSFCaYUBedfRgOVZcDEMATJH,TABDHCCBXEFF.LBABNEED.KGAASAGChAAAaAGDBHHGdGDHRFAFVFGHDAFHADIBICEBhABA.PGCEhADAQACDFDCDCFFC........hAAA......hABA...,1,-10,-22,12
AGXMUcYRCISFZTKdfJHBbEQWPLOagDeNV,GCEFUGFARCAG.SGFEZDEA.KAAFdFABJHBGBFDD.EGAHQECAhABALAEC.aBFGDBBEhAAAeADC.AAIFMCBGhACACHDCFBEE.HDAH.WFFEOFHD..NIEH..hABA......hACA...,1,3,-28,31
HXCbJKIEVYLfASDFRcNTagZWGMedOPQUB,FCBARFDC..TCEBZBGFGFEHdFHE.QEAGUAAEBAHECEDCKAAGEFACLCDDhADA.AAEFDHBChAFANAFC..aACAMICGhAGAeGAA.OHFEXCGH...IDBDhBAA....hBCA...,1,-17,-19,2
ISNbUcdGfFKDQRYOEVXZMeBATaLWJCHgP,LGEAJAFHHCAC...IGBESABEUAGGGGEFFEFEDBBARECDOHAEhAAA.EEAFXADHhAAAMAEDBFGBaDAD.hABACBHG...NIED..dDDHfEEF.hACA......hADA...,2,-30,-7,23
bEPIWJaNdLeBXYDcMZQKTRHUSOCVGfFgA,EABD..PFFBJECA.dBBDeFAHBHBDDCFFMBFBZAGD...KEDHHGEEhAAAOCABCEGB.GCGEhAAAFADAAIBG...IAHFhABAaCAHXBCDQFAD....hACA......hADA...,1,-22,-26,4
JIBUPXRaHObfYVAQGeSgFcCLZNKEWDMdT,QCFAGFDFSFAFFAAALDABZBDDECFEMHDEdBBH..JHBCBDEGhADA.XEGEhAEAaAEAOHFCfECDhAFAABID.eHBGCACFNAAGKEHH..TBCH.IAHAhAGA...hABA...,1,-5,-15,10
XbCILdeDHOVZFGgWQcTRSJBaKMfAYENUP,EDBEUEAG...XAADCAFHdACEHFDA.ZCFGGDEC.QGGBhAAATAABSGHBhAAAaGDDMDHBABHGNIBBPFAAhAEAIBDF..DHBEFAFB..gAGHhAFAWDAEJHAE.KBEF...hACAfHFD.,1,1,-9,10
BHQeGXCTKaWfSgMIFPJYUELDVZbANdORc,dFDGOFADBHGAHBDBQGADGCFACCBEKDAD..aHGE..SBCHhAAAIAGHJHDGEDEEDFFGhABAZFCEAABE..NDIG.eEAEhAAA..XBFAWDHB.fABHhAEA.....hADA...,2,-28,-15,13
dNYbaKeHEPSTMXcLWDQRVBUFGOIgZACJf,JDGDdBCF....bDEDeHBA.EBBC..TGBBMEABLFBEhAAADBADRBGHBHHBFBEHGDABhAAAIDCDAFBHCAFH...NIED.hABA.KBHHSEHH..WADE.hABA......hACA...,1,-22,-28,6
DYCSbdFgQJVKaENcLTIAHRZOPeBfMUGWX,RBDHZEDCeBBDMGCCGDFADIEE...SDHBFCDEQDABKFBCaGCEhAAA..EABFLACEhABAIHACAGAEOHEChAGA.BHHBfGHA.XAGEhAAACAHD.gACHhABA.JDHB.,1,-6,-31,25
fWMSIEQYbBLGPgaDVNHOUcAJCRFKXdTZe,CDDBRFGHFEDAdGCGZBAF..eEBD..MAGBSADAEGFE.QAGGhAAABAHDLACChAAAGBBCaDHDDHDAHFDFODGBhABAACFB...........hABA......hAIA...,2,-30,-22,8
XcCdLTRMHSPZGONKWJBAaDUfbVIQYFEge,aEFEDGAAUABD..VAADQGEB.FEBCeHAE.XGGAhAAACAFBdCHGLHAChAAAMGBCHCDFZCDG.NBIGKAECBEEDhACAACDB...bFGBEBFH.cDAE.SGDAhACA...hAEA...,1,-2,-25,23
CXDKFQAESJTWPGeNgcaIVfBMHbLZYdROU,SFGEJDGB..TAECGBBCeCAGNDEA....gGBGhAAAIHCHBEDChAAAbAGF.LEABdADFOCAHhABACCFHDFEDFGGBABIFWBAEPBFD.aECD.MBIBhACA......hBAAYFHB.,1,11,-36,47
NGfaQbRTCOJeBMFWPYEVcUISZDgHKdAXL,XECAGCDEaAFFRAFH...CGHF.eCAHFABC.....PHEChAAAEBHFUFBFSACDhABADFGFKCCDAAADfCHChADA.TADBBCFGMIEEWFFCVFABIEHAhADA......hAEA...,1,0,-35,35
HfdMYXPbEZKABQRNWeSTVcGFJaULgDCIO,QCBHRFCEeBAD.SBFFTGAHGCCFFFEBUAGELDHHhAAADGGE.IBCHHABGdEADhAAAXAEBbFAE.KHCGhABAAHHGNIBB...WEEEJHFCCAGA...fEFGhACA...hABA...,2,-14,3,17
BLATJRSCYWdgKaXMVcNeHQIPGDZbEfFUO,JBHBSBDH.CDEH.dBEC.KCBCMFFG..VEECeACFHDAEhAAAPFCHDHGC..EGDBfHGHhAAA.FAGHhABABFCFAGGATGEARAFF.YEAEWABCaFAHNAICICAEhACA..hAEA...,2,-27,-24,3
RXCeMdQLVaDGSEINHUObPAYgWTBfJZKcF,....gACABECGJBDGKGGGFGEFCBGFdGEELFDF.DFAEEBBAhAAAHCDEUDGE..bAADhAAA.AHGD...TGCAhABAcGAAeDAH.QGAAGCGGIHHGhACANADD..PEDAhACA..,1,-16,-27,11
aIUDCYZeQgJWOFBdfbXRVcSNLTPGMAEHK,KFAFUECHDIAGCHFC.ZCBF..eACE..JHCCFBAGBBHAdFAE....hAAAXGCDRFFD..hAAASABALFFETCCBhABAGADEAEFEEAGFaDGAICHC.gGGBhAFAOFHFfFDHhABA,2,-38,-33,5
bGcVfURXZdJBWageYFHEILPMOKNTAQDSC,DBFBSGAEGBAC...VDBERACDdGDGBGEDaGGE...eDGDFGABEGEChAAAIBAE.MAFDhAAAODEEKDHBACCGCAFB..hABA.fAHA.XGGAWEDG.hABAYHAA..hACALCHH.,2,-19,-15,4
YKBNdOMaCXcLVPQWbIeUAJGfZTDgHFRSE,GABHZAEGDFGGFHDEEHCEBHHB.dEDGMCDFCGAA.LEAB.QGGAhAAAbBEEUCAFAFHEJCFBhABA....fFEBhAAA..gFCA.SBBFhACA.NAICaADGhAGA..,2,-37,-20,17
cLfSBATDdQIPFCXZaEVYKeNJgWMHRbGUO,TGFFdACFQFDA.FDFGZCBB.VFCAKGACeCDC.JFGHWBGBhAAA..MCCDbAEF.hABAOAAHLDADBHCDhABAADEFDBCCCAHG.EHAENEIG........hACA......hADA...,1,-20,-21,1
KGYHfRLdSPEATcBQJFNUXWgIDCVeZbaMO,BBAEQDCGJCFG.FFGFUFEG..XAFD..IDCHhAAADFIFCABEeFAFZEAF.aEFBhAAAMIFEKGDA..HADDhADALACE.SAGAAIBENIDB.WDFAhABA.....bFCDhAGAOBHD.,2,-36,-10,26
KTaBRHgGUVWMPSfFLNOJQDcdACIebYZEX,CFCHeGAEZGEA.KCEHBCFGRBAC.HBAFGEBB.UGFGMABE..SADChAAAFGACLFFAJBHH.hABADDEFAEHH...IAFHhAAAEHAEaBEA.....WHAA...hACA..fDCChAHA..,2,-32,-22,10
OQBAeJUPWVHGMELFaNbcDTYdSZCKgRIfX,JFAAUCDD...VGFGHCED.MFIBFAGA.aGCE....NACE.DAGEhAAA.dGFFCGDA.KBBGREAB.XDBEhABABADG.AEEDeBHDhACA..PAADEADD.LCHH.hAEAcDFE..SHEAhAFA,1,-12,-44,32
WYdUFbRPDgcVNBOfJTXIMSZaeAGELCQKH,GBCHEFHBLECAQFGHHBFHdBAEFEEGRDBDDFGD...VACBBHDChAAAOFAHTGAAMBIBhAAASAFAZFBAAHHDCAEBKHEAhABAWCAF...YABE....hAFA......hAGA...,2,-23,0,23
JREUHdPaODXNZbBSgGIMcWTYFeLQKfCAV,VEAGRGBEHDFF.dAFFOEGDDBEDZDBA..SGEH.GBDHhAAAcFGD..WGBAhABATBBG..YABGhACAeFCGKACC.AABFEBGDaDGBNBIABHEA.MAADhAIAFDDCfAGFhAFA...,2,-24,-6,18
ACUNfHBEJQSFaKcOgdDMYbeXTIRWPZGLV,CAHDUBFEHACAEDHF..QGAGFAAB.KDFBODEBDGCC.MADHhACAeECG...IGHEhAAAPFAHLHCAhAEAACACfHEHBGHBaAFDgFFDdCCD.XEBEhAFA...hABA...,2,-28,-18,10
PGSIeKAUBcMCfJOWZgaLDNbYVdXHTEQRF,BFAFMDDF.CDGG.OCHDZAAHLHDEDFEC....NHCD.VACFdFACHBBAhAAA.QCEDhABAFEEFSGCFeACEABGFhAFA.fGGDgBGG.bAEB.XEGAhACA.EGGG..hAHA...,2,-29,-9,20
VQPEcdATKMSbBXRDHYaZNCLGWUgFeIOfJ,TCAAMFBFBGHG.DCAHHCEB.ZFGFLCEAGACFUGAFeCCHOBEGhAAAJHDA.QFEGhABAPDCD.EABCAAAHSAFEhABAXDGEaAHFNDIG...CGCE.gBGAhACA...hAEA...,1,3,-25,28
NJTFcbGdgPRKXaMOAQBfZSYDUCeWIHVLE,BGHCZFCEDBHBUGEF..CCBD.eECGHCFBLAFBEABA..TAEGhAAAFCHDGBBB.dHBDhAAAPEAAKDAEMEAFAHGDSAGEhABA.WFHBIFBE..hABAJCCC.....hACA...,2,-26,-20,6
FVRCNbYUfIegKTPOHGaQDMBcJSWdLXAZE,EEGEVEECRBAC...CAAF.....bCFGUCCDeECGKBFA..PGCGhAAAOHEEGAEBDADCBHABhACAJDAHdHAH.AGGANABDIGDGhAGA.....gEBAhAHA.aBBA.MDIDhAIASGHH.,1,-1,-32,31
dVAJSLODCgZKeQTWFaMRNIHBYGEcXfPbU,SDGBDEAFCCHC.KABDQFEE.FBEAREDEHGAAGDCHEEAChAAA.fADChACAUAABADIDODBHeCDCWGEGhADAMIFCBAHH..cAGCXGAA.PEHBhABA.dADC..hAFA...,1,-11,-21,10
dDMFQcAYZJUeCBPNfTKbOaGXVHSLEIRgW,JCEEeCABBHFD..fGBEKFGG.OAGHaEEH.GFEFhAAAHGBEEEAHRCCGdDHG.FECDQCAHhAAAACBEZABCCAHBNIEB.TACDhABA.....XDGASAEBhACAIAHG.DDDDhACA...,2,-34,3,37
NFgDTbYaSWQXEZUMHCeOKcfAVBILRPJGd,BDCGLFFCJCGH.dDCB.FAGDDFFB..TFCD..aGBASAAChADAQACFXCFChAEAEBABZAFG.HGEGCGHC.hAAAOFAFKGADAICERDDFNBBB........hABA......hADA...,2,-36,-11,25
BCgNFZHIPWLGRVYcbQESKUXJOdDTMafeA,CCEGFAACHCFF..ICAELABB.GEBDRECE.VFGD..hAAAYAHHQAEBhADAKHDEUEAGXFAGdCDFTFGHhACAMIBAfBHGAAFABDGE....hAFA......hAHA...,1,-6,-27,21
QOEXcUGbSMPfAHCYIRWNTaeDVJLZKgFdB,CABDRBDH....TEAHDDCEJDGFKFGE..FFCABHHH.QBAChAAAEHAA.UCGBSDABhAAAfGBCAICAHAEDhACAIAGAaGAGLEEHgFEBXGGEhADA......hAEA...,2,-33,-20,13
SGCVKEJQUgLOaTFDdBbHPcMIYeNXZWAfR,RCCCCGACKCDHQEBG.LHEGaEBF.DIAAdABEBEEHHGCAMEABhAAAIEFG.eAEAhAAAXEGDABHB.GABHhABAEFGH.JBHFOBHDFCAG......hADA......hAEA...,1,-9,-33,24
SeaPKIdXHOFRMBCLfYWTDZbVcgEUQANGJ,JBABaFGH..KCCGdEEGHFADFCHH.BABDLFCH....fCHChAAATCCCZAFBVECAhACAEEAH.AFHFGAEF.hAAAPHCEIGHDXDACOHFC.MABAhAFA.CAHADFFC...hADA...,1,-18,-20,2
aJUeSEPROLIVWCBGfYFQNcMHDZTgAdbKX,KDECaBBD.eHAG..EHAGOFBGLEFD.VEGFCGFDGBBD.hAAAFEGBNAEFHEBHDAFAZAEAADGGdBGDhABA.JFDDSAAChADAIDDA.BGCHfACD..YEHBhAIA..MIEGhBAA..,2,-32,2,34
YXdRaJQSecVMPNKfHGCTAFUOgLDWbZEIB,FFGDOFDADHDEZAEHBFAF.dCFBRDAG...QBBEeHAG.MAEHhAAAKCDHHABAGGABAGEEUAGDhAAALFHH.EDAGXCGHhABASABC.cGED.NEEF.CEFD.hADA......hAHA...,2,-24,-8,16
RYLTSCAIBVFceUWGDZMNdQHPfKaOJbgEX,VACFFGCFUDDF.GADDZBGBMFFG.dGDDQDAHHBAF.KABFhAAAOAFB.gGGFhAAAEGEAXGAHREAA.hABATEGBCEECBGADeAHH.DCCANIAF...aGHDhACA......hADA...,1,-1,-15,14
HgLNbZEUVYQaCIJSMGedfDPXcAOFBKTRW,FEHBKEGFRECCHECDLHDAZAFHEABD..UAFFQCAG.CBHF.JADHhAAAGGEBeABBdCGDDBFHXEEFhAAAAHHGBCAA..hACA..TGAEWADDNIAD......hAEA......hAHA...,1,-7,-29,22
WTKBcXFMUPaOJSLHIQdNeGCYbEgVRDfAZ,TGEEKFAEBHCH.FFGFMEDA..UADDaAEH..ODHHLEFEhAAAHCBHdBABeFAHGEDChABACHCEEABGRCAG.AAGEZAFA..hAAAXAGF...SGHHhACAIHHG.NDED.....hAEA...,1,-5,-23,18
WAcXFUfbGBIYHRCdODJNQTeMVgPaSELKZ,FCGFUGAFGEDFBBEDHBGHCHBE.DBBCQCAE.MIEGPCAHhAAASGGCLFBEhABAKAEAAGFB...cAABhAAAfDEE.IGGHdCDCNEAGeFCBaCCDEGDDhACA.....hADAWHFA.,1,-4,-38,34
STLKFVNEJeACWBPRHGUYdaIODXcbfQgZM,BDHBRBBFHBEBUBEDdAAAOEHBDCAC....XAGF..hAAAfGEAQGEHhABAMADCTFBHFGBFEDDDhACAAEGGCHHCGDBDIAHE.bFFHSFFEhACA...LFAFhADA..,1,-15,-22,7
GfTXCeRIUDOPSdANgBLHVWaQKMJbFYcZE,BEBGLFCCHEGFVAGFaCGC..KCCE..JAEFFAHFZFAHGDEA.hAAA.XBAGCADCRFCBDABD.hAAAODHDdGAAAIHC.gGFHhABAMCAF.bDDA...EDBC...hACA......hAFA...,2,-20,-9,11
PFQIXVETfLBCYMOgWSKcJeUDabdARHGNZ,RBBDHBACZEFGFHDGQDDB.VGACTGGHBBEC.CAGF.MDEEOGFGhAAASGAHKDBDJCFC.hABADBDCdHFHAAHA..PCAHhAAAIEHG..XECH.fBFFhABA...hACA...,2,-21,-16,5
eUdQZHVXSMYbCGRATLEOfINDaPcFgWKJB,EGEGOEDF..ICBBaCEC..FDBHKBGCBBGDUGAFZFGBHDCBhAAASBCDMAFGCEHFGADEhABAAHDDLAAEDGIF..hAEA.gGAGJDAFeHDG.dFFE....hAFA......hAGA...,1,-7,-29,22
fbAYBFZLPJIUXdWcKDHCgVOTGRQSNaeEM,FABCZBFALEBE.JGBEXDCG.dFHAKBCEDAAFCFHD.OEFDhADARCDE..SFFDhAAANAFG.ECACfBGFhAEAAABFBHED.IGBA..WFADhACA..gGDBhAGA..,1,-37,-40,3
VJcCANOKLXHRUeWDFEQYfTbPgSZGBIMda,OBCGLHCEHEAARABHUEGFeAAD.FCEDECGDQFGH.TCGBhABAgFAF.hACASFDEBHAAIGEEhADAMAFEVBDFCGCFNIEBKAGCXDACDCCB.fGHEhAAA..hABA...,1,1,-23,24
cPCUXGaIgLJWNARHOSMDKfVYdeTBEQFbZ,RCBESBEGMBFA.DDIFKGEB...VEAGdGHAeHCE.TDABhAAABHGHQEGFhAAAZEEECGAEGBCAIABHhADALAFEJHAEABBHOABG.ECGHcADG.hBAA......hBGA...,2,-26,-8,18
ICJKRNVeSXGYPEDFdHOgATcfWLbBUaQMZ,TEEB..cAEDLBAC.BGAHQEAAMDAGIEHAhAAAJEFEKAACRCBE.eCFChADASGHD.XAEAhABAYHBAPECHEADFDFEBFGEHdGHE..hAFA......hAHA...,1,-18,-19,1
ZFASGBCVcKNMHYOQPdLbXUWeaIfJTDRgE,GAGGBBAACEBE.KBDAHAFGOFFGdFEDLDAF.UCGHaGEDIGBDhAAA.JBAEDFDDhAAARDDF.gABBhADAZDAGADIF.SHFC.NIAH.MABC..hAFAQCDD.hAGA...,2,-24,-16,8
YaXEZHISNAbTUDWVPFKcBJGMOCeQdRLgf,UCBFDBGA..VCDE..FEAHBEGDJFEDGACDOCBD..CFFD.dDFDhAAALEHB..hAAAgGGFaHDCZFBASCAFhABAACFG..WCHBKHAA..MBBEhACAeEDF.fHBBhABA..,2,-31,-31,0
ISdCKXPDJWLYTbUfaBEAcQOGgZHVRFMNe,QCAEOFEBZCFBRDBCMDCA..eADGdGFCCABDKGGFDFBDLABBhAAA..TCGCUGACBDHBhAFAAEIBGAED.HFCHhAAAFFHF.IGHFSAHBXACB.hAGAPEEE.WFADhAFA...,2,-18,-15,3
QKaPVOANbeIBXUWRFDMEdScfTgHLJYCZG,eEDFXAGDUCFAFGGFDAGC..dBBE..SEBCTGABHECDhAAAJFHH.ZFEDGBABKAECaABAhAIA..OAAGAGIBIEHBhBAABGBFMIBC.EAEGgCEDhBEACGFB......hBGA...,2,-22,-12,10
gVBCaZGfXPMHRUWIDKTbcQEYJeFSOLdAN,VDBACFAGZCEGGDBC..XCGAMBEGRAAB.UFEH.DBAHKHAA.hAAA.TGAFQFGEhAAAJAEF.FGEBLFHDhABAAEFFBADCaCAHfBBC.PAFAWAHB.hACA......hAFA...,1,-12,-21,9
CKDagLIYTRHOXdEUVBWAbcfSFMGPJZeNQ,...fGEDSGDCMFIBJAABeAGBCEBH.DCGHaDDC.LABChAAATDBA.HAEFdHFHEFFGhAAABCBFAEHF.cGAChAGAFBDCZFAFKDGA....gDDH.hAHA......hAIA...,1,-15,-20,5
DbfFIdaSgXeRTOVCEMWQNLGUBPcAYHJKZ,JCCGKAABDFDF..FEHBdBHG..SEADeFBDRACB..OFEDhAAACFFFEAAG...MAGFQFBChACALEEEBGHAhADAAHHD.ZFDHIAEFaHAC.XCAEWBDE.hAEANEIC......hAFA...,2,-35,-22,13
HQcTAZDIBXePNWJYgVFfUMLRdGSbKOaEC,ZDECDAFFBCBHeHDC......NBAF.JFHD..VEAGFDGBMEEDhAAALAGHGEAGKGGEaCDBhAAAHACH....cFDGhABAACACIECE.XGCDWACE.fAHChABA..hACA...,1,-18,-43,25
BXJTGKIDZOUgfPFYdHVLbWEQMceaNARCS,RCGDSCDEBFDF..TACCKCAEZGEAUFAB..PHBCFGFCHCEFhAAALEAA.EFFEhAAAMAEAaDDF.CABFXCCChAIAIABFOBGF.fGAFhADAdHBH..WBFEeADAAFIB.hBAADFIH..,2,-23,-4,19
XVKYHICLZUGacQBRTSDEbdPMNgJFeWAOf,OBAEXGECKGBBHDGHLADGUDBGGBEC..aGFCBAAGhABAREDASGDDEAGCdACAMFIBhAEAJAHD.FFAHAEHE.fGCChAFAIFAHCCFC........hAAA......hABA...,2,-36,0,36
KATaPgZILHNCJBYFRGMfSeXUdbQEWDOcV,aGEFZEBHLAFDHACECCEG.BHEFFDHD.RABAGEFAMAEA...SCDBhAAAeAAHdGGDEFCHDDIBOAHHhABAKBGH.AIBE.gDEAhAAAJEAH.fCCE..hACA......hAIA...,1,-20,-22,2
SEPOXUKafTdYZeJFcVRbDHBGLCIgWAQMN,QCGFSFFDEEBGOFAA..KCDFaAGAdEGBZBBCFAAB.RGBGDGAHhACABFFE.CACE..IAEHhAAAADAAMAFD..XBGAhADAfHGB.eDEFcGGAHGBC..hABA......hBAA...,1,-22,-24,2
WZdKVXESTabCeYcOPgfMNJIGQRBUDFLAH,ZDDGdEGGKABEEHCA...SAFHaBAB..CCCFeDBDODDG..hAAAPBHHMEABIHCBhAEAGFDBBAEF.FCEGhAAALECAAHHG.WHFATGAF..YBBGhAFA.fBHGhAHA,1,-27,-32,5
gOBKSCYRJLfAIaTXQGNUPWbecDHMVEFdZ,aCBEQFBHGEDGUAFF..PCDFeCHHDBAHMCHB.EAGAFGGDhAAAdGFAZEAHBCABKCGFCBCFJABAhAAA.ABIB...IECHhABANDIE..WFAD......hAEA......hAFA...,1,-22,-27,5
JFIgLMURfDGOQbWCcSYdPVHXaNZTABKeE,BCEDKFGEeCCCEBCBFAFGLFAA..MICARCADDHCGGEBH.QGGDhAAAbDEC.CGEC.hABASACCdBHE.hACAPBHD.XAEANCGEADBA.IAAHhAFA.fGHChAHAWEAD.YFFF,2,-31,-12,19
eXaQJNfGOWLbUCAHPcSERDgdBYVKMZITF,HFFESCBHRBCBdBGGBEABKCHBZBCHFFCG..aAGB..JAAEGDFAhAAALHACCHBGAABB..EFDD.hAAADEAF....YHEAhAEAIFBA.XADFNAFA.fHCDhACA.WFHHhAIA...,1,-26,-35,9
dJVCKFQbHZNXeMPBfOSgTcYIWREDUAGLa,aEEAJBEA..KFGAFGGC.HCBEZCBC...XGABeFFDBHHD..hAAAfACESCADhABAgAFF.hACATGDBYFAGIEAEEHBCAIDCLAHBhADAdCHCCBAF.....hAAA...,1,-22,-28,6
PFBXIUYcCWQLTJDHNKbROSdMaEVfGgAZe,eGDABCHDUGDBCAFA.LDBCDDIBKEEF.RAEA.dFAB..MCAAEBBD.GCFGhAAAAADDZBEG..FDFEIHAHhABA...hAAA...WHAGJABGNECASBADaGHD.hAFAfGHE.hAHA...,2,-37,-23,14
VYNBcOJSRAMWeEdIbHfGZDUFLQaTXgKCP,MIBCEBHHdGDBHECFZACH.DGHBFGGBLBEF.QEACXAFFKBABhAAACCHE..VBBFNIAH.hABABHAC.JAFAAFCEIEHHhAEAfEFFaEBG.......hAAA......hABA...,1,-17,-28,11
IHAOCVFeKLPaNfXBdQGRgJZMUTWbcDEYS,CEEFFFHHLAAG..PBGBaAEB...XDDEBEHHQGDFhABAGDAARACGZBAAMFBDhACATFCE..cCFAhAGADIDAEGFBSCCHAAHHOCHD.eAHD.hAAAKGHH.NEGC....hABA...,2,-17,-13,4
NAfYFdRDBbZMaCKEeUWQOSLTGHVcXIPgJ,FECGRGDGBDDHMGFCKCGD..eGDGUADF..OBFGLBADHACF.hAAAVFAH..IHBEhABAPEFC..NICFABBBfEFEhACA.DGADaCAHECBESAAEhAEAGEAH..cBGAhAEA...,1,-5,-35,30
VQJLaHdGeAWbPRSfCFIUNZKcgBDTOYMXE,...PGDCSEBCFGAE.IGDAUAAGZCDGKGAABEEFDFFBOABFhAAA..MAIHhADAEAEFJCGBaFFAdBDF.AIFG.hAEAWHFA..fECGcAGB.YAGHhAFAQDDG..hABA...,2,-39,-24,15
AROgXScYBENDTdWLIQJCbFHfaVZPKGeMU,RACGXGDH..SFDFBADHEECBDCDFTBGDLEFE.hAAAQAFHbDDAHCABaAGGhABAPDADeFHFAHGCOAABhABAcFADdHEF.ICCCCHABFFGC...hACA......hADA...,1,3,-20,23
geTbEBILNDUOGVAXPYCMHfKFSWcRQaZJd,XDGGCGGBHFEFKCEEFGAF....SGABRBAGZFDAdAFA.eEDHTADFhAAAEAAFLCHFhAAA.DBFAOFHBADCHMADBhACAcDAHaFAA.gDDEBDFANAEH...hBCA......hBEA...,2,-17,-13,4
EBfDJUOcKFYZgPVWQaIANLbHXSGedTRMC,LCEAXDCFGAAGdACARFEB..CHHDBBADJCEAUGGD..KEBFFFAEhAAAZAFE....PEEGhACAQGABAIAGHAFChADASGCHMCIBEADF.DEIF...cEFAhAAA.....hAFA...,2,-31,-12,19
baJYIUFZcRXEdOgAKSMDHLVeTPGBCfQNW,SGHHDGCBLHFGeHACGCBFBACDCABD.QEEE..hAAAWDGDaHDE..IFBFhABAFFAGZAEC.RBEAEAGGdCAGABIHhAAAHCCD.TEGDfEEA.JDHF.hADA......hAEA...,1,-8,-24,16
CcgHFeQdSEMBLJDbGVYXfRaWIZTUOKPAN,CAEEHECHFFCH.dADD.MCADLDCADFFH.GEGE..XEGFhAAAaBBBZACF.UGGHKAGEAGECgBGBhABA.SCBChACABBGDJHDG.YEAB.RCDG.WBADhAAAOHAE..NBIC.hABA...,2,-35,1,36
KVBYXNbOEgeaTMRWQJdZDcPIFAHCGfSLU,CEDFSGEFUBBB.BFHG..XFGGOCADeCCAMCIDQCFHhAAAdGBBDIAG..hABAIAFDHFAFLAFEhACAVABC.bFCEECHHaADFTGFAWHFA.cCEEhAAA.AAHC.KHCA..hBAA...,1,-11,-18,7
WOeALbQTMFcfgBEZJCRYaSKIVNHdDXUGP,LACBTBDA.MGCCFGEH....fFBBBBHFZBAFRGFCaCBHIDFFhAAAHBGD.DDEFGEFGhAAA.OABFhABAAIECQAEGcGBCEDEFCDHFKFFCNEAAdADBXGAChABA......hAGA...,2,-27,12,39
NASLZgVOFcfbUIPEKCGBWDaeTdRMHYQJX,ZAAEVBFDFGBH......fFEAUAEFECCECEHDBBAF.aGGEhAAAeHDEdBDGRCAFHEFFJFBB.hABAAHIDLDFC.hACAOFAAcAGFIAHCKHEADFAFMECC.hAAA.XCAH.hADA...,1,-14,-19,5
VBYLCGHNAUMZcgOPFDIaeXdfQJTREKSbW,ZBACOCDGDEBF..eFEGXEFB.QAABTFCB.KAGESAFFhAAA.bCEAhABAVFAE.BHHHCHFGNIAD.hACAAIDCMFFF.PDBCaAGEfDBDhADAEEHHYADA....hABA...,1,-17,-29,12
cKUZaVNGOSRMbLJfdHgTPXIeBCQFWDEYA,UEDGVFEC.OBBE..SDHFMACALBHBdECGHBAG.hAAAgAECTGGDIEBEhABABDACFHCCDAGFAIFAKDDChAAAaHAA.RBFAJEAD..fHDH.hABAXDFDCHAA..hAHAWEHH.,2,-18,-11,7
DQSYJWNgVabUEXGLPMfFcBRKIHAOedCTZ,OBFHdGBACBHBZEFEDGIB...QECGJABA.....gBGEhAAAaCFHEGDFLEAGhAAAfBBAFGGGBHAChAEAKEGCICDFADCA.SHDC.hAFAWBADbBBC.UGFC.hAGAXFAD.,1,-17,-28,11
WMETCIcPLKRSdNXeQGaZVUfBHAbDJOgYF,DIBCOBBAFDEG...MDAAEBBC...CGBF...IBGHLHEGhAAARFFAdFBCXDEG.hAAAeCEGaABGZECHUAGBBHHAhAEAAHFAJFFC..WAFEPEAGKHEA.SBAGhABA....hACA...,2,-29,-23,6
BMRIDJXUeVbcgdANQaEHCfFPWTZOYSLKG,aEDBCBFEFFAD....TGAHZEFBODEBLABABCHBMFFE.RGEEJCAEhAAAUBAB..eAFAhACA.VCFGgEBBhAAAAFAB.EBDE...fEHC.hADAPHBE..SGGEhAFA,1,-5,-48,43
afSIXLTRVYAPeDGHJEZFKgBdcMQCNbOUW,eBDHGFAHEEHBZEFHFFCABCCD.MBEGQDAF.CACAOAFFhAAAaEHDSBBCLHAEhABATDAERGFEAFFADIEGKEDG.hACAdAHA...NABB....WHEGXBBGhAEA.....hAAA...,1,-4,-26,22
HXUEPWcYfKJTAVBLbQRdOISeMgDNaGZCF,BAHHQEGCOFDDSADH.eDDHgFFGDIAEaHDGZAFBhAAACEBFHADH.XCFChAAAECBF...PCAChABA..WBACcDGEKFAAAFFB..bFAGhACAIHHBMFIBFHAEYAHBhABA,2,-26,-17,9
AXTKHGJSNcdaDRfFgQUZMPbBLWVeECIYO,KFBBJDHF...SDACdBDEDGCC.FAACUAAAMBECBEEF..LFGDhACA.eDHBhADAIHGFODEFAGFGHAFGhADAcGAC..aFABfGEG.QDCEhAEA.bBFEhAFAWCFB.,1,-7,-58,51
HWgSVaUEXIfdABGRQTPKDZCeYbFMLcNJO,GAADQDAEKBFDCHFCeDFG.FHAEMBHFLFAG..JHACOACChAAAHEAASFGBhAAAaFGCEEDE.XCDHhABAIHHHdAGBAABHBCCB.PHDCDEIDYGDEhADANCEH....hAEA...,2,-20,-5,15
GMaHCZeJKPEIRbWgYQfNXUAFDBTLdOScV,DCHBTAAHLDBD.dABCSDFCGGCDHACDCGHFeDBGKHGGEEFDhAAAIGCD.bAEAgAFChAEA.fEDAhAFANEGEAHIHBDADcFAB.MIACaCEE.hAIAZACH.....hBAA...,2,-12,-7,5
WOQPVaeNDYEFUGScBLMfJZbAdXKgHRITC,dCBCXGECKHCAHGECRACE.CFDC...QEFGaFAC.DCCHFCFBGAGChAAABAAHMAEAZEACABAGIGBBhABAOBHFeADBhAAAEHGCSCABLFFEfDCBgDDDhACA...WDHH.hACA...,2,-23,3,26
QfdLUXTbFCeAgVOEIKZBMJPNRDGYcaSWH,VFAHOBBB.KFFBZDAEBEHG..MDHD.JABHRECEGACD.hAAAaHBASDFDhACAHAGFQCEDdADCUGDHXFAGhAAAFGHDAEIB.IHHHDAIF....hABA......hACA...,2,-23,-19,4
NGYOXISgeTVUHfPALWKJEdCQMcaFRbBDZ,LHAEKDHBdBEA.QGFFMEGH.aBDBFGBCBCBDDEFFGABChAAA..XAFAhAAASAGDgEAEhABAeDAHTECHUDGAPECG.AACD...JFHHhABA.CAHA.....hADA...,1,-13,-24,11
KfPBQNDaCTeAIMHZcgVRGbSFdYOEXWJLU,HCDGZGCA.VGAARDAEGABFFDGE.dEFB.OAFAXAAD.LBEChAAAUBGFKBAFBFGBDIGC.hAAAaGHD.CDAC.AHGAMGFAhABAbEAE..EFFB..fCDHNEEA.IFDHhACASAGE.hAEA...,1,1,-26,27
MEdKGRAfZYJNaBSWPbXLCVOeQFUcHDTgI,ZCBGJBFCBBEDSGCA.....PAGBXEEELACEhAAACCBA.ODFBQGAChAAAFGHB.HEAGDIBEIFCAhABAEHFAKGDAAIHCNACBaBBC....WBCBhABAeBHH....cDGFhAHA.,1,-13,-41,28
aRKeZcdXIVAYTPNUQWMfEDJgOBGbSHLFC,TDFDUEAEQEEG..fGHEDHCCOCDABGCGSGHBhAAAFFAGCBDGaBAHKHAGeCCDhAAAdDGB.VFDAAHHD..hABANBAB.MIDG.EBEE.JBHHbAFE....hABA......hACA...,1,-3,-28,25
dOHUJfTIAabFcSKZRgMQDYXNWLEBeVPCG,FAEBSADHZAADRDCA.MEEADFCF...XBFGLHFA.EFFAVDBDhAAA.GGBBdBGAOFDDhAAAJGFA..ICAChABAaGAD.KABG.YAFCBGHFPACDhAGA.CAHB.....hBAA...,2,-25,-10,15
NLUIKBFQJDgCSOaAMREdWeHPGYbXTZcfV,MCHFdCHCeBDHGBBH..XACFTFDCZDFF..fGHEhAAANEACUFBA.IBAChABAFAABDIFECADEaFCH.EEFH.hACAPAFE.bFDD.LFADBHHE.gCEHhAFAAEEE..hAIA...,2,-17,-8,9
TXHfGWJeYAaVCdKcNQURIZPbSFELgDOMB,CDEGKBAH.QGCFUACCZEFD...SBGBLBBFDBGEBGGBHGAChAAAfDEF.hABAJFADeDDDAFCC.aCFAcGFChAAAIFAF.FEHDECDCMIDEXABBhAEA.WFFE...hAFA...,2,-24,-18,6
KAHFVRDSTCcBfLMJNdIbUQeXZGaWgYOEP,VDDDSAFA.CEBC.BDAALDDEJABG.dEHCUAFG..QGCHhAAAeHEAGEBChAAAaEEF.....WEHBhABAgABF.EGABADHEFCCGDGGHfADChABAIFGB...hAIAXBGE.,2,-25,-17,8
cGIdgaLYVRAUXfeJZKQSMHETWDNCOPBFb,UCBFXADGeCEGKDEF..SGHBHFAGEGGGDCACCHFF..BFFGhAAAFBHB.GEAHdAFAgGEBhAAAaBGELADE.hABA.YEAEAAHD.fDFB.hABA......hACA...,2,-30,-10,20
RIaYPHeVAJfZKUCBTFdQcNGXbgSDWEMLO,JFDEZDGBCAAFBBCC..FDFDdDCH..QACGGAEA..XGGDhAAAbAEF..DECAMEBHhABAOGBARCGH.IAHChBBAaACA..YHAGeHCAAIGCKCBD..hBCAcAGA...hBGA...,1,-27,-28,1
CUbANBafWdgXPSKGZcEeFVTMHRILQJYDO,BEEEaGFA.dAEF..XEBASHAAGADCZBFA.EAFCFBAEMBHFhAAARDBFLEGD.QFDGhAAADIBCCABGAGEFfHFDhACA.WFFEKBDFeDAF...hADA......hAFA...,1,-18,-32,14
BafZLDUIMVcCTWPNgEYSFRdJObQGHKeXA,aEAEZFFHDICC.UAFAVAEA....CCBD.TCAH...NEEB.hAAAEFBB.FDFAdGDEJABEbFFEhABA..HECHKHFAAIBCBEHAhAAALAHHMBED...cACG..hACAWBAD....hABA...,1,-8,-40,32
ANXaZOKfUIDFgeWLdEVBRPbYTGCcSJHQM,XDAAaAFCZDDG.KBGAUGFF..DACDeEAHdGADBFEARAAH...hAAA.PBHFbFCDGGEFhAAACFCD..SCCGhACAJDEEQADCMIAEAADBfBAC.hAEA......hAGA...,1,-19,-24,5
NDaREeFfZIXcCgSJPQdKbMVUBHYLATWGO,TFFAGAAGODDA.DDADRDCBECGG.FDABIHFDCGDH.SGEFhAAAJABFdFBAMIFAhAAAUAGBBAHALDHHhACAAHHC.aDCC.eFBCXACF..PHAAhADAKEEC.....hAFA...,2,-27,-5,22
TVKAYSMLRfCGeXQZdWOBgPFEINJDHbUca,SEGHMBBELEHHCHDH.eHACZGFAOECHBDFDFFFB..EGABICAHhAAADDEG.HBFChABAbBCB.aDCH..TBGDhAAAKAFEADEB.RBAD.XGDHdEEDWADEgEADhACA.....hABA...,2,-22,-1,21
LZSHTKRgMGDaebEJBXCUOVdQWFAYfPcIN,...fEDAIFGEZCFGHBCEKHEGMAAHDDCG.aGFG..EGBBBEAGhABAUEAFOHEE.hAAAVCFEdBAHFGHDAAHEcGAGhACASEED.RADA.eCBB.JHBECAHE..hADA...WFFE.hABA..NBED,2,-28,-6,22
RcZQEISDgbNLMXHWFAVfBUOCeYaGPTKdJ,VCCGBEHDCEAE..eHDAGECE.KGFAdAGA.JFEGRABAZCEF..EDAGhAAADAAA....gABHhABALAGFMFABhAEAHFAFAEADOBHFaEHFcFCCSDCC.hAEA......hAFA...,1,-18,-29,11
KLAEWTSZeOVFfCGMbgHRUdDIaJQBYNXPc,TDDDeCFAOBCG.FHGAGACB.MFGDHECGRFCGdDAGDGBEaHAEhAAABHBE.XCFEhAAAKBAGAIFASAGCZBACCHHB.hABAbDAGIFHC.YAHHcFEDECDAhABA.fDHAhACA...,1,-3,-21,18
PZVACYdQERIaOSDBXfcgKFGeJTbMHWLUN,CCECQGCARBAB.aHEASEEE.DGAGfEEHhAAA.gBCFhABAFADCeCCHJGDCMGFELAHFhAAAPBFCAHABdGGEIECH.BDAF.KFAGhACA......hADA...,2,-35,-20,15
DLGMWbNeYTZfQSUJKFVPCgdaEHBcOIXAR,LADHGACHMGDE..NAAC.eDHDZGCCQBFFJHAGKBBD.FFEEhABACDEBdAGAHBBHBFAGIHGAhACAAAAADHGG...WEEEhAFATDCG..fGACSCAD.hAGA......hAHA...,1,-19,-25,6
AUCJKGbFaPROgWXBTVNEIQdHecYMfZSLD,UCEFKEGAFDADREBE...OCCD..gFEHBAHB..TGBHhAAAEAECdAACHFEBeHBEhACAMBBEZBGFDIFAABGCCBAD..hADA..JCFEaEABXGGBIGHE...hABAcBBESEEFhACA...,1,-15,-33,18
BVPLfcMUEHOGaCgSRdJADXYNZKFQbIWeT,DAHDXGABZBDDKFAHFFDD....QFFBIBBG.eFCDBCDBhAAALAFHMGFGUDBAhABAOBBDCAHA.SABEhAAAdADFAIEG..YAFBNAIA..WHEAhAEAPCHH.EEEGaFEH.hACA...,1,-17,-30,13
BdDEHUZJfeNFObgPCRVSITWAGMKaLXcYQ,MGAGKCACLFGF..XBBHQFAFDEFDEEDDZADCeFEFhAAAFBFFOHDC..PDDBhABACADDRGFG.ICEFhACAAHBDaDHFBAHE.dCACJAHDfAAFNDIE.hAEA......hAFA...,2,-19,-17,2
LMOTRZUQJABPaIEHWNdcfDbSCFXegVGYK,aEFEHBAE.dEAHDDEHSHDEFBGB.eDEAGAAFKBEH.MFDFTGGDhAAAUDAA.AGHDBGEChAAAIAGB..NCIE.fEGAhABA..CGAAXAEBYDDFOBHFhACA...hABA...,2,-37,-5,32
SdVcOKWTbQegfHDRZUJCFEMBNGaPLXYAI,dCEFVBFAOFHB.KBBHTADF.eDHFHEBHZDDDJAFE.EEFHBHHDhAAA.GCAALEAFhAAAAFGFICCASDDGhABAbFED.fFDCUGABMAFAaADB...hABA....PHDChACA..,2,-9,-6,3
YbMWFGKESZgdTXQaPUVJDecOLRBICHfAN,...NDCF.MAAFGGBBEEFHZEADdAGD..QADFUBBDJEHHDIAAeCBDhAAA.LFGFRFCB.hABACEAGAIEE..bAGDFEEHKAEFhACASBAE.XCGHaEDF..hABAcGGCBHAD...hACA...,2,-19,-10,9
IUSMeBLKFWgdbfPXEJAQHZcNYGOTDVCaR,QCDBHCACZGDA..NIBF.OGAC.DDADaFCARBADUFEAMBBCBBGEhAAAFCGG.dFGD..fFBDhAAAXEEFACAAGEGAhABACBEHSEABKAGA...WAFE.hACA....gCGGhABA,2,-25,-13,12
acGNOBYMILHbedWPTfDZgXKFEQARSJCVU,JCDFVFBB..UACFGEDBBHDA..MBDEHDGBeAHDdAGE.TBBGhAAADFDHZDAF..KGGDEGHFhAAAAEDGCEAD...NDDD.OFAHhABA..IHEH...WABChAFAPFFH.fCFEhADA,1,-29,-31,2
cYVLZXdNaKPGEBTeWHFRSQCObgDAfJIUM,JEEAUCCG.MHBE..VECDZBGDdADH.KFECEEAC.BHAH.eAHHhAAA.HBDEFCAFSHFChAAACAEE..hABAgABFfEAEYHEGNIAD.aEHDhABA......hAGA...,1,-28,-34,6
AOgHPXDUGTLaQEWfIVKRYCbBFdMeNcSZJ,HEBEDGDFUBCETGEDLAHDEGCC..IBEFRFFD..CECCFGAEhAAAdGGENDED..ZCABAAIFOABGhAAA..gAEHhABAPBBHaAFAQDFHfEEDKFHB.hBAABFDEMEIH.SGBDhBDA,1,8,-35,43
POfMBYgZACSLWKEdNFeGIXDcbQVURTJaH,CCHBSBEDKFCD.EFCDFEEG.GAAGDFECQBBFUGFH.RFGD.hAAAJAFGHAFD.fCHGhABABHDEZADDADFCLEABhACA.dHEHNDAA.XDDG...hAAA.cEGB..hACA...,2,-43,5,48
YPgdEcZIMNLXJVRBaAGbHODeKfFWUCTSQ,HDFHeGDAKACBFFCGCCDC..SAFAQAFG....YEBHhAAAdBBCZFGDIHAChAAA.MHCENFEDXCCEhABAJDAFBACBAAEFODFCDIDE.fGAGhACA.WHDA..hAFA...,1,-15,-38,23
FCObaALRWgdEfIVNQKXUSDPBGcHTZYJMe,LCBFRCDDdFGG.EAGEVFAHKHGE...UDADDCIDGFBHHABG.ZABAhAAAMFDHCEHD..aHCCAGEF.hAAA...fBAEhABAIDDA.NIEF.SADE.BEFHhACA......hAIA...,2,-30,-18,12
SHKQEDaYUOeZGBfRJPVMdCAcLIFXTgNWb,LBCAXBBH.TGAC..NHBB.SDDGHBEHEEGHDABHUEGDhAAAeAFGZAGDBEAGREAC.hAAAJHEEMCIBABAE.IHGDhACAFFDC...WDEDKDBHaADG...hADA......hAEA...,1,-16,-17,1
FEBGTbHdOLUZCDNKAJgcSPYVWXaIQMfeR,JCFBSBFH..VDAHXDAB.aDHFIEHE.hAAAQBCCeHCG.hABAEHACBBHHGEDCTEFGhACAbGFA.HACF.dGACUAAECHGHDAEGKAHBAFEF.PADGhAHA....hBAA...,2,-13,-10,3
KNJVfIAPEbOdeLGTcMgSCDYUWQHBRXZaF,ECFGOADHLHFCGGEDMFAHCAFD..DEBGUDCDHDFABCHBZBFGKAAGhAAAJBAF.....IHAChACAAFDFPFFGeGAEhAEATGBD...SGEFQEDHaAEBhAAA.FBBA....hABA...,2,-22,-10,12
JCMcSbXLRIKeEPTZFUNOgYDQAHGWVBfda,HCACVBBD.BHCE.aHECCBHC..MFCC..bBFDLFGD.hAAAKAFEEABGZGCCNGADOHFAhADADIAGADGH...fHABhAEAdABFJEAB.SFGEIDEA.PECChAFAFAEH.....hAAA...,1,-8,-28,20
fdEVeDSIKGRMZXAcbNUOTWFPCBLJaHYQg,...NEIA.UBFB.ODACFFFDBDDALACFHFCHQAAAhAAAdHGHEEFADBAB.KBEBGFABhAAAMFADACHA..TFGChABACDAHaADB.fEDF.eHAGIHBDhAFA.ZBFBXGDEhAEA...,1,-14,-16,2
EGaKIcARJOeNgfULZBMXSQbCHdPWDTFYV,JBDAeBFD.....fCCBUGBCLFEEMFHF.QBBDhAAAbFABHAAH.dFACDEFHTGEHhABAFCGAEACGGDAFhACAaAEAIHEFADFEODHF.NADHBHHFCAHBYECBhAAA......hBHA...,1,-6,-9,3
RPEQTHSBWbgYGNKFZXJfVcOAeIDdCLaUM,DICGLBFEUEBD.MABBRBAG...EEHFQEFDSEEDBCGFhAAA..bGFEGADBhABAFFAGJACB..fGAEhACAcDFB.AIHAIDHFaAEGTGCF..WDDBhADA..NAAG.KGGF.hACA...,2,-23,-18,5
BbEXOAeLYKCZQPFaWMGTgcNHIdDUJRfVS,eBBFLDBDCEEG.ZFDAFECBMFHFGGCD..TDDD..cAEEhAAANAEH..IHCGhAAAUDGCJFAFRACEVCFEhABASGGEBBBG.EADCACAF.......hACA......hBAA...,2,-22,-17,5
QKBbYZMEdIPUNCWDJRXTFSAHaceVOLfGg,HDFEaHBA.eFABOBDBLAABGFDDQECDKDFBBAHAZBAHdHCFUGGGhACACFBA.JAHFRBFEFAEGhAAASBEBAFDA.fCCHhADA....YHEGhABAMFFD.IEHC.hAEANCAC...,1,-5,-17,12
NfRgDdTGKJMYIHSOLWZBFaUbVcACQPXEe,CFDHXAAD..NEBH.RGECdEAHGCGG.KCBCMHAG.HDGBOAEAhAAALDBCBCFCFHBGhABAaDFBVADEAGFF.EBGCeDADhACADGAA...........hAAA......hACA...,2,-38,-9,29
fBWTCNcIXJZgdHUPKDaeSRGOVbALFEQMY,EACBQFBG.MCEFfEGCBAHBCEHD...ICHGhAAAZCAAHAAGKHBCeBGHSFCChABARGFCOFABAEEAFAFBTAEBhAAAXFDA.gDAH.dGHChADADICEaDDG....hAEA...,2,-22,-4,18
JYNaPXIRZKEOVfDQCWMTLFAGcBegSUdHb,BHBDeBEBUAGBdGEHHCDF..JABDaAEC...XCAFIFFChAAAZCGHKDDDOAAE.hABADFAFCGDHTDGCAAAA.hADAGEACSFCFNIDFEGHD......hAFA.fHGFhAGA.MAIF.,1,-17,-19,2
GKCaVMIASOYUbRXTEZPgBdNfJcFWHQeDL,OAADUDGFRFGD...EFBBZFBCBGDAdAGF...JGFGFDABHAEGDCDALHCAhAAAGEDFCCEDMIEChAAA..ACCH..SABChAEAYDAGXDGA..gEDEhAFA..fBHChACA,1,-15,-43,28
EVYIdfKFOUPGMaQTZCLeXbARDJgBNWSHc,DEGDBACG.SDGDHBEHVAAHdEAC.FHCAODDDGCCA.MABFhAAATGBA.LAEEhAAAeEFDAFBA.JEHD.gDBFhACANCIGEADE.YAHBIHHH..KHEAhADAaCGF.CHAB....hBDA...,1,-12,-14,2
BGLdITWeZHPFXbRaVCQgDMcYSKOJNfUAE,BDACLFGFdGDF.TGACZCEDFEHH..RDDBCBFEDIDA...MBEASBCGhAAA.KDADNDCE.hAAAAAGGEHCCGACE.eFAFhABAPFHF.aDFC..gGGGhACAODBDfBAG.hAEA.WAFE.,2,-25,-15,10
cBDGMWFOJRYLQZPEfIgeXUaCdKVbASTHN,SBCDTEBH.HEDCBHAHGBDDMBAFFCHFOEBDRBCE.LEHFhAAAZEEGEAFG.IADHhABAeGDAaCBCKCAH.AEDADIDEhACA.WHDE.JAFCPAAA...fDEFhAEA..hAHA...,1,1,-23,24
JcUGdbALCRgeEBNFSTDMYWIQPXKafZHOV,RDGFeCGFEEBF.FFBB.DAEGMAEH....IBBAPBABaBBFZFGBHFDChAAA..OFCFhAAAVBDF.UGGH.dHAHhABAAAIBCHADgDDGBDADSAFATAFG..hABA......hACA...,1,-5,-27,22
FSZPbTCEILHNAWMOdaJKeUXRBGcDQfgVY,OBADaEEH.KCFDeBCD.RBDGGGADDIFAQACC..gDGFhAAA.FBGAhABASCHB.hACAbFFAEGGAIECENIEBAAEAdDAA.XGCH.hADABFAE.fHAFhAAA.,2,-49,-3,46
RONYTWaFHSLVAeQXJCfEbGPgMZKdcUDBI,eCBBQEBGCCHH.ECCDGDDE.MFBHKEFFdHGFUAADDAFBBDGGhABAIDHHRBEA.OAAGhAEATFGGFHACLAEEhADAACBF..XGCAfGFGgAGChAGA.....hAIA...,2,-20,-16,4
TfPCNJLHXOAUaYQgMZeGDdbBEKRFSVWIc,aCGGQDBEZFBE.DDGDdBBABAEBRADG.FBBCSAAF..hACAIAHETFGDCDEHLDHFhAAA.HGCAhABAAAGAYHDEMIFAeBFFEDADKDCBcACF.fGAAhAGA..hBAA...,1,-19,-27,8
KOUJgTHLGNbVABQYaRPdFSCeWZIEMcXfD,BGGHaCED.dFDCFABHCDDC.ZEAA..MCAC..fGGHDGFD.hAAAKHAAUFAA.JCECHCGDhAAALADANDAFAAGHQGCFhACA.YFFDSEEE.IABFhAEA..EAHBhADA...,2,-46,-22,24
YLINcPSOeZBEFHGaJMgRQdVATDfWXbKUC,DBGAXGFCKADH.UFCDCBAH..LEEC..ICDChAAA.NBBC.SDAChAAA.eCFEEACAGAFAhABAJGAEMEIF.RCCFdGFGADFDWAHH.YFFChACA.PFABBABEFGDDhADAaHBE..,1,-22,-29,7
YUIRBXeHSQbOfaKMdENJLgAPDCVGWTZcF,CCCCVEAAGCEG.ZCAFFBAG.UFEHRAEGBHAHHBDG..QGFHhAAAOFHFKCHFMBAE.EGDBhABANIAD.LCHF.hAAAAEABDGAAcCCH.IAGEeDDD.SADChABA...hACA..aHFC,1,-11,-15,4
beIQOZBHMgYVNFCdcJSGTXDWRKfEUPLAa,eEFAOADBBGGEHEFEMFAA..VBAHCBBD.dBGE.JFEHSBGAhAAAGAECDGIBRCEGfGAFhABAUGAEAEDF.aDBCIHGGhAAAQACB.YEEF.NIABFAGGhADA.....hABA...,1,-6,-16,10
QeTbBRUIHEdDJfNLYWSgcMPCFXAGaVZKO,GFAFVFDE.OAEFQBCGeEHFBHAFREACHAGFdFEE.DBAAfDHAhAAALDAASCAEhAAAMBBH.FDFEXDEAhABAAIGEKHCA.bAEF.IHHHEBDB.NIBF.hACA......hADA...,2,-11,-7,4
CBFaQHcDPZdfITAVEOgGULWYNJebSXKRM,VFFBEBEAGEDE.LCCF..WECAJAAE..eDHFSEGEhAAA.RBFECDCFaEAHhAAAHFAHDAHDZGFGdACAIAHFhABAAEBD..gGAANAEA.KDEEhAEABBBC.cGDHhAFA...,2,-27,-8,19
CXQcWbNVIKUDAJHGEPBSdOYaLgZfeRTFM,HDFHEEADBBBFdGCDOCABLFGBZBBF.eBEATGCB..MEBHhAAACDECQAGB.hABA.WHFCNEIG.KDDCAABGPDAGhAAASHAGaFCG..fFFEhADA.....FHAChAEA...,1,-18,-20,2
fWPLCZOAYgaEVJKHSeIMcBTXGDQRFdbUN,aBCBJCDHHADA..eFAAMCHFBDHFGBAEDHFCFBEEdGECUGGD.hAAA.fDEHhABALGACOHAEAEAEEEGDKADEIDFFhAAA.XABFbGAENIEH.CBHE...hAFA......hAGA...,2,-26,-8,18
JfIMgWRQGVbAacDHXPOUBZKdeSCLFYENT,aFGFDEID.HBDFODAABDABZAFAKHDG..SDEACBACLGCEEACG.hAAA.JDFG..MEHDhAAARAFGQEABVGAEABBE.hABA.XFDB.dGFG.eCFEFBCB..hAEA......hAGA...,2,-18,-18,0
GUVBcQIOdCTPJMgDWKEbZAFSLYaNfHeXR,LCCBaAFEHDEGeFDHGAGCBCECQFEFOCAB.CACF..PAAFhAAAJEBBMHFA.DGGAKGBGhAEAEBCFAIFGSBEDhAFA.fAFAXAAF.....hADA......hAEA...,1,-12,-23,11
QPHMZYaGUDTgJcRfVKCOFELBeXIbAWNdS,dBBESFABHDDDMCGDZEFBGABCDEAE.JFDDRAFGKFAC..CCGGEBEChAAALHFG.BHAHhAAAIAHCACACQFFFhABA.aFDH.gADDfDDHFCHDeBADhABA.bFGH.NCIA..hACA...,1,-11,-13,2
QLPWFTEUGJSfdBYAbCZgMaceHODNIRXVK,CHCBMCDF..eBEFOEGDDAHFREAHKEFD.LADGFFED..EACCUEAFhAAAGDGESCAAhABABDFEAGIDZCACaHAGNBIC..hACA..IAADQGDH.WBEA.hACA......hAFA...,2,-32,-13,19
JIZWBbEDKeVNfQLaMUgPHRGOSTFAXYCcd,XEBGCAFHdHDFZBBF.BHGB..DADDeDDB..VBGHQACEhAAALFCAMCID.UAFEhABAHBDBOCABSAAFhACAAEHD.JEADbFEHEHACfBBEaHGG.hAEAPHBA...hAFA...,1,-6,-20,14
BeZIbGMKEFOQVNJPdgDWAUXfScRaLYHCT,XGCHSHCERDFG.LCGHHAEGBGGCeCCHZAAEGAABKCDDEFADOFCChAAA..QCAEhAAAJBEDdAGFDHGEAGIH.fEAChABAYFCCCCHH.......hADA......hAEA...,1,-9,-17,8
fbLEMJAegGVKICQaSTcFHPRXZUNYdDWOB,GAGGVFGB.CFFA.QCBH..aEDGTCGDFBBERDABZGEAUFCDhAAA.dBGFDGAFBCED.hAAALACEECEGAAFBKGBBIGAFhABASABC.......hAGA......hAHA...,2,-28,-20,8
TREKedXVaDSZfLOAHCWFBQMcJbPNIgYGU,HFGBFGBBMBCBJHAA......PABAIGEFGEEGRDGBKGGFXAGAhAAA.DDFCSADFhAAAZEBGOCDGACACBEEEhABA.bAEHYBBFTAGEdEBDaEHFCAEH.hACA......hAGA...,1,-1,-29,28
TOFEcdbMNBAaYfJDHIZWCGKRSLeXPVUQg,aGGHJEGBHDEDZDAH.GBABKDDALACB..PHAGUGDF.QAEEhAAAOCFAEEFAbEAAhABABABD..AGIFfHDHhACAIHACCFDBSAFEXBGH..hAAA......hAEA...,2,-32,0,32
PDYXbVeFCdcQETSaKGfNgBLZIUAJMWHRO,JDBEMFCEHABARAFF.DGCD..XCCD.eBEDFEGACGDD.QAGDhAAASHGEaFAFfGEGhAAA.BCHGhABAIHHGAACHODABbFEHdAEAEHACKFGE..hADA......hAEA...,2,-25,-20,5
BSYRePMJKGUOLWgbaNVTdQZIDcXCHfAFE,FGGHBACHRFAC.eGEC.MFIHKDFGGAAH.OHCALFCD.hAAAgAEAaCDG.hABANBBE.TEDDZCEEDAAGCEABAAIFhADAECCH..SAFGPEFGJFAF...hAEA...WHAG.hAEA...,2,-21,-20,1
QUcbNAaVWJgYRCBdDTSGIXFEfHOPKeMLZ,aBCBVFDC....JGFARCCECFAABFDC.dAFGDEBEGBGCFABD.HCABhAAAOAFAKEEE..MIFEhABAQCGA..hAAAbGBCAFIH...WADBTGBB.SADGhABA.IHHGhAEA..,2,-27,-27,0
PbCFXfLIYgHUVQGdADTWJcOZBRKeENaSM,TFFCJCEDZABH..BBHBKDCH..EAGA..aFABMGAC..CFFG.fGEEhAAALADE.ICHHhABAHEBFQEGFhAAAAADFDBBHOBEBeHECNEIA..SCADhACA.....FCFDhAEA...,1,-22,-26,4
VJAKaUBfOYTNQCLESXcZHdbIWGFeRPMgD,aFGCBCDE.OHAG..NEFELAAFEFAE..XDBBhAAAZECHdBGBIBEBGGEFeEFAhABAMEAFDCADABCEKCGGfABFhAEA.YBECCHHHSBBG.hAFAbFAHFFDC....hAGA...,1,-19,-22,3
aCGTPYSgIJeHOMELBRVZXUNFAbDdKcWQf,dCBGKFDHQCBFCFAGGGBD....TADCSCFD.JHEGhAAAHDEGOAEGEFGABBFAhAAAZCGDXEBGNAICADDBDCAH.hABAfHBHaHAC.YABAIHHCMDIFhADA.....hACA...,2,-21,-12,9
GZDXYgUNAQEeMOTKIfLJRaHPcdCbWVSFB,EGCBMECAKFEDLFHH.RFBDHBADdGAGCHGB...VFFFBEBADABGXAEEhAAAUBFG.ADEA.OEABhAAA..ICCFhABAfCDFJDFEaBBB....cADGhAGASADC..hACA.FFFA.,2,-43,-5,38
ALSaIWHXOVQeUYDEgCbTJPKZcRGFfNBMd,LEDGaCBFHFFDOABEQBFC.UBBDDGAFEFBCCHGA..JDHBPCABhAAAZFAA...GDDDhABANABH.dBFHABIHSHAEhAAAIGDFWFHBeHDA.....hACA......hAEA...,2,-20,-14,6
LMZJUAXBaEfTYeOIVGPNdgHWFcRSDQCKb,aBEBTBFH..eEECODFBGBAA.dGAAHGAEFCGCRDCHDBEBKGGELBAFhAAA.JEHDAIFCBAFEhAAAECBAIHEEhABA.PDDHgACFSAFECAHF.MAIFhACA.XEAEhADA...,2,-20,-10,10
SUdMeCPANFYRXbOIDGgLBfQEKcVZTHJaW,FAEFRCFHOHAEDGFBLBBFBFDF...EAGHKDBEZCFGHEAB.JFFFSEEAhAAA.dCDGhABACEHCABAA..XGGBhACAGADB.QGAE.....hAAA......hABA...,1,-18,-39,21
AFWfRSEUMbNDZdcVTOYHBIKPCLGQJXgae,FFFARAEAECGBMIDG..DCDHdEAH...TBCGOEEC.BCAGKFDDCDEBhAAAQABF.hABAXGEGgCGAhACAAHIDSFACNADF..cAGDYHAEhAAAIHHG...hACA...,1,-28,-39,11
ScAebYONRKZGWTDaLUEVMQgCPXdIHfJFB,eHAEOBAGRBCCZDEGGFBD.DIBCaFBGLAFFUFFB.MEDA.CBHB.hAAAXAAGdGGAHCACFAFFhABASHECAIEG.hACANEAAKCHFWDAG.........hABA......hACA...,2,-25,-10,15
CbMSNPKRHLFVJIDgOQWZeaGcETUdXBfYA,CACCMFHD..SEFEKEABLFEBFFBB.JBDDDAID...OEDHhAAAQGCFZAEBeFFFhABAaAAAGAGCEAGH..hADAUBBFBFCBAGIBNEAA........hAEA......hBAA...,1,-26,-29,3
SEIHXJAfgQNKCGLeRaOYBVUMWdZTcbFPD,QACEKHFCCAGG.LFDFRBAF.OEHFVFCC.MBBBZCEC.TBGAhAAAFACE..DCFAIHGHhABAHFAFAHIH.fCCEhACA.gFADNCIE.eCFBhAFAaDCB.BFFG...hAAA...,1,1,-36,37
FYXcUOAZgdbSfTVJeLNGWIECHaPKMDRBQ,dAGHSHAE..TDCBeBFGLFFHGBCHECGHCDEFaABHMFEChAAABDBHFFBF..XGGAhABAOEHFAGEA.gACEhAAAfDAANAEBHDCBDACG..YHAAhAFA.....hBAA...,1,-9,-22,13
ePADVgMcEZYWCTKHLfNBFIOdUabGRXSJQ,VDDCMFBFZEEC..CGFCHBFGLAAEBEAAFBEHdAEDUCGCGABARBBH.hAEA..XEGAhAAASGDCeHACADDFDAGAEHGG.hABA.....WFAA..KGHH.NIDBaAFChBBA.....hADA...,1,-15,-17,2
UVNfRgacDLbePWTKXdSYFBIHOACZQEMGJ,CFFDZBAC.QAEHGDBBUAEB..fGEBRDGB.aDBFLHBChAAA.PBAHhABAKHAAXEEAdFAFFBBABHHFhACAIHDCAAHE.MDFC.NDAGDAAE..hADA...eHFA.hADA...,2,-24,-10,14
JNITZSMFAXEdLfYGaUBOcVQPWRCHbgeDK,EDDCLDGDGAAABFAGOBFAQGCH.RACHHECCeFFFDEAFhAAAJBFE.IGCCZBAFMFIFhAAAXADHdHFB.YFABhACA.aFEB.......hABA......hACA...,1,-12,-14,2
FIJaVOACMDZBEXcbeWUQGdTNKgYfRSLPH,CFBDMBCCDGEB.ZDEGBEDH..XFGB.eGCAQFFDhAAAGCAHdGBCKDAE..fAFBhABASAHFLBBChACAFEABICFCaHAGAEABECFHcAAG..WDHBhADANIDF.....hAAA...,2,-35,-17,18
QeYAfVELNPSGWcMJIbgUaKFRZCBDOHXdT,EABHLCCA.SFEGGADGMBGBJAAC.IEHF.UDAFhAAAKEBBFHGCCHDD.DCHDXFEFhABATGAAQAGDhADAAHHFfAHG.VFABNDIC...WDDDhADAcAEG.aDEEBGGChAFA...,1,-17,-22,5
eaHAWKXJEdNOVIDPUTCFcMYGQgSbZBLfR,KAAGXBABEGFH.dDCGOCCB..IDEADFGEUAFD.FGDBMHEGhAAA.QEFDhABA.SAGAhACABHHFLCAFeHACAFAGNBECTGAAcACEgCGEhADAfDFF.aAED.hAAA...,2,-43,-7,36
TSHQbINEdeLDAGgUfKXOBMPWaVJCcYRZF,UCAHXBFABDED..MEFEaBGG...JBCDCDHC.REDB.ZEAG.FEHDSFFBhAAA.QGBHhABAIGDBEGGBhAAA.LABADEBHAGIFfCACKGAB.WAFChACA.....hACA...,2,-40,-24,16
ZYOQRITgWXMdfHULVKbcBDJFEaGCSeNAP,ZCDHOFCFRAEB...TAADXFGF.dCBCHEGFLBGHKDECBAHDhAAADCAFFGAAEBFECACEeGDEhAAAAEGDQEAB.hABAICCHMAIBfABH...hAEA......hAFA...,1,-18,-27,9
UVfeDNBJEcOYTKHbRSIAZPaQWCFdGMgXL,ZDCGaAGA.CAHGGBAG..XCBCLHEAUFFHeACABAEDEGAD.hAAAOCFFKFCA.RAAESFCAhAAAPBGH.FHBChACAdFFDMFAC.fHDDDCIB.cBGAhADA.....hABA...,2,-19,-16,3
SeaQNLgOZHRKbTDcBAMFYIWPdCUXVfJGE,MBEDFGEC....IFAAPHCGCDBAUCEA....fCAFhAAAECHBaHAC.QCGDhABALABFZEBHHAFAhACARACCKFFCDFIFcEFDAEDH.WEAG.XABAhAEA....hAFA...,2,-25,-25,0
GWRaLNFPXgUJHdfKDTBECAIceMObVZQSY,eBEEMCGB.OEDDZEGBQBBBGAAAaBHFLECE.FHCGgCDEhAAAJFAB.HFGHhACAdBEGfAFDhAAAKHAGBFAEAFCA.IDAB......hABA......hACA...,1,-11,-22,11
gQVONLHDbYdZEfTcaXAIMPBCUSRJFWeKG,MFCECCDHUFCARCAH..FACAKAAD..GGBD.QFGHODACLADAhABADBGCdCEBEAAFTFGChACA..XFAChAAAAAHDBFEA.SCCBeBHHNIEH..HFAH.hAFA......hAGA...,1,-15,-23,8
JBOYCZNeQVfDGaELIHWAXdURSFTbPKMgc,dGEASFFBFDDG..TDFEKFCFMEDC..JDABBADF.CAGFZAAFhACAQAAEDDDGGBGEhAFAEGCBLADEhAAA.IHAHAFID.UGGB....hAHA......hAIA...,1,-23,-40,17
RKWYVcgMPbUDSOXaEQGAHTdCBZFJILfeN,TEGCCCFCFCHD..LBBBeDFFKGCA....VFEGMCCFUGBAhAAAOAAF.EEDBAEDEdFAChABAJADH....IFAHhAAANACD...WAHBgBDFDCABSGHHhACAaHFE...hAHA...,1,-19,-35,16
QLVMBSDWHXbKgROZYPaNCdJTeGEfcIUAF,FHBCQCBELBAEBGBDDFGBHCAEKBEBRAACZFEH..aCFAdAGAJEDHeFAEhAAA.GEGCEAFG.hAAA.fEAEhABAIHDDABIFMFFBSEEE....XCEChACA...hABA..ODHF,1,-8,-17,9
SeUCOZBJPMQEWXDIHNgVTcLARYbFdGaKf,RCGDFBAGdCBFKGFF..SFBAUGACZBFC.BADF..JDECMAAH.hAAAEAGFDDDF..ICEDhABA..NADB.TFFGhACAADBE...YEEDaGGA.eFADhAFACEBHOEEB...hAGA.WFHH.,1,-18,-47,29
SMHcGgVeBLUbKWEAONDTadRJPQfCXZYFI,DCBGdHEHRCABQEFG..CDFGXCDFFCHBSFDCHFBBGAGChAAAeFHHBEAEUFFDKABAhAAAADDDOACG.aBAGhABAPHAC.fCED.IAGChABA.MDAC.hAGA...,2,-24,-16,8
RKXZTGVUeLbYQcCHIADBPWEdfgMJaSFNO,DGEABHABEEBEdEDH.MGFA..aGFEFBECOBAC..XAAFhADAGBGGVCDDeCFALHEEhAEAQGBACFADAIFEPEABhAAA..fEGBSBDENCCE.KABEhAEA......hAFA...,1,-17,-28,11
OZIaMPLHYBTXUdfGSeRcEFNgDQWVAbKJC,KBACCHADZBBBMBGFLAGFHACBBGFC.UEAHdAEGSBADhAAA.eGEGREDHFCHHDHCAQGAHhAAAABHB.JHFEhABAIEFGaCAC.PFBG....hABA......hACA...,1,-17,-36,19
gPTQJFXAdOGMWRCKceaILBUESYNHfbVZD,ODEFGGDFRBEEKBAGeACDLBGBBGAGUEGF..EEBB.SADBhAAAHDAA.bGDCDBIFhAAA.PAFA.TEDHhABAJFAHAHHBMCDHCADFaHGE...NCIEfABBhAFA....hAGA...,2,-26,-5,21
XQENfCVSRgJBAWHYGOFPLMUDdeKbTZaIc,HCFBOAAGLEBBUCBE.DBAGKFCEZFGD.aBFB..XFEDhAEAQBCHEHAG.CFAFSHBAhAAARAGDJDHD.AADE.GAEChAGAFDDHMAHH........hABA......hACA...,1,-14,-24,10
JDRBbPfFgGaSYIMdVQLEeXCHNWKcOTAUZ,UFBBZEDCJBEDDEAB.BEHA....fAGGFGFDGBBE..hAAASABFMEDGQBEFhABAEGEDCCCD..NAIG.hAAA.KEAEOHAE.AACCPAHFgGCDhADAIHHG...hAEA.dGHG.,1,-28,-34,6
QeWCcLPRJTdUIfOVYHbNGKSDAXBEMFaZg,BHFAMEACZGDGQDCE.CHCE.PDFBREEH.dCBBUCGG.OABAhAAAVAFHHFAE.hAFANBIA.SAGGhAHAAIAE.FBEFaAABeBBHWADBcGGA...hACA......hAFA...,1,-18,-20,2
KFNeZISHOgbCJXDLERWaBUTMfVPQdcYAG,KBDAeCBEZDEHHACG.OHFGCBBDDFIB.RDAEBHAC.UDFHTEAEMICChAAA....PHEGhAAAQAGA..hABAdCHEAFAANGCHSHAG.gAGChABA...JDBA.hACAEACCaEHDcFBD,2,-26,-13,13
QcNdRPGCSBVKILWZFgYXMAEfDebHJUaTO,EHAADBECeDCAHBCDUDAB..TAAFOHEEQEGEdFDDRCGFCABHBBGFhAAAKGEALGAEhAAA.FHBC....hACAYEHBAIFGfDFHaAGA.NFADSDBChADA...IHHAhAEA,2,-29,-8,21
XgAVTEZeOISFPGNWdaCJYBcfDLUMKRbQH,TABGEGFDZCCA..OCBHFDGEGFBB.dGGFCDHGBCGFDDCGLAFBhAAAMFFA.KEAFQAEBhAAAXADH.ABBCIHAHhABASHAA.....WHFGaGEHJECDhACAcDAAfGGDhADA...,1,-13,-31,18
KZaBAPWVdOMCbeHDgSFNYGIfRULEXJTcQ,VCACdCBDMEBG..eGCCHBFCDIGGSFBGFEFC.GGEBhAAARACAEBFF.TABHKBHFBEDAhAAAAGAFPDFH.OADGhABACFAE.NIAF..YDHBIHEF.fHADhABA...hAHA...,2,-32,-4,28
MCbAcXFLGZHWaJgOTUBRNDfeQPYVIKSdE,FFDBGEFGHDEDJFDBOFABBABG...RDAADIFGQGAB..hAAAPEHBIAEHSAAGhABAEDCA.CCGCACIDXCAChACALCACaCFE.....gAFHhADANBDFfHDFeFHHhAIA...,1,-17,-27,10
gHZNLaeRCQVUdFfcbDMEJSBOKIAYXPTWG,XAEBTDBD.GCBAHBCCZCGFLDGDeGEGCEEAUABH.FEEFbAAGhABADIGC..EAFEBBHDhAAAIHAAAEHC.WDAFhACAaHFGRGBA..dFBD.MICCSBDH.hADAOCAB...hAEA...,2,-9,-2,7
IYbXVJcGEMZDWfBeCdOgUHKSNaRLTQFAP,..IGBBXCDB.JGEEEDEF.ZFCHDDFEBBEEdCAE.UCBHKFAF..hAAA.aAHBREBDLADChAAA.FDHDAABAbFFD.hABA....cEGFMIACfCCGhACACAFEODAH.SFEChAHA..,2,-34,-21,13
LcbPdEHTBNAXZJVKSQGgfOMFURYIDeaWC,ZADBKEGEGGCHOBHFUABBRAFF..DDBHeDECCDCB.LHAC.hAAA.PACCEFGFBHEAhAAAAIFE.JFCASCEDhABA.QFABgCAAMCAAIAGDhACAaAHFcFFF..hACA...,1,-15,-32,17
DMaINTFeAfdWBCZVSgKXYEQGbJPUHRcOL,dEDABDDGCBEHZDAHSAAB.KGCGEABHGAEF..PDHFhAAAREGBOHDEDHBA..aAGDTFAChACA.AFEE.fFFEhABA.gACHQACE.bCFChAFA......hAHA...,2,-33,-25,8
ZXQfANcVgRCGPaWFEOBDTMJeYHdKIUSbL,VBGBRFGHCEEC..GDAG..aDAGFDGABFDADDDE.MFGD.eDEBhAAAHBACdGADIHCBhAAA.UAGELAFChABAXGEFABBE..NEIE.PADCWCCHEBEB..hACA......hADA...,2,-24,-17,7
aIHUgQfMVFCKJeOALGNBTRXdEZYSbWPcD,LEDCBBFHRFBBdFGDEGBBZAAE..SADD..PDDFhAAAaGGCHFCGQCAHhABAMAFECBFEKCAGJHEC.ABBGNBIETDGEhACA..XCFE.YEADhAAAWAFCIBHG..hAEA...,1,-4,-31,27
UYSKcFBWEOdLMZaNbDGAIQHeXgfCRTPVJ,HDGFXGBFCDCCRFAB.....TAAAJAFAUGDGSFED.hAAAFBDBBDAGOAFEMCBAhABANEAFDCFGACFG..IHHChACAgDFC.fHGHPEDG.KFGFhAAA.EGAB....hACA...,2,-32,-22,10
bWODGgfYMAacVPSeCKXHdUJTRLFEQZIBN,aHEEVBGF..eDCCCCAC.HCADUBDGRECCFAECZEEA.BCHB....hAAAbEAEDGGG.GGADhABA..gGBDhAAAfBBBAIAESGEAdEGF.LABBhADAIHHHNEIGOAEAhAIA...,1,-6,-20,14
DKLGIgXVSBdWPEFCTJUNQOHYRbZMAcefa,eCFFaEHHLBFCGCAE..XFBHSEEEBACFdDBEEAGEFACECGGB.hAAAJGAGQDGAhABA.OCDHYHDChAAARADCMIEGADFGDBAH.KCCE.IHHB..hABA.gEDGhACA...,1,0,-26,26
LGdBMNJSeIQWXZEYbgfcAORPUKHVFaDTC,RFDEUDBHHBADFGDFDCDGLFHDBGAD..MDHH..SCAEhAAAeHBAQDDHXADFhABAEBFG..bBGDfADHhAAAAHABKGAE.aDAHCFFF.NIEH.JAFB....hACA......hAHA...,1,-10,-25,15
LOTIdZCQSfDBRAbWVHKXYNGUJPeMgEcaF,VADBHAFDXDAA.GEEEPFFFeCHBEAAG.FBACLFEDhACAIHGFCGCG..SFABhADAfBDDBAGEhAFAAICCWFAHKDGHNAIE.JCCF..cDDB.OAAAhAEA....hAFA...,2,-13,-11,2
UKVZeJgWdHNGRFOLEbMQIBaSCYDAcTfXP,TBDEXCGH.UDBAZEEFeFAA.JAABdAFD.GFCFFCHFLAFGhAAAEACFMIDCBEABCGHHAFHB.hAAA..fEGChACAKGAF..gBEGNHAD...OCAHhABA....hACAIHHCaEDA,2,-18,-17,1
TBIJGaXRWbCEKdQMSgDOHNVLFePUcAYfZ,ZAEFTBCHJDAC..GDGGRGDC..CDEEKAFHQBCE.MFFFhAAADABBHFAD.NCHALEAChAAAFHACUAGBAGIDBHHFhACAIBAEXEEAEHCE..SEEFhABA....OAHFhADA..,2,-22,-15,7
MJUORQSPIFHYVBDALdfaeXgbCENKGcWTZ,LCABdCABaGEG.eGFA..XDFGCEHBEDECGABH..cGBDhAAATGCFZAFGJAGFREAGSABGhACAFFFG.hAAAHGFCBFCCAEDAfGAAgCCAKHAGMAEBhADA......hAFA...,1,-8,-14,6
NMGBdTfIeCZEWObFgUSHJcLYKaVPXAQDR,DCEFRAEAMAIBBBHH.dGHG..TCBEeAFAZFEFOEGF..FACESFDFhAAAHDFHLFAGhAAAaEDA.VCAAXEAChABAADHC.NEIG..ICGDCBAC.EABAgGCAhABAcGED..KHAChAEA...,1,-14,-20,6
AMFOdDYWICNaEKeJXcUfSTVQbGHPLBgZR,FFADdGBHDGEC..IDFGCCAA..EDECeEDB..JEHDUBBBhAAA.TFGH.QAFHhABA..hACAHABABDHEgAGBAGCEMIBGWFFFKDCHfHEHhAAASDAG..hABA...,1,-19,-54,35
GXUTJgSIdWVNYDFBKfEabAcQLZOCPMHeR,QCEGLAAHOFGDCAFDHAGBGBFA.UDCFgACFhAAAdGAD.VFFHDAEFBEHBhACAfCABbFCD.cEBChABAMAFC....RFEF.XGAGSACHhBAANEIA......hBCA...,1,1,-12,13
NSeWbdVQHZaTUPfCGBYMELRJcXOFKgDIA,eDEAdFFHQFBDZFDEUCBB.CAAG.BFHG..MAEGEHACLACGhAAARBFA..XCAGhABAKHEAIAHANHEH.SDADhABAbBCBaEGAfEDH..YCEEhADA...hACA...,1,-21,-25,4
gGfKLXANEISDWdQBcYeJUHPZaOMRCFVbT,EBEESFDHDEAG.dADHQBBCBAABeCCAJFEHHFGB.ZEAFaBHHhAAAMDIBFGBF..VDEChABATDFG..fGHEhACAKAHFAFDFNICF...WFAEYCAE.hADA......hAEA...,2,-29,-6,23
ZELfGKJePNHOaTAXdFcgSMRVYbIBCDWUQ,XAEAFEBG..SEDHRBCG.VACGbAGHBEFF.DFHBhAAAUDFAZEAELBAFhABAKCAGeHBE.HFDFaAFAADDCdGFEhACAMAIFCCBG...EGGG.JHEC....hAAA......hABA...,1,-6,-24,18
WLCUNERZbPDfHKVBAQXgGIOFSdeYacMJT,QEGFGAEEOEEBFAEFdHBFeBBD.aACEMGDG...TCBEhAAACGHGEGFFZAGF.DDGHKACBhABAAIGC.IAGHSGBChAAA..YCAFWCAD.NDED..PECEhACA.fHEBhAIABDDC..,1,-9,-24,15
XAgPeQcKFIaLRMfEWSTdVCUZGBNDYHObJ,eFAEKBEDFFGDLGEE.RCDC.MFBEEEFG.SGCDdADFUBAEBBGFhAAADIEEHAFEOHDEJBBD.hAAAAHID..QGADhABAaEGG...fDHEWEADCEEE...hABA...NADG...hACA...,1,-6,-36,30
KcXCABZFJPHIYGEbgQMNWDOeRUTaLVSdf,ZFGFFDFFHEBGGCBDECBGQGDE.MBABNAHGDFIB..OFBHhAAAeHFGRGAEaECHLACAhAAASAFF.fAGFhABAXDAGAGGGBDFA.IBBE.hABA......hADA...,1,-8,-19,11
KSVPDNMEQZfYOTLWgHJIacebARBFdGXUC,BCBDGBBBCBGA.KHDG..SAEEVFFFDHBA...EGFCQAGChAAAZACCOAABLFAEhABAHDCEaGEBeEEC.AHIDFDAAhACAXCGENDED.MIAE.fEFFhABA.....hADA..YHFG,2,-15,-12,3
LNVdPXFKQYfEWUJTMSaHIGgBCDZceAObR,RFFAVFAGdAEFFHAG..KFFH..QDFFEGDHUBCG.MBAFHBEGGDCGhAAACFHEDAFE.ZBDCeBADhAAAADIBOCBB..LDFGhABANICD.........hABA......hACA...,1,-16,-19,3
NfHOGRdULEBYAZPCeKTFIcVQMbSJgaXDW,CFDAKEDAFAFF..VGAE..MBCF..SHFAJDFG.aEGChAAADIAE...NHAD.OBDEhABAGADGdDBEEGFAAACFeAGBhADA..ICAF..QGDGhAEA...hAAA...,2,-52,-23,29
dXeOUBDCEJWGbFcgfRVLTZSPYaNAKIMQH,MAEDHCFGdABG.OFEABCGFDADB.CHHF.EDAHGFAHFAGE..fCDGhAAALFFHZAAHhACASFCDaAFAAEIFKDDF.hADA.IGEA.XADAeBHHWBFDhAIAcGAC....hAEA...,1,-25,-28,3
VdSZUPebYDaWMHOCQcfLgBAXJRKENFGIT,XBABKEFDFAFBGBDG..IHGCdBAHZDBFUGEBeDECDFBB.hAAAMCCCCHBC...fFFHhAAALDHDBHCAhABAABIFEAFBNDAESDAD..YDDFhABAaAHH.WHCA.ODHFhACA.,2,-28,-22,6
JdObRYUfKBSMHTaEcgeNVADLQFPWZIGCX,LCFFQEFGFCCCZADCCDAG.dCHC.RDDBUEAEKAACBHCF.HCGDTAAGhAAAEGHB....eFBEhADAACFFDGHD..IAFHhAEAJHBG..YCAGMIEGaAHF...hACA......hAEA...,1,-21,-23,2
MKDZJdeSPXHFaBcOQWLEVIACYGgNfbRTU,CBHAGFEF...NDCH.bAAC..RAFEUADEKBEHDDEDZDEE..JGBGSBBFhAAAHDAHBGHFOHAChABAQGEALHFGhACAEAFGACCH...fDFF.MFFChABA.....hAHA...,2,-23,-19,4
bCZLaHOKgDNXeEBVcYGPSQfWJAUFdIMTR,dBHETAAFREDGZGCA.LFADOEBG..DEGDeDEEEHFC.BBBD..hAAAVAGFGACDQADFhAAAJDAGAGIB.ICCEhACACGGE.HFCE.NEIGXGAD..hAEA......hAGA...,2,-25,-8,17
VTYAfWIHCgROdEUZFbSKJNGQDMLeXcPBa,..IAGCHFDCCDHGRDCGdGCGUBGDZFDH..FEAAKACAGBAFDAGC.MAFHhAAAeBAH...XEAHhAAABFFHaHGC...hABAYDDAAFCA.fBHCWHBAOHFEhACASABE..hAEA...,2,-29,-23,6
GHDIcJLeBEgWXPOQUbfYZaTFKVCMNSdAR,RCEBDCAF..JFBFLEGDBDCG.EBGE...XEBFOAEAQGDAhAAAUGDB..hABAfCCDZDGFaGGCKBBChACACAHBNEIAAAIF.HAAH.cFAHeDAF...PBFBhAAA....hACA...,2,-27,-23,4
KCcFUYLaHTAGSXNIfegDJEdbRPZVBWMOQ,SDHFXEBF....ICHAfFBHeADBDACCEFEBbFDEhAAAZBFFBHAFMACBKBFGFHBEhAAALDBEaDFH.AFEA.hABANIEFJEAFdBBF..PFHDWEHH.CAEA..YHBGhAGA....hAHA...,2,-21,-5,16
DRHcbVTWEJIUFfBCPaNASeOKLdgYXGZQM,SEFGKEGCLBBFdEAH..XCFCGCBFQAGDhAAAMHBCDGACHEDAbGAE..TGEAhABAEAFAIGHHUACBfCGChADABADGCCDFNIDFAEAH..gGGHhAFA......hAGA...,1,-4,-18,14
OCBdEJPRWeUTKSQDbLXYNcZfVFIgMaGAH,CHBDBFCFdEGD.JDGBRGDG...UACEKEBD..DFABLAFE..XBAEhAAA..cFCEhAAAZCEC..FADEIBGHhABAMAIDADADODCFECBBeFEH..SEEBhABAYDDENEBEfGGBhACA,1,-34,-51,17
fXFcRWYdKAIbUDNaTePJCMLBHZQESOgGV,UBCEaEBF.eADECFFABDHBZCGH....EECFSDDDGAAC..hAAAVFEGFACCRFAB.dAFEAHHFDIAAhAAA..NHEF..JBABhABAMHAC.QCEGOHCC.fAGBhACAcEGFKAHB...hAIA...,1,-13,-26,13
UaVgEfFQSMKPBHJORbCXeIWcGDdYAZTNL,TEADLBDA.aBCHEAGE..QEBHKAEHBABBOGEGRDEG.hAAACHCG.IGHGGDDFDIEChAAAAAEGNHCD.UBBH.fGHChADAMAHFJCAB.XCGEcGAC...hABA......hACA...,1,-13,-23,10
KeAEVUZDRJbaCNTMWgYIGPOSBHQcfFdXL,EEACVABGZBDC..DGAERFDD....JGFACHGEMAIH....gBAGhAAAIBFEOEEAhAAABBHEQGAFhABA.FDDBXGDBeAEAAIGCaDHH..NBAGYHAChABA.SFHBhAEA,1,-25,-35,10
LINRVQgOYacZWbeFBPMAXCHDKJdSTUEfG,CDBCKFCAdFEBUBAHGABDLDBG..IGCHRAFC..QGADhAAAOAEA.aFGBZDDGhAAA.eFHHBHGHACFFDBIHhABASEFFEHEC.fHDHNBHA..hABA.....YDHHhACA,2,-30,-28,2
TSLQCRIZEMHaDPYGKbXdVNBUWgAfFJecO,FGAHeECHOBFGLFEH.CBDEZAEFEECFMACEDGGA..GAGGKHEAdBCDhAAABHHEUEFCACBHJDAH.hABA.SBBDhAGA.ICHAaAAA...bDDF..XCCChADA..WEHHhAHAfGAG.,1,-17,-25,8
bJZfXIcRSagWKMOBLeFHQDYEVPGCTAdNU,dAABUEGDZDCA..XGBERGEA..SHCGaBFA.KBHHOCDGhAAAeBBAHAFHDGHBEFAHhABAGEAECFDE.TEGHhADAAACG..NCCEbFEHfFDA...hAEA......hAFA...,1,-8,-34,26
TAJbOCHVZIYXgKeNQSDGWfEFadcPUBMRL,JEHDODEGHCBEZEAA....IAFBXBBEeEEFQAGEhAAADIDEGEAGEGEGaACGdABB.hAAAUGAGMDGBLEHFhABAADHECAHH...........hAEA......hAHA...,2,-22,-10,12
HJGcXWRTZdKLgYaVBDeEFfbSOUANMICQP,MDADCCBHHFBHGEBG..XFDHRGDCZBEDKGGELDFC.aGGDhAAADEGGFBFAbBBGUADGAAHD.hAAA..IABFhAGAJABC...WDBAdDDCYAHB..hAEABFFF....hAHA...,1,-12,-22,10
GgKCZRXAPacINELeOQdVUFTJMHfDBbYSW,aBHH..IACHEDCFLEEBOCDHdGAHFFFHMIBCHCEE.BBHAhAAASAFDGGAHCAGAXACDhAAAABEE.NCBAeDFGhABAQEGEUGGC.TBAA.DIFG..hABA......hAEA...,1,-3,-20,17
MbVEWgFLCeDZYKdOScATBaXNfHGQPRJIU,aGHHXCEDHBEFQEAERECB.JEFDUGAA.MFGBEBCDFHCChAAAeBADDGAFKAEF.dEHASDAChABAACHCBCCH.NACD.hAHAPAFA.IBBBWBHFCECHOEHFhAIA..cGDE.hBAA...,1,-9,-20,11
JYBEZWHeGVDfcRPdUbgLOFNaTXCIKQSAM,JFDEEGCDHDEBGCBEDBCH.RAEC.dDFF.UABDLEGB.FCADaHGACDDGKACChAAAAAFG..BDDEZFAFeAHHhABA..fBGBhAAA.PEAB...OHAEhACANIEB.IFHGhAEA.MIEE.,2,-24,-11,13
JLdBRIZAeDQHaVfFXUCNgcTMPGWObSKEY,eHAEHCABVFDAFABFUEBA..CHAH....NCIC.TGDHGADBOAEFhAAAKAAD..EDEELAGHhADABHGA.ZEFEDCHDhABAaGGCfECH...cGCChACAWDBE...SCCChADA.,2,-20,-20,0
NKOFfPIQVLcHGgEMABCYTZUXDbWaSdJeR,BEHFCCCFZAEE.DEAE..aCGFdACG.RFFB.KFDAFBGB......PAABhABAVDDGHFCF.hACAEFACAFHD..UEAHXBAHhAAASGGG.NCIA.fHABhABAQDEFLAFE.hADA...,1,-17,-39,22
OPXIGWJSBfZgeUDQcAEVTLHRNKbYCMdFa,VGEGLEBG.HGFERDDAKACCCHBFdBDH.ODEG..XBGDhAAA.IFCDhABAWABHBAGAZBBGeHACDAAFAIDATEGEhABANEIG.MDAHaAFG......hADA...PGCGhAEA.SBGA.,2,-17,-11,6
cfdGSeOBQJZXKPMHUDYFRVbELNTaAWIgC,..IEFECGHEdECFeCCGBAAEZAFG..KGAGMCADDIFC..RCCH.EGFHLBFGhACA.TFDDhADAAAAC..WCGBfGGHhAEAOGAAJABEPAFA.....hAFAYCBDFGDD..hBAA...,2,-38,-26,12
FcMCZabAGPKYEBHOQDdegSXWLVfUTNIRJ,GCEHKBECEBBE.BHEHHFAEOEAADAAE.dADCSFDBLEEAUGAEhAAA..NCIEIHHChADAFGHDCCBE..aAFCADEDPHBEhAEA.QCFE.XFFGhAFA.fDBHhAGA.,2,-28,-27,1
QaIHGXUJdCAFgSZVeTDEWOPMbYRNcKLfB,SEGCVBGB.DEFHOAAA.MGEAbECF...RDCBKFBHBABGhAAA.QCABhACAaBED.IAFH.hAEAXGGGJHFEAEBHFEEAeHAGEHAGWAFENDDH.LBBGhBAAfBGH.hBDA...,2,-19,-19,0
AUcCNfYIbEHJZaPFGSRTLeXVQKMWDdgBO,UGACCFEB....fAHAIEDFEBBGZDBEFGBG..RBEHeGFAhAAAXBCCKCAFDEGHBDFDhAAAAFAG....NAHC.HGFEhABA.aACASABELDHDMICAdGDG.hAEAcAFG...hAFA...,2,-28,-15,13
cZXPKSRJbagFDeLCfTQAWNUdIOGBEHVYM,UBECODCBBDADHEFH.MIDCZFFAKGEF..SBCARAAC.hAAAaFDCDAIDeBHBCHCA.fGBEhAAAAAHD.dBAChABAIDCEEFHF..YBEB.XAFBhACAPHFEJFAA.hADAFCHH..,2,-42,-8,34
eObLWBYXSMcKZdEINfFDGVJHPUQCTgaAR,OHAALCEBBGEHSACAKGGH.EHEA..IECHFDAGDAAAGFABhADAHADBQABChAAATDCHAEHA.REEEWAGBhADAMAIBdGGA..NAIG.fAFF..hAFA......hBAA...,2,-22,-19,3
eEUXGSQfFKdRAbHJDMPVCgTLcZOYBNaIW,JABEDDCCMFCC..CDDDLBHHOGDCBGBA..aEBB.eEDAhAAAXABDGGCHQBGEhAAAFAEEKHGA.dAEHAFCH.hABAHDAA.gGGB.cDGChABANCCDEHAGfFGHhAHA...,2,-30,-14,16
XFQcOAaGWdUSCLJgYRbVBPDeMHTKNZfEI,aDGDdABGCECALFDD..JAFFRADDBGAGDGIB.HBAGKFEB.ZDAG.EGEChAAAFDAA...QGAEhAAAAGHHUBGHSGHHhABA..bAGBeFBBMEHB...NAEE.hADA.....XGFHhBAA,1,-14,-38,24
LPVJcfUHFRYTNdAEeMWXCISbgKaQZBODG,MECDCFBC..SAFGKBEBZEGHBCCHDEGCLFDA.JCEHfEEAhAAA.FHDEhABATCBDABBG.EHFEeEABhACAIAACbAGFaADGOAHD.GGABhACA......hADA...,1,-27,-31,4
VXYPdDcWEFINHLSMAeGROUTJaQgfZBbKC,GCBFUABE.aFHBQCGBZEAFBHDEKDFBCFDH....XBDFhAAAdABCDCGGEACCFHCGIGHFhAEALFCGAAGH..RDEDJFAEhAFA...fAHC...hAAAYHFAWFADSGGDhAFA,1,-25,-36,11
DHYUVTNfOAZeJCWgGSRcdIQPEXBMLbFKa,eDAFJDAG.CHDG.GCFCRDDE.dAFFQBGA.EFDDBABELGFChAAAKFDCDIFAUACFTGBEhAAAOFBBZBBC.SBAFhABA.PHFEMBIFFFHDaDCB...hADA......hAFA...,1,-7,-32,25
JTUKDCPebZXYLSRAfcVEGgOMHBNFdaWQI,VCEEGDGG.MBEGHBBGFGCDdGFC..QDCGIHCEJCAHUCAAhAAA.CEFC...bEEEZBFEhABALAFEAIGCEFADBADFhACANEIA....WGBC.DBAE....hAAA......hABA...,2,-18,-15,3
EPKObRLdUCTHSABQGaXFcDVgWZIJMNfeY,BDEFQFAGGBBBaGDBFGHH.DCAH..VBCGZGAG..MEFCeBADhAAA.EEHHKGFHRDEELAGDhABACAACHAGF.AHCHcGGChACAIAFF...fEBC..hACA......hADA...,2,-34,-3,31
aFebgPKSVOLQTICXZdDRBNMJAUGWHYfEc,UFECHEAFEDFGFBEG.eBCB....PAAEVFEALAABhACA.TAEECHBHZDGDdDAChAAABCHEMIFGAIAA.GCCChADAfEDHaAHHKGACSHFA.IHDBhADADEIB...hAEA...,2,-24,-1,23
OgdEIbPZVKeLHRNATUFCQDacMSBfXJGWY,UBBBQEBBDECE.aFDEMIAC..BGHH.XACBJHEGGBFChAAAOCHHdEHAEFAFIHBFhAAA.ZAEGKBHBHCDChABAAEFBFBEBCCBGSGGD..WBADhABA......hACA...,2,-35,-7,28
bOJRBYdHMLfNPWZDXFeQIgTCKEGVUAacS,aFCESHCE.OAGDBAFGdACE.MAHBLEEA.PACEhAAADBBDFHEC.IDDGhAAATGGGEGACGDFAhABAADGFbCCEREAF.HBAE.NBIA...XCEFhAEAgECDCHHCKDHH...hABA...,2,-19,-8,11
WUBZMNceSYCDGLXaEHQOKgdVTPARFIbJf,FAFHJFCF.UEGEBBEFZEBG..MGEE..eCAACBCC.LABEhAAA.EBHB.HGDCOHFAhAAAKHACdDDFTBFAAHIH.hAGARCAE..IHAA...fDFEhABA.NAEF..SEDGhACA,1,-23,-36,13
aReIKfCTSGVFXLdBYJPbUMEZAQcgOWHDN,QGBAOBDGDFEH.RAFHKACF..TDFDSFAFFCBELFABhAAABDEF.JFGBUFEDMDIDhABAADAD....WBABhAAANEAFeAHH..IFHBCFCE....hABA......hADA...,2,-41,-20,21
DbYLFMXCWKGVfEAHPBSTIORcdNeZaJgUQ,BECATAADOCEH.dCGBZCAC.JFHFQGEHDAGCLEEDFAFC.hAAACCGE.KCADGEAC.hABAEFFBADCHSBBAhACA.REGBeHAC..aDGC.bFCH.MCCChAAA..XEADhADAWAFG..,1,-17,-23,6
UDXHMWScPBagFOGdCEVNTeQfYIRAbLKJZ,KCCEZAAEUEFGDHCGHEBA..MEBFSEGEBHFHFFCEdEEA.CBHF.ECAFhAAA..TGGB.hABAeADAfDCDhACARBADAAAA.JAHF..WDADaCEG..OFHDNIAB.hACAIHDF..hAEA...,1,-14,-33,19
XAgGBRYQabMcCDVJdLIEeTNfZSOWFUHPK,BBFHRDEAQDBHMAAHDGADdGAC.LFGF.eBAHfHBHhABAZACHSBHDODCFFFEDhACAUGCAKAEFACFC.GBGGhADA.aBBBCAFB.IHGAEFHF...NEIE.hAFA......hAGA...,2,-29,-4,25
JLHVWPAXEYZfISbgNURBQeOFcTdCDKMGa,EFBAZAGBSBAA..NBDDRBAEQGFEOHCC.FDBBdHGFCEFBDGAEhAAAMAACGDCGLDEEhAEAHAEF..WGFChAFAAHEFfADA..IEFC.hABAbBFEBHHE...hAGA..eCHH,2,-27,0,27
MdNeLTCWPbFSJVYIRGcKaHZXDOEfABQUg,UDFHMECAdFAHLBDG.CGDG...PBFGSFAC..hAAAJCBCVBABRFFDKABAaGFAZFCBhAAA.DADE..EAEAAHFDBEHDhABA..NIDDeBHB...WDDBhABA.FHAG..IHAFhAGA.,1,-14,-39,25
RDOQLfJaXgBVZcSTHPFbUdAeGYNEIMWCK,GGBDEEDD.MADHKAEHRCDGDEGBLCAF..fBAGhAAAaDHHBGABZGFGSDEDhABAHAAGFGCFdAFHADCH.NAICCCGE.JEAGhACA.....gFGH..hAEA......hAGA...,1,-20,-23,3
PWCFSXfZdUeGTcHbKLgNADMORYBEIVJQa,MIAGRECEBGGC..VCFAQAED..PCCBCGAFFCGE.SAFFhAAAZCAEdAAE.eFEFhABA...TACEhACA.HGFCKEHBNIBHAEAHDBGAEEACIHHCaEAD.hAEA.fEDChAHA...,1,-14,-32,18
DEXUAKIGVQSabRNMJYZfHdcCOgFWTeLPB,KECGGBGEQCGAaFCDRGFA...MGEGJDEFZCAHdGAEOBCG.hAAAFBADeABABGCHDGEFXCEHhAAAABGDSCCHhABA..NABH.fHABCCDH..WHFGhAGALAFE...hAHA...,2,-29,-10,19
fHQMYOTGNZRVBSaAIECXgDUeWLPKdJbcF,EBBGXACCDECE.UECBLHFG.KGBEdAAE.JFAHFFFGHFFCMAFBhAAAOGCCGAGGZCDCBACEhABAaAED.AIBA..CGDH..hADAeEAF..WHDA......hAEA......hAGA...,2,-25,-22,3
LCUHKBgaPYcJZFOEWADXSMTbeQGNfIVRd,XDEHSFAB.MACFeBCC.GBGC..IEFEhAAARFCFCFAEKAAAaGGBPECB.JAHDhABAFCDDEFGCADADDACE..hAAATBDENEICdAGB.HGDEBGEAcAEA.WHAGhADA.fDDGhAGA..,2,-14,-4,10
YQcCfOTbJdPBLFHKSeIXWVaZMAgGDERUN,DECBEAHBUGFDQADA..CFCG.OEGDJBBH.dCBFBDFHHDEBKGABhAAASGAG.hABAXBGBaHCGZACCAAFGgGDBhAAAREFC.NBAG.fDDH.hABA..PDAB.hACA...,1,-19,-30,11
GRMBIJaXAPNVDZScbdTgCQKHfOWYUeELF,VBADDFDAZEAD...SFHHdHBHCAHEHFDA.OCFEUCGALAEBhAAAFFHB.MADHBAEAhAAAaCAGADDA...NGDF.cEADhABA..........hACA......hADA...,1,-33,-35,2
UacKebZdgDGOHCRIFYMQASXBTfLJEWVPN,SABBBBGHLBABEFDH...VGAEUDDBKFFHeADDZACEDIDEOFGDhAAA.CEAF.RDFEFFCAQCGBhAEA.AAGCfEBChAFAPDCG.aHCC.dGFG....hAIA......hBAA...,1,-14,-32,18
YJFGfaegLWDPUTNOMRCIdXSAcHKbQBVEZ,HGBAQGEDBCFEZAAHFDBFGEGCeDGFLEBCDDDGUACBOAFEhACACAAA.dADGAAIF.KHFGEBFDJFHFhAFA..aHBG...hAGA....WAGB...NDAAIEEGhAAASFDA...hADA...,1,-14,-29,15
KXdGbRODYcFAaeNLZMQTISEfPgJBWHUCV,aFBHeAFELHDEMBAE..QCECSDGCEEGG..PDAChAAAgEBEBFCAHADHhABACGGGKGBA.dAGG.REGHDACBhADAFCCFAFFBTEEA..ICAFWFAD..hAAA......hABA...,1,1,-25,26
cPCKRJBaIVAXYNUfeQSgOHFGEdMTWDZbL,XGGFUDBGQBEG..OBEFGEEH.dCHGMAGDDHBELBAChAAACEGBKCCDBBCEIHGDhABAABAH.NADB.SEADhAAA.FHBCEGDEWEDF...hACA......hAIA...,2,-40,-19,21
eANVFTOHKUdaYfSgWLBCIXRQEZMcPGDbJ,VEAFOBHB.UGGAdFDG....aHFESABBLCHFBCAHhAAAXAEHRAEAZDDA.MACChABAPDBC..DIBGJFDEhAAAAGGBFBBATGAH.KEAD.fADChADACAHB.IDFH.hBAA...,1,-18,-20,2
ANUPcaJETBWXLOfKRMVbCFYIDeHGgSZQd,UEFAaEEG.EEDEBCEALBABKCCE..RBAD.MCCACGBF..FBFAIGAFhAAAHGFG..SGDChAAAQGCCAFIH.NDDD.hABA.JHFGXEAG.OHDCfADHhACA.YBFChADADADCeCHF..,2,-26,-22,4
AaQYEJKFDRPdMLBCeNTZcIVgWXGHUfSbO,QAGFJBCG.DCCHdDFFBGCFCDDH.eAACZGCC....IHAFhAAAVGFG..gDFAhAAAGBAEUFGEfBEDhAEASAGBbFDHADEHaACGKHAG..FFCAMDBHhAFA.....hABA...,1,-9,-34,25
gXPHALWURFDaOfGYJTBMQKecbIVdZECSN,LFFGUEACRCDF.FFCGDBACOBCEGDFA..JDDEMDAC.KHCEeHEAhAAA....bAFChAAAdCHE.CHAGSBAFhABA.NAEFXCBCAEIHfACBBGEGIHAGhABAEHBG...hACA...,1,-23,-31,8
YSLBgTCeDKRWMGIVfEcXHUQZaPJAFdObN,OCCC..YEADSGFG.BGBFCBHBKFFAMAIDGCBHhAAA..IGDGhAAAEABEXGBHHEFGQAEFhABAPBGHAFEF.FECANADDLHECeCABDGIHWFADhACAfECGcCFEaDHDhAIA...,1,-8,-26,18
BAMYCOGIcXKgQWLTSHdFZaefRUEDbPJVN,CAGEOHAEGCDH..XGGEKBAG.QFAFTEGFHGECFDDDZAEFhAAAeECHRBBF.DDAGJFEEBAEDhAAAAHDG.MIAE.IFAGhABAcACALAHB.SBAFhABA....hAGAfEEG.,2,-18,-1,17
OfSDGACIHQgWLeTUFRNKZaMXYdBcEJbVP,HECHQAFALFHDeBAGUBBBRDBH.KFAAMEEFdBEHBGEA.EAHDhAAAbGFA.OFFGDACGAHCF.hABAIHBA.WFDDhAAANEGCZCEG..aCAH.XBDH..hABA......hACA...,2,-18,-14,4
ZQAMfTINaGSOPHLDVEYWJgRKBbUXCeFcd,MBDETECF..aGDGOCEFHAABLDFC.DGCDVBBDEEFC.hAAAJHDCKHGCBCGHUDCFXGAHhAAACFHFFEAB.dFGAAAIF.hACAIAFE.SDAD.WABChAHA.....hADA...,1,-19,-20,1
DaEdSCIJUBRQOKHVfNXYbPcFMLTAeWGgZ,GDCBZDDFEEAE.CADAUGFABHFCRADC..KCFEHBGD...VBACfCBBhAAA..NEIE.hAAAXGBE.PCABhABAMDGHAAIH.gGADDBFGaGAGSEHBhACA....hADA...,2,-32,-18,14
SaKDYVUAWgCdPBLcQTObfEGIeMZHFXJRN,CGGDBADGLFBFQDEA.OHDEEDFFGEDCMDDB.HBAGJAFE.hAAANAHE.KABHDAEF..UEGChABAADBHdAFG..TEAChAEAfAAF.IFHBeGCAFCGA..hAFASDDC.hBAA...,1,-14,-17,3
TObZXgfEdADaGSLNYPWQIMJHKRecFBVUC,GBCHSABDLDAB..NDBG.PFFAQFED.IACBhAAAMIDCKGEGeAEAhAEABHHHCCEF.TCGHODGDhAFAXABCfDCCEDDDDACAWHCAJAFA.HFBBhAAAFAHD.....hBAA...,1,4,-23,27
TIgJeWKGbaMSNYXHZVdPDUQfLCcOEABRF,FCDHTEBH..IGCDeDGHKBGE.GABDaCFF...MEDGhAAANEAC.HGDCdBAFDFHHfCAFhABACADC.ECDABECGhAAAgGADJFEDSGFH.ZBGH.hACA......hAEA...,2,-34,-8,26
feBPNVWDdbLKTcIUaMEJYXOCFZRGSgQAH,HDAFBBBA.VDDCDCGFdCDCKGCH....TGFEIHCH.UGGChAAAaABCEADG..XEAChABAFCGF...ZFBEhACASAADAAIDeADC.WBHB.cCCBhACAMFFHOAHH.CCEH.hADA...,1,-11,-33,22
fVcFAdGgNaLKWXUebRJMSYTEQDICHPOZB,GCBBaDACLHBEKBACUAFERDDE...SEEAEFGHQCGAhAAADIEGHFGDOACBBEBFfBDAhABAFDHFAGDH.NGAHeFHHhADAJACCMIAE..IAFACBHB..hAEA......hAHA...,2,-21,-9,12
GZPgXNTcHMbOYFVdaBWDKRLeAfIEUCSQJ,EHDGCEFB..QBAFZCAE..XCFDTDBBHGBGOAHBFADGhAAAdECDBCGADGGB.KFFFRAAAAFBHhAAAIHHEJFHB.gAGChABAMAFF.bDDBaGAH.eGBCSGAChACA...NCIA.hAGA...,1,-11,-13,2
DZOVHISYgeQaUJKELGcbfdMTBPFXCWRAN,DIBCOEDCHBDG.SDBDeADEQBBBUGEF.KHEALAHHhAAA..bDGBdBCCMCEChAAA.BABEXGAGhABAWHAGAHIFZEDE.IHHCYEBFaAEGEAGE.hACA..fGGGhAIA..,2,-18,-10,8
AbWENMLCVaXBKcSDPTIHOYGdZfFgJUQRe,EAEGMBAALCEB.CBCF.aGDHBDCESHFCDGCA..TGGFhAAAHAEAOCCF.hABAdCACfCHAhACAFEHFgGAFJHBCQDAHAGGEWCFAXEEGhAAAcBGB......hABA...,1,-20,-22,2
KfJOHeEFDgIMZQGCNWcXYVLaATbRSPdUB,RABBdCDBBHFBKHFC..OEADEFDH..DCGHMABBGDAE..CFEG..hAAA.NBIC.XDFAhAAALADBABIH.SFGBhABA..fHBHeAGB.IADEhACAWHAG.YAFEhBAAaCED...,1,-19,-52,33
AdVXHFfRYGcTCBbJWUaEILNSZMPgQeDKO,VBDCFAFARDDFGAAC..CEFEBFHD..JFFBaHCEEGCELFADhAAAZBFA.MBADQEAFhAAAKGGFdBGEHDBC.hACA.fADG....cBBBhABA.WBHHNEIE..hACA...,2,-30,-16,14
UJbgCdcfEOZBaFKHMDAGQSWTNVXIPLRYe,SBDCTEAD..VAEFXGGF.LHDGeGDCJEEAgDGChAAACABC.dGAEhABAECCGBDEBFCHFKFHHMBBHhACAAAIDQGAFNAEHRECG..YBFGhADAcCBCOHEC..hAAA...,1,1,-19,20
YBJNcOaKGMDPTfVLCSWFRAeXHZQgbIdUE,HEEHZDCCQABD..gBGEdEAAUGFFEGBCBEBHJAFFNDCDOBBAhAAA.KCACMAAFhABADEGC...fEGBhADACAEESGABWHAAAAIHeFCF.XGGBhABAIAHH...hACAaFDF..,2,-24,-17,7
MVUgeBQPaJHcAKIOfFbDTEdRZSXNYLWGC,KCCGOCBAFDHD.DCABdFDGZBFA....SCEHXGFDLDEEhAAACHGE.UFAHeADChAAABABDaAHBHCAFABDE.hACAIGBHfFGBEFFF.NIAD.....hADA.WEFFMIBC..hABA...,2,-33,-24,9
ZfAbQVeCPDFGYMTcUgRHIBJOXaEWKLNdS,VCCDeBAFDFGE.FGAFMEBB..UGGEHAFHBCECJFHB..XABFhAAAaBDG..KCBBdAHEhAEAZFDDAGFFCFDH....hAFAPDECYFCF..gAFBhAAA.REAEOABGLFFBhBAA.fBDD.,1,-7,-18,11
COgdQKUIHFTGeZYbEBDXARJSNcPVMaWLf,SGFF..PFDCaBFFLCCACAACdBFBKGCDHDAHGCEDhACAeBBE.bEFEDIFEAEGCJHBGhAAA....cDBAhADAMAFA.OEAF...QBCFhAEAIHGHFBHFYGFGhAFA.BEHD.,1,2,-19,21
PdBIUfOSZVaJMHTXbeCWYFREGcNKLDgQA,dFDAUFEESEBDZBAD..JDFAMCCHHFCH..XDEAhAAAeACECAGD.FGHBRFAB.EADH.NIBF.hABADAIB.ACCCBHHAOAHFhACA.aGAC...WAEHcCDGKFFD...hADA......hAGA...,1,-16,-31,15
YVaPBJLZIGRQbKWfOgNScFEUMDeCHAXdT,TBBHaBGHBHAA.LACDGCFARFDD.KECFOEHF..gADGhAAASEBEFAGFEFDFhAAADAIHCBAAHFFBABAC.dFADhABAPCAHIBDCWHFANAEFMBFH..XFADhABA.YDHBhACA.,2,-24,-7,17
QSAOdLYcZIJKgabFeCNVUfXETDHRPBMGW,dAABLHDEZDDEKHACaEAC..eADFCBCD.UGGEEEDDHAGF.BBEGhAAAGAGAQGAChABAAFBAOGBAIHHA.hADAJDGFgAEHFDDANACF.fBBEhAIADEIHMBBB.SFFChBIA...,2,-28,0,28
VcSCYdgMRfaPNUAOeQIWXHBbGETJZLFKD,OEFHeAFCQGFB..XBGDBBHHGFADEGBFJCBGZBBAhAAAFAEEKDFHDAIBSDAGhABACEDA.dACHMFIHhAAAfDDEaEAG.NDIG.AADAIBABWHBA.hADAbEGF.....hAFA...,2,-25,-11,14
aEHZSLTXdgUCNGfBRecKFYAWDPQJObIMV,DFGCJBGD.OBAF..IADEMEFF..EAEBZFDALBGHhAAAdCCCCGBB.GFAFBEEFeDHHhAAAFGHDAABGQCCAhADA...aAHFSBAB.gBEFhABA.NIAF.hACA.fHEB.,1,-13,-37,24
NJOaLYTWADBeHgPIFMcEKfCdQXZUGRbSV,BDHCHFFD..IACBFABCEEDF.CEAG.dAEAZADDRGDE...SAGBhAAA.JBAHaCCHLFHBhABATGAGDCGFeDCBMEIHhAAAfHDD.XCGE.bFBHhAIAODABAEFE.cFFAhADAKEED..,2,-34,-5,29
FPYaQDcBGTWCAbMZgLfKVSedXHJENROIU,ZECDLAACKDAA.VDFASAAE.dAFAHFCG.JBDBEFFGRAFGOEAEhAEAFFBB.aGHBDEGChADABHAATADB.AAHGMDCEhBAAeBBH...IHFC...hAFA......hAHA...,2,-28,-16,12
BEcPMeNQZCgTSAbRKVWIUfYLaHGDdFOXJ,KEDAVAEDUEGC.LDAEHDFCdHAF.XABFBFCG..EHCAMDDBhAAA.QFFHhAEACAFESACFAFIB.RBEB.IDBDhAGA..aEAD.FAHFOEEB.hAAA.cGFHNIDF..hABA...,2,-39,-4,35
VWXZdAfOSIDFPGbHTKeCEcBaULYNgRJQM,OACEDEFBFBEAGDBGHAGFKGGH..CGGGBHAAUDAALEFC.hAAA.NIDH.JEDD.MIBGhAAAXBAGAFGC.SDGDhABAIBAGPCCGeBBEEAHF..cGAGhABAaDDF.....hACA...,1,-16,-36,20
IMOWXQTRPHZdKNBeFGJVgLaDbYUfAcESC,SBCHCBEA.MIFGXDFH.QFAGPAECdCEDKCABhAAABEAAFGCDGAGGhABA.VDCAaFCBDFFAUGGDhACAAHEAIDHAOABE.TBAC.ZFEA.hAEANAAH..eHAG..hAHA...,2,-23,-7,16
WNGMYTaRgCHIQeFcJXDVPBEbSLAKUOdZf,ODCEdBFHZDCF.....NFBB.MHFG.TFAFRBADCDGAHGAA.QADDhAAAFEEFXAADhAAADFGHBHHGSADDhACAKAGD.fEHA.WAECaGDA.IHDEhAIA....hBAA...,1,-25,-33,8
dWPcfMbYABVODEaULGXRIHCQJNTSKgeFZ,OBDADGGAEEBC.UAAGLDADGCGC.RFDH.CABD..QFDGhAAA.JCHHSDAEhADA.eHAEZBEBWCGDhACAfEADMIBCACCEBDDAaAHF.XGGAhAEA..IHHHhADA...,1,-18,-29,11
GHbDLUAKNMFaJeYSIEfPCgdWXQcVRBZTO,KGFCMBDHFCFF..aBFCeDBB..SDGGEEHD.CFDAdHBBXABFhAAAQGGCREDFBAFFhAEATBAAOBCDHEAEhAAADIBEABHDYFEB.fCEGWHAC.hAHAcAGA...hAIA...,2,-34,-4,30
FCQbJANedBIMagHSWfDPcKEZTOUXVGLYR,eAHFBAEDaECEHFEE.SAFBDCGA.KCDAEGDAZABEOACDUDABGDEFhAAALCADFFBHQGGGhAAAAIDG.dGADhABAIHHDMIBEfDGH.TCEBhACA.....hABA...,1,-13,-16,3
eALGCdSMZFXIbRYOKNPHUBaEgQVfDTJWc,LBHFdAFEMGDCFHAEXEDH..RDAEKFHBHBAEBAADEGBGQCDDhAAA.DAFHJEEAhABAeFHDAAHGCDHB.SEAGhABAZACD.YFFBOHEE...NIADaAGGhACA......hADA...,1,-3,-39,36
ICLHcAPXbJRZMaNYdKWUfDVeBTOgSQFGE,XEDBRBDGMEIB...aHDGdCAE.UBGAVFFGeABC.BGEEOBBAhAAA.SBFChABAFGAAEDEBLHAAABIBJFAHNACF.hAHAKGGBDGCH..gDBHIDGFCCED..hAIA......hBAA...,2,-23,-18,5
gEbScZVKUCPOaWfdGLeQFXTHYMJRIDNBA,EAEESDBHZCAA.KAFHUABF.OBEBaFAHdFGBLCHB.hAAAeHBEFFEBTACHhABAHGFEMFDCIDGHDCGDBGAChAAAAHCE..gDDC....hACA......hAEA...,1,-11,-34,23
CEHIFKXVBUQgDWOJdALTMNbZecaYGSRPf,LCCATFED.MGDCZCDEeDCD.aBAASECE.fGHEhAAAECAHFHACKDHHBHCDhABAQAGADGAFJCADADHBhACAcGFEGACDCHDHXACBgBGCdEEF.hADA......hAFA...,2,-25,1,26
beTRISYQMPCZAFDEKaHOfJNdXgBcWLGUV,FEGADGAFKCEDHBDC.JGDEdHBB.BBABLEBHGFCFUAAD.eDDHhABARBFB..SDBEhAAAMAFECHHH.EGHFODAHhADA.XBGDgACF...WCADhABA......hACA...,1,-10,-39,29
dKZcUFMCPRXEYIOBSADQGgbeLJTHaVNfW,GBBBeBECLBCBJFBGHGCGaGGD..VFGD..NHCH.dDACKDFGZCEEhAAAUGAGFGAH..MABAhAFACDABXEGA.IBAAhAAASBEEAAEEDFDA......hABA......hACA...,1,-9,-26,17
cTECaKLUNZBFJgOISDYARGHXfWMbPdQeV,HEBBXAEHMBDFdEDDeAGH...TEFEECAGCADALFHHhAAAUBAFBBEHJHDAOAAG.hABASHEA.hACADFEBAGHHfGBEPFHDcGAC.NAIE.FAHDhADAIEAG..hAEAYDGD.,1,4,-25,29
IYGNLdFHJPXDCAWRgEVBTKSZOfaUMbQec,REGFEGBBBHDFKAGB.ZCDE..aCGEUACB..MCAHeAHD..IBBDhAAAGFABdAAAHGFC.hADAXDCFCAFGAEFC.WFDAhABA...TBEDSGFDOEFA.hAGAfDBG.hAIA...,2,-33,-12,21
LWKADZBadTEIVYfOUecbFHQgMNSXPCGJR,ZDBCdECAECFE..IADC..YADCOAGDUGBC.hAAAeCFDFHGAQEGBhABA.NDBEPBBAhACACGGCRBBELFHBAEFF..DHCABHEA.aAABfAHAhAHA.HCDHhBAAMAIB.,2,-30,-6,24
EGgKDHeNQJIWUAMSYXRZbOFBaLTdcPVfC,SGDDRAFDZABFFEAB.LEECdFFH.VBCBCAHBGDCH..DFBFhAAAeFDDJBABUGGH.hAAAAHAB.MIFC..YAFEhABA.bCFABADH.cFADEEBE.hACAKCHH.....hADA...,1,-20,-24,4
YJBcSOTLRDQbKNFeEdHIfaCUPWgXMZVGA,BAFHOEDALHFADBCD.KDFFFHFC.dGAFHEGD.aEBEUBFD.hAAA.PCBEXADFhAAAMGDE.ZABCAIDGJBABSEAChACAQFGAeHAA.fBHEhADACGDG....WBHHhABA...,1,-5,-41,36
ILWfDXEecFBGSNKHdbORPTCQVAZYJgUaM,ZDGBJCCE.aHCALAFE.DGIDeEDC.BAEBGBFESBDHhAAAKEBHdAACRFEFTBBH.hACACBHGAGAB....YEAFhADAMFFBICFGfDHAcDACFHCC.hAEA......hBBA...,1,-23,-27,4
ZYHPWDaXCUbQdNgecKOFGJRBASfTMEVLI,TGEAMACALBCH.ZBEEPEBFDEHD.aABHUGDE..dAGFhAAAeGAGKCDAFGGAJBABABECSHBGhACA.EEEHhADAIDFA.HFFFCDGCNEAEcADB.hAAA......hABA...,1,-9,-26,17
JbZAdEaScMYDNKVgLBWXPGHOTCfUIRQeF,EGEHSGEC.MAHFDDFEVFAB.BDDAPCBBGBADODDGhAAACGGB.UAEBRAEGFEFGJHFChABAAADF.dFCA..aEAANFEBKBBChACA......WHFA..XFAChADAfAAF.hAFA...,2,-28,-18,10
AgRcDUSYXFZQHaEPNbJLKfIBMVTCGOWed,RGDCDCHHUBEB..XGCHZAAAHEAB.EEEA..bDDFKCAC.BHBAhABAMFFB.CCBA.GEGGhACAeAFBAABASAFChADAFGGCaAHF.JAHDLAAA.IECD.hAEATGACODDB..hDAA...,1,-7,-18,11
AHOEQbdKWFDBPaIJSNRVgcGUZfMLeTXYC,HGCEOGDCQDFDKBDA.FAADDBHDBAGAaCAA.SADFhAAA.RCBF.gDDGhAAAUGGHMFBDTFBFCFDEADEHdAFGhACAPDAB.IFGDNAIG....hABA......hACA...,1,-1,-44,43
BabcHPZLUDKTJgQFSfAYVCeNIEdXWROMG,VBABeBACECFC.dGBFRFFAGDDGBGFG..aCDFHBGB.LAAChAEADAGCKAEB.JAFDFEFCAICG.CEAE.hAAAXEBH.MIEEhAFAPCHF.UGGG......hABA......hACA...,1,-5,-28,23
cXBLGNEQHKdCDOTWeJfPMZgFaYVURIbAS,SADHBDDDGBCBEDHDQFFG.dGBGOCFGeFDHJEAChAAAfEDAZAGB.gGBDhAAAaBAH.UCAHhABAIHHGABCCXFED...LFAFhACA.KGGCDBBGWHFAhADAMFAD.,1,-4,-21,17
aRGQbIefWCFAUJVcYgPNXMTDSZdHKBLOE,VGFE..gECF..XDGBDBGEdAAFBDAELBAHhAAAOGACaADGRFCEQEGEhADAIBGBfDEChABACFEGACIHUAEAJBCDYFBFMIAGSGEAhAHA..KDCD.ECCEhACA...,2,-24,-15,9
FAdcNJLRXgOUeYSKGCPHWBQZIDTMVabEf,dGBFJAHFLDECRDCC..OBBGeFGBKGAACBFGHEGDBEBAZFDDDGCEMABEhAAA...aCHFECBHhAAA.AEID....XADChABAYAFCSFFD...hBAA..WCAF..hACA...,1,-22,-44,22
QaIefNdPTMYFCRJgUKZAHbEXBDGcVLSWO,EBBCXDBCGEDBLFFEOEAG..aEGAIDFD.eACHhAAAdFADPHDCMIACFHGACHBERADHhAAA..UAEGAIHEBCADhABAcBGFSAHF.fGGDhACA..NBAAJHDA.KEDBhABA...,1,-4,-13,9
PRXIAdOJZCbgLNeETUMVFBcWYKSfHDGaQ,JEDHCHFHLGCE..EGGGMAGBFAFDBBBG....WEEGhAAAKADESHBGhAAAHCAADBAGaDHFRCFA..AFHAdDBEZFABNAFEhABA...UACC..cABA.fEEBhAHA.PHEChAIAIAHH,2,-45,-16,29
ODZFNaJPceQTKfAXBHCVLUIgSMdRGEbWY,BFGCCFHHUABDSHCA.RFAF.EFCB....bABDOFDGhAAADDECFAFGNICH...aECAJAEHhACA..eGCCKFAFAIAAXADDhAAALBHHIGHCMHFGdDED..WDFAhABA.....hAFA...,1,-19,-31,12
IdUTEPWRJMZfeXaBVFNDcCAQKHSLgOGYb,KFCHSCDGOCFFGADG..bFFCUBABEGAC.RFGB.ZDBAeHDAhAAAXDGGBBHAFAFEDIFAAACGhAAA.HFCFLFAHhABAIAEC.dAGD.PBAAWDAA..fFEAhACA...hABA.aCFA.,2,-13,-11,2
NQJZTYKLEefRIAPbgDOCdXBMUScaHFWGV,...PHCEbAFFDIFGdCBGBACF..UCDHSFCBaFBE.FEEAhAAAVFGD..QFGDhABAJACCZAFFKBHBLBHFhAEAEAAF.eBBDIHAAADDHCBEDMIAC..hAIA..cEFB.hBAA...,2,-21,-15,6
VCMQIDaULgAFcSBfTNZJEXWPYOGRKHbde,SAECBBGG..fGEAZCEDJHAA.EHAG..XECBhAAAPAAD.OGEGGCCEhAAAKABGdADFCCDE.IGHGhACADBFALEHBADIBFEFEcBECWDAB....hAGA......hAHA...,2,-27,-24,3
cgRVKTefAHIUOJQBYdLEZaXbMDFNWCSPG,HCEBOCBGJDABBDHBdBGELECHZFAD..aDDBMICCDIGAFAFCCAAHGEGAhAAA..REGBKDAGhAAATACBAFFB..UGCEhABAEGAC..NAIA.SACE....hAHA......hAIA...,1,-7,-32,25
SLICFbcOMJAHgDefBQRPVYXUNZKTGaWdE,DDFBeEFCBCDDRCBD....VFAHXEGEUGDBZAEBKEBFGADFhAAA.dABCEACALGDGhADACHHHFBAB.OHACAGHB.hAAA..gCGC.fECBhAEA.....hABA...,1,-17,-29,12
OXJaGTgdEDZNVKeWLRBQcAIPfYCMFSbHU,..ICEAfCAA.MEEEFGAGSEGDHAACUFCFJFHHGGCDhAAAdBGDDDEGZCBFNBAGeFFHhAAALBDCBDCDAAHBCHHE.OEADhABAaDGF..EDDB.......hADA......hAEA...,2,-13,-12,1
cVGRIOfgbXWPZMCdeKaJLNASDFYTHUEBQ,FGEEHDEGEAAEBEBH.QAAAGDCFRAEBOEAD..fDAAhAAAXDGHZCAECCHAdGBDhADAaCHFNIBB..AFFHSHGAhAEADACG.TAGC...cEGEhAFAIHHHWCDFMIBEhAGA...,2,-24,-11,13
bMJSIZLYeTDcKdEOagRCNfHAXPFWBQUGV,FDACQCGCUGEBGCDBMBAG....SDAEZACEeGACDABGhAAAdEAAOGFEREFG.fGDAhAAAABIF.WDFFhABABHHH..bCCHIHCFLAFG.cGADhACA..KAGC.hADAEECC..,2,-24,-20,4
PFIUCbZLXGgBOdSeHaETADcWJVRMYQfKN,DBFEJBDG.MDFB..QEGDKFCG.FBAFCDCGLBBGGGCDOEAEhAAAdGGHeFAF.aDHFhAAAEDDB.AHBB....hABAcCGFWHCG.........hACA......hADA...,2,-41,-29,12
VfgNAeXcKLaWMRBFGSYHPIZJTUOCdbEQD,eFECKCHDLFECMFBGBHEDGEACHABAZAEBUCGGOCBAdGGAQCEGhAAADICA.VGAEhABANBAAAHIF....aGGHFAFEhADA.SDCC..YAAChAEA.IAHE.hAEACGEA...,1,-5,-22,17
gFXNCcAESPKTWIJOBafQGeLVdHbMUDRYZ,SCHHTAGA..JEDCOACDBGGB.QGCBeDFELGCEhAAAdAEHMGFCDBDHRBABgDEBhAAAFFAG.NBBCABAHKAEHhABA.aGHD..fECD...hACA......hADA...,1,-19,-23,4
JOgBQEMHDVPLCNZYcAWXKaTSUfGdeRFIb,KDCFTFCGUCGF.GFCDeAAARDDE..FFAHJBHFBADG..MAFBhAAADABB.LHECZGFGAHCD.hAAAXGAC.aEAAhABAfCCBIBDG.OFFA.QAEChACA..EFGChAEA...,2,-30,-18,12
XKSWCBcYgRLPHUGNaTeIJMZFDbdEQVAfO,XFAGSGHFBDBB....gFDDLEEHHCFEhAAAUCDAaGACeEGF.IACEhABAMBCEFBGGDDDDdAACEHCGhAEAAFGEKDHBCEBGRAEC...NAEBTDAE..ZBBChAFA......hAHA...,1,-8,-15,7
QUMeGKaCIYLbDdZSPBXfRTgJNHAFVOWcE,FDEFVEEFOGEC..EAFBUBBAGBGEKCGA.CECGLHAG.hAAADBDHZEAHBGHDfAGDhABATBAA..JDAFNIEHACFAhACA...QEGEMIFGaAAA.IECDhADA.....hADA...,2,-22,-20,2
WVGZfAJeOLDUSXgTMCYRbQHcdPINFEKaB,eFAFODGHUFDH..XBCFMFCHRBACHADDdECA...IHHAhAAANADFKBEHBBAB.GGCFhAAAAIFELDAADGBHSHGAhABACEHDbAFH.PAHFaABG....hACAWEFBfEEGhBGA...,1,-4,-30,26
HEBXSRZPeLFgACTYINOUWcQdMbGDfKJVa,TADD..IBBEUGCD.QDDCMCFCGBBGKGADVDGHhAAAEDEGBFGGRADG.PFABhAAAFGCDACDGCBGA..OHFEhABAdDAHDAFGaFFHSGHH.eFFBgDGBhACA...hABA...,1,-6,-18,12
HZGBYNdJaSAeVDQfXUgMbIOWcRKFCPLTE,DACCXBCHUEBB...MFFHOHDE.RAEA.FHAGLCBGTEGCZAEAhAAABEFEdBAH.SGGDhABAAFFFeHAA.fECHhACAIEHAKGGECFDHEFAE....YAAAhAFAaCEA....hAHA...,2,-40,-6,34
KJcYOMeaSLXCGQREdZWVBDINAfFbgTUHP,FAGFTDAEUEAH.HCDBJADH...OGCEeABDLDFBGDFGQACChAAAEGADdHDDZAFABBAHhABAIEEAAIAE.fFCDhAAA...PEHF.KCHDhACA..MIFC.SBHHhAEA,2,-16,-16,0
FPZfWHARYIOKVcLbQgBaUMDdCETJXSGNe,REBDOAEAKFFDLAEH..QBEGBHFAMADDDBBH.EDBCJEHDhAAASCHB.hABAeFECZAGFfBBChACAAAIDIHDE..cECBaGDDCDFH.TGGG.hAIANAAC......hBAA...,2,-30,-20,10
HabFcXTKLgUYBEGRNdCJePWVAfQDOSMZI,QAFEOADFZGDAHEGDFBDF...XDDCKGDBUEFDBHAGGBAEhAAAdAAAeAGH..hACAWFADfGBGhADADFCDMDIFaCBD......cGGH.hAFA......hAGA...,2,-27,-18,9
XLFaECSAVNedBGcbKgTUOZQPHJIfDYRWM,eDEEdBEFGEGGKFHDUFCEQDCA.JHACIAFC.DCEGhAAARGDEXAACLBBFFBHFhABACCAHAEABBCFD..hABAcEEAbAGB..OFAC..PEABhACAfEEDMIACEADFhADA.NIED..,2,-27,-8,19
MPUWJQRYHIcAXBEdCaLbZDTVKSFONGfge,BEEFCHAELAEGDFGEKHEAFBBF..GAAA..eCECUFAGQDFAhAAARADCHAGF.IGGEhABAAAABEGDF.dECEaGHF.hACAZDCBSDBD.NIED.fFFGhACAMAIFWEHB.JEEF..hADA...,1,-16,-22,6
fZQdcUVOHMXDBKLISGWANaEFbeTCPYJRg,aGEAFAHBeEAE..TAECCBDE..JDGHREAGZBBC.dHBHUBACOAGDhAAAHGBEDCABKBFDSHEGhABAAAAE.EDEA.hACA.PFFH.fDDBcDGE..hADA.MFAD.BHHAhAEAIHHE.,1,-17,-22,5
KNIGRQgUHSOefdEbYCMaPXJDBZcWALVTF,VDBHKBAAGEDG.QAEFHGBCeAHBEDAACEFEMADD.aFGDJAHHhAAA.BECCZAADAAEAFGHB.hAAARDFG.SAFHhAIAOFFDdFAC.....YADFDIFAcEEChBAA......hBCA...,2,-16,-7,9
LFTIWbScBYXdDUgaAGNPJOVHEQCKRfeMZ,GBEEJBGFHEDECGGAKGCHRDAG....MIFEZCCFLAABFBBF.TEAGhACAIGHE.SGABhAAABEHDdAHGDAEDhADAUADCAEGD...NAIE........hAFA......hAGA...,2,-30,-22,8
bLQGPHCIWXafdgcSKAYNEZVTBMDRFOJeU,EACCZBFBBCCFDBHD.OECHeAFCLEHD.QDCHhAAAPBHFHADDCGCH..IDFHhABAaHGGdBAGSGAHhAAAAIFCNEBE.MEEBJCAG.bFFC.....hACA......hAFA...,2,-25,-13,12
BGWPcYSIXefJQdZCbHAEKVMgaLOTDURFN,KDEFMHEELDAADBFE.UGFEFFCDGABC..PBCESFFChAAAeBGB.JFADZFBHCDEBABADhABAEFAD...aAAA.hADATGDBNAEBBBDE....WFFE.YAHHhADAXCFB.fDDEhBBA,1,-27,-28,1
TCYLIbNScXABMVODZWEFRQPGKaJeUgHfd,VAAEZCFFEAAG..QEAEGEEGKAGBeDFGUCAAHBDD.TGCHhAAACFBGLCDH..hACAIFFBSGHFhADAAHGBBFHFMCIHDGAFWGAAPAEG.aBHH..hADAJADG.....hAIA...,1,-10,-12,2
TeKgLdVARIFEOHWXNcGDPQfZaSbYUBJMC,RFCAFFCCEGAFHAFG...XFFBGBECDAGAQAABZBCBSHCGhAAAUCCABFAECEHGeBADhABAKGADLHEGAGHE.hACAIADGOGFC.NDIE.fBBE.hABAbEAG.MBID..hADA...,2,-13,-9,4
JQUDKEYIgHTBOeVLdWaScNGZMfACFbPXR,CBFCFDEB...XCAFJBAHDFAB.KFAA..EHEE..IGEFhAAAHCCCBGFEOADAeBHDdGGDhABASEFE.hACAGEBEMCIDAHCB.bCFBPBBG...hAHA......hAIA...,1,-27,-32,5
IaGHKBWEQgLVTPRAOUDfcFMJdNSbXCZeY,OGBCDGBHFEGF.dBAF..SBCBCFHEZEFD..eBFAaCFCGAEBhAAAKEAGBEDA..QEADhABA.LECBhACAPADHADEEcFFHNIED.YHCG.hAAA.....WHAGhABAEBBD..,2,-38,-26,12
TCfHeaVMBSPNUcYEGIFWRJdQbgOKLZDXA,TEAECCFDHBAH..aDEHBHED...PFHBNADE..UGGHECCGFCAChAAARFAGdBHA..gAGHhABAKEGGDAAAAECD.fEFGhACA.MBBEcAEGIDHC.hAEAWAEBJHCE.QGBDhADA.,2,-28,-20,8
OGCHLBIZfSMTVUYFEKNdWDgebQJcaPXRA,OCGBCDHCLHFCBGHFZGBC..SBCBMDABUECEFHEA.KAHDdBFChAAADEBEeACD.JFFGaGADhAAA.RAEF.ADBE...IFEDhABA.fCAA...hABA..YCHBhACAEAHB...,2,-43,-25,18
ZRfVEGeQdXYCaBUgHLSAMIbPODKJTcWNF,MAAA..IFHGOEBHDFEHJDFA....TDCG..hAAAcBCAFACARGCAVAFAhABAEHCGGDEHdBBC.CAHCBAFFhAEAHFAEAIHGKHGE.ZFFGfFEDeBBB..hAFAYCFC..hBAAaCCA..,2,-24,-6,18
SVbKIfUNWZOGQYegATXcPFMdDHBLREaCJ,XGGFFGBCMAEAHDFFLGAC..ECDCaDCDCEBH...JBEASBBGhAAAKDADUACCZEEGOFEHhABA..QAAChAFAeAHHAHGFPCAHDCIBBHBD.....hACA......hADA...,1,-16,-23,7
AeKWRVOYZPXbUgdfLTEcBFaSQGMCDHJIN,eEHHKGADRACB.OFDDZEFA....XAEBgAEBdGEFLEBEhAAAEDEDBDCD..SAAEhADAQCGCCDGDDIBEhAGAIBABABDC..YAHHPHBCfHGHhABAcGFH.aCAEMBBHhBAA..,1,-18,-28,10
dJXWaUfVLEgGOMDKYAINTRebPQZcCSHBF,TDFBeABEQFFD.CBGE.HECBFEDGdGCFJDAEaHAE.fFGAhAAALCDEEHAEGADHhABADAGEAFIBIBBChACA.NEIE.PBBF.SFACBGAAWFFDhADA......hAEA...,1,-14,-18,4
NVPWXAFBcCYIUSEMeHgTdGbZROJaKfLDQ,FCBHBDCECFGB.UAED..EHDGMFCDHAEEdEED.GBGERCFEODDCKBAH.hAAADBAB..QGGEhABA..PGAAhAAAWFDD.AIGA..cBBFIFAA.SAHBhACA...hABA...,2,-37,-25,12
HTVPgcZdJMSBFELYQGWaRIKXNOCADebfU,DICEeDBCUDABHAAE.VEGF....gEGAZAECMFDFSCFFhAAAEBGC.QGABhACAGDDHRACFKGAHhAAANIEBACCC.fFCH..PEEB.hABA..dDACBCHA.hADAFGHD..,2,-19,0,19
EZBfWQKYOIcHNDGVaLRMUAbFSeCTJgPdX,FEFBCGAF..JEDFdBGD.EGACZBFCBBDB..QBBCKEHB.OHFEhAAAIEDC.HBBBhAAADDHDaGGGLHEChABAMBAD.AFBASHBA..eCEB.hACATGBGXBEDWAFEhABANAEB...,1,-20,-41,21
QbMCaIVSKUHZRcLTXYBAdWFEOJGgPfDNe,FGFFOEACGCCD....PBACDBBHeEAAMFFECGCE..aGEHVCDGhAAA.UGCCRAGFLACEhAAAXAGFBHHHdADBECHFhABAJEFA...fGGEQGAG..hABA......hAGA...,2,-20,-11,9
CLDWfSPcTBQUaVAbEYIMKZXHRedFJNOgG,EAEEMIACKEGAZADG.RFGB.FCCE..OABBCBHELAACDBHB..SDEHhAAA..PFCEhAGABGFDUCCHABCFIGGAhAHAHFACeCAD.dEGBNEBD....WHCEhAIA...fCFEhBBA,2,-38,-21,17
NFYAIfeRcOCbQPWTaUgXJMGVEHdKLZSBD,eBDBOHCEQBGA..PAABaGFAUEBCXBEE.hAAAJEDAMCABGEACEHEEdABEhADAKAHDSAEChABABHAGDDFBFEGGACDHIHHB.fEGDhACACBFF.WCCD..hADA...,1,-12,-27,15
ODVJQCMHEdRFKNBbLGaeTIZfXUSPgYcWA,DFADQCFCHDFEdFCDFFDFKDBEBFBBLFHFeBCBZFFBUAAG..SDAAhAAA..hABAYHBEAFADOAHFCAEHEBGChADANEIA..aADG.TGADfFFG.hACA......hAGA...,2,-23,-19,4
KQHPNSTgIWXYDGFeZcRJBAfdLVabEMUOC,LEHBVCCE.EABFOBFFKBDG.HFEBSBFH..gEAEhAAAIHBEXFEHhAAADCHFeADCcBADhABARDBDADADaEGH.MHAA.CHHGNDICYDDH.FAGAhABA.BHDD.fFAAhADA,1,-9,-23,14
NQXaCDgILPTURBVeHGSEWMAcKYZdObJFf,KFHHdFAHJFDDFADE....QGDBCDDB.DAGBLAAD.hAAAUGGGRDFEBABAHAEFSDCEhABAMAIBAEIBZBBHfBHChADA.NECE.aDFD.IHBGhACA......hADA...,2,-36,-30,6
WQNRbLDHTYgKIUBMfVGCcXaFOdJSePZAE,EGAHQFDERGEE.LBGBHBDDTEGGKBBCBADEMACCGAEGhAAACDBB.aHAEOCFCdFGESGAChABAZFBBAIEC.bCAEhACA.DIEEIAAD.fAGHhAGA......hBCA...,2,-18,-5,13
TKWHfLYOaeCBFZIdScGEXPNQDMVRAUJbg,JHFCTBEEHFBE.LAGFaGHB.BBEHFGAEdEFHGCABEDAD..XAAHhAAAQEEFDDBAMIAEhACAACIBUABD.KEHHfHDDhADAeEAF.CEDHIAGE..hAEAPHCC...hAFA...,1,-5,-22,17
fQHaRETBXWZALPdMSOgKUeDVIFCNcbYGJ,dCDAMIECOEFAKFED.DADCFAEC...CGAF...NHDF...bDEEJCAHhAAA.HFBARAAH.BHAHhABAXDCFABBFLAGFhACASFFH.eCFCIFFG..YHAGhAAA..fAHChBAA,1,-29,-43,14
bGNVRMEUXCaTcfSgQYPAHIZWFJODdLKeB,HBFEZBFHJCCFdEDF.LDAHBABBGFDHRACCMFIH..EGABCHBA..aEFDhAAA..TEAD.hABASDHHYAFCABBBhACAIHHCFHFGKCDA.NAEC.......hAAA......hADA...,1,-8,-35,27
XEeOKCHPQBabZWMLfNgTJFIVRGScADYdU,dBCEUADFeEFEKEEAHGAGQFBBBABGZEAGMABH..LHFAhAAA..gBEAhAAAFBGDRCAA.SHCAhACADCEBXDGECDHBaFGH.WEAFfFGCNADF.hAIA.IBHH.hACA...,1,-8,-25,17
OMNHfRCEZKBSXGLJAYITQgUWaPDeFdbcV,TCCCUCBD..aCGCDAHF.dEAB..VEDBMBBCHFABREEA.CGHBZADFhAAABHDA.SFHHhAAALAFAAEIBQGAHhABA.PBFBFHFCOBAANACF.KHCG..hABA......hACA...,2,-15,-14,1
NJEfPIgBULYWbTRDMVXcZeKHFdSQCaGAO,JFFBECDB....IACFBACHLBFE..bFGBDGCAMFFBhAAAVCAAZBEA.HFBFdGACCEHHhAAAAEAHfDFBhABA.PBBHgCFA..WAHB.hABA......hACA...,2,-47,-3,44
PVRKeabDTYAZGINFSJHcOCMWfgLEBQUXd,GBEEFGFBHDECCCCG.MAID....fAABEFBDBACCUBDDhAAAXEGDdEAB..PEHDhABAKECDeHCG.aEADDGABhAEAAACGIAHGSHBGcADBOEDH..hAFAWGFG....hAGA...,2,-38,-9,29
QCBPRWfTAFcVHKXJaOgbESGMLIUdeZDNY,FCCBVGCEHEGF.JFDFOCAD..EEEAGEDBLCFGdDCFDAAFhABAQFAGBCFGRADA.TAAEhAAAKAHH..aGADbADAhACASGHHMIFCIDAF....hADA......hAEA...,1,-10,-22,12
DHFAfbEICdGSeWcQZMKLNXYROJTagVUBP,EFAFCDBGdAHEGBAH.eDBBQEDBZDDAMDIDLHBA.XABFhAAARFDBTAFFaEACgFFGhAAABGFGHDGFAIBE.hABAfGBBIADFSDFEKADGOCDC.hAFA......hAGA...,1,6,-17,23
RKDSXHMCIeWLGUYNgcaEAJBdFTVfQPOZb,JFAABFGB.dFADFAHH..TCDHQEECZFEF.KDHFDHBC.HBAAhAAACBAE.eABGGCAD.hADAUGGANAED..aGDDAACD.hAAA.PAEFRBFE.SGAG.MIAAhABA..IHHDhBAA..,2,-30,-12,18
SRVJGTbNIHZPfUeOQgAYEKDXaWLdMBFCc,KABDDGEA..aFBGLCHHBCAB.CEBGRFFHGABF..TGBF.hAAA.bCGDHAEEZGDAUAGDhABAQDDCAECGEDDGdHAHhACAMAAHSEAFNEAG.IHHDfDBBhACA.....hAEA...,1,-13,-16,3
bUgdfMTREeBISPKWLVGDZHJFOcAYQNCaX,QGEBCGEE.aADEUACC.dHGFTECGeCGBBBEE..hAAAIHACSDDGhABAPAAGKHBALFDChAFADFFGHBGHOCCGABBC.XEADfAGBhAIAMEID.....hBAA...,1,-6,-40,34
SGYgaJLFUcRHCQBIWXDVPTENeKfdMObAZ,ZGDGSDFAGCAEaAHHLECH.UAEDRADDCAFGBDFE..ICCBhAAADIEC.PDAHhABATEEE..eBHBhACAKABEMAAHbGFEAFFB.gGAAcFAE...hADAWCCBXGDH.hAGA...,2,-32,-7,25
PUaVJgWRfBXLACQZISFMNeTcdbHEDGOKY,ZDBGSDHFFGCB.MBDCeACG.dFFEEFDCDFCAKAAA..UBAHaGAC.hAAA..JFAFRDADBDDAhACALEHFAHGCQGEAhADA.NIAH.bBDA.OHDCPCEA...hAAA..WAFE.fCCChAEA,2,-31,-10,21
AUNWDLTcEIgOCPZaSKVXfbRFGeBMJdYQH,UECDDGFHLDBGEGDB.OBAECBGGZBAE.KGCB....VFFBXGGGhAAARFABGBEEBBFGMAIHhAAAdGBGHDFG.NDAA.hABA..cDAB.IABD..hADAaFDF.....hAEA...,1,-19,-23,4
EDGFJKaAfMeVISUXBcPQLOTHgWdYbNCZR,eHDESEEEUAGEBBDFQCCCLFAEOBEAHDDH.dCAFNABAZFCDhAAAEFFE...DFCBJAAGhAAAKHFAAAEC.MBID.IFHFhACA.PFAD....gGBDhBFA..hBGA...,2,-24,-13,11
fQYMObFANeVGHdJULEcWgaIBXRCSZDTKP,VAFCdEGDLFAF.EBDD..gEFABEEHCAEAZABHKEDD.QCABhAAAMGDG.OCEChABAAGCBeHDCJEBBUBGAhAAAaGHF.RDAGDIGA..PABC.bGEC.NEAG.hAEA......hAFA...,1,-12,-17,5
daDHWRTJKbASeMYEFNBPXVILgZcCGUOfQ,eGFAMCFFFGCFBBDE...XAFFVBBCLEGDZBBHGBGCOBFGhAAAdAACDEFHHDAHTFCChACAKFHHAABB..EEDDPDABhADAIHAD.CHFG........hAEA......hAIA...,2,-19,-12,7
PWAEZTQUVIYgFGHDfMSaJXcBdNKLRbeCO,ZEDHTFABQABF.UDFAIDBBFGGBHBDEMACC.SGEChAAAXGADBFBEhAAAKBCBRDEAeHAAOAFGAAHFEHFEhABAgCADDEDHJAFDNDIGCHCB.......hACA......hAEA...,2,-13,-5,8
cHLfNDXTIRZEKUdMCSWbPeAGQaFVOYgJB,QEBEFFDGODHH.JADBBGBC.LAACDIDG..XGAHhAAATCDAZGDGKFGDMBADhABACAGC.SEFChACA.PAFDABIDaCBGYEADgFDB.fBBGhADANIEB.ICHFhAFA,1,-16,-42,26
aCXTOIRWDFcUHSGgdBAfLYZNQKVbJePME,LBCBZCFBKHDG.VFAEJDDF....MDAFaAAG..CFFE..OBEAhADARBCEDFHF..FEBHHFDBhAEA.SHFAhAFAdAAGABIF.NBIC.eDHBEDFC...IHAEWHAG.hAGA......hAHA...,1,-17,-39,22
NcOAfETPVDLeUbCWdRFaJKYBQXSHGgMZI,EECDTGBADGAB..UAEHCGEC..RDFC.FAABaBCF..KDAEBBEH.QAGHhAAAHFFBMCHBIHHAhABAOEDGAHBEPCAHhACAeCCG...WEBAYHBG..SCCDhADA..hAEA...,1,-24,-31,7
EeRKNXadHDAYZQbMcFSfVgUTPCJILWBOG,QGAGMDBBFBCD.SFHF..VFGBUCCGCFCFJAAGLDFBhAAA.BAFAEEEH.hAAAKHCAaHCGDACE.ABDGYBADhABAZAEF.bBFEgAGD..hAIA......hBEA...,1,-17,-35,18
OcaRNJMDgeIZfbLEPQAHWUBCXTGdKSFYV,UADBCGECGBBBdFEFFFHD..VDFA..aAAGJEBD..MIDGeADEhAAAZECFLHCG.hAEAEGGBAHBHBCFHKCAD.SBBHhAGAOAHD.NAHC.IABG.fEDAhAGA..hAHA...,2,-37,-22,15
OYWQeFcNRBVTUgZKSaLbPdJXMfHAEGDCI,DDIBCGEH.OCDGQBFG.eACDFFDFRFADBDBEUDABKDHH.aHGELAAGhABA.dHGFJEDAhAAAMDHFAGHAEHAC...hACAIFCH..cEEANBAE...hABA......hADA...,1,-31,-32,1
JdcFaXZHPEYRSbKVGLBWDfeTCAONQUgIM,QCBGUCBGMIBG.dBFGFFFDZGCG.HEGBEGAG.SGAB.hAAAKECGLAFEBCGBDAIBhAAAfABHCABCAAEH.hADANEHA..JBFDaAFA..PEDF...hBAA......hBCA...,1,-20,-25,5
fbgXELNDOHJQMAVPCYTWUZceadKISBRFG,VFFECAEH..TGBDUADBZECH..eEHBKAHDBCHAFABHGDAFhAAA...fGEAhACAXCBCEGBFDDGCJBFEhADAABGB....WAAFcGFE.IEFHhAEASEEC...hAGA...,2,-39,-23,16
JROKfdeVIPWHDcUZaYGSgCLETFMXBAbQN,QFBARACGKGAB.eAGFVEDA..IHHEHCECDBBBZEEG.aABChAAASDCFLDCAFHDEhACABEHGABEB.JHCEOADAhAIAdGGA.PBHD..cAFF..hAAA.YCAFCCCB.hBAAMAIF.,1,3,-31,34
LXJgMbOUKFGDZHSdPWAeERTCIVcaYBNfQ,eBGBRGEGCGBG...IHFBaEBC..BBBCQCBELACHJDFBhAAAMECGOFBC.KAEChABAGAGGDDAB.SAEBhAAAPHAGABBG.EFDAcACFNIBF...fEHAhAHA.XDDFhAIA,1,-13,-39,26
QZEVKARFJDPfecObLMYaWSgCdIUXNTBGH,REDHDAGBeBHBOCCALEBH..aGGFSABCCEAC.dBFEICHHhAAAXGFEBCAEhABAGBCEZGDCEDFHAAIFFFABJDDHhACA.....fHADMAEG..hADAWAADNBBB....hBCA...,1,-17,-28,11
HMVEGQYIOegSNdDTZRUKcBaPJWfCALbFX,FEHFMCCDEBECGBED.QGGEOCFCeCBDSEDCdEFGDADARABEhAAAKBCC.aCAB.JEFECHBCLGAChABA..hAGAHFDHIHGFTGAFZEDHBAFC.WAAChAEAADDC......hAHA...,2,-11,-10,1
JgHSPWaBKEAIMNDLFCQXZRfeTVcdUGYOb,MGDELCGHFFBH.QFAFRACA.TDADdEHGUCAA.OAFGhAAAJADAHFDG.PCDBhAAAaHCEBEFFAHHC.DDFGCBCFfAHGhABA..eCDC...hACA......hAGA...,2,-32,-17,15
gHGXAWKEFRZIYQaODLfdcUMBSbTVPJeCN,KHCEEBDAFDEEZDEB..QADHDEIFLFAAdFAA.UBBGBGGD..SGFEhAAATDGDJCCF.hABA.CHFGHBFCAACE.IHAChACAaCGAOBAFMEAC......hADA......hAEA...,2,-30,-24,6
TNCPIgGZeYQcWAfDKHXRFdBSbMVLJEUaO,DCCCKDBHHBCCFGAEBACEMAGF.LFFDUDEE.OAAH.CHBH.IBFGhAAAGEGGeFDFhABA..QDGAhABAADDHfBHGdEBHSHCA..JEAFhACATGGE.NAED..hADA...,2,-40,-11,29
aDgfGBLVKcedNOZWTAQJYXSIHCPMREUFb,JBFFSECCHCBA.CHAG.MEEH..RGCAEBCHFFFEDCAFGAGABDHALAEHhAAAKAAG.dGHEOEAChAAAZDAFABADQGFChABA.IEFGUGBGaBHB.fGHChACA....hADA...,2,-32,0,32
WGEbfZaIYRODMQJCdHKPNALTUVFBcSegX,UAEEFBDCBBBHeCAC....XFGGEEFEZGDCaBGARGBC..MFADhAAAJABCHDDBKEED.AHHG.TBGHhABASHAG.hACA.gDAB...WDFGfCHEhAAAIHHEDGGACAEE.hADA...,1,-17,-37,20
FLfYPaEAeDgXOJMCTRbHcQIVZWKdBGSNU,DFFAXFEEMECF.RDCH.HAGB..QAFFIDEG.ZAAAdAEBBHGHhABASABEFEHBfCADhACAaGGFACBA.OHCEhADACBEHTGEE..cGAGKAADNEIG.LCEGhAEA.....hAIA.YDDF.,2,-14,-2,12
GAKQMOcTZagXRIDWYNFUPHbEBefCJLdVS,QCFAOCFDZFCC.aEGERBAC..DBEG..NCAA.FCDEHCBGBABFCHAFLABEhAAA.SGBHhAFAKGHDMAFA.cGGHhAGAXEAF..IHDC.WFCEhAHAYBHF...hAIA...,1,-20,-42,22
VAfeLNGbKHXIUOcTFJYWMCSgDQREBPZad,LHFEGDAFKFECXGACOBFG..FGGBJAAD..MACECEFHDEEHEBBGhAAAZCFC..dGDCAEBAeCBAhAAAHDFGUGAH..hABATAFASBDHgEBA.BFGAhACA.....aHCEhADA...,2,-27,-7,20
fdITbYLRQgEFANaCcBXDPVKGUOJMSZWHe,aDEDCCEABFFA..DDHBKAAHUADD..JHCESGGF.ZCBGhAAAHFADdGEC.TCBGhAAALHAARDEC.EGAEFAECAHHC.hABA.XEAEPHFCOAHF.MCABhACAfABC..hAEA...,2,-30,-24,6
ULcaMQJfbAFKTVIZRODEdNWCBgXSPeGHY,KAAFVAFCZCAD.DGFGdDAD...CDHHBFHBSFCEGFAHHCDCLABGhAAAMICG..fBGBhABAAEEHFFFC.IGADhACAOCCGEHDE..gDGH.hACAPADA.YGCAhAHAaDFG,2,-36,-29,7
QdZUaBVeMLDWfACKJPgITXGNScbYEFOHR,CFEGKGCB..JAEC..PCCC..TDGGGEEF..SGGFhAAAbCAF.FCCGOAHDhAAARCADZGCA.aABABFCBhABAMHEEDAIFAAHHXGAD.cCFFEHAGQDEEhACAdAEB..hADA...,2,-30,-8,22
KOfQdScXCPDTHUgVWaeGZLbBANJYMRIFE,JGEGRAFEEFGG..OAEDdGEC..SDGECHCB.DBAGHEABUCAEhAAAgBBA.hABAaEDGeADBLABEhAAABEEBAFDGMAHHIHHH.KFCFfEGDhAGA.....hACA...,1,-20,-30,10
HEObRBTfGXLCPaNAYSVcIeKJWgQUdZFMD,SGABVAEA.eECCJCHB...QABBUABHZDDADCCFHAEEhAAA.bFFEREAFBGDAGGCBhACALFFGCCEDaAHFADGFIEAHhAEA.gCGBMIAE...hAAA.OCAB..hACA...,1,15,-30,45
SIEcaTPMbCKdgDeONGHJXQAUFBZVfWLYR,BBADZBFB..VBCDLFHHREBE.EDDAaHAGMFBA..CAEDKHGEdBHEDAEAhAAA.OHCCHAADQEGHhAAAADBDFADH.hABAfHDHSEGD.IHAE.hACA......hADA...,2,-30,-22,8
GITESWYNLMeUVfZBJcRPgCQXFdabAKDOH,DHFGOFEFHCAGGDAFEABG...SGDDNIEB.eDDEUDGGhAAAfGGCBAEHREDDCAGDFHAChADAdAAFABFD.ICHBhADATEAF.WBBA.YAFC...hAEA......hAHA...,2,-25,-7,18
dHbJaODICPWLRNKfBMZecXETQYgUVFSAG,GCDBHCAGJAGBOFBEDIAC.CBCA.LEFA.KBCCMAFCZGEG.XDAFhAAAECHF.QFFFhABAUFAFSEEDhAAAAHEEaHBGIHHC..WACENICDBAEG.hABA....cABBhBAA..,1,-14,-26,12
CSEGDYWBZOcdaMQgFAeKIfNUTbXRHVPLJ,eBFHKHFG...IFBGUADHXFFA.RCDG.PBHBLEADhAAAJFFB.EABFDAEFBHDDhABAZFCDODAAdGBA.MEIBhAAAQDGDAAFG..fABFhABA......hAHA...,2,-31,-20,11
VcfYUeIFQMXEaOGAgBHdbJCRNDLKTZWSP,HFCEJCFD.CHFCRCBEDCDGLEECZGBC...SCFEVAAF..hAAA...fFFDhABAeBFEQGGAhAAAEDADaGADAEIFdEDEbABENADBTEBDPAFA.....hACA......hADA...,1,-9,-27,18
OYDdCeVLcGNZMfRWIgaQSEKUAJXBTFHbP,XAGABCHAFFAFHCDH..OCCFdGDFeEHFVGCGGCBEZCGHRDAD.hAAA..IADHhAAAaFFCSGADKBAFAIHETDFFhABAPABE.DIGECAHH...NAFGMCEF..hABA......hAEAWHAG.,1,1,-26,27
MAKgCJecDfLVEFdIZWYaSGQPRBXTbUONH,KBFCJFAC.eGFCDAAH.LEDF..FFFBdCADZGAAaFABGBCA.hAAARAEDBBBCXABC.hABATCGH.OEFChACANCIAAHHD.CCEH..cGAE..EDAEIHHDhADASHEA..hACA...,1,-12,-41,29
eSZXTRBfIOACNVEDHWPMYdGQUJKbaLFgc,CEHDEGEFDFBAHFAA.MEFAGCDA.UGAEJDBAKAFHLCAG.FAFAhAAAeAAE.ZADHTFFBhABABGHBIHCFhAFA.OAHFAEAFNIEB.PHFC..YBBEhACA.dDGFaBBC.hADA..SFCE,2,-28,-2,26
GBAPEUKcVYHfgTSIbMRDdWOZCLaeXJFQN,EEHBKBCH....VEBEHBED.fDAB.TAGBICHEhAAAbEFD.RGEEdAFBZAAECGAHaDAGhABAeFAEFBEH.GDDGhAAAAACBUEGF.......cGBHSHGAhABA.DCDH..hACA...,1,7,-25,32
RCQIfMaVgdbYcNFTWDXOLeAPGHUZJKBES,HBGFZAFEBGABEFAERBBECEDG...QFEEMACF.aABGdHCD..bBEHhAAA..NGCB.FGAHDEAAXGCDhAEALFHHAEDHUGGGhAFAKADC.IDBA..fDDBhAAA...YCFGhABA.,1,15,-51,66
fASUJRBGIYVaKEZcNeHLCgMdDOQFbWPXT,UDDBJDACGGEF..IBGC..VAFHaHGCZAACeFACCEGH.hABAMIBC.DCCCOFAHhACAFACE...bFCGWEFChAAA..TDAFAFIHBBAAEHDA...NCIA.hADALDDB..hABA...,1,-18,-25,7
adFHTUGbOgPCJWDSRcINeEBAQMVKLYZXf,QAGDKFACZADC.aFGEFBAH.HCEDGBAGOHBECFEEDIEG.SDGFhAAARFGF.IDEEhABAeCHBADCAMEAE.hACA.VACHXGACTFBE.....hAAA.gGEDhABAWEADNHEDBHCAfBBD,2,-19,-14,5
OUZXWIJdNQaKeGDYLRHPFESVBgTMcbCfA,ZAGFXBBGJHFC.dGCE..QBDCKCFEeDDBGACHLACCHDFGhAAAFGBCECFFSAFEhABABEGHMEEBbGFEAGGEOABHhAAAUDAB...WFFA.....NIAH.hAIADBIF.....hBAA...,2,-23,7,30
GJFQLaEbKUSXTDdBMgWNZCePcIOHfVRYA,GBABFFACQABELEHD.aEACKHGCUGBGSDFADEGD.MHCEhAAA..NAABeAHHhAFAPADEOCEDHCDDfFGDhABARGDCADBDEEDB....bADEdAHEBHAChAHA....WHBGhAGA...,1,8,-23,31
TacNMbVWeBRFIOEUKAYLPZXJgHfCGdSDQ,LGBAZACEJBAH.HAFBGDGEDEIDQDEH.aEABcBGBhAAAMFHF...VDCGhABABBAH.IBDDhAAAUGBEAGEE.XABFCAGC.SAHBNEAC.hACAWFFD.FFBA..hAEA...,1,-17,-22,5
BJSdgbQeNYIZKXVWFRTcMCOPGULEfaDAH,BCHFdACEQGABeEAG..IABAKFECXGDDFFEB.RDGB.TAFHhAAACECE.GDEDhADALBEEaHAEDDCGAEADJAADSHFEhAEA.gBDENAIE.ZFAChAFAcGGEMFID.OCDEhAAA..,1,-12,-16,4
AJXeKWadQDVNIFCHUGREBfbLSZPgYTcOM,JDDHKBEGdBAB.DGEC..IDADHDAGGDGEBFBHLAFChAAAZGBC..PAHDTABBhABAMAAGeHDE.aCHHQDDChAEAFFGHCHBC..ECDG.fBFHhADASFAF....hAFA...,1,-17,-20,3
PHCbaRDUINJBVXegFMKdELAfOGWZcSYTQ,OGBGZECFSACD..TFGCQDAECBCERBAD.DEEHIHEHhAAANCGG..BGAChAAAeDFGMAFFEHAEAEAFWCHFhABAPBFA..aHGEJEDA.XADF.hADA.KADB...fHBDhAGA,2,-28,-20,8
YPAFWfMQbXaURLdBeVSgcNDEJOITCKGHZ,FCBFMDGFQDGE..aBGGLFACdCAEeCDHVBEDSHFAhAAA..NHAFDFGBhAAAEABCIEHGKADF.hABAHFDD.PFBHfBGBXADABABHhAEA.JEEFCCCF....hAFA...,2,-24,-5,19
KRebXOaCSPdYLWfUBEJZTQGcIHMDAgNFV,FEFDVCBFeHAA..OGAEaAAE..CGAE.SGHDdDDBLBEEhAAAUEEBBFCEZACATBGDhAAAQCGF.IHGChABADAEEAEHCKBAD....XDAG.hABAPEHD.WEEDhADA.EBCHcGDD,2,-27,-23,4
FeLTJfMHUXEBaZYAScRgVNGQDPbKCdOWI,SEBDREBF..gGFGGABAQFGHDGEHKBAHdAHGIAGGhAAAFDGA.TEEHhABAMABAHAEHECFGBDDBhADAaDCAAIBANAIECHHD..OFFGeFAD..LHCAhAEA.fAEAhBAA..,1,12,-28,40
JbXKHWZRBMIeEANgDafOdSTCVGPFQLUcY,DFFGaABH.dACF..CEAEGECEFDEBLDCF.UAGAJEFAKGAD.HBDDhAAARAADBHDAMADE.ECFAhACAAGHA.....fGGHhAHASFAD.......hAIA......hBAA...,2,-48,-25,23
UXGgOEbZBFcNaLTKRQYDIVPSeAMJHfdCW,HEDCdDABCEFD.XCGDGAFG.OCDGEDDDZEGBBHBC.FBADaHBGKEAAQABAhAAADHGE..hABAIGDCSFDGhAEAMAAGfHDF.WFAF..gAGEhAEA.NIDF.hAFA...,2,-31,-9,22
VKTIMFBZedQPRLGHYbOADCEWaSgXUJfcN,EBDEaFBF...SFHBXBDA.UDDGJEFH......fBHGhAAAcDAANAGEKGFGhAAAMBBG.BBADdCHAPFBHhABALFHHHABBODDFAHDDDFADWADE..hABA.gCAAhACA.IHAE.,1,-6,-19,13
PLBcQeGUAJXMgbTaWHZRFVISYfNCOdEDK,JDBHMGEG...TAGEHEFGFDDE.SAAG..YACFhAAACHBGdGEC.KGCABGAChABAeAEFAAIF.XGABhABAaADHRAFD.IEEAOFCDDCABcDACQGGBhACA..gDFBhADA,2,-26,-20,6
VTgGZILcPKQHEJBedXUDNCbAfRFOSYWaM,FGCASECC..aBEAMGDC.TBFFZCCFIDAH.hAAALCHHKHFAECBHBBADhABAeFFDdHAHDGAFNHBDCGGEAGACfFABhACAOEEA.WDFGgAAC.hADA.cADE..hAEA...,1,-22,-34,12
ZPRMNILTJcVXgbYUeHdFWKfCaDSAGOQEB,GEDAEBDGBCCDZCFHREGD.MDCHLFBC..TABBJFFH.XGGEhAAA..YAFGhAAAeDADFAHD.fBDFhABACDEEDHCCADAA.OHAENABB.IDHFhADA..cGAC.hAEAgCGE.,1,0,-32,32
YNASRGDLIbTFBaWCPKQOdfEXeMVHcJUgZ,SGFBGCCEDFCFLBEG..IEBDFAAABHDHaFEHCGGAKGADhADAdBBHEAGG.MIAGhAAAHEFEJBGH...ZFAEhABAAEAA.TDECWAFC.PAEHfFEG.hACA.eDHH...hAEA...,1,-2,-37,35
EFDKAWVYRXGMPBLJgabQOIeZfHNdSUcTC,VABGXBBG.GFEHMIFEBEDCLAAC.aCFEQDGChAAA.OGAEIGADhAEAfCEFNBIASEDFhAFATAGDCHEFDGCHAAFFYFEDJAFE.gEAChABAeCDCdEFB.EGGA.hBCA...,2,-11,-4,7
QPJFeBKWVRgdOLMUfbaTXSDCAHZINEGYc,ZFFDEDDCGDBCQBEDFGGFBBAGKHBC.RAEA.OABDLFEHUEBC.hAAA.aDHFSAHBhAAA.DGABAADHIEGFhABANEED..PFHFWEAD.dBACMIACbFDB.hABACGDD....cBBFhACA..,2,-19,-15,4
DIWVcdCTFKJBMfSeUAOgPXQEZRLGbaNHY,OBCHXBDCZAABGGDB..aFEGHDAFDHBG.IDGA.hAAA.VCFAdHADCBAGFAEHBDEChAAASEDFABHCPAEGhABAEHFAbEFE..NIAH.WBBBKFHBMAFE..hADA......hBAA...,2,-25,-1,24
ILVbSZDUGTaAPcgdMHXJBQWfYONCREFeK,...PABHdGDCHAFABDGAfECA.OEHBCBEHFHBAIFHEhAAAVABAZFFHDCIBUDCHhACAaFAHAEAD...MAAFhABAXAGDJDDC.QFDF.NIEFeADFhADAKEAE.SGADhAFA..,1,-10,-18,8
QUGbHBfAOIESMDLTKRCNJaWgZPFcYXVed,OCDEEHBEDEBD.LAEAKECG.CEHD...aFFEZFECFAAE..XDBHhAAAeHEEUCCBGGABhABABDHAADBBMCBCRAFC.NIDB.hACA....WFAD.....cCGBhAAA...YADEhAIA,1,-30,-31,1
GEMfTASQJBCagHVIXLbOFKWYDNPRdcUeZ,SCBBBAGACFFHHCGD..VECH.LHEGODAAFBCEKADHDHAChAAAREAHdGCCUFGHZGEGEAABMBFDhABA..AIHC.QAGHhACAaDEB.IDAGXAEF....hABA......hACA...,1,-13,-23,10
bYXLQTAZDHSMOaCcgNFWdPfBEURJIKeVG,HDAAOHCCaHGA.CGCF...NEHC.FCFE.dFEHBABERADE.KDEEGBADhAAA..XEAEhAAALHBGAAHFSADFhAFAMFAFWEEE.fGAB.JEFD.eDDDhAGA.YAHB.hABA...,1,-15,-26,11
KYdFQBbXJHMSCZALaTcePIRUOGEfVNgWD,LEFGTDBH.eEBFRGCGUAGEGADC.VAAH..NEAADGEAKGCDdGGEhAAAFBAH.BHAG.XAGAhACAJCCAMDIHCFDBADDHaHGGhAAA....IDGGfDFH..hABA...WEEG.hADA...,1,-18,-22,4
CaPeTYWbNRIGBUdgOfAEZMLJFSVDXcKHQ,MACDLCFFFGCF.DFHHKDBFQFAD.CGEE.aFED.eEGBTACHhAAA..bAFEICAChABABADE.dBHEfDDEhAAAAECFEAFC.SCFGcCCH.PFAHhABANEIA.....hACA...,1,-25,-29,4
aGCIRJFLYNDBSWKXHQPeVcgZAbfEMdOTU,EBCDMFEGdGBGUBFCGAEA.RCAF.JCBELAHB.DFHFSFADhAAAKGEF.QGGBhABAeDFH.VFCBcAABhAAAAACAOEAGCADD..YEDDNBIC.BAGDhAEAWBBC.XGEHhAEA..,2,-17,-14,3
TbXaVAQJfMGLIcCEdBHYPSgNDURKOWZFe,JFDGGCEHLBEBCGAGBAAAHBBF..SHEADIAARCGD.KEFFOFHFhAAAZEBE.eECFTADFhAAAXACB.AHHDMAFChABAICBF.EFHBdBGFPAFG..hACA......hADAgGEAWHCC,1,-4,-23,19
EJYGcDUFQTgALWCNZPKXbRSeIdBaOfHVM,LCDHCGEBZCCH.XGFBSABA.dBFBOAAEHEAFEGHBJAECGEBAhAAA.DDIFUDGChAAAFHDC.TGCGAHAFPDABhABAKEEE..eCAFIEGGBCEGaGGH..hABAfBHC.hACA...,2,-16,-10,6
ZEVbFLPYCQcdgHSRTaADfXJOBUeGMKNIW,DAFBXADBBABEUCEHGEDC..KADDIFBG..EBHBFAHBhAAALEHBCGHBdCCGSDFFhABARGAG.ACBHfGGGhACAJFEBMEAC.ZGAA..PAAH.hAGA......hBAA...,2,-38,-19,19
EfNVYAaFdJDBeIRSGcTWPMLCHKQgXUbZO,dFDCDDIDeBDHRBAGGBEC..TFBAMEAHCBHGKFEF...QGFHhAAAXEGGZEBBOCABhABAEHGC.NBHC.ABEH.FEEABABEhAAAIBBGSDABWHAA......hADA......hAEA...,2,-22,-16,6
DcUaOTAZGbJQENIWMXHfgFLSYKCBRPdVe,GCBEJHFA.EBAH..IFACMHEGHAFCFEFE.SGCHhAAA.CEEDBFAGPADFdDFDhABADHAEaGGAACID..QFCEhAAA.NABE.fBDG..hACALACF..hAFA.KCFA.,1,-8,-40,32
dXVNPELfHYIBUgbMJDCTcOQaRSGAKeZWF,eHDEFCBEdGFB..VBEBEDGFHFBDBADDUEGFMBFE...DFABCEEGOBABhAAARCBF..ACHFKABFhAAAXCEF.NIED..hACA.fHAF.IHHH.hABA......hACA...,2,-33,-29,4
abGSCAgRdPfNJXUHLBeFTEIMWKYOVZcDQ,dDDE..fCECJBFBUACG.LBHFBAEH.eABBFGGB.IGEGhAAA.KAEGOGAGhAAAZFFFDDDFQBAAhABAGCAGACGFPHAA.XACFEEGAMIBE.hAGAWAHB....hAGA...,2,-43,2,45
SGWDMFCQaIVANPeJLRbHEBUXfcZTdKgOY,eDCELBEEREACHEGHEGECBCFDUABH...XCBHZAGBdGCEKAEDOFFAhAAASGEGGFAFMADAhABAFCAH.CGHAQABHhAHAaGACAIGC.NICB........hAAA......hACA...,2,-13,-7,6
TMQfReXZFEIgcKbPAJdWBaCDSHNOUYVGL,JAFEdEEFBCAF.DBGHHCDF.UEGCGFADMHCGQGGDhAAA.eDBCZCAEECFAIHAAhABAKEBAACBACACC..ODHFhACA.LAECfFAEFHDE...hADA......hAIA...,2,-35,-17,18
VYgBDHALFOCeIPKabfZERTJXWUGSdMcNQ,FEFHeCFAKGDD..aEDEZAFBRBAB...JADBXGFG..GCAAhAAAMDIBQGBGhAAA.VAEGgEGBhABADCCGAGEBCDDA.IHHFfABDEBHHWFCFhACASHGA.NEAE.BEDEhADA..,2,-29,-20,9
XBSELQUPTOJFDGVWMgNYZCIcRbfKHAdae,dECDaEBHBAAHLABC.QGBCUEEFODDAFGGHGAGC.hAAAMDIBNCIG.ZBCCCHCGRCBBKGADhAAA.AGED...SAGHhACA.EACA.JHFEDGFD.WDBCIAFChAIA....hBEA...,1,-12,-35,23
RTXdSBDFKYfOZCPGeaEHWQNcMJIbUgVLA,RDFEXDCBBHBAKGFC..OACEZCBEGAAHEFEGHCGF..QEAFhAAAMBBFJFHDUGCBhAAALAHHAHAFdAGHSFDChABADABAFFAG.CHHG..eADEaCEF.....hAFA......hAHA...,2,-15,-7,8
eGRZPNAcMILKOJSHdaBgWYfQTbXCFVUDE,MAEDKABFODCAHGFABDGD....gAFHfHAFQGDAhAAAXAFEFCAGhAAAUDGGDCDFGEABRFCBZCEBAFAGhABAIGHC.SACB.aAEBhAIA..WAHH..hACA...,2,-21,-14,7
OILQgEcfCTbMNBJaZVDAGKHYeWPXURdFS,HDCEeFEE.XADCdAEESGDBLGBAEGHFCHHAMCBB.JCFGZBAChAAA.ADFBKGAB.PCHBhABAFFGDIAGC.hACAcEFGfDBENBAEBFCGDAGF....hADA......hAHA...,1,-9,-25,16
gOWHUTAXFDdEPLaecGfVbKYNJQIZSMBCR,DDFEdCGGLBBAeDCFGABF..VFEBKCAC.JAECZEGF.BBHECDHB.hAAAOEADHDAAABAHFEDDaDDFhABA....bFFHNIAB.hACA..SAACMHAG...WHAAhAEA.XAFDEHGA.hADA...,1,-17,-18,1
MdOCUPfSWINYaDGgARFBLcHVXTbKJZQEe,FFFCLAEFHBBG.VABHXFCD.KEGEZEEA.eDFAMFABCAGCUFBHhAAASEAB.ICFEhAAANICF.aHBCDDADhABAAHHHBACC..cGGC....hADA......hAIA...,1,-23,-27,4
bAQJdWBNHKCOgGLTVeYMfRZaSFcXPDEIU,QFFAJDBCBGDH.KAGE..OHFGLABC.eECHMAAEZCBBhAAAaCGDFEEB.XBGAhAFAEAFFUFAAAFIFdHDF.NDDF.hBAACFGB....gBCE...hBCA......hBDA...,1,-10,-42,32
OGXTeZNgWBJdQYfKIbACcDMaSFPUHVLER,CHCHDFBB.MFCASAFE.FCFEHGDCLAAHEAFHRCBGOCHHhAAAGEEEeCDF.NACC.BAHChABA.dCAC.fGGBhACAKFBDIHHGACIBaABE......hAEA......hAFA...,2,-24,-22,2
OTcDNLKMRGBUECaVfHWAZIQgXJPeYbSFd,QACAJEFC.eBHDSAACdHFBOEBFDBBALCEDhADA.MEAEGDDAUGADhAEACAFFfDGEhAAAAGIDZGDG.ICAGgBGFXGCD..hABAYAFE..hBEA...,1,-11,-34,23
RKTDbcaXUHCdYPWIefOZgVJAMENLQFBSG,MEFFLHFAFCDCBGDDGBBE.KFDADICAaEADHEGF..CDFBdAFE.hAAA.PCBDeHACOAHDhAAAVAEA.AEIFEFFGSBBChABA..TADCXCGA.YDAFhACAIBAGfHAHhADA,1,-20,-28,8
VCJMEAQYGUFgdfKacPSIeTWbOBXRNLZDH,GABEUDBAFEEHdAGF.aBFC..SGHB.eHEGbDDDODFFhAAABBGCRGAGLAAAhABADHFACFAEMIFCEDGH.AIDC..hABA.YDHBfAEHKADHIDAGhADA..WCAF.NAIE.hACA...,1,-10,-28,18
XNYHdASJWIFfgOTPMZUeCBKVEcQDbLRaG,SGAAJFHD.FBEF..gAECOEDDMAFAZCFACHFBBCCHhAAAKDDH.EGGG..DCBALDADhABAaACG.NIEHdDHChACAABAE..IHAA.fDBEhAAA.PGCGeDFF.cAGDhABA.,1,-14,-49,35
BKeOYPJVGZQLSgdMWIHUcAFXCTfbaNRDE,CGHBTEAE..aEDBRACEDBBHKHDG...eHAEOBBF..JEEBZAEBhAAASGHDdAHAMFFE.hABAHCCAAHHBFCGHXCGGhAAA.fAGEEEAGBBDH.....hACA......hADA...,2,-35,-13,22
RQOXGTePFZCYfKNBaAcUgdEDSHbVIJMWL,UDABEBHBHAAE..IEHCJFEALDACRFAF.OGBAGACBeAFHhAAAFGGCCDDC..YHFEhACAKEECBBAF.ACIB.dHAFhADADHCASFAC.MBEHXAGBhAAAPDFCfFDDhABA.aHDE.,2,-36,8,44
ebaKNOUHMRSYDBcJZPCWFgLXQIAVEfGdT,EBEHGFCDdBAE.eCFFKGFG.OBCCHDGFSGBFBABGZBGB.CDFF.FFAHhAAALEBEQDABhACAAGIB.fHGBhADAaAGENACH..MICEDDDH.JGCEWCHH..ICCDhAAA....hABA...,2,-18,-8,10
IWcJUFDZYgKMCBbNAdLHPaTSGVROfXeQE,dCBAHCCDaEACGDGE.OBEFeGDCEGAFIAAG..JDDEDCAHhACAZAAGKGCCBHFAAEBATAGAhADASGCF.fAGEhAAAXGAGWFFDFFHDMBIFCCBF...hAEA......hAFA...,1,-18,-19,1
ZGWRJbXCPLBDSKYQfIVdgeUEFNTcOMAaH,HBDBZGFGRDBH.XGGDCCHH.BEAHDEEBKGBFQGDB.fACFhAAAdBEAUABFFAFANBIC.hABA.OHAEAFFA.aCAChACA.GCFG.WFCCPCAHSAHFhAFA..IEHBhAAA..,1,-4,-45,41
FcNTSIKOHMYPUeJBXaWbDZfgALEGQVRCd,LFAHGDCDRFADFCBCTBAA..SFFCOCDBHFFCMCAFUGCBhAAAeCFCBAGD.aDGGhABAWABEDEAA..gADGhACAAFIBEBEACHDF.dAHEIHGCKEEG...hAEA......hAFA...,1,-5,-17,12
RPKbFaGVCYTLXWeHfJDMOENdAIUQSgcZB,QDEDSAFHZDAHBFAAKGDHFADD.GGDBCDDHLFGF.eCCFhAAAfDGD.hABAMIAEOBHDdAABIFCChADAUACB.gAFCPFHF.aCCC.hADA.YHAAWBBDDIGGhAFAAEFB...,2,-25,-15,10
BJDegHKAPCRFbTONESUYIWdMVacLfZQXG,CBGDREDDFCAD..TBDEOFHH..SHACUAGA...WACChAAAdFFEVFAB.LCCEhAAAZDBCXFFAhABAJABG.eFBGKDGAAAFBPHDC.bDFE.EAGGMIDChABAaGHDcBBC.hBAA...,1,-1,-21,20
VJOTNBSAFDKMLYbIZUQEegCWRHfXacdGP,FGEGMECALBAE..IFCCQDGGEABD.eAFGCAFFHBFDhAAAXDADdGFF.PDDBhAAAJEAHOADBBHHFDCGChABAKEHHZFDD..WHAC.fADDhACAaHAC.cCEH..hAHATCADAFID,2,-25,-9,16
KGcJbXWSNYPdICMUgZTVeOQHaADFRELBf,FFGHEGGBBAADGDAH..JCHDXFDB..SGDChABA..YAFFhAAAIGAACGAEMAIHZDDCTBDGhACAOHECaAFGDBABfCFFKDGHcBBGWHBAhADAdHAH.....gEAEhAEA,2,-28,-24,4
cKTgLOGaMUHPeSFDBWVQZIENRbJdYXfCA,TGGDLBFD.ODHBMDFAHDAE.eACDFGAEDDEHBBAHVCAFhAAAIHCG.NADF.JFFFhABAdEFH..XACHhACAfFCFCHHFAAGAKGDDaBGCUGEC....hAAA......hABA...,1,-9,-27,18
AEgBeHUcYMWDfVRdTXCGKLQNJZOFPSabI,BDHDUDAFMDGBDFGDRDEH...dHCHCGBA.KBGELADE..QABGhAAAZCAAFAHH.aEEFABCF.hAAAEFDF..eFBEHBDChADA....YFHBfFHC.TFAFhAEAXBEG..hABA.NIAH.OHFC,2,-42,-9,33
GNRPEHbFKCABZXcUeLIfQVTMYdaWSDOgJ,ZFBDXGEHUGDALAEB..IADFQDAGMFCDaDHFhAAASDEC.hABAOBFGgBCChACAJABHNCAEREGFEAHB.HGFAKDCBBEFFcDED..eFAHhAAAfGAA.hACA...,1,-2,-21,19
ERgLeaPWdCHDcVKUOMbFfABGXQZTISYJN,GDAGQDEEZFFASACAJDAH.RCGHLDCCeACBaAGAdECChAAADEEHKAGFUGEH.ODHDhABAMIBGFBABACHBBHBEXFCDhAAA..IHHF....hADA...EBBB..hAEA...,1,-12,-22,10
HSKCBNdEYDPQbOMIGVRTgXFAafcUJWeZL,aACEUACG.eCDAZFFALCDCKCHH.BAFBdFBGDGFCQBAChAAA.MEDDIBAGhAAARCGF.XDFHAIBC.hABAJHEGWFEDHAFCCAHA..EFBD..YEBChABA.....hACA...,2,-23,-20,3
LQPBEWOSJIHXcCTFKDAdbgNMZfaeUGRYV,dABE..NCCHZDFBaBGDGFBH.RDEE.LEBGBGHA.ECAFSFAChAAAJFAH.IDBAhADAXAAC.CEHEKHCGhABADCIHAIBEMHFGeHFG.VADG.....hACA......hADA...,1,-14,-34,20
LFEfMNDJgbSTQGKedIBAYaWCXUVZPORcH,aFGECEEDUGDFZFAB..RGCC.HCECLEEEFAAH..MADDDAFB..JCBASCBHhABA.QFAFhACAKCGEdAADBADFhABAAHHDXAEC.PAHFEAGC..NIEH.TEGChAFA....hAGA...,2,-28,-22,6
XQPgNbKIEURBcZaTYHGVDWJSOdAeMFfLC,FABGCFDD.QGFF..gCAEKCHHEBEEBAGHZGBAaGGAHBCHhAAADFAC..SGABhAEAAHAHMAEBLCGDhAAANFEFIDFF..cABC..YFAChAFAWFEBdDDDeHCG..hAGAfAGB.,1,-3,-27,24
NSAPGKJROYWHIUbgTMVQEcZBLafCeDdXF,KFGCRGCGOCAHHBFAUEAH..TFGHMDDBEBAGBGBF.LDFAhAAAaADD.CEDDdBFBFEEGSGAHhAAAACCB.JHDEhABAIBDA........hABA......hACA...,1,-21,-37,16
PUWeDRfTLINVOgEYMdAZFQaJBXSbHcGCK,FDCEJACDBDFG..XAAHHAEAGECFKFBEUFGBDEAE...RAFALFEFhAAAIHFDODHDhAAA..gADFhACAMIBEAGAB.aDHBSGCGCDAA.eBHFhABATGAEEGGG...hACA...,1,-22,-25,3
bBdDCgZELRXOPMJKUVASWTNQeaGFcIfHY,SAFBTACE.QCFFaCGHGEABFEBD..IGABhAAAHFEABAADCGHGEFEAXACAhABAMCIHKAEEAIAGeCCB.hABAfDHAbCCEDBBFLHDAPCABJHBC.hACA......hAHA...,1,0,-7,7
cDKVMSEYWCaOPLBNFRIAUHfbXeJGgQdZT,UADCHFFHXCEDeDEBGDGEQAGGZCAADHCA.MADD.ECAFCBHG.hAAAaAAB.LFBHhACABHAAFBAAABEFbBBDJFBCdAGFKDHFSGDDhAEA...OFAHNIEH.hABAIHHA..hAFA...,2,-21,9,30
HBcFCZQGUOAbPefIKVgXSRMTJdaYDENLW,eFEHKCDD..VEADSAAG.MCCHJAADdFGCDEGH.LHCEhAAABBDGFAFDCAEC.ZAGDUCEGhACAAAEF....PFADhABAIAHGRDDF...aDGAYDHB.hADAEDAF.....hAGA...,1,-16,-34,18
GNdaFbMISOVYUWPcAEgRBDKLQTCfXZHeJ,EHDEBGFALEFECBBCZCCA.eEBHGEBB.dEHCaCBC.MDFCOAFFhAAAUGGF...cAFFhAAAABHADFAHKADD..TACChABA.XEDHNIDBFCAH.SCADhACA...WHAGhAEA...,1,-15,-37,22
eMGRIaBTCEQAXgVDYZdLFfJHWKcNPUbSO,XFAEDEBHdHDHLCBEFHEG.HAGHKEEH.....NBAGUEGEhAAASABH..eDEFhABAMAIDIFCFhACAaDHHTBDACHHAADDH...gDBC.ZAFBhAAAfGAGWBAF.hABA...,2,-36,-18,18
DgcASdeFRbJWTOQUMXaYBEPIKCVGLNfHZ,dDDCeBEEREAB...JEDBODGBUABF...MFFDaECB.BAGB.EBBDhAAAIHBB.KGFGhAAACBDALDHH.hACAfGCHDIDGAEHDSFAFFACG.bCCAWCFChABA.....hAEA...,1,-26,-42,16
HJFRSdDIYLVcBPfNWbACGZMQETaOUegXK,CGBCZCEA.QGGEaBCC.UBBDXEEHHFACFAFDdHDFDCAHLEEHhAAABDBC...NABBAEBGMFBEhAAA.TAGAeHAGKEGDhAHARDGB..IHHD.....hAIAYABC.cCEGhAFA.,2,-41,-2,39
AFQVdabRJWLSHGfOIKgNBMXZYETDecPUC,VBEEdDGFRFGDLCEF.HAFGfFAHKBCEBGAAZAAE.EGEBDADChAAAeBHHUCAAACCGQEDHhAAA.aGGBJGCEhABASAEC.IHHHNIAH.YHAChABA.TCAHhACA..,1,2,-28,30
bKROfCdYEQUPWASJIeVBTXGZgHcNMFLDa,JFBCeFBDBCEEGACD.ZDCEHCBCMABFDGHHKEHFREFF...OFCFhAAAdABCEGADUAGG.AGEASCADhACATBGG.XGEEhADANEIA.FCCCaACECHHG......hAAA.YAFE.hAFA...,2,-25,-6,19
YZLegNVbaKUMTEIGcCdJSHWROBFXAfPDQ,DDDDQGCHLEFFeEEC..VGACaBDBKAGDMDAD..IEAChAAACCEDdGGAHBAH.OABAhAAAFGFCADEA..fABGhACAZBFANEIA.........hAFA......hAGA...,1,-16,-30,14
HJUeRYfdTMCZEQagLPWFbVNXIAKGDOcBS,KDBHDFABODGBBHGEHFDG.UDEFeCCB.RFDFdCAGCAAH.ZAAC..EGBFhAAAaGADLACE.hABAFDHHNCIG.AAHD..SAHHhAGAfHGHMCCGPBFA....hACA.WCEB...hBDA...,2,-32,-18,14
OYWBMACgcTILQGVKfbPeRDZEUJSHdaXNF,CEDCTGCCLGAC.GAEAKADD..fFEHeBAGDIEGUFFAhAAAJDEGHEACdCHC..XCAGhABAFAGDOABH.BGGBhAAAMIAAAIHEIGAD.....hACA......hADA...,2,-23,-20,3
PaBHeVZObQdCJRGSMDAFTYXUKNcEWgfIL,FGABXGAHUGCH.KDGC..EDAH....fDDHIBCBLEFBhAAABBAHVGFGZFGBhABAOBFEdECFJCDGSCBHhAAADBFAADIH.NDAA..gFBB.hACAaBDG.bEFGCDGEMADAhAHA...,2,-23,-11,12
IdcXAZGETCNgfVKSJOaQFDWRHUbBYLMPe,ECBHCBAH.....fEDEKAGCJCCD.aACEDIGE.HEDHBHGEMBGHhAAAICGB.dAFDhAAAXEAHABAGZFFGNAIA.SGGAhABAOECHFGAH..RDGH..bADB.LHCAhACA..PEEGhABA.,2,-22,-18,4
HIXNWQeJRCVLDKPAUEBdTFSOaYfGZMbgc,ECCCTADBFCAH...OHFEaFEC.GGCBMIFA....bEBHgBAAhAAA.IFFGhABA.NCICQDCDhACARBGBCBABDGABAAFBBFHEdGACYDGHcDEAWAAEhAEAeBFF....hADA...,2,-28,-6,22
bLPEZYXfGKeWJIQOaCBgRTAScNUDHMFVd,SHBEUDFBDHGCHAFFFDDA..dGFDLFADEAFF.ZBBG.XFBAhAAAGAGAKEHH.JACEhAAAODBCCGDEBECD.TCAAhABAABBGMIDA.........hACA......hAIA...,2,-26,-24,2
TCQcaUbGKgfDIBOSHEXNAeRVPYJMWFZLd,VGBGJACC..MHBEFCEHZBFALDGF.dEEACDBB..QAAEhAAAUAGCKCDC.DGFHBAAGHEFEhADAEFAAAGIB..eFAF.hABA.PHEC..WAEETCBFaHGC..hAFA......hBCA...,1,-14,-29,15
ETOLYKVbSRadGfIFPWeDcMUAgZHBNQCXJ,ZEBFHGFABBCACDGB.EDDGOEAH.KECHVAEFRBBG..dABFGEFChAAAFBHF.eBHFDBFHMFEEhAAAABBD....NDICQGDGhABATGBG.YEAFSEHH.hACAaGEB.....hADA...,2,-19,-19,0
EIeGMbcYFUOATCDXNLWPVaJRZSQfBKgHd,CECAXDBHLDAH....VFFEaAEAJCEESGAG.BBGFhAAAKDHHHACBECAFIDHGhABAMHAC..YFGHhAAAFEEGUACB.AGDBNIBHWEED.....hADA......hAFA...,2,-31,-21,10
fNAMRPIOXDSFYJaVGTeLCBZdQgcWHEUKb,MIAERDEAOFBADDBC..FFEH..aADAGBGALBBABBEHZGBAdAAFQAGGhAAA..hABAcEBCEGGFKDBE.NCIAAHFBhACAXGGF.SAHB.YDCGhADA...hAIA...,2,-31,-17,14
ZGCATIdXHYBcefgQPaJEMNLbVWDOURFSK,TEFGdAHGHDCB.BACEeFBGQGFA.aFFGJAEB.MABAhAAALBBGbBCH.WGBGhAAADHBCRAGB.KHGGZBEDACBCIHEAhAGAXCGCcEAB.....hAIA......hBAA...,2,-23,-6,17
OcEZGITJSXWLYPCdFUMAebaRNHfgQDVKB,eFGDaBHFHCADQCDEKHAGBDGEEGDH.ZAFDGDDA..JFBDXAFBhAAALBACCFBHFHFChABAAFHGRCAD..NAIC.DGGA.OBBGhACAIAEA.WFFD.....hADA......hAEA...,1,-6,-21,15
KTAMINBFLbXVDORHJZYgEWefPUQcSCadG,MFBDBDGELCCD..XFGHDAFERFEEZAECEGEH.eAGF.hAAAUAADSABAhABACCHGdBEATDCHNIEB.FDAGOEHFhACA.JDDCWEFEQGCG..hAIA......hBAA...,1,-17,-26,9
bcKBIRfLYaDFeVTESCgXNGPdZOJHWAUQM,UBEEMCDBKHFGBEAF.RGCE.LHBG.aAFEFEGG.eECG.EGHBhAAACCHCXACE.hABAGEEDdBCG.ZBAHOAHHhACAHFACAACAQGAA....hADA......hAEA...,2,-28,-15,13
cgPEfHReUALMGdDTYabICZWNXJVSBKQFO,LFEHGACHDFEGTEGB..aCFDCACCZAEAXDAF.JFCHBDFFhAAA.FFACOBHFhAAAPDCFEGAFHBAE.UGGBhABAAHIFMHEEdHAD.IBAE...WCCBhABA.SFGAhACA..,1,-15,-18,3
LJAPCbERdaGZgYeOXcUQVfHDSIKNTFWMB,CCAFEECDRFAA.dCADZAFC..eAEB..XDEHUCGCQFEBhAAAHBDHDABGKFGAFAFABHHHLHCGhAAAADDFaABB..gDBEhAEA.........hADA......hAIA...,1,-20,-30,10
APIRZCOXDabMHSETBVWfJgLeYNUdGFQKc,RCEEOHAGDBAC..MDBBSEDB.EHGGBAHG.VFFAfDAEhAAALADGNBAFGAGAhABAFECBKDHH..AAEE.ZFFAhACACCCD.XBDEHGCA.WFAG....hADA......hAEA...,2,-28,-18,10
GLPJDgFaENYKSfZCHeXUTQBRIdObMAcWV,VAAHGFAD.JBBAFDDE..EDAHKAFD.ZDGHCHHBHEEC..UAGChAAABDDGRDBBdFFGOBHBAIBA.hACALHAADADD.NAAB.hAFASGED.eEADTCEC..hAGAIHHHMIEA..hAEA...,2,-26,-8,18
NDaCXAeGLFSUTfERQBMOWHKJcZIgVPdbY,eABALECCFHDGUEEGTAEG..RAFCBHHGOGFG.KABHZCEC..hAAAIEAB.VBGDhAAAdCCGNBAE.DGAECGAGADCA.hABA.SCHBEFDDMIBC..WHFG..hABA...cBDChADA...,2,-29,-25,4
YVZPEKCgOTBdDNbMIfaeGJFLQHcUASWRX,RADFVDADEHBG...CGHH.OAHDBAGC..DDIDMCGH...IFDHhAAAaADFGFDDLABDhADAHDEGACAHSHEChAFA.XGGFPBCFKBHFgDBAhAGANIBBfABC..FDHHhAHA...,1,-17,-24,7
MJfObIcdLGUEHQgTWVXYeaRFZDSNKPABC,BBHCCGDE.MCDHJCAH...ODHF..IHCHLFFHGEDHhAAAEBBDHEAFQGGDhABATAEB.VBGBYFDBhAAAeBCDaAFBFACGDCEHSGBFKCFGAHAB..hACA......hADA...,1,-8,-26,18
OJGbeZMXLSVaABRNEQCFWUPdHDKgYcfTI,BACBRGBEECCF.FCDD.UFGDdFBBKDEG.......gAEAhAAAfBGGOACGhABAGEAEeGFGZDFEMBABhAAASAHBACCG.CHEH.WFDDDCBHYEFGhBAA..IAHFhABA...,2,-46,-12,34
DEgRULOJSCFBKWfQTNVHdGPAaYZMbeIcX,ZGFAMGEEeDAE..IADEXABADGBHRFAHLFDC.JAEEhAAASCDF.hABAFDHBKCFDfBADhAAANAIAdHCHAIFG.aGCH.bCFFcEGFEGHHOFBABDDB.hACAWAFE....hABA...,1,-5,-36,31
HOVPbdNKXJGcRFAgIaUTDCQWfLeMSYZBE,aCADTEGG..DGIFCBBC.QGACLADBSFDFBCDGHCFGVEEEhAAAdGGDKGEDGACDhABAFFADAAFEUCAHeFCBMIEChACAECGAODEF.bFBH.......hADA......hAFA...,2,-8,-7,1
TLabQdgURIVfAXYZeJNCcBGSDMPHEOFKW,XEFHZCFHJDBB...CEHEGAADDCIBHFEFFGBHKADBLCDF.hAAAaAGGbDDB..dGDGRGAC.hABAICGCACAC.NDAC.hAAABAFB.SGGEPHFEOCED.hACA.....WDAFhADA..,1,-17,-26,9
RPFXHKMTOCgIQZLcBYSEUWfJaADdeVbGN,DGEAdFBHeADDGBBARFEH.FAADHAAF.KAGHOHAA..IHHChAAAQBGGZBEHBCHHhACASFBAEGAB.fHFBhAAAAEIHNEAF.PEEC.MAEHCEGH.LEHHhACA...hAEA...,1,-14,-15,1
ZEVXHJKGfCBANPFMIeQOWTgbaSYLRDUcd,FDCBeDBDQGGBOEGH....gCDHaDGCSEBDhAAALEHHDHACdBDDEGADHGCEhAAAJFEFKAGDCBADABGE.MBBEhABAIBAH...WHAA....hABA......hACA...,2,-33,-11,22
TPMBIUcEKRbfQLZaGFWAYgJdHXVNCOSeD,JCECHDCA.VGAECGAF...SAGGDDBF.MFFGUEDFKBFDRGEA.hAAAQABGZACDFBAA.hABAAHEEdDAA.XGGBhAAAOBHF..eHBGBAEFEAFGfDGHhADA....aEGF.hAHA...,2,-32,-10,22
YEWDaSAHebILFfRTcKCBMPNGgJdQZOVUX,HCFHeFEGLBDBRBDFKGADBBBCMACBGEABJBAB.dCADZAFC..OAEGhAAAVEAG...XEGHhABAECHBDGAFAAAGFHCETGDGhADACHHF.....PHFCNBIA...hACA......hADA...,2,-14,-7,7
ZKbCDJRcIAGeNTHWfFOMEBPYSgaLUQVdX,eAEATCFFHDAC.FDFDMEEDEBGA.BDABSBAHLABGQGGDhAAAVFAAdCCBKAHHCDHDDCCEhABARGFEAIDA..GEDAhACAfAFAOFAH..YDHB.aHAChAAA......hACA...,1,3,-17,20
MQWcSdIfgPEZGCJbHTDaBVLFNOYXRAKUe,eEEBMDGF.QACB..cBEDIFBB..PEEBhAAAEDHHCGCHHCEADCIBBAHGhABAVBAFFBBDOFAHXEAHhACAAICAKHGESHEA.fAEAhADA.ZGAG.JFHF.hAAAaDCD..,2,-14,-4,10
UTHDeIaVbLKJYRMAGcfEPXQNBOFgdZCWS,GBAHEEEE.QFABOEHHFHCGdFGHCACC.SHCGHBDE.IHHHhAAAbEAA.KAHHJBAHhAAAMEFGAAHC..fCGFhABANDEEBEABZADAUGEEDFFH.aGAH....hAEA......hAFA...,1,-5,-16,11
fdGYUSJDFNBKOWPTRHLebEZaQCgXcIAMV,MDFEdACGUGBGDECEBBDCKFGC....OEBCTAAFLDEBhAAA..eHCEEHECaAGAhABAgGFG.IEFGhAAAADHGfADHYFBAFBEE...PAFGhACA....hADA...,2,-43,-27,16
ZJcESYgMAGCURVNdXKbHPLWTQDaFBOefI,UGBFVFAD.dCDA.KGFBHCAC.LGDEQDFCFCFGBABA.hAAAeEHHfACDhABAJEECEAFC.SBFChAEA.MBCHAAAFCHEE.NBBCPEHFDICAaAEB....hAFA.OFEB..hAGA...,2,-24,-13,11
AIHaXKDNfRVTWgeGSECMYULbZcFJOdPQB,HAFDaCEE.XABDDAFBREGF...VEAGTGBCeFFE.GEDGhAAACDBEUACFLADH.hAAAcGGHFAHHJDDH.OHDChABAdHABBDHHAGAA..KDAD..WBAFSGHHhADA...hABA...,1,2,-24,26
dTECHWFRNbSfKIMZeGDPUOABaQJcVXgLY,QFCFVAFB.LBCGTACDCAAFHFGF.FDFFRDEH.SFAHhAAAKHAGMIEA.eAFEGCABhACAPCAHOFAEBDDGhABAaEGE..JCHFcGGF.....hACA......hADA...,1,-7,-12,5
MTacUXEdWAFZKQSeLDHOJfPBYGVIRbCNg,ZEBEKGFEQDCDSCAGDCCAHFAB.JADFBAACGAGERGBG.CCBH.MAGDhACA..aAAEXGGAhADAdGDAAHHAFDFFLAHHhAEA.PFFGIAFH..NBBB...hAFA......hBHA...,2,-23,-11,12
UFDSgXHRJBOeYaTEIZPKbfdNWCLGMcVQA,DFBGSDEAHGCAJDCABECC..eFFBaACH.ECGEZFGF.KFABdACECAFF.hAAAMBAH..QFCDhABAFAFC.RADDOAHHhADAIEGB.fCEDNIAB.WBBDhAAA......hABA...,2,-32,-22,10
BNJbPGMLISaTgQCKUHfdRAFXeEOcZYVWD,XBGFeEAFOHDEZEDC.....VDFGDIFCBGEC.bBCAGAEBhAAA.MEEDIGHAhAAATBCB.CHCCKBADhABAfGAHAEDHFGGA.EBAB...YHAGhABA.NAEBPDAHhACA.aCFD.,2,-32,-12,20
PTLYBZXJFDbdeUWVISQNKfGHaCERgOAMc,MHACTCFCBBEH.ZDDBFBDA.dFFDUAAC..IHEBSAGAhADAKHACHDCGEGFEODFChAEAABBHLAAF.YFAEhACADAFGbDBFeFFE..WAEENICH.fGHAhADA.CDHH.hAIA...,1,-14,-24,10
YbOQCaNVUSeXcBGJZfAWFIdKEDPgMTHRL,FGFHKFDGDDCBMEACHAGDLBGB..OBABCHAH.aHFCUADBeEEGhAAABFEFGGAFZAABAHHHdBDHhABA.EGGA..TGCHhAAA..YDABNEIC.SDDFhACAXCCEfCFAhAEA.WAHB,2,-25,-13,12
DfXSJQWgbIEeVAYPCLTMNRBdKcFZOUGHa,CCEFMDEBBHEAdBAA.KFCBFFGB.ZCACUBFD.HGFEDEAH...SDBAhAAAQFDG..hAAAbFABeFBD.AABCLAHHhADANAEF..OFFAaCGHJBBGIACFhABA.....hAEA...,2,-36,-15,21
YaDgCGMfZSTFHNOEPKIdBbARcVJXWeQUL,VGEAXGAA..eADGLDBADFDBGAGGMHEGZDFG.SAAEhADAFBDHOBADEAEFKGAEhAAABFGHACFFREFG...WBFAhAEA.QBBFaCCHCEEF.fAGHhAGANIAH.IFDHhBAA...,1,-12,-22,10
COFbdeZYKSGfXcMHWBVALIgRPDUaNTEQJ,LBCERDGDDBFA.aDGBEECD..CFDE.FEABdHFDZCDFKGCGGAAB..hAAA..XCDHhAAAMIEGBHAGABHA..PDAFhABANADH.QFGDJGDG.eHAGSCHBhABA....hAIA...,1,-21,-26,5
aSecgUJbETADPMYdZQFOWXICNVBLHKGfR,DGEHMADGZEFCFCDG..OFBB..XBFDCDCDBBEB.LFEGhAAAKDFC.GDBERAAD.hAAASBAGeAFG.hACA.gGGGJHCEEEEEAIGEdAHCQACAhAHANBBD.fEDChAIA.aCHF.,2,-36,-10,26
gMOVHAdPYeSBTWRINFJUKbCcGLDZafQXE,dDDEeAFBBBBCRABE.FBEEUFDG.KEAECFADLGEAZFGD..aBAHQCAFhAAA.EHCEhABAOGAA.AHAGSDDAhAAATDGH..IHAHNIAF..hACA......hADA...,2,-40,-29,11
UcSIfgMYEOVDCLAXPRJFdQBbGTaWNeZHK,XGGARADFdABCBHFFGBAA..aCGGeBGHKFAG.SDDAhAAA.IGBFfFGGhAAAMFFBEFDFDCIBAEEGFDAChADAQACD.TEGGNEIA.ZFCB.cAFBhABAOHAE.CAHA..hACA...,1,-9,-28,19
DOXHQWaeETNJgAYUMPKIVSfFcGZbLCRdB,MEEAKGFG..VDFGSGDB.FADEGEDELCABCFCFBADAhAAADAIBHFGHaCCF.eCEAhAAATBEHJHAEAGBA..PAFAhABAIECG.fCCHbDAF.dFFGhABA......hACA...,1,-16,-22,6
SCJbHRdBTWKcMDOLaeQfNFEgXAYVGUIZP,GEFAZFCHCABGHBEEBADCKFAFDHBG.LFDB.eBEANBIG.ECCDXBCDhAAA.ADAAUGFHhACASHAG.JFAChAAAdFEF..WCEAMEAAOBADaHAE...hADAfAEF.hAEA..YFHB,1,-16,-22,6
gHXCAOBePZfREMTaVFcUdIQWYSJLDNbGK,BAGHeFBEZBEFRDCG.MFFFaFAG...FBAEUFFGdEHA...QAEAhAAASGCGDIGG.GBAHhABAgBGDCADCAHDDOBHFhACAfDDE.EHAG.....hAIAcGGCIDGHWAFEhAAA.LDAD.,2,-22,-10,12
HXbABDRWCdaTJVUMOEZYfgFKGQNPLIeSc,BABGRDACCAGH.dCDH..aHGEJBGB..UABFMFIDZDFA.....hAAA.fDBEhACAFGCCKFGD.GFBH.QGFAhADA.NIAFLEEAIGACSDDHhAAAHADEAHAADAFG..hACA...,1,-8,-52,44
OFTbKCDRIeXNGPHgMEBAadJSZLYfVWcUQ,aCCESCAAZBFB.LEDA.VEAHWFAB..UGDBQACFhAAAFCHFKGGECAEAIFHAhABA..eBBEhAAANEECHFFBMABCBHCGAIAA.YAHBcCEB.ODAChADA...DGAHhAFA...,2,-23,-15,8
GcPDeLHTYgWBSNKMFAXfRQIEZUbdaOVCJ,XEBGQEEEZBDBdBEE.OCCDCBHB.GAAADFGHeAAAHCGH.hAAATGBH.gAGChAAABFEDKGAFMHCGhABAAGHFfFAHEDGGUAFG.aHFE.....hACA......hADAJBCD..,2,-18,-7,11
DZLAPKNXEGYQCTWdOMVFIecafJHbURgBS,KEAGEEGFGCCFQGAACGCD.dCBB..ODAFFFFHeAGD.aACCfGEEhAAA.bBAChABARDFGBFDFZAGF.AEDCNAAG.hACA.....YFAF.MBBGhADAICEAcFGE..hAEA...,2,-27,-21,6
KYEWNGTMfXZeLOBbFDcJRgPHQISAdVaUC,dCGBVCFCUFAH.KCCAEFCB.GCAA.MACEXADB.eFDAhAAALHFCBEHEDBABhABAJFFEPHACHCAFSHDChACACBAF..WDDBfHFFOAFC.hAAA......hABA...,2,-25,-17,8
cfKPgFadYITBQCVGAOMWeELDZJSNURXHb,OAHBeBFAEGFDDECDZDCF....SBCGNAAA.UEFDHDABhABA.fBBFhACAKDDFgGCHFCHDaAGGIGAEhAAABEFHCEECACEF.MFIBJADCRBAB...cGEDhABA.....hADA...,2,-24,-13,11
YJeLGSHRZBTFIXWaCUMcAPdEgVKQOfNbD,EGFAKFHFQBBH..OCFB.fFBCNDACDHBGeCDHhAAALCAAGBFA.SAAGhABA.REDBTDGHhACAFFFHWACEaAFEMFEDAEAF.....hADA..dEBG...hAEA...,2,-25,-17,8
FJcbAWOKZDVIPRfSMLQTHXUgYdGNaECBe,KDFGDDHF...VDBGIHHA..RGFAMBDALGAAHFAEXCDAhAAAUAAHdDHAGECFhABAaAHD.EDBEBFFCFACAbBFBhAFAAAHFOFDD....fBBBhAGASDAF.....hAHA...,1,-12,-23,11
dFMbOAHgTeKBDLGUWCQYNaPcVZSJfEXRI,TABBeAFGKBBD.DHFALHDG.GDDDUEEBCHEGQFAChAAA.aFGEPCHDhAAAcAGESBEBhABA.EGCDIBEAFEAGMCDBAEAABHHG..hABA.NDAF.....hADA...,1,-15,-30,15
YOWcEGQRUJHaXfgDPZVKdMIbTASLNFeBC,LBFDeAEFBDFGOACAEAAA.RFGD.UBGEHCCH..aEFEXAGDhAAADDBHZACB.KGAE.IHDAhABAAHAFSFCEFDGACCBC.hAGA....cGGCJEEF...gGCEhAAA...hAIA...,1,-14,-28,14
XUJQPDaRLIGAdZWCEfNVKHSYOeFMcTbBg,dDAAZECBEFHD..fGDEKADBHAABOFEBFEGF..MAACTCGChAAABAHC.UECFQGFDhACAaAEH.LDCChADAACHACGAGSBGDeFAHcAFDXBBBDIBA.hAFAIHHE..hAFA...,2,-39,8,47
KFdMgDTJUeZINVQHBcOCELAYPWSXRbaGf,...PEBCXGBHRFFC.GBCBKCCGdBCBMAAE.DAHBUAGCeGDChAEAZFAA..IDBChAFANAAE.QDGGhAGABHEFCEEBAIHE...SGHDaEGA.fEEFhAIA...hABA...,1,-12,-33,21
PCUGAHXYgOfbNQVaTLIDMEWcZFeJSRdBK,HBBGXFDAOGFE....NEDDQEADTFCALDADhAAAMCDE.ECFEZACEJAHHSGHDhAAAdEEFBACCCBACABBHYHCAhABAfEHEaBGFIEBGDCAF..WAHBhACA.....hABA...,2,-18,-10,8
JEFcKZONYSaXCUBVLTbQdeWGADMPHRfgI,DAFAMBBGRABE.....IDHDEDGHKGDGZFFAOFDG..SHFAhAAAXDADCDDFBHBHhABALGCGQBFGhADAdCAFGAECHEAFgCCAFHACcAGFNAAF.UGGGhAIA.....hAEA...,2,-26,1,27
fGVOSMXWTNdYPaDUHZeERCQBcIAFbLJgK,LEEAJGAC.KGCFGAAGOACHMCDC..XGEATEDGdHGBhAAAaBFF.DFACZEAAEDGHCAHBBHHEhAAAABIF..FADEfADEhABASEHH..WBBDYHCGhACA......hADA...,2,-25,-25,0
aCWcPSYOLDXefBTFgIHGEKbJUAVNQdRMZ,VDDEdBDFREAFZGEA..CFCA.....PDHDSBCA.OADAhAAADADGeCBGBHDFFAAChACAIFGBEGCH.KBFAhABAbDFHAIEG..MBIF.aCADYAHD.hACAfDEC.hAHA...,2,-40,-17,23
OfKCLbIZdHDBYNUQVJRFcTPGAXgEMaSeW,XDDAEFHB..MEFHeBADOACBKGHDCHEC.LEBAZFBD.DAGEhAAABBGHUGCAJEAHFBAH.hAAATBGEACECaGFDSDGDhABA..WAEDfBCA.hABAIDHA..hACAYFAF.,2,-25,-22,3
gcUACIbHSLaPJVWZFGdNBRfDXKeTOYEQM,CGHEHFDHLEBCJBAHZCFFdAGBBCDG..RFBEDCBGKAEF...OFFDhAAAEGBG..MAHHUBDCADIH.hAAASCHF.hABAaFAHWFHH.FGGBNABD.eCCD...YFAFhACA...hBAA...,2,-34,-19,15
gTMcIdbZJEWKfGNHXOACYSBQeRPVUDLFa,SFAHeBDEREDH.UEFFLGFC.FDEAaEAAMACCdBDEJABDEBAE.hAAA.KAHBGAFA.hABAXFDDCECEBDHH..hAAAVGACDAID..gGGA...hAGA......hAHA...,2,-21,-21,0
bSdDBIAGTEaeUFNVYgJXQKfLMPCROHcWZ,GEGAaDED.UEBFFHBG...VCEEJCBCKHFGLBAE.CAGFHCAGhAAAZBFFdEBABAEBAADHeAHBhAAA..NAIE..XEEGhABAMEABOEHD..WHBGSBAFhABADHCG.EHDA...hACA...,1,-13,-24,11
TYdKPBCRIXGgZFVecbUafQNWMAEOJDSHL,JFAHDDFEHBDALEDEdAGBBBBE.RFBCGEEHZGDAFDAEeBCC..hAAAUDAFaCGF..QFGAhABAMICEAAAFOHEAhABASACC..KACECCFG......hAFA......hBFA...,2,-23,-20,3
dbcOaSLTDWZKIUfAeEFVRPYMHBQJCNgGX,EDBEFADDRDAD..MCFBHEEABBBCCABE.GGEFdGCG.OHAASGEDhAAADGBGZDDHKAHDUAGFeDFEhADA....YEAAhAAAQGGC.JCCFXADBaAFH..hABA......hACA...,2,-21,-11,10
FEOeHaATGLVRZgDPMIKYQNCcWXSbdJBfU,TFFEVDCA..ZGFEDEAF..MCBCKHBAQDCFCCFF.XBEAhAAASDGBdBABBHEGhABAfAHGEDHDOADAhACAaCAHAFGFLGBC.PABGYDBFhAHANIAD.....hAAAcFDB.,1,-13,-16,3
ULOHDKBadbYCRJPfQTgXMIGSAZWFeEVNc,FBCBeADEEHDC..VCEHUEAEHABDBDHCaEHB..dDEE..CEBHJHBGhAAAQGGE.XAAFhADAMGAGSBADhABAABHGZCFH.cGGEDAFCKDDFYAHF.hAEAfGFC.hAIA.gGBA.,2,-17,-6,11
RJYCBePgWDNETHALdIfZOVKMbUGXFcaQS,dFCFZBFHKHGCMBIDGFABFAEG...aHBCRBAECHGABEBC..eBGB.hAAA.PCBEDDAHECEBAAED.hABALHAAODHD.UFGHhAAAXFEF.SAHF.gABChAFA..hAGAWDBG.,2,-33,-15,18
PTgEUHfScFIGYCeODVWJNXRdZBbLMaAQK,KEGDTEGCEAAC..UBGCSBHH.FBCAIBDDGFCDCAGCDDDEhAAA..JCFDRFBBBHAHhADAMEACAHBE...gBAGhAAAfFEEcFABeEAFOHEE.hABANAED..dEHE...hACA...,1,-19,-25,6
FQRNPOGYHVaKUALBDbZgJWTMCdXeIEfSc,BGHFDGHHZDDBJBFC..MADFdDFA...eBBDEEBC...SEAHhAAAFADFQGAGRGAAOAFChABAHCAEKFFCABAB..LHDEhAAA.WAFECEHBfCFD.hABA.cEDG..hACANICH...,2,-33,-25,8
ORWMeBTKGQFJIZVPEaLUYCXdNDcbSfAgH,OCAHMCGDBHCHGBGGFAFB.ZDDH..EHFGLBBC.CGFHdGAAhAAADECASBBAhAAAACCGRFCD.eDAFKHGAIBFDhABAaADFXEDE.NBHE......cGGAhABA...fHAFhACA,2,-29,-27,2
FKWACSZJOIgLVNYRXfTUaGQDdMBEbHePc,CDAAJDHD..OEDBLCAF..VEGDRCDE..XFBEUACCaFAChAAADAGC.BCBHHBFDeFFDhAAAFHDEAIAG..SABEhAEAIBAA.NEEG.fDDB..hABA......hAFA...,1,-30,-31,1
CbLKAUPQdOgJZNHFeDBMSaXGERTfIVcWY,UABDdABCOAHBZCFHFFDCDGGB..BGGA..SBDHGGAFEAFEhAAARDAE....IFHHhAAA..cEADhACACBFFKGCAAIHAQCDH.NBIC.MEFD.hAEAXGAF.fACHhAFA,1,-35,-36,1
JIfDMNSZQGEWFYVULeOPaCRXAbTdBcKHg,dBFCKBHHHBCFJCHF.DBBF..MCCDZAEEQFDAGEAE.EGHBFGGGhAAA.UEDFeFAAaADGCEAFAGGHhAAA..BBAG..hABAcCED..IAHDfDHE.hACASABB.hAGA.WHFG.,2,-31,-15,16
VLBURYgKONSdCaDeWTGIAfPXQEJMcZHbF,XAFDQBDE.MFIHZECEHABB.FGEFBAHERDAHKCHBSEAEhAAACGGB.eGEGTADHhAAAAAFGEGBA.bABHLHAGhABAgEFBdDEFDGIDIHDG.fBGAhABA...hADA...,2,-10,-8,2
UKJIfQGVcWZARaedEDNMTCHgSFYXLPbBO,RCBCeDAAEEAE.DBDG..MAFGCEGGHGAE.FFFHXFFELAAFBFDChAAAKDED.JBAG..IFCChACAQGDDGAGGhADAVDEAZBCCAEIHdGBA.gADBSHGA.hABA......hACA...,2,-16,-8,8
FHPCGdEfWQbJgBYDMcUZOVRAXSLTKeIaN,LDBDKBDHeBCD.aADEFFAFHDCCGEFA.dFCAfGDC.hAAAQAGB.hABAbGFGBDAFMDFGcCGHhACAOBBCAFEBSAHBNEAGEFFE..WABChAAAYHCGDIGG...hAHAZBED..,1,-2,-21,19
FRZQMVBDEaNOLSXbPIKJeWUdGYgHCATfc,TEGDFEEGZBBA..MCABDBEC..EGAE.OEDBXEBG..bACFhAAAKGGB.eCHF.dGDGhAAAYCFACAGG.fAHEhABA.cGGD.RFEBBCBDhAFA..aHAGNIAF.PABAhAFA..,1,-19,-30,11
MRELbVUABFaTXJfCgIcDWHYdGQNOSZPeK,BFCGTEFCJBGH..CFDC.....ICBCDGBBHBBE.dHEFQGAChAAANADFZFBF.KACBhABAMBDAEFFH.LDEEhAAA..UDDHAABAFAHD..aGHF.fAEChACAWDHH.OAHFhAEA..,2,-31,-22,9
CSVYLUcEbXWJZaOFHQAGIRgdBNKPeTMfD,RAFCdAGHBEGAKHAE..eAEBMHCA..CEHD.SDEELAAAEFEC.hAAA.XECAZDCDaHDE.hABAOADGHCAHAGGAgGGGhABA.NCIC.fGHADDBC..hACAYBBA..hACAcCFE.,2,-25,-18,7
cCNDPIJFMeLdaZKRUBWEQTXHbYAGfVgSO,VCDASEHF.OCCGCFFEDHFE...JGCAMBDELEBFZCBBUGCHhAAAEAHD...QAGGhABATAABHDEBAEAC.hACAfACB.NEACIHHCeFADKDGH.hADAWHDA....hAAA...,1,-22,-23,1
RETPMVXIKacgfGAHeLCSdYBNWObZUJDQF,eFCHLCHHCEAE.dBAFBCAFOEBDZFFAUCDBDDBF..QFDAhAAAFAAC.RCDG.TAFDhACAMIBA..XGGGhABAKCGBaGEC.fADFABIB.HAFENCCC...hADA.JFAF....hAEA...,2,-27,-3,24
EFaKGeZHYfXLbJPNAMTQCORUDgSBVdIWc,MEGFCDCHRCAH.UFAEDAFH.BBAG..dEFB....IAEAhAAAEACAFAHBKFGFZDBAHAGF.hAAAXGDEJFDBACAF.OCCAhABA.SHGA..WCFAhABA.aGAF....hACA.eFHH.,1,-20,-40,20
KTEageMUcRbFNOfGCYDXVWBIJZPALdHSQ,dCHCSDFGQBBAKHDG.EFAF..aGFA..MGDCRGAAFCBCfHBFhAAACEBD.DEACVACChAAABHFAZAFFAFFALAFFhABAHEDA.eECC.......hABA......hACA...,1,-15,-23,8
VTaOQgBPAedLSbMfNKYXcHRUWIJZGFDEC,eCDFLECHMIDGKAFH...XCFCRFAHIGFAZBAADFFF.CBHA.hAAATEGD.QCFChAAABHGBAADD.dCAAfEGChABANABHHAFGWCCFFEABEHAEOEEBSGEDhACA....hAEA...,1,4,-32,36
fJGSIXLECMHZYUVKabgPeDRFONdABQWTc,QFBBTAAD.JBDHSGHH.XGBFEDHBCHFHMABDhAAAHFEAUAFFKBECbCAAeFEChACAFEAA.dBHGAHIHBEAFhADAfEFB.IHAH....hAAA......hACA...,2,-29,-13,16
OaNVBLRMKQdZGFWPIbTAHJYXSEDgCeUfc,HFCAJDHF.SGAHDCDH.CABC.UAFGOFEA..aBBGBAFFhAAAMDGFdADG.ZCFCFHBEPCBFhAHA..IDABhAAAAIGCEGHB..fAHANCEE...hABA.REAA.KDDGWFFD.hBAA...,1,-18,-40,22
BfXJIMWEcFHOLPdYeZUbKVaTQNDCSGRgA,BDGEXCDHMCAC..EEHFHDDDLAHHdAGBeAAGUBBHKFGCaGBFQDAGhACADGFD.CBGHRGEEhADAADFAfEBDhAAA.IAFCFFCFYAEHZFFF....hBAA......hCEA...,1,-14,-15,1
IecPbTfEHKaLUYBWdXCZRJFDGgVAOSQMN,OBAGSGBG.QBFCMEEBeFFF....bEAGTCFGhAAAfFFEHAEAKGHDhABALBBFBHAFXCAGhACACFHCZACHFHECDEGGVEAEABABIHHBEDHHaAGA.WAHBhAAA.....hADA...,2,-8,-2,6
QbBagfXLVSHOEGACcTFdKRUIePDWYNMJZ,CEECFABERAAD.UCGH..eFBHDFHD.....NBED.MDCGZCDEBHEEhAAAaGFB....XFCGhAAALEGDHAFCEEAHAADHhACAdFACKHCG..WBAD.....YECChABA...hAEA...,2,-36,-29,7
ZGbKQEadSeYLOfCMNUDcgAWRFBPHVXIJT,RCACFEGEBABGHAAH...XGCCTEGEZFDCGEEEKCGF.QADDhAAA.aBGGeAEFhAAALFAFOEABMCCDhACANAICDFCHADADWDDE.IHHCJHCG..bDCEhACA.....SGAHhADA,2,-17,-10,7
YNZOTSKbcEdUDXRFGHaBQegALCWPfMVIJ,CDGH..PDBCMFGB...JBCEZDCF.OABGKGHB..EGDFDEBHFAFAhAAAGBDDBFCE.eHAAhAAAABBHLFGD..hABAfFHEICGHNEFGSFEB.hACA...dDAG..hADAXAGAaCHD,2,-29,-26,3
TMPZQKWLDNOIXHJgUAbYefcVREdCFaBSG,eBECVBAG.RCAC..EFACFEEE.BCECGDFA.MFDHQFBBhAAALABEDADCOFEBHEGBUAGBhABAAIGC..fFHAhAAACGDAaHACSDBAPBHFKHAC.IDEBhAFA....hAGA...,1,-10,-18,8
LMeUTgFcHYZICbRJVBGQSAaEdPOXfWNKD,EBCDOABH..XFDD..WDAADEDBMCID.TFFHhAAAFBGBHFBD.ZGFCIHBChABACEFFJACEBHACSCFFhACAAHEBdDHC.fEBGKEDH.eADBhAEA.cAFF.YHFGhAHA,1,-16,-37,21
LIXWfMJbKPZUaVcNdBRAHGCeSYOFgDETQ,GCEFSFAAODCBDFFD.EGFFLBBC..XAGEhAAAMEGFKFDFZACEUCABaDABNEIABDDBhAAAABBF.CHCGeBHDFGACTEEChABAIAFD.JEHHbFCH.....hABA......hACA...,1,4,-27,31
UKIdMDGWLRaCgJXVBeTfQFYAbHNOPEcZS,HEGHOBGBEFAEZBABSGDHKGGC.MADCDFEELHFG.hAAACCHA.gCBEhABA.XBEFBFBFfAGDhAAAFAHHADGHNEFGcACCICED.WDDDhABAaGGHeEDF..QACChAEA,1,-12,-37,25
YcVWLfEgMNIObPSTaXJFKBCGQRAdeHDUZ,eFDFHDADDGDHZFBB...VADALABD.fFFGEEHDMAIFOCFFhAAASBEFXGGDhABAKAFECHEEQBGEhAAAdFEE..UGAFWEABIBBGbDDAPACFhAEAaDDB.BHHEAIEA..hAIA...,2,-13,-2,11
JWgLGcPZOFdHKbAUEXSTMRYBIaNQfCDVe,UCCCEBHB..SFACTGGC.MAAEBDFBaBDFQBGBhAAA.DEBBJFEDLHAAhABAcBBHZDGFOADGFGCD.hAEAdFGB.bFCEAHACXGGCICAE.CDEA...hAFA......hAGA...,1,-12,-21,9
URYSPTgeWXHECFOQNfAbIGKVLdZaBMDJc,GGBFLBACZBCFBDFGDEGHUEAASBGA..TBAGeFAGXFFBhAAAEGHH.OCCBhABANAAB.AIACIEDBhACAVAFBMCIHRAECPHDC...WDHHhADACFEG......hAEA...,1,-15,-22,7
UZQefHLNFRTXgJMaWKAEGOCVSdbPcYIDB,OAAHCGACdBFA.....bEEFPEBG..IECGDCIBBBBAhAAAQAFCHFEFFBDCRDGDhABAgEGC.hACAaBDHAAIHEHBGSEAHcGGE...YHAEhABA....hACA...,2,-32,-25,7
McDFVATQUObgJPGWHLCEZNaKIXBefdSYR,UGDEODCA..JDCBGCFEHADALBAHEACHaGAC.KEFCBFCFdFHG.hAAASCAHRFAD.hABAMAIDDCIFAAFEQAFDhAAA.PHDGCEEGIAHFfHGHhABA......hACA...,2,-26,-19,7
VHZcdUegGLBbCQfKOYETSRIXFJaMNDPAW,VFADHEFAZBCE.UEACGGEDLHACCAEDKCCE.ODDF.EACCTEGAhAAA.RCFAFCACaDFGDHEAhAAAABAA.dBACBFCBfAFBhABASAFHIHHFXEDB.MICChABA.....hACA...,1,-13,-14,1
RZgSXEcYWAONJUBQMIDeVafbFdKLCPTGH,OFDEUGADBGEC..IEHFeCEG..aEEGFACDLEAAhAAACECHGEAERGFCZBAG..SCEHhAAAEBGA.YHDAhABAAABA.JAFGDIDE.fDHChADAKCAFHGFC......hAEA...,1,-14,-27,13
gJcBCfIFRANQSVMbXOHUDEZWLPYedGaKT,SCHHVGDA.MGFEOCFE.HCBDUGAHDEDBEBBBLAAChAEAeEBCdDFCKGAA.TEFFhAFAgADEBHGHCAFHfHFHhAAA.IBGFABBANBEA...hAHA......hAIA...,1,-16,-20,4
RKHDFISCPfOJYUEaAMWTGeXBbVcNQZdgL,TDEHeEEFBAAB..VGAEQCAA.ZFAHLCABhAAARGFEHCGHDDDBFGHDICCAhABACAEDOCDA.JADG.EHEAAACB.hADAMCFEXAGE..bDGB.cECAhACA......hADA...,2,-14,-13,1
YbSGJCZUNaRLDQgIMWdVfETBOAXKFePHc,FHAEeECBHFCC..bBEHGABA.CAHCUCFHNCHC.RDAD.QGGFhAAAMIEA..dADFEGAChABABGHGAIDCXACEhACAKFFE.cAGFSBAFaDAFDCDHIDDEhAAA..WFFD..hADA.fBBG.,2,-11,-1,10
PCQfOAabRBJEcMYeHdTgGUDFIZWKSXNVL,aAHFBBAB.JECHMCHB.HEFFdBHCGDDHDGBBZEBFKBAA..XFGFhAAALCDC.CAFEQEDChAAAOADGACDEECABeABGhADA......gGDHhABAIHHDNEAAfBFEhACA...,1,-3,-42,39
LdNXVObGfUEHWZTMPaDeYcSQJgKAIFRBC,RCCFCAFGLEDFdAAG..VFDGOCCEGADDEFFC.ZCFG..TBGDhAAAaGAG..DGHFeBAGhABASDAHQEAEhACAKHCAABBCIHGDBHAH.NEICXGAC.hACAfACH.hADA...,2,-23,-7,16
CUVDWTJSZXbMPAagLBcQORfKEGNYFHeId,aBGEBGCG.ODAHKFFAGEBAFFHD.HDFCdDGHUCDHDBAA..TBCEhAAAZABB..MFFDAAHALAEHhABAQECFfCAGhACAEBHH...NIDF.IBAACGAD.hADA.WEEDSHBGhAAA..,1,-18,-24,6
PWAUgRLYbQXVEdTOCefKHBcZMIJSaGDNF,UBBGRACDLFFBQGDFECFC.dDFD.CEEG.KDEFBBEBMGAC.SDHFhAAADFAFFECB.AFBC..hAAA...gGGDhABAXCAAOBEGeDABfHBB.hABA......hACA...,1,-25,-33,8
cLeUVGMAgRSTODYHENBPIQbdCWafKZXJF,SECEODCEDFHDHBFEEFFE.BCDC..QFAFCHAC.hAAAaCDGfFADhABAKGEDJHFGLAEAVFDEACACTABDhADAYDFA.IABAWHDA.FGCD.eAADhADAMAEC....hAIA...,1,-4,-30,26
OPHaMQdJTVeCEYfBKgcSNAWLGDXbUFRZI,LAAFDDCAUAECZEBGODBE.HFCGQGGDTAEG..eBGHhACACBDCEDAGBGFA.KHGGSDGDhAAAAGADXBCGFABHhACA.RFDA.aEACMAIDJDHDfHAFNAHC.hADA......hBAA...,1,0,-20,20
eMSLCXQTADcPabWIUfdKEGOYgZHRVFJNB,DGFFaABD.....IFAFdDABKDHHEFDDOCACZFABHFGD.RAGHFDDFhAAANEIC..BAAFMAFDhABALFEC.CDEAXGAAhACAAGFB.bAEA.....fBBDhADA.YEAChAEA,2,-32,-28,4
cTHUVYJKDXWMbBLOSaFAZRPfedgCENGQI,ZDADRDBBeAAECAEGGCGG..IAEEHECGUABB..JGCGXGBAhAAAMIFEBEEBLGFAhACAaAGG.AAFGdDDBEBGF..hAHANBIE............hAIA......hBAA...,1,-13,-31,18
bQNaWIATBdPYMKXeDFHGgROcVZECfSLUJ,dAGHMHBAKCBADAIFGFDB.RFAF.VCAEZACC...EFGBCAADLCHBhABA.UCEHQEDGhAAA.aFHFAEADBHDBhADAPACC.XBFAFGHD.....hAEAOFAB.SDFGhABA,2,-25,-17,8
aWGXBfcCdVTPDNLMSRgZAUYKebEIOJFHQ,UAECKBGEEGFDOCCC.HEEBaCEAGBBCBHBD.CEEB.dDHE.VAADhAAADIACMAAG.REGBAFDBeEBAhACA.JHCAFGAGXAGEhADA..fADH...hAHA......hBDA...,1,-16,-29,13
gHQcbZdJDVUAYSLfPaWITRNFBeXMECOGK,LBCEaEFA.TEACFCBEeBFE.MEIFODAA.KFGAHFAEhAAAQDEFbFDH.dAGDhAAADIAEACGESHDEhABAfGFFIECDBFDACCHA.cACAJHAC.YBADhABA...hACA...,2,-20,-6,14
PbDSENJTWICdfLGBaVAOcgKMYRZeFXQHU,OBDCKHEERCBEZAACFFGE.HAGDUFAD..DFAH.EEDEJEFA..TGEFhAAA..IBFFhABACCBBdFBHLACEBHDDACAH.hACAMDDA.eBADPFDE..NIAH...hABAfBHAaEGG.hAGA...,1,-5,-43,38
cWaCFGLDRbXSBMQeHdgfEIPUKYVZOANJT,JEDCTCDG..aDHHFFGD.LCBHDAEE.RFCC.SAGHhAAAMAHDeADEdBDA..EAAEUABChAIAKDFA.ZFDCABDDNDIA..hACACHHGXFBHQGAC......hAGA......hAIA...,2,-35,-10,25
gEJZOBCcKYLDRSFTPHGXIMNfQAdWaeVUb,aFFGeGDE.UDDCEHBAZAGHBEBC..CCFCKDBFDDHHFBCB..HBBCGGAFhAAAMDAH.QGEFhAAAAAFHdBGH...WEDChABA..gGGBOACA.YBADhABASGBC...hACA...,1,-10,-35,25
USBabHMWJgcNIOXYLDCFKRGdQVPAETeZf,EFGBTCBDZCAG..UAGGSEDCBHFGHFCHJFFF....NDAC.OABEhAAALCFAFEEGKBEHhABAdHBBQAABhABA.AFBHaEHBMEIFWBECcFAH..IHHGhADA.DGEB..hAEA...,2,-22,-20,2
QOeWfRPgcZVaEJdTYBbSXNHCUIKDALFMG,FGGEMAIBQFAC..eHAARBCD.PBEAZDFCaAEFdGDEBBAChAAAXGGACCAH.IDBHhAAAABEBOEEH..gCCBhABAEAGH.TDFBSHCGNCACKABADFFDhADAWHFGfGAFhAEA..,2,-33,-2,31
ECTJPHeRLUQIDWfZYSMgFGaNBcbdKVAXO,OGAGTCCH.HCBDLHCEUGFDDABGZEABSAFAFDFG.aGGGhAAANBBB.BEFC.dAECAAHECEAHhAAAeBACREFA.QCGBhABA.IHHAfHBFMDAD..hACA......hADA...,2,-31,-5,26
NTXLYWUBQgVdOCeaKAbPEIHGMFfcDSRZJ,EEDGGEFAFAFC.DBFCRAAC.ZDCF...JAAEXGDELCFE.UFAEhAAAQEAG.gCGDhAAAdFHACEEFKBDBAHEBIGHDhABA.MAIF.SCDAhADANAED.WHAGBDHG..hBDAOEGB.,1,-10,-22,12
UfFKMHYQTNVbRPAZBDSEGcXWIegCOdLaJ,BHABDCFDGGEF..XACBeCCHCAFGdEEDaFEB..UEBAFBAFMBIFhAAAQBAA.VAFEhAAAPHBE.ZCGHSHGEhABAEGAF.WDFGODAH..fFGDhAFA..hAIA...,2,-36,-13,23
NZeWJcGKLBOCdSfMXFUQbYPHAIERVTgDa,REBHTEAGDAHBZGFC..eHFC..JFFCGCAFBEAB.CBAAdAGA.MGDChAAAFCDB.QDEHhABA.PDHFAIEGICAGhAAAEAEBaHDG....NAIE.KGBB..SABGhACA.fAFEhADA,2,-52,-7,45
eOCGTRYcfbHdUWLMgJFaXIDVQPBZKEANS,SCAECGGBRCBH....fDHCbBEGHDGFdGAGLAGBhAAAMIDCFGDAaGBFDDADQDDFhAAAZABGAEFA.NABFeAFAhAGATFDH..cGGHWFHH...JDBFIBFEhABA.BEDC.hBAA...,1,5,-22,27
GeVHbXDKTERJSdfYOLagCMcUPWANQIFBZ,QFDCFCBBBACGZDDBeFHHHCGBDCBA.EADGRGFEdAFA..OAFAhAAALFBHCCFE.MAAFPDBChABAAAED.GCGG.hABAXGBF.KCADSAHB.hACA.aFFD....hBAA...,1,-9,-27,18
EGBTWKMSQfZLFIOcbXVNeYACRDagdHJUP,DBEDdACFJDEHUGGD.GDDHBAGG..KCCFQGAC.LAFGhAAAOCHD..XFAAhAAANBAA..AIDCCCBHaHGEhABAHFCE.EEHHMBBHSBBCFGEH..hABAIGGH.cBFHhAFAeCFE,1,-14,-54,40
HMWgDGAKUBIERcJFQCdbaPeVYOZfLSXNT,UGDHEFGHRBCE.FBFF..dEEH..aBBBeAHD.VFABOEBA.ZACBhAAALEAE.NEIC.hAAATEGGMACADHDCAHHFBFEFhABA.IBHB.JFAFCBAB....hACA......hAFA...,2,-34,-16,18
DEgdLJeZXIVBCWAHYNTUMQSGFOcPaRKfb,HFDFTCBGQBAC.FFGCOACEaBGERACD.bFDC..DEDHdEFDhAAALEBHeDABIAGFhABACHHDABGA.UCGBSAEChAAA....PFHDKEEE..hACA......hADA...,1,-12,-19,7
FAZHGTaYRdEVbXDcgWeKJQULBOfMCIPNS,HEFHaFCC.RBFGEAEC..VFGFDDCE.....gBAAhAAAKHAEUAAFLEHBBGAEMCEDhABAIGDHSHEGhACAAEABZDCGTBFEdADC.cDAE.eDFA.hABAOHAE.CAHAFAEGhADA...,1,-12,-14,2
GJYXKLPRDeMFZIaEcbWOVCgfASQTBdNUH,SEECTEEH.dFCGUDACGBAG.JAECKGBD.LBCAhAAADGGEMCCGIDDD.hAAAEGHBbGFCOHCC.hABA.CEHDAHAHQAGCNDED.YDFChABA.XGEE.hACAPACA.,2,-20,-6,14
CJDUEcTSZPYfgROHWKeGFaLVIQXMbdANB,CABCDEIHUGGEEGGH....SFBGZFAF..PADH..hAAAYBCCREDCHCECKHCEhAEAFAHHaFDA.LAAHhACAIAGBMEDCAIEABCBETGDBOAHDWAFH.hAFA..eCCF..hADA...,1,-21,-25,4
UIDCBdKHZNebELfcSFVPaWgXROTJMAYGQ,GDDBUFCGCCAH.dDHAHBFDZEABeAEALEAB..SBADhAAAFHGEaDCG.XGGHRDEB.hAAAJGDGMACCAIAG.IFHFhABABBBBKCDE..NIAD..EAGG..cAGDhABA..PBBAhAIA...,1,-14,-16,2
SaMfWBQgVRNJEHXDOLKcATebGdCIFPYUZ,TEGDeCEFGAAD.CAHA.FEAFUGDGZABASFCA.MCFAhAAAfGGBBDEBQGEEhACAVDABRCGFEHACDDDDhADA..OADAKHBGAAHHIHHCaDCF..hAEA......hAFA.WCCF.,2,-16,-7,9
BUSFVbEAdceXCDOZaLRfYPGJQKNHTMgWI,eFDGXEEFCDGE.DDGCZFAC.RBBH.....fAGHGAEGKGHDhAAATBBFMBIF.IFCAhAAABADFFBAB.EHAAAACCOFHHhABA.aAEHYHCGPFAFJHCE.hABA......hACA...,2,-23,-18,5
GONecPdQbaMYUFfVEZSRXWBAgJHCDKITL,JBAHHCDD.KGAGLFBCOADA.eHDAdHEB.QAGHaFGF.MDEEhAAAUAAG.FDGAEEEGSBFAhAHAXCCFAGGCDAIHhBAAIEHBTEBC.cGAD....hABA......hACA...,2,-24,-17,7
KgQAGadVFeZDBNPLERTSUWcHXJMOCbfIY,GDBFdGBFFAEBZCFEDFFABHGCLABFRAFG..UFAAHCCB.MEHDCAAD.hABA....IFFBhAAAKCDCACAFaCGHeBFA.hACANIEF.TFDH...SBCFhADAcDAC....OHAEhADA..,2,-38,-7,31
SGDfeFTNQgVALMCPKcHdaRJWOZXEIbBUY,CECAKBDGdFHCRBFH...OABAEFGHBFBF..SFEHDAGE.FBBHhAAATAAH.QDDDhAAAAEEEMAFB..PGAChAGAaADAJHBCZAGDIHHH...UCADhACA.fHEDhBDANIDB..,2,-40,-19,21
eBUcIdCWAQMJXHGYRaPFSVfKbgLDOEZTN,JAFDXFEEGEDARDDC...FGHH..VACCKCHDLCBBDBAB.hAAAEHBETCGE.BHABhABAIACFCGCCABGCMCCBhACAaDDB.....fEHAbFFB..hAFAOAABNBBG...hAGA...,1,-21,-29,8
NCSbPGWcEJdAIRaXZMBLKOgVTeQDHYUfF,aDDDMEGFBBCDLBEB.KEADOAHB..VGBEQADAhAAAHAAFUDCEFBAHCGDHSBGEhAAAGCFAEGHHAIAGIFHEhACAZDAEeGAADIEANIEH.......hADA......hAEA...,1,-11,-18,7
bZgJDUKFCefQGacIMHTXNSALORdWBEVPY,ODBFdFGDEBFC...VEDD..PDACZACEDCIBKHAC.FHECCHHD.QACEhAAA.aDGEhABAICACHDDF.TAGFhAAASFAEADHHRGAGBGHE.....hACA....YDDChABA.,2,-41,-10,31
IaYLRMDeTQCFWHcVXKSONdAgEGZUbBPJf,EFBGUABEBBCE..JDDDaEABLBGH.RFEF.eEFA.CHCEFAHBhAAAHFAH.XADEhAAAKCEAOGEAAHHA.ZCAA..hABAfCFAIHHCDGBDWCHH..SEEChACAdEAF...hAEA...,1,-24,-27,3
TXVPIYGALRgFaDfZEbdJQeScWMHKNUBOC,LEBGFAFDDCBAZEFGEGHF.dACA..eFAFSAFAMIDC.KGDGBECHhAAACFGH...XADBhABAICHDAIBAaCGEJFAFQCDHhAAA..WEEFUBACTGGAhACA.....hABAYDBE.,1,-16,-31,15
RBVPMOAFKdgWCZDaXNJQcGHETeSLYbfUI,dGGCCDFDDIBAaACA....JFBCQGCA.GCEDHADATAAFhAAALDBB.fBCDhAAAIHEFVFGHhACAOAFC.KFECZAGHNBAEEHAG.SFHHhABAbDACBEEDAAIF.FCCCXDDChAFA..,1,7,-24,31
PDTFaGEMNOQZYWIbdCVBJKHUgcLXRAefS,SADEDEBGFACBGGAFEECE...MIDEQEEGZFGF.IBDGhAAACFEHBDFHKAFCHCGDUBFDhAAALHBE.AGHDfCAHhABAaBAF....NAEG.WGAChACA......hAGA...,1,-23,-29,6
YUAMVDPcROaSZbfgJHNWLBTEeXIdFQCGK,DEAHRCFDOAFAZCFD......gADANCACBBAB.EHAEeDHHhAAAdFDAFHGCGDBH.KHDChABAADEGMCCD.PCHFhAAASCCE.fGGEWABF.LFBHhACA...hADA...,2,-34,-18,16
LPeAVMJaKHUgOIWGYdTFNRcQECZDSBXbf,JFCAKEGFUGCC..OCHBGAGGdBADFBBERAEB...QDDBhAAACEACZGEE.BHHE.XAEGhABAfCDGLDABhACAAFIB.MFFHaHAG..IAGD.hADA......hAFAWAAE.,2,-52,-13,39
MJRZLWAYfDcXHKFeCVBaObPgSdEUIGNTQ,DCAGXCAGKAFH.FGGFeFAD.BEHAOEBF....PFGBhAAAgGDE.EAHBhAAAIDCATDDHMBAEhABAJDFGLFCHAFGE.fADACGAEVBEC.hACAaEEH.SABChAFA..,2,-33,-20,13
PXZMcgWFaRHdNSTCQIYfJVBKAeUEDLObG,eEGBDDIFLECDGAEGZGDCMEAH....gCAFaFGCHAAEdEEChAAATACCCHHA.IHBDhAAAfBEEBDDAACDHOHAChACAbBGF.XBFB.FHECSGAFhABA...hADA...,1,-5,-18,13
PcZOMIJeQbDERNTAaXVKLdFCgYSWHBfGU,VEDAdECBCAAC....SAEHBDBFGGBBUGBHZCFA.MDAFJFFH.hACAQABG.hADADBFENEAEAGEFaGGC.KEBHFBCBhAEA.....gCGA..hAGA......hAHA...,1,-22,-42,20
SINgCeVZfWXbRTEKcQYPMOJGFAHLaBDUd,aEEEBBAH.DEEFUGADdBGH...SCDC..gFBAhAAACBGFeDBGZFDCXCBDhABATAAG.KHDA.QGFBhACAPHDCMAECOADGJDHDAADHIDHFhAHA.fCFEhAIAWCAD.EBDBcBGD,1,-13,-38,25
OYCJfWVMcEDARKILZHXQSBFGTPaUeNdbg,RCFGLGAGZDCAHBCGQGGABGFFFHBEGDAEaCDG..eHCAdGHAOACGhAAACCGGJBAB..VDBFhAAAEHFCDBAFAGFC.KAHFSEGAhABA.PAFC....hACA......hADA...,1,-12,-17,5
YUFGdKZeRDBTOXLHcPbaVQNgWSICMEAfJ,JCEDFBGAdDDAZFAB.DGAHBHDA..ODHBLGCCHACA....hAAAPAAAaCCHQGEHhABA..gAFGhAEAWCAF.IDHFECFHAEGD..fFCEhACAUGGF..KBCHhAGA...,2,-39,-20,19
NZJPSfFHUVBQacXRDLdOECgKMITYebGWA,JAEASDDDHBCCUDDHQGDB.aHAARGCCdHGF.OBBHhAAAgBEHKCGH.TAAHhAAA.eBGH.WDABhACAAAIDNCAA.ZEGDFFGCBCCCDABACHABMAFG...hAHA......hBAA...,2,-22,2,24
dDGANVSZLTgCeEJUXIBRKPQcHOaYFMbWf,VEGHZABCLFDF.CBFA.eFAGUGAGBEED.KGEGQGGHhAAAOADAFCDAMFFG..hACAfABEDDEGAEAASCCDhADAEAGA.IAHFPBHFaCFD.bCAGhAAAdCHE.....hACA...,2,-25,-19,6
KDCBELbgTaPWdGJXcUYfZVNIASORQFHMe,SHECOBAHRFAHHCEEeFEC..CAFHLFFCTFAC..aDHFdCHAhAAAJCDGXGCA.hAAAUCCCfAEFhABA.ZCBHIGGFFAHDMCADDBCEBABA.EHGAhADA......hAEA...,1,-13,-14,1
UIdLgGacAKYSJQfHVeEBDRCTNPFbZXOMW,KAEBSEFBQDBGHBEC.ECDDBAGBCHEG.TGDGFFADZFBDMEEGhAAAUCAALCHB.hAAAaHGGAHHHfABBhADADEABNDDD.PDHHOBAAdAFBcGBH..hABA.YFFA.hAEA...,1,-8,-11,3
PWcHbNUMGDCLFKOfJASXZdETVYeIagBQR,XEEFEFDC..TCAEeAFA..aGAEQFAERCAF.PAEDhAAAHDCBbAACUGFDMHDGhABACCGBKDCBJCEGAEHAdACEIHHHhACABHAD...NBIA.DICCOADG.SEGHhCCA..hCDA...,1,-1,-16,15
WEZcDQYfbRVIUAPTOLNBaGJMeSdFXCKgH,TBCAOEBDLBBA.BHBGJHAGSBGBFHGAKAHB.HFFBhAAAZFFGDIEAQCEHhABA.bFBAIDAEhAAAAAFFPEAEGDDGMFIFdBBGCBFEgDGChABAWAHB.EACC....hACA...,1,6,-24,30
NWRgGfMKTaJeLEVbOUPASXIQHYdZCBDFc,SAGHQFDHdGHCBCAFDCGDFCCD....NBFE.RFFCGAAFhAAA.KGBAaBAEeEDCEHBEOAEAhAAAAICAHDABCHHEgDAHhABAMBIB.JADHbAEH..PAHFIHEAhABA.....hACA...,1,-1,-24,23
GfUNJBXEgeIcRCOMSYbHLdTVDPAZWKQFa,KDBAQEBHFDFAGDDGUBCABADD..EDHFeDHHRBAF..MFADhAAASAGCHGFGTEEHhABADFGBAAAAZFACaCGGNACBJABB.hAHA...XGBDIHBECHDB...YBFGhAEA...hAIA...,2,-26,-2,24
DIBUYMLJRTZOGXSdQVFfEcbPCWeagAKHN,KGFEHABADCFBBAHA.UGGCLDDDRDDHZCGFGGBFSABC.QAFEhAAAFBAHEEAH..hAEA.PFADCFBA.eEFChAFAAAAGIDCHMECFJHDAXAEBdBCF..hADA......hAHA...,1,-12,-16,4
aObeDUIKZCNWMBXAYQJHfLcPERSGTFdgV,JABALFDH.EFCDSGGHGBGAdAFG..aCEHeBAD.DGHBhAAAKDHDZBCHCHAD.MFGFAGBFQGEBhAAA.HDCFhAEA..PEAHFHCCOAFC...hABA......hACA...,2,-26,-16,10
GNedUQTPABCLgFEJZXKVcHIafMSbDROWY,BCBECFBCFEGA.EDGGZCDDKEDA..HFEB..aEGCSABGDAAD.hABAOAEGGBDBdCGBQEBEhACAAHDDLCAE.hADAXGGDIAGEfDAAMFAF..hAAA......hACA...,2,-31,-25,6
NYQCcRKJDBMXbGdPASIWaefOEVgLFHZUT,SDDFaDDH.OGFEEAAFLDBH.HDGBTFAENDACCGEA.hAAARCFHDADHBBHHMABFGBEEhACAAAAHeAED..fGCFhADAFHCA.UGGFcEECKHAA.JAFAdBCFhAEA......hAFA...,2,-15,1,16
HWcBUPFVeObJCLGAfMQXYNdaEDgISTKZR,MDCBXECHdHAFDDIB..SBBFZBAGRDDE.HBFCBFDHFGFGeBGDhAAAOCEH.CAACAIDAQGFEhABAaADA.IFAGhACATGAEKDHH.WCADPAEF..hADA......hAEA...,2,-27,-15,12
bNITUYKECPdFZaVLWfMJGHBgAecODSRXQ,eBDCDCBDRAFG.QEFA..ICFHTDDBKGADEHAEdFEAFCBDaDHDhAAALECH.MIFEhAAAJFCFBABHAEGA.OAFAhABASBAF.NAEECGHGZBFE.fEAEhADA....hAEA...,1,-11,-28,17
XbPTBGINaYZHKAfOUJRWdSLEVFgQcCMeD,UBDFREFDdGBALBABFGBH..QFGDCADHDAFD...XCAEhAAATECCBGDAGAGChABA.IEAEaAGDHCCChAAAADIBJEDBSHDA....EABH.hABAcGDD.MIFEhADAeBHH..,2,-26,-18,8
afDQMbgUJYPEXBWdGKOLReAVZCFSNITHc,ZGFASCDH..NCEGHADCaDBG.QCFDMACGUBFDJCAGEGAEhAAABABBdEFFGGDBhABA.KBBCLHAEhAAAAGGACHAD.IEACTEBDDGIHgAGB.hAGAPFFG...hAHA...,2,-13,-12,1
DNOQLYfBZAGXSRaIgFKJMeUPdTCVbcWHE,SBECaFEA.FFCCKCBA.MBIFUFECdFHGCBGH...VFCH.hAAA.bFAHHADH.DBGHhAAAQBBCfABAhABAADEAXGGDIFAC.eCHH..PHEChADAWCAFNABFODECBAHB.hAGA...,2,-28,-9,19
cdQIJXEWgCAGFZaNHDVURSMfLKObYBTeP,GBADFGDAZCFGHACDDIBERBGH.MIEAKGFG...OBFABGECeFAC.hAAAdAFGIECG.hAAAEGGACEDEAHABaHAE.NCAC.SHGAhABALABD..TEFG...hACA......hADA...,2,-38,-2,36
RICJUeMFTYXZHbVLWcBSdNfDQKGOgaAEP,EEEDRACCCFGB.UAFF..eCEAMHEGFDHF....XBBBZCAHHFEBhAAAVGAALGAC.hAAABHHGNAIGDBEDKCCDOBABhABAAIBE..JAFATDFB...YEAGhACA...WHFAhADA..,1,-12,-27,15
QCUEcILSPbAFdGZTKYHDWfXVeOMNgBRaJ,dGFBZACCKHBCDECH....XBBEOEGFMAEABAEC..RBEG.aCCHQGAChAAA.EEDAhABALDFC.SGEAhAAAADEGFEGE.YDAFfDAGNABACAHH.hADAIHDF..hACAbDDD..,2,-38,-25,13
CUSBIGREdXTDOcZKfgLaPNVeAMbQFHJYW,QDAHJBHF.CAGHBGGDIABE.GDEGEEEBdCDH.DGIDOEAEhAAAKAAF.LADGhAEAaDHB...NEHCACDHFADEhABA.HGCC.UGAGSGCC..hAFA......hAHA...,1,-19,-38,19
LGcORZADHEMgaJUNfbdKPTFXCeSVQIBWY,EFGEaEFC.UFBC....NHAH.dBDCKAGFFEEG.eDAESBCBhAAA.QEAFhABAIBBGBAHELDEDOBEChAAAABEADADEMIFEgDGE.fGHEhACAPGDACFAD....hAHA...,1,-25,-30,5
OZBEGIaCYJUXgRbALWdTPcKfeVMHFQDNS,LDBDdBDH.TEFDKCHBeBBH.HFEBFGHHDADGSAGFhAAABDDEEABFaEAE..CECGUAGEhAAAXDDGRGDG.AIHCPHBEhABA...fAHCMDIBNBAA.OACAhBAA.IEGEhBBA..,2,-28,-6,22
ZNEWKJAfVIRCdFaDGSQTbHMULcBYePgXO,VDBDCDDAFEFA..GGDDQEFDHEADLBCEBEHE..PAGHhAAAOCHFZDDDEAHFKADHADAF.hAAARBAC.aHACDIDC.SGHHhABAMABG...cFAH..eBBDhAFANHDD.WAGF.IFDChBAA,2,-25,-3,22
IgQEKNMXDUPBTGZHLCFeYAbSWVdRcfaOJ,SGDDVFBA.dEFHRCDC..aGFAJCDH..QCBEKABG.hAAAMIEEDFIDBFBAGACBhAAALGEACBHFFHACeEFChABAbAEC....fDAB.IHAFhABAEDAB....hADA...,2,-45,-2,43
bdCfgGIUKABNOZWMRSeEXFHLQJYDcaTPV,OECAMDFCRCCD...SHAEEEFBHFAHJCADDABC....TFGChAAAPAAAdAGG.CDHCGBBFhAEAKHFGBEHEZFBCeFHBhAEAXGEDQGCHaDFF.fAHChAFA......hAGA...,2,-14,-13,1
COWFQNKLXVbdGSUZeMJTDIYcPgaEARHBf,HEEFCHDDFAFB.KHDGLBHB..XDGGdDECUEBFeBCE.TGBDhAAADACB..IHGEhAAAYBAH.gAFGhABAAADEBFGD.fDCFOBAB..WFHBhABANEAG.....hACA...,1,-22,-42,20
KXLcBVQeNCdMSJYaEbIFZWgGDOfRHUTAP,KFDEXFAABDCB..QEAHCADE.dACDJCED.aCAGEHECFHFAZDGBhAAA.GBDHOAAEHGBGhABAAIBALDHH.hADAeBFG.SGDHIHHGDBGCfDGGhAAA....hABA...,1,-13,-31,18
UIcWgAeXDMGYQdVaBRTCZKNJPLOEFfbHS,XGDFDDABMHDGGBDDdCDGBBFH..CDDDZCAH..NADH.LFGHhAAAOAAD.EFEGFHBAHABDhABAUDFE..IHBDhADAgGGHAGAAeAHB..QEBChAAAaDFE.KAHB....hACA...,2,-27,1,28
SGTJUHdXWNEZCBeRPVgcQIYLKFaOMbDfA,TADBJACAHEDA.dFHE..XGCBEBHFZBDGBHBARCFA..VFGHhAAAQBAALDAGKGEHhAAAFBBBMFAHDBGEAGFDSDGGhABAWFAH.CGGC.PEDC....hABA......hACA...,2,-18,-13,5
DOMRJcAWGIQZgYbfHBFKXdENULPaTSVCe,GFDFZDAC..bEFCBDAG.XAFCEGCBUAGGLBCB.hAAAPHCESGBDhABAeBHHDAABMDCA.cGGChACAAFDEQGAB.fCFHKACAaBDECDGC.hAEA......hAFA...,1,-14,-21,7
GTdBMHFZcPVYNeEWOLgXKSCUADfRJQbIa,REDGQGGG.aFGAdHGB.MGBAFAEEZCDHVABD..eACFECFALAFAhAAAKDFESAABhACAADIFDDAF.JHAG.IEAFhAEABEBGPHAG..YGCC.hABAWAHB....hBAA...,2,-24,-22,2
LdDaIXFBYHOPNGRQKVACfcgWbSeTUJZEM,CAGG..fBFD..WCEBeFDCUEGAEADBdEAA.DDDCXFADhAAABBABODEEhAAAGEDCKCBBAIAC..bABBSHBGhABA.JHFAMBDHIAHF.hAEAYDHB..hACA...,2,-33,-25,8
FbINRGZJUdHPQALECWfSaKMBcODTYeXVg,EHCCCFHD..SGEDaDCEBAFA.DECH..TBCAeCAB..VAEGhAAAFAHB..IABGhAAARABFZDEEJHAGUGFB.PEAHhADAAHHE.LEFGKFFHMDDBcCGDOEAHXFCChAEA...hABA...,1,-6,-21,15
GHUWcaSLATgBNPZOXMYbVJFDKQfCEIdRe,TCCFBDGAZCEB.OBBDMBFC....VDFDDHAAQAGBhAAA.CAED.dEAGeHFEhABAHAACUGDEaFCAAHIH.PHDAhAAA.XGAA..YDAFhACA...FDDBKCEEhABA...,1,-17,-24,7
LHOXTBbKRSdaQMYEJVNIPgfWCeFDcGAZU,LDECXGBFBHEHRDABdBCE..QAFHMFFCEBAF...JFFGNAHA.hAAA..IGCFhAAA..PDCGfHABhABACGHFFBDCDAEEAEFA........hABA......hACA...,1,-24,-37,13
cVCDUaeFMBREKNJXPWSbQgYLfITdHAGZO,OFGDCGAADBIB.UCABFDCA.BGAB..KBBA..XBFCSEFGhAAAQGDALAGBhABATECAAFCFZGEAaFCDeAFGhAAA..RAEH.JABA.WHAG...gCGAhAEAfCAE..hACA...,1,-15,-42,27
HOZQBKgYbDdeIcCEGTRNVWALUJXSMfFPa,JCCAXGAE..MFFDFBEHHCBDZAFCBHCDKGFC....bDFAdEGGhAAA.eCADCEAH.EFCETGDBhAAA.RAGFNACDAEIBSGAChABA.fGHAaBBAOHFEgABChAEADFFC..hAGA...,2,-40,-1,39
cOXRLfFKaCABQMJbdPNZYHVUSgWITeGDE,MEIFdFEDZFCHHAGBUCEDSEAF..IEAHTFBAeHEEhAAADABG.OCEBLCHBhAAAFADBCBFFABCEBHHGJABDNIAD.hABA...VDFH..gGAFhAEA.ECCH....hAFA...,1,10,-41,51
FPKAZIHOXCfeTLGSYJDNcRBEgWbUaMdQV,ZGFEHEABOCAHXADC.eAHBGCBBJHDC.DAGFRDFB.BABD.EHAChAAAbCDDUECD.dDGF.hAAAFAHDKGHH.ACHFIBABhABACFFG.TCBC.SAEEhACA......hAIA...,2,-27,-7,20
OGSgTEcUNaHQYRWIBXMDeZPbFCLAKdVJf,dHFBVBFEOAHB.GEBATDDF.UAADaDEDHBAC.RBDHBAADhABAMDAADGEH.PGAAhABACDAAAFGDJEHF..gFGDhADAEGAD.NAED...WAFBeFFD..hBDA.FEBC.KDHBSGEFhACA,1,-9,-17,8
ZUTdXBeWKDFAOYQfJNLRcVIbMaCPHESgG,QGCEJBDGLFECRDEF....VCAGMFAFCFBB.HBGF.EGCHSGAFhAAAGCAETGEFhAAAdGHGBAFBKACCABABYACAhABA..fCCEIHFGaBHF.hABA......hAFA...,1,-17,-19,2
GNLHXSAbRUZTagJVBPQCcKEIFOWDYMdef,REDDTEDB..JBACBFHGCFBH.KFBGFGCDDIBE..dDDFGADBLAFChAAAHAAD.ADHHbCDCaDAC.hABA....gGFBhAAAPGFE.EEAAOBFCMAID..NHAD.SACEhBDA..hBHA...,2,-37,-5,32
aZQKdgBWMFICETLcYPeOfANGJbSHDXUVR,GBAEJHBCHADGDFFCUDDARGDGZACA..dGFABCGCFCAE...EDEHLAHBhAAA..cFAEhAAAPEHB..OAFAhABA.ADDG.SBACXDGAaGGFQEAHhABA....hACA...,1,-20,-23,3
AMHDQFROgCSdTGbZEUNcWKYLeIaJBVfPX,DEFHFDGARFADOCCC..SEDFGDAGEABDUACD..NIEF.KFFDhAAALCGFeDDEaHGEJAEChAAA.BHDF..fAFEhABAAHAHMBIHgFCCCGHFdAHC...hADA......hAGA...,1,-19,-28,9
ZVIfLcXNYAHMeBGdCaJWbFQEKgROUSTDP,eBCAdEEGaAGF..JHCGFAADKGHB..RFAEUDAFDAGFZAGD....VBDAhAAALAAH.XEEDhACAAHFCMEIHCGGBQDBDhADA.OCHD.SFAAhAEAIHDFcDFE.hAFA...,1,-28,-31,3
PEVBTHFLWJfZcXDGbaMAdIgKOeRCSQUYN,dDGHKADDOEEGeGBGCEEH...UFGD..NBED.EHDABGGFHECDLFAFhAAAJABB.ZCAGDHAA.hABAaCGEAFCG...ICEGhAAASCEC..QAGCYFHBTABAhADAFEAB...hABA..WHCA,2,-25,-23,2
BIcFfNUDHSXLJQaKMARgVCZYOWbTEePdG,REDBCHGDZEDFOBCG....TCGCEDGAeHFCdCFGBAFAFHAG.UBCChAAADAFCHAAFLFFCJBFBQEAFhAAAKFAE.hABAAEIH.gCAF.....WHAAhACA.....hACA...,1,-20,-25,5
bdcNIHUZCLgJEeBXRFfQAGSDWKPaVMYTO,GDBGSGDGKBAC..aCCFVCCA.MCBBOBEH.dFGBIFGFhAAAZAGHCDAF.LBGBhABAEGDCBHGDREBFFACE.AAHCDIBGhACAPFAB.........hAFA......hAGA...,2,-25,-22,3
eOHgXUTfIZSKVCbFLJMNGdPBWEQAcDRaY,DEIHREDAeFCBHEEA.UEBG..IABAZACFSBHFCHGBLDADhAAAMAEEdEHC.BHBAEAADAGGHhABAaCEE..OBFDhAIAgBCH.fBHG.KGEBFHEChBCA......hBEA...,2,-22,-17,5
UVAQYPHZbEfcedMDRJOFIaSgBNLGTCKWX,QABAHFACEAABeDEGDEFFRGCCFDAC..aHGASFGE.BGGGhABANDEDGEAGKHCAUACDhADAAIFEZAFC..bBFAcDBAhAAAMEEF..IHAH.....hABA......hAEA...,2,-25,0,25
POgMFcQKaYeDNBRCGVdEIWHXUAJTZLbSf,ZAFBSGEGOBBCFCHHQCEG.aHBGDABC.REFH.GABEhAAAdFBAEEDEIAFH.hAAAXDGDADDGJFHB.TEAEhABA.fAHAMIACKADA.NIDFBGGBhADACAHH.....WDDFhAEA..,2,-34,5,39
WdDTKBHZROSeCfPXGaNYbJAcFIVELQUgM,FCACVBCFLHAE.UEFBMDGF.DFEDBHHERGAA.eCECCBFE..hAAA.XEBFaFHH.hAAA...YBAHhABAAEIDEAGGQABEdEADKAGEOHECSGEGhABA.fAEChAEANCIA...,2,-31,-19,12
IBcLKeAVZagCfQRUSWEbDGPFMJOTHNYXd,VDBFaGFC..CHCF.QAGGUCBG.ECAHGDDC.MBFDJEEEOHFEhAAAHBGH..NAADdAGFhAFABGBG.KDDCAIFE.gGDHhABASGGEWACGDDGH.....hBAA......hBBA...,1,-20,-21,1
YcAIeOgQZSCBXMKWLDRdFaPVUTNJHbEfG,OADGQCCGZCBABFGAKAEHDGGE..FDFAaGCFUGCC..TDFEhAAAHFEBEAHBGBAAABGB.hAAAICHGeBBGCHHB.XFDFhABAMFBF.WHFG.dGAGNBAC....hACA.fACFhAGA...,1,-16,-22,6
LJWgQTEcMDSBdIaUfGXPNeVFHYRCKbOAZ,LCCCJFDE.QGBETBCE.MAFGDAAHBHDFdEHG.UFABhABAfABHGCEF.XDDGhAAAeBFEFFHHHGDEhABARCAHKHAGADBFZAEC.EEFHSGGDIHHF..hACA.NADHCHEA....hAIA...,1,5,-16,21
gcDKOaWIBTQCUEPYVLdReMHfAZbJFGXNS,JAEHFBCDGEEE..XDCGSFAGDGFA.KCFB..OBAChAAAIEBHBAGACGHCEAEChAAAVGCC..dHBHeDAHhABAfAHGABIHZEFC.gBAFaCGDQGAAhACAPCHH....hABA...,1,-17,-28,11
WeXgFZSGIcTdOfPEaYDQVCBKbJAUHMLNR,UGGFHGFCMEAHLECBRCEH.eDCEFBBGZGBGGBGG..TBGEhAAAdAACOBDEEBDH.aADGDABEhAEACAGC.BFBA.KEDFAGFDNEBChACA.....WFDHSFGE.hAIA......hBBA...,2,-19,-11,8
gIGJTcRCDZSBNYHOUfELXKQdWbPFMAaeV,aCDCeEAD...VDDBIABFGBAG..TFCECGEADDHBBHGBhAAAHDAHOEECUACFEFCDXADBhAAA.dGGD.hABAWHEGPAHFACHE..JAFE...cCFAhBAASGGE..hADA...,1,-6,-26,20
ATNHcOgBeJDbYZQWLFEaKMUfVISXCGPdR,HGACOFFEBBACDAGEZDDCQFFE.LDECEAEGMFCAUDBGhAAA.IBCECBHFdGDATBBGhAAA..NAIAgAFEhABAeDADJCEC.WFEFKDHBSABEhBAA.....hACA...,2,-22,-15,7
KDdWRMABFOTPZXHGVUegQCfabJLYSEcNI,FAGGODHFZGFCHDEAGCCCUGCCeADC.CAAG.aBCGLFBH.EHDEhABAIECAKCAF.DDCAhAAAdFFGMABHTAGHXBGAhACAVBEBQGGC..JEAB.hACASAEB.hADA...,2,-15,3,18
EHfLOYDcXJbGZBFATRVKCQNPMSWaIgUed,TAGERACGCHHF..QGABMDEC..SBCDaGEA.gECGhAAAUDFGEAFEHBAFhAAALABCDICEXDCEhABAJEHFGGAFBEHBAFAEKFFBWEAGdBDD....hACA......hAEA...,1,-3,-20,17
HMecKXbIZOLdNDaYgWSGAERUTPfBCJFVQ,UFGETFDHBBFE.FGAEQGAD.MACBeDAEKAGDXGEHhAAAIHFC.ODAHhAAALAGBdDDBDBIFaACB.hABAgGGBSDDEEBDCfEADhAEACHDGHCGF..ZBAFNAIG...hAFA.WFCHAFCF,2,-25,1,26
HXUbVQGBTafcLPIJWOFNMgYDSeKECdARZ,RFCAHECCUAFBVBDGGBAGBFAF...aGHDLDEA.PFHBhAAAIGBC.OAAChAAAMICEDAIDeHEAKACBECABhACAAEAD.XDGEQGACfAHA.hABAWHAG....hADA...,1,-13,-21,8
VWeYcNSRGJbTOHUAaECfMFIQPZdLgDKXB,EBBFMDCGFFCC..QGFHdEFALAHDDFGEBGDFeADH...NACH.hAAASDEFGBEFTEBGhABAHGAAAGHC.CABFIEHDhAAAPBBGKHAC.XEEBWAFB..RDAC.hADA......hBAA...,2,-14,-13,1
ALXWMOeJEDfaUHBTPYCdGKRgcSFVbNZIQ,LHCGMFCE.OCCHeCGHJCCCDDDGUABHHADGBHHG..TFFDhAAACAGBKCAA..RGCE.SFEFhACAFFGE.NEAAZBFDhAEAIAAB.XEAHfDHC.hACAaEBH.....hADA...,1,-17,-28,11
EHAcXQPFCNMIBZSVYGbDgOWaKJLTRUfed,QBCACGCF.MFHHBEGBZAFHSABCGDAGDEEHOCEChAAAKGFFLECHTEECRCCB.hAAAeAEGEAHBACAD..XGGBhAGANDIE.IHAAYABE...hAHA.WCBDaHCE.fHCFhAIA,1,-19,-26,7
GOSEMIVZRUAbWBcTCKDQgdJNYHFLfXePa,BDCECACCDCHH.QFCB.dGAEJBDDHAAHFGEALEFAeBEEaAHFGDFChAAA.EHGAMAFFhAAA.ZEAAAEHEWCADhACATGAEKCEF....NICF.fHDHhADA..OABH.hAEAIHHF.,1,7,-38,45
QZLFePVKWdADHTgbBOSRMEUNCJfXaIYGc,DDCEHAGH.TFCBBBHCSFHDMAAB.UEAGNAEC..CGEHJEFAhABAaGFH.GDAEZDFGeAFFhAAAKHGEABBB..OBAAhABAECCF.XECA.IHDG..hACA......hADA...,2,-33,-11,22
FKMQBaXPfENJHRGSTgDdbeYLcIUCAZOVW,OGBEVCEF.KADAMBIBBCCB....XFBHEEEEHAGFRADC.GCAEhAAASAGBDEIFdGGEhABAeBAH.LFGBhAAA.cEAGCAFBAIDA.WDCB...aHEGhABAfABF.hACA...,2,-28,-17,11
GDcAKMFIPJENZBXTQfLSdVYabHOWRgeCU,KHAEFFGH..JAAEZGEA.BFGB.QEBGSEAHdBCB..aCGGhAAAOEDGRFCB.eAFChAAAGDCFAFIB.MBDEIBAChABANEIA..fHADLCDG.YAFChAEA..WDAFhACACCCGDFFD..,2,-34,-19,15
ZWNEYJgALXBDfcTCPGebKRMHSVIUOQadF,XABHBDCHDEFF....TAAACFHEGGCHKGAD.RDAEMCGFHCFCSAEDhAAAUAFH.aHGGhACAFEDEZFBDEADB.YBHBhAAAAGEBLAFG.fDAHcGGAeGAChABAIFHC...hAEA...,1,-12,-17,5
BVXDPSNLWCUfHZbaAQOdcFTYRJMgeKEIG,dBACFEDDRAGFJHBA..MECBKEFE..GCBGBDDCDCAD..SEHHhAAALABEUGGGHBFGZDDDhABAAICE.OHFC.hAAA.TGEGgAECICBBPEAHNAFE.hAGACFFG..aBCF...hAIA...,1,1,-39,40
BFRcKSfWdUDaYQEVXGAHbeJITPgZNMOCL,eCBDJCAF...ICHDTBBG..ZEEHMGCELDDDREEG.KHGGhAAASGABdGAF.hABADIFCaEHDQACGhAAAECFGXAFEAEDGPAFGNIBD.BGHB.fDFBhABA...hACA...,1,-17,-23,6
LWMFJaRCcNeTYVPABDKEfQgIdXOSbGZHU,BHDCEGDE.QAFBdBDGOFFEGCBEHEAFLABBFADBRDDH.CAHCeCHBhAAATFFB..PCFBhADAAAADDAIFKGAD.gBAFhABASECE.......hACA......hAGA...,2,-22,-10,12
SOIEBWLPaGUfdJFQCgVXTNbcAZMKDReHY,ZFFHMFDBKCEFRADC.HGBE.OAFDBAGBLCFFGABF.dEAHFAHDCCCG.hAAA..VCABTGGHhABA..NDIC.AIEEDGEG.hAAASCABWFADaGEF.fEHE.hABAQCGDXDFE.hACAeABC.,1,1,-30,31
PBfgMFJEcZKLdSNCTHOWAIbYRQUXeGDaV,..IHEDbBGH.RBBF.QFGG.XDCADFFEaDAHBGGFhAAA.MGBEJCBEEBFHhAAAKBEBSEEChABACBAHODABAAHCYFBFeAGDPHAGfGDH.hACAFABA.....hADA...,2,-33,-4,29
QgJRSIEbKUeGDaNYBFZHTfVPCXcOdMAWL,QDCFJAHD.RGAG.EDGBUGGGGCAEDAAH.aDDDBADA.ZAFGTFEAhAAA..fCAHhABACHHBXACCdEGDAGCBLHAAhABASFACIAFHeHDCFCGG..hACA......hADA...,2,-18,-18,0
MIgSAPCYTGEfWUFVNJaZDLbOXcHRBQdeK,CFFAGEAE.EEEAUDFDFGDG.JADDDADA.LBBC..OAFGhAAAXAFEHDADBDDDhAAAdABAMCFASFHHhABAAHHA.PHECTGDDfCEH.WCCDhACAaEDBbFBH...hAGA...,2,-26,-24,2
KOGWUZdCRgQTNfcLJEXBeHPaSAMDYIVbF,MEGHDDCC..VAEGFBEFODBBGEAFUACEZGAA..CABB.RFFF.QEDDhAAA..NAIGLHAAhAAAEHEGBBCAeAFEhADAaBAFAGEH...bCGFKDGH......hABA......hAHA...,1,-18,-21,3
TDCHSgWPMUQKIbLAEaOGXFRZeNBJfYVdc,ODFAGCEEFAHFZADABDED..JBCF..VGEEdCAGDFBAHEAFSHCAhAAA..hABAPABDMHFAKGAHIAHHhAAAACGH.EECDaDGDXEGA.NBAE..hACAfHCB.hADA...,1,-14,-36,22
EWQAbTaISOBCeXNLMHRcGVFgYJZDKPfUd,aCGGSBGGBEGA.CHBE.eDABLFCGHCCGRAAEGABDFAGE.JHDCDFIBhAAAKDEAUGEB.dFCAEEAAhAAAACAG...TGGEhABA.IAHG.OCACMFAH...hACA......hADA...,2,-21,-12,9
CEOgWTBcMDPQZeXUALdGbVJaNKIHSYFfR,GBEBVCFB.JFECKFCBHFBF..FFHHCBDC.EBABOCBH..TGAAhAAABDEHDIDEZAEGUDCHhABAAHFGLDDD.dBABhAAAaDAH.SHCAfAGB...WEHHhABA.MEAHeFFD.hACA..NAIA,2,-21,-20,1
KGLVHMfbYJNdQBUDReWESaAcXCPIgTFZO,XGBHCHEF..IFBCFHFAZBGDKADFGBCBLCBGHEGBMABGhAAA..fGAChAAAbDDE.JAFBNAIGBAFFhAHADGFEeEEFSHBCAFADPEAGOBBHdBAB.hABA......hACA...,2,-13,-12,1
OXUbeLFdcSTYPgCQDVZKNEMIfWHAJaGRB,aFAERBDGBDGH.UAAGeGBA.dBFB..SFGHTBAB..PEFChAAACDBF..DAGG.hABAKEEGNEBBMDFE.IADChACAHFAFAADCOGDGXGGA..FDDB.hAFA......hAGA...,1,-23,-38,15
SUdaeFgXTNHZCKIJLPVDYEAROGfBcWMbQ,OCAHGDCFBDAD.MDHBSDHF.dGFCFBCBXGAHhAAATGFFHFBAKFBCIGDBhABALHAADFEAABFDfAAHhAAAbBDB.aAGCeABHNEIC.CDCHJAGB.hADA......hAEA...,1,-13,-17,4
THRNVZWKELPFMdAYXJBUScOaeQgGDIbCf,XDEHUECEOCAE..aDAEQBFFGGBHDGIFCFGH..HGAEhAAAVAGH.ZBBGEGFBLFAFhAAAMAIHAAGEBHHGSFGHhABAgACEIDDEfEFHNACH.hAIAKHDG.FEAB...hBAA...,2,-9,-2,7
CEdKBDQJSPRULIAGWfVbaOTHZFeMXYNcg,GCBHVCDH.aFAAOBHHZABA..MEFA..XDAH.hAAA.NIBHCHGDKHGADGFASFCHhAAAUBGGAAEC.fACDhABAbGAC.TGEB.FEGH.cGAGhAEAdFHEBCAF...hAFA...,1,-12,-35,23
SKHdJRPYBANFIUObZQTCcVEGDXMgeaWLf,FGDBUEBCOFFBZFEB..CADH.EBFDDBFC..MEFC..aDFALEBFhAAAKCDE.JCAGRAAFBHAAhAAAAFAH..IEDBhABAQGGE..cACF....hAEA......hAFA...,1,-37,-45,8
PTRYFIGbaMBOQWUSLANDXHcgEZdeVJCfK,DBIFXBCEHBCEEFADdFAB...eHFEJDHHKHBCREDFFAAF..GDEEhAAAaDHHBDAFOBAB.UBGFhABAACGH..NIAFZEBHfHGHhACA...PDBC...hACA......hADA...,2,-20,-15,5
KDYScNVIdgebROHZMXTAPQGFUEJaCLWfB,QFAHGFBBEHEGCBEDLFHB.BCDFDAGFSHAGhAAAVEEFdBADeBHHOCAFZDAAMIAEhAAAAACDFDEC.UAFCJBHHaCCHhABA..fGDGKGGB.....hADA......hAEA...,1,0,-25,25
eDNKcLRFXICObaBSUQVZgfJYETAPHWMGd,HAGBMDCFdFDBeACDDBCEKADH.REDG.FHGC..CHHCOAFBBBFGUBGGQGABhAAAZGAC.JDHDECABhAAA..AABD..PDADhADANEDH...LGDAIFHD.aBBC.hAGA......hAIA...,1,-8,-35,27
bNOSEHMZRYIcDALXVUeBadTJFgfKQCGPW,VEBFBCAGdGAG.FHBAKAFHGEDF..PBEH..NDCD.EEFEhAAAZAFARABD....IGGChABAAHHA.LAHBhADAXDGEaEABTAACgGDCCEBG..hAEA..WCEE.SHGGhAAA,1,-27,-33,6
eTCNGLBWXRdYHKFSbIAcaDPQJUgZOVfEM,aCDDQCCG.JDAFUEAG.ZCFAOFCDEBCA..MAFGCEGEGEEAhAAABHCERGFEdBHGKBAEFABGhAEA.SAGFhAFAAIBCDAAG....gEGDfHGFeFEFhADA......hAEA...,2,-28,-19,9
HafTCMcSFWUbZdJDVBeKPRYgNAQGEXOIL,EEBHXDBELFEBHADH..aBCCCHEASBHFFAAFUGGD.dFAHDDDAhACAeFEEKADA.RAAH..NCIC.hAAAADABOCHB.IAHFhADAfGDFTGCEMEEE..cGAHhAFA.....hACA.WHAG.,2,-17,-6,11
ANTgFBHOYJbPaVMSLREQCGZKeDUWIfdXc,TFFCBHBGHFDC.OCCBJFCB..aDBAVBFBLEFC.REAH.hAAACFAGKHGEeBBCDEIBICEAhABAdABHAHAH..FEDGPAEAhACAMIDE..SCADEAHH...hADA......hBAA...,1,-16,-26,10
NMSDTOQPGfVKXIHYFEbJcACLZdgWeBaUR,ZFFGdGGCeEHBaCGH.RECB.MIECDCGF...QFADGBBFKHAGHAFChAAAFDAG.EFDA...JBEFhABAAFAGCAGGLBBDBCHESFFFhAAAOACGfCCG..IABFhADA...hAGA...,1,-11,-30,19
DNZOfECMLGdbQFgVaWKSBHJRUeTcIYXAP,DEFFODDDEABA.LEAFdAEE.QCFDFHFA.aFFFKDCABFHBhAAAJDFCRGBEeBBE.ICAFhABAAEBHZBAE..CBGD.MICEhACA.gFBBSAGE....hAAA......hABA...,2,-40,-7,33
RBWQbXcJHDEdAaZNGOPeKSUTICgFMYVLf,aBFEZABGOHAG.KGGATGFH.CBBCFDEBMFDG.LAAFhACABFBCQGAB.hADAXADCcBFEDEGChAFAACAD.PCCHUDGHIHDE...hAGA......hAHA...,1,-28,-34,6
HYFXZRAcMbWVDISGNKLBeJOfdCgTEUPQa,MEDAVBDE.DABAGBBALHAEBHHC.eFEGJAFD...dHABTFFGhAAAEBAFUDGA.aEAFFADDhAFA.XCGEAAAF.hABA..bCBGSGEGOFHDCHEF.QAGAhACA....hADA...,2,-19,-11,8
MTNceFXfUWJZgBIAYdKRbGPLCQDHOVaES,KAHBGDAECBCB.DCAFHCAEOEDD..VFCBSAHD.MDFHhAAANDED..FFADfCCDhABAJFFC.ZGFEBAEAhAAAIDHAABAAdECF.PABCaAFD.EGCD..hAEA..eHEC..hABA...,2,-26,-10,16
dJAGDcRXaVLOeWPNFITYQKHEfUBgMbZSC,DGDDRDGF..VBBEeCCH.....PHFGNHBB.FFEB..IDFDhAAATBGFQAAFhABAEEDHUEAEBHHHgFAGhADAMAFG.ZDFCCGGDAIBAXAEBaBAH..hAHA...WBDB.hABA...,1,-9,-31,22
HbWBaCDfLMEQNGVARFTeIgKXJZSUOcPYd,TFCEeEBFKGDA.ZAGFUDEG..OADD..cAECdABDHFFGhAAABHEFDIECLBCBhAAAQDEDGBAEAICE.hACAFGGA.IHBG.JAFASAFDhAIA.....hABA...,2,-20,-18,2
QGfELbOWFBCRMNXSZHUDTIKPaVYdAeJcg,JAEFQEBHGBBGLHEEOBCEBGGFRBGF.MDDE..NBAE.XCAGhAAAZFFC.DDIDKGCBhAAAaHDGdGAA.ABBDeEFGhABAfAGF.bDEACEDC.SFAD.hACA......hADA...,1,-14,-18,4
ZbJUMNVdHfELXRSaecBAgDGPWYCIKFQTO,DDFHGCEH...PCBBCHDHKECAQCAA.ZFAAbFAAUEGEhAAAVEGDHACELAEGhAAA.SDDGhABAeBFCAIFC.WHCAIHABTABCMAEC..hABA......hACA...,2,-25,-4,21
gbDCBMAaOeFPULJXGdWVRSTfEZcHKYNIQ,eDGDUECELBECGCADdHEFRBAD...fAFGEFGAZFEFHCFDKFCE.hAAA...IDHFhABAbFAFBCCEACAA.FGHDPHAGhACA.XEEHSAAEcEAHNAEBDICCCHHHOABEhAEA...hADA...,1,2,-9,11
dKfbDcJgQZYXRaCAMVeNHILGPFUBEWOST,eDFBHAGDLFAEFFAABHAD.EGGC.OBBAdGDFKABGDCIF..JCDBZEDFhAAA.XCABCEHC.hAAAADDEMCGBVAEC.NIAD..hABA...IHGCPGACSAEBhABA..fBHAhADA.,2,-46,3,49
YORSgeKDLINbEGdHcXaBVTCfWZQJMUFAP,OBBDSDEEKGCFLDFG..NEBGEAEFdAGGHEBC.aFHFhAAABCCG.CFHHfGCBhAAAQADAMCAFhABAAHCHRAGDDGADIGGAGEECcBABXGDH..hACA......hADA...,1,-17,-23,6
UMeCfAgJPNbITcYFXZGSaWRHDVdLKOEBQ,JHEG..bFEH..TBBAFCCFGBEH.SFBCRAEFDDGALEBFhAAAOEFABDDEMAAGhAEACFFFAHIH..PHAChAFA.IHHHXEGFWBBDdGCEKAHHEAGGeEDHhAIANDAE.....hABA...,2,-33,6,39
VGTZOQPcFYbNRHKIESBfaeJgWDUAXdCLM,dHABMFFFGBBCZDGF.OAGBQGBH.FBGENBEE.KDBC.EAFFSFFChAAA.BDHBhABAfADFaFBCeGEAhACAgAAEDEADABBDCHHE.LEDE.PDAHhACA.cGGHhADA...,1,-20,-23,3
WAXfLGKReZMOCNJQdDVHcTbUSPYBIagEF,LBBGRAACZGEC.CHHA.QCDBDAHBHEEB...TGBGSDAGhAAABEFCaFGEEGAAAFAAGBGEhAAAMDFCOEDBJAEEVDAAhABA....cGFD.PABG.hADA..IEHGhAFA...,2,-29,-4,25
XfHESeNgMdOZWUABDGVLCbQcaKFTRJIPY,DBDELFEEQDFGKHEERCBE...JCBH..PAHH..fHGDhAAASABCNIAB.hABAMAABdAHEZDDFAGCDBAFEhAEACGCE.aDGCFFAF.IFHDYBCCEABC.eAEEhBAA....WFDDhAIA..,1,-20,-26,6
dMgJGSNFWVRBePEfTZLYIHcbODaQAKCUX,CDFEXEABdEAA..MHBGJHBC.GCCA.FAHFRDFBBAHB.EAFDhAAATADBLBDDHFGBhAAAOFHDaBAD.AFCDKABEhAEASGFD.WACFeHEE.fBBGhAGA.IFDHhBAADDIH..,2,-26,-14,12
ZJeOEGQYMVPIABSDgNaKULWbfHcRTCdFX,DBBEaBADLGBA..bCCCHCGBRGDGdAEDFGGCZDAFeAFD.EACEQFGAhAAAMDCH.IAHHhABABEDCNEAAKFECUCFGhACA..fCCBTECHCFFFOFAH.hAAA......hABA...,1,-4,-13,9
MdXOEPeHgWcbNIYGQaSBfRAKVFJZLDTCU,FDDALBHHDGGG.TEACCFAA..dAFFEBAE.HFEB...gDEChAAAbGDG.IBDBhABAQCAEBHADhACAACGGJAAAMDDDOCHD.eFCEcGGE.hADANADDaHCCSAEDhAIA.KGBB.,2,-36,4,40
aZIgDJHQcPfNGWAFSdEULRBTYXeOMKVbC,dGADEBFARFACBCCB...XDABMEFCVCAC..CGDAZEFBDAEDQGFGhAAA..hABAfBGBNFDF.hACAABACFCFCSABALECGeHCAKACG.ICHGhAFA....hAGA...,2,-37,-21,16
XVaJZYOPgDQBRIbFcAdTEMGUfCLHWNSeK,dECETBBAGBFA.CCAGHAAESDGF.XEDEaHBEZFFGOHFEhAAADIAARAECFGGAAEFDMEAFhACAUEAFLAAC.hADANIEFKGCGYBHH...gCCEhAEAIDDC.....hAEA...,1,-1,-16,15
OcbfYARSLZFaWdMVgJIeDKEGCQBUPTHNX,SCFCZGDAaEAF.MEFGJDEB...eACEDBDBKCBBGDBE.BHDChAAAUAGHTGFFHCGHOAABhABAbBAG.AIEEFHAAhACAWAHH.dGAE.IDDGCFGD....hABA......hAFA...,1,-15,-27,12
NDZSQWfcdVaTIRKbOUYeBEPMHXAFJCLgG,JDHFCHEEGDAHZGFA...SFBAQDDF....WHAEhAAAdAFBaACH..TAGChABAIBAEKGHFUACGhAFABBFAEHCEMDDAADBAFEADgEFHDIAA...hAAA.fADGhABA...,2,-35,-18,17
NIGfRHUPacVDAYXLEBKZTgJebQSFOCMWd,LDAEEEDEZFGH.JCHBQGAE.SDAHCAGDdABBGBCHhAAAHAGHaHCADFDD.XAAGhABATEAC.eADHFGFAMFDChAEAIHEH.fCEF..hACA......hADA...,2,-23,-15,8
XObdJYUKMgPWaSZBLDVcGCIAEeRHfTQNF,eGAERBCCHFAFQGGCFGGE.OCEDdCGBJEDGKEGE..MBAGPDAEhAAA..SADEhAAAZAFCBADHDIDE.cBABhABACEHCIAGE.ECAE.fHDFhABA.....hACA...,2,-24,-18,6
fSABWKGcPMQegIHYTFELRaZNXCJVbdUDO,BFDAKBCEGEDFMDEG.eDAGHABF.FGCHLGEAZEAB.CHAHJFCFVADChAAA.dFHEUBGC.DAAAhADASHEC.hAEAABAE.WCCGPEEA.QAGGIFAE.hAFA......hAGA...,1,-9,-29,20
UcCeRbdEXgJTNMAKGFPfHZSVYQBaLOIDW,KGHBGEDBFCCHHCGFZABASGDH.QDADLADGIGCEhAAAUBGGCGAC.eBAHhABAdCABEHGGXFFG.hAAAJFAD.MEEHAFIHfDDHBCFCDICE.cGAEhACA.....hACA...,2,-21,-9,12
ZOeKNQFASCUIHRGTWYPaLdEVXJDMfcBbg,UAGCHGAGRBBEGDBC..TGEA..PEGFaCFCEEDEXBDChAAADGIBMBECBABGZDABOAAGhAEAKADCFHDASCAHhACACEGC.IDEC..WAFEhBAAdDGB......hBDA...,2,-18,-15,3
HfMZDOcRAQLeYTgSdKICJbPXBNEGWFUVa,QCBCeEEG..TAECdFACCAAGJADFXAAD.BDCFGCGGhABAFGGGUGCCaHAEMEEDhACADCHBRDADACFB..LFFBhAEASADDIHHDNAIEEHAC......hAFA......hAGA...,2,-20,-14,6
EBdKWPeRYFCAUIaObQJGSDcXNTZMfHLgV,UCCCOFAAQGFFGEEADCCE..XAFDZAAGMIBELBAHhAAAEDHHBAHBdDFF.KFAGeAGBhAAAFADGAHACaHGA.SDEEhABANCIC.TCAB...fDDEhACA.gAEDhCIA,2,-32,-3,29
NXdDPVgKfRQMAGCOIeTabSEFZcUHYLBJW,OAFATFBF...aADCSAFAZECE.HFFHBCDBJBCAXGBAhAAADFAF..gCAHhAAAKEAHQFGChABAAFIDCHHAIDDGECBDFGEH.YHCGNBIC.dDFD.hACA......hAEA...,2,-25,-11,14
OgXfWSNJdARPVCYaUebKFMHGBDcITEZLQ,VBBEaGCB..eHDGFDHBHEBEDEBG..TABFZGAAQFEHhAAA.OADAgCFHhAAAfCAGNAECAGHFCAFD..hABA..bEFAMIFABHAHEBGAWDADSDEEhACA.....hABA...,1,3,-29,32
WLIFDcdZTBVKCOeYbJQGAEURaNHSXfgPM,UEGAaEAGHACC..SCGCXAGB....fEGAhAAAgEDCPDDFLCBHhAAAFGBDDGHDcADBdDGFBBAFhABACHDHeHACYFFF.JCAEAAGBEGFD.hACAMCAD.IHHFhABA..,2,-13,-5,8
FJeLIOUVDQYRAgaKHbGCEBcNWdXZPMTfS,aDFBKDABHFEAGDCECBHBBDCF....WHFCdAAEZFAA.MIAAhACATACB.FHBCJADGIFADhAAAUDED.DAEE.hADARCGFACAAEGHH..cBEBNCCH...fAHGhABAeCHD...hAHA...,1,-16,-20,4
cSQNRgHYDFAGPadeLCbIMWVJXKBEUZTfO,GDACaEHBLAEDCEEA..MEHDJFFHKCBFEAGBZADF..OFCBhAAASABDQAFEhABARFCH...HCCBDGGDABIBhAAAdBHEIDCDWCAD..BEFE.TABDhADAfGEC..hACA...,2,-34,-4,30
ITaQdDBWMURYfGNKcFXbVOSeZHLAEJPCg,EGABCDCH....TABHdGFFDCGCBGCHMFEEUFEDRCDGGBAG.KFBBhAAAXFAF.VAGFhAAASGED.hABAHAEAJBEBIHHEaACGYDHHfDFAhADA...NIAH..hABA...,1,-18,-25,7
HSdcIKeYTVOfLBJFZMQbRUPNWGXEaAgDC,DIAECAACdAGCKDFE..eDHB..TECAODBCLCAGBFCHFADCQAFEhAAA.bABAhABAUGFF.NCAB.WDHHhACAEEFD..AHBD.HFEFSFDHIFACfFAFhACA.MAIDhAFA...,1,-13,-38,25
YWEGPJHaDOAZTLgIcUKFVSQMNBdCebfRX,ZAFDLHDE..IDDHKCDHSHAGMCBGBABACACG.eBHDhAAARDEF..XEAEhAAAEHECGDACHAEEDAIDTEGChABAgADE.UGGCFBHD.NFEH.fBBGhADA....hAEA...,1,-9,-19,10
MHZWFPBXYcTLGQNeAVbDKfUESdCJOaRIg,VDDDDAADKFFA..UADFEECA...CBGC.JDABRCAG....MCHHZBBAFBGChABABGAF..XFCAhACATGFC..QAAHhAAAAADA.fEABSHEA.aFHDhAFA.IDHGWDHH.hACAYHAA.,1,-25,-39,14
WHPdKBTGZLMOeDgEXRNAVJFCIQUScYfba,FAECCHHCUCGF..SFFA..fBAEaDEBHCAFKHDEhAAABDAGZCCBODFHDAHDEABBhACARGACACEE....IHHAhADAQDCEcDGBWAFCdGAE...hAAA......hABA...,1,-13,-47,34
PFZMUfCODTBgEXGHVJaWILAKRdQYSNebc,KBBBQEAA.SGFFbFDG.FGHFMCIDUAAFOCFDhAAABEDAEGDBXADB.hABAHAGHVADAJFHFIEGFhADAAFBDRDBAdHED.eCFAcGACPHAC.CAGBDCDHhAIA......hBIA...,1,-6,-9,3
XGWAbDPOESeBJMdIFUaLfHQTZgNCKRYVc,DAHDEFFEBBGEMDBF.dBCEUGGBLAAB.HGCAQGDDZEAECAEB.hACAKCEERCEA...VDFAhAAA.GABEAEIHPHFEhADASEDGIHAHfADD.gGAAhABA..hAFA...,2,-28,-12,16
FTcdWgVRaZIYLKPfAODbBeCSQNXMGHJEU,OFHDBHBHCECC...SABDQAAHMGEAHCAD.EFHHUBDChAAAFDHBdGEEVGACZFAGLAGFhACAKAEBAFFC.eEFCXDDFhAAATDAB.........hACA......hADA...,1,-12,-21,9
ZTceXINfYJRQCWGbMVaHKDUdSBgLOEFPA,TFBBXCDH....IGGD..YDGHRAGHCDBDGBCAhAAAMIEEaFHFKABADEGGSAGAhAAABAEGLFEHhABAEEAAAGGHZFCANDAE.fADD.WHAChABA......hAFA...,1,-13,-35,22
eCUVSdHGZPTNAYDWOBXLMREcIKbQFJgaf,DAEBBABHMDCEEEAHKCDB..FFCD..JDHFaDAD..CEFF.UEECdDAFGGBBhAAAZAAE..NBIC.hAAAAAHA...OHDChABAXGGCLAGF..cACDIHHGhACA..QBGDhABA.fFDB,2,-32,-29,3
XJSLgVQGZRbDWIOeKFfNTUPAHEcdBCaYM,HEFBEBFCBDGAaBDBMDEF..SEAHLEAEQBABhAAAGABCbFDG.IHCAhABAKDDHFFHH.TCGDADAACHAA.XAGGhACA.JFAB.......hAAA......hABA...,1,6,-35,41
AZKdMBECNUfIcgYODXRTVJLQaFHeWPbSG,KFFEBFECCAHC.UDBF....IDBF..YCFGhAAADACERFBA.JAEEaHDC.eAEHhAAA..bFGHAABBMHEEhAGAEABB....NDAE.gCFCOHBEXACFhAIA.TGEBhBAA...,2,-38,-36,2
cTaeMdKgHfASIPRUJLZbEQNODYVXGFWCB,SCACRACFLGFCEBEFOCDB..VCAFFAEHCFGE..BDGGaHAC.hAAAdGAEHGCAAEEF.IBGHhABAUGCBJAFA...hACA.QDAEDBAE.XEED.hAAA..cCGDMFFA.hABAKGAC.fGHA,1,-8,-24,16
dWNecSTRFZYPVUCaLDgAHOMQEBXfJIbGK,HEFAQDBEECBCBAGGJAGH.GEDG.KCGHNFEB.eFCD.SHGGhAAAFHAGZGDA.PEABhABACBBGDAFFAACG..MACAhAHAXACEIBEGdDED......WAAFhAHA...cGGAhAIA..,1,-13,-29,16
EPaUANYJcVLbHdRDMOSFIeCGQWTXZgKBf,JFDFLABHHEFHdAAAMFGH.FCFFeAFA.CCCF.QECA.hACATAGFXDAGKADDEDHFhAAAaGAAACFA..YFBFhAEAbCFADDEH..SHGAIHHAWFEBhAFA.BHDAfFHChADA..,1,-16,-25,9
fJMQEReaKDIAYgdONLHTCFBGcWUXSPbZV,dFEFOHDALAHBHAAGFFBDBFBAGEGEUBBC.SDDDZGEG.hAAAVBFBMAFH.EGADeAFEhAAADBAF.IEAAhABAAEEG.NIAH..CEEB.WEAE......hABA......hACA...,2,-40,4,44
BUMPNcSRHTILEJfDgZYCAdWKOaFQXGbeV,KDFBaGFB.FCCHGDCH.eFAHBEEG.MIBA..NACHRAAHHAEHLFCFhAAAJBHB.DCDCZEAAACCBODHHhAHAQGGBbAFA.hBAAUABD...SGAEIHHFEGDDhBDAfCAG.CHAC.hAAA...,2,-31,6,37
HTdQKJNRgVFIcSMOEUCfebWXZLDYPBaAG,TGDBQBEE.KEGGRBBFFDFF..SBADOBHDUGBCCDDCeHDEhAAA..XAEBhAAADHGEPEAEBFGAAGCA.dEBHhABAJBHHNCAA...IBBGMFIFEEEB..fEEGhABA..hACA.WAEC.,1,-9,-25,16
YFcgZCePdROLADBQVGNbaJWXUIMKfTSHE,DGIBQGDDGADE.aCGDJFEF..UAGBMAGHKCEG...TCAGhAAAEHBAFABBZEBD.CFGEdABDhACARDAEAIDGBFAH..NEIG.hAEAXDFESHAG.....cEEChAFAgFFB.hAHAeAHD.,2,-34,-5,29
RfIXeYMVbFCNLAZDTUcBKdaWJPSgOEQGH,TBGFUBDGBEHE.KGHDaFFF...JCAHSGEG..hAAAEFCAHAGFfAAGhABAIBAFeHAG.MFIHhACAbFADFEEECGEGAEECcCCDPDAC.OAFG.hABA......hACA...,1,-13,-35,22
HaMZKXOdWbCNYVePUDLREGBFJfQcTgSAI,HEEEMAACKBGHdCEBCHED....VEABUAAARAEF.EGBFGEGCBFAFFGGDhADAQEDA.TCCDhAEAABDHIAHD.hAGAaEBAOBBG.NAIC..YHAGDAECfDGHhBAA...hAHA...,2,-29,-11,18
AMBgcaUGfCeKXJDPZRVdIWLNOFETHbYQS,BACGaGFGGEAACBAF.KAACDFCG.RCGB.dAFHLADBFCHBHFCB.QCEEhADAAHAD.MCCBhAEAUFGFeBDFJGBGZAFGIHHGhAGA..ODEFbEFA...SCCDhAAA...hAIA...,2,-41,0,41
CQVIHGRcWgFTdNOPJDfLbEYaBAeKXZMSU,KGGEZDDGMAHHCCBB..QGCCHAEBRBAF....gFGGhAAATDCDdAFCOGACDBGGLBAChAAAEACABEHFAEIF.eFFDhABASHAC.IFEEWDCDNIAF.fHEFhABA.YDADhACA,2,-27,-15,12
gdFRSeAMQHCabVTIUOBXWLJDEPGYcNKZf,MBABCAGD..VCBCTCBA..UFCDXGAHLBEH.DDHDhAAAEFDD.GAGE.hABAcFFGNCIGKGGBZFAFfEAAhAAA.dHGBSGFDADEGaBBAIEEChABABACA.WDHH..hACA...,1,-16,-31,15
HDaPJAMQKSTBUCXOZfFgRGWILVeYEcbdN,MDBBKDFGBBFCUFED..OEAEFDCCGBCBLDDH..eABChAAAEAHDdAADDGIH..aAGFJFFFhABAAFHE...SEHHhADACHDGXDFGZGAARFBH.IHHB.cACDhAFANAIC.....hABA...,1,-21,-24,3
fEKcOGbdNeXDMFQLPASgIWVZRaUHJBTYC,SGDG..WDFBRDDAUABFHBAEBBHCCGBDKHDCGEGC.hAAAdAEGNDIA.DIDC.QCAFhAAAPBEA.AAGA.IEAFhABAaGBH.JECA...fHGDhACAOCHFXFBBMADC.hAHA...,1,-11,-35,24
NDbcMBdVGLaRJEIPYHFeKQfCSTXWOAZUg,ZDAHUGCGDAACMEADBEGDGDFELFFG..aCBERCCC...JBHBECHBhADA....IECGhAAAPAFGHFCBFACAKFHHhABACBBA.SBEH....WEADhAEAAHBE......hBAA...,2,-33,-24,9
BNgPTLfQKMcAHaeJSWbdEFOZDUGIYCVRX,HDBFJDDB.SBECdFGFFAGD.ZDEGDBAGIGAA..VCAChAAABFFC...gGDBhAAATGDH.LBABhABAQGAEKGHBADIBaACAWDDCECFB.OAFAhACA......hADA...,1,-16,-34,18
MOaLIJHNYSgcVBFPdATDReGKCfbQUEZWX,RCDCKBDECHCG.QABEZFEC..MFAEOCFELBBEJEFD.HCGFhAAASGAE..hAAAcGABFHFEAAHFeEHBhABAfDADbFCB.UAGDEEACaAEA..NABD..hAIA......hBAA...,1,-13,-17,4
DOUYgCBNAJdLGFXEcaeRZfQHbSMPIKTWV,LFAAFDDCEFHD.aFGBZFFFHACC..SECGMFIDKDDGTDAAhAAADCAEUAGG..CCFFAIDAJFADhAAAdHADGABD.XGDFhABAeHEGRBAEfBHG...hACA......hAEA...,1,-2,-25,23
TdfeDaRBKIWZAUFgHSMCLPOXVcEGJYNbQ,UDDHFEBBHEGHCGAC.OCDG..XACEVFDH.EGFHGAAHhAAA.JAHBNBBG..QDGChAAATDECdHADDAIBaGHDhABABHCBKAFC...IAFDAGGHMDAG...hADA......hAEA...,2,-37,1,38
OYEbZMJdRUIWNGcXeHQKfDABLgPTSVFCa,LHBGTCEB.VABACHGB..ODBF.EFABZFCC.dCEDIHEEhAAANCHA..XGGEhAAAeABGKEGHAFBHBEFAhABASEEDaEAB.MIAE...JAHB.WECHhADA.cAEFfDDEhAEA.,2,-33,-15,18
TGaUOZecdPLWRHINMJCXQESgKFYDbAVBf,BDEGTEGHaBDA.ZGEGdGAF.LBBEHBAGMGBECEAB..QCEEhAAASFGCFBHHDCHFAAIHfDCChABAOEACeAAChAAAPGDEIHBBNACD.EAHDKHAG....hAHA......hBAA...,2,-14,-14,0
NaZYTMKCLAPVWFXQIRUOGdefcSbHEDJBg,VEGDFFGGQBGA.UCCBGCBBdFBA.eEEB.SEBFhAAAEGDEDACEBAAGaAFHZAGHhABAMDFDCGDEAIBC..XADEhABAOBBG...fGHA..hAGA......hAHA...,1,-15,-33,18
LFXcPKTANZGCdaJUEOSDBHIVWRfQegMYb,ZCBGCAHBdBDBaBAE..UGBCEGBA...DAGHBEEFHDDB..IBGBhAAARCBH.QGGEhABAeAACMDHFLFFDhACA.FFABcGFC.KEADAHEDNADH.JDFC..hAIA......hBAA...,1,-15,-29,14
WGFDBKeUZbVCRIOALYEPcQaJNHMXdTfgS,LDBDEGBD.QADDaFEBHBDDdAGATGDBSGFC.hAAAFCBCKFGDeEACUDFBVDFChAAACHAEIAGHAIDE.hABAPDDHJABE.NAIA.MIFAXBAC..hABA......hACA...,2,-20,0,20
dHJGCRDgcXNaBKIbWTYFLVUSeOQZfAPME,MBBAHGBACEBGDDEH..XAAGBHDCKEAH....bDDBTGGFhAAAFAGCUGGCeCCHZFEBAGEGdAHGhABAJBCE.GAEARDFG..hACANEAE.IDGC.......hABA....WFFEhADA...,2,-35,-4,31
IQOXTHbgcSPEYWDLZMBdFfJUAKeNRGVaC,KEAFRAAGGEGECHAA.OECEHDFG....bACGSAHH.hAAAEGDEDGIDLAEHhAAABGFFFGDHfAGChACAACHE.eDAANFCFaCEBXGAE..gBADhABA...hADA...,2,-33,-15,18
NOGTPdXYFVeQMgWEafDcUBRKZAJCbLSHI,JEEECDAGLCEHHCAF..OABFGABGdFCEFGDA.QAGAhAAAMDDAEGAA.aDHFDIEG.UAFGhAAAKGGFAGCB..SFGHhABAIFAC.TADD......hADA......hAIA...,1,-17,-27,10
WSOdJPcHDAZCbELTMGgeVYaRFBXQIUKfN,CBAEEBBALEFEGECFeAEA..aECAFCHFQADEKCEH..hAAANAAC.SGCDhABAdGHE.JFDFPFAHDDAFAHGDTFGFhACAMIBCVGEGBAGDIGCFfCFFhADA...OCBEhAHA...,2,-24,-4,20
FdNHZBKOgEADWMPLRIVQcUXJGSaYeCTfb,DGBGMHCALDBARAFE.QEGEUCEEJHFG.GBBB.SAGChAAAeADFCABH.TCFEhABAFFFGHDAEBFEHOAAHhABAEADGAHBE..IHHBXCGE..aFAGYHAAhADA.dFAHNIBD.hACA...,2,-17,-9,8
VWgORUeaDQIYACLKPBHMTFSdcXGZbfNJE,KGFEHBDHMFCDFAHFdCBGGBEEZFBH......bFGBfDHGhAAA.EACEgFEDhAAAODDHUAGAaABCIDFChACAAABFLHFGBDHFcEAGNEAE....hAEAWADEDGBHCCCF...hBAA...,1,-6,-18,12
EARYSQJdbHTUMXWIFeLcOZGgDaPfBNKCV,SGEFJBCHHEACUBGCMIFE...XBFCFHGGeAAF.OEEFhAAAZCABDECC.aHAABBEChACACAGHADHG.QEGAhADAdGGBTACDIHAF....LEFEhAAAgGCF.NAEH..hABA...,2,-23,-11,12
PEYBfdGFHcLMAJOXKgUZaINSWQTDbCeRV,XBDHUGFFZCDD...aAFDSBAF.QGBDhAAADEGBCAACVEAFECCBBCHCGCAEhABAFGHFLBCDADGGOAHFKAFEhACANIDH.....WFFEeEEH...hADA......hAEA...,2,-25,-15,10
IVdRLXJfAabHCWEMGQcBOZTegKUFYPDNS,HFAHCAGE.EEDFQDBGBEACZAAA.eGFAKAHBUFGAFHCEDEGH.SACBhAAAVCFA.LDFChABAJFEB.AGCDaBEGMACEhABAOFAH.TEDBPCCH..IBBEhAEA....hAFA...,1,-15,-22,7
GXYJeagIKLVDFRBQTPHCWdOZcSUMEbAfN,GADAJFEH.aFGAKEBFDGBEFGGD..BAFA.QDAHHACHCDEFdHABhAAAOFEFZAGD.SHBGhAAAMEID.ADFCfGGAhABAXBAD.gAGHIAFA.LACFhAFA...hABA...,1,-8,-39,31
EfPdLAZSQbJVXBWGHcMKOYTFeDUNgCRIa,ZABFSFCEQFGC..VFFDBAFAGCAHMHAEKCFHOGBEhAAAFEDGDIEEUAGE.CDEAaEAHhABAEFAGdADCLACG.hAAAAFIF............hAFA......hAHA...,2,-35,-12,23
JMWHCfNadQPDOGEFAKBLcXURIYgZSVeTb,LFEHXCGERGAA..IGDHZBAF.SFABeEEHJACAMDDBhAAAHDBACHGB..aGGGQABDhAAADCFE.GAEFhABAACCEKAGABHFDYDFC.....hABA......hAFA...,1,-8,-26,18
SdMJUIRPYKNgHVEfLOAXDTCQZGebFaBcW,DDCHQDEHeAFDFFHHaFAH..BDGH..SFFGMCAHUGAFhAAAIEBE.PADBhAAAKFEFHBCDEABFOCHFhABAAABCCBGB.GGCDcEEF..WAEE.hADA......hAEA...,2,-37,-6,31
cAeNOCRbZMXQPJSfEgTdLFGYVaHWUDIBK,eECAOGECRADHZGEA..XBCDQCAFSEGFEGCD.dEAEhAAAFAHBGECAaBBGHDGBhAAAUAFADFABBADBAIEEbFADMCIHhABA.fABC.....hABA......hACA...,1,-4,-14,10
BMaQVWGOHdPJgKebCfNXEFLAUYDZcTIRS,UBCBDBEDZCBF..TGDCRDEHBAAE..QEFCGEAGdHDHJAAFKCHFhACA..CCHE..XAGGhABAEGGHFAFD..AAIF.IFBDhACA.SGHFMBDBaEGE...hADAWEAF.PHAChADA...,2,-37,-26,11
QBaFLOJYGUDcRTfeAdPMHKWCIbXVSZgEN,MEFBKAHDCACF...XBGDZEEG..EBCCQADFFHDG.OEGFhAAAJCECGEAGUEAFDBAGhABA.TCAFeAAHdGHChAAAHGBC.IEDHSDDGNEIEBAHB.hAEAaGGH.....hAFA...,1,4,-31,35
KbgAfeQGOPIVSHCUTRMBEYcJXNZWdFLDa,eABGQDAFOFGH..VACACGBA.UDECTAGGBGCA.EBADJCEFhAAAZGEAdDHE.LDADhADADAIFKAGDAAAAGDCA.hACAIHEBSHAGMIAEXCGH.hAEA..FFGEaCCB..hAFA.fBFE.,1,1,-11,12
EIUKafbPXSdcGVOAeCQBYLWTDZJFRgMHN,QBBHBCFCLBAFDEABFBGEMECE.EGEBUEFD.KAAC..aGHBhAAA....PEDHhADAXFBHdGBGGGEHhAEAABDDeFFBCBGE.TDGC..RCEE...NIADICBGhABAfDBCSAGEhACA,2,-29,-16,13
IMeOGfPHFBdKJAEbDXgRaLYZUTVSNcWQC,EHGCXGGBREEG.LBDEZBFHUFAG..SEDG.NHCD.hAAAWAAD..CFAGeABChABAGBCEHCDC.BEGGhAFAdAEGKAGCABHCDICAaHCE.......hAGA......hAHA...,2,-26,-20,6
XAaFOLJcPgKZRHCIbfUTWEVQMYBNeDSGd,FEADOCEELDED..PDABKHFGZFBBREECHDCACAAA...ICBAhAAAUACHEFFEQGAAhABAMAIB.BHGBhACADCDDdDAB.AEHHaHDG..JACG....hAGA......hAHA...,2,-28,-19,9
YeUMTDXEPZWfbSBNaJFIcKRCQGOAHgLdV,HECBdBFAeAFEMCFGDGEHEFFHZDBH....fDABBADDaACHFGFHhAAAIAGA.RAAGCEEFOEDAhABAAHEDLAEF.hAEA.YCHB.....XGGBhAIAWFBDNDIGKHGA..hAAA...,1,-18,-26,8
VTaZQSbdMILYOBeGcRPCgfXFAHJNKEUDW,JDAFEBCCUFGG..VGDCZDAD..QFDAdBBCLEFCBCEEeACEhAAARAFCCCHB...XCCBhABAAEDHKABDDIAG..aCFGhAFAMEEG..IHABOGAE....hAGA.cGGA..hAHA.fEDANAAC,1,-19,-27,8
dTbMRJCEQDUfZKFONaSPVLgWAYeXHBIcG,eDAHBDBFGECBdAHEMDGFCFHD..DGAAZADE.FBACOABC..NECE.hAAAaDGC...SHDEhAAALHDEAIECXAFAhABAHCDBIHHF..cGGH.hABA......hACA...,1,-22,-37,15
BUfgGTKIHaMPOVAQFSXWedLNJZcDYERbC,FCCHSHACeAFDLGBEZAEHDCGC..REEFBCAFUABDGEFE.hAAAKCHBIGGBMAEFOHAEhAAAVCBE..AGAGQDGEhABAdAGDNCAA...cEBHYFHBhACAEABC.CHEH.....hAHA...,1,-8,-18,10
DRGOKWFYAfVPUNbeSXdTMZBgJLEaIQHCc,VCABUFCGeEAB.dDCBMBAEBAHELBHF.aFDBIBEHhAAACCFA.DCGGGFEHhAAAKACCFBBCAAHGNACH..SFFDhABAXGBDgCCBQEGG...hAFA......hAGA...,1,-12,-34,22
FbJadVeIWBMKGYZSgTULNARCXOQfDHPcE,CFHCQGCADCCG.HDEAEBHH.JEACdABBeCBGBAFDGACDZFEB.SFADhAAAUFCGLEAFhAAAAHHDOEHF.cBGEhABAaGGE...IGFDMEDA....hACAYCDG..hAEA...,2,-40,4,44
OgdTZfbRQFaLUCKNIMeXJYSAGHVcBEDPW,HFFAVBFC.BHHG.EFBBDDEB.OABGdBHCZDEARFEC.aCDBLEHHhAAA.CDCG.IDAChAAA.eABBXFAGhAFAYAFHABEHPHAE....WFDD.hAGA....fACBhAEA,1,-15,-36,21
CWScBTJDdIbRQaZYeKFLGXgMAOUNHfPEV,ODBFUCDDHAAE.EFGACEFH..SGAFBGCHDGEDdAHERGCCZADDeDADhAAAKBAHLAAE.hACA.XGFGMBHBACCC.hAGANCCG.fBFA.PHFEcDFD.hAHA......hAIA...,2,-25,-19,6
KHPDRMYaZEebIQfJSLBTUGWNgVAFCcXdO,CCGEXFCGdDFAHCDFDCBDREAC....MIDEaHGCZCCH..eAECICEFhAAAQCAG.hABAJGBESBGFhACABAHHTFGHWFAB.NDHAAGFEcAAAKEEE..PADAhAHA.EHCC...hACA...,2,-18,-16,2
GIKAXcBTWCNUdHDPQaRMfZFebJSEVgYLO,BCDCCDDBdBHGHFBFQCEDRFFB.MFAAZCABFAAGeDHD...SGFEhAAAEAEA.VGBAhABAgFDDLACE.hADAOAHD.IDBAAAHEcCEANIEFDFEE.hAEAfAGC.hBCA...,1,-3,-28,25
HfbZXEVLIGJcFSeaUPONgDMWKTCYQBARd,REFHHFCFZDBE.VAGHLAFDGEEAFCGA..aDAEOGBGDHGC.KCCECFBBBBBChAAA.AAFBdADGfAAChAAAEGAF..IDDFhABAJFHBeCAF.NIAH.......hACA......hADA...,2,-23,-12,11
UXdeZgPafcHDLGVSbRCTIYMOFNQKBWJAE,UEBBXCACeEHBZAFD..aFFCHFBC.LHBGSAHFbBBEREFHhAAATBDB.IABDhAAAMFIBOAHD.hADAFABGKGBGBHGAAAFDEGEB.dEEBfDDEhAEADDBECHHDNEAG.WFAF...hAEA...,2,-18,9,27
LPCBfVREQcgZaHWJDFSXUOGeMdKAbTINY,TCCH..IGBHLFGFBBAGVAABQFEFZAFG.hAAAaAFAJFEFDDDGFDFCUCFAhAAAeEAGMAIDAHCG..NCIE.hACACAEDRCBBEGAF..........hADA......hAEA...,1,-11,-33,22
PKLQRZBTJFXMcaeYEOdSAHbDUgGNWCVfI,HFBBUFDEGACDCFAF..fBBAKHFGQBGARBEDBADDJCAAMFGBhAAA..eDEGOFHBhABAAGFADICE..gBGGhACAVFAD.IDCG.PEDFhAEA......hAFA...,1,-22,-24,2
QgDWSaEIVBXLMTHRUACbPcZFNYJdOGefK,CBHD..bEBDZGFC.FBDEJGFGGDDD..eACFQDAEDFEGaAGB.hAAAEGCHBGEC.LDFEhABAMIEEHAAEAAFBPCAFhACANACD.......YDDDhAEAfEHCKAHBWHFAIHAAhAAA..,1,-10,-26,16
edWaKBZAXfLVbYPGMODHFTgNIJUEQRScC,XAGALAHBVCCC....PDDAMIEAOEGFHGFATGCFhAAA..NDBGJACGhAAAQABA.SEBHhABAeGCEdABGKCFCAHACfEGG.hAGAYBEADEFBFHBE.IEAChAEA,1,-10,-19,9
KAcEMIfRVPLDeCOBXWHNUJGZgTQFabYSd,MAEDRFADLAADDEEA.eEDDBFBEHCEGUFDGZFFF.QBCFhACAFAFC.aAHBSHAEhAAA.ABACEGFEfAEDhADACDBF.OFHDNDIE....gBGAhABA.YACHhAHAKDBB,2,-50,-4,46
ALUDVXSGNZbgOHfPQeBcTaMECIYWKFdJR,LGCGVAGH.GDDDZDFGOGFGHCAHPAHDBEAG..TABBhAAAaHACCGGA...IGAAhABAKAEFFACFdAFE.AGDCDGIHhAAANCEE....fEBD..hADA.cGDHMIEC..hAEA...,1,-4,-39,35
YdJEBUGPSWNcRgeLfTbQCIZADXKaVHOMF,XBCHKHFAHBCFFBFDdCFHBAAEGAAA..SEAH..hACAWDHBRECCeHEALFBGhAAAfEHAbEEBCBHDAEABDAEFhADA.aFEE...MAIDYHAGJHAAEAFANADF.hACA...cGGAhAIA...,1,-7,-19,12
dUMCKGPOBTecXRJNEAFfLaYQDHWgVbIZS,LECEaABB.DAEFHEBG.VCGFZAAEUDGGCBDG.KGABOFHDhAAABGCE.TFFBeCAHRGEGEDDEhADA.FGACQAGGhAAA..WHAAICCCdAFC...MICAhABA.....hAEA...,2,-19,-13,6
KPEANIMDbQYGdFLcOBXaUJZHfWgCeRSVT,MBDAQCDHdECBLHACBDGDUGABHCGB....fEAFhAAAWFFA.CGHCSBAFhABATAAEKDAEAHIDDFGF.hAAAbFCF.GAEHcAGF...aGCA..hACA...JCCA..hADA...,2,-17,-16,1
CDAdJZKFfeQGRPScgTMWNIVYBObXaLHUE,dCAEKAAAeHCGQGEGRADC...SCCHTDDB.MFFEIFGAhAAABHHGOGAGhAAA.aAFEUDACDCFFAAIHZAGDhACAfHCFcGACNHEB.YABG..hABA..XDGAhADAECHD.CCCE..,1,-10,-22,12
GcLfWONCYeKbTHIXVFDAUPEBSQMaJdRgZ,EFDGSACH.MCEFaFFFRDAE.ZGCCLAHDOBAE.CCFEKGFAHBGBhAAA..VCAFABIFBGAGhABAQGBBdADB.gEGDhAAAfDDDWDEHNEIGeAFH..IAFGhABADIAA...hACA...,1,-11,-14,3
TBJRCMcHXLObfdAVNGYWeZUQSFagIPEDK,VADGGDAE.eAACZDDCUAGASEFF.FCGCaDCH..gEGFhAAAEDGGKABC.BBCEhAEACGHHHFDAXECH.hAAAOAEFfHFDAAGENIAB....WFHHhAIA......hBGA...,2,-22,-16,6
AYVWfLTFdURJcSgaZCDBOXMQeHNKbPGIE,VFAHLACA.TFDGdFEFUBCH.RDGB.JGAC...SCFGhAAAZAFEDEACBGDDOFHHhABAMACCeDAA.NEDBKAHBhADA....PAAFEGFHABBF...fCFHhAAA.FGHDaCCAhAEACDDD...,2,-24,-18,6
TQHcOfUaPAWLMFRIbBKGdXECZegSNYDVJ,LECBRDAHBDDEKDHFdHEF.CEGHZAFC..SBAGDEEG..JCABhAAAQADHHABEOCDGhABAUGCC.AHGGFDFDIHHBhADA..XGACEGAF....hAAA......hABA...,1,-23,-43,20
QEVTJbUHLRPISNMAeXOGFBdcWaDfZgYCK,eHACOFBEBBCAdCAC...aFAADIAGZBEFCBHA.KEGB..EDEA..VEDBhAAAJBDCHEFDLAHHhABARCBB.SGGAhACAAFADFHDE...fAGGYABE.bCBCIDHBhAAAMIEA....hAFA...,1,-5,-32,27
AWKCeJIMNHSXZGdVRgBDTLcUPEYfbaQFO,KCDFCBCE.eEHHJEDH...MDABHCFEZGDAdCADRAAE.BHACLBGBUEAA.hAAAEBED....fGGGhABAaGAEFFEGAFBA..hACA.IFHDNACD.SFFF.hAAAXAFA..hADA...,1,-14,-41,27
MYLWBaAdTDgCIObFGUVQRcNfZXEKPHSeJ,DEEFCCBG.OAHHFGCAGCFA..QGEARAEA..NIBBZCCDhAAAKBCHPGAA.eCADhAAAMFHBLABDhADABBBBAAHGdEAAIECH.......hABA......hACA...,1,-24,-34,10
MFZYPJBNHQdTIEcVUgAeSRXWGaCfbDKLO,SEFCREAGGDEECAGD.DGAHLBCC.FGCEZAEF.PDDDBGGEQCAHhAAAdACGEGGEVGBAhAAAAIBE..eBHF.aGHDhABAbBAD.KHFA.MBIB......hABA......hAGA...,2,-17,-17,0
HGIRMPOKSVeTdBbJcYfgFAELZaDXQUWNC,LBFAZFEEaCDE.DEECUBGGCGGA.GDAERDBD..MCBGKCBCeEEAhAAABHDE...JACGfADHhAAAAGCC.XFDEhABANIEH...IHAASHAAdDAG.hACA......hADA...,2,-39,-24,15
AJSTOFPBYfCdVKcQMUZNRLHIDEabWGeXg,JFGHOHBGBHAG..CBCDKBFB..MCDBUGGCRAAEHBEF.DGCCaDBChAAAGAGG.eDABhAAAAGAGSCAF.hACAFFBAfEEGdFFG......hADA......hAEA...,1,-27,-45,18
fHGSCLTFXOeUZBgcPQaIMYNWADVRJKdbE,DBGBRDEHdEAHEBEHHCBC.GAADSEEALDHHFBCF.eEGFBAAC.hAAA.PBEEIEBGhACAMICC..NICHAAGAKGAFCHBC.hADA...OAHD.ZEGD....hAEA.....gFDGhAFA,2,-23,-12,11
bgMXDUcfHJGSFYAeQBIaPTdNWOCLRZKVE,eDBCQAEGBGFA.aEBHdBFH.OFADREDEKBAF...EBBCMHBADEFD.hAAAUBBAHDGDGCEDhAAAFFDHAHHD.IHFE.hABANIAF.CADB...........hACA......hAFA...,2,-31,-12,19
FVMXLQYaCDGEfecAHBONWJTZdRUPgKSbI,HBCFOGBEJEHBZCGDdHEFRDAG...UAAGKEED...SBEBhADAFACAMEIDLAFFQFAGhAEACAGA.EEEA..eAAFhAAAcGBDACCABGGF..TAGG...hAIA......hBCA...,1,-10,-29,19
dHDMVEJRPZFWeQXYfKcTIbOGACLaUSgNB,aFFAUBFG...SAAEBCFBdHBFHACBMFCD.JFBEZCDH.eDHHhADAXGGA.KAGCIHEAhAEA.OBBBhAFAAIEECDEALBBFDAGAEGFG.FAEC.....hBAAWCAD...fGEFhAAA,1,-25,-34,9
TYbKaOLZDUIfHXWdMSRVBCGAPQFJEecgN,FBGBeBFC....NEEA.TFBD.KDAEaEBALBBCDADA.IDHHhAAAHDGFXBBEhAAAdGGESGDABFFGAAHCJFBFhABAEEEC..gCCBOCABfGHChACAMABECHAA.....hAFA...,2,-25,-18,7
HCcKSWTVUAdJRQBEGfbgZOIDNaXYePFML,JCCFRFBEEDACGEEF....fGEFZAAEOFACDIFC.aCBAXBEDhAAA.eAHFhABAFDFAMCEGCHAD.SHGEhAAA.WEFA......hABA......hACA...,1,-33,-37,4
DeWEMQBAGKUcTYfbHaLgSFCIRJNZdVOPX,KBDEUFFG..TCAD..fCHGHDGFLFDHFFCFRBDFJAAAhADANEAGdGBG...PCEDhAAADIGEEHAABDCHAHEB..hABA....YEADaGHDCGGG....hAEA......hAFA...,1,-12,-40,28
dWcZGUSCQTXeFAIbgLEPMHNVaOKfYBJDR,..ICCGLFGB.ECHBHAGDaFCHODEEKFGDBFHE.JEBDdBBDZAAGhAAASAFA.hABACCEEQDABhAAAeFEDFDEAAHHDgAEDMICENABF..fGAAhAGADCIFWECH...cEDChAIA..,2,-27,-6,21
VcRYDNMATJFHeIOPGUSadZgEBLbQfXKCW,TECAHCCGOAHF.UABEaACGdGEDZFAGEDHDBAAH.QGBChAAAKEFBCAEF.VAEHRAFBDIGEAHACFCCBhAGA..eHACIHHFhAHASFHD..LFFCXDBChAAA...YFEFhAHAMAIF..,2,-16,0,16
KUcBGeCVSPgIAOENbZYDdTJXWRMaLHfQF,EGDBZCAAdDGD..TCACXGFB.RAED.aAAAHEAEFFHH..KCEDBGBHhAAACAGH.SEEFhABA.IAHEhACA.OHCENAICDFADWFCEMFFCfBCDhADAQAEE.....hADA...,2,-42,-4,38
JXVRNaDgeTCSAPKOWbdBMLEIFZfcHUYGQ,KFGAOCCCdBGFLCAEFHGGZDFD.HEABUGCAGDEH.QFDHhAAAVAFA.aAEDeEADhAAACHDHAHHF....PABAhAGAWEBCBBBH.MFCA...IFHFhABA...fACDhAEA,1,-16,-26,10
cDOUKTVgbZGFIHMPBSCQNYXaRJLedAfWE,ECECOECCUFBCKGDB....VDGDZBACFHBCHBAABDGG.CHGF.NAEB.hAAA...aFEHJAEAdGGDhABAAIHG.....WECEhACADDBB....gFGE..hAAA.ICEAMIDASADGhBAA,1,-10,-60,50
eEfKcAPJZRSUaHbBVIGOQWgYNdTCLMDFX,JCCCZFBASGHFHFEBBADBGAFG..OCCEQFAGhAAAgEEDdCAECEGADICAFBAHEAHBhAAAKHGG.ADHA..PBBGhABAaGGA..IABGNEACLHCAMAIB..hAFAXCFB..hACA...,1,-9,-19,10
fLcXFSQJaRIZAWDEKYCdbOVeBUPNGMTHg,DFIBEFCGKFGCdBDD..OAGDBHCEUEAE.GAAHTFDE.HBAFhAAALCDAFGBF.JAHHIDEChABAAAFA.CDHAeFFHhACANEEH..MFFD..fEBHhADA.SAEEhAIAaGGC...,2,-27,-26,1
QHVgOELXbJedUDYMFSBKGTZPIANafWRcC,aGABRDCHCCHE.HFDH.OAFHLHAA.JACAeCBH.dDEDDCDGFCHBKAABhAAATAAC.IHGAhAAAAHHA..fHFDhAFA.QEFCEECFbACFMFIFBAGAhAGA......hAIA...,1,3,-47,50
GCIDbXHQFPKfATRWOaedNZJLSBgcUMVYE,REBBOBBFeHEEZDFDLHAGBCAA.UDFC.MBAFEAEBGACC.hAAADFDEbBDG..QAGFhAAAKAGCAFEFaFGEdHEDNDIC.hABASEBA...gFAGhABA....YHAAhACA,1,-17,-23,6
dUceIPNVAXZJOCSBHTFDKfWbQRLaMEgGY,ZCABCHCABAHHFHCGDDGD..KFHF......fFEEhAAAQEADLAEBaBDEEFECGAADhAAAdGGFeDCHIHEBhABAPBHFAIAG.OHFETDDBRABG.MAEG.hABA....gBGGhADA,2,-26,-25,1
ZPTeSCGNIbYcOfRJXLMWKgUQHDVdAFaBE,BAEGZCAAeFACCHFHGAFE..IGEB..bDEHOCHBhAAAJHBALFHFMFIBKBEAUCCEhAAADFEEdGGEFABAaFAAEAHDSBBChABA.NIAD.fAHGhAFA..WGAA..hACA...,1,-18,-24,6
bCBeMNRGaZgOdUKISfHcVDAFYJQWELPTX,FFDCQBFDEBGD.LCBE.TFGECGGDBDCC.MBCANAICGGAFhAAAaGAEZAAD.OEHFhAAAKEABIACD.hADASHEAfEEDHEEHDICGAEAFYAEEhABA.WDDD..hBAA...,2,-34,-7,27
VNRGIYCcOXWBQHJAFZSdKUgDfaTbPLeEM,FGFBdDDEKAGFDBEB...aHDE..TFBALFABeDFGMEGD.RBEDGCBChAAAIHDECADB.ODCChAAABBAH.QABChADAAABESDHBgAFC....hAEA.fHGHhAFAbFGD.EBHH.,2,-30,-16,14
BFYDCagPZERHNXQKcVWdOSJGefbIUMTLA,BDEBDEFHCFDC.aGBHZADGHEBG..QBACKFFE..VBABdHGFJCDEhAAAeAFC...fCHChAAAIEGGUFAGhABAMEAHAIEG.FHGC.PABANAIC..WAGHhACASGCA..hAFA...,1,-21,-31,10
MXUgPLHSDfFbYdeAaJQEVZIOBRNTcKWCG,aFCAQEBBZDEC.BHBARFAB...TDGCKBACCBDDGAEBUFEALACFhAAADCAB.bAFB.hAAA.eGFGABDF..ECEHhABA.IBHDNCIE.MIFGPHCCSGGEhAEA..fCCEhABA,2,-26,-22,4
ORcTVDQUABPNdKCMEHYJWebLfgZFaIGSX,BBDFdBFEKFCHCGGCHDDA..JEAFeBEALDBCZCADFAACGGEF.hACAOAAETFBGDFEGAHEFMBIDhADA..EAHD.hAEA.YHAA..WHCG.fEGBhAAAaDFAIHHEXADFhABA.,1,-13,-41,28
KgVYdTZOMALPBGUWHecabESQfXNFDJRCI,LFHFBDHFUGFCHDEF.eAEGaBAA.EABBQGAF..hAAAfECFFCDCRAFBCADG.hABAIHCEKEHH.VCAHhAAATEADZACHAHED.WBHHSCAFDGGDYGAEhAGAMFEB....hAHA...,1,-9,-24,15
cgLPQdWHZEOGRJfCDXVBSYbUaKIAMeTNF,TBEDFHGCLEEA.dGBFZFAHGACEJBADDDGEBABH..SGEBhAAAUBECaEABKAHBMEEEhABA.eCCF..NDIE.hAAAgAGD.WEFAEBADfHDFhABA..CGGC..hAEA...,1,-22,-23,1
FCGASWYReJgafHQNZVIKEPLdTOcXbBDMU,SGCGREAAeFEE..aBDAHDDCZCBGKGEGLBBH.dGFEOCHDhAAAcADEBBCG.MIBGhABACAGGAHAE..JCFCQAGFhACAICABPFHF.XEAChAAADGCCFDEEWHAC..fEGFhABA,1,-7,-26,19
TeMPCGOHEFIKXVcZAfDadQWgSJRbNLBUY,aGBGQFGB.SAEFbAFD.BAHCUADGeFDBMICACEECOAFDhAAAEEEBKEGAVAABhAAAACBFDBBAdFBC..gGGFhACANDAE.TDBCHCGFIDCAhABA......hACA...,1,-9,-18,9
HOVWUMPLeCRfTAbJdZIFGaNKcXQDBESgY,JAEGZBAAGBEA.KFAAQACABEGA.SFCEHGBGOGEAhAAAUGFBMIEEeHBACADG.hABATDGF.ACADdCGBhAAAIAHEaBAF.NEAHDCIDgCCG..hABA......hACA...,2,-21,-20,1
CIYMaGREfgXQBSNdPWbHcKODFUeVAJTZL,ZEACCHHE.MHDERCBF..EFGH..XAACBAHFdFDB....PBEHhABAbBFD.KFEGDFBFFAGHhACAeADAAEIHLAHBhADA.ICCDaBAFfHDD..SHFAhAEANAAH..hAFA.cEFF.,1,-16,-32,16
WECVgAfMSYQIUOHLDbcaJdXNZPBFTRKeG,SFGCQAECUEGALECFDHAE.aDFBdBABZADBBHHG.FEDHKBBEhAAAGCAACGHDAGAG.MIDChAAAIBFC.OCABhABAbEEH...JBHFPCFCTGEC.WHAGhACAEAGE..fCDEhABA..,2,-27,-7,20
UAXYcLDNQgVSdRJPeWIHKFGfTbaCEZBOM,XGDALDHDDADB.QAAESAFCdDFAJBGF..eHAChAAAHEBHKEBBfBBAhAAA.aEAHEAGBBEEGhABAMIFEAIBGNEGERCDDIAECFADB.....hACA......hAIA...,2,-19,-16,3
KEBScPUaFDgXITOAHQbZYeGdfLRCWMNJV,HFECZBEHGECFLAEBCAGC.MDAH.JBBCEGGEBEECSDAAhAAA.UGDBDCGGXGBChAAAIHBC.ABAFQEBFhABAeACDdCGH.WFHBKFAGaADGFHDE....hABA......hAIA...,2,-16,-15,1
IRGZdBKYTCOHQMXNLeEAafVPJcWUgSFDb,aFCDVDAH....JACAUGFEFFAB.DBAARCGD.dDHCBEEA..KHAECHGC.hAAAQDDG.hABAMAAEXCDF.hAEALBBFACDC.fCCEWAGFSHCAhAFAIGED...hAIA...,2,-39,-38,1
JWKTOFLacRZEfSPBgDdAQGCbIUMeHXVYN,CEBBUGBAHBFD..XGEEVBCB..JEEHKACF.FBDELHAEhAAA.aAFARDFGEEAE.SAFBhAAABBBFdGGHAEIHQDDAhABA.IBHH.MFIBhADANCACWABE....hAIA.ODGD.,1,-17,-19,2
RNTabMGgYZKDBXdAUPCOSWVFEecQHLIfJ,CCCHSFEBFHBC.EABHQDEB.HAEFIBGFRFGFaBAE.hAAAGCDDZDAF.BHAGhAAAAAHD.ODADeHDE.fAEChABA.TEGC.MICA.hABAKGGFDAIF..dCCG.hACA...,2,-22,-7,15
cWAKFegTQUfPSCbHDMENOIBLdJGXaVZRY,eGEATFEGQACD.UFAAfCGHCFDGHDDG.MIEEEAGHOCGFhAAABCDFdGAB.JABGhAAAaABBVAEC.YEDDhABAADCB..KAEEFEHD......hAHA......hAIA...,1,-10,-17,7
NJHVeEDMXSPBcZaWQYGdIUfOgbLKATFRC,RAAHCBEDHCACEGAA.DGBEMEBE..SEGFBEFCZEAA.QFDGhAAAGGDBdCCFUABBOHBChAAALCHBAADDFAGD.NIBDJAFGhACA...eDECXEGAaHGAIEAFhAEA......hAFA...,2,-15,-6,9
DQCfILEbegWSNRGBHXcMdJaUVYPKOZAFT,DAHFCDGFLEBDEBDG..eEFESHGCGDAHBGCAHFCDMBABhAAAdGGFUABG..PCBChABAKAFBOHDCFAFCTEEBhACAIFAF..WCFENDDD.....hAAA......hAEA...,2,-24,-14,10
fgcGCbeEPLNRQKaDHWSVIZOJdXMBUTYFA,...fBEHgGBECHFG.EFEBLBHHQCEDaADBDAABHABGhAAA.SHFAhABAVDEDIHAAOCADXCADhABAMFFABECFUGCDTAGHAFAF..cGGAhACA.....hACAeCCB.,1,3,-19,22
dcGHUYAZIMBQFfaePgDXWEVLJSTRNKCOb,MFDCBGAEFEHF..aCFCeCABDFAE..EAAAJABA..RBCD.CGEG.OAEEhAAAdCEEHCCH.ACHFZAFChAAAfHAB.gGGHhADAXGFDLHAGNAIEKGCG...hAEA...cGEDhAFA...,2,-29,-24,5
CZDaBPfYFAIEHbQKTJNdeOXLRcSVWgMUG,EGFBHBFBKGADJGFE.dCDEODEBLBAD.RGAC.SDGE.hAAAVDAAMIEE.CEBAaAFAhABAPADCFEGE..AFEA.IBABhAAA.TGCF.NCCF..eFFEhABAWBCC.....hACA...,2,-24,-21,3
VKUSeEbdIcfCQFHRaTJNMOYALZWXgBPDG,ZBDCXFAFBBBFDDDBGBCB..KCHDeAAGdFFC...IHHChACACFAAHGBG.aFGC.JDEDOADAhAAAADGBLHDC.hABAPAHFSAHBbDAA.QGGGhACA......hBAA...,2,-39,0,39
KBbcSHINLTfdCeYGEQURFZMWgDVXaPJAO,BDHASEHBHCAGLAGFdHGD.CHFGGEDDQCEHRACEFFAHZFBEhAAA.MBCFDHCAaGHFADAGOAFChABA.KFFAIBAGhAAANIAD..fEACEEAG.WACBhAEA......hAFA...,1,-15,-28,13
fMTNEZPHKQXdagJBbCDWceSORYLUGVIFA,MDCCEEFAZFBGHEEF.QACBXAGBdCEGaGCDBECGDFIH.eAGHhAAASBAHOBAHLFAHhABAGGDFFACGAIFCNEHAKDCDhAAA............hABA......hAFA...,1,-3,-25,22
dUYaECKIAOFQgDfSLBXTbZGPRHeJWcNMV,OABBQEDCDBFELCEEBDAG..TEBDZEECREAHHGECeAFDJHEGhAAA..NAEDMDIDhAAAVACDdAGB..aFDCCFGHABAFhABAFCCHSCHB......hACA......hAEA...,1,-13,-20,7
AedgUFZWcCIHDNGLYQJVfRTbaXSMEBOPK,eCEGUDCBFGDGZBADCGAFHACF.GCGELHCC.JEFCRAEE..TGAEhAAAaHGA...SAGEhABABCCAOEAEKGHHACAGhACAdADH...cEDFIEAFDAABNAIE..hABA..YFFBhAEA...,2,-21,-18,3
GcLSKYPVRfNUFAWHZgedaXOTCDbJMQBIE,HCCFeECHdACDOEAFDEEC.JCHHBBHC.GGDBLGCG.KACGVDAHhAAARAADUGGB.AHAHZAEHhAAAXEGH.CCDHQBAHhABAEAGFSEFGfGAG..hADANIBF......hAFA...,1,-4,-25,21
NdPGLEUABZXIfMOFVaQCJeYSbDRcTWgKH,BDEBZDDG..XFDAIACHMBBF.FFAFaAAF..QGGChAAACDHHeFAC.SCHDhABADGEHREEA.TAEHhACAKCGCdHGFLHAAACDFOAFAJACD....cGBEhAEA....hBAA...,2,-40,-1,39
gCUTYZSIERDfBHGXFQJcLKbVONdPAaMeW,MACEeCAACFGCUDDG.ZDGHSAEH.RAGDBEABXFEEFFDB.hAAAQFBCLDDCKABChAEAVBAHdEHAABGAaBGETGABhAGA...IHHGDIAE.HFEF.hAAA......hABA...,2,-28,-4,24
ISFXVdeMHbYgZcRDfNETGWUABLKCaOQPJ,BAEELGCACECD.aCEDOBAG..QABF.IGGDhAAASFGCFCAFdDGDhACAHAGB.bDDDZAEADHGEEGABhAFA.TECFUGAEKDAF.XCCBMFFA.hAGAYHEA..hAAA...,2,-38,-2,36
GYIOdBFgPMEDeLAWSXTbfaJHUKQVNRCZc,XECDTDDB..aAACUEFC.KEHHQGDBRBCG.CBDGZDABhABAGAEDOAHFBEADFAEFhACAgCADMEGDDHAAADFAhADASHCA..fHGFhAGA......hAHAJAAE..,2,-22,-19,3
VTNPGMaWfdFbDQJYBUXCOLRSAHEKZIegc,EDABZFEBeDAE..VBDFTAAEGEGAMFBCaBGB..dGADFFEDDAIFhAAAQAAFBGGGXBEAhACAOCHFLDHDhADAAAFCHFBB.IAEDcDBF.WHAA...hABAfCCD.hADA...,1,-7,-8,1
gFGLAMRWbfIUVPeYBXOEcHKNDZJdaTCSQ,MAFFREDC....fHFBUECCVGFEeDBFBEAB..EABAKAABhAAADCHDZEFGdAGF.CFGASHBGhAAAFBGEAIAA.bBAAhABAIGAE..YAEBXACDcGCFhAEA....hBAA...,2,-33,-25,8
CPUNHGWcKJgTFQeZaBYfAISDRLOVXbEMd,DGDFRECFODAB..XFAHMCCA.CGEG.UEGBHCBF.GABHhAAAKABDJBGHFFGB.eEECBFEAhAAAACGH.LHBAEAFENBIA.hABA....WAHB......hACA......hADA...,1,-16,-38,22
aYAgdeXUVHQJTLMBCOZFPESbDfRNGWcKI,eGCEUDBEQGAELEFCCDBBZAEAFFEF..EGDDSGGG.hAAADIDGNCBHGAGCKBADaDDG.hAAAAACEdHGFHFAFMBAGBFGBhABA............hACA......hADA...,2,-22,-18,4
XgNDbBWPZAKRUVcCGIQHaETMeSLJYOdFf,KEDFVDDFGCGC.QACHaHAG.MBBHLACF.OHCChAAAfAFEXFGHhABANAAGBFFGPBEAABIFUGAAhABAIFADECEFSGDHdDGFDECH...hAEAZGFGCGFF.....hAFA...,1,0,-19,19
dILRAXQFZaMbPBSeUKEfCDTcVWNgOGHJY,QCAGaEFH.MAIFBDGF.SAEFeEBFKDFA.EHCGCAAFDEIBhACATBBC..VFDFhADANBAA.OHFEJFHDIBGFhAAAADEBXGBDZDBEUGAEfBBD.gAFEhAEA..hAHA...,2,-22,-16,6
EcYTHOLGNQUefaXDbBCgSJMWVIAdKFZPR,KCFHZGCAEDDG..TAGEOCCHGEDH.QFBCeBFEaCAFDGHBhAAACHHE..SCADhAAAMEGD.ICCHhABAFGAFPABAYABGNEIC.fHDHhACABFDEWAFEAEDAdGAG...hBAA...,1,-3,-27,24
QRPKaeNDELIWMfAZUOTYVHCSdGcXFgBJb,OFFATFFE.HABGCAFB.SCHHGABFFCAEJEAHREAH...aECHDAAFhABALHDCMFEDAICCZCGHhACAVBEHdDEF..XCAFhAAABAHB..........hABA......hACA...,1,-17,-18,1
UKaRVBZSYGTNHAeFbXDJgIPLMCcQOdEfW,eFCDXGDFDAGG...JDAG..IGGGLFHDMBEGQACHhAAAOBAGdDFHECGHfDEChABAKEAFaEDH.BFAEhACAZEFGSDAETGBCAAGA.FCCA...hAEA......hAFA...,1,-18,-21,3
HLXDSbOegVdIcYFaNJPRCBMfWKZTUEQGA,HBAADAHBODFGeAEDdHFF...IDGAFEDBJBBB.RDBHBAGA.hAAAMDAFKFFGTAEFhABA.UGACEDDGQGAHhAAAAEHBLADDSGCA...hABA.bEFA....hACA...,1,-12,-33,21
IQPTXJfCMdScYFKEZbaDLBeGHVRgAUNWO,UFEGOCEEQCBD..XACHCGAGMAAB.dFFC.SFCFhAAAFFCCZAEHDGIHBBAFhABAeCHDHAFG.gEGHhACAAIDA.IFAB....hAEA......hAFA...,2,-35,-32,3
VBAYWEMKIDGcLCOHPbJdZXFReUgNSaQTf,EEGAKBHDDDEGLAGHHDBC...JBDFXEFGFBAB.RGBC.eGBAUGGAhAAASGEAQADFhABATAEBBCABAAHCMIFGhAAA.GEAHCEADOABF.dGAGNIAFfCBChABA....hACA...,2,-12,-8,4
FVbCHYBNXZDOfeRLSETKAWMcdUaPGQJIg,MBIHUGAHGDEF.QAFEJAGFFBEHCGHG.BGGCZDAG.DHDC.eADHhAAALABD.TGEGhAAAAADHdBBAIFDEhABA..VFBCYCAFNIAHOEEESHFAhACAEACC....hAFA...,1,-17,-22,5
MdBaAKCURGWSQNLJVTEFOcZPXDIYbgHfe,KEEBRGFCGEAEQDADLDFA..JCGDECDFFGGAOBBAZBAEDEDB.hAAA.IGDC.hAAA.gGAFhABAHAFEMACGBHFFAFFCCBAGSHCGTCDGXAGGhACA......hADA...,2,-30,-5,25
NcIETWMVZKeCgOaBPHAXGJDdFLYRbSQUf,XFFADFBHdGCGFEGALBDG..RFEHQDDBUEAE..hAAAfFDF.hABANEDBEABFWCCD.MBBGhACAKHBACHDEOADABBHBAADEGBEH....hAHA......hAIA...,1,-26,-29,3
PgSJUYRNQKdWALEIeaHFXBbTMOZGcDfVC,EDFEeCDBHFFFFABEBFBHMFEFZEBBGBED.DGECCBBA..SBGBhAAAUDFHRGFA.KBDFAIDGLFADhAAAIAEF..aEEFXBAGhABAODAB...fAEH.hABA......hACA...,2,-21,-17,4
AUJKaBdXeFYHTISLcgCQfDbVEZPWORNGM,JADCaGABBCGF..dFFBeDDFFDDCHCFC..IEBASBABhAAALBHHCAHD.fACBhAAADFIHEGAEZCBDOEFChABARFCDMCAHKGGF.XBBG.TGBChAEA..cGGChABAbFDDWAFC.,1,-14,-31,17
cBGbSZReIACaMLHQEOfTPFKDYXWgJVdNU,aADAMEDGHBCH.EHECTAEA..KEFFXCGEJHAC.dEABNDHE.hAAABCDFGAFAZGAEeGFEhAAACABBLEBGOFDG.hAHAfCABDIGC.YHEA..hABA.gAGHhACA...,1,-12,-20,8
ESDXZAMeFHgCVWPIQUGfJdLRTaNOcbBKY,MDEHHGFGVEAG..IDBAUADBGEDCdBADLDHFRCDG.hAAATAFHaAGDOFFGhABABHCAKFACSGADhACADAIBAIFEeDFFCCHH.QADAfBBC..cGGHhAAA.EHAA..hABA...,2,-21,2,23
BXIaMPQKZYCbNGUOESLVAJfedFgRDcHTW,JCFGdFGARDDHHACDBGBF..aGBHQCAC.KFFFCEEBGEFChAAA.OAFGLADEhAAAAEADeBADFCFADIBC..hABAcFCCWAHBXCCFIHHD...MIFEhACA.....hABA...,2,-28,-22,6
XTYVLZdSHFCORWePaBGgMJUbfNDAEKcIQ,EGHBKEGCQADA..TDGCLGDGdCCFSDDGhAAAFAGCCCHDOEDCeAEBBAAGGGBFhABAJCAA.fFAChACAADAF.XAFBZFBH.WBBD..hADA.aGFFMFIB..hABA...,1,2,-30,32
XAaIPbVfBFgGcNHLCQDSRJOKeZYWdTUME,aFCG..PACE..bAGFVBAB.FAGCGEEAHECGLGFGhAAACBCCSDCCJCHFOFAChABAeEHDZEAFdDDBMAFFhAAAAICE.IBAD.fGDE.hACABHHD.NBIC.DCEC.hABA...,2,-17,-5,12
QOKWbPAHgeTGIaXUBdDVEFZRfYCLMSJNc,HADFTAFHaHEG.UBGABCBG.dFGCEEGDFDEDZDAD.RGAA.CAEFLAAEhAHA.MHCGSFDEhAAAJBHD.QABBhACAKECF.WAFCACCG.......hAIA......hBBA...,1,-5,-35,30
KYTScAUMfDHaeEQOPRFLCNVZGgXbdJBWI,UDGBMABHHFECEHFE.QCEAOCBCREAG.FFAELADECCCC.ZFEAhAAAgACEdHADBHDCKBAFhABASHBA.hACAABHFDAFEaBHB.PDDB.NIEB.XCEFhAHAJCHD......hAIA...,2,-13,-1,12
JGUYLaSEfCIDPHMVdcAgeQRWKObTFZXNB,QEBAKCDGOHBE.FGBHZCGHBDFGGDBCLAAA..EHGCCFHADIDEhABAMBECdAEAAGAHRBAA..hAAATGFFJGDA.aCAEIEEFhABAHEDA..VAGF.....hACA......hADA...,1,-8,-23,15
UHMcEgCFRZBbYSPDaQeKfIJGdTVXNLWOA,MDIBECAEFCGBRAAG..ZCDHBEHB..SEAEDBIDQGAGeGEAKGBHhAAA..JFGFdAGCXBEBhAAANDDGLFADABBCUECChABA....cADACEAFbFED.aCAC.IHHBhACA...hACA...,1,-5,-30,25
WgYSEaFPKdHJCBQDeNfcXITbLMAUROVZG,OHEGZDFGGAEB....gAADEHFEPEDBHDCH.CGAAQADAhACADABFeEABNECC.hAAAXCGE.IEFGhADALACDAFBARAFEWGFESFGA.hAEAaHAEKHDA.BHAD.hAHAcBDC.,1,2,-9,11
PTEgRdBWKbFXSAGMQHcJaYVZfODLNIeUC,QBBFHFEGaACCZBBADIDALBGD.eFBHCAGGEFBAdEAABFGCKHDGFDEDhAAAAHCFMABA.JDED.hABA.YAHB.hAAAOADAIHAD...PFHD.hAHAgBDHWFHB.hBAASDGA.,2,-32,5,37
JHZDcPYAafWNGTLKBCVMdXbRQOFIeSEUg,aAHF..fFFGGACAKEEHBECA.CBDAMFABdAABXFBBhAEA.RDGDFAFDeAEGEGGDJEFAhAAADBBDPBBB.AIHCTGDEhABA..LHBA...hACA.bBFAOFAB.hADA.SDDB.,1,-9,-13,4
NXLEDFIGOfQSBZRJgeUVCMWcHKYPAbTad,aGEBdAFDLDHB.DBDDICGEGCDGQFFABCDFZAAEJGFGhAAAeHCEUEBE.MHAChABAHDAH.KABEAAFB...hACA.NAIG...ECFBfEEF..hAEASAHH.hAGA...,2,-35,-9,26
CdbJUAZOQcWSIMNVRXeHKYaLDfTBEPFGg,QACDSGBDMCBERDEHHFAH.KAFCLFEFDCIBBHEGFACCCHHB.dAGAhAAA.JDEEAEACZAAF..hACAOBAH.cGFHhABAWCHD....NEDAeGFCaEAEEGGE.PDHDhAEA.....hAEA...,2,-23,-8,15
GCQcITLbaPROXJYNUgFMWfSEZAdBVDKHe,BFGFVACA.KECEGEDB..QAFH.TGCBLCCGhAAAaAAH.OGDC.hABAYBHFNEBEFBDDMFIBhACAfBAAEGEG.AGBDDICGCADFbCFAXGGDhABA......hACA...,1,-15,-26,11
CgUNKOZScRdPXALBYfQIFGbHVeEJWTMDa,BCHBQGCGFGHBHDAEEFEC...JDGDTGGG.DEFCaCAACADEUAFEhAAAKGCCZAFE..SFBDhABAdADEABAGLEEBhAAAIBCB...bCFAeHAEgCABhACA......hAIA...,2,-22,-22,0
cYeOTSKRHbIEFfJGWNdaVMDUPgLXBQCZA,eFBEOBGFKHBAHADG.EGDEFDEGGEDBdBGFMHEGUDAE.LHAAhAAABABACAED.ABAE..cCCDhABASCCB.RCGF.hAAAfGGE..NDAADGIB...hACA......hADA...,2,-34,-9,25
XSbGMAKfOCWeUYTHVZRNJDgQEFBPdaIcL,KDAFCHHDUCEDHFCF.ZCEFRBAC.DDEF..ECHHBHFF.dAHAaEBALAAEhAEA..SAEChAAAMAGFOBCHeFEETFGDhAFAJFBHFAGE.IHFG....hABA......hACA...,1,-21,-31,10
NCJOVISBLRYHcUXAdZaKFWGPeQgfDETMb,aDCHFEFGGFAB.eCAFfHDH.EEGEMHDA.CCEEJAAAhADAIADDLAHDRAEHHFFHhAAAUGGEdBACKDCGPGAAhABADICE.TDDF.NAIESCBEhACABBFE......hAGA...,1,-6,-19,13
TKPUeHZcgaLfNMWFDXbYJSdGVOACBQIRE,BBCGRCBBKACE.eFABZFEB...aFDBLBFC.MCHHFFHBXGFHhAAA..YFDDhAAAdCGBOAEF.CAHEIDADhABATGGG.PEEAHFADcBABhABA..fCDChACADEEA..,1,-24,-27,3
BDdQKZFNWLRGHAPIbCTegVJSXOfcaEUMY,..IHHDCGEEeAFH..JACAOBGB.aAGAUDCA.MBIHDEADdFCHhAAAKGGC.FCDHLBBDhAAAHACCACCD..TFFFhABASAHFfHBBEDGDBFAHNBBA..WDHBhACA......hADA...,1,-21,-32,11
DQaVIYWNgdEOfbeTRSMJHGXAUCFKcBPZL,FBCHBBFFLEACDEGG.QGCFVCAH....IFHHhAAAWEEB.dGDC.OABAhAFAbADFRCFD...MFFDhAGAJBHHXGAHCHHDKHACZCFEaCCAgGGA.hAHAfAAF.hAIASAGEADDF,1,-9,-29,20
cDeAHgPdUaEfJOTbGVMNKQLZSCYXWRBIF,HEDGdBABaFDCEAAC.JHEGOEEA..GAGEMAFA.KGBALEABhAAACGDE.XGGGhABABDAGFDCBDDIDAAIF.UBDCTACHhAAANDCG.SFAF..YHBGhACA.....hAEA...,2,-26,-12,14
TVOBaLQYFNKJfcgbXHSCIEeMPRAGZDWUd,DCCBdACDOFBFBHBDLFEBFECA..JBHD....gEBAhAAAHFFCCAGH.eBDDMCDChAAA.AIACGBACZBEFUGGChABAaGDHYDAD.fDHCcGECSDDEhABAIGDCEAHFhACA...,2,-29,-17,12
aZMSHbgTJYWDVLAOIfKXBeFQCURPGENdc,ODBBKGBAeAHHFCHFUGGEGDDF..ECADdAFGZDEBMHBC.HABBhAAATAFF..WGFAhABADCCGLEAG.hADAIABHBAGACFGHNEACaHAC...SDDBhAAA...gDGAhADA,2,-27,-12,15
PHKEWJaCVcBFdSXZMQNOeADfgTYUILGRb,DFAGTAGAUFEH.LBCDRFFBHDBBKEHH.EBBCaDGF...CHHCBHCChAAASBDH.XAEBhAAAMAED.QGCDhABAeBABAGCE..fAHEIDAE..hABAPDEE...hACA...,2,-47,-2,45
fVQDLSEFaZdYcKgHOTRCGAPUbJNIeMBWX,UGBFJAHF.eAFHMDDGBEBG....fFFFQDEFDCCAhAAAEBCEFCACdFGB.KCAAOHEChABACAHG.AGAE.NAAB.IAFAhACA.XGCCSHEGZEBCYABGhAIA...hAFA...,2,-36,-23,13
NcMEaWQOGIZADeYCSXFdKHLJbVPUTfRBg,DEAECAEAFDEHKBGD.LCDH..bBBDUGEGRBFE.BDHB..NCAE.hAAA..MACAEEHBQGDAhABAOAADZFBFAGHDeHAGhACA.SGFA..dGAC..hAAA......hAGA...,2,-39,-17,22
fQAENbBKaeLCUTPdcFJWHGZVIYgSOXRDM,EFEEBEDEKDCAaCAD.LCEAUAEE..dAABFAFFHGBAZEGF...IDGDhADASFFHRGFCDIDAhAHAMIEE.AIBGeDBHhAAACAHA...TABAPBBH..WHAE.hBDA......hBEA...,2,-26,-21,5
cTWRPSCQfXgGODLeFIKHUBEJYbVAZNaMd,ZAAFMFFEdHEH..TGGGRECECCEC...QABE.fAGChAAAgEAFDCHHLADGhACAFAEFHDDAUDGHhAEAEFDBYDBDAHCEaHBC.cGACSGGEhAFA.OAHBKBAD.BHHGhAIA..,2,-15,-14,1
EGcKaYVRNfSJULZbTeCXHIFPOBWdAMDQg,DFDEQBADEBGF.GDFEaBCA.RBFGSFACJEAB.LHAGhAAAbAEB.CAEDIDEBhABAOFHBdHDB.ABBDMBAFhAAAKDAANEIE.ZDDAeECH.FHECBCHA.WDCDhABA......hACA...,2,-28,5,33
FWMQZCSXLONaEIGcDfHAVPRgbKUeYJdBT,RCAFKBDAUAFEeEEC.dFGGBADB.FDFAQBAB.CDHBLFAEhAAAOEECEAAH.GFBDhAAADBGDAHAC....PDBChABAgGGF..JHBEMIBASADEhACA..XCCDhACA.,2,-35,-18,17
FABDZbdHKQJRSLPXWaCGYeUfIOMcgVTEN,BGEEDFACdFFHQFBBRECF.LABEXCCEaAGDGAAF.hAAAUBGCIDHB.hAAAMIAEgGEGhABAVBCDEGGEFGABZEFCKDAASAFFCHHH.eCBDhAIAOADA....hAHA...,1,2,-17,19
RWOdAMHKUTVXJbZLcBEYegaSPNFGQCfDI,KDDGTGGG..VGAAJCBA.LCBFBBEE..EEEFeHEA.aCDAhAAAPAHD.FEAFCABDDDGDhACARGBA.dAEDAFGAMAGBhAAAXEGH..cECGgAGH..hADASBAD.hAFA...,2,-26,-23,3
YUJfKePZCRdWNGcaQSEFVXObHIAMTDBgL,TCBFBBBFLDFG.JFBGKCHB.ZFABdDABGADH.QGFEhAAAFGFBVBFA.OFEBhABAHACFAHIFDGCD.gDFBhACA.fDEGCGAGWHAA...hAAANDAA.SFFEhABA...,1,-7,-36,29
ZGHbcLFNYXATOPJVESUBadIeDWCgMfKQR,TGAAJFAF..EHFCSEGDBCEA.aDDEdCGG.DEBC..gGDEhAAAKCAFREED.ZAFEhABAHAAALACFFFBA.hAAANBBGAIDE.OCGF..PEHFIHHBhAEACHDFfCCHbECC.hAFA...,1,-10,-31,21
dBYMJKTDCNgWXfHUIAGOZPVFSEbLQaceR,ZFCEVCEFFFAH..EBDHQCFF.eEBABEAA.MEHFJBAFKAEGhAAACGFA....WHBAhAAAfGGEHFACACBFOADAhABASBBEaBHB.dCCHDGIFNCIE...XBBBhACAIHEA..hABA...,2,-27,-17,10
PaNVCTeWdBgMXHEIKGUSLbADFJYQORZcf,FHBAQGFDOECAZABH..PBCE.aEDDCGFEeFAA.dAFChAAABGAEMEHBHCADEDAB.hADAKDFG.SAAAhAAAAEIDDGEF..JAHHYAHF.fGCEhABA.NEIE...hADA...,2,-27,-24,3
eSZGEOMCHPfRBYWXQNDVbIKJTdUgaLcAF,SDCBZEBGGADFOFGBMABB.HCGHRBEFBAFE..XBBHhAAADEGEVFGBIGEChABA.KGADdADCaDEFAIBGEGDDhAAAfGCE.WEACbAGHJEBH...hACA......hADA...,2,-19,-11,8
FHDYWXIcCGQZAdKNJEVRbOULgTMPBfSae,dACGKAGCECGGREBEUBEF..LBEF.TAABMHDGBHBC.hAAASEGDFGGCDFFGXDAChACACAGB.QFCHhADANCIA.bFADOHFEfCCEeBAH.hAAA.WDEHcCFHADDD.hABA...,2,-39,-9,30
CRXKLAUOeHZTGfVYMNWIDPdaFQBcEJbgS,UCDCeHAEHBBCZGFCGGAFVEDG...MAFGIDHG.DACAPDABhAAAdGHEFBGC.BBAFhAAAJEFG.SGEAhABACCBB.KFAGAFDGTBGB.fABFhABAWAFCaDEA......hAEA...,2,-29,-5,24
TYVFIKdXJEDOUWSMRfgeBbHcZQLaNCGAP,TFECVDGB..KGBEJAAA..EBEDDAIBUAGD..MAGDRBBB.eBEFhADABHAEHFAGZEDBaGGEhAAACHGEACCFFHCE..XEAGhABAODFESEAC..fCAGhACA...hAEA...,2,-25,-21,4
ePcFUBYKOXHNLDEAafdSJZCIbMRQgTGWV,aGCBSEDBZDAB.CEAD.MFDC..RGEEQCGFTBCH.VADAhAAAeAAH.FHECUGAAhABAKCFGOAFCHABBNEIGDDFHhADAAEEGfEGD.dGHCIAHG.hAAA......hACA...,2,-21,-6,15
acYGgRNeIfdPTMZDKBWAbSEHQFJOLXUCV,EAGFFBHDOFEFUGFA..CEEH...aFAAGEBCRAAD.eAABdEEFTBEChAAAMEIFZACB.DFADBAEFhACAABFB.SHBEhADA...QGGHJBHD.XDBEhAGA....hAHA...,2,-27,-25,2
ASfUMcgCYEZNRVBdWaPODITFKbGeLHQJX,UDBCMFGF.CHFC.EADHZDEHRCEH..BDAHdGBH...aCHDDAFF.FACDKHCC.hAAAeFBEHCGF.QAGHhABAABHDSAAG.hACAfFAG.gCCANEAE.hAEAPFHDIHHE.hABA...,1,-27,-31,4
KENLPaRFBWbDMfGAQSCeYUOgIcVZdTXHJ,SCHBCBBHUCDG.ODDE..IGFDVFAE.ZEBCdCBAHAFGhAAAEHGELAAFhACA.aEGDBGCHDAFEMAEHhADAfGAHAAIDeHBAYADE...hBBA......hBCA...,1,-11,-41,30
YDJBEHWVGdegabLRQIFNcSPOAfMKZTCXU,MEBHKHCGZEFB..CDDAUCABJECB..BCDCHFFCGCAEdGCF..aDFGhAAARABC.FABA..SAGAhAAAAAFF..fAGAhAEA....YEHBhABADAIBEEFC.WEEF...hAGA...,1,-32,-39,7
FDKPVLGUHCYAbefQIOEXaWRTcJSNdMgZB,eCDCQEFBEEEF.aHDCRFGH....JCBDdFADZAGDDECAKABELACDhAAAUGAC.CBHFAHHG.IFDFhABAOADE..XDGEhAAATBEH..NBBCBHAA.....hAEA......hAGA...,2,-25,-21,4
aUOFARTbMLWCXQIceHGDKNEVBSPJZgYfd,RBBGTCCGMEFF..LBAFCCFG..QFGBeFAHDHGAEEGGBAHAhAAA.SGAHhABAZFBB.fGCFhACAaDEGUAGFAIEGWBDE.IHFH.HDFG.hAAANDAA......hABA...,2,-23,-14,9
bWEONLXfBHKeMURVPTYgcFJGCQDSZIAda,aDCBEDCDLHFABGBAHAGDKCGH..MABDRFDF..TEAH..hAAAYEDCFHAEGACDhABADEHFIADHAEEA.hACAdGDHOFFANCIA.fAHGeCCE..hADA......hAFA...,2,-19,-16,3
TFLbDNMEaCcRAUBgJOdIVZSeGQPfKHYXW,BADBODFEdCDEZFBGeBFDGCCD..QGCAKEAAHACEXAGEhAAAFFFHLFAD.DACFhAAAEGGHCDBH.AIHGJHCC.SBADhABAPBHBfBAA..YFFEhACAWEHH...hABA...,2,-37,-4,33
YDcCLIPHNZBMUaAOVbKJeESdXQgTRfGFW,VCACKCDFEAHB..dFBCQCGCRGFE.FFGBDGCCLAFDHAFEBFGBhAAAMAAHAHDDOABChABA.eDECgDAFhABA.TGBA.fECG.hADAWEEBCHEDNEAEaEDCSBCChACA.,1,-15,-27,12
MgGNEQAFbCZPVRUKOaTLBDYJIXWcHSdef,FDFFCDBEZFFGRCAB..KFGBOEEA..aAEABBAH.DABEJFBD...hAAA.XGBHHABAeDDBhAAAMAGFGAGE.hAEANDIE.EBEFACDG...PBHD.UEBH.hABA.YFFFIHHDhAFA...,1,-16,-39,23
bTCVENHgfRdaGQXYFIDcSeBKUOJMZPALW,LAFATCEH.EBBGHEFBRDDH.aGAFGDAAQECEFFHFDACASBBHhAAABDHCKGFFOCEAhAAAJADEPHCA.AFIBCBAE.hABA..NAHA.dHAHYHFG....hABA.eCAD.MAIFhACA...,2,-19,0,19
dTOMcGFSLKVeYBXbNIAgRPDfCZQHEJaWU,RDEADGCHZFGFHAFE.JDAEUBCB.dAAAOFEGGDAEFDGCLFDFhACA.KAHBVAAC..hAAABAEBXEBA.hADAIHGCAGCF.fFAECHAG.aADFhAFA.MFIBeAGD..hAHA...,2,-23,-16,7
BTeZPXYKaCNSUIQFVRGMfAEcHLdWDbJgO,EFBBHFBGLAEGDFFEJBHD.OCCBBDDEZBAD..XGDCKGGC.hAAACEGGUGGGQAFChABAFDEGRAAC.MIFGAFFD...hAAAdADCWFAD.........hACA......hAHA...,1,-18,-31,13
CdEOMBeYUJWgcNXPIQaLKGADfHbRTFSVZ,DFGGHEDDRADG.TCFEFGDG.ZFADdABE..EFGAODAAeBADUAFB.hAAAJBBA...gGFGhAAAcGAB..XGGFhADA.IEEH.LHCAhAFAAICC.bCFESCHHhABACAGE,2,-40,-12,28
XNQUeCKScFRbJYWZTdHgAGLDEaBMfOPIV,DDBDBEDAMADEOEAH....IHEBXAABQAAAhAAAUBEECEGF.SEDChAHAFGGHRGCC.JGFAZCBDHFBBhAIAAIBCEBHDfDGB.NCDDeFDC..hBCA......hBDA...,1,-16,-33,17
VRMfAdPHaKEGIbXeYQWSFgBcULTZNCJDO,HCEEKCDDEEAGGEBC.ICAAXDGBeGFAQEEAFAHBBFFGhAAALGAAZABCCAEEDIECVAFEhAAA.MEIBACCAaDDHWABEhAFA..SGADcBBB..NIAB..hACA......hADA...,2,-12,-5,7
TAecPZMWRVFgEBCULfXdKGYINOHQDaJbS,eEACZDCCMHCGRDGB.FADBBGAH.LBBGdAHAKBFFGEGE..hAAAIACHOCABDGBChABAbFDFAEEC...PAEGhAAA...gGFGCABAfGAGYCDGhABA...NAIGaHBEhBAA..,1,-11,-37,26
PTGdCKSWZcVBaJeEDOFHXNUgIRfAYQLMb,LCAFMAEE.TABHCGBGKDCCZCGH.BFEAJHCCDCEE..FCABXDCEhAAAUGGA.RDFFAFDDQABBhAAA..hACAPHFGdECDSHBAWAGB.aBEF..hAIAeFBF....hABA...,2,-30,-24,6
UcAYZaBgGFDJTKNVOPMSdbERfQILeXHWC,ZGCGBHGEGCBHFAGGDABCJDGF..KCCB..VEAC..MFBAdAGAEABEhAAAQCGF.hADAeBBFXAECHCEBCFHDhAAAAHHH...aADENAIASEEFfHCF..hAFAWEAD....hAEA...,1,-14,-37,23
IcWHaXZVMGgSLfKJeYFOPNCRdQTUEABDb,BFFCDCBF...IBCDHECDaAAG.XAFEZFADGAEG.SAADhABAKGFAJEHHFCEHOHCGhACACFFF.QGGAhADAEFABACIH.bAGHcBBFMDEB..LEAEhAEAfADF...hAGA...,1,-11,-29,18
VQBXUdNFcYGCgODaMRJbLKATfSZHWPEIe,SAEBZAEHHABGEGCEeCCHBAHD..XGBDUGFEFCAAGEFChAAACEDB.DAGBMFFE..hAAAJBABKGAAfDHGhABA.IFDB.dAHANIAD.YBEFhACA..aAGH..hABA...,1,-3,-28,25
XUMFBYROWQGJCDNVLAfacgTZSbKdEIeHP,aHACTEDDZDDG..KHGCEABC.HBGDUBDFMBADBDHDRGEE...QAAFhABAJFAACHAC.DFGALDDChAAA.ACEEcBCBhABASDAAdAGF.eGBA.FBGE.OFFBhADANDIC...fFAFhAEA,2,-23,-11,12
LWOdXYGTPSUZgDBJEIcAMQNaVCRbeFHKf,QDBFVBCC.RAACFGBGHEEH.LFAHdFDAGAFGTGCFUGGHhAAADFIHBHAGEBACIGGBhAAAAICAMFFE..CAED.bCGBhABA.KDAEODAH..PAEG..hACA..SCCEhABA..,2,-11,-8,3
SGVHefBJOAEdcIFDaKgXbLURMQYWNCPTZ,dEDAFBBHDFADaCEE..KAHF..XEBAUBAD.RADH.MFGH..QGCBhAAA.NCIA.hABATGBFZEFD.SGAFhAAA.HDFGBHHFABDAIEAGhABAgCEH....YFHBhACA,1,-25,-39,14
fLMTRQGWDHCIgKSAPBOFaEVXbdcZJUYNe,OEFEFCGEEHAE...VBFEdDBFZCEB.UGFFeBAHLAAERFDEGGAHhAAADECBCEBA...KEGDAGAABCDHhABA.aACGbAEC.hAFA............hAGA......hAHA...,1,-23,-31,8
QMePEWXbJRfAYgdVNHZOKUBGSLTDICcaF,dAHAHFDEKFAEBHABGCEETBABDADC...CDDBFDFHeFHD..EFAGXCAHhAAARAEC.ACCF..hAAA.YCHDVGCAOBBAhABASHGG.cABFaGFDMAGDWEAEhADA.....fFHAhAEA,2,-26,-12,14
DQWGLJRAFBcZXgbSUVCfYNTEOeMdIPKaH,BHBEXBAGSCFGUGGA...CACF...NEDF.TGFA.hAAAeFECdEAGIHCChABAKDHHDAIBQAFBhAAALDCFABHHFBCEZEFGVEACfBDBODDCaBAHWAHBhACA......hADA...,1,-9,-30,21
RVPAJGZTdfaNCeUXWQKIcFHEYOgDbLMBS,ZGAEdFBEaBCHeDCC.UEEBQBDF.KDEHIAFHHGFGOAGDhAAADACHLHEGBDAASEFHhABAVBGB.AFAB.hACAJDAHfEHECFHA.XGDHFAAFEBDE.hADA......hAEA...,2,-18,-8,10
AFINJbOMdQHKZUfTVSgPLDaCRceBYXGEW,FBDFJHEA.MGFEdEDGHBCEZAAD..UGAG..TGBF.SBGFhAAAgDGBDDIFCBFB.hAAAeCAHBDFG.GDADhADAAHHCIABHOAHDKEFA.fFAChADA......hAEA...,1,-25,-29,4
JPMGgWETfbRKCDYeaXHULIFZQcdOSAVBN,VFCEBFEBJEGD..MEBHGFAH..EABH..TCCGRADCCAGBDGGGhAAAeACGHCEBLHBAhAAAFCHB.QCEGhABAdCCGAEAHPHFGWAHD.KBBFaBAHIHHG.hABA......hADA...,2,-13,-12,1
JNWRDYGBeIFCbHfPAUQcOSEVXgMZKTdaL,UGDGOAAFEBBF..XECBZBGFdEDHLEBD..NHDFDBEAhAAABGHHFGADHADB.fAAFhAAAPCFBACHHSAGEhACAMAFA.aACDWCGD....hADA......hBDA..YCHB,1,-22,-30,8
feMGRDUIOFCJKYBEcTXNaLdbQSVWZgAPH,HAFGMHAARCDFDGAD.UBAGFHFG.KGHBBCBA..EHEA..XAFGhAAALDEAdEABSFDHhAAAVCGBZABE.ADFGeEBBhABAOFECCACB......YFFENIAH.hABAaCCF.....hACA...,1,-13,-22,9
UgcfeLXdQbCSOPBIDVAHYRTFNJZEMWKaG,HEDARCECFGGBZAAFMCHH.aCAGUECF....gAGEeACELHCEhAFAdDDFQGDBhAAA.SGGBhABABAGADFGCABIDTEAEEGADKCCEfABF.hAGACBDA......hAIA...,1,3,-29,32
DHBgFJMGfeEWLdSRbKaOPQVNIZAcXTYUC,TDGGCGCDDEBH..BAFFFCEAGBBC.eAFGLEHFRFEF.KBBDhAAAPEADQAGEhABAIHHAZFEFAGGD..cAAGhAAAXDDG.HCFHgEDFMIBGEACChACASHCG.hBAAaADB..,1,1,-27,28
BHWITeVQLPbGgJXOFDCAKcZSMRUEYafdN,ZBBCRAAEEHECaGBA..dEADBEGGHGBE..TDBDVEEELADHhAAA.GAGGXEEDhAAADDIFCHHGKAHH.MBDGfCADhACAIHAE.eHEA.....hAFA......hAGA...,2,-29,-6,23
DFOEVdLBKWecASJXfCTRMNIPgUYGaQbZH,SACBJDCG.CAED.TBGF.MFGHNEFA....PABBhAAAUABFaEAC.QGBDhAAAZFCBFAGHOEGBhAFAdFHCLFEHKCDGeBHHABECfCAEIHAG.hAHA.YEHB.hACA...,1,-16,-27,11
NYgVMCDcHaZELeTAGFbIUOPRXBKfdSQWJ,FFFBUGFDRAEEBDCCKDCB..dGBC..SFCGQCFC..JAADhAAA..NBAF...gGABhACACCDEDAHBHCAHEEHFhADAeEFAAHID..IEADPFDD..fAEBhAAAWAHB.MAIDhABAaDFA...,2,-33,-29,4
FOCceXTQLaYEIGPSbAKJWgDBUdRZVfMHN,JDGFDADFBBHF.UFFCRFACZGCG...MAACHFDD.OCEECCBF.hAEAeFACQAFGhAHALAAHEGGD.GCDGhAIASHGAABEG.KAEG.WHAC....hACA......hAEA...,1,-25,-34,9
XZYMCTDGUOEPFdaRcKWJeHLbQBfAISNVg,SACEVFEC.ZCCFCDGHGGAHUFGE.ECFFdAAE.RAEH.KDCFJHBGHBDDhAAA.LAFAhABABDBFABHH.IHHC.hAGANBBA.XCGA.TFEGDIEEFACG..hAGA......hAHA...,2,-28,-7,21
AFJTGWeYMgSPCUaVQLODXfEBIKNdZbHcR,JFHBTGAEGBCF..eEBCMIDG..PACACHCC..aGDAQGDAhAAADAIB.XDGDhABAfAFFIHGFhAGAdCAEHCGHADIHWCCASAAC.UDDHhADA.OFADKBBD.hAHA...,1,-8,-25,17
YeMaGRNfPVTAJWSDHBQdbCZKOEIXLcUFg,JGDCSAHFHCFGdADBCBBA.ZCAH..KFDBOGACECDF..LAAFhACAFHGE.eCGDaCCHGEEDhAAANDIA..PFABhADAAABCDIBABAGCQGFF.IEBEhAEA.XGBD.hAIAcEEA.,2,-17,-9,8
EWKgHBZVFdMGRISDNcQPYbALaCfXUOTeJ,aBDBXCGD.UAECOBFA.eAAHEDDFKACDBGFG.ZDGBVFDBhAAAdFCGMFAB.GCDChAAAIHACDICANAEBPBAFhABA..AGID.CGHHfEBAJCBB.WFFBhADA.FAGE...hACA...,2,-17,-14,3
FLEZNaATfKeGSOMXdRHPYBcQCgbIDWUJV,TAACKCHHGDCH.OHCCMBFDdCAD.REFGHEADBCCBCAHC..IGDEhAAAUGGCFAAFEAGDZFAGhACAAAIF..SHAGhACA.XGGEYAFD..gCGGhADADDAFWFFC....hAEA...,1,-9,-29,20
FHRYOSabXMfCWUecgLADPQJNKGVdIETBZ,DCDDJCAFGAABdBFH..EAAEBDEFFEFBHFACOFBE...aHDEMCIFhACA.CDAD.UCFEeHEGhADALAFGAFAC.QFGChAAANIAFKGGE.IDCC...hAEA.ZCECSGAGhABA..,2,-22,-20,2
QVUGYRPcETLCdDbBFgNIfHSZJKXOAaWeM,eDBEQDACGEAFRCFH.EAAGCABA...dDHCBEDBFBCE...IHGGhAAA.HGAASAGAhACAKEHFAAGE.aGGCWAEBhABAMAEE....YHCGcGDHDIGEhADANAIE.fFEFhBAAXBCD...,2,-28,-18,10
PKbWBfgeAZUJQMOCLSEGIcFdXaNVDYTHR,ZEBCUCBDJAABOBHB.LFCEEFFAGCCBFFHH.dEHE..aAAGDGBHhAAAHGAEKAGABCHE.hADA.fAFEhAEAAAEE.MBBECHHBSHDEXGEC....hACA......hADA...,2,-36,-14,22
eLfcTgDRMEAWaQUNFVSGdZBKOIYCXPJHb,QDFAUGCHFHFAGBFCdEHAKGCE..OABFCGAF..XAFEhAAAJEAG.HCBBLADFhAAATBDFDFIDMFFDAEEFaAHBhABASADC.IABH..hAGA......hAIA...,1,-21,-31,10
dDefCTVOBIUWQbMaSRYLKFHGgANcJXPEZ,JDDEXDFFZAEG.DAAH..CGCB...TAEBBFGEUDAB..hAAAbBBGMBAGRGAC.LHEEhABAKEEHFBGEHDBC.hACAAIHEPHEGeBHFOFADWDAD....SGGEhABA..hACA...,2,-36,-16,20
MXBfYODVeWNHZRQIgUaAbPGdcLJCSEFKT,GDAELDBFCHDBFAEGKEHHMHDA..XBBEBEFEOADC.hAAAeDDFNEFG.ZBCCQCGFhABAUAGCACAB.dHGDSAAChADAECEF.fHGFDAHB..hAFA......hBBA...,1,-23,-27,4
cOeLCJgDIHYWQBFXaKPfNZSUTGAVMbdER,MCFEEGADRFEF...OACFCBGB.DCCBHFBA.QCCAXDFEKHBChAAAfEFDZEAASEEGhABA..UAAGhADAAIACdHGHcAEC..eEHHLDHHhAFAICAGBHHA..aBEBhACA...,2,-30,-2,28
cIaQdUJLKReYgAXNHWbVfECBSDFZTGPOM,HDFAVFCG.CBCEBABF.DICGZBAD.TGFAGDADMCFB.aAGEdGBDhAAA.JAHB.KGGGRACFeCHBhAAAAADG.XGADhABA....WFAD.EBFH..SAFChACA..OFFBhAFA.,2,-36,-7,29
cUTCPKFVEafMOWHJgNdZISBDRQeGLXAYb,...bDGBTGBE.CHEEFDFAaBCA..OEAAHAEEJCAAdBAASGEFhAAABHAGDEEB.eFABhABAXGGFACDHUGGFKEAEEBFGhACA.MFDE..NAAF.IAHH..hADA......hAEA...,2,-32,-12,20
IQCeELGPBOSfNJXWRaAdUMTcFYbDgKHVZ,MDADFGCFDCBFHCCCZADD.CDGGLACEBEFH.OHAG..SBHHhAAAJGFCREBC.AIAGdGHGhABATBAD..bDCCKBGAhAAA....IEHCEHDC...fBFFhACA.NDAAaACDhAGA..,1,-19,-38,19
ZEeJYPdUFCcQNVMSGOaWbATgBRKDXLfIH,TDGCBBGCKDAC.DAAELACE.HFDHeFACJDBFdEGBFCDBCHFG.QAGEhAAA.MIFEhABASEFDOGFCaGAChAGAAGDHXBBA.ZAEBEBBD..PHAEhADA...NEEC..hBAA...,1,-4,-39,35
IDQRNgOPCBHfSFVTWbMLeKGcAXYdJEaZU,XFGBdAEEEGAGZDCEDBED..RAAD...OAGDBCGGSHBAhAAAFFAB..TBBDhAAAbGEELACB..hAGAeFFBKEGFAGIHaAEAIAHEgFCH.CDABfCFEhABA.hBCAMIBC.,2,-38,-15,23
JbVaeBfHdSAEZCMOTPFNIGUYcKLRDgWXQ,CAEATFAHFCCF..GCAGUCEFKAEGLAHHDDDH....XFGBhAAAQGBD.bEEHhAAAaCAHBCFEdHDBABCGMIFChABAOAHD..IEGCcBAF..gFEEhABAJABGfEDAhAGASHAAEGGG,2,-23,-23,0
OHUYgceXSNBMdVWJbaFTDPKLCREGZAIQf,QAFAHDBHUAFA.....gFCAeDADSDFFhAAABGGEMBIFdGEBJDHHFEADDFFDhAAALBBECBCGEDDHACEG.fADFhABAcCCANIDD.WHBAaHBG..KAHH..hABA..RCAG....hACA...,1,-9,-12,3
dcYeTbKWGUXDJgICRFOEaSBPLANfVHMQZ,VECAQACH.ZCEBdHGHeFBGKAFCGBDFDAAG..JCHDIBBDhAAACCDD..OAFGhAEAaHDABDABAGFB..fGGBhBAAMIBGTFGF..WBBDgCGAhABAFHBE.EACG..hAEA...,2,-22,-22,0
JXcSUHNeMKRZWBfCOLGQTPEAaYdDFIVgb,aEEBdEGEDABG.FFEFVBGB....JBDDXACD.UFGAhAAAeGAEKEBDZCFGBAGCCBFCLCBBhAAAQCAD.hAEAPFCDADBB.IABB....hAEA.cGEBNIBF.MFAFhAFAfGHA.,1,-12,-41,29
BRULMWOScTJPQEZYdAfgXaHVFIeKDCNbG,XCEAaCHHHCCAFGFGKFCH...CHBA.GAAHBABDRCABLEEH.hAAAOFABSACEhAFAcEGGPFCG.EGAHhAGAdGHEAHIB.gDAG.IHBChAAANIDHbAFEMCGFWHDA...hAHA...,1,-9,-15,6
AdYGWXTHUZNeQIgbaRJcfKVSFLOPEBCDM,dAAAGBFE..XFDETADCZDAD.eEDDQBGG.hAAAbDFAaBAG.RGACfGHGhABASCCEODAFhACABEECDAIBAIACHFBFNIDB.IGGF.cADAhAFA.KDDF..hAGA...,2,-21,-7,14
cgDHLEMWdINYBGQURKaAJZeXbPfFVSOCT,JAFCZDCGeAFB..XBFC..fBBGSCAHTACDhAAADEHHHEDCMIDAIGDBhAAABEAFQEFDhABAKGGDADCDFABF.CAHAcGADEADHNCIE...YDHHhACA....hAEA...,1,-22,-27,5
MHOWKecCASQLbUGIdFgVRZDEBYTJNfaPX,LCEEUGGEGDEEFBCDREFEZBAFBFAG..JFAG..aGGHMHAGOAEAhAAAKAFE...CEBGAIBA.hAAA.bACDdBAE.DFDBEAEBhABA...TDGFNEEA...XGDDhACA..WBHB.hAIA...,2,-34,-16,18
SJZODXcfTHEPYFWIGQUdLVNaBgbAKRCMe,CFCESDFGZBFG.OFACXFGA..TFGGECBC.FBBFIGABhAAAUADCLHDChAAAaDECBADHAFFCMDEH.hABAeAHHDIECfDHCPCAH.YAFEhACA.WHDCdHAH..hADA...,2,-40,0,40
HJFDZXUTYEaCQeSgVAOIPWfcKRNMGLdbB,OADG..PFCE..fCDERBBCMCHBLAEBhAAAdEGFBGCEFGHDDGGFZDAEXAGDhAAATGAD.EBAGaAGCeCADhABASBACADFC..cECANICF..hACA......hAIA...,2,-33,-11,22
MLZbIKUSCYTFdOgXaPRHeWGVNDcQAJEBf,JEFCBBCELCAAZGAGKCAA..UAGACGGA..FBFAdGFD..OBAAhAAA..XECGhAAAaFDARFAB.eDEA...hABA.WDECNDIEDFFGAAIHEFCBMIBC...SAEFhABA...hACA...,2,-37,-32,5
acCbQRGUVZfAILFEOdDJKeHBMPgSTXWYN,FBGBdGCDKGHFBECC..MAHFSCBF..TDEC.XCBChAAANAADCEDA.QAEBhABARFABUEGAZAEBfABFhAFAAHIDLFFFEGFHDBBC......hAHA......hAIA...,2,-33,-24,9
LQeWCONfdDUJYbHFPVGSZIEMBKTXgAcRa,RGCEQADHeCFE.OEDFdGGBUDAB..bBAHFAGE.GDEDhAAAIHCEBBAA.KGACXCGDhAAAADEE.LFHHhABANABH.fGAGDDDD.JFFH.YAFChACA...hAGA...,2,-28,-4,24
YNSBbEcgCQfATGMJePRFVLOUaDXZKHWId,MAECJEEF.RAAF.FBBGLDFE..UCFBXDCGKGBE.HEFGhAAAdHBH.SEBDhACAEGGA.CBHAAHBCeADG.OCAHhAAADGEF..IHHFBAHG.cADHhAIA...fCCBhBAA.,1,-25,-42,17
IKYfCDVNdWbXGeAJUZOHQEBSLRaPgcFTM,JCBFZDDAHADHBHGD.SGBHLBGB.aCAC.....gGDFhAAATEDGKADHfBHChABACAFFDBAD.dAFEXGDEhAAAAGIHOHFEEBBEcFFDFGGA..IHAAhABA....hACA...,2,-43,-4,39
NdLgKOaWfQUIBRFVXZGcPMbJSeCHATYED,TDEFEDCBdCGBLAEE.KEGBOBAH.aGFBQABFhAAABFCHFDHFZEADPFCHJAFCSBCDhAAAeFEFAIAENCAG.hACA..fGHCIHHF.XGCAhABA.MCFCCEEFDBFD..hAIA...,1,-13,-15,2
BKXfTNbDceMFOaRVUSEZGPJCIdHLAQWgY,QAGH..gACFBEEDKABETGFAbBFH.eDHDhAAAMFDGFGAEaFHF.UFAFhAAASEAFEBHFZBAFJAEBhABAIDFGdGGCAIECWHAAfBDB.DDCA.hACAOHCC...hAGA...,2,-19,-9,10
TZAGXQNKJVgIWEMPLcDUOBdebRHfSCaFY,QCBEJAAE..IBDAMIFGLHBEUFDG.BCAFdAHARFGDhAAAHBGB.SAGFhAAAaDDEFFAC.YFBAhABAADIF.NFEFKABG.WBEHcCFFDBED.eHBGhAEACGGB......hAFA...,1,0,-36,36
aWVKSBAeIOTNYbXUZJPfDGcREMdLQHgCF,eBBDODCE..TEFB..bDABUGAEJFDF.DIFEGBBDRECBMHEAhAAAQAGB.hABACCHAFGGHWAEAKAAFSACFhAEABFHCIHAGNDIAZBFE.fEFChABAEDDE......hACA...,1,-6,-21,15
FAfKeTRBPCNbWLacZVSEUQMXJHYdgOIGD,eBHHTGBFRCBABADD..CAFC....bDFHaCFHZCAFEAAB.QGGAhABAXABEHCDBhAAAdFBBOHAGIHFDDFFAAAEGhACAKAGA.NEACLEHBSAGD.MEEF.hABA......hACA...,2,-12,-10,2
EaKCXJMdPBIHAbUVDfGZcFWNTSOQegYRL,UEEADBEFZDFAFABG....TGAAQGAAeDCB.RADELCHHhAAAKABECHGB.JCCBMICGBHDBhAFAABFA....fEADhAAA..cGFESFFG.hAGAgAGB.hAHA.aDFA.,2,-32,-32,0
fNbeIGVTMDXLZOdFQCJgaRBSWcEKHAYPU,UDFG..bCCEeEBAGACHMACBLHECZAEE.dCGACFAG.gFADhAAABFHA.SGDFhABAEAAHADDC.YDAAhACANICB..IGCEDFGGFAHFaFFC..hADAcFEH...hAFAKDAG..,2,-35,-3,32
QMJeAERZaFDObNTLcIGHdKSVPfWUYBCXg,ZBGHDBEAOFHH..TCEBLGDAGECAHBACSFGAhAAA.VACEWCFGBFADhABACFEEQGAAhAAAMBBDAHIBRGEEFHAENECBdABBKCCFfEAB.YAFChAEA....hBAA...,1,-3,-25,22
OMTUbKIaHWQeSRFYAVNdcZGDEXLgfCBJP,dGAFGEFADGFGLEBACCDDBBEG..ODBDMDACUACBKBHH.HCEEhAAAeAAHFHFEADFD...VAFGhABAZGAAEDAF..XDGEhADAgGDB.......hAFA......hAIA...,1,-17,-28,11
bZJKYFBVEQgGCeUIaROfcSDHLAWTdPNXM,dCGHXBFHMACHZEDDKBCE.BFBG..QFEECDAH.UEAEhAAAIECBaCAC.RADE.fHBBhABADGAB.AAFHTDDHhACAbFGB.FGGAEAAB..eAHBOFFBhABA.SHBGhADA.WAFENIED,2,-25,-18,7
GaeOdcEHWQJBLURKbZgXCSFDYMTNIfVPA,eAEGdEEBECBGQECDLEHBKHBGZDADCCHHFAGHDGIH....MAAHhABATACF..fFCEhACAAHEGaHFEOEEG.hADA.cEAGJHACBCAF..bAED.SFFAhAEAIAAHPCEAhACAWAHH..,1,-13,-32,19
FbKYVPNITAXdDEaecQGUfCBHJMWZLSgRO,XFBCdFEDaAAG..eDGBQEEEGADAUGBFBBCDMCFGLAFAhADASDAEOFHDKDBHhAGAPEHF.NDEBABEDEBBFhAHA.CCGB.JHEE.gAAF.FAGE.hBBA......hBDA...,2,-9,-9,0
QDTeEJRCaXBbfPcdSgLVZFMKWIYOUNGHA,TGBEJFDH..CCAHBGBF..fBAGdBEELAGFZEFHMDDEhAAA.IFAFhABAOEFAUGFENIDDAADF.eEAAhAAAEECDaAHF..XABBcADDSFHBhACA..FAHDKEEDhAEA...,1,-15,-33,18
QLdARcgOBCUNWHIeDPJfVGSMTKYbXEaFZ,RAEGOACCBBCDUDBEHEFDDFIH...JHCGVFDCGEAF.SAGChAAAMCHF.KBAHXDEEhAAAEDDG.FBABLBHFhABAAHHA.CHHGNCCFeGAG.....hACA......hAEA...,2,-34,-12,22
aWGCBJAXDMgdFURcfIYSOZebHQTKNEPLV,XEEDDAEBdFECFABGRACH......IGHCOGAAeBFFHCAHTCFDhAAAKAHF.EHAEVDBGhAAAaECH...CHFAAAFGMAEEhABA...cBGASFGG..hAIA......hBAA...,1,-7,-43,36
EWRLbeNYFcXGaQKMSfCPDVZIdATHJUBOg,TGBFHCBGBFBG.EAHBLFBC.NADC.FGGFGAGEaDFDMFADhAAACAEDDGFAZGBG.dCEEJEEA.hABAUAAG..OHDEhACA..WFAD.eFHH..cEBAhADAKCEG.PADEAIDA.hAFA...,2,-16,-12,4
eQYMbSgJcFIPEZAXaOGLKDUfTBNdCVHWR,ODHDGDCEKEECDGEG.UFGGBHCG..CFAHHAFEeBFC..MADDSDAAhAAA.JABDcGDChAAA..IHAEhABAEABBAFFALCEA.NEAAdHGHRADBYHCGhADAFEBE.....hACAXCGE.,2,-16,-10,6
GJYaBCAeFgMSRHLNcOPWVUdZfXKQbEIDT,eABCMEFGRFBBLBHD.OCDEVBEGdCAEZFFFKECF..EHFCIFABhAAAGCCCaFFCAHFFFBAHhABAHAAC..NEEA..hAAA.WFHHXAEEDFAB.JHACCADESBHBhABA....hAFA...,2,-11,-8,3
eJbdMEgHFfABcZXNaRKVWYQSGIPTCLODU,BEAHZFBDaCBFKGGF....VFEDQAEFGAEB.TDDDLEAHhAAAOABFDDDEUDGGhABAJECFdEGHEHGCHBGDAADC.NIBF.hAAA............hABA......hADA...,2,-24,-15,9
NdOaTMGVKJLAfDUFCHXBIEYSgPebZcQWR,DEABFGFAHCDCBBAF.EAGA..SEEAeEEAZFAAQADChAAARCDA.OBAHaBGAMIFGhAAAKBBEAFHGCFBG...YHCGhABAPADA..bEGH.......hACAcGCE.WBCFhABA...,2,-51,-1,50
eUgWZFGfBMQLXYAbRcKOJTVCDNHIdSaEP,RFBHOGFA..JGFCCDBFDECDHCBG.dHDDEBHHeBEC..UDEFZDFGFBBGhAAAGGBBBEACMAAHhABA.LBBEAAGCKADC.hABATAFA.IFAEaFDFgBGAhACA..WHFA..hACA...,1,-13,-31,18
NLFWUTKMVOHBdRACbIGEcJQZgfeYSDPaX,CGHBGCFE.EFCHQEABZDDF.eDGFDFAGaCAHLEDBUABHMHFChAAAVABABBHC.hACAAHFH.IHACJBAF.hAAAfAGBSGADNIDBFEHDWCDA.KGBH.hAEA......hAFA...,2,-20,-15,5
KANBfeXSHZRVYFcCWJGIPgQdDOEUMLbTa,BFFDXFAFSAGHHCEHRACB.FGEH..CEGDGAGA.ICAEhAAAQBCG.ODGFhAAAEHGGMIBELFCFhABAaCCHKAEGADAAeEAC.YACC..hAGAWEED....hABA...,2,-24,-15,9
UYJBGZEOFKDcIRWMXCVdLbNAgQTfHaSPe,TEDEHCEEaACG.eHECJEHD.ZFFA..FGAEDEBDRACA.MECF.CCCELAFAhAAANDAH.ABAG.fHEBhAAASEGAPBFFhABABGAGEHCC..OAFA...hABA....KHCG.hAGA...,2,-23,-13,10
CSGREMVUcIWaeHTLJPNdDOXAFZQfYKgbB,QFFBKFBBBDGBGABFEBBA..UFBA..ICEHeDDBHAFChAAALFGDNCIC.DAEEhAAAACECfHDFhABA.gCAGCGEGSAHBMEAHWCAHaDGB.hACAJCCF.dHBD...hADAFEEG..,1,-5,-24,19
RAebfIUagQBKdESOYNCTPXDcLHZWGVFMJ,eAFH..fBBEIGDC.UAGBaFGA.QECEBDDBEFAF.hAAASADF.hABANFEHCHAHTGGC.XCAHhACADGIBLAADZACEWBHHFCECMHDGAEFEKHBG.hADAdGGAOFFBcFAF.hAEA...,2,-19,-5,14
QCKaNgBeWAHcXRDdSYFbOJTPGUIZELMfV,HCFAXACFRABGdAEEFFHBOGAA..TDDBUGFDZEFALAAHhAFA.VGBEKAHB.aAHFBHCHhAAAAEBG.DEEF.bDAAPBGHhAGA.EFFDfBAGCCCGNIEF...hBAA......hBCA...,2,-16,-11,5
KLQVIAfSPBFURbcCDgEaXOMdJeZTHYGNW,SEGCBHCDRFFE.CCEH.EDCG..OHCCMDAFdBADeACFHBEA.hAAA.NEBCLAGDhABAIEBDAIHEFGGD.UECDDFEHaBHDhAAA...........hACA......hAEA...,1,-27,-30,3
WYLDgNVGQIbcCBKJSXOEHTeRAZFUdMfPa,UAAGdCGHMACC..aGABLEBHDDDB.VEDAGBDD.QDADhADAIHGFCAHABDHChAEAKCDA.XFFAHBAEeHCChAAAAEFDFGBD..fAFF..WGDGhAFA.NEIA....hABA...,2,-22,-22,0
RHdGfVPgSDaCbZUMWLFQYEKBIOANJXTec,JDDBeFDGHBACdACDGBFA..PAFBSAFFDGEH.CHCEZBAHhAAAMFFCLHFEFEAAECGFBHBHhAAAAHAG..NAICTCCFhABAfHGD...aAGAWDADKADH..hADA......hAHA...,2,-19,-15,4
XUVCYHPfKaFQZMGBSdWLbEOcTDgIJNReA,VCABCCHGHBAC.KGBEFDEFZEGDBEHC..dBFGLAGDEEAF.OBAAhAAADAIF..JDDHRGEEeFCFhABAAHAB.....hAAAYACCfFFCaGGAMAIDSHBGhABA...WAEF.hBHA...,1,-23,-29,6
HRGfTKeCMObZJWAYUQEXVSBDdPcNFILga,QEBDVAFC.BAFHdFGB...NDBF.LECC.HFCGhAAAfACGTACDCFADOHFGhAAAJBAFAIEG.EEFADCIBPHAChABAFCDE..IHGAaCGGKADCMFEH.hABAWDHH....hAHA...,2,-28,-15,13
RTZISFEPOWAMGQLgdfXYUDVeBcabKJNHC,QDCDdGGF..fFCGXBADUFFBDCDABAEG.aFEDhAAAKHCCHDADCFAFZAEAFDEBEABEhAAAOBHBAEGEMCID..hADAgABA.eFAD..cGAGhAFANIEH.....hABA...,1,-19,-23,4
cVeTQNXOZFUBdIYagDARfSHLPMGEKWCJb,REDBHBADMAIFEHDG.CCGD...JCCA..VFFGeABCQGAHhAAA.ODEBFEBGBFHDhAAAdAEAIDCEaFFFDBGHSBDEhABA.PHAEKAGAcABF.hAFAXDGE..hADA...,2,-30,-14,16
KJZNRaGPCTYfgQWOcHSbIFeMdBVAUXELD,EAFHKFFBZECBRBDB.GBAFCCBH....TBGFfEAD.QAGHhAAAOHEGSCADhAAAIFHDFGAFMDDHhABABHHBAIDALEFADAFBNDDDaHCEPFAD.gABChAEAWABE..hAFA...,2,-27,-12,15
LaVeNUJZQCMGYdSXEPDBFWcIAROHKbTgf,RDDAKCDG..TAFHLCGF.VAAHUFAHZGBCQCADGEEEdEABhAAASFHB.hACAXACFDAIDBAGCFGDHhAAAIGHBABABOFFFgADCaBHD..hADA......hBHA...,1,-9,-22,13
cMYTSAKWFgeLVEObPfGaHQUXBDZdCJRIN,KEBEFABFeBFAEBFB..OEAH..bDAHGEDDHEEHUEGCBCBCdGGFhAAACHAD.JADHRADH..IHDBhAAAMCIB..TGBBhABAAGDE.LHEG.....hADA......hAFA...,1,-16,-24,8
AbFTWNLPVCcSUYeaDGIKBdQZXHMfREOJg,FEFATDEBLEAG.CHCB.SGGF.UBCHaCDEDEIFIBGHhAAABGBFdBBEZFADMEAGhABAEADD.OFCFAHGF.hAAANCIE.PAGH.......cGGFhABA...YEEFhACA,2,-35,-32,3
ZWecSUFLMAKVCGRQDIHbJPgdaEXBNfTYO,CGDAQAEGDECC.HGCGJHEE.dFGE.EEBDBGBH..TCBAhAAAOAHBeAHF.SDEHhABAFACDAIHGGBAAIACHhAGA..bECEaDGE...fHADhAHAZAEF..cDGDhAAA.MIAC,2,-39,-9,30
QMfKHPTFLENUaDdJGeRZCbOBVXYIcgAWS,SBFFQFBBMAEGKFFAHDFC.FECBEBCFUBABDIGCdDEF.eBABhAAACAABBEAA.XGAChACAIHDA.cAGDhABAAIDG..fBDEPFEGNDAE.aGDC..hADA......hAEA...,2,-29,-12,17
FVEMbdKYPBDSLNJeRHWAZXgaTQCUfcGIO,XEAGaCGG..QDCAUEGBGCBDOHAEEADA.dEHEKAAABFAEhAAADAHBLEEHhAAAJABFHFEFAHAATGADCBED.IHHAhACAMADC.....bFCHSCADhACAeCEE....hAHA...,1,4,-25,29
CGTHfSZJOeacWBQKPFRLbIDMAXEgYVdUN,XFBHEHFC..VEDGUGEEGBDHHAFBSACDZAAEeEADaDGGhAAABAHG.KDAHPCCHhABALDFADIBAAAHFdADBCHEC.hACAJDDB.OFFA.....WAAFhAIA.FGHD....hBBA...,2,-10,-8,2
LReZWfEFNAKCTXJGMPDdQaSHBYgVIcObU,TFAEXDEB.GGCFDBBEdHED..QFGFSCDGBCCGhAAAVDGFIDAD.hAAAOABGbAEALECChABAeFBFfAGGEDAAACIBKGCBMADAaECF...hAFA......hAHA...,1,-5,-20,15
cXSYbeMOCgARLfZIJaWPHDQEVGNUKdFBT,LGBAZEADaDGE.HCDHECBE.GDFE.KAAAFGCBBEADTAFFSHDAhAAAeABE.OADAhACACGGAAAIHREDE.JAHDDEAH..hAAANCCA.dCFH..........hAEA......hAFA...,1,-15,-20,5
TDbBUIdgQfXMWJHNAPRLZEOKeYGCaVcFS,LFAGEDBHKGAG.eBAEGEGECGGE..aCFEVEDF..FDBHDDECBHEChAAA.dEFDQAFChAAAMHACHADHPABBhACA.OADB..SGHH.hAEA......hAHA...,2,-23,-22,1
TWAJcFSLDPfNOVCEUQYIgMKHdGaeXRbBZ,FBEGSEFHDDCA.....NEHACAADEBAE.QBGA.hABA.IEAAMFDHKHEEhAAAdEDEaGADXCDEhACABEFDZEGHABIFJHCC.cFBGfDAD.OACGhABAVACCYAGFhAFA..,2,-36,-19,17
VXZQCGMYIUFDHBaLTcdPEebgOKfRAWNJS,JEAFSFFCZEGF.CCBA.GGCD.MADFIFDD.UBEHhAAADDFDaEBFLHEA.hAAATGAGdBADeAHDODCChABA.KACEAIBAWBDHNCIGXAGF...hABA......hACA...,2,-33,-17,16
OBTKXUgHSGIeMERNJYQbFLdAWPcfCaVZD,...PCDFfCBE.aACCVBFBDIDEBGHEKDAFUGGDHAGFGDBAhAAAMDDCEEFBRABAJDHDbGAChAAA..FHACdFBFABAD.CBACOADAhABA..gFEFSHEE.hABA......hACA...,1,2,-14,16
DTQeBaSdRJXbCOcMPYfEAVWHGLKgNFZUI,HACCLCBHKEFHFAHFUADDDCFGQGBA.BGGBSBAGhAAAJEDG.CHGFODAAhABAMDEG..PHECEGABAEDEVFDBhACA..gAGANDIG.IEHChAAAaGBF.dEAG..hABA...,1,-15,-27,12
KdgSCWTJPABeIDFHELcfONXVYZaGbQURM,eEFAFEDHEBFFLBDB.OFAGVAAHZFFEaHAA.GBGG.QFABhAAAUAAFRFDEdAGBCEEB.hACAJDAGBAECDHGG.fDBChADAXCGG.MIBG.SAHBhAGA......hBDA...,2,-14,-12,2
XYcTSePfZNHJgDEMORbWGVCQBULIdKaFA,XGEGTFFF..eGBEZBBFHEEADFIDEECCMCAH.REAFGBDDhAAAQABGBDGBIAEDhAAAdHADKHGGADIDSHBGhADA.NDDHOEFA..WABECAGA..hAFA.aGGA....hAGA...,2,-8,-7,1
AeFLfIDCESBgcKTNHQbWPJMOXRUVZaYGd,FAAELBEDDCCH.SCABBGFHKBHB.HFFA.QGDHhAAA.PAFGMDDFOEEChAAAREACZABHaCGDGGABhADAAHIB.ICFBCADF.EEAH.....hBAAgAECNBIE.hBBA...,2,-41,-2,39
KULFRWaQAIfTdPMCZgeDcHOXSVNEbYGJB,TEEHdAGDMEEA.ZFAAeCCEHABF..SBBCEHGE.GDABhAAAKFHBUDBFRGECQGBHhABAICHD.CBGDgDGDhACA.DAFCXGDHNAIG.bAEHBADEhBAAWBAFAIHG...fFFChAAA,1,-7,-15,8
XEHTDPcZgRFQGeIMVfaSJYdBONACWKLUb,CCDHKHAGLEACUGEH..EEDEDACE.ZFDGFAGCGAGC..eBCHhAAAMCFHaFAC..JFHDBBADhABAAIAA...bCFBXBABhAAA.TFAEcDAC....hACA......hADA...,1,-28,-38,10
XWeVSaUCKDTBfGFMOcRINgbZLPdJYAHEQ,EDGEQBFE.eDDBSGFDUFBGCBDG.KAFFBGHDFGCFODBBhAAARAAB...gCCDhABALFGFdEAGAAHEHEFDhACAWAHBDGAH.fACHMACCIHEHhAAA......hAGA...,1,-20,-23,3
gPAdTMaHCEXOfDUIQFLZSGKVJbRNBYWce,MEEGHGBEXGFADCBH.QCABFFDEZFBDKBFCJDFF..RCCCBHDAhAAA..WCEEeGFAhABAAEDEaAGC.EABCOACAhAGAIAEF..SBBE..hAHA......hAIA...,2,-36,-13,23
dfPWTOIaXGMRBFUSVJcgeYCAbQNKLEZDH,QFFCKCAEEFCF.DCCCHGEGdFCC...fAEHTCAGOAFEhAAAXCFEGCEHBDDBhAAASGAHJEABeABCAIHGhABANBAHLHEAZEFA..WHBGaEEBMEABhABA......hACA...,2,-9,-8,1
fNJAaCSPXQgZDeHLFGIbcRWTKEUYOdVBM,aFEFSCHB.QGGAZBACeFAHHCEEFEECGADDIECEhAAARDABKCCHEAECUGEEdGCAMIFAhABAJHAE.AEAE.CBBFXCEEhAAALEGH..cAGG...WCHBhACA......hADA...,2,-10,-7,3
JZKGNLHUFIagVEWBCSeDYbcORPdXQMATf,JBGBZDBEKCHBLEEDHAEFUBAH..FCBFaFEFEADG.BABD..hAAACHAEDGAE..bFAERDFDdGHAhAAA..MCIHAHCB.hABAfGFB.NIAD......hACA......hADA...,2,-31,-29,2
KbRWLaNfCdUQZgJcOTEHPDMAGYVIXSBFe,GBAAVCDH.SEGBFACE.KACARGCALBAFaHCE.CFBDUDGAhAAAgAFE.JEDChAAATAFAECFG.DAIDYHAEhABABHAE.WFDGfGGB..hABA......hACA...,1,-11,-31,20
KLIHMENURWGJTFeZbVSXgBDaAcfdPOQYC,dBDAOADHQBFB.KEFGIBBAHGAGMCAGUBGDGDADhAAAFHBEZFFBSGGBhABABFAEAAAA.fFEGhACACFDFLAEBNDIG.JFHD...bEEF...gCAGhACA.DAGEaAGAhADA...,1,-6,-16,10
DfcHNEXRMZFUKSGLCaPTOVYdgeQJbBWAI,DACEHGCGEDEHMBHD.FAAHUGEFKDAH.GBBBCAFF...aDGAODCHhABAdHBBQEBChAAABHHHADED..IADBhACANBACXAGBSEFH....LFFEhABA....hAFA...,1,-14,-34,20
QVHPWTcXeJfGbIUZLYdBMCSDRKENAaOgF,aEHBOCCC.FAFDVCDEHGDE...TAACeBAFGDBA.hAAAIHDDUDGHZFAELAAEhAEABDAFCBHBSHFAhACADAGEKFFFACCEQBGFPHAE.WFAD.hADA.JEAG.fFEDhAEA.,1,-6,-16,10
gTEQGJdKUaSbRZXLMAHfcIYOWBPNCeVFD,HEBH..fABHIAGA.OCEBBAEGCCABeCCDDDEEEEFEGAFGhAAA.dEAGKBBCSGFAhABAZFFCMIEAAEHEWFBBhAEA.NDIC.FBHD....gFEChAFAJFAFaAAG......hAHA...,2,-21,-16,5
cbEeHDAJUSMfTNKRPVGCWYaILQFgOXZdB,UCGDSAGDMFDB...TBCERDCEGBADCAAD...aGAAIAHFhABALFHDQFDBhACAFHECXDADdEBGBHFBhADAEHAEDABCAFAHfDEH.NDIEKAEBPAEAhAAA.....hAEA...,1,-5,-24,19
PIQSTZVKWegCdHObGAMcULFERBDNafYJX,MCDCUABCLAEARCGF.BGDDDADCaFEF..JHFA..IFBChAAAQCEFZBBHKHAEhABAeFADdGHEOEFE.hACAADBAEDDDfGDA.XAGESFCFhAAA.....hAGA...,2,-33,-25,8
JVcFdLgHYTEPUSebZQOIfKACRDBNXMGaW,DCFDXEFHMHAAGEEF..JEBHFBAFdAGCHADHECBB.UBGBSACDhAAAeCBH.ZFCDIHGFhAAAAAEGBEHFNDDHaHDE.hABA....WFAAcADC...YFHBhAIA...hABA...,2,-22,-21,1
AfLIbSZVGBQFHPdecTJKYaUMDRCgNOEXW,LCEBSAGFZABHBFEHFGAGdDGG..eDEAJEAA.aGGG.UDAGhAAAMIAACAEB...OCHDhAAAXACHAIHC.IHEFhABAGGCDHAFE..PFCD.KAHBhACADGGG.....hBAA...,1,-14,-31,17
aJLNcIdRSXUWGHAEVBDPCKfMTQFeOZgYb,VEAADADAKFDF..MFIDQEFH.FBBDeHEA.ODGBhAAAZDBE...bACCaGGCJEEHhABALHBG.NAAAdBGHhABASHAC.UCDD.WAEEAGAEBAHFhACA..CHDC...hADA...,1,-19,-26,7
OMGRBWaYIUQZPfdNDKCgLJVeHTAcSFEXb,SECHXFEA.MBIHBCAF..aBFBIECEZEAD.dGAEDIFChAAACEFCLBEEeHCCACDBEGHBhABAOEHFGEEHRABB.UACBhADAfHDBKAGE.......hAFA......hBAA...,1,-9,-28,19
fbDMBUcTXCHdWKQNgGaLJAIZeFPREVYSO,eCEERBGDEDDD...SBCFOAFB.DBABMECBBGAAUGEA..hAAATDABXBADCGGFHEEDhAAAKGHDQACGhABA.NEAA.aAGGAGDH.FHCG...YDCBhABAfDFAcEGA.hAEA...,1,-19,-23,4
SJgfKVIGCHUMFOcQEZbBdANYRXDWeLaPT,RBFDXCFFDHGCLFAB..aDDC.SAGEJBBBKDDC.IACBhAAACHCB..HFEAhAAAMEIBFAHDOFADEADCBEHDhABAdFFBADHA.NDCGWBAFTECF....fFDAhABA..hAEA...,1,-25,-32,7
OcHafNJTIUDgAFXYMZdKSeGVCBLERQbPW,XGEEMCBCdAFEKDEFGCAF.BABGRDGB.QEEB..hAAAPABAODHHaHCEfFAFhACA.TAEGhADAIFFHDIAAAHHAFEBEYAHH.SGDFhAEACHHEEBHDWHAC.hAGA..NAAC,1,-18,-42,24
GBVXUSJfYLNeaHAOcWDdgbQZCRTEMIPFK,OGEADCCFdGAC..QBDGCDCBRCFF..EHAGMDFDFADB.BAFFUAABhABA..SCGChAAA.JHFGfBGDhAFANBAC.eFCBAEGEgEGA.TGBFhABAIHHB..hAGA.KHEG.,2,-35,-26,9
YKdWRCaBIQVHMUXETNgbLSFfcZOAJDPeG,JAFDDIGGGAGC.KEDDdDGF.CHHHBDEGQCDBHBBC.MECHEGFB.hAAA..TFFD.hABANBBE.bFAFLACEhAAAFAHFZDAAAHEF...eABC.REFA.IGADhABA.....XGDHhAGA,2,-21,-10,11
JBcKaSNIGZXORWLAVPCQeHbEDUdfFYgTM,CCDCeAHHHAAGEBEBDEFAdEAG..FBFE..TEGABHFGKFGC..aHBAhAAASEBHGABEXFEDhABA.WDDFhADAAAFBPHAG.QFDBbBFB.fDAChAAA.MAIDhABANIEH.IHHC.,2,-32,0,32
RJHPeYBLbTOKWVAZNDdUgFfSQGIcCEMXa,DFBAdACGUEDBFGED..QEEHGAEDCHHC...ECCAaCGDHBGH.hAAAeHACBHFA.TEAEhABAKCABADEF..NBBF.fHADhAEAIGHDMGACXEGA...PCDChAFA....hAHA...,1,-18,-31,13
SdVPfaMACcRWGFLQOJNXbTeKUHEZgYDIB,RABAFBGAOAFB..XEFHeEFAHGECEDHHZCEDDAAGBCHE.dEABhAEAfBAFACDD.hAGACHHFGFABLHACJDBGhAAA.TADDKEDD...YHDC.hAHAIHAG.SDADhABA,2,-28,-7,21
JXVbYdcIHgPZKOFaLSBfGTeWRNDAMUCEQ,UFBBCEBC.EACHQFGG.JBBCXFFG..bEDBdEGBhAAAHAFEPCEHKFCDOBABhAAAaAEFLAGHBDFBfFAGhABAeBBD..NCAAMIAC..hABA...YHFGhACAIDHF.,1,-3,-33,30
HaIWXbPZCNcFQfeGMTKSRELDJBVdUgAOY,HGFGaGGH.XGCBZCCFCAGD.FBDG..eCAHTEEDKDGA..EAAALEAEhAAABADB.dAGAACEFOFHFhAAAIEHF..hABA.WCCANIBB.fCAFSFDAJFADgFAChAFA..hAHA...,1,-2,-37,35
SgWdVeEATfIcNZPFJMDCHaUbOQKGRBYXL,TAGE..IBDEZDDBFFAB.MIDGCECCHACAUFED..OAABhABAQCGEKGGARDFHBEHHhACAXFAA.LEAChAAAgGCGWFHH.eABCAAEA.fBAEhABA.cBFBhAFA...,1,-13,-30,17
gQNXEPfOLSZAYDCTRHBbaVeWGIJKUMdFc,DACFCDCHRBEA.BAGB..aACBeEGB.GDABKEAFdEEBFHEA..QFFFhAAAEAAH.OGAEhABALFDF.AFBHTADAhAAA..........hADA......hAFA...,1,-35,-45,10
aUYRgLeOAENdPQHGFZVSCcbfXBTDMJIWK,dDCBQEGHGFDHFAECSHCE.CCAE.fHAHBCCFTCFFhAAAMIFG..IEBAhABAKCGGaBBERDABLAFAhACAAAAGEEHD...NEAAPEED....hADA......hAEA...,1,-21,-25,4
DeORcJMXBgLAWUEVZSPdQYFbKGITaCHfN,UECAEBCDZAGDdBCD.FCHHGDAC..aAGACCEBHEFG.DGAHeFFEhAAAOABAREAF..MICAhABABGCFAADF.SAADhAFA.QGEAbCDEIHHBfEDGhAGA.....hACA...,2,-33,-8,25
GbLYMPNIKXgUFSfDWAVRaZcEOCeBHJdQT,aFHHECBF..ODAHeEDHHBEDdFHGGCEHLAHHMBAGIFAGhAAA.XBBBFEEBfFBAhAAADDDHAGFH.ZECHCCABBHBDhABA..........hACA......hADA...,1,-19,-20,1
UNMWQFZceYEKfBSOTHPdVADIRagXGbJCL,DCCGaDGGGFBHCHBH.LBAEMDAD.FAGGZDDE.eGCEEBEHBEEFhAAAOABGHCAB.dGGAIHHBhAAA.XFGGhAFA...JDBBNIBD..WEHB..hABAYAHDSFADhACA...,2,-32,-16,16
RFJUXDHgYeAZQPIbWLaTNdKGOcSBfMEVC,ZBBHQBFF..PEGFIBDDLHAGaFEG.dAGBODDBhAAASFABBGHHfHEFhABAEGEHCCAC.FGAAhACAJCFGDIAC..gBDFADIHWCBBKAFCMAAEhAEA......hAFA...,2,-28,-18,10
GEJAcLTaBKOgWYNRfICMPXFUQDHbeZSVd,TGFFBHDFKBFG..ODHF..gDDG..WFCChAAARFGHCAAC.MADD.FCAChABAQBBBHAGBZGBESFAFhACAdGAFEDFEAEAALACCYBEDNBIAfECGhAGA..hAHA...,1,-10,-34,24
cUMfIHXJZNOBSQRbVTYeAFGgaLKCPdDEW,GGDFaGDHLEFCKCFGdEGFDCDG..EAEHUGABMDEHHDAA.JFGDZDABhAAABAAHSAHFhABA.QGBAhACAbAFE.YCCBAAFECACFWCCGfACA.hAAA......hAEA...,1,-4,-28,24
aBJFdeTGUIKDSOERQCZcWHYNXLVfPMbAg,BFEEJFFA.FBGHeDBGUBBEDIFA...EACBCHGEZFBA..HFCF.hAAAXAGHLBEBVEABhAAAMAEE.ACAHdHBHTAEAhABA..KHEGSEGEOCHD...hABAcFEC.NDDD..hACA...,2,-37,-9,28
JGdFOTIHBWDNCceAYfVXMESLZUKaRgQbP,VEADXCAD..MBCGLBFEZDGHKDDEaGEA.RDGF...QGEChAAAPAAE.dABGFDEHhAAAIHHABHHBDADCCHCHAEFAhADAfGAE.EGCHSAHBhAEAbCCF......hAFA...,2,-29,-7,22
ZOSTENdgCPVMIRFXbKHBeaGfJAcWDULQY,DGBCUCAEQFGGOAGF..EGCCdBCD.CDFD.MCFDFCHF..KAGEeADHhAAAGDABAHFDLEHBhABAZGBG..SBAFhAAANFAF..gGAD.IFGEhACA....hADA...,1,-28,-29,1
HdKQBTDaVJXZFeOEWUYbLCINMGRAcgfSP,...fEFDPEHDKHECQCDCBEDGDBAD.VFCDZBBBFCFBOBCHhAAA.UAGALHAChAAAIHGGMAFEABFDSCAFhABA.HEAHaBGA.XFGEhACAEBDA......hADA...,2,-30,-5,25
WYHaFXPOGfgeTNQVSAEcKLDIdZRCbMUJB,EAEGKAGFLAEFDHCG.dCBCRCCCCDFAUFFH.BDGEHABC.FFGEOBHFhAAAGAGC.eCABQFCBhABAAIBAZGFA.MCDDhACA..YFCEaHAE......hAAA...fGAAhABANDAE,1,-18,-36,18
EFafYIAGSCOMUdZeLDJQbWgNHcXRVTBKP,SCFBCBBEUGFD.dADCeDCCDBGA..QEGE..bFCFhAAA..gEDChAAAHBGBXAEHRCADBGADKEABhABAFHDAaEGEfABEAADH.MAFG..hACA......hBAA...,1,-23,-25,2
UDNgTBaWeZfcAQGOJbIPLVHXKdMSYFCER,GGADODCA.JADH..IEHDLEGHHACGKDEHdEAAMAGBFAAECDADRFAChAAA..DGFB..TBADhABABAFHeCCBZGEEAHCFPAHHhACASCFE..EFECNEIG....hADA......hAFA...,2,-24,-8,16
VWGUHEcSPRCTDXZOaKeAdQfJgbNBYFIML,QGDGJFAG....bFFEBECFFEDALCEEVABBUAECEBBFhAAASFGH.hABACCHADDFFOADB.aAFChACAAHAGdDAEfHEH.NAICMHAE..hAEAWDFH....hAAA...,2,-40,-12,28
bYEFJeHKGSfMaZCdgDANUPIQRcTOXWVLB,UDFDQFBCRCBA.OFFF..XACELAFEBCFEbCDAFBBGhAAAeDAD.KAGASDHFhABAMAAE.aHBECHGGDICEhAFAAFIHIDAD.WDCGEGGE....hACA......hADA...,2,-36,-21,15
gVaXCSQHcWDRZGfeEOAILUJbdNFKMBPTY,LEABJBEA.dDEFFBADKCGCMFACBEHG....TDECVGFECFEEhAAAHGDC.DEAGGBBFhABAECCBADGE...IAFChACANEIC..gGACSHAAcAGAhAAA.....hADA...,2,-36,-24,12
UICYdDZOQbPMGVXcLJSBNeTgaRKFWHfAE,EDEEUFAE.CAAE.dGDEZDFAOGFC..QAEGMDCDGAAE.hACAXAGALBDFSEEGhAAABHDCTFGGhADAaAEFFGAFfCBAAIGCIDHCDIAC..bAGDPADBhACA..cGFHhAGA..,1,-18,-21,3
KVFIJgdXCQPENaZRTbYHefOcMGALUBDWS,LAHHUDFHBHGDDCDAKFBHFBAC...JEEGdBCA.CFHA...EEBHZAEEhAAARGBE....TFGChAAAHBAHOEAB.hABAMGDEAAEHSDAF.IDDFhACA......hADA...,1,-37,-41,4
gOHIDPcbGQKBTJESeAZUNWMCfdXYLRVaF,ZBFEUCAAMBCCdDDFLGCERDFB..FAAFOAAEDHDG....hAAAbEADKGGD.JDHHECCAAGBH.hABA..CHHA..XEDGhACAVAFC..aEECIAGG.cFGEhADABADESFAChAFA.NIAB,2,-37,-31,6
SVgaHfbFPBWNQMTeUZcCYdGXKREJADLIO,DFAGOEEH..SHFCaACFHCFAFGFDBAHB.QGAHhAAAMBADTFBAZCEBCCAG.dDGCKCCDhAAAEBCHABFHLFAFhABA.IBHFfDDC.WABCeFFEcAGHhAFA....hBAA...,2,-39,-4,35
TVNLYPFbJWeadCOXKMBHRGDcQSZEIgAfU,UGGFVEBG.LECD.FAFFbABA.eEGHdAAFOADF.KEEHhADABBHB.HCDCDDFCQEGBhAHASHAAEBABhAAAACCH.fGEE.NEIC.PAHFhBBAaAGBCHDDMDAB...hCAA...,2,-29,0,29
GQBdZAELMVPFgacbKOCTSXJeDWHURYNIf,LCAGMDECFBBH.aEGEKGAE..CGDE...XGGBJAHD.DADEUGAHhAAA.RAEF...NFBHGAEDhAAAdGGGAEEFEABG..hADAgDGAOEAASGEHeHCC..hAEAWBAD....hABA...,1,-20,-35,15
CaWNAIZTdLcFJMQHSYVeUPEKGOXgfBbRD,TAAAdDFALBFE.JHCEQEGE.SDDEhAAAVCAEeABAEEABGFAFOBEChACAXGGEfDABhADABDEGDGGDCFGH.aHAEAHAF.IHHB.FGEFMAFChAAAYAHH..hAEA...,2,-16,-14,2
HINeELZKORMXfYcgFBSCWPTaVQGDdbJUA,HAFAeCCFEDGCZFEHODFFRAFB..MBABXAAH..cGFChAAABCDFCGHD..TFCBhABAaFAE..QDAFhAAADFFGdFAEJBEFAHEFIDHANEIG.KHAAfBBChACA...hACA...,2,-26,-7,19
PcSfKYUEQWJVeHAZFaLODIdgMNGbBCTXR,ZGEELBGBOADFDGAHdCFDMCCGGFBB.BABEXDDE.RDAF.hAAA..PBBBSDHHhABAKEECEAGHQGFGhACA.WAECeFADABBHaGDBNDIG.CACA.fDCAhAAAYFBB...hAIA...,1,-16,-22,6
NSYMcCPKWDJTHEXQOAVUBefRILaFbdGgZ,BFEBeEEFRCBHaDDA..FAEFGDAFZDFB.SFBDMFHB.CBDE.KGCHhAAADFIHJAHH..TAFFhAAAEGAD..OBAGhABAAICCUGEH...fABA.IDHFhABAdDAGNEIE....hADA...,2,-38,-16,22
IMCXNSGVbFROfUJPeHYDZBgaTcELAdKQW,dCFBQEACMFAD.CHGE.SACHGCDEFBCFODGBUAFBeHDEhAAADEEDZCACBDGH.aGCBEAEHhAAA.AIFAKBAE.IFHHhABANEIA...bGBC..fBAEhABAJEAC.....hACA...,2,-22,-15,7
dPEFIaKBRCDebNcLHZJfQMUOTGWSgAYXV,XDCHVAEB.dGDBFABG.KDDFCHCD..DAGGeEAD....bBEAhAAANCCA.LBBBZFFCQDGBhAAAMABGUGGEOHBChAEATFAE....SAHBhAGAAHEH.YHDCEEEGBAFDhBAA...,2,-21,-15,6
SDZANRBMPXbITFHWCfVgcLdQYKUaEGeOJ,BEECMEDA...XCFATABDHFBH.CBFC.fABDhAAA.VDADLAAFhADAQGGAKAGCaEHFeFCHhADASGFCDGFFABIBRBCAIHADWCDG.dEGHEHFChAEA.OFAH..hAFA...,1,-8,-22,14
NFTODBXWPSLKaVCGgHcRfAMYUdbQJeZIE,UADGdACGJFEGeCBG.ZFFEEAGB..FHBCDGDBBEHF....XEBFhAAASGBEaHAEGBDChABAHAGH..cAAGhAAAAFBBMFID.bGEAIHHF.TDEFhAGAPDFCKDBFCAEB...hAHA...,1,-16,-27,11
EKZORdAgDeBTWMbHNQJaCLIYfGUPVScXF,DHBGBABAMDDHHBDC.JDGDCCAG.LADC..fGFFhAAAGDDGUEBASCFHhABAFHGAKHCGOAHDABBCeAFCbFDHhACAaBAC....IHADPBEHXEABhADA.EBCH.ZCGB.hAAA...,1,-6,-18,12
SFCZOfWNLJXTeUcYEaQGgbDAPdIRBVKHM,dBEFRFAABBACHEEBFHDEOCHF.....fHBFNCCFLDFBhAAATABDUDBH.EDDD.hABAaDAE....gAFEhACAAHHHPFACKAHFCDHA...WAADeHAAhADA..cDFF.hAEA...,1,-5,-34,29
XABFINaPUdKCOfcQVYGHWJebZMSEDRLgT,FGAGaCHD.dCAEKDCG..CCFF.OAEG..QDCFGBABHFCDhAAAJEHBZAACECFHDHGA.LFFDhABAXGEAAEBHBAHHhACA.NDAE.fCHA...cGBEhABA...YADChACA,2,-34,-21,13
SYMZEcWHQKgBUGODJPCFdLTebIXRfaVNA,MFCEEAEAHDABKEGCBBGAOBCF..DGBFJCGF.FGGCLACE.hAAAeGDAbFDH.RCDC.fCEGhABAaDBC.AACGSFCHhAEAZBAG.QAGE..hBAA......hBBA...,2,-36,-13,23
MYdFTgZJbLecOaQIDXBHVPSGRNCKUWEfA,dAHGFFGEZAEALACE.OHEEIBBADDGABCDFHCDA..SFEHhAAAGCECCDBCKGADEGAFADBChABA..MGBE..hAAAgFCCJEHF.cDACaEBEXBAGhABA.....hACA...,1,-18,-33,15
OcPUBHSZfbJQYIGRVDAedKLTECMFWNaXg,dEABKBHBEGBDMDEE.FEEA..aAAB..OCAEUDBGBADEZGAC.JEFHhACAQGGE.hAFAIAAARAFHADEELFHBhAHACBGC..XECDPBBESHDGhAIAfBCD....YACChAGA,1,-23,-32,9
OHIbgWLYKVNdTcCQJXaSRfUGDZAePFEMB,FBCEBDBGHBGF..IBFF..gDACLBAGKHGChAAAdEFACFCEQDGHhABAaDEBSGAAfGDHhACADEIBABGHEAABOCDD.bFAHWHFENADH....hABA......hACA...,2,-30,-20,10
fYaMGWLcCeREgOKBNAHPDTZIVXQSJUbdF,DCDETFDAZDEE....XFGBSGGBUAAAFEAC.aDCEMEABhADAGBBBLFBDCHAFECHBKABEhAAABFDGAAGA..IHFChAEAJHCAdDBD..fADHcGBA.eFFBhAGAgDFBNAIC..hAFA...,1,-14,-22,8
VDJbeHAFTYgfaLPGXKZMBcUOIdSREQCWN,TFCF..fAEGLDBEXAGGZGEGBACCUFAC.hAAAdDDHSEFBhABAEEFFCDBC.NCHCDCIBeCGBAFFHYFAHhACAaAGGKAAD.cABD...IAEChAHA.WFHH.hABA...,1,-13,-32,19
UAYcTVKeNJWEOfFdLGDIgQXPBaZSCbHMR,TFDCeCDD..JAFFOACEFFGG.GBFADBCB.QGGHhAAABDGHZADF.CGAGMDIBAHAA.VCCFhABAKAGEEAAHLCAHhACA.IHCBXFEH.aCAD...SCHBhAAA..hACA...,1,5,-41,46
eXSfcKIgUNECVAGFaTDbQBPMJYWdHROLZ,aFBGDDABBEHF..MDAAJDED.dDEFHFAAOFHFZACG...XFEBhAAASAAD.KCFEhABAgACFUGGGCGEH.hACAABHBFCHD.QGCA.YFAFhABALAHHeAEAICDChADAEHFA..,1,-18,-28,10
FKBPWcRVZHbDQAYGMfgSLOTNJXICaedEU,MDEBSFHDLCACODAF..NEBC.JCDF..CAEB.eFCBdEHCECFDhAAAKAFCBFFF..hAAAPHCG.RFFDVAGFhABAZACCDCHB.AAIFfBBG.XGEEhABAIECF.aABE.hADA...,1,-11,-37,26
eGSRJFTAUgaHKcZIQOLPEfCBVNYDXbMdW,aEFDKGCBZACC..OCAALDAA.ECGBBHBF.VBEHDEEGMAIFhAAAdDAC..eEBERFFBFFAChABAACIDHAGH.IABDhAAAfBBECHHCNGAD.XFDB.WFHHhADASEHF..hADA...,2,-25,-22,3
FaBOfVDJWcPLCYgdSeAKEIQZUHMbTRGXN,KEEEEDDGZAGFMAFH..REFDGBACFEGEBBCCOFBF..DBBBJFDB.hAAA...PHDEhABACHHEdACDAAFHUAGC.TGBChACANCCD..aAABfGGD...hADAWCDF...YDAFhADA,2,-35,-26,9
DcSTUZaeKJXLgfYWIFMNbQOdGRBVEHPCA,DDAESGEGZACFKGFF.LBHD...fFBFIBGFMFDChAAAQFGFGEAAhABARCABBEEEEGDFHDGHABBCUACAhAAAaAFG.JAFD.YHAEWECC....hABA.NIDF.....hAFA...,2,-20,-13,7
HcBEeMIAQZOGVfaCFSdLNTgKWDPRUbJYX,OFDEGDADaACDFHBELDBG..TGDCKHEGDBGAUFGF.hAAAbAGBJEHF.HACDBFEEhAAAMBFBIABA.hABAQFACfEAESDFGgCGChACAWADH....hAFA...,1,-18,-22,4
DPAFOTaBNLUEQcMXJKYSHgIVdZCbGfReW,TEGGBFCEUGCB..EDBCMADCKBGEHACG..VBFEdGCECDFGGCBBhAAAeFABDCADAFGAOABChABAaABB....QGGBhAAAXGGFSEEC..hAHAgEDB.hAIA...,1,-8,-33,25
IFYMeXJQWBfdTGAaHCcPVNKOSgDERZbUL,HDACCHEC.VGBGKBHHOCDFDBFD..ZBGDLBDEFEED.eEGHhAAAXAAB.JGFEBEAHhABAdGAG.AFCEaGAD..hACAPACFSDGF.ECBDbAFB..IHHDhADAMIEG.WDEHhAEA...,1,-5,-43,38
UGbJXWCEOVITfeHANRQgBaFKMLZcSdPDY,QBEEBCCGKBGDLFAFSCHD.DHGAGEBE.JFHBWCCFhAAA..CDAEEFDGIHAEhABA..fABChAAAAFHHgDDGMAECcGCAdHEH.PDAFhACAbDEE.OADG.hABA...,1,-19,-32,13
QKeDFacCXWfVNBZdLSJMYHPGbOgIUAETR,EHCAQADDKAHH.FHDAaECA..CAHD...XCAGVDEEBBABhAAALCGFMFACHFGFhABAGABDODAAUFABTGGGhAAADGBA..fCHEdFDD.SGAGhACA...hABA...,2,-18,-14,4
MeDUfTIcbGVHNLKEWFQgaJOZSYRCBdPAX,MIAAeBCBDGAEUGGF....IADGGBCAVDGBLCFBEGBG.hAAAFHCG.aBHBZBADSAFChAAACFEHBAGAABFHXADFhABATGGHHCAD.NCECKHEA.....hACA......hAGA...,2,-20,-7,13
bQAaDHIZLWdKPJCGTeUOcgRYBSENXFfMV,HEGDZBGBdADDJEAHCHHH.GDBF..eFFEUGDAOCCFRAABBCHCEGAGFADEhAAA....VFDDhAAAAACFDGCD..LBBDhABAKCDC...........hADA......hAGA...,2,-27,-26,1
YUNAPLDSTcRQKdEOGVWHbCMJFeIgXfaZB,DBABSEDCRDCC.dAFGODGFGAACHBFECDHF.MAEEFFGEeHCGhAAA..IBCAhAAA.XFDHfGEDhACAaCADBHBHNDCDAAHCPEAHcGGHKADF..EFBGhABA......hACA...,2,-27,-13,14
cRXAMUJOgWBFENbTeVfKDHPSdLYGQIaZC,JGCEOAGFBHFBFAAD...EEEB..TBDGeFDBKAEHHBADdEAALADEhAAAGCADQGFAhAAAZCFGCGGB.RGACXCFDhACAAFBBMFFA..gAGHNAIC.fDDGhABADFID..hACA...,2,-33,4,37
NLIfEZcGXJRePdCYQgUTFBSaVbWKMDHAO,OCEDLFDF.EFAHGDBCRBBA.dDHAQDEETADC.SCGBhAAAaGFG.VFGFhABAKAACMAGFADDB.fCCDhADAcGEH.JFAHCAEB..gDAEhACABHHEDAIB.NAIAIHBDhADA...,2,-15,-15,0
GaVMegXfPTJBcQUAKZLNOESFbWHIDdRCY,KGBAZEABOCBGECCA.FADAHEGH.DFBECFCCGGCHaAGC..MAFDhAAAeDGF..XBAFhABAfAABJFEDBACEhAEAQAGAADGGSDEGWDEB....IHHEhACA...hAHA...,2,-26,-21,5
OYIGVebNXMBFfZCQJTdAHDSgWKLPRcaEU,DEEHSDCCKAAELADFREFG..aAFAUGDBOBFBGCBG.eAHBhAFAXAAFBGHDFBFFhAGACHEAQEAC.hAIAdCHGAFFC.HGBG.gACA..hADAWCHDEGGD....hBAA...,2,-35,2,37
WZfETePDUHKSINFAQXaJYRgLBcMbOCdGV,QBBFJEEE.RCEDBAGBMFIHCDDFGDACZAAB.EFGD..eHAChAAADGDAKDDF..SAHHhADANBIG.FAFAAABAaHCGhAAALCCEOHFCdFBBfAEA.hAEA.PHDCICGFhADA...,1,-22,-24,2
cYCBgGfMWHKbSRPaQEAIDZNJeLUXVFdOT,DGEFZFBEJDEALABG.UAGDFGGFdEAD..OFGF..TBCDhAAACCEABCAE.GDEDhAAAMFIBKCHHRDAA.aAGCAFIDeFBHhACA..XBAF...YHCGhABAWFFD.SFFChACA,2,-37,-31,6
BfFbUgLMDAGCJcYOSeIHVQKEaRdTPWXNZ,CCFGJEFE..OAHFeBCFHBECKEAC.RFDFdDDH..TAAC..hAAAPCABXGEEBGHGhAAAFGAGUGAFMDHHAFBB.GDCAhACASABCIADF.EEEEaGGHNEICfAFEhAGA..hAHA...,2,-24,-13,11
OAYLXgBCUcZfVIGTEWNFbHeaJQPDSMdKR,XEDDBFGECCDBZBEB....VBAHGEBAECHB.FBBHHAEE.JDFFhAAADIDCMICEKGDAAFAELECFhABA..UGGHhAAA..IHAHNAIA.aGHFSABEhAEAOHEA...YAGBhAFAfEAE,1,0,-44,44
NLOEbHJPXfRgSeVUDZdFQcGTCWaBIKAMY,MAAHLDFB.EHBAHAED.JHAAXCCHRGDG.eAECDGAAFDGChABAGAAGCDCCBFFEAHFBNDIGOEAHhAAA..fHGFhACASBHF..ZBBAcEDDaDAD.IHGChACA...hADA...,2,-29,-3,26
XdPLEYWBGcJbVCgKUDFSHRNZIaMOTefQA,dAFELGCEEHDGBBDCGCBH.JHFGCDFGKBBBDEID..HAFEZDDH.MFABhAAAOBHF..eECAhABAAHFA.XADB.hAAA.PFBHWDHF.bDGD......hABA.....gDAEhACA,2,-32,-24,8
NcWPAaUBEDHGYTebOSZXIQKLRgJVfCMFd,UFEFDACDGAEBeBGB.ODFEZDCA..XBBCKDCFLHFA.hAAARFCA.VFADMDBFdAEG.hAAA..NAIC...WADFhABAACADBHHCEFFE....YHAA.hABA......hACA.SGDD.,2,-18,-17,1
ePcMOdIQEbBVZHfJWDgKXaCFLTSYNGRAU,eBBHMDGBdBADQEEEBFBFZAEBHGBA.fBGFDADBKDHD.aACFhAAACGBA.FCECLEEFhAAA..YHFChABA.NAEBAFBAPAHDODDBEHGG.....hBAA......hBBA...,1,-2,-38,36
DaGMgBcYCWJeQONbFKPASUfEdZHVILRTX,SDDBEEECdBAF.HBFGLAGDREAC.XGFDaAADMIBCBDDDhAAACGFA.JEABeDGB.OBDGhAAAFHBGABDD.ZGAETEGDhABADIFAgCAA.WEHH..NAIC.hACA.KFCGfFEChACAIAED..,1,6,-28,34
AEaOMXcNCDQWYUISBZTGRfePLHVFdKJbg,OEAHXGGC..CEBCDDEDQEFD.UGCDBHGCZCEETABBhAAAGACA.eAFELBHDhABAFAADKEBGJFEEAAEFMDIBhAAA..NDDGICFG...fADDhAFA.PHAChAGA.,2,-48,-4,44
HNBcTPgIVFefAZGRSUKQEdMObYLCXJDWa,RFGBKEBCdAADMIBE..OEAELADD.JFEHDDEH.aBGABHGF.hABA.TBEG..hADAIDGGFGADADHFSCCBhAEAUBADEAGGCFCHXGDAHAEH..PFFAhAAA.....hAFA...,2,-35,-23,12
ZNGPYJWILaVHFBdSKUMXbcefTDRQEAOCg,OCCFCFDFZABCGBEC..JEADLFGDHFDGBBBEdGAFKHDCMIDA.hAAA.XCAFeCGHDCEEhAAAEBHHAADA...NADB.WADAhABA..aDCCFGHH.SDHH.hACA......hAIA...,2,-25,-20,5
HQLEJDFCTcdegfNXZbUGMRWOPYaAVBSIK,VBBASBFA.KFBBLHEG.DDFHCGECTGGDdGAAeCGH.hAAA...NBACXBBBhABAZEBFbAFBMDIH..hAAAOEFCaEDBAICABAEDIHAG.EBDC.FDEGhACA......hADA..fFGC,1,-10,-31,21
XcMbPYCEgeASOUQdWDIfGTLKRFBZHNVJa,OGEEQEDDdCDCDHAEGBBD.KHECRBAFFCFHBGAA.HCFA.JAAGhAAAaAFGMBEG..bCGHhAAAPEAG.CHHBEEGChAEAAAEBSAGA.IACB..hABA..fHCBhAFA..,2,-42,-3,39
AJSKIBMeLgfYGNHdRZQVOXabcWEFPTCDU,JBDESHBGBDEG.LGDG..fDBCGCAGHDFAhAAAdFGDRAGFVAFE.OADDhABAXGDGaHFEWACFhAFAEHFCFGAD..CFDBADDDKBAF.MAAG....hAEA.eCHH...hAIA...,2,-23,-9,14
eQdWUBEKYFMTDCNacHfRAIZVgXbLOGSJP,VAEFXFCC.LEACGDCA..SCBHeACFdBFCBHBDhAAAKHEAFFGGDFHD.CGEHaBABfHBBhAAA.IABHhADAbFFHOAHB.PBDDWBGHEGHH.MAIBhAEANEIG.....hABA...,1,-14,-19,5
BdbgHTQeSZIENARGLUMKOJVCXPfWYacFD,GAEAUDBGKGCEOCDB.CEED.XAGG..fBAHhAAAaCAGDDEABFHEdGABbEGDHGFEhAAAQDAFeEECIBEFhABAAFGDMAIH.PHDE..cFAChACA......hADA...,1,-7,-31,24
VDgRCAYbUPNJSIZcdOEafHKTLQFXBeWMG,UGEGJDGHZAAGdBCG...aEBDKECE.LAEEQBFEBBEHMAAEhAEADGBB....CHDB.ADIH.hAFA.bGAASEFDhAAA.OCAFfEEFFCHF.WBEF.hABA......hACA...,1,-25,-43,18
AbICZWQHGVBeTfdOSEJMDRYaFgKcPULXN,CHFBZBCFHCAHGFEHBAHGeAAHdHCF...OEAFSABEMAEDDGAHhAAARECCFEGAKDHD....hACAPFAHXGCCACCA.hAAA..ICFBVAEBfCGF.hADA..EFGB...hAFA...,1,-13,-25,12
XdRHbWaQJeNLCUGZcIFEKSPBTOAMgDYVf,MAIFDGGH..VFACXBABHDFC..aACAQEDG.JFABhAAALBBFUCFBGGEBhABAICDEFADAEDBCPFDAhAAABFGEABAH..YAFCfHBH..hACA......hAGA...,1,-15,-22,7
WNLCaeYdVZOMADQGfUXSRcPgFJbIBETHK,QGGFGAAGUCDGRDFA.....PHFGgEDB.FEBDhAAAIFAEBABBEAHFKADAhAAALHAACEGB.eADEhAGAdAHCOGBCDDDGfBDBSFDA.hAHA......hBAA...,1,-17,-27,10
FTAGQYKJBOfXdgRNPZeHEUIWMaDSVcLbC,QCBBJEGDBEDF.OHFGdCED..RBBBZGBGHADH.UCFG.MEEFhAAASADELHAEhABAFEBHAGBAKDAD.fFGFhACAXGED.gAGEeAHHEAAFIAGHhAAA....hACA.DDIF.,1,-2,-35,33
VQNGJaAcTUIYeLOdXgPCWRKZfHDbMEBFS,TAEHUBDDeCBH.LEHBXCACCGBG.KCHHHEDCDDFF..EEDHSAFEhAAA.NIAF.hABAaGEE.AFIHIHCHhAAAOGDCdCGDgABF.WCGDfABChADABHHHFEAD...hAEA...,2,-16,-16,0
DeVXUIHCdNbLgWQYZBcaGPSMfKOARETJF,TEDGFDBFDDGH...eDBBUGCAHDGFdHGHLACEQBFCBFHBhAAAaBAASGEHhAAA.MEADOAHHAHIFECDChABAVBCAIADH.bFAHgEEDhABA......hAGA...,1,13,-39,52
ENYObVdCISZgcGMLPKQJDeRaAHBUXWTfF,BFDGXECF..TAADFFBD..EGGHOFGBdBAE.CBHFZADB.hAAAGDABPEFEKFBDQAGHhABADEFH.eGDAhACAADAA.HACHfCHAbAEF.SFHHhAAA..MIAEhAIAJAFBaACF.,2,-31,5,36
JXdBIECKcGWFRMLQDZSbaVfPeNHAOgYUT,OEHHUBAF..XCGHdBACEFDD..KBEHGEEEFBGA.MEAHDDEFZBCDhAAAaFBA...VGAGhABAfHBD.eBDGhAAAACBE..gGFDJDCEIHHGCEAARCFH..hABA......hACA...,1,-14,-24,10
IegGFWQLVCTfRSaOAUJXPEKBcbdDMHNZY,JAFDECEEKDCFBEDC..dAADHFFDZGEC..eEEAFACFQDGBhAAALADGCHCA...REAFSHDChABAABIB.XCCChAEAPFADDGGC..MFID.IAHFhAFA.....hABA...,1,-15,-37,22
DMJeYdUfaKIXRECZFgWSLHQTVNOBbPcAG,GADFDAFFeGBGdEFBUCCAKCCHRGCC..ZDGBFAAE..SAGEhAAAQEAG..TCAGhABANBIEBHGG..bGFEADGAMCEDhAAAfFEF.IDFHEFGDCHAF.WHBGhACA......hADA...,1,-17,-28,11
edDKYHLFQcbRXNAOTVagMBJZWIUCfPSEG,TDDFaEAABAFE.ZDEFUDAE..CCHC.SBGAGBBH.DEIHHEGDhAAAFGBD.QGDHhABARGECXACDAADAOFBBhACA..MDFGIAHCEAAFKEGH.YAEChAAA.....hBAA...,1,-13,-21,8
gVeMGcPWKTQfLadXEYONACJIHSbDRBZFU,JFDFSEFC.DGBHRCCGFFBD.UGGCeACE.MDCCGAEF.hAAA.PGCAKAAEQDAGhADALBBFXGGAhABAOFEG.ACIFCAHD.HAFB.BHFD..hAFA......hAIA...,2,-32,-19,13
AOUQMIFSHcGVXfTDdaJLbYKgCWeEBPRZN,UCAGMBAFFDFGHDDEGBCH..fAGADGFDdEHALFAHhAAAKAAECDHGEFHDBAGEZFACADFCOBBHhABA..SADAhADAXFFB.TGFCaAHDJDDF.....hAEA......hAGA...,2,-20,-15,5
UEKIdPYGXWeHMcLfOZSaTDVRCgbJBNQFA,EEBBKGCEdHGDGEEF.eAFDHBDCLDCEOACBaEBADCBGRGBC.CACD.JEAFhAAABAGG..FCHDAGHH.hAAAUFFB..YAHBhABAMIAE..fAHCSDAF..hADA......hAEA...,1,-20,-23,3
KFdBLTYceIHEDMbOaRSUVCXJGNgZPWQfA,dFGHLDCF.TGADeAFCHBBF.MFEHaABEUDEGXCFDhAAAJHCGGAGAZFAFQADAhABAAAEGFHGABCAEIHFChACADGEA...........hAAA......hABA...,1,-7,-24,17
FECVHMWOdDLPSAZaJNefgBGKTRXbUcYIQ,ZDBFJFEG.eACABDCFKGDH..RBFB.UBFA....IAHBhAAAEDDFCHGF.MBEFdFFHDCAHLEABhABAAABC..aHACfHEDhACA.gABA..hAEA......hAFA...,1,-40,-44,4
CcFaXATMWBGRHZLKgIVeOEYJDdUQNfSPb,MCGHBEEHRCCEHBBAZDACLHECKEHD..IHBCeAFG.OADEhAAAEFGEDACGdEAA.QEDEhABASCGECFCGFHDEhACAADGA..TAAEgGGAJHAC.NAIC.fBDDhAAA...hADAcFBF.,1,0,-21,21
gDJbZMcUNQeCSdPLKHABfFOYVIaXWGTER,BHAGOECA..IFFGXCGB.GEAGECFA.RFFB.DFAGJCAAMCEBhAAA..UADANDIE.hABACFHEdAAHKBBF.ADGFFFDHaDAC.hACA...TACB.ZGEAeAFCSAGChAEA....hAFA.PFCF.,2,-16,-12,4
KLQbYJSMRNBgFHTaDEAeUWXOVdICPZcGf,UGEBXGAEdDBC..CADH.ZDACGDEFLHFC.QBBGhAAAJAAG.MEEFBGAGHBGHhABATBGBDEIFADDG..OCCGhAAAIFFC.PACGKAFCSFBAhAIA.....hAGA...,2,-31,-15,16
cMTFaUKXIQYEgOfeNVPRWCALZdHJDBSGb,ZFFDHGCAJGBABABA.SAGEGDDHMEABaDDG....KEFGIACBhAAAQEABECCA.hABAgGGG.hAEAOADCeCFGNBBCPBHHCBHBAEIBDIAC..cBAHhAAA.....hAFA...,2,-27,-11,16
FfAWRaSCdLgeOTUEJHcPMKGbBYZXNIDQV,aEDBSDFFLDBHeACEUEGBHDBH.MABBGAGEBFGAXFDDhAAAIHHDDFADQGBFhAAAFABGAAID.CGEFdAGFhAFAgADCECCE........hAGA......hBAA...,2,-25,-5,20
DJPCdFKEANfcbLMHSeVQTOUXaRBIGYZgW,...fEHGbAFALACFMAHDHFEGSACDVCGH.TGEChAAAUGAHaCEBBAFFIBAGhAAAZEBADIBAJDDC.CDACKGBChABAEEBCAFIH...eADCXGGH..hADAYFDF..hABA...,1,-4,-10,6
SFYARMOHGUcZgebKfVNaLPCBXIQdWEJTD,REFDOEBDHDAHUEDAZBCE..eCADKBAG...VDFFaFAHLCFEhAAABABBQFDCEABEJADC.hAGASAHDAHDA.hAHAMIAG..........hAAA......hADA...,1,-20,-29,9
VERWbBDANGdLSfQCJKFHUZeIPaTXgYOMc,dDBHSGEDCHDG.FBCAHADFZEAE.eCHH.aFBBXGAH.hAAAODDGMCGFVFEBhABAEFFERBABBHCEDIAEABCCLAFAhACAfAHAKHGAIHHE...TDGDhAAA.gAEBhABA.,1,-12,-25,13
EDUKcdgFHBMYINReCaWZOPATLXbVGfSJQ,XGADVBFD.GDEEJDHD..DDAAKCDF.dGHCHFFFBEAHMECAhAAA..IEHFhAAAeACAaGAGZAEEADDG.LHDAhABASHBCEFCGcCGBFBACNFBB.CACF....hABA......hACA...,1,-9,-22,13
LfGXWeHTZgbPORQAVNKdJIYScaDEBMFCU,KAGCJFDF...SDFBaADC.EFEDBBCGMFIFCBAGLDDAhAAA.GEAEWACBTEAHhAAAZGFA..bEFAPAEBhABA.OGBEAAHANCEF.IBBB.hABADCGCfAFDhACAeHEA...,1,-12,-33,21
gUPdHKQWXISAFCRELcJVDTfbNGBaYeOZM,FBBFEEDBLCCG..JCHBDHAGTFCH..fFGHhAAAGBEEBHAAeAFGMAAEhAEAgCGAdGFDKBGEXDBChAFAACBDCHHGRACE..cEAD.bEEH.NIAHaCAHhABA.....hAGA...,2,-32,3,35
GbDHJFAcgTRUKEaVYQfWCZSOPMeXBILdN,TGDFRDDFEHFG...aCCFQBGD.CAEDZAAEPCGD.XAEGhAAABGGEdCCCbCAHDIBGhAAAHFFHAEIDUFADKGAAfABFhABAOCAD.MFIB.IEEAhAFA.NAIG.FDGD...hAGA...,1,-8,-17,9
GLRHTAYPaDgSbNIUFOZVMeECKWcQJfBdX,aBEDDDIB..SEFB..IEBDFGAHOGDCVGFCEECGKCGAhAAA.QABChADABCGCdAAA.XAFBGADGLDBFhACA..TEEAAHHE.PHBAhAEAbAFA.NCDE....hADA...,1,-14,-25,11
PcBMCOSTDbAZEFXHaLVfNQGgJIKeUWYdR,ZFFCXEGDaGCG.LEAC..VAFDQGABJACF.KCCEhAAAUDAFdEEERBFDBHHDMIEEhABACDEH.SABAhACADCIBAHFE.EHCCFAAF..NAIC...IHDChADA.eFAH...hAEA...,2,-29,-11,18
bBKaVMDNAfWCTgcGeYSOLXPIJRHUZFdQE,CDCATCEEGABD..eDGHOFCHLAAA.XBGEJAGFUGGChAAAFGACdDFGEEBBBFACKGEFaCDBhABADIDG.AGHB..fAEFhACA..cCAESGHHREDB.hABA......hACA...,2,-33,-2,31
cKLZVONHCQXWeGBbFJUEaYfDMRSgPTIdA,KAEALAABZEAE.OFECCCCA..QEGDeFCDBAHCFCGBUAEHhACAEDAG.aEDB..DFEBMHFAhADASBAG.hAFATGAGAFIHcCBDNAIE.......hAAAWBHH..bFEHfEFBhBAA,2,-38,-23,15
KMfdUPAFbZNeBVgYTLIGHWSDQaCcREXJO,ZFAEeBBABBHB..VDFBTBDBLCECHAAGDAEECACF..EFDHXFEBhAAAOEACMIAGhAAAdHCFAEGGFDAE..NEIA.IGGAhABASBAFaDDE.cAGF...hADA......hAHA...,2,-23,-14,9
EBRUMCSeLXYbIDQFfNJZTWdVGKOcHaAgP,EFBABFAERCBA.UDFH..CAHDLFFE..bACADCHBQGFFhAAA.FDCGNBCFTGDFhAAAdAGAKGDDOABHhACA..aHGGABIBMEIBSCACXECEfDEAhABA.WFAFhACA...,2,-45,-18,27
OXRJHDCSgbGIYfWLMeKAQadUNVTZBcPFE,QCFBaFFH.dAABVBEHBEAAFDCDEFFHRGAA.HBCB..DDBBCGBASAGFhADAGEGCIBBGhAAA..fHFFhAEAMADAAEID.NBIEcECH..XBGBhABA....hACA...,1,-15,-30,15
DNXeBHTSfUbFZIWJCaRVPOGcYdgEAQKLM,QEDAMCBEDEBC.eBDCHFAC..TDAGUEGAZFEF.JACERCFBVAAEhAAAGCDHdGACABFGKHAAhAAALHDG.BCHDhADA.fFHGIAHDCHHBOAFA..hAEA......hBIA...,1,-3,-21,18
OESMeNJPUZVGaLdQCTDFfKXAHgWBRIYbc,HBABBFFERAFD..IHBA..bCAFOFFB.EFBCSADHhAAAeCEEJAECZEGHaFCDLHEGhABACEECDDIB.FFHFhACAKACFADDG....WHAG...MDAFhADA.NEEH.....hAFA...,1,-19,-31,12
JNYHCZGUfVIXDBOLTWQRFePbgKadMScAE,EDFAJBCAHDEBZFFAGECAUBGA.....IBCCBBABTFAGhAAARAEFeHEC...gDABhAAAKGGAMDDBAEGECGAF..hABAfBHGDADALHAGWABEFCAH.aHFCSHAAhAGA..hAHA...,2,-17,-16,1
KBLcXHgYbePTWQfZAVURMOECIFGDNdaJS,UGABRFFCMBGFODFG..EBDBFGGFDIBGdACF..aFBGKDEF.BFFFhAAALACCHBBG.gBABhAAAeBFC.PCHFhABA...QDDBAAFHIHEBNHAFSAGEhBEA..hBHA..YBAF,2,-30,-20,10
eWBafQVKMCXgNOADTYRHJSFUGPZIEbdLc,DBDGTGEFRDGBHBEG.FFEBUGAG.ZBBGECCGdAFBLBAHeDFGBCHDhAAAQGAAMABGCEEE.XGGChAAA.NACH.AHHDSFCBhAIA.......hABA......hAHA...,1,-18,-25,7
REBSOTAPgbdcYXLQaUeHMZKFDfJCIGWVN,...bEBFdGBB.XCAFaAAE.HDEBZFDAKADGFBFGDAEGCEFE.GEGChAAAVBGF.ECDFBCDBOABChABAAAIH...cGEChADA...LAHB..eFABhAAA.MDAG.fFHGhABA,1,-16,-28,12
bEYCQVULZeIKXDOHMBSAacRfPFTdGJNgW,RFDDFECBdEBFGACH..JAFD..NDHC.....bADBCGDBQGADhAAAUBBCLCHFIBAChABAKHBG..DBAH.hACAHFFHMDAEBAHCAFFEcAGF....hADA......hAFA...,1,-23,-35,12
JcLNKFSfdYQZXBAGOIRgMEDeHUaPbWVTC,GEGEODFHRBCHEFCEHAABUAFF...aBCGbDGB....TGAFhAAACHAEJFCFLAFAhAAAFDAEdHDFZDDCBHHGACAD.MDABhACA.DGEH....WABC.NAIA...hAGA..SEBFhADA..,2,-17,-11,6
KgQGTZHPEMbRYDOdIcWXeBfaJUNLFCSVA,KEEAQGFFGDAFHGBAEBBH.MABCRDBD.DAFDIEGC.XDDFhAAABFHDaBDFJFAHUGEEhAAAFAED.SAGGhAHAAIHETGCD.....PDFA..OABAhAGAdCBF....hAHA...,1,-8,-18,10
XYDHUJfdgKMWSbTQCFEGLNVeRZIOcAPaB,aBFBBFFD.DCDAUGGEdBAB.KADB..SEBDQGDAFGDBGCABhAAALADG.eDEGhAAAIABGACHA.PFAFhADA.HDECfHFHMAIB.WFADCGCC.hAFAEFHD.RCAE....hAGA...,1,-15,-24,9
YOcCREWNKZbdIgLAQfUTaeMDSFGBXVJPH,UAAEaADB.DGBCFAFCBHBC..VEEBHDDA.OCEGCBHA.REGF.EGCEhAAA.KBBHdDCCLDDEhABAABFG..TGDHhADAMIDASHAC.JCAH..YAHHhAEA...WFAFhAFA..,1,-28,-30,2
YIKEZcROLdGAbWaNQSCgUJBHVMDeXFfPT,aBEBQDAF.CDEH.JBBFBECHMFFGeGCAFGBF....TGGFhAAAIHFB.EDGARBFDODABhABALBBGAHAF.WFADhAAASACC.gFDD.hABA......hACA...,1,-23,-38,15
gKIFWQGaMfESHRePAUYDbOBXLcZCJdNVT,UEGADGDABDFGLEAEZBAC.dBFD..TDBBKFDHFAAD.GCCDhAAAaAFA...EGBGSGHFhAAAeADCAICA..OFFHhACACHFFNBIA..IBFHWAHH...fHCBhABA.PEAHhACA.,1,-13,-53,40
AWJUOQPdVYNIcESeRfFBaTXGMZgKDbLCH,JECGQGDH.dDCAVBBF..ICEFEGEC.RFGHBBHFhAAAaBFEGDGCMBBEKGBFDIGCCFAHhAAAAEAE..UCGH..hABAOHAENADF.eAEFTEEG....hACA......hAIA...,2,-28,-20,8
PRXfJOZMHKeAcdVUSDQbLBFgaCNWTGYEI,dDGGVFEDSDDA.DAFEQDDF.BFCCaGCHCCECNCBHGDGGhAAAEBBD.IDBDhABAXAGA.fACEhAAAJAGBZGAEMBIHHEADAAEA.cGGD..hABA......hADA...,2,-33,-10,23
GBbENUcVfdWHXRZgSDYFPKIAeMCQTaLJO,MAAETCBCLCCD.OBHFBGDHEHACUGEFVADH.dAAAXGBAhAEARDFDZBGF.DBFHFHGGhACAKEDCeFACCFAE..aBCAhAFA...JCGF........hAGA......hAHA...,2,-25,-15,10
EOTNDHLJbdMIBKaFRXAQcWVUZCgYGSPfe,QACGVEEE.CBEHGGEBSAFAeAGFEFDB..OHCChAAATDBDDEFFLAAHhACAdEDAMBBFKDHBaCHFFGHDABADUFADhABA..YEAF.NIAFHACF.hAEAICGE..hAEA...,1,-3,-12,9
cZgeSXUWAaMBFNVOJGTICRYQHdDbEPfKL,BFHCFEACOBHFJBED.GEDH..CHBBRDBBQABHHACD.dHEHhAAAEAHHKCEALHEGhAAAZGAGSGGE..hABAWBGDADDBaAGG..MBAF...TFEFhABADDAC.fFAChACA..,2,-26,-19,7
TCYMZLSRfaDIKbWNdHcQJUGAFXVPEOegB,XBEBVBFD..EFFGOGDABAED.CHHFZCGHLECB.SABFhAAAaABCDIAE.ICCEhADAKCAE..WAFEhAAANCIAdGAGHDDA.QEAH..JHEAhAFAACDGeHBE...hAGA...,1,-13,-26,13
CgWMPTBEQAJIfdKcOSbaNULFDVRHZGYeX,JACHdBGAOEFC..SGFAaGGB.LHBADBEBREACHAAAhAAA.ZGCEGBFCeDDBCAEBhACAMBAFBHHCEEDFAGAB.fFAFhAAA.KAHDNAIC..FDAG..YBBFhABA.WCHHhADA...,2,-37,-9,28
MBKJULbQWeNYDCZcFRIHEOXAGSaPTgVfd,GDGEaEAA..TBAFVDAFdFDH.BHAEKHGCLBGD.hAAAbGACeBCA.NIEHDABBhACACFDGFFFGRDDA.EDDD.AFAASADChAAAfACFUAGDYHCG.cCDAhABAIHCD...hACA...,1,-11,-23,12
LdKNYgUFcPBXOefEbHWCQZMSGTaADIVRJ,VAGHRFEAdHABKCBH......gFBCUAGFFDGEBEEBOAAHhABA.eEFBEBEFHEAEhAAACDAHMEHH.SDDBhACA.aBBAABBGDBADIGEHJHFG.NIEB..cCEAhADAfGDE.hAEA...,1,-20,-32,12
cHVNGdBRfCAaYXKFPSDEgLUQMObeJIZTW,XDACKFGHFBAD.DHEELBFD.UGACMCDH.OEGDeHDGZCDFhAAATEEAHDAGVAABhAAAdCHABAHF.CGFGAGDGaGBGhACA.PAGHEABG........hADA......hAEA...,2,-27,-14,13
QgJNfTaBVZXHEOSGURCcAIdYMWLPDbKFe,dBDFMHFCLDFBDHCG.FEHBQBCD.JCADfGHAhAAA.TGBFaCFABDFBhAAAVAGFXFBGhABAHCAEEEDASDDD......hACA......hADA...,1,-11,-41,30
BUHEWOSDVbMZFQKdLgXRaIPGCeTfJNAYc,BAABEDEA.OAEFDHCAMFHHFCHD...dADFLCBERECE.aDFDGBAGhAAA.TBGDhABAJFHBACAHUGCCSGBChACAZDAGKAGBXGEH.CHAD.fGAEhACANDIA......hADA...,2,-33,-7,26
NDQTMSBZGebERaKJgfVYFAOWCHUcIPdLX,OACCHFEHUACH..IFGCLAGHDDFFMDAEBCAAeFADECGA.hAAAaDEC.KEHD.JFBEgGAEhABA.fECGhACAFAAFABFFCHHH.dCDGNAIE.TGEH.SAFHhAEA..hAFA...,2,-35,-10,25
adEVYIcBOGTbHSMKNDWZQPLJRgeUCAXFf,XGECFBAGdEBH..EFFB..IBGCBAEBODHHGDCDHGAEhAAASACHKCEA.NCIADAEChAAAQAGDLBABhABA.JFCHeCAAAGFCaDFAcGEHMFBH....hABA..WHFA..hACA...,1,-17,-18,1
OKLTXYHBFgNEJQCMaGfdAUbDSeZIRVPcW,DGFFSCDBeAACZACGRFAG.....VEACPAAH..OHAEhAAAKFEGTCBFHAGBBDEGhAEAFBHFEHAGCGGEMFFC.hABAaFDDdCFE.AAEDIEHH.LHDAhACA.YAFEhADA...,2,-19,-18,1
RbMCSfHQINTEPKeJWOFVZXYdgcGaBUALD,LAABDBCAMEGD.SDEEHFBC.QGBATBEHKDDAJAHFFDAChAAAZFFBdAHCGDADBABCAIEEhADACHDE....IAFAhACAEFHD.eFHFWFAFOACD...hAEA......hAFA...,1,-4,-29,25
ZCPIRAKWSMTLfNOVUYDgHaQBdeGbJXEFc,KCFHSABGLEHHOADGUFAD..DDEBaGHBBFGCGECA.JCDChAAA..EDAAFHEACHDBRADAMBFAhACA...fEFGhAHANAAD.YCHDgBBE.dBHChAGA...eFFD.hAIA...,1,-23,-25,2
YMJNTEOgeQCPBXWLSVaRKDbIcUZdfHGFA,MCCFJBBH..EEDEeAHD.QGDHCHFDBAGHLFADaADA.DGCDhAAAbBDA..UADCZDDCHAAHhAAAFDGD.AGGFTGAFhACAOFDH....XBGASFDC.hABAKHGAcFGD..hACA...,1,8,-40,48
BMXYVFdKCHUaDcfANTJObSEZPILgeGRWQ,TBFDOCDH..EEGFZDDBLCEEeBCHRGFABHAHMBFA...VAABhAAAdBAACHGA.UEAGDEBDAAFGJFEFhAAA..SFGChACA.IAHC..WDHHYDFGhADAFACBaGDHfECAhAEA..,1,-7,-27,20
dgJXGRfSQCVKYaEeUbBLcZDHAWOMFPITN,MFDDFGHB..TBAFdBEGJDBHRBED...QBAHCGEDKADF.EAGAUGBBhAAA.BGFELCHDhAAADFABAIEC.OEFH.hABANEAG...XCGDfDDESDDFhACA.YAEChAIAaGEHcABA.,2,-34,-27,7
AfRDgeTEOLCYIFSHZXMKGbBaVcPUNdQWJ,RCCEDCIFeFFEOBDALHCA..CECAFABGZAEEXAAFGGDHBGAAhAAAaCFD....PDAHhADAdDCFQEFBhAEA.ACHF.gGGGEAGGSGCCKFCE..hAFAcGABNIAB.fDHEhAEA,1,-6,-35,29
JadfSPeTHUBMOQGgcbRAFINWECVKZLYDX,FDEB..IAFBECAGKBECLAAGDBAH..aDEBdDGDSFHFhAAAeGAAUFFEMCCDOEAAhABAgAGH.hACAbGDAAIBCCFAC..ZEAFYHDAfDFHTBGGhAEABBDD....hABA...,1,-13,-30,17
NAPMdSYJbcTGRUXaLBQEfZCVWIFOgKHeD,dHCFSCFBJFCC...TGBAUAAALBEGBAGBQCAHhAAAEFFG.CACD..IHEGhABAFDABKFBFDGAHABECMFDChADA.bFGH..cCDCXCCF.aFABfHFHhADA..hAEA.WFHB.,2,-39,-9,30
BEPGSHALQJZaIYdNMeFUgOVbWfDXKCRcT,QBABJAEEZBGD.aEDEdGCF...MFFCFGBCOFGF.VCFGhAAAbDBE...DAFECGGERABDhAAABDAG.ECDBSDADhABAAEIB.ICFGNICB..eEAAhABA......hACA...,1,-21,-34,13
FPHZdUeOfWRSgTNLEGYcBaDMKCAIXbJVQ,XCDEJAEH.FAGBZFGB.dBAGUFGEOFAFREBE....TCAEhAAAECGFGDCEBBACDAIBhABACFFCACID....IBCAhAAAQGDH.eFAD.fCHEhACA.SAEFhADA..,1,-12,-43,31
KRFbYgfCITNEBZMGcWOUXPSLAaJHVDedQ,HCDBVABB.eCFE.dFADQGBEKBCEFGFE...bDFF..gAADhACAIECHEBEGhAAABHEGMFHF.WEEHhABAXDAFLDAFAHBCDIAAfAHANAEB.hADA.cDFAODHF.hBFASDDB.,2,-13,3,16
HUTEISNbPDMKYXJOCFRGWgAcQZLadBVfe,ZADALCFEaCBF.dGGCBGDGeCDHHEEFUFAAEBHF..SGEHhAAA..PFAGhAAAMBCCXBACCGHEFCAHWHEAhABAAGDG.....cGAHfEHE.hACAIEFFDDEG.JDAEhABA...,1,-16,-28,12
LBSMARcXWFJTaeIOEPfNgbGZHQVdUYDCK,REAFXFDDFCHD..aFHBOAHH.ECCC..PAFD..hAAAfEAB.hABANCGGGAAFQDCFhACAUGADYHCGCDECBHGEAADAcBBA.JFDGIAFDhAAA...hADA...,2,-35,-14,21
gFMRdGJNIXEOCHZaSUAYQTPbfDcBeVKWL,QFGBTDEB....bBEGDHCEBBCFKBHBLDECFGDA.hAAARFAAJBDCIFAF.hAAAECADCFEHaDACSHGEhABAAACD.fDCEeBAGWHFGMAIF.dHBFhACANIAFOAFG..hABA...,2,-24,-8,16
geKXBACdcQOMWRJSILVUYNGDaEbZPFHfT,CECCdBAC.QGCHOFEFRABC...SEBGLHBEUCGHGEFGhAAAEGGGbCCC.ZCGFFAGAfAFBhABAeCADBCDDAFECMEAFhACA.JBCC.IHHBNAFCDIGAaAAG..hAEA......hBGA...,2,-23,10,33
dQfEOXcSTbZNBaICDMJeWFRULAPKYHVGg,KGDBHGEGGCGAQDGFODCFSEDD.TBDANAABBHBDhAFAIBBACCFD.DHAGhAAAMFIHeDAFRAFAAFFHYDBBhABAdGAFEBBC..XGFD....hAGA......hAIA...,2,-23,-2,21
UbNFfEDgTdJVBWeMAYOGZHXLaKcCQISPR,OAECHFEAXACCLDEEKDFACCAC..QGAGSFADRFECUDBBhAAANDIG..FFBGDBBETBEAhAAA..dGCEJBAHhABABHFHeHCEMABEABIDYAECaAHDIHHDhAGAfDCF...hAHA...,2,-18,0,18
HKNfDVaXMebLcFORJUCAGWdSIEBZQPgYT,GBBDdCHAEHDABDDGQFBA...gBFHTAEAHFFChAAAfDAGDDBBaAGAeBCFhABALGEEOEAHJEDCAGABhAAAIDFFYHDGKGCDNACFXDGAMIFCcABGhAEA.....hABA...,2,-8,-3,5
cBPbSRdLFEJZGMWHfaYNKQCeIUgXTVAOD,DGDDBEGG.SGGEdAEFEBGFZBBDGEAC.HEDDaFEH.KBDHCFGC.IDHFhAAAUDDD.TAFChABAAFBG..OHEEhAAAcABB..PCHDLHCAMABHfDBBhAEANCAE....hAFA...,2,-26,-16,10
KRXaMWADeUQbHOfSIcLPYgNZBCFTEdVJG,eDEEUAGDQGFEHACFSAACLEBH..gFBHhAEABFAFTACFVFFFKCDHRBFEMCBDhAFAAFEGDFDB.OEEBhAGAICAH...YEHHNDIGCAHD...hAIAEAAA.dGEC...hBBA...,1,4,-15,19
TULAfQPXRCZFBEdeOabIMHDYKNcgSWJVG,QEDEXCAAZGEAEHDA..eAEFODBFaACG.MCAEHCFBDAFAKBHFhAAA....NBDFSHGGhAAAJGAC.TDGFhABAAGIFfFGFCCHBBEAD.IBADcFFFWDDChACA....hADA...,2,-24,-16,8
VbSRBNCKZDaAEcOLdYITfJGHWFQMPgUeX,EEEDODCFdBBG...TEGBJEADHGCA.FADEQBFD.hAAAMAIDPCGBUGEBXGGBhABASGADBCEDhACANAEACDAGKBHHDABCAIFCLCCHfFBA.gBBFhAAA...hADA...,2,-17,-13,4
LaIgOGCPeYKNWZEVDQcRXMJBFfHbAUSdT,UBDFSFDHdABELFFD..aABDOEAFCFBGeAHD.KADFZDGBhAAADIBGQAGAhADA..RFGDMDFHBGCHFEDFhAEAfAFEAHIF.IAAH.gCDFhAEA..hAGA...,1,-25,-39,14
SIWdTJKAECMFGDOefBZcQPYHRUaXLNgVb,CHHCGGDDDBHB.OCCCBCFFZDBAQAEC.HDADRGDGUAAGXAADhAAALAFE..hADANCGCbAGF..ICDGhAEAWBHH...dFGHKEEFAGBE..EDFF..hBAA...eCHH.hACA...,2,-27,-7,20
gDNHLCGfbEPaKQYBVAScOXTRUZMIdFeJW,OBFHRFBBMGEA.dGAFFAHH..eEBC.JAACDCED.HACDLHFEhADACDGEGAAAEDGC.KGHHBCCChAEAAAEE...SFGGhAFAXDEH..........hAGA......hAHA...,2,-31,-30,1
FQfRCUDJdKBHMeATIVYaLEOPZgXSGNWcb,TBAFVAFD..LEHBEHDEZEFF..SECCGCAE..WHAGhAAAFADEQGABhAAA.RBGFCDAGJFEGKFHHBDDGhABAeCDAAADAaACC...PHDG..hAFA......hAHA...,1,-6,-27,21
MKVJPfWOBQCDTUHeaAgNdZEXSFbLYGRcI,dAFBZDAHSHACFACCLCECGCDBREFD.MIEAKEHB...JAFE.hAAA.PBBBOECEBGBDhABACFHDDABGUEAHHBBAAHIF.hAEA.EGDFXDGE.YGFA.hAIAcGCEfDEChBAA...,2,-28,-4,24
VHFEYPXUcLaSNKgbJRMOTdDBCZWGeQIAf,HCCFEBAH.XGDGLAFF.aEBASAGFKCHD.JAABMIFEhAAAdBHGCFECGGBDeGFGIFBHhAAAAGHAFEEH.PAEDhACAcABF..NEAC.gEAG..hADA......hAEA...,1,-3,-24,21
KBeYRFaCEDMGJHgNPUfWOLISbdTQVXZAc,KEEAeGAAFGHHCCAH..DFAGMAHD...GBBCJABAHCDD..NBIG.hAAAUFGF.ODFChAAASACB.TFAGhABAQAGEZAEBBGDGYHDAaHEE.EDCB.hAEA......hAIA...,2,-28,-22,6
NHeTVXKQFMRAOEGWJZcLSUBCdfgIDabPY,GDDAJDAGLEHFSHBEBHDH.CFBBdAFB....fGBDhAAADGGEPBAHHADFTDGAhAAAKFEAQAGDhABA.MFAE.AACEEBBCcBEC.IHHBhABAaGAH.bBBFeDEChAFAFGFHOAHD.,2,-7,-4,3
LVWYDOHaEQTcUegKXZIfGNbPRABSdJMFC,SAGCMDEGLDBD..VABADAECaFFHEBAB...QEGGhAAATCGAeFCDKABAXAGHhABAIFAEGEEEhAAANDDA.PDDBAIDEBHHGFGHFCEEC.YAEBhABA....OBCEhADA..,1,-9,-15,6
NOPgfaUMJAKVEXTYHSceLDRCGZbQIBWFd,VEDGEBGH....XEBGTGAHHBBESGHFeADADIGEGCEChAAAZDAGQCGAhAAABAFFdBCCNICB.OGEE.hABAfAGCaADFMHDEKCAD.cDGE.hABACGBH......hACA...,2,-7,-6,1
QLEbJAMGaORdHXVNCWYPDTSIKcefBZFgU,aDGAOBEBHCCC..VCFECEBA....PAAGTABG.SHBGhAAAKFCAeFGHBFAGhAEAZEAGUFFAEHAAAFECMIECGAEHhAFAdDABNGBDDICC..fAHG..hABA......hADA...,1,-13,-15,2
BXcYfDVWgTadIRMKCbAJePQZLFEONGUSH,JEBGQBEFZFFE.EGAGOABDGDBBHGACBEGE...XFFHhAAAfADADEIFgABAhABAaDDA.IGDGhACARBEGCAGHeAAFLAHHNIEFSEGC.hAEA......hAFA...,1,-13,-15,2
VNWRCgIDPHFdaMJBEOcLXebTAKQUSGZfY,UEFBSGDFGBACZADG..VFCFRCADCHAG.DFIHHFFF.FCGEMAFFhAAABHEG..OABAhAGAXFAATAGHAAEAKCDHQCCGhAIA.NIEH.IAAH.aFDAhACA......hADA...,1,-9,-27,18
QPbWXUMODHZIKLVCgSaBdYGJcFfAeNRTE,eCCGTCGDEFGG..QDAC..WDBDUFDHDCABIHHAhAAAKABGLGDCCHBGaACCdBGFhABAGAGC.FGAHAAEAPDCAhADAMECC.........hAAA......hABA...,2,-27,-16,11
WgATeVZISJfXHbaNGLUKFOEPMRCQcBDYd,TAEEVFFA..ZDEGJBAAHACE...aFABLHBAKHCG.EDDDhAAAMCEGQEAChABADEAEdBAGAHIBIHGB.hAAAfDGANBIAFGBB.OGDACFDDBCCDWAHBhACA.eCEA...hABASDAE.,1,-6,-10,4
VNETPbZRFAcSQOKUDCJdWGLBYfeMaXHIg,QDEBUFBEDEIH.JDBDdDEG.GAFABAADeECH..aCCHIBDAhABA.VAFEhACATGFA.ZABGAGIFODHBhADACDAG..WAHH..fGFDhAEA.MIAE.HFDFhAFA..,1,-5,-43,38
LMNYeCZHGKBFQcIgdOSAWXfTVDbJEURaP,XGABVGBG.DCBCEEAC..UCEHREFALAHF..MHFGhAAAeCBAZCAAKDEGFAFBIACHhAAAOCHHAAEH..fAEGhABAbFEC.aGHFNICDCAHFBBBD.cEDHhAFASABC..hBAA...,2,-29,-10,19
PNdZTOBMHFcSJIXbKaDEfAgQCUYWRLVGe,CDHFUFCERCBD.GCBF.eFHDdAABOFBBBBGHFFEE..JEDB..hADAIAAEKAFEDFGD.AGBE.hACA.QACDhAEALHCGVBEB..NAIG.MEAFcAFB.SFAFhAFAaHGEEADF.YHDGhCAA,2,-34,-13,21
PXQONbGKdgHaVeZfWDRTUIFCMEcBYASJL,JGAGXCAC..OACDGGCDKEFCdBGCHAEDaEDA.ZECCDGIDUBAEhAAAFAAC..CBEA..MAIHhACABEACADDG.SHGGhABALFGBQEAA..NCIAbAGFeHAGhADAfGDA.hAEA...,2,-22,-10,12
OIeLQSGKXMbDHPcVgYTEBdCWJRfAUFNaZ,FEHDaEAGZDEGOABF.LGBGQBCAGAGCKABD..MAIBDDEEHDBChAAA..cFFHhAAAgADF.TGFDhABAEFACBGCECBFC.WHFG.fHADhACAAHIBNIAHSDAFPEHF.hADA..YADC,2,-15,-13,2
ZIRBFLAcXGbKWEPeOUVdHSYgCTfDaNMJQ,XABCGCBCKAHB.EHFGeFEC.UAFDdDFBSEGACEAB.hAAADCAFMFDDZBDGRGAEFGABAAFE.hAAAbCDG..OEEBhABAHGEG...gABCaACANCCE....hAEA......hAHA...,1,-10,-14,4
LcGaAWPTMfNZbOdRKJgYVFeHISUXDQBCE,TACFMFBHZEBF.dAFFJEDG....VEDEFCADHBFA.UGFBhAAADAIDBCAFCHDGLFBBhABAaGHFAEAH...fCCGhACAODEAKBBCeDGHSHFCEFAB...hAEA....WABEhAAA.NCDD..,1,-1,-41,40
UQcWSCKLADMaVREOTBFJZXNePIGfdgHbY,MADDREGHEFEC.BHEEZCBE...eCFDGABBdGGFHAGFUGBBQCFChAAA.SBAGhABAKBBDAAEBaAAAVFABFAFANIED.hACAfEDA......bEAChAEA......hAIA...,2,-23,-2,21
YRfQScgHFNTGedKWOJXLAPIUMEbBaCVZD,UCBHECDHBGGACADH.DDAGRDFD....QFCFSCGFHBFGFFBHGAADhAAAeFBDKHGAOFEGhABAXABBAAFA.IAFBhAAAaEAA..ZAFEfHEHNIDH.dEHEhAHAWEHB....hADA...,1,-4,-29,25
OJMdHaXDYITbeCZcURPNBEFKQALSfgWVG,LGBASGFH..fCEFVBCFOEEGJFGD..HEACaAFGDGDDhAAAICAC.eCDDhAAAZBAHUBGBRABABHEAKEADhABAADGFgAGGMFHB..dFCB...hABA......hACA...,2,-13,-13,0
TPLcHVGSKRbdZaDEYQJMOXUgFNefICABW,TGFCLBBH.HFFCSCDDKBFGRDECdFAEDCIF..EECHQDAFhAAAOADB.XEFGhABAFCABeHDEIGAHhACAABIHBHBH.cBDF.VAFC.....hAAA......hABA...,1,-8,-16,8
eSZNXfdKHQRTWAFYDabVLEBUJIPCcMGgO,DBGDVBEFBEFD.UAADJDGB....CHBD.MADEGEBD.eBBFhAAASEBDZACD..hABAXAGBKHGCHECH.hABATBDDAHID.FAHHaGHBEGECcGBF.NCAC.hACAfEGB.hAFA...,2,-30,-21,9
OLCAdXQGPHbSKfWRUaVZJNYEBeFDgcTIM,dCDEQFAHHEBESDACKBHBRBBC.aDHDVFFA..ZGAEJADAEGGEhAAABABCDABC..TBGChAEAMEDH.LBCEhAFAAIAEXCFD..PHECfCEC.NAAGFHDEhAGAcFEB...hAHACAGC...,1,3,-24,27
CNZEVePYIMgBTFAQcLDfGOWHKaSUXdRJb,LBAFDFIBOBHBKEDD.UBCBdCCCREEH..CHEEZBGHeACA....hAAA.IFCDMAFHTGGHhAAAADAGQBEHhABA..cGCCfGAD.WHAGSFGChABAXGGD..hACA...,1,-32,-33,1
cMXHFeBOaQSCIJUPLbEKTYAWgfRDVdNGZ,...fAADDEEFdHDDZDAEMECBHACEFBFFeCFGBEEDODFH.hACAQGGGCAHGIHGChADAUAAELEABEAGGKEHHhAEATDGDACHERFAG.VBCH.cFDC.SGGEhAEA..hAFA...,1,1,-23,24
DAZHKGFNMJUWRVOXaYdcfIeECSgTBPLbQ,.KGGGGGDBFBGD.MFBDUFDFRABE...OBBGXEGH.aHCC.hAAA.dCDH..IAFHhAAAeFBFSDAGhABABDACLCFFDEEGAIFE.NCEAJCCF..YCHBhACAfCGHCAFB...hADA...,1,-12,-39,27
gHVbRZIQSOdcLEeYaFGAWUNJfTPCKBMDX,UBEFJDBH...TABGKDDCMDAF..DIEEHABHRDEEZFFGQDFEhAAAdBHCLEAHEHGCeHAChABAFDCD.AAHC...NADB.hAAACHEDBBGE.XFFG....hADA......hAEA...,2,-25,-22,3
XLYNgdcbFGQUPCVWZBSETJHaMfeIAOKRD,OGCEKEABREEFLAGB..gEBAdBBBFFCG.QBCFhAAACEHCZBDD.SHGAhABAEGGF.TCEAHCACMFIBhAAAIAFDACIBDIAEYAHF.bEEE.hABAPCAH.BGGDhACA...,2,-21,-16,5
cGBEDFCeQRgfZMLHJWAaIYbUTOKSNXVPd,aECF..IHADUEFEKBABSECD..NDCF.VGECdHDBBADEhAAADBDGeDEE.gBBDhAAAZAFAMEIH.LDAFhABA.WEEGAGAB.bBFA....hACAXGAD.cABAhAGA.,2,-47,-6,41
GcLECTVOFgKWDSaJXIBAedUPHRMbZYNQf,dACEHFFDMFACZBEGQCBBGEEFLCEECGAG.OHECKFDEDAIHaHGAhAAAJAAC..BGDAAEAHeADGhAFAUGAG..PDHDhAGAYBAB.fDEFEGDDFDEE.SAHBhABAIHHD...hAHA...,1,-7,-15,8
MYXAdeRfIEBWGPDScOCQaUTbVNZKgLHFJ,eBFERBGFEFGC.BGDBGCBEDEIB...OEDCCHHFUBAC..TGCGhAAA.VADCKEEGHEABhAAAMABBAAIDICFG.hACA.SGAB.aDDANAEGLCCHhABA.YHAGhACAfGED.,2,-27,-15,12
NTEOeMFgcfKbPWGSDJQaHAVBdLXUZICRY,VBDBdACHUFAE.ZDCCCDHD..RDAG...TAGHEGFH..OABFhAAAFFDB....gFGGhAAAfBGHKHDGPGBAhABA..SBAFDAFGaFFAAGIDBHHDhADAXCGANIAB.eHFG.hAEA..MCCG,2,-26,-20,6
SQMeJTVaKYBELHNOZcRCGXfbPWDFIgAUd,SEBFQGEFMBFBeAAC...TBAHaAFEBGCFLAGHhAAAHBCHOEFDRDBDCHHD.fHDBhAAAWABE.DDFEhAEAFDDFAAFAdFHEKFGCEGBDNAIG.......hBCA......hBEA...,2,-18,-9,9
gTVKBbLIXWMHNaPQFDZSdeOGCURfEYJAc,TCBDBHGALBFE..XAFGMADCaCDBFGDFZCADdGFBODFAhAAACHAFRCFH..EAACAGFG..hAAAVGCAKECGIEAFhADA.NCIC.DFECSADHeABGfHABhAHA.....hAGA...,2,-20,-18,2
NXeHUQfTAEZKWdJMbFPOYGRgSIaCcBLVD,KBCHJDCA.FDAC..OAEEGEFC.RGBA.SBBF.CGDH.BAFHhAAALCFGNAIAHCDBQFGHhAAAAHHF.ZFABhABAWFADMEAH....PBGF.IBAGhABAaADGDGFB...hACA...,1,-25,-30,5
ebPGgSaWLKQCFcJOfHAVIBTEDZYXUMRdN,BDGGDEGCZFEBUFBGRADB.dFFF..eBFGGAEE..SBAAhAAAaDAGKGHB.CGHFFDCFOAAEhAAAAIBA...TAGBhABAXGACMIDC.NDEE.PDAD...WEEFhABA.....hADA...,1,-27,-30,3
fdSKPTLWgIXQAcNYEFZHMODGVBJCaeURb,...NEDD.EGEEHCABOAEFDGBFGABDBCHDaHGEeCFE..UBAChAAAfFFFSECHhABAKHGGLFDD.hACAIAGHAEHBYHBAMDDACAHFdEEHWAAFgEAChADA...hACA...,2,-20,-15,5
NQTcVBLeJUaPZGAOdXIRFWSKfbEDCMgYH,OCHHXFACFCBGKDCD..EEABDACE..MEGHHEGD.QGDAhAAATDDBBGDDLCBChABAUGAHZAAGACIBIHBDhAFASBEGfBFGCFHA..NIDH.cDDDhAGA.....hAAA...,2,-27,-10,17
AgTBOSXMGNZHRQWVFLEecKPIaDbYCfJdU,BCFFOCDHMIACGBFEHEDDQFCBFDGGLBBEEEHD..KAAGIAHAhAAADDBFCCEF.JFGBAGHBTGABhAAA.NACH.RFAEeDAGhABA.aAEAbFED..fCCBhACA......hADA...,2,-15,-8,7
IBEcVSJfQdFaTORDeNGbCWPZUYXHgMLAK,BGGEEEGB.SDGCQDDCFDBEOAAARAFA.DCCAGEDBCHEBZAEHUEBGhAGAHBAAMFAD.hAHAAIHEKADHIHBF.hAAAJAHBaHCEeFFB.NDIA.......hBAA......hBBA...,2,-19,-12,7
EDJBaLbPRYGKMQZHWgAFdOIVeUXfTSNcC,FHCEOEFEeECGUGDF..XFGH..fGHChAAASBCFCCGHDAGFBDGALBAEhABAbAEARFAE.KDEGMABBhAAAZFAD....WAEFACFC.dDAF...IAHFhACANAIGEDDEaCAH..hACA...,1,-20,-22,2
DbEXLQHGAFWaPKSUZJICRTgfNeVYcBOdM,FABG..aAGHSDGEUFBBZDDC.CBGARGBG..TADB..gFGAhAAAeHEE.VDDBhAEABBBG.MCABEBEBLFADhAFAHEGBAAIHKABCIDBG...hAAA......hAFA...,1,-16,-25,9
gbDRWFUXTBEQZSOJGHafPceCdMKYVLAIN,..ICBFNEBA.DHFGRDEDFFHH..UGABBCCBEEFHQAEHhAAA.OEDHHBFEPEAGhAAACBBF.KABGLAGHhABAAIGEbDDB.XCACSEHBJHEC.aAFGhABA.fHDBhADA...,2,-26,-22,4
KPNICTEWQOefdagUJRVGAZMcLYSDFXBbH,ZAGFMECDLEBGDGDHBAHFKAEF.....PAAHNDFE.CHFH.EBEEhAAA..OEGFeEADaACGhABA.UEGERGCGADEESFADhABAFDCA.XCBAbBBCIHHFhAFA......hAGA...,1,-26,-28,2
TDIOCGYLgUWeaEMFNVQcXPbJfBSHAKRdZ,dECADBDDOCDDCGACLAAC..UCFDeAEFMIBAFGDE...QBABhAAAXGGBJCFFBGBFhABA.SFGGhACAACHF.KEBATBBE.IEAGYAEEaHBChAEAEGCANAIG.PHFG.hAGA...,2,-29,-21,8
RSJELPAHXfUOQZdeWcVKTNbYMIBaFGgDC,XDGGUEDBZCADdAGE..eEDH.VFAHTADG..bBBCMBAFhAAABGHBFFHF.DDDARFEFSAFEhAAALHDEAFCH.hABAOBED..WBHHKDBAIADAhABA......hACAaGBHCHHD..,1,-14,-26,12
KcLURdEFYafDOCNJVIBMWHTZSPAXgQGbe,XEEGGCCCKEFHUCFGdBFFFACB..aEBHDHEC..CECA..JAECIDHChAAA.MEABhABAHBBD.SDAFhAAAAGIH.gFGFbFGDeEBD.cACAECFFOHAChAEABHDF....hAFAWAHB.,2,-35,-12,23
ANSOLFafDEHKIBCbXcZeUTRGMYWQVPdgJ,SAFAOBCBLEFFFGDE.DICGECEHKBFDBHGF..CCHH.bBBGZADBhAAA.eGBAUDAFRDAD.MAIBhAAAQAGBdEFFADDBaGAFhABA..IBAB.XGGH.hACA......hADA...,2,-24,-14,10
WMeKUAEGLBDfVaSbICgNRYZHXJFTQOPdc,ECAAGBCHLDDCDEAH..aHACSABE.CFEERGCCZEEAHDGBhAAAJAAFTGEBQAEChAGAdCHGMADCKHAAAIHGBEBAhAHAVFBC....IHHG....hABA...gDBChACAXGGG,1,-17,-21,4
QVSZdUTMIPFecRGHWagbLOEfXNYBKCAJD,DBFCSEGBZBBBdDEG.UBFD..MADEFEDHeGDA.GAAHhAAAaGCCLFGDEGAG.XCFDhAAANADDBHHEAIEAJBAB.hABA............hAIA......hBGA...,2,-38,-25,13
fNJFdbHGVKTLEYWBAQUSIDOCZMgaRXePc,UAACSBBGODEHMAAG..aBFEeCFE....PGAGhADAcEAC..fHDDhAEAFGFDHDFAKHBAEDFGBHHDhAFAQFDCDGGACECFZADGXBDH.dAGDhAEA......hAFA...,2,-22,-13,9
cWBNSZHXQRFdGgfbeCKYOUTVPLJDAIEaM,EDGEaDFA...MFHBBGEHZDCAQEDFRBCE.FFAEdEAEGAABhAAAfFDECAFBKHACUGGGhABATAAB.LHCAhAAAADIFIDADNACBHAFG....XCDFhADA......hAEA...,1,0,-24,24
gXMYfOQbWKITEBLFdZUecNGPDHSARCVJa,REFECBBB...VADCaDFG..MCIBOCAD..QAFDKAAF.hABATFGCLHECZEBCeHAAhAAANDDFDDCBHGACAAHGJBDBXFAGhABA..fBGFWFFDICAEhACA..BFEGhACA...,2,-27,-7,20
ZPeBURQacfWDdGSTEAgJHNIFOXLYKMCVb,JFDHHBAA.FHFELAABKECH.MEFBCBFDZEEGBCEBUGAC..aAHF.hAAA...fABDhADADEAESACEACHAIAHAhAEAXGGF.bCGD.RFAF.WBED..hAFATCCCEHDA.NAGC..hAGA...,1,-19,-29,10
ENGWRCUTAbFMPOdIDQeZKcSBYgXJLHVfa,MGDCdAFCDAIDZBECKEGABBCD....XGBGHDBEaFBH.EHGGGBBAhAAARDFG.CHGGAEAFPAEAhAAA..QCGDhABASBAF..JDEF.fACBhAEANICF......hAHA...,1,-15,-37,22
FSOMdeGTPRfWEQagIYBZHNCXJVDcLAUbK,UBFEFEGBODCHMAFGGEEA..PADCRAAD..EFCCaHGC.hAAA.IHGBZDDDCBGA.hAAAJEABDBIDAECH.KCAEeADFhACATGAC..WEHB..YFEBhABABCHB......hACA...,1,-14,-35,21
AHBdKcaTOXDVEMWYGNZSPbFgIQLfCJRUe,dECFKBEA.aCHHOEDA.DGDGMAAD.GFBFSHEEFCBEQGFAhABALAADCHHCJAFBRFAH.hACAAAEC.BHDG.TBBHhADAEHAG...NCIE....ZAGD...hACA......hADA...,2,-26,-22,4
UVFQNXYeGTSaWMbBIOEHDRAdfcPLJCKgZ,dEDD..PFAELDGHCBAH.ZBABUFFGVFADFDDG..QGEChAAA..NCCDeAEChAAASAFAMABCBHCFhAIAOCEGDGEHfADFKBHB.gCCEhABA....hACA...,1,-20,-32,12
LCZOIgcGDfRQNVeEKJMYUHPASaWdTFXBb,SFABdDBGFCCABBGDCAGA.ZEFE..OGEC..IAHEhAAAGACCfDGHhAAARFCD.NFEF.EADEKBAEMCAHhABAHBEFAGHD.aGCH..TGAB.XCEHhACAgCAGDIGC...hAFA...,1,-10,-31,21
fDCgURYBGFZLJbQPaVIKSOENcXTHWeAdM,MEFBCBBCRADE.GDCELDDAQADF.aBBBIHBE.hAAAOGCGNCAA.XDAGhAAATBFEeEGH.hABAAAIFDFIDgGGDBHAB.JAHF...PHDChACA.SCCEhADA.,1,-11,-31,20
XYVJadWADQFegbOBIcTRMUPHNGCKfESZL,DIBAFGAHeFHHODAEBDGE....TACBRDDEUDAFHFFAGFBFhAAACAFFKCFFEBCCZGBC..XBFGhABAVAGF..dBAAhAAAAFHD.......gECAhABAcABGMIDC..fEGBhACA,1,-13,-29,16
XVWAbBNHfTDJeRUdLGCKIMYFQPgOZcSEa,BHEDHEADDGDGRADBUEECdACCCHDG..KBAG..MAHHFDAD...QAEFhAAAODHB.SDEGhABAEHBG.XGFEhAFAAAAH..fBGCeEHB.IHHFhABA....hACA.PDCHcDBF,2,-43,-20,23
ABdYTaLDReVPEIbOXUSKMgcWHZNQJGCfF,BCEEdEAGaHDEDGAH.RDEC.eEHF..EBACOBCHUGCD.KBFE.MFCHhAAA....WCCHhAAANACF..QEEEhABAGAEDCHFDADACTBDF.LAHBIGGE.hBAAbEAF..SFDDhBBA.,2,-35,-16,19
WJbHLYcVQNdRZIKSAfgCOUGBTDPaeMFEX,CDGAOFEDGBCBDBEB..aBGAeGAA.FBAGEFAE...JFFCbCFBHAAEhAAA.LEEDhACA..YDBAhAAA.QGGC.NCICdADFIHCBhADAAIAEfAGHBHHHMAEGhAIA...,2,-24,-17,7
VPIfCZAdHSNDLMQTaFYeJbEBcGWgUXOKR,dDFFHFCESDBFLHCGTAGEFGBB.eEHFEAGCBACCGADGUEEFhAAAXBAGKAEFRCCF.IEFFhAAA.CGABAIGADABFhAFAaDBAJHCE..WCFAOFGD....hAGA......hBAA...,2,-24,7,31
BbQGKLVZWPUNdgISXceYaMHAOfTEDRCJF,OFADTFEB.RFEF.CECD.BADCGCGGLDDHZAFCUBBBdCCG..SBABhAAAeBEBMIDGAGIBDCFDhABAFGADKGCD..PAGFhACANCAA...IHGF...cAEGhAIAaAAAEGHF...hBCA.JDHB.,2,-29,-4,25
EabQDeUZdgXALHWMCJfSIPOFGRYBcKNVT,LAAGHCEGCGGF.JCGHSACB.OFBHREDDBCHE.KDCFTAAEhAAAaCAB.DFIHeGAChABAZFCDdEEEAAGG.MFAB.hACAfHEBIBEFFGGAcAEBEHBA...hAEA......hAFA...,2,-31,-8,23
ZdeCEDJTIfbcWYVALXHOMUSKQNBFgaRPG,LHDAHBAAMDGDKBFBBHBFFEGH.RFEBZECHdCAA..eAHDEAHH..DBFFTFAEhAAA..IEAChAAA..cEDFhABAWADH.AAFGOADB.SFHHhACA..NEICaFAE.CABB.hADAfCEE.,2,-21,-17,4
NQYFPKCgbWAUROJeMDVTfXdBGcLaEHIZS,OABDeCEFDBCA..TDDCdFGFBECC.LABDHBFFIBEAhAAAZAFCQGABFDABCGFHbFGDhABAADHGUGDE.JDAHfFAFhADA.cGAEEDFHSHGAhAAA..PAHDhAEA.WEHB.,1,-3,-14,11
bMgEWcGIHfeSTAQDJVLZaBFCUPKYXdRNO,DFGFLDCABGDBFEBCCADGUFAB..KFHHdGGB.RBDC.OAAB..hABAMAIHEDEC.GAAChAAAHCGFeBDASHFAhACAACIDQGAHJEFG.aBCH..XGDFhAEA....NAEFWFFDhACA..,2,-24,-21,3
CMSJOAPNBgYcKDFVaWHfZXGLTbQUREIed,BEGH..gCGHKBEHDEEEFBBEaCDA.HGCGZEADGGCFLEBChAAA.QFABhABAEAFEdCGB.CACFMIFGOAABAHADNBDDhAEA.VFFAXGGD......hABA......hACA...,2,-35,9,44
WKgRAdEQOBPceSbUHFGNDMaTVLCIfXJZY,EFBEBBAH.eEACSDCCUBGGGGEDDBAAMAFD..aCAELBGBhAAACFCE.IFGHhABAfHADJEEBZGAAKFECAAEAhAAAdCAC.OFHD..cGCH.FDDAhABANAIE...XEGFhACA..,2,-17,-15,2
JXFDYCOKMUQIPgZVaNfLWbETARBcdSHGe,BHDHSGGDeBAGFECECDGE..KBEHUBGD..QDBHhAAA.IFEDPHFG.hAAAVABEaFEELGAAhABA.EBEBAHCCdFHE.JFAFXDACOAEAMICEhABANACB.fDDDhAIA.,1,-21,-25,4
BOYJFEIUMeQbCXaWKDAHTVPcZNgfGLdSR,TGADVBFD..ZFGH....NGDHGDEDSEBBODCHFAAEEDEBhAAAMCCC..QGADhADACADFaAAFKHCAADDCHBCDhAEA..PBFAfHEBdHFBBCADYAFChBEA.....hACA...,2,-17,-4,13
cZMWfeNHQdKBSGOPTEbFAaYgJVRUDILCX,aDFBJCCE..UBFGDCGELDBG.CAFB.ZEEG.MHAAeEFHQGGHhAAAdHBDBACESFCFhAAAODAH.EHGGACBE.hABA...gEBHIEHDXBCChABAfABFNEAG.KGEH..hAEA...,1,-22,-34,12
cPKMWeOESNaFIJCbQRgDVfdHYBAXLUTGZ,UADHZBEHKCHFMCIH..OGAEEGBA..SEDAFEDCCGGA.QCABhAAADBAEdEADBBGFhAAAAHGAXCEALCAETAGGhABA...cFGA.eHEGNICDaFHFhABA......hACA...,1,-9,-41,32
RLSfCHcGObNJDQUKMYXeWAdagBTIPFEZV,dDAABCEA..TGDCFADAEBBDRABDLAGD.CEFA.HDGBGEBGhAAANICHDECAKDDG..MAGDhAAAXFGHAGEG.aAHDIHAFhABA.ZECGfAEGOCAHQGGBhACA...hABA...,2,-20,-18,2
dQXWafBRGMbFCUDTIYeEVKJLgNPHAScZO,ZCEGdAAFQGEFaAAD.BHAAGFCDMDBBCAEDUDBG.DIACTCEAhADA.eEFAKFHBJHFChAAANCDG.AGBD..OAFAhACAWADA....fBBG.FHCChAEAEDHHgAGHhAFASADD..,2,-25,-25,0
FXgGcUfaZLYATMHEIKQWBCVdRePbNSDJO,MCACEGDBKFBHBHFG.dFABeAHB....NCHE.JDEA.FGFFXCDHhAAAGAAGUADG.hABAaEGE..ZFDBAEEH.HAEDhACA.IAHB.CGGD....RGAESABAhAEADGAD.hAAA.cBFF.,1,-15,-27,12
BRfVIbJEdGKWOcSHXYPZgMeaUTNLDFQCA,BCCCRDCG...IGFFbFGB..dAADKBAFOBEGHEAEXCGGhAAAZEAHeADDUFDF.hABALAHBQDDAhACAACGE.JGBG.EBDE.cAGHSGAD.hADA.YEHF.hABAMIFCaHEC,2,-28,-18,10
ICdDfRZANJEebaMWVOKcQHGTXLgBYSUPF,JDCBEBCD..eGBCMDAHOBAF..KGBFQDFBHABDGDGChAAAXAFFBBFESEDHhABAFHFGCFFDDAEF.fAHChADAABIHNIAF.WFEH.....cBEHhAEALAAC.YDHBhAIA,2,-38,-11,27
MfWPFDIAYHUeERZacOdSKBQTVJGbNgLCX,HABFUBECECCCRAECZDDC.OBHFKABEBFFG..QGCE.hAAAJEAAbGCGLFHFhAAACBHFMAEG...fHEBhABA.FFAHAEEBaGHD.SEGEhAIA......hBAA...,1,-2,-45,43
HbWQBCEGcPUVNZKXfeYIFDaSgOTMRdJAL,LABFHEABQEDFCHFAGDEEUACAZBGDKGADeAFD.FGFGDADBSHFAhAAA.OABBhAGATEAHMDIBJEHDACIBBAHAhAHAEAEH...cGBDNEDE.....hAAA......hAEA...,2,-28,0,28
XUcIbWeZESGLgYfKTCJBHaNPRMFdAODQV,OEAEQGCFUBBD..IGHAeEFCZBEAEBGHLFHD.hAAA.fBEAhABACHBFBAHAHFDHaCAHREBEMABCAEIDDBDFhACA.cFFBSGAFYFAF.TDEGhADANAAA.dBBA...hAFA...,2,-20,6,26
abMRWZFgGCUJXBdQYcIHfEKSDPLOeANTV,VCBBaBDG..MGDAZFGBFFABGEAC.CCAA.UGDABDECdDFF..QCFGhAAA.IHHDhABAEHACDCAHLAAAhABAAEHHNCIC.bEDEWAFE...JHCC..hACA.YECA.hACA...,2,-27,-14,13
TCAPQNOWFBGegUKcZRVJdXSLfYDMbaIHE,QFGDOHFGBBCAeDCAKFGA.RBEE..JCACdHBB.LEACDADHMHBEhAAAaABG...EFEFAFFH.hABA.NIAH.FAHB.GBFAhAAA...cBDEZEAASAGEhACA..fFAAhAEA..,2,-26,-21,5
XEIaBVNYCZcGMbWfdPTeRJAFKQgSOULDH,FDGFQDEHOEBELGCEHAFFEDCFBFAH..VBAFCAACZBBGMDIBhAAA..fEHAhACAPAEE.eHBCAHGHSCEBhABADIDCaBHDcGGDWEAD.dADB...hACA......hADA...,2,-31,3,34
KUHOTQbPfLCgcEdGAZFBJMeSXWNaDRVYI,BBBEMBDH.eDBA..XEFAaADC.REAB.IHDHHGDEQBAGhAAA.fEDFhABAgEEAEAEAAIGGFCHFhAAAJCEGSAHBDGBAKFHHOBAB.PAFGhABACHHG.....hACA...,2,-26,-13,13
DFGIcOPBYUJNeAQdTRLEWafgCVXKbZHSM,TDCGLDAB.aCEBCGDE..KACBZEGH.SBBBDCHBFBAF.GGAHhAAAOFEGBBAD.JFDGhABAAGHFQGBHhAAARAFA.fBEA.gAGChABA.XEAGMIDA.hACA...,2,-26,-23,3
BfgHEYCTMZeKUaVdFDSJQbOIPXNAWGLcR,LFECBHBFHAEFEEBETCAHZGCE..KBGEaEDFFACH..DFHBSGGDhAAAJAAC.ODEEhABAXEBDAAGE.cGFHhADAfAEE.CFAEMDAAeAGB....hADA......hAFA...,2,-28,-22,6
UDEeYTPXGKVLFASNdbfRWZBQOaHgIcCJM,dBBHRBFFZFEGOAEHHBCE....IEBBJGEGDBIH.EHBE..eFABhAAATAABGDDHLAFEhAAAABFC.bGFEBHHCaEDBCDHDhACAMBAF...UGCA.....hADA......hAEA...,2,-31,-2,29
cPGHgJYIZOAbWEKTMDUBXRFaNCeLVfSQd,EHFEMFFBUCDARECD..FCBCCCBA.LCGD..SHAAhAAAdAABGADHJACCZEAHAEHEKAFEBGGFhADA.aEHFeDGD.QBGAhABAPCEB.HFDDIHHA.WAHHhAEADFIB.....hAIA...,2,-25,-7,18
SCULYZbEfKQaJXcHgeWMTDIdAVORGNFBP,RFBHFDBFBDEECHDA.LCAFZFCG..EBAEKAGC.QEFAJAGD.hAAAHBBFeDEGMIFGTADHhABADBEEAHHE..ODAHhACA..NABD.SGFAYHDE.aDHF.hAAA.gBGAhBAAWHFA...,1,-24,-26,2
FfDcebVJKGARgECHdTaSBZLQPMNXYOWIU,EFDGCBGCdHED..aBFHZFDGLFHB.MCAHXCCE.OBAEhAAAIDHC.UCCHhAAAfEACDBBBeGAG.hABAJABAAICCRCFCHFFFBADENIBH.FFHH...cFAEhACAKAHD.....hAEA...,1,-6,-27,21
UETacSNgAQfDWLFIMCbPXeORYKBGVZdHJ,QFFDDGIDFDFC.CCAB...XBCFODBCKAGEBBGGGAEGhAAAdGAHHCAHUGBDEECAaCGESAFFhAAAAIFCLABAIHDDhABAMEIH.bFFH.......hACA......hADA...,1,-18,-21,3
KBIAGEaVSfZXdbUeHPNJTcDLgCRFOQMYW,aEDCSDHDZBEA.dGCDeAAFHDAD.JDDCTFABLACA.CFFH.hAAAFBCB.MICAKECBAIAGEEHHhAAA...fGEBhACAUAGCNIDBDBABOAFG.QDAHhADABCCFIGHD...hAEA...,1,-13,-16,3
ALZHYNQBMFIeWgORcKJPSdVGTbEfXCaDU,LFAEHCCCQDFDFEGFeCECOGCC.KAFASBAGhAAAdAADVEAB.TGBD.fFEDhABAaFGHDFIHADACNIDBMBBEhACA.IHHB.WAHBgACHhABA..JDAA.PHDEhADA.,2,-21,-4,17
DRbBCAYdZOFVUEJHGaIQfMWXNgPSLecKT,dDAAOFBEUCGCHFFCGGDHQCAC.MCECNBAB..SCEDhAAALDECeAHBhAAAKFFCDCCFRABCCAFF.AHIF.FHAG.hABAJAEAIEFF.fDCCXDCH.hABA......hACA...,2,-29,1,30
ZcBMOSbUHDKJNXgVdeEWCYQTRGaPLFfIA,BFFFOBBGUECCKFCD...JHAC..NBIG.....XBADhAAAdDFFeFHBCBGH..QACBhABATGFGGDDGhAAAaFHH.PDAFFAFBAIGGMEFASAGC.DABEhAEAEHDG..WHBG.hADA...,2,-37,-16,21
OaHdVeXEMbCSRUTKJLBfFGYAPQNDWIZcg,QFAEDGDG.ZEEHOBBGHAFHdACDeAEEEBBBCAAF.UEGCKHCALDEEhACABHHBGECAAFEE.hADANAAA...IDCFhAHAaHAC.VGFA.MBIF...SFBChAIA...hABA...,1,-7,-26,19
GJgNXcFSPEKYRDULCTbQABHeVfaWIdOZM,BGGAVGBA.aFAH..dACGZADEGCDD.JEBGNCCE...FAECEABCKGEChAAADCID..LBAHhABACFGC.QAGGhAIAAHDGfFDBIHHGMAAB.XEFA.hABA.PDEA..hAEA...,2,-48,-5,43
GOKegMBHQdPFSZXLEIJNfRWAaVCDYTcbU,aCCBDGFG....TBFFUFBGGEEE.eAFABACGdEHCFEAFXDDFhAAAIHHCJBAFRFBHAIEAhAAA..CHHE...bDFEhABA.KBBDMBBG..HEDDSBGAhABAECDFfAHEWFAD..hADA...,1,-13,-30,17
VPfaEGXNbHIYLgWcRJSZQMKDOUFeBTdCA,VEEGaFAAGEEE..XBCEHACEIHBALBBD..gBGBhAAARAFGSFADhAAAMDDHDFIFOBAHFFCFBHEFhABAdEHECHHCAIAAfHGBEBBDYCED...hACA......hADA...,2,-23,8,31
cYgLOWPTCMJGRVfbKEBSdUAFaHXQNDeZI,HBCEXCGDDDHHZAFB....IAEHgGFBLGAAhAAAOEAGPCBG.CHGEMIBGhABARFBBbAADBACFdDAGUDEChACAAIDCaFEHeFHB..YBHH..hAAA...WFAD.hADA...,1,-7,-15,8
KSaXWfIJTeNbEVgGFCOdPcBQZDYMLUHRA,SGFAXGEG....IAFHTFBDeEEAEEFGGABChAAACCEBdAHCBBFBDGGEMCFAHAAAhAAAAAIFKDDCaDAHJCCH.NIDB.hACAbEAGFGAHOHAG...cDGF.hADA......hAEA...,2,-10,-7,3
XIdaUOPTcZFNHVBKYeGQbJgCDAMLESWRf,MDFDEGEHRFBA...XFBDdAGCUBDE..TAGBFABG..HEFGhAAAKGFHGCAFJEAE.DIDEhAAAABHASGGDhAEAIAEFODGD.cACH.....hAFANCIABHHD...hAIA...,1,-14,-28,14
ebGYBTCWIZSQJRVagDNLPfFOAKEMdXHcU,MFBCdBEGHAFBUCDCeCADGGDFBGHB.CAHAZEEFJAEE...RCBB.aACGDABFhAAALBHH.FAAFhAIAADHBKFAD..EFFE.hACA.XEGG.....YHAGhADAICGE...hAEA..SDBC,1,-21,-26,5
bNCWJTMVdZAYIDfGFBePgKaRELcHUQXSO,DACFFABDBBDBeDHHKBEEREEC..LAGBHFAEQEDA.SHBAhAAAOFBDNEAB.CCFHJBAFhABA..MFADZFFHAAFGhADAIHGE..fAHAPFDHaCDEhAAAEDCA.....hABA...,1,-7,-40,33
aUdMZAfPGLceRFYISHQBTODNgEWCKbVXJ,GDDDeDCFFBBGSAAEBGDE.DGGBEAEEKGDB....bEFBJDABhADA.dCGFAHCBLHFAhAAARADF.HBFG.ODADhABAWFGBCHAFaAGAMFIFfCDD.YDHBhACAIFCF..hAFA...,2,-34,-4,30
LMIgHcZAfFGJSeRXYdaDPNOEVQUTCBKbW,FEBBSCGDeDDGRFFB.dFEG.DAAEOBCG..QACDhAEACGCEBEHEKAHBbAFE..MACGhAAAgDDCZFDD.ADCGfGGEhAFAXBAHaGACEGAG.....hABA......hAGA...,2,-28,-16,12
VEMTHcBXdJIRUQgLfbYNZFPeSKAOWDaCG,DGGFaGAAGDAFECFB.HAFBBBDBdFEERCADUEDBQDGE.LAAEhAEA..YHAChAAAZBBAFGGHSHAGhAFA.ADFB.CEGAMACD.cCGF.hAHAIAGF..hABA.fFHA.,2,-40,8,48
WEBPLSbAXFVeTfDURZQOICNGcgKdMaJHY,VGACTEEB..DEAHUBEFZABB...QGGFOHEC.ICHGhAAACCEDGDGG.KBFGaEADhABAHDCFEACHBHFG.hAAAPDCFSGECAEHGFHAA.fADHhABANAEF......hAGA...,2,-25,-8,17
dAITWSUFBEfeYPHVDgNJRCcOaQLXGZKMb,TGGCSEHH.FAGHEACD..eDACPFAGDGGB...NIBF.CHACOCEHhAAALBHDXFBEhABAKEGDMAGH.ADDFIFEBhAAABACEfHDFYABF..gCFGhAEAJAEH.aFAG.hADA...,1,-20,-24,4
dRGHLFPCOSWgVKZeDfJINMcTYEbaAQUXB,UEAEBHFHdEGBGFEBLABACBAD..SDFEVFDC.eBDAhAAADCAG..JAFBMCIF.hAAATGCBEDCGACIFQFAEhACAXDDCFHAC.OAFAKDAA..IAHEhADA..YHFGhABA.,1,-23,-27,4
NagAdQBcLfMSDFEOVUKCWGIRYTbeXHZJP,QAFFBECELBFHMEEADGIF.FGAGOCDE.UEBAKABGCCHAGAAFhAAA.RGFGbEFEHEGDhAAA.ZADB.JFDD..hABAaHDCAGGDdDACSDAD.EGAB.ICHEhABA....hADA...,1,-6,-32,26
JOYSBGVIdaUWXFCKLebDNREPHZfAQgcTM,QDAATDEG.OHBABFCAGDAA.VAGBIAAChACAdCCCaHEAXFGB.hAAAKAHBeABADBGDRADDEDHFZFAGhADAAFGHMBAFSEEH.FHEECHHHNIABfDDGhAFA....hAGA...,2,-14,-3,11
XdWfCKBNDIJeTGFYbRLgAHOcUSaMEVZQP,OABDSDCD.EAGEVFEH.ZCGDQGBHdBDH.CGEGKBDChAAANEAC.DFGA..IEBAhAAAeEECTBFD.hABAFGGBRDDCAIHAHBAAUGBFaDDGMADAPDAH..hABA......hACA...,2,-17,-7,10
HSeLITbNQMFdVaRZGKPBgECYUDfWcOJXA,SADBLFBFTDFFQFGF.dAGHRABHKGGFBHDCEBDAUBBGhAAADDID....fAAChAAAWDFF.OGCGhADAAEEDHFADeFHBNIEBFCHFVAGFaCAB.....hABA......hACA...,2,-17,-6,11
MZHdcDeFVSJQaATfGUgBIXbONKCPLREYW,GEEDBEHH..XDAEOFDHCFBGLBFCRAFH.EABHMEAFZECBdGEAhAAAeABGFADG.SGAFhABAaCDBACIB.TGGEhAGAfBBE.IGHANCGGKCCC...hAHAPHEE.WAADhADA.DIAC.,2,-33,-6,27
HXRfFKIWLAgCVOBZeQJNEYbSdDGTMUPca,VDBEZFCBeAAF.QAGDJAGB.EFFGSADD.DFEGhAAATDBEUEGC.aBDARFAFFHDAhABAKCHDLFHBhAAA.gFAEBCAGbAEBMAIDcCCAfABAhBAAWGEGACBB.CHHB..hACA...,2,-18,-13,5
FZJEHMGaPONfgCQeXBKSbWRdVUIYLDTcA,JCGFEAAEGFDF.OFAB..fADECCCC.QFABhAAABDAFKBFBSEFEhACAbFDH.WDHBhADAVCCB.ICABDEBGAHBC.FFFDMIBGPAHDhABA...NBFCeHAAhACA..XDDF,1,-23,-25,2
OIfQRYdeUTNSFZLVAWcJKgabHEXDGBPMC,JHDGKAGG..aBDHHDDC.DAGDBDHF.MHCCCHCCOEAD..IEEChAAAQBADdFABUGGEhABATFGFFCAA.ZDAChACAAAAG....WFCG.....gBDChACAXGAH.PAHBhADA.,2,-39,-28,11
TJCeNRfWPcZIKHXBVbAFESaYUgGMdQLDO,EDAFSDBDUFDHGADHdFDBDGAH..JDEGCHHG..RACB.....hAAAPBCHIBADKAAEBHGAhADAAICAFCEE...gGABhAEAMHCGLAFAeEHB.fEGEhABA..WAHB.hACA...,1,-18,-36,18
JATRDVWfCEMaUgBLZGINFXcOQHYdPeKbS,DFBFVDCHCDBE...MEIFUDGB.LAAGGAEEFAAF..XGGAhABAOHCAHCGH.hACAPACHKEDCSGCAhAEAAHGBREABEAGGBFFDIAGG.NIBD..QBEChAFA.dFFD.hADA..eAHH,2,-14,-7,7
MfgaWcVANPCXKRbSEBHUQeDdYZTFGJIOL,CGBGKFFFRABG.EFBABDAF..UAAGDFGE.dHGFZFDFFAGC..GBEB.hADA.IGDEMEDG.hAAAaCEA....cGGBhABAAEBEXCDC.SADAeEAF.hADAYCHHOCCB.LEEChAEA,2,-40,-23,17
JXVfCGZYeMDRQPUaLbgHKIAFETSNcdOWB,EFBBTEBB..SGFEdCDCOBAGBHAB.JHECVFEC.CDABZAEFhAAAeCBE.DAIFQGCDhABAaFEGLAAAgAGChACAKAEDADGGFCAHNDIG.XDGE.fAGGhABA.MFDHhACA...,2,-27,-7,20
RAXJbdaBYEQeHPgfZTWSKNGCIcFLVUDMO,XFGBJFBC.dCDHBBAF.EHCEeEABHCDC..fFEGhAAAZFFHSADDKHBGNBCHCHEGFBGFhAAA.LAFEDECDOBADhABAAEHDaCCH..PAHH..WEAF.hACA......hADA...,2,-24,-21,3
TYMgBbDGOfQZRFaPELXHCdVeSJWNAIUcK,UCCFKAEGMCFEBHCHGEDG..QFFFRBAAFEAG.aBAHEHGEHAGHhAAA.CFCA.eHAASFHHhABAJDFAAEDH.ICFChACA..YAAEDFAAfGEEhADA..PFFGdGACNBBF.hAEA...,2,-22,-19,3
ebXHZaQLUWgESJBTMFdVCPOAGINRDfcKY,GDAGRDFFDDEH.KFDBeGACHADBZAACQAAA.LHFChAAAUAFBEHFCSAHBhADABEHHMAIDFCGD.CGCGAAGBIEBGhABAfEEB..bCAGaFGE..WGCAhACA......hADA...,1,2,-33,35
NWDUZVROCSYageFdcLIKAGMfHTXbQJBEP,GDDEMEEFHDAD..TDBFQGGEJBABBHHFNBBD..UGAHhAAAVFAHCCFF...aAFDeCAEhABAdAAFLHDGhADAADHEXGEDEDGBPAFADAIH.ODGHSFGGhAEA......hAFA...,2,-13,4,17
HDObWQafTeJXdBCRVMSgPNYcKGEIAUZLF,LGEEHCEHOGAAQBCCaGGE.eCABdHDDRABFMCFE.SDGBhAAAPBFG.NIDB.KECAhAAAGEBGACIH.FAFEDEGBhABA..fDFGTDAHBEHBCBBD...hABA.YFAF.hADAIEDH.,1,4,-11,15
CYbRFJaIVESHQGPdLZDBMAfKWNUOXceTg,KBABUEFDOFHFeAEB..CBHG.RCCF..FHBAJBBH....aCGH.EGFDhAAAQGBE.hABAdDDADCFHADAB.NDAE.TGDHhAAA..gBGBIHHCSGADhABA....hACA...,1,-32,-38,6
RZTJVHYbgIQXBNGfEdKCADWFMcSeaULPO,FEBEMFFDeDGBUDGDLGCG..RFCBZBCHVADBHBAB...hAAAgAGBXBGBBBBChABAGAECfEFEhACAKHGGDGGGSEADaDAB.....hADA.OHAC..hAFA...,2,-21,-8,13
ARSCNYKOXJBETDWGfcbLeUVgMZaQdPIHF,RDACCFACKFDGOCFF.BGHDEAAH...DIDAGBCH...bCGHLBHDhAAA.UBBHhABAMEAAaFCHdHBFHEDBSAHBhAAAXADFTGGB.fDFChACAeHFGgGAD.hADA...,1,-13,-32,19
bPUJXRNOFgdEeHIYQWZTALcaSBCMGfVKD,aFBABAGBGBDDKADBDCAEUEEC..RFAE.FEHHdDEAHGBA..QGGEhAAAZAAHAHHGSCADhACACABC..MCIBfAGHhADA..PDAGNIEBOFABEGEHeAFDhADA...IEGAhAIA.,1,-2,-41,39
bORXJLgYQZCfUeIFPKADSMGNWVTdcaEBH,MHDGGBEB..VCFBdFBHaDAB.BAAEOACDRFFCLBCF.hAAA.gEAHhABAZEDDCHAB.fHAFhACAIHHFKHEGDIECNDIG.cECDEAGE.HAFC.XFFAhAEAYACC..hAIA...,1,-4,-22,18
bfUDeFGACEJSRBQcHgZYaVKPNOITWdXLM,EEAGRDAGBHDAHFEHZBCAaADE..KCGB..PCCDOAAB..TGBDhAAAdFHCLEFH.hABAMAIFfAHEhACA.DEIDFFABGAFAAHBDSDDB..hABA...cGCBhACA...,1,-5,-36,31
PTeWOHLRYICEAcFGJbBSfZNKQMgVUXadD,FABCGFBDBAEDZDBGKCDFMBAB..UFDGaHEG..DFECeGFG.HBFHhAAARCFACBBA.AHBC...bAFChAAASDGH.hABAQDAD....gGGHhACA.dHAB..hADAWHAG.,2,-44,-10,34
WVCFKeIDadAfXgULPHRQGNYEOBTZcJSMb,XEGFLABFHFEEGAEAECGGBGGGZEAHSDDHMDCH.VACEhAAAFHAAIBBGhAAA.aEAFAGABfGDEhAFAUGDFQAGEOHFE...cCFHhAGAWBDDCCAGDAIH....hAHA...,2,-11,-7,4
RgaDITWXKdAGZFCUBPOLfeYVENcQSHMJb,FFGBCGCEBBFGLBEF.eDDDVEDE..EBHFQDAAHBAGMDBBhAAARACB.DIDA..IAGDhAAAXGCG.AAEC.GGEDhABAZAFBOFHDNIBDSCHB...hABA......hACA...,1,-10,-24,14
QdNAIFSeZXYVfMgUTDPBKbcaEWRCLHOGJ,FHEGZEEB..VDAEMFAD.UDGGDBGEBAAC..KABH.aFCFRADBCHHDHADFhAAA..OFBEhACAJBFAdDBFAAGC...SEEBhABAeCHD.XGGBfBBD..hADA......hAFA...,1,-21,-41,20
TQOgXabNEZWeDRIVYcBSUKLGFPJHMACfd,dHEHQGBGOEAD.aHGGEDEB..ZBAEDCDCRAEE....VDFFBAHGhAAAKABCGDGEFECA.JABChAEAMDIBACGGCAFE...fEADhAAAXFDG..NCCG.....eAHHhAEA.....hAIA...,2,-34,-5,29
ELIXQRFabGDAdOVfWNeSKPBgTMCZHUcYJ,OEFCVEBB.....fAECNEIG.SBADhAAABFEEgABAMDDCHFCBhABAUBEGYEADEAGELEGDhAAAIBCEXCAGFHGAbBGFACIBdHDFKHAGCEEF.hABA......hACA...,1,3,-20,23
YeOgBTACQJZKGcdEWFSXfbRHaIUDLMVNP,JFCAZFDHKADFGEAGdAGF..FAAG..XFFFRDGH.HCEEaGGC.DBCGhAAALFBHMIEENCAH.eCBGhAEABAHE..CBEAEDEChAFASAFB.IHCG.PFHDhABA.....hBCAYDAC.,1,-10,-23,13
DgUFGcAQEXLYTISMRfKBObVZeaWHdNCPJ,XFFATCBF..MDIBRCEAKEAABACB.OFBBZBACaADF.dGBECABDDGHBhAAAFAGE.GBEH.hAAAAFGFQDEGhAEAEHEG.IAHBSEGCfHDH.hABA.....eDBGhACA..,1,-16,-30,14
BTGcWJagHXRPEeSdMFIDbZOfCANKVQYUL,KHCGQAFDUBEBBBCDGCAF...JFFDaDFEHFAB.XCGAhAAARDABEAAF.dFDGMFABhAAAFBAGDIGGZGFA..CEHH.AEAF.hABA....NADHLFDETDED...hACA......hADA...,2,-28,-10,18
KcZGOCBfQYJTbgaPIWVDMUdHLNAFXRESe,XDDBRCEGEEEF.KBAAZBCB.CEAB.BBEA.QAGCTAAB.aFFGhAAA..PGFE.hABAVGBGUFAF.dHDBNAIE.hAAAAHHGFDBB.SADFcAFC.ODFChACA......hAFA...,2,-21,-18,3
FIeSdfgWEYTQZDUXPaGOBHVNRbAcMLKJC,MFEBJDDE.FFFDeFAB.dBCF....fBCDEFFEQDGAhAAAUCAEaDFABGCEHGAAhAAANADB.RAFAAHHG.LFAChABACBADSBFA..YDDADICA..hACA......hADA...,1,-16,-29,13
GfTFXPbJQYZdNLEIVHDCMUcaeKSOBgARW,RBDEGECAFEGF...XDBFJEDBZFAH.LAFG.EHEAIAADhACADCCCCACG..MBABhAAAaFED.KEEEBHHBACHFTFGDhABAQCBCdGAC...NADF.....hAIA......hBCA...,2,-41,-11,30
VEJOIfZegCSXAdNcGMbWLRKBUHYFQaDTP,dFGAGACCMFBALHBGRADD.BHFGHBGBQEGBTGAAEAAAICGBhAAAZDCC.CFDDAFFHNEIG.hAAA....WCABhABAKDAFUGCAFAFA.DAGCJCEBfBCESEBHhACA.cGGH..hAEA...,1,1,-23,24
RZSMdCQcDLEUeBFKHagTPXGVNWJYfOIbA,ZGFGdGCECFGBQEECLBCD.eAADBCABHBGH.aBFHTAED.hABAGEEANEBA.JDFCfCCGhACA.IADEhAFAAHBF..SAHDDGAHEECB.FEAHhAAA.KGHB....hABA...,1,1,-30,31
BFbYaKJZcCgLNPXUMdWTHGeRIEODAVfSQ,SBDDBBGGFHAA..aBCAKGHB.ZEBCCDDA.LAFE.XGBBhAAAUFDAdHGBHFEFGAAGhAAAIDHBDAFDADCG.fBABhABAQDGC.......hACAYDAFcCEANDACMAIDhACA..,1,-26,-30,4
ZLgbWYFaEVfABeOdKCSTcDQXHPRIUMNJG,BGDAeFCGOACHdEACCEDH...SAEFDADBHCBDRDGDMIEE.JBGDhAAAZFFFLEFG.hAAAbGBC..FBFHEDADABBBKBHHhABA..cAFGPHAEIGGG.hACA......hAEA...,2,-35,-4,31
EcWKadVUCgQBFLbHeJIZXGfNADRPSTYOM,DDDASDECOFFB.MFEC..EDAGKCAGaBGHdABD.UEAC.CHAF.hAAAgECHBCHCFAFAHGCChACAIBBE.ZFAHhAAAXFGANACF.AFCE.TEGD.WAHBhABA......hBAA...,2,-32,-21,11
IbcMPKYCGBDTXWfLedAZUNEJFOSaQRgVH,ZDDDUBGAJFFAOAAH..QAEFRDEHHEAD....IGHHhABAbFAB.MIACKBCHCHEHhAAADECC...TFCHhACAfGCEdAEGEBBESBAFaHEE.gAGHhABA.PDFChACABEHA,2,-40,-15,25
fVSEKJgMDANWObFCdaXHPYUQLeRTZcBIG,OFBHCABAdBECHBFGUCDCLDBB.RFFEZGAGBHDA.GAEF.hAAAfFDCSDDGhABAKCBBMIDGAACD.NADBFEGAhAIAXFFB.QCGH.eFHHhAAA.IBAF.hBAA...,2,-20,-15,5
QTCSLRacHIEWVKMPgNBDAebGYdFOfXUZJ,GAADFDBBOEDCUBGAZGCGQFFE.CECE.SCGBhAAALDDHaFBFIACE.hAAAEAEGKGAF.MFIBNDIGBHGBhABAAIECbAEBdDDF.fAHE.XGAFhAGA....hAIA...,1,-10,-30,20
SaPIYDTZAGCLXbWVJBHdEfUcRQMFNgKOe,CHCCLDCD.XEGDbAAG..VDEBBCHH.EBEAUAFCQACFhAAAFDGA.KEEHeEBFhABASFAFaHFGICDChACADGEBAABBJHAE.dDEBfDAHMIFC.hADA......hAFA...,2,-23,-17,6
CcfFHOIdJULQADRVSBPbKENMYTagGWXeZ,RFDDVACCBHAG.KDBFEFDH....MABEaGACGDEB.XGGHhAAAZCDCfGHEhAAA.HAEGOCAHIHCDhAFAJHDGLABDAIFGDFFGSBCFPBFE.hAFA..YBHBhAHA...,2,-35,-4,31
CbcgHUOYEaDeVdQGRWSZfPLIJXNTBFAKM,CFDE..bGBEHDEE.OCBHaGFH.DAIHeBDAdADFGGDFRDAAZCFDLFAGhAAA.JABETGAHhAAAAIBGKGHF.MAGH..hABA.cBBF..YAHH..hABA.EDDE....hAFA...,2,-18,-13,5
EVcFUQGHWJfaXMIZDdBRPANSKCObgLeTY,SBEBCEAC.OGBAbFBELCFA.eCDHTABBEADEFFGAhAAAUGGA.HEDGfACEhABAaAHFICDEhAAAdAGEBCCGADACKEAC..YFFF..cGAChABA....hADA...,2,-24,-13,11
LGWgTPSBVeJRENCAUabYHdcIZfOXKMQDF,UBFFaAECHFDBdGGBZCBDODDC..KBAEDDGGLADHGDAATGGHhAAABHAC..eEEGEAHHAFIHhABA.....cABDhACAIGDAMCDAFCAHWHAGSCHHhAAA......hABA...,2,-37,-1,36
gbcDGULKPBeFJIWaQMfEXCTZHdSRVNYOA,...bBFDDCCG.LCAHKCDEBACCJEDF..aEADMIFA.EGGGCCCGHFFBhAAA.dBHGVCFHhAAANEIE.AABF.GGAD.hACAeAECIHCH.fAHC.hABATAEBSEEDhAEA...,2,-32,-16,16
KLZNgeXVSHIDURJabTQGWfPEMYOABFcCd,BDBBCCEHdADHZGCGeCCG...SBFGHDCFDCAERBGDJEGD..aGGHTAAHhAAA..QEGFhAAAGECE.fGAEhABAMAFGAEFAKEBD.NEAA.XEAFIHHH.hACAWFFD...EACGhAEA.OBHD.,1,-8,-18,10
UNeLSWYcBVdKFPORfEZCHJAQDMbXgTaIG,DHFAXEAG..TBCBaGAD.UGCHLEGB.SDEDhAAA..YEEEhAAABHDAVBECdEABKABEhAEAPBCBfBHC.CBFEAGAFMABE.IAHAhAFANDIA...hAFAWFHH.,2,-33,-33,0
VJCLXTgUWBSIZHcPFaMYREeObfNKQdDGA,CACETCBEUGCG..BFFCSDFA.HECDFAEFMEECEBFEOABEhAAA...fGFHhABAKAGBDDDEACBELFHFhAAAWEHHIHAH.cEAHaECC..eBADhABANICF.dGAA...hACA...,2,-36,-20,16
JfaTZXEOHYbIFgLUAGcWRMVKDeNPQBSCd,GGADRDFFKDCH.eBAHQAECBBGGCFBFdAAF..aHCEZFEB.ECDGOABHhAAAHDBG..IGHAhADAgGAH.AGHBMFIFhACADEGC..SAFFTACGbAGB..hBAA...FHFC..hBIA...,1,-13,-17,4
KSBXJVfecdHOIEaQDTZAYCgURMPLWFGNb,CFEHRCFGLCBGFCGC.GEBFKFBGBGGG..XGEC.JGAChAAAfCECdADH.hABAOEHFEHGCDEEEAECGUABAhAAAMGFE...NIAH.SCAD..hACAcAGA.HADAhAFAIAHE.,2,-38,-11,27
GaBEcFWdTbDeXAQKUMRJfCZSVNPgLHYIO,UEGCJCAAZFED..SAAB..PDEELCEHHADGIHBBhACAGECCaGHFBCGGhADAEAHHFEBC.dAHEDAAEAEDCKADAhAFAMDAHCHHD....NGAD.OCHF.TGABhADA....hAEA...,2,-26,-16,10
cZDCYAeHVfUNQFEPSaGBObgMLTRXdJKWI,HDBHVCBF.UBDG.QFFEEEDF.aAGAOFFD.MAHFhAAATGCARAEFdEHGKBAEIACHhABADGIHCCAGACIB..fFAGhAAANIAF..SGCABEEA..hAEA......hAGA...,1,-16,-27,11
gJNYEcfPZRIHBVGACTQbaUXeMWFLKdOSD,QDGAaEGC.eCCEFDCBKFAFdDAEDGCFJBEG...EAEB...hAAAfGFEPBBGRFDEBBAGhABAAGGCTAGF.XGDDhAAAMAEGLHDGSABCNAIG.cDDChAFAIHHH...hAGA...,1,-23,-27,4
HdPUBXIWGcEKQLZgSeNOCDaVFAYfJMRTb,JBAAMIFE.RDAG.HCDFUGCEBFBH...IHBAGAAFKFGELDHBhAAASAHH.hABAOCDGCAFBVGEAAAHBTGAEhAAAdDAGXAGD.EDGBgFEBhABAeACGDFDB.YADC.hAEAPDFA.,1,-3,-10,7
WAFMbYgXJRVGKBSUHQIDELcZTCfdPaNOe,FGGCMDEA....bACAXFAA.VAFEBEEB.HGBEDBBFEGEGhAAAZAAHfCCDhACA.aAHDNIDDWFFEhABAAGABgDGBRDBG.KECBSAEDIEAH.hADAcGGFCBGCdGEA.PACFhACA..,1,-14,-15,1
EHaAVGPJSLeIbTUDgWcNRKfZMBdFOXCYQ,GEGEJEDHLCACeCAF..TFDCUCECDGHH....gACGhAAA.WHDAhABAREAFKAEEZBFEMIAEBAGDdGFAhAAAOFBBCCHFEABEAFHASCCD.cDFBhADA.....hADA...,1,-2,-35,33
GIBZbCXAROedDEaJFMUYcHgQLTWKVSfPN,OCCCeBBHDHDE..aACAMBAF..UGGFHAGFQAADhAAATEFBKCEFVGCE.SEFGhAFANIBBBAFBCFBCAAIBdCGCFHGEhAAA..gGAF.WAFAPFCChABAIECDZBCD...hACA...,1,-9,-12,3
HMgCZFYRcaKOfUBQIAJeWETGPDXVbLNdS,eFDFEFCHGAFADBIF...XBAFLDDGSDEDMCABCBCHZBEEhAAAFGFDREAF.aFAFKFGCfFGDhAAABCBGAHAD.JCCB.hABATADEPHECNIAH........hACA......hADA...,2,-27,0,27
LARMDQZBeadGcfUNTYOWSPVFXKHbCgEJI,DDHBQDFABDAHdABCGABC.UFDHTDDAOAFE.SDAHhAAAFCEAKFFDHFAGCADBEGGAhABAJACGLCFC.hAAAADDHMIFGeHAGcGFDNIAD...PAFChAIAXFAA...hBAA...,2,-32,4,36
bWFaPVSUfTeCgOcRKDdXBHGLYMZNIJAQE,EDGBFCDF..aFHFSFCA.UCADTFAFCAHF.ODFBRGFCDEBBBBCEhAAALAAHZDEF.IGGFhACAAFAH.bFCBPHCEhABA..fACCeCFEKDDD.dCHG.hACAXAFG..hAEA...,1,-15,-28,13
LOHDfQgWEcNZPYdaFUbMCGRAXBSJeVKTI,SCEHeEGHKBFGLECGDECH..QBAAECCEZAAB.PFGHhAAAdGAGaBHF..FBGCMIEGhAAACADDAFAHBEHCJACE.TGDEhABAIGDFHFAB.WCCB...NAED.hACA......hBAA...,2,-21,-18,3
SeaGBTKDZXRFVNAPEfCOcUMgJdQILHYbW,EGGAOBDBUDGC..JHAGQBACHCGD....bEFHWFDHhAAASDAA.aABHhAAATFBADEEHZAFGFACEAFIFCCAGhACAMEDAdFAF.IAGD.eAEH.BBHHhABA...KFFD.hADA...,1,-9,-16,7
fcdWagVIZbeGMYJCBADELFUPQRSNOTHKX,EFDALFBCFCBF.UFGHQAGDRBED.OAAG..TDGBhAAAKCGB.XBCDhABAdGFGaGAAVADFIAGBeDHHhAFAMFADCGHHBDDGABCHDEACNIAF.HGCE..fDFGhAGA...hACA...,1,-3,-22,19
fMaIDKbUcOHCPZWBVQYdRGeTSLEXFJgNA,aDFEKAEAUDAEHBAAZEBFBDFD..QEDGRBCD.eADCSCEEhAAALHFCFHEGgAGChAAAAFGG.IFGBhABAbAGF.CCDH..WDADYABE..hBAA.dGGA.EEEBNCIADBFHhACAODHF.,1,11,-34,45
efMATPbZEHXJYVGadcgRFNLQSWKCBUIDO,TBAGZDAFEEFHHGDE..JHDCGBBHdEFDRADALDCFSCEAKEABhAAACBHFBHAA.DIFEeFDGhABAAAEGXAAGaAHH.hACA.cGAHNDIC..WDGHIGHE.hABAMDEE....hADA...,2,-18,-8,10
YUHPKAMZNVSGfQbTLaFeBDdXJWcEIRCOg,MCCCVBCG.GGBH.QDEETGGDaBGABAEB.dBAGJGAAEAGChAAACBAE.ODBF.UGGDhABAKEEDAADG.SDGHhAAAfEDEFCFDDCIDXCAG...hACAWHAG....hABA...,1,-5,-34,29
YedEDWQNBISMgfCJHKGTZAObUPcFVRXLa,UFGCFFAFREDALAAEeDCHdACF..DGECQDGBBHEA.MECHCHBEHAEFhAAAKBED.ZAGHAHHEOAEGhAIA..bBAD..hABAPHDA.cBBFaDGC.....hAIA......hBAA...,2,-24,-17,7
VXPFaINYRfEbHGOQWgKLTBMSCAZJecdUD,JEHBdFFHDFDH....XDEFFBAHaAEE.....IABGhAAANEEA.RFCFEHEAHDAGQAFGhADAKBHFTFAFMBDBhAEAADIHeBBE....cCGE..hAHA.PEBHYFHBhAAA...,1,-16,-36,20
BFSDQHXKNTbdeJaVfgYCMPRIGOEWZUAcL,BDAEDDABQEDGKCFH..TFEHdCGAaGBF..VGBG..hAAAfBABCAGDRABA.hABAOFGFEDDF.UBDAhAAAAIHCLAHBFGFHSACCNEAA..eHEAhACAgAGE.MEIFhABA..,2,-26,-12,14
dNGSXRacAVUBWKMfYQECFJHPZbODILegT,BDDCMHCG.QBGCEDBFFFEE.HFGBZAFHDGHBIEAHLBDFeBBEhAAAdABGGFAB.XGEDhABAaAHDAGIH.WDFGhACAfFBCCHAC.bDFEOADA..NEAA.hAAASEEG.hADA...,1,4,-23,27
fZgFPNQKXACLcGDSEVbYBJdIHUeOMaTWR,LGCGDDHDECEG.VBDBBDAC.dAAGHDGDUFAEOBBF.MFBEhAAATFEARAFEZFFH.FCAHQDCEhACAAFIF.CAGBSGHHhADAYFAF.......hABAeBEE.aEEA..hAEA.fBBB.,1,0,-20,20
AIJEPLcOeDUTbCYfgBFGaNMHSKZdRXWVQ,EACDLFGF.OEADDECHUGEG.CHAB.fBBAFBGG.aDFAhAAAMDDEHAFGKHGEdFCDREFE.hAAAXCDB.WABEhAFAAAFAIBAG.JDAFeEHH.bGCEBCHHhABANIAH.ZFCD...hAGA...,2,-25,-8,17
VHDEGZBJATRafgUMbOYNLdIKWSPCeQXcF,aBBCUFEA.OABCLBGF.dEDDKCCE..SHGAeEAAXDGAhAAAFHCEDDDG.GEAAhAAABFCAACHGTFGFRBEHMBADhABANABF.....IHBDCBDB.cGGEhADAECHD...fAGHhAEA,1,-25,-26,1
BfcEUJAFIgMdPLObQWVXRZaYNGeTKHSDC,FGFHMEFCLEDA.QAFBXGCARDADZCABaHFE..NEHG.GACEhAAA.eAHHTACAhAAASAGFDGDDBCGHhABAEFGFACFFdGACOFAH.WFDCKCDB.CCACfCEChABA...hACA...,2,-21,-1,20
WMKDdIGbZAeLPCRQVFBTfcNXSOEYaUHJg,eDDELCDDRGFG.FHDABFBB..TBFB..fHAFhAAAXDGHSAAHhAAAEDAFaBCBHDGFgFAGhACAMADCDAHDIGDD......hABAZFFAAFFDCECBcDAFNICD.hACAOAEG.,1,-6,-10,4
PYAMNUCfEBXQTbFZRcOJSGDVLWeIgdHKa,UBEFCEEGBDDCQGGG.FFBDRBEEJCBFDADC.LGFA..hAAAeHCAdFAGKEHFaCBCABAD.hABAMAIDEACA...TEEGhAAA..cGBESEGE.WAGBhABA.....hACA...,1,-21,-48,27
SPbUIeMDVgBHZYWOAaLNKXFQfCEJGRdcT,LEBCXEGAFECBQFGD.CHAFGADDRFDATADE.SBGGhAAAPGCE.IAHAhABAeABBMDDC.DIEGhAAABBBFZDFEOCABAGAEaCAEfDDB.hACAEHEA.....hADA...,1,-8,-18,10
VCEUOPcfMHdXDYJBQeFbNKTZARLGWgaIS,GGDBaFCB.SCDCEABEUAEC.OABE..fEDDhAAAMGAEXCAGJDAFBGFEhADAeDFBFGDDNAIGZAFHAIFGLFHBhAHAIHBACAHH.PEAE..dDGDDAHD.hBAA...bCCCKEEF.hBBA...,1,6,-15,21
RXMefVgQdcZEBDYTOLbPaCIAUJHWGNSFK,UFGGJECGGGDHFCBE..RGBG.MEIF..eEBE..fADGhAAAQBGFdAFFEADDBHCDhABADAAE.OBBBLAFDhAEAaDGDAAIBHEEFSCGE.KEAD..hACA......hAEA...,1,-17,-22,5
UAWOZDQSXcKRNFMIfGgbdJLEHBePVYaTC,ZADCDGDDQDDCSDFAKGADRAEA..MCAFGCBC.dGGFJGFCEAAGhACAeABH..VFDHhAEAaHEC.CHBH.AECG..XFADhAAA.FEGE.gCGC..hABA......hADA...,2,-24,-22,2
caAfVEZKQPOMYFJXgUbHWeNBIGCRdSDLT,VEDHKFFAQDBC..OCCAFBGHJBBGXBFF.UEAHhAAAHGACeABGNAEFBEEEhAAAIHHACHEE.dDHCSDGAhABADDAE..cGFGADDC.fHAHhADAEGHFMDAD...hACA...,1,-16,-27,11
GZaWRNYDcLCFeJIdBPQKOgTUfMESbAHVX,XDDEGCFAZEABRFAG.DIDALFGDFACE.eAHDJFCG.BEAF.KGEFhAAATCDCUBBAMACEhABAEAAH..AGIB..aAGF.hAGA....NHDFCCAHdCEB......hAIAOCHF..fDHGhBAA,1,-13,-34,21
PZFaXLMWbADOgBIYUVfdSHGCTNQJEKceR,DFDBBEEEUEAHdFGHGBBE..TCABQAFHEAAA.KFAFeFEChAAARECHZADHFBGA.aGGEMHFChAAA.AEGC.OHDEhADA.IHAB.fDDDCABFNIBB.hAFAcACD...hAHA...,1,-19,-24,5
fGKOgCUdNAbLHecVQZTaIXMDSPWYBRFJE,HDECVCFA.QGGAZCAB.aFCAMEFBDGAB.SECF.hAAA.PBHDBHADJACAhAAAfHBHOEDDCAGEdAEHhABAAIFA.eDAG.IACBXGGB..YCCGhAFA..ECDAhABAKFFDgGBG.,1,2,-19,21
PBdGZCfOUMcVKASFQRgNbeTLEHWIDXaYJ,FFCFRCFC....bEEGTACD.LEGBHACDDEAHaBGAJAAFBEAEhAAAdGBD.CDEC.UGGA.MCCHhABAKFADAFIB.SHAAhABANIAD.eBBBIAHAPHDE.fEFEhACAcBEG...hACA...,1,-18,-25,7
LJRGMIXHNOeZcUfKPYFSVdTDaECWgQBbA,JEGDMGAAHBAA..eAAAUFBHKFEBFBEHdDHE.DCCCCGEA...QAEEhAAAAAHELDAAIBHChABAOHBC..ZAFAfDFDhAEA.SDDFaCFDEABEBHHGhAAA......hADA...,1,-22,-28,6
MVCTZWcGLHUBRAPKaSIQNeJOFbgDYdEXf,aBEHQFBF.JAFHbFAG..DFEBdHDF.EDDBMCIB.CACAZDEAhAAAGFEF.LBAEhAAAHBADBGGBAHCHKDAE.IBFEhABANIABeAHF.FBHH..YFFF.hACA..fDCAhABA.WEAD,2,-17,-13,4
HXfaYeVRKPNZUBGdgcIWCQFTSLAJDOMEb,OEEAEBFGHCAB.aBAAeBBE.RDAF.KEGFZFFEGDDEdGDG..IHHHhAAACHAFFHGELACBhAAA.AAGAMBIBXGAChABAfHBHYADC.PCFEBFHA...hABA.WFAGSCAChACADCFD..,1,-11,-12,1
aMZGCTAXRBNgHPdbIDKWSEVcfLeOQUFJY,XEGDBHBHHBBAdEEADIEE.KGDAEHCE...VACBLEBA.hAAAOAGDFFAHJBAHMCAFhAAAZAEHCHHEABAARCED..NAIC..hABA.gGGG.IGAD.hABAcDGE...hACA...,2,-24,-20,4
GAJabDUHQFLOedfCXcRZIPWSNEKgTBVYM,JEBDaEAA..DICEQEGCLGAA.dAEGCCGC.RGCAZBAG....IBAAhAAASDDBEFFD.hABAKAGHBEHBMAIDbEDB.hAAAHADGFGHDeDAF.fABFPCCE.hACA.WFHD...hABA...,2,-18,-18,0
FcIWdQSGaRPEeHUfVDKONJLMbXTBgCYAZ,ZFEAFDFD...IBFFQBDEGACEaGGC.EAGGUDAG.DBGENDICLHDEhAAA.XBADhABABHDHCGCEACHAdEAHPBAGhAAAfDFH..KGAD.MAEC.hACA......hAEA...,1,-13,-34,21
XFAWVSRaZPMCUfEJHDKebdTIgLOcYBQNG,SEHBRBDGZDBF.MHFGCFHAEGEB..DGDEKAFCdFBG...ICCFhAAAOEABBDDFGAFGhABAFEFEAAFBaDBCUAADfADEhACA.eHDGgGGGLAHB.hABAcEFCNAIA..WHBGhADA..,1,-21,-29,8
FBaKMUNdIQPXWSZfLEHOJVTAcGgRYebDC,GDEHRGCEeACA.CBDBBFBGMDAB...dAFHQDFA.XCCFhAAAWFGH.ZBFCEHDEOBBHhABA..JBAHAFDEgFGAhACADBIDKFCCICCFSHBG.hAAA.fCEFhABA...,2,-48,-4,44
OgXfIFQVUZEYKTGAbJWSBHDcLePdNaMCR,JAAABDEEHBFHDBBALDAEdAFF..MDIDREAB.OCEH..hADAfEGCFHDEUEACZFDChAEAKGDCACFC..SCCBhAIAPFHF.CHHF.IHCD.QAGEhAAA.YACChABA.,1,-16,-50,34
fHTSGLCgVZBMARYWNPdJDaeQbKUcIXFOE,RCFG..NIBF.JEDF..aFDDeFFF..QDCCKABHUEAG.IGHBhAAAFGHF..OAFAhAAAECGBTAGELADFhABACACAZCEHAHCF...WFAFDEEG.XCAD.hBAAfHFD.hBEA...,2,-31,-15,16
QVIGACWaHJeTgSKPbYEcdOURfZNFBLDXM,aBGEJCEH...eGBASFBHKDEG....PEHDEBGBOBCGhAAAUACDRDAGZCACBFAGXFGHhABAMFFD..IBABhAAAAIBCCEAF..TGDH...YAHHhACA.fFAChADANIAF,1,-36,-39,3
OcefgPKXVJRGNHdSEADITaUZFWLQCbBYM,DBIFTACFUEAA.ZGEGLDFB.CEABBBGAOBBE..fFBFhAAAKDFG.JHEENABFHEDEhAAAdEHE..AAGBaEDDhABA.FHAEQAFA.MIFCgCCAhACA....hAEA...,2,-31,-24,7
SBLVDEOcGFWHgJAaTbNZRKYMPUeIfCdQX,aAEBTFEFZBED..KGCHMBEH..UFFBIHDAdCCC..SBABhAAALBHBECBCODABhABAGEAB.FBGH.hACAWHFAgCGBAAHANAAH......hADA......hAGA...,2,-34,-13,21
WPdKVeENCXZBLcIFbMHTYSORQgJDAfUGa,UCCCGBAA.aGFEdDHEKAGCEEFB...CCFABACBLEFE.FEDDMFCBhAAATGBF.OACEhAAARBADJAEG.DIGA.ABAB..hABA.fHGDPCFEeCCHXGED.hABAIBHE.YEAFhAEA,2,-30,-20,10
DPBaHSMOKAFZWfYbIGQTReXLgcUEJVNdC,FDGEZECD....fAGGICBDGACFQBCCRFGF.eEHHhAAAXEDA.LHAEhAAAgCFEEDCCNBAACAHBDGFFhABABFAAaCAD.SEAAMCFCAIBA...hABAWEFB...YACChBAA,2,-24,-14,10
TbWVfABHcQSCMGRKOgXYZdDUeaPFNJEIL,BAEAQCCECHHAGACEKBFH..OBAG..XGCGdEBGDIDEUFGAhAAAeCFAaGEDFADAEFDBhABATEFC..bGACfBFFhAAA.AGAFcEDGMCAB.YEAHhABA....hACA...,2,-33,-16,17
JOcDUYAPRNVQXCHBSEZIfKGgWedFLbaMT,RGECQFECHCEDEACHZEAAKCCHGBFC.eHEAFBGFLCAGhAAA.aDHDTFBEJHACDEBAhABAUAACABBH.PAEHhADA.NCIEXAGBCEGC.SFADhAFA......hBAA...,2,-14,-7,7
UWegOVafbCcEAFTRQHZIPXSGJYLMdNDBK,FCCDTCGDQEGA.HAADIHGFSBEEGDBALCFGhAAAMCAFDBGEUGAEWFEGhAAAOEDF.aADGfDDHhABACHHGAAHD.PABEYCAFBHAEKFFFhACA.eHCG...hAEA...,1,11,-31,42
NVJUFfXMPLaGDSKRQIdAYegTHWEBZCcbO,eEECTGGEEBBD.BDDACBDG..ODAA..NADFUGFAXCGHhAAAMECDaEDB.GGADhABADEIFSBEEQAGHhACAIHDDAEBF.gBGHZAEFbEFC.JCAFhAAA.fABDhAIA...,2,-32,3,35
TVYHKNALQXZEaJOIgWMSfcRdGeBCFUPDb,XBGGZDBAEGFD..aACFOCBH..IBBFMAAF.SGGEhAAAREEHdCDABHEDCHCGFAEHhABADBBCTGAEHDFAABHHLFABhAFAgGGCfGCBeAEB...hABA......hACA...,2,-24,-9,15
EYAFWRbXBSVKdJCTNMcZLDOHeQaGPIUgf,FDGBRCFHBEHBKBDC.dHCF..JHACCHFB....MADFLHFA.DDAFhAAAHBAD.eFAFaCBGGEDEhABAICEBUAGDhACAEAFGAGGG....XCDASAAE.hADA......hAEA...,2,-33,-30,3
QKFOYTJDceHPZLgdIMaSVNCbRBEXUfAWG,QECCFFACOFFH.JAGDDCEF..HACELAAFdCCDMHDA.aEEFhAAANBIG...CEADREGDEGCA.hABAUCFFACIBKGAF..TBBBhACA...cAEA...eEBEhADA.gGGBhAGAICAA.SHBG,2,-23,-11,12
IRPANfEYGFbCgMDTQdXUHcLZWSeVKJOBa,ECEGGEBEFCBH.CGECDFIDdFADHEEG.LHCCSDEBKGHHBAHDhAAAaABG.RACC.AEBD...fDDBhABAbAFE..hACATGFG.XCCB....hAAA......hAEA...,1,-17,-40,23
WPgCfKJHAUEMTGXZOaNdBcFeRQLIDYSVb,MEDHGEDDZEFEaECHBBGBFACB...QDAFLAHFDBEF.SEADhAAAbABC..hABAgGGHCHGCKBFBAGEHEDCGhAEAXGAB.NCCHdGEH.eDDG..hAAA......hACA...,1,-16,-24,8
aSZcVbEYdNBHACTgfKXQWFeUPORJGDLIM,CCFETCEEKEGA...QFAHeABGUECEOABCGGEHLHDEhAAA.aFGFSEAHhAAAcDAB.ECCENADFACCAXAFAhADAFDGE..PDDHDIDCMBIB..hAEA......hAFA...,2,-28,-2,26
EgWYcbTCHXNIfKVRFSMAeLdQDPUGJZBOa,eECDQEFBUAFCGEFEBBAEEDAG......gABEhAAAYEAF.TEDDhADACHCFHCDEIEHCKGHFRACCMAAGhAFAADDEDAEDZFCAaHBC..WHDA....hAGA.bBFA....hAHA...,2,-12,-8,4
KHeDcVPAQTSCGgbXNBMfUILRaFJdZYEWO,SFADCDFEGBCH...XADEBFBHUGGFLFDBaAAAFEGEJCGBhAAA.dDAHZAFCEGGFKEAFDGBEhABA....PHAGhADAADDFQABA....gDDGhAEANBICfHBFIDBAhAGAWEEB..,2,-30,-22,8
eBRJgXLSGAQTIaOZENDFPdWKUbMHfcYCV,QAAFaCGGZAAE.DGDFdFDFUAEEMDHFHDBF....fAEHhAAACHGGBBGEJEGFLCCGhABASFEHGEAGhACAAHAGOBDHNEIEFGFD.KDAD.......hAEA......hAHA...,2,-26,-16,10
PRUbJVacSeYfXKABEdHCZIDOWQNMTGLFg,dDBHHBBCCGHFZEFDDHDEQAEF.MFAHTBGBLCGBFFCCRACE.hAAAUEEC..JFAFaGHDhAAA.SDABhABAeABD.fABHAIDABEECOAEANIBF...hAFA......hAHA...,2,-29,-12,17
eBPdWKACTZQSGLRNJfHIaYbVUcOXgMEDF,CGCEZBGFGFEDLDCBRAFG.JCEHHDAG.aABD..VGFGUDFHOAAChAAAMADH...ECAHDFAFhAAABAHBdBAGACIB.SHAAhABAfEAAIHHA..cGCDhACA.....hAEAFGAD.WCFB,1,-16,-21,5
PTSCRZJDQfYUIKaXLEcGbOdVgFMNHeWAB,TDEARFCHDDAH..QAABUCAHKGFCLFBHGBEH..ODBBhABAdAFCFAAGHEEHAHFHBEHGhADACAHEJHFG...IEHFhADAaBHFXBCF.EGDBcGAH.gCCEhAEA..hAFA...,2,-21,-18,3
bEOPFCDQWMTNKLYdHeGVZAgSfBIaXJRUc,SGBFBEHAaGAA.RBAB.UADF..bEDAEEAA..FHDADABFQAEAhAAAMAIH.NDEF.LEEDhAAAHFGB.eCCBhACA.ZFFAAECE.IHAGXEAC.OABGhAHACDGAKHCG......hAIA...,1,-13,-18,5
DKPEOdNAYIcbVMeTfFUCgGLXaSHQJWZRB,..IBADVBCEeEABFDBD...CEEEGGDHaBGDHFDD..JCGFRDEEDGGDhAAAKAAA.ODHD.hAAAAIAE.bFBDMHAE.TADAhABAgCAGLDADSAGCWCCBBHHChACA.....hACA...,1,0,-26,26
DMFcfQbYICVEaedNGJSXBPRWATLUKHOgZ,TGFGUCAEOGEE.ZEECMCBC.FBGCQFBB..hAAAIEEHCADHEAGGaEGANEDCJAAChADA.BFBB.RCEGAAEChAGAKCFFDIACfABF.YFAFhABAdEHA.SCDFhAFA...,1,-22,-28,6
IGMKbeHZWJEQXcaVOTPRSUCAYdDFfgBLN,dGEBDEGHFABBBAHALDCFGBBAKFHDHAEGZADCEFAF....QDEDhAAAXFEHaACDOGAAhABA....PBHFhAAASCADCHHHAIAC.fHAB.hAEAIDHGMDEB..hACA...,2,-37,-15,22
JfaIYDONAbeBZCHRdcFVQSMKXGPLEUgWT,BCCHCCEHREGF.FBAD..SACBMBEGGEAALHBAUCFC...hAAATAGBaFDE.IFEHhAAADHFGAABC..eHDGhADAdEBHQBAE.KCGFEECE...hABAWCHHfAEAhAEANAEH...,1,-25,-30,5
XNWfBEKJOUeGgTVLDZRCYdMaAHPQISFcb,QFDHFCAH..bFFBXBDA..NDIEBCGAKEAGJCCHOCCBhAAAeAAGGCGAhACA.TGAFDBAGCAGGMIBAhABAAHHBIAGASEDFWFFH.EFAG...hADA......hAEA...,1,-18,-33,15
KHDWTVEFYcAMPQabSIZgGRBfXUeLCJOdN,QBEBSADFZABHGCCGREDE..BGBEfFFCUBFCCHAE.OFADhAAA.KBAEDCIBTCGFhABAEGGD.FCAHAIFAaAGAhAAAIHGE.eAFEJHCG.NEIC.....hACA.WFEFcEGF.hADAMBBH.,1,7,-36,43
TJdCBXYfILZeaDNOGMgRPQSHFUVAbWEcK,EBFGTGBDdHDFBDBD..XAFG..fECAhAAAIEDDZDGHeFADDCCHGEEDhABAMABARGFGSACChAFAFBDDAIFC.bBBEWAHBKDGECHHDaGAB...NAAA..hAGA......hAHA...,2,-18,-10,8
XHDbAFNcZIUaEQWRMTYVGJeKSdOLBfgPC,FABDZCCHaBGEEDCA..REGH.MFID....TGBAVGDCGBEChAAAKAFAOBAHBDBE.fHAFhABACGEEDCFC.AADG.IEEHhAAA..WBBEeEAHSFAAhACAdDGF.PAFA.hABAHDGD.,2,-21,-17,4
XRBACUOTbQGDJMFINaYPVKSWfedcZgHLE,CFDEOFGH..TGGHQCDEGGBDDIAEFAGA..aABHVBCGhAAAKEBC..SFADhAAAeABCdCGB.ZBGHLFAFhABAEGCABFHAAEEG.JADG.MFFHIFFB..hAFA......hBAA...,1,-16,-17,1
VAORKLgYEJdaHGZUcSCeMQfBDFIXPWbNT,RDGDKGBCLAADEEHD.dCCHHEDAZBED.SBFDCHBH.MIEABGFChACAFBDFXAGH.hAAA.PBBH.bAGBhABATEAHAACFOFAHgGDD.aAEG.hADA.cGGFfGHChADADBID..,2,-23,-16,7
BdYXcPDeCAfNWHMSTUVRbgOLQKIJEGFaZ,...fAHCNHCBHCFFMAAHUEDB.RCBA.OBBGKBAD..ICFHhAAAJEACFAHDBGAF.hABAXBDEDGEDAEBFTGAAhACA.VGFAbDDDgGGHEAEAaDHB..hABA......hACA...,2,-21,-10,11
GJESIdfNMZbTYBeDLcgXKFAaOCPQRVWUH,aCCAOHCG..CHDDRAEDUBGD.HBADECAGdEAEMFCAZDGF..TCDChAAABHBFDAIFLFADhABA.XEGEAEFE.hAAA.PFFHQGGC.WADCSABEhAEA.IHHAhAGA.fDDG,2,-28,-17,11
gNADCHVaBMYFEcOXIJPKGfZRSLQdUTebW,CBHCHEECBABHFBDB.EBHBOHDE..IABEKCDBGEBAZEAGSCEAhAAAdGGH.UGBGhADAeAFF..WEHHhAEAAEGADFGG.aDAHMHDG..cBCB..hAAA......hABA...,2,-42,-13,29
YRTVdKEUNMfJXCIZePWQLaBHFcSOAgGDb,DIEARCFEdACFKFAGUGEB..MHFG..XEDCZAFDeBAG.QCDAhAAAaBAH.BBHDhABAFGAHSCCAhAAAOACEAIBC...gAFCbDGD..YDAAhACAEFAGfFGDhABACFFF.IHHC.,1,-21,-22,1
eJXSaELdMAUPGbCYFgKfNTIcHWVBDQRZO,GAAACCEEFGDF.KAFH...TFEHIAGCHDBFBEEBDDEBQDGAhAAAOACH.eHAEhACAXFGDSGHBhADAaADAdEBDAAED...PBAB.....hAFAgCGAfGDGhAHA...,1,-15,-38,23
aDBJFIHeXfWKQPdSLgYbRcEZOANCGMVUT,CEAEMDBAUCEADAFA.BBBCFAAD..HEGF..XEABKCGAdAGFLHBGhAAA..YDEBhAAARCCHEGFD.AIHEVCGHhABAaFAE...IFCBfADDQADGhACA.SGFHhAIA.,1,-18,-42,24
RLOTfSaANJgHDMXKGUCEbWcdYQFPeIVBZ,JDBGDDHBKDCHGADF..EEBB....bGEAdAEA.FEFHeDFABGDDhAAALAABOHAC.fHAFhACAAHHAHABEUAGHhABACAHB....YFFE.IFDDhADA.....hADA...,1,-14,-37,23
JXRgCfcZVONFBGdAESYHWMLIDTbaKUPQe,EFAHHGFGLAEFDBBFaBHD.UGCH..QDCAXDAECHHGfBEGhAAAZFFE.OGBGhABABABAAFECSGADhACAMDDD.IEHATAFAPBHDJAECcEEAhADA...FHCEdAAG.hAHAWEEE.,2,-23,4,27
KCIJLHEfVZTQAgOFGYbeDBSMdUPNWXRca,OBECGBBEeFADBEADdGACUBEC.....NEIE.RDDEaCBDKGECCADCLGFChAAA.EFDDfGCEhAAA.TBGAhABAAHBGFADB.DEECMICE.WABFXEFEhACAIDHB....hAFA...,2,-35,-15,20
SBdeREVUCNKOMDZXLcWPfAgQJYTbaHGIF,QGDBJDHF..TEEFaCBGHADGFAABBGBHdAADECED.VEAFhABAUAFDKHFADDBC.ZGEAXEFEhADALEACWCHBhAEAACID....gBCE...hAGA......hAHA...,1,-7,-34,27
YOeaHCcXVWUIRGbAJSLPfgNKFdMTZEBQD,SHGGLCDE..fFFEKCCEFHCCdEAGMFDBZAAGBDFD.hAAADBFEYADC.hAAAeBBCaDGDCFCAXEDFhABA.WAHHIHAA.bFFEAHEFJFHHNDEC.hABAECAD..OCFGhACA...,2,-30,-5,25
DFfGIKBRMJTXEUSAOWPQdaZHgNVYbeCLc,OBHHQFBDdBCCZFCHHBBA...gFEDVFAD.eBADhAAACAAALFEADAHBFHGEfDDChABAKCEBBAEEMCADhAAATAEF.EEHFAIHE.aGAH......hACA......hADA...,2,-32,-4,28
caEKeQUNLbCYZVBPIOAWgSMXdRGfJDTHF,SFAGXFABdGEHREBGGDDD.DBIHTEEGHBAF.FACHaGGHECEEhAAAKGDAUAGG.LBADhABACHBAVACC.BDHG.hAAAIDDFAHHCMAHHfFGDcGBD..hABANIDB......hACA...,2,-11,-9,2
SAWMKgfTNCbZPIQEeLBJVFYaRXDcGOdHU,KABDTGDGCDHD..ZEABQCBFLDEBBBDBFGBGRBFB...DDAAOHFChAAAHAFA.AGABgEEBhABA.NADF.IHGFhAAA...EFCHeCADYHCGhACA...aCCF..hADA...,2,-39,-10,29
VCDWHEecXLRTGQgABfaJKNYMSIUFbOdZP,BDGEaAEA.KEFAMBCBUBDFFBDG..dAADZCFG.CGHA.DHBCHDAB.eAAFhAAALAECRFCB.GEDAhABAAGGEJEEH..SHEAhACAbDAF..OFHD....hADA......hAIA...,2,-37,-12,25
HRZaVUTDASdGECJfgBQcXPbIMYLFOeNKW,SABGdAGEGEAFCDEF..JCDGBHFE.QCBDXGAC..hAAAIFEDMGFEFEGAeHDAhAAAKAEDRGBCaCAA.UDGBhACADAIHAADBEBGE..fBACcEBH...hADA...YAEEhAIA..,1,-10,-30,20
EeBIMbZcOUYAadgRVKPNTSFDXQGJCHWfL,dBCCVDEHKGHB....TBDCDAGAQDACCFAB.HEEDLHEAhAAAeGBGMACGbDAEOAHFhABAADEHaHBC.RFBFNADHSCFBhAAA..FCAA.JDHHWDGHBGGFIBAHhABA...hACA...,2,-15,-7,8
ESNKRGfWCXDJgPAMZYcbHQUTLIOVeBdaF,ZDDA..bCACHGDGUFBBICHB.eFAHaFEDSHAGhAAARAAB.GCFECHHGXAFBhAAADCEDgABChABAACDAMFCD.QAGFOACCBFDGdGHC.NCAAKCEGhACA....WHDAhAEA...,1,-3,-14,11
ZYFLXGMRHJcPIEeNaBAfDbVgdOCSQWKTU,DDEHVDCDODCF..QFFDKCHHZFGDLCADMBADHGAC.hAAAPBEDeABEBGEFhAEAAAFG..fBGDhAAAdGBGSAHFWHEGTBBCFBEE....hABA......hACA...,2,-28,-16,12
QaNMKYLSPAJeObIfRGVTDUHZBcgCEFXWd,ODDB..IEHAGAAEDFAGUDAHHCEEZBDGBGEFCGHC.EEDEhAAAFHAG.dADAQGADhABAaEGAMFFD.KDFCSAGGhAAAABIDJACC.fHCHTGGAXAGBhAFA.....hACA...,2,-25,-17,8
BcERAGLVbIFTDYUNZHXCQMPOeJdWSfgKa,VEBHFGGEDFEB..UBAEZCCCHFBD.CBEH.QEFD.OFAHhAAAJDABSAHDhAAAKDHHaHDEBDDFEADAAIEAGAEAhABA..IABF...YDFBhADAXACB.MEEFhAGAdDHC.fGHC.,1,-12,-24,12
DcaFeLIGfQHdbWSMJTZEgKCXRPOBVNUAY,DGGFFHGAeGCALEBDGEEHQDEBHEAGdBGB..SFDFhAAAMDBATABDZFGHKAGGXAEBhAAAPACEBHEHNCCB.hABAAHAFaDGA..IHEDWBAD.ECAH..hACACDEH......hAFA...,2,-21,5,26
RPaNUSdgCWDLIQKYAecJfMEXZGTFOHBbV,JBCFEDFCZABAGEGG..OEDBBHCDRFDDaAHF..UAFCdDADCCFCDAEHLFABhAAA.QGFBhACAAIFCeCAB.MDIHhADAXEEB.FAAF.....bCFE.hAEA......hAFA...,2,-26,-21,5
aMWcXEUfYIQBdFGgTHCNDRLPJSObZKAVe,VFDCeEBEMHFC..XBBCEHCA.UBEFIHAABEAGFGAFhAAAGAAH.HBFHDBABLDHDhABAJFEGSDADhAAA.OFAEZDDCAAIDWHCGfCDG.hACA......hADA...,2,-27,0,27
dPWHRABEfXTaVSGNFYCJZUecDLgbQKIOM,EAGDXECC..aBAESBGAFGEH.JGEEUFAG.DDBCbAEChAAAQADB.hABAKEFDIDGHMEAGdDGDhAAAWDADABIBBGHF.fFCFTBBENEIACDDC.hABAeHAA....hACA...,1,-21,-28,7
CebMPgASTHDfXVaQNZRJBYcIUKFLEdOWG,SAGGDCCF..VAEAaBEDZEECBDFA....IACGhAAAKHFGLFFEOHACCEDHeADDhAAAMBBDAGIBHEABXEAAhABA.QGDANBAG.YCHHhAEAFHCAEGGGWAHHbCCF..hABA...,1,-3,-30,27
AZGFePcKBYQODSNbULTRHMdVgaWEJfXIC,FBHHeBCDKEFHQAFB.OGECNCEALCAAREAGdBAC..aCECJFHDhAAA....IDHGhAAACGBEABBDZFCH.GEEBhABABBFFDAECSGAD......hACA......hADA...,2,-47,-10,37
aFMTDBKZAOWgeRJUCELcSQYfPNXHbIVGd,ODACeECGRGEE.UFGAEHBA.LFCF..SBAGQGEEhAAAfCDFXACCIHAEhABAGBFAFEABTCDFhADAKADAAFIFJAHFCDGHPBFA.....hAAA......hABA...,1,-9,-19,10
QFVRTgBLAEcKMaOIJbdDCWYNHPXeZGSfU,KBFDOECC..IHAHdCEACGCA......NBGAHAAHXEFChAAAeEHBSHGChABAUGAGFHDE.RCCDBFHHEEAAMADAhAAAbAGDDDAF.PEBDfCCB..hACATABBAAHAaGHH...hBDA...,2,-23,-14,9
DEJHaYVbBTQOGgMCUfWRPZSFAXILKcdNe,XCEELACHdGDGDBDG.JHEAHEAE.aFGA..VEEABHGGQCGFhAAAGGAFMECAUEAChABAfAADRAFG.hAEAZCAGAHHAIHACKAGGcGGAEBBH....hAFA......hAHA...,1,-5,-14,9
ReKCLXYGgAJZSDUIQVMBTFNEdWcaOHbPf,JEGBZAGFUADH..VDBEBGGB.FCEHEAAE..dGDB..aCGAOEABhAAAHAED..fFEEhACAKBAB.CGDGLDAFhADAGCBCAIHCDGBHIAHFMEIB...NEICcGAEhAEA...hABA...,1,-12,-37,25
SGXFLYNQRVdZOgfbMDIEUceJPaWAKCHTB,KDGGHFCCBFBCXGACLGCGQBFF.VCCEOCCG.hAAA.fABFhABADIAEIGGDcGGF.PDBHhAEAaAGFAAEFCABHSDFAFEDH.NIBF.dDAB.hAFA......hAGA...,2,-43,2,45
aGfSbdFLPHKIJMOYRUAVTcZDEXCNWeQgB,VCDGTBBC..DFAHCFGC...eCABBFDBGDGASAGBFGEGLABAhAAAHCEBKGDDIBGChACAMACCOBDG.hADA.YFBBAIHCEFHHNAAC.......hABA.QCGBhAIAfDCG..,1,-15,-23,8
cKNRJTMSaPVXbBfLAGgWUOQDHCedIZYEF,GEFAUCADDEEACHAAdBAEZGCC...FDEDKBECRCCF...MIBA..PBEChAAA..XEDChAAABEHDAGDH.OBAGhABAeEAHEACAJCFE..TEADaAFA...fFGHhACA...hABA...,1,-28,-33,5
WGCDZdTSeAKaXMLVQRHbFOYgNBcIJfEPU,KABFaEFHLFDBQGFDRBAB.FDBD..OBFC..NAHABAEEhAAA..cFACJDDFEADBhACAUCCE.CAEFDFIDTGCGhAGAADAFMFHD.........hAIA......hBAA...,2,-36,-25,11
JSfIBYCUbGdPRXNTHLVeZDEFcQagAKMWO,MAECOBEC..JDAESGECBFEF.CDEFGEBDRCFH..NIDD.hAAATGAGLBBCVBAGhAAADFHDFDHF..aAHDKAGGhABA.fHFHUFBC......hACA......hADA...,2,-37,-20,17
XTCSBIYPAcdWUHOJfQeNKZLRDMaGFEVbg,dBEHUEDBHBAAOBAGQDDA.KGECRFAFDDCHMCIBGGEB.hAAAEEGEVEAE.bGACXBDHhAAA.SAEBhABABHGFIDGBADIHJAGH.NAEF..aABA..hBAA......hBCAFDAB..,1,-9,-14,5
QLGROTZUVWEYIaMBgCAXfNPDKcFeHJbSd,XEFH..NBFAKBBAFHECHAEA.JCAGdGCCLECEGGEBTDAEhAAAZEAH.UBGDhABAEABCaDHHMDHBCGDCAIHCDEEH.hAAAeCDFSAHB..OFAB.hABA..WADCBGHH.hACA...,1,-5,-24,19
fHDcOSLPZbRKEAaFNCXdQYJVgeBMGTWIU,aBCCFEBCCBGA..QFBA..JDGFVDEDBAGCMIBAGBDEhAAATGGDUBAD.DAFDOBHDhAAA.SAHFhABALHDE.bDAGKFEGAFHGNACH......hBAAYEAFWBDEfHEBhBBA,1,5,-52,57
aUSERdgeZGYCPBJLFVIMNObHcfADTXWQK,DAGEXGACKBFB.UAFAEFEG...RACHdHDDZDACCABBBEHA..LHFChAAAFGHB.MEECNEDB.hAAAHFADABBA.QBCAhADAaCAH.SCHBeFDC....hAEA......hAFA...,1,-24,-29,5
PgEATYFJcIOMSLKVGHRBfWdUNQXabZCeD,FFDGJAHH.ODAHLHFCGBBGBAEA.dEGEQBGE.aHFAhAAAZFCH.DGACEGACAABG..hABATCEFIBECKCCE.hAAA.HDAAWEEE.NICHXACBCBBC..hAFAPEEB...hAGA...,1,-18,-25,7
YfFNTKOcXQgLWIRbEZAMUaHDGeCBVSJPd,aEBEDIACeDGHBDCC...JAEAdCAE.FGGDKBBA..OEEAQBDGhAAALHAARGCAZDABUBGEhAAACDFH...VFDCSFDChABA.fGHGNCCB..cFAChABAWAHB.IADEhACAAACGMIEE..,1,-20,-34,14
VYGZbHBLIXgdRKaUAcfJNEWSDMPOeFQCT,JBCGEEHHDGEF..ODEAeHAE..FCEACEEH.....TEEGhAAAGGCHZCAFBHABLADGhABAXCACdDCFaCGDUAFChAAAAGIF..fGGGSFGAMAIDPEAEhABA.....YHFGhACA,2,-30,-19,11
UBPWCRYdZVfTOcMNQaDgXeASLHGFEKbJI,HFGFEDAFKHCCJCBF.UFDBBGFB...CDCGdBCBVAEH..OCGHhAAAMIDC...aAGFXAAEhAAAAFBALFHDFCHF..hABAIAHDRDDH.fDDBNAIADGBHeADE.hABA.SDADhADA...,2,-28,-19,9
GAadZVObDBEHQWgNKSCFUIeMJTYLXRPfc,aADGdFBHOFFBBBHFHCCG..QCCB..gFFDhAAAKDAFCHAEFCFHeEHDMBBBTDGHhABALACE.XGCAhAAAPGCEfBFEABABVAGDDDIF.NIDFIHAChACA.REBC..hABA...,1,-3,-15,12
eQaOTKYCMULfIXSNBRbHFEPcVDgAdGWZJ,GACGZCCCeDAGaEGBOCGBKFEF...CHGBLCHHIGHESDFFhAAABAHDRGBE.FFCHEAEChAAA..VAEEAEAFdABDJEAFhABA...TCAEMFFBXECENIBD.hACA......hAEA...,1,-14,-15,1
TcDOJKBQXMNUEfVWHbdaLGRZAPeYFSCIg,eCGBSBBFCBCB...TGAFDABCKFBFBFGBQGFCMIECECFGhAAA..VCDFHDDBaAGFhAAALADG..hABAZFCHACCAPGECFAEF.IEAAOBBBNCIE.hACA......hAEA...,2,-17,-17,0
HAEOdSJZFPNfCabcMReUXVYGLIgDQWKBT,OBFESAHDFBAG.....PEGHCFDEaGAG.MBCF.eAEDhAAAXDAAGDDCLGDAhAAAIGAHDDIDKDABTADHhABAAIAEEAFBdHDDZFGHNEDHfBAC.cDGAhABA....hACA...,2,-23,-15,8
GOQCSETbHceMWXPJgfIYBFKZANDRadVLU,DGEDaHBGLCBDUGGDGEBH..CDGFSDEDECGF.HACGhAAAeADCMHFEXDAGhAAAPAHDJDHB..fEHChABABACFFGBBKAGGADCHNGBH.dCDH...OABHhAIA.....hACA...,1,-9,-24,15
DZdJAYTSaCcOUbIeMVKfFQLXHWNGERgPB,TFBGCEFEUGDC...eFEEKCFG.FDFALBCGHCAGGACBREAF.BBHHhAAAZCAAAGHGSGHHhABA.OHBEMAIHfHBFhAAAWFAFEHFCDEDEJHFC...aABA.hACA....cAFAhAEA..,1,-6,-29,23
MTfPWFgJCNeZabQEcSAOdGYRBLUDKHXIV,OFAHdBBHRFGDBHBBDABAHEEE..VBEBTDBG....fAGDhAAAPBFEFHGCJDAGhABACDHFZBBG..QDGHhACAEGDDADFE.GEBH.....hAAA......hAEA...,2,-24,-22,2
XBEacLGSOYHMUQgCKZTNeDFRPVJfdIbWA,EDBELEEFGGEBSADBOGBG.HBBDMIAGQGGAhAAAKBFCZBACeAAERCGHVFAE.fCAEhABAdDFGbADFAIEAaAHFhAGAYAFA.CFFBDICCJDHD.....WDDChACA.BHAD..hAHA...,1,5,-1,6
NaPgMULKFDfSIWQcVZGTXeJAOdHBYbRCE,dFACHAAABBAHRGFACEDA.EFED..aBEB..MDHDKGCEDBIB..SBDChAAAQCABVCBDhABAGAFE.eHAEAICCOAEAhACA..YFFENDGA.gEAAhAAAFBGEIHHG..hADA...,2,-34,-5,29
RcSEJYTBLWIDedHPMZKGQNfCAVbOgUFaX,VFCEOEEE.UCBCFDBH..RAAG.EGBA..JDCCBHEA.LAFEhAAADIGEdAGEHAEDMBBGKBFHhABAQFFGCHHA.AIBA.hAAAbEAG..aBHDSEHH..WEADhACAeHBA....hACA...,1,-17,-25,8
FYDKBgGbNeXACVUMPZLfRIEQOaWdcHSTJ,VBFAUEEAMEAH.ZECFREEAEGAG..OBBBaDDB..dADHSBFChAAAFGGHDIDA.KGHFBCBEhAAA....gCGDhABANBAEAAHA.CADAfCDDWDHH.hABAcGAE...hACA...,2,-32,-29,3
GTXZfAOeSQLPEgFMbDBaVYcHdWNRCUIKJ,OBDCeCGBLADE.EECEMFFDBGECaFDB..VAAFHAGDdBEEhAAANABAUGGDKHAA.JDDCXGGGhACAZFAB.AFIHSAHDhAIA........hBIA......hCDA...,2,-25,-18,7
FUREKZMPTJHLWgCDYQaGISVfANdBOcbeX,BFHDODDFeEBFFAEE.EBCDKHEG..ZGDCMEHF..JCHHLDAHhAAACBDE.DDFGaFEESAHDhABAACGDdEDF.XGCGhACAPCAB.HBBG..gAGEhAAA......hABA...,2,-33,-23,10
HAVIZBSOdKFaCTGYbMQgWDXfPEeUcNRJL,ZCGBSBHBKECDFAGB.CAGF.GCBB..MGECQADBDFDEXCGDhAAAEGDF..UGGAhAAARFAELACEAEEBBABHaFFHhABATCCE..bEAH..WHFG.eBABhABA.NIAH.....hAIA...,1,-11,-27,16
WUDMPFAOdQYNJgbXSCHBVGeZRfcIETaKL,dEGDQFDDJDBA...XBGBSAEDCBCHBDFEeHBARDAG..hAAA.ICHDEGGHTFAHhAAAKABDUGGGMFFGABBHOFAEhACA..NABF.HAFA.....hAGA......hAHA...,1,-20,-25,5
QaVUWfSYRHTZCENAIOXgJbKcDdeFGLBMP,XCBFJCDA.KEFCDBBB.eEAGFAFABGHA..QEFGhAAAUGCC.SACFhABAHACCCDAFABAEOFFHbAGFGGBHhAEALCFAMBIBaHGEfDDC..hAAA......hABA...,2,-30,-13,17
VPULHQYFBaKDNeTCbcAMdfORSEXGgWIZJ,MFFCODEERBAF...SAECEEABGCDF..IBFFJGCCUAGAhAAALBBFHACGFHGEBFHChAAA.KGHHDIBAeHCGhABA.CECHADCGfDCGXACDWAHF.PFFDhACAaGGG....hBAA...,1,-5,-27,22
RIEgeQCUdBXPMcYJLfVZWDGaFbOTNSAHK,KFHDRGCEEHAEQGDC.UDECBHHD.MCBAJBAF.LCFAhAAAZFADGAEFaEFEFADC.ODDFhABASDHB.hACAICCFCFACdGGF.PAAA..fBGFhAFADFAH...hAEA...,2,-26,-19,7
YUOeHDSZcAVIdNGRbPWEaBCXfJQLFKTgM,VEACdGDHGDEF.RBAB...PHDGEADGBCCECCHC...fGAFhAAAJBACFHAE.KAGBTEFBhAAAMFAG...OACGhABADICASGGDAHIBbDDD..aAGC..hAHA......hAIA...,2,-25,-23,2
fYSNDLgbFEIOeWHdXCaGQTBUJVcKAMRPZ,MHBCZFDASBEHLBAEFDFA..OBHHeBFGdEBFaFAFQBADhAAAUGGH.JFHBKCDBhAAAAEAE.fCAChABADEECEBDF.IFEDXGCCCFCDBFHF...hABA......hACA...,1,-17,-25,8
POdaZXALDEWQCBJHNUGeTRKbgIFVYScMf,DAAHQEEHCDCG.JBFHUEGF.GDDGeEACKDHB..IHBHhABAVBAC..SBGBhAAAMBDA.fADHhABAODAFaCFGAGHBEHAABHDD..NICF.RBBEFGHHhACA.cAGF..hADA...,2,-30,-16,14
gYVeUCRSHbfdMDKWPAIZJEQBLGaXcOTFN,ZEFDQBDHLCCCGGBHaBGC.OEEGFEAF....NDIA.VDBBhAAAUEDBCGHARAGD.SCAChABAHFBBdAAHDAGGKAEEAGGHhACAEADE.BHHD.....XGDDhABA.....hADA...,1,-7,-17,10
PEBJNdTacVSYDMZgOFbCGXfIHRKUeQALW,LCECEACHBGDAdDGEaGFE....SAGGMBBDZBFGFEDECBBHXFDFhAAAHFAFKAFE.UGGFhAAAAAFDJDBB...NBAC..hABA.cDCGDHAGgDGA...hACA......hAEA...,2,-27,-22,5
ZLdFVAGMHWJaEYDReISbCTKcgNfQOXUPB,MABAHDDBaGAHDIBC.RDAC...eECASCHFCGFH.KBCH..NCBG.hAAAQFGCOAHFUAFEhBAABBAFZFGFFGCCAEIH.WAFFhAAAECCG....IGDA...hABA......hACA...,2,-26,-23,3
gPNCLJVfHGOFRIMDdAQbSXKYWaeUTEZBc,SAHHXAGHKEAD..aHFGUCBFZDCABBBB...PGAAhAAANDICCFDA..LHEEhAAAVADGHCFDFADFIDFAhABAMBABAEHE..bCAHeFBF.EFFC...hABA......hACA...,1,-16,-22,6
IGOeAWNVSFXafbgJDUQBCKPLMEZYRdTHc,VABBXECE..aAAB....gAFDUGFHQFAEhADABFHGCCDFKDBGMBEFZAABdAHAhAEAHFFBIDFEOBHDhAAAAFFGSHBAFGDHfHAFDGCGEEHD.TAFAhAFAcEAC...hCFA...,2,-14,-11,3
IPGNdRDQWJaXgBZKfeAcTEUMYVOCSLFbH,EAFDMEAG..OEDHCAHGFACC.HBCGGCGCRFFCDIEE..JFAHaBHHBCFDhAAAZBAHKEAF..AABFUFEFhAEASAAE.LEFEhADAICCGdHADXFBB.eFHHhAFA......hAGA...,1,-3,-32,29
aOEGPNXdRZCbIJfHFTYUQeKAMSBVgWDcL,BAHFVADC.DDEHLCBF..OBBEEDDCGAGAXFBEZGDACEFAhAAA..JBFBFGAHUGEBhAAAKGGEADCH..MBAB.hABASFGE...gDAHhABA.aCHD...hACA...,2,-32,-23,9
NEXLBTgcdVMSfQDUHKObYFJZaWeGPAICR,CACEEFDHLAEDBDBG....TCCEdBAAMGCEQFFEDGGGKHDE.hAAAOAHBFHFE.ZADAaHAGhABAeFAB.AFCGIBBDhAAAXDFH..VAFESEHBHCCB..hABA......hACA...,1,-17,-24,7
EbUIYBKQVSdXCgaGRWNMLTOJDFcAHfZeP,ZACEeAEFEAHBUDDDBGDGKAGA..QEABdGFA.CDDD.aDAFRCGB.MIAEhAAAOFEF.DIGGAEGBHCGHhABA..PAAFhAAAIGCG.SEADXGBH.GABAhADAWEFB.NEIC....hACA...,2,-31,-8,23
CTWFRXNOEfKdgJMVUHaGcePIBYDZQSALb,LEDBTBEF.FABDREFH.OADHEDDF.dBHAMFADHCEHGBAC.hAAAeCHDBFABDFEDSFHBhABAABADCHBH.WAEChAIANAAFKHGA....JHEEaGBA..cGBBhBAA......hBFA...,2,-24,-9,15
RgYcIbOSGKTWUeQdZXBPLFNVaCHJDMAEf,RBFE....gDAAIEEB.SFCAKECBUACB.QAAChACAZDADBGFELFHBhAAAFFFBaADHCAGADFIFADDC.fBHAhAEA.cCFCGGAFTGAFeBAF.hABAXDDC.NIDF.hAFA...,2,-21,-19,2
XJPFYDTfNVLeMOHAdaQEbGcRZSUCBWKgI,dEFBQDGHGBAARAFDSAEABFAD.KEAGXDCAFFDG.DHBGhAAANCCD.LGFA.hAAAMICEAHBDaHGC.cGDEhABACABE..IFCEJDBAPAHDfAHGhADAeACCEGGG....hACA...,2,-18,-18,0
YXLJSbGZHCOeKRBadWFfcUTgQPINVEDMA,LDFEJEHHGBBFZACAHAFGCHAH..KGCHaHDGFDCH..UDAG.QEDAhAAAIBAHEBGAhAAAAAEGSDGF.hABAeGAAdGHAfFAC.gEFAhADA.NEEEMAFEhAEA...,2,-28,-10,18
ZEPYRCGgXSbJMVIDKAFHcLTefBONQWUad,FFBCHCBFLDHBeHBEOBBAQAGDUBGFZEGHEBDG...PFEDhAAACBBCGEEA.SDAChAAAMACGDIGEAGAHfGAGhABANBAA.WACEdDDE.RCCH.....hAGA......hAIA...,2,-15,-5,10
dZHeMcAbTfNEFBDPYVKUCJISWXaROQgLG,TGEBEBEBBHEF.DFIB..VDAFUEABJCCC....SEFAhAAAXGBERADEOHAAhABAQCGBLDDBdAADHEFAhABAMBBBAHHFfHGFNAICFACF.KAGECBGF..hADAaGGB.....hAFA...,1,-4,-19,15
CQPHgIMVDTBbeZNcGOAdURFXLYfSKWaEJ,UCDFFBBDLFHF..SGDAKGDGaACA.JAFG..QAGHhAAAHEBFMBIHDDDHBBDBhAAAeCEDZCAB.NEGA.OEFDhABAAFIH.dFAG.XCFEWACC.CFCG.IHHBhABA...hAFA...,2,-26,-24,2
VKTJcYDRdQeEBACZIGSHfMWLUagONFXPb,CCFCGAECHGBE.MDADLFHHUEBB.ODFEFDHF...XDAHhAAAbFFC.KDDF.TFFGhABAJCBADHCEdCABeHAGBAHDhACAABDESACCfAEBaGABPHFC..hAAAYBBC..hADA...,2,-13,-11,2
MKBOfWRYIADgCLdaEcTZUFSeNJVQbPXGH,CHAHdFBE.aHEEEECE.ZFBAFAFA..eABA..VDFGQFFEhAAA.XAFGMBABBBDEhAAA.fFDBhABAYBAFAAGGDBIDLDHBTCBE.NDCD.JFHB..hACA......hADA...,1,-9,-31,22
DfFJegZBKbNVRUXLWPEHGOYAMTcCdSIQa,MHFCCGDBdFAF...SFCCaEEE.DHAGJBDDZCEABHGG..NADA.hAAAUBAHLFFE.hAAAEAGFODFAACCB.TGAHhABAIFAE.FCAFKFHB.....hABA......hACA...,1,-31,-43,12
eTLHGbRXVaQSfKMIFgBPUNdYWAcZCODJE,CHCGDCID.eECGLBHHGFEHRFFD...aBDFSBBE.MABAhAAAIHDBBCEHUECGhAFAdBAEABHDZAEFEAFC.TGAChAAA...........hAIA......hBAA...,2,-37,-25,12
WVGKIfdgLRXaZCBYcMFPQDHAbeSJNTOEU,eDABSDBH..NEIG.TDDAUCCGGCFAKBBGdDHGLGEEhAAA.XGCHhABAaBBHBHCG.MFFFQAGBhACAHAFCJACGOEAHEFDFIHGFgADGhAEA.CDFB.....hAFA..FGAH,1,-4,-10,6
IJfZaTWNCDcOYBFeKLSgAGRXbHPQEUMdV,GEEEXGCBHDGD.QABHMAFAVBCFJEBH.ZCDD.TAFDhAAACFGGDDADOBGHBHACKHCAhABALEEBAIGE.bBABhAAAECCBdCHA...aACA...WHFA.hADA..YFBFhABA...,1,-1,-19,18
cZGWXRQNbTDBUAECFVgaLSOHfJIPMedYK,EECHCCEAFHAC..aAHBLFFEHEEE..fFACJBBD.IGGBhAAAMFEH..eFAChAAAKAFHGABARAEG.bADHhABADABEBGDAADGHSHGA.ODCChAEAdDGD......hAGA...,1,3,-35,38
CVDHPJSFMcEZYbXOIBdLAUNKGQWfeaRTg,UBFFGBABQGBFeAHBaFDB.RAAC..CFFF.DEAGHCDFSFFGhAAA.FDDAMFAHECFEZFADhABAXGECBHEFAHIBNADBKEBHhAAA..fADB..gGGHhABA....hAIA...,2,-17,-10,7
fFEWGCbgYNaMKIRULVBSeTDcXPdAQOHZJ,ODGDHEGFJCBHFBAGGACC..CFBA...bAEF..NBEAKHBCUGBDhAAABDADSFEHhABA.DIEGPAGBAEFGfAGChACAEDCD.WAHHaGECMDIB.IHHGhAAA.LFADhABA..,2,-28,-20,8
QYKJHZCVOIDAEcFgSBNdTWePfXbLMURGa,FCGEBHFFdHEBeEHD..XADHMBGBUEADGFAH..aBBHKBBDhAAAZEDDCDBA...IBHEhAAAAFFEEEDC..SAFBhABATADE.WHAAfCCB..hABARFGD...YHAAhACA..,2,-31,-23,8
DTedFAICVLfOMKUBSGgJaXbRNcHPZYWEQ,CCFEVCEELABB..MIFAKFDCUFGEBFHDGDCG.JAEAbADHhAAA..RDAHHBBAZAFAEGEHhADADIAA.dFFCAAGC.IAABhACASCHD..aCHF.....hAIA......hBAA...,2,-34,-8,26
XDQWbEYgCJZPMARUONBaGLTfHFSIedKcV,UDEFOBAHBDBHLCEDHBGDFGBGeFBH.dBGCKABE..XGGGhAAADAAH.QEGFhABAEAEGCGGA.ZDCFABDHaHFCfEAHhACA.SBBA.IHEBhADA..cFDDhAGAWAHB..,2,-45,-17,28
YSMLTEVdWeCHbAcOaBJGKXZPNfIQgRFUD,OFGHJEBHGADBKEDHZADG....fECBQEAAFHEEUBADhAAADBAB.MHAELDGBhAAAECFB.dCCBCEHEABIDBEEEhABA.NCIA....IHACYFEBSBBFhACA...hABA...,2,-33,-18,15
NYQXPcKdFeTDJgfGLbWCVZMUISHREBOaA,QEEEXBDEKEGBeCFG.DABC..JFACGEBGLFEDCHFBVBBChAAAMCIH.UBAHSAFEhAEA.EEGCOAGBhAAAAFID.YDDA...dHAB.hAIAFGGH.....hBAA...,2,-21,-15,6
BgaRHVSbXTDOUKIeZPGcJALWdFNMQCEYf,LEABdCBHMBFG.EFGGBGDCRFDG.HEBA.SFHDTBAGDCFHKGAAhAAAZFBD..GDEFhABAAHHDNADE.CEAC...gAGAhAAAaACE.........hACA......hADA...,1,-23,-27,4
ASdYJZTNfUXRQDIWPeBCLVFaEMGHOgcKb,SBFCdDBFJGAG.ZGEG..TGDEUCGGQFAHDCEF.hAAA.PHFCBCCFCABAFABHhACAMIFCGADHHDBGOEFAhADAKFECADAC...YCFGNAEB.XEAGhAEA...IFFBhAGA,2,-29,-13,16
NMZQHIPWeTgGRbdUDXYfLOBAVJaSFEcKC,VFCGJCAD..FFDCEBFG..CDCH.ZFABHFBB..IABAeEEEGACDhAAAdHGFDCCF.XBDHhAAALAGH.AGHHaHEChABA..KAHBMAIDWADC...RDEC...hAHA......hBAA...,2,-24,-18,6
bPAWQcKSFdEfXLJGHZaYROMegDCINUVTB,QAECSBGCEACHLFFG.JDCFGEGAZBAC.aFBGOAAGhAGAeFCACAAE..IHDAhAHANAEHUCDGBCHFACHAKCGFFHFGhAIAdCACHGDCMEBF.DDID......hACA......hBAA...,2,-15,-4,11
aLWXeTcgIJRQZfdAYOVGBNbPCFHSMEUDK,OHBEVFCE.GDEFBFHC.....PBBBCCACHCCC.MCFAhAAAEEBCDHFEKFAHLFFBhABAeAGBTACC.IFDDhAAARABGfAFFAGCBNEAE..SFGAhABAWEAC......hACA...,1,-19,-20,1
gJADfPTQMCWcbVEOdRUHGBNXaYZFIeSKL,DCDATEBBCEGE.......bGBGOBBGdABFRBDGUDGGBAACXGAAhACAaDDC.FFEGeFFDhAAALAGDAEAAQAGBhAEAMEDD.cGGFVDAFEGHD...NIDB.hADAICBG..hAFAKDDC..,2,-24,-8,16
YWCODbRMVeBFgQdSNJHTLfZAEaGUcIKPX,GECDUAACKDEA..PAEG..XGFACCDDDBCF.REBF.MCIBhAAABBFGFBABdAEB..JFGBhABALBHHADBF.aDAFhADAIGCEOFFGeHDGSBGH.NIAB.hACAfCDA.hADAEHAG..,2,-33,-20,13
UNIXGRVFBPdAEWOJDgHLCMYecKaZQbTSf,OBABJEGDHABBLGEG.MDBEeHBGKECEaBEAZBFHQCEChAAA.SFAChABANEIGIHAF..XDBEhADA....RFAEBFFBAGEDEAHHDFFHCAABYAFChACA...hAEA...,2,-21,-17,4
YKNXBMWRZQSTdUAPOfGDeHFVcEabJCIgL,ODCBDHAGFEGG...EGFBaGGH..CGDGLBECKABHBHCA.REGDZAAD.hAAA.QEAHhABASEDAdADBABIF.GCDEhAGAeEAF....cACGIBGD..NIAFWDDEhAAAPFHF...hAFA...,1,-27,-30,3
OPMFADTGXWbNVfgIadSKeHYCERQJZcULB,TADHXAGA......NHBD.gACDdEFHKDCEHDAFCFEBEBABhAAAJAGHZEACUAAE.BGGBhADAOHCEMDIHAGHBDDDEhABA.bDEA...fHAH.SGAChAEA..hAFA...,1,-22,-26,4
fXgcdSRCbPOKJMWNZGFATQHBDYaVIELeU,QBFABDGBaBFE.EDFDUGFD..XEDCdGAACADH..OFFGhAAAJACCMCBH.NBIAGGAHhAAAACCCDABC..VCDFhAFAIGGB.fCDESFBB..hAGA......hAHA...,1,-12,-43,31
RBXadWNceGJTUFCMHIQZYfOKbDSEAPLgV,LAFDVCBH.BCCFaFDD.dEFB....NDAA.eEAFGACFTAAChAAAUDFFCGGH.HGFAZECHOHBChACADGCDAIAGRBFAXAAFhADAJBHH...MDIDIADD..hAHA......hAIA...,2,-27,-1,26
XWdLAcgODaFRBTKfCJQNVeIEZGYbPHUSM,OEDFDBCBRBDGBDHEKGFB....CDDC.JGAEQGBG.eCBFhAAAIHHAGABB..hABA...bAFDPEAChAAASAHBMACGdHEHAFAHcDGEaAGE..FEGBhABA.TDDF..hAGA...,1,-14,-41,27
PGbYBDRJINFfTKXLVEQUdWAeacMSHZCgO,aGGDMBCAZDDG..CCCD.OAFGGGAH.BGGFDGCARACC..JBFDFDABKAGEhAAALFFC.ECEAhAAAdEAA.AIFCSEEAhABA..PHCEIECHfCHGhABA.....hACA...,1,-21,-44,23
FUeKYAGgZBRcXPWMdOICDLESafQNTJbHV,ZECABADHRDGB...XFGHMABBdCDB..CCHBDCBFEGCC...SEDDhAAAaCGA.QGADhABANIBB.TEEBhACA.HCECFACA.KAFEAGBEgGGAhAAA.WFAFICCDhADA...,1,-27,-36,9
NFfCEMVHXdaAIWSUDcYgKQJBbTZRLGePO,SBEFDBEC..gGCGJHBABDFDZEEARAABLDGDGCBCeHEGhAAAOFAH.FDCDEAGEhABAMADCHBFA.aADGIHFFhAAA..WCADYBFG.KFDGhACA......hAHA...,1,-9,-27,18
RJYFIcBGPLbfZUdMHVCNEeDOTagASQKXW,KECDREEAFGGDBHBGLCAEZCAB..UEGAdEADMDFAHEED...CABD.EAAAhAAADHAA..aAHFAGCE.QADAhADA.XCDChAGAJBDC.IGDAcAGC....hBCA......hBFA...,1,-23,-42,19
ACFYNBZOUHQJbefcVLEWRPXaDGMSKdgIT,CDHAFHFABAGFZDECUEACHBCF..QEEG.eHDAfCCEhAAALACEEBHBRAADaECCDDFGMEIHhABAKGCD..IBHAhAAAABDHOAFG.bFCFcGGA....hAIA......hBEA...,1,-15,-25,10
PGZEbVfIgABMDYLSXKCWacNQdUFeJROTH,DBAGLDEBKGFH.CEAD...aGCAQACH.dBAEFDBDeFCFhAAARDFEHADGGGEHEHAG.fDCChABAACAEBFFFSAGHhAAAcBGG.JCCCPDHF....hACA......hAEA...,2,-32,-16,16
ScdHLMbCfQOFWKBDAURZNIGPTeagYJVXE,UBCBZCDGGEFEeGFG.aHDE..JAAF..EAFGdCGDLABEMHCA.hABACEHCOCBFFFCCBHABACHFRFBChAAA....PDAHhACA...gDDG...hAHA......hAIA...,2,-31,-23,8
dILOcUJCNRABebWSXYgHfZDEKFVMTQaPG,eCBFSHFA..gFFGHBCADDIFKCFAFAFF.MCAFQDDChAAAaFBAGFEHIGDGhABALBBFOHAEJGACNAAFhAFAAHFBBBBF.WBHFfAHGEADF.PEDGhAGA..cCEAhACA..,2,-11,-11,0
gZaTYGAXcVONHDfEeRFSLWJUPKQBbCMId,XBGEVDDD.HECDDFGE..EDBAFGEFLBBAJACC..UBABhAAAKGGCBBGEMFABIHBAhABAdFACaHEE..TCFHhAAAAEIDOCED.fGGHeHAASACChABA.....hAFA...,2,-26,-16,10
cXSBHAVNPDfWdCUbIRLMOTaZYeJGQgFEK,VBBFDECCdAEE.UFECRCFALEAA..MBHFaBEB.ZBAC..eEFBhAAAJAAA.QGAAhABA.EEHBXGCHhADAHGCCNADF...fGGDCHHG.IHABhAGA...YBFBhAHA,1,-9,-41,32
cXLZdJYIPEKRHSMFWbfQeAaGBgONUDTVC,BACGOBABDBFA..TFCECHEDLDEC.ZGAAJBED...IGGChAAAKGHDHBAEFAGF.hAAA.fFADhABAAEFEaFFBNCIC.UEGD.XADBYCCDEFCGMDBDhABA..WEFD..hAGA..eFAD,2,-29,-19,10
SUaINcXRPfYDMbTVWEgGQJZBOHAKLFedC,KCAALFHBdFAEUEGGaGDA......IACEXEBFRCCE..hAAA..fDFHhAAAMFFBTAEGEAGFQFAAhABABHHAABIBCBAF.SHCAPFDD.DAFDbAGBhABAWBBD.gGFHhAEA.,2,-28,-28,0
eMcDTaYIdCURNLEVZGAgHOXFQKPSbWJBf,HBGFXFDFQCAHKGBF.SHFC.JGACBACHfDDGhAAAMBFADHGGTACHhABAICDECBFA.NICBLCAHhAAAEEHF.ZCFHAFFG..OEAC..hACA....FDHF.hAEAWAECaGEB,1,-8,-41,33
JCGMEdQKbWcOafNHgXVZFUeDYTABPISRL,BEECSAAFREGHLEBBGFDFdACAKCCH.....bCFGOBAHhAAAaEBHHAFAVBFHFHFEeAFEhABADADAABCF...JHAEhACAEGFD...WEDDfEHG..hAHANIAD......hAIA...,2,-20,-13,7
ZFdbSNeTEDHIcfJWMXRQPgAUYaLCVKOGB,aDFGLADG.CFHBKCACGABA.FAHHSFDGTAEB.HCDGhAAAIEAH.JHEGMIDEhABARECG.gFABhACAUGAGOEHFBAHAdBAGeGEA.DDCH...hAAAfEFH.hABA...,1,-12,-17,5
BLfIHcJbAgEeGaSMZQNCWVdPYURDTOFXK,eECHSDABMAFHZEGHQFEC.CAFC.VBADdCEF.UAGBDACFFAHFhAAAKEFFBAACLEGBhABAHGDAJDCDAEEH..EEBFNIEB.hADA....WHAGYEAF...hACA......hADA...,2,-19,-16,3
RTAFNaIDMCLeJfUOXPGHScBEgQVKdYZWb,FEADaGHH.DGDDLDFB.eEAFUEEGODCHGABHHBCEBHFGQAAChACAdAACZCGDRCCC.ABGDICHGhADA.CHEDfAEHhAEASGBH.gEDHKHGC.hACAYHAG..hAHA..WAEE,2,-32,-8,24
IWQcRKEFLDHYOPSNJaBUTeMgdZCbfVXAG,GBBFQDAFKCHFLBAFHABGODFDSFDFaAFGBFDCUFGChAAAMEIBdAFDZGBG.fBGBhAAAAGCB.IHFGhABAcEBBFGEBDEDA........hABA......hACA...,2,-27,-6,21
UDXPVYNMRaFTgIJBLHdSQbGWeOfACKZcE,ZAFHEAEDUDCBDGIF....VBDFMCAEFHAC..IFAGLEFChAAAdEHCQCADhABAGGDBeHAGAFGAKACC..PAAGhAFARFBCaGGF.JDFHBBBESCGC..hAGA......hAHA...,2,-17,-16,1
dSbXBaEVgNKWcAMGeQDfCHYTIFPOUJZLR,eGEADFCCCHCC.HFAC.TADFFCBGUEEG..ZBBHLHEGSAHDhAAABFAGaHDC.VDFChABAKCGAAGCEMCAH.fEEGhACA.IHHHOBEGdAAFEBFF.NADH.hAIA......hBBA.WFHB.,1,16,-45,61
AYLKPeNgRUTIQVBbEDJZCafMHOFWdGScX,LGFGeBEBRDAB.TBCCQABF.BFFFDBAHCEHGMHCGHCEHOHAChAAAdGCFSBHDhAAA.AICEKDABPAGDhACANIEB.IEDGEAFCJFAH.fHGF.hABA..FEGA...hACA...,2,-14,-12,2
cdaSPWbQBfYEOZGUFKgXAHVJCLNITeMDR,JACBLCCH.TCEDDFCDdAEF..SFBG..PHCChAAAbEEABCHEEDDFOCAHhABAZABAFGEGKHBA.AIFCCHHDhAAAIFGHeAFEcCAFaAHH...WEADhACAfFDH.YFHBhACA,2,-42,-19,23
BFbZVNgdAOKLPEHfMaceJUSDGCRIYXWQT,KCCAEAFHHGDEMFHD.eDFHUEBCGBCC.CEADRAAHXEEG.QBFChAAABCHEbDGDNECAADHCOABAhAFA.LHBAhAGA.aAHFSADBDGGFIBBA.hAAA......hACA...,2,-15,-11,4
eIUPgAdNBbFSMWcJLXKRGCaEDHfYOZQTV,BCBGFHGGMEAEJHFG.LBFB..KDEGCADH.EDHFDIDCHGBA.OAABhABATCDC.eAHBhAAAUAEHAEHD.dDDC.SBGHhACAXBAFGFCBaAHFZFFG.IGAHhABA......hACA...,1,-17,-27,10
GTUaLgcKYHFPMWQVJbSOfCdeRANZBIDXE,BDFDXBDEGFBHUGAELCAB.KAHDHEGDMCCCQCAChAAA.JAHHOAAGhAEAfGCHCHGHdEHEACIBNEFEDFAChABAaGAC...YADEWEEG..SHDAhAFA...hACA...,2,-24,-21,3
NEDRQcMFdXWKaOBYVUPfgJZIebLGATCHS,CFGFSHAEDBHH.QCCHFABC.dBGAXFDAKEHDBHHBUCDGhAAA..PAEFhAAAJFBBZAFDIBAC.hADALFFFACIH.TEABNEAAEGHB.MAIHaHEE.hAEA......hAFA...,2,-38,-12,26
FJfMScXZILOTaCAdUbEgDBRWNVKYPGHeQ,UBFDEFCHBAHBREBF....VEECKGGCGBEHHAAE.eDCAFDCAMDADhAAASDAC.ZFEHhAAAIHADOACFaDHHhABAAACGdHEHDCAE..NCIA.PEAF....hACA......hAEA...,2,-18,-18,0
bUFNdXYPJZaVMSKeICgEDAfLWTQcHROBG,LDEDQCBDRGFGGBEHFGBGdAEF...XCABJFEBZEFHMCEGhAAASDAD.IHBDhAAACEDHDABDACAH...TDGAhABAODHHBAHGNAIA.aABE.KDCD...hACA......hADA...,1,-8,-30,22
BQPaIXSZDHWJAFTeMNLbOEcfVCRGdKUgY,eDBGMEAALDGDEAAA..VGAGCCAEdAGFUCFGBHHB..aAFEXECEhAAADDABHFDAACIHFCDGhABATACH..NHCH..hAAA..OFABcGFDRABC......hAEA......hAFA...,1,-14,-22,8
XWDUFAgCbfTJdKVcaRQOGZeEMSILYBPNH,CGDBTFABdDCH..KGGGaFFE..RAFEGBBDZDCCMBAHLFAHBBDCHGDEhAAADFDA.ADDE..fAFGhABAJAAE.QCFBhACAEGCB.SHAGPCFF.NDIG.WHFGhAAAFBBB.....hADA...,2,-27,-10,17
HcgeGBfbLRPIUTZNCFYXOJSQaKDMAdEWV,dBGEECFBHDAAeFFDGDBABAGELCHHRBDG.UBAFTEGHCGGCFEECOABHhAAA..SGCEhAAAaFAHDACAMAIFABGB.hABA...WHDG...cFACfDDEhAFAIHHB..hACA...,1,-9,-28,19
BHWJeZdGKVYFfNUSQTLADPMcaCIbXgROE,MCBACFBH..XGECOAFFHDGD.JAACZBEFGFAFKAFCFDABUDDBhADATCCDAEAG.DDHFaGGChAEA....IBBDhAAA...gFFEBHAFWHCA.hABA.dHBH.fAHAhACA.,1,-17,-37,20
fbMgFHNVCTQdKcaDSOUJZeAYPBIWXGLRE,BBCFXCGBLAFFRACA.ECHBMHBAHGCACFCD.dECF.KEGBDFAHSBABhAAAOGFEZAAHAAIH..hACA.ICEBGEACfGHAhABAFEEF..NIEB.....hADA......hAFA...,1,-12,-29,17
HLUWgQPacGNVJFKAISODEfCYdeTXbRMZB,SCGADGCDEBFD.CFFG.eAFG..TBDGXEDB.MDIHhAAABAFCLFFHUBBEQGBGhAAAPABFaBDBNEHAFGEHhABAABAH.ODAHdEAH.......hABA......hADA...,2,-24,-22,2
EXTVYLZIFcKbCAMSUgPHNJOGWQDBedfaR,UAAFHAFCJEGDGGDFDBAH.BFDD.dHAHaGDERAEB...EDBA..TDBEhABALFABZBGF.FBCAhAAAKEEGAEEESFCChABA...NEIE.WDAD...fBDEhADA...hACA...,1,-25,-29,4
ZNPMCRUOAXbFfVgeBcLaWHEKYTdISGQJD,XAEGFADH..VFBABFHCLBADHDAFKCGDdFGAGEEADIFGZBFDhAAAPBAC.CDDEOHAAhAAAfCCG.eEEBhABAaAGA.EBHHIHHB..SEHBhACA.NIABMAFGhAEAAABC...,1,-10,-17,7
ZTIKJNEQAWLbSVgCaBXRGDcPeUMfdHOYF,LADBSBCGVFBCCFDA..BFBCGBFADHBG.eBABUFGAMFHBhAAAHAGBFAGAZAAF.KDFFEHEGhABAADAF...bBBBaACA.hACA.cEEH.dFAC..YHEAhAFA.IDDDNDIA.hAFA...,1,5,-29,34
RQACGbTZKfUNBeYWVSLOaJXcdDHgPFIEM,CDGATEGEZDAF..UACFeFDE...VCAFSFFCLAGDOHCEhAAAXACH.DBAChAAAHAFEFDDAMFAHADDHKHGEBGDChABAaHCC..cFCC.....hADA......hAFA...,2,-39,-4,35
VeNfgPJEYRUWdcTbKXQGHaLMSOCFBDZIA,VAEGeEAB....fCBBJDAC.REEFdGHGTDFD.KFGBXBEFhAAAHEDFLHDAhAAAOHAEBEHFDABGACBANBIGECGChABA...YEDD.cCACbEAGaHAGhAEA.SBBEhAHACAHCFABE...,2,-17,0,17
IOZEKFXeQbaVHAYCfPMTBNgRDLWSJdcUG,CDFBMEFABBGGRDAE.LABB..SGCGdFFDUFCFGADEhAAAOACHKFFGFHEE.XBFAhAAAeFAB.aGABACIB.fGHChABA.NADFDBIBWDAG...IAHHhADAEEDH....hAFA...,2,-34,-14,20
VOWZBFDcfPGENbSAIQgTeCMJUKHRLYaXd,QCBCeFCAMDBDUBCGHEECLAGD.XFBDdHFDOHBChAAABDEADEAHfADBhAAAPBHF.EACDSABDhACAIHGFCFADJEHFYHCGaECG.WBAFhABA.FAHDNADDADFE...hAFA...,1,-7,-15,8
PXGVgNUcdbQKEBLTSfYHOeJRAWIDMFaZC,DDDDaECGZBFECDGG..GBAC..NIEBUFGEdAAFQEEG.hAAABBGGTFAC.SBBDhABAfHGBOACChACAeAHBJFAHAGDBIFEAPEHD..XAEBhADA....hAIA...,2,-29,-27,2
WbCAJdfYLBPaZUQXGcgKMFISOVTERDeNH,JDHDdCHALFFCBEEH.aECHQEAF.GGBFKEDHIHHGhAAAODCG..ECAADBGAhABAeACCHABB.CHDBfEAEhADAPBEE.ZADBcAABMIAGSGGFhAGA...hAAA...,2,-30,-10,20
aTNPSVKJdbYXWgZMLHUOCRQAIFBfeGDEc,BHAFeEECGGDBDCCA.EAAFaADG..TEBCSEDH.KEHFhAAAJAEA.dCBB.YCHHhAAAXCAD.gBGEhABAMIBG.HCDCCDAGAIHC.IHDCcCDD.hACAPFFH.WFBHhACA...,2,-45,-3,42
XNbESRdcKVDYLBHZFeWTAQICGUfJPOMga,QCGDGEEHUGBCJABCOAAF..MCCEaCEE...bAFESAGAhAAA.dDCGhACAVEEDDAEFBHEDFEAGTGCFhAAACDHD..fACCXGABEGHDKGHD.hAFA......hAGA...,1,-12,-27,15
JgeIKGNMcdOVAPSCDTbFEYaBRQUHfXWZL,CDGADAGFFBCEECCE..BEHHQFFBHGAG...XCEHZFDBLEAEhAAAeFACKBADMFGBdHADhAAAOAGHADGASAEFhABA..YABDaHECfBHE.hADAWFHHIHHA.hACA...,2,-26,-25,1
dPDBHMLXEaeJcZNIVfGFKSgTUQCRAbOYW,OAEDdFDBDBAFHCBELFEEEEGC.eAHBZGEE...IAAFVAGH.hAAAFCAEKDEA..SDEAhACAUFAFCBEDAIHC.WHDEhADAMIAE..aEBD.NEAA.......hAEA......hAGA...,2,-27,-18,9
dDfVKIcBQERXJCAZSNeMGUWgOLPYbHaTF,SDFBMDGHUDBC.ODADLBED....PHDCHGCGaABEhAAAFBHDdABDDEAHfBGEhABAKECGBHADEGGEXGADhACAADCEZFCEGBCH..WFGHYAEChAAA......hACA...,1,-13,-17,4
MRQGcYTFbAWeUIEdKCDHfPXZOgLVNBJSa,eCGDUFDAEGABCCDD.HACH..XFGGZAFDLAAHBAHFJFAEMECBhACARAAG.QGGBhAEAGGBD.TDGEAFFBdDABDIFChAAA.OACANICFSCDH....hAFA....aEEB.hAIA...,2,-18,-2,16
FEgDZCUMWeBPRTcQdHYOfGbKaXILANSJV,JHFCFBGDEEFGZCCE...MBIHBGDE.RAAE.QAEBHEEE.ODCHhAAAGDAEKFFDaCGHLBAAhABAAGAH.SHGAhACADAECCHCC.eHAC...PDAH.hAAA..dEDAbAEE.NAIE.hACA...,2,-27,2,29
gEcAfaBdMPGUYLJVSHbCFQReKNZDXWOTI,aADABDEC.dBFDGDBBUEBBLHFESGDCHABFCHGG..RCGHKACDhAAADEGEOFEG..hAAAIAHCEGBFAIDGMAFEhABAPCDG.JBAD.FGAG.NEIE.....hABA....WDAFhADAcFFA.,1,-23,-25,2
fMBeNWbKHISZXRQgLYcPJGUVEdCAOaFDT,FCDHDCFBMEAEBEBH..eFDB....bBDFIEFEZABD.QGBDhAAALGBGPAHBhAAAJABCGBEDEFGDCBABAIGEaFHHhAEA..NDIGKHFASGAF...hABA......hAEA...,1,-22,-25,3
BLeMfHgGdVAIUcSOWKNEQbZFCTXYRJPaD,UCDHOFAEKGGH..QAAGFGBG.CHAF.TEFBRDEE..aBFFhACABDAGMHFGHAAAdBDCAECAhADASGDA.hAEAEAGG...bEBE....YDHBhAFADGIFfAFG.hAGA...,1,-26,-31,5
QfSJaTdHIZFPcgAOYKNLWUMDXCREbBGVe,OFABKAFBLFFEUFGE.DBDDRABE.BGEGGBEA..eABFQCGChAAASAHFJGBEaBAHhABAHEBF.FEAB.PDFGhAAAADDDNIEF..MAEACHHAEGGF.....bADFhABA......hBAA...,1,-10,-20,10
TVbUXeDKFRMfSJgZCGQOaBAdEcNHIPLWY,dEEGECAFHCEELADC..TDCEVCBAUFFAeFGHDHAC.KGEEMICGhAAAJABEZFAACBAG.OBFAhAAABDHAABHF...IHAFhABAWEHB...XEBG.FGCChACASCCC.hAHA...,2,-27,-7,20
VOeBYITKLRbDSFEUXcJNaHCMWgGZAfPQd,QBFCdFGCeCBBBGAA..TDCDLBACDABBSFFDhAAAEAEDXCGCJEHB.aFACMFDFhAAA...WFEFhABA..gACHAHCFfDAEOHBEIAGGhACAKAHH....hADAFCAH.cDGG,1,-10,-33,23
ERHANOMVXWSUTJFBPcdDYgZLfaQCKbIeG,ODHHMHEG..XEBGSECE.JAFHBCCE.dFFDDBBDZAFHhAAAaHAECEDEKACC.eHBEhABAEFEFAIDC...VACDhAAAWAHBUGGB.FGAG....cCEHhBAAYCAF..fCBEhBBA,2,-35,-27,8
CRfKSJDYZIHOANeBcTEPaQMdGFUgVWLXb,eDAGBAFFEEAHQFBGGGEF.FFFCUACH..VCDCLDEFhAAAXABACFCDKHCA.SDCBhABADGABIBGGADAH.hADANIDH.TBGBMCIFWAFEfHAF..hAHA...YFFChAIA..,2,-25,-10,15
aAJXHIMBOcbQLFEeKDNZGVPgYCWTfRSdU,HAEBMCCBBCAGOCCH.QACFLFEAEBGDeAAFDFBBGFEFhAAA.VCGBPABACEEHTGAFhADARFCDdHAHADDB.JBEBcAGAhAIA..bGFE.FAGA.....hBGA......hCBA...,1,5,-14,19
LgIMQRDbAdScUaKVGZPXWYJFNHEBefTOC,dAGFSBBGUAAGKDCFZGDE.....XBEDJDFDFGGH.NCAG.BDDBhADA..eDBE.hAEATGABOFDFCEGGLECAhAAAMDIF.DABEAGCF..aHBE....hAFA.GBDH..hBAAWHEA.,1,-31,-32,1
MXYPOaRBUHQgIVKFAeGZNdEfSCLTWJcDb,GEAHZBADEHCG.CCDALGAA..WCCBDCBDMIBG..XCGEhAAAOAEFaGGEUGGAhABA.QFDEhACA.IADGKACCFFEEABGFeBFFNEEDfAAChAAASFAH....hAFAcBGE.,2,-22,-13,9
BeWIGSdfNPKMELVZaHYXgbURJAFDcCTQO,DFAHTGAAOEEA.BFDFeCFH.GABEdBBF...fFCGhAAAKGGGEHBGZDAHaAFEHAEHhAAAYHFC.bFDH.hABAJDADACEBCGDA..WADCNAIAMCCH....hACA......hADA...,2,-30,3,33
cURCLTBVWMPJSQOaGDfZIKEAYgNXbdHeF,...NDFE.dBEGHDGFeFGFUDBECFABBAAE..MCCCSEEChACAQAAFOCFADHBCfAGAhABAKDAGABHG.XGDDhADAbGAA.FGGHcABD...LEHBhAEAWEAFJADG..hAIAaAGG..,2,-23,-14,9
BFWDNcbRTZUSEIdVPXeafYAHGOCLKgQJM,OAGDKGBGQDEDBADCDEFG....bBCGRAABZFCE..SEBAhAAAEGHDdFAG.XBGChABAaCDE.AFHDCCADJEBCMEIBhACAFGFD...NAEH.....cAEGhAAAIHEH.eFFB.hACA...,2,-33,-14,19
bXQWIHSdEJKALcODeYRfPCVTUMBGNagZF,LBEHDHDGeCEFRBGBCGEAUABD..BABDGDGAaCAD.FHAG..XGGFhAAAQCCFHACBhACAEBGEAFGG..OHAChAEAfFAFTEBGMIDC.NAAA.....hACA......hAEA...,2,-23,-18,5
CZPLdHgSFMWYTXeVGcRQDUfOAJbEaIBKN,JCABEGFFBHCH.KAAFZFBG.dHDHHEAAFCCC.MBCE..TAGFhAAAeECEGCDFRDFF.UAGAhABAAGHEaACECHGA..gCAChACASGADXDGE....hADA.cFGFDCIDfECHhABA,2,-34,-17,17
AdYQKGBVJDObgaSWHMIeRTPCFNfEUXcLZ,dHCBQGFHBGADDDEFOCCB..aHFGSEDCHAEF.MBEEhAAARCGFCEBH.FGAA.NBBC.UAAHhABALDHBABDAKFFG..hABA.JFDD..bDCHIACC...hADA......hAEA...,2,-33,-15,18
OMUcLgeDSNEFVIfaRPXbKJGAYHCBWTZQd,CCDBBCHEZFCH.dFFEUBAHLAEH.DIFESEEA.FGBFICADhAAA.aEGFXGGChAAA.JAHDGCCEhABAAEBC.HGAETAEAMAGB..eDDAhABAEEBB..fABFhAHA..,2,-39,-20,19
OAdLNgXFJHaDRWCbceBIYfGTVEPSMKUQZ,dDCBLCBC.XGCGFHBCHFBG.DGIFCACF.eEFFBDGD..fCAGhAAAVAEE.EBAEhABASFEAKBFC.hACAUDDFZCFCAIFEJEABaFAGWFHDIGGE..hADA..YAADhAEA.PBHD.,1,-9,-20,11
AKWIHTfdNEYQFgXLPMaOSbZJCBUVRDeGc,KCGCHEDDdECFEABCFGEBLAEH.MHFASHAEJAHF.UBBEhAAADCCGeBADGBEGAAGHIDGFhAAA.fFGHhABANADBQGGCPEBFaAGEODHF.hAIACBAG......hBDA...,2,-19,-14,5
ZYPbcOMDCTSgNWUVLHfGdJKBeRFXEQAIa,aGDGZGAC....bCEAOEBB.CCBE.TECH..NDEFUAFGhAAAHBAEdHGHBDCAFGEGEEEGAEBFIADBhAAA.PAFEhABAcACF.MHFGDIAGWFFE..fEHChABA.KAHHhAEA...,2,-40,-7,33
DWBAfNZYXLJFcKVQHROIdTESCebMPaUgG,ZCCFXEAGJBAF.KCGDHGBE.RFFH.OCDDdBFC.EAADCEGB...MIBEhABAUAGAGEGCDEIBBEBHhAAANACELGBE.hABAFAHB.....cADFIHHC.hAFA.SDFDhAGA...,2,-34,-15,19
ROBHWIFAVLEYMdfJCSZPTKNaXDQbGgceU,VBACLFCC.MHFCdHBBCAGCZCEE..KBEDaFAD..DEAFGBBBhAAA.eAEGUGEHBGCHhABAHDGBIEHEAEFAEFBA.hAAAfCAE.SAGENABB.hAIA......hBAA...,2,-34,-10,24
dHfEQZRVWTaDFSgKICNeGBALPcYJUXObM,LDBE..cBFFJFAFOCFB.dGGEfGHGhAAAZAACRAEE.TBAEFHCAKGFDNHABBHFFhABA.AAGCUEDDhACAbCGD.MADH.EEAH.QEGHaCABSECGhABACCEB....hACA...,2,-21,-7,14
YMVgfLbdWCOXaEDcQUJIZTFeSAPBRGHNK,RFDCHBFDKFBC.VEAFLABHdABE..CDEA.OHBEEGHD.DEEC.UBGChAAAJADFZFFH.FHDAAHGG.BAHEhAAA..NDAAMFIFhADAfCHA..XBEGaDDH...hAEA......hAFA...,2,-31,-17,14
TWUONBPAYVXECRfdQLHbGaMegJFSDcZKI,XDAFRFDFdBCGHCFCGFEHMAAB...eGACJFFC.DFCEZEAFKAED..hAAA.TCEEOBDEBDHBhABAAAGE.EAFECEDC.LHCAhACA.aBBE..SAGAIHHA.hADAWFAD....hABA...,1,-1,-34,33
ceHLBNRMGWbCfdDVFQXEgAaIZUTJPSYOK,aCCDUGGE...TEEFSGEE.KABDHDBABBHEMAAEGEAAhAAAbAGF.dEFB.FGDHXBCBhAEAAAHEZCFC.YCHBhAFAeFHHLADERFBACBFH..DIBG...hACA......hBAA...,2,-17,-2,15
CJWBZLgPNQKTcISHVUfbGDEMFRAaeOYdX,eBEGdGBACCEGBHEEZEGDLADC....NFBF.TDCB.IGEFhAAAHAFBUBADfBBBhABADEEGMFGBACABaAHFhACAOBHD..JHBA.WDGF....hBAA......hBHA...,1,-20,-44,24
NgZWIeaEFKHPBdcAGQSTOJDRYUbMXLCVf,SDDHJBDB.RCGD.UEAB.MFDCCDCG..VGAG..NABEZGEEhAAAIDAD.eAFGhAAAEEGGKAHHBFEAAADH.GBBDhABA.TGGEDGDFXGAHfABHhAEA......hAHA...,1,-20,-39,19
KgXELPHAeMIQYBFOTDSGfNJdRZUbcVaWC,eBCFMCGF.QDEHBGBBFAFE.OAFDDCBDGEECJCHH..dEACRABEZCDBhAAAUFFH...bFBDhAAAaAHDKABFEEHF.LFAFhABAAEDFIAHA..SGHHfADBhACA......hAFA...,1,-15,-16,1
XSQDCecYJAPRGgbBKWOLHTMFfZNEVaIdU,REDFGBCBBBHCKBEFLHBE.MFDGFAAEZFGFEAAE....IFHHhACAdFAGSCCFhAAADDGACAHDeDAH...cGGChADAAHDFPCHD..WDDGOAEG..hADAfAEBaGBFXGEHhAIA..,1,-27,-28,1
HaQbcIfYJSPODURFLKGWXENgZTVBAMeCd,eGFGCBCDdAEFHBEFQDCE..IFHAJCFFSBHDDAAFUDAFhABAFBADKDDFGGAB.hACAEEAENGCD...gABBhAAATBGABHHBAEIHaAGB..fHAHhADA.OHEC.hADA.WHFG.,1,-3,-16,13
agPHAOdFWJUKGDIYRZSVELBQMNTbeCfcX,FGFCJAACGECFDGIB..RDEAZACBEEHF.BHCBQCEE.MEBHhADATBAH..CHCHXCCBhAEAaAGH.PAFAhBAAAAHEdFBDKBED.SBHHLHEG.eFADhAAAfCGF..hBEA...,2,-31,-19,12
TRGODPWdgBSHLUVIFEKeAbJZQafNCXYMc,JCBEQCFF.aGHDCHGGMEHD..TBAEREBCGGBHDIAEdFEChAAABBAESECBhABALBEHUBGFICDC.hAAAFFGGKFAFAGBHZADC.XEACYACE..hABAOAHF...hAGA...,2,-29,-1,28
fdIPeVaJUXOZRDTHYBQNWSECKAgGFcbLM,FFDFLABBMIDG.dFFA.eBHHaBDG.UAFDZDAGDHGGHEAF.BHHHQCGAhAAASDEFEGBFKCAAhABAAIEC....cECChAAAbFFG..fAGCPADH...hAEA.JEHB....hAGA...,2,-20,-15,5
OGMcHITLNSRPDQEFfVUYCXaJbWKdAeZgB,eFCDBBDCGEEAMBIFHABCLFACRCDB.DEHBFBFE.UGGBCAHEJBEEKFGChAAA.AAHAZEAD..OAAHhABA..IDGBhABASHCEECAEfFDGXGAHWDAAhACA.dBBA...cCGBhADA.,1,-4,-40,36
AGaSdEQgDBTYbXRPZUecWIJMOLfKVHCFN,aAFGEBGADFCBBHDF....TAAAXCDBZCECUEEHeHFA..IADBhAAAMCDFLEADhAAAKFFECCBH.FFHFABGBdCHEgADEhACA......YCAFhABA.....hAFA...,2,-30,-22,8
CRgdAKYISLDOGVNMfETBUeHZFaPXbWcJQ,KBDCSEDEDAHFGGDFMAEG..EBAFTFCAUGAA..HCBEFABCaHEChAAA..XDFHhAAAbBEG..JGFACFDFdAFAhABAAAIDIDADOCHD.fHBDBEAB..hADA...eCCF.hACA...,2,-15,-9,6
ZLAObJESRQCBMTFDWKVHIUcfagNXPYGde,OFADEGAFRCAB.BHFBMAGFDBBE..KCHDHDECUFFG..aAGC..hAAAXFCAGDCAeBABhABAABBA.bADBSAAFhACATFGC.FCCF.IAEGfCHENICF.hADA......hAHA...,1,-8,-30,22
XAMDFUQfgLIHWZGKROBbdCNYPSJeTaEVc,DHBCUDGGQCEFLBDCHGACZGFEGCBGOABFBEFAdEDFCDAA..hAAAPAAHeGEAEFAAXAGAhABAAAIH..MADChABAfEAE.WHAGKFDG..NIED.SEEDhACA.aBDG.hAHAFEHBICEE.,2,-5,-2,3
KEBPGYScDHZeJfAdCXaRWQFbVLITMUNOg,CDCBXABGREDB.FBDDLEAB.MFFENEAF..KFCDEAGHBGFAhAAA.GAFCSACEhAAADFABeFEFfBAGhABAACCFaDHH.QGGB.bCFGIHHBhACA.OHAC.hAFA.YHCA.,1,-12,-19,7
fbeCGRBdZaIXYOPDScFAJWNLMKUgHQVET,JCGFLAEC.UCCEQFCBEFED..TBFGeADGRFABBGHChAAAdHGBaDDE..IFBDhABAOCCADGFGFDGDABCGMDIFhAAA.KCAD.........hACA......hADA...,1,-21,-37,16
BHdYQAecXbFfaEMPNDJRKVgOISGULWZCT,XGEAFCCFEFDG..MHBCDDFBRABG..KCFFOBFFGACBLEAGhAAACFFBBDAC.dGAF.AHBHeDHHhABA..cAGDhAAAaCCE.JHFGIHHB.SADEhAGAWFAG......hAHA...,1,-22,-30,8
QZSTfJFcUKVHgALWeYPbGORNDIEXaCBdM,eCDE..PFBEOACCRFFEDIAGEGFACEGEdBHC.ZAEF..SEAAhAAAJCAD.FHCCKDDGVBAHhABAAAAGLACF.hACA.bAGFIHEHBDDDMBID.fFEChAEA....hAFA...,1,-16,-31,15
UgQdAeOcDJPRFKVNbGTZSHMWCaIfLEXYB,eEFAOFBHDBDERFGD.KBGG....VAGFGBAGZFEDHCCFMEABCFDFaBEBhAAALHDE.EDCHhAAABBAA.gCAAhABAAGEA.JFDB.FCFHNABFSGBBhAGA.fGGBhAHA.YCCC.,2,-18,-3,15
BecgGbNLRYZafSTAEWKCJUPFdIMHVQDXO,EBFBCFEEUBEGFFGA..dEAHHCBF.DAEGBACA.eFEFGGCDLHAEhAAARAAAZCGD.aBBH.SDDFhABAAHAEKGGE.IAGEhACAMDAH...XGGC.cCGEhAEA.....hAAA...,1,-15,-31,16
IPXBWagFOdSReQYTMUCHfEVKAZGbJNDLc,GBABJBFHLFEG..IGDGBEEE.aEFDOBHHREBA.QBCAhAAAMFADCGHBECHDVGAEhABAAGBBZBEB..DAFE.hAAAXDABWAEEFHFEeABC.....hABAYFHB..hAIA...,1,-12,-28,16
eYMDdBWJSIaFCZVAPXGUQLbETORcHfNKg,XFGGGGDBUDABLDBHEBFF..RDFBHFAHKAFDeHBCDAIBBBDAhAAAJDEA..aBHDFEDFVACDhAAAAACEQBAF.hABA.OEABNEIG.YHFGMAHD...hABASEED.hAEA..CCAF,2,-21,-8,13
WTJQfVNLKHDSGUaYIgeMcOdPREbBFAZXC,CFCFTEGD..JAFAQCAE.VAEFKCDBDICE.SEHDhAAAaHBA..IEDHhAAAMDAH.cGEAhABAOGCEdGACECBFBHHBAFFDZABEfCGHhACA....NDGE..hADA...,2,-44,-22,22
IDVXAdPCbgJfaBKGWNLRYZUHMSceOFQET,CHHFJAEABEEAGDAFLADBZGDA.HBBD.MHBASHAG.hAAAeBBAFGFGQCGChABAEAAEDCHBADDE.PFAEhACA.bAFCaEGH.NDIC........hAGA......hAHA...,1,-16,-25,9
cFWLSENdRDbOTCYGAJQPfIVZXagHBeUMK,QBDH..IAEDXEFCaEGDBAAGMCADKDABFDDHLGBGhABAEBHH.dCGADDCDhAAATGGBCGAAAHHD.fAFBhACAZGCEeBBF.WCBBSAGF..hABANCIA......hACA...,1,-13,-34,21
FcMgaVDdPKBfOIQTJGAYZCREWLXeNUbHS,ZDCACGBFREBG.EABELFHB..eFBBUBEEbBBCFABE...MAAFhABAaEGGdFDC.BAGGOEEGhAEAIGHF.QBEChAAATGFAADIHXCCBNDAGSHDAgGCAhAFADBIF.KAHH.hADA...,1,-16,-17,1
PDGbZQLafMYJKCgRUHEcAVFXTeNOWBSId,FBDCeADDOEDABGCBdFGAGGCBZEBCLAAH..aGBBMICEhACAKDAACAHCUAFBHDGFAIAA.XAAChABA.NFAB.SFEHhAEA.DIGG...fDEHhAGAYADC....hAIA...,1,-18,-29,11
HUAKQOTWFYIPgaGDbVRfBCJcXNEZLdMeS,QEBHOFBCFADA...IFFGaGDEDFIF.RBDDBAHC.CCAD.JDFHhAAA..XAAAhAAAEHBEZBEGMCDFeHDGSFHBhABAAHHBKDBD.WAGD..PABD.hADA......hAEA...,2,-30,-29,1
HJYQGeWAFPRKUTgdMOXEfDLNbacSVZIBC,RCFHTEGEMAFE...EABBDCCELDCC.aGAHSGBEhAAA.ZEGBIBGBhAAABDAGCABFHDDFQFBEhACAeHCAABHFKAEDdDBE.fACHNIDFcEEH...hADA......hAFA...,1,-20,-21,1
IFCGYNUJXVRaAZcLgHKfdQTPWEeBOSbMD,ZGFCLCBCKAHBdCEGTFGG..EADGBADFODDHMAAF.FBFDCHAAGBAChAAAUGAC..JFEFhABARCFGAIFC....cDGGhACAfGBD.QEGFWFAEeAEChAIADFAB.....hBBA...,1,-16,-25,9
CTXLbYWIEBVRJcfMFUOZSGdgaeHDNPKAQ,TCEGLFBB...bBEHIACE.BBADRDCBJAADMEBEFHDGUBGChAAASFADGEGChACAdCHCeEADDGIBPFFGhAAAADBECFFF.XGCB.ECCC.fGEChABA.OBFGhAEA.aHAE.,2,-19,-8,11
ILeYKOEPNBFWQZXfASTGDVbMCdcHUJgRa,SBHHDFIFMDEF.dAAAHGECUEDHRAGHLACBKEHH..OCDGhACAEAEFBGAHFAFEQGFHhADAZBAFACIH.GEAGhAEACFFCgDFEaGDD.IFCG..hAAA......hABA...,1,-15,-22,7
OKLaWZJgUcFSCENGIeVQdXPHbfYMRBATD,DCEEKCEFLDBDZGDCUDEF.FHDC..EHAAGEGC.eBCBVBABdHABhAAAHEGF..bAFCfFAAhAAA.MAFAhABAAADCaDGA..WAEGgFED.CABC.hAGA......hAHA...,2,-20,-19,1
CJQNAZfYbHDSKWPXOVdMaGRTUBELcgeIF,ZEDD..fFBCHEAESHBGKHCGXACDdCDFaHFC.TBAChAAAUFGALFADhAAA.cDDCIFFBhABAJBEA.AHAHDAGHODFGMCHHBBAHEADA..FGHFCABBNAEBhBAA......hBHA...,1,-3,-17,14
PHdDCBRbKcLFgeZQTOESXUGWAMVIYJafN,VFFGJFBH....aDCD..NBIC.dABFDFEBBGHE.KGECFDAFZAFCOHAGhAAA..SHEAhAAAXECBGBABhABAMEAH...YBGHfDHACCFG.bBCGhAEA.....gCEAhAGA,2,-38,-33,5
gRELATNdWZMCXfUGYHOPKBcIDabSVJQFe,dEHCMHDGCGAG.UBDFHBDD.KBGDBFFC.DIFGaGEB....SEAFhAAAJABEeCCBEGFFACBB.hABA.TDGGZFBH.XFADhACAfBAEODEBIEFF..hAAA......hABA...,1,-26,-38,12
IXFeGWLbEMfNYHDRKUaJScCVOAgZdPQBT,ZBCGdFDABBGC..TGCFFACDeBABLCAD.MEFD..hAAANDEDDAFFKCGEaGFD.JDDHhABASHFGCDBD.hACAVFFCAEID..QGAEXGAAWDDGhAAAfAGH.YABGhAFA.,1,-30,-37,7
BDSXGIdTQaPYZWFLCeMJRHKgUVcAENfOb,EGDCOHFABDCBDDHBGBEG..dHAHaHAGZCBELDAHeAECMGCChAAAJBAE.HBFA.KBACgGFAhAAA.UCGAhABAAIDGfDEASECD..XACBhABA.....hACA...,2,-21,-17,4
RZdXYUOfSeLcgIQbPHTEBGWCMVDaNFKAJ,JEGHRFDBdBGC.UBAHOBAA..eFBHLHDG..IGHAhAAAPCECHDCBEEADBCEGhABACEAFMACGDFFA..aAGAFGBHhAAAADBH.XAGE..SGGDhACA......hADA...,1,-19,-31,12
AXHYRNGSWbcBeIFgdPaUMLfJCOKQZTEVD,HCDCRDFAGEABSFGA..bAEFBBAGeHCGgCGBhAAAdAAGaCDDLFHBJHFGKAGATECFhABADBIBAHAH..XBBDhACAWEAH.FGDAMDAFCDAD.OBBG.EGEHhACA......hADA...,2,-13,2,15
MGYcQVKgWEHaJURZebFDNAXSfOdCIBLTP,SFAFdEGFBDDDLAHFMBBC.GAADQDDEKFAA.EHDEHFDDhAAAUBGEeADEDCDGACCFfCEBhABACGEE.IGHBhAGA.YHFAgFBF.JBAFhAAA......hABA...,2,-31,-7,24
WCeXTbdHAfOIEgZYRQaLUBKNJVGDcMSPF,OHDAEABAZFDC.RDFALAAGBEDEKDHB...JFAADAIB...SHDEhAAAFDDHCCAE.eAGFhABAXBEDdBEGHFADAICA.hABAIHHFQAGB.UGGG...hAEA......hAFA...,1,-22,-29,7
FDRYMZbNSdLeAJBVIGWKgPHOCEQXUfTca,BDDFGCEBKBBBHAAH.OGACEAEDUEEFTDCE..aBGGFFFBDIFChAAAMCCG..ZDGHSCADhAAAdDAEAABD.JEHFhACAIGAFPAFACHHD.fFBB.hACA.YFDFNICB.hADA...,2,-38,-4,34
eKAOQNDgGBafIMRTLUZYFWVXJbSEcPCHd,OFEBQDBFDGADBBGCaDFE...MFDHRABDUAGA.FGDCXDAFhAAASAEG.EGGDhAAACHHCeACGAFGG.GDEDhABAfFAGIBBD......hAEA......hAFA...,2,-38,-21,17
BCZfVEFHAdWNSMUJRGQecYLPIaDXObKgT,dABBSFEBJEFB.QDGHeDHFLGBCaBBA.DIAG..XFBChAAAKDCDBEEFfHGFhABAEBFH.AIDEMEAHhACARADH.GCCDPAHBOBEA...hAAA......hAFA...,2,-32,-6,26
QIgKXfFSeRZYMcNJBWdDGHTOEPUCaVLAb,QDBFKCCBFDFH.RBFH.MAEH..NHBDBAAEdHGDDCHF.GFCBhAAAOADFUFAE..CCBEaHGChACAADID...IFEBhADAXBACeDGH.ZFAGcAGA..hABAWAFC....hBAA..EFHH,1,-26,-28,2
CRIPLaWgGNHUVYeSZdKcEJBDFAfTOQbXM,OEEHQDFB.MBFGIBBBLDBD.aBCEGBDH.hAAANABFUGABVEDDYHFAhABAeHFE..SGDDhAAAdHAHcABBEFFEDEADfDBB.hAEA..bDFA..CDDCWDHHhAFA.,1,-11,-13,2
RWEgIGBZMXUeSDOPJaCLcdKbFTfHYVQAN,RBFFEDGCGDGCBCEEZBBFUBCG..DCAHOEED..aEDDLFCFhAAAdGAFKFFG.FFADHAFC.hABA.QCAAhACANAAH.WAFCIHFDMBIH.SBDDhAFA.CEHA.....hAGA...,1,-9,-31,22
dfCePKVbOcDGQZMXTNaYSIAUWFRBLJEgH,FEAGBCEHLEECEDFFdACH.CHAE.KAGB...OBBBGBCE.MGDAhAAA..NICF.SABBhADAAIHCRFAE.JHDGfDHChAAAeAGD...PGFE...hAEAcDCA.DAID.hAFA...,2,-31,-31,0
FYMWgVTILGZSdOfNHCXRBJbQDEKecaPUA,MHEAVEBC.LCFCGBEHdHGDODDFHABCCFFG.BGAE.QEGAhAAADADGeAAB.aDDAAGAGFDHHhABA....YCADhABAWFBH.IAHBfACG.NBEH.XGEBhACA...hAGA...,2,-39,6,45
fJSFdbaNDRUCPIOQeYKgBWcXMHLTEZVAG,JBECSEAE.dBGHaBCHRDGB.UEGH..IGAAODAH.eEDDhAAAKAAEBHAB..hADAXGFHLEEBEEEEhABAAHHGGECCfBBH.FCDCDAIDPADGhACA.....YHAGhAHA,2,-42,-5,37
KcJMPaEBRHeNDQZAFVIXWLdfYGSUbTgOC,VEEBXEBE.dADAGAAD.UCGBbFFH.OFAG.CDCB.JGAChAAA.MAFEEGBHBDAEhAAAeBACDFHDAIGA.FEEHIAGChABAfCEF.SCAAKGHBPHCEaEHFhABA......hACA...,1,-17,-22,5
IVdeZaDfBWHJCPTKLQYMXbUGERgScAOFN,FCDDVEDHZBAF.DHGABEBE.HAADCHEH.KGHDLDFF..MAEGhAAAUFACGBFARACC.hAAASCDCAIAA.hABAIHBDdEGFfAGFPAHF..YDAFhACAXGCFEHEA..hADA...,2,-31,-22,9
PEacFHCZXQeOWIMKfLAbDgJVGRSBUYNdT,DBAEVCGDRBGDBFHH..UGADdCDA.EFFFFEFFZAAD...QAFGhAAAeAEC.OCEHhADAIFDGKFDFAGIF.JCCBSGBGhAAA...TDAEaEAFCHGG.MHFEhABA.....hAEA...,2,-39,-15,24
OWXGMbBKREJLfUSQACTaPYHFdDIVcgZeN,CHEDTDAH..aDAGHFCHdBBD.DAFA.VFGBZAGDOECA.GEGGhAAAMBGFBBHHREAGLACChABASDEDAFFDFGAF.hAGAIHBA.gAAC.eADHhAAA.....hBAA...,2,-21,-12,9
NSVBfbUXacODCAMFgTdZWRKLJPYIHeGQE,MFAGFGBDdCEARGAG.KDADLCEE..JCAC..IHFDGEGCEHDGhAAASDDG.hABAfBAFbEDC.hACAXEFDOAGHAHAFgAGE.WAAEhAEAYABG..hAFAeEHB.,2,-33,-24,9
cKTEXIRHNDGBFWCQbfVSOaUeJPdAZgMLY,MFAFLCDAKFCE.TAGF..EBAHRGFCDBBFBHFE.FHCACEEGQDGDhAAA.VEABhABAaBEFeBGF.dFGBACIDZACChADAcABF.XCCENIAB..WECHhAEAbEAB......hAFA...,2,-25,-15,10
UGaEIAVPRdFMWBQJZLHXYTbfSKDCNceOg,RFBEFEAEBCCEZBGFHAEF..TAAASGHBCGFH.eEDHOAGBhAAAUABFEDEBAAEHdFFA.MIDChAAA..WEHDQGAGhACAJACCLAHH......hAFA......hCAA...,2,-34,-6,28
IXUWeLBOGTaJfKcQEDZNgRCFdAHMSYbVP,SCDGVAFF..XCBEeECHLEEFBEFAGEDGaHFEKDAChAAAQABCDBIDZAEERFFACABAhABAAFACMDHD.PHAGhAAAWFAD.OFHD.fEBBECFE.hADA..NAIA....hAEA...,2,-17,-4,13
YSEJNKQGeOdAVHCaTgDFIUbLPXZMWRBcf,CCBBTEFHDDEC..UGGFLFAD.ZCDGREEHBEHE..fFCFhAAAEBGD.KGHFeDABhAAAAEHEaHDAFECE..IABHhADAXABAcAEESHAE..hABA......hACA...,2,-44,-23,21
NIDeFYBTfgXGSWdRCaMOKbEQVHJcZUPLA,DFGHFCBEBHAF..TCBA..XCEBGBEESEBDhAAAREGHCADD.MEAFOEDChAAAEHBEQABDhABAHGDEJAFCUEAFAADCNEEGYDHB..fABChABA.dDGFKECBhAFA...,1,-19,-22,3
SJTAUPBLQWCOKHdbIXNgaFeMERGZcYDVf,BFHDQAEACBDCHCEHdCCE...XGBFNABH.aEEBeAGDMCAHhAAAGCBCZDFB.DDIFfHGFhABASGFG.hACAAEGHLHAGKCBDIEHDEAAD...YAHHhADA....hAEA...,2,-19,-17,2
XcDOWBSQHbKPNReVCFLdgEGZUYIaMAJfT,JHFCTABD..DGAFBHHEHFBEKDGERBCA.eDCBFEDG.LBEG.hAAAEEGDGBFEZFAB.IEHGhABAAEFFXDDFOCBHhACA..SAFC..PHCChADANDACdAAC.YAFChAEAMICA.WFFG.,2,-18,-4,14
RVESbWOXUKYeDgcfBMIACFPGdLZJHaTQN,FEHHdBCDLFADZDDGHACGQFDHRFED.EDAESBAHhAAA.bDFEWFFH.UAGGhAAAeDDCDFABfHCFhABAMDCAAHHCCGBF.JFBGaABGNAEB..XGGD.hAFA......hBAA..KBHF,2,-11,-1,10
MCDENgXQUBJfVHdPbLSAaKIeZYFTORcWG,aBEFKEEGeCEEZEFD.FAAARFAFGCCG.DHCEEGGH...XEBHhADAUAGABHHBJAFGHCCDhAEAdCADLAAEAFHE..hAEAIHEA.OBHFMDIDCBBF...hAFA......hBAA...,1,-18,-25,7
bcRAYJCTeGNLFWgaBZPEdOfUIKSMQHXVD,JCGDTBBFGAAB.LFFAFDDB..aCFCBFBFEFFE.dCDFUAGEhAAAKGCG.SEHBhABAMIEAQAGDXFAFDEAAhAAARGEEAEAGCGAD.eADE...NIBD.WHFE..hABA......hADA...,2,-27,-3,24
EPgJZXOBGcASTHRbWFdeQfNCKLDaVYIMU,TBACHCCDRAEBFFHF.dHEDQEBH.CEFADEHFaGBE..IFEFhAAAMDCCEAGG.PHDEhAAAJDABZBGH.BBBGAADHSAEBhABA.eCHB.fGHAhACAKACC.....hABA...,1,-9,-26,17
ATJLYXgCDOVWNQHUBMKcFeaSZREbGfdIP,JDDBXEBE.DIBCODHF..VAEAQAEBBAADMCAAhABAKCACFHBA..SGGGhACAEFAA.fGDFhADAdAHAAHGCLHFACDDEHCGB..cABFhAAAaHAG...ZFEE..hADA...,2,-25,-20,5
KfcPeJYZEXDaMdHFLTUQCgNIAOBRGWSVb,OADERAADGCGE..VFFCKEDC....fEBGeCABJDCEEDFAhAAADAFAdACD.LFDAhAAAUGCGCHAC...ICDAhADAABCBSAGE..PHBC.ZAFGhCAAaABG.MIFA..hAEA..FGHD,2,-28,-3,25
gOHZBXfRADNGCSMUYdELVeWPIQaTFKJcb,DDEAGGABCGFF.MFAGdAGBLBAGeDGF..IAGHQFBChAAAaBBHKADE..bDAGOFHFhAAABEGA...fFEEhABAAIGGNEIA.SDECEHDG..hACA......hAIA...,2,-32,-25,7
KcHQMfYLZNIgFEBJdGVbTDUSXReaAOWCP,CGHCKBDGHBDEMFEELAAFZGBE...IAFCEEACdADFGAGAhAAA..VFEBDDDHUBABhABAXDBAaHGEAAIFWAGHhACA....cGED..YCHBhADA.NEACBBCF.hACA...,1,-13,-25,12
QOEabCTWRgecSXDdZUFKGPNBLVMAYJfHI,JCAHHGBC.QDFHODCG.aBCFCBGE.TBAERGFE..eFCGSBFAhAAADGCDZAACKEECPADAhABA.BGHGMIDEAGFBIEDAhACA.WAHH.XGFDhAHAFDHFLAFC...hBAA...,2,-27,-9,18
PagOGDQBVWLbXTdNRfeCZMAEYSUcJIHKF,EBCASBACUBGH...JFHFKCDB.aFCCGBCH.BGFFVGFGhAAALFAD.XDDChAAANABERFAD.CGBBAHDFIHDEhACAFDAGOFDFDFFC.bCFAdDFH....hADA......hAEA...,2,-25,-15,10
SaPRcUgKJNbMdfTIDZQHeGWVLXBAYOCEF,CADHEBFDFBFE..aECBREFF.UAAG..JDDFMHEA..dAAF..fEGFhADADCCFZCFGHGAAhADAeADC...WAHFhBAALHEABFEAACIDSAFCcEDB.NBBC.ICDFhBCA...hAIA...,2,-33,-20,13
GHeDcgLMPQFaRYEXUCTISAVBWbJfOZdNK,BEBCJCACZEEEdEDE.KFFGHGCE.DCEBLFHB.QAEBhAAAFAFEaEBA.EBHDCADD.TBBDhABAAFCD...bGCCfAADhACA.OFABNDDHeFABMCID.hACA......hADA...,1,-19,-33,14
fIAUHJagXPYBNbCDRKTZWMEeQSOLcGFVd,UAEEJBAG...XEBEBCHFCHHG..RBDF.KABEZDAF..EFFD.SHGAhAAAOHAGGDFAhAAAdHCDABHGHCGB.PBBBhAHANDIG..DEAF..MDDAeFED..hABA......hACA...,1,-15,-36,21
QXfVGLYWAdHaZUNTCDReSIEFcbgOPMJBK,dGCDaEECZCGHUCAD..CHBE.DEEC.RFFB.eDCC.EBDCFBGD....hAAAbGDG..gBCBhABAPABG.BFCEKAFCXGGBhAAA.fBBGLFAHAEIFNAIC.hBAASAHB.hBHA...,2,-37,-21,16
VHJWcTKNQMDbagELOIPUXGfFBSYRCZedA,JHAATBEH..KGGFQAGBDCGG.aDGFLACE.OECAhAAAPACDGBAGhABABGEESBAHhAAACFGE.ZFAEADFCHFCEWEACMEIBEAGAIHEBhAGAfHGBFCCA.YHAGhABA.dEED,2,-26,3,29
gCMGAPLJIaQDVSUXONEFdZTBWYKcfRHeb,LFEEaFDC.QBAEDEDGSACGOBFBFHCGdCHGBCFBKFACRGDAhAAAHBAA.eFABCHHFAABG.hADAIGGEUGADXDBEhAEAZCGD..WAEE...fDAEhAAA.MFIF.hAFA...,2,-19,-14,5
VbOCWKcaEYSNHUTAQXfdgeBFDMILZJRGP,QEGHdCBBeDFHBGHCDDEHLBFFRECB.GACGVAEF.OHCChAAACADC.KGAAEAHBSHGGhABAUGAFAABF.fEABhACAMCAB.ZAGDJHEA......hAAA..WGCE.aBBBhAEA...,1,-16,-22,6
MJagEeROXbVZYGPCfBLDHAWcQdSIKNTUF,QADBSGAHKEAFUCBB.FFDHMEIH..aGAHEACD.RCEAOFFBhAAAVFGF.GECChABAPBFFCAHDBCHB.DCCBhADAACHDdAAFIBEGTEEE...eEAB.hAEA......hAFA...,1,-9,-19,10
KUVXSNJLTQEeWPcBMGIZdfFCHOYADgbRa,DFDHRBDDKGFHUCEC..SFBHLAHBEGHD..eDDD..hAAAPEBHBDBFMIAAhABAGCADIBBCdHEDfACHhAAAFBGGCHHDHDGFAAFFaFFBNDAA......hABA......hACA...,2,-26,-19,7
CFHZPbJDSdYUefKNMVagRBGQcTIOWAXEL,LDACHBFFZAACJEEHDECDdBBF.UEGFeFAC.KBHBMDFG..aEHHhABAREDFBEAHQCABhACA..IHHBhAAAAAHCEHBECAEBFGGHSHAC.fAGEhABA.NICH.....hACA...,2,-35,-11,24
TWUcDJFOYVMPELCNAfRZeGSdgQIXbKHBa,RAECeCHBdBBC.QDBA..bFGHKAEGBEDGaGHFUGCGDEAEFCGFOHEGhAAA..VFAFhAAAMCBELADFAHAEZDEHSBAChABAXFED.....WDAD.hABA......hACA...,2,-28,-8,20
QScVWgZNBYIMfOPGFEKXaJbDdURTALCHe,LBGFHEDBQBGFSCDDVBABZADFBFFBMBIBOFBF.hAAAFGAHKBAB.XFCDhABAJDHBDDEA.UGGDAAAGCAFC.cGAGhACA...NFEH...IHHBhACAfDBC....hAFA...,2,-21,-15,6
MYAHNOeULbDTaQCWEZISFfVRBPXGgdcKJ,HEAFODGHLBCDDCCB.TFFACFHAZFAE.FHCGRBDF.BFHBGGCBdDGHKEDAhAAA.MAEHAAEEeBFEhAAAaAHF.EDAH..IHHBhABASABC....fCAChACA.PAFH.hAGA...,1,0,-32,32
GSJAcBYeZOTaRVCfWdHEbKPUIXgQDLNMF,BFEFZGAAaDEHCCDH..dGGFECBH..KACDUGGB....IAAEhADAQBGCLAGDhAEAMBCCFECDSHBGhAFAAIEE.eEBA.OAHF..TEGGhAAAfHED.WBEBhCAA...,2,-48,-26,22
WVCedPTGFcaQJBEZXOMSNgfDLYURbAIKH,HGAACDGCdCBFGEBBFDGEaBBH.BHFCZFGF..OFEHMIAA...SADDhAAA..fCEChAAADEAALBFEhABARACGIAHBKDDDeCFFTFGG.JGAC.NBAG.hABA......hACA...,1,-11,-30,19
dYKFANJcHRLUgTbIQWMfZGDXSCeVPOEaB,JCGFHDAELFFBUGAD..TABBQAEBMAFHZGFADIACSCCGhAAACBGH.eHBEhABAPDGBEACB.BCDAKFDAAECFhADANIDB............hAFA......hAHA...,2,-27,-21,6
RTEPOSaLUIQBfNJeWVKcCbYFdgDMXZAHG,HFFAGCDDEGCDOCBBaBEA.LHAGUDFHBABDJHEA...eAHDhAAAKAEACEEDFFADDAACMADDAEGG.hADATCAC.SEDFhACAIFGGNGAD.......WCHBhAEA.....hAEA...,1,-15,-30,15
INbTfQceZVROJEDAaGLBHUKXWdFYgMSCP,LHDEBGGEUEADKFAFdEEFFBEG..MDDFCFFD.....IAADhACAbDEC..fACAhAAAQADFZBAHOCHDhAEAEHAADCGEAHAGaCBB.HGDAWDCB...hAGA.SBGFhAHA..NAEB,2,-37,-30,7
MLRZAFePGaHJBTINEcODfbXKgCQVdWSYU,eAFBaFCCBBBH..ICCEEBDE.OHACDEFE..XDDFhAAAKFEDCCHAdHFDSGAFhABA.MHBE.ZFFEhACAFEBHHDAENEIEfCEGQAFFYAABhAAA.....hADA...,2,-27,-19,8
CJQMPWBOaEXbZRgGNYdeKfUDVTASIHcFL,SBFDHDEGFGCEJFHDMDIF..BFBHaEAE.EBCBZEFF.GGABhAAAdBHAKAECDDED.AFFDICCChABACAAE..QCADhACAOBGFXADFRBECNIAF..eFFBfCAGhACA...hADA...,1,-12,-19,7
aJXCEVKDHAIPWLZfMUdSTYbNcFQOegRBG,..ICAALFFCZCGBMEFC.dEAGSCCDTBFD...hAAANAGA.QBBDhABA.eECHBHBGaHGCCHHDEFDBhAAAKADHAHDHPAEHfAHGYEFF.FFAAhABA......hACA...,2,-34,-10,24
gZVPGSHAbWJdCYIFaDMOBfRETKLNcXQUe,JBBFCFEHFAFG..DDHFBECA..EBHDLDBF..NAEF.QCEBhAAAeGFEZACAGGBBhAAAAIFEdACC..aBABMBGBhABAOFHBRDDBKDAD..XDGE...hADA......hBAA...,1,-21,-35,14
MZbXgaBcVEURFQLCDHYKTfSdOJPINWeGA,MEBAXAFHBGCB..EACCFHAALAAFDEGDHACEKCCH..SAEEhAAAJGDE..PFAFhACAICAHeEFCAHGDZCFAhABAaDFG....cECD....hAFA......hAHA...,2,-36,-25,11
fAMJcaPSHXKEZgbeBICVFTGNOQWULDYRd,JFFAaEDHHBBB.KFGHECECZBFC..eAFEBAACCHHG.FFAEGEAE.hACAQBCCLHBEDAEChADAdHCBAAEFMBEF.SFFDhAHAXDGAIBAB...hAIA......hBBA...,1,-22,-24,2
JWFgbSYBXLUNGVOAKQeRdIDaZEMTCfPHc,eEHBRGFAdDEHDACFEBGC..MFAB..CFDCHAEGJDAE.FAAH..SGDFhAAABHDG.XEDAhABALDAE.UFADhABANBCHOCCAAIBCKEGG.IHGH.aCGEfBHChADA...hACA...,1,-28,-30,2
ZdQfTNbPcMHICKSYEDRXGVAFgWOeJUaBL,FEHFOFGDUGFBBBEEZAFE.dEDD..QCAC..TCAChAAA..bABAMGDGhABACHABSCGAEGAHDBBG.hACAGDDAAAFEeCEAaHCCfAGHPFAC.IHEEhADA.KCHB.hAAAXEAA.,1,-9,-23,14
ZCbVMQdEcgNWSXIPfGOaRLUYKJTeDBAHF,FFFHZCDBCHHCMBHH..dHCHEFBC....NADH.SGCA.hAAAICACfBADhABAaAEBLBBBKFFCeDBFACGEhACAbDDE...cAFBXAGE..OHFEhAAA....hABAYDHHDIBA,1,-25,-36,11
PWRCXaMBHGbTIAOeYfZUEKQVNgdScLDFJ,eEFGZDCAEABCKBAC..QAEF..NFADSGGAhAAALGFEDDGEFBHHPBAHRGAGCBEA.hABAMHAGBDAG.HCCAhACAbFDDAIBEOGDG..YFAE..hAAA.fCCBhABA...,1,-20,-22,2
dYMADeOPfcZKQLHgNXISUCaFJRTVbWGEB,DAHDOFEC....PGBCZDDGKACEHACBXAEDUEFHaDEBFAHH.hAAA.RCBC...TEAFhAAAVGBE...WABFhAEABEBD.MIFEAHHBeHDAfBAH..hABAQAEA.hAGANAIC.CGHH..,1,-13,-26,13
gJaeZLIKCUFMbcGBSVRPAQWXEYHDfNOdT,QCABXBEGHFDFDAEB..OFAFdDADTGGH..aEFEZAGHhAAAIAHGCBBEFDFDbFBFGAFGhAAA.VDCEAABE.hADAEHDEYFAF..fFHChABA.gABChAFA...,2,-21,-3,18
gASdbDILGZHKFUOPBTRYXJcNQMVCaeWEf,SDDCdFCADEBGLADGHBAAFBEEUEFEBHHB.RFAF.JCCE..QGEAhAAAMIEE.aFFAhABAEAHFAFED...IABGhAAAKDADPDFE.XAGBNEAC..CEEG.hAEA.WFHB...hACA...,1,-17,-32,15
VAagcZUNeJKRYLDQCFPWXbHdTBISEOfGM,aBDAZCGDeGBG.KBCGLAAB.CFGFFBGCXGEHdFDGBCDCEDDCGAEBhAAAAGIB.UDABhABAJFADDIEAQGGEhACA..bDEFIHAEODAE.fDFAhADA....MACAhAGA..,2,-31,-13,18
VSXeCdDYKfJZTRMWQNbEIUBLFAOHaPGcg,aFGEGABG..VFAHeBDG.CEHBDEECKDGDZDCGRFDA...MAEAQBGGhAAAEBBE.UGAFhABALHFAFGHFAFBGOAEGhADAcBDD...SHFGXCAC.dDDGfHCHhAAA..hABA...,2,-30,-5,25
SDbJaFRKdQGcMXHENLIgOTfUBWYZVAePC,CFHCDAIH..aGABFHCA.KBCAdGDBGEAB..MAADEEEG.LEDAhABAOADG.TCDABABDZDGHhAAAABBBSHEAhACA.RAFCXDAAIBGBfCAGhACA......hAHA...,1,-19,-39,20
DcXNLWJRQMGBFedUTaCEIAbOgYZKSVfPH,OFBBZDGBKFAC...VDFAHBCF.DGAB..XADELGCEJHCAhAAAMADABCAFFDFDeDDFhABAdABAaBEE..CFHAEBBGhACAAEBC.....gAGGfGHAcGGHhADANIBH...WEAFhAEA..,1,-17,-31,14
OLUPNHfTVgeJZADQaGcSYFERbBdMWKICX,QFEEGDBBSAFCECBHBDDBMIACKABG.CDHCLCFBUBGCHEBGhAAAVAABeEAD.AHEBDIAEhABAaGGDFADHdGGE..XCEFhADAOFDCNHCB.fEAG...hAEA......hAFA...,2,-11,-1,10
aCbWIgLOBZDYXTeMKQURSFEVGfdHNAJPc,JBFEaCDH...CEGB...bAEF....IEEBOHFAZBGHDEDD.hAAATAADKDAG.UGCDhAAASHAGEEBE.GBAHhABAdCAHAFGGWFFABGFE..eHDEMAIBFFAG.hACAfADH.hADANDIE...,2,-34,-12,22
WIPdACQXENUfgbYFcRVZLBeSJTGKHOMaD,XFBEUFAC....fCGH..gFEEhAAAFFGGVBBELEEHhAAABCBGJBBATAFFKDAAMIEADIBEhABAIAGEAEHEEEACbCFC..cADAeHFASAHHhACA..hADAOEDH.,1,-11,-17,6
XKNAgMOTWRfCQPdSBJVDaIFYbZGEcLeUH,OFADTFDF.RFFH.QACEdCDFBFEF.DCGCFABDZCAF.GCDFLAEEhAAAeHFEUDAFHGAGKDGGhABAABAEMFFC.CAEH.SCGChADAaAGC.IHHB...hAAA......hABA...,2,-27,-3,24
AFcMPLaXYgBeCGHKIdOWSfUENTbVRZJQD,FGBBMCAFLDHF..XBFHBEFBeEDFGEFCKBFDdCBBOGAAhAAA.SBDAhABAEADCTAGGbABD.ZEDFDCAFhAAAAIHG.aGDDCBHAIHAA.fDHChADA.....hABA...,2,-33,-2,31
PWgXAMbOcCSGURTVZLeaNDdYJIQEHfKBF,MABAOAHD..CHHBGBBGUDEARFCDZCBDLHAA.eCHDaBBBDHAEhAAAdEECJFFA..IADDhABAEAADKAGEBFAE.hACAFBEGgEGHAEDF.SAFDhAGA......hAHA...,1,-14,-33,19
McgSUJdLVFOeRQANTWYXHEZGICBaDbKPf,TEEBXDGH.ZFADCDAABHAF..DBACKGCEMAFB..SCCFhAAAdEDEFCCCeHCCAHFB.hABA.NDDF..HADEEACEaAGGhAAAfEHAUGGE.......hABA......hAEA...,2,-34,-21,13
GeVFTbQEdWgNJBUKfcaPDHROYAZISMXCL,ZECFMFDDLCCAGEEEeBCCFHFC..TGACQCGG.dAGHhAAANBAF.JEAHBEGGKGHBaDDGhABA.DFCHRAGDOCAFhAAA.AFFH.ICAECAFC.EABC....hAEA......hAFA...,2,-27,-10,17
aZJeRLbBgXQIMAfdGCEYUSPHcOVWDTFKN,GEDFCCACUFEB.SCHFHEAF.OBCEDCCEKGCHZFAA.eHBGLCFAhAAABABHQDBChAAAAHHHEAEE..PABEhABAWADEFFHD.aGEERDDE.......hAGA......hAHA...,1,-3,-29,26
QbSMRdALHGYEBCDXgeTNfaFUOWJIcVPKZ,HFABECDCBCCCXEFB.eAEFTGABaCAD.FGCAUGDH.OCFChAAAIFFG.PHFEhAAAQDCC.SBBEhABAdADHABBHLDFACAGBDACGfHGHhAIAWEAEcAGC.KFHB..hABA...,1,5,-30,35
MJLNGdBFUQAZcgXDSRHEVOCWTIPeYfKab,ZEDCXCCHSDCCHGEG..EGBFCHFG...TAECIFBFeACFhAAAKBBCMICALDHFhAAAdEAAFDHDAAEADIBCOAHHPCAHhABAaBABJDFB..BGDG.QAGDhACA.....hABA...,2,-21,2,23
PRKXOBbWNJEdHYcaQFUMLAgTGSZIVeCfD,TFACSABC.ZBFDeAFEDCED.RBDGODBGBGGD...NCIE.JADGhAAAHEEBaCBF..FFCGUAAHhABAABIH.IHGAhADA.fHCDKHDCXEGAEDGF.dHAB..hAHA......hAIA...,1,3,-37,40
faSWXbPIFAUJOQMVZcGeDRBgHNKdCTEYL,UAGFOFDAQADCZDBDGBCFDEGHBHHAHFGBdDAE..CHCHEDDGLGDAhAAA.SCHBhABAXABG..IHAChAAAJABGMIBCeCAB.NCCCTFDCaAGAbDEEAIFG.hACA......hAFA...,2,-16,-4,12
EYXMWDdKIcRBHfGeZCOTVQNPbFaSgALJU,LDBGEABG.MCHFDHACdFBHKGEE.RBCABDEFGBBHZFEE..TGBChAAAQAFE..hAAANIEBFADASHEAhADAABACJCFB....XAGEIDHF.cDEDhAEA.eFHHCGHB..hAFA.OBBH.,2,-16,-15,1
cLAFeHdNbPCRDIKOTaGVMYgUXWJQZfESB,eABEdABH....PEGFDHECKGCE.TEECVAEG...MCDEhAAAUDDD.JGDAZAGF.fFAHhAEAEHACBCAEAIHCHBBFhAFACEAB.OHFE.aDEG....gCGChAAA..hACA...,1,-11,-37,26
bMHESRaeXJULKGDcCNQIZTgAfVFYPdWOB,VDAAFDBCdCGC.BAFCHDFD.RACE.eFDDUAFCLBAGDHFA.CGBG.QAAAhAAAZFEH.AIHC.hAEA..fGHEhAAAPEEBOHBCMDADaDDAKAHB...NAIC...hABA......hACA...,1,-8,-29,21
FVIREGAHWcPQbCKSafgUYdXJOeNDZTMBL,HFCG..PEECbCFE.SAED.aCGAgFAFhAAA.UBBGXFBBhAAAJAEDNEAFDFIDMBAEBCAChABAFHGEVGDAIHFAEDDCWCAGCFFBKHCG.dAGF.eFADhABA.....hACA...,2,-15,2,17
gPdCGRSFKHOWDLAUYTZIVEXJacQNeBfbM,UAAFTEGAZCGB..EFDHaCDH..QBEFeFBBBCFGMEAEdGGBGAEBhABAFBBHKGEGWACBhAAAAADA....IGEChAFAVFAD..cGGDNIEF...fDFAhABAgDBDCAFF..hAHA...,2,-29,-5,24
dIUMVJQaHPeAZCBDOLXgGSfKWNEbcTRYF,CGBBDDIFLDFGGAECKGAD..EGDE..TEAHFDBGdGHC.MCAAhAAAJGDEHBACAEDE.BAAGhABAXFFFSHGAhACA.fEDCNIBHRBFEIADF....hABA......hACA...,2,-29,-23,6
ZOgaRGIDABVYbUHPCWdTEMLSXQfJceFKN,VGFGUDDFCBAF..dFBC..MBFGSEBE.QAAFhABAJGAGFGDDKCBEOGCG.hAAAaCDAGEFAAIBCBEHB.hABAbAFA..PCFA.EADB.LFHBhACAcDDANDAA..gEAChAEA,2,-29,-20,9
SAZbIPEKWdCXQTGFfeVOgaNYUJLHDRMBc,ZEEE..bDGHEAADKABGCCCG...QECBFGACeDEA.OAFG.hABAaBAHNIEB.UCDFLAFGhACADEAHMFBHBBDESCGChAAAAGHAIDAGdGECXEAA...hABAfHCH.hADA...,2,-24,-15,9
UGFYdQeXMCETZRBNbLDKcIVHJWAfPaOgS,aCGCODAA.UFEFFFEEQACC.eEACMBGD.CBCDTEAAhAAABFCF..NEEFLCBGhAAAKCHB.IHFHhABAJFCDAIAE..fFHCPHBCSAGChAEAYAEEdABB.EDEDhAIA...,1,-14,-38,24
bcaLOAQgTGUKMPCXNISedRBDHFJWfZEYV,QBDGTGCE.GCGEMFEC.CAHA.XBDHSGCC.dCBAhAAADAEAJFAFZBAH.EGEEbFEDhABAaACH.ODFCAACFKGHH.hADAIBFEBDFFFAEAfBHA..hAAA...YDAFhABA.cGGA,2,-15,-10,5
DaGRfVBUFWPCbILMAcYeJQdKHXZSTOgEN,eGDGQEAGKAABHAFGZEDAOGDC.EBCFNACADAEC..GCGEhAAAVEFA.BAHB.WADBhABACCFALBDD.hACAAFCDJDADSAFB..aHDCfHBBhBAA....hBBA...,1,-19,-22,3
gGJQZEBAYRFUHbVXMTNDKaPfLICSdceWO,FEGCHDEB.XCAETGGHDFBEKGCC..aHGALEDB.IBCAhAAASHAC.cBFChAAAeAHHOACAhABA.gGAFQABHECEBAIFE.RAFF...hAHAbEAGMBBBfEHAhABAWFFD..,2,-18,-10,8
RbYAMVEaPFWLBgGXfCHScNeJUQIDZKTdO,VDFAaDBH..FAEDLHCGBGCDGDDB..fBEHhAAACACHHFGHSAADeFAFUDABhABADCIHTFDEdGAGOHDEhABARACHAGIBEABH.....gGGDhAEA..XCCChACA...,1,4,-25,29
WNXVZHdQfREJaBcYGMDgIFKUACSeLTPbO,CGHHSBDHLDCF...TAAAOBHD..XCACHFDFfBEChAAARBFGJFABBHGCGDFGhABAMGEGDEFAIDAGhACAKEHBAAFFeHBCPAFA.WBBC....hADA......hAEA...,2,-18,-17,1
VEQLDNZCTUGXMgOWSbBFfdYceKJaAHPIR,HDDDREGDQBABDGDDCCHAGAAH..MCDGOFBBSEBChAAABDAGFFGFdFAH.eBHBKAGDAEIFhAAAIDFA.VEDHhABAEHEC.LHDG.NADD.....hACA......hAIA...,2,-33,-5,28
FUWdCXYbAegfJDKOPQVBRZEHaMSITLcGN,eCDBJAHH.KEGFOCAH..VGCCBCDB.RFDBZFBFHBFC.SBABhAAALBCEGDFEhAAAUGACdDADCABC...YACChABAADFFDDDD.EHGAIHHG...hAGA......hAHA...,1,-15,-30,15
UFITGbegDQAcfBMWaOVdNLCPEXJSHZRYK,BDBAMFID.OFCHdAGHCDHA...EDED..SHAERBFFKACC.FEEEhAAAGEGEeDCBDBDFAAFD.hAAA.fAHEhABAaGDELCBDXBBCJAEB.YDDFIGGG.hAGA......hAIA...,2,-30,-25,5
eDEJATBNdGgacOHMVWXfUIbKFZQCYLRPS,BHFFdEDBGBBDaFCGHCBEMACC...XGEHIHAE.FADC.hAAACBAF..LEHHhAAASDGEEAFGADHAgGCAhABAOFEE.fAHCKHCE.QGGAhAGA.PEBBhAHADEEA...,1,-19,-20,1
EFgZKNdGeAaVMQCYbTBcXOJRHPDSLfUIW,MFIHQCGF.CCCG.bDFFBHCB.OFEEJFBARBBD..HBDHDAFBLBAHhAAAUAGEEHFG.FDEDhABAKCAFdAGFADIF..aGBCTACChACA...XEAASABCIHHBhAEA..WFADhAAA...,2,-20,-18,2
MZHLBYQOfSUcNgDGTbJeRVAWPdaKIFCXE,dGCEKCFGCECFMEEE.ZCCHBBCC..OGFEUGFE.....gBFDhAAATCAGeGBChAAARCAHAIEC...aHBEFAHFEEHDhABA.LAEGfFAESEEGDIGG.hABA.....bADBhACAWFAFIFFH,1,-13,-44,31
daSeRFBHfOZWKTcEQUJNYbCVXGMIDLgAP,dFGDSCFEeADCFBFGBCCHHBBEZFAD.KDEHEGEE.UDDH..NAAD.hAFACCAD.GEFCDIDCABIBRCGHOCHDhAGA...TGDGhAHAJHAG..YAAEXBDB.IBBAhAIA....hBAA...,1,-15,-28,13
UdKRNDJPVCBZXTYbGcFWOMAgeHfSQELIa,eHDCSFAHEBGDLBHBUBBA..RFCGDAIFJGAG..CBBF.BHFCZDAG.hAAA..TCFDGADAhABAFAECMIFCAAGA.fFGEhACAaAABKFFE.NFBH.PHBC...XDCEhACA...hADA...,1,-15,-23,8
MaLfDWbONcCIRZUeQTVYESdPFJGBAgKXH,KFEGHECBLFBBDFGAOACCCGAF.ZBBCUCBH..TBGCEDHFdAFGJHEChAAABEEC..AAFEMIAAhABAaACE...fEEGhACANAAC.IEABeGFA..YHDAhABAFCFH...XDFBhACA,1,-25,-27,2
VegRXNDaLIYTAdJQZCEUOMBbFPcfGWHKS,JACDCBFCUGCDBHFD..FABF......fEGDHDEHKHFAeDCDhAAARDDHDCGC.LAEEhADA..IAEChAAAABID.QGAFEBDBOFHDMCAB.cFGHhABA.SGDDhACA.,2,-50,-26,24
bdfWRZHJDMKEYQGLPSXUATOcVNgaCBFeI,TCDCVBEA...aEGDCEGFBAHF.FAAFeCAA.dBFFRFACHDBChACADBIBEEFF.GGADLFHFhADASAAHAFAG.hAEAOEBEcFEFNAEDIHHHfHDHWHDAhAAAMBIB.....hACA...,1,-17,-18,1
DVGMSTQCEWOaAdBLUbXYRcfNFgZIPKJeH,BFHHLCBEUACHXFFGRGAG.....fGCBhAAAFDFFIAGCJAFEDEEA.MIFGhABASBABCFAF.hACAEDCFWCHFAHFF.dDAHbCGBNDIE.....PEDDhAAAeDDD....hABA...,2,-45,-10,35
VFMSRWBGfYQHIPCbAOeLEaZgdTcUJDXNK,OECFEAAFZEFC.dBFBUEBGDEAD...KAFGMHEARBCA.BCCDGGDF.hAAA.QEGEhABA.HABCICHDhAAACEEEAHAEaCAF...........hACA......hADA...,1,-30,-37,7
SQIZPWRVCafNKFeAbDXBLTGEcMgUOdHJY,XECFLDFAEGGA..MIDAOECEJCAC.SABCZEGB.hAAARBCGCFAHNCGG..KAGEAIAABAEHhAAAGEAEUGDF.dAHChAEAYABG.ICHE.WFHHhABAfCBEFFEH.DGCFhAGA...,1,-12,-25,13
aYBWENSgPIbdKcMfQFGXOLDTRHZVeUCAJ,aACEBBGG.EEGE..SGFB..PDCCdHDBMDDGFGFBOFBAhAAALFADDHBCREGBVBABhAAAUADAAICAJFCE..hABA.NCED.bBAB.fAGD.XCGAhABA....hACA...,1,-13,-35,22
IMaCTRbgWNEfGPDUecHZBYVAdQSOJFKXL,QCDDOFFDFCDBLBBDMCCB..aFGECFDD.RAFF....bBAFhAAANAEBGCGA.DGBHhAAAeCHHZFBFBHHCAHHASADEhABA.JHDCIEEDgEEAWADGhABA..fHABhACA..,1,-3,-35,32
XGfTYOEJeLRHBPWZbCdQgUDFIAKNVaSMc,KECHaEHH.MCBCGEAH...TBGAEAGALEHFHBBEBFFBZCEBCABFhAAAdBEEQFADhADADIDEIGACVGDCSAEEhAAA.fGDHJADE...eBADhABA...WDDAhACA...,2,-16,-13,3
LEBGYNCcAXSWbHfRVPgUKaJMTdIeOZDFQ,XEAHSFCDHDDERCEG....VBBGUBAHKEGBaFGF.MHDAhAAAdEEEOCABFHAALAFAhABABGAB...NCEFAHIHfGHAhAAA.JBFAeDFEDEBA....hACA......hADA...,1,-11,-25,14
YCLGKTaSQPOgEUbBWHAdXcRFVZJeMDIfN,dDDGRCCCZEBEJCHBDFGC......IDBB..YDADhAAAGAEGTFFGSHDGhABAOAAEEGHDBDGBhACAHGBEAAEBFBBAMDAHCGBAKFFFaFHD..PAHF.hAAA......hABA...,2,-23,-21,2
GWBVbeJOLKDCdMZFYQSXHgNfPAUERTIca,REBDTCFG..IDDAaAEC.BFAGVFCH..JGFCLFGBhAAAKEFG.dBAAFACEYEEHhABAQBAG.SDFEhAAAgDBH.fBHEAAIDEBECWFEDhABAOFAB.MFIBhACA...,2,-33,-17,16
cEeMAYSDONPIKTbZGdfVUgCXHRWFBaJLQ,DDAFOHDG..ICEBKEFFZCCHdBHE.UGGAXABA.HEBBhAAAFCECBBBCJHDCQDFEhABAEGAG.AHHASHAGhACATDAF.fAGGCAFAaADG.cCCChAEAMAAD....hAFA...,2,-34,-27,7
GgeXMPBWaIJKAZcSORNDQfdbTFHUYCEVL,SBEGRGDADEEG.QCGHdDBE.FBBHHACGUDDBEBAGLGFGhAAAeGAAXAFBhAAAMFBDBACDaHGE.KAGGADABOFFGhABANDAE..TEGH....CEDDgBGHhACA.hABA...,2,-21,-10,11
HTVEdNUYRcIgLFGJASDMZBPQeCXaKfbWO,MCEABAHEeDCF.CHDC.KBBC...fDDDOCHBHBCGEHGEdFAGhAAAUGEC.RFAB.gGDBhABALADEFGHDAFFBSCGAhACADAAHZBAB.XDAEaEEG...hABA..WHAA.NADH.hAIA...,2,-35,-7,28
DYICObRfKJUBXMcGWeAEVPdgLSHQNZFTa,VEBDdGFBSGAH.HCCFQAFGZADAaCHD.IHDDhAAA.OGFEfBAAhAAAKEEEBEAFMCFBcABEhABA..WEAFEBDCPBHFLABB.FGDDhAEADIGC.CHAF....hAFA...,2,-13,-12,1
ICWBLbASaTFdZHDgPYXNOKUeEJRQfcGMV,aFBDFFEDZDADHFGBDABA....PBED..NCHC.UAAG.eEAHhADAEGHFQBCEhAAA.GAEEMGDECDDDhAEABHBGAHEHSAFE.....hAEAgDFH.hAGA.YAHH.,1,-14,-30,16
bRcYGUSDaVWOHdPKTMFgCeLBXENfZIQJA,RACFGDEFUCGE.SEAHDFBF..aGHBVGCE.OABFdFFGKFCFhAAAMAIF.FAEACFDBLHAGhABABHFHEDCFfFGHhAAAZAFE.JADHACAD....cCBChACA......hAEA...,2,-34,-6,28
VdXNQGcAWPEIKOTDbYHBZFSMeJRfaULgC,ECAHKAEDDGEHHCCDBHBHSEGE.eGCAJBFD.RCEF.UDCALABChAAA.CBGHdGGHQDGDhAAAAFAFIFBDOBBBhABA..YHAAMFFHaGGF...XAGFhACA...NDAC.hADAWHFG.,1,-13,-32,19
WUXQCZLEdYDHcVBMaGgeASJPbIRfNOKFT,JEAA..IDAEREEB.OBBATCCDUCFF..QGBBhAAAZEDEEFAEdHGHDBIFHGCChAAABADEMABCaABFeAFAhAFAAAGC.SEGG.fCGEhAGAKGGCXAGECHGD.cCCHhAFA...,1,-17,-20,3
UZBGTcPELJDXHQKROSNVfFIYWegdMbaAC,ZAFCGCAH..PFFGLDGD.DABCHFCFKFBGOAHDSDBGhAAA..VAEAIBAHhABAeDEFdBBFMIEGaHAEhAAACCFBBGAGEHFC.XCCENEIG..YEADhAEA....hAHA..gEAG,2,-17,-10,7
bfHSMKANQWUPTRGOFYXZLVBDCEcadgeJI,QGGEUEFBRFCBGADAOAAA..FHAAZCEBLAFBBFGCCHEEaFBFhAEAdDBGeAAE..IAFFhAHA.HCCFhAIAMDAFAEIB.NEIG.PBBB.XBGDDGGH.hADA......hAHA...,1,-9,-19,10
CNPXOUfJeZSYdTaHgBEWFcGAVKMQLRbDI,KEEGMCIFRCAD.DCDA..CDCE...XGCEUGDB.eFFESGGFhAAATDAE.HACGBADFFCGEhABAAHBDQAGChAAA.bFAGIAHG..NDDFfBAHhABA....hACA..JFAH,2,-32,-23,9
AfLZJbHTWNUgEPBeYMXFQVGIaKdDScORC,LBFEZADAJEFF.TGCEUAAB...EFAGBFAG..eEBEMFDHhABAFGHDGCGAIGFHhAAAKDCE.dBAB.DEEEOAHFhAEAAADFfCAA.HCFGNECC....hABAYFHB..hAFA...,1,-2,-38,36
RdHEaSgUPKAOLJeMIVCfDQZbGWcFTNXBY,LFFBeEBAMAFDVBBCDGCF..ZFFDGGAFFCCB...TCEBhAAAXABGBAEF.dAGEEFEBhAAASEGEUAGGAEABOEHDhACAIHHE.CDAB...fGDGhADAWFBE.....hABA...,2,-22,-15,7
DcTfZKUSGWLCFEXaMgQRAJbHNPdYOBeVI,HCFBdBBEODEBBEHAeBCDDFBC...TEDDZAEESFGBhAAALAFGCDAHFGAFEGGB.XGAFhAAAaHEG..MBABhABARADDABADNICH..PCHFICHGfGCAhACA......hADA...,1,-1,-33,32
BDVcgabYHfdNLWIGPZTROJEAKMCFXUQSe,MHBGXDEBUADD..SEAHDEDC..VBAHaAEAHDCDhAAAdEGELAHHIHHFZEAAhAAAOGFGAGFF.CBAHFGCHhABABBGBcGEH.YBDANEIE.WAHHhACA......hADA...,2,-29,-18,11
HQLfdIBGEWDXSaeRMOJgFUcYNKCVbAZTP,ZADAHEABQDEGdEFABEDHEBAHDCID..aCCHeHCE.OCFAFGABUFGChAAA..NABDKHGE.hABACFHA.AHCFPCAH.hAAAIGDEWHAGXCDC...MCCDhAGA.....hACA...,2,-33,-11,22
DTEgVGUKBXRYPHCJQeaSNWZOcAFILdMbf,LEFFMDDFDAEH.EGACGBEEUADH.BAHDRECBHCAB..CFAAQGFHhAAAaABF.SACHhABANDIGOAABAAGAIEHHhACA...fCGBTCDDKHDAXGBHhAFA.JCBF.hAEA.WCHF.,1,-8,-20,12
ZMSGBDCQUIYHKJgPaTdcONAWeRLbfVEFX,RCBCLCAD.VEGHXEFD.SBCEDCEHQFDBhAAAUFADHGDAJFBB.PBHHhAAATCBD.dABHOHFEhABAAAIDeAHDfBFGZBEFMAGF.CEEDKHAG..hACAaHDCNADH.....hAIA...,2,-13,0,13
KdFbgUPcIVSGEXeDQCHYLTfMONJWAZRaB,aADAKEBCdGBC.FGGEUGCE.....PDFCIAGEGBAGhAAAeDFHCAGDLFFGhABA.MCEGJCDGABABBHAEhACAbAAD...gCCB.SHFEhAHAEHEE..DEAB.hAIAYCHH.,1,-6,-39,33
ZGLUQdebPNOSWBEgKMYIHCfDXcFARJTaV,RDCFaCDDGBABLDFAdEAA..eGDA..bABGOCECBAGHKFBAMDIFhAAAHGCGDADA.FGHHAABH.TDAGhAAAZEGFQAFEhACA.SFECWFFEEBHHICCBhACACHBF...fGAEhADA.,1,-2,-18,16
FBHZbQAGTEOPWageJcKSCLNDVfRIUMdXY,GEDBEFEC.OFBDaEBA.eBEGKGCALCFADDIDRABF.UABHMFABhAAAdGGGFHEEBGAD.ZAEGhAAAAECG....WDABhABAgEAG.SCAGCHHANAEB.fDDBhACAIGDF..hAEA...,1,-18,-29,11
TVaFEONXbABRYZWJKGHeLfdcMPDSQICUg,BEEBRDDBZEBFKBAHeFCF.dFAE..MCDESADH.CAAEUFGFhACAgFGC.aAEGOCEEhADA..NICBAFDFJCBFhAFA..HBGFfGEEDAACIHAATAGGhAGA.EDHFYDAFhADA...,1,-15,-32,17
BNAXMZFOLdcEWJbCQgKPYVTaUDHSIGeRf,MDBCOEADLADCdBCH.EDGAJBAB..CHFBKGGC..VDFAaHCE.hAAADFFFHDEF.IGCAhABARFCHBAFGAIAC.FGGDWEBChACA...gBGC..PAHFhAAAYBBASABEhAEA.,1,-10,-40,30
SdcXbKRgQHPIDTMNVfBFLOaAEYCZGUeWJ,ECEHZABCeCFD..SAAFXGCARFGFHEFF.IBBBhACADDIBTBGHMEAG.fADHhADABAFFFCAGLEAAhAAAAHEDCDGBUGBBdHFDKFFD.gAGE.NFBF.hAIAaGBH.....hBFA...,1,-10,-13,3
NIKOdeUHSYALZbQfVagDJWXRFMcTGBEPC,ZEAFQABHaAFB.DGFAJCBAREBC...FFFHMDACGDGABEHH.ECHHhAAACHCA..KAGHdBEAUECDhAAASHBG.AIGA.hABAfABF..WAFE.TGDDhADANAIA.IBGGhAEA...,1,-28,-32,4
UQTJeOGMLCDKRFHZYdAEVcWaSPbIXBNgf,EACGVDDB..aHEA..SABD..bBADIDGChAAABAGFNDDG.UFAB.TGGFhACAeFFCOCCAGADFCFHEhADAKBHFFHCEYFAFADCE.WEEC...hAEA......hAGA...,2,-20,-18,2
gdICQFGXZTHYOWAVMJRPaELbSNcBfUeKD,MBDCJFAA.RBFC.EFHBLBAF..bABDSFFF.BHDHhAAAeAHFKDEFDHECIHGChABAFEEAZADH..YHAGhAAAACBCaDHB..NDCA.fBAAdGAC..hABACFDG......hAFA...,1,-20,-33,13
ZCTPRWgcLFfdBUHQJaYAbVGXSeDINKEMO,VBEASAGE.DCADKCCA.OBAACFEBRBBH.....gFEEhAAALAACdCFEBEHHhABAQGFDJEBF.hACAAEDDGEACIHAHEDHBMADG.PHDEhAHAFHCE.fDGHhAIAaAFC...,2,-34,-13,21
NTEecVOAZUXQbMHLKdPRFBYSagWfCGIJD,XBAFQAEBHFDFdCGBFGEEBDAD.aBGA..fBBHhAAAGCEEIHAAJEFG.DAFChAAATDADeCHBcCCDhABAAAHFZDDDMIAC.KHGG..PHFESFAGhABACACEEFBD.....hAEA...,1,-8,-9,1
MbUOLSEJFBGIPZcYCegTRKXAWHNfaDVQd,HBAGaFGG.QAFGMAAFUBBFODBB.LFFDSDFChABAJCHBFHAAIBEDZEDDCDFBTGGHhAAAKHCGAGBF.fADBhABADAHDbEAEBHHA.PEEH...hACA......hAHA...,1,-3,-23,20
dXCFQaKHGceVWJOfAYZLBITREUDSNbPgM,LDGDBFBDRCEAUDADDBBE..SAAC..bFGDMBECCGEE.hAAAaGADGACC..hABAeHFEJHACAAGCIECChADAEABF.gDDB.FGCH.KEAF.hAEA......hAFA...,1,-17,-33,16
ONeJIRAgMVDZCBKXYcaWSTHfPLFEdQUbG,MBGFDCEBZFAHKAHH....XEBBaEBG..SFFDhAAA.HCDDLDHBhAAAEBCHdEHAQABEhABAbGAANCAC.eFEH.IAHGABACCHHBBFBHYBDChAEA.cDFA.hABA..fGGG,1,-19,-24,5
VcENWQCGIePXbfMZJLSadKDHOTgURBAFY,FBHBVDFAEBBH..QBBFCFEF.eEBFXGBE.MCDFhAAAZFCESDDDhAAA.KAEFDBADOAHDhABAUAEEAHGEcAFENEIA.IDADPDBFfHEBhABAaFHD..dGGChACA...,2,-32,-11,21
MJeCRKLafAWHcZSYNEFQBGVDOPgbXdTUI,HACCZBEESCCFEEHFFBACGDDHDDDH.OHBC..bEGDTFCDhAAAMEEH..CACALEAHhAAAADAE..YAGDhABABCAFgGBHXFAFIGFBhACAeAFC.aDAEWFFF..hABA...,1,3,-27,30
fAJgDFdRGIacbVTLUCENePXYMHSZQOBWK,DBFAREADGEEG..ICADaBCF..VAEHTGAHLABDhAAACCDG.eEHD.PAHHhADAYFCE.MBBAhAAASEDFOEGHBHFD.WEACAIDE.FGDDhABA.bBFE....hACA...,2,-37,-6,31
ATLCaObfEZSFXNDgdHVcUJeGKIMYRWQBP,TCBGCCFG..aEAEOEED..fGAHSGGFFEDHNAED.hAAAdEHGHBGB.VGBAhABAJHDEeCAGKBEG.MADEhAAAWBBCBCHE.AHHFEABDDEIHcDAC..hACA.IHHD.hACA...,1,-3,-36,33
EYMTeNVIfFaXLJUdWPcbSCRDKOBZHGgQA,EBACMCFB..eEEBVEGFFHGC.LAGBdACD....cBFFhAAASDBF.CGCCDIDChAAABDCFZCCDgGDGhABAAEAFNCIA.IGAHaADA.XECEhADA.WBBG...hABA...,2,-27,-23,4
YQJgdZHIRcLbPOBSEUXCVefDGATaFKWNM,TABHaFCF..KAAHMGFAQCAF.dGBGHAEGRFFB.bCEGBBFEhAAAEDHFCDAFeAHF.GDDHhACAAICCNCDE..gFAHhAAAIFHE.LFEDOAEHXGDHhADADAIH.WFAF..hAFA...,1,-2,-14,12
JVEXKTefGacAgCZRMDFWYOQbINLBPSUdH,CBCARGFGDGBHFAAE...OABCQFBC....NCCA.BDHFUGDAhAAAHAFD.EFECXAFChABAKADCTDDCGDDBhADAaHFCAHGAMCIH...WEAF....hAEA......hAGA...,1,-29,-30,1
FPJAEWdXNDgVKTLCYZIHaGBOcQfeUSRbM,EDEAdDCDDDGBKFHB.LAAFZFACHBAHGGCHBDCC.QAGFeHEGSAAChADAMDFH..PEABhACAACIFXFFF.hADANIAD.gGGH.CFCAYBCChAEAOADDfBFD.hAFA...,1,-12,-15,3
NeTQHZEKJOSGdfcWFPagUIXLBCVAYbDRM,DECBMABFeBDDHCDAKCAFOFBE.GEFCdFDB....fABAhAAAWBEEFHACaHDEIAGChABABHHG..CDAGAACCREGDTBEDhADA.EHCCJCHBSBHH.hAAAcFAC...hAEA...,2,-21,-18,3
CAHUQcdJgTVMabYRNZPDBLFfOGEIXKWeS,HDBHQDGBdDGCJHBC..TAGCMBDA.aFCDRFEDZBAABEBD.LBAAhAAAFAGA.GEEEhABAIHHEXDDB.hAAAeDAEAEEC.cGAH.gAEDhACA......hADAYFADDIGG,2,-28,-1,27
FaDZRHeAKdIgCQMOUJEYbfXVGPScNLBWT,KGFBdBGFCHHFODBF..EFDA....fAFCXGEDGCCBhAAASBDBLBAFhABABHADTDGCFFACaEHH.hACADFDC.ZAADeCHBAGDC.IHADMHBC.YBCEhADA...hAAA...,2,-40,-8,32
WMeCIOSQPJbdZBEfTXHFVRKLcgGAUYDaN,DAFFaGBG.MIFG..CGEGOBDCQABD..JCAHdGAHBBBAfEFDhAAAHAFGFFGDKEDALEDAhAAA..cCCDhABAAAFA.UDAGWABCSGGGZCFE.hAIAEBGG.XGDFhADA...,2,-27,-23,4
URMIDbTFcVXZCHPQBGJYdNLgefOKSAWaE,EAHBMCDADBBHFDGD....VFDGCHGAHFDDBGAEJEBD..dCGALBAFhAAAeADBKCCBAAHHaEDG.hAAA.IHHD.hABA..bFBD.XAEB....hABA......hACA...,1,-30,-38,8
JYDfRcNAIbXKPCUMHeOZdBFaSVELTWGgQ,XAEBCAHGHACEZBAHBBDFFEGH....aFCCVFGB.LDAChAAAGGDBQCDAhAAAJFDE.DAGFfBGAhABARFADACCF.IHAH.KCEFMEIDODFEhACASDFE..hABAEGBE..,2,-15,-15,0
VUQcBDYFTAIKXfdbJgOGeCZPMRNEWLaSH,XECGdAAHJDAA.GBCFZEDE..RBGH.EHCALGBAHFFEQDGFhAAADFAE.FAFEAEEGKGGEhABAgDAF.OACGhABACHFEMAEDaAHD.SDDG..hBAA......hBBA...,1,3,-43,46
PUVcaNZdHWfRgDbASCOLXEMeBKFGJQIYT,CAHALGBA.EAFEMAADBEFCKFDHGEADQDAA..IFHBhAAATDFEUGGHhABAVBCEaBAGdGACHBCA.hABAfAFGDIBAAAHCSGGGOCHFFHCC.hACA......hADA...,1,-7,-25,18
WPVOMHNdUFSXZYbCcTQIGAeJgKBaELfRD,eDHHJHCEBDAGLBDF.DAHH..VBDDMAAGHDBFdGECSGHHhAEAZEFE.CDGGQGABhAFAAFEHKBBFEHGERBGDOFAHhAAANFCH..FCEF.YBBF..hAGA......hAIA...,1,-18,-25,7
aJgGLUPCDTZREVdYMFNKbHSOBAXecfIQW,XGDCeFBD..fCEEQFABaHFGJBAG.LEDEhAAAUAACCHDEDBIHTBEH.ZFFAhABAEEFFdDAFMDACFAHHNIEFKAEHhADA.SAGBADDA.cDGF..hAEA......hAIA...,1,-2,-26,24
DBRZLMcAOgJdXfePFWISNaGHEbKYVTQUC,JAHDXFAC..eHACFABG...IEHAaEBCEGEG..KCDBTDABhAAACDGB..DBIHRFEFZBCHhABAMFFAAHGAdCFG..hACAWAEBNGAD...HGBCbADF.QGGChAAABBBD.cBCGfAFFhBAA.,2,-21,-16,5
RSCBdLIMKJacfDEbWYHGZOgUVeXAQTFPN,QAFBFGFERDEEBCHB.dBBCLBCCKDDG..JFFA..aEDCDGDGEDAEhAAA....WAAEhAEAGGAB..OCHDhAGAgAGCeEBFAHDFNACDCBAGIHHF.MCCChAIA...fCGAhBAA,1,-27,-35,8
OGMJaefdbWXYFVNDIBUTEPcSRQLCZgHAK,KDECMHBGeBEAdBCB....XBGAFABEVGAADGDE.BCFGUGEAEEFAhAAA..SEAEhAAALCAHCDDBHEFCABAEOHFEhABAaCDH..fGHAYADC.NAIC.PDCHhACAcBAC....hABA...,2,-22,-18,4
JQGeDcbEWZgVFTNIURLPdKYfaOHABCMSX,BBHCCFED.MDGFXGCHGBAHDFAE..EEDAZCAAFEBB..IGAAhAAALHAG.PAFBhAAAKBECaGGCHFGF.AADDSHEGhABAQABCcDFA...hACAWCHB....hADA...,1,-8,-45,37
VAIDgSJOaCKeGZULQEMWYTPRHcfNbdFXB,DGAESGFEODEC.CBAH.KBCHZEDE..UGFDECEE...MAAATBGFhAAARFCH.HFAB.fHEBhABAdBHEBBEEAAHGIDAFhACAJEAE.aCCD...LAFChADA..WFFEPDHFhAEA...,2,-42,-11,31
ATYGDQNeHKRXIUSZgLMFJBOfCbdaWcPEV,GDCFDBGEQBDDHFCHRBGDUGFBZDBHLFEFMADGBBBGCGFB.dBDFaDAHhAAA....PCAHhAAAAGACNEDD..KABASHAAhABAFCHFOHAGWFFEEFHF......hACA......hAHA...,1,-14,-15,1
EDAWGQTYVaFMBKLSCcIeXROfUPNJZHbgd,QGDBVDEH.FEFCKHGGLAHDCHAH.eCBGXAEARAEFOEAAhAAAUDBG..JABAZFAAhAAA....gGAChAEADABEAIEE.TGGGYCHB.MCCEhAEA.BAHE.SBBChAFA,1,-21,-28,7
GBRLJYXKEMPeHTWAOSQfIUVFdgDZbNacC,QFFDUAGHdFDFDGEFZDAA...aFADCGHBGEAEBCDBLAAChAEA.JFDBXCDBhAAAKAGFMBIFeACE.TBADhABAAAFBSBBB.fCGCIDHGFHFGhAFA.....hAHA...,2,-28,-22,6
HNOebIAcTYZVEFDURJQWXGPBfLaCSKMdg,TBACZFEAFCHFREAH..JHBE..QCEDGDGGBFBELADAhAAAaGHDKDDFdCBB.HGCEOADChAAAIAHCAIEC..hABA..cCEF.EAGGDFIFXDAGhABACHFAMCAH...gFEGhACA.,2,-24,-7,17
IMLHfaDWKbGAXOVZFECRNTPYSeJgBUcQd,VBCGZCGBEEDG..RFBC...TFAHSFHBeFDDBAHFUBFGQGFChAAAMACCLBBEhAAAaDAHDAGCKHGCACFF..OEEGhABA.CHCA.NGEFYBAFJCBH...hACA......hADA...,2,-16,-14,2
EXcQdOULbAYeIMSGCWKNDHJFaZBPTRfVg,eDDFMFDHGDDBKBFGDFGA.FGFCZBAEBAFH.RACF...VFAFECGEQEAGhAAAdAADUGEEAAFG.SHAChABA.NIED.hACAaEFG...fGHC.gDAChABAOEHF.bCFE.hAEA.CCEF..,2,-22,-14,8
ZXHcJdQUIYMabERKNLBWDgOPTCefGVASF,SFHHZAFDHCADdHFDUDFGMGEE..EGBHKEDCBCCGDHBE..OBBGhAAACBBFeADC.GEDEhAAAAAFHFECH.JAHF..IEHBhABA..aDABNIAF.gBEC.hACA.fAHChADA...,1,-19,-29,10
gbCHAZLQGSBWOIFEURYKfNTeXcJaPMDdV,ZBFHGCAABGHHOFHBEHBE.RFCH.KFDE..TGEBeCCF..JCAHaDEBhAAA.DIAEdABB..VAGHhABACAHBAFGC.LACHhAEA.SFADIDEBFHDA....hAAA......hAEA...,2,-40,-4,36
cbKYTGQANWVUfJHdEgPMZFLORDBSaIeXC,VAAGJAAEHGEE.dAFEEBHD..MDIFLAGDDBDF.SEDChAAA.eFABCDFEKBHDTGFAhADAQEAGAFCDNEIA.hAEA..fECBgFDCFHAABDCCaEGD.hAAAXBDE..hAFA...,1,-12,-23,11
XWdfDBEacQMVNebYKGIZLOgHCRUPFJSAT,XFABdEBDDHGCBBGH..aDHHMHAG..VFCCeADGKAEGGCDDhAAAZDCALAACHBACCHEEUEGDhABAFHGGJAHF.ACBF.fEEGhACAECCG..NIAH......hAFA......hAGA...,1,-11,-21,10
UEbWgZOfFRTPGNDdKIQaXCSVecALYBJMH,LEEBBEAFMIDEUBBG.EDHD..gDDFZDAAFFAE.RACBGBGChAAAdGHEKAHH..aGCDSGHHhABA.cFEBhACAAHACJAFD...HGAGOACAfFAHhAEANEGA.IGGFhAFACBAD.eBBB.,2,-17,1,18
NHOGWbMXRQZcIfFYESgUdLKBaDCeAJVPT,VGCETEED..HBEDOCHDGCBA.MAIDQDBBZFFD.hAAAfHDHEAFESDAFhABAUGAGLAFHhAAABACBCHHHAHAE.NAEEXGGF.IABBhADA.FAHB..dDDEaFCDhBAA...,1,0,-8,8
ebgQcSDHEJaAWRUCMLNfXdGPIYKBTOZVF,UCDHCEBCLFED..NCCE.dHAFGDGG..IACAKGDCBBGGhAAAZCFEFFAFeAAF.QAEDhAAADBDAEAHBaBAHAFCCMGFEhAEA...fDCD..hAGA.PHFG..hAHA...,2,-38,-25,13
eFBJbPKMOgXaVWLYGCAcHRdQZUEINDfTS,HCADRBDE.dEFEUFEGEECDDBACSDBD.FCCHBAHB.bAFDMAEEhAAA..OHEChAAAaCHFLDGBCAEDAACG.QGBAhABAIHBAfGHG..hABA.eDDBKABG...hADAXFAGWAFA,1,-14,-20,6
VYWAKXHOGRZFgePNSQaMCTLfdIJcEbDBU,KFEHHCBAOEACGAGCZADGFABB.eFEB.SEEEQCGCMFBBhAAACBHELAAFdGGBJADCEFCDhAGABHGC.UCCD.hAIA....YHAEAIDA....hACA......hADA...,2,-35,-1,34
QUMWgPcHdBZFfLIaYDNOSJKTXbACGVReE,CHAERFAFQAEEUGGG..MCAG..PDHHdGDFFDDGLEDBhAAA.IACFhABAaDAGDBBAOECBKCCAXGGGhAEAAFAEGAGGeDFH.WHCA.....hAAA......hABA...,2,-39,-5,34
dBVQgOSYTKFHLcWENfbAXMIeaPJZRGDUC,MGDCaGDCZAFGRDCA..GAAFCCCG.BEAEQFFF.OEAAhAAATCGDKABDHBDCLDFEhACAEGBF..NEICAHGHIHAChADA.eADCDAFA.......hAAA......hABA...,2,-23,-17,6
GEZYbADHJSLCdUQfKgWVBXTOaFeINPRMc,JEAGCABHdFFH..UEGBQCGA.KDBBVBAG.BCGGOAEFhAAA.eGBC..PEDFhAAAMIFAGACGhABAZAEAAHAE.SHBA..fHEFhABAgAGC.WGFAaDDAIHHEhACA,2,-38,-29,9
SOJBdRWCFMEZeHbagUNIKAGQXLTDcPfVY,XGCHTFCF.DHEE....PFGDVACB.OACBBCFHdEDHhAAACFBFMDAFECAF.HCEHaBFG.hABANICD.AGIH.LBHDhAAA.fDDEYFAHSEGGhACA.WAHHFHAGeBABhABA...,2,-23,-6,17
KbXLQJdAcOMfTRCBGNPFeVIZWSHYDEgaU,MEFETBFHBGDH.GDAGFAAHeFDDZEEAHBBGEBDF.UGGBKGHDXGAGhABALAHDJAAEAEEDODBFhACARAED..NIBF.IGFBhADA.SEGEDEDD...hAAAaAFA.....hAEA...,1,-7,-12,5
NRHfcPdASaEbMVWGZBJXeLCOUgKIQFDYT,EFGHMBIDGDBBZBDEBHCCeBFGLDBH.UAAGIHEB.hADAFBAADGAFTGACRFDDHDFBhAEAfADAdGHAAEEA.hAFAaEGA...WAFE.CDACKFDG...hAGA......hAHA...,1,-6,-20,14
LZIBVJNcgdAFWSPKOEDeCaYXMbGfTHQUR,FEHHSBCAKDCF.DGBEaDDF..MGECGAADHCECRGCA..LDFHhAAABEHBVDBE.NCAE.hAAAdBHEAHCF.OFAB.hABACDAB.bGFEQAEG.IHHDhABAJAHHcABG....hAEA...,1,-12,-23,11
VBGPcDAQgFZOSLbIHRNefWdTUKJYECXMa,FCAGZCDHOFHBLFBGHGAEeFHDdBAG.KHEGJDBE..CCGD.MDIHBAEDhAAA..GAGADCFFAEGB.hABASDFFRDBD.hACANIBH.TAGCEAFHaGEE...PABE.hADA......hAFA...,1,-7,-25,18
YaAETIeQRdfcUKPNXSMgWGCbHBDOJVFLZ,TGDCeBDFRCEA..dAGDUADDKHGE...XDFAMICAGFAHHEAHBHBHhAAADEAG.OBBFhABAJABGFFFELFFA.hAAAaECDABFDIHAEcAGA.SBADhABACDDE......hAFA...,1,-4,-23,19
OADWTfJeHMFBCacSIGLQPNXUZKRdEgYVb,TAEGeCBHHACD.BDGECGFB.aEDBSDGHGGEBLFEChAAAQAAAXGAFKGDHRDAHdCDChAAAEAFA.gAGBhADA..YCADOFHDAEFCDIDC.WCHBhABAMIAA.....hACA...,1,-4,-7,3
AENWLQTUGSRZaXdVHbYBfFgIDCPcOeMJK,EHCELADHUACAGFDFSHAG.aCBHdBFE.HEBEBAGG.FFAAhAAAIGAHCHEC.OAFAhAAAMFFAADHG.NGDB.QBAAhABARABD.ZDDA......hBAA......hBEA...,1,-7,-31,24
cQdLKMPJgUGHXSeWBODERNVCaAbIYZfTF,..IEAEfFGAFCHH.QFABLFGHMACAJBAGGDDEhAAAHCEHeFBHOCEGDBADEDGFhABARBBACDDDAIEGZCAE.dHAHKGEFhAAA.gAGE..SEBChACA.BHHBaGCD..hADA...,1,-1,-4,3
VKTANSBQIYbaMCRFXPEdfJeZLHWgOUDcG,BBBDQCFB..IHAEaFACRDACFBDDEDCE..dEHEeACELHAChAAAHCECOHFAhAAADHFC.VFCAAEFDNEEESABDhACAMBADCDBG..PFFG.JAFAWHFAhADA......hAEA...,1,-7,-24,17
QPDMWfSCYNZOgeKXdLHGRAabTJFcEUIVB,aFFDJAFB..FGDGUCEE.BDBADDAH...MAAHSGHD.hABA.CGBCZAGBeFAHdCBFHDBDhAAAAIHA.TEFGEEHB.hACAQBCBfAEDNCIAKACEXEDCLHCAhABA.....hADA...,2,-36,-9,27
YKVOJbBgAMfCReQXWFaUDPdIcNGHSLZET,CEBDeDHH.QCCEFGEHDAHB.dEAD...NDFG.GADGHGAESGGGhAAAZFACEAACKGGDODAAhAAAJCGDBADA.ADAAfAGAhABA.XFCAaDFF..PCHDhADAcABB...hAFA...,2,-39,1,40
gGIRFBKYaAPWJfVEDUXdCZLOSbcNQMTeH,JGDCVDGB..DDCAdEDFZBEHLGAG.OADBSFAB.hAAA.bBADQABBhAAA.eECGgAFFhABAIHCDBHHDYAGDACAH...fCAAhACAEFAEXGDDhACACHHDNBIE.MAIH.,2,-29,-7,22
YEJaCPVOQdcLAUSgTBMGZKDRXIebWHfFN,SCFEBFGFGABHDEDERDEA..eGBGHFDEFECFEBAC.CAFA.OAFGhAAAdEBEAAHG......hABA.gCAHhACAMDBCKADCXDFDIHHGfBHGNIBHaAAG.hBDA...PFHFhBHA...,2,-23,-18,5
AbfDXgcOJaWQNBZSVKEYMCeLPTHIFRdUG,DCCAXBAHODGD..aFDCQDDH.BAAESAEBhAAAEGBD.CHDHeDEETGDGhACAIEBHFAGEdDBAADGDgGFHhABAJACG.WAHFNDIE.KGCF.MBIBhACA.LFHB.hAGAHACB.,2,-18,-16,2
eMOacSRVUCFdbIDXTAGQLPNfWJKEYHZgB,GGCHLFGB..NABF.JFAE.KFDAHCCCBBBBOHFE.SBGBhAAARBEDCDBH..FBAHhAAAdEBADCIBAGFEfEFFhAGA.WBCCYAECeHAGMAIB.hABA.aGEE....hACA...,1,1,-48,49
JYWLMfAZUCORdINTgcaeVGSFDHbKPXEQB,UBEDCADDdBGH...TGGCaEAE..GGDBDDIDHDAEKDGD..EBAGBAAFhACA.JFAFLDDBhAAAAEHFOEEDNAEF..eHBGhABAFBBA...XBDE....WHCGhADA....fCAEhACA,2,-42,-14,28
KgfEVcLANIPMWBCaZYSJXGODdQHeUFTRb,..IGAAMFHHCCDBZBAB..SEFFGFBDdAFEeFHDFCHDRDDAgDBFhAAA.EABEhADALAACADHC.WHBAhAEAaHCEYBDG.XGFDDGIB.hAHA......hAIA...,1,-13,-25,12
cYMgaCUAfdJVENGDFQSWbIKXBZTePLOHR,dEBFVEFFGGDF.QEGDSGDF..IAEGBAAETCEDhACAeDCEOABBhAAARFADMIEGCDCHAAIDEGAA..FAFEhADAbAFHXCGF.......hACA......hADA...,1,-14,-22,8
LUACOIDTaPfeWYFEZGKQRBMgdNJSHbcVX,OFDDDGBB..aADEeBECFHDC.GEAC.KADFQEFDhAAAMABHdFGC.SCAFhABAHDDC.VBFA.UECChACAAICECCHF.IHHD...PCBEWCCD.hAAA....EEAF.hACABAHB.,1,-17,-25,8
cBdOWUeZLPHEDRJAKfVaCFYgNQMTGXbIS,KBGAVEACFCEC......NABD.TBBFGDEE..IEAFhAAABHBHOAGHeHAAZEFEhABAHBCHDHEEAAIBaHEECADF.QDGAhAAAMGAAXDDGSGGBdGGA..hAHA......hBAA...,1,-17,-18,1
aKQRFIZALgCWcJMVSETfOXdbHNDGUPYeB,LGACCCDH.JBAAMAHH.SHEGECDFOEFFdEBD.HGAEhAAADAFCUDAGeAFFKEFGFBHFAAAChACA..gBAEhABA..WFDB..TGGGfFHChADANGCB.....hACA...,2,-31,-23,8
TYDaQBKJAMOEVPeLbISNXRdfFCUHZWGgc,OEFBEEGC..VBBGLBAE.IEDASGDG.NGEF.hAAAXGBC.fAHGhAAAUAFEZEAEWABEhAIAgDAB.cCGFDIBCBHHBAAFEMDDAhABA.eEGHdBHACEFC..hBAA...,1,-14,-22,8
IbZVeMFQBdHcCYgTWPDXSOJKELNaGRAUf,UAGG..fEFAZEFCeCAHFACCdABEHEAH.CBDC.TGEFhAAAPCHHDDEG..XCDAhAAAJFBAKHGG.EHGCaGBHAAGDIGCHhADA.MIAABDHG.gCCDhABASECE...hAEA...,2,-27,-9,18
RgBSdQCeZfYDbVFUXEGaNHLJMIPOcKWAT,TECERADDBHFHdFDA..eCABZCABDCIBFCGDUABC.GGADaGBDLDDGhAAAMBIB..PGFChAAAKFHFABAH...SCEChAEACHAC..fBGHYAEG.hAFA......hAIA...,1,-15,-41,26
MRSHbdICUVQaWNKAgTYLDBZEeOXcJfGFP,TFGFDHGCBDDC.ZFBCOCFH..XBAHJGBAFGAH..MCAFhAAARDFGHAFA.dECDIABHhADACBED.UDBFaHCCKACChAAAACCD...LFFGEGFD...eFADhABA.....hAEA...,2,-33,-14,19
IQDJRXaZHEGUNcCPAfeSTWVBgdFKYLMbO,eEFFSHDA..TEABVEBFBEHGFBCDKGDBLCBG.hAAAMAFBIBHHDACFXAGChAAAaABBECEENDIGCGGDAHAD.hADA....gEEHdAEHOHAE..hAFA......hAHA...,1,-22,-25,3
VWfdHXAQeJPgDFcIGYURMZKLBSNbCOEaT,eFCGJDFE.DBGDFDACGADC..RGCAKBBABHEA.SCADhAAACBGH.EGGBTGGD.hABA.VGAGdDDEAIEAgAGBhACA.ICBFUGAAMACEZEFA.LFFChAAA...hADA...,1,-17,-32,15
KbHJRSFLZYTdAXfOQNeIgDBEVUMaGcCWP,XGAEQDEA.eAHHDAEDBCEHUGEGGCACCAGA.KAAFHEEBhAAASHAGFDBGLBAEhABATECGAIDGODHDhACA.IHGEVADDaGHF..WFAE..hADA......hAFA...,2,-30,-3,27
FNbSWCUBYfDKcGZTXdgJRMVOLQAPIaEeH,aGGEeFAAHEDEFBAC...SGEHUAEABEGEDDEEKDECZAAD.dCCCJAHFhAAAVGBA..OGFAhABAABEAEAGB....WAHBhAAACDCF...fFAAGGBHXEEGhACA.MIEG..hADA...,1,-9,-30,21
HaCKIWPfAEdLXQTNUFgBSYRDcVebMJOGZ,LEBBQDGDUAGBBCBE.RAFE.DCBAeGDAMEIHGDAGZADHHFFHhAAACDEBKDDF...IGHAhAAAfEEC.EHDGhABAdADA.NIAD.FFABSABG...hACA......hAFA...,2,-22,-12,10
IaYbLZKgDNQFVOWTcECdMJBUXPfeSGARH,RGFAHAFB.aCADLCFGZDCD.DCCFFFGEOGBGTGEE..CBDCMDAFhAAABFAAUACE.XAAGhABAfEHGeEFChAFASBABIAHB.YEDG..hABA.KHAA.NACB...hAHA...,2,-35,-6,29
MDNPZaVWBKXJCHdAcGFSLQgUIYfEeTObR,FGFCQEBHUCDC...IAGAEFDCOAAEMCHD..DHBGZEDDhAAA.VABBBFAAXBDHhABAJAHHHCFHdGFBAAEG.SADEhAIA....gDAChAAA.fEHEhABA..,2,-31,-20,11
AZYMcSJWCXOLdfVEDUePaRKgFTQHNbBGI,ZAGBMDBASGFF..CHEEXABHLADFdAACEGGBDAEDUGAAhACAeDHDaFBAKHGA.FAFHhAGAQFAAHDEANDIC.hBBABFFFAECG.YFDD.JAHHfCBAhBCAPAFH....hBEA...,1,-6,-17,11
KWFDPOCZVISgGeQJUYBXacHAfMRNLdTbE,RBCHdDCEEHBEFGEG.DBEACCGF..ZFAC..SHBGeFHF.UCEDBAHBhAAA.aEEGAGHC..MFADhAAATDABKBAC..OACGhABAIHFF.gABFJCHB.cEGGhABA.....hAGA...,1,-21,-40,19
KVABXPgcMOWLCDeHEFSRdZaNbJGfUTQYI,XAAE..cACEMFCDLAHH.DBFDHDABSBDHhAAAZDFBaEHHNIDFbEFFfFDEhAAA.QAGBhABAIGDGAHBDBHACOAGHCEEGeCDAEEAHdHFDhABA.....hACA...,1,-9,-18,9
UWPIbRQaHYegJNFKGLEDZSMfTVdBcCAOX,UDCA..IEFBQFEHHBBFeACCJFAHFGGELBGBDDIHMDEEhAAATGAB.BBADhAAAADABOACGXBDEbGCC.hABAaFHD...NICB.KBFC.EFCESAGEhABA.....hAGA...,1,-7,-23,16
EgOSVQLFIDecKARYfJXBaMGPTWNHbUZCd,RFBDJGEABEEBGCGA..TBEHHBEDZACHdDBF.EHAA..SEHHhAAALCBBDAADKGGDAFAFfAHEhABAMAIB.NIDB.hAEACADFOBAE.FGDA.IHAFeGBE.hAFA......hAGA...,2,-25,-8,17
bFNHZeOTSUPWKfEMdYRgcJCQXVDLBGAIa,aBDBFGFDZDDC..TGBAUFBEKBCC..MDIBdBAE.RCBB..JFDCCBGG.hAAA..QAABhABADFAHBCEC.IAGBhADA.NAFC.HFDHOHDC.SEAHhAEAWACE.fDGAhAIA.YHFC.,1,-2,-45,43
OfgTaMJBCNKRXYSZHALcGPUIEWdDebVQF,LAEAGFBBUCFDEBBHDIBGeCAE..QEEAFHAGOGEETDBChAAAMEAA..BADAKHFCXEGAhABASHGAAHIBIFAChACAdAGB.fCGBaABGNCIEZEEA..hADA.cGDH..hAFA...,2,-27,-4,23
fZCRNEVMOQbXKcadBeALTHUWPgIJFGDYS,TEAHHGEGUEDC....PEEAJFAEDBEGSFDHCCDA.hAAAEBCBOBCBQGGChAAAKCHHdBACeADBAAHA.LAGDhABA.ICAG.YHBAhACAfHBDNAIA.MFIHhABA...,1,7,-45,52
NeCgOWaEVGbBMPYJdDSIHRKUTcXfLAZFQ,QCDGCABF.OCACECEHGCFGBFACMHDGJDCHDFID.HAGDhAAAKBGEUAAD.TFGAhABAXFACLFCGhADAABDHNIEH.eDFA.WAECaAEB......hAIA......hBDA...,1,-17,-27,10
MZcJLbADKWECPYeRSGFUXaVTHNdfgOBQI,KEAAECGG.CAEA.eBBGGEGAUFEF...aDEGHCEG.dABDOCADhAAABECEMCACZGAG.JFEDAIEADAFHhABA...WFHHhACAPGAA..SAGCFAHB...hAAA......hACA...,2,-28,-23,5
bJWGCBDRMSafIcFTVOLXNPUEKeYHAQdgZ,QDFBZBDEJEEH.CGACBBFEDEDB..MBCBaAEH....IDDHhAAAFADEOCAD.LHEAhAAAXBBF.NIDBUFFDhABAEGAAeDHBHCAFAIAG......gAGBhABAWAFESHBChACA.,2,-28,-27,1
ZBPLeYVaXWUDMCAIbTfJcHEQSgNFRdGOK,TAABJDACHBFF..QEEESFCHFCDFdGGHOGDCBFEHeACBhAAAVBGF...aHBCXEBGhAAADFAGAEHB.IHHBhACAfAEAEGBFNAEFKAHH......hABA......hADA...,1,-5,-28,23
JACEMKUWOXaRNgTPeSDQVdLFZIbBHGcYf,EABBUEAB.OEGBREED..TDGCeEEFDBGEQGCDLBBAFFAFhAAA.ZAEABDDCHCDA.hAAA..YDAAhACAADHACHCAMACGKGHBaFHD...NIEB....SHAChABA...hADA...,1,-7,-27,20
JFZAUcBbCdgKRSVaWEDQGfYTIMHXNeLOP,BBBBdEBDRAGB.aCFHEBAEGEBC..TFFDMIFGHCAHeDDGOBDEhAAAFGFCAEDD.UGAACDHFSAEAhAAADIECQFDAhABAIAHDNACD..PDHDZACHbEEC....hABA......hAEA...,2,-14,3,17
YCRULfFIOPdVKZJeMGSWaHXDEbQBcTgNA,CAEDRAAEUGDCFCDC...ODFFdDAAKEFE.ZGDGMFAE..GFABhAAASCGE.HAEAhAAADAIHEHGABGHF.gGAFhACAAACCLBCFfDCDIHAE...hABA......hAFA...,2,-36,-22,14
NfBIJFZACVEaQHcMYOGSXWDgPdKTbeULR,VGAGEGABHDFD.MADHOBADGCBC.SAAAXGGGDECGhAAAdHGHKFHDeACGLBFChAAARCFEBFHGFAGFCGCHaHCE..hABA.cFDAYEDGWAEC....PCCAhABA....hAEA...,2,-23,12,35
KUPDTaIXARQFECGeMJYNdOWLBgZSbVHfc,QBDDEDDCGDAEeABGMAHD...JFEDdFFG.OBABBCGFSHGGhAAAbFAD.fDGAhADAKGGEPAAADAEGhAHAIGDCAIBECCCD.NEDB.WCHH..gDBDhAEA...hAIA...,1,-10,-28,18
CgPOKNGAFWafcZUebYLJXVSDMTdIBERQH,aFAAZABGeFFDLBBH..JFACSHAADEEC.MFFBdFDAEDAAhAAAQAGGHAGBCCEH.gDDAhAAAKGGE.AHIFFEHHhABAfGAEUADC.XCCFIHDB.hABABCAB....hACA...,1,-13,-19,6
cENTOZGfVAYaHXWUQLIKPCBJMReFgDdSb,aBCGXDBA.UCGGLBFA.IBABCAHHMDAB..RGAEFGFGhAAAdFABSFDDhAAA.EEFGNBBFOEEChABAZFFAfHEHAIGA.YDAEWCCC.KGAABGDBhACAeDCADIDE...hABA...,1,-21,-22,1
AEPRIeSQVWKNYUfaTODXGBgMZbHCdJLcF,EAGFRDBAeGEA..QEDBKFAAUAAF.aHDEDGDBBCBG.ZGAGHADGhABAdFADLEHBADAC.hADAIBECSDFHhAEANABH.fFDBOFGBXAACMCIF.CCCB.hAGAFHACWCEAYHFGhAGA...,1,-3,-25,22
WMTLGXZIcPOAbKQgVDeJEUFfRSBHdYNCa,QBAADCIBeHBAUCEARBGDBFAD.HADFdAABCDACaGGA...MIEGhAAAGEBBZDAC..PEEBhABAAFGDKBGCJHFC.FFAHSHAGhACA......YACBhAEA....hAFA...,1,-6,-37,31
ZPYMUcTFfICHVGaSAXQLNgbeEDBKJORdW,XGFCQCCCLAFG..NBHCeCAHBDBBKCGARGBE.ZEBEMGDGhAAATBCAFGHDCCFEGGABhAAAAFBE.EEGFJACCOCAHhABA..dEEB...WAHB...hACA......hADA...,1,-16,-18,2
YWGSNXbeLcKDMaZFRJQgACHdfUBOVEIPT,dDCFUADABEGDEHCA...TBEAGCFC.XBAELFAAKFBCDADDhAAAZAGHRGDA..QBAChABAAHIBCGBD.OAHDhACAIDDE...WFGH..SGGEhAEA...eHAEhAFAaAAGFFDE.,1,-11,-19,8
AXFCTUEKfgBHbaNDeRdcZMVSYIQWOJPGL,FCCDTFACUGAG..ECEDKHECBDBDHBFG..aGCE..DBEEdACGMDIBhAAASGGE.hABAIDGBOFDAJABBhADALAFEAEAHCHHG.gGFGeDGB...hAEA..cDDH.hAFAYBAD.,2,-23,-19,4
VOdWaKcCTPNFJMgUBERHASbZfQGDeXLYI,ZADAQGBFGDDCDCDELBAF.IEFHdFABKGFACCHD..TFGDhAAAFAAD..MFIFhAAABBFGRCAA.ADDFSECGhABA.fHDFeHAAXDGGOAHHhACA.aCBGNAEF....hADA...,1,-20,-24,4
CSgaEVMYHWNXUZIDLTGeARFcdfbOPBJQK,FACFdEBCOBHB.BABDKEDFCFFF..aGGGMHFA.HAAB..hAAANIDFZCDBDAGALEBDhAEA.eDDGABDGcFEGhAAAfAFG.PDHBSAGC.hBAAECAE.WEADXGDDhBEA..,1,-17,-48,31
HIYNJXEARGVBQCfadPTeDLZMcUOSKFgbW,GDCBBEEACHAF.aGHHdAED..eBEAZFGFUGCBOHDE.KAAGFDAF..hAAA....gGAFhAAAHDCDIABAhADAJDADAGGBQACC.fCHEhAEADGGDMDIFSCFEhAFAWFFC...,1,-8,-41,33
ZgNQXfFBLSaJIVEPdARcTUKHbMOYCDGWe,RADAUGFFKGCFHEGBMGBA...CBAGGCDHeDBGZAFE.QCFDhAAA.FACDBDAC.SBGAhAAAJHAEEBAHAAFCTEFGhABAOEADWFFD.XDCCfEADhACA......hAEA...,2,-24,-14,10
QbGLSPaCYdEAUfNeHMKXOZVcgIRBTFDJW,UGAFeFEDKGBDOBBGZDCG.....VCEHIDGCBFBCDAECQBCBhAAA.LBFAhABAaGGBCEHE.dHGDADHEHAFGhAAAMBBF...XDAGcFFF....hABA......hACA...,2,-36,-18,18
ULeaFdJbDXVYAHBNTQcMSEKgPfOWCZGRI,BFCDTGGHMFFF.KDFC..fAEC.OBAGZAACIAGGhABAeGBEaDCCdCAHDAHFhAAAVEGFAACGHCFF.NEAGSFCEhABAEBEG..PFAFWFFDCCCERDDH.hACA.FHCG....hADA...,2,-22,1,23
VaDcQFXPdCHEMgJUNTfGRLKSAbOBeIWYZ,BBDFeHDG...IBBGZEDCaDGFDCBA.FAFEXGGD.dAHGhAAAEGHDMFBBJDBH.UAEEhABA..NBIG.TEDGhACARADDKAAF.SDHDADAH.bGDC.ODAGhADA..YFAFhABA...,1,-11,-30,19
YEaOUQFHKMVWTIXdSceRPBCJGZLDbNgfA,EBEDUCCCFBBEHDGF.MDFH..TFEAXAGHdDAESAHBhAAA.eDDGBFCChAAAJHBAZGBGLEHFhABADCABNIEFAHHAaFABKBGH..WACEIABD...hAGA......hBAA...,1,-17,-22,5
BNgJeCcYMbLUWIEASfVTDaRFGZKQdOPHX,SEDDVADE.DADEFDDFGBBBQDGFdGAGHCGBBBHCJEFFCHGD.hAAA.MBABLAAFhACA.IEBCAGCCaGADKCBChABAOAFEXDAHNIDD.eFFFbGCG....hACA......hADA...,1,2,-23,25
YSeHZCaOIKGBWDdAQfUMEJXcFVPRLbTgN,QCEFMBAE.JFCEFECC.VFEFLGFE..TAGChAAAgDAHSAEChABAeHBCCAGBIDACBCACDABAhAAA.AGBFEAEGPBFHNAIA.HDGDOHEEKCCG..hBAA......hBBA...,2,-17,-10,7
IRMCKYUOXgHaVAebDBWQTdZcESfFGLPJN,DGCGBFHBQCCDdDBHZAED..EFECFAHHLAAAJHEA..RCFGCAFGUCGAhABA.OHAAHBAHAFGGhAAA.eEADTGGDSEFDhABA.fADENCAAMIDA...hACA......hAEA...,1,-18,-25,7
VMbFCLRSXdOBUTPAEgfKIJaGWeZHDcNYQ,EEBGKDFE..aABBGADEZGAG.DCGA...NIAH.QEDF.hAAAVAEAbFAGCFEDRFGFSDBFhAAAXGEE.dGFCBCBFhABA.PDHFAEIDfCCBIHHG..hACAWDAD....hADA...,1,-16,-27,11
fTEebCXGVaHAUJZPQNOFLcSYKMRBIWDdg,JFFEQEBA.FACCLHCG.SBFEKFFEBAGBDIEAhAAAdCBA.TCDFEFDACBDH.VBAFhABAAACGZEAG..PGDEhAEANAED..ODDAMEFCICHE.hAAAfFAE.hABA.eBHH.,2,-21,-19,2
MXVSKcdebTfUZLDGNOHJgCRBPAIQaEFWY,QECDFDHHMCDG.SCAHKFFF.dADFTABDZGBADEEEGDAHhAAAOCCAHFAH.CDFC.hABABABFAGHEaAFCEFHF.YFFHhAAA.cAGH..fHCHhADA....hAEA...,1,-16,-26,10
NVdCSHRPUQMWbEgIZDXFALTcOKGaJYefB,LDHHOADCKEGGaBDC..eCBABHCBdAABHDEHRCEB.UAGA.QAABhABAMFABEHCGZDAChADADBEAAGGD.GEACJGDA.hAFAfGDBCBHCSCGA..WDAEIHHGhAGA....hAHA...,1,-8,-19,11
JFCNdWVeITGEDZLRMAOBaPfUYKcQSHXbg,OADCBCFHaEEDUAGG..KBAEQFFEHFBF..XDGHhAAAgEDHFBGACDDCdDABeFAFhABATFABEDAHDIGCRBBEAAAD.hABA...PHDCfADGSCFGhACA......hADA...,1,-14,-20,6
aLHAKbMVPfQYWcOJCZGdSNUTIEBRFeXDg,MFBAVFAC...QADD..WABDJHDCCDGFZAFE.dFEGSAFEhAAAUCEF.EABHhABARACFFDHDDFGD.LHDAhAAAADEDKGBE...fGGDODAGNDICBBHHhADA......hAIA...,2,-29,-19,10
WRacLJPNgTAOeUdHZGMbKYXfVEQFBDCIS,ODFCeEDBHCEGZDBEGAABKGAD..XGFFEGACFHGE.BEBDCCHE.hAAAICBGRFDGLAFChABAJABA....NDIGACHCMDAChADA.fHDBDAFC.aFFAgGBHhAAA....hAEA...,1,-3,-28,25
GOAcafJTIDERdSQMNCBFebLUYWXVKHPZg,aGDBTFCD..DACEdABBMEBHCFGE..FCDHeCHHLHCGUBBB..hAAA.XAGFVDEFKFHHhAAAZAEFOAGFAFEE..hABAcGGCIECHECBDSBHHBGGG.hAFAWEHB....hBAA...,1,-21,-26,5
GPJQDTULgFSEbReHAWMKfOcZBNVICXYda,MBEDKHDEOCDGBAHH....VDGBCEFFdDBFGFCF..PFBEhAAADFABLBCB.hABAFGHDEHAEeAAHABBHfGHChACANBFE.XAFAaGBCQDAEhAAA....gACChAFA,1,-21,-35,14
YCcTXfEHBVIeOLJabZPgDWdQMGRFUNASK,SAABKBEACFGC...XFFDEDGEBGHDeHAEOBCHLAEFhACA.aCGHZFAG.DAFAhAAAdFBBMIACFDAAADDDTGEEhABAfAGE.IEEEPCAFQDEGhACA...hADA...,1,-24,-28,4
CNJURHSZBbdEeAXafWLIFGDYQPKMTgVOc,XCDGaHDELAFBFGBC.DBDH..QAFFMBCF..VEADhAAACGHEUCAEREDD.ZFFDdAHEEFCEhAAAABBB...IEEBhABAPAEBKGHFOAHDJDHHBDAFfHDH.hABA.WFFB..YABGhACA,1,-9,-22,13
TSIWDVJaKXcbgdMEHNGQeACUfPYZOBFLR,CEHCUBGE....fBFHZFCEODBCFBBBLADF.RGFG.hAAASGHBDAGA.hABAaDEHKCACXFBHhAAA.bDFBMEFC.NFAH.eADAAFIDBABHIDCGhABA.JEAB...hAFA...,1,-18,-32,14
dFcWVJBfLDIUEMXZSQOYNCHgKbeTGaPRA,dEEHFGFF...VGBGJDCBLBEEUBEB..EGGAMEHFZCBB.ODADhAAACHEH..KBAFeABAhABA..aEAHABIBBHABhACADDDF.IEEESAHFQGCD.hAAANDIC......hABA...,2,-33,-23,10
LZagSJVPXKYbWBEcOGeAfFRDINHCQUMdT,FCABDCCEHEAHQFCEMCGFLAEHZCFB..SBFFhAAAJHFE.XCDHbAADBACBhAAAEABBOAHBAGIBREGHCGAEdHADhACATFEBaEAE.....PDHDYHDGhADAcGBE.fDDEhAGA.,1,1,-23,24
aXefPSHgUGdRTWEYKOcQNDAJBZLbVIMFC,BFFAZACGLAGH..IEDBCBADeEAC.SBDFUFCHRFFF.hAAATCAFECDB.KHAGODHDhABAQGDGAAIH.hACAVBFFMDFFFEAHaGBHfABF..hAAA.PDHD..hABA...,2,-31,-12,19
MELNHgPJbFCWXdVRGKQAfIDUTOaBYSceZ,DHAETGBEBACE..SBCCZEAGMDIDLDGFHCFGJFFCFGEB.hAAACDAG.dCEG.RBAEQFDDhABAIHHBUAGDaAEE.hAEAeCDB.EAAANICH.gEAA..hAAA......hADA...,2,-22,-11,11
OCSAWBMgfcZHIFPLGVTaEeDXQbYdJNKUR,BBHBMEDH.....fCBEZCAFIGAHLADDGEGATBFHhAAAaCEDEAEHDEFHXGDHhAAAQGGA.bFAChABAYCGDdEGFKHDCOHACSABEAEEFcAEGhACAFCCCeFFD...hAHANAIG.CBBE..,2,-16,3,19
CSQacgMfHDKVbYENWFTUPXLeGARBdOZIJ,dFBAOHDAJGDA...QCFB.aAFFgDFEHEBAKADB.hAAA.VBAEEDAAFBGETFGDhABAUACBLBHHhACAABAGBFADCDDHMDAB.DEDCNDIC.PHAE..XGGDhAAA...hADA...,2,-32,2,34
XcDgTNKRCFEdfSUIZaHALOGPBYMQVebJW,LEAGOGEEBDACMHEC..QDFAeFFGJCAE...XCBDhAAADIBGTCEGKACACGCFdAHEhAAAUAFFaACE.AAIF.PGAEhABA..bDDB..WHFANCICFGAB.SHGAhABA...hACA...,2,-24,-15,9
XgOCPaDBTAJfcNGKZdMIWQeFULRHEYSbV,JDEF..fDDEGACFKDGDMAFF.QAAFUGCDHAGBSFFEhABAXDAECCAADHBGhADABHHAAEADNEICZAGH.dGDAhAEAIAAFFEBCEBDB.....YFAFhACA.....hAIA...,2,-22,-9,13
IBWDHbgaeRLQdCJSMcUKZFVOEYNGTAXPf,XDED..PDABBBBCDADDHEEC.bDCDaAFD.LECFhAAACBHFMAAE.KGHBFBBHEGEAGGDBhAEAAFBH..fBHGhABAICEHWHAG..RCAC....hAFA......hAGA...,2,-27,-21,6
FAJXCIZQdOTSMYVNeWDcfHgbPLEKaGBRU,XAEGCBBCZDFF.dGAHOHCA..MEEA..NEBA.DGIHHADGhAAAPHDELAHB.hAAAECCHKBGBBEEHRBACAGHHIFFAhABASBADeDDDfGHAaDAH.FECDhABA......hACA...,1,-19,-25,6
RYUBgabLEeFNXOfIMTdPGWVHcACKQDJSZ,KDFGDCCEZDDBRDBGBAED..aHBGLHFG.FBGAXGGD.hAAAOAFAMAFATGCFhABAdACHGDFC.HDAFhAAACBCBSEGA..gCGBhABAEFFBeDAD......hADA...,2,-25,-23,2
IBaFLNEMegRfSDAdCVUQYJKcZGbPXTHOW,dBDGVBBEQBAA.KHECGAFG.XFGETAGHOAFHhAAAIEDBBECEaFAEFDABhAAANDAC...MHBChABAREEADICCACIHCGFDUGGG.cDGF....hABA......hACA...,1,-18,-21,3
DdeUNJfHRWISTaKCMXAPFGBVEcYOQgbLZ,GBGCBCHFEAABODAE.QFEDLEDEDBDFdAADUADBJGBGRAEG.hABASGAHKDAE.hACAMEIBAFHH..FHEGcDDDhABA...gGCD..hAEA......hAGA...,1,-15,-44,29
gWfIGLPBFXTCYNRDJaQbHdcKeVEUMASZO,SABCZBGFODBH.....fCBHGABEBGEEXFCHhAAACHACRAEBDHGEaEAAHDDEdGFHcBGChAEAeFFE.EEDEAAAC.hADAgEGC.IGAE.LAFFhAHA...hAEA.FGDHNIAD,1,-12,-21,9
RDNMBJYHSZOCXIbWVgTPFaULfKeAGEdQc,dCEFRFFGMBDFBABB.HFDGOCBHCGHC....XGAHIDFF.hAAA.VDBGTBGBFAHHLHDGhADAfABHAAEHEEFGhAFADHACJAEB.SAGC.WHEGhAAAaBBE.KDHH....hABA...,1,-13,-32,19
ALPcNXRDTJFYOedSCgIEQVWBUGZMKbaHf,LEDG..NEAADBADFHCGeBCAdEDD.CCAD.ECGCQAGAhAAABCBFUFGBMGCA.KCFDaHBChAAAAFAC....PFHFhABARGCGTBEGOHECIEBD....hABA......hACA...,1,-18,-38,20
bFWEUXQSOaMDPZJfNAcTVGdHLIRBYgKeC,TGGBdFAGLGDE.RCCDBFHAKDCBeBAB.FCGDUAEAQEEGhAAAaHCE.DDIHZCFEfBFAhABAAACAGAAC.IHBFhACACEFA.EBBG.OEAB.MADE.hAAA......hAHA...,1,-4,-28,24
NZVMbUCTgcQEIJOBSWYPAXLfaFReHKdDG,XEFCaABA.FBCGeEFB.dEHEGECCZBFAMAFCCEAC..TAGEhAAAQCBB.IHHBhAAABHGDWACEAGDCREABDIBChAEANDDB...........hABA......hAGA...,2,-36,-17,19
YgdLJADVKQaebNCGFBMTXScZRPWEfHUIO,DBGGQCGGeACG.CEDGBFGBMEDB..SGHDZFBFRCCE.EGEEHGDChAAA.IACDhABAODDAdFAFABGGKAEHaBBB.NCIEFHAAhAAA..cGGEWEEG.fGAChAEA......hAGA...,1,-17,-24,7
DTRJBAYHNbMGWeQfUEcLIKVXOCdZPFSga,HFDFMGAGGCAFeCEAQDGAUGEFLCFAKFBBOABECAEH.dCAAhAAAFEFESGFHhABAaABCDIBE.JAFEAHHG...YCCHhACA..WEAGEEEEIHHFhAEA......hAFA...,1,-2,-30,28
NcDWRYQZPbGXaEVBTeJSMUICdAHLgFOKf,LDEDOGBGKCDA..NDAG.DIAG..RDFCQBBBZBFHGBAEEACEhAAABGBC.eBFCMFIDCHFDdEBDhAAAAAFGHFEFFGGA...hABAfAHG.WEAD..YACChAGA....hAHA...,2,-23,-17,6
bCaXFLQANPBHZTcGJMSWdVgUDOYIfKeER,BGAGHFFGZBFAGEEASEBEdBBGUBEEOAAF..IGHEhAAAKGAAEGDBRCCGCECB..aCAHLAEEhAAA.AEFANCACTBGFhABAMIFG.....gDGAhACADIAG.fFABhADA...,2,-36,-3,33
faSAFUEZKGgbRDeWcOBdTQXIPMVHLCYJN,FAEBUGDHKEFGGBEF.RCCD.eAGF.OBACTEGH..QGGGhAAAXFAFIABHhAAAMDAELGAG.hADACHEH.NAEDSGGGADEH..EABG..hADA......hAGA...,2,-31,-18,13
CcZFDUQdIfEaMSPVLgYAJWGOBRKHTbXeN,GBABBADAREFAKGCAHAED.XDBE.eDGBCCEAZBBFDEEBdAAGIAAGhACA..aDAHMICEhADA.SAHFhAEAVAGB.gGAHAFEB.WFGD..hAGA.OFHDNIEBcFAEhACA...,1,12,-49,61
EMASCfDHcBZUGVOaIbRgWKQXLeNYJTdFP,CHHDHFEBZDEBGAAFaGBGRAFA..KCABLFBF.eAFENECH.JHCCFCDChAAA.MACDAGHA.SEAGhABADGGBBECEOCGDhAAAIHHG...WDHHYCDH..hABA......hADA...,2,-27,-19,8
MIJYWXaKEZAVLBfFDNCcQSOTbPHdegRUG,LCCBBAACDACF.CEEC.QECDOHFC....TADDHADCdGGDhADAeDHFgCEAhAEAUGCHICAA.JFAFhAAAWCHHKBFG.EHEEABAAfFFCNIAFSGAG.hABA......hACA...,2,-24,-17,7
OIDKHLcaMfXUFGAEbgNRCYTQJPVBWSdZe,EGFC..NIAF.RCBECADGQFAB..VEAEBEFHdEEGOACEhAAADHBGLHEAaDAE.MAHFhAAA..fBFHhABAUDGHAIBE.bDGBgAEHYDDB...hACA......hADA...,1,-19,-33,14
ETHLYeGXDKMgfUaQVRCFOdJWZAcbBNPIS,BBHE..IGEDSGADEAFETDCBHDBBLDEH.hAAAGGEBDCFCgEFGhABAaBDAQBABCEAFOFBFhACAJBGHAAFENAIEeBBGMAAAfDDE.hADA......hAEA...,1,-7,-23,16
ebWNaOPdAVEUBSMFJfLCTIgXYDZHKRGcQ,UAFFMCGDFEHBLGAE.CCBC.TEBF..IEGDXBAGhAAADECCKFEA.GGBBhABAeFFB.NBEF.aBABdDDDAAIDBHHGhAAAfBDE..ZEBCcDABWAEDOCHFhABAEGHFSHAGhACA...,2,-24,-15,9
VcBXMEDCTPgLdWZUSeNARFGbJIKOQHfYa,GFEHJEFC.OAEHQBGAHFAGaHDABAFB..MIBECHHG.TAAHhAAALFCDZAFBSEFChACAABDFFFFHKDAG.fDAGhADA.cDBFDABGPAAHdBHA.hAFAWDDH....hAEA...,1,18,-48,66
ELgOXCNUPZQaIdKSBfYVebFGcARHMTDWJ,MFABDHAEEEECLEDG.OECHXBAGCHCH.UAFBZBFAaHFGdDGABCDDhAAA..VACHhAAAeECBFEHDABEF.HBAFJDAD.hABANAEF...QGGA....hACA......hADA...,1,-7,-27,20
XdDEafKVRZSJBLGOWeHcUgAIPYTFCQMbN,..IADDTEEGCCBG..MFDE..XECFDCCGECGHKFACRAFCSACChAAALHEAOGAEhAAAHFABUGEDACAHFDDGNBACaDHBhABAZBADBFHG......WCCEhAFAcAGG....hABA...,2,-29,-8,21
ZBXgaVCNEdbAKMQWTROceLGIPSHfFDUYJ,KCDCMDFCQCBCREDH..OECBeDHFGGADSBFGfACBhAAADADAUBBDJCFBBBHBhAAAaEAH.CGFB..dGACAIAATGFHhABALHFA........hABA......hACA...,1,-10,-29,19
BZKSMcGIRNOLUJHXgfECTPeDadbFYVQWA,KDBCSFGDMEIHGGBFRAEFLDHD.UEDDJECEHBGB.XEAHhAAAEHBACGAD.eBCChABADABAaBBCFFGF....hAAA.QEAAAIAE..BAFBcGEChAEA......hAGA...,1,-15,-25,10
VdJDEQWFfMKebgcNaUGRIBTYSCAPOHZXL,HADHLFHDdDAEDEIBQFAFFBAE.KBECeFDG...bDCGNEADaHDEhAAA..UAGDIBCHhABATCGB.SFFEhAAAAHDEZEDGJAHDfCADMHAA...hABA......hACA...,1,-17,-19,2
TRVJXIBHSYgeEcGFKPaQDdWZNOALUbCMf,LDDDUBAECAEF.MHFCRGDA...JBGFBEEEHAAF..SGBBhAAAeADAEDADFEECKECBQBFBhABADIBG.ZEGFhACAAFCBfFGF..XACDhAGAIAHA.....hAHA...,1,-18,-35,17
MeOVWNScCfKEGFJYBIDRXaALUHdbgPTZQ,UDAAHADHdGAC...PGFETEGEMCAAVGBA...SGGAhAAAfHBDGAEFhABAJEFGBGDDRCCFAAHCbFEHgCFChAAA.eDAGOACG..NFABKABChAFA......hAGA...,1,-8,-13,5
QVTXFSDHgINMPGCaYLcEebRJUBZKdfAOW,ODEGQBDC..TEFBSFDFDBCAHECHIAHE.hAAAMCCDCDCCLEAFhABAECGBeFADbBBGRFEDJEHBBHHGKAAAhAAAACAD..XBGAFCAH.NIABaEHF...hACA......hADA...,1,-5,-10,5
XQYHBTPfWNeSEbKDIVcJRagCULAZMGdFO,MBCHFBAGOFBC..XAGFHFFEBBEFTGBB..PBFEhAAANBGE..ECABKDFAVECEhAAARCCFCHAELHFAhABAAFHH.dDHAYHEC.eAEBSDADhACADIDEIFAB..hABAaAGA..,2,-22,-8,14
ZeQBdEgRcPTfMCYJIKHNSADFOLUXWaGVb,FBDALFCDUGCH.aAHDGBGGZACB.BDECdHEDREGD....TGGAhAAAfBEF.CFAG.hAAAIDADHEEBABBHDDEChABAOFFB...XAFBWEBC.eBAGhABA...gEAAhACA.,2,-33,-15,18
HaRcIbXQPAVBDGUFWNdSJeCTgKOYELZMf,VEGBGADF.FBBFdACCeEAA..CECHKEEFEGFGLDHFZAGH.MFDFhAAAHGCA.RADA.IEEBhABA.QGAEhACAAIEEDEADNABC..SCDA...hADA......hAEA...,2,-28,-16,12
ORAIHWBMbVJTFZSUYCcQeKPaXEdgfDGNL,HAFABDAEMACDJEEEZEABUDGB..CFCB.QAFCKCDB..aFHDhAAAEFDFdACADAEFLHDChABAADFF..IDDChAAA.VFGFFCGESBBDeHAGXFBFhABA......hADA...,1,-24,-25,1
RNBSHVKWgQEePAOabdCTIDZLMYXFcJfGU,aDDCdGGFCEAB..DDFALCCB..MBBFFGCA.JFGHUCEABHAF.hAAAHFCHKBAFQGAGhABA.eAHFAHFDOACAhAAA.IAGF.XBGEhABAfAFHNEIESCCFhAIAWEFA..,1,-28,-38,10
DbIANgeKCTOBEFPcWHSMLXGQZJVUYaRdf,eCAGCGADBACAEAEC.FEHF....PDDAHGFASCGEhAAALBFEQFGFZFCBUEADRDEBhABAdECCfHAFhACADAEHIBAFAADD.KGEGOCCAMIEA.....hAAA......hABA...,1,6,-37,43
ALaZSKfTcQGMEYWPNVXOeFRDHBUbIdJCg,ZGEEKCHH...TCDBQGEEEABD...PGAENCGA.OCAFhAAAREBEBDAB..UCDDhABAIGABJAGDAAFHaBBFSAFGhAAAGECB.MFID.....YHAGhACA...hACA...,1,-20,-24,4
bcIgKNeWdOYQPJfLMCZGFXBTVUDAHERaS,EEDERFBF..aEFFSEAA..bCAEIABGKGDH.eGCGhAAAOAHBQBDBhADA.fCHGhAEACFHDFBEHBEEGVFGFABAA.cAGBNAAHdGAC.....hAFA......hAGA...,1,-6,-33,27
GdCFYHTIXPKBcaJAbQOZWEfURVegMLDSN,OFEEECEBUGBERFAG...eFFBMIFALAHFDDCCGAEDCEAG.FBBETBBChAAA..IHDDhAAAKEHDBABC.aADGABAGZDFAhABA..fBEDSECGNEEA...hAGA......hBAA...,2,-24,-22,2
KUZCAdWJaVGOLgQXDFPBEMHTcYbSNeIfR,JGEEGBBHLAFGQDFF.FGCFBADEEBHDHFGHTGAHbDAFeCAEhAAA..REDDKAADUECGhABAAGADaAEAOEFE.DIEGhACA.MCFE.SBBE.IHHHhAGACHAA....hAHA...,2,-26,5,31
SEZDMVPIcfKACeRdHTNOYgBJLXGFQUWba,CCEFeEBFHFBCOAEDBADCLBAFFHDE.QFGFUFGFaABHEAHFhAAADAGG..MBFC..hAAAIDHDfCBGhABAAEDBdACBNEFE...YGCEXCFA.WFAFhACASDBC..hAGA...,1,-12,-30,18
NXdESWRAYTaCcMJeLFbUKOPIgQZDGfVHB,aCFBCHHD..MAFFeBHHFEAHUGGB..ODEB..IHAAhAAAQAAHGDDGHFFAhAAABBBHdBHESEBEhACAADBGYADC.TGCAcDBD.LBADhABAKADH......hACA...,2,-25,-14,11
OENWgPRdQVTIZFMUfXaSGDJHACKebBcYL,KDBEBHEFLBGDEEGH....NBCG.gADCRBEA.dEDFTEDHhAAAFAAF.MFIHUFGAhACAaHBCDICA.AGAFCFCDeCADhABA...bFAGOBHD..WBDF.hADA......hAGA...,2,-33,-16,17
FMIJGNCHdgSDROWQVLEaBfceTYKUZPbXA,FAGDMFACGGDFHBBFdFHADDCB.OHDA.QGAAVAAHLAEFhAAAaAABBFDAeFBAKCHDUEGDhACAZBED...PDAHhADAXADBAIDA.IFFACEEB..SHGAhAGAEAGE...hACAfCHC.,2,-8,1,9
MUITAGHJaDKLCNFOSEYdRfgbXBQWcZPVe,GBBEJDCH.DBGCLHCACHHD.OFGBEGFBRDEC.....gBFAhAAABGADQFCDhAAAZBBAeACEMIAEIFEGhABAAFBBaAEBKDAFFDHBSFABdDHA..hAFA......hAGA...,1,-19,-26,7
fJIAcFNUdLRQKHCWeYVaSPXgDbBZEOMGT,FFECUBACRCGDHDAHeHBG...aBAEXGGC.DACGBABCZBFGEGEDhAAAMFIB.TGCG.hABAJAFDACEFNDDG.LFAFhAFAKAHBCHAF...WEFCSDCE..hAAA.gGFAhADA..OAEE,2,-25,-11,14
RQYGXgVDLWNTEFMeaHfJbcCIAZOKBPUSd,KFFCBGHHUGAHRAGFGFBH..VCFALABB.TEFHEADBFCCChAAAeDDAHCAF.JAFCCFAFAADBhAAAZFCFOAEB.PHEChAFASEED.dHGH.....hAGA......hAIA...,1,-14,-16,2
APXQBZNLfHJTGaCYOEdMceIWgVUDFRKbS,QFBGBFFFLAAAHBBFGGBHCBAD.EAFEdFHC.MDFDeCGDIADHhAAAVDCG.DIGGKCAChABASAFFXEADfHGBhACATGDBOBGBWAHH..FAHFACDA.hAEA......hAHA...,1,-6,-14,8
MLDcGbIJEFdNRgeYQaOSVZWUHXfTKACPB,BDAEMCDADFAEGBAH.JDFGdDDF.REFD.eHBAQBAH.OAEAhAAASFGD.hABAVAECUGDD.HCGDhACATEDGAEIBCHBC.LAAEIHHHEFHD.NEAEaDDGhAEA......hAHA...,2,-18,-15,3
QVeZDFBIXHUacfOdKPEJAWSNCTRLGYbgM,SCBHCBHFRGDG.GEDH..bCFHMBGF.eBDFFCBHBAFBhAAAIHDBUGGAfGAFhAAAOHAC.dHGDEECChABAABCENABBLADB....gAGBhAIA....hBAA...,1,-19,-30,11
DOgbYLBZVJSIHMFfTaQKdWREePcNXGUAC,DHGCOCBA....gEEBbFFA.LBBCBGBCJHCAHFAGhAAAMEDEFDAH.fBHEhABAaBFDQDADhAAAKHDCRCEEeCCBNABH..XAGFAHAC.CHFB..hACA......hADA...,1,-15,-21,6
UTKOBHAFXYMaeNQZJCbLPGdgRWEISVDcf,FFEGMDBCeDCAZCFF..CFDE.LDBDGACHdGGDRAEAEBBA...SHFEhAAADBIDUGAHKAAEBHCHhABAAHDB.aEHF..JDAFgCFHhACA.WFADIHEB..hADA......hAFA...,1,-13,-34,21
WbITdgcJXRLSGafACQFVPUEOMYZeDBKHN,FGDGUAEFOFHBMFFEZABBBEBH..KHDGHBAG....bDDDdDEFhAAA.JAHBRFAD.SFEEhABAaHGA.AFABVADAhACAEAAFDDDD...WAHFIDAF..cCFChAAAXGAH.fHEFhADA,1,-18,-38,20
JdQRcIKNDXFHMBWeTUgSPafLGZCAYVEOb,VDEEOAHD.dBDFRFCG.KGCGDGAF..FDFDBGHH..eCBGUBCHSGHFhAAA.aFAEhABAGDAG.CCHAADDHEEAAhACAJAECIHAD.NADD.MIBG...hBAA....WAAChAHA...,2,-42,-21,21
WBbKYRaCPZJTcgQUHIOdXVLGSfFEeDMNA,BGGEKHDCRFGB.aEDHZBDA....JHEATFAC..QCBChAAAUAADOAEGdGAFLBHFhABASEDFfAFHhACAFCHDDDAG.MCFFAEFE.YBDHCAHA..hADA......hAEA...,2,-30,-28,2
NHfPDMCQeAREbacJZWXgdUGFOKSTVLIBY,EFGFaDCBZEED..XBEFdGAHFBAD..KBGESBBE.LDEGhAAAIHHHBECAhABAHAEBDIAAQDGChAAAeEAFAHIFRCAGcGCAJABA.WAEE....hACA......hADA...,1,-22,-23,1
CXIRHFYdfNDEZBOTMSAcKLPGQWUVgJbae,KCHDLEGBGEFE.QEDBUAEFVEEH..JABAeCBF.CDDARFAAhAAAFCCE.dFAEDDAHBAGEhAAAMEIDAFCD....WFHHhAEAaABE...XGCHIAHF...hAFAfHCF.hAIA...,2,-30,-20,10
NJALTOfSIEBbUPHRGXQMFZYacgdDCVeWK,TDCCOGAG..SEHHEEFHBAHFUBABREDGGGEH..MFCFhAAAFAFEaBDCdBEBDBIF.eFDFhABAKEACABAELHEEhACA.fFAGPDEGXBAE.YHCAhAAACEAB...hADA...,2,-18,-14,4
PfUTKVLNSReMZXQDAOWbgCEJHIBdcYGFa,OECB..bADDCGFDHCDABGADdDAAGAADFBGC.aBGCUFGD.KAADhABAVEGF..LFCGhACANIAB.eHEGMAEEhAAAXDFAAHDAEDAA.IBCH...hABAYHAG..hADA...,1,-8,-28,20
bMNdAJYTERICDfBOHSXceKUaLZQVPFGgW,JBFFECBERABE..DBBFBFHHHDAG..SHFEeDHFKHCE.LCEDhAAAQAGBFCFDgEAHhABAMFID.NAEB.dFEFhAAA.AACHIHAHCHCF.OFACcDGEaADGhABA......hAHA...,2,-22,-18,4
dWBSVOUNMDXTcRZAGagQbPHfFILJCeYKE,aHAEQDCBHBDHFABFLBDA.CEBGeAAFEAHHdGFEBGEESGBChAAAOHAC.MDFADEFATGGEhAAAZEGFAAFH.bFAGPDAEhADA..fAEF.ICHGhACA.KEHBWFEFhAEA...,2,-19,-7,12
ODZcIFVNaQMHWeAGRBLEfgXdUKYbJCSTP,BDCCEFDH...XFAFdADAUFAE.KGGDJGDACDBC....SDFHhAAAPAED.DCABIEDEhAAA.FBABaBBGhABAMAIFeEHDGCGAfDDH.gAGBhACAYHAGOAGBhABA.cGGD,1,-23,-41,18
QaVYIRZATSHbOKBdfWcCJEGLNUFMgPDXe,TFCEHGDCKAAG.dDAC....fDBACAGFEEDGGEGGUAACMCCBhAAADAGDXBDChADA.aEFBIDFFhACAACHESGGFBAHHcCGFNEIGPFAHeFCF..hADA......hAEA...,1,-15,-20,5
ZbNGISTEAfRMVDdXCgePFJYcaQBUOHKLW,MEGBDIACdGEC..CBAA.eDCCFDAC...JBEGaCDHBDHDHFAH.KCHHLCBFhAAAZFDB.GDFAhABASFHDAADG.fGCAhAAARABGXFACPAFB....hABAYFHB..hAFA...,1,-21,-30,9
CSMAUNJcLadFbKeHOfTPEIgQRGDWBYVZX,JEGHLFBD.FCDAKFADHAGDODEB..TGDCECGD.IGHChAAARAEADCAG.BFFH.hAAAZDAASDAGhABAAGCAUBBCaEEGdHCHeACE..fECA.hABA......hAFA...,2,-39,-9,30
dSTGDgQZUcKaLYfOBJHEPeWIXRMFCVNAb,SHFGDGAFZABBKAAH.LECB.ODABJEEGHAEB.eHDChAAAIBFB.XBBBhAAAREBDCHGAAFIB.dFEH.GBGAhABAUBGG.cFAEfADCEGHDMIBEFDDB.hAGANACF......hAHA...,1,2,-25,27
AWGacBDFOfKJRYEVXHQSeTPIbUZLMNgdC,aHGEDABDFDFH..KFCG.RAEH.VDAFHBBF.SGGCeCHD..hAAAIGDFUDEFLHAEhABAMACC.NCACCHEHACCH..hACA....cGGDfBGHEFGFQAGDhAAA...hADA...,1,-20,-31,11
QYgfZVEPedKcOMCTXDUWGSARNIJLFBbHa,REGBJGDGFCGCBDGGHEAH...aCBCQGAF..fAEChAAAVABA.EACHeECGhAAAKDFFOFCECAEBDBAB..hABA.WHAGAHGCNEIALCFEgAGE...hABA......hAGA...,1,-8,-34,26
UadTONVSHKQAZFBMbGfWEIYCgDcPJLReX,FEDHMEEEGEAE.EAAFCCHADEAD..JADCeCAE.UFGHaHEEdGFFhAAAOECC..NDDH.VBEEhAAAKEHB...AHHBBABFhADAfCAA.IHCFYEBF..hAEAPAHFLHAA.hACA...,2,-29,-23,6
gTGeabIKdfLZHXOBRVDEAQPJcMFYUWCNS,QGDBJDAA.FCACUDFG.CHHB.NECA...SACGhAAAGBGCaBEGKHCCdABH.ZEDCOFBChABABFAGDAEA.AFIH.hAAAMFAH...YBHH...hACA..gAEBhADAeDDGIHAHfDDD,1,-12,-39,27
XTWMdKgZfUaODICYJEcLeVHAbBRNPSQFG,RAGFSGABQDAEFABGGGEH..XGCDMEDCKAAHZAEEUGAAhAAADCDDCCGGEAFF.eADBhACAVEFAHEFCBDBG..hAAA.NFAF.......WFDF..hAEAfGHA.hAFAaCHF..,1,-1,-28,27
edPLVbRKUOSEFfMXAcCWIHGYgTBZDJQaN,CBAFHCCEGBDGTFBBDGBB.QAEH.eEAFdHDHVFGHRAABUFFAhAAASDGCEBHFFACGMFIHhAGAAGCA...WDFAhAHAgDADBHBG.JAFENEEA...LBCFhAAA.....hAIA...,2,-22,12,34
dAJXUfaWMCVQKOSIYDNGTLgFHRBPcZbeE,XDDEaDFB..CABFKAGESBAH.DGAGGACCLFGHhAAAFGBFBEABZGDEEBEFAHDBJHFGhAAA..fBHChABA.MFAAOCFAYAECNGED.TACEhACAgDGA..hAEA...,1,-6,-44,38
IFbMYTCBVEPKLUaDdXGRJSWfHQgANOecZ,eDGHZAFAFCCGMBDA..TEDACGCGBDAG..EEAEKGAHLAAHhACADEEHdCFGGBBGSFGChADA.HGEEADIFOHCEhAAAICGG..YFHBVGAAaHGE..XAGBhABA...hAEA...,2,-24,-10,14
TgCVQdfZFDNAREUeYKbPMIBcJaHSGOWXL,EEACUCFEKEFCMEEH.BBBAaABE..HEDDOAEELCDC.CHBGdCAFhAAAFGFGDICCAGGD.RFAG.eAEChABA...YFHHhACAIDCC.SADDXAGE...hAEA......hBAA...,1,-14,-46,32
TgcUCaOJFZPMERSLbNIGHeWdQXBVADKYf,KFDBTBEAUDBD..aGBDOBAB.ZFFGEHGA.REEGLAAHhACA.IFAFeBGFdHADhAAABHACACFHDAFE..fHDFhADACDHG.JCCHMIDENAEB..WDHBhBAA..XBBFhABA...,2,-41,-7,34
UPQWAXMTEBJeNZdVSfYICLDKRbHOaFcgG,MDFDTCCFBAEF..eAFHdHBD..SBCHfCAACGGHLHFGhAAAKFFERFAAOAHBFBACGAGEhABAPHEEAAADEECDNCIE.hABAZDAH....IACADEGFaEDFcAEEhACA.....hAEA...,1,-7,-22,15
LKBWQGUaPHVbFYSONEgRXedCITDcAZfMJ,MBBBKAAFBCDAGAGCUFGFHFEB.FDDEOBFEEEBF...RDAB.XEGGhAAAdEEC.TAEBhABADFAHAIAE.JACFLADEhABAaGDH...PHDC.....hADA..YDFChACANEAGCHHG...,1,5,-43,48
HQfNBZgSKdPEMeJODVRUFcWaCTGYXLIAb,HFEGQAACBCEHZBAFSCGDKHBCdDGH.EDCFMAHH..JBDEDIFEhAAAUGAAFADF...WFFChACACFBF...TGGAhADAXDDCADHC.fAFGNEECeAFE.OFHDhABA.....hAEA...,2,-24,-20,4
PfZYQGFgKURXLDEbeMHSOJANIBacTCVWd,BEFFaDCF.CDCA.dFAHZAAEQAECGAGE.KBABRBDDLFAE.hAAADAEGeFFG.MIEEhABASEHHAHCEIGEAhACA.TDGCPHFEYHAAFGDEXGBHhAAA.ECAF....hABA...,2,-22,-16,6
RgbaEJIWefNdTYXHUKVOCLDPGZAQBcMFS,BBGBMFAAFFGFSADH.RFGF.aCBDEEEFJHDG....eAAHhAAAdACFTGBDHGACKCEAOEDGhAAALAFEGBDHhABAAEHGQDBC..cDGFgGEFhACAIAHF...hADA...,1,-13,-19,6
DeCMdTEaLfZHgRUJYBOIAVSPGWXNcKbQF,VACFSCBB.GBFEXFEBKECBFFHHCHHB..dBFFEDDGLDEGhAAAHACARGAA.UFAABHEChAAAABAB.PCAB..hABANCIEQGCCDAIB.TCAAaGGH..hABA......hACA...,2,-20,-3,17
dQNgHMPLTJEVcFBOCUSGDeXAYIRaKbZWf,RACAaHGEKGEGZDEB..dGAEQECCHBFFLABDEEHD.FFCABABGCHCG.hAAASCCADAFE.hADAAGAB.IHHA.hAAA.WAEA.NIBDPBHDJFFCOAHD..hBAAeCAB....hACA.YGEGfDDB,2,-16,-12,4
UQNeEcJCObSAIFdYWgMPRZaBGLTfXVKDH,dADF..gCGBMBBBZDDEBHEEGCABLBHBTGGHVECFhAAADFGEUGAF..NICDEAEEhABACBGG..OACHAEBD.hACAFGGGWFFC.aAGAfFDAHABC..hAAA......hABA...,2,-34,11,45
fcLNMBCdbYeHXWgaJKFSQPVDOEZRGTAUI,UAEH..IBDGLDBBBFACdHADeDDHXGDE.aCGHJGFAhAAA.FABAQDDBhAAA.DACHEEGARFBHAHGHfBHEhAFAMAEACHHFYBAD..WHDGhAHAKAHHSFFEhABA...,2,-28,-28,0
OHbCWFKcJZQUfXPIBSNREVADLMegGaYTd,DEHHMFFFeCBHGCAE..aCFCdDFHHDCBCACHFGHFKAHDZCCBUEEE..hAAAXAFEBBDBNIAB.EGCBhAAALACC..hABAYFAFOGACWGFA.....hABA......hACA...,1,-14,-25,11
SYdCMXHLIRNaUWVZAEJbOFTGeKgDcBfQP,JEAAFBEGGBCA.KFEADCGGBFHCQGAC..SAABhACACCAFHFFHRABB.UCGFZDECAIHEhAAAOGAEeAFE.fHEBhADAdGDGMBDG.IHHB..WEHHhABAEEAF......hADA...,1,-19,-26,7
NWdfJcCTbIPLReMUADSXZBFGHQVaYEgOK,DGBAZDBFGBBD.QGFHaBFAEDDDKHGC..dDFG.JEADCHEB..hAAATABFIEDERCEA.hAAAeHBGMBIDABAHXEGFhABABBEGFDAC.HAEGgGAG.NGEB..hACA......hADA...,2,-25,-6,19
VFQSMeKRDcEOfbXTgILZPWYCdAGBHJaUN,HGFCUEBBFBCAQFCB.MIDEKFGADFEEEEHBODBE.XAGFhAAAICGDZABC.hAAAPCAGCAHEAEHA.JEAHaAEAhABA..SDFHRGEE..bCCG..hACA......hADA...,1,11,-45,56
JecgOSQIXDFLCYEbTdAMWBUNafPRVZKHG,MBCDBGCCaDFCRFBG.ZFGBGAEB..eEBCOHCEQAFChAAADEABCFFE.EGFHdDDH.AIAA.NABE.hACA....fHGHhAAAKGDHHACBcBGDSBADFHAC.YCHFhABA....hACA...,2,-37,-5,32
aADTKGgCHYXLbPdOEQNRIZUSeMFJcBVfW,KDGGCEABHFDGLAABdACD.EBFCQCEB.RGAAUAFBMFFAJECDhACABAAC..VGDAfGHEhADAAGGCDIAEGCCBhADA..YCDFPEAFOAEGIEHBSAHHhBAAeBBB..hBCAWHDA.,1,-3,-23,20
FTcXGKSOANPWdJMIVCUgRQabBLDEHZYfe,...PEEEdFGAJBBC.MDDACHDH..UDBEQAFDBBCBDCACEGEAhAAAHAFC.ZADFfDAChABAFHGG.XEBAhACASDGEAFEFNDIG.IGAD...hADA......hAEA...,2,-32,-31,1
NUfFXZKgeADaVJBSdQPWOILbETMcCGYHR,VDBGSAGE.dDFBQAGB.OABBIEADEDHFMEAFhAAACCBBGFCB.HGFChAAAUGDGFADHKHAAACFGDIEChABABGGELCHB.cGBC..YADHhACAfDDA.hAFA...,2,-27,-10,17
XPSLYAaOMGUEKZJDFVCeBfTQRcIWNdHgb,MACDEDFDKEBFZGCG.DDFDCGCG..BHHH..QADCRAFH.ICGEhAAANIBH.dGGDHACEhAAA.XCCChABALFAHAFAFaFFEODDHJBHDFCABfAHG.hACA..TEGEWEED.hAEAbBAD..,1,-15,-24,9
gPeCTabJQLODABMKGEHfXZWVNSIUdRYFc,BBEGKCDAGEBCHBADZGAC..VFFDIEHEdAGCFACD..gEDEhAAAeEEF.aBGGJCADhAAALGEGABIF.MABChAFAfDHC..NDCHSFBGhAGA.....hABA...,1,-7,-31,24
RMGfYCPAHTdDVWbKUXONFLEQcJBeagISZ,dAFDVADCKCDA.UEFHODFB..FEBBEEHB..QGDChAAABCBAeHAG..aBBFIGGChAAARGAA.MIEAfADAhABACBBCAGAG.DGIFbDCD.XDACNCAC.hACA......hADA...,2,-30,-19,11
HDVPcLQfOdYFGbMTWNBaUJAIeKSXgRCEZ,eEDAKDHB..SECGRACACGBFHBEC.DGGD..VCAGLBAB.hAAAOADEFCHDMHFGTGAEhAAABAHGUCDEAFGF.IGDChABA.ECGA.ZFGH.....hABA......hACA...,2,-29,-16,13
aHTgbOSXCUdcWeABNLMfPZIFKRGVDQYJE,BDGHMFBEZBAEKBBDGDDEDGHH..QGEBEFGHHDAG..TGAEhAAAgAFB.SDEEhAAACAGCdGCAeAFDNIADLABChAHAIACA.FDHFYFHB..hABAaDDC.....hAEA...,2,-18,-9,9
JSHMDIVfYQFWcegGALBKEaNTdZUOCRPXb,KACCaDDE.dBBAUBGDRCFA.....XACBJAFGHDCAMFBDDFFF..hAAA.IFGF.hAAAVBABfEHChABA.QFAEWAFCcGEFgGCBhAFAAIHEBFCGEDHB....hABA...,1,-26,-29,3
cTgaJdXUGeVSQKbWZfRAOLHDINBPYECMF,LAEFDFIFBFBB.EEFGFCCG....TGDGaAGH.dBACUGECeFBChAAA.SHAEhABAKEECZACCAEHC.HAFC.IDCHhACA.NDIECFFGMDEG.JHBG....hAAA.XDAG.hADA...,1,-12,-45,33
BEeVNUSXbcYKTLPMZgHCRFWGdQDaJOAIf,BBDBeFAGUCFGSDEC..XBDB..bFABKBBGLCAAhAAAPGFCMIAGhAAAgFFCRDAE.GAGAhABAdAGFaFFGOFCFAHDE.EAEGNIED.cABB.hABA......hACA...,1,-9,-16,7
SIbdPNMDAcXFafBTUWJgERYGHLZeOCVQK,XEDGFGEHBACBUCDA..JAACREAF.HDAFZAEA.eDDG.CAHGKFGDhADASDGF.dFFDhAAAMCHB.DCCGABIDaBAFhABATGDD.EAEA..LHAG..hAFA......hAGA...,1,-19,-33,14
NTYadgEIGSfebZQAcMPXFUDVKBCJWRLHO,MBCHFACEDGAABFEB..JAHBRDABHFCH.OCHF..TDFGhAAAdDDHEGGEGEDG.hAAASCCDfADEhABAZAEBAAFBXAGBKHAACBADLFHBaHFC.IGGAhABA....hACA...,1,-11,-32,21
QNRDOFVGbZWgUXBAHeLSMICaEYdKPfJcT,HDGFeFGHMAIBCFFG..EBBDdCEAKGDB..PACCJABC..QAFGhAAARFAFDCDDFCAB.GEAGhAEAZEDE...gDCFhAHA.BCHBAAAGSAFEIHHG.hAIAaHDG.....hBAA...,1,-20,-22,2
MCGHUOQYLRJEDPTVeZBdNXgWFKcAfbISa,..IHACMADACBBBUDGA..ODHBLCAFRACHEBFADEDBVEEHhAAAZDDFBDBA.dBDBNABG.hACA...XCEGhAEAFHCEAGGH.SAFCaBGA.....hAAA......hABA...,1,-16,-36,20
UdNJEHSCLMaYFDABeVRQTXKcfZbWgGIPO,BCEFVDBH.QABD.KHGGfGACZBFF..bEBCgGGDhAAAGFEDOADGhAAAdBAEJACG.SFDAhABAMIBCaAHFDHBEAIFETAGDXDDEIHDDhACANBAECCCD.YCHB.hABA..eCCG,2,-12,-4,8
gXJeQbYDPdKFMBWLaUHTONSVAEfcGIZCR,ECDCGBABZFBD.CGGCREAC..JDGF..eADEQAAHDDEAKEFDBGCChAAAaDCC.HAGF..OAEEhAAASGADAFEGfCAAhACAIHEBXBGEPDHD.MFIB.hABALHDC..hADA...,2,-24,-15,9
GgRNeUIcfBAOVWJKbCEZdMQXSLaHPTYFD,VDCBJHBE..CDAB.dFHE..MCECSEGDLFEEHAEG.TBAChAAADBCFREAC..eHEChAAAcFAHACAE..OAEChABAbFEHEABE..XCGEaHACFCDA...NEDD.hACAIDHHBGAD..hADA...,1,-8,-26,18
cKeYGZXJSRNLPTCAOdfWHQDbIaBgUVFME,dFHEHCCEQGAHDGEDaFBH.BGDAUGFDFCCA..MFFGEAGDKDADGACFhAAAZEFD...SCGGhABANAAB.PCAHhACACCFCABCAOFBA..fFCE.hAFAIAHA..hADA...,2,-26,-25,1
DOSLNbdCEJfKQYZVTXBFPaHRecgGAIWMU,MBBCOFFALFFBdCFA.CAEE.EDAB.KFBGQBGDZFDH.XDCBhAAABDHBaAFGeGAChABAGAAFAEEFUCAADIGESCDFhAAANEHC.fAHAYHAGFGEBhACA......hADA...,1,-13,-23,10
DJfTYBLQAPCSbUOMIHeaZVKNGcWRFEgdX,CHHGSABAUAGE.OGEGMECH..HDDGZAEAKEDDGAAARCAFFCHDdAEChAAA.DIDG..TCEDhAAABDHCAHFC..IHHBhABAeDADaEHD..cGAF..WGDChACA......hADA...,2,-25,-24,1
ZTFUXAeYNPSDCVJaOHcbdGERgWfMKIBQL,eABE..PCBFDCFEJEDAODDD.HGAAdHGHEAADRAFC..fDGGhAAAMDIHBHBEZABEhABAFEAEAFFDSEHHhACA.aHDEbFAE.WCDGIHHD..hADALGEE..hAEA...,2,-34,-1,33
TSHDBZCJcOYMNEKeaXAUWQRdfPFILGgVb,QFAEdHEHFABELCHDGBDC..VFBDSAFE.DAAFhABACDDHJBDGODGB.MBCHhACAKGEE.eHCAAFFE.WHFAhADA..fEAFgFGH.HFCAhAEAcBACNAIE...aAGAhAAA...,1,9,-44,53
FDXSNgZcVIKeAOUWYdEbTfLCBGJMQRPHa,OEGHUFCGdABA..TCECCBGBBGAH..GEAG.MAFERFFCaCDAhAAADABC.SAAGhAEAZDBG.ICHEhBDAAIAEEADG.fECB.JGCEPCGHFCCGNEIA.hBEA......hBFA...,1,-14,-41,27
TUMgBAfRZLSObKdHFPXNCWeYacVQEGIJD,ZEBCOCBBdCAHFGBD..XCCHCCEH.eAHHaDHB...VFDHhAAAEAGDGGEDDDID.MEADhAAAACFBLBGD.hABAKHFGNBBH.WACA.QGAG..hABA...JFFC..hACA...,2,-30,-17,13
VgOMDWcUfFbEHZKBICTaGeSLJAQdPRNXY,QBDGdCCDRAFH..XDAGVCGFOAFGMCHD...DCCFUGEFhAAAFFDBEHBGKACECEEFaAAC.hABA.eHAGLCABhABAAAIF.PFHF.YFFDWFAA...hAFA......hAHA...,1,-5,-33,28
QBWVARfdLJGKYgDaTSbZXEHCePNIcUOFM,dAGBLCDHKFDEDHDCaHEG....SGHHZFCEXAGEHCDCCBBG.hAAAeBAA..NDHEUDAHhABAFEBGBFGE.AIDEfBDHhAAAJACG.gFAGEGAFPBFB.hABA......hACA...,2,-32,-15,17
TVQCaYDdJNFPIBOeLSKHfEcgMZRAGXUWb,GEAHXCFAUGEH..TEEACABFDADH.JGBCFCHD..BCCAODDGhAAASHGG.hAEAfAFCEHBAMFFGAGBDhAFAVAACQAGF.aBECNDIEeDAGKCBF.hAHA......hBAA...,2,-20,-16,4
bfcVFdgHUPESeaJQGXZCRMKINOLYDWBAT,TBDD..fACGFFADHAACEHFEeDDE.aGBFJFFA.QCGGhAAAZAGHCAAGKAEFIFGGhABAOFDDLDAEhABA.DAFEAFADcGDB.VDAA...hADA......hAEA...,1,-11,-20,9
QGWRfBVAceESdIXaKYbCJTLgZUONDMPFH,eBBEdBBCaECHKFDA..CADA.LAEAZAGD.UDFCDFFEFGECGDAH.hAAARGAABGGCAEEH.SHCAhAAAXGAGJAFD.hABA...OFHDMIDE......hACA......hADA...,1,-20,-43,23
ebNXDMScJVRUgIYaCZLTdQPGBFAfOHWKE,HAFHEBDA..eBHBXFEAMDDC..SGCHJBBBUEAH.IGFGhAAAaCHBLADF.hABA.dBBAPHAABEGEFHAGhACAABAFOFHFKEAANADDDFEG......hAIA......hBAA...,1,-16,-20,4
WYDNcCFMIKTUbHJfESPRQOLgVXGdeZAaB,aBHDBFBG.DDIFCEBD.FDCBKGGD..UFDBHBCD.JFEB..EAFESGAChAAARBDC.QAFEhABALABCXGGFhAAAeEDFAHBH...NIAF.cCAA..MCHFhAHA.....hACA...,1,-31,-34,3
KJOUWZLSQXTIVPNcYEefDRGMFagdHABCb,CCAHKAHHUGBBLEDE.QGDE..ICDDVBDC.hAAA..NAEH.EBAAeGEGhAAAfFAADACHGCFEhABAMCHH.aDBGHDBEBHGDOBFAWADESHAAhABAPEHF...hADAcGGA.,2,-18,-10,8
GYRELaFUefSKTgCAdZHQDMWOPcXbJBIVN,ZGAAHAEBMBGBOFFF..XEBGBHAGICHEGCADRFFGEDBGaBBGhAAAFBBC...fDFChAAAKHEECEEAAABC.DCAFPAEFhADAJEBH..YFHF.LDDHhABA...SAGGhACA,2,-27,-7,20
TPabWQUdNDMHGgeXEcKIZFAJSfYRLCBOV,SDABRGBGBGFA.OCCCTEEB..aDHBQDBB.hAAAdABDMFABHAGBeGDGhABAEHGAIAFGZFFAABIBYHBAhACALCCECBGGbABANEAADEGG..XDEEhADA.....hAAA...,1,-6,-14,8
UAbgBZRLFJKQfWeXOSYTVGCHcadPMNDEI,BDFAZABBRCGHLBFEJGCG.KDDGQABB.eEBESFFDhAAA.TFAGhABACHGGaAGFdFAGMAFADBIBIGDAhAEAACDBFFHF..XAEH.OAAHhACA......hAEA...,2,-32,-24,8
eQAZFCaHVfcDJIdgbKOSNYETUGMLXWPRB,ZEABFFBDCADCaGDH..HDGF..VCCEDIBAdGEBKAAD...SAFHhAAAEFGEUCFGLAEChABA..XCBEhABAPFFBBHHHAAHAJCEHIBBE..OCHFhACANIED....hADA...,1,-20,-30,10
GVIagCcDLKBJeYPfdMTSFRWUENbZAOXHQ,OBDEHABEVFFE..IGGBaFAH.CGBG.DDIHLFHHKCEHBHEDhAAAeDDG..fGBDhABATGDGSABGhAAARDAG.EEACbBFBAAED..QCGAhACA......hADA...,2,-24,-19,5
CVMRALQbTgZKeFJNDUcfdWSOXHEYaGBIP,LCFBTADG.KDBFJCHFDFIF..UFEHdBCCOHDEHCCH..aHFChAAABAEECBAF.MEHHAFCFQAGDhABAZFDCFBAB.NIAH.hACA..fGAF.SHCChAAAEDAE.IDEChABA...,2,-36,-12,24
FAZUbdMKVGRYEeLPONgcHWQITfXCDaSJB,UDGCMAEFKBFBGAEB.EHGAeFAC.LFEGODBB...gBBChAAAHFCA.IBHEhABAfAAACHHBDAFAhACASCDDBDHEZDAGdHEFYHAA.cGEDhAAA....hACA...,2,-29,-12,17
SNQfHFPGRTdEZCIVbJcLaAMXKgYBUWDOe,MCDAKBHHBEHAUBBCDDCF..OHAA..SEADQEADhAAAFAAAGEFGdDECEGCCZCEEhABA.CCAF..IAEHhACAVGEE..JADCaEHFAIAG....XBDGhAGA..YFEFhADA..,1,-7,-43,36
dbSTKEWZGOFLaeCMYIRfHVgJDNcPXUBAQ,dBEGSBECEEEAZDBDGGCBOFCH..FGEDaABA..eAAB.MBHBhABAIHHEHDFBJACBhACANBBA.XDDBBBHHAAGE.hAAA.QDGGKEAFCHGF.YFAFfGAChAEADGGG.....hAEA...,2,-20,-4,16
ZTDSQKBRUYNVWcaEOGAbgPfXdCJeFILMH,...PAEAdEGACBEGFAAFLDFBHCBCZFBADDADKBACBCFA..UGCGhAAA..NAED.VDCE.hACAaAHDECHD.AIFC.fFHGhABAeHBEMDABSBEG.YHEChACAWGFG.ODBHhADA...,2,-26,-23,3
ZEgRWKNIHOBUGXPbQaCSJFLecMYDAdfTV,dGBFTCBDZDFBEADG..RDGDKFBHHBBFBADAUAGGGAEG..PHEChAAAQEDH.hABACHCASAAGhABAFDEHLEHDMCADAFAF...fAGE.hACAWAHB.IHHAhACA..,2,-19,-13,6
XCNbSMYWOKJVdfUgQFGPIeDELBATZHacR,HEFFaECE.RBEBCHDH..SCAHMACF.OBFDKDHDdDAEUADDQDCHhAAAFGABGFEFeAHBhABAEHBABGBBAEHAZABF..hAAA.NIDB.WFHH...fGAEhADA......hAEA...,2,-21,-13,8
DXYQOHgGAULbPNfFZeIERSMVCBKJWdTca,UAACLBAB...bFCAPFEF.FDBHZDEC.IGGChAAAEAFBRCDB.MFAHCGAH.BBGGhABA.KEBAJCHHdACCTGGBhADADCIHQADA.OHBA..hAGA......hAHA...,2,-34,-12,22
LPdOEGYeQIcBFNRDZXCbAgTVUaSMKfWJH,VAGBSFGD.MBIFKAAH..JDBFLAFD.OEDHhAAAEADEeFEFQABHhABABGHCFCCEDEFHZDFACBGDADAD.TEAAhADAaGFDHGAAdHAFIHEANCAA.XCCAhAEA....hAHA...,2,-16,-16,0
bYIeAaWHcMdOfgXTZGCPKLQJVBSUFNDRE,HFAE.dFEAgDFBTDBA.ZBFAGBDBCGBCLECEQAAGhACABAFBFCBANAIC.EACGIHHHhADAABAF..aEABhAAAMDHDfGHCPHBCKDFBJHDESHAAhABADAEA....hAEA...,1,11,-21,32
fdEFLNACDQUWXBMJKHOGRZIYgVaceTbSP,CFGEUAECBDEGKBCHHAFGGBACZABD......IECDVFFGeHEGhAAASGDHdAHEFDGCAEEDhABADGAE...XADHhAAAMEDDOEBD....gDGEhABAaHBC.cGGHhAFA...,2,-41,-13,28
NFcCMYGHALbRSWVafeOETDdPIKQJXZgUB,LACERFDG.SEGGVDBCeAABEEBADCAB..dCHGKAHFQGDEhAAAZFAFBDHCFHGECCDCMABHhAGA.....hABAYHAAAFID.aGGCfGCG.hAHAOCCAIEEC.hACA...,1,-13,-36,23
TIFDVHdNGOaBeKMRCUPXSgYALZEfQbcJW,LBECEFGA.QFDBbBBG.JDDCIGCD.DDAHdCAHhAAAOHACeEABMIDGhABACGFDUBFDSCGGhACAAGEH.fHGDTDFAFACC.NIEFBDDHKFHB.hADA......hAEA...,2,-21,-17,4
WabSYXdDcTZLGeVfQJgERMBNIUOFCKAHP,HAGBaGDG.SGGDdDCFDFAGZADCeBBD.VECBQGAG.hAAAJDFHEBEA.BADC.hAAANEICIHEFOBBCFAHFhABAAACHPDDG.YFAFTCGHfHGDhACAMBADCFFF.KFHB.hABA...,1,-7,-20,13
eWIQZdPJFGgBMKHLYANXfOTcCaDERSbUV,XDBGOGBA..TAAHCHAC..aGDARBEHUGFG..eHFChAAAQCAFZCDDdACCFBGHhABABHBFMDIFKECALAEChAAAAFFCfAGDDEIBSAHHbFBH..hACAIAEB..hAIA...,2,-24,-16,8
PZMXONdEHICWceSaJRbYgTAFfLDGKVQUB,LGEAGEECQBBABDDGZBAEMCHDOAEAdFCAECGAHAFE.CABG.hAAAWEBF..SFAHhACAaABGRFCD...hAAAgDACAHGEFBDEDDEF.KEFF.....hAIA......hBAA...,2,-17,-13,4
fLPaUXYgIWDQGHceNRAVSdTZEOCMbFKJB,VAEFTEDE..OHDACGHA..FGADKHAGBBDGLCACUAFD..hAAA.XCGHIHEFhAAADEFFQEAHhABAHDADcAGFeABC.NDDHAICGSABCEFGA.MDEHhAEA.fGGDhAIA..,1,-8,-29,21
cICAMYTPfQZHJKUEBeGDdLVbaNRXWSOFg,MCDHTACF..QGBHZGAGKDEEBGHCDFFELEEF.aBGAhAAANCAGREEC..SADGhABAFCGA..IFBFhAAACBBEAGGAPCEAJCCFeHEEVCABXDGAhACA.OFAB..hAEA...,1,-13,-26,13
KOHPDAcEXRYaWNFTLCVbfJgeQGSIBUMZd,XBCAaFHH.FGCCLEDB.CAFF.fABDeABAQCFDhAAASFFEBCCAUCFAhAAAMBABZDABKGBCOHAChADADAHDAEIFEGFH.WCAHNIEHbAFA.....hABA..JDDF...hACA...,1,-5,-26,21
bgGULcNeFIACfdJMBWSRHXPKQZTYDEOVa,CDDEdGHABHGBRCFFHECD.KCDGQEGAZFAH.DEFFOHEG.aACFhAAAGAFE.UFBGhAAALBAFNCAH.IAGEhABAAIAGMBBG.SAHHPHDC.ECBBbDAG.hAEAeAHB....hABA...,2,-27,-5,22
DGZeJFVCXRESbAPaYQIKdUNTBOfHLWcMg,aDDDQCBE.dGAATDBBOFEELBDEMFCA.DFADGAEGhAAAZGEEeCGHFHFACEHERAADSHBChAAAADHC..hACAYCAFKFEANAEF.BABA.fAHEhABA..WHFAJHCC.hADA...,1,-9,-17,8
bDgUXIBFdAGJeCMQHaERcVTOfNZSPWYLK,GEECJDAB.eHACCDDHHADEaBCB...EFGBVEAE..OHCGhAAAfDGBSDGBhABAPAEDLCAE.hAAADEIHgAGCXBGEIFDGBCAFFHGAAIDGhABAMCFB.cFAEhACA...,1,0,-28,28
TedbOcfVGAFCNZPQSEKLUBHYMRaDJgIXW,FBGAZCFGQFFFKFBGLEEGBAFCHCBAMEAADGHH....IEADhAAAXGCC.TAGFhAAAdADAOGCE.fABDhAFAAIHECCABSADBEHAE.YBAChABAaDFG.WDDH...hAGA...,2,-23,-20,3
gecBHSDVYaLNbIUAdMPEOCGQZXKfWJTRF,dDGCECDHGFABQCBAZBEFKAAD..JADEFDAAeFEFBHEFDBGG..hAAAaBHBLHAG.hABAIABHAIGGMFFECBCEXGGHhADA.WCFC....gGGEhACAcEDB.SHAGhADA,2,-38,-25,13
XGJHUFWgTAcQdOCBELDPfZVYabeKMINSR,QCCFCBCBLECADEAHZEBH..aEFFKHBCMACA..SCAAhAAARAGFJHFA.HGECFAADTFDDhAAAABFDdDGAEBGA..fAFAhAIA........hBCA......hBDA...,1,-18,-36,18
MVIJRfgdYcAbCODFPZLSeEWUHKQaNTGBX,CCAGFAABLCFFeECEUGDAKFGB....aEHFTAFG..XEBDhAAAMHFG..IBCHhACARGDCdHADAEDDDBAGZDFASFAChADA.EHAGQBCHBCHC.hAEAfAEH.hAFA...,2,-31,-24,7
aHODYRLZCIeNXAGFBJSTfKMgWcPUdbEVQ,FGFBSCFHKCCC.MDBH....gGCEPAHDdHGDEDEAhAAAaBBEHAFA.DEADLHAGhAAACDAB.IFGHhABANBADAFFEBHAFfECF.WAEC.hABAbFCE.....hACA...,2,-39,-11,28
KBAUIgSeVJYNHXbcQZWRPCLFGOMdETfDa,UBAESCCCeGAC...JDEDHACF.XFFHQFGCRCEFCAGFLCHFhAAAOBGFMEDFhAAAdEAFEEDBDAFHKGBDBHBAAAIHIACBhABA.gEACNIDD..hAEA.cGDE..hAGA...,1,-3,-35,32
ETMWDLKOBUgSGFReZPXaVcfCdJYQNHbAI,TGGBMFFFLAAH.KCEAOECABACFUGGCSAGE.hAEARBBCeADEXFBCVBGHhAAACDHGdAGGJFCF..NEBAAIFEEDCHhAFA..DBAF.FGEGPHBE.aEEB..hAIA......hBAA...,1,-6,-24,18
agJTcBQUeFZIDNYGHAKdLRSCWMXEfVbOP,KDBALDEGCEGF.MFIHEFDA.....fECCOBBEaAFHJABAhAAABCHFUAFD.eEAHhAEAFHFCDCAHGGCFHGAEADCGdFFDhAGASAAA.XFGA..hAAAbBBCPDDA..hABA...,2,-35,-3,32
QDIgUXNdWEKGVROYJZaPCSbFeMALTHfBc,LBGFHCEBBGDFQDDGDACAUFGFdBBHKHFGGEBG.VBAChAAAOBHH.JFBDaAEG.hAAASHDCeAECAIEG.hABAfFFF.IHAD.NEIAEDADhABAZCBE..CHHG...hAIA...,1,2,-27,29
HcRDaICLOMVYXSbPUgeTAKNFfdGQZJEWB,KGBBFDCBdDFCQDDGZBEE..EBBFHAADDAGG.CHHBLBFA.hAAAOGDAMACGXEGDhABAPEABUACE.eFFEhAAAAIFANEEE...fHDBJFBF.BEBEhAFA..aDHF.IHHAhBAA.,1,1,-38,39
TDPJFeCfAGSZBgUVHEOXRMbLYcKQIaWdN,GEADSEFCBGHEUAEEHBDG.OAACXDBGREEHLHBGhAAA.KHFGIHGChAAAdDGDDAIDFAGFCFHEZDDF.gABHhABAECCBMACC.YHAG...QBGGhAHA..hAIA...,1,0,-29,29
KdRHDQPOIVTBgfEAZGaMUcXeJbFCYWLNS,aACCUAED.eDDEFEGE..CHGE.LAHB.KGGAHDCBDEEFQFAFhAAAIHACBGDAEHBCZBAHhABAGBDD.XEADhAAA.JBBF.bFEDWHFG.SFFChACA..PAFAhABA..,1,-14,-26,12
EeJATFgUVPdcNKWDIQaOCSGbXZHYLMfRB,TDAGFGHBUGAD..dGADKAFHDGFF..QDFECBBFGEEBZAFDLCAEhAAAMBIB.BCECECDDAHHAhAAA..VFDA..hABAcADFIDBG.aABESHCAhABA......hACA...,1,-25,-27,2
eSMWFgfQILUVDOAKRYGcTbZNPEJaXHdCB,RFFBGEBC..TCEHbACF.ZDAE.EHACJFHH.HDEHBADHSAGBhAAAMEED.FHDGfBBGhAAAIBBCLFADhABADICGKFBC.cBEAPDHB.XAGDhABAeBHH.....hAFA...,2,-16,-8,8
TFCERgbZSOAJaIULNGDWcXHYKfPeMQVdB,aBABUAFBLBFBGCCCDIDC..XFCBHFEAKDACeFFG.MDCGhAAAVAAGBBHFFEHFCGAFEDAFhABA.RFAB.ZCFGAIDGJBCA.hAAAIHHH....cGAEfHEBhACA....hADA...,1,-12,-17,5
aKGXPTBfICMdFZcgOHSYNJbLQEDVRWAeU,UCAAGFAD..TBFFICBD.CABG.FHDAZDBGODGFHDFGSGFAhAAA.JADChACAQCDGDIAC.hAGAWFBBAFGFeAHB..aFEA.KGAF.PAAEhAAAMFID.dAFF...hAIA...,2,-21,-15,6
QRMZbdcEXUfLgWYAaNFBIDGSJTPOKCVeH,aCEGBHGAGFBHSFEA..JCAATEBBKGFH..CEFCeEHHhAAARACEZDEGdHBD.EAGGfEAChABALCHHWBADhAAAAHEBFHAGDAEE..OFABHABC...MDCAhABA..XCFEhACA...,2,-21,-7,14
SDTaLWHRCdYgEJbFBKcIMXePNZfGUOAQV,QEFESFGEDEAGLBFAHBDACFACdCCE.EDAAFGDAKADE.MIAAhAAAXAAE.eEEChAAAZGDCfABDhAGAOHAGTGGHaECE...WCFA...YADChABA....hAHA...,1,-11,-25,14
JMPTacUEgRLeSfBYbQIHFNKVXOWCdDGZA,JEFDTGCF..aDDGEDBB.LHFA.SEEHfADAhAAABGABQCGFhABAHBCGNAEFKCGAXFCGCAAFDDABAGGFhACAMEID.PHCE.gCAEhACA.eAFA.IHGFhADA.,2,-29,-13,16
RYbXACfPSEaLTcUHgGDFBWKVeZNQJMIOd,CAAGSGBFLDBDUFDHHGCEGEGC.FAFDBCECKAAAeCAFhAAAQAGBMCCFdEDFRDCE.hABAXACBAAEDEACFTCFHhACADAIH....WAHDNDIEOFAH.fGGGhAFA.aHEChAHA...,2,-24,-1,23
RXWSGNEBQMLOUcgHKPeIbfDZVCFadJTYA,RBBCSBBGEFFF.BDGEQGAGLBFGOBEDUECCHEFBhAAAKHGAeEBE..IDAGhABADDAHCAHCdDGFTGAAhACAAACBXGCBNEIA..MIDE.PAFGfEHEhAAAFACE..aDDA.hABA...,2,-22,3,25
TYcFBVIKZLWgJPOaNMAfSHRCDQGdeXbEU,SCEBREEGDBIBGDAFeEAD..EHDAUFGB..TBCGFDDBICHChAAAKGBHZAFFLABChAAA..JABEaAHBhBAAAFBACEGEdHGDXGDC...bBACBFDDhBCA......hBFA...,2,-23,-9,14
TYKfQNMICcJRgLEbFAWZHOUeSVPdDaXGB,ZFDHHBDHeFCBVFDBdFGCDBHHGDDH.BGAATGAFKADF..QCADhAAAIEAHCGGERAGH.ECAChAAAABBE...OACGhABASHGAaCFD.fAFAMCIF...hAGA......hAHA...,1,-14,-17,3
UDBSQANLVRJaCPOgIfYebdHFKWETXMcZG,VBACJECE..CBBG.OFHD....IACCeFBGdAFDHFFChAAAKDFGEDDBMAGDZFFHDCIBSBGAhAAAACDA.RADDaHDGhABAfHCD.bFBGTGAD.XDAGhACA...hABA...,1,5,-49,54
gRfDGXJZETVCNOSLBMHQIYebdAUWPaKcF,UAEAaCAG.FEBERDFEDDEFGEGA..ZAFEEGEDCBDE....OFFChAAABACDMAIHHEAEQGABhABAeBABAHBC..KEFFhAAAfHDHXDDB.......hABA......hADA...,2,-30,-22,8
FMJdQYDWXKgEGbBcPfSAUZOVTLCaeINRH,UGAFVEFE.LCCC.eBEERAAGMFBDQFFFDEABKCDBGGDDhAAABHEG....fEADhAAAADACZCFCCDCGaAHDNEEFFABEhABA.dDDG....YACCWAFE.hAEA......hBAA...,1,-19,-21,2
gJKLIPBTNUHcObEZVFYWMfDXeCRGQdaSA,KGAHLCDFBBDHUEFFHFECOABH.EAEDFCBF.MEIHDDGAeHBEhAAAGAFAdHFD.ABGFIFAHhACA.NEEB.bEAEhAAA.....YABEfAHAXDDFhAFACACH.aGGH.SHDAhAHA,2,-27,-22,5
bgEVJaFRCIZBfGSLKcANXWHUdYPOMTeQD,XDCDHDFCUADDdHEDOGCE..TDGBeEAHQECGhAAADABDEACA.aCBCCBGEBGCGhAAAfFGESFHHhACAKABBAIDE.NCCB...WAFHMEBD...gEEBhAFA...hABA.FBHF.,2,-20,-13,7
WNBZgALDTFPEQfeCYSMHUOdabRGKIJVXc,DGACTFDHEEEB...eAECSCCBHBEGUCAHdDAARFCFKHGA.JDHHXCFFhAAA..cDEChAAABABHAIAC.PEHDhABAfABH.CHBAMAIHOHEEaDCDbAEG.hABA......hAEA...,2,-19,-13,6
YJGBWcCTXIKSLeDbROEaAfHPZMUQdNVFg,HGFEZEAFMAGDUFABdBBAFAEE...JBCDGDCABEGG.CHAG..XADGhAAASFDC.DBABhAAAOGFG.EEEGAIDA.hABA.fDEFNIDD..gCGHhABA..YBFGhACA.WBBF,2,-34,-26,8
IgLdSKPBNAFUVaTJceMGDQORZCfbEHYXW,UGEBVAGB...TAFFeDFFDEAB.RAAG.CEFE..EBBHHEGH.XECBhAAAIADFLCAAhACAKAAFBFAAAIDCFFBDaCHHMDCEhABA...OECEfBEE.hACA.WHAESGHHhADA..,2,-39,-5,34
AgWcSYHFXReLBaKNIZEdTUbJOQPCVfGMD,....gBEFSFHBFFFERDEGBBHGaDCD.KBDDZBAFEBEETGAFhAAAJBAH...PHCEhABAfFFEGAGCAFAD.hAAA..YACEHGACeCCDIHHGdGDE.hABA.OAEACEEH..hACA...,1,1,-17,18
WFZNMSUfQAePbGRYXLKOCJDaEITBVHdcg,eCBCGCCDRGAGLEGFCBDCDGFA..EAGBTFDBBHEHHFBC.dABGhAAAgCGEFEFA.hADANBAB.MIAGUEABfEABhAEAAIAA..YFHHKCHBaFAHIHHAhAFA..cDDFhAAA.WADE,1,-11,-19,8
TeEaWdcRKHSCBGOfUbgDZMPVFJYLNQXIA,TAGEaBEE..dEDGKFCHSFFHBEFDODAAUABF..DDEGMAEAhAAAFHECLEAFhAAAQCGDAIAA.ECABRACGGEGGhABAfEBA.ZFGD.PHBC...hACA......hAEA...,2,-24,-7,17
PTNASYMOJHCDZBWdXGaRQVgEefcLKbFIU,MFBFHCDEDAFDBAHDdEADGCEFQFEH.EAHBfFCEhAAA.LBBDKBBBIHCGhAAATGGAAGBASABEhAEAJDDFZFEBXADDRDFCeFHH.FGAHNCACCEHG.aABAhAFA......hAGA...,2,-8,-3,5
gAPZOfbUFLYeTQRXWBaGVCMcDEKJNHISd,OAAHUDCBFBGHLEEF.eFAFQADGRFFEBEBEGAEDhABAMHEADAACJBBCHFCD.IGABhAFASCDAADBBZFFAhAGAfCGH..YCHBXDGEhACAaHAECHFH.EBBC...hADA...,2,-14,-8,6
YSaXVNKgeEBPDRCbTMAGFHOfWIUQdcZJL,FHBCOCDE..IGDDUABHQGFF.ZAFAJABGSDGAhAAAaFEA.XEABhACANBEDKFAC..ECGHBEEAhAEADCEE.CHCCMFIHAAHGHFGFfGAGdDDHLAAFhAFAgECF.hAGA...,2,-26,-11,15
RLBdaUNIPEXJYZFgGTWHbfQCAceOSVMKD,eDCHSFGEKFEADIFCLACE.aDDEIGHH.EBCFXCGChAAA.YHBEhABAgBFBGBBFhAGATGAGbEBGQGGDAAFEOBEBMABDBHEANCAE.hAAA...PEFAhACAFAHB...,2,-32,9,41
RVfHDIGWQOLXJSZgEbNAUFaBCeKMPYcTd,FGAABAGCCBAA.MGCE......PGDCTACA.dEAAVDEGhAAADICEGCAD.OEEAhAAAXADDSEHHhABAZDAGbABF.AAIBeCFEKBFE...cGGHhACAfHGF.WAHHhAFA...,2,-42,-16,26
RVQHAgFcdTZPLSUXCJfDONEBWbIeMaYKG,FFHFdBEBZDFGLDBEUFCE.CHHG.DFIF..ECGABBAH....bFBChAAAMDAC..aAEAKGAChAAARABCHDEBAHFF.gGEAhABA..PFGBSHAGJAHDOABGhAFANCAAIECH.hAGA...,1,-3,-43,40
HOWQPJacADLdBbRUEMGeCVKFTYZfXINSg,DIBGBEFGRAGH.ECEHGFAB..eGBACDBBKDECFACH.ZAAH..XGFBhAAASAFC.HCGBhADAQAEBaHGAAIGEdEBBhAEAUABFMIAE..YCAF.IHEDhACA.OEEEhAFA...,2,-29,-13,16
gAHdBWTJZKYfMFLPGSONEQVRXeCcabDUI,dDEBBDHFJBCCKEDH...MIACLFHDGCBFSABD.hAAAEGCEQGFGhABA.XAEBeFAFcAFChAAAaAGEDBCGUDABACHGWCGDZFEBfCHAhACA...FHBCNEIACDAGhACA...,1,-6,-34,28
QdMDEIaXLbSfKNVHeFZPYJGWRTCAOBgUc,BFFEUBEAdCBHMEDHDECA..aADFLGEA..SDBHhAAAKFABHAAGFHBEPABB.hAAAJCHDREFAAEAG..cGDDhACAECGG...XGAGNIEF.eBEH.hABA......hADA.YAFCWAFB,2,-24,-17,7
OPUXQcaEgDWSIHBFKNCZJbeALGMfYdTRV,GCCBMHAAdCDBREADOEHHUGFB...QGEHaDAH.EBBHDBBFhAAA.SABBhADABABFFADGCCHHJCGDAEFBLFCBhAAA.TAGDXEBF.gAGChAEA.IEEHhAFA...,1,-7,-38,31
BYZCIMcfbXNUPHSaFgLTJKRQdDVGWAOeE,OFCFBECHCHHF...MCHF..bAEHXBEAUCAD.HDADaFFF.hAAAFGGBLHBEKEDEQBCAhAAADGADGCGEAABF.hACAEFEBIAHC.fGEESABEhAEA..gGAGhADA..,1,-9,-30,21
JKVRFIAHCOZPUYXNSLQafWMBDgTGEbdce,HBGFZBFCUGBAXBCCLEDAQFAH.aHFAfCDDhAAABAEDTDEEGEGGdAAC.hACAeBADJFCAKDAGFBBFAAGFOHAChADANEAE.SGGEDIECEGDA....hAFA......hAGA...,1,1,-8,9
EAfVHTDJcGdUMLXZbWBYCKNQSgOaFIePR,VBDETGEH..DHGGJAFAGFAH.dAAHMAEHLHAAZDEEBABDhAAACFHB.QFBHhACA.OCCDFDAAIEFDhABAPDAHAGIH.fFFBcAFA...hADA......hAEA...,2,-33,-18,15
APRDcBVgJGIUbfFMXdNKZYeHQOECaSWLT,DIEABFGG.JCGHUAGD.FBDBdCEEZAEHHCBD.EAAECGEC...aEABLEDChAAA.AHCE.PAHDhACARBAH...gGAAhADAIHHAMDIFNIED..eADA.hABASFHH.hACAWEDD.,2,-38,-30,8
gGADVLTNfeURMXWOcEFaHBbZCIYdSQJKP,LAACTDBE.eDCCMIAEOCGF.FEAHHFFFBFFACEHBIAFGhAAAdHAB.QBCBhABAKBBFPFHFAIHCVEDDhACA.fBGA..XFCFhAEAWEAD.cADE.aGEChAGA...,2,-32,-4,28
fWOCZbXeJPIdQgLSHGKEYBTaVDFRNMcUA,OFCCCCGEZBDB..eFFAJADB..dFHCLHBAHAGBKEFHBBBD.aAEAhAAAFHEA.MFAHAFCA..hAAA..bCEDIBAEhABASCHHEGBBTDABDGIBNDAC...cCDDhACA..fABBhADA.,1,-16,-36,20
RfSNTALecHGPgMXBDObaJIEdQWCVKZYFU,LEEGeFCHHAGHGCEHMADFBABDDAFDaEAFEGEF..dDCACEAEKEFBZGBEFAGGhAAARCDH...SGHFhABAACFA.PBBChACAOHFE.IGAH.WAAD..hACA......hAEA...,1,-16,-25,9
WKCfDdEHVZXPaYUBANeFcMTGJbSOLQRIg,eBAAFCGBMBCCGCEG.SFAFOEEDRFAE...IGCBhAAAKDAGCEDB.DCIFdGHAEBDA.VGFAhABAXBAC.aBHFhAAABBHF.AHEHNADB........hACA......hAIA...,1,-17,-36,19
HfKPJBICUWQXZeVScADdGTRLbYMONaFgE,dADARECDLEAHMEHF.OEEEFFBBHAGB.KFECBGHAUBAFQBAFhAAAZBED.eAGBSGDGhAAAACEDDIFE...hABA............hACA......hADA...,1,-31,-34,3
SgUOLMETRFAVfHYdCPIcGaeDWXQKJZBNb,VFFGHGECCECE.....PBGBIDBFGADGDDFE..XFBFhAAAKGAAZBABBFEG.hABANDIA.gAEFhACALAAEMIAGTAGCAFAAfAGBcCCFaEGAeFEDhADA.WEAD..hAEA...,2,-28,-7,21
GeOTHUcRXNBZfASMWbKEDPLYJdCgaIVFQ,MDDBKDBBDDFBLAHD.dEFAaCGGFEAGeDDDHADH.UBAERACABDHHhAAAAGBH...SHAAhABAEHGEJEHF.CGAGVGFAhACAOFDD.....XGBD..hAAAfHDD.hABAPAFG.,1,-8,-31,23
TDWVQPKEIHcJdASBZMfFXbRLGNaCOeYUg,SFDCMFEFFCGG.RCBBLGCAGAADCECB.OBHFUGAD..DGGEQGGGhAAA.EABChABAIHFAHADHdGAGAEAHBCDChAAAZAFHfEGD..NBFGaDAF.hAHAgDGA.hAIA...,1,1,-32,33
KcaCMGIWPDbAfNZUQHJOeRVSFBXdYEgLT,ZFDGQABDJHFE.eDFBREAC.FBGHBCGEdGAA..EECFLAAFhACA.KBCFCHGEMBADGDDBhADAIFHHDICC.AAHFfBEChAAAHAEASEHH.XGAChAEAgDAH.aEEH.hAGA...,2,-19,-13,6
KTVRdMOaJbHNDGFXgWUcQAefZLCSPEBIY,eDAGZBCDCGBA.EBGFBACCKEHH...RFDB.MFBF.OFDHaGAHHBFEDAADFGGFhABA..XEEFhAAAUBCGAEGDLFEHhACASGHBIAFDTEAGdDHCNEAG.gBABhABA.WAEEfCHChADA.,2,-20,-9,11
FHUCINYdQJBfMWKReODGcZLgSEbTPVaAX,XACHUCDBCCGE.....IDEHdCADBAHAMIFCKFBAREFEDDDD.hAAAZEFBLHEEEFAETCAEhAAA..aEAGAIAEHGBGhABA.NCIC.JHACfAGGOABA...hAFAcAEC..SEEDhAGA,1,-23,-33,10
RNfUPOTXQHeMJdgBFbaGISLVYDZECWcAK,RBCDUDDHOCAHQGFBHECC..eHCEMDBDJFABdBBD.BGCBaFGA.hAAASAGCLABEDGHBhAFACEHDAIDE.KCEE.fDGFhAGAXCFFbADF.....IHBFhAAA....hABA...,1,-8,-33,25
MXBJQKaEZYWfbReGPgLNAOdFcDUHCIVST,OAEAdEEGFAFDDDEAHECD.CCCA...SACBXFGEBBDBKGHFZEBFhAAA....YBHHhAAAfAHARCEFPHDEhABALFAD.ACBGIHFATDAD.JDGBaACBhAIA....WBAFhABA...,1,-9,-40,31
XWUCJbREDHTBZKAecSOQgNYfaMFGPdVIL,eDDHSCCBOCCHQGFC..NAFA.aBGGMEAHFEEAGGABhAAAdFGGLDHBUDAGCBABhABAJBAFEAEHDBGEBDGEAHCF.hAAA..YFHHfGEGIFDA.hABA.WBBE...hACA...,2,-20,-13,7
DeMHJYPKSGNFcTaZRBCLdVOfbXQWUEAgI,DGGFeCDHMDEGHABH.JGFCKAGAGBFE.FDHDaAAEBDABdGAGOBEChAAA..fFBAhAAAQDCHEAHHAIHA.IAEAhABASEHFcFCDZFEBCAEC....hABA......hADA...,2,-33,-6,27
QUgLaBYOWAXCJTfEVNDbMPSKHcGFIRedZ,CGAATFED..EDABDAIDMDEFKEHB..HABBGBBHRAEAZDEEUDGBLFABhAAAaACA.BGCHOAFEhAAAADDA...JFGBfCFHhABA.NIDDSDAGIHDD.hABA......hAFA...,2,-33,-10,23
ZdWUcNbXCPBRgDAfILFSMTQVaOYGeKHEJ,LHEEFABFMBDD.VEAA..aBFE.OEEGeEEEEADD.dCBFUDAEhAAA..NAHCCAAABGAEhADADDIF.AAIDSAEGhAFA.TGGD.QGDA.hAAAKCHBZAEFWHAGXGAGhACA..,1,-15,-30,15
RVQJGASDTCMKcLIeWbHEBPgXYdZfONFUa,SBEDDADEMDHHLAAHeDBDHBAC.EGFDBHAB..PBHHhAAAgGCGdGBDfFFBhABAOEFBFBFEaAFFQCCFhACAAFEFKEHB.IEBFWDDA.XGGChAGANIBF....hAHA...,1,4,-34,38
VDUQHCYdGRfMJcNIAOLaTXKWBZebgSEPF,OABAaFHH.KAFCBFDCZEBE.eFAH.SAGHEGGDFDEA.DCFBUGCFhAAA.HBBBdBCHfDBEhAAAMFFG.NCAELFFFhABAWBHH.gCGA..hACA......hADA...,1,-25,-29,4
JNKQecgUGFfWXLTPMRIECAaYSVbdHOZBD,SEGGVGDE.HCDDOAFGBFACJBAGQABE.eGBChAAAgDGGUGGCGAEDhABAFDCH.XGDAhAEAPBEBMFBBIDBCAFFAaHGE.dGCGDCIFNAABKGGEhBAA......hBFAWHAG.,2,-10,-8,2
BeGJRNTPMVQCXSOWEdIagYUALbcfDHFZK,LADE..bGECDEDFZCBHBCEBGAFERBAD.TACGMBHDQFFBhAAASBAFEAHDhAAAdHADaEEBUEFH.AEDEHEAFhABAFFBBeFHH..NDIGCAEE......hACA......hAIA...,2,-21,1,22
cAGHIZSJFPbVDgTdNYQUMCOELWefRaBXK,HEDCSDAEFFHF..VAGHTFFA.dAEGQBCBMIAEEABBLBHDhAAAeFBDaBABBDBAhAAAXDDDAGDDZAEHbGBANIED.hABACFBG..OHFE.fAFF.hACAKCFH.....hADA...,2,-10,6,16
fJcYXHDTPKedENBbaQASZLCGIMUOWVgFR,SHDACHHHGBCAUAFFOGAA...VBFFFFGBJGAG..XAAHhAAADEAF.KBDEdHDDhAAAEDCHBACFQFFFhACAAEEFZBAH.MAEG.WBHHfFEA.hADAHCFE....hABA...,1,-10,-29,19
cWUIVRHQCKBaXLPASJFbEYNZfeOGdgMTD,JAACFDAHEDCFZAEF...eACEdEFD..MCIBTFFF..DGABUGCAhAAAREBB.CGAABEHGLHDChADAADFA.SBDHhAGA..NAICfCBF.OBAGhABAgGGBIEEA.hAHA...,2,-39,-20,19
GIEfdVHAcPgRSJMTZYXLUFDWBObaCeNQK,...PEABRGEGJCDCZGACLEDE.UGDBFAAABDAH..OADChAAACBGF.eEGHQEGEhADAGBBCfHAFhABAHEBEAIAG.cCGFMAFE.....hAEA......hBAA...,2,-37,-12,25
ZKcgLVeNMYXUBRCAQSOHEbdGaPJfTIWDF,QCACHCFFdACBGDBAJHDA...IGHEFABAKGAGLBFEhAAA.eDCCMAFFXEEChAEABAGFADBDOAHFhAAAaFGD.PHDATCGCDABD.cCCF.hAFA......hAGA...,2,-20,-15,5
MBGSYKQFZXdNECLWRUJATbOIHaeDPgcVf,TEDAOCAHHEEF.aBDHeHCC.DGIF..gBFHhAAAfBGAMDHDBFAHSFBGhABAYCAGKFGEFHAGZABBhAEANBBF.CHHC.LAHH.WAAC..hAEA......hAFA...,2,-27,-6,21
fAPLgaGHbUQXKTONSYRBEFDceWZCJdVMI,LDAFGDDEUBDHKEHFOBEA..SFADBACADGFDeEDEhAAACDGGdBGBMACG.AGID.hAAAaHACQGFAhABA.NCCA.EFCE.FCGEWBBFZBBAIHHBhABA..fHCDhAGA..,2,-31,-18,13
OTBYDUSKbdMZEJNIcaQgLFRPfCeWHVXAG,TFFEBADEUEEG.KFCCMBBD.ZDEAECHBJAHB.....IAEBhAAAQBACFHAG.hABAfAFACCEBHDCFAHIB.hACAOHECDAGD.dFAGaACD....LCDAhAAA.eEHBXGDDhAHASHAA,2,-21,-21,0
RFTgceGVIEfaCSAdZKQOBDPHbULJNYMXW,dGGCQDAEOBCHDFCFHEDD.UAGFLBGFJBAC.MDAF.RFDH.hAAAgADG.hABAeFGHIHAGaHAACDGHACAFhAAAZBDFKDECBCAE.NCIG.WFHH....hABA......hACA...,2,-24,-13,11
PIEFDcXafQHKYWZTBGeANOJSUbgdLMRCV,OCDBUFFCdGCDRFAA...CBHD...IDHBFDDEDCBA...aBAEHDABhAAAKBEEZEEABADCeGEEhAAAAAGE...SDAFhABA..gDGEMICA.EAEHcBFDhACA.fDBChADAWBAF,1,-30,-57,27
JVeSXFaQbDEYgfcKRdPTAOIMGBNWHULCZ,OBDHGBEABGEHHGAGCCBGJCBH..eGDGFCHD.aAFFDGGF..EEFG.hAAA...fGBAhABAKEBAdBABAAEHNBICUACHZAGDXGGBhAAA....QAGFhADA.YDDFhAFA...,1,-3,-38,35
UBWXLAJYNODSfbIKgEaGCHZdVceMQTPRF,JEFCOEFE.DABBSDCC..IGCFKACB.aCDDHFDHhAAAZCAG.VAEB.MHAEhABAPAFGFEAHBHGHhACAXBGAAGGC..NAIG.fFDB.EHDAhAAACCGA.cGGH..hACA.eEAF.,2,-22,-22,0
VHQeTJKbELBGCaZWMNROXcAYSFIdPDUfg,FDFBdDDBDGIDUDBH....VABEQAGF.JADHbFADBHDFhAAACGEC.ZFGB..NCEH..hABA.OFCEABAB.SFADhACAfHFF.gDGF.hAEAeAFG..KBBH.hAAA..EGFH,1,-23,-41,18
OMWLDHRQgZCNVTGJXcEbSBeUFYfdAIaPK,aAECOAFDLDBCRBAGZEBF...CFHD...TEFGGGDB.XGAHhAAAEGHBBEAGeFDCFDEBdAAFhADAAEIDKABFMDDHDCADQCGGhACA..NAHE.cAGA.SECFhADAfADH.hAFA...,1,-18,-20,2
UASKWGYHVIDaQTZeCbdJNPcFXOgfLEMRB,KGAFGGEFHDBHDDHBQGFFeADG.CEEF.JDBD....NADDFDHBhAAAXDDG.fAAGhABAEBAFBBFBADDESGAAhACA.YAFCIGDH.aDFDZBDAhBCA......hCAA...,2,-27,-27,0
VaPOLUbECeRZDJATSQGIdNfHYFWBXcgKM,QAGAdDCHHGCCFBHBBFBB..XDFHKEFHaABDLCDFhAAAUADFCABHZEAAAHGG...SHAGhAAAIFHFfGDFhABA.cDAGMIFG...OHEChADAEGGEDAGGTCEA.hABA...,1,-19,-21,2
dKJFWDMZEIYARSOQPCGcBbfaLeNUXHVTg,RDEBSDEFOECH.CHFB.BCBB..aFCDLBHFUBAD.HACEhAAATEAHKGGCJEAH.DDDBhABAEFGE.AIDGQAEChAAA.GAGGfGEE.NIAFXBEEhACA...hABA...,1,-23,-26,3
VQAGXBUFNKYMCWILHceDOaSRgdTJPZEfb,BGBGFGDGKCGBCFBELDFEHCCGDEAC...SHFGdGAE..JAAEhAAAEAEF..VGFEAADEGCCEhAAA.XEGGhABANFCD.MIACIAHFOABDRADG.gAGEhAIA....hBAA...,2,-25,-25,0
YFTKLNVEgeXbUAIDROGcJSQdaWCBZMfPH,RAEEOHACGCAB..SEDCQGGBaDCBBGEA.MFCHfCAChAAAHDFGFEAHLHEEhABAEAACeFDFXAFChACAAHAADBID.JDGDCBCB.YGAC.KACH..hAEA......hAGA...,1,-3,-23,20
EFUgXHMNcBfRSGPCJabAVeKIYdWQZOTDL,KCEAdFCHZADFOFEGLHDC.EAADFGAAUAGEHABD.MEBGBDCCSAEAhAAACEEB.aHEEhABAAHHAeCAD.IFGHhABAYAHD.WDHHDAFF......hADA.gGCHhAEA...,2,-31,-29,2
XOdQUISLFWNMbYDKaePfGRJECgZTVAcHB,BGDEdFFFQADFSDBBLHDEFBAC.MBBDDHBCeHFGGEADhAAAEEABCGBDZAGF.AHIBXCDChABAOBEBUEFANEEH.hACA..KAHF.aDDH.......hAEA......hAIA...,2,-31,-8,23
fTXJWPQAeSOYEKDRcZMgBCFaNGILVUdHb,SGADECAADFAA.ZACABGHHFEDB.GCGCLEHBUGDB.HCDGhAAATFEFJABG..QGAEhABAADAGeCFCOCCBhAAAKEEDMAIDCGBHIEAF..dBEFfHDBhABA....hADA...,2,-24,-7,17
cZIWgLdEGUOYPbAXVDJRTNeKBfaMQSHFC,VBFGDEFFREAD...eFFDBHEG.MCDCHCBA.FFDFCHHF..ZABGgGGBhAAALDGHdCADEBCGUFAHhABA..PEDBhAAAACAA.......TAGDfDAEhACAaGAH.SEEEhADA.,1,-16,-29,13
AMCHSWOBfDUNLXcZEPGVJaegIFKRdTbQY,CECCSABBBDDB.DAHBLDFDZFGB.GACDaHDG.eGFAFDFFdAEAhAAAQGABADBHHEBFODDFhADA.NAIC.cDABhAAA.EEGA.PHCC....hABA......hACA...,2,-27,-21,6
MDZdAgCGVUBOFXLYQfNeTaEIPSJKWcRHb,CBCHGFCFUCGE.ODFCLDDBQAAC.eHFEaHAEEBAHICCFhACA..PFHDhAAAKAFFREAFMAHBZCEFdAGHAEABBECEhADAFEAD..XGDENIBFSBDB.hABA......hACAWFFE.,2,-16,-13,3
MLCNVGXIAYTBDdOgWFacRESZJQeHKbPfU,TDAEdAACODCC.FGEGaGEF..RAFGZFAHQCGD.HAAGhAAAKBBE.fFBHhABAMFDDCGHA.NHADGADEACDCBDAG.hACADIAE.cAGFSCGGJFFC.eEFA.hADA......hAFA...,1,0,-28,28
OCKMgXTZfFYdcLIWPASNQbGHRaUeBDVJE,QDCGGDBDaGGCBFCDJEGD...EBHFCCABMAAA..TABAhAAAFGBHdBEBLDAFhABA.IHAHAGEASAHFhAEAHEFGRGCCDIFCOCDGKCEH..XCGAhAFA.fBBDhAGA..,2,-25,-10,15
dOBXFMILDPcGZTCQSHUWRJAVegEKNfabY,VDFBEDCCKBDC....aABFdEGCBFAEMGCGDHBGGDAG.CHFBHBAGhAAAUAGFJCDDAICA..eAHBhABA..NIED.fHDDhACAOEHD.IHHBPAAH..TFDHhADAWADE.....hAIA...,2,-30,-21,9
YZXPfRQdELgHIBJAKFGWSaTUCVMeDbNOc,KGBDFBFDGCBC..SCBAaHEE.TBFBCDHGMABEeEBEhAAADEEC.ODHD.ZFEDhABAfBCBQGGGhACAEGADHADHJFFCAAAH..WFAF....hADA......hAFA...,1,-15,-33,18
QOWIDTdASbRGYBeLUPcfgCXVHEMJZaNKF,REDGBFGHeCDELCDB.UGDEfGBGCGHA.HCAEJAGHZBBHhAAANAAFFFHB...OHDAhAFADFAHAAEA.GAEF.hABA.PFBHXCGDMAIDKBBC..ICADhACA....hADA.SBEB.,1,4,-32,36
KNcWHDfAYZRQGCXadOMIVJBUETLbPSgeF,ZACDQGCCCBBE.dAHGOECHMDFD..JDAGUAGF.LHDEhAAASACCFEECKBADNBGG.hAAAHFGDAGAE..REGFaEDFhABAIBEB.EDFG..bBBAeFAFDIEG..hABA......hACA...,2,-19,-12,7
ORWEdgADBVeJTfNcYMbFQHSXCZIPUKGLa,BBFHVFBF.JFDD....TGGB..fBBD.hAAA.YCAHFEABSCHDhAAACHEHIEFDKFFAaBHFhABAOAGFRCDG.EECEAHACDIGCeBBGMACCQAEEhABA..ZFBD.hACA...,2,-26,-24,2
AgRdDUSeKOJMHCaBYQNXTLGIEFWbVZfPc,RDBEDFHHeADGODBCHGFABADEQGCH..TBGDIGAChAAAFDFF.VCFHZAAC.PBAEhABA..gFABhABA.SHECMDIFaAFA.NDICXFCBhACA....hAFA...,1,6,-36,42
HcMFCaXWONRZDYdLAJPgSfIGTeBVKUEbQ,JAADSDGCGCDDBFFBUGAH...QGAGHFGBMADHFHFECFDBaBGAhAAA..OAFGhAAARBAFDEIHdAFCAEHH..PDAChACAfDEE.IHECeHCC.EEBCcECEhADA....hAEA.NEIE..,2,-27,-9,18
JOVeDREWXBKdTANaHGSPgLfcFbCZQYUMI,aCDBSAFBLEFDFCDDZDBH..UAAGJHBA.eHCADAIH..EACABAHBhADA.dGGGABGA.NFEH.HEGFhAAAGDBC..fBEBhABACDHBQADDMFAD.....hBAA....OEDFhACA..,1,-15,-22,7
fXUONcLEdDaKbMBgSZTHYeQGCWIVFAPJR,JBFCXDCE.UFGCOHFE.LEAHDCAEKBGFBGECZCEHHABBhAAA.eGDGCDAA.IEDEhABAFFAEAHAF...fDHGhADANBBB.EADCaCDG.MADG.SAAChAHA.YBHBhAIA,1,-26,-38,12
AGDaVBEbLORHWXgcKZFPINJMUYCfdSQeT,DCIFaCEGBCCAEGAA.LBGBRFFGHBDG....XABFKACCFGGH..hAAA.IEAHJFDEMFBHhAAACHDGdDDE.eADCABEG.hABA............hAFA......hAGA...,1,-20,-49,29
eXEBUfZTPKNAICLWSQJgVGHdDacYbMOFR,LDCAQEEBJEFBGGABHFAH.DBGAaBDF....bEACMCIBhAAAOBBGFHCGRAFFeFHHBABDhACAUCDH.TCAEhAAAPHFCADIHCHFF.SEGH....hABA......hACA...,2,-19,-4,15
XYVZJfgBDGNQMTUbCSIEPcWRdHKAaFLeO,FGAHeAEFOBCF..XGFAZDFB.JBACBAAHDCGD.QAEAhAAAMDIB.UDAFSFDHhAAAEHEE.PDBChABAcFDBdAHC.AFGBaGAE.LDAFfGHEhACANCFECACE.....hAEAWCHB.,2,-39,-7,32
WAHZOcfaNBLPMCUVQEYeGRKJDbIXSgdTF,ODCAaAHDLEFD..MDABUCABEACAeBCGRFED.DEHD..IAAFhACASABFTBGBhAFAAAGEZFBC..cGGFhAGANIDDBDHB..CECGVGBA..YDDEhAAAJBDG.....hAHA...,2,-20,-19,1
AgWbIVCGYFRNLaJBdeQXPHTEKMcSfDOUZ,...bADACGGEFBGA.LEEEBECHeHFAQBDFXBAHHCBDhAAAKFFFMCIF.SGDBhAAADGADUFDHACACICEFhABA.GEAANEIAaABG.dEEFEEABfAHAhACAOHDC...WDHDhADA..,2,-24,2,26
aOdXYQcFSDgHPEAfeIVGBJZWMLTNbURKC,eADCGBBGBDFFZBFGLBEF.TGADUGCBCHGH.aFGEdGFEQBBChAAAFEHBDAAF.HECAhABAAHHF..IGDEhABAJBFGMDADNADH.....KGFD....hACA......hADA...,2,-22,-17,5
eGbPHWASVBFUIcRQEdJNOaKCYgMXTZLfD,VEFGUECCRBCA..EFCGdABD...OAFAKCEHCHBC...MHEGXCAGhAAALCHB.DGFGhAAAbAFFHBFB.AFBBSCABhACABHDGFBBAIHHA.QEAAhABANIBD.YAHBhACA..,1,-16,-24,8
EGZAdeORMQgVYfWSIDUcCaFHJXLNTKbBP,OFAFQFFF..VAAC..fAAESFCBICEDhABADDEFCFGG.HCBBLBEChAAATBGHBHFEPHAAhACAEDAHAGEBdEGFMAIDYADC.cGDAhAHAJCGFNEIC......hAIA...,2,-21,-16,5
BQCAYFGRfMZVNcbKLDHXPWTUOIEedJgaS,GDBFREDAMDEE.ZFBF...VBGF..NBBFKFGBDFFHHACC.XGGBhAAATCABOHBAhAAAeCAAdGAA..aCCFBBAHhABAAAIDFBFE....fFDCcFAGPHEEhABA..WAFEhACA...,1,-15,-23,8
AOKVQRTIaBJbFNLMXPfgScdGUYDCZHeEW,KFBERCGH..aCBFBFFFFDDF.MEEH..XFCC..gAFGhAAASAFCdABGUGGDhAAACDAAHDGDeBADAIBCQACEhAGAJEAH.NIDB.......hAHA......hAIA...,2,-33,-27,6
CaMJLFZcVDRUTGbeNKWHOQESIAfYgXBPd,...fEGEXGBFBHEGdBGC.MCDFJBCFFADCZFEADBBH.UAEAhAAAGCAG.eFCHhAAANBAC.KFEBHAGDEGHHAAIBPDHDhABAaFAH..........hACA......hADA...,2,-25,-17,8
BabCDfcNQPKLYVIXSFRZAEeMOWJHUTGgd,EAAAeEAH.OAAHHCFEGEBDdBHGBBDHCBDFDADG....fFGEhABAQFGBKFCDYHAChAAAXCEDSBGEhAGAFHFCADBCMEIFWHEG.TCBFaGDDcAEAhACA.....hAHA...,2,-19,-18,1
bKSdgEFfHILNOZJPQWCTMcBGAaVYURDXe,VDFDUBDGDEAC..eACCKFCE.dEBEFAFAHGCA.LAHHOEHDZAABhAAAJBDD..QBAGhAAACHFG.MIEGBCHBhADAAAGBaGHFXGCESEEDECGD..IFFHhAEA....hAIA...,1,5,-44,49
KAJIFTMaWDNHQOEefGZcPbURSgYLXVBCd,FCADMFFDDECAHADA.QDCCEEGFGABHZGAC....PHAGhAAAUCGASBADhAAALFDHBHHDCHGFABBFTCEAhABAaCGEOAFAeAFE..fCDH.hACA......hADA...,2,-22,-9,13
LWaQRMcTCNJKSgEFUXGIHDZAfdVPbYOBe,dFAAVGFE....bBAEBACFLFCDQEECRAGD.MAIBCFHHKEEEhAAAEFCHFAEHGBCB.hABADBFGADEG...fHDBhAAAYDAAOGFCaEAHcDBE.NABA..hACASHAG.hADA.XGDF.,2,-15,-6,9
VKUWbTBPJRLYIZCeEcNfHdGQSgDOMXFAa,KCBBUGEB..TFGEBCABJFBBLBHB.ZABCCCDD.eGCA.EDDHhAAA..fAGGhAAAHEAH.QDABhABADADCMIFGAGAHVDEH..WCGFRABCIHHHhACANIAHSCAFXDGF.hACAaAFH..,1,-12,-22,10
HASDYagGZIVMKFNEXfcWPJeLUbRTCQOBd,DDEEaBBDGEGAZFGB..VACGKAAFFBEA..EGCF..XFAFhABA..fDDEhAAAcEED.PFAGhABAeHAA.UAGCTDCACHEEOBBBBCGAAIEASEGChACAIAHHMADG.hAFA...,2,-25,-12,13
GEIJRMXWSKgTfbcFePLdANZBVUCYHDOQa,ZEBCBCBHUDGCCBFGHDBGDAEE...aGDGEBAARFAH...MBDF..XACEhAAAKAGH.fEFGhABAFCEHLDADNAIG.hACAVGEC..OFHBIGCDSAGBhADA.....hAAA...,2,-33,-17,16
gPQXWMTZcBLRbKIAFOdUeSHNCfJGDaEVY,FDFDOBCGeBHFHEFA.CCEHGBAEDGGAEEBF...VGDC..gABHhAAAQECBMHBAhABATCGBBCDC.RAEGIFDHhAEAAIHCSGCDJHFCaHACYFAF.hAGAWAEEcCDE..hAHA...,2,-22,0,22
CJEQSFeXdZDOIUPBcaNMAgLfRHVYWGTKb,LFCCRABCHDCG.VDGDGDFA.TGCHCGAB.EAFDQBAGhAAA.FCDGeAHBZGDGOAHDhABAUGAEPCABhAAABEADNACFAABGfHGF....KDBGhAHASCDEDIGE.hBCA...,2,-16,10,26
DMRUVIPfZQKbFOcENLeBgHXWAaTYdGSCJ,TFGEdEGCGAAA.JFEDRFBAUBBG..VAFH..PAEHhAAAQCDHKAGFFDAHEGHHeBHFhABABDHBHDEF.AIEE.hACAaADG.SHAGDIAG.MDCB..hAAA......hACA...,1,-9,-22,13
WYKeEQSDfIVHGNPRXLCJBdcgZOUMaFATb,TBFH..WCAAKEDG..EDBDDEGA..VGEEGFAD.RBEHLABEhAAABAFFdAACgDGAhACAUGFBMAIBFECAhAFAADEGeADHSHCA.IHAG.hADA.NIABXBBFhAHACBCF...,2,-21,-15,6
IQRBVNCOgLabKXDeSdcJPETfHYMGUFWZA,QDFCBCDBCHDGLDAEKFCFDIFG..dHFBJCBAEDGB..HAGFMAFFhAAAFEAGZAGFABAE..RADAOFEHhAAAaGBH..XACGhABASFGH...cGAHfEEGhADA.....hABA...,2,-26,-26,0
LXWTRDCGFeaHSMUcbNAgYBfQEJZdOKPVI,BBDAQDACEDBCZAEFOFHH..KFEGIAAFLDEGTCGBhACADBIDCGCD...FFCAaAAEhAAASHBE.hABAUAGBNIEHAFHH.fCDE.JAEFdDAGXGEDhADAWHAG...hADA...,2,-39,-4,35
HcLBgZEVfAeDWOJRKMXCYUNPTFISdbGaQ,eFDFDDGGOBAHKBEB..CGBB.UFGA..TGGFSGAGGBCAhAAAQDBELAHFBFFAhABAEBFEABBC.JDABMAAEhAEAXCFH.NACB.FEEH.IHED.hBAAaHBE.HBCC..hAFA...,1,-14,-23,9
JfYQBIDSRFPAUWdVeNaEMbZOHgCTLXKGc,dDHGVGBCaGBF..EGHHZAEE.HGEA.CEAALDDDKFFBJAED.QABHhAAABCCFSDDDhAAA.RCFAABIHeCFFMEAFhABA...OCAF......hACA......hADA...,1,-18,-30,12
PHJEBVaSCfTQZRFLbgIOWXeKdGMNUcYDA,JAFFVABD..CFHC.QFGBZABF.FDEGLFDE..bFCDhAAAIDAF.OGAChAAAWEAD..eCHFhABAKEBBMAIDNBEB..cGEHAHIFEGEDBDEH.hADAaAGFSECFhAEA...,2,-32,-25,7
LMRBbKVTEYFacgPZGSefOHIWJAUCQdDXN,QDGDXGAELBBDMCFGBBDG.KGDAECDC.FFFH.aFDFPABHhAAAZBFH.GDADhACAeDAD.HFAHIHHDhAAAAEFFdGGA.DIDANADB.....bAGB.YDHBhABA.cACE.hAIA...,2,-14,1,15
bgMOLKVYHaAfeRWCDcNdSZIEGUJPFTXBQ,RBCFCGBADFACdABCZFGB.GEAAUBEF..FGGABHCB..QBADhAAAMFCAKAHHHCEEAHAF.eAEChAAA..NABDSHEAhAGAIGFC.EFDE...JEEC...hADA......hAEA...,1,-18,-38,20
HNBTQMceCXYgZbfVRULWIAKaSdGPJEDFO,SBEDdEGHJBEE.EFCCODBH.BGDGMAHB.CEGH..XGADhAAAZCCC..fGGGhAAARCACUEEC.LHCGhABAIBFBAAGAaBBGDGHDFBAG.NDIC.TCGGhACA..eEAA..hABAYFAF.,1,-7,-29,22
SeHEBUTDIQbAMGYJPfOVFcgCRaLKZdNWX,MHBCJBDA..OBBDVFGD...FDFDCDDCLAAEdFAA..XEDDhAAAeFACEEFHBHEAhABADAIHQAEChAGAAHDC.PBBFfAGDcDGFaGGB.NDICSCADhACA..hADA...,1,-11,-43,32
NBLPJTGVdaFUfEWDHRAScYKIMCXgZeQbO,SGCDKBGGMACG.CHEB.ZEFB..eEBAOBAELDHD.JAAEhAAATCDAdBGHFGAFEGBFDDCGhAEAABFC....cDBAhAAAIBEC.gGGGQGDABFEFhAFA......hAGA...,1,-27,-29,2
gdNQBFGCAafWcZELIYPSDJebXVKOTMHRU,aAAC..fADDZBEDLGEG..IFHCSAEFJGBEXCAHhAAAKFFCMICCUAGChABAdDDCQAGDhABAGDAEADDCEDGGDEEEeFFB..OCAATABE.hACA....HCFChAFA.NIAHBHHF.,2,-5,7,12
FdPGBMEJLgNcHbCUfXDVQTWYSIaeRKAZO,FDEAGEDEEGAG.JCBGLADE..NADD.HBAB.CFHAUGCGDCGHQGBHhAAA.TGGHhABAWCCH..IGFChAAAeAHHAFHEOCAHBHHEMAHD..cEBBhACA.....hABA...,2,-31,-18,13
SbcaMIfGdXJHYADTFPKOeVLUQNBZERWgC,FEDBKAABOFDALBHB.UGFDBAFGZADCEEAE..RBBG...CCGF.SEGGhAAAaHBG.MHAAhABAfDBD.hACAXEGB.JADDAAFCDIAC.TCEGhAEAPHDC.eAHB.NGAD.hAAA.gGGG.,2,-21,-21,0
UTBJPMSZaHFObNVeCXDgWRGfEYKdcIQLA,BFFBMDAHZDEDFHFE..OADD..bACHeDDDDAAG...RCABECGHhAAAdHEBQEBAhAEA.ACHCTGADJHBESBHBhABAaBEA.NAFACFHBgGGB.fBBAhAFAcGAGIACEhAGA.,2,-41,-13,28
PLCefQFIEaOWKZcADJHRdYSVbgXBGTNMU,DGEARDADdHEB..SCBG..gBBEXDFCBBGBhAAATEFGMFID.LECFhABAeAFEQGBAhAAAFADFaFAHKABHcADCAIACJHDE.YDEE..hABA......hACA...,1,-24,-28,4
ACDfUNOSQPFYWLHaRXcJMTebKVEIBGgdZ,DFGBUACEOAFGQFDD.FGGHLBDFRAGB.XEGFhAAAMBBDeFABVEAHBCEHdFECACEDhABACDDD...SDAEhACA..YEHH.aCFD.TEBDhAAAEHBCIBBHhADA...,2,-29,-17,12
CbZUIJEBRFMOcfdKTNVgDQAGeXLPSYaWH,XAFALHAESFAC.aAEAWCCA.HAAECHHCZEDHIEAEhAAABBEFFCBEMFIDhACAOBABdEEEKCGF.TECEhADANBIEDFGD.AIBCPGACbCEE.EGGF..fAABhACA..hADA...,1,-3,-29,26
YLeXacCJBMOPIVDQFGTZHSgANEbUWKRfd,EFDHUABBKHDGRDDG..dAFGeDEE..aBHDJDBCBHFC..MBABOCABhAAA..PBEGhAAADGBAFEHHTGGE.SGAAhABAAFDA.WFFEfHCD.hACA.YBBA.hACA...,1,-18,-47,29
LQBbDNMKfgPaGYAZIOWHCFcXeRVEUdTJS,ODBGHBEGCCADFGAB..XGFFeGECEEBAUABC.dFBH.SHCGhAAABEGGNCIG.KAEA.hAAA.gEDChABAaAHBAEEGZCFF.ICCG.WHDA...cABBhAEA....hAFA...,1,-27,-29,2
XUeBACbdfEPOMJKIRNGaLDQgSFcWTHYZV,CCBCdGBH.EFGFODDG.KFFFIEEG.GACDDGAEQAFEhAAASAACFADDTDAChADAHDGDZDACUCGCABAB.bCDChAFAMICG..NIDF.aHBG......hABA......hACA...,2,-27,-6,21
UKASgQOINGWBcTHFDfCPYaEJRbeVdXZML,QCDAOHEAGDDHBABCHCADDFACCHGCaAGE.REBF...eBGHXFGEhAAALFFEAIDCIAEGhABANADB..cCBChAAAFBBAfHAD..EGCG...hACA......hADA...,2,-30,-10,20
fYPaNJDEcGRbgeVMOTBFXSALdKHZWIQUC,KGEAHFGDZFBEQAABUCEF.CCFG....PGCAaDAHDCBCEBHD.hAAAGDBB.bADBeDHDhABA.MICABHAHXGGHhACAAEIFdAGBfHEHNBEB....hABAcDBF...hBDA...,2,-33,-3,30
FdRebEPZXKgCaHADJIUNSGQTYWOVMcBLf,JEFAUDDBGABAQBGB..TEDCOFGDMHDABBEELAFAhAAAdGAHeBAGECFEXDAHhAAAKDAHaGAH..ADIFIADBhABASHBA.YACEcGGE.FGEB.hAGA......hAHA...,2,-16,-14,2
eVRWFUBGMEDOgTZaHYAcXQfINCJLSbdKP,QGEH..NCBCJEDGLCFG.SEFGKCGGeGBARABAhAAAFCBGBAGCMADGEGFDOEBHhAAA.TAGBhABAaCDGABIH.XGGB.IECDCEHB..hACA......hAIA...,1,-19,-42,23
FeACTEZLcXJNYUSQKPHGDWfadOBgIbRMV,TFEALEFC.JEAGUFCE.KFADGAADDEDA.aHDEdCGFBGGD.hAAA.IBDGMADCFAHFhAAACHBDZCCG..XFBEhABASAEEHBDCfGHE.OCAFhABA....hACA...,2,-33,-16,17
fAcTSaVEdXUJeRQYBLHCbNIFDZPgWGKOM,TDFBVDGF..dAEFJEHBRBCH..BHAHLFBCHFCH.CBCD...IEEChAAAFAADDEAHZADC.hABA.PCAB..hACAWHDAOAHFABHEaGAE.ECDHeCEC.QGGBhADA...hAAA...,2,-35,-3,32
BFOGLgfQVSREJcUPWKHAXDNIYZMCTdeba,DCBD..NCEEZFFAMCHD.CCDG.dEAA..aEAEBBAB.OCFAGEEGhAAALAFCQGAEhABARDFEECCHJABE.UAGH.hAAAKGHFADAGIHBCeFDD.FACBfAEChAHASFDD....hABA...,1,-11,-25,14
eJEXTMVFKBbPILaGgUfCZHRQNDSWAdOYc,OFABeEBCEDFC..XGGBMAFC.KBFBBBBF...bFFEPBCHhAAALEAFGECHhABAgGBBfDHChACA.CADF.RBDE.DHCCADBEYHEAcAEB...hAHA......hAIA...,2,-28,-10,18
gTHCIYRQKZeXfdFNBLJMEWDUcSaOVAPGb,GDDGTEBH.CHFCRCFGKCDB.ZEFE..eBCBdHDHBDGHJHBC..MBAHhAAAEAHHDBCD..SEAHhABAOAEFAADG.bFGHIAAChACA.QGAHFAHDWDBBcAFBhACAaAGB..gGGChBDA.,1,-12,-30,18
HPcWBObSXNDAUMKdRIfageFTLCZEQGVYJ,KFCAdGEERBDC..aBDBFBHBLFEHZAAHGEAB..VAFFHDDC..hACA.PEHBBDHHSBBFhAAADADAAHAA.MECChABA.IHHB.fFAHhACAeHAA.CAHB.....hADA...,2,-37,-14,23
TSXBNWEYReMQgdKfFVJLabPOIcUZGADHC,DAAFCFGD..SEACXCFEBBEC.EEDCeADE.MHDAQAGHhABAdAAEKCDFfBDDhACAJDAAaGFG.OEFAhAGAIFAE.ZGAEAEEBNIDBWFFERAGH...FBBGhACA......hADA...,2,-26,-18,8
YZQSRdMfcUGTEIBJbFWLOAeaKNCDgPVXH,KFFBDCGF...VADBXEBEHAGDZBAF.RFAD.MCAC.UFGHEDGBBFEFhAAAFAFCLDAFhAAAAIHCeGCG.CDBA....PHCEhABASDDGdCHEfHAF..hACA.cDDF..hADA...,1,-18,-31,13
ROQINaYgCZXVedMPFbWcJHTDLBSGAKUfE,UGBEEAGERCBF.OFFA..IHGA..NFAB.aBCACDHCZADEXFDAhAAA..dBBCMCIDhABAFDDA...WAEHhACAJGEADAIFBHDCAIEG.KDFG.YEAF..hADAeAGH....hAAA...,2,-36,-17,19
dCaIPRHKENJMgTWceULSQbXFfDZAGBOVY,GCBDOAHFdFAAaDHDRFFGKABD....EBAAJFEHMCFG..TDGGhAAAeAEALHBChAAA.SEAChABAQCCC.XGGG.DCADBDGCVBECCFAAIEEGhACA..hADA...,1,-14,-26,12
EVRgdKJQYMbZPeIDSXcANOTLWCafBGFHU,TBFECAFABEABHBCC.UCGBECHHRAAF.dFDFKEGHQGAH.hAAAMDCEPDDHDDAFSHGEhAAAABCELHAAaABGhAEAFEBFgEGA..JFED...hACA......hADA...,1,-13,-28,15
UZcDaSEXACbYgdOTLNIQMGBHWVKFPfJeR,CGAE..bDEGdAFD.LCBAQFGFBGDCHACDKEFE.FGBC.JBEG.hAAAUCACDGHFEEEDADIBOHCEhAAA..NBIAMCADhABAWFAD.....fEBGeFFD.RABE.hADAaCFESHCGhAEA...,2,-38,1,39
HaFTPfbCMZVAKQeXcEWOUBRNIGJDYSdLg,eBGBEEBFUFECBDCC.RFEDGGAFDABD.dABA.LBEDHACEaAEAFEAFhAAATDGE..fHGHhADAMEDFAIHEKCDG.hAEAQCAF.XAGHWDGDNBIE..hAAA......hACA...,1,-13,-22,9
OIdNVaLYAfPEbUcGWBRMTFDJQXSHCegKZ,ECEEUBCCGAAABCFHRAGDFEGE..DEFFQGGD.HDDFCGAFKEGEhAAAIBHH.NIADLGCGhAAAAHID.fAFGhACAbDAG.MEAFXGGBeADF.ZFCFhABA......hACA...,1,18,-48,66
ZANGJVbcOSKFeYQIBXTMEaLRCUdHfPWDg,JCGDVBBE..OGBEFFDE..eBHBQDBHBCAG.MIBAEGADRCEGhAAACAGAHACC..fHGDhABADGGBAIHA.NEBD.hACAcAAG.KFEBIFBCXFACaFHF.hAAAdAEF.....hADA...,2,-27,-12,15
LWFMTSZBdUQERecgYabKXHNCPJVDIGOAf,LABBFBGDMEBHZEGBBDCA.dAFHUFDBEFFGRCFE..eBAH...hAAA.gADDhAGAbCDFKACE.XGEGCAGC.hAAA.PCCHDIGEIHCEAHIH.fEDAhAIA....hBAA...,2,-30,-24,6
OGFLRIWcPJgADbNEMYBQfUSeXVTKCHdaZ,DHGCEEFHBHEDUDAF...eBFC..XDEFVDAF.KFAHCHHCHCCGhAAAdACEZGCEFABE.LCHDhABARAAF..IEGHhAAAcFBD...JDDFAAHC.MAHH...hAEA......hAFA...,2,-32,-20,12
eWEYbaCSADVBJNZfTGgIRLPUXdOHKcMQF,BGGEZBFHGBABRBDDLGCCUFCHdDAEKCFE...MIACeDAH.EABEaAGFhAAA..AAHE.DHFAJDHF.hABA...fCEChACA.IFGGPCCHOADA.hADA......hAEA...,2,-33,-26,7
gYfSWVXJFLUKbZCdTEQNaOcPGAHMIBeRD,MBCHBEGHeBAFRFBD.DHCA....fEHGSDFCVEDFhAAAXEAHLBFCKFHBCGEEhAAATGGG.NAEB.aCCBhABAOADB.PBAHAHAHIBHG.YAFEhACA.FGGH.hABA...,1,-20,-31,11
GHBWPUKSgVdecNEQYCbRZDaTXOfFIJLAM,HEGFBBCHUBEGSFBCdGEB.eADGEECD.CEDERAGHDCIH....TAAHhAAAOBAFFCCGJFHDMICGhACA...WFCAhAFAKEFEVGAG.QAGCbGAC.aAAA.hAGA......hAIA...,1,-8,-29,21
PgcNCdRKESVbOZBDYMGfHQaFIJXLeUTWA,...PFFBgDDE.CGDG.dFDAKCFASBFG.VCBHhAAAODAHBHBDMIBGhAAAGDGGfBAGhABAaAGEIBAHJFHHeEBHWFAGNEGAEBBG.DBEA..hACAYADHFAHH..hABA...,1,-7,-29,22
EBUgFHNdaKPbYeXfcRQLMVISTZAWGOJDC,GCFAJABD.DIGECGHFBBFHFEDHHAAF.dDCFKEGG....PFBFhAAAeECG...XADEhACAfFAFRAGBMEADhADASDGCAFHA.OHCE.EAEF.gGAAhAAAaFFH.cCDChABA.,1,-5,-59,54
LZbXECcfdeUMgKGWDOAVRINSTaFYQBJHP,VAEERGAE..SAFAFCAHBGFE.JFGDHECCLEAGZBBF.EBDHCHHAdHDFhAAA..MADAKCHHDDDAhABAAFID..IHEFhAAAaHAE.PEEG.XCGEfDGEhACAgBAH.OFCEhABA.,1,-23,-24,1
aKGEDHCTcLAQMNOIWfRSJVXFYZbeUPdBg,QBFBMFBD.OFFAfEEC.SAEAVCBGXAAChABAFBCFZBAFUGEEdGFEaEDBhAAAKGAGDDABCHDGLCFChABAAIBEIHHCJFHD.eDFABEHFEEBB....hACA......hADA...,2,-15,-8,7
DFbPeCUcJXOVKMWLaNBAdYTQERfSIHZgG,dGGDTEBFEDFF..RCAA.SBCHHFBAGAEDFEEC.eDHHUAECXAAChABAKGHHMHBELHAGhACABEGEAAAF.fECBhADAZBADDGDCCAHB.OHEC..aGGH.QBGChABA....hACA...,1,17,-19,36
bdDJaPOHVLNTUQISCFceBEZAfMgKRXGYW,MACHKAEEGDAG..bFFHDCAD..aCEAOFFFHAGDLDDHhAAAUFDGQBBASEBChABACCEA.FGACeAHHBFHBhADAAGCF.gADCXDGA...WDFA.hAAA......hABA...,1,1,-29,30
VcMAELSJQOYWUFCaGdBfNgZKTbHPDIReX,SCAGOHBEUAFBCEFG.GDAABFHG......fFBHhAAANHEFZBAGKFGE.TAFChABAHCECDAAGeABC.VGDChAFAAAEFEECGJDCE...WAHHaEEF.dHAD.PBCEhAHA.IHHEhBAA...,2,-17,-16,1
VUdgRBfKCWXFMYDLaGebPIZNcHJTASOEQ,SDFGQAEGUDDBdFAARBBH.BHAC.KDAACEDAFAAB..DADFGGDBhACAeEGB..IAADhACANBEH..cEGDhADATGCF.AIHGECGE..fCGFhAEAMEIH.aFCC....hAFA...,2,-30,-25,5
MAdHURaWPQCgXbVfOEZLTBFDeINYcGSJK,UAGGaAAH.QDAHCCCF..XAEBVCDE.EGBBZEGFTFDAhABADDIBeABG..IDFFhACANIBD.YHFEhADAGFBDKGFB.ACCB.HAGBPAAHfECFhAIA.BBDB.hADAFDHD..,2,-12,-4,8
JcfEPFaDMGWUOZIXHYNTgedKbQBLSRCVA,JEHHECFCFFFF..aFABGGBH.UCCGZEDGHBDD..NADD.eBBFhAAAdAAE.QGDAhABABBEBSDBDCCGEAADAfGGEhACADIFCMCIFIGBBXDFA...hAFA......hAGA...,2,-25,-21,4
gFdeNDICBOcXVAQabUSJPZGHRTWLYfKME,aCBDUCCH...JDGHGEGCHFEF.RBDGTGBGLCFC.KGAGMBIFhAAAFAAB.eEDA.DGDEIAGAhACABAHCOCABhABA..XEBAADEDSGAF..WDAFhADAfABC.hAEAEHDANIAHcGGD.,1,-7,-23,16
VaPSGOHbRJfWMATQUDLINgXYdCecZKFEB,UABEDBCFLBEB..NFBB.XGCEdBEB.CGAA.ZGAE.KDBEECGBhAAABHEF..aDABSFGGhAAAOFFFbACBRCGF.hAEA..JFHB.MIACAICEIDEAeECGcAGAhABAFAGA.....hAFA...,2,-36,-9,27
PVROTUJFXNfeIZbaWKDHgGYcLCSQMBEdA,REAAUEEGFGEA...XAABeDDEZAGD..aBFCKCAH.HACCGDCChADALEHDSAFEhAEAMICAEGBFAIACOFHH.hAAANICB....IGBCDIGG...cBDChAIABBAF....hBAA...,1,-14,-30,16
MLHWcZKUNQDAFVeaYIBgCXPGdTRJOEfbS,VFDAaABABHBB..CHBCGADFRBGB..ECDHSDCBMFACHEEEhAAAZCFEKGEFUCAA.DABEhAAAABEEFCBHeHEA..IGGEhAEA.........hAEA......hAGA...,1,-26,-28,2
bGdacBeJQLVPAgKfXNMRDFZSYHICEUOWT,KDGAXAFCMEBC.FEGAZFCG.HCDG.CFHA.EGHD.UBABOBBATDCChAAAdAFBBHHA.JEAFhAAAVGAA.AFFEfCFHhABADBAH.IBDE...WFEDhACAaHFG.eDAF..hADA...,2,-28,-23,5
LGUcANbOeTEZSDXKFRgdVfHJPaBQWMCIY,OEDDECCFDDEG.KCBCFHDG..dDHGHAAB.JFAEaDBH.BFFB.QGBDhAAACGFBLADAUAGDhABAAHHGeAHBZADHSHGAhACAXEGA.........hAAA......hACA...,1,-25,-31,6
eRFILWfPATEZXYHDJVKcGbNBQMaOgSCUd,TBGGEEEBZEACHACF.DDHHJEAH.KCCBGGCDBBBH.MBEC.aGGDhAAAOEFB.SHGGhAAACBHHUGAGeABFFEHDLHAAhABA.fBDBABAHXCEEcDAFhACA..NDIG..hADA...,2,-39,3,42
ABXHMbJRWdFPUfgQZCOYeVIGScDNaKELT,HECHMEFHRCFDFFFD.UBEBQEAHZBAE.OBACeBHHGEAChAAA.DIEEKGGFEEHFAHBCBABEhAAA.bAECdAFBfEDAhADACHHEIABFNBIALHAA...hADA......hAEA...,2,-10,-10,0
GQIAPBRYMESLDgaUKTCdbVOXZcFeNfJWH,BBFFRBEBEBCH.SAAGLDADDDEFUFGBKGBGdDDH...OHCChABAXDGHFEBB..eCGBhACANIBD...JAHHGGEDhAAAAIAAMEADaAHD.CEBA...bADBcABG.hAGA.fBCAhAIAWDDD.IGEH.,1,-12,-14,2
eHDgFbIPJOTXREMWNQLUSYcAaCfZGVBdK,aEDFZEFABEBA.KBBDDICA.FBAC....PAGDOGAGRCDH.MFFBhAAA.QGGAhABALACGSGEHhAAAABEDCAHEVBFD.HGAE.IHHBXDACNBAC.YCHBhACA...hABA...,1,-22,-31,9
HfCEUDgRSeFYOBAbPcGXKTLIMadQNZWVJ,...bDCFPBCC.GEEFTAEELEACMHDAdGADQAGFhAAAZBABVCFH.HFAAfFGHhAAACHEFDDACSACChABA.FGHHOABAADIFKDDEaHAENIEDEEED..hAGA......hAHA...,1,9,-7,16
LPDNSHUFYKQTecWJGXaZEBbVgfACMOIdR,CHGCMDEAdEFELACEDCCBHFAE..UGGHFECGKDGC..TACF.hAAAeDDBJHBCGBAEhABAZAFCEAACBFGB.bGCAfBGFhAGA.ACCGOEHF...hAAA......hAEA...,2,-29,-14,15
cQgZACMKWBYLIefaPJDTGdEOSUVRHNFXb,CCGCKFFBBEFBLEAC.eDCEaADF..DGGAdGBC.EDHDOAAD.hAAAUFCGRBDEFABE.XAGFhABA..bCCGgGDGhAEAABFB..WHFA..fHGFhAFATFAESHAGhAAA.,2,-56,-11,45
JceNHPMWIfYbOdZGTQRaSBCKVgELUFAXD,DGEGeBCFHEAAMBGB..IHEA..fFFCOBCDZCEFhAAATFBAQAGChABAaDADCDHCKAABEGHHFABDAAHDXAEBhAAAcDGC...PDDD...YEHBhACA...hADA...,2,-20,-14,6
GSUNdbMVQDKFXEHJaPgCYLfBRITcZWOAe,SABDdBGHMEFHDDCDFAHF.HFCF.aEACCCAELDGD.BFDEhAAATFGCZGAEAHHBGDEAhAAAUADF.NAGEQADHhACA.KDAEEABD.gEAD.hADAfEHEIDDHOHEEhAFA,1,8,-45,53
IgNOeFfLYDURMdHKTESPCXbBacGJWQAZV,ZFCEVDAF..IEHGOBHD.FBDGLACADABH.UDDHdGGGKDFChAAAEGEB...SFADhACAXGGGBGCFGDAFhADAJAGDAHHEeHBA.fBGBMCCEPAABhABA.CGAG..aFGA..hADA...,2,-17,-15,2
SdbYcfUDNBHaLgMFOCJPXARWTIeVGKEZQ,TBACVCCA..EBGEQDCE.dFFDbGFG...fFAGhAAAUFAANEIEBAGFaEHFMFCEhABACHDDJAEF..ACID.ICAEhACAeAAEKDGDSGDFDIAE.gAEDhADA...hADA...,2,-21,-11,10
PRYbagECfJHXNWedSLcKUQIAOMGVFZBTD,MCADGADBZBEDDDGDRDGF...aBAFCHBH.HECF..XABBeCHDdGGEhAAALDBHKEAAQGAChABAAGEGOAHDBACF.hAAAPCEHgGGGfCCCNDDG.SAHBhAEA...hAEA...,2,-29,4,33
EOGRUQPHaFgYBXVSKbCAeJIZDLcTWfMdN,JDCBDDDGLECE..TAFCMGCCEHBEOHAEGBEB.UBAFhAAAPCAAFDHHBAEGhABASFDHKHGC.AGGDeABEhAAA.ZFGDWFAFNEEH.......hAEA......hAFA...,2,-30,-21,9
aNZdEIDQFHORTJAcfKMUeXgVPCSbGBLWY,KDDEUGBFeBFB..VDAESEBCBEFELAFD..aFEGhAAAZFGDIADFDCIFFBBGHEDHhAAARFAAAGGCMICC.XBCChABACAHA.WEHBdADE..EHEC...hACA.OAFG.JHFAhBAA...,2,-21,-16,5
WHaOeZbXFUdgAVQDICLcJfRGPBSTMKEYN,DGBECCCDLEHF..JADARFDCBCEASDBCKEBH...EFFA.hAAA.NBAD.HCEB.OBBChAAAeCAFZGACFHAEdHGBhABAAFID.QGDDIBGE.GAGAMACAaEEAhABA......hAGA...,1,-10,-32,22
IHeSXWfYLbPNEgKUTCRdOFJQDVZaAMcBG,MIBCGDFAHFCEeADDSDED..fAAFLAGHPADBhAAANAIAEGAH.UBABhABACEBDRAEAFHDGDHGCaAFHAGIDBCBChAAAIFHFXDDGYEAHKHGA....hACA......hAEA...,2,-12,-5,7
ARYEXTeaKWfGOSCDLHbNFBIgQJMVcUdZP,RCEGEFGCeEBCKCGE.GACB..OEDGDIBAHBADFCDCBBBHQEGHhAAAMIBE.UAGEdADBAHHFXFAChABA.aHGCWAADhABAfFEA..CAHBLGAAhACA...IEBHhAGA..,1,-4,-30,26
UQOYWIbESKNgCXZfaHPJBTGMLRFDceVdA,QEABOEFF..ICFBSEDCKAFC.CBHEZADBHFBDBHGAhAAAMEHBFABFDBHBeGDCADCAUACBhAAA..bCGDNIDB.fHADhADA.aGHFPDAH...hAGA......hAHA...,1,-18,-24,6
EVYcZbKeJHQfGCaDASORXLIWTMgFNUBPd,OCAGXFFDLDHD..IDGATDEGFGCCBDCCEECGVGAEhAAAZAEE.eFBEHEAHfBEChABACGFEAIHG.SACEhAFAMBACNICF.PEHF.dBBH.cAGBhAGA.KDEH..hBAA...,1,-8,-17,9
TDGJVfQcYEXaWFedAgHSNbPRBCOLMKZUI,SFEF..NCHARGFECFCCLBDAZBAGUFCE.DDDAGAEC.hAAA.JHEG.QDGAhABAEHAGaAGGFDADeDABAAAE.hACAbGAABDDHOAFAMDIDICBE.fABHhAEA..hBAA...,2,-24,-20,4
fADNaTBcKGZdSJPLYbXVeQWUEFHgRIOMC,DCDDTBEBBEAH.KFGHdDCD...SAHBJHDC.LEFFhAAA.bACFVAAFQGAFhABAECFHFFCCHAEAhAAAIHDG.CHHFAFIHNDIA.aBBB.GBGG.ZEBAhAFAXGAD.eEEAhACA..,2,-30,3,33
MRJKfHIabBTGgDZcSUeNdAQOLEYXFCWPV,QACFEEABFCEF.CGEG...VEFDMDAGKDCAHGAA.aEEATGCHhAAADAIHZDGH.UAFCdBBFAIAGhABAOFBG.XAAHhAAAPBHH..fADDBFFD...hADA......hBAA...,1,-11,-28,17
faFKHONDdPMUBIcWYVTLCJEZGXQbgSeAR,RCGDFABBKHBC.HEDHDDAHMECCBAFA......IACC.hAAA.WCDATGGCCFHDZBGHhADAXAAD.gFAChAAAeHAGfGFGaCDAdGFG.UFCD.hAEAcACD...hAFA...,1,-21,-35,14
EYfBbaQVNMOAZLCPFIWUXSdKGgTRDHJec,CCDDFDDHUFCEdADDGCFC.RGAA.DEGEHABBeCAHEGHHBGHE..aFFHhAAAQABB.hABAMFBDADIF...LAHFhAAAIEAFSGFBKAGB...hAEAgCEH.hAGA...,2,-35,-18,17
WHfSbPedcRQAIOJBUFaMgCNTXGDVEKYZL,OEHHJBECBBCHUDAA..MGAECEEG....TBCGGCDADDGBhAAAEGGBZGAELFFDhAAA.HBABfAEEhABASEHFeHDAdBHERAGFAHIDFHAC.aACG...hACA......hADA...,2,-26,-9,17
QSBDUREJbLCAYPgXNVaKTWOFIfeGMHdZc,...PAECXCAC.aEDATGDF.FDAAfGFEhAAAGEDBdGGHZFACSBHHhAAADDDEEBECJHACCCCBADEH.gABChABAVEGHOBBAMIAG...QCFAhAEA...BFCDhAHA..,2,-24,8,32
GZFbDJEfdegCVXUBaOKPIHTRWQMNcYALS,LGDASEAFGDBFFGEB.DBCAEDBGdBFFeBGBCAAF..UCGBaDDFOFCBhAAAKCAC.IHHGhABATGAF...WBCAhACAMFFG..YAHHAAIF...ZDFHhADA.fGAAhAEAXEAGBHHE.,2,-24,-4,20
dQebWgDTSAaEHGIZYcXVRKBLNPFUfCOMJ,EGEAGABGZBDE...XGDDKFBABEDBLBHHFCBD.UBEDCHFA.hAAAMFGBdAFBQDFFhABA.eDHHgFAEhAAADBBCADAD.IHAF.YFHFhABA.RDDCNADFfHCDhACA.,2,-35,-4,31
fGZdSDeHTJKaWURMOAEYPCXBNFVQbLIgc,EDBECGCEBEFGFFDC...QBBCLHEE..IHAC..hAAAfBEFGBEHZBAChABAdFHGDDIDTBGFaAFG.hACAWDADMDHF.ADAD.YDDHXEADNABH..hADA..gGEFhAAAcEEA.SHAE,1,-18,-25,7
WADQINOGTbUePCHVMcZLdESXFBRJgafKY,QFFAODDFGGEBUBGDeACHHCBDMCECZFCDEACG..SEBGhAAABAAAJEAFaEHFfCAChABAKGED.ADIBNIADTDEFhAAACGBC..LAFE.dDGG..hACA......hAEA...,1,-8,-11,3
SBTYUJRbQLaGFANZIeVWgPcDEHfXOMdCK,ZFBBVEBH....gAFADCBHHCDGOAABCCBA.BFGBTFDChAAAUGEFRFFF.LHAAhABAaFABAEBE.eAFA.PBHFhACAfADE.dDHCSAEChADA..YDDChABA...,2,-33,-6,27
faLJgDOPGWURNVCKXEITeFHdAcYbMSQZB,...bFFCMGFE.ZECDaDHHLBAG.JDABDHCGGBGGUCCGRBFFhAAACEFA.KHAG.EDABeEBHhAAAFAHFAAFE..SADEhABABFCDOABANICH.IHHB.dBBC.hACA......hAGA...,2,-22,-12,10
LSaVMKJQTHUdfRDIbZgFNWOeYGPcECBAX,XCGGSECF.MHBAJACH..HAEHUFGCdEDGDAFDZFGH.FHBAOCAFhAAAGBAEECDEBAHHhAAAAACDLAHDaGAG.KEEChABAQFEC.......hADA......hAEA...,1,-4,-32,28
RZcdVOLHGbTEQCgMFfDSWJPBUKNaXeIYA,ZFEBVFCBOBCG.GFABTBDE.CGGA.MADG.FCEASBGGhAAA.JBABBHGGhAAAKEEBaEADIBAH.hABAADHDdHBHLFHBEDDDfGGDDAFCPCCHXCAAhABA.YAHHhACA.,2,-28,-16,12
ZIUeNGTEWdOgXKFcAYPJVSQbfRDCMLHaB,JFAASEEF.QFACRADGCGHELDECaBCA.BHCAZDFDUAGEhAAAGABCEFHH..OFEAhAAAgCAE.KHFAhABAAABB..PAHDfDHCMIEC..IDAFhADA..NEDEWAEBhACAFHAGYGEA.,2,-20,-1,19
HfCAbGgRQWDFLTKXBSdMYVeOJNPIEZUac,GBFCRCEDDEBBLEHFKHBCBEDC.dACGMIBA..eDBFOGDEJEHH.hAAA..IAGAhAAAEAGEaBDA.HBAE.ADGAgECAhABAFBAHTFEF.SAHHNIDH..hACA......hADA...,1,-17,-24,7
dRQHZBCAcEIaWSDVMegNFGYPLfXJKbOTU,EGBDaBAH.DDDG..MAEGeDGHFDGDGDAF..LEBBXGDDhAAAKGGATADBUFDGdBFEhAAAQAGEBCCHAIEAIBBChABASBAG..NAIA.fFHChABA......hACA...,1,-19,-27,8
cERgVAZUaPXIWMJYNLebdSOFHQGfTCKDB,UFAGaGDD...XCACIBDF.MAEGJFGF..LBCGhAAAdCFDFDAEQGGEhAAAGDBDCAGHDHDGBBAA.cFFBhABAgCGGZFBD..WDDGNABD..SFDAhAGAOBFG...hACA...,1,-20,-23,3
KfdbZaWGTPVOgNDLJYHUMcRIBCSEeXAQF,QGCAFAAEKHCG.dAFBaFHDGDFE.TCAEOFDC.DCDDLEAAhAAAHCEDUAGFMCEChABARDBDBHAGCEEFSEHBhACAEHEG.AAIH..fBBB..WDADhAAA.PCHH.hADA...,1,-15,-22,7
BMCSZDTPKbAUdHEJOGfacWVRXNLYIQFeg,HBEEJDBCGABDaFHF..VEBFRGCGLFGD..IFEEhAAAeDFEBFCFCHDGZACHDAGBKHGAAFAFEBHBhAAAOEEA.fBBChABAXBAC.NAED.FHACMBIFSEABhABA......hACA...,1,-4,-17,13
ANVHKCJSdbPMQEgTLXfIFRZBYcOGDWeUa,VEEAKGFHCHBG...dABEMDAD..EGCBLDHD..fFAGhAAAFCDBBBFEOFDGhAAADEDBUBDFAGDD.JHEASCBBhABA..PAHH.TDADhADAIACC....hAEA...,1,-21,-53,32
ANeLdOBTPUEMSbaHWYDCKGcIfXJFQRgVZ,LEAABGBEUDFFSBDFHBAEDAGGGADD..fCHChAAAFGFA.QCAAhABARDAA.VFGHAICCNEIGeEDHhAAAdGCHTAGF.MACE.aGADCABBKBHHhADAXGED...hAEA...,1,3,-20,23
ONfCeUQGWLTbADRgdPIcEaBYFKXZSVJMH,DDFDRCACdGGH....IFAHaCGFBECCFFHFZFEH....SDCHhAAAMCIBHFCDOABChABACAGGeFABUAEAGABFhAAALHEEAAHG.cGBE.KDAC.JBHD.hABA......hACA...,2,-27,-17,10
LcMUEaKGTFVDPYIAWBSHdJXgCRbfeOQZN,SAADJHCG.CEED.REGDeEDAZAFG.LEBHUCGDKDBFFEAHDDDD.hAAA...IABHhADAAADEHFGDdHCB.XBBBhABAbBDGOAHD....NGADEGFB..hACAaGGH.....hAFA...,2,-23,-22,1
eMOYUQfgXLHSNDTJPIKBEaCbdGWZVRFAc,MAEEOBCCUECH..QGEA.XDFELBECSCADhAAATGEBIACBhAAAEFAACABCdHAFGDGAhABAWAFA..ZCBAFDEAACGEeFDCfCCE.NAIGDIGChBAAKGHF.BGCA..hBBA...,2,-23,-3,20
FgEKDQZBPHAGNLYWMcSRfaCIbTJOeXVdU,GCEFLGECMGAARDCDCGAB...TABFeBAEdCFCUEFBFDHBKHBCDIFABBEEhAAA.AIGC...NAAD.hAFA..WEAG.SAHFhABAaDBHJAFG...OFHD..hADA.....gDCEhAEA,1,-13,-37,24
YMdTHREVaIBAXKbecDJQPSULfGWOFZgNC,KEBDeDGFDIBAQBBF.UEAFfDEGOADGZGBECFHDMDABhAAAdFHARBEH...ECABIGEGhABAAIEE.bCCFPAHDhAAA.SFFDLAHHFACE.NIED.hACA.YGAG.hABA...,2,-23,-7,16
WANGZXgRCTESeIfdJPBVQDOLcbUFYHKMa,ZFADRFEHCECF.ECGE..eDDGdCEGBBBE.QGFDDBABOFADLFDBhAAAUAFBHBBAKCADMABChAFAAGIBGDGE.XGCDhAAASDGG.IDCAfDACPAFEhAIA.....hABAcFGA.,2,-15,-13,2
BLKHIDfXVTRSObQWeNCAYaFUPMEZgGJcd,aGEFFCCAUCFG..ECGDZFAEGCABdAABBHGBLGAC.IABAhAAADCIF..XFDDhADATGGESAFFhADA.OEFCWAEG.CHBAAEAH.MAIBJFFGHDBAhAFA..fECHhAEA,1,-5,-45,40
NVCJXBZbUdDYcMaFARfHTGKQLOEePSIgW,RFBETDGDKGEALBAD..OBBHeECE.IBHC..hAAANCIEJCCCBFEC.ZECDdAGHhAAAcADFFDFEAHCB.fCCDhABAQGGGEGGESBDEWFAH.CCBD.hABAXAFBDFAD..hACA.MIFG.,2,-12,-12,0
QJKBUITDgOScEHfGMRbCeFYLVdAWPXZaN,XBGCZFGDaFAD..QCDBBCBFUFCCDBCFOFGD..SEGFhAAAEBEFHACDfFEHhAAAMBDGCHCHFCHFLBAFhABAdFAEAIAA.NEFCKECH......hACA......hADA...,2,-21,-20,1
fHZMcFKDSBYCTJeUdgOWILVAPRGXNEbaQ,GAAEXDADEEDB.QGFBHCEHZEGHMBAAKFFCBDDECAHH.eAFEhAAAdHADODDBLBFBAAED.hAAANIAH.aCABFEAHDHDGSCHFhACA.YECF....hADA......hAEA...,1,-6,-21,15
eAVEdTLDRIFSXNQYKUGaWMBPJgfHOCcZb,VGFAEDCALGEE.DGCDRBDCFAGC..SBABXGDBQFABhAAAKADGaEFG.MFFAhABAJFADHAFB.OACHhAAAcCAH.ZDDEAFDFIHFHYABG.WDHBhABABHCH.fCHAhACACDAD,1,-20,-29,9
AGbCXVEfeDHYPBJcZULOIQdKaFRTWgMSN,GACBCECE.EAHDDHBAHEFBBFHCZCAAUBDBLFCD.OFEHhAAAQAGGdFAEFDGARFFB.gCEFhABAMCBH.AIHA.hACAXAAG...fGEEhABA.eEEC...hADA...,1,1,-37,38
gPMKWFROYcXZJeHAfCSUGBQaVILbDdENT,CAHCGDGGBGBH.QBCF.aAHHIGDALEFDDCABdGBC.hAAANBBE...TDCEhABAMIDCKFDDFCFDOFFEhACA.XBCEJAFDAAEG.fAFCSAAFhACA......hADA...,2,-42,-11,31
DPSaQCJLcKXREYIBdgbeMfOFUNVWHAGTZ,GCGATAAE.DICC..aGDCJACGLCEG.KHGCXEDBhAAAREEAECADBFBBdCAGeFBF.hAAAMFIFOEAHFCEA.NICFHDCEhACAAGFHSAGCCCCC.ICCG.hADAbFFHfHAFhAEA...,2,-14,-11,3
WEeTJcROGfUHaBALCDYFNMSIdPbVXgKQZ,DFHHFBCEMEIBdAFG....VACFXCFGKGFF.ZAAB..eDFEhAAATEFCRCAD.GFBFhAAAUGBEHEDAADDCCHEB.SAHBhABAIAHAgAFD.EEAC.hACA......hAEA...,2,-24,-12,12
DbKYXRVEdQLNUPJaFSTHMOWZfeBGcICAg,DAEHKGEGRFCFdDCDLAAEUEFB....aABCSBFH.TCCBhAEAHFBEODFGhAAA.fAGHhACABGAHIEBFCBHAAIFE.bAGBXGGEQEFA.hADANCICFBBB..MFAHhAFA...,2,-33,-14,19
SeFWaTcCHLYAQBgNfDGJUPObIMZRXEdVK,QECBBCAH..fEADJAEEUGEB.OCDGMDIFRACBEHDG.hAAAKDFBeCGB.FAHDaABEhAAACFFF.HFDCLCAFhABAABHFDAFEPCHF.IGHE.dGBC.hACASCCD.hAEA...,2,-18,-13,5
OVSceMFKadfHQZBWNYCPbULRAETDgGIXJ,EHDGTEDBGCDA..XBGBJAAB.SBDEeFFAMDCBFFGChAAAKFABdGACQAFGhAAAZCAEBECCNACFCHAD..bGFERGEGAABDhAHADCIHOCHD.aGCFfDAC.hAIA......hBAA...,2,-7,-6,1
TQBHCGZbeDdaJKSYcERNFIAOgPfUVWLXM,OBBH..fEDHVACC.XFGFQDEHBCGGCHBFZFCAhAAADDBEdAFHKAHHSAGFhABAEHCAFAABAEBH.UGGChACAMCBC.HFDGeFAFYEBB.NAIEIADHhACA..PHCChAFA.,2,-17,-13,4
LSaBFCeJEHUMGORAZNgfYQDPKTcdbWIVX,ZFCA..gCAEQADBDBFDKCBBdGCH..IHDELFHDhAAAaAAFFCCA.JEAHEDEGHDEGhABAUGGBMBBAOEFEhACAAGIDNICH.PBFC...TGAAWAHHSFFDhACACDDG..hADA...,1,-6,-16,10
LgPQGVXUSbaeCWRdYTJIFDNcHKMAEOZfB,OEEFBEBDLCEA.QEGGXCCHUGBEaAGC.eAEDhAAACAEFdHAHTAGGFBAEDFEBHEGHhABAAIEG.EDAFZCAGfBBHhACA....gGFGhAAA......hABA...,1,-8,-29,21
YQcSUVDOMCLIEdZTJGKXfFRBAHNPbaeWg,HCEF..PDFHaGCEeBHB..gGGBQBCASBGBhAAADGBEMADALGFEhAAAEFBBTGDCKCABXCADhABAFHFEAACHWHAGUACFCBFEIECHJCDHfGAGhADA.NCIE....hABA...,2,-12,0,12
EBbVCNPUdeDgRKIFaLOHZMQGTcWAYfJSX,JHDEXDAHBBDG...CBHD.UDAFDABAKCBC..FDGBLEFGhAAAZFAE.MEDBQBAFhAAATGGB.AIBG..SFGAhABA.EEDENCEGdGBE.gAEGhAFAaBFC...OHDEhAGA..,2,-42,-17,25
BZIgXYAQdVHPDTCJOfGeNcFaKMUbLRSEW,QABGHFABDEFDJDDHOFCC.GDDDeBDGFDHHMIBCLAAHhACASAHFBCCFIDADhAAAXAGAADDEdAFETGFHhADAfGFH.cEAEaHCEKAEC..hAHA......hBAA...,1,-7,-18,11
HPSecfXUdVgAEIGWBTQRJbLYFOMNZKDCa,EBAFGECDBCGBQAAARDAB.LFABOHBCMGFANCHG.DGADhAAAaAEGHDEASDDEhAAAeABE.fAGHhADAdCCAAHFDIAFFWGCA.TFCG....hAEA......hAHA...,2,-19,-5,14
VHGRLWAEfJCFNBQZcadIUKbgPDMTXOYSe,JEAGCGEBBEFFZABD...dGCCKAEE......PCEAMBGFXFDFhAAAOBCH.eHAAhABAHDAFGDGG..hAHALAEAAIHCEBHDfDDDFGGFNAIEaAAFIEDEhACA....hADA...,1,-22,-34,12
BZGDXbRAFWaJLTEVdgHKePSfMYQIcCONU,aGBFLECB.TFAAdDHAHEFB.KDCASBECMCDA.QBAChAAAICBHCAFBUFFChABABABFGCDBDIGGXGDChAAAAEEHWHBAEACD.eAHBfADBhAHA......hAIA...,2,-34,2,36
GEHIFZTXcBDNdJYPRbAWUMgeSafOKQCLV,UADHeHBA..SCBGaBBF.KGFBLBGHGBGAHADGFGGBTGCGhAAABEEENAAE.JEAERDEBAAHChABA..MGAGOEAAhACACHHCEBBGIGAH.......hABA......hACA...,2,-24,-11,13
BNAJRXEPMHcTIFQVZCbGgfSOWaLUeYdKD,RGDEXEBEECFB.HBDH..IAEFQAGFCHABGDGCSHAAhAAAODADLFFFhABAUDCFeAACKFADBGHFhACAABCFMAIBFCGH...bBBFfAGGaDHDDADC.hAHA......hBAA...,2,-13,0,13
RWKAHaZXcUbSEFGNMfeBTVDCIOJLQYdgP,aDCFZCBDUAEE..SBGCFGFDGEDHMACCBAHEDGFG.CBBC.OGBGhAAALGAG.dBEChAAA.RCGHAEIBXABGhACA.EHCCNIABeDBB.IEEBJBHH..hABAYDAD..hADA.WDDCKGHH,1,-11,-21,10
bgANaBYGXZTDPfHREeLMUICcVKFdQSOJW,BEHEGAEBZEEHDEGEHBCARFABLCAAUEAB..CCAB.KGDBFGBH..dDEChAAAOFDFJGFG...hABA...gABChAEANABB.aECBXGGD...fAHGhAAAMIFC..hAGA...,2,-42,-15,27
UMALHQaSfDBVIXOJGPgTCZeWNRKdcFbYE,LGEEaFDG.SCDFDEHFBCBD..XEAHOBHHJBAHGAEGhAAA..TAEHhAAACABEeAHDNICB.KGEH.dCCAFGABhABAEGGDMFDGAADG.....fCFChACA.....hAGA...,1,-17,-32,15
UZeWLHJACPgcIENdXYfKTMRaVQbOGBDSF,CGBH..PEFF..IAHEEDBC.dABHfBCFMIEERBDB.hAAAaDHH..QEGHhACAOADABFDBDBGBFEAFhAEAeABF.LCFEAHDBgFEDXGBGYCCFhAFAKAGA....hAGA...,2,-32,-11,21
HOGcgJYCUPdVbeATKFfXWBLIEMZSRQaDN,FBFEXDDHLFBG.MEHFRAFADFGD.OHECGABH..JFABCHDGdGFChAAA.eDEAADBDKBBCBHADhABAEGDC.SCAAhACA.NCIC.HCGF.cBCDYEAC.hAAA......hABA...,1,-9,-33,24
LGYHJRMUbKIAcCgVfWSNeXPEOFTdZaDBQ,CHBGVAGF..SFEAeFAH.EECDOHEGdBGGZDABBACHLHEChAAAGDEBHBCAJCCAMBABhAAAKAECAEEA...fFGHhABAWDHH.XFCBFBAB.aAFBDAIFYBBFhACA...hABA...,2,-17,-7,10
gLCAYWEDHUMKQBGfVNZOcJdabeXRITFPS,EEEBHAEEKFCHQGAB.GEGCfCCGZBABJDFDdCEFaHDCXGEChAAARCCB.IHABhABA.FCHFSAAChADAgCADAECFDCIBMBFE.BFAF.NAEB.hACA.OBBA.eHFAhADA..,1,3,-13,16
dPgcVfZQYOCGIMAENFeRUWXaTbHJDLKSB,FHFEeEDGRCCC.UGEH..XEEDaADD.HDAHJCBHLAHDhAAABFHHdGAD....PACAhAAAgFAG.fABDhADAQDGFCDFAIBFDEHCCTAFGDIBGhAFAcBAB...hAGA...,1,-9,-29,20
gWHeNFfVUJRCGSKEILZQdBcMDbPATYOXa,TDBBOFBB..aEDHHBFG.FEFFUCFHCFHFKFBFEBBB..ZGDCQGFEhAAABABCMBCADBEBAIEC.hAAA..XAFFhABAeCCE.fDAC.REECSACChAIA..IHHFhADA.dHAH,1,-14,-23,9
SEGCYDZJWQAVTNbfaOURMLBgKeXHcdFIP,VDBCTFBA......bFEGfAGHOHFA.UBCAMBGFhAAABEGBKBHDHBAEFDEDSFAFhAAACHAGZFAAQADFhABAaCABgGGB.XGDE.hACA......hAEA...,1,-8,-17,9
RMaPFDTICWKNOfeHVLZgBUQYScXAEJbdG,EBEAJACEGCEBRACF..aGDGDCCC..CFFEKAGEOFEB.HGFGVEADhAAALGAC.BFFEhAAAUBAESBAHhABAACHAMIBCFHFGIHBD.WBFCNEDB..fEHAhABA..hACA...,2,-28,-18,10
GACRafBbFScZVXLEKTIWdHJePYgMUONDQ,CACBRADFBEHCFGFA.ZBFBLGBA..KFAD..TDGAIGHFhAAAdECCeCCG..gBBDhABAMAAFOBFGhABADAIFAFFBaAEB..fFCHSGADXGFDhACAEEEE..WBBFhAGA..PHCA,1,-29,-34,5
DcHVIFQPJabTKYXfgMOUZBReGASEWNCLd,EEFBCHCADFBCHEAD.FGDHQCCF..PAAAaEEF.TCCHhAEAXADC.MIFGhAAAZFGBBCHDRAFH.AHAHNBDBdFHAhABA.ICAGKCEC.fGFF.hAFAOBHD.eFADhACASGEB.,2,-13,-11,2
RNWdZEPCfaDJKMXHQUVLSgIbTYcFGeAOB,BBECRADAdBAAZDCDEEGC..CBAC.DFEF..KDAEMEADHGCE.UDDELCHBhAAA..IHGAhAAAbFFC...cEAChABAFHBEAHHEOCBD..NGEF....fAGDhACA.XCFFhADA,1,-26,-35,9
gGDfQFYHAIKJONbEBSLWZePCTXaUcVMRd,KFDFJBFE.ODAB..EBBEBBBELCABZCFB.CEDB.aHAEUGEG.hAAA.MIDCdDGADAAEFAHFAEDAhABA....NAEH.SCEBhACAeECB.XBCH.cFGBhADA...gFAHhAEA,1,-28,-47,19
QTOLEXcPCJMVNAKfGaIgHbWeZSBFdRDYU,KHBGaCHDHBCCeDDDBHDBFACG..DHCCQBBBOBAD.ECFHXFFGhAAACGHD..MCAHhAAAAFBG.IEBBbAFFSEEEhABAdGFCRAGD.YDDF....hAIA......hBAA...,1,-21,-24,3
DMEJcdCYPfOLgZeVFBbTAWQaSIXUHKNRG,QCEDSDBAUABCKHDERACH.GECF.MBGFEBAFdAGH.CFAE.hAAAPFBBOHFELHEEhAAAZEFGFCHBBGHEAAHDIAEBhAGAXECGDDHD.JHAC......hABA......hACA...,1,-12,-17,5
fRNHJDaSTCOBdGILYVFMZKXWPAgEUbecQ,EGDEUAFA.eBBHQCDARFED.HAACDBIB.SHDGOEBCBBAChAAAIFBBLHBChABAFDACKHAC.XAFBhAAAAEECbDGD.cEFB.fGHGJADBCHHH.hACA......hADA...,1,1,-24,25
VIMYaQHNOTcXEgbGAKBUdSPfRWeZLCDFJ,KEHFUAAGdHBF..SCGDREDAZDAFLAHFFEBH....VEDChADAIBCA.MAAGhAEAQADA.NCIGODCGhAGAXAEHEHFEGGEFAHHCBHAGfDDFhAGACHCBDBHB....hBAA...,2,-26,-18,8
PDLBJYUcHSEFMTNQXWaOGKACRZIdVbfge,ZDBGdFGG..VGAG..gGAHDDACLAFEBBDCUAABHDFBFDCEhABAMCFE.QBADhAAAXEAG.aEHFOFEFhADAKAGACHHBIFDF.eHDEJDFGSEHHhAEANABHAGAD...hAGA...,1,-10,-18,8
ZGVMXBUfSLRYICWadKDNOQcPTHFgJeEAb,GAFCVEDG.BGFAUADFSFADLBHFRCBECCBH...dAACDBBGQGCHhACA..hAEATEBCFHGA.JCHDAFHEMBGBhAGAfDDB.WAAF...NIAB.hACA.....cFDEhADA.,2,-47,-14,33
SdVLZcaNCEYIgbWGUOMPAKTXBJfeDQFRH,KBGDBEBBeFBAQBDAFADH.HCGBdEHEZGFCaGDC..CHAD.EAHB..hAAAIBBG.bFFAhAAAUCAD.MAFFAFACXCAGhABADIDESDDGcGAA....NIDD.hACAWGAG....hABA...,2,-33,-7,26
GNdDYRKLaZWVbCSPQBXgFTUfEIcMAOHeJ,OGBCHCFHeBBDGDGGdBFBRECEKEDFLFADZAAB..VCDGCADCSEHDhAAABEBHFAEAUGEAhAAAIHHG..ACCADBIDhADA...aAGD..WBAD....hABA......hACA...,1,-16,-24,8
SQGYgOUWNLDPcAaMKTbIZJHdCVEFBfReX,KBAFTGGGZBFHdFFB..CGBEFBAABHBD.RDBB.eBFF..SCCBhAAAQGDG.GEEDhAAAOFEHNADGLFAFhABADIFGABDE.aAEGMAECIBHC....hACAJAHD.....hAHA...,2,-36,-13,23
VWXUafPcBYIDFeOAHdCGSLRgZNEQJKbTM,CAHEGGADLBBGZCEEEGGFKGFE...MFIB..VCEGUCAEaGBB.hAAA.PFCABAGGDDAFhAAA.FHCGADIDHABG.hABASAGGRDBE..NIED..bEFE..hACA......hADA...,2,-26,-11,15
DHAfMRTaQUIYPGOJLecZXSKdbCVWFgENB,MCABTDFCUGEG....IFHCGEBFLCDAeEBAZCBEKBAChAAAdEHGCBHBFHACEBBCBBGBhABAAHAC.RGCGaAFGQGBChAAA...........hACA......hADA...,1,-20,-22,2
WDYXCEObTaGUBSNAJfKHFQLIgdZRecPMV,KFFDQGABLACHdABCZDEEeCEE.MDFFDIFECFCG..EEHFOAEGhAAATDAAGBEF.hAAABBBFADEBJAFGFHBAIHEHhADA...gGGA..hAEAPEHFWDCB.YBAFhABA.,2,-40,-5,35
ORIEbeHVZcFPABDLXKWQYdJTfGMSUgNaC,DGHFXADEKFBH..QEFCdBGC..TBAAMBEAUCCHhAAAaHFECDAG.RGDE...IEGChAAAECABeAHHHGAA.hABAZDEF.FECEAHAFBEAD......hACA......hADA...,2,-29,-16,13
KUALSNHQJeIafFcdOTBbZMVRXWEgCYDPG,LHCCSBGAQDFDeDHD.aAFAfCFG.dFEGhAAABACGMEBAREAFXADDhAAAEAECCDAFDGBC.KDDHAAHEJFGFhABAFGGGOABHZBBA.WAHH..PHBEhACA......hADA...,2,-18,-12,6
DVGWfANeCSORMKJULcPgQHIYEbdZTBaFX,CHAESFBGRDAB.KECCJDEELHDE....gGGDhAAAQBEEHABBEBCHdEGEhAAATFCGBHAFXAGEhABADAGCWBAHAAGC.NABH.MFFC...cADHhAEAIHHD.YCHHhBAAaHCE,1,-33,-36,3
fTVBQGbYaZHPWFCRUJcdgKONDLEMeXSAI,TCADBDFCGCGA.aHAAHFFD.FAGHCBDHRAABJABG.dDDDKGFHOFBDhAAADDEH.LAHHhABA.EAEHeEAGAHFBfDGEhBAAbAFAZFAA....WACC...hCAA......hCCA...,1,-12,-24,12
IYKfHXbTQgSeNFUaJAZGBDcEdCVLMRPWO,BFBEDEIBEDGFdFDF.CCDG.LCEF.RCAH.OBADKAHFHABA..hAAAbGBATFBG.SHFChABAeFHFUAFCADDF.hADAGDEHMFAH.IHFH.XACGhAAAgGDF.aHGE.hABA...,2,-33,-6,27
CZeXYLTJUGOgKMRDVAWbPaSIFNcfQEHdB,...PFAHSCEDFFGD...cGABEADHHCBD.CGDFZBEEhAAAeFFBLFEBUAABgDABhABAKDFEDDIDACAB.aAFChADAfABHBHDCXDGF.JFHB.MDDFhAEA.....hABA...,1,-8,-21,13
ANHSBLVfDXPUQTEKZcCedJGYFRgbMOIaW,HACFBHBELEHHDDGCUGAD.QBCHKDEDZGFC.CBGF.dBFFGDFChAAAFBAH.REBGMAFF.aBAHhABAAEABSEHHhAAA.XEBE.EEGHeHDE.YAHBhACA.OEAHhADA...,2,-24,-14,10
GUXFPbNTORSCAagVQEfBHdDcKZJWLIeYM,VCFEQBAH.BGDDHFFAdCEDDHACKEEDZEAGLAHFeBBEMACGhAAA..UGAEFBAH.NEIA.hAAAOFEHRDAE.CDDEABECaHFAhABA.EAFH..........hACA......hADA...,2,-20,-18,2
GZLNaOIfEJgRQWUcbADKXVTSdMYCeHBPF,DEDBKFDD...XAGDVAAG.dCDDMFGHCEGH.BEEGFFAC.GAFEhAAALFEDOFAD.ECHHhADAgGGC.hAEAQCAHcCDFAAFBSFHBeAACHACC.hAAA......hAFA...,2,-20,-20,0
IMeYCKdScfWEVRGNJgOQZXbATaFPHLUBD,FEFDHEGFBFBFDDCBMHDE..CHDCdABA..fABEEAGFGDBFhAAAJAFH..OCHFhADAXDEGAAED...aGADhAAAPFHBICABKHEASGADWEAF.hACA.NICD...QBDBhAFA,1,-23,-38,15
efTcOUDQMNKEVYJPbBHaLdgZAWXCRSGIF,CFGESFDGFHCC.eACG..TABGODHFDAGDQCFFhAAAKEAC.EBADJAHBBEAAhABAaFAH.dHBHZDDGAGBEXFFHhAEAGFCH.fDDBMFIF..NDAB..hAFA......hAGA...,2,-29,-17,12
NTeDYbSKUCcGPEHIMLFWgRAJZXBaQfOVd,JDECBBGG.aHBGQBAE..OHFCdHDHTGGCDBCHSABChAAAKGAFUFCBCCCBGDGChAEAHAFGLFFChAAAFECCRBDDACIDZFBCXADF..fAGDhAFA......hAIA...,1,-5,-27,22
TYQINeSfLOBFJZHKAUcPMbDWXCEVaGdRg,UBGHMIFADGFECEBD...EGBFGCEA.RCBC.TDBDQGADhAAAeBFELDFEFGGGZABGAACG.hABAPABG.XGEGhAAAdAFBIHEFSEFAfEGHBFAGKBBDhAFA.WFCH..hAGAaECD..,1,-11,-19,8
WDMXdgbGROHSPVJYTQBCAeKUcEaNfLIZF,UBGFEBAB..aEEFLHFEFBFC.DFBDMIFEdFDAGACERFAC.HCEBhAAASDFB.hABAPDHFJCBH.QDBHhAAABAFCAIGCKFGANIAHIGGBWHAG.bADF.hACA......hAEA...,2,-23,-8,15
feSUDHcgNJaBRdLGYVPbEWZXOKMTICFAQ,eBAEUDDGDFBFHEBC...NGEH.aHDEBBHCdAAEGAGA..PAFFhAAAEBDAZFGDKHAGMEAChACACDBBADDA....fDHAhABASGECJHDCLADE...hACA......hADA...,2,-28,-18,10
ZEDQMWbePKTcdLBSOUNRJYAVIFGHagCfX,VEBHFEBFHBCH.CEEHZFDGDHEC..QAEF.MDAEbAGFeDFGhAAAKEEEdABALFHFhABABDHBSFGENDAC.hACA....YFAFAGIHaGBH.XGGDhAAA.....hADA...,2,-22,-16,6
bLUDcCYIRAeWQgBOMfGVHNTSFdJEXaPKZ,eGDCQFBEBCFDMBAFGBCD.HEECSBDDJAHHEDBCaAEAKBGAZECEhAAALHEA.DAAAhADACAFARDAFAGHC.OFHF.hAIA.fDEHTDGAFBBF.dHAF...hBAA......hBBA...,2,-10,-6,4
UgIYbaBeHKTMSGNZXQVEJdALCRFDfWPOc,LFCHFGEDDBFD...fCGHODGDUDBB..ICAFhAAAaAAD.BBEAKHAAMGAGhAAASGEF.ZABFhADAQGGBEAGGAGCFCEFAWFAFPAFA..YHFEhAEAeCFH.HDCChAFANAEE...,1,-22,-27,5
QBPZeaWMfDYGXUKAOHVINJbCdTRLScgEF,HFGDVFFF.JAAB.dHAFLCAF.SCFAECFFFFCCBBEHZBDDeFCDhAAAMAFA.DGAB.XDGEhABAADCBOHDEbBBFCFFC.hAAA.....cCCA...PDADhACA..WFEFhACAfDHG.,2,-23,-13,10
DXJOMTbgPYUVQKBaEfSdLHIGAeFZCWcRN,eFDGCEAARBBC.DCBE..OFCGMFFC....TAED..PAHBhAAAUAGGKHDAaDDCSGFDhABAdABBIDECAACEFGABhAEAZEAB...WEGDNAAC.....bAEHhAGA......hAIA.gGCG.,2,-22,-22,0
BDZWHXCYdcKVPbSUQNRGaIAMLfgTEOeFJ,LDHDTGBC.OBAAeDADFBAFBGFEZEGHHFAC.CEFA.dAHGKCAFVCDGhAAA..SBFChAAANIDB.aFDFAEBE.MICEhABAEFFHDAGFXCEC...cDAEhACA......hADA...,2,-23,-17,6
EaLQSHZPOVRNKGedXWcYDTUCBFfIbMAJg,EGADLHCGHFDBODBARBADGAGA.dAAFXCGA..cFGAhADATAEF.CACAFGGEbAEB.hAIAAEEE..aAAHQEDGhBDAPECH.KEBA....eFFCDGBH.BEAHhABAfCCB.hACA...,2,-9,-3,6
WDJAISQVRePbUfgNKaBLFdEMcOHYXGTCZ,SHFAQBFBRCBGeDCEUFAB....NDGEBAECdEGEMFIHOECBhAAAXGFGGBDFCABEDIAChAAAADAD...IHDGhADAPDHDfAHG.KABDaAEBEGADhACA..YFDEhAGA...,1,-10,-27,17
CAHKPJbZWBFIdGDYQfSLXgTEeacUNMOVR,HBDCJACGZDDDFEAE.dEECDFFCQGGH.LAABTAGDeGDAhAAAaBHHUGBF.OFFGhACACBFDACACKHGE..WAEChADABDCH...IGADfCCE..hAIAXCGE.cCAEhABA.,1,-1,-53,52
REPUVgSMZJDYBecGXdLQIHfaKbFAWNTOC,TCDBCBCDRGEG..UFAFSHECZEDG.DCCHeBEDGDGALAABhACAIAFGHBFCfCAChAAAaDAE.FAHHAIHCNIBHhADAPFCE.MBBGBDHHdCFA.KEAB..hABA......hACA...,1,-11,-15,4
PCQJZdOALcIbTSNMeGXEKaWBFfHYRDgUV,LHEE..bGBESFGEMBECeFEGXCFFKCEG.BDDHhAAAFAABHDBGDAIHUACGhABACCBAJHFGZFAHABIF..TDGDhACAEFDFaCBH..YFAD....hADA......hAEA...,2,-22,-19,3
RJUcMBeCENOYDaFTfXKdgSHLGPAQVbZWI,VACEZBDCRFFDUFDA..BFEB.CDHF.EDDGOCFDDACC..FAGG.hAAA.XCACKFAFdBBGHCGBhAAALHAE.AEDBQGGAhABAIEBHMIBANGADaAFA....hACA...fCEAhAIA.,2,-32,-22,10
NFUPYZMeESaGORCWKdfDAQHJVgcbBTXLI,QGEBJEDB..VADA..cDGEBHFDLCBDhAAA.FGAGUDAEZCDGEGHBhABAaGBARAAG.KEDEDDABAIAEgAEFhAAA.TAGAIFFBNDDB.MDIHhACASHGACCHC.hADA...,1,-10,-32,22
RIQYAHeadNCOBUWgSPDbGcEJLFMXVTfZK,eHCEaFGG.dFFCCGEGBBDHUACH....SGABDBCBGDAGJAAHFDEFhAAA...MABCXAFEhABA..TCGBhAFAKDAFIEDCAGCH.NCIG.WHAG.gAGChAGAcCFFEHGAfGHAhBAA,2,-40,-34,6
SPZVaUKLfCXbgJQYBAWMDRGdNHTFEeIOc,MGBEDEDGdAFGHCBEFACD.eECA..ODHBPFGDZGDE..VBFDhAAAKBGCLBAH.hABACFDE.gADFhACA.JHBABCEDAHAHWEHBGEBCEDAB.IHHDhAAA....aAGAhADA...,1,-7,-32,25
LVNGfKUMcYDbETPBeOFAQRWXHZJdSagIC,RFAAHAEDdAHC.SDHH.aCDDCFGBVGDGGCFG.KAGEMACFDDACEBBChAAABADH..OHCGhABAACEDQDACZEABIHHBhACALDFA.fDDE..hAAA.cGGE..hABA...,2,-38,-1,37
QIYdSZObJHLeAgBWDVMCKFPEXacGUfNTR,BDCCDDCGCEHB.FBDC..EEAHaFBE..UADF..TGDCRDFD.QAAEhAAAdAHAOGCAHDEAhADAACAB.VAGBKABF.XEAChAEA.cGGAfHGB..hAAA.IHBF.hAFASHDA.,1,-8,-41,33
TeBZASbFKCDIaLdcYNMgVQPGRWOXEUfHJ,SBGDFCHBKFGH.DEFEaBBCLBCF.dFAD..NDBDMBGFhAAAQFDF.PHBChAAAREBHOFEDUGGGJACGBBHChABAAIHE.ICAE...YAEFhACA.....hABA...,1,-11,-44,33
cAORadEPIDGWJCUNZgHYBXSFebKVQTfML,aCEDdFGAEDAA..DEBBJACAUDGA.ZEBBHBFGBAAGSGDHhAAA.FFAEeGEGKDFDQCCGhABAMCAFACBD.OHAAhAFAICDFCBBF.NIAB......XAGChABA...hAGA...,2,-36,-19,17
cLDTaCBEfJVPWIZQYSGdbKFgRAHXUeMON,XCDCeEDBMDIB..OGBELBDCaAGH.BHFA.EDGBfFEHhAAAVEAD.PDBDhABAIHHEZABGSFHDhACAbCACFCEH.AEEDNICFDFFHCHADJDFEYAHD.hADAdABG.....hAFA...,2,-16,0,16
NSVDPYQCRGaFUfLTOcdBeHZKJMIbAXEWg,EGEH..gFCGSCHDDBGDQBEHCBAEGBDE.FAAFLEAFhAAAOEADBACH.hABAZCAGJFFDbFFBAADBNDIEYAFChACAaDFE..fDCGcGBEeDEF.hACAMFIB....hAEA...,1,-5,-18,13
WPKLDUCGXfFgJIYMcHaTZbQANVdESRBOe,dFAHSHEGOABD.eDHFKGFFLDEG.DDBDUACH.GCDHhAAAFADA.IHBBhABAMAAFaDDHTAFF.hABAQDAFAHAEECEEBHHCCFFAXFACfGCChAGAYFHB..hADA..cEGD,2,-26,-19,7
FJEPeYOCcLTbQSKdIfGBZgDWaMUARXVHN,VDEEHBAHFDED.EABEeDCB..CCDALAFCTAAB..SADChAAAIHCAGCGGhAAABHHFZBFADGGFaGACAADAXEBHhBAAJHDEOCAH...cEGE.KBDHhACAfBFH.hAGAMFIF.,1,-3,-25,22
dTcaFHeLBKGbQSUIZVYXNDWRMgOPCfEAJ,JCFHdGFBaDACHDBB.BHHGKHFAGEBB..QAGFUBCBZAFG.hAAAXAACDHCARCGB.MFFBhABAOABACBDC.AICGFFAHhAFALEAD.IDHC...YDDHhACA...hAGA..WHAA,2,-20,-19,1
IAKcLgMEUDGRabVBZfXSNedHQTJWPFYCO,KAEGLFDBEHBE.UBCADADFGDFERGAG..VAGBBCBCZFFCSCDAhAAAdBACHDEGQEADhAAATBGF.JHFCFEAEhABA.OFEHAAEC.MGAC.fHGHhACA.....hABA...,2,-18,-7,11
MHRCUILdebOWKJGDXVQYcgfaFBZEPATNS,TCGESGGC.RBBD.CFFCLBCCdEDE.eFABbAGB.KAACJADFDECEhADA..QGBHhAAA..gGGAhAEAaCFFBAEBEHEGAAHAMFEFIHHFWDCE...hAFA......hAGA...,2,-32,-14,18
YLaKeGVJIFQbCgfTBXHZMSDUdcPNORWAE,EAGFaCHDGBBC..JCBBQEEBCGGA.TGAEBBBCXFBHhAAAMAACUGGGdADCPFDBhAEAOFEA.ADIHLDEGhABAVBEEFAGA.fFDG...hAFA..SGADhACA.NICH,2,-41,-2,39
PHNbXVfdJeKZAcGgRLFDIETaBCUWMSOYQ,GFEHLHEGFEDCDBGAEACFBCGF.UEBAMBHF..OBBAQGABhAAAHFEG.XADHhABAdHAHKDHDAFAERCAGaGDC.SAFChACANADH.fCFAeEDC..hAIAcBDEIHHGWAADhABA...,1,4,-33,37
TAgSHCJGUVDIQYOZLcPRNFaEWMKXfBbde,SCBFCCDHUGGH.DDEBQAGFZFDG.LFAARAFGFADHaGHFMBBEhAAA..KHEABDHHhABAeDFCAFHBHDAE.JEEHhACAIAAHOCFFPHAGNEAE..WFCFhACA......hAEA...,2,-35,-10,25
WRfEQIYOMdLKcCGUPSJXZNDFVTeaBbAHg,HDACRCFEQFBCOBDFMBIDKDDD.GDGAUGFA.JHCGZABD.FAGFeFAHhAAABEGGACBH..fACHhABAEAEFdAAE.CFEDSAFHhACADEABaFEB........hAFA......hAHA...,1,-12,-21,9
ZeRNTCafgJVUMFGdHSEDIBbOAKWcXYPLQ,KAFGXGCALBDHZCAG.RGFE...CEDB.aEFGJBGD..UAADFGGEdFBBhAAAEDAA.BACA.AGAF..hABA...YFCFhADAeBEB.fFDGMCIF.SFAHhAEADGFFIAFA.OHAChABA..,2,-32,-27,5
JLfPGdKZTRFHYIDSWEXBeaCbUQcVNOMgA,JFAALFDDGADAKFHHZGDGFFAH.HCEFDBID.EADHBCBF..eAADhABACFFC.QGFDhACA.NAIA.MEFC.fAGGhAAAPCCH.dABD..YCGHhADAIHAH.SDDDhACAaGBD..,2,-35,-8,27
UQXcSZJIGbfdLATEVCWPHaORMFNeBYDgK,ECAFCAFHHABDRBFE.FFCDBAGE.DFBEUCFC.QFFASFGGZEADhAAAGGDHdDEC.LDCGhAAAAIEG.TABEhABAWDAF.aDGC.MIAGNAIC.gFAGKFHH.hABA......hADA...,1,-7,-22,15
EQDXfgGLIFKAHVCWOPRYJSbeBdcNUTZMa,HFDDCHHA.OAEDRAGB.JDBBeDFG.dFABUAAEZBDFECACDCGA...hADA.XGACGGCDIDCBhAAAADHF.PFFAhABAbFFFBADA.NDIGMEDCfGAC.hAGA....LACChAGA.,1,-17,-18,1
ZACYIVHPdTSULKgNfRXMabFWDQOJeGEBc,CDDCVACDHBEH.dEAGUGDCKGED.......gGGGhAAAfHBDMAFFFADGDAHBOBAFhABAJABD.eAGBBGHAAFHFIEDEhACATDGDLFFB..NCIGaCFDhAEA.....WHAChAHA..,2,-31,-10,21
CZVaAELNKeTQfBIPYWbGgRXMJUOScHDFd,EBFBLFEDKAGG.TBCGBCBC....IEABPCFA...hAAA.bEACRDEGMHCA.hABAOACFcCBHDAAACGBHaDGEhACAACEHeFAAQGGDfGGBWHAA..hADA......hAEA...,2,-34,-15,19
JSgbBCeEPNHKfZVcaDRTWQXYGUOFILdAM,JCFGSCHFBEAD.CFGA...ECDCHEBHKACD.ZGFC.VBDHDFECRFBAQAAFhABA.XAGGhADAUGGFFDAALHAAhAEAAAAF.MFEFeHAGfFAGaAGC.hABA.....WEEEhADA..,2,-38,-8,30
RPCLaJgEKBOTGdXMeVWZUfNAFHSYIQDbc,SBEHQBDGDGBHREABLGFA..gCAFBGCATBBDhAAAdCGGMCIH.eFEGhAAAVDFBZDCEUAGAAAHDYHFGhABAIECB.cACACACCEHDC.KHDG..hABA......hAEA...,2,-20,-6,14
UcFPfObdWagJMITSeLNHXGVRQAZEBCKYD,EFDFBHHAKAEGUFBG.FGFBOADH.dCGDaCCG..JABF..MAADhABASGFDLDBAhACA.HBGBXEAFhAAA...RDEEAFCDCFAGYAEHDIACfGGEhACA..bEFAIAHFhAEANIAF..,1,-21,-33,12
WEaRSbTCHOdfGABQNPVDJKILFMecUZgYX,BFDHQCFB..NHBD.VCCFKFGELDFCMABG..eGFChAAAZCAB.XGBDEADDaAGF.hAAASEFA.hABACGACOAFGdGGDfDCEABEFDIEGIBBFhBAA..cAEA.hBDA...,2,-30,-19,11
MCGaRHXEAPIfFBNJKZSUcQgLYdOVeWbDT,..IADGfDDHBEGHKEABZEEB.UGABQABB.LAEChAAAOCBDeAABhABAWGCEDFFECGGCRAEH..EBGHAGIHNIADhACA..SDDD..YCHHhAIA.dGGE.bBDEMIEEhACA.aDHF,1,-16,-24,8
VSaYbdLBARNcXTHefIDUPCGFgKMZEWJOQ,RCECXCAFeCBB.DEGBCHBDGACG.KGFEMHAG.ZABAEAFAODDFhAAA.QBGAhACASCHBaBFHdHFHAIAGNICFHFCFhAAA.fFABUEADPEHBgEGEhABAWADE.....hAHA...,1,0,-18,18
HEMXBeRNFgAUVbLDTZPCQaWKOfdIYJGcS,VCEGDFACZDEE..CDCA.aCGG..OEAFdBBH..JFCD..SHCEhAAAEFFF.XBAChABABAHGeDACRFFHNBBF.AHGC.hAAA.LACCQAGEfGAAIHHDhACA...cECDhADAMIDE..FEHD,2,-30,-23,7
CcfBQLYDNJOZKWAIRgdebUaEFSGHTXPMV,RGAAeFCHUGGDEDCGGBCHHDAB....XAAFMACGCEGC.BHGALAABhAGANBHC.ZFDDKAEFAFBHdDDDhAHAaGEBFACD.TCEGhAFA.....cGFB...hAIAfGAEDDGE.hBAA...,2,-22,-3,19
GCLTcJKOWXAQEBRZNPbSUMFaeYDdfVHgI,QBGCBCHEZECF....NEFG.PABEUGAF.MGAA.aFEADGIHhAAAdCFGHBAB..gDCAhAAACAEGLEGHJEHHhABAKFAEOHAGADDG.ECCCSACH.hAEA......hAFA...,1,-14,-33,19
GbCfSQYPXdHFJITWBRADVcUaZKOENgLMe,DGFCUGCFZCCCEADCLABCGAAE...CAHG.SEEGQCGDXBFDhAAAHFCBFGADTFGEhACABBEHAFAA..aDAHKEEFhAAANCDC.eHEC.fDBEdGAAIAHC.hAFA......hAGA...,2,-21,-5,16
QHBaSWbcTeRNCPGMYgdXLfVAEFZIJUOKD,ECFFFFAAZEGDUCAFKGEEHFAA.BGHC..aAAFSGEB.hACA.bECDeEDGRBDACDAE.MAIHhAAA.dABH.LBEChACAAIGAIEFEDDHF.QAGA.cGAChADA....hAEA...,1,-11,-38,27
HIVJKSBLgPNAcaYUFWXbDTeQdROMCEfZG,aDEGUGCB.FECF..XBGBDBCA.QBBDOFHB.MFEGhAAACBHAZAFFGFAD.IEAHhABAKAAEBCCBPGEChACAABFB...WHAGeEEAEADD..fEAEhADA...hAEA...,1,-19,-48,29
LXIDbSFaHdNCQfVGeZPKUcTgBARJYEMOW,JFGBMEABLGAADGFA..SCGBHADHdEEFCDABQDCBhAAAGABGZCFAKBDA.UGBB.hAAATABGABGEEFAG.OFHDhABAIHEAFEFCNAIG.eADE.....hABA......hADA...,2,-19,-6,13
VZaWbHSNLOYgCcUDMQfRGBeTdEIKPAXJF,JBEAFDBHZEDE..aFHBHACF.LAFDOGAG.CABCDIAGQFEFhAAARAGD.BADCeEGHEBCDhABA.KCHBAEEAXGCEhAAA..VCADSFHHNEDD.YEAFhAEA....hAIA...,2,-25,-21,4
gCVEAUbfIcaLMDTSOeWdBKHRPGJNYFZXQ,UCFB..fBBFaCBGLAAEDDEBSGEE.eEAEhAAAWEDAKGBEHFBAGBFEhABAJFGBFAHFXADDhACAQAEDCHECEAHHIHAGMFIDOEABBHHF.hAEANCIE......hAGA...,2,-19,-5,14
WBdLbGFQCgVIJZEcXHfeURYAKNSTDPMaO,SFADDGBFMAAF.ODFHdCECLFDB.FBCBCCBBVFCBZCGH.hABAEAAAHGFC.eAEGhACAUBEFAAHAKEBETGGF.hADAaADGBFFDQDCD.....hAGA......hBBA...,1,-14,-18,4
UOIAZVYBWdDEceaMKTgXJQfRFGCHPLNbS,ZDEABDGDdBGDEGAGeBCBKAFG.....TGDBJFCARBDD.FEAEHCACLFDChAAA..SHAGhAAAIHBBABAEVGFGhABADADCMDID..gABCfHGBCHDHbBFAhAEA.....hABA...,2,-28,-13,15
MAFUERZBfPgQVdLbIJNTKGWcaCeSDOHXY,EBBDRAFEBADC....fBDEQCBCdBFBLFAEJCFDKEGHGEAAhAAAaGGECEGE.DABCHFEDhAAAMIDCAEDEFHAC..hABA......PDDHgGCGhACAIHHFTBDGWAHB.hAFASAEC.,2,-19,-10,9
HMeCdPbLQOaSTRIgAYKUcEVGfWXDBFJNZ,UBEBEGGFGACF..XBABDBIDFHCCZFAEHGFE.CHDH.dDEELEAEhAAAODAE.aBHHSGEBhAAARFABAEGF.KBAGcFDGhABA..WCFBBACEMBHH...hAEA......hAFA...,2,-22,-19,3
MZTIEAROPGScXCeWQVDbdgJLFNHBKUaYf,OFDESHBA.CBBA.QCCD.VDFAdBHCJEBHLBEAhAAAFEGEBEDBaABEMFBHhABATFEAAHGE...RAEB.PCABhACA..XACBDIFA.NBAEKHGC.hAEA......hAFA...,1,-18,-30,12
HCGPMFEVZQKfaXSOdBIJDUAeNRcWYbgTL,eCAARCEH......WCBAgFBCLEBFCEACGGDFhAAA.FEGAVAAGQAGBhABAKFHBaHDE.XEEChACAdAFFBEGBDIGEAIAANDAAcBFC.bABA..PGCAhAAA.EGGDSDDEhADA,1,5,-31,36
baHFdVURGfNOCLATBKcPJZSYeEMWXDQgI,BADAKGDF.JDDFSDCC.EBCCMFFFDFIF.QBGGhAAA..bEEAaCBBdFBCVFBFhABAGAFE.NAAB.LEHBhACAAAFH.PCDAeAHB..WBBF.hADA......hAFA...,2,-31,-17,14
RSUagPADBZVOEYWCdcJHeNfILKTQFMGXb,BHGCZECFEAFHCABF..dECEHCGH.eBED..NBCH.IAAELCDChAAAQGGGFDAH.hADAGDAAXEEBSEEDhACAaHBA.AADBDAIBOAHH..WHAGhAEAfEHAKCBE..hAEA...,2,-46,5,51
OKSMEDPYLgJcCVIdBUeHafRNZTAFXGQWb,XBAHQEAB.OEFASCFA.DHBEPBBGLEBGhAAAJBEE.CFFAdAEDeFGDfHGFhABANICB.AIEGFACDhACAGDDA.KCGGMIACEBABYHAEgEGBhAFA.IAHFBFHAaAGAhAAA...,1,-10,-11,1
VTdIHCJFWBLUPZbKAGNYRgEfMOcSDeXQa,GAEDRBCAEFAA.OCFEDABF.eCAFQGEEaDDH.dDFHCFFCFHAABEDChAAAUGGFZGAEAAFB...hAAA.gABDhADAfACHSEGB.XEADIGHHhACA......hAGA.WEFA.,1,-6,-25,19
FMgXVGJSUQYDBZcHeCKObdTNLAPWIREaf,..IGHFEBDEaCGCFEEF..MDEG.VACFSHFG.hAAAUCBFDHEEBGBEZGBE.hAAAeEEAKFAGOAFGhABAdAGBTCAGAGHE.....WFCHfABFhAEA..XEAGhABA..,1,-23,-31,8
RcgBaEfDGHbFdMQINLeWOSAZVTYKJXUCP,TGGBKDCCUEAA..RDACBFFFECAA.GBDHFGFF.dAAFMFDF..hAAAIDHCLAFBeEDChADAOABGAIFG..YHBChAEACHHE.gAGEDBIHQEGFhAHAWFAD......hAIA.SEEF.,1,-9,-23,14
HTKaEfFPVBNOCDUWbSgJcdGRYAZMLQeXI,MBHBeEAEHACDKCDF.aDGDEFFH..FAAHBDFCCGBG.DDBHUAFA.SGGGhABA.JEEFhACAcGCG.dGHAYHBGhAEAABIFQAAB.IAEAfDEDhAIANDAGOECE..hABA...,2,-42,-8,34
TaRLJYFMbNgBUWHKEAQSZIcDeXVdCPGfO,SBBGZBEEDBEE.eGAEXCCH.dDFDPAECGBAAOHFEhAAARFFCLHACFDGEMEFHhABA..NIEB.BEAC.hAAAWCEFKABEAEAF....IHABCGDBaAGA.hAEAYDAC..hACA...,2,-34,-10,24
KJdBNbfWRFcYCgIMeEPaQHVDUGXTASLZO,LDDCKCAHBGCC...fGGFRCCAFEEG.CAHH.MCFE..eHAChAAAEGAH.aCADHFGFUADBhABATABBZCGDdECH.NIEB.hACAbEAC....YGCCgGDH.hAEAIDHE..hAAA...,1,-4,-31,27
cXHLFUeKDdYBPaOJbfSWINgGVCREAMTQZ,MEBBZADCHDFFLBCGUBAGeHCCDFDDBAHBOFAH..JFFDSDEFhAAA.IFCEhABANEHC..gBADhAAACHGDABIH.TCFBXCCFdHCHaAEA.hACAfDEEWAEE.hAIA...,2,-30,-22,8
HYCKbNXefUQRAZLgDISMBcWdPTaVFEJGO,ZDCFLFBCDDBB.MABEBEEAdGDD..TADDVBBC...FGHBGCEHhAAAHGAAKGEBXGBDhAFAUCGE.RAEAAHGD.SAHBhBAAPAAG.JFFCCAGE.......hAFA......hAIA...,2,-33,-2,31
YZMeEcCDgdNVJPbGRIFAOfXSUBWTKQaLH,XFFDBHGFKBFCLEFEHFAEZBDA..EEEDDCDHdAEB..JABDPEHFhAAAGDBE..FABFAIBE.hAAASDAAUGDAQADAhABAaAHFMIDACBHH......NDAC..hADA......hBAA...,1,-9,-30,21
USeVgXDYFQAOTZBJNHWRfaEGPKdbCILMc,ZFFCBHCAHDFCRBGF.EADCKACEdGBD..CFGBLFEDUDAFeAGF...hAAAXAABDAFBFCDDACBAODDFhADA..TEBEhABANICBaBDE...........hAGA......hAIA...,1,-9,-52,43
YgUMQeAJNRZDfCWLcEKbIPXHGBTVSaOdF,RFDGDGCDCBHC.LBCE.KEABIEHBHDCCGAGEBDAD..SHAEhAAAdFHEFCABUGDBQABBhACAAGGA.NECH.fAAFhAAA.EGABPAFB...hADA......hAEA...,2,-38,-16,22
UfLDVYMPKGbISHegFaEAZJTXcQBWCdNRO,JCEATCBC..QFAFCADG.RCCF.OHAGUAAF.DEEEMBFGhABAKGHBGBGC.IABEhAAASFEHeFAGhAEAFGGFEGFDADBGXEGEBCFC.NICH.fEDGhAFA..YADEhAHA.,2,-33,-17,16
QCYKIRFNbLJOUTeGMDVcSPBXfWaZHgdEA,CHCEKECARDEH.FGGALBBD..UCEAeHFAMCACDGGA...SHAChAAAXDCBaAGAHGDEhABA.EDAAADAD..ICGGhAAANADD..OBFATFAA..cDGDhACAfACD..hABA...,2,-39,-24,15
NZbCGALOYJBDWfPQIEgcaeUFXRSTVdMHK,LADGOHFEBBDDDECB.....fAFGICCGEGDBaEHD.hAAAUFFF..FFCGXBGAhAAASHCEdFAAMDEHhABAHDEDKCCF.NBAGCAHCAIAGWDFG...hABA.gGADhACA..eABF,1,-20,-31,11
WJPcKBMIODFCfVdSTUXEGgZQNYeaALHbR,HGDARECH.JEECKBBGBCFDOAEG..CCCFdHAHSBHB.UBEBhAAAEACAGCAEZGEAQDAGhABAeAFEADDG...hAAALFFG.WEEEMIFEDIECfECAhABA.XFGEhACA..,1,-15,-27,12
HBZLKIGAPbEUWgXSfaTCYJcFMVNRDOQde,EEHHUCBH...XECGSGDF.aBFGTGEF.CAEH.YCAChAAAFDGF.NFAF.DAGHhAAA.dABFHGEABAHBKADChABAAHIH.WECE.gGABfHBFMCGHhACAOEABeAHH...hAEA...,1,0,-40,40
AZPCcTEBeFHKVaLgNdDSYWRQJUGMObIXf,ZABGCBHC.EAFABFDGHEEFKGFHLCDC.dFABDFEESBHHhAAARACCUFAF.MFDD.IEHEhABAADDF..PBBBhAAAcGFD.FDAAaCED.....NDIA..hACA......hADA...,1,-7,-55,48
FMcRNWXaBVSZHTLUPKIfgQAGEObeJCYdD,GAGEOCFF.eEAEJADA.dFED.MDIFRFCA...XGDGVCCFHBADhAAALCBAUGGHKHAGhABAIACD.gGAAhAAAAGACECHBCAHA.DBFF.FGHH.....hACA......hAGA...,1,-2,-21,19
QYMcdNLgEKaBJCOTVPZGHRXFfWSIUDbeA,MAEGdDGGLHEAKBEHBDHEOACE..TGDHZCEBHFAA.FCDFhAAASDCFDBIFABAFQCAEhABANDAG.aAFACEFEPABEhAAA.XGGFIHCAeBAB.hACA..cEDF.hADAEHBE..,2,-22,-16,6
gCbNeBUQKAOEXIdRMTGVYFDacHZPfWLSJ,ECBFXCGHdGFG.RDCE.GDCB.FBGAaHGEHAAEZBDA...PADGhAAAfGFD.LABHhAAASHAEJHAECAHBhADA.eFBGBEHAKAFAAGHGIHDEMFFG..hACA...YCFAhAHADEAF..,1,-10,-13,3
RQJeGSBMUOPfZVLbdHgTAYKFEWCcIaXND,KGHHFFEGEABCCBHC....aCBHDFIH.QBCAeFEABABEUEAG.hAAAODGFZDDELADGhAEAdAHGHFCFADHG...cBAChAAAIFAD.RGCGJCCESAFBMIAC.hAFAfDEH.hAHA...,2,-26,-11,15
eWYbDNBHKgdREPMGSJTcLAZUfCIOQFXVa,ZBACCCHD.OFCHQEGCFGFC...XBCBeEEC..bDBCDBFHhAAA.BHBD.KCAFdBGDhAAARECBMFFHSADGhABAJEAB......cBAA..AIDEfGAChACAaCEH.hABANAEDEFDB.,2,-32,-24,8
ZPUTgaHKAOMDBYbWFEVNfRIXQLCScJedG,OEGFDDEBBCCF....bEDFEBAC..VGAGRGDGQBGGhAAA.CEBC.JBABdFFFGCEFhAAAUGAE.aCDGKECHAHIDMFAEhABAFADC.IAGE...SFFDhACAcGGD....hADA...,1,-19,-31,12
HafRLTQSYNEXKgPJcWMBOCbGedDVIZAUF,HCFFRBDBLAAGQEDD.SAEBEBFEKEAHJGDGMDAF.CCCFeHAChAAADBIDZDGHAEBAaGGE.hABA.fCAChACANIDH.XGAC..cBGFBHHAOCCBhAEAdBDEIABC.hAFA...,1,1,-24,25
NdOgRTBJWfYFeGIAVcZLEUCQPXMSHDKba,ZDCFECFFUCADQCFB.MECHSFFFHACAKAGDaGAG.OAFGhAAATFFCBBHB.JDDFhABAYCABGABDADIBLEHBhAAACGGD.DIAENCHE.......hACA......hAEA...,1,-5,-21,16
JIWaMeObYCPNAEHTVcDBSKgfUXFZLRQGd,TAGHVFBD..BDFEKDBHUFFCZBABLADCGADE.dGGC..IGAHhAAAMCEC.OCABhABACDCEAEHCHEDGDIGESEHBhACA.gGCDfHDF..hAAA.FAHF....hABA...,1,-18,-24,6
YgMKRALJWaHGCcIOTdeNSZUbFQDPXEfVB,JDHBHBFGGADCCCAF..IGAEdAFB.eECHSDFHZGEGFBDFDGIFhAAAECAHBBAF.MDDHhAAAAEAFaFFG..OHDEhABANEEB.QGBGXBBD.fGHChACA...YCBBhADA.,2,-28,-18,10
OHIGCRePBcATWaZVgJMYLNFKQEXUdfbDS,TCFHaGDBZFED...JBABMBDD.LDFEKBHBECCF.dFAF.DAEFOBEBhAAAGAACCGFEeGAAhABABHGAAEEB....WFHBhACA...YAFEFGAD....hADA......hAEA...,2,-34,-27,7
KSYWZMcDRGUCPAabgFBfOHJVeELINTXdQ,aDGFFEGBBAEHHGEAeACCLAHF..IHBA..NCCDdBAChAAAKBAFSDCFhAAAZFDF.DAIDGDAHCGCEADEBfBDHhABA.JDFHEGBBXAFHYFHBhABAMEID....hACA...,1,-17,-28,11
UGgVeIZJNHPKfTOYFQRcbCXEBWAaSDdLM,DCCGMDEAUDBCGDAF.eHECZAAEHDEC.KAEGfBGDhAAA.OACGFHAEQFGEhAAAbBBCCFECBEHAaFDELHAChABA..IAHF.NIEH..hAGA......hAHA...,2,-29,-13,16
BAGLbNEMHRDIPcSVgYQUOJZWCaTFXKedf,LCDGECAERFCA.DHAG..IAFCSAGA..VBGBgEAFhAAAQFFCJHFGCCADhABATEAB.KAACeDGHhACAdADCAAIBbECEMFIHcAEBOHAE..WHAAhADA.aEHDfDEDhAHABBBC,2,-27,-16,11
KULEDfZOgbAMcPGeCRQVINSaXJHYFdTBW,MEFBGAEERCCG.QDCG..VEBESCADaAEG.HABChAAAdCAEBAHCKGAEUEGBhABADEHF.OHCAAICCeAACCHHEIAHBhACA..XGGC.FBHDhAAA.WGBG...hAEA...,2,-23,-12,11
FQdTbVKZfXGAcREaIPYHDWCOUJLeNgMBS,EACEaCAC.....PDCBHFBADFHF.OEEAJEEBLAHFhAAAeABGMEAGSAEBhABAdAGBbGDE.KGCHZBBCXGGChAGAADFG.IBBECHBGNDIGBFAF.....hBAA......hBGA...,2,-28,-5,23
dMRKOeHFWgZGAJXYSNTPLDQfcVIUEBCab,JFEEXEDA..SCGB..PBEADGIBQEBDhAAAfACF.IFHChAAAEABACADAdCDFMBBFKAFEeHBGhABAWGAA..ZCEEAIFGNAIGcGGHBDEGbGEEOCCBhABA.FHEC...hBAA...,2,-24,-10,14
JFZaWEYDfKLbIgePUHXCMQOdVSTBARGcN,GEADJABFZDED.EGCA.DFHHKEAGLCCG..IHHDeAHBHADAhAAA.MABHQDCAhAAAOFFF.dBGDSHCAhACAADAARDGFFGAA.YDEGfAEF.gGEAhACA..hADA...,1,1,-33,34
MKXBZbOWJIeaGDdCHEYTRFAUQLPgScVNf,LGCCSBADVABEMCGB..BFAFZCDHOFGD.JGAAaCFBhAAA.dEEDEAFETGGBhABARCBHAEHC.UBGC..PHDChAAANAEF..fCDA...hABAKEHHWAHH.eAEBhACADICE.CHAG..,1,-14,-21,7
BbdPGRfDCFVZAOeSTgJMXNWLYKaQEIHcU,eAFASDHD..JCAEMCBF.XACCLEGF.KCEFaFEBhAAAIACDUGBFdGFEREAFCCHGhAAAFCEF.ACIH..TAGDhABANIEF.QDCCEGCHBFEC....PEHFhABADFAFOADA.hAEA...,2,-30,-2,28
TQcagJEWSDFUICMfXNZAGPbYLeVKHORBd,GDEH..bBCALFBAKCGDHGACRAEDBCHCdAGHQAAGhACAaAGGEFGC.DEDDUACACEACMEEDhADAXBABZFFG.AHIFeHBAhAAAOHEE...cEAEWFFD....hAEASDDF.hAFA...,1,-7,-11,4
XAZaMeKTfRUSJHYPNQFCOcbIVDGdWLgEB,aBFCKBHBRFBH..UAAEHDFB....PEHDNCAC..FCBECHAG.OHEEhAAA..cFDBhADAIBEH.DEDEdDBFhAEA.LHEABBBCAAHF.MDFAfFHChABAYEBB....QFDChACA,2,-39,-22,17
NAbTGWPeXdVZLYFJMfaCIEQBcRSKDOUHg,GDEBeDAEdDFBLFBDFCCA.JBEGaAFHCCCH...QGGFhAAABBADSFHHKGAFOABAhAGAUFDA..NBIAABBBbDAC.hAHA....WAHHPHBE.ZEBAYAAChAEAMFFH....hAFA.fFGA.,2,-20,-3,17
GFIWDRUAeOXCdJfKEgMNVHYSLbTQZBcaP,ODFACAHHdBAH.KBCHMADGHFCH.LBEF.QFGAhAAAZEBGBDDFaGDFFDAEDAGEAHGAeCHFhAAA..fBGBhABAEBEB.gFADNCGGSHGA.TGBEhABAcGFC..IDBBhACA.,1,-6,-39,33
KaUBNZePVbMYWAdRIcOGLHgSTXfCFJDQE,RCFFOFDDHFCB..TBBBXGFE.FABEDAAB.KFHFBHAGZFABeECEhABAVBEA...MBDAhACAAGACdCCC..IAHAhADALAEESHEACFFFEDGCNBAC.....hAAA......hABA...,1,-8,-27,19
NBYXVfWJLRGcMPHECKOeAaFdDISZUgbQT,FFBDdDEESEGAUEFG..QAADBAGBXCBG..hAAAWADCRBFGMABC.HFAFhAFACHHFeHDGDGEFIHGBhAIAZBFCTEDA.VCAHfECC.JBBChBAA......hBEA...,2,-20,-19,1
gWLPGFOCDQedKfUaARcNHXTMBEIJYVbSZ,RBDHHCEEMGCEEFFH.JFAG..VBABZGAGLAEEFGHH.DGHDeBHFhAAA.KHBGaDBCAFEG.XABChAAABBGC..IGAHhABASHEA.WEHB..ODHDhACACCCA.fDFGhADA.NAEB..,2,-32,-13,19
eXaTJLDZPNVcEWUFSQOHCAgbKdIBYRGfM,KAECdBEFBGHARAAHGEDBMEAG..eHAG..TGDDDDAFZBGB..hAAAVCGHEDCFUGGC.hAAASGDBOCAECFFAABIBhABA.IACFfBEGXGAA..hAEA.aHGC....hAFA...,1,-14,-33,19
gDBXIPOERaNMSFVZGQfCLecWKAdYbHJTU,dCCCHBBDJGFATEGF.DFACBHDB..PAHDOAAC.RCFD.aDEFhAAA.MHDASAGChAAAVADC.GFAHCCAGeGAAhABAKBEDAHIB...YBHH....hACA......hADA...,2,-38,-5,33
CHZOBAULGWJEIeXgdfMaRFTSNDYKVQPcb,GDFAECGF.eGBGXBCCdBHAMAFA.FABDNHED...KHEAQFBChAAA.cCEGhABACDEEOEBA.ABDC.WADGhACAIBFB.aDAHSFEADAAB.hABAPDHD...hADA...,2,-26,-21,5
MaGIbHcDNJEgWSZCYKAedPVTOQFRfLUXB,eADAdCDH..TBGFFCAALDEABGEDMDAFaFFDGBEBHDFBDEIFJHBChAAAEECF...SHAEhAAACABHAGIDOEAEfDBChABA.IACBbFGH.NIDB...hAEA......hAFA...,1,-17,-23,6
NCdAVMQXIWBfLRgPGZHaEeSbTDOUcYFKJ,MFDFXDEGBCABLGCERFGF.GAADaCGE.SBHHhAAADEBEOBFGUDAE.FGADKFAHhAAACHGAAEIBQCDFhABA.IEFHfAGF.ZAEHEADCeFFEhABA......hADA...,2,-30,-7,23
NTAXaVCOIfdPbRDGJcLWUSKEeMFBHgYQZ,VDAGCABH..OEBBdHFDRFDA.GBCALBBCUGCFKCGH..MFGDhAAAFFAHBGCDHAEDQDGBhABA.NEFCAAHGaDDFhAAA.fDFEDGAF......hABA.WADESDAFhADA..,2,-36,-11,25
TCZJFfNBDcbgMYEWXGPQOaVIUKdSeRHAL,TFFCZABGFDDBBGFD..DGIB...gDCEMAHHEGBDGAEAhAAAOAAE..IDFAhAAAUEGGKCADeADEAIDGCCCC.hABANCCF......cGAG.WHEGhABA.PCHD.aAGAhBEA..SGAD,2,-31,-29,2
DLCZaeTKVWPFISgBYAJEfHQMbXORcUNdG,JBDGHEDB.QCGHMIBC.XAGGODAARGEEUBDDGAGGCHGFZEAEhAAAeEAFKHAC..PBAHhABAFDEASABGhAAABFHDAIHE.bEEC...NACHDFIB..aBBF..hACA......hADA...,1,-6,-7,1
JGfbPDFQdAgaVXWYCUBERSZIKMOeHcNLT,VEDHXEAE..CGBGBBFHSAEH.ZEEBKEAFMDDAOACHhAAAeABCHCFCLBHFhAAATGFDJBAH...fGADhABADFIBdADDAAHEaECBUGGEEBAH....hABA......hAEA...,2,-24,-5,19
OJLGRVXPNFeUdTWcKHIBEbMAgZaYCDQfS,ZDCDaCBG.DCEA..SBFHJFFC.LFCERGAG..XBAGhAAAFHCCeDAA.dGACTDAAhABAKEGCIABAhAAA.BGGEEHDCAIFCYAFCfAGDOADFhADA......hBAA...,2,-39,-23,16
KVIdCfNRQaMFYHOEJXTScWABGLegUbPDZ,BCCBGABHeFFEUCAADBDAZGBA.KGHFdCFD.CEAH.REEF...QECChAAAMAIBFAGH.OCHDhABAEEDF.JHBG...SBGChACAADDE.gGEB..hADA......hAEA...,2,-32,-32,0
JVdRBLAfaYGObgceFNPIDTSMQHWXKCUZE,aAAFOCHH....bDFDeFHH.PFCAIFBC.SGHHhACAMBBEHCAD.KHAChAAACDEFEBDAdBGFBGFAAIBEfCBAhADAYAEBGAGE.cFCDDEEC.hABA......hACA...,1,-14,-21,7
bcEKdHPFOQaCMfRgJZXVAUGWDeYSTLBIN,UAADDHAEeCGH..TGGDBFAB....IECBNDEA.EABDhAAAKBFCHFDHFHCCaCFCCHFEMDDEhACARDAC..ZFAGADAF..hABA....YBDASADH.LFFFhADAcGGAdAGF.hAFA.OBHF.,1,-11,-22,11
cPZdBbgMVFORTQIJWfHSYeaKLDXEGNAUC,UBADCEGCZACBBHCHMEHH..FGABRAEF...QEDA..ICHGhAAAJAFD.HEDFhABAeHCAKGGBDDGBEGAFAAEF.dCAEhACA..gDBATEBDSFHBhAGA..aGHD...hAHA...,2,-28,-26,2
OgUXWbcdVZATRFBCaHKNDePJSQMYGEfIL,RGFAFDADCBCB.KAAB..DBIDeDFC..JHBEMECD.GDDAEDFELFBEhAAAUAGF..XGFDhAAA..cAEFhABAZACBAHADBHCHHCAGSFGCfFHG.OBEBhACA.bAGF..hADA...,2,-30,-19,11
WFUIRXEPCKOJGTafNMBYQDAZbSVgdLeHc,SGGCVBAB.dAHGLGFGHFAFFACBUFCFRDEB.EAHFCAEDODCHhAAAGDED..aDDGMIFGhABABAFEDEGEAAED.ZBDGeAAEhADA.IHAAKGDF.......hAFA......hAGA...,2,-14,-12,2
QDUMVPdeLXYBbKRgZNTOGaEJHWcFfACSI,CEHBQFGCUDEE.MAEBdDBHLAEABHBGKDCGZAAB..OACHhAAAEBFHHFEDFHCCAHFDICHChAAA..DCGCeFAFhADAXFGD.RFAF......NBAGaGEGhABAWAFC.SDGGhBAA.,2,-25,-22,3
ZWIOMCgfacYJRPdQEDXBKFHGTANeLSVUb,eHBCLBCEUBCGZCEA.OCDHCHGG..aCGCJEFF..RDAEQEEHhAAADAEGKGBGHDAHAHAC.SFHFhAAA..hABAWAFCIAHC.MICGfBGBhABA.PFHD..hACA...,2,-37,-20,17
MEVIXaTYdCSJBDPgfNRcZHFLWGAKUeObQ,eAEDOAFAMDAC..EAAC..XCGDaCDBdEEH.SAGAhAAABCBCDDGA.fGDGhABAREAGHGBCFGHDLFBFhACAAFHDKACG.QFFH.IBCFCCEA.hAAAPDEB...hAEA...,1,-2,-26,24
LgcMNAXVWCRTPFBbedGQUEYDHSKIfJOZa,XCDHCADDRGEG.FAECBABF.eEAHQABC.EFFDDFDCHBGDhAAASGCBIFHFhADAOAFGZGAEaGDDLCBAhAAAMDCFAGAE.TCFC...dCHA..hAEA......hBAA...,1,0,-34,34
USbePGVXfOMADQcIBRKLEgYadFJTHCZWN,DDEDQBGHBEBFRDGH.LBED.EHDCaAECFDBBHAAHZEGHUGADhAAAeGEG.GDCC.XABHhABAfCFCMIFGhADAAAHCKGAF...dFCACFFDNAEFSACBhAAA......hAFA...,2,-34,9,43
gDGFEKVZIeaMTYORbLJCSHdNUfXAcWPBQ,...PHECgADAFCEB.KDEHZAFFeGCEMEBB..OBHBhAAALCACSBAFhABAdEGGNDIA.fGHEhACAAHCG.cCBCWABEDAHHEGADaDHD.TEAChADA......hAEA...,1,-15,-27,12
JQMFPOXKBUdbATaYEegWVCZfRNGDSLHcI,TCBBaDBA..eFCG..VFCDZBFHRADDGABBSAABHBFAJHFChAAAMICAOFFGBGHEdGAAhACAAHAC.EDADCEAEDIACIAHGhADAFDECKAGE..UFFG.....hABA..YCHHhAFA...,1,-3,-14,11
eJfdWBFgIGMLQREAcbCYUPTZKVXSOHNDa,CCGGUGCEZAAB.KACA..SHFCOCDCHGEGDEFD...eBFCdCDFBAGEhAAA.FEACgBAEhAAAMBIH.RFABEEFAhABAACCF....bFBA..YEAC.hADA......hAEA...,2,-45,-13,32
OIbcLYWVGMJSPKADUEeaXfCBTNHRQdgZF,DGEEEAAD.eCCG..aACHCEFBBBAAHGEAQGCAZEAE.ICEAhABALHCE.VADEhAAAJAFESEADhADAAHAF.fDBHTCGBdGHCFEFE.OBHFhAEA.YEBG.hABA...,2,-35,3,38
gAOeKXZBdCVFfMENILbDGPYTScHQJRUWa,eEBBKEAHBFDEdEFBFAHF..MIDAEGFELBCBDGHFGBBC..TBAChAAASAGBHAFFRFDDhABAaCGCAADEOFAH.hAAACAEA.fFFF.IDEA.hACAYACC.cGBDhABA.,1,1,-54,55
FLfMeZRCXPTcQVUHWaOYAGIgNDEKJbSBd,GEAB..gBABDIBGEHEEKAGHSHEGBCDBLBABhAAAMADFRGAECACE...PDGBhAAATDGA..QAGDhABA.UEAHWDEHOBEHAAIFIGAHhABANDIG.dGHCfFEGhACA.,2,-23,-21,2
GYbZHFWAfIMNPJCDBadQXOELeSgVTKURc,MCGFJFEBBEDBdCBG..ODEHLBGB..SFAA.hAAATGGHKCAFRFABGABEhABAZAFEFHDEAAEDfBEDhADA..IDHECDFFDDIDaGHDEABC.eHAChAAA..gGFHhAEA..,2,-25,-24,1
bVEYgSTKHFAafCXGdNPeBUMQIOWZDRLJc,aDCAXCCFGEFCdCFC..eFAAMDIHOAHBZEBALAFE.hAAAJAABcGCG.EABHhABAgGBDSAEFhADAKHGEADIDCBFHBDGEIHHEDGFG.....hAAA......hACA...,1,-8,-24,16
cDFeTHBWLVZXAUSNQOIYMfadCbKPEgRJG,SGGAODBH.MDGHdDEECCGC.KGHDEHEG.RAGB.GABG.FEHFhAAATDBEBHADLAFAhABAVABAAFEAQFAHhAAA.fDDDaHDC..gGEEhADADDIHHAEF....hAEA...,1,3,-31,34
XJefCSDEAOBaIUcbPLdHZRMKFYVgTNQWG,OBADBAABUFBD....PDFFdCBERAGHFFFB..VFAE.hACA.TDDBNCCD.QADDhADAXDDBfACDhAAASGHBDIDCEHCCaAHH.IFHFhABA.....hAFA...,1,-17,-38,21
DdATHVLGORJXCcKENbZMUFfYeBaWPSgIQ,TBEELGBG.OBFGJHFC...XDAECFAHEFFC.ZBAEMACAhAAAFHGC..eDDHBCCAaAAGhADASGAA.hAEAIEECDFGCAIDA.HBAD.....hAFA......hAGA...,2,-30,-27,3
fMRCPcDQHNXKYTFVWLBSagEeUIOJdZGAb,MCHBCHACDFFB.HAEE.KEDBFDBALAAEBBEH.SGAHEFDB.hAAAUCBEJCFE.dGHEAHGD.fGFAhAEARABG.PCFDhAGAQGBC.XGGF..hABA......hADA.YEFCWAHB,1,-6,-41,35
IdbWDMcKRYSLTNefaHBAEVgOJGZCUXQPF,VDBGOBAC.ZEFAUDGA..QFCCFADFdHCB.DBHFMGCGKHGGSBEDhAAALAADeAFGhACAHDAABHAFAGAGEGEA.hAHAJAFHCEFF..XBFCIHAH..cGGDhAIA.....hABA...,1,-14,-23,9
CFdBHREbTUDLafAVGQPNXeKSZJgYcMIWO,QGCBXFAGKHGCSDEF.JBADgCFA.hAAAMFFFWGFEFFCAHAFDhABAEBDCUBABLCCBAHBD.hAAAPFAHZDBEIEHFdHFBBBED.TDGChACADICGaAEA..fDBAhADA.,2,-11,-9,2
GPJQdMfKSVULOYHCWIgaDATENBbFZcRXe,EAHFBCDBZBDAREFAGAAB..JHEAdHGFKABFUGDHLEFGHCFECHBD.hAAA...IGADhACADFBCADAD.TDACFAGGeDDBhAAAMADC..SFAGYFDDaHAE.hABA..cCGE.hADA...,1,-18,-19,1
YEDUKIMgXZfcLJRBOePHbdAWNVaTSFGCQ,VGDASABE.CAGE.ECCC.KDFCMEDGZEAALABEBCBD.OCHDhAAAHAEDdGGH.ADGCNICBhAAAFHBCGEAGDFEAIAHFhAFAfEGF.JGCG.eBBG..WDBGhAGA.aGGD...hAEA...,2,-17,-16,1
acNObKGPVdYHEXSUQADTRfMZCBgIeJLFW,RACAZCEABDEDeGBCFFDE..aBDA..OBGFKFGFGAAGdHADHDADEDCGUAGHhAAAAAGF..DGGBMIDEhACACHHG...IFADhADAJAAD.LFHHNDIG.....hAAA......hACA...,2,-37,-5,32
AdKRVMYCUOeGfZIbSTHFDaWXBNLgPEQJc,REBGMFABCGAH.UEGCGEEEZCCD...SCCBFGBHDFEF...aAGBhAAABGCELBBCEAEAQDABhAAAAHCAKDACOEHHhABAeABHfCGF..IHHBhABA...bFEDWHBAhACA...,2,-28,-20,8
OHDBXAPIQYJESFgRaeMbfZcKUGVdWTLCN,QAAHJCCH.SEBERCFBMIDEZGAEUFEAGACHdAEATGBChAAALBAH..OAHFhACABFAHAHGE..IDGAhADAEFEEaEHD.eHFA.cCDHWAFE.CHADDEIBhAGA......hAHA...,1,-13,-23,10
eZCLHRDNFXOPgBbUSQdVAWcGYaIJTfMKE,GDDEaABF.JBBBTCDB..KBHFeBEGLFABDFIF.XFGBhAAAOEGHBFAF.hABASHBGQADGhACAAFFD..YAHHMAGFEHECCGDEHDACFFCH.PAABhADA....hAEA...,1,-14,-24,10
OJKRaLcGEDWPbYFQSHUACedZIMXgNTVfB,CGGEeBEHdHDBZACAMFEA.....XGDBTEDCBAGCKAAGLCAChAAAGBAC.EGAADBIFPCHFhACAFCCAHCGFAAEAIGGAhADA..NEAC.fEBB.JAGDhAGA..aAAB...hAIA...,2,-23,-15,8
BCJEdURWPfSeXOHGYNTKLMZgcaDbIAQVF,FGEFBABGEBABdBGD.UFBGRCEA......PGACSDEDhAAAeADHHEEGGGEHNIAB.KCAHhACAZDAAaDGE..DAAAADCACFGEhADAJAFE...fHGBOAEG...hAIA......hBAA...,1,-8,-35,27
fcBWGNOdZVSHabEMTLKXQgAePURFICDYJ,eCFAUCCHRFBEFEHF.DFEB..JAECBCEFGGEDdHGBZACBHEFG.EHAGMHAChAAA..LBADhAAAQEBFADFECBCB...hABAfAFDNAIA.SBAA.hACAaFFC.....hADA...,2,-26,-15,11
WdDKUGPfVbLYeXRFSIEcOZMQTANJBaCHg,JBCCCGBBHDCG.dBEHKDECUDFGGGAB....VAAFLFGHhAAAeFAD.XCABFGGDEHCA.hAAAOAEA.QGEChABAADABNEIG.aDAHDAIHfDGF.hACA......hADA...,2,-20,-19,1
MbDNUZBdGWHXICQJSAcTReEfgKPYOFLVa,TBAFRBBHeAHB..EGCHKAHF...OEHDFDFHaFBBDFGB.ZDDHBEHFhAAAdBFCHEAGCBEF.SDHFhAAAAEAC.fGCAhABAgGGC.YEEFMADA.NABB..hACA....WAGDhAIA...,1,-11,-40,29
gFQAJSVUeOKPTXbIDLdZEYWGfBMaHRCcN,VAFEODAG.KGGH..TBCB..bFDGDFEDZAFBEEAH.GCEEhAAABAEBMBAGRDGH.CBHE.hAAAgGGGAGIB.hABASCAFPEDAIEHBYEBBWHCGhACAfABFHBCG.NIAH.hABA...,2,-19,-19,0
UQSgIfHMERWKdDaLGJCYPFBZbAXVcNTOe,VBDCTGCG..UGBHQCCA.SBAFfEEGHEFBhAAAECCB.RBGFdFAFLEHFhAAACBEE.FAHDBHAFACACNEAG.hABAOAEAeABC..MIFCDEIHaCADJDBF.YHFGhABA....hACA...,1,-4,-9,5
SdLWJHeAaCYBXPNRQcTOUIFKfGMbEgZVD,aGFDBHHC...XBADRBFDQAAD.OBHFIGAFKADBMFDHhAAAECFC..gECDhAAADFABSDCEhACAdAEELFFFJFHBHDEBADIHCACDPFBHNIAF..cCCFhABA.FEHHfDADhADA,1,-3,-34,31
aGLUAPMdbTHZYfeJCDNEgBcSVQKWRXOIF,MDBBTCBBZCDA..eDFAJECH.DGAG.EADABGFG...VAFAhAAAKBAFXGBA.hABAIAHAFEHBaBCGLFEDhACAUFGDABBEdBFC.YEDHCHHHNDAA...hADA....SHFAhAAA,2,-34,-12,22
cBGEfPZHTVaYCbKNWJSAQIeRXgOMUFLDd,eECHRBDDOBAAUGFHLGECdBBBGCAH..EAFFZAFBHDAH.aCHBhAAACEGCKFAF..JHAAAEBB.hAAA.IBHHMIFGDFFChABABFEC.....fAEEhABA......hACA...,2,-30,-16,14
dTBMWHRLFXbEGICAQVeZOaKfDYJcPNgUS,eGECOFADKAGFDFGD..JCDA....PADDUEACdADFBAFGMDIBhAAARDEHLBBD.hABAFDHBECCB.CEGAAAHCVGCAhAAA..aBBB..fHGHNICH.SAGBhABA..hACA...,1,-30,-33,3
NaRDTEKXSAPgOMdIGeUWQfBHLcYbCJVZF,OCDGdBGFeFBFUFDGQFGFBDAA.LDAA..bFBHJABEhAAAFAFARFDFDDFG.EBADKFGGhAAA.ADGF.MAFG.IHFDhABAfBBE...YABChAIACCDBNEEF.aBHD...SHEAhBAA,2,-31,-17,14
TdLHJRQPCegVbENKFDOAZIWXSYfBUMcaG,ZDEGXAEGSBFEBGDE.UGGB..aBBFGDBCLEEEJBAH.hAAAQGGDCFFC.hABAeHAEgGDBhACAEDAFKCGGDABGAIAC.IFFGfCCBcDBDdAEC.hADA......hAGA...,2,-21,-13,8
QJdFaYNVcMBRUgLWbZTHCIPEKfDXAOeSG,OEDFSEBA.QBDDFBBHaGFA...VEFABHCFUGDBhAAALAFCZAGHCGHAEGBHfCFHhAAAABCA.JADBNBAGMBBHhABA..WFFE.....bDAChABA......hACA...,2,-41,-9,32
PRCOLXSFKdEMagBVHbWcDUIJTAZQeYNfG,eEEE..NEIAGBBDRDABCAAHLACAFGFBKCFAdGDD...MAIDaHCEBGBEhAAA.HDAAcDCHhAAADEEF..JAFGACGGQGGBhADA.fGBC.OCCAhAEASABC.hAGA...,1,-22,-29,7
FRfJGAXdaVOEDIBYSWHcgZQMTLPbNUeKC,XBBDaBAA..VDFCEFFABBFG..SCDHHFAHZDCGMCAHhAAATGGELHDAhABAPADA.NAIGeFHHKGCECCHEFCADhAAA..fGDDABGEDHAG....hACAWFFD....hABA...,1,2,-32,34
SKbdFYHVQNOcUTPXgLGAaBWJMeDEZCfIR,BFCFJCBD.DDEDCDGB.RAEE...KAEBFHEEHFFB..QAAAhAAAODEHUGBB..PDHDhADAXACBLEAHhAEAAGAH.MDGDEEHFIBAESCDF.YHAGhAGA....hAHA...,2,-35,-35,0
BAICgeJZOEVMFQfXGcPNaDWRYLSHbTdUK,CADAJHFAZBFB..OHBEEFGG..FBBBQCFD.GADDhAAAPHDEDDDD..RFBESCHDhAAATCAC.dCDDhABA.BHHEAABGIGAAeCADMAIHcEGCaHAG.hACAWCHB.HEDF.hADA.KECCfBBD,2,-17,-11,6
URbEYZQMLgFePSaTcfJBNKHADGOCXdWIV,OAEGdADA..IBBBUCDCEHCEZBEDLFGBFFFF..SCGGhAAAaAAC.TDBFhABAfBHG.BCFAhABAKEGCAAIFDHECCHCDXGABRDBDYCADMFIF.hACA......hADA...,2,-27,-26,1
KPBNTYFUQCZJGaHfIcRdAbLWVXgSeMEOD,LBFHVGBC.XDCDeCDB..MDABEAHDDDABKBFDBFGE.hAAA.TEGBFAHFCEBCZABEhAAAaHCAHEAB.fABGhACARFEDAIHC.WBDBODFCPFFH..hADA......hAEA...,1,-18,-24,6
MPeRIOYEgFTVNXSJbQdBUGacCfDZLAKWH,HBFCeEEGOFBFEDGBFADB....TFFCNACD.SCEDhAAAJBDCdBAHBGDGUFBA.aFHDCDCEDIEGhAAAABAHMBBF.IAFGhABA..YAHB.XFGEhABAQFDAfFDDhAHAKCCF..,1,-8,-31,23
cVdHJCQPLEBFTKUYbWeSGZNAgOfIRXDMa,OEFERBEDMFFH...aABCdGCCHCADCDAD.LFCHBCBBFAAAUGGA.hADA..bAEBSBGBhAEAZEDHAAHB..fCGHhAAADDEHJFAHQEGEECCE.KEBA..hAFA...WBDF.hACA...,1,-12,-27,15
bHTWdQBXFNLcVJRYgMSZEIfOGaDCPAUeK,eDFHKGDBHCDFdGHEQBAABFCBFBGDLFFC..JGACRABHMBIDhAAASHEE.EAFDhAAAIDABODCCaAEHhABACHHHAAFA............hACA......hADA...,1,-27,-31,4
EMeAdQPbORJFLTICNaKZYfWBUGXVcgSHD,dAHCQFAGOGBGFDEGLFHB.TFDECDCFKAFH.ZADH...hAAAfBBBBGGDXDAHhABAgFFBHABEDIFGhADAECADABIF..PDHHJAGF..NIAFaAAG.hAEAWDDA....hAFA...,2,-30,-10,20
gMXJKFLUYPAVbaHNdSfcCEIGBOQTeZRDW,aDBEdBGGSDED..fAGFCHADEFBF.BGDDOCCDhAAAeEEADICGMCCGKDABLFHFhABAPACAAHCDbFGHNACH.hAHA....cGABQGEFTAACWBCChAIAJCFE.....hAAA...,2,-26,-18,8
cOfQDbJCaXSAdIeZUEGgLYVNFBHMTRPWK,eGBCUAAFEDBELBCB..VEECFFFBMIEERAGB.KDHDOEHDhABADEEC.CGAG.SBFEhAAA.ADABZCAFgADFhADABGAF.PFDHWABE.fHEFhAGA......hAIA...,2,-27,-24,3
OcNRMfXGBJaZgIeEKQPCLTVUFYHSDbdAW,OHEGRABCMGFA.GDADBAFAZEDFeBHF.EABGQDGGLHACUEGDhAAAFCAFHFAEDAFAAFDC..hADANIAD.JBDE..IAHBhAAA.KCDE.CHHB.......hABA......hACA...,1,-16,-19,3
bTURXcKJOLCVgGINDFHAMWaESYeBQdZPf,MIBEEFGA..eACBdFACZBDD..fDFHTEFE.XEAGhAAAKCBBLAAECBEHGGBFhABAIFCCNAIGDBBBAHAHaFDDBFDBhADA..QBGE.PFHFhAEA......hAFA...,2,-23,-10,13
VEXGCMTHDeOBLINSQKbAUWFYgRcPJafdZ,UCFCFGCGRACG...JDAEdDCEZFFGEAAB..GACDCGGF.HEDHOBFEhABABBBGLEAF.hAAASFEHKFAHAAIB.hABA...WHDAYHFG....hACA...PEFAhAEAfHBFMIBG,2,-34,-19,15
IOTPKVEgcHaQDSBCXRJFeNMbfGYWZAdUL,UCFBLBFHOFFAKFDEEBDBHAAB..aDHDQDBH.BADDhAAAXGAERGEGFAHFeGAGhACAMDABGAAE.hAEAWGFAAAFE...IHDH...hBAA......hBCA...,1,-17,-24,7
XJHCPGfebdQFISTENARKWLBcVDMaOZUYg,KBEDBHGADGGCMABHZFEH.UCCG....XBBACEACGGAFeBFGhAAAdGGFFDFG..SDHHhABAEBGE.ADGALEAEhACAaEGE.YFABJACEPFCG..hAAA..fAGBhADA.IHHC,1,-28,-29,1
DHNIdLVUFEYafWGeOBgKPQXbZMACcSRTJ,SFDCTBCF.HCCEdEGAUEDFFFBHECAHaHCEGBEB.eHDGhAAAOCABKEGB.QBGBhAAAZACEMABACHADJEBD.DIGEhABAIHHD........hAGA......hAHA...,1,-5,-24,19
AbZGVcDSQKeafOdBIRgJPNXYWTEFLCUHM,ZFFGVADCSACG.KGAFeBGH.OEDCBCHBREAAJHAG..hAAAXBEATBACFEHFhABACDEGHBAHAIHG..bDAGDCDBhAAA.aADA.dHEHIGGE...NGAFWAHBhACAEHBC...MDCChADA..,2,-22,-8,14
NcKeLEAFVGaJXYWdbZOfUSgTCBRPMDHIQ,VCGBJCHH....XCBFdCCFOFCBUEEB..TAEGRADCDAIB.hAAAHGFC.QEEHhAAAKHFGEFCB.GCAChABAaACG....WDDCfAGD.CACGBDDGhADAIGAA.eFHDhABA..,1,-8,-30,22
gPJfFLdWYIVMQCaXReEBATcZbSUHNOGKD,ZFBGSBGEUBCEHBEGOGDGKHEA..DACCJFHD.LDAFdFFB.hAAA..IABHhAAAMAFCCDHARBAFeDFEBDEHTBCChADA...bFBBgGGGfBEB.hABAWEEG....hAEA...,1,-24,-27,3
NfYGeALJODIPSFMUBQaVWdZEXTCcHKRgb,OCCHDDGD..IHCGFBGAUGAD.BGEBQDBA.aEGDhAAAdBEGZEEFXABChAAA.CHDAHDGFRADGNAIAfFABhABAeCABADGH.LCBCSGGDMAHF.hACAEGAB.KFDB...hADA...,2,-28,-5,23
fNdDbUQaLFIVXWYeOZSGJRKPETcBACgHM,HEEAMCGHdBDEDAECUCBALDABFGGE...XABBeBFAZGBAJHDGKAAAhAAA...EADBBDEHhAAAAGDG.CHBC...NDDB.QAFDhAEA.IHHF..WCADhACAODHFSHAGhAHA..,1,-19,-35,16
QAbHegVWDdBXRPFYTGfOMELCZaSIcJNUK,HBFEVADE.dEHABBACXBCA..FCGCGCAEOEFALEFFhAAACDEF.aHACSCAHhAAAIABFJFDHKGACAGIFeAFEhADADFGDRDCD..YHFGMFFDEAHD...hAEANIAB......hAIA...,1,-3,-24,21
JGCWSEVUXfbAQILOeaDKcdRZTFMgYHPBN,QDEHOACGDEEC.KDBBdECCRAAF.ZAGB..FGDBMCBHHFAD.BHHGhAAAJFFA.CCHE..EADCXAEEhAAAACCELFFA.eAFChACAaCCG....gFDB.NBIC.hABA......hBAASHEA.,1,-8,-26,18
KgHCFAEDSbWeBQZOdPRILVaUYXNcTfGJM,ECFEDACH..SDCBeEDHZDFEOEABdEFARFBBLAADUACB..XGGDhAAATAEDJEHFMIBChABA.KDCBCHAB..AIDCBEAHhADAIGFD.aBBHNCEC.fFBCHAGF.hAEA......hAGA...,1,-8,-18,10
QBCFIbTeMYRAKPHOJNVgUZDEfaSLGWXcd,KDDHOFFC..VEAFZBCDDAGG..EGGCSGBCLAHBGBBFhAAA..cBAGhAAAQDFDBDFCCDAHIAEGhABAeHEGRBFEAEEFJHCE..NABF.fABHhAGA.WFDGFHBE.MIFGhBAA..,1,-6,-31,25
dNXACcJMPLUgeHKRZSFWGbTIVOBYfQEaD,JDBALCFE.UABEeDHFHFEEKCFHRAFESAFC.FDDBbFCFhAAA..TGBE.hABAOHFCfFEAhACAEEABaDGCDFIH.dBBDADBFMAADPDAH....hADA......hAEA...,2,-30,-5,25
XGEVHUDRCbOSgMAQKTdYeJFaPfLZBcWNI,TCGAdBBBJDAH...aBEELCHB.ZGAGBGFC.NABAGEAFhAAAHCDADHEGCEHH.SGGHhAAAAHBFKDDCFHGE...cEFGhABAIADE.EAGE......hACA......hAFA...,1,-28,-29,1
SXOWTYbZDcICJRAFKQGPEaBVeHULMNdfg,QAAAGADEaBAHBHGGeCGBUGBGLCHFdECH...SGBHhAAAOAEGTGGDZAFBDIDChABACGFFADEGPCCHHACDNAIAXFFChACA.YFAD....hADA......hAFA...,1,-9,-14,5
THCQPcROXMDLWSfFEbBYKUAGZgJVIeaNd,GBEHJBDF.eDBCaAEE.dHFFHCAHCFBA.QGEHRACA.OFCDhAAAMHAGDIBELFEEhABASAAFFCFABHAHKEGGAEEAhACA.ZFFCIHHA.NCIG.....hACA......hADA...,2,-20,-17,3
OUFZaeTXgfDIPKGRAJbSQdBcMVEYHLWNC,SAFHBFHGMDFA.EGEFHDDA.LCBBCEECODEAFAEH.eGAChAAAXABGDDAFKHCAAHGAJCCFhAAAQGFH.dAGAhABAcFAF.WFFE.....NAICaHAChACAfACE.hADA.IAEF.,2,-20,-12,8
WCRZQeUKMTJIdGbVScYgAHEXLPBaDNFfO,EECDLCACBGADDAFAFHBEOEEB.RCEC.ZFEE.UDEDMIFAJABCdFHAhAAA.GDAG.SAGChABA..hACAYBGHAFGD.PBBHfAEC.hAAACFCA.eFHH...hADA...,2,-39,-19,20
AFTdMUeNBWYbgDQJHcSCfaLPORGKXEZIV,TAAGdFHAUCGA.BCEF..bGDCQBAHHAFECDDELCCDhAAARFDBKGBA.XGGBZFFH.hAAAAEAHFHACMFAHeEFC.hABAWDABDEACSDDG.aBDG..hACAOACG.ICHGhAHA.,1,-8,-19,11
eENaRMVDJFgLGbWCHTSIKZUAYOPcdfXQB,OAFDdGGGQBEABEGF.ECAHaEDA.RABD.VEDG..JAHDLAHHhAAAGEBE.CGAESBAEhABAKFGBADIB.PHCEhACAfFDDeEACDDCAFADA.....WFHBhADAIHAA.YBAFhAAA,2,-29,-15,14
VFTJBNGdeHaQIOMRcAbCUYXLfWgZKDPES,CFEAXFBHLBFC......gADEDABAEDCDSGCGhAAAVGFAFBAE.BHAANEEA.hAAAdBDCHBGFaGGGOCFFhAEAMAFGADDE.....YBBDWFFE.KHEGhAFA......hAGA...,2,-32,-14,18
bHQFBaOSDWIcLVfdTPYEGRMXJCAKgUeNZ,UFCDZACDHAEFBGHBaABBDDBH....IEBBLDFG.dAHATEGDhAAAEBCD.RGDCXGABhAGAABGDKFAF..eFFBhAAAQDEBFAEG.WAHFfBAC.hBAA......hBCA...,2,-36,-15,21
JbGKEgaTCIeQFdLZWAONMXPcRYSUBfVHD,OGFEXGDFRABH.UFBEBAHB.HDCBDGHFGBGEKFAG..EEEETBAFhAAACDHC..eAFFhAAAFDEHZADGAEIB.MIACPHBGhABASEAF..fDAAhADA......hAEA...,2,-27,-16,11
IQNVLTGWXebPaDcOMFdAYgSRJKUZCEBHf,SACERFBGUBDAZFFB.BGHBHBAB..IEFBQAFG.LEEHhAAATBEAXFAChAAAeHAGaCHD.DBAE.MIAEhABAAHID.JCDHCEAG.fDBE.NBHCVGDGhAFA.....hABA...,2,-14,-14,0
LFUcaPCTOJZWVEdQXKNgeAHDRYMSIGBbf,DAGHRCDAMHACGEDC.BDABLAABFGGE.aEFHCAAG...OACHhADAJFAH.ZBGF.EECGXDFFhABAKAECeHFG.AIAASGEDhAHA.fEBGcDBETACGhACA...dAEA.hAIANAIE...,2,-34,-14,20
YaUICTKWSZEAfQVLgcdHGNJeDObFXMPBR,QADDLEEGdCFCHDGFGGDHJFDFDGBBOCAD.FAHHMBBFBCCEhAAARCDBUAGB.CFFGKGHHhAAAZFBDEADE.ADIHfFAGhABA.........hABA......hACA...,2,-24,-18,6
FRaTgDXICWJKMbeELNGHYZPfOBSdVcUQA,FFDHaACH.DFEC..CAFGKEDHMAIH...EFABLGCA.HAGBhAAAZBBGODBCBADBdDBGUCFAhAAAAGGFRCEB...XGBDhABA.JFHDNIAH...PAEGSBAFhABA.cDGE.hACA...,2,-30,-25,5
dBNSYLIFXPaTJGeMVgcHfbDOZCQEWAKUR,UAGEdGBGSAHFLCAHFFGC..aEBCJCDCMGDE...VCEFhAAAHFBC.DEFDOCBAhABACAEHEAAA.AHEGKCHHBEHEIHGEhACA.PADAeHDCfDDEhAAA.....hBAA...,1,-25,-27,2
QLdBGNIKeEUDMASWJcYXaPObCZgTfHVFR,JACDXABA..OAEDZEFE..TGCGHEGHFEAFLBFBhAAABHCHGDDCKFACEHAGMDEFhABAACAHSCGF.hACA.cGGFaAGGCAAA.fHEH..hAEA......hAFA...,2,-31,-21,10
ALeOPDUVSNBFdYWbCRQcTIgEHafGZJMXK,eBHFOCEDDFCCUDAA..VCDGBFGAdHGF....bGDCCFFBQABFhAAA.TGAChACAEBCGaEGA.fBHAhAAAJGCAMBEAAAEESGBF.YAEChABA....hACA.cEDC.,1,-20,-29,9
SbDfMTOLUaQeXWRYPKEBFZNCgcdIHJGAV,VAFDSFFF.DIFCMDEFLAHBUEBH.QACBeCHFRABAKGGEhAAABFBD.FHBA.CFDHdBAEhAAAICADHCCGAGHDTGEChABAaAFD..YEHHEHAA....hABA......hADA...,2,-17,-16,1
TaQWXeGIdAMRUBLJNKSPDcZYEVOfFgbCH,RDBCLCFAKGCA.DACBZBFFEEAAOFGH..FGGBCFHA.HEEA.QGBDhAAAXAGFeBAAhAAAIDDG.ABDBBAHDhABAJFABSAEDPADA.....YFEHhABA...hAIA.fGEG.,2,-28,-13,15
fXgeIPEAZHKcVUbLRJDSWdONTBMYQGFaC,HABBKGDEUAGALHDC.DCGHSEEAdFAGTEGGBBCA.MFBBhAAAQEBG.hABAFADCCAFGXCDDhACAIHHDAFEBZEBF...cGGG....hADA......hAEA...,1,-18,-40,22
OGRXEYSgLCbATIJWMHUaDdQPZKceNBFfV,JFHBHDFH.aDHDdDGAZAEBKBCF..eBCFBFDBFAHD.OBAFRFBH.EDDBhAAASAFCLHAGCEAGhABAAIAG....TGEFhAAAIHHE.MFFHDBAFQBEFhABA.NEAB.fGBHhACA..,2,-45,3,48
NbBQFOcUMWdAKDGVXfLEaSJRgZPCIeTYH,DFFBGDCG..XFACfACCLBAGEHEA...aCEFSBGDhAAAJCHF.RCADgFAGhABACHHHeEBC.hAAAYFFANAEDBGCHODAGMAIDAAECKCDC..hACAPEGBIEHC.hABA...,2,-33,1,34
eCSUDbdEVAMIYJfONZLKBTaHWGRQcPgXF,MFHFJEAD..OEFBZBECKDABBCFBHDDFGECARGBG..QABAhAAA..cABDhAAAgAGEFGGDCDCFDBIHhABAdGFGAFAB....IAEFNEIA...hABAaEHF.....hAEA...,1,-14,-36,22
LbHDEdNRaSVOgPCGXKUFAeZfWMBcTIYJQ,ZCAGMFBHBBEF..ICDHJDEFLEHHHCBFEAAE..dBGEaCGHhACASHAEOAEFCHGHKAGEhADAAFAF..eHFGfEEEhAEATABA.YHCEDFDH...NEIE.hBAA......hBDA...,2,-34,-19,15
SYeCJcAfXbHOWZdQPIBNERaDGKFMLTVgU,XDBFHEDEZBBDdFAG.QDGEBHFHEGCEDAEBKBADLHCGhAAA.TAECVEGDSHCGhAAACHHCAGDH.OBABhABAWDDC.PAHH.IEDFaBGE.hABAMFAH.YBFDhACA..,2,-18,-14,4
TZOVYbEcPNMafRJCDUIWKXeSBFAHgLGQd,HACCLFEBQGADZDDGOABAVEGDEBBH....PCABhAAAaAGBREGF.JDCBUFAEKGDHSABFhADAAIAEdBEA.TBFGhAFA...YFFFNAAACDHBDIGE...hAFA......hAIA...,1,5,-18,23
YCNeDMaQcELIRKVHbAJPgUWSdFOBXfGZT,JBGHUAGB.dAAABHGAGCGAZGAA...CFDH.DEBA..aFCBEAAFRBED.KFFBhAAA..HCBAAGED..hACA.gFFDhADASFBGFFAHOCBA.XAEFfADHhAHA.NIDD.MAIB..hACA...,2,-49,-3,46
eJPAUTbVLQCWagHdMGBYfZOXDRKNcFESI,TAEBVFBE..CBCF.aCBDHDEA.GAEHBDFCZEECOGFCDDABKGEBhAAAFBAF.EHACeEAC.ACDF.hAAAbAGF...QABDhABA.dGGHMIECXGCFNCIEIHAGhABA.....hADA...,2,-17,-6,11
CFbVHQOcAfgMBIEJNaeSRZPXWDYLKGTdU,MBAGBAHCEADD..aDDFSGFBRFAA.ZCGBPHDCDBCHKDDAdBFHhAAA.CGGF.FFDHHCAFOFAFhAAAACAB..IDFDhABAeCAH...WCHHYFHB...hACA......hADA...,1,-26,-30,4
YdfQBPNaDHJUeALWKbZcIgEMOXTSCRVGF,LGBAKGCAZAFE...IBDAMDAHOAAASHEA.CABBRCFBhAAAFDDD.dEGCBBBGaHACDIFChAEAUDAH.AICCbFFEECGE.hAFA...XBBCTAGF...YDBBhAGAQDDD..hADA...,1,-24,-25,1
JNRXLHbdOcWFGDIQfEMSPUKZVBeYaTCAg,JCBHRDEBHFAC.OAFGFGEDDDEF..QBDF.EDACMBGHhAAASHEGKDHBBADCYBHHhAAACGAH.AHFAXBAChABAdAFFGECGIHHD.fEGDhACAUGGHeACD.aFFA.hADANBAC...,2,-30,-8,22
YTUDQeZcXSIaOVWJABEHNGLRCMbFdKPfg,EFAFGCDDRADA.CEACFECEdAAAKGFA......gGEHhAAATDCHDCFAQADBhABAZCFGSGEDIBGFaEFE.hACAOGAA.JBBHAADEBHBENAIGMFFA..fCBHhAGA..hAHAYHAA.,2,-22,-9,13
LgFPEYDTfNIXRdWOGQMaJABCHZceUVSbK,HGCEZBFBUGAESBAELFHDFEGF.ECDEDEAE....fDAHhAAAIFFDdCDDWFAHhABAOADG.MIDChAAAaGGCACGHBCBAeAGBKBAE..YFCCTECHNHCDhABAXADE..hACA...,2,-19,-19,0
KAFXLbeMdGPIJOZNSVgRYCHcTfaWQUBED,LCECeBGBMCFFGFDF.JFBBOHAAZABF.VACBRDEE.CFBCHFGBhAAATDAG..fGEAhABAaAGG.WCAFhACABHHB.DIECAFIHFEDDXADG.PAABhAEASAGE...hAFA...,2,-17,-6,11
KQCDEBSFdAgeOTHRfYWLcUMNJXGaZPVIb,OEBEHFCGRDFG....fBHALAEAMIACJBCF.aDAGVADChAAAKFHHQGEFhAAA.CBAHEDGFBHABFCEEAHHEeCAFhABA.WFFHcABF.....hACAXFAG..hADA...,2,-25,-15,10
WBEAULcdbIMgSRNVGeTOFQHZfDJYXPKCa,UGFBLEHDdBFH.MBDBRECCGCBB..TAFDFAADHGAAZFEHDICGhAAA.JBEHXADBhAAA.CEGFBAGFECBBcFABhABA...ICHENCIE.eABC.hACAfHAF.hAIA...,2,-19,-15,4
LdAgCGUaKWXJSHNIYBZfPRQcObeMDEFVT,CFECGEDDKACE.JAFBHFAC....IDHGBHADZBCE.RFGFODFEhAAAeDAGDDCC.EHCCFDDBhABALBACAEBA.UGGFhAAAaAFA.XEACSGFD..fAHEhABA...hAIA...,2,-33,-15,18
bAGdgECLQcZRIDUHeTBYWVNaFSXOJKMPf,dDCHEBABLAEFQEGEREEB.DBDCHEGDBHADVAFAFAGC...SDBHhAAAJCFD.MIDAhABAPABBABBGCGDA...IFCHhAAAeFCF.....YHCAhACAaCCFODABfEAGhADA...,2,-44,7,51
fTeRKWaJBUFOMEHLIQGgPSXdZNbcACYDV,DGFCVFAGeAFD.KCDFJDFG..BACCUBCFFFDB..OHFEHBAHLAHBhAAA.IEHFhABAgEGAXEAChAEANBAA..AAIFCEEDTGACaAHH..MBBBhAAAEGHF......hABA...,1,-15,-36,21
XcFPTGgVHafIMLEbNJWBZSAURDQYOCKed,DGAFQDGBOCAD.eCDAdFFG.FCACGACAHFAH..aGFAMDFAEAAC.hAAAJFBGBAHGZEGFAEIHRECACAEH.hAAAKHCE..XAFEhABA...cGCD.....hADA......hAEA...,2,-22,-14,8
QSIYMfXCKHeOJdbUEBFAaLcGZPVNTDgWR,aFGGLEFFZABD.VFAHDGAB..RBFG...SBECMFBE.XBBGhAAACDDFHFEBOAAHhABAbDBA.BHBBAGGEPDHDhABA..NEEH.gGCHIHHHKAEDdCFFEACAhACA.....hAFA...,2,-28,-1,27
GfTeYNXAZRPKgaWbcCIEBJDQHLOUMSFVd,ZDCAKBDG.aAFH....bEEHCDAEBFGE.DIGAHCGF.UDAESBBEhAAAdABEfGCAhAAAeFDD.XGGHhADAAHCD..PBHBcDDBIHAFEGAC.JGEAhABAOAEGMAEH...hACA...,2,-39,-3,36
MAFKJcVYBUgRHXINWCSQOGafDLebdZEPT,FEDHJBFF...VAECBFGF.UECCREAFHGDC...XCBBhAAAICDACHCG...QAAGhACAaGGADAIF.eAHHhADAdABHPEEGAHIFKDHB..gGAENDDH.hACASDBD.hAEAfAFD.,1,-3,-36,33
gHRIFWbcMQedVDCELJXaZTGYfUSPNBAOK,ODBHKHEGRCBA.FDEE....bFCFQDCAdBGA.CHFALAAEhAEAaGABGFEFUAGESACGhAAABHHCADHBIFHAhAFAMAECeBAF.DGCDEGBH.ZBCETBEE.hBBA.fFFAhBCANBIG..WEEE,2,-23,-4,19
AbSYIUTQcaELHXfJBPeFCVNZOGMWgDRdK,SFFCUGEHQFABEDAG.HAAC.JBFGBFCH.eGAGVDGBhAAAOGEE.MEEChAAADBEFdDAFACBGIACChABAaDDC.LAFG.fCDHCHHG.hABA..NDIGWHAG.hADAKCFAYHAG.,2,-12,-11,1
WMDCQIFagYBbANXfPdRSecKGJTVLZUEOH,XGDCdFFCRAFH..SDEGeFBFGBDC.JDFBLEADhAAAZCADEAGE.HBBADGIDCCHAIDHGhABAFGGF.aHFEBACBhAAANIAH.fAEBKFBH......hABA......hAIA...,1,-16,-18,2
BAFTOCMUbWJDVSePNZKIGfgcXEaHdRYLQ,TBDBMEBFUEEH..JBAGDBCD..VFDHeACE.ZCGHGEAChAAA..fBAAhAAAXCFAaHGEdHADRFCDYAFAhABABBDGAFAHCCEH.SGHHKFFE...hACA......hADA...,1,-19,-21,2
VKXJGMLdWfCIeTNbQBgRaPZHcDFSUYOEA,KFHDJEDEGABCMIFALBEE..fBEDCDHE.eEGFhAAANADFBBBFRAGB..PFADhABAHEDBDDBG.SFCDhAAAYEHBADADXCEAdGDG....hABA.WCAD...hADA...,2,-30,-21,9
FYaOADeTGWMPXNRJKESUVLHcBICbZQfgd,DCFATCEGGDED.MHBAXBAB.REAAKBHHEGGAUAAB.LDAGhABAHEGBBADBIAFAhADACHBHQEEBhAAA.fHDDdFDFaAHFOHDEACAD...hABA......hACA...,1,-14,-21,7
TDEZHWQAGFSMOPKgXLbeUdfCVBIJcaNYR,SEAEMFBGKCACLHDAUFEG..CDFGBBAGJAGD...aHDCRDDEEAEBhAAAZAFC.HEGB.AIAE.hABAGADCFFAH.gGGHhAAAXABE.dGAD.fCCE.hACAcDGF...hAFA...,1,-19,-20,1
YKaTMBQSCNVgRcWZFfAbGLHXJUedEPDIO,GDCBXBFHeEAGdHFF.DIAG..OFABaACHBBHDCEGH..VACAhAAAREGDZGBA.AGDGLAABhADAUEDFEBBB...IAFChAEAKHBEMDIBSGGD..cCAChABA.....hAHA...,2,-20,-19,1
QDEWTBcNPHGFOaXZYLUKJMVgefSdIARbC,CDDDEEAGBGGA....NDICHCDAGACDFCACOCGBZGBCLEGHhAAAKAGE.MBACeEHBdAFCAHCBRFCChAAADAHF....TBABhABAaEFH...UDAB...JFAB.hABA......hACA...,2,-20,-15,5
cWBHULdYKMJfeCOZTEXRQNSVDIagbAGPF,GBDBFEEBBFCALHBAKBFD.MEEAeGEAOCBCZBGD..ECBBXGGFhAAA.QFAHhABASEAHDACEaBAAhAAAAAFE..cEBA.WFFDdAEFJHAE.CHHC.hABANAIG......hACA...,1,-4,-32,28
BgVZfCdcOJRKeQAEHSDbaXPTUNIFGLMWY,EGCFSHACDFFC..aADDXBGE.UCABFDAHMCCFBFFFZABGhAAACHAFdGHCOEDB.hAAAKGGFeDDGAHEC.bBGBNDDF.hABALFDH...YBAEfFADhACA.cEGA.hABA...,2,-26,-20,6
WHfCBSKRFgPYaJdebVUGOAMTQDcZINELX,MGCADEBBZDFA..EHEALBCDHCDFBBCCKFGGFAFD..PDFAhAAA.aEBCdHAH.bGFGUAFDhABA.AIACQGGGhACA.NDAA.fCGF.SBADhAAA.REDF..hADA...,1,-13,-32,19
dJfcSVCYZDGWAIBOXeFTURHgPNLMEQKba,OEFGFBECRDFFHFAA....gCCCLABBEHDEKAEBaGHHJFHB.hAAA.SAHFhADACBHFZAAGDGDAAFDGBDDG.eEAEhAEAUGAAMBIHbCAHdHDBfFEG...hAAA......hABA...,2,-21,-4,17
SPGdcVNIUFZQYTJaEBKLRbgWOfeDAHXMC,XFBECHFAGEBEdBCG..VABAUADAZFGF..QEEDhAAAJBHBBEEHKAFFRAGF....hAAA.bCDEWDHH.OBADhABADEIBMBAB..cGDDFHBCaEAEEDFG.hABAfGAGAGAH.hAEA...,2,-18,-13,5
VeOgBUTEXIJZKPFASLGbdafQNMCYcHDWR,LBFDdGBAaBBG.QAABCDFE.HECADCFGREGFOHDEBFEG.ECCChABA.JBHFZAFC.FEBESDAFhADA.GGABhAEAfCCDYEGB..WABE.hAFAeHDE....hAAA...,1,9,-45,54
SBCJbgMLRXfIHTdUPGFNeQYWaVDcKOEZA,CGDGJABA..MCCGRBFA....XBBCIFGDHEABdEBCUDDAhAAAFGGAeEEAQAGFhABA.aFHDDHDC.cDDBhAAAKADGEGEGAIFG.BCAFLAFCPHAC...hAEANIEB......hBAA...,1,-12,-23,11
fWRXdOQSYeJIbDFGCcaLTHKNMUPgAZBVE,BACGVDGF.EEGD.RBAG.dHCH.QEBDeDEB..JGAADAADCBFALEHHhAAAHBEEKBCFNDAEMIDEhABA..UGGDAAEDZDACfDDDhABAOAHB.SBHB..hACA......hADA...,2,-20,-18,2
VZSYPFLNORBDMUcAEXTKIQgJabeGfHCWd,XFCEKGFFQGBE..JFFDeAGBHDFCdCBFZBAESEADhAAAFBGELABEODEEBHADhAAAMFDEAIDAEGAGTDBBhABAaAFB.fHGFCHHH.YABG.hAHANBIEDGGAIECF.hACAbCBA..,1,-8,-12,4
ADdNYGXZQabFVIPSJcWHMLKgOCeEURfBT,DIAGdAFDGCBDZFDF.aHDEFGGC...VCFBSEAA.JABGhAAAHCBFLEHDOBDFhAAACGCCEEFHRFAEBAHD.ABAE.hABAXBGE.IGABWCAFMDIBKBAF.hABA......hAGA...,2,-24,-19,5
aGZcBUeMPYNTFCHVQObKEDXJWdAfSgIRL,SAEBRCFDGAAABHDCeHBC..MAHB..PDFHTFBHCHHEQAAEhAAAKGAFDHFAJDEH.hAAAACGHIDBHLADG.hACAZDCD...cBGFNBIA.FGAB...hAEA....OHEChADAEDCD.XEGH,1,-2,-20,18
RLQDNAFUSBfaceGWIJMPdbKXECOgZYVHT,SDFBaFCDGCBC...JHEAdAAC.XGFBEDAE..gECAhAAAVBDBHBGDTFGFhABALFHB.DADEFCHBhACAfGEGeFBDMCDCKGADCFEHZACG...hACA......hAGA...,2,-8,-8,0
XgTeALVISCaZQYFRWfDbGOJdEcUPMKBHN,VDCHCGDCZCBF..FFHDRADA..DIBAGDED.dAAFEFHD.UAGAMAFFBEGFhAAAHAGF..XBAChABAeADBADDF..IHFHhAEAaFED..WEABfGAE..hAGA......hAIA...,2,-32,-23,9
BfegZUTPIQNJWAEFDMCSbacGXVLHYOdRK,FCHHCCAG..SFAEaBBAGECALEGHHCCCdGGEBEDAeCABUGDHhAAATAFDQBGBhABA.JCBAEHAGDEIHbEFCXGAChACA.OABE...fCEBhAEA...hAAA...,1,-10,-15,5
VQdCgbcReJMUGAPFSKBELOfHYaXWDITNZ,FFGCBAGFEBEBOAAG.HCBGaHBA..DFFHIDGAZCAB.QGGBhAEACABE.bGCERAGHJDCChAAA.MIECAEBCSBFGhAFAKFBGLADCfEEA.WHBGhAIA......hBAA...,1,-25,-30,5
XCYOFULbGJKVeTBMASDNagWPcEHZRdIfQ,DAAHaEGC.....PGFAEEDDHFAD.ZABHRCDFdAHEIHCF.hABAXBEGODAAFAFFhACALAFCJHDCKDGETGGEhAAAAHBD.SEAE.WEEBfFCBhADACDGB.YEADhAEA..,2,-28,-15,13
UIHLPQdRgaJDCAXKVeGNcTfZWBMbSFYEO,VCBEeHBGGDBD..TAGCZFGHMAEDFFCF.EFCDUFEBHBAELAAGhABAQAGF.hACAdAAFaHGEDEGGADIHXAEBhAIANDACfFFGBHEHSBFDOEEG..hADA......hAFA...,2,-13,3,16
GcCOKXESfMBbDZYWHVNgeadIJLFUTRQPA,GADFCEEBKDAD.SCDDBCFHZFBA.HFDF.NAIG.eHBE.dFGDIFFFhAAAFHFC.REACPABBhACAAHHG..XDBFhAAAEHGAfHADDBCA.YCGH.hABA.WBBG.aAGG.hADA...,1,-6,-43,37
eYWSBOZbIgGcPUFERTCXMJHdNAaQKDfVL,aECHQEGB.KCBEVBFFLAHF.eECASHEEhAAABEAAZADAIABDGGDBUGABhAAAFFGFEEABCABAMDDChABAdADBADIFDEFH...fGAG.ODDDhAGA.gBCAhAHA.,2,-28,-6,22
YXFLdfWGIDQVRPZOUCSABHcbeaJgETNKM,BDAAHEEDeFDBJCGD.TCCEKAFB...MFIHFCDHdABGGEAE.hAAAIAFDDIBGRFGB.OBAHhAAAUFDD.ACIBaCFF.hADANAHGLBBEQFAA......hAEA......hAFA...,2,-43,12,55
REQKZHFDMOgUTNeBbLacJYGVACfIWPSdX,CEFG..IFBBSAEGdAFERDEFKCEG.ZDAHDDDH..MDIHOHBAhAAAUAGCeDAFLBCBhAAAaGGC.JHEEGABB.hABAAGDCPAHDXECA.EBBD.....hABA......hACA...,1,-19,-22,3
ZfAYJgMLBTGeUaHbCFSQEcXDRKNIWdOPV,JHBEMBEBBABAGDAA.eCCBHFFE.CDBA.FFFC.QCGDhAAAEAHHDDGA.KGCA..NEDH.IABHhADA.OAEGhAIAZBDGAEIHLFAAaGHDSHEA...hAAA.XBAC.hBAAdHFH..,2,-25,-15,10
BEPdTCfIYNLZKAWFMgeSHDGRVJObcQUaX,FBDDMCCCeHAEDIEAGFBDRDFE..JAFGOCBB..QDBHhAAAaCHBBABH.EFFHTEFFhAAAIHGELAFEhABAZFACAABC.SGHH......hADA......hAEA...,1,-24,-28,4
KHebQgYVdAOCPXLRFfTcWaNEJZGDBSUMI,CFDCXCBFFDBB....TFGBaGBDEEDCGAGADBFG.BBCEMEGBhAAAHFEFQBDChABA..gGAHhAAAdGDDAHAGPDABfAEGcBGE.WCAF.JDDGhABASACC.hACAIHHG.,1,-11,-13,2
HEWRJTaOQFGPNScUgLfYKZCIBMAeVbdDX,eAFHVFEB.DHGAHCAFRCCF...aEFAOEABFGACGADD.SCDFhAAAgABAfHGHhABAZEFGCHEBBDGCAGCG..hAAAbCFAEBHD.TFBCNIAH......hABA......hACA...,2,-26,4,30
MCJdKVYgAfSOTEaXeRLNFZcHIUbPBWDQG,ODFGTEGC..EACAXFGG.REBHLABEFDCAZFACHFEHUAFAhAAABEBCDIEG.MAHFdCBFKDEDhAIAVAEBAHBF.aCAB.NIAD.hAAAIHHC........hBAA......hBCA...,2,-25,-5,20
fGFJgdDLQOHCZNPVcKeRWMSBbEXYAIUTa,TDGGaGDGGAAC.FBFBJAGD..DEFEOFBAHFFBZAGB..PCBEhAAAKCDDeDAD.MICAhAAAbDEH.EEHFAHHGIADAhABA.UGAF.fABCdECDCGAD.hACA..NIDB....hADA...,2,-16,-4,12
XdaKEWCUZVYHPQbSAOcGMLfReIFBDJNTg,OAHBMAACRAFA.FDCDBEBH..DAFB..TBBHdGAEaFEC.KAAHEEHDhAEA.CEFG.ZADHHGDCQDGFhAAAAEDC..cFAHhAFA..fGCEIFDDNDDB.gGGBhAGAXGFAWCADhACA..,2,-31,-30,1
JLFIARCYBdSNKHQGOUaebcXfgWEMDVZTP,RDGBBHDHdBEGKBCHQBDA.OAEAaEED.eBHD..bGCCfEGChAAA.EBAChABADFCAZFCGTAGDLDDAhACAFGADCHHFYDAHHBAB......hADA......hAIA...,2,-25,-11,14
CBUNTeVQbHgRZXKEAOLfPDIdWcYMGFaJS,OHAGLHBEDFAGdFGC.......cCGDYCDEGAABhAAA.aFBCCGECUCADhAAA.TCGDVDCCHAEFhABAREFDZABEKAGEfDAHIHHBMFFB.FAGEhADABFHB.NICF...hABA.eFBA.,2,-9,8,17
YeXGFbOLSCaPERcZQDfdWVKJIMgNUTHBA,eDFAXBFBGBBAFFGB.OECDLEDBCFAE.EAAAZAEA.DIBAdEADKGGAhAAAJCBC...IHAChAAAgEEG..hABANIEH............hACA......hADA...,2,-30,-28,2
RgMKfUDPFBaCVJTIcWYAEHOGLSXbeNdQZ,EEDHHGDAGBBHLFDC.SBECXCGEeHECQABEhAAARFAB.MDBAfFGBhAAADFIHBDEHCAHC.VCGFIAFGhABAWHAGAFCD.NBAG.gCAG..hACAKFAH.....hADA...,2,-16,2,18
gTEWYfabBZFdJPAIQMUcSXVCHRKNGeLDO,MGFGSBFD.CFAE..HEECKAAFGAGEeHAADAGGOGBG.hAAAEDFFfDAFhABABAFGZCAEdHFDAHGBIDDGhACA.QACEcEAG.XCGFNIAH.hABA......hACA...,2,-28,-11,17
RSYCUENJMDXObaFQgfdLKTeVHPcWBIAGZ,GEAESEFCCDCFUAECEDDD....JFCHMEEFDAAD...XGGDhAAAaEAHFHGA..QBFHhABAfFFALBBGhACAKAHHeBAE.PDHDcEGEBHCDAAID.YCADhABA..OADAhAHA.,1,-15,-28,13
WTCacHKMYSXLeAgOfPQJIDGbUBdZERNFV,OECHQECFDFIFGADCUBAFdHDB.ZAGBEFGFRFEG...FABDTGAFhAAACAGHHDEB..KAEFMIBAhAAASAFBeFAHADAB.hABA.fGEGIHHCNCICaDBA..cDEAhABA.....hADA...,2,-15,-8,7
bBWaUXEPeZgOQAMVYNJRDCTLGFcIdfKSH,VFAAJAFB..RABE.DEDCLHFEGBDFFFGDdEDH..KDGDHABA.BHDFhAAAaDHD.EEFFZFAHOBABhABAACHE..MBAFNCIC.hADACHDE...IAHA....SCCAhAAA..hABA...,1,-10,-37,27
RKYeHfSGJINCgODVbcQZTPLUdBFaWXMEA,RFFBeDEDHCBBGCGG.JBDCIAEC.CEEDDGDHVAAB.QGDDhAAAZBDGLDADBAHFhACAFHACaGBGXEGBhAAAAGAH.KBACSGGD.ODAE.hABA......hACA...,2,-20,-10,10
XcdUBMaLIPDZRCFbJOHKENTgASYQWVeGf,QDCAVBEG.GAEAXFGAdAGHMDAHLCCHDGFFCACHJEEGHEGDhAAAKHBA...EBBDNABB.hAAAAGIH..SHAAhABAeHFGfAGBBHDCaDGGIDBGPEBB..hAIA......hBAA...,1,4,-27,31
WFJUDBMPHfcEbLXCeONdAIVZGRaKSgQYT,ZDCERECGKAACSAHH..QCEE.TBCCWFBDUBEDhAAABHHEMDHFHFGFEACFhABALEADCHEHeDGFOADAhAHAAGAFICAHaGBDFBGADDIHcGDE..hAIA.XGFH.hACA.dAFB.,2,-13,-4,9
bWaNLdJYPTUfVIEGeZcCgKDMXOASQFRBH,SEHHRAEABHHEHABB..aDAGLAAD.JDEDTFCDUDGH.hADAfAGBEHAE.hAEAZEADCDDFKGCGMCACAIGCFFAEhAFAbDEFdABB.PHEE.ICHAeHDADGGChAHA......hAIA...,1,-4,-9,5
YWBDLUTdRNcgIOeXFKCbQSMfGAEJPaZHV,EGBFaDFEZAEGHDED...VBAEBFCGLFBCdFHARFAB...cAFBhAAAIDCF.OFGBhAAAeGFCFDHH.KADECDACQFDChABAfGDGAABGJABEPAHFDICGNAIE..hBAA......hBDA...,1,-3,-20,17
gKaMGEITZNVRfFAXPOcLWdbSDUQeBCHJY,XGGBOFDCLCDAdEEA.DAHBUGADQCAEeACEBCFBCGHBHGBEhAAAJCCC...KEAFMAABhABAEHEC.ZBGDRDFAAACC..hABAPCBHbACA.......SDHHhAFA...hAEA...,2,-19,-11,8
cSIVOdYfBKCXNaWGDbAJMLTPgREHQeFZU,MABATAGCRAFB..HBDHFACDZEBHUEFF..SDGDOAAHdDBHBFDFhAAAKFDB.CGHE..aDDADFAGhAFAACAA.LHDA.hABAEAHBeFAH.IAEG.fFFEhACAXBBFWFHH.hAGA...,1,-10,-34,24
bOIYgCKAMecfSBRPZJTFQdDHNVLGXEUWa,MAFGeBDD..SCBBRBBDZGBEFCGG.dBEFDIDCVEAD..LBEFhAAAXEFAECAD.aEACOFDHhAAA.IABHhADAgGGECCHFAGEC.fEFCBHAD...hAEA......hAFA...,2,-22,-22,0
VWAKObBUMcSXCDLQHNTeEZIgJRYPfadFG,KGBHBGGCUGEASDAB.DCHHQCCBHGAC.TDFGhAAAeDEHECCCZACA..IFAEhABARAECfABBFEHD.hADA..WFHBAAHBOAHDMAIFCAAD....hADA......hAEA...,1,-22,-25,3
IaORVgDLbHeSXTfPEYJCcKGAUNMQFBdZW,MDEBQDFHdEAAZFFHaFDF..RFBF.DIFCLABGeFBF..SBDDhAAAXDFATAFAhAAAfAGH.EBAHCFHHKCCChACAUFGDBHAGIHCCgGDAPAED.hADAYEAD..hABA...,1,-11,-22,11
SGRXPKJELWAHCVNQUOcMIaDeYdZbfBFgT,CGHBQGCAUGEA.MBDCDBGB..dECDZCEGBHAHFGGA..SAABhACARACB.KDAFLAEChAAAAFCDHFEBOFADhADAaABH.eEFG.fECBTDGGXCAChACAECBCNAIA.IHCEhAIA...,2,-44,7,51
OCSYEQgIMfVPFKZDcHeNaUWLAGXRbdJTB,GGEBRBAFdHFBBFGDCADD..EDEBQCDG..gFBChAAAMFCB.VBECKDHBDACGhAAAeCABaGEBLHAGhABAADGDJAGF.SCBB.fCHAhACAPFAD.cEGH.NAEH.hBAAWACA.,1,4,-39,43
IUJfFEXPNRGDHYVQgZSeWTObcKAMCLdaB,CAHCdHGHBCFHUABD.FCFCEADG.....XGECREEADGAEHCACQEEBhAAAZECD.eGAGhABAOAFCKCCHLBBFhACA.IFCFfEABNDIA....hAAA.YHAA.hAFASEHH.,1,-17,-24,7
UacdEMBAWfeIKCJFHGXOPVNSRZgYDbQTL,eBDGCECFFEFE.GFBD.OBFAVBFG.RBAHZCFGDBAH...QGFAhAAALHACUBDCdHABBEHChABAABBH.IDCAhACAKEAH..JFHB..XEAGSEEF.hADA......hAEA...,1,-4,-42,38
DbRScQHYTGFBZdKCfMJVOePgNaLWAXIEU,EGGFUEGCDEAFRADF...QFCFHCBHGGCHZACDdCHGCBHG..MDFGhAAAVCEDOCAH.eFAHhABANIAHLFHB.hACAABGA.IEEESAAA.....hADA......hAFA...,2,-16,-16,0
UYNEWPcVdfHSICbGTeOLMQDFZRXBaKJAg,UBAGEGGA....PDDDVEBDdFED.HAEGCAAHGBDH.eGAEhAAAOBHFMDACDCCCFEAGhACAZDEABFFBaFHDAHDGYHEAhADA..NEAG.fDGHSHGGIAHBhAEA...hAAA...,2,-25,-8,17
WZSOBCARgYaeTNQGXMfPKbDHIcVEJdFLU,RBECaEAGeFEH..TFAFGDBH.MDHHKHECDDDDHFAD..IEGFhAAAVAAHEGGB.JADELADGhABA.UGGAhACASAHBCCBHAAHC.NDIA.fCHE.hAAAcGCG.WCFFhAEABGDF..,1,6,-40,46
KQegLDYRAXFWfadOTNMPJCZBGVSIbcEHU,FADDaAAE.OFCD..TAFAMFFF.JFCFCHAB.BBHAGEGA..hAAAIDBHEFAGKCBFeDDChABADIGCADFA...XAGChACAdGFHPADH.ZDEG.bFAD....hAAA......hABA...,1,-21,-28,7
dFJaSNATXgUOGYKPBDcHRVCWMfIELebQZ,TDGGUEBHOEGF.GAEBKGFBBAEADGGD.HDAE.CGBHMAAAhAEAIBAELFED.hAAAQBBAdCEAaCCBNEIE.hABAAAIFgAFH..cGDD.hBAAWFAD...ECGChACA...,1,-13,-32,19
bcKWOgfCaVIENRMYJQedUHFASBDZGLPTX,BDDEDFACGGABLAGD..TCCEXFGAKGGB.OFEBCACH.hAAAaHBCIDFG.hAAAEAEGREBDMACB.YBAFhABAQAGCeHFGUCAGAAFH.ZEEEPAHFhADA.....hABAWDFG.,2,-24,-11,13
LQRKXUMfCJcZFVDgBSeHAGYbINOEPadTW,GBED..YAEGIHDC.EEGEdCABLACCQDEChAAAREBCKCCGUGCC.CDAAJHFChABAFAADDFFBBFAGSHAEhAAAABBEOAHD.aGHDTDCH.MGFEfAGDhAIA.cGFDhBDA...,2,-18,-16,2
GNfPTWJgCKcMZVIdYBaDARLFOQeUbSEHX,LADEFBHDeEFDUGCDSBAE.EFGCGACH..fEDEhAAATDAH.JCFBCHADMFIFhAAAVCAF.dDDEBHEFhABAABBB.OHAA........hACA......hAHA...,1,-26,-27,1
MYUcGKEePZCDWOLFXQaNAdIfVbHSBTJgR,dCCCVFEASDFC.BGBHJAHBMBCBUFGAGADH.EAAAhAAAZBDA.DGBFLDDBhADAFAECaDDB.ACIB..fEAGhAEAbAAF.gGEF..YEHHhADA...hAGA...,1,-22,-32,10
IFTGWUbLVOECaBZAgHMJSeQfPXdcKDYRN,HDFCMECH.eFDFQBEFXFGGKBABDGBDRDFCFDDDGACE.UAFAhAAAVGDCEBAHBEAC.AFBH.hAAASFBBdAHA.hABANEAAIHHHWADF.......hACA......hAFA...,1,1,-23,24
dEabBKeZgLOHMfGDNQIVAUPcCFYRWTJSX,UDFFCEEFFBFC.RACD....JFCCSGDH.dBAEEBHBBFFCZGACOAAHhABA.HGFGhACAMDFEDIEAIEBGhAAA.VACFAAIF.PGACcEAC..TGGBhABAaBEA.....hAEAKAGE..,2,-28,-27,1
SDTCURagVAXEHZOYFQPMBcWJedNGfKLbI,XAAHZDCHOAACFEBG..QGGDBGBC.JBEHdGGD.fAEAhAAALBHBSGDAhAAADEEDCCHE.UGAAhACAaDGBAAHEHEFEMDADeAFBNDBF.KDAF..IHEChACA....hADA...,2,-40,0,40
DcOQYdaCXAHUWRVbMTNBFISJfgEGLKZeP,UAGFRFDBMBCBBFHF.FHEGJDFD...EADDGABD.KCAFZEAHDEEDhAAAOHFC.dAACCHCHHCFGhABA..VAGBhACATFAFIDDH.SDHHgCCAhACA......hAEA...,2,-33,-20,13
GOAJIQeEKdZVgSCPXMWLfBHUcNFbYTRaD,JGECQCEA.EDCDdDDEZFGFVBAH..CCCBMAEGLGAEBADDhAAAHCFGUGBBFAEATCGGhABAaAAG..DEIDACAEKFFDhACASHGA.PHACXAGE..hBAA......hBBAfEBH.,2,-19,-9,10
fcZEUBgJSPMRXWTLAeINbVODYGHFKQdCa,eADE..bDFADAHHGBDAHCEEQFGGCEAD.aBBFfFGDhAAAEEBDBGEFSBDFhAAAPGCAMBBFXGAHhABALHCAAEIDICAENADDOCCHKGGFZECB.JAHBhABA......hACA...,1,1,-9,10
WdCQVAUGJcORSKHMFDZITBNefgYXPabEL,UDBGGECEOEHHSAHBHABA.MFGBDAIDZAGFBBCF.eCAH.hAAA.gEDHhABAPEHFECEELGCACHBHADDCRBGBIGABhAAAfBEHYADCaGGHdEAG...hABA......hACA...,1,-5,-10,5
OGDdBCbRUMcLfVYKQJPWEZNIAeagFTHXS,eDDEaGEA.FEBCHBGF.OEADDAFCBCHECBCEUAEHLHEG..hAAAVDDEKFHBQABGhADA.JBDEEAACZEEGhAEAAIGEgFCDSGCB.dFHC.MIAC.hAIA......hBAA...,2,-24,-9,15
CUBPMWZQVATRDcfEXaJIYGNFgKbHLOdSe,TABFRDEFDGDD..EEGHaEGH....JAEAIGDFGDABFACHKAFCLFBFhAAA.dCDAhABAeFHFBAHAMAAF.hADA.WFHH.ZFEHAAIBXCGAYDFC..hABANEAC......hADA...,1,-9,-33,24
NFVSBGEHPMALOCJWdYUIDRgXZeacKbQTf,CCGGJBEEdBBH..UFDEDEEF..RFFG.ZFGH..eHACaDCE...KFAFQBAFhAAA..hABATEBDFEABBHAEEDACMACAhAAAOCHF..IHFD.XDGEhABAfADFSDDEhAGA.,2,-41,-36,5
DdgKTVUbBaWZRMHNeJfCGOFXQASLPcIYE,LFCH..PBDEIDBFEDFHDAEGKFGHUDEGBBABaGBHRAGFHADChAAA..eEGHCGAGOHEEhABAXDAF.ADDHSCHBhAAAdACC.gFDE.hAEA......hAGA...,1,-20,-27,7
KJagDQSNLTXMfOAbCcIFGVBUZHYPEWRed,CEHDFEHHGCADBFABHCDA..EGDCeBEEJHAC.DBAF..SGFHhAAATGFD.MACAAFCC.hAAAIBGCZBAD.PFBGhABARGACKFED...aAGANAIC.XDEA.hABAOBCG...hACA...,1,-11,-23,12
JZUHYWGTbQFEcLOaVNXABPegDSMRIdCKf,BEFGeDFFDFADMCEHRECB.dAHG..KHFAZAAFUADFHDGH.GGBD.hAAA.QBGFhABAEDABLAFBaCBF..NIAH.AHIFSACHhACA..fEHEhACA...WEAB.hAEA.FGGH.,1,-14,-27,13
YFDLfERIHOUAbJCVKQNBdZeWMcSgXTPGa,JEAEKEBBBCCFZADF...eAECMBAH..SCAD..hAAAgGBATGGCaEDAhABADGIHLHBCRDFDOEEHhAAAAHFHCBGAQBBFdEGD..cABGGAGEhABA..fFDDhAEAIHGF..,2,-27,-20,7
bZAJIDHPNMKeSgLdYVfWREXCFBTOcUGQa,DGDBHFCFMFBGKBFHeBAFLBADdEBC....VFEERFEGCDDABFHB.hAAA.OBDHGAFG.hABAQCBFaAHHAHIH.hACAIHHHSHFAfHADEGAD..hAAA.FHEC....hABA...,2,-28,-12,16
aBeCAVLgDSZYFMHbGNKcQUWPETRfdXIOJ,LFBFDFFFZGBGFBGFHABC.GEEFKFAA.QGDBUGGC.ECEAhAAARBAHdCDDXAGB.hAAAOCAEBACFAEIDSHGAhABA..MECANEAE.....hACAcAEB...hAEA...,1,-3,-46,43
DGHBSKNUaVMCXRALfJdIecTZOQbFYgWEP,JAHFdDGAeBFCZBFF.QECBFBAH......gECGhAAAPFAFGAABBCDBSHFEhABAKGHDNAEH.hAAAaGABCGEHAIFCLFFEfCDDIHDFODAGhABA...WCHBDAEA.hACA...,2,-37,-4,33
aAMXbELUTeNYgOSJDZcGfCRBdHWVIKQFP,MGCGEHFALDBGUDEG.eFCC..NEHG.OCBG.DBIFGDADhAAACADBdAFE.HAFG.WACBhABAIFHA.FAABhACAAIEEbGACTGDH.SHBG.ZAGBhBCA..fBBChAEA..,2,-19,-15,4
YfeBQbAagGVNHOWPFKDMIdcXZSRJLUTEC,aHFGVCGFHDEB.OFBCFCBFDAGG..dCBGZFDHRAEALDHDUFAG.hAAACDDE.eBEHBAAEAIGG..hACA.NHAH.KGGG.MABChAFA.....IFFESADD.hBAA......hBBA...,1,-18,-34,16
fLbCVXJdIAQgHcaYKGWeFRMEZUSDPONTB,HFBHaGBHGCDGFDCGEBBGZFFE..DEGEOBFGBAFCLFDBCEBD.hAAAJFFHAIECQABBhACA.gCGChAEAYCAHeAHFMAFEPFCFNEAC....hBAA......hBEA...,2,-20,-13,7
fPXOcDHGKRdeYWgVaATESIMQbBJLFNUCZ,EFDCMHDEBDBFLDDHFCGH..UADACBEBZCAH...XAFFhAAADBAGHGBARDFBdCCGeGFG..hAAA...gAGDhABAACHGIHHA.JABGNCACfDDH.hABA.OHBC..hAIA...,1,-21,-22,1
gOZCTHBfNKPVGLYcASeJXFWaIDUQdEbMR,JBCHFGFH..aEGHUGFE..QCABdBEB.EHCCMBHB.OFCGhAAACEDABHBC.fBFHhAAAKGAA.PEABhABALCAH.ADADXCEHDDGA..bBCBhACA......hADA...,2,-41,-30,11
SUaQRPdGZNeWDcbAOJKgTVXMIYLFfCEBH,JADFTCAH..MAAFLFGD.FBGGCFAFBEHEHFCGSCEDhAAAUFDC.aACCQGAHhABAdFACNAEH.DIDAACCAOCHDhABA.KDFCXCBG...hADAIGHB.ECFAhACA...,2,-54,3,57
aJYSOcdePDIQZAUCEWRHVgfbKFTMGLNXB,CEABRDBFHFDH..VBCE..gBGEKGDDFHFE.TAAGLEEEhAAABDAH.aGGDJAHFSDHDhAAAOADAeFFGhABAIADF.AAFFEGAHfGBE..hACA..MCCE..hACA...,2,-30,-16,14
VIcUdLWGKAbSEgYaBMRHQPDJFfXOCNeZT,SEEEEDFH..aFAABFBDRACDHFDBDBHFFDCFOCHD.CABCeHFAhAAAZAAAVGCE.UAEChABALAEBKFGG.AIAAYAHDhAGAMAIB..PCAHfGBG.hACAXFGGIHAF.hBAA...,2,-24,-13,11
JHUGKNFDcdZaPbXCeQMTROgVIfWEBLASY,JBCGHCCFGDDGFAHFDCBDZEAF..aHEC..XAABCFFE.MIAGhADATCGG.RFBGOAAEhAAAIHFD..EAEAAGCESAGDhAEAKFHD.cGGF.PDHFhAFAeBFF.....hABA...,1,-19,-22,3
HQSKUdAbZCWcRgBPXTFeVIJaYGDLNOfEM,CAHDREBGBEHA..XDAAeBBG..VGEGJDHFGFCB.DAAGhADANAFE...OAFDhAEAEGABQBGFKBCAAEEE.hAFAZCAC..gGFA...FHCChAIAaABA.....hBAA...,2,-30,-23,7
SdULARFZTPfEOIHCYbBNMaQKJeVWXGgDc,FAADZCCC..TFCDEGBEHCFC.CDAF.BBHCMAFEKEAD.JACG...hAAAeAAFXGEBDGFDdGGFhAAAABHAPCCF.IBEGhACANIAD.aHGAWCHH....cEFAhADASBEA.hAEA...,1,-28,-31,3
JSVeGXcACLYfBOaTdMIUPHZWRQKgDNbFE,LDECBFAFOAADaFFF.dGDCUADAHADGZGACRGEA..KCDFDCBD.FBFASEFAhAAA.eBGHhACAXAAGAAHG.fEHChABAMECD.PCCH...gGEDhACA..hAGANCIEEGAF.,1,-19,-24,5
FRKeXVAdLIWcMBYSZCNJUgfETbHPDQGOa,LAEE..cGGFBGECSEDGZCFHCCBB.UCGEfEAChAAATBAAHCDAhAAADEDFQACAOHFGFGBAhABAeDHBAGGA.dGBGMDADJEEBbAEA....hABA......hACAaDBDKDDC.,1,-10,-16,6
RYJgdPNKLZcIbAXEfTDVOHQUWGMFeSaCB,EBEBDCFEOCACUABAGEFG..MEEBFGCE.eDFACEEC.BFHAJBGH.hAAAdEAF.KGABLFHHhAEAZACE..IAAFhACAAHAFfFAGTGFGQDBEaAGE..hAFAYECBNIBB..hADA...,1,-13,-30,17
DfRcPdUGMZgBKJXCbAHSYeLIQaNWEVFTO,HFDFSGHHLDAHQBBFaDGG.ECGAFAFF.DCCGRDDDdDAAMBBEhAAABAEDKFGD.CAHGAGGDIBHHhABA..WGCGhAAAOHAC..cDFCUDDD...gGADhABA...hACA...,2,-20,-20,0
DeFUIVdOZNWPXaMbBKGATQEJgcSRLHCfY,TGECQCEB.JGFASBGC.HBAACBBBDEADeEDEFEBHUADHhAAAVFAEOADAhAAA.NDIE.XEGEhABAMIACBCECAEGGEHDC.RCAGLAHFfDBH.dGGAhABA..ZGAE..aDFAhACAKEED..,1,1,-5,6
aMBfNKSFYdDcXPAHVIEZORTJWGeCgbQLU,VAGHEACGREDC....JBAFGDBA.CGDAQBCELHAEMDDChAAABDAHKHECFEFH.dAAEXCGDhABAAAFD.IBFAhAEAOFHFeHEA.gGADaECHfHGFhAFASDGGcAGFhAIA...,1,-10,-31,21
UQKADSYIRFVaHNeOdLXTBGPWfbMZgJcEC,SGGBREGBFACHHGAG.eEAGLFBEBCCFGDEA..WDAChAAAMAFCZAFCJAAF.EEGEQGEAhABAAHCE.ICEDhADAaCGAOHDCdDGF...TADB.hAEA......hAGA...,2,-14,-13,1
OYgDWZbQfVPFIHSRUGcAJTLeEXdMaNCBK,TAAFeECFEGGH.dAEBMDED..aABCCEABKHBGOFEG..DCCF.hAAAZFFCfCEGhACAFAHBSDCHRBGB.UDGDhAAAAIEEJDAELADGBGDBYHAA..WHFGhACA...bFAG.hADA...,1,-15,-19,4
JMDXbeFSKUTaHNfICZOYLBPgQEcdRWAGV,JBEHMFCH.DDGGeFHH.FFFBUAFH.HDAH..fEAFhAAAZEGDLADHBGCCPFDChAAAEBCFdBGC.AIBC..XBABhABASBBAaEHBCDDG...OADAhACA......hAHA...,1,-25,-26,1
fObMaGXUgFNSRIQBeKdDEJCZcHLPYWTVA,OAACaECGGAFCUBGEFHFA..RGCABECGKBADDCIH..EGHDZFDGLEAHhAAA..WHBGhAAAAFIHMADG..NDBF.SEEEhACA.QBDHeBBGCAHHPEABhABA.....hAHA...,2,-30,-22,8
ecQWdTVZYFAbIKfOHMaNRPBEgLXUGDSCJ,KBFHOAEDMBCFREEABHDELDDB..UCBHDACC..CGAG.eBHBQFGBhAAAdGHEZAAEFGAHADIF.hABA...IHFFhAFAaEBD.EHCG.XDFG.SBDChAGA....hAHA...,2,-33,-32,1
SXdHUcNfTQEWKJMFIaRPOBYGbLeCDAVZg,ZEEFSHFEHEAGUACG....cDFHTEGB.EAGFKAACFCHFhAAAaECD..OBAFhABABBDHbGBCeGAG.CFDADIBEhAFAACIFXAFE.fDBGWDDCIHHDhAGA.....hADA...,1,0,-43,43
KEQCSMJBUXfAbYecLdDVZRaOPIWgNFGTH,eAFCdAEGZBCFREBB.OEFA..PDDD..IGDB.hAAA.WFFANIAD.TACBhABAEGGGQBFChAAA.MCAHJHECBBHDfGFGADIBcCAGDHACgBABhABA.hACAFAGAKFAF.,2,-31,-10,21
NEXQgAHLJMRBdIcPOSafbFKUYCTDeZGVW,JFBFBEDH.dHFB....IAGGOAHDaGAEFCDC..UFEHCCDCDEGBhAAAZABE..GADHhABA..NIED.QCAEhACAAFCCLDHHMDEGPCAHfEAG.hAAAKEHB.eFEFEDGD..hADA...,2,-29,-25,4
OWaIBMfLCSYHeFJcUERXGgAQZNdKbTPVD,QCAEdCDGKBAG..TGAEDHEGOFBG.aBHHMAIF.LCFDhAAASDCEeABEhAEAFAFDUGEAXDGChAAAAHDANFAD.bDEH..WAGBBABF.fACHhAFACHHG.YHAGhAHA..cDGH,2,-26,-19,7
XLFMUJaKdeAVBPHTCIRfcDgYQGOWSZNbE,BHHAHBACCFGGRBCHDAGC..QCEFGCFE.SGBAZCAFEAEBLHDAhAAAMBEGaADGeFABhABAAEHETGEA.IHHDhAAAfEHA.gFDGWFCC..hACANIAB......hADA...,2,-22,-11,11
XNcCWBRDGSFgMaIUHPfbJTVdAYELQZeOK,EDEFQDEEZBAG.OGBAKGGD..XBEECCDHBBCADIDA.FGGGhAAAaDAEHBFC..fAADhACAbBAF.TGAGhADAAFAC.eDHD.NDDC...cGAChABAWAFESGEHhAEAIEHBPAEG.,1,-15,-18,3
gCPWXIRDEfYBJNLQacedOHASFMbTVUZGK,FAEFMFFE..VGCGUGDDGCAFKEBG..CBCF...XAGBhAAARBABDAGE.EBACBCHFLFFAhABAQADGaGBBeECChACAOFAHAHHFSBFH..TGGGhAAA.PDDA..hABA...,1,0,-38,38
ZELeVbHFTDOPdWXcAJKMRYUNagQfBIGCS,MHACREFDUBAD..aBCBQFCABHHB.GDAASEHFZCEEEAHDhAAAeBFD.HEDEDIFA.hABAPFACXAEAAECGKAAFhABANDIE.IDAE.......hACACAFB......hADA...,2,-18,-15,3
GRKBDTHEdZcCANgWUYfMaIVJXLeQbOSFP,...NIEF.gCAE.UGCGfABFMBEB.aFHDJAHFeFCEhAAAQGEEOBEBPDGDhABAKAFFDEFGEGABdHBBCFBDhAEAAHHD.IAGF..XAAESCCHhAFA..FEAF.BCFHhAAA..,1,-10,-22,12
fWNBMZEIPVHGedgJKaUbAXQcRYCTSLFOD,QBBDRABCCGCA.LGACDIDG...fAFCBGFBEAFE.hAAAPHDEHEAGeEEFhABAJEFAKGGHaCABAEAB..XDBHhAAATCDDFFHFOBHFMBIHIADB.hACA..dDEG...hAEA...,1,-2,-28,26
JGDOMICdFUBTWfbNXSAKPeHgRYEZVcLQa,eAFEHAAHRCFEEDBGZACHLBFHQGEBGAAFMEAHdHFD.BFCCTFBGhAAA..fEGChAAANEBBAIHC.KEEDYFFChAEAaCHFDEAHIHDF.CGHB.WBFEbEAD.hABA......hADA...,2,-6,-3,3
BbSOUEHMJZPFDGICXNATRaVQLYWKegdfc,aAEFQEGFLCBEKBEHdEECBGBE.OBACHGAAMHEA.JCGFhAAAFEDHDIGACHBDAGGH.RAGH.VDBHhABA..eEAFfABFhAGAbFED.SGGE..EABGhAAA......hADA...,1,-8,-27,19
QBDYVagULfNRMAbOHXCeEdJPZFIWSKGcT,ODCDCADCdCEFZAADFEHH....SEBDKAGFGBAA.QFEGhAAADEFDaFDF.LHAGhABARAFGMIFC.AAEAXCEDhACA.ECHBJHACIHHDTDGGBDCF.hADAYGFG..hAAA...,1,-8,-36,28
CbHFVJfWPQKYaLEUBNGZOIgMAXReSdTDc,eACFSBDDDFAC.CGCD.FAEH...JGDEPCAD..QAGHhAAAaGDFUAABBGAFhABAZDGFOBAHMBIBAECDRDDCdGAAhABATEFF...HAFH.fHGDhADA.KHAA...hACAEDEFNIEF..,2,-25,-7,18
ICPOXJLGUWbSHFTZKdVNAeacBYQEfgDMR,eECABGBCQGGCEGBADBFB.RBBH.CDDC.OEEBLFFEGAEFUABEhAAASHAGFEAHZGEEKADHhAFAVDFE..AIBE.cDAHhAAA..fAHCMABG...hAFA..IDHBhAGA...,2,-30,-6,24
UNEgfTWBLadOQeFbHMcVSPIKZDJGCYXRA,UEEFEAHF...TBDHLEAG.aHFCdDAFeDHDHFGF.VAAAhAAAPADFKDHH.ZABBJHDCGGAHhAAA.CFFFXCEDhABAAGCDfAGBBHHBFBGHMAGFSEAHhADA.DDDD....hAEA...,2,-15,0,15
aIVcYCLHbOSANDEFJTPBKdgXWUGZQRefM,DHCCJFECBFCFdDBH....XEFFUADEZCBCeAHD..MIFEhAAAaAAE....IHFBhAAAVAFG.CFAEHADGhABAOCHFAGDEEGADFABCKGDA..WCDB...hAIA......hBAA...,1,-22,-38,16
gUfXQDGcNJVPOHAEMCdTFaZRLbWeIYKBS,MCAGTBEGFEGH.ZCEBRBBFLEDH.eFAAIGBCKHGEBEAGhAAASAFEUDGD.XGDAhAAADBHD.NAIE.PACAhABAHDAA.AAHCCFHGaGHD...bABEWFFD.hABA......hACA...,2,-21,-14,7
FRdAJIKaUXZNOCebHVTBGWfDQPScgLMYE,JFADaCCAZAEF..CBDAHEDCBDAFGEGG.DCIFPFCH..hAAASBHFLHFCMADGhABAEABARGBAAFFHKCCFXEBGhAAANBIE..eCAH......hACA......hAHA...,2,-27,-25,2
GeFWdQRKVJbYTPcOIaCZSNBUEXfAHMDLg,MFBCDHGGGCEGFBEE.dGDCKFEA..JBAH..TCAHOEBCaCCFZAEChAAA.BCDEUDGF.EABAhAAAAAHA.LHCGeBHHQGAFhABA..bFAC.....hACA......hADA...,1,-21,-26,5
EOCBPcQGeLRUXFHKJNTdgWbYfAZISaVDM,SEEAVBED.DGCCOEAFBDHG.QAAFLAECXBAGhAAAHFGHJHCC..NAEF.dGGDhABA...gBEAhACAWCDD.bDAEfDGHAIBAaFBHMIFECGFG.cGDEhADA....hAIA...,2,-21,-20,1
XBDOaMGRZCYbHWUTJSAfFNcPIgVdQLEeK,FGFG..NDCD...ICAEdEGGQECGeEAFBDFHDBAHMHCEhAAAZFDF..CDDFHAEHUAGFSFAHhABAAIAG.hAAAfBDFPCHFgABE.EBGAhADAKGHHaECHYBBDhACA.WHDA.,1,-15,-21,6
TAgXcIdFZSWDNKGfaEQPMbRJHLeBVOYUC,XEABdEBDSBGGDICC.GCCH.aGFBPEFE.MDDFhAAARBACJHBGHABEBEGEOAFGhABACHHAAGHF...IGGHhADAFGAG.NCDF.fADFbEDDeFBH.YAAEhAGA....hAHA...,1,-4,-29,25
JdPSeOaEQFDCbWYRgKcINXfUTGBAMHZVL,MEBCVFDE.dEHE..SHAGeCFH.EDCADGFH.CBAB...bBFChAAARAEHKHAC..IBADhABA..NAADfHCHhAGATDFBAGAELDHH.JHFGaGGHFDADhACA.YADE.hAHA...,2,-43,-1,42
KbeCDILfcMFAQBGXgWTEaHJVUPYRNZOSd,BECAXCFF..TEFBaADC.HEDFJCAA.VBGFUFEC.RGACZDCGhAAASDBF.KGAGhAAACAGDDBAAIAFH.hABAfABEMCIHFEABQGGCgACBEFHFhAEA.NIED....hACA...,1,-5,-19,14
CFMIaAEWQSPDRceLYKBgNVUXbGfHdZOJT,QCECDBCDREBDLADABHDD...NAAH.UDDFGCGGdDHGJGEEFBBB.hAFA.MDDHAEAH.SFFBhAGAeAAH.KEBHXAGDhAAA..fAGC..hAIA.OFHD..hBAA..CHHC,1,-25,-38,13
ITOXKAYUbGCLPNgZERVSedMHDcWJBQfFa,UEDACCDHLFCE..PAEHZBAGEGAERABD...eABCMIBADGGF.hAAA.JAHFBDEH.QGDChAAAfGFAIAHGhABAXFABAFAC...YEHD.hAFA.NCIGSBEEhAGAdDFAWBAD..,2,-36,-18,18
KDIVSCeMEBTRJgUNfXWOQPcLAZHdFaGbY,ZEAGHEFCdHBFFDBHGFDFKDDFDBAE..VAAHCAEC...EADBRFCAUGGDhAAA..NEIG..XCGFhAAAOAGH..QBCHhABAPDDAAHHB.aHAA....IAHDhACAMBIHBHDH...hAEA...,1,-18,-20,2
GaTHcCXLUDQfKSbgRPIdAVeFJBNMEZWOY,eHDCBHGEMBIDZEDCOAFAGBDD.HEDECBCHLCAHDACHKDAA..SADChAAARCGFdCEDAAABFGBFEGADhABA...aGBA.XGEHhAGAfHGF.......hAHA......hAIA...,2,-25,-18,7
ZBYReLaASIcbKPODdFNGfJWVXUgQHMECT,SCDD..IBEEKEHDDBDAFBHFNAHEGABA.JFABXGFChAAA.QGAGhABAMFGHEFDBCDEETCABhACABDAGeFHBaFDDbDFF.dAFEfEEEhAAA.....WAFBhABA..,2,-26,-25,1
EFCJDWMGdfVRLOBXgIZNbcSeYaKTQAPHU,HDAFUDAEFDEACEGBDBHDGFCD..dCDBRAAEBGHHXFFD.ZEDB.hAAA...NBHE.SAHBhAAA.eACAhABAKHAGTDCAAEIHEGBCMAGBfAEG..hACA......hADA...,1,-18,-38,20
BfGeWQgJKbacdXDZEVYLTFMHSPAUOICRN,OHACCDCCBAFDGEGE..eDEBQABEKBGFaADDdDAGZFCBECFEhAAALFHBFEAC.MAAGhAFASGAFAFDCRCBH.fDEEhABAgGFAcGECDGAE...YBHHhAEA...hAGA...,2,-23,-10,13
HXeQKNYMEPbUAFJfVCgWDcSTaZGBIOdLR,JACEVCCG..CGCC.DFBF....SGGGaEGHGAAEBFHEOHFAhAAALFBDHAFCXDGFhACAQGDHNDAG.MCAEhAAA.EDEGUGCFAABH..gAGEhACAWFCE...cDDHhAIA...,2,-40,-4,36
RHPbYEaQWMLKJOCGUNeAdgcBTSVIZFDfX,dAFFBBAASGCHZEFHFFDE.DGIFREAHHBDF....bEBGECHBQEGChAAAMIBALHFGhAAAOBDHCADF.UBAFADCD.hABAcCEEIAFDfCHG...hACAYFFFaGCCKAHH.NEAE.hABA...,2,-26,-10,16
PZeWdNIRTCUSXDJVYMHEQabfGAcBKLFOg,BFFBLFHBOBBGZEAHeECEdBGD.RAFDUBAEDGAH..JDDH..MACGhAAAQEAB.hABA.bFDEAFHAKHGEFCCAPHDEhAHA..IDGBCDHA.XBDAhAAA...YHBChABA.,2,-53,-5,48
ZGSHgcFVCWaOfDAYEbTedQLMKXIRBUJPN,EFBETCCBdHDBLEEE.KGAGIFAHBBCD.JHFAZFFFHCEFhAAAFAEB.CHCGOADCDCABADFE.hAAAeBHHMDBA.RAGH.NGCBSBABhABA.......hABA......hACA...,2,-28,-14,14
QUbDafLPAdBJNHVgFcMOEXZeGRTISCWKY,dCGBJBFFHCAFFEDA..MACCOEGDZFBFGBAHRGAC..SAGBhAAACAGA..KFHBUACDhABADHEEaHFEfEEDhADAAGECBGAD.NIDH..cEDCEDGF.....hAAA......hABA...,2,-33,-12,21
cOETPLYWHUFeRaKCQDXAIfGgVdbZSJMNB,GECBdAFEZABCMEFEBFGAEBGDLCAGHACEeBABKFDG.DIAAAFBH...hAAAICEBVGFC.JHEEhAAAOHBG..TFADhABAPAHF..YAFC.FCCHCEAC.hACAXDGE..hACA...,1,-10,-21,11
TcALYgaQXUfVCFEZMWeGIDbPHKRSBJNdO,LABAaGGG.UCAACAHBEEBBZBFD..MICEeHAEGAFEDFDHHFFDhAAASFDEBHEFdDEGTAAChAAAABID...QCDDhACAfFABFDHFIHHDPFABKADAhADA......hAFA...,2,-20,-11,9
HeMUVGPSJXbDLAdCgNTafIFOYZBRWQEcK,dCFGCGBD...TCACaABHFGEHOAAC.ZAGDBFGHRGBG.QADChAAAKGFG.HAGDMIFEhAAAGDEHSDCAhACA.XAECLFAFAFFDNFAFIHHEEEGC.hADAeFCB.PDBAhACADGAB...,1,-2,-21,19
BWVQUacMdgFSTJDHOYXGbReLfICNEPAKZ,BFFAVEED.UFAG..aBAAdHED.FBAEJFBFHAGH..OADDhAAAGBDCRAGFLEHDhABACDBB..EEGGACAFKDBB.hAAA.WADCMAFB.SGDDTFCF.DIGAhACA......hADA...,2,-25,-23,2
XFEYNDVfTRLaPMbgcQUGCAKBHZWdJeSOI,HBEBdEDCSAAEXBBGEGEHDIAE...TEBEaHDE..MDDAhADAgGBGQBGFhAEACHHHAEEHKEGGBGGGZAGHeBCAhAFAFACENCAAfFGB.PDBFcGGBWEFChAGA.....hAAA...,1,-5,-13,8
HPCAZbOYRSTNEaFQcKLXfJDMdeWgUVIGB,ZDFFOFACSBCH..NCEA.EFEBaAHDFGCC.KCAELBAChAAA.JDACMBEB.eEAChAAAgGGGIBGBhABABHFDCHAAAIHA.RAEDTDFBXAEBdHAD.WDHHhABA......hACA...,1,-20,-21,1
TAeBXVcYHfMUbFgILPSQOEaGdDNJKRZCW,BAGGXABH..VEDDHCFEUCBFFHEELDBB.QEGAhAAAEGGFdCGAJACGKADB.hAAACHBFADAHeFBH..fDDGhABAMCIH.bAFEICEA.SBAFhABA..hACAaFAB..,2,-37,-5,32
VPFXSaJcObBIHRDMfQEULTYKCdAeZGgNW,ZCFFGCGE..NCAB.VDAG.FADBaGBB..JHBAOHEA.BADEhAAAIHHADAHDMEDHhABAQEDHLFFAKAFDhAAAACIBeDBC..WAHBSFAC.hABA......hACA...,1,-25,-32,7
bLFJBaWSNcECIYTHfAOKRDUGeZPdVgXMQ,RDAHGACDZFDGdDEC..VFGD..MAGBLDAFJACE.aEED.SCDDhAAAEAAA.CDGD.hABAICHATGCHfCGBhACAAHGFDDDD.eBBBPEHD...hADA......hAFA...,2,-37,-13,24
NJEcLbRYaWPKCedUVQHGMIZOTFSBXADgf,DIEE..NBDF.EDBALEEHREEB..aAFGKBBBdAADQDGDhAAAHBFCMFDFOFAA.SDDChABAABDDfEGFhABAJHFE..bGAGPEABCDAD......hADA......hAEA...,2,-25,-18,7
PgWGUIbSJLKAQYBdRDZENMaVFXeTHOCcf,BADGDAGAZBFEEECC..aHEGFFGG...eGBGHDGDCGEB...fEAFhAAA.PEDBhABAWCBGUAGC.SBFFhAAAKCBGAGBAdADHMFIF.....hABA......hACA...,2,-49,-22,27
WEeGAJNCHfBSTDOKXUVPgdcbLZYaRIMFQ,JCFFHDAABHCEDABBKEFB.UAGD..VFGDdCCHLFDHZDCF.hAAARFAC.FEBD.QACDhABAeFHFAADH.CAGD.fDHChAAASHAG.OBHD....hACA......hAEA...,2,-36,-22,14
RbgYCIEDZGTPOdMaWNecFLQJUAKfVXHSB,KEABXCAABACERBDA......YCGDIEFA.DICCTACEhAAA.dFEEaGGHNAIA.hABAFABHLFBF.hAAAQGGDAAHBHCGHSGAACDECEAFE..hAEA.PDDHMDDHWEAFhACAeEHH..,2,-40,-2,38
gAdDVIRXGHYeFBWfJOLZcMPEKQCTabSNU,dDDGVFABRGEGHCFF.eFCDFBCFBHGG..fCACLAFCMEEAhAAAEBHBKBEHQFFDhABAaACA.SFDBhACANEICAAFCDAAD.IDACXBBBYCEAhADA.OHCC..hAEA...,1,-6,-23,17
CgAYeVJUDKOaSQRBXZGIMWTNbFPHcLEfd,VAEGUFFDDCFG..aFEBQCBE.BEAHZAACMECA.hAAATGFHFAECHGAEECHFCDAGhABAAIFCeDFC.KABDSHAGhACAXECA.WCCG..NEIEcAGAhACAfFGB...hADA...,1,-22,-26,4
HBdgMSUaVcWXZRfTAbIGeYOKQECPFLNDJ,GCBDeBAGKEDGQDGE.CGDBFAFDNGCDHBFAdHGD...SHDChAAAaAAC.VDADhABAXFEFZADD.fHBHhABAAAGGIHBEEFADDIFEBAHGMEIBcEAFhACA......hADA...,2,-20,-12,8
WaTZLOQIbEMeXGfPDKFCYcUNBdAgRHVSJ,HECCVCFG.SFAF.aCGHZGFCQBDHIADHEFABMHDAhAAAGDDEDGFEKABBFBACCCHG.hABA...UGBCBFBBhAAAABHG.gCBAJDAAWHFAOAEAeHAAfAHEhABA.cAEDhACA..,1,-9,-11,2
ZEXILYBcaDKVHSOURFTPJeQMbWGfgCNAd,EAHDXDDALECDBGEGDDCAHCAE.UEAHRAAEFHFE..JCHFeEEHhAAAMICCGAFC.CFDFAFHHhACAdABHZFAHIGHAhAAA.aGGHSADHOGAC.....hACA......hAEA...,1,-12,-20,8
VEaPgLJIfTZSQANCYHRDOUbFcWdKBXMGe,CECCHEBFDEGB.ODFC.UAACFBBDdEACBHABGGCHeCDB..aDADLADHhAAA.JAHHIHFAhADAZDGF.AIHANAEF.hABA......YFFE.cGCEhBAAWBFFMIFC.hBCAEEEB..,2,-31,-29,2
DFKNYSILfXCTbQMVEJZcPUHgOeRGdBAWa,DBBDFAGCKACE..SHBELGDECFHFQFEF.ECGGZDEGhAAAUADCOBBH.eEBHhABAdDEDBAHAAHHC.aEHBhAAANIDH.fGHC.TDBHMAFB..hABA......hACA...,1,-30,-34,4
FcVIHaJgEYLMdTGODCQZNABXRUSbKePfW,BFFEXFGHRCEEUGBFKCEG....eEEF..PACFFBDBVFAEhAAAHCAD..JBAFEGHDMAEGhABAdAHE..OFEHhAAADIDGCBBB.QAEDAIGC....SAHHhACA...hABAfDHE.,1,-16,-23,7
gdZBAXPOKTMCfGHaIceYRDSELQUNFbWVJ,XCFBOEEHKHCA..MBBFCAAC.HEGH.aHDAIDFF.hAAAeBDCDBIDSECChABALDABUFFEFGAHVACHhACAJAHFZBBHAAFBfEAG...cFEAhAEAEFCFNACD....hAGA...,1,-15,-19,4
YaUEZKQHgcWNBIFMJPRfVCSbGXTAOdDeL,OGBADHGGLCBBUBBEZDEAQGBH.HACA..cAEDhAAABAHCMFFF.JDEAhAAAfGHACBGD.hABASHCAXEGEACAFYCAFKDDF.NAICFFFFhABA.....hACA...,2,-24,-23,1
cOIELedVHBWCYSGgUJAFRafDMQZPXNTbK,FBFBREBDDGECMHEEZABD.....XEEGTAGEKEEAOBBD.EGADhAAAdHEBBHCECAEE.SDGEhABA...hAAAgACBAIACaDDGPDHDNAEF...IGAEhABA....hAGA...,1,-23,-41,18
KQcaYOXSAIdgCeLWJPGbTFMfEUBHNZVRD,dAAECGDFLEACJFAF.GAGGFDHF..MDEFEEEBBFAA.ZBCEDBDHhACAKGGCQFGDhADA..aAAHOCCHhAEAAIEC.IBFEeADC...PHCEfHFBhABA..NDFA..hACA...,2,-30,-29,1
OFEBSZfTVdbDCQGHePagMURJKIcYNWALX,XEEBEACBZDDD....VFFEDDDFCHCEQAEAGBAEHAFGeDFAhAAAaFHDUDADKCEG..IACEhAAANHBD.ACIBFHFChABABBAA..SFAATAGB....hAEA......hAFA...,2,-20,-12,8
ORTAWcbBUGLVHDFKgQSJXCZIfENMPeadY,...bEEFBBGH.LGAEDAIDKHCCQACCSCBFXDFFhAAACGHGZCFA..fECChAAANCIG.PCBBhABAdDCCRADDTGGA.AFAGWEEFcAFA..hAEA......hAHA...,1,-26,-30,4
gXQCJMScDFPfYOEZeGLWRNbTKIAHVaBUd,aAECUCGD.dAEDQCCA.CEHBMHAASDEF.FECHfFDDhAAAEBACZFGHeCAAhAAAGCAALHACNIBDbAGFKABHhABAAFAHBFEH..gFFH..hADA...JCFBDFIH.hAFA...,1,-6,-24,18
gBWQceEXCIVPSNRATbYFGUDOLaKdJfZMH,TEGBFFGEUGCC.LBBHdEFCZBBHHFBB.BFDHQDFFhAAAEBDDCAFB.VAFB.SDEDhABAAACGbBFGDAAF.OEABhACAaEABKHDAMAID...cADBIHHGhABA......hAEA...,2,-15,-12,3
fCSIOGTgUXAcYMLNRbDJFHdQEZWKBaVeP,MDGDLDAHRDCC.DFGBHAFAdABFZDEABFHB.eHEECHBB..OHDChAAATAAAUAECAFFB..NDAG.hAAAFDCD..EBDHaCGEfCHChACA.IHCFXFDEYDBFhADA....hAEA...,1,-19,-30,11
ESZXVaMfQDGRdJAcIKOeFgBPHTNYUbCLW,KGDDFAFHBBABHBGH..TACFUDFGLEAB..SDEEhAAAXDCD.VFFBMFIBhAAAQGAD.hABADCAC.dAGBJHBEIEEFgACBPEAEhABANAIGCGGA......hACA...,1,-14,-31,17
ETPCZNGJcHKMaWDeFdIfXULYQRbAOVBSg,BDGDSCBFEHFC.CCGC.ZBDBGEDCHFCEMBIDDABG.FEAHdGGA.XDFGhAAAUAAHLHBGhABARDBFAHFD..OAFGhAEA....gEFGNBBB.KDBCWCHHhBAA.fHBDhBHA..,2,-23,-15,8
fZCYXIVbeHRDJQUWLTaSBNMAOKdFPgGcE,KFFAFACDGEABEBDE.CAGF...IGCCeHCGDBIFQAFFhAAALDDC.SFHBhABABFFGAHGCOAADPCAG.fEEHhACAXAEDHDGFJEAFWAHH.NIEFMHEEhADA...cDDGhAEA..,1,-4,-27,23
ECbWHFJRYOKcaSdBULGfNPMDITVZgeAQX,QCBHCDCFHBDGFAAD.JAEBRFGF...KAGGSFECBHDELCHHhAAAGDAA...fGDGhAAAMGDCDCADIGHHhABATCGH..gAGEXEAEEABA.hACAWEEC...cGAChAEAaEDG,2,-42,-24,18
RLKNBfHCPJVZTIgXQOMaGAUESeWYdDbFc,UBFFEEHH.eEDFdEBBFAAARABH.KGDABADE.HEGFCBGB...JFEDTADEhADA..gGABhAAAOEFDMAFCaBAH.hABASDDEDAFA...cCFFNAICfDCChBBA...hBAA...,1,-15,-41,26
WANaGYPFKRVfbSZEXBQLTMIDCOUdJHegc,GBABFEBFRGFA...bCFESAAB.EAHHBFHA.QAFGhAAALADDIEHFhACAODDFdFBFeFADcFFChABAAGDEaEFFKHAC.fDACTAEGDDFECHCH..hAGA......hAHA...,1,-13,-25,12
fMZPSIgAOLHdbCWeDacJRUYXBQVGNFKET,HDBGCAAFDEIB.aGEF.RADF.UBEHBHCBGEEA..KAADEDDBMFFAZEAH.hACASBCFABBE.hADAOBHDLHAGdHGDeGAChABA.JAGDYAFC....hAEA......hBDA...,1,-9,-36,27
eHaDNIYEFcPKbUGCOQdfJBZSLTgWMRAXV,VACGHEEEDGDB...IBCCFEGHKBBFUAGECHHF..dGABBEDHhAAASAFELFAHTCDEhAAAMFFH..AEIH.aABBhADAEFCD..bBFE.OEACfGHC.hAEA.gGEAhAIAWDDC...,2,-32,-21,11
LbBQPDFXWHYTGMfUZeNJSaOcCKVRAgEdI,EDGDLCACBBECDFGBXAFF..HDCATEEHMAAC.UAFEhAEAZECBJFHDOHBEKBDCAIDA.hAIAdAADICBG.hABA.PAHD..WBHBfEAChADA..SHGAhBAACHFBRCEG.QFDE,2,-18,-14,4
GfHTRFZPedALKQCOWcVJXUaMYgBNEbDIS,QEFHOEFB..VEACUCAG.MHECBGHEEGBHDBAG.SGGDhAAAHABCTBFFZCACeAHHhABALAHB.CECHWFAFhAAAJHBCXAEH..aDDA..gDGGhACANIEF.IAGGhADA,1,-14,-18,4
RfTNBaKcACQDgMIUZbXFdLEGJeSOYWVHP,DFHBMFECUECBZGEEFECGLHDE..GBEFeCAH.OABH.hAAA.VAGHHFAERABE.TACAhAAABCDAKGAACHBHIDHHhACA.dAFF..SDGG.hAEA......hAIA...,2,-32,-13,19
XaJbDFUETKCeZPNfdGIYSgcLMBHQWORVA,XGBFJGDG.FEFGTABD..CECAZAGH..PCDHdBEFGCABhAAASDADLFHFhABAMEIFBACEHFAGQGDEhAEAWBEC.OFAHAHABDIBEEEFE.eAADhABA.IHGEhADA...,1,-10,-24,14
IWeATgacfECJLOYGZVPUNHSDFbQBKdMRX,TGEHaDHB..ECCFCFBCLABDGECCZEAFUDGDHGFG.DBAGFAFBBAHGhAAAMAAB..RAFBIFFDhABAAHBA.fACBhAEAYDDDNIAD.QGGC.XAGDhADA.WEAFhAEA...,2,-30,-7,23
CNDATXgcPabJOUVWEfMQYdGLZFBSHRKIe,TCDCXGAE......PFBAbACFUGGAEGEA..QBGFhAAAdEEGGAAGFHGABFBFhAAAHBABKAFDCEGHADIBcDFAhAGAaHAAJABA..OHDG..WAFCMAIDhAHA......hBAA...,1,-3,-17,14
UZHWLKaVNOQAEDJebSFRCYXfMPIdgTBcG,DCGDJEFF.eAEDFDDD.RCAC...CCFG...XGGCMBDA..dHDDBFEDhAAAUGAFZFBB.LAFAhABAKDGA.aHDEOAAHhABAADHBEABC...SCBAfEEBIEADhACA....hADA...,1,-20,-50,30
NcJbSTYeHQLWMfVFDKZgCBUdGEPORaAXI,XAFC..cDEFJDDE..SHFATFAFHGDEQDAEhAAALBDAfGEFhABADDAEgAAAhAAABHAHUACAEAHBPCHHREFGACIHNGAB.bFFA.eEAE.hAGA..MIAAKHCGCBBF.hABA...,2,-5,-3,2
MOIVFUHKeCPBTRafcAgWdLSZXQEJNbDYG,dGFASBBFQDFFEGFC...JAAHDBFEGBEBMDDH..OHFEhAAAIDDAUCFDKADGCEBCBADAhABAaFAH.AEEHLFFChACANDCC..YFHFFHAA...eDABhABA.....hADA...,1,-13,-26,13
IEQZGcWRANDUXVPHYaJTBfFMLCSdOKgeb,DIFEXCAFHBDGaEEHBDCD..FFABMHFGLHBCCFFD..ODHHhAAAeGFAEDGCQBGDhABAZAAGGCAHRFAEAAIDNAEC..hACA............hADA......hAFA...,1,-12,-30,18
GbeVCKBWMRPdHXgDIAQNFUJZLacOYESTf,QAGHFGEDZCAELFAAOAED..SEFCTAACGDAChAAAeAHBKHGEBFEH.MDIHhACAdABHXBEHICCFAHFChADA.NEDF.aECGEHCC.fHGHCHCE..hAEA......hAGA...,1,-12,-22,10
OAUPGMbCQHXESFKgaRVNLDJITfdeWZcYB,UEBDGDDECCHB.HFBF.SDGC.KACARCDCNEFCLGFAhAAA.IAFGfGGAhAAAdEACZCACBEGFAAIBMIFEhABAQGBDXCEFFABBaDABDAHD.eACH.hACA......hAEAcAGB.,2,-29,13,42
UePQSTNAgVBFGZYKLEICJfdHcbROXDaMW,VDFDBHBHFABB.GBDEKBEHLGCE.CABC.dGDCHDAARGECOEAEhAAADADA..aBCH.UAGChAAAeAEE.SHGAhADAAHDE...gCGCEGHH.fFGDhAHA..hAIA...,1,-23,-32,9
IbEARWgeMSBNDCadVKUcYLTOJfZFPGXHQ,REDDeBFDMBIDBGAB.CGCH.dHGF.KCAHUFFALDGD..OCBAhAAAZACCFGABGDADHCCA.hAAAIABGAFAC.SAHFhADAaHBE........hAEAYAEC..hABA...,1,-24,-34,10
GQaPeOTSdUcCZDIVXABKNgJFWYfLMRbEH,KAEEJADC.FAHB......fHCHMFEHRDCCEGFHHBFG.QEFAhAAAaDAB.eCBHhABAOACBTECHdGCGCHHGhAAADCABXBEEAHAHBHHD..gBCBhACALDHH......hAGA...,2,-21,-20,1
fCXEKWPcQZJBFVYGSaONTeRILDAHdbMgU,dAEAMFHHUBGF..CCABKCGE..PEEFZCEFBDAGFBCD.GFADhAAAOAAAeCCB.RABEDGGBhABAADHHHEBB...gGGChAGAfGECEHAE....WAFEhADA......hAEA...,1,-23,-31,8
fcdWHeGEAOCQYLbDVZINKXaBJSPRTgFUM,CDDELEHDDCEA.ZBEFKFAFBBCH..SFGGTBGD.FEBGUGBFhAAA..MAAAfBAHhABAdBBGHFDBeECEhACAAICE.OEACQDGB.bAEEIGFChADA.NAEB....hAEA...,2,-35,-13,22
DYQKNLdTeSAEOPWUaRFbXgfHIZJVCcMBG,OEBGUDBFRFFE.FGFD....XAFFHAEFIDHFZCDH.CAACBAGDhACADACHKFBGLFEEhADAdHCDSAAFAHCHEBBDaBDHhAEA....fDHG.cADAhAIA...YHFAhBBA.,1,-21,-44,23
RMDFJLIUKcSaGCWfXEdVBZAHNOTbgQPeY,HDCDOFBGTAAC.QGEGPBBARBEE.MAIFDBGE.FBFDJGEE.hAAA.IFAEKHAG.hAAASHBCCCHA.hABAWADBEEGABGAFAEFCbEFEgCAALDAE.hACA..aGGD...hADA...,1,12,-32,44
WeBNOKcgRLXCEPZUJaYMHFGSdfbIVDATQ,QGAGeCCFBAEGOFCCKBBFRGDG..LEFGCHAHZAFF.UBEFaGGA.hAAAMAEC.GDABhAAASHFG.dEFDIHHHhABADABCABBB.WACB.....cCGDhAIAEAHH....hBAA...,1,-20,-33,13
FNAbQcGIeVSBMEdfTaPHgOJULRXDYWCZK,QCGEGCABeAHBBDFDMCGFdGBF.aGFEHGAA.JHDELCAAhAAARAEFDBCC.CAEAFAGAABAAIFEBhAAAEEAG..TABDhABAgEAEXEEG..WDGH..hABA..NIDH....hACA...,1,-11,-14,3
IDXVBNGEAPOdLfFUcYQWZTgKaRHbeMCJS,dAFHLDFAFHEGUDEFQCAC.ZECHKDBDaGHBRGAGHFFC..hAAAMADASACHhABAXBFBBCGBNIAD.ADIH.fFFAhAAA.cABHWCAF....hACA......hAHA...,2,-33,-22,11
ZOgCJLcFDQVbTBYSWRIKfEeAdNHaMXPUG,HFBCXGEDGCEFZDBC.OAAD.CAGGLFFEDDIFVBBCBGDHhAAASEBCRFAG.KADDfBHChABAAHCDdAHAMFAF.hACAPHECgAEG.FDFC.TGGGhADA.IHABEGGEaAED.hAAA...,1,-6,-7,1
CVHZADSGObdgaEeJTFYNfUQPcKMRIBWXL,DAEGSHCGOEHF.dFDC..EABAJADFFEEC.....NBAC..hAAA.QCAGhABAKFCARBGFBCDCLFGDHGEEAHAG.hAAAgCFBaDBB.TFAFfCEFhABAPAHFMIBCIAFFhACA.WEEB.,1,-17,-21,4
LIOVUFNfdGcaXYeZBEQHTCWJDMSPAbKRg,KFEFLBADOCHDFFDG.dCFAGACA.aEBBeFHB.BFBAQAAGhACAHCBACDHHDIFASGGBhAEAABHC.gAFChAFAIHDENAAFcCFD..XGAGhAFAEGCD.....hAIA...,2,-26,-24,2
RdOFcDMLaeTCQbgAWSEYGIXKPVHBJfZUN,EFECGEDBKEDF.HAEFBCCHZBGD..UACFRBAEdDBDFAGBMIDE.aEAHCHDC.hAAA..QGGFhAAAAIGA.SHAAhABAXCEHJFBBfGDDODABDFHB.eAHHhABA......hADA...,2,-37,8,45
PUBWKLREaCAYdfgIHVXTecDNZFMQOSJbG,dGGF..fAEAIDAFHEDC.TBCDeDBEDGEH.ZAAChABAFHAEQDFHhACASEAAbFCFUBGDBGFAKABFhAAAEAGFAHEEYACCgGAF.cEABMGAAOHFEhAGA...hADA...,1,3,-17,20
CPVDEMfBdRJKNeOaWgHUXLcGTQFIAZSYb,ZEEASGEHCDCE.DGHFECEBBEDCdBAFKAHF..OBDE.aBCHhAAAHFBFLADCTDAGhAAAFHBEAGDC...bBADPADGhABAMAID.RGEGNEIGgDGE.cEDEhABA.....hACA...,2,-21,-18,3
NIRUOYMeHQaCbXLKWZSAfJBVDTcdEFgPG,BCHETGBFEBAD.FGGHGAEA.RDGDUEBBMFCH.HFFFCGAD.XCBBhAAAKEEEZCEA..AFGG.fABHhABADAFG.gAGDhAEAIDCFOBFG...eAAGhACA.aDAH...hAIA.WDDB.,2,-33,5,38
fPLgCBSDAFJVKTNXMadUWeRQIZcEbHYOG,JFGFKCDH....TDBGXBFG.dGDHeFDB.QAADhAAAZCBGEDFCHABGOFHBGEADhAAAPAFACAHBDCAGAFEGFADChACAMDIDaGFH.UCGEIHBH....hABA......hACA...,2,-18,-8,10
CbgQIPRWeaNAdTUGLSFMEXVYcODfHBJKZ,UDEESEABMHCE.ECBE....XABGVEEC..OBHHhAAADCDDHBFGBBACKEAACAFHQFCGhABAIHGFPAEAhAAAWFHH..eFADADAHdEGETBDC..hACA......hADA...,2,-23,-21,2
cXMZHdgTANOGPWEQUDVbCJLaRIKeSYfBF,OBBDGECCEAADUEDFDGGG..CHEE.LEADRAFE.eCEF.SACGhABAfHGHFCHBhADAXEGGZGFC.dADAhAAAACDFNBGCQFAF......hABA......hACA...,2,-34,-10,24
fDPeIWZFREKaNXHBOGLcUYJgTQCbMASdV,dFBFDCCHeGBCZAFCEBBEKFAD....XGGGOGEEGACBLHCChAAAUDFCJDEF..QCADhABACDAAMEID.AHAHfACBhAEAIBAD.FEGANIDDBDDA...hAGA..YBFGhAAA...,1,-6,-34,28
XUQIgZdHBYOfSMVRKAWCeLNacTbJPGEDF,CBCDeCFGLDFB..NFAB.aAAH..TCAEJEDF.GDDHDDABFBHFhABAXGFE.UGBBhAAAQFAAZACEdAHG.hABABHHE.fHFBSFGEMDBA.hACAKBEC.AFIH..WHAAhACA...,2,-39,-2,37
PHAFQTBGZCfIDJVUYROcWgLaMEdKNXbeS,FHACTFBBBAFG.ZFDHCEDE..DCDCUGGE..OAAE...hAAA.gCDAhABAMBHBEFGHNDIAeCBD.SACBhAEAAGEBfAEDJBGD...YDADhAAA.WCDAaCHDdFFGKHAAXGEDhABA,2,-34,-22,12
YJZFLXHEegTNPQMUICVKRGAWbDdaSfcOB,DCHBSBHBODEHBFCHZDBHFBFC..HGDGEABA.eAFD..TEGDhAAAQBBBMBAFUEEChABACDABKAGGAIAE.dACBfGAChAEA.YHDGXGGFNDDDIHHHhAFA...hAAA...,2,-31,-7,24
TGORMfNLIHabSWcAQZYdVKeFPgXEUBDJC,ZAGFdCDEeDFDFGGD...XBGCEGBEBBBADGHBCDFD.GBBA.MEBHhAAALABC.HDBEhAAAaABBSDHDhADAAGDA.VFCFKFFCgBDAJADG.OFAHhAFA.NEIAIHEAhAIA.,2,-33,-4,29
eJcfCUWdBbLEOMTPDXaAFRHNSVIKgQYZG,FCFFHACH.VEFHKEFDQACGGAEA..eCHBJFAG.CEABUGBGhAAABHFGLBADMEEFDBBHAIHEhABASHGE.hACA.IAHCZDGDcCBHWCCD..dHBB.hAEAEAHD.....hAGAOEDD.,2,-17,0,17
ZQNIVGYPEMcdKUSXLgFaTHDbeBWOAfRJC,REBHZCBFQBEG..NADAGGDFEAAFMHFAKBFC.UDGELHBGhAAAFHAC.aFEADGIBeEAFhACABEEDACBFCCCD...IDGEhADA..PCABSDHH.hAAA......hABA...,1,-5,-39,34
OFTKVYQDWNRLcBaZCfGHXbJSMIPEUdAeg,ODAGTCCH.KFHFQFBC.DCEANEEELBBCBHGGZAGBCFEDHEAChAAA..JAADSFFHhABAMFAH.EAGAAFHBFAEGhAAA..WBHHaDFH.fGCA.hACAXAEBIHEG.hACA...,2,-32,-21,11
aDSdOgeAcCBXZbKHLIfUEWMFQJPYNRGTV,CCGFBEBAZDDFHDFCLCDHUFBCMDAA.FGCGQGGD.JAAFhABANAAHGBGG.aHGGhAFADBEA.SAFEhACAdAGBOFEDADAD....XCBHIBBD.hADAWBEB....hBAA...,1,-20,-30,10
McVabeTAJUXPHKNZfBYFOQSDERCLGgWId,XAFAHCEGKECEZEAFBDFBOBAA.DIFCCGABLABG.GEGChAAAIFEHMFFFaEHHhAAAbFCFACDG...UCCFhACANBIA..FAFBEDAF...WAHH...hABA......hACA...,1,-10,-32,22
aEDOMGRBUbACQWLKIZYdJPVgHNfXTSecF,CAHEQFCBKGCE.ZBDBdGHC..VDFDHEEH.XDAGeABCaHDEhAAAOBGBMDBDBHHBhABAAAACLCCCJBCB..NBIG.hAFATGACFHAC.EABCDAGG......hBAA......hBGA...,2,-25,-6,19
cQbRVBWdSUYTXZPEfMCHOKIgFDAeJGNLa,JGDAGEBFLEBFaABA..QCGGRABFBAFF.dGGBUCGB..hAAAXGBGEDDE.CBEFKCBGhAAAIHHHDAEGAAHHNIED.hABA............hADA......hAEA...,2,-44,-20,24
MWFPZQNDLeEfGHcIbdaSTVBKCRAgYUXJO,UFBGJDEH.ODCEFABHZDBB..DBCBLHAE..EGGBGAGEhAAAIBGEdAEFaFHFSADChAAABDFB.CGECAGIHXGFEhACA..PDGFeDAH...fCAEhABA..hACA...,2,-49,-18,31
dbcEYOGXPgKfDWULFNMSCARVBTZHQIJae,VCAETBBE..QEEDaHEC.eAAEbCGB...EDGBOEFDhAAAXAFAKFDCDDECUGAHhADAFAFGMIDCCDABAEABBDDGhABAIHHDJFHD...cDCEYFCF..hACA......hADA...,1,-6,-22,16
HAQLRMSeCDaEYNJPgBFIdZGcWKTUXfObV,LAAHMDEE.CHCBDEEEaEEB..EFFE..JEHDBCDF.FAECdCEHZGCEhAAAGCBEKBGGUBAAOFFHhACA.HAEAAEIDSGHHhABAeBHH..NEAE.IFCH..hACA......hADA...,1,-19,-32,13
TKPNSIQfdJXAMbeUCVHEBRGgLYWFODaZc,eHECVBDE.BEEAGDBGLECDFGHB.DBGBZEEFKAGE..SAFEhAAAQEGBdEGFXACFhAAAADAHMABACHCH.EBBHgBADhABA..WAHHOBEH.aFAHhAFA......hBCA...,2,-27,-13,14
GCJABWEDOeafNHbYXUZgVQMLTKcSdFIPR,EDHFOFBD..eAFGaAEGHGFC..bCBGXBFEZFED.QAAHhAAAMBAATEBDhAAASDDGIHADGCAChACACFDAAIGCBHHEDAIBfGDGNCAA.YFDChADA...hABA...,2,-22,0,22
HFLgcTNGYKJbdBRPMDSXQWVEIAfOaUZCe,aGCAUBCGZBEGCHDE..HDEAFBCGLEFD..gFBFhAAA..NACBGBAChAAAKBFGJFGDBEADMIFADEIFSBAHhABA..WDHFIAHDAAIBOHAEhABA......hAHA...,1,-25,-32,7
gOUdQIYMFEbWcaRKJZHPNSGDALCfBTVeX,LDHBBCFAeAGBODDCQACE.MEEGFBAEEADC..bCAChAAAaFCH.JAFBHGFASHFGhAAAAHAECFAB..fFCEhABATDACXGDFdFFF.IAHDhABA.....hACA...,2,-18,-18,0
GHSWZgNPOfIRaAUQJXTDVCMFLeKbcBYEd,QAEBTGCA.CEFELCBEKBADBHHAdFGDGDBCHCBCZGDE..hAAANDFG.OAHDRBGH.AHIBJFAHhABADFBAFAEC.eAAGhACA..cDDCEHFASGAHWFGH..hADAfDGBaAGA.hCCA...,1,-10,-11,1
ZCaNPRIeDAOFBLWUMVgGdbfEJYSHXQKTc,OFBGFDEALDCFUBDE.MIAAGABE.dGDAEABC..SHGChAAAQADDKDHDTGFDhAAACAGG.aFAD.PDHBhABAIDAA.AABHBEEBgAGGfFAGhADA.....hAFA...,2,-25,-22,3
UCdNAcYFRSWbEHMZLDIgXOTaBPKGJQfeV,FCBBSECGEGEF.HAFHMACCDGIB..XFBFTAAGaFAFBAAHhAAAKHEEGAFA.QEGEhAHAfDCDeCEDhAIACDHBAICE..REGHZFCGIHHEPADF...hBCA......hBDA...,2,-21,-4,17
BOQaGSfYNIJXWgcTeKVLdDFUPMHAEbZCR,EHBACEGCBHFA..QDDEGBAG.SDFA.NACE.JABAhAAA.gGCBhAEAeHFEKAFALFAEDDFBFBHBMCEHhAFAAGFAbBDC.OAAFaCCF.fEHChAAAIHAHXFGE.hADAcAFGdAHA,1,-8,-30,22
DAYcVbedUFJRgWLTOZSEGPBfQNaCHMXIK,VDGFdGEBUDBD.FAAGRBEDLGBG.OBCF..SFBHhADAGEADBBABfEFHhAEANICF.CAHCMBIBhAFAIAGH.AAEA...YHFGcFFH.hAAAJCDA...WADAhBCAEDACaAHDXGCD,1,-23,-31,8
PYOGUXWcaFAZCMRKTEVDNBQdJbIfHegLS,ZFFGMAEDKAGF..VAFHBCAA.dEFB..JFEC..IDDEhAAAHFAGLCAF.PHFEhAAAOABFUBBAXEAFhABAaDHHAAHA.CGDFEHAA.DICG.....hABA..bCFE...hACA...,2,-34,-18,16
YCUbJPQNMTERHeIcFDLWaVBdgXAKOGSfZ,OBBDSGBAZFDAUGAE..JFEGQADDMBEARCAG.HBFFhAAAeFAAFEHFDCIBLCADhABAaDEBBHGDdAHA.AHHG.KACEhAAAfEDDCFHH..NIBDEABB...hACAWAFE....hBAA...,1,-3,-30,27
fVdIaUTGeXARSgCKZMbONcDLPWBEFYJQH,SDBBKGCCZECA.MFEDOAEG.DABDLABGBHFB.EBFGFEHHhAAAQGFBHBEG.hACAfDGBdBHEaCBE.hADATDEE.XFAHAIAACDEH.NCAH..cAGAhAAA.WDDF.hAIA...,1,-6,-34,28
OFcBXQMbfEVHWLAKSPdJYICTURDeGaZgN,KBFFdEGBJBFGCDGF..RDCC.DECCGDAG.ZABAOACC.BFDAMFGDhAAA..EFAF.HFGBhAAAAHEHSCHH.hABAIAGDTCADaGDEFFHF.....cGAEhACA....hAEA...,1,-33,-40,7
MLEQGOSNdeHKbgXAZcRaUWBJDVFYfTPCI,ZACERFAEUCEBBCAG.DGACFFFF....TCDACDHBLHBA.GAAEhAAASEHD.hACAeCFEKAEAXDCHhADAABBDaFEH.JFHF..fEABIAHF.MICEhAAA.EFFD.OHAGhABA..,2,-28,-28,0
IMfONDQLCXaAEBRJZTGFWeUHVSKdPcYgb,ECECJEDHGAEGFGFD..UFABHBAFKADFdFGC.....YEAFhAAAIAAE.OEEEhACANDIG.DIBCCEBAAACBBDGEhAEA.ZECH..WFFDeCBFSHCGhABA...cACDhADAMAIB.fCGA.,2,-28,-15,13
XGFQUagKWPLYZIRfCDSVbMEBOJceNdHTA,XDEHQCEFUAABaGFH...KGEDLEAHZCGH.REFDfDDGhAAADBEGSHAEMBDEhABAEGGHBCBD.OHBChACAeECDNAIETFCF.AIHGFEHFWDBEYAFChADAIFAE.CADC...hABA...,2,-33,8,41
NPRFeYZfWDQgTVcMadILSKHOBCEAbUXJG,XECEJFDFGCGARAFA...FBDAZFGF.DAEDQBAG..hAAATCAEMFIDIEEGhABAKDHBBDGFAHCG.bAAGUGABhACA.NAEH.eHCAfDCHgGAFaBFDSGFDhADACDEE.hABAEGGB..,2,-26,-5,21
FYNBdAefDZHKXMTUagIPRJbSLOcWCEVGQ,DBBAZBCCKBABMHBGUGAA..aDEC....IAEDJEAD.LFHBhAAAOCAACHGEGDAFhABAFEGEBADEAGHFHGCA.hAAATDFARECESCGC..EFFD..hACA.YAHHNIBH.hABA...,2,-40,-6,34
CFPWJKIOSceRgLAQbdNZYTMDGaUBfHVXE,dAABZFGBMCCDDCFBGGADUEEA.BECCHBEG.EABACEAF..FEGC..PGAAhAAAKBCB..SAGDhADAeHDALAHHhABAABBB.NBDG.aGGH..fAEHXEDH.IEAGhAEA...hAEA...,2,-45,3,48
BQFGDcMENPHTaXZWAfKeVCYSLdbgRIJOU,KBGDCACELAABdEFGRBDF...JDGDUAAH.FCHDDFBF...EBEGHEAFhABA.aADBXECGhAEAAFDD.eCCESFHDhAFAIAHCOFDDBHCF..QGDGhAFAMIFE.....hAGA...,1,-26,-28,2
SEgWVYKNbBLZQaecDdMRAUFCXIPTHJfOG,CHDEXBGC..PBFFJEAB..ODECEACB...VAAEhAAAKEDHBBAHZFCG.aDGDDDCEhADARFABADIBFAEG.HGFESAHDhAAA.gGGENIAB.LDAChABAeDHH...MFFHhADAIECB.,2,-22,-9,13
ZRFGUDVEHKOgPaYCMJbcQABXfWeLNdIST,BEHDXBCEeBEAdABH..TBBGFGDHDHAEEGEBHEEE..OAHDhAAAaBGC.CHHF.MAFHbFBH.hABAAHIDLEAE.hACASGGDZDAEGEFG.KGAD.PADAhAHAYCAA..cEDGhBAAfAGB.,1,5,-19,24
YMfVTNZbQBLegJDcIOGaUAdWSFCPEHXRK,dBBBSCCDFAEG.EBDAXEDB.KCGDfDGH.hAAATAGAZFGHBGBHeBAFhAAADEIFIFEDaCAEAHAFCFFG.hABAHFCF.MIFGNIBF.QFAF.hACAJGFG.OABA.hADA...,2,-40,10,50
AHXKYOSgZEDQVfBUPLGaMRTIJNedbWcFC,KBHHOHFEZEGFDACG..VEAAUCDDGGBH.RACE.JDBBdAGC..hAAA...bDEFFGCAAGGA.hABAHAAD.SHAChAAAECAGfDDGLAGDMCIDIGFDhAFA.....NIEB.hAIA...,2,-32,-4,28
SMfYZPaVTCGceFRdWbQBUKAXHJNEILDOg,XDEHHBAEJBGD..EGFADCBC...OFGFMIFAZFBG.aAEGVFBFhAAAGDBHFDBBdHEH.hAAAQAFGBHAG.hABAAEGGIABBSBFFfADDYCHBCFFFhACA......hADAeAHH.,2,-29,-4,25
FESbfcMWQZUKPdeCLDIgHGXBOJYVTaANR,FCGCEEDE...SHEE..fEHCMFBAZEGHKDDAeBAFhAAACBDFLBBDgAFHhABAHGAGBGEAOAFGhAAAVEAHTDFBAIEC.NIDBbABHWFDA....hABA......hACA...,2,-23,-8,15
cPBMAQgZJNRSKLWGUdHXVCYDTOEeFbIfa,QFGHZDCCRAFDLEGBGDACHFAGCHBHDIEEEBCA..FCAF..IEEEhAAAaAACBHDBABBHJABCSHAGhABA..KFCAhAEAdBHEXAGG.YDECeFDG.fCCAhAFAMIFC..hAHA...,2,-33,1,34
VRbWYDEIMLNXacQgKUTACGdPOBfHJZeSF,CDFGdFEABAGHJDGF.ZFBA..FFAHRBEG.......bBCDDGFH.EADChAAALACC.XGGAhAAAaDCBQBABhABAKGCBABAE.ODHBeBFCSEBG.hACA.WFFBMCIDNIAF..hABA...,2,-34,-30,4
ORNecMQgIAHaSdFELJPfbYCBGTKZDUVXW,HAEFaDEH.SHACECFDLBABJBCB.....fFBEhAAAbBGBCFFGBCAEKDCBDICCUACHhABAXEACRFEAeAGDMEEDhAAAIAHEAGDDFFHB.YHFG....hADA......hAFA...,2,-16,-13,3
TVUKZFCbGOEcPaQIAJXYLgMdHNReWSBDf,JADBLDGB.dHBBHEFGeDCBBAFHDIEE.VDACUADF.ZEEFCFADGGCFhAAA..EAAHaBHDhABAAAGD..XAGDhAAA.MCBDWHAG.fEDC.KABBhADA..OEAHcGGDhAFA..IHHH,2,-30,-15,15
MKTDAeVBbRCYgHGOWaSPJdEfQLXIFUZcN,VBCFBDBDCFAC.HFDHGEBE..aBCEJEFDdCHE..EAFGQGGHhAAALBADFEHHZFBBNDDBKBFFhAAA..AABB.eAHH.hACA...YADCWEEF.SEEEhAHA.....hABA...,2,-23,-12,11
HAZfeSEKRCBdMWDUGFPJNXgQbOLacTYIV,eEEEEEGERGCC.BHEE.MEDHUBDG.FHGGJBBB....XDAFhAAAQAEDOAGBaADB.hAAATEEE.IHAGhABAAAHDfFFE.CCHFDIBE.NCAG.LFAGhACA..cGABhABA..,2,-30,-25,5
MJeCNURDAHTFEQLdagWZBOVGcfIKYbSXP,TECAEDEGdCHA...aBCAZFAE.BHFBGEEC..IADGhAAAKEABbCCG.SCEEhABAMAHHCAADUGAHDFIBAFGHFGHFLCAGhACAOADA..fCAAPAFG.NBIE..hBAA......hBBA...,1,1,-32,33
UIVcZLPNfaQHeSFMWDdCXYBEKJTOAGgbR,GBEERCDHUEGD...VAGFLBFA..NBCG.QFAGhAAAHEAFSHGEMHEEdBABCEGFXACFhAAABGDCKAGETCAChABAAIEAIBAH.cEGE...fDDGhABAaHGE..hAFA...,2,-22,-17,5
dCVFfSIMXJbDEQWOePHUgAKaTYRNBGZLc,KAHDaCDD.RDFDBBEDZAGDdBAF..FABA..SFGF.XDADhAAAJGCAEFAH..ODCAhAAAPFEH...UGADhABAAIHC.NDIE..LADGCHGCfCHCMFDB.hACADFID.....hAEAWEAE.,2,-58,-5,53
eYLHDPaQRgIXGZSNdVBJTMCWAFEUfcOKb,UEDGODEEKDAB..eAEDLCFHDDIBQGGERADH..IDHAhAAAZDBFdHAFBAGDhAAAJFHF.MCAHAAHC.EBAG.hABA.fFAG....cEDHhABAHABHaHCE...hACA...,1,-26,-30,4
SEAYPgDcCFHMVZQGeKNLURBWaXdOTbIJf,...PFEEDCCBFDEDHDBFZBGDeBABKGHHLDECBFGG..aGACXAEAhAAA.dHBBTAEGhAAAIAHD.JBAAhABASDCHEHFGAFAB.cEAHMACC.GGDFhABA.NCIE....hBDA...,2,-23,-11,12
YZRfdAKHQGcXWaeUNLCIgbDFMJBTVOSEP,KBGCQFDDGEEA...XGGEeBCAUEAHCDDD...IBAFhAAAgCGGDDAAMDDEhABABAGGVEAB.OBCBhAAAPDHD.YHAEfBDD.AADAcDFHhABAaHGC.NIAH..hACA..FCAB,2,-29,-7,22
NUQMVDWFZefHJXgBPIGOTRAcKYSaLdECb,KADASBBFLBHBEAFFCGBF...UDABMGDCDDHBZEFAHGEA.JCCChAAABHCC.GCCHhAAAOABAAABCaGAHdAHGNCGCQDAHhADAFFAD.fHGH...hAFA......hBAA...,2,-21,-18,3
BKRLVQegPGdIYXTFWJEDNcZfbOMCSUaHA,KEADLCBGQBBAeEFEGEBCdHDD.XBFEFCGGEEEHDGHBZAAAOFFBhABA.SHGEhACAaBDEAGFGBEHE.REBH.hAAAPADGIHAG....WFDHNACH.hABA......hAHA...,2,-28,-3,25
SQEGebCJFcaKAYWUIHDTNdXMfZLVOgPRB,UEEADBDGdHAHMDDDZCBCLGFC..OCEGREABBECFQAABhABA.eHBECHDEFAGDhAAAKAFGAABH.IHGAhADAHDFC.XFAC.fADC.hACAPEHF..EFDChADA...,1,-14,-32,18
UDXIbATNVMLWHOSfFEaZQPBGKgYceRCJd,TDDGMEADLFCH.OCACSCHFFDEGZEGBPDAD.hAAABFFHKBEE...YGAGhAAAcABHCFFBdACFDBHBhACAbBCEAGEB...NIDHWFHBEHACaGED..gAGChABA...hADA...,1,-8,-24,16
CHRfYMUIKXJBFGOAZgPQbScDWeVNEaLTd,ZFEAQGGCSBGEDDGC..eADBEHCAaDCCdFCECFFC..READMAAGhAEAKCAHBAEBGBDDABHG..hAFA.PHEE..hAGAcGAG.NACELEEDfDGBIAAHhAGAFBBG.OBFChAHA..WFFE,1,0,-32,32
eQfdPTbBJgXCAKZOVURYEaNcGWDMSLIFH,OFCAVAAF.RABE.EFGF..aAGCGBFC.MDCHLDGHHADFQGAChAAAPEAHBDEDhAAAJDDFCGCEADDBKHCG.YAHHhACANCIA..WHCADFFBIHHA.hABAFDAH..fDADhADA.,2,-38,15,53
OMNgbQYXATZLeWKGFaBDIVPJESUcfHCdR,LECFeFHDKADG.aBGHBHCD.DHEA..IHGD.JADFSEEEhAAAUEFF.HCFGhABAdAABMEIBgCAEhACAbFAD.QAGH.YFAChADAAGEH..WAHBFCCA.PBBHhAEAEGAH,2,-33,-25,8
gNABZOIYXcWRFLQGUaMPJSHbKEDeTdCfV,OGBAXDDHRCCBLEHHUGBD..aEAAJBFEHBFD..EADCTEGGhAAAdAAD..CCHA.fCAHhABA.NAIEAHAHhACABDAAZACB.cFFGFGGH.MIAG..SAFChBAADHAAeCEB..hBBA...,2,-21,-8,13
GZMYJbSgQdOCXNFEVaWUcBLKTeAHfDPRI,DFFDRAFFZEBDMBID..JBAG..SCEAdFGB.CEGD.XFEDhAAAEBCC..aCBH..hAAA.UGAFBAEFTECFhABAADIFPDAFIGHDbDDF.OAEG.FHDChACAWHDG....hABA...,1,-17,-42,25
NBDKbaJUMcAIFGHEgTCPXdLOZReSYfVWQ,FAEHHDFFEDEFCACCdFAD.LBADRCCF.eGCASGGD.VAADhAAAQCDDBAHCKDAFhACAJAHHUGCHACCF.GDGChADAPFHDOBGB.ZFADWHDADFFF.MBDGhAAA......hABA...,1,1,-20,21
QZKYUBIFfcJSDdHLCVEMPaTXAeOGbNgWR,GDDC..bDCBNCHE.REEDZCFH..KDAFBHAFFGCF...fAAHhAAASBCBDIBAdAGDhAAACCBC.MBFH.TBADhABAAFBEeHEAOFADQAGBIGFEHACA.hACALDHB..hAEA...,2,-17,-14,3
MIaefEHBVgTURKNGZQXJDYASCcFWOPdbL,SFGEFEDEOFAE.dAEFLHEE.MABAaEDHEHEA.BBHBhAAAVBBFTCBD.KBAChABAGADDQCFEhACAXEGGJHAAAIHCCHCBPBHFIEEC.eADDfHABhAAA...hAHA...,2,-16,-15,1
fWLbODFXQNIZaHBPTdeUgJEcAVRKYSGCM,REFCKBHHGABFMGECLBCCOHBC..FGDEQDACZCAHBDDHdCGFhAAAeHEA.UDCGEGAFAHGDSHAChAAA.CAGA.hABAfFCHDCGD.IAGGaHDG..hABA......hACA...,2,-25,-17,8
cbMZOQELXFTPIRYWgVANJGaefSUKDdBHC,JFGDaDDB...eECDUFCDDCCGdAGB.BBEGHAEH.CABE.MIEGZDAB.QBGHhAAAEEED.LGFChABAFCHB.TABDhADAIHBD.WFHHAAFB..fEAGhAEAKAAD.OEEAXGDHhADA..,1,-22,-25,3
BWNDgEHVSPFQaMKGLUdXRIcAfYOCTbeZJ,OEFHTAEH.ZACABHCFDEHD.HGEA.VDFHFBHBQGBAhAAA.MCEHKCBCLDDDhAAAdDAD.READABABCCCBeFAChABAWAHH...NIEHSAFBaAGF..hADA......hAEA...,2,-24,-14,10
fLcNTgEbRPASdUaBDCOKWZFIVJHGQeXYM,dHABUCAFaDADDCFB..CEGH.KFBFZCDD..FGFE..VGECHAFCGABDhAAAeEDG..MFIBLAGBhABA..TDGHhAAA..ECCDbABGACAF.SGDDBGCB.hACAWFAD....hACA...,1,-18,-33,15
NgCOVGeIKdFMbSQfRJAcTWaYPUHXZDLBE,TGCDaEDE..UFGBHBFGDBECLFHDBCAE.NAAA.OCFAGCDAhABAKDBAdBBE.MEBB.hAAASFFHfHBHhABAAAGBWFADXGEH.ECCGCDFB.eGAC.FABEhAEA......hAFA...,1,4,-30,34
UFgVNcBREaJIXdLGOWCKAPbMfTDSYeQHZ,MGEADIFGeGDEZEBGFADE..VCACBHDGRCGF...JCAGdAFE.OFBHhAAACAAG..AIAE...hABAfDEASCGBhACAHACA..gCEBNEAAEGGG.aBHF.hABALFHB.KGBBhADA...,2,-39,-9,30
bKAeEWSLZBIXVdQCDgFfOJRPcTNHUaGMY,eFEGEHGGLCDCBGBH..XAAGQFECCCDD.DBAEFDAAfEGGhAAARBGH.TFAHhABANDICUAEHMIDC.KCAChACAAGEFSFAFIAEFdHAHOHFE..hABA.cDFC..hACAHDBEaFCF,2,-29,-7,22
NGgTfJMXOaZVKLEWbdQARFHYDPCUceSIB,HAAEDIGAUEECeFGFBGCHGAED...gGDDJADC.OFDAhAAAZBBFKBDDECDEdFHCQEAHhACA.ADIHYDAChADACCGCSGACIHHG.fHAHhAEAaCABLBHH.hAFA...,1,0,-45,45
GYKaMNHJdObDRcATfgSPUWELXeZBQVFCI,TGCHSAGH.UAAGEBFHLEEAZDECBFCE.VABEFEAF.CFBH.GGDHhADAKGHD..MAEGhAAANDIE.dBHC.DBAHAFFG.fCDChABAPBDAXCBEQGEC..hAIAaGAE.....hBFA...,1,-11,-18,7
GAFUYgLeBWdZbJXOHINfMKPQDcaVRSTEC,UAEDLBCBeEFEdDGCZFDHJFEBHGFA....IHAFMDBBQAAHhAAADAGF.aHAChACASBAGECHDAFFDFDCG.hADABDAE.XGGHfFCGPFCB.hAFA......hAHA...,1,-6,-38,32
ZeYWIGHCNXUcaQbFTgASOMfELJKVDRBPd,MCCELEHDKAAH.DCDGBFBGdDAHZDDD..eFDE..IBBEhAAACFHCUAGD.QAGDhABAFDBGAHAA.SGAAhACAEDGCJHCG.PFFF.WEAANCAC..aDEG.hADA......hAEA...,2,-34,-27,7
GaCbHXUcIAOTLRegDPWQEMFdJNYKfVSBZ,LHCGeECEDCBA.QAAAEAGC.MAHBFHCAdGFA..NDBAKGHHhAAAfCFC.SBDHhAAABDDHaDHDCHGGbEGFhABAUAED.AEFFTFDFgEAD.WACEhAGA......hBAA...,1,-19,-31,12
CSODUWAfITGYdPFabgecNLQMJEZRXHVBK,TACEGDDEdEAH.aDGAeGCE.LHAAMCCCZGACRCFCHFGDBGGCCHHDhAAASDED.hABADBFEABGDICAEhACAYCAHPCCH.FAAG.cFAHNBBB..hAEA......hAFA...,1,-1,-28,27
SLWXgPQVAaYTHJBZENMDOGebCRdFfIUcK,aBBDHCFBZEAAMBBD.DIEGeBEERFCG.dCEAFAECUFFCKGHD.LHAAhAAA..XGAChAAA.PACHADDFYBHBhABABEEGODHDCGAE.ICEDSHGAhACA.WADC...hABA...,1,-16,-25,9
fVaROZNEHUPdAXIFTDcWCKQLegbGMYJSB,XGBCFACFDAIF..CDDA.LCEA.eHEAGAFEJEFBBACEhAAAaFEBRFAF.ZEBAHBAFdCBBAGAB.hAAA.TFGDKAEC..hABA............hAEA......hAFA...,1,-29,-33,4
bEBIaZWGdYKRJXCUVLfScNOHPMgFTeDQA,BFFAZCFAdHGDKAFEREGB...JFDHCAEALABD..SCHFhAAAOECHHDDEMCACFEABeEAHhABAABHH...ECEAIHAEhAAAaECG..WFHBXACD..hAEAfHBDcGCE.hAGA..NBBH,2,-51,-23,28
OeDZABcgIHMUafRKWLYEPFQXVJbdCNSTG,BDGH..IEHBMCEGUFACRCCEKEAHLAAAECGE..FAEHQFFChABAJAAE.dFDGhACACGADSFEDhAAAOAECDIBEADDBHFFH.fHBFWHFA...hAEA......hAGA...,2,-34,-25,9
VKJDWeGdIfOZbHFTRPLENcBSgaMUCQYXA,JCAFeHBCGCFCdCFFOEEFHABB..FGBFRDBCLDAF.EGHDBDEChAAA.SHDGhABAaAABCBBH.XAGAhADAKDGFDIDAIAHDfFHC.TECB..hAEA......hAFA...,2,-23,-20,3
eTDSXPdCGHIRZOLYANJaWKBfQVgbUFEcM,JBEFKAABBGBC..QAAF..VECEUFFHFCDCEAGDMIAGhAAADBDD...SFHDhACAXEAFCEGCGAFGhADARFBH.OAHFADIDaGDD.fHDD.hABAgGFD.hADAeACA.,1,-28,-35,7
ZfXJLaHUBdAWeYDKGRICPgcbENMFOTQVS,eACADHDERFFC.CDGA.......PCFDgDCAECHH.MCCEhAAAODCB..QGBHhABAZCADXADDLFGDhACAaGABBABHdAHAAHHCKEEDIFEHNIBH.FDABhADASAAF.hAGA...,2,-22,-19,3
IdCcBGWQHTPOSVEAeUgfXZFLNKYaJRDMb,UGDBXBCBLCCEKEEH...JAEERBFHDAAD..MDAHdHDHBCHAhABAQDBBHEAETEGFhACAOEGB..SABGhAAAAGGDfGAGFCHHaHGECHHE.....hADA.WAEEEEEF...hACAeBBB.,1,-16,-25,9
RCHGYKfIWDQgTLMeVNAcUEXdFPBJabSOZ,EFAEdCHCBHHE..bBDBSFCD.ZBBBRBAACHAHGDDGKCFB.hAAA.fGGFhABAIAHFDGGHTAGHMAAGNDDAAEIBhACAXAEA.PFAHaEFEYFEFhADA......hAEA...,1,-20,-23,3
IBcZLKdUHaAEROCQXJfgYbMGVPDeSFNTW,OCDACHAH..XCFFJEBE....fHDDbDGD.hAAAMFFCPDDH.DIDAhABAFBABTEAGIGHFhAAABBCDZBGD.KHAGdAGBaAEEABDGQCADhACA.gFEFhADAYGDC..eDAF,1,-19,-26,7
dMTegLJIVAPBRZNaYWDSFQfUGbXHEKCcO,RFEBaDFCDBBD..FFBBUCDCGBCDHCFG.KEBDOFFC.dDABMACAhAAAeACCLHBC.hAAA.IHHFAHHABAGA.hABAYAHH.SHCA.fDDGhABA..hACA...,2,-36,-30,6
gCdANQFVfWZUITLPSBXKcMHbEReGDJYOa,FECAVCFDZAEH.UDACLCAD.BHHBKGCGHAGDEFFB.RFGBGAADhAAAJAAE..OFBFhAAAaGFH.CHFDAAIF..QGAAhABA..fEHA.WBDHhAEA.IAGEhAFASEGE.,1,-20,-31,11
BeHFOAXLbEKcWDPfVNUaMQYRITdZgJSCG,LCABEADDKFDA.DICA..VAFBUFFD.aADGMFAB..QDCHhAAARDFAdGGEZCBFSAAChAEABHAAeCHDFGCAAFIH.hAFA..XAGE.cCDFfDDHhAHAIABF...hAIA...,1,-20,-26,6
THfCcEPBMQKeUIaZSLRbgNFXDAOJdWGYV,JAAGGCBD...TAEHCBGCEDEB.BEHGKDBH.eAAC.UGCBaAFGLEGBhAAARFFF..hAEAgBGCXFCEACIDhAIAdEAD....YHCAfGACMCCAhBDAIEEB..hAAA...,2,-32,-23,9
ZFMCbJVTcdfgYaRIWPLOABENGKXeDUSQH,BCFCGCDAeEEAUABDQCBHZGDCFEBB.MAIHCFFB...VACChAAATAEE..fGHEhABAaGCH.IGAFhACAPBHDAAAFEHFEKAGEDGDGSCAG.hAFA.JHCA....hAGAcDFA.,1,-6,-23,17
QPHADgYMUOfVKdGcSeNBRFJXTELIbWCZa,DGEEMCBGOECAKFFDGDGE..SAFDeAEGBACDFCHFJDAHXGFAhAAA.LHBGhABAIFCECDAHaDFDHDDHhAAAABCF....YGACfHCF.dAHAhABA.NIEBEGADbACH...hACA...,2,-32,-8,24
aHDVEgdAQfXOJFYUeLZKbPScTBWINRMCG,XEFEFHDCUADGLDDAKFBB..SDADBHBD.IAAChACARFFECAGDHAAH.DCHBEBHFhADA.dCDDAFDF.OGDAhAEAJDBD.eHAG.ZDBA.cAGGNCAC.MBCAhAFAaAHF......hAGA...,1,-15,-29,14
DSfJZFBGAIgXdYLbHVKQcMCaTNWEOeUPR,XBEAdAHCLEBHHCCFQFED.CFAF.NABCOHCCUAEHDDEHhAAASFHDZABD.hABAFAGAADDF.IGEFhAAA.gFAGYDHBKDGDaEFGEACA..hACA......hAFA...,1,-15,-23,8
cBfbTeUKHQRJFMNVGEOPALCSYZdaDIXWg,LEACSGGHdABFDFFF..IFEE..XBCFhAAA.gCAGhABABHGEbFADeCHHUBGEHFBDhACARCDEFCBGMAHHNEEEGAECEGCBAGIBCEAD..aGAH...hAAA......hAEA...,2,-21,-2,19
XOZYBAePNbdHfaDIJcFRSEMTGCgWVLQKU,eAED..PGEAdACAaEFEJCBF..RGCEEGGGMBFH.GGAB.hAAACABG.gAGEhABALEDGQAGChAAAXCBGYEDEAHHAbACFDIDAFFACSDGE.hAFA......hAIA...,2,-17,-7,10
eIBgPQDfKaEcbXHAGUFLdCSZWRYMTOJNV,GAGAUDAAdABASFCGRFDE.MDDEOBGBJABB...eGAGhAAABEBFQDDHhADADIFGfFFEEHFA.XAEBhAAAAAEFCCEE.ZGBAWEHB..NDAGIFHDhABA..KAHH..hAFAaEEG..,1,-8,-27,19
ULGMETVAHYCWXOadQRcBFeNSKgfDZPJbI,HGACCFDE.OBDEQFFFRDFDFDAD.eBCBKAAH.DAAEZDDD..bAFGLHEAhAAAGEAAMIEChADATAGAAHHC...XACGhADAaCHHBCEGSFFDfGCA...hAEA......hAFA...,1,-11,-14,3
HagUYECfOJKIMXSZcTWebPGQNdVARLBDF,BCCCFDCEHBAEUFBECEGC...JGEAKFDG.MIFAZBAH.....TBEGhAAAeADGGBGAhAAA.dEEHAAEBLFADhABADGADaDDG...EHBE.fFHC.hABAXBGBWAFE..hACA...,2,-32,-32,0
MTADCEOIefbVZWKLUPSHFRgQdBJGYacXN,CGCEEHAA..ODFCeBEF..VAGBKAACLFFEUFEGHEAGREAFdCDG.hAAABAFHJCAGaGGD.XDGEhABAMIBGAGHDDGGDfACFhACA....WAHFSGDFhAFAFADG.....hBAA...,2,-40,6,46
dVTCPXNbaJIAKBYUEfLMGWQFZcSeROgHD,KCEHUDFHEGEDLEBG.MCEGQCACFHBA.ZFAFeAAFOBBGhAAADGDAdBCATCGDCHHG.hAAAXGGH.aEFDhABAAAFGBGHBGDCCSGFH...hACA.gAGEhADA...,1,-11,-32,21
XZQHJfATgULaWCIeVEPDbSMBKdcYFNGOR,TGDELAAB.aFBECEAC...eEGBEACHDAHBSAGDBGHCKDDEdHBFhACAFGAEOCEB.RDAAQFEHhADAHECEAIFGgAAFhAAAWFHH.IBFDbACEMAIF..NAIE.hAEA......hAFA...,2,-31,7,38
bKQeZBCEdaPcgNMRWIXLFUVTYGDfHSAOJ,OEAGKFDFeCFHZAGDBCDFdFAD....aHGA..PDBB..hAAANIBBRBBGIGGE.hAAAXBAC.FHEChABAVEEHTAGADABCfDHAAGAFJCHDCAEB.EADAhAGAMBBE....hACA...,1,-23,-27,4
gQIdCDVaSZKRGPJcLWMeNHfXFYOATbUEB,UCEFBDGAQFBECFGA.DBDBVFBAZGFAKCEDGAAB..JCBDhAAALEAF.MAIHhAAANCAE.HFEBFABBABID.hABA..EHAGIHHHaEGE.SDAEhADA.....hADA...,1,-13,-36,23
dLDHWFNSCAfaKPgVeRMUbIOZQTJBGXEYc,KEGDVFCDMEEB..UFFFODCBZAFG..QAADJCHH.BADFhAAAXGAH.ECADhAAAdDDBDDDGFGAH.CEBEAIGCaAGGhABAeCAFRABC..IGHA....hACA.YFFF.hACA...,1,-23,-26,3
OKCHBLbeDPTcWaFUNdRZVgMAIQJSEYXfG,JBFESACB.EGGDXDFH.OHECKGAFCAAGBDHA.hAAAeAEDTACF.aEADhABAUDEFRCCCZFBBgGCGhABAACAD.IAFBfGGHLCBFhAHADAEG.WFHBdEEC.MDDDhAIA...,1,-16,-26,10
AfYJFKITLadGQPXBbSCgWREcOeNDVUHZM,JBEBFGCCKCFFLBGHGBAE..QGDGBGGHCAFE.RDAF..EABCOEFChAAA.DACEUFGGhAAAHAGBAIGCICCHhABAdDDG...bGAG.....WAECNIDD.hABAMBIH.fFEDhAIA.,1,-19,-32,13
ZYKJDdbCFMGPQIXAeRWcgOaLTHEfBSUVN,eAHFRDBC....gBFCaGGAHACABHEGUDGAZFBAKEEGDCGDdEFGFBCEhAAAMHAE.GCABhAAAQBAEAFDB...hABAOHAE.LAFCfFAHSGHDhABA.NDAC.JHFC.hACACEAC...,2,-15,-10,5
cLafHIXeKWDbJVGBZTUFYdMAPQOECSNgR,OBBGSABARCEALFHBHFCGeCAC.KGGGDGAD..VBEFZCAETFCEhAAAFFAFMIAGAFBCQGFChABAEAHH.CAFC.hACANEAFaHFC..fEFFWFFE...hAAA......hABA...,2,-19,-10,9
RSINMDTWPVdeXKYGHbfZQAgBCJcUELFaO,CCHHUBDEFFBF.OEEA..SBACMHAGDADG...TCCHhAAAVBAB.dGDA.eFGDKHFGHAGHhAAAZCEBAFIDBHAHEFHHaGDFhABAIAHG.PADE...XDAChABA...hACA...,1,-17,-26,9
KHEGCZRcYdXbAMOLgDPTNJWFeVSUBfIaQ,OCCFLEEGDCIHTEBF..JEAHFBHH.eGDGUGCFBGAB.hAAAaDDGHCEG.EEFBCHHCZBBGhAAARADEdBAFAEAF..MABAhAFAPHFA....WHAGfAHAhABA.KCAH....hACA...,2,-22,-19,3
LDZfYCSJeVbBXOKFGWcHQEaMURPgTINAd,DDEDZAEFCEGBeABEBCCFKEAD..FAAHGGCB.HBGHaECF.MDDHUGFFhABARBBH....PFFEhAAATGACAAIF..fFBAhAEAJDAD..XEECWHAG.ECGGIHHBhAFA..NEIE.hACA...,1,-4,-40,36
QfcGLBeIPXRMJdDHUNbYZVKEWCgaFAOST,TABCQGDB.GAGGeAGH..IFHHXEAE.MDIBhAAADAFBHFDFUDEEbABG.hAAAZCAAEDCH.WDFGCGGHaGAChACAAADGfFFEBBEH.JGAG.NBAAKBDB.hADA......hAEA...,1,-4,-5,1
WZFAJYMTPdeKafRBVEbcSONDUQgGHCLIX,JFDBMAEE.dEBHKHAEREEB.BDBE..ECGE..SAAGDEHDQBBFhAAAHCGHLADGhABA.XFGEhACAWGBGAICE.TEACaCEC.fEEB.bCCBhAEANBAA......hAFA...,2,-29,-27,2
FDBTaQVMYSNcACdfHLbKgOJWEGPeXIRUZ,dECBHADFKEGBOEHD.JAFCEFBD.eFHHRDBGFBAFBAAA..aEFCMADFhAAA..SCFAhAAAABHACHDCLAEF..hACA.gGEBWGCC.GAFEIHEFhABADCBF......hACA...,1,-17,-31,14
NUPWHZADSRcLdfMGOKaIbJFEgCYXTVQBe,RDGDdFDBGDDEKCBF..aACAJAAB..FBGBCFAB.....TGGBhAAAQAEFBAHBeDHBhABANICB.UGAHHCBFAEEADAFHhAGASCGC.LGFGMIDG.IAHFhAAAEDCC....hACA...,2,-24,-22,2
SZbXCTRIWgFNdcEPQfAYJMHKUOVBeGaLD,JDHBHAAC.OCGHeGDCGDCHaBFA.DEBBZEDD.CCHARDAD..IAHDhAAAFHAAdGHE..ECDAPBDEhABAAAGE..MFFBhAAAKBBHBCGA.LADC....hACA.bGFE....hBAA...,2,-25,-14,11
KTAdfJWIBOGHeXaFQNDbYcZRMVESLUCPg,dCFEJCDDBCGAOFAC.HDAG..XAFBFFFCDCBC....bADFhAAAZFBH.RFGDEFDHLHCChABACCAHKGEG.AHAA..IHHHhACAaACF..NEAE.MAIB.SAFAhAGA.....hAAA...,1,-10,-40,30
eITdbaRXCSOQVBGEZFcgWPMYJfUDLHANK,KGGEeBEAdDDDRDAB..CHCB.QAGBBEDG.EBDAZFGF.FACE...hAAA.gFCGhABAMAIBJFED.DDAFAHAD.TABDhADA.aHAEXAADOHEEcDFE..hAEAWCDGfFAAhAFA...,1,-23,-38,15
YJDfAbKQBZEdgcGNTHCaPUXMFIOVWeLSR,KFAGBGHAEEEHdDCB.GDEGHCCGCBCCUGBD..MCFCFADG..OAAHhABAVGFGLHAGhAAA.SEAEhABARBEEDCIFAEHH.QDGE......hACA......hADA...,1,-17,-40,23
XHAfIPdWMYNQDScaeBUJCFRGTKEZLOVbg,..ICADPFCFdCFC..MIAEQCADDFCF.SFGFhAAAeEEEBAHEJFHBCABGFBFDhAAATAGFKFAFZDCFLABChAFAOFHDgEDBAHEE.fHEBhAGAWAEF..YBHFhACAaCCA..,2,-25,-13,12
WNAUSFEacgHJORfMeICLXTVYGBZKbDdPQ,FEBDEHEA...aEEFHDEBREGH.MGAC.eCCDICCDCABBLBFGhAAA.XGGHVAGDBABBhAAAKAFEdHBHQADEhADAADDASADDJFDDfGAE...hAEA.YEHH.hAGA...,2,-32,-1,31
ZMIVdTgDCbKBfPeGJLaNERQcSWHXUAYFO,OEEEMDDCdGAFDGDGKBFABBBH..eFHBLHDCEABD.RAEF.SCADhAAAHDACABADZAGBTFEHhACACADG...fDBDhADA.........hAAA......hABA...,2,-39,-25,14
RZOCdWEUVBLPXgQeKaTbFHSINfDYcGJMA,ZFFAdBDAEBACBBAALFEH..PDAHXBGBeEDB.KCCETGCBhAAAFGBE.HFAHSEEEhAAAIEGEDIBEcDAFhABAJCEE.ADFECHGD...WAFC...hABA......hACA...,2,-38,-3,35
JgXNOMBSCIZecPRDKEbHfUWFYaAVdLQGT,dCAGQBCDGDFGJAHH..NFEB.BABBCHHCZDAH..eCCDRAEDEHBCHEDBhAAA.UGAHFHEGAAHETBDHhADAOAAA.MEADhAEAIHHCDEGC.KHEG..fBHEhAGAaAFF......hBAA...,1,-6,-21,15
XcSJNVTeAYKgMZdPBIDbHGaQRFfUELOCW,KBGFMBEFZDBGdDGGBAFCDDCB.HEGDGFDB.RGBG.FCBA.EAAECAHB...hAAA.XAFDSGEHhACAJBAB.TFCC.hABA.AFAC.PHAEIHHEaEAH..fBDBhADA.OAHFhAEANCIG...,1,-20,-25,5
XVNTGLIBAdQRFHODUEagJMePWYfSKCZbc,dADEFGDAOAAHUFFB..aAGDMECD..eDBD..PBEEhABA..fBBEhAAACFAFbDEE.XGBAhABA.NIEHLDEEAHBBQBBGDCIB.EAHDWFADhACAKGGD......hAFA...,2,-28,-22,6
HGWeYgVMdPSORUTQaCIFBJANfKXcbZLED,KDEEXFDCZDBDLEGFDEBA.GACBeEFB..VFADdCACSFHBhAAARACEUAAE.aAGFFCFFhAEAAABH...NICF.bGCAEEHFhAFA....YFAF..MAIDhAGA......hAHA...,2,-15,-14,1
dEbQWBKaeIMHDTGgYONAfPXUSZFJVLcCR,XFGEUDEDZBAFFAEBLEAB..CHBC.ECEF.QGDAhAAAKHCG.eBCCIBGBhAAADIBEgDGF.hABANADHAEFBSHGE..cCBCdEHG.hACABBACaGABMCDF.hABA..HFDG,1,-16,-27,11
WRUeTYfXCAaVLIEOSNHFPGDMQbZJBKgcd,aABCLEHF.EBFGOEAAHCCDGAAFDGGCQGAHJCFHBFACKCCEhAAAdHBHREEH.eFFD..hAAAfDGGCDADAHAF.hABAVAGHNEECMECH........hADA......hAEA...,2,-26,-3,23
OeHJUgEdWPMGQcBaCKZTYRNAXILVbDfFS,XACHLCBEDBAEFFFG.eEAAHEAC.JBGFEAEC.dDHG..MIFChAAAGEEABAHGKAGHZCBCTGCFhAAARGAEAACH..IAEDhABAfGHG...SDFBhABAOFEH......hACA...,1,-13,-22,9
GSTOKIeRLYBPEZXHAQFbMVCNDgcdfaUJW,FEAFMDDHCEDE.DAFF..dABEUEAFGFDH..TGEAOBHHeABBhAAARBDABADA..PCHHhACAEHAE.ZBDFAAIH...hAAAQGAHNIEH.gGGBfDFGhADA.....WEHHhAFA..,2,-27,-26,1
WLHgdJCbGUaIQVFYScKBRfOEXANePDZMT,eEAADCGDMDFDLCDBHCAG.JFEGGGAH.aAEBICGF.hAAAQBAHFABASGHFhAGABGAGODHFhAAAEEGHAIFENBIG.PHBE.WBEBdFBBCAGH..bGEE.hAIA..YAEChABA...,2,-24,-2,22
FdGXCLcJgfSPZTMeBbNRAaIHEKQVUYODW,aABFEACEKFAC..QGEHUGCE.DDCEdEHECBEG.JHFE..SEGGhAAAZCBC.eAGDhADABHAARFABAFDEHBEE.OFEAhAAAWEAC.FAGEXGGBLBAD.fDFHhABAMAIF...hAEA...,2,-31,-14,17
RVWCUMIJOGNYFeKLfSQDPgaATXZdHbBcE,TFGFdBEHHAAC.BGEEEDHD.RBGH..CGAC.UGCD.MFDGJEHD.GBCDhAAAFDAHLFFBSDAHhABADDCB.aDDE.AIHAXAGEhACA..ZDCD......hAAA......hABA...,1,-9,-30,21
AQbFcTDVONJSLHUYZPXedCRIGKagEBMWf,QFFGFCCGDBBH.OBEBJDFA.LCADUGAB.ZBGF.eABAhAAAdFGDCEECGDCE.KHAEhABAaBFABCCF.MIDGhACAAABG....TEADSAGE..hAFAPHFCIHHAEACC.hAAA...,1,2,-53,55
bOaBeGLZNPRCASUTWQHEVXYfMcgDFIJKd,TBCCQAAA.EEBEVBFA..fADBMIACDHFCFAAHJFFFdDEFhAAA..aFFABHEDhAFAeEABZBDGREDBAIFESBHHhAGA.HEGHXDGAYHAA..hAHAcDAA...hAIA...,2,-16,-8,8
KQUSeWTEZaPYMJBdGgXcNOLFDCRfHAIVb,VDBDKCBAUABF..eFEAEGCB.ZGEE..aFHFMDID.BBGEdGGGGBFChAAA.XEAFhACANACDODDG.DAAHCHACREDHhAEAAHAD....IBBHSAFC..hAIA..PBDE.hBAA...,2,-28,-22,6
BfPVQgeICOANRKUTXaESJDGcLZYbWHFdM,KAHBXEACEHFC.DEGBLAAG.ZCFBbACBFDCA.BDHE..hABAfHAHQFAAhACAIGDEAEAARFCB.aCEGhAAASAFCJFHBGBGC.YBBHWCCE.hAEAMEFB....hABA...,1,-17,-24,7
DIaeCKBRcFfgYdEZUTVOSHLGJPMXANWQb,QEGFDADBeEAGKGHDREBGFCDB......fFDChAAAdAEDEGGDTCGESCGGhABAHBAFLHAGJABBMIBANECBhAEAWFFD..IGFFBBHEcFAHZAFC.hAGAOAAA...hAHA...,1,3,-28,31
bDcVHICEXNBSGURgKOaePTJQLAYfdMWFZ,dBCFFEFADBCEHDDH.CGGB.EHDABCFC.UDAHKAEE..eDCH..TGEEhAAAQCAHAHIFMFBBhABAZFFC.VBFA..hAAAIAGCSHACRCGB.aABG....hAHA......hAIA...,2,-27,-24,3
NcQUKJWEPTFYZdbSXfDgVLAHIOCMRaeGB,OFHHMEBHRDGH.GEEABCEH.QGCGUAAF.KCFCJECC..PAFEhAAAFADDZGDC..bBBFhABA..SHAGhABADEAHgDCHADACHAFACCHH..aFAD....hACA......hADA...,1,-11,-28,17
OMFfcZWTNXDRaHbQYIdLGPKgSeJAEVCUB,CGEBBCEAFBBB.ZADC...TECBDDGHRDBBHGBC..QAAHhAAAdHGFLADGPFEEKDDG.hAAAeHCGAAHG.ECAFOEAHhABAfAHG.WEAH..NCIEaBFEYEHHhACA....hAEA...,1,-25,-26,1
RdNFgMeWLKGVJPfBSTcOYQUIZXEAaHDbC,DHBGRGACFDFAMFBELCABGBED...JBADBAAF.SDDDhACAOHFGUEGAZFFHACCHaDDC.hADA.CAEGdBGH.eEHFhAFAKFADPABA........hAAA......hAFA...,2,-32,-26,6
EVMGUcBdYHKTPASgLQbfWCZROXaeIJDNF,LCCAQBCE..bGBACCBGZAFA.RDEC.aAGGeFCDDIBC..FAACMABAhAAAUDGGBHFD.dGGDhAGAKCAFACEE.SFAAhACA.fECD.XGGEhADAIFDG.....hAEAEEHF..,2,-25,-22,3
PaTbCSIfKMFNVWdgcEXYZQOeBUJADGLHR,DABFGCBELFADHAADRFDA.aHBECHFC..SDEFKAGBFBFH...hAAAVFCBdADCEHGE..hACAXBDGQDDChAFABHHHAGIBPCHFIAEA.NAAA....cBGDhACA.OCBDhADA.JFFGfGAC,2,-34,8,42
gNcCLeAFUfPMaZTGBWIVbEQSdHDRKXYOJ,UCDEMAADZBGHBBHG....IDEHVFFG.EGDHSAGChAAA.DCBFRFFEKBBDOEAEhABAgFAG.hACACCDCAAIFFHDAaEBC..WACA.dGCC..YAEEhABA...hADA...,2,-38,-21,17
BOHeQLXRcSdaDPZGMAEINYKCUJWfgTFVb,EAGB..IDHAKABECECG.UFGB.JGAE..fBDDhAAAFADBBAGHHEDHLFAH.hAAAXFGCRCDGSGEHhABAdGEEaDEEDCCH.PCADMBBBADCC.WAHB.hACATGCA...hAFA...,1,-19,-25,6
DSLIafNGORCdecBHTKZgEMFWbPJQVXUYA,SEFCaFGBGDBERAABCECD...dBGEeCAABACEHFGFZEDH.MBEGFAEG.hAAA..bEDH.QFAHhAAA.XABGhACAAIBEIHHCNAEDOBHD.....hAHA.KDHB..WDDChADA...,1,-11,-28,17
TZgRdHbJOKGcBDPIWMQaFEXUeLANCSYfV,CFBASEAG..VEFBZGFEdGCAHBEFOFDAKCBDBAGFDBHF..hAAA.IHHBQCEChAAAFHBCUCCAABAB..hABAYDBE.fADA.TGAAhABA.gEGHhACAJHDC,2,-37,-33,4
eEXIaOBYMWJLHPGAbcZFgVQDUSCTNfKdR,ZBFBFCFHQGFBSBCG..CEDC...TGBCKGFFeEABECDFXDADhAAAaDBF.BBBAhABAMEHFJAHDLAHHhAAA.PFDDAEHCbADA.gADEDEEH..hABA......hACA...,2,-25,-14,11
BScaTHQKVFYZDeUPCNAIMbOLXgdWERJfG,MAEGLBDDdAAHRDFGJEHF.BAEB..SGGF.aBGAQFEAhAAA.FCFEhABAYEBBeBBHPHAGhACANBEG.AHHB.OBCDXECCWHCAEAGGfFDEhABA...hADA...,1,-26,-30,4
VNITQeHbWKEMOLCZAUBPcGaSgFDfXYJRd,BADFGCDDSGBFDEGF..XGCERDFDdDCA.VBACTBDChAAAHAFEKGHFEFAFLBADhABAZDACAFHB...cGCDhACAFGHDfEEE.NABH.IAGEhAFA.eCHBMIACCHEH..hAAA...,2,-11,-7,4
NPdWSDHfAZeIbcRYUKVQFOTLMCgXEGBaJ,ZGDCeDFB..IBAEREBDKACAFAGALCCG.CFFF.EAACBCGFaGHF.hAAAJCHDdHEB..SEBAhAAADDDDACDG...hAEA..YADG......hABA......hACA...,2,-42,-39,3
YeCTPbZLOXdUJRDWGQAfFVcgESIKaHNMB,VBEBEDBBKAEE..HCBBMHBGBCAC.CFFF.TEFHZFAALCHHhAAA.dABHUBCHDHEAQGGChACAFBGHSHGGhAAAaAEA.NDICeDDB.ODAH....hABA..JHAA..WHAGhACAAEGC..,1,-12,-14,2
GdZCebQBTISJfcNRPOMFHEaUKLYXgWDAV,dBDFZBFGCHBFeDAGBEEA..TEFA..SCBDJFDH..hAAANAEH.REGHMACAFAAFaCFEUGDDhABA.KAGCLACFhBGA..XCCBDIGGAEEF.....hBHA......hBIA...,1,-26,-37,11
NgYEXZcQCJLFRTDSUBGaWdOHKeVIfPMAb,...NCHE.gFGB.ECFCXGDCQCBECBEBFAAFTFEHhAAADGEEUEAABACAGCCHhACAdFBFKBED.eAEGIAHFhADAMIEGAIBE.ZGAC.cCGE.LBADhABASGHH..hAEA...,1,18,-40,58
JKNeIWgTGfCOLZQYUESFaDVMdHXcABbPR,BADCRBFEKCBD.eFEE....IDECTAAHGAEACGHG.LCCDhAAAZGAEUGEDSDHHhACAaEFE.MHEGhAGAHABEAHDBbBGFNADB.fHADOFBG...hAAA......hABA...,1,-7,-29,22
BVaMIUfCLXGOdJRPAWgSHbEDTcYQFeKNZ,SECHEDBEDGAE...TAFCQFEDKBCFBDAHVACGaGGDMBAHhAAA.UAFGCCEEGEEGhAAAJFHD.AHAE.HDFEYEHHhABAeEDFIHBH..fADHhACAOAHF.dHCD..hADA...,2,-25,2,27
DUgXREdfAZMINQaHPTcOBGVWeFLKbYJSC,MGFCQEDBHCEB..TBBHODAABAGCVAEGFEABLHDEhAAA.KBHBJEDFDGFEXFBHhAAAEEADACAA..IHAChABANIADaADFGBGAeABASDGBCHHB.hABA......hACA...,2,-11,-7,4
EJLeUMCYVgBDINdWFOTKbZAXfSQHGPRca,SDACHCECREEFEGAALAAHMHEG.CAFG.VEEEBHHB..IABAhAAAdECBFEHDOACBhADA.KEADAIGGQBGBhADA.GFAHaHCG.eDCC...hAEA....YBCGhAEADAID,2,-27,-18,9
WJLUegIQSHBEaRMVAdPTcGYZOfbNXDCKF,dCFDTGAGGACF.ZBAHOEFG..NEEG.CHGDFDABLBHHUGCAeABAhAAAQFFCBBFHECCGhABAMCAH.AAAG.PFHFhACAfGAE.DEDBWEBAIHHG.hAFAaGCH....cAGAhAIA.,1,-9,-28,19
IJcDSQUZNXbdaMfAGCLHKTVRBYPFEOgWe,GADDCEEHKBDF.RBBFBDGAFFCC...EGGHOAEFeHAE...JAABDEEHhAAA.SFFFhABAUBGFZGFA...NEIEdCGFMEAGhAAAAADGLCAF..TGAEPECFIHDFhACA...hACA...,1,-12,-40,28
GKLRQOFYTdAMHIcBJUDSgbVaNfPEeWCXZ,MEEAHAAHBBEGDDDH.SCGC..bAAGaEDA..NGBH.EEAFhAAA.CGFEZFBDKEHBLHCGhABAOFDDFFHBdDAFAGBBJAEChACAUAGG.fFFBeCCG...XBEFhACA....hADA...,2,-29,-7,22
bAQBYXcIFDTgOUHefaNLECZKSJVGMdRPW,QBFBBCAG..XAGCIGEEDFFFOFAHeDCBaHCEEBAECDHGhAAA..KFAH.JCHHGDADhABA.dGGHRBBG.PADFhACAAEAAFGGH.UGBENABD.SFFE.hAAAMIFA....hADA...,1,-7,-31,24
LUgMAZYJTNXbFRKWDcfVaEQdGHBSCIOPe,JGDGXBGB.RGDG.KHGG.DFBF..VEAGQDFGdBBBBDDB.hAAACHAC.OAEBLFFAhAAAUBAAAIHGZAEH..TDCChABA.FAGAcDGE..aCFA..hACA......hADA...,2,-36,-22,14
ZUVMEKfGJTDPYcHbeRCdQAIaFBSgNWLXO,aGGABCHF.SDDD..gCECLAAFXFDAhACAZCBDMHDAKAGBGGAHDAAAPFABhADAYBFFbDFACGHEACDAhADA.FHFE..ODDHEEAFfBBGhAEATADE......hAFA...,1,-11,-19,8
FWgIBZVfCSeQPUXEaLOAdKJGbDHRMYcTN,KAABJBCBGEEFDEIFHBDG.RGEE.MFAB..TCBCFBGH..ICAEhAAAZGACCEAH..SDGHhAAAeFBF.QEDGhACAPFDHEGHFaACELAEDAIBE...hADA......hAFA...,2,-21,-18,3
TdBaJSbReWKLYHCfQgZXEcPONFVIDMUAG,dBAEaEFB.SFEARBFG.KCEEHCAD.QDCHXDCCEDFChAAAOFDB.FEHFDBFEAAEEBHGAhAAAJFADeHFELBAChABAfHCF.ZACHcGAGNAEH..MEIFhABA.....hACA...,1,-7,-20,13
VfPHIRdQeYUCbFaTBAMGSNKOXWLZJgcDE,SEEDKGGDOFCHLDCAZAFF..gADBDAHH.VBAChAAAfBAB.hABAIBFEdEHEYHFAhACACFHFFADGBGDEAEDBMAIFNCAA.WHAC..cEFBhAAA...EGAF.hAHA...,1,-22,-29,7
WfYAZgTbcRBPdNOVQSLGeKIUCXaHJDEMF,TFEEREAEBAGCdBCB..VEBGLEFF.eBHDIAED.hAAACHGEHCCGDIGEMIAGfEHAhAAAABAB.ZBGDbCAEhABAcABAOEGFSHAGKCEAaGCE.EDAF.hACAWAGF....hADA...,2,-18,-16,2
GBXUgRTDJPaeNfOZSIHLMEYdcWCQKbVFA,GCDGXCFHUGGCRECH.DCIF..JFHFeACA..OAFESCABhAAALABHMFBBdGAAhAAACGCGKCFCFEAABFFE.hABAPHDEaFFG.ZADHIAGE.YCCDhACA..WCHBhAFA...,1,-19,-22,3
IgQLJeUBCcXGTFVSWbYDAMaKRPEdZHONf,MFADRDFDEEAA.HCCE.OFCA..IBGCLHDGeFHFUDGBhAAACEDDGBABVAEGbBAFDBIBhAAA.AADFKGAF.dHDDfFHGhABA........hACA......hADA...,1,-11,-27,16
BedIPFaXZADNLfGRcWTbEgUHSOJVQCMYK,DGBCLDDHGCFARGDC...TBBDECADUBFAOHDCQFAChAAA.MBIHKGHBBBHHhAAAdAECFABDaAGGAHIF..fFFBhABAWCEDHDAESHFACADCIHBB..hABA......hACA...,2,-26,-6,20
QWRdAJNYObKBMgeSLZIUHXfVFPcTGDCEa,JGFAOHDABABG..MCHD..SEDHZFBBHADGXGGFhAAAFDHB.TCBCDEAACFCCaDDAhAAAQDEB.hACAdCAGAGAD.NAIA.KBDC.eHBAIABGUAFA.fGAChADA..hAEA...,2,-39,-10,29
NcHRMQBgWJFCZSPOLfKXADVGadUETbYIe,DDFBaGAB.EDBF..TDFE..IGHFeABEHCCDQECAhAAABBBAJAECCACBZCGHOEHFhAAALAFCKCEEAGHF.dHBB.hAHAbBBEYHDG.cEECMIEGFGEESHCChAIA.fBHAhBAA,2,-21,-4,17
dGTCcXbEfDeOZRLgVAUBWaNHJPISKMYQF,BHBBaHCCHGFEJDAB...SFCAKABG.MAEBFCECdGFFGABChAAA.CFAD.XDGAhAAAEEHHDDDHOEEAZDCFLHDGhABAAAHEUBFH..NADH.IDAB..YEEAhAIA.TBGBhBAA..,2,-28,-11,17
agEJFLKCdYGOTMXBUSHeVZWRDbQfNAPIc,..IBGGaBCCECHDLDDDdCDBGEADMBFCUGDCHGACZAAGDHFEQGFAhAAA.ADBDPEEEhABAJHAEKFFEODEEhAAABAEFeDAD..WAHB.....fAEFhABA.gCAFhACA,2,-15,-14,1
cgSTbLABDaHUJMefdCKWFPGQENYVXRZOI,aCBDJHCG...eAGBCEFE.KHAEFCCCGEEH.EBCEVFAE.ZBABICAGhAAA.SEADhABALADCAGGDBDHHhACADFIBMAHHWFDDPDDG....NAIG.hAAA......hABA...,1,-11,-43,32
XOFSIZEKPYCdgfGcQRUTDWHJaNeMbBLVA,XFGAFBFBZGFAKBAF..CAEH.dCCFGDAH.QGDGTFAFDDHFhAAAJAAH...aEFGMDDHhABABGAFAEIB.OBFEhABAEEEG...PHFEfDBG..cGADhACAWHCG.eADD.hACA.LAEE.,1,-5,-26,21
XYKagNWIFReZGDdbOfTPCVMESJQcHBLAU,UCCHKAAB..aHCC..NBAE.FCDGZCGFDBID..dFBDOEFA..hAAAfGGCCGDA.hACAEFEEQBFGhADABHAEABCA.XGAB.gDBDIAGD.hAAA.eCFDTGGEMAIFhABAcEEC.,1,-28,-31,3
aQSBeXZWPgVdTNDORKfILFCcMHbYJEUGA,aAAGBABEZCDE....PGDGdHABDFHHRCGF.KEEHLCCH.FAEChAAACAEEMCCAHCEHJDAFUDAEhADAAAHA...eHEGXGAGhADA..WGAE......hAGA......hAHA...,2,-39,-23,16
eTVSMLNERgIJKDcfGdBOWZCHAXQFaYbUP,FEEBaBFE.UBCC..TECCMHEE.LDABRAAB.JHFGDAGBGAAHhAAABHBC.OEEACDGBHEAGhAAAADCAQGBDhABA.bFFGeDHH.NICBEAHF..IAFChADAKBEH.....hACA...,2,-28,2,30
DQTbESBAXMCdFLPgeYIGZcWafJOKUNHVR,XADEdECFLCAD.eAAGGDCAZGEC.aFHDOHAAKBCDHAGDDDGB.hACATFEEEFGA.AEAHCAAHFBEBhADA....gGABhAAAICCAfAGDUCEHRCABSHGGhACAMDFFcBGH.WFAAhAEA..,1,-1,-13,12
LYVDUAHGNePfFBOSgKEZMCQRbaIcXJdWT,HCFAeDDFFCGDBFHF.SFFHKHAEZAAA.CHAE.QGFDRBBH.hAAAaAFCIFCD.hABAJAFEdDACLFEFhABADFEGAAGGPEHDfEAEOCCBMACE...hACA......hADA.cGCE.,2,-17,-15,2
CXNfGJWTcEeZPIOLdRUVagQBbKHFDYSAM,XBGDGCFGJHBA....TEGGEECFZBAEOEAHdBEERFGH.aDEBQAGAhAAABABHKBCAFFCDhAAADEAAAFAHMADE.fEBFhABAeABC.IHHF.VFEB.hABA......hAFA...,1,-7,-17,10
RLMDfcSXFICaGUPeHTOQKENgBVYdJZbWA,REFCMFGDDEDE...SHDAFCBA.aBFGGEAE.eAEDTCDGhAAAKCHHEAAGBEGEdAFFJEBBhABAZGCGAGAHLDHBhACA.fBBGIHHDCCAD.....hADA......hAEA...,1,-23,-31,8
DNGgbBIdURQWLCYZPHaOeAFEcfXSMVKJT,FEGHECDH...XDAFSHBEKGACDFIBGDGG.BAGAUEDCQBAAhAAACAHE.PFEDhABAaABDAAAF.MDAH.hABATEBA.gBEBIHDBdCEF.hACAWAEG....hADA...,2,-48,-5,43
YGVFHLgdUIeXMOSQCbAafTcNWKRDZEJPB,aGECTCFH......NEDEKCFADGGHJDBCBBBAGEAEHADELFFGhAAAdAHGUFCGIBCBhAAAMDAESGABhABA.CCHBAACCcAED.REGBEBAF....hABAYHFG.FEFAhAFA...,2,-27,-11,16
fZYQOUgEIAaHGCPXdeSMcJLWNFVBKTbDR,HDBFCGHAdACB.SEEA.MCHDLFACFHBGKADGDHAGZBABOFEBhAAAEHGA.ADHBGBDBhABAeAFGJDDG....NAIEBDDBhAFA.RFFF....fBBEhAGA......hAHA...,1,-15,-31,16
BTJfIbGcRWXNVMYKLDUHedaAZOESFQPCg,ZACGOBDDSECDFDAA..QCFGCDAABBAD.JGFC..IEGHhAAAGGADRAACXBGGhABAMFDCKEAFLEEDhACADIEG.eFFBAFHGEBGGTGAG...fAGBhADA.WDHBhAEA.YCDD,1,-16,-24,8
WaYNVIefUGcFLZJRDgOEAdPQbBTSCXKHM,dDCHQCBEBAHGCFED.KEDAHBFF..MHEEaADC...VCFCeEHBhAAAGFAFFABBLFCDhAEARADDDCAHEAHDAGGC...TAAFhAAA.SFGGYFABNIEFIAFBhACA.....hAFA...,2,-29,1,30
YfaNOQSBRWTdKCbVcXMHZJUeGDPEAgLIF,LGBGFAGC.aBCFQDAFBDAD.TFBEdDECKAFG.CFHE.bEEEhAAA....XEBAhAAAMCIBZBCHeFGDDACGAAFFhABAICGDfGEGNIAH.SGGGhAIA..WABE..hAFA...,2,-40,-13,27
EgFQDNPceLSIfaAZJWOMdbBHVTUYXKRCG,ZCCBJFGH.OEABdDEDHACDUGFD..KAACGEEFFFAE.DGBA...hAEA.NEIA.eBBFLAHBhAFAICHAAHBG.MHBChAAABHEH.TFDDXADEEAFF.....hBAA..gCEAhABA..,1,-16,-27,11
WSgBPaDbIEZLMcFdGAUXVfNCRYQJeOHTK,UEBAVFEF.CBHH...QDFEOCBAHDFHKBDA....SHAGhAAABHDCDDAHEGADZEAEMACChABAdGHCABFF.XBBBhAGA.NDIA.JABA...eFFDgGCDhAHA.aBGG...hAAA...,2,-35,-3,32
bQdJYESRgKZONPeXfDWFVMTIaUBALcCHG,CCGFGADDdDBA.EEGCRFEGZAAEOCAD..eEHBDACCFGCF..TAEChAAAICCE.aECGADFDLAHBhABAHGEE.QGAFhACASAHHNIEF.XGAH.fAABhAGAWEDD..hAHA.MDFABCCB,2,-14,-5,9
GFfDYLBKQCSTdVNXgEcHUbRJMAaePIWOZ,aFDHeDFB...IDHHODCEGADH.FBAADCCFBFGGQAGEhAAACHHGdEAC.NEDCEGHBhABAUCGG..RADBAFFBPHAEhAAAZFAB.LCAASBBF....hACA......hADA...,1,-18,-22,4
FQOBAHecCUSEXJWKgYNGdbTDZMfLIaRVP,eEBDCFAHUEGCEDDD...JDHHKAEH......NCCBGFDBhAAAdEAFbDEB.DADAZBAALHAAhABARGBG.FAGCBHHFABDGSBBFhACA..WAHH....hAAA......hABA...,1,-14,-45,31
TJbSdKMEHXGYPRcNBZWDeAUOgQIFLVCaf,UADGOCFEQAGBFFCBLFFG..CFHEaFDGJDAD...dDBGKDDAhAAAMAAFECBG.GGEHhABARADGBHEDDICA.eDDAAHHC.hABAIBBB.fCHCSHBAYHAEhACA...hACA...,1,-5,-37,32
KEWTIfRZBSHQMOVGUFcYeagALPbXNCDdJ,LAAHXFGCDCDFdBEAEHDA...TEFBRABHZFAFSAEEhAAA.MDFEGFADhACAFAHHeHFAACCBNBIECHGFKDCBIGCGhABA.BEGE.OCEHcAFA..hADAgDAE.hAEA...,2,-26,-9,17
eAfNMHWLEKZVRIgaJOGQYcSCbDdPUFBXT,MHAGLDAEKDEEZCBDRBFH..aACDGCGA.QAEFSHBEhAAADAAHPHEEBDAEeEEBhABAABEEHECCEGGD..IEHHhABA.gFGG.JEAB.hACA......hADA...,2,-25,-8,17
MKGYHFeDSbBgcATNJdOWVPRfCQIaLUXZE,JEAGdGDEOCBG..VAGFRCFE..CGHC.aCDGLAAG.ZDDChABAKGFEHFBFDFEEBBBChAAAAAFF..TAGF.hABANCAG.fAEH.IEHF.hACAEFDDMIFG...hACAFFFH.SEBF,2,-53,-1,52
SWAdQMBYKCNXgJHcaRefITEDGLbZPFVOU,QEBCBAGGCFHH...XGEBHDABaDCGeCDG..IHFChAAATAFGEACCLDFGhABAPHACOACAUAAGAFAEhAFAdGDGKEFANCCB..gEEG...hAHA......hAIA...,1,-13,-21,8
SNMDQWfcYXJTUFHKCBLZgGRabdVeAOPEI,OBDBEEDC..ICAHMHDCDAAA..QFFC.fCGAhAAAcEEHXDAEhADAUGBAKDCEBBHELHEAhABAZDFARAFBaFABdBEHACCE.SFADNIAD.hAEAWAEEYHFGFDHDCABH.hADA...,2,-18,-13,5
XWGKPbLNVSMCTdcBYaQDOUJREHgZIFfAe,XDFHKDGBLEAC..VACCCGHHdCDHBFCB..QFEHhAAADEIBOHBEJAGDHDDDZACGFGAAhABAAHIDeAHF.GBAEhAAANICD.SGACMAIB.YHEChABAaCAC......hACA...,1,-13,-17,4
fgZPXCMGKNYDcFLUReBHEWdJaVbSOTAIQ,QCDAZAEDCDCAGEGEKGGE.DIBEFCHF.LCAFeCBBBFFCHGDGdAEDhAAAaABG..VCGDSGBHhAAAAGCG.IEFBhAEAPFAHMBAH..cAGG.ECBFhBAAWFDB....hABA...,2,-31,-3,28
aFHeEYGbRdPDNUZXOJCKgTIVBMfQAWLSc,SBCGFAEFeBGBGDACdFHCDEFHZDCH..OBBHKFGB..IBBFhAAABHEBMGBG.AADGLAFChAAAaEEE.EHCEhABAYAHHRCFE.NIED.JEBGCCED.....hABA......hACA...,1,-21,-26,5
YTQScUZFORdNeEfbCaJGXgPDHWAIKBLMV,BBCFMIEG...TBGGQEFE.SEDFZEEDFEGDdCDFEHAChAAACAAFGEBC..hACAgBBHDIDGAAFHKEAF.hADAYBFA.cDAHOBBHeFDHfGHAhAEAaABB..XFAGhADA,2,-37,-8,29
GDcFVBTQfMZKLXRCJUaNbdWOISEHYAePg,eFCHGDDDFFEDBBBG.QGBGZBFBLDBDCDBC.aBCCdGGGOBABhAAASADD.EBFDhAAAAIFADFAD.TGGEhABAMFIFKAHDJBHD.NEAG.IDDH....hACA......hADA...,2,-21,-20,1
YIZgeaMUVfNLcWJPGXbCEFKRDSOQTdBHA,ZBBBaEFA.MEDAUDAH....VFBCLFDC.JCCAXGFChAAAEBGA.RBFADDDEOAAChAAAdAEFBHAE.AABGIEHDhADAgGBG.NACH......PFHDhAHA.CBFCSCGAhAIA,2,-36,-18,18
gELHfDGNYaBKbeVPSMIJcdXTZQROUFCWA,EFAHHFFCDEAEGBCG.aGCFKCDE.eHACVAGBMEIB..JFADXEFHhAAAQBAGOHCEhABACACCAEAELFEFhAAA.fCFGBEEBPACE.SBBDhACA.IFDHhAFA.TCGE,2,-17,-10,7
JYXBbSTHAcLQaUZNKIVCERDGOFWdPegfM,QGGCUEFAKDAB.CCFA.DDCCFDHF..dHDFeHCC..MAIHJBABBHAFhAAA..TAFHhAAAAECFaAFGZCDH..IBCHhABAEEAHOABAgECA.fGHChACA.XADFhAHA.,1,-22,-53,31
gAacXNLHWDUMOKbVJIBZFYTPECQdRfSGe,aCDEXEAHHEBCDGEHUGFC..KBAD..JBDCBAFEFEEE...TFGChAAAECAGdCCARBGFSBDChABAGGBDAEADLAHFhAAAMEABOHAE.bEEFIABD..hADA......hAEAYBBBCHHB,1,-10,-21,11
JbdQSacZWTILKMRUHVFPDXNBfGOEYgCeA,dCCGQDACSHBEaACB.ZBAB..IGHFLEEG.KCFARAEFVEEDhAAADGHBBHAD.OACAhAAAEBGCCGAAAIDA.JCHBbAFEhABA....cDCDTGECMIFA..hABA......hAEA...,2,-21,-18,3
NTIeEdHSAaWLJDRCGbFVQPMKXgYfOcBUZ,aCAHJBGD..DHFACEHDGEDC..FEGDQBCCKEAB.XEAEhAAA..fADAhAAABDFBUGGCTDDHhABAIAGE.ECHDSFDGAAIDLABERCAGPHAEhACA.MEIBhADA.OAED.,1,-11,-33,22
fVRdITQaMcFGSHeDNUOBZbPgEWYCJAKLX,LEACVFBE.RFDFdAGCQAED.aDADMCFD.FHFESDEEhAAAeCAAUDGFOACBhABABFBFZAAG..gGFHhADA.WBHHCHBGAGGAKAHHfHDFhAEA.TEEG.hAAAcGAH.,2,-18,-12,6
IFZLYeJOSMGRbWTcaHAUgKXdNPCEfQDBV,KDBHdFCHCCBGQFCEBHCD.FCHFZFFF.LAHFeBDH..SGGAhAAARBEB.TGAAhABAaEADABIDUAAF..hABANADHfBFEDEIF.ICADOADB.hAEAbEEFWEHD...hACA...,1,-27,-32,5
TFaYUEDgCIeWSNBZPcfdJQOLbKVHGAXRM,MICATFGEFBBD..UFBDDDFG...ICACeEFA..NECF.ZEEBhAAA...fCFDhABAJGCELAEEKDCFHABEhADAAAIFaGHH.EAGC.CCHBSGADBDADdABFOBFChAAAbDDF.....hAEA...,2,-25,-12,13
eAWRDUfbZMVTFIEagQSHCJcKXBGPYdONL,DBEFUBEDZCGFMIDAFDBD...EFHHQEED.HAABJDCDXABGhAAABGAGGGDHdFEHLBHDhACAAICE.fDAChADAbAFG.TGAB....hAEA....aHGECCCFKEEEhAFAODDB.,2,-16,-7,9
QdeCfRWBYEHMZKcFUNIVbSDgGPLOXJAaT,TEFCQECB.eBEBCHEERACE.BFGBHDCGMEIBKBAAFAGB.UFAChAAAIBBE.bAGHDFDHhABA..GEAA.hACALDAEXCGAABABaGEFdGHC.fAFEhAAA...EGGDNIAH.hAEA...,2,-17,3,20
ECTUcaWGFNfQdIHXYVJgKbPeDRAMLOSBZ,MFGFLCFCBFAHCDHDUCBG..aABDFHBAQCGGHACC.XEBBhAAAJEEFKAFE.eAEDhABAAGHC.OEHDEAAA.TEDBhADA.GGBHNDAE.IAHA.hAAA...gGGGhADADBDB,1,-18,-32,14
STeDbcEIgPUFYHRfXNQZAdVWBJKaOCGML,dEBEBDEFJCAEKCGF...CEBDLEHFeDDHDAIH...EHBG..IHAChAAAUFEFFAHBHGDChABARACF...XAEHhACAZFACABAE.aGGAMIFASABA.bAGHcAEEhAAA....hABA...,1,-20,-33,13
EVdRDFMfQUJWBZKaOLYTbHIPSNXcACeGg,GBCGEGGHREBC.DFACMDAGQGEA.UDGGBAEHZBABaCHDLGAGhAAATGAH.HCEFIABHhAAASBGG.hADANIAFAACAeEEH.gAGCdGHA.FCEB.hABAWDGF.KHCG..hAEA...,1,6,-23,29
CJfVFdPZAWYGNSBIQMgTXUHcbEKRaDeLO,GEABSGCCBBBDMEDA..XBEAHCBAEGHHKDHBRBGDDAFBOFDEhAAACADG...fDEDhABAdFFAAEIF.NIAD.IGAChAAAQACF.gAGBcBAGeEAGhABALDAC.JFHHhADA...,2,-16,-10,6
LVNRfHXWMZGeQYIPJFKgCUODbTAaEBcdS,aGAEBGFF.dEBALCDFRABCHDDD.MBFHGDGGeEHHQAFGhAAA..IDBEhAAAFCACCHABDAIHAGECEACG.cDGGhABANIDF...fBGD.XGDChAEA...WHFAhAFA..,1,-15,-23,8
WfVDGeRbYTFUOZPAaJSXMLQdKEgICHcBN,SBGHLBFHdHEBEEBBCAECBFCE..fGBGDGAEGBBHeEFHhAAARFGD...bFDBFAAChACAOBBCAEDG.aDAAMIAChADAKAEHIDDH.NAIE.YBHHhAGA......hAHA...,1,-7,-31,24
SfTWGNBDIYXLPHKQAcUOgFeCEMVJZRdab,OCGDFBBFeFDF..CECE.ECFEMBDGZFFCdAFB..aGAE..fCAEhAAATCDDGGDFhAAABECADEABXBACLCHBhABAPDADKHEGAIAEcAGA.....hACA......hADA...,1,-17,-23,6
TfBDbYcKWNOdaFReCQEHGISLUgXAVZPJM,ZDAAJBCC.MBIBBFHDDGAH......bEFHKFEE.OFBDdAGHFEAFhAAACHGCHBCEGDDCSAFChAAALHAGXCAAhABAABBF..TGDAfCFF.WACEhAHA..aBGF..hABA.eDGBECHF,2,-21,-17,4
SdIPNVWHLJFEAMDUbXgZfGCBeQTRaKOcY,UBDBXEDEZBGDGGCBBFBA..eACCREAEKAAHOCAF.SAGHhAAAdFGF.NDIE..hAAAHCCGFGABAHIB.DDEHfGEGhABACACF.aDGH.cGBD.IGGDhACA..WAEChAIAEAFH..,2,-35,-21,14
fUZVTSPaNQDeIFLGbWEBgRXOJCYdMKAcH,HAFHUEECZACGSHAE.aGGENCIA.DCDEFEABLABD.GDDFhAAAEBGDBHGEXEBChADACAHA.MIFCKFCBAAAAfHDHhAEA..TGAC.eCDEhACA.IHEG.hAFA.gEGA.,1,8,-35,43
BKNRGYLVSdQWHFbDCIPEUcAZJOTeMXgfa,OCDDTFDF..eBAGMACB...XGGHaGABKGFGRCFDGDAGhAAALEAAdGEGHDFHDGIBIBEGhAAAECGGAICAJAEGBHCHhABA..YBADSACCFFCDCAHAPBHDhAFA.....cDDAhAGA.,1,4,-22,26
NPAJcUgfWXKIOaZTCGSdVQLHFYbMDRBEe,UDFF..fAHEKAEGOCCDZDEAGEAAVAEDHGDA.bDBBhAAADFGD.RGCABAAH.hABA.EBBA..NAICAADGcFFAhACA.XGAHICAACEABSDGEhADA....hAEA...,2,-41,-3,38
USLcOWXNgGYCFJTQfEBdAMPZRHeaDVbIK,MFFGZABEREEAHFAFDGCH...VAFDKGGFLBCG.OEDBhAAANCICGCCACHEB.FCAHTEAEhABAEGHDBHDA.AABE.aAEAhACA.....IHAESGGDWDBEhADA...XAGHhAIA..,2,-27,-16,11
LUGJcNXDgeaSOYKfZbTVRIAdBQEMFHWCP,QDEAEAAHHGDCCBFELADFGFBF..JACHXEFFDGGE.aHAGhAAASHAA.hACAODAEYEBCKAAHbAFChAAA...........hAFA......hAGA...,1,-23,-26,3
JcMYeNfTGDHCbRAOUaIWKPZLEFXVdBSQg,OBGFaCFH.KDAGLFGB.FGBAdHAFBBFEQEDE.hAAAJACGYBAG.hAAAeEEBTGGGDIACCECDAHFDIFBBhABAZAGDECDFSFAFMDDC..fBBGhACA..hAGA...,2,-39,-20,19
HaEgVDCeQFbfIJOMLKNAcZGUdXYWBPRST,ZEDEdAAF..XFEDBEHGSHAGHCCBaDHB.EABGDCFH..eBEBhAAAFHAA....IADFhAFAMEAAKFBBAGGGUAGEhBBAYHDA...WAFERFBE...gGGBhADACHHA.fCDEhAEA,2,-27,-24,3
dgEIHJfXFVTOSANReQKWMCZaUPBbYDLcG,eEAGQAGGMEGDZABFaBCH.BFHB.DAHDLECE.GGBDhAAAEFEHHADDXFGGhABAFCHDOAABAIAEKAEGCEAH.PDFGhACAYGAGdADGIHHDfDEC.SAFBhADA..hAIA.NIBF..,2,-21,-1,20
TDKdFHGPZNOBfIUAbYCMEaXJcVSQeLRWg,CAFEEEDB..aFDG..XDAE.VBFCeAAC.LAHBhAAARFFE.gFGFhAEAKBCBFGADPHEENECD.BABBhAAAIHCFADIDMAFGcBEA.QBCHhBCADBBD.....hADA...,1,-18,-24,6
WHUSVAIgRCMebXDNKGQaBcJPOLdETYZfF,RACAMADAeDFADGHBGDDCBCFD...JFCHLCAHdGHA.ECCHTBFBhAAAZEEDFGBDHBAB.SGFBhABAAEDBCAAG.XGAHhACAKBGHaEDD.OAFAfDHA..hABA......hACA...,1,6,-38,44
HSCGAVJTYDWFOIZcagKXQbfMBPNRUdELe,VCFBJBAF..DCGHOHBAZFED...aHFGKDDC...QFBGhAAAfBAGMIACBFCHhAAARAGB.EAFC.LADDhABASHGECFGAAFFFYCBBFAEHIEHD.XBBFhABANAIE...hACA...,2,-27,-26,1
RAbHcEIOGFBXTLWJeSVdPfCDaYgNMUQZK,HBFFEFGAGDBFBFGALFEHeCGH.VABCdABBCFCG.DFFD.aHBAgEADhAAA.MCIFhABAQAEDZECFAHIHIHBFhAEAOEAHFGHD..XAGB.hAAA......hAEA...,1,-5,-20,15
UZdMfSIcKaQWEOLXFYPGJAVgHTBNRbCDe,HDBDBCEHRDFGCAHHDEIDUDBFZADD..dHCH..MFED..IAGChAAAaDFF..EGHDXBBBhABAFBAC....hACAYHAEPFHFAAECgAFF..hAAANDAAfFFEhADASFFD.QFBHWDAF,1,-21,-25,4
UFTRbJXVPKCdLQYaBGcSAZEDgMOIeHfWN,ZEDDDGABOHCAeCCCHEAF....NDGE.UDGE.RAFAJAAD..hAAAPFCAKGHDCAECLHCAhACAaACDBCECGCAGhAAA.AIBGEAFC.MBHDfFFGFHGE..hADA......hAGA...,1,-18,-24,6
WJPZaeLRdEVASQfBcbUFDYHNTOIXCGKMg,SDGABHGFUBDADEIFHBDA.OAAG.CAGCGDECKBGGMDHHJAHDhAEAZCAFLCBH.hAAARFBAdGHAAEAHQGAChABA..fHFHFGDENADH..IEEAhACA..WFADhAFAeCCD..,1,-10,-31,21
VGcWDFYgMbKNXefQZaISJACUETLBHdOPR,CGGDUFEBLCBDdBECRDAH.GDEB..DIEGFGACMBIBKGCE..eACAhAAAQAAC.ZDDGhACASDCBAHBE.hADAEAFCBFHDPHDEcAGG..WCEE.hAEA......hAFA...,1,-20,-35,15
fRJUCWgNOIVbZGFeaMSQPHLDXAYcdBTKE,dFHCBGGAEEEHJACE..CCAH......NAGG.IHCHZAAC.GAGGhAAAeECFMEBHQDCBhABALAEBAGFC..hABAcGDFKGFD.fBEFWHAAOAHBbEFAaCAGhACA...SGAChAGA,2,-33,-23,10
NgYfbAIBUJeHEGTcMdRDVOXCQPSKFWaZL,BBFDeBEBHGDCGFDDTCABdCAFDABA..OFAGQGAFKEGFaBBAhAAAZDCGLAGB.hAAANBIE.fEAGhAEAAHID.IDHCEAEGMDEF......hABA......hACA...,2,-30,-6,24
KNPJTeUafOCSALZbdFHDEIRMQVBcYgGWX,LHBEZCCFFGGCDDABEFDG.RBCE...MBGDBAAF.....YCGHhACAgGAGXDAChADAKAAH..JCEHTGGBhAEAaACA.CDDDACIBdDBAIFBF..cDGEhAAA...WHDGhAFA..,2,-33,-33,0
VTGXLYIaJDHWdCUcEZROPBbSNFQAMKefg,MADCKFAEeHAG..VCGDGDBFLEBAaBCEHAAH..CCEFEHBEhAAAZEGHRGCGOBAABAGFSADEhAAAQGFHAAIH.hACA.gCGE.YFFHICAHhABADAIHWAEA.cGCAhACA..,2,-20,-7,13
RDaJPfbGYEcLUZCeIOSKAVXMWHQFTNgBd,MBDGHCABQFEFFDDD.TCFEBGADREGHaHBGJBAB..fBBDhAAA.bADBGGCFhAAAEAGDLEHFhABACBGAeCCCSFAEAFCFXDDGNIDBDIGG....hABA......hACA...,2,-37,24,61
ebJQOfGdgWMEPZUVTNCILSFDcABKHRaYX,BDCGKECDRACH.aBAA..eHDCQDFFGBFGdFAEMAFEZFEC.UBAEhAAATGBH..CDEGLCHHhABASBDFDAEGABFFXGDBhAAA.JEADfHBHWFHB.hABA.EGGB....hACA...,2,-27,-13,14
CYFScILRGbMJdgTaDeNZHQXEKPWUAVfOB,VEDDBHBHCDEA..FCHF..SAGGLCADRCBCGAAC.MDGBhAAAdGAATABADCGAZDCDQADFhACAKBEHUGGEAAHAOCFDhAAAIHEG.bFGH.....aDHFhAEA......hAHA...,1,-15,-24,9
HdDNZEVTOQLXbPcBACWaSMgReUFfKYGJI,CHBFSEEDRBFA.FBHBKADGGBCCHFFGdHEDDDIH.ECAE..TBAHhAAAQECBLHFEhABAXCCFbGAA.BDHBhAAAAEBAaBFFMAFGeDADfDAGJFFA.IABEhADA....hBAA...,2,-24,1,25
RQJAEYPIHgGXOcFLVTebCaMdWfBDZSUNK,EFGG..PAGHHBADXFCHFDAHLCBETADFeDFB.CHGFdFCHhAAABCDDZACASEFChAAA.UBGBNIBFKDHFQGAEhABAAHIH...IHHH.hABA..ODAH.hADA...,1,1,-23,24
BJYCEfASNQeLIaObDdKXGgHZVFRPUWTcM,QDGGLEFDaCBHDCGA.KGAEGECC.ZAAERCAEUFDG..hAAAcBGDMEDE.BFAHhAAACHHCAAFB.SAFBhABAeABCOHAEXCDF.....gGGBhACAFBEH...hABA...,2,-27,-11,16
EOIVUJGBZPWHYSCbKNMaLAXRgFecTdQfD,REAFFEDFeEDBdBEGDAAD..EACE..OGFEVCEA.UFADBGGBZBADHAAFhAAA.CHCA.KHCGaHEEAFFD.hABA....XAFEhAEATBFG..QDGH.ICCDhACA....hADA...,1,-17,-38,21
eBNQIabCHKDWMFJPUTLXVcSOgEdRYZAGf,GEFCeADHBDEEQBEE.aHBACEGDDHCCFEBE.JDACUBAA.XCGBhAAASFAGOACGhABAEFFD.dGACZAAGAHIBNEEG.hAAA.IHAG.KFCE.MFID.TBFHhABA....hACA...,1,-2,-36,34
JgDUfRPdSKAZMBTVIEOXYNQCaGcLFeWHb,MAHDTDBA..VDFHEADH....OFFGXAEFQAAFhABACGCDGACCLBHDhADA.FDDAWFHHbGBEDIAGhAFAfBAGdFBHAHIDIHGBNAICaEBC.cAFGhAIAHFDH......hCAA...,2,-11,-3,8
NUcJAOCIBSdLeDGTMYZRVfWQbEPKgXHFa,OGDGBAGBdDCEDAFEMAAGZDAD...RDGD...VCFHQBEAhAEA.EEEGKBBEHGCGaHCC.hAAAUGGDAADECAHH.SEBFhAFALCEFeFHF..YBBEfDCChABA.....hAIA...,2,-25,-17,8
CKcVaQUTFRDANSegGLJbPBfWXEHMOdZYI,SAAHeGDALCAA.JEFABAHH.fCGHEGBAHAFAdGHGhAAAZFFACADGKFDC..aFDFQEAGhABAUGBGRAEFADCD.NDED.hACA...gABAPHFEXEAChAAAMICG...IDDAhACA..,2,-15,-4,11
bTVZKYIcMOaSPJXHDLEdfeGQBFUWCgRNA,VCFFKGBE....IAEFMEBF.OBBDSFFD.JABAhAAADFCELCDHEGABdFFBeHEGhAAABHCDFAHHCDHDRBFAABBH.hAEA..ZACHcBBC.XGGD.hABA..fFCEhAFA..,1,-18,-30,12
MOeXfBNFRGSgHadVJUKTEWcDbPLQZYICA,eHDGXCBBBAGERAEB.GAAEHDFC.dCDBVECBKFBD....EEGBDDBDhAAA.LHCGQEDGhAAAIHGAAAEBMCIHOEAHhABAfAFGSGGEaGGE.JABG..hAGA......hAHA...,2,-14,-8,6
RGMYTXbFIKCfcSOLdVJBDZNPaEQeAgHUW,HBFHUEFCRAAFGDDE.MCAFTEDGFABGCHBF..SGAChAAAOFACLFHFdCCBBHFFDIEEhAAAZDAEaBDGeBFAAECC.gGBAhACA...YADGIDHEhAEAKEHB..fAHEhAFA.,2,-20,-5,15
OfDHQBARPGUVSCYIWLNMgKeFcdZbaEXJT,RGDEUECFCCBF.....IADCLAHBMIFCeFAH.FBEGdAADZDCDhAAAEGAG..XEFEhABAJAFE.OACGDFGCBDDFhABAAIGC.......PGEC.hAGASGCHNEICKCFB.hBAAbBFAaHCC.,1,-20,-31,11
DaBIbMJfQeEGPdANUFTVRcOYHSXWZKgCL,FGHBTEGFRBBF..OAEESDDF.ZDAHKEAACHBE.LHAAhAAABFDAMHDGJEDC..QGEDhABAEBCCGAFGADDGUCGEhACAYABE.WFADDADE.....IHHEhAAAfFCC.hAFA...,1,-23,-26,3
JdKDfXeWCMUTIQgRHAFBNLSOPZVEbcYaG,BFFELFFHSAABOCAGZDDD.ECFGbDBA....aAGGJAGFhACADBIDeFDD.CAECMFIBhADAUFBGIHHFhAAA.QADBgGEBAFHENEACPFBB.hABAcCFC...hACA...,2,-20,-20,0
MRXFVAfbUDIPgJGTeSLCdZKOYNBaHQWcE,UDCHDBFE....PCADJHEGGBDH.eDHBCDDGZAAC.OHCAhABABAAFaAEAHDFA.QGAEhACAEGDA.MCFGhADAXDFDFGGDACEHIFDDSDAD.KHAEhACA.WBBC...hAEA...,2,-23,-23,0
XRQEFBNCKbfMWcPagIYDeSHOTGAdLZJUV,ZFFGVDCDQECH.EBCENICF..CCGD.KGAH.MAFH..PBBGhAAAaDAD..IHHHhAAAeBADOEGDGAGGhABAAHCGJAHF.RAEFBGADfBBG.cGDChACADFFFSGHHhABA...,1,-9,-27,18
HGLeaOICgAbWNcPQBDVJKUSEZXFMRYTdf,...NDBF.QBFCBEAC.VCBHUGGBEHFGFADDREDG...dGDEGGAFhAAAeFAF.aADBCABE.ACAA.hABA.bEGF..PEEGhAAADFIDKAGEZFBB.......YBHHhADA....hAFA...,1,-1,-37,36
NTHEbYcROXZFGePCDVdSLQIfgWaBKAMJU,JFAGTAEDHDGH..EHCG....bADARBBCXCGAFCAH.eDFBhAAAPFDDDEHDSEDHhABALGFGQDEEhAAAIHHE.fHBBaAGDAIBGNEAC.cCDGhABA.GABGCABH..hADAgDABBAHA,1,11,-5,16
QaRUTYLOSeHFZfMEdWbNDgCIVGBKJAcXP,XBGCQEGBUEEFLDCB.OEEHHCAHFHAGZAEAEFACdECA.hAAA.NBAB.DICA.CCAE.IDHChABABCHAKBBCAIHCaAFAhACA....TCEHSCCEMAFGgGGAhAAA..hABA...,1,-16,-23,7
gKbEfROINJCMcGYaHDUFAdBTXVLeSZWPQ,BBDCXFAELDECZBDB.QFFFKBFAEEAA.OHCE.JABFhAAAMAEGGEAFaHEGHAAAhAAAFAHDAAGC.TEGH.hACASHBAWFHHgAEBfDFHIDAChADANAIACHHCYFDAhACA.DDAG.,1,-11,-15,4
GJPcXZgWTEOSDBAKIfFQaUHdCYLNebVRM,KAFBFGCDUDCGHBCCCDEALAAH..NBIG.eBGH...RFAFMEIBhACAJHCE..XCAHhAAAZFEG..TAEChADAOCGFDEAGBFAAAEECfHEHaADGdHGD..YFFAhABA...hAEA...,2,-25,-22,3
dYTWELUPaBbFCMJIeDGZXVfHRONcKQSAg,dABBTGDBLFHH.aCGHFEFH.MFBFeCBBDDDDGFDHZBAH.VFAFhAAAHACC.OAHDhAAANICD.KAFCQDDGhAEAAHGGgCFB...WHFAEAFHBDHE.hABA.CCCF.....hACA...,1,2,-19,21
JVdPGcZFYAIUefWBSgbQRONHCXKDMaTEL,UBBGeADFBHAA..SEGEQFGGRAFEOFEECEEADCFCMIDEhAAAEEAF..LHAGhAAAdCAAGFBDZEBDAIGE.IEEHhABAWAHB..bCECHADBKABE.aHFG...hAFA......hAGA...,1,-5,-22,17
MGWTNEfVJDXLdKgcePZbUBRCSIaYFOQHA,MDCHGCCA..TAEBECGEJHAE..LAAFKEGD.eEEEZAEHBGHHhAAACDHGSGAGhACAaBAAFDAH.OCBAABDA.fGGGhADAXFEDdAGBcBFE...PEDBhAEA....hAGA...,2,-23,-22,1
HKNFgPESaXBMbeTLUdGcCfVADQJRZWOYI,QEGDJFCDZFFH.OEEDHDCCFCBE..EDBD.aGHHMEIFeADFhAAALCFAdBHAGGABhABAfAABDAFHRCDHIBBHhACAKBGE..PEAHSAGFBADH..hADA......hAIA...,1,-2,-22,20
INYaBLKEcZMeDFVbXQUWfPGRHACTOdSJg,ODFDSGBE..IGAHaBEGBGAGEECEZFEB.DCCDFBBF..hAAAXGGBUADGPHEEhABARAAHAEAE..CDFA.TAFHhACAdDDAJCHB..YCHDKHBAMAFCeEHH.hAAA......hACA...,1,-14,-22,8
MPQTHgEJLSecUNaGCIYKdFAWbOXfDVRZB,OBFFXGACDIGGRBDC.ZFBBBHGB..MHDAQDAAHBAAJDBELFDGhAAA.eABAhABANAAHGDGECEHGKHDCACAE..hACAfAEHPAFA.gEEDEEECSCGAhBAAaAHF....hBEA...,1,-11,-12,1
cQWDNUBGPdSEgCXbaAOKRMLVfeYHZJITF,RCDCVBDGeCAH.HAGDZDGF...TGCH.FEFGQCAGhAAADCCHBADEdGGDEGACCGFB.bEAEOFBBhAAALHCC.fABDhADAIABB.cAGFNIEF....hAEA......hAFA...,1,-9,-20,11
PaGYLOVCABgcZJUXMKHTReEQDWfbINdFS,BHFGZBFFJDCBMCAH.KGBDHFAF.eBBCDHGC.....bGFAdBFEhAAAFEECPABA.GECDhAFAOAABAIDE.cAGAhABATBDE..EDAHfCCGIHDAaCDAhACALDHB.CAHC..hADA...,2,-23,-16,7
WDABeObFUGEPfLcIaSQgKMVXYdCHNTJZR,BGGFOEEDFFABUBGDGAAH..ECAGLDCA..aABCSGDFhAAAQEAHMBHFhABAXDCEdHFDNBIEZBDGhADADFIHAHAE.eHEA..fEFCIAEDKDHDhAAAYFBBHFCB..hAEA...,2,-25,-7,18
ADBSadVEeKcfHgQPUYFWGZTNIOXRbCMJL,DHDESDDGdABD.eBFBKEBGHEFE.QCGBPBBAFDHDZBCGhAAA..IBHChAAAOAEAXDDFCFDAMBADAHDFBGFDhABAaHCCEHGC.fAHCgFAC..hACAWCAF....hACA...,2,-21,-20,1
OHDfgYBFWQNGaRCXEPcKSZUAMLVJeIdbT,LDHHVAAE.JAAGeCDC.dGGHOEEBDIEA....fEEEhAAABBDAQDBAhAAAaAGA.CHCHXAGDhAEAEHBCKEBDUDGDMFBBIAEDbGFG....hADA......hBGA...,1,-24,-25,1
MNUfWQDEHgFKeGScbaPOJYTdRBCLVIXAZ,ZDFFUDDHQBDBDFGAHGDE.FGBBKCHDGAGE..SABDhAAAaAADOEBEJFAFdFHABADGhACACAEF.LBFCXDAGhAAAAHHBMDCHNIDB..fFEA..hACA......hADA...,1,-10,-30,20
NUGSMHXOcAfZDbWEeJPFQCVIaKLYBRdgT,DCHHEAAB.eCBHFDDB..CEHA.aEAHLBFA.BGGBRGFGdGDC.TACDhAAAUDAGMHBAHEEEXGAEhABAAAGBZFED..JACEhABA............hACA......hAHA...,1,-20,-33,13
JKeBGYOEZLNCVQPMdFScUXAbIWDRTaHgf,..IBECDAFCaFCFHFEA..JGCGKDDEGDBHOBCEEAGGLAAAhABACAAC.QBGDhACAMFFCFGGDSEADhACA.UCGBXEABADACWHCA.TBBChADAfHFH..hAEA.BEHG.,1,-12,-18,6
MHNEVRBgSKFePDWQXbOJZGTaLdAIUYCfc,UEEFCAAB.MDDEEEBGBCBG.KGGAFAFD.DCCDQBGC.hAAAOACDZBADaEHDdFACIADGhABA..YFEHhACAHFAE.NAEDRDEGSHDA.WAHBhACAXGCD..hBAA...,1,-28,-31,3
MXVRNdGFaLbSZcAeDEWgTHPBYJQfCUOIK,EFAATCCBBDAG..QBFHCCEC.OFAFIBAGKADCMHFEhAAARFFDGGADLECGhABASDGEAGEHDDIFWCAFhACAHDDCPAFE.fFHG..hAAA......hABA...,2,-28,-18,10
cbYXOINPAgaBLJUWTSFKRfMdDCVQEZHeG,BGAGUFFH.SEGBFCCBRAEC.dACGDHCGCCFB...EAABeCDH.GBAChAAA..bDADXFDEhABA.IAFEhAEAAIECaAHD.LHDAJECEKDGAMCAB..hABA......hACA...,1,-19,-35,16
CSaJZHWcDPfYQORGUXEFMBgNTAIdLbVeK,dDBCVEDCKGBF..CCFG.SAHHZDAD.HGFADIAA...fAFHhAAAQADCODGFhABARAACXGGDEACCMCAEhACABGCFTCECAAHF.bECBeDHB.aAFF.cGEDhAAA....hABA...,1,-4,-29,25
VcPCBFNGOEYJUZaAeQgITDHWMRdKLXSbf,eCECQCEG..TFFGDIBGMBBCdDBFKEBGSDAD.hAAAVFFAPFAH.CACCBAEBhABAFAGENCCE.OEEGhAGAJEDFaCHFAIGCIGDE..WAACXGBDhAHA..fGAChAEAEBCA,2,-28,-28,0
MaXCPgANHSDBZOeKGWfJVEURQYIFcbTdL,HECDDEBDOEDAeCEGKEACGDGG..fGHEEHAA.RAFCQAADhAAAICFGFCCGbEEFhACAdAABLCHHaADCCAFEAGIBBAHDhAEAWADF..UGAD......hAFA......hAGA...,1,5,-27,32
HSGDRTIZgMOaAXfBePNJbCEKVdQcYLWUF,BFGAeCBC.JFACCDHHKCFA..dAAH..QEBELFFFFDFGSHAEhAAAGADBDDDFTGFAhABA.ZABEMBIFOEEChACAaHCC.ADAF..fAGE...hABA...NCECEGHH.hADA...,2,-30,-29,1
EfWUGBaHMPgbCNcSKTdYeDXRVIOQFLJZA,EBDEUAAABDCBMGDE......PFDFCAECSFCFdCHEDGBDRAFAhAAAOEFE.FDEAJDABhABAAAGB.GDFEHBFCNIBDKABBhADA.eFHH..IDCE.LDADhADA.fHGFhAHA.,1,-18,-31,13
ZPKbXEcaGeLSMHJBCdDOVRQYFUAWIgfNT,..IFCHfGBBZCEA.KAAD..EFHBGDEALHCGMDIHBEAFhAAAdBEFDDABVABHQGGGhABAFGABABFD.NBCE.TEEAhABAXGDD.aDGF.SAHHhACA.CEDC.OADG.hADA...,2,-16,-14,2
MPRNaWZHdCJEGDBKgeTOAXSbQUVLFfIcY,XBEESBDEUGAEFCGB....IABEMBAGRGEG..aFBAZFGBhAAAHCCECCCFGDAC.hAAADDDDBFEFKFDGeHAAhADAACAH............hAEA......hAFA...,2,-31,-29,2
VMAUHFfGKTPbNBcCEdXgWaZYQSJLRIeDO,FDBAKCDH...TFDA..NICDBCGDCBCFdFBG...XDEDhAAAaAAFZBEDQGGFhACALEABeBBBDDABMCGHAIHCfGGFhABA.bFCCcAGF.EDHFYAFChACASHDGRADGIEHFhADA.,1,-13,-32,19
XSKQAFMRVHedOCZaIUEGPTDBcbgJNYLWf,MBFEVACH.dACAZFBCUDFCGAFG..DGIHBEAC...bFEHNHAFLBAHhAAA..hABAWAABSECBhAEA.AHHFFHEEeDHFaCGAIHABEFAE.cGGHhACA.....hAFA...,2,-29,-21,8
cGZELKbDBRJCdHWfOPYVaeSXMUFQATgNI,TBAA..IGCDGDBDEFAELBBBKFGCBAEDCDFGHFFCOCDGhAAAPBFE.aADESAGAhABA.XGEDhACAFDDHAFFGNIBF.cFDGDABCJEAHdCHC.fHAFhADAeHEEMAABQGGBhAFA,1,2,-22,24
ZaUIWMYLDCEdRABScQbTgFeHNGOXVfPJK,BADHQECG..TFCAeFABGEECXGAGVBCE.JCFGhAAAZCACUBAAIBGGhAAAMEIDDAEGCFGHECEF.AABFSFEHhACA........hADA......hAFA...,2,-38,-13,25
ZfeIWOKNCaFYRUXbQLTAJSVgGEDBHcMdP,SCAHGDCCBDACMAFEdGEAZABG.eBEAIDFC.OFBChAAACEHEaBHD.RFFA..XCDBhABAQGAHAHEHJBFCEEEGhAAADCCD...PABEfGGBKDHH..hABA......hACA...,1,-15,-26,11
fHUOGdNBXSDELVaFKIQRTWZCAbcMeYgPJ,MFDFeDFD....PCDBJBAAHFGD.GDAEBAHBXADEhAAASCEGDIFGEAGAaCHDFCGAhAAAQBAH.hABATGBGWEFFAAEHcFGD...fEAHhABA.dBGANEEE.hACAKGEF..,2,-22,-5,17
gCXLNBEfDKSHFdMGbOQRaeUJcYZVIWTAP,CGFBLDEEBAAG.DDBDKEGGFAEAGACF..OHCAQDDDhABAaFFE.UCGB.JFAAZBCDhAAA.IAHEAACE.hAFAPFCGNHAH.EGHFfAGBSBAEMIAEhAIA.....hABA...,1,-26,-35,9
dbcJSgPXKMOAaWVDUZYCeLEFQGBRTHfNI,aBAHVDBDZFDG..CAEH.LDFC.QDBEGEGETBAEhAAAHFAB..IHFAhAAAbGCEJDDC.SAFAhABA.PBCCMIBCABGCDDED.eEHBBGAD.NAIA.hABA.dADC....hACA...,1,2,-16,18
WNTfKGcbLBESMFUPOHgVCYaXZdIRDQJAe,eAFBTDGCKCBD.GGEHLBAFBADBSBDBUDDF.PFBGhAAAOCHB.HAACCGHGXGAChABAdFCDDGAFAICCfCCEhACA.EFEH.MAFA.FBGC..hADA......hAEA...,2,-24,-15,9
DUQYPBdMVTfaNEZgFARKGebHSLCcXIOWJ,KAGFeFGFHCDBCFEG...XEACOCDEJEACQBBD.BADGhAAAdBAETGBEaHFEZFDAACIFhABA.GCGA.SHAEhACALAHHcACH.IBGChAAA.DFID.PEEGhABA..,1,-13,-24,11
aScYWJFfNEHCALQDVbUeRPIMgTZGXdKOB,DFFBUFDHRBCC.MIAGZDGDGDAG..dAFHKGDHBEBG.SCEAhAAA..cAGBhAAAJBAGFGHD.EGAGCAEEAHIFLEEEhABAQDEDbCAA.IACF..hABA......hAGA...,2,-38,-20,18
LIaPcgZfBDRbATYJUKNHeCdQSMVGXOWEF,TDGCUFDEKAFG.HAAGCFEE..dBDBMDCCGGCD.ODACEHFAFCGEhAAA.LEADIAHBhAAAaGCH..gGGBhABABADEDFGGAIHAJFAGNECH.SCAE.WAFBhACA.....hABA...,1,-11,-22,11
aKJWFCYLGbNIgVRdSZeQOUXAMPTHBcfDE,MIACHCDHBCFEDGGB.KCAAFCAECFBF.LAEGGAAF....IFFFhAAAgDEF.dDHChAAAeFHBUFADACIHPHEChABAfABD.aECFYAEC...hADA......hAFA...,2,-31,-22,9
OMUJBfgVDWaTdSQKZbHFGIRcLYePEXNCA,OEACMECHUDGGBDEH....VBAAaBDEdFFBKGED.ZGACHAFCFDGAGCAFhAAARDDA.LABGhACAeFFB..EFAFCBGEAIFGhADAfADFDGED.WFCHSGGAhAFA..IHHChAAA...,1,-16,-22,6
GHdTXRZEcBMPVQbaAJSWeFgOYCKLIDNfU,JFACeFEC.OBABCHHD.KFAEDBAD..UCECGEECdCCC.RBCHZAEBECHHBHHAhAAA..MAAGhAEAQGBHABBG.FAHBhABALBHH.IHDGfFHC.hAHA......hAIA...,2,-39,-20,19
WEAXTLDOdZKHMCNJPgQbIGVYRfaeUSFBc,TBABDBACdCGCKGGB..CCHB...JFAFQDEC.IDCAhAAAVFCD.RFBEeHFEhABAUADHBDDFEBFBLEAFhACAZEFGHCABMGFE...NIBDgADFhADA.....hAAA...,1,7,-39,46
ZOeMCbSaVNLGQXETfABdUDJKRcHPWgYIF,UABCKEEERABGHGCE..PFHB..gGGBFGCEZAEAMEDEhAAACHFH..aAFDLFFHhAFAQDAHXDBDhAGATCGBADBFDAIDJFAB..cEDHWHAG...OAAHhABA.SCCGhADANDDB,2,-32,-16,16
eOfPbTZVSdcHJWRFAINLEgBGQKUYXDaCM,LBFCEGDCBHAAKFHDXDEF..DBABCACC.OCCG..fBDAhAAA.PGEGhABATDFBZFACdEBDJHAAhAEAWAEEAEIH..NBBA.gBGG..hAAA......hABA...,1,-20,-50,30
gCJHDLVBZGdEefITbaUYFRWcOSQAMNXPK,MABAXDAEKGEE...CFHHHAFCLFBBBDFDdDDFEABHeBBD.TBGDhAAAUGDBFGAH.RACF.hAAAOADEAEDH.NIEHJDHBhAGADGGFZEEG.IHHFaEEE.....hAHAcFAF.SBADhABA,2,-25,-8,17
LJQCEOIafGAKHTRVUWdMSPebXBDgcYZNF,TDEHUCBEdGCG..MCCCSHFG..bGACBDHADGGC..hAAA..gDAChAAAZCFHFAFGQFDGhABACABGEBGHIFBBaDAHABHGKACC...HBDFWHDAXGGEhAIAcEDHNBIC.OADEhACA.,2,-28,-11,17
MFPfVRgNJWZECGOXIKSTYeabLAHUdcDBQ,UGFADDEEMHBCFDAH.....VDBFRCBAJDEGZEGB..GECAOBCGhAAAKAAF..SCAChABAeBHBLBCEAHADdEEAQAGDhACA..fGABhABANIDD.EEHBCFAG....hACA...,2,-28,-14,14
NIKFcMCSLQfWZUAYBgTOaJGDdVbRHeXEP,BCCFOBDEJHCGDFFB..dDGFREBEHCAA.eAAEXAAF..hADAEGAG..IFGChAEAKEGCFAHDCGHCLBDBhAFA.fFDFWHDAAEDC.gFBFhAGAaHAC.bAFA....hAHA...,2,-38,-20,18
GMcbDFZPdaULIEKfXOgeWYTHRSBAJCNVQ,JDBACCFG..QECBMABE.DCGCFBFCdAEDUEFDLFAB.EAAChAAAKCHH.OAAHeFFHTCCChADARFDDBHABAHIFNEIA..hAFA............hAGA......hAHA...,2,-44,-18,26
TMaXIDeZHJdLQFgPWNSKOGYUVbARCBEcf,BGGCEHBG...TGBHMCBBaEEG.DGBEeCBFZACB.JECGLFFHhAAAFEGE...WCFGhABAKGEBGAFC.YAHHhAAAUAGGAHHFCECDfACBIFHC...hACA......hAFA...,2,-28,-27,1
TBbJaXAELYfVZQIDWNPOFRKHUecCGMgSd,EGECLBFE.VCFDIEBH.DCHD..PBAAOAAAFGAGhAAAHAFEeEHFCBBDGBDEhAEASEDDBHFHbADFXEGEhAFAAEEF.YHAGfHCF.WCAGhABAKFCG...MFFDhACA...,1,-12,-23,11
gSEMDGKIZQdbYBAOCLeHNaPJTRfXVFUcW,CDFHeCEEHEBC..aFEHTABCRAAE..VGAAFAECUFGE...hAAA.gAGGhACASHAADFGCICDEhAAAdDAEYDCAADABNIEB.fHGDcBAH.MIDChADAKBHD.ZFFABGAH..hABA...,2,-25,1,26
DbLZMVcXeYHKQORJGWBIAETdUagCNSPFf,TFBBdAFBaGGC...CCCC.SECCFEEB.DCGGLDHDZDGHMDFBhAAAXGEA.eAGHhAAAHABEOAEBREABWFCHhABAABBE..UDBF.NCAG.fGEG.hABA......hACA...,2,-22,-17,5
NFKBPcSZLfHOdDJXQTIYCAaWMgGURVEeb,MDDGGCADRFEB.EBGB.eDGDFBDCKDABBHEG...SAFFhAAALHAGHAFGDGGBJDEBQAAHhAAATACB.CHHAAAFGaEAChABA..gDGF.....hACA......hAEA...,1,-18,-23,5
GPYOENXQSCAFBgVTUKdbMRWILfaJcHDeZ,FAHFVDBEUGBD..dACCMCCDRAGHLFGB..aABEJGDEDFGFZFAHhAAAGADA.OEHFhAAAXAEC.CBAGADGHBFEHhABA.KCAB.bBFH.....WFAFhACA......hAFA...,2,-30,-27,3
JZbIQKYcVNSfOUTCAeXEHdaLMgBPRDGFW,XGABHDDAaBAEMABCBFEG..DIDCFFFBZDFAQFAA.KHDAhAAAVBCB.SFFEhAAAOAFDCCDFeDHHdDAELACEhABA.PAHF..WAHFIHHFhAGA....hAHA...,2,-27,-13,14
YRWQTdCaOZfJDbcNHGSEgXAFVKUMBPeIL,KBFABAHHeDAELDCARACB.QAEECGFG.OEACZEAADEED.hAAA.NIDH.SHAChAAA.EDHFABADVCGDhABAUGGAMICAYCBCdABG.fFGE.hAEAJGBCcAGF..hAFA...,2,-25,-14,11
aCNfKRBEQdVObAHYTSIJZeFgMULcWGXPD,HFEFTDDDJAFG.ZBDFeABH.FAEHUEGFLEGBGEAGDGBHCCFD.KGCAhAAABBCGdAGB..OCFChABAAIHG..IAAEhACAMICCXDAAaCHB.fFFCEGCC.hADA......hAEA...,2,-23,-10,13
AOGVDQgTLRKabBeEfWSNXJCcYIdPMHFUZ,GGBFDDAGQFEDLADGKCFCBCGG.ECDDSGBC.hAAAXDCDCBADIGGFhABAdABEMIEAFEGAAAHBgEAEhACAaCHD.fFDBNAEAJAFGPFHFZCEH.hAEA.OAHD..hAFA...,2,-16,-15,1
eDOGabKWCVMNgYXISdEcLPATQFHZfBURJ,TCDAHDEGBCEH.REAHDCADaFBD..KHCGCABE.MAFC....NBDC.hAAAXDABdHCHLHFAhADAAABFQGGHFCGA.hAEAfFEBJBBFOFFEWACG.VBGHIAFAhAHASEGG.hAIA...,1,-13,-21,8
aOFNQCgZXIMdfHTYWLRBKDVcbPSEeAJUG,GBEAFDBHCGHC.ZFGD.MGACdGACHFED..TCBCLDFABGFChAAADAAG.VBBEPAHBhABAeAFCABEFaACF.OEAChAEAQGCC.IEDHWGBA.KBHF.hAFA......hAGA...,2,-20,-15,5
FSGABWUDMefKbgPacdHLJOTIECQYXRNVZ,BCEDDCGFeBECKACD......PFBAaHFGdAHAHGEAODBAEAFH.hAAACEAB...QEGAhABARGACZABGFEGDAFEHMBBD.hAAAfAHE.cFAC.LDDGhADA....hAEA...,1,-21,-33,12
QJRLXaZVFCTeKYNSEcAPWIGbdMgfOUDBH,..IEHGbABA.dAAAMGEC..OHCCBEEEJFAELCEFhACAaHCEZAFEFDAB.CBHCTEBFhADAeBADKDHF..NDGG.SCCGhAAA.AHHD..WHACfGAChAEADGIB.....hABA...,1,-24,-28,4
YIGPbKHFcVREBDUWTgMXdfaOJeAZCSQLN,SHDEQGDHLEDA.IAEAGACGKCEB.FBGChAAARCBABBBEDEGETFBHhABAMAIFdGGHaBBBOHAChACAABAFCGBANAHA.PFFE...cEAG..hAEAEDAD.WAFHfAEFhAHA.,2,-23,-18,5
IAORZdYTgBCaXKeHDPGLMVJcQfWEUbFSN,ZDEATAFBCGFD..KFAEeDADHACFDHCALDHBMDBG...JHBAfDGHhAAAUAGD.FFCGhABASBABAIFAdACHBFGEhADAXFDF........hAAA......hABA...,2,-30,-26,4
QcBJdKEbMGSZgCXfUeARYHFVaWLDOITPN,RBGFHDEEFEEF.aFCDDFIBODAD...TADFQGCD.BBDChAAAJEHDdCABKDAEEEADMCFChAAA.SAGChABACGFH.fABHAAGE.WFGDIABChADAcDCG.....hAEA...,2,-50,-5,45
FRZaLdEJcDKCQNIeVOfMXSGHBbYgUPTAW,RADFLCEBEBGB.JEBEDFDA.KCBFCBGG...QABBeDGH.OHFEhAAAfBBF.hACASGAEBGEFgFAFhAFAPADGTGEHADIDFFHF.aCAHNIABMEEAhAGA......hAHA...,1,-23,-27,4
IFafZBVRDUTNSKACbXLYMdeHOEgPJWGcQ,XFGGMBEA.dDGDeFCEHEAEOAAC.EDGBgAGDhAAA.JCCAcEACFGCDZACAhABABCEADEEF.TGGChAAASDAEACDALGAAWHFA.ICACaFED.hADAfCCG.hAEA...,1,-10,-15,5
LXEMCBcQFRaVbPgWOAZNYdefTUGJHSDIK,ZACEdCCBeEHDUGDCHBEGDAHFLGAE..MCIHCGEDBACBFAABaDDHhACA....PBAFhAAAODAFAFFE...fFHEhADATAEFSCFHKGAFEHBC..cEEAhAEA....hAGA...,1,-23,-36,13
eLAbEGcBQVJfWHKRXSZaPTODgUMFdNIYC,GDCGBCGCQCAFJAFGHABE.RGFEZFAB..PGFCDDHHUECGdGEG.hAAA...ICHBhABACAGCLAAEACECEEABfAEChAEA..XCEAaEHD...hAIA......hBBA...,1,-13,-29,16
CKZRdLYWHXVQfEgPcISTMONGAUJeDabBF,eCAGDAGFBDGFKFEDdGBGLAEDHAEB..QGGDEBAC..PCCBhAAAIDHB.SAGBhAAAMHBCOFCChABAAEBCJABEbEEACDEG...YDADXEBEfGGGhACA...hABA...,1,-20,-24,4
QaCAdYGcLPIONgWFMEXDUfJBSTZeRVbKH,dBACGCEHLCDFOFEE....gBGHFAAGEEBADAIFJEBBBHFChADAZFFC.eCCC.RGBEKADAhAFAaEGAAIAA...PGCEhAAANEIE...MAEAfAGESBCChABA.....hAHA...,1,-18,-23,5
eNIROSZLTJXGcfQgVUHDEbWYadPCBFAMK,KFFBeAAFRBFCZFACLCGH.JFBDGDDA.QBCFUEECEAGC.hAAA....YBBFhAAAaCADdCDHCGHBBHFDAFADMICGhACAOHAC.SABE...hADA......hAEA...,1,-21,-26,5
VZHNCQDBJIXdROLcWPYbeTfGaMUgFSAEK,KECBHADDCBDC.DCBABHDDJCFB...dCBELHEC...PFADhAAAeABCTAGEGDADaFCEhABAMFEE..FFGCAGHBEFADhAAANAIC...IGEH.OBFBhABAcAFF.....hAFA...,2,-44,-11,33
edUEfGPHSLaKRCVDQIcMONJYXgFWBTAbZ,eEDCdDCH.EFGAGBFCHAEGLACHKADFRFCECBAD.QEAH.hAAAICEGOEAFNIADYHCGhAAA.FBAFBGHGhABAAHHA...........hABA......hAEA...,1,-8,-42,34
XMDHFJCGfeTUaRgNdZKPOcYAWBEbQIVSL,BAFEECBA.QGCCSFGAMEDEDCFAFAFECAAG.GDDC.eABEhAAATGFDRFAC.NDDBKEAAhABAPHFA..OCHDhACAADIFIEAEVACE........hAEA......hAFA...,2,-22,-19,3
EfBeCbTDJdgXcWURLHSFANYVZIPaMGKOQ,VFACZDCCaGGE..GDDCKHBG..QBCABBADCAFBDBBAdDHA.XBEAhAAAUGFGRBDELDAChAAASGFD.ABHEIFAEhABAMBIFOHBEfABH.eFDDhAEA......hAFA...,1,-20,-23,3
DFOZMXCEgKAeIVLaTcbfQRWUJdYBSGNHP,VECEaHCA....TABD..cGDEQGGG.UECBhAAAJABBdADFBFACGCDHhAAAHAEADFFCFGAEMFIHhABACCDDKDGGADAHIGGCfGAC.....hAGA......hAHA...,2,-27,-16,11
SZPGRYAOTbDecgdEWVUFMfNJLQXKIHBaC,TAFCeBDFdFAH.EGDHUEAF.FEFCMEFD..JCHHQGGBhAAA.IHAEhABABACBSGDCPBBHYDFChACAACDADHGE.WBFA..fAAEhABALADE.KDDCCEDA...hAHA...,2,-41,-10,31
OMeZfNgbFaHQBUPWScYEIAXCdKDTRVLGJ,XFBHdBGAKGCCRAAA.GABB..MADEeGEEZEDC....NAIAFECAhAAAaCEDBCDAUAFASHEGhABAEHGC.ADGDTCAHhACALFBDOEAH...fFHGhAEA...hAAA...,1,-1,-40,39
ZNbeCJIUTQHDRKWPcLYSgAVfMEadOGFBX,MFCBaFFHGDEHBAECZEDE..eBFECDBH.IHDEQAABHEABhAAADFHHKBCD...WAEChABALBFA.YDEEhABAgGGBADDHEGAFOCAB..FAGGhADA.NEIAJHECTECG.hBDA...,2,-22,0,22
QVLcBabNKWTAgXfDPIMFRGSdOHJYCeZEU,XFEEDFHBMBEBGGBDdCBBHAEE..CCBBZAEHQGAG.LFHFhAAABABFaGFDKACCAAHC.hAAAgCGC.hADAIHEASCGHYCEFUDBD...hAGA......hBAA...,1,-3,-35,32
ITeLAMBXdcQVWabJEDYZfKUOHGSRgCFNP,XGCHQGAD.aFDGEEFE.ZAGBKCCBUDAAHCFCGBCHRAFA.CGAA.hAAANGEH....PDABhAAAIACBLABChAFABHGB.dHFHWEEDDCEF.OCHD.SFFGhABA.FAEAACBD..hBAA...,2,-15,0,15
LQBefAbUCWSdEFXKPIODaJgNVYRMcZTGH,UEBGSAGHdHCBFABFKFCD...OEFEDCDC..aEDEJADH..hAAA.VGDAMAEETCAAhABALEGF.BBHHhAAAeCEHADAHCBFBEGAD.IHHH..NDDH..hACA......hAEA..YFHH,2,-38,-26,12
cbDHJYNdFCIMaWSgeXQZUBKATVRfEPGOL,VFGHRACFEGFC..GEDBOAGBLFAH.DCGEJFADdAAHFFDDCHHB.MFCDhAAA..SEHBhABAeACFZCEHBHEAADGC.hAEATDCHfFCG..PCAH.hAFA.cCDE..hAGA...,1,-17,-24,7
GTQIDSERJBZcMUANLeWFfaHbPKVXYOCgd,LBGBeCDCFCAFHGFAKCFF..XDBCCEHFdAAFGFBFQGCFhAAADEECRAFE.BHGG.MCAHhABAAHAH..fEBFhADAaBCEbFFA...........hACA......hADA...,2,-27,-18,9
agdHCKXcBTMWRFGPeQDOfVNALUYJZbEIS,UGDAZBFGEEAA..aGACHBCD.CHBG.KDHFBBAGMCBEFDHH.GFEFhAAAeBEEDAAAOFAE..hABAVCEDAIHEJADC.SEDAhACAXDADTGGF.....hAGAWAEE....hADA...,2,-39,-10,29
PgeRTMAcCYWEUXdHQOSJZNKVfFbDaGLIB,CHCCEEGCUBDBdABEHFEH.OADHZAGBKGEFFEAG..DACCLHAChAAABABG.eFAARFFA.MDEChAEAAEEA......hAFA....YGAE....hAAA......hAFA.WEDASHGG,2,-57,-9,48
XbQMEVNOWfSRCZFcaGgUPeLDATdHYKIBJ,HCEBKGGHBBEBXBAB.MHDAVFDDOBFG..SDBGhAAACADCFHAEGEGGUAGDLDCDhAAATFAHIBBGhABA...QDFAWCAD.ZACDhACAaCCA.....hAFA...,1,-5,-29,24
YRVbCcdGTfePAKJDUHFMXWEIgZQLBSNaO,KBGFUBEDHAAGFBBA.MAEE..XDAEEEGAZFBFBGGD.SEEFhAAANBIC.aCDCRGAGbFGDhAAA..CDABdBHEfEEFhABAACEA.DFGB.ICAF.gFDGhACAOFHF..hADA...,1,-16,-33,17
RWSHcTVAJYbIKaMfgXGFQBEeZPNUdDLOC,JBCC..IHACKDGE.MDEC..XGAFFFHHBCABEGFFeABAhAAAZAAD.UCCELDDHhAAARFCFSBGAHDACTAFBhADAAFADaFFH....fEBE.hAEA.gFGBhAFAPAEEDIFGCHCD.WEFE,2,-24,-14,10
CLdaRBTbYZQNJGgOFXPUSAHfceDWKEIMV,HCDFeHDCDGIHEDGHMBACLBBA..dDABBAGHTAFHZDACJGACOFCBhAAA.FFADUCFCAIGG.hABA.fFFGhACAKFFACACB.aFHB....bDDFNAICXGDHhADASAAF...WAHHhAEA...,1,9,-37,46
JOEVPbgaNTFBCHKYZMUScQLIXWARdDGef,dECDeBHHOFFEEACA....VEEC..PAGBaBFCFFAGCCDGHABAhAAAZBAAUECGQFAGhABALHACIHEAhADAABEHDAAAJFHBNAIEBHHF.KBEB.SHAAhAEA......hAFA...,2,-17,-9,8
CcDaSNKFdIAfGXUBZgEJMVORTeYbQLHPW,XAGBZABEECGC..JEEEOBAG.REED.TCCGeCCF..QGBFhAAAHFCHCFAFDHFGaBEASBADhAAAKGHBdEGBIDAHhABAAHBB..fEHABEDCMFAH..hACA......hADA...,1,-12,-28,16
VfHTIJOSNFgQdPUEYRZLbXACeBaMWGDKc,eAFDaFBBGGCBKGGA....VBAAHABD.IFFAODEFFAGEhAAAQAEAdHDDUEAFEECEhAAA.RCGH.LDDDhABAADAGBEAFDIBCTGAB.SEHBPDDG..hACA......hADA...,2,-15,-1,14
TUXeOfYbMSIWCRgEHLGcaQJKdFNZDVPBA,XGEGeAAEOEGB....bCFGIDHCCGAG.REDDEEABLADChAAAGBEDaEBFQCCGhADAKCCA.dHAB.hABAFFHDZEECDBBHBGCAABEE.fABASAGEhAEA......hAFA...,2,-22,-6,16
adVWIOZRSAXfQEKBTLCcFUHeJDNYbGPgM,XGEDQDCFKDHFLFFD.FADAeADADCBC...NEAGGBAHhAAAMDBDdEHG.IBHGhAAAZEDBAGBHEBFCBGDCCABF.hADA...cFFFUGAD..YAFBhABA.gGGGhACAWDDFSGHH.,2,-13,-12,1
QYaCRMcfHIVgXZNLBePOGAUWDJKdFEbST,UDGCDGGDKCGAdACD.FHCAEBDB....SEDBTAAF..aFGAhAAACAGE..RBDC.MBFHHFAHhAAAVGBGZFFALBAHhABA.BHHG.OCCBAAGHbDAG..cFABhACA.IHHHhADA...,1,-13,-38,25
UYPLGBTSfgOaQdZNbeVREIWKFJHMCAXDc,DHFCUEGBLFDE.BEGBSBHF.OEEDdCACNDCA.eABFhAAARAFC.EGHBKFABFCCHHABGhAAAAIDE...XGDDhABAcADDGGAD.fEAChABAaHGE......hADA...,2,-26,-26,0
JYXbDVcadHEUTGKWgRLAfOIBNSPCeFZMQ,OBDBBCFCSHEC..CABFeCECFFECQGADXEGADHEAhAAAVDBGdEFG.HDAFhADAUACGTGBGKAGE..hAEAgCGHAIHCfAGBIAAF..hAFA......hBCA...,1,-16,-30,14
TeZBONEfMGVYUWSCKcRHadDbIQFJAPgLX,LBDFeEACOEDDEDGDGEACUCGF.SGGBCBCD.KABEHFBFhAAAdAHCDIDGIHFAhABAFAFBAFEG.PBDA.TFGGhACABDHEfGCH.YAAFhAEA.WCCDaDAG..hBBA...,2,-23,-13,10
MOQSNKALVfTGIdXcaWgZReHbPUYJCBEFD,LGEETEED.GCDBdHGB.aFADZDAHeBBDHCFG.UAEACAECBHCHhAAAEBAGDEIFMBAB.OECEhABASDCAAAGB.IAHAhAAAXDGE.cAGEWGBA....hACA......hADA...,2,-20,-15,5
UfgVcHLATaWSDYJKFMbBNRXIZPQGEOCed,aCGBDHFCKGBD..FDBFMECCBACC.RGACZFFBGCGE..CHHF.dGDG.hAAAUBCG..fDDHhABA.VADGhAGAcAAG.AFCGTBEFSFEH..YEADhAAANCIA.IFFChADA.,1,-29,-47,18
bEVJSTHYDZAdIFaNQKcgWRMOBXeGCPfUL,FABGaGCE.KDFG......gDCFRFDBBFBDeBDDCHGBUAABEAHD.hAAASCGBHFFADAGDAHCDhAEAIEEH.NBIC.hABA..WFADMEBBOAEFXADA.fFHEhADA..hAEA...,1,-29,-34,5
ECNDFHRBObQSWdZgXUKLJYMcTeAPGfVIa,GFDBVABB.aDBDEAFADEFC..REFD.BBHAOBEHQBDF.hAAASDDDZCGHUFAELDAGhABAJHBA.YFEFhADAMADAeAAFADIHIHHFCHHD...hAAA......hACA...,2,-26,-9,17
dKYTAPFeQVaBERWIbXSZUMOHGJfCcLgND,eEGHVBDF.EBGG.RCEA...IAHH..XGAEUBAHHFEDhAAAJCCDCDAFLEHDhABADCAAdGEEKEABYAFH.hAAAAIGEFEAFBHHDSHCCMBAA....hACA......hADA...,2,-25,-16,9
DgZUcEFPVMRYSCXOAHIfBdLNWKGTbeJQa,HCDBBEGHdBDCLCACKGGDGFBBeFAFaFHDZAFB.EFFH..FABBMBAEhAAARDAG.CBHH.AFAF...fBEBhABA.NIDHTDGGhACA.JGBEDBIHgDAC.hAAA......hADA...,1,15,-45,60
QDNKUXYCIGgBTEbFWZVfcLdOPJMRHASea,SADEeCCADIEAKDHBUDDH..CGAHGBFGBDHHEGBB..FEAEVGDGhAAALACG.dFFHhAAAJCAD.MCEEABBBaEEBNCCA.hABA....IHHHgAGE..hACA.WDGFfAGBhABA..,2,-32,-26,6
DOCRHSbEXAQYBWgIcdULVZKJPNMeafFGT,QEFCBAHB..IEGFdHAFLDBEZCABKAACNCAD..MAFDhAAAeAEEFCGFDFDF.CECCHCDEhADASEBA..hABAXFEHAAGHWEHH.UGGCJABE.aGCH...hAHA......hAIA...,1,-21,-23,2
GOLceJXWgCADaNEYPKBSUZdRbFIfTVMHQ,aAAGEDCCKGAEBCBH.ZEDGdCHC.FFEE..TBFDMABA..HAEHOFAFhADAeBBG..JFHDXGCHhAAACAHB.AHGHDDBBhAGA..YDBGSCFHRACAIHEHhAFAfFHC....hAHA...,2,-25,-22,3
eWHbPaMZSOGEVYBdCcKJNXDIgFUTQRfAL,eHCAHFABaDEAMDEDOCBFGCGE..EBEGBEBE.CBAAKAGAXEGEhAAADABG.FABBUGGDTAGAhADAQGABAEEGLHDChAEA.bDCDSBDG.dDFCcGGFhAFAIAEF.fCCGhAAA,2,-16,-9,7
KHUPZDMGYTLgCdWBFfVEIQSbXceaARJNO,RFACJGFGKBBBHFBFZADH.GCDGLFEE..CBCEdDAHFCHH...EDGBSBFBhAAA..hABAXAFGeAFEABDBOGEChACADAIFMIDG.TBACBDDD.....hAIA......hBAA...,2,-28,-20,8
DAcZbVdOIGePaXHWBTRQYfCLFgJKUESNM,ZFEEdAGCOHECeEBH..aHAEHEDHBABDTFGBRCDE..QAGGhAAACCEALBAFFACAJBCEEEFChAFASCHHDFIB.hAIAAHBG....cCBH...IFAEhAAA....hABA...,1,-21,-27,6
QdBLNYWHJUGgPTKIfbDeaMXVEZRCAOSFc,OAEHSEGHFBGE.dGCDLFEB..NBFEHDAFJBBDGDGGhAAATCCEKFAG..IBBBhAAADDDFMHAEEGFDCAFGAIHCBADChABA.UAGG........hACA......hAFA...,2,-32,-19,13
XBRSAeaDWHbMLZUQdCgGFKPEJINcOfYVT,aGHDDEEEHGCGLAECUFGHdGFBGCAD.FAGAEAAD.JDFC..IACDhAAAOECF.VBEAhABAXGBH.RCBCABGHbFAChAEAMFEH..CHHG.PDAB...fEEBhABA.BHFAhACASEBA.,1,-6,-9,3
GZbFKUSQARWTXgdfIaHPNJBCeDVYEOcLM,RACHTEBGdDED..aFFCHBEB.JCBGeFAFDIEG.EFCELEGB.hAAAMADEbAEF.KGBFSDHHhABAAAAG.WHEEhACAfEEE.PAHHCHCCYBBF.hACA..OBHB.hAIA...,1,-8,-27,19
bJZdaHOVfeLcSNCEGBKYQWMTFgIAXURDP,UBEHDHEG..JDFDdGGHHADFOFFA..eBAHLHAE.SCAChAAAEGBBBAFAKDDDhAAAQDAHMIEEFDHBAGACRFDDhABA..bABFaDCF..fFDCNEEF.hACACAHF......hADA..WFAF,2,-21,-20,1
OHNKBfGTeWQLbXVESMgJcIDaYAFCdRZPU,FFGDdHAHRAEGZDAFUGFAHAAG.BHEAGCAE..eCFGLAAC.hAAAXCCFEFECMEDGJDFGhAEADGIB.ADDCCAGA..OFDGhAGA.KEHBfHCH.WFADhABA......hADA...,2,-34,-16,18
LXHcNVdWeJfMYKIBgECGUFPbSADaQOTZR,aECHTCBDLAAH.HCDCVEECdCHEJHEGMEAF..KAFBBHHHhACAEBEDGFABFHAESGGChADADIBCOAAEREEA..hAAANBEFeHDEIBHECCCF.......hAEA......hAFA...,1,-2,-18,16
CLbEXOceISUFNYAGRPQJTHWZaKBgdDMVf,RFAFJCDAHDCCZCAD.KCFBBEGHdABA..DIEC..MCIHCAEB.LFEFhAAA..EFFEOHAAhABAIDAH..SABAhACANAIE.AGIFQAGCWFCB.aGGHhAEAfGHAXDDG.hAFAeAGB.,2,-42,-22,20
bMLVGDdJFWfAaeXHSZUTCgIKPQYOEcNRB,eACASEDBUEFH.CFBD.KGBD..QAABOCAF.EDFHRCDABAAHhAAALHAADGIDdGEHJFHFfAGGhABA.hACAXDAATAFBPECFcADCMFGB.hADAFCHDAEIHaCCG...hAEA...,2,-20,-17,3
dHYNPDBOTcXLVbWMKUSIReGJCgFaZAQEf,QFAHEGBAHCAE....PFFHBADFTAAFLDFEVCEBhAAAMIACKHEAIACAhAAAGEGACBHHaAGGACCG.dAEENDDA.DDEHhABA.cEGF..WAEASHGAhBAA......hBBA...,2,-19,-6,13
EfPAgCVJaZbIcLQTRdYUMFXeDNGKWBSOH,VAEFaHFAZADB......IHBELGBCQDBGhAAARAFBdHADUAABMEFAXDFGhABAeDDHDCAEKFGABDHEODABhABAEDADAGGECGHA.JABE.TGDGFDCH...WFFChAGA.SCGAhAHA.fAHC,1,0,-18,18
IJOVDZFcUGQRaKPgeWXHEbSNAfBLCTMYd,BCHCCBEA.MFCBdDBDOBHHDADE.ZGEGFFFDGEDBRBAB..KDDGeBAFhAAAHAFE..EGABSFDFhAAAAIFE.LEHBhABAIGCFcCEAaAFFPABG..hAHA......hAIA...,2,-28,-26,2
BHdKAQMeNDTfZSbGCFgJYERcUVWLXPIOa,QGECMDIFDAIFZDACSAEC.CGCE.JAGDRBGF.UGACLDCGhAAA.XGGFhABAIHEGBCABdFEBACBCNDAC..hAAATABGGABFgBECEHGE.WEFAhADA.PHAE..hAHAaCDE.KDGH,1,-13,-22,9
BFAfgTZKVDSHXWUeRJYMOdNEaIGCcPQbL,TCDCKAFEDABEHFEA.UFBAJFFF..MDIBOECAdDBA..aABHCCCD.hAAA..QGAEhAAABEAFADIFZBGDVAEC.SEGBhACAXACAeHFA.....hADANIAB.EGDF...IHHHhAEA,1,-9,-35,26
dDXZaFVONLJSbfURQMPHBeKTICAGcEWYg,GEDBEEAC....gGAAXBGFFDACOCDBJCCG.SFFHhAAAUFAAMHEEBACBhABAKABH.IEHGAIGE.hAAAWBGFDFIHaGCDLFEF.fBBChAEA.PAED.hABA...,2,-30,-11,19
SMPYVQOHARfDIKGbTeFNWXUCBcdLgEZaJ,DGGAGBEAeCFHFDBD...XACACCBEBAFHLEBGZGAE.aFAChAAASGFA.hABAMBAHPHEEQBGAhAAAOBHDHABCAEGE.ICEBKEHBNICBWCCBhABAdHAD......hACA...,1,-18,-20,2
XEbYfBMGFVLeRIDJHOaNTKPCAcSWdUgQZ,SCGGUFGCQGCFEGEC....fGHAMADCVCDDLACDhAAARBGFDBBG.OECAhABAaGEDKBADPADE.hAAACHAGAFCAdFBBXEGFBAHE.FGAA....hAGA......hAHA...,2,-18,-17,1
SVJBZXUPfMKYgFGNacLIeCREQTdDWbAOH,OAAFSFHDBGHCZAEBUAFD..fGCFKHEA.FCGCaCDHhAAALBAH.CFFCEDCGhAAAdGAADFEBAAHH.VDFDhACAXGEEMCIDGDBEIACFeADBTEBBhABA.WEFE...hAEA...,2,-23,-11,12
VXSgWRMbfOUNDaJcedYKEIGABLFQZTPHC,LHEAFECCZFGDHABBCHCG..SAEBRBDFMAHH.OCDHDIDGJEAHdFGBhAAA.KBGG.GBAGhABABFEA...QACDhACA..........hAGA......hAHA...,1,-22,-42,20
ZCLSHXJfWBKcUaEdGAYbNQePDMgVITOFR,...bAFFNCHA..QFCBDEEF.MCDFgAAC.VBCGhAAATAEH.FFFFREAALHEChADASHAGXCGDhAEAfEAEBAHAUAAFEFGAAFFA...hABA.eFHH.IDBEhADA.,2,-27,-5,22
KMRZXTGQJYbfdCDaPOLeSgNBAIUEVcHFW,EFGHHBEHKGDBMICE.REDGZEGDGAAB.QCDFJBAC..fGBFhAAACHBEaAGBLEAGhAAAeDBCSEADhABABDAEIEFG.cBGDWFHH..YAHBhACADGID.OADGAIAA.hABA...,2,-25,0,25
AQBIKcOgVSHYbJaPLEdRTZeCFWXMNGfDU,BDCHKDBBOEDASFFGHACF...JHDCaFBHLBEFRAFD.ZCGFhAAAFGHFMBABGFCDDFADAHBEhABAICAC..hAAA..cBBD....YHDGhABAEFCCeCFBCDHF..NEAC..hACA...,2,-31,-10,21
DePTfVIKCLEAXZaNYBMdbRJSOUcgGQWHF,aAGABEBC.MHBEREGH..OEBFUADFGCDCHABBDGBF..eFHDhAAATDDF..fDGFhABAKGDGEADCAAACNDAAdGAG.hADASCBG.cGFCQBEEhBAAWAFH......hBBA...,1,-18,-22,4
LHKMfEgPVcASIRWQNCZaBUFdOJbTXGYeD,SBGFREEDQCAAZBEFBEGDUFGG.dDCDOFBF..JHACTBFGhAAAGAAGDEAFKFAEMEIHhABAEHDE.....hAAAPDCGADAFNAIG.CHGEFACG......hAFA...YAHHhAGA..,2,-27,-12,15
PFSCDVWLZRdQGXfOYNcaeUgHIETMBAbJK,KHACFHBACBABDCFG.LABAZGEC..RDEAdCCEGECG.OFGF.hAAA.NDAA.aCAD.eDDGhAAAUBFD...IFGDhABAMAFCAACCbCFE..SACA.hBAA.WFFF...hACA...,1,-16,-45,29
JeUNHVGPBgFWdSIcEQDLXYCRAMbKTaOZf,MIFCKFHDOAFAZCCE..JBGHeGCG.HBEAGFEFBFFEFEAHSDBDhAAAEBBA.DIFCLHBGhAAACFED.AEFFaADDhABAfBAB.NEDH.......hABA......hACA...,1,-25,-35,10
fZQcPTSDHGMaNIOEeABgWYFURLCJbXKVd,BAHF..gCDBFCGHRCAHLDDDCHDFJEAF.KEEH..dAAHQGAFhAAATEFH.DFHBMGCGhABA.aCCH.NAHC.OACAhABA.eHCAWFHH......hADA.YADGXGFHhAGA.fBBB.,2,-25,-21,4
EcPaWYFIRVQOfGAUJSCbBDXMdNKeLZHgT,JBGFCBBFBDHG..DBCCdCADKFBFZEDH.HEBH..EFFHaGCDFBEDRFFA..hAAA.OHFEADDE.UCABhABASBGC.hACAMFADNEEC.eABELHAA...cAGFhADA....hAEAWAEB.,1,-31,-35,4
cbZgeWYCVPFSLJXBdUOTKMADRGQINHEfa,GFAFQBFHHAFAaGEAZABG.eHDC.CCEGFFEASACCLDHBhAAAXCCDBHABUCAFhABAKFHFDGDH.IHBGhAAA.fAEA.gBAGhABAWDDG...YEFEhAGA.,1,-7,-35,28
HRCUeaDPQIBXbZNcEOVGSfTAYFdKgMWJL,FADAdBACMBHHLDFFHCDEUECDDFFF..QGGHBHGDZBEEECCBGEADhAAA....SGBAhAAAABCFKGABJAEGCEHAeFHDhABA.aBBB.IHEHXGCD..NAIA.hACA......hAGA...,2,-26,-14,12
OBPNfXYadAGgcSUWTQCeEFMHRKIDZbLVJ,GBBFSAAEUGGGQEGECAEA.FBGEHGCEKFCH.IABAhAAADBEGZDBGLCCEhADAOEABBFEE..NAEDfHDFhBAAYBGFAHBH...cFFCeDAEMCIBhADA.....hBBA...,1,-11,-25,14
QMSZJGWcTAHIOdeCBVREfPbLYXNUFaDgK,ODCBCAFGBHHD.REDA...EBGA....PHCELFEB.NAEA.hAAAaAFA.DACCKDFESBFDhAAAJDBF...hABAWBHHAICEIBCD.dEHCfBBChABAXGAG.FHGAMDDF.hAIA...,2,-41,-31,10
MgfcHdSLRFYbOWGCKQAVeTIJPZXaBNEUD,VGCGeHBE..JCBHZDECBABAUBFC..MEFB....fGAEhAAAdEGCSEDBhAAAREAEFBBG.OAFGCCDC.ADDETADHhABAIHHB.XGFFaBGEDGIF...hADA......hBAA...,1,-26,-32,6
HAXDFLCgMeQNKYfJZGSUVdPBcTWEaRIbO,XBBCFDBALHAA.MFCAQBFE.KFBFJDGBSDEHhAAAUACEdBGHBFABTEGEhABAEFHHaACC.RGEGODDBhADAABBGDAGA.CHCB..NAED.fGDD..hAAA......hABA...,1,-2,-37,35
IcBGdQJSLYKRXZeWEDOHfNVUCaPgbTMFA,BBCEGECCdGFFJGFALFDD.KBGBZAFE.eEFEEAFF.DHAEHDDChAAA..VABDaFAG..hAAA.PCFCTCAFAAGEQDAChABASACEXEGE.fHAFhABANAEG.CAHE.hAFAMIEC.,1,-12,-19,7
eZJOfWNbALFgBIRPScYdEMUKTXQHCGDVa,LGAABAHERACG.SAACdGGFMCGF.UBCCKEAH...QCFGhADACDCHGGAD.DICCeFCGhAAAJEHFOBBB.fAEBhAGANIDBFBAD.IFFF.cECAhAHAEAGB.....hABA...,1,-15,-30,15
JWFXSTOADaBEeYLIUZQKgRdMCGPVHNcbf,aBAFEGFCLBHFZBED.KEEEREGDMIACGABGHEAA...NHBD.fFDGhAAA.FAFGhABAXCCBODADAFIDDCADhAAABCFFIAHH.gCGECHHH.hADA......hAEA...,1,-15,-24,9
VYCAFJHPGfRLaBOEKbMgTWSecINUQXDZd,HGEGGBGCRCDBLAGHBFEDKCEH.MFDD..TCBESGBDhAAAeAAG.NBCG.UFBA.QGFAhACADBDGdEGHYBADhABAAEIFJADC..aAGAEEAF......hACA......hADA...,1,-11,-18,7
GTUHLaAZPFBWObIVDEcRXQMfdKYNeJgSC,ZCBABDEHOHFC..VEGBDHAARAGHQFCB.dFACKEBDeAEAhAAAJEGH.CCAD.UFDCaABA.hAEAABBA.FBBF...ICHGhAFAEADBMIACNIEF...SAFFhAAA......hABA...,2,-37,-18,19
TRSfObZLaDPQYVGMIgBcHJXAWdKCeFNEU,dAFHCDCFFBDEUCDF.RGEE.OCGFLBAH..aFGHDIDC..QFADhAAAGECHMGAGBBCFhABA.JEDHAHIFKBHB.EDHBhAAAfCAG.bFED..YACDhABA.....hACA...,1,-18,-41,23
fcAbRCdWUDEQLeMNIFTXgaZVHPGSKOJBY,REFGdHEHDDEAEBEHLACB..MAHDFFBD.TFGA..gFEGhAAAZBCF.HAFEhABAGDAA.SGCChAAAOBBB.BDFCfHDBAABFCDHH.WFADhAEA......hAFAeEFFIHHG,1,-21,-25,4
MFLGRJdISNWVAgQPfHXUEOcBYTZDKCbae,QEDCHDCHXBBGOBECBFGAZBBDCAAC.eGFCMHDCLHBEhAAA.JBABIEFEhACA.SBFBhADANAIAAFAEfDFFcGABDGADaAEB...FCHF..hAGA......hAHA...,1,-13,-24,11
QcXTBHdIPFYeZSgbAGWEVLMaJKfDRCUON,GEGCEACBLEAAMACBKFAFDDAE..RCGBUAGBOFBD...QFEAhAAAXGGEBBEBhAAAdBAGFBFDZDDFSDDHhABAABAEaHAC..CFFB.NAIGcAEG...IHDAhADA...hABA...,1,-8,-27,19
IVFEMdWSZceNXDfUPRgCKTYJQbaAGLHBO,GCDBBABFOFGFFFHDEECAdAGG.ZEDE..eGAEDECH.UAAGRCDG.CHEC.hADAKCBD..JAEAaADBAFFB.hAHA..LHBGhAAA....IEGBMFAF.SGGDhAIA....hBAA...,1,-32,-34,2
PLZHWSAedbMBRafOTKCcENJgQVXUYDIFG,dCDCMBDHRAFE..OBBDCEAC..EEDA.JBBHQEFD.UFCGhAAAIEGCFHACLCADhABAHGDASBGChAAAeHEC.aFBCfCGGcGAC.NDIE.gGGBhABA.YCHHhACA.,1,-7,-40,33
OFgLdMXUBJYPHIbfNDQARVSGKTZaecCEW,VFDHGDAA.KCEFZBFFeGCA..CHGAOABGFAEELCGH.MDDHhAAAXCDDBACD.JFADhAAA..PFHF.hAFAIBABfFFBDGGHAAHHSDBChAGA...aCHF..hAHA.WFCD.,2,-26,-19,7
dFMSfaDAJBgIYNbWcOCPeURZTXVLGHQKE,BGDC..IGEC..YHEEbABG.OCCACCEEUBGAhAAAZEAF..XGADhACAGAGEHEFEEDDEMAFAhADAfABHDEAEAGHBNFBD.PADC.eAAD.hAEA......hBAA...,1,-12,-27,15
beNTAaJgCYBcFUZGRfSPdWQKEVMOLIHXD,aCBDJCGB...CEFDBHFFFAFCZCAD.GGCDRBDE..SDHFhAAAdECFKHGA.EHAAMCIF.LABChAAAIBAHDIAGNEEE.hABAAFDD.....cAGAfCDF.hACA.WDDF.ODAHhADA.XFGE,1,-23,-34,11
QVRZHEDBSCLgfKFPdaAJTcMNbOUWYXIeG,TBDBMBGD..ODBEUBGA...XEAGeEHDVDEBHEGHEFBDhAAABAAB.CHBCLBCEhACAfCBCKFFFdABF.hADAAFAHNICDYAHH.IHDC..hAEA......hAFA...,1,-14,-25,11
JMdBRNDUbFOHWVXeaEPTCZKgcYSfQLAIG,JCBAMFDABACEDBDA..UGEBFFAG..HECB..VFAHaFHH.EDDECHBF.hAAA.ZBEHKCBC...hABA...gGFDhAEASAEE.QDAHACID.IABGhAAA.dDHGNAHA..hADA...,1,-30,-37,7
XHJTNeAMGRQIPaOSdgfcKLbWFBUVEYCZD,GABCQDFFaCGGdGAH..fDADKFECLADEFABCBCDDhAAAEGGBZBDDXGCF.hAAAJFAHNIBDADHCMAEE.IHFEhADAOEHF.SEHHcFDH.WBFChAIAYBAFCHHC.DCFB.hBAA...,1,-6,-26,20
NefWLFVETAJgGQaScYMODZBbdIPKUXCHR,JDBAQEDC.SBFFMBEEZFEEdCFFKCHHUFGFHEAHeEDAhAAALEBDFBAA.EAAEAIDA.aAEBhACAODHFBHFGICCHhADACAHB...fHCF..hAGAWADC....hABAgAGH.,2,-23,-8,15
WSTbgNLIYdPXCeAQaUHDFKcfGBJVEMRZO,UBFGFFEGKBEFGDCHBBHH.EBCGZFBB..OHEC..SAGFhAAATFGC..bDADLBCFhABA.YHFAhACAPHAGeAAF.AEHA.aDGEDAIBJDAFMAEEhAAA......hACA...,1,-13,-34,21
OFAHIZSUJdYREcaGNfVQbMBWgPXCDeTLK,HBBEZBADUFGFJCFCdFHGRBFD...EEFDaFEDGFAF..VFAHMCAHhAAABADB..PHEEhABADICGLDDHKHAGAEDASAHBhACA..NAICfDCGhAAA......hABA...,1,-10,-32,22
TXSNdYBaHPVDOJZIUEMKRbfGgWceFLQAC,CEDDTACH..XBFEdAEEBDDDHAAADFDBZFEBEGDA..KGBHRBAHGCEHhAAA..cCAHhAAAFGABAEHB..SGHBhABANDIAaGGD..ODGB.IFAFhACA.MAEBfGGEhACA..,2,-29,-19,10
LUIEgKaZdGSDACVTfeQbBNHcXJROMFYWP,VEFGeFFBQDCC.BBDBHADHJFHHRFAGOCCF.MBBBhAAAFBAFPAFDLHAGhABAEHCCaBHFdFACDEEDCCHA.fCFHhACA.NIEH.......hADA......hAFA...,1,-11,-25,14
MdBXDaLZNVRcOAFKQGWCJgeETHSUPbIfY,KGGHQDEEGDCBCEHDJAHD....EBACTADHHAEBUGBF.hAAA.IHFAMAHFBFFEhAAA.DGIBaDGENDAG.RGAGAIHChABA.FFCAeDBDSACD.bDAG..hADAYABC..hAGA..XFGA,2,-21,-4,17
cJCNZBMWUGIDXTegAfHdPYOQFRVSabKEL,dEEEOFBCFABFRCGF..SGFHKGBE.EAEDJFHBZEEB..BCFDhAAAMCHHGAEDDBIBXCBChAAA..eEAGhADAAAFAfHBF..YHAAaDAH.hABA.cACCCBDD.NEIGIEDHhADA,2,-43,-15,28
bJfBUNLeDCMEWSQXTVFAYIORZdcPGgaHK,OEAFdFDDGDAFHACFKGACJHBEBHHC.LCHDeCFECFDA..EBADSGGFhAAA.QAFFhABATDEDAFGGIGHHhAAARBBG.PHEE.aAGEfACBhAEADGAFMAEE....hAGA...,1,-8,-26,18
XVIHDRYZcUCPKaBLbNMFAOeEGTdSWJQfg,eHDEEDDDGAAHdEFG..JEABQGEE.XBFDVADGDCDHhAAAZEADCBHF.KEGEBBABbFBDMDAFhAAAAGHF..SEDHhABAfGHG....gCGGhACA.....hABA...,2,-36,-10,26
EfXTJGeDWcSBNdROaMFQLUgZPbCKVIAYH,HBCHEGFE.TEAAeBAHDFDH..SCHFdDDBOAAAFAAHLFABhAEAZDFFCGCFKFEDACIBXEGEhAFAJHFGGAEDBHDHaDAAMIAAhABAQAGG.......hACA......hADA...,1,-3,-19,16
MHFCfgDTAEZLXIGdOeKWbRPUBVcYSQaJN,ECFBLCHFGFEFdACDKAFGRFABBGGD..VABBSFDG.hAAAQCCANEDCFCGACEBGDFAFhABAAEFDZAED..IHHBhADAeBAD.....WADH...hAAA......hABA...,1,-23,-28,5
BZDaNFYCWJQRVAMTfdKeIEHbgOXPUcSGL,MIAATFGHKEAG..EFACHBGB.OADCXGDEUGFBGBBHhAAAZCAADAAEFDEC.CAFBQCGAhABAACEFdEEDeGAA.IDAHhACA...PHACSBBGBAHF.hADANEIC......hAEA...,2,-15,-12,3
ULBSPQFNJCHIMXATZDRVfdacgEeKGYWbO,DCBBRGDEdBBB..aGDBEBGFKABHGDDD....bCEEOEBB.hAAABAFEPADHFFGACHHGMGFChABAAIAE.ZFBB.fEEBhAEAeCCA.UAGH.LHFANCAG.hAAAIFAA..hAFA...,1,-20,-23,3
UGDYWIZRNHBgbLVCEfPXeFJdSQMcKTAaO,ODFCUBAEDCFA....IAADREFDHGBGBDFCLFFECAHE.EAHFhACA..XEBFhAAAeDCCFGGCdAEFQGAChADAKEDHAGIB.YBDCZACF.NEEC..gEAEhAEA.fCBHhAFASHFA,1,-16,-28,12
KUTVNbDQFMLEfYXBcZASGOWeHCPgdaJIR,SCGBODEEHACACFGA.dAGA...aDDBRAABTAEC..NHDDDBAFhAAAFECDMDIBLFADhABAEEEB.XEGEBHADADABeACBhAAAPBBB.IGBFKHBC..bGEGfFDFhACAcAGA..hAEA...,1,-13,-20,7
MGQLCVNKaDBJcXFedWUYbIgfORPSTHZAE,EBGDMBHBGEEBLDCHCDDF.KBAABACH..JFEEXBBGFCEF.hAAAdEACUFAC..bGDGhAAAIDAAOFBDSCEBhABAZGEEADIF.NIEHDAIBcABA...hACA..WHAA..hADA...,1,-9,-36,27
UgWRIZMKDcCaXFJNdLfVTeSQBAHOYPbGE,OADB..YEDFGECGEGAH.UEFBRFFCMACHKCABCGGGXAEAhAAA..JAFCdEEBhABALCEETDAESHAEhADABBBEAAAF.bCFEWFHHIHHA.hABA.DIEGaFAC...hACA...,2,-27,-7,20
gYXeILEADfZWJOHGBUFabTCSVMcRNdQKP,ZBFAJEDFHACDGEAFBEABFGDH....aBBGCCEGMAHBRDED..dHFBKGBHhAAA....gGAGhAAAXGFFICADhABAABEBDABGOAEA.UEGASEEE.hAIANBIE..PAFF.hBAA...,1,-15,-31,16
bYNEQaDXPecFCUAHdIOLSJWgGKTfMBRVZ,HAABOGACJDGBGBABKFDG.MDFARDCC.ZEBC....NEBA.aGFBDICChAAAeADA.CEHBAAAHLAEAhACA.SGHHhADAgDEG..BCFH.....hABA......hACA...,2,-29,-28,1
EZHgKOXNGaPAUeDJLYIfMbCTBRdSVWcFQ,UAFBJEBGLABH..fDFECDHD.BABERAFEdFEFVGAAhAAAFGCHZGEGHEDD.KBBFOADHhAAA..NIEBaDAEhADAAAEDDFIB..MHFE.bDGB..SFADhAFAWADH....hAHA...,1,-9,-34,25
VDeJaEPfQTCgUMSIRWYOdHLZAKNGBFcXb,KAABGGCFFEGE...XBEADAGG.eHAGaHBE.EDGH..QCEBhAAACDECMBCG.SBDFhACARDAGOFACdGGALEAFhADAACACNABBBCCF..bGEE...PFBAhAEA.fBGBhAFA..,2,-25,-14,11
TaeHLGFcUMWfCYIOBJdVSPgNAREbQZXDK,EDGAQAAHDBAD.KFEHaFFHHDBD.FHCGMFBFCBFD...ODBChAAABHHEJFABdFCEPAFDhABAAFDFZBDH..eAFGLBBAhACA.UGGA.fAHE.hAAA......hACA...,1,-15,-27,12
LgZNWRdOJIMXCfVSQHABbPUETaKFYDcGe,BBBAUEEEEBFHaADB..FGFGDGHF.GACGLDFGZGAG.RFBG.dAADJAGHMFBGhABA..CBEH.SEAFhAEAAFAC.TCGDhAFAKHAAeBAD..NIBDOEHFIDDA..hAAA......hABA...,2,-39,-6,33
CfXPTdSDJgaHVYGROKZNcLFWbMQEeABIU,UBCBXGDFdEFDDGAC..aFBFHFCBGBDBKAFEZBFCLAAE.hAAAFCBCMCABEGGAeAFEhAEAAFIFBHHACDFA....fEDBhAIASEED...gDBAhABA.....hBBA...,2,-28,-17,11
aEIZcDfTCLMgPXFAbUONSeKRWBHdGJYVQ,OEABSECGKACCBBHAdBGFGAAE.JFGFQDDC.hAAAEDGHZDECDGCFCHADMIDEhACA.XFBGACFDUGDBNEIGhAAAeAEDHCBBaGDEfBDF.gBAFhABA...hADAFGGFWAFC.,2,-11,-10,1
AdKEaWfZTBMCgYbeFOURISPVQcDGJNLHX,dFBHEBAE.aAGGZFBA.BCDHMAFF..CCHB.....gCFHhAAAbBEDFDAA.RBAB..IFFHhABASFFA.PACGhAAA..QDCHDGABNIBD.LHBGhACAADHDWFHH.fHGBhADA.,2,-29,-28,1
IMCGXcHDSKeEAfgVNFWPTbBOUYaRdZLJQ,VBCEFEAG..TFFCBABHUEGFRCBE..LABGQGBGIBHChAAACFAC.GGAFhACAXGDHDEFGeCFG.hAAAAFIDfFDHNAHE.WHFGPDEF.hADAODAE.dHGF.hAFAMADE.,2,-28,-2,26
WfAGTIBNPKDLbYFgOSCEHUaMJQZVecRdX,TFBCBCCDKDEH.DAGALDAE.FBFASADEEEEFHABGaHEChAAAQGDFZDFB.eBFAhAAAcGAHdBAAXEGChABAACACIFHA..PEBF....hACA......hBCA...,1,-3,-39,36
NPSLIaXGWdYVDcgKUbFHRTBCeEJZAOMfQ,MFFCQCCD.SACCLBBFIAEHaFFD.XFCBhAAAdBFHDGBHKFDD.FBAChAAAHCCEBCHACCGCECHHAFACNIEF.hABAWGEG..YEHDcGBC...gDEHhAFA..hAGA...,1,-21,-27,6
cYQUMGbaTISLNFDgABRPJOdZKeVXfHCEW,RCGDJAFCOFBAZEDF..KACGeHAC...XDDACAAD.EBBC.hABA...YDGHhACAQGGCMICGaAECSFBFhAEANBACDCEABCDGdCCBfAHE.hAIA...cFFHhBFA...,1,-14,-46,32
WdGQFZXELBJKeAHcbUgNTPVafODYICRMS,HCEDUEEE.TABCaFAH.DGGACHEH...SCHFdCAAFABEZADBEBDCBHCDhAAAKHFCAEID...bEADhAAA..NDHE...fDDGhABAOFBG.IAGBMAIH.QGCChADA...hABA...,1,-3,-40,37
ENWBDQcMTUKaHAXFLYVZdJeOgCbRSfIPG,LABDVBCC.dEGAOFGDCDDG..RAEB.SGCH..hAAAfFEEPCGHEFBDhABANHADBGHHDFDC.MDADhAAATAGBUBGAKAECaCCAAIEGFDAB.....hADA......hAEA...,2,-31,-17,14
SYQUeLbdAMWFIKTRJXVHgcaPGENODZfCB,FFFHKDDARAAA..XGAFHFFE..aFCFGDCDOBGFDAIF.CGDHBCFBhAAASCDCUDACeACAhABAdGAGABEGMIDC.IEABhAAAJCHF.........hACA......hADA...,2,-30,-22,8
QedJYIDaSKNVHCXTLGOEPFZBAMfgUbRWc,MFEHUCDGRBGB..QDFFdGFF.JBDAIDBD.DDGDaEAAhAAA.KCCGHABECBACLCHBhABAOHAAFFDFBGHCAAAD.hABAfGAD..WADEYFFFhACANEIA......hADA...,2,-32,-27,5
CFZDRNUdEVHcYJBGWAfXeMbQPOSgaTKLI,XGCCeBFBMDCD..QGFHODAFaAFAKEFA.LCCGhAAAFGFDDACEUEDDdADDEEAGHAAAhAAAJAHHBFEDAIAA.fGAGhABAPDHB.SBBFIHCGCHHCNEIC..hAIA.cCCF..hBEA...,1,-7,-18,11
ZWNBdbRIMYKUAFXQETJCcPOGDeaHgfVSL,QCADJEEE.CFDB.OGDEDAIF.HBDE..VBEFSFAHhAAALFABZABHBHEGhAAAdADBICHAMFHFKACDADDHhABAEAGG..PFFFaGGD.fAGGhADANEIE.YDHHXGBDhAIA...,1,-16,-23,7
HLIOFcedZDSEaPRBGKUAXMQNCfbYTWVJg,MEDHQDEG.CGAC.fGAF..TGFCVBEEHFFHhAAAOCHHFCBEdDBESADChABAaAAARGBABADHKEEDABBDXAEHhADANEIC.WCCB..LCADhACA.IHEBhAGA.eCHFDBIF,1,4,-16,20
JXZbFNVEAHfIGMePLQKTDWOUSRadgYBcC,HFEBGEEHMHACeACCQAGHKBECDIAAUAAGRDEEdDBH.BBBA.CFAB.hAAAJFDF.ZCDEFGGAECHHABAD.hABA.IAEC.hAGA............hAHA......hAIA...,1,-18,-32,14
NDcGeXKTZHUJECWIYROafSBAMFPLVdbQg,FCBFLCCGdGCG.QGGBDDEEGFEDKFECZBEAUGBH..CEHC.IBAFhAAAOAFA.aAGGBACGhAAA.AFBH..MEADhABAbDBC....gCGC.NDAE.XDCDhADA...hABA...,2,-33,-28,5
JDRcUVQdWGfLMPCAFZbYeTEXKISBaOHNg,FBBBZGAGeBBBEGCB.KDAFBFDAHBGF..JBGFDIFE.UFGEdGFCGADEhAAALDED..MCIBhABAABFCTACE.SAAChAEAaFAF....ODAE..hACA......hADA...,2,-35,-17,18
ITQRBAWKVESZNdDbcagYPOCGLJeUFfHMX,KBDCSAEHZAFHDGHB...aDED....PCBDCBBGJGCGUDBGhAAAHEEE..MHBA..hAAATACEBAHAACAGWAGFhABANDIC..dEDG..gCGHOEAB.LEAFhACAFABGfHEFhAEAIHHB.,1,-18,-39,21
AQBXJHWaeVEPMTSRCIDYLcZbdFfKGgNOU,BBADXDCBJEEB.HGCE..eGFAEHFCMEBBRCCD.DEIBLBGBhAAAZABGFAFEGCFCOGAAAIEChABAaAHD..TBEGhACACAAC...IEAD...YADEhAHA....hAIA...,2,-33,-8,25
BLeMRgJDPKUEQcNdYIXTCObaVHFSZWAfG,GDABLADEMIBGRCDCDDHHKFFG..EBHDQAGGdCBA.XFCDhAAACHHDOFEC.aAABFBDFhABA.SBFFhACAAHAH.BHFAJFBD.PFAH.cCGD.hACAIBBB..hADA...,1,-21,-33,12
BOdNgPITSCDbUXFAQHWcfGLVZYaMEKeJR,HEBB..fAAGLDFDZADGaFGEMFBCKDACJHDEBDCCdABG..hABA.NAFG.IEGAhAAA.CFAC.DDHB.XACGhADAAEEB.cGBFYAHBEGED..eAGFhAEA...OBHFhAGA...,2,-26,-24,2
NHXRGIYBPMKQebCgdaWcSJZDFOLUETVAf,HGDERGAGGBACBCHAKFHBQABA.eCFFbCFA.dFBH.aBDFSAFHhAAAZAFG.OEFHhABALEAFUECHTFGHhAAAACCAXACE...PHFECBAD.hABA......hAEA...,2,-10,-9,1
HOWIbdRaDYZAMCgGeSBQNUEVFfLJKXPTc,CEFEGAEEBDEF.UABCFHFE.LDBF.KHBGTAECHEDHOAHFhAAA..bDAGdGGFDEHBhAAAAEIBMEADeGDCQBGAhABAEDGF.fACA.XGAEhACA....hAEAWHFG.,2,-25,-20,5
CJKEHTFMgNZPefBYcIOWVALDQXSbRGUda,QEFFSCEEGDECaEBH.KHFGTABHFHAA..MCBHZCDEfAHGhAAABDCA.hAAAIGHGOAECAEHGDAEFhABA.XGEHRABBCHDG.EFCGNBAC.....hABAYFAFcGGF..hADA...,2,-21,-19,2
FeSZCgabOBDUMGfPNdJYKHWLAXTVIERcQ,TECHEAEARFEH..QCEBFGGHZCGH.CBAE.aGEDBHCH..MACBhAAAGCGE..PAFChABAJCCFKGBD..WFAFhADAAEAFIAHB.eCABgCEBOAAADGIHhAEAfADCdFCH.hBDA...,2,-23,-11,12
WgSdBcCaGEMQZYNeXURAPHKbTLDfVIJFO,KGBFTBEADGIB.....IGHFFAEBODCASCBDBHEE.hAAAaCCFGAGG.MGEChABAQGBCZDACeABHhADAXGEB.AEEBPACGLEFAfDGHhAAA.WBAFhABA.dAGDCFCD,1,-29,-31,2
TfREPDNHIWLBACOQUJXZMYGbVaedcgFKS,QEABXEDBZBCAMAADGDBC..aAGDdABBFDECSDGEhAAA.RAEEEFFCPGFChABADGHF.HECFLEADhAEAAIDCCBBAOCHDYHCG..eBDA.cGAChACA.....hAGA...,2,-7,-6,1
PbgdXAEaNLQZMcBfWGKHVYISCROFJeTDU,aHDGLHDCZDDG.MDAHBBBEGCEAKCHDHAFA..IBDChAAACDBHFHAC.eFBAUFGBPBFAhABAdBDA.ABCF.EFAANBBCQEGHhACA.fHABYCADSFCAhAAA..hABA.OHFE.,2,-13,-1,12
EcHTFINASYafbQdgROBGWVDLKMXZCeJPU,SFFAaFAF.QBECdCAFRCFFGDCGDIEAKDGGMAIB.CEHE.eDBGhAAAUGGDHFAD.IABGhADAAAAB.bGDGOBDAhABABEFD.LHCAJAHF.....hAEA......hAFA...,1,-14,-20,6
CHebQPEFLNZIXaMYSTgUDGJdAfWKcVORB,KCADOBCDBFGGHEAA.QGCFEAGBFDDELAAAZEFGaAADMAHHhAAA..TDGDDGIBdAEDhACAADCF.fHEFhADA..VFAECGGB.PGDCXCEBSAFDhABA....hACA...,2,-37,4,41
SdXIeNCDJabcfFLHUZVABWRKYPQEMgGTO,BAEFKACBQDECECBEGGAH..OBAFXDBGeHDA.CGBCDEAFhAAAJFFH....aABAfEHAhABAFFCAHAFD.ZBFChACAAHHA.RECD.MAAFSHAGNAIG...cGGDhAEA....hAFA...,1,-14,-19,5
fEXQVaKUANgDCIRdGJMZOYcSbLHWTFPeB,DGGFCGEFdDCDMFFBZDFA...OAHF..SBHHHFBBFADFBFADhAAAXFBCQDDChABAKAAFACFC.IDGFhACARADAJGFE.bBBH..LHAGWEHH.eCAHfBFAhAFA...hABA.aAGF.,1,-11,-28,17
AECSgYBcbLINPKTHeFDXMVWJUGaORZdfQ,SGGGBADFLEEG..ICAGKABDTCEGFFCADBFH.MEBDhAAAVGCE..JCGBaDCHhAAARABGZGCCdBGHAFIF.EGGDCAHD.hABA....YFADNEACeDEB....hACA.XCCB.hADA...,2,-22,-18,4
ONSKXIaYDWUZRbgcLVGTfEBMdHPAQCJeF,JFCFeAFG.FFCBODBCKBBA....XEEGIAFF.DBAFZCEChAAA.RGEE...gBGAhAAA.LGFEhABATDADBHAFMBBCPCCAAFIDCADASBAFhABAYEFC...WEADhACA.bFDF,1,-24,-34,10
BZKTCEWMVefdRHaQFbLNIDUJASPGcOXYg,SFGAGFDBOBHB..XCEABFCCKCDCCBDH.MEIHeAEGdFAAhAAAHCBHFAEGLDAEhABADEEHAHAHPHEA.gABChAAATABCEEFGfBHC...hADAaFFGNIBF.JGAC...hAHA...,1,-3,-15,12
ORYSTbDEeXdPWQCKMFZLcgAVGBfJUINHa,VBAABGCGJBBH..UGEEHFEBRAGF...TACBDAFD..EDEFeDFBhAAAdEHE.QBGFhABAKGBEFEAB.ZEAE..LAAChAEAAHHEfGAA.NAEF.aDDB..SCADhACA..hBAA...,2,-24,-19,5
LXfRgCdPYVFcKTHQOGSaWJDAbIeBZEUMN,eCCEEHDGUBFEMHBCLABGRDFE..dEAH.VFFBKCDFHCAH.hAAAOEFBaAGHDADAAHAHBGGFhAAAXCBCCHHCFEGA.QECBhACASFCA....WAFEIABDhAHA.NIAD...hAIA...,2,-23,-11,12
EbJDOXVIRgYBQCNGSZTFWfcLMdeAPKHaU,HBBGEEEBDGGCOEAC..VABBIDGBRFAA.BHFECEHC.NFEB.SDABhAAAZAEC.FAEEhABAfGGDLDDCMIFEhADAAGCGaGAFJAAG.gCEFGGCH..hAAAWAHB....hAEA...,1,-10,-19,9
gaeNIKFDRUJMGHSLCQfPEOAcZYbWTdXBV,ZCFH..bEFFdGBFBFDCVBBD..aACBeAECKEHB..DBGBRFEEMAAFhABAGEAE.LAADhAEA.CCEA.fHEBhACAOHCEACHD...YAHBWBCH.XEAGhADAIAHDFEDG...hAFA...,1,-9,-30,21
UNfCRXMOEaTKDLWSbIceAPVgFdYBJGZQH,VFFAFCDABDAG.ZGEEQADDHDFD.UFAGCAGBRDBF...MBABhAAAEAAH.KDEFDIGCLAGDhABA.SBBBhACAICHHACBDdECE.JHCEfFAE.aEEHhAAA......hACA...,1,-8,-37,29
BQFITgeYGRaSADJdVWMcbLOXfEUCPHZNK,JCEAVCDB..MBEGLGEA..XEGBUGBECACCHBFCZAADBGAFhAAAQBBB.hADAIEABeEAAYDDBhAEARDFFAAGDDGIB.dFFC...WHAA...hAAAcGGD...hABA...,2,-25,-16,9
gELNDWJebIYFBHPGdXaOZfKRSAcMTQVCU,TDACCACFUCGE..LBAHDFGF..JFHDeEBH..IAGDhAAABHADGCCHaACHZEEDKFEHhAAAAFDH.QGGChABAEADE..WDEFFAGGHFCFdCGFXFAEfADAhAFASHDG.hBFA...,2,-18,-13,5
bIDgETMKFUSXLOGYZWcRfVHeBJAadQCPN,dBGCCGBH.....PGFEIBEE.EEGBKCAH.FFDHUDDDSACDhAAALDADOFADhABAGABGZCEHRGDAfAHGhAAA..eAECAHHFNDIC.DEIBMIAG.hADA.WHCG...hABA...,2,-26,-24,2
CIJMDNLSEGcYQFPbOaAgZfXeKWBTRHdUV,ZCADXDDEKAEEBEEDHGBE.dEGGUGFF..VBBECGBG...MAHBhAAADCGCLAAChAHASDABGCDB..hAIAQAEEFEGBOHBEAIEAfGHChABAeDCD......hACA...,2,-25,-20,5
dIUYEOGXFRcgCaTfPQWeSZLAbDKJNMHVB,DIEEKAHFMFDHHCCAdAGA.UFGDEFFFGDAE.RDCG.CBBGaCGE..hAAAPEHFeGBGSFEBhABAAGEDJBBA.BEGEhACAOADAXACAFCGH.TDACWAAF...hACA......hAIA...,1,-15,-21,6
LZVeDcJUfIXAEgFNadMGKTSRWPYbQOBCH,EFBFFFBEdCCFKCDB.RAEE.......PACEbGEE.BFFGLEEGhAAAeCABDDIDJCAB.UAFChAAA..IHADhABAAGDFaHEC..MIAC.SEGBYCHHCACC.hABA......hACA...,2,-35,-27,8
ENPAZYSFgbOMeKaJWRUcVGQfDdHIBCTXL,SHEEFDGGOFGB.KAHF..JBEDRECEUAECGEAH..DAABdAAGBDBHhABACHCD.LDHHhACA.EDGBNADCAAEH...hADA...gGBDMFFHaAGF.cCCFhAIAfCBAIHHA.hACA...,1,-18,-43,25
MDaEYSeANcGUgIVbKPZdXFRLHWfOJCTQB,GEGCUCBH..VCFGKCAHdCDD.FAFCRGFELADEHEAGOBBGCAAB.hACABGDFDFBF..EEEESEEBhAAA.ACIF.hABAgFCEPHAC.....WHAAhAHA......hAIA...,1,-19,-37,18
DRCMfITVabLKZXNJFdOcEeQPgGSHBWYUA,CFACMFCC..TBBEaACCLDGHKAAF..XFEHFDAGOGAEhAAAeEBEQAFGhABAGADDBCGC.UGGEADDBDIAGhADAIHADbGFGZBBC.JCHB.EDDE....hABASEEE.hACA...,2,-17,-7,10
FMGKfdXLBcEAaYTeVPUNbHOQWSJRCDZIg,aFCCTEBG..eHCAUCBBHCCC.OABGQEGH.JHBEhAAACHGFDAHFZAGBFAEBMFECKHGEhABAfFAAdGEEBACAABGFhACAPAAB.bDFASEEC.IGAHhAGA..XAEAhAFA,1,-9,-23,14
EALQeDaBZgYIWFVfdHcSKXNCJRObPMTUG,LAFADFGDBAAEZDCD..ICCHFACC.dFGGSFADhAEAKGDACCFHREBB...OFHFhAFAMBAE.UBGFAEFDeCAHaEFB.hAGA..gGAD..WBCA.hAAAHFDBNEIE....hAHA...,1,-20,-35,15
SWZeGQdNBODTUIELbXCKHgJfFcMPVRaYA,SGGCeBHBdGEEOCAEDEAD..UADELAFECHDF.KDEEJBFCFGGFhAAA..MDFFREAHAABAZFCDhADAGCBABBBF..IDGFhAAA.EBAA.XGAH..hABAfEHG.hACA...,2,-34,-23,11
AUTNEgQdeaLHPOBfIJKRVbMFDcXWCSZGY,TEEBEHBCdFEALABB.HADHOCAABGAGIADAKAAFRCFDMDDHhADAFGCHXDGAhAAA.CCEFSGAHhABA..YHFGAGHBUBFG.NAIE....hACA.eHFGfFADhAFA..,2,-23,-11,12
GFNBHVfTdQYRCgDKeMLbWZAOJSaUXIEPc,JABAUDFH.EECGGEEFBFGD.HAFH.TFABdAGCQADChAAA.CDDB.DEDAKCAHMHEEhAAALFAFZBBCAEABaCHDXGDHhABAIHCC..PFCB...hAEAFGHD..fFCDhAFA.,2,-23,-15,8
ZMHPXJUebTRdDBWFQSCOAGIVYfKcLagNE,GBBBVDGB.KEDALCBH..aAAGEAEHMGAEHEDD.JHAAeHAChADARAFHBAAEFCFESFGFhAEAAEAF.fAFDhAHAcGGCZACFPFHF.....hAEAXGED..hAIA...,2,-27,-10,17
DgBVfRMPEFWXYCcLKOJSHIaUdQbGTZAeN,eBCGDBDFBGEHREBE..ECAEFCAC....XCGACBEBLDECJFFEHAFEhAAAUAGE.dHEHQGBEhAAAGDDHAABD..NEAA.hACA..fGGE.MFAD.WEFGhABA...KABBIHHEhADA,1,-2,-49,47
ODdZWURMBXIcNGQVfHeEbAFJKYgSCTLaP,KBDDSCEELFAGOFHHDADEZFGD..UEDEMBADBCCC.XCADhAAA..ICFGhAAANICB.QFEChABAfGBDeBBBAHECFAHDYAHDCAGCaACEdFAGhABA.cDFE..hACA...,2,-29,-25,4
WdBCIVROeZFUKgMJXGAESYbHTPNfQLDac,EBEASGFDHEFE..TBBD..fBEFDCIDaHBCdABFBHBEhAAAVGDAOEDG.hAAAFDHFgEAAhAEAMAEAXDAAAEDDPDDAQBBD.cBGBhABACHHGIAHAeFFEKFDFhACA...,1,5,-28,33
OJaMecEBHCYgAVGfXIDSZFQWRUKLTNbdP,VCCAXBGA.DAGGZFEE.QFACUGGGKBCA.LHDG.hAAATABFbDEB.OAGDhAAAJFADMDDBEDAECEFEAEHB.IAEAhABAFBAF.NCIG.aHBEBHHFHAEA...hADA......hAGA...,1,-7,-17,10
PaUMcQdFCJIfNeWDRKLbASOHGVYZgEBXT,SCFCGEDDZBBGBDDF..PCBGMCIFQEAEhAAACEEA.JHAAfEABhAAA.NICDDGAGLGEAhABAOEGBYAGHEACCaBAHdBHAIACH.hABA.eFHF...hAEAKGDAAHIH..,1,-6,-24,18
MYDBOVcAHZCFgbGPLXKTfdREUWSINaQeJ,CHGCFAGCGDBHLDCHKFAF.dEGG.UADA..SAEF.hAAAIFGBNIDHQBAChABAMICEBBBAOGDCAAAEHCFAhACAZCFE.....PGBEfEEEhACAWFHHaDAGYFBFhAIADAIH...,1,-20,-24,4
RYCgJMQVZPGUHWfebNcOFdKTaBSEADILX,DFAFLDCHRDEE.CHGH.MIDAQAFFZFCEGBAFHCFC.eFHB.hAAA.NBEB.FGED.dAAAaGHFhABABEAEAGGB..XEABhACAYBDH..JCFA......hADA......hAEA...,2,-25,-16,9
bcLBQfUEFJNZRWIAOeDYHGSKaPVdgXTCM,DDGGHAAFGEFCaBEFdGGB..TDADMIFALDDABFDBUGACFCHHZBCHhAAARFABADAF..eAFG.hAAASHCEPGCAXAFFhACACHHF..cBAA.EADG.WCFFhABA.....hADA...,1,-10,-13,3
LGebRHZIPQCafXVFAEgUNJWMdDBScKYOT,UADCJAEG.MDDCDCAGBABD..KABG.OFBBLHBGGEEDhAAAeGFGRAFGHGCAZECGQBGEhAAAaCCH...hABAXCECAHIF.NADA...WHEAdEGB..hAHASEAC.hAIA...,1,-19,-24,5
DCFRSGdEOgUMabHeJYPWVcQABKZfILXTN,BEDDKFEAZAEDLCBH..XCAADDGACAFCRGBC.dEEF.EGDBUFGAhAAAMBHFHACH.eBEAhABAPFHB...VEADhAAAAAHETFEFFACCOHAEaEAB.....hACA......hAEA...,2,-24,-13,11
SREMaWXfIdNUcFZQCPYbegKOAVDHLTJBG,DBECHAFDLHCEJBAABHECRBGH...MEBCXAAEdDAG..UGFEhAAAFEEFCECE....PFCDhABAbDAB.KEFGAAEGTGGFhAAAEHAG..aCDEfGAG..hABANAIEcACA..hAEA...,2,-25,-24,1
SfdLaTEJQPCGDYeAUNZBMbcXOgKVWIRFH,ZGDAMDBF..XDAEKDGH..VGCCIBHCHCCBdACBLFFChAAAaGGH.EAFBQAFGhAAACACADCCGAFEHBABCOBABhABA.WAHBSDEG.TGAB.hBBA......hBDA...,2,-22,-16,6
bXUgJTARINSfWHZaCOYQdLBMcDKVFGEPe,RDDDSEGAHBADCCFC.QABGdADCBGGGDAAGKGECFFAE..EFBBeEEChAAA.UADGJDGHAAFGIHHAhAGA.fHBFhAHAaHDALAHBMAIH...cDDBhBAA......hBBA...,2,-32,-20,12
CSWKIFAVgZHUYJabcDNBOdTMGXEeLPQRf,VDFCZBEAHFEE.UBABaCCH.DAGGBGCA.dAHCTDCAGABHeEFEhAAAQGGF.CFAEKEEFhAAAAHBEgEAEhABA..YBAF...cGAChABAOHBEMIDE..EGHFhACA...,1,-9,-21,12
EaKcZTSdRMfNePOFYGCBQVAWgIHUbJXLD,..IBADUFEBXBDBDFHF..ECEHaDHBZBGB..dGCEREAEMHAGhAAAeCFFFAHD.GCAGhAAABCCBQFEDhABAAHIH.gAEE....bABBhAEA...KDDF.SGADhAFA,2,-35,-13,22
SgPOELbJCAeNcZUFVQRXWHDTBKIMGaYdf,eFDDZCFFUCBHQCBARFEE.HBEEDGBAKBHFGFED.dGAD.fBAHhAAASADBOEFAhABAEABE.JAFCCAADADIFFDAHhACA....XGACBHHHaDDF...hAFA......hAGA.YFHB.,1,17,-38,55
FfeWXAdUQbLOPYHKCRgZIDJVcEaGNBTSM,QABAOAFFHFDDREDCZAFEJCCE...VFAFEEBCGAAF.BDADhAAAMCIBFGHDeCEAAHAAdFFAhABALAAFKHBA.IGHHhAEA.DGGFNAICSDFGfHDH.hAFA......hAGA...,2,-15,-9,6
cLMFObEDWYKPZaXJUfeTARNgGHIdSQCVB,RDAFGEAFHFDBdFFDSBGECAGD.BBEALCDEFDEGOHDADACCKBHHhAAAaACDUBAF..eAADhABAAHAC.IHHBhACA.QEGHMIAC.EGAHWDEG..hABA......hAFA...,2,-30,-6,24
GSAPbBIcLdYDXCRTfJMKgHNEZFQVUWOea,BEFCLAFADGCCRGFGJGCG..KEAAHBDE.EHGAZAACFBBBUAEE..hABAODAB.eDFAhAAASBGHAGHA..hACAIHADdEHACHACMIDG..NFDF....hADAWHCAaCCC....hABA...,2,-37,-26,11
TUIgBaXPOCKcMZebNRVAGJQLFEHSDfWdY,JADDFGHHECDCHDFH.DBIDdACH.UGAGBCAG...aFACODFH.hAAAKHDCMFBAZAAHeCHDhADARGCAAGIHLBBB.SHFAhABAfAFF.....WFAEhAFAIHAC...hAIA...,1,-27,-32,5
PJBaARgOHFdeXKYfcCSWEVZUGQLNIbMTD,RGFCHGDCeAABKFDC.....fBGHCECFSAGHEGBAVCABhAAAGCCBLABC.hABANDDB.IEGC.hAFATFADDIGEBGGBaACDAFECOEEAdAEFXFCDhACAcAFG.....hAIAWAHH.,2,-28,-2,26
GPKDbQgAdEBLUMIOCWYNcZVRXTfSeFJHa,dHABBCFDUGGGMGAC..OAAFCEFB....NFAB.ZEBG.RADC.TADBhAAASFDA.hABAJCGDGABA.KGHBhADAbCCCADDAIHAC...WHDEcAGFhAAAfCHA.hACAeFFAaDHD,1,-33,-41,8
WLHCVAbMfBTOeXNEQYcIRUFdSaKPZGDgJ,MCDBTCEB..OBAHeAEC..EFGEQGAC.IGHAhAAARDCDUCGCSBBDhAAA.aACHZGDEDIDAhABAWBFGCHHDAAIBBHBHXDGBYEABcCEH.hADA..FBBF.KEBB.hAEA..PAFA,1,-12,-16,4
fDKPGUagJMTQIZNBeWESFXCdAYcVLbRHO,VCAHREFDOEDB..DFFBGBBBUCGD.aGCH..MIBC.QGGChAAAIHECNAHGeACGhABA..EAEGSEDFhAEACAAEAGAB..cDAHLGBG.fAGDhAFAgCEA..hACAJCCA..,1,-10,-33,23
fSGNVbDMPOZEAHUCTXYFeBLWcgIdKQRaJ,CFDHXFBAFAGH.BFHFLFBF....gGEEhAAAIACAKGGAaCCH..JADHfDDHhAAAGAGGbCADMAIHhABAZAEHAIBEHDFB.YBCG.WHDGhAEAcEEF....hABA...,2,-25,-23,2
TbZMOgIJRYGdDNAfQSVcHKLXWUFaCeEPB,QCFGSGGDHDBGKCABLHAGUEFBCCBD.EGHHBBACZDCBMBFEhAAAOGBC...IAEChAAARFFHdACEAAEA..fGADhABAXBFDFAHFPEEB.....hABA......hACA...,1,-3,-31,28
bMXdNaeURKQIVBYOGDSTFEAJCgPLZWHcf,CGCELBDAHCCG...fCCEMBCCXFADaGGB..UDFGhAAARDFGQAGBBAEEGEBAhABASGGFFCABABIB.hACAPAADZEDBWFHHdEAFKHDAIHACOFHDDIDAhADA......hAGA...,1,-2,-11,9
OQGTXaNfMSIUAPCKHDgEVYLbcWFRJBeZd,KFFHDCFEEFGELBDB....bCBAFCFGRFAFBBADdBBAQGAEhAAA.XDFAhABAaAFEfFFEMAIBIHHAhACAAFDFPHDE.CADG.gEAC.YADChAHAcAAFWEFEhACA...,1,-13,-42,29
eTKcJZCDMFERQPaVIYGXfSUbOWLAdNgHB,dDGGHAEBBAAFeGACKFEFJEDCZCBE..CCHDDBBDFBFG...RFGB.QACGhAEA..PGDChAAAIHAH..XABBhAEASGHH.OFAEAAGGNICH..cDBBhAIAEHCE....hBAAaGGB..,2,-30,-29,1
aRIUXJLdgEHYDQCTOAfSPGeZFMKVbWNcB,SFACeEECMEDDKABF..VGAE..NCAC.aDBG.UDEAXBEDhAAAdABGEHFE.HADChAAADFIBQGFDhACACEGEAHHE.PHAC.FCCB.cBGABECE..hADA......hAEA...,1,-17,-24,7
UedJWXPRcFCfNEZDKOIMQVYGbHTASBgLa,SHDGBGDAaCCG.dCGH..JCAD..XFFBRDGFFAHD.fEBBhAAAEDFH.DAEAKGAChAAAOBCFMBBCQGGFhABAYDAF..HFCCADDH.gBADhABA.eFHFcCEBhACACAHC..NEED,1,-18,-39,21
MNGVPaIAKLUFeHgfZcWDSJXQRBdEYTCbO,UBEHHDCGZBDCDBHF.XGGDRFED..BBBBEEGG.CEAD.MADCGDBDhAAAaFDE..KBBHLGAAhABAFHDCeBAD..fEHEhACAWFBH.SGGHJBHH.dADB.hAAA......hABA...,2,-28,-9,19
PDASORZFINGaYCdJTVMWELfBKgHQcUbXe,SFDFOGACZCDHFAFGGBEB..aABBCEEBJDAE..MIBCEGECLAFChAAABADHHCFDQABFhACA.cGFEhAEAbEGHeCCD.DAIHIEGCdDAA..hBAA..WFCGKHBA..hAAA...,1,-6,-20,14
NeRcIHdgPEaBCQXUZMJYLWGAKSbVfTOFD,KEFBVCGHOHBC..DACDRADCHDCGdHAHEAFFCAAB...UFEHMDHFLDCBhAAAAGCC.SEAHhABAfCBDFADGNDAG.hACAeFHH..cBGB...IHHFhADA..aCEH.hAEABBHB.,1,-22,-23,1
VMFXWgDRJdbOQGfSTCLEHZABIYNaePcKU,BGEH..NBEEeGEGKCDBMFDH..FHAC..XEAGDGGGRDAAJCGDhAAAdADF.OBBH.hABAQEGBfABAhADASCGGCAGGEFCDAIHA.IHAE.aHEEhAAA......hABA...,2,-40,-31,9
XdRaAOgYIcHLfQPVeKDNFGZSBCTWUMEbJ,OFAC..IAFGLGFCQAAGVDCA.eCFCNHAH.hAAAZEABBBDATFCHMIFEhABA..EFFG.XCDBhACAaAFBAAIB.YHFAfBBADDIDSEFEhADACDADbCFD...hACA...,2,-32,-5,27
BIJREaNeXOHUDdZcbPFTfKLVWAGMQgYSC,MDDDQFAE.SABEBCADRCEGEFEGaEGF..eBFEHCCDdGAEhAAAbFEBFDHD.KCBEWAEBhAAAAAFGGGCB.CAHB.NDIAUGCGhAGADGID..ZABCcGGC.fBBChAHA..gEAEhACA,1,-10,-14,4
OgVdFaWGEXCHRAfBbLQeUSIYPDMZNcKTJ,BHCGLBEFeDHHSGEA..IADCDADBMIDENACA.TEAEhAAA..ODDDhAAAgAGGdAGHFHDAaGDGhABAEGFECCAGAHHAQCFF.PBAHcCGChACAKFBF.WFAD..hABA...,2,-27,-18,9
dBcSEXZKHTWYQLgRUGAFfePJCMaDIONVb,FHAEeCDBCCDE.MAFB.DHFAOCAB..VEBBdDFGBGHD.EBGEhAAA..KAGGHEBAWEADhAAAQGECLDHDRABChABAABCGJDHHaGDD..ICAHNABH..cBBHhAGA.....hACA...,1,-21,-26,5
VDcaIBXWEKYgCNQLSeUGFRAHfbMdPZOTJ,HBDDMHDEdEEHZBABTCFADDAG...aFBGBFCE.EGAFKAHBCBEGLAAGhABAeFEBFGHFAGGB..hAAA.fCCEhABAPAEGJCHDIHAG.WADCgGGBhACA.SDDChAIA...,1,-7,-37,30
dRFSOYPgZCcADaINHVTWfeLQGJBUMKEXb,aGHDHEFA.TACEeAEFQDBEBFAAUCFBECDHdABBFGFA.OHBEhAAAPAABZBGF.AGEFDCGDhAEAIAHG.WGBAhABAfDEC.JGAGMIEE.KAFB..hACA......hAEA...,1,-9,-18,9
ZfKUOVDMIcWAaJFgBPTXbNGELeYRQdCSH,JBDCBAEH...TDEAXDABGGDBLFDFRBAF..dAHEHGEEhAAAZDGDKGBHUEGFDGAFMAFEhABA...WEADhACAFEDH..bACDeDDACEAD.fCCB.hAAAICHEACEGaBGBNEIA..hADA...,2,-25,-8,17
RFHbSAXgNWPIdDMZceGJBLaVEUKYOTfCQ,XDBD..NEBF...IEGGdBFFZACDeFDBBBAGLAFGhAAAEBAFKFAF.OHAAhABATGGFCFDAFADFHCFDAHHCPFFBhACAMIAG...cCGFaAAGYCHBhAFA..fBBBhAGA..,1,-18,-21,3
ORPeTKdBFCIgAfWXbESYDcJNVMZULGQHa,XBGDEAGADCHH...JHAAVBBH.UFFDGBAG.aEFGOCFDhAAAeDCAdGGAFADFCFAHAEAB..hABA..fACEhAAASEDHNEIEZFCCLFCD.....hABA......hADA...,1,-15,-26,11
JdFGKETHYbWUDcNfZLCeOVIRBSagMXQAP,JBBHGCCC.EBGHHDDG....bACCDIBC.NHAH.LHEAhAAA.OBBHIGGBhAAASFHBMAGHABEGdEAAhABAFEFGKFAF.TGBEWACB....fEGFhAEA.CFCC..hABA...,2,-34,-15,19
EbBgUDKVYQPWedOJLfGaSMXCcRIANHTFZ,TBBBEBDHBDBB.DFHBKACC...QFDDeCHBdFCALEEBhAAAaCGCXFFBCABC.IECBhAAAAAHDFBFB.ZAED..hABA.gGBDUGAE.....YEHBhAHAOHEEfDAEhADA,1,-27,-31,4
QWdPZLcRUTHYFDgXMaANSVbIJeBCOEfKG,SDEHVEEB..JADABDBH.OBGBEBGAKHFAQABDhAAA.dHDDPDBBhAAALAEERBBEHDGDDFGEXGGHhABAADFGIHACeECHCHHB.WDAF...hABA......hACA...,1,-16,-25,9
KXJaUOSZNFdTWHQRbcADBIMeVGCYEgLfP,DEHDMDHHGCEH.CHBA.EBDGLCBHKBGAJABH.UADDZEDC..dGDHHGFEhAAARDAF.AEABBHAF.hAAAeEEFgGAGhACA..XAGASAEENDDG.WDDE.hABA......hACA...,1,-20,-21,1
gQSMAJUKDeOdGWYZfRPTXBHCcLabFVINE,JACEKEFFODFAGAFEZDGD..REAH...XDDAHAECCGHALDDDhAAA.aGGHFFBE.hABAIHBEEBBGQCAHhACAMBBFAIHC.DIAGWAAFfEHCBCCCbGFC.hADA......hAEA...,2,-25,-15,10
CLAGZgMKSPdeOXIfNYETFUbRHcBQaVWJD,ZFFFKAAHdBFBeAED.OGBG..IHGE..NDHGTDCChAAAUDAEHFDG.QGAGhAAAaAHDJBAG.DICGAFIDMAGBhABASEHH.PCGHYDADEDDEFACFhAEA.....hACA...,2,-27,-13,14
PMIFCHYDKNJSfAEdXRZGVUWbLcBaTOgQe,EGDEdGEBZDCCUABFLAFFBDEB.OADF..eFBHMFIBIHHEhAAAFABFHDGH.DICGNEAA.hACASGBE.hAEAAHAF.GDFA.WBFCaBHF..gDADhAAACCCD..YDHHhAFA.,2,-39,-7,32
geICEJdQXPVUKTYRFWBcbNaHMfGADZOLS,DBHDZDBDLHEAeBCF.CHBC.dFHE.QFCAVEEE.UEEGTBAAhAAARAEDFDAD.BBBC.hABA.NAEA.aAABMBFEADIH.hACAOFHFSGAFIDHC.EDADPHEChADAKFDF.....hACA...,1,-13,-21,8
cLCBPSMgEGYKFWVIZfRDdbOeHQJaANXTU,TEDBLAFC.BDBGMIEAEBGFGAEG.FDHHVACBZEAHDDCDdGHCOHDAhAAAQACFAEIDUEDBhABACGEA..SAGBhAAAKGBD.IBAD..fEGChACA....hAEA...,1,-9,-27,18
WDcQSVTaREOCKYAgUIZfLFGNdHbXeJBPM,UDEDZEEDFDCEdCDBHBFC.eDADBGHF.MAADDGDFQBBGhAAA.SGAAhABAaEADRFBFCDHGAIFA.IGGDGAEB.hABANEIC...JBBHPACG.....hACA......hADA...,2,-35,-5,30
HVIZBWJECeTAaDSfOXUYKcgMQGNbLPRdF,SCFCOHBAUACBKHBC..MAFCQBCEGDABLEFFhAAAdFHEFABBHEEDZDGBBFDEhABAJEAECAGCAGDADIFG..XCGAhAAAYBFG...NEIA......hADA......hAEA...,2,-22,-13,9
QCHVKOGbSLeaRTEUJBdfcPZgIMWAXDYNF,XDFCDGBHFEHHHGCGKAFD.GCBALAHBRAFD.EEADBGGG.dACBPADHhAAAZEDG..IAHBhAAAMHBEAHGEQBAGhABA.OFHFeBAHaFAB....hABA......hAFA...,1,-13,-15,2
OeDUFHEYGAVcbaMgNdCfJWPLKSTRIBXZQ,VCAFaCDC..MECGdGBG..CCFD.JAADLEFAKFGB.RDCH.BEFAQGGChAAAOGAGDHCGFGEDHACGhABAGBEHACHH...hACA...cAGANIEDfDAH.SAFChAAA..hACA...,1,-5,-41,36
WLfdEgVOJeUGNISCZaFYcXTHBPKDRbAQM,MAGFLDCCdFCE.EFAAOBBDUDGD..GAABSDDEZGCAFAFF.hAAA.XGGABDAGDGHFhAAAAEBFQEFDhABA.fHED.JACAIBHEhABAaAHFYFAF...hADA...,1,-12,-31,19
REdYLWbZJFcVBAHfTIaKPNSMCUGgQXDOe,HDDGTGFEKAAF.SAEFUADDGAAGQGFBDGDCREFG.EGCFLHBGhAAAZCBD.JAHDcAGChABABDEEAGCH.aEAE.hACA.NEIGCHDA...ODAB.eCGBWAGFhACA.FDDHIHADhADA...,1,-8,-10,2
AYgJbOTcCVLMGHaeBKRdZIWQSXFENUPDf,JDDCTBGF..CGCALBBBHFDAaDCGeBBGBHGG.KAFFZBDA..IADAhAAAQFGBSFHHhABAEAGA.PHAGhACAADAF..gFAAOHECcDFFMFFH.hAAA......hABA...,2,-37,1,38
UEFOcNATKfLVSQPGgBWRMYXCZdHebDIJa,TCFCLCDB.SFAEGCACBAHCRGCA.XEDAZDGFHBABeACBhAAAIHHCUGGDFGBEhABAOABAAIEAKEGGQAEAhAAAPADA.WBHBMBIHdGFE.DIAE..aCDDhBAA......hBBA...,2,-6,5,11
EHbLFgNOaMKQSWXDdfPRZBYJAVCcGTUeI,VBGDCGHBGBDH.UBAHEBCGHEBG.FCAAOFEBKGAA..SHGAhAAADGGBdDHCRGAEBDDDhAAAAFHHeAEB.LEEHhABAaAFA.MIBCXEAE...fDFChABA....hACA...,1,-7,-29,22
IFPLVONBgZEWYbdQUAfScHTeaGJDRCXKM,SGAHHCADTEEDGEADDAGG.RACFKFFGFFCCLBAE.OHCChAAABCAFgAGEhAAAEEHDbGEA.QDEBhABAfDDHeFHHJBGBCAEFIHFA.PCHHhACA....hAEA...,2,-16,2,18
FHITKRfcYUSVPgQbGLJaXBCDWAMEeZNdO,eBBFdECCOFFEFDDEHFCBKDAE.RFGF......fBGEhAAAUAAGSHAG.VAFBhADAPFAF.gEFFhABAbDFCLHDGJADBBAFFCFAFAHHG.MCIDNAEG.hAFA......hAHA...,1,-4,-24,20
aRVMLbIWHJBCGXFgYdSPNUDKZeOfAcQTE,QFBBTGGA.aEECVCCC..MEAALAAC.IBBHhAEAWADHHGECBGEGCAFGFBAFhAAAdBHESHCGhAFAUCFGDCIDeHAGAHAARDFBJFBE.XAEA..hAHA......hAIA...,1,-10,-11,1
BFQINeLZRUcDfVgKaMYAdEPCOWSHTGbJX,dGGFCBDE.OFCGSGFDHACEGCEH.JHCCBCAD.IGDEhAAALFABRBEHDBAGgBAGhAAAMAFG.AAGGEAHHhABAPEFE...bCCD.FGBHNEAB...eEAFhABA...cGGChACAKEGG.aCGE,1,-9,-18,9
eEIGFaUJAWbXCBfSQDTVZHRPOcYLMNKgd,XDEFCFFHBEED..QBABDHECZDBHRAAA...OHBGLBFChAAAKDCBdCFBIGAG.hAAAFDHHaFHBAGGE..fDAGhABASGAD.TEAH.HADDYHAGhADAMIEA.eDDD.hABA...,1,-14,-31,17
UVZaDIFBGKQYcdeESRJbHNMgOWLXPTfAC,VAEEDADEFAGD.GCCGQEFB.dCAFeEFBRECH.JDHBHDAD.hAAA.MEBDODDGXFDHhABAfGEE.hACAAHGDCHHDaBBFIABGBHHBKBDEEHAGNIBD....hAAA...WCHB.hAGA...,1,0,-25,25
eHFONXAGTSUQRVCaJWBgfEYMIPLDZdbcK,TEGBSHAC.UACBVBEA..CHFD.JBCBBHHH..fHBDhAAAMEDDLEFGhAAADGAHdBACKAGDFFEHOCFEhABAAGGHQEBBaDAG.WAFEEFACIGGGhADA...ZDDF..hAFA...,1,-18,-21,3
aUFPYDCWegNdOcRHfZEJQBXKMTVAISGbL,SHEGGBGELCDBUCEF.FGEEDAFCeBBBdHBF.OADGHFFCEABEhAAABGBEKEBDMCFD.AHAA.hAAAaCCFCHHG....NICH.hABAfADD.JAHD.....hACA......hAHA...,1,-19,-23,4
XfHbDgMCTLWdZYaJVOeKQRPNFBUAISGcE,GBBCEEFBHCBGDGDGCDHDLBFAZBGF..aFFDJFHFeBEH.RFABFADHhAAABABD.UEADAIFG.IADHhAAASABFXGADhACA...gGEEWAFE..hAFA......hAGA...,2,-25,-22,3
KGZUfECFNgIQdSLTXODMYRJHeVcbBaAPW,KFCBZFCHUFEEEAHD.FBAB....NEGE.QAFCdEEGLACDOCHFhAAAMFHB..JDEAHADEhAAA.eFAB.bBAHhABAaDBAADEE.GEAGCCHGIHEAXGGH.DCCAhABA......hACA...,1,-5,-23,18
LWIeaBGfDJgKRAYTcFVPZHMNCXQOSEbdU,TGCHVEBF..HAACCBFC.OFEBEFDGUCBE.LBHBIDDEhAAABAAFDEADKFHBAHFFFGGHMAHFhABAQGAAdBEBeHFGhADAaEEA...fADE...hAEA......hAFA...,2,-18,-17,1
WNeATGKMEIXJCRHbgfacLDOVPSYdUFZBQ,GDCHEGEH.JDHBCAABRCBBHFAB....fBEFLBAFDCCAhAAAOEGDSHDEhABA.UAGABGCANBCHACFFMCGBhACA.XGAF.aBCFcGGHYAFChADA.FEEB...hACA...,2,-21,-19,2
cVZaWLfEIgdHOMRYTBbSKUPAeCFGXDNJQ,CFDFFGDEDFGBQDGF.ZBDBLCAA.IAHAdGGBHCAGhAAAMECBTAGF.BEAGhABAKBAEAEIBXFAEhACA.NIAD.VBEAaABE.EHDE.OEAF.bFGHhAAASFDC.hABA.eDEB.,2,-21,-1,20
EdABYMaWTPfCGXNIUeFJDcHbVLSRZgQOK,BHAAMBCH.aEFA..TBEACAGG.GEFA..NGDF.eABEJABF.hAAADGAAHDADbGBELAHBhAAASCFEZEACQADBhACAEDDDAFID...YEDA..hAEA.fGHChAHAIHHH...,2,-39,1,40
IbVGYMZDHAOeLXUfEFSaQgKdRWBTCcNJP,OCHDLEBEUBAFFAHFQGCD.dACDBBFF.CGDDJECEhAAAPCFD..IHGAhABAVFGHMCCE.DDIFhAAAABDDeEAFEFBH.SHAAKBABWFAD.NDDH..hABA......hADAbFFG..,2,-39,-13,26
NUBMgeLDWYOIFPQARdETGSfVXacHCKJZb,EFACSHCG..VAEFaBDBHFEFCEGCKFGH.JFABZDBC..UGGEhAAABBAEMCGHLHDEhAAADBIHOCBFFHAGAFFDdACCfDHEhABA.cECENCIG...WAEHhACA......hADA...,2,-26,-22,4
LFNDVbecZgJdROCaXWKTYfMEGHUASBQIP,QEFCLFFFDGBHeHEGZCDAdCHERCCB..CFDA.aAFDKDBF...TADDhAAAMEAFEAABHBGFAACABHDFhABAIHAG.FBAChABAbCBH...gGGBXAFFWFCDhACAfADF..SHGEhADA,1,2,-37,39
abEQRZUDIAgdcOGWVFYMLCeTNJPBXHSKf,dGECODHHGACCFEEDLDAFeCGD..TEBGJBED.BEEASGDGhAAAKGFH.aHACECAEhAAA.ZGACDBACIHHEhABAACGA...cAFBYCACCABA.XGGChABA...bEBFhACA...,1,-10,-38,28
YEQdfVScDAgUOTWFMKReLHBPCJGabZIXN,UBBFOBDCFBGHRAGDLDFFBEHD..CEBA.aDDHZFBG....IEAGhAAA.XCAAhABANAAC..QGEHhABAfHFDSGADAEIFgGAC.hACAWACEMAFEKEGBeBEFhADA...,2,-46,-17,29
cUFARfQdPGJXZSVCIaTENeHgWBbDKYMOL,QBBDGGBDJEFHZBBHCFCH....aABAEADBeGEGHAFHBDEHDEAHMEIBhAAAOFBH.LAHHhAAAFCAFAFCHdDDEXAEHhAEA.IEHB......hAGA......hBAA...,2,-26,-19,7
CKORTeFGdPUWVZHDQJbcMASXEaBYILgNf,SAAEaDAABHEELBFD..fHCHCGHG.RFACTEDBhADAFCHFdFGFUABDZAFAQGFBhAEAJFAF.bBBAhAGAMDDBEDBF....YCHFNAEFKEEFeEBBhAAA......hACA...,1,2,-27,29
EUDCBbZPKLIfVWcRXTNQGJdeFAaOYSgMH,aEBDOCAG..SEFAMICAHBEFDBDBBEBFZBFDLEAFhAAA..fEFAhAAAVFDB.cAGFXGGAhABANCHCGFADeABHAADEEDDDCEDFKCHBIABH.hAFAWFHH....hADA...,1,-9,-23,14
OCJFPbcGKDLfdNIZVQWBeSURXEHYagTMA,CHEHFBFA.....PEFAGEED.KFAHLADFdCFBZADBQAAHhAAAeGACSHAAhAAARDBEECAF.aGGA..MBIHhACAAECBOEEHJAFG.DACHfGHEIBABBBEGhABA.....hADA...,1,-20,-21,1
LbFCcSTRIXJfeYKDGZQaMdHOUEAVWBNgP,VAECBFDB....NHDD.LEHB.FDAGSGAHRFDG.hAAAJABEfABAhABAKDGBDICEGBEHaHDCMAIFdCCAOFFChAAAADEF..gDFFCAHD.IHAGhADAYBAFHEAGhAEA..EFBG,1,-18,-29,11
FERSQYPDIdTaeUABWHbZVOgcXMGLJCfKN,BAFHHDECVAGDOBHD....XBCHMCGFGFAHCAFCKFCAFBAChAAARCCCQGGCDIEA.hABAIBBFaEBGAHFGbFFAZEEHhAAA..LDAFfADA.SHCAhABA.PCAHhACA...,2,-18,-6,12
ODcTEXUBSMFQadWCPIYeZANVfRbHGLJKg,VDDHRDEBHCBH.LAAEKACA.OBHFDHACEGGGBGBE.MFHHaHDC.hAAACEAB....PEDHhAEAeCFAAAGE..fHEBhAFAJCAATEAHSGAD.FAFEdAEEhABA...IEHGhACA..,2,-23,-18,5
FDAELcRQZKfGaXCWTBPJeNOgbSMYUVdHI,EFCDRCEBKHGAGCEB.CFAH.BBGA.JEAGOADB..SAGEhAAAUBAGVFGFdEHEFAHBAAEGLCAEhABAZFEB..hACAfECDXGDE.......hADA...WBBE.hAAAeFBAgAEH,1,-11,-38,27
GbYdJHTcWQNaRMVKAOBUXFgSELfDZICeP,BHEAUFAFFBDCEBBADEFCZDEB....eBHFGADEdBAFHCAF..hAAAWAHFaDDB..MFIHhABAAACAOGBA.SBAFhAAAIHGHCHBGbEFE.....TGGEhABANADD...KGAF.hACALAFH.,2,-18,-12,6
HGfNRceZdLMDVKAJCQXgTEIabPOYWSUFB,QBECXAGD.EGBEaCDC..OCCFSHEEBEFHHBADhAAAGDEHNIBD.eBACLEHBhABADGAHKECHCHFE.IGBFhAAAPAHH...WABE.fBEHhAFAZFEEMEABAADCTFGB..hAGA...,1,5,-24,29
ZQPNKbTFgfcWRaAXYIdJBDLCUeOHEMVSG,XCDCdEDCDFADLBAGUEED.HGFA.ECDASFCBZAEA.hAAAQAAHKEHD.hABAFBEAfHDBhACAREADAAGGYFHFBEFB.CHAHODAFMIDEPAHF.hADA.bCFA....hAFA...,2,-13,-13,0
KWRUbVGcYMIfFSTeJgZNDLHCdaXAEPQBO,QGBGKFAHUCGGGCBGMFFC..FABAeACCZCCHDCFCHFDA.CHAD.aGGAhAAAAAAF.BEAE.OAHFhAEAbGFE....VBDFhABAIDGGSCAF...JAFGNIEB.hAFA......hAGA...,2,-30,-4,26
eUMHTFJZbRaYGPgXdCQEIfOLAVDcSKWNB,DEFDSCCBKHAEBBEAeHBG.HBEDFBGDZEFBREBEGCGG.PGDChAAAdCCACDAA...IAHAhABAOEHD.AFIFWFADhACA..MBBA..JACGaFAE....hAAA.YEDB.hAGA...,2,-48,-5,43
bgNVOZPGLDYaEfAQTICHcBFKJUWeSdXRM,TEDCCEGBHAFFFBAB..JBFEUFGH..SADHRFBH.MIEAhAAANIDHZEDBLDGHhABA.aCACAAEAQCBAhAAABGAFWFBB.dBEGgABAOAHFDFFB..hABAfDED.hACAKGHH..,2,-17,-14,3
RKXYGMTeaDZcSCJdINLQHgFVBbAEPUWfO,EFBDUBEG.OEFGKEEFGCAH..eABBaHGCDCIBSGAGhAAA.CCAH.IBAEhAAALFHBHAEEFEEHBHGFhACAADGFfFGEXDBEMEADTBGDJHCE.NIAH..hABA......hACA..gEAG,2,-23,-9,14
VHPQBLXcCRKWEGDAbMeTZSFYIJNdfOgaU,MEGDTFGBZFCC.FAGBJGAA..dFAE..OBAEaACD.UBFBHAAHhAAABHEFLDECCEEEKDAF.hAAAEAEFDBIBAIFE..SEHHhACA.NIAF.fEDE..hABA......hACA...,1,-11,-47,36
ePAOTQdbLaJUgIHDNcCXZSKMfBRVEFGWY,TCGCdGGCLBDG.aFDAUFEC.IECHHEAHDACD.CDGEZDDChAAAMCCCBBAGRFAF.EAHFGAEFhAAA.eBACAICCODHDhABAJDDANICB.SDAEKGGCfDACFAEG.hADA......hAHA...,1,-2,-13,11
GDWHYKPFNaJVEgfCBXZeTcAMSIRLbOdQU,SEACLACHOCEAdGCFUEFCDGBCHEGHKCDH.FAGC..aBFAEAADhABA..CADGBCBDeEAGTGEGhAEAACAH.IEEFhAFAbFAD....WDFENIAF...JHFGhAAA.....fABEhACA,2,-32,-21,11
BFXVWZERMeOGLHKUbcIQSCPNDadYfTAJg,BGCFFHCE..XFCGVABCZFEEREFH..MBHDOBEF..GACDhAAAKEABUAGH..IDCChABASEEGNCAEDIGAhACAaBAH....fGAAAAAA..hADA..WHDAEFHF.eFHHhAEA..,2,-30,-27,3
KgEZPGfYTHMQNVeXLWAdODBaScJIUbCRF,OCDFaCBE..SDEEJAFH.UFCHCBCDKGAEZFFA.GADBhAAA..fAAHhAAA.TEGEMEAENICFhABAeDAGXBGELAHBAHFGBGAAcGGEIBBDhACARFDCFHCC.EDHB..hADA...,1,-15,-19,4
DceFPbQZLNCOGBVXgaARSJUETIKMYfWdH,SFCDJDAA.UBDATEFE.MACC..fDAChAAAHBCADBFEFGADQGGDhABALHEECEGGBBHA.hAAAXGDDAHCDIBADKABHYFABWFDFcCGHhABA..eEEB.hAGA...,1,-15,-33,18
SQZaCYdcNFDBEITWRHAJgfMULOPXGKeVb,JFCGMABCLBFC..OGFGGBAAVFBHSECCZBBGCDDC.hAAAdGGAFEFGDDDCBAHETACBhAAARAFF..ADIF.fHDBhABA.PCHH.eHAEaHFCNEEE.hACA..EDBF...hAEA...,1,-17,-22,5
aJBcGQKeYEdAWTfgSHbLRFZCMPUDVOIXN,TFABSFDG.HCDCRBAAFFFCCHBG..MAHBDHDAOCHH..hAAAIEHDXEDBJCAGhAAABHHBQGGDhABAKAFDEADBAIAAgEAB.bABE....hACA......hADA...,2,-30,-19,11
EAYRMdJSVOQTDbIGZWPXeLFHgBUCfcKaN,RGDAdCCD.JEBAOCEF.QDAHDGCDGDGAZFBG...XGGFhAAAFFABHGDAUACDfABAhAAAaAGB.AAIHMBDChABASAHH........hABA......hADA...,1,-24,-30,6
IfAJYgEVRaMGdOZSHFQBPXbKNDCcTLWUe,JAFBEFFDRBAEGECD.ZCABSHEG.FFDBQGGEhAAABEBA.bABEDEEE.TAGFhAAA.UBDAfHCHhABAAEAG.gCGCMFHBdGAH..OABGhAFA.....hACA...,2,-25,-17,8
baLSVeCTRAfcXMPIWJBYEGgdFKOHNQDUZ,XDFCMHFA..IAFEBEDHEBHDdFCGKDBFHDDA.DAAHUGAGhAAAaADB.SBAGhABA.CDDFAEIHcBEC.hACAPCAEJHFC.YAHHFGDFNBBBZAFF..LFFGhABA...hADA...,2,-20,-11,9
JGARdMPeBFbaLICVXEZTDYScgfHKNWOUQ,dHEHMEFEBABGFHBALFHBCCGA..EHBCZBCEDFAG..SFDEhAAA..gEGDhAAAHDAFNAEBOBAGhABAQADDABIBeDDCIEEH..TGFGhACAfCAA.KGAFhACA.WCCG.,2,-46,-2,44
VJYNaFWRfASXbGBZIHcCKPLUDeTQMdEgO,SBBFXDGCBEECHAGF.CFHD.KBEGUGDDDAAC...eDBHTGABhADAdACAEGGB.VDDGhAAANDBB.FAECRAGB..AIHCZEAChAEA..cGAHQFGE.MBBA.hABA....OFFHhAFA..,1,-11,-13,2
LEAbYeJNUGPBSFcQOMDfVRKHgWdTZaICX,eCDEJDCEGEGCBEFDFHFA..QACBDCBHRFBD.KBGDHAEGdAFBaAADhAAACHDHLACF.hADAAEDC.bFEFUEGE.SFAFhAAAMBIFgFCE....hAIA..WBAF..hABA...,2,-28,-7,21
gNbfLGQcVJFePaXCdBARWTEKSDYIHMUZO,RBEGTEDEKGAB..DEEDHACBZBAD.OGBE...NEAG.fDHAhAAAGCEFQGGFhAAA.cCAAJFFFeEAAhABAaGFHCABCAHDAECCG.IHHCMBFA.gAGEhACA...hAEA...,2,-28,-4,24
LbcCIUYQKZgHDXAPFBNJeMSRVfaWGTOdE,BFEBeDEBRCAGaGDDGCGG.dFBCLEAD.CDEDUDBGQACGhAAAKADHZDGBDIAE.ADFAPAEGhABAJBAA..MIFGhAAASFCA.fGFAWGFA..hAIAEBGCIHHD.hABA.gGBH.,2,-25,-8,17
SdOCJfcZRIPgWYHTVbBMQLGaeENFDAUXK,KCFDSHEGOCBF.CBEC...JFGDZCEG.RFGB.....IBABhAAAPFAG....hABAgABDHAEGbFAEBDDDhACALADCeHAGEAHBDEGCAFFFdEGFfDAEhADAYAAFMFIB..hAEAaGCD..,2,-29,-12,17
SQgBPdDabGZAKNOIXJVHFRWTcMYELUefC,KAGDOEDD..JDHFVADEFGFC...RBAF...TAAAMIACEDFDhAAALFAAUGGBCDCDQADEhAAABDHH.DDCCaCGGhABAZFDDAAGA...IHAE...XDEAhACA.HDAAhADA...,2,-25,-25,0
OGFcTUEHIbNXWQPaYdJgAVBMSZCReKLfD,VEEHBFEDZBED.CEHB.eBBELABHDHGEFFBA..UGAFHAED..hAAA.NIEB.XEBChAAA.QGGAhADAYEAFJDHDADDESDGCKCAAfHBFOAFA.hABA......hACA...,1,-21,-26,5
cHXKRfUFIVGPNEZAeJbDdBQWYTgSLaOCM,eBBHDCEGQEDH..WFBH..TEAHLDGDOADGhAAACGAFMAFBXABHhABAKEEH.REGFFHDGIHEEhAAAPBHDEBAHAEGD.dEDCBHBESDHHaDDA..hABAfAGH.hACA...,2,-30,-8,22
WQOcEFPMXCIHgBAdNDKeRUbLYJGaSVZTf,DCAHRBBALEGDGAAD..aGBASGCH.ZDAFfEHGhAAAOFEHEAAEFDDC.MGEChABACGAGHAEHBHHFAEDA.KAFFeCHBhACAUAGC...JHDEWHFAcEAB.XDFFhADA...hADA...,1,-9,-15,6
UEVaMNDRTCHJZXdIbfPQgOSBcFYALGKeW,GBFCKGBCeCCHEHCE.MEHFDAAFREEG..CEEHZABFdBFA....IBHChABAfECF.PEAHhAAAOFAH.BCBDhACAcADDFGEFAEID..WFHHaGHF....NAEF.hADA......hBBA...,1,-16,-32,16
JFCUNDQGgXZYIfAHWEMcVRTaKbdPSLBOe,HGBAEAFG.MEAARECDKBAGdCBHLCDCBACEJBGFFGGC..UGEEDDADGEAGhAAAZEDE..IAHDhAAAAABE..WAHHhADA.....TEECaGHDSGAFhABACHEB.NAFG....hAEA...,1,-18,-29,11
IMbBVXTfHOWNCZDKQJSRUYFAecLagEPGd,eFEELFHBEACGdFAGMBEHBEGB..TBGEHCEEOFBE.hAAACBBDDBIFJFADSDFBhABA.UDAHAEACaDCChAAAGFCDIHCGXABENEIE.KCAE..hACA......hAEA...,2,-20,-18,2
OEKQMFHRJaNAZdGIPXDfSBcWUTCeLYbVg,dEAAGGBF..PACAfDBC.BHGCUGGECEGB.LCFEhAAAVAAB.EEDFKBGBFHBGREDA.hAAAJCBAaADFZFEB.DEGESHAGhACA.WAFFeAFA....hABA......hAGA...,2,-18,-16,2
JYgMBLOUHCcKXTPQRWSbNIdGfEDAeVFZa,VEADaGCA....JEBEMADABFGGUEEEHBEBKBCE....PHAChAAAQCAD.hABASDFEIACGfAGEhAEAAABAFAHFZFCDYHFAODHDCCCA.XGEHhAFA..WEHHhAAA..,1,-18,-35,17
VaIZbDPFgGSOQCLEfeXcAHTdJUMRKWNBY,dCGFMFAHKDEDBBAH..aCDGZFBE.DABGFFFBGCBD..OFAEhAAALDHHECBB.eHCEhAAAAAEEHABEJEEA..RADC.NIBF.hABA..IHHF..PDHBSEAEhAEAfAFH.hAGA...,2,-26,-21,5
VAgWXGNFHTDcaLdSBeKUfEZYCbOJIPQMR,XACDGCEHHDAFDCGA.aFGHLAADdADGBFEFKDDGEABFZEAC.CHDC.OHAGhAAA..JGFAPAEChABAMFFE.AIFGNEIAFGAG.hAHASBEB..eHCA.fCCEhAIA...hACA...,2,-35,5,40
RJcdHYDGOIMVLbgSUTfWQKZAaENXFePCB,aFGGXCDC.FBHHeHBG.BDDCRFCHdHFFHAAFDCBD.OCDA.hAAAIDHGLFBDSEBGhAAAUEFEfAEFhABAKEEEAAHBEHGACACE.cGDA..MEIB.hACA......hADA...,2,-25,-20,5
fcgQBPGMHVLSXeKFENIdbZJDYUOTaRCAW,...fFDCQECGBGGBMEGHLBADSFBFeCGBKAGBhAAANECF.dDHEZAFCDIGAOBCChAAATABHCGAD.AFAHgCDGhABA.PADA.HGCGFGFH..hAIA......hBAA...,1,-13,-20,7
LBcOfaeAHdTJXZNWSVPDQGYICEMKFgRUb,dFAHXFBCZCBC..SABCDGGCGBEGCEGE.MCIF..KGFEFBDBhAAARAEGLCEHBABBfHCHhADAaDGA.AEABTAGDhAEANAAC..PHAAIHHD.EGFD.hAEA......hAGA...,2,-31,-16,15
BWSXMICYegbaNHAZDPVcdQERUOTfLFJKG,DFAEVEBEdCEG.RGBA.UBCC..OBCBLEGDKCGF.BHAF.SBGChAAAMHFG.CHCE.hABAeAAC.aAGENEIGAADCZEFEhAAA....PFED.ECADfAEHhAEA....hAHA...,2,-35,-26,9
GLdbSRAIZTFXHNUYaWCDOVMgeBPfcQJEK,ZABGFCGAHCAAUECB.aGBBDGFH...MDDCBAGH...fFDChAAAQAGHJGFAKDGGdAEGhABASGHHAIFA.hACAXFAHNEEHCBBE...OCAB.gFFBhAAA..hABA...,2,-37,-24,13
dHAgUSFEVLCbZMPTYcBRfIOQNJKaWGXDe,SCAHFHBGLGEACFCF.ZBEA..MADBTDBDBABE.RAFCOEFDhAAAQBAB.NFDF.aFEBhAEA...XCDDhAFADAIHdDGHAIHGEFHD..bFACcGACJAEAKDDE..hAAA..WHEA.eCHBhAGA..,1,-12,-15,3
FZdVDENTGcPHKabQRLXSIUBWfgMYOJAeC,FFBEdHEBDDACECDH..GEGAHBEHKABB.QEGDXAACSAGEhABABAGF.fEEFhACAMEBCJFAEAHCCCADBZGCEhAFA.TBFFaDGG........hBDA......hBFA...,1,-17,-35,18
ZPJNbgQAIdGHeTVRYaKSXfWUDBMEOLcFC,dFDCHFAAeDCCRDAEKCDG..XGGAUEEEMCHDEBBB..LBGDhAAAFBBFZADA.JACG...NICD.hABAbGFAAFBA...IAHGhAAATGACaFEE...fCAEhACADIEG.BEEE.CFHC..hABA...,1,-1,-23,22
LOJATSXDWbGaVEPMIFBeURZgHdfNCQcYK,SDEAXAFADABBGABH..EGGDMGCEFFDHBDCHeEHBUAGChAAAZADFHEEHdGGENFCFCFAFQGAEhAAAKCCF.OCHDhACAAAEAbGBG..aHDE.PCAB...hAFA......hAGA...,1,3,-20,23
bgWfXcaTDSIOEFHNZJABeMdGLYCPUKRVQ,BACCdCGALAEGCGAG.KBCDVADA..QGAG..hAAAgEDAfGGBhABA.aECHSHDChAAAEDDBNICB.AGGHMEIB.YCGBPCAD.RBAGWDDChABA..XEGAhACADIAC,2,-46,-26,20
gATDIEVXUaFKLfOGHNCBPRYeWQMZJbcSd,TGABDFGCEDEG..UFBCFBDEKCAA..OAAHHCFDCAAABBGG.RBBH.hABAeFED.QGGAhAAAMAFAZFFA.JAFC.cACBhACAdHEHAAEH...XDDCfDDG.hAIA......hCAA...,1,-15,-30,15
EUcCdPJXOeTfgbSDQHZFIYKLBNWAVRMaG,MICEEAEEUDDEdGHC....JEEAeBHH.TGAB..bABEDCBDhAAAQAFHFFGG.hABAKDCHBBBEAHAF.RGEGaCEAhACACFACOGDESDADICAD....hAAA.NBIG.WDCD..hADA...,2,-27,-25,2
IXZdGUWMQFOJTEBcCKaAfDRNYPeLSbHVg,REDB..NDCH.eBCCLGBAHDGH..VDAAICABdAGA..UGBBhAAAMFAGFGHDOGFGEABHCGFA.hABAAABBDEBG...SAGFhAAA.XDGH...hADAWHCA....hACA...,1,-9,-43,34
MLAgXFRedScNPaWBEfJObKQIVCUTZYDHG,XDEDeCAHdECG..SEEG..PDAHBGGFfADDhAAAbBBAKBGD.IGAAhABACGEETFBH.DGGGMDCAhACAAAAFFHACNIAF..WHCEJHFEOACG..hABA..VBFA..hAFA...,1,-16,-28,12
JMSDFRGZdTNfKOPgCIEHBAbYXWVaLQUec,XEGBaFFALFDBUFEA..eCBA.JADGSGBD.hAAADCDHGCEDTAGDKBAAhABAOCAFCGBHEDADAGIDWAAGhABAQAGA.cGGHMFAHFAEF.dCGDhACA.NCCA.....hADA...,2,-21,-9,12
NTdDSGUFYfZMagXKQOIcPVLbRAEHJBeWC,EDEGBDGF.CEGA.dFGCDDDESCCB.GBEHUAFDFDADZBABMIDEhAAA..XGAGhAAAKEBHIHAF.PACGhABAbFFCABBD..JABC...eECA..hAEAWEHBNICF.fAGBhAIAaCCB,1,-25,-45,20
CRKEGDVabNQFZcXYeJPSBMATIHUdWfLOg,TFABUCBFdHFF.LDFACAEE..KDFCDAGAaHCC..QFBHhAAAZBBHXEGHJFFGBAEAhABAAHIFHDDF.OADHhAAAEACH....VBFANBIGFCAB...cAFDhABA.....hACA...,1,-9,-29,20
LITOfRHcMgAaYFSXCdBWeDQUENKbJPZVG,aCBDFFEDCDAFBGDC..DEFGQBDC.UGGHEBEFKCHB..hAAAJCHHVEBE..IAAEhACAOACFRGAEMFDEhADAAHGD.XEACdAGH.NIBH......hABA......hACA...,1,-27,-39,12
FUfMOYKQVDBXGAWPRaNcTgbLCeJHIEZSd,RFGDaBFH..TEAGLADB.eAADHABBEGBFSFDBFHDE.hABAMAEAKFFADCCDBCEGAFAC.hACAWFFDPAGD..hAFAgCGDCHHCZDFE.dHBD...fAAAhAAA.OAHFhADA..,1,-4,-21,17
KZRTYgbPMJBOWCcIUeVEAQXDdSfFGHaLN,XADCSFBCFFFCGCBH.HFGDLDFEKHDGRAEA.TBAAhAAAbAAC.MHECBFEH.CHAAUDGDhABAVECBEGBDDEAFaGCBhACANEAA....ZBEG.......hADA......hAEA...,2,-6,-5,1
DOVBXAGQReSPbIHgTLcfJWEYdMUaCNFZK,GBAGREBCeABB.SCFD..PDHBbCGBHECCLBDGhAAAfGBBEFFBdGAAUGGAhAAACHHAFCAFKHAGDAFEBCCEXGDChACAAIDGIAFG.gACEJDDC.hADAMEAHaAHD....hABA...,2,-4,-3,1
faTDEXgAWBNGJYbFUScLPOZIeCRHdKMVQ,BDDHGDAAJBFAFEHD.UEEGLBACZACA..CCGG.dDFG.KEAHMAIFhAAA..VFGHQCCChABA.aHCEDAAE.hADAEGEFAAEE...NCCG....SGADhADA...cFCDhAEAIAGF.,2,-36,-24,12
WGHUdLEVSZCRFbDKTcgXQfJMAIeaPBYON,aHBCBFEB.OAAFGFBFUEAELCAC.SABARDFGFGGGKCDD.hAAATGFB.XBEDhAAAJADEAHCA.eEAF.hACANCHAdECFEHAECFDG.DIDG.......hABA..cAFD.hACA...,1,-9,-38,29
DMEXFHaYCGJbdVAPSKgTLUZINWcBROfeQ,SBBGTDFA.ZDBB..NCBF.BEDBOGAEeEHB.QGDEhAAAMFFBFDBGHAGFCAGHJCAFdDFChABAADADKABC.UGGHICHChACA..WFDHfHGDDFBC.aGAHhADA......hAEA...,2,-22,-17,5
VBecHLPbNDIQdZXCMSfYTJaKWARgFOGUE,RBDHFEDAUABEBHHHHGFCLBHH..bFDCDGFC.dDAHZCGF.CEAG.SHDAhAAA..hABAYDBHTBFFKBCEhACAAHADOHBCEFAG..eHACcDED.IAGFhAAA....hAEA...,1,-23,-27,4
XVUCKIcDRBeFSAHOGaMPYdEbNWQLTgfJZ,GECBMDAHdDDHEBDG.....NABCLHEETCGDJFHBZAGDUABBhAAAKGCDDEADBAHB.eFCBhACASCDG.AFIDaACBhAAAPEFD.bFAD..WBHH.fGAAhAEA.CBFB.IBEEhAEA,2,-27,-21,6
RAfOHbWCXYVeSgFMETdKNJZGPBcaQLDUI,HBADCEGE.VEBBSFDDFFFD.EEFDKDEEZAGBBEHE..QBAChAAAUAEGACDD.OCDAhABA.bEADWAACeDDBhACAMIDGdHGBJACG..PAHF.aHACDIBEhAGA....IHHFhAHA.,2,-33,2,35
gKQLdcSeWGEFRXfYJMATNBPCZbIOUHDaV,BGAECFGAZBAD.OBADDIEE...aDDHKHBEdFHG..SAFChAAAeGCCECDG.FCCBRBFG..XEAEhAAAJEDA..MDFGhABAAHAH..NEEH..IAEE....hABA......hACA...,1,-27,-53,26
DANYSZaTLQGWMUReJBcfVFKdgXCHIObPE,SEBDTCCD.GDDEUBGGeGECBAFB..VABBdABGXEAAhAAACCHCHCFB.OHAChADAbFGD.DIFCAAID.ZBEHLHAEhAAA.MDAB.......hAEA......hAFA...,1,-5,-23,18
aeFWQTcbGEHPfJgLRDAXOYCUNMIVSdZBK,XFEBCGBGUGDB...MADASCFFBBDBKBFDFAFE..TDGDhAAAGABGHCAH.PGBAhABAfEFH.hACALEBGRCCHAHAHNIDFIGGCdHGDZADBaBAH.eAHHhAAAQAGA.hABA.cEGE.,1,1,-6,7
CASYdLVEgIGRabBfWUJXcFDMHTNZePOKQ,SGEEdGEDEAFAGDGARCAEBHAAUDBB..JAGDFABG.DEFBHECE.hAAAZACAeFCBKHDCCGACABHGLCCEhAEA..IAAGhADAfFAEWEEEMIEG..NCIE..hAFA......hAIA...,2,-26,-16,10
IDEfcXQgZSdFWaOKUVBMGJHTNbeRCAPLY,LFABDAIHEEAE.XFGBQDEG.ZCGHFBDA.ODAGKGBGBGDEhAAAMDFHHACE.NIDF.hABAeAGHAAGF.IEDEhAAAfCABgABD.SGGDhADAWGFCaHAC.....hACA...,1,-14,-25,11
gUcEaIJRBeQFWLCdbDPVSMZKNXHAfOGYT,OGEGGDGG..TDBFUADF..aDHFIAFBBBBC..QAGGhAAALEFDbACFDFDDSDDAhABAMAIFKAAHNHAFAGCChAAA..fGBE.cCAEEBGH.hAHAJHFG.....hBCAFEFECEDH..,2,-18,-13,5
ODEWJUICNagGbLAKFHYfeXcMTBQdZRVSP,FEDDHCEEeFBHXGBE.MCCHBBCFdAEDZAFBREFD.SEHBhAAADCGEEFAF.UADGCHEF.aGFHbBAFhAAALABF.KHGChAIA..fDDG.....hBAA......hBFA...,2,-28,-7,21
HIQSDZfWYOceTMGNCEKadJULBAbRVgXFP,RCDGXEBEHFCCQAGAZEFD..fBGHOBAHeDHBMFAHhAAACHFCKEAHdBAFLBEDhABAAAAA.bGBEFFFASADChACADBCF.YHFGcGAH...NCIG.hAGA......hAHA...,2,-14,-11,3
OdNKJcPUfeFAYDXMEICTgBGQWbVaLRZHS,XGEGMIDA..EFBDCBDABDHDGFDH.QABF.VCFChAAALBBHZAFESDCHhACANAEBJFBHUDEAeFADhAEAAGGCDCAHIHHC.WCDBaFCFOHFEhAAAKEHH......hABA...,2,-37,10,47
GIeQNJWEFSXAUgOVBYLMTaZCHDcKPfRbd,OECBBAEAMHFCZBBADADCKCBB...RAFFGGEDQCFA.JEAHFDEDhAAA.AACD.UEDH..hAAAVDGBLHAG.hABACCHA....cABAfHAB..hAHA.dDBB..NIEFSEHHhADA,2,-30,-29,1
OACgceDFdLTHfMERJGYVSZBUQIPNbWaXK,CDGGeCBDDBFG.FGBCLHFAHABE..MIFAJBDD.GDDD.VAFBhAAASFCGBGFBICDFhABA..NAAFaBBGhAFAKEADAIACdFGBEHDAZBFG.QGAD..hAGAWAHH....hADA.XEGE.,2,-28,5,33
UbEATHGPJNLYWcdCXaROIZgQBMVeSDFfK,GDDGJBBBLCGH....YABHdDEACADBRGEA.OBEFZECDBAGFhAAAeDAD.DIBCFFAHfCHAhAAA.KFGBhADA.bGAGAHIF..........hAEA......hAFA...,1,-21,-45,24
aEHdVPCSMIRALGgFcNbWeOUZKTXJYDBQf,LCHDFEFB..NEAE.bDFD..OBEEUBBHKBFE..XDBEhAAAJFAHDFCB.BABBaACA.hAAAdADB.CHHH.MFDDAHFD.hAGAGCDE.WBADeFDF.YBHBhAHA.EGGF....hAIA...,1,-17,-36,19
GcDEegbVFfNOZBJMPSYARLWadKQTCIXHU,RAAHaFDHQDDF..CGHFHCBAUGBADGFCEACCeCFA.VEEChAAAFBHHOADDBBGF.MAFChAAASBAFLCFBhACAWEBDdFHAKHEC...XDBHgAEFhABA.NIDD....hADA...,2,-15,-8,7
fHNSVYeIZTgUFKEdABWQMcDCbJGLRXaPO,QGAHDDAHCDHE.JFFFGEBB.LAACaFCA.OGEAhAEANBAF..SCDHhAAAVBDGeHBEICCAhABA.ZCGHgBBDFDAHdAGHAIECBHHEMEEGcAGFhAFA....hAIA...,1,-14,-26,12
MgFISXATNLHOaWUDdQZBRbJVeGCcfEKYP,TAEEHCAFOHDE.UEFFdEACBFHERADH.JCBCVAGHGGEDCABH.hAAAECGFKFCA..PECChAAAFGAC..SGGGhABAABHCaCHDDHAE..........hADA......hAFA...,2,-23,-19,4
TIUPWcEgdXYJFeQKNbLHRMDaCGSAZfVOB,VABABEAGUGGD....PECF.EAFCgCFGhAAA.dHCBXCDEhAAAJDDBQACFNCHCHGFADBABhABACHAFADAG.fFAA.OEEHTAGCIHBBhAEAcBBHeFEChABA...,1,-5,-38,33
NeDHGIgBcMCFVfPdALTOaQEJZbKSUXYWR,OGBAQAEEZBCHKBEFSDEG.UABBXAGAREGB.DFAEhAAAHEAAGEFCIHBGhAAABCAGCBBDFHDG.PFDChACALFHBaAGEECGC..YHAA.hAEANABBeDFE...hAHA...,2,-15,-4,11
DcGgdNBZIHLWFRSKMQOePEaUXYAbVJfCT,VDCCJEED..CAHA.DBFBGCAB..dEGCBBCEHGDAFHAASADHhAAA.QBAChABAOAGHEDHFaBGAUGGGhAAAAAHCfCGB.TFAGcEBH.NABF.hAHAIACB.WHFAhAFA..,1,-7,-41,34
gXLRKBZWETYSCVIOdQeNHPbJAUFGMcfDa,UCDEMDBBDCAD..aGFGLEEEBAHBZCAFEGFF....TABFhAAACHAEVBBC..OBGBhABAQAGCeFDF.NABFHFCHhAAAJFAFAFIB...FHGEfHFH.hAIA......hBAA...,2,-28,-16,12
eIAbUMNaCKDXBLgOTcQdYPWRZHFGVEJSf,UAEAaGAG.DFDFLDFB.OBDATDEEQCCFdFHE.hAAA..PAAHZDADFCHDhABAEHGASGFDhACAeEEFAFHBMAIDKBCBBHAD..YHBA.hADAWAEE....hABA...,2,-32,-19,13
XLQJEWaBDeYfRGHUOFCMSAPNcgKIbVZdT,...PDCHNBHE.KFFFVFBE..dAEFLBEBEABHBDGADAGHeHAAhAAARBCDUGFE.CEAE.AGIBIBHGhABA.ZBDAhADATAAF..XDDB..WEHHhAAAfHFFOFAHMACGhAHA.,2,-30,-21,9
QfMZcNYbFOaeIUEBVdPAKWRXGJTSLHgDC,KHCGRBEFGGEF..JABCSACBLBFCDDDEQEEFZEAC.hAAA..NAHC.FEFEeGBAhAAAEHGEBHAD.dEECAGBAXBAGhABA..gCGEfEADhAEAMBBF....hAEA...,2,-38,-9,29
GRfSDXICUgbBTZNFaYeOVQHLKJMcdPEWA,GBCERCCHDHBG.CGEEUCACBEAFZGFG..aEEAeCFD..QAFDhAAALADCKAADMIAGdCGHhABAEABCAAIH...SGGGhABA.IEHGbFBEFCAE.OFAEhAEA......hAFA...,1,-22,-29,7
KBRcLbJHYAVGIXCWUaFdQMDfSegTEZPON,GCGACBCCUBEF.aEBA.dBBFDFED..eAGFEAHB.OFDEBGGDLAABhACAHFBFABFH..IFAHhAAAFDFH.MADESGAHhADAZGFG.KHCGbCAGJEAA.....hABA..YCHFhAEA...,1,7,-44,51
ALeWNISTDBPMbCYZJadXFcHQfREKgVOGU,eDHD..IDBBDBCBBEFAMAFHCHCCZBDAaAHF..dAGHFEECHEBEhAAAREGFEEABKADC..OAAChAAAACAB.LGAGhACASCAHTGED.bCCFXGGGfCGChADA......hAEA...,2,-32,-12,20
JPTfIGcXLKNeEQgMODaSbFZUYCWVRAHBd,BEEEdFCBJDCC..TACFGACDLHFE.KAFDNDAG..eFGDhAAAEEACQCGAhAAA.OHBGDCHFaABHSCAGhABAFGED.YFDACHBEWDHHABIDfAGBhACA...hACA...,1,-16,-37,21
ZeCEXQOYdPWgSRNDaVcHbIfFATMKUBLGJ,TDBCMGFGBHFC.GCBEZEFGCBFD..QGAGdAAA..PHBEhACASAACDADGaEFGhAGAHBBG.fFDGhADAAGDGKBFBJBDF.eAHFEBHH.XGGF..hAEA.....WEEChAFA..,1,-3,-31,28
cDHLSJfWFAYZQVegOPCBMEIKXRabTdNGU,ZBCHQDAEeCFHOHAGBBCBEAGD.KFGAaGGC..dEDFUAAEDGDELADBhAAASAEFJHEChABAFFBCABBD...gAGGhADACCGDMIAG.IEHEXFAC..bFDHhAHA......hAIA...,2,-23,-20,3
BEfDJFKZQNCOAHeGUMcdYgPTXSIaVWbRL,GEEFMACAdBFF..PAGFSGEA..IHGAaHAGVCBEhAAARBDBBAAD.DDBAJCFBhABAFGDHKHGGQFAGhABACDHFAAGA.eEAE.cACBgECA.hACAWBBE...EFGGhAIA.NIBF..,1,-8,-28,20
bGJdeZfaXgMNCSITRQLYUcEDWVHKBFAOP,OAGBGCECdCCBZDCF.aGGDMBEF..SGBGRFEHLBAEUAGHhAAAEDHB.DDDHHEABBFBBAHIF.hAAAJBAFeCAF.fEFBhABANEAG.IHGBQGDC..hABAWHAG....hACA...,1,-13,-19,6
GIYMBcbWJRVTKQCUSdFZeaXODPgANHLEf,LHBAEECHGADAMFFGBCHC....bAFAREFFTGAD.CGDEdAAGhACAZBBEeDDH.aEADhAAADAGEABAHHCFEfDBAhADAIHGB..WFHH.KHEG..SFCDhABA..hACA...,2,-19,-16,3
aXcMVgSLFfBeJAIQZGdWREDbTYNHPUOCK,ZFABGCCCdGGDEDAHDEFC....TFGHHFCEOBCFKHBC.XCEFhAAAVAACLFAFhAAABAGDAIEG.ICFBREFE.hABANIEH.CAHEMACAFAEBfBGD...hBAA......hBBA...,2,-16,-12,4
XZWgePOBMGDHQdEKRVfaFLINJSAUcTYbC,UCAETCFCCADE..ZAAAeACE.BBAFGDGCDFIBHFAGdHABRDEH.VFEChAAAFFBA..LAFGhABA..IDBBhABASGGDABHAcBCA.YHAA.XDDChAFA...hACAWHEA.,1,-21,-25,4
eUgdKcDJRTWCSQZbfBMYPXLGOAENIaFVH,EBCDaFCGHAGFUFDF.dFAEKBEDDDCA..RAFB.CGHCZAAGBHHE...MEEAhAAAXCAHLEAFAIAEFGEGhAAAeDBH..JEECSBABhABA.fEHC..hACA......hADA...,2,-30,-28,2
MLfFdgQZYKJCNGEeVXAOBHRIcaPSbWUTD,OACDHCCCREAE..aFGASABF.UAGBDCHDfGAAhAAAFDHDdGGHZEBG.JFEBGBEEhAAAEACHeBAHAHCABHAC.IGEGhAEAcAGA.........hABA......hACA...,1,-20,-22,2
DebRZCKITEUJGdAQOPXBaFcgSHYfVNWML,OAFBBHHAFGEB..SEDDHCBE..fBACVAAAMDIDhAAADFDDRGEC.CGHC..KAFFEBDHhADAGEEBQAGChAEA.XEFCgGADNIAH.LAAChAEA.eDEC...hAIA...,2,-16,-13,3
UXEbKIaZBFVdPYNgcDeCSMLAWOJTGfRHQ,ODBFJFBCGCEARAGBHFGH..QCADEAECKEDEZGCGBAFC.dHCDhAAA..PBACNAIADDHB.hABACEADMABEABBE..fAGAhACAXDGA.IGHF.aACD.hAAA..FGFD...hAIA...,2,-17,-15,2
MdFfBHLJAcKQVTOYgWRSNDEXGZPUbIeaC,KGCHVCBCOCFE......YGBAREAGDFECEFHF.ZADAUCFBhAAA.eADEaGEGdAAHhABABFGCLHFGAHGG.hABATCCDWBBENDIGXGAH....hAEA......hAFA...,1,-20,-32,12
SQcDAfCXJTaLUVeWKZPBFOEHGNgbdRIMY,XBFHTECC.LFHBeCCEKBFBZEBGBHHBEBBD.HFAHGGAH.hAAA.gGFFhABAbADBIFFGMBBE.YAHDhACAcCACDAIDCEHBaEED.......hAAA..WDACFHEE..hADA...,1,3,-17,20
NTVKBafPLgSbCRYIQZUOMGdJDXWceEHFA,VAFFBCECaBAC.LBDESEFC.CHGA.RDEE..QEAChAAAOBBBMDCEdGDGDAIBXECHhAAAeFFAEHAAHFABAIGEKGHHhABAPABG..YDACIFGB..hAFA......hAHA...,2,-24,-9,15
gNJdVWIXSKfHFCULAGYebZTRDacEPOBMQ,GBECeAEEZFDEDEAEEEDCBABE..MABHQGFD.JGACdCDDhAAA.IEBHKECAFDGD.hAAACHHBAIBA..TBCAhADAaCGCOACC.NCAA.XAFBSHFGfAHChAEA...hACA...,1,-25,-26,1
XdJCLgQRPNEYfSBTbAIDUeMGHFZWKaVOc,DGFCUAECeBAAGBCCFBEE.KFDG..OCDBdFHACEBE.LHDA.hAAA.RGBGEEEESCGAhAAABCAAAGGDHBGFZEABWAEEhABAaABG.....cEGF...XEEGhACA...hAHA...,1,-19,-24,5
JgNBPfAZCKHMcRebUSDTOYXFGWLVadEQI,CABFHCBBRFBF.eDFGUDBDSAAA.DHCATADDOADEFFFDLFHBhAAA.dFEFEBGGhAAAIHAAJEHHBDHEfEAEhABAAGABZFDD.cAGE...YHDGhADA..WAFEhADA..,2,-34,-17,17
NcSdEROaeZXBKWDIFCbMLgUQGAPHJfYTV,HBFAJFFA.TDBD..NBBB.SDHB.dADGOAGDhAAAZFAEBEEDDCIHFFADCFGCMABFhAAAUGDEAGHE...PCCAhABAfHBD.cGEFEDEAeDAE..hACAWAFEIHHC.hACA...,1,-23,-31,8
VXDWNPMLeCYREFJQOTUIbZGcBfAgKdHSa,KDAHSFGF..aBGGDBHD..PEFGLCAB.eCDAhAAACGDHEACEQGBAhABA.ODFCIGGGhAAAbABE.cDCAADABdGAC.XGAFWCCDMFIBYCFGhABAJEEH.ZBBCBHGHhACA...,2,-27,-11,16
JaFgKePDHABIELYbGOcUXCWQRdfVMZNST,EDEALCDBGDCAOFBCUAFD...CABFQGGBRABHdDACMICGZEGBhAAASGAG.JHCGhAAAaFFBFBFCKGAG.DAIBADAFICBHhADA...YAFC.hABA......hADA...,1,-17,-21,4
TSLRWXdOYUBCZecbJKQPNHgAEVaGIDfFM,EHCCGEDHDBAD.MDEGLEEGRGBE..dGHAOFBHBBCGCDBDZBEAeFAFhAAAJBBB...KADGQGEChAAA.PAFGhABANBACAIEG..aEGAfDCA.SGGHhACA..WCFEhABA..,2,-30,-24,6
HECUKYJgZbaPQWeRcVSLdABMTDFXINGOf,BAGFDDEDFAAH..XEFGGAGGHFFA.EGAAUBDA.KDAEJCCDhABAZEAC.aCGAQGDHhACA.eADGcGEEhAAA.LEHBAAIDIHHHfHBBhABACDFA...gABFhAEA.,2,-38,-11,27
DOaPHfKgIMSJTQLWBZEFdVCAGcRUeNbYX,GDDFUGEEeBCA..bEBGDDHF..OHBEaGBFHDDEKADFMAAHhABASBBC.QAGAhAAAWFGBBAHAFCAHCBBCADDAhACA..NABB...PGDGIGHBJAFF..hAGA......hBAA...,1,-16,-21,5
CBQaDOMYXZfVKbUHJSGIgWcNFPTLEARed,RBCFCGCEBDACQCFB.DCIBOFEB.MDFGXFEC.ZCAHhAAAKAGEUGBCJACH.SHGGhABA.IAGEhACAcGGH..NCEH.FFHDLEBFAHFHaFAH.fDEEhAAA..hABA...,1,-9,-54,45
eIBSJKNCRfgWOGYDPAdEZbTaVLFQcXUMH,dHDDZAEDaGBBLADG.FCDFQCBHUBAGHEAHBACB.SHCChAAAKFEDRCGH.gDGEhABA.GECBhAEADGHBAFFEEFCFVFGF.MIDAIAHDCAHF..hAAA......hABA...,2,-27,-2,25
XLWABEDJbdeMVSUgTRfIcGYPZNaKQOHFC,BFEFDGCAdHCBMHFEUBDFRCDC......IEHCGAAGZBGBKBAHHEAHhAAAXFAFLADGhABAAFHH.ECGGJEDCeDCBhACA.SHAA.fAHEhAEAcGGENADD......hAFA.aFGC.,1,-14,-33,19
eWHBTGRgMSafQXYZFDPNbILUJCcOEVdKA,eEHBHEDCBDAAGDCFMCAGaBBC...QGGFZDAFDBHD.NICD.IFFAhAAALADAJACECCHDEEGGhAAAdFCAAGAH..RCDAfGCDhABA...XFAF.hABAFAHFPAFD..hACA...,2,-25,5,30
TbXLFgRaBJVAIPECeYSdcDKGZMUNWHfOQ,EEDDCDEE..SCBHDEHBGEAAUADBHCDC.OBCAQFGAhAAATGFHLBGD.hAAARECB.aAFABEEDADADICHAhABAYHCGKCAENBAA.fGCAFCHF..hACA..gGAFhABA..,2,-19,-9,10
DAbKHPIOTWcXCJNgVaMRFQdYEUfeLSBZG,KBAHHGEEODFATDBH...XACBCFGD.JGAGVEBH.MEFHhAAAFAGDdAAC.UDFChAFAfAGASDDHhAGABHCADICCAHHA..IBECNBICaHGE...YFAFhABA.EDCG.hAIA...,2,-36,-7,29
YdZBSbCMVgPcJIRUQFWXfaHADGONeKTLE,DEFFOEFEeCDCKBGCLDAB..dHGBSAADCCHAMFBH.VEGHhABA..PBCEhAAAJAEA.UGDDFGDHfDCEhACAABBFGDAB.ECGFBDFH.....hADA......hAHA...,1,-25,-30,5
eLKVHJSabdCIMEfXTNDFZBYWPOcAQUGgR,QAFCGEAAREGBeCAALFBFHAFDaDEDCHHCMDAC..EAAFTDEEhAAADICABECD..YHDChABAOHDAABCCKEGASAHHhAAAICHHNCAHWAEF....cEDHhACA....hADA...,2,-25,-4,21
WUgSREcAYBIHXNMQPdZaCJebOVTLFfDKG,BAGDXCCCQGFFZBAD.CDFG.JDGFeBCE..OFCALDCHhAAAFBHDDGGFGDAEUGAEhAAASGDH.hABAECHBAADGIAFGMCAEaADA.TGCHWEEA..hACA......hAHA...,1,-8,-31,23
IQJAHPVEZfFOXURDaLbSWeGMYdCTNcBgK,HFFCVCFE.EBCFZFFHOAAB..UGBEDEEALBHBSACEeEAFhABAGBCEMFDEdAGFNECGBHDDhACAKFHHQAAHhAAA.ACEG.fAEBFFEH.aDDG..hADAWFAFCHAAcGDA.hAFA...,1,2,-15,17
FTMRXNeGSIBOWCVdUcJAYDEagbfZLHQKP,DGAEEFFH...aAHB..bAFHZCBBLFCDKHFCFFEG.RCAD..eBBGGACDhAAABBHFCDEG.dGHC.JFAHhAAAADGE...fEEAhABAQGCHPACGMABBSCADhACAIEHF...WBHH.hAHA...,2,-29,-8,21
fQWMXDCIFGPZeNaHVKdUYgAROJTbEBLcS,OGACTFBF.BABALABF..fBEEMDEDDIBGIHEBhAAAGDDCeBFE.aHGAhAAAKADFUDGGAIGAJGFCEDABSAFEhAEAXDBFCBAGZBFFNIAB.dDHE....hAIA......hBAA...,1,-8,-19,11
ELcGeIHBRCbAJYFfDaSUOgNTZWKQMVXPd,JABDFBGBDECH..aDFGOBAH..TFBDKDGG..MAFHVGFEhAAAdBCA.LFGBhAAAGADAeEFCBGAARFEDCHBDbAFAhABAABBD.....SDDDNEDE.QDABhADA..hAFAEEAF..,1,-15,-30,15
LfgTAWYQBPJVIGceOCXaDZNHSREUFbMdK,QBCEBADBJGDE.GGAH.eBFGOAFEaEAGZFFGHBBAEECCUDFAhAAAFEFA.MCFCLAABhACA.fAGDhADATDDCABAD.WHDAVFAECHHHDDGGNDIA.....hABA.SHGGhACA...,1,15,-26,41
TeLHSGCZcgNUMYPKFARBDXOdbEaQVIfJW,DDBDXCBCdDCA..aEECQGCA.VGFCfGCDhAAA.JBAEWFBC.eDCAhAAASGGECAFEZCGDNBAF.hABAMICEKHAG.FAGAAAHA.RCEGOEAH.EHFE.hACA..LCHHhABA.cADE.,2,-11,-5,6
GDEaCbKPdQWcFRZNSIXBTeAVUfOHgJMYL,VCBBOEGF.HDABMDFGLEDH.DFFHaHGECHBE.KABAdAGFQFADhAAAFBCGRCDG.SHBGhABABAEBAHIH.gFEDhADA.GAEBEAAB.PEHHcCGAhABA......hACA...,1,-6,-24,18
QaOKZTDGVNXARWFgUcJIBCLSYEPdfbeMH,FFGBUGBB..JEDHBAFHLBFHSEGF..EBAEdDDFeDHBhAAAHABA.aFHDOFAFhABAKDAHDFFDVBDD.AACA.gAGHhAAACAHD..YDBH.fHCDhAEAMEED..hAFA...,2,-29,-27,2
TDIYJFceWNSaRCPHBfGUVgEKQZdbXMALO,LFEDDBEH.JBFDeBCD.SFCHaBDDRGFC.HCFDBFADfEADhAAA.UGGHhABAEAHBKDBAdAHCMADGhACAAACAIDHFFFEDNIBD.CAAF........hBAA......hBBA...,2,-42,-12,30
MaNgFWKAYIGdOTVPHfJSQLBbUeCcEZDRX,GCEDTAAH.HACF.SEGABEHCeDCAEAHBDCGDREAG.MBFEaAADFGGChAAAKDAFAIGG..dGAAVFCAhAAAJFEFQAEFhACALACBCGADZGFG.NIAB........hAFA......hAIA...,1,4,-13,17
HgfQGKRDUVZdMWaOYXTcJbESIBAFNCPeL,FCCECECCLEFBHFDDQAGGGCCF.DFFCZACEdEBFaCAB..OAAChAAATFCC..JFHDSBGChAAAADHEeAEBKFAF.hABA............hACA......hADA...,1,-20,-31,11
AWOZKQYGagVXbPDTJNLISHcRCUedBfEMF,OEBHQFEAGAEEaAFA...VEDFXDEGDIFE..JAHFICCChAAAHCACRAAACGGEdBGDBFHBhAAAfHDD.hABAEEBHAGAD.KBAC.YDFC.PCABhABANIAD...cFBDhACA.UGGA.,2,-13,8,21
cVPbCZIMfgHaTKWASBFLDNOQRdGeUYXJE,FDDGLGCADEGB.QDFAdHDBGBABeCCHUEAE..XBABhAAAEDGG.VAFACABCZFGBIEAEhABA.MICChACAfAHCgGGFaAFGKFCCAFDGBADE..hAFA......hAIA...,2,-27,-8,19
DMTfQXPZKeEdJYAHWSBGcNgFUaLCRObIV,SAAFBADFGDCG....NDEEFHFALHFC.CBFCRBBHbEACDGAChAAA.MGFGQDGChACA.ZBBDKBHBEGCBdHADhABAABHCHBDG.WFFG......hADA......hAEA...,1,-15,-35,20
DOaQJZBcPdTNRIVMgAGYbWSUHfEeLFKCX,GADA..bBBGSBAAHFCGeFABKAGFCHCCDFIHaGEA..JFAEZCFBhAAABHHBdAEBRDBE.IACDhABAMDIFAEFB....hAHA.WHDAfHED.EDAG.FHAGOAHFhBAAPDGF...hBFA...,2,-19,-9,10
bJOSHIBUfeCDTcaMQNZXVYgGFKALdRPWE,LDFBRCGBEECF.OHFEHFECUAGH.CBDH.TBGD.MBBEhAAANDABZEAB..XGBChABAVAAA.GCCEAFAF.hAAAWCAD.JEHHBAEEDFEH.aEEG....hADA.YFHB.hACA...,2,-21,-10,11
TCFDSQbJNcKUGEdaXHLPfMeIYRBgAOWZV,OCEEZECDCCEB.DBCFQFEB..NEBC.UBAHdGEHHDCFLBGDhAAAMCIBeHFA.IEBBhABABHGAAAEGTAGBhAAASEADJBADKEEEaEHD..fHABhACA......hADA...,2,-26,-24,2
aWfNDHPZGETbUFXRgKYcSJBeLCdMAOVIQ,VEAGQFFA.aBGB..fHFBHDCHGBADEGCATEFAhAAAFDABXGAH.KGEDhAAAYBHHSEFChABAJCDEBHEGCAHBACFHICHADADGPBAG...hACA......hADA...,2,-14,-6,8
RGYXaDeEWOPBKIAHFfSUVLJMZTcQNdgbC,HBDFSCABVBAFLGDCMIDE.ZFADTGAHQCGC.hAAAdHFDbBFHCAFH.RADHXEGEhABADFAH.eEEDWAAChAEABGGBAFEE.FCCHfEHCcAGF...hACA.gFCDhADA...,1,-6,-11,5
LYKSBaFPdJXMDVWOIfbCZEUNgQAGRHecT,HGCCTDFELADE.SCFBFACAJHFGMDIDDCCFOFGDhAAA.IAHFfECFhAAACDDF.EHAA.UAGBhABANBBCAFFEeFBFKCBHBFFD.aFAB.XFCEhAFA......hAHA...,1,-16,-20,4
gDMNfeacPZEQBLURIWTVHYbdKCOAJFXGS,JDFGFAHBGBCD.DHGAMAEG.eFFBaAEAZDAHQDBD.hAAALBACRDGBTEEGVGCGhAAA...HBDFhABAdABFCGDBAIBCSBGCNIDH.cCABBDDD.hBAA..IHHEhACA...,1,-16,-17,1
ANfKLQTHeOMbdDYGUZCRgBPXcJFVIaSWE,KADBTEGFHBAG.eEDHOEBGdAGHGCGAZAEGCCDG.BFAG.XGFGhAAAFAABaFDD..SFADhACAAIGCLFBBMADAhAIADDDF.UCGBRBEH.PFFB.....hABA......hACA...,1,-9,-15,6
NZbdCDTWYEHfaOFBMcgULRKVeXGIQPAJS,SGCHZAGBCDDF.DADBTACG..EDEGaCACOAAB.BHAAhABAMEFGUFFDKFBGXFFDhAAAICGHAFCCJAFDdCBChACA.HAEAFEEHLFADeDDB....hABA..PEAHNIDF.hACAWEHB.,2,-24,-14,10
WLBQebdCgVcHJAFSYOXMGTaEZRPIKUNDf,SAGBXACBGDEGEBCF.ZBAFREABKGECUFAB..DFIFLEGHhAAAeAACdCFGVAEEHECEAIBEFDDBhABAMIAE..aGDDIDHEhAAA.fAECBBHACDHE...hAHA....cGFDhAEA..,2,-10,-8,2
OTPCKVbSEMABUaHZdDLfFWGRQXIgNeJYc,BFBEUAEGHCGFZEFCDHAAFGGHGABBREDD..QCAA..hAAAIBGAeHBGJABCOCCEhAAACFHH.KHGEbCDGMICGhABA.dEAC.fCAHWAHB.NGDD..hBAA......hBBA...,2,-28,-15,13
MZRVfNYITJBCKQUcOSXbgHWLadDPGFeEA,MCEDVFCC.....NDGE.TDAGBADHKGBFQBCH.OAAGhAEAXAGHHGFAaCAEhAAADBGHFFCCeHAE.AAFCZBGBhAHAfHDB.IFHACDDD.SBFFhABAWCFD..hACA...,2,-47,0,47
ASPeQaFRKUIOLfWNGZTMYHBdEXbVgDcJC,eEAFFBGGUBCBLACB....fEFGNCHAZECG.MIFChAAABBAE.EGFB.XGBChAAAVEAADDGG.JHACSDEChABA.QAEBKEHFIGEDhABAWEHH.....hACA...,1,-16,-39,23
NaTAgVfbWROIBGMDEPFHZULKXYeJCcdSQ,VBAD..fGFDRFFDBFDG.MBIHDGCF.EGBFFDDCUEBF.KCBAhAAAeEABCFHH.dAAFNEAA.AAIF.hADA....WHFAhABAIFHGGADFHAGBLEEA.XCEEhACAcCEA.aHCE..hADA...,2,-28,-11,17
NVXHQLeBIfRTUWOPYADcZaKJMbFECdgSG,ZBBCJFBE.FFEBdCAHGAFE..VAEHQFAABFFH.RDGHUGGBhAAAOHFAAEAG..DICCKAHFMACEhABA..EABASDDAhAHA..XGAC.LDHDhAAA.IDDAhABA.fGDA,1,-19,-31,12
YWQEMGaCebgFTRXVPUSdOfZADLcIBNHKJ,LFFABGFAKGBF.JHEEQDAHGADD..aEAHCCGD...eFDHhAAAFACARCCD..VCBFSEGAhAAAdCGF.OHCEhABAAAIDIABB.NEEB.YAHH.WBFDhAFAEHAC.....hADA...,1,-15,-34,19
IYRWQUZBfCTFGNLHbJaEOgMVcAXKPSDed,KHAGSEGCeCCFdGGARAFC..UDAHBABG.CDFG.FHGAGBEDHFEDaBCAhAAA..EHDCMDFGAAABDFIHhACA..IHCGhABA.QDDCTEDGLAECOGAG..hADA...cFBChAIAXBBG.,2,-21,-15,6
VIgDXAfcPFEbSaOdKQRMTCYWBZeHUNJGL,...PFAEEFADaFFHKFECRCFE....CDEGBHHCZABAeDDAHABAUEGAhAAA.JAEALECHhAAA.IDAADIFEXDAGhACAAEGFFAHDSEHHOHCGMAIH...hABA.WHAG...hADA...,1,-16,-25,9
OQWBEAZcaNDeVRGgSPHYJMfKbLCUdFTXI,ZAGDaBED.eBCERCGH.GDCD..PCAFHFAAMIEAKGDFLAAChAEACEHGFGGC...XFAGhAFAIAFHQFFDhAGAWABD.EHACACAFDBIDgDCG.SGHHhAHA.fBBBhAIA,2,-28,-2,26
IDXRPAFLNTSfOGdYEVZHWQecbJKagUBMC,LDEASDFBOHFGdBCH..EBHFVAAFHEDB.QFAEhAAAeEBEJFCH.KHGEUAFGMDIDhABACEHH.XAEFAFBH.hAAATCACfADC......hACA.YFFAWHAAaDDBhACABBHB.,2,-28,3,31
MEFLJPbSOICVRGNUdQfYXZWeaKBTDgcAH,EEABFAHBLFGB..JHECSDBDOECACEGGGBAFUADBdABAhAAAQAGF.hAEAXCGEZEEDaHDCKDDChAGADGCCACFAMCIH.IGBDNABF..fHADhAAA.WFFGhAHA.BHHEgECB,2,-18,-13,5
IBEVOYFXHWJbKeADfgTNLZQaCdMSRUGcP,DCDFTFGCZFFA..CEDH.dFCF.MDCCUCAGGAFA...IHDBhAAABAABVCFGFADEHCABhABA..JAFGKHAAAADC.hACAfAHGLFAB.aFFHSFCGhAFA.....PHFEhBAAEABA,2,-43,-13,30
TdNeCSJfMOWYVUaQEHBbPRFLKZGDIAgXc,XAEETADD.dBBFeCDA..CDGH.fEEGMACE.OHEGhAAAVEEB.QGBGhABAHCCCBHHGbDFAFAHFKDAEDBADhAAAAGAFgABFSGDDWFCFaHGEPAFGhBAA......hBIA...,2,-18,-2,16
AZEgBKGcUJDTbaNdOFfRSQHVPIYMLXeWC,ECCABHAHGGEDUGCCDAGC..aBAEdBAAOHAG.RAFF.HDACVEAEhAAAIBGF.LHFAhAAAWEDE.CEFAAFABKADGhABA....TACGNCIAfFDHSEHFhABA.PDDG.hACA...,1,-17,-25,8
BgQKFPDNTXEYRcUeJAfZMHVdWGISLOCba,MEADVCAC.GFDFLCFFCBFH.BHEDKCBDFADADGIB....TAGAhAAAEHDERBGH..UCCCAFBFZEGDhABAdAADSACGhADA.aDGGgGAH.NDIE.XFBHhAEAcDFH.fEDChAFA..,2,-23,-14,9
ELHKFCORabcMBUVWYSdNTgfDJAeQXIGPZ,XDEHGDDCEBBHKHAGOEBF..aGCAMICGBDHDUBGC..hAAAVBAHSFGDhABAdGGDTAFAfADChACA.DAFGAFHAIECF.LAAChAEACFHA......hAFA...,2,-30,-15,15
SPbgfXUFedGJaKAOWZTEDMNHCILcBYRVQ,ODGDTAFE.DBIHHBCHLAECBEGARGEA.QFADSABF.hAAA.PBHF.fEEHhABAFCDGdGBFaGEHADAGEEBGhACACDBFIEEG...cGGD.hADA......hAEA...,2,-33,-11,22
RNYUEFaKPIZQLHODBSdJfCWATGgbecMVX,TDAGGDEDeADB.MHACRACGUAGG.EGBBFAFF.aCBBKEDCZEAAQAAAhAAAHFGFDCDFBAABhACAdHFBCFFHADFC..bFDD.hAEA.XEGF.YFCH..hAFA......hBGA...,2,-17,-6,11
dHbFSYLQXWIgaEBeMNTZROJVCAcUDGfPK,UCDAGEDGKCHBHCAE.FHFALHBAQCGB.XFAEhAAAIEBDEABBeFGHMFIFTAGHhAAARAECOHAC.CEADAACChAEADBCGfDEBdCAHbFAC..SGEBhABA.WDFBBFFB.hACA...,2,-28,21,49
RFENXSICHgDaBVKYZdAWebPUfJTOGLMQc,eADCUDAH..JCCAOHAA.MAAEQFCHRBEF.EAACSGHFhAHACHBD.DFFGVEFEhAAAKCCBdDGFAIGG..PAGHhADAfBGB..LAHHNCBEIHEFhAIAaBDABEEF..hAEA...,1,-18,-23,5
aVFBSHcfDbPgRALKIXQMeCETUdZJWONYG,LFHFXBAC.eDBGCHBF.UAGCZCEHOFBEGBBFFEFF.BHEAhAAASHGEHFBGDFAHPEAAhAAAAABBKADC...QAGFhABA...MIDC.dDHG.hACANBBHaDDF.fGEFhACA.,1,-17,-22,5
ABCNQSHMJcXEWKGaYdTOIDPgfeVZLbURF,BBFHQGGASACDJDBG...XFBCKABBaAEE..dCHAIDEGhAAADEEH.fHDBhABAeCFBZGCEbFAGFAHBCHGHhADA.MBBDEBAB.YFFA...TADChAFA.PCHDhAGA...,2,-31,-18,13
EUefdYFGcHMgVObJDNQBAISRaCLXZTKWP,RGECaGAFCCAB.LECFZDDC.KEFEEGBF..UGGCdABBFAGBHBDH.MDFEhAAAODHFDBBC..BEAEhABAAFAG.SAFGhACA..WCCD.eAEHYHCG..hADAcFDB...hAEA...,2,-35,-23,12
KRNWMIHgQSVfFdPOacBXAGYTCLZeJbDEU,TCDFZBDEeADC.DGGDEDCB..RDAB.MAIDHEFCSEGFFGEH.hAAAdDAGOHACBGCHACCACBBCLAHBhABAJHFGKBGFIGAFhAAA..gDECfBAF.aFEHhABA......hACA...,2,-26,-15,11
HDKLPSObXENJZCTdBcaWGYfQVgMRFeIAU,DGDGLECDODABXGGH..JCDACCDEBGFF..aEHBGADBhAAAQAADMBBFFEEGhABAADBAKGAHSACChAGA.NIBD.TGFHWDFE.fDDEhAAA...gGCGhACA.,2,-48,-17,31
eZSNWgAXUfOTLdabJQGRcDEVKMPYFHCBI,UCEHTAECdGGD..aEGDJDAF..RGDADCBGKBAE...MCAHFHDGBFCAhAAAeBHDZDBA.SHAGhAAA.NGADAIHCOFEGhABA.LBHDbCDE.QACChAEAEABG.....hADA...,2,-38,-13,25
DPGYaCdJMcLTAEUbVHgNQeZFXOKfRSIBW,UFFDHGFAQDEDFBCE.XGDBKAABSFDDBEBGDCAFGCEBhAAAaCCCdBBF.MAGDhAAALBFEAHCFEFAB.bFAHNBIC.hABAZCAC...OHEE.....hACA......hADA...,2,-19,-10,9
ACbRacQgKDBYVJOdSXUGITeNFEPZWfMLH,REGFaFFDQABC.DDDBBHHA.JDHHOFAFSCEGUFEGGAEFhAAAeABA.FCECEBEEhAAA.ZCAAMIEGACHECFEB.gDAChADAKGAAdFAB.ICHBNIAD...hABA......hACA...,1,-8,-27,19
GcUAJEaNBHMOFVXYRgebCLdfKZQDWSPTI,aDFDBHGEHDAAMCIBFBCF....VCCARFDHeAHBCGFC.dGHCZFCHDGBH.hAAA.SACEhABA.TAGEIAADhACAUGAEACFHEADEOCBHYCHF....hAFALFEC..hAFA...,1,-14,-22,8
XBYMZFPQDEeIgVATNJUWbGKaRdCLcOfHS,JDDAUDDDGGAHKFGF..dHCDLCAB.OFCGHBGHSFAFhAAABGHAMABAFBGADGDGEADBhABA..eADAICAAhACAACDC..NIDHaGFGCHHEfBBBZBBF.hAAAPAEG...hAHA...,1,-14,-26,12
SgMDBbUJFQfATWCRcOZVXNeYEaLdHKGPI,CDEDOFEHZEAH...XFGAeHFCEDGBdCHEKHDEGBEC.SEBDhAAADDIHBCFFJADAQACFhABA.AAGHWCCDhADARDCBVBAE..aHAE..PAHBIAHGhAFAMGFCFHFE....hBAA...,2,-23,-14,9
gfAFVUBTaOdLKIbEZXDSNPGHeQWJcCYRM,VEGDTBEB..dFBFKFGF..EDAFDABG.SHACGGCHeCEHhAAAQEDGJADA.CFAE.hAAAMBIFADCDBADHLAGBhABAbDFEZAGDPBCH....WBBF.hACAYHFG.fCCBhAFA,1,-15,-18,3
RYbeEOJGaHQScKMXPUNFfDdZLVgITCWAB,BAHGRDEGeCCCOHDEGCAGHCAG..SDHHKDFAMGBAUABBhAAAFGCCdAADZEDALAGBhABA.gGGEhADAIHHGCBFCAIAEEAFBaBEHXEACNICH.DHCA..hACA......hAEA...,2,-22,4,26
KCeTcGHSNdAXEfIBOQJPWLFVDZRaUbgMY,EEAHBFDC.QADHJADCLFHFDFFGRFADUCFD..MABFKDCB.CCGE.hAAAeAAB.GGABhABANHEF.dCCFAACF..IAHGhADAPFFD...FDDE.....aEGAhAFA......hAGA...,1,-15,-36,21
cPZCefJSGONgBLQAIbTXKVMUdHEaWFDRY,TDFCXABC.KFCEUABE.HFAHECDBFCGCDFDGRGCA....PFABhAAAeBEESAHBhAAAGGEDODACgFGHhAEAQEGFAECDIDDAMADAWBFE..hACA......hAHA...,1,-6,-17,11
MGeLbNcYEfTURHFQXBSOaWPKIJDVCdZAg,GAEELGAG..bCAHNBBD....EGEFUGDAFDCA.BGBG.aHGEhAAAKDFDDDDFCEAAAACA.MDIFhAAAeDHH...fAGEhABAHBGDXGGCOBBA.WEFH..hACA....PBAHhABA..,2,-26,-21,5
GBgYSLUTKHeWJDFCMIOfEcQaPNAZVRbdX,VEAARBEFdADEGGDD.BAGBSCBGLBABTDGCKFACHDGBhAAAJFGF.DCIDFAAC.MHAAhACAODDB..cAEGhADA..aHCCAEDEbFDD...XAGEhAEA.....hABA...,1,-9,-21,12
YPNcKeZCWDBAVUMILGSbgdEHXOfQFTaRJ,VCCFMDDALEBA.GGBDSGDDdAEBEACDOEGD.hAAAFFBDTBGFaAACJAEENBACeGFEhABAZFEF..DBIFAIBAIEGGhADA..bCAB.....hAHA......hAIA...,2,-23,-9,14
RTgGCdEPQbOKFBMYJfSIUZDAXLeWaNHcV,LABEeBFE.aFCENCAH.HGEC..RFCFGCFEEAFBQCCGhAAAODBAKAAGMCIB.YAHDhAGASGHF.IADGhAAADCBDACFHXDFDcGAG.....hACA......hAFA...,1,0,-29,29
CXTdSBcWLgfVNAIaYeKZPEJQRMHFbUOGD,aHFCeAGBZADBEDBE.REFA.HEFG.FDCHODDDDADH.CHGH.dABGBFAALBFAhAAA..VACDhAAAAEEHIAGEKHAGQGDFhABAMGDE..........hACA......hAEA...,2,-24,-23,1
eSJGVaMfBEcgPKTROWUZIAFDYXQCdHLbN,DFCCXFGAQCEGHAEBLBAD.eEEDGCGEMCDDEABBhAAA.PHAGTCGDRAFCOFHDhACAWHBGZDBHIFFHhADAAAGHCAHE.dEAGNAAD.SDCCaHFEBBCF.cADBhAGA....hAIA...,2,-13,10,23
BIXVQGCDaYUTLdPFWOHcEZAJgbKfSReNM,JAFBKFDHRCFG..eECABHBC....IDCCVAAEGADC.hAAADHFCUGDF.TCGDhABAdAFBFFFAOCAHHDAB.hAAAEABFAGIH...gGGGSAHHMFFGhADA.CHBDaCCA...hADA...,1,-15,-26,11
ObEcQCXTMNdJLZPaSefKYUgHIAGDVBWRF,GCCHDAHHBGCEREAEOFFA..bBEDEHAC..QDABhAAACAEE.XGFGNHEHLAAFhACAZABAaGAHSAHBhADAfCCDKBBAgBGDACAEFEHD.MIEGhAGA......hBBA...,1,-15,-20,5
CaULFNKOPcdDIBHWVgTYXAZbSMQfEJeGR,ZACFMAGFEFDAGDDB.CGHB.aAFBLFBCKDFE.OBBEdBBGIEAFhAAABHFE....hABAWDACgGBEhAEA.TFGGYHCAAIBESAGHJAAGeAHD.hAAA....FECG.hAEAPHEEDFAH,1,-11,-22,11
SdBbJXOLRWGMAEUgefIaPVFQDHKZcYNTC,EEGBeCFA..aACDFFECDDGGHCAH.ZDDA..NBFA.CGBEBHHE.JAFAhAAALHEE.RFAFMEAGhAAAAEAFUACBIBABhABA.PAFAKEHH..YHEASBDHhACA.....hABA...,1,-16,-30,14
AEGCQJVcYSUIKXPagHbRBdFODfeLMTZWN,CHGAJBBA....VGBGSBFF.UEEBXCCD.aBAEhAAAHDABBEFCdHCDFFHFDHFGhAAALAEDMBIDZDGHABFCGAGAhABA.QDAAIHADKAGE.hACA......hADA...,1,-23,-26,3
LTXaYCDUAWKOMBEeHQGSdZNIRVgbcPfJF,KFAGOECCBCHAHBAAGADCdEGCZAGF.RBEH.VAFE....bGDChAAA..PFEGJFAFFABAhAEATDBC.aABEDIFEhAFAAIHC.MEIB..eHEA.SCAFhAAA.IDFHhABA...,2,-31,-8,23
MdLEcQYHFUTPIVARGegbKWCSZDaNJBfOX,GGEBeACHKAEASFDFDFFD..JEAAfFAF.MDCChAAAEGHDQDEHhAAAHABGFCAFPAFEIHCEhABAACHCgCGGCAHAZCGHaGADBCABOFFA...hACA......hAEA...,1,5,-29,34
KHYGSRACeXcVIQDbEFdTUZBfOLPNgWaJM,CBHBXECF..VDCBQEAGDGAD.EACBFHFGUAFAZBCGBABBhAAAOFHBLDHHhADA..PHDA.hAEAgBADaGBDMAFE.KFEC.YDDChAAASGECAIACeBHHbBFD..hABA.fHBDNDBE,2,-33,5,38
dHFcaXTeEYCQNMUJSDGKZOBPfIbWVRAgL,dCHAHCGFaFEEXEED.ECBBCCEBMFID.UDCEDBGEKBFD.BABEhAAA.IEAGhADAbAAEVFABAIACFDDB.eHAEhAEANBEH.JFHDZGDCOFAEfCAG...hAFA......hAGA...,2,-18,-10,8
GPBdIYScDTRLbVZENFKQXWCHUaAeOMfJg,eFHBMDFH...JFAEGCADBHEA.dHEB.SEGHDCIDRACELBADhAAAZABEFAFEKEDCQECDhAAA.CFAGaDHFAHCAfGGGhABA.IAHD...hABA..YCEGhACA...,2,-45,-15,30
UIXGKQgWcaYAObNdDZeRJPMLFESfBCVTH,OGFCdDBBDIBCZEDGRDAF..MHBCEBFF..BHEDCBAEHDDH..UGGFhAAAIAGGKCHD.QCGAhAAA..WECDhABAcADF.AFFENIBDJADHFCCG..SABHhAEA...fGAChAFA,1,-26,-38,12
RDOJaNHMZeCGSgUXQYFLAIcBbKTVfWEdP,BCCFTDDD..VDDGEDBH..RADG.OAGFaDHF.HEABZFAECHCGSAEDhAAAUGGH.XGDChABAQBABLFGFhACAAAFAIHEH.bCFD...KAAE..hADA......hAHA...,2,-22,-11,11
HYLcKfdESVaIRWBUPMQTNgJXDeGbCZOFA,HFFELDBDKFCGdCEAEFGB...aBGGRFDFBDFDUCBA.QAEDhAAA.TDCGNDAG.XBAGhABADBDA.eCHDhACACHCDFDHDABHA.fABHIHFFMIACJHDA..hADAZFAD.....hAEA...,2,-16,-10,6
SYBDbFTNOaXeJAQRLHcfPGdKIVgMEUCZW,QEBGHBEB..PBHDGCDEIFFBMDAECACDZGDE.SAEAhAAADIGGTEBFNBIC.hABAXBCB.eAAFhAAAAHIHLFGBfGACdHAD.KHEE.EDAAYAGBhADAFGCDaAGGcEGAhACA..,2,-14,5,19
eAQMOabKNWgfBTIPXcYSHEJGZCLVFdDUR,OHBGaFDH.KFBG..NEDF.....fBECBGFAIGBEhAAAXCAASAHFhABAHEEEGAGCCBFBLFFChACA.FBBHDFIHeADHAIEAQABHMIBCWCFAhADAgGGD.hAFA...,1,-16,-29,13
UbRGTcaNOWIPeYdKFZLgAJEDVXCMBHfQS,EEFDDEAACDDDBACE.HEADQFFDUAECREDB.GBCB..TBBDhAAAaADA..OAGFhAAAIFHHeABFKDGGLFDBhABAAAHA.JGAGMDDAfDHCSBAFhABA.NICF.....hBEA...,2,-22,-14,8
FdEAWOBTQaNPCDeKXRIbfHUJLSVMYGZgc,OBGBQEAF.aGCHCFACDBDH..KDEDRFDB...IGEDhAAAHFBFLBBFSDFHhABAMACGGABDZFGH.cAGDhACAFDEFABIDBHADTGGFNDIG.PDHF.eCCBhAEA...fGAGhAFA,2,-31,5,36
adNVOXMBcLPRWEJgUCSGfIHYZQeTKDFbA,dHABVDBFMCBB.LCEFRAFE..EFFBUAGESEHHGFEBHAAChAAAZDDBeAAGDADCAFHAaBCEhACAOHDEBHDGPFAHhADAJDCH..CDHBIHHF....hABAYHFG..hAEA...,1,-6,-21,15
RUQdFeaHMgbZGPKEOWDYfAcXVCSLIJNTB,VBAASCFG.LDDBJDFHBECBQBBF.dAHCeGAGhAAAMFADZEGDKFGHEAFCDADEhAAAAADC.CGBG...NIDF.TGEHhABAFCGC.aAEEHFCCbDFE......hABA......hACA...,2,-26,-6,20
eVCAbYKTGcaUdgSQNPILWOJEMRfFDZHXB,KEBCGCBHUGBGSGCA.QAFGNFED.LFFDhAAAOBBEEAFFMFBC.fBHChABAFHECDDACZAGBBGGBhACACHHG.ADAD..YABGaACG.gDGGhAHAIAAEJDDC..hAFA...,2,-38,4,42
MWXfaIYPORZcLBKeCbdEAgUJFHGSDQVTN,JFBGFECAGEAA.DGFAVAAB..MCDG..XGGEhAAAaDAG..IAADhACAPEEAOAFAZGDALAHFhADABDCCKGDGCEGA.dBEGAAFF...HBFESDDEhAEANDAGfFGF.hAGA...,1,-15,-25,10
HFbTaMRPZNGVDEBXSeOQIWgJYLCcAfKUd,UBEFdDBAHABAFCHB.aEFGRBAF.ZGFCGGAD..VAFGDEGDBEEE.hAAA.eDDBODCDWDHHhABA..JHFALFAGhADAAACD.fHDD..KAEEMIAAhAEA......hAFA...,2,-39,-7,32
VDUadBERSfCZGKeIHLTbAXgMNPFOQJcWY,MGCCFADHQCFD..JEAC....WFFFVBDGDAFHaCHFhAAAdAGFEHAE..SHBAhAAACABAKHGEHEFGbEABAADG.hABA....gGGBOHDEcCCChAFABDDEfBAAhABA...,1,-17,-39,22
OaCQJRbYSLefAXKHDIVcMWEBZPgdUGNTF,XDADKEDEDDAB....VFAHMDFGBCEAZFEBdCDG.UAABGAAHhAAAFHBGCGGDQGEFhABA.JDHFbAEESDCFhADAfEHGAFFE....IHHAhAEAWFAA......hAFA...,1,-20,-33,13
ONLDWcSXGZdKAEbMBYFUaCVQfgJHPReTI,MBFEFCFDCACH...QCCG.JFACPFFB.RBAH.eADChAAAOAHFDDFGSFEBhABA.XEGHhACAZFABKHGAACEHBCHBaAEGfEGH.HFCHhAAAIHAH.NIEF.hADAcDCAdBBC,1,-26,-27,1
MVSGZgdfQcXLJWTPRHKFeBObANEUDYaCI,UGBGaBAA.CEAB.MEFDGFEHdFDA...QBBGXBGBLFABhAAA.JBDBPAHFhAAAKCADBDBHAFDADBABIGHAhABAVCEH..SAFBZCFH.fHEBhABA...hACA...,1,-24,-25,1
GdeTCBROKMNcbEHYWgDFUVJLAQSIPaXZf,QFGBSDBB.aBBFZAAA.dDGF.CFDABHHGODFA.KAFAMEBBhABA..bDBGEAFBHGCAhAAA.gFAAhABADIBGUDDHJEHFAADE..IFEDfGFE..hACA.eHCENIEDWCAF.hADA...,1,-4,-26,22
McAdUVBOQLRDKXWbPJgEIHTfCYFZaGeSN,dAABVEGDOCFH.RGFE.KBBB...XBDH..bFAFJFCDhAAAEBDAHDAD.TAGFhABACDHCFAGHaDDF.SDAEhADAcGDD.ABBBBGDHDGABgDEAhACA..fFGBhAEA..,1,-23,-27,4
AcFgDKeZdBRGOIbHaVMPSJXUYTQCEfLWN,FAEAKDFHZABFdEECBCHERGAG.GBCGOBFAHDAD..MDIB..hAAAPDGHJEAE.XAAHhAAAUADAQFFFhAGA.CFDC.EHBC.fHGBLHEGABBDDFIHhACA.IAHG.hAHA...,1,-15,-22,7
AeWNFQCKDMHgbXYGTBdJVELaUZSOfIPcR,eGCAFDEDCHHC.KBEHHACG..XDCCGBAABCHHdBBB.EGCGUBGFhAAASHACOHEEIDADhABARCCHAAAF.QEFFhACADAFAMBGDYGFETFAF....hABA......hACA...,1,-14,-21,7
NBVgTALKXCIdOPYEbWeJSfcFQGRHMZUaD,LDADXFFFdBHAOBBE..EFCHeEDAJCCG.SHFAhAAA.FBEARDAEMEEBUDGAaGHFhABANACBBHHG.TAAAhAAACHBBIDDE..YBFB.WHCAhAHAfABF.hAIA...,1,-20,-27,7
eYNaXRIAUdZEWGgBKLOFDQHCMcfJPTSVb,UGCEZEGDEAEHGBBFBFFCLEAAFHFGHEECCAAF..MIDE.JACBSACChAFA.eBHFhAGAaAHHXGBGhAAAAEDAdBFE.KCEBOEBBDAGDfGDD..hABA......hACA...,1,-13,-29,16
AIEDSLcVXRNJdCZUaeMHGgQbFKTBOYfPW,DBFESFFALDBB..XDCBRDEFdFACCHHC.aDAFHGCG.GAAFhAAAQAFHKDDDBDGBhABAfHABAAIB.cAAHhABANADH.JHDG.eACCMCIHFDGG.OECHhACA.....hCAA...,2,-20,-1,19
ZSXMLGIYHBbeFWcgPQCfaENOADUKJTdVR,DDADJCBB.dFBFRADC.ZCGD..MHBEGBDC.HFEFBDDEeBCFFEGE..hAAA...gGGHhABACAHGaCFH.OHAAhACAACGFKHGC...SBBFXFFG.IAGBhADA..WBAF.hAEA...,1,-10,-50,40
AOWEeUISDNYGfXVdCTPZbgJKHaBMQRcLF,OFBFEFFAUBDHDBEBGFAB..VBFFCHHDZAAD..JFEBKBHDBDAAhAAARDEC..LHAAhAAAACCEeDHF...SEBChADANADH.XAFBPDDB....gGGGhABAMEID..hACA...,2,-42,-6,36
ONBVDAfHeXPTFCRIJbUScZWQdEgKaMYLG,eECGTDCFFCAH.RCFC.JHEA..UAGDZFCEdACAKFAC...MAEDLFHDhAAAGBGCOABGhAFABBFBDBBHAEEEHBCGCFACSHAGhAAA..WHAG.EGFD..aEFFhABA.NEIA.....hAFA...,1,-13,-22,9
PAgaZTESfbFdNVKGMcCXRDIWOHULeQJBY,aCDGZAEHSEHB.FCBBNBAFKGHB.GAGACGGDDEFH..ODCFhAAAUEAEQEEChAAA.BHFHYHBAhABAAAFFECAG.dAHGMEDHcGEC...IACGhAGA....hBAA...,1,-21,-39,18
IdBPVRcDHLNSEUMYTeaKWbGZfXOCAQgFJ,QADAJDFCBCCF.RDDDHDABLBAD..NBIC.SAGDhAAAUGFFMAAAeFEC.aFAEKGCFhAGA...bDFBfDDChABACBCDAIACFAGD.PHACDGIH.EGGA.WAHBhACA......hADA...,1,-1,-37,36
PSZecQfGdEIBAaLgbMKJNUOYTCWFDVRXH,LDCEMECFKBAH.UDGH.OFHBTFDAFBAADAGG..RFCEHAGDhAAASBFFZFAH.eEEEhAAAQADBdEACEGGGBCCHhABAAGGFaCAH.JBHBCEEG.WADB......hACA......hAFA...,1,-6,-26,20
JFQOWAbRLHXGaYVBeTZcCKNUfIEMPDdSg,LECGXCGBGDFCVFGH.BCAEZAFACEGFUECD..ECDAMADAhAAAdGDF...SBAEhABA.FHAAQBBChAAAOEHDABEB.bEAHaCDEeABE.cCGFhAEA.NIAH.fAGFhACADAGC..,2,-15,-14,1
FVBGALQPJHOdfUEeWaRgIXcbMSKDZNCYT,QDGDJCCEHCGFdFFGUABG..eABAaDDGREBD..XFAGhAAA.MFIBDIBAZFFCCCAA.hABATAEEBFDHACIFOHFChAAAfHBFEAHBIGADSBEEKGDG..hACA......hAFA...,1,-11,-25,14
HQSNYcTBMPEUbdCeaWILGRfDFZXAOgVKJ,OCAGKAAGHFCG.SDEG..YADHBFHEMADAEGCBdAABhAFAeCFE..aEGBIEBChAAALCFAfGGGhACAFDDHAHHDVAFGJHAC.cBCGPFEFbAFA.hAIA...CGHB...hBBA...,2,-17,-10,7
NbBJEKFZSQHRDgUYAGOCdfMTaPceVXLWI,CDCFdFCG.MCCEaADE...eAHHLAAD..NHEBBDADJFGFEDFAZDEHhAAAHGBGDBDE.UAGEAHAG.hABAOEAH.TEDChACAcDGD...XAFBIBBH.KHEAhADASACC.hAEA...,1,-18,-30,12
EBKeMWbIFDafcASNJUPOXGQCVHgRTLdZY,SDBAUBFHOHEAGAEE..QECGCBBEHCGFRGDCTGAChAAALHAA.dAAAEGGEBEGEhACAKAGAMBAHIEAGhADADIFGfEDCAIHCJADDPFEC.....hABA......hACA...,1,-9,-20,11
MLZYJFXdIHCeEQSUDBTfGNaOAgbWVKRPc,...bBABKCEG.RDBBMEGBLCFEZBCF.JEGFdHBBHFBC..EBAFSAGGhAAAUAGA.DFAGhABABFHBfCCAhACAaFEFAIEG.WHAG.cEDAFAEBIHHC.hADA.eHEG.TADBhAFA.NEIG,2,-34,-11,23
QNMgHAbLPIdCFaGTSfcOJZXYEWeBKDRUV,LFADdGAEFFEFGBEHTCAH..SDCCOBGHZFFGEBCCeACDhAAAKDGGDAADUECH..QGGHhABAMHBCABAAIHHGhABAfDAA.XFBBYAEBBDEAhACANICH......hADA...,1,-6,-21,15
XVICJKPdYSDFNEMLOeHAbTRZWfQcgUBaG,TAGERGFCZDBE..QBGGUDFEGDCE..IBCGKADEPBAFhAAASGCA.hABAFEFBNEICMFBBeAACAAEFfHEFhACABFCGaGADCAHBdCECDDIH.OAFH.hAGA......hAIA...,2,-15,-11,4
PMfWZBDcTgEdJQFRLXYVNGKSaCbOeUHAI,MBAFZABABGABDGCG...TGGHdBCDFGHDRDFF.LEEG..VAFEhAAAKBFCCFADOFCF.hAAAHCAEAHCG..IHAFhABAfFEE.WCHHgGEC.hACAJDBE.QCFBhACA..,2,-27,-27,0
dVgGaZcSJPKNUFbCIfRLDQBAXMTHeOYEW,XFBFHEFBOCFB.EGAAdGGGGCCCaEDDZBAESDAFKAHB.hAAAFDHHIABBLAAChAEABAGCAEBHMIDCeFAD.hAFAVCEEcAGFJHCGPDAE....hADA......hAEA...,2,-14,4,18
fdaPLGAIcQTVCUWJEKOBMNYXgZFDHeSRb,QCDCTACE.CGBD.JEDGKADABHFA..MBCH..XCCGhAAAFFEEDFHFeAGDSFBGhABARFCDdBAELFAFhAAAAHDBVAFGEGGE..OHECNCIC....YFAFhACA...hABA...,1,-19,-21,2
JgIHWZDdXRbMLTfQSGEBCFPYANcVUOeaK,VFFFOADA.KEBG..JAACHEFHZBGH.DEEHdCFERAGDLABD.hADAQGCHGEBEBFAFhAEACCCBFBEHAIDCUDDC.hAAAaBCE..IHHG.....hAFA...WAHBMDIFhAIA...,2,-25,-21,4
aAIXJUHDMVfLCcOKWPEFQNgGBZSYRedTb,XGCGJDAGHCFFDABE..MFEGLHFACBBCKDFE.EECC..QAFAhAAAGGADBGGHSFHHhABARADA.TDAHhACAADIBIBBBUCDAfADFcAGF.PHEChADA.NAIE...hBAA...,2,-22,-17,5
NGFDBYMKOZJacgUREQTSXfVdbHPAeCLIW,eFAGCFEALDGB..IAAAGEAHFAGCBEGCKCCCZDED.JBHHaACAhAAAUCBB..EBAHSAGChACA.XGGAhADAfGHAdECHbACAACHEDEEA.MIDA.hAEA....OGCChABA..,2,-23,-21,2
BIKOWFCTfUaebDdAEcLXPRgMVHJZSGQYN,EDAHXFAHREEC..MHACHDFFZDCBQABABHGH.KAGDOCBGhAAACHHATECDUAGEeHEChAAAdABFAFIHLDHB.hAEAPBEHJHDESBFF..NBACIDBGhABA.fHCHhAEA,2,-30,8,38
UMQOSGREeXfCBDYPJAdTVIZcgHFNKLWab,VBDEZFBEHACG.FCHDKDAFLCAD.aEEAbGDA..UFFBQDFDhAAA.GFADhABAEAAAeHBCCBCFDIDEYCCDhAAAAIAGdAHA..IHHBcAGG...NACF.hBAAMFIBSBBDhBGA.fDDG.,2,-7,-1,6
KSGLOUAZPRWFdgfEBXCNeQIMHYVcDTbaJ,RFDCdBBDEHGABHHH.CFEB.QBAFHAFA..VDGBTBFC.JFBHhAAAKHCEGDBFOEBBAHDBZADHhABAFCDD...fHEHhACANEAG.MAFEDGGHSAAChADA......hAEA...,1,0,-33,33
dYMbVcUfFCRBPLOgWaHAGDZSXQKNeTJIE,DGGGSBHBQGBFeEED..JACAEACGdAGGMFBD..VCBDhAAAfAED.FHCGhAAACEGFBHFGOHFCaFEBGCDHhABAKAHH.TBBGIBAH..YFFChAGA....hAHA...,2,-35,-12,23
JSLEZYHaGfNdQcIFbXMgOPUWRCeAKBDVT,KDCCBEEBDGAGJDADLFDG.ZADCaCDE.GGAHdHBF..QAAHhAAAFFGGMAAGOBBEhAEAUCFFCEAF...AHHCSGEBhAFAEFHH.HBGHfAHG.hAGANIEB......hAHA...,1,-24,-29,5
VKMASDJUZfBXEYdgQROabcGNeWTLPFHCI,DFEDZEBCBDDCECDB.dAEBQDGERCGF.OAECaBBFGGDF.hAAA.NDAG.eHBGLBBHhABAFCABCAHF.KCFC.MFGFhACAACGDSCEB..JHAGfFFDhAAA.....hADA...,2,-25,-20,5
fcDSKJMgUGdeNZVIAaHTFbEQBWRPYLXCO,TGFAFFHHQAGC.RBDD.PEEHLFCHCAHF.ODBBDEIDSDGHhAAAMABA.UBAChABAdGEGZEFDACGEHEBDBGBAhAAAWACBfCBD..JFAH.eAEDhAFA......hAGA...,2,-15,-9,6
GMFYJebdQaDZcBENPfOUVSWIHAgKTXLCR,KAFEXBGCRCCEGFBFFABH...eEHHQGGEDBCGBHFFECED..hAAA.PHBAUCACSBFGhAAAIADCAFCALFFDhACAMFEA.YAFC..dBHE.hBAAaABG.NIAD.fDGHhBFA.,1,-16,-22,6
YPgVRAIKBXaDFcGZENQfSJLbWHCOdeUMT,KGCAaDCC.FACDZBFF..QDFGSGHBLEABHFDAdBCFeDDBhAAAMAEE...PDAHhAAAgCAEAHCABBABXAFAhABADIDGEHFENBICfFGC.WFHHhACACHBG.OHDE..hAEA...,2,-28,-7,21
fGbMYXWLAUgVQIPTRCOEaDdcJSeZNKHFB,VABAQFGD..TFGFODEAECEFaAGH.dCBA..JGDCSAAAhAAAeEAEKBGHBEFHhAAAbFCH.MIFG.XGAGhABAADAAIAHCCAFBDDIHNEACfDDGhABA.WFFF...hAEA...,2,-21,-13,8
bWcFXUeNRfaBKMGYVAdDPTgZSJOCLHIEQ,dDGBDAEC...TDBCSGBHCGBA.LFFFEAAF.QDGBhAAAbEEC.FCBAXAFAhAAAeECBRAGDBHGEKADCMICGhACA..YBEDACCAPFHF..JDAH.hAGA..IABDhADA...,1,-17,-23,6
GCLRTfAVFPUbZKOSWDEIYcNHJgMXQeBad,FBFGUFEGZDFEKBGH..ODAGDCBE..EADD..IBBE.hAAA.NDIAHGAEJGDEMIFGhAAAQEADBAEFaGAGdDDBhABA.CGGB...TECFACADPAEASCEGhABA.....hACA...,2,-31,-28,3
GAFTgNUHQZMeEOPRKYWaIcfJLSVbDBXCd,FAEFTAGDUGAD.ZDCCeFDF..OBGHKHGEaABD...fCEFhAAASBAFVDBFhABABHFBdADDABCGHDAB.hAEAQEGDMFFEEGEA.PFDH...hAGA......hAIA...,2,-24,-15,9
VPWZAfeFXTCgEBLScdGaQbUINRJMYOHKD,FEBHCDGCBECFLDDB.dAACQBBGUFFF.RFEA.MIACOAEEhAAAKAGF.DIDA....hABAPCHFAAIHeFCCXCAAhACAEDDESEAD.aGHDNBBF...YCHBhACAWEAD.fHAFhADA,2,-41,-22,19
XADVUSEWGPONHadBbKCcLIefMZJgFQTYR,UABHSACFGAEGOEGHHDGDdGDH.BGBHKCFGCGAE.LCEFhAAAfBGDMIAAJCCHFAHBhABA..QGGFhAAATEBA..YHFGAEAG.DBEE.EDHHNIBDaGABhACA.....hAEA...,1,-6,-23,17
cZJVFWUSQGAMDPKEONRgCBTIdLfbXaYHe,DBDEEACFRCAGCHDF..BFGAdBHCLFAC..XECHaEHDHFDBeBFAhAAAJEEA..FGBBSDAHhABAAICGKBEB..OAEAhAAATEED.IGAD...bCFAhACA.ZBBC...WFHHhADA..,2,-30,-17,13
XVKJFeSWTfEDZURaMbgAGdPNIHBYcOLQC,GADHdAFA..PHCCIGHA.BEFBOECBCEDA.KBBFeDAFhAAA..SFFEhAAATGDBEBACDDCAZCDGaACCMIFGhABAAHHD..HBGFLCHH.XGAHhACAFEAH.fFFEhADARFDG.NCCE,1,-11,-25,14
OIaVMdLHDXNCFRPgQBeASJKTcGUfEZWbY,KFAEGDAGUCCCZEEC.....bABGOFCDaCDB.dGFHDICACBEB.FDHFhAAARAAC...QGGFhACABFEFAEHG.TAGFhADA.cFDC.ECECIAGB.MAIHhAAA.....hAEA...,2,-51,-6,45
QePANaGJIbCfVLBUYWOdRXTEMcFHgDSZK,GAGAJBHD.CGECLADCBGHDUCBG..OFCFdACHRECC...TCBEhAAAMDDG.HEFHDIFE.hAAASFBFZGBG.hABAeFHFAGFA.IDED.fBAChABAYFADXAEHhADA...,1,-2,-42,40
NSdICaTeRWALPEJFQBfHXYbKcGgMVUDZO,LDGHEFCFFDAA.QFCGBBGEHBCCXCDCKFEHGDED.MAEEhAAADIFEZDAH.NCIGdAAEhACACGHCaBHD..eHAGAIAA.hABAfAEE.bEEDcABB..hAIAgAGF.hBAA.OHFC.,1,1,-11,12
EcLeJgDWRZbSKTFdOBMIHafQXYUGVCPNA,EEABLHAG.JBDHDDCCZAFHKAGD.FFGGBEGFHBAE..QBAGhAAAXECCGGDBhAAACGGCACFB.eABEREAC.SHAEhAEAdFEGOBHFIDGDaHFE....hAFA......hAHA...,1,-21,-22,1
FeSDfIQbRAYaPUZNJXVdCgKMcEBOGWLHT,aFECUDBAZCGF..JAAEdAGH.KACGEAHF.BDGCOEAC..LAEDhAAAHCEFFBABDICA.QFGAhAGAAGHC..hAHANHAFCDCDMGCG.....WGBGSCCEhAAAIEEH...hABA...,1,-32,-33,1
LTYHbXQEDBWIfKMcFJeUCZgdPRNGSaOAV,LGFCHFAEXCCHEBFCDFADBHBA...IFGBMBDHFEGCUBEHhAAAZAABdGDCRGEG.SEDAhAAAAFDAVBAD.bFAHWAEEhABA..KCEF..eDHBCAEANCCA.OAHDhACA......hADA...,2,-13,-7,6
cLTQZNaWOJMfFXUICRHeBPdKVYEgbGSAD,DDBHLAAGZDEB.aGAFODHD..fFGDUAAFRFBF.eBDChABABDDCdCGGKAEG..YDDHhACAEHGE.gGGGhAEASAGHACIFcFCH..NDAEJHDAhABAMDFD.IAHEhAFA...,2,-32,-23,9
OUHgLYMWCaKSIRBeTPGXQFdVANfDEbJcZ,DDBAEFFD...JDFEOBCBHEDDLAFAMBIHCEGF.KGGARECH..eHAGhAAAGEBGFACA.AGFG...hAAAfAGCbBEC.hABAZAEDgABFaBABBHHF......hAEA......hAGA...,2,-23,-14,9
cdOgGZRYQFEaWTXbDAIeKMUJfLHCNVPSB,eBEDUDGELFBACGCC..VCBBSACFdFACGDFGRGEGFHBCEAAAhAAA..aBEE.TDEChAAAXBGA.DIEEKDBEhABAMAEGfAHE.NEAA.BBCE.OEHDhADA.YEEFhAIA..,1,-6,-23,17
LFHEAMBURbYWQgGdICPZXfJOKaNeTDVcS,BHGERDFG....bAEEQCEEGCBBdAAHCCBDZDAG..fGAAhABAJAACKAGG.NEEA.DHDEhADA...VFACSGFEhADAFFFA.AIFAUEAB.YFCBhAEA..gADHhAGA..,2,-33,-17,16
SYPAKIMCZgRLGdDXWeUHcJQFVBfTENaOb,KDGFMGFAZECBLEBFdAGE.DBIDeCAEHDDGQFAFFBDEBEHHEAGAhAAAOFFE..SHEGhABAADABCBDD.RABFXGCBhADA..WFDH.JAAG...hAEA......hAFA...,2,-33,-16,17
UEKeZgWMfLcCPTQaYBNFXdSJHIDOGVARb,RECFUFCEeADCZDEH..MBAHLHFE.CEGD.TGEB.QBEEhAAABCGBXBAGhAAAdEGCSHACJDBA.hABADBBDOBBAAIBAECCEKBGAgAEH.fEAChACA.aBHFhADANEIA...,1,-7,-36,29
CABPfSLKbJUaTNXdgEOFWeZIcGQRDHYMV,BBCHSFFDLEABKBGH.UGCG..aBABXGFEEEGD.FDFAhAAAeDBFZCBA.GGAHhAAADBAH.MBDFAAFD.PAEFhABAbECA.NIEH.dAGD..gEDFOEHF.hABA......hACA...,2,-23,-6,17
fKBgZUDFbNXdYAMCLOReVQScJTaWIHEGP,CGDELAEFRAAE.eGACSEEA..cEEDJFHD.aBBAHBFEhAAAGAGAKDAGZADFDBAH.hAAA.FGGBXDDChACAACCFMFIB.QFAETDAAEAFFBAFF...hABA......hACA...,2,-18,-12,6
efdbZHVMTBgIWRaCKYXOEPLGDFAJNScQU,SECGUAABeHAEdCDGHAAA.MEECBAEE..IHBHaDHDKGHH.hABAODAFLDFFDGAFFFGGhAAAADAA.JGDCQAGEhADAZADFVAFA.TEBE.gGEGhAGACHDDXCGEEDGH....hBDA...,1,4,-16,20
FANSbDLHXZMRQKacBfOeEWVdTJgPYICUG,SADEDBCGLBFHHECHMFFCKBGG.BHFHOHBGEEGE..VBDHhAAATEAE..JBADgCAEhAAA.IAHHhABACGBEFGAHAFFFXGGBZDCBaHGEeHDA..hACA.WCCE...hABA...,2,-24,-7,17
CVPRDNEMLQgfdKeaUWcXGYZTAbBOJIFSH,BGACJEDC.SDGDCCGE.RCCG.DGDDEEAAQABC.dBFGhAAAeBAA.aFCAUFADhADAXGBDGGEDYBHBhAAAAEGGOADD..IGHH.FAED.hAFAHFEFNAIA.MABE.hAGA...,1,-3,-33,30
QWdegENUTHIGPZaLVfCAFYOSJBRKbDcXM,FDADODABBGDDRFDE.DFID..MIEAdDDG.EAAHUADG..HCFAGAGAhAAAaBGALBCHhAAA.CHCHAGHASFFFhABAKFBC.XGAD.eBBBTGAAIGGDhACA....hAGA...,2,-39,-11,28
eSIAfDCWbHEUPcTOBZYJGXMaVRLKNdgFQ,CAEEHFAGUBCATFGA.BGFGJFGH.GADG.XAAGaGBFRBAH.hAAALHBAdFEE.QDFFhABAeAHHAIDEDFDDbAFFhACA.EDBGODEEMAIDKDAFFGAH....SAFHhABA..hACA...,2,-34,23,57
KfMcFXTgRGYUedIbQLWCDBaAHSVPJZNOE,HFBCVDAF.ZCAC.OAAGEFEH.KEADMIFCFFFC...TAGF.hAEARGACGCCFUCEEIHABhAFAQAACCBCBBHEGhAGAAICCPGFE.JADEfGHAXDFA.eCHBhAHA.....hACA...,2,-17,-3,14
McUCfFXIVLgSYdPaQKDbHOJeGRTNWAZBE,BBDAEEFEUBFCCFAA..FHFC..XEAELDDG...SABHhAAAPABFKBDDHGAGhABAJEDFRGAETEGE.ADBDMADEhAHAfFFG.IDAAYCFCaFHDhAAADFDC.....hABA...,1,-24,-29,5
NRCUAWXMfTcQBdDJVgIFaLeYSEKPGZObH,MADHTGDGBBBD.DCABVADE..FDECaCGBLFAE.eFFGhAAAEFGFKBBBZCGFOHAEhABANAAGCHHD..UGACACEE.hACAfDEA..QGDAhAEAgDCFIAHBSCHHhABA..,2,-32,-11,21
QdFAHCZSgEPaNOfbYMWBcJGeXVLTIRDUK,HEAHSAGHEHCCaDEAOECF..bCCFMIAG.BHHDGFEDhAAAeADCLCHFRFED.hAAADBAEQBAHhABAAIHGCAEDgCAENEEBfDAAcAGB.....hABA......hACA...,1,-7,-16,9
EbJZdVNPCHYMIBeGXKfLDUQWgaRTSFcAO,EAGDJHEGZEDDdGCF....VBBCCBGFHCGF..MIAABFBFGCFChAAAKBEHLBAGDHGGQDADhABA.aADASHAChAAAAFFFODHD.NDAH.IEDHeFFG...hABA......hACA...,1,-5,-34,29
RIVBbYFOMHaWPDUQfEdSLcJTGXKZNgeAC,RACEBBEHFGCA.HEFD.aBGEDEFH.QAGAdCBCSAAFLCCHhAAAJDDH.GCACZGBAeAEEhACAAGIDCBAC....IGGFhABA...YFAFOFHFWHAGhADA.fDGDhAHA...,1,-22,-28,6
WDSRTVQLBOXaMNHKgcCPbZUeGdFAfIYEJ,..IHHBJCAEDFFH.RBBH...QDFBLDEBXAEGhAAAMIACHFAGKCGFCAHB.ZFCDeAFDhAAAFEHDAHABEEHH..SCAFhABABACHNDEG.cFAFUGGFfEAHhABA.....hACA...,2,-26,-8,18
EBXWCUQeDbJKgfdaHTRFNOPGIYMVcZALS,SAAFEGFHBAGE.CAHD.eBGB.DEAFJHFCKACCdEDD.HFABFDFF.OAFBhACAGECA.MCCGhAAAZCGDADBALEBFUGDC.hADA.gBCEaEHD......hAEA......hAGA...,1,-19,-24,5
AFgcKZXfENDLTYbIOdWQPeaMCJSVUBHRG,FCDHKBDDZBFEEBHF.LAEE..TBAE..IFBEhAAAdEGAQGCGaCBH.MAAChAEASGFFBHBFHADChAGAAEFCXEFENDFEDEIH.OEDD.WACFhABACHHH......hAIA...,1,-11,-39,28
IYFTVBWHQeODCKMJdXgZGcSRbLaPEUNfA,FFFDBDBGQBFBDGGAKFBE.dACBZGEAGFAB.RBADLHAGhAAAEAFFUABE.AIFA...TBGDhAAAHDDCCHHE.MAFEJDDA.hAEA.......cDGEaEHHfCCBhABAIHAB...hAFA...,1,3,-48,51
QLRaPXKUMNJSZBOdEATfFHYGIcWebDgCV,TGCCHBADGGBB.IFFBeCGFDDADCAFALAEDaAAF.KDDFhAAAUFFHMEFGJEBBBCGHhABAdCDEADFDFHGG..cAGFhACAWDAD...bACE.......hACA......hADA...,2,-19,-16,3
OTSCWdAFbZEcUIeGJBLMQDRXYKHgNVfPa,ZCDHEFGAUCBAGBAGBFCDMGBE..DGIDRFGHKCHHHEDD...VAFDhAAAPAEC..aACGTDFGhAAA..WFABhABAAHABFACG...IHCALAHB...hABAXBDD.YHEGhAFA,2,-28,-18,10
YXFcHWNDJAgZdQRCUESMfGaPeBLOTIKVb,ZBBFdFGCCCCCEGBC..MBIDaAFG..BFGCLGBA.OBDDIHGAhAAAKCFD...YDFDhABAFAGFHAAE.DIGGJBDFhACAADAGQEADSHDGfDAChADA.PBFC..hAEA...,2,-32,-23,9
TVFdCPMQaAKRSUJGgIWXNDHbZEcBYfOeL,SBFBUCCGGGDD....IDDBXEGBDGEFZDAHBCBGhAAAOHACTFAGdAADMAGBhABAQACEAFEC.KFCChABA.JDHBNAFA.EAHDfAHALFFFCHCC.aGHDhACA......hAFA...,1,-17,-18,1
NgVUFOHAJbKScPTZEDRBMQWafGCLeYIXd,JAFHKDHD..SGGD..PBHDEBBADDCBBFHB.QEDDhAAAfBFBCHEDeBBBhABAIDEH.NACF.VEABhACAFFCD.AEGC..TGFDMICCaAHFLADFhAGAYAADdHAD...OFHFhBEA.,1,-8,-37,29
aQTHWZAOLcVDKBbMCNeSYIFfPJRUgXGdE,LDCEDEGAKFGBBCABMBAH...CCFEeAFCSCCE.FFBEJHCChAAA.REGD.UFEGGDAAhABAdBFC.EBCE..aBHH.hACA....QDAB.WHAChAAAAGEC...OABChABA...,1,-20,-46,26
NEPcfJgbLZYICeBSAKUWOMTVDdHRQFXaG,UGEBOEAGMBHBDDGBHBCE..QDCCFBGCGEGEEBBG..hAAAfFEAbAEFLDABhABAZFAGCAAABFEEAIDCKHAATGBChACAdACB.aAHF.NDIE.......hADA......hBAA...,1,-8,-15,7
gHdDMVIZOSfNbcJAeBWUGERCaYQXFLPTK,eABAUFFDRFCDCDHG...QCEBLCDGTGBBKAFD..dBHCDFGFhAAAMCCBZECCOAEEhABA.SFHDhACAfBAGNIDH.JAACAFAABGEGEHAG.aAHDFEAF...hAFA......hAHA...,1,-17,-20,3
MCaLZBIQNHTedcSYVgDAXGfKJEPbFRWOU,GDBCKGBDEGGB.FADGRDGB.OFEH..UCCBCHGALBGHBCADQAGAhAAAHBDGdBABSFFAhAAA.gGADhABAAFADfEBEJCAB.bFDDMAIFaDFHNABD..hAGA..cDDFDGIH.hBAA.WBBC.,1,3,-20,23
beGSaURZWIQAOCEfdcTDMYFLXHVJBPKNg,OGFGCDGFdADH.DBFDMCBBLFAF.HECEBGHAKCAG..NFEF.eACDhAAAGECCUBGBRABB..hABA.IHEGACFF.hAAAfDHGTAGGXGAH.JHEC.hADA......hAEA...,1,-24,-27,3
CWYeIgMNbVATRdPHDLOSaEJUZKXFBQfcG,dCBGDDCHLFFDSFGAEBHHZAFC..FABHQDDBGECECEAA.eAAFhAAA.MCDCVAEHTGAAhACA.HCGDaHAAKGGBhAAABGEF..fDDDWEAGIHHChADA..NEIGAIAA...hAEA...,1,-9,-17,8
DeLPYacEVQbWNBOUfFdGTMZCHJXgRKSAI,DCBFeHCGLCGD..aDCFECHHQFGG..WFCAhAAABCAAUADBFAGBdBEEMCCFhABACBHHJFAB.XEEDhAAAKDDHIHHF.PEABcABF..NIBB.hACAfDGD.hAEA...,2,-34,-20,14
LQcZgYNKGRXVTFaMUWDAPBOdSECbfeHIJ,OAFCECDG..CGBBeDGDJCGHLEEHZAAG....NBIAGEEGhAAAXCBGFAFCMCAFDEBGACFEhABABHAB.SBAEhAAA.HECBIHACcGGHKEAD..hACA......hAEA...,1,-22,-27,5
SZAfTUWeJcOIMKVdLDQRaYgHbEPBFNCGX,UAAAeAFDOCDHMBEG.KCHHdAHA.DDEFREFG....aBAHHFAAEGBABAHFhAAAFFFCCDBAGGCBhADA..ZBBBAHHBfCFEhAEAJHCEIHHH........hABA......hACA...,1,-24,-26,2
IMbFOUBVaHGYCTeNRAEZXdQgWKLJPSDcf,ZEECXEFGQEAGKCCA.LDCH.JHEGDDAD.fECAhAAAMABBOACEBHBFHCEChAAACHDFTBAAeHBCAHAAdAGChABAPAFGSGGG.IBEE.hACAFDGA.aEAD..NDIA.hADA...,1,-5,-19,14
REIZDbeSFLTNMcQCJfHBaAKWUYdgVOPXG,UDDDdCDAOABFGDGCREAE.EAFGZGFG..eBBHFFFCLAGF.hAAA.NGCHMFBBCHBE.HADFhABAAADHKBAF..YHCAhACA..PAHDDIGCSAHBhADA......hBAA...,1,-11,-34,23
fOXQbRSLPKZNIUHTaFGcJEDYeAdWCMVgB,CECFMCBHBGDB..OABEQGAHRFBE.LBCAKDEGZFFEUAEChAAAaGFH.FCHHGBAE.hABAEEEGDHAEeAGBADCHdDDG.hAAA.WDDE.fGGDSHFANBIA..hACA......hAHA...,1,-12,-28,16
RBdKWIEQbeFTfGANSUXVcHaLPgZMCDYOJ,UABGXDEFHDEELGCAZEABCHDG..DHGEOCCFBFCC.dBEFKAEBECABhAAA.QEGHhABAFAGC.fEAGhACAAFGF.SBHFaGDAMIFA.....YHAAhADAWCHB.IHGEhAEA.,2,-39,-21,18
YJHNCLbVcdMSfOZAQTEBePgWRDKUGFIaX,QGDHBGFCeAFB.....PDAHRDGHDGEDKBAHGDDHFGAF.IBGHhAAA.XABAhABAHADBCHHBLAAChAGAVFGDcBDDMAIFfGACAFIBTDEGECCBWCCDhACA.....aDGAhAEA...,1,-14,-19,5
fYBGXKUIZOATVbgaEJFLeHDcdWRMPNQCS,VBACaHFG..FDCBeFGBDGAD...dGECRAEE.MBIFQDFE.hAAACDAD.fADEhABABDHAGEDCKFBFUDFBZAACAICE.hABATAFA.....EDDH...hACALHAA..hACA...,1,-14,-27,13
OcDZAUSWMaYNbgXBIeQEdPCFVKGTJfRHL,UGCDSGEDMBEE...aBGC..NDAF.XFADBBCA.ICDDhAAAEECB..CEAFKEEAhAAA..JDHDRFGBLAHHhABADCCHAEFHWABC.gGFEeABCdGAC...hAFAFFCF.....hAGA...,1,-22,-26,4
KVQCaRJcDASFIeNLbUHOPBZdYfXMEGWgT,SABAFAEFeCDHLCADHDFDOFCBBDCCdGEF..fBHAhAAAXCGG.MFFBEGAE.hAAAgCCGKAHB.hABACGAEaBAHJFHDAFEGIGHH.UAEA.YFDBhABATABG...hADA...,1,6,-27,33
TAEZIVLGKaFfdSOcQgebXHJMUNCYDRWBP,ZDEAVFEDKGBA.FAGHdDDA...SBFBODAE.QGAChAAAeBACHFDAMCAHCHGFDIBERDGHBHHBhABAAAHG.LBCFhACAaBDE.fAHE.cEBH.hAAA.....bCFAhABA...,2,-34,-1,33
ECZQUYXIHgWdKGFaJfeAbSNTLMcPVRBOD,SFBHLCHBMIBA..VDDHBGBGDAGFCACEUBEC..IHHBhAAAHFEFdEADKADDaBBBhAAAJAHDAEGH...bBAF.hABA.NCDG...cFGG.OEABQGGChAEAXGDG..hABA...,2,-35,-15,20
McSZgQFdEHTCaPGfeNUKRXYBOADIJLbVW,JGFELHDC.VBDCMCDE.ZDDGFFAAdBCGHAAF..CAAHGGADhAAAeFFEKDDF..XAGFhACABHHHAADBIHAAhAAA..cDAFSEGEEEGCaAECNAED..hADA......hAFA...,2,-28,-16,12
UAKcgIbTQJPSEGHMafeCdRZLNWDVYOBXF,KFDG..IFFEQCBCSAFBECFGMBADeADH.CHFCZDAAhAAANHAB.DEECOAFCBGDBFBBBhABAUGGEAHIF...cEBEhAAATCGD.PFBHaBBAfHEHhABA......hACA...,2,-24,-21,3
ZWgEIMYTOLCUXKNcSVQHabdAPfeGFBJDR,eFDHGDGCBFBHDGEARCDAZAEG..EAHHMCAG.OFFGCBCAUGADKEAD.hAAA.SCABhABAHDBGdAABAHGGFAEE..WBHHhADAIECE.........hAEA......hAFA...,2,-28,-28,0
JNbdLBZMeQFfPKRHaTcASCDUWGOYIVEXg,SDCBUBGGGEDEOFDD..IEBAVAAB..XDGChAAANCAD.LBEBhACABHHGeAAGFFGDKCGEaHACAFABhACACFAADADDEGFC.JAFCdDDFMIFCfAEF.hAEA......hAIA...,1,-14,-19,5
LagNdHDEKcAIXMUfBRPFTVeOYbWJZGCQS,MFCDUADFBGAHRFDC.FFFAeAFB..OAGH..YHDGhAAA.JBAHGBBEhAAAQCCCaFDCdCAGEAHBKHBAhABAAIAAXDFE.fEAEPHEE.hACA.bDEGCHHA.SDHBhAEA.,1,-10,-30,20
INREFcZDgHQLGVUbePKCdaMfOTAXWSYJB,SDGHBGHHRDFBFCDF.DIEAHFCHLDDGGAAFUAFH..PAFHhAAACGAHMAAC..TEAChABAADBA..XFGEhAEAJBHFEHAC.ZECC.gBCE.bGCCeHEEhADA.aAGA...hAGA...,2,-27,1,28
VIFfdNYZGAeSBTbQWRDEOUMCKgHXLJPac,SGAFBHGBQEBFRBCF.DFECEBEEMHAGCFFCHGBC.LCBFhAAAJAGB.aHGAVBBHIABBhADAFEHDdADBZCEGAEGGeAAFhAAA..bDFE.OAEAKHDG....hAIA......hBAA...,1,0,-21,21
GUcRNXaeZLKSCEIPMdTVYBbWAFDgQHOfJ,FEECDDBHQBCBHFAAJAFE.UGFERAAE...aGBGeDHF.KCFEEEEGhAAAMFIDdAFA..TGDBhABABCAHADEC..OAHFhACAfGED..NEAEXCFASDAAhAAACADF.IHDH.hAHA...,2,-24,-19,5
QLOBReNFWYSaAfXEIZJGCcUVMTDKdbPgH,XFBGEGBAZADBGBFGUFGB...MCCHTBBEDIACdFEA..PADChAAAQAAG.hABAODABRDDCNIDF.WDHHhACAaAGAAECD...fDHACAHHKHFG.bBEA.hADA......hAGA...,1,-11,-15,4
fJFGHIEVPMCdXcNOUBaWTDgSLeKYAZQbR,ZCGHQGCCRCCBFEBD.GBBCHAEH.EFGFMICCCFFF..dBEB.XEDFhAAANAAH.BHACTFFChAGADDFGSABEhAEAKGDAAFEA..fBBFIHHC..cAGFhAFA..OAHFhAHA...,2,-24,-11,13
gPRfIJKVDdcYXWGTOCULHFbaZNSBEMAQe,eADFRCAH..IHAAKGFDDDIBdCAE..XCCBGEGACFCBHFEEhAAAFGBB.ZAFDBBFCEABCAHDD.hAAAQDGD.hABAfGHAcCEC.TFBC..OAHHhACA....hADA...,2,-37,-3,34
faXAJcVDUWCIPbKNdHBSQFGTgOZYELRMe,VBEFUGEBCHCG......bEAEKCBEdHFFBGBFFACF.GAEH.hAAAODDBZGAAEEGGLCEHhAAAMBBDaEEH.ACIHDBADhABAIDHB..NAEHSGGEQDACYACEhABA.fFGBhAHA,1,-20,-29,9
YEZaABXSUNbOCcRHKMDIdLFVWPQfJTGge,BDCAUCDDOGEGCHAGHADHDFFALFAA.FACEVBFE..QCAFhAAAJFDB..TCADhAAAeBFEEGHHZDFCaHGChABAADHESABF.NIBB.cGAAMHACIEHFhAFAdACCfGGDhAFA...,2,-26,-8,18
HMUeNXFQdVBJgILDcEGCKTaROWZfPbYSA,HGEEUFFCeGBCFEGBdFCCBEDD..JBDDLADHDABE.GAFEhAAAKBGD.RABDOHBE.hAAA.fBBEhAEA.bFADAIGEMFIF..NEIA.....hAFA......hAGA...,2,-35,-23,12
JDfNXRFCYQTKObUWVPAdGaIEeBLZMcHgS,aFGFEDFCLFDAZACA.MECBHDAH.SEEHJCDH.fBHEhAAAXBAECFAETCCHhABAKAGDOHFGUGAHPHDAhADAdABFeDHFBDGCDIBEFAEH.....hAEA......hAFA...,2,-13,-11,2
WXMPNGCOcKgDLfbeTZSIVJARYQHFaUdBE,QEEHaBEGBFAA.EBDCMEIDGAAG.CGBC.KDGFLEAAeCDDSGCBhAAAIDGEAHADHABHhABAUAGGdBHE.WFHDhADANIDDOEHD..DDFFfCEA.hAEA......hAFA...,1,-4,-26,22
PRLcJBdVWEfQIZAMDYUSgbGHXNeOTFCKa,DADFSAFDGEFGHGBCeAAG.OCFEFGAACEFA.KEDC..RCDGJEHFBAEGhAAA.VCAA.EBFAIEAGhACA.MIAAhADA..YFHB..gDCGhAEAXFACaBAGcGGC.hABAfAHEAIBE,1,-17,-24,7
GLIKeaDPSQEWZVFBdgUCJMTNOXAYRfbcH,RGFC..fFBGHDEBGAFAKEEH.aDBEDBABQBADZBBEBDFBdAGGhAAAUFABMEHDOABAAIHE.hABA....YHBGhAAALFCHeAEFPDBCSBHB.hACA.WAHH...hAHA...,1,-2,-25,23
HZXGWPOTVBbIQYNUgLRdADaJMKEcFfCeS,DCGDJFAA.KFABFFFE..CBDE.HBDGZFDH.GCAB.OBHDBDHBQCCDhAAA.UGGGhABALHCC.AGABaABChAAAEAFEeABFSDEA.WAECPFCBhADA......hAEA...,2,-37,-19,18
GRTDWZafANXVgJdIYCKbFeOSQBHULPMcE,XDEHVAGH.dCBFCADB..KEGAeECB.OADFSDBBHCGBLBAFhAAAMDDB.EAGEhABATGGEDHGGZFAFfAAGhABAAIGE.gGDC.IEEEhACA.FGADBFHAhACA...,1,-8,-25,17
OIQSgTDeVYUAPKXcBfJEbCNWHFRZaMdLG,XFECBEBGJCAA...CBEGHGAEFBGFZDFCdDAD.OHFA.QCGHhAAASFFCDEDGeGDGhAAA.UADEABFAKABEEGADhABANICF..aBBC.MFFEIHHF...hAEA......hAFA...,1,-15,-38,23
ULbPWOHYIVEDAZCeaMfcNQJXdGRFKTSBg,CGGEMFDD....NBDF.JEECGBBEFGGBKBCABFDE.LHCEhAAA..PBHFOBABhABAHAEEIHACDAAFAGAFaDAChABAQCGC.XEAH.RDEB.hACASHAA.hADA...,1,-21,-37,16
HANCdEcPaeFBTIfKLZVSWMORJUGbgYDXQ,CEBBEBBG..aACBFDDCBDEG..TGEEKFBDLHCASBAD.hAAAMCEGOAFHUGACGDGAhABA..YCHBhAAADBBFXAGBAEABNBEDdDFAeADH.IGDGhBAAfGGB...hBDA...,2,-30,-15,15
QfaCUYNHMWGcJdIFELDAXBKSeRbPOVTgZ,XEFABEHAeFDBRAAD.OCEE..TADCZFEHQGADhAAA.CCBG.YGBGhAAAHADAMCAHGAFEdGGBEAGGhABADBIHAEEDKDCGSHAG.PFAAfBBBhACANEICcCBD.FGGHhACA...,2,-18,1,19
MeHcaVTCXFKJIYEUOBgGRQNLSfZWPAbDd,DBGEdACCHGDG.aAADTFGG.FCEEKAHH.JDDHEFEHBAFEGCCGhAAARCGB.LABGZEAFADBC.hAAAbFABMCFH..eHDAhACACGGE.IDHFOADF......hADA......hAFA...,1,-17,-20,3
ZYPGAgScILNUaBKXEWDdRfFMVHTJbQeCO,SAAHLHAEaDBEKHFE..EAFFdAHGREDB.MGAEHBGB..TDDFhAAAbAAC..CGHEOFAChABAZAFFPFFEAHFE.IEABhACABBDADADE.fCAHFADD...hADA......hBAA...,2,-26,-7,19
KXTHIdYLFbaJWGRCUZMPNQegSVcfEOBDA,XGGDTBFC.dEFALDHH.FEEAJAFFGEBEUEBDMCEHhAAAPHEE..eCAESDCBhAAA.fBCHhABABHAHKDHDIHCCYEADaADACADD..hACA......hAGA...,2,-32,-18,14
bgYZCSEXeMJdWRQTGKcfLOINBPFUAVaHD,HCBGDBAH....bAGDYFEE.CCAF.SHGC.hAAAEGCFMFDHdEAAQEFHhAAAKAFELBHFIDDFhABAPEBHAGIFaBBEXGGHeFED.JABA..hAEAWAFF....hACA...,1,-14,-30,16
eIbNOaJGUfHZKPVDTXMFcgSdYWABCRLQE,BCDHCCCFLAHFEHCE..eEEE..IDACODABGFCHhAAAUEDDZGBGKBCDDICCMDFGFGGF.hAAASFBFdBFA.hABAAIAC.bABAaHGA.fACD...hACA......hADA...,1,-18,-30,12
eNLAFZQUTJObRSHcVCBEfaXDKdGMYgIPW,ZCDETBCGODGD.RGAG.SDAEHBBHCGEF.BDEF.aFABDAGEdFEAhAAAMIDE..YDHDhABAIDAB.eABEhAAANIABAHCEUGGH.cAEFfFBB.KGHBhAEA......hAFA...,2,-25,-16,9
OPBeCEaMVdTDXcFfbgIUKHAGLSQRWNYJZ,SBFCQEEARFAC....NECHZEGBODHDBABBeCDA.aCAFhAAAMDAGdHDFDCCDFFDA..hABAfEADIAHCKGHFhACAAIBC.GABB..WHCE.YGAEhAAACCHC....hADA.EBCA.,2,-42,-3,39
KdOJYQHCVIabWgATUGPNDLSBfcMREZFXe,TCEGUECEGGEH.DBBALDBFBDHE.fECHRAFGZBAC.hAAAeCHDOCFFQGGGhAAACADB.aGEC.WADEhABAAICASFACMCAEFHBEKABG..YHAEhABAIAHE...hACA...,1,4,-36,40
LNUHIXGQcWeAFDRTVfOBbPMCKJagdZSYE,DBDBVCDDOFEE.BHDGMCBD.KCGG..JFADaAFFZAAF..EGEHhAAALAEDHFCHIAHHhABAGAFG...WHFAhACAADADFEHF..fACACHBASACF.hAEA.YFFC.hAHA...,2,-38,-13,25
DCKARQVeJYGgOLFdXZPcNEaITHSUBbMfW,QGGHVFEF.eBAGGDGALCGFXCDHZBDF..NHBD.IAHHhAAAHEAGBAGHfBFDhABACAEEAIEA.JGAAOAAAhAGAFDABdACHEFDAaCCB.......hAIA......hBIA...,1,-8,-9,1
dBXGSKgDMRFaVEOLJfACPNcHUeIQZWTbY,CHCC..NIBD.HCBA.eAFEQFDBZCFG.TCDBbFBC.dAHGBGHGhAAASAEEDBCEMFFBhABARBAFFHGEaCAB.OCGBhAAAfBEFAGGF..cABAIEHHXFBHhADA.....hACA...,2,-23,-3,20
IHQBePFKOMZULcVSJNYWGDgRTCAXadbEf,aDBGEFDEHBCEBHAF.FBAFKFCCZAGH.LEHB..SEEBhAAAJEEA.NCCH.GGBBhAAADEGGRGFG.AAECdBFA.fEBHhABAQBGGODABMBBE..cEAHhABA...WACECHGG.hACA...,2,-30,-4,26
YcUaebgVBENDPXZOSHMCWJFdfLQTKRAGI,GDDD..cFAGUGGCaABD.eGDEVABCBAFE.EGCDPDGFhAAA.ZEDFHADDhAAACAFAFCEFdBHG.fDADhABAQGGBKHAGAAEE..IHBC.YBAFhABA.NAIA..hADADGDD..,2,-12,-12,0
CVIXgPEeaOZdRUSWfbTFBGLMDAHKNJQcY,KFHHQECGCABA...ICCAXAEFEAHDODBCZADAdFGBRFDD.hAAASGEF.hABAfAABTCFDBGBEhADAMCABDGGHADHENEEFJAHH..YGAA.hAIA......hBAA...,2,-38,-6,32
LAdfDSWaJeZVQKHBGETCXYPFgbNMUORcI,dCDESFGEaAAF.eACDQEFHHEBEBDABEEBE.CHHD..XEEDhAAAFBGF..NGAFMIFChACAUAFAOEAH.hADAIDGFAHAEfAEGDIEEWBHBZGDEKCBG.hABA......hADA...,1,-12,-21,9
QJVHLdaGKFUAfSIODbEcMRPTWgXYCBeZN,SBFFDBIBEFBB.RDCD...TGEF..XFABCDECeACHZDGHhAAAQFEAJAEGHECHhABAdAAHKCAFAEIB..IHCEhABA.cAGDMIAEWBEABBDFNADD.aGGFhCAA......hCBA...,2,-27,-14,13
eGUDPYgARaJZNbBKOCMdSHWEFTcVXfQIL,REAHJAAAZABABAHCKEDC....CDGE.dCEGHGCAEFGB.FAEA....VGDAhADAQGGC.hAEALCAEeFBADIBEPAHDhAAAAFACaDCB..OCHFSEGA..hACA......hADA...,1,-21,-36,15
ITeAKfYGVdUZXSgNHaFbBMQEDLCcPJWRO,KECAGDBHUEGGSHFEHGDE.FADEMBCEEBBFLHBE.hAAACFGA.cGBC.JDADhABARBGB..IAAAhACAAHHHVCDA.dAGF..........hADA......hCAA...,2,-28,-18,10
dabPgDGAXTYWLEFZOIeNCMQSKBJfVHcRU,XGDBTGFB.LHACFABBZEAF..eDDBMEECKDGFBGFH.JDAFhAAA.HBBGUAFDdCGHPEHDhAAADFFAAACC..EAGDIHDDhADACBAC.SBDBfHGF..hABA......hAEA...,2,-21,-21,0
cKHYXOLIMWNfUbFGJgVRdATaBEDePQCSZ,aBGFEDGCDFFF..QFFECEEF.SBBAKADEHFBHXAGFhAAAIGDF..MAEGhAAAfHFHUDAEbDFEFBBFhABA.JCAF....gDDDdCEFADDHBEHAhACA......hBAA...,1,-17,-24,7
HOLXcMGFdEaeBfAWIYQNbDJCZUSVgKRPT,..IAEEQFGBDCGD.JADEZCAGUBGE..SHBAhAAAKFDERBACHDAGXFFB.hAAAMEEBdHADEGCGBCHCWHFAhABANEIC..CFCEgABF...hACAOHEC.cGABhABAFDDA.fAGF,2,-20,-15,5
CHABbgQdSYeVaGWcDIKNTXUMPOELfJZRF,BFGBQGDESGDCeDFDGEBCDACGKDCD.TACG.UAFBhAAAMFABECACJBEA.FAAFCEACABAChABA.dGHA.aDDFIDFFhAFANBIG...PCHDfGAE.hAGA......hAHA...,2,-50,11,61
MGHNLXKVTeJZYbUfcSaBdRgCPFIOQAWDE,DGBGECBCGCEEHAGFLEDBKDGC.eADGZEBCUGBGSCAFBAGHdFHGhAAACHFFFCFHOACC.hAAAAABD.MEIH.NIAFTCBAhABA...bFGDfGFCaFAH.hACA......hAFA...,1,-6,-27,21
ECDHSYdIRQPJgLGZcbWVKNfXOTaMeABUF,UCFFFBBCCHHH.DAFCHAEB.dDBBREFH..QCBEJEDG.LGBEhAAAGGAFZDGH..WEAFhABANCAC...OACEhACAMBIHAFGHBHBA.EFHF...SDDHhADAYABC....hAIA...,2,-26,-24,2
PQbTMHRFGfgYXCdZUBSVDcJIEeNAaLWKO,aFHFLAFA.OCCFQDDE.MEBHFDAFGEGA.hAAAgGDFYCAACGGHhABAUAACBECGSHAEhADAcAGD.ICEFEGEFAEGBKAEC.PABEhAHA......hBAA...,2,-26,-16,10
PNWJBLZVRSGOIUHFcdQabYCeTKgAXfEMD,XFEFEDFADCBH......NHCHBAHFZFAGVAEGGEBFUEGEHFGDhAAAdEADaBBCCGAH.KDEEABBCMICAhABA..WAAEhAEALCCE.OADGIHDF.FHAE.hACA......hBAA...,1,-18,-21,3
LgTcYHeQUCVfKAbRIDOMaNPJBGdSXZFWE,RBEBDBCGOABBMFDD....aFECJFFE.BACBSBFHZEAE.EGADhAAALHBA.TBGChAAAcBBH.eEAChABACHHGKEEFbCGD..NAEH.dGHG.WACE...hBAA......hBEA...,2,-32,-15,17
eNAIUXCbGSEVYFLMPgdWKfcaRDTOJZHBQ,XEEHCDFBGBBB..EFFCFBFB.LFAD.MIFCdGAEfAHEhAAAaECA.TEBFhABAOBBEHGCABHDENEIEADAFhACAIBHC.UDGGSDEDPAAAWAEChAIAKAFBDGHF...hBAA...,2,-26,-5,21
bPIZHQSUFDRXfKNEAVWGeYgCMdTcJBLaO,GADDeGAACFHA.MHCCdAAB...JEFHaDBHOBCH..ICDBhADAZEAGSCGEDFFAXAFBhAEAKAACAAHG...VGEChAIAgDGBBDFCbBGDQGAA.hBBA..FHGE...hBDA...,1,-10,-25,15
EKAUGNdOZTPCIbRQFefDMLcSBVaHJYWXg,UDDCdFCHOHFAZFCA..CCAD.RAAEFAEHDAIH.LDFEBAFA..HAAChAAAJDAE....XAGHhAAAKGGEAAEGGBGG.hACA.TGADIHADeFFCMIEC.SEBChABA...hADA...,2,-30,-26,4
TDUVNPMdIEFbYfCeLBJOKXgGZSHQAaWRc,RAGFTCDGDCBB..UCDE..PAAGdGDDFEGC....YBFGhAEACCCGBAFA.KHGEGEAFhAAAHDBBAEFG.aEGD.cGDGhAFAMIDE..EHGEfGBGLABG..hAGA......hAHA...,2,-30,-23,7
YfaFMATKZCOXELJeIBWGUgbPSdDQVcRNH,TEACKCEFCCBF...OEDFEHGGLEFA..JBCHBAHGUFGChAAA..bADGSGCHhABADBAG.QAEAhACAcFAH.RAGDNIEBfHDB.MCFGhAAAADAD.eEAG.IDGHhABAgCEG,1,-13,-43,30
fRcBAHbQYgZdGCIFaKXELOTUJNDeWMSPV,QFCGZCFBdDDCCHFH.FCABKCAALDEA.OFAHTAEBUFFGhAAADAIH.MBIF.SBFChABAVGAE.fDBAhACABABEAEHF.HABC......hAEA..gEAChAAA.IHHD,1,-13,-41,28
VWOBaCbQUFPJTIHSgdZXceDKGLRfAYMEN,EEEGVCBFBBGA..aFEBCCCB..UBEEFADF....JAFDHFGDdGGDZFAAhAAAXCAC.DAGChAAAKHAGRFACAIDAMCHF.OAHFhABA..PCHF.TGEFSCAFhACAeABA..fECBhABA,1,-16,-32,16
OQYRSZcdVbBeIKLHXEWFGCJAgUDaMNTPf,DBCAMCCF..TDFFOBAHRECF.ZGEA.dCGGBCCAKHBC.HAFE.XDAGhAAAEFEGFBEHCFACAABDUGGChACA..aDDCfFAHhADASAAB........hACA......hADA...,1,-21,-35,14
dgHTUPWcQCNROfGEMFYKeVDSJLaBZAXbI,XDCCdBBHHEBAUBGH....cGEHQEGD.CDADOACAhAAAEBAAMDGDKDEADFDAhAAAJHBCaBGC.BGHHAIHC.hABAIAHB.TGAGWCBA.RADHFDHHYFFFhAGAeDAHSABEhAFA.,1,-17,-19,2
ZBMfPdEJYQTHaVFDcgWICLSbeOAGXRNKU,REEDKEGCUBGDBBCC..MAFCdGCDEBEA..QDABHGFCFEAHDACChAAA....cBDGhAAAIEDD.LAHHhABASACFeBBDAEDDXDGDfCFAPHBEhABA....hAEA...,2,-37,-22,15
FWROKdLeNVPaDAIHYgbSTQGEfBUcMJZCX,HFFA..bDFEQEAHEFBGBDCGMGFEZCBAXDGB.FHAChAAAOBDGdBABLCEBhABANHCBaBBC.AIFCIHHChACA.SBGGTEDAfGAGhAAAJADE.CDAB.KGED..eAFEhABA.DDDG,1,0,-11,11
ZMDcaHeLCQdKUfbRESGFAINTWVXPJgOBY,TGBGVABA...JGFGBHEE.MGDADCCGHDEDCGAD.QEAChAAAdDDCKAFCUCFDRCAGSAFGhABAAIGA.IEHGhACANDIG.XGDD.OABEcFBHhAAAaAHFeBAD...hAEA...,1,-10,-32,22
YGCdDBLAXTQHJEFWbMVcSORUKgPIafZNe,TFFCHCADEFFG.FFCEMCBC..SAHFUCGFKEAG..IEEBhAAAfCEF.NIBFGACBhAAACAHABAEBAGBDJDHHbFCDhABAOGAC.RGEGaABGeFHHDEEG..XCAChACA....hADA...,2,-28,11,39
JKYfTPIFEdAHLXOMSNWgaeUQVBbcRGDZC,LDGHMIDE.SBFA..NCCGaAAFUABCBEEHRDBBGDEEhAAACAEC.KAEA.TGAHhAEAFEHDADACOHBG.hAGAeAFH.....bAGDDGIHZGFC.fACEhADAIDDD.dEDChAIA...,1,-18,-28,10
EHcGDNBdXgVLWUTPCZSfJIYKQFbeMaROA,EHDEHCGFGAGABBBGdADG..XEEELDFFUEBACHGASGBEhAAAICAB.QAGHhABAFAAAMHFARCDAAAFHcGAChACADIAG...NEEC.WEAD.....hAGA......hAIA...,1,-13,-21,8
LQeAXDfOZEVRGMgPIbJScFBCYHadTNKWU,DBEHOGBA.ZBCHVCADRBFH.GDFA..MABA..IGCChAAAbFGB..JHDGSABAhABABBEGCHAGaBBHNAIAKHAAhACA.UAFCeBHHACCGEHDA...cDDDhAEA...FHGE.hAAA...,1,-10,-30,20
dFYgJEKTLRefMADIbPNCHScGQXWaZBOVU,DFGD..bEFGCFCGHBFBGABE..QADBXFAFZDDBBEHHOADChAAAVAAB.dGGDFDDDJAHFhABAKEAH.LHAAhAAAeHEGADAGNIAFSHGA..aCGHYFEBhACA.EBHB...hADA...,2,-6,-3,3
gMZFALcBTEfUCOQaKbSHNGYRXdIDWJePV,LDFABFHBEBBDUGFGOAGF.KFBDHFCDGAADRDEGdBGG..DEACeCADhAAA..PEDHhAAAMAFCABDCTGGACABB.aFGGhABASBDA..NIBHICDDhADA......hAEA...,2,-22,-19,3
dAEZPJLXbeTGRaYFDNUfcgCIBSHOQVWKM,ZEEDLCCEeADGRDCFFDEH.DDHFUGGD....fEBAhAAACBAABBHFOFADQGEEhABAKCBB.dAGCAIEE.EDAH.JABEhAFATEGEaGHH..cFBESAAC.hAIA......hBAA...,2,-32,-20,12
IETJSHNdYFOcBDeMGAQVXKPgbfUWCZaRL,XDCHKCFE..bCAEUGDB.ZBBGaGGFLCHF.TCEChAAAHEAANABH.FEFCBHGEhABAeHBEAHBGQEAEhACA.PAEAfHEDCAHH.IAGAhAAASGGE..dBCFhAIA...,1,-7,-24,17
HFAEMGIaXWCZdfLDVbOQJRNYceKgUPTSB,GCEH.aHBAXBDHZEBCLEHHVAFAQGDDRAAF.hAAA.cFFEKFABUFGDhAAASADABBCAAFECEDAGhABAMCCECCHHDIAG...ODFCNDAG...hACAeABC....hAFA...,1,-6,-18,12
ZUDbJBPYOKCSRfMNHVdTGQgEaLXAWcFIe,FGFCeDAAUCGCDGCEBABD..OCCACGHG.RGAC.MCFCHDBEdFFAQAABhABA.EAGAhADAXADCADFA.IDEEhAAAZEFA.PFAHKEADNIDD.....hAEA......hAFA...,1,-10,-44,34
APJeITEVKbfXLCdQOFWYBcHMDGZgRSNaU,JABETCFG..EDFBKGBA....XECEdAEGQFEBhAAA.FBBFBGHDMIBEDFFHhAAAgDAENCEHADCD.hABAeAFCIDHH.fAFBCGHAWDDF.hABA..YHAChAHA...,2,-56,-12,44
eSAUFYBbDQZLXEgHJMfWcdOGNKRVaIPCT,FDAABECDDAECLBAC.EBEEJDFA..MHCG..fHABhAAA.dDDEGCCBhAAARFFC.IEFChABACBFCSCGEAIEGYAHBQABEXGGG.hABAHEAB.WADE.hAHAcCAG.,2,-35,-15,20
HgAFKWfZcJIdNUBDMeabQVGXLEYCPOSRT,KACCZCBAJBGFdCECUFDE..MBBE..eFAHaHGE.QGGAhAAAGFAHEEFBCBBG..SAGFhABATGEC.ACIHFDGFhAFAfHAB.NAED.BEBEDCAF.XCBAhAIA..YDHBhAAAOHBC..,2,-27,-15,12
CZfWYTcIdMHJVaNPEORQFSBKUgXeGALDb,DFBECDFHZGCG....fGFGTBCBdDACMACCHEGF..aBBGEFBHhAAARCEC.FAHBBHCB.UGAGhAAAeCEFAEEHLEHFhABA..WABCIBECNIEH.PAHFhAGASGADKCCF...hAHA...,2,-23,-14,9
ZHOMbLRQfVJCXUDIANSgaTeWFcdGYPKEB,SAHHTBEF.FEBFdGGHGGCFKFEHBDAFZAAFHEEAOBBAMAFBhACAREAB.QGGGhADA.fGAAhAEACEDADIEEACIBgDGGaCCFeAGF.....YHAGhAAAEDGA....hABA.bAGB.,1,19,-38,57
YVMeCQIaOFKAUHgLBRDEXPJTfcbWZSGNd,HGFABHBDDGAGXDGD..TDAH..cDDHZAAGSEHHhAAAdFCGMAABeCEChABACAFCQEFFIBBCOCDAhABAADBBLAFEEGDAfCCEWEAD.NIDFaAHFhACAUGDG....hACA...,1,-6,-17,11
TFXbKQAVdHIRZgfUMGYWeJCSaLPDEBcON,VBFGdBFDHGEA.ZBBFUACDMCIDGEDC.eFHFJDDCCAACLFBHhAAADDBF.BDCGOGBGhACAFDFHKBAFAIHA..IHAEhADAfDHA.SAFCEADF..hABA......hADA...,1,-17,-25,8
bZcPAEROHfaXSUYBMICTdeGLVQgWNDJKF,EAABRAEAHDCA..XCGASHEEBAGCMFIFCHCE.dACALDDBhABAVFAG.QGFDhACA.NDAE.DIAGKDFFFDHBhAAAZCBDAGGGaAHDIBECeBAH......hADA......hAEA...,2,-21,-8,13
USMLWXPFNKARgaVcGbODTBJdIfCQEHYZe,aAAFGCEA.DGGBJDCFdAAD..CAED.QGBCHEFAZFAH.SDCChABAMFEBLAHDXAEAhADAFGHDADDAREGD..cGDAhAEA.OAHFBCAD..fGCGhACA......hADA...,2,-31,-4,27
LaPFHSXCUGEIRdZTWQDBbYMJNOAVKcgfe,KAFA..gEGBLADHaGGCHDDFCGDF.UEAFGCBAEBCAdBAEZFEF.hAAA.QDFFhABABHDDMAHBOFAFABGDfGFDhAAA.FGADSCHBRBEBDCIH.YCADhACANACH....hAFA...,2,-22,7,29
SWRAXPUdYIcCgMTJKBVDOfbZaeGEHQFLN,XGGGdCAA..IDFCCHBC.MFHBTAFCBECGDFCGOHCEhAAAZBDFeFDA.EABBFFFFhABALCAHSAFFhACAAHDCPCGD..YBHF.cBBFhADA.KADB.fGBDhAHA,2,-32,-30,2
dNZHUacTFDJQCeBXKLPVfbMROGIWSYgEA,dDDFZAABUCCCaEAD.FFBDQGEH.BAEGLBFG.VFEHhAAAfBBF.hADAMFIHOAFAGAFChAAAIDGEYHACAEAG.NBAGHECGDDIDCHHD.eDGHhABA......hACA...,1,-7,-31,24
SILQTWdXFAOHDgNKCbEUPGRVZaJYceMfB,DGGFKEEEECDEGABF.RCEEZCACaDAG....JFCHeAFGBBGALEEGhAAA.QEAChABAdAAGAHECHFGFCHAGUGCB.hACA.PEAD........hADA....YFHBhACA.,1,-18,-35,17
gRcAdaIEXKbWSOZFMQCJPVHefTLYDBNUG,aFCGXDEF.KAEHSCDA.ZAEGMCBDCDGF.JACFHFEEhAAAeGFGTGAFDEAHBGBAhAAAUBAGRDGF.AEHAEGHF..hABAOAHDFEAB..PHCCfECENACF.hAIAcGEC...hBDA...,1,-7,-28,21
dJcOGfIZWPYXBAMDLFeHSQVURgCaNbTKE,DDCDFFDBeBECQGBAUABA.RFEE...CHAB.aEEG....bFGFTABDhAAA.dAHCODEAhAAAIAFFZEEHPEBFhAEABEAFAIFCMEID.SBDHNICH.EBABhABA......hADA...,2,-24,-23,1
KJAQTRPcBIHeEZOaNCSfUdDWFVYGgbMLX,RDDDBDCAeDFBOEGD..CAHBUCAFDAFCFDFFGBEH..MBBHhAAAKHBEAFHFQGCGhABA..PHECIADEhACAZABESFBEdBFH..WCDH.hAAA..YFFFhAIALEHB..,1,-13,-43,30
RedKISAVUQHPNELFMfDJXaBYTGZbOgCWc,UGCHQFGAHCCAEAFBFFCEDEAE..aAAGBEEBGDGEOFADCADD.hAEARABB.dCBCKADHAHAB...hAGAVAGHPFFH.MBIBhAHAXGED.......YAAFhABA...hAIA...,1,-14,-24,10
BTZAFYXOSdIMDVGbagHREJKUNLQcCWfPe,FBHHOEEHdCABDBEEGADD...aCDCHFFAEABH.KGCHLAADhADAQDDECHDD..PHFGhAEAeABABECGAFFG.SHFGhAAAMCHFgGACJFAF.NCICfECGhAGA...hABA...,2,-31,1,32
gJVDWQTGAeOCBFNUKHZfRLPMXISYEdabc,CDFBFFAAKBEEZAAB.REED.LEEF..XAEESGAD.EECFhAAAaGHD...bCCGgABBhADA.VFFEhAEADIEGQDGDABBB.BHBANIDHfBHAhAFAIBHA...hAAA...,1,-23,-37,14
HYZJUMFgEBLVAOfXdWRCcPaDTIbQGSeNK,XEFFdFEDCCGA..aDDADBFA...TBCGQBADGEDASBDEhAAAeEBDKHFCZAADhAAAJEHDUEAFMAEAFCEEBHBBhABAAAIBODHD..fHEH.hADA..WAHB..hACA...,1,-4,-41,37
XFDSdAUOIagWJNKMCRbTcQZHPBYeVGLEf,UFEEOBFA..aFCDJDFF..KBGACFAA.RDBA.....TFCAhAAAQABBZBACBDBCeAFChAAALHEEEGGE.fCFBhABADIBAAIEA.IHACNCAE.MADGhACAcCDF....hACAYCHB.,1,-25,-26,1
GUgEJLTMCeFRbPNOcIABYKVHQfZaDWSdX,KAHFQGEFZEGDDDED.dBFFGBBDEACC.LFDACECHREFG....hAAAPAADOBFDADGCBFAAhAAAHFBBaGAB.SDAEhABAUCCH..JHAGMIFE.eABC.hACA......hAFA...,1,-6,-23,17
NFEGWgQfLKcAaJUXTZDHdCRIOYePSMVbB,UDFFXBBFZEAHDIDGdDFH..REBB...OBBEeAEHMFFEBAAD.EGDChAAA..GFCBQGGChABAKGHFABIH.aAGFJAGBCDAF.hACA....IDDBSDDD.NIBB.hADAFADA.....hAEA...,2,-37,-10,27
LWNSTQfOMRHIgZbeVCGPDdYXKcFJBAUEa,aCGHLEDG.SCDATFDA.QEACMAIBHDCEIHAAhAAAZAAHVADA.CGAHDACBhADAXABDFGGGBHCCEADEfHEDhABAOHDE.bCGB.PAFG.hAGAKGHDAFFA.WGDE..hBAA...,1,-4,-18,14
UYZNKWJHTLBCGQFcIeaVEdDROMXPbAfSg,SDGAUEBDZCDFKBAHHAEG.BEABCBHA.QGDBFGEB.IGHGhAAAeHAA.aCCBdAFBhAAADIBEMDAB..XDDFhABAAIGE.fFAEgGGEWFFBhACAJABA......hADA...,1,-29,-33,4
aINFLTGHfgXWDYCABcJUOSMEKQRVedbZP,JFBGSAEF.EACBKFEA.QAABRFCEdGGBZDEC...ICCGhABAFHBGTBFHHAFGXDADhAAADAEBAHDHBFACOBABhABAMDEAeAHB.aGABNEHG....fDABhADA...hADA...,2,-30,-7,23
JQMdNgIYWEVXAKaDbSOfLGPZUcCTHFBeR,DHDAODCGGFEHZGFE.UAFGCEFF.HCBFBBBDRAAC...MEBH.dFCDhAAANIDF....IDGChAAAEAHBAHDCKADC.SBDGhABAPBDD.FCHHQFBB.WBHBhABAaFGG.....hACA...,1,-11,-35,24
GgBacOHXfYVSeKMQJWZbLNEURFAIPTDdC,TABFDCBECGCF..GDBDBFBEOFEFHCFC..XAEHVBEESAAFhADAKFFE.MIAEhAEAQGEH.hAFAJAAGbDEAEAGCFGGEABDAIHHE.PEAHhAAAdDDGaAGA....hBEA...,2,-15,-11,4
FGKRPDOMQeUWAIZHLSJfCNcbXBgaTdYVE,ZCBFLABCJHDG.CCHF......NEHC.bDDEBBCB..aCAHTFEDhAAAdAGB..EBHBKDDHhAFARFAB.OFBH.MDIFhAGAUBDEACGH.HEGFSFCBfABH.hAHA......hAIA...,1,-14,-39,25
cNUIMCeRXWZEDKGAbdgPfQFBVTaSHYJLO,dGEF..gBDAQCAFFAGCTGBDaGEA.SBFBhAAAHFAEJAAEODFAUDDFCAHCRDGH.hAAAXEAGEEEGDEBGAIHCfABHhABABAEFLHCCIHHGMEIH..hAIA......hBDA...,1,-3,-9,6
EaSUHFRPDVWTMZBOYNKIXbcLeQfAdGgCJ,GFEHJEHH.EHDEaEBBUABH.HDDGFADGDDCE..TBGBBFFB.hAAANCCG.KBHD..IAFChAAA..bFDDeHAEhACAACBB.dEAGCGCD.SBDH...hABA.PAFD.MCABhACA..,1,-6,-46,40
cKCJPILMQZUDYeHRfBTEVGXaSgdNFWAbO,OAGBKEBCCCAC...JEBDLFBAZEFD.UAFCDBDD.HFFFBBBAEABGhAAAGCDA.SHAGhAAAgDFEFCHFADHE.hADA...PHBAMAFF....eDAFhABAfCDG..hAEA...,1,-28,-32,4
ecbOUYIMgfDHKXZdACGPQLNRSWVFEJaBT,CDCDQDAGLAEGRFEFSAEA.FDFBEDAHBFCCeFCHOHDAhAAAUCGBMCBGDACFKHAE.hAAAZFGHAGAF.GAGG.hABA..PCDF.NDIE.WDDB.aGHD.hABA......hADA...,2,-27,-13,14
KZPDYIAgcLUReEbdQOWGHFafVTSNMCBJX,LAACUFCBECDD.dBFF.QEDHOEAHHDFDaCBF...fBFHhAAATGFH.SCABhABAMDIFBHEGJABEXBDDhAEAKHFEDCCHAIHAgGAC.RCFF.eDHHhAFA.WHAA..hAGA...,1,-6,-18,12
OJAabHFENeUZDTMBdPLXfCWSYVKQGgRIc,HCCDFEBCEAFCeAFF.DGDHBDECLCABCGHE.SEFEKBBCGGCFhAAARFFHOEEBAEFB.NECC.hAAAUADA.MIAAPAHHhABAXBGE..WBBEQDGDhABAIHHBaHFE....hACA...,1,0,-27,27
LFOMCQgGNZWVAdSUeXHYBaIDJbcEfKTPR,SCAAeAHFHCAFBGBEDIDE.JBBAEGCGKEGBREACLABG.OEGDhAAAQFDGGAEChACANIDDZAFDAGFHdAHA.XGAGhADAaDDC..cADFfEDB..hAGA......hBAA...,1,-11,-18,7
WEdVDHMcaUSJbYeIBfZKNgAXGLCPQRTFO,XBGDGDFCCHEGRFBDFCBA....EFEBdGCGDDBBMBEF.UFEBJADH.hAAAeDAGBABAZFADKAFFAEABLACEhAAA..hABAQAGCOFHH.WEAD....hABA.cCCCSDFGhAGAIHHA.,1,-8,-31,23
GbOFALcTXYCRfUWIBdHDEZKgSMPJNeaQV,LHEEXDEERAGFUEAE.BDDCDEBDKBCHMDGB....NIAF.QACEhAAA.bGAAhABAFADA.ACAHTFCEhAAA.CCEG.IFEFEGGFSFHBJAFBaCAG.OFFBhABA.fCBEhACA.,1,-21,-33,12
bSPEHXVOgGZaKAUYfNQCTeDBWcLIMdJRF,UCGB..NDHACAGADGFA.BADFLFCDdAAE.FGEB..SBDAhACAHACGXCDGOGBGhAFAGAAGKHFG.AIGAfGAEhAAATCBF.WEFBIDEF.MIBAhAGA..bBFEEAHF.hACA...,2,-33,-22,11
NZTdLBYRaJcEDSVfAOMUgeIFHKGCPWbQX,OGBEUFECeDFAHEEDKABFCDCG......PAAAQEBFhAAAZBEGLAHBBCECRGAGaAGChACAEEGESGHHhAEAAGIF..ICCGWBDC.NIEHdADBYFAEhAFAcEGEfGGAhAGA...,2,-19,-18,1
YLfPVaMIEcOCTWXAFDeUJRZbGQdKSBHgN,DHDAJBCDZFAHQAEB.dCBBKAHBBEDBHEEA....NAAALDFEhABAfAAHaGFFEGGFhAAA...CFCAXBEGhADAAHHCeFAG...RCFASAEEYFFCPHAEhACAMFIHIHEDhAHA..,2,-32,-14,18
VAXdDbCTKOgWBNHMQGaPEYfFJURIZecLS,dHDDDEIDCGGDOGDG.BECDMABBGAFE..EFEBFBBHRCBFeBHHhAAASGHH.AAEA.TFAHhACAKHAA..NBAE.QAEEhADA.PHBEfDECIDFFhAEALAHB..hAAA...,2,-35,-20,15
LKPEGIOXNMAQfHVdaSRcFZYCgTJbUWDeB,QAAGHABHdGACSEDERFFHFGBE.ZGDECCFE...TEBCJAHBUDBBhACADDGCLAEAhAAA.EDAHIEHBhADAOEGFMIFCfAEF.aFEB...cCDFhAEA....hAHA...,2,-34,-3,31
ZOYDKAIegWCQEHUfBSXbRTVdNcJPGMaLF,eBCCCBDHHGDGUFGGBAHC..SEEBRAACdGBE..JEEEMAEGFAEA.hAAAOBFE.KFDBIHHEhABAQDAEECEA.hADAfAAF.TGBGcEGE.aCCHhBIA..LDDChAAADDGC.AAIF..,2,-21,-21,0
aPSJbEgcNQLYfVFXBOUHMZGdeDAKTRWIC,KFGDRCACCDGE...SADEEECA...NCEE.LHAA.VAFAhAAABEHHOEGBUCFGHBBBhAAAMACCZFEHGGADhABADEIHACECIAGA.aCAHbABC....hAIA......hBAA...,2,-22,-20,2
JafRFNQCTXILKSUAeBGDOWMYVgEcPZbdH,GDBEODCG.MDED..VAFBECABZAEAdACHHECCJDHF.RGEEQDAGhAAACBCG.IHAHhABASHGE.AIDGBGAGhAAADDIF..WBBG..YFFDhABAPDGD......hACA...,2,-33,-6,27
KTLVBNAIgSCaRMbQGUZeOWJYDfXcdPHEF,SDBDaFGD.REEA.bAFEGBBH.ZBGH.OGAEJFDGDIEE.hAAAXEAFdGGDEADE.FCDFhAAAKDECLABHBFAGNIBFABAFhABAIDHH.gGAAMAIH.eHCChADA.fCFHhAEA..,2,-13,-11,2
FMZdAOSNGRIJCEbVWeTUHcLXPgaYDBKQf,SCGGGDFERCDBCBDC.EBAH....VDAGTEGGHAGDLECDhAAA.XEDDhABAgGCCaGADDBFBBABDKAFChACAfHGFMICEAHHEIBDEJFAFWACEeDAChADA......hAEA...,2,-11,-10,1
QNHFgEXUDYGOedRIMaLJbKTPBfcCSVZWA,HBAFFGFBEGBHDBFB.OABAeBCC..dAAEMIAALBGBKGEB.TECAhACABHHBCFAH.ZDCDAHHB.QEGChAAA.XEEGhAFAYEADIAHGJCEFfGDChADA..SCHBhAGANCIC..,1,-15,-25,10
WNJfEMFAYQBVGUHKLacSPTOegZdXbIRCD,QBFCVECB.UEGGKGGFLCEA.aBBFSHDGhAAA.OEDDgAEBhAAAdEBDIABGhADADHACWCAHNEAGECCE.AHBGBHHAcAGFeFFDZFEB..hAEA......hAFA...,1,-18,-21,3
acCeEHMdWfYFBZVSRTIJPGLAbQUNOKDXg,QGGAOCHBDFBA.aFFG..CDEFHACCdDCA....fAGDhAAAFCACBEFAZGBARBEHIBAChABAPAFG.ADGBNDACXGGEhAAAeHCE..MCID.WFAHSCCHhABA.....hACA...,1,-18,-27,9
cMgRfPDXWUAaQGCbFKeENBOVJdYHZSLTI,aCHDCEAFKCDD..eDEHBHHEOCBD.dACDHEBBLGFATGEDMIBChAAARBFA.DGBGUBACAGGAQAFDhABAGEEDEACGNHAB.hADA....YHAAIDDG...hAAA......hABA...,1,-9,-25,16
UEIFceGMOWVZHLgXCabDBAYJRQPdKfNST,JFBEQFDA.dBBCKBFG.SBABEAFBFECBeADFGEEAMAAChAGAOHBEZFGFLHDGhAHACCHHDDDE.BBHGAFAH..hAIARACC....NEHC....IAHFhAAA......hABA...,2,-37,-10,27
VOaREMHAfcDWFSXQLIJYUTGCPdBbeKgNZ,DFBASAAELBAA..JHEAUDEDGAEGCAHHBCHBKDBFZEEC.OHBChADAaFHH..MFFHhAAAADHD....fBCChAEAFFAHIHDGTAGAdAED.....hABAeGAC....hAGA...,2,-37,-26,11
AOTMeQLUJaVDZENXbSgcPdIfYGCRHKWFB,TCAHMFFFLDCG.UAEGaHDGDBHHEGGC...XEGBhAAA.SAEEhABAcBGAICAAfDDGhACACEGCKABEFBFHBGDBAIHAOEBDJHAA.....hAAA......hAHA...,1,-20,-29,9
fIVOAdYLbCJDaWFNgHRMUGPTKZeSBEQcX,dFBFLHAGCBEC.aCCBFCBGHBEERFFC.GEEBKDEG.ZABEBHHEEFADXCGAhAAA.IGHEhABAAHCFJABE..DHDCWHEGhACA..MIEE.UAFCeDDF.SDABhADA...hAAA...,2,-50,16,66
XKCLJOHRPQgNIdDSYTZMbGBFceVEWfaAU,XFGCCAHALHCCHCCERCFD...QAAD.IBHHhAAADBCHSEACTAEFMIEEhACABBDEFFCGeCFHEGGGhAAAWHAG.ADHEJDAHPFAFdECH...YADChABA....hACA...,1,14,-45,59
ASCLWNPbfTXcJgUDRYOMaEGdKZeQIFBHV,SBFCLCHF..NEBF...bDAAXAACJGCG..DAGGRFDHOBDEhABAaACGGEEFdFFAKADChACAZCFEeHECFGBDBAGDhAHAAABBCBDE...fHGFTFAC....hAIA......hBDA...,1,-9,-20,11
fGEWCbYUcMReZOXgLKNABSJaVTIFDHdPQ,SFBHVAAG.FDHHHCDF.QEADGDDECAFFUCACRGAEeGDEhAAAOAHFXDFBKGFEAHIBhAAAJAEA.aHECDBGDfGGBhADAEADD..WHCA.....hAHA......hAIA...,2,-27,-3,24
XTFgPDYSRIUANZaQdLMWcfKHeBCGbJOEV,aEGGdDCELBAC.MGDGfCGBHCGBCGADGAEEJEDB.ODADhAAAXGAE.FCAEhAAADIAESHFChABAIHHEAIDCNACHZFFC.cEBGBEEG...EBEB.hABA......hACA...,1,-13,-18,5
XHTVcgbGPFJfMLWdaSDZUBAEQKNCYOIRe,EGBGKHFGCDAE..OGDGRBAE.eCCEHFBF..VDAE..gEEGhAAAPADC.FBGBMIDEhAAALEHFaHACZAGHAAFD.hABANFEH.ICEF..cABG..hABA......hAIA...,1,-12,-29,17
AdRZWCFUSaJHTBXgDQVIbYKPfOcGNLEeM,ZABHCGAGFGDDaEBG..HDFBBDAFDDCE..VFFF..IFCBhAAAKCHH.OACEGGAFEFHFhABAAFEBRAFD..UAFASAADhADAJCAB.XDFG....hAEA......hAFA...,1,-28,-30,2
MeXgWSYHcETaJNOPGCdVbZfKLRQFUADIB,DAIBMCBCeDEH..XGEFSBAHHEBDEGFGJABE..OFCHhAAAGDDBdDGF.VACGhABAfAFEKAGH.LAADhAGAFHECAFAABGAGYAHBcCCHNEIACHGC..hAHA......hBEA...,1,-13,-15,2
gOXMbGBQKJCeTUSaLfDYHIcVdZNPEAWRF,RGBGFHAAODEFMAAEGBFGBCBC..KAGFJEAC..eDDDUBCHLDGHhAAADGGD.HABC.hAEAIHHAdEHENEFGAAIB.XEABhABA.CHAG.SAFC.fDDEhBAA..hBBA...,1,-17,-36,19
bFeCDEgPVQdYJMHZARXNOTWLSKBcGIaUf,XFBCTFDH.LBECBCCBGDAC.aHDCUGFA.bAABFCGChAAADEEEEAEB..PCCHhADAdGGEMBAB.AHAFNEDBSGCAhAEAKAGA........hAFA......hAGA...,2,-31,-15,16
AgZYLMJIXPSUHVEFWeTKfQORGNcDaCdBb,ZEBBMGDEJADH..XCDDUEFH..HBAHEEHDFEAH..TGDEhAAAKCHBOADGGAFGDBCDhAAACAHABGGGAABALHAGhAHASEADeDBBRGFCaHAC..dDFA....hAIA......hBAA...,2,-19,-9,10
IJSFDHRACGWcYNBKaOfPUdLeZVbQTMEgX,CBHCGCBE......YGFEBADGaHDCOBCFfAGEhAAAUDACLACEhAAAZEFDQEDAEEDH.IABChAEASGBGDBIFAHHDNIAFKCEHdFAE..eAEH.hABA......hAGA...,2,-31,-10,21
ZTDfYFJgabQUONcISMBPWCHVedXEGKALR,ZFAATEEFDAAAFGFC..JBGH..aBFEQBCG.OHAEhAAAIEHFBFBGCBDGHDAChADAdEDGEGGDAEEH.LBABhABA.fAHEYDFE.....hAEA......hAFA...,2,-44,-14,30
fPAWHGEQRJIcKTDOLeXVaSbUMgYdNFCZB,GDEDQGEHJFHB.KCCBDCFALBAD.eEDCXDAB.hAAAaAAGbGAE.MAFAdGBBCHFGhADAfCFBAAEH.hAFAWBFEEFDGIAGC.OBBESGGEhABA...gEAAhACA,2,-36,-3,33
VaNTCfJOFBEYDXScLeZbKdMIAQUPRgWHG,QBBFUGCARAEAHDCGGDEB..VBAGNEDG..CAFE.JDFCFBGEBAAChACADBAH...SEAFhADALFHDbDAHdGHGAAIFhAEA..PAEHaGFDOFADEFFB....hAFA......hAHA...,1,-10,-14,4
CRZVINQeBUJbHSfXPdGTKAWLaFEDgOMcY,aAFFDBCAOBHB..MBCDCFBG.ZDFE.VEADQECF.hAAABAADJFHBSGDEhABA.XBDDhACAdGGBKAFBAFGGFHCGECAC.gGDAYAHD.ICDChABA...hADAeFAD.,1,-13,-45,32
RDefVKaQCXTHIJEgbUSGOcZLAMdFNPYBW,dHABFHGE.....NFCDBCCDDAGBVFDB.KAADaAFG...QCGGhAAACEBCHDEA.EGGFUFAHhABAGADCOBCCLBAHhABAMAIF...PGDA..WCBGhACA...fADBhAFAIACH,1,-31,-38,7
CZWFfBMdIATgSYceVbNGKOHLJREUaPQXD,SBFBeBGB..bBDFKDGBLFAARECGUFGH.aFFH..QDAFhAAADFEDZBADFHAEfHAHhABAMIFGACDD.TBCEhACA..YAHH.NABB.OAHFhADAJCFHEGGEPHCC.XFAGhAEA,1,-9,-13,4
YgZNQaIcfHCVJbOMeFGPWBKRAUdSXTLED,dHEDSEBELBDAEABFDEBE.ZDFA..NDIG.QFFD.hAAAaHBCICFA.hAAAfFECCAHDJFAAMADGhABAFFBD.PHFEBCBDACAHTAGB.YACBhABAHDDB.ODGFhAEA.WFAD.,2,-14,-14,0
XKcWGRMbIYFgOTAVDJCEQNfLaUHBPSdeZ,VFGHCCGD..EDCBQCGELFBFHAAEBAGFdFBCZFEFKDADGABFhAAAMACG..IEFGhABAFEGBTAGFDEAENEDCaBDE.hACA.SCCGeEHH.WFAD.YEEFhAEAAIDG....hAFA..fDDB,2,-19,-4,15
TaPJXBSdcYIZNAebCfDVGUEHRLWKFQOgM,CBEHVFDAUDDC..HCBHRGDE.LAFGFEAF.OHAAMACC.aADB.hAAA.JBHDBCGE.dGHGhAAA.IABFAGCBeCBBDGFEhABAGDEDKHAG.........hAGA......hAHA...,2,-41,-7,34
FHAQCIYJXKdOfETMZLWgUPeVcNaDGBRbS,CAFEJGEAdHBF..EDAEZDGFLABEUCAA...eFAG..NEGC.aAAHhAFABCDARDFE..FAHFAFFH.hAAAQCDC.hABAIHCCXEBEfGAGMCIH..hAGAWEEF...gADEhACA,2,-44,-26,18
GYUKVHOIEdDPQeZFCbLMTcWfgaBJASRXN,RBFCXFAHGBCAUAAFKCAG.HEAF.ODHDEHGADDEG..QGEHhABAeEFHCDCALAEGhAAAMAEE.TABA.hADA.fDGABFCGAEFHSEHH.hAIANIAF.IEEF.hABA...,1,-5,-30,25
cHKVFGJOEefDLWBTAbXCIgSNUdRYZMPQa,XEBCCABF..IADESGDFdEGGRBEDMDCE..aGBHHADGhAAA.KEFBFCGAJABDeEDBhAAADAHDBHFAAFID.NCIEUGADhABAPCBC.........hADA......hAEA...,1,-19,-37,18
AGRYHDXNJLEOBSKUQegCfMVbZPaWITdFc,GACHREFCHFDBDEEGJHDCLDFHBECH.KCADUBCC.QBFGhAAAeBHHCHBA.MABCZDCDaFABhAAA..IHAEhAFAdGHCAABC.NBBG.EEEH..SGHFfBBE.hAGA......hAHA...,1,-11,-24,13
VZAUJDMKQXFHLfaCNbPOdecRGWSTBYEIg,JDCADECCQEACHFGHLAAD..CCHA...PFABdAFGeGFChAAAGBEFSFDGhABABBCG.IBBBZFBFABEEKFDHhACAfEFFNAEF.OHBGWFFFEDHDgACBhAEA.MIEChAHA.aDDA.,1,-4,-30,26
gQJNcUSBYTEMGdAWHPFOeZIaCfDXLRKVb,HFAAFEFFODFAeABGaDAA..DADFLHFCKGBH.VAFAQAFEhAAAJEDE.UBADSFGAhAAABFACEHFAMIAAhADAAFHEZDDFfEGF...XCCBhAEA.....hABA...,1,6,-35,41
OJRgLeZXdVEASCfMQHFabUBWcYNTIDKPG,CGBAQACBFHEG.UGGBBEFF......YDFAhAAAIEBADIAGKAGEOHCAhABARBACeAFBXFAF.hAAAdAGBAHIHMDEBaCEBcBBHNDHG.....hABA......hACA...,2,-48,-13,35
AafRKXeFBWIGESYJQCDZOTPdHcMNbgLUV,RDDBKBCDeAAAFGECBAEDGADH...SFGAJHAG.DECBZDAATGAGhAAAdCGDHEFE.MAAEhAFANHEB..LDFEhABAABBB.fCCHXAGBEDDECHCA...hAEA......hAGA...,1,-11,-31,20
afETWXUQRJOdGbIFPNAYKHDLgMeSZcCVB,KDCGHDCDLFEEeADCSABFCGBH.aBEDEDGE...TBAFhAAAWFEA.UAGB.JABChAEAOBHF.dHBDIHHEhAFAPHEEAFEADCDGMDAB.ZBFBBDFDfCBHhAAA...hAHA...,2,-35,2,37
VLGYPTZHWDcKUJCAeONEQMIaSbRfdXFgB,eDGDEFFC.MBAFSCHFRBDH.dFACFHDCBDAGLAHFGACDTBBGhAAAZCCADFCA.KGEFCFDEABGFhABAOHAEQEAAhACAIAADfGAG.XGGG.hACA......hADA...,1,-3,-27,24
KIDSQPBCEVFecUAXWJNHTgRGabLfOYdMZ,XDBDJHBCHFEDRCDBGBGA.LEFHOAAHdBFCMEAHZDBHIACChAAADHGA..SEAHhABABBAACGCEFHGEeAHBhACAADEG..NIAD..aADDfBBB.KEHHhADAEDDB.....hAEA...,1,-8,-18,10
MedHaIDJCPRZBGOWfASEYVbQUKgNLXcTF,SGAAEHFA..bABEUEDC.KAAGNBIA.LHDE.XBFGhAAAFBGFMCADdEACIFCHhAAADDBE.CCCEPDEBhABARDFFBCAF...OFBHAIAC....hACA......hADA...,1,-27,-29,2
aJBcLgXbVEdfOeMKSYRCAPWNGQIFDTUHZ,...PAHHGDGGFHGATFDF.HDAGJBCCBCFALADG.hAAAgAAGVBABEAEE.hABAdHBD.fBGHhABAOEFEMFEDKFAGYDDCADDBQGACDGIFaGGHhACA......hAEA...,1,-1,-21,20
OSHdDNQBcPGgMafZEXYRVJTICbLAeKUWF,KBBEFEGBOAGHdDCGDFEG.BDEBGGAD..MDDFZAGF..EDAFRCAD..hAAAJFAFCBFALHFEhABA.ADED.eEHHUEGASBAChAAAQADCPEEH...aAEBhABA...YHDGhACA..,1,-22,-24,2
eADFKZMLUVRQJIgBSdHfcEGWPXYCaTNbO,DFAFKAAALDEHRDGH.QBGAIABEBEBFHEAHEFHFGAEChAAAXGFDCGHA.aDGCTGDBhADAOFCF.AAEHMBDBhAAAUDCA...gCACdGBEfBHGhAEA......hAGA...,2,-30,3,33
HEZgSTYDcRGWQbUCJeIXVNaFOfLBAKPdM,KGDFdAGHMHEAEABE.ZBCB..SEABDDHBREAH.QAGEhAAAUBAE.JBDDXFGAhAAA..aEFCFFDGfFDBhADAAHCHHAEF.gCFG.TGGBhAEA.YFAFhAFA...,2,-32,-23,9
SFRDWBKGAeYUHIgTdaPCfQJOMcLEZXVbN,eDHDHCDHTABAdEFGCFDF.QGBH.MAIHECDAXFBHhAAA.VBAGSAFGhAAADIAEKFADGAEHhABAADAHIEGHaHGC.fGGFOEAG.ZDAB.NIEFFGDAhABABADC....hACA...,2,-12,7,19
TMZHIFfgAXdOeKWCaDNLUSPcbQJYGRBEV,XFFEOBHFKBBC..CBDG.DEHBLEED.SHAGhAAAPFCHQGEHJBHF.hABARBDGBEFAEFCFTAEChACAMADGHDDHFDAGADDHWCFH.aGHDNAAE...cEADhADA....hAEA...,2,-21,-21,0
dQcVZgFBDLAaJbUWeOfHRIKXYCNPTMESG,JHAAUEEH.eHEEHCFFKAGBCCBB....TEACMFIDGEAG.hAAAQCCGVADDFFDGBHGFhABAAADFaDFA.OAGFhACAIABFXFGA..NAAASFCHhAEA...dAFG.hADA...,2,-25,-6,19
ASYGFdKUTLMcaRWQHfgOIVeJbDCPENZXB,SCDFFDGEUDDDLBCEMICC..aAGBRGFEHFAD..gAAFhAAAOCAB.IFHDhADAeHCGDABE.CAHDEFGGhAAAZDFGAIHA.YFAHKGDE.WGDG.fFDBhAEA.bAED.hAEAPCBFBCDB,1,-9,-10,1
UONXZAWeYJQBcbGFgSMTdaVLIKRHPDECf,eABDQBBFBEGAGADDSFFBdEDDLGEEKGAFRCEC.DCGDCHGAOECDhAAAZEABAHIF.JEHH.hAAAFDAHMIAC.aCHFIGEHhABA.EBGENCAE.....YACChAGA....hAHA...,1,-19,-23,4
CKMPSIRbOLJcgZAfBXFTNUYVHeQDGdWaE,BEEHFDDFUFBAHGBA.DAAAdAEHEBCAKBAD..SAFGRGFA.ODDBhADALAHD.JBBAhAAAZBFG.AAGAXEGChAEA.NCBG.eFDA..WHEACEHBMFAD.hAIA......hBAA...,1,-24,-33,9
eKZBHUdYRMPVbQaIgOWfLJDETcGXNASCF,SACECGECKDEE.HCBBdGBDRDBBMAID...VFCHaGGAOAGDhAAALEEE.DABFEBCATGFHhAAA.GBDDhAFANABF.ADDEFHACBHFC...PEFEIAGDhBAAfAFA..hAIA...,1,9,-46,55
QbLfPTRCAeUKJEZSWgHIGaVYOMcdXNDBF,UFCGJFCGZAFF..SGAFHBBEGGEF..VBDCMAAHdCADDEBFhABAQFGFLHAE.hACATAADAEAF.KBHFEDDGhADA..IEAHaBDA.OFFHNCIABFGB.hAAA......hACA...,2,-25,-5,20
PbgdXFGIHJZfcNOWeBVTMUaSCQLYDKREA,...PABGgBBAdHBBGDDFHBEBZFAD...fFFEhAAAOBFCBFHHMAHFaDGAhAAASEHHCEBAQGFChAFADDABKGEDABBFFAGAIHHCcBDG.NABD..WEBEhAGA.....hBAA...,1,-2,-21,19
TSLMWRKUcEVaNOZAdBeQgbCfDPYGFJXIH,BHCEQACECDAB.DGEFGEFGFCAA.JDDDHDDA.SGCFhAAAMAFCKCCC.EAFE.aFGAOBGDhAAAZCFAABIF.dACFeFFBhABA.fEBB..YFBDhABA.IHHG.hACA...,2,-38,-11,27
FZQbNLKgRdSXUeMVaTHcBPGCIDOJWYfAE,ZDCGQBDCLFAFKDGBRBDAdHCHUGAF..MFGBaAFG.HDGHBABFCBGE.hAAADCCH..OABGhAFAJFHD...fBBGhAGAFGDBNCBG..SEEGeFHH...hAHA..cCFB.hAIA...,1,-9,-33,24
MYQUGDfJORCaFXKeAWLcNSgVBTEPbIdHZ,LHCGSBFEBFCCECAA...IFGDdEEDHFAAZCEAMDFAQBBChAAADIECJFHBCABHaAEAKCDChAAAAEBD....NCAA.TDBFhABA..PEEHYHAGfAHGhABA.FGHD..WAFEhADA..,2,-28,-11,17
WPIGSVZNFECTbaDMfHUBYKXOQdceAgJRL,JCDGLDBC...IADEVGEEFAAGEFDF..CAHB...aFFAhAAAMEIBUCGCBEGDKGAHQGGBhABAdADF.hAGAABBDRAEHGEBBSACDTGBG.DCBG.fBGDhBCA..hBEA...,2,-37,-12,25
cETUSJFNXZaLPbKCAOYedBfHGDIVQgWMR,eFHHBDDCHADCDHEA.QGAEMDCB.EABBUEFGFGGA.ZBFAaDGELBDHhAAA.KGBFAHFDdECHhAAA.fFEAhACAIABC.gAGB.WDAFcFDGhADA.SAEEhAHA...,2,-35,-6,29
ELRZIFeSGAVXdYTJNOgDMaHKCbUQWcfPB,VAABXGAG.dEHGJDAF..ODFDDECFHFEACGCE..UCDDQAGFhAAA..fCAChAAABDDDRDFGFCDASBGChABAAFIHTGCB.NICDMFAAKHAG...WACGhADA.....hACA...,1,-20,-24,4
YXWLcIaUJCHeRKFOETAbdMDQZSVBgGNPf,MDAHQFCAZEDABDBCGAEA...PACHXCGDLAAFhADAaABD.CHGGeEADFHGGTGBAhAAAACHBDEBESGFFhAEA.NIAHWCHHcGDE.ICFFhABA......hADA...,2,-41,-1,40
gKdCaBWPHXcYfGMTJDeVFULISNEQRAbOZ,OFGHZFDEdBDACGBABCAD.HGBC..XCFH..cBBChAAAGAAAMAHFDIBEeAHDhAAAVEAGLDEBhABA.SGADEEADAFCAKGHD.aAEG.YFHHhACA.....hACA...,1,-4,-35,31
TedIYEVXZagKMfHSGWRUQFcCDPLAOBbJN,OEHFJCEC..eBCFdGEHEEFCZFFA..KBADMDAFHGAGGABE.hAAAUGBCFDDFCHEADBHHABBEBEAFhABATDDF...IBFChAAA..XDGEaEBCSAHBhABAWBFE.....hACA...,1,-9,-39,30
KMXFfAgQYOHPSTILeNZBdUaCDWGVbJcRE,QBGHHFFGSBCFLECBZAFCBGDGaEFDDGHFGEAD.bDDAhAAAJDAD.EADDMIACFBAGAGBEhAAAOADD.ICAFhABAeCDBNIAB.CHEA.WFHB......hABA......hACA...,2,-22,-1,21
IeFdYQREMGXPaASHUCLBDVOgKJNZbcTfW,HCEDLCBDDACEOFAGKFGCZAAE...TBAHIDCD.FDFBdEGEhAAA.RAGFMEBEGADAaAEEhABAAAAACHBCBCDF..gAGBhACANDIE.bFBE..fGFEhAFA..WHDG.hAIA..QGGF,2,-18,-10,8
TCfIdUMBgNWAEaYRbQFJLGSVPXeZcHKOD,aGCBRBBEFGAALBECGEEE...SCFB..VBFAPDAChAAAeEHDHEGHDEDFCDAFIBCAhABAdABFMIAABGAAhACA.NFABADDGEEAA....YHDA.hAAA......hAEA...,1,-8,-22,14
XbVOIWBTRdZUGaCEJFSQANDcLefKYMgPH,DCBGeBCGKABAMHAEHFEB....VEDGOCDCBCADREBCdEGCZAFAaCGBhAAACHHG..FAHHABBFLHFEhABA..fDAFhAAA.gGADXEAEIEHDhACA.WCCG.hABA...,2,-37,-18,19
fHSXRWUMFDAbgaQYLJGNECZcBKTVdPIOe,aCHHLGACGAEAECACZAADKAAF..dGECODDCHEFESGBChAAA.RCCH.MFFDAEBF.hADAgAFC.hAEAJEGD.CEADBCDF.PBHFfHGBhAGA...WHAGDIGG.hABA...,1,-8,-32,24
TecEPMLQGZWKCVgJRBHXNdFDUIAfOaYbS,aCDBSCFD.eAAEEEFCLGBGGFBHKDADCCAG..JAFFBCCDhADAHFGBNAIA.DBCA.AABAOAHFhAAATGFCMCHF.hADA.ZEAAWHAG........hAEA......hAFA...,1,-21,-26,5
ceMQgKXLVCSOfTEYPZHNUBRJGWDAFdIba,FACGdABAaGHHeFEG..MEADKDFBLCCH.CBEF...SCGChAAATBGD.EGFFZAAFhAFAHDDBUGAHBADGJHFCDIDChAGAADCAbGBG.QDGA.XBDAhAEA..fCEChAHA.,2,-26,-9,17
TAcPEfgGdVZLKbaQHSRFMYCIJOXBDeUNW,ECCGGDGAdAFFZCAFKBCCQBGDHGFA.RFAE.FGBG.CDFG.JDDCOABGhAAADAFF..eEAENIAB.hAIATBAHAEHB..fGDFhBAALHAASGHHMCEG..hAAA.YFFFBEEG.hBBA...,2,-21,-5,16
QagSZHYDKRPXMFeIUEdGbcLJfWAOTVCNB,VEFECFEBBCFG..QDCF..SEHHHDABDIECKFDAhAAAPHAAMCCA.IHBChABAdBBAGDBHLAGBhACAJAEAAEHHOBABaABE.ZGEC...XBGEhAAA..FGHD.hABAEAEE..,1,2,-32,34
gbZEOJHQKLAaRXMWPNYSCGFVDcdUTIBef,aCFHXGCB..MACD..PEFDNEHE.SBDBhAAACBHA.FGABDIAAdACCUFBAhAAAICFFBFFHfAFBhABAbBADOCHHJAFEKHDGABDB.RDDD.YFHBhABA......hAEA...,2,-34,-16,18
KRGHdQNbXZfDCIYOgETWPBVUSeAMLaJFc,aDBFJHBC..FAEFKGBF.RFGF.dDDF..QAFA..XEEEhAAAZBCFCDFGODAHEFHH.hABA.TBBBBAADVFCGhABAeHEGMGCA.LAGF.cCAChACANICBDBEB.....hACA...,2,-24,-21,3
JgEKRMYDfSFQXHPNLGdZBTCAceUIaWVOb,UGGDaFGD.ODGD..JADGEEEAMFFBDACA.FEDFHBFALCDEhAAAZEBFBAHEACIH..IGBEhABAbDCF..KBBDfCAEhACASFAFQDGHNAAC.TAGHhADACHBG.WBBB.hABA...,2,-20,-20,0
XMJLdRVYOBcSWfDEbCPIQFUGAHagTNZeK,aEAFTEEEZGEG..KEGEMACF.LBAHdABGRDCG.ODFGBAHA.SFHDhAAADFCF.EEBFhABACHAEQADGhAAAUGABAAFBNDDG.eAFHJHEAcADH..WGDC.hAEA......hAGA...,2,-31,-11,20
LWESCeJdMDPBVAXOUFGZbRHYIcQfgTNaK,XEBEUCFCZGFGREBCHACB.....IFGAfABETAGEhAAAKCEFLAEEhAAAEGAHCHDBdCGHMBBHBCADAHDBFEEB.hACAbAEB....YFFE...hABA......hACA...,1,-9,-32,23
ZgPBfXUMKSVGbCROaFEAdDcQWTLHNJIeY,dGCBQDDHLEFFJBBFeCCB.ZAECBHFA.UFACKHGASAADhABAGACDCEGD.aDHDAAAGDGDGhACA..TDAGhACAIHDDPFAH.MICGbAGF..FGGAcCFFhADA..NBIG...hADA...,1,-6,-27,21
OGTZRfCaIXYNWDHAUbgJLKdQVBcPSMeFE,UGDCJHAALEDEdFHCBEAH....SAGEFEEAEBGF.TCBGhAAAZAAGRGAG...CBEBaHEAhABA..IECGhAAA..XFGE.WCGBACCHgBDChABAKACBcEACMBIF.hACA..OAEA,1,-23,-40,17
GRCHSWOMNEZQeacFdgDKBVTJYPfAbULXI,UEEFXCBAGAGGHCEFOBAA..MDIBEFABZDACeDGHFEHDDHAGhAAABCDEJAFA..PFBAhABAAIAC.LBBChACACHHESGDANIAH.aACA.dBFCKGHF....hADA......hAEA...,2,-18,-8,10
BDQPHgMESCfARIWVZGceUKdJbaYXTFOLN,RGCEVFDCZAEDGCAA.UEFBJDDA..aHGC..XAAAFBCELFBDhAAABHHGDAIDHBABMAHFhAAASAFC.hABAfGCGIADDeDDB..KAHH.hBGA......hCAA...,2,-21,-18,3
UPgGRLJNXdWKCacQEDOMVbZHeFAYBISTf,BDGHSBBBUGDGGCAGRAFDLBDD..XGGHKEGHCDHEQGEChAAAOAFG.MECDhABAZCCAFABCAEAE..IHHGhACAfBHE.gECC.dADEhAAAWFADaFHF.DFDB..hADA...,1,-11,-31,20
aKDXHISZdAWGEUefTQgYbFBVCLcNJOPRM,GEGEEEGAUBFAeFBD.QACH..bEBGBBACLBDHhAAANCFGOHDEMIBCaEAGXGGFhABAHDCBZAGHACCGTGEDhACA...YGAGCGDA...hAAA......hABA...,1,-7,-13,6
ZAcCRUGQFJbDBXLdgIMHeYaNWTKOSVPfE,CEDHRABDQDBFFGBF.DAIFXAEH.LGDAdDFDIBFEhAAAMCACHDAEeFFGNGAHKAGBhAAA.SABGhACA.fFEHAADGGGDFBHCGaHGE.OBABhABA.....hADA...,2,-26,-11,15
KQLeJRIHMZUOdfYADNXWGSacEFCgbPTVB,DGAFXECGGBAG..SAFDEFFCFDGE.CHDD....gFEFhAAATDDFKFDFQACGhABALAFHeACBhAAAIAGAMFCHUGGCdGHEABHANBBCaCHB...PDDChAEABAEG....hAIA...,1,-12,-20,8
fEYWBALIbUDTgQPGRCNKaXSZecdFHVJOM,LCDAUGFEDBGB.TFAF..QFCFRDFACAAH.aCDBSADAhAAAZBEFeDBFFHAEHDAGhACAOABBEHGCBHBHAFHG.hAAAIAHA.gFFANCAGKAHB..hADA......hAEA...,2,-20,-19,1
EaAYgSGVKFTMdQfHPJNOeUDWCZIXBRcbL,SEBFKCBDMEEC.QBCFHAEB.JGDENAAC..UGGEDIDECEFEZGBGhABABAAHRCCF..LAGBhACAEAFDAGHB....hADAYBHF.....gGAGhAAA.FFCGdFFCfCAAhACA,2,-23,-20,3
decYBKQNJLaOISDVbgGHEMPXfTRFAUZCW,CADAeBDBBDDAKAFH..QFFCJAAF.LGBCOGEGSAHDhABADABF..VAFBhAAAGCBCMIBAfHFFhACARCAAAGIFZDFA.WEAD...dDHGNFAFaHFEhACAIEFG.bFCH.hADA...,2,-21,-19,2
ZVafFLOQICUAWNcDgJeHYMXRKSdPTbGBE,...NBDB.gGFBHCGDMECBKBEA.dGBBTAABBEGCZACH.aCBBhAAAfGAE.hABALGECIAGBAEABDEDChAAAeEEFRCACbFCHEFHBOEAE..CEFA..hAEAWFHHYCHH.hACA...,2,-11,-10,1
SUbHXRTDWfKLEICacPFAJNYMZVBQgGdOe,JCEGMGDCBCDCGBBG.dBGGeDHFUADGHEEFREFE.DEAEKHAG.LHEChAAACHHG..PAFAhAAAAGAB..NBAC.ZEAE.hABA..QABFSCHH....hACA......hAGA...,2,-30,-19,11
DbWfTgKNeXYGUMFSZcAILEQCHdOBPaJRV,LAEAQCEFHBAGBFCDaGFERBAE..DABC..fFEBhAAAKDHFeGEGGADHMFIHFGADSGABhAAAZCFHIECChABA.dDAE.PHCCJHCAWEAE....hAEA......hAGA...,1,4,-26,30
TQDdBYfSJXaHIcZGACLOMEgNeKVRPUFWb,ODHHMEGB..EFACeEDHRCBA.UDAFFEEF...TAAGDDGCBABHhAAASAGCJHAE.HFABhAAAZAFCAEHECGFG..gBDFhACAKADB.WCGFdFHA..XBAGhABA..IHHGhADAcFDC.NICF..,1,-22,-24,2
cXdgBECLNUIYfZGeKVMbPHDASRQTOFWJa,QDBEFEEF.aGCBXAGF.BBAFEADDCHHHLEBFhAAAUDEH.IBCAZBFAeAEEhAAAKDGCMCAAHGFEADHBTFGBhABAOAEHJFDF..cFDD..NDAA.hABA......hACA...,1,-7,-26,19
EKaRgPXDUQbMcBWZFIOSLVfHeNTdAGYJC,JHAAEADGKFED..aAEBRFAF.....XBAEDCBFUDFH.QDCBhAAAMEDFBGGBFGGCOCEDhAAALHCGHCGHTABEhABAABGDCDAB..gGEEPAGB...hAFAcAGF.IFBGhABA.,2,-42,-14,28
fCWLDcZYRTIbOBaMKgdJGXeFPQHEASVNU,VDAHUBBBCBEC..LDEBZGCA.RCGF...IBHEBHGEaAABKFGHhAAAdGCG.GBBDFFADHEDGhABAAAHA..SEHHhACAfDGBDAGF....cCDE.hADA......hAEA...,1,-22,-33,11
PbfHcZBCNSOFEeVgGMQKLaTIWJdXAYRUD,RBFAUDEDDDDD.....fGAHHFADBEEFCEBD.SAABhACA.EGEAeACCGACDhADAMDHDKHGEaGHD.IHCAhAAAWHDG.dAGHAHAH.YDCHPDGF.bBAG.hAFA....cFFHhABA..,2,-25,-21,4
dFXBfUbMLTVAaKDQCJRZWSgEHGOPeNcIY,DCCHCGBARBDH.ZEBC...SFGFEFFEHBFBOAAB..eADChAAAIFAFFHCABFHAUCBChABALDDCAIGA.KBHDhABAWFED...PAHFNCAAYBDG.hACAfABHMHFG.hADA...,2,-29,-25,4
IWBcHXaZQgfKAONCFDGYbMVJPUeESTdRL,CEBEFBAGGFDDMAHF...JBGFeEHH.EFDESEAD.RGAC.hAAAICFEBCDCHABAhABAaECGZGBCQDEDhADAKGFBAIHADFAF...bADF....PHFEhAEA......hAFA...,1,-20,-23,3
FbQURXAJeLgSPBfYEZaGVIHKDONdMcTWC,JCEDLBDE.SGDCBBGHEEGAZCAHaBGD.GGADHCCCOEFGhAAAdCCG.MICG.TGGEhABACFADFAECUGGDAFCGgGAAhACA.fDAAIAAHDGDGNADF.hAIA......hBAA...,2,-31,-10,21
RSPTXdMebQFBLVgAYNIGOWaDJZKcfCUHE,..IGAEGEAFOAHHDDFH.KBDDCDCDUAAHHGAERFFA..SADEhABATAABdAEHeGEAhAGAQDEBBCHALFCBhAHAAHEB...WCGFaCAE...ZDDH.hAAA..fBDBhAIA..,2,-23,-14,9
PIbOKWYAUDTFZREJLBdGgcMVHeXSQaNfC,DFCAFAEHEGEBBCHA.GAAAMCIH.HFGD.eGDESABH.hAAAQGGHaDCECGBGIAEFhACAODDA.KDAGACGE.hADATGAF.JAFCdAGDcEFB...hAHAXGCH..hAAA...,1,-21,-26,5
YMaUEIRdDCGVQebHcOAWZLTfNFKBJXSgP,LEEGTDGB.FHDGBHCD..XCEESEDH.PBAAhAAAMDCBEAHB.IHGBhAAAdGGHCBFHQDAHhABAHADAACACfABGKFBDgAGBaFGEDDDFeCDFhACAODAHWFFF...hACA...,2,-19,-11,8
ARGBYWfdEQPNLIOFMaUVCTKeZJSgHbXDc,BFBF..fDADdAHGQCAALHDCFACEUFDDVEFAKEDChAAAZDDA.JFBCHAEFDABCAAGC.hAAAGACDEHGG.ICCHhAFAMIDA..aGAHCHBAeBHBSEHH.hAIA......hBAA...,1,-12,-13,1
GVBLdESefJRUPFINacWOHbAZgQMTKYDXC,ZDCGQACGKGCEDGGD.CHCCBAACLCAG..dFADEHBGSBFGhAEA.eECEJAEBUBGGhAAAIGEF.NIEH.aBAAhABA.OEABABBD..TDFGXEFAfGGBhAFAFGED.WAHHhAGA...,1,-21,-38,17
NdOfRaJLFYDgVWXIZEQcKGBAMCTUSbPeH,MBIDCGHFUEAF..SEFE.eAECdFEDfGAAhAAARCCC.LBDFDCBFWHCAhAAAIABFZFCE.EHEChADAcGGHBBEHACCHbEACPDFG..OBAAhABAaHCG.FBGF...hAEA...,1,-8,-35,27
gGAYfTbLERUcFHNKOPJMWXCQVaSBDZIed,TCBDLCDD.EBFBREDEFBFAKEBF...OHAEJHDC..MAIFXABEhAAAQBAG.hABASACE.hACABFFEIGGBeGBCgFGHAFAFfEHEhAEAcAFAPDEGCHAGDEEAhAAA...,2,-25,-25,0
dYJKHFVMNeAWScGIZXCDUgLQOafbEPTRB,SCDBGEDFZBFADBGGLEAA.QAGEOAABaGABfCBEhAAAEDBA.PFFChABABHGAdBCH.YGDAhABAKGAGFHECMADE.AFEBIDHACDEC.hACAgBEB.hADATABC.,1,-2,-21,19
FVgKDCJfZWXEHabLPIQMGSNAYUcBTOdRe,UBCGBABFOCFAdHDDFCAB.KGEB..CBFG.ZDEA..EFAB..aEAHLEFEhAAAQFBGSHGChABAAHHD..cDBAhAAATECF.eAHFDGIDJADE..fFGBhACAWFFB...hADA...,1,-26,-42,16
bPfRdNeKWECABMQLXIYVDHaOUZSgTGJcF,QEBAXBEG...VAAEaEGHUFDBSDAFGAAEJAHFFHAEhAAA....fFFBhAAAdAHGeDBHWADEhACAABGHBHHF.MFEBIHHCYDFA.DDCGOHDChBAATGACcDEGhBCA...,1,-15,-17,2
HUBGJETSPVaYKcebgIQdLORFNXZWMCDfA,HBFFUFGDBHBFJBBD..SFCHaADD.KFGBeABH..IEEFhAAAQDBDOHEChABARBGDFGDGZACFMAFCCFACAICCEBHDhAEA..PCFH..cGAGdHFDNDAADAAHhABAfAEC.hADA...,1,-14,-17,3
SUFINPeMVYdKBgQWHGaXAbLEfJcCDROZT,LBEHJHBE.DFFARCFGZBDDUBGFFCBC....IABBeFFFMAEChAAAdGHCKBDF.QDAHhAAA.HGAAhADAXDAGAHEE.EACD.CBHESHGChABA.....PFCAhADA.,1,-25,-35,10
aCNWPOQSeBHEKJIDRdYZGVgMFXbUTfALc,aDFGCFAH......NDIG.OFBH.eHCCEAAAJAFHDGFCRAEGdHCFZCCHhAAAGECDMFFGFCADUCBHhAAAABAF......hADA.cGGHWHEASAHBBHFGKDGHIHAAhAEA....hAGA...,1,-24,-31,7
aNGDVdLQWRECTMUHKbOFXJZIAYgcBPfSe,....gFFFBEGBSCAAeCECaDEEDGGFLCCBQGCEhAAAEFBDCHABMDDA.HAGHhABAKBAHOABAFECEZFAHYBCChACA.PFHFfDHG.hADANICBdAFF..WFFFhAEA...,1,-6,-21,15
FWCRJbeLDagdAfZcXYPEOITMNKSGHBVUQ,ZEFBXAGDEAFC..OABFMFCE..SHEEBCFHUFCCQBDHhAAACHHC.JFAHLDAAhAAADGGEaDGFgCAChABAACIDfBDB.PFAFIACF..hAEA......hAFA...,2,-31,-27,4
BdAgUHVKcMJTQZRLISFNPXeafDEYCbWGO,UFFAVBAA.MADC..TEAGREDDLBDAFADC....XDEChAAAeBBDDIEACGGCGGABhABAdBHAAEBFKFBHQAGChACA.IHHHSDGGaDGA.YHAAhAAAWFFEBECE...hABA...,2,-29,-4,25
XDBHMWeTKdNAQaZcVIFUGbSEJPLRCYfgO,ZBEHVAAAFHFA.GEAEEGFF.LCACRFBB.CHCG...fCDEhAAAODGDBEDEMEACeAAEhADAdAGGAFAC.QDFBhADAIAHB.SBHB....hAEAYGDEDGIFWFGHNEIA.hAEAaGDF..,2,-30,-4,26
SNgAWYUXFbIZOQMcLeTCBPVGfEHdaRJKD,UECAFBACZDDFMIAGLBFF..eCBABHFHVAGHEECBHGAG.hAAAaDAHKADE.DFGHSFHBhAAAAFEA.XAGDhABAIBBA.cCFCCHHGfFFB.hABA.JFHF.NCAG...hACA...,2,-33,-12,21
NOYaePMJILGEgWXdQRfDBCHUVKAbScFTZ,SGDAFFFHZFDF.ODAAaAAG..MCFCLFAGGCCF.EHAChADAWAHB..XBBGhAEAQAAGDBGGBFBHhAFAHEFAKHGEAHID.cAEBTDGEYDEDhACA......hADA.eHBG.,1,-4,-17,13
UgPeRZMQOKCcEaGVTfLDBFWAbJNIHXdSY,JFBBHAFE.SBAFUFFC.eCHDZBFCQABAKFDGCEAH..hAAAaCDFGCDCTCBGDAEAhABABHHAAIFC.IDFHhAAA.XFFH.dHAD..gDGEhAHA.MFDHhAIAcEBEfDBH,2,-29,-20,9
JYFNSPeIOULaMKZXETRVWgfHBGDcQCbAd,JHCAFDGC..SCDCeAEBUECELHFA.aHCEKHGC.EFGERDAG.hAAA.VEDA..fBAFhAAABAHADAGHQFAHhABAAFFDdAGE.YACCIDAE.MFAHhABA.....hAHA.XBBBWBHH,2,-33,-5,28
JcNTGZXADLIOSWCURdeBKPYMfbVaFQgEH,LDBHOCBD.SAGCCCAAdDFEBAABKFDG..MFBH..fAAChAAAaEGD.FBCEhACAEDDEJHEE..NCICZACAhADAAEAGDCHBUGCCeDDC.YFAFbAGF...hAEA......hAFA...,1,-24,-25,1
cXICgeGFfJRdHbMBSPYOTKDNLUVWAEaZQ,ZFBAQFBH..IHHGCFEDGABHFCDBJDFFdACHHAGDBEFFSCAHhAAAOBHHDAFDNIAF.hABALHAA..hAAAUCCBAEEFaGFG.XBAGfFHG.MIFAhACA.....hABA...,2,-36,-2,34
ASRdPZLDWHgceQGaKTYEVbBNfJIFMXUOC,SGBAREFHdDAEZCCALGAGHGFGeAAG.aFGGKCGC..ECEEBHHFhAAAJAHHFEEBMBCA.OFCAhABAAAFDDCCH....gEADhACA........hADA......hAEA...,1,-18,-39,21
EKWbJRAXYdNQUgDBVFaeOHLPZSfMGCTIc,XBFEdAADQBDEUDDF.DCGFBDBH.FGBBOBHH.LGAAhABASAGCMFFBCDGG.hAAATEAAEFGF.KGGHJABGhABAAEEG....NEIEaDAAeAEF.....hADA......hAEA...,2,-31,-22,9
XcNIaUfQJGZALdEHWBSTVFRDCebKOgYPM,EGDGBBEA.SADFFFFFDCDE..CCGF.KDGA.OFEF..PFAFhAAAXAFF.IHHAhAAAaDDDUCAGJBADAIDALADAhABAdDDHHEBAWABB.....hACA......hAEA...,2,-40,-22,18
gMAHENKJIOfaVXYFZdBGQLbcPDSTUCWRe,HGECKFGAOAHFVCCGFGBHBFDC..LBBF..PBCChAAADAIDTEGHCDDH.eFBGhAAAMHEEAFAH.EDAGJADCIGBDhABAaEFB...ZAFH.dEGB....hACA......hADA...,1,-9,-33,24
PYHaZAWdXEJeUfVbOcDFGNgKSRQMILBTC,XFBEeFAGUDCD....VCADOBEAFGEGGDDBKDHBRGDCMCCEhAAABAGC.CBHAHACAAGIFECAH.hABAJHFE...fAAFhAAADDFHSGAGIHBB....hAEA......hAFA...,1,-18,-28,10
WGMbXFQNUCfAYHOdaVIPBDZRgSecKETLJ,HBAGaDGG.VBFGBGCGDDIHZGFG.RCDD...SDDAeABAKGAHLFDAhAAAJEGBGGAFMBADhABAFDAF...UAGGAGAGOABAhAAA.dGEAIEBA....hACA......hAFA...,1,-11,-25,14
DZVAReLQCdfbPWOGaNTIgJcKYMBFXUSEH,RDCFeBACQBGDdAFG....PFEDOFGFGBDETGEGJDGFhAAAKBAGMAHFFGAESBEHhAAAEGBBZEAC.AEGECABEfGHAhABAaFEG.NAIE.IDBE..hADA.cADBBCCF..hAGA...,2,-25,-1,24
ARXBWEdZOcKDTgGCfaHUNIbMeJFVQYPSL,BHCAdFCEOBCFKEBDDGFGGAFE..CHFCHCDEUGFG....NEIE.hAAAIAFA.MBHHhAAAeFAH.FDAEQFCDhABASEFAABDH.XADBZEFA..cABGhAEAfBACaAHF.hBAA...,2,-38,-20,18
eFbGQcDIBaOMJfHVKNWgSRdUCZXLEYATP,TAEGFBFEGDCA.DBCDaGEC..MFFHJBHDHECDKBAB...NCBE.hAAASADFRFFE.hABAUGGDZACBXCEAhACAEGADAEHCeBEDQGAFBFBGfEGGWHFACEEB.hAGA..LAFEhAAA...,1,7,-22,29
WSORecMLgPZKbTdUANGFfBICDQYEHaJXV,GGCBBAGFDGDAEFAEHCFA..aCDEJDAFVDGD..OCDDRAADMAGHhAAALBAE.ZGFEhAAATACCAAIFFEHBCHCFYAHHhACA...SEFD.eEAEhAEA.....hABA...,1,5,-37,42
dfINOVAWEKBYQJTCeaFLZcMbXPGHSRgUD,KEAGBDFDQDFGCCCD.FBAALCEE.MGBGbADCGEDChAAASHBGUGABdBBBIHHChABAOAEGAFGGECDAJCAHhAAAaGGG..ZFFAXBGE..PHEEhABA.....hACA...,1,-12,-27,15
RHUfFMEeDZCLTISOcGKVaJQAWPdbgBNYX,dEEEBAHG..XAEBRCGBUCCDFGAAMIFE.DEHBZGFGLDAG.hAAASHCEOBBAKDFDhABAaBHHAEAF...WABBhAAA..bFCH..NCGEfHADCBFB.hACAIBDG..hADA...,1,-34,-36,2
bNTJOBDQVSUZaFLGAMYHPRgCEdeIKWfXc,HFCCRFBCCHDE.EBFBdBFEeCCG.KBAE..XACB..NEEDTEAHhAAAOCDFDCIB.QGGChAAAVGFESAGGhABAaABHLFAFAFIBMIAC.PACG.ICHBhAHAWFFF...hAFA...,1,5,-37,42
IaRFgEWHGLTPUSKAVCBJeYMfDbcdOZXNQ,BAHFJHDA.eADBMDAHDGCF..dCFAOCBHZBBF..QGAEhAAAaCFFFEEC.EFFBGEGChAAALCHH..PBHDhABAKBDEADDECBAG..fGAA.cBBAhACAIHHC...hAEA.WFDD.,1,-23,-24,1
AcIeBDMgJdaRZLTWUFXbOEHVYfGSCQPKN,eDGHBFDCDAEHMCCHdAFHRGDG.ZGFELAAF.UDDHFDHFOAAChAAAHFABVAFG..GDAGhACACHGHKBCEAEAG..ICCGhADA...gDED.aGEBhAGA......hAIA...,1,-10,-37,27
GNSHdJaKFUWCPTEBXZYQecVbfMLORAIgD,DCIFSDHBdADCKCBB.FFAB..CEGH.EDEEZDDEeDAC...bGBALHDAhAAA.OAEChABAAAABgACEHFDGaGAEhACA..WFGFBHHAYFCE...hAGA......hAHA...,2,-33,-19,14
RTYLFVJBHMXPGKWNQCOfgSEabUcZAdeDI,eABDRBFGLACGFFCABCEDMIECGAGE.KACBQFGA.hAAACEFAOHBGgFFEhACASCDFaGBC.UDAAhAAAAHFBDFAHIBAGTAEG......hABA......hADA...,1,-22,-24,2
FBARVJHLdGDUXTcCPbWMSYIOKfgaEQZNe,VCFCLDDB.dDAAGDBEDICAUAAE..XEDHCGBE.bACGhAAASGGB.hABAOCFCKFADaGGDEEHDNIAFeAEEhADAAGFB..JAEE.......hAHA......hAIA...,1,-15,-37,22
ceALDPOBVZQbdKXHSMTGRWaYNCJfgFIUE,LFEEDFFBOHCEBFAAZDFA.dBHAHBCHMCBAGCAGRGCE..aACACCFEJADChAAA..FDDAEGGDeBADhAAAADHG.QAFEhABA.KGGFSBAF...WHAChABA...fAGBhACA,2,-27,-20,7
VAfWSCZaeLNgJREbOIQGTUPKDHdMFXcYB,SACEaGAHLFBC..JFDEEBDB.OEHHGAFE.UCCAKBAGdGDDhAAA.FCGCXFBDhAAABAEGAHIHCDAGNBAE..gGGChABA.IAHFTDEDDGGBMCIF.hABA.YAFCfHDFhAFA..,1,-13,-29,16
bYXHDNVKUOLSTfaIFJcgGZPQCWEAdBRMe,dDCFRAFHMIBGeCFB...XADFDHDGKBBFUFAEOEHD..LADHhAAATFBC..aAHFFGGDhABAJFEDGEEH..hACAPAADCDCDAFDD.BHBG......hAAA......hACA...,1,-26,-28,2
gefXKHEBCGaSYNZRbQPJALVdMTIWDFOcU,LEGDdACHMFBG.TEACDBBB..FHBGODCFUGGG...fBHGhAAAKAFDBAHGGDDHhAAAaBAHSFEB.hABANIBHZAEB.RBBAPEHDACGHICDC...hABAWDAD...eHDChADA..,1,-13,-32,19
WPZUdXSGIQRgDEHLJKVaCATbcMOeYFBNf,TGFFMDDB..eFADFBFEBABF..fGEEZFDDdFAFSDAAhAAAQBGARDEGEACChAFAJDBBaACF.AFGAOAEDhAAANCIG...UGGHIHAADICCKBAHCDDC.YEEEhABA...hAGA...,2,-26,-6,20
RNJDKQWEgSLXVYOFUCeBMIHdGfTAbacPZ,aBCHZAACJCEH..DDGFKEGAQEBB.ECEDSFCBhABA.LAHFYFHHhAAAFHGACAEEBCHDMDACdAFAhACAfHBDAIBE.cAGANEAA..gGEFhADAOHEE.eEBDhAEAIBAG.,2,-25,-17,8
ZJDUXRdIGESaCFAOYgPeWNQbfMLHKTcBV,OEAE..gCEHeHDGQBBEMFHBLHCEKBEDBCGGhAAAJEAFXEGERCAG.hAAAIGBESECHhABACEFFFAHBAEGAWACE.NBIC.fGGE.hAGA......hAHA...,1,-21,-29,8
NbOecEYgIFVATQfdJKRaHCDSZMLPGWXBU,TEFEQEDG.dHAHKCACRBFGHABGCGBB.SAFCMBFDLBHDhAAAGGDFBADCUEAHOEEHhABAECAD..gDFEhAAAICDDAHIBaCCEDAFA......hACA......hAIA...,2,-39,11,50
aIYJPeUQVfLKNAdgHFRDcbETZGCSOBXWM,dFEEHGDGFDAHREBHDEEH..EDGFZADDGAAHCBCCBDGDMEDH..aAGEJHFGhAAA..UGGGQCEGhABALBAHAEIDgFAAhADA..cGACSHCG.hAAA.OBFB..hABA...,1,-12,-28,16
LUGdOFMHPeJKbZSfCcXBIaTYgEAWDQNRV,QDDDVFDF.GGEHFEBDHBCEeCEEKCBDSABDCHGH.hAAABHAFIAHAaCACgFBDhAAAADFBDFABLABChAFAdEGHOAFEMFIBPCHH....hAGA......hBAA...,1,-2,-23,21
MCDgKOUYAeXFPJLdZfcVHBQIEGSRaWTNb,FDAGJDDELHAEdBHAZAFB....VFGBHBFCBGEEICCD.hAAASCAHRFAC.hABAaEHHTACH.NEDD.hACAMFFB.DAGC.OABAABBDPHCEcGGHhAAA.EFAA....hAFA...,1,-24,-25,1
GFaHEgVDbURfOJcMeXWNSQAdYTBKCZLIP,TBBCCFGBZDEHLHAA.GEAFaFGBHFAG.EGEHDCBDUAEGRAAEOAEGhAAAMIFGeAHB.hACANEEF.SCDDhADAAACG.BGEDIAACPBHH.....hAIA......hBDAFGHD..,2,-15,-12,3
faCAFNHbeUcVGBPEdKSTZDOWLQgIRXMYJ,FCFEHFCFeFFHUBCDGCAHBAABEFAC.KGGFSEEC.ZFADhAAADACELAFGIEFEhAFAMBAEJAHD.aHGEAIHG.NCIE.hABA...VFCFdDBH.....WEAFhACAgAFF..hBAA...,1,5,-35,40
UeLNYQdEJDMaGcHOPRCgVKATZBFfXIWbS,TDCGBAEDFGCE....IEFBSBHHeADALCEDhAAA.QGAEhABAJFHFDBHFMAIBaBCHHFGBODADhAAAPCADgGDDAIFGXAGFbBAG.YDFHhACAEHAA....hADA...,1,-11,-21,10
MDZXVHgKeITGCJWBNORPQFafcdESUYLbA,MEAHZBCBHGDEKFEB.TEEGGCCA..JBGFBHGG.RBEEFBABaFBEdAAHhABA.EBEFSHBGhAAA..YAFChADAADBDDAIBXEFBeEAFIHHBCGBBODHD..hABA.fHDDhACA...,2,-30,-1,29
TLWZgXNQMeEYdHBaIARPGDCKOUfSVJcbF,GDFADHAAOBEBUBCB...SHBCVGFC.JAGFFBGBLDAHhAAAZBBD..XFDChAAAMIFCEFDGdFADBACEhABAAEIDCCAHKAEE..fFHC...hABA......hACA...,1,-20,-34,14
TIYcReXafKdCLEQGSNAgHFBbJZWOMDPVU,FAABJEBBZBCGMFGD..DBCCUFBB....TGGFIDEHREEC.hAAAeBCG..aDEGKCHHhACACBAA.EGEDGAGEAHIHBHADhADAODAB..PAFG..cGBDhABA..fCCGhAEA.,2,-38,-27,11
LXfBPWZeQOEcTgVbRSGdAFDYJHKUCaNIM,DBBAJHACHBFCCFEC...aGBAMBHB.LDCEBABEZDEB.QCCBhAAAEGAH.TGGGhADAVGFCSAFHhAAA.AFAAKADCIAFCXCAFfEAChAEAPECD....WCHHhABA..,1,-28,-30,2
ZRMfUWOPJVTEHIXaCeYdNbSgDBFcLGAKQ,KFGGZEFAMDCBUGBF...OBFGJAFH.EACDHCBG...aEEACDDGdGDFhAAA.SHCGhABABBBBFHEGLAAChAEAAEHAQGGD.fFAGPAHH.IDAGhADA..eEBG.hAEA...,2,-26,-25,1
BIFAXRDGdQPHWegOELcYJZTUfMaSNCVKb,RFCDdEGFQCDGHAFFeHDE.OABHEAADLAFA..cFABhAAAJFGBTGAA.MCCDhABAaCDBCHBD.KFGBIADDhACAAEAADEEH..WACC......hAHAYEFD..hAGA...,2,-23,-18,5
gacWAeRGTLCOIFNYEQbfPHBZdSKMVXUJD,GFBHTCGD.OACGFAAG.EBFDQCBA..bCCGHEADhADABAGBdGFBSBAFhAAAMIECXFCHDEFCaHFCAAECeEEEhAGACCHFIGHENBCHfAHE...hABA.KFFC....hAIA...,2,-20,4,24
WTUYQKaLBHcVNfgFPbDMXRIASeGOJECdZ,eEDHJGBE.CGHC.ZADBUBBDKCAH..BBFGHEAH...VCGD..hAAAfEFCFGFFDAEBMBADhABARBGF.AEDH.OAAChAAAEAGA.dHGD.....YCCF.hACAaHACNIBF.....hADA...,1,-19,-34,15
XdOYIKgDTaRbWQHFJVBUeELNSfGMCcAPZ,XDADdFFBOAAHKFCBDDEC..RBBE..QGAHHDBCJFAFBHDEhABAeFFGLADA.hACANIDB.SBFChADAGCEBCHHEAEHGPBBA.ICHEaAAGFFEH.UGGDhAEA...MEFG.hAEA...,1,-6,-18,12
ZFXKYEJScgQbIMVDOAeBUNdWGHRCfTaPL,BAHCUFFEdFCGHBADRACE.TDEALDEG.ZBAAKFCA.EBFD.SFGEhAAA.QGAHhABAIBGDDAFCAFAENIDFCDCChACAPEAH.XGDHcADGMBID.hAAA......hABA...,1,-5,-36,31
dBAFKHIZaDECcMYQLOfJRUXGgNbPSWTeV,KCBDHABFZEECEBDE.CEFF.MCCGLHEG.OAFEJGBCRCFC.GFAHhAAA...NDDBSGGChABAeABCBAACIHHBhAFADCIDQDAC..UAGD...hADA......hAEA...,2,-38,-6,32
FAICPEUWLKYafcgeVXBHRDOMNbdGSQZTJ,CEAAEEAALHDAKAAA..aCAE....fFFCeCFDBGCDREDHOAEDhAAAMFIFdHFBSBADhABAZAEAFECEAHAB.IHBGhACA.UAGFWBHHcDCGXGDBDBCFGCGChADA...hAAA...,1,-5,-31,26
dOaNgLQGCSHBTDMVbUFARKZXeJYEfPWcI,ZDCDeADEEGGC....fAHG..PCFAICBHhAAAaACBLHBCCFDFBHCBDDEChABAMABBUFGEAEAFKEGCJFEB.hACA..WADAcCGFOFEFNEBD..QGAAhAGASEAH..hAAA...,2,-33,-11,22
BGDeSFYVaTJIOKPMRXLgbEcANCZWdHUQf,CEHDdDEEUBAHBBED.DBBG...FHBGVEBD..aGEBJBHH..OBGHhAAAMFFF..LBDDhAAAEFHH.AGIDZAEDHDCHhABA.fAHCSEAFIHFBKHGG.hABAPEAB.XCAFhACAcGCD,1,-38,-39,1
dgLbSAfDKUIGEJYTZcFVPBOQWXaMNRCeH,KGBAGBABEAHF.JDFCZDGD..FFGCBBEE.QCBEaADA.MAGHhAAANGAH...CEAAeFEDhABAdHBBLFEH.hACAAEDGDCFEIHHH.cDDAOAHF..hAAA..WHAG..hADA...,2,-34,-28,6
XQHKYBWdgfODMAUTZcGPFJReaNELIVSbC,ZBAFGDFAFEGDRGAEeBHH.aDDDLDDB..SAAEhADAXCFCKAGGBBFA.gADFhAGADFAEMADEAIEGTFBDhAHA.PHCCNDIE.IHHE.CFHH.hAIA.....YBBFhBAA,2,-41,-2,39
bTJIXWafQANeYdOGKMRgBPLUDZSVEHCFc,eEAHOCEBMEFBRGFABBFELACE.ZFDHSBCCEGHB.CEGF.hAAAbAFD..JEACICDDhAAA..WABFhADAaDHDAAIH..dBHAKBBFPGAEDBAD..FHBEXGDBhAEA...hABA...,1,-11,-32,21
MVPHZRcgeXLIKDJSUOEGYFbWfQaBdTCAN,VDBCZDEHRAAH..eECBLBCAKAFG.DGBDUCGBGCGE..FHGA.hAAA.bFDHQFAHhAAABBAFdAGDCGCHAHEFMADDHGFE.hABA............hACA......hADA...,1,-14,-28,14
WSUVROdJAFMBeQLDTEHGbPgZfKCYacINX,MDBBeABBQDDGLEFGDAEDHCGDGGAHPADAZCDGKBCF.CDGA.hAAAaGGH...NHABXCADhAAAUGGBOBABAFFHBBFAhACATAGHEFHH.fFCB...hAHA......hAIA...,2,-12,-6,6
NegMLBEXHSdTDUGCbKOcfWVZaRIJPFQAY,eBBDMEFGBBHGHCGFdEEEDAGD.CFAF..KACAOEAF....cAEFhAAAfECF.hABAZBCCaDDHJFHFQGGDhACAAHDF.YHAGNDAFLABEEAHBSCCEhAGA...hAAA...,1,0,-42,42
IWYJRAeNSHDcFfEZTMOCgKBXbdQLGPaVU,eFEESAGCDECHFBECZCFC...MEEGCACFKBCHBGGB.dGCHQGEHhAAALEABGCABhAAAaAHB.IBADhABA..JDFAABIFcGFCEGAGOBAF...hACA......hADA...,2,-34,-24,10
GINSQLHUEgeYfKcFTWXaBPZCAdORDJMVb,RFDDDBEHMADDGGED..SAFBQAAGHCBBEEEE.eDFAfDFDhACAKHFGFCABXFGAhAAABGCDZEAACAHHAAIDOHAEhABA......JDAA.IHABhADA...NCIE..hACA...,2,-17,-13,4
fZaWAEgSYNTXLPDcVBdbFJQCHeGKURMOI,EDGCSDCC..TDDCXFDFLDABDCFCBHBHdFGBFHAAhAAACGABHGFCeAFBUDGDMBAEhABAOCAFIFCEZABAAAIFhAAANCAB...PAEG..cFDD.hACA......hADA...,1,-9,-18,9
fRQVZHeSAXNEPMGUCTIYWadKBLDOJcbgF,XBFHEAEDGDEFUGFHCCCB....IDAEaBDEBHBB.DACHJHCGhAAA....bAADfFADhABAREDH.QGGBhACAHEAGAAECNBIE.PAHD.TECGhADAdGAC.KGAD....hAFA...,1,-16,-20,4
VaNfHIMJQPUFAbTDScOeWZYCLRGdBgKXE,TABDSDAF.ODFAeCFGZFAE.CEEFRFFEdGFG.BCBBKCDAEAEAhAAAaAHFHFBE.MCEEhAAAJHBAUDABABAHDDEH...hABA.WHBALHFA..XDBEhACAfEGBIHHE.hABA...,1,-15,-17,2
QIcVOSUaWPJeLZDbMGYRfKgNXEdCABTFH,TEDGQDCE..VGAGUAFC.aGECJAABZBAG..DCCEMEIFhAAAGCDHRFBH.KGEGNIDB.dAEHhAAABEAEHDAA..IFFEhABA.OAHFSGGE.WHEAhACAeABC....hBAA...,1,-12,-16,4
JMDGEaUNCVeWRKgXfBAFQbZcYHITSPLdO,FGEBQGCCZCGHHCCGSDBEdGBG.ODAHDDBFEABA.aAHFCBEFVFFDhAAA..REFDKBADhAAAXCEEAAFE.YBHFhABAIHHG..TGAA.JABGMEAFhABA......hAEA...,2,-22,-7,15
QeYSBWEVJFcDGTCIfLPAKaMUbNHdORXZg,MIBEUEGEHCBAdBDBRFFH.ZGCC.eAFDBEDEEAHDFCGD.GDAC..hAAATACFCHHALACFhABAAGABKAABaEECOGCA.QAGDhAEASCAD.WEAA....hAAA......hACA...,1,-14,-18,4
JGNWFODSaXHMLQfVcCAPgdKUBbIEeRTYZ,dCGHUAGHBFAGEDEF.eDDFRFCE.ZFDD..JABHGAAB.FFHBSEBFhAAAHFBFLBFDhAAAVGFG.CEABAAHE..PACGhAHAKGFD...IDHC...YHCAhBAA...hABAWFFE.,1,-13,-39,26
ISERcOTUNMFKbfeBVYJLaZGdPWQgACDXH,CBEEXGFEHCDE..EBACRDAF..OCGDUAGHMGEAFAEC..KECGeDAEhAAABACF..YEFGhABAaAHFZCCAdGCB..hAAAWFAEADIFDBAF.IFFESHDG..hACAcGAH...hADA...,2,-27,-21,6
EFgJScdDNHafORWBPZMGXbYUVQLKCeITA,FDEFJHDA.dAEDDBGDHCGF.OABBRACABBAFZCCB.GGDB..XDDChAAA.UDAAhABALFAB.CAHH.IBHFhACAACABSDAAaFGA....fGGGhADA.MGAChAFA...,1,-17,-50,33
VIdBefADSNRZaMObWYCQLFKcJgPGUETHX,DGBARDAFMABEOBDF......bECECAHDLFGBFGCF.JFEHhAAAPHFCUBAAHAFBhABAVBCG.BDFG.eEAEhACAAIAENCIEZAGB...aEGBYFAF.KCHBhADA......hAEA...,2,-23,-14,9
bdQAUTGfVXPHYcgFRSLICeOKZDEJMaWNB,TAAEVEBH..HAEC....gAFFRFGFIFEACGFHODFChAAADBBHMDCE.aACGBEDGhACA.bEBDAAIHfHADhAAAYDAD.SDHBKCCGEFGGNIBH...hADA......hAEA...,2,-22,-19,3
DaOgZUHbJXTVPQKAGdBeCYWLIREfFNMcS,GEEAeAFACCCE.LFAARGDA.FCBFMECGDBHFOADBUEGHHFAE.hAAAJCFE..XBEDhABATCAH.PEHH.hAAAAIBABABHIHHF.NABB.aAHF....hAEA......hAFA...,2,-23,-15,8
cTEPHZLDRdUXYfOVQJWGgeCIBSNMFaAbK,KEEBEEHHZEDFDICG..UAFE..XADA.OCBEQEBFhAAAJEAFGCFACBCEBFHHMIAAhAAAAHBD...cBAGhABAPDGBLAHF..dABGYECFhACAWAED.IHHFhADA..SDAC,2,-44,-12,32
FRNEfSUXKBbLODaHdTYIAVGPZCeWMcJQg,VFFCZDEFCBHF...MFAEJCAH...FAAFEHACUACF..KHGGBAHDhADALBCHDDEGHGCCdDGD.hAAA..IGAAhAFAAAHEeGCG.....QCGGNABF..hAGASFCEODCC.hAIA..aAFD,1,-23,-32,9
cMYDHgFNIEBObTAVKWQPURfJLaeCdXZGS,VCAFQEGB.RFCBLBAGaGBB.CECFZAFHSABE.hAAAMAIBDIAGFEEBEGCFBEHAhAAAODAGAHEDKGFEUGGHfDEBhAEAdAHC.cAFAYEAF..hABANCCBIHHE.hACA...,2,-20,-13,7
fJbTWXISPEQBFGZNaAdRMKeYgOLUVDCHc,MCCHKCGEeCEB..OFCDUGFCDCADCGABHFEC..JEBC..TAFAhAAA..IFAEhAAASBED.ECGFhABABCCDFDAH.NBDHAEHDdFHA.YACE..hAHALHAA.fABAhABA,1,-26,-42,16
XCAYJKMUZFdgQPeNWDbOfHBTcLaSGVIER,KEFAMEFGFAEEdDEG..QABAeHBADADD..OHFEBCHETFCGhAAALAHF.GCAChAAAIHAAEAFBCFCE.ABAFUFGFhABAPCDF...WHEGfCCG.hABAaGACSCFFhAEA.XGGA.,2,-29,-2,27
YNUBXCMFDdEbLQcGRaJHfePOIWgSKTZAV,VDCEUDFFCAGA..DBFFdBDHLAHDGFAH.RDAD.HCAB..eEGDhAAAIGFGSADChABAKAACAEEH.BHFA.MEIFhACAEHGA.QGBAaAHD.fBBDhAGA....WDHHhADATGDC.,1,-21,-25,4
BYAUbWgPNLDIJcGEHQOXSTdMCfVKZaFeR,UCGC..bBBC..PAEADGCHJFADGDAGHFDC..QAFHhAAAXCCB.SEHHhABAMFFECAAF.KDDBFGHBRCFDADABhACANIBH.IHHE.EACCOFDCfHDBhAFAaCEDBCAF...hAHA...,2,-17,-7,10
aLTfBcHCEONUdJFWDPSeIMXZYGAQbVgRK,VBBFRAEELABH.BFCAHEFD.EAHHUEFFdHDHFADEDAIH..eEAAhAAAXGBBZGDE.AIGGQCFHhAAAKHAG.aCAHhABAfCHECHAH..NDEG...WADDhAEA.IHHD.hACA...,1,-11,-30,19
QOcURZdHGLAeWSDNPCbBTEaKJXMIFVgfY,SGGGDFHHCGAF.BCHEEBHH.KDFD..XAADFGCH..VBBBhAAA..gEDFhAAAfAFEOHBChACAREAHZEDFdABBGCBBADGC.WAECNIED.TGEA.hAEAMCGHIAHHcDAChADA...,1,-16,-33,17
bYHANOcfPeFdLSRDCJaGVZKEMgIUBQXWT,ODAD..PCFEFDEDLAECRFFH.JHDGGADH.KDADhAAAEDHDMEDHUABFBGABhABAQGGCTCBG.HECBhAAAAFFHfABCSCCGaHACZCFH..IEHEhADA.WEEFhAEA...,1,-5,-31,26
JPgNXHGBZDYTbcWAQERVSUaCOFdLMeKfI,RGCEVFDAUCBF..CBFH.dADFLDFCKGHH...JDBD..PEEEhAAA..gABEhAAAHAFBBHADDAGCTEBHhABA..WEADADIHSGGFOHFC.MCAFhACAIDDD.XADBhBAA,2,-34,-29,5
MDXLPWgOBHREbKYZQFdGJSceafAVTCINU,VFDECDFEUCBD..MFBHLEEF....PDBAOEBDBCAChAAAHFFCRCFCKAFGQAFFhAAAFHFEdFCG.JABCSBBEhABAeAHHAEAB.NEAA.DDIF.WFCH.EGAB.hACA......hADA...,2,-23,-11,12
KYcMVGNJZedBURAITDLaXOEWSbfPHFgQC,DACGXFFDEEEE...SDCB..fFCHhAAAFAGBCHDHKEAAMCAAVBAHJHEEdEFBBCEHhAAAAAGDLHACOABGhAFAbBFC..PBHDQEGG.cDBEhABAZFBG.....hAIA...,1,-16,-20,4
QAWIbJMRLZYFGEVaSdXHUNgDeCTOBfPcK,..IHDFbFDE.RADG.ZBABGCFGEFBCaBFGdAAE.HDCFUCCGDIFECHAHBHDAhAAA..cAGAhACAAIGCJCHF.LFADhADA.FCBDSAGEXFGHeCHBfACBhABA...KFHF.hAFA...,1,0,-16,16
MASXdROPEILaZcVYHGFBeNbCDfTJUQgWK,SFEAdAAEREAH.OHAAIFEA.LEDEaCCHZCAHVAGBhAAAHAFCFHGA.BHEENEHA.hABADCCC..JADDQCGFhACAKEDGMIDEADGDEADC.......hACA......hADA...,2,-21,-18,3
HCPXSWMUabKLOeDRdJFcfNgGBYVQTEIAZ,CGGFXCCA..MCAEUEBAKHBALFFDeBEE.DHBGRCEHdFADJADE.hAAAFHDA....fDFDhABA.NEICBACFhAHAQDGD.IDAAAICE.PAAEhAAASAHHaDDBOAHFhADA.,2,-34,-28,6
IfDUWaHAONePFCgTJRbXMLBYdGcQEZVKS,OECEeFCECBEC...JHCGRBFC..MIAGLACHBGGCGBAAQCGFhAAAEDGF.KHFA.IBBFhABADIFGaDDA.HAFGAACHFGAGhAAAbFACdFHE..cEGHSACH..hABAfBEGNAEF.hBAA...,1,-9,-14,5
CQbYPVMUIJGXRBSdWHcZKgDaETLANfeOF,eDCCODEBFFCH..CBAF.QAGE..YEHFMFEEIBCGhAAAJECF.XDABhABASBFHdGGG.HFAFhAAAKAEEaFHDTCAENIBF..fDFFhACAPFFB......hADA...,1,-17,-27,10
dYKXcgNMAfTBGCEIeURSFZaJHbVOWLPQD,BDCFECEHUEGAREEEFHAGZCCD..HCFA.OACALEAH.DADAdHGFhAAAXGCA..hAAAgFCGAHID.hABAfBADCAGCeBBBaFFHJAFE...WHCAhABA......hBCA...,2,-31,-26,5
IRSBEKTgXCfaMZFHYUWGNJePQbdDVAcOL,OAGFRADDEGCF.KAAG..TFFHCHGE.MFAHFGDDHBCH.UEFEhAAANDIG..eBADQFBFhACADBHFAEEHLCCDhAAABAEBgCECaGBB..WBFH...hADA......hAGA...,2,-28,-13,15
PSGAVHFeTMZaWKJRNfCYOcEXQLBIdgUDb,FEAHeCAFMIBGZFBHKGEE..JGDERBEE..CEFB.OFCG..EEDHQBCGhAAABHGAdACHDCCBhAAASDEE.AIHCTBADhABANAIG.fADD.cGFDhACAIAGE..bCGFhAFA...,1,-36,-37,1
NDBaCYUfKJbLVRZecWPTFgQESXHOdGMIA,BFEBCFGFUDACJADH..LDEDZEAB..eCHF..PFCFhAAAFBACEHGCHBCD.GAGEhABAAGCHDAFA.aEHDKGED..hAAA.....bDDG..cGAH.hABATAEFSGCHhACA...,2,-43,-14,29
AfBCKcGNZLOMdTSUQEgbJYVWXFHaRIPeD,BCHBCEHEKAFA.GCCBLDCFdGEAUEBF..QGFGEGGA.hAAAJBEFVABGFBAEHGCChAAAaAFH..REFC.eFABDBAHAIBChABANABFZEEC..MHAGSAHB..hBAA......hBDA...,2,-16,-14,2
QeKdbHRfEMPCBcLZUOXFaYGWNITAVgDSJ,DBEGQFDGKFEHHCCEEBCB..MEIBCFBDBAHELFAEZDEC.OHBChAAAFHGGaDACGBGA.hAAAIBBAACHGSDGEhABAdGGC.fGAE.PAFBcGABhABA......hACA...,2,-19,-18,1
HLRYebDIaSKdXcNGFAMBgOQPUTZfEWVJC,BGFBODBGUCCBZAFH..EBCCJHCA..CFEGLDFAREGD.eHBAhAAADACA..SEBAhAAAdEAEXFFDGAFAACHGMFIHhABA..PFAHfECC..WABGhAFA.....hACA...,2,-38,-23,15
MYVEcSHCgWJaOFbfeULDQXNIKBTAdRPZG,RGECZFBEMBCBEDBGHCFF.CEAG.JCFH..OBCEFBHB..eFAHDGHBXABChAAAKAEAAAAE.dHAHhACAGECE..YADChAHASCADWDHBfBDE.hAIA......hBAA...,2,-31,-21,10
CVYKXTQFNZEIfSMGDUcHBRAJadbeLPOWg,JGCGaAED..dAGFeDAELBAD..PBEHOHBE..CHHDKBGAhAAATEFG.FHEAEGFASCDDhAAADAECHDFGBBCEhABAACGB..gEAA..YHAAhACA.NFBF.ICBChABA.,1,-24,-34,10
WaeTMcGbDPIgKCQVELBJHXAYNdOfFZRSU,dGFAODAFFBDARDCBUAFG..eFHDMEIFGGAFDFDG....ICCBhAAAKFAECDAA.EHDCBBAChAAAHFBFAEEA...fEGAhABASEGETADCPAGD...hACA......hADA...,1,-29,-30,1
caBCbQSUYPXFHLRTeJDEAMdOWVgGNIfKZ,dADEVBFFGCFE...IGBDKEGGaEEFBABCCAFD..SCAChAAAUDCC.XFGDhABAFADALHBAREDHeDBChACADCBAMIDCOGAAgAGBfGGE.hAIA......hBAA...,1,-16,-33,17
XTfVMaOdYWDKReZPCEJSQIGHbALNcBFUg,LBFFBCHFUGDEXCCC..fADHVGFE.OCDGhAAAdGCDDDGE.eEABCHGDEEFDhABASAHF.hACAIABAbGAGAFBBFCBFMFFCaFHDKAFA...hAAA......hADA...,2,-27,-25,2
BWCHPOcaeMERTbKDNVFYAfUQXJSLgIZdG,QACASCEDLDAAZGCABHACCBFBOEHF..aAAHeHDGhAAAEEDH.TBGHDHGAFEGDfFFAhABA.XFBChACAIFAFdBBCWDEB.HCACMFAB.hABAKFDCNBIC.ACCG....hACA...,2,-27,1,28
ZOSEMAIGNDYfHPbLQRVBWcKTJXFdUgaCe,GBDGDEGDHCEHLAFERACGBCAC.KACC.JGCAFEAB.dEHAUGGB.CABD.hAAAeHCA.SEEDhAAAAFGE..IBGBhBAAfAHC.PCCF....hABAbDFAWHAC...hCAA...,2,-38,-20,18
XYTgCKcPeMRBNJUZIFOadQASfHbELGDWV,SDCFHDAAECFGDACB..VGAE..XFDHTABECFGEKAFE.hAAAeFFABGEGJADDUBFFhABAFFBDOEEAdDGDAAGCfEDFhADA.........hAAA......hABA...,1,-23,-26,3
MCbFLcVAaQUYWOPNXdBSKEgTefHJZGDIR,QDDFUBFGOFAB..XGBAdGEEBCDEEHEA..eFCDHADGhAAAGDBBDAGCMCIFFBBDLEHBhAAAAFFHaBBH.PACGhABASGGB.KABCfFFDhAGAIEAECEGD.cBGG.hAHA...,1,-5,-19,14
cFbTadRBZIgPAJYDUOEQXLKMeHSGfNWVC,JABHUGCB.EDBFLADG.MDIBeBGHHFDEGEDB.fAAAhAAANBHC.CHAA.bFADhAAAdHGHBDCHZADDIBCEhACAACFBDHGC......OCABKGGCSAHBhADA..hAGAcGCC.,2,-24,-4,20
DEcTPJaWXZfLBbSVeRUgCMFQdOYGNAIKH,KHDCDEGCECDF..TGGH..aEACXECBZFFALAHH.hAAASGCDRBBACBEBMAHDdBAChABAOACEGEACICABhAAAHEFA.JFDFBFEGeHFE.FGAFNAIEADDG..hACAcCEE..fCFChADA,1,-1,-27,26
ZPAQRDgGKSOVbYLHFUIcWeTMXCBfEaNdJ,QFDHDFBDGAAHKGEFOHFE..VCDALCEE.UABAhAAA.IEACeAGDXGGFhAAACHACBEHAaAGEdHAHJDAChABAAGHERDFF.SDHH..bFBH.FDBAhAEA....cEFBhADA..,1,-12,-20,8
cOHINFESGLbdDAUJeMBYPKWgTZaCfQRXV,UGBDeBEGMEFBBBBCKDEG..TDBBZCCB.CDGF.RFGH...VEGDhAAAOAHDHGBG.IAGChABAEBFALAACdACGABBD.hAEA....YAEEWFAD....hCAAaDDFfFFAhCCA...,2,-42,-3,39
VYaDPeOJSMfRTWKBgZHUALNIGcEFbCXdQ,LEGFGDBHFGAEXACEdDGE..QBBCaGAC.DGIHeCFAhAAAJBFC.SEDEhABA.MCABRFDDKACCBBGChACAgFFGHFCCAFBENEIC.ECCGCAAC.YBBFhADA.....hAFA...,1,5,-28,33
NKRXLfMZBVDeUYCTSIHFgQAGaEbPJcOWd,EGDDJBBC...OABEdGCERCEGLCHBZCEGBFHFeHAE..CGBG.SAFHhAAAFGFBACAG.aGGHhABA....PAEAhAAAWDFAKDCH.fCAEDFEATDAE.IHHEhABAgEAG.hACA...,1,-19,-42,23
PSXDENcaQdgLUVCbHGeZIFKYfTJBRWAMO,MACDSDAGDGFB.EBAD..aAFAdBFDUDBHCGEBHGBGZEEC..FGBGKAAChADA.TDEEBAAGRADDAIACOAFGhAEA.XGGAhBCANDIA...gEBA..hBDA......hBEA...,2,-40,-14,26
eHDZBgJVLUYfNFWOGcARMIbKSCPXTadEQ,MBCHKHACCDGF...TAEDEBGE..HFGFZEAGBHDAJDBC.UEFH.hAAA.fABHhABAFGGHOAAFAEBFRFDFSGAAhAAA..aBCE.eFAADDGCLDDBhACANAEB......hADA...,2,-25,-18,7
eTVRNIMbGFJfQUaCSZEHPALdWDOgXBKYc,LDDAdAAFDFGF.XEAGKAED..eDFGTCADRFCC..MIFEhADAFFDBJHEG..QDBGhAFACFFCEBGGACEC.OHAEhAGABABF...VAGFIHAF.fEHChAAAaFHF..SBBAhAIA,2,-42,-18,24
ZfPLRWNJbIUQeDTXEGcMKCABOYdaHSVgF,BDDHOAAHdGDFHFGH.SECFFEBCZBDGLABFRAEE..JHDAhABA.ICCCeAHDDGABhAAAEDAHMIEGADGA.aGGAgGAGhACA.WEFC..NFED...hADA......hAEA...,2,-36,-10,26
TbMYPReSOJXQBNfUagFKWLZDGdVCcEIHA,TEDBMFABRFEC...OHEEJDAC.BEHHUAAG..aAFDFFBFKABFLFDFhADADDCEGDAACBHF.hAEAEAHB.AHDD..PACGhAAAXAED.NEED.gFGG..hAIAWHFA....hAGA...,1,-13,-37,24
QYcMHWbFAIaZXVLRTCSGBgdUJPNEKfODe,aAFEVFCFLGDC.RCDE.CAHHBAFG.UDEEPABD.ECGGOBBDhAAA.DBAHeFHDhAAA.QGAEhABAMEID..HEAHbEAGAFIFIHGA..ZDBChADASGEH.hAEA...,1,-4,-36,32
BSeMFfVdEOacPJgTUZKbRDIWAGQLYCXHN,QBBBCFHCHDBEBHEFMAABFHAE...VFFCECGF...OFAGhABAaADE.JBHBUGGFZGAGKAEGhACADEFBABABLDDG.hAAANIEF.SGAC.fFDAhABA.cBBA.gAFHhACA,1,-19,-26,7
eCGLAZPYgbdRcSUHFMXfQTVBNKDJaEWIO,ZGCG..PBCF..gADFdAGCREFGSFACUBAHMDIDhAAAQAABBFFEDFCGJAEFhABAEGAFOFEBGAFAAGDH.hADA..bEGHFHBCTDADKGHBaCGE..IDEDhABACAHA....hACA...,2,-18,-6,12
QSTRaVHABPeIgZLfXKGOJDWbNUcdCEMYF,eFABZADHLCGFKAAEGEBBJAFG...DEGB....NAAGUDBDhABAdDCFMHFA.QAEHhADATBBF.aCBBAHGHBHHGhACAPCHF..IFEHXGDH..WFCDhAFACAHF...YDHHhBBA.,1,-11,-42,31
KZCYePAGdWEDVHUbMSRJFcIaTBfQOXLNg,dDHGEGHDDEBEUFDD..MFAEJCAF...FAGB..aGGFBHCA.QADHhAAAXDCGLAFGhAAAKCDGCHEG.eCCEhABAAACFVEEHSGAB..cDGF.hACATBAFNICBZABE...hADA...,1,-23,-26,3
JAGcLeMEWgHVadKZYDRSbNOQPIBXfTUFC,LDGDMDEH.EBECHFFAdFDCZBAEDGDBSCGE.OAFEhAAAIEBBBCCHfHFBhAAATABEUEAFCCHEAIBCeABChABA..gDFEKDDCYAFCNIEDXGAHhABA...hBAA...,2,-27,-12,15
fBKQDOJLHSVITYdGcgCMFaZPNXAbeWRUE,eCCDRBAAUFFDBHFG.DEGAOEDHHFBA..SAGH..hAAATCFEdDAEGABFhABAgAFEMDDGZFGFNICF.hAAAAHDEEEEDKDBH....JEAH.IADDhABAcGACaAEA....hACA...,1,-8,-26,18
MXDYJbeWKOBfHTQZFCVcaERGSdAINLUPg,LGBEUABBMAEBDCBG...JAEHeFDFKABC.BDFCHCFFQAFEhAAACAHA.aBHFRFFCdDBAhAAAIHEA.PFGFhACAYCHH.....OHAEZFAD.hAFAFDDHcCCC..hAIA...,1,-20,-22,2
ROPGDagEMbQKFdBJCfNUASVXcIeLTHZWY,SBGDXCCG.eABALHDCHCAFZGEGRAACGECHDGAE.EAEEQEGDhAAAdGAFCBHB.fHBHhABAAGGCIDGAYDDAhACAaDAFMFIBFAHFBHAH..JFCC..hAFA......hAGA...,1,-4,-7,3
FOIWHPUSJdXbNGTLBZQaKceRCAVgMfDEY,MECCEHDGFCDF..ODAHHAABUAGBdGFC..XCBCGDFGBAEEhAAAaAHB.KDBAREGBCBBEAFCE..hAAA...VGBGDDIBIHHDhACASACB..JHACTCFD.hADA......hAHA...,1,-14,-22,8
UMaAKWgVFLcfYNRBbPDCZdOETQXIGJeSH,KGAEVECHFAEA.LFFA..fCBARDBEBBBA.DCEDdHCDEHFEhAAAQCFD.hABA.XFADJAHFSAAFhACAMACEAFFEWEHF.gAGFhAGA..cADCNBBDCHDH.hBAAOHFA.,2,-26,-16,10
EFKULJYWeGdCIBgOfHVAXbPSNMDaZRQTc,XGFASECEDFGERBFF....QAACEBEAKGCCLAHFhAAAJCHBeFCHCDABBCFAOFECHFABhABAABDG...bCCDMEADhACAaABE.ZGFE...FCCC...WDABhADA......hAEA...,2,-18,-15,3
AYSTCcDPMfbadQeVBgXOJZKEIWLUFRNHG,SCFGTGEG.CCDD.DDBB.MAIF..aEFAQGBFhAAAeAEABABAOCEHZEAFKGHFEBCDhABAIFFGUAFCNEACAACG.hAAA.PHCCdEGC.XECD.WFADhABA......hADA...,2,-34,-12,22
agXWEQAbOPLGTcCIUJYdVHBRKNSDZfMeF,OGCALAECGBEFCBEAUFDHdHGD.BBCBKCCA.DEDG.ZEABMEHHFCAC.hAAA..aBAC...hABAXGFHEAGEADHCbEFETCFChAAA..IAEFYDAH...hACA......hADA...,1,-25,-30,5
FfIMYPBXZQeEJCVKDbHcgALadUNOWSTGR,dECFOGACSCGEGCDDRAAAFAED..MIEGBGEFZAEAeDAC.JHBChAAAVEGB.DDAGHDGDhABAAFABUECGTABD.IHHBhADA...YFFB..hAEA......hAGA...,2,-21,-21,0
ATEBRKIQfZXWNbYGLPcadHFCDSVeOJgMU,BBCHRACHQAGEZBDD..XAAF..NEGCGEAHLFHDhADAPBAFdHDDCHAGSDFBhAEA.eBGBhAFAgGCAAFEGEAGGfFCBYFHHaGAHDCIH.hAIAOAED.MFFDhAAA.KDGC.,1,-16,-18,2
deaYKTLASXJgODRQVbZPMENfFcCBWUGIH,SEAFJBGD.DGGHQBCCZBFB.EEBCFAACBHAEUFBFHFGFhAAAdECBeCCCKADCACIDOFDChABA....hACAREGDPADGMBBHfAFFCHCDICAAaHECLAHBhACA...hAIA...,1,-11,-28,17
BTZRFMfSAJgaCcQUKIHeXDGLEdbWVPYON,aBGFCFDDUFABHFDB.eEABDIFA.LABA.dFFDVCECOCACBDHHhAAARCFDMCIB.AIGG.JABDhABA...QFFGhADAIECEEBEF.WHAGPAEC.NEAF..hAAAFHCE.....hACA.SAGE.,1,9,-32,41
PWKDYFegMTLAXZGEfSJOBQdVRHUbcCIaN,XAABZFDEGBBD.ECHDJAFCBHBG.dEFBVFFHHEBA..UDAGhADACHGE..aAGG..WDEEhAEADDECeAAA.MEADhAAAAGCFODCF........hAIA......hBAA...,2,-40,-11,29
TfOaBSHKVWGNEPCDRMecgFXbJLQZUYIAd,TACFOBEBBGBF.KHGGVCEG.GECBEHDG.DHFAeBAAFHBE.hAAAJEGDZEAD..UAGFhAAAAIEAaABH.HAFG.PEHFhACACDFAMDAG.XFDE.LEAEhABA.....hAEA...,1,-8,-22,14
AWHVDOPIURCBZdNGgaJELTbScYQMKfXeF,HBCBOACDUCGFBECBZCAHdGBEGGBH.aAEFLAEG.bEFChAAASFGB.hABAQAGFfHDBhACAFEEFACBHDGAHIABECHHAJCFEEGGA....hAFA......hAGA...,1,-8,-27,19
ANFXUdeLHPTMgYGOQSaRVIEfKZbBcWJCD,FDDDdFEFeCBCLHFAHEBFMBFDGAFC.SFHBaEHB.IDEHhAAAfBGEKDAFBHDGhABAJEBFCADE.AAHDNBBFXBADhAAA..PHEA..YHBGhABAOBHD.....hACA...,2,-25,-9,16
ZgCPJLGQKbBUAdFVDTIREMaSHWXNeOfcY,VBDETCGF..RFAF.EBFF..SEEEHGEANCEA.eHFE.OAFAhAAAcACD.ZFAEgBAGhABAPCBBJHBALDAGhACAKFFCBAFCAIDADGGGMAADaHCG.fDGDhADA....hAEA...,2,-12,3,15
PUDLCbFSJGTIAeOagcEYMNKfXZdRVBQHW,eCABOAGD..aGGHEABD..MHACKFBGZFDDdDFDRBCAQDAChAAAHAAAUAGCLFGBCFBA.hAAASAECJEHDGEDAhACAIDECAIBE........hACA......hADA...,1,-2,-30,28
AfODTPBSWXbeUJCQKdaLEFGIYcgHNRZVM,OFEBTGCC.BCFB..SEEB.XAADbAAGJEAGKBHDhABAaGGHLAFDhAAA.FBDBIFHGhACAgEABRBDBZDFEAHAHfEGHDGBBPAEG.eDAEhACAQGFHEAGF..hADA...,2,-26,3,29
WSBEKZQfAgVTMebdYOPIFDLHGCacRUNJX,VBCHeAAAdGAB.OAEDFAFBHGCC.CEEC.aDFDUGFC..XFGEhAAABBHCKBAFZBAGAHAB.MFEFhABA...PEBAhAEAIDGGDHFGLBHBREAH..NDIC..hAGA.SGCHhAHAfAAB..,2,-27,-15,12
gJKDEGQRZLePdUNbOHTVBAfYICaFSMWcX,..IBDHFBHBSFBA.MEEBXFCAKBFDGBADQAABhABALHFEPAGHhADAdDAGNAAHOGFA.TEABhAEAAFGBCEBBaDHD.gGAGJHAEEHFEZCCE.eEEGhAFA.....hAFA...,1,8,-19,27
NMdZbPGKEDWfcTYHOQIgJeBXRLAFaSVUC,FFAAaGEA.UDEC..CCCH.dBBBZEAGGAEFDCHF.....fFGChAAATAEEHAAAOCHFhABAIHBB.eDGDhAAABGEC.XCACAIHCNAIGMCEDKHEGECABYHAEhACA..gGCBhACA,2,-36,-14,22
cRLJYEVgTQFKADBZWNdebISHUaMOXCfGP,BEFFZEBAdHCFeCEG..IBCBSAAGHFGDUFBB.aEGEXEEBhAAAGCAD.PAFGhABARAEEJHEG...ECGB.hABA..gCDC.FCABAHIFDEEHNBIG.hACAMEAD.CHCD...hACA...,2,-21,-3,18
gAPCGWJUSVadMDXIFEfZNeQbRYcLTBOKH,CGCEJCFGUFEE..aAAGDEAG..FDDHZACH..eEGBQAFDhAAA.RFAD.LGAEhADABBBHKDEAACBHGADB.hABAWHEGSEGH.MFIHEFFBfEABhAEANIDH...hAEA...,2,-36,-27,9
eUcOYaDZIKQVFNEBgWdJGTLMPCSRfAHXb,HFDDeBBAOHBADEAGZBGFQACCFFDC.EGAEBFHC.dGACTDEEhAAALCEE.CDDDSABChAAAAHGHXBAD.hABA.cGGFIEACKFBE.gGGAhAEAWHAAMAFC.....hAFA...,1,1,-34,35
MVEIbJZKCgSWXLcBQPRFYTedaDAGOHUNf,GABFUAACMFFGEHFA..JEEDZAEC.KDAFSHAELCFABHGGhADARBFFFECG...eEDHdEAEaCCEhAAADDCEAHEB..ODGDhABA..HFAFNBIAfCAHIECACGGB.hACA......hAEA...,1,-14,-22,8
aPXQMOeKbDTIgRcUVACFHLBSWNGZfYdJE,HAGFSDCHGECCZEECdHED.aAAAQAAEOADC.eBFADFFBTCDBhADAgGBBUFAEhAFACEAGFHEEBGGE.fBBEhAGA.EEFEMBDG.IDGDhAAA......hADA...,1,4,-24,28
eVfMCTEWcIbHFGOdJZPDRBUXKSYQaLgAN,eBGFMFGH.CBAB.EDCA....IEEHFAGBdBCHZEEBRCBHBGBEKDAHQFBEhAAALACEAGHD..hABA.NIAH.fEGFhAAA.TBDB.WAHBbDGF..OACGhAIADHDE..SGADhABA.,2,-35,-13,22
bHdVMCBfXeRcOgYPTFZJAGEKNQDaLWISU,GDDHKCAHDFGCLDEGSHDEHAEEdADBVFGHBHAF..eBBGRBBBOHAEhAAA..gGCHhAAATBDHFAHDACGBEGGFhABANBAE.aCHF..IGABUEABMFFHCCGG..hACA......hADA...,1,0,-13,13
PIZYTEOfdCcBMVUKALSQHJFXWDRebGaNg,LAACQDGGFECEDFCARFEHGCGC..NAAB...IAGDhAEAZEEFEAGHOBBECCBCBCDBUGCAhAFAABFBSEBChAFA.XGAEWEBF.aGGF.....hAIA......hBBA...,2,-27,-21,6
QWKUOdAZMbGNaLfcTJEDRBPIVYHSXFCge,MAAEGBDHLHBA..TBAHEBGHBBDFIEBDHFBEXGGAhAEAFGDDeDGFKHGCdDFHAFGEhAFANDAG.aBBB..JABCDIFGhAGA.PCDFSBGE.CEDAgGAHhAAA.WFFD.hAHA...,2,-13,-6,7
NZCXSaObgPUJeWERDIGdAcLHBMfKFQYTV,LDECHBEDMDABFGFBQGGF.TGDAZFAESACAhAAA.ODAAPACAhAAAeHAAEBBGIEDHhABAABAGcEFA.BHBC.fCGCYBHHCHHHaFFGhAGA..gAEHhABAWAHBDGBG..,2,-18,-12,6
YACDJVfWTdZGBRFMbcaIHESUOgLeQKPXN,CHACDDHF..JGFEVFBG....TCGBZDDCBAGFRACG.MIBEaEEG.hAAAHAAB.EHGCSBAHhABAOBFELEADhAAAeHBCKAFCXADCADDFfEAE.WFCAhACA....FFFH.hAEA...,2,-39,-6,33
UaPTSdZHYFRDIVcJgWACOKBMfGeNELXbQ,KBCEBFGBMHCAeBDGLBFHQDCH.UGDHTEGFZAAHFAFGDEAB.hAAA...VCACgBGHhACAAHHGCFDH.GEAGhADANICF.XGGAaGADSAHF..hABA......hACA...,2,-29,-7,22
aHZEMcIFNVAQKTYBfXdSWDUbPeJGCROgL,KADFBBHAdFHASCFDUEFE..eAADGABFRAFE.LCABhAAAHECHMFADIECE.hABAFGCCNIDF.AABEQGGChAEA.fGACDDDGbEAFCCGG.aCCC.EEGAhAFA.cAGG..hAGA...,1,-16,-18,2
INYQcGPdWAbREOeCVTKJLMZUXHBgaSFfD,REFCeGBECCHF.KHFALBAGZADCHCCBBGHF..SEFDDCGH.hAAAIABEQAEBhABA.PHBEACCFOHBChAAAJDDH.MAFGUDAAXCFA.aFHF..hAEAfCEE.hBAA...,2,-28,-19,9
ZaEHUODFPYLXecBMIfbWAdSNQRJCVgTKG,SADCQFFDRDDGCAHG.....TAAAKDFFaCAAHBFG.OFBEhAAA.DFIHPEDBhAAAXCAEBCFBMACChAGAICHGfHAHWEHFAGBENIED.....hAHAgBDFEDHH.hAIAFGFH..,2,-39,-6,33
NRECZUXKTWGOLbFVDYAeSdPHJcQBaIMgf,SDBDHDAHJEHFBFDEMCGB.....NBAF.EHAAZGBAUACDKEEBGCCAhAAAOGEELCFBhAAAFAEADHFAAAIB.eAHHdCAF.hABA..PDCAaHGEgEGHCBAG..hACA.WHAG...hABA...,1,-5,-22,17
eUSIJPgMHAVXfbWCRYLNTZdGFDQBaOKcE,XEAC..fDAGCCGGLFFCZABCdCCHGDCHDEFGBBAGhAAAaAHBOFCHKHBE.EHEAhAAAeAHB.SHGAhABAPFAHMCAEADAAWFDHNEHA......hACAQFDBIGGD.hADA...,2,-35,-6,29
HZdbafKNJIMYARTFSOCLXBVQPWgEUceGD,FGFACABFBHDAQBBB....gDEEEBGFUFAEeBEDhAAAHEGFdDBCaEGG.KCGGJFCGMGAGhAAAADAC...RADASHAGhADA.OFFHLFHH..hABA.XAEBWCCBDHBChAEA..fHDB,1,-13,-29,16
gTMCLYKGFbZefEOBSAPdDXHUWQcRIJNaV,DFIBUFBDQGDARBDA..ICHDJDCG..aCGF..VEEBhAAATBBBCABE.LEAHhAAAKAGEGDAFFAFEeFCFhABAEGHBBEHHAADCdFFE....WHEGNAIE.MFABhADA.....hACA...,1,-17,-19,2
UBcaQIDTfeYMAgFHOSVREGWPLbdNJKZXC,HFBHSEAGEDHHGAAELCCAdCEAKGEEXAGEBAEH..aHGGQGDGhAAADAGF.TEFFhABAfDCFeADCAHCEhACAODAHWBBF.PAHH.....hADA......hAHA...,1,-10,-21,11
WdABUVCSPfIcTJHabFeNDgRZYQOLGEKMX,UFBHCHHE..SBBF..IFFCJCDAHCGFFFHDeDDBhAAADAHDZAEFQAGDhABALDBCEEBHMICC.dABChAAAAGHABAEC.fGFGaGECNDAC.RGACOCAHhACAKACH....hADA...,2,-25,-13,12
NMKaAGPXebWCcZdFBSLYVJHfDOEURTQgI,GEDDeEFBCCEF.dBFAFHDESDAG.LABFJBBDDDHBUBGHhAAAQFAF.IHCHhAAAMEABAFBC...XGEGhADA.cGGFZFBEBDDG..YAHBhAEAfADDOCCAhAFAEHBA..,1,-2,-46,44
PdHTAWKYIfEMbUgeZLVXSOBCQRcGNFaDJ,KHDE..IHHEMCCCUDACeHCCLAGDXECDBFFH.QDDAhAAARAFDGEFAaDBBhAAADABGdHGBAABD..YCHBhACAbDFA.ZADFSAHHCHAA.cFBDhAEAFBCF.....hAFA...,2,-19,-9,10
TMEZdGXbHIPgDYCLfOacWeJSRFKNAQUVB,QCBHVDBF.BDFAEFECdAGEGDGCHAED..IBAFhAAADCAGCHDDLADDaAFB.eEHDhAAAJGBCFADBAEFE.MICEhABA.ZECC...XAGD...hABA......hACA...,1,-8,-26,18
SfRPEGQdXMUIaTDOZgcBWYHVJCKeLNAbF,SEEGRFCDEAEF.QBFDdEFGUABC.aFBGDGIB.ZAFBBGEAHEADhAAAJCAGKCHFLGAGhAAA.AGGB.fHFHhAEAXACAIHHFODBG.WAFC.CBACNICD.hAIAFEGA.....hBAA...,1,-7,-19,12
SUePagNMOLCRIcWEQAfXGJbBDYKHdTZFV,XGGCJDEEBECD.DCGHHADD.ZAAHFAAA.UDBDeFHD..aBGAMCIBhACALHCARGAG..hADAIHEGEEHDAEED..hADAfGAC.bBCEdAFE.SGGDhAHA..NAEBCFFF.hAIA...,1,-17,-23,6
FTBXJKPVSgRNWLadMbEUcZCGeDQOAfHIY,HBDGFCCFBCAFJEFCKGBD..VGAERDAA.LEFAdGGB..MAAHhABAUGGFCAFB.DBAA.AAIB..hACA.fCGFhADA.TEDHPCFCNIED.aBFG.EEBE.GEDChAAAeBBCIAHGhAEASAEF..,2,-22,-20,2
FQLPSDdKMJfCYGVAOHBIbENeRWgUaZTXc,OFCGHADFBGFH.EGBEeDEGRDEF.UFGBZCAF...XAADhAAAFGAHQABBLADASEHHhAAADHACMCEECEAGVAFAhACAAIDC..IDCB.NAIA.WHEG.hACA..aDGF...hAEA...,2,-26,-3,23
WVJTQZSOUNFDeYCaLEPHcbAIMgdRGBfKX,MFDEdFCARAGDGBAGKAAF....XADDVFGD.JAHHZACHOGEEhABAFEEADEAB..CDGGEDAHhACA...HFAAAIFCBEHEhAAAfDDB.WHDGQGAEhABA..NBCG.aGDD..hAEA...,1,-16,-22,6
RNaPdQCIGgSfUVLHAKFOMBeTEZYDbJXcW,OAAHMDBCBCHE..EHDGDCFF..JBFGXGDFREFE..NECE.hABAdACB.CFBCGEEBhAAA.SHAAhABAUEDGLEABAHGFKAGCeAFBYDFC..WBBGhBAAaBDDIHHH.hBDAfCBH.,2,-26,-21,5
AFBGgHJQREKfCXdVMaeNbcPTZOIUDSYLW,GBBDJDDE.EDEDKFBHCFHA.dACA..MDGFeGFG....NHBD..hAAA.PAFCTBGCOHEChABADGACSCADhAAALBBDAHDDBAFAHDGHfABH..hABAaAEBbEAE.IHHFhAEA..,1,-11,-29,18
LRQdbaPDKYVZBONIFWMJAXgfECUSHcGTe,XEEAEEAHUGGAHCFEGBCDLEDF.QAAEaGDADEADKGBBhAAAVADDZBAHBDFC.hAAAOEHHIFEBFHDCMAIBhABAAAHGCHFFSDAEeACC...dGBE.hACA......hAGA...,2,-14,4,18
aBgNVILFRGMOTCWAKHbYSEXUfcQeZDJPd,KHCGHEDA.SEHFUDBFQDGAeBABDADBdAGHaGAHBHHF..hAAANHCBLAEHFBABRFDGGAEEhABAMIFE.CEBHACGF.EBHBhAAA..fHAF.....hABA......hACA...,2,-23,-13,10
AKMTGCRWONcQbJBUgIZVdDfaLFEHYePSX,KADBGCBBRGAC.OECEQDFDBGHCUCGHZCAH.DBECLDDDhAAA.EBGGeHAE.SAAAhAAAACCDTGGCCAFFNADB.hABA.....cFED....hAIA......hBDA...,1,-25,-33,8
fWeYICFZGXULQJRdADVcaKEHOTBMgSbPN,DDFGVECEKABF.HGCG.BBHDMABF.SBHB..bDBFhAAAPAEH..fFGBhACAeHFACGBCFCCBXAEFhADALHAGJEDGAGGHaEHDEGGBOHACNAGC.hAAA.WCAD...hAHA...,2,-30,-10,20
gVcZOEeXRfFIPGNWCUbMJQLaSAdBDTKHY,BBAFKBFEHDFA..VEDDZFCBEBCBREAH.FHGCGAEH..CCABMADAhAAAQCADLAHBhABAAHCGTGFE..YEBHhACAgCGCOFFBfCCD.hBAANIAF....WAAEhAEA...,2,-31,-11,20
LOKaZedfUHQEVcDYFMgBATJSWPXGRNbIC,TEGAJCCD..SCGD..PDDDRFAG..NACF.IBHGhAAALFGFOBAChABAKBBD.aGDCeBEHfFAAhACA.QAEAEAHHDICCMEFFBEAFhADAAHHE.XGBHCAAF.hAHAdGGD..,1,-9,-31,22
RaJNYFMdBbXCeHAGgWIfcEZTKPOSQDVLU,GBGC..IEEDEGECKEAF.OFAFSBECDAAHLHEChABAaBBC.JECHFGCDBCHChACACEEDACFA....fHGFhAAATADCQCBHRDBBMACE.XAFFhADA.gEGEhAIA..,2,-29,-19,10
eVgKNQDYOJUIcRGaBfdFTLSbWXHPCAZEM,MFEGVFAA.KBAF..DHEAOEAHUBBF.RGEE.BDHG..FBHBSBEFhAAA..WBDBhAAAXCEHHFBFABFGEGGEhABAeCCB..gAFB.NIAD..hABA......hACA...,2,-33,-32,1
eaERCLDQbOVYKSTWXJcAUFZdHNIfPGMgB,UCFAdFCFHDAE..ICCHfFGAGFBDBBCF.ECHFCEABDACChAAAOAFH.KEECSAFGhABAXGAHAAHENIEH.MABChAAA.aGDCLAHH.bEFA...hAGA......hBAA...,2,-25,-17,8
HXNSCAFJRMcWEBbQeaVKLTGOPDUIfgdYZ,RCDFMDFDEFAH.BGGD..eFFCKCBD.GAAHDAGBUFAB..gGCHhAAAdHDBHDGBSAEFhAAAFCGDJAEA..cDABhABA....QDCEaGHH.hADATABD.IBHEhABAfHAH,1,-7,-40,33
IfcHeRFPQLaGEUYBMATJgDbSNWZXdOVKC,TCDBJFGH..DBAHSEGFZGCA.OHACKECBCDBA...IFAHhAAAHBDHFAFGPDCBhABA.LCHBhACAEBBHBFEDABCHNBDBdBHA..fFEAeEAB.aGHFhADA......hAEA...,1,-21,-35,14
eMdAUKQfCDVgaTLBWSEROIJZPYNFHbXcG,QFBECGCGDAIH.aHGABCAF.EEEAIACHZGFE...PEFAhAAAFCDGHDAC.XAAEhAAAcGAHGBCFhABAdBGCAFAAKHAGVFDC.LAFA.WBBDhAEA..SEGHhABA..,1,-13,-29,16
THcVQXPAUMRJKNBfeZLgabEYCdWGFSDOI,MCDCJEACBAAFZDEALFDC..aHEAEHGEdEEAGEAE.DIDGhAAATBGE.HADHhACAcCAFQGBChADA.AIECKBBFNBAH.fGGDeAFE.gDGAhAFACCHHSGDA.hAGA...,1,-11,-32,21
AYUdIScXEDOVfegTLFCQZaHGWRJbPKNBM,UDBHSDBEEEEG.DFHDOHEG..VAFEeACFLEFFhAAAFBGACCFA.aFCFHGAAGADAhABARADF.JFABKDGGBBBBAHIDIAAAhACAfCHC.......hAFA......hAGA...,2,-19,-16,3
TdbQZMVAJOIKUPFBcWNfGYCeRaSgLHDXE,OHCCUAGDFADHBADB.....NCAE.fDDGGCBFCBHD.RAAB.hAAA...aFHDSEEDhAAAHFBBEDFBdFFHQFBBhABAMIEEABFHKDGEcGGAeFAFDFFE.TABGhAFA.....hACA...,2,-26,-13,13
QKFMBdHSAVNZRLDeCfGJOcWXagYTEIPbU,ZBBGLCCDDCFG.CEADGGBHOADA...XBDHaEFC..TDBBhAAAIHHH.UAGBhAAA.QEEFhABAMDFCdGGBSGBCACACRCGDJABG.WHAG.EHEGhABA.KAGABGGCNCAC..hAFA...,2,-20,-10,10
LgOEDGUaAMfIbPJSHWKRecTXBFdNQZCVY,MFBE..fEDH..IGBDJEGHSGDAhAAAKGGGRBAFeCDATGACBEHBNADFZBEGhABA..CAEGLAGBhAAAEEBBDACFaBDGAFAFPFEDcDGA.FABA...hAIA......hBAA...,2,-28,-21,7
XCdKITfcRJLgHANYPZSMVQeGbFUODEaWB,...PCGHZECDMFEF.QCBBeGACFDDCDACGaAGC.BHFBCAADdGFBhABAKAEG...fBABhAAAJACGHBEEAFIBSFCEhABA.bFFAEHAE..XAGBhBCAcCGD......hBDA...,1,-14,-32,18
AHBbDJMXWaZVcefPNgEFdUTOKCSRYLQIG,BFCDJDBF.MCDA..XGEFaGEC.ZBGFeDAC..fEDDhAAANFEB.EABBFDEAhAAAdADHTAGG.CFAASABFhADARCDEQGCDAIEEDIGEWEAD...hAEA......hAFA...,2,-34,-20,14
JIHVgNTUKROMDLXZaScQBGAfdEYFWPebC,EBADFCHBeCBD..CDDGJBBCHABA...NFEF.UFGAKGGE.OEADhAAAMBGBLFAGZFBB.hABASHAGBDGGAFEFdAFFhACAPDCA..IHDF...hAAA......hABA...,2,-37,-23,14
FfHRLKESDYBXGUTVAbJQgOIZdPceMCaNW,JCEAOEAFZFGB.dGGB..eEEHCAGC..aDCGFCCF.HFAHLEEFhAAAEACC.DIBEBCAFUABCAAFB.hAAAQCGD.hABA.PAHFMIFGfADH.KFCFhAIA.SFFChBAA...,2,-29,-27,2
CfeQSVOZJYAPGTbIXRaBHMLNKdgDWcEUF,GCBFTDFC...IACCaHFAHCBEMAIBLEAG.dBGHDDHDhAAAEBAFCEBHQEEDhABAOHAAJABC.AAGEXGBBhAEA.BHHGNEEAWFFGFBEESFADhAFA......hBAA...,2,-23,-5,18
ERCBYbDgWZTOQIANPefJHMcULdXaFKGSV,eAAFHDAGMFDFLGCEdBFGFGFDSAGE.EDFFCDDBBFAE.hAAADCIBgBCGhACAZCGHTABFIDBG.hAAAAFABfGHGUGAHaEFBKBAFRBFGWFBD.OHEEhADA....hAEA...,1,-12,-16,4
eMgKJGNEHRUZfIDYSFOWQaPLXVCTbdABc,BGFHMCFEKHGGJECG.GCBEHBFCZCAG..DFFDFEHDOBCA.QDGChAAAaCECLEBFhAAACAHAdDDAAHEB..eABANACB.hABA.UGBHIAFHSGGE...hABA.WHAA...hAHA...,2,-23,-20,3
RDfSHZWIVMTcJgOPYLKeAXQdBFGNCaUbE,dDFCFEGACBDFUCCF.RBFE.DBGDHFBBZFCF.....IDAATDDB.hAAA..JHFEOFFFhABALBACABBCQGAChACABGEBaEHF.EDAC.SAFCWAFC..MAAChAEA....PAHFhADA.,1,-17,-36,19
WBEQIRDVHXAePKLNTZcJFfMaObGCdYgUS,KFEHLADCZDDEFBABaGDC.GAAAdDHE.UGFCBEBD..ECDFQAEFhAAADEGCHEBEAIAEeFABhABATBGB..JCCCMFFGhAAACDBB...SHAEIGGGXGCChACA....hADA...,2,-36,-2,34
BPeKbIJNGDTQYZcWdfLgFMaUVOXRSECAH,BHEFKDBG.JDFFGGDD.QAGCZEGBdGAGLECDMEIHUBDHhAAA.OFAFRBAACAFHHBFChAAAeDFC...IBAEhABADEED.TEDB..YABChAFA......hAHA...,2,-34,-8,26
bKBaLdNORXceHAEVYfZQJgUMGWCIDSFTP,VCEHZADAJEDE..UABAGCBA..CGCEDFBDSFGH.FHCAhAAATAGH.KGFAaDGAhABAdEAFOFAD.XAGBhACA..eEHBACBH.EADC...hAEA......hAFA...,2,-36,-28,8
ABfgGHWJRYUbELXIKFQPOVMdecaTDZCNS,BEGHGCABJFDFUFGC.EDFFLCDE.KBHBFAED.QGBFhAAAODAD.MEAFeAEEhAAAaCGFZBBHCBAF.AIAC...hABAfFDB..gGGDhACA.WEFF...hABA...,2,-35,-25,10
geIdHOBTKNEZaCfQPXUAcFDRLMSGVWYbJ,DGIFMAAFGEEG..VECC..bABCJFGB..eAFEdAHCBEAChABATEAGKFABZCDEaGCHCEHDQFCAhAAA.hACAUCAFACCFFCEFSHCG..WBDChADA.IDHD.hACA...,1,-10,-36,26
MPQOSdFDLJUaBIRcGbCgXKAEHZfNTWVeY,ZEFETCFEeAEA.MBACOADH..FHCCDBADUEAHBGAB.IHFBhAAARBGBGCDC.CDFEKHGChAAAEAFHHCBF.WEHHhABAPCAE..SEFG.dAHC.hABAJEDD.....hACA..aBBB,2,-17,-10,7
eKRHLDVNdZOXMQBIfFJScGAgCTYEabWPU,TEEEECGE..aAAC....bBABUDCA.KDAALGAChAAADDGBdFFDZFACOAED.QCCChABABACBIHEFhABAfBHE.SGGCABHA.CHEAWEAGhACAPHAE...hADA..eBCA,1,-25,-27,2
MgKJDcUQWLZTdCFPGVHfXSaBNbReAOIEY,ODGHEAFC..MBEHKFCGDCFBUBBGLBAAdFCEFFEC.GAEHHCGHSEAFhAAABECFRFADAEAH.hAAA..IGHBhABAJFHD...WFAHCHEEfEEENIED..hABA......hACA...,2,-33,-13,20
PDQBUXbNIGHfFEdLMecRJOgWTSKCYVaAZ,DEEHUAGE..XAEG..ICCGGAAGFCFHLFFHhAAAeHFAJBHHOCAB.TFDHhABACEHGaFFH.AFHGQCEHhACABFAAHGACdDCGMBCC.gGBDhADAWAFE......hAEA...,1,-11,-28,17
KAZYXeVfPDdcQMLIHFSNCRUTbgaEWOBJG,ZADGXDABeBHB....VCABDGACdHFFMIBGHDEH.FAFBCHFGRFEGTACGhAAA..gDEChAAAaAHHEGCHBBAD.hABAKEHBAAHCfFCE..cCCEhABAIHHF...SACChAFA,1,-16,-26,10
OYacPgTKNQLCDFSAXeGVURBEIbfZWdJHM,XFBFVAFD.BCBCEABH....IDHFfEHG.dGDFhAAAMFECaEEC..PBEDhABAKECHNHAFLDABhAAA.CGHBDGEGFACCAAFAUCCHZAGDWEAC...hABA......hADA...,1,-19,-24,5
dYWAVKcHZBLRgJaGbeXOfSQPMCEFITDUN,KBFEHCBFBCDELBBERFEF.JHBGGBAA.eHAGXDGB.hAAASFHHMDHFCHHCEACFhABAFAGG.DBFBdDDHAFEGZFAGhAAAaFCE.OGEA.fDDB..hABA......hACA...,2,-25,-17,8
cDMKQARSULHCFINYdaOWZbXfeBEJgPGTV,SBCFHAAECHDAFDAH.....ICFDdCHEaGHDZCEBXEBFhAAABAGB.EBHB..PGEGhAAAGEEH.cADEhABAKDCBAAIHRFAANDAEOHEC.fGHE.hACA.eBDCgGBGhACA.DBBF,1,2,-21,23
PeUOgATSBMNDdYCXJQREIFcKVWbHaLZGf,TFCEBBHCDCDE.dBCGCEEB...QGACEAFFFFGEKHEG..VEDHhAAAHCABZGFE..fCDDhAAAUCGHAGGC.MAHDhABAXDACIHHA.WACCaABB....hAIA......hBAA...,2,-28,-26,2
EVNDAKGYdTRLbfHBaPMFJcgSWZUQICXeO,GCCETADH.LEHDHFFCBEGCaGBFMBADFGBH..JDCE.SBAGhAAAUBEGCEFAOHDGhAAAEAGFDFCCAHAFdAGA.fCBAhABAgGDD.WAHH...IDADhABA....hACA...,1,-13,-28,15
YgcHWEKBVIDSMAbZXCdJeFOUfTaPQGRLN,ZAAACBADdBDBeCCD.UEFFaHDE.GGCFLDAA....gAEGhABAHEFCEBGCBHAChAAADAGAADID.JFACFFAFOEEHhABA..fCGFQGGB.YDFEhACAKCAHIHHGSAGChADA..,2,-27,-4,23
fKaGdgWeITLXRJCUSNbYcZBEFHQDAVMOP,VBCFOCDC.KBHBGGEB.dDHEeBAGLFCAREBBCGEB.UAGESHGEhAAA..NDAG.hAAA....cEEFhABABEBCEBADFDAGDACCAEEHfDFE.aGBChABAIAGD.JDHFhAFA...,1,-12,-35,23
ZDFIPEVAeUfNGHJWLgSaOXMdcYRBTCQbK,eCHFUBDE.GBAEJHEC.LDFD.aEDBMGACdAEA.RAAHBEEGhAAATGBD..QEGChACAKAGGDIEGFACCECHBfHGBhAAA..WEAC.SHBGhADAOEHD.....hABA...,1,-11,-33,22
ZHDUWSQYAdceMbNCORTKLgaJGfIEFVPBX,eFDDMGAC.CFAG.OAEHRDAG.LHFA.JDAAfCDEhAAA.EACFVEGDBBFHZBAChAAAHFECDFBGSHBAhABAABIBdEFBNDIEKHAA.aAHFFBABXEEB.WAFBhACA......hADA...,1,-12,-19,7
SVEUQeCDNgIYJZRAHPGaOdWMXcKbFTBfL,GADCaDCF.dDBDMEABKFBGFAHHBDGF.LBEAEHEE.UAAFQDFAhAAACDHA.DGADNEFC.hABA..IBBDhABAZFBHABIFOADAXGGFTGGDSFDE.hAHA.....eEDHhAIA..,2,-30,-14,16
EPVCYZIGLfXAMNaSBFUeQKWTdDbgHJORc,aCBBBFEE.UGCBQGFBKCDD.dAFBDBFHHEBF.JCDCODADhAAAEEFG..CBHAZAAGLFHDhABAAHDGMEIDFDGC.TABFhADA.....gAGDcDDC.hAAA......hABA...,1,-16,-37,21
HEdbXUTDQCPRWaYNIJcFGZKOMgABLVfeS,BBCGVDBB.SHBAHAEEEFEG.dGGE.UBGCDIFCCEGH..RDBC.aHCC.hAAA.IFABJBAE.hAAAGAECKDDCMAIBAEHBLABChAGAfGACeEFF......hAHA......hAIA...,1,-19,-20,1
LQPXHaNUEAfWcbKFZCBgOYSIJTGVRedDM,...fCCAbCCEFAACBDGDOEFC.SHEAJEHBGFADeFAHhAAAdDACDIDGQCFDhABA.XADFhACANACFABHDKFFH.CHHDIAGA.RFCCMBBFLAHHhBDA..aCHFEECE..hBEA...,2,-21,8,29
TeONXZQCPLIJSBVaYFGUcRfgdbEDMHAKW,TCFFeBAEODHH.ZEBCCDCELFCA.SBBGhAAAaCEGFBHFUGADRADGdHFFDIEAMHBEhABAAFFDKAEAXAGB.hAAAIFABBDBEYDDGfEDH..hACAbGFEEDAG.NDIG...hADA...,1,-14,-21,7
HVYEbDBQIMNUdPRaTXFOALcZSgCfKGJWe,ZEEACACAGDFEeHBGHDAC.ECGABEBC.MFADUABFdGBHaHEAFDEBAAHALBFFhAAA.SGAFhACAKAEBJBAD..hAEA..WHEA.......bCCBhAAADFIHNBIE.....hABA...,1,-6,-38,32
DgKYMBFNWPTJLQGdVZIfOHaUbXERAceCS,eAFCCGAGDCAA.KDECBEEFFDBD........PFFALFHDhAAAQAAHdADFIGCDhABAOFAHUGEDEGCAAIGASCBAhACAMHEA.TBGB..JADD.hAGA..ZBGDfEBHhAHA.,1,-12,-47,35
EeNYVTBRDZUbSfdaJWKFQgLXPAOMIGcHC,OHEEMDCGGACBHACFeEEB..VDGDBFBBDFEHZAFHUCAESCAHhAAAdAHA.JHACFFABhAAALEHBAIDACGCD.EDEEhABA......YFFF..hABA......hACA...,1,-12,-28,16
SgAfBIdOGCKbDZLPVWXRQYUJHTecEaMNF,BECBdGEGCBBD.DBAGLFCF..PCCGVAEG.RAFE...UDGDhAAATEADEHGA..aAHFFFHHhAAA.ADAD..OFEHhABAbEAFZACBXCGG.JHAGcFFEMACASGFBhAHAfDEA..hAIA...,2,-28,-12,16
NADBdgTeKGaPIYcFOMVHWJLXbSRCfEQUZ,BABETGAHKBFF.GGEFaECB....IBFEFDDHMAFGHEFGhAAALBGHSBAAhABACFGE.fGEEhACAUEAHAAAFDBBHgCDB..eACHcGGHhADA.WAGB...hAEA...,2,-35,-5,30
aGPTAfCXdLbDEBcgUKHRQWJNMYISZOeVF,CABGLDFCDAGD.EFCGBFFBUAFBHACB.QFADJAAF.MEBEhAAAIHHE.SGAChABAeHECFCFHPDHHhACAABEDXEEEdHBD.....gCCGhACA...KHEAhADA...,1,-20,-32,12
HDVceSRBAJPEKFfMWLdQaCZUbNIOYTgGX,EEFGFFFFMCBFdAAG..CDDEZFBAUACF.....IEDFOHEETAFHhACAGFAFDEIHeCHDhADABHEDADBF.KCEGLCCEhAEAQAFFaGGAYHAA...hAAA......hABA...,1,-12,-36,24
TFZNHfMVbXgOJPBIRQcULKCYGaSEdWeAD,DCADZDCHHBEDMEBE.XABD..gFGEJGFCBDHCRDADQBFEhAAALHAACAGAaBCB.hAAAdFBDAIFC.FHEE.NBIA.fADFhABA.OEFCIHAE.KBDBhABA.SAFChACA.EHCC.,2,-26,-12,14
WLNJCbAXYMQVfRcZDdUHKIaeBFSPTgEOG,MBDBVFEH.RAAH.ZBCADBFCHDGB..KEBGeAAHFGFA...SEAHhAAA.TGBGhACAOAHDLDDACGABAFIDXGCBhAAAYAEG..fEFB.hADAdAEGIHHEBEEGEHEGhACANAIG...,2,-41,6,47
cQgUOKWdZfYECLHNTIJXeABFRDSbGVPaM,RDDFSCFAGGEF..VBBFaAAH..MDDHQGAFUGFCOEEChABAKAADdBFCZBBD.EAEFLFFEhABAHGAG.IDHChACAeBFCAIAEDDAB..cDAH.fBGFhADANDIE...hACA...,1,-5,-10,5
IbBVdKHUYSPJEZOGMcQFRWeLCADXfagNT,XFAEaCGD..TGDDBFFDKADAHFBDUCEDSCBH.hAAAEAGEOAHDMBAFFFGFhAAAeHFCCEEBDBBD.NDIA.bCAFhABA.dEHEJAFHZFCD........hACA......hADA...,2,-24,-6,18
HcDLYGVCAEbMBUJKfFIOWaSZTXRQdegPN,MDCGBCGGUEFEKBDE.FBEFOCHF..SBADZGFGRDAD.dGAAhAAAeGCC...gABDhAAANDDGHBBDLFHBhABAVDFDAAIB.EAHBfAFDIEAEaHCC.hADA......hAEA...,2,-24,-19,5
MgdEIbQFBASYeWDaPfCXUJKLcHTRZOVGN,eHCGDADF..aDEACAGFUCGFKAFG.LDCFHEEAZCAH.OHEAGDEEhAAAMAIFEEADQACEhABA.AHHESEHDhACAWEADXGCH...JCCH...hAFA......hAIA...,1,-17,-24,7
TXJReWbOdBGLSNDYEQPHFgcZICAaVMfKU,MECDKGAGUAGF..JCADRDEF...eDHHOCBEGGEDLHFAhAAASEDCDAEB.EAAAHEGDhABAFFDEZBFEAFCB.fGAEhAAAXDAC.bACDBACG.....hAEA......hAFA...,1,-15,-28,13
ZDNOESWdPVLCUBbgeMJTfAacRIYHFXQKG,aEDFRCGFHACF.QEBAZAEDOADBEFFEdCAHLHBGUDGH.BBBFhAAAeHCCTAEHAFFB.IHHChABAFBGGKGHFDGGFNCAASEEDhACA..VEAACAHB....hAAA......hABA...,2,-23,10,33
HROKLIYEfGSbdTQMBPVcUWXDeCaZgNAFJ,JFBCHDBD.KEHDLDBEEEEAGGDFdACBMFFBBBDE....PAFHhAAAUAFHDABH.CDHAZEFHhAAAgBGH.FEAHhABAIGACSACF......hAEA......hAGA...,2,-38,-17,21
MLDeGEcCQJSAbVZafRBWHKUPTFYgXIdON,VDFA..aDHDBEEGKGDCUCAAFBAA...XAGEdBDBOEABhAAAMAFDDGGH.GGBHhABACGFAQGADADDF.ZECEhAAAfCAG..RABGWHDG..hABA......hADA...,2,-33,-25,8
RNaLXTZUJGEWHgCBeFIbQSDAVcYKPdMOf,VECHKABAMEDG..OCECRGBCLCEAZABEUGFGGEAD.EFFFHAFEhAAABAGEFFAF.QCAFhABADADEAIAE.PEEGhACAfHGB.XBAC..WHAGhADACBEB.....hAAA...,1,-6,-29,23
QeIdaUPSXGZLYOTKCBMJHWVcEfAbRNDgF,RBBFDEBFFBEHQBCE.dEGDaFED.SAHBXAAGGEEGhABAZAFFLEAFOAFHKGGDhAAABGDGMFIFJAHF..hACAVFBGfECAAEFG...NDAEIHGBhADA....hAEA...,2,-20,-20,0
IDKfUPLaJSBTXHeVZYdONgMCbGFWQERAc,DBIBKAHDUGFBLCDH..SDFFTAEEeHDEZFAD..dABFNEIG.hAAACHDA.GDAG.FBBFhABAQDCEAFFF.hACAfBDHaGCBBAGE.XDGDYEGF.hAAA.MEAH.EGCH.hADAICBH.,1,-6,-23,17
eBPQMGDZXSaWIcEYLRTAgdOUHNJVCbKFf,ODBEUGFBHFBD.JBACCBBBKADC..eAEABGEB.QGBFhAAAMBIBGDBHDAIDZEFFSEFAhAAA.IHDBhABAcCGFLCAFADADdFAG.....hACA......hADA...,2,-36,-15,21
PYRELeSMHJgGAdNaUDVWIcFQCfOBKbXTZ,dDCAaCFF.DGAB..VABA..IBECFFBF.QGDGhAAACHDHBHHEKHFG..XBBChABATCDE.PCGF.hAAAEGHFeAEESAEEJBHBAHAE.NBIA..cFEAhACAfFGD.OEFHhABA.,1,-16,-37,21
QfgFJLEdNGVRYAUSMaDOHbeTBWPXICKcZ,MADGDHGEHCCA.eFBABEBB.XDGBCHEGKAEG.ZDCBQAADhAAAFGFFLHAEdDHCNEACGAAFhAAA.RAFAAGEFaBFE.TFEAhACAIHHA.fEEDgDAB.hABA......hAIA...,2,-20,-7,13
acMFbdAVXZEBKSGeITHCRYgOPNJfQWDUL,XBBEEGCCBABGKCFFGEEA..eEFHIFBFCBHD..REAGOADHhAAAJAFFQDGEhAAA.DHGGaCACMHAEdGAAAHEDhACASDAC.YABENAEDfHGFhBAAWHBA..cAGFhAIA.FECA.,1,-22,-23,1
fXeOMJPUgRLFcAWNHBVQaIDGECSKZbYTd,HDGBBADEQCEFaGBEDAFGGCAACCAF.ZABF..TGGAdCFGeFFBhAAAJFBB..UGEARADF.FDGEhAAAAAIFNEEG..EAFE.KBBChABA.....fHCH.OCDHhACA.MFFE.hADA...,2,-14,-12,2
eYbNTaGCPURdAWESZJBOVFKLHfMXIgDQc,SCAFJEFGBHGD.FAFDKGDEHFFH.MEBH..XACHhAAADFAFeCDB...NBIGGECGhAAAPBAHRAFFAHFHZABBOEBAhABA...LFBFIHHH.gCFAhABA..cGGFhACA.,1,-1,-47,46
PEMDFSJIUAeNCRGKgOZfacYVHbdQWXBTL,CCBHRDFFKCBCZGDC....aFDAVAEB..HAFHdEDG.QEABhAAABHFALAHDMIBESADChABAUEAFACAD.eAHHhACA.GEGEfFHG..YBEFhAHAWAAE..TGAHhAEA.DICE.,1,2,-37,39
cLMUNFHafdCXIEZPBGKbDVeRTSJOgQYWA,LGFGMIFGUDABFEGEHGCAdCAF..CFBB.EFFBBHBEKBGC...DBAGeDDBhAAA.SBDBhABAJAHH.QDFFhACAAGABaDDA.IBBHZDBA.bFADTAEG.hADAOHDC...hAEA..WAAE,2,-36,-8,28
XHBDPNUTQIASROadbgGJELCKfZYFcVeMW,OHAGdCBBGBGELEDCCDEFZEAF.FCBH.eFFBMFAFHABGBACFDCAHUGFGhAAAQGDC.hABAIAGBSFHHhAEAaCFA.bFCFEFAG..KGED......hAFA......hAGA...,1,-6,-22,16
ZODcTALEVCfgQJIXPNMBSbYeGHRaWKdFU,VBCBCBHH..QBED.JGACPFCABHGG...SHDAhAAAeCAGRFDAKEBEFHGAOABEhAAATDAC.ADHEEGBGhABAIFHAMEEEbAFG....YDFGhABAaFGA.WHAGdACBDAGAhBAA...,1,-16,-25,9
OIDKCFaBbXQSMTGRLVJdecWHNYZfAUPgE,UCGEEBDCDIFGKEDB..CFGB.BAHC..XFDAMFCDGACF.hAAALBAHJCHHeCBFHGFGhAAAZAFDAADDOFAB.hABAICCFaHBEQDDCTCEAdFGBNCAA..hABAfABC.hACA...,1,-15,-20,5
IgfDSeTQHFdBKaZPGCLEOJRUNbYcVAMWX,MEDBXABG..ICEFDAEH.eFAFTDDBHABFBFHGZEGHCAEBhAAAEDADREEB.UAGH..hAAANIDD.bGDA..YCHHhABAACFFfDGC.SHACFDABKGBH.hADAPFBC...hAGA...,1,-8,-17,9
BKedbSZGTYCQDXROHfVJIFPacEUgANWML,MDFCKHACdCDEZAAEGAEF..TCAFQFEGREGBHFCAJBBHIBHFhAAAFFCF..aEADUAEDhABAAHGHLAAEBDCAeFADhACASEGGCEEDDIFG.......hAFA......hAHA...,1,-7,-19,12
KGXZNFdEIYPMWbRLeDfgBCaAOVcUHQSTJ,OEEFVEAE.UGBGHBBA.QGDE.SFHFhAAAKAGDZCBAdABBIDGAMFAFREGBDIFChAAABHAAAECG.JACC.XDDAhABAEEAE.PAHF..WDFE.hAFA......hAGA...,2,-31,-12,19
NRbLfGQdHCDMVXUBeOYSFZAaPgWITcKJE,aHDG..gEDD..IFACTGGAKADCEGHHbADFGAAGhAAAHBAEDBFG.MCIFhACAXDGABHCAYCDAhAGASFBHAFFC.PFEG.cCEE.hAHA....JAHB.hAIA...,1,-6,-25,19
NVdGSDBRcTFPaUCEZAJXIObHfKeLYMQgW,XGBBOAAGHEBGKCEF.eBHBLDHF.MCCHgADFhAGA.NHAH.dAHEGCDHhAHASBCBDFFHREGDFCBHaFFDEEAFhAAAAGGD.IHHC...fGDFhABA.YAEAhACA..,2,-13,-6,7
PUeZNTAIOaVLRQcYWMJCESHKDGbXgfdFB,aGAFLADD.RAFGQDFC..cBBFMFHBCFACSEDEhAAAHECFDDIBXCAGhAAAfBFDBHAAPHFChABA.eFDDNICFACBEIABHYCADECHH.hAFAKCEA...gEGGhACA,1,-16,-22,6
DTQNXCROZAYHLWVcGPJIBUESMFKedbafg,HCBALABEVFCCGEFG.JBFBBAFGUDCFMHFG.FAHHKHACeCFDhAAAdFBH...bABGaBCFhAAADEIB...NIAH.CDHA.hAFAZEAHAAIH....WAGB...IHHAhBAA....hBFA...,1,-9,-32,23
TEXVMIHfeONGUPSQCYcWLFKbDaRAZgBdJ,BCEATAABEDHD..MEEFHGDE.OBDBUCGBSGFAhAAAQGAHCEFH...YAAEhAEAcAFAFBDA.KDAAhACADCGAAGIHdHAFJAEEICBHfCCB..eHFAhAIA.....hADA...,1,-9,-27,18
EVXOdcPSCbKfAMBRgGYNUDQTFWLJeIHaZ,MDBDBBFGRAABGCDFUFGB.DECD..FFEFLHCA.eBACIDCDhAAAaAHHZEFG.EGGEODAHhACAdAEH..SFADhAAACDHBKDFG.ACCB.NHAH....QACEhAFA....hAGA...,1,-7,-40,33
ZcDVRILCMKJQGBdSePETbYXUOFgWfHaNA,ZDFDDCDBRBEHLBDG.CGHA.KHFAGDDESBCFEABC..TFAGhAAAXEFH.FAAFfHBFhABAHGBCAACAIAHAhAEAMAFGBAEG..dEBGPHEC..hBAA......hBHA...,1,-17,-28,11
KAXCIbaOPFHQeZcRBNYUWSgTVfJLEMdDG,CDACaCCD..FFEHQFEGZBFGBAAB.UBFE.SAAF.hACATGAEVFAGJAFGMAFChACAGDBDKADBAEGEIBBEhADAODHB.HFCHeACHNEIA.....gGGAhAEAfHFF.hAFA...,2,-34,2,36
eGMQNTcbVUWBPaZHgDSOFXRfYEKJLdAIC,eCAAQCGF..NECE.TGBC.VCBAUEGE.BAADPFEChAAAaAFGZDEB.DEDFSAFFhABAFEAH.fEABhACAEACAKBED.dHFDCHHFMAIFbABA...hADAWHDCOEHF..hAHA...,2,-25,-8,17
eJSPTDGfXZNWFgBIRYHbQVcMUOadLCAEK,EAGFeHBC..SECETADFGCEEZAAHFCGEBHFARGFCHACBQCBBhAAAMFABUFBEOCAHhABAdGEGABEGKAHDDFFGNDIAgFAAhACA.....YDGBhADA......hAFA...,2,-9,-6,3
aSeLXWMIRBUVCNOAKbEcgDTYQZdGHFfPJ,KECFEACADGFCQFGC.dAHEFCEC.JFBGaBDDLHDA..hAAAXDAFMCIDBEEBhABAUGEGCHBC.AGAD..gAAGhABATAGGZCABfAFG.SDHBhACAIDCE...hACA...,1,-21,-36,15
dDBZCHVRaGAfeKYMOTIXbWPJSgNQLFEcU,KCFAMEABODEB..IEHE..bGFEJBDA..NBDC.FFFFhAAA.ECBHdFACDACGCCBFHEBBhAAARDDCABIB.eADG..hABATGBHPHCESBGH...hACA......hAFA...,1,-22,-32,10
agXJSKbeGZUDVTCIFfcRHAWQNMBEdOLPY,QGAAMAEFdBADLHBEaCFE..JBAAKGEEGDBFZBFGDGBECEGCFAFFhAAARDAE..AAFC.BCAGEHGE.hAAAOFHD.PFFBhABAXDFH.SAFA...hACA......hADA...,1,-24,-25,1
KRCOHXIUdTYfcPQWFbMNVJaeASEZBDGLg,EDGEZCCBBFFCDIAE.LBHBKEFF.RBFDHAABUAACdCDA..TGGDhAAA..fAFEhADAQDAFFGHBMHCEhACAVEAGaFACAHBA..SAHBCHAC.IHFDhAEA...PFDDhAGA.,2,-36,-10,26
dRCYOVKBMcgbQUfGWZAHPNaSTIFLEDJeX,HFBFaDDD.TEDEFBCGLCFDDAFE.eHCEdDGACBEE.OBBDBHFEMIAChAAA..cGGEhAAAbAFA..QEAEhABAfBGB.WCADAGGGNADFECAEJGEE.XDGEhACA.....hABA...,2,-28,-1,27
LFaERKPHUfcSeYVQBbOTAdMGZDNgIXWCJ,dGEGMBIDGCFADFBE...IBBBCFHGFBBH.ECEHRCEHHADA.UGEAhAAAfBDH.hABASDACeHBA.hACA.YGAEBHFBOFAHAHHBZDAG.gGBBhAAA.XDBEhABA..,1,-12,-21,9
FWdCPRBMTVKGfgDbLAZOXaHEeQNcIUYJS,ZBFCaGACHCGFQGEE..IEAAUGADJADHSGCEhAAA.dACCCEFGBABEVADGfEFEhABADBGAAGHBECCBeEAEhAAANIAHFDDD.....WFHH...hAEA.MAFA.KDHD.hAGA...,2,-23,-12,11
KCBPGIDaAfVOdXbUWgNRYJSLHFQZTEMec,OGECXFGEUABH....NCDGRBAHSDHBLEEAFFAGTDDFhAAA..EGEDMFADhACAKACEBHCBGBEBIHAGhAAAaGGAAHBDdFBD..gCEGYAEE..hABA.HAEC...hAIA...,2,-23,-6,17
BFJdOMUTKcLVISNYXQaZGEfgRAeCHbPWD,CDCGHEBF...bCDBDGIHBCBEFGCCdFAA.UABBKHDCLEGDhAAA.SAFGhABAXAGFZFFDfACHhACAADDE.eHAG..WAADMDFE..TCFFhACA.....hAGAIEEA.,2,-46,-6,40
VAJQgZPdXefUEbHKIBTMGSacRDFWNLCYO,JDDCZGAAdGHC.eBEBUDAEHCAABBHGGEAD.aGEBRFGHFHAE.LABGhAAAOAEGAHFG.QAAHhAAA.PBGDhACAXGDC.fCGEKFFC.MCCEhACADAIB.CFFF....hADA...,2,-38,3,41
cAYIWHbLGDEaVeCSUXKfQTBgORJPNFZMd,..IBDCHEEFbBDEDBIB..EBBF.aGAACAAGUGDD..KEAAQDFBhABABHGEODHHhAAAJDAFFDDDMAIF.AADALHBGhABAeAGFSFBHfDDCTGGG.hACA......hAFA...,2,-25,-14,11
GNEfTDKadCJVZWQSYMHbgALeOcIBXPFUR,eCBDOBBGBAFEFAHFGECAEGED..TABAaFEF..dFACJDGBZAEFhAAA.QGGBhABASFDCMCHBHCDCAEECICDEhACAPHBC..NBAADGIFCDAB.....hADAYAHH..hAAA...,2,-25,-6,19
XPCgcWGSUDVQTbZdRFANYOBIMaEfJeKLH,OEADMCIB..aAAHEBAF..eCCEHEGDCGCC...gCGChAAAGADBDGECQAEDhABAZDDCdHDBADAGBEABfCCChACAKGHBXGAHPEEBSFCH.hABA......hACA...,1,-1,-22,21
ZSQfUVWAEXJTODYNbPeLgGIFdKcBRaMCH,XGFCTAAA.DFDA....bCAAeAEDLDHHGDAFFFCFKEGAhAAARFEHMAFDZAGDSGBEhABAQAGFUBBHAEEEEEAChAAAYFAFPHACIEGHBBFBaGGACACCfACDhAEA...hAFA...,2,-11,8,19
LaBQPIHONTegCGZVYFSbWDXMfEAcJUdRK,JFDGUFAC.KHCGBHDG..QEECHCECTBBBCDBH..ZAECFGAAhAAA..SACBhAAADGGCMBDGABACdDDCLEAEhABAaBAEOHEGeHEG..gDGB.hACA.....YAHHhADA,1,-20,-35,15
REDcKFQUISCdeHWAYZbTagfMJXBNOPVLG,ZEEDTGEDaCCC...MDCGBABG.OBDAVDGHLBBDGEABDICAhAAAFBGGUGGCCAEH.dGACHECBhAAAACHC...gGAEhABAfEGF..XACDNACF..hACAEGCC..cGGEhAEA.IEEF.,2,-17,2,19
UZVAHJgDRLPbOGFXCdEIWNaMBfYcSTKQe,JCBDDADGRBDCLAEG..OFEDGDCGCCAE.ECGG...IBADhAAANAHA..MDDDhAAAfEGF.SGEBhABAQGACUGAAAEEBPDBFXGGHhACAdGGDWABGaADH.BEGDhACA...,1,-6,-42,36
WBEHROCDJYQNUMKLgIaGZdAebXcTSFPfV,XBFBTBGE.FCBA..VEDHBABAEBDCOBHF..CFAHDFCDhAAAQEAGMBCDKAFCLGEAhAAAaGHH.GEDBhABAdDDFAAIBeBAFSHAG.WHDG..hADA.RADB.NDICIHFDhABA..,2,-17,-10,7
TSIUDaWZKfCENQAgGeRMdPHOJFLVXYcbB,GCAGRADGMACF.dFCEHDCGOCDFLCHH..VCGHXGDChAAA..bAFESHAEhABAIHHG.DGAAaABFKHGEhADAEGFBAIAEeFFGFADBBHADTCFF...WAFEhBAA..CFFB.NBBG..hAAA...,2,-16,6,22
XfHeBFUVQARZYSMGNdgIDbWTLPKCOEJac,ZCBFMDFAGGBDdGGGDBDG..TCGEKBBA.CADA.OEEB..EDDGhAAAaFAEXGGB.hAAAfFACBBHHFHAGQAFGhABAAABHSAFGNEIG.IDAF.hACAWFFCLDAC.hACA...,2,-28,-24,4
gJRUIYVcWPMASKTNBdOEHbafXCLFZDGeQ,SEDAKCEABEGGdBCGOGDEHAFE...aDCGXGGHLCGFFFEHhAAADBBFGCAEeFBBQAEFhAAAJHAG.IHHGhABA...YFAFcECGMACAhABAAEIB.NDIC.EACF..hACA...,2,-21,-16,5
RcIWOdBDVCXQYJSUEaAfKbGZFgLMTHePN,KHGEZCAFLADDHEDHeCFERDED....IFHGdBEGDBAHCCBC.QFABhAAAJAFC.SGDDhABAEDGEAIDCGGEDMGFAhACATFCG...cAAFBAHB...hADA......hAEA...,2,-25,-17,8
PMOcbIZLfQCeAKUFdXWVGREBSgHJaTYDN,KEBGFACDdDDC..XEEAGGBBEEGHBBBEHBFE..aCAHDIFGMEIDhAAAOFAB.IAAGhACALHCC.fCGEhABACHHEAEAA.WBDCSEEH..hAEAgCDF.hAFAYFGB.,2,-35,-16,19
QeXScCPNDZJWARbUfLdYBgKOaMHVFEIGT,UFADdCDCBBFBKDAG.MBIFHDFG.FCDCGAAC.QEFGhAAAeGFCXBAACHAA.DGDDZFAChACAAHID.fFHAhADALBFEOEEBaAEGEHECSAHFNAAB..hBAA......hBCA...,2,-18,-15,3
AaZFCMOcTXbHJfGUVQBDNPYgRKILdeESW,ZFBFFCBEMEDEODCG....XGDEHDFHJACGGEBCQAGEhAAABAGBDAFH.PAAChAAAYFHD.KCAFIHGBhADAeFFDSGAFADFECEGA....hABA......hACA...,1,-17,-28,11
dcWLDEXSBegMbJaGRKQOAfNPZVUTYFICH,...PEFCVCEFUFGBFBED.HDADdDBBLAGDDIAE.XABChAAASBBB.eHDEhAAAbEBE.aFAHKHCAAHHBZADEhABATGGACECA..cCGABAHAMACA..hBAA......hBEA...,1,-11,-19,8
DFWZgIKfLEeXOUcHQaNCASVPbdYRTGMBJ,VEFCdDGDRABDGDEE.BDACJGDCDDBFZGAC..KECELCCB.hAAAEBAAeFAG.XBEChABAOAGB...UGGGhADAcADA.aAAGAAID.SBHH.hAEAYHAA.MCEHhAFA..,2,-24,-21,3
RCdQXNbKEcWgOBZfJeGSIYFaVHPALDTUM,LCCHDHAGUEAB.CCGEdAAC..QAAF..bEGDEHGE.hACA.gFEFhADAOEEBfBDHJFAFGADDhAEASDGDFCEHaGDH...HBGHACIDMIFChAGANIADWADE.BCCD.hAHA...,1,-10,-21,11
ZTGFgJWIePRVOEMCdHcfDNaBbSQYXLKAU,ZBEFTDFHGDGG.JABHeGAC.RBDGOCBHMECDHGDE.DBGFBGHFhAAA.SAFAhABAXDDHAHACFHCG.IDDBhACAECADCEAG.fHFDNAIA.aABE..hAEA......hAFA...,1,-17,-21,4
UMJFAYHdLaZTEbXGgcQfKeCRISVDOBNWP,dFABaHEAZBDBECHDGCCH..QDFAKFFFCEFE.IFCGhAAADBABBAHA..NAEHUCAEhABAMAEEABDE.LGBAhAAAXABE.fHBHSGHBOBFC.hABAWFFAFBBBYHEGhACA..,1,-17,-24,7
fTWCGYHeVgUAOPNRQEJFcdaDKZMBIbXLS,OHACRFDGQDBGFCEE.dHADDGFHZBEHBEAG..XBBALCDDhAAASHEA.hABATCGEWCHDCAGH.GFABhACAeAFEgAACAHHAEBBA..aDAAKDADhAAA.IHHEfEEDhADAYFFC.,2,-27,4,31
bLGVgKHNJfQeBYWdDCMZcXaESRFUIOPTA,GBFCVFDG.KAAGHBAA..JECHeHAGBEEDdEBADGIBCHHHZDDA.aAGAhAAAEDAD..RADGFDHHUACGhAAA.OHEEACHA..hAFA.LCHH.fGAA.hABA......hACA...,2,-28,-14,14
GMPbcdWIfQLHgNEYBUDZCFaeRKTXSVJAO,ODACGCAFMFCE..bDFBdAHA.IHGBLHBE.gAGEhAAAEGECBFAFDEECZACACHHAhABAaEGEKEED..SAEChAAAADIHPFACWBBGQGCA.YBAEhABAFFHB.TBEAhACA...,1,-6,-24,18
dFUHcTBPVMKWEORDZJgYfLQeCIAXbaGNS,aGADGEBD.dADGFAEGHCBABBBHMFGHKEDF.EHDGRFFB.ZAFG..JCDG.hAAA.fBAHhABALDHBQDAChAAAIGAHAIHANDIGSHCC.TAGHPCGDOEEGhABADAFE....hACA...,2,-27,7,34
KITSMeEOZJADfVGNQWCaFLdcgHbPYRUXB,DEBFVDDDGFCD.QBDEaCBCLGACdBABHAFF..PACGhAAARCAGBDHGKCECIHFHhAAAMCHBEGGHOHBEhABAABHC.NEAA...CAFHcGDD..YFFChACA....hADA...,1,-11,-21,10
gGTJcBOQXdWPCeYHbNAfRFaLZSKUVMEID,FDDCZEGHKFCEUFCH..EADBDBAFGCDF..TAFDJHAC.BHGEhAAAQAGB.dFFEhAAAPDHDeCBH.HDADhABAAIEEaBAD..LCCC.MBBA.IFFEhACA.OHAChADACABE..,1,-18,-21,3
dSZILDAQTPJcUKNaeWHGEXbROVYgBfFCM,TEEDJDBH..UFFAKGGG..eBCBHBAGEAADXAFA.OABAhAAAYAFE.BGCBhABAfDDCMIEGSDBHhACAZGAGDIBAAIGA.PDFAaEHF..WFEDhAFARADDFDAB.CFHBIBHAhADA..,1,3,-28,31
IECXTPWDJHdBbeVOZfYQGLcFgAUSMNaKR,MBEAKCADEGED..CGCH...XDDBTBBCDDEBHEBBBEGHeBAGZEABhAAAQFGCLGEGFDFGhABAAFFFNAIE..RBEEIAGEhAAA...WFAD.....hACA......hADA...,2,-40,-2,38
HRfFCZIWTbKdXQBOMANgcLPVJGSEeDYUa,...NECA.LFFC.JHEESGEHeCBCDBAHUBFGHEFHRBBEFGAHhAAAIGAE.bAFDhAAAXFCBBAEDMBIDhABAADDH...PEDDEFAE.aDAGCAEF....hACA......hADA...,2,-32,-15,17
YNgdePfRSKCJWVDZaXOBTQAGHUbMcFLIE,GAECHBGHUEEFMCHFLFACEBBD...NADG.dEBB.PEEBhAAASAABKFHBCGAH.JAEDDEABhABAZGBAaBDBBFHG.AAIB.hACAFHBE..IHHE.....hACA......hADA...,2,-20,-19,1
aKQfePNHZDTYVSLCGAbFXdMEBJcgOWUIR,XDBEEAEGBDEG...JAECOHEE.UFCGICFDRBAF.KGEChAAAQFFH.hABAeACBPEEEZAGBDGAEhAAAVABCCEGEAECCFHGE.dHAHMCIF..WDHB.hABA......hADA...,2,-22,-18,4
GIbVdSeAOBUfCNLMPaTDHZWYQEXgKRJFc,OFEEUCBBCHEF.LECD.MAAEaFBAHBGFZAEH.QGGFhAAAEBHHKGHHFBDHGAEE.hAGAIABHbDFAdBBC.AAEDfEFChADANIAF.TGBADEBF...hAHA......hAIA...,2,-12,-9,3
JCXcgOZIBHKbEAMTaSWeYRdUGQNLfFPVD,MEBFTAGE..aHGEeEFF.dGDAQFFGLAAEFCHDVDCFCDDF.hAEAXAGFOEBCBGGAhAFAKBCAEAADAGAC..SBBGhAGAWFADUCGHfBEEDADE...hABA......hACA...,2,-16,-16,0
ZVIUWMPcfRJLFGQedDABbEaCTOXSKYHNg,BBFFaFCH.CFHF.OFEBKGAF.HAFBZEDA.UBCD..MDAA..hAAAfHFBRCFCLBBEhABAQDACDICGAEAB.hACATDEG..SGCCNABHIAHBPHEGhADA..FGGA.hAEA...,2,-42,-6,36
EAYbGKVPcZLWaDHMSTFCJgIdQBXRNfOeU,GBGAKGGD..VDCDPDAFLAGF.DABGHDEB.MBBGhAAASEHBTGGBCCDCJEADhAAAIHAEBBCDRADD.NACDOFCDhABAEGEB.AEIH.....YHBAhAFAcGEC.aFFA...hAHA...,1,-16,-20,4
HLTQeWBcVENOfdFGbXYSPZCaRMgAKIDUJ,DFBBUEAFLCBGQBBEBAFB..EBDCODFDFEDFGDGA.hAAA.XFCHSFFDhAAACGHEMBIDAHCDIHADhABATABD.eBGF.WADENBAGdHFH....hABA......hADA...,2,-36,-8,28
eDBdULgObYSHXKMfCEZRJFacQTNIGAVPW,VBFHeFDDBHBD.UBEDLACE.OECASBABHBAFXGFBhAAAMFIB.fCCBhABAZACBFAHFcFFEhAAANIAFAHBA..DAGCdEEF.gFACKEHBCHHH.hBAA..ECHB.aCAH.hBDA...,2,-13,-12,1
AaUKHdeJGSgbIFRBWNQOcVXCTfLDEYMZP,KGBCeDBDGADD..SDFH.bADBFDDC.BDABNBIA.hAAAOFDA.XEGBhAAAfHCFDIBCEBAEhABAMFHFAIGGHGDEdEEGIGAA.QBBEhABACEAG.TAFFhACALAHB.,2,-27,-5,22
QgdBfXIYEAOMGZUcaHePKWVCDRbLNJTFS,OGFCZGAEUCDHHAFHKEFA.CACD...DCIDREFELECD.TBAFhAAASEBF.dGGEhAAABFAB.IHAEhABAAACEMBDAaBBHeBEB.PEDF..WAFEhABANIEB.....FHEGhAEA.fCGE.,1,-4,-36,32
cUWQZbLPJXeNaTBdAGHIKSMRgVfCFYOED,HCEHKGFDMFBEVBBB.FGEEEEHD..UFAEQBEAZADALDHDhAAAXCBG..NICFBHHHhABAADEDICHH.gGCDhAAAfAGDCADEDBBE..cECDhACAPFAH.aGGF...hAEA...,1,-14,-16,2
DcLJQefKMYNTWAgXbaGUFIdBPSHVRZCEO,XAGFGBDAFDBFdCBBBABBHEBDRDFE.ZFEG.CEEG.DAGBLEAD.hAAAeABGfHCDhADAKDGEMEIHTGGDADEA.aEAHhAEA.....IAHHSADEOFCChAFA.....hAAA...,1,-18,-21,3
DLPETWFHQYCbJaSfKVeRIUXNcAMdOBgGZ,dDCHBBECZAAGLAAHEHFA.FFCAQAEG.CAHE.bDEAaCHHKAHHhACA.eAFHUFDFXGFChADAAEFAOEBH.DGAHPHAChAEA...TCCH..WHBAhAAA......hABA...,2,-30,-17,13
QcIBNfWbGYdXCRgADKHTFJOeMEaPUSZVL,DICGTFDFFHFC...eDHBEEGH.UAFDZCDALEBHQCAHBCBFhAAA..fDDFhAAAGADHdAHECGGAAAIFKEAFJEADaACGhABAVACF..IFEBWHFG..XDFDhABA....hACA...,2,-22,-13,9
BGaYAbeNMRFCZgPHdQKcUIVfSETDXWLOJ,eCAAMFGHFAEECCGB.ZEGHHEED.QFBDKFEHUEAD...IEADhAAASBHHEABADGIHhABALHAEBEDCYCHBhAEAABCBRCDBdBAG..fBGAWDDE...hAFA.OHBC.aGGBhAGANAAH...,1,-15,-20,5
MSIacQZDYFNWCUVPHKGEXdLbeAJfgORBT,JBFDOFEDBGEG..TFCF..ICBGaEAFZBDH..DACEFDDHhAAACGHB.UFGHHBAEKGAAXAGHhAAA.LAFFhABAABEC..fDGHMIBGSGGDhAIAQACE.NBAE..hBAA...,2,-49,-13,36
WCKQfYDGRXgNUTLaIEeZcJOdVHPFbBSAM,MBABCHGBKFAG...QEBADBECGEEEXAFB..NADA.TFFAhAAALCEG.EBAChAAAeBGH.ZBBEJHBAdFEGhABA.PDHDBEHHSEAEAICAfDDDYAFChABA...hACA...,1,-15,-32,17
PHLeFYUECROJGWbdTSQDXMZAfagKcNBIV,aGCHKBADBEFA..VAFALFAG.FHBAEBBCRFGF.JBEHGBBEhAAAdEAD..SDHHhAAADAECZBEEAAIB...gEEAhABAIHEFeDECCHGE..WDCB..hACA......hADA...,2,-32,-26,6
NaPMXSEYgJOCWdReVLZTBGKQfFbUcHIAD,aEDFXAAE..ECGHJFAACBFG...dHBFeGFELDCCBBCBKCDGhAAAFEGBUADDHFAFDHEAMFFDhAAASEBB.hABAOAFAWAHH.........hAEA......hAGA...,1,-28,-32,4
EFSafeYJgTCIMGVDbWdNOPZHcLABUXRQK,XADDKBHHFGFA...SABHeBCGJDDE.CAGDGEFG.DIAGhAAAdFBFODDFZAABLHAAhAAAUFAEEDHFaEGGfHDBhABA..TAFGIDBEMIFEWFHHhADA.....hADA...,1,-9,-32,23
UZVSbEPXLcGQONHWIRJBaefYDdTCAMgFK,MBGDFBEGUBAEZAAA....VFFDSEHD.EFDHPCAFhABALEDCQCDAhACAHAGBIGAGJAHBeFBADDIHhAAACHAHAGADKFFD...XEAAODHF.NACDBHHEhABAaAFG.fCCDhAIA..,2,-15,-6,9
JbTEaWXOZdFUMRBVceKCINfYQDAPHgSLG,HAAGSBCGJBFA.EDFBaDGH...OEEDFDHFRGBGBAHD.eCAGhAAAIHDA.NFAH.hAAAfEAF.hABADEEFAIAAPBDDgADE.bFFGXGGAhADAdGAG.MGAAKHFGCHHB.hAEA...,2,-28,-3,25
ICSAFHJDUBPQKcEXOVGYZaWMTegbRfNLd,FBGCJADEBGFDQDCC.KADEECGA..OEFDGECGZFBCMCAGhAAAeHACREFC.LAAHhACA.CFHFAHIBDDDE.cDABhABA....YCCCaBGG.WHEAhAGA......hAHA...,1,-26,-33,7
MJYXWBNAcaEDdSVOFRgLICfTGPZQUbeHK,EBAFSFCDFAEF.LEADCGDFGDADQFEFUGFA.bBCHeBFHhAAA.MBID.JHAAhABAYBFC.BCBFhAAAAHHCDFFEdDGH.....OHDC.hACAIHHCfCCDhADA..ZADH,2,-29,-3,26
QVSJXLNKfOUDZRaHYWdGEcPTIMCgbAFeB,FEECBEHAQGEGJADB.LAHBKGBAUGEAZDAC.HACGdCAAGAFAhAAA..PGBEhAAAMFAB.CHHDAAFC.SCAEhABAXDEH.fBFADCCB..aGHHhABA.EABC....hAFA...,1,-10,-36,26
WfgFJUTIRHDGOBSXYCAcLPKeVabEdQMNZ,LBFAKBFFeBCH.VDFBEEHD...dAACQGFEMEAG.ZDAH.hACA.fBBDhADAJAHBIBBEDAFEBHGC.hAAASHDACHAHADGBaEEFNEDG.FFDH.TCDG.hABA......hACA...,1,-17,-25,8
BbUTEfYadQCKPIZgGXNLROAVFWSecHJDM,FGADeDBHHFCBDDDBBGAGUBBG..EGHH..aEDDCCGB.KADEZAFG.GDCHhAAALAAFAAEF.VGEEhACASCAD.MFFBhABAfHCB.QCGDgEGFhACANCCD..OAFC.hADA..WFFE,1,-14,-21,7
NHPWEJIRBVYFZcQOTMXCASDeUGLfKgbad,eACDGFBHKEBAaACAdFGDHAAD..EADDJBHBBEHFFCCFZAFD.OEHFhAAAXAGC.ABAGDICEhAAAfGFC.NIAB.hAFAIGEH...YBEB.hAIAcFAC..MCEFhBDACHHBSCGA.,2,-31,-1,30
XPcMSUWAfILYHgKJORTeGbFCQBaDEVNZd,LGDEHCFGKAECRFFETDAEGDCE..FDEAQBCHDIAE.EAAFhAAANADBZBCGdGBC..XGEGhACAMBBG..SEHHhAAAAIFEIDABYBHDgAGC..hADAOHFE.CGBGaEEChABA...,2,-27,6,33
TSVHJYdNWUBAGcbELRKZaIPQOFDgMfeCX,GGBHEGBBRFEG.ZDEF.aBCEQCDG.DBACMBADCEAD.SHGAhAAAVAGH.HBFHhABAdDGD.NCBABAHG.AIAC.hACAcCACKEGH.IHHE.FFCGfDDGhADA...hAAA...,1,-11,-30,19
PIYOfGDLedZVRTXMWACHaKSENUFbJQBgc,aGACSAAE.ECCHUGGA.FHDEJBHDBACH....gDFDhADAIDFAODDHhAAADHGAeEBAZBCETGBHhAEAMCABAEBHCFAGKAEH.bFFCQBGA.hAGA......hAHA...,2,-32,-23,9
fLYQaSJHMDFcXTIBOKdGRbegUNVWCPAZE,EBEDLGEC.aBFGJACDHCBBFEAH...TAABBDHDOGFAhAAAGBDAeCGFUDEH.VFABhAAACHFEZGBE.....hACA.fHEHSAHFDDADIBAAhABAKDHB......hACA...,2,-40,10,50
fOULFKSAcTdPZMBVIRDgabGWYCQEHeJXN,TDDHZBEC..VEFCDAEH...aCAGbAGBGDAE..CACFEBAGhAAAHDDD.eABCJFBCXGGEhABANIBD.fFFAhAFA.OCHDFAHFAGDD...cGBHhBDA.....hAAA...,1,-16,-18,2
eXQAYJWSIHbdaGNOUEcBPMfTgRFKLVCZD,JEDASCCCHADAdHGHGGCF..OCGFEAGFBADAMHAETCGGhAAARCAF.LFGHhABACACF..DGGGeFADABIBIGEEhAAAaFCGNCBG..PCEFfCEH.hACA..KAGC...hADA...,2,-25,-10,15
bQgFBPJEdCfZYLTXUSANaOVMIWDeRcKHG,aGEAMDAA.DHCGeHDE.RBEEHCBDGDEDQDECBFDEEHAECABEZFAELHFAhAAAXACFAEBE.OAAHhABA..WAGBhADAKCHBFHBC..dFADYAFCTFGENCCBIHHEhBBA....hBCA...,1,2,-20,22
AHTUaXbMOJPYGLgFfNWIQZRCDceEdKBSV,TDECUGFA..aBADMEAH..OCDGJEHFGBAFLFBAFGCG.hAAA..fABBhAAAIGFAQBFFhABACHAADBEGECCBKEHHBEBCAHDCXAGFYADE.NIAB.ZCFGhADA.eEAESDDFhACA..,1,-5,-17,12
CQMNgcWGEVYDaeXKOSbZTAFRHdPfUIJLB,RECGdFDGUDGBLBDABCAE.CABC...MADD..NDAE.....hAAAgGADGBGEVFEChADADCEH.XGAHhAEAOAFCSHCE.bFGHAEBGPDDEhAFA.ICBBcAAAEEAAhACA..,1,-25,-27,2
GgcTfBIWFbPJDXdKLAOReSaVYMUCZQENH,OBDCRCAEeEFE...SEHBVFCD.MFDHCEAEZABC..EEFEHGFAhAAAGEAGTAGBIBBGhAAAFGAD...PFFHhABADDEBKCFGAAFAYAHFNACB...fDBBhACABFFF.bDDBhADA...,2,-27,-5,22
ebEOdfXVYgHJAaNCDGKWSMTBLUIRFZQcP,aFGBCCBGKEFE..MCABBHBELAGB.RCDBFFCBZBEAQGDChAAA.eDHHEHEGdCCChAAAXDDFYBDCHEAChABANDIC.DCAH..WEAHSGHH.IAGEhACAcABG...hABA...,2,-24,-23,1
CUQERPWOKZYbFfHDdgMJTXSaAeNGVLBcI,eFBEGAAHBBAHCHGDUDCBRAGB..OFHFZFBCFAGDDCEF..dDFCJDAG.hAAA.SFHHhABAAADC.LEAFIHFDhAAAEDHHKGAA...fDHCMADEaHDC..hABA.NIAF.....hACA.cDEE.,2,-34,-11,23
KTCIaAUdNMXDWgZBGJRFQHVLcPeSEYbOf,dABHMDFCDHFEZBCHBAFHRAEG.HEDHLFCH.eFFHSEAChAAA.ECGH..ODAHhAAAKBDAIAHAAGIBXCAFhABA..gFAC.FGCDcGAEhACAPCACfEGDhADAaGGANIEF..,2,-28,-19,9
gcWJQbMUaSHXfIVCPRGdBEKeLADTOFYNZ,DAEFOBFCFBCHZFAD....gECCJCEE.MAEFSGEGhAAAHFFAIDBDhAAA.CHAD.REFEBDADKBBAAEIHYHFGhABANIED.cGAF..WAFGhABA..QGDGhACA.aAFA,2,-53,0,53
LUPBOaHCbKJFGYMQNISRTEfceDAgWVXZd,VEDEXFGF.ZDAFdACGLAEHBGACOEHDCDHH..KABEJBFFFHBChAAA.GEEC.MAGBhAHANICF.RCCD.ECDFeAHHhBAADAFGAHCE.....gEAE.hBBAPAADaGHD...hBDA...,2,-32,-5,27
HBGWabfFAZSILeQEPONMDUgdRTCVKJYXc,ZCCHLCDAQGCAEAAG.OFFDDAGCUEAFdCAARCEF..CHCDKFFAXBGFhAAAHDFCBHHF.hABA.aGADFADGAFAGeEHHhACAMEEF.TADH........hADA......hAFA...,1,-9,-32,23
CBdTeFSADabZNVPfQJgUOWLERcGXHYMKI,aBDFZEAE..VBADQGFC.UCFDLHEAEFAAGGABXAEFhAAAHBBBMEGBCFHHBAAFhACAdCEDFEEDADIBDAEA.bAFEfCHGhABA.gGBDWEEG..hACA...YFHHhADAKDAD.IAHC,2,-6,-3,3
geASQOYMFKZbHRIDUEVWPBcfJaTCLGNdX,OFDAMACAFCBFZADGHFGFDACE...EEBD..VFADBEDA.fAFHhAAAJDDA.aGDACHDDLDGBhAAAdHBH.eABDhAFAQBGAKGHB.......hAHA......hAIA...,2,-31,-17,14
GZKcVJFaXebCIMYRgfdWDUNTASLEHBOPQ,SAEEEAFEBFFH.QFCDGEAEKECEJBEDFBAH...aCFEbCBFhAAA..CEHD.MIDCRGCEdHGBhAAADDAB.TBGAAAHAOCCAhABAZGFAVEFC.IHAF...hACAfABFNBBB.hADA...,1,0,-23,23
FbcEQKXdaIeVORDZGMUSNBJWLfHCPYTAg,FGDDEGBDKDECdDBC..eCHDOCBDZABA..UGFDSBCE.BBAEhAAALDDACFHG.TAFAhAAAADIH..cAGHhABAXFAG.aCABVFCGDIACMFDCJHEGWFADhACA......hADA...,1,-15,-37,22
BZgOadRNSGYHDLUKVTMIeWJcfEbXCQPAF,BFFHZDFBaABFRCBCGAAB.HEAFLGBAKDGA.TADGMFIFeAFGhAAAJAFC..EDDECGCAAICGFGHBhAAAdHFBSDAAhADADEEB.IHFGfCFC.....hAIA......hBAA...,1,-13,-23,10
WVgYOXbBdPSUcNJeQGTZHaLCREKMADIfF,DEDFFEDC...VAEHOCCABEECdACB.UGAF..JBAHGBGChAAAHGDGLAGBRFECKAFHADBG.hABA..ICCFhAAA..fGHCgEGH...XEAGhABA...hAFA...,1,-25,-34,9
DRaJMIcYXGZCeVdHASbKNgPWQTUfEFOBL,SCADKEDG..NCCC...PCCETAECEBHF.BBFHLHEEhAAADFFGREBC.MCBHIHEGhAAAXACFZGAECGGDdFGDhABAABBH.bAGH..WABEfGCA.FGAHhAGAaHGE.....hAIA...,1,-20,-22,2
OSDbQVRZgTeWCJPfcBGHEAdFXKYMNaLIU,dEBGKCDEMGCGaBAB.LAFGUEEA..DHECQGACRAFH.TBAEhAAACHCA..fBHChAAABHHHEDFAAFHAFBCCNICH.hABA.ODBCSDDD.....hACA......hADA...,2,-40,-23,17
LHKIeNSVUMXORfgBZEYcdbaGPTWCDJAFQ,QFGFHDAEeHDESAAFUCCD.MCBAXEADRFEE.fHBDhAAABCHAEHAAdAGHhACAaFDB.TDFHDACEJCFAAIHGFADChAFAIBAD.OADE...YHFAhABA...hAHA...,2,-14,-7,7
FPUWAgRICTYQDKZESBLdaJMGbfeXVHOcN,RBBDCADG.QGAGZFFGBHBGLCCEdGGF..aDGFMEDFGAEA.hAAAeDEDXCGBOBAHhAAAFEECPAHFUEAAAHHB.hABA.gEBG..IBABhABADGEF...KAFA..hACA.SGED.,1,5,-24,29
CETUOAcMBWQZVLDSYdGRHXFIPKJgabeNf,BFDGZEECDHAGdBAHHAEHFFGC.KECD..aAGGeAAA..CCGF.EGEAUBDHhAAAAIHG..MBIHQDABhABASHBARGEE.IEAEhAAA.PBCDJFAFNEEH...fBGAhABA...hACA...,2,-32,-15,17
fKGDQMXEFLdTPZYcRHbaSNBOeUCWgVIAJ,JFCCKECAQAEG..XDAFFDGELDBCTBGDZAAERBCDHGEGhAAAaGAEBFGAUGABCHHB.hAAA....WCEBhABAgGCHAIDADAFGEABAdFFC...cBGGhABA..SDHHhAEA..,1,-12,-24,12
XFYPQGSHMWTdRbgCZcDIfLNVaKJeAOEUB,UADEBCDHFGCEQDDHHAEG..MCBHTBABdFFF..RCFC.CHFGDIBGhAAALBAC.aGGCKDBBhABAAFCF.EEGF.XBGHhACA.PFDDWHAG.....gGAChAGA.IGHAhAHANAAF,1,-26,-36,10
TgfUOMAIEPWbYZVSCadGNFeBXDQKcJRHL,EBBG..bEAEZFCGCFFH.dBGCGGAFeDDEBGAADHFG.KHECRBCAHAAD.hAAALAGHTADGUDADhABAAIACIEEA..hAAAWDHHSDAA.NIEHXEGFhACA......hADA...,2,-26,-7,19
XKBUEdFMRbIgeTPSaLHGZYNVfWcQJCODA,XBEDKDCBUBGB.dEBCFFGF..MAHBRFBF.....IADGhAAATBBF.aDCFLEEDhAAAHFGFZFEF.NBAEfGCHhABA.WBBGQADB.CEAGDIGGhABAABIH.EDHD...hACA...,1,-17,-29,12
HGaObWQRTUVdBEIeFMJDXACKSZYcNLgPf,SEHHZDBG..NCDDLAAH..fCADhAAAaGDBODFDbGEG.RFAHVCEBhABABHADIHFDFADFDAIHAHCHKABHhAFA..gFBFPDCD.WEHHTAFHhAHAEAEAMACBCDHF..hADA...,1,0,-34,34
RaGUWATCBgOeMFdZIVPSKcDLfXQbEYJHN,BBGFOBFAMFDCdGGEZCBF..VBCBKGAEDDBDLGDG.QCFBhAAAEACBHGDERDEFUGAChABAADDB.CCAH.eAAFFEAESHFAhACAXDGD.....YCHBhADANAEEaHAE...WAEChAIA...,2,-22,-10,12
eSGFWLNfTcOAUYBXQbRCPIdHDJEVZKagM,BHAAXBGAREBA..CDBA.dADAHACADAFDEEDFZGDCKBAG..MBADeAGHhAAASGGEGEGGFDDAhABALFFD.TGAGhAAAAIEG.QDBC.IEHDhABA.aGDDWAHHfBBFhACA,2,-32,-6,26
WcgQdSYDIEaBCLHfFUAORbMeZNTJGXVKP,OECAMCACZAEG..TBAGGDAE.XDFCKFGH..PABAhAAA..gFCHhAAASBGFIGHEhABABHEHCFCDfGACAHFG.eCHDNBIGJABEcFDEhAFA.dCDBDGAHaAGAhBAA...,2,-29,-12,17
YDBQKOXdGAeVLZNTFMcaESCJfUbWRgHIP,VFDHZABAFDCH..MBHDaDHD....EGGFSCAH.CABFUCCBhAAAbBFFREEF.HADG.hAAAIGHBDAFCBHCAODFDhADAGEAAAAHCNBIGcCCF...fCAAhACAgGAH..hAEA...,2,-22,-18,4
ZcNJEAXDVfdMgPHUYIORKCeaLBbTGFQWS,DFEDVABDdAAH..MBGFHAFC.UDDF.OFGFCADBeAEH.BFHEhAAAGEAGQFDHhABAZBAG.JBHDACEFXDGChABA..fGGDYHDG.IGAFhAGAaAEG.....hADA...,1,-20,-24,4
bIgCGFaXQMVHANSYPZeKLBdcWfOJTURED,SADGZDCCeAEABFAAdHAF....fBFCTGGERFDGDGCH.hAAA.gEAAhABACEHD.FFGHaBBBMDDBAIDA.hAAANEFCKCBCLCFCOCGFUACG..ECAD.hABA......hAFA...,1,-10,-24,14
IBaJbAeUECTPKQZGFHDfYOdRXNcWMLSVg,ECAATAEDKDEC..GEFEFAHFDDEA..OACFdFEERDBC...XEBChAAA..cDGBhAAAMAHHSAEGhABA.IHHCaABDAADBeHFACEHAQGCAhACAHGAENBAE.WFAD..hAFA...,2,-24,-17,7
SfXKJRGVOAdIMFLCUbeTEBWPZNYaQgcDH,dGGBMDCBFGEDUEGD..eFAEEACB.BEEAZDDB...aAGDQBGChAAADAACHBCH.SHAEhABAKEGARGAE.ODABhADAAAIFCDAE.WHEE..YAEH...hAEA......hAFA...,2,-28,-24,4
HafXFVBDQTMeICPAYgJUEGKNRLOcdWSZb,JHACGAGC.KACDLBBAdEACZCDAHFED..XEFFBHHHDADGhAAAQDBEMECCCFCA.hABAPAGDADIF.gEDBhAAANIAD.OCAB.SGDGhABA.aBFH.FHGC.hAGA...,1,-10,-27,17
YdAgPXUTHaGeDVKEFcCfMBIQNJWLZOSRb,XFEGTDFB.GACHeBCDDEED.KBGGECAE.CHABBHEAQBDAhAAAJBGB.LFCBhABAZDCGSDADRFGHbDADAEIF.PFCDhAAAaADG...FGHDMFFH.IHAHhACANAICOFFA....hABA...,2,-15,6,21
ULVEDYTIKAcagCPXBdQbHMOfZeSFNWRJG,aFACCHCHBAAA..QDFBHCCBOBECZADGeCCDFCAD.RGCCUGGEhAAAEEGF.DABH..IGEHhAAAAAEG..PAHFhACAbFAC..MACCfHADNBIA...hAGA......hAHA...,1,-15,-32,17
FPKMBGcUYbQgVEHRLXDTOJeZAWdaNSCfI,dEGDSHDECFEH.FCDHKCCHBEFEUCAG..QEAGEFCF.hAAAHAFCLAFGXACEhAAAOHCEJFDCABABaABAfCHChABA.IGHEPCFEcGGGhAEAgGAA.DCCF.hAGA...,2,-41,-9,32
KbRdACWfFGVJeUEaQMXLNOcgSDIPHTYBZ,CHHBFBEFGBDGeHAEUEED..EDBD.aGAFMFAALFFA.OBABhAAAgCBF.hABADBGDIHCGHFGFBBAFhAAAZAFHKHEEbAGFAAEGfEGF.JAHHNBIASHEGhABA.hACA...,2,-17,-10,7
NcGSIYHUReVWZPALJdECOFMTBDQKbfgaX,dEAAOFFHMBCHDDEDKGGF......gCBAaEDA..hAAAXGCHGAFAIAEDhABAHCFGeADCVEGHhACAWFHHAHADEBBCFAAFBAHEfECA.SBHBhADARBDA...hACA...,2,-22,-15,7
VYBUDCHAbZLSTfcQaMNXeRGWJIdEgFKPO,LDBESBCBTFEHQCGE.MBEDNBAD..RFBBJAGFECAGKFDAhAAA.OGFEBGHADCCAhAAACFAFAFIBZFBBaHEEeEFEhABAIAHHdFAC.FAEA........hABA......hACA...,1,-17,-19,2
AWVeCTbLfdPRgMaEFcOKDIZXSYBNUJHGQ,eGAETADELDFH.dBFFRGEGaCFBEDCFOABEDBAEZDAE..SBHDhAAABAAFJCAGHEDHhACAAHAFCGBE...fFHAhAEAPFFGMIBCKHFGIHAH..YCAEhABA...hAFA...,1,-13,-20,7
ATKWRLZJGMHBDSEUCgaNdIcOQbVYXfePF,KCEALBEEGCACMCFFHAFGDGECEFFE.UGAFCFHC....NABG.ICCGhAAA.ODHDhABAbDBD...YHDGhACAfACEFADFAHHFWHEC.ZGACSEEDhAFAaDDH....hAGA...,1,-10,-31,21
GfQNYeZJWOEPULHKVaTgBMbdIRCSAcDFX,DDDBFGBBGBBHQBAGeHDAZEFD..JFEAEBFGLAAFKEED..hACATFAAMEBGdAEB.hAAACDFGAEHEfHDBhABA.WCEGPAHD.......hACA......hADA...,2,-33,-19,14
YQODERNgcHTJPZUFGKadSfMCeWBXVAIbL,LAGHQBCEDGIBEDGHRBAF.....NAAFHGCEJFGHZFBFGBEFhAFAKDCE.SHGGhAGAMDFF.CHAABEEAAAEB.IAHGhBAAOFAHgACDTFGEPCBBaHEC.hAAAfFBH.hABA...,2,-36,9,45
KIWTDZcQRgFfYdCUHOVSebGJPNaLMBEAX,KBDCTFCDDEEDZAGF..QCCDFHFA.dCAGHAAHVBFASDCBhAAAGEFG.JEAHNEIAMBAGhAAA.AHAFIHEAhABA.RFAB.fFGHCAFC.OFCBhACA.....hACA...,2,-38,-3,35
KPcFGaOTgeZBdUXWEJYLfHCMNQAIbSDVR,SAGFVEAB.KDDEFBABGBGAOFEBeEACBDCC..dHGFUAEEhAAAEBBALFCFhAAACGHE.MFFHAGDHDAIBcADAhABATDFA..XCAG..WHFGhABA...fCHGhACA.,1,-2,-47,45
JDCcRPGVAdeZWLHfNQISOEKFXBUYaMbgT,eCDAZCADLHEEHFFGQGBDSCFBKADCBHBAaBBB..MEFEhAAATCDEDAGE.RABEGFBHhAAAVECEACCA.dAHC.fAEDhABANCAEEDBH.FFFAUBGE.....hADA......hAGA...,1,8,-10,18
SZEXPWGNfQgJbdeORBAIMCDVLFYKTUcaH,MBBHDGADFCGFKEDH..UABGHGFAZDBEECDC...XACCGEFAQFBHhAAAJDHH.hAAAdAEHRGBCBFAFAHHB.CAHGYCFBhABAaFDF.SADENBIA..hAGA......hAIA...,1,-18,-26,8
bUfLBEeaVARPcNYOIJKSCXWZdFGQgDHTM,RDEC..PCBE..NDCG.OBFAKGAD.SCFHCDAFZBAA.dGGFhAAAFFHDQEAGhABADIBEHFDA.MHACUAFEBFDAhACA.eADCAEDD.YHEA..IHFEhAAAWFFC....hABA...,2,-38,-9,29
XJGLeaMSAZTcbKQVPHRDNEfBgdCIWYUOF,ZCAHTDCEKCDG..QGFEHAAADBHHEGGHBDFAdFGF..CEHD.IGCChAAAUADH...OAFDhACAFCHFXGAHhAAALAEDMEAFAHADcDAC.PFEFfGCHhABAWBHH.....hADA...,2,-29,-14,15
QAPKDTeMZSOFdXYBLIEWgbHafNUCRcGJV,KBFADFABeCBEZEBGFGDEdECG.BFFCLDAA..EHGG..bABAHGCGhAAA.aACEUDGERBEE.hABAJHAAAIBEMAIB.ODAFhACAIHGA...fCADhAAACEEF...cAGAhABA...,2,-38,-14,24
eBUbgCEAaQRFfHGcVPKWZXTMSNdJOLYID,RBAEFBHDGDEG..VCAEKGBDZDAA..MFAASAGAdEHCLEEFhAAADDIHBHHHUGBBCABB.hAAAaACEHEGB...hABAPCFAXAED.......hADA......hAEA...,1,-24,-26,2
aTRXMDbfYHWPGSEKcJeVABFQNgLZIOUCd,BCCGFGAHQBACLEEHZABEUDFECCEC.dBFHREGH...MEDFDBIF..hAAA...fDBAhABAHAFDPFACSACEhAFAKHAGeBADAHHBNDIA.IHEH.aGGB.hAAA......hABA...,2,-29,-12,17
KXGgNeMdDLIWZASfEYCbOTaUcQVBRFJPH,EBCECAFD..OEABUDFDQFBFBCDH.RDAE.JFEGKAADGABGhAAAeHBA.DHEGLGFGhABAZDFAAHBE.SAGFhACA.fBHETBGBaFCGcADA..hAFA..FHGE...hAIA...,1,-14,-32,18
TcgeEFCfJPaLHIGBXNMWbDZSYAKdVOQUR,VFDDUDFCRBBG....TCAGeEAHCCHE..JCHDLAFAHABABHHEhAAAMIFEDAHFZGCEACGHdEDFhABAOCABQGAGhADA.EAEEfEDH.IGHBhAAA..XGFHhAGA..WABC,1,-14,-21,7
XFIbKDOYdfaBWUQHRZTSNAEgMGVCLJcPe,MCBHGAFCLEHBJHDG.eGDGFEEHKCCDODFH..dHADaHACBCAFhAAAQAFAHEADZDGBhABANBAG.AIGG..EBDCgCCGhAAACHHE.XFAADEDB..fABFhAEA..WBBEhABA..,1,-6,-24,18
JYMNBgCfIWdUEXTOPHGVRaFDQbSALceKZ,eFCEJDBD.MCHBBAHB..CBCG...IBAFUGABEBDE.OBABhAAAHAEGGFDB.hABAaDFEDDEC.SGGGhACAAIHGKHCA..NAAFfDDEdBGF..hAFA......hBCA...,1,-26,-40,14
TEZGMFIRVCbBPNfJOLSdUWecKagDXHYQA,ZDCGGBDCFFHHRBADCHBFBDHC......NHAD.OGDCdAFDUCGEhAAAeABC.KFAADGDCHAFBhAAA.ACCGEBABMIBCIFGFhABA..PABAfAHE..hAFASGFH.hAIAaCCA..,2,-32,-28,4
DTHESZGfQRBKbXPLIUdAWceCgYVFNJMOa,eBAHCFFG..VCCCJEFH..OFDFDFACHBGBZAFFGACGRFBC.BHAFhAAAKABB..XADEhAAALHFGdGHEAIBEgFBDhABANICD.MDIFaAGBEBAD...fEFBhABA..hADA...,1,-15,-22,7
HOZLfADJVcdQaPgTNRWFYBXeIMbUGCKSE,DHAGVECDQCCD..aAEC.TABANGAD..RAEEFAAEXCDBhAAAeDFF..MIDChAAAbGEEGBGGCEHG.EGABhABAOGFE.fEADAFFFcDAD...hADA......hAFA...,2,-24,-16,8
CASYGERdMOHQFUNDfBIJgPecaKWTZVXbL,SABEGAEGREFDMABBHEEF.QCBCUGBHDCCB.BCHC.JHBChAAAeEBAaDEA.KAGGTAEChAEAZACF..XCGAhAAACHGEABBEdGACFEHBIHECgECC..WEAFhAEA.....hAGA...,1,-8,-12,4
fNTcLWaYXDZRMIVBgCPFdKUEQJeSGAHbO,OGDETGGD.LCBD..aBBAXCDEZEDDMEAGBAFDCHADdCGBhAAAEHBGQFBChABA.SACEhAFAAABBHCGHNAAGcAGFYAFGDGIHIFFBgECHhACAKCDG.eEGD...hAGA...,1,-5,-15,10
DdaHRACGZgPWOTVSNXIYEFBLUQcebKMJf,GDDHZACC..PFDCOHDA.SCCE..NCIEXCEGhAAAEAGDBABEUDAChAAAeCCFKDAFMIBA.DGCEdHDHhABAaFGGAHHACCGB..WAHHIGAD..FAEFhADA......hAHA...,1,-21,-27,6
VWfXIASCdMcRHFJEDBGgONbZYaPKeUQLT,CHFCMDBEHDAAFFBADACDBEFDGCGA..OACEZAFD..aHBCKGEHQCDAhAAALAHFTGGGhAAA..fBAChABAAGABSABCdFAD..cGGEEEGENCCB..hADA......hAEA...,1,-17,-29,12
WIGAPfMHONVbUBZKCRcEQSYXdgeaLDTFJ,MEBBODDH..VFCEUAGH.KEHFRBDD..EBBDQCAB.hAAASFBHXAFHeFFHhABADIECFGECIHHGhACAAAEAHABGBHHACAHHdHAH.aCEB.LHAA.hADA......hAEA...,2,-19,-14,5
MaVLfWFUJRONEcTDCbZXBSYAHIQdgKePG,HDBDdAGAKEAEeAEAGEDDMCHDLHDGFBBGUGFDODEA.EADEDAABhABA.CDFBZEDDBBBDAAEG.QFAFhAAAaHBC.fACEhABA.JFHDNEIC......hAFA......hAIA...,2,-19,-16,3
bBENdPgJFDcfHUeLGaYWMKZXSVRITQCAO,OBEGEGDDdFHG...JEDDDCHDHACFUABCeFHHLEABGEAC.aAAFhACAMDFH.KAFEXFFFhAEARADD...ICHAhAFACDDDAIACBGFA........hAAA......hAIA...,1,-12,-35,23
fMYPLdgXSEBZHVWRbFeaIGUJcKACOQDTN,QCFGTAAH.MBCCLADE.XCFCBECFZDAFVGCAhAAARGFAeCHHGCAFJFDGKCCAhAAAOFBBDAHD...NAIEfFGGhACAdABCSAEEEEEBWHFA..hAHA......hBEA...,2,-15,-6,9
GPUcdgZBbLAWTKHaMYEOXCQDSRFfIVNeJ,TECEHDBGaABA.MBFHOACD..QGFGRBFEFGFC.VGAAhAAANCBCGGABUBCBdDGDBAEGhAAAAAFCKAGBECED.DBBHIABEhAFA..eFHBcEGH....hAGA......hAHA...,2,-20,-1,19
WRbFQcKIaMJUdCZSVgTGAOPNBDLYXfEHe,OGBGBDGBDCEBLCDH..fHBFeAFBRGECFACGKGHHMABBhAAAdFBHCBCE..ZAGFSDAEhAAA.VFEDhABA.GAEHAEIDNCFE.EEFG.....WEADhACA.....hAIA...,2,-28,-22,6
DRKUcCVPNdGbZLOQTYXFISWBaeAHfgJME,HDACJBAA.EDGDDICCRFFEKCHH..CGEC...VFADdGACGDGALFEDhAAAQAFE.hABA.TBCDFDDBIDAEhAAABCAHAAFAMFDF...cAFDPACAhABA......hAIA...,1,-4,-40,36
EWaYSfVOQeGBHADdFXJMKLNIcgRTZUCPb,DFDCdHDFJAHDMCBD.LAHB..NGCD...IAAARBCHZBFH.hAAACCDF.EGHF..aACBSCAChABAOADCeCEChAFABEFDFGAHKDAH.TGADUFGFWEEE.fGDDhAGA..hBHA...,1,-28,-30,2
SaQEOVRKbLceWXDJFNfGAZCHYdgIPMBUT,HAAEdCCG..IFBGMBFHUGBF.SGGFaAFGODGFKDDDLBABhAAAeAGB.XFEAhABADFIDFEAC.GGBBhACACAHE.PAHDBEHFEGEH.bADFcADH.hAAANIEBADFH.....hACA...,2,-18,-2,16
gCXeHAdNPKZcYGDRETIBLaQfJbWUMOSFV,dDAHKGABZEAAGBFCDCCE.EBHBBEECLBCG.QFAFJACE.hAAAUGGHSAGFhABAFEEBCBAD.HCGFABDG...hAAAPFGB.RCAE.IHEEaBED.WHAAhABAMAIH...gGDAhACA,2,-25,-23,2
acJKFVBbQSeORHWENfLTAMdIgPUCGYDXZ,MEFBdHAH..IGDHUGACGCABDBEHZCADaAAE..KBGBFBFDBGFGhAAAQEGB.SECAhAAAOEEA..hABAWABCNAEDLHDA.ABEGCCHFYHFGhAFA...cDCHhAGA...,1,-6,-50,44
cBOXWEIFCHDbZSfTMUgGdJLAYQRVPeKNa,QFACVAAB.KCFGaDCCBHHF.OBCCXGAE.EGHBIEGDhAAAFAEH.CABFHDDBhADADFAGSFEHhAAA.MAIBgCBGJAGHAFEF.YHCAhAEAPDGH.cAGH..hAFAWADD.,1,-16,-30,14
bSMPHDKLOUeVAgWCFdcIGaJNBQTRZEXfY,CGCFFFFGdDEGGBDC..aHGCBCGH.RBADEEABXBAD...hAAA.fGHAhABASAFEMIAGDFBAKFGBOGAEhACAeABGAEHA...cBGEIAGH..hADANEAE......hAEA...,2,-37,-28,9
gOcLQCPTfGSJYDINdHXEWMBAabFVUZRKe,aFFBVAEHZEBG..eAHBODAELFGD.CEDF.TADCGBBEJHBChAAA..IDGDhAAAdAGBECCGMABHAIEEFEAFKGAD.hACA.QCGASHCCDGGHXACBhABABHHG......hAGA...,1,-11,-15,4
UQcNZEBRXPWdgOISTaKFCDJMeLAfHYVbG,HADHVCFG.UDAD.QFGFZBABEGAGBAHDRBFA....PBAChAAAdFCHIFGE.hABASCCHTGAGKDEAhACADIEAeHFGAAFE.fHDDYADHbEEH.hADA......hAFA...,1,-10,-25,15
LMaSFUBVfQIXWYPHKAGDegdRcJTbCZEON,DGBAdBFERECC..TFEDZAACOAFALCAG.MCHDaHDA..FGHDBEDFhAAA.QABFhACA.XAFBhAEAYEAHPHBEKEGDACCFeCHDJCFFCEBFSHGAhAIA.....hABA...,1,-4,-33,29
ZWaeBcKUFNDRSLVHGdCbIEAgMXOfPYTQJ,MFEHOBAC....fAGHTGBDQDGFJFAC.aCFAhAAAeCEGBABBUFGADDFBSDBHhADAHBAACDDCIAEBhAAAAIFAPDDFZGACWDFAKFHBNBDH.....hAEA......hAFA...,1,-13,-23,10
ALEFYaIHKNbQBCeRGfMUXgOVTcSdDJZPW,EDDFaEHBHABEKFAH.QDAECBCG.GEEEMHFA.UAFBOADGhAAATDCDdGCEDCFFZGAGAIGAFAHHhABA.....IDBFhACABHHE.fEHAXCGC.gEFFhAIASAAF..hADA...,2,-31,-8,23
GTVIFHfWAEPRBSbLgUCMYZQDJaKXcOdNe,EABGRACCBECCLFBDUGGF.CCCC.ZCAD..DGEEKDGAOAEH.dFHEGGAFhAAA..IEEFhAAAFEDE..fAGGhABAPCGB.SGDEMIEEQAGBhADAJCDG...aFDH.hACA...,1,-19,-34,15
dSGXRTQecUCgMONfILPWZbBEDJYFKVHAa,dABDXEBDQGBEUACG.MEFF.ODHHIGGH.LAGFhAAAPBDE.ZFDDEDDDDGIFhABAFEAFKDHBACAC..SAHDhAAA.........hAFA......hAIA...,1,-20,-37,17
JBaAGbgUQMFKcDVLZXPOfCTeEIRWSdNHY,GDEBUEFAMDCAKBAGDEBCLGAGZFAE..OHCECBEE..TDAChAAAeBFCRFGH..SBGChABAdADH.NIAF..hAAA.YCBGBHHGACCGQECD.hABA..FABE...hACA...,2,-26,-19,7
DKeSTdYEVPHFRbWfMGXUOBaNIgAQJcCLZ,QCCFJHDALDFGKGAA..eBACdFCDEGGBHAECFACAREAF....hAAAfGGDXAGHBBAHhABAICCGAAFFZDFEDAIFhAAASHDCTEDG.......hABA......hACA...,2,-22,-19,3
WcQBEbMJdIKGUCfZYgDFTLOXaAVPeNHRS,eCHBHCGDSBDFQBAHBHAGMFCBdDAFKBDGCFFDZEEB.DFAFLEDDhAAAXGGGAGIDVEAFhABA..NAAH..WEDFhAFAEHGEIEGE.fAEBYBFE.hAGA......hAHA...,1,-15,-19,4
gNUdeRKcPZJLDWFXVaSMQHYIAfGECBbOT,ECABBCGB.OFDB..NAADUCGFeCDEKDDAZBBHLFCGDFGG.hAAAFFHHaAEE..SHCAhAFAHFAHIGGBhABAfHAHCDAF.TAGCdCBA.....hACAcDDD..WFFDhADAXGFHMAID,1,-16,-22,6
QELIFPYDRVgaAbZNCUOBdGKWeMcHSfTJX,ZDBAUACFBHEHdGDCKDCHeBFD.HFFE..TGGFQACA.hAAALFAGFFABDCFHREECaAHDhAAAACHF.CHBDOBAB.hABA...MAIBfDHEEHAAIDAFhADA......hAFA...,1,-11,-35,24
XHIOaMTDfVbNFYPJCUgWZQLcESGKAdRBe,RBAHeCDDHEFBOBBBMFAADAHH..VFFGFGAE...JABACDDAUAEAhAAAZFBHLDFE.SAFAhAAAAHFBdDHGIACDhABAaGAH...fGDCNCEB..YHEAhAEA...hAIA...,2,-30,-9,21
gGLQaSVYNJBCFbHPTAdRKZfeMOXWUcIDE,KECHeBBFMBFFOAEG.UCDGDDAEGGCF.LBAEaHBEVEFChAAAJCGHBADD.FBHDHFAHhAAAAHIH.dAHAZFDFXFGEhABA..IGBA..EEED.hABASEACNCACCCFH.hACA...,1,-11,-21,10
SIMJgPWYUVeHXGDdQCZKNOLRcAEbFafTB,EBCBaBHBBCDC..SDBBMEBF.JEAD..PEFBUEDGeCGHhAAAHAEHDEDFCHHCZGDEKABAhAAALADCAIHEFBAHIEHEhABA..WBHBXGDH...hABA......hACAdHAD.NCCC,2,-29,-24,5
BGXQfTFeHPEDJZYgULdSORKbIWACcNaVM,CDBBaAAEBDDGGAEB..QABGFFFHHCDCEHCEDAFDZFEGUECCdCGAOHFEhAAA..KAGAIHAHhABAAGDB..NEAE.hAAAMDBD..XEBCeACHJEHF..YFHBhADA.SADHhAGA,2,-37,-7,30
dIbJNMHQKDfZVceXAPETaYFSUgWGBCORL,EEEEaDBB.FCAGUGDD.GADFCAADLAFH.dFCEJDFEHGEEKABEDGGGhAAA..fEAEhABAZCCH.eBHBAHCH.YHAAhACASBGABBEAIGAB.MFFEhAEAcEGF...hAGA...,1,-7,-34,27
FTIHDgCYZLVQfKORebXdEAGBcUWSaMPJN,BGEDUACE.SBBDMGEC..JAGFTECADGDF...CFAFLAEEhAAAVDEE.KACHOCBHhAAAeDHHdCGCAIFG..hABA.WHDAaHACNEICIGBF...gEEBhACA..hAIA..QFAB,1,-30,-31,1
COBZaKJegFMTUcVLESdYXAfWDPGQbIHRN,DBFBQBGBHABECEFGBBGEaFCD..KEGGeEAEMCCH..UGAGLEEHhAAAEBAB.dADBXDGEhAAAfGAE.PBAHhABAIHGE.NGDF......OCDDhABAgGGC.hADA.FHDGcBEH,2,-23,-13,10
AMWOXTSNVCacEfLYKdeDJUGPFBgRQZbIH,ODBESACG.CHGE.EADDLEDBKBHHDIGEGGADBFCDRFABZDFCHFFChAAAAAFB.MBAB.TDFGhABANBAG...aFBAfCDHhAAAeAFC.PFFCFBBH....hABA......hADA...,1,0,-34,34
dJFWXRDZMUeHCabNLSQfKAEIOYgTVBGPc,EACGOGEG..TGEAGCCH.dFAEFAGAXAGHDEAAZECEMDEAhAAAeDHBHAAE.aAEGNCIALFADhABASFCCKCBAhAEAACCCIDAG.YHFGBHHGcGCBhAFA.....hAAA...,2,-16,-14,2
XFQVKHRAMGWJCfNUYPbedcSaBZLgODITE,MHAGJFFA..CGDF.UBEG.....PCAHdCGHaACGBEFFZDCELFAFhAAADBIF.EAEChABAFGHB.QABDhAAAKBDDAEHC.fECF.NGCB.eHCASHEAhABAIGBCXAGBhADA.,2,-38,-33,5
OQeWdFMbHfPSJKBCRNcGXgIDTAVZUEaYL,ZFEAECDFLFEBeABHdAHCFFCBMAFH..HCDGSDGGBHDGCHEB.RDAHGAAFhAAA.IHADhABADAEEAIGGaBEAQGCChADA.fAGHPDAH.KGGD..hAEA......hAGA...,2,-31,-4,27
agYNLKbdeHOXcRUfSCFTGQDZMEIAJWVBP,JFBEBBFD.aEGH....NIEB.LDBB.KHBAbDEAdAHCHAADhAAAODFARBEE.UACDSAGGhACAFDDD.TCCDhADADIFCEAAHAGGH..WHACPDAH..YEHBhAEAeFEH....hAFA...,2,-27,-19,8
WETdbGUfgaZXDePHBVINSARFCcLMQOKJY,RDCFCBBELFEDQACDKGHB..JGEC..EEBHdHAHUAEA..aAABhACADBHFeBGDBGFHIBHFhAEAACDB..MFDFhAAAOEFC..TCAE.GDEFfFABhAFA....hAGA...,1,-27,-32,5
VBSJQFYUTfPNGdHCIODegXKELZcbaRWAM,MFIDBEFHSBHDFDED.UACCTAEG....fGBHhAAAPGCGdGAGCHFHDFAChABAXABFKDDC.EEAELFHBhAFA.cGDEaGGFACEHJBHD.NBDGIHFChAAA.eHBGhAEA...,1,-20,-35,15
PJgDLUfCBFMWNQeEGKdZVabRXOAcYTSIH,TCDBHEGDJFDB.LBFBCAHDBEAE..FABGMBBG..QEFFhAAAEEADdCADZAGHaDGG.XGCBhAEAADDHSGHHhAAAIGHEDIAE..fFFENIEDKGAB...hAFA......hAGA...,2,-29,-15,14
FBdNCYARIXVLeKJDWUaGZOcQMgHTPbSEf,RCAGXBDALFDCKEFDDHGA..UGCCZAFGOAAG..QBGEhAAAMDECHFABPACAhABAEEHBBGEBCGAB.ABED.IDDBhAGA.JFHB.aBBH.....hAEA......hAFA...,2,-27,-23,4
SEXYIMcDbJLfBGVFaQdeZTWNPAHUgOKCR,HDEBUCBEKFFASAAF.EBBHIBGHMCHBDEDHLAADhACA.BHEBGADHFFADaGHDhADAQGEF.hAEAdDADTFCCNCIAADDECHHD.XCFG.YCHBhAFAJHAG....hAGA...,1,2,-34,36
JdRcDGMfYeZCKLWaIgAPUSOEbHXFBNVTQ,SHGCOFEBHADEBGBA..TBAEdDADDABCMFHBeAABCCFHKHAChAAAaAFE.AGAC..UDADXGDChAEAFDDBQDGDhABARDDB..cCFE.fFAChAFA......hAGA...,2,-33,-9,24
WLYcUeEZCFNKQPAODGgHMdfIaTSBRVbXJ,GEBFHBBGdAHEaAFEBDEARBAH...VEGFXCEHLFBC.UGDFhAAAeEGFCHBG.KFHBAACCDGABhABAfGAD.IACChAAATAEGSCGGJHCE.WEAChAEAYAHB...hAGA...,1,-11,-22,11
JFLRgOXECNGTaSPHYeDQcKVMfUdBAWIZb,ZFBFJFEALEBBOCDB..EFFFCHHC.GAFG..TAFFSFDHhAAAHBDHDAIHKBBHfCAEhABABAADADHD.IAHDhACAbCACFGDC.........hABA......hACA...,1,-18,-32,14
DHXYGQcMOJLfFCaRPBWebAKNSgTIZdVEU,KDEDSBEH..IFHDdGFEEDBDHABCGGABMIAELABChAAAFAHDRDGHBGBGeHEAAHIBTGDChAAAZCBFDAFG.XBGDhAIAcDED.OFDECHHCaAGB...WBDANBAE.hABA......hACA...,2,-13,-5,8
UJcReOPdfGXZbVYASDCKHLTNBIgWEFQaM,SCCGDHBGCCAH.KAACHFECLGDABDDF....IBGFhAAAECGAQAECMBAAJEAAhABAeDAD.dEEHfDGHhACAXGACbFGDAEEH.gDBGaFAC.hADA......hAEA...,1,-5,-42,37
YDECSPNMWKfeBZGAgFXUVORaJTIHQbcLd,FAGDUEGCODCGRDAG..JHBCHABE.QEGFLAGDDCCAEEADCBAGhAAA....SDDBhAAAPHDE.MAFFhABAfEEGBADGZGFAACEAgGAA.hACAaGHD.....hAEA...,1,-9,-37,28
KcQWDJLGgBVEafMSTeAYIXdbRNCFZOUPH,XAAFdFFDRBCAFEDB.UDABHCFA..KFDGQDAEDBHD.JAAEGACBhADA.VGFEEGAHMHCEhAAASGAF.hAEATDFAAGIFIAGDCDDAODHD..WHEAhAFABCCB...aGCH.hAIA...,1,-10,-22,12
EdLOBcHDGYVIXAfTJFMNCPaeRgKSQbZWU,TCBEJCHF..FFEBMAEB..CHAH.eDFEKBAA.SEFDhAAAZBFD.UAGGEBEDOCBEhAAABHHFHFAH.YBADhABAXGGEAGEB.....PEACaFCF.hACA......hADA...,1,-15,-43,28
YBNeWPTSAQUVIfGcbCMRgXLJaDFZEKdOH,QAAGUCFD..IGEBGBFGbFCFCCBE..RDBC.LHEChACADIDGZAFA.EDBA.KAHBdAADhABAOAEBBADFeFFGhAGATGACAAHE...cEGE.MDAB..hADA......hAFA...,1,-5,-37,32
AYITPXdeSZcMRVDGCOJafQEBbUgWNFHLK,TAGDdBGBeFFH.ZAADRDFCGGAH.ODAAfCDFBGGHUAAFhABA..NFBFFDHDKEDAABFBhADA..IAEChAAASFHBVGAGCFAAaAEBEACH......WDCGhAGA.....hAGA...,2,-20,-14,6
YRdUENCGcXQObeZTJMBHKFLDAISWafPVg,SGGGaEAA..PDDDVACDREDEdFGD.UGACCGDE..XBGBhAAAQADG.eFEHhAAATCACBABEFFAFADHAIHHFhAFAfDEDEDGBNCIEOHECZBFE.MFCDhABAKBBF.....hAGADAEA..,1,-4,-12,8
CbScWdZBEXNMIJfGHLTFQgVYUPORaDeAK,CDGCSEBFdFFBBBAB.EBHB..MGBA..fCDELBDDFHAAhAAAQFCD.hABAgAECUAECOHEChACADFECAHFGKDAAcBAAXGGAIHHF.hADA......hAHAJDHH..,2,-34,-13,21
dQNLOEGSUFWYJDHRaVMeZKXTCcbfPABIg,BFAFdGAHLCDHGEEBFBEHJCFE.HABD.RGCC.aADCMBIFZEGBKFFFCHGF.hAAA.....fCGGhABAPAFAAEABQCABhAAANAEF.SGEDYDAADGBHhADA......hBAA...,1,-20,-25,5
egAZRBIHbXMLKSOcUWJVTECDFPafYdNGQ,RBCHBDGAHGFGMGCEKFEE..OBGHUAAC..JFAFEGAH..FEBEaEBC.hADAdBAHQBEChAEA.ADBEZEEAIHCBhAAALHCCSCEH.cAGF.WDAFhABACHHADEID..fEHGhACA,1,-14,-36,22
MUQaeFWSRLBDbPTKdVNZgfYEGcJXIOHAC,MBDHaDFG.FGFCREFADCDG....TCGCdEBAZGEG....fGBAhAAAEEDDJAFGOABBhAAACAGEeABC.LFBEhABA.BCEHKADE.NEIE.......hAFA......hAIA...,1,-29,-37,8
CgLSTMfGYDOWVKecAaJIERZQFbHUXPdBN,aCAFEFFDZECF..QFCAHBCCUBAAXCFHBFBDCAHE..LCHHhAAATABCGADGhAAADIGA.VFFAKCFAAAECJAFEFHBChABAdFAA..SEECMCIB....hACA..OHDE.hADA...,1,6,-20,26
YQaOKVEScZWJHAGFMIDfUPLbXTegCdNRB,MCIHDACDUGFCLFEH..TBFFCBBERCFBBDDH..QEBHhAAAKAGHEFAA.SAFChABAZACDHFCBFGGHIEGAhADA..PBAHbEDHgBDD.hAAANIABaBHD.OBBHhAEA...,1,-12,-22,10
ALDZVbFaWdeOCJRQXKHNPSBfGMcTgEIUY,DAEAZADCFEFBdDFA..CHAF.JCHB..RAGF.KGGCHECD...SBBHhAAABDDDMBAD..gGGFhABAEFDF.IEHGhACAAAIBVEAG.aBEGeHBGODAH..XBCChAAA..fDDDhADA,1,-20,-44,24
NXJcMRIaLTHZbYEfQCVUgGKOeWBDASFPd,FGDGdDDEJFHHMADB..RBAF.LAEDHEBBZAEHEHAE..CHEA.UCABKACH.hAAAOBGBBFFB.DAIBAAIB.hABA..SAAEhAGA.NFED.IHABTGGB.fDHEhACA.....hAHAgAGD.,1,-18,-29,11
cWbLCJaFOefSZINdUPDGMQVgTHXAEYKBR,KEGGBEFCRABE.....bEGHLDDE.CHAAFBFEfHDHhAAAZFBA.dCFFDIEEGDBGhABAMAAH.VACB..TGGHhABAAGDCEHAG..cAGAaAFGeEEBICAAhACA......hAEA...,2,-27,-22,5
NRecCKGBVEgOLSUbITJXdAYMWFPHDfZQa,MHEGFABEDGCGZBDD..QDDGaAGH.RBDE.CFFABDGC.EEABOEAFhAAALAABSFGChABA..IFDBhACATGEHdAGHAIAGWBHHfCHA..hAEAcCBDKHCA...hAFA...,2,-36,-28,8
ZXYeOVSfbREaKABPCGUTNIWMLDFcHgJQd,BCDHGFBH.UAGATBFF..IFHELGEGDDBGHAAAQACChAAAXFABOCEHhABASHBARGEA.KAEEhAAAACFHCAFDMAIB.gCAGJEAG.dFGB.hAEAZDEG.....hBAA...,1,-1,-20,19
ZAGbMPIaJYcBOeTUSVEfDCXKgQFRWLNHd,MHCEaEDD...JCFGBHGG.TBFGSAEDEADA.DDCACBADKCCChAAAFGHBRAAELAHB.hAAAHGACAAIHGDAG.hABAIAGAOFFAeDADfEGDgGEFhACA.WDFGdFED..hADA...,2,-23,-15,8
CDTdWgSUcJVHIZFOREMAGYLBPaNfbXKeQ,LEHHBBGCaEFC...NDCG...XADCKBADCEEE.dBBG.SHDEhAAAUAGAJFDFHEFFhAAAIDDHFBDF..EAEEAHIDPFCEhABA.eFAHDIBE.gGGFhACA.ZCFCODADMAFC.hAEA...,2,-22,-20,2
YaQPEeVCHMIGDKBbJZgTULSFXcOWRNfAd,dDCBaECA.QGCE.eEAHCHHFHACEMDFADIDGBBHAJBFBZFAAUABFhAAALABDFHGE.XEGFhAAAOGFGNAEBAAHAEBHBhAEA....IEFEKFFF....hACA......hBAA...,2,-23,-19,4
FCfgIMLRdWZKaeYNQUXEDScHVPTGObABJ,BFBEFDCCCHFD...IFDBMDFE..dFEFKDDC..eBAFQGFFhAAAEGHH.DEIDSBEEhAAAHBGBPACGTGAGhABAbBAB.AAIH...gGBGLFAC.WCCChABAaBDC.....hACA...,1,-18,-31,13
KLDOIPUSZJCaBYTRcHbgQXMEANedGFVWf,eAGDGEAFFDAC..fHCBLFBAOFFHUEGFZCCA.aACGBACBhAAA.RDFBHBCCQAGDhAAAEHAAAHHDdEHAKGAFIBEAhABASBAC.CAHB.YHEC..hAFA......hAGA...,1,-8,-16,8
XSVZLENJFeaYWQbKdMfRgCGDPBIcUHAOT,XECDSDHHLDBCEHAE..FGDEaFGHQCEAdFBG.hAAAMBDDRACCCFEEDCABBGHHIFHFhABAHAFCADAATEADhAAAZAFBJHDC...WABCKAHB...fFFBhAFA....hAGA...,1,-13,-22,9
WSeMbdQXITDREYcFOLVHfGPZBaNUJCgKA,SBGDeFCAdCDHQAAG..TGABRAFGEGHB.FDECODADhACALCCFHDEGfDHChAAAPHDABADCUGGFhABACHADKCHBMICA.IACE.DFFD.cAEBhAEA....hAHA...,2,-30,0,30
ZDFOKQIgRcWTfGNBJYXMLHSCAUdPeaVEb,UEBDdDCEaAEHEFEG.ZABGFBAA..KCDAQFFB.RAFB.TAFBhAAA.GCGABHDDYDAHhAAAMIFELHAAhABACHHEAHEE.....eCAADHAEgDGChABAWGFA....hACA...,1,-9,-30,21
PVJUfbEaYRGDACKcFQWZMBNeTOISLHXdg,KBBFQEDFZGEGBFFBeBDG..OBEASCDGHDFGdECBPAHDhAAAUGAH..bFGFEEADhAAARDABGGADACDB.CAGFFBAEhABAMIFE..IDGDXFDG...hACA......hADA...,2,-23,-3,20
bHXdILaEJTeOUNBMDWVQZACGcPSYgfRKF,CCCAGCCG.SBHD..gFDFfEAEKBHHFBEBhAAAXAEHdEGEaGFCECFHhABAJGFC.eABAUEAEMICEhACADEECQAADAHIB..YHAEhAFA......hAGA...,2,-39,-6,33
DTIJfGHVLMQbUYPaZKSWBdCXEcANROegF,ODDCFBECDCCD...JGDAHFFFLBBHMGAAUDDH..aAFDSCAHhAAAdFACEGGGAICC..hABARCGD.eBHH.IACGhAEAfACB.QFBAbGBE..hAAAPAFA..KBADhABA...,2,-24,-15,9
cfKJdCLeAPWYbSZEgHTUNOBXMIVFaQRDG,...PFDBbDEEZEACHBDGUABHBGBE..MICCVCAHFGGEQEFFhAAADHCAGBEFfBHEhABAdGACCDDF.AFIBSGHDhACAECAD...gACChAFA......hAGA...,2,-17,-17,0
GWXESTJUIQdNOKVRCAgLYPFfBcebaHMDZ,LFDDFABABBGC.eCAFHDCAMEBCDGACZGFEGAAD..EDGGSAGGhAAA.JFBFQBDEhAAAOGFGRCDEAAHAPHAGhAEA..fGEGaEGH.WCFEhABA......hADA...,1,-18,-27,9
CaBgRFTOGeDXZVJEIUYfSKdcAQLMWHbNP,LBBAMABGHDEC..NBAE.CHGEBCCH.RFBFFAGDGFCH.XDBGhAAAZACGEEHF.UDFF.hAAAfBGBdHDFAEDB.hAGAQGAGWBBD.aHGC.....hAIA......hBAA...,1,-14,-23,9
NDIAUMaTGYWLZKXSFJVPedfBbgQOEcHCR,MIFGaHACGEBHLCFDKFGE.FDDB..VBCGdGBGBAAH.QGDChAAAOBGHECAHCDHADAHDhACAIABA.AEEAUGGDhAAATFGB.ZACGSCHBJDAB.eGAEhADA......hAEA...,2,-16,-15,1
BORHAEZMceFGdDPSVNaQKWgYXJLfUCbTI,EDECZABCeBFEFEBB.DGCH..SHCC.aAEAKEHF.gDDAhAAAXEFHfCAHhAAACCCA.IHHBhABABFFHOFAFAACGMBIFdHDBNAHE...QDADhACAYCDD...hAIA...,2,-33,-30,3
HBPTEKXgQRSLcCaMbOeYAIZNUDGdFJVWf,ZCBDDFCFdGEGJAAC.....VABFHCGDBHHCTEEB..XEDGhAAARAECLEDF.CHGEaHAChADAMBFA.eDHFAEIF.hAEAIGAA.NAEG....FDAFfFAGhAFAKGFB.SGGEhAHA,1,-17,-39,22
CeYXJfbSEMNdGTRHOQBPUAcDaLVKFWZIg,aAFALGDA.FCECZBAFCEGF.eFGF.XAECJDDF..SHCGhAAAMCFFdGECGDCAhAAARBABHAFABEBHACHGDDIBKACDhABA.IHHCfFAGNDAC..OCGHhADAPABG.....hAIA...,1,-8,-26,18
BcIbOUXeJYHCANEMWgaGDTRVLdQfSKPFZ,MAEAaACCGDDDRCBE.dGGFSCFG.FAABBBGC.cAAChABAIGFG.UFBGhACAXEADeEHD.JHCECEECAIEGhADAEBHHDAIB.....LBEEKAEC.hADA......hAHA...,1,-18,-28,10
ATIHBKLdegFGSaPEZQWOcXVfDMNUJYbRC,HAEEKBHBLBCEeBABFEGFGEFG.aCABEFEH.QEABhAAA.OHAEXGAChAAAVCDDDFDCMEIHNEIAUGCEhABAYAHBCDCCAHFDBFABSGGD..WDEChACAfBBB.hADA...,1,6,-24,30
dYeUTAbNZLWMXIgCEPaBDGVQRHKScFOJf,ZFABMAGF..IFHHCCHD..EFDGBBCBVCBBQDDEhAAA.RAGFKHECSFFHhAAAFDAA.fAEEhABAdDGD.eHBCAHHFbFCHNCAC.XAECaHFEDBBG..hABA......hACA...,2,-22,-20,2
FETVKZAJMUBPbDLONWRcYeIfaQSXCgdHG,MCEGBHAADFAALEEG.OCCHRDFHeADH..aBGAXAGEhAAA.dHFHFFHD.EAAHKABEhAFAJHAGUGCA..NCBG.hAAA..cCEGIGEBSEHHCDGC.hACA...gADChADA.,1,-27,-28,1
gKfEOZaWHVSbJQMYNLPeCTIXGcARdDFUB,dDFEFDAGBGDCKADH..EDAFaGFHHCCB..SDEAQGGEMAAGhAEALCHF.CACFIFBEhAAAXFBBAAFHDIEGhABAfBBFZGCG.bBGF...YHAAhAGA.eEHF.hAFA.cAGB.,1,-10,-25,15
MEAGJWXKIQBLTVYRCUZNecdFgPHObaSfD,JGDAKGBHBCCCLEAB..TEAGRAFHZDFE...eFFBdADGFDDBHCEChAAA.OACCSHAAhAAAfDDGEBACAGGC..hABA.WAHBXCAAIHHF.QEGEhACACHHB....hAEA...,1,-21,-25,4
CLdIbQSWeGVDgAUBRNcZMaXPTEOYHKJFf,UCFGBHFBRAFEZGAE..aCCB..XBCG.EAEAOEEG.hAAAHAADKGHFJDBHCEDDdGCG.hABAICFBSFFFhACAeEAFDEADAFIF.MDEFPACA.....hADA..YFGHhAAA.fHDD.,2,-26,-19,7
fUBgKTGWRLSbXDYHPMeCQOaFIZJNdAEcV,EFCBVDBABFFE.KAGHGABH.LFFHSDFCDGBAHAFFhAAAMBIH.CHHHOHACFCBEJFHD.hAAAADHB...UAEGWCAFhABAREDB....bABG..YDHBeDADIHFEhACA.NIAD.fGEChACA,2,-25,-11,14
QOVdYWNCEZISPUAMXHRDTcgFbLKGJeBaf,XBDBHFEDDFCG..TDABFAHFKFFD.GDCCeAFBBAHB.QBCBhAAAOCAFdBABNBHEZGAAhABAPHFE.ACHBMEIHhAAAcCDD..gGBD.LAFHhABAaHGA...YEEChACA,1,-5,-21,16
cIFJGHOUNfZRDLVAMKgaTBSeQCXEYbWPd,MHEAKBFC..TDACBDCCSFAD.CEBG.EFDD.WDDAhAAAdABFFDFDGBAHODHDhAAAUFGGZAEBLAHBhABAAIAGaBGF.XGAF.YHCA..hACAcGCBIADD.hAEA...,2,-40,-6,34
WOLRUSbEJPFXadGKcMNBDeAZQfVIHgYTC,QDBCVCEG.HFEHTFFBCGHELBCCUEAF.EDFDFBGAdAHGKBAAhAAAMDAFBADEAHHDIBAEhAAA..WGAAhABAOGAE.SBGDJDDH..aEHF.hABANIABeHFAfEDAhACA...,1,-12,-19,7
ZRIDYNCbTWHPBLfOeXcgJGMSQdaKAVUFE,VDACEDHBRBDB...DBGBCFCD.....TAAAHABDLHBChAAA.eBFCgEFGhAAAMBADSFFEhABAdHCDKFCGAAHDUACGIHHFNBIA.WAFCfGAChAFA.XDDFJEABaDDH.hADAFGHD..,1,-10,-16,6
gXUNOKSQPeVJaCWBGMfIDYEARHTbZFdLc,TAEFFFEFdFBGLHAA..XCDDUACCKABDQDGGhAAA.VFDGCAFDBHEGhAAAfGHEDAGEAEBGRDFD.ZDBBhABA.gACF.NIAHSCAHhACAeDDFaCGF.MHACIHGBhBAAEAGE..,1,-5,-30,25
IMGeDNaQLEYBHAdVfXUbCZRWSJcTPKOFg,VFFAXABG.UCAHZACDRAFG...SFADJFHH..PHAEhAAAOBAH.IEEGhAAAeAFBDDFD.NAHELDDFhACABGDEHCFEAEIHdGFACBBGTEBCKEAH.MIEEhABA.....aHAEhACA...,2,-16,-14,2
PTJCZgYXeQVdWDaBELNOUfHbFMRGIcKAS,TFEFCFABZDFE....XDBAeBGBVFABDADD.BEHHLHAChAAAODBGUFGBHECHFBBDMICEhAAARAEA.GABDKFDAAABE.hAEASGHD..JCFG....hAFAYAFCdHFD.aBAChABA...,1,-9,-14,5
VJMdRHfYZFagBCSDWUePXKTIbNcQOLAEG,EEDEGBDG.MEADdADGHCGDZABBFFGBBHHBDIEA.eBAB.KHAGTFCEhAAA..IBFHhAAANCIG.OFDHACFG.hABA..RFEAaFACCGEHWBHFXCCC..bFADhAEA......hAFA...,1,-10,-27,17
gKeYSAETdUcGRbBVXfHFOCLPMWINZaQDJ,EFDEdGDAGCFABHDD...XFGHFBFBCBDGLBHBMABG..IAHGhAAAaCBC.JDCGKEBHhAAAeFBHACHBUFFA..hABAcAEE.........hACA......hADA...,2,-43,-19,24
BJEZbWQHaKUXcRIYefOLPGgVSMDNCATdF,dDCGFFFCEECHZGBEQBAB.KADGXBEF.RBGFeDCEhAAAfDEALFHHPFFDhAAAVGCG.DEAEAGCGTBFEhABAJBAC..bFADaAHF.IFAFOACGSAGEhABACHHEBDAG.hACA...,2,-24,2,26
fXcNSbDdEHMGUFgOaTBLZKVAYIWRPCeJQ,..IBFCPFFD..eDCBQEGB.XAADSCGAhAAADDBFEADBHADCMFDHhAAAFAHBaGAALAHDKDDCAIEEYCADhABARDDBJHECfGADcGCEdEFB..hACA......hADA...,1,-3,-12,9
KLFNEAabYJXWGMHeBRcVTCZIPdOQSDUfg,aGEBJBBGGFDDHGAEeCAGBCAD..RCEB..VGFCTCFA.CAGH.IAGHhAAA.OABAhAFASFADDCGEfDGDhAIAKDDBNABF.ACCEXEBBMCIBPHCC.hBAA......hBBA...,1,-8,-31,23
KfMOPNHLZQWbYaDdSIRXJTCFeGgBAcVUE,UBDFEDGEKAGHOAAB.HEDFLEEBZEAB.QGGF.hABAbBBGaGFD.dCHGSFBBhAAAIAGBJFHHFFDBeACGhABABCBEAAIBfFAGMCGD.NIBDDEAE.hACA......hADA...,2,-22,-1,21
VSTRFLGHDCBdOXZfabPKcgeJQMNWYUEIA,VBDDTBBG..RGAAGFEHDDEHBFBE.OEGHZCAB..aAGHKAAEeDFAhAAAMDAH..NABH.UBGHhADAAHFD.SEBEhAEA.LHBACHHD.fBDBhAFA......hAGA...,1,-20,-31,11
LbQPKYVFGeCSOBUDAfHRdZWXcgaTMINJE,HDCDZCEF.XGGEaFBHMIBA..JCHDECBCQBEC..hAAAPGDAVFAHFEFDCDHDBEDDhAAAAADCdBAB..gAGFhABA.IADE...NCAEKHGChACAYAFC.SFEDhABA,1,-9,-35,26
cHDQANUVSZadMGOegCILBPTKJXRWfYFEb,VEGHaGGEGBEB..eDDFCEHHBBCFKEAARBAA.....fBGFhAAAEDDDHFEHAAHESEFFhABAZFAAMABGIEBGhAAATADC...WHBGFGBDDAGGQDFBhAFAdHDF.....hACA...,2,-20,-9,11
SOcVKBHMfaFAQYCNXIdDZTeEGbURWPgLJ,QAECCBED..IACDdEGDDEEFTCABGCFGRGAE...hAAA.gAGBhABASAGEOHDAKFDABDDDhAAAMDFAfHFBAGIFNIABXEBHEBAFUEAH.hACAPEHDcBBF.aGGDhADA...,2,-20,-19,1
MHTWcFbfKaGLEdYIJNZXUSBPQOgAVCDeR,VECADGDHeCCH.REEA.HABD...TAEGFADAKBAEGGDBdGBA.hAAAJBGBXGGHBBAGQEAAhAAAOBHFCCAG.MIAEhABA....cAGGaHGE...EHEChABA....YCHBhADA.,1,-14,-26,12
aMWNSDPFJVZdGbHRYEXOBLQUTAegKIcfC,KBGF..IADACFEE.aDCAMCAC.SGAEDGBFFDGFZFCEGEGAhAAAHBAHEAFABEBDQGGFhAAAAHDAeABG.fAHChABANICF..JDDA.dBHA...hACA......hAFA...,2,-27,-21,6
SGdNHFZfIgWJRaAUCeTYEOPDLVcMXQbBK,CADCTDGF..OFABDEBGLFACMCDH.QBCAKGEAdCAFFBFEhAAAIFFC.JHCChAAAADGBeDHFEAHD..cBAGhABAbEBHBEEG.SBEDHAEFfGHGhACA....hADA...,2,-34,-13,21
NbLJOXMVgRAdcYFPKUSfIGDEHaWTBQZCe,dDGHFAHBKEEHUEAD...SBEHGDAFDIDGHBAC..aDFABHBFhAAACFAF.eEEGLFHHhAAAOHDEMBCG.RGBAAHGHhABA..cGGC.YAHD.IADHhABAWCAC...hACA...,1,-18,-36,18
NYZMeJFcTHfCXOIEGULSAdgPKDWbaQBVR,dGFHKCBBDCGAaBGF.BFEBRECG..ZCCA..MBFGeFAG.FAEHHDGH.hAAAXFCC.EHAEhAAALBAF.AHAD.hABAWBAD...bGFENEIC...JDDE.fBCDhABACBCB.IFAHhACA,2,-35,-25,10
KcCeMPbZJWSEBUTgOAXGHfaRQLNYIdVDF,XACEHDCCRFBCQBEBLHBC...ICAGDFIHFCAEKDEBCHEEeGFEhAAAMDGHZAGB.JABESBFEhAAAEGAD.BHGEhABA.gFACAICAfDHCaDDBNAIG..hACA......hADA...,2,-27,-2,25
MHgLTSUfeaJFOWCBbERNdVPZYIKDGcQXA,HDCCTBBFSFHD.UGDFaFFBFEDDOFBDBBFARACCdBGGVFABhAAAZDADKBDCDIGC.QAAEhAAAADHHMBAHLDDEhABA.JEHBCHAG.NICD......YAFChACA....hADA...,1,-7,-19,12
FBKGMTHCYSaUAPELXdNbJcZWVROgIeQDf,EEFEXBGGdHBB..JABDZDFA.REBB..OEEBeFDBDAFABFGCKCEFMADChAAAHDAC..CCAG.aBFAhAAAABEALHAA.hABA.cGGEgABGQCGFfHGDhACAFADB.....hAIA...,2,-20,-16,4
fUbJDOZIWPSQRYTcVFCGXBLdgNaMHeEKA,UEGBDIAGZFEG....IHBBSHBERBDB...TAGEhAAAFBFACAHBBADCdFAFaEDCMACDhAAAEBCBAAEB...fDABhABAJHECOFACQDGH.YAEBhACA....hADA...,2,-41,-28,13
dWXLCcFRMEVIabTNKfOSBGHUJeDgAQYPZ,QEDBZBBCdEAGLCHDCAFA.FDEEECGB.aBAD..TFCDKGHHOFAChAAABGHGHADG.hABAJHAADICEACAB.PCCGhACAXGFHMAIH.IHFGNAAB.fEHChADA.SEAChAEA.,2,-26,-15,11
GZIATSRCgFLfPBeWEbUYOJMVKQacNXDHd,TCBDCBCBFHDE..LAFFBFBCeEFG.EBAAUCAG.OFGFhAAAJFFFMDECKCDH..QAGAhABAaBHF..cGBGhAAAXDGEDABAdAEGGEBDAAHESHCAhAGA.....hACA...,1,-13,-28,15
HDfKgNSTOAQWJVYeZcRUMFaGEIXdBPLCb,QDDEVACE.ZABBRCEHUEGGMDGHFEABGFAB..ECGEdCACBADHhAAACHBG.DHGGKHDESFBAhABAABAA..JAFAhAAAYHBGaDDH.IAHH...hABA......hACA...,1,-20,-25,5
EUWFdJZGNOHADPCIcXVeSYBKRaMgbQTLf,DHEECAHA...XADEVBEE..eDCHSAAAKEGB.aDEBMICChAAA.QGGBhABATEAFLGAGEDBHFEEGJFAFhACANBIGAEGF..IDCHBBDC.bFGD..fBBChADA..hAEA...,1,-19,-23,4
FBDISVeHKTcCJbgRXZPQaYOdNEULfWMGA,BHCGDEBA.SGFCHFDCTABH.CHGH.JBBARBDH.ZAFF..aAFAOBABhAAAdHCH.EEFGLAAFhADAMFCGGEAGADFFFFBGeBHFhAEAKAHH..gCDA...hAIA......hBFA...,2,-19,-13,6
gNFUSHWAVcRdBMZTOeYLbKJaIGXDECQfP,REDEBBEGZEBH.OAABeAACLBFCKDFH..JFAEaHFAGCBF.hAAADGGBCCBGQDGBhAEA.PFAHFGCESAHBhABAAFIF.dFHA.MFFH.TAFFhACA.....hAFA...,1,-22,-29,7
gJWOKcaCFAHfMVSQIBYUELbNDRZedGTXP,HCBHVFDC.SFAGBHBD.EDGALBCBDIAGZAECdHFDXBADhAAAJDEB.KAFACABD.ACGDMAEBhABAQFGH..ICHAhACA.UFAFNEDEeCAD..PHFEhADA.OEEAaAHF.hAAA...,1,-11,-13,2
QIHabLGPdBcfRAgNVYJOXZCUSeMEFWKTD,VBAGJBCAZBFF..UAEA..SFGDeDDDFBHF.KEAFDIFGHEDFhAAALDGBdHADBCADRGBCAFFA.hAAA....NEIGOCCBhABACEBEMEID...EBHH....WDADhABA......hACA...,2,-27,-24,3
WMIZPTCEgRbJNFBfeKVODaSXQHLAGdYUc,dDGBUCDDMBEEZDFD..CADF.ECDC..RFBA.JFDFBHFE..KFFGDBIHaCBFhAAA..QBAEhAAAAIFCGDAA.....hABA..cAEGIEEE....PEHFhABA...gAGFhACA,2,-43,-35,8
IRDJbNXAacWgEGYFVZKeTLOCBPfdHQSMU,aBFH..gGEAGECBFCBCKFDALBGBBCHFdCAHSGHFhAAAUAEFDBAA.JFAD.XGCDhABAAFADEDED..ZFADOBBAhACACAHF....fDHCMBIFIHFHhADAbDAA.NAEH.WAAEhAFA...,1,-2,-35,33
VFBRULTPHbOZWSICEDXfcaQgMGKNeJYAd,FCBDUFGFLGCCHAEAOCBHZEFC..SHEGCGDGDFFB..XGADhAAAaABA.QECHhABAMAHHKBFDNAEAeBBGhACAAGGB.dCHGBFAE..PDDAIHHG.hADAcGAC...hAEA...,2,-29,-14,15
gOMZUWQfYdXGHCSJTbDARcaLEBNePFKIV,RBDAaAFBLGEGBEFA.eABDFBGA..KFGBVFAD..MDEEUDDF.hAAAQDGDdBCFGDADhABASEAETGCADEIHhACAAACD.EHAGNIDF..IADAOHEC...WAFEhAAA.....hADA...,1,-7,-24,17
RKTDAYUXcGgeCLOHZIJEWMfFaSNbVBQPd,XGGGGBFEeBCCLEBEOFFEZFCAEEAHMICG...aAEDSABChAAA.NIBBVDDBhAEABBBGPAHDhAAA.KDFFAHCG.cABACHACIHHHfGAAhADA.FEHH....hAEA...,2,-19,-11,8
dEHSZUJeFgaBMCAXGVTfKRbLIYcQOPDWN,GBDBTGGB.KEAHLDAA..IAGGQGDCOABDhAAADCBGNAFGEHGC.HFEFSGAEhAAAJDDDFDHDaBABBEFAhABAAIBC.fBHA.YABG.hABA.WEBH...hACA...,1,-13,-30,17
HLBCOQbRNcMJfdSKXTYIPVADFGaZeEWUg,DDGDFAHBGFDHeHAAUEDCHDFE.LCABBADC.OGAERAAH.MAEDhAAAdAHGSFHFhAAAKDCB..XBBBhABAIHEBACFE.EFBACHDA.QAEH..hACA.bCCC....hAGA...,2,-28,-10,18
QEcdgfZHXUOJeNCBRIGDWAaTYPSbVLMKF,aFDCTGGC..SFCDLAEFMDIHKEECFFABQFEGhAAA.EAGGdDBFZFCHXAEEhAAAOCGB.JBBCeCAChABABHDHIACFDIFEAFHHPBHH...bGFAhABA......hACA...,2,-31,-1,30
NGcbaPVHOMBAeSDFTgXUfIKJYRQLZWEdC,eABGFBDD..TGDGUEFDKHCARBGB.ZAFDEDECdCCAGEAH.aGGGHDAFhAAA.BCHHAFFESAAFhACADIGE.fBBAhADA.IGADQGEBCAEB.cFCBhADA....hAEA...,2,-33,-11,22
VYeWXdGBbPgRNaCMTfHDIUJZSLFEQKOcA,VFGHeCADdBCA.GEBGBABB....bBCERFFDCEEF.MDEGHDAGUAFEhAAAJDFGZFAGLABChAIAFHCAKADEABIB...XEEGhAAANDIE..fGEEIBHD...hAGA......hAHA...,2,-19,-10,9
JcAWZLBVONgKbeRMPfDSFIUdGHaXQCEYT,LEAEBHHGODFCKGGEeBBARCCG..MACCDDGHFAAG..dGBGaHAChADACEBD..EGFF..JBFChAEAACBBZABC..gDDBhAFAfHCDIHDGHAFA....hAGAYFFCWHFG.NAAC.hAHAbFCC..,1,-23,-29,6
AYHZdUPRXMOFGIWQDEgJeVfTaSLBcKNCb,HDAGdEEDUGCAXEDHFBFH.GDFG.IAABQCCFEFBBeAFHhACATGGGLADHhAFABHBFKAGANIDFABHAZAAEMCIHhAHAOEAC..DIAC.......hAAA......hABA...,1,14,-32,46
faQMgdeDEZKIAYRUcJFNWGPCVSLBTObXH,UEEHFFCFGAAGCGDG.LBHHBECF.OFHBHAAFaHFG..MCEEhAAAeADAEADGKGBHAGAFRFEF.hAAA.JEAD..NDCD..hACA....WFAHSDFC..hADA......hAEA...,2,-39,-18,21
XRMGdASKbcHJIBNeaFUQZfLPDETVWOgYC,SEHHKAGHHFDBBADFeDCFUCEFZAEHLFFDDGFE..EAAEVAAChAAA.OAGDCBEEMFIDhACAAEHHJDAF..aDGDfGGGhADA.WGAGgGAB.hAGAYCCD..hAFA...,1,-7,-42,35
YBbDTHfSZNRVeCOXKGaMdPEUQWJgFcLAI,BGDDTEEESCFB.RAFG.CDAHOBGBKBAAGEAHdFBBEBCDQGGAhAAA.JCHBcGGGhAAALBDDADEGIAHBhABADIAA..fFFANACD..eCHFhBAAaDAGMABC..hAFA...,1,-19,-22,3
SbCcHXUPWKVNBFegDQTYaAOdZRGILJMfE,ZDAGGEBDJHDE.EEGC.CBAD.HGAA.UAAHKHBCBGEGFAGC.eBDEDEEG.hABAQAGA.hADAaGABACFDRFGDLBBBhAAASDGEXFGE..PFBANIDH.gADHhAIAODDGMADChABA...,2,-20,-9,11
DaZFdHLMOJGeEbBXUYVKSPcRIQCAfgNTW,...fEAAgDEC..TCGCDEABFFHHdCEEMCIHJFGFEFBChAAABABHUBBFKADCSBCHhAAA.PFCBhABAIHBC.CACCAAHBWBFCaAEE.ZFFFOEHFhABA......hAEA...,2,-23,-20,3
DKAdBcERHJeNaVIYbWMSPXLCOQTfUGZFg,dCEHBADCRFEDHFBHJFCH.eADE..VBEG..ICBA.hAAA.bEFEMEHH.SAHFhAAAXBADCHGGTDCAhABAGDCD.ZFAHDEIDAAHDEGGGNCAGaBHD...hABA...WAHH.hACA.OBBA.,1,2,-19,21
TPCUGLVYbJOMEIdKgWaFDNBHXQSZfAceR,REGDCACCUFGCGABE.LDDC..bFBBMBEC.EEAEdFEAKFCBaDEChAAADADG..BCEBQFEDhAAASBHDABABTGADhABA..VBAB.JFAFOHDE.hABA.IAEG.hAGA...,1,-13,-29,16
ARGbJeTFZVUMDIXBOYaNdWQScHgKCfLPE,GDEDeAFEFCGC.UGBFDHDCBEDG.aCAHdHFH.QEEBhAAAHAFCCCDCLABDEBBG.AFCFJFGDhAAAZCAFIEHAhABA.OADFWFABSFDA..hADA......hAEA...,2,-30,-15,15
fGPcTFIOAbBdUQLNXeRKJDgSEaMCZHYVW,BGDFQCAALCAGeAGFJBEHDFHH.EFDECAEB..ZAGHHDDC.VFBFhAAAGEEH.TABHhAAAFCDGAFAAdABD.NEIEKAEChACASHGAMIDC.fHEH.IGBAhABA...hAIA...,2,-29,-1,28
dKDCEcAPVeYXRBQaZFNIUTOJgfHbSGLWM,VFEEXBEC.RDEE.QACCZEAH.FCHDIHGBUGAAOBEDhAAAJAHF..HAAASEAChABALCAGMFIBhAEA.KDDFCGDHAIAEeHCEBAFGaBBBNEIA.....hAAAfAHA.hACA...,1,-5,-19,14
SaWdeLBTcIZYCXgNUKfPDAGbOJMREVHFQ,GDEBOCFBRCCFHBAE.SAGAdGFGeBAABAEEIFHDZGBGCHHGXECDhAAA.gAEDhABAKAAEDCIHAGAA.MFFHhACAEAHF.FHCG.aGGH...WDADcDAH.hADA......hAGA...,1,-3,-31,28
QbOCYdWULRPNaGEgSBVeKJfDXTHMcZIAF,FEDDODFGdAACLFAHRGBG..aAGDEAHBSFGFBCGC.KBDFhAAAJCCDDCBDHAEH.MHEEhACAIABGAFIF.CHEHUEDBhADANIEH...gEAAfDHC.hAEA.TAEE..hAGA...,1,-23,-29,6
XNTdPQUgFOJLbWHCYVGcKBEIDZaRSeMAf,XCAAdCAHQFABUEDF.FCHBLGBAHDFFCBFDGEDCBHGADAEDaAEAhAAAeAFD..ABBC.TAGBhAAAPFHF.OHAEhABAWBAC......cGFGKDCBIAHBhACASGAD.NDIA.hABA...,2,-33,3,36
fWCLGIRQOEaVFdDYgAKBJUNecSMHbPZXT,JGDAUGFD.eBFEMCCCHACBZDEC...XDGA..fEAGhAAALHAEIBAEhAAAQDBBaEDBdADFDFFAhABAAAHABCAFNAEH..SEBBPHBCWDFEhABA.CGGB.....hACA...,2,-37,-8,29
ZQeYVTFSOEANCLUIgJKfDMBGRPcHadbXW,CDEBUABD..JBCEKGHB.MGAAGEAG.RFGDHGDEaAFH..dDEGXAAFhADAQCAFeAHBhAEA..TGEAODDHhAFAAICALCHFfCFBBECA....hAAA......hACA...,1,-11,-30,19
JfMaQANgLKYOGHUWZXbBdFVPCcRSIeDET,LBCCKDDBGAFCHFDAUAAEXCFEBHHG.dDABFFAACHGB..READeAAChAAAEADC...fHBFhAEAaFDEAGIF.NDIC.OHBAhADA..ZDDC.......hAHA......hAIA...,1,2,-40,42
WfUZaYHLNOgcdQGeMEVBKXSTIAbRPFDJC,RFCEDIDCCDHD.UDBDZDBE.HAEALBAE..OCHHdAFA.eGEEMIDEhAAABABEKGGC...SHGAhAAAAIAGFAHD.fCFAhADAaDAB.YGAANFEF.QBCHhAEA...hABA...,2,-34,-18,16
AWMaHcGBIeSfXgYRDQUVLKbTJOZCFPNdE,aDHFHFDCGECFBEBEeDHF..SCADXGBCRACHDABDUAEChAAALFAFKDFE.bGEE.hABATCEH.OBDGhAAACEDCNICFABBHMCABIDCHfAHCYHCA.hACA......hAHA...,1,-3,-18,15
gDPJOFRITBbKLVdUASfXNCWMHZYEGaeQc,XEEECFDGHAEGZCDCGGCD..eCAFQAAHDGGBOEEFIDBEhAAA.BDDGKAADLEHBhABAUAEEAHHASBGEhACAWCBH.MIFAYAHBaCFE.PHAEhACAFHAC.....hADA...,2,-15,-15,0
CSBfaZeMHDEKQPJGNXcFRWdYgAIUVLObT,VCDHLDDF.OAADCBCGBHAHZBEF.MFADEEHH...KGGGJAFFGBGChAAA..NAAH.XGCGhACA.FDBDRGECdDBAhAGAAFGH.IHCD......hAHA......hAIA...,2,-39,-20,19
dIJgTKPWBaNXLMAZVeQcRfFEHObCGDYUS,eEEBQCEFRBBE.FFAAEDGAHABD.CHGCDAAHUGGC.dAFG.JFDHKAGEhABABABCXEGHLDAHhAAAACIBZDAC...fHDDhADAOHAE........hAEA......hAFA...,2,-25,-24,1
TeBJIOXCGZKUNDMgfaLAbdWVPHcSERFQY,dAABVDDDHBGB.EGEBQDAE.eCHDJADEOECCGGABKGFEhAAADAIDMDAGaAGGAHHB..hADA.PFGDRACDFBACBHFGhABAXCEHCFAD.UGBA.NEIG.....hAHA......hBBA...,2,-13,-4,9
ZYNFXKRLdUbWAScCaMIgJEDGVTOBHQefP,CHFGMEBA..JCHBDAHHGFBBOBAB.BHDDQBBE.eAFFhAAAfBBBZCFBFEABKGGHhABAdFDDUBDA.AIFAaGBBhAAAIHAD..EGGEHDCGNCIERBFD...hABA.WFAFSADBhACA..,1,-7,-28,21
CMTLgGREfIUXBNWcAFPeOJSQDbVdZHKaY,FBAHeCGDOAFGQGGE.DAIFdFHAKACFaFFB..MAHDLHDGhAAARFAEECDF.UCEGBAAC.hABA.NEAC.AFCGJFEF.SEAChADAbFBAZCBBCDDC........hAEA......hAFA...,1,-15,-23,8
ELWNcMZTgeBUfRGFXbdVQKCIaYSOPAHJD,DICALBED..NBBE.ZEAE.eFCABDGFRGAGFBAFdECGKFGH..aHGAhAAAOCCAAADD.HAFEhAAAEGEFMAIFUFEA...hABAfCCC.......hACA......hADA...,2,-43,-19,24
RECJPYXOHGFcbUWLgVKZDfaSBNQMAeTId,eABETEECdGAH.CEEH.JBBC....XFGGHCFEFDAE.UFABhAAALAFGKHFGDGGESCEAhAAABCACMDDFADHBEGEFhAEAOBFAGCCA.WCBF.....hABA......hACA...,1,-19,-26,7
LQXMaDRSHJedVUPAWYZbOEgNBIcfFGCKT,ZDGFEBCABHDF..IGEFFDEDKGGDLDABQACB.aDAHSAAHhAAAHECH.JAHHhACAeBEH.dAAEPDGFhADAAHBAbFFHOAHF..cECH.fGBChAEACHAG.MFIBhAFADAGH..,1,-13,-23,10
BMNQLOVKeAgEaUCJIbRPHfXScZFGDTYWd,aDCFCGHD..JADERFAAHCEG..SFEFFGGDDCAF...TCCFhAAAdFEGMAFELCHHhABAOBEGeHACEBAEIHCDhAAAfCAA.cAFE...ZDFB.hABA......hACA...,2,-25,-22,3
SbAFKedTDcNLUMBfJIEXQgPGVaRWZOYHC,KCDATAGCDAFBLEFG.BHGGfFDF.EBBCQGDEhAAAgDFDPEBChABAaGGEZEAD.OADDhAAACHBESACBAHEA.dAHENIAHMDACIBBE.hABAXCGC..hAEA...,2,-39,-1,38
gQFdCAeBfTUERaIbSHYcVJDOWLKGPNZMX,BFFGTAACRAGD...aBDASBAC.HDBEVGCGDADAOCDHhAAAKDFAGGABZCGBXGGDhACA.QDADhADACHHGAIDAeBCAECAHIAGF.bFAD...hAAAcFEA...hABA...,2,-26,3,29
TEFMWgaJKRUIZCQHOYNcdGVbLePASfXDB,SCADDCDDEFGF.MGECaDAF...KGBARABCUGAECHEA.HCFHOEFChAAA..NAED.dDCEGEDChAAAVBGBLFAFhABAAGIDBHHD.TBDH.FABE..WCHBIHHFhAEA....hAFA...,2,-19,-16,3
BVRUIbJgAeYaMFSKTWXQLfcPGdEZHODCN,eAACaACF.MEDEFFCGKHEA..XDBHLFAH...fEEBhAAAPFFHdGDGEBAAOAEBhAAADEHF.BBGHUAGChABAIHAE.JEHBACEBSGEEhAEA.TAEB.WDHBhBAA..,2,-30,-20,10
JOCXVeBMPIfgdcYTSEaWQUNLFHKGZRbAD,DGFECEFF.eADFMCFA....IEDBdEACTBCHEDGG..aAEDQGGFhAAALHACKBGGhAAAZEBDAIEAOBAFXBADhABABAGFfEDA...YACChAGASEGGWHAGNCCCFGHDhABA...,2,-27,-14,13
bWaDRMLJPBHUSAOfKIVGZYeXEdgFNQCTc,OCBBKDAAGCGAZGBE.eADGEADE...FFDGCEEG...TCDH.hAAA.WCEEaGABDABDRDFGMGAAhABALGFA.BGCGhAAASFHHAFACfACEIGFD.YAHHhACA.gDCFhAFA,1,-24,-29,5
PRCTJNZaDgfVHEcXKbGUAdQWOIYFMLBSe,QCGCODFFFEBABHCHeDADRBBF..CBBE.JGFCZFCG..DGDF..hAAAVADEHEDA.cAGAhABAKAHD...bBEFAACAIGHFhAAA.MBABSHFG.hABA.NIED..aDCA.EGABhAGA...,1,-8,-35,27
MWSRaUHYcJbDIfeTPAFQXNgZECGVBdKLO,QGEAXCAAZFEFCEGDBBEDLEAB.OCFASDCA.hAAAaFABHABC.cDGEhABADBIHfGCHhAAAeFDDACACgGGGEBCFdBGGMABE.WBBF..hAFAYDDGIGHH.hACA.PAFANIAH,2,-33,7,40
ANcYbFGdCXDOWHZIUMaBfEVPKJQTLgSRe,...NFAB.bADEGADFCGHE.DFHBHCEB.IEHGaCGEBBAFVBAEhAAAKDCA....TGEHhAAAgFAFRGAA.AHDBFGGHhABAXBCGZDAEMAIBfCAC..hABA..EGDG...hACA...,1,4,-31,35
OGfQCUXcdBJgPMNTSIZADaYLVRWHbFEeK,aAGHLCBF.RAEFHGDCFDHHECDGeDDDGDAAQGAGCCBB.UGGAhAAAXGGEBDGEJABChAEAMABGSAHHhAGAAGEE.DEECYFCB.bACE...KEEEhAAA.fAHGhAIA...,2,-25,0,25
XZHIRYDCALJEUQOcfTWSbGVFBeaMKPNdg,EGAAOAAD..TGCFSBECGABBFFAGeEAEKGCE.dEGDZFEHHAGHhAAARDFB.CHGEACCFLAHBhAAAJEEH.QDCFhACA...WHBABBAGaGHFMDDA..hABA......hACA...,1,-10,-13,3
SGQKPVTJDbefFOAEdgaRNYCcXHIBUMZWL,dBEERCEECHBH.HCBDBGAFMAIB.LGECQBACKHEA...TAFChAAADGAEeEEE.OAAHhABAgFEDaHAG.NDIG.hABA..XAFBZECFWACHSHBAhACA......hADA...,1,-16,-24,8
BFfAdTRbDeMZWCgYQIJVPNLOEGSXcKUaH,TGDARCACDEFEZFAA..CCBB...QACFJHAA..VCGDLFGDhAAAODCEEHBGSBDFhAAAKBFBaEDFBAHAAHHDeBEAhABAMFFH..WDADIBAE.NEIG.XGFBhACA...hABA...,1,-22,-24,2
eVZfFPMIRKCQcLNdEXSWJgTYOaHBbDAGU,eCBFVCAH.FDEF..MCIBKECF..QBGCLHDAEBGD.SFCAhAAAgFGFOCCGhABABDHADAECAEEGZFGFPGCChAAACAHEdGAGJACA.aDEAHABG....hABA......hACA...,2,-24,-2,22
NELMFQPdWYTBSceRbKDHAgVCGJUXIZfOa,CBHCUBFFZCEC.OEFE..aABFLABCFEBC.dCCF..TFFAhAAABFAESGDAhAAARGCE.KGGBADCAgAFFhADAJDDF.XFACfDBGMDIFPHAChAFA..cADGhAIADAGA..,1,-28,-35,7
SbCXYFDAPUcVZgHREQBOKIeaLfNGTMWdJ,UFAAVCCG.HADE.QEGEBGGGOFHFKFCH.eEBFLDDEhAAAGAAFMIAAdAHESFFFhAAACBACFGGHAFFFZAGHEDAC.hABA.aAFB.TDGH.JHBGYFEFhABADGCA......hACA...,2,-6,-5,1
dPJCTYeSEcbNWOaQLUVBMDfRgIHZAGFKX,KAFEXFDAdEGB..CBHE.eDHB..EGCDNADA...OCBFLFBFhAAABEEDfAHChABARBEDHFGBAABF.FCAH.JAFDSEAFhAAAWEFB.aACG......hAIA......hBAA...,2,-35,-17,18
ebQDPVZFBdEfTJUAcYHLgRKCaSOWGIMNX,HDDGRCCDCHDH.OHBAGADBMAFA..XGGBQDAB.DABHhAAAZFEFFFGABGADdCGHEBDHhACAfABCJFCA.AEGDLAAFhADAKBGEaGGC.ICHDNIEH.eECDhAEA......hAGA...,1,1,-24,25
YbFDQMZfRKLWaAdBJPIHcEGSVgCTUOeNX,JAHDHEFFGEAASCBA.CAFE.OGFGXBGDFADHDDDB.ZEEEhAAAKAAA.LCADhAAAABACBCFD.IHHFECBB.hABATFBF.eECGNIDF.YBEBMCAHfGCChACAaAHFcGCD.hAEA...,2,-31,0,31
adYGQcMZSPVFBJCbRXTDWHUOfEAKLNIge,KBFELCAC..ICCGaDAEGFADMGFESBDB.hAAAVDEHJGAECHED.XDEBhABADIFCHAFB.fDHChAAAEABAAAGC.NABHdHBHYHFC.ZEBCBGGFhAHA.....hAEA...,2,-41,5,46
MUFfOeRQNGWHcgVYdDXaTECAIZbKJBLPS,ZABCKFEEBDDELEDG.MIFAFAAGOHAE..QGAEhAAAGBGEHDBFgBEHhACAdGGADADAaAGACCCAADAAICHHhADAJBDC.SEHBfGEGNGDFcEABhAEA.....hBCA...,1,-8,-30,22
DOfJYWMFKUTAdGbNLEXIeHScZQgBaPRVC,dFFHGDEHLCCDEEBBeCACSAAHZECHBACFRAFD.DAIB..JFABMEAFhAAAKADC.AHHG...NEIG.hAAAIHBDHDDA..hABA.gBGDPHDACCHH.OFFH..hAEA...fCDHhAFA.,1,-15,-21,6
BDdJTNFHWMQAGXaRCbPIYLOcfKSEegZUV,GGDFXEDARDCCCDAG....ICCHOAFGKCHHEGAEZEGBBBCAdBAChAAA.JHDCFAAA.MCGDhADAADGGaCFG...PAEAhABALFBG.SHBGgEBDDIGA.hACA......hADA...,2,-27,-21,6
DKdIBZYPfGNAXRUJCgQLTMSaHeVWEFcOb,XGGEUFADCAAC.LAFF..TACCaACCHEFE.eHDEhAAAVFDHEDAEFDFA.OBEChACADGCEIAHH.hAEAZCCHPBBBNEAAACID.gGGBSHCG.hAFA...cDDFhAGA.KHAGBBGD,1,7,-33,40
FBbKOfPZYSLRVJCGXAcUDIgdEHaeNTWMQ,UAAADFEDdAFHHDEE.aAGGTGFC..MHDEFCBEKCFGOFBBZEAGLBAFhAAAJBDB.CHCC.hABAXGGF.ADIHIDAChADAEGAAeEEENEIEBHCG.fCFBhAEA..SBCEhACA.,1,-16,-25,9
gFbWLcKRSafdEIDYeXZGCJQVAMUTHOBNP,UEAFOABCBBBB....gCDHFFGELFEFKBHDaFAAEDFC.hAAADEGG..eBECZGAECDAAhAAAQGADAGAGHFFCNADB.hABAbCAE....WFEDSABE.hAIAIHHC..hAEA...,2,-33,-15,18
CcNKSBAgTIOPVXLRYUbJZfdDaeEHQWGFM,TAEEOBDA....XAGHRFDGUCACJCGHdDFCDBCD..EDDCHDCHhAAA.QGGBhABAFHCECAADKHGABHACgGAFhACA.IHDC.PDAH..hADA......hAEA...,2,-38,-16,22
KYGRAgQNeVHOaPIEBdTWbfMcZCSLXUFJD,QGFCeGBCOABHaFAH..EGGEBCHDdDEB...TDCE.hAAA.bEBGfDGEhAAA.ZDAFCADHSDHFhACALCCEFABAKAFHYAECAIFANDAC.VGCChAIAIDCF.MIBEhADA.XFEDDFEE,1,4,-13,17
TZKBgcCHAPQVJDdMWRLaNeUFSbEYXOfIG,QBBEJFDG.dCHERAACaDCCUEEC.FFHBEAGF..OHBCGGAFhAAAKBFFBHEA.CGHCAEAEDACAhAAALAFFSEBDhABA..bDFEfECG.IAHDhAFA.....hABA...,1,-21,-29,8
CUVAaJODINTFBdYZbReKHWGgLfQMEScPX,OGBGDDAE..TGEAdBCEZDFG.eBABKHGAGBCBLHBAQGBHhAAASGFGXABGhACACAFBADEG..IECFhAAABAHDbEAGHAGBWDEAMDAD..cEGDhADA.....hABA...,2,-20,-16,4
ZISaQGUcgALePCFDbfBRKdHWYOTXVNJEM,LBBGeBFAFGABDECDBHCE.dEGAHFFDOAFD..XACEhAAAJFBCZGFC.SCDDhABA.aEHFQDDFhAAAUFDAADGBCDAA.fHABKAFE.WDAD..hABA.....YACEhAHA,2,-25,-25,0
HbKTcFaEJLRVfSUQeWDNgdGPBIMAZCXYO,ZAFCXDEHOECCHADDKCAE.FGAB..aEAFLCAD.RGCASDCHhAAAeAACDFHFdGCDBGGDhABAACDHCDGB.bCGB.EBBE.hAAA.fCEE.....WFHHhAEANIEH.....hACAgGEH.,2,-32,1,33
VfaQOgEKMPeLZdScXBYJFbDCGTUWIRNHA,aBBFOEDB.KCGGeEFALBEDdFBC..SFDGBGAFFGFHDABDhAAAGGEF.TDDDhAAAIEHHHAED.AGADfDAChABAEDBDMIAEZACDXCGCJAFA.CACE.WCADhACANIBB...gGGBhAIA,1,-14,-21,7
IJcUSGLRAHNKWeBTYXgDOPMdaCZQFbfVE,KEFBeGFGBDDD..XEDCDEHH.ODAGdGBEaDBDZGAC.FBFB.hAAA.VBEHECGHJBACUABDhACALAEE.AECH.hAAANEAG.TEGH....PHDGCACB.hABAfBHA.hAIAIHHE.,2,-39,-5,34
NKDdPYTCGcgRObVaULHMFeXIEJBSQZfAW,KFCHdCDH..TGGBGACERABA.VFFCLBGFFCFC.eAAD.EFADSAFEhAAAZEFA.AIFADIAGhABACAEEOECD..hABAaEAEMIBCICADBAHBfCHEhACANEEH.....YEEFhAGA,2,-39,3,42
NSFPLHRYfbQVgMUBGdcTKDaEWOJCIAeZX,ZAFGSCFDFHCCLECARBCH....fEBAbDAF.QAAHhAAAMDEAUFGDBAHGhACAdBADKGEBEEDHOGBChADAIHACAAEANIAB.YGFA....hAGA......hAIA...,2,-24,-22,2
UCeMWIOFLGZcDEgRNXAfHYbBdaPTKSQVJ,HEADBBHFdDADaBCAKDDHQEEF.UAADCFFDeCGB.MAIHOFDHhABALHCEZFADDGGAECAEhAAARBDG.ADAF....fGHEhABAPHFGSAFC...hACAJCHDFAGF....hADA...,1,-16,-17,1
NYFILcaZfBJTgCOXPMHWKdUbGDVeSEARQ,RCAFQACGFGEGLEFGZEFGBECA.JAECCCFHOADB..PHCAhAAAMIBEHAGH.hABAKGHBUGGHDECEeFBChAAAADDGIHAH.aCGHfABE.XGAGhACA..WBBDhAHA..,1,-23,-28,5
ELFCaUAKDHfdObGJQIeRWSZgVcBYNPMXT,DBAFHCDFODBGJBFC..eFAERBFHZFEA..VBBHBEHA....hAAAPFGHMIDAEGAHCDAGAIDC.hAAAdEBD..QGADhABASBCG...YAFCNACB..hABALFHH.aGDEhAHAfEEB.,2,-31,-1,30
AFHKaCJcEYWOegBdGbQRMfLPNVIZTSXUD,FCBFKEBBCDDFEGDF...ODEAeBDGdGDD.GDFERABEMHFELBHHhAAA..PFEAhAAAIBAASBGAhABADEADAHAG.aEAF.JAFEcCBGgECFBHHC..hADA......hAEA...,1,-21,-30,9
YSdMJZKfIEcODQeHaGRLFPNXVgbWAUTBC,UEBHBGBHSCAFMEIFZBAC.KCEH..EAEHOFAGDEEE.eDHDhAAAGGDBFGEC..XABFhAEAbAGD..ABBCCDACdDBDhAFA.fAHGQGABaGGF....hAGA......hAIA...,1,-21,-27,6
eKUMTaRgcCJEGBZVFHSdNPIOfWQLAYDbX,DGFGeDCGUDDDMEAD.RFGF.CABC.GCEBBHHH.ZECCHAECdABB....hAAAPGBAIHEHOHCEhAAAQDAEAIAA.hAEAXDGAaBEG.JFAF.EACH..SCBChAFA...hAEA.fCGF.,2,-26,-1,25
RSTKNbCQgUXJcaeVDWAMOGELdZfIFPHBY,GFEDLDCHZDCAFFHHHAGFBACERAAEKEAF..CFABUAGFJGAG..eHEGhAAADABDAEFD..EBDCdGEFhAAA..ICAEhACASHAA...NIEB....QCEDhAEAcCFH.aDHFMIBAhADAfAEA.,1,-4,-31,27
VJAFZBaEdRUYbNGgTSOKIMPXWfQHDcCLe,ZFEEaDCD.dECAUBFB....NBEFGCDBTCADKEEE..IHCEhAAAMABE..XGFBhAAAQCABDGDFCEHBeEEAhABAJFAFBBBBEABFYEAF...SGHHhADA..hAEA...,1,-21,-31,10
YDMAbEOJNZGTVFRgKeUCBHXadWIfcLSPQ,OEABZAFDGGEFFCFG.KCCHUBADBACA.HEABdEFH....IGBEhAAAfAEC.SFCEhAAAQGEFDIDChABAMDIBACIBECACJDDBNEEF........hABA......hACA...,2,-37,-15,22
FIKYGTOcfeAWLXdVBUQgECMZDHaPRbNJS,XEGDBHBHQADF.CHGE.DAACHBBFaAFDRFDB..JBGHIHCDhADAKEEG..TFCAhAAAOEBBeFHBADEELDDAhAEAdEAA..gGEFEBCAPAHH..hAFANAICFBAB....hABA...,2,-19,-15,4
IYbAJMLVSeEFDOCdUQRGPcaWTfKNXBHZg,MFAESCFDFBCC.DGGGdFFA.UBGFRAFAGDCA..aDAGTCAAhAAAKHGABDDCHFAHZGACIHFEhABA.AAFEJABGhAIALEECECHD.CAAE........hBAA......hBEA...,2,-35,-12,23
LWAbKSUIVaegQMDBPNRFYXGTEfCOZJcdH,SEGAVAEH.eDAGMBIHBHBARCADFGAFGBCD..TDDBhAAACFBBOFECZGFAJDGFdHDBLAAChAEA.ABBCKAGAhAFAIHCB.aACB.DIFGPDFA.hABA......hAEA...,1,-12,-24,12
FKUMSOdQDEWXIaJTgCLNRZcYHfePBVGbA,KECGMAGFdGHEDHAE..ECEA..XFFB..ICHBhAAATCDBCDAHRGBCZBBBHEBG.fHDBhAAABBAGbFEDAAIBSCGHhABAOAEAaDABJACCLEGFNDIG..hABA....YBBHhAFA.,1,-12,-26,14
JKMfcHRPGTXbOdLAeZYgaCQUDFSEVNIWB,ZGFCaFAD.UDBGFDGF...EBCE..IAABJHAA.KAEAMAAFHCCDhACAGDED..XFEAhADAOAFEACGCgGCBhAEADGAG..SFDHNCIEBAGBfDBEhAIA...hABA...,2,-35,-19,16
cefDPaEOASXIUWQbRYNgBLJHVZKFMTCdG,SGCDXABFUEDDQBCG.RGFA.NEAG.BAEAHGDAKCFFFBEEhAAACFFAGAACeBHDDFIHEEDFhAAAADCF....WDDEhAEAbBGF....YEAFJEBH....hACA......hADA...,2,-18,-17,1
CUTIPENAaDGKYLecObWBQZFgXJfHMVRdS,DEFFKAGFLCHBeBDD.OEFHBHFEFGCH..XEBBJDACHCFChAAAMDCAdFBF..CABA.IFAHhAAA.PBAAhABAEAEAABAFaEGC....cADAQAGDhABAfHGF.SHAChACA,2,-33,-23,10
bVdeLGPZKRWBXHFcgTUfNOCaMAQEJYDSI,QAEHEEHHDFAE.SBHF..ICCAVFEHLBABhAAAPBEGZCEARDFEBDCChABAXGGAFFCGTGAAhACAfHAFCHHFAAGG.bBAH.eFEH..KACH.hAAA.WGAC...hAEA...,1,-8,-20,12
aHgUCcQAFPNETbDZeISLKfJOBdYGVXWRM,FCAAEAACDEEAeEHH.LHBEKFFC..OCDCdBGAGEEG.XEBEhAAAMBFGHGCEUAEChABAQGAEACID.hACAPDAENDAA.TACG.IHHEhAAASBBEBFAF.YCFChAEA.,1,-9,-31,22
TFVLRJeGCfMAcdUNKBEagHDZQWYSIXPbO,UEGFBEFDaFDHHAAEZFBFQECA.SBEAIDCD..hAAAXGEHODADFHGGhACALACGeHCGfAEFhADAcBGA.dBHAEEGEDDCAPBAB.TGGChAAA....hABA...,1,1,-33,34
RZXCYBIODAegSLUHEQbTVdcWfPKJaGMFN,SCCBUEAAHACHQGDH..TEGGVEFGdAFDfCFGhAAA.KACEaABHhAAAGEEAMDFCFEDBNCBCXAFBhABABGHADIACAHIHeECB.EHBG.WAHHhBAA......hBBA...,2,-20,-10,10
QFeVUTabMSGdLDgEAKYcOBZJPNHCRfIWX,KEBCOADDZEEE...JGBEHBFE.RAAC...fFGGXFADQGGGhAAAeBFFUAAGaHEAhADAMDAF.SCDBhABALAHFEDBDACCBBHDDCFAE..FDDHTGEBhADA......hAEA...,1,-14,-16,2
KLJNSAeaGQDRCdBMbPZEHUFVIXYcfWgOT,eBEHGDCHDDDHdCFDBDHFMAAAZAAHHEGB.UGCGFFGG...XBBGhAEA..cGCEhACAfAFB.WFFDhAHATACA.KBGANAIGABECaFAF.CEFC....hBAAEGHF.....hBCA...,2,-33,-14,19
QIVfMKGeRWDcNBJEgbASXHPOUZTYLdFCa,HFACUADBZGBCLADDFFEA.aGGB..QCEBIHDEVAABhAAAKBABGCGA.RCBH.DCEChACABAGBEEEBAAHE.PDFAhAFA..OEABYFHBCAACMIFAeBFE.hACA......hAEA...,1,4,-21,25
CBagQGZDTIUYWVcbeNOJKFMLXdERHSPAf,BCHDQFEBGGEFDDDEUGCE..VGAEeEDG.OACAFBBBMDIFhAAALBFHdCFEEAFERAADSDCChAAAAEAA.hABACGAD.aHGA.TADF......hACA.WHEG...hAGA...,2,-25,-14,11
CUfYVeFcdESWTaLIQHJgPZRGNKbABODMX,DFDEMBBFUEGA..VFEEeACE..FFBHEABD..SCFGhAAA.TAFGaBGFIDCGhAAAHECHJADDgGDDhAFA.PHAC.ZGFCNAICAIHGBCFGhAGAXABB.CEHG..hAHA.fBDG.,2,-18,-12,6
RbMUIQEcJVGBNefPAgODCXFaHKZLYWdTS,OFEGCBGGFAAG.HCCALECGdCBGRBGH..MEIHQADA.EGEChADAJGAGBHBDeACGADCCDIFChAGAaAGBKEAD.ZGEATEGEhAHASBAF........hAAA......hABA...,1,-10,-36,26
eITNXWSYQfUabcEgVCHZJAGPLKRBOdDFM,GDBHKDCBOBCGDAEEeFBG..TFAFXGEA..SEFEhAAAQBGGfGDDhABAaBCBEHAC.CHCFJFGHhACAAAABPBDCBEEDMFIDWDAD.UAFE.cDABhADAHEFG.....hABA...,1,-15,-17,2
VScgIUbNOafHBLFJTMWCPdGZKReEDYXQA,SFGB..gBEAUAFHOABHaHFAHEEGBEHELDDFhAAAFBBBTCGFMEAFhACAPHAAdEBEKACH.REEBDIBGhAEAYACCAHDA.IDCE.NEIE..hAGAfAGD.hAIAWAAF.,1,-15,-32,17
AILYeDTbXOaRMQFNgcHSfGKBUEJCZWPdV,LDBEeBBDDAEA.XGDDRFDC..QCFAFDGE..NAAFHAFHhAFASFBCKBCEBFFAhAHAEFHDCABB.ZAEGWCEHhAIAdHDHAIAE.TDDGaFHFMECF...fHGDhBAA...hAAA...,1,-13,-23,10
bVKaDZXYUCRASWGQgPeTBcfIFJONLEMdH,GAEHQCFGeBBFBHCD..IEDAOCCEEFACMCFFdAADVDGDhAAADFHHZDACUFAECAHEAHEESGGAhABA.gGDGhACAcAFFfBCH.FEEHLADDhAFAKDHHaGGH...hABA...,1,7,-24,31
AgGEPMTVNUCHXLaWfIeKOJBDZYSRbFQdc,EDAFMCBH...VGECUADB.CGEFLDGH..WCCCfGBFhAAAKAFGBCGDDCCDSEBHhAAAFABB.dEDGhABAcAGDAHIB.gDDE...hACA.PEFCNIEHaGAH.IHABhADA,2,-38,-32,6
PcMZdXNGgFULJbeIfDOWHASTQEaRYCBKV,QBBHEDGERBBG.BEDEKBGG...VGEGMIBGZAEBdDEEGEBGhAAAFFACLABEJAGB.eHFAhAAAIDHFDGFEODBChAFAAEGFaABG...CAHBXFCHNEAE...hAEA......hAIA...,2,-19,-14,5
EdQYCHXLcAUWMOBJSeRKVfZGIPaTbFDNg,MEIDBDBDSHACRFDE.KGGBfDBEZCFAGACEaBAGFEEFDEDEhAAA.ECGEdAEH.CGEDLCAFhAAAAADCOCDCJAFE.hABAVFAH...IHGGbFAA..NIBH.hACA......hAFA...,1,-13,-18,5
EAaGgFdVBIUfSPYZeXbCcTWMKLODQJRHN,GCBHdDBFBEBHUGDB..SHFAZEAFeAFDCEFE..TEDAhAAAKAGCDCAEJBGH.HABGAGGFFHGEhAAAVGAE...IFHGhABAPABA.YAFCXECA..WCAFhACAMBIF....hBAA...,2,-26,-14,12
RcNTZaMdIELeKHJDYOVgGfFWSQBXCUAbP,RCBETEFDMAAD..dGHAEBDDLFFD.KFAHJFDH.OHAEGAFChABAFEBGSBBChACABCGHCAHAACAH...PCHFhADA.NIAB.IHHG.DAFCYECFhAEAgAAEfAEChAHA...,1,-14,-33,19
ANFEbfMXTeKGIZgHQJLCdOUWVYBPcDaRS,EBCGMEBD..eCADKBDGZAGHQDGDLEEFdGDHUGGE..WDDChAAABAAH.DDGDSGABhABAAEDFFCBF.XAFFhACA.IGGGgGBHCEECOAHFhADA....YACEhAAAaFCB,1,-20,-46,26
KcaQWCeZEIfHXDAPTBUgLJbNFRGOdVYMS,BGBHUGBDLBDDJAAC.FCFARBDCdGDC..VEFBMCCF..KBAHhAAAQDFF.hABACGGC.eAEE.ECEBIFADhADA..fDAEDIAEAAHA..hACA......hADA...,2,-44,-34,10
BJEACYcLWGbSDageTKQdFHNIUOMXRVPfZ,CBDELDGDGBBADBADeHAC.KBCEFFDEHDAB.UAGDMHEGRFCE...hAAAVAGF..fBBEhABAJDHD..AIHE.hAAAcDDCSGAFaAED.....gDEEhABAdHFHNDIC.XAEFhACA,2,-28,-14,14
OVQRaMBIPEWJeLNdTHFgbDYCXfZAScKUG,SFAFKGDEUAEDGBGEOFEB..RDCCBBCBEGCF..eCEAdFFAFBAHhAAADABBCGGC.ZACAAICE..hAAA..QFABhABAaECBMFIBIDAC...PEEAhADA.WBHBNIED...hACA...,1,-12,-31,19
TgdAKaUSeEMDPfLFXYRCJNBWIVOHGbQcZ,aGCASFFA.eACCMBAA.DEDALEDAFDAGREFG.CCAABGCAhAAA.VAFFOFAFHCCGhABAbAFC...ZCEAdEBAhACAACHAUGGFEHEAfHAB....hAHA......hAIA...,2,-25,-10,15
aMSCJPfGRQFbDUdLBEKWZXHVTAINcYOge,..IFEBNDCD..OGFAaCHB.CCHF.JAEAGDAA.FBAADCEEhAAALFEDKDADZCBBXGFHhABA..VADEhAAAAHAC.gDGAMIACSDEAfHBFhABA.....hACA...,2,-40,-16,24
MaOTDYVKHZcfgJUIFCPXLWASBRbGdQeEN,BFHDRFCBGBEGQDAHeABG.EFEBMBBDOBGFDHFA..KHAEHACChAAAZBGD...fDEFhABA.UGBECDCGXFGEhAAAAAIFSGGDNIEBaFAG.TCCC..hACA......hADA...,1,-14,-17,3
BHefSbDMCVGcPFJEIQRZagTdUKWLYNOXA,eAGHSCDGDGEE.CDBC.GBAF.FGBHIHDDZEFA.TGFFhAAAKHDCLABC.hABANAIE.ABFEHBGF.MFEChACAPFBAQEBAaBEDdHGD.WADCODBEhAAAfHAB..hAHA...,1,-4,-34,30
dWHFYLQgUCBJGVEeATcNISMafRXPKDbZO,TFCD..cCABSCAG.MEAHfFDD.hAAAXAFGKGFCZBCCOCFDhABAdCHAFHAGLFHHhAAAgBGBUEBCCDDCBHECJDDAEGFFAIBGIHHFhACARABEDAGC.WEBD...hABA...,2,-13,-7,6
BdUKITeAFLfaEODPMGCbQRYZgNJVWSXHc,LBEGaCAF.DDDCMEGDCAEE.QEDCZGEC.JFHBSDBHhAAAHGAGBCCFdDGGIAEGhAAAAEIHEACD..PBAFhABARAGB...gGBA.WFFGhADAcGDD.KABC.FCEEhAGA...,2,-25,-20,5
ZgFRYeSaWVLCfdBcJPbAHTIMEUOXGNKQD,TAAHMCAEUEAB.GEDEQBDA.DDAHFBEBRBGD.SBGBhAAAaFHHLGDGCDAEdFHABEFBhAAAJABE.PDBEHDFHEHAEhABANIBD..KFAB.......YFCChACA...hAFA...,1,-5,-14,9
geAJNKadPObTIRfWcDHQVUSEGLZCBXMYF,KABCdDGBOBDG..bDFDRDCE.....fBEDDFADQGFEhAAASAADEDAALHBAhABACHBDMCHBYEEDhAEAgABF.AFCFaFDEICCE.WECFhAFA.....cAGFhAIA.,2,-47,-17,30
aCMJXIOdHUTVbWALDBSNKZFEQeGcRPYfg,DECCBACGKBFBEDECGBAARFGF......PHBCfGEGhAAAaAEC.CAEH..MBHDXCGDhAAAdFFFUGGH.TGAGhABAWDCBACEHLFDDSBBGNAIAFCCAcFAEhABA.JDABIACBhAEAOFFB..,1,-1,-37,36
VOdaLHMBXZcKYbNgTARESFJeUPIGWQfDC,SGGFJCHF.UECBIBAAGADD.QBBDDDDH.hAAACCHCdEAEaFEALGAAhABABEHAZGAG.KADC.bGEENIBHABAFhAAARBEH.eDEE..PCBD....hACA......hAGA...,1,-7,-33,26
GPMdSJXQLYONHEKbUAfDFZCcageRWBVIT,FEHBZADHCFCE..aBCBeFBDBFEC....TCBEMFGHdDEH.JGAGhAAALEEG.YGEGhAAAHAEBKBAFbAFCAEAHDICEhABA.RAGB...IBAFSEBEQCGDhABA...hACA...,2,-29,-16,13
NMbUJRaeIZTcFOWSgKPdXADQGfCYLBVEH,GBDACHDFLBFDEAACMFIDUACA...RBFAeGEGZBAFFEEH..SEABhAAAKGHBdGAE.DIBEQGFEhAAABBCE.HCGHhABANCCAaGAC..IAHEcDFD.OFAAhAFAWAFC......hAGA...,1,-9,-17,8
GBgDJcHSVELTYOfKaeWdRCXFQUAZIbMPN,ZAFDMFHFGBBDBCEHDBGAHFGF.SEBGLDBHOAAHKFEGaHECdEEBhAAACDFH..FDHFAHBAIDHEhABA.NCAE.JFFDhABA.EAEF.TGCFfABFeDDBWEAFhACA......hADA...,1,-5,-30,25
ITQZWJeECaVRKGOAMdXNgLFcbBPYSUfDH,MCFCdDFE..XDCALECDFHEEBHAE.SFDGUAEDDBHBHBABhAAATADGQFGEhABAJAAB.EFACCGGBaHFChAAAVFCDKEFGAHAB...NDCH.......hACA......hADA...,2,-32,-7,25
YHeTAZcVNFRDIXJEPOaLgdWCGbSfMKBUQ,ZFDHVEFARDDEDDAF..JDCC..OAAFLEAHdGAAGDGE.hAAA.SAGEhABAKBFBBACA.YCFGeCCF.hAAAAECBFBBEIHCAEGCDaADFCAHF.MIEG...hACA......hAEA...,2,-27,-17,10
VYDSPUNCBMeEROLXKIFfdHcGAJabgTZWQ,JADHaAEE....TFFCZGDCQCAH.DCGEPEAB.hAAACAABMDCGeEGBREAFOHEChACAXEEDKDGHFECG.hABAdCGB..cAFBABCFWEHHSDDDhACABHBC......hAEA...,2,-29,-18,11
JTHEGLSCOcXAKgIDPNQVBbefRZaWUMdYF,KFDBDAABQCCCBBHE..eHAERBFCaFDAMDFE.dCBF.FEBETADFhABAHFGFLACChAAACHFFXFAHAIFG..IFFChABAPEHF..NIAF...bBECfDAFhACA...WAFEhADA...,1,-17,-31,14
LJeRVdNOFEWIZTBKfPCScAQbaUHXgMGYD,aAACUECFHDAEMAGDDDFCLFGH.RAAF.dEGB.NADB.OEAB.hABAFCCCEGCCZBEFTGGAhACAKHBG.CBHAAEEC...QBCEhAIA........hBFA......hBGA...,1,-20,-32,12
ebBIRVKgFYNHJaMXfAGTCcWUDEQdLZOPS,GEAGCECEUGDA.EFDD.dCEGZEEA..OAECSDABeAAFIFFBhAAAKAFC..FCCCNDICHCBHhACAMABC..AHCB.WHFGhADALBHFBHCF...gGGAhAAAaAHF.fCFEhAIA.DBBE.,1,4,-41,45
BRFOMegLVaUKCfcWbdPJISNHGQZDEAYXT,TCCHBHBEFCBG..MFAGLFDE.aBFDKGEB.CADA..fGGGhAAA..WAHFhAAAbCGH.JEAD.SBAChABANAGCQCAEEHEEAAEEYHAE..hABARFGFgADGhACA...,1,-16,-39,23
KHJQdZgWFTUNDVYePEIGbSBfcAORCMaLX,CCDBLDEAKCFD.JBDEZFAB.FAGEUGFH.DFABeDAE..EHBAGCGGhAAABFDG.AACDMFGBhABAHBAHdCGF..TGCBhADANADB.....YFHB.IAEFhAGAfABD.hBAAOFFGaEEH,2,-31,-29,2
XeDTCIFUARaKNYLcJWMVfOESPZGdHQbgB,RDFGKGBHLBEG..JBCDVGAAEFGGZAEGHGFE..QCFDhAAABBBHDDEHCACBFCAD.AGAD..hAAA.aDCD..cGEEhABAMAIF..SBAFPEDD....hABA......hAEA...,1,-25,-31,6
IBXcfeGUMHPJKYdabSNAZVgEFDQTWORLC,VBBAFAFDDABH..QCGHODDF.RFFHLGBGBBHC..XFAGhAAAeAECUEAHMIAAhACAPDED.KAAEdADEhAFA.aHEENIAB.AGFHEDGCCHHF...IDBAhAHA.fFFDhAIA...,1,-3,-42,39
OBJdgcbDPSKUCZaVWIEXGfeHQLTRFAMNY,MBEAOCHHBACAdEAF......bDCBDAFA.PFECKADHCBFCZGDGhAAA..aCEB.IDHFhAAAEABA..XGAAhABAfBBEQEEBREAHNBAC..JHFEcAGFhAFASGCB.hAIA...,2,-28,-28,0
YaAgbJMWDSCVeRHFUZXBPEfQcKTOILdNG,JECHMEHH.DCDCCHGH...eCBHRDDCHACGZADABAHD..EFFCQEEAhAAATBAD.IHCEhABALAHD.NIBH.aGAFhACAAEHE....WAACSDGE.FDDGhAEA..PFAH.hAFAKFHH..,1,-17,-29,12
CUbSgQBYdHaLXPGeTRJDNEWZOcMfKFIAV,CADGSDDEBDGCHAEBLEAAGABCeGAGRAGDDADC...EAAHOAAFhAAAMFFC.FHGAAHHA.VGAEhACAUEDE..QGDChAGAaHCE.TEFGNAICcEAFKBEG....hAAA......hAEA...,2,-16,-3,13
AcCIZBVTYaFDSbdQWUfPKeJXgRNLGEOHM,CHEEZCGDBGDF..VFAE..TBEFaEHDDAAAdAHG.UDABKCDH..hAAAeFDGJDFG..RFGFLBAEhABAEBCCMIBGAAHB..hADA..IEDCSAEEQGABhACAfCBE....hAIA...,1,-21,-33,12
RIbHNdDCKJeMSQXPBULWfEYGFcaZOgVTA,RAGHHAAFdDCCKGGEMCDD.SHGE.QBEHBGEALABGhAAAfHEBEEECFGAFaBHHhAAAOHEETEGEABFB.IEBDhACADCAE.CHACeGAE.UEEGYCHBhACA.....hADA...,2,-33,1,34
XCdIKYPRceWEBHAJgfaMVTDLFQSNbGZUO,JACHaGFA...MEFBTCBBLEBF.FBAHNCIA..GEBBZDFHUAFFhAAAOADF.CABDKGAChAAARECBeHFABEGCAIBE.gAFEhACADEAB.SHDE.dHAHIEHAhABA...hADA...,2,-22,-19,3
OgZaIFMcQTBHbKSPELDNeWGfdAYCJRUVX,CFHDUGDC.OAGBZCBHFFFD..MFACQBDABBBHHGFEKBGHEACAhAAALAEB.eDAChAAAfFAAAEFHRCGH.XGBAhABAaHAE.IHHHcACASBAFhABADAFANAIC..WFEFhACA...,2,-37,-4,33
cgYGSAfXEeLBTCODZWaFUbHNVKRIPdQJM,XADDeEEGLHCGBHAB.OBCBZDABFCGAUAEGHFEDKAGA.RCFA.IAAAhACAdGGC.MEIFhADA..cDAC.hAFA.gDDFSAAFAGDFEAFCDDDFaEHFNEHE.hAIA......hBCA...,2,-18,-12,6
OFELfAUIbePSZaDQXBRMWVGTgdJNCKHYc,UGCGeDFHZBABDAEDBHGHMABG..GADFdCBA.CHGE.KDFHHCCH.OEHDhAAAFBFALAAAhABAAHCB..IHDChAGASDDHXCGFRFFC..TGAC.NAIA.hACA......hAFA...,2,-35,-7,28
TNVWQLaedJbZBACUYIRKSGFXEDHPgfMOc,CBAFUBBBRAEB.KEABFHFA..DFDDHBCF.....PGAEgFGBhAAAMFIF.OAGDhABATDFH..VCEDQDAHhAAAeADEdGAHbAGBACIDSHEA.hABA.EEEB.NIBF...hACA...,1,-14,-23,9
HSLVfcdIAaYJGKTZBWMbPUXOFeDNQCEgR,JCCBKDFCBADD..MBGDUGGGFEDDDDCH..QAAG.hAAAEGFAgAGChABA.HDDHSDHBhACAfFAGdAHEIDAGACHEaCAF.TGAEhADAbFCHOCCGCHHE...hAEA...,2,-34,-28,6
CeIVcGNaDBAgESZdWbMHRfKFTJUPYXQOL,SACEdCAHMAACHGBARBBD.KAFAFGFA.UFCD..XDFBhAEAODFACBEAeDDD.IHFFhAFA..cAGChAAANDIGDCFEAAHAZFAF.fDEE...hBAA......hBBA...,2,-29,-25,4
CWHJVOgaEUYBIKQNcbXSDTAMZdLGFRfeP,dDGFFBECeFEGCACDHGCE..JBBHODAB.EGHFBAGB.KDGEQCDGhAAA.NFEB.cDAHhAAA..SABDhADADGEHADEEZFAALFHBfBGD.WFBDhAEAaACG......hAFA...,1,-29,-34,5
NgFUERcDIdJBYVOeLZHWKCSMGTAXafQPb,XDGDQECH.....PCBHgDDGUDGFEGGFDACFJAHFhAAABGAA.OAEAhAAAZEAFKBDHCABCMHCEABBB.aCCAhADAfGEH.bFCDNIAF.FHGEcAGEhBAAYAFF....hABA...,2,-30,-6,24
ZVHWNMBLRAFdgaPQEfSUCKebOcIJYGDTX,dHBHaCBB.QGFC.EEFAfAGD.SADChAAAUFAHCACBeBFEOEBFIFDEhAAAJFEHDGIDZCDEHDFGhABAMBBHBABHAFHF.FCDB.gFFB.hABAbFCH.....hAEA...,2,-22,-6,16
ITOLcbERDWYMZPSefUAVBJHaFQKNCdgXG,JCFFaCAF..FABCKEDF..CHHE.dAGAGFEH..IHGBOAFBLHAEhAAA.EDCChADADABCMBIDZFBFSBDHhAAAfBGCAHECBFAD.NBIC.XDFAhAEA.cECDRBBH..hAGAWFFG.,2,-50,-7,43
EABNDOIPMCUeRZGYcKTfXFdgbHQLWSJaV,DEGHOAAAMCDGUFFFZEGB.GGAB.KAECTFAG..FBGDdGDFhAAAHBBCLAHHJEBC.hAHAECBBAIGEBEGF..hAIAIAEE.PDDG.CACD...hABA......hADA...,2,-30,-28,2
FeUXRagfDSJcVBIPGZQWOHCYAMNdbTKEL,dGBFTFFHLEGB.UDCAXCFBRAEC.aDBADFAF..JECFBBBHhAAAGABFZFED.OEADhAAACDAEABAE.MFIFKACC.eHEGhABA.fAHESHAAIEEBhACA......hAEA...,2,-36,-12,24
MeWZbHXICNGUQLgcPBAaKSYFEVTRJOfDd,aDBGKEAGFCAA..VDFARBGB..OFDBDGGAdHAD..eEFGZFDDHADDhAAACGHG.UAGFLCEDhAAA..gBAChABABGBGABIDEADHTFAAMIEE......hACA......hADA...,1,-14,-31,17
QfAaERScPFWJBeVGYgKLZIXdHNMUObTDC,RADGSFGGFEGDBEDB.eFDFGABC..KCBBLHCAZBFEdABHMBEDhAAAODAHDIFE.QDFHhACAAAIHEDFF.PFAFhAEA..WEHHJAFE.gGAF.hAFAIAAE.XFDChADA,2,-22,-21,1
cLPaECVWgNYOQbJGMZAFUISKBeXHfDRTd,FEDDSFCAKAHDBEAGHBAC.RBFH.dAAALFFB.aFHBEADDCECG.hAAA..VFGB..hACAWDAH..gGABhAEANAEHOHBA.bCCE....MBIHAFFFIDHAhAFA...hABA.fDDBDCGB,2,-33,-8,25
aYLONRBGUeXZbgWIASDPdVFTcJMEfQCHK,SACGDGCGdAGFFCHH...TAGGMACD.QFCCKEFA.aFGDhAAALEAHOCDGBGFFhABAGBDCeDAFZGCG.WHEGhADAPAADJDEECCCD.NDIE.UGGH..bFADACFC.hAAA......hADA...,1,6,-23,29
UfTXLJaRYIVCeZFbSPKDBdHWGOEQMcgNA,TBBEJBCB..aEGGRDFC....VADEZEAAFGAG..SHFEhAAAKFGGdEEEHBEEODDHhABAMABCgDABhACA.AGCFXAGBLHDGIHHGeGDCDIBE.hADA..BCHA.EAADhAFA...,1,1,-27,28
RHMTJZPKDEbLecWOIfXGBSaCYQgNVAdUF,FGGARCBHHFDFMECAZAED.KACHDBGCLBHB..eBCAOHACfFCDhAAABBAFCCAH.QGADhABA.NIDDABBATFGChAAA.EEADcCGHXDEA.aECD.hACA.YDAD.hABA..dFFC,2,-19,-16,3
ENPRITCKMYcAgDGOXJdBLfUVbeZaHFSWQ,DAFDGBEAOGDEJGAEBCBBLDCC.UGADeHDG.ZEGFFAAHQDBFhAAA.EAGENDIA.hABA..RABG.CECAMDBHhACAAIAE.dADG...fEGC..hAGAaEEH.SDADhABA..,2,-37,-14,23
XCdJRQVZTIOSNcAGKabWBEMDPLYgHFUfe,KGFEaGCCBGFEEGDE..MCFGLBED.HBAEFFACeACACAHE.RCAAQDEFhAAAVBFGZDAAOHFEhAAASDHBAAFG.hABA..WHAAPEFC....YHFGhABA.fECDhACA.,2,-29,-14,15
SgHPOBDXFQZeUWIGLaYTVMENcJfbdCAKR,KFAHRFEGHDCDOEDFBHDE.FGBDZFFD.UBCAGAECLBAH..hAAAaBAG.TAGHMIBEEFHFhABA..JCABfDGFhACACCCFAAACSGAFDADCeCFCIHHD.hAGA.YECF.hACA...,1,-13,-22,9
OeXJQVIWbEfNgBTCKaGRHYAUSPLDcMdZF,SDGBDBFEdBABZDEG.OBBF..XGFDQBDD.IGEFhAAAEGAG.fEADhABABFCAKDAFRBCFADIHPHBEhACAMIAAJEHD..VAFE.WEFBNAAFCCFGaAHDhAFA......hAGA...,1,-11,-28,17
HQLSTRUIYGdcKVOAbXBCfeNgMJFZDPaWE,XEABCGHF..eCCEMDGHZDFG.aFAEHFBBLDACTBDARAFA.hAAAUAGH..IGDDhABAYEHH.dEEEKABGhADAAACDfHDFNIAF.gAADhADADIFEEEAA.SHGGhAEA...,1,-14,-19,5
dGbgSPeFMODXCUaKERNIZLBTAVfWHQYcJ,VBGFHDBEQGFD.JBHDbBADSADBFGADDFAA.CGBHKGDFhAAAREFDZEDH.BACHAACB..hAAAfAFA.hABA.WCCGdBBHGEDDPFCFMEIFOBAHXADDhACAEFAHNEIC...hABA...,2,-13,-5,8
aIXAFQMBPEDNZYKfTJVdGUOLgCWRecHSb,FFCBBEDGECCFDBEH.ZFACKFHB....TCBEVAAFGADB.hAAALFEHCEHBRFFDHBFHSAGEhAAAaCAB.IEGChACAAHACMABGNIABfGDC.dEAC.hAFAODEG..eFHBhAGAcGGC.,1,-7,-19,12
SKaeLJYgCPHVWRTNMDBfOdQbZcGXIEAUF,UGDEKGDFeADHLAEB..JFHHCGGHHDACRFED.MBIBBCBEdGBEQFAGhAAAZEFAGAADEAGBhABAADAC..FAGH..SDEEhACA.gDAE.PCHDhADA....hAFA...,1,-15,-30,15
OXWUFBPbaKeMQGJTCZdcIAVgHDNYSELRf,HBDGDAHD.SGBARCAFOEEC.UEEBBGHDaEBG..KAAGeFAAGECGhAAACHADdHFH.AABE.VADHhACA..NAEHLAAGhBEA.fEHEXGAGWHEG.bCFAhADA......hAFA...,1,-3,-32,29
WGKdYEfURcJeMaOFbXACQNZLBVHgIDTSP,QGEHLFBHVADAHDCE.DCBA.SEAHGAGAKEDCEAAAUFGBhAAARAFF.eCAFODGFhAAAXCCGAFFCZADFBHCChAFATGDGdAHE..fABFMFIB.aGAB.hBCACDFB......hBDA...,2,-2,-2,0
cXHaBgLPRKMAeJTGFdbfVNEODZYIQSUWC,JFCCFFFFdACF....VABCEGBEDCCGZAFD...QAFChAAASGGGCFDHHDBEBCHHLEABhAAAKDFGAAIF.eFFEhABA............hAEA......hAFA...,2,-37,-37,0
USQBJDTINEOdPeZbGVFRXcLfMWAHgKYaC,KGDDaBEC.CCHE.UGDHBFFC..DDFF....ICBAOBABdGAGhAAAZAAAGAEGFGGCRDBBLCHBhABAMDEH..AAEH..hACA.gCCBQGGGJAFANDAAEGBB..hABA......hACA...,2,-36,-17,19
DbFJcdLRISUBMPfEYNgaTHAQWGZOXKeCV,QFCDGFCHZCCAOAEAKBAA..eEABCHBFDCIDFBDC.dGFGLBEGhAAASGHBMDHHEDDEhAAA....YBABhABANADHaAGEAHDH..XCFE....hABAbGFA.....hACA...,2,-22,-22,0
MefSELgOFbGVIWJQCYDcdUaTRZPKXANBH,HFFBMCAC.eBBEEFEHLAECFCHBGEBH.VAEEIHGB.QGBAhAAACDAHDEEEdHAFaEHDhAAARCFAKDACABAD.BABH.SECChABAbCCG...WFHBcGDG.hADA......hAIA...,1,3,-21,24
RVHAQBagKWXELTOUINDFdMJbfCSYGZPec,aGGGKCCBEFEBLHEG.UCBBDIGCFEAF.dABF..JGAGCAGBGCEFhAAAeCEEREDCHAAC.AEADBDHAhAAAXFCD..hAEAOADGMICGfFFDSBFE...hABA......hAHA...,1,-16,-32,16
XFbgOZHfeYaWEDRTGUJBMAVQNcPICLdSK,QEGD..PADGLAFFdCAESCCDXGEHbDBAhAAAOEGFHAGDfGCChABAaHAADGIBRBFA.TBCFhACAJFFFMFDDAGEF..NDAACHHEKDDE.FAAA...hADA......hAEA...,1,-3,-19,16
ILKZQONXdWFCERAgPGYSJDBUHfVcTbeaM,GAFGJFAGBAEGHFAG.VCCC..TEFAaFEFLHBGZCBG.hAAAODHDdHDHCHAAADGAPAAEhAAA.DGGBUABFfDAChADAeCEHMAFGIHHFKGHD..NCIC.FAHFhAEA......hAFA...,1,2,-28,30
XANLWQdaOeMZVIgTUREFPDfJbYHBcSGKC,LCDDdECFOABEZBAD...IGCETCACRGEAEEEEDEAB..JHEEhAAAHCGHBHACSBGEhAAAKFAEAICG.NIAH.aADGMCCChABAUEGCFDFH.bFBG..cAGH.CCEA.hABA......hACA...,2,-25,0,25
daDOSgVIeKYcUTbEHRBMXALGCFPNQJfWZ,LCCHFCFAQBAEJFHBZFACDEBC..OAHDSFFH..hAAAVAEDIHAG.hAAAeCCEKBAEUGEAEHGCBFEAhABAAAHBCDBD.PFAC.WADCaEEG...YEFChACA...hABAbAFE..,2,-30,-8,22
GDTCLbJFaMXAgEQIOYSZHNdKfVPeWcURB,EDFAQGCD.OEBASCACHAEBdFFHVECAeACBUBDDBBHEhAAADCGGLHEGhAAAFGAHXBADIHBD.hABANAEH.KCGB..WGFC..cEACRDAFCDHA.hABAaFHDABBA.....hACA...,2,-17,-1,16
fMBWKSYPVEaJGUeLbTFgDQXCORNHAZcId,ZCCDdAAFMEGHBBAFKFHB..SFDC..PGCGaBHBUCDDhADALBGDFEAADBDEXGADhAAAOGAC.HCABhABAAEIF.IEEG.fHFBYHEA.hAEA.EBBBeADAbAFF..hACA...,2,-30,-15,15
PMfBNbOcFCDaXReHUdKVWGgEAIYLQZJST,LDCAQEFCSBGEMCBCBFBDOBCACAAA..DICERGDGeCGFhAAAdBHEKEDDGEAA.hAAAAEIDICABZAEDJFHB.hACAfGGD.NAEF.cDAA.FHAGhADA....aABG.hAEA...,1,-5,-29,24
ZEHJSeQWCKGfXDLRgBaVUAPNMdFTcObYI,MDHDTFCB..OBAH..bDDAZDBBEHAGHFED.SBEHhAAA.eHACWEHDhAAACHHFfAHChABALBBABACBaAFFADGDNIDDdAGHYBBAIFAA..hABA.KCHBDCIH...hAEA...,1,-3,-22,19
adfGDceVTLNMREIWBKbHXQCZFJgYAUOPS,UFEBSGHBdAGADADBeFCB.LAGFRFAD.EABCBFHHHFEDQAAAhAAACDBAJEFA.AIHC.hAEAaBCEGDDH..hAFA..cDDGNAIA.IBHDKECDZCBE.FFABhAAAOHDEfBAEhABA...,2,-15,-14,1
JZEGOMITeRVCgDNdSQHLBWPKXfUbFYacA,ECFDGGBF.MBDETAFFRBBH..CEFBDBIBSDHH.HEEDhAAABEAAPEBHKDDEXGGDhAAAUABAFHCG.aAEBAAHA.hABAOHEEICGBeAHH....NACBQECDhBAAfDDAcGGAhAHA.,1,-13,-23,10
gcNaQJSZdIRMUPeAKDGHTYXLCBbfFEVWO,DACHTGBGLAEH.CBDB.BCEH.bDDAEDFF...OEEHhAAANFBB.aHGCQAGGhAAA.SEGHhABAZCGHIDACMBCBUGADAIHEKDAFYDCHFHDEgACBhAEA...hABA...,2,-34,-8,26
ODANIXBPUcEgSYCdQZVTWFafLbeKMGHJR,XCEHBCBBUGED..EBBDSDDG.dBFEVAGF.TFBEhAAA.FGDDLABAhAAAKADCHFFFJDAHOCABhABANDHA..IFCD..cGAHhACACAHEWCHBaDBE..bGAG.hAGA.MFID.,1,4,-34,38
QPGfbNVTIHFJEcYKLWdDgMSaZXOCBAUeR,UEDGREEHQBBHGBAB.....NHAH.IHFFFEBD.JCHDEAGEhAAAKADAdAEA.DIACSFAHhAAA.aHBEXGGEhABABCFD.AIEGeDFEfAFD..hABA......hACA...,2,-40,-20,20
HMFBNaZbSYPDQTdfEVGIAcOgeRCXKJULW,OAHFeEFFCCHF.KDFBLAEDHBBBBCACZDBD...SFAHhAAADBFGdGGCEAAEGEGA.IAFFhABAADACRFCH.JHDAMEIHhACAFECE.aHAC....bBEG....hACA......hADA...,1,-16,-23,7
MdZXIWYLRVNPTUSgBabQcACeEJGDOFHKf,CFGAJEFAGBDA.FAGEKEDB.dHADZABB....XEBFIFCFhAAALBFERFAD.VACDhAAANICB...TGGEhABASGEGBGAE..QGDBADHEDEAC.hABA..fCABhACA.MAFG,2,-36,-17,19
gWYXHUMEaLbTKDcGVZBdOFRPAJCINefSQ,CGFCeCCF.QFDG..WACAXGBFHCDFEBGDLAEDhAAAKEGHDFIHVAFE.dHGDhABARFCDAIBCICAB.hAAAfABHSCAH.YAHHMDIBbDEAhAIA.cFFABABFOCCBhADA.,2,-36,13,49
ABGLTWZacKCbYFUQORDVJegNXSdIMHfEP,BHEGGBCALADCZCEHKAEC.CHBE.FDADUCGHRGDG..DACHeEBC..hAAA.XGGDIAHDhAAAMDFFEBGB..TFGEhABAaCAE.......YEBBhADAQEGD.OFCFhABA...,2,-31,-18,13
VLTMCUgdKQEAHaBRWfGJFcSOeXIYPDbZN,aFGBRCFFGEGC.FDBFSFCE.XGDGPBBADAFAZBCHLCEGhAAA.CHBAUEAAhABAKGBFAEDABFDDJAFGOACAhBAA..eHCAIHHFNAIGMABC.dBFBhAAAEBBB.....hBAAWBHH.,2,-20,-18,2
VMAcRBZLWTIQUYegGfKXCbEPaDOFdJNHS,BGABZECCLCAF..IDHCUGAGeGFAGBBFKBEFCCCCEEFD.hAAADHCGdDGCHAFE.SEDHhAAAADIF.WFHBhABATGCH..gDADfABDXGEHhACAaAHF...hADA...,1,-17,-33,16
EdcIBbPHRAfMSDQaeJCgZKOYUWGLVXFNT,MCGHDGBHQDGH..aHCCJAGDCFDHZBAFKBCG.OAHB.UADBhAAALEDB.FCAChAAANCAC.EGHHdEHEBFBBHFEFhABAAGGDSDDEeCDH.....WABChAFA.....hACA...,1,-18,-31,13
dfTZDJNCRFGgIKMWEQbeOPaUAVcHLYXBS,HCABXBGABADAdCEETCGGZEBC..DHGEJEDFRAAH..GGADKHAAEABDhAAAQCCC.hACAOHDEPFHBAADFLFFGhAAASEEBfAGFCGFHIAGE.MCDChADA.....hACA...,2,-16,-12,4
DVMXaSgQLJCbZTfFKUWAcOREIBPYNGeHd,OEEERCEBEBGB.BDDG....NCAEeDDBDHGCMIFG..aCBDQAAAhAAACDHA.ZBFAhADAfABHFFAFKHBGAAEG.hAGAIFGC.PFBF.HGDGdGDBSDCDhAHA.hAAAgBDD.,2,-24,-15,9
YDgKEVdOLZUNFcBGHXRaeCbIQMAWTSJfP,SDGHJBEA....fHEFDBFHEHAAODBHZCAGFGDBBDCFhAAAGEDFRGDE.aHACeEDAhABACBCF.IADEhACAAGIHTFAHPAHF.KBBAdGGANEIC.XCEChAAA.MACEWAGF..hAFA...,2,-24,-11,13
eHIRdCSDJQaAFbPXWfGZcOUEBTNVgYKLM,FBADXABCGCCHZCGDOFBFBGBE....TFEEVAECKFFCMEAFhAAAHGEE.dAHADDDC.hAAAaBFFADHE...WHBGhACAfEAA.cABANEBD....hADA....YEHBhADA.,1,-11,-40,29
BfdHZTGSURYKJIcbaAXNLQCgEMPeVWFOD,LBEEQBFHEBAAMDDB..eCFDFFGGDCCGBGHDdFAATDCFhAAAGGDFSDADhABARBAD.KHDCIAEGhAAAaGAHADBFCGCF............hABA......hACA...,1,-20,-28,8
SBRUdFWYbCOKTLJGcXAeZfQHVEMPgDINa,eCBAQGAFEFBC.MEEADDEG...aAABBFEBUDAFdHBB.FAAB.hACA.bBFGCHEFKAFDLFFBhADAJAHF.XGDGhAEAAGAHHDGF.PBDH.IBBDNEBH..SDADhACA..hADA...,2,-31,0,31
UTbCAOcfQDRaIVMEWYLPdHeNKFSgZGJXB,OFDBQDCCDFAD.aFFH..MCDE.EEEGLBAE.dGDGhAAAeEHBNAFAKBGFFCHFSHGAhABAgEBFJEAFBDAChAAA.TGEBABIBfEHEIACD..hABA......hAEAWADB.,1,-20,-32,12
eWHQcMBNaSfYDREUbZGFKOdgJTAPIXVLC,XFDACCBCHDFG..MAAHaBFG...SDDCDGIHREAEUBABGECDhABAKBDD.dGAF.gFGAhACAAGGAIEHELBFEhADAeDECQGAG..BGDGNAEBEHCChAAA..FEAG.OHAChAEA..,2,-24,3,27
SGLIBOXJFZMCfHATERaQbPNKcgDVUWdeY,TGGFRAGHQBAF....PCDDNECC.KABADGGDUEACdEFDSDDDhAAALAADIFFFhADABGEAJBEBMCIDhAEACFAFAEID.EDFA.aFCD.gAFGWADE.eHAGhAGA.....hABA...,1,3,-36,39
MNCBEUVSRAfYPKJILTFaDGHgZQdbWecOX,...fEDBPHEEKEDELDHF.aHCCDAEGHCBDZBCGQDGFhAAAdAFDeDFBOABGhAAAMHBGBACCEGDESGADhAGAAFGDJBAHFEBD...bBECXAGECHHE.hAIA......hBAA...,2,-25,2,27
FJYRbWQcTMUgCIeEDSOVLPNBXGAZKfHda,KDFHdBFDFFAFRFBG..QADGMCDD.UDBHCBAB..EEGFDCHDOFEFhAAALFFA.BBAChAAAACIFZADH...aHGAJHFEhABA....YDBHcAGB..gGAGhACA.SBCFhAFA,1,-24,-48,24
HfGKFMDgAWTUSCXPeaIRJbZOVYBEQcNdL,TFAACDHD..eFGBaDEE.RBEFZCCF..OAECBGBGEADCQBBHhAAAdCAELHAGGEGEhABAMFFBAFCCSAHHhACA.IHDH.bDACcAGAfFDFhADADABG....hAEA...,1,-13,-26,13
WBFQEXLVYSOJgPdKCMIbUefANDTaZcRHG,DIDETGFBZEAGRAAC..GDBAFDHH.EEFALCEFSBGB.OCBAhAAAJAHF.dACDCGED.MDIFhABAUGGEAHAHaDEG..hADAHGAABAFF...XGCHgAEEhAAA.PDAAKFEF..hABA...,2,-27,4,31
QgXVMWbcGJaOHSUeCLANDZYFIETKRdBPf,ZDAGFGCAEEFCKCDERCFE..BDEG..QGFGXACF.MFBC.hAAA.bCBHGGBH.hABAaABBSBEChAFACADGAEIBDAGG.IHFE.TGABfBGBhAAAgAGHcEGHHFGDhAGA...,1,-19,-29,10
YbCVXMQOPcHJBADGeadURENTfIWZFLSKg,GCFCeDFAdCDAEGHF..TDAA..IAFGZFFFLADChAAASCHBKGDD.bCABCBAEMEIFhABAOHDA.PDCHhAAAcFDFBADFAHADDCFAaFDE...NIAB.fFBAhACA...hABA...,2,-21,-13,8
cBMRYNCbaVDASXHPWUEFIQZedfOJTKGLg,XEAAHDCDUEFGFBGFQADA.dBAGfFEFOHAEKBCDhAAAGBCELHFAcGAChAAABGAA.RAFDCDHBbGDA.hABADDIFSFDHEAEBeDGBgBAAhABA......hACA...,2,-14,-2,12
BSaTUPIKOeWYMNGFEVbAZDQcJCgLdXHRf,QCGGJCEELECDHGAABBHEaADD.UCAAKADD...ODFHhAAAeFECMCAHFAFEEHFEAFBHZAAHhACACDDG..dFCF.fABBhADASGHDPEHFIHEF.NEEF..hAFA......hAIA...,1,-3,-33,30
LAgYHUDBKGaJfWMbeZSFQcCVNIOPRTXEd,HFCDBADBKDGHaBDG..JCBFMIBG.ZDBHQFFD.CBHB.IAGFhAAARBFF.XCCFhABAEDDGABAG..YEAFhAAADGIFGBEA.WFAFSACC.hACAFEHFcGFC.OBHFhAFA.,1,-11,-41,30
IgBQbWJHPeLGACKZdERXNDUSOTcYMfVFa,CFBDKAAAZDFHEDEE..RAEG.DCHDUCCA..TGFH..MDIHFDAA.hAAAaCADBGAF.QAFFhACAJABEHFCBeHFAhAAAAFCEXACD.OEHDfBHC.IFEDhABAbEEC...hAEA...,1,-20,-33,13
dULJTgIEWeYPBaDZFXfSKQRGOHNcCAbMV,VFAFLHEG.TGBGEECC..eABFBBDGaADGFABF..XGFGhAAAfDAG.QBGFhAAAOFDFNCCHABEGbEEFhADAdDHGJEGB..WDDEDFCE..SAFFhAEA.....hABA...,2,-24,-9,15
TWacJeRPAZfbVXIKCDgGBEFMLONdYHQUS,ZCDHVAAFKDGC.DBEEBCDE.FGAFLBBF.OGCAdFCCQFFChAAAUFAC..TGFGhAAAaAFAJBEC.eEFEhACAAIEE..XAGH.CACEECCDMICE.NEAF.hADA.SDGEhAEAcDFC...,1,-24,-26,2
fOXWKNFMUDPHbTQYgBJEVRSACIdcGaZeL,CBBHdDDEGBGGaDAD.LADFOFGD..KAGCMBAF.DGGHHFAGQGCHhAAABGFCJADAREEFAFAEZBBHhAAA.eBHF.XGDDhABAWEBE..FGAD.......hACA......hBAA...,2,-21,-19,2
CFOAPYNIDWZJcGXRQdVaEfHegbMLBKSTU,...PHECNAEB.DGGGZABB.JCEDGCCC.RGBGdBBCEDGBeECBhAAAMAEFBEGGKFGD.SBGBhAAACHBDAIGE.ICFAhABAXBGA..aFAGfBAC.hACA......hADA...,2,-36,-24,12
CVcdZKeIEYRDAWGOHUgQTSXBFabfJPNML,GAEAHDBEUEFGQFGCSGCFBCBDFAACaCHH...JEBFMDIHhACACCCE.dBFCKGEBIBDEhADAEAACDIBE.AAHDOEAHhAEAXAGE..PHDC..NDAA...hAAA......hADA...,2,-24,-14,10
NEOBKcTMULFCdeGJIWXVHDbZARagfSQPY,RBEDaAGA..SCGBQEBB..PACHNCICBCDH..TEAEhAAAUGEHCACAGEFG.hAAAJHAEIAED.hABAXEFGDDIDABBFYAECKGBFMBAHdEDAeBBBhABA......hACA...,1,-10,-24,14
ZSYQRFbgTKGMBCLUEAfHPJcdWVDaXINeO,HCCDJDEH.dACBDCAHaEGB....XEAHIHAA..OFDBhAAASFHFRBBG.FAFFhAAA.bGDGTAFC.hABAMAIDLCEHAHFAcCFH..NIEB.YEHBhABAKCHHCDBG...EDBGhACA.fHAH.,1,-4,-25,21
COSfdJBPHYacAFLKXQRGeEbDMVWTZUIgN,FFBAXEBEGDDB.EBDGMEAD..TCAFUAAF...IBHBhAAACEFFSHDE.hABAfCDHBEHHPGDEhACAaCHDAHGFKAFCRFGDDBDG..WEADNADHOHBChABAdGGE......hAIA...,1,-14,-24,10
UZXJYOgfIRWAKcHedBQNCVGPFTbESLaMD,HABABHCCQEFAVBEEFGFA.ECBELDAFDEBEZFCA.JCDH.OHBChAAAIBGF.AFBBeABGhAAACEHD.....hABAPHFC.bAEBaBHFMEIF....hADA......hAHA...,2,-23,-22,1
FYfVXNgOaHQCBcdRKGPMZeTbLAEDUJWIS,DADDJEFG...SEDAFEAE..VAACNBBA...OAEFhAAAQAFFBGBFdGGDKHFEMDGFhAAA.ZCCEeHCGhADALDHBEDCGUAGFIGAB.fHCDhABA..aFEH.hACA..CHAG,2,-32,-30,2
cCDAXQSRFaYJbLHMKdGITegVZfUBNPWEO,SDCBRCDAFBBC..JHDALBHDHDGFKEADGEEB.TCEHhAAAeHAGZECEUFADBBGFhAAANBBF.ECADCCAB..DCCCAHIB.hABAaHGCMAIH....gGCHhABAfGGE....OAEAhACA.,1,-15,-17,2
ceVPXOdQbHIEUJRFSZYCMGfDLAWgKTNaB,KGGDaEEBBFHDeCCE....XDAAdDAGQBCFHAFAEDGARGEAFBGFhAAASAAFZFBB.CADBMFEHhACADGDHABAE...WFAHhAFANACB...cFGA.ODDB.hABAIHCD..hAHA...,1,-19,-30,11
ULEebORJIXHSgTGMFdaVQPZCKANcBfDYW,BAHEDEFHUGACeFEH.READ...XAAESDFCGBEDFBAEaFCDhAAAQGGC.CEHGAEAGhAAAfGGBLAFCEDDHhABAOADG.JCDFIADGgEGEdHDF.hBHA......hCAA...,2,-19,-17,2
eORKBEQGfgDTCJFaWYdXLbVANPMHUSIZc,MBFBHECESADDZCBC.OBFDBAHFQDGFGGAFDGFDCABAhAAAaECCdAFBLEAFhAAAAGGF.UACCIEAChABAeGFERGCG..KHGGfBGGTEGE...hAEA......hAIA...,1,-12,-15,3
ReCfIQgTJZEbLXOWHYBGdaPMSVKDAcNUF,UDDFFFGHCACB.QEAE..JBBBZBAGEDDBLHDA.OEHHhAAAHCECBHCDaAEEMDGBhABAKAGEABFARAGH.eEBH.hACA..IAAC...bFED..hAEA.....WEHBhAFA..,1,-20,-31,11
gTAeBLadYfFUKMDPREJbcCXWZHSVQGION,eGDGLACCdBGAFDCEKBEDMIBC..DBDARCFE.JABBCGAH..ZDCHHFGDhAAA.QGAEhABAOFFFTBAABFACaEFG.hAAA.fAGE...EEEC..hABA......hAHA...,2,-27,-26,1
SVbTLQDOYcEZGKRXFMIAadPgeCBJHNWUf,aCFGdFFFeBCGBGHAHCBDUAGB....SCADTEFFDIFEOHCGhAAAEGBA.ZDDGKHDC.XAAChABAMABEAHAECFBFNBED..hAFA...fGHC.bCCGYDAFhACA.cEDHhADA...,2,-32,-14,18
WQVJPdOYFAfgRCbZeNXMSLGUEIcTDKBaH,RGDECFCCZBCEeFBB..MDGFLAEB.UDGFEAGB...TABChAAAKEAFBDDCaAGG.QGCAhAAAJECGdDAB.OBAFhABAAHBF.fHFDgGGBNAIC....SEEBhACA.IHAChADA,1,-21,-23,2
eUZAMPBLQVSHTGgRKYbCcDfFWOdJXIaNE,MFBEBFACLCED.QGDHHBBDTBGCRDFCKGAGCGHDDFGDFCAC.hAAAdDED.JGAAaEBAECABeAEGhABA.ZFGDAHEBSHFGhAAA.YAEE..fABFhAGA...hABA...,2,-30,-15,15
dXKJcRYNDIfWeQbVZAFTSOGECBHPLgaUM,FADHTDBFODGH.GGADBEGFLBAG.aFFCMAFEdAGDJHDChAAARDDDDEAE..fADDhABAeHDAbBFGAAAHCDDEHFAFhACA..PCAEXCGEKHGA....hAFA......hAHA...,1,-12,-17,5
FGZUWXOYeDPfaKVJHgEbLcBRASTNIdCQM,TFCFdBBECDEE..MADGGACD.ZGFAUEEBXBGH.eFFEhAAAfAHEKGABHDDEEHFGhAAALCACBEBDSDHHhABAQDAAOECDDABEaAGAJBGH...hAFA......hBAA...,1,8,-31,39
WPXQCUGZVaTdMRfLNBFKObYJEDASIegHc,eGBEHCFH....PDADQCABUCDEZGACTDCFdADHRFFCfGHEhAAABABA.KAGEOHEChAAAbCFB..YBHBhABADBIBABAH...IAEHWCCDCHHE.aHFC.hABA......hAEA...,1,-6,-18,12
UOVBSXELaGYJcQHfdIRbWMPTNCZKAgDeF,DEBHeBFCUDCEBGGC.EACFLHBE.GEEEJBAFQDCEhAAAdABARAFA.MAEE.TFBEhABANEAAKDGG..FADBSEEBhACA.aHDC...cEGAhAIA.IHHH.hAAA...,2,-32,-10,22
RZePIbcXNfVTOKAMYEFHdBUDJWSGCLQag,ECFFdABBBEEDDAGA...SHEGLDAFQDCFRCBCZAFB.hAAAIBAHXEBAfGEBhAAAOFHBKHBEAHBHFEHBhABAJAHB.CHHH..aFCH.eBEC....hACA......hADA...,1,-22,-31,9
RBDJMOVIQKdLPANeYCFbSZafXUWTGEcHg,eDAACCFBFADF.ZFFF...XBCATEFEGBBAHBFERFBFBGED.hAAAMEIFVFAD.KEDBdAAEhACAAEID.NDHA.SCADhABA.aAFAWADCEHCCDHGAIAHC..hBAA......hBCA...,1,-13,-18,5
dPKGCSOHXAFgecMJQDUYTLbaWEIRBZNfV,FEACeDGDMAHFQEBF.UCAHTCDGaGCD.EABCBHHEZEFF..hAAAVFCBKEEBSAGHhABA.XABAhACAAGBDcBAHDEIBLHFGIAFDNAIA.dHEFPADEhAAA..CCHA...hAEA...,1,-6,-14,8
QSdOKWVTXUGaMPfRZeBJcLbNEDHIgFYCA,dDDFOFFEKHFA...TAGGXACD.UBGEGEBC.MCDFhAAAREAABAEFJBFHLABEhAFA..ECAFICBBhAGAFEFDAIAGSGCCaHEA.fFHEhAAA.....hAIA...,2,-30,-24,6
XBQfeGAYEaFMKVNRcHWCJbIPTdgDLZOSU,aGAHKHCERDABHEAG.CHEH.JFCG....PFGFdGGCDFAH.ZBBCSCDGhAAA.BEFAhABAeBHHACAFFBGAMABANAEF..hAAA...bADATGCCODDEXBBFhACA.fBEBhADA...,1,-26,-31,5
ScVWKCdOQARPGNgeIaMZHUbYTFLXBJDEf,RCEHGCDGeHBA.aEHBMEIBHFFF.UAGA..TABEFEAELAAGhABAJGAGDDCE.ECAA.fAEBhACASAGG..hAAAcGDCKEAECGGCdGEEODFGQADCADCC.hBEA......hBIA...,2,-16,-1,15
cMDbdZKVOHNGCBeLRXUfJQagAYSWEPFTI,SCDHEFBFFACG...TFFHMBBFdFGGKHDGHFAGCCCCLAGFhAAAXAEBUDDH.JHBGQDAGhAAA.AIBGWDFEhABA..PAHFDACB.....hADA......hAHA...,1,-22,-30,8
UeRKYTCAaIGgLHWNOVEcQFXZJDSPdbfBM,aHEAGCFGLEADHBAGOBFA.VEAAQDFGZADF.DBGGhAAASHGEbBBABCHHUGCEhABAeDHHKEEDCACCADDF.IHDBhAAA.gGAGEFGAXDBH.hABA......hACA...,2,-14,-4,10
GIdHOYSbDPRNXACMTeEVgZfUcJFWBKQaL,CCHGeFEB.EACFVDDHZCAE..UEBAFDADKGFGLBFA..GBBBhAAAIEHHdGAFOEHFhABASFFBDACA.PAFGhAAARCFDABBE....MIBGfDFF.hAFA......hAGA...,2,-25,-15,10
SUAONKQZbGCXYFEPeVHTJLRgIBMafDWcd,KEAAZBGBCBEEFHBG..EEFBeFGH.HACDLDAGRDFHBAAFMABB.DGBAhAAAdCAFAFHG.OGCA.hACAQAEGGGCBXACHhAEA.YFAFTBGGIDEDhACA..aBFDWFHHhAGASHGA.,1,-11,-17,6
WVQGYfTHaZPONJeAREbMCLUKXISDFcBdg,EGDDMDFAUECBKEDD....SBDDFADEdHAB..VFFHQAAGhACAGAAE.fEGChADAHBGBaAGB.ZFAH.OBEGhAEA.NIEBAGEACCDF.IGHCDFID.BEEEhAFAWDAD.....hAGA...,1,-14,-20,6
KZgOfHQTacMdbNDRVCeGSBJUFIYLXWAPE,KCHFOBHDHAAE.QGADTGEB.MEGDdDCHDFBC.RACECBGCSCCHhAAA.BHHFhACAJEFAFHGEIDAFLGAChAAAXGDDAABG.ZCDB.aAFA.cFBFhADANIAF......hAEA...,1,-15,-25,10
ecOVMNXJLKSgRfWIbTUDadEYHQGBAZCPF,ZEFDCDFAFACEOEAF..MDCAJCEB.LHDGKABE.RBGD...ICCEhAAATFBCDAFEEHCA.hAEAHFFGBAEHAECGeBAFhAAA..NBIE.SEEGfHGF.bAGF.hABA..dECG...hACA...,2,-26,-21,5
UFTQNgEbDBeKGRPVIdHXaCJLZYWSMfAcO,UAEBFHFCQDEFEGEEBCHB.GACA.RAGH.VDAAdEAAHEGD.hAAAXAAGCHDDJEEEZBACSGBHhABA.ADIBOFDHhACAgGGHDAFH.KHAC.aFAC...hAEA......hAGA...,2,-28,0,28
KOGJIdgUTZcfLPENMYSDVRHeXAbWFCaQB,FHFCCHBDBFAGODFDGDDB..dDCGUAEDZBADLDED.EADAhAAAMFGD.DDAGHGAChABAXAAEAACAaAGH.JFCFIEHFhAHA.........hAAA......hABA...,1,-15,-48,33
FRDISGUBYHMTKcOAfgVNadbZLCQeWXEPJ,VEAEdCCHLEFB.CFCG.QEGA.eAAFEACGFBFADBIHICDFhAAASFAFBGEDhACAMBIFKAEAAEEF.fEEHhADANEHG.aGDHWBBFXAGF..hAEA......hBCA..PHAC,1,-24,-32,8
GcaXPYBJSVgeQEDfTHAOWKFRdZCbMNLIU,OBAEKAHFRFGFZDCC..MFCGLAADUBEFGFEH..aBCFXDGAhAAABEAE.SGAFhABAeFBCDEGETGDGhACAAAFDFHDGCDBG...IAFEYHFG...hADA......hAEA...,1,-18,-36,18
QUCfZYWLMKEPdgVTIOeNFRSHbXJaADGBc,BDHEUDFACHGEZFDC.LEBBKABD.dDEH..TAEEOCCGFCCFHEFChAAA...bAEAaEDDhAAA.ACHCGEAC.hABA.fABAMDIBEHEE.PEABIAHAhACANIAH.SDAFhADADGIH...,1,-10,-34,24
fTgGIBUAWFeSJYNHQVDMKdRXLPabcEZOC,eFGHJBFBHBCDQDEHDIGG.KAAGdCHCRFAALBDC.aCAGbGEGhAAA.EABFCHEE..TDAFhAAAIHBHBCHEAFGCFEBDhABASDDF.NEIEMAFGcEEH.OAEGhADA..fHBHhACA.,1,-14,-17,3
SXEcLGNORPTdBCWMbKAHDFVYQUfZgaeIJ,FGDHVDACQBGC.UFGAfCHEZCBC.aABFJADGSFHBhAAA.EFEELDFGhAAAOAFAPDDAhADAdHAD.CHGD.MDAHKGBCAGEBDFCC.gABDhADAXADDNIBB....hBAABFFD.,2,-22,-1,21
LIfZESdKOVeUDFMTHJRQgNCXYPAcGaBbW,GBCFBHEBLAHFZDEDdAAHOFBFeBEBFFFFHGFARAAA...NAEH.XGBEhAAA.AEED.cDGDhABA..WEAGhABAEHDGKDAHDEIH.MDDBQCCC.YADChBIAaBHB...fHGFhCAA,1,-15,-20,5
NeGJXQEWLFUZaCOTfSbYDABgIHMcRKVPd,BEGAHFDBRAFCKAFGdEBAGBACQBDCLCCHFDFFZFGB..OFFHhAAASAAEDGDHAIGAMBIFhABA..cGAChADAVCEG......NEAGeACAEBBBaCHBCGGB.fFFEhAEA..hAFA...,2,-17,-11,6
KgDFGCHVSfMAJcOYINTdPWBaZbXEULQeR,JBBAOBBG....IAEAdHCDBEEBZFCDXFCFLHFCeAFChAAARDEB.KCDEDCFGCHGCHFAHhABASGAH.ADAA.hAAAYDAA.TEGGaEGAEAHD.gDAAhABA...hACA...,1,-24,-27,3
VNgeRIPZcOXKUJQLTbBWYHfCDASaMdEGF,SDEHMGAGdEEHGCDBFGEG...VABGNDDA..RAAH.ZGBEOFAHhAAAUGGELEAGhAAABHHHHCGBDAIBaAEGeBADIBFChACA...cDAC....hADA...KHBG..hAHA...,2,-22,-10,12
HdGfAgPOZWUMbNRBVKLDXSaJeITFcQEYC,OCEEZGFAUCAG..MHCGRDFHBDDELFFG.DIBGaFCC..JDBBhAAAeAHBFEGG..QACAhABACFAAdADGAFDE.PDDBhACA..NAFAKAAGSAFG.IHHGhAGAEEHF..YHCAhAAA.,1,-19,-36,17
VcFNQBdUCLGKaHOfWbMDYegAZSXRIJEPT,XCFFJCDA..TFEGFECGBBCA.dGGHUGBFLABEKEAEOAFGhAAA..bGAGDGHFhABA.eABAAEHBSFEBhAAARDFAECCB...PAFA.NCBGCHDH.aDDAhBAA......hBCA...,1,-24,-27,3
VfgdcQCAbGEJKZeLYRXITDPWaSUFBMHNO,EAFHZEDFLAEARDFG..XFGEIBBBDBBC..aDHFSHDAhAAAFGCDBECGMDCEhAAAOCAF.VDCFdGACCGHAAAIBJHAGhABAeCAB..TBGDWCGD.....hABA......hACA...,1,-16,-25,9
VeYSAWGUCBLgTZJacQNIPORKfbdFXDMEH,UBEHCFGHLEBBZCBD..JGFCQADE..ICAEhAAAOAHHfEDHhAAAdABB.XBAGMDDDEHBChAEAeHEGSAFCAHHG.BEFFaFDENIABPBHHhAIAKCDDDBGH....hABA...,2,-29,-19,10
gVGKebYMBNQCLfSWIDTJUZORPdaHAFXcE,FCGAEDAEGEFAKCDD.eACAMACBBBAH.CAGC.SFAB.hAAADFDFTFBAZEFGRBEDdHEFhAAAaEDEADEF...XGDDhABA..cGGA..gBFGhACA..YBAHhABANAIG,2,-46,-28,18
MKZGefQDSXdWHENgAOVJUaBbRTLPCcYFI,OGDEVEAA.UDECBGDH.RFFE.LBAH.CGGE.FDGAKHAAGBDDhAAA.eHAEDCCDdFBFhAAAEBBAAAEEJACE..bCAG.hABA.TAGF..PEDG.IAGHhABAMEIH.fHFBhACA.,2,-31,-23,8
UGEWOTcbFIBLfMJSZHVCYdNXgPaRDAQeK,QCBCKBGGGDFCECDEOHEC..TEAHFEHFBAAA.LEDBhAAAfAEHSAGAhACAHFCACACGdBAGXCFGhADAaCCHAIHEeEHHUGAFWAEFIHEBJGFA.YHAAhAAA....hABA...,1,-8,-10,2
gGaIBcPFRUdNOJZMADLTeHXEVWSQbKCfY,DBFAeADGEDEG..SAHBKAAG.CGDG...fGAHhAAAGCAAaBABBFFAFFGEUDEChAAAdCACNCDD.OBHHZEAEMEIFhACALFCFHGDEXDGFQCCE.YFAFhABA.cGEAhACA...,2,-16,-13,3
WgTfFXGbLUHNMSJeBDZVOARIaQCdPKcEY,aFEGQBFH.dEGBKABAEEBC..gEAAFFAHGAAALHAEhAAAUGGHMAIFeAEH.hAAABCGDDGDHZCDHAHGBIFHHhABACAEF...cCCH...WDFGhADA.....hACA...,2,-27,-15,12
AOSQXGNKLPbfHaURdWgecEVTMBIJZDCYF,SBCBGAADKECCLAFA..PGACHFECaHCAUEEAREAFdFHEhAAAeAEGECDGMBIDBDGAhABAJAAHDDABFBEHADIH.XGFEhABA...fEHG.gDAGhACA..hADA...,2,-26,-9,17
dcNDSQFYIVREMUWCHPLegTXbBGJfOAaKZ,KFAAZAGDdEFCDDDF.QBDFFDAG...IGCCVGDC.RCADUAAFhABAHAFDeCCE.TEFGhAAABGAE..JHECAEEBaABEhABASDDD.MBIFCHHELAHHhACA......hAEA...,2,-22,-17,5
RYXTfCZNDWGgbFcEMKdBIHPVJQAaULSeO,LFHBOFCBRDDB.XCDH..fAADCGBFDBDC.GCAEhACAFHBEMACAdHFHBHDEhADAHFDGJDFCAFGGaDFC.UAFEhAEAeABB.TAGHNBIG.....WAADhAGA.cGFEECCA..hAIA...,2,-24,-9,15
UAVBbDcQNIPGKeLMXOgZJFTdRfHSEYaWC,BDFEDGECQAAD..IBEAKEFGLEADMACAXGBFhAAAOBGDZCDB.TGCAhAAAdEFDfBAHhABA.SFGAEGHFWADFAIFEcCCH.NAIGPAGFhAGAgEBF.hBAA.FDBH.,2,-34,-18,16
JOZfEBRaCFPIGgHUAdXLWeTNMYSDcVQKb,dGAHLEAEeBGFMCCADIFEQEGC.KGABOHDCZABDEFEFBAFGhAAA.aHGAFGCFIACAhABAGADAHAGB.hAEAABFA.TEEESAABbDGDfEBHhAGACHHE......hAHA...,2,-28,-3,25
bDQMREULCSeKdFXfJaZBcgAGHPVNTWYIO,GBEDVDAD...TEBH..YACBIGFF.DEEGMDGFhAAAUAAACGHG.KEHDdEDFFAGAhADAJBHBBFAG.ABEAHCBChAEANHAF.OFDD.......hABA......hACA...,1,-10,-41,31
VUeQJRDYfLENISMgFWCaXGHcPTdbKABZO,OFAEUGEHeCDCRAEG.DFGELEDG.ECBCIADH.MDFGhAAAgGDF.hABACGHAaCEDXFAH.hAAAcAGFdHABAACGBABGZDCAJCADNBIEFEAG...hACAWHFG....hAEA...,1,-19,-21,2
FQVWfJHbIMcTgdDPEOSKNBLaYGeXRCUAZ,ZBAGVECHJEEA..HACH.MBADTFBADHFA...EAEHKFGELAGDhAAAaBGBGCEEeFDHCFAGAAAChACAFGHF...fHEHhABAIHAAdCHEOAHFBHDH..YDAGhACA....hADA...,2,-22,-12,10
fGVFISWNQbdcMDZLaAPHCBJgeXYTOEUKR,HDFEBGEBeABBXGCBOBFGECDF..KBBFRFAAGADGFAGE.SGGBhAAANACF.dDFEDGGFhAAAaHACCBEEJFHD..TDAHhACAfEEE.ICHB.WBADhABA.....hADA...,1,-14,-22,8
IAMOPTeDJSYHgXRGWQacKLZFUCVbdEfBN,MFBGTDCEDABD..SGBBHDDCRACBQGDA.aCAEcFFChAAA.LABEhAFAUGBACFHBdAFCBHEBIGGHhAAAAAHGOCDG.JEFAYBHD...hAGA......hBAA...,1,-9,-31,22
QdMLHaUGOefZRJbVEBDTXACcPSWgNFIYK,CCCHSBHF..gEAGFGHHKDFBdFCEHABEUABHOADAhAAAZBDD.JAGDEFAHBHEADCAH.hAAAAEEE....cDGDhABANICF...IGGHMAFCaEHFeFCH.hACA...fFFGhAEA.,1,-22,-29,7
TIGFDZdLXWKHAfPMYcCJNeROBbVaSgQUE,MGFGCFFE..eBACBBHCaCFDSDCG.QEADhAAAEAEBTGABGAEEDFAGZDDBXDGGhABAKDHBAHGA.fGBGhACAPDAE.YHFGNICHRAGB...OADBhAEA....hAGA...,2,-23,-16,7
YdDPKBIRGSHaLcfNWZCVEgXFTUAQJbeMO,JBAFeDBA.MCHHOCGHDFCA.BDHBGACDHEACLAAF..hACANICDZEEFVGCG.XGGChADAFGGAABID...bFAHhAFAdCCBKEEEIGAH.RAECSAAEhADAfAHE.CFDH.EBBB..hAGA...,2,-15,-5,10
PcbDVEfOWYKAdegJQHXRBILaSGCFMTUZN,dEEGeECHJBBAHADC.RCCEBBAELEAHGGDFFCGH.MAIFZGFE...hAAAPDAFDEDDEAFGOFFGhAAAKFFE.AEGC....hABA...gCAEIHAFCACC..NIAH.hACA......hADA...,2,-32,-6,26
PWGNfUYdBbcKOSFDegCRTJXAHQaLZMEVI,aBGHZADAMIBA..IFHBGGEHUECCdDEABAEEKCHF..SCADhAAAeEBHCHEB.JABBACAEHABGhAAA.EAGGPCDChABANIAF...fAHGcCCCDEGHgFAFhAEA.XEFGhAFA.,1,-20,-26,6
ZfLHDYAIeaFSCUQcJXRgGTdWObEPKMVNB,eDCBSEAGQEGB..XGFAgBFFdAGBODDBhAAAEEEHMFADVBGH.NBAH.hABABADBZBCE.LCBChAAAHEFEAGIDICAHCBAFJFBF.RFDF.WHEC..hABA......hACA...,2,-15,6,21
SQaWfFXVAIORGDBbMHedgELCPZcYKUNJT,OGDCRBEHGBAGBBDFMAHBHCFB.dBBEEHGECEDG.ZFFA..KBADJFAHQFBChAAA.aHGEhABAfGDG.hACAXACHAIECbAGFLAEHYCHBTFGGhADAFDDHDAEC.....hBGA...,2,-11,-10,1
NdADZfYRgGHUWETPFBKcCLXaeVSbMOIQJ,ZABERDEHGCBGHFFAEAFBFADGBGDBKCAF..CHAGLEEDeBHB..SAAEhAGAMDDE.IFHFhAHAJBHHACCHDECF..hAAAfGBE.YBDG.WHDAhAIAcGAF...hBAA..aHFE,1,-23,-33,10
HZTcaVFWeDYMQPXGCUSEIbNBdRgKJOAfL,HADHTDDBVDEF.FHECeDCD.DIBCMBIDQFFBGCBCSAFHhAAAIBHFNAAG.BHCDhABA.dGGDRBCAKGAFAIAAZAGDhACAaAFF...WFHH..YDAFhADA..CGEGEFBD..hABA...,1,5,-19,24
WcgdKaePAEfLbRCFBUDVIZXQSJMYGHTNO,LDDHREDBCHHD.BFFADFAFZDGHQEBB.JHECMBAG.HDAEhAAATBGHOACA.hAAA.gADFhABAaGBFABHF.EBBBFCCEIHAESFFHNEIEdAGB.KCAFhACA......hADA...,1,-13,-29,16
PWeIHMARDQcSdCFbVGLfNBTJUZXaOKgYE,QGFDdAFECFDC.FGDBGEGALBBHBCBAUCGAaADH.KGAFEEAHeAEHhAAA.HDEFABBFDICCSGBBhABA.fADChACANDEDZDDC..OHAG...hADA....YFFFhAAA.,1,-1,-41,40
bXBUOVLCFAfTcNGRQJHMYSaEIZdKgPDeW,TGGCGAEAQAGE.JDCHMDEG.SFCFhAAAaDHHIGAGZBFAKDBF.DBCAhABAeCACXGEHUGGB.hAAALCAEAABBNIBF.HEECEEEDdACDPFAHBGDAhADACEHE......hAGA...,2,-4,-4,0
FSLCXaZcVEMATfRbKDGdYPOUgHQNIeBJW,RAABKFBEGFADdAAG.OFEAUAECHEFA.QCCCeAEDBAFFFAHBhACALHDC.XDBAhAAAaGBE.ZBFD.hADAEBHHAGHDfHEBDFIF.....hACA......hADA...,1,-14,-25,11
ANBaDdQKCbWXMFHRgVJTSUOGEPYZLcfeI,BBHBdEADQGGGCECH..XGDFFGEHRADB..JCHBTAEBhAAAUGBFGAAEEGGHZCDFLHAAhABAeDFH.ACGDDCAFhACAKDDF.MBBF..gAGHOCHB..hAAA......hACA...,2,-19,-14,5
HdTfZCABRNKGMWSLPecQVDFYJEOUabgIX,RDAGKCGDGADDMFIDLCAHeEGB..QGCDFCCF.EAADaAGAhAAA..IFEHhABAdCEGfFDCCDDEAIAABCCFSFFFhABA.cFADDGGDYBHBhACA..JADC...hADAOHEE.,1,-10,-19,9
UWPFDEAgfZSJKXbCeOYBTdcRNHLQVaGMI,ZCBDSDAGKEGG.CBBH.OAADBDFDdFHGRADCLGDA..aGFHhAAAMEDAUAGF.FFABDCGEhAAAACDG.JHAC..bEDG.hACA....TCGGNIEB.HFBB..hABA......hACA...,2,-33,-26,7
bMENCSYFUeLABVWDRadcXTZKGHfPJgQIO,BBDEVFBG.DBAD.REAC.aAFH..dHBF..XFFAKGGGGEDAHBBEhAAA.JDADQCGAhAAA.OCBEMAHHNIDFhABACHFDFAGAeEDE.AADA....WEHBcAEFhABA......hACA...,2,-30,-12,18
TbaVEQcgPYUFRKOGJXZNASHMDCIWBLfed,SBBBDEADCHFG.BBFAeCBBdDBH..aFEGEBHD..QBGBhAAAPFHD.FABCREDDKDHFhAAAGADEZFBFAHADMIAG.hABAIHHDfAECbDFA......hACAgFBGYFFB.hADA...,2,-27,-14,13
gVbBPEARYCFcJOTUQDaXIMZLGKdeNWfSH,RFCHCECGFAGCOBEB..QFGFDEFG..IAHHZGCGLFAHhAAAdFGF.eDBE.NBAB.hABAfBFBHBEB.hACAbBBFBEGBAGAF..JCAD.aHGAMIEC.KCGChADASGAH.hAEA...,2,-28,-10,18
LcAMbHeTaPDdKBECZJXgGRUFfYWONVSQI,HBDCaEFA.DFACKGBGCEDGZFFG..JBAEGAACFBFC.....fHCFhAAAOFFFSEAGhAAAIEGDACHBMCDHhABAeAHBdGDABADG.gGAFYFHBNBEA.hACA..LAHBhACA..cDDA,1,-12,-34,22
YWKMeZSTBfXdORVEPNaHgDAJIGbcUFLQC,JGDCGGEB.UCADQBACCDDC.KCDCMFAHZGAC.BCHC.dHBHhAAAVEFC..EEEFaCGChAAADDGHABFE...IBEHhABAFEBE..WAFEeABA....SACAhABA..hACA...,2,-36,-30,6
NdVFXaOcEHUIPWBRJefSZMDgYGLKQbCTA,dCAHXDGBaEFH..EBGDHFCB.UCCE..IGDBBHAEeAFEhAAAZGFGDEBB.GABBhAAAKGGHCBEENABCFECA.PHAChABAJEFDMFID.gEAG..YAFChACA...hACA...,1,-15,-21,6
fCOZHFcXJQadSKVWRDbgBTENMLYAIeUGP,eDEFGFBHCFFB.HCCAFEAF.JAGB.dABHKAGGRGFE.DGIDBGAD..EABDMIBEhAAALECFAFID.UADBhAAAOCAHZGEEQDGBhACAaEEG.SGAD...hACA......hAEA...,1,-18,-21,3
IEfbSYLCcgAeQBaFKJONWDRMUTPXGVZHd,BDBEFCDFOFCEDEDEUGFF....XDFBGBGCZABEdAHAEDAChAAA..SHAAhAAACHFEAFCG.eCCGKABEJEHBhAEARFBEMDAB..TGAD.HADGfBEHhABA....hACA...,2,-30,-20,10
QfLEFgPVaAdWMeGTDOZCHcXIJBKYbURSN,dGDHMAGDGDEHDEFGZEAGCGBAHAAA..XBCGBAEDKCCG.UGGBhAAASFFA.QFDEhAAAfAGBFADEhABAVDADACHHeHAE...cCAH.IHHGhACA...hACA...,2,-26,-17,9
FAfQIMZHcXabBPCWJUSDOVgNLKETGYdeR,QCDHZFBGHBDBaFHFBDGG.CFBE.JFFHDCAF..OBAH..hAAANDIEKAGAEDCDGAGAhABA.eEAFFFFBAFADIBCFhACAXGAD.bABC.....PHFChAAA.SCCFhACA..,2,-30,-15,15
McDVRNTLBaYHAdbQOEeIFWJCPfGXSgZKU,QCDBOADF.eDBHFCCFJBGD..CHCBGAED.SEAFhAAAKFCCMFHHDEIHVEGHhABARGBELDADBHABaCAGAGEGhACAdFFCECGA..IABC....hAAA...WAHB.hADA...,1,-15,-33,18
cCfAPdBKHVaUQeZWYIENLXMDFgObTSGJR,dGCBHDFCUFGHeCDGZBFE..IFBCLFABDEBEOADG..hAAASGFERBCD.hABACAGEAHCHBECGaBABYFAFhAAAEAGCMBBFFDHB..gAEB.hACA.bFED....hBAA...,1,-17,-19,2
INdZbRSJeVKgafDGBYOTLAXPWHUcFMECQ,XDGBHDBBFBEFMHFC..CEFBQAECdAAHZEDDRBCD.SCCBhAAAJCHB.VGAAKBGCaDABhABAfCAABFFGOHAEhADAAIFCPEDF.cAGFIGABeFHHDIFGhAEAYABA..hADA...,2,-19,-8,11
fZRPVdGEYSHWALQUaeCgMDONTJbcIKFBX,QDEFaGAE.eAFFCHDHDEAC..OABATBCAJCBD...hAAAIGHHKAFFXDEGhABARBGBdHABGECGEGHDSACChAGAABIBLFGD.MAAHNCIEFFFBBBBFZAGD.hBAA......hBBA...,1,3,-24,27
JWUVgROaPFMXdZQNTLHICBfbYKDSEcGeA,JADCUAAE.REBD.ODGHFFEA..dEHCZAAC.QEDBLBEACGAFBDDBhABA...bCAHDIDEhADA.SDDEhAEAGAGAAHHEVGAC..aAFGMIEA..NHDF..hACA......hAGA...,1,-16,-35,19
HDVbMUECSdFYaXLTIAZBNgcWeOKQRfGJP,BFBB..gFGAeCEHKFGBRABGJAFCHBGBDIAG...MAFGCAACSACAhACAdGEAFGCD.aDAHhADA.LCDD.hAAAAGDAZCGBWDADQCEDfBAG..PBBHhAIA.bFEHECDHXFBHhBFA,2,-36,2,38
aULcEXYdQgJeBbGSCfMWDARHTFZIPOVKN,HFEBZCEFOFADKBCFUBDELDGH.EAGCdGAA.QGCEhAAA.JCGBbACG.SDAEhAAAMABEABBF.FHCGIHHGhAFANIEF..cEDH..YAHHhAGABBAHCEAFDCGG..hABA...,2,-21,-21,0
IGRaAeDVWcQBECObJZLSUFYMNXHgdTfPK,DDDEVFEHQBAC.BACHCHCBODBDZBGFLECCFAFF.MAIHhAAAHDGB.dABCTGEAhABAfDACKHACIHHDhACAGADGAHAH.eBHBWCDE...EEGD.hAAASEAD.hADA...,1,-13,-19,6
BFQfPERIYJAdHGNLWcZKUXegMSOaVTbCD,HGCGGADALDGBZGEAKBBFUBGCeFADSDAC.aBEFbEFGhAAADACBBDBHFDCE.QGAFhABAEEFH.IACBhAFAADIHdBGH...NICF.......hAGA...WFBC.hAAA...,2,-20,-15,5
XWRgHLbOCdEPcQFeSDJVYMBZAUaNKTIfG,aAGGTEEEGDAF.RBCG.HCDELEFDCFBCEACF.QAAGFGGH.hAAADHCAVAECMFIHBEHAhABAAGDAKBHDfHDDhACA.gCGHdFAC.eBBD.JHAC.hACA......hADA...,2,-16,6,22
gHdQDaNWEACVYMIZfRLKPBXUceSTGFbJO,CDCGMABGZADFLCFBKDCBBHAE...UBBBSEHDFAFC.OBDFhAAAdHCDQGGChAAA.DDHBaGDG.NCBEACFCIHAGhABARAGB..XGFHeCAD...hACA......hAHA...,1,-25,-35,10
VSdfABXJcbNWaCIHMRLTGQEZDYKOPgFUe,XCBHJEFH....NAGG.CBHFHGEALHEAQCGFZAAADEAF.hABAKEAF.OBBAFDHHeEBEhACAdHAHAFEGBFBB..hADAWGBCMAIB.TCDD..EBABYHAAhAEA....hAFA...,1,-18,-29,11
KgbcRUBCIFLYGTJeOdfWMXaADSEQPZHVN,EDGGQBGFZDBFHEEEKBCE....gACAbFDD.UAFDhAAABBAFCFHHLCADhABATFGAJCCFdGACMHAGAEDDDGGFPBEDhAAA..cGCEFDADeFFD...hACA..OFAE.hADA...,2,-10,-4,6
RBedZCOKgVYISJNbFLcWMPUQGEXaDAfHT,TCBARDFGBCAEdDCC.ZEDHOBBA.VFFESGCH..hAAANBIELCADMEAFQABEhABAXDEBAFBDeFGBhAEACHCAKFCG..IGAAJBEA.bBEE.WHEGhAAA......hABA...,1,-19,-22,3
EbQfWYAZdTNXBRJeHFKCLGDgIOSMcPUVa,dAFETCCABEBG.eHDGFHGGKABCLAAF.DCIBIDHA.hACAMDBHPFGF.aBBFhADAbAEE...fFGFhAAAAEFEXEECHFDBCAHCOAEBUCECQGAFhAEA..WDCHhBDA..,2,-24,-18,6
GZLKbgICFXBMYRaTAUNcefESJWQVdOPDH,UGDDeBHHEDDB..SEDAJFBC.QAGBOBCEDACEGBBFhAAAZFGFLAAHhAFAKEGFIHAACBGDBDBHRCFGAHGA.hAGA.NIAH...cEAGfGEF..hAHAdBAC.....hAIA...,1,-14,-26,12
IVbRCZNTXGSFMHDQUeYcgaKdAOfJPWEBL,JBGDEHDABBDBLEEF..VBBFRACBZFFD....XCGHhAAAFFBBDBAF.QGBGhABA.eAFCgCAHhAAAKEFFAEAEfGGHIHHECDHHNFAD..SDEChACAMIBC....hADAYAFD.,2,-30,-6,24
HVJgdKEWPGFaNCIeMfUBRQZTbLSYcODXA,HBCDJFEA.dBFHKGHHEDACGACAFGGA..CEEH.eCFCUGABBGAF.RAEC.hAAAQDGEZBAB.hABATAACSDHBhACAOACADIAGABIH..VGDCPHEC...aEAEhAEA.MEEC...hAAA...,2,-13,-12,1
QAbfHELKcZeMWXTaRFDNOgGSICVUBdYJP,HBECKEDFeAEBMEDC...XEADaCADDHCC.OAHFGEGASBAEhAAACCGCBAGE.JADGABAHEFAGhAAALFFBZEEF.WDCChABAFBBA...NDHCICAB.dHAD.hABA......hACA...,1,2,-29,31
SVObDgBMXULCKFYacfTGIJQWHZdPEAReN,RFDGSEEAOECB.DABHMDEGLBDA.KHGGaGHD..TGDEhAAAIDAC.JBBAHFAEhACAdAGB.AAHC..NEAFbCFEhADABHCA.CBGAFFAF.fEEDQFGH.hAAA.WACE.EHFC.hAEA...,2,-21,-18,3
gdaEcFSYeAfHJPVbBCINMLWTUODQXKZRG,JABAVEBFBFCB..CEEA...MGEALCBCUDEF.DIAC.QAGDhAAAKCCFRAFC.dADHEFAEhAAAFEHB.eGDCAAEG..hABA.fGHCPHEC..ICHBhAGANCACOHDE.....hAIA...,2,-44,-10,34
XQACbPGZOILaVBMcHYSNJgfWUDKFedRET,CEHFGFEHZBFALAEEaCEEBBHAHGFC..SFBBJCEF..hAAAfCCCDIACFABAdDHEhAEARAACEHDG..TDCHhAFAAIBAODAHMBBHNGBB.WCCC.KAGC.eHEGhBAA......hBEA...,1,-12,-18,6
ZXHRPSONBDGFEILgQeJUCbMKTfYVadcWA,HGEARADGOFABBDHCGDDHFGBFEAED..LCBEQDEAUFGECBBCKCCHhAAA...TAGFhABAYHCG.aBHHcDBChACAACGB........PAAGhAFASFAFDIGE..hADA...,2,-27,-16,11
bfeONDMaGZdXcYQWKURLgJBTAESHFCVPI,EDCHSFCGHBADCGBD...VEFA..bEEEeADEDCID.GAAChAAAdGDG.XDCBQAGBhAAAKHDGLAGBhACABHHHFADEIDFBNAIEaCEF.......hBAA......hBCA...,2,-16,-8,8
FgDYMAPOZQCBHaIVELecXfSWUJdRKTGbN,ZBADCHCDBAEHHEBE.VGFELFHH.eFCAXCDD.SAFDhAAAUABBJBFEKGFBTGAFhABAGCCHFDGCgAGBhACADAAD.ADCC.OEADaFGAIADChAIAEHDE.cFDE..hBAA..WDFA,1,-7,-27,20
gSeaBKAYCTdLVfQNIbUPJZWcRXMDGEHOF,TFACLCFA.QEFD..IFGBbDBF.PAAChAAAZABGRGCGMFIBEFDDOCFEhADASAGDBEEAAHHACFAFfHADhAAANIEFUCCGJAEA.WBADDIBC.FEDGaAHFKGGDhABA......hACA...,2,-10,-5,5
MPgYVbLUfONRWGAdSKBDaTFHecCQZEXIJ,dBBFBAEEDABGaGFBFHCGHABE..eCEACHGHZCEF..EFAG..XBGDhAAAJFFF..MEBChAAAPDCF..gEGDhAEA....bDAHfFCBhAFAOHACNEIA.WAHBSAHBhABAcAEE,2,-48,-28,20
eWYODbJVQPKFMLHfcNUEGgCdXRZBTAaIS,aCGAeHBE.OCEGDABE..JFGDQEEG.KADFLCCDhAAAfDGHNCBGGADDhAEAdEACRCBBBGHDAEDG.IAABhACASGDG.WDDE..YHFAhAEAPHAE.MBFC..hAFA...,2,-30,-17,13
SNIWbUBHGJOPRCXgMeTDKaVfQAZYELcdF,EGHFLACBdEDD.SECE..ICGGUDGEBFCDJACFOADAhAAACAGDMIEEDBAGaFGB.hABA...QGBFhAHAAEAHZBEFFFAD.NBIA.WHAA.....bFFGhAAA..PBEH.hABAXGEH.,1,-19,-22,3
cCGTNPHWBUIdfEOaSJFZeRbQMYLAgDXKV,DGBDKAFCCCGFGAAG...TDDFHGECBDBGUGGF.ICCChAAAdHCDOAEE..JEDGFECHhAAAeABE.QFBGhAEAMFFBAAID..XEGBNCIC...WFAFhACA.aADBSHBAhAIA.,1,-14,-36,22
SgEYMaQVbTFKCLHXUAOWZJINfGRdDBceP,ODDBZACGJDCH.....NFEB.GGCF.dDAEDCHFBFFHeCAASAGHhAAAEFAGMAGBaBEFhAAA..QGAAhABA..TGEHCHHALEFEXABCADDG.hACAIHAA.fGGDhACA,1,-25,-32,7
RfZNFaQIcUgbGJSdYCWEeHTBMOPVADKLX,LBGBRAEAZEEEFACH.aEBA..QGEDUBBCGEEGdDAH..CDDB.EGCGhAAAHFAEBFBC.MAEGhABAPAAFAACGDDIB..fDFHhAAAIHGA.gGGB.SCHBhADA.eHAAhAEA..,2,-32,2,34
aXCKIdULFfGQgYPBJDVSeMZHWNbTERcAO,XECFCDADKCGC.UGAGLFFE.GBABQBFA.PCCEhAAADGEBSFAAhAAA.ZFCBNADBbFEDTCEAhABAEEFGAGGEaGGB.IHHEfBABBHAAeCADhABAMAFG..WEHHhACA.OAHD.,1,0,-19,19
YfRUBWJSFgTIXCDNcdALaVGEeKPZOMHbQ,LFDFaEAEGBECKEGGZEGBHABB.QFEDRAAHUGEGBDAGJDDCSAFGhAAAFAHF.TDAFhABACHCDDGBA...cGADhADAADHCEDDB...eCFG.....hAAA......hACA...,1,0,-28,28
IMFOTUeQGHCVBgSbXPaRfWZYKAdcELDNJ,EGAEDFCH..JDEEMCAH.OAAEeAACHEFGCEDE.BAFB..SGEDhAAAXCCBaHAChAAAWDFF..KCBDACCAdFHAhABA.LBECIBHFFFCFUGGD..QGFEhADA..hAEA...,1,-23,-26,3
fRVFcdKYBJeXSIOGDLQZgbNECUHMTPWaA,RBFGFCCAdFAEKFCEBFDG..eBFG..XBADSAAEGDEAhAAADGGC.QACEhABAZGEC..gDAHhADANDIACHGFMEBA.PHAA.AAEGVDEGJHBE...hACA......hAFA...,1,-20,-22,2
IVeDKOXZAMHgNaQfBEFRJbGdSPLTUYcCW,MIFAHBAEaDBDBACCEGFDFHBC..RDEA.GBGESGBALAFEUAEDhAAACFEF....IECEhAAADAHFXEGAAHHCQBBFhABAbFDH.PEAHcGGA..eDDEhAEA..KDAD...hBAA.OGFG.,2,-7,0,7
BJSdTMGQDbPcNfRULVXEKYZOeAgCaIHWF,aFBGHGEABHHBSEDG.MADFQBABDAGF..PCGFhAAANGDHRCGBUGAHLEBHhABAEADAZCEHAEABCBBE.FAHFTAFDhAAA...cDCFfCAB..hACAKDADeFAF.WDHHhAEA...,1,-9,-20,11
dWDeYBPfMVGgXERANJTOIHSCcUZaQLbKF,JBEGOHAEHEBH..CDHHZEFALEGH.FACHdCEHDEFFBHDE.MEAAhAAA.GABDXDDBhAAAABHG.IDAHhABASFACaDHFKGDHeEEDfGAGEGAATGGC.hADAcBAC...hAEA...,2,-28,-14,14
NPTBgOJXFSMeRZIDfWaELKAcVGQYCUHdb,GAGGCEDDdDBG...NCFE.TGCHBDBH..OHFGFFGC..SADDhAAAeEADRBCB.IAEFhABAfADB.aGEHhAAAKAGBACAA...QCEA.UGAEhACA.PHEEgGBHhABA.MDIB,1,-15,-33,18
HQOAfKRJgEcUTDIZVWBPeaXLNdSYCFMGb,KGBCRBDCEFGDUEGE..DGIDZBBGBHCE..eCADaEAG.LFEBhAAA.SBHBhABAFDGAMDDDHABDODDGJFAD.hACATGEAIHHA.....WHAGhADANADF.dAFECEEF....hAEA...,2,-26,-22,4
IbSROYJeUVFEWAPaMKgGXfDNQHTBZLcdC,aECCMABFGEAGDCADHGAGBFFBLAGB.dDDACAEBSFHHhAAAREGH.JHDEeEACVBCGhABAWCCC..AHCEKEGEhACAXFEH.NIEF.ZAFB......hADA......hAIA...,2,-22,-13,9
FVQbONAMKLBDGTdPXZUJfEaWcHgCRYSeI,LFDCDHBGGBBDdBDFZBGFUCEB..EEBBaFAEHFEC.CAFC.SCCDhAAAFDEE...hAAAbEGDABAABACC.XEDChABAJHBEfBAF..WFHH.hABA.cAFF..hACA...,2,-33,-23,10
aOMPcZBYIERUQdSKDJGgLCXNVTFbHeWAf,aDGAMDAEZDBGBCFE..EGEEQFGH.SAAHhAAAKAEBGGABLFEBCBAGXEFBhAAATAGGFAGG.eEBChACAAIGEOCAEPFDB.cFAC...IAEChADA...hABA...,2,-29,-7,22
TRdOMeGbCXHLKIWSZNPFgVBEJYQfDaUcA,RCGFMABAGCAF.CFED.HBBCLFAAKGCBSGFAZABG.FBGDBHGGhAAAEEFC.JHBA.QBEAhABADCFFaGBBABBAdAGB.hACAOEEHeEHHIAHANCIG....hADA......hAFA...,2,-17,-16,1
CRcYFAbEUXgTGIKJMLHfOPdNeaSZBQWDV,ECGFXGECGACFKDCCMHAE..HCFBOEDCdFCEaFFEBCAADGABCDCARFGBhAAAFDAH..AIAE.bAAA.hABA....gBGBhAAAIFAB..fHED.NCIESFCGhACA.hABA...,1,-19,-24,5
fcTYUWGaFLKMODHPAXgeEIdRSNbBQJCZV,XBBCEAFHdHBH.RADA.SEFBBHFF.CBAA.ZCFB...VFCBhAAATCCHUGGAGEABhAAAaDEB.KHGEDACGACHFIADAhABA..NBAA........hACA......hAFA...,1,-27,-32,5
FMDPHaJLfCcVEgdQSWeTRGAUBYXbNZKIO,BDGCXACHZAADOAHDFEDF..MHCGDFEBHACALBAH.CHHBECFAhAAAQFFC.hABAeECHTFFCACFAbEAFKDGGhACA.aFAC..fDDD...hAEA......hAFA...,1,-23,-24,1
OYKFBHgdGAfPVSbXeCWLaRNIZTDcQEMUJ,VCAGXEGE..eFDFLAAC.RECAZBBHDAFBEGGEMHDEJCHHKBEDhAEABCFAdFAG..ACHHSGBBhAFACEDF..hAGAaHAEIHHAQACA.OFED.hAHA..FAGE...hAIA...,2,-23,-19,4
UAPREYDcdKeGQCZLSOHfBINaJVXbWgTMF,RBEFDBBFdAEFeECDGDCEZDEBLBFGHBBHBDAA..aDCFVFGB..hAAAXGFD..hAAAWAHDMBADABAD.EHBEKGEHhABACEHDOAFA.NBEC....JEAD..hABA......hACA...,2,-20,-14,6
NgJLcfGKEBRPCFAZbOSHeQadMDWVXUYIT,ZAAHOCFEeCFFdEAHDHBE....XGBCIEBD..NEICLEDAhAAAGEDEEACDRBCGFHFAhABASAHHHCAEaEGDMAEDhADAUAGDTGFF...cAFBfABHhAEAKFAD....hAFA...,2,-10,-4,6
bQKPHfFEANBYVgTOWSRMeCJZLGdUacDIX,BECFVBEH.OABB.REAB.CBHHZCAALCHHdHDBUFGCDHDG....hAAAXGGDQFAGhABAKEFBHADBFBBGAEAC.NIAF..hACA....YAGD....hAAA......hACA...,1,-29,-32,3
KWXGPdFeEQfMYUDgSHVJARBCNcTObIZLa,BBBFCHHB..TCABIFDHZCEGLFFE.KAFBXEAHhAAAdFAGFDCD.eBDE.EFFEhABAMCCADHCESDDGhACA.JBHHAHEENIDBOHAC.aHFAPAAAhAEAfCDB..hADA...,2,-34,-23,11
EWJGbVKURdagYOIFQfSTAPMecBLXHCNDZ,eGDABCHALBDHCBEH.DCADEBCHGFDHVEAG.KCBD..UDGEhAAAaGAF.OHACFAAEQAFDhAAATAGD.AIEGMCGBhADAXDEG.NACDJBAB.....dHGBhABAIEHA.SFAEhAEA,1,-16,-22,6
ZXDbWLNEUVPRITMAgJGCQKfeaScdFOYHB,JABHGGAB.KABHaGBEdDGD.FADBHFFC.ZCEFDAFHLFBEUFGC.hAAAVAGDRECA..MBADhABAAAFGCDDE...QAGAhAGAfHEHSDDCOCAHBEHB..hAAA......hACA...,2,-22,-17,5
BSDPIdTReUcFGEONCHQZJbAgYKfWLMaXV,KDBBLEADMCIH.XABCBHED..SACCDDFDdFCDRBGHeDAEhAAAUDEBGFBH.OHAChAAACBFEQGGFhACAZBAEAHGH.fEHCaAGGPFHBcCCF.NIAB.hADA..HAEF..hABA...,2,-15,-7,8
JFWSIMCbdUDHGLXEPafAYcgBKTROZeNQV,....gEABKGDFODCBZEFHeCAFQAGFJBEB.FCCHSGADhAAAMAACdGDADFDEhAEALFFAEBCG.fHFDhABAAIHCBHADNCIA.WBGFCHFD...HABC.hAFAPBHD...hAHA...,1,-14,-18,4
JRFGSEgVXMDLaWfIOZNbUCBHKTAPQedYc,QEEEeDCBdFFG.JDBHFAEF.EHDE..XGAHMCBFLBAEhAAAaBCG...ICHDhABANDDHCHEBBAFFKGAEAIDC.PDDAhACAREGD.GEGCgAGFDIAC...hADAWECH.OAABhABA...,2,-32,-1,31
KVbgLfPYICXEHRGeSAFDBcNOUMaZJTWdQ,FDAFDADABBFFOCFBUEBGZABE....JCCBdFHC.QBBEhAAAKEGG..VAFALEEDhABA...YBHFhACAIHGD.EGEH.......hAGA......hAHA...,1,-42,-43,1
JdgcGZTLVEWNHXIORSaCMPfFDKYABeUbQ,UGEFQCGCdEBEGBFCLEBH.EADBHACCOAAHaAAGMEDHhADAFGDDDGHH..ABIHBCCFhAFAbFEB...JHACZAED.hAGAWDCBIHHH.SDDBCAGAfBBDhABA.KEAF...hAHA...,2,-21,-2,19
MNBGLecRQXHZbaKAYFIOUWgVCfJSPTdED,FFABOBEEUADF..VDGDCBHH...JEBESHEA.dEFAhAAADDCABGDAeACARCBG.XGAChAAA.bFEHAHIBIHBEhABA..WBAD..gCGGhACA.fECGhAEA,1,-41,-45,4
OLbFDVYSTGQcAgBXCMeIdPJaENKHURWfZ,BEHEMCACdAAHaBEE.KFGDRDAE..ZACGLAFH.DEECVGDA..hAAATDBCQGGChABAADAHCDHF.eHAE.PEDChACAEHAGHFCG.fHCDbAGDSCDGhADAgBDH.IHHGhABA.,1,-3,-36,33
WaEXOQVcMgLTFebYSfBKDZUPAGJHIRNCd,JEEGRAACdCEE..EBACQEGF.MGCCTEAG.FAEHeDAGhAAASFHFBFABDDCGUGCAhAAAAIAGHAECCBHD.aHDAODDGhABA..cGGE.LAHBhABAfDBD.KGAD..hACA...,2,-33,-6,27
YafUJDRcHgIBNeXObMQdZGCASEVFKTPWL,EGFGKDBE....TEDDLAHD.fDFCJHCERBED.HEABhAAABFAFXCDGMADEQABHhAAAdABACEHESAFBhADAFFGB.YFCBaBGEDBADIHHEhABANEEE..eFHB..hAEA...,1,-7,-25,18
UdTKLaDNWegSIAGQMbOVJfZBcHFPCREYX,QECGMHEA.OFAHVACDZDEFBEHGFCACCBFG...RFAAEAAAXBCDhAAA..dDHGKGGBhABAaHBEDACC.eEEHgAFFhAAAAHCE..bCFE...fBBChAFA....hAGA...,2,-30,-18,12
AYUgXeHKOEaSdTZbQGfLIRCWVJMBFcNDP,UAGGXGGDHAADKBBCaFBD..dEGFZEEEGCDELCCARAEB.CHHA.VGAAhAAABFHA.FEAFDABEAACC.hAAAeDCD..SADHhAFATAGH.fGEFIEADMFFHhAEANIBF......hAGA...,2,-16,-13,3
BGfbWPNAdZHOCSLIRFgEcDQXVKTYeMUaJ,HBFCCHDCLAGDRDAFEDFHDABB..QFADKGAD.eDCEMIFAJGFEhAAABEDEGABD.fBAGhABAWHEC.ACIFOECChACAFADAXFDC...YCCAhAAAaEGCNIEDSEAChAEA...,2,-19,-13,6
aEXYcUMFNeAWCbOVSdZKJQfDLHRPGIgBT,CCFEVCGBdFGEZDCG..KAGD..QBBEDFACHECFGADCBDHHaDAFhAAAEGFF...XABBhAAAUGEGFHBGAHHC.OFABhABAfHAHLAECIDBE...hACA......hADA...,2,-23,-17,6
DbAHMfYGOQeTWVLRCESNdgFPBZIXUaJcK,HFAEMFDDGADFQAFFeECETFFCLABHECDDdFHAFCGBBGHAhAAAXAAFaEHB.KGDADDAFADAB.hADA.fDFHhAEAOEADWAHBCDBFNIED...gGFDIECD..hADA......hAEA...,1,11,-16,27
HDOKJaENBCPgFQLYTefSbRIGVUZWMAdcX,XEEFODAEKGAG..EAAACEFC...FBEHLBAEeHBC.SGDChAAARDADGEGCZCCHAEEHdAFChABADCGG.NADH.BGGC.hAAAQAGAYHDG.bADH...IHEChACAWAFA...MDIDhADA..,1,-15,-21,6
BgAUfHaIDQRGSCFPJWTYENKVZcebXdLOM,UEDGaBCC.DABCQFDGGCEH.FCFA.JDBETGBF.EFAFKAFGhAAA.ZFAB.eFFGXAFGhAAAdBAGMIFGBBCAAEEC.hABAfFHE.IHEECAHEWCHH.YBBFhAEA.cGGHhAGA..,2,-22,-20,2
FCXZSaTYBMNgWcPRdfEVHQUbIAGeLODKJ,LDDGDBFBFAGCZCAATBGF..BEECMDCF....NAAH.WHEEhAAA..RGDCdDGFEADDQEGHhABAUFAF.hAFAAGBBOAEAKBBECHGA.aCAB.gFCHhACA.fBBBhAIA...,1,-22,-44,22
ZXJQIcBGLUbDfKAOTegPWYRCEdHSNVaFM,OBADeCAC....gEABPBGBREAA.dAGHHACH.SEEGhAAANAFEFHFAZEEGJABCIHEHhABABECB.LAEHhACADICEADHC.YDHBCAAG.aHAG.XGGGhAGA.....hAEA...,1,6,-29,35
WJeYTSZXOEdBQUaKHGFfbANIcCMPLDRgV,..IECFCHDFLFEHDDGF.RDBF...VFEHeDAF.SCHBhAAAZAAGOBEDBBAD.UGGEhABAaCHFHGACFDFGAGBFMADHhACAWAFE....TCAAdHADKEGG..fEAGhAAA..hABA...,2,-30,-13,17
KcOVLDYRAfWJETUIeHNPaQdBSFGgMCbZX,JDBHUBCEHFFB..aDFDBAFCFHFA.MDAFZFBD.KAAC..OAAHhABADBCGAHAH.EDHB..TCCHhADAeBFE...QGCEhAEASEAFCBGGXDFE..LFEGhACAfEEG.hADANBIE.dCEE.,2,-23,-22,1
DFVNAZadGHKfbePCMIcUERJTSOLQWXgYB,dGDHHCEDKCABeBAE.MDIHUDCGRGFG..SFBAQAEBXAGDhAAABEGAFFAH.ACHA.aACAhABA...bGBAIHGBhAAAEDBD...JBBA..LFADhAFA......hAGA...,2,-45,2,47
SLcANPQdOYCMBUVgFJHKaTXIEReDfZGWb,QBADdGGBCBADBADE.UGEF.FDEGHCEBKFAE.aAHD...XDBEhAAAEAEBDDDHGDGChAAA.SCGEhABAAAHDNIDBOFAFMHAG..JGCAIAGFfCBHhABA.ZAFF....hACA...,1,-17,-25,8
BfYJAQFCULZRgbePScKINDHWGVMXaTOdE,FBBECFFBUGCDRFDD..eBGF..SBDCKAADDFGB.HCDEGDAGhABAMDIF..XCDDhACATCAGdAGE.fHGHhAAAAAIDLHAAbEAAPADG.IHHAhAHANABH.....hAIAaCHDBHFF.,2,-12,-11,1
YJgWfFDOZTHUSCQLMadKEBbIANRPeXVcG,RBEBXGBAGEGC..JGBA....fFFCOBCHHEDECEBBQBCGhAAAMCIHKEAABHAAhAAAAHGGNEAC.eAEE..hABAVBFH...YEED.FBAHDADBhACA......hAHA...,1,-17,-19,2
XNbZgMODYEFPBfUQJKTdSGVWIACLeacRH,CGCDeGBARAGB.HCBG.XEEAZFEEMDDADEAEFDBBBBAH..QABGhAAAKGHDdBFGSABEhAAA.GAGChAEAIHHCAIAE.LEFEaFAB.cADA.hAFANIAD......hAGA...,2,-27,-12,15
gaXRFHJfbSWDcOMAKdGUEQVYBeTNPLIZC,dECDEEBE.QCACBBAB.eBHHTGBCLDDEZDEHCBDG..aAFBFGAAhAAA.HFGD.fBFBhABASHGCDBBGMEABhAAAAFAC.KEHDUADCNBGG.gFEF.hABA......hACA...,1,4,-34,38
EQDaeFZKBbNHOcgGVdRPIJYTfLCAXMSUW,MHBCUCCBECFBDCAC..FCDDKFAD.BAEDHAFH.OFGDGFEHdDBGRGBG.hAAA..JAAC..fCAAhABAAFEHSDFDhADAaHFC.ZFAE..NAIA........hAEA......hAFA...,2,-27,-27,0
MFSIJYdbgCNPcZKeRBQXDaWOVGAEULfHT,UFABHGDAFBAH.SCHFIGHGdGDCCDFB.....PEDEhAAAKFCCBDCD.XAEEhAAADBAHaBFE.OFAFhABAABBDEAEG.LFFGMIFAJDBEYHFG..hACANBIG.eBBG...hABA...,2,-34,-11,23
dTZLFURVWPSOGBNKJgfYeaAQEDbHIMcCX,EFCBHADH.MGEACHEDdCDBLCAH.FDHBVEGBSHBABHBFKCAHhAAAJCCB...fAGChAAAeAECAACADEFFIEFAhABA..TBGGZFAEWFHHPEAH.hACA..OBAA.hADA...,2,-28,-15,13
GeMYURcKTLWSBQgXVHFONfbAPaCdEIZDJ,aHBAEHCCDGIDGFDD..eABBMBCDRCFFKFBCLCGD.BFAAXCADhAAAFDDFOAEC.hACA.NAICAFHHCAAAdHEH.ICADhAAAJADFUAFBWAHHSFDA..hAEA.....QGAChAGA,2,-29,-11,18
gMHBVDOKSEPGRQeICWbZTLadfFJUAYcXN,XBCBMBFABHHEDHCGKBCF....SAGGEGAHRCGD.eDFChAAACCAGZFCFaECH..FEFHAFAD.hABA.NICD..HFFEOCEBhAAAQCACIEAHTEDGdABF...hAEA.fGEEhAFAYFAB...,1,-6,-34,28
WQgUXTAbLINfEeHDYcCaPMJFGOdVBSZKR,LFCF..ICEDEDCCDFEGCAEAMABDGBGGdFAABFFA.hAAAKAGBQCAChABAUGCCAFHE.fGGEhACAeDFCHACAcGECaGHFFHEASGAB..hADA.WCCE...hAAA...,1,-12,-29,17
VWOMGgPDEYATXCdbZLUaFSBQIeNfRJHcK,TCDDdAACZDCCLFHB.UAFCFGBASAAA.IGFDhAAAfBDAJCFCKAEEhABAVFBE..WCCFhADAMDAH.GEFADIAAAFIDCFEFBHDH.NAIC...hACA......hADA...,2,-32,-17,15
JEaUITZPFfKCBGQeHDgSdcbWVMROYLNXA,EGFAUBAGZFAAFFDG..CCDBGBBGHAFDDCCGdDFD......bGFAhAAAMDIFRDEG.OADGhAAALEAFAABAaHAA.IHHGhAHAPEBFKHDA.BDDCeBFESDHHhABA.....hAIA.WEEG.,2,-14,-12,2
IUTcCQSgfbHLXeEZRMYBVAWPFKONJDaGd,FGGBKCFBOCCDDBDGGAGA..dHDFUDABCBAH..QGAFhAAASGBD...gEDEhAAAbABBHEFCXAEChAFAEABFMDDC.BGGDAEGBNEIG.aDBH.....hABA......hADA...,2,-29,-16,13
IVgEACRYfUeGaDBNXOdWJQPcZHFTSLbKM,CACFRDDFUBDBGGBDBBGH..XAEDdGGC.QGGAZGBAHDAGFAAAhADASDCFKDGE.hAEAIAAB.EEDChAEAAAFA.fBGDDGFH.OFFG.WDBDhAGA.....hAHA...,1,-9,-35,26
QUXBAbaHSCWDMVcNdTLgPfOYEKIeGRJFZ,HADBSBABCGHHDGDB.MHAE..VAAAdBGDLDEF.fFHChAAAEEGAIGBBhAAAeCCBRAGFJDEBZFFDUADHhABABDAAaGAHNIAF..gEAF...hADA......hAFA...,2,-26,0,26
QLVbEUWOeXgdaTAFMJBfSCKIRHDNZYcPG,MCDGJDCGBBGH..CAFEREEAHFGBZDAD.....PEADLGDGhAAAEBBF.OBAA.eHBGhABAgGDAaDDGAHHBSACEhAHADAIH.NBIC.cAAG.QAEFhAAA.UDGFhADA...,1,-16,-28,12
VZJbHEfQPWgIYUKaFTGNLcSAOXMRdCeDB,MACECBACDDFG.BBGFZDAC.HDBB..EAFBQGEG.PDDEhAAAIBHE.KGEGFBAChABAGEEHNHAF.SCDBhAAAABDBXDGFRGAG.dGGE......hAGA......hAHA...,1,-17,-36,19
JgGAEFDUOMRTVdeHQfIaWLYZbPSNcCXKB,DCGEOBCBMFAGRCGB..dHABeEEDHFEE.QAFFaBBELABCZEBE.hAAASGGFCHHH.hABAXBEHKCADBDDCgGBChAAAAFIHEBEB.FAGC......hAFA......hAIA...,2,-26,-13,13
FTWCZJgDRSPQHGeLBUAIdOXKbfMaVNcYE,OCEGXCBFKEGG..MAGH..NGED.EEDF.FFGHCDHE.ZFBHDAADSBEDhAAAHEABLBCBhABAABHBdDHE.aHAE..YFEBhABAJEDE.PFAHeAFEIHHHhACA.fGDGhADA...,2,-29,-13,16
eNbSOQYagVGMHUTcCRfFDZIXWLPJBdEKA,eBECSEBHOFHBQBAE.aADBGAAF.HDFDhAAATGEEcFDHCAFBFDHBDDDEhABAIBEFXEAEPDDHhAAABDAFdHAHAHAENIAB......gGGBhABAMIDC..fEEGhADA,1,-3,-28,25
bJPdNKHFSUeCTYIGROaAZDWBMLXgQVEcf,DEBCMHFELFDD.QGEFEHCA..fEEDhAAAJADGdCCDKBAHFCCH.eABFCHBC.hAAAIGBGRAGBAHIBBCFEXEAChABA...cBEGNDAESFFChABATDGCYADEhAHA.OAHD.,2,-24,-10,14
AcGZUQIFOfgNLKaXTJDWVCPdEReMBHSYb,ZAADUCCAFDCBOHCC....NEFCKAGHaBBB....JDFCDGAHCGHE.hAAAdDHG.RFCB.BEAEHACEhAAA..SGCChABAAHID.QAGAIGGBfEAGhAEAXFFHWADC...hAFA...,2,-35,-34,1
WIEfFAYDbaGLdVCMceBXNQTURHZOgKSJP,DECGaBDAGDCELBDAdGHEMFEFBCGH..QFGAUGEEZBAHOFADhAAASFBD.PAHHhAAAECDGAAFG...bABBhAEACEHDXAGA..NDFA.....hAFA......hAGA...,2,-27,-18,9
DQCSbWOeVdHNIgLPUfGREJXAcTZFMKYBa,ZBBAKACHBHGDaEFD.DFBGCHBA.....SDDCOAECeCFCHEGHhAAA..IDHGhAAALEAD.fGEAhABAEEAHAFEHFHGGMDDFQBGCWDBB.dCAH..PABAhAGA....hAHA...,2,-28,-25,3
ZfFKDAcYUBLWTGVJOIQXSCdNbgeaHRPEM,UCEBBCGGLCACGFEDOCHDQGAB.SHFAhAAAdDBHbFCD.aEHBRAAC..MFADhAAAfEDGKFBB.ADBB.hABA.WAFGJAEACHHENAEAeFEH...EABA.hABADCFH.....hADA...,2,-16,-8,8
fUMFWXYBKDeEdHLcZPaAgRVGIOJSbNCQT,RAAAVBBBGDAG.OGCGJFDA...SHAGCHCG.QDEChAAAUAGEMIEAXAEAhABAKAACDHDE.dHGFHFAHhADAZAGBaCDHAEEE..bDGB..fEHGhADAFAECBHHE......hAEA...,1,-8,-23,15
ZgOIfcbWYGVJDRUFPTMeLSECaBXHKdAQN,QGEHZCCAOCAB...IAAE..cFBG..hAAAYDBBJBFGDGDGFDHBhABAMADGLFFHCEDBaCAHXDGFhACAKBCEAGAF.gGBAWFHH.GBDDhAHA.....hACA...,1,-9,-35,26
MVaIKfcZNAQBXLdFbOEUSHTGgePWYCDRJ,BGCHLECBFEHD.OAADUBAFHCEDGEAE.eADD..PAEGhAAACGFEDIEEREFE..MHEAhABAaAFBKAHHZEBCAICC.dBHASCFAhAAA.WEEDYBDD..hACAIHHD..hACA...,1,-21,-23,2
PHUFMDBTYRGWEVfbJeKNaQgLOSdXcACZI,ZFGHHCACMBDCBGAFRGCE.EFDA....VCDDfDHA.JAEGhAAANABC...QCFChABAOCFGSGAHhAAAdHGHAHBFIHCFUEADDADE..YEAAhACA...WGFC.hACAKACHaGEA.,2,-26,-6,20
DgVdScLRBJaYKGQANWMePOHZFXIfCUEbT,MFDEeBDGOHDAZCFEFAGD.....IFBEUFAAEAAEDCAAdCACSDDFhAAALEGHJBDDhACAKDGHAHAF...PFDChABA.HAFCCDBB...gDAChACA......hADA...,2,-30,-26,4
ORcVPIdJfBLXYSbDZETFKQgHMeNACaGWU,CBABGEDFUBGF.RAAG....VAEAdCDFBFEGLCAB..SEHFhAAADDEEEHGAFHDEKFAF.hAAAHGFEeCHDAAECOFBDhABAIHAG..JDACXDCG..bACGhADA......hAGA...,2,-34,-8,26
AecNWgUEaOSTfQLJFdKCIZYGRbDBHMVPX,eBFA..NDBEUCFAEDBFOEDH..TEDALADB.dFFGhAAACDCHZGFARBACDIGCBHDFMEIHhABAXACFAAFA..hAAAWEECSAHB.fBBEhABAFHACKHDA.IAFC.hACA...,1,-16,-31,15
FUcGNXIfgWeYMJQSbODHBCAPZaRLdTKVE,aGECLBGD.TDAAKEAHFDGE.GCCHXFDC..IBBBhAAAfHAH.gADFhAAAeAEGJFEASGAGhABADAGCCHFEAIHCZEECdCAF.EABCNIAHMFIBOHCEhABABFCB....hACA...,2,-27,5,32
KdCeIAFUERfXQabONVJPDgSMZcGHWLYTB,FBDERGEEQBAGOGAE...JBEBDGHB.MEEDGCGELAAGhABATGBFdCAB..IEAHhAAAAFFGEDGE..XAGFhACAaAGC..NCDAPACAgEAF.SFHBhAEA.cGEEhAFA.,2,-37,-12,25
GOLSPaXHQcTZEFbMCRYNWUJgABdfIeKDV,BAFBdABFeCBCDDBHGCEAOFCF.LCAE..PEHFaHFGHECFhAAATAFCECHDMEABhABACFECRDEG....WEBDhAAA....JEHHAAEB.IHBGSHAGhAFA...cGGHhAHAFABE...,1,-10,-29,19
AfUBJgDZdHWNYLacVTCKERMXOIbeQFSGP,UEDCBHBDDCDHZBAEHDFF....NEGELFBGVAEDKAAGRDAH..hAAAOBEG.eCAFhAAASHCAAHAB.JFHDhACAdDHAaAHHTABG.CCEGMHCGIDHA.hABAQGAB.hADA...,1,-7,-37,30
gUKSOJFAcWVXLBGEDCRbYaeZINTHPdMfQ,VCCDXEAG.BFCHDBECRAAD....bBGFeDGB.ZFEHNICD.HFAGhAAA.dAHGMEEHQGGBhACAKFGESCDEhAAAFDAHAHDD.LABFEACC.CACHIHAFhAEA.fGGEhAFA...,1,-2,-32,30
PBcHeJGNfCIgYTbRDQLKOAUdVSFZEMaWX,dEEDFFCHMACEaGBG....XFGABBCAeAEAGAAGCEEG.IHCAhAAA..YDEChAAAbCEE..QAEEhACAKHFGAEIDSFGB.EBAHWADFPAHFhABAJHFAfAHGhAIA..,1,-5,-44,39
PbcSeATWNEGDdQUXHFLJRgOIVKYZCaMBf,TCFBEBGEGCDG.DFFBdHCB.QBCCUABGFDBGLHAChAAAJEAARFFBOFHFKGGAZEAC.CEHD.hAEAaBHFBCGD..fGAEhAAA...PADASADAhAGAAEDEWABFNIEF....hAHA...,2,-22,-13,9
bgBGVDeXaSTWRPMYfEFKQdCNLOIUcAHZJ,ZDABJACCBCEBGEDH.DBHB..aFAFSADG.RGDEMCBEhAAAEDGDKGFF.CHHF.OHAChABAUBABHDCG..bAFFhACAeCHB..XDGATGCC....hAEA......hAIA...,1,-18,-32,14
gCVBUZNfRPATSYJFKdHOXMaELQIGceWbD,TBCGSAEB.FDDEHDFH.MHFCaHEGLHAC.QABEhAAAIGCEeAHHhAAADGGECEGFBAGCNADBfCADhABAAFFDKEBGOHFEEBEEcEDHgBGH.hACA......hBAA...,2,-18,-18,0
TSeARXOLCEbFYHKdQPVaBDcMUJNgIZGWf,OAFFCDFEFBBF.HDDGdBEF.QEBH.aCDGBHHF.DFCAMABFhAAAJDHH.IGGFhACAZFCG.fDHAhADAeDBAAAIHLAADEHCEKBHD.......PFAFhACA....hADA...,1,-2,-45,43
FDXcfHTeaRGCMJYBOLAbVQZUNKWdPSIEg,QBGGZBCHKCFCdGEB.SEEB.EFCBDBEC.XEADhAAAHBBHaGEHCBAC.MBABBFHHAFBBUGGAhAAA..NAEB.IBEBhABAFEFA.fHABeHBG...hABA......hACA...,1,-4,-43,39
cTbAPgXMGFYfSVBdaeRJZNIWCKODHUELQ,XBFBFCAC..fEDFBGHDdFFEeACBZAGF...NEEA.CCEEKFFEhAAAHGACEGHDLBABhAAATGEG.AFIDMCCFGEAGhABASDFARABE.IFABDEIDcAEAhADAbADB......hAIA...,1,-4,-17,13
fLASVCcMGNWFdPJIUeZaTEQHXOBYgDKRb,VEAHCFEFGCAA.FFGHJGEG..UGDFZBCH..ECEBQAGAhAAA.HABEBHHADDEGKAHFhAAA.fADBhABA.ADHAMFFGWFCF.dCAF.....eFCHhACAaCDBOADA.hAFA...,2,-25,-19,6
VdHCFSbMXeaJgYRBUcQKTIZDOWLGAEfPN,EFHF..PGEGdCHACGEF.FFBA..MAGBeBDF..JECBRCEHBABEhAAAQCADKBGAZGBCOABEhAAA.LFFHhABAAAIFNDAG.SDDEaHFE.YHAA.hADA......hAEA...,1,-17,-30,13
IdBEJDFASHVKWgfCPLYGXbRMceaOUQZNT,HFDBKFBA...fDGECBAHLFFHXAAARADB..eBFGhAAAaAFFUGGFZDDE.NDBFdEBChAAABFHA.DDACAICCSAHBhABA.WEADPHAG....hABA.YAFC.hADA...,1,-19,-37,18
YWXUVTLRDSIKgGHNAEdMCFQbfBeOaJPZc,EBEFCCGGFEGA..QABABBED.OEHFaFEA.ZDBC...WAEChAAAXBAH.TDCEhAAADCGESHDChABA.IFFGKGBAgABB.NICHAHHHhADAMDFG.fGBGhAIAeEAF,1,-31,-49,18
LGOJgPASYIDMBEUeFZQWCNdfaVXHKTRcb,SBGADCDAEEFH.UGBCeFBDZACH..CHFEdBAHaEBE.HAFD.TDBAhAAARFFELBAB.hABAOCEDPEHBAHDGMIEGhAAABHDDQDDC.WFAD..hACAfEGBKADE.hAHA...,2,-22,-12,10
ALDXFfCWPEaIMTdGRcVYgNOJSUeHQBbZK,XAGBCCCF..EFABMDAFdADFGGEF.REBG.VAAB.NGCB.hAAASCABUDCCeGFAhACAQDEABDHBZEADAIFGhADADIDE.fDHEPEEA.IAHBhAAA......hABA...,1,-7,-31,24
ROKDQeVLJaCAPUHTEGfSdBFNMWYIZbcgX,HFEGTCDCGABE.dHFHFCACMHAC..IHAAbDFE.XAFDhAAARAFEDDECQEADhAAAeFGHLABCaAEHADDD.hABAEEFB.fHDDNIAF.WFAE..hAFA......hAHA.cCGE.,1,10,-12,22
TWeOfaFUgEKdXRAPSLVCNDIYbGBJZQcMH,LDGBVFDA.CCDDDBBG..IEAGGCAEBFEDQACFhAAAMIECHGCATGAAOAHFhAAAfGHAUAFEKGHHhABAdBAGXCFBACCD.SDDG.hACA..NICB....hADAJDHBcECBaAGC,2,-13,0,13
OGHXPYKUZefVQAIdEbFSMNagRcJTWBDCL,EGGGFDHBMEAF..aAEDRADC...JDEABFCGDABFLGAGOAAFHCDGhAAA..XEAAhAAAPGEE.KACC.eCDDhAGAfDCGAICG.IHBFdFFCNIEBTBGGhAHACEED......hAIA...,1,-18,-26,8
cZIDMTaCAbdFWPSGKHReVBUgEXOLfNQJY,FFAGSEBCGBCFKEHDRBCCBHDB..EHBELAFG.QEDDhAAAJAAHZFFFDHDGMABBhACAaAHB...bGFAdDADPHAChADAeDDA...UCGH.OEAH.hABAfEGC.hACA...,2,-27,2,29
aTKOUdbWZfAYFMDSQCcIPHXVBRNJEgeGL,FBGFMACBDGAG..SBFFQDDGCGEB.....IDAFhAAAXAGHBEHDJEABEEDAhAAAGGEDLHEAKHACUABGhAEAdBDEbDGDfCFEABBF....cGADhABA....hADA...,2,-26,-26,0
aIETdWHOQgXLcGFYDRBNbKPAeSZCfJMUV,eDHFSBFBCCHC.MHCEaDFB...TEBGdAFEOHBE.QBAAhAAAXCDHcBBAhAAAGEAHDABCBHADKGGDhAEAAEGGfGGC.JFDEIDDAhAHAEBHDWBAD.....hAIA...,2,-24,-15,9
YABMDJUcTGLIdWfKbQZSeRNaVOECFPHXg,MAGBJBDD.UABBGEAELDDDdDGAKGCBZEFD..eAEEREAB...hAAAaBAEEAEH.CAHEFHGEXFEHhAAAAHDC.BDFGDCCH.hACA..IHHFfCHESDAChABAOHBC......hACA...,1,-15,-32,17
WLgQPEFDKMbdNARUGeTIVOcHZYXCSJBfa,READeAAE..TCCEOADGZFEACEFG.BCAH..aBGFLABAhAAA.QDFEhACAEDDCFFCGMHFGdAGEAIFCIEHBhAHAcGBE...XGCASEHBWCDEDAIFhADANBBC......hAFA...,1,-18,-24,6
TOYZRdCJDbWXFGaLAVUNEgBcSKMQHeIPf,UAGCEBCCBDDEKGDAHCCA..IHGG..fEBAhAAAOFECRDAFJDFADEABbACEFHCG.hAAALFFE.AHIH.hABAgAGDSGBHMFIFPDFCTECDhABAdGGECCAGWACE...hACA...,1,-15,-19,4
OcNYXGCFAeUbDHMQBLWZgEfPdRJSaKVIT,eGBAUAGAHCACMACCBFBDZDEGEHGA..dEFGSFDGaBBD.KFBDhAAAIGHA.TAGDhAAANABH..YDHBhBAACHECAGAHDDEGLBAF.fECBhABAJBCC.....hBBAOHFC.,2,-14,-13,1
HZfCSKbBVMFceUXWIEaDQORdALPNGYgTJ,LAABGFCF.TBFDJDBAZBFE..SFAHKAFEBHFAMFHDhAAAFECGUGFH..XADGhABAEEGEDCIFRACH.AACF..hACAPFDDNDIEHEADCAFF.......cDFGhAEA.IBBAhAIAOHAE..,2,-20,-15,5
PBXQFLaZNcEVSUgYKeMfTJdIROCHbADGW,DCCFGEEBBGCHFACBZAADEGDH..UEEGKGAC..eDCDMDEC..JAEHhAAAdEAC.RACD.CHHHAFAG..hABA..XGFEhAAAaCHB.....NIAHSBFEfDDBIAHBhAFA..hAGAOEHF.,2,-32,-24,8
dbDWJFUcOHEXgZNAGPeRLfCBaKVYTIMSQ,eEADLEBFCGGA.aCBGKGDC....TFCHIECE.MACBhAAAdAGGDICE.JAAGUADAhABAHCDAEAHBZFFHADDCGEEDhAGAfEHEBCGE.SGBHWFAD..hAIA..FAEF...hBAA.OHEC.,2,-13,-10,3
WMTBAISGVZXNOUYgeJCQKbRfaPDEHdFcL,SFECZGCEOEDAUBEHeCAH...QDACKAACRBFE..aGEDhADADHGGHEBHFAADLBHDhAAAMDIDABHGVCCG.XGGChAEANAED.YHAACCCHfFBC.hAFA.EDGD....hAGA...,1,-5,-24,19
QbLYIKMagXHERPFGfZCTceJVUdBASWOND,ODGBDEDAQAGFLDADKEHBMCCA..XBDDEBACFHBGGDDAhAAAZCBBCHHE.eAHBJABEdAAChAFABHFA.AFHF.SGCGhAHANEIE.IFFFgDBC..hABAPHEE...hACAfDGF.,1,-3,-21,18
KcIHgaSNRFPUOLTZfQEGCMdeWbVXADBJY,JCCBKDAEHEED.SAFARAABUCGALGDEZBCF..EHCGCBEH.MBIBhAAAdFAC.eFAH.bEGHhABAAIGGBHHE..ICEBhACA..NFDBOACAfCGA.hAAA.....WHBAhAGADAEG..,2,-40,-14,26
gXZKRPfASINWceQCJaOTMYFDbVGLEHUBd,SBBG..ICCB.NDBC.eHDC.QBFEhAAACGEFOCEA.TGAFhABAMAACDEDBVEEELAFAhAEAHADHdDADXEEAKDHHfHGFABBEJDHFaGAHYFAChACA..FHGChAGA...,1,4,-32,36
DUCbVfSdeYZFgJIBOATcMGNHKQPEaXLRW,TDFAMBDEHGDC.QEAEEGCALDACRCDDUEGECGGD..fGAAhAAAeABDZAGH.gAFHhABABCFGAAAFNIAHaACGDACD.hADA.SEHH...dFAB.YHCGhAEAIHHC..hAFAOCEB.,2,-2,1,3
TBaXONMEWAgSKeYHJZLUDfGPVdCRbFQcI,KAHFHEADZABADCDAGCACdHDDCADB.FFEF..QCGF..IGCAhAAAaCBC.OAFBhACAEFFDAEDHeEGBJEHDLDEAhADAPAAC..........hAEA......hAGA...,2,-30,-22,8
fBIgDEVZJGcXYWATdRQULaFOCKSebHPNM,RGDCLADHOBDC.KAGD.eEFAHBBF.MABCBBAEDIGGEFEDZEDCJDEEGFADhAAA..XFBGhAAAAAFBdAHA.UGGACHBD.hAGASHAANDIG.IDBC..hABA......hACA...,1,-11,-30,19
VaYGRJQPLFXITfUKdSBZbAHCeMWgcDENO,CCHDMCDC......gEBBEGBFNBAB.OABCaDGFRDAG.QDEEhAAALDDBIGFBhAAATGEDKHAGBFAFhABAAEIHHEGF.eCCCDFIBYAHHPAEGfBAEhABASHCAWDADhADA...,2,-22,-20,2
edQFLUJHXTVKADZNSIMaWfCYcbBERPGOg,DBBGSDACMADC...aFFCCDEF.....bFBEBBEA.EDGGhAAARDEEOBEEdDCGFAHHLFGHhABAHACD.XGBAhACAKHACAIHGNCIGIHFB.fBADhAAAcFEF.gEAChABA..,2,-44,-1,43
TZPKJdSQFfaBEUAYOCVIgecbWDXRMGHLN,CEEGVFAA..eHFG....bFFGXFAFGDCFLAAChAEAZBAFJFCDdAECSBBBhAFA.fHFFhAGAEEGGAGGEIACHWBDADICGMAHDNAIC.KDCEaDHH.BGDHhAHA.....hAAA...,2,-35,8,43
IYeQLVJAXcPgFfNSEROdbHZWCUMDKGaBT,XDEF..PFEGFAFA.SGEGRDBFdHGFHABEZDACCFHHMDAHhAAADGAFaBBH.BDGGIGEBhABAQBFD.hADAVFBFACIHfGCCOAFAUACDKBEA...hAEA......hAIA...,2,-19,-11,8
bIQRSfYMcgFALPTWKHGUXNCJOVDZdEeaB,TFBBKAGDHDDH.GBADUCCH.CCFD.OHEGDAIBZFAFEBFB..BAAEhACAIEABRGFG.SACGhAAAMDHDFHCAAFFBPBHHhABA...NGEFdAGBeDBB.aADEfEFDhADA....hAEA...,2,-20,-12,8
bdfMREeaVTcFYQICPgZBSLUOJKGNAHXWD,XFAEDABEdHDBRADC...aHFC..VDCBTBAF..FBHDIEFGhAAACGAC.ZAFEBHHHhAAASEGHLFFCODDBhABAKGGDABBG.bADFEHACcGCE....hACA......hAGA...,1,-20,-36,16
QYTBVJfUHGRcCKWEONdZDAPLgXSFMbeaI,LADEXECDFAADMEIF...aBHDQGADBHFD.fBEEhAAAGCAACGCGEDDDdEHGAHDChACASEGBeDCEYDADhADAJCDC..UAABRFFBWBFBNIAD..DAHB.hAEA..gFFDhABA..,1,-6,-17,11
HASCbeRdUfgBJaTPKYXOIEZQVcNWGFLMD,CEFGeEDARGBC.dAADUGGGBCEB...aBGBKCAC..ODADECGCZADCQEGHhABA..hADANEAB.FHGADDDGAHDEfDCAhAEA.JHAC..YAFC.hAFAIABE..hAAAcBCG.,2,-43,-19,24
GZPEOIFMVBTWKedXDcSaACfYNJRLQHbUg,CAGA..NGCH.RDBCLAADHCAGUAEGZBBC..EHGGFFDHBCHBKHFC.dDFBDCHBhACA..aAAFAFFG.JHBA.hADA.QGAEhAEA..bEBC...PEHDMDIBWAFFhAIA......hBCA...,2,-34,-15,19
cLDgIPNKVReXFdGWUYECBbJMOHaZfTQSA,LACHDIDG..PAFFKCGFeEHD.XEAGFDDFdFFAUBAChAAACEDCBHAC..MDHHaHCCZBAFhAAAQEAB.hABAAIBA.gFDC.NBIE.....hAEA......hAFA...,1,-25,-39,14
GTSLHYagfdAIcNbXFKDOCeWEJZPVRBUQM,..IGGCbFCD.FEEHDFCH.eEED.EBADJAFFZBFHRABFBAHH.hAAAUGADMAFE.SGGGhABALEAEaADDfDBChACAABAE.NEACOADD.CBHG.WHFGhAAA.QDGDhABA...,2,-36,-7,29
IVQYeFLZRHCUaNWPAJXbOSdMKDBfgTGcE,JGFCXGDB..SABGKBCEDAGFBDHG..TEDGGCADhAAAEGAGQGGEhABAFBFGRCAFCHCA.NEAC.ADDG..dECGgECChACA..IHEH.YAHBhAAAeFBD...hADA...,2,-27,-26,1
HfPDTOAeUVNMIBYFcdaRECgQGLZSJKbWX,eDFGUCCDMGAGBHFEFCAH..dAABEBFECHABGDEELCDB.JFAHKGHDhADA....XFFEhAAAPAFC.DABHAEID..hACA.IHDHaEACgGCAQEBASHEAhAEA...hADA...,2,-30,-24,6
XdJBbeCZTPDVOfNGEHYSacFRMWKLAgIQU,QGAAUBGDdHAHBGFDeFDHZDBDDIFE.OCDEGEEF.HBCCaAAFFAEChACAMADG..LFFEhADAABBG.ICHChAGAJCAHCDEH.TDBE.fGGBEHDGSHGAhAAA....hABA...,1,-7,-21,14
SMQYTKVGZNaeLEOARdgWPfFBUXHIcJDCb,dBCG..gGDD..fFDBFEBBXAFGICEHhAAADIBACBDA.MBEG.TGFAhABAKEFGVAAAZCGBNCACaCGGhAAAEGDDAFDE...WFAHBGGG.....hACA......hADA...,2,-28,-27,1
ZKbYNGBRJgaEceVdIOfQXMCHUSTWALFDP,LAEHFGFAZDAAKFBD..NEFA.BAFG..RABHJDGFEDGA...eEBEhAAAdAAFOGCC..hADAQGBGMIAECCCG.hAEASAHDAGID.DAGBbEEG..gGGGhABAaBDF..cCFBhAGAfBDC,1,-24,-39,15
VcOWGaNeDdbLgHCfZMUIAXSJPRYFQBKET,XDGEJAAG.RDCA.FFGGBAEHEEDH.....TFFCVEADOGDChAAAaACF...DGIFhAEAdHDHLCCCgBAChAAACCHBMIAAIHHEAIEA.SBGDhABA.PEAHKAEA.cGADhAEA.,2,-31,-27,4
DUPTYNWgQBaOcIEMCSLJKAfdGFXVeHZRb,dDDGXEEEeBFCZEGBDCFD.UGAA..TBCG..NABG.QFBChAAABGDD.OHFEhABAEADBMCAHCDHGSAGFhACA.KADEAFIBGEEGFFHFRGDCPAHDWCCF.hAAAaBBHICHD.hBAA...,2,-20,-11,9
EYUDMHKBWdSOaXGcVARPFLeNCQbTIgfJZ,RDBGLDDBCADH.TCFG..gDGHJAAAZGAC..EGFCDCFAhAAAKECFBGGA.dGBHOAEChADAXGEH..hABA...cCAGAEAGeHFAbAFAIEHHhAEA..fABHhAFAMCCC.SGAD,1,-22,-26,4
PGWQdNbOBSJZECRIKHAceaDFVgLfTMXYU,aAAHDCBCFCFDLFBA..MEBGUDFEGEGGdHAFODAABACAZFBChAAACECA.KGFDAIEA..eBEGhABA..fAHChABA.XCACPAFGNBIESDHBhACAEGHB.IHAG.hACAcAFB.,1,-15,-27,12
WbeRSMJFGAONEYTLXdUBCZVgfHacQIDKP,OBEDEEDCLGDAUAAEBHAGCDCD..ZAFE..VDBHHEGD.QAAAhAAAKGDH.bFAHhADAeBGFMEADFFHDNDDD.XADBhAGA.fGFCIBDGDIGC.hAHA.WBHH..SCHBhAEA,2,-43,3,46
FfTYUZEKeJgVLCBQdPNHcDaGXRSIWbMOA,FEHHTFCHZABAKDFH..eABE..JCAHVEFELGCECBHA.BHHHhAAAPEAD.HCBEhAAADAFF.GAECRAGD.WHDAhAEAMIDGABBC.UDDE...EGAB..dHADhAGA..aCCBIHHAhAHA..,2,-31,8,39
agNOMLAPJeCGYFBdDbcTKXZIWRQUHSVEf,JCAFGBDCBECEdDAA.DIDG....TFEEZGBERFFHHCGD.EBBDhAAAaBHFOAEGMIECACGGCHHA.hABAFBBE..KACHIGBHhAAA.....WEEESAGAhACAfAFF.NDDDLABEhAFA,2,-35,-20,15
ABZegEHMdGNbWcfTULKCOVYDIPaQSXJFR,eGEGHCBHdEDAGABG..NHEF...bBEB..fDHChAAAUFAECDGDOEHDDBBEaAEGXAGFhAAAJDAFFHAA.BEDBEDFA.hABAMIDGTAGAKFFEIDAGSFGAACIB..hACA......hADA...,1,-7,-15,8
OLeCUMAQSYKFGVEWgcbaXJZIHPNRdfBDT,SHBEFECFEHBA......gABEcBDE.XBGAhAAAICBG.NGAFdAHAhAAAfHDFBHHATFFBhABALEADCEHA.ADDCYEFEKHEAWEBEbAFHaBFGZFGDhADARABEDADE....hBAA...,2,-19,-11,8
PTQGReBEWVJgIbOcCXHUDfFaKLZYAdSMN,SGEHMIAE..PAGDGBCHBFHDEAACJCGD..gCAFhAAAIHGBOEABhAAAXFEFDDDD.fGBFhADAFCDCLACAAGGCNAIE.TFCBeHBA.WHEAhABA.cEADCDBFaEEB..hADA...,1,-5,-33,28
FVQZfUYGdOgPRbEMIXWHJaLCNcSAKeDBT,KFAGeFCHBHBGFAGDZCAGUGDHGEAC.dAAFOEAA..PFEFhADARBDA..MACBIGHFhAEAHDFFaBAF.CCHA.hAAASCEGAGIB.DEEG.....hABA......hADA...,2,-37,-19,18
YBIbWQJAXEGSReMgdVaLcfFPCUTODNZKH,EAFCGFBDRABF.eDDAdHBHLDFDFAAHUADBDFIBKCHDBEDC..IHFDhABAQDACAIBA.hACAMAEFaHAG...PFHFhAAATEFD.ZAGHHFAC..WCBASGEGhABAcEAB.CAHH..hAEA...,1,-5,-22,17
VNHCbARFcYKTdZGOaJEeLQWIXBMgUDfSP,REEEFEGAKGACZFCFGGCF..JDAHEDGALDED..IBBGhAAAMAGHDABESAEAhABA.VDBCCGGAACECTBBAhAAAdDAGaHGE..WHAGBHBF...fAHAhAEA...hACA...,1,-17,-40,23
WGERAKObYBVXcfdQFaMgUeIDLJTPNCHZS,OFCEBDGB..XBBGdADFFFHB..MEEEUCEC.eGACDCCBLAGDhAAAJFHD.TBDHhABACGFCZAFA..SEBAhAAAEAHFAACF.KHCEbFFH..YABC.hBAA......hBBA...,2,-29,-28,1
HDJQMWUdBSNgReaPFAbVEKOYLTIGcCfXZ,VECAEFADKCGC..LAEGGDAH..CCABZFCDDCBBMDHF.UGAFhAAASGGDRABD.PAAEhAAAFCEFAIDEOGFChABA..IEGAXBGAHADB.JFEB.hADA......hAFA...,2,-20,-14,6
MEXcfNSKVZQHDGdITegOaLAUBPCRYbFWJ,BGDGCHBERFEA.FDAD..JBCAEDED.....XGAB..hAAAfCFASGEEhABAKAHBZACADFACIDCEhADAeAAFOHDCAFHG..PAHDbFAA..cCCChAAANIEF....hACA...,1,-27,-48,21
aNJLQCRcHDFIWTGdZPBbfeUAKSgMYOEXV,KFBDSADGMECG.ECGE..aEHFLECDCHFF.RFECDGAHFCDE.TAAGhAAAdGDEZAGF.BAADhABAfDGEACAD.OEAFhACAXFFENIBBcDDAICBG..WCCEhAEA.....hACA...,2,-44,-4,40
dDHXAReFWaIYVbTUCKPZLNOQcEfMGgBJS,FGHHaCEB...VBBATEAC..KCHDLDHDOEFF.EAGCMEBDhAAABBHA.SDFBhAAADDEFAFAB.eABG.YGCGhADAUGDECAEE.NIEFfCCA..hAEA......hAFA...,2,-43,-21,22
VUAZKOSPacDdHgMJbNITfGRBeFXQYCLEW,OFFFSEFA..aAECDECGdDDGMFAE..JCBD..IHGDhAAATCGHGFAFhAAABHCDXFCACFHHLHBGhABAWCAAABBCKEEE..HAGF.gABHhABAfAHGFGAF.QBEEhAEA,2,-29,-14,15
RZVcMKLfPQNgYOCeaSTUIWBXDbHGFJEAd,RDCDZCBFMHBEKHAALBAD..PBEFQEFE..NEAGOABEhAAAaAFFUEDGBHGAhABADHFE.GCGCECHBAAHBdBDHhAAAfFFC.CCACSBGEWHFA.hABA......hACA...,1,-17,-23,6
CTXUSEWKgLOFJDIeMYBadNQAZGRVbfcPH,ZBCBRBAB..VDDE..fBGCHFBHCHEHUAEASFDG.hAAAEEAFKGHBLDHBhAAAFDHFDAIBMDAFBHAGaACBdGGCAABAhADAGGEH.PFBD.WABD.OAEAhAIAIHABeEEG.hAHA...,1,4,-22,26
UcJLKRVaYCfebEPMHFQAdOgIZDSGXTNBW,dGACODHBZCEHDDEBGDCE...TACHBCAEUGDBJBBF.LCHDhAAAKBFAaFFH..CAHBeFAFhAAAEGGBHEAC.FABFAEEAIHHGhABA.NICF.WADF.RAEE...hAGA......hAHA...,2,-23,-12,11
ETFJORfAgLPeVQSWBDYUXMNbdHGCaKIZc,LDCCeCBBQABBBAFBDCBDUFFF.MAECdFGCCBGA.KHDEIBGHhAAAZEAA..EBBEFFDFhACA.JFBHOBHDAEEA.hAIA....gADESDHB.WDDEhBAAYHAA..hAAA...,2,-45,-16,29
FbJDHGAMQNgfXCUVReSKaLPOcYZBWdETI,MGAAQFDE..fAAFXAAEVAGFSCBH.hAAAaDFGODDCZAFAdHEFTFABhABAIHHBbFGHDIDChADAGECFACDGCEAFeADCKACHPHAGBGFE.FFGE..hAAA......hAEA...,2,-10,3,13
SPFRGIbCMEWDYVafeTdBLXKHNJUcZQOAg,SAFFRBBDGEFGCHAH.EEDF..DFDH..aBCFeFEDBHGA.LBGHhAAAKAFFHBGDJEAGZDAFAHFBFCABhABAMDIF....hAAAWGFE..fACBXGCGNBIA..hACA......hADA...,2,-29,-20,9
DXaPJSCUVKEOQYIbRFgHcfANWZLeTBMdG,ZBEAeBFABEGEMGDEGEEADACC...aCDCJEBA.UBCEKCABEGBF.hAAA.ODHB.QBAChABAIGHFbEAGhAAARGBGFFAB....HABHACIHWFHH...hABA......hADA...,2,-27,-17,10
DTQXVYLHMKRBJCUFGecOWEfSAIZNaPbdg,ZADFaHGG.dEHGDEDDQDCH..XBDBLBFBKAAFJAABUCFBhABAFHCA.GGAF.hAAAeDABWFABEAGAAIFG.IFGFhACA.NBCC.PAHH.bFCE..hACA.gGGGhAFA...,2,-21,-17,4
MAJRFPcdXIgGWUQbOeCaTDLZYfSEVBHNK,JBDFFAEHdAGC....XABFIGDDGCFGUABC..ODDChAAAeAGBCHAC.DEABZGFGSHGEhAAA.BFCBhAEANAIEMFAFABBFRFDF.PDBH....WCHHhAFAaDFA.....hAFA...,1,-24,-33,9
RXBgWGOMZAYVaDeCLIcNQFUbdKSHJfTEP,VBBDeAACCFEG..LDEC..IGAHQEADUDFCKFEChAAAHAEEJADC.ECDDXGAHhABABECF.GGEHhACAOHCGAAHE.DIAA.NEIGdGGEfHCD..hAGA......hBAA...,1,-18,-21,3
OTQaRGPDJNfcLeCVUZMIXWKbFdYSBgAHE,ODCAaEBCGCGGDBAB...JDDE..fDFHeAAAUAEHMIBChAAA..IGFAhAAAKBECFEHBSAHFhABAAAIHECCF.QGFGPHAANIDD.cEACCHHE.ZGAEhACAXFCAWBBF..hABA..YECA,1,-13,-18,5
YMWSLDPCcAJFEGefQBXgRUabNKHIdVOTZ,FAGBGEBCeGFABEAHRFAD.aGGBKDCA..HDEHdDFE.OAAAZBBEMIFEhAAASBCH.DFIBhAEACABFAAIFJBHH...EEDDhAFAfDHAXAEE...gFCGhADA.....hAHA...,2,-26,-19,7
RXJbNCZFAGBPHTYUSEDVfKgaLWQceIOdM,GBCHHCFAUBBGSFGCDFCAKGAF.LGBC.QDBDhAAAIGGEMEIHJAFGCBAGAGHBBEAHhAAA..PHEEhABAEADEfHCBaCHB.eEEH.OBABhABA..XEEFhACA.NEAE..,1,-13,-18,5
bKRUHQINTJOSEaGVZWLXPFCDMABYcefgd,BADHeBDFdHBBKCFGRFBHHBFF.QAAC..TBBESDABhACAEAGGGDDEVGFGWEFGhADALGFG..hAAAXEDHFDADCABFMIFEAFCBfAHE.hADA......hAFA...,2,-27,3,30
LdCVHKNGMJYQfIXaeASZPRcEDFBgUTWbO,SFDCZGECRABCDCGD.BDEDUAFF..TBED..OCAFhAAACAFEHACDKDHFMAIF.JHCAhAAAQDCG.hABAXGADAEGCcCAEEFFGgEGA.hABAWAGH....hACA...,2,-32,-30,2
AFRaNKVIHJYWGLdEbgCOSfXPecTMUDBZQ,aCEGVAEDHDDG..JDCBGGAH.LBBDdGGFEGDH.CFBCSGFChAAA.PACGhABAcAGAUDGCBDABAAIFFAFEhBAAKDGH..IBCC.bFEHfGHChCAA..eEABhAAADIEE...,1,8,-36,44
EAHQUWCXTRcSdKBJMbODFGPZILafYVeNg,QDGCUFCGCAGE.RAFCdDDABGHC..JFACMCCG..DABFFAECZGEGhAAALDAA..hAAAaCEF..fCGHhABAeACFgGAGAHFGXEGC..SAEChACA...hACA...,1,-18,-49,31
YSPBKEORDWNZCfVdUgQcGTbLIJFaMAHXe,.HDBGeCBGSAFHKFAFODEDRFBDDACB.ZFGFCHDCdEBFUGDG.QADChAAATDGD.LEFChABAIBDCJAHDFGGEAFAE.hAFA..XAEBBHAB.EGBA...fAAFhAAA..hADA...,2,-34,0,34
CQcDFPLdaYTfSUAeIOBXNJKgZWHMGRVEb,eBCBBEHBJCEBKCADZDFD.HBEAMHBGGEAB.EHGGCGHADDGC.LFAFhAAAdEHGaHAGfAAFhAAAUBAD.AAGEOHBEhADAXECH...NBDD....gGFDhABA...hAEA...,1,-4,-40,36
GaSIEAgLRPcQZKTVbFeDfdWJNOHBYUXCM,RGEAQFABZBDHKABF...TBDFFDCBDFBBdGFA.JDACHAGB.BDFEhAAAXDFD.CBBCMCIFhAAAaADAEDHFAABELHAAhADA..PCABcFDCeFCC.NIAH.hACAOAEA...hAGA...,2,-24,-7,17
gDWUedZJNEAcYVOFCSIbGQafLMXRTHKPB,VDFAFHFGCFFF.....SEBFGBBGaAEBMBDH..XCGGhAAATEDDKBBDBACEDBIHhAAA.UAEFZFBGJAFEAHCEOFAHhABA.QGGBfEHG.LBAFhABA....hBIA...,1,-13,-32,19
HOMDABfPeGQbYIdXZEVaFCSRJUcgNLTWK,BECGeGFAQGCA..ICGAdDBAXAFFEGAGFCBECHBGSCADhAAAREEFUGGB.hAAANFEF..LDEEhABAKADBMBIFAIHGfBCG.PAHDYHBGhABA.aAFA.cABGhAIA..,2,-30,-14,16
QWPdTVRNYBJcgOMIGCeaZUbXEALfSHKFD,SDDDHGEAFDHFQDCAdCFARAAC.BEAHJGAC.OBAAGDGE.hAAAeAEEZGAAXBDAhABAACCHKCEFDIDG...WAEChACATDAC..YCFBMAIHCHADaGHDEBGE.fFFEhAAA..hABA...,2,-18,-5,13
eLCdRIaFOcGfbKVXMSZJEgNQBHUADPWYT,DFDG..PBGFTCBECBBF.dCFE..aCEDODHHGEAEKGFBMEIHhAAAZAFA..EAAFQFFGhABABDEFAHHE.eADCIGABhAAAcCCB.fEDE...hACA......hADA...,2,-37,-9,28
MIaXDHPgbVZUYBKcCGeJWAdFRTfQLESON,dGCCTEGCQAAD.EAGCSCBD.NBAD.aCDDDEFFPHDGhAAA..bCDFZEABhACABHBCCDACeCFFAAGHFCGCfEGAhADAMACAXGGA...HFBGhAAA......hABA...,1,-9,-21,12
gQFMXcCaLdJOGDURASPVEfWNTYBHIbKZe,SFDBEABG..fFDHTGGHHAEDKFAHeCCFQBGAhAAAMIAGCGHDdDAG.JDBGDAAHhADAAFGDPHACVDFG.NEEFBFHBhABAIBEB..gABHcAFAOBBBhAEA....hAHA...,1,6,-25,31
BMZCKaPOXcYdSeGJEgLVbIARNQWUDfTHF,RAEGQADHUGFG.DCCDHDCFFHDA.MFFACGHB.KBAE..aGCHODAHhAAA..XDGChAAAdACEGGAHECABgDDFhABAbCEGAIDE.fFAHBHHB.cGGChACA.SAFEhADA.eAHH,2,-16,-11,5
ANUTPOMEfZVBJecRKSWFDYGCbHdagLXIQ,TDBHMHEGZAEB.BACCJFAH...eFFEKDFGFACDDCIHGAAGHBFGaGHDhAAALCDF.IGCDhAAAADIHUFDAPAEAhABAEAHH...fGGC..cEADhAEASBDH.hAHACCAB...,1,-14,-28,14
IDZLNKUEedfJSYbXaWAGCHQMBROFgcPVT,CFACMIFABEEHFEFB......PACDTEAADFDFLDDBhAAA.KHAGEGFHeAEBdBACSBEGhAAAXCGEAGADHBAEhABAOBHF.gGAFIFHGNHCBfEGEhABA.JAEC.hACA..aGDD,2,-29,-19,10
CXAYFfbNJWBOLRGPQSHZcdEeDIgMaKVUT,FEBD..fGBHJEFFBDGH.RFFFGADE.SBGChAAAHABEZBDEdAHAeDAEDAADMFAChABAKAEC.TABBAHIB.NCIELFEDhADAQGDGIHHAaDAB.CGAF..hABA.YDHBWHAA.hAFA...,2,-30,-2,28
ZRKFBEXYDcMLeOTGdNPgfCJHaSbVWQUIA,ZFFGFAGABDHHEFAH.DBBGMACA.LBBGeBCAGGEHdDEB..PAFEhAAACDADHDEH.aFCASCGBhABA.WFCDhAIAQGBB.AAAERBFG..KDBAcCAFhACAOHFE....hBAA...,2,-20,-16,4
aOGKcALHIFgRXUNbYMQZEDBPWTCfVJSed,LBCCFDBDRACD.XECFUCGH.....bFEFMCAH.EFEGhAAABEHF.TCFAhAAACHAAVFCFeCAF.dHBBaHGChABAKFAGAFHH.IHHG.NABB...QAGBhACADGGCPAHD..hAGA...,1,-13,-27,14
EcQeYUbZWfRJOKAFMgadVBGIPTDNXLHSC,FBBGMCBBdHAHBBGBGEAH..TGFBDFFCLHDCHFCDCDDBQACEhAAAeDCGUBGAZADFfEHChABA.RCFH..hAAAKGADaGGF..........hABA......hACA...,2,-22,-14,8
LGaIgUQWBTbMPeVcOAHNXYSDZCfdERJKF,HFBHXEGHSFEBZFDD.CBDE.dDCCEAAFKABDFCCCLEAD.hAAAGBDBIAHH.hAAA..gBFEhACA.UEGHBCHAMDADeADCOHEEAIHCDDGFfGBDhACAaCBH.hADA...,1,-13,-20,7
egIOcJKQUVNGTXSaMBEAWfPdYbHRFLDCZ,...PBAGbECEHGAAFCEG.DDBCZDDE..eADEOFBDKDGBQGGEhAAAUFGH..NIDD.hAAAXGDDMDACBDHEhABAABACfCEFRAFELFAFIBCC.cAGFhABA....hACA...,2,-21,-12,9
GNMKaPcXDVJYWSTbgfHFZEQACOLdeRBIU,LBFDRADCBBHAUGDBGAAB.MIFEKEFE.aFAB....XEABhAAADECHJBHD..SFGAhAAATEDB.fEDGhABAFGGEQBAAAHHECDDEeHAANDED....hADAcGAEWAEE...hAIA...,1,-23,-31,8
YdCGMDgPSKUNRXHIcJZWaVQAEfbTLFOeB,EGEHTCGGLAHF.FCDBBBEB.dFAAMEAHDEEDSFGEhAAAKFCERABHHEGB.JBCHZBEFaGGFAFFCOAABhABA.CGBH.PBABhABA.UAGH.XFED.cCEHhACA...WHAAhADA..,2,-18,-16,2
WTJBdfSAKgMaFEeLNPZCUXQDGbcVRYIHO,KGBAMABGEDEALDFE.ZFGDCBEDQABHGGCB..cCDBhAAARGFAIAFB.ODDHhAAATEBGBBGASAEAhAFAADAEaEAD.FBBFeFFC.NIAD.XAGHhAIADEGE.....hABA...,2,-23,-3,20
NYMVTFdbEQHZUeSWBGDOgKcJRIAPLCfXa,LDEACHAA.aEBENACD...MEIFFGGCdFDEQAAFHBEFeDBFhAAASAEHBBDFDGCBOGAEhABA.KCCDRAGBAIECXGFDhADA.TFDEEBAA.UAGC..hAEA..WFFC..hABA...,1,0,-34,34
KebJcEBSDXaFZLCWMfVRIOPYGQdUTANHg,HEDEKEBGeBGHJBBGBCHFDBDG..FGGGCHBF...MFFERAFC..OHFEhAAAGCDEUDAAACAF..hABA..bGCASGGEhACAaAAALEAD.fBBEIEHD..hADAQGDBNIAH.hAEAcCEF.,2,-26,-12,14
ZUWSKGbNYBcRMfFIXageTCPJEAdQOVDLH,dAEHVFFGLCBF.HEEFUDBFKBHBGFAB..NEHGBGCGhAAARAACFAFEaADDeADD.CABE..hAAAEDDBOBHF.DEEAhABASHBG..YHEA.hAFA...MFIF.hADA...,1,-15,-25,10
BTaZQKgPeAFbdCUfYVWScDREOXJHNMILG,dDECCEAAUBDH..fBCF..VEGDSBFARGBE.hAAAOGAAJABHHAGFMBBHhAAALEFFTGFEaADAhABAKCAF...eDHHFEDF.WHAADIAE.EDFA.IECGhACABGAF...hACA...,1,-8,-23,15
VaMSZCHQYEXAFeLgOGJUBfRcKbTdPWNDI,LEDEOEDCGAAFUEAFBHFGRAFH.KABHdHED...PFBDhAAADIAEaGGCSCDFhABA.CFHGQDAChADAEGDBXBDEAHDHFDGEeAHB.JBGH...fBAEhAAA...hAEA...,2,-30,-12,18
gAbXRTaMOKSGJNdEDcBWIPfUHLVFCZYeQ,XEABaGGD.KAHDSCDC.GCFEJBDFdDFFEFABDEGBBDAChAAA..IGCChAAAfEDD.LAHFhABACBABeHFGAAGDbFBDMEIBOACG.cFDChAGAWACE......hBAA...,2,-38,-17,21
UdSeCAHNJEQLWBVPFgcaKYZOGbDTMRIXf,JGFCLBDFBACC.FCAG...aGHBKEBBOFBDDFEE..MDBERDFE.hAAA.XAFEdBGFCBED.hAAAAEAFEGFD..QGDChABAPFDH...gGAG.hABAZDFC.....hACA...,2,-41,-27,14
bDZLaNPTFdHWGecCUOEVRKBJQASIYgMXf,SADD..YFAEXDGFDDBEZFCGLHBG.hAAAaEFETGGEdBBBGBEDhAAACBFDEBBDKEADBFDHAHBBMICEhABANAEDFGGD.eEBG.cDEF....hACA......hAEA...,1,-20,-23,3
YFXDgBMVCUacLWQIeZfRPESTGNbKdJHOA,FBGADDHHBABGCDDE.UGFFLDBH.QGDCZFCHRFAB.EDFCGBEBhAAA.KADDdAFCHCAEhACAAACFXFGE.hAEAMDADaEEE..IDEHeHACSAADhABA.NFDB.OAFAhBAA...,1,-14,-25,11
abEfIJKSHXZcBMCNgLDAFVOYGdQRPTUWe,OCGBdEBGQDEBRDCH.UBACaACCEHCG..IAECKEACHAABhAAAZGAGMFIDCFHE..LCFEhAAAAEFDFAFE.YHEEhABAPFGDeFAB.fHEBSAGEhACABCDBDCCC....hADA...,2,-13,-13,0
dIeUASRTaPEKXDLQbVMOWgfNBCJcHYFZG,RFBGaFFFKBDHLAED..VGFCODAG....fAFFhAAANCICCGCDHAFGZAAEGBAEhABAdGAAUGDCSCHFhACAEDFCDFCAQDEH.WEADBHHEcACBhAFA.....hAAA...,2,-12,-11,1
dbgCecLBERTSNKMJaIGQOPWDAFXfUZYVH,XAAAUFFFZDADHCFGdFCG..CHAG.eECABDCEEBAFRCEG...TGCDhAAAKAFGMDAF..aAFDhABAQFEC.hACAOEGFDIEGAHAE..fCCD..hADA......hAEA...,2,-34,-19,15
IcOGCPSAJZVaMDKRefEQHgdNBTXbFYLWU,VAFGaEFC..MCACKFCE.RADE...EAAHQGDGdGFBBBDG.XGGHhAAAFCHDLDAF.hABA.UDACOCEDCDHFAFIBDDEHhACAfGDAgGAG.....hAAA......hACA...,2,-34,-14,20
NKgZTQRHPbdOBLSUVCWfFXeJDGIEcAaMY,MFFDKCGHZBCBRBCF.HFCBdBFALCBDUFFE..CBFGFFACJFCB..DADEEABHhAAA..AGAA..aHGC.hABA...NAIC.QEGChAAAOAEABHBGSBHD.WEEFhABAfDAH..hADA...,1,-27,-32,5
VEbXNFYGaAJKCIBgLdTDUHRPQMfOZcWSe,JDEFKAAABHGALFHBDHBE.HECB..QBFFMBIBZBDASBGBhAAAECDF.XCBChABAFEAE..YFDEhAAAABBGCAFF.dAEFRGEAPEAHOCAGeHDA.hACANCIG.aHAE....hADA...,1,-8,-28,20
AWeIdXMTcLCbaUQRFEBYVJHZSfgNKGPDO,eEFEXAGDMFGBLAED..aFBAQEGERBACEHDE.BFFDhAAAJCECZAEASCBGhABA.gGBFhACAKHACDDAFACIFIDDEcDACCEECFHDC..YAAEhAFAfAFC..hADA...,1,-19,-22,3
PBHDGCTAaEYSVbFIgeXdNURfJKWLQZcMO,aHCEECGA....VFEAIHAA.eBDFNBCC..RBDH.KCFDLFDDhAAAZBGFMFGHOBAFhABABACGDGCCTFADABAESDAAhAAAFAEA.dFHAfEHG..hACAWFAC....hABA...,2,-34,-10,24
gfIeLHObRaAFNPJCGQVZKEXSYdWMTDcUB,FHBGJDGDGGDHZBBGKEDB...EAFC..SCGBdEAGMFCBDBDHBFBAhAAA....ICBGhAAAeFHDHBEBRCEFABIDCEDGXDAGhABA.TGEG...cAGAhACAfABH..hABA...,1,-24,-36,12
WGCZdFAcNIeRfLETOHVQBKYDPXbJMUgaS,..IBAFeBCBLFFD.TFAEOEADHAFGQFFFhAAABCABDCFBPDEGXGCAhAAAJFCDMBDHgDGEhABASDAECHHHdDADAICGNAIEEAFAKGGE...YHEAhABAaECE....hACA...,2,-26,8,34
OUVeZdNKPJDaRgcBLSGHbQYEfAWICFTMX,CCHGFHEC.MBDBUADEZEEAdGFG..KAHDDFEB..RCEGBEAHLDDEGEBEhAAAHBAH..QAEDhABAEAFAAAID..IHBChAAAOABF.NEIA.aGGE......hADASFFEfGAEhAEAXDBD.,2,-30,-14,16
XBDGMbSVPKUCdQHTcYIfaOeJRNgZFEWAL,LDADDFCDMACF.VCEGKBEC...dHABHFGD..TFGAIGDEhAAAOBACJFAFRDEENDDC.FBAHhABA..AIFABEHB.hADASAAE.CFBB.QDCAhAEAfEEEeHDA...hADA...,2,-30,-15,15
VYcJXIfgZPTKFGOeMWACBDQaLRbHSdNEU,CGBCDCFHLFHBRGBAHDBCdGFFUAAG....VAABJEED...XBFFhAAA..fDDFhADAZCGBKFADFADBeAEAhAEAAHIB.aGGB...SCHF.NIBFEDBFhAFA.....hACA...,2,-28,-22,6
LTBMcPKZWdbeYRIUXFAVaODENgJGHQfSC,aDAGOFBH.DIEAEDGE...JEGHQEGF.SGGGhAAATGCDMCCAKADFdCAHhABAeACCRDDFICGEhACAFDDAAHBDNBEH.....gAFCfAAABECFhAEA.....hAAA...,2,-37,-15,22
gbaJEWOdPAQRecMHBVGISUXYZDCNKLFTf,REEAMEGBBDDGGBDAUBED.ZAAD.DBHFKAHFFFBF....TCAChAAA..fACFhAAAaHGAECHF.dGDDAIFCeABChABAcAFGHGAA.SEHHCHHCNICB...hAFALFAE..hAFA...,1,-18,-19,1
CVAgRXHJTQcdfUZbMOeEaIPKDYLFWGNBS,XFEEJEEF..QBBHdEAC.ZDAAMBAEOFCHeDFGEEHHhAAAaCCG.KFBEDDGGFDEH.hABAGGBHBBHFSHEAhACAAHAH.gAFF...hAAA......hABA...,2,-28,-28,0
aJKecTMZGOXRPfCHDIWdVUYLANSBgbQFE,BCBCQDDGaGED.KBAHeDDF..MIEGZBFGOFADRFAH.CAFBHEGBhAAADCCEIEGEhAAA.dGGBUDAFAABAgAGHhADAFACC.EGDG.TDBE.PADChAGA.....hABA.fGDC.,2,-22,-8,14
LTACSUbdPZFQGcgRBIaEDNMVXeJYOKHWf,SEECUGCBdBFFFFGFQAFE.GCADRDBABBAEEFGGMADChAAAXECH.eBHHhAAAOFFHKACGHFABLDFGhABAAHHACBAFPFFB..cACH.IHAGhAHADEAB...hABA...,1,2,-32,34
dcfDagWAVLZSXHOBPKFMEIeRbCNTJGQYU,LBFGXEFHHCAFOCCDBHAHFFGC.MDEFeFDH..CAABJCFEGAAFhAAA.UGAFdACADAFGhAEAaFFHAIEESAGAhBAA.EFCBIDGC.RDADNADDYHEEhBCA......hBEA...,1,-7,-23,16
EfGdNQBLVebUAcCKSPDFRHgaMXOIYWTJZ,KEDCDBBHFACERADCHGAC..MCDGOCFC....IEFDhAAATAABEFGFdDHEBBHHeDADAIGChAAASGDFaFHD.hACAXGAEWFFFfAGBNCAGLHEC.bCCGhABACCCB......hACA...,1,-4,-35,31
GDAFcSHeCOPUXNdRJLMWZbKfVaTBIQgYE,FEBBSFBCHGCCCEDD.UAEAdAGDLBCEZEECKCHF...aFGCBABFhAAAQDGBEGECADACOHBChADAXBAD.NEAC.MDCAhAHA....fDDBIBCD..hAAA......hABA...,1,-21,-31,10
fbOgcISaDWMTKdYGHFCeNJXRAQUZLVPBE,ZCADLFACBHCDEDFBOBBD...IHAHaFHHDGAA..MEDBhAAAKEHD..GADCHACECCFEhABANHDBRDEFAHBF...UBGHhAAA..PAHBfBAC....hABA..cEEH.hACASHEA.,2,-28,-10,18
DReYHWJMKbFfESOXgTZadVQcAPBUCIGNL,UBBAGDAGLAHBDCAHeDDBHAEE.JFDFKCEC.FBCBEEFF.ODABhAAAXAGF.ZFFEdHFBhABAQDFHAECDCDEB.hACAIHHE...NICD.....hAAA.WABEfGAFhADA.SGGE,1,-15,-26,11
cBFDdSOMPHNfAITYWgCKZURQXbEeGLVJa,TFGC..YCFBCBDBZCFA..QCAAEFADLBBEJFACBHAGhAAAFCCCDFIH.SGGDhAAAOEDAMABENAHGACFB.hABAIAGBKEAE.RGCA...bFBD.eADEhACAaHEE......hAGA...,1,-14,-21,7
KbAXSUeFDNIGgLBVOPfaCHQWdJETZMYcR,SAHHUAAFDIACGCFGBABE..OFCA..fADHhABAaGDHCAGCHGEEQDADhADAdBDDJDDE.TEDBMFAH.hAAAcBGAKBBFAEBE.FCDGIHBELHFE.WGAGhAGA...EEHH.hADA...,2,-26,0,26
bIVOMLCFRdADagSQJPYGZUcXKfHNeWETB,DGGAaCCA.QGBF..JFBAGADCZGCGXDEHKBFCHAAGeDAChAAAEHEEBEFE.IHHFhAAAVAFDMIEALAHHhABACABEdGGD.AAFEPDAG..YBHBhADA.fADFhAHA..,2,-15,-11,4
PXNQOLeUSHZYaBDcERVIGTbJCMAgKfFdW,KBBEFBAEdGEC..XDFCQAEFLHBCUDGGHFAGZAGHBCDChAAADEEA.EGFARDAC.GCAChABATGGHCCFBAAFH..fBDEhAAA..WHFAOHACSEDFhACAaAHH.....hABA...,2,-19,-15,4
LPMHNRWDZAIcdEYOXJCVGgFUKTeSaQbBf,dHCBEFGF.OBDBCAFG.GEGGFBCGKFCH..eEFFQDDABEDHLABDhAAAMBHF.NEAA.DEAGhAAAABGB...IBAEhABAXBGD..gGAGSADEaGFHPEBHhAGAWCFB....hAHA...,1,-23,-30,7
WGHcFfDNVPZOIUKCLSJAQXbYBMTdRgeEa,QGEDXFBDBDAEMFIH..RFFBeBGDaGCBHAED.FECAfCDAhAAAVBGB.OBBFhABAKABDSCCAhAAAAIDG.YEAF.dACAWFAD.DFIH.hAEAPACG.IFDEhAGACEGG,1,-9,-40,31
JCcFLISfaBeXGYDKPOTRgVWQMUANdbEHZ,dAEBEHDCZCDEJCGH...FEBCLCCB..SEGHBBHDXFFDhAAADACBKFEC.TGBBhAAARBAD...gAFEhABAWFEF.MFIDAFIBNDAG.CADC...ICEGhABA.eFBD.hAHA...,1,-31,-35,4
AXeLdQcMHNaPgYGJBIDTFCbWZVfOSKREU,LAAFdEBHMACGHFDHaBGD....PCCDGCED.IGHBhAAADFCBFFAB.CAHDZFFHOBCAhACAKDBEEGACUGEGAHCGeBCGhABANDIA....JEEEBBBD....WHAAhADA.SGHDhAEA..,2,-17,-11,6
RdNMJBLXgWAfcQeKGSOaIVPUbZYHETDCF,QAGEeAADKGGDGAFCaEGC...VCDBPGCG..UFBHhABAZDBEEBBHDAIHFEHBdADBMIBGhAAABHADLBBHhACAXCFCAGABSADEIHGB......hAHA......hBDA...,1,-8,-17,9
UPbONSJZEcYdTfKBWQALHGgRaIFVCDMeX,HEGFRECEFDAG.CACGDECC..XABAUBFB..OFEFJBGH.EFABdHBDhAAA.KGGBBCCG.AEFG.hAAALAFC.aFGGhABAMIAEeDDEPBAH.SAHBhABA.....cEBChADA.,2,-39,-26,13
LXMKeUYbAgVWdNJfGPFSZOQRHTIDcBEaC,VCFBdEGAJBBD..GDAHFECG.ZBAERGCC.HFAE.DAIBEAEGLFFGhAAAKEFD.eHFEUGAGAHCD.hABA...gAFChACAfAHGSBDH..OAAGhAGA.IHHAhAIA.aDGAMIDG,1,11,-42,53
ZRYAPNHIMSfWEBXKCcTaOLUDbFdVGgeQJ,HAFASAFDEGFHKCDECCCF...aAABOEAHLFFEDDGA.FEBFVEEEhAAAeCAF.ZDEEAADD.IHCAhACAMFIBBHGH.TGBHhABA...dEDG...gCADhACA....hAEA...,1,-12,-29,17
HRcaNXGIAFgSbDUBEZCYePfWdKMOTVLJQ,SADADCDHUEAFZEGDCBGC....eCCF..PAAEdGDHMFIBhAAA.OCAFTEEFLDFEhABAHGCAaBHFNIADXEEChACAABECFGAD.BGAG.EHFC....hADA....WADEhAAA.KDFC.,1,-8,-32,24
BEfNIQdOZaFXKgcMJSCTLUHADGVPbeYRW,DIDEGGDH..VEFFeBBG.RCEEEGAH..IDAGQDBDhAAAZGAEFACCXEGE.hAAAKHBAMAGHCADHUAGEHCCGhABAABAH...PFAA.WEHHfEEChABA.....hAEA...,2,-32,0,32
BCRDXPYJWgbGFVIQKeMNEUfOSZAHTLdca,TGFGLEGD.aEADRFBEDAAF....XACAJAEA.bCCHVDFChABA.KBBDMDIHEDBA.hACAfCGFZBFE.hADAAIHGHGCCBEDCCHAHPBAB.gCEFhAAA.IHAHhABA.eAFE.,2,-23,7,30
MSaOIXKVbGBAFdLUcWYNfPQJDCHEZgTeR,FACELDEHUGFE.......YBADNBAE..QGBBhAAACAGCEHCCZEADTECBhAAAMEEEOBFE.XCDGhABAKGGAbCGHABDCdAGFfCCFDBBF..hABA.....eAFDhACASECG.,2,-27,-8,19
dHKZPDJTegUABfNQMCRFXELYVcabGIOSW,BCEAQAAFMDBHFFGCLEGF.VCCCaDFEGGAF.OADHhAAAWFCH..KEHHDCCBhABATBGHeAEGAAGGCAEAEGAGhABA.....YFEDIHHFSEAGhADA...hACA...,2,-37,-9,28
XTFaPKfQMYGJbVdgOZBcCHNUAWSERDLeI,EBCDDFIHeGBE..XFEEFHAGKADB.QAFDGDED.VDAFhAAAOFFBBBAEHCCEAHIFSHAChABAIAGGaCFAhAAAfDEA.MEHBJBAH.dHDD...hABA....cACFhAEACBBENFAH.UCGH,1,0,-19,19
RFMVIXNOAbBWPLfYcdGDSUTeEQZHaJgKC,BEAALAEH..fGCCdCHCSABHeFBCZCDGJGEGCHBHFCAA.hAAA.MGAC..IAGBhAAAXECEAHFEbFEAhABAPADHGABB.DIEC...EBHFaBAHKEEChACA..NIDD.WEHB.hABA...,1,-5,-32,27
DSQPbBOcFIgZeLUfCTAWKdXVNJRaYEMHG,dEBHVFCGJBCE..RFAB...EHDGHADHGEGGSACD.QDAHhAAABBHFOAEAhAAAFHFAZDDCeCEFLAHHhABACFFFACAD..XCGENEIG.MIAE.DBBFhABA......hACA...,2,-26,1,27
ZWRSPIgBFGLDXUHCbNfJOKQYEaVTMcdeA,ZEAERDAH.SGBE..IAHCFDAEDFHHUGEHbCFA..JHFEhAAAOCCAKBCA.EBAHaHCAhABA..MEECeFCEAABC.hAAAPFFABBHG.XAEECHAB..NDIG.fABAhADA..hAEA.YDDA.,2,-27,-12,15
YSQCKEIGDfRHLbBgZUVPcaAXOJMNTFWde,OGEEMGCCFBAHdDEG..eFHDSEBG.QCGGhAAAEDEAIAFFDEADHBAELHDAhAAABABBZCBBVGAGcDFDhABAAGDENEIG...WBHBYADGKHAE...hACA......hADA...,1,-7,-23,16
bSUNDgOLWfETGPCZFBAJaKYXcQReIdMHV,KBFGXEGDQEDDRBAC.dHADMDEDHBAE.SABEUAFEDIFELAAEhAEAEGED.PEBHhAIACDHCBGGB.ADDEJEAHhAAAaGDC..eDFC........hBBA......hBEA...,2,-21,-19,2
HbRBQZcVMYJUGPeOECKdTLFAaWXSgNDIf,XEFASCGFDFADHGBC.BFEAZFADMFDHUACEGBAA.hAAAOAFBKDDATBEAhABAFDDFaGAHNIEB...IGHChAAAfDAF.QCGHYHFA.eACChACA.CGHAACCE...hABA...,1,-10,-19,9
XOHdDEVabJSeYRQAcgTIUGMNBKFZPCWLf,TEACGGCDBGBC.KCDEFCBCZAAFCAGCLDGF..OEFGhACADFDHaHFESEAChADA.eACAYCEBhAAAAAHCIHHDNBBD.fEEGdHCHEAHF.JCFEhAGA......hBAA...,1,-21,-29,8
EWbLDdSFMRCPZUTeKfJgXVBOIGYNaAcHQ,QBEDEBGFLEGFDGFAdEBBFCBHRGBG..ZACBUGAHKBAG...JDEB.hAAA...gAEChABABHHDIAAH.hACA.NEIAABIB..WACBMFFDCAEF....PHDEhAGA....hAHA.TDGG.,2,-33,-14,19
eBgXOZVbMHFdDNfAGYUaTQcRIJPCSLKWE,UBFAaBFF.QGGEREAC..JEFCSGEHKBAG.EECFBDDDhAAAOACDVFDHMEEAhAAAdADEDGGEABADGCAC.hABA..cFCDIAHCCHAB..WAFEXGAChACA....hAFA...,1,-7,-39,32
ZVSQTYDLFIAdUbfRBGMXKHOPEWgJNceaC,dDEHUDBARBBEBAGCMIBCHDGF..EEHBJAHFeHBG.ZBFASADEhAAA.QFEHhABATDAHDGGDLBBEhACAAIHE.fDEBKADE.OAFDgFDHhAAA...aBABhABACHHC...,2,-31,-2,29
FVgDJBICUYfPQLSHMbXdcRTaZKAWeOGEN,OFEEGGBDFBFHDFDFBAECUDCG......fFADhAAAPCAHLCEFSFFBhABAHAAEMCAEdFBCTCGBhAAAaAEBAIGAEAGA..NIBD..JHFCCEGE.QAGHhACA.....hACA...,1,-7,-26,19
VRbIgQfOXSKWANDHeGZJUEPLCdTcBYaMF,HAFEeDCEGBEFUEBEEGFACGEF..dACFBCHHMHAGFCAG.RCDD...bFFHhAAA..IHAGhAAA.QGDAhABAOFAASBADAEADDBBE.....PFHFhABAcDFAaBBE.fDGHhAFA,2,-32,-12,20
cCABNZXMJGYLTKRdVfPWaOQeEgSIFbDUH,BBBAXAABMBFBGCBFLABE.RFAH.dGDF.VADG..PDHFhAAAaEFCeAHB.SGAAhADAFDCFDGGFHAGDhAFAAGHCNIAD.ZGCE..........hAGA......hAIA...,2,-23,-11,12
DcZLVMgJAQdBOXWNTbHEGCPYKeSaFIRfU,dBGABHBAODBB..NBDAHAEFGGEDCEBF.KBCG.eCFDFFHH.RFBHDABBhAAAZGDEMBAD.AFEE..hACA.XDDD.hAAA.TAGEEDHHPADGaDGCfBBChABA...cGABhACA...,1,-13,-36,23
TQAFRCYgebJEdfHXLVPOKIDaZMNcBWGSU,FHACCHDF.eHFGEDAGHECELFEC..VAAEKAGEDDBDZAFG..MIFGhAAABDCAGCGCSCGAhAAATGADAEECRBCG...hADA.YGFAgAEE.JHCCfCDGhAEAOBAB....hAFA...,2,-19,-8,11
OCcALGWFRKUNTXgHYbQaPDZJSfVedBMEI,LABAFGBAUABB.TDGBHEDC..QAGBaFDEZDAG..SGHBhAAAfEHGdGADEEBChAAAICAFCAEA.ABFA.hACAWDDEKCFE..NICHgCDBPCAHDIDA..hADA......hAFA...,2,-18,-14,4
VPBFACHMWJYgcDeZfadGbXSIROQNLTEKU,CEABMFBD..JEEE....gAAGDBHBZAAGdGCFGCDB.hAAASGCBOCACQFGAhABANADFLEHB.hACATFFEECECKHAAPECCAFAD.YBEChABA.cCAHfECFhAEAaGEH..,2,-35,-19,16
CDSKUZfBgYIAHPOFEGLWcXJQeMRbdVaNT,OBFHFACDLEAA..XAAGeGDCMEIDdFAAaCDD.CHHH.DAIDhAAAKFHDUGAA.BHFFhABAIHCAAEEHECADGCDDhACAJFFBQCGG...VCAASFFEhAEAfAGB..hABA...,2,-29,-14,15
ebUHgdDOMEPSJYCINQKfVcAaTLGRZBXFW,aBGGTAABLGAE.ZEGHBEDF.FBEFeCADUEFHHBCEDCGCMHDEhAAAEEEGSAAEhADA.CCHD.QEAFhACA.KHACcFDAADDE......hAEA......hAFA...,1,-17,-36,19
YUFgcBfENMCIdbQGeAVOaRXJZWSTDLKPH,OHEAXGBGZBCA..SCFGDBEGKEECHDAHUEAF.FDDDBGCBhAAAEABF.CCHD.dAHC.QADFhAAAAIHEaAHF.WEGDhABATEGB..PFEF..cEDChABANEIE.MFAFICCHhAEA...,2,-27,-20,7
gKDVeCIZELcYMdOaBSFAHUPTQXNWfbJRG,HBGFTCFAQAEC.XDCCNHEH..fABHhAAAbFEDGGAFDIGECBCCIGGHhAAAEDBELEADMBAFODDDhABABDFDAIHCWFFE.gADFeDAH.hABAcGBAaEGE.SBFEhAGA,1,0,-11,11
TdcZGSOfHMKNXARgLEJWIYeUDbQVBCFPa,RFCBEGCG..JBGH..IDBCUEEC.DAFGQABFBEGB.FHFGhAAAPEED.aBGBdCDBhACAGBBFSEBChAEAfHGDKHAAAAFE.WEADeAHB....CABC.hAAA......hADA...,1,-23,-38,15
JdBKbFNPXIUDeSLQVMTORgfcYAWCHaZEG,CDDFZCGHGFEBdCDBKDBFFDFA....XGDEDFBBeAEGLAAGhABA.QEEDhACAVBACMIBEOFAB.RFBHfAEDhAGAcFCCAEBCaABAEHGABHHB.NAIC..hAHA....IEEHhAAA.,2,-34,-2,32
JZDYRaMLIQVdPeENFfObGATHSBgWUKcXC,HAAEBBBFUAEEXGAFZDAE.DFGGRFDF.LHDE.QAEHhAAAdHGDEAGCFDGFODFE.hAAA.ACCE.gDCBhACAKGGCCADG.aDAHMBIDIAHC....hADA......hAEA...,1,-10,-38,28
cIVEWFKJLaHDRXPQSYefOTgUdbGMBZNCA,VBCAFDGAKCDB.LEAGDIAG..REAHQGDDeABF.OFGDhAAAgAGC.dGAHhAAAMEIBZGEACCCCABACIAHFhABAEEFH..aADEXEEE.SDFChACA.fAFGhADA,1,-23,-31,8
MELPBCDVSAcNORXYgFaHUbZQGfJTKdWeI,OAGHXDEEFBEHHACHZBAA.GECA.TGAGKEEDdHEB.eEABhAAAEBAGLHEEBDAEDDIH.hABAACFFNCIE.RAFC.aGFA..hACA...bFBHfEAF...hADA...IAHGhAEACFFD..,2,-22,-6,16
UHGfOESLbKMVTWDQdZeaFIANgYRBPCXcJ,...NADC.RDABBBCE.CAAH.XBAEUEEBHCGHGEFG.OCEFhAAALECBKGCAVBGDhABATAFCDEAGZCCA.aHACAAHA.hACA.PFAG..JFHBSFHBhAEAMACC......hAFA...,1,-17,-20,3
fcbReGWaMQXgINBKTHSLVJEDFOACYUPZd,UFCDZEBDdGFB....fABAbCAC.eAFFGAFG.MFDGhAAAQDACXABAhABAICCEBFAGKDHHSAHFhAAALHDG.VFFBDBEFAHAHCAEFPDFEhABA......hADA...,2,-24,-10,14
IgKSRDZAbXTPfaQNeYdVUMGOLBcJHEFCW,XBBGTDEG..aEHDeFAE.dGEHUADDOAEELBBFBCEHHEFGhAAAEGDDCGBF..IGFGhAAAKHAADDDFAIEA.PABAhAFAfAGH.NCAE.YAHBMCHB..hAHA......hBAA...,2,-20,-16,4
eURAXNagVcGFDWEJfSMHTCLbKBIZdYPOQ,XBBHaDDE..VGFGFDAHDBGG..EBHBJGAEMBGH.CCCFLEAFhAAAKFDEBGFHdABFOEBChABAUCFAACAA..NIBH..hAAA...gFGBWBBE.SDHBhAEA....hAFA...,2,-38,-22,16
YVEgMBfXFDZcTIPKNJAURLWGHObaeCSdQ,LBCFGCDDHFAEOCHDaHCG..eBBFSGCCQEFHEBECBHDHhAAAFAHHDAEHZEFH.IDAHhABANEICAADD..WHEAhAAACCFAdFAG..gDCGfEEE..hACA......hADA...,2,-29,2,31
SDaKdGBQPHAVRbgfWZNTEYJUXFcCLeIMO,RACG..fEEFZGCGEEDC.UGGAFAAHLFADMEAF..DGDDdBGFhABABEBHQDGFhACAAABFVADD...bCCCgBGAhAAATGGE.YABB....hADA.cGAE.CEHAIHEGhAFA,2,-20,-20,0
PRECHIXVMBKcdWgeLbJOZaGYAUNTFDfSQ,UFGAFBHFDADAQCDC.RFAD.EBCGCAAC.HFCF.XEFDhAAABBBBdCGBeAEALADEhACAJDDGOABHaEFGAHDE...hAHAfGHA.IHFHKFCC.WCADhACA.....hAIA...,2,-29,-15,14
YdFAJTZfDHcUPWOSgebRaELCMXKNVQIBG,ZBDHHEDCUGGEOAEH.eAFARFCGLBAB.CGAD.MGAG.KHDAhAAAQBFGIGHGBCBDhABA.dDHGACDDJEFEhAAADFAGcBBFSHDAaDAC.NACF.....hABA......hAHA...,2,-29,-11,18
eFWTUMDAHKROgCBbLcGVZEfPQNdIJSaXY,HDFFKECDRBCD.CEDALCBBGAEFZGFAEBEG.QGAAdFEB.SCADhAAAaCAHeHACFAAF.hABA.WHCEMICAAAGABABHhADA..cDGAfHGBIFABXAGEhAEA....hAFA...,2,-18,-14,4
NRDSVEJTAHXfcabKgdIFCMQZGWLYUBePO,XEBCaCBH.KCCEIFCC.CAEC.QFDAZDEB.LCGHhAAABCCGeADDNBACSGHHhABAEBFGJGFGAGAA.fCEChACA.bGAG.dBBGMICA.WAHHhAAA.YHAEhABA...,1,-9,-40,31
fPUDZMcNXSYRdEeCHKWFGVJaBOLbIQgTA,UCDADEHBZBCFMFFA..XCEARBGF.dFBBCEACKBAEGGAD..hAAAaGBHBBEBLADGhAAAIBAEQGEEhABA.AIHA.cDAGSGCCEFFH.HCAGWADEhABA...FGHD..hACA...,1,-13,-30,17
TdSGZXabeIFOPfWVcNJULEYDBRAKgCHQM,CCDDHEFG.MEBDdGHCGDEHaCAG.eCFEODDF...fHDHhAAAWBBE.VAEGhABANCAE.LDFEDGGHRGBAAFHE.hAAAKBDF...gGGASBGE..hABA......hACA...,2,-35,-3,32
GHSEgVIdDQbOTLeCKXWUBaPcZfFRJAYNM,MEABHEBGEAGE..VGFCIFGH.DCDAQADE.hAAAbCDGLGBG.hAAACCAFKDBEUBADBHHEaGBAPEFAhABAcCGCfAEDFBFAAIBANEEA.SABChAIA.OFFHhBAA..,2,-16,-15,1
GfFEgbJMVXOHdSCaRePcLKBZWIDQTYNAU,UABBFEABEFDD..JBHDMEEE..OAEGHBCGCFHGRFDH...eABFhAAA.LFFDBGBEIHGChAAAQBGA.hACATGBEAEDG.fGGGbCDA.dADBaGGAhAIA.KEBA..DBAH.hBAA...,2,-41,2,43
RSDBTNAbdUWXegJaVZfFEIMLYQPHGcCOK,UDECXBFGeCAD..aFEFZEGH.ECBBMADFLAAA.QBGBhABAPCADGEGAhAAACAFFRDCFBHBBAHDAdDGB.WCCDhABA.....JHAC.FAGC....hACA......hAEA...,2,-18,-16,2
dDGACTbeVKQRXfIaEgNUJcZWYBHFPLOMS,TABEVBGH..KFGCRDAE....XAFDIEAEEGGC.UFDAhAAAJHAEZEED..BHBGhABAHAABPCHDMDCADFCChAAAACDEeFAFaADG..NIED...WHFA...hACAYDDC.FADAhAHA..SGGA,1,-14,-15,1
NHdaWcXQVMGFCEADPUeYBfSZJRKbOgLTI,UAFABEGDZGACRFBC.KHGGOHEGLCDF....TABCHAFHaADGhAAA..XDAHhAAAQBADVEFEMAIDhABACAEDACDADDEGeFEH.SEBB...hABA......hADA...,2,-31,-15,16
OeIXELRYFNQKadfScZTJUBVHDCbGPWAgM,MFACeDEHEAECRBBD.FBDHKGBG..dFCE..SDEFTBGGUAAEhADABDGFDFIHCHGCGAEDhAAA.ADIF.gGEFhAEAOFFBXACF.NIAD.aHGC.fHADhAHA..JEHF.hAIA...,1,-19,-21,2
caJIQVRHSPgfeDFNWEGbdYCBUKXTALMOZ,MFDCODGFZBCB..aADFJGEA..QGAHREAHHDGH.SCGEhAAA..fAHEhAAAFCAGECEHdGDBBABGhACAKFBCACDHIAFE..PAFGDGCFNIDH.WFFBhABA.....hADA...,2,-33,-13,20
eYQRHIafLXPEUdBDgOTKSFMbVACGWNJcZ,CGHGGBAG.JBHDeAEG.QBDGRAFFHFEDaDDELEEC.hAAAEDADBACEDABCOCCHhAAAKAEFSFADMIBEAGFA.hAGANIAD.ZGCC..IGHFPBHD....hABA......hAFA...,1,-10,-25,15
MIdVOXPafHCBbQFSLeRUKDcTEAZgWNGYJ,ZEFB..gEEDGDAFJABEdHDH.OBCGXGCB..aAGEhAAAHBDACECFBCGAFBGALDFEhAAAeDABREGBKBAGDIFAECDAhABAAFFD....WFAHMFAB.....hABA......hAFA...,2,-21,-11,10
BAREfPVTSIHCXZFKYcJNLWgQbeDUMdaGO,ECBFVBCA..SGCHCDFD.ZAECKAGGJFGBLFFD.QFAChAAAeDDDMEIFGDAFhABAACEFfCFAhAAATGCBIHHFXFAHFABBNACD.WFFFDEIH..hADA.aAGABGGF..hAIA...,1,-6,-19,13
IgGKfQVeLFbCYNdJEZUXMWOcPSDBAaRTH,RDBCTGFDHGCCGEFA.KEADfBAE.eAGFFBDAYAAFhABANFDDdCDAZFBCMAAGhAEAOCGFSGADhAFABAHBACCGaEDEICHH..QGAEhACAbBBB.CHHE.....hADA...,2,-10,3,13
EPMVbNCKdQYLWfZJTOcUDeRSGFBAHgaXI,HEBDXDCFEGEGMFEE..VEGBCCDDdAGFLFBHZABA.TAFGhAAAODEEDADDeFADSEEChABABHHBACAEIDAFhAAANIDFKCAC..YEAFfHDD..hACAcFDE...hADA...,2,-19,-12,7
dafMZQJYbOEDGgBcTWCNSHUKLRXAIePVF,eDHFFEEHdHGHMBBFZAAF...QBFCJCGF.OFCCDDDFBBHChACATACC..CHAEHADGhADAKHBAXEAC.hAEAIEFGaECH.fGHCEFHH.cCCChAAA.SHDEhABA.,1,-26,-38,12
DACRKVcMLHbJBQTOgNIYESaUPFWXefGZd,KEEGVCEFLEBF.HBBCJCACBHEAQGDH.OAAAhAEANFAD.ICFHEGCFUGGAhAAAPAHF.XGGDhAFAfAEB.GAGCDEDFAGGFCAFHRABGcGAGhABAMEIH.....hAHA...,1,-9,-19,10
BDZOAQLfbFCJdWeUMPREVcXHYIKNaTGSg,QDABLAEFFGDAdCHG.UACFMDAHEGAE..VABFHFFGKFFCaEDFhAAA..SHGChAAABCFFDABHAAFCCHAB.eHBARBFDXDDGhABAIAHHNCIC......gFBDhADA...hADA.fDFC.,1,-8,-10,2
QFIKCYRGXBcgUVHaJdOENDMPLZbTWAefS,SCAEFGADKDBB.CAGC.RFCEBDHC..UDDAHADBaHDCdAAFOCHFhAAADBBHLFHDZEAD.hABA.TADEAEFE.fHFDhACAIAFDXAGHcFGF...hADA......hAFA...,1,-30,-34,4
TYHZgUCPQMdSeGXNFabKJfRcWBODVLIEA,HCBDUFDEQBEGSABFeFHDGABEFAGHaHAGKFEF.RACEBFAGhAAADGGELBGBAFIH.ZDAFhAAACDFAMBIHNAEF.JFCD.hABA...WHFAOHEC.IHABhAEA......hAFA...,2,-14,-9,5
EfAPVCTOaWFIRSXMKNbJUGDYegBQcLHZd,CFGCOBFHFEBH.RFAA...SBDGMIECKADE...JAABDCCG.eFHBhAAABHCDLEDGhABAdDFBAHIH.VCADaAGB...hAAAIAHAXEDHNHDB...bGEA...hACAYFAF..hACA...,2,-46,-15,31
aTCgDLFQdGPBbRZYISKOAVcXNeMWUEJfH,XDBCMEDDUCFB..JGAEHBAC.CDBGLFHFdCCBBGHHREEFZDDF.hAAA.SAFGhABAOAEAAFBG...NBICEACEfGFChAAA.aHBCDCFG.FDFA....hAEA......hAGA...,2,-29,-19,10
IJSNFEcPZWOXMDRVQeCYfdGALUHabgBKT,HBBBaDDGBBBCKAHDJFAF..SBDCFDHD.EAGAZFDH.OADEhAAADEHDREAE..eHCACDAGdGGGhABAAGIBUEEA.TGAFhAAAIGCD..NCED.PDEGMADA...hABA......hACA...,2,-27,-20,7
AVFNHdebMPCDTOBUWYXgLcRSaGZfIJEKQ,FCGHdEBDMGDCCECF.DEHFOABF..UAEG..XADHhAAALHDCSHAAhABAGABAIHBFJFGD.KEEEhAAAAFFFNGAHeAHB....PAHFBCGHWDADhABA..cDDDhADA.aAFG.,2,-43,-20,23
URDYgKCbGEMLVeZfdWTFOXNPSJBQIAacH,aBBGUDBH.RFEG.DCDAKFCDGFBH.LFAFZAFFdAHGFAEHODEA.hAAA..XFFBhAAASACHBBHCAEHH.HDAChABACBAE.MEIBeFHHfHEB.NACF..hABA......hACA...,1,-5,-36,31
eVgcbFCSLXNZJBfHDKUPRQMOEdWaGYATI,TECAeEAH..VADE..bFGBFCCFCGCDLAFHZFFBBABCDCIDKAEDRCBChAAA..OGCGEAHHaHEChABAAHCB....IHHHhAAASHAG.NCAAfFFGHCEG.hADA......hAGA...,1,-3,-29,26
JKHgABCEcbOeTZSGfDQILNRMdUYFPWXVa,CDGFEEFH..OFDEeDBCSGACDDID.LHDCRAADMHBAUAFGhAAAFADHXBAC.hACAJAECHDBBAIACBFCETDDHhADAfCHAIHFENEIA.dEAG....hAEA......hAIA...,2,-24,-12,12
AJSOgWXFGEaQPBDHLKdfCcMRTYVNbZIeU,OEECXCFEFDAFGFCD..aGBFBCBCDDGALEDDKDAFCABCMEDEhAAARACG....TAGGhAAANCIAZGAA.UGEC.ABAD.hABASGHDECEA.QACEdGHAYCCDhACAIHFDeFAD.WBFChAFA.fEBA,1,-9,-16,7
GWdBFALKQTYRUNIDXgeJcHVaObMZCSEPf,KGAFQDECRDBH.UGCADEGAeFFGHBBFaGFH..OACFZAGFCBADEFADhAAAGAED.BCHHhAAAADAHTGGF.IEHAhABAgFCH.JHFAcBEFMABD.fECHhACA...hACA...,2,-32,1,33
AIUPOVgSecDJGBQYaMKTfdFCENbHRLZWX,UABGOAFD..SAFEeFBBDEBEBHFHQCDA.aEFDKEFHhAAA.TBBCdHCBFDBCEAHFhABA.HEDFLFHDhAAAXADFAGDAICGG..PFHHcEAChAEA......hAIA...,2,-27,-17,10
YLRSPHeWZOEQXBCTdAcFGVaMIfDJgUKNb,GBEFMFHFDCDBJEDC..KACG....NHEFLFAGREAESGAGhAAAHBAGZAEFEEGEBDHDCHAAdABBhAAAACEHFBAD..aHDC.hABA.IGECfAEF..gEEEhACA....hAGA...,1,-10,-37,27
aEODWNCgGLBJQbSMYTeIRAKUcZHFXVfPd,UBCAZEFGFDDG..XFGH..fCAAaDGB.DFCANECA.hAAACHGC.LDAHBAHCQABBhAAAMFFD.TGCBhACAIBHD.KFDBHAFFdAEEEBAGOEAFhAEA......hAFA...,1,-19,-29,10
FTAdKMVZUDGNcfeCQPWOYXJSgHbEBRLIa,KGBAVAAHZBAH.DBGAGGCH.....fECCCDGDQCCBhAAAOADDJEFHHACEhABABEFBIGACFFHF.hACAAFFFMCIBNIAF.cGGAeCFE...WAFFhAAASEADEDBC.aFDFhAEA...,2,-26,-16,10
IHMDfRYZcKXbVBECLgSadPJOTNWFUGAQe,eFDGMBBCDCDFRCBBZAFE..KFFD..XACBBCAHLGAC.hAAAaCHHJHEA.NBAAUDGDhABAACFFHAFA...fEFDhAAAcGAH.EGHFSBED..hAFAOHACFGCF.IEAEhABA.,1,-9,-40,31
aHdbfeRXWJAKCDLTUQcSZEPNIVgBGMFYO,DDAALEAGUGFB.QBCBZEEE.ECHH..ICFHBCAAGEEGhAAAFAAE.aGAEdAHCfAGAhABAeEACRFAC.WEHHhACAKBCHCAEG..SGDD..NEIEMIBEhAAA....hADA...,2,-29,-10,19
dVbPGUJXYWBFcSHDKOCEfTgINZaReMLAQ,QFFCVCDE.GDCAJEAH...XBABBAHDFABBSBEEhAAADCHDKHGE.CHDAfAGDhABA.ICHChACAaGEBMCCDAHHDdEAA..PFFA.hADA.WCCEOADAEEGE.hAEA..gGBH,1,-18,-38,20
AJbWUdCYRDQXFHTOgMZVfIENLcaSPBeGK,JDFGUCBE.dGCBCAHB.DFGB..FAAEHAGB.OAAAMDBDZADF..hAAAVADCEEEB..LCCBhAFAaGAFBFHHGGBDhAGAAFEE....WDFAQGGC..hBDA.XEGA.hAGA...,1,-17,-37,20
AZabMfdTEeRCBKYULDQWJGNXPScIFVgOH,aEFAMECH.dEEHeAAFBGGBKHCELBHB.DGDDJFGH.GEBDhAAA.XBCBSCBChAAAICGEgAEDhABAABIHZAEB.fHADEHAGCDAA.YDAFhACA.WDDC..NEIA.hACA..FHFC,1,-18,-19,1
DNVMdecBFOEHbLaPfTYgZJIKGUASQWRCX,QGABCDEEDHBC.MEFHdDBHBDGA.FGGFHBCF.aBGC.TEABhAAAZEAAJBAEKBAD.UDGEhABAABIB.SHGChACA.WAECXEEGNEEG.eAGH.OADGhAAA....hABA...,1,2,-49,51
UHVZSGTYOFeQKJdLCBbfcWgNAaMDEPRIX,MEFGDEDFRBDF.UBFFZAAAGCGC..OFADFEAF.KGGDLHAGhABABGDG...bFFDfDAChAAA..hABAWFEFACDD..PABFIAGAHEDA.SFHBhADA.eADChAHAdCABCHHENECE,2,-32,-25,7
fGLDEYQMIcVaPgFJCSbZeKATRWHXBOUNd,TEAEHEAFXCFF.BAHANGDD.dGFFGBAFECHH.MFECVCBEhAAAaFHDFACE..SHDGhAAAbEFE.KGADAABFOFDDhACAfCGFDAFG.IDEF.PAEAhABA.CHBH...hACA.eHEE.,1,-1,-2,1
JGBMgEQdIFKfADSVTWHRCUXPLZeaYbNOc,DECFTAGHHBBC.CGGE.UCAELGBGZDEGeFCB..aDFB..bFGHhAAANBEB...OCDChABA.JFFDMEIB.gDAFhAAAEGABdADD.IHFH.KABEABBC.hACASDGH.hAEAWHAG.,2,-39,-2,37
BKATdMgQGOEHSYfaUVNbXZDCcRLIJPeFW,MFDDGEEAHFEGSHACaCAG.UBBAVAFH..XADHhAAACABGREAFLHFGIFAE.hAAAPDHHeDBEFCHDBCGFhABAAIAC...dFDG........hACA......hADA...,1,-8,-20,12
WgFPAJMOdKIGZfXRbScCTEeNLUDVBHQaY,MFDHKDDFZFFBRAEE...SBAHCACE..ECDFeAEGUFEBBCGBhAAAaFHH.....gACDhABAAIEAJBAAdGAF.fHAHhAGAXCFG.TCEHDIAG....hAHA......hAIA...,1,-31,-38,7
TYXBSCRZLfFVdPDWNHOGcMQUIgAKaeEbJ,eEGBEAAC..JBCATABGBHFC...RBFELBEDFDAFdDFE.DGAFHGBEhAAAOEACMEIFQFDEhAAAUEDCAAIH.aHBGXCCChADACDCE.ZAGFPBAH.NIDF...hABA......hADA...,1,-13,-17,4
NJCQOXGUdbBgWfEPHIMacVTRSeAKZFYLD,FGDGLAGBDCCH.CAAB.OADDGDBD.UFACBHHD....gEGAhACAfEFBEHEChADAHAFE.aCFETFDGhAEAeAACAGIFKCDEZFAF......NBCD..hAAA......hAFA...,2,-34,-14,20
fLOGgRFUDABZVYTSJEKCQdXMabWNIHPce,BFBFVFFG.SGFD.KDCBdAGH.aGCC....NAAGHAFChABAPCDBeFDCLCFAhAAAOEHBGBAGRBDBDCBHAAFChACAYHAAEGCD.XACE.MEFGhABA......hACA...,1,-17,-20,3
RPDTQaYdgGSOeLVUIXKfcbFNWMZEAJBHC,BADCHBDBCABGRDCGDHDG..aAGAdFDHGEAB.eGCCLBHBUFFEKBGGhAAA..fCDDhAAAFDAGMACAAIFAJEBF.TBADhABA...gAFDSEHBIGGDhACA...hBAA...,2,-29,-18,11
ETZQeYFLVMKaIHSRfBCAbGJNgUODPcXdW,JFCCUABH.DAGD..XAAGdDFB..TEFCQCGE.hAAAFCCCLEAFKFAAaCADHADEhABAREBGBHCF.AIFA.NHAB.hACA.OFHDPFHFEEEEZBDDeAFEMBIDIHFFhADASCAA..hACA...,1,0,-27,27
JKSfTCgZRPbOBALNMEeFDYUWQGXdHcVaI,MCBEeDFFFGCCDAFF.UACCGDDA.HEBFaDDH.KEAD...SAAFhACACGADRAED.PHFEhADABHHENICH..WDHFhAEAdAAA....IFHCfAHAZBGFABIHEHAGhAGA......hAHA...,1,-22,-26,4
MXIaZJbcFRLOTgNDdPWAYKGVBHeCEfQUS,KCDBVBBAeADG..EAFAUGFF..SGCCXBFAZFDBJHEGFAABhACARCAB..LDFGhAAATDEG.DBBAdDHEAAFCBHAChABACEAAMGFC...IBHF...hACA......hAHA...,2,-25,-21,4
SXBTfgGIJVbcAHKdZOERPDFCWYNaMUQeL,HFFAKAHHOGAEEDEGDAHF.FAFDCFAD.......NCAD.MFEFUEBDhAAAeFFELHFA.hAAABDBETCEG.fABGhACAIDHBJABCcADEAAID.RDAA...hADAWEADaGGHSDGAhAEA.,1,-19,-35,16
XOVHCTdGQcYKPEBLIAFUWeJgRSDbaNZfM,UCGCJACG.RCAE.DGAH..aACEZFBA..MDFBODFE.HBECTGFGhAAAdDCEGAAA.hABAQFFFKGBHPAFChACABHBGAFIH..FEDFWFHHSGDD.hAAAfFAA.hACA...,1,-21,-25,4
FHgMWVdRYLBNCXATcaKbfOQGSZJUeIPED,TEFDaAFG..KEABOCAHQGGDGGBHZDFBUABE.eFCEhAAAEBHBFFDBMDBGdBCDLBFChAEACDECADAC..fAAEhABAIGHDDECC.gCGD.hACA.WFCD...hAFA...,1,-11,-24,13
ZLeMgESdVGJcRUXbCHaDYBNTfQFAKWIOP,KDHDOCAGZADGLDAD..MGECEGGDdGEGGCEH.cFAChAAARECFUCCH..bGFAaBHFhAAABBFC..fABAhABAAECBPABGgECHJHAACFHH.DICCYCFHhADA...hAFA...,1,-10,-28,18
GMSgUaQfCYKNLdTAZWREcJDPBHXbFIVeO,RCDFEEAHDGBFBFFDHABBFAED..eFGDGDCBSGCFUDGC.aDADCBGEKACFhAAA..dAGHAHAHZGCAhABAJFED....PDFEhAAA..IGHDMFIBfADHhABA......hADA...,1,-17,-33,16
SZYPEBXCGIVTMdUeQAfJHFbKcWDOaNLgR,HEEGKDDCDBAGOBBFLFCCSHAGZADG.ECFFCCAFGEGA.hAAA.IBEDMIBEeDAFhAAAAHHDFAFA.bDADaAHDNBAG.hABARGDGBHAC.........hACA......hADA...,1,-18,-19,1
LXAYIHBVNCPRTGeQOSWcJaDUgFEMZKdfb,HFCBVAGB.CFBHREGHGBBA..QDEDSAEDJBFGUFDGECABZABEhAAAKGHBdGAD.fDGEhAAAXCCGAFAH.IHAHhABABDEDNIDD.eFFDWBAFDCIF....hACA......hADA...,1,-8,-12,4
ALTIEfcOXNYSQPMKBeCVUgJWdGDRFaHZb,TEFBEFGA..OBFF..XAAHSGADMAFGBACEhAAACBHFUFBHJEAEdHDDDCDEaDDAhAAAZBBEACHGLHEG.hABAfDABNAEDQEDD..KCHB.eEEDhACA.....hBAA...,1,-7,-29,22
caDTSLdbBMWeOYgUFRAPXICEHJZNQKfGV,XFCHCEEDHCCHZAFHKGAFGCAE..aEEDDAAALCBDBGFGMCIDhADAeCGF.OAFBUGGCAAIFhAEAEACG.QGGChAAA.fCDEcFCHSHAAhAHAWBAF......hBAA...,1,-7,-25,18
LVWcDeTCGRHAOdfSbFXKIEZPYMQgNaUBJ,dADESDFDFABHKBHD.ZFCC..MDFHQGGB.aCEABEHDhAAALABCVFAADIAGCEHBRGAEABIHhAAA.OBCF.fCBEhAFAIHHBPDDD..YAGHhAIAgCAG..hACA...,2,-49,-3,46
GICWRSTJfaMEUBeZDAKcXLYHQVbONFPgd,XFDHHEAAVBAG..OAEHFGDCdEFCCEEE.RAEE...JFAGaGHBUGGDhAAABHAGZDAEACHD..KDDELBHDhABA.QBBBhACANAAF.PHAC.....hAGA......hAHA...,1,-14,-26,12
gTGPQFDORCUHJfMeAabdELNcXBIWZSKYV,aBGDdBEGEGBFLBAB..XBGABGEFZEAEKABG..VGACTGFHhAAAQGGDFEAADGDFOEHDhABAUADGJEECMDAAhADAAAID....NACG.cEFG.SEEFhAEA....hAFA...,1,-16,-24,8
BOSDNCMdHPVKJZLGEeFIUYQcRAfbWgXTa,...bAFAXEDC.aEACOFDD.DEAEMFHHdGHEPAABhABAJBCAZAADEGBD.IHEHhAAAUCFEQGAAhACA.AFAAfDCDgAGCBCCDSHFChADACGFBKCGA.eCCE.hADAYFFE.,2,-14,-2,12
IUaSLBTdEHQFMOKVDbcWPGYRCgfZXNJeA,aHEGLCEEBEGF.TDAFHEBHFADG.KBGFVAAG..DCBCbEEC.hAAA....WHAAhAAAPCDF.RFGBCABCfAHEhADA.NEIGACDFSHAGdHEFQFAFhAEAcAGA....hAIA...,2,-40,0,40
PVYQDBXgdUZWRHCGKcaAfLeIbMJOFSNET,eDCGMBFHFCHBEHEA....TBDHVEBDDACBBBGD.dEGFZGFEHFBDhAAACBAD.KBAAAHAB.LEAFhABA.IHHHhACAJADFSEGD..NADB.PEEBQFDGhAIAXAFB...hBAA..WHBG,1,-2,-34,32
MHYODJKNZLaRVegcXBCdQUEfGTAbFIWSP,FBBCSHAAMDEFHDAEDGHH..KHEAZFFBLCEERCFC..eGCGhAAAXDCCCGBDQAFChABAUBBBEFDHTADH.hAAAAHHH.WDFF.OADAaAHF.....hACA......hADA...,1,-8,-27,19
gPdRcFATEYUBeCSQbDXWfJIZaVKNGOLHM,TEACUDEABFCE..eEEDSACAQAAEDBAH.XDGAhAAA.fAHAhADAJHDEIHBBVADHGCGGhAAAOHFCMAFCPHAGRDAHABBH.CDFF...WCDChABAKFFC......hACA...,1,13,-37,50
GNKVDgYZLJPaXIRMcHfBbAUdWOQeCSTEF,dFBHOFEHCDEH..EHDAFAAG.KEBFDDCBZGACLFFB..JDBCaCHHhAAARADDHDFD.BBCDhADAAHABQABE.hAFAeAFCSGHB.NBIG.YBAFhABA.IHHFfHFHhAGA..,2,-39,-23,16
HafJKcLPWRMVDFEXOIZbCTeBQGUdYASgN,SCEGHEEFaCBHKECHLABB.REFGDAFBEHCCXAFCZGAC.hAAACCHBBAAFQEBAhADAdGAGAGCF.fHEBhAEAJACD.cGGHMDDG.OBGFIHHF..hACA......hAEA...,1,-9,-25,16
JFEUIAZOMWcKaDGVNHXBYdQCeSTbfRgPL,MCHHKBGBGBBBHCACBHHHdEFH.CBFC.eEBG.SGEATFEHRFACLAEEhAAAEFAB.IABAhADAAEIB..OAEAhAAAaEHDDDEBNIDDXCAC....hABA......hACA...,1,-16,-25,9
FRaXdTKQcNZBIgVODLfbYGSJWUeECPAHM,HCDDFADGRCDD.dHFHKAFGQDBD.ZAGBBHFC.VBAHLAAEhAEA.fGCAhAFA.GFEFSCFBhAAA.WFGB.ECHBADIFXBBGhAGA..NHAFOFDEhABADGBH...,1,4,-45,49
gCKHZeAJGEQFVcNXaDLITMRdOUbYBWPfS,JEGFQAEA.FHGGVBBG..NECD.DEACLBAD.MGFAhAAAdHCFOFAC.hABA.YCHDBAFGfDEEhAAACBDGKHACHFDBAABBECFAaCCC...IHAChACA....hADA...,2,-50,-7,43
fSJBUZPbWKAGQeNTYILOMCaEVdHgFRDcX,QFDFeADE..TCAEIABDOBBACAFA.EEDGHBCHFGDHRCFHhAAADEAB.XEFBhAAA.fHABhADASCHHBGHGPFHFWCHHKECDACFH....YHDGhAEAaHAG...hABAgBGF.,2,-10,-9,1
ZFdUYGgHcbBaeVCJXOKPATSLEQMDfWRIN,TEDDSBFE.EACADBGC.RBACZADHFCAHdDGGUFGFGEEE.HGAAhAAABCGCaCCBeFBHCHGAOEBEhABAAFBBMIDE...hACAfAAFWEHB.IDHH..hAAA......hAFA...,2,-31,-4,27
QgRBHJWOdfUEcSMLCFTNIbAXDaePGYZVK,DEFAaFBCGBEFZEAFKCCF.RBCB.HADA..OEGFUFGC.EAEAMFCECAHE.hAAAFAAC..TFEGhABA.ICABAFADXGDHhACAeHBA..YAHD....hADA......hAFA...,2,-33,-11,22
dYGcAgeLMPWaEVRZDKTUNfSbXBOCQJHIF,LDDBMBEH.aABDRBFADFDB.KABFUAFH.SCGABFGBCGBDHCAChAAAFGAEdBACGGEDAGGAeHFGhAAAEEAH.ZDFC.TDBGhABANIBH......fAEBhACA...ODEDhADA...,1,-12,-25,13
RBLfFJaOHVSACUGcdXDQZENTWIbeYMKgP,UGCAdDEGQAGDZACE.EEGGTGEG..IBDFeCFFKDADhAAARBABBFBCFECE.OGDChAAA.SAFFhABAAAGECAHHXGGHNIEF..YGFCMCHDLABFhADA..fCHGhACA.,1,-18,-24,6
LBFYZcAJHQWdNGKMODEeRXfgTbCVUSaIP,JHACQDBF.dGFHKBEDMBIHDDFFRDBH..XBFA.TACAhAAACGEEUABH..IGDBhABABDHEFGHBcDFHhACAHAFE...WFAHOCABeAFC.fBBGhAEA...hAAA...,2,-46,-4,42
GOXFQNBTZKHPIbeCWcRMEAYdSLDUVJgaf,dBDGDECDUBCDJABB....aEGBOEFH.FDFABCFFZEAHHAFGhAAA..IFAHhAAACABF.RGAAAGHDSGHDhADALFED...gGCHXDAENADBKDDD.hABA.eHFG.MAIDhBAA...,2,-33,-27,6
KHGDTWFIXPSROcgZbeQLNYECaMVfUdBJA,KEDHDDCFFBHD..XCAERFEG..OBEAZAEAQGGEhAAALEHBEHACMFCB.fFFFhABAUABGBHFDAFAC.TDDHhAAAIDGE.SABAbFAA.NAIGCGAAhACA.dDDB....hAFA...,1,-23,-24,1
PaRgWUHJOLBcfYESXeANFGKMZbDdIQTCV,FGDHKEGBMACADBBC..dBEHQEBB.CGGG.VCCD.RFEBUGGGhAAAOBCA.BHCC.hABAfCCCEBHDeFABACADhACAZEED.IAHH.aDGAWEFEJAAF..hADA...cEAAhAEASBGG.,2,-22,-22,0
IUcTPWBFgaDSVGAQdbEXfKMJYHLNZORCe,QCGGdCACEECD.KGBDJCBGHBADZBFB.CCFDUDCE..TFFAhAAABAHFaGFGSHEGhABA.AGAC.fADDhAAAMDIDLHAANEIG.ODEH.IHHGhACAcABA...WAFFhADADFFG...,1,-19,-24,5
bJAdRFKOfNLSGCWXHYBIagMPVcEQeTDUZ,FEHDOBFBLCABGFAFCDDE.HBAFBFCBaGDE..MBHH..cCCEhAAAEGEC..TGBAhAAAZFFHAEIHKHAA.NABDSAHBhAGAXAEBgABD...hBAA......hBCA...,2,-33,-11,22
LBZOURDgPGQbMdEYSHKCINWFJfaATcXeV,TGDCXBFB.LDEGOCHB..RACGDBABGBBA.MFGHEDEHSGFHhAAACGAG.hAAAIHACWFCH.FFCBhABAfFHEaEAHAICEeBBBBBAD...gADFhABA..hACA...,1,-12,-33,21
GSTPUBJZceOWIDNRYKHFCgXMbVfaQLdAE,SGEBUEEAZEAE.eCAAOCGF.DHGENEIE...KBCHFBFG.CCHE.hAAAMIDA..fDFAhABAaGBE.dEBAAAAFTBEAhABABHGDJACG.IHDF.YDDDhACAgCAB..hACA..XGAC,1,-16,-45,29
CSGbHBTKaLXYJIcfVWPZdROeMQFADNgUE,DHAAUEBCEEAEGEEB.BHAEaACFLGEC..XBBFhAAAIBGEfAGDhABA.VBDHWCEHPHDAhACAdAACeBDH.MGACAICGCEADSCHFhADA.....hAEA...,2,-37,-11,26
VLIXefJdMTSOBPWDKRNQCHEAUYgZabcGF,UDBEZFAFaCBBGAAH.FAEALDCB.eAEEJGCCMGFCSDHHhAAABHAF.DGEGKHFARABEQCFFhABAHDEEAIDA.hAAAbGFAICHD....fEEDhADAODAB.WHEGCHHB.hABA...,2,-26,0,26
WbAQFXPHVGYZCLSdNEMceDfJaOIUBKRTg,QECHXCGFHEACGGEDZDEDLAABdCBCEADB.MAEADFGAJEAHhAAAaGGE..OBEGBCDG.hABAKCCC.....hACA............hAEA......hAFA...,2,-34,-16,18
aULSZKfdOgDETRcIHXMeBAJQbWFGPYVCN,JAGBQAGA.FHFGGFEF.VDBFNAFGLABGZAAB..hAAAKCHHdFFHDAEEEGDBRACH.IGAEhACA.XECEhADA.MCGHAFEAWHEACDDFaCCB....hAGA......hBAA...,2,-38,-13,25
IGSBFcfEbQCUYKPHMgXLNDeAZRTaOVdWJ,ZEBARBFHOACCdFHG..JABGGCCABBHH.FBBH..EDGACFGA..UFADhAAAKCEGHGAC.MFGDhAAALFEH.NAIEAHIBaBAHhABA.....WEEBSHBA.hAFA.fAGAhAGA...,2,-36,-25,11
NcDfVAMSWgHQFKZTbdaEIPXJeGLCYROBU,SABFHBCCFGEDKGCEZFAGdABB..aCCCEHAC..XFGEeAFBCDDG.hAAARBFCBAEDUGGFDAHDAEHHMEFBhAAA..QEAGhAEAIDAE.JEFELHDG....hADA.OAFGfCBEhAGA..,2,-24,-8,16
OLdAScKUDfIPbeYEZJVgRBMWCaGFTNHXQ,SGGCKHGGUAAC.DGDB....PCFDeDEHECAB.JCCDVECAhADARCGD..BGAGCBDAGGABhAEATAFAHAFCOAEHhAAAADBA..IFHD.....hABA......hACA...,2,-31,-22,9
EUQdCafAHWSPYZgVbBcTeOKNRGXFMILJD,SAAEZDGD..VAEDBEFHeBACKEAHRACHFGECLDHBDCDFUGAFhAAAdHFH.CCGC.AHHAHEAAhABA..PFCF.hACA..bEDB.OAEANIED.....hADA......hAEA...,1,-23,-24,1
VZHCOXJPILKRFfQaNYAebESdGcDTWMBgU,EEGFSEAAdGHGGABCDGDH...MAIDBEDFUBDAVFEB.ZBAEODABhAAA.JEEFPBEAhAAAKHAERFCD.FABG.aHGEABABeBGHhABA..cGAD...WAHHhAEA..CBFA....hAFA...,1,-4,-37,33
JKfZdFPUYEGNSBaCbQXDRITMHcOgVLeWA,JFHHKEEHdAFB.FAACUBGE.GABGBEBD..CADC.QEDFhAAA.RFAC.ICGHhACAMAEBOHAELDCHeBADhABAAHGFZGBEEGFB..SAFCaFHD..DCCChAIA......hBEA...,1,-6,-45,39
XVJLbIAKGScONHeDUTPMWfBEYgRZadCQF,SCCCOEAGHGFGDIBAUBAE..TEFEMDGDBHCC.EFBAhAAAgEAFZAGH.hABAdAHGCFEDQACGhAEAFAEAJAADIFCFAHEFKAFD.NHDBeDECfDDD.hAAA.....aHGEhACA...,2,-24,-6,18
aBVHNOARIXCbFefcWgDQTKSEYZPLGUdMJ,XECACBEBFEGE..eDEA..fAAF..WCAEhAAADCDHKBGA.SFHBhAAAZFAELHCCGGDHhADAMAIHBAHB.NBFAOGAAIGGC.cDAGhABA.....hAEA...,1,-29,-39,10
MXdTaRcSIYeWDFGLNZPQJbCEgKOAHVfUB,VBECUAAHBEHF.dFBAREBB..SBBEeFEEDFAB.FGHBLADFhABAZDDA..JHDECBGHKGEAhAFAAGAHMCID..aHDCIDAAhAAA..WBEH..NACB...hABA......hAHA...,1,-27,-39,12
PENWcZJQFKOLbdGfMRaCASTHBDVXUegIY,SFEATAFA.BBAHDADFUCAC.eFEDIEAA.EDEFhAAANDEBZFFFFHCGLAHFhABA.GCABMEIDaFAHhAAAAHFC.XDDCYGAE.WHEA..hACA..JFCH...hADA...,2,-26,-16,10
CPSbcHLeUEVDWKgaXBAYQFdIZNOfMRJGT,FAGEZEECODBARAAGGEEG..CEAE...SHGCHBGDeHAAVCADhAAADACEKGED..aGAGBGADhAAAAHEH.dGGD.fBAFhABAMACGTECA.PCHHcADE.ECFBhAGAWDDE....hAGA...,2,-23,-15,8
JQWFBDXcdLITgGefYNRVEaZHKMCPOUASb,JFCEQBAHBCCC.DHBGdEADLEAC..IBEGTEFHeBFHhAAA..fHCDhAAANGAFRBDFEGHD.aEHHKAHHhABA.PHDCAIHE..WABC...FAHDhAFA.gDEEhAGA...,2,-54,0,54
cBSWZGLPMDaRbHCXUefJFVQIAgTKNEYdO,KCGCEFFCdDEHOEFFBGHCZABFLCAH.DDDDREAHCDEA...UADGhAAAJHACFAAC..IHEGhAGAACCA..gAGGhACA.TADGYAFG.WFGHhBAAPHDA..aGDB.hADA...,1,-36,-38,2
NAVdJcSYaFeQRfCOUHZDELgPGXBKTWbMI,VAFFdGBCSBBC.FDEFRDCGOEGH.UABEDIDGLDGHhAAAGEAEBCHHKAFATECAhABAMIFCABDA..JFDHaADDhACA.QDAFCAAG.ZGFA....hADA......hAFA...,2,-25,-19,6
USRYGCXLQfKPVNMZgHeDcJOTAEFbdIWBa,EGCGdDEHBHBCUBBE.RCAEGEBHLCEF.KADC..VAEHMBIFZAACeBGBhAAA..JHFGTGFBhABAAHDB.FHAG.IDFAhACAaFGECGAF.....fFGDhAGANAIEDACE......hAHA...,1,-21,-23,2
LgNAHFSIPRXCJbKVaWGfeDdZcBUMOYQTE,SFAARFDDCGBC.KFDAaHGEGBED.DDBAdCACBFHEUDFBMHEAhAAAOAHD..TDEGhABAEBDALAACADHB.hACAFGGGIEAH.PADGJCCF..bAFFhAEAWHAGfHBFhBBA...,1,-24,-25,1
IBdGUbQgHYeLfPVXFNJcZMOaESKRCADTW,TDFDBHFAdCDE.UFCAQGBBHBGFLBAFVBAG..XADAhAAAFFHB..NAAFZFAFhAFAaECGSGGAhABA.KAGHCCBEAGFCDIFE.IEAD.gFDBhACAYBDC...hAGA...,1,-5,-31,26
BXdbWQSOFeNGRICDPcTALgHEKYMJUVafZ,HBFCKAFFMGDEJAADUEDC..VCBGZDABBHAD..XABChAAAdFFE.QCFHhACAOECBFCCAeFHH.NHABIHFAhADADAEA..PDHFAIDCEEBBaFFA.hAAAfAGB.hACASEADCHGH,2,-29,-3,26
HcPOELdeIBTMFXNGJRZWaUSQAfbYgCDVK,...fAEGbDBBCHEH.DBGBKAABHFEAOFEGdBBDBFAF.MIEEhAAANDEB.JHAEZADAaDEBQGAChAAA.AEHG.hACAgCAG.PAHDEAHHIEADhAEAFEHF.XGGAhAFA.WFCHSECH,2,-16,-4,12
UTYVbZBOMEPDSRXQWLKIGCAJgHefdacNF,HGBAeDFHdADBaBBGFDDHUGBE....TFEEVCBCBAGC..hAAAOAEFEGGB.DIECSHDEhABARAGBQDAAhAAALBHBIGHGABBEfBEG.NCAC.hACA......hAIA...,1,-14,-24,10
QFXOaDbeKCBWYEVGLJINTSRMPAdZfHcgU,ZCAHHEFDUEGEQBBAFDDC.aGAADBBAeAECBAFBEFCG..LFFFhAAAIHHE.SDEChAAARFCHAHHD.dHBD.hABAfHEBXAGHKAEDCBFHWCAD...hACAYAHB..hABA...,2,-36,-9,27
QaOLMASbUXIKGTeBFVYcCfEDPHdRJNgWZ,SGHFXFBHKABHeDFF.BBHAFGFA...VBDBCDGHDIEEdEAHRDAC.hAAA..JGBC..gADChABAQCAFaAGFhADAMIAC.AAHHIHFCGDDC.TAAChAAA.fEGAhACA...,1,-25,-26,1
gZBTPRNdCIXUbFGAWELeYQSJMHfDOaKVc,EDHFeDEH.QGFAJEFHHEAA.ODCDKBCA...VAAAZDDDBFHHhAAARAFCdFAACHDFXGAGhABA.FAECWADBLDAChACASCHBDICCcCGG.....hAAA......hAFA...,1,-12,-18,6
THbONgLVXaJeREKcWPFBYZCUdMAQGSfDI,QGFHGDBBDGECHACGOCADLAGD.aHGAeCDE.KBBEhAAAPHCCBGAFYDDHhABACFAFMAIF.AFGEIHCFhACAbEFE..gBAEXCGFEAFA.hAAA.cFAD..hABA...,2,-19,-14,5
EVYBHZJWFfPUecXCNOAaGKDTRMdgSbLIQ,GDFCTEFF.dBAH.SEHBLFADICFBEBEE.BCCDhAAAJDAFFCDBUEDC..XGAAhAAANICFAABB.KHDGDCHFhACAMAIFgADCQFDH.YAGHhABAWBHBfFHAhADA...,1,-2,-36,34
TRaLWDFBfHYGIQPbEdZJSKNcMXVOUegAC,CBGATFFGLGEA.FDGFHCBA.GFAHQECCbACEZDFCSCCEhAAAKBHBMABEOHDChAAAUFAGAGFC.aHACBBBCIHHFhAGAEADCdAGB.NICB........hAHAXCAC..hABA...,2,-25,13,38
DZRWMdFEfHSgJNUVYLAbQTIaBCPGXOKce,TEDABEHBCGDFGABH..XADFKCCDDGAH.RCBFMAHF.FFGDhAAAEGECSBFHhABA.NCAC.YDFEhAAA.AEAB.IHEAaBEEPHFCcGAE..hACAWEDG..dBBFfCAGhABA,1,-22,-37,15
adHSeUKfYVZTJAGPbcMEILNRBFWQXCgDO,GDCH..cBAFMHFAEAGD.LCAHBEEGFGGGQADChAAACEBFDCFG.dFCAeHDEhAAAfABDZCFGADAAIHBBhABANCIEXGDD.aFFCSACB.hAFAKFAD.YAEDhAGA...,1,5,-42,47
QEPGgXLRdHOMeBfJcUIYAKNFWSabDTCZV,FEBGSDHDDCHBZADB.EAEBGFEH.LFDFHDDEMAGF.fHGBhAAAJAFD.cDABhABAIBCH.AEEEKAHHhAAAaFFCCCHB.QABDXCACdHADBECG.hABAYHBA..hADAWHFA.,2,-32,2,34
faZScHNVUYdCeAPGDJLEQKOBRXTgMbWIF,DAAEJBBELEHDKGECBBCC...RFAG...TGCFMEDC....hADAIGFHFAEEZCEESHGChAEAHAFFUDAF.dDCChAHAAAAAEHAE..XEFAWACE.aBHFNIDHCFDB.hAIA......hBAA...,2,-38,-16,22
ecUBSgRQaXGLWCATPIfOHYbNVFJKdZMDE,TEFF..IHBDOACDHBGD..YGCCVFCFKEBDhAAAZCABEAEEeAHBBCEHgDDFhAAAaGHHLABDhAGACGGGAIEE.fHADFAECMBAGDFFC.SCFHhABA....hACA...,1,2,-27,29
OFgQMHRfJcTaWSBUVAGPCbEeZNdLYKDXI,GEECCEGB.EGCHZBAEdAEBKGGEDHGGOEAH..QCGBhAAAMBIFREDB.fCCHhABA.TDAHaGCHSBEEhAAABBHFACAHeFBC..LCEAIBBChACA.FEHD....hADA...,1,-8,-36,28
OgZLFBHXTaPKfICVWGAQYRUJSNcbMdEeD,REGDUDEF..JCEBSDBH..NADF.MFFFdCGF.DBAFOCBFhAAALGAG.FGGHXECHhABAaAED.KHBACBCB.hAAA....WCAFABGAcCGA..EHDEhACA.eFFDBBBD..hABA...,1,-29,-40,11
gbOFJZXCSEPdfUTGKIcAYWeVRLNMHDaBQ,eDHBRFCCLHBGHFFDDCGGBDABQDDG.OFBBJCEACACHEAEAhAAAdCAGTABF.IAFAhAAAAHGDVCCBMAIDhABAaGDF...FFHH.SEAD..hACAfCED.hAEAKDCD..,1,-1,-30,29
CBMEPZJWAYfURKcaGDgHdXOVFbLNSIQeT,UFGFKGEAGBBHDDECHGCCdDED..OAHFFFBGLBBE..SAGDhAAAQAGGCDAFBFDChABAMEFEEDAGJEADAIHA.hAAAREGH.gCCD..XFBHhACANABD......hADA...,1,-10,-27,17
AROCSBHTWZYLdbIJGXFVPMDKfcEUgQeNa,ODHBBGCFHCBFZBAFdAEGJBDGGEFC.FAGAMIBC.DGFBKDHBEEFBhAAAQAAF.hABAaFDDABGCSAGEhACA.TFBEWDAFbFAHIEDB.PACDhBFA..cDDAhABA..,2,-34,-14,20
GZHMUadCbDKBVSFIYTPANQELWfReJOcXg,EAGGLEDERCEG.OAEB..gACCZGDEMCADUAGBCGHHKBADBEHEhAAAFABH..IHAEhAAATFBDAFFH.NEEG.fHGHhACA.JDBHcAFC.XGFDhABAaCHHDGDG....hACA...,2,-33,-15,18
YPKebdZGRCaSABTOVDcFELJUNXQgWMIHf,OCEEDBGHFBDBLDABUECA..QABAMHBGHEEE..fBDDhAAAKBBHdGGBZAEDRGFGCAFChABAAHADBBAC..TAGBhAEAEDGC.JEFCNIBB........hAIA......hBAA...,2,-24,-21,3
aSFcVJCZgBGITYDOePMXUNbAdKHREfLWQ,dFBERBEELGAGaCEA.FGFCJGFGZBAE..BFECGDDA..IBCAhAAADABEOAFA.MFIBhAAAXBGF..hABANIDFAAEDKFAF.ECAD.fDDH.WAEChACAcCGD..gDGAhADA,2,-33,-32,1
ZfaTcPgVASQDMFJeCIOdGUXHbYRWKLENB,DBEBFFBCCDDDOFFD.GDAHUGFEHAAD.RADHLFDBEFEFZAFFaCHDhAAA....TAGEhAAAPFBBACIB..SDHDhACAMFIBICAGXGAGWFDDBHHEgABGhACA...hADA...,1,-13,-25,12
ICUQdEfLYFVWcDKgMSAOaNTGBJbXPRHeZ,aABATGGDBCEH..JAFE..XGBEHEDCeABGCHEH.QCCChAAAEBBDLECGVFACDAGEhAAAKDACSEGHhAEAAICGODHD.NBGE...........hAFA......hBAA...,2,-37,-4,33
bQVMJOaPEXcAeCISNHfLUTZBDgWFRGKdY,CCADSEDFHEEBUDCBBHBC.DEGCFAEHKCBGdHAH...QCGHhAAAJFGB.OBAGhABAPACGEAGF.AFIFeHEAhACAfBAA.TBGEZFAA.RFDH....hADAGBEE...hAFA...,1,-6,-29,23
FRbDJgGHYdeIaTQcLNZOPKWMSCUEABfXV,BCEEXGGBRGAGDEFDGDBC.HBDAeHEAaHACQEBELBAD.hAAAZAABODECKACGMBIHhAAASGDG.CAFGACBGhABAFAFEJBHHdEGG.ICCE....hAEA......hAFA...,2,-26,0,26
fQRHXbcMZaVYPALCedGOIJEBTKFSDUWNg,CFEFdGDCGAADOCCE..JCFFEDBB.BHFGKFBC.FGBHDFIF..UADDhAAA....NAHA.QEFBhABAHGBC.XCGAhACAMDAHaGGB........hAAA......hABA...,2,-41,-30,11
eUDcLVWYSPRTGQFaJfMdOEIZAbXNHgBKC,XFCHHBFGBCACKAFBCGGHUCCG..LBBE.VFFGSEAFhAAARDDCGEACFGBGJAHFhAAAMFECdCAD.OABAhAFA.EGEFAHIFNABHDEGC.....WHAA.hAIA......hBAA...,1,-11,-26,15
ZBTJbdXDaHYRVKCcAPFfIWLSGUeEQNMgO,FAGD..fHABLBBFGDDGEGDFMFFEZCFCBDDGTFGFJBAAdEAAhAAAaADA.HADC.VCFGhABACDCBAAAE...IGGBhACAUGAE...NIEH.OHECDAIHKECF..hADA..WCAD..hACA...,2,-22,5,27
FcTOPVYRNdUbMCKfZWIBeAGJLHSQaDXgE,LBEBQFCAaBBCDCCB..EECFFFFAOEAF..VAEFRFFAdDABhAAAMAADKCHF.ZEAHIAHDhABAAAGCJHEE..SBCBhABAXGCE.....cCFDYACEhAGANCIACAHA.BHHF..hBAA...,2,-19,-17,2
IZPLYGJODWFgfHCdXQMAceENBTUaVRbSK,eBBFEHGCBBGBUFDCRGCC.KGHBZACC..LCFGGCFCDDADFFBBHAEGhAAAdECD.MEDAAGAF..TCCAhAAAaFGB..SHAAhABAIBAB.YADFOBHD..WFAHhABA....CAHE..hADA...,1,-9,-27,18
QGgeHAcPUZbBIYNDMTXfJRSCLKWdaEFVO,UDEEZDAABBAC..ICBEDFFHMFBH....XADEhAAAJAFDRCDD.CEHGKGBBdHCBFEGEOGEChABA..QGGFhAAA.eAHBAIGGcEAG.PAHBhACA.NDDC.SCBChABA..,2,-43,-25,18
RFXbeMWHBAZQfTgEdPDGIJLYaVSOCKUcN,QGDFTFCH.dCGBDBIB.GCEEJABDLFBEaAEC.SCEBhAAAOBDHCCBCKABE.hABAUFACNBEFFGGDeHEGMFIBhADABGHBAAGA..fDBH...hAAA......hAFA...,1,-17,-24,7
aQNGDMKCVWXFfAgcdUILTHEZROBJYePSb,dGECLBEDEGABZDBCBGFH.JFAEeCFD.SAAGaAHF.QADBhABADCCHMEIFCEGAXCGBhACA.AHHEgEAGhAEAIDAATFDB.HAFFODHDhAGAPAAC...NIDFKHBChAAAFCCC..,1,-8,-22,14
SgYZJIMfTdAQPUWDcOaRVbBGEXHeLFCKN,UFCCDBBHOBFFRBAGBHHFGEEC..EFADeCDHLDECKADG..hAAASGACZFFDMBIDdBEDhABAAHIFQDABhAAA.PDHDaDBE.XABFCFEH.NIAF..hACAYAFC.IHGHhBAA,2,-31,-8,23
LcCOIefYSPJTdZNGWEbDMVUAKgHFBaXRQ,KCCAHCBHFADAaGGF.RAEALFAHCCGE.eACCSGFF..hAAAPEFCJEFAZDBANEDE.GGABhABA..EFEDDHGAhACAMAABAAGB.BCHG.......hAHA......hAIA...,2,-42,-5,37
KeDNGPgRSJLCaOYZXdfWFTEBMHVcAbIUQ,UBGGeDAAGAFERFFCLFBGCBBD..OFFCZGAAdBCCFHFABHEHHECGAFFA.hAAAQFAH.hABANABF.SBEHhACA.aDABfDHEEEBEMEEG.cBDC.hADAKHAGDIAC....hAEA...,2,-21,1,22
UXGfCBRPYJcTbESQKgdWFDHMAVZOINLae,VCBHZCFGOAFE.LGCCeHCAUEFHGCAGBGHARAAE..JCDDTAGFhAAA..bFFBSDADhABA.KABGhADA.dGAHDFAFAIFGIFDFNEIC....hAEA.aDHFfHCHhAAA..,2,-25,-15,10
SUFDQaRPcbCEJLdXTAZVOYeMBWKgfIGNH,ZEDDOAFHeACEBFECKGHD.....fDDDNBDC.SBCFhAAAFDGCDHACRBAF...hAAAbDGDJFFDLECDhABAdBGF.XGFCABAFMAFA.ICAG..hACA......hADA...,1,-29,-35,6
UJTKfMPbRQDVLSABaNWYZGFOCeXHEdIgc,BCACaFDG.....NBEGZAFGFABECCFF.eGEAHCGDdAFB..IGEChAAA..gEGEhAAAUGAAKDAGMFDHhABAPBDDRABDDIFCLEADSHGEAIBC...hABA.WHDG...hADA..OCCH,2,-26,-22,4
ZgbIUVGMNXDfKHQPaWYOJATeCFBdRLSEc,CHAHdDEDLGCAECHBZFDA.....IBAGVDABGBADMAGHDEDGhAAAKADGHGAG.aFFAOAHHhABAAAAG.FCCGBHEChACAcEGGUAGF..NDAAQEBH.hADA......hAFA...,2,-23,-7,16
VJPBeLHADdaRcYbNSTgMfZEQOIGFKXWCU,dBEDaFEE.RCBC.....bCDETFGA.MAFCEAFGQEABhAAAGEAAKDFF.CABFJDHHBHEGLHCEhADAACBGDAAH.cBCGhAEASDHB...fGFEhABAIEEC..FHGG...hACA...,2,-33,-5,28
geLYPJQUfTRDVGHOKFZcAXBWCaIMSdEbN,XBGGCGHD..aBDBSDBDEDAC....NIABLCGHhAAAYGEE.QFAGhABAfEFDDIGGHAAChAAAFFDEAEDBIAHGMACAgCEGJECARGAAOADAhABAKAGABBBDWHEAdCDD.hAGA...,1,4,-22,26
MREaQWSABDcdgVTJUXNOCHYLeGfZKbIFP,BGEHDDCFdBFG..TBEDJBHF..UGCHODAD.HAGHeFFGZEGBhAAAKABEFACB.MDDFEADC.hAAAQGAB.hAGAAFIB.gCCBXEECCBAGLHFE.hABA......hAEA...,1,-16,-33,17
NfLdXFKOPTDYIcVWAHeRaSgCZMGBEbQUJ,HCAFaDCH.CHDCGDFCBCHFEGDEQCCB.JCHFfFGChAAA.dBEAFGBFPCADhABADAABIAFA.hACAcFDAAGBBSAFEMBBE.NDIALDDAhADA.XGBHhAEA..KAHB,1,-9,-25,16
HgCQOPdMNcJYKIeXUSBREATaGZbfLWVDF,aFBFGEBFZBDF.LAGHDGAF.HADDCEGA.OBAHMAFC.JHEAKABCXEGBhAAABCCA.AICE..hAAATBBH.fGBBhABAFBGCgGDG.dGGB....hAEA..YFAFhACA...,2,-38,-13,25
KTFMXWBUbaJGDdIYPEQOgfCLHSNReZVAc,KGEHFEGDMDBHBEFDUGGG..JABGDBACdDCA.....ICEHhAAAEBGEQFAAhAAA.ODDFfHDBhABAHACBSAFCRAGBeFADAIGGXEEFaDGCPCABhABACGHH.....hAFANIAB...,1,-19,-32,13
IBVKdNcfEDFJePMgHGbaCXZTUQWSOALYR,LFBARBCHBBBCKBFBdFHA.....fGEFFFEGeEHBMBIFhAAAHABCGCDH.CECCTCABhAAAQEAGOAFGhABAAAFHIHDFNIBH.DHAA.....hACA..gGGDhABAaCHD..,1,-12,-34,22
PMgJXRSCcQODLITGfdKVEeWaBZAbHNYUF,HDCAUDBAFGFDMDHD.JAGDRADC....CFGB.QFADLHBCGAGEhAAAfCBA.dGGDhAAAEBAGaAEBAACC...NICF.hABAPEDGSBBEDDID.TFDF..hACA......hADA...,1,-12,-28,16
XUFaMcAHZGRESgWNPKQDYdbOfTJVCBLeI,ZBCHRGFEEBEHSHGE..NACB.KBAADICCdBHG.ODGH..hAAATEEHJFCGBBEHIBAHhAAAUDAD.FAHDMHAChABAACCBHCFE...WGBA.QEBChABAYHEA.....hACA...,2,-31,-15,16
dcIFMJLNVQGaUfERAgSCOXPHZbBDTKYWe,SAGCOEFCHCDHZDGBBEBBDICE.KGCFeEBDdBAAFGGELDDH.hAAAQBADaAFAUGDAEACChABAAFCACAEE...XBGGhACAbGFE....WAAC.IBDAhBCA..MFBF.hBHA...,2,-26,-12,14
KCGOEYMNFBfIQRTHDXdeLAcWZPaVbUgSJ,ZAFBVECBUBCB..SFEHKFHFGFCFOBAA..EFABMCHDhAAABDHFQCDBhABARCABDICA.eHAEAIHG.PDADhACAaAAG..bDDGCAGEFGHD...fADBhAFA...hADA...,2,-31,-4,27
SUDBGLdKMCPEgVfTRYcNAZWOeFaIXbQHJ,ZBBBeDFBaHCC..XDBGHEDGUAFABBHBdGHGKGBD..CBACEFBGVFCChAAA...RADA.NAIG.OABDhABA.FGHDIHFFhAAAJCFCDEAH.MDAD.fEGB.hADA..YBDBhABAAEIF...,2,-25,-16,9
ZOBeHVNAKUMbPgRTXcaWCfGDSFLQdIYEJ,UBFDMAIF.....bGDGRCAAXAAC.aDECfCCAhAAA.DGAEFGBCLABGhACAdCFFIHEHEEEDJEGHhADABHHC.eFFGNEIAACIDKHAAgECB.hAFAWAEECECH....hABA...,1,-13,-31,18
cQdEIaeOXfgSRWVDCKFBLMPAZbYTUHJGN,ZCFGTAEEJBAD..GECAQABB.EBHFaHEA..eEDDOFAFhAAAfFHERFGD.hABAWCAACAHHBCCE.MCEGhACAAEFHUGAB.cGFA.XCEGhAAASEEGKHEGFEAC..hACA...,2,-25,-6,19
eWOEKYTGSbCFHMUVZQfcJdPaRILXgABND,DHGEeEEHEHBGKECG.GBGGCBDF.HDADUFDBZGAE.QBCChAAAJCFF.dGGDaFAG.RAAHLAHDhAAAAAFBNIEH.ODAEhACASAGC.MABAfEHG.hBAA......hBBA...,2,-30,-4,26
KCLNMcTPZFfDAXReSGUIaQOYBVHJEdWgb,eFDBSEAHUCFD.QGFEOFFBBDAAHDEF.dAAF.bAFEKAABhAAALFCBMECHTCCDhACAFDCGDCGF.AHAH.RAFAaADGhAGAYCHF.EADCCHGENCIA......hAIA......hBCA...,2,-21,5,26
SEWIaMFLDcZJOCHNUfeBAPVYRKXQgbTGd,VDCGKEGCQGFE..TAEDdEDDSEABEABC.aGCGhAAALHECZBBA.CDGCNEAGhAAAUAFABHBBAACE.PFFAhABAXDBF.........hAEA......hAGA...,2,-29,-23,6
aYMSBPdXeLCOcUFQKWDbfJARTZNHgIEVG,TCFFZBBHHADB.EGAEaAAE..MAADBGHEdEHGLHECCGEG.UDAEhAAAKCGDDICEJHAGAGAGRAFG..hABA..IFFAhABAVBCGSAEEeCAHcDDDQEEH.hACAWAHB....hADA...,2,-21,-7,14
NBdVULMaHOYXQADgbJKfGSEePCZRITWcF,DHCAJFEAGDBHECEG..eEBACCAF.RACA...TBDHFGFGdCAELBHBhAAAMFAHHBGH..hAAAXABBAGBC.gBFBhAEAKEFG.fFAGSABCIHHGhAFANEIEBCCG.aHAE.hAFA...,2,-21,-17,4
gMZbHUATFSWVPDCQaGfEeIKdONYRBLcXJ,TABGFHAC..VBACCEFAGEGE.eDDHIDGD.OGAAhAAANAFEBHCE.LDAChAAAJCEHZBFAHGFGSGBFhABADDDBaFGGEAHB.KEAGdAEF..YAGFhADAXDAC.....hAEA...,2,-12,-10,2
LeNVcPaIOYJgKfAZCSbFETBdWGHRMQUXD,SFDGEAADBBGCdGACHADB.MHAEQDCDDFFELDBDeHDEVDGBhABAaABF..YEHBhAAAKAEBAICGCDAB..FACHWAFHhADA...........hADA......hAEA...,1,-17,-25,8
HBXUbYRcdKCGJMfaSOAZELNTeVFWQPDgI,EABCLDAH.eBCEFCCAQGBGDFGGHCFEBHEDXEEBUGGCRAFGhAAAKADGGCCGMCFAaGHFhAAAAACA.ZFDF...NBAA.hABAWHAC..IAHCcBAF.CGADfGGEhAFA..SFFDhABA,2,-24,-6,18
gBMbUfNQCSPXEdIDWVeTRYAZLJcaFHGOK,LABGJABB.FFEGOBFHBHCFUBGC..QEEFhAAACCAB.PFAAXDAChAAAdAHCDIFCeFAFREGHAHDBaCCFKDBGhABA..MEHF.NEIC.EGAB.IADGhAFA......hAGA...,2,-29,-26,3
RMdbeKcgJTOBNZDfQVYCEXPHLISAaGWFU,aDACGFCB.FBEARBBEMFFEdGHAKDBF..JBHHOAAH..BBFEhAAAZCCDDCHBVGDG.CDFH.EHAGhABAHFAE.LABEhAFAAEEA.UGGEcAGF......hACA......hADA...,1,-12,-32,20
SdOCFZQeTbJRIKDVEWYcaBXAgLfHPMGNU,LCFGHEBAMACCUGBCSHBACEHE.FFGDQDBH.hAAATGEERAFADDGAEFEC.hAAA..WBADYCADhABABHECXCDDAEGH.gBBDhABAfAGH.NBBHdGGE..hACA...,2,-27,-8,19
XRICEVdHLKZDOTQScBYJWMGbfFeaUgNPA,XBFCCBGAdDDBLFCGDICA...QCABBBBEJECBGFEHhAAAFDHDaGAC....NBCD.AAEEEDBAhABAHGECKDHB.OCABhACASABC.WAFE..fAGDhADA.eHFA.hAAA...,1,-21,-26,5
bdKRFcQeDEOHBAYNgJMGaPTSUVCZXIWfL,...NGEB.gEFHGABA..aDFBPCEHUFBGZBEG..IAEGhAAALAHHdFCCFHFEhAAAQCAEeDAFDBABEDDBhABABAGEAEHA.YFHB.MIAA.TBFHhABA.CACC..WAHHhBAA..,1,-7,-12,5
GbRVPFYXOadUcQHeCWgLBEfIKDZASJMNT,SHECMEGBGADGRABF.FGAH..OBAHdGDFQBGFHEBFCFFDLBFDhAAABACAEFBBIHHAhABADCAEAIFA..NDIC.bAGFhADA...PDDDaAAG.eDHFWAFC..hBBAfEAC.hBHA...,1,4,-23,27
YTbVSeCROMXHDUafGZQIAJPFLdBWNKcEg,JHEGLFFCBACH.KGBF.EEBG..TCFBSHCARGAE.ODDGhAAAHADBDCCF.aFGAfBDFhABAZAAD.IAHDhACAAFEBdAGD.cCGF..YFAChAAA..eACFCFFD.hAFAMFAF.,1,-17,-33,16
NIeJZCfEGYTKBLHVAgWFUcaSRMPdQbXDO,FGBHaFEF.RDEA.dCCF..QCBCDFCD.OHDAeFAFZBED.CDHGEAAEhACATAEB.KEDFBHGDhADALAAAADDB.gFGGhABA.UAGCMAEAXEAGhACAIGDH.fGGDhAIA..,1,-15,-34,19
aAFEgRKSXZGBQWJDbfTLcVNMPdUOeCIHY,FHFARCCBKABAZAGFBBHB..JBAEDGCE....TEDFLAFD.hAAA.VFAEMAEFUCDDhABACHDHHFFB.AHCFEDAFSFGEhACA.XADB..WEFChAAA.fBGGhABANIBD...,1,-23,-46,23
AKYSTIQMDfLRCGcaEbgVUXONeFWJBdPHZ,KEEETCCFMFBH.LCCGGAFGEADD..VECDOFDD.NBBE.hAAAFGFABAHCHACGAHIHSFHFhABAIDAGDIDECCHAaFBDhACAUAGE.eAACWFAD.dGFAYEHHhAAA..fEEDhAEA..,2,-15,-1,14
EYdTOegGNHIUQRJKXDFSWaLZPMVfbcABC,ECBBTEGC..OCFDeBBCGFCFHAACIEADRCDEKGAF.XADFhAAASDAD.aAAGhADAZFFAMCFAfHBBhABAAHDFBHHGCHBHdHEH...gDDF.hAEANBIA......hAFA...,1,0,-16,16
DdBCQbZONFHJPVGSRYWUXIATeEgacKMLf,EAECaCGG.KBGBLFHH.DBAGBBCB.QECAZGEEFBDAJCAFVFFFhAAAGDCG..RCAG.hABAUGAGXEAHAFFCeAFEhAAAMFID.CHAFNIBFSCCF...hACA.WEFC...hABA...,1,-16,-20,4
OFAPWXVJeERMCQaTGLcNIgKZBDYdbSfUH,XFFBJDCG.RFDB.CHEE..QAFAGAEELCBD.IHHHhAAAgDGBKACBDIAEhABAdHBBSHGGhAAAHBGBFGAGAIFE.PBAA.eEAHMCAFaFCC.cFGHhABA.BAEC.hACA.fDDA.,1,1,-16,17
SNKLAZdQWHgGbcefJBVTOMXUCPYEaFDIR,dFADQGFCHBBA.GADHeBEHBGHDODCFXGCECEHC.EGFHhAAADAIFRDFC.KCACLABEhAFAAABC..WGAG.hAGA..gCFAfBHGJDAHMDDF.hAAA..YHAAhAHAaCDF...,1,-11,-17,6
HAXMEgBJUbdGLTYKfSPNFCZaVWcRQIOeD,MAECBDFCJCAFdHGFLDEH..KAGFSBADFDHFZGEA.aEHHhAAA..VAAARDBDOHBChABAHECD.EDDB.bAFE.hAAA...YHAAfBCFCFFF.WDGFhACAICDAABBB...hADA...,1,-17,-35,18
QVLGTACFHYIeOZEPKcJgDbMaXWRfBdNUS,FEBEHDAGeAAFEGECKDHH..JGCCDHGA.MFDDaBEH...RBFGdHAHSHFAhAAALAAGAIAACHCGIFAChABA.ZADBPAEAhACA..cEEGgBGH.bFFEhADA..fCAFhACABEFB..,2,-37,-5,32
TdUXfGgHYaCQSDAEcWBMKROZPFbLJeINV,EBGABHAEKEDFOBFD.ZDAEFDAALAAGeABG..VGAEdCAHXFFChABA..fGFEhAAAHFBHCHHHSDHHhACAADDGMCCGREGDbCFENEEC.......hAEA......hAFA...,1,-17,-22,5
dEegSVXMPKYQBaUZTLcbDOIRFCHJNAfWG,GDAEEDGC.eEGDSDDEMCAA.KGGAQGCDBDADZACGLGCEhAAADADAIDDACBHF.hABANBAF.AFCGdGAG..VAGBhAAA...YHFAaAFDcCAF.OFFGhACA....hADAFFDA.fCEB,1,1,-28,29
bQRCLNfdcIZGVYgBUOaEeKSFJPMHATDXW,XBBBQACARDCB.LFFC.dGGEZBGHVCAHBEGG.aDABeDDGhAAAKHACFGGGMHACAEBH.DCGEhABA.CHEB...fGDAhAAAIFDAgAFCECFF.SFAAhACA...hABA...,2,-38,-4,34
UOXHLPDFfeRNJBAWGcbSgCTKZVEaIYdMQ,GBAGSEGGCCGAZACHECDD....aDEDdGCDUGGGXFAF.hAAALACGDIDAFEGGRAECBECEhAAAAAHG.WAHD.bFEHhABAKECF....IGHCMEAHOGCEhABAPBBB.....hAEA...,2,-23,-12,11
FPfAQWBDNgdbeOScVEYHTLMCZJaUIKRXG,BBEADAACdGAGOFEH..SDBCEAAAHDFFMADBCGHCZDFGUAEDhADAKAHHRCBB..GEACFHDCABCF.hAFA..NDIE.eFCE.hAAA............hAEA......hAFA...,1,-20,-40,20
XVNWDbITCELBdSAOUaGQgKRFcfeMYPJZH,aHCAGGCB.KEBFFCFFeAEBMABD..JABFZCDHHDGB..XFBGhAAAVDCE.DDIFIHHGhAAACHHFBAHB..ADDB.UAGHhACARFEA...fHABNEAE...hACAWDAFEADASCBHhADA.,2,-31,-8,23
DKYOGdFISVRJabLBHNXWcfEUgPZCeMTAQ,KGDAOBCFFDFG...VFEAJDBH..LACEBCGGHCAD.XGBAhAAA..cGGEhAAAUAFBZDFC.CABCMEAFhADAAGBFQBBBDIAGdECDIHHESFFG.hAEAaAGA.NBAG..EDDF.hAGA...,2,-33,-9,24
bEGfNTSOdJLMKDFZIRYWcPXVaUHgeCABQ,QACGGGBF..NFDH.TEGAdAGEMCAGFGCDREAA.....hAAA..cAGGXEAGhABAaGEFUBAGgCGAhACA.ADEHBHGEEBEHSDEAOBDGKDAEDIGChAAA......hABA...,2,-16,-16,0
APLGJFOIbeXMKUfTVQEYdCHBWgaRcDSNZ,GCCHFDEFOBFFeAHH.MEHDUGFH..VEACEEHB..dHBFBBBChAAA.aGEADBCHZGACADABJFAChAAAIAED.KCAF.hABA.fAHG.....YBDDhACACEFCWFHH...hABA...,1,-20,-35,15
NaDJWEPUfZHbeVLGFYBXKQAIdCcSOgTMR,CBDFSEEE.OFHFgGDA.RCCC.aDAFDDGFEGAEUGAHhAAAHECB.VBBAFDADBBBEhABAKGGDAABDdAFC.MICChAAANACF.JAHH..fBGB...hACAbDGD.....hADA...,2,-31,-8,23
FMORaJBSYAeLcPEfbTKZXgdIVCNUDHQGW,eEBFLFFHECHB.TBBBKDFAZFDH..XBGEdBCCCFGG..DIGEQEBBhAAAFAEC.MFHHhABAOHAEaACASDDEhAFAADEB.fGAAIAAHNCAC..hACA......hADA...,2,-35,-13,22
MEPgcFdJaUBLCKDYGeVNWTZIAXHRfSQOb,RDAHQDGDOCDB.EDBA....PFGDgGGD.dBBFhAAAUAGGCBGDDCFFeFEDVFBBhABANBBH.ZEDHAIBG..XGBEhAAASAEC.MDAHJCFFaCAABAHB..hACA......hADA...,2,-19,-10,9
NFURYTZHQBEdDJKObAWafLecMPVGgSXIC,aGGALFHD.MCDGGDAD.SBHFIFAA.CBFHUFDGhAAARDEHZBBBBHDBDBDFKFAAOAHBhAAAABAE.eDDF.PADGhABA..XDGEFCAB.YHAAhABA.....hACA...,2,-28,-18,10
YFDbNeMIRHKTZgVdWOfAJaXEPQCSULBcG,JDHFEAFD..CHCG.UECFBGAGGAAG..DFDDeDDEMAACHAFAZABEdGFFhAGAOHAC.AHHE.XCCBhAHASFFFLEEAhAIAFEAH..IADHKCEHgBGHhBAA..fGDEhAAAaGHD..,1,-14,-28,14
WQgEaVDYLcKeGSZBPTbCMdXJNRUAIFOHf,OGBAHCFAQDDH.ECBEVDFCDABGLBFCKDBGSACBhAAABFGFbABACHAH.dFADXAEGhABAJHCE.NFAF.AGHGfHAHhAAA..aGGF.eAHB.hAFA......hAGA...,2,-25,-6,19
gVGQXLMTHYEODeSaBNIJAWbUdCFfZKPcR,UDFHdEBFCHFGZAGDKADD..RFBD.GEDALABHHACC..EGHHDDAA.eFCDhAAASEDHBAFEJFFChABAAAABFEAB....hAEA.fBHE...cGDEhAFA......hAGA...,2,-34,-28,6
PCTeIHJMbKQaXGBZOYEdDWcUVSFRfLANg,...PEAHCDBCTGCBHFCH..JCGBKABD.aCEDGABFBFHDZCFBhAAAEFDGDIGCUACA.SHEGhAFAfFAEAHBB.NCIG.hAAAIHHC..MBAF.XDDEhABAOCHD.WHFC..hACA...,2,-30,-12,18
LcIVCOAeQgZPFXSbUTEBNDGaJHWKfdYRM,eFDAQFDHZDADFCECSCHH.UAFBBHGBDDDFJCHHHCEGhAAAKAFHdAACMFFGLHBEhACAIGGE..CADCAGGE.hABA.XDAAEBBE.aACC.fGAFhADA.....hAFA...,2,-34,-5,29
YWUJNLaMHQCROefBDgbKdEFPSGVcZTAIX,XGAHUABALDGFHCGBRABCOECA.BAHCDEAGKHGG.dCDFFHCAhAAASAGEGEACVAEDhAEATGCF.AEDBIFEHhAAAJHFCMCIH.eGFC.fAFGhABA.ECAE....hACA...,1,-12,-17,5
CUMBKfVIeTRcLWdEFDbNYPGHOSXaJZAgQ,CEFGUBCFKEBA...VFFGeGBE..RBFBLHCCdFHCEADE..FDDGDGAFhAAA....NAICGBADhAAAOABAaFBA.AHIDMBIDhAFAfAFB.IHAB.cGEDhABA....hACAWBBD.,1,-23,-38,15
JaMVgCKfTXRODGIBWASEcYebdFHZUNLQP,EDEBeBEAFGAHUDFE.LBAHQAAH.JADCMEEB.CHHGKGAAhAAAXCGH.DDCDBDCFhABASGGDbEAAdACG.hAEAHECF.PFHF.aCADfHEFhAFA.....hAAAODHF.,1,-10,-14,4
RWNgYdHCUMBFbXOSeQAKPZDLIJTfVacEG,ZDFALCDDJAHH.TABH..VECAaCFBGDGGRAAG...hAAANDAE.dFGGHFBAMEABBAAChADAXADHSHCAhAEAAFBFKGCD.DGGF.fBHEEHDA..WCAGhACA..CHAH...hAFA...,2,-23,-13,10
KBeLTcaMHNfdWGAFPYCEORIQVUSgJZXbD,FHEACDEERBGD.QCEB.UCAGSDAGZEAE.DGHDKHACeGAChAAALFFA.aABEMEIBhABA.fACFhACA.dGFAADCGEEGCIAFAgBGBXEEGhAHABAACcBCDWFBA.hACA...,2,-28,-23,5
YcNAeGCSBRQLMFDIWfTKVadHPZXOUEJbg,GCCCCFCFRACF.QGGBLEGFDAIB..WABEKBEH..dAAAZCFDhAAAUGBDEGAH..JDHB.hACA...bEDB..hAEAYAEBAFFDBAGCMIECFFEHIBBH.hAFAfAGH.hBAAaDBH..,1,-6,-33,27
MHgKDbaOXeCPJGWFVTLcfYQNBdURZEASI,MCBFKFCDDICG..OFGBeBHF...CCDEGAADFDBCLGFC.hAAA.fHBFhABAQAEFBFHEdAAG.ZCFGSBBEhACAIGEHgFAAaEECJFAB.VAFAhADA.cDDH.hADA.YDDC.,1,-10,-21,11
UXBMYaREVGdDSLfOeKIWTQFPANcZgCJHb,ZAGFCAFCHBCHUFGABBAA..MECGaFDHREFBECBG..dGBGDFFDLCHDhAAA.eAGFKABGIAEGhAAAQDAAAFDC.NIDD.hABAJGBC...XDAH....hABA......hADA...,2,-41,-9,32
TDJbWeAPGKNUfVdYIHBEZgXMcaLFRQCSO,GBCBUBBBdFGEHDABBFDHEAHDZEEBMDFA.aEGH..LAEChAAARAACSGADOBECDFFFJDAHhABAeDDB.AEIDKGBH.hACA.fDHGYHEG.XGBD.hAAA......hABA.FAEACDEF,1,5,-36,41
fJGDHWLgFRSVKPUTQYNeOcZbBaXMdEIAC,JBCBDFFFLEAF.RBDF.KCFBUBFETFGH..QGGAhAAAeDABZFEBBEDAaHECMCCBhABAIHAC.CDHGHAADhAAAFEFASBBC.YHAG.hACANACF.cAFB..hADA...,2,-34,-11,23
WQLMBTfCJUHKRIeSPGDgaEYNOFdVZXbAc,QEBBBEFGCBGBHDCDKEFARADH...SAFADFHD.aGACNIAH.dABHhAAAZGCAAHDELCEEhACA.MFIHTAAGfHEFhAEAIDAE...eBHH...hAFA....gFAFhAAA,2,-29,-27,2
fbLBeTUWdYDMaIQgJFEXAOKPGHcNVZRCS,KCFDHAGH.VEEARACACGAA...SBAHLECFeEFHUGAFdDCEDEID.hAAAaHGA..QAGFhABAJACGFCEEAEHG.OHDChACA.PDABNIDD.fGHGBFHA.WCDHhADA.....hAAA...,2,-16,-15,1
YXGDZFcTUOBKAQbHLSgVCPNaRfWEdMeJI,HGACLBCGSGFFVFAF.CAFA..aDDARFEEEBAB..MBBGIDFGhAAAXCFF.DDAEhAAAZDAG.FHDATEGDhABABADCACIFQECF......hACA......hADA...,1,-18,-25,7
UMTDXLRfGaSZgVQPdAbeJEOcIHBKCNYFW,eGCEODGDHACFKEDG.CDEHFAADUBCG..MCIHDGEELDABGDFEaEAGhAAAZAFD....QFAAhACAAAEEJHCG.IHHBhAEABBHG.NIBB..WAHFXAAB.hAFA..SECFhADA..,1,-10,-36,26
XYdfHCBVWbZIUgcEPTQJNOeAaKLGSDRMF,KBBGLCCFGDAFDGGHFBHFdAFAHGEABCHH..VDFHZABEUGDB.hAAA.EFAHQDEBhAAAOADAAFDGSBDHhABAMBABXEGACHDD.IHBCcGBG....hABA......hACA...,1,-6,-30,24
PHWYCEfbZeVFMaBDgQTKXUJAGdIORSLcN,dDBFODAHSHEGLFDE...PDEAHAFDCABD.EEGCZACEeECAhAAAFGBCMCECaCCABGHChACADIEC.TFACKGHF..hADAXAABAAECICHBNCIA.WHAA.fFFEhAHA...hADA...,1,-3,-27,24
OWGRUJZXSaPfTbMDgCdQKNBcYHLIEeVAF,OAAGGDDCRACHZFBE..aFAG..TAFADIECCDHD.QCEGhAEABGAAHAEFEEBGAHGE.FHDEJAABXGGAhAFA.fFFDhAHAMIACdFGD.KDHH.YBCH.eAHHhBAA.....hAAA...,1,8,-29,37
WDgBFLUecZIXaKNSPATHOYJVRECdQfGbM,ODHBVDCD.RAEF.CAFH.dFEFGBGA..MABCDCAEBHHHLDBAhAAAeEBDZGAE.aFHDKFEHSCGFhAGAAFAFHABGEGGC.hAHA.fBBB.WHBA...hAAA...FHAC..hABA...,1,-13,-23,10
adEMUPCROGDSBeFXTYHIVAbZWcLJgNfKQ,ZDAELGAAJBFD...NAAF.QFFB.EDGHPCEH.hAAACDCFOAFGDGAASABEhAEAFGFE.XBCEhAFATCGBIBBHAHAG..WHAAfEBEhBAAaBBHMFIH...hBDA...,1,-20,-38,18
VdXNLDbEPWUCYMGTJSABgHOReQFIcfKZa,BGGFOABEQEBDFEDB...fAHEKEHDaAFFdGFELFFEhAAAECEG.UCDACFBBMHAChAAAJBAGAAED.RGCAICGDhABAVCAA..DGEFWFAD...YDAEhACA....hADA..SEAD,1,-23,-28,5
MBUbIJfeEFacWYRNQSDAPgLdGTCOZVXHK,LHBAdAHCGGADTDFEZACAHDFD.KECEUBAA.JEBGeHFGEFDA.hAAAFFDE.aAAF...hABA.cAGERDABSCCGhADAAHGFCCCBOFHDMEIBBAED.fGBDhACA.....hAEA...,2,-15,-4,11
gQTbKZBWcAefdFCDNXYORIHMUGEJPSLVa,dBGHDHFC...XGACRDFAHCBDGEDGEGDE.SBFALAEHaACHhAAATADCZEEABECHhABAAICAFAAB.NIEB.OFAH.hADAMFIF..........hACA......hADA...,2,-23,-18,5
NODaCIGQPKXFEHBMRYTVJfSeAWZLbdUgc,LCAGdDBHUGEH...NEFE.aFDBGCGG.KCEFFCHHBHBHRAEE..hAAATAAHJABG.eHAEhAAAAEBCZFBC...bAFGgCDBhACA.DFFGCHHB.IHHD.hABA......hAGA..XEAG,2,-27,-16,11
WYXRBVHNaGCecIOEMJZPbTLKQdDfSAgUF,UDCFFEGD..XGEHBCGAHGFCGBBDeGCCOAGBEABB.MEBBhAAAZDFE..TBEHKADCDEDHhABAAAHB....YAAFhACANAIGCHAG..IHHAJFAB....hACA......hAHA...,1,-14,-29,15
VUFKHDEgWCTRcaLXbGPfBdIOSNJYZAeMQ,MHAGVEGF.KBEDHBBA.EDDDCDDD..RDAHLBAGXEAB..GGCDhAAABFGAdDGHSAFDhABAJFED.AFFFQAGAhACADGIH..WADEaGAHfDFHhADA....OAGDhAAA..,2,-39,-3,36
EWTHSVMfPUBeAQYJbadODcZGFRILKNCgX,JHBEdACDDCGCGFDBRFCH.LCABKFGC..CDAH.EBHHHGEA..SDCEhAAAMAAF.UADEhABAAAGFQDDBhABAaHFEOEFAZBCEFAGG..gFAF..hADATABE.fFBChBAA,1,-8,-34,26
QCSMIcUJFGZLfaVTeNEWAgXdRHDYPbKBO,XABGdBBADEAD......bDGDOHAACDDF.IHGChAAAUADGFFBCGECBLFDHhAAAfFHE.aEBBhACAeHACECCBAIEA.gAFEYAHHBHHBhABAMBIF.cGFH..hACAZADH..,1,-2,-33,31
QafcNLgHJWTKdYIEBFXDbRPAZUCOGeMVS,ZEDCUDFHODBDeCAE..MHACSDGC.QADBhAAAfBFHLGBAHABGTGFChAAAKAGDIHFGhABAFFAGDDIB.PCABAGDGCEDA.aHACNIAH......hACA...gBBEhAEA.,2,-18,-11,7
KGXaWJOPBVCISEgcdeDfLFbQYZNRHMTAU,KFFAaEGG.OABFBCFH..CDDD.EFAF..dAFBDEFGFEBH..QEDGhAAAZFEEHAADMIAAABEHXDAChABA..PADDhAAASHCCeFHHfBHCYHFANDIE..hACA......hADA...,2,-27,-26,1
eJSAfUEcaMWZdGRIbTXHKNOFPDBCgVYLQ,ECFBMBGDZDABdFDGGGBFRADF....IGAGXAFA.KFEGFACBhAAA.DFIBCBAD..gECChAAALFGDJBAHfADHhABAaCHH.WHEA......hACA......hADA...,1,-27,-33,6
VUJMXcgbAYDKIfdEBPWZNGCQOeLaTSFHR,DBGGKCFGdBFFECAG.BDDBZEBFGAAH..CEAEQBACLDFHaGHDhAAAFGGCRDDH...JACEMAFGhABA....XGAEhAAA...bDFEAHFDIEHEhADA.WFBDeECB..hABA.SAGE.,1,-16,-29,13
NWDeKIFZfSQTLBCbdgXJERGVPUYcaMAOH,ODDAHEEHDDHHKABFZFAD.QAFABHFFCGAF.dCBF..JDCFEGHHGEGGhAAAUECG..aCAHAADA.hACAeAAAFBDA..SGEFhAFA...TGBD...hAAA......hABA...,2,-37,-17,20
fEYReOQVaATKDFPHdSUIgBcZWJCbLNXMG,KGACFBBBHBFBUBDHBGEBZACD..CHAELEDF.MFECEEACRDFHQGGEhAAAABABDBBF.SBEFhABA.IFAEhACAWHAA.NAIG...fGHGhAAA.....OADGhABAaHCC,2,-58,-17,41
UbDZHRGAETMWVaXLYgOcSIJdfFQNKPCeB,MDEEVFFH.LFHB.OBBHIEHGdGEBFFBDKEEF..CCCCBBHFhAAAUAEHDBIBZGBCGCEDhABAABAD.EADCaAAA.XCCHhADA..YDADSHBAfABChADA...hAFA...,2,-28,-22,6
PfCBdOKHVIFZMERYSXWgebTQUJcNADGaL,aAGELHEC.CEBABBGGKHCGHCDH.VABCZABARDDG...XFDGhAAAgDFH.eHFAhAAAQGADJEAGACHADAEEhABAPCAAOFCCMDIBSEHH..hAHAWAFD....hACA...,1,-5,-34,29
BRMEXfANQOVZbJdeFTcaKHgICYWGSDPUL,QFFBOBFHZFFCdDCEFAHF....TDCCaBAHKCHDHFAB.CCACGAAHhAAASGAFPHDChABABEADRCFF.EHFGAAFE.VGBAhAAA..eDAFIBBFDCDC.MBEB.hADA.fFDChAEA...,1,-1,-21,20
HUBcYTVEgDaRbfGeIPZWFCQSMXKJONLAd,HABDBCAG.TFFEEGEHDCFERFAHGAGC.eDDEIBCBZECBCADEMAABhABAKDFF..JEAFNIEF..hAAAAFAB.UGGE.VECFhABAaFHD.....PCHD...WHAGhACA..SBDAhAFA.,1,-1,-32,31
GPTXYDaVAKecWREgCFIdZMOfNLSJUQbBH,eDFARACACHDD.dGAEZFEHMBDC..OAGHLCACUEGFBCEC.HGDAhAAA.GEABPFADhAAATFGFDHGE.AABDKAHFhACAEECDFDDGfDAH..SCAFhABA.....hADA...,1,-9,-28,19
YVcMFIKHCeRTaWSJfGNdABLEDQbPgOZXU,BHFHEEDGDHFGQBDC..PGACZDFBXDCCUCFB.VGBChAAAMABE.KEHBeCAHhABARADA.TAGCaAACSHGAhAGAfFHGNIBHACCDLACC...hAHA......hAIA...,1,-3,-27,24
CGJdVIEDROeNQHZgPBfFKTXMALUScWabY,UGGESCGG..aDCCCGEGGADAdHBDEEBD.OCAH.eHEAhAAAQADGZABDBFGGFFEHhAAAKGBFMAIFAFDA.LBGHhABA..cAGFWCAF.....hACA......hAFA...,2,-28,-25,3
UJedGWFgSZKEfPOBQNMVTYCAaIXHLbDcR,aABFXAAALGAGDFEF.UFGH..eFFCdAEGGDCFFGCDZDAEKADGhAAAEFBC..OHCEBAHGMBGHhABATAFGCGAAAGHDIDABhAAA....cCDF..WACHhAHASHEA.hAIA...,1,-17,-30,13
RBPTbWOAgEdCMLYcKJfFDNHVGQXUIZeSa,EHDCdDBAMBEBLBHBKHGC.FBCCHFBCGBFCQAFAUGAFZEBCaADBRFFABBAFhAAA..PEFGhAAA...WFFDhABAAEEECAEB..YDAC....fABChAFADIFE.NIAB..hABA...,2,-14,-14,0
XPEKJAGeHBUgMQOVZSNRYIfcFdDWCaTLb,eEDHBDDDMBCAOBDAZEFCRBBD.....IDAEfFFCdAFADHGAhAAAaGAC..LBAFhAAAXFDCKDEE.AIEGUCGChABA..QCGDSGHHNCCGFHAGWEAAhACACHEH......hADA...,1,-18,-26,8
UBQPRJZIcHgaWXGYbLCNOVdAefSDMETKF,eGDGDAGEMEBFEBFDKFFEBDFG..RABA.ZBDEHFAD..aGHFXDCFhAAA..bGDGNICFOAHDhABAAIFE..fADDhAAASEAEFCHD.PBBDICAGWFADhABA......hACA.YEDACHHA,1,-17,-26,9
ceMQTVNXILBRKYAUPDHZfCWJGbSEadgOF,DCAAHFCHCEHB.GDCH.ECHBdDCBFCABeHAAMBEEQFDA.hAAA.TGFDXGGFhAAAICFFBBDAKAGEAIBAPABAhAFAfCGDJEHFaAGAOFAG.NABB..hBAA......hBBA...,2,-26,-5,21
PVAUHRXgFQOSEdCaWMDLeYZJKbfBGITNc,HGCCREGFFHDC.QAFC.ECGCCGFGaAGGMABBLDAFeEEEJFBEKCFHhAAABGHB.GACEhAAATBCFNEAA....cFFHhACAAEDHXEEG.SABCDIBA.hAEA..YEBHhAEA.fBHE.,1,13,-29,42
MECZVUOdKJLHebfcYSWIgDaTANGQRPBXF,QAFHRBDHBEHCFCBG.CHDEZCAG..OBFGJECB.HGDE.eACChAAAfBAD.SEGFhAAAIHHBDCAFhABAaFHBAACBPDFD.EGAGdCEH.KEEB.LAHBhABA.YEABhADAWHAG..,1,-10,-33,23
GSOFfBZDdEeaQgCNPMVAJHURKTcLWYIbX,HDBGRABGKEECLFAC..IBFEGBEHFFGDfGDFhAAADDDEdHBB.eFHB.aAHHCHEFMADEhAAAAADFTFAG.YDGDhABASCCDBCAGEBABNIAD..PABFhAEA......hAFA...,1,-13,-21,8
JZeIVgOEMWQUScaFfBATNbGLPXDKRYHdC,TCCDGBDALHFG.DEABKDGCRCABHFCFJAEHeFAA.VFEFhAAAEGFEMBHH.QAADhAAASDAHaCFDBBAFhABANBIE.PHAEdGBG.CAHEIHHB.hACA......hADA...,2,-21,1,22
BWbPRHIAcaDQTNEUgfMFLOSeXCJVGYZKd,aBECDDGCQABF..EGGFUGBBfDFBLHFCOCDBhAAASAGECBGE.GDCBhAAAKEEAdADBBEGAPCAHhABAHAEFABIF.TCADNBCCFHACeGAE..XEAGhACA...hACA...,2,-20,-3,17
ORgYLNAPcUQZWCXaDdHMbSVTBfEIeGKFJ,UEDBZEBHCEHD.DIDGdBGBHADF..MEGD..VCAHBFAB.EDEHeBHBhAAAGBBFKGAFFGHBOADGhAAA..RFBBLAFChABAAGDC....PHDCWEGFaABESBAChABA.IHHGhACA.,1,-10,-38,28
HLaYOecGZDPNXSJEUWQbKFITfCBgRdMAV,LHFCaCCA.eCEGGDBHDFBD.XAEFSHCCUFFBQCAFhAAAFHCG.IFEEhABACAHCBBGGgBADhAAA.MIEGAEABHDCEcDGBNBCBEAHDWDADhABA......hACA...,1,-12,-24,12
IVJPLfYREXDdOAcHgQCZbUKTNMeWaFBSG,HGCCCGGEUACHTDAD.MDDHaBGB..FAADBABA.SCGGhAAAGFAHJHECfGAChABA.EFGDDFECAFADcADChAEAgDAA...bDFEeEEC..hAFAIDDH.LHAAhAAA,1,-15,-24,9
OXfNQadYUPBRbFLDHAcMVITeWZJKESCgG,MEBBTDBEZAGF.KBABCGEAGAEB.OFAHXFCE.QCEGhAAAaBAHUEEHBAAEhACARGFEFADGDDCEADGC..IHGFhADA.JDHDEFGEfHCBNIBB..hAEA.PCCG..hAFA...,2,-21,-21,0
fFMPaRUSKINJdVBWEHgGbAQeDCZOXcTYL,eBAFDIDGOBAC..TAGALEDAFDBDMFEFaDHD..SFAEhAAAIFGCJDDEBAGFhABAEGAEGAEE.AHEECGDChACAcCGE.fGHCRBGHNDADdHGB.WABEhAAA...bBDG..hAFA...,2,-29,-11,18
AaOYQSZXDKMBUIEdTHbVRGfLCgeFNcWPJ,OAGBSACEZBDBDGFDKDBABFCG.UDFCEAAAHDGF.VDADhAAARAADLAFE.CHHEFHBGhAAANAIG....WADFhAFAAFIDaBGC..YFCBQEDE.MIEAhBCAIHAB.dGGDhAHA...,2,-22,-20,2
dHOTfVYWeJMKRZQCXSPDFAINcBULgEGab,..ICHHNDDE.BBACLEHFGECHdACCOCCAVEADeFEBhAAAKFHHRCAH.ZFFH..CGBFSADChAAAFBAFUAEAaAHBTGCFhABA...fHFF.WAGFhACAMIBA....hABA...,2,-17,-15,2
JOfCXVIYdcWDKMNeUQSZBLPAgaGFRETbH,GCGEFGCARFAB.ECAGHCDGOFDFCGFF...VABAdAFHDAEB.MCAHhAAAeFAA.SHBAhAAABBCCAIDE.aBED.bAFFfHFHhABAXGFCIEAC.cEEAhABANAICZEEA.....hACA...,1,8,-31,39
cFbOUGQKgeNDPTVWCYfLXIJHaRESZABdM,dBCFMIAEFDABUDBDGDFE.KFEDeAHD.DCCE..TGAHCFEBLABChAAAJDCD..aBFAEHDEhAFA.AGHABGBGODHFQCFDhAGA.gGGGNAAF..hAIA..WHDG..hAFA...,2,-34,-18,16
JBFPUTdQKEMHVcGWXDYASaOCbRgeINZLf,OFEDRBFGeDBGZFGDLCFCBHEH.UBBF.QGBBKFDGEACFHGAEhAAAGEADDFBC.AAGEaEGDCAEB.hABA....IAEDhAAANCAC.FGHD.dDEDMDDG....hACAWBADSFFBhAGA...,1,-7,-24,17
SJeYbaXfgCIRNOFKLQBHVMdGTUZcDPAWE,SFCAJBFC.eBBCaEDA...XCEHCFAHRCBF..FAADKCHBhAAABHFGMHBCGDGEhAAATAGGZADHDDDBAAIF.WFFEhABAEHAE.....fCAEIGDE.OHEChACA.LFAFhADA..,1,-6,-38,32
TeDgGOKdZfLbUBVQaMcJSPNFXWIARCEHY,REAEEDDDHGDG.eACDDAEDODADKBDCZCEG.LDFDBGBD..aBBHJABFhAAA..SAGEhAAAFBHHIHEGCEGA.TFCGhACAdGGA...fGAG...hABA......hADA...,1,-21,-30,9
PeOLGNgdUREIfMVQYJbcZWFKXDSTaBHCA,OBGDGEFGdBGCUBDARCBH..EDEBMFAF..QGAFJEEA.hAAAZACAKFCEDFIHSGHDhABABBAGCHHDAICG.eDAE.hAAANAEF.IHEE..fGBEhACA......hADA...,2,-35,-19,16
ZPLWeUCTKEdXBGVYfMRbSDHIgJNQFcaOA,LCCGUEBEKGEC.dFHEGAED..VAFGMCAESDBGhAAAHDFAJAAA.QABDhABA.FGEHOHCEAGGHZFACPEEAhADAWDAC.CCHH.EGHFBAEF..fHAFhADADIAC...hAIA...,1,-10,-21,11
NYZLPfKTEACIacSdXHGMVUeWbJQDRFgBO,aFDFdEHCGFBF.MCAHUCGA.eACHJBBE.DBABFCFCBDDF.OEADhAAAZDDALHBGhAAA.KAGEEAECACED.CGGFIHHHhABAXGGG.....WFFE.QCEChACANABD.YHAGhAEA,1,-25,-27,2
bQgIOHKWUFBaZSRfAMcNYLCEVDGdeTJXP,MCID..NEHACACEVAEH..DCCBdEAG.eHAGJAAD...XGDFhAAAQBED.OFAGhAAAKGGBUBAFBCHASBDDhABAAAGGLEFHTEFF..bFDH.hACAIHBH..hAEA...,1,-14,-45,31
cbVTEdaOZWFYKHUPICGJLfNRSQAeBMXgD,BGEEMDHBDBAC..bEAGEEFB..dDGGaBEHOBAE..ZFAGFDEFhAAAKAFGHGBCUCACCBGGLABEhAFARGDAACFG.gGGEhAGA..cDCF...WCHBhAAAIDBB..hAHA..fHAF,1,-24,-29,5
LNTWIYDUbJFSGCXMOQfAVdBRKHegPcZEa,dFCGBDACHFEBeCCD..PBBBEFDALGFE..NCEETBGEhAAAIABF.UBGGbACA.hABAFGAG.CEAA..MIEChAAAfEAGADDC.KGAF.cGGFaHAEDCFFSDGDhACA..hADA...,1,-18,-21,3
bcPNVXHfeDEdJRAWYZCQMBTaSOUgGIFKL,ZGEGCCHDBDFASACD.UBEGIADDFCHD.KHFGLFFEhAAA..bCBD..cFAChABAVFDBHBDG.hADAfGABDAHBdECEABBH.QAAG.hAEAaGGA.OAFG.hAFA...,2,-27,-16,11
dEfRVgGAacTFMUDYINJXZbQKWHLBSCPeO,TGFBMAHHUGFD..DCBA...IHCDXAEHZAEDKDFBHEADhAAALABFCEHD.OEAAhAAAECGF.RGBE.gACEhABAAADHaGAHFFDG....NCIA.QEEGhAEABDDB.SDDDhAHA..,1,-9,-23,14
BVIZXDGNCOPSFAaMdQTRWEcfeLKYbJgHU,MBGHdGGGRCEB..EBGCeFEFLACHKFAF..JFCBUFBEBGHDZBABDGGBCHAD.hAAA...OAFGhABAFCDCAFHG.QDGChAEA..WBBB..YEEF..hBAAgADE.hBEAICAA.,2,-50,-4,46
JXUeEIAQTNVgGCPHfYFaWZdMRDKbLBScO,TDGCVFAD..GABECHGEHABCFGHFZFDDRGDE.DBGELAEGBFABOCEGhAAAUDGB...ECAHIDDHhAAAAHAD..NCCC.hABAfDACaGFG.MCFASDDGhACA......hAEA...,2,-21,-12,9
XTDEeLNfBbVWUcaSAICMZOgGYdQKFPRHJ,MECAOAEEGBDDdCBAFDEHHFFA..JCHDDIBC.eAFGLAAFhACABBBCbDAFUFAE..SDGAhAAAAHHACCGC.gGDBhABAKFDF..XGEENEAG..hADAfACB.hAEA...,1,1,-37,38
CIDVJKANHBEPRGTdfFUOcZeWbSXQYgaML,BDAEREAFdDFGUBBEODCA.ZCFH..eHDCSAGAQAEB.hAAA.aFHDMAABLHCAhABACDGHDAHD.VABGACIBHFGHhABAEFAB..TECBFGCB..cEDH..hACA......hADA...,2,-16,-15,1
YgOTGFdIePWVbARJMScQELBDCZaHfKNUX,JFCESGDA.QADDBHBFDGIBZDECHAGDKCBEUEEB.XFAEhAAAOAEAGGDFhAAAFABGIHHD.WDDFhAFAABEAMCFC.EDAGaHEE.NCIC.....hAGA......hAIA...,2,-43,-10,33
NZaJDMTEBdUbKfLcgFOVSWIPCeXAQYHRG,QBAHREECGBCEZBFAaBEBDABG...EEAHBGEE.UGABKHBCLAEEhAAAFEAAOBGDSGGHhAIAIHHDCEFAAFIH..hAAA...NBDAMAFCdGDAfBBA.hABA......hACA...,2,-30,-16,14
aLgfbVHCKcQTIRdAZYSeWUMGOFNDEBJXP,ZFEAeDCBMBAHGAABFBFG.DIDCBEHG..XEADLGAC..hAAAfGGAHCCHCHAAKBBDhABATAFDdHCDAIHC.SHAChAAAOCFE.JDDA.aFFB.....hACA......hADA...,2,-24,-13,11
ZCBKPeXWSTbJNAURQdOHFEgacLGVDIMfY,UDACdHEDOGAEEBCC...aAGBLBHD.DCGDMBEDZFFBKCEDhAAAXEFD.TCABhAAA..bGAAAAFDHDCBhABAcABGIACD.CHHHBFHBeFHHJFEDhABA..RBGFFEAH..hAEA...,2,-15,-10,5
CBRXVKNceWMUaZIPAHdFfgOGJSQEYLbTD,FECHOCFGGEED.QAAFECBELEBEDADFBGHFVFGDKBDCeAEGhABAUGBBZCCC..AHDFdCHChAGA..fAGDhAAA.SDFG...YABEhAFACHAA....hAIA...,1,-23,-27,4
CXUFKILBGENagYTWeZMcQVRDAdfSbJPOH,dFBFSEDDJCGD.HAAHUBDCFCHDLAABEDDG..aAFE.TFFHhAAAeHFEMEAD.hACAQGBDDGCFAGACfCFEhADAOFFECEECIEBBBACC...gADFhAGA.WHFGhAIA..,2,-32,-7,25
ELSCXRaVKDFAMZWYcQPbBJUgHeTOGdIfN,MBDBZCDA......YFHBQFEBBGABJGAAHFEBOAEFhAAAIEAFEDFHCHGCaCBDhABAKAHBAFEB...WECDhAAAPEHD..UACDeCAFdBACNAHCSACChAGA..RDGF.DBIBhAIA...,2,-18,-10,8
VYMHZUJQdgGbPNASRfaLTWeDcOKFEXBCI,REDBaCBFLCFF.eDAGDADCKAHB.EGCHCAAG....IFAHhABAMGEAZEBEQGGBhACAdBAC.GACBPHFGhAAAAIFESBHBTBEBOCGFBHAH.YCHFhADA....hAFA...,1,-18,-25,7
HSaDGUegOPBALKQJNMZRIWFTVEXcdYbCf,QBGDMEDDRAEE.FFDGEDBBdADC..CGHCHACBDDHFUBAC.eFBHhAAAOEFCBHGEAGAHKAAAZBEB.hABATCGA.XFEGhAAA..cGEBfEAEaGAB.PHAChACA.NIEB...hAEAWAFE.,2,-34,-3,31
SFMOWdVXJLfKQRYcEGaCAgNHeIbBUPZDT,HGFAeGACBFGAZADHDCGFFBAEMHAE..OGDEdABG..JFCGLEFChAAAKAFE.RDBAEBDCCEHCAIAE.hAAA....NIDDUAGDhABA..SCBA..WDAFhACA......hADA...,2,-37,-27,10
LNWAdEBQcKgYJeUaGZPHXFMfVCIbTDROS,EFCFBCAAKCAAJECE..eCFEUFGBZEEA.HABGFCCB...MEIDCGDE.hAAATGEERACE.OHBEhAAALBHFABHE.dHAHgEAHhABA....aAFD.PEAFhABAfAED..hACA...,1,-16,-38,22
WGSXRNODZLJHYUPVfTIFEaBKbgdMCecAQ,QAECGBFARBCCDEEBJFEBHAAE..UDABVDAD..TGGChAAAEFHHBHBHKBCHdGCE.MEEEhABAeAHBAAGA.SFEHhAAAXBGA.OADA......hACA......hAIA...,2,-22,-10,12
KgBZaSANYCGIQOXURWLFJfDHVeEMTbdcP,CBEBGAAA.QGCGXDFB.RCEHLEGFJBBC.HADEeEGHhAAAMAIFdHCHKGAHBHFDZDAEhABAAGAENEIE..OEEFhACAUDCC.FAGDDBHH.EHAC.......hADA......hAEA...,2,-30,8,38
bCBDdaHUKfILeJFEGXSZAVOQYNTWcRgPM,OGEEQECE..TEEERBABMEFBBGBBDHGEHBFEKACGLBFAhAAAJDHBFFAB.EDDH.SAGChABAAHDD.NBBC.cAEGhAAA..bDGFCHBCaABAfCCF.hAEA..eFAD..hACA...,2,-22,-14,8
JbeMBOIGTcZLaCHSFUQfDgWdYNKXAEVPR,EGFFRGDAeBCB.BBHFOECGGCAGZFGHCAFBHCFE.FGAHQBDChAAA.DEGCdFCFKCGGACABJFFAhAAAMIAE..IAFAhABALEAF.UABA.gGCEhAEA......hAHA...,2,-18,-17,1
fGPJBaOeDAbTLEMSVcgdCUKWQRFZNYIXH,TDFEEBEB..VDDFdGBCCHCB..UFAAQABHFGGEZCGD...hAAAIBFEHBAEPABAhAFAaEHDDEAG..AIBGMIDEhAGASDDF.KEEF.WAAD.YHFChABA..fGCBhAHA,2,-42,-13,29
bCTHgeBaIAdfFENVLOKMDWSUQYZPcXRJG,FEBGEGACLEBGOEGH.DGFGUAFAZAAD....XCCCGABFCFDHhAAAHGCABDHHAHHHfAEDhAAAKCDHMBAH.QAGGhADA.cEGAJHBEbFED....hABA......hACA...,2,-31,-6,25
TOSRHJcLegMfadWbCAEGKIPNZYFBVQDXU,ECECKBFD....IEGHNCBA..ZFBBBECAQFEADBIBUGDChAAAOEFAHBAEJEABeACFhAAA.MFIDdHGFCCGAAAIDPAEChABA..FABA.TGBAcGDCfDDDhAEAaGGFWEAD...hACA...,1,-20,-26,6
TBdLJHZFVYAPQRefWKSbCcgOXUIaNEDMG,REGFeEHFKCBA.CFDG...OAHHUCDG..aCGCDEBE.GEDGdAHCLABDhAAA.ZGACYAEHhAAAAEAC..fHEBhADASABEgEFFIGBGNAGAEEBFMIAAhAIABAFA....hAEA...,2,-29,-25,4
XeFaIUKLEYWBGbNTcfPCRZMJdDQSAOHgV,OBAHHCCEXEGBFGEE.UBGCEFADBCGBGEAA...NBBF.fHGFhAAACFEE.MDDChABADACGAGIHeEECaFCDKGFAhAAALECB.WBCC......hACA......hADA...,2,-33,-17,16
DPVMKdOLXaHUbYBRZSAfIWgGQcJFTNCeE,..IGFDGDEHJFAEFCCF.CBBD...eCECEDAA.DFEG..VADAhAAAKAGGdACHLFHHHDAFbDFEhAAABHCB..SGAAhABAAACBfAHEWHFAQFDA.hADA.NIAF.....hAFA...,2,-21,-21,0
XcEDFQLNIaVJdMTAKeYWGPCgfBHRUbOSZ,KFDEeAECGAACCHHE.BFGGHCDBUAGFOGFGZCEG.EGDH..QEBAhAAAICFAJCAD.hACAdAADMHEEABIH.PFAHhADAfCHG.SGBHDIGANDIA.aACDhABATADG...hAEA...,1,-13,-21,8
TaAYUXFDfHNRdVBOcICLPGKQbWZESMgeJ,XEADDDAAHFFDRECDdCEABBHD..OGEECHACLBAGKADD..bAFEhAAAEAEA...MCEDhAAAJEFGAHIBFCGH..NACG.IEADhABAQGCESFHBeBAH.aGBFfHABhABA..hAEA...,2,-23,-19,4
WaFMNIBUJSCdLXRTYVZGADfgEbHcOQPeK,DDEHEHFGHADEOACDQCFE.eDAAaAGAMFHFBBHEJFECCBEGLEAEhAAA.RFAC.YFAGhAAAGGCFAICGfHDBhABA.cABBWABDIFFGhACASHAEXBFD.hAFA...,2,-20,-18,2
DOWbEAaTMZJQeGHYBPUFfXVIdNcLgSKCR,aEEGZDCAQAEFHBBCBGDGFEAH..fGEA.IGGBhAAANICHLFHB.SAAEhADARBGBOFACEACFhABAMAIDeCAFPCEEXEGAdFFGgGAAhAEADAIFAHAB.....hACA...,1,-6,-14,8
LMTAWUHEBdKGYJNXFaPOQgIRCeZcbDfVS,UECHEAADKHAAGAAH..JHDAXAEF.FFGHODBC.hAAAQAEBIAHBeHCAhABAZECEDACBSDGChADATBGDAGGDBFGEdDDB.aEGA.....hBGA......hCAA...,1,-20,-29,9
SaJQEcPFOXeRZDKfTHdLACBNIUYMVWgGb,BCDGUCCGMAAG..VAGFGGDF.SBHBaHFEQADEhAAAEAFB.FDAAeEADZFFCDGEFhABATDGDHFBD.AHFGCABAhADAIFCA.WABAbDFE.....hAGA..cEFC.hAIAOHAE.,1,-7,-10,3
LMHdfSGIYFeBKXJgQZVCRUbcENaPODWTA,MFHBdDGAGDBFFCEABGFFKGBC.....JGAAZAAF.CHACUADCEDGC.hAAA.aDAEDEID.ABFCHFDFhACASBAH.IACHhABAXAGHQEDF.bAFEcFFHhAGAOHCE...hAIA...,1,-23,-30,7
FfUHGNaSbeKDEdRJAVWMcILgYBXQCTOZP,VEAGMFCGLHDC.BDBGXCCECDCEZBFA.FAEGHFADGDGGhAAAaABB.SGCHhABA.KGEFDDAHEABHRDGHAHABIAHAhADAQACHODED.....hAAA......hAEA...,1,-10,-21,11
afDQJegURMGETVZPYHKAONXBWdSLcCbIF,OBHBBBCASGFHLBCBCCAEFFDF.DECFeGEE.RBEH.MAIDEFHDZGAEhAAAHDDG.AABFXDAFhAAAdFAH...IAFChACAaABG.fFGB.JHAG.hAEA......hAFA...,1,-23,-24,1
DBgLOHePKGaRCAJIMSZdWEcXVbFQfYNUT,.MBCCdABDEBGD..VDEFFHAEQDCH..YAFChAAANDFA.DCGGBEHBgECDhABAOEGBPCAGhAAAaCCECHFG.AAEE..SEBDcEAC.fGDGhACATGGA..eDHDhACAKAHB..,2,-32,-14,18
HecPAQCIgaNLRDYMSTVbWUGdZJKfEOBFX,CHBDaFABLBAF.RFDD.DGEF.MCDG.SACCVBDFUBGEZDGBhAAAKFFCEEDH..BHGHhAAAFDBAXFBHeDBHAFAB.hABAIHHB.NBEB......YFFFhABA...hACA...,2,-35,-18,17
NDWfdgFVECZPABeXRbGJIKcQaTSHOMULY,eGEAXBABRDCFGCAGKBGH...QAGEaFDFHADAUDAF.hAAALHFGDEFGfADDhABAFDECEGAECGGBADHGBACDhAFA.IHHGcDGESHAGOCDGMFFAhAGA.NIBH.....hBAA...,2,-10,-8,2
MGWSRTPYbVUfJFeQXcaANZKEIHCLgdBDO,KFAGHECDCAHH.LACHBEDC.MEECGCABSAEGRGCE.TFAFhAAA..bACAVGFEhABAJEFG.eCHB..XAAFhADAAIAGEAHDICECDFIFOCFEYBBDhAFAFHGCaHAC.....hAGA...,2,-21,-2,19
NYFUcPGWVTXOCKSRALgIQDMEaZJBHdfeb,LDFFQDFEMAHDEDBCZFCFBCBE.dBDDeAEE...bBFANABDFGAGhAAAUABE....hAAAPHECWDEDTGGHhAHACEBGKEGC.ABDC.DIAEaFBHJDDHfHEB.hAGA......hAIA...,2,-31,3,34
XgCQRIYWeFMVDJbdfEPcSNOULAHTGZBKa,TABEZCEABFHF.KBGAaDEE..CCAF.REBD....IBGDeAAEMFFBhADADAGAdADA.EGFDSGBGhAEAOEFEADDG.XEBBhAFA.QGGB.WEEFhAGA..FBAH.JFAH.hAHAfHDBNIAB,1,-17,-41,24
bYdKCgTVWEIUOGceAMBSZLHafDJRXFQNP,BCAHLECGaFGH.DEGHRDEF.FGDG..QEAC..bAADdDCHhAAAKBEDTAFD.EACBhABAOHAEeDHDAGDGMIFAhAAASHCCfFAENIEHCAHB.gCGBhACA.IAHC.hADAcACB.,1,-5,-30,25
geKYVBMfRQcTJZNDIAGOFPWHXdUCabELS,GAECFACCHCCDdHBFUGEDCHFA..EBCBSBFHKEFG.BEFEMBBFhAAARFABQBAGhAAA..JEDFDAECACADPEABhABAaDHB...gGGBeFCBfEEEhABATCGE.IHHHhAHA..,2,-33,-4,29
CTPLSKcJAaMVHOegFdURfZBIGEYbXQWND,aCABHBCE.eAHBFHCCRAFFZGEA.BHCCGGEBEEBC...XDGDhAAAQEFGDDCC.PFAHhAAASAHBJBAHAGIF.MABEhAFAgAEEdFDF.fEDCIFBAYBBChBAA...hABA...,2,-12,-10,2
UTBFYOALegbJdXNSEIVZCaKWGDMPHcQfR,LEAGeAFC.JFECXDDD.SDGGIHFFCCABaFHBGABBhAAADBBD..MHDEhAAAHCGFQACFhABAUGABFGDHOCCEAIHCbFABNICHECCB.KCEE....hADA......hAFA...,2,-17,-11,6
NaYHdFTCeIKXgJRMbfBPZSUOVEWGLDcQA,aGBDHBDG.TGDECCDF.KEBCJGDC..MABEBBGFZFFHUDFC..hAAAEFADLCADDBIHAAHCNEED.hAAAdABB..eCBGIGABhAEAXGBD......RCBDfGGDhAFA..hAGA...,2,-40,-6,34
WVXNdbRJBISTAeOPMGacUCDfKYEFgQLHZ,eHBEODDEMAHHGGBDUABHDGHD..KEDHFAHHLFFEHACFVEAEhAAAdBEFRGECBABH.SGFBhABAADEGaFAC.CEGHEAEGhAGAQCAF........hAAA......hACA...,2,-21,-11,10
DfKgNFReJPZAXdETMBUbcVOIQYSaHGCWL,dEBDEHDABECCUGDG....VBCGOFBB.QABASGBDhAAAGBDECEED.WAFGhAAADGGF..KCGCFFFGeAFGhABAJBAHAHGBMEAH.IHHHYCHH.aFCD.hACA.fDHAhADANEAA...,2,-36,-11,25
ZKAQeYbVNCSRFLGDJWEaUOXgITMBHPcdf,QEEAeFGD..bBGDVABH.CCEA.RCBH.FEBEGGAD.JDEDhAAAaEHFXBDF.hAAAIFHFTBGGBDADhABAPBABdHFF.fFAGAAGE.SHAGhADADBGF.EGDF.hABA...,1,-15,-16,1
aQbVcdWTADUCMBLPHISYXfJgeKNGFZEOR,CBABMBHDBDBEHDDB.SGFH..YFDCXAEG.hAAAfACCeDABGACChABAZCAERGAEaHCE.bDGFcGDEhAAA..TAGGAIHCDAGGPCFFgGAAhACA.NAFCFGHD..hAEA...,2,-22,4,26
WZBOJMATgSVdUDLKPRCGNHfFYcbQEXeIa,SBAAdCHALFEEKECACDCDGADFHBEFFGEF.....bEADECAChAAA.XGAGaDABBGHChAAAODDAAGGD.TGEEhABAgDGHDACC...NIAD.cGGDIAGChABA.....hAGA...,1,-13,-24,11
cSMfgRdAFECBZGTNKbWHIeaOXQUJPLYVD,FDBEEAGCBCCHZBFCGAADKAED.HEEB.aFAFXFFH.QDAChAAAJDGHLFDDDIECSCGBhABAMADE.hAAAfFDG..dHADAFEECBBB.TGAGhACA.NDIE..IDEChADA.,1,-11,-37,26
gdVZeDERHWaIATCKFYPBQXOSUGfLJbMNc,CGCHKGAGFGEBBCED..OAEBSGDF.GBBAJBFG.MAADhABA..NADC.dEFHeEEGhAAAEGGARAECHCAB.aBBFAIBC.hACA....PFABXCGGUGGG.bCFEhABA......hACA...,1,-22,-25,3
FRVeHYTZLDGIQSNgKMOCUdPAfXbaBWEcJ,XFDEaFFABDGF...EGAFFFCC.RACDHAAFZBDCDIFCGAEBQAAHhAAA.SBFEhACAKHACCFAD.UEADAHECfCEChAAAcGGF.eHEATDDA.IEHEhADANCIGMEAG.....hACA...,1,-4,-20,16
VDgFbXdSEHeWPJUCKOcZNMGBITfYaQALR,RFBDDDGBFCCBdDCFHGEC..eAFEJBFD.CHCB.KABAZFFA.GACHBFFF..hAAA..TDGEaCFGAFHALHEChABA..hACAbADFEDAF..WBAD...OAHDhAAA.MFID.IHAChABA.,2,-31,-22,9
dMIJAHKNYcPSbGEOfVgXTZWBDaCeRFLUQ,HDCDKAFH...NFED.PECBGGCF.EDAAOFGD..fBGHhAAAXCAFZEEDBBBChABAaAHHCADAFGADLDEChAAAdBFCIHHAABBGSADC.....hACA......hADA...,1,-16,-25,9
HXPNQSWCBTRbeIfgMDadKJOUVEAYcFZLG,FGFDLHCAGCAGXAEGQADC.CEGA.RDCGeFAD.IFGGhAAAfFCC.MEDAhAAADADFKBGHUAGDAHIFZBABhABANEIEBHAETFCH.aEHFOCDEECFB...hACA..YABHhAFA...,2,-22,-1,21
YOZcKPSHAUNDMgQaCRLdXBJTbEFfGeWVI,DDAEQEDFRFEDLCCBBBCG...TBGEFBHBeEHD..VCAFhAAAIAEDOHFEKGCHhAAAHGBGUGAEMDDAaEEG.hABAXFAC.JACCECEGfFGDhABA......hAFA...,2,-22,-12,10
aVZWdXMRcePSYAKUTLQgIOJHECBNFDGbf,TDEBLCCE.QFFHOCAGHDAGCFACBHBHFGDADBFCGDDGaHGAZGAChAAAdBGCMEIB.eEBHhAAAPABEABEA.KCGHIACAhABANAIG..fFABWAHB..hABA......hAEA...,2,-13,-12,1
GYDAFHaSbLZWMgQefJdBcRICOVXPNEKTU,aDGHLADBZABD.MAFGeFHFdDGFBDEG.RFDH.IFHG.CBAH.hAAAVAFA..NHEDKGCChABAUEBD.DAEDAEFBFBGASAAFhAFA..gDBDfCHC.hACA.OFBH..hBAA...,1,-23,-31,8
BZacDeYQfFVbEJXCNOSLTgGdHAWPRUMIK,RCEEUECEMGBABHCH.ZFFGaADF..eBCCQGFEFHAG.EAGACHHF.hAAA..OHCELCADhABAGABAAAGE.WAADhABAIEFHDFEE.VBGFXGAC.NBIESDDGhAFA..hAGA...,1,-15,-30,15
feLdGHBJVXDUNbEQaOgTMZFcAWRPKISYC,RECAKACC..SBGDCCEBLFFGdGHGGEBCBEAF..JAADDAHHUBDGhAAAEHFC....QAAHhAAAaAGF.ODFEhAFATFACMDEFFGECAICG.......hAGA......hAIAWCHH.,2,-39,-22,17
MfRXHCDAEIJVaNYBSZdgKUeTQGbFOcLPW,EADAJEBC...aBGHBFGHdGGF.KACEUCAE..QBDHFDEFLFBGhAAAMBAH..fAHGhABAHAFGAEGA.IHEGhACANIABZFAA..gFEF...hADA......hAGA...,2,-30,-30,0
HePWSNMOJLGRBEfabVYcZQDgUICKXTdFA,eECASEDHMEHFLABBRBFBBCCG.EFBDaHGG....VAFDhAAAZGACDBABUGEAKEAHdADAABCA.hAAA....WAHHhAFANAEDOFFE..fHAB..hAHA......hBAA...,1,-19,-37,18
XcaeMWZRKLIdYPOVJUENbgTGCQFSfDBAH,XBFAeABGZCEFKAFCdAAA...ODHFJBDBUGFE..EDDB..hAAA.bFBFTGDE.hADACEFBFGAAfBGFhAEAAADDaHAC.MGDCLAFCIHDEPCBD.NDIG.hACA......hAEA...,2,-21,-16,5
fICNAZScGRDgaEBJOVUbTHdKFQYeWMLPX,ZCEESAEDGEBHDGGDEFGG.BEGG..VDDBUAEFHGEEFDAB.eAFEhAAALHAEXFBHhABACFHH.ACBARBFH.JCAFTBBChAAA..KABA........hADA......hAIA...,2,-33,-4,29
fQAdWSRGZCNEBUFTgMDJaLOPXHbVcIYKe,dCEBRAEACDBG.BDFG.FBCFMBAE..DAFEaFGGLEBF..PBHDhAAAHFFC..bAABIFEFhABA.eCAEhACAAHEASHEAZGCCEGHFgFAFXAGA..hADA.....YDEAhAEA,2,-45,-12,33
dTcIBRaCWLeMDEXJNPHgfUFOSQZYbKVAG,dBFDTEABBDHC.CFAE.eDHB.DDDBEBBE..XAGDJDDG.HEFHhAAAUGEESAEGhABAZDBFKEFG.ACCGIACEhAFA.aBBHMIACNCEGfGAGOACA.QGDBhAGA..hAIA..YEHB,2,-39,-9,30
ScGMDNTIKOgVJEbeXfQCLFdRPaWYUHZAB,BHDGGDDEDFGG..ICBFKBFD.OBEAJDBG..eBAGfGGFhAAALAHDdHADRFAB.hAAAaDHDUGGBAEAA..SECFhABAMEFD.NACH...gACEhABAEBHFXGEHCGDB...hAEA...,2,-34,-10,24
HMPFTfIKCXbLORSEcYAZdeaBVNWQJGgUD,ZEDDdEGHBAFC..NAHA.QBCAGEBEDBDBHAGF.FGDEIGFChAAACFCHLAAH.SEAAhACAECAEAFFA..hADAeADG.aGAH.WHFAUGGD.MIAGfABGhACA..KDEBhAEA...,2,-25,-16,9
MHVFPQYCTOcRDAeUJKGZNgbaSBWdfXILE,eECDUAAGKHAAZBEH......bCBCSDEFBFFBdABDXBGBhAAALGEEMCEC.hACAVEAEPHFC.CEHAOFABhAEADDAAAHFHJAEC..NEEE.aDGD...WAHBhADA.....hAFA...,1,-18,-29,11
aEUKMAbFSZJDRWLTVYCPdIXBcgHNGeQfO,SEHFJEBA.DCGDRFFHLADC..VBBFCDHBdAHEXAEGhAAABHHGHCDEGGABhABAQAADfEDGhACAEFEFKHBAAFGHFFAG.ZEEH.......hAAA......hACA...,1,-12,-27,15
LQWcBKTIfASONaRUJgeYVGFCEXdHMDPbZ,OEFAaEFG.UFDGeAEGGADDEFDH.dCCHDGFAZEABLCCH.hAAAQDACBHHGICABhABAAGCHSABGhAAA.NEIGJHDEYCFGCGAAMAIB..WGFE.hACA......hADA...,2,-25,-16,9
RBgLPZXWCcMNeSUTJbDKGdVIOEfHAYaFQ,aCGFQGAFBADDLBFCZAAGCDHG..MDDASGEF.UCBEhAAATGGCDIFCdGAHIEBHhAAAEDFD.ABGCREECXGGEhABA..WFCHNFAFeDHHKAEB....hACA......hAEA...,1,-20,-24,4
aGgIXBOcbYQUVACDPfKLReJFZWHNMESdT,DAACKFCERACGeFGBZFFH.HECC..MAIBECGAdHADGAFC..IAFChADAXCCCBBBG.hAAAODHDbFAD.YBDAhAEA...QGEHABBDCEHGfHDFhABA.FCAHSDDChAHA.,2,-22,-14,8
ZUcITGYREJVDWaFMXQSNHLPbfBKCdOeAg,UEGGTBEBGDAC.EEEFJAAF.DAIDFABD..QDGAhABASHCGHDBHLEDFhAAAbGBABGGFdAGGOAEFhABAACCGZFEHIHHH....YADFhAEAWADEaHACMIFA...hACA...,1,-5,-17,12
TSHFEGgOXKMBJdYWLIRaQeUPANbZfcDCV,ZFBFDEIFCDBDSGDB.FCAGEFBF.OADCKGGDBBEC.dDFBLFAFhAAAREFE.aGFGQAFGhAAAUDEDACAA.bDBEhABA..fABH.TGCB.hACA......hADA...,1,-26,-34,8
dXTBDFIGSAeEMZKLUNYRcaOQPWJCfVgHb,MAFCKAHBLEHBUGBE.RBAE.OAAD..QDDFJCFF.hAAACGBD.VCCDHDFFdHGDXAEChAAADFHH.FDACIHEHhACAACFG.EADBNIDH...aEABWFAEfBHGhAEA...hABA...,1,-21,-23,2
EPNLMdCGcRZYIOKVFSafgJbXQATUeWBHD,eDFAHFECEACBLDEFCDDFGAFARAFGZEAG.OHFCFBAC..aDHBJAAAXEAGhAAA.AEEH.UADGhAHADICCMIFG..hABA..cGCAIHAHKFFC.SDAEhADAfFHA....hAIA...,2,-22,-3,19
XCPKFLaAHfZVORQTceYUDWdBgMSIGNJEb,ZABBRFEDQAECeDDEDBHDBGAD..MBIHGFBBJAAH..EEDACFHEFGGChAAAADEA.HADC.OEAGhABATDBB.cGCHhABA...WAHFSCHH.NIBF.hAEAXGGF.KADFhACA.fGAC.,2,-16,-14,2
fDRUbKXeYGOcHZIgMTFVPCWaNAJdQBESL,JFAAQDCDBDDE.SEBDLEFCDIDARDFHKAHD...XACFhAAAeGFAGAEDHFGBgAEFhABAMAAAFCBHCCHA.hAEANIAFAFIHdHAB..fBBG.YGCGhAIA....hBAA...,2,-30,-12,18
fPeSBRVHcgEGCJbLXATaNdWODKQYMIFZU,TABEdGCFOCBF.KAFDMDDD.ZFEFUEFEeBFERABG.HEAF.EGHBhAAACEAFLHAGAEGE.hABA.aCDFDDDBICFHhADAFGHD.SDHHBBHH.....hAAA......hABA...,1,-2,-38,36
DMeCaTAXGNPFbcUSZdHVYWRIfEJKBOgLQ,XDCDGEEHFBGEUGBDZDBEdAEC.HAACVFFDRGDE....EGADBCGGhAAAOFBFQACHhABAMDAG.CAGFaAHDAHID.NEAG.hACA.....cEGFSDGE.hAEA...YBBFhAFA..,1,-12,-16,4
gJeYBSDLNcAIaKTVZMGRXUfCHbWdOFEQP,KEGCZFFDMEBHRACA.UADGCGHHHCCC..dGDDEDABQCGE.hAAA.PFFFeDEFSBBBhAAADAIDLFCFAEDBTAFAhABAXAFB.fHDDOCAB.FBAChABA......hACA...,2,-23,-12,11
JVRaGgQXYMebSIFdHZDBWcEKALfTCNUOP,LFHFTGDG.UCECOEBC..PADARAFAGBAH.QCGEhAAAXGDGMBHDhAAASEAFdDBBDCIBBHHBhABAEBAFAGGBfFFH.CGAAJDDAaHAG.YADEhACA....hAIA...,2,-22,-13,9
EAZaHNOgRXYSbGVUfIdBDKJcFMQCTePWL,HGAGOEEEXCAB..SCCAVBFEUEDFdAFDBEHDDACHKCHHhAAAFADDMIEGCGAH.eEGDhAAA.LAFChABAABDCNIBFRFCG....YBAH..fABFhBAAIGHG..cCFBhABA.,1,1,-50,51
dbWDTAHBEeYSaLONFgGQKRIZXcCPfMJUV,BGGEEAHB.SDBEOBAA.FAGBQGFBKAAF.ZECFCGDAMFBChABAUCFGdCAC.DFFAABCDeFABhACAaGAA..NDIGGBDChAAAXDGF.PADF...fGFGhADA...hABAbBEH.WHCG,2,-28,-12,16
ZETBfCWGHbgKSUaRPAFcIDdQOJNMLXVeY,FDHDDBGCdCFCQABC..OGFGMIAALFDAeCCHZABDEHDEhAAABFAA.CCDBHAFCKDGEaAEGhABAAGHFJDAG..XEEChAHATCFA.....fFBGhAIA......hBAA...,1,-19,-31,12
DJQULVTfYeENbZBGFdHMPXacKgROWASIC,CEDBQBAGUAAA.LEBG.VFGFTCEC.eHFCEAFDZACHhAAAFAGGdEAAMHCAaBDGKCGHhABA.OHACACHE.IAHEhAEADDHFJGCG.NGADBFFF.....hADA......hAEA...,2,-38,2,40
PBNRLZbOSHEQGecaUTgMKFfJDAdVIXYCW,dGGBVBED..XBCCCGAG.BFAHRDGDLADCOFDFHCFHGBBAhAAAaBAHUGGB.MHCAhABAKAEHfHADhAAADIDE.IDDD.WHFGNAICSCADhACA....EDHFhABA.eEAE.,1,-7,-14,7
VaUMZYeFCgNJdEPbQHLKABDSWRTIOfXcG,BBAFSFCARCAA.ODHBXFEB.GGAHUCEBMAFCZDGFFEBEhAAACBEB....gDADhAAANAEA.EGFGPAFGhABAHABHAIHEDIDCIHBEfGGG.aBGEhACA......hADA...,2,-23,-18,5
RFMLQENcSDbfdXWKOHJUBZTAgGaYCVPIe,aBFFVFCE..eFEBFCAELAGDEDCD..NCIC.SFADhAAA.DBFHbBAEdGGGXDADhAAAOACF.UGADBEABhABAAAEHgFFBCEEE.IHDCMIAE.hACAfABHWFHB.hAEA...,1,-8,-29,21
KIQTJXSAMYURaECGWLFDgOHPZecdVBNbf,MBCFRDDECBAG.GAFAFGFB.DFFEHGBAZDDBdHAFBEGA....fEAGhAAAIADAJCBGSGHFhABA.AEIHaADFhACALFBE.OAFGPHDA...eDCHhAFANEIEKAAE....hBCA...,1,-7,-34,27
JFGYLHEaACbTcWZdBDPUKNVQOIMefSgXR,TCGGZAFBBEGF.DAFHUABD.KHAAQDBF.MAAAfDDGhAAA.XGEChACAFHBALFHFEAFHCHHC.hAEAWEEHdEBC..PFFANAIGOEAHIAHGhAFASCCC...hBAA...,1,-25,-28,3
ULOIENcPVfZQTaRWeXbGJHBAKFdgDMYSC,FAHHdGBHDFBAMFCA..CFEELABBOBDC..EDDE....NICH.hAAAVEGBZCGB.QGDBhAAAaAEB.eBBFbGEE.hADAJEAFBAHDAIAAKACESDDG...hABAcBEE...hAFA...,1,-18,-32,14
CTRIcLeVUYfZXHbDWgEPMKAJGFdBNaOQS,FFEEBEDHOAEBCBCD..RFFBLAEAUGBBZAAGHDFGDAIH..EAAFKAHFhAAA.ADFE.dFAD.QCAHhAAASDCH.IGHChABAeDHB.VCABXGDH.WDDChACAMIFA.....hADA...,1,-15,-34,19
aSbOJLFIeUBYWXHMQdcPDVKTRCEGgfNZA,SGECJGACLFGHeFADBFFG..XDAFMFEH..dBFGPDDHhAAADCEB..KCAERGFAEDHHhABA.GAEB.hAAANECAACBAaDFEFACFIEAD...YABChAFA....hAGA.WDCB.,1,0,-40,40
GEIdeDFHAMPLQcYWSBZNRUXOJTVabfCgK,LAFEQBBC......WDFEZEAHRCFAUBCCJFCCTGGChAAA..VFCCbAFC.hABACABFKGGG.GDAEhAAAIEHA..DICGADDFMIAE.cACAhAEASEEEBFFB.NCEF..hAGAaHFC..,2,-23,-20,3
NFcITVDBHdCOYSgGMPUeAKQEWJRbLXafZ,KGADEABARDFGLCCA..aFBBZFBCFGCETGFBDAEA..HGFGCEFG.hAAASCDEMFIHeACChABAAEDFQAGHhAAA..JCHBfBAGNBEHIECCBFFEdCAEYHCAhACA..hAGA...,2,-21,-14,7
VBSGPWHAUQJKTMLbfdICaEgZOFcXRYDNe,UDGAJFBB.KEBFMABGLCAE..dDBFCAGG.ECEAZFDBFGDD.REFF.DCGGhAAA..eAHFBABASAADhAFA..hAGA..WECBAGIH.TGGEIEED..hAHAOAEHYBBC.hABA...,2,-48,-23,25
AQgEJHRcPNOZadSTeICYMVfDWKGBFLXbU,ECDCRBBD....PFCENAIC..OFBEdDHAeGFCCBFE..MIFChAAADADCGBEDBEEDXBABhABAAAIHQGAH.hACA.JHCEHDEEaEACIADAYBAF.fGFBhAFAKAAE...hAGAFGAH..,2,-19,-14,5
GbQBVINcXLFeSfWOaAZCTEDJHMURPdKYg,TDGHJDFAHEED.UADBdDDCKGHF.GACHBBBH...VDABIHGAhAAA..NHCB.XGBAhABAeAAHSAHDhAAAOEAAABGB.CFFHDIAEMFIF...PAHDhACA......hAEA...,1,-11,-32,21
BNSEcMTJWZfeCHFIKPQORYGVaAXbgDLUd,XDGFDBFFLDCDUBADBAAH..EFDEMAEE..JEBHZEEDeCEDhAAACBHEFHGGKAGF.QGGHhABAOCAG...hAAA..YHCGaBGHAGGG.dAHENEBE..SEGAhACA.WHCGhADAIAEC.,1,-14,-32,18
cPHRWZedLAJbGYFBEXQMSUCKgODVTINaf,GEDEBCCGEAFAQBADUECH.KHBEOEHHVEAE...TBGAhAAANAAH...aGGHfFHGhAFAHADBZFAHdABHhACALAGDADID.JBDBYFEBMAIDCHHGDGGF.hAFA......hAIA...,1,-1,-16,15
cBAFJRfgGISbQMODaEKHTCYVedXZNPULW,JFHHRCBEGADD..SEFCQEFEDCAGaECCHEAB.CAAA.eHAEhAAAZFDC..UAFAWCAFhABAAADF.FHFC..IHDEhAAAOGCA..EABAKDCE......hACA......hAEA...,2,-36,-8,28
GHWafOIFBJcKdNVQCeXYMRSUEgTPZLbAD,DFAAHDAE.aDGDOEDFBAHCKEDHdCEH..QCBACCHB.eAHBhAAAMAGFRFGH.UACF.EBAHhAAAPGAGZGEGAAFD.fBAChABA.IAEBJFCH...NIAF.hACAXCDESFFFhADA...,2,-26,-20,6
UYIAFNQWLOECaeKgVJcSTDBGfZXbdHRMP,QACDLBCACGFGKEAEJEAH....TEFCDACABEFF.GAGEhAAAfDDFZGBCdDDEMDCDhAAAUGGCAHGGFGCE.NIDB.hABAEBAB..eAHH.......hABA......hAFA...,1,-16,-30,14
FPMDBUNacHCfTZGESQAJbYeILgdVWRXOK,JGBAeGBALCDH..VADBRCAD.KGEAFHGGDBGHBCCGUAAB..hABAaAAACDEHZDAE.GCGEhADASAFB.AEGD.hADAIAHB..WBHH.OCFBhAEANIDBfFACEHAE..hAFA...,2,-31,-28,3
LKOTWQUMIbJYdcDGCXRfeEVAPgBNaSHZF,BFCESGDAFAEEKCADODDG..QFGHMCBH..IGHChAAAJFED.dAFBGDEBhAAACADCXFCGRBCFeHAGhABAAIEA..NCCD.HAGFLEFG...WBAFhABA.YAHBhACADIFEfABC.,2,-19,-14,5
GNgOcReWEbXMUfPdBFSZQVDKJCHIAaLTY,TBDGGCECODCH.eEADEHCCbFABMCBE..UDGBdABFFHGAhAAASADEQGDDhAEAVCAEDGGACCHF.AAIBaCHDLHFAhAAA.gEEDcBFA.XAGChABABHAG...KABG.hAFA...,1,11,-13,24
bTCVOgPQMYeJSfEUKIdGBWZARLaFXcDNH,LFAEXFFEDGCGHCCG.CEGB..OBADQBGDeAEAJFEDEEAHKADEhAAA.dCCFBBHHABAAaDDEhABA..FGHD.NAAH.bGBChACA............hAGA......hAHA...,2,-27,-27,0
RUPabYVWDCNXdJITGfMgeAFLZKcSOEBQH,FHECZAAEKCFBODEFBHBFHDBD..UFFBaGHD.....VEAGhAAADCHHCBCE.dAFE.TBADhAAAMCCGAEEGLHAAhABA.EEGDPHCC....WADHNAIAIAEChABA.fCAChACA,1,-27,-40,13
TbCPJMLVeFOXWRUDdHScKBaIAQNfYZGgE,QGDG..YHDGGAEFEFGBCBGG.JCACLBBHhAAA.FECDOCFHXEEDhABAWFACRBDHDIAGHCGHSEHFhACAKAAEIHAHAADAfGAB.hADA......hAEA...,1,-18,-22,4
GMDTbHgIcJBCaWeLAPXEUYSfdVOFQNZRK,XGEEECDHUBFB...SBBAdHGFOFFGFFCEZBAEKAFGGFABhAAAMDHF.DAEAHDAD.IAAHhACABHAGCDHA.aCHF.hABAeDDGAEEG..fABFNIAB...hADA......hAEA...,1,-18,-25,7
GeFTVEfOBISQCaKNWdYcJbURMLgXHPADZ,ZEAFFHAAEFAABCCG.QGFECDCF.KEFFdEEC.JBEGUGCGLBABhAAAHCFAABABGDFA.hAAAeACCTBDA.fEHEhABASHEGNADD.YFHB..hABAbAFAMEDH...hACA...,2,-21,-13,8
GgJRaDXeTIBAbfcZVLWYMPFEdCNQKHUSO,...fCFCZBABLGCAMFHHEECACCAE.KEGDHADHOACGGFCHhAAARCEC.aDCDDBFEeGAGBGAChAAAACCG....cDAEhABAYCCEPAHFFHGE.NEIE..SHDAhACA.....hABA...,2,-31,14,45
GXNEacIHUgZWeODPfbSdKJLBTRMQFVCYA,GBCGEGCA.aAGGIDECUFFF..ZBEHeBBDDCAG...fAEChAAASBHBdGAGJFAChAAABFFD.MDIHFDACCABAhABAAABGcEAA.WGEAOHEE.KHCC.hADA...RAFH...hAEA...,1,-17,-25,8
ObdAcKTEDRVFGXZYQgJaIBULNCHfMPSeW,TBDHRDBCFGGAZFBG..QFGH.JAABaDFDBDHELADAhAAACAFFHGCAMFAF.SHEGhABAeDDDODBHABBHKCAFhACAEAHDDCDCXEEF..ICHBhAEANEAGWHEA......hAFA...,1,-2,-30,28
XdVPOgQNMDLbIAfKUWYCZeHEGJcRSTBFa,KEADUECBCDBG.eFFEGCDFRABA.BHFEFCAF..dBGB..OGBCQGEHhAAADFIBLBBEhAAAADIF..fEAEhABAZFGF.JCDC.SGAGaEEH...hABA.XBGA.hACA...,2,-32,-24,8
IGgfDSBJNdAKMZOYQbeWXaTUcPEFRVCLH,MGDAZDCHOBAB..QCEEeCEAaGGG.UFAE.EAADFEADCEEGLEHDhABAHGBE.IACBhAEAfEFCBCGHhAFANBBHAAHEKDCH..YHFGWHAA....hAAAcAGF...hABA...,1,-17,-25,8
BVfZLgYAOCbTPHKQRUJXaDSdeFINcMWEG,CAGCTGCHHECHRBAG..UCDB..JHDEaFGHdAEAFAEE....IHBBhAAANBHC.MDBHhABAGCAGBFFCZAAE..hAAA....gEGHAIFE.ODDGhACAKEEDDEIDeAHHWAHB.hADA...,2,-27,-20,7
HOQZVDBSCLTWYJgRcIAXNfbdUKMEFGaeP,XEFG..NBGGdFBGUDBCKACFFGCDGDDG..eAAEODHDhAAAVAEABGGALDEEhADA.TGGFJAHB.hABA.gDACIHAGAIEGfADBhAFA......hAGA...,1,-14,-38,24
aXZTcDFfAVLJPQGBbWKRMESgUICNeHOdY,JADHQDGGGAGCBBBHKCCDRFDA...EFAC..UADE.CGHBeAADhABAdGECXGAAZGACDBBCAIAGhACALEAC.PFFGhAAAMIFCSBFE.IEDEhAGA.....hABA...,2,-33,-15,18
gcNLWaJGEVHedKbOYMZBCIUPQFDASXTRf,TABDRFEF..fBED..NBEDaEFDECAHHFAE.dDEFhAAAKGCGOHBEMCFACDCBICHEhABAUEAFFHFAADCBXDCHhACALDFCWAAFJAFCeBBG..YHAAhADABGHA.DFIBSHGGhADA,2,-34,6,40
bFgNCecIEXWODQHYMSdUKLfTZAaGBRVPJ,aAGEBECB.RFGD...VFGFJADC..FGABCADA..eFAD..ECHFXGDChAAADDDC.QBAHhABAHGCCMABFSDEGhACAdCFA.KBEH.TDACAFFGPACBgCGDhADANAAE...hAGA...,1,-9,-35,26
gMWebDVZLFTSCaQUOdHPRcYfAJBENKGIX,JEFDBAEF.EGBHKGCFGBBB..XCCHMEEE..eAHBDFCGZBGHhAAAFFDBCDAGQBADhABA.dBEGRGFCfCFHhAAAADBD.IABGWFAD.LFFEhADAaGDF..OHFChACA...,2,-35,-12,23
LDcGANWOdXgUFTPEKCRZIYQfaJHBbeVSM,OAACdAAFUGEFFDHF..ECCDCGHG.ZFAG..QDDH.JDAEhAAAHCFF.BAFDVFDHhACAMBIFLAFEDBHHADBB.hADA..NBGC.WAEDXADD....hADAPHACIHBAfEEGhAGA,2,-32,-29,3
JNWLQPbZdMECaIfGeHSYDOgFTABUcVKXR,BAEEVFGD.RBDH...JAEDLDGB.QGAEZEADEBAECEFH.aFDHhAAAGAGGHBBHDIFGOFDDhAAAFAGEAABD..KDDDXDEDhACA.PDAH..MIAGeGEGhADASADF.hAGA...,1,-11,-24,13
EFdBScHZLVJRaKGeMDXOQNAbYfPUgTCIW,...fFFEUCCACGFHECGGBEGD.SBAFHEGHZEAFLAFAhAAAVBEF.aACAGDAFhAAADFEF.OHECABBC.hABAYHBEPCFB.TAGH.FFAB..hABA...dCBF..hACA...,2,-21,-11,10
YbFNMRaZVWJQfAXDSdKTPLIUBgcHCOGeE,DAAFKDDDLFEFBHFEHDFCOAFGGCAG.EAFHFACG.RBGH.ZECD.JAHHhABAAEBHdCFG..IHHHhACAUFGECAAH..eBCAhAAANIAD....MDDA.aCCG....hADA.WFFG.fADHhAIA,1,-11,-37,26
LgdBRaVZXQfGPKAJbOcHMYDEWNTeUFICS,JBCCOBCHHDDDDGEH..EGAA..TDEDUGGACDGELAFG.hAAABABFaBAFZAFAXGAChAAAQGCDGDGGAEABMFFHhABAWEAAFBDF.IDAG.SGGDhADA.dCGB.hACA...,2,-22,-5,17
CSTUGWFgBZaHMNcEdVYOeXbDQKfAPRIJL,REEDLAHHCGCC.UFDGFBECBHDAHFAFMFIH..EAHHdGGCOBDHhAAAeBBADACE.KCDHACCB.hABAJAFHGDAE.ZEGFhACA.aGAHNBAC..........hADA......hAEA...,2,-31,-18,13
dFILCeTbDUWcHONPgGXZEVQYfaMSRKABJ,dBEBFDBECADEeDEC.DAFGUFAAHBCB..OEHH..PFCAhAAAGEDAZGFE.EHBCQAGBhAAAaCBHMCAHKBHBACAFJABBhABA.LFFH..WABC...hAFA......hAHA...,1,-8,-30,22
FeEHQJPgIRcDZTdaMYfCUWXKBLbGOVNAS,FCHBHEECQFEFJAFB..IBHHDEACZAABdAFEMBED.CHEF.XDDEhAAABEABGBBAhAAAVFBF.AHDHEHGC..RACHaGHDhAEAfHAH.WFAG...KACEhABA......hAFA...,1,-15,-22,7
MWISefbDaOCYcATHQgBLVPRdJKXZNGEUF,TFCBQDFF.LHCGREEDdEHEKDAEXEADZAFCGAAH.EGAHhAAAMCBE.IGDAhAAAeCFGDDDACBACAIHGBHHHPAEAhABA.....NDADFFGDSHCAhABAfAHCaEAC....hACA...,1,-5,-20,15
DgVUEYJRWSdQXcOePLKbBNCGHaTIFfAMZ,MBAFDCEFUEBG..EBFBRFEB.dEGH..QBAHXEDBeBCFhAAALAGHKEAABBBF.hAAACBHHHGAAIAEDfHDFhABAABID..ZDFAgGGE.hABA......hACA...,1,-10,-38,28
GPQEJCaXINDHUgBYTAZbVLRMdSfFWKcOe,VABCLCBD.dEHGFFCDKGBF..eEFHGAEHEBGA.aDFG..IDEAhAAADGEGHDCDBGAChABAAEADZAAEMEAESHCAhAAAfAFF.OEHF.....hABA......hACA...,2,-23,-19,4
WAHUKGVPYaIfTbJFRXcZQCEdMDeNBLSOg,HAGHGADAVFFAaGGH....TGAFJDCBFCACRABFZFEB..CEEAdDGDhAAAMDHFDIACBGDCLEAFhABASFACOGCCADAFKAAFhABA..PBBGIDFG....hADA......hAFA...,1,-13,-18,5
JREUGXOADWBLNFeaYTfVHPcCgZQbMSIdK,BGAGFBADeEEEaDEH.....TBEBHBBBCHHFQGBCSFEAhAAAIEACdAFEKEAAEHDGhABAXGGBAFDDLCHBhACANAAF..fHEH.cDCG.hADAbAGDMIAG...hAFA...,1,-17,-23,6
EXJDCFYBHbVWPURTLcIQZOSaAMGNgKefd,MBHDGBCGKEAHeBBF.EBFEDAEF.FFFABGAEHCBDVFFD.UFCBhAAALBAC.QGCBhAAASHAGAIBCfDEHhABAXCEDCDHDYAFC.WABEhBAA......hBBA...,2,-28,-18,10
bOfUFDaXPAKNcIeMYSZVJRBLHdCgEQTGW,KDFG..NEEG.eACEMDGBSAGB.ZFABJAFDLCDBhAAAdACHCHHF.QFFBhABAGAAAOFAAfHDBhAFADBIFaDHHACIBIHHH.YBBFBDCEEHAGhAAA...WFFD.hAIA...,1,-20,-27,7
fIaCGSHXPDcMLZFgKUJNRQdOWAEeVbYTB,VFBFTGCD..BCDCaACF.GAABHCFDXFFCDAGELFFFZBBFFAGFhAAAKEHD..UBFCNBIARBDHdFABhABAADID..eDAGfHFHhAEASEEC.MEAD.QGGFhAAA....hABA...,2,-15,7,22
PAGDVKMYBEgaFOdcCINXeLZURQWbHSTfJ,GCDDDACAMDDAEEBE.FAFEdECG..CBDA.XEEGZAAHRFFH..QGCDhACAHBBESAGAhAAATFAC.fHGHhABA.JHCAADIHKEEDBGADaAHDIFHF.hADAeBEG...WDFAhAFA..,2,-16,-12,4
UEFeAHJYdVZfKTICaSXPgGWMBbQcRONDL,JBHDVBFDZEDF..KECH..CEAF...SGGF.XAADhAAAPFFEGDBEhAAA.BAGAcADBRBBEDABAhAEAEEEHAHHG.dDAB.IHBAaGAH.MAIB.hAFAOFHDNIEF...hAGA...,2,-34,-19,15
NQebMcfaCdHLFKIAPDUVTBJWOgSYRZGXE,DEAGVGBEBFDD..OEGHSAGGZACDGBEB..ECFHeAADhABAMHAGaEEFdCDA.HFGFhAAAFFAGAIHCUBBC.JEFBhABA.......YACC.hACANIAF......hAFA...,1,-19,-25,6
IVeOLCBHAdDJabMQKFWEgcXGPNSUZYRTf,DECCaDBC.MFBEKHFC..FHCAECBE....XBFAGGCDPCABhAAAUEEFZEAA..TAGEhABAVAAC...OGAGhACABGADACDBdFFH.bABEWADB...NCIC..hADA......hAFA...,1,-18,-28,10
JGQbODCfKYSMdBXUgAVHeIWNZRFTaEPLc,VEBCHEDEeBDF...IDGENABE.FBFBaACBEGHHLAEAhAAAGGABOBBBCFGDKCHBMHCAhAFABADF.XAGFhAAAAIGG.WCADRCDGcEGF.....hABA......hACA...,2,-23,-8,15
EfXcZLHJaGAVdgNObSUPBMYQWTFeCKIRD,dAEHODFASGFEBGGG..QAEEFCHHKBAADABEEBGG.XCCEhAAA..LCDEhAAAaABDAFFB.VFAANEIAUEADhABAMFFE..YHAAWFDHCDEF..IAHChAFAfEFD..hADAcDBF.,2,-30,-13,17
SDaXHBVbLgTWZIdQfAREFGKNMYcPUeOJC,EBHBKDGHMICC..PHEGeBEE..JCBGCBECDDED..HFEGBFFHhAAAVFAFLBAC.hAAATFAFIACFfDFDhABAAHHBFBAB.NIAHUDAHOAFA.SEAEhABA.aEDB..hAEA...,2,-21,-17,4
aAGTWEDQBbXHPCfYeNZgSMdIcOVLUJFKR,GGCHTBCG.DDBFBBADHDFG.CDDH.eFBDZAEH.SGHHdGBC.hAAAIDECOCBAUGGGhABAFCFAKFFBAFFDEAGAQDAHhAAA.PADANCACMBBA....cGEHhABA.JDHB.aAHFhACA...,1,-8,-16,8
PLSeJTXEKcQACgdVabGfMIRWODYUBZFHN,CBGDVAFEGGDH..MBBBRBED..DCAFBEFEFFAAHDBGLDHHeAAGhACAXACA.KFDHhAAAAIACaHAA..bCCCIEGChADA..WFAF.OHEE.hAEA..YFCFhABA..NDIA,1,-26,-33,7
dNXDfLaRYgQEZWOKIMbTAPSUCGHBVJFce,SDFECDGAGCAEBAFGFECA..dHFBDFCFLDBFRCCA...QAFDhAAAEHFC.ZBBAhABAKAAFMDIHTEEBAEGFPACAhAHAUAGA...JGCGNEIEaGDF....hABA......hACA...,1,-9,-31,22
CeNHSXWOGMDTLdagZAfKbUYJcIFVBQPER,KCDBUDAE..JFEFFGHHBCFAEFDG...RDAB.eHDCHGAC..XBCEhAAAOACG.GDEHhABADEIHdAGDaAHDZBBF.AAAG.fGABhACA.bAEBIHGF..hAHA.PDGFCACH..hBAASHAG.,2,-27,-6,21
YZcGQNFLeJWVRHgbBSDKTPaOfXIUdMEAC,CHBCZCADGACAFDHFLDDG..eFFEVGFEHBAF.BFAADIAAKCEChAAATCGF.aFECOGBChABAXAEEdACHADCH.hAAAQAGFNIED..WFCB...hADA......hAFA...,1,-12,-24,12
IPNUGScBCdXOLTMDFefgQVJWRZYHEKAab,aFEH..ICAEUAEEGCAFBGBCCCFEdGBDLAEGDBAA.eEDHhAAAQGGA.JDFDhAAAWEHFRAGB.ZCCD.EABBhACA.AIGE.NIBF..SEBA..cGEBhADA.OAHDhAFA.MFIDfACB,1,-14,-19,5
YKNUIOLDfTSZbFERQGMeVdACWXacBgPHJ,CAFFXCAEBABAHGBEKEAB.UDAHLFFG.DBCCTEFGZDEGFAHFRBCBGAGChAAA.MEIHhABAdGCHaAED...cAAGhAAA..gFDEPHFE.NIDD.fCFHhADA.EGABhAEA...,1,-12,-25,13
PDebASVHEZKdULNOGQCacRgMITFYWXfBJ,SACHEDDEKBFF.dGABLGAAGCEGCABHaABF..REBE.MEHDFFHD.hAAA..XDAGhAAABAFFPBHFeEFFAGIFZGDENIEF.hADA.QBGG.IBDD.hABA.....WADHhAHADIAA..,2,-20,-20,0
dDWURLQMJaKYGAHVXgIPBESZOcNCeTFbf,VCADXBBF....IHDDBGACSGCBOAGHCDDE.eFHDhAAAFGFD.dEDB.DFAEUACFhAAARBDGMABGKFDGACIDgGFDhAFAEHAAZDFC.NBIG...fFBHhABA......hADA...,2,-25,-17,8
TKFcAdXHDQMRGZSLBfaIEUOgCYPVJeWbN,dAGEHEDCMFDCZBECBBBA.aCACEDGD.UCAGCGGA...VADHJFBB.hAAAeHDG..NEAEKDDChABAAFACDGBG.QGGFhAAA.SDDGfGDCOBHDgDGGhACA.WBFE.hABA...,1,-18,-25,7
BFMKbdIDRLTOYCAcGSEXJZNQeVgfPUaWH,GDDHSDHDEBBGZAFHQBDF.eEABfBECUGDAaEEChAAABADG.MHCGdAHEIDFBhABADGGHTEAECBBEAEBChACAcCAFXGGANCIA.......hAAA......hABA...,2,-22,-9,13
JXTNPSRKZCWIEVOBfAYaGUQHDbMdFLecg,aFFAQFEFHFAFMCBEdCACeAGH.JBDBNICD...RFAB.CDDHEAEBBFCFhAAA.ADHD.UCGHDDIFLABHhADAXGGESAGBhAAAKGHH.IDBC.fABHhABAYAFD...FFDBhAFA...,1,-16,-21,5
KIJSCVNUPLTGFReWgcAdMXbfEHZYOaBQD,MDCGXCCD..EFBEHCFAZEEC.aBAEQGEFDGAGKFEB.JABCCAAAUFCAhAAALAGB..hAAAFBDAeFAB.WEAEhAEAAIGC..fAHGBHHDSBDA.hACANDIG......hADA...,1,-9,-30,21
EZLRHTdOaJbcBGCfPgSYADeIKVWQMXNFU,DEFGKFABQBBCMBBF.FEDFZACA.LFDBRAEFHDGFdCAGaGHH.JHCEhAAABGAC.CCGE...hAAAfAHGSCCChABAADDG.eFFCIHHB....WADEhAHA.NAIAEHBA...hABA..ODDG,1,-17,-24,7
eNFRWJBPdTIKMgLXOcGfDZaYAVHUbSCQE,UGGDSABBCBDH.EHFAeHAE..FEEEJDBDdGCC.KAEHLEFGhAAAOEACGBGGDDDE.hABAaAAHADGHHFCA.NADD.hACABDCG.IHAAgAGAXFGEhADAfBBC...hAEA...,2,-24,-23,1
GHUEVLgYJCDNAKFWPOXZRSQeIBTfcbMda,FFGCOBBCZABHRAGF..QFFFBFCD.TGCG..fAFAhAAAMAFGaEABHCFHhAAAEDAHLFEFJACACFCCAIFAKEDEhABAXADB.IDFH....hAIAcBGF...hBAA...,2,-39,-9,30
EDbOWaIeXGKNHfgFQBcLUdCZPSRTVJMYA,ECDADIEEODEF..aGGGeABFGEBDKGBDHAFBFBBEBHDFLEAChAAAUBGEdGAGCGGFZACDSDAEhAAA..TDGAhABAMIECAAFFIHHDNEED.fFBDhAFA.....hABA...,2,-25,-9,16
WYBGaFZXIEbMgVDLUdHQSeNPcKRCfTJAO,OHFCBFBGaHACZDGH..EHECMCEC.DBGALCEBHEBD.SCAChAAAeBAH.NDHA.PABAhAAAKGDF.CGECfCCGhAFAJABAAEDA..WDFHFGAFIEEDhAGA..gAFBhAEA..,1,-21,-28,7
CZNHKgMTSAfReaDWdYPOBcILbQUGJXEVF,REEADGCEdCGBOCAEBECGLBEB..bDEFQCAGGABHEAGEhAAACHHA.ZGFGHFAH.MAFAhAAAAEHAaEAB..PHDChABAIECG.XFADNADEKABH.SHCAhABAfGGH...hACA...,1,-8,-23,15
OgUMBGcKJVeZAWIfLQRaDTdbCXFPYENHS,..IABGfEEFLFHDQADDaEGG.TBGBdDCBCFABFGDFhAAAEFACSCBGhAAA.UFGBBCFEKDADJAEEhADAeFDDACIFDCCEXGBDNEFE.OHFEMIAC.hAEA......hAIA...,2,-29,9,38
IaUFAEcdQZVSNKCJGDYbLRXgeTPBOfMHW,dCDFZBCCSDDDCFBDGEED.DGDDLBAF.RCBD.eHEEBGHHMCIDhAAAHGDGaCAHAHBDEAGDVFABhABA..KCHB..YAFEhACA.gFGE.OEEGhADA..WAAE.hAEA...,2,-23,-19,4
YaSQCBLHOGPUFNcIXWfMZRdegDbKEVTJA,aGAASEDBBFFCLBCFGAGGFCBG....NICF.IAFChAAA.XGFDhABAMAEAdCACeDFFgBFAhAAAKEACEFHHJABEAGHGCGEGOBHDPFCF...WEBAhABA.fGGEhACADDDC...,2,-37,-2,35
HDJgNafOVTeKWAPGMdEFSXRZUQYcIbLCB,MGBAdCFEFCADRADF.ZFFHUFEG..QACG..IBAAhAAAbFAD.BHBAHFDDgDBGhABANAHA.ODHFhACAeFHBKAAFAGGGGAFAEDDF.SFADhADA.YHFGhAFACAFGDECD...,2,-26,-3,23
ZMcFWRAdLfbeBGOICVYXgETaNJKPQSUHD,LFFFeBHFGBBAOGACCGFC...XAFFTBEF..NEIG.KDGEhAAA.QBAAhABAUDEDDFAHZEAHFEACAEEF.fDCFhACABCACIAACgADG.EEHFaHBEhACASGGA.hADAMIAG.,2,-25,-12,13
TOKNeVBGCDdFMYIWUXHRcfaZPSLQgEJbA,TEGHKGBBeFGF.BHDHCBEF..FAHHMFAE..IAAHUCBEHAEFhAAARDCE.aBGASDGChACALDDHEABEACFHODAHhADA.VGCGDGAD.dGGHYFHBXGAH.hADAcCBG...hAEA...,1,-8,-19,11
QZYHgMPFTSNbLcfKRDBJOaeAGCUIdVXWE,CFDCdGAF...XBEAQCBFZFGDHBAGMAHDFBEESDDEhAAA.LBHDfEGBhAAADDBHOADAeACAABIBIDEChABAEGEG.YDAF.gGFChACANIAFKEFBBABCGGADhADA..,2,-11,-11,0
ReKUaHAJTGQPWFCNIZbfLcYEXDBOSMgVd,TGDGQGCD.FCADCBDDZDFCLAHF.EEFCBHAH.SBABhAAAgACBRDAAKEDAhABAUGGCaAHDAABDGEABhAAA.WCCAIFGF.fCFDhACA.XFAGDGBBMAGDhAEA..eADE,2,-16,-11,5
WLJOPSFMBHUfYDKIcGTeRQNAXCEbZgVad,XGECEADAZBBA..aBHBLCEC.OEAFPFEEMDAEUFBAhAAADGADKHFGGEEH.hABATAADeDAENIAHACCACHHD.hACA..bFBDdDGHWAEESFHBBDEA.fAFHhADA..hAIA...,1,-6,-19,13
fTYOcXMAPBaReDWQUgFdCZHSJbGIENVLK,aBCCDCGFQAEG.FCCFdFBD.HEFDJAAB.ICFD.hAAANHAD.KEGA.TFEEhACAODAEMGAGAAAGBDDBeHBGhADAgAGGCHGB.SFHHEEBELAHBhAGAfACD.hBCA...,2,-25,-18,7
AVcSKMfUEBTeOLQbPWZXJCYDNgRIGHFda,SBCBMGAEUDFABAHFeBGDLAEB.QFEEhAAAbFEGZCBF.XDABCHCA.hAAANIAHRECHHABC.aAEDAHHGKBAGhABAECADOFHDJAHHDGGEIGABdCHEfDDDhABA.....hACA...,2,-6,-5,1
NUKFeOREYHWcJAQCTSVMPDfbBGgLZXIad,CHGCSDDB.MCEGfACA.BHEALFHBZAEGaFFChAAAdHBF.UEBFFDCEOCGHhABAECAHHGEE.cAABhAAAJCABTFAEDCCD.bFCBgCGA.hACAIAFF..hADANAIE...,1,-17,-20,3
JCNfSDgAGeBPVKIXUWTcFMEQRbOdLHYaZ,BBGEKAGGUGDF..TEDAFGAF..ECDEQGCH.RCBAdFHAhAAAHCBDaBAGCEGBSCHBhAAAABEAeDAB.IHGEhABAXCFD.MFGFOCAHYFAFJABEDEEBhAFA......hAGA...,1,-12,-31,19
ZVeAKSRbNGCHLTEYBgfJcDOaWUPIQFdMX,SAEDRCDGGCBCCGAF.HABDLACCECHBBGDH..JGEEDGBCOAADhAAAaHGGUDEC.IHBChAAAFCHH..XEEChAGAZDAGAAHD.KHBE........hAHA......hAIA...,1,-20,-26,6
cISOeVXKfgHEFMRLaTYJCdBAbZGPNDUWQ,ZFBFGFBFDABEUGGGQCAE.SCHFOCDG.XEEAhAAAKDBEHDFAFFHFLAFChAAATCDACAGCBADHAIDGNBBF.IFDFhBAAeFAD...fBGBMABE.hAFAaFFH.....hAIA...,2,-24,-4,20
dJAgOaUFYZcSTINXWRLfBMGHCPEDKQebV,aBGAUEABZCAH..TABB..NFEDRGDEBCDF.GGCBCHHH.DDFHhAAAKAEBQDGAhABAeAAGdGAHADABFBGE..SCEAhACAIHAH..XGGHfCCCMADGhAHA..EDGC...hAIA...,1,-23,-25,2
bMIdCRANVYDHWKLEZeGJPXgfUcaBSTFOQ,VCBBHEGDKEEB.EECCGFCH..PAEDXAEB.UBGDhAAABDHBFHFCOCBE.hABAQAABMIACIACEhAHARGBCAADADIGE.WAGFeEEE.fDHGhAIASAHH....hABA...,1,-9,-23,14
ELBQaKVUTcbHIeWAMDYOGZdNRgFSXPCJf,MFAGOAHFdGEFRFCC.FADA..SGHF.CDFH.fDEAhAAABACAQCCAKHCGTAGChABAHBADeCCCDIECZFAHhAAAgCAFPAEGECECVDGD...cGAGhACAIEHAAHIF...hAGA...,2,-22,-7,15
EPOecDagJLMYUKIQCGTbFdBfWRSAHZNXV,ZFFCVGDAEHDC..OBBGDEAG..aFAEJCFDLCAC.MEDChAAAKGADCCDA.GDAFFABGdCHAhAEABCHCRAFCAHHB....hAAA.NADH.eFCH.gBDBIHHFQFBFhABA..hACA...,1,-7,-34,27
LDAeJRITZdGPObKNCMgWXfHQVBSFcaEYU,eHACJBAG.RBGHZEFCdHCDGFEF..OBAEKFAE.MCED..hAAAXEDGQGEDhABASBHBaAEEUDADAGAHTBEFhAAA...NAEF.CHHFWDDDHCGFBDAAhABA.EDDE.DIFA.hACA...,2,-20,-10,10
ZKMRXCVdcePHTYUfQbIANFJLaSGDEWOBg,FGBDaHCGGDEBDEDE..OBEEBGHFZCABKBBA.MACC..CHFDdGGBhAAAeAGDHEAAUDCEQDGDhABAAAHFLHFGSAGEhACAEAAH.RFDF........hAAA......hAIA...,2,-23,-19,4
eHgdFbXWVPINOMCJUAfZTGDEaSYKLBQRc,TAAAEGAG..aBEEKEABBDEDRDEE.HFDGdHADFGDD..XBBEhAAAVAGF.NDHG..MAIFhABACFCHADAAZFFEDEIH.LACBhAAAcCAC.eHFA.....WAEF.hACA.OHCC.fAEFhADA,2,-19,-12,7
MFCeLGEaJcIOWgPdTRDYVBKSZUNfXbQAH,HEAHFADGeCBDEAHBaBCD..JHBC..ICEHOFGD...gGGChAAAdCGETFEC.hABARCCDDGAHYHCA.hAAABFFFZAFENBAAfCGB....hACA......hADA...,2,-23,-20,3
AXSFGHMKVYfaNDJeLQBWgPbOCdTZUcERI,XGGEFAGDGDBCKGBA..VFEA..fAADDABBLAEFhAAAQFEBBDAG.PADEhACACGABdACE.UDABEDDDAFIHhAGASEDFMIBAaDGE.NCCBeAHD...hAIAWHEG..OHFEhBAA..,2,-25,-7,18
KTAHBJgeOPVcWEYNGQFXfCSbDRZdaLMUI,BEGDJGCA.OHBG..VDFFEAGEGDBFQAEAFBDCCCBFDAAF.hAAAZCBGdBFA.LFFGhABAMICGKHGCAIAA..eDADhACA..PAHF..WHDANDAE..SBBEhABA..hACA...,1,-17,-33,16
NfXJQLdFgVMRcZbEDPOGAWIYUHKeSTaBC,..IGCFUEBBHACCKEAA.TEFGBCCB.CBHC...XBGHhAAAQAAELACEdHGHFGDEhAAAMEDG.ZFDHDAFCOFGDhABAGCDBABGBWHAG..SGCDhADAaAGAfFFC..hBAA.gBDB.,2,-14,-6,8
AKCFGHDELMgIZVRQOYfUeBNTabdJWScPX,FDGBHEFDEDEHLAEH.MHCEZBDEVFBCOAGF.UCCCBCAATCAEhAAAaBAA..dHFDSGABhABA.PABChAGAAHADKDBACGHEDCIFIAED...YBHHhAAA..fHGHhAIA,2,-42,-3,39
CIScEgLPdXVUTMfOGBKWYeFDNZHRbaJQA,CGHESGBD.EADFgBGE.LAAEXBFHUDEHhAEATCAHOBBFKEECeEGFhAAADIACHECBaDDBAACDPFFBhAFAMECHBAHBFBEF.NIDH......hAGA......hAHA...,2,-19,-13,6
MONQGWBKeEcSLCFHAJdbaXgVZRfPIDTUY,JDFCaFDE....XEACZCCFRCAD....IAAADIBATGGFhAAAUGFCMCHH.NBDC.GAEBhACABGBA.KHAEECED.hADASCACCFHEAIDGdFAD.......hAEA......hAFA...,2,-28,-28,0
LEOZXRAMWgbaBIcSVeJPGNCdQfKFUDYTH,MEDB..bCFGaFEABBGC..SHGEeHAGJEBHGBCAhAAAdAHAQCEBKFFGDAEE.YFAHhAAATBAAEGEDXABChACAAABA..IHHBcADF..NDCCCGEB.hADAfEHC.hAHA...,1,-11,-23,12
LPTYWOdSaVKQDcfXJECBMGgZbUHReFINA,LFEATCBA.OBECSCGCKFADDCCF..XEBG.hAAACHEHMAACgDCHhABAUFGBRACAIHBCAEHD.hAFAPABEYEEDdHDBQDGHfHADBAGDhAHA....hAIA...,1,-20,-21,1
SUANEbPIaZQDRXVgMfLTFYOedGWBcHJKC,EHBA..PFDFZACGDGGARABG....XFGBVCDD..MAAChAEAfAFEFHEC.ODAFhAAAeBGDdAHEBBHE.hAGAcDDF.KHACSEGAADFGNCCG.IFCChBAAaGGH...hABA...,1,-24,-27,3
faKcSATRGZgPXWHFYOdQJLVDeIEUNCbMB,GAEDZGBG..PDFCHEAFOGDC.QCCAJAEFLFFEhAAADFDAIBAAhAAAEBABCDCABHGFfHGHhABAKFACAAHF.RDGD..WHAG....FBBA..hABA......hACA...,1,-2,-34,32
cMDIXgJbQCKZVYPWEBHFdUaATRLNSeGfO,RFBGLAEFeFGDGCAHOGDCDFDG..IHBBJAEA..CCHEKACAhAAAZBCFVBFC...hABAPFEGBFHEFGEDaDAGAIFGhAAANEEH....SHAAfFBH.MEIBhABA.....hACA...,2,-31,-14,17
BLAFNJfKgWXSHaYDQOMeGdbPCEcZIVURT,FDGHJCBF.KACC....XGCEaDDB.DHFCQBEF.hAAAMEFBdFGFbDEG.CHBDZADChABAVBAF.UGGDBAGBhACAABHB...NAIG.WFAFSEADHFBAOBHDhAAAeBBG.....hAEA...,1,-14,-29,15
HYNPJFCKZdGAOeXSgfLTDMUQacWbBRIEV,XFBESBGALABBDCAH..UEFEQFFFaBDG.bAFAhAAABCBF.EHBGYDEEhADAJDDBKHFE..ZCFAAEHCeADChAHA.fDCCcDAE.WFHHIAAChACA....hADA...,1,-2,-38,36
gPbBFWIOGfVAKNJRZScUEMHYQTdLDXaeC,JFBHSFGC.EFEFHDDC.QGFEdCDEDDFAeCAGCHDB..hAAAgBADBBHHFGHDIGAAhABAOADDVAFChAAAAFBCKAFG.RABCZFCD..MFAB....hABA......hACA...,2,-23,-14,9
fMLHgVPQRJUYdNACKZWDcTGIObeSBFaXE,KGDDZAAADGGBGCEE.OGFEeDFAFCAH..EEBBMIAGHBGH.VACBhAAAQFDH.hABAUAGCNAEBABBF.CEBATCDAhABASEGA.BGBDfFAE..hACA.PEHD..hADA...,1,-11,-27,16
VNBWDKgLEAJTMRQPGbcSZOXHUfCdeIYaF,MCDGQEFAGFDDSCHBODEGHGBACCBF.eBAD.IHHChAAAYCDH.FAAGBAHFhABADGDBLADEhAHAEEBFABIB.JEBH.....PHFAcBBC.hAIA......hBCA...,1,-7,-25,18
JNAdODGWMaQHLXEBPSVZIfceKYTRCbUgF,dAEHOECGDFEEGFAH..MCAAHCAAEHDGSHECZADA.hAAAIAHEeBHBTFFDhABACAAB.bFABUCECgDGDhACANDIAAICC.aCDE......XGGDhACABHHF...hAEAfACC.,2,-15,-3,12
HNbZDecSgUPXWdTRMAVGOCfLFQEKJYBaI,GECDCFAHFCAF.ECAAKHBABAAD.HBEHZEFCDAHFSGHH.UGBBhABAXECHdAGHMHEAhACAAEHE...OACFhAEAQGGDaEBG.NBBH.cCGB..PCCGhAAA...WCFAhABA...,1,5,-54,59
UOMfeYcHWbNFGZRaILQPKTgXdAEJCDBVS,JEFDDFBHBEFG.UBBDMBEG...eFAFHFCC...NEAC.GCCFhAAAZCEG.aFCFQGGFhAAAKHGAXBACAEIFCECF.hABASGCD.OBHFYADC.hABA.WEAC.FEHH.hACA...,1,-16,-38,22
fIJAUVKFBCGNQZTdDXHebLOWYEaPScgMR,KCFFBCADCBGB.QFEFZFBH.DCCHeFABLAFFOEGD..EBGEhAAAaEEHSECHhABA.MEHDIDBBhAAAJHACABBEFEACTADG.dBAB......hABA......hACA...,2,-37,-23,14
feGUHALNaIcMEWSFdQBPXCZTYDOKJbVRg,aECAMFBD..EGDBFCDCBCAACCFE.ZEGFDEIHKAEF....JADARAGBeFFFhAAAUGFC.ADFE.LAAFhACA..ICCBhABASAGEdFAG.XEEG...TDBChBBA.OHCGhBCA.gCGH.,2,-27,-24,3
THYOUGVJXSfKcFCQaLNIAMWPRbDBEZdge,MFGDRDADDECCBHDFdBBG..eFDBHAFGUBFFGBBF..JDHBXFFHhAAAKGAB..CAACLADChACAAGDC..bDFChABAEDDG.ZEBFgGAG.OADGhACA.SHGAhAIA...,2,-23,-21,2
LTURDBXGMNbYHKPfSJCIagAOFcdEWQeZV,FHBCdBDGQECHZDEELABGRGCGBAFFGCAF.MGBE..NCEDHDADhAAAKFGA..SAFEhAAACHBGaHGC.AFCEEGFDeABDhACATBFDDFIH..YEEC...hACAfAGFIHHH.hADA...,2,-21,-11,10
gRVUKXTNMEJDGdHYQSBbLceCPWfIOFAaZ,ZEDBRCADKDDD..XBDHMCFE.EDBHGGABdBBFHDGHQDGBhAAABFFHLAFACGHE.PGAGhAAAIGFBAFIHaDABgABBhADA........hAEA......hAFA...,1,-9,-30,21
OGKHTedJCNLbYcWSDRABXEUfIMPgaQZVF,EACCUGEA.MEBGaBFDZFFE..FABFKBAFeEADCCHH.LBFB.hAAA.bCCH..WAHBhAAADHCCABHA.BGAD.fBEAhABAIGHC.PEEA..gBCHhADAOHFC.HFCBhAEAdEBC..NIAH,1,-25,-33,8
gJESLDHQeTIRaUbABCVOPFYKNdMZcGXfW,CAGGVCEDFCCF...KHDAMFFGGAED....XFAC.hAAA.fACChABAJGDEEABFDBIFQEADhACA.IDCGaAEDAEEDBDGAPCHFNAAE.cGGGhAEASGHFeHAA..hABA...,2,-47,-11,36
STgeBfWcKZNOYJLPFdXEVUQRDGIHAMCab,aAECSEGC.eDEDBGAA...fGDGKACEOFBFLFFEhAAAdHDFVBFEQGGHhABAGAAAAHGACECEgCAFhACA.WDEEcADE..NFAHYDCAhADA...hAAAFAGAEGADDGCD,1,-14,-23,9
VCGfQDSIKTPWbEYcXgFZeUNLdaJHBROMA,CCFFGFEHDGFC.KCEC...TDAA..WBEDEDGG..XAGAhAAAZBAAUFAFdACH.aDCFhABABHHFRFBF.MAEGAGADfEEFhADASHDE..IHHEPBHD.hAAA......hABA.cDBA.,2,-45,-3,42
ISHgWRXZDCdQULKaFfTMcEOVGJBNYAebP,eHDA..ICFCHCBCRGAGDCFHQFACUACBKEFGFBDD.TGEBhAAAECGC.ODHB.hAAAGDAFBHHG.YBAEhABAABFGSFAC.XFGACHCHaFEAMADAhACA......hAHA...,2,-23,-14,9
NfSHVLQbYXdKGOMcUEJaeTRPAFBCIZDWg,CEFADIBE.....NABB.HBCCLBECQGAE.XGDFhAAAKGFAMEEHUGGBECBAJCFBhAAATDAC.AEEFIDHHhABA.ZAFCWDDFSABAbGAG..hACA......hAEA...,1,-17,-37,20
aBKPXRfcEWHVNLegbdCTUIFDMZOYAGSJQ,GCBGSACFaFEDBADEKDBE..RDFHEBEBVAFH..LFBAhAAA.eHFAgGGGhAAAdAHGCDHB.IDHFhABAMFAF.YFDDAGHE.PFABfBAAhABAcBCA.....hAEA...,1,-13,-24,11
SEAaKgYJGNOLFUQIHWMVRfTZCDdcPBbXe,aEHHKFGA..JABGODDD.LBAAFGBAUDEHQGFC.hAAAIGAEMFAFRBDG.fDAFhAAACHEA.DIBEhABAdBHGBHDE.eBFEADDB.YCFH.hABANADHWECF...hAFA...,1,-4,-48,44
JWUbSdPKcTFVaGNgICHfDBZMOQLXAeERY,eDEHRABD..JGBEUABBdEED.KEAHFHEGGGAD....ICFBhAAAfDDC.BDGGhAAAMFAALFGFhACAAIHAEAGD.WAGB.PFHDTADE.aGGACAEE.DAIHhABA....OCCBhAIA..,1,-10,-42,32
gcYKITNJVfMEPBadWQXAZHGbUODCeFSLR,HDAHGBDFUGECDDGGFGGCSEHBLEDCRAAG.....gGBHhAAAKAFAIEFCTCBFhABAJCFC..MFDHBEAAhACAaHAAdAGF..QCDGABBC.OACAhAAACADGeHEG....hAEA...,1,-6,-19,13
RAIeYbNDUaKMBdfVWXCLGEgJScOFZTQHP,eGFE..bEADUBDHKDFAdCBH..fBGAXFGALAAChAEAEEDA..SGADhAAAOEDHFAGHQEAEhABAPAEDAFFEIHFDDICGaACGBHFECHHD.gDGFhAFA..hAGA...,2,-30,-15,15
KHACMdfFIcDOUNJVagQBEPGYWXTbeSZLR,CAHDMCHHdGAE..FFEFDBFC.UGCA..JACGaHGEBBFD..ECEEGAAGhAAA..XBBFhAAAeHCELDGHhACARGECHEAAABIB..IDDDcDEC...NDIC..hABA......hACA...,2,-32,-30,2
RVUKYfCADdJIBHZagOFTEMXLQGNPSWcbe,dAFEBBHBHEECZECHOBEBFACBMDDA..LCGFQFBAGEAAhAAASBHB..hAAAcBBBeBBD.UGGHhABAYEADADIFDAFCIFECaGHBEHEGNIAH....hACA......hADA...,1,1,-28,29
FVOTSJGYDbIMARNgLKBZUafQXHCPdEeWc,REAGLDCGBFDHUBCEaAAD....QGCFCGHH.EAECeBHBhAAAFBGBVFFBSBABhABAJDAFDFCEMBGB.AFFHKGFHhACAfDGH..PHAA.dCEA.hAAAOADA...hACA...,2,-24,-21,3
MWONLSJBZQXEPfGCIFUdYAgbHTecVRKDa,HBFFeBGHRDBFaDAF.OAAELBCC.JFDCBFGCZGAE.XDCGhAAA.EBHDfBAChAAAGGABFHGAdEHAAAFHbFED.hABA............hACA......hADA...,1,-4,-30,26
VgCdQbZKMGfTUNBXALcaSYHRWFOPJIeED,aBHHSGAEHFDFFGFAODHB..JEBEeEEHDAAF.CCFG.dCBDQAAFhABAKAFCGBEGTADFhADABADBAICGLHAAhAFA.RGFEIEDD.ECCG....hAGA......hAHA...,2,-32,-9,23
RDSefWZcCaNUVBIAJXTQHdLPYGbKOgEMF,XAEDQACELDAHGCFGOHCA.EEDDFGBE.DFEAfGHEhAAAZCDCaFHDNAHG.VBAHhABABAAEAFIHHAFG.hACAPFABKACAMICA.SHGG.hACAWCCDCHFA....hAEA...,2,-30,13,43
FPQRbCeIfJSYKgOZTLDNMHXGdBcWaVUEA,FBFCQCAGCBCD.eDEDJFED.KGGCZFAHLADG.DBHFMAEGhAAAGGCDBDGC..cEADhAAAaGHH..EADBABAAbCCBhABA..SGFH.ODHFhABANBIE.dCAGWHAG..hACAPDDHfDGG,2,-31,-1,30
PKfQYMcFWTRUgJNHIdSEbDLVCeAOGZBXa,ODACZBCCaGGF.KDHH..QGAEMGBAFHDE.RDDEUAGG..JFGHhAAAHGDAdAGA.ECAHDDFFLFAChAAAeCCABADCfDBFhABA.WACEgBACSFGEhBAACAFDAIBG......hBBA...,2,-33,-4,29
NATZCgcRbUeDWEfXPQMOGSILKadVJBHYF,CHHDRFGDUEAHDGAD...EDEB..XFCC.QABHhAAAMBHDSCDFLDFBKABHhAAAdHDBVFDBBADBFBAHAEDETAFFhABA.ZFAFcGBHeCCA....hABA.WAHB.fBEBhADA,2,-28,-23,5
aeASNBIJRDXbGLKZOdVcHMYTfFPUQgECW,SGGDBGDHJDDG.RCAF.DBGAGDEE.ZAFEOHEEdGAAHACD.hAAATDGDFFGEQBAAhABAEGDFCCGC.eEAGIAADhACAXGAAKECCMFIH..fDGAhACA.gADEhAFAAAFE,1,-5,-42,37
JLOMaRFeXcgIdKVAfCDETNGYSQUBWZHbP,DGDCTFBBGCAF.QGGEBDFBZEDBHABB.JFHBLCFChAAAMDAB.FACEeBEGXFAChABAIHABdHBFAFFAEAAHhAAANEED.SDBG.WHDA...hACA......hAFA...,2,-22,-8,14
FcVPXfLSgBeUEdRDOKNGMJQZTAaHbYWCI,HBDF..bAGBCFAHFEFH..VDED.XBABSAHHBGCDhAAAUCAHdFHGDGBFOHDChAAAKAEFMIEAJABEQAFBhABAAFACaCCC.IFHAfFCBeFCF..hAGA......hBAA...,2,-18,-18,0
RVeOUcHCWIGTLFMfAgNdKJQEBYaPSZbXD,dFCGJEDEBDCG..PBDHZGAE..DHEAeGFE.UAABHBADCADBGAFGhABALAFDMAIHhAFAAIBAKAGH..EHECaABASDGHhAHARFGB..OADDWFBDIEEDhBFA....hBHA...,1,-20,-31,11
dARGUFaMQWXPODNeKITbSgBHJcZECfVYL,GECAaCAB.MEFAXEGCDFBH..KFFATBEC..SBEBhAAAHABDJEEFEHACCDDBVBAGhABAdFAHADGE.FAHDPHFGhACANIDD...ICHBBGHE..fDCHhAAA...hADA.YAGD.,2,-22,-8,14
BTdQAZJYFCSeWDLIUHVGREfMXgPbacNKO,JADDCCBE..eCEFDDAGLFBFHEBDRDGH..MGDA..XBEDhAAAbAFA.aHDEKCAFBABAhABAdAADADDBFFGC..IGABhABAVAGF..EEEBfGHA.PHCChADA....hAEA...,2,-30,-19,11
bRMQaEFgDYfPJVXWGASdTeCcIUKNZHOBL,SCBAdDFBCCAD.UAFFKEBCZGECHCEGBAEELEAE.bEEEQGABhAAA.aBBGhABAgGAE.hACADEIDfEDCJBAEWABEAAAHeBFC.IFGDhADANIDF.MCIF.hAGAECCE..,1,-16,-26,10
cEaTRGYIXJMBLbfHSPAZQDVdgUKWNOFeC,QCEAVFFA.dAHAKGBDOEBHCAHG.EAECaEBG..RDCFGGDDhAAA..XBCHhAAAMCABBBBAfBBAhABASEFAAEEFDGAD.gAECNDIA.eGCGhACA.YDFGhADA.ICFH.,1,-9,-21,12
TNcdSWEZJQaIHBRgefbDYFAUKVXCOMLGP,KFFBVAAACDFA..LBCFGADA....NGDD.SHCCZFAH.hAAAaFHHBHFD.eCHBhADAbAEF.DDDDFDAFAFFAXAGEhAFAMAAG..cCGAECFHIHHA.hAHA...RECC...hAIA...,2,-31,-14,17
HafEQSVACeUFgcOBZdITKNbJGMXRYPDLW,UAAAFCBGOCFFBBDCdEDB..KFBE..JAFBMFHB.RADEDEFHHGFGhADA.EHBA..SHAEhAAACAHH.eEDHhABAgEAEZAGH.IDGFNCAG.XEGAhAEA....hAFA...,2,-41,-27,14
HXJBSRZYIedgPaKWVMCNTGOcFbQDfAUEL,EECCXBGABCEFZBGF..eDBAdFAE.aGHDKGED..MEFGCFFDGABDhAAAFACCDGGH.AAFBHFDHhAAASGCHRBAG..IGAHhABAPHFEVCAGOHAE....cEFFhABA....hACA...,2,-28,-8,20
BIOYAUcbZgPKWXVHLeRQNaTJMGCdfESFD,UCBEZDBFKDFG..XFCCLBEG.eEAFREFE..QAFDhAAAaHDCMFDG.GBDC.hAAACABFdDAGSBAGhABADIAEIHHDAGHB...cGDEPAEAWAHBhADANADEfHFBBDHD.hAEAOCHF.,1,-8,-19,11
RGYEaVXNFLZWTDdeUIbJMOQPfcKAgCSBH,CFDBBHCFHADCGDEF.ECCGaABF..VAFGFEAGZEEH.DBIF.dGAAhAAAIBAGMEIHOCFFhADAfFAG.ADACSGGAhAAA.RFDGXDAANEHA.hAEA.WHDG...hABA...,1,-22,-26,4
GCNgVUOSDAXfJWMQFbRBPTZHeaLdKIEYc,XGDBJDEG..QAGCFDDHRGAE.BCBATBDBeFADdCGEKAABhAAAECAEGFCB.CHGD.hACANBIA.UADGDADCfHGDhAAAMFFC.........hAIA......hBCA...,1,-22,-27,5
eaEfJUDWSZTMRLGKdIYQbFgBOAcNXVHPC,XEBEHGDGCCHF..eGBCaABF.EDAC.UAAADDIBZCEH.MDHBGDEHhADAKGEHdAGFQADAhAGAFGCHBHHCAIAENFBF.fDCHhAHA.SGGELEADIADFhAAA....hAFA...,2,-31,4,35
FBUcTNQGAOPDYZaWRMXCdHSIKEfgeVbJL,OEFBDEHHZAFCRCEG..CHGGHFAGKEBG...EBBHeAAC..JAEFBEEGhAAATDCCQGCBhAEAAHDF.aCCGMEHDSHAGhAGAIAHB.fAACbGFA..hAAA...FDAH.NCIA.hACA...,2,-27,-23,4
SOHeDNBEYLcAXdKfgCUQFIRTJZPbVWGaM,dCADKFGBCDGAFAGC.RFAD.ZACF....VEEBaAFD...OFCFHBABeFEBhAAADAAC.EHCALCEEhADAAAIF..XFAGhABAfHGBQDEAIEHD...hAEA......hAFA...,2,-31,-25,6
PLIAeNgMEcFXRDTbHBCWYQdaGJOZVSUfK,eBCBMGFAFAFCDFBFHDFEBHHD...CDBBQEDDGABGZCGBUFCDhAAAKHGALAEHAAIB.EAGChAAAXDDGRGCC..hABAWBADaHACOAEH.SDAFhADA..fCGBhABA..,1,-9,-26,17
SBRIXNQaOcAHWLZPJCFKgDGVUeYdTMbfE,HDCDLFCEJFFCKHCGDEGFUBDC..dCADMADEEFAGBBHC.RAEF.hAAAXBGA.aHFGhAAAAABE.ZBBHCBBCFGEF..hADAgDGB.eHBE...YBAFhABAfCHC.hACAIHAC.,2,-34,-14,20
JSTNIOdbZPXGBLDEQeacVUgFMfCAKYRWH,REGHJEDH..TFACOHAGdHDHZGFEGAEB.BDBBEBBH..QCFGhAAAaCCF.UEAChABAMAAFACAF.KEEC..HAFChACAICHG..PFFGDFCC...hABA......hACA...,2,-28,-16,12
NOcEGKgJRXdPWAUZFHVDLbYTCfMaSQIeB,FEGHDBBBLFEF..bDBHCFBG..aAFDQACA.IDDGhAAAeDHHOABAhAAAEBHHKFDEJCCHdBFEABEEUGGFhAFAZGACHBAH...YHEAfHAFBHHBhABA..NAHG....hACA...,1,-10,-28,18
ZATcgKfQYPUOMBDXHaSNLGCRbeFWJdEVI,TCCDKDEBQFBC.UACCODFFBFHGDAECHAEESGCEhAAALEGFGDACCAAGeAHHhABAJAHFdDDCEABC.IHFGhABAAEIH..fGDCMDHDNEIE...hAIA......hBAAFCBH..,2,-20,-8,12
cgdTaQfKFeSDCHVOREZPXJMLNYGAbBWIU,BGBEUGBDdEEEaEGD.KDCDFHCE..DACEHAFB.ODEDZBAA.JDADMAHBhAAA.LHFChABAGABEAHHC...IAABhADATBED.eDDFCFACEEHDNAIE......hAFA......hAGA...,1,-15,-34,19
JSWFPIEeMNfBZQLAKgHUVaXbDRYCcdOGT,HDDCVDCB.aGCA.DFBCRFEC..CEHC.dBCBGAFGSADEFHAG.EFGEMDBDhAAABAAELBAGhABA.AFADKADCXCAChACA.YBHB.cGGH.OHCChAGA.JAGBIHDChACA.fGHC,2,-19,-19,0
cOMGJIEVdZaCXRbQeAPBgSLUNHfKFYDWT,BBBCLDBHUGDDHDEGKCHH.FAFG.DDDD..TDEFOCAHGEABhAAAJBAC..EFFDdADCaGCDhAAACHGBRCAC...eAGFhABAPAHD..SGAFNEIA.fAEHhACA...hABA...,1,-21,-23,2
WQVSTHEILYfdeJKRCBNDXFaAOMGgbcUPZ,MFAEGDFA...bBCAPBAC.QFGFVGBCHBGDLAHFhAAAfBAAeADCKDEDhAAABDAGDAEGaDBDOEEBhABA.UGBGSHGAEHFG..ICEAhACAJABACAHB.....hBAA...,1,-2,-4,2
SDXZIeEQcYCTbaMHUJVBfFARGPKdOgWNL,RFCEKADHOBGB..NFDH.DAACZGAA..eEABEBFD...QBCHhADACFAE.aHGAUCBDhAAABAHBAACEdHGD.LGEChABASBBFXCGDIDHA.cEFChAEA.....hAFA...,1,-27,-34,7
UXHcNZLbaECeDgBYTGMIJKVOQfWRFSAdP,dFADUADFHBDEZFDDLECHaAHB..EBAGCCCG.eFEFDCIB.BACBGEAGhAAAMDDD.KCHHOFGFhABAQGGBRCFH.SEEChAAAAEAB........hABA......hAEA...,1,-18,-31,13
RBbKHDIgCVXYOPUWaALZfcNMdeESGQJFT,ZAGD..fBEAMEFCeCCHEGBAGFBFFFFDBBAGKFHBDBID.CBDB.hAAAXDAB.PBGHhAAAaCAFAGGDLAEBhABAdFDESDDA........hABA......hACA...,1,-23,-32,9
IDgBCNTfKGcFRLeMEbOZQWYVdXaSAPHJU,HFBHJBFC.UCDGDFHFBACGCDHC....TGFEKFFFFFDHRCADMFDChAAA..OAABZAFBQABBhACA..hAEAVFABaGEHABIF..gDEE..hABA.NDIE....fDCChADA,1,-19,-49,30
BKfAMDNPCJbHIEgWRXYTGFZSdQceLVUOa,DIBCCECDHBFGEGGA.RAAF.....TBEGFCCEZEECSACFQFAGhAAAeEBBLHEGOEEEhAAABGDFAIECMEAH.PGDGhABAIAEE..XDDGdAGB.cBGFhAEA.aBBH.fDHEhAFA,1,-5,-25,20
WXdgAFKDVITBJRLPHbYGQCEeaMOfScUNZ,FFGEDAAD...VADBBFEHLFDHHCGDGCCA.EBEAMHAAOBBHhABASCBBUGAA.hACAZBGFXGGHAHIDKDEGJCAFhAAA............hABA......hACA...,2,-28,-25,3
aGPLHCcJZSUNbERAMBFXdfWeVDOKYIQTg,MBDCBEBAFEEBdBAE..eHFCDAEGKGHF..QGCE.TFAEhAAAGBCGLEDGhABACEHHJGBAZBABNCCF..EDDGAAID.hAAAfEHG.WAEEOAHH.IGFDhABAaCFE...hACA...,1,-13,-46,33
MSeLAVUZJWIaPHFTfXYbKCBcNgOEDRGdQ,ZBAGJFFC.aBHFHEBF.FAFC..XGEAKCACBHDF....gGBChAAADDDGdABHSADHhAAAAEGGUDDE..IABFhADA.fAFCCHAAODFE.EFAF.hACA......hAHA...,1,-24,-42,18
TaIJVgKFOCZXNfdeRDUGLScAbBPMWQEHY,BCHBMCFA.EACAHEFE.aADCVFDF.KBFDCBCDZBAH...NAEH.dGBGhAAADHDGUCAA.SGGAhABAAGBA..WDDDhAAAQDFH.IAHHFGHBfHBBhABAeEBA....hACA...,1,-21,-32,11
fEQOBLRAWVJSdZeFPgHYMCcIGDNbaTUKX,VFAFJHEAZCBE..eACDFGCH.HDEH.CGDAGADHDBGA..aFFCUDGChAAA.KGGFEADHODAEhABARCFA.ADAA.SFBChAAA.dBAB.......YFAFhABAMICC...hADANEIA...,1,-14,-30,16
eAgIXEGBYMDdLaKJfRZSVCbOPQNHTcUFW,XGDBGAEAMBACDAEH.LDAH.JBHBZBAG.CGBDODFDhAAAQFFHHAGBTEDBhAAAFGHHAAGF.ECCGBABBaGBDfGDEhABASDDE..PDAC...hACANFAF......hADA.WHFAIHFC,2,-18,4,22
DSaUeFOEgWNRdHKTBXZAJPIcCGbLMQfVY,JAAB..IHDACCDD.LGFGMBGB.VDCCSFHBhAAA.eFAHFCGHEGAC.hACANBAHdAEAKCHBTFFAhADABFFEACAF.PFCB..cAGHbAEF.fDAFhAAADFEH..aDBChAHA.OHEC.,1,-12,-21,9
CbJXAEcRHZdVLWgUNOGPSKMaFYeQDBfTI,EAFGHCADZAACdCFALFECUFFFOFAEGGEHKHAGMEBA..aAEEeDFEhABA.BGCC.fADDhACACAAGbACF.ADDG.hAHA..cECFWBFANIAHSAHH.hAIA....FDHF.hCAADGIF..,1,-10,-12,2
cFUWbRCNgZfYJeTMdVSEKBODQXLaIGAPH,HABDUGCDRADHCGHGZFCF..JBBDMBEB.dCHEEAACBGBE..DFEGLFFBhAAAGAGGAHHBFBFD.hAAA..NADH...fFAFhADA.eDDASBADKFHH.hAFA......hAGA...,1,-25,-32,7
UFSPEKdDNMRVLBJgcGOaIfbXYACTQWZeH,CEECQAGFZFBFHBEGFACHEFBH..KEGFdGFCDEDDRBAD.BCDC..JEHHGAAGhAAA.ODHFhACAIGACXGDE.hAAATCECeFDBSADEMFAB...hADA......hAEA...,2,-25,-19,6
SObaMfRHGVEXBIKFYeTNZWLDPUAcJgdCQ,JCCDdDCDSEFG..aCHHRGDGGAFEXABGKDAH.FBBAeBFBhAAAZFBD.LFEBhACADAIHAEIB.CAHDOADGMAAF.hABAHGBEBHAFIGHC.....hACA......hADA...,1,-19,-24,5
gUMDSaeLKcHVGNbXWPYRFfJAOQBCTZEId,BDHHCDHFZCCE.dEAEUAADMBDF..DDGB..eEGBKAGB.HCEHGEBFhABAXBAA...hADAPHAAFGCHAHHFQFGDhAEAIAAG.aGAHcECH...bAFAhACA.....YHDGhADA,1,-13,-41,28
HZfPUFCGJgIQDYeTALMEdNOXaWRKcSVBb,EDBDdCAHOAAA..aBAEKFDGSDFFBHFDZCFD.UGBAFHAG.JHFAhAAA...QAGEhABAeBEHAHHFMFAGNADAXEGEhACA..WDHHREDDcAEH...hAEA......hAFA...,1,-3,-45,42
YMWNVJESDdQRHCeaOKAbIBFUZLGfTcPXg,BFEHZFAHLFEHGBDF..TGFGXBEBMCAD..VDFCSABFhAAAdGHAHDBACGADaEBFhADAAAGCFCAG..UDGCPAAChAAAgCCG.NIBHDAIBQGCBhADA...OAHDhAEA.KGGD.,2,-9,2,11
cQDFUgBVMeHYLSCWdfaKZXJTOPIARGENb,GDCGEHBG...NCBH.QDAG.FBGEBCHEMEEE.eAAEhADALDAFSFHBhAEAdHFFfAABhACAaFDDZBBATGFHIHABAIEEcEBDDGEE..gCEAhADA.YEHHhAEACHAD,2,-43,-17,26
VgAaBWPHFDeJbcSTfKMUCIYRQOLZNdXEG,BGCGHCFGFAEEDBCB.eEDG..JEFESGCDKEBF.CHACRAACLDEFhAAAZFGDdGEH.EAEGVDAHhAAAAHAE....aHGA.hABA.PCCG..bBDG...fBAEhABA.MIBGhACA...,2,-53,0,53
VbaQOHTMdBDCPGSgfNJWLIXRKAceFUZEY,eBBBUEABZBGBEBED....VEEDQABFHAFEdEHCBHFCDHCCCDGFSFGEhAAA..hACANEAGLADFRGBAKCDBAFFF.hAEA.FBEAaAAG.MICA..gGGBhAFA.....hAFA...,1,-13,-20,7
IQUedJOAcRVMbZHgFCKTWYaXDEBPSLfNG,RCFHMABGHEGBFEDHCAED..KDAF..TAFA..aGAHEBBCBDCCLDHFhAAAGGBFQGFHhAFAeAAG.dEBGACFD.cDDFhAHA..........hAIA......hBAA...,2,-34,-19,15
CFXNTOBPIGRUdbHZEVfcAaLDJSQYgKeWM,LCBADCFHQGCDKEBDeFEH..MAIBXDGBOFADBAGDhAAAGAAAdHABHFCDEADBfAFGhAAAAIGASEEChABAgFGHFACE.PCDBIGHC..hACA......hAFA...,2,-18,-9,9
CNbYEJHOQcAVfSMLWTFKXZedgRaUIBGPD,SEAALBCGTEFCFADEZBDG..dCHEaFECBAAA.DDBDCAHE..hAAA...NADFEGCEOCHHhAAAAEDE.fHBDhABAKGHHeFEB.gDEERCECIHBDPFHD.hACA..JABB.cGDHhADA..,1,-16,-24,8
QFgDCUGPHBNXRbMJAfOdZLeWKaTIEcSYV,dCFELADEKHAE.TBBGEEHH...SGGDVCCC.FDGBDBGChAAAUFCBGEADBBHDRABCMFFDhABAAHAAOBEB..hAAA.eFHBIHDAYCAFCCAANAEB..XGGEhACA....hBAA...,2,-20,-17,3
DaTWUHXLZegINBCcGSEVdJOMKbQYRAFPf,FBECDEDD..aFACTEGGHCAHLHAEZGBG.eCEHNDEH.BACBCHHDGCAGhAAASGFG.hABAEEGHdAHGMAEEbCCD.QAAHhAAAAADF..PFFB...hAIA......hBEA...,1,-12,-15,3
MfgDBXUZNCEbYPeLRScTKWHVaAJIGOdFQ,JCGBGBGC.OABGFGBG.MDFFDBDDBACCZGFE..ECCH...hAAAPFACeBEDSAHBhABATAEH.KEAAWHAAhAAAHFGFADBB..IEDCfAEB..hAGA......hBAA...,2,-48,-10,38
aGKPUOAgFHdMWZJXcYeRQTbfCINELSBVD,HAEHMFABZECAXDFA.eCCDRCDAQGBGTFFF.CHHFEACABDDBhAAA.DABBKBADODAHhACAACDCFEHD.JHBC..bAEENAIESFHHhADA.aGCA....PHDChAAA....hABA...,1,2,-23,25
bIYEOdDegURcWXSFNPZJHQaTKMLBCGVfA,..IHGEECCADEGDeFHHRDBD...XBFBFGADZAEAHDDD.hAAAaAABKFDGMADDCEABfHDDhABAADGDODHB.dACB.hACAUFADSGCHJBHB......hAFA......hAGA...,2,-21,-21,0
bJFXIHaWLdDgCMUTAVcReGNEKfOSPYQZB,RFDEeDCCEAFG.KHGA..SCBDQEEGBHGEJAEC.FACEHBBELDFGhAAAdGGFCDAG.UFBAAFCH.hAAA.....cGDHhABAfCCDOBHF.PHAEYFFChABA......hACA...,2,-32,-9,23
HZKYDEbSBJFPVGgUefLXCRIQMacTNAdWO,dEGAOFBFZFEBKDDADCCC...EGCFBDBD.JEEHFAAE.GDAEUGGDLBFDhAAARAGF..hABAIAEEMAHBaACCTBCGhAAA..AIAA.......WEHHhADA.....hADA...,1,-21,-46,25
JDMcZTgBCNfPaGSYHQWOKAbXRIEdVULeF,XAFDRDFCdGGHUBAHFFHD..DDDDZDDD.BFFF..CBGE...PFBDhAAAaFAA.GBAChABASBDCQACEhACAKFDB.IAHGEGAF.LHDAMIBE..hAFAcCEB...hBAANAAH.HDFCAFHC,1,6,-47,53
QRVabLBSgGIeDMOfKTcPYEWJZXCHFdANU,UBBCVCFC.LEGBBABBGDBAeBFGOEADKEEB...TCEBhAAAPADE..EHBAJHFAhAAACECH.dGAEAAEF..NDIG.aCCFhADA...SEHHIAHEDGFDfAHEhAGA..WCAFhABA.XEEC.,1,-15,-16,1
GCgQbHZYcdSfFTANXLWJUOEIMaRKDeVPB,XFEGLCFD.UADFOBDF.EFAGaAAEDDGC..eHFCBGHBCDHB.hAAAQGEEHEAHZDDEdCCHhABAfCAHAAHE.hAEAJABG.MHAAKHBG........hAAA......hABA...,1,-12,-32,20
JfFMCNVUTYBEaIeQAZgScObHXPWDKRGdL,ZBDDSGGGOFEDHGAC..XECHDABGKGGGdDFFLBAChAAAFEAE.CBGEUCECBAGCEBCHhAAAIFHH.AADEbGAGhABA.RCAB.fBGH.MDIDNIDF..hAEA......hAFA...,2,-27,-11,16
QGKVDEOdNCWfBLPXUTIScMgbeRHAYZaJF,ZBAAaEFE.FGEDGCAHDGDB.EGGFdFEB..CDFEBECALEAA.UBGChAAAIBFH.MHCGhAAAeBEBAEAC...QGAGhABAOBBANCIEPFAHSDAE...hABA......hACA...,2,-29,-28,1
dQHTPXYSLAcEJVbMNUaOBZCKFeRGIDfWg,JFHBMDBD.UADABEFAZCDEKBAA..FEFHGEAB..DDHF..hAAA..fAGChAAAgGBHdHCBQBAHhABAHCDAPADGXAGFSAHHAHHE.EABEhBAANIEFaGECCHFF....hACA...,1,-19,-26,7
WBEUKbHdFCMYRTSJQgOVGAfXDNPLcaeZI,DEECLDBCeFAFZFCFBACF.KBGEdFGGFFFCCADB...MBFHRBCE..SAAHhAAAJFAD.OEHDhACAAIHC..NAAG.aCGEhAFAEECGHAFC..QGCB..hABA.gDGGhAEA.fBCH.,1,-18,-30,12
MGVPcDeOKSWIRFJCNgLHfYaZEATbXBdUQ,XAADdDECQBFAGFEH..VBADDFCAeHDEKABE..IGADhAAAJDECCAFHLBDFhAAA.HAGBaHECAGHDBEAFhACAMEGFPFADOEAESDAEWCHB..hADA..FAEB...hAEA...,1,-9,-15,6
gWHKfAZRbUYXVDJcIaETCGLQSBNOPedFM,ZFABRCDDUGDF..XCEDDAAB..JEABIEHE.ECDHCADALCGBhABABHDE..hACAOBBAdGGGMCIDgGFGhAAAKBCD.AAGCbAFE....cGAEhADATCAE...SCGGhABA,1,-19,-47,28
LgReYEBXKcGbDaAdWIZHUTOPFNQCMJVfS,dFGFZGDCHDADODAAFAGC.QADFCEEC.MFEAVABE.SGDChAAARCCDEABFBCHBKAFD.hAAAGEAADGCBAHHDICFGhABATCFC...NGED.fAHE.hAEALHEE..hABA...,2,-27,-4,23
eRaAPEUVdIGMFSTYZXNHcBOfKWgJbCQLD,UBABdFAEGCBAFHAC.SACAZDDGHDGBBHCBKDGE...JFAACFGFDHCAhAAA.RBDC.AGGDEBDGMEIFhABA.....XEEFhACANIEH.fAGHgAGC..hAAA......hABA...,2,-36,-23,13
PYUQbFVIHdTXAeEgCRWNDGOZJBcaLMKfS,ECBCCCDHREBD.DGEHGEGE.ZAEHBDFF.aGBCKEEG...SGADhAAAUAGEQDGEhAAAFBCB.IFCFTBGHADIDhABAeADB..gGEEWBAFOFGHJCAB.hACAcDDH.fEAHhABA,2,-26,-26,0
fYabCFRABSEWMPcdTQOHKZDVINGJXLgeU,BFGBSGFAEFCH.MCAFdGGDQABC.KDCAZBCBDCFDVFBHhAAAGAEBJAHFXBFHhABAeHEGUDAG.aHACCEHFAEEAhACA...PBBB......hADA......hAEA...,1,-18,-26,8
YRJFAWUEGPOQNIZaCfgKVXTDbBSdcMeLH,EBADGAEE.OBBFICFFZGAG..aCAHCBHFKDBA...TFBAhAAADDEBBAAC.SHEChACAMDABeEFBHFGDhADAYFHDFAGFADIDWBDFPHDC...NBBDfCCDhABA..hACA...,2,-33,-17,16
CPbWUJHVGLIQZRfSEceMKXAadNDOFgYTB,aBCHdBDAODAH.FHAETEFE.CHDH...PBBBUFAEJCEChAAAHGDCLADAQCFHhAAA.ZEEASDCAhABAEAHDMEIDAHHFDAIB.BHHF.WDHHIFCDhABAfCAA.eFEBhACANACH..,2,-19,-13,6
PCTdgSKLQOBMIVJDcaGYXNFEfHWbAUReZ,UGEBRECCZGFG.CCBA.dDBB.KBBALEAH.BHCBMAED..JEFGDGEAhAAAGADC..XGAEhABAEABAHAFDABGDeAFEhACA.....PDHBSDDDhAAA.IHHH.hADA...,1,-27,-36,9
WKeHCdYaUZNcIESJQFRMVBOPfDXLbTAGg,GDBDKABGeEFCdCGCUFCCZGAA....IADCJDAH..RAGDBFHHhAAAOFGDDECGLFFFhAAA.bBBGAHHGHBDEhABA.aHFCNBAGSBGE..MIAGhADA..fFBDhABA..,1,-8,-33,25
ZMCYOVfbaBQTKGgeWcARFDNHESIdPXLUJ,FDGAHCDDEAGHdDGC.XGABUEBAZGEG..MBCFCADD...VAEEhAAAaFEGBBACKGHF..eHCEhABAADCADIACSDBDhACA..LCBEJFFF.OEAB.hADA......hAEA...,2,-37,-11,26
ZbRGcVfPADULaETNSKBCYQXHJWdgIFMeO,LBDCaECG.EGHDSAEHKAAH.CFGD.QCGDHEAFdABGFEHFhAAAeFADOHCAZECBbFDDhAAA.RCBH...cEDDhADAfFFAAHIBDBDD.NAEBBDAFJAHD..WHAGhAEA......hAGA...,1,1,-24,25
HgNUKFSLOERebMJZTAVcPWIDQCGdXYfBa,VFCE..PCGDDHGEGCAAdGGG..XFEBBGADHCFEUBAAhAAAKCDHLEAFEACFeAAFhAAAJFBAAHFH...WCCEhABAQAFD.fFFDNEICSBGEhACA..OHAE.hADA...,1,-4,-26,22
gLKWHeaMZVESJXYbGPFNARdQIDUOfTcBC,RDFAdGEHQEAHUAGF..OFAC..TFGHBHCCLCDFhAAAKCDDeAAGaGBEMABCZFDBhACASBEHXAEB.hADA..bBBFFBGCIHADDIACCAHE...WHEAhAFA...EFGE.hBAA...,1,-10,-24,14
YPFaTBICRgKeEGQJcUAMdDSLVXOWfNZHb,DCGFSEBHLDDBOBAD..NBBEZFFDHDEE...PEDHhAAAFAECBHACCGFG.KDCDeCDChABAEHDC.JAEE.AHHDMICEhACAdCHCXABB..WEADfAGBhAAAaEHDICHG.gACFhAIA,2,-40,-5,35
dYROMFVXALBbIcaJEPUgGHZTKDCWfNeQS,LAFDBEEG..bDGHIGCB.aEDEEFDD.UAAEGCABhAAAHADDTGGADBIFfHAFhADANEBA.SFAChAFAdABHRAGHFEGAACIBcCBE.....hACA......hAEAgGFG.,1,-2,-19,17
JNcTRgWZIOEKGPFdaDVQYHASeBUbCXMLf,BEFFCGHDLGDAJAAD.....TBCDRGBGZDBCECDCGCEG.PEBDhAAAdGHCDAHH..QAFAhABAAFGB..hACAeGDEXEGAMAID..fAEBhAAANDAGWHBGKCBF..aGAH..hACA...,2,-39,-2,37
HfLQcWBgPMADaUOdXCEeVTIKYbNFZSRJG,DBDBOEFHCFEA...EACDeAFE..TDAGKCAA...bBGHZDGBhAAA.SCFBhABAGCCHfGCBQEAHhACABAGCgGBAAAADdGHE.IDEBYFAFhABANIEF.FADA....hAIA...,2,-28,-14,14
OgSEVCNbGTUJBLHeDYRMZIQXWAfPFKdac,FABGdCGFaGEFOEFD..SEFAEGBG.CBCD.GDDA.TDBFhAAAUGBEBEBDeHAGDAEEhAHAMBDCQBFEhAIAAADAfDDGPFHDKGHF...cBDG.hAAA.NCACLABFhAFA...,1,0,-34,34
fJAGEecDXKaSHUbVFQIPRCYLgZBdNOMTW,eBFHXFEDKHCAHCAEUEAG.FEDF..QAACRACGLCHFBGCHhACAdGFGMAEATEGH..hADA.fAFBhAEAABAFEHGGDAAA.bCCA...IHAACFCG...hAIA......hBBA...,2,-15,-15,0
BWIDYUOPLfJdHQAKGSZECbVMRgXNcFeTa,KFDBGFEDEAFB.CCHB..MECFRBBG....XDAHFCADeCDBaHGCBBGFhAAA.DIAGUDFCOHDEhABALHAEdDFHAAGE.SAAChADAZACE........hAEA.gAGBhAIA...,2,-32,-23,9
QgURVIMbPEKLSWXaeHGFZBDYfdJCcATON,OFEHQEBGRBGH.MICCEDBE.LEEF.SADDhAAAaACHeHAEFEADBCBCDAEFfDGBhABACHGEABAB.NCACUFGHhACAIFCGKBHHWHACXFGA.ZAEB.JEEChAAAcBFG...hABA...,2,-20,-5,15
WMNJFDLPQSIEKecCRAaXHOfUbZTdgBGVY,aGEHHACF.OCADUFGAZDBEdGCCBGACGABB..VEFAMGAEFAFCDCFHhAAALCFG.SGHHhAAAKCACCFFDADIHXAFBhABAbEDH.....YBHD.hABA......hACA...,2,-22,-16,6
WgbSdAJPMCEYcVfOKNGLUFeRIQHZaDTBX,JEBDMHBA..EGGDVBEF..KAGCLABEeDCG.REGDHAGHDDFGBAEAhAAAXGED.bDCDhAAAAHFDCEGC...fCAHhABAOCBF...NDIG.FFABZFCD.aACF.hAFA......hAGAWEAF.,2,-45,6,51
ZTLJQcKFbfGeaIPECVDXSdWYRUMBHANgO,OCAATDDH.LEECQACAKAAAFFFDGFBD.eFHBaAFBEAGAhAAADBFFXFFD.hACA.SCEGhADAdCAFWAGF.UEACBBHHADHEgGCF..hAEA......hBDA...,2,-24,-10,14
OXBCgSLADZeJTUGfWPHFdKRbMEYaNQVcI,ZFCBeADFUDACGDFC....fDEDHFBAKCBHbBFCEAAHaHEEhAAAQAAB.IHDHhABABGBGCFGGSAEHhACAAHHDJAFCPDABdAGAMFIBNAIG....OFHDhADA.XBCBhAEADIAEFEDG..,2,-10,5,15
TagFKGAYPBRebNdEQZfMHSUOJCXIVcDLW,BGAEREFAeEDFdCDD.QEGDZCFCMEBFHABEUCAH...CHHB.XGCAhAAAVAFE..DICCLBFHhABAaBAH.gECHhACAKDCDAAAG.YAHFNEACEGEG...SHGChADA..hAEA...,2,-30,-5,25
VdIeJFEUQWHGDbPgOcMXLTSZYfAaRKBNC,aBDFBAHB.CHGA.dDGC.eCCFJDDG...ECADQGBEGFDDDBFD.hAAA....bFAHgCAEhABAMDIBLHEAhAAASBGGfAHAAEAEKEGDIDHFhACAFABD.HABC.cFAGhAEAXAFB.,1,3,-32,35
YWGEOSNMTKPcQHCRVXBfgUeZdFbaIDJAL,LBHHGEGCOGBCMFFDKECDQCDD.CADD.RADHBCAFUBACZEAChAAAdDDHFABA.aGBEDAHFhABA.AEIHEGFB.NIAB.TBFGhAAA...cGGAXEEG..hACAfFAC.hAEA...,2,-27,-13,14
IHJAEFCeXLOVWGQMYcTRfUbKPNZBDdaSg,CGFFeEDCLABGOEHHGCDH..MIAGTAGBRAAHUBEH.KGFDhAAANCAG.DAEE..SGCGhAAAHDBDACHHFAHFWFAHhACA...QECBYDAF.cEGFhADA.fGHEhAFA...,2,-27,-16,11
NFAVWCDSXYTUEcPbaRBHdfJQOLeMGgKZI,VFABCDBHDFCB.....SEFCXFGFUAGCEADH..bAEDBHDAhAAA.HADFdAAHfGFAhABAJFAHLDFFeDDDhADAMDDBKHGA.NCIAAFGETABHaGCD.OBAHhABA......hADA...,1,-3,-25,22
bRLNPXUaYBIGEOVKAFJWMCZcQdHgTfDeS,FFBAJHEA.CHDB.ZABD..QCACHADE..TCGBDADG.SFGGhAAARFGHLDDCXEDEhABAaGAFBAAFGFAFhAFAOAFEAHHGMIBEdEEE..fBBD.hAGAeCHD....hACA...,2,-28,-8,20
SWPADCNIeVcFXLdQBURTYfaZbOKEJMgGH,CEGAeBDEFCAC.LECABAFC.REGB....fCBAZECHKAHFMCCAhAAAGGBF.SBAFhAAAAEFEDDDC.NDDFIAHFhABA..cGGC..dGACTEAFhABAaAEA...EABC.hACA..JEEH,2,-46,-9,37
aEcFVbQOJITNULAKRYdgXefDCPBMHSWZG,KCEFdCECeGBGCGAE.BHFDHFEFZADCEDGE.FAEAQGGF.OCAChAAATFCELEAAhABAAIDERAAC.XDGHhACADIGAMAIBSHBGaDAE.cAGF..hAEA......hAFA...,2,-27,-16,11
SIFdNQGeDMcLbECXYgRHZJOVaBPTfWKAU,UDEBSEBEdAHGGDAADCFBLDGD.CBFE.XBCG.hAAARGCGZADCJABBaADBBHGHTFAChABAKBADAGHC...FHFEhAFA.eAHD.bDDHEFFD......hAAAYEHH..hAGA...,2,-24,-23,1
BgZNaCfFXdJLQTKAeOIcUbVWRHYPSGDME,eFDBOGEGUCGH..VBDCRDBHHADA.SCAFDEFEBAHEZDAChAAACFHA.FGBDdHBBLABFhADAKABHAHHF...IHDChAEAWFFD...PHFCMFABEDDE..hAAAaDGA.fFAFhAFA..,2,-20,-20,0
aXCKAHITFSOZVNJMeWcfBPULGbdERDQYg,HGFGTEEESCGB.ZEAFVBAGMEEHeBEC..cBCBhAAABEBFLHDAhAAA.dFHADCFBYDFChABAaGAHCAFFAECEIFFHNEAE.WABCfADFhACA.....hAHA...,2,-28,-8,20
LbGHYBFJdTeNgEcMRPfZOXCVIQAWUSDKa,SACBaCBAGDAHBGHAFBEA..dFDDTFFHeCBF..EHFEMBBChAAARCGFZGAACHBB...QAAChAEAAGDADADCKBFFHAGHhABANEIA....cDEGfHEB.OEFAhACA....hAGA...,1,-9,-22,13
cFCWTPXgGfVZDYdeSEMRIOLBbNJaQAHUK,KFFCFGGCCADD..TADH..XGABGAAAZDEGDAEG.dFCCeBBGhAAASEHHRDDA.IBGDhAAABCHG.NDAG.QFCGhABAAHHF.HCAHUGDCcGDEWFAH.hACAfAHE.hADA.EDCCMFFG,1,-14,-19,5
DIaQWAGLJCFPVEZXgKOReMTNUHBbYcfSd,LAAFFAEEEDAH.ZECHKGGCREFH..MAEHUDGEBHBH....bFDDhAAAfGAF.hABASCFFIHACaDDBhACAAIDGCHHB.XCBBeAFCTBBANCFG...hADA.cAGE..hAEADIFC..,1,-17,-33,16
QOFfJAPdXBZCMSLYbcaHEVUWeDKRIgGNT,dEFDBDHFMHBASAGCLCCF....bCBEaAEEHGDGEABE.VFAFhAAAUGEC.DHGEKABERBFC.hAAAIHHA.gDEHhAEA......NBBGOEAHhADAfBCHADEE..hAFA.XEGE.,2,-19,-7,12
OEPUTHgQGNbWdKXBcCaRVMZALDeIJYFfS,LABADIDCeECB.JDAGFBDC..OAGBEFFGUCGAHFAD.GFEFhAAA..NABE.dFCEBGBEhAAACHFDaEEGMAFEAHHE..IEHBhACAfFEGSCCE...hACA.gCCGhADAWAHB.KEAD.,1,-9,-35,26
HPJafRTgGNQMDKZcSdLVbAFOXWYBeCIUE,ODGDXCGEBAEA..eADACDEA.UFEFEBBCHEAHJCDG.aGDATCADhAAA..NCEB.DBGEhABAKDCHSHAEhACA..dAGHbEACAIFCWAACPFHD..gGGGhAEAMEEA.LHAAhAHA.,2,-29,-7,22
eKCWfVDNMaEJTARLdOcSIbGUQXgPZYFHB,dEEDSBGCGAAAQGDG..gDBAZCGFFAEDBHBDhAAACBDBVEEADHGGaEAEEHDAADFGhAAALADF.IAHFhACAXBAD.YEAF.eDHBhABA.KFCGfGBDhAGANACD..,1,-11,-26,15
gEPDBNJcfeSdKUZaWHAQGMYCRTFIbOXLV,MCCCCCCERCGF.FCAC..OEBHLABG.EHEEDIBEBHAD..NBBB.hAAAJGBG..eGDEdBGCKFGEhAAAZCDB..aAGAAIHEQDDChACA..YEHBIFAF.hABA.XCAC.hADA...,2,-31,-31,0
fLKJYRFBMaNVcSXOEUAWbDZPQHTegCGId,DCAGZAADHGCAeAEGGEEGdGAGLCGB.JACEFDAFBDCBaGAG..VDGHhAAASFEG.hABAEAFCUDCF.AICAPABEhAGAgCEB.IHGFfHAH.hAAAKGHH..MEIF.hAHA...,2,-17,-11,6
OePDTAMZGUfSdQELBaNbKWXFgIRYcCHVJ,ZDACUBDGdFFDLFGHBFBE..aEEGKCBC.FHDARBGF...CGBCHBFDhAAAVABF...OEAChABAeHAEDAFFAAGG..MCIBhACA.SEEDEGHF......hADA......hAEA...,2,-34,-28,6
fIGKQSBVgbZPJFYXEUOALWNdMHDCcaTRe,LCCCdGDDHBDBDAIDCHHC..aDHFRCGDeEAH.GABAQGBChAAABHGA.bBFFZFBD.FAEAEEDFhABAADAEMEGHTFFGKAAFgABChAEA........hAFA......hAGA...,2,-19,-10,9
fSgJdZKcPGXRDbCeUFIYLQaTWHVOAEMBN,EACFMBBFBFGG..SFCCJEAG.dHEDKGBCGBFERADH.CGGBFDCChAAALEFE.QAGHhAAATADDHFABhABAAHHC.NAIE.fHFB.ZFDH.cBAHhABADFFD.....hACA...,2,-23,-19,4
PJObMLaWICVABGTKcEdDZQRSYFeUHXgNf,TEGFECCDDDFH..ZBEGRBBCFAGCHGDG...XDAH..gFDDhAAA.NEBB.hABAfGACODAHMCFGhACAaABGIAECAHDHBFBAcGGCSDGAhAAA.UGGA...hADA...,2,-29,-14,15
NXcDBGZJSATIdWYPgUbfFOEHMKRaeCLVQ,TEFAdCEC..PDBFUCCBFCFA.HABGRFDGCABB.LFBB.hAAAQFDDNEIG.hADADBABZAFAAAAC.IHDChAEAWEHB....YAECfHADMAIBhACAKBBDaGHHXDFFhAGA.BHGG.,1,-2,-23,21
bIMcNAERFWaOTXHJLCVQYGdBUDeKfSgZP,REBFaGDGOBHDHACDLEHF..CBDCQBABdGAGBBFBDBBFeGDEhAAAKGFHSEAGhAAAZDEAIHAGMEDC.ACEFECGChABAFBFBXGGB......hABA......hACA...,2,-26,-17,9
JgDHOAFXCcTWfaVSEGUbRdNeIQPBZYMKL,CAFHTGGH..aCEHSACFUABC.RDFCdHCDeEBD..IGAChAAABHGGMFDGLAEGhABADFIHAHBF.XDDDhAFA.WBBDEGDHNAIGZBFEKDBE.....gCFBhAAA..hAEA..OGDA,2,-43,2,45
MCJOBSIPaQgdVeZcDFXfRTGHLAWNUEbYK,UECFEAGBKCAECCCH..BGFG..IEAD.QGFHhAAAdAAFZAEHDFIDFFGARAGFHGAAAGCD.hABA.NDCF.MIEGOBBAhACA.SGCHaDADeADB.XEEB.hAGA.fFFDhAIA...,2,-31,-18,13
WdBGDeTUOFRXQcMJLZPVCHaKgYNEIbAfS,SADFBHDBeDFDOBDEFFFH..XEDFQGAD.MACChAAAJAFAZBAB.PCGFhAAAHDBHgAGEhABA.NDIGEGEGAFDDWFBB.DGIB....hABA......hACA...,2,-39,-8,31
DbFJRPfcCTIOZgLBVaeHEUdGWQMYNXSKA,FEDDJBBC.RBEC.......PEACCFFBOCACLAECBFHE.eFEFhAAAUGAGGDGE.hAAAMDAGXGEHSGBHhABADBAC.fDEFIAEC....hACA......hADA...,2,-49,-24,25
LOeVaSBZcWFEHCdUNXQKRADfIMPbTgGJY,DAFBMBBD..TAAFGEECLCDFOCGFaFBABGBG.ZFFDFDCGCGDFUCGAhAAAQGAE.hACAAABE.IDBE.hAAA.bAFC.gACFeFEHSEAGhADAEGHH.dAGH....hAEA...,2,-22,-5,17
ASHaVKZTGOcQIRPWFEMfDgbeXdLCUNYJB,aDCEVGFAZFAD..GBEGOCAB..IBDFRFEBFBEG..EBBGDEGAhAAA.eABBLFDDhAAACEAHUGBAJEHBBCAAACGGSAHBhABAKBHH..cAGB....hACA......hADA...,1,-20,-27,7
EHIKUGYTLPZJVNWcaReQgFCBObDMfASXd,XGFHHGAAKEGCUCDBGCDBLAFEZBAH..JFAHVFFD..hAAANAAF.aCBHREFE..eGCChAFAQABBCBFB.BGDBhACADCIFACDGSECA.ECGC..YEBGhAGA...hAEA...,2,-15,-13,2
XUaLbcPMgERSTYfDZBGCWQNIJFdKVeAOH,HGDCUCDBLBBD..cBBAMFAEEGEFSFDC.hAAAfEAFDHACGBGEhABAQGAHNGABFADFdGGA.hACAKDECAFIBaEEEPAGD.gEGG.hAFAYACC.CAAFIHHAhAGA,1,-1,-18,17
fEKIOSMUAWLDJNBPFQZRVebXCaTdYGcgH,LDGDDIDGBAFBFGEAQDDG.VAFCXEAG..TFAHhAAAdFDCGBCDHABEKHFAhABASCHHAECF.hADAJBAHNDIC...ZDDC.eAAGCEACaCDA...hACA.YAHD.hAEA..fHGF,1,-11,-20,9
QPKFMAWdcBUbNaSEHDZeVRfLgOYXICGTJ,dFBFUCFEaHGGHDAG.DHDGeDDCRAAD.LBAHOADE...IADChAAACHAA.GCGEhABATGGEJAFEKFDEAFFG.BAHHhAAASGCG.EFEB.fCCHhACA.YFAF.hACA...,1,-3,-38,35
SJbXHaVKcPMEdQZWTeRGCFOUBDINLfAYg,SBBHJFDCHGBGKCFGMEDG..EHGGQBFGZBAG.TFCHhAAAeAHBCFBFFGHFBHEAIAHChABALABE.fBEAhAAAAECBbACBaGFFcGAH..WFADhAFA.OEEADDIH..hAGA...,1,-6,-22,16
AZYQdgISJRWXEeDbaLTONPfHCcVUFKGMB,QDCEdHCDSFCCJGBE.RACH....EAADeEHFDAEE.aDAGLBFFhABATCFD.ODHDhACAPAHFCAHG..UGFGKBAEBACEhAAAAGDC...gFEH.IFAGhABA...hAIA...,1,-14,-27,13
TagZPAdFbDScfNEWXQMUJeCVBLIOGRKYH,FBGBSHCG..NBDE.EEHD..QEAHJDDDCEAF.BFGBhAAAICBCREDFKHAA.TFEAhAAAaDHF..ZAEDdCGHDBCFhABAfHGD.WBBEXGED.hABA.MBFE.eCFDhACA.OFAD.,2,-28,-11,17
YXIAeJZRETaCOfPKBQVGHFWMLDSdUcNbg,ZGBERCACEFBGaABA..OAEDKEEGBFHF.GCCBFGGBLCHH.hAAADHDASEBGhAEAdAAHUDEF.bBGH..XGAHhABAIAFHAIHE.........hADA......hAEA...,2,-30,-26,4
AJRMVadHZGTPQEfBDCXWbcFYgSeNUIOKL,MICGaAEFHBBGGABBQFEFBEGHDFCHCBHH.....XFDGhAAAcDGH.FDEG.SBAGhABAUDAFOGAAKBGCAAFAhACA.JEAHdEDF..TGGEfHGF.hAEAWHAA...gAAChAAA,2,-29,-7,22
eJDMWFYVCgTNRGEHSLPafdbBXAQKUIcOZ,QDCAKECEUBDD.OCFDeDGH..MIDCFBCECAFA...TFAChAAAGDAGHFFGSGEGhAAALHCGaAGFdAHCBBAChABAADHGZBADDEFD.........hABA..WDHH..hACA.gGBH.,1,-4,-22,18
TCWeHaYJPALGKMEFBgRZOQdcINXSUfDVb,KACGMADGBBBGRDFG.ZAFBOFDB..dEAH..IGGBSEDGhAAADCCG...VEGHhABACBFGeAHH.aAAAJHDAAGFDEDDChAHAFBHHQCDE..NEBE..XDBFhBAAfCAE.hBBA...,2,-29,-29,0
XWfdJYPUgAHBKECNFLRGQMSTebVZDcaIO,HEDBBCCGCEHCLAFCGCAA.MABA.eDHDZFDGDAGHaBBB.OABChAAAXGBCdDEB..JAHFPCCFhAAA.AHHBECFAFHGCSFADhABA.....bFBHcGEDhBAA.fEBEhBDA.,1,-17,-25,8
ERAcUfZPSHgWQDVOeGKXBCJYMbTLNdaIF,UFDFZGDGHEFGQCDGVBEH.GEAEBAGDCHAGJEHF....MDCDhAAATCBDdABCFACEACHH.hAAA.fABDhADASDDDDAFBKCHHXGFD.YAHHhAEA......hAGA...,1,-17,-22,5
IEgXbBRODGWFVTPQcNUMeaLZKAdSJCYfH,JEBBCGEFHEBA..EHEGXAFABDGA.DGDBGAED.FFFGPBCEhAAA..QCBHhAAANBIG.MFDDaGAFKEEEhABAAIHCdADCSGGBIBAD.bCBC.WACChAGA......hAIA...,2,-26,-26,0
AEQMDfXgJCSHUBFWORYeZTVdPNILcKbGa,QFCFMAEBDFHB...XFGDCDCCHFABBDGEOCABRAACeCFDhAAATDCF.dBGB.IFFHhAAAKEEDaAFGAAIH.EDAFJBCGhABA.SHAAFHCE.WEAH.YHEAhACA....hADA...,1,-21,-23,2
MBRETPedFaICAObZYKcHDfGVgLWXQJSUN,OEDCZBECKGEEDADCGEBE.LBHHQGBCUADGBCBBEAFCeCAHhAAAdEDFFAHF..aDDAABDH.hAAA..bGDA.HABDhABAfHGD.....WCAD.hAIAXDGE..hABA...,1,9,-46,55
GQDKbRgLeJXTENYFdfMAHZcaCOUPBWISV,ZGDACBGCUBBEBDAA...SCHHGBECQGGFDFID.KFAGhAAARADEeFEG.XAADhAAANEAHdCHE..AAIFaHAChABAPCDB..IGEAgGAC.LAGBhACA...hACA...,1,-19,-33,14
MYfJCdSTeHFAEBbIKVPRDQcONLZWGaUgX,EEDEBEBDKDAFRDEADIEE..OBHDLAFEZGDAGACHUBCH.MCCDhAAA..JBADCHAESGGBhABAeHCCHFGDAGCBIDFEhACA..........hADA......hAFA...,1,-28,-37,9
eXfABWHdMRCGFTbVgZaDSEIKcNJOLYPQU,BECDdFBDMEECCHCAGFDBFBHB....TBEBVAFEZABE.DFIDIACAhAAA.KEHHNDAB.hAAAOBACLHEAQGGHhABAeFABACCERDEGaEAB.SHAA.hABAEGDH.YFFDhAEA...,1,-15,-26,11
dGMQIEOBAeSgTRYKXHacLPFUJDZVbfNWC,eAGHTBBFKCED.HFBBaDDE.LCAD.FGEEUEAFDDDFZBBDfHBBhAAA.CHGFMGEGhABAEDGAAGIFSGADhAAARBGF..YADG.....hABA......hACA...,2,-22,-22,0
ASfFYbCTePBVKXJQRdEMcWHZDgOUGaNLI,SFHDFDFGCEHE.eGDEBFGB.KDDDQABB.dAEFEGGDhAAAMDCDHABBZDDGOBDAhABAaHCALAHBAAIH.hADAfCAAbGCG.TBEDXAGD.hAAAJFAD.....hACA...,1,-12,-28,16
gSTMYROADfdFVLZHbKQBEJWGeNPCcUIXa,dAADLHDGHFEGKGBEBEDGEHAGJDBH..eDDECCCA.UAGB..XFFChAAAaDBF.SBBChABAMDADOHFEDCADFDGEhACA.ZAFGWBAA.NDIG.IHHD.hABATGABAHEA...hADA...,1,-15,-28,13
KWNcQVXPIGeEYaJCOUAZfHFBSLDRgTbMd,HEBDFGADLCCCDGABREFA...TFGDdAFAKDDE....WAGFhAAANAAC..QGDChABA.XBBBhACAIDDGEGHDaHEACBHGADHCfBAFBBDH.bEAG.hADAMCIH.cEFBhABA...,1,-13,-41,28
NJUOXaGBHFLKEdcTgDfbCIVWMYAPZQeRS,ZACHRFEE.SECAUFBGOCCCGAEE.BGBHLBEEEEHHdAGHTDGBhAAADCBD..fHEDhAAAIABCMEAEhADAAAEBQGGF.NBAEaBBFKFAF.....hAEA..cDGBCEEFYFHBhAFA.,1,-5,-33,28
CSYZLJHWXafABeGVMcTUDKgPRbINEdQFO,eDDFVFCA.MCIB.UACDDEBGKCCE.RGFA...IGBBdCFHOACGhAAASFFH.hABALAGFHAFEaBBHAGIBBHCHhAAA.GBAEcEEA...PHAChAHAEFEFCHGH.....hABA...,2,-21,-20,1
NKaBPYIOFeGDJfQHLCUcgdTXRZMAWbSEV,SAEGEDDBKACC.BGFF..IBEHeDHFDBDBJGDEHCABCBGB.hAAA.UDGCdAGATDEGhAAAZCBHAICA.VECB.NIAB.hABAaGAH..OABFfGHEcFAC..hADA..gFABhABAMIFC..,1,-11,-30,19
gdBbLRWHGUNSJQFTcVfOEYeKAPMXDZICa,XGAEZBCHCDGE.dEFABGBALAFEHFFFUAFB..SDEChAAAQDADFABATFDEhAAAcEBF..fBBGhABA..YBGHAHIHDEIDaADFbBBC.hACAWHFCNIAB.ODHDhAEAKDFF...,2,-30,-10,20
NYGBaITKPSFQULDgdZWRMefJbHAOCXVcE,XEBFECHHGFCBBCHE..aADFKDGBFAGCLCBADCDFZAAFMHFChACAeHAC..JABEAIAAOFFAhAFACHGA..VFEANIEB.hAIA..IAHGTCEESFBDhBAA....QAEAhAAA,2,-23,-18,5
QLHDNfWYgGSOZTUPdRceXVaFIKEbMJACB,BHABQFCHLBABHBAGDFGD..NAED...fDEDhAAA..YCEHhAAASDBHOBEATAFAhABAPHFEcGDDeDHFaCHDIDABKADEMCCAABIB.hABACDDDWHFA...hACA...,1,-19,-20,1
MUJgNZOeWFBTCfRdcKXYDVLHAPSQaGEbI,SAHDQCADEEHBMAGB..UGCFJACAZFDBeDEB.FBGDCBAEdFADhAAAKGGDDAIF..LGFEhABAABFHGACAICDBhAFAgAAC.NFAFBHAAfDGH..hAIA.XCBD.hAAA...,2,-20,-15,5
HbJdKVXPBEOgMecNIGTQSfZWYULCaFRDA,JGDCKHCC....XDBCECBH..ODHHeABE...IHBDhAAATBBHQFFEhAAAZEAEUCEDLACGhABACDFEFHACABGCdAEEBAHG.MIEAcEDG.SHGAhAGA.fCGBhAHAaFEA,2,-36,-28,8
FZMVfEHbRQBWTCADdUSgJeLaINcYPOXKG,dAEAUEBBJDDDLFEG..aBCH..NACA.....PHAEhAAAXADAKFEHFGHBMHAEhAAA.EAGEHCFH..hABAQCGABDBDCDHAAGAHDCABSEEE.hACAIBAE.YFHBhABA,2,-39,-24,15
FJeYgQEMPTaAUOBZDXdNLfbCVIcKWGRHS,BFACXFEGdBCHLDDC..fBADVGCE.IDEHhAAAKDACRFFD.HEAFJAHD.hAAAgAED.hABAMEIBaFCGAACEZCAEDAEENCHECHAD.WECBFHAC...hAHA......hBAA...,2,-28,-6,22
KdPOLReXWTIaMCGZbDHNcYBJVSQgfAEFU,EECEUDFBKAEHOFCF.LFAHeABDXCGE..ICCHhAAAaFHHGGABDABHHADEhACANCAA.BGFE.JFHDhADA.SEDBfGFGdAHCPEEG.hAFA......hAGA...,1,-17,-21,4
HYUaTWfFPeZNXIDJMSGVLACKgdbcERBOQ,KBBAdFCAECCGBDBCHGFEUFGB..TCGGFADC.eDBGZDED...IACDhAAAMAADGAGChABAVAECCHAH...cEGHhABAOGAA.aECGPEABDIEA.....hACA..LFEFhAEAAIBG...,2,-31,0,31
bWTZgcJIRKQdfSANCYPBGEDVMULHaOeXF,CEBHBFABDHEA.UFEEHAGD..aCFGeBCG.FCAD..TDGGZEFGJGAEhAAAKAAH.dDABAFED...hABA..NICFGACGhAAAMIDCXGGB.bDDCcFBD.IAGChACA.fGGDhAEA.,1,-19,-37,18
EfUDSXTBVNQLIRGFbWPgKMcCaHAeYOZJd,eFADOAAHZDDAdECEUBECDDBF....SFHDXABCBEHFhAAAQBGDLHDGRCDBFHDChABA..PECBMAEECGFFhACAAAEAEBGC..fGBG.NBBD.IHHHhACA.bFFC.hADAKDAEaEGG.,1,-11,-27,16
UKRCEfbJeFOZYDNadSQWTHGBAXcPVLMIg,XDCEVEFC.LCAHMICG..UACHCBGGEEGC..JDCGFGHDZFCAhAAADCDGdBAA..SAAChADATAFH.BHDBhAEAAHCE.IHBD.KAHBfBHAhABAOFBEaADEWFAB...hAGA...,2,-28,-25,3
dPbUMaSOfQJAGgFNcCKRHWLZeXEDVYIBT,FGDECEECKBBAHAFB.ZBBEeCDADDDE....VFAGIADH.BEGDhAAATGGHdHBFUBGEhABAMFFA..OABAQGGHhACAAAAH..NIAB...cFABLAHHhAFAXECH...hBBA...,1,-16,-28,12
TVdAXOZPbgRFUeYQDBIfNHMSaKWCcGJLE,XFGAZEEF..bFACRAEEFEFE..eBCDDAAGBFCA..NACHMIAEhAAAaDAH..CDECGBBHhADAEEGHdBFFAECB.OBADhABA..gGDCYEHB.QGADhAEAfHDBSAGEhBAAKDFC,2,-28,-27,1
VFWPGXcEaYAKeJSLgBZfQTURDINOMbHdC,JEDHSBCBLAAGZCAF..QGFARGECDCHB.OCAHHEDEdGADhAAACBGG.FAFGGCDHhABAECEBAADG.KAHBBABFTFADhACANEIC.MEIB...WCCFXGCDaHAC.hAEA......hAFA...,1,-12,-14,2
RDdFWMQbYXJKITUGOPaeNcAEgCBSfVHLZ,EFFDBFAH.SGCHHACFLAABRFEB.FFBFMBHBQAFGhACA.bDEGXCBFhAAA.IACFTGDCOHFEhAEAeECAAAEGfBEDDDGEWHAG.KHGG.hAHA..PEHDaEBA.hAIAcGAD.,1,13,-25,38
NZXfTBGCEUIdHWSgVYMLaKFcbOJAPRDQe,DAHDQCCGeFBAZDBE..TGAGBHDHEGEGUDAA.dEHAHBBASHDChAAAVCFD.MBBAhABA.aFEG..KGAFcAGEhACAODHD.ADABNABFfAEDIHHD.gGGGhADA.FDFGhAGA...,2,-17,-12,5
OLJaVdbSfRgWIKUZTMHDBGQecCXNFPYAE,LHBEJFAC.aCFDVBDF..dCDF.SGFFRFEB..hAAAIHDDKEBETABBhABAMADADDAABCHDGDGEhADAQAACCFBDFEDDAEAHEAGEfAGH.gGGBhACA.WEFEhBAA..,1,-15,-33,18
cgNSYeKZPARfFIDEHLWbJMCQOXBGdaTUV,FEEGDDEGHDCBLBBFJBBH.CGGB...OAFEGBGAdFFAUFBC..hAAAVGAE..gAEAhABASAEDKDCEAIGG.hAAA.IEHEEGFBMIBABHHBaAHF...NBAA.hABA......hACA...,1,-18,-29,11
LNbEPMSYFGVQBIDfeACTdWZcXHORgKaJU,dGCAZDECHACARBFGKDDG.aBADLEHF..NDDA.EBAB..MFAHSEBFhAAAFBGCQGGHhAAA.DECBAEADTGEAhABAWEAB.OFDG.JADG..bFDD..hABA......hACA...,2,-23,-17,6
XGdceDPaZbYERfCISUALgTWBQHNFMVOJK,LAFDTFGA.QEEGFBEF.OAHDXEACdHGDDEHDaBHDZDCHhAAAEEAH.RGDA..IHABhABAADCBBAAFHGCE.hACAMCBEKBGFeEEC.......hACAYBBDCADFSGBFhAHAWADC..,1,-11,-25,14
KHVPRAZNIegdQMWYcXBTFCSEaLUDfbJOG,ZBAEeDFBQFDEMACB......WBDAcEBDBGHECAFDEBHBhAAALHCC.DBBDhAAAJFGFKDAFHCEEREBEAIDC.gGAGhABAdGACTCGCFEAG......hACA......hADA...,1,-13,-20,7
CYDbHRcAIaKTOMJfgZEFVBPWULXNeGdSQ,aADBTGCF..MBFEJADE.ZDGH..FCEEVCDHBHGC.UDAELFCFhAAA.eCADSFFEhAAACGEEDBAA.HAGHhABAAFFCKGABgABF...EECG.XGEFhAIANIED...hABA...,2,-26,-15,11
AKLaBdcCWPgNDTURYZeIOEXMfGQSHbFJV,KFCHaCAFBBFFCEHB......PCDGDIDEUECCRBBB.eCFAEDAH.hAAAMAFCGFEFHFGFFAHDhABAJABAAHHDLADGhACA..dEFA..cFAG..WEADhAAA....gDEAhAEA,1,-16,-40,24
SWPZgIeBcCXMKaLQNbRdYUFOJGVHfTEAD,SCAAZFBGeCBFBHDECFBE.KDFHLHFA.QAEFhAAARADCdGHGFDDBGAGAHFFATEDAhABAAACD.DFAB.WCHBhACAIBAGMIAENDDD........hADAYFFF..hAAA...,1,-3,-35,32
ODfRLeFgNZcKGECaWHMUdBQSJTIXAYPbV,...PDEDOEEHDFIDRFABFBEB.ZCGDKBBFGBBGEECB..CGDHHAFBhAAAMFIHdAAGBHBASGGHhACATADC.AAHE..hABA.YCAF.fHEHeAEEcGEDhADAaGGD..WAHB.hBBA...,2,-22,-17,5
AQRdcMXBEUJDTZgOYaNSLFHbGfePWVCIK,QGACRAABMBFE.BCEHUFFADDDHZEBHOAAG..aFABLEEFhAEAFDDA.HAFGfDGDhAAAeECDVFGDKACCAFIFhAFAXBCG........hAFA......hAGA...,1,-15,-32,17
IBPeMJNXfRAcgESGLaHQZUKTDOFbdYCWV,EGFCGBEAHBFCQDAFZBCDKEEE.OGEAFGBGdAADCHDD...IEHDhABAPFAH..JAAGXDABhADAAHHH.SFDBhAEALBDFUCGEDIDE..WFADBFHE.hAFA......hAGA...,2,-19,-11,8
FQRVCHBISZNLMPXfUdKGeAbgDaYEOWcJT,DGBEaFEE.ECBH..OEBE..JFEGFCGHQBFFRABDHGAEBAEAhAAAZAAEMAEF..XAGFhABAdDFHKHGGAEIBYHFEhADATDCD..CFACSHACNCIC..hAAAfCEC.hABA...,2,-28,-18,10
CaEgYDVUXKLTMPbSHOZINWQFfARdGeBcJ,dBEAeBCGJHEECEFG....ECADDBDD.UCGGKAHDMIAE..SCAFhAAAZGCC..WFAEhAAA..fFADhABAAGGG.RGBCBFGHcBAAaECC..YDEChABA.XAEEhACA..,2,-47,-29,18
PFDfKgGdeMEHCQOXVBYJISaWZRLcTbUAN,FCFDDDDAKACHdABF..EBHFHBFD.CGGA.OBDDBCAB...JFFDSEBChAAAZEADLEHH.hABA.bFEFAFCF..NAAG..hACA.PFBD.fAGDeHAAMAFC.hAEA......hAFA...,1,-22,-42,20
eOQfKSAWHdFPNaDLVGMERgUXBZJCbYTIc,HAGFFECD.aBADDHAAGGBHEAEB.REAG.UBGEBDCAZEEECHHG....TEEAhAAAeBACOFHDhAAA.KCDHAAEHdGACLDAFhABAMEIBJCDA.IACBcGEG.SEGHhABA..WHAAhACA...,1,-1,-32,31
XKFgRAQOCNBfVEGIdPWcbZeMUTJLSDHaY,QGCHCFFCBCDF.EAFAdCGE....PBEHbFAD.ZFFGMFDHhAAAUBBHLABCDAAHaEFCKEABhABAFEHDAAFF...OCBFhAGAfAHA.IHHDWEEDeAHBhAIASCGAXGGG.hACA...,2,-24,-22,2
ATFeDBGVMQJSgIdENPYCHbRLfKUcOXWaZ,eAGHDAAAGCDHQEBH..JFFBgABFEHAA..NBCB.hADACDDFRGACLEAGKEFFUGGGhAAAODHDaHEG.ABBHBHHHhAEASADAdAHA.....YBAFhABAfGCD...hAEA...,1,-14,-25,11
UNHMLTVBFYcZJAbadODGeKWQPCRXSfIgE,dDFAOCBGDACCKAAH..QEFDRGBC.SGCG.hAAAfFAAEBDGNIDBMBFChAFALDDH.BAAAhAAAFDDFZCBDJACCAHHCaGGAeCFC.WHDA.CHAH.hAFA..XCGFhAGA...,2,-35,-11,24
VaFIdeNgSJBZPfRTDEXKCYMOWbLHGQAUc,VFECaHFC..dDGBeCFA..SFEAZDEARAAHDIGG.KECB.CBHFMBBGhAAAOAFA.LEBFhAAAQCAGADCEFADHIGAFhABA...NADFBGHGfFCHEDDG.hACAWEHH....hACA...,2,-27,-21,6
QSbEUTfgNdOeMDaHKcZRIWFVJYPXBCLAG,GBGCSFHHEBBCUEDH..TACF..NDACdCDHMAAFDGEBhAAAKGBERFBB.IFGChABA.FDEGVGFAJAHDYEAAhACABHAHABAE.fCCGOACA.aAGB.hABAcGEF...hAGA...,2,-16,-14,2
INMSDfAbcBeZYKgPUELRdOGHJCXFWaTVQ,BCFBZCEFKGEFUBCBLCAGRAFG.dAEDGFEFHAGB.CHDC.FDHD..aDDChAAAQGGH.hABAIFAGNDBG.DDEFhAAAfDGFAIBG..cABG..hABAYHFG..hACA...,2,-44,-13,31
ROdKQDCfXYPEIGgcSMbWHeNAVLZBaUTFJ,LDAABHBCaAFA.FEEERDBC.KCHH..QGCCCHGF..fGBEhAAAXBCAPEFFhAAAEABDGBDF.SGDGhACAMAID.WFADNEAEAHHHUBAE.OBFBhABADGGE.IFHEhACA...,2,-27,-20,7
bVAKMPTIJYQCUSdFaDgcEOZHBeLWNXGfR,KGCEMAAA..TACHJHDG..QCCBSBHFdFCBDAGCEFGEHCFBhAAALAFDXEAChABARAGHABBH.IGGFCHHH.hAEAaFDAOCHDBDDCWFHBNEBC...fBEHhACA...hAIAPBBH.,1,-10,-12,2
FaCdUJXHBZPecYgfGKANOWSIbEMVLQRTD,OHDESCFB.EFFHLAEF.QEEADECBFGHBCCDEdAEDhAAAXGCGBBADeCHFhABAgCBHKHAE.AGDGIACGhAAAMDAH.TBFG.aHGAJDDHPBAHhABAfHCFNAIC.WDBFhACA..,1,-23,-26,3
IMYPaedKTUSWGNbBcVJXZfRHCEFDQLAgO,OBCHMIDC..aADDdDFA.UGADGEDHBDHBVAGDZADG..REGFHDAFhAAACCADECBE...DCADACFFIGAFhAAAeFEB.SGGChABANEDE.cFBF...fABFhAFA..hAGA...,1,-21,-28,7
MaELJTXcDHINAYfCeUgSBOFRdbKVGPZQW,CCDCUFAGBEEAFGFC..dCACKBDFGCEHZFDH...MHEGLABChAAA.JAGFXAFGhAAA.DGFCHCEDACCHeGAEhABAgCBDSHAG.bEAEPDHF.hACAaHGE..EEGC..hADA...,2,-26,-20,6
fMNVPRGZQXIgSWKdFBDcLHUAbYeEJTaOC,eEBAEECB..JAAATGEG..CHECMEABVCGBGACH.XGAHhAAAICCCSDAFhABAKGFEBCHHDIGE.hACA.cFCEUDEGAFIDaAHFOBFGfHGHhADANEBC.ZCCE....hAFA...,1,-3,-38,35
IBfYEASPNUcJbCMeTVdXWDGZOgKRLHaQF,SDEFUCGD..bCEDMDGB.VBBBXAAB.DDBCZBEChAAAKACGRFGHLAFGhABA.aGAAIAGDhAEABHEDYEAAAHGDPHCC.JFADCHAH.TFGF.hACAdECE.....hADA...,1,-15,-17,2
CfRVNLeKGQIXTSWbOFJZgABYcMEHPdaDU,BHCEMEDFHAECdCBFDEEDUGEG.RCGF.LDGDKDBB.QADFhAAA..IBBAhAAASAGEOEABJEAAABHBhABA.EEHBCGHFfHAH.NABBXBDChAHAWFEH.FEEC..hAIA...,2,-35,-18,17
gCEfeANHKSRJDbPaFcXWIVZBUOMTYdLGQ,KBCGJBDE.DFFC..aDHHFHBE....XFAHVBFA..BEBHhAAAOABA..MADGhABATGEHdEDELDFGhACAGBBACDFBeEDHABEA.NAIGSAADPFHF.hAHAIHHD..hAFA...,2,-34,-31,3
WULCNdgQZbDESYRVAXJGIPcBfeHTMFOaK,GAEC..PDFCBBHCeHDEHBEEFGADKEGDUCBELGFCCGBF.hAAAdACBZEAAEAAD.SEDHhABA.VDBFhAFAAEEBIGHF.fACFMIFCaBDH.NIAB.hABAgAGEDAGA.hACA...,2,-34,3,37
EbdIKVfaJHPGNODRgZWBCUScQYLeMXFAT,EADHdEBGKEGF..aGACJAGHGDEH.DBBFZFCDBHDBCCAC..UCDAhAAASBGG.QECHhAAAeHEEMEID.hABAAAED.ICEBHABHOFAHWAFCLFHFhACA.XDAGhADA.FFFH.,1,-18,-28,10
PDNBFOQScEbdeJIWGAMCHRVZXTKYLUfag,CAAERCDGZFFEKDAD.UBAD..aEGFDAFC..FGAF..SGCGhAAAEEDHdCEF..eHDAJEBC..hACA.ICBGABDBMBHF.hABAHACD..........hAEA......hAFA...,1,-35,-45,10
QUKMfeOFYdVILBgbaDWGSPRCTEXNZAHJc,JBDAQAEG.MHEAeEFA.FFDCdDBGLCAFBHAHaFDGDBGGSCHBhAAARGAG.CFGAEBBChABAXCDC.AIFG.hAAAcCEEKCBHOABGIAHD..bGEEWHDGhACA.....hAFA...,2,-30,-17,13
QMUCHRaNAbEdWcKLPBDGYFeTSOfZJIXVg,ECFBdACEKHGEBABGGFDBFGCD...eAHBTCAFSAEA.hAAAOEFGfGGFhACAIBAEXCGB.hAAAQDCDMDEACEAFaFCHAAEHWAFGPFAFDIEC.hABAJFEG...gGAFhADA,1,-16,-26,10
MbQXPaLVgdGHAfUeOIFSNCKWYcZRBJTED,UEBCOGBGFGFC..CAHFKAAC......YDDCZCCFBGFGhADAEBACDGGA.MCFDQADGhAAA.PBHHhABAaHCELFADdFACACCDfEHASAEENIBH.hACA..WBHH.JCBFhBAAXEEG.,1,-15,-34,19
AYJFgXOeIQcVEGBSRKPCMaDNWTUZbdLHf,JEFDXCGB..eEBCQGGAEAGDBDAGRFCCKFFE..CBCGDIEEhAAATGAHZEGD.LDDEhAAAAGDG.FACHOABAhAFAIDAC..GCDFMIDCaAFAWHAG..hAHA......hAIA...,2,-34,-6,28
UJbBLCdGOTHSMaKZEIcPfWAVgeYRDXFQN,eDGFDAEFQEGBUCABBGHEdAGGGDDCHEEBSAABKCFE.hAAAEDDAIGBF.hACA.cDAEfHFBhABAWHEGABHC..YAFG.FABEbFBDCEAHMCIDhAEAPACF...hAFA...,2,-25,-5,20
HERaNWFDXCALQTKbJfSPcBIZdYMUegGOV,TEFHKCEC..JFBFSACFBEFHZBAB.dBGH.MDBFeDDDOEEHhAAAHFGFRAGD..WFCFhABADBADAAAA..LDHBhAEAQGDFfCEG.IDCEhAFA.YHEG.hACA...,1,-7,-36,29
bJGfSWAQVFDIPcdTOYBReLMCZEKgXaNUH,QCBFFBBFDBIH...IBGCdEDBTDAFBAEF.eHAGCAFDZEGDhAAAEGFH.KDFG.aFDHUGAGhABAHAACJADH..fBEAhAAASHDCAIGAPDAHOCFF...hACAYFFCMIFE.NAIG.hABA...,1,-15,-26,11
OZSAfMRcBeaXLNYPVIWDUEFQbCgHdKTGJ,MBIHRABGBBGD..XEEFLHBA....PFDHIECHhAAADCBCUBFCFEEACDAEdDHATDAChAAA..OFCEhABAZABAAGGDeHFAaEAH.NACF.....YCCGhADAEHAG.QGGBhAEA..,2,-20,-18,2
BLfAJGbWZCReOUXHKIEdcDYVTagMSFNPQ,GEEGZAFFCABH.RAAEODCGHFEEKDDD..dGBHDAHH..TBFFaDAA.hAAAMACCFFCH...NCIABHGDhAAAABEA..WCCEhABAXECC.IAHDEEFE..YEAFhADA..SGADhAGA,1,-12,-47,35
XbfEHRcCPYJgdSWeGLAMaQBNIVODKTFZU,MHFCBBAC..VAEBKAFFFABGZEAH...UEFE..fGGDhAAAEGCHRCDH.CCBH.JAHBdDHG.hAAASFEHeEAEACDD.hAEANIAF.DIGA..TDCGXGAB...hABA...cAGAhACA...,1,-26,-35,9
WJHgXdMCecRTGDIAQZSbLNPEVOfUKBFaY,ZACCSDFGLECHECDDOBBH.UGFAKCABaAEF..JBHFXBGHhAAAdEFF.MFFEhABACAACeHAGTEBF.IACGhAGAAFAA.QGGHNADF.fHAFhAHA..FCCAhAIA...,2,-26,-11,15
QESfXPTcgZCeKYLFdNbUMHJGDVAWIBaRO,BFEARDBAQGAASHFA..XBFCTEBFZBCCKBBEFFEHdDEDUGBDhAAAMADCGDFAhAAA.DEIFWAHHaHDCOCABhABAECAB..fAEH.PEHDhABACCHH.....hACA...,2,-19,-10,9
QFYaNMHdeEfTRCUOSDBVPWZJbLIgXKcGA,QFFFaCGHHCBAeDEHEECF..RABH.CHADOAEESGAD.DIEGPAAGhAEAZBGDLAFDhAAA.IHHBKGGFAFGGNCICMHCChAFAdBAGTGCBBFCC.WBED....hABA...bEAF..hADA...,1,-4,-14,10
JcTQLHbSAOVWdgPBeNDZfYUGXaCIEFRMK,VFAEdBEFBHEH.DHCAZCDB.UCAEGDCF.CFFA.FFGB.MBBAKACE.hAAA..JHDCTCGBhABALAFEHFAH.AIHAOBBBhAFA....WDEH....hAAA......hABA...,2,-36,-29,7
TULcaOeIfGWRHgXKNdMZABbCVPQJFESDY,CHFGQBBGFCEC.DIEEUEEHLCGB.OFBHeACGGCBChAAARAEHHEDHKBADdHBBMAHFhABABHHD.....PEHFhAEASEAC.cAGF..fFAChAFAWDHHNAAHAGDD..hAGA...,2,-35,-10,25
XbeABdGHMfUgKQFcNIOVRTJPZWEYLCaDS,GCCDMDHHUCECQACB.FFCBNBIE.OBFE.RAABJGEAZCABEGBBhAAA.CCDD.DEHDSGFDhABAXDACAHAABGDGhACAdAGB.....fGGEKHDGIEFFhAAAPADCWDHB..aAHBhADA...,1,-4,-37,33
gaPWUbIYeSAJXQVLBOZKcMERTFNGHDdfC,XBEEVEDA.BDABKHGC..MGAEEDGFFFDGHAEB.DBBBdFAFCHBD.aFGDhAAA..UDAH..hAAAYACDAAHHJHCAOAHDhABARGAG..NAEFfDCH.WFHHhABAbACBIFHF.hBAA...,2,-28,-18,10
EFBDTYVcICLGANSXQUOWJeaMPZKHdfRbg,XFECQFGDUCEAJAFD....MCIBKHGEdFBHREBD.EAFGDCBD.hAAA.TABHVDDHCHACAHCGOBABhABA.aDCGZABAhAAA.fHEDFBHDBFHGIHAFNCAA.hACA.SHBAhADA.WBGH.,2,-13,-13,0
dSXgCKIRUEOZcAJfaQDNHPBVbGYFWMTeL,JABCaEHH..DCFDHDCHBDDCGBEF.FDHFTCAFeHBELFGHhAAA.dEFGSAFChAAACBBDKEAF.IGBChABA.EFFF.cGDCAAIB...fACDhAEA.NAIG..hAEA...,1,-19,-35,16
gEdXNBUORLePQfbMZYHIcWSKTAFaDJCVG,DEDEVAFEEADH..dCDGBDHCRABF.LGDA.QCBChAAAMFFGZFDAIHEFSBFChABAKDAGAGAH..aDFDJFADCHCDXFAFhACAOAAB.fHGF..hADAbCFC.....hAFA...,2,-28,-20,8
eLAMXFBWaEKgNUfScGdHQVJIPDRTYZbOC,MFDCBEABEBDGKCCH.UFEE..SCGGdHABHBBD.QEGChAAA.JHAGDDIFRABATEAHhABAYAGH.OFBChAAACAHCACAF.FHGEaCEBNEDD...fAEBhACA......hAGA...,1,-23,-24,1
JEUbCRHMGTQcSKdaXDgNPVZBAYOeIFWfL,eDCFFBGBLDAHEHDEUBFHCBCF..HFEHGAAFQFCESDFHhAAAKCDEdGHCDEAF..NAICZFEChABAAAIHOHAC.IAABhACAWADE..fHABJCHBMAECaDDC.hAHA......hCAA...,2,-17,-5,12
KZgHQGcSFUaVOMeDCINBYPWXfLJRTAEbd,EBCEKAADZFDFHEDBGCBASCGCUDGE.OAEEDDAH...IHHDhAAABBGH..PHAEhABAXBAD.LEAAhABATGGF.AIEEdHADQBDGaFFDMDHH.CCEH.hACAWEEB...fFAAhACA,1,-11,-27,16
NFJHOeYRWAdBGVfLKaQMbUICTPXcZSEDg,BHGFVDEH.LBCG.KDBFaABE.QGDCUGCHCBAG.XDCBhAAAZEECDBGC..FDGAHCGDhABA.eAEG.RGAAAGAAhACAfGACIHHD.......hAGA......hAHA...,2,-48,-10,38
PaNZOfgCJGdQLeVDMKEUSTbXFBYRIAHWc,HFEG..PBHFaEAAOFCDCDACGCDGdBDEQAFEeBCF.hAAADFIBEAFCUAABSGGFhABATDEB.FFAEBHFDhABAYHBGAEHC.WFFC......hACA..ZFAH..fDFDhADA,2,-16,-10,6
QTNHZVPgSIERcdDOUJbXLACGFaKBWYMfe,FCCEKBAHBFBAMEFF...QEFGHDADVGBC..SDCGhAAAEBAFdCFHDHGEUAFA.XGDHhABAAEIFaAGG.fDAGhACANAAH.PFHDIEGHOBHD.hAFA..JCCC.CHBD..hBAA...,2,-24,-14,10
WaNBgXGDFAKEOLVJebRYIUQTcdZMCfPHS,KGBDEGBHLEDHeDGDRCBB.UACE..QAFHdGFHCCFGHAFESEHBhAAAaBAF.BADHhABAXDGEDDAHABBBJEDBIEBEhAAA..cGGH..MICGWAHHhACA......hADA...,2,-36,-13,23
ECNaAegGIfPKOHdXLTVMRDWUcQSJZBYFb,eFCEGFDB..IBBGfCEB.KGBHHDDGLCBHMFBHDABEhAAAUAGASEAFhAEAJAACBDDGFEFACHFHACGAODHDhAFA.dBDG...XGDC..hAGA......hAHA...,1,-18,-27,9
DQZOVRIYaBEdWPLHAJUbTMFSNKcefGXCg,JFFHTGGF..SDDDKFAH..fBBCCAFG.DIDAhAAAQCAEOADGVDCGhABAIEGHBEHDEAHHhACAdGACPBHFAFFFMDGFFFCHeCDG.XGCHhAAA......hABA...,2,-38,-13,25
QeWPGDNMcLBFXbRIdfOATgEUVKJZYaCHS,TDCDEEAEUEGA..KHCAZACG..CDACHFAFQDDHeACEGBEFhAAADAIDMCDABHHA.FGGBhABARCAGdGACOEFCAHCHJGDCSFEDhAFA..NIDH.XBBFIAABhACAfAGB.hADA...,1,-1,-20,19
RUHceDgPGYJZVXSKCWOLdIaQMTFEfNbBA,UBDGHBCHeHACDDGCGFAFZEACSBEB.KHGACEFBOAFAhAAAdAGCaEGE.QCADhABAFAABEEEC....fCBGhACABFHEAEHEgGGGJHDEWAHH...MFFBhACA.....hADA...,2,-26,-8,18
TcbIHXDUYWJNgZQKBVafSOMdPCRLEFeAG,GBEHTGCC...IHGCHEEEDAAFUCADJBBCZFAHBHBF.aEGFODAAhABA.MAIDdDEAPFBChAAACAGCLAEHFHDGADDFhABAXCGH..WAFCgGGHhACAKABAfEAA..hADA...,2,-27,-2,25
FbVHDCQGJBcdKfTNXUWLRSOegYMEZPaAI,FCBBVEDACCHB..GEGCBAAGdBHA..TDEEUDAFRBDA..SFBAhAAAOHCA.eADEhABA.MBBEEGGBaACEAAGGHGDChACADIAE......cDGCfDCChAIA.WHBGYGAEhABA..,1,-23,-25,2
bRXSGgTNYQCMFcIZEAHafeWUVOLPJKDBd,HCAEaFHB.eGCCUFDAOGEELEAFKEDEDFIBdACCRCFFGCGC..hAAATFBFQAFBhABACCEFFAAF.IACG.hAEAAECBfGAG..WADA..hAFA......hAHA...,1,-5,-31,26
dHVMFYZXCUGaRWBQTJbEfAOcSegDNIPLK,OCBFSBGEDDEC.....IDDCKAGHHGAEMFBBFEGBXADEhAAAUFCAaBAFBHGChAAAJFEB.ECEEAEEH.eADC.hABANACG.dHGHZFFECEAF.RCGF...WDCH...hABA......hADA...,2,-29,-9,20
dRUZDYaENIXfPeMTcQObFCJHGLAWKSVgB,KGFGSCDABHCCUECCDHCC....EEEE..IEABXBBChAAA.eADEMABCQGAEhABAFAHBHBCAAGBFWDGBhACAdEFB.REBG.aAAC..fGHA.cGEDhAGAbCFA....hAHA...,2,-29,-25,4
IeXHgRCaDBYdcbWfOTAVLSFMPNUZGQJEK,VEEFLDHB.SAEBMCCE.UFDAGCEF.JAAHEHACKDDFhABAeABDHEAHCCGCDCADBGHEhACAdAGB..bAEEfDDHhAAAABIBFHFE.NICB.IEHG..gEBDhACA.aBDBhADAWADC.,2,-19,-10,9
ANbdUOMeIgHJQSTXEKfYaDCRPBGcVFZWL,dGEBOBGDeFCFHFEHQAFESEBGEBBG.KCDG...aGHFCDDABFHFhAAAGABFVCADFGAFLAAFhACAAFEA.NAEHMCIBhBGAIHHG.JFAHXGCDfACBhABADEEC.cCFC..hAEA...,2,-26,8,34
MOCPVbJKAHZFEYIgTDBSdXNWfQReacLUG,FCCCEBHF....IBAATBEFBHDF.dHABNCCH...QEFEhAAAaEHFLDBBUEBGhABAMDADCAGE.VGDGKHFAABBBhACAZDFFDEEHSAAE.fDDGhADAeACAOFHDJHAC...hAEA...,2,-20,-15,5
SQZKcXDHVGRNEeJWLdaPMAfFIYbBUCTOg,FAFF..IFACBAADCGHF.OEED.SCDGKGEBDEGCHCCHhABAVAEEREEG...NICF.EFCBhACA..JECHdBHAaGHBABDE.hADA....fCAGbEAF.TABEhAAA.....hAEA...,2,-36,-22,14
BUaPWVEMZDQgOYfRFNJAHIedCXLGSKbTc,HFCCdHCBCGGBLAFBKDAF..TCCCUBAH.aBFF..VDAFMBBAhAAADDIBOHEE.RGAGJFFChABAAEFBeDDH.SAHDhAAAbAGBBECG.EGEE.......hACA......hADA...,1,-12,-29,17
HDFURTWYVaBGLbEQCIMNOdPKgJXSeAZcf,ZCABHFGFDEECRAEB..TEDD..VFCEaHDEGDACEGHF.CEHE.ICFChAAAOCBAdAGBKACC.hABAJAACeHDA.ABHGFDCBhAFAWDGFBAGC.LCHH....hAIA......hBAA...,2,-23,-6,17
ZabQGFDdEJONBAfKgHRCTXILPceMSYUVW,KBAHHBCGCDGH.TDGCLEDDeBAH..SFAEUGBBZGFAaAAAQGGDhAAAFBFAdDFC.OABGhAFAACIDRDBE...PHAEhAGAMAFG...YBEA...WFFEhAHADIFG.EFEB.BDCChAIA...,2,-30,3,33
RSYJaOGEUDVHQWPTefLIFXKBcgNAZMbdC,ZAECMBDFdHADRCAD...SAACJDFD.GFDFDGAHQFCBhAAA..WEHBPAFGhABATBBDLHFGhACAFEDGBHFH..NAECAGHBYDABOCHF.ECEE.hADA......hBAA...,1,-19,-24,5
SNTZcHbfDAIEKPFeQRBLJMOVWGdgXYCUa,EAGHFDFHQBBDBDDBLECG..MEBEODAHGADDdAAG.XEGHhAAACHCEUGFB.aGAHSBEBhACAZGCC.HCGDhADAfBHAAGEBKGAH..eCBC...hABA......hACA...,1,-10,-22,12
PHdJNUVWbeLZfCYFMRgScAGBIEKaXQOTD,BAGDECDGKAGGQEAC.ODAATDBEDDFHdBAD.UFFEVFCAhAAAeGACLBBECEAGMICAhAAA..SCHFhABAAIGCIDHAXGGH.PHACJADG..hACAWEEFfGFAhADA...,2,-25,-20,5
eGOMCWDbNYFPTXgBJZULfRESHAKQdVaIc,dFBAVBGHaFGG..eCCBGACH..CADADCBH..NDACFGED..hAAAPFDFXCCCBHFFhAAAJDEDLFBB.hABAfFAGSHGAABBCKHGAIDHFOCEDhABAWFCH....hACA...,2,-32,-22,10
EHAVaJceTDLYCbMKfUgXGRQSFZIOPBNdW,aCCHJBGH...eBECDEDALABDCCAF.KGFAfFED.hAAAUFACXEAGQDGAhAAASADGFABAIGDFhAEAOFCDBCEGWHCAAHGC..cFGAhAEA...YAHHhAFAMDDG..,1,-28,-35,7
QNUJTZIDcegHYMfBCSFRbaXVAEWOdPLGK,OACHdCHCGBABKGGD.UGDAZAFC.DAFC..eFCHHEAAMBBDBEEDCFEH.hAAASGHD.hABAFAAGaEAHAIAA.ECEB..hADALDDEJEHHICGGcADFfEBFhAEA.....hAIA...,1,-18,-25,7
SLHIPdJVURMfOgGZTKecDbYANWXCaFBEQ,XCGACCDBBBEE..EAAGLEFD.HBCFIGBBdFBGUCAEhAAAMDDFfGCBhABA.OADGgDADhACAGEGEZEEG.TGGCKAGADEEBYAGBhADAAIFANIAD.WFAD.QGEEhAEA,1,-6,-23,17
dcRbYJKQFfBCNGEUHPXAeSTWMVagLOZID,eAEBSCCCMECB...aBHBOBCDZDDFDEACdEGF.REDH..JBAFFABGhAAABHAACHGAEFBAHAGBAHAH.hAEATGGC..WCHHhAFA.LBFFIFAHbGDC..KAAEfFFDhAGA..hAHA...,1,-9,-27,18
ZbSJOEYUPaLXDMHfKRVdBQCFgTeWIGAcN,ZFBHSFDDEADG.UFGDLEEG.MEDDHCBBKAGCRBGBVADChAAABFADFABFeBAFGCDFhAAAAFEC..NIBD.JGEGODDAhABA...aGABDIEE......hAFA......hBAA...,2,-24,-5,19
dfHSMJQEePXcUAZCbVKOIRGFYTDLWaBNg,ZECECCHAKECCOAFA.GAABFAFFDBCDLDAE.BGGCdHAHSEGDhAAAJCEE..hABAEDHHeDBDXGEHhAAAABBH.IHHETFDCaEAHfEAHHADFMEIDhACAcGBC...hADA...,1,-13,-33,20
UEWXHTSCRDgfaecMNFOVbIdBJKGZLPYAQ,EFEEHADE.CFADRFEDDAIH...aGCAMBIF.FABGVAFHdDDDBGCFGABEhAAA.LEAFACFEUGGC.hAAAXGFE.SDFGhABAfHCFNEIGIADH.KDDDhAFA.YHAGWCCF.hAFA...,1,0,-36,36
fHeJMACVZTbaDWFKXESGcLNQBIROgYdPU,ZCBHTDACDABEFAEB..EHCAGDEELFCABGDBOCDC.dCHGhAAAUAGEeFHHAHGHCGBBaADG.hAAAKHAE.SBAAhABA..NIBBIDHHgAFF...hBAA.fGGBhBBA...,2,-48,-2,46
SAMcOQUGDadKCPLBRIfWNeYTFJZbVgHXE,ODEBGAAHDDFBdFGGKAGGLCGD.RGAE...ICGB.hAAA.NDEAeDAHTABAFHEEhABAJFAE.ZDAE..gGGBhADAEGEFMCIFQADC.aAAHhABACECCPAEAWGAA..hAIA...,1,-13,-21,8
fBMGPNJUHZFKbRCEIWOAcDgYaVXQLedTS,DHDAaADD.QEEBdDAG..SCGBBBCBMCEEGEDG.hAAAJFFCZDGHKBBBbAFECAHHEAAAhAAAIEAG.OCCHhABAADEA..gGBGXGGCTGADhACA.NADH.....hBAA...,1,-21,-23,2
EXDIcLdUMfGVBROJeQAgTSPYNZWabFKHC,TEFDSEFB....PDBENCIAZGAG.aGBAFFBG.HBADXBFGhAAADABGLDEDhAAAdACAMIBGfAGGhAEABEAGOABBeHFCAFIHYAHHWCDC.CHHBEHEG.hAFA......hAHA...,1,-8,-15,7
HCNZgfdRAeKDYUObLaVQXMEBSWPcTFGJI,DFBBUGDCLCDDQDDHEHGG.BCGC..SFGA.hAAA.cACBGAADJCAHhABAIHCHCDHGZAFAdGAAAAFEYEEBhAAAaHGA.XBEDMECD.TAGChABA.NDAC..gDGAhADA,1,-10,-31,21
XMDHaOKBQTCVFJEPdLIeASZYWGfRgcNUb,ZDBDGEGGRFDA...NHCB.XAEGHCAFaFDEBGHF..CFADFDDHJDEAdBHAhAAA.LCABhABAAAHA..YABEhAAA.gCGEcGAH.MCCAKBBE...hACA......hADA...,2,-30,-12,18
aGDOSCPeNIEUZgRVMYLdTfWcKJQbFHXAB,GECAOFFD.CCEC.eAAAECHD.ZBCE..RBAEMEBFdCGG..TEBChAAA..fABBhAAAKFADJEHBFHDCAAEBBGFBDBIBSEDBhABAIEFDgAGCLAEE.WFHHhADA.....hAIA...,2,-22,-17,5
CMaQbGXSePLJRfKHWYcIBUFNZVADEOdgT,DHBGECCCdHABCCEB...MAFCaCGD.GCGC.eEAAJBBEKFBEHAAA.hAAA....YFDDhAAABHGCFEDA..ZEEFhACAAAHBODABQBEGSFGC..hABA......hACA...,2,-59,6,65
FbAOSRGDLUfgYXQKWMEaeIZNBPHVCcdJT,OFCHSBAERAFHLEDCUFGG....fDDEXBDDKBABhAAAMBECEFAF.eHEAhABAZCFENCAEBAEBHGCECFHFdDAHhACAFDBDAFFFDBIBQGAE.....hADA..WBDG..hAAA...,1,-11,-17,6
TDOgVaeXdQEHIfZFYUBSAbPKGNJCLcWRM,KFEGGAEECFDC.LGFGRABE.MDCHOBHFVAAF..aEAHdEAAHCFDhAAAZEECFHAABHFEAHDG..hABA..NAIE.JHBE..hADA..WADDDECAeCCA.....hAAA......hACA...,2,-30,-15,15
WQeRScZEOdNDJCVaMgGAIHPLTXbKUYBFf,HGACLAADTEGDXFBDKDFDBBDB.FAGHQCEE.hAAASAHDEBBE.hABANIDFCCCGMIEEGDGCIEAEhACAPEAHYEDHWBBCeEEB...hADA......hAEA...,2,-26,-3,23
fcGNERdBgOHFXWLYQPbSCeJZTKDAIaVMU,aBAHMDGD.UAGEGDEH.EEAHBADBHAEEFFHDXCDCLBAGQGCHhAAA.SHFGhABACCEGJHDGZFAADFBChAAAAHAGIGGB.fBBG..hACAcDDC...hADA...,1,-8,-40,32
eBLFDEHdCVNZbWMKOGPYagfISUAXQTcRJ,QECHRECEBACCDBAB.dGFF.CEEB.ZAFE..MBAGGCED.aGGFICCHhAAA.ADABXAGHhABAJGAGLBBGHFABhACA.NDIA.KDBD.PHCEYAFD.SGDDhADA...hAAA...,1,-10,-34,24
HNFXbTUGAgSLIQPYOZEafVdKRcCMeDWBJ,LCECQGCBOFBCECDD...aGHBfDABKFFC.RACGMFFChAAADBBFBAGCHAFBNAAC.hABAFGGE.bFAFGDBBhACAAFDESCAEIHEA...YFAFhADA......hAEA...,2,-32,4,36
JgXFLCWZBHbfPUEMYOQRGSDdTVeaKNAcI,JFCCFGDGCGBFZDAH..HAEG....PDEGMFIDQDCHhAAA.RBAEDEABdAHGeABAhAAAKCHHAHGF.IHEFhABA.XAEEBABEfDFDEGGCOFAHSDABhADAaDHDgCCFhACALHCA.,1,-16,-18,2
ZHUWbBCNXDJEYKQLTAMefFdSgGIVRPOac,eECFFBBGdEDGGEFGRFFG.aBCCHBDG.UEAHBEHE.XAFChAAADADCEHFE.KEABLCHHhAAAACABMAIF..SHDEhABA.IEECPHBA.ODBG..hACAWCAGCHAF....hABA...,1,-7,-27,20
SJODEgcCRXUYWZNfbKeHAFdILaMGBVQTP,dGGBaCBAGFEFQCFF..TCFGJFABDACGEGAE..CCBDUECDhAAAZAEGfEAH.hABAKFCBAFFCLAFGhAGAMIDABABGSDHHOACG.RGCEXCCBhAHANBIC......hBAA...,2,-22,-1,21
PVabBGNCFXfEJTUgLRAQdYKZMHWSOIDec,QCAGdFHCKEFEHAGBOECHDFDD..eEBHVGEGBBADGDDHFADE.hAAAEADH.UAGALDEDhABAAGBDMIBAIDADhACA..aEGENIBHCCCEXAAA....hAAA......hABA...,1,-10,-20,10
NZUPWcKOCeQabLDgfHGVMJRBYXEFIATSd,dBGBUEAC....PABAKBCHCEDF..eAFHQGFBLFECDDGGhAAAHGECMFEABAHAXGAFhAFAFCHBAAAB..SHAChABAWEDD.aADAfCCD..hAGA......hAHA...,2,-39,-27,12
cLQMdNTJBAWFgKEPGRbVfXYaOZHCDSUeI,FBGEEABHRFDE..VFCE..XACHOHFCHBACDGADUCGD.eFBHhAAAIAAELEAEhABAdHAFTADDBHHDAHGDKBGEhAEAbDEE.aFFA..CFHHcDACMBFD....hACA.WDDC...hAFA...,1,-6,-15,9
WdRAXOMebagISZELfJYUGDcHVFQTKPCBN,OGDAeBFD..aACDSDDGZDGD.LCCDfGHAUAEChAAAGGBDDAIFHCGDQEADhAAAKHBCCCAHBHGBNAEAdBAAhABAAIFCMBBEIBGH.EFEA.....hABA......hACA...,2,-25,1,26
DfTBUNeKELPWRbFSIZdYQAMXgCHacJOGV,XDCCCDBHHAFF..JFFBOBGFGDCGDCAABADFUFGH..KEHHLADAhAAARBDD.FEABSAABhACAIHAEdGEEhABAAIDAaHAE..fFCCTFABEHGA..WDDEhACAYAHH..hAFA...,1,-18,-23,5
QAFUXdYIaegDWMLTZBOKREVfcbHNJPSCG,XAAFdFDDaCGG.DGFDMEBH..LADGBFHEOAADKCHFRFCDECEChAEA..VADB..hAAAfEEHbEFB.hACAHCBBNIAH.SGGCCHHGAAGG.YFAFhAFA.IHHGhAHA..eHDE,2,-22,-17,5
GbSfCVQJXcPgHDKBaEdMURTILOZYWAeFN,FBBHGDBH.SACFVADG.QBGAXDEF...gGEChAAAKGAAEDADUGGEhAAATEGDOEEHZADGABAHeDCHhABAfCFGCDHF.JFAA.PHAEDICABAGEhACA....aBBHhABA...,2,-17,-4,13
cGbKAdLITOUCDVFBNWMEeXHSaJZQPYfgR,dCBDTDEDOEDC.DACHVBAB..BCECMFBGeGDCHGDE.SGBHhAAAaBGCZFADQDGBhAAAPAEC..YFGHhABAfAEHcBGDKGHFAAHB.LBADhABACDCANEAC.WHDA..hADA...,2,-23,1,24
dYDMeBAWcVIHQNSgOXJfCFTKLEZGRabPU,VDFBQCCD.SCAHOFABJAECCGBE..KHDEZEBC.GBADhAAARAGHaACG...PHDEhABAdFACDFFA.MAADBGHChACAAGGHIHHA.NCIC...fDDFhADATECE...ECHBhAHA...,2,-25,-14,11
HIFGVBOCbREQcYKSLZaPWXTJfNAUgDedM,DCHHMFEHFBDDBEAD..CDFA.EADC..QGCBKGBAZAGB..aFFEhAAAXCAF.JFABhAAAAIHGeDCC.HBAChABAIHHF.OFCGbDFA...YGFEhABASGADLADChACA..,2,-31,-30,1
EVaJRXeDMgSZITPOQBYLAUcCbKdGFfNHW,UDDHCFHEKACG.dAFDGCFEFFGG.HECA.EAHDaBCB..RBAB.DHDCSGADhAAAZCAF.TGBFhABAQGAD.BCEChAAAAHIFbAEB..fGHCNIDH...hACAWABE...XCGFhAGA,2,-36,-14,22
UbIEaQdMNYZBWReJSTLFDGHCXgPKfOVcA,UFDDECEEdDCCMAECZADCBHFB..eBBF.SDADFCHDGEAGhAAACCGE.XABHKDDH.hAAAOFECABADIGGChABAaAHB...NIEB.WEDE..JCFFDBABPFBFhACA.....hABAfEHE.,2,-22,-17,5
eLPdNUFgAKZEMHWYRSaOVfGcbDXCBJIQT,EFDBHGAAREED.SAFB.aEDFOGACGBBGDGHFCGHG.JCBBIHEFhAAAeCFELDDEhAAA..dCAGFADDgCGHhABAAIFGKAGCMEIHWDFD..fABChABA.....hACA...,1,-16,-20,4
WRXZfCdIOBHMbPKcNLegUYQDTVaFEJGSA,RDGFZDCAdADEBADBHAAAMFDFKGDELCFC.UFAHDBHHaGFH.EFBHhAAAJEDE.GCABAFAF.hABA.XBDACGGG.hAAAIHHEOHAC.PEGH...NBIAeABFhAFA....hAGA...,1,-11,-33,22
RaTFNUSdKZYXLGWVQMPHCObBfcgDeJEAI,RDAATFBCUBGE..KEFEZBDB.LHFEGDDC.QDFDMBACHFBHhAAAbAAGBGGC..fAGAhABADIGCECAA.ADCEaDHFhACA.SFDHYFAF.XDAGhADA......hAEAWACECFGG,2,-29,-8,21
ENLGMYAXITCVgDcPbQZHaSFBeWKROUdfJ,TEDCVBAC..DAGA....PBAAQEDGHFADSHEChAAAFBEDBHEDKBGHUAEDhABAdFAAEGGDLCHF.hAAAMDAAACIFIFHFCHHB....cDEAhACAaEAA..eABE.hADAODFC.,1,-4,-18,14
dVBJbQcLaODWYPMTHeZXGUSRNAfIFgCKE,FGHBCBABdFGCBCBH..JEBFQADC.LEEBDBDF..hAAAPAFBMBIFeCGDhABAZFEH.UGBA.SCADhACAADHGIHABEAGA....bBDHaDDGOEHDhAAA..WFAChAFA...,1,-26,-43,17
LKMfXDTZEeYHOPVcCSgdRGJINABFaQUWb,aGFAUGDGLFAAMCGD.DBDEEACE..HCFEOECA..cDCAhAAACBEAdAGFRAAF..IBBDhABABHHB.FHBCbFADXEGEhACA.TDADYCHBSAHFhADA.JHEAAFAHKCCG.hAEA...,1,-13,-21,8
bRTYaPEeVBKJcfdINQCOZWDAMHSGXULFg,MAIDHFBESAGCUCFGLGFGFFGGRCBA..aAEBeAAH.KBHHJFBChAAAdAEG.QGEDhAAAOHACZBBFAEEBXDFGhACA...........hABA......hACA...,2,-36,-2,34
UFLRSXDdJQIOAKGCPgEVfaHNbZWeYTMBc,KEAACDAD.EDEDaGFC.HFAGZAAA..eAHBMDBGBGBAUDFCRDGB..DDDHJBFAhAAA..QCAHhABAOBBGAIHG.GGDF.hABA.PECG.fHABNIAFWACE..hACA......hADA...,1,-14,-28,14
QSdgWDUFeVCAKHJNLRaXZOMGTEYIcBbPf,HEFDJCCDLACGXCGFZAGDMECB.EBAA..IAAGBDDEfFAGhAAAQGCDSAEChABAdGAEDFHBFEEHeFEDhACAAGGDKDAHaDAF...OHBE...hADA......hAEA...,1,2,-30,32
GWTYKMDFAZgRVbaHSCEJPIQeBLUdNOXfc,RADBVBEFHFBD.EBHD..JFFCQFEFLBABUGBDdHGBOBAFhAAA.XABF.hAAAfHDDcGEFTDCEhABAMFAB.AHIBgACFSDEACBFEPAHBhACA..BDCH.hAFA...,1,9,-30,39
PDROEfZFMYKCeTdAJNBWSbGgUXVQIcHLa,JFEBBDHG.SEDCGCFCUCAG..VADFQGABHGEGaCAAhAAARADE..ODDBEHBGFFAAhABAMAAGCAGBdFFB.AGDB.NDIC.hAFA............hAGA......hAHA...,2,-24,-18,6
FeIfZNKTXdHgbWVDMYRLJBUPAcGECOQSa,GFDBEAEC.OCFGQCGBFCAG.ICADZDEGKHBCdGAG.HDBFhAAAbFCA.DIFARCDBBAADhABAAHHG.SGGAhACAaAFEeABA.NIAF..XCBH.....hABAWEAGMDIF...hADA...,1,-6,-22,16
YZXgBeCcMLINUQJGFPTRdDWfAbSOKHaEV,SDGHOCAFHAEEEECCZGDC.BHHG.CFFDLCDGIBFGNGEBUGAAhAAA..GCAHhAAAFCHH.PFAH.dHCHhABADCCDAEAAaBCAXECA.eABAMIFC..hACA......hADA...,2,-17,-13,4
ZgPLTSQXcdMeWNGYKaFOCJbVEHDBUIARf,RFABZDDFLBCHQADAdDGF.MHCEeFFBGAGAKAFC.FGGHCFCH.JAAFEHCAhAAA..BDFFAHHF..hABA.fGAChACATCAHSAEDXCBHNIBDOFHF...hADA......hAGA...,2,-19,-14,5
eafAdJHFLXbCZWVgUPRMDcQTYGEKNISOB,HBEELCCDXDEGZADD..VFFHUEBGMAGFQBBD.hAAATEGAEEEFKBABSGGDhAAABHAEaDHBAHIHJHBECDAD.hABAWADC..PHCEDBAF..YAHHhABA.....hACA...,1,2,-25,27
gOLcYUFRGXESdCBIbZVMQHDWKNJfAePaT,aFFFTCGGLCCD.UCGFFFFHGECG.EGBBCAAHBAEGZBCCMDBGhAAADCAFKHCG..NEICAADGhABAeFAH.OFHBhAAAYAEGSAGA.IDEF.hACA......hAFA...,2,-30,-20,10
TPSEOcQHgaAJMIUDCKbdWVBRLfYFGNeZX,JABGUEAC.KDDCdEFFBHGDLEDF.FCCGGCFE.eAHBZBFC.hAAA.TGFCSACAhAAAEAGA.OFCDHFAFAHIDhABADCCG.CAFC......WABD.fFHAhACA..hADA...,1,-22,-40,18
IUdRBAGfCSaXgNPMJZWOVcEKLFQbDYTHe,GBBASDBHaHEE...XEFD..NGBHJEDGZAFGOBAHhAAAEAHFLDHDFDEFDCCETAEChAAAIHAC.RCGBAHIDhABAfDAE.CBABgGAGhABAWGCG.KACCYDDFhACA...,1,-4,-30,26
VSZJeCUEPWTYMaGKFQbLgIBdHNcDfORAX,SCEAZEGBeGAGCFFA.EBAA....TBACaAEAKCCE..FEBGQFCGhAAALAACIFDFhAEAHGEGNBICDDAAODDGhAFAXEEBJAHD.WEBFMIDE...gAEAhAHABAHF...hABA...,2,-22,-11,11
geJTLGfbDHPICEOMZVdNBRSUXaWYcKFAQ,eFGBLHFCGEDCDGDBHCAECAEH.EEGHODCHZAGFdFBABCAB.SEAFhAAAaCCA..hABAYEEDFABEAHFAQBGBhAEAgAEGTGAFfABDPDHDMFAHhAAA.....hAGA...,2,-20,-3,17
SNeDWUQfGAPKbXVdBEILaHMTOZRFcYJCg,KGEAVFEHEDAH..LEBFMEFE.ZAEHFBBC..JBDBCBGE..SBFDhAAADEIFUAGCQBAAhAAAAIBC..XEEGhABABDGH.IHHHaABA.HFAC.hBAAOADF...hBGA...,2,-27,-27,0
ZTMAOcQSeLWNbVFHYaEGJfIdgPCRKBXUD,QFGELADE..bFGBHCEC.aAAGGBAGJCBD.dGDCPEEDhADACEDABGEA.DDEETADEhAFAOBHDeFCH..hAGANECA.FBGA..........hAHA......hAIA...,1,-11,-27,16
FTCHAIbdfLWcEDPBgMJaYQVeXUNZKRSGO,dECCLGBAEAFEBCDEJDBC...QGGEeBCAUFFHKBAD.SEGGhAAAOAFDCCAFABBE..hAAAICHA.fDAAhABAcEAFDIDGPHAAMBIH.aBFH.XEEHhACANAHC...hABA...,1,-14,-35,21
ePUaRFVLgWdMBHECfTQcGNbOZJDAXYSKI,XCEGSFBGKGCFeDDE..UEGDFEHDLHDGdEAEBADFEDCBhAAAfAHA.QCAChAAANEFCZBAA.AECGYEEFhABAPBHHaHGCgAFF.MFABhACACAFB.cADB.hABA...,2,-27,-1,26
QSWBONRcbAMCXTIfDVUeFLPGgadHJEKYZ,XFEATFFD.DAGHeDFE.LBCEGBBDaFHDJGAE..KAAFQDEBhAAABCDAOHCEhABANABHRFBF.AEAHCAGB..IHDDhAHAfDCE.FEEGdEBB...YAHBhBAASFHBWHFGMAIDhACA..,2,-20,-12,8
FIJZdYRAPDTeWcLfXbGOaQSNVCHEUgMBK,TEGGeFFALCAH..XEBGOCDFSCGAhAAACBDAUGEDBCBAKAGHFACGJHEAdDGBACCGDABAhAEA..fEEGhAAAbDFGGEBEaGBDQAEENBAGEAHB...hABA.IHHE.hAIA...,2,-11,-11,0
FPfWNMeAOgSHKJLUIXVBDCGdYRETQZacb,SDDHKDGDLBBFUGDC..VGACDCFE.dEEGECACZAFG..aAGChAAAFADF...fGHAhAAANDCAMHFC.AABAHCCAhAFAJABABEAGCFHC...YDHB..hAEA......hAFA...,2,-35,-17,18
JBYQWIXMfCdeAZTKHSGPgVNREcUFObDLa,KBDGGEEF..VEFCREADEADF.FAHDOFAEDBAA.LHBEBGCAQCFHhAAA..hABAICADXCAAfDDGhAAACAGFAIEA.HAFHSGHDNABH.hAHA......hAIA...,2,-34,-20,14
GbaMYVEJeIXLQWfRFdNgCHBTPSZKOAcDU,UEFBaEAE.MAFCEDFC..eAEBLBFA.QDAAfGBFhAAAFBBANIEF.CCAF.BGHHSGGGhAAAKAGEACCEDEHFbGBGJCDBhABA...XBGEdEDA.TCAA.hABA.OHDE..hACA...,2,-18,-10,8
SIfGHBdFNRbTDecCEaAPgVOXYWQLMJUZK,VCCAXCEB..QCGCJBCH.KGAESGEBGGDHBDAEhAAAdBHEFHAGREBEDABFCAEGAGBAOAFChACALBAH.MDGBhAAA.....IHGENIAH.eEDFhABAaACEgEGAhADA..,1,-8,-31,23
XaeHYPTBENRGAMZKVgJbfIFLQDcOdCSUW,KFCEJHDG.....IHFBLEDCDEECOBBH.CHHAUACHhAAAaHCEHCBE..TAGDhABABGAANABB.GBEFhAAAADDAMFBB.ZDGFgGGBFGCGdAFG.XEGEhAGA.....hADA...,1,-19,-23,4
AVFMSCEXbJUPIHDcTNdeKfRgZQYOLaBGW,MBGHSDGC.ECBDJAHH.UGAFHGBEDCCFTAEG.NFDB.eADFhAAA.KEFDRAAGQAGChAAAOEDD.BHGChACAAACACGGB.PDAB.IDDEfBAG.hADAZAED.aHDC.WFHBhABAXFGA.,2,-30,7,37
cHFDeIaTYObSKUGfPRLZQdCMJgVXNAWEB,EBAGBACEFDGEeCBD..aGFHOFFB.SEADKEBFGADDRDFAZGBEhAAAQGCF.hABACDECMDAEJCCAXBFBhAEAAGAD..cGGFDAIFIHHC..hAFA......hAGA...,1,-23,-25,2
EQBPecYfLVdaMTXFAKJgZWGCINUDRHObS,JCCAZGAEGBED.CHGB.UGGHDFBE.RCADHFBA..SBDFhAAABEEBeACC..fABHhABAdAGFMBHHXGDAhAAAFFGGAEEAKHDG..WAEE......hAIA......hBAA...,1,-27,-38,11
WLdJeBQZUFKSMDbGafCOHRgPNIcEXTAYV,VAFCLADE.dFDGeFEFBBAHUACGKDCDDHFGGBAC..CBHEHBEEhAAARDDA..PGFEhAAA..NEBA.IDHBhABAEEGEAFGH...JFAF.FFCBMIDE.fCCBhABA...hAFA...,1,-10,-32,22
NWDCEgIHZGaAQRfdcSKOTULeVMBFJYbPX,RBCCdBFHKGAEUDEHLBFB..MFFDBACEFBAC..JEAA..bGAAhAAA..XGGFhAAADAECCECC.ECHB.HEDFaGGEADAHhABAQBAA.SHEAeDAH.hACAYHAG..hABANBIA.IAHG.,1,-11,-29,18
AOMDQTLPGacWHegSNCbRIKJVfZEUXdFBY,DBGGQBBHLCGDaCHDHCAH.eFABSCFFCDDB.bEDHIGGHhAAA.JECHfECChAAAUACB.dAEDhABABHEEAGGAMFADPCHDWFFE.NIBB....hABA......hADA...,2,-22,-10,12
XEYaQTDFgGfdLOWNbKcRBSMIPZVHeCAUJ,XCCBaDEA.DFDGFAHB.GBBFdBAAOEAH..NEBBKGBERCFDBHFAhAAAMIFGZACA.eFHBhABACFHGAAEF...EHBC..hADA..YFAF.gFFDhAAAfBHCWFBE.SABChAFA,2,-32,-25,7
TSagQLGFDdHOCbWAUPVNJEMXZKcBeIYRf,VFCEEFGGZGAA.BGEHeCFA..RCCF...fBBESBGFaGGBhAAALEFCGADHDFIDhABAOABBCDDHADAA..PEAHhACAMAEGKGGD.IBED....hAAA.YCAF.hADA...,2,-23,-22,1
XYSaBJeDfdOMELWHUIgGARKZPVCFNbcQT,ZEAEVGEAFBEH......NAEH.bFEBQDFC..XBBDhAAAaBCEBDABeADEhABADBIHdFCDEHGALHBAhACA.WDHBIDDHAAIHKGCECBGAcAAD.hAGASHBC.hAHA..fBFF,1,-17,-27,10
XUCHEdScJBPKMWbZQeDYFIfOgLNTGaRAV,UCECCBEDdFGE...JBCHKFBG..MIEGZCEGQDAC.DBAAhAAAIEAD.OEHFhAAANAEF.GFABhABAACIHHFEDEADABCCE.PHBCeGDAFBHD.fHABhACA..hADA...,1,-29,-31,2
QJFeDLEIdfObGSXgCRaBPVcYAZNMWTUKH,ZFBAMAAGUAFEKGCGHFEHFEDA.LCEAdHBD.OFAHSCCGhAAACFBCBBBD....VFGFhABAAEFETAEAQACBhADADCIFEHGE..fCHC.XGEDhAIA.aDFFPDBChAEA..,2,-27,-18,9
aVUPOFQWSdHYBEcTDNMKIbfgCAJRZLeXG,ZDBGXDBCaCFC.UGDHOADE..FEECSHAEdBBHBAEFEBGChAAADEAFKFHD..IGAEhABA..fFEBhAAACHGDAACGREGH.eABHPCDEWDFA.cGCFhABA.....hAGAMIFG.,2,-43,-21,22
AYfBHMgRaNGVbTdOFcLEIPQUCZDJKWXeS,BCFEMBCFRFBDGDEE..TGGHdGGEOBAFLDFHEAGDQEBEhAAACDADDEDG.KAEDeAHBhAAAAFIF.fBFDhABA.gACBNDAAFABAIHDHPHDEJCHBhAFAWFAFSDCEhAHA...,2,-19,-8,11
BIeZYadOTCSbQRUDVGNFWMKLEPJgXAcfH,HEDEBGHGeDEAaBAEODAGCCCB..QAECRGEGUBFG.DHCEVFABhAAAFEBDKHAGLABC.hAAAJDHBABBG..IGFDhABA.dCAG.SAGB.bEDGWAFEhBAAMDIF....hACA...,1,-9,-30,21
XGTJHZRBESfQVPKcWbIeAUgONLDMFaYCd,OCCALDEAFFFACGCFdAHAGAEBHABG.BHFGECGC...QBEEhAAAVDABKAAA...WFGBhABAeEED.AIHGNDIAaEAH.hAAATCAD....JHACSHBAhACA...fFFEhAEA,2,-27,-12,15
bMSKDgBEGOCfdeLTXWAIQZFaNRJHcUYVP,ZBCGaEEE.JDFEUCCD....VFDHMHEC.SHGAKBAHBFAC.hAAAEEBB.GAEHCBHGdGGDLADEhABAXEGHAGDFFHAEhACANAAD....cFAC....PEBGhAHADIAG...OFFAhAIA.,2,-28,-14,14
UROJeHYdBATGIWQPbCLFZSfEMNKacVDXg,TECFGEEGQCBD.CDGCLFCHSCCGEHGENIDBaGAFhAAADABD..UAEERAFCOFFAhABAJAHFeDADdAEGBDAEhACAAHED.IDHE.PGEEFACCfGBChAAA..KACB.hAIA...,2,-9,-8,1
eLcDWJZOYMATIFGCbKdPfVaRNBQEgHUXS,TAGFGDDEKAGG.dACFVCCARDGF..BBAEQAAAHBEASDCFhAAALEBHWFCHhAAAOFACAFEC...CHHD.bEGHhADAaGEDEAEB...UGEG...eFAFhAFADIAA......hAGA...,1,-3,-18,15
dLXafFKTVNScBQUgJRIMGAEHbZWeOYPCD,HEACZGCAeCBBOGCECAGD.DFGHdAAH.LDDFaADDFBAD.KEEA..TBGAhAAASGGHBDDB.hABA.QDGBhACAJAEHIFADAIFEEHAE......YBHBhABA.fHADhADA..,2,-24,-22,2
MKINgGSOebXTBLJHADVEfWUdQcCPYZaFR,DBHFEDBHUBGEQFFE..CEDFZAADaBAAFADGKFFB.....gDEAhAAASAFCOCDBhABAeEHD...TGCEhACABHHDJGCCAHAAfBFCdCFG..cACEhAAA....hADA...,1,-21,-35,14
BPIfSAMXJFOdGWeRHTNDcbKQULCEgZaYV,MHDEFHCEOBDEGACD.eDFCHEDE.TDBDDFDGKFAA.UCABLAABhACACFGB.EGGHaHCCBDGAhADA.PEABSAFEhAAAAIAC..........hABA......hACA...,2,-31,-15,16
ZFRDKVIeLXSOQBNgCfcAdTUYEHaPGWbJM,TCDDUDAFEEFF.HABEaBFG.GAGA..bGAGMEEFZFEERABGDGHFKDFGhAAAeFCHLEAA.hAAASGHHODDABHFAhABACCGBACID.dGAC.WFHBFBAH......hADA......hAEA...,1,-5,-8,3
LUKBfIdEPagbHeYTcGDMWSJQXZOFCNAVR,LEEDUGEBKBDGBAFCdCGBEBAB...aGGGHAAC..eAEFTDDBhAAAGEAADAIDMDFGhABASDCD.JAAAZFGFhADACCCEAAHBREAE..IHCB.....hADA......hAEA...,2,-22,-22,0
GBIYJWgVROPDUCNcaMLbEQFTKXeHdZAfS,GCDABCGCJDDC..VDGBREFA.DCCHUADC..CADG...aBAFMFAChAAA.EGBFFFBCKCAH.hAAAeGDAdGHGACIH..IAHAhABA.gAEBOHDGNACC...hABA......hAGA...,1,-19,-43,24
BMLEIRNPfXOCTAJYUFVHdZWDcbaGeKSgQ,UCFBVCGB.dBBBZFFADGGF....aAADeDAAKDCE...SAAFhACABHAAMADEEGADREBH..hADA...fECHhAEACBEAAEBBFAHFHFDBbAFAgGCC.LFHHhAFA...hAAA...,1,-9,-26,17
UZTSRFLQfCNgDVcabMXYeABOdPKWJIEGH,BCHEOBFAKCCA..JEFGEFDDHFDBZGFC.RBCDLFAH.CABD.gEAFhAAA.DAEGhABAaAAHMIEAXGGAhACAABBHdCFG.PECH..IHBG..hACA......hADA...,2,-42,-17,25
OJbDUIMdAHaEeKVLGBQcgWXNfPYSFTRZC,HGBAEBFCKDCALAGD.GADEBGEAQBAFgDBAXEFEhAAA.fGEDhABAPDGFFFABTABDhADACHHAOFBDDAIHMFAHaBEBeFDF..cGGEhAFANAADSDFF.hBAA...,1,-3,-24,21
UINeWOHJFYcafGPDEAQbgCTVLRMZBdXSK,QDABCAHGLABFZGECBFAD.dEDEKBFAUFFG..eDGHOBCChAAAJACG.FDFG..aDEDfHADhABADCID.AACH.hADAbECB...TGADMFIHSHEGhAEA.NAIA....hAAA...,1,-17,-35,18
TBfcXSFYZULNbHOMIJeKCVgARQPGEDaWd,QBEGEDGFDACB.dHFFBGBC..XBCCSADCZCGBLEAAhAAAHBDFMCFGIBAFhABAKFGACAGGAEFF.RGBAaEEBTGDAhAAAFAGG...NABEOHAE....hAHA.JDCH....hAIA...,1,-9,-24,15
gADcSHJOeBVNXLQUYdbRFCGWfETMIZPaK,DEIHSABAOBCDBGDE..NAECLCAHUBFF.dCGGFBAFCHBFGFCFhAAAEFEE.MCDFhABAZFABKGHDADHG..JHFG.hAAA.XADF.....YEEChABA...WAHBhACAIAHF.,2,-35,-23,12
BPGKcbTIVNZOReQdFMgYXLUHEDASJfaWC,SBFCJDEF..aAAFCGECBDHHKAGA...TBBGVACGZDFFhACAeCFC.dGHEFFAEMAEBhAAA..XGCEhAFALFACEHFGAHFFfHAH.GEEHhABA.cCACNCIC..hACA...,1,-20,-29,9
fLcNCSAVMWbQPGeZETYIaXUKRdBgJDHOF,MGBGQCBDGAAEEGAB..TGFF.aDEBKDFA.BHCGDBHBHCFBhAAAfFFBLFAFhACACBAAAEEB.WADEeAEAIECFhAHAREAAdHFD.OEHFNEIC..SAAChADA.PGCGhAEA...,1,4,-19,23
gbSLfHYJGcdCBETPKZAFeXQORUWVaMNDI,eFCGXEFBRAEE.UAFAaDAA...DHBG..IDEDSCDBhAAALHFCHBBBJHDEdCHCCEFAhAAABDADEGAHKABEAGDE.FEABhAEAOABAMCCA.NFBF....bFGH...hAGA......hAHA...,1,-15,-16,1
ZBALDOMCbeQTSNEaHYGgdWVIXfcKPRFUJ,LEDFMFIH.eBFHQFCF.SCDFNDCAEBEH.HAFBhAAAGAAFdABAIDAGhADAfEFFKDFDFHGCUGFDhAEABBHHABIF.DIAEOFAH.CEHF.aEAFWHBAhAFA..cEGD.hAHA...,2,-15,-12,3
BadXgAOMJSDVEeNCcRWfLKYQUIbTFZHGP,JCAGDDAEEGGD..CBED.REBELBAGKBGF.UAEB..bDEGFBHBHEAFhAAABFHHdHGH.AHFH.SEDEhAAA.eHAChABANBIG..fABBIHED.TFGDhADA.PHBE.aFDChAEAXFAC.,1,-18,-23,5
GXDLAIZeQRSUCEBVbHPMFJdTWNYcafKgO,eBBAQEFBUBGHBDDCHAEBMDDB.FEAHJHDEdHAF..TFBDhAAANAAB..aHDAKFGBOBCBhAGADDACLFADhABAAHHA.ZDFCSEEDCABA.ECGA...hADA......hAEA...,2,-29,-4,25
XQbcRZNFEKBgIHTCdJWLVDeMSGYOPaAUf,XGDAQGBFRCDB.ZAFE.FDBBBDGDHDFCCCFF.dDDCLAHFDFADeABChAAASBCC.hABAGEAEOFFCaDAGAIDA.hAFAUGGBfCFH..NAAF.EBCCIAFBhBAA....hBBA...,2,-22,-3,19
GJCFDXcWLHAQSBIKVfYbadMNOgTUZREeP,QCAFBBDDKEDE...VBFB..fBEDaGGFdFAEMECEhAAAOEGF.UFADEDHFGABBhABAFDACDIDA.WFFFhACAABAG..SBAA.IBHGhAAAYHAGbFDGNAEF....hABA...,1,0,-46,46
WFbcEDPgIYdMRLfNHSGBQXCOTaAUJVKeZ,UEGDKAGBZEBHFADC..EHDCDGBB....ICBCMCBFLECDhAAAHEDGBFAFCAHH.aADCACDE.hABA.eFEB..cGGHhAAA..PDDGYDECdAGCNCAE..hACASBAF.hAFAXGAD.,2,-26,-24,2
GfdDEbJXWIOBFVLNgCMPKaHSTAURYQZce,RDBBQCECeDEB.dCGEDHBGEEBA..JABDXAAG.OFGBhABABGFAVAFGLDAFhACACHHE.MDIDKADHHDGFhAAASHBGADIF......YDAFhABAcBCB.bFDDIHHChADA..,2,-29,-8,21
acNLJOPbgDGAfMXFZUYBSVTeEIdHQRWCK,XAACZCCEBHAH..SEGBeHACdDBDQAGCRFBG.CADEKFGChABAaCBGLFFBhAAA.PAEEDGGFADIDFEDEhACA.YFBAEACAIHHA..WAEHhAIANCAAOAHD...hBDA...,2,-27,-18,9
KQPVAOUdaebCMFBDIRYGJLgcSZNHfXWET,dGGGeECEMDEEFBCCDDAGRGBA..GBBELBFB..SAEHhAAAZEAHHDGBXFDChAAAEDABTAGDKAHBQEEBhABAAHAF.aFHDCBADBHHD......hABA.....YHCGhACA,2,-19,-17,2
BDYCfIcedVWSbAaEKRQLUGgPFMNTOZHJX,KEEHLBHFUDBD.GAAEFADF.MEFD.OFBHJHACBABG..hAAADEEH.CECD..fAFEhAAAIHFGdCGESCDEhACA.AGHBaDGHEAGERFBE...PEHDhACANICB.....hADA...,2,-39,-28,11
YIFOCRZVTBDSMgPJEcNfHbeAWKdaQGLUX,dGEFQABBUCGC...ICGHCAFHZEADBHHADIBC..MGFA.hAAAJAEFEBAG..NEEDHCABhAAAAIBEKEDALADBhABA..YDCBFFCHOCAB....hACA......hAFA...,2,-34,-21,13
VAFXegZfWBCQGOaSJPKRNULcITbdMYHDE,FAAHeFBGZEEGBFGCGDBBOBCF..JHDARBEALBBF..hAAATBDEMFABHFEBhABADGHFVFAEAEED..fDHGhACACAEE..aAHFKAEC..NDIA.IHBAhADAbAFH....hAHA.EHGC.,2,-18,-18,0
MGSBCQREXaHJIYKNDdgPUeVTOcWZbALfF,FGHHGBDACDEC.QGCERGBA.EFBFaAFEJAHB..KCGGdGHEUDAFhAAAVDFB...OEAGhAAAZEFCAGAALBBChABASACDBCCEIAFHDEGG...gBADhABA....hADA...,2,-36,-7,29
LETcWHRNJOUIFfXBVbDeZgQaKACYGMPSd,GDFEMBCCdBAGEGBG...TDACHFEARBFDOBHBIHBB.FFAGhAAABDDHDIEG.eFCGZCCHaDHDhABACBCGPADE.SFHHhAAA.cGAHNAEFfGHAhACA......hADA...,1,-8,-18,10
JCNUSDYOLRKQHfWXVIgPdAFBMTEbceGaZ,MBDATBEE..EFFEeEHBZFCF...JDBHUCBGDFFHLGAGhAAAKCHFHFAB..XDDFhAAAIADG.dBAFACGFBHFHhABAcBGDCACFSAGE.OEHFQDDChABA.fGGChACA.,1,-12,-26,14
DFfTLYaOZRdNSecKWbPIUJCAgEGBVHXQM,EDGEVCAEHAFA.QGEFMEHF.DDCHFGADLCAFOAGBZAAChABANAAD.eFDCKEFA..bCCFhAFAIDED..hACACHCAAHAFBAECfHGHaHCESDHB.hAHA......hAIA...,1,-11,-19,8
IYXRTKQGFJeSbHaNAfPBDMLUOWcZgCEVd,BDGHLCDFODABZABDCBAGdFBD....IAFHRCBDQGFFhAAAFCGG.SBHBhABAHFEFaEGCAEAADFFC.MFIFUGGChAAA..gACE.EGDFYHAChABAKHAG.....hAEA...,2,-23,-19,4
ARNCcOLeIFEYMBDUgTdHPQGVfaKXJSWbZ,CBBCLDDHFGEB.EAACMBFADGCD...UDEETGFEHCGF.QCAFhAAAVDAE.KEADXAGEhAAA.JDFASGHBhABAbACE.AIAGNDDGcFGF.IGABhADA..BGGGhACA...,2,-30,-10,20
HBUYfOVITgMFRPeaQDZXWSAbLJKNcGEdC,LFCDKEADGAABdGHGBFECUCCE..OHAETFDAFCEG.RDGD.aAAHhABAZGDC...SADEhAAAbBFG.JDCBEGFFhACA.CDAB..fAGHIBHH.MFAH.hABA......hAGA...,1,-12,-30,18
EcTDABCUWdYIgRNFXfbPZQaMSJGOKHeVL,CCBGUEEFdHCD.....ICADRADBFFFC...XDBH.hAAA.bAFDQAFHhAAAaFAGMFIB.SDDEhABAGCCCKAHBeFGHEABCDBAHAFABBDHF.WABA.hABANEICPHAC..hACA..OEFA,1,-13,-30,17
AXTFNBVIgdCZGSJaHDPLeWQcYRfMEOUKb,FAAGBDGA..VAGDdCEFZGBGGDFCSGGDHACHDECHLDBHhAAA.eAHBQFDDhAEARACFMEAF.EFADKEEGAIFGNIAFCBAH.hABAaEHF...WBEHfFHC..hACA......hAEA...,1,-5,-23,18
fQADgXdIROBWKLZSYCGbeJVMNUPFTaEHc,XDBAdAEBRCCHBDHDKBCGLBAF.ZFFGSAEB.CGABGCFGhAAAeAGHMEEHNHCB.hABA.FHGETFBG.hACA.EAHHfHFFAEEDDDIH.ICBChAAA.WBFD...hADA...,2,-30,-20,10
DbdUEVWRJFfOaHIAeNLZBScCgXKPYTMQG,LBBDBEHFCBCB.KACE..TGAEGCFGDEBCUFBH.ECCEREEFFGHFhAAAOEEBHAGF.ADAH.NIDF.hAAAZFCD...SCAEhABA..cAFAgBDHPFHDhABA.MAIDdFAB...hACA...,1,-13,-24,11
VaPXDNZRGFeTWbIcECLgMOHfBQdYSUKAJ,JDGHaHBA..DGDEZABEGBEHFDAC...eABA..TCCD.hAAA.WCDDIBHDhAAAEGHHCHFH.MHAGHCAFBFDAhABAdAFBSEHFABFH..XGGEhACA.NIAHRFEFcEEFOFAGhADA...,2,-27,-12,15
FWVeDNbAJUHcgZGdfOPLBEaCRMKYXQTSI,JBFHUFAEHFEHZFEAdDFB..OFABLAAEEABH.RBBF.KDEF.QGBAhAAASHFGFHGEeBEAhAEADDDD.ABEG...gDAGhABAfDDCBBDF..CHCH.MDHFhADA......hAEA...,1,-18,-24,6
SUIcWCZQHNPRbMYFVaJBfDTdKOAEeXGLg,EDFBXBGGLDGBUGAD....IBHHCBDEHFGHRCCDMCCCFFEH.hAAAVFAABCAD.DIDEKAFEhAAAABFB.eDAA.gEDEhABASABHWEHHQDGH.NAEH.hABA..PABC.hADA...,1,-7,-23,16
WCHRFDcJSPgQOBLbATZNaUYIVeXEfdGMK,ZADGUACC..VFFAeFGB.EDHFdDAC.KHAECDGCHFBDDDDG...JFEHhAAASCBB.hABAQGCGBEDCAAFHNBBGaAGHhAHAXAGD.fAAF..hAAA.MIEG.WEEChADA...,2,-37,-26,11
BDOEdGTAaINUWRgSQXCHMFYeZfKbcLJVP,aBBEUADB.RECF.QGAHHFFHFBAD.ZAFBKGBDLEGH.VECGhAAADCCDEHDAdDACAEBE...hAAAIABHNEAA.SGFDhADAMDDE.fCDFcEGABHHBhABA......hACA...,1,-7,-30,23
EDRdJLNWQFBAYgTMcHZUVbISGKXaefCPO,TACAMACDZDDE.UFGH..IHCHKADG.aFAECHDA..EBABdHFHhAAA.NBBG.FBHFBDDEAGCE.hAAA..gAFDhABA.HEFDSHFGeAHBOEHDDGAF.hABA.JDAFWFDB..hACA...,1,-14,-35,21
AFZgRWUSVPYNHGdbIeCMcOBQJKfLTDaEX,ZBDGRAFCUACFSHBG..VFCH..PFFGHDEDdBAAIFBAhAAAMIFGBFAA.hABAKFHDfCBEhACADDCG.EEDH.FADC.YHDC.bAGHCGFA.hAAA......hABA...,1,-13,-29,16
ZXRVfaCILJQeKOWgBUSFYNATPDcHMbGEd,DGEAMEEGGDABdGGEZADCRAFD....aBCCICBGLDHF.eAADhABAOBHDBEFAUGDDSFADhACAFHAEACEE.PFCDhADA..cEADEADC.fAAChAAACHHF.KFDC....hACA.WDDC.,1,-8,-22,14
ePQULDVNHcbMZJdXKATFgGIWYESCOBRfa,FBEGGDAA..ICGEEBCCCDHEBDFF.RECF.eEEB.QEAFhAAADABBHFFFMCECJBAHdHGFhABAAFFH.TCCF..hACAWHBAOHBC.fAHGaAEA.UEGEhADANAAEcEGF..hACA...,1,-4,-30,26
LgReKYAdBWEbMaZJONFGPfIQcVCDHXSTU,BBAFEGCC.aAGAOBEBGFDF....PDFCIECB.QBFAhAAAVCABCGHAXFFFhAAASHCALHBGhABAeBDDACBFdBGBMDABJABE.fGHADFAH.hAFAHFAB....hABA...,2,-20,-7,13
EKgVdPOWLRQHDSYIFZAXTNfaCBGUeMbJc,XFAFTEDF..aGBAGAAG.MFDDJAEHEAAHKCEE..VEGBhAAAdBHCOFGDLAHBHCABhAAA.DIAASGEDhACA.FDCGAAFCCCCFBEED...eADAhADAcGEG....hACA...,1,-1,-28,27
aGFYUMXCTbVKDQNfHIdPBcLWAgZReOEJS,ZDDGeGAAEBDD..SHFGaFHH.GCDFFGFDMHBCCECD..VEFDhAAADAIHQAFAhAAAHAECIBAFdEACcBAAhABAADBBODAH..YFCG....hACA......hADA...,2,-24,-12,12
aSJPcXINMdDBULWEZTfKAVFgCRbOGYeQH,FFBCRBDAOAFAeFECHGEG..JDAA..XAFBMAAEBFFBLABEhAAAZEBE.TDCHhAIAAHCBCDGF.bBCE...YBHBhBAASHFGIHCEDBIFEBBAKCBF..hBCA..gFGHhAEA..,1,-6,-34,28
UJTWZASQEgYFcGIeHXaRdDVNLBOfMKPbC,QAEBEDHHFDEF.GABGHAACREBADCGELGDCBHEBOEDAMCEGKGAAhAAACBAC..UFAGJDAGZAFChABASGGD.hADA.YFHBIDHA.aGDBNIAB.fFGBhAAA....hABA...,2,-28,1,29
KNgEHaRJOWcbYBLPVCXAefMSQIdZUTDFG,eEFASAFAdGBCUAEADEGHGBBF.KCGGEGEHHDAHaBAEODCEhAAA..WHEG.hABA.bAGHBACC.PDEHhAAACHHBADADMFDHQGAB.IFHAhABA.....hACA...,2,-26,-11,15
ZUKbXHNcAYSaEReQDBIWFgCGfPJLVOTMd,aBEBRFEGQABEBDBF.FFBECCGBGDFC..JAGHLEHHhAAAOEDGMAAFdFAFUABCKBDE.hABAXFDD..hAEAcEAGAFDFSBHBDAIDIHHCfGBGhAFAPHAC....hAEA...,1,-16,-30,14
YAfVHZSFCXLQBRWKDbJTGIUeENMaOdcgP,VGDEZFAACBDELHFC.BDFBKCDGJBAAGCAHUGAD..eFEGhAAAMBIB..OAHDhABAdBFH...PHAChACAAEBDfGGDFEGE.XCAC.QDFEhAAA.DAFEIBFHhADA,2,-41,-16,25
GbIWODfBTeJcRCgLAPQNYVKXMadEFSZHU,QDAHVABA.KACGaAGHFEHDHDGF.UEDAGBFA.IHBBhAAAOEABDBIHBFCAJBAHhAAARDDBCHHGAIEG...NCAH.XGGChABA.ECDASHEEZFBD..hABA.fAHEhACA.eFAF.,2,-12,-6,6
QJUSbdMLHFITNKARYDPEcaWGVfeOZXBgC,DGBHEGBB...aGGGVDCE..eHDEZFFABCAGCDGGUEADdAEE.MAGFhAAALBDEHCGFFABEIABDhAAAKAHH..AIDE.PDEDhADA.....WDDFfEBEhABAOCHF.....hAEA...,2,-36,-16,20
DQcCAKFBgTbXaGSYENUHLfdRMPIeWZJOV,FHFABAAF..TBGFaHBCGADF.ECHHHBBF.LFBFhAAARECGMHFC.PEEG.IFDDhABAeHCEZCAGVADBhACADFGGQCEFAGAD.gEAFhACA..SFGAhADA..,1,-7,-18,11
BgNQOREZfFXPMVaWebJLGTdUCYSKcADIH,DHDABGEAQEGDRCCHZFAB.FGBFMADE..VBFGaEGA..eFFGhAAALAEFGBEFUDBDhAAACCAC.KHGGAAHDHABAOBAEhABAEFDF..fEEF..WHDAhABA......hAIA...,1,-16,-17,1
OTBELNbFfJICSQcKDRWGUeXPZdMaHgVAY,OCCFTCCG.BDGBLFBCFEEC...fGFBJAEA.CDABQGAFhAAAKCABDCGCREBBGGEFhAAAUACDXDGGhABA.PHDEZABCaHACgAFA.hACAABBH.YDHB.hADA...,2,-28,-12,16
gCUeDFfOKWQZEdINRcXBSGbTVYJLMaPHA,UCGGDFCDODDGQBBCZCAB.dEADREFFBBHHGFDD...VGAChAAALADG.MEIBhAAAaDDDAACACDCG.FAGE.KADHIHAChABA.XGCHSGHH..hABA......hAFA...,1,-17,-34,17
PgOQJEWVNdKaXeFbCTSDIMfGBRZULHAYc,...PEBHOEDD.JCBDEBBC..VDFDKAEFaHEA..eHAEhAAACAGEDDHDMBBGBFFGRAFCLDHHhABAHDDEAIAE...hAAA.YFCB.......hACA......hADA...,2,-30,-29,1
LZPgNcVOUBbfCEaeHJMWdGXAKYRTSDFQI,RDGDSGDFFGABLBCAZBED....PCHB..NDFGOEBEhAAABFAFCADG..EAAGaBBHHFFBhACAMIDEdCCG.AEAG.KGHBhABATGAADADA..IGDD...hAEA......hAFA...,2,-29,-23,6
CFLcEABZXbVKQOaUYTMIGPdgNReHJDfSW,BEHHXEGCKDDD..OAFGUFDB..MCAEGGDHdAAD.RAAFHCEChAAADGAE..SBHFhABACFBBFHBC.ECDHABEC.ZBED.hACA..QDADaADB.YHEGhADA.IHAF.hBAA...,2,-31,-10,21
QMLPgOVZSRTbGYIaBNWUKAeCdfJDFHEXc,CEGCJHAAFHGEHCAA..ECDGQAEE.LEEHPHBCOFAGhAAASACD.RDGBGEAFhAAAIABCNIEB.KAGChADAAHHE.dFFHDBGEMBDG.......hABAgCGE.hADA...,2,-29,-9,20
GWJUCgMbfDBLQNcIEadOPKVYRFAXHSTZe,HBEGTCDHGEDC.JHAGCAFCMBCFDBBDBAECLBHH.QFCGhAAAIHFAEACDaGGEOBAHhABAKDAF.REFEAAHGSAAFhADAeHCA.WAHH...bCCGfEAChACA..hADAcFFF.,2,-20,-2,18
TdHBfCaeDbVRYSWXFPKAIZLGMEJUNOgcQ,LDCCMEIDUBFAOFAD..QCABdBABHFCHCGHEeABADAFBRAGDhAAASCEF.hABAFHFGAEADIFFEhACAZFACEHAEgEFDBDAEaHEA.......hADA......hAEA...,2,-24,-11,13
GdSKTDfEYIRUNQOABgFZPbcaHeCWLMJVX,BFHBFBCDZFFF....PDAEaFEHHDFGeBGFLABE.MFCBhAAAXGBHdBGHSAEHhAGADBFDfFEAhAAAIHAAUACB.OGFCAEDG.cFABCHHEWFDDhAHA......hAIA...,2,-27,-20,7
eNVMaTKAdbQEWDJgRGUZSYcCLIPOHfFXB,QEGAEABFDGFF.RGDEUBACSDDE.CCGE.IAECHECGFGHFhAAABHBGeHAAMBGHTADHhABAAEFBdACA..bDACgDDFhAAA..YGAE..hADAPAHB...hAFA...,2,-19,-18,1
BEKgQSLWOdDTYFbeVURJMGaXHPcNCfIZA,BABDKGAGQCGCLEFBdECDDBBB.FBGGeDCGUGDG..MIFGGEAAhAAAaGDG.HADD..hACANABD.ICCGAFBG.hAAA..ECHHSAFA.WGFA.hADAOFFA.YCCChAGA.,1,-15,-37,22
TaQeBOXfLbUIVRSEZFJgWdAMHYPGNCKDc,MEBCHEEEGCBCKGAH.DGBHaDDAeABG.OHECLAGFUAGDIHCHhAAASHGEEGFBZBCGhABAJAAFdEHEACAC.NDAC.CFFE.hACA.........cEGAhADABHCHfFDEhADA..bEAC,2,-19,-11,8
gTeIAMNWRZCcJHaPXGBVLOYUDKQEbFfSd,MCGFRDDEZEBC..CCDF.HGBG.aBGAGAABBGHAOEAADFGDKDGE.EEEDFGBFhAAA..dCBB.eEGHhAAAAAGF...NBAF.JFHBXFAChABA.........hABA......hADA...,1,-9,-44,35
DcCZSWYIeFHVaGgEQULTNMfbXBKRJAOdP,OCCCdAHEDEBAZCBA..SABB..IGDHeECCFAHDhAAAHABCGEGCEHGELCFBhAAAMEBDfGCGhADABEAGKGACAHABCGEB.VADAaHDE......hAGA......hAHA...,1,-17,-27,10
JYBEfNQcFSCKHUaXVbDdIOgMPLZTRWAGe,JBAGBBFH.EBAEQGDCFGAE.KEAAUDCE..XCEBhAAADGDBdEEAOHEGMAIFZAECRACG.hAAAAHIBGEFA.fGABhABANEIC.SEDGCAGBaCAH..hACA......hADA...,1,-20,-33,13
WSCKJPZNdDHEULIAMeBQcGFYVROTafXbg,BFBAGAGCFFGBRFCDOBAB..aDEB..XGFG..hAAAgCAECDCFJBBAZFAFdEGDhABAEAAEUAFCLBEBhACAAEIFMICG.eBHH...YEADhACA.fGDFhADASHGAKCCEDGGC,2,-36,-7,29
cfSEWFDRIGYNKUbCLOXVMAeJZPaHgdQBT,eGAAZDDBHCAGdHGFBFECTDFB..SDACEHBEFGGG.RDEGGACAhAAAKBGGCACALHFAOAFCMCIBhABAAHAB..aAABcEAEhACADAEB..IFAAYHCG...hACA......hAFA...,1,-7,-19,12
JSKLfOTYRNbWcZMAIXgGHQdUFDaCEBVeP,XBEGGCDHdABBDFGCCAEEBFHA..eBHH.SGBEhAAAKECBOHEGRGEG....NEAF.hABAbEECZACD.ACAGIAGAhACAQAGDFDFBEGAD.PCBHLFAFfHCDhAAA..WHCGhAFA..,1,-7,-35,28
CKZNSMgQGLeFbOJaEYPRDBcITdAfXVUWH,XECAUCACCGFA.KAABZAGF...MADFQBEALFCFbEAB.hAAA.aEDF..EGEC.hABARCBEDACCBFAA..ICHEhAAAABBA.fGCG.WHEAhAFASEHDeFFE.FAFHhACA...,1,-10,-42,32
LVeHbJKEOMWQAZcUfTIaYBSgCXdDGNPFR,ZFBHUACG..TCDAaDEGBGHDCHFB..dACDGAEFFAFGLFEChAAAHFCDKBAHODFCMIECAEHE.hABA.IDAFSFFBhAAADAIF...PFAFeDCB..EHDE..hADA......hBAA...,1,-17,-21,4
DVJZOCLYFSHcAeRKWdNITfaBPEXMgbGQU,eECAKDDDdEHA..TGADBEBBECAG..MEGBGAEEQAAEhAAADDGDZGACLHFGhAAAFAFFSDHDAEAB.NADEaGDDhAEAXABF...gBGB.hAHA......hAIA...,2,-24,-23,1
fNPHWRJIGOBScMFYVEbdKTZAgDeQUCXaL,DDBBUEEGCCGD.LCAF....NCICHEEEJCFGOCBCBHEG.MDIHhAAAFAAF...VGAChABAdGGEKHBA.AECF.eEBGhACAaCCE...fGHERAEASACCEHEEbABEhADAZFAA......hAFA...,2,-27,-16,11
YcdZNGJgaVUCRIHeWXfbPTFMEDLBOQKSA,dAEBGEFAJFCF.aBFD.UCAHCDCF..RAGH.HFBH.eAHD.XEDFhAAAPEEH..MFIFhAAALEHH.BEAAhABAOBBEKBCEAHDGZDFF.NCAE......IABHhADAfGAEFHFGDIAChAIASHDA.,2,-24,-1,23
KaSQZDCTXVMPbUfNWLRecOBEGIYHAJdFg,FFHFaCDAZABECACG.....TFGDMFCAUAFG..fFBChAAALHDEeDADBGEHEGCChABAGAAGIDAGhACAADDFdBHESCEDDICCXAGC.bDDG.WFAFhADA......hAFAODGB.,2,-22,-4,18
FYJEOBeHDCgUZNAcIXSaQRGLPfdbWKTMV,XDCBSDDBRGBG.LBFC.dABGKADGMGCCVCFE.FFGDJHDAhAAABFACDDBF..CECD.UABEhAAAACHD..aADGQEEGhAFA..fGAE.TGGDhAGAEAHB....hAHA...,1,-21,-36,15
WSNfLZbPTcAJdHXEFDOMaUKCRYegGVBIQ,JDDFXCGA.FGGBOADE.UBAFKHCERCDB..eEABGEAEhAAABCFHQAFChABA.SFDGhACALHEAZDGBTACFdHAHDAAGMCCDCFCG..gAGBhADAWFHH....hAEA...,2,-29,-7,22
KUgSfCeVRcMNBQZOHXAIbDPLTWJadYFEG,DACGLGBC.TDBCJCEHdCCC.FGFHEABB.KEDGUBGE..SCHBhAAA.CAHGVBDAhACAMBCABBAGZGFCODAHhADAAHEF..bGAG..WHDGGEGE.hAEA..eFAG..hAAA...,2,-40,-6,34
DPWfcELHaMeIJYAZBSgFGNXQRTKUOdbCV,BBAASHAGGEFEQACAKEBDdAAB.CGEG.DAHF....fFCChAAAEGDEaDEBMCIFhADAIFGC.AABBFAGBhACAXGAETDEBOBDC..PBHDhAFA..cDBAeHEAYEBDhAIA,2,-43,-8,35
AIceRONBDHLMTPWYfKUaCXEFSVgQZbJGd,eDDGOFCGBBDDDBBCLAHBMBFG..TAAC..WEGHhAAAKHGEaDAH..CHBGEBEHhABAFFCGSHDChAAA.gEGHbDAHdCCGAEABIGEAcGAC.hACANIEH......hADA...,2,-30,-27,3
eHXZEfgdcOIPKQMBLTSRVaAJCFbGYNDUW,FCAGGDEEDGCG.UEADHEDGEBDEdAGG..OABFKCDDBAEBLAADhADA.SGGDhAEAaFHDJCHB.CAHD....NDHAeHCGhAFAfDBA.IABGMDDB..hAAA......hADA...,2,-46,-5,41
UEDQZPITCBXLFKbcOMHdGeNWfAJgaVSRY,JCFAVAFC..RAAD.UCCEDGFA.ZFDF....TFBECADABFFBFEGEKFAChAAA....OCDHhAAAdBAGeCHH..NAEDAIHAhACAaHGE...EFHHPDAH...XFDDhADA.cCEChBCA..,1,-33,-35,2
RTKIZWFUPVDBQNEbMYHAgSCeXaLcGOJfd,CHBFeCDFLBDEOCGFdEGCKFAEZEAA..FAAAUBADDAGA.BHHG..hAAAEEFHMFEFAAEA..SHGGhADAaCED.JHBEhBAAfAGB.IHFGWBEH..hABA......hACA...,2,-38,-35,3
VDZfLRXNbJaMOdcACPeSTUQYWIHBFgGEK,CBDCSFADUGFC.QEBC..IHCBHAABBEHBhAAAGBEGKFDAVAEBDAHHZDAAhAAARGFGNIBFaBAC..dDEDAGEDeFAFhABA..WADFgDGF..hACA......hADA...,2,-33,-5,28
aJfYLFPDMTWVHEIUNRgZBAXGCcKQOdebS,XEDCCDDAKBGD.dBDHeFBD..SEGDJEFE.LAGFhAAADGAHMADDTFAG.hAAAVBAHHFCGEHBAUCAGhABANEIA...gGGFBHEAAEEE....hACA......hAEA...,1,-7,-35,28
XQHgFZfLYWVNDUMeTKSCGIAORdEcbBJPa,dAECEECCBEAEJFGF...aCBEQBAC.FGADZGAELDEChAAAVGECDDIFeFEBKEFECBBBAIDCRDBBhABA....bAFEPBFGhACA....XADB.fCEHhAAANCIE..hABA...,1,-13,-38,25
feLHMgaKPDCRUbWQJOdGXYTIFVNAESZcB,ZBDGBFEHLAABHBEHaFAAKDEH.DGGGUBBC.QAGBdEAFGFBDhACA..XGGFhAAAIHFDNHAF.ABID..EHAEfEDChABAeACA.MIDECHHAbAGFOACA.hADA......hBAA...,2,-17,-7,10
BceGaXFHfbTOCPEQdJAgSZKWIVRMNYDUL,ZGFGKGBA...IFEEVDGB.RDAH.MBCDDBAGBGBHGAEF.aABBFCCFhAAA.HDFH.TADChABACFEDEFAFdDDB.AAAHSDAFhADANIADLAHH.XGGGfAGG.hAEA.OHCE..hAFA...,1,-11,-20,9
QTDJaWYIFdcBKePOAgHLRVZSUXGMCNfbE,HEDCVFED.UBDEGEBECBGG.....fBAGEABDTGGBDCDDhAAAaAHF..IAEAhABAFDHDBEACPAGBAHDFRFADSDCGhAAA.MACEQDFF.hAGAWCDHcGDFeDHH.hBAAODAH.,1,-5,-6,1
XfDEJAYVSLFCHPbMcIQeNaUGTdKgRWOBZ,SFFDLDDGFAGFHBCGMCDEQDBA.eGAEaGFDTEBGhAAAKBAFRDGFBAHAZABDXFDEhABADIDAAEAHCHHF.PFAHhAEAIHAE.NAABdBFEOEHB....hAFA......hAIA...,1,-3,-18,15
JIHSNbegCLRFQVUMWcBaPYfETZAXKOdGD,OAHHdEAFDAACHFFD..NEDC.eHBELFEHRBCHQAGCMFCFBDABhAAAaFEH...fGGFhABATDGEADAG.XBCAhACAKFAGIHHASEEECEEB.FAEA..hADA......hAIA...,2,-29,-7,22
USIXCJZbWaMfOHRLABNGVYeFDcPTgQEKd,GCECeAAEDHEG..TCAFEAHB.UFBFSEBECAEH.ZADHaGGDhAAAMGFAOABGLEFEhAFAAHCBBEHGVFBFFAGH.gBFGhAGAQCCCICCFJHDG.WHFAhAIA......hBAA...,1,-13,-16,3
fYCUPdVJNIQgFSDWBXRZObTEKMeALHGac,LHAGaBCD...fHEDCGCEUEEEdBEAJBDDQGAGhAAA.FGHHDGAEBEAARBFHbFGFhAAAEECEMAEG.AHBAGBAAhABAPHDC..IAHEgEED.SACFhAIAXBAF..hBAA...,1,-16,-24,8
FbcXgTPYdNSZEBIeWQARKafMVCLGJHUOD,aDAAMDBBLDHBGDEAHADADAFE.FCGB..XFDCTAAFdCCChAAAZCFBEBCABBHB.IHHBhACAQAAG.KHEAhACACDDBJFCDOEAB.cBEBYFAFSDDAhADAADADfEHC.hAEA...,2,-19,-1,18
MHXGbDCPaAFcNQZfBJEeSWTgKRULOYVId,FEFDQFGEBDDC.JFBGSDBF..gABDhAAARGCGUACHLAFFOBEHIHCGhADAdBHGMDAF.HAFGhAEA.XGEHDEEBaHGCAABH..cDBB.hAAAfGAG.hADA.eHAG.,2,-20,-9,11
XILCJTYcdSRVOUKEfPBGFWZgNaQHMbDeA,LHAGTCEF.dEBARAEGUGAHEABHBFGH.GAEEFBCCZDGD.aDAHHEDDhAAA.MBABDEIDAHHHCBDFJHEEhABA..SFFFhAAAKBHB..fDGBgCAB.NEEA.hABA......hACA...,1,-10,-26,16
RTJYCSePLEXDHAaBZOGcKWdfbVNgIQUFM,aDGHZBCDGEFC.KFDDdGBB.VAEA..NADF.QDCAhAAAFEHFRBFE.JBABCAAD..eCAFhABAECHBDGGABHBCOABGhAHA...fHEHIFBBMACHSCCChAIA....hBAA...,1,-22,-25,3
aXcWUJgHLdeOAbIVCYGRTBPfESDQFMNZK,VBBHGCBE.BAGFEFGE.DHDA.FGGGMEDAZACH.KHEG...XFCFhAAAUDFGJFABLBAFhABA.eAFHAAAGCAEA.TCGDhACA.SHAANICH.aFAB.cFFChADA....hAEA..WCHB,1,-12,-44,32
PHUaJSXKMQYDOgWGFTbRNcIefLAECBVZd,CEDDBDAGdGGHHBCGaFDA...SEACKGABQGCEDBBF.OCFAhAAAGGBF.TBGFhAAANABB.IFBEeAFAAFIHEGFChAGAPEEAUBBAMACC..gDEEhBAA.WHFA..hBEA...,1,-10,-24,14
IVfWbKRGEcFQLOaSMgAZDUXPYBTeNCdHJ,ZABFDDBGUACF..PHBCBFHE..eEEFdEEHJDBF..VAGHhAAA..fGAAhAAAKFAH.GEGGFHGCLBAFhABASAGEAEDH.TADGCHEH.WDFChADAECEH....ODGBhADAaEDH.MIAG,2,-31,-23,8
gaQIGdAZWeRJVPEUKXBDcCSFHMNbfYOLT,ZBGHRADE.JBBHEGCB.KGEDBDFA..DDCHCGAA.FBBBHFCG..MAHBhAAA..fADHhAAAODFBLFAFaDAHQGGHhABAIDDEAFIDeBEHUGGHSCADhABA..NIBD...hACA...,2,-29,-21,8
SUYDbTRQdLPfFNeBAJKHWcgXCVZIMGOEa,HAFA..gAEEVFCCZBADGCCDaCEHUBBADABCRDGF.dGGELHAGhAAAFHAGBFHBJGDCKFAE.hABA.XDAGMAADEHEChAEASFCF.......hAFA......hAHA...,1,-9,-13,4
TICeEONFSgMAdHfYbcWLQGBUKPZDRJXaV,HEEB..fFAAbBDFLFCFQBAFBABCKDAFPCFHhAAADBGE.XGCGaHGCTDGBhAAAeAEE.EADBFCCBSFGChABAAGDB.dHGBYFABWDDH..hADA......hAEA...,2,-18,2,20
fVZEQGIceDJbgLPCYUHAaOWRSNdMXFKTB,aDGDOFAG.RGFC.SCBGdDDF.MAFDFCAAKHDABHGEZABCQEAEhAAA.IHAAhABADAIHJCGHLGAGhAAA.CFFD.HFEA.AHCDNEDCfAEBhACAEAGCcACE.....hADA...,1,-15,-32,17
ZNReCWYJdAfOgQLGMaScEHUIKVXPTDBFb,OBCAQACDGEAEaBBH.EGHFHEAF.KFGDXAAHDEEGBHDBFEDGhAAAZAEFeFFCCAAF.JAFAAHCFLAHDhACASCEAIHHBhAGAPHDC.........hACA......hADA...,1,-14,-16,2
KHXfdFCJgeSAMYIcZVUOGWQLTEabNDRPB,MCEH..ICCCZAFGUAABOAAEGGCDQBFFLDFAEGAAhABAaFHDDEEHBADFKEAAXGGHhAFAFFFHCGAH.JDCHgDGHhAAAAICG...cCEHWFFC.NICF.hABA......hADA...,1,-10,-28,18
YfHdGLbKPUSAVQeCDcgNaIJRWXOZEFTBM,QDDHDGFH..gDBBIFBBJBBCRGBA..OBFEhAAAFHFCBAGCMAEEHEGFGEEHhABAKCAFSBHHhAAAeADDCFBGaHGG.XGCAEABF.YAFF.hAIA......hBAA...,1,-13,-16,3
XEObfAdBDLKTPRJUZWQeFCaYSGINgHcVM,DCAAKBBCREBDUFECZCDC...eECDFHDC...CAHG.SGGAGADE.hAAA...NDBGHEGFhABAMAEEEBECOAGH.AIFEBCHAhACATFEA.JCADaABE..IBHAhAAA......hABA...,1,-18,-36,18
XcVNRCDdKBebgUIEAWQaFMJZHTSGOPfYL,QAECMFFGZGEAHACDGCGA.OGCEfFAALDBDXCFAhAAANBAH..DIBGdAFGhABAeFDEgGBFhACAIAHEAIEAaECEFDCESGHH..PBBHhAEA....hAHA...,1,-5,-11,6
eINKcAFHBSYEgLXRVMOZfTPDWCUbaGdQJ,FGDBBFDFEBEFLBHH.RGCC.MADFOACAZEFH..TBADDAGFCDCB.hAAAUGAHGCEGdEBBJAFAhAAAeBAE.KHGCAEEDSFHBhABA...XCFAfFBAhABAWFFDaHAC....hAHA...,1,-12,-29,17
CcUKYbILHeTgDOaRPVEQAWMSXfFZNBdGJ,MGDCSDBAFBACZEADdEFF.GFBH.CCHF.UCDDKBBG...IAGFhAAALAFGeCHBhABAgGGHDGIH.aDAHhAAA..PHEAEBDGAEIFXGACfADGBGFHhABA..cGCHhACA.bCFD.,2,-37,-7,30
RTGKceNBCObVMQWPaSJEXZDFdfILYHUgA,GDCAKGACeHDCBCGF.CBCF.OAAB.MCDBPFGH..SCEFhABAEAAHDAGGFGEHfGGDhACALFAFHBDDhAAAAEBHTDGC.cAEANCICQCAD.hADA.aBCB.JFDE.dAHAhAGAIGBG.,2,-10,-6,4
CJWTEMKfVcdRFeBGNIHDgULXQSYAOaPZb,aDECZDFACHAB....JGAEEFBGKFFB..VAFDRDAGBADH..GDDGhAAAHBFCDBCHUGGDLFHHhAAAQCAEAIDC.OACFhABA..WAFCMICAdFDA....hABA......hACA...,2,-33,-14,19
XgTBEfSHFVbNGaJACRKMZeOUQYPWIDdcL,RDDHKADCeBFAQFBB..PACGDBHBdGHG.LBABTCBDBEHDhAAAECEEHFEDFHGEVGAAhABANAIC..GDCBhAAAAFFBMDGD..OACH.YHAA.hAGA......hAHA...,2,-21,3,24
AfONHYMUcReBaDFIQKCbZgVTLGEPJSdXW,OCDDHCBFMEEBUDFHRFGDBDHG..FHCEQFACKAGFZFCA.TAGChAAAEBAH..JCBBXAEBhABA.ADFDNICHeAAEhADADADD.CHHF..........hACA......hAIA...,2,-36,-17,19
SdTHDKEUZMICBXgLbAJeNfaWRGcPQYFOV,JEGDeHAG...aDDEGBEG.QDBBFBAESDCFdHDHTABEhAAAHBFDEADAZFAHCGCFBGHEhAAALAEEbFFFAHDCfFBGhABA...cAGA.ODABhACADEEHMBAD..hABA.IHHC.,2,-9,1,10
dYTcZECBLJVePRKWgGHOIADbaQFNUMXSf,DEAEaEBG.FBFFUACA..MAAC..SEGFdGGF.TAFDhAAAZDECCHBDJCBG..eHAChABAREBC.KEHB...hAEAGCDHIHDFAHGGNIDFfEEGEAHDBHHGLFFDhAFAWAHBOFAEhAFA...,2,-28,-25,3
ILYSREQdMCJXDUZAcGNFaKHbfeOgVPWBT,GAAHaDBFHGECeBFEOAEA..VFGFBDEBTCFALFFESEEHhAAAQABDMIAAhABACBEADCGEAEAAFDCAKHBGgFCDhADAIDHDEDABdFAE.JDDH.....hAEA......hAFA...,1,-2,-9,7
bKDHYfGOdXUWeTgFVcNAPaLBQEJSMZCIR,LHBCQGGCSABHCAAG.REGHDCIHHBDF.fBGGhABAdCDBUEDG.eHBAFAGC.cEAEhACAAABHBEAB.MFAFhAAAIEFGKADE.OFCC.WADC..hAHA......hAIA...,2,-27,-21,6
LOcZJNXfTFCSMEAgGRBQKdHVbIPaDWYUe,RAEEKDEHdCDDHEAF..VAAAIGHD.DEGFUDGGLBAAZGAE.hAAAJAHHXDAB.hAAA.fGDGhABACHHD.SCEEAGGFgEEFBEDG.PADAhACAWHCA.eHFG..hAIAcECG.,2,-27,-10,17
TIGfESKZFUYaJMNVReCXbAODgPHWdLBcQ,DFFBHCBEdCAGBEEG.QGGETCCFGGABEAFDZCFG..FBFGUGEAhAAAaGGB.MHBA..hABANEEH.eBCG.CEADXAGBhACAbABAADFC..OFAG....hAAA......hABA...,2,-28,-3,25
YMDZAEXecGdBQCVaPRfOTKNSgFJbILUWH,eCFFdGEECEDH...aCBCRCAG..OFFAKAEFSACF.FHBCIHAFhAAAUGEB.HAFFhABADDEBZBGHXGGEBGAF.hAAAQEAHfFGBTABCNBAG...hABA......hAFA...,2,-27,-20,7
WeSBZTHUOKCQJDRcXYFaIdAGMVNLgfPEb,VABCLAAD...fBEBECEHeEGHBEAEHDCFOFHBhACACFAGQECHDDIFRAGBXGEChADAaHCG.ABCENEACbFED.hAEASBHBZBBCKEEC.cBAC.IHAEhAAA....hABA...,2,-26,3,29
ABUGcZSMHLEWKTQFJRVfeNadgICYDOXbP,UDECZAAHMBGBEAEF.KHEAFDGE..RFAD...VEACeEHH.dCCACBBG.DAIDhACA..OABG.hADA.PFCCAFIFBHAGSAEBhAGAHGBCLHFE.TAGHfHCFhAHA.aBEH..hBAA...,1,-18,-26,8
OeFdYDRJGbWEHNLVQAZcPBXTMIUSgCfaK,ZCCABDADMGFGSFGE..CGBAKBEEeAAGFABGdCDF.DGEDRGDG.JEDGhACAGBGG.EECDHBGDhADALFAFAIHCXGBBhAEA.IHAH.fAFHhAFAaAAH.OCCH..hAIA...,2,-24,-23,1
WQBGKaDVPNcOIEXbZFgRHdAUfCSLeYTJM,UEDBCCHHLGFCeDAB...JFBFMHFG.BCGDKABHDBAH..NBCF.hAAAOBDD..IHBGhABAEGDH.XCCChACAFAGFHCFBAAGGfEGBSEAC...hAAA......hABA...,1,-35,-38,3
JfFeCBUNcDdQXagGObVZHYWSARLIPTKME,REEELCAH.TEFGEBDEJHDA..FGAEBGBAUAGEDIAC.dCCAXGDDhAAAGAGC.ODHFhABAZBAD.HDCDSFBEhAAAIAEFKFADfHGBeADECHHH.cCDAhACA.aBBF...hABA...,2,-23,-2,21
OaMRIdfAYWJKEGVgbNSTQHPDBLFZCUeXc,JEBAGBEF...bEDHTBGF.QFEHDBBAFDCBUGFEeCAChAAAOHAERGAG.dAAGADIHKABAhABAEDGC...NAEHHCDAhADABEAACAEB.aGAGIFHA....hBAAWFFE....hACA...,1,-9,-22,13
EIPYcfWVSRAXgUCLeGOHBJNaKMQFZbTdD,XGGCCCEGGDBAHAEGBAFF...aFEGMHCCFHGEZAADdEBCDBCF.EDDBhAAAIHAA..hAAAPADDfFGChADASABFAHDELDDAeBHHOCFFNCIA.KHAGhADA......hAHA...,2,-27,-3,24
gGfYFCcaLdDQWSUPZJBNHITVAbRKEeMOX,RBDGEDAEeFBG..MFDHOABDGCCD.FFHHCGABLHEEDGAC.hAAASDDFPABCBHBEhABAIAAFAEFBKAFEXGFDhAEAfFGF.aAEAdEGBQEEFhADAZBFC.NAHG.....hAIA...,2,-24,-7,17
NdfHaZXLFRBEgQCOeIDKVGWTUbSJPYcAM,dBAGaBGDLDBABCDCQFAG..CFCHOBACeHEAKEGGVFGDhAAAGAEH.UFCAbFEB.hABASCBH.hACA.PFAFAEDGMGEGfAFG..hADA......hAEA...,1,-21,-28,7
XIbUHJcLADMaZdONBQEYPfKeFCVWGgSTR,DFCBZCDGOFCFBCDF..EFHB....fBBFKAECeAAFCDAAVEFEhAAAGCEF..SAHBhABATFEB.XDAChACAIHABbFAD.JFEHAIEGaCCH.QAGAhAAAFGHD.WFCHhACA...,2,-37,-10,27
DgQaTcWOUXEHFBCbKIPYefNSLVZMdAGJR,GEGADEFGQDBFaFEF..TAEEOAEGEDADHFGHBBCEbGBGKCHHhAAA....IAAChACAPDDEeGAASCCEhADALABFMICAAIAC.JEEHcBGGXBFHhAIACECD......hBCA...,1,-1,-12,11
QKbRAPYDBZeadIfXHCVFcJGSEgNWOTULM,DAEBeCEGdDCE..IFHFHFFEFAFC.GCEFSDBH.EEFHhAAAgAABOHAELAFAhABAMICGKDAGbACFAHAHBEHGhACAfBBACFEF.JHEE.NDEE..WGAChAGA......hAHA...,2,-22,-15,7
AHLSJDMeNZcGgTUdCWKFPabVYIQOEBRfX,LAHDDCAGMAEEZDDDGAEE.UABDdFBGCDHHKDGF.FGGB..aAAE.hAAA.VGAGQGGFhAAABEDGRCAC.AHDGHBEG.hACASEBENEIC.......hAEA......hAGA...,1,-19,-27,8
JfFdVCBbHeLRTaSUPMEOcKGDAXYZNgIQW,XACGZBBD..IDEFQGBBJFGF.FHEG.dDCEBEHBeBEFhAAALAFGaCGA.SACEhAAAUGGEMAECEGAFhABAKEFGAICE.NBBC...fGCH.CCFE.hAGA......hAHA...,1,-7,-42,35
AVQNRCKHeLMZbUgFODaTBYXGWESfIcPJd,QCCARBFACBAE.KFBGeECELBHBMIFGUGBEOABH.DFIBBGEGhAAAGEDDEDFD.fGDChAAA.PADGhACAAAIBHADE.ZCAGgGGDFGGGaFAH.XBFDhAHAIDHA...hAIA...,2,-16,-13,3
VNDHKbGESWgeAcFQCBORfTPZaLXJMIUYd,FAFGQGEHBDAEREFA...TEABZCDBLHCCMAIBUCEF.dBAGhAAADABDKFFEEHGC..SHAEhABAeCFCACCGCACA.PAEChACA.JBCD.IHHENEAG...hAAAHFCH....hADA...,2,-34,-5,29
HCNUMYLSfPDQAdKEZJWcTVXeIGOabRFgB,KDFCZBDDJHDC..TAAD..eDFAOEAGaFGG.FCDGBHACCGGG.hAAAMDAELGBC.hAAASCHHPFAEAACBEHGGhABAVAFA..XAFFIADD.bEFG.hADA......hAEA...,1,-21,-33,12
acTKgDdIBXWNefAMGHUPVRFELOCSJQbYZ,HABFVFBG.FHFELEAFCAAD..QDEHZBAATDEGKEHBdFGDIAFDhABABHHH.XFFChADAeAAEAHEDMADE.hAEAPBFAEFCHSBEG.YAHHhBDA.aGDDDIAE.fHFFhAHA,2,-23,-9,14
EYJWLXCTQeOIBacRdUFHAKSDgGNMfPVbZ,SABBDGHBGBGEMCFF..PEBHZBCFEAADJEEA..XDABhABATGGE..eHCAhAAABGFEaCHBRGCGUGAGFAFHKCDDhADA...fFDCYACC..CAHB.IAHEhAEA...hAGA...,1,-11,-20,9
OWLeGQcHRgfXEKBPbVNUTCDaAdMFIYZSJ,dEBDMHECFFEFZEFA..JCHFOCAB.eHCGQBCHHBEARBBD..hAAA.XAFBBAGB.hAAA.PFAF.NABHCEDGhAIAaHBE.ABAGSCEH.LDAFhABA.gGGChACAfDGD.,2,-24,-21,3
FCcJaMQPbHSUIdeYgBOfNTXKWRGVLZADE,EBEHFGFGCDFB..aABA..MEIBQGEGHDADUADGdAHAeEAHBHBH.hAAAfEHE.hABATDCEWAHHREDALDGDhAAAAGCC.cGBB..PABFIHHFhAEAOHFEKCBE...hAFA...,1,-5,-25,20
YBdESGXJQNbRCFODMeIgULcTfHVWPAaKZ,ZDAHdEEFSCBAJBBC..QCFBRGBEFCEGDGIF.MEFD.eEHFhAAAIFAELAFAhABA.TGCFHABEWBADhAAAAAEBaHEEBHAA.EDDHNAIGCFGA.OHEE.hACA......hADA...,1,-14,-21,7
DKadUNgIfSTHECeYZLbMFAQBXPJcGROVW,BGBGXAAEJCCF.RGDG...OHDEDEBEKCGB..UFEH..NAEH.hAAA..IACEhAAASFDCEAFD.CBDCZFGBLCFGhABAFGBBAIDE.QEAD....hAEA......hAGAcBFGWEEE,1,-31,-34,3
IJbSFNGacPVYCDUfReZTOLXEWQKAHdMBg,MEDGBBDHJFCCFAEAGDGE..aBAE..VBAEDFBHUGGE.hAAA.eGCEOAFEXAGDhABA.ECEEKHCAAIGA.hACAdDDBIEBESABC..NIAB.PCHDhAAACADGfFFE.hAEA...,1,-6,-47,41
GBJWYRKDFIZXALPTfUQOcgESHaNCeVdMb,LCEFTBFH.UBFGQCBBOBCH.EGFBHEAH.CEGBdBAGMCIHhAAAGFEDBFDDWEEChABAKHCGDBIDFGAF..IHHDhAAAAADGfEBG.cAEGSGADhABAeFFG......hACA...,2,-17,-9,8
FgGAXMRSbQWIecHJECPfOTBLYKDNaZVdU,XBABSABD.QGEFeFGFHCCHJDBCEACE.CAHB..OHCEhAAABBGBKGAEDGACZBEBVDGDhAAAUDGFGAEAABHD.MCABhACA..WGAAIHHCfEABLHAGhADA.....hABAaEBC..,2,-13,-3,10
KReOYHVLZCWJdDESNGIAbfXUTMPBgFQac,XDFHMEIFBFABFAEH..QAGHKDCERCAD.OFGBHGBAZAGFhAAAJBCG.EABBGGABAFAHUGGEhACATCAB.PEDGhAAAaFDC.........eFCGhABA......hACA...,1,-13,-19,6
UOECBSVbQILYTAWMKefgDJPNRZHdGacFX,MDCGKFEFeCBDDGGB...JDGFRACAdBGB.GCGEaGBE..FBBAUGDBhAAA.CECG.SAGDhAAA.QCDHhABAICADTGAGAIFC.fEEDNEIA.hACA.cADF.OAHFhAFABABF,2,-34,-34,0
GLFeKZUadPCNXAfRDEHVWMBISTOYbJcgQ,RCDDEBGHHBFA.MFBFIHFH..OHFCJFDD.QACChAAAFEAFZCBAdABBCAHCAEGCDBIHBGGEhABA.SEAChAEATFGB...cFDCgGAGLFFCKECD.hAAAaBBH..XADHhAFA..,1,-12,-19,7
ECZPYdeNRLSIDacXFWGBfVgKUHTbJMQAO,ECAHCCEDZAGHdGAC..eAFDLCFH.SEEDDAIBaBBH.XDCFhAAAGEED..BHHChAAAgGGGHDBGJEAHAHFHOAFGhABA.YCHFIADHFEAEfHEHhABAVACGKHBE...hACA...,1,-9,-24,15
RGeQLEbCBXdOHWZPfFDJSMagIcYNVUKAT,TCAGGCFALBAB.CGHABCHBdAADOEEFZDBBFEDFDEGA.SAGBhABAaACD.gCEChADAIHAB.NIBH.hAEAKAGAAHHA.eFFD.EHDEXFAE.WCCBhAFA.....hAAA...,1,-21,-24,3
UCfWbgLTJDeHFSMdRGYXNcIVaPQEABOZK,OABGZFBHUEGE..CAFC.....bFDBTDGG.DDDEeADHhAAAHGCGFGFHSBGEhAAAdDAHRAFD.XGFBhAHAIAHGaEBBEBAEAEEGfBCF.WFCChAIA..JFAHMFIF.hABA...,1,-16,-19,3
GLcWJMCYFaOebUfESPNQBVRdDIAHKgTZX,KBEDZFBDLDEF.JEHHCAGGaDFE.eEACUBAG..EBABSBFBhAAAQGGDBBHChABAdFDBAFHEHGEC.XCCBhACAWHAG.FEAFOGCE...fBBDhAAA...hADA...,2,-29,-24,5
LHUFVMcXRBWNefdbQKAETDYgCOZISJaGP,DEFFCDDEZDAB..JBCGGFDHHFAB.FAEC..MFHDRGAABBCE..NACF.hAAAeAAC..fCGAhABAQCFDABBGEGFHhAHA....YHFGIDDFaECCUGCGhAIA......hBAA...,2,-32,-24,8
eKTXRQJCNIOPDWbAMfEGUgYFZVcBLaHSd,MCDCEHAGUCBBFFBGZGFCBDHA..HDDAdGDGKEFHRAAG..CDHH..OHBAhAAADCGAAAABGADD.hACA.gDAChADA..YFHFLAGBSDFChABA.XEAA.hAEA.JFFA.,1,-12,-33,21
gXSWKDecEGFaRBfOQCATJNUZYdHIbPLMV,TEBHUEAHZBCC.dBGAHDGB...IBGGLEFEMFEFXFGChAAASGAH.hABADBADeADAGBEEaGCDBDDChACAQBBEAIHENEEA.......hADA......hAEA...,1,-11,-27,16
fcKRGJHWAegVZFObXNdQLTYDCSIEPBMaU,VGBAODAB...XGDAdDFBQADGLCEBDFFC.SGHDhAAAPBAEBHGDMBAEhABAaFBDUAGEKDGA.JCAHAAHAeABEhAAAFDDD..........hAEA......hAFA...,1,-17,-30,13
IgeEDbZHNBWfKcCXMSYOATPJaFRUGLdVQ,TBDGJHCC..RCDAUABEGDDH.LEADdFFD.IGFBhAAAeFAEDAGHZDBBBEFEKGCBCACH.hAAAMIEGOAHDABBHFEHD.hAEA....gBFBEGHF...hAFA......hAHA...,1,-5,-39,34
SgMPbaKQNUJdEIcZfFBHVLRWYGCDTeAOX,OFAHXDBH..SCABMDGH.aBFBNIBD...UFFDEBHBZADHhAAABCGBHBADLABGhAAARFGH.GDEHDEFBAGBHgFCAhABAKCCB.dAGFfECEhACA...FHBE..hADA...,2,-22,-1,21
eVgcIMfFEYOGJCUTNZBALdXQKWDHSRaPb,dHDBKCCHDDGCHBFG.RAAC..aEBAeFCF..VFAEIHHG.FGAFhAAAECDEGFEDCEFD.UAEHhABANAEFZEGFBHEG.ADABLCBFhACA.XCEHSEED.hADA......hAFA...,1,-14,-23,9
TfXOLMRgQAbEVUSaZBecHFJNCdPDIKWGY,EGDGUCCCZEFABGDGHABCFCFGCGGG...dFFGDCAH.KBFFGEGG..hAAATCGBODBHLECDhAAAMEAB...gAGEhABAABCESACEaCCEeEAFNICD..IBAAhABA.fGBAhAFA,1,-21,-31,10
cgQeIGRXZHASYJNbfPKEDFLCOBUVMdTaW,SEGEJHBG....fEECECFELACFOEAAUGGHhAAAdAADTEDAaGGE.gBDDhABAIBDBRAGHXGAChAEAAFGB.YHBGPFABDDDEBFABMADEhABA.cDGC.hAFA...,2,-20,-20,0
OfDTeaWbBLCUVIHKZAREMQYXgNcGPdJFS,MCEHQDEF..XFGG..gABGNABB.hAAAPAEAFBFESFBEhAGAfEGATCBGhAHAWDABBECBCHFGIDHEHGCGAHIB.YCFChAAAdBBBDIAEeFEF..aHBChACA...,1,-12,-26,14
gCPGFDOESLRBUdVWMXefNaQAIJTbcYHKZ,TACC..bDGBHGDEZEDA.CGBDGCCHFCBDEGBE.LBABBAFEdABFhAAAMFEE.XEAEhAAANEIC.AHHFIAGGhABAJDDAKAEDDAHFSAHH.....hAIA......hBAA...,1,2,-31,33
XgOfQCKMEeIcVaBTRAWHGbZNDULYSJFPd,GDEEZBGDUECCLBAG.SHBEFBBAdHADOGFACHHDKEHFMAAEhAEA..IAFFhAAAaBFGBECEACFBHCAHDGGDPFAChAFA......fHFBhABA.....hAGAeEAD.,1,-17,-34,17
ZaBdVLNGOQRCbPISfDMYJWTcFEAKHeXUg,HBFBeHACUBEFaCAHdFHALCAEGEAFRAAECHEE.....IFFHhAAASGFEDIEAJHAETDAFhAAAFCDBAEHEKDEB.XDGAhABABGAC...OAHB...bFAChACA......hADA...,1,-12,-23,11
eZOUXaWfRbLMYGINPHKCcSdgTJEBDQVAF,FFAHOFCAUBEH..aGGFRGEELEFE.GDABNICDHAFCKAABSBCAhAAA.gDAAhABAEFDHDGGGAIHCeACBhAAAXDGE.WGAAMAIH..IDEBhACA.CADF....hADA...,2,-23,-12,11
RcfFdQEAWSMLNTJDIPHXgCaGeKYOZUBVb,SBBAMBBBLGDG..TGFHDDDDHACGCCHGGDAHKBGFZFGFBAGAhAAAVFAHRFCBFEFB.EGAGhABAAGIF..JCED..PADGhACAaCCBOAFA.......hAIA......hBAA...,2,-18,-13,5
LBQDgcYeJANMZaXKFVOfdSPbCIGETHURW,ZFCAKFGGFFDEOAED.dBHCSABA..PDBCCHBDGAFEhAAAEEFGHGAEUEACLCAEhABABGHHDABG....hACAYBBEAEDENAIC.MAABaHEA.....hAEA......hAFA...,1,-19,-27,8
BcNMGCEeDPKAdZFabRfUYLHOSITJQVgXW,dBCBFEGCRAFBUFFAHEDD..OGAASDAC..JBFDQEADhAAA.XABHhABAWEHB.NIBF.GBAChAAAEGGADAIHAHDF.aHAG..fDCHICEF..hABA......hACA...,2,-47,1,48
DXdgOKRCePLfQEWVcNAYMUGbBaISFTHZJ,MHBGUBADBFHG..aCFGFFDDZBADDEBHdDCB.KGHBRBDF...eFAFhAAALFFBEFGC...hABAVAFEACAF..bFEHSDFChAAAHDFEXECHCHHC.PAFA.hABA.WFAD...hACA...,1,-9,-38,29
WKDdTXOJcbfCFNRAZGIHgLYaBEVQMSUPe,ZDFGGCDGHBADLGDAaBGFBFDHEDBB.QABGUFGD.PCHBhAAAKGADDDDD.dAEEOAEGhADAJABA.....hAAAfGBENICH.AAIB..IHHHhBAA.....gBFFhBBA,2,-36,-1,35
DPIYWXKVETJbFHZcfaOSdRLGBgQeUANMC,CDFGDCEB....IFCBXFED.EDCDJBCAHACH.ZEGHaCABOBFHhAAA..RFABBHGGhAAAgGABeEFAAHAHMDIDhABA..PAFCKCAF.TGDDFAHDSGCBhACA...hABA...,2,-42,-5,37
SdbHXJcWGNZYQaVBPFIUgKAeRLfTODEMC,LFFAOCEFDBFCCCGEdHABHACF...JGCAGECAZFAD.QAAGhACABAHBFAAD.IAFHhADAUFGAAFAD.eCCA.TEAEhAEAMEAA.SEFE....hAHA......hAIA...,1,-15,-34,19
GIVaHFgSdeEOLMQAcWCDbTJYXBZRKPNfU,CCCFDAGB..JBFFBDGF.KCAF....fABDIBBGHFBGhAAAFGBB.dGHGEDEDMCFHhABAAEBD....cECHhAAATDBE..XFGC.ZAGHNICF..hADA......hAEA...,2,-45,-39,6
AQIVNHdGgRMXWOEBUYfaDJZebLCKFSTcP,VGCAdFDBGBDH.MABDOBEABADGUDEE..aHEEDBCDJCHBeDBDhAAA..CAHDFGBHTDCEhABA.AHHD.QEADhAAAIHAA..NCIA...gGGBhACA.WDDGfFGAhACA..,1,-25,-30,5
GAdYcSVQKCIbDTWNXZMgLUEOaRPHeFBfJ,dFBBSHBCKGDG.CHEF.DCCH...TADGNAHG..MFAELEFEhAAAUACH.EBAAaDCARAFHHFGFhABABHGAGFEBhAAAAEEH....YHAAcDEEIBAFhABA.WDAG..hADA...,1,-21,-35,14
aGIDAQWfSHCKcgBYUOFdPNTEReMZbLXVJ,QEBD.SHGCKBCGgBFHBCGGOBDBFFAEdHAFTEDFhAAAEBAHREED.MACChABALAEH.XAGAhAAAVGEGaCBCDIDEAIHEfDGHHGAGCEGCcDABhABA......hACA...,1,-7,-18,11
WePXOICURYZBGgJEfTMVLbacdAFNHKDSQ,FBBEKEBAQCACeFCD..OAFBCEECUEGBRBGBBGABGADBEEDCMHCGhAAALGFC.aBAHhAAAADDEDCGG.SGABhABA..WDAAIHHC...hABA......hACA...,2,-33,-26,7
JOFTNRLacQIWXKZbBDVSYeMCgUHAEdPfG,dCADGAFAFECFRFGBLBBG.aFDDQAEH..XDAChAAAKHECBHBASGGAhABAMEEGCDHEHEABAFGCfAHEhACAOAAA.NDBBWFAADAIH.....hAEAeACC....hAIA...,2,-23,-23,0
gSUDLMWXeIRPdCaOBfYQNVcTbAJGFHKZE,FABHKBDHZDFCEEBF.UEAGDHBA..LAGF..XGCEeEFHRADFCAHHhAAAaHFC..BHGFQBAEhAAA.VAFEhABAcDABAADD....HFFCSFCAhACAMFCE.IEHD.hACAdDDD.OHCE,1,-15,-20,5
BOAaUEDdRWLHTYPMKGXQJVCSZcNeFbfgI,EAGDDDGBRFEHLEDHHAAD...TCABMEBHKAGHGDGGQFCFhAAACACCSCEBZACBNIAF.eFFBhAAA.FFAC.fHABhABABCECAGHCaCHD........hACA......hAFA...,1,-5,-20,15
HIZbABVEDdYOWFNURKSCXcgfQTePJMGaL,ECCAdBECOAAEFBGC.RCCB.SEAB.CBBG.gEFGhAAA.QBGGhABAPFFAJACCaFCHLEDBhAAAHGEEIGAFAHABBFCCDIDGWAFEKCEB..fDADhADAMAFC...hABA...,2,-31,-6,25
aHcAgbCVDRTGEWJXYKSMPBLefOFQUIZdN,CHADVEEDDCBG..GECFEBDE....XAGHKBFFMCAFBDAFeGEChAAAOGBE.FFAGIBHGhABAdCCA.aEBBAIFGgAAHhAAA..TGBFJDFCSGHHhADAfDGG..hACA...,2,-43,-15,28
SAPUQCRJWYDEHGTOgdKcLXIBVMFbfZNea,UDCACEHCRAAG...JAABDIDCHAEBGDDA..OGAEdGBDKFHBLFHBhAAABCEE.MICEFGGHZAFFhAAAaEGH...AADA.QAGEhACAEEBB.TDAB..XCAGhACAbEEDfDGDhADA..SAHB,1,-18,-26,8
eYAOJbVUWgfGKNIPMQRHTcCFXZDEBaSLd,JAFHUCAB.....fFEFKHGE..PABFQBEDhAAAHBDFCGABZDEGBDADSGABhABAeAHD.OHFChACAbFEC.WDHH.NDDEMAFETDGG...hADAXEAEaHCEdBBBACHA.hAAA...,2,-37,0,37
EObJFgDdfZSQWLGBKAaHCRPYMINXTceVU,aCCAREFAMFDH..XAEEeFAD..EGHFJCFHDCCAZAAH..SBGGhAAALHAGGEGGhACABEABAGEHCABEIBHAhADA.NFAD.TCEH.......hAEA......hAFA...,1,-24,-33,9
QPeBAHfUDEcTKYJIRZGMgLbSaVOFdCWXN,UBBHEDAAKHGE..JCHBZBAEGBEGLAFD..aGBGFCHH.CAGA..hAAA.XGGCQGCEhAAABDADHEEEDACATAGFhABAIECC.MABGbGCE....SFAChAFA...hAIA...,1,-21,-23,2
JKZgePROBCTdWEFSAQLGcMHYVXbaUfNDI,LAEGMBCAHECAVEGFaGAE...UBAFDEAGKDDEZCFG...PHFGhAAAODCD.CGEBdHCBFAGBACAChABA.QEGEhACA..YDABfHCH.IFAAhADA.....hAAA...,2,-33,-8,25
QMTIDacLBXPWbgRNFUOEdeSKGHAYCfZVJ,CHCAZAEH.QEDGMABCDGHD.LABBBCHD.XGAC..hAAAPCFHbFGH.RBBEFGABhAAAEBGGSEHBhADAGAEFADBA...fEBBJEDHIGFFaHDCcFEEhAGA..NEIE..hAHA...,2,-30,-11,19
TGCRecgFLSPJadKAHNWDXEIQOZMYUBbfV,HEFGDGEEECDEQBAA.OGCEMBGHUFBEBFDFVADHCHEFeAAChAAAFGAFLAFE.hAAASEACJCFEaDAHADDBNIDFhABAICBH...ZEFC.fHGBhAEA....hBCA...,1,-7,-26,19
XdeAcGaYVbZOHWSJfQFIPUKCDLTMNBEgR,GGBBaFFG..VAGHOAGF.HACDJDBE.fFEHFBCC.hAAAIFBGKGHHDFBALDAFhABAMEEABHHFRGDG.eBAFhAAAAACG....cGAE....hAEA..YAFFhABAWEEC.SCCD.,1,-5,-26,21
edgPWGHTbYZINLCaODMFSAVfBKcQERXUJ,BHHCKACEEGBGRAEEUEEE..eBEHdBAE...PAGBGACGHDGDhAAA...TBBEhABAZEACIHCFNEFELFAEhAFACCEADAGCMIBE.AAIFfGGGXCGA..hAHA......hBAA...,2,-35,-7,28
gRAXLKTNcDGCJbWOSFMaQUfHBEIVeZYdP,LCEATEAB.DACBJEHHOBDA.FDAAaFDD.UAEDBGCHEACFeFHHhAAA.ZFABdBHCREFB.ABAGKCAGhAAA.GCEECAHFSHEGhABAMDDDQGFH.fHAHhABA....hACA...,2,-27,-11,16
cTeJgDFLWNbUIAZHOYRSaKXGfdQVPCMEB,ZEBDODGFRBFAKCBFGDDA.dAGEQEGC.CHHC.EBABBEEBhAAAcEBC..TABFhABAeFGDJADBDEAHLFDFhADANBIG...bADDAGBBSAAEhADA.aCCHfGFEhAFAMFAD..,1,-18,-19,1
MbEQdeFVLYaIUfXTZCWODRBJNASgGHPKc,SCDEGDECHBDHKHEAMAFE.QEAEFEHFLAAAaHECIBHAhAAAXGAFTCAEhABACDHEDGHDRABHBGCH.AADC.hABAPAFEEEGE.eEDE...YGEChACA.fHCFhAEA.OEBC,2,-6,-4,2
MLBCFQJSUcYPeWHdGEXDRTZbIVfKagNAO,LHFCFECEQFADSDAEUABA.....PDFGeEHFdHEFhAAAEDEDRAAAZAEH.IBHBhAGAVAFCKEHB.aFCHADHDBDBBhAHACFGG..YFAF....hAAA...WCCB.hAIA...,1,-8,-28,20
HVABaLWTGIFJgbNfXDOZcdUKRECQMSeYP,LCBDGAEDJDEE..NEDF.DADGZAFA.dFDFKDCD.RFCG.CHHD..MDIHhAAASHAE.eBBFhAAAPHCGHEFGAIAABCDGhABA..aBABIACH..gGGAhABAfCED.OEAHhAEA.,2,-37,-17,20
NdJYQgSPTIGKEfVeRZOCXHFUaLbcMDABW,BGHHdBBDQGABSCDA..TAEBIGDFKHEG..fDEBhAAAeBAFZDCCXFBBhAAAFEEHUDAALDHFhABAMIDGAGABJBGFgBGC..EABE.OAFAhADACHHH.HEFB.hACA.aECFDBID,1,-3,-8,5
gMaFOcILBSKAePCUHYTXQZVbdRNfGJWDE,CAGAUGFEHFCD..XBGCQFAA.ZACHdBBDRDEAGAAADECBMEDBhAAAFAEF.OGFGLAEFhABABHHDSEFEhACAAIEE.eHAGYAHBbDAF..NEEEfAGDhADA...hAAA...,2,-11,-10,1
FeIEKUSHXMWCDaPRdcVgGNBLbTfJQOZYA,FEEDeFEBECADUCFH.HFABMAIHDACE.RBCD.dHGF...VEBFNCIC.hAAABDDHLAFA.hAAATGGEJAEAZABAAAGCSBBFhABACFHC.aGCF....PHCChACA.....hBAA...,2,-26,-14,12
FWYVgIbMZcXfLJTDUdeRCQBNHESGaPOKA,FCHFVCBB....IADGZEFH..fGBGTEDCDAGCUBFDhAAAdAAA.CACF.BFAHEGDF.hABASHGG.hAEAaCCDKHEAAEHB.WAHBgGBAMFAB.cFEDhACA...JAFHQEDDhAFA,2,-44,-15,29
JRMKTgLHbeFPZQIVXWcfDAaCUGNYdSBEO,CEHFGEAHdEDEBGGEOBCD.MGEEKABALCDAHGBGeAHF.FBBBQFBAhAAA..hABAIBEDXGEHWAAFhACADADEAAHGaHFA.NAGGEEEERAEC......hADA......hAEA...,2,-35,-8,27
AJZVXfReadBWNPOFcTUQgCGHbMSIDYLEK,JDCCXBFG.REAA.dGAHBDHF..NDGA.FGBD.UFGGCFDG.GAAChAAAMIBG...DADDEBBFhAAAAEDEZFEH..fAFChABAeAEEaGDD.PACA...ODHFhAHA.TBGE.hACA...,2,-34,-20,14
CEHUMXNcYAZgPDfGeTJSQRWOadBILVKbF,ZADBDCFGGCAGJCHF.QEGBRCAB.OFEBdEFEBCFB.LGAChAAAKCCBCHHEUACHMFHDhABA..XGBDhAAA..NIADAACHfAGDeACH.SBAFhABAaFDF..bAFA.hADA...,1,-24,-25,1
NTUAfbKDRaYXJeILgBZdWcFSVQHECPGMO,KECBDCCERFGD..XBEAeEACLEEHBEFCZBBDdADHFGGE..SGBChAAAQGACCBAAGAGAhABAMAFG..NAAEAHDHaDFFhACA....IHED...cEGGhABA....hACA...,2,-39,-21,18
KIdDbGRVXaJNEZUCecAPTYHfSBWLOFMQg,TDFE..fFEFBBBDODCGFCHHMFHHQAGH.hAAAKEAGDBGBRGAA.XDDFhABAaHDEEACB.ZFAA.CEBBAACGPEHFhAAASBDG.WHAGIAED.hAEA...dBBC..hAFA...,1,-13,-31,18
SgJKPEBYcfUOFCILDZXNMaGeVdQTWbAHR,HAFASCEGKEAFEEEDBAFB....fDFBUABACHDBLCGHhAAADADHZBBFMCIFaHGAGEADhAEAdHCHTGFEAIGG.hAHAJBAH...cFADOFFB.IHBAhAIA.eDBE..hBAA...,1,-7,-24,17
ZCOGSdVDbcMgEFAeaKXfPURLTQWNYIHJB,KBAFXFDFUEAALBDG..QBBG.WEAChAAANGEDHDEGZCGH.OHDAhAAASFBHDCIH.cFGHhABAMIAC..EAHFAADHaHBEfCCEPDDGYAHHhACAIHHHCFDF..hABA...,2,-31,-13,18
ASWHeJRBFXCQPgfUZDdYcIbVMKOLETNGa,HBCCRBABBHFDCABD..QDDF..fHCHDGDGdCGEICAAhAAAVFAA..KCEDEHGChACATFFFaHAA.AAFDSAHBhAAAeAFGXDAAPDFE...gABBhADAZGDG..hAEA...,1,-2,-38,36
BDPCXdgfIJNZRUOLaFEbVGWHAMQKYeTSc,QDGGeBFB.SCBDDFDCXCBCdHCH...IHGBhAAAJBFAZCCAUADGOAHBFGHFhAAAEEBH.VGBC.HABGhABAABBGKGAD.cEECBFGGCFHE.NEAC....hABA......hACA...,2,-21,-5,16
UCJbDPdTKOZVYLQaeBASWIMNfHGRgEFcX,SFGGMACFHDFBRBGBEBBGFGAC..UAGCCCEF.DEFAdAAE.KEAEOEAEhAAAZFDFLBDDQBDGhABABHHBADAC..IHDBhACANADD...fHFB.cGBGhADA....hAEA...,2,-35,-18,17
BAXYOfWcQENZbTDdPFVeaMILGKCSUgRJH,OEBE..fBCHQFFCEGCFZBBADDFCFAGB..eEAHhAAA.aEDCMBABLHFAhABACGEFSCHBRAFEBEHAAFCDhACAWHEANDAHdEGC..IDGH.KFAD.hADA......hAEA...,2,-28,-16,12
JDAgVPCWcfFEQITHbXYOSNeUKBGaRdMZL,VAADCDCG....fFDDFFGHEADA.QAEDHAGH.XGGAhAAASEFFNIBF.hABAeFBEBFCGaCDDMDBHhACAZGCCDDAFAAHD..WADDIGAH..YCHBhAEA.KGAF.hAAA...,2,-21,-20,1
RUHLYVDQAWSfGdEMFJCXTaONIBKgZPebc,SADCdABGMAIDFEFECGDH.....TDBGOEFF.BBBGKFAFZAEAhAAAeBFARGCC.UGBG.hADAHCDH.LFHDhAAADHGCAFIFfDDDEAFCaBAH..IEBDhABA......hACA...,1,-19,-29,10
GKCXgaQYLFZDVfHMbcPAEeSNUOWRTJdBI,eFEBUCFDRDDDdBDBBBDEGDFA.KDAACBAG...aCCCLGCA.hAAADIFGfGAFhABAHEAHMAIF..bECHAHAHEAGHhAAASAGF.NEIG.TCBF.IGGEhABA....hACA...,1,-12,-32,20
eREJXcQfTWgHKLSFVCPaMbIZUdYNOABDG,DFFEGAFCEDBF.JABA..QFDC..TDCGHABEKAEEhAAALHBCSAHDhABAFFEGCAADaGHBIDDCdEAA.hAEANIDFAGGDBAHH.eCCEXCGG.fGBAhADA...hAFA...,1,-14,-24,10
YUOCfPZWLeMNSQgAbaKJBEHdTFGRcVIXD,KBGFBDHFEEGDdFGA.FAECGBAC.RECD.VAADDEFB..UACB..hAAACAHCZDDHeHAG.SCHHhABAQGCCAEEBaGGChADATGAF...IECG.ODABhAAAWAFFMIFC..hAHANIEH...,1,-22,-28,6
JIgOUCYAZTWQNMaHGXSEVfbDPLFdBRceK,ZCCBQEFFaFAF.HABASFEAEGABVDABDIGG.LABGhAAAdHGDBCHCRGCGKAGDJFDFICDGhAAAUCABAIBC..TCGGhACAMADG..fFHCFEEG....hABA......hAHA...,2,-13,-11,2
ZVdOfGHDKRagTJIQXCcUESBebWLNAYFPM,FBFGMDABdHDFGBCFDEAD.RDBH...aBDDTFEA..JEGHIHHChAAA..QBBGhAAAXDFBCAHEECHDBCABhABAeDEFLCHHAABG.PHBGOFADKABGhADA......hAEA...,2,-35,-11,24
XNEQLWZcHYKgFfGPRUDaCbVdeMTSIOBAJ,JGFCXGFA..QAAELBBAZEFGHEDAKGDDFHCAGEAChAAARADBDCDD.CCHGdDDC.MAFAhABAIHACBACGAADCEDAE.hBAA....cAGDgCEH..hBFAfFBD.hBGAaHFC..,2,-23,-16,7
HVOILKcCNPEQBRGAYUDZFbSgTafMXJWde,DCGBFEAG..SBCBTFBB..MBAAXGBCdDADHBDF.OFEFhAAAKEDECFCCEGFBBHHCAEIHZAGBhAAAaAFEJBHB.eFADhABAIHHA.cADFNACF...QBAGhABA...hAIA...,1,-15,-22,7
OCYNMbGFHgAWPZQBeLUERVSTXcKDfdaJI,ZBBAQAEFeHACLDADUECARGEE...VEFFXEFA.KDAHhAAADFIHdACEIFCHhAAA.CBFB.NEIEMIACFACEAIDABAHGhABAEBAA..cFAHaEEB...OCFChABA.....hACA...,2,-26,-5,21
PMGHTJDKgRYOBAZFCcILSeabXfENQVUdW,FGHHCFBALEDCeEEE..aGBF..XBACEEBG.QAGAhAAAUBBEdAFFMAIHHFDCDBDEhABAKGDH.YFAFOAEHAGGFhAAAICDCSCAFfDAH.WDHBhACA.PHFE.hABA...,2,-25,-4,21
BQKUOdIVMaREHXfCPFbNWJGAZceTDYSLg,eECHDFHBLGAGQEEBKCGH.dAFF.MIBAaADHHEDG.CBAC.bAAChABA..JCABZCFA.cBCDhACASCCG.hADABFBAIHGFEBFC.fEAFNAICAFIF.hAAA..YFHHhAEAgGEA.,1,2,-32,34
efAaBDUVFbEcTOgYHRLISKQGPWXCZdMNJ,DEIFUEAAFACCEHFG..OBEFHDFFLHBG.KBCBPAADhAAAXBADCDGD.ZAFGMAIDhAEAeDEFAIHE..BBGE.hAAA..VFAB.TDCCYCHH.SACChABAWFGF..hAFAdHDH..,2,-27,-15,12
BNEVCGfcIHJWMLPeQbTUZAXgRDFOYaSKd,REGBOFHB..aCHFSDAHdFBDBGDA.ECGCCDDG.GACH..hAAAIAFEHEDGMDCGhABAeAACTGAAZBDCACBHDHAAhAAAFHECKAGC..NIBD.fFCG..hACAWEFD....hAEA...,2,-41,1,42
IfMDLVORENdSGBYZXcKJTPQFbaWCeHAUg,UGGB..fBGADBCGLCFAVEFDOGBCECAB..dABHSDABhAAABHAAZCCCKAFEhAAAJEEE.TEBB.FCHDhACAaCCACAEGAFIDMAEG.NIBB.......hABA......hACA...,2,-38,-10,28
JFKYIPCbGaMQEUBcLDSTOWXAHdZegVRNf,dFBEZFCDeCFDRDEG..JBEAKAAH...IAEFCAADGACE..QCBEhAAABHDHLFHBhABADCHFSGHBhACA.TGAHOAFAAIEEgAGEfCACYGDChACAaHFAEDAB..hAEA...,2,-40,-11,29
SNgZAObdBDFPfEXKIQHWUeTcYaGCMJVRL,OAHHBAGGDBBEFEGE..EFCEKFFDHBEA.UFEGeDCF..TCADhAAAaADFCGHG...JHACRBAFSAAEhAFAZDEC.hABAAGDA.dGGE.XCGAIGAF..cEAChACAMIDGLBFFhAGA...,2,-33,-12,21
SPJbRVHEXeTYfdIOBNUaZGCAWMKcgQFDL,MFAGKBFCQCDCDFGFLCCA..JHFARGAAHACCEHCE..TEBHhAAAdDGHBCAG.aHCEZDGDhABAAIFA...gGADhACASABFPBBBXAGDfADHhADAIFHF.....hAGA..OEED,1,-14,-19,5
QfWbGRPgBXVOCcHJDaETSLIAKdUNYMZFe,UBEEMIAAZABEQDAG..fFCGGEGERGCGBBCEOAFBhAAACFEB.JEFBDBID.EGADSBHBhABA.AIGGKEDChACANAAD.FGHFeECCWDAB......hADA.gCCChAGA..cBBH,1,-19,-26,7
KFUCWGHPLaSTDNOARVMYXQBZeIfEgdJbc,RFAFVFEDMCCB..QFACZDEB.eCEFEBDEdEHA..bADAKAFBhAAA.FHCE.CBAF.HDFAhAAALHFCaCABDDDHADDBBCHDhABAIHCC.fBBD..JCABhACA......hADA...,2,-22,-7,15
XDSBALbRIUGVdfcOYFWgKHPQaCTMJNeEZ,LHDARGAGGEABdEHGODGBFACG.KCBCHBDC.QEEGaAGA.hAAACDGC.JECC.EEADXBAChAAASBDBAAGEIHHDhABAfGBF...YABE.hAFAWFHB....hAFA...,2,-39,-6,33
PSgIACaFbXdRBHZDMfUNecLKGOEYWVTJQ,CDEGFGBCdFDDBEEFZAFH.DDFE..MDAFUCBD..eEHBKGGG..GACDhAAAECBB....VACBhAAAJAHF.SHAGhABAAFAG.XGFD..fGEChABANHBH...cEGAhACA..,1,-27,-50,23
ZWJVAOdfPGgNYMcEXTBIHRSCaKUbeFQDL,OEECdHEDGADF....gCBEMBIDEGAHBDEGHFAACAAGKDCFhAAAUBEDFCGDDCBDLHDGhABAZFFG.JAHHAHHC.fACEhADA.NGED.XGCBIHHESACChABAaEAA...hAEA...,1,-14,-23,9
bQYXLVNEZgMfFKcRIAJSBOUPaWCHDTGde,JDDCOEHB.UCEGaFBB.HAADGEGE.dABFeHCG.QAGEhAAAXFCDLBEGhAAAEDCCZFBEMDAF.fACBhAEA.cGFHAFAHPAEGCFFEDFBA..hAFA..YHDGhAIA...,2,-36,10,46
gJCDUHcQGPMXRWafLSOIANEVeKZYdFBbT,EHDCeGFEZADAFHCABCEH..TADBCDCH.UCAEHDFFGBGCMBBDRFAEhAAAaEEELAHF.hAAASECAIABFAIBGhADANBAE.KDDA.bFACDIGG.....cFGEhABA.....hAFA...,1,-11,-15,4
MRSTDKbYcPaQEAgOBXVWIeCNdFGUZLfJH,OGCGXCAH..VBFBeAGH.dDHAFACBZFBFLHEEHADHREFBTFDDhAAADECGKGAB...bABFhAFA..PAADEGAHBDDGhAGACCDB....NDIG....fEAAhAAA.MFEC.hAIA...,2,-23,2,25
DNbSdGBXKLVOEeTaQAWYIPCgfURMZcFJH,..IGEGCAAHUGAFRFGFZACE..FBEHDGGC...SGBDhAAAdGDBBBGEKDCFLCFD.hAAAECDBaBCFABAC..WECBhABA....gDFAfAGHJCABNDAAXCGDhACA.OHFChADA.,1,-32,-43,11
aGYNXcWHfFdOBPEeTKVDJCMSQURbALIZg,LAAHZEDBGBFAXDFAHAAAFAEF.OHEEBFBDECDB.TAEBhACADFFBCCDC..MCCBSFFHhADAQGAHbFDBACHChAEAIDAE..aCBD.YHAChAGAcGGAfAGDhAAA...,1,-9,-21,12
DFWNaLgEIcROUAfHPQdGeTZbKSCXBMJVY,HEGFQBFHdCBATAGBZEAGKFFD..SBAFCEECBHBE.JFEFDAEEhAAAFAEF..aDGCEGAARABHADABhABA....fDDAhAAA.PCFDeHFAMAIH..hADA......hAHA...,1,-14,-31,17
AfHBcaRXebTKgSJWNDIYCdVGPOZEMFQUL,BFBCaEAF.RCDE.eFCCKDGG...JBHHDDAACCBF.dGCBGGDFZACG.MAAGhAEAUGGH..AHAGHCFBhAFA..XAAFhADATCDHSBBE..IAHDhAEA......hAGA...,2,-48,-11,37
KGbYLWSegfOCIFUcEHTDZJAMaRdBNQXPV,MFAEdCFDBHEH.QECHXEEDKDDEGBAGLAGD.eBABhAAAfFGBCGHB.hABAUGBDEADGDIFGAAHFaAEENAIA.hACA..PABG..YHBASCCEhAAA.IHHHhAFAFBBA...,1,-13,-27,14
SPFgHeRWbdaLXODcVJGAIMKYZQfTBNUCE,KDCHZFDDQBGHBEGAUGED.CDFD...EBGBFGGA.HCCDRFAD.dFAGLAFChAAADABA.JBBGACEEIHFFhAAA.MAEAhAIAfDAH.SEECeBBFaGBDXDGDhBAA..hBBA...,2,-39,-14,25
AIcVgSTaLRYeBbEXWCJPUFNDdHQKfZGOM,VBFBTBBD..RACEBBBGEFEF..CCFAUGGGDGHBHFAD..fECHhAAAZEFEMICAAEEFIFAChABA..cDCBhAAAaDHHeADC.WBHBPCABFHCC....hABA......hACA...,2,-28,-15,13
JBAXFEVcNRCLMKUYITZbGgSfHOQaeDWdP,XADBVAGH.RFCC.CDECLACD.KEFGIBCG.bCEEhAAASFBD.hABAOAAFQGGAhACADEBGdGGHBHBEEGDCMIDETAFB.ZDDA..gADHhAAAaBBH..hAGA..WAHB,1,-10,-31,21
UWHIPVScXFANgMKOJdTfQRDZBGbeYCaLE,MEDFOBCBdADF..TCGDQAAE.DEHBGGCB.eDDEhAAACCEGEEBDUGGCHAGFIAFDhABASGEDcEBChACAAHIDgGAEKADBfEEGRFFDBEEFaHAC.hAAAWDAF....hADA...,1,-7,-20,13
SZdCONIJBeURFEGVDWQfMLbPgTaKHAcYX,XDGBdGAACDAH..OEGDJDCE.BBACeFBD.FAGEEDDD.DCFGQGGDhAAA.fABBhADAbGDC.TFEChAEAHADDAIFA.YDFEZBBGIFCD.hAAA......hABA...,1,-10,-42,32
XeVaDTHIKBJGFPNZLdYgfURECOAbQSMcW,SBEHMDCC..XAEBaACDHEEDBHGAJAHHGEGCFECFZEFCdABAhAAA..fGAHhAAAEHDACCGEAAHG.QCADhABAeDAFDEGEKGBANDDC........hADA......hBAA...,1,-3,-27,24
NfJPGTcDgOEaMWSRYHUFQKAdZeXVbCBIL,dCBHeEHH..VEBCBHFFLABEJDCCGAAEDAHF...OAGHhAAAMDHB.SHAGhACARGDAHAEFQGAHAFFBZEACCEGC.hADAIHHG.NBIA.fADH.hAAA.cEEFaBHDWHBEhAHA...,1,-5,-30,25
KVCUJWgGdRYAZNFXLDScfMEaePTHQBOIb,FAHDXABBDEGD...SDEGMGCCEGHB.aGBG..eAEFHBFGhAAAQDBGBDHAIHFDhAEAKGBDCHDD.UDBDJAAC.hADA..gFDHdDFFAGAF...LAFEhBAAfHFB..hAEA...,2,-33,-6,27
TgbCOaYXQDNWJELSZfMHeFPABIURcGdKV,BCEEUFDGRFACGCGE.dADHVBAF..bCAGCHAD....aCECQGFChAAA.DGDBhABAJAFCSAGEhACAMDIDFGGHAICGIGBA.KEDHOABG.NCHC.hAAAEEACZDDA....hAIA...,1,-15,-23,8
gAGCHdFBTWPfIYZDNERbOLSQaVeXKUJMc,CHBFdFHAFAABBBHH...TDEA..fAHAZCBHDGFHEACBOCCEhACA.LBFBhADAaHBCeADEXEFAhAEA.KGGD.MFABAHABWBADYEBC.NDIESHDEhAFA.hAAA...,1,-19,-43,24
XBdaUEAZbDMSPFcHgIVQJTYOeRKCWLfGN,DDFEMFDBFFGGHBAG...IHADJEDB.OAFBeACGRCBCKEECLHBGhAAAGBGGBGFAhAAAdFAD.EEABAHAF.SBDHhABA..cBAG.....hACA......hADA...,2,-42,-17,25
GMBfPNQAbEFIKgVSLHRcCYOXeZaUJTWDd,EBHFKBDH..SAGGRDBDCHHG..OACGXGFBeDEHZEFAaDHDUCGAhAAA...TEAChABADHEAGBCFMDDFfCAChACAPHBEACBHIAAELHAE.cACBhAFAWGFEBAGHNEEC..hAGA...,2,-28,-4,24
KeMENBVOSaZXfRJWAYCUPIGDgcbLTdFQH,CGGDUEGFGCEFDAIH.......bCCDdGBAFBAAQBEFhAAA.KACEEHCCBEEGSAHHhAAAaCBBZGDA.XFBGhABA.fFEHWFACAIHC.YADChACAIDCCLFHBhAHA...,1,-23,-40,17
PXWbecQJGfMdRTYNIEFULAVHSBgKZaDCO,VDABSBAG.BGACKBBGDAHD..CCDEOEFG..XDGFhAAAeBFEQFDAhAAAfGEEdGGBTDDFhABAICFCFGGCAAGFZDAE.WHDGJACCMIAE.hABA.NADD.EFCF...hACA...,1,-23,-26,3
NTESfRDgMAZJFBUICKWbLaXcHPQGYedOV,ZFAGFBEABEHHUCCGKGFFLAAA..aCHBHEDD.GEAGdFEFOAFHhAAATGGH.SGDDhABADBBEADAD.JCCDCHAA.hABA...XDADPAHF...eDHHhACAECAH......hADA...,2,-35,-9,26
cROIMDbGZQgaYAFLCJBeUHdTWKXPNESfV,CHFBBEAGHEGDdEEGKDDC..XBBGEBAB..VGBERCFD..MHCEhAAADCCHGBEFQGGEhABAaAGAAHIBFAGE.eADATEABhAAA..NICFfECAIFED..gADChABA..hACA...,2,-20,-17,3
KMFUBbTHDSVdEfgYWAcJLQZNRCGaIPeXO,JADDLBBEZFCH.RDECCGHCGCEG...aEGEeEDB.KBGCFABDBCHAhAAAHAFGDIAAdGAFEEAB.hAAA.fGGChABA..WDCFAAFCcDAGNIEH.....hABA...IGFDhACA.OADA,1,-25,-27,2
dMgDWCcRFYKBZHbTEaUNLISAOXPVJeGfQ,XBGCVCFC.GAAHQFCC.MCCEgEDH.hAAACDCAFHGAKACGBDDEZFAF.hAAATCADaHDALAEBhABAIGHHACDE.OAEA.eHFGDFGG.WHBAhABA.YFFEEDAASAGEhADA,1,-1,-33,32
UXWaIgGCVLcYMNfZAbQORKFdDeHJTPBSE,OCEBRBFHdCADDHAEHDFH.JGCGBBCB.UFEAXGAH.aABFGECChAAA.CCEFLAFChABAMFIBZAGHQDBFhAAA.KAEAFEAC...eHFASADFhAIA.IHGFhBAA..,1,-2,-33,31
YGTWBEQSIgZfRMLbPeNCaUFAdDJOKVcHX,JDEEOFCA.KGFAHBACGAFEBDBG.QAEHSBBCZGAARFAGLDCChAAAeEHF.CAHEFEHDhABAAHIHDAAE..XADFhACAYFCG.EHEAIHDEMAIB...hADA......hAEA...,2,-25,-13,12
WfSPGUDAMZdQXcHaeCYEVOTFNbKJLBIRg,MHACQCEAHBEHCFGEEAFE..OCAEFACBKBABBAABREGB...fCGHhACASHAEUGGHhADADBIHACDDdAGF.XEBFhAEAcECG.eEEDTGDE.....hAFA......hBAA...,1,-14,-25,11
SYcAMJRZbHNFfGUeWBLCEPOVKIDdXgTQa,JHCERFDEZFADHAEFFBDG.GEAA..UCGEeCHHBHGEEBAG..ODBAhAAAKBAEDDAHdEEB.TGGFhABA..aDDGSACAhACAAFID.MGDE..NAAD.fAHChADACAHD....hAGA...,1,-3,-48,45
dZXScbEHCTFPaVGYKRJUNOIAQfLegWMBD,QFGEeEBEMHFGDGAHdCDAZAFE..XBDHSDBD.EFEDhAAACFBAFEHD..aCHFGAFAhAAARGAGJABE.OBAChABAACGB.fHBBgDFAcFEB..hACA......hADA...,1,-11,-26,15
NBDdbGEVOLUTXRcafAWKHSYJFQCPMIZeg,KAFCSFDBFBDF.CAFB.MFHHZEEH..eCFEBDGC.DAACdCAGGEEEhADAOABGLHBEhAEAUBDE.RCBH.aAHFAFDA...hAIA..WHEA.JDGH...IHBBhAAANCIAEBGA.....hBAA...,2,-32,-17,15
AGgaKQJbePZcLOWDFMBINTCVRHEfXYdUS,aGCCJCCE...eABAZEFDLHAEDCFCBFGD...TAGGCEGERECEHCADhAAAEDAG....fFADhAAAdBHAAIHEKCCCPFAHhABAOABAFEHD.IFEF....hAFA......hAGA...,1,-24,-30,6
RDdGKbPIMUEOYNeSQFgXBWAHfJCLZVTac,JAEBCAEALDGHZFFG...aEADRBBFDEAF.GDEFKCEC..IABGhAAAEGCA..OAABhABANICB..eCDBFBGABHHGhACAAAHH...fGAFcGBBdDAFMIDGhADASFFF.hAEA...,1,-29,-30,1
GedScWHUBTOPQVZXKIAMDJNaRYCbgFLfE,JHDCaBHH..RCAC.CCGG.FGHHLCAA.GAABdGEESDFFhAAA.HGAABEFBPACChABAZFBDXAGE.hACAAAFHDDEBNFAF...gFGFEEHD.eEABhAAA.....hAFA...,2,-26,-22,4
gWedGMBTAYcIEKUCHJZVXFfSNRLQbaODP,..IEFCEHCGCDGFZBAAFBAE....SFADLEHFQBEBhAAAaADG.OGAAhABAgDEDdDDABDBFhACAABECKFHHHGDAXFCAfAHGbBFA.DDABeHFGhAAAMIFG....hADA...,2,-19,-17,2
DaJNfcWYPIKFbVdeQCHZALETgOXUSGBRM,EDDAOEBCUFEDGEGCBBEB...DGAGJFAC..fCADhAAA....YDHHhAAAIAFBKCBEFAHHdAGChABACGFDAEGHLHFGTABGSGCHMIBGaACG.hAFANAEA......hAIA...,2,-32,-21,11
UDVaSXTNHAGcCZIWRfdYJBLgFPbOQKEeM,GBEGZBEEREFDdCCGBACBLDADFEAC..OEFDKHAE..MBAAUGAEhAAADACCaBAC..SDHDhAAAXECB.HFDHhABACDHC...IHHCWFHF.fEBEhAFA..YHCChABA..,2,-29,-25,4
UIKMGWeJEaSXNfgPZDORFcYBQLTHbdCVA,KDBHMDHBGGBD.eEEGJEAFEHCA..aAAFSEEE.hACA.fBFGhADAZACFDAADFBBHBHGGLCFChABATAGCdECAAEAFIBDHXGGCNBED....hAEA......hAFA...,2,-26,-19,7
RcNSZBLYEFCeQbKdMfGaOXJgATUIPVHWD,TDBCUCBD..VGEEDCGBRADH...SBABZCEDBBBEECHHCEHB.hAAA.QEEChABAdAEDMBAHGFAFOHBCJAHBhACAAAHE.IHGF.HFAEWHBG...hADA......hAFA...,1,-15,-27,12
dFPabOCeUGSILVJcgAHYfBENRTMWDQKZX,HFCHBHABEFCBRBADMBGBDFEH.ZFFD..FBCGaCEH..CCHFGBACLAAEhAEA.JCHFAABA...fDCAhAFATCEFKFGCdGAAhAGAOAFG.UGGBIHHA...hAAA......hADA...,1,-3,-34,31
KDCTfNMSWLVEXJQIFHAGRPOabZeUdBgcY,GEECOBDAZDFAdGCGBDHH....gFAAKABETBEBMAFGhAAASBBDLEDFhABAEDCCQCBChACAFGHFAAGHaEAB.eFGB.YFFFCHAFfADA.hADA......hAEA...,2,-21,-19,2
AYdHRaGXIeLJCOMfWNQBgPZUDVTbESKcF,dEACRBDDGAFGeGDGLEDEOEHH..MIBE..NCBDBFGAZFEHDABFhAAA..TCGBSFAEhACAFABGAGCF.aDBEIHAChAAACAHC...WBDE.....hADA......hAEA...,2,-28,-26,2
YFbeLWMSZTBdfaNCgQEHAIJDVPKOUGcRX,DBACVDDFKGHB.GDBCRAFB..FDBDLAGHMIBG.SGEBhAAABACAdDHA.aAEDCGEA.ECABAGGE.hAAA..JEEEOBCEhABA..cCCFXFAGeEAD....hABA......hACA...,1,-21,-31,10
FgEYHCedQGUJBLNRIMfbPTcKDZSVAXWOa,XCBHaBBA.FGGCEGDD.CCGD.dBHCGEACBHAALEEGREEH.hAAAMAEGfADBhABA.TCDGKGCCDAAESCAChACAABDHOBFB...gGGAhAFAYDAF...eCHH.hADA...,2,-37,-2,35
IdWcZSOVYbfgFTEPDHGJRMaNKeXAQCBLU,BHBELBBBdFAFZCEAOCHF..VCAA..fBDChAAAFAHF.TFFHDGFFJAAAaBFHhABA.KGCBAEEG.QAGGhACACHGG.IEDG.SFADhADAgEGAEHEG...hADA...,2,-49,-3,46
fSVTYZIMEgKaWRBLQObFdCUPXcNHGeJAD,DBDESGCH..TGGGZAEEMGFCEBHFKDAAaFCG..BBBHLHAAhAAAOEAGdCDGCHFB.XDFHhABA.NFAF.eCHFhAAAACAB.fCDE.IGAEhABAWGBE......hACA...,1,-28,-34,6
WYbEcMNQLIZdOGUfTgVKCJSBaeXPADFHR,FCFHHDACRBGD...bABEEEDE..MGFELBAEdBGHGDDCUGBE.TDGDhAAAKFHFCAFG..BEAFhAAAaFACeCACADAC.DIAA.hABA..WGAA.NIDF.IGFBOBFH..hACA......hADA...,2,-40,16,56
SWgPBTAXNaVUfdbLFEYOKJHRQCZDeGMcI,XEDAaDFA.UDGCdDDEFGBG.EAEHKEAGRDAE.QACCZFFF.hAAADBGAeBFCGGEFMFIFhABAIHCFSACChAGAPBAHAFHF..fBBEYCEEOGAGhAAACGEHWHAA.BHAD..hABA...,2,-20,-11,9
COEeKbDHZANYPXaScFRdgTLfWMGVQJBIU,...PACCXAEA.aEDGSGCG.FBABdHAHTFGBhAAAfFGCGDEFVBADhAAAJAFCBCDFCGEHeFAGDCCHhABAAIDGNABF..YCFCcCFH.gEDGhACA.MIFEIHHDhAHA.OBHD,1,-8,-16,8
cfXaWgDYZKUVbCGBeSQFEIRHALJOPTdNM,OCDBTDBE.dHFHMBFD..XFEG..aFFCDCFAKHBCUFADhAAAbGEGBBGCSADAhABAQABAEDACIDGEhACAAAEGLAHB.PBABNEIA.fEDAhAAAWHBG....hABA...,2,-23,-21,2
PVSKCZMdXDFEGQcNagWUBbOHRYfTJLAIe,eCCESGCECEHH.ZAFEdAGGFDDHEEAC.GEEEQABA.aCHFhAAAUBAABGFGOFCFhAAARCFH.fAEGhABAJBAFAECH.IHGBKGAHDEAFgGGHWAHH.hACA......hADA...,2,-22,-15,7
PHGOEKbDdRUeSQgLaBJNWCYAIfFVTMcXZ,FBBDVDBHMBFB.ZECDGGEF.KAFCdFABeBCGSGGBLEEGhAAABBGBJBHH..CBABADDCTGEEhAAA..XGCHhABAOADBDIAE........hABA......hACA...,2,-38,-20,18
aZTVUICOEbYXWAQSfHRdMNBKceJGLFgDP,SEBCRDCHdGHABBHF.KGEC..JBCGGBDB.FGBHDEFEZABDUGAAhAAACEEB..EAAD.XDGGhABAAEABHGDA..MCBDhABANEAELHDA..aACGIHHDOCEC.hAFA.....YFFEhAGA,1,-24,-29,5
SDAEKFGZfdLOQHWaXVUNbBYJIgCTeMRPc,KHCCFBFFGCAAdDABLEEEQGEFHFFBaFAFUGAD.BEEG..hAAAIBABCECA.eBEAhAAAPDGDDBIFAFIHfCCHhABAODCD...WAFE...NEIAJABGhBAA.....hABA...,2,-27,-11,16
bgMVXRNCYOEJHGLTIWAQeKBafSFPdUZDc,KBDCBDBG.SEGCdFGEUBAFZFDBDBAG......bACD.MAFGhAAAVCEA..RFFCCEEFOFADhAAAEFDB.JDCDLBFChABA.ICGHAAEAeDAF.aEAH...hABA......hACA...,2,-36,-16,20
CUIabHeAgcPEZLBVWFGfQdJSDYTNMXORK,...PBBALCBBBECHVDFG.GGBHdHDFDFFC..TAGAhAAANEEH.OACCCHBBUBGAhAAAaEEHHCAHABAE.EGGHFGGHhABA...fCAESFCAMFAHKCEE.hABA......hACA...,1,-5,-28,23
fOcJUFTWDYdLBaVHQSMGeIXKERAZNbgPC,ZCDD..gDBDCEADOFFH.UGGD.FGDDDIBALBCCBBGAHBAFhAAASAHFeGBGKACEhABAAFFF....PDEEhAAAfDGHJFABWADEaCCFMEID.XGGHhAFAEBAFNBIC....hAGA...,2,-30,-11,19
XdYNJfQOgDKeaIcCbEPUGRALFBZTVWSMH,BDBBZDCG..VFFEMIDAdBCA..JEBHQFCEDEFD.aABBCACE.hAAA.EEHDGBEH.hABAAEGA.LAGBTGAHSAFEhAAAHADBNAICODDHKEAD...cGGHhAFA.....hADA...,2,-29,-15,14
JCKTeEbGNLDMcYFQfWUBOHIAZdSXaPVgR,dEDCSFAGaBDH...VEDGRAEACGFDKEAAeBBC.GCEBDADC.MEAGhAAAFEFG...fHEDhABAUBACBCGEIHBGhACAAGGC.XGGAJHAG.EAHH.NADF..hAAA.YHFG.hBAA...,2,-40,-11,29
KYRPGaeBNCJLXEAdMVOQTbUgfSIcWHZDF,MACAVBDB...OEFCQGCDUCCH.SGGH..hAAAIGBBHDAEDEFAFAGAhAAAKABDRFDF.aFFGBGGANAIACFAD.hACAJBADLADCAFCAdBFA.......hABA......hBAA...,2,-32,-6,26
DEGdVLecfgPTRMHJSCIYWaZABUbQKNFOX,BBHGUCGAKGGBFEBHDDDHGEDC..dCEBLDAA..eFHFhAAA..fAGBhAAAPHDCMABASABBhADACDGA.YFAFaFEGAAIDQBBFXBDBcGBFhAEA...hAFA.gGBA.,2,-30,-17,13
MOUeVQgSPICNfDFcEARBKXTYabWdGZJLH,RFBHBEGCKHFE...TECEaAFD..dEFEGAAFZCAELCEAOBDEVGAEhAAA..SAHBhAAAIGGCNEIGDDID.hABAEEAHAEAB...YABAbAGB..JFEB.hADAMDAG..eEHDhAEA...,2,-27,-8,19
bcFBgPKGeQJRDIUMOZSaWfNXYHTCdELVA,FDBBBAAEKACCGGEH.eBFDJFFC.DAFGUCFBZEAC....SDHFhACAaGBD...hAAAfAHCXBAGTECHhABACDCCdBCFEEEEAIFA.gGBBRAEE..hADAIGAC.OGEChAGA.,2,-40,-13,27
CIabeWNPHQUTBcJfZFODXRgMEdYSKGLVA,CCAFaGCA..eAFE..NIDB.QGEGBGBD.JBFDFDBC.DABDRFBFEDHHhAAAdEFBKFGDLABBhADAABIB...IDDBhAEAPAEH.UGGC..fACC.hAIAOAGD.MFAFhAAASEBF.,1,-8,-38,30
AcHXZODQCbfgFKLEBVNSeMYaUTGdJRWIP,HFABOHFCDDDD.CCBC...fGDDFGGAKCEALADEBAGBSEEGhAAA.eBHHhABAaCGATDGEJCDCRABFPEAHhADAAGFF..XAACZFBBQFGEEEEHMIFEhABA......hACA...,2,-28,-3,25
MZEYeKLWPCIUbNcDVSFAOQJRdHBXTGfag,OBDDJFACHAECBGCEGCAB..aACHMHEEEAGD.KAAELHFAhAAA.CDBG.bDFEDFEE.SHAGhABAACHGdFFF.TFGAhADAfHADZEAE.eACCPCHD..hAEA......hAFA...,2,-21,-12,9
DfUXKZOMPegIJECGdTFLcBHSVANaWbRYQ,aFBFRCECDAFD..UDEAKGBAZAAG..MEIH.eABHJFFGGCCAhAAAFBHFBAEE.HGECAAHG..hAAA.NDDC...bCAHfHABhABA..OHCE.IHHChABACDAD.dGAG..hACA...,1,-19,-33,14
HJgNIMTdFWYbVaPDQKcSeGUCBOELZXRfA,JCCC..NDEF.MBFAdGEFFBAD....bEADaFCD..DIDCKDBAeFGBhAAACAGC.BFEALHFGhAAARCGDAACH.HFAH.gAEDhABAIBAG..WDAFPEFA..hACASEEC.hADA...,2,-33,-24,9
MGSeHPBAWdRbYIETgONULVKZJDXcCQFaf,RAAE..bCCCEGAA.OBEHLACE.KFGCZBFBDGCCCFFC.FGHD.MFCAhAAASGHB.eHEGhAAABCHBAAFCdFCEIBDEhABATDACgGEF..NIAF.JHAE.hACAQBFE.hADA...,2,-22,-13,9
ERWKGcXLgdOACfBIYHVDMUZQabJePSTNF,CAGDBCFCHEDBDHBEUDFCZECA...QFBAJACH.eACGSEABhAAAFHGGEBAB.RGFAKDGCXCCChAAA.LFAFhABAdBAGAEIF....IAGAMDIF.aHCE.hAEA......hAFA...,1,-5,-43,38
JdeBKRSCHZEfXPacMNGgQWIVTbAOFDYLU,FDEEDBBGUEADdDCCKBBA..RBEAHFFAZGCE..EFAF..XDFAhAAA.aGDDMDIB.GADHhAAAQCABIHGHhABATGACABIDODGDYEDD....hABA......hACA...,2,-27,-23,4
ATcISFBOCgZdYQXVPHeRKDbGaENUfLMWJ,TDBBSGBC.BFEBCADDdBFF..QCECVGAC.HAAFhAAAKFFCDEEEaGGFEDCFUAAHMDAHhACAAGDG.FCHFOHDEhABAgGEG.YHAG..eDFEhAEA......hAFA...,2,-30,-4,26
KcMPVEbFJfZBYIRTGOedUAaDWNLSCHXQg,aCAFDGBDLBDHHAAGQDCCKFGE.MEHHEHCCFCHBZGCE..BFBGhAAARBBD.TAGEeFEBdBFGhAAAAEAHSCEGCGCF.hABA.XDAHcADFbFFHfAGB.hABAIHHE..hACA...,1,7,-30,37
ZKVcFWQbaSCEGITJMRUPLNgXedfYHDABO,BFGDZEBEKFGEFECC..QCBFaHEC.CHAC.GCDB.ICBGhAAAMFFFRABCUCGB.hABALAEHNACD.XGGAhAAAeFBDfAHGDHCEOCAH..WBBEhAIA.EGHHTAGChABA...,2,-26,-18,8
UKePBLgOGNAfSbVDXYcZERdWIFHMCTaJQ,SAFDVCFC.DCAAXEBDZDBH.EFHHdGGG.FDDCHACFCHEA.hAAAaBFGQDFGhABAKCAHPDEBBHCC.OEABhACANIAFAHFG...YBBCWEAD..IABHhAAAMDIF....hAEA...,2,-22,-21,1
RDaefcFNCJGMZdLYQBAPUIOTHVSEKWgXb,UCCETGDCHBFA.EGHDKDAD...XDBFDAECaAAA..eDFDhADAFFGACACHMIBEdGBCLDFChAAABGEEAHDC.OBFGhABASFBE....bBBE.fFFGhACA....hAEA...,2,-25,-24,1
gDdXeIPCLSZAVbGJKfUQcFOEWBMRHaYTN,GFDBKGFGQABGFAAHOEBGBFCB.MDDAHCDG.aHCG..NBEH.hAAADGID.eBHFCEEDSEGBhADAACDGJADA.UGADhAEAEGAB.....WDHB.....hABA......hACA...,1,-20,-32,12
aSYRGJbTAQPDZefHFgcdBXWECIVLOMNUK,QEGGZFGFeFDFHFAFFFBBdAGCBCFH.EAFCCCDDLFDB.OBADhAAAMACEKDDD.SBCAhAAARACG.JCBFhABA.AFIHDIEGcGFHXFEH....hAIA..WAHH.NEAAaCCHhABA..,1,-18,-20,2
gOaIXdBVLYTKCRfHPecUEGMDSQJZFAbNW,...NACG.gGFC.OHBGIHHBdBAABCFELEEHhAAATDGFCHBARAGBHEBC.hAAAeAEBcDCBEFABDCGBhABASAHFJEGBAFIDaBDHXFAG...hADAKACG.fFDFhABA..,2,-14,-12,2
HaLGfgcRYPWIXUDEbMVFOeNdACKJBZTQS,KFACJADHBFEAZDCB..QCACHGBELFAEGAAD..fGFFhAAARGCC..PEFAhAAAIBAHDGIBEAGDhABAbAEF.MAIDFCBDNDIEAHADSGGF..hADAaAHH.YEEChABA...,1,-10,-27,17
OUYTgKVcaBeRNQMCXJDHWGSPZEIdFLfAb,UBFBTCBCKEBD..aBFCBHFB.REDH.MDEG.CAAG.JACFHGEE.hAAASEEGEHAC.hABAIGBGdAGBFFGGAAEDOECFhABA.gEGB..eBBDhADANIABDFAFWDFA..PACGhAGA.,2,-37,-18,19
FPQKVNdIWCRbBMATJYXHfDgeGSOLUZacE,TDGCXDCC.DDFCeABD.GEADLAADZGAAEADAFFCEKHEGdDDBCHHChAAARFGBBEAEABGF.JHBGfFFBhACA.SGDEhADAUAGDPFAB...NCBD...hACA......hADA...,1,-4,-23,19
ISUTKOLDfZHNgceaFAbMQdPEBYGVXWCJR,MBBHdDEBBBEHGDBA..VDAFCDECREFCUGDHKHGC..LFEGhAAADADEZAEE.HGBE..NCAE.hAAAgACF.hABAeAGBaHGGAAIB.........hABA......hACA...,1,-26,-27,1
NgXMIYbLOUPefZVDBAJWFcEdTSRHaKQGC,FDFFdACBSGEARBDCHFAHKCBF.GBEC.CGCD.XGGG.MAIHhAAAIGAHLABGhACAPBAB.ZFGBBFHHhADAJDDHEAFEaDDHNAHE..gDGC..hAAA......hABA...,1,-13,-21,8
QRPCGIYHgOaFVZfTLSKcebXNWDEdABJUM,UCECMEECREBACDHH..GGBDHADEOGFC.FAHFVABEZABDLGAGhAAAKFFH..bEACNDDB.hABA.DFGEdAHE.AGIBBHGHhAAA...JBAH.......hAFA......hAGA...,2,-26,-18,8
WRPCGDcdXLMfSagHbFeKJINEYVAOZUTQB,ZDDHQEDEBCHBRACGGCAAdBAEMIEA...aAEAHGFA.FHBGKAHFhAAA.JCCDIAHHhAAA.EDFCACGBOFFGhABA.WEBDCFCHDGAB..cACAfEHChABASDGA...hACA...,2,-23,-22,1
VNSUCaKDHdERABQLIbeZFcPYgOfTJWGXM,QEAELEBDeEEDFCDE....PBACgBBH.TGGBhAAAJHEGGCFC.hABAXAGEVCFASAEChACAaHAADABGEEHHAIEEBAHCIAEBcFCHfEEGhAAANDACKFFE...hADA...,1,-10,-16,6
JGAaBXOFDWREHMYPLcINbQfUTSegZdVCK,aCBBOAEE.DFIFRAFDHDDF.MBACLABD.IEEGhAAANEHEQFADUFAHeEGBhADAdAECCDCEKGEBAAIDBHDE..hAEAWBHBPCEA.fCCD..hAFA...SGGDhAHA.,1,-15,-31,16
MJKRVgaDfGTdSbUNZHCWEPBLIOeQAXFYc,FBEAMDEFKHDCRBAG....aGBEDACB.GBAGSGFBUEDAHDFBhAAACFCF..EBFABAGEOEHFhAAAeFABAHEH....hABAcBGEJCHF.fAEHdGHANECA.WEAChABA......hACA...,1,-17,-38,21
IOKCHNbGJQEaWZfSTVPRAYeXLgUDFMcBd,eAEEXCBCLCDADGBB.FGFGBAGBdDBEOCHDCHDF..HECChAAAGAAFQFGBhABAaHACZECDSGEDhAAATCEGVABAAHHB.UCGE.IHFC.NEAA.EEFEhABA...WDAD.hAEA...,1,-1,-17,16
SGVCXTLEIRPDFHQgbBdMUfeaWZJcKYANO,SGFECBGFLFCDRDDGDACD.HCFC.QDABBABDUBDDaFCBJFHBhAAAKAFF..AHAGGCAAhACAXGEG.EBDHFDHBdEEHhAAA.MIFGeGDEcGAHOADG..IBADhABA....hADA...,1,-13,-21,8
IVDYdLQOAHbTfFSgKBCJUcNGXERZaePMW,HFDBTFGBFGBG.KDFABDDGUCCEGADF.XFDGRAFE.eBBFhAAAMBAB.VFGBDAIDdGADhABA.OHECABBDfEAAhAAACEAG..JCFB......hACA......hADA...,2,-26,-16,10
BbRJMPWZDfcIKTNaSLGCFQYEVOAUegdHX,eFEBdDBDBHDGRBBA.MACCZFFFDCFC....IBGAKADEaDGCLAHBhAAAFFGF.EDDCOEDDhAAA.UBABgGAGhABAbDFA..PFBBfFBD.hABA..cCAHSCFGhAGACAFA,1,-31,-36,5
YFefaMGWQKTcdPUgDAVCIRBSbJNOXLZHE,CGCGBGAG.JBEEOADF.LBHFEDAAFEDF.eCFH..aEHHMCBDhAAA.QDCHhABAKAACdHDH.UGFDACCGREBD.NIAD.hACAZFFH..fFAE..WDDEhADA......hAEA...,1,-13,-41,28
ISREQYdBHDUAWXLKZFGVPeaONcCJgbTMf,LBGFKHGCZEDFGAAAeEDHOBAB.CCHG.gADD.hAAAMIACIFAE.hAAASFFCEBGHdGAFBDGHhACADIAEAHAGWFAEXCBHFFFEaDDANEIC..cBDFhABA.....hAFA...,2,-24,-17,7
gVOZXbPRASdTCJaLWIMNFBDcKQGYfHUeE,SDAGCBCHLGDC.MDFCFFBGBEFB..DAIFQAEEhAAAGDCCfEHEeDAGECHD.hABAOGEC.XBCChAAAPHACAFIFdHAHaAGENABDcAFDKCDH..YFHFhACA...hAGA...,2,-25,-15,10
eBRXLEKbFHfTJOZCQcIPMAaSVgdYGDNWU,VCFHdDABGDGG.DGECUBBDBDDFLEAGKHAA.FHFA.HEDFhAAATACHOHACZAFGCAACQAGAhABA.IBEAhACAAEEEaGCF.SGAENFAB...hACA..eDHH..hADA...,1,-9,-33,24
EBAVSQTKbaGRMZcgHCXUOLDFIeNdWfJPY,QCCEKCDGGFCFMDIFZAFAHEGD.CGCHOABGDEACFADG..eAHHhAAAdFEEJEBD..EGAGBAAGhAGASFFEaHAC.hAHARABD..XCFDIDFEfAFAhABAAIDA......hAHA...,1,-13,-22,9
HOIJRYgLZNdSaePBGWXVfFDEbAcUMKQTC,MCBCKCCACFAC.HBFD.OEEHJFDG..RBEA.LGAEZBAB.NDICdDBFhAAAeHEEBADH.XGGDhABAFADGDIBG..EGAHAICE.hACA........cGGA.hADA......hAFA...,1,-21,-43,22
JgIGLeXBcdFQKHbPDZCOAafUSWNYRTMVE,UEDDSEDG..NAIA.RCADMAFG.EBGGIDAF.GBCDhAAAeACDBGGBdFAAFHFEhABAKDGH.bGCADEHFCAEGAAADaHAEhACA.....fAGE.TGDGhADA....hAEA...,2,-30,-26,4
IVUECHJPYSRbfMdXATBGDLZKcWeFNagOQ,GDDAZEFAKDDF.eBFFFGAE.aECB..OCADVABE.UGEGHGFE.JFADhAAA..SCFBhAAARDGFMICAAEACDBIDLABEhAFA...NAIAIAGDEBADCAFC....hBAA......hBCA...,1,4,-35,39
NbcAaKgLVPSHeDGfFQUJORICETBdZMYXW,KBDCLDDC.SABBHFFCDBGHFDABJHBE.OAAG.CCCH.EBGBhAAABDHBdDAEZEEF.MFIDhADAXGAE..hAEA..NAEFABBBgDEEPFBC.fAGBhAFA....hAIA...,2,-42,-19,23
NQLOIMVSJFecdRWYfHEUXPTGbgDCBaAZK,ZGAGQCCFOAFE.MFDF..VDFHFEEHeADAdDAHRABG...fEAChAAAEECA.UBGBhABAPFHF.bFDHCHGEAFHHhACA.KHEA.IHBFSCGE..WEHBhADA.....hAAA...,2,-24,-12,12
KfMOPVHARIcCTYeXFJLgSbWQEZGBdNaDU,RGBCCCAE.eDFBFAGELEBD..SCCFQEGBEEDBZEEHdAEBhAAADEADKCFC.MAIHOCCFhAAAPFHFAHHD.IACEhABA..TCGEYHDGXABBhAEA.gGCBhAFA...,1,-12,-33,21
DbKWcZLONHCBGEAUXVSJfPdQYgeIFaTRM,XFCASGAA..JDFFdDCC.QABDeABFFBGF.aADAMIBAhAAAKGGEZBGDLADDOHFChAAACFHBBHHEGEDCEAECAEBB.hABA....fECF...hAGA......hAHA...,2,-25,-16,9
BJcQXWRZdfHDIAVKSMbTGFEUNYCgeLaOP,SAHFMCFEGEBAUGAECBAF.LFGF.ODEFPDFBBHHEhAAAJCDB.QBABhABAREGF.dAFEfADAhAAAIDCFKCHHTGDBEGDF.YAFAaEBC.hACA.XADCHCAHAIHC.hABA...,1,-1,-16,15
UJfeEPQLOVRBaNMKZGADFHIXYcdWbSCgT,FADDXABEdFFF..SCAGCGFB.UBFFJAEEEEDH.LHCChAAAVGAG.BCGGMEDEhAAAGCAADIFC.HEGHhABAIBBHWCCA.........hACA......hAEA...,2,-38,-23,15
EVCQRaHZJTgIXBebFdWAMOGNPSKYLDfUc,MAEBOBEBGAFE..NBAG.KBAGLGFCUDBCEHBCCBGG..QCBEhAAARFFGZFDD.TDFHhABA..IHFHhAAABFBDeHACbFACdBHEAEIHSFDBDABG..hACA.fAHEhADA.aBBG.,1,-5,-27,22
MSJFOdRPUBeZYKaGDTIWgcbAXNfQECLVH,XGEBQCCBLCCAMFEB..FCGDdDGERDAFUFFFBDAEZGBAKADD.hAAADGAH...IBAFhAAAgAGEAEFDEECCCAEBSCFFhABAOAEE.......hABA......hACA...,2,-32,-20,12
IUMfdEGWPVHOZDNJCQTFSAeLaRKbYcgBX,LCCEKAAD..bFCE..gFABBAEAUDBEMFFH.EDHBhAAAGDEF.PAHFhABAOABG.DIAGNHAB.CHHDTDDEhAFAABCA.aAHBcGGHIGDF.dGGBhAGAWDAD....hACA...,1,-7,-39,32
IVNHfTCDGFMdbXPBYcSgZQRJUaLeOWAEK,EBAFKHFE....IFCBHBEECDHAGFAB.FFFAdCCG.bAGDXCCHhAAABFFE.SAEEhABAQAAFJHDGLFADhABA.WADCABIBfCBCDEGCMEED.hAIA.cGBC.RBEF.hBEAaHAC..,1,-12,-27,15
XcPKgRUMIbAFaZOdBDNHCYSWTJEQLVGef,ZEGHdECEDEAHCEEB...SBBGTDBD..EAAFQEGBhAAALFABeAEFXADAPAHDhAAAKHAERFEB.UBGGbFCHABCChACAOCDF.BDAB......hABA......hACA...,1,-15,-23,8
PLfMbQHVcJdNGIeUSRAFTWOKCgaZXDYEB,FHFETBAFKFCD...CEAFZBFFDEHBBACG.LAEBMFIFQEDBhAAAHDAH.JHDCdAGFIAHChABASFFFAGAFODCAhACAaDDC..XBAGPFGD..fADHhADAcGCD.NECA..hAAA...,2,-42,-8,34
fZYJHPXACKIdFNgSQWDLGVOMUcTRbeEBa,CAHGdDFEFDBCSADH.DFBFVCFF.UGGFRAABEDDE..BGBBhAAAZFCFJHFEHBBC.AEIDKAEChABA..gAGEhAAALFCHMEEH..cEGD...hACAbDAG.fCGBhACA..,2,-31,-15,16
fAVZMUeXRSPCcBbGOLHTgEDWFJKQINYda,MDABeACGRFCB..CBFEBACHOFFALAHDHCBBEDDEDEGB..FBGGJECBhAAAKBAD.QGGBhAAA..NCEGdFHEAAGEZFAHhABASBAB...PHEE.hAEAbFAD.....hAFA...,2,-31,-7,24
SQAIJPZWVCacdYbNXHBDOeGfgFKLEMTUR,JFEHZFAECEGG..dDCH....NADE.BCGDDAED.eAADGGCDFGBDKAEEhABALAFC.MBAFhAAA..UGGGRBFEACCD.IAHFhACA..WFFGaDFH...YCBFhABAXEBG.fDHAhADA,2,-40,-40,0
FZGCBUJRaNTDgMOQKPbIfEWLHeSAcXVYd,VEBBFBGBCCEF..BCCDUEGB..RFBC...TBBBDEBG..MHEEhAAAKGAD....PBEGhAAA..IDHGhABAEHGA.LACGeHDAAADDcDDHdDAGJFFANIAF.hABA.OCAH..hACA.fGDHSAGE,1,-14,-33,19
QPLHXIEeZGbVWDaBNYSOgfMFKJUdCcART,QBDELAFGHCGBEDBFGFADVGCGDCBBBEHA..SDCDhAAAOAAFMGFEFHGGKDDGhABAdBHAAEFCTACAIHAAhAAAeEABbAFF..aFFCYHEG.fACFhACA.CEEG..hACA...,1,3,-11,14
ARWFGZLITBXVDUKcMCSdNgbaeEJOPQYHf,FBHFGABHLFHFBCHHDFIBKBAD...MBGBdBDH....gDDBhAAAaEACJFEF.OGCEhABA..QCAEhAAAfDAHAHCCZFAETCFEXGGDUGAGSGFBhACANIAHEDDA.YEAGhADA,1,-15,-32,17
WSBcRLdFHGbZVeXOQUICTDaJNfgAKYMPE,KDAHMEHHEDEABBAD.REDF.FHECGCADZEGD..eAAGOBEEUAFGCEAE.hAAA.DGFHJECH...hABA.NCIA.AACG...PHBChACASCCG.dBHAbDFF.QFABhADAIFFAaADD..hAIA...,2,-33,-9,24
TDGMPObHKFXedScVIJRZCfWgUaYQBELNA,DBCCGDABOFDHKAAGFGBH..dCCD.SGFAIFEDRCGDCAEE..hAAA....fAGChAAAUACGaGGEBAHAhAFAEEFCACAG.MBFHHDAE.cGAD.ZCFAgGCBhAGA...hABA...,2,-32,-22,10
QLKEdRFgBWTPeVICJYaMOAXbfZcHNDUSG,XADAZAECHDACUABFGEEDQFAHLEAFECCCdGFBFEGABGBE.hAAATGDBeEDHCDFCaAAAACAH.hACA....fDEFhADADIAC.SGHD..KHDAhAFA......hAGA...,1,-10,-13,3
LdBRJZaGTQXWcVeFSKYbMPHEgOADfCIUN,CAEAUGDEdEHCBCCAZCFEGACA..QDEF..cFAHhAAAeFCFFEAH.SAAHhAAAKGFBMBFAEEFCACFCDIFGhACA..IHHCLAHDJCBFaFGH...hABAWFDH....hADA...,2,-34,-22,12
CagLDKAFBcYGfXUOMQZRbSTdVIeENWPJH,FDCHBGCDGADBUBEF.MCGDQFDB.RAAA.SHCEhAAA.dCBFIGHBhAAAeEFDEBHHNBHC.JEAHHDAACFDHLFHFhABAAFAF.fABFXGFH..OHAChABA....hADA...,1,-6,-27,21
CgbHXSGJcEQRZMFDKAdTeVfBPLNIOaYUW,eFBHVDEF.BAGELABAOCCEUGCC..CABAHFEHGAGCEADARCCFFHGAhAAADGDH.AFBC..dCAFTDFGhAAA..fAFChACANBAC.IFHFaBGC..YEHBhABA..WFADhADA...,1,-19,-20,1
KGeVCAXPSUBbfMHDQgRNLOWcYdEZIJTaF,XAEBSHBAUDFBBFHH...MBEDDGFHQDAFhAAARFBALHEGOCAC..hAAAcDCDECFHZAGHIAHAhABAaAEFFACDeEFFAGHAfBDC.HGBAhACA.gABAhBAA...,2,-31,-6,25
UMfNLbHVWDgeJTRIQKOaYGdXcPBFCEZAS,SBAHMIFALBACHDECDDFCeAFG.TFDCIFBB.KGGAhAAAaACFGEEHXEADhAAABAHHCGHGAAHEUCCH.fHAHhABAbCCG.gGCH.JCABhACA..OHDE.hADAYCHHdAGC,1,-1,-12,11
PSbZRGaIgDfUCLXANBMWKdEQTeYHcFJOV,BBEC.MEFAKFBCdCDD.EHBATBAGHFFCFAGAOAGF.SFGEhAAAbABGZDEE.GDBChABAIDADDGHFUGDDhACACFAD.ADEE..NADCeFAD..cGDA.hAEA......hAFA...,1,-14,-21,7
LYSeKbgZcTCBOdRGVFWENafIMHQJDPUAX,LHCCeHAAKCCDZFEECHAFBBBD..RCFFFAEFECAD....aGHFMCBFhAAAQDGADFIB.AFGH.hAAASECA.hABA.bDDFTAGCdAFA...WHEAfECChACAIACA...hADA...,2,-31,-29,2
ITQWbNGUFRdDJOfKVCEMZPLegSXHYcAaB,BAFCTDFBQFFH..bFFGNDEC.FBAD.dAFGOECDKDCECFDFZGBChAAALBBB.gADDhAAASHFA.hABAYEADAHBFICAF.UBGEDAIFJABA.hACA......hAHA...,2,-25,-11,14
IAgPQEWaVZYJOdTDSGbeRXMLUcFfBHKCN,QDDAEHGC.aDACVCBE.ZCGHOFAEdGABDGFHGAAB.hAAAeHFAMBAAUEGDfAFAhABABAHHHGCCCDAGABIH.hACAWBDA..JDFF.SGDD.hAAAbEBA.....hABA...,1,-12,-14,2
AYBbRGMadLKDFWZQEJfOVecCUNXIPSHTg,BGDARFBDMEFGLBCF.KGHDDEDBFBGCZACG.EGFCOEFD..hAAAeCADCEDA.XAGBhAAASAFC.HEAFhABAABACbFDDaCFCdCDH.WFFCfCAA..hACA......hADA...,2,-36,-16,20
JQXKILHSWgbaVYBCUDZFfTEeGPONAdMRc,dBFHRCGDQGAHKDHBHBBG..SGEF..bEDBaDEDBCEDhAAADDAGFGBFEEAFeFHH.hAAAPABCAHFBMEAFJFFFIGHEhABALDCFWDGFYAEC..CEBH.hACAfBAE.hADA...,2,-28,1,29
RbgaOXINcTAePBVLEGQMFSDfCJHYWUZdK,BHBDVAAA.EDGEGFCHFGEA.DCEH..CFAFHBEHUDAHKBHFRCCH..aAAGhADAOBFF..IAHGhAEATGAHAFFEeBBChAFALHFCSHCEJDHD.ZEEC....hAGA......hBBA...,2,-17,-17,0
CQIWdagGeUbEcLBVfYAMHSOPDTXFRNKZJ,SGFDDDAAFGFE.RAFFZBCFJHBG...CGHF.QBFAdEGHGEADUAAGhADAEAAD..BCHG.hAEA.fCEGhAFAAIAEMACG.HEBG..OHAAXEGA..hAGA.KBHBaBEH...hAHA...,1,-16,-30,14
fHadUBPGcQFCVKbYZOLNWIMJAeERTSXDg,EGBBTFCHDGGB..HDCCUCEHGBFGFCHBKFAEZAAF.OEHBLAEChAAA..NCAA.MDAC.hACAAIAERFFFgEBGhADAdABDBHHH...PAHFCFEE......hAEA......hAFA...,1,-10,-22,12
ZdGNMSAJVYHcPfDbaWeKCOLgFRXBQTEIU,JEEEHDAE...PHDEDABF..aGCGKFGFLCEEFBABBAFCEAHBUBGAhAAA.ZECEdADDMHAAhABAAACF..VFGB..hAAAfEGBeEAHgGDARCCE.TDCChAEAIHHD...hAGA...,2,-27,-11,16
faZMUEVLXRIeDbYdQPJFOBKWcTAgGSCHN,GDEACEAHHCFH.aEBHMDACUCCFLHAE.RFEG.DFADdAGDQAEEhAAA.FHBABHEGhAAAKHGCTDGEAAEGSBAGhABAfCACEECB.IABBeBBE...hACA.....YFHBhADA,2,-29,-10,19
QCEDIBHRLKASXFUfVMPgZNJYWaedObcGT,FDCDVCBDMEHH.ZAEBJFFA....aDAFOBAB.GGCFhAAATGDDQBGEhABADFGHBCGCLAACADFFSAGChACAXEEFfFABNCIG.YBBChADAdGBCCAHHIBBD..hAEA...,2,-27,-10,17
fgCDQcTKSIOEUJNaeVBGYHLZAFPWbRXdM,FCDF..bBGDRFEEMFBCCACD..DGAD.QBDDKACFOBGFEHGAUGABhAAA..aGCGBHFGhABAHAABAHID.XEABhAAAdAEH.cFEFSDAGNADB.....hAIA......hBAA...,2,-36,-16,20
fGUSNAEPgMcDYIaLKOVBTedRZWQbJXCFH,EDCEMDDDDHFE..aAAAOAEBBHGF..dBDFZFAD.QAADhAAAJAGFFFAE.HAFBGEECNIEFAFEC.hACA....PHAAhADAgDGC.IDADKCEFeEHDWFDGhADACBBDSEAC.hAFA...,2,-22,-20,2
AMVSEdUNTWIHeQKDZXgYOcLfPCbJGaRFB,SACAdGAFUBBF...TEGBIEFFQAGFDDEB.XECEhAAAOAEGLBEGhAAAPCADCCCE.JHFERGEABDGChABAMAID.EGCBHDACKHAG.ZDGFYCEHfFDGhABA.....hACA...,1,-10,-11,1
cJdGTKfRVOaXHELYgFbQCSDWeUANIMBZP,MBAAZEGFJBFAdGDE.GCFGKDAG..RFDE.ODCBHBCCLAAChAEAFGADCEAD.DDFDeBCA.AAAEBGHChACATGAA.aDHFXAGBhADA.EHFE.......hAFA......hAGA...,1,-19,-28,9
dVBbPWcSXegLDfKOEIaRTJCMNFHQGYZUA,VDFBBDCG....bBBA..PABG..SBAChAAAXFCALCECDEHDKGBEOAFEhABAIAHHaGFFJCFDhACACGBGMFIBFHDE.HCCF..YEAAABBBWAAD.hAFA..cGAC.hAGA...,1,-21,-24,3
GHAeMPCUcgKJSLfRbZXNOVTDIFEQYdWBa,MBIHCDEAUADAKFHD.LBAARABH..ZAGBOEDEDFHH..EFBGdGDHhAAA.BAFFHGAAeAEDhABA..PHEEJHAAfAGChACA.bDABNBAAIFFF.hADA.FCGDWEHBADDBSGGDhAIA,1,-7,-43,36
aLQBdAcDKbgVZNHXMCFPYTURSIWGEOJfe,KBAHVFEGZDEA.HFADCBAE.FGGF....PCCCUFDHSCDFhAAA.GADDhABAJBGFaEAHBEACAHBBDIECNCIA.XEBFhAAAMCCF.....YADEhABA.IAHG.hACAWFCHOHCE,1,-6,-50,44
NAWgBdaXVcPSTJZRUFICQKbDfeHGYLMEO,BHAA.dADBVEFE.SBGBTDDARCGF.FDCG..CAHCKBFHDFBAHAAHhAAAGBADMADAEGFA.hAAAOFEB.AAIDaBEChACA..cEBAJHAEIHHH...hABA......hACA...,2,-34,-14,20
VPWYedKHOIAJUBXNFRgMfaQDSGELTCZbc,JACHBCGC.FEHDMFFB..QECADGIFGAEGEADDLEBAhAAAZAAF..VGEG..hACAWCHDeFABHGBEIAHAhAEAABIFXBADRCEB.aEGHCCHA.....hAFA......hAGA...,2,-19,-18,1
YbgUAGeJHDNQTSBMIFdVOcPWfZCLXEKRa,JBHHHCBC.DECHQDCDBBADFADF.dBEFOFEG..PEHBhAAAZBFALHBCKFCHRBAFaGGH.hAAA...gGGEhABAAGAHNACH.MEEEIGEDWAFE...CHAH.hABA......hAHA...,2,-26,-19,7
MIQdZNBGVUbKFJgXPAOWfYLRDHeTaESCc,OCEB..fBBELDCFRDFADFIHeBAAECFF...SFHHhAAACBDCMFFHdAGBNHBBBADBhABAGDAC..bAFFFEGGhAAA.gFCAAIAA...WHBA.hACA......hAIA...,2,-27,-21,6
aVCQNPJWgeRdLbUTYSOZDXEAMcIfHGKBF,MGEG..IHDCHEBDBBCCFADAaHAGVCDB..QDGDhAAA.JCAGgAGEhAAAdECHLDEHTCAAhABAOAGBDFIHAAFBfHGDCHEFNEAC.WBAC.hACA......hADA...,2,-24,-14,10
SGeULfVPFAagYRcQEdTNDOCJWKZXBMbHI,aBGHREEAQAAE.dHADDGEF.JFBGKDDDZCEFBBEHHCBAGDAGhAAAeFHHLAEC.hADA.VAGFACHG.gGDEhAEAEABG.NDIACHGAMDAD.IHFChAAA...fDHChADA.,2,-28,-9,19
XIcSgNLbKaROMGYPZBeHdCTUFQWAVEJfD,EAECDAEG....IFDCSFEF.LCBDaBHH.MEEGhAAAPAAGBAHF.eCEAhABAdDCHCBFHUGBBFEHFABEAfGGChACA.XABEgGFENEAC.KHAEhAHA.ODBH..hAIA...,1,-12,-41,29
eQKHMNCZJGgbDXWBLROEYcFISAPTafdVU,aGHDdCBHUFGH.KAFGHFBG.CHFEGABGDHCC.BAEAREBC.ODABhAAAEBEB.FDEHAFFF.TCFEhABAeFAB...NIAH.JAAGhAAA..XFGFLAHBIBHHSHFAhAEA.fDGGhAFA..,1,-20,-26,6
OXEUGBSQAKLVCNMFeRgaIYJDZfcPTWbdH,VFBFMBIHRDAB....aBAHJHBAZBCH......fGEBhAAATGFHdAFAOBBGhABAEDFFBFDBADGCKCEFCBBGeEHDhAAAIDCDDAHH...cAFA..WAHHhABAHEFA.....hACA...,2,-27,-23,4
aCcDKeLfTgROFNJASPMGHZBEUIWVbYdXQ,MABCZCADEGADUCCH..VBGDdBHE..aGHBDEEC.LACC.hAAA.gFDAhAFARGFGOAABJGBAAGCBSBFGhAGA..PFDGBHABbEFF.XEBChAHACDCHKCDC.....hABA...,2,-18,-18,0
ACdBWJOVfcgSebKMaEIDXGTYPNQZLHURF,BDAEJBBD.ODFE..fGAFSCCHeCFBKAAGMFFBhAAAaHEE..DIAEGFABhACATDDHPAFFZDGDLAFAhAAAUGGFAAIBCBHDdEAD.WACB.....hADA......hAEA...,2,-26,-15,11
WTcZXKDaLMdJFEeNbVfSUCBOAPRgHGIQY,RBEAHBGHQCBFTDBGZBDHDHGA.LAFD.MDAFFHAENGDHfFGChAAA.CGEHAABGPEFAhAAA..IGBEhADAWBAF.KBBFJHDC.EFBA...eAFEhABASHAGBEDB..hAEA...,2,-17,-15,2
XZfSgOBLHQWVJDIeYaEUMAPCKcdFNRGTb,KBFEFFDARCCEGCAF..XEBDSEFBBDAFHFDH.QACAhAAAJBAGDAGA.IHGHhABAeBFC.aCHBEGHDAGAAPHAChACACHFE..dHCH.NAAB.....hAFA......hBAA...,1,-7,-34,27
gLRHGcdFMJXPQeZTUVCNAaIWfEObDKBYS,aADC..IHDBEBABDIEC.BFGE.SFBFLDEDGCBAhAAAdBCFFCAD.MBHD.JFABhABAXAFEeEHHTGCChACACAAAADCEOFDCKFFE.gCEC.cCGEhAAA....hACA...,1,-8,-43,35
UYcbWVNPFLAfdJeHXDGTaKROSEgBQIMZC,JDEDeAEDHBCGDDDFGGDHKGFF..RFAF.SABGEABA.QAFEhAAAMDDDCDBB.UFAFhACA..bAGH..WEFEhADANEHG..FAFFAIAEXEECaAABBEAC...hAEA......hAIA...,2,-19,-17,2
MUbdGTQgBJDCaKVIXWcNYEHfeFOLRPSZA,MFCDUEGEGECD.QABEBAFGJCCEDGEGCBGD.KHDA..VFADhAAA..XDBChAAANHDDHCEE.FHGC.OEEEhABALAECRABA.SDBEAFDHdGAE..aAHBhACAWBADEDHD....hABA...,2,-22,-14,8
XBZOfWbSENYaAgDCPFKHVJecLURMTQIdG,CGDFKHCCHEFHeFECUDAAREAB...MBAAQBDAdHCDBCGAOAHBhAAA...bABDEGAD.hABANAEA.AADFDEEG.FGGGJFHDhAAA............hABA......hACA...,2,-34,-20,14
TOXcEFUBZQIaKDWVgeNGYCJPHbRLASMfd,SADDMGDAdDFE.OFECEHCCBBGA.ZBAHIHEG.KBAHhAAADFBD.VACGeAEC.hAAANEEHGCBECHHC.PAHDhABA..........hACA......hAEA...,1,-24,-44,20
gSUNTOERMbeFfLcPQCJZXBYDKVGWAdaIH,aFDAHEFF.SCFEUCBA.OAACEHBAMAFEFECBLHAGhAAA.PCCCCEHAXBDDhAAABFADDACCVGFAAIEAdFHEhAFANDAG..RBFE..fACF...hAGA......hAHA...,2,-16,-15,1
VLZNfERQcATIeaWMbgCGFXdBPKOUYSHDJ,TCBDaDCC..MDFACAAFGGCHFGEC.BBGBOEABUDGAHFBBDAEFLFAChACAZEDGEBEFQGGChAAAAEFF.ICADhABA.eABAgGGB.XGADhADAKBGC...SBBChAFA,2,-22,-12,10
gcDPIKXHEOCaVGZTSWbYdUFQJMLANfReB,RFCFBHFEDEBE.KAFBHAGD.CGFE.VACFGABDZFCH...SCFDhAAA..WEHDYFHHhABAUDEA..FBADJCAChACAAFAC.eFAH..PAHHEHEGaEEC...hAAA......hABA...,1,0,-43,43
ZISFYGNbaQMdfLREVKUHgTXCBWAODPJec,OBDBJEEDZCFH.FCBBGBCE..aHEAQGACMGEG.dAAFLFCHhAAARAFG.KEFCUGGEhADAHAFEXEAEhAEABCGHAHHHDFIFeHDASHAC.NABHECEH.hAFA......hAHA...,2,-14,-10,4
QRHWaZBIdegLKVSXbfYCFMUATcEODPJNG,TBGCEBAHDHDG...JDCBGDBG.HAEFaFEFBFAGdEEFeAHFLCCChAAASHFA.hABAbFFECHHD..MEEAABDGOHAChAAANHAB..WADG.....ICAEhACAKABE.XEGAhAEAfCCD,2,-40,-2,38
dLJcTAPfBVNgOMHaGIEQbRZeXDWFCYUSK,BEEAVABE.OBDHHFABGGEB.QCDDbCGDZGDA.DIDECEBEUGABhAAASEGB.hABAKAFELAFGTFCHfCFBhAAANGEDMCAFIBBAEBAB....hACA......hADA...,2,-28,7,35
HEVCebUFdDKGRafTLBZPNIMWYOAgcSQJX,SFBEJBBBHGFE.CCHG.eAAC.UEAFdEEBDAABKGAG.RBCG..aGAFTEEGhAAA..LDAChABABDDCZDGHIHFDhACAMBIBOHBEABEGQGCBXADHbAFF.FFGEhADAfFDE.hAEA...,2,-18,-8,10
CDbLgJMPQFYKOXTAWHcNfIEadRGBVeSZU,HCFB..NBEEEFCBREBBBABG.eBECUDBHDAECLFGDMFFBFHCEOBHHhAAA.AAID.fDAAhAAAdAFCSACHhABACCCFJDDF...PFEDQGGBKGBF.WAHBhACAaCAB......hADA...,2,-22,-14,8
WLbZCTaePUMBASNcEKHJFGYgXIfOVQRDd,SEFHEFGCKGEH.FFCCGDAF..XCAAfGABQAGEhAAADCBEdCGDLAAAhABACGAEaAEBUABHABFHcFDBhACAJHEC..IDEEOAFG...WDHFhACA....bADH.hAGA...,2,-29,-11,18
LIWFRaOZfDVTegESPHBJMCQANGdKbYXcU,GFCDKABA..XFECUBFCLCCB.IEAFFHBARCCCZBFBhAAADIFGVEAE..gGABhAAASADEPDHDhABABHFCMBAD.CHHBAEIBdCEC.cABGhAEAaGAHODGDfGHEhAFA...,2,-23,-16,7
BXOFDTaeIUKVPZbMAQHgCSJfGELcWYNRd,QAGBHCDBCAEB.JDDAECAH.LGBA....WFFAhAAARABABAGAFADB.aFFHIHHBhABAVCGH...PFAChACAMIBCAGCC.SDCFfEGF.YHAChAFA.dBBADAAChAGAeECGKHGA,2,-34,-17,17
WARBdcGDPZUaFQNXOHKJCLTIbfVYSEMeg,REEGdEBBDBCEZGCC.UAGFFBFG...QFGAOFADKCHHLBAGhAAA..IHHDhAAAVCDCSADEEBBB.hABAeEFCgGDCABBEBHAA.PECB.NACF.hAHA......hAIA...,2,-37,-11,26
PFHOTBALINMJZGfSXbEcCYUKdeaDVQWgR,LDBCMADAGFCFSEGGEFHH.CHAG.UBFBKECF.dDCA.eAADhABADEFFQBFAhAAA.RABCFHCAOHAGACAE.hABAIHFHNAEH..fGHE.hACA......hAHA...,1,-22,-26,4
fUEeCYDSgLIBbVcHPZWXGFaKRMJTAdQNO,dBFDQGABOHECUEGECCFB..SGHFLEBABGBA.hAAA.cBAFZABFXADBhAAAFEGBaAFEMFDF.hAGATDAHAFFGNDEB.EDDEDIBAIACE..hABA......hAEA...,2,-29,-24,5
CAZJKITabRLcOPgfENQSYMWDeFHVGXdUB,KEFETCDERGCGLBCD..PFFFEAAA.SFAAMAEEDCFEHFGHhAAAXDFEBFDBACADJABChAAAaEBH.OHBE.hADAfBFBQBDEeAFE.FEAGdBHECGDEIHHFhAEA..hAIA...,1,-8,-15,7
HSfVcgMJDAUFaLbOKYIGCePQBZNRWXdTE,UGCBFFCCLBADOFCG.KGGDGBEH.CGHA.eBGDBAAERCBEdGACHABFhADA..SBHBhAAA..fFAEhAEAgEFEDDDGAIEGaAFGIFGB...hABA......hACA...,2,-28,-28,0
PcMWGdLeXCFBfVAEaRZDTQIOKbSYHgJUN,RCBHZEGFDAEBQFBH.KBDHSDFHHAFGJFEF.UGCB..hAAANCAC.MIFGGDBBdFAGXBGAhABACBCFBAACAIGEaFFFhACAIEDE....OCHFgFGHhACA...WAEHhADA...,2,-39,-5,34
gWTeIaGDHBJCcQMYLFbZKfRSXdEONAPVU,VAFBUAFE....TEBEaGEGGEBHBACE.CDAC.MHDELFHDhAAAFHGEZDGHKCBE..RBDDdBAHhAAAOHAEAFFG...PABChABAeEADDICCJDDC........hABA..YBHBhAEA...,2,-20,-20,0
IMCfEKVJUcFSDNdRagQOLBZYbAPeTXGHW,TDDBXFAC.GAACHGAEMFGD.CCBBKEGEJHAGFDFC.DFGBdBEDhAAARADG.aAFG....hABAODDDBDAFYFHBhACAPHDE.eFDBIHHCfACFEDCH.hAAA......hACA...,1,-7,-26,19
HcIUYAbSeWDKRVOCZEfBgMNTaPdLFQGJX,eHCADCHFKFFDOCEFZACG.BBHH..MDCHaDBELBBGFDDE.hAAAQGFGJCADHFCF.hABAUFABAAGC..SBGEhACAWDHDCACB.EHFCNAED.....dEGD.hAAA.XBFB.hADA...,1,-12,-31,19
CJEcWegYQRNIAZXVMadKBHOLfFTGUSPbD,VDBAdCFGKHAC.HECGLGCEFFGAGCAAUADB...SCCAhAAADGBBEHGC.eHCAQEFFhAAAIAGAAABCMAIFhAEABACHTCGECCBF.cGGHWAGD....hABA......hACA...,2,-22,-13,9
XMTYRaIBbCgWQJDHdZGPfcUKLAeFSNEOV,eGBEFFGHEBCFOAHH..XAABMBAFREEHBHFHCAHG..QFAAhADAHDBGdBBFPBFDhAAAfFECKGAFAHIDNICD..hABA..VBEE.TDDB.aDHH..hAEA......hAFA...,1,-15,-21,6
DGFBHWNMJcTfdLIgebKPUREVCXQOSAZaY,aCDDDAFHFDHBBCFDHDCD..MEBFJFGF...TAAEdADALAAFhACAeAGDKFFBUAGH.EHCGhAHACCCGOFHDZFEH..hAAA.YHEA.NDAE.IBBD.hACA.bFBD....hADA...,2,-27,-19,8
SGQTMIZgbWdHJYRVPFKNOceELaCABUDXf,DGCDSAGCQAAEMCIDZDFB....bFDAdBDD.JEAFRCBFFFAChAAAKEDB.OADFEHFACEHG.AABFBHHGhACA..fAHEhAAAIHCEWBHF..YDAChADA......hAEA...,2,-35,-22,13
YQWUDBLGXIORCHJNVdASFPcfgaTZbKeME,FDCF..fHFDaBFHZFAF.eECFEFFD.QBDDDBEFLDHFhAAAXCABOABACGDHNABDAEFG.hAFA..SBFEhAAA.gEEDTAGCKGCHMCIH.YHAAhAGA.BHHEhAHAIBBF.,2,-26,3,29
FCGXLbcZTJdSaeHVOEBKRQWNDMUfIYPgA,GADHLDFFZCAAdCBBeAACOADGBFHHKHAGQEEH.DICEhAAAfEDE.hAEAIEHAgGAHhAGACCHAXAFETDGEaFDHEDBH.WCBENCAG..YAAAhACAAIHC.cGCHhAIASAHBHGFG,1,-5,-9,4
aUTPWGMIgXQVCAfHLYRbSDBFeZEOJcKdN,LAHBRCFEDEBDBBCHZFGF.JDAGKECF..dFBCUFGA..TFDGhAAAGEEA..MEEG.hAAAXABCCAEGACABHGBGSACEhAFAEAHD.OAFDaBBB..IDDAhABA....hACA...,1,-18,-34,16
OTeENHbcGBYMQFRVaISCfdAUJPDLKgWXZ,UFEFJBCHLGACKFCH....XBCATBFG.EFAHHDFGGDAFhAAAMCADFABAREDEIGHHhAAACHGA..ABHGDIDGhAEA.ZAFFNBBGBCEG.YABC.aHBChAFASHAA.hAGA..fFHG,2,-22,-17,5
QWFabOgJCAcMESINdYPLGZDVBHKURTXfe,MCCDEAGE..SDECdHBFLFHDGECGZDAFBEDBKBDERCAATGGGhAAAXAEF..QEAFhABAaDGC.bFEBJFFHhAAAACHB.NBAF.DEID....HAGFfABFhAEA..eFDB.hAFA...,2,-9,-8,1
HNQMeZLDaOICGVYgREBPfcJXWKUFdAbTS,SDBEQEEEMAFDeGEGZACCLCCBOCFECGCEGBGE.hAAA.gGAGhABABACBfGBEJEHF.WBADhAAAKEAEdEEDAHGB.........hABA......hAEA...,1,-19,-28,9
gDeYAOTGEFUMBISdZVQaNcCLHfJKRWPbX,TAEHFADHMHCC.BFEFdGAEZBBB..aCBFCEDCLFFH.JEHFhAAAKDFH.RAFC..PFAAhAAAbCFA..DABDAEDGEGHBhABAIAHC.QGCANIAF..fCAEhACA..hAEAWCAD.,2,-30,-30,0
IWcNHSKOgUMXaGCBfdRAFEDLQZVPJeTbY,DBGBQDFDZFEA.JDAGeCHD..TFAGIFBH..NEEA.hAAAKACF.UADEMAFCaBABhAAACGGFBHCD.fACBhABAdDDHAAHELHFGbBCA...cGAHhABA..SGFDhAEA..,2,-31,-18,13
CbXZDWHFegVEKGRBAYOUaIQMdcfSTNJLP,ODAFUFFEQAFHdCAF..SDDGTBCELCABhAAACAAFZGAGDAGAFCFD.eEDDVEFFhACAEHAGKCGHBABH.AAEGIDHEhABAMIFC..NCIC....PAFBhADA.XECChAEA.WBBE.,2,-16,-9,7
OEPTSWJIHKeBGbRQagcMdLCFfVXAZDUNY,DDDAUCCEOECGEDFB....TBFCJGEAKCGGBDHG.RFBH.aAHFMAFChAAA.LABDhADAFABD.VFGFXEAChAAAAEBH..NEAE.SBDG.IEHHhABA...HGAGhADA...,2,-41,-11,30
GCHWDYAMeZcbVFPRONXIUBQaJKTfSEdgL,MFCHeBAGZBEA..VFFHFEHFOEAA..IDFDBHBCQFFChAAAKBEGSFADhAAAdFDELADEGBCECABAhABADICCAEHD.PDDAXEAB.aDHFfAHEhABA....hACA...,1,-18,-19,1
bFMSADfHdIBgECQLaeUGKNPWJVTOZcXRY,DGCFHFBFBCFCEGGECABHLCDD..eEACKDGA...NIDDJEEDTGGEhAAAZAEC...XCAEhABARCDCFDGDMBAH.ABDHdGAGhAAAIGDD.aEEF...PAEAhACA.WBBC...hABAOAHD.,2,-31,-2,29
NaVZgGeEdMWXOPCbTJSFDAcLUBRKfHYQI,UFCHRCCBHEBB.QAGGaCBEZBFE.GGEFeEAD.MCIF.OADEhAAACGGDJDFB.DABBLHAGhAAAfEFD.NCAG.EFHDhABA.XACG.......hACA......hADA...,2,-25,-8,17
CSOHZDdVEPXKJgeUTRGBAafQcYNFbIWML,aEBDQGCF..NAIC.ICBDLFFDCEBHHAEGZGACDGEFdABDEADFhAAAKFHB.eDFGRCAHADFH.fHFFhAAAFGGF.MDDBhACASBAFOAHDXFEB.JFAHhAEAgAFD.hAFA...,2,-21,-1,20
IVNCbYgHXJfMeLKTFGDZEQWacBRdAUPSO,SCDFVAAC.CHAD...bFBBHEBA.JAACeCEDKGHFFAFCDIDCQAFEhAAA.hADAaGDEBDHHAEAAOAHFhADANDGA.XGGGMHCE.TDGAEBHH.WFADhAEAdEEA.IDCB.hAEA...,2,-29,0,29
agYKJSdQeUWLPIbfODGcHFERAZXCTBVMN,CAECVBFG..MFBC..aAAAKGGEdFEEQAGCeAEFLHAChADA..PAAHIDBHhAEAOGDCDIECHEGDhAGAECDFAFFGZBEDBCCB..NIEF....gCGAhABASGHH...hACA...,2,-28,-11,17
VWefNULDTaYACHPKJGMQcEgFRbOdIXZBS,CFDCKADEGDDDMBBD...QGFHEDCD.FFABOGEEdBDHZBAFBCGBhAAA.SFBDhABAeHBGfEHANCFG.hACADCGATEGG.AAGH.......hAHA......hAIA...,1,-20,-38,18
LAOXCeSUcJYaGgDMTEIbFHRZBQWPfdVNK,OCBACBGCUFFF...JACEGCDA.DBCHMEGB.EBFAFFAFZFBABDGFhAAA...QADDhABAWFHF.dHCHKGADhAAAADAE.XEDA.SCADaGHD.hACAICHH..hABA...,2,-42,-34,8
fWUTFSJZAdNLBGcIDaQgHeRMECObKXVPY,dEBFLHCEBCFDGCGCDCCDQGGGHBAAMIDACADC..KAGAXAGAhAAA...PGCAhABAfFAD.hACAWBEDTADDFAABJEFEAHHEcGAHaFDC..eCFGhACA..EEEE..hADA...,1,-15,-21,6
XbJCYFDWcUGZVMSBgIdfNPREKLAaeTQHO,TFDCHBBDXEGH.CEEC.FGCH.DCAGUBFEGDEDZEAHMAADhABABAFHdAHA..NICFEGEEhACAAHGEaADH.OEAB.hADA........YFHHhAAAcFCC.SCDAhABAfBDBKEBE.,2,-31,-13,18
JAREWGQNgVBSbdUFecKXaDMfZYHOLPCTI,EFABQFEC..gCABSBEGdAEGUBAAFGDCKABADHBAMAAEhAEAZEFFHCGDOAHHhAFACEDB.IHGBAHID.hAAAGDBFBFBB.cEGFfAHG..hABAYFBA..hAGA...,1,-16,-23,7
LTgfGISZUBFXNCaJQDYAcObRWdHMEVKPe,OEHBRCEGdBCAHFAF.EEEEVEDF..KFGGeCFDLAFE.TECChAAAGCBE.IABFhAAASCACBCHDFHEChABACAGCaBDGDDIDAHHA..bFAH.MDADfDAAhACA.....hADA...,2,-25,-2,23
IYRCQVgcdDSOKMLFWHBEXPAUJbTGeZaNf,UACDJGAAGFDDeGFEZGCC..aBFH..IHADRACB.CFDD.QAAEhAAA.gAFBhAEAcDEFSAFHhAAAOEDGMIFAFDAEBFAHEEHBADIH.NCIEfDDGhABA...hAHA...,2,-24,-18,6
LVdDEOJMFQWeBgIGHRKUcTaAXCPZNYfSb,CCGBZCFG.....fDAHSFEALHFCVEAH.DGBCECDEhAAAMABEFACE..eHAAhABABFFH.IAGBhAAARDECKGHFUCAH.aAHFAGEHPBCA.NFAD...hAFA......hAIA...,1,-16,-36,20
MKYOfCLPXTJIbSGBDgWUcVAQdRHZEaFNe,dGACRFGHHAFHZADFEBBEFACF..eFEBKAFA..OCHDCDEDLECH..hAAAXCFBTEAEIBAGhABASFEGDDIHUDBGhAAAAIAG.aGHH.MCABfBHA..hAEAJHDG.BEEE..hABA...,2,-19,-10,9
XVOFBJWKdEgIDZNeTUQbaHLYARGfMScCP,GAEASCEHCCHA...XAECOEACBFFFJBBF.KCAFdGEFEEGGhAAADABEZABEeDHH.TFAGhAAAQCCDHDCFAHDFhAFAfGBHMAHH.PHCEWHEA.IAGFhABA.UGGB.hAGA...,1,-8,-17,9
UdLBTGIcCDWJRHaVZgXAfSMQYbKOEeNFP,SEBBMEFA.QABHKGGAeFDGFACAdGFDLBGHBAAGGGAHhABAIFDADBFFJAGHHFABhAAA.VCDEZCBDAEDC.hABA...fAEF...OEHFhADA.NIDD...hAEA...,1,-4,-33,29
FeCSZTYUDGWJOHgfQEXbKLacNBMRAPdIV,dAGBFDECeFBGSEGFZEFE.UFDBGBBH.JHAG..OFBBhAAAHBGBQGGEhAAAXCBCKACHaEABBCFAAACH.IHHChABACBAF.DECGWADEECHB.....hACA......hAEA...,2,-32,-7,25
ZVKXgCJSdUYbBMEHAfPeaQWNOGcDTLFRI,eDDCQGADODBBGBDHDHEC.FCABRACHZFEAKAGE..CHHB.dAFFUGFEhAAABBHAHDDBADID.aCGE.hAAA.NCAG..LFCBhABAIEHG.XCBH.SABAhABAMIFA..EGBH.fABAhAEA,1,-15,-17,2
AdXFKJCHeRVSIaQPMZOgNDTWEBfcUbLGY,dECFXFFGKABAHAFFRBFB...SHGEaCABMDBA.OFFG.hAAADHDEEFBABBAD..hAAAfHBBbDABLDFGhABAABIHCEAAVABGIHBFPDHFNEAC...WEEFhABA.....hADA...,2,-18,-12,6
TeKUGVZfRbcHLYISQXWAECaMOJDFNPdgB,CFCEOBEFFFAF.dDCABBBEKBAF.GAEDZDGD..RGACHEDFLDCE.hAAASFFHXAGEADBBhABAMDIHDEIH...NEEA.hAAAPBBA....eBAB.fCGFhABA...hACA..bFGD,1,-23,-24,1
geRWQDKZNdTIPJLUBMSOCHbGEXaFAVfcY,VBFH..fEAH..cBCCYBCC.RCCEDGBChAAANDAA.dHAH..IFBChAAAPBHDUFEABABFOHFGhADACCAH.bECFEHGAXEGDAFIBWAEE.KFEChAEA......hAFA...,2,-32,-12,20
cBSLaHDQWTIdUZXYKePMJVfbCGOFgNERA,BBAHLFHDaDFGHEAEQADH.TDAGIGCB.dHGFXDEEhAAAKEGC.MGBEhABAfCCFCHDEFAHFEABF.hAAAADIHSEDGDIAAZFFGYADGeFAD...hADAJAHH.....hAFA...,2,-17,-11,6
QAGJdRBTOHcSVMZIWLDKgYNeaXCUFfbPE,JDBEBFEEHGACSHFGZDGDLAFDDHGCKBAE......YCADhAAANIAF.aBGACEBEFGBGhAAA...bDFEEBBEhABAGBDFREEH.OCABMEIF..WEBAgCCGhABA.XAGAhACA.,1,-7,-35,28
GbYLVfOcXQKPIFTCZgEdMJSeAaNBRUHDW,BCCEHBECDEEAGEAALAAGOEEDQCCCKGGE.FHGCCEDDEAEDhAAAJDHHAHAA..RCFCUBAGhABA..YFAAhABA.fFFCXGCDPAFATCADZFDFhACAMIFAaHBE.WAEC.hACA...,2,-24,6,30
SYgeFWLcTMAJBCVUdDZIGbKXRNPOEHfaQ,BDFCUECFDGFBGAEH.KFAGRBAF..ODCGEAABHEFH..aAABQCCBhABA.SEAEhACAgGGEFHAAhADALAHHMFIDAHDGCHGAdAFC.IHCB.hAEANEAE......hAFAfEHEeEED,1,0,-28,28
GCdXKaUVcefWTSJMNHRbBYgAFLOPZIQDE,OAAGZFAADBBEGBFAdCGDKEEC.UGGC..VFDHeECE...TCAAhAAAJCBAHADE.BGGFhAFAAAHCLHBGQGAChAGACCCEaAEH..fAHCSCHBMFIDhAHA......hBAA...,2,-24,-15,9
NdQUHLPGXgCDSMWAYKBTVIbcOeaFJZfRE,KHAGVGAA....IFCHOECEaBCCZBCAREFF..dGHEHAFDGAGAhAAACEEDDAAAMGDE.ADEABAFAhABATDAB.eCHDhADAFDABfACBEADA..NIDD....hAEA......hAFA...,1,-15,-22,7
SVKWAHMGOfdcaPEbDUYJNgBIFXTQZeLRC,MCHHOFFEdAFC..aCGFEBDD..DECBJBBFBCBE.FAGEQFDGhAAALAAC.SDADhABAKFAHADGDHDDBfGHEhACA.PHAEYBEHIAHB.hAEAZFFHCHHA...WDDGhADA...,1,-20,-31,11
WMOPTEGDUgRFfBLecQdYCNbHAaKXJVSIZ,aDEBKCAC..JGFA..IHCBZAFH.OAHBEHEEGEBB.DICAhAAAgCBB.hABARFCGFHFCBEGGeACEdAHECADDhACANAGAABADXCDA.SEADMFFCPFABhAAA.fGGBhABA..,1,-7,-35,28
ZPNJaHgTKWCQIMdBeYAORELFcVXDbUGfS,OCFAEDDDFAFB...XGGDDHAEUFFHGEEAZBAD...NDIAHFAChAAATDFD..CBAFMADGhABAdCCFBCGBeCDGAEIFREAAVCABhACA.SAFAaABA.KDDD..WHAAhAAA.....hAIA...,1,0,-25,25
WUCLdISXQERVYgKADMPfbBHaOZGTecJFN,DHCAMBBB....PCCEBDCEaFGC.OAECZDEEeDBB.JAFEhAAANDAA...CFACdGFCXFDGhAAA.RCGD.gABFhABAKCECAIDC.fGHE...hABA......hACA...,1,-31,-40,9
PHSKXLMaeTUVYOBfCEgDAcNJFZRWbQdGI,JAABREBFQBBFGGADHCFAKFFG.LFHD.eEEDVBFFBAFEhAAACBHEDAGEAEACFBDEZEDHdDAESGFHhACA..MEIBhAAATCBEOABG.fHFH.hADA..EAEF...hAEA...,2,-12,-11,1
eGERbgKBNVLUYWXSTIAHfDCdFPcJaOZQM,HBCFCCGFFACA.JHAEZFEE..QEEBGCBERAEF.KBGABHHCLFHDhAAA.UEADXGADhAAASBAAAABF.fFDGhABAdEEH.aADAOCHF.EAGG..hAIA......hBAA...,1,-11,-27,16
WSHXOTgEJVCIYFDUNZRBdbPLAfKGcaQeM,KABDaDAB.eFDF..MEDBHCEFOCHBEAFDJHFACBAC...FCCHDBGFZAGDhAAABGFFdDAE.LDCChAAAAEHH.GEACQGAHhACA.XFGE.....hABA......hACA...,1,-4,-40,36
MCPXWefIVYTdLDbQaNBGFcUOEKAJRgHSZ,RDACHADGZDGF.CGCG...XBCBeCAA..fBGC.VDDChAAAYGCCLHFChABADBGGaEECBFGF.FGAHUAAAhADAEEADABBESGADMCIB...IHHHhAEA.dAFG.NICB.hAHAcECH.,2,-14,-4,10
GLfDZQMKYNUVSJERbPTOecXBWgdFCIHAa,GBADLFECDGDAQFBFKCFH.UCCHJDHDRGAE....bBAFhAAATDADeAECBCFBhABAdABFFGFDCHDCAIFG..aAFBMBIBhACA...NEACSGHHEAGCPEDE..hADA......hAEA...,2,-20,-16,4
ITfHBVQXRAKLJGUFOdCZcSMEbaeNDWgPY,JCDGFCAHCEHEZEBB....SCBEMBCG..EGGGaAACDAHB..hAAA..PECATDFGhABABHGEXDAFAGDDKFAHUGEGhABAOHDEdAFG.eCGFNACH...YAHHhACAfEEG..hAIA...,2,-37,-22,15
fFNOdGCcWQAbDgBYEJITXHKaMZUSeVLPR,DCCBBBADEFCGJAFA....XBDGaDEBZBBF.eHCCLGEG.hAAARFBD.NAGCdACB.CBAEQGGAhABAADGH.bEFGhAFAIDAD.KFFCMAHBSBFGhAAA..PFBB.hABA...,1,-5,-44,39
gHAXOedLQbMUYVFCDNaSBEWTRPIcKGJfZ,XDGBeEECLABH.QADCMHCCUEEDFGFGDEBE.aBGASBHFhAAABHGA.TFAGhAFARABC.IHHGhAGAcCDAKHAAfFCDZFAGAABAOAAHdHAD..hAEAYDDECGHE..hAHAWAFC.,2,-26,3,29
HTOeQPEGJSVKYCgRNZcFAWBbXaMUfILDd,BFCEaBDG.MCAFUAAD.LFFFDICGdFFFHGECOECH..eBFDhAAAEEDAGBGESCCChABAKCDACGGGRFAFZABG.FCHHABGFbDABhABAXEDB.IAGC...hADA......hAEA...,1,-6,-20,14
cHIYTVLRUgNGKZbdBMCSPOafWAeFJEDXQ,JEBHXFCCHFEC....TCCGLAFCRAAF.NBAHGDDDKDFCdAHECHEBhAAASGFH.hACAPCADaAEHAADFEDHFDFGGQBGDhAAA.ICDGYFAF.hABA......hACA...,1,-16,-18,2
ZLHEMQOTPJNIRSUbFdKBYVGAgDafXcWCe,aFBEXGDD..CBDAeHCCLAFBHCBBEHAAMAECOADB.TAAAhAAAJEEARBFGUGGC.hACAFAABdFFBBCAAYDHHhAEAAIAADDDE.cECG.......hACA......hADA...,2,-18,-6,12
KfJDVCMAHdQbOGPFWUcEZYNgRTLBSeaXI,QBFEGAAEFADHUDGDZGEA....gFBHRGCCBEDGaHGEIAEBhAAA.fEFChABADFABMBFGAIAGdCBF.hAAAOAHD.PDAB.EABANAEDSFFAhACAKCEFCHAD.WCFChBAA...,1,1,-39,40
FLGNXUEWCYBcRTHKaQMeAdgJbfODIVSZP,JDDHOCCD.DHBCSCECZCFF.FEBFLEHB.XAAAhAAAEFFDCAHCBGDD.RAAC.hAAATFDGKFAF.aFAG.hABAMAEGAHCHdFHE.fAEDIDAE..PAHDhABANIEB.YHDGhADA..,2,-40,-16,24
DEOSfGNTCAQLWJUeHPdRKbBcXVaIgMZFY,LABGUECBHBAEdFHEKGGEBEEF..XDGAaCFA..MAIDhAAAFAHFEAFDSCCEhACA.GGBBCDDCAEBDJHCARDAG.hADA...bFFHIGAFYFADDFFBfDFDhAFANAAD...hAGA...,1,-4,-32,28
EJIPbHLeXFARfVWDTKCOdgQBcUMYZNSaG,VBADTABG..CBFD.dDFGBEFEUCGE.ZEAA..SAEFhAAAEFGCJBDE...IFDFhABAbEDH.eGBGFHACAIDAfFGChACAKDAE.OBHB.gDCChADA.MIFE.hAAANIADaAGG.,2,-31,-18,13
OGSJdHZYQbRMaPWUeENCKDBIFAXfLcgTV,XGFALBDDTDFD..GABAJFCBZCADQEDAhAAA.RADCaEHFUGGAEHACNCEFCGAAhAAABCGD.IAHChABAFABGAIDE.fDAE.....hAEAcFCH..OFFHhAFASDDC,1,-3,-28,25
eOLcgFZMRXEJPfGYWBQTbVHCdNDKISUaA,eCDDOBBALEADFBGDZFBB.REBF..ECAGJFGFGGEH.BBFDTCADhAAA..bADFCDEFDFIFhABAKAAASDGGhAAA.AHDBMAIHfFAE.QAEChACA.dFEA.NAIC.aFGAhACA...,1,-7,-22,15
MLcGAQJDWKFZdOYHVICBgeXbNESaRfUPT,QEEGDBECFAACZFFD.OAFGHEDB..CADC.eEBF...NEAAEAAGhACAaHAERCAB..UBDATCFDhACAMBID.LHCGhADAAHHGKFADdDCAIGGC.BEHG...hAFA......hAGA...,1,-5,-27,22
beQMRTECDUOdVBSaYfFAgIKPHXcNGJZWL,KBFAXCDDGEBDZCFFLFGD.QABDMHDCECHHDBCHdAFBBGEBhAAAaDAF.FCHDAAHF..hABAIAECPDAG.NIAF.hAAA.....WFDG..eEADCBAD.hABA......hACA...,1,-13,-34,21
DMaAdUePSOWIFQCHNZbEJTGBgfcRLVYXK,dBGEeHCASDDGOFCEFDFEHEFG.ZADHEAFAGGAFBBHH.fCABhAAARABBLDAAXGGAhABAMFIHAHBB.UGEAIGGGhAAACAFC..NAIETABGcFAG...KFCEhAHADFFA.WBDB..hABA...,1,17,-27,44
dDVfgBOESXZJcYWaAKbHRLQNFGTUeIPMC,KDDFHECHRFEBLAECQDAGGBAHeFFHPDDGdCHG..DGIFfGAGhAAABEFEEBFBZGBChAAAJACA....WCHBhABAaDAFAABHNCCF..FHGE........hAFA......hAGA...,2,-21,-6,15
WFRbSIZAGVBPHCXJUdYMTgQNeKfDLacEO,VFDCBHDFCADE..UADGMDBG..QBGAKHFGLBFBEBACOFBDhAAAFAAA..SCHBhAFAAEDDHCACdGHCTECDhAGAeAFCaHEE.WEEEIFHC...hABA......hACA...,1,-5,-43,38
geVIACYDMQfTHWBJPZXNFLdScaREObKGU,DDBCMEDFQFDEHFFGBAFHZADFFABCLBGDdEAA...aBBEOCFBhAAAKGADUFGEeBHHAIBG.hAAACCCA....YHBAhADAfHCB.WAFE.....hAEA......hAFA...,1,-24,-29,5
TebPYFUcHCWJBGdAXfEMaIRZKDSgNVLQO,XEEDMBDHRBAD.DDDD..SFFA..gABDhAAAVAFEOHDETAFGPFAGhAAAUDAA.CHCHJFHDBCEBhABAAHAAEHEGIEEEKDGB.NCIG.eAED..FDGBhACA......hADA...,1,-13,-20,7
BHgWVJIdTKDRUQGFZPAOYSfcaNCELMbeX,SFFAaEHF.CDFH.MCFH.eEBHBDDFHGDGVAFAJDADdAECTABDhAAAKDAD..DIAA.hABAUFDEFDDBPAHHhADA.AGGG.fABDNIAF.EBBD...hAEA......hAFA...,2,-34,-11,23
ETHeObUaANKMFLcRQXGPfBZSDVgYIJCdW,KDGCLBFDQFGFXEDHGECA.BBCHSAHBDCEE.hAAAVCACICAGdGGDEEHHhAAAeAFEUGADACHG.NACF.FHFChABA..RBGDZABCJEAHCABA.......hBAA......hCAA...,2,-20,-2,18
PJeNWIdYSXTQcOUHCELMaFZRDABGgVfbK,GDCHVBBF.KDHBeGEA..IBGDdHBFSEGGQFBHhAAAOFBCCHADLACBhABA.MFHDZAFEDFDAAAFHBGFAhAEAfEAC.PACGNBBCXGDHhAGA......hAHA...,1,-18,-21,3
YfAcILRaPQdgXGFKUZVeMNDEHWOTJCSBb,LFFFaGBH.dCADGAEAFGDFZFABVDBB.eBAFDAGDHDBC.hAAATCGFSBDDhABABHHG.YFFBAAHDRABG.hAAAgDGE...KAGGMAFH.hACA.EEEB....hADA...,2,-17,-13,4
DQBLFGWRAHSKUENfXMPcYgdTVbZJOaICe,SGCAUBDBECHB...XDAGMFAH....PBBBhAAAcBBCdFGG..TFGEhAAAVGBAJEEFIEEFhABADBADLBGDGACBADEGNAEH.fDGC.hABAgGAD.hACAOBFEaEBE,1,-10,-15,5
EXKfMVBaGUgIcDbCHONQLRJFYWAeZSdTP,ZFBHdADDEFCFKABE..MDCGaBAG..GCEHUGEH.....gFEDhAAAIAFH.DECCHAGFhAAAQEAGREEAFADDAIAE.hAIASEHH.PCAE.fAHGhABABDHHCHHGOBBBhBAALHEA.,1,-18,-19,1
cRGZNYWaeFXDfTMBPKLHVbEJQUdAIOgCS,OBCBCDCFRBEC.ZEAE....NIBF.aGBFFBAHDIGA...MFECBDGGhAAAKAHHHEEF.EFACJBDChAAAdAFBAGGA...IHGDhABAgGDA.SCAD.cDGAhABA..YEDDhACAeDDG,1,-39,-43,4
ULBadDHPfSZbQKVOIGeNJYATcXFWgMCER,TFFGXCED.FGFAMIFG..CGCARAAGBCDH.dEAHDBGDHADC.hAAAfABCZAGFKEBGOCABhACAeHBE..NEEHADGG.hADA..gAGHLFHHaBEBSFHBhAAA.QFDAhABAIHED..,1,5,-32,37
UMDbRNTWeaOCFXVfJgdIEKBLSHQYAcGPZ,GEABUECBMCBDDGFFRAAA....TBGBaAEBFGCE..XGAGhAAAJAHH.dCCFKHGCLFFEhABAHCCAAAGD.PHEGhACA.NADD.eEEE.CDAD.......hAAA......hABA...,2,-25,-12,13
OSWDdReELPBAfbQMVJCgNIKYFTacGHZXU,QCEFMADB.CGGF.NECB.KAHF..FFDDaGEBGBAG.HAEFhAAAZEAHXFCFOHACSHEAhABAdCCGEBAABFHBhAAAAAHBfCHAJADE.IHHG.cFFGhACADABA....hAEA...,1,-20,-24,4
SFDVBRKaCcAEJeNGTPYIbQHUXLgWOdMfZ,JAFHeBECGDEA..TCFF.IEHDQEAB.UGGFhAAAgEACOBBAdHBBhABAZABHDHCEBCAEKBHBCEHHAHAHhACAEFEB.NIAD..PAABYDDDXGGAhADA.MAEG.fEEBhAIA,2,-33,1,34
TcPLEOZaAYCGHFeNRWJfbSUMVIDKdBQXg,CGAFFGGHRAFC...JCFF..SFEHUGAC.MECDDBACBCAG.hAAA.QABAhABA.TGGCPCCDEDDGhAEAOHCAAFDF.HAFENICHfEGF.hAAA.IEAH.hAFAKEED..,1,-32,-42,10
QUEDAILYfcTebHNWMOBVgFPXSaCZdRJKG,LFEF..cFFGTGAEHACAMBCEOECCBCEAVGFEhAAAPBAD...aBFDCDFARDAGhABAJHBGKAGG..UCCFhAAAADCAIDHGeFAGWHEA.FBHB.SGHBhABAdGCA....hACA...,2,-15,-8,7
HAKGQfYWDMUcNgPOBEICZeaRbSTdJFXVL,GDFGQCDA..fFHADIAGMHEGUAGE..cBEDhAAAPCAFBCAD.EECEhABACHDDaEGHSHDAhACA.dGAHFDGALAECKBBENGBFOACAIBBEhADA......hAIA...,2,-19,-19,0
aXcALPZGDRgVMHSKdBJIQfEbCYOTFUWeN,LBFBZDCDDACGRBEE.VEDHHFDB..dAAFBAABQGFDEGAD.CAHF.hADATFGAFCDG.eCBBhAFAaDBFAIBA...PBHFhAEAMAIDSEEE..IFADhAFA.....hAGA...,1,-15,-25,10
NUORXQGIaBTPcSFDCLYKHJdAEebVMgWfZ,eAEFMCGB.....fDBDNAAB.OCGBRDBHXGBGhAFAIACATAGD.SBBEhAGAFFHFCAAFLFCFhAEAYHEEHFDDAEECbDGHWBHB.....hAIA......hBAA...,1,-15,-26,11
ROaZVSgcLUHFDYXQJEfPTbNIWAMdeBKGC,eCEHGDEDOHAGaHFAZBEA..SBCCLADEHAAFDCDHXDFDhAAAJFBAEFGA..fHBBhAAAPDAD..NABFAFIBhAGABDDCKHEG.CAHB.VAGF...gGGBhAIA.FECH..hBAA...,2,-10,-5,5
ZWGagSDCPHBVUKOAIEFMcJdXbTLRfYeNQ,EFHHFEBBMDDBdDGE....XACCTBDDLFGBREDF.eFEBhAAAZAAFaGBCSHCEhABACAGFBECFKBEGOCABAEAF.hADAIHAD.cAGEfAHC.hACANIDH......hADA...,2,-24,-24,0
bTcAKSJZfRgUaeGQFYXBDHMOINELVdCWP,KCFDJEACZAFCRABD..UEBAGFEB..QFGHFCBGBABFHDEAhAAAMAED...OHAAhADAECHDdAAGCCGA...PAFAhADA...bGCEAGAGSACA.hBDA.aEECeHFADICG..hAGA...,1,-14,-27,13
HZGUbfdeCDJQBgPYXAKcESVaOTNWIMRLF,EFBCSDGF.OHFGNHBH..MAAFLDEDFAEBHEEAZEAEGABFhAAAUBBFdAHEeHCGhABADAGDBDEFPAHDAIGAKGGChABAVCAE.aGBG.IEHF....hACAfDGBCHAD.hAEAgDAA.,2,-20,12,32
HRgEfZcXbOYeLNAGDUQCWFKdTVPBaMSJI,UAFDQFFHCCCF.KAGGdHEH....VCGBBFDDMCCCJEBDHFGDhAAAEFBCZDDB...XGAChAAAOEFGeABChABALBBFAIAGGBDCDIGEFACA......hABA......hAFA...,2,-28,-12,16
MDJagPGfOBWZcCTQedFXYSUHLRbEAVKNI,KFAFMBIFDHFC..JFCF..aCBAGBDCBEHCZECHCAGG..eCCDFBFB.hAAASFGBLAEEEFEAhABAAACC..VFEF.hACAIBADgDADfBFE.OEABhAAAcCGG...hABA...,2,-33,-27,6
CcJAZeHNbGQYgIXLWKBadfUPRVFSMETOD,eACAHEBBGABBQFEBIEGDLCFEKAFEBDDDdGAFUDAHRFEEFBAHhAAAEDFH.DEHDCEAFAIECNIEB..hABA....bBBGXBFEhACAaAAB....fDDChACASFHH.MIAE..hAEA..OHAC,1,8,-17,25
UDRAWPFZYScQeVCaITOLbGHXfBJdNEMgK,FCDDSBDEQFGECHCH...aFEGIGEGOAAE..LAFDhAAAGDEBXBBChAAABGCBJEACdHABMADGgBGDhABADGGBWECGYAHD..eHEGhADA......hAEA...,1,-15,-26,11
BgMPDXOcNSUIdTfLeAbGYEQJVZHaWKCRF,GDEEEBBH.QFADVAFDZDAA.aBCFCEGA.BDGF.MBAFDAIFOHAGhAAASCCD.dAFAhAAATFDAeBHB.AIEA.bEGHhABAJDDCKHAAFFAA.XGGC...NABB.hAHA......hBAA...,1,2,-23,25
IYHZfWODCVgcESRaKXTMbeAGQdJUPLBFN,GADAJEDELABCBGHDFGDE....ICFGHAFEZCFEOGAChAAADBABVDBF..gGFBhAFASGGDaDBBhAGA.KCCEMIAC.AFIH.dEHCPAAGNIBF.fFAGhAFA..hAHAWAFAEEFC,1,-19,-35,16
SKGIcdORMVWfEXDJFeYPLAUBCNgaHbZTQ,UEFEBBEGCAAH..aBFDHDADZEAH.QGCCGBBBdHFBRAFB..MEDChAAA..fAGBhAAAEFFADBIBeACCLACChABAAHBE.NEDE...........hAIA......hBAA...,1,-22,-23,1
IOYKSaDBATgNCbHGUVdcLXfFEZMeQWPRJ,TGBHCEGBGAAH.dDCCLCCD.XGFFfAEBZABGMDEChAAAQGFERAFC.IEEAhAAAKEGCaGABADAGNAIGUGDChABA..FEEBEHAC.eDAFWFHH...hADA......hAGA...,1,-8,-14,6
KXNJMgTYfICQUZLabPBFEAHdODReGVWcS,HFBEDCIHeCACVCCF..SHGCKBHB..JACCMHCA.TCFAhAAAfBAA.hABAIAGACHBGUECHLAFChACAaFGBBHECAEFGOAEH.WFFC..hADA......hBAA...,2,-30,-23,7
GKVOFdYcAZeIHMRfBETJbgQPNDWaSXULC,ZDCAHEFGRAFEBDGFJHBA..QCACDBAF.SFCALFGHCHADhAAAVADAFBDD..dFCEAAHCeCFChAAA..IHEChABAEABDgGGG.PDCENCBA.aGAHhACA......hADA...,2,-40,-5,35
GBeUELDgZaKbQcHfdAFRWCTSXMONJYIPV,FEFFREBGCGAG...XBFAMACD...JBAG..PBABBGDHEFBBhAAALEHBDEAB.ZEEFaADAhABAKBGB.QGBGhAAAHDCHAICESFHFOAFGIBEAeCDG..hABA......hADA...,1,-21,-24,3
LaVSQCcdYIJWAOMDKHPRXFUNgGfEeZbBT,DBGAHAAHREAH.FFDHUCCFGEEF.EFBHZEFDBHADLABA..SBFGhAAAQGCGcDBBhACAdAFC..ICADhAAAJADHAFAD..MIDCKFDENIEFfGHAhAEA..eCHB..hACA..aCHD,2,-23,-4,19
TFRJDWBYKCXbPVSLfIaUNOAdGMZHgEcQe,dBFDMAIHHDDC.EGGGeDBGREBH.DIECBHEBCDFF...XACEhAAAVACELGACaBBH.UAAEhAFAAIBG.ZEFDQDGChABAFEHD.WCAD.KGADSCFEhAGAfCCBIHBH.hACA...,1,-15,-16,1
FDUBJZPEbaROWYVIcXGCKQANfSedMHLTg,SEDHMDCAHDGBLGBEFFBBBHDHZDAEEBDARCAD..OAAD.hAAA.WBACVADBXCFFhABACHFC.AGGHfAHEhACAdDFGDDHFUAGF......bFEDIHHAhAAA...hADA...,2,-24,-14,10
USKXGVfTeNdcQMJBLYIbRFZEgAPOCaDWH,CBBHaBCBDEDCHFFD.UFAAKBFDGEFA..fDDBeGACdHDD.hAAAQCGDBEAELABChAFAICADFCHD.ZFDFhAAAAAGC.OFHDSAGATBED.NAED.MDBGhBAA......hBDA...,2,-29,2,31
IWfTRBdJVbKAFDgSLECaZXGUOMNcQHPeY,DHFGSHCACBDE.ZCFGUCDH..NAEA.QFBHHCAF.eABDhAAAICCA.fFGChAAABFFGdAGEJDABhACAVFBAKEGAAGABFAFG.EEFAaHGEOFHDMIAG..hABA......hACA...,2,-30,-11,19
LBXcMNODVgbETQCFGAZUJHIdeafPSKRYW,UGBAJEHDHCFDeFEH..aGGHSCCB.RACGLBHDhAAAXGAANBDEOCAB.DCFDhABAbAADEGGG..CAFAAEEE.hACAdEAHKGAFBHEGMIFC.......hAAA......hACA...,1,-10,-27,17
AHJEcTMaPKRgUCSIQFbeZdLXVGNDfBOYW,HCFBEFCE.TCDGMACAKFFCRDAG..CCHHQFGDFGHHZBBCdCHCLBFDhAAAVABF.GGAHhABADBFCOFABADDB.JHCCaEBBhAGAPFCE.SAAF...hAHA......hAIA...,1,4,-17,21
OeFfRCLDgbEdPaWGBTKAcMUJINQHYVXSZ,UFFBJDDH.QAGBHCEG..XFGGZCACeFDFFBADRABCDGIHEAEBdFAChAAA..aEAHBHFGhABATCFCAHEBMCID.NCCG.hACASHAA.CHEG......hADA......hAFA...,1,-15,-23,8
KYSAWfXTVdNRHMCbcOGQFageBLDJPEZUI,XFGBVACH.RADE.MFGB..CCHBODAHFFEFeBFA.BDGHDCGFEFEDhAAAUFAH..IHDHhABAKBABADFF..fEHChAAATGAEdECC.HCCC.cABBaEDB.hABA......hACA...,1,-10,-33,23
AbSeCBgOEWQVZUFTPNHcIJfKYGXdMDRaL,SGCGCGDBBCAD.OFFEQGFG.UCDCPFCGHEABJBDBhAAAKAFEGAGCdAAHDCHHaCBHhABAAFFG...eACCEHBC.hABAWFBD..FFHFNIEB....fAFAhACAMCCF....hAIA...,1,-17,-23,6
MGfOXWKSFPdBbTULaRQZCYDNeIgEcHJVA,GDBGXGACSEHBFDAF.BBGDTBCHUGDHLAFEhAAAQADEZBGFDCFFeDEAIGEBhABAEABA.JFFAAAAGfAGDhAIAOEDB.KGGFdACFaCCFCHHENICB..hBAA......hBBA...,1,-4,-10,6
WbIKXNQZGRYfPDELHeBdgcOVTUFCMSAJa,aDCE..ICCCKBDE.QEBFZDGBGAFCREGB...fABFhAAADGEHEAHHLHAChAAAeBABBFEFcABGOHBGhABATADECAHHAFAFbGFGNEFE..HCEG...hAEA......hAFA...,2,-22,1,23
ROfUSCYJBbeVIMAGWXLNPcgTHDKEdFaZQ,XDFELDGF....NCCD...cCBHTEBE.HAFCKACGEEDFhAAAFDEFaEAHREAD.OCHDhAAASFGDCGHA.BAEEhABAeABGMIEAABBDWDAEDAGAZGCE.fCFFhACAYHFAbGAA..hADA...,1,-10,-13,3
MHRWcBOEgNAeSDbTPadIFGQKCLYUXVfZJ,eFFBSDAEDBCH...TFAFaBFHdADGGABDKGCFLBHDhAAAUEDHXGFHZBAHHDDARGCCBCFGhAAAEGADAIHC..IFHGhABACDDBYAHF........hABA......hACA...,1,-12,-17,5
bOWKAUEJdRVeXGaSLfYQBPDZHINgCFTcM,JBBHVFFGGAFA.LFDDQCCGBHGADAHBHEEB..gGAAhAAACEBDFADC..hABAMCADbDABKAEAAGHEdAABRFDBaACGhAGASHAE.fDDHYCFDIDHAhAIANAIE..hBAA...,1,-11,-16,5
FeKgEDXAHBVcRIZOaTNCJMYdfPQbGWLSU,BHCFRFCDOACHaEDG...CBEA.MBDG.dBHCQFFHGBACSGFEhAAAeAHDEEDGDFABAAEA.hABAHCEG..IEHDhACANEIEJAAB.fCCBbFAD.LCFBhADAKHFA.XGAFhAGA...,2,-26,-3,23
dYQLGIfVXSWaZOHPEBDcbAUMKCFJegTNR,KDHFCDFGFBHBeCEH....TGDAdCACQGBBLCDEGAAFhAAAIAAB..XFADhABASBFEaGHBHDAChADABHGFDCGDAAFEMIAGgCCHYFFEWFHHhACA.OFFBEEDH..hADA...,2,-38,3,41
eLEgPDSMUIZNQTfKFdbBCAXWVaGcYORHJ,XGFAaGCHGDAA..OAFCRCDBHEGFJFDAeAAC.LAHBhAAAEBEDDACGUFAHIGEEQBABhAAAfAEBKDHBFGDHhABA.dDEHBDCDADCH.......hAFA......hAHA...,2,-16,-1,15
bRBCIgNQJKTEcMWGFZeUAPadXHLDSfYOV,dCEBHADGDIBGSEGE.OBAHbACBBFHECGFH...IAFHhAAAQECB.TBGChAAAEEED.MHACGBAChABAFCDCeFECAHDGaGGHLBHHfBBGREBF.NIBFKEAHhABA.....hAHA...,2,-22,7,29
cYNQUXgAZMVKCTGSfDJeHRWPBELOaIbdF,ZACEVBABCGEFGBGE..SGEBDCEGHDAARFFHBAED.LAAEhAFAOAAG.IGAChAGAdGBB.FGGGNIAFXDDBhAEAMFCAfCGA.WHBA.EBFHaAHFhAGA..YCHBhAHA...,1,-9,-31,22
YgKOaLEVGFPNdRIfAZUHWcDTBbeQXJSCM,UGEEHFBEDCACBEDCeEHH..QACGSDFAMDHFKFFBLEAFhAAAEEAH.GADChABANAAGdHBB.fABHhAFAACGCZCEH.cBFE.......hABA......hAEA...,2,-34,-3,31
WReHIEKTSCYDXNAaLGcbUVFZOJdMBQfPg,GCBHUECFFGDHZBFD.dAECMDAABHDH.QAAD..gAFFhAAAeGFGHFBFIHBFhABATEGF.CFHADHFChACAAEEFaDAHLAEF.bBGD..OAHDhAAAfBBF.WHFAhADA.EFFC.,1,1,-37,38
cENPIdebTUFXJZRDALGOCBMVYKgaWQSfH,LBEDGFBHOEFABAGGMIECKABH..aCDDSCAEHAEEEGHB.hAAA..IGDAhAAAdAHETDACXBGAZACBABABCHDHhABAgEAG.fFGBcGAC.hAGAPHACbFFH.JABE.hCBADDDB..,2,-17,1,18
fTDeSLdgGVJUHaKMAbRPWOFZNQCBEXYIc,RCEHOBEDFFBAZEGF..QCBABGBG.EEGH..XBADhAAA..IEADhAAATAFHDEABeHDCLHAGhABAdGBFgAGEJACGaCCAAEIDWBBC.CHHHfEEEhABASGFB...hACA...,2,-27,-17,10
MUaAWTLKSRINQDGPBYegJEOZfdCFbVcHX,TCECKBGFRABF..QGFBGDGGBDDD.eFACJDABZFDFdACHCBHCFHBChAAA..VBABHADFMIAAhAAAAAHB.LGCGhABASDDGIAFDDBADgDGF..hABA......hADA...,1,-4,-21,17
BMAKQZdPDRCLbFSYaJWXEVeUTGHcgNOIf,QGDCZEBBDDGFLCDBFDBA..SABGaFHB.JDFDECAGUGGChAAAHFDC..NCCB.IABEhAAABCHD.MAIFhADAdEAGCHAGbADE...YFADXFBD..hACAeHDG....hAEA...,2,-20,-16,4
GaKUVBPCfETeILHJZbcOAFXRDgWYQdNSM,RFDDDBFA......gFFDQEFFdFAHSDDFhAAAMCDHaBBD.KHAGBBAECGHAEHDEeHAEhAAALDBDZBFDOACAhABAFABF..XCFFWDHB.NDAC....hAGA......hAHA...,1,-20,-25,5
fTCZbAHIOaYdcMNUSLXGKRQDeBEgFWPVJ,HGACOGAGaBDDdBFAMIDGUABF..LFEAGGEDRDDFQDAGhAAA.eCFFBEAEgACFhABAPDHHJAHFTAGDhACA.CEHBAIAC.IHHDNIAFKCCDDAAB..hACA......hAEA...,1,11,-23,34
gTKDBdLZNPXMSOEfQYIaHbeFUWGCVcJRA,KBABDAGBLBAGZAFF..XCCASEBDODEDQGDEhAAA.IECChABAaHAGeEHHUDGHCADA.cGGFhACARFBGAHFHBAAFdAEENDAAMIBAEHFG.fDAGhACA......hADA...,2,-30,-6,24
SVODTANRQMUCYeIXHgJWdFGPZcfaEbLBK,RCEGUBDGCCHB.eFEFHGAG..JBHDdEEG.FAFEZBAD..aGHHEFAFBHEFhAAAKGCF...SCAGhABADAAEAIFC.MCBAIGGChADAXEBC...WABAPAFG.hACA.bFFFOCCH.hADA...,1,-20,-30,10
KaPZcUTEOVXWGRfYbLJMFCHeSdgDBIAQN,QADAaADFZCAB.UEDAEDEA...XGBDRFCH..fBHChAAALHFAMDCEhAAAFGADeFFFdDAABGGHAHGGKEHB.hABAPAHHODCBWBAG......hABA.bCFDCAGHSBBEhACADEIH,2,-24,-23,1
FTBNDCKYVRSbOHXULEWMeQaPGJdAZIgfc,ZCBF..gBEDFGBHBGEBDEABCBAF..KDBHRACC.OEGBUDEG.EFAGhAAA..eBFAQEDGhABA.PAHFhACAdEHGAAAC.fGAE.NADHSEHHhBCAXGGC.LHEAhBDA..aDAF,2,-39,-11,28
NXaFYdDZcTQCSKBbMVOIRLGEHWPAUJgef,JEHHeABE...XDGEFFCGdCBBZGCG..QCCCCAFC.hAAAKFFCBHAHVFCHOBFDhABALFAD.GAEEhAAAEEEG.WBBFADIB.fHGHaAHHDBBC.cBGEhAEASEAH.hAGAMCAD.,2,-47,2,49
YaOUNQgSKHIDJbEBFcZfdVeALWCRPXTMG,CEEHXGEDGGBH..OCBDQBFH.SGGEKAGFDGECJHFEhAAAbCBH..BADEFABGZBDHhAAAdDEFAEIBLBHBhAEA.PHAAMABDaFACNGAD......hACA......hAFA...,2,-39,4,43
PIMHZNBWXFCeEVGdKaLDOQURJYfgTbSAc,..IFAEMFAGHEEFBFGHFBGD.EBECdCFCKDDCDCBC.UECB.RADC.hAAAfCAE.hABATBBFAHBGPHEEWEHBhAAACDHE.GGAHLHAAOABA..YDAEhACASHGG..hAFA...,2,-27,-16,11
BTgVXOcdIUQEWeDMJaZYHGFLSfRCPNKAb,TDDEVECH..OAEBdGEHUCGG.QGAGEGBDDGFG.MCCDhAAAJCABZAGDGADB.FCABhABASBBBCFFF.hACANIED.KHGABEHE.XCEHWFDD.aGAH.hADA....LAAChAFA.,1,-6,-25,19
INaYBKSTRJUZOCQbcefgEPVAXHMWDdGLF,HAAEMCBBDIAALBFF.IHFBaCGDBAEBSAGBRCCH.hAAAUCCGCGADQFGHhABAeGDCfFAAEGDFABGAXFEBhACAdDGANBIGKDAD........hAAA......hACA...,1,-7,-30,23
SYHeWULJATdPZVXMgCcKRIDFEaOGfBbQN,TBFCZBDBMCGB..CECG.KCAFDIDGFHFE..aEAHOAGF..fEHEhAAABFDGQABFhAAASBAGHFADUFEChABAACIDdEHGPDDC.gADA.hACAIAHFEFEG..hACA...,2,-35,-16,19
PDdFABTUQWgIceNGSOZVLKCJRaMXbEHfY,BCHCTBEEQCDD..IEBDNCAA.SGAFhAAAOFHHVFCACACEJGBEMEBDhAAAbFFG.HABH.fHEFhABADBIFdHEHACCDWEDC...eAEELCFBhADAKABD.aHAC..hAEA...,2,-13,-12,1
IYKXCGDUZOWfBbeQJgaNVAHFLSMdTPcER,LFBHMGBEdAGA.TGDHEHDC..RDBCKFGFXACG..DIGAOAFBhAAABACFQBDFhAAA.JCHDNCDAAEFEFBAFhABAcAGF.CGHCZEFEWFAFfDAHhABA..eDFF..hAEAaGGH..,1,-12,-23,11
DdEFZRUBMVIWbLTAfSeYQPXNCaJcOKHgG,SFFFeBBFQCEB..PABCCGHHJEBD.KDHBGADDDGBFEAHDhAAAREFCMEEH..WDDHhABALHCA.AABD.hAAAXBEAaAHF.cGGA.OEAAhAEA.dHCB....hAFA...,2,-29,-8,21
PTBcYFUIXZDOQRNJdGMWaEfCHKVgSAbLe,eDDABCGEFBAGUGEAZEDEDDCE..OEGDREFE..JACCMBFC..hAAAaCHHCDBGHGDA.KCDFhABASBAAADID.hACALHAATGAGIADH...hAAA.QFAEhABA.dAFA.,2,-28,-27,1
ZEGRJVIPLgXDSUfeMYCbdBATOQWFacHKN,TFCCQAGE.FCDFaBAEHAAAZBECEGFCJFAH.....IAAEhACAgFFGDEFESDBHhADAfDHCeFDHhAAACHHABHBGADAHOBFBKDDCNAEB.....REBD.hACALFFEMFIH..hBDA...,2,-21,6,27
bSQZRMdPVDcGaNEUWIeKHFTJALCBgfYOX,LBGFCEHFBAHA...fADFOFDH.SFFCQEADhAAAMFBH.dGGHDDAGGCDEhAAAEEEAUGFDIHCDhABAKBBCFGBHTCBAADEB.YAHBXAEB.hACA......hADA...,1,-15,-34,19
aILPfBdQSbXKCNOWZDHUJRVFMcgeGAYET,TFEAaGBHLABE.BEHGdEAFQGAC.SDCEhAAAXCCDKGFCOACAhABADCFAJHDCRCGDMICA.cBBBhAGAeDFCAFFGEGHHIAFHfBFCCFDB..hAHANAAA....WCBDhAHA...,1,5,-43,48
eXOgBVLWNPaUCGISMcZDbAEdKFRHfJQTY,dAGGFCGCHFECJDDG.QGBB.eCEDXFFBBDABLAFEhAAA..NEICaDAGhAAAUABBGEBGMEAFDFCAhACAADHEEBCDfCCE.YEHHOACGgGEDhABA.hAEA...,2,-27,-11,16
eFKXNVcAbIBZMPCOTHRWDdJfgGYEQSLUa,BHDGMFFA.CEGCHAEHDFAFdHDD..JAHHGCBH.ECGBQEABhAAALBADaGGFFHFEKDDDXGADhAAA..VABHhABAAFCE.ZFFEOBCA.WEEFgGAGhADA...SFEFhAEA.,2,-21,-13,8
KWLHTYPGAVaOEFMeDQcBZXNIRUfdbJSCg,OECCEDDDFGBB.DBBCBHHAZCAD.....IDFGUFGEdADE.SGDBhAAACABGKAGA.LBHDhABATFGC..PHDAhAAAABGBaGAB...MCCCQCEDXEAChACA.fDADhADA...,1,-24,-43,19
bJafHUcBKFeVLITMZCDGOEPYSRgXAWQdN,QGFDdBCHJDAG.aABCUCFF.BFBDeCCD.LHBG.hAAAMFEEDGFCGGCBhABAEAGBPBEFSAFEhACARDADXCGGADIH......WHFA..hADA.bEDC....hAEA...,1,-3,-42,39
fQTKIGMXNJRFUBHODAWEYLZVagbcePCSd,EDGBLEAFZBBH.aFHF....gAGHbCDH.eGBECEBASGEFhAAAfEACKBCBhABAIEEFMACCXDGGhAGANIEH.FGBABADCDIAAAHHFWGFA.cAEEhAAAdBBC.....hAHA...,1,-14,-17,3
BgGIJCMEVRXfSQaeFbYLTDNAHWUdKZOPc,UFAFZEECOFCBBDDGGACB..JACHMEGFEBED..RDAF.XDAFhAAAQGDA.eAGFhAAAFHDCLBHDhABADGIDAAEG.dFDDKGAF..PFHFIBAHCHAASCEAhACAaGGHbDFA...hABA...,1,-14,-19,5
DfeSQJAMHYKVdcGCTXIgNbRFaBEUOLWZP,MCCGKCDBdFBEGDDE.CGCH.XEGB..NEBE.FHDABGFDEADAUGGDhAAAOAAA.LAFBhAEAZBBHDAGG.SHGAhAHAAFEB.HCGFYBAF...TBGEhABA..bDBBaDFHhACA...,1,-12,-31,19
ZcPAEQbeXRdCTUBYWDKaFGHSVINJMOgfL,EABAQACH.eDDAdGDECDFDBGFEDAEDFHAEGEADHDBE..SAAHhAAAVFGB.ICHBhACAMAGFOAHFhAAAfGABZBAEAFFHXFACTEGAYHBGhAEA......hAFA...,1,-12,-24,12
RSObVIFgLTJNCEZPXYKeMcDAHafWUBQGd,aBEBUCEGBBCBdFGBRCBF..OGCE..IHCGLCAD.TDFDhAAACGDBZABG...XAGChABAKHEGMBFEAGGCfCCGhACA.WFCCSGAD.hADAFHGANCIGEHFAeDAD.DAAAhADA.QCGE.,1,-16,-17,1
KcZBFOdVNWGYQfPDRHMJSeCAgIELTaXbU,EDGETGDD..XABCUCAAKFBBBEAGdBHG...VEDGGABFhAAAQBDHDDDHHEFGJHCChAAACGHAAGABLFHH.hABAaBGGZAFBFGAF.OADA.NCCE....hACA..fGGAhACAMIAASGGD.,1,1,-8,9
VbMAFeXcRWELTHCPBfdOUSKgaDYJQIZGN,XBFERDEEECCG.HCAABAADdABHOEAH.KBDCaFDD.JFAHZFCBGDEBhAAA..bBFAAIGGeCCEhACALFFGCFHEfGGDhAEASACCDIDEIHHEMAIDFEBE..hAFAcGAD...hAGA...,1,0,-22,22
SOcUJBfMKZAIGLbDgPdCYTENaWFQeVHRX,GDGELEEEDHCEdEAFCCED.EGFA...aBAFQGECHFCB.RFAASABBhAAAUAGBBFFFKADHhAAAACDB.IHHChABA.bCDCYAFC.WADGeFAH..hACAOEAG.fEEFhAEA,2,-26,-13,13
MNQaeDAPgXUZHVCEIRcJBSWdbTfLYGFKO,XEDDZAFGCHEC.REAH.JCBFBCBD..dGGH..TCEDLHAAhAAAFFHHOAFCQDEAhABADAEBAACAUCGC.HACBhACAEGFFICHASAECfBBDKEDDMIFE.hAHAaHAC.gGCGhAAA..,2,-16,-15,1
OCGBdHQASFgfXDEVZIMcJLWNKaPUbRYTe,FBAFXCGDEGGH.ZCBEMEED..LFCBKGBBUEBBRGFCeAAG.hAAACAECdGAAAAEESFFFhABADCAH..IAHGhACAWDCC.NBFG..aFGGPAFC....hACA...YDHHhADAOEEH..,2,-29,-17,12
OWPTUQMaZJEebHFGBAYfdRSNXLIcKgDVC,dAADRDDC.SEGELACBKAFFDHCG.CHAB.OFAB..TBAFhAAAQFEBMICGaEAEEEAGHCEDhABABFHA.AHBDNADAIFFAhABA.....gCGGhAEAWHFA...PHFAhAGA...,1,-20,-30,10
SdJYNZfEAIbXWeTQHRBDgVMGKCFPcULaO,XDCHeCDGHAECDIACMEID.KFABFEGGUFEHOCDA..JAAHZBBDhAAAAIAG...IGDGhABAbDEE.TAGABDAG.hABA..gGGFCCCDPFCFaAHFdFAAfADDhACA...hACAWFEH.,2,-32,-9,23
SCQaebEYdINGZROBUVfJLgXDWHPcMFKTA,QDABaCEF.eFCBEBBBdAFDGFEDREDGUGCEJDECLAFAhAAA.DCBCPHFCFHACACHCSABAhABACFHE.hAAAIHHCNEAGBACFfEBA..hABA.WBHHcDDHMBDBhAEA...,1,-6,-32,26
RJOZfXGHPEIaTeSgACUYMLKNWcQFBbDVd,CCFAUDBDLEEEKFDH......NEEF.QFBGBADA.DBDBhAAARABBZAGHfAFAhABAHFFCEGBEIHHA.hAAAaACGSAFDAHGB.MIBEFFFCdHDD.hABAOFAB...hADAPBBH.,1,-16,-22,6
SbIQcDOTfUdNXRPZWEgJLCGBHMKFYaeVA,SBGCQCEBDHAEOABHUGGF.dCADXEEAZBCD.EFHFLEEAhAAABECHHEABFAEA.hABAaHCGAHDA...cACFhAAANAIE...WHFACFCE.MDDA.KAEE.hACA......hADA...,1,-8,-26,18
DKTdECcORLSeVfAMZBQbJWYaNUIFXGHPg,BAFBQAGCJCBH.aEDDUEGF..XDFGHFCBDBIF..KEAChAAAEEEHCHHCOBCF.hAAASBBDVABEMDEChABAZFBB.bADB.WDHHIHHD.FHACPHDEhABAdBFH..cEAHhAEA..,2,-20,-19,1
GDXBMEVRQUJLfYHWcKSTaCFAgIbPdOZeN,..IHFDPDBFZBACGEDGBFGD..MCAFEAEH.QCFChAAAUAGFLDFEHABGKGAChABASHCECECEAAIBdCHEOHAEhACADBBEXEDHJFFA.fHADWCCG.hAEAaGHD...FHFG.hAFA...,1,-2,-11,9
VLcZTCfRKBHOYNeJUFASgWDPMQXaGbEdI,SAACDFDBQFADGACHdCBDLAEDZDECCCCF.KHFEBCFHOFEBhAAAeHAG.FGGBACIH..hADA.PFACaCFDIACBhABA...cAFGfHDB.hAIAYAFCNBHC..hBBA...,2,-32,-19,13
fWGJgQcSPHbaFUKdXNCTMeRDAVLBZYIOE,VFACBDBAZDEF.ODHHEGEHGAEE.QBABSBGFHEDEhAAAFFAEKBHHdGGDNAIGMBBAhAAADCDDLHAA.hABAIADDWHAEJDDF.....cCAGhACA.....hABAaAFB.CHHE,1,-2,-40,38
ZJPRAIGegDBTHbKCQNOLEacVXSYUMWFfd,GDACDCAGHFEGKFFFCCFD.OABDLBGH.EFAHaEGG...XAEFhAAASHFG.MBDHhAAAFFDDfDCHhABAZFBBPADGAHHCeAGHBEEB.......hADA......hAIA...,2,-27,-18,9
NbedHBgOVXAEIWaRZGPKUTMLYJcDQFCfS,EDDHaFCGGDEDKEGA.UGBBMBAH.LCFEJCAG.QGDChAAACAHC.SCBEhABAeBEEBCEGOEBBAIGEIACBhAAAWBBEZFFC.PAFGTFGB.DFFF.hACAFEAB.....hADA...,1,-13,-22,9
BfYQCZFDVRWLTIbGdPHNOaAJeScXgUMKE,eGFCSBGA..gCEEMAEFKFEBBDAGQDAGFFBDRDDALFADhAAAIHDFdGAEhAAAHABFaCGAAFIF.JABEXGGChABAEAECCFEDDIFG..WFCH.....hABA......hAHA...,2,-16,-15,1
RQgMWIYeHDEbKFcSUVZPXfBACdLJNOTaG,dHFHJCCB.ODCCGEAARFCF...QGEEMBGD...ICAAhAAAeBAGDGFGKABAFCAHUDFEhABAZCGBXFAChAAAACHGLAEE.NEIG..aEEB.....YFCBhADA....hAIA...,2,-26,-17,9
CZJQEPefVFbASMcYgDGHOaKNRBdWTXLIU,SFDBMCBC....gGCEHFGHOBCCKDFGNEABdDEB.hAAATCABLFBECBHFJHAAhAAAQFGCEFAC.hABAPABGeAEAFHEEAAFHDIAE.aBHBBDHH..hACAWFFD....hAGA...,1,-2,-26,24
dOVQWAMgZTNBEeYLbfXRKCaFIPcSDHJUG,MCHBZCEHBFGH.eDDFLBAD.bEFHXCAA.CHCB.ICCGhAAA.SFDFhABADGAEJAHBdAAHOBDAhACAQGEDAEIBNIDDECFFfAEBaAHFFGAG..hABA......hADA...,1,-8,-39,31
gcZIbKNHWUMSFYPXOQfBALVTDGRdEeaCJ,TGDBRADBeBFE..CFHF.JCBDZCAA..KBAFHFEDUAGDFDGE...XFAAhAAAODFBBDDDhAAAAFAEDCBE.EHAE..aABGIFCChABA.NBBH.MIBC.SFDFhAFAQGGAfGHChAGA..,2,-34,-11,23
feNMYOTgKRBEZdXUbJIWGFcAQPLCDSHaV,QGAFCBCCDHDC.SCDGHCAFaFFA.eBFCMGAG..TGEGhAAAKHBAECDEdFBB.XEEGhABAUAFGJDFE..WCAFhACA.FDBCAIECLABENDHGOBBGBHCHIHHBhAAA.....hADA...,1,-9,-21,12
KLDMUHcIGEYRJeQWFNSdXfBPTCaAVOgbZ,VADHOFAG.ZDEALBBHUCBC.HFDBGGAHRFGDQBGHhAAAFHGEdABFBAGFCGBHAHAH..KAFEDGDEhAAAMDDH..IAEDhAIAEBAB...eGFCSEEE.hBAA......hBCA...,1,-3,-26,23
PJXTKgYWHUafDcdFLeERIBOVCQZMGbNAS,JEDFTCGC..KCBA....gFDBHBEGaGGGDICCdDBDeACHhAAARAAC.IGAFhABABHAGCEAC.MCFF.NAECAIFGPEBDhAAAXGBD.WCAD..fDHChABAFGGFEABF...OADAhAHA.,2,-40,4,44
DPUGaFQBTcbLOHfNCJSRVAMKIdZYgEXWe,KGBHZACFEHEAeDFG.DDCAUBAD.FEFFBBGD...TGFBLAGHhAAAODADHGBACAED.SFDGhABAAACA.IBEBhAEAdFFBgECEWFAD.PAAHaHGE.hAFA....cAGAhABA.fHDD,2,-28,-22,6
SKYDeLOQafNBPRbgIZAJVCFEHdTGcUMWX,VEEEEABBdDDG.GAEBMBEE...SGEAKGCHeEAALCBGhAAAQDAEaCGABHHA.hABAPDHHgACFhACAAGDBFHAAHCEFUGAE....WHEADADHOAAHhACA.....hAFA...,2,-18,6,24
BcKOAGVQMSFTeIgZERfWXCLDYPHdNbUaJ,VCDDQBGB.MEDASHEC.FCAHTFFC.gEBGhAAAEEGARAFD.XBDHhABADFAEHBBHNIEDaAFGhACAJFCBcGGFKHBG.AABBIHAEWEADCEHDPBBDhADA.....hAAA...,2,-24,2,26
eZKRMBfVXaEAHcCbFSLDTNdgUOYPQGWIJ,CAFAFBEGLBCDDDIB.dGEFUEAF..OAGDQGGEGBDA.hAAAJFHHKBBF.BAHAXDGChAAAAEGFHFDB.SDFFhABANABA..PFCHIDDGeFADMADGhACA.aHAG...hACA...,1,-23,-26,3
cObgYSMBXeATPUdFQDJLRIWNZGVHECafK,UFBBdBECDACARBCE.....IFGCZAFCGDEDHGDGaFHBKAAB.OCBDhAAA..bFDDSCHHhAFAMAAG.BDFAhAGAAAHGFFFHJHACLBBFNBDA.CCHD...cAGEhAHA....hBCA...,1,-13,-31,18
OKdTAQeJDaSbCVfGUBMgFLEYPWZINRHcX,JDHFDGDH..SFEECECD.GCEFBBDFMAFBFBBHLEADhAAA.EADCPEEBZFGBIECGhABA..NBBGRGFAhAAA.HGAA.XAGF.KABCABIBaBFGhACAfCCE..hAEA...,2,-40,-14,26
fPXTUKEZgeDOLbHcdRIAGVQNaCFBMWJYS,GAABVCCD.aBFDFGCBBDGA..JCAHSEDD.XDAChAAAKBBEEHECeAFF.hABADGFALFGBHBGD.hAAAdGAEIHAHNEFAMFCFfAHG.hABA......hACA...,1,-11,-31,20
QgacbOFSeIHBCVXYMWKLRPEJGADfUTNdZ,DFEGUDDCdABAQGDD..aEGFOGFAeGBABCFGCBHA..hAAAXCAAMBDHKEACRAFFJEAHhAAAAGAC...fABAhABANAIC..gGGAcDGD.SAFChADA..hAEA...,2,-47,-19,28
XWPEKSMHfVcRDUZedYOJFQINALgGCbaBT,LFBDGDFAaDAETGDA..XACBEEEDKDBG.HECH.fBGBhAAAVACADAFGUGGHhAAAeFBDdBACJAHDFBADNAFEAIEC.hABACGCF.BHHF..SDDE..hABAMDIH....hAGA...,2,-11,-6,5
WfdBQVNSTAPeKLcgEDMGUOCZaXHYIJbRF,eHDEKBFCLFCBEEGGDDDE.GBBH.CAABZDEAXFAG.ICBChAAARDAFFGFGdAHA.BACChAEANADD.AHIF...PCFAhABA.MBECaGAC...JFGF.fECDhACA.SBBEhAIA.,2,-27,-24,3
OPZGgTdLJDbKNYEVQUfMIHcWFSCaBeARX,XBBCZEEHGDGAdAGBDDAE.KEAEEFGF.QEDCUGAF.MCGDhAAAHACDFAEDSBGEhAAA.CBAEBCFCAGIBOABGhBAA.PHCCTECFJDBBNIDB.YBHFhBDA......hCAA...,1,-13,-17,4
IEXPNYDFZQbCgGHKOJSVeAaTUWMdLfcBR,aAHHTDEB..MBCHdDBCLAGFBGEBRBDD.XABF..hAAANBAAFGBHQFCDhAEA.gFGChAFAKEHFOHDCSBHBAAAA..fDFFhACAEDCCDIEECHHH.....hAIA...,2,-40,-12,28
EHcXLMKFGbAefUDBdWYaCPNOTgVRQSJZI,eBACDCGDdFFE..aEAHCEAC...OHAG..TFCAVDFFQBDEhAAAJABBZFGB.IHHEhABAEDCGHADFXFCAhACAMICGKAHFFDAAABAFBGADYHDG.NAIGSCFEhADA..hAEA...,1,-13,-28,15
IPgGUKbTfZSLaRDcVMWAeYQJBEdOXHCNF,QDFDBEDAdHAFODEAHGFGCHBF..FAFAIAHHGABBKGGDTDBChAAA..ZCAAaHCEDIDEhAAAVAEHACGE..JEHHNDACUBBFhABA..SFEH...hACA..cEACeEDF.hADA...,1,-2,-32,30
WCOHGUDTJAEXBLIPfQbVgFacNeKdRSYZM,BFFELGDE..IGDAQBGE.bCDCFCHD.aDCAeFFEhAAARAAAZEBDMFAH.CHECOABDhABAGAECDEBFABDCXECChADAfHFH..gAEHNIADdAGB.hAAA.SDAFhABA.YFHHWEAB,2,-13,-2,11
aHWVbZIBJLADSMTgEOeNCFcXRfPdGUKQY,DBCFTBBFOCHD..CGHCFFDCRFCA..dAGGKHACQDBFHCFF.hAAA.VADAZFAFBGGAhAAAJDAHAHIF.SABChAEA.EDFFeHDG.XAGF.fDDFhABAPAEF...hAIA...,2,-29,-16,13
KaQZReBTJNLfGYAdWDFCXgbVESUHOPMcI,DBAECGCB...XFDAVAED.UAGDOCBF..MEIDKEEGaAABhACARACFBHDF..TGGFhADANEAC.LAHDhAEA..fECBAHFFFGAFEDDH.HBEBIEHDhAGAZCAHeCGH...hBBA...,1,-13,-25,12
aCSTbABEYVOcJXNHgfPRUDdWeIFLGQZKM,BABDVAEA.JAFHHEEH.....PCAHDHCGdHFB.eCGHIBBBhAAAFDDCLDBDhAAAZDGD.KADBMIEG.SGDFhABAAFFBEHAG.cECG..NEIA..hACAfAGB.hADA.WDCCaCAB,2,-35,-11,24
RaXLfTIHdVZMDgcYEJeQNOKUCbWPSABFG,FAHFaHACLAAC..fGGEHCGHZCEDDCCD..cCFEhAAAJAFGQEAHhAEA.KGEBCCAFWCBHAEDABHHAhAFAXBDFIGGAMGBAEBDF.eDHH..hABA.OFAH.bGCAhACA.SAEE.,2,-16,-7,9
BXcgQMWfFVNGEKDUPaRSAJHdLIZCOTYbe,JEBHLFAAZEFB.CBAC..ODAE..bAFDeBFABBCA..XBCFhAAAQCAHMIEGhABAFEHDGEEHKDDGDAAHPGDChACA..aFAHSHACAIAE..hADAIHHG..hABA...,2,-42,-10,32
WQCcPbSLgJMHaUYfGZdDRFAKIeBOXNVTE,KBDGeFABOHFG..VDFHEEGD.QCDBCAFA..PDBEhAAASAHH.JADChAAAMDFEHABDaFAFfHGBhABAdBAFDGCAAAHEBHCE.XEDATECHWGCAhAGA....hAHA...,2,-28,-17,11
BJWYGfObCVQdeNHARSXIKMgZDTPELcaFU,XECBMFDDDEHD...EEFGLBDE.aGFDUBDABDDEJHBEGCBEhAAAOAFG.bBAGCAGBdBAEhABA.eEFFAHGHIEADhAAAKCHB..gFADTCGD..FGGAhABAWACC....hAIA...,1,-15,-25,10
HVTOWFXPZGegIRAaLdUKQcbBSECDNJfMY,dBFFUFGDQEAGBDGD.CADE.DAIF..JHDAMCEGHDGH.ODCAhAAAFFDDZBBF.GEAEhAAAIHAHAADDLAEGhABA..cBAEEDDG.fGHC.hACA......hAFA...,1,-22,-30,8
agdSADbWOFBTPXGIfNeYMKUJRcVQZECHL,DCABOBBGFECHBAGC..PHBCGABB....IAHAhAAAeEGBMAIBUDFFRFABQCCFhAAAEGGCCDDCHEABaEEHhABAdHDBAEIF..bBDEXEEHfCAB.KAEEhACA......hADA...,2,-20,-12,8
VfQRGDaXEZPdYHSWCKTMBLIFObeAUNgcJ,UEFH..gGACVBBA.QBFDRAEGDEED.EACAdGGDHDCHhAAACGDG.MIEEBAHEIEGEhABAFEAE.OCABhACAAICE.cGGA.fGDHXCGA.hAAA......hABA..ZBBA,2,-44,14,58
aKIQAgJfRWMVGBXDebYdHONZSCcFLTPUE,JHFGRGBCMBDGGBCH.BEEHDDAB..eEFAdFGBHDADZCCH..SAAEhADACADCLHAEUGGAhAEAaAGC.KCFDAAAG...fGEBhAFAXCGEODDBNBBA.FGEBECGG.hACAIAHB..hAGA...,1,-11,-23,12
JagBeRHTMDWLAQPXNYCKcfbFSUIGdOZVE,QAAHXEFE.CBFG.KDBB....fEGESFDFUECBhAAAIDDCdEACZADDECGChAAAJHDEBGEBeHACTAFHhABADIGA.ACAH.NCIG.YABG.FFABOAHBhACA..gGGAhACA.,1,-7,-35,28
deLEPHCZaMFGXfRgNJbIcKADTSQYWVBUO,TDFDSAEH.QGCHVFCE.BACDUCACdDEBLABGhAAAEBHHHFEACHAGaDDGFEBCfBAAhAAARBFG.NEAE.hABAIHFDABGA.DAFA..WHFA..hADA..eFBDMDIHXGGFhACA,1,-8,-17,9
TSDLEaAeXUMGJbfHWPCgQIVOdRNKZcYBF,eAAGMAEGGDBG..fEHGHEFFPBEHCAGGQEBEhACA.ICCFhADAOBHBNEICKGGFZBAABHCGSGDFhAAAEDFCXBEG.UFDE.WAHBhAEAdHFD.YFAFDIAAABBC.hABA...,1,-3,-8,5
ZWgPdDaTUefNCEAcOFSMHLBYRXJbKIGQV,OCHFMFBABAHHRDAC...JCDAKGEE.GABBQEGAZEEA..hAAA..gGBGhAAAdHCFTCADeAFECHHBABAFSFAGhABALHEG.XEEHICAEWAEChACAaCGH......hADA...,1,-9,-38,29
LFfgGNBcbYRPWVQAKIdUaHCETMSDZOeXJ,KCGHdEBFUAGACBBE..EADCSBDF.DCAFeCDA.LECAhAAAFDGBGEEABDAB.hAAAbGEARGBC...PGAChABAWABC..AGHFaFACMBFE.XEGC.hAFA......hBAA...,1,-24,-32,8
EFRDbXeSCHUMQNgTLKaZBdfYJGIWAOcVP,OHFCVDGH.FGGADAID..eCEDCBDH.MDAFQCAD..hAAAgAAETEAELHBEhABAaDCFBCHDYDDFhACAJBFHGGBB.IAHFAHAFPFFHEEBF.hADAXACB.SEGAhAFA,1,-5,-32,27
EcHDTfGALdYXPSZKVOBUgaeMbJRCIWFNQ,LEADdCAA.XACESAAA.VDFDOFCGBGHCaHCEMGCChAAARCGH..CGFEFDCAEDDHDAHHhABA..TBAFhAAAfAFEAIHG.PADHKBFF...gGADhAEA.eHDEhAGA...,1,-20,-31,11
OJTISQbMaHFAdRUgWXcVBfDKZCGYLEPNe,UFEEXFGHBBGEDDDEKEAD..ZECBGDBBLBEG..EGCBeBBBhAAAOBBCJFADSEFDhABAQEGCMAAAhAEAFCAHAIBE..dEGB..WCFG..fAFHhACACHHB.NIDD.IHAEhAFAaCGE,2,-38,-20,18
ZAfDKSdJTcagFGIbOYBLEHVWNRXeCPUQM,DADFSGBBdFBD..TCDHaGEHGBCH.ODECBFGGHFEBhAAAVDAC.RAFCCDHCUFGDQCAGhABAAACBKAFE..JAHBhAAAFHCCIBAB..YFAF.hABA......hADA...,2,-21,-15,6
ILUVedPJYgFRZANCEfBcSbODWHQaMXTGK,CBHAEDGGBHDE..SCDDDFABHAEA.aDBHMECGGADH.LHCAhAAAeAAAdGFAJDFHFDGFAHGH.hABA...NCACfGCDhACAOCCCXGAHIBBGPFHD..hAAA......hABA...,2,-31,-11,20
XPFUgIBYeJLfOKdRTNDCGWAZcbMSHVEQa,ZABEMFDCSHAEHCGDEDAH...aHDCXGEFFDFD.UCECIBGEhAAABDDFeABDLFHDhABAKADDTGADCCCEAGAGbDAC.hACA.......PEDDgAGEhAAA.fHGFhACA..,2,-26,-1,25
NKaJGcWbFZMBPAOERLHfTSgeIDUQXVCdY,EFDELBHBHBBDSAECeAFDDFIH.QCGGCECGdBDE.KFCFJGEGhAAA.GBACbGFEFDAHBHAHhABAAAHAOFFA.fDDDhAAAgGBB.IEFA..hACA......hADA...,1,0,-30,30
GBMUDZJAOCKbLWNFVEfPIcHYXRdeQgSTa,CDEGLCAEFCAG.VDEBEGDB.....IGDAHBFHXFAGhAAAdBFFeFADSCHHhABAGDBAMABCUGFBJFHFADDFOHAEhACAKHEA.WECGNAIG.....fAEChADA..hAEA...,2,-27,-7,20
GYIcPKTQdFBeUSbRMWHfLVgOaXNDJZECA,GCED..YFFBIAAG.KAEHQFBHFEEF.BBCHhAAASHBCMAFFfEDGhABAVEAAOHCEhACAaCAHDAGBEAGDCHHHAEIB.TEGEdHCDeABCRBCH...hADA..WAGH..hAIA...,1,-3,-29,26
XOgNfCHIVWATGDMEdbPZaFecRSJQUKYBL,GEEFEDGGdCAEZABFaAFHFBHH..RADC..JEDEQDAB.KGHDhAAABHBGXFDGOGFEhAAA..gBDDhABANIDHCGCA.IHACAGAGDAIB......hACA......hADA...,1,-22,-36,14
TMSJPWAXaZfNUcEGKLYVQIORBgDebHdCF,ZEFEUGEFEGCFKBCBLGEG..QEFDIDDF.BECEeDBBhAAAdAFEFABGMCAD.SBBFhAAAPAGFAGAHaAEHhAFA..NDIEGEAG.OAHBDGIB.CHHD.hABA......hACA...,1,-16,-23,7
KZEUBdOQfbSRFGITgYaJWAMcCeHLXPVND,CFAGeCFEHCAELDCC..PFECDACGKGEEZAEFEAEHdCGE.QECGhAAASGBGFHBGIHHGhAAATACCaHFAJBAGAHGDhABAMFIF..XAGE..NAIABBAFhABAOEFC....hAGA...,1,3,-29,32
IGQOPdXUDVWfFaEKNTBAMbLcJgRCeZSYH,LCBFJACG.CFFBZADESEEAHGCCGCEHQCCC.OCAHhAAAPECG.dGHGDIFEhABA.VGCEfAADhACAaCGAKFBFBFGAAHACMIAC.......hACA......hAGA...,1,-6,-31,25
WAZVEcaXTbJgYBfUQRMPHCOSNeFLGIKdD,ZDEFVDCAaDAE....TCADJBAEBHBFUAFE..MAIDCCHAOFHHhAAA..SBGFhAAAFGDBGABHIFAChABADEAFAGGB.EGEDXGEDgADH.fGHGhACA.QDGDhADA,1,-22,-29,7
NfBRZLJDEeTdXUSOMYGQWgFPKVCbaHAIc,..IFEGfDGGBHEAZAFCLFBBDCBCeFCGdBAE.UACGSHGAhAAAMAFG.QEAAhABAFHGEKDDF.CCHGaACGhAGAADGDRDGHEBGAXDDB..OBEDYHAGhAHA.gGFChAIA...,1,-16,-18,2
FbORNGDZELgXBIPUaYWQMdfeSJKHAcVTC,TBDBFEHDOFAH.GCBAEFGDLAGB.BACEIHDDhAAAUEADaFFHQBFHhABAdBBESCHHKEFBACIFCABAbDDHhADADFIDZGBE.XDDGWAEC.MAAD..hABA......hAEA...,1,-9,-16,7
PfKUWVOTXBLHNYQbSeJdDgMGCZIAacRFE,RCEEEFCBKEGBUGFG..OFACBBACLBHBHACFQCADeCDADBCAhAAAMAFGZEAF..AFFE.aEFHhAAAFCAE...fDFFhABAWEHH..XGCANEEC.SBHBhABAdFHACAFD...hACA...,1,-14,-18,4
NeIJbFZLUdYEPaBDWQgCOMcGRfAVKTSXH,KDEBXBACHEABeHDA..JAHHFABGZDFBUFCEEDCD.BAHF.DGFGhAAAQGCB.hAEAgBDECAFBODBAMCEChBAAGDAGAHHCSEGGIFHF...hAAA......hABA...,1,-23,-25,2
VEgbWKTIRYZfAdFBeCGOPUHaDMQXScNLJ,FGFFBFGBCGBD.GCAB.UAGBaAEH.DFADMDAF..SBCEhAAALBCFEDFE..bFBFhABAKAHFRGDE.ZEEA.dGCAPDEEhACAXAAB.NEIC.......hADA......hAFA...,2,-26,-24,2
IZUQBgDALSMEFROJePXVGWHTfNYcdabCK,LAECEGFDFDGC.OFBDeADE...XBFCGCCATAABhAAA..YDHHhAAAdHCDCBHDIHHAUABDQDDDhACADGAEAEFBSCADMFHHPGDC..hAIA......hBAA...,2,-22,-15,7
NeOPfZEAUdXKGWgcDITSBQRaVCbFJLYMH,UCBBKDGEGFBB....gGBCDDACIDDESBGFhAAABAHARAAE.CFACFABC.LEFDhADAMCFE.eEHBhAEAOEFFPAEDEFHHAIHCdAHAXEAC.WACEhAAA.....hAGA...,1,-19,-27,8
LEHbIeZKRSfcGaVPMgDAWYCQOdUXBTNFJ,CHAEdBBGBFHGFADCLEFCHCEE..eGBERAGB.SBCFGDCAaFHHhAAAMABGDGGF.AGFCQAEDhAAAOFAF.TDCChAGANCCB.JHEE.EEFA.......hABA......hACA...,1,-10,-27,17
AEYPIcUQRZVWeaCLBDKNXHGJMFdgfTbSO,EHEC..PGAEUDCGRBGDZFFB..eFEACFCEDDACKAAEHDCCGEAGMAAEhAEAFADB..dAFD.TBCHhAGASAFC.hAIAOEHDYEHBcCEA....WBFAhBAABCBC....hAIA...,2,-21,-12,9
UFLGcJZPNBMeAdRbCIgVWaXYfEDKOTHQS,dCCGCCAA...IAHCVAGD...aDDFXEBA.EEGCDEGEhAAA.TEABHACDSGGGhAAAUFFDFHCELACEhABAJFEDNEAE.BCHGAABBbBED....gGAAhAGA.fBDBhBAA,1,-21,-31,10
OULgXPWecGSAQECbaVJDZKdfRTMFHNYBI,EAFFaDAE.DIEEKAGF..dGDBREED.FDBDHFAC.BACEUACGLBBGhAAA.XGDHPCGFeFADhAAASGHDAIHGCEDD.hABAJBHD...fDDCMCIFIGGGhAFAWAFD...cDDAhAHA...,2,-35,-15,20
fPeKWcYNTBESRZFIAJOaCbDQGVXgULdMH,aAGBCBFADAEEGADG....VEEFXBBBLBAGdFBHfHFHhAAAKEHB...hAAAWFFCYAHH.hABATDACSDAGFECDAIHEOCDCgCFAhACA.MAIHeHCGBHBFhADA...,1,-21,-24,3
ZFRaCHQeUXAdIPYcBVMOgTELWfJNGSDKb,dGFB..ICHH..cCDHBECAOACEEHDELAAEhAEAfGGHJDFAGFADhAFADAADKBFBZAEEFHBGCBBE.QEFBhABA.XEDHAAIH.VCACMFFChAGAWFAF...NIEH.hACASGHH.,1,-9,-16,7
AZFTXcYBGfHbWNPLJIdOCMgSDQEReaKVU,TDAAXAAD.BDCEHEFB...bCDGNCGC.LFHB.dGCAhAAAOEEHCEEAMABCDBEHEGABhAFAaHFGKAFHUGAAACHHFBBG.hAAA...YDHFfHEBJAFGgDABhACA..SCHHhAHA,1,9,-40,49
MVZSWaXUIRQEfDgPFeOGbNTJcLHYBAdCK,dBEGKDCFMBBEZGDC..SADF..XGGAUBGARCAFEDDDhAAAgEGH.FAFEhAAAOFEEGEACTGAFhABAcEEB...YFDFCABA.aCCAIHHChAFADACAPBAB.hAGA...,2,-28,-12,16
YCRPbdMNLFaXEcABHSgIVfJWUZKDTOQGe,BBDBHEEDSBBD..IBBBJHAGUBFEDABCOAAAhAEAQGCFGEGACDEGREAFbFAChAFAMFGDLCCH.hAAA.aDGA.EAFCADIB.gDCD.fFHChAEAKBED..hAFA...,2,-41,3,44
bLPDZWYadSQcHCGVBUMKOAFJXgERTNefI,JFDFEBDARDFF..eFAB..IAHHLCCGZEDHaCAFdCAC.SGAEhAAAHDEGCCHEGAEHhAAAUBBAKHCG..AHFHFGGBhABAgFGHNECE...fBFChABADADE.....WFAEhACA..,2,-17,-12,5
CDMTARLdgBUZKNIcFEOYJVWebGfQSHXPa,dBECUFAHKBAB....NIAB.IGAH.FCHHEEEG.JGECeFHBhAAAGAAG..SCBHhABAXAEGCBHBMADBhACAADDFLDHBBFCHcDED...OFGHhAEA..WHFAfBFHhAFA,1,-29,-42,13
MJSNCaWZFUdRbVPKEQLgXTHGIDfABcYOe,BEBHOEBHeDHD.MBDFSDEA.CCHFZFFAdCAHRFEA.VAFEhAAAEBDCLHEE.hABATABCIHHGADIFJAFChAAANBEEFFAH..PBABKGDF.QFCGhABA.....hACA...,2,-26,-8,18
BIMLTJCKVdRDXUOHGYQWefbNSacPAEFZg,ECDCZFDGBCFDLBBFCBFB.dHCFDDAGUDFG.HFADQACD.hAAA.eAEG.NAIGaEEBhABAPHEC.AEFBFCHBIGHChACA..TEACKADD.XDCEhAAA.OHAC..hABA.WEHHSGGD,1,-1,-33,32
UeXNYBERcVKPLSOFdTIMabZGfJAWHgQDC,HDFBDGIDCDFD.UCBE.eGAG..NAEFBBCHEAFERFCE..KABGLGCEhAAA.FABBIHGFhAAAMDAE.bBFEZEBGfADBhABAJBEA.AIAG.....WHEAXDDFhAHA..YBHBhADA.,1,-1,-49,48
BecGAgDbfEORMWFQSLCNYJaXHUIZVPTKd,DEHDEADDRDDFFBBB.LFAGCCFH..JBCHHCDAZGBA...TDBBhAAAKGFAdBAABADH.eHDAhABAAFID...fEFChACAOAFGMBIHSAHDaEAE.IBFFhADA..PDGDhAAA..cGGE,1,-10,-36,26
YSgaLIJFDANOKGEMeZTbcRXQHfVUBWCdP,KACFGCDHEFDF.MBBFZEAE...TFBHRGFEQAEFHFGFUAGCBBAEhAAAdGFC.SADDhAAAaCGFJEEC.AAEHNCAC.eCCDhABA.XEECfHAD.CDAB..YCDAhABA....hADA...,2,-30,13,43
gAbMKZeLTOSJDQPHBRYWXGcFCaUdVfNEI,KEHFeCHBLHBAOAFADAAFQGFC.HABCRDBGXBCBhABAFCACCDDCdFCC..VGDCfCEDhAAAICFBAEFHMFABhABASEFEBBGF.YFBD...hACAcGGDaEAF.ECAF.hAEA...,2,-14,-12,2
HTKPdDRVNgUbSZFafEIJBGQeOWAcXLMCY,LFEBMDECHDAATFBFKAFEdACD..DCABREED...VBBDUGCFZAFChAAAFCCGEHGABHHF.eAAFhAAAADFECHDF...NBIE.SEGDhABA...IHAD.hADA......hAIA...,2,-21,-21,0
gNYQbWHVaMEPRedTFfBcKAGXDIOZCSJLU,DAFFOAEDCGCH.LAADUABB...NEIC.QEGFHGAC.MEBAhAAAECDBREBG.dFFBTBGGhACAfGEG.BBGDhACAAEADXFEGSAGE.YBBEhADAbADDaAGG.FGGHKGHB...hAEA...,2,-25,-5,20
dNQacDTWbZYgXSGRPMUBeLVOfEIAKJFCH,KADBCHAHdBEBQABE.DFGHbBAH.ZDCD..XFBCREEE.hAAAMEIDBDHELEEBhAAAfFAFICFBhABAAHHHFHCG.NCHA...aADBWAHBSHEA.hAFA.PHBE..hAGAeAFE.,1,-14,-32,18
NbEOCGIYLTSUXFQPZBMVdJgfDAKReaWcH,KBDGaAFGHAABEHBC.GCDALDBFUGBEQGGBBBHDdHEBJEACDABCAEGGhAAA..RFFE.eFDB.hAAA..NAED.CDHEIADAhACASDDE.PBHD.MFFB..hBAA.fBBFhBBA...,2,-26,-14,12
bVfaHcDPAYQMLegRGOdKFUJXNSZCTBWEI,MHCGLCCERCDA.dADFKBCAJFEC....SEGGTGBBBHFGhAAAECGE....IHAEhAAAfAGCHEAGDDIBhABAAABFQGGGeCAFODDBFCAC.NAEHCFEC..hACA......hADA...,1,-18,-28,10
ULdBeFVEHYKWCSbJDOQAXZGNPRgMfTaIc,XDFCZFFAGEAARABB.MABE..aFGCUBDABGCHeDCBFAFFEBDEKAHF.hAAA.CHFG...JEAFDCIBhAFAAAIB....NEEG.fEGBhAGA.IBBALAAF.dHFDhADA.YAHF.hAIASDDF.,1,-14,-20,6
ILRaWTMfPAXCDYUKVgNGcHOEbJdBSQFeZ,CDGCUADCKGCC...VFBHGCAB.HAAAOEFBEHBG..dGGFSEGEhAAAFDEDZAFCLHEAhAAAaAGF.MEAFADBBDDEC.hACA..NCAA..bBBF..BECA..IHGBhABAWBEG.fDDEhACA,1,-18,-29,11
ENLIHeGBPTUgMYFDWVARbdXJfQSKaOZCc,RBFHdHGD.JDHHQBBB.KHDCODBHCFFH.EBCCLAHBhAAAHFDGBHBFTEAEMAGHDIFEhABAAHAF...XDDChACAaECA.ZEGDNABBeDDE..PADA.hAAA......hAHA...,1,-8,-27,19
NDTeKSWcCYVPRbLFEOIBfAUdXGJQZHMag,UDEHXGGGQAFCZEDFHCDC..aFBHDGBFKCCBSDAChAAA.CACD.PHDALCHDhABAFAAAEHGCBAHEfECEhADAAFAG.dAHAJECFMDIH.TADHhBAAWBEC......hCAA...,1,-15,-18,3
VNEXYCeQTDFMcdLIbUBWaPRfZGOHJKgAS,SGCEVECD.EAGGXFFF.CFAG.TEFE.MEAFhAAAdBEGIAAGBHCDPCEEhABARBFEZCAEOACBKGEBAACF.hADANEBD.eHAEDEIDcBDB.....hAEA......hAFA...,1,-16,-22,6
eQPRJNDFdbTHXMSOgZALacfCYUGIBVWEK,aEGECCDBUBBCBGBF...EBAAeEBB.RBGF.DGEEdEGDHDEE.MCEChAAASFEDODABAIGGLAFChAAA.fGGDhABAICCHKHDG.PEBENEAC.FGHF.hACA.bFCH....hADA...,1,-20,-27,7
QINgPfMBRWKOVFbHaZYLeUCcGJEdTDXSA,QFDA..gFCGMBHBRAAHOBFDVDFFHAEEZFBBLADHhAAAeBDDCHGHJCAFdGGADFIBhACAAAAG...IFAEhAFAPHAEBCBBKDBA.aAGA.....hAGA......hAHA...,1,-13,-15,2
TCfRBXIDFAOaePdcJgbSZELUGMNHWYVKQ,eCEBdCAFJFBC..SDHFLHDAUBEFGGBH.MADBHDDCVCAHhAAAKEHD..CBHFBABChAAADHGEAIEGaAGA...cEBEhABAgGAD.EDAHNGED.....hACA.WFAD...hADA...,1,-7,-31,24
ADYGQKRgUPBENJFdITSCebacOZVMWXHLf,DFCAGACFRCGH.UCGGEABE.FFDE..dDADSDCDCDDE.eAFEhAAAaGHBZGAA..VGFEhABAXBBGLDAFAIBCKFFHhAAABDDG.NIAB.TAFD...cGDFhADAMCAG...fFADhAEA,2,-28,-21,7
JFRBVLDfEIgKUcOSAXPdaNYGWMTHbCQeZ,XABCaGDDGBGE..MEGBHADD.bGFCQAEG.JDCDhAAARFAFBDDGDHDA.ECBCICHGhACAKBADOAFGPDAHhADA.dHAHNFCB...YHFG.CCCF.hAGAFAAAfEEChAHA...,2,-25,2,27
GTBcebUJIfPDFXZHONgVLMSRKCEAWQYad,QBDBdDHCBFCDeBAAJEAB.....IAFGDGEGFCFDZGFGHBDAhAAAOBBF..NICBLDAAhABAMDDBKHCAAEHFaEFBhACA.TGGH..cAAG.fGBChAAA..XFDDhADA,2,-45,-13,32
cUDEfIONQWCXFdTgRZJSHebABLGKVYPaM,LFABKDFF.VAEHPBHD..aFGDUFGC.DADEEAGE.OBBBhAAAQDCG.hABACHEFFBDEdDEH..RDCDJHCChACAeHAGAFFBBADFMBAGfCAANCIA..hAAA.WGCC...hAIA...,1,-14,-27,13
CLNAfQeYOGTUaBFSIEZgDWKXVcbdHPJMR,QDDDeFHHOACDUAGDBBACFEAB..SHDEEGGGZDBDDCHFXCFDhAAA.VEAGhABAdABHJFDD.CHADAIGEfFFDhACA.YAEFaFGAICAAKAGE.hAFA......hBCA...,1,-23,-26,3
BRIXcCWTSVYMNFJaGPOgbUefHLDQEZAKd,BHFFXBFGCFAB...SHEGVEDE.MAFAFCDGGAAFhAAA.OGBCUEFHeABAhAAALAHHDCDFEGBAAADGKGGEhABAdCAD.IEBF.WDHBNAGA.aBGA.hAFAgGGG.hBFA...,2,-30,-10,20
YIeZTbXRGcgEMWAFHDUCSONdfVQKLJBaP,FGHDHEGHDFEACCHA..OGBAdADA..QAFEJCBDBDFA...aCCHhAAA..IABEhAAAeABFTDGARAEB.GFABhABAgEDEMICAADFGSHAE.fAGDhADAKAHB..hAEA...,1,-12,-39,27
BbXLaVFWQHdYMJSgfcZCATUEeRPKIOGDN,EAEHeDAARFDD.KCFFGCFGDHAE.BCCHLADCFBACHEADdEGG..MFIBhAAASHGA.fCEAhAAACFBCAIBGTBAGICHHhABAOFFHNEDEaAGA.......hABA......hACA...,1,-7,-31,24
LPBfHQAEIDUSdgKbYFGZXJNeCOcWTMRVa,DEEEUGCAdACBKFABFGFHZDFG....JHACeCCA..CCDH.OAAChAAA..TBAAMFHBRDAEhACALFDCBGFCQAFBhADAECGG..IAFESAHH.hAAA.YEHH.hAEA...,2,-42,-26,16
CJDAVKOBbGLESIaRXFZTgWdYQMfNHceUP,VDCBOBFE.GFAFEFEA...aFHFXABBFCAGZCDH..TGFFhAAAdEAGMBDE.NBHGHGEGhAAAeABCCDFA.AAIHKHAGBHAGhAEASAFC.IDHFWCDE.QDBHhABA..hBAA...,2,-17,-10,7
fPSFBECGWcRTOdXJDAbUeNLVKMHgZIQaY,UAGGeEEELACAKBDGHCABZFFEQCCB.aCGC..fDFDhAAAPHACBDABEGBCCHDBhABAGEAD.WFFGhAAATABCdAGFDIFEAFFA.NHEF.MFAF.IEDChADA...SHFAhAEA,2,-16,-13,3
TIKLafEbSGgFPMdHCARcJUQeZXYDNBVOW,JCDCeABGZAADDDDC.BHDH..VFGFOBEE....IEAGhAAAKDCDaFGE..EEEE.hADAGEAAgGAHhAEAFHFGMADCCEFHAIDE..UAGGXDGB.NAAG.WACAhBAAfAHESEEFhBGA.PCCB,1,-21,-31,10
STcQDgEaNUIdCBHWFMPRJVKZefOXYGLAb,TBDHQCCC.ECGCaGBA..UFEGdABHHAFAMAFH.JEFAZAAFeCAGhAAAXAGCLFDBhACASEBGgGGBhAEAIHAEBHABFCHFPDHD.KACGOFFHhAFAAHIHDEECCHGA.....hAHA...,1,3,-4,7
GNIVDCBAQcRfaHePZYdMSJKFLXgEOTbWU,REBBaFEAHAFEZDDE.dHDB.MDBAKBGBLACH.EFBGbDEA.UACChAAAGAAC..IGHEhABADIGGCHEGBFADAHAEfFDDhAFAPDHD.SGGDFAEAOHAC..hAAA......hAHA...,1,-9,-18,9
BPNXcFDKALUfIbCGOWQgZSMYdaEHeRJVT,UDFG..fEDACABEGCDE.QCFAZGCA.MDAAaAGDEGGEhAAAHABE.eHAGRADE.hADAVFFEBGAFPAFAhAAANIAD.XEAFDBBHADCE.......hAFA......hAGA...,2,-27,6,33
SZNEABUPDKeGCHfTMLIbOgYaJQRcFXVWd,UDGHDBFHeCBAGCAGHGCEMCFALFEE.OFAFaAFERCCDFAAAXCGEhAAA..dFFHZABGhABAAHDHBHHBCHHF.IADGhAFAbDAG...gGAG..hAGA...YFEFhAIA..,1,-12,-18,6
TcBMYNPabDWUSReAVOEJICgLGFfQKXZdH,OHFGECAA..JEEECHDDGEAHFBGG.QAGEZFADdACHHGDEBFGChAAAMAFG..PBBChABADCIHSGGBhAAAAAEF..IDAGfFCAKGDETGAGhACANDDF.WDEC...hABA...,1,-19,-24,5
NgeIRPSJATGHKZfMBUdQLEYWCDOcFbaVX,HDADZBEGBAEEUGABdDGFQFDBLAAF.EBCCCFHC...OCFEhAAAFEBB.aAFD..XFFHhACANIEH..IGHAhABASAGEADDE.TFDHfABHMICADDDHhADAbEFB.....hAEAeBBA.,1,0,-34,34
YOQTgNaSFEZKcCILJPUBdXWeGDAbVHMRf,HFAAMIFGRDDEOFFF.QADDTFDA.aFEBSBEAhAAAZDFCCCAELAHBUFAFdBHCXCBDhAAAeACCAFHG.fBAChABAYFHF.FCCBEAFEIGGFBABBDDAD.hACA......hAGA...,1,8,-16,24
GbcDSYQWOMFeEVXCaUfHIdPABKNTLJgZR,BDAAKDCALFBBJHFE.ZABERFADGCECDDAB..SHGChAAAQBCCMGEAFAFCECGBCBHA.hABA.UDGE.HBEHhACAIFHHAHAE.NAIC........hADAgAAF.hAFA...,2,-25,-25,0
QNURcSegFXdWOJCYbILABKVDGEPTHZfMa,BHACKHAEDCFEEECDHDBGZCBC...aDGBQCGFUGGF.RFFHeAAEhADAXABAOBEG.CFAG.hAEAIFEGAGEA.PAEAhAAAMFIBSHCA..FCAB.hAFAJDHB.....hAGA...,2,-19,-19,0
IGNYEFOXBDWbLCKfcVJRHPeadUSMgAQZT,QAACTDGC.GCDGEEDFFDABOAEFBBGHDDCFLHEA.hAAAKDGAVBCERCACeAGHdGACSFGAhABAMGAAAGFD.hACAIHHGYFFCbFED..CEAG...fABAhADA.HGBAhAEA..,2,-8,-2,6
VcdaXPFZKCTBQbSYJDgAEGeMNIfRLHOUW,eCFHMCGD...IDBBREBALHCC.OADEVFCD.dBHEaGAHFAAGhADAKBCHBDCF.QFGDhAEASHGEDCBBAAFGNAAGhABA.HAFG.cEFE.....hAGA......hAHA...,1,-15,-28,13
MCIZaFXcYDfRNVBETQJWdKHAGPLSgUebO,LDCASGBEeBFGMEGHZFAF.FGDFXECADCCC..RFFDBACFhAAAQACA.WCHFhAAAKBADAEAGGCAD.hABAgAFFOFHFCAHCaFCBfHGF.hAEANIBB......hAFA...,2,-26,-8,18
dBQgERSHCZIUbOaVWcPFXTMNDfeLKJYGA,QEECRDABCFEC.UADBaHBC...VCBF..PAFDFGBGMAGHhAAADIEELEHBhAAA.JABAADIHdGGGBFGDEHDEhABASDDGIAHAOFHD.WCADhACA......hAEA...,1,-21,-38,17
HYeCdXOWAJBLKaIZfUREbgPVSDcTNMQGF,JBGBLFAD.aHGGZBBC.UFAHEDCD......gADHhAAASDDGDGECTEGEhAAANEEDMHBE..QDAFhABAFBACeCFGCBGBXGGAAICCBDAFIFHChABARFDCPACG.....hAGA...,2,-33,-6,27
bEZKCPUDFIHYLVJdWNAaOSBQMgRXecGTf,aGCBOBBGBCCA..QDGARCEG.XGCCeBADTFFChAAAEHGGZAFGKAGE..UDDAhAAAIFACHCAB.LECAhABAdGAANABHAFGD.SAEG.MIFG.hAGA......hAHA...,2,-19,-7,12
VdRfWGZQKNgMBAEaUCTSXLHbPDFeYJIOc,EDHFaFCB.UECG..TBEDLBCEHCAGDCABFHFA.eEEAJGEG.IABBhAAAOHAEdAHGfFGHhADAZAAF.KAGEMFIDhACAAFAGCAEF.SDDE.XFAFhADA....PBHFhBAA.cGDG,2,-23,-5,18
YFdeRPEZLMSAHKXJcNGOTfQVCUWIDBbag,HEEEJAHDGDBCOBEB.QAFBCFAG.UDBADCAHaEEHFGGGdBBDhAAARABC.EHDELHEGhAAA.ADIBKDECNCAG..TCGChABA..fFHG.WHAAhABA.BFFBgGAAhACA..,1,2,-39,41
AYXPVSdTIaKCZOWFgLRDGMHcBeJUNbEfQ,XBGFSDDHdADC..aFBCCGFD.ZAFFOCBDFGGGLAAB.hAAADDIFGDEBHACABHEHhACAeFAGNHAHECCDADDB.PHAChAEAIABCKAHH.RAEDMIDG..cFDEhAHA......hBAA...,2,-13,-9,4
RTdOXMKLWNEcgBZeHFaJYQfPIbCDAGSVU,SEEGRDAGOFAH.KBDHLDGH.EAADgGEBBEEGZBFAFCCAhABAaCGG...JACEYDBFhAAA.fABChABAPFDH.CHBEDGGEABGC......hADA......hAEA...,2,-39,-24,15
bBJEXaGIRFCZQWYcADUVHOTKPMdNgSefL,UEGBVBDG.HBBE.OEAGKGBHMDGF.dGHESFCCLAACBCCGhAEAJHEE..aHAGRFEDFBGAhAFAQAFE.hAGA..cDDAABBEDDID.NAAD......hAHAfGDC.hAIA...,1,-14,-27,13
MYbERHeQFUCdDfOPTNcKZIVgXSBJWaAGL,MFEBEHBGHCDGFGFE.CFAE.DFBA..ODBC..TCCFKCGCIGHGhAAAXCAHBGEAJAFC.hAAAaDHDAFFD.LBBEhABA.bFFDQCGC.fABEhACANACF.cADH.hAHA...,2,-30,-17,13
IVTDcUdCZAXYaWfLNgQBEFeGPSHbORKJM,XGBAaCHFLFCG..QADCEDBHeAEDGGEFHCEHOHEEhAAAKGAGJEFAIAHEhABA.DFGCdBACABBBYFAEhACANIAHBAFBFDDBSEED..MAAGhAHA..TCBFCBCG.hAIAfCGB.,2,-4,2,6
DYbfFXZdUeHaMBAPVSCLcIEWKQJRTNgOG,VFDACHAALBDD..EDCAKGEFRCGH...TEFGODAB.DFBB.hAAA.fBGHhABAXBBCdHGHUEAFHACCBGHHhACAAAIBSHAAIBBFWDFE....hADA......hAEA...,1,-15,-37,22
CVGHQgLfWUaPDKYFZIRXNJbOBdcMeATES,EFFGCCDDGEEHHADEQDACLCBD.UEDEaHCA.KBHHFAAG.RAEG.JGAAhAAABDGBMIEA.ABAH.SGHBhADA.fGAHhAEAWCDGDIAAIEHBNAIC...hAGA.dCEE....hAHA...,1,-15,-19,4
DNSTUHICOJVEKWdYPgAefQbXaBGRZMcLF,QGDCXEEHGCACZBECMDCDLHBAFBAH.DFHB..SEFFhAAATACCHCCGCHBGJAFEhABAKCGFdGGFPAFG.hACAAFIHfFCHaDDGBEAA.cAAG..hAAA......hAEA...,2,-19,-9,10
KMgSRHWNeXCaTLJcVOAbEIGfZYPBQDFdU,EEFFGBDBZAAHBEHADEDCUGGC..KBEBMACHRGCAHBGH..eFAHhAAACDDHLFACJCHD.OADGhACAIGDH..hABAfGHG..YAEC.hAHAFDABSGBDhAIAWEDA...,2,-25,-25,0
ZCRQKEbNTHdDWVgAYPJFLIGSUfaBMXOce,JDCFFCFGLDBAGAAA.UEGDBAGG.MAIHOADE.ZEACQGFHhAAAKBBG.EFAG.hAAA.bFEHHEEE.DADGhACAgGAHAHEDIHAB...SCHDhAHAfAGD.aHGA.hBAA...,2,-23,-22,1
dBDKMLHWGTXbEcSeZQIONJPAaVFRUgYfC,aDEGVBBC..REACUBBC..fGCBBHACKHFC.MFFGLCGHhAAAHBGHTEAG.hABAEEDDeAECIHHGhAAANGEHAIEC.FAEECDAG.DEEEXGBHSHAG..hABA......hACA...,2,-27,-12,15
BgaFecbVORMSHKYAZfLXQWJIdGPENTCUD,ZECALFFBQGAAJFHFGDCGEEHH..TBFBDAAGBCCF.FCGDhADAeAAD..VAEChAEAOHDG.RADHMAFEhABASHAGKDAFAEGHfCHA.IHHAhACANCBCCCED.aDDE..hADA...,1,-9,-27,18
GVaOJHTKdePEFNWZRfUMLAIbcXDCBgSYQ,..IFGAXDDABDCCSGDAGBDBOHBCHABDKAEGeABGhAAAFBHBZEGFRGDG.MIAEAHHBDGBGhADACEAD.QDEFhAEAaECCJBAFdGAHNBBA....WAHH...fAFBhAHA...hAAA...,1,-6,-13,7
JNVUXOcLeFRWISKPGTCDfZgQbBaHdYAEM,MBCEJFDH.UCEHOCGDLDAB.FHGCIHHG.KCBGGGAFhAAA.CFHHDEFHZBEDQAAFhABAaFCA.hABAHFFHAEADNACD.XGACeDGHSCCBhAHAfFAB.BADD..hAEA...,1,-13,-30,17
TfLPbYUAgcNECaVMIBGOXJFHDKeQdRZSW,...NEDG.CDHGaCEA..MABEBACBGBGGJHAE.FBCADBEEKHGC.QFEGhAAAdGGARAAH.SGBDhAFA.fBBGhAGALFEDYEAGACFAEDDE...hAHAIAHB.ODCAhAAA.,2,-51,-11,40
HCfUPEgbGeXQVTKLRAaYMcFSZdJOIBWDN,MFIDSBFFZBDDdCFCOABCBHFC..DBACCCGDUDCB..EDBFGFEFhAAA.eHEGXFAGhAAAQGAEKHAGAGFC.hABAaEABFGDH...ICABNAIAfBAEhABAPCHB.....hADA...,2,-31,-19,12
UFfZEObNXTGBQJaARIMHYeLPDCVdcKWgS,MFFFeFFBDAGFdAGGKEFE..SCAGUABGZFCF.EDFD..ODBBhAAAbBCD...TCDGhAEAQFAC.AAIDIGDBhAAA.LHCACHBD.WAEFhABAfGGG.XADAhAIA,2,-33,-33,0
eLPNSHgFdaEGIBVCWKcMJAZQTXbYRODfU,QCEATFAD..XAAARDAGDGDEeHFCLAEF.PEEGhAAANAHGHGBE.FBCCaFGDEBAHhAAAIDCEBFHFCFAG.KGDHhABAMBIHAIGA..bAFE.OHAESEEGhABA......hACA...,2,-13,-5,8
HTGLRVbJWegYNXIKZDBUaSQAOcMfPdCEF,MBBBdEEDCADFHCBCGFBDRAFC...JFHBeDHH....NCEDKDEGBGABhAAA.SHDChABAADDB.fGHAhACAFHDELADEbFCG.WAAF.......hAFA..XFFBhACA.ZCBDDDFC,2,-28,-12,16
RBFHPDKGafcEAMeJWIgVQOUZdCXSYTNbL,JEGD..gGFDQACGUEBHdFCACCEHSFAD.TCBGhAAANAICLBFB.hABABBAFPEHDDECGKEAFhAAAaHCEfEFHAGIF.eADGWHCAICHFhACA....hAFA...,2,-34,-21,13
VOGNaPBdgIJcXQSEUeYFLCMZAfRWbKHDT,RCEAKEECDGBEOGCCGGEH....aFBBBAGEdCBD.JDBCQAGFhAAA.EACCeBCGFBEFLBAFhABACAEFMIBEAFFD.fEGFhACA.WFADTEGE.NCACIAAGhACASCGA.UGGFhAFA..,2,-41,1,42
BgSRDMAEcOWZNeVCfaQLIYbGXHJdKTFUP,OAFCZBECeBAB.CGGC.aGDCLDDH..bCCDHFBF.dDFEKCGDhAAAFAGABADGSFAFhAAAMGFAAAEAEBBF.NIDB.fHEBhABA.IHHF..YCHBhABAXBBF..hACA..JCEF,2,-24,-19,5
IDHZGceLaCMgWSJBKFfdQEXNAbURPVTOY,RDBFVDFHOCHH..DAEDZEEDGFBBLAFCCBBA.MBBA..SAFChAAAKCCEFCABdGBHEDCAhABAAIHA.UDAA.PAHDhACAIGHH..eFHF..aGFDWHDAhADABFDE.....hBAA...,1,-21,-22,1
QgJSHNOBFLCWVDcKPXAUdMIbEfGeZYRTa,MEEAEBFEGBCCZFGDRFCG.QEAC.SFGBNDBHBHDGFHAALEFChAAA.CCADVFDDhABADEBDKAFBAIAC.UABCIBBGhACAeFFH.aAFA........hADA......hAEA...,2,-34,-6,28
SCcNfVTXLdUbAEYFWZIBGQMgHKeDROaPJ,FACFZFFCBAAAMDFGHEEADCGB..OHEA..aGBG.SGCAhAAACGAF..fCAGhAAAXGGEdBEBUECAhACAABBFWAEEQAFDKHEAeCCBJHAG.NBAG.TBCAhADA.....hABA...,1,-17,-31,14
SaCRIEVWOJMcUXdNGYbQKeZgHDAFLTPfB,TGAABABESEDD.RBDH.VDEDOCFEJDACUACA.dHGHhAAANEAC.GAGG..hABAQGFAKFCGeEHF.hAFAgFBDAIDE.PAABfAFChAIAIDBF.WEHB.hBAAMICE.,1,-3,-41,38
UZCLYcRXWGdaQPNEFJOfDgSAMIVBeHKTb,VABCBAHGeFDB.KEAEUEFALEEGREAFGECGdBCE...aHFCQCGHhAAA.EGBBhABAOAHFDGGHAGAHMACGhAGAIAFD.HCDH.......hAIA......hBAA...,1,-19,-28,9
BKYbUXLMTfPDFHQVSCZEgIcdJWAGORNea,OFBDeFABKBCGUADELFFA..TEEDDCGGFEBEHDBG.VAAGhAAACAEEEDGH..IHFFhAGAdHFFAGDFRAAH.BAHG.hAAAXBGCPDDA.SDHH.gGGBhAIA..hBFA...,1,-20,-25,5
MUEOJYILTaSZGDABdPcQfVNHCWFgXKReb,BGCCdCHEQBBH..NCFACGGCFEDC.KFAARACH.eGBAUBGFEBEH.hAAA.OBAF..hABAIFHGaEHF.SAAChADADEEBAFBC.fADH.VGEChAGAWHDG.XGAHhACAMIAA..,2,-42,-25,17
TDIMfGHLecgUNCYESZdBbWRVQaXOJAFPK,KEBDTCACMECC.GFDBHCGFeAAC.UFCCCACCECGDSDDEhAAA.dGFABHBCRAFHaFHDhAEAXAGAOFADAFFADFIFhAAAfAECLAEBcBBD.NIEB..hAHA....YBADhABA.,2,-37,11,48
CdTSQRXeWIMDfVbUGKZaEBYOFLcgJAHPN,HGCECACEdBHC.TEABRDCA.eDCGMBGD..fFGEUGADZFGHBEHBhAAAFBBGLAEB.hABAcGACACCASEABhAEAQCGD.WHFAVFDBKCAFaBBB...hAAA......hABA...,1,-3,-25,22
GLdXHgTNeOIbKYDfWESJRQZPUcFMaVABC,BCAHGBDDdGDFHGBG.TBAEeEABOEHHKEGGDAEC...EACGJEDGhAAAQBEAZDAGUGGFMBIBhABAaFFF.AADFCAHFXDCHhAAA...NIAHICHA.fBBDhABA..hAEA.SAGE.,2,-15,-7,8
EeZUfAPNSRWcdOXCaTHVLFBMgIQJbGYKD,SFEGREDAdGHE.CBDA.TGEDLBAHMHAGQAFG.hAAAJDGFbBACGDBEDBFGEDAFhABAeHCAZDBB.AFIFNAADODEAhACA..aDEF...FBHD.IHHHhAHA.....hADA...,1,0,-21,21
WQDRcFYKJNSZULaTVgHGXeMEfBbOCAdPI,dBAG..IBHHQGFFDEFFFHACKDDDJAGDZFDHLABC.hAAA.TEAAVCBEHFAGhAAAeBCEEEFEBHHECHDEAHIBRAEH.hAGA....NAICSCCFaDHD.gGAAhABA..hACA...,2,-26,-11,15
bFdMRWOTBHgNJLfcSCPKYEAVQIGeXaDUZ,QCEAeDCBDDHBZEEDdGBB.MEIHRDAB.OAAEBACFHAFD.JCCChAAAfEBD.hABACHFFKAHDAEEBIGGFhAEA.aFAHbFGH.FAEB.WDACNCIG..SHCGhAFAPEEBECHH..hAAA...,2,-20,-17,3
ZESIUFQDJaOLAKfgRNbWVHPeYCGBMXTcd,KEEBRGCG....bBBAVFBE.HAEEeGFECAAABDCEMBGH..XEEChAAAdFHAECAA..SACChAAAIGAFFDBHJHDGLAHHhAGAADIHNABD........hBDA......hCAA...,2,-22,-20,2
bTAUGXBLHNZICeYQOJDgSWdKMPcEaFfRV,XCFEBBBAHAFAZFFCeDFH.QECHJCCHDIAC.SCEFhAAAKBEE.MHAGEACBaDADhAAAFGHFfACBhABARFAA..bGECAGGH.........hAEA......hAFA...,2,-27,-18,9
dQfWTcEKbJRYNCBSLIeGFMOXPHgaDZAVU,VBFAdBEGQFAD..TDAHECBHKDGGJADERGFC...CBCGLEHFhAAAeEEGMBAAXFEGhABAPAFA.HDDCDFCAABIFhAAAfHAB....cGDHhABA....NIDHBCAChACASCAF.,1,-8,-9,1
MbaQJDOGFICedSPWfNBUKEgZVLXAYcTRH,TDCGHFEAaDFE.DECAOBEFGADF.FGAGCABDeGAE..dBACPHEChAAANDIE..KHFGgDAFhACALCDGABIHRDGBMBIFhADA..........hAEA......hAFA...,2,-20,-19,1
FVGAJWMORgYZfQIBaCXENcHKdTDULPSeb,MDGFRACCZCCA..QFGCaFHB..EABHHBGBdHCBDBGAUGCFSCCBhAAAFCABAGADOECE.hABA.fBEDhADACHAH.NDFAKDBF.....PFAHeAAC.hAAA......hAFA...,2,-21,-16,5
CAJTVdHUDYMPRLbNXBgOQGcWfeSZIaEKF,VDCBUGAHDCFA..MBDGRCBALEGB..NAEBBEHBQABBhAAAGAAE..fFEFhACAeDADSBHHhAAAIAEEEGGE.CHBDAHFGdHDB....YCDChACAbCFA....hADA...,2,-26,-20,6
TDIEMJBNdAceSZfUbGaWPQVgHOKLFXYRC,SFEAZAFFUGFEGDAH..PGBEQBACHBFBLBBGhAAAFEHFRACE.DACEMFDGhAAABEEDAHBE.fFAChABA.aGHD.WAFEOAHFXDBFCHADEHCC.hABANICH...eDDE.hBAA...,2,-20,-5,15
fPXBIOAZHJKQdFaDYScVWUGEbTNRgCLeM,HABBKCBGQFGGaEEBDBAB...SEABVBEGUEAFEHBE.TFEEhAAARFFHCCHA.LDFAhABAMDDF.XADFhACABEHBOHBCAAIBJAGF..YEDD...hAAA......hABA...,2,-24,-1,23
GICbYMdfSgBHORQXFJAEcZNDULVKeaPTW,EFDGZFEHUCCHLBACKAAD.eEAA..aGCBTDGF.GBEEhAAACAHG.MDAGdAFESEBAhABABAGEHGBAQGGHhABAJDHD.AIAGDIDA..WDAF.IHHAhACA...hACAfGDAOAHD,1,16,-42,58
gMRfKQTPYNbeSEDHOCUAVdXaWGcFILBZJ,XFDAaDAFGFEDFGBFLACG.BEHBZABGJAFHMIDEKDCAQDDGhAAA.PAGBhABANCAEeEHD..DFCDCHADAHHFhAAAdCCC.IHHD.fHADhADAYHDAEDFD....hABA...,2,-35,0,35
WKSNFdcZbLPTVJUACfBIXGgaYOEDeQHMR,BDHDXCCDGCCF.aGAEOEHD..EDAHQGFHhAAAHAAGRFFCKFCCSFCAhABAdBGB.bGACPHCCTEAChACA.UAEFCFAAIHHGDFFGMIBE.FDFG.cBBGhADA....hAFA...,2,-10,-6,4
AVPdULQYeTDIHfScJBbZKagRWOXNCFEMG,dFEFQDGGeABEDCGCHEBH.SGEBBGHHZFAFKHFAaGCDRAAH.XAFHhAAACDGG.ECDHGBBAhAAAABIHUGGFLAEHhAGAIEEGfEHAJFAF...bECHgADChACA..hADA...,2,-21,2,23
QEHSbGaIRKXWOeBPLgMTFdDZYfNcAUCJV,UCFDVEGB.EGCCHADHGEAHRDDA..KAGGOABABGADLFCHhAAA.MDAEdBEBZFFB.hABAYCBAfABAhADANAIC.AIHACCGB..SGAB.aAACWFFDhAFA..eFHF.hAGA...,1,-7,-19,12
RIbFgMBeWaQcJUZHETCLPGDVXKOYSfAdN,dDFARBGFFFCFMCBCBGGF..aGCE..JBAGUGGD.HDBDCEFD.LBFChAAADHAE.KFABOAFGhAAA..fADHhABAACEB.NIAF.IHHE..eDDHhACAQDAC.EGEDhABA...,1,-6,-57,51
deNIDTGVPbLZQgfYXEcWBAROKFaCHSMJU,KCFDaDGEHBCAMDCD.dFBF..eAEFDIGEGGDH..PAAGhAEAZEECfAHGXGFHEDHDhAGABDABAHBAFBGCSGAAhAAANBDA.IBAHbEEC.gAFDhABA..WHAACDEB.hACA...,2,-14,-12,2
ESNITALQODaWGFcdPKeUBCRXZbVMfJYgH,OBEAaDCHGBEFdFAHKCAEBACE..RCDAZFGHMHFE...JDHHHFEHhAAAEEEF.SHCAhABA..IBBAhAAAAEFEDAIB.WHAA.FEAFcDCH.eDHBCFGD.hABAXABE.fHAHhACA,1,-13,-37,24
OaHgDFTJPQdMbERISXcGWUVfABZYNeLCK,BCBDZFFHeDBALDEEKHCAHFAFDHGGFGAG..TAFDQAFAhAAAdAAGMEHBEECG..RABG.XECAhACA.cBBDhADAWDHHUGEA.AIBCCEAAaCGE.....hABA......hADA...,2,-28,-3,25
NWZVISaXcTAHUKFMPJCGQdYEeRDLOgfbB,UBBHMHCC.CCHD.QAEC.EACHeEAHLDGF.fDDHhAAABHFCZECFIAFDhAAASDCD.aAGATEFAhABAAGCGKBAFJHFEdEECDGCF...OAEHhACANEBA......hADA...,2,-38,-4,34
RXfAbQZKLSUMPBeNWTIYcGDJCVHdgFEOa,QACGKGEDUCFFBEDDeHBC...TFFF..IGAGhAAAGCDFCFBAHABDFAHDEBABhAAAOGFAaFAB.RAEEABABLFHHhABASDAFNEAB.....WHAADIDA.hAEA......hAFA...,1,-2,-34,32
beNQHBXWTKVCUEILOJGPfaZgFDRAcdYSM,dBDHSDEGMEIH.eFABHDDEBGDA..TGBHKGFACCDFEBADLBABhAAA.JFGDfCHGhAAAgGDHDAEGAGAF.hABA.bBGBNICF..WCCD.....IAHEhABAOFAG.aBEF.hACAFFGA..,1,-12,-23,11
MZdaEQcBPLXGDNKCSObHUVFRIAeWgYTfJ,eGDC..gDAFTBAF.MBIDaHAG.EDEEBHHALFCFhAAADBEBKCGBCADESGFBhABAHAFAUDAHFEECABCF..fHDDhACAdAAF.PAGDNCIA.bBCDIHFEhADAYFHF...hAEA...,2,-18,-1,17
aLTDBUfKedIGMSXEOJHWcVgYPQCFbNARZ,ZBBFLCDEBGHAUGBGKEGGeFEFGAFE..MBFGECAF.OABHhAAAHFEH...VEAAPDHHhAAACHACFGHHAEEA..aFAGfACBhAEAdBEG.ICHB.XDEGhAFAWACBYAHHhABA...,2,-21,-11,10
WEdAXcYFMbZPQIDCVOGLfNRUTKaHJSgeB,XEEHFCGCZFEG..QDDCDABD.CEBA.ODCGLACANEIA.hAAA.UEAGaABHSBGEhAAABHFDEBDG.AIHEMIAGhADAPHAC..IGAGfAFEKHEA.JDGHhACA...eAHH.hAEA...,1,-17,-29,12
HSOaDLEVJPBQRWGKbUYNCIfATZMXdgcFe,TCFGMCAAdAAD.FEHHeAEF.HFEAODBDaGBBDAAHLFDF.hABAEBEAPBBFBHAERGEEKGHHhACAUAGGNADA..CCHBAEHCZDDChABAXEAGSEAD......hADA......hAEA...,1,-5,-13,8
cDfYUJGbLXOSKBHRCFNdEMWgaQVeZIPTA,DGGBUGCBGBBCLFFGOEGFBAFB.HBAHFCHFdGCAEADD..MHFChAAAaBEA...eAHDIDFChAAAADDF..fDGAhABAJEABSCAFCDFFWEAG..gEDGhABA....hACA...,2,-31,-16,15
ZfHTdNSPAOCacMeRVYKFgXQGIUDBJEbLW,CCFCaBCE..MDBCeHFERECF.KDAB..FFEEQAABUAAD.DGBHBAFHhABAJEFG.EAHHLFDFhABAZEAF.HAFBdHFDSEHDhADAADEB....OAHF.hAEA......hAFA...,2,-31,-15,16
PcCMFTAHVBZSfLJdKaXINWDRbQYeOEgGU,VDEFSDBB.LAFFdAHEKEAG.aGEF..XADE.hAAA.NEDFRGBAQGGEhAAAOBBEEEAHGBAHUGGHCBAFhABAFGCDTBGBABGFBEHC.fGAEWEFA.hACADDDF.....hADA...,2,-16,-12,4
JTfBNRMUaPeKHVYEOGFdLbgICZSAXcDWQ,XGAGDCIBQCBA..TAFBBFDFRFFCaBBGeABCHEDHEAGAFGFAhAAALBEF..hAAAbCAGIFACZCEAAGIDcEBBhABAfGCGMIEC.KBAF...OHEChABA.dCFBCHCA...hACA...,2,-6,-3,3
IZECcSGdWVPfURADXKbOFgNYJMeBLQHaT,KCFDOHCEFHEC.....NBEE.JEDBBFBBLDAGHBAF..IGFEhAAACFGCGAGC.dACCPAHFhABA..UFABhAAAAACBDDFD.XGAC.gEGGhADA.MDDDaGHHEBADSAEEhAHA,2,-40,-14,26
gdbPDXWYNIJUFVeHOEZTcaKCSMQRBfALG,GDEDdGDFDBID...XFBC..YBBDNBED.UBFBhAAAFACGeBAFHDFBOEAHhABAEHGCZFDDTCCAKDEFSADDhACAMCEE.BGHHAIAE......hAEA..gFGChAAAPHAE..,1,-3,-30,27
KHDYARgNSJUFBcIZfXeCMVOdGaTQbLEPW,RCFBSBDBUDBCBAAAZFAA...eGFCMGACOAADGEEEaAHB.hAAA.QACBhADALFEFEDCF.KAEEDHBCADAFgDFEhAAANIAHFAHD.IHHAfBEFhAFACCCC.dGHG....hAGA...,2,-20,-6,14
RZIYGfUMcVagAOBNHPLFJdDEQCTXebKSW,BAACHBCCFBABdBDCDHDGQGCC.CHGD.TAFC..XDBChAAAKCAEREAHZEFAGEEAhABAUECA.VAFE.AFDANEIE.hACA..JFAHeHEA.SCHBWCFA.hACA......hADA...,2,-32,-6,26
EdgOMDTLQbVRBFSeaIfWUGZAcXYHPKJCN,XCDHHDAAJDHB..EAGEOBEA.MIBATFDALGDC.hAAAQCGAbFBHBBCBSCAEhABAeFHHIDAFhAAAWFFBGDBA.AABHYACHCHHGgADBhACADAFG.FDDA.aFAH.hAEAfBGE.,1,5,0,5
TVEJgRWcNDKGBQZYdeMOHPIaAUXfCbSLF,UDABCFGBLEEBFEEH..ECHFJDCH..RDFD.....NBADKBEGBHBHhAAA.ZABGdHABOFCFhABA..PAFAIAHAhACAADIB...XBFGSEAD.gCGFhAAADIGCYEHBhADAMCACaGAB.,1,-31,-36,5
SgMYDCNAGFBfaZdVRTHOKbXeWcPJQILUE,FGGBaAEDZDFDdBFARBBF..OHEEKHDE...eBAF..PEBHhAAAIFHFLEEC.hAAASACEgCBFhABAMIAEDAGCCHBGABBFBAHCfDEC...hABATGCH.XBGEhACAWDDD,2,-41,-34,7
NFcdYgWaMDXIVGOfLbJBHERKTZeSCQAUP,UBGFFEAGdFFE......gBAGMCBGIACCOEECLAGDhAAABEHEHDCDEDDERFBAhABAZADH.CHBAAGEA.PHDEhAAANCIA...WFAFDIBC......hABA.XGGBfHGFhAEA..,2,-26,-26,0
YQKVUDISPGfBHTWOCJdRLNAEcaFbeXgMZ,EFBAFDDAeHFC..XCEDZCBDKDGADGGGSBFE.GBAAhAAABBHGHGCCTACCCBEFdABBhAAANHAB.AGBB..aEABgFFChABA.MAIH.YHEGhACA......hAEA...,1,-17,-34,17
ENfdDcJHbGeRBUVMYAPIFWSLaZTCOKgXQ,FCHBLFBFZGBG.CBCEKGCBQEFC.EEBAdDAB.JGFCHCDAGAGEhAAAeABEBEEEMFIDABEF.hABAPAFC.SCBFhAAAaDEA.OEAHNACDDIFE.....hAIA......hBAA...,1,0,-36,36
WVQcBCbJgANZSERULdIKMeHXYGOTfPaFD,ZFDBEACDLEECKCAGHDGDGAADOGBC...TDCHaFFCFBEADAGEQEABhAAACGBG.JAHFhABAAGDFNAFARCCA...dGGHIHHDhADAMEAD.eHDA......hAEA......hAFA...,2,-16,-8,8
ZFYCJIfXENWadTGPLSbKeRDBMUgVcHQOA,FHEACCAG..JBECXDBB..EEFBaDHBdHFFGAADLECBKDFDDAFBhAAABHAC.UABE.hABA.gGBAhADAHCDAAEIB.IBGHfFADNEAG.....hAEA..WAEESGFEhAGAeEHD,1,-27,-36,9
ALTcXCgeJOGIYDdaRSFWPBNUbHZEMQVfK,TGCCXBDF..CECF.JDEBGBBF.DBGGdGBGREAD.SBAAhAAA.FDGDWFGHBGGDhABAUEEHZFCFQAGFhACAKADCAHAH.gDAFIABGaDFG.NCICEHEAhAAAMIFA....hADA...,1,-13,-20,7
SYfGbcRZXIaMHBPQTVJEAKdNDFOgLCWUe,dCHEDEGCFCDBOHFELFHDUADF...SEEHGCAERCCAZEEC.hAAA.XGAHaAABBHAFhACAQAFG.hAEATCAFVGCAAIBC.gAGCCBACeAHHbEAG.hAGAMIDG....hABA...,1,-6,-24,18
dSbaJPXAHUTNeIQfRBWGKOYDcCMVgEFZL,UFBGTACEeAED..QFDBRFFABDBBKBGGOCHD.DAEGCHDA.hAAAMDECEEDG.FHCCdDGDSGGAhAAA.bBAHhABAPACFAIACHAFGfAFFWHFG..cCCHhACA.gEFBhAIAaABB,2,-42,-10,32
ZEPHSeIGLCVdNMbJOBcXfDWQRAgaYKFUT,aGFGKEDHFCCDZDFA.HGFC..eACALAFECFBBdCEF.MAAE.JFCFBAHFhAAA.XCCHhABADEADQBGHAIHGUGBHECAAhACA..IBBC.NEBGOFFGfHFHhADARADB.....hBAA...,2,-19,-15,4
ecYOFbQTIPBaWgUJSANZERMdGKfDVHLXC,EHAEdEGCKHAGDDHB.LFCA..XCBCCCBA.eCFBOAAGhAEAQAGCTDCDBBGDhAFAgECA.SADChAAAAEBFNHDF.MFIHfBCDcFFHFABFhAIAIAHF..hAGA.WHFA.,1,-8,-34,26
EHBQPZUVRIOGKCXgTNWbYLfeMDdFcSAJa,JDEFaHBGBEDDZDAD..RCFD.GADB.CHEA.XAEC..NAAE.hABA....WBCBhAAAYCGF.LCBBhACAfHGBMGAADHAAdGHCSHDChABAAEEA.EFCG....hACA...,2,-46,-24,22
aKBFOgGZTfCPWIXUJLNRdcDQbMeYAESHV,EEFDVFCCKADE..BBCCFGDCGCBHZDAE..CGBD...IGHFhAAAJCFDRGFC.DIFC.QBGBhABAMAADABFD.SFCChACAaAHD.TGAH...fBBHhAGAWHAG...hABA...,1,-17,-48,31
MbfGLWHQBXPSdcgJKRYNFeIZVDTUECAaO,MFCCGBDBHFGFBHACSBEAdFGB.JACDKACG.RGDCFCAEZFDEDIDGhAAAEDED.CBAB...AGAEOAEAhAAALEAD.WDEGhABA..XCGE..cBGDYDDFhABA.IHHHhACA...,1,-17,-30,13
USbJXZKVCGFDgYMeaIfLBNcEWATRPOdHQ,TDEHRGAEdFECUDGC..JHFAZADD..KEAFCCAF.FCBC..DIGEMGCChAAA..aBFBLHBEhABABBBE.NAIE..ECFEADCB.hAAAHADDSGGC...XAGFhABA.....hACA...,1,-24,-39,15
FINAXHLbRMEJUgCSGZQKVBefDYTWcdOaP,HGCALCEAMACEEGGCJHFEUDAB..SEDBQGCBKBAAVAABhAAAeFFE..DAIBTBFDhAAAdEFGaHFCFEBHIAGDhACAAHBBXBDF.bDFACDDGBBFD...hABAWFAHcAGF..hAIA...,2,-14,-8,6
fGVLPbdYKXBANZJIMaTHgWOceSCEFDRQU,JEGBaDAHHFEA.OCCFeAAACEEA..DCBHREAE.UDGGGADBLHBChAAAdDGBKHCEAHHDZACG.MCEEhABATCDB..cAGFhACAEHAE..........hADA......hAEA...,2,-29,-14,15
VRYfFSNJOPTKGBeDZcLWXAaEQICgHMbdU,aEGHQGGE.CAHEHCDAMIBEdBBE.VECCfCBF.hAAASCHDNHAB.hABAOAAHKAGCBBFDDFCBcFEEhABALADDWEADACABIFAG..hACA..bFCD..YFHBhAFA,1,-25,-28,3
PBWRbYTOQNHDSgAfICGZJFedaKULVMEcX,CFAHGBDGZEGD.JHAEeCAE..dEGHUEEDMBAG..ECEA..XFAGhAAABBEF.RFEH.TGBHhAAAOCADQDAHhABADDCDSADEAIFAfABHIGHEaAHFKDGEhABA..cGDD.hACA...,1,-20,-24,4
EKfNbSBVCAWTFUZJdQXHcgReaGLPYMDIO,TDAAUBCEdHFB.HDFGRGCCGAFGLBFEMFDGOFAC.KBAANABFBBBBhAAA..CDACFHCGhAAAZDGDXCDD.hABAeFBFaEEHDAFAIAHFfCFFSBCHhBAAAECD.....hACA...,1,1,-24,25
EGFgCVIXPDUdTaKfLWMeABSOZQJHYRcbN,OFEFZDFEQAAGHAFGRDGD....NCCH.FFGD.CHCB..XFCEhACAUEABaBBGLEAEhADA.eADFBDDESAHBhAFAcGGEECAB..gBFF.hAAAIGAGDABGTGAChAEAWFHHAFDA..,2,-21,-11,10
JXKTMVALEUZYDIdbfaQBRHOcCeNPFGSWg,LFECUEDGZCDCDBFGdBGGaBCH..BHACHEAB.OECGeBAAFGGEhAAASBDB.JBABhAAAXADFMCIDVGEAhABAEHDE....bBFE..fHCBhACA......hADA...,1,-11,-36,25
BLROANDHgIXaZKYVbEdCFMQTeUGfPSJcW,DHCAHDBE.XEGFKAAF..VBFFEACFCBGCFDAFMIBC..QEEGhABAeAHHGFBDSGGHhACAcGGHLCADhAAARFACAIEC.gBDH.aHAGYBCFhADA.dAFF..hAEA...,2,-34,18,52
GZUEAWMSgOfBeRTIQHcDFbdLJCVXYKaNP,MDBEOHDGBFEARFBC..QACBDCBEdAFELDGBCAAF..VCDGhADAXEAHKEFAaAGG.hAAA...PAHDhABAUGGGAAFHSHAEeBHD.IECE.hBBAHACC.bGFA..hACA...,2,-27,-14,13
TVAdPfLUSYXaCFRJMcGgWIZQbBKEOHNDe,dGAELAFESGCBXCFHFBCH..MBADGBAE..IEHFhAAAZGBEBHHF.KDDCOGEEhABADICEeFFFAEBEfFEFhACAaECBCACE.JAHH...gBDBhADA.WAFB..hAEA...,2,-32,-22,10
XECTegfDLJIHUMaGSbNYFBKQOPWAVdRcZ,RACAXGEBCFHE..eGFEDCEFLEAHHDEGaAAB.SDFHhAAA..bDADNBDCBBBFhABAQGCHOAGFAFDEdBHEhACAEHGCTGCC..fCCG.hACAIHACMADC.FCEGhADA.KAFE.,1,-12,-14,2
GPDcJZYSXFRgeAfMdHCVLUaTWQEKBNOIb,MCEBCGCAUDBG..TBAD..EAEB.KBCANBIG...OGEEhAAAIEGGGCGG.DFEEhABAcEBBZAFD.SGGAhAAAFFAH.eAGDAIHC.fFDEhABA.dHAF....hACA...,2,-32,-31,1
eWTRILdNVKEAUfBHJOFbGQXcYSgZCaPMD,UAFGHEGHOBAGGEBCQBDE..YAHBZDDGaEHHDEAFhAAAeECE.RAFFdDAAKABFACAHhACAJCCCFHDEXFAAhAAA.SGEECGGGMAIF.IHAC.hADANIEB......hAEA...,2,-18,2,20
ETPdUKZFHaVbBNDcgfIJQXeYGACOSMWLR,SDDBLCHHREDDECAHdGAEKBDA..HAFHaADA.BFFB.DDDCfFGBhAAAJEAB.QCGFhABAeAAGAGHBCECFOHAEhACATCABZFDA...FHCE....hACA......hAGA...,2,-21,-21,0
DHPaXbIVAgOQNUTFcRCYWLMdGSBEefJKZ,ODGHQBEFUGBGFGFG.RFBA.CFDE.LDAEdCCGBAHCEAAB.eEFChABAKAEHZAAEDBHB..aAGA.hAAA...XFEDhABAIACHAHHE..NEAC.cEAG.MICASDDEhACA.fBHAhAEA,2,-35,-24,11
JNEdgVHAYZRcDGCQUKefISFWXaLMBPOTb,ZFAGRBDGDDEFGGCH.UAEBKDFGeAHB..IHHCFGGE.aDDAhAAABGBG.OABBhAAAJCBBEFGAdEAD....hACAgABCAEIBCCCDSADC.LFFDhAGAMIACPBHDNIAH..hABA...,2,-24,-24,0
WNePQDKHSVBAOJbZMgGdCFREaTfYcLUIX,JEAAMABCGABFFHCG..EDEA..TEFH..fDBEhAAALEHHIBGGhAAAXADAeFGDDGACKDDAVAGBhAGAAAHGOHDAbDCDZBBCCBADaCAEYFHH...hABA..WFFD..hAIA...,2,-16,-10,6
JAgYQFCOSIDfTRGMEPUKZNabHLVcdeBWX,QGBFFECCCEAE.SFEGDBIFRGBA.GCAFMGEA.UABFKBBD.hAAAZAGH.aBEAHCDELEHHhAAAdHFD.BEABJACEAGAHhABA..YCFFOBGF.fHFBhACA.EECFNEIC....hAEAcAFB.,1,10,-29,39
EMBcRdVZGTXFDILQOaYSbAfJeKHPNUWgC,JEEAKCGGHFBC..UGGBCDCDEFGBMADG.BCDBdAEDZCAD.XFEHhAAADHDALABB.hABAQAGHaHAESAHBhACAAHCH.eADDPFBANEIG.....hAFA.WEEE...hAAA...,2,-47,-3,44
HLJKUbMIRceVfNXPaFdSTYEAWQOZGDgCB,QFACZFCBGAEACEGALBEG.JFEFKEADUDFAMIEA.RDBA.eBABhAAA..VABFXDCChABAaBHH.FGGCSBADhAAAECCEAAGCDBBABAEBIHADNBIC.dGGB..hABA......hADA...,1,-6,-19,13
HNMAEPQJfIXeSUaWDLCRdFOZYKVbBcTGg,EHDAQACE.JHAEXBCC.eBEGaGCADCACCEEB.dEFFFGBEhAAAOAGBZEGFKACCBGFGhAAA....cAGAhABAgDDFMBBHAIAGIFAGSGFHUGGGhABA.LAHH.hAFA...,2,-29,-14,15
SURECeQJGILWXAdZOcKgMFVTPDaNfBYHb,OEDDKHGAMEFBFCGB....TBEDDIGGaCAHBGAA.HCAGSGBGhAAAEABEeDHHJCCGLEDHhAAA.XAGFhADAAGHHdFAFZABGgEAENBIE..YFFDhABA....hACA...,2,-37,-1,36
UFJLGdQKeMWXIaOSRPBTDcAYgbfEHVZCN,...bFFFHEGF.CBEEFGDAGAACQFAFKGDEMAEE..XABGhAAAaDCASHBChAAABDDEDDFCAIEA...YDAAhACAfCGGEAHFNIEHJFHDdHAHIECG.hADAPAHF...hAEAcADC.,1,-7,-12,5
CPfgYeHGDEJQXTLVSNMKFdAUZbBOIWcaR,UAFCBCGFOBDD..IDGAaFDHRDAD.CBAE.....PFHDhAAAfHGB.hABAeCADDCBAEGFFJFECQCCFhAAAXAFGLAHBNIBBKFDFABHC.WDEHYEBBhABA....hACA...,2,-34,-24,10
XcHABFbSCJRaIeNMPELdQYTUWfGgKZODV,FHCCSFCCRACE.eGECMAFGLADAdDCC.QCCBhAAAUGGAGEAGKBGADEIF.XDGBhABAAEGHCBAA.IFADhACAEFEH..WDEEfEED.OHAChAEA....hAFA...,2,-35,-19,16
BEGCSQfZLOcNXITDFAKaeHgURdMYbVPJW,aGFCHFCC.UADFdDBCMADC..bAABJAACBEAC.EHCGGCEHhAHASAGAZECHLEFGhAIAODEC.XGBHhBAADIGCAGGFKCCFeBCA..gGAD..hAEA.YFFC.hBGA...,2,-14,-9,5
AVLCFTMWdJgSBQfGePZNEOKbUIcHaYRDX,CBGFTGAGdEGA...JBAGSAED.QFEEeEEHPAEAhAAAEGAA.KCFEUDCCHDCFhABAaAAEDBEH..AHIBFDADhAAAWHDABHDH.fCHENAIGODABIHHFhACA...YDHFhADA,2,-37,-9,28
HVGXDYNJAQRZKdFLCBMeEbPOcgTfUaSWI,QDFDKACFLDHDBFCBeECDEBAB.OFDDTBFE..aDCASEEDhAAAHAEEGEAAhAAADEBBJBDBAICAdGHA.CCHEMFGBhABAPHAE...fGFC.IBAChABA...hACAYAFC.,1,0,-20,20
dKQYHAecfbPILGWaSJEDFBVZMNUOTgXCR,eEAC..fDHGIEFD.GAEHaCGC.EBBDDAIFFFEGZGAEMFDBhAAAOBDDTDAECCAFdEHEhAAAQGGAHABDAAEE.hABAcFAELHFCSABEBFBH...hADA......hAGA...,2,-12,-1,11
CIgPDXTUHfEYRaQFGLbNJZSMecAWVOBdK,VBFFBAEBKEBH..CADC...IBGEDAFGUFFBHBDH.EBBFRDCDQBAAhAAALFDGJEHBhAAAZFBF..SAGEhABAMIECAAID.OHDG...gDEHhACA....hADA...,2,-32,-24,8
AfZLHOdNKXGVbceaMJWFRBPQgYDEICSUT,ZAFDOFAGdABHKEGCGFCF...VDECeFBGMAHHFBDDBCHA.hAAA.PDBGQGFGhAAADAEFCBAA.SHCGhACAAFHEfGHALEAD......hAEANICHXABF.hAFAbGAG..,2,-30,-9,21
JYAdFeIUQXbcaHNfBPSGKCEOWRZVLTMDg,dDDHeDFFQDAH..XFBGaGFAHACGNCEDBFHESGBDhAAAKBBA.CAGDECGDOHBChAAA.ZDBCTFCADCAHJAFGhABAABAGFHFC..IHGEbEFA....hACA......hADA...,1,2,-30,32
BfMSVCKTebIGHaAgEQXYRFUcdJLPDNWZO,QFGCRDDDFCCB.dDBELEAHDFDAZAEBBHBHSBCE.CFGC.hAAAeBBAGAFAHAGBAGIHEHBAhABAXGDA.cAAGhAAAJHEA..NAIC.WDADMACC....hAHA......hBAA...,1,-14,-21,7
UGZLQBANJRHWTaXVCOfdFbcMSgEKIeYPD,JFGFHACG.TDDD..VCDGCHHCdCGHFAAHMAAF..EDHFIHAHhABAeDAE..DAIDZFDGhACABAECAFAHRDABaCCBOHBEhABAfHEFSGEBKEHH...PGAAhACA......hADA...,2,-33,1,34
fWSHLgYMCOKEdBZbAJVQDPTcNIUFRGeaX,VABFQECG.DGHBTFFD..NBFG.FBEGRGCC.eFDD.aHAEhAAAfCACHEADLFHBhABAMBGHOBHBhAAAdAHGBEEHZACDAEDG..cCGHIGAB...hADA......hAEA...,1,-6,-21,15
daKBgCTPbfWIFQHJNLOMGVUeDcZSREAYX,XBDAaHCGBGAE...CGCH...TEDC..bDACIBBBhAAAFFGAJFEDLAGFhAAAOAEAMBDF.UCGFDGGFSBBFhABAAEBDdFHCKHEAfAHCHFAHNEEF..hABA......hACA...,1,-14,-27,13
HAZSNIQLeDTVMPECdbXJBYfcGaUFgWKOR,SFHHQAGEeFEDDGDB..MFBHPCFBECAA...CGAEdCCFhAAAXACFBAFCfGHGhABAaEHBUGEFFAFBgEAEhACAOECAACIBNDDBIADF....hBAA.LFGF.hAAA...,2,-27,-5,22
BFKTdOaILXgWfYRPcUZVQNECDMHeASGJb,GEFGJEGDBACCFDBD.KFDBdCDF..OCABLDBF..XGAFhAAA..fGAGhAAAPBCG.ZEEDNEIEDIDAhABAeAFE.SEDDaDDA.IBAGhABAYAHD....hACA...,1,-32,-35,3
QcENUgKbGAPSLIYHedBZOMCRTfJVFXaDW,SDCELBBHHECGdABCBAFFMFBBTFGE..fAHAhAAAFHCCDAEDQAGChAAAEDAENBGGKGGC.AAFF..YDEChABAeFCDCHAFRFEB.XACE..cGFHhACA.....hADA...,2,-24,-6,18
ZSCcINKFQRBTAJXWMdLHEPYUbDafVOeGg,XGFDMDIBdCAGLGCGHBBG..EEABUBBGDEFD..aDFFfEEFhAAAOCHBGGAHhAAASBFBIABBKECBFHGEhABAQAGHBBHEAAFEJEGDPADA...hACA.YHAA.hAIA...,1,-9,-14,5
EMcJaWXZDQOAVUCNBRLdeFbPgHGfYKITS,CHCABFHARAAA.eDBBFEEH.....PACBGBDFKHBGSFAFhAAA.MEIDaHECZEDAhAAADDDDADAEVBFB.LAEEhABAdGGGHEBFfDDBIHEC.EDHHWAEEhABA..ODAH.hADA...,2,-28,-5,23
bPHUKAJRNBWaGZVgQSEOdIFTcCYeMLXDf,JAHBRFACBGHDGABEZEDB...QGBEOACGdFFCFEFG..CCCH.eADGhAAALAHFDGIF..hAAAfFGHHBAHACECaBFDhABAVGDE.EDDC...IFAF.hAGAYBAFMICA..hABA...,1,-18,-21,3
ZbCgaJBPSIXAHKVONUDeGRcfTYMQWELFd,HAFGOCFAUDEEDFFFGABHRDBF..fGGCMEEC.EGEBFGGAhAAAZAACCHBH...aGADPFDDhABA..SCHHhABAAGBGVCAA.NCAEeFCH..YAEChACA.....hACA...,1,-15,-20,5
cTKEeRNGWAXOUQYfCbFgSVPaMJIHBLZdD,OEEAUEFCQEAA..fCHGCADHFBBC.VADCMBAFhAAAHBAHBDDF.ZFDHdHFDhAAADHAGKGCD.eDADNCIG.hABAADDAYFDA.SGADaCFEIHHFhACA...cAGBhADA..,1,-19,-24,5
OfYKFIAQRJDSUGdZLHTNXacPWeMVEBgbC,JBGHDEDGUEGCZACE.HAGD..XGGE..aBAE.PFAFhAAAMEFDBCAD.CHAEODCGhAAAKBDEAHHHRFDHdDADTEABhABA..NABHeFCFVFCD....EAGE.hAGA......hAIA...,2,-24,-20,4
fYdCVHGIRSaegbcBZDPTKXNQAJOMEFULW,JFAFEDFEFCACLFCB....fDDBCGGEGDCDRAEAaBAA.eAHHhAAA..bBAFBAGAhABADCHFKCCEXGAB.hAAAQGGAAHFCMFFE.WECH.dEAF.IFFAhACASADC.hADA...,2,-24,-20,4
UcOKCGQRSMHWDbedAYPJFETfBXIaNLVZg,JFAFFCAAEAHDBDBH....aCFALDFFZEFBUGBFKBAC.GADAhAAAQDCHMDHFDFBEdADFABAEhAAA....TGCEhABA..IHHDNIEB.....hACA......hADA...,2,-37,-28,9
JEgdaDMCfYSUPQRIBeGHcFAXZNLWTOVKb,XCGCLBHHOGACKAED..EHAGaFGFCGHC...SDBHhAAAQAAHBCAGeCDDGBCBhABAHFCBAGGBNEEC.WDBHhAAA.....TAGGJABGDGIFMIEGfAFFhAFAYCABPFFHhAIA.IDFA,2,-20,-12,8
fDeITGWEVUOYMPCFbNQdXKJgSAZLaRcHB,LGCEaHBCHCAEDABGTDCBGDEF.EBGGVAEC..OFCChAAAMICGCHACFGHF.QAEAhAEAKGHBSACDACEF.hAHAZDABBHFAIAAE.YEFC.hAIA......hBAA...,2,-15,-10,5
DWVcJTRFQGPXIaNEUgeAdSZLCKHbBfOMY,ZCDBKHCGBCFHMGECDGAH..VCBF..TDGDFAAHGEFG.hAAA.IABFaGAGEHAA.hABAeGBG.AFAASBDFhADACEDHHADCOFHDYAEC...cCFBhAIA....hBAA...,2,-40,-20,20
EHKIUODbeFaZPdYVSLQRNXMTCgJcBWGfA,EABGKDBHUEGEDFDA..eBFAFAEEZFDD..dEAG.SGEBhAAALAAEQBGEhAEARFBFMDHFCDEF.JHAEBBBD.fBDHhADAIDEDaCCF......hAHA......hAIA...,1,-26,-33,7
YfJXVIeUMRKBacEbLZCQGWdHTSgDPOAFN,FABC..fCCDJCHH..XCDFVAFGUFCCKGCFBGEBhAAAaAAE..EFGBZEFFCEACQGEGhAAAdDAG.SCEBhABADGAHAIHC.NCICIADEMDDD.bFADhAFA......hAIA...,2,-44,-13,31
ITdOCBQgWKSUMfFPGXDLHJYANeEVRZbac,EADBZGDGaACB..TBFECECB.BHGDQBEEKEEF.MAECPEHBhAAADAIBLEFGhAAA.JBAFADDHNAICRBGB.IHABhABA.dCBA.gFAE.SGFFhACAfHGF.hAEAXEDDYFDF,1,-17,-19,2
aECZJHXgMAeNfDUOcGQBTILKPdWbFVSRY,eBDCDBCCUECBGEEFBEAALDBD.KABAdCHAFHCASGAGhAAARCEA..aFAHEFFGCHHG.hAAAZCCCXBACAHHD.hABANAIG.fHDF.OAEA..hACA......hADA...,1,-11,-41,30
bILXfDOQJWREHZAgUTeCSGcFNBYadPKVM,TAEHCBGFGCBG.FDFDBEEA.dABGKFHFMDGFLFAF.DGGBQDAAhAAA.JDHBhADARBDDEBACAHHHUGCAeFCHSAGEhAEA..NABFPBHDIDDG.hAAA......hAGA...,1,-21,-24,3
BYIHXTgSbWFNRGPUcaZeDQCAdOEJLfKVM,ECCALGEEKEDC.MIBGBFGGHAAB.XCFESGCD.FAAFhACARAECGDBFUAFAaEAHDEAHhAAA.AGCFOHFC.hADA.VGDC.IDGHbEFE....hAEAWAHBNBIE..cDBChAIAeADD.CHHF,2,-36,-8,28
bPYRQaLUcFdNDMEOIAXWCSBTZVgGeKHfJ,XFFHCDHCBACEZEBHGACE.HAGBJDDB...bFDDRAFELCCChAAA..UFAFdFHGDGEEhABAOCAD.AIBGSDFGhAAA........hABA......hACA...,1,-15,-50,35
acXSODRQJNTCYWgdVPLUBIeGAKZbfHFEM,KGDBZDCBHGFCMFFE.aGEB..SFABOAHHDBAAQCFGhAAA.JDCBCDBC..gAEFhAAAdAGBPABDBEEChABAeADBACAFFDHDXGGBNBGE.WBAD...hACA......hADA...,1,-12,-25,13
UWGJeAcfCYZDSRabKXVNIETPMLgFBdHOQ,CACHDGBGRDGB.KGFA....VFADECDC..MDFAFEDEHBEG.QGFHhAAAGAEDAGEFfDAAhAAAZCAG.SEEBhABAaBACNAIG.IBBA.LHAGhACABEBEdAFF..WHFAhADA.cDCH.,1,-8,-27,19
WcfgFHEULNZBRMYaQIXOJKeSTAPGCdDbV,CAHCDFAH...VEDH..fECAHCEEEBBBLEBDBACBMEFChAAAaGGBQBEAhABA.OGACKAEGSABEhAAAAGIHdGFCbCBCWEEGFDHDNIAF......hAEA......hAFA...,2,-32,-14,18
YTHdWVCJXNeIFLabBAUcGKRMEDZSOfPQg,UGCFGACEMHFCZEEGOAHB..QBCETGAD.dAGCCAAD.hABAXDFBeAEBICAAhACAaEAFACBD..KFGADIDEhAFASACCfGGDYECC.WAAFhAFANCIA...LBHHhAIABDFH,2,-27,-23,4
OGYJfAWHDISXKZLUVgPecTFBNdaMbQREC,HABDDBFB.SGEAKAAGLADDUDDH.VAFAeFFG.FGACdDHEMFAAhAAAQDAC.hACACHHHGFABJHFCAGEEXDGAhAFA...PHCEBAAFNICF..aCCHhAGA.ECGA....hAHA..OAEH,1,5,-27,32
gPaLQTAdIbNfHKWFEYMceJVUXBDSOZCRG,dGEG..bCDAHBEDFGGA.ECBF.MEDDeGBGUGABDEEFZBBE.CABHRDAAPFHBhAAA.LCAFhABAAAGE..fBHChAAAKEFHWABA...cDGDXBGDSFADhABA....hADA.OFFH.,1,-5,-11,6
IRVBeWGQbacYOULADKFPfTJEdMXgNHSCZ,KDGFFBEA...TADGdEDDXGEBHFDBCDDEZFFCRCAD.BAGGGCCFQAABhABAaAAG.ODAChADAAIBEDAFG..JCHFEBHFMHBAhADASHAA.IFAB..hAFA......hAHA...,1,-16,-25,9
AFETYCPgUHJXRceGBdbDaIMfZVWKNLOQS,TCBGCCFFUCAG..HDFFJAEG...RCDDGGABdHEHDEDB..MEFGZAAAKAFEhABAOFHFAIEA.FABCEGHBhACA....gEABhAAAXEBEBADEaHBE..fBHChADANBIG.SFFFhAEA..,2,-19,-17,2
CAIENVKaSJHYbLDRWMTcPeQFXOBdGUZfg,EDFBVFFAKAAG....SDDFHAGFLCABRAFG.MDEBTBAEhAAA.eCEGQGBDhAAAODBFBHEHdHFDUADDhACAZFAHCGCAAGHGIEHGaEEGJABCDDIBPCCH.hAEA......hAFA...,1,-1,-8,7
YLXEcSRbFegUPHdJCOTKNBfIWVDAGMQZa,QBBAaDFGLBDFEEABRFAB...eGCCUGEEdAHECHGB.KAAEBBAGICFBhADADFFE..MCFGhAAAZFFHXDCE.hABASDFAFAFCPCBDJEHDODHFfGAGhAEAAHAF.cADD.hACA...,1,2,-26,28
UcAeCJOIPNQfGFbEaZXHBRgLdYDKWTSMV,CGBDJAEA..ODGD..NEED.QBBAGBAGFGFEaFDB.ZEEFBCEGhAAARBFCLBADDFCHKACB.hABASFAFUGDEAIHA.hACAIHHB.fBDHEHAG..hAAAXBGA..hAHA...,1,-13,-35,22
KZMcFQEONUCaLGVYgebPWRDdXJIBATSfH,SCBCKFGEMCFF.QEGAEBCF.OFFHUAGBCFAGGAEBhAAA.VECHeEDFbEABPEAGhAAA..WBAChABADEGEJHDGAHID..TCDBfHAF.cABBhABANIAH....hAEA.aBDD.,1,5,-35,40
RQKJHUgNCafcSIBADEMLbXeZGTdPOWVYF,DDBGEADCLABBeECBZEEGGBEFdBFG..PHEGOBAE..VEEGhAAAFGGAKDEGHECFUGAChAAACCHEaGAH..SAFEhABAADDEMEIF....XDACYHDG.hADA......hAGA...,2,-15,-9,6
XVcaRKBeIQMAHGOJTCfEUZSYFWNDLdPgb,OECHCFDEUFAE.ZBAB.FHFADFIH.LAAEdHBD....gEDDhAAAXCED.aADERBBBKCGGhAEA.BGGGeBGFMIEChAFAAAGAJEHF..EGCESCCA.NAIE.hABA......hACA...,1,-26,-34,8
aOZJPWVKeIMYfCNbTFAQdLBHDGcUXESRg,QBDBdEBHBEEGDDGDUEAH..SADHaFHFZGDA..JBBDVAGHhAAAKEEF...IHGGhABAMABACDFA..TGABhAAAAGGE..LGAA.GCAFEFGD.hAFA....OEHFhACA..,2,-26,-25,1
FaYeLcSRAVMDWNQKdPETgCIZJXfOGHbBU,VAGHMFADDBCA..QFFHdGEE.EAECTDFE.CEDHZBFChAAAXBAHGCAABDCHhAAAaGGF.LEAF.hABASEDAADEAKCCHgGBHfACE.hACAOEHF...hADA...,1,-16,-25,9
VIOWbEDgcSKdYJALGPeNaHFUfMZQRTBCX,GEGCeEFAHBDDFDDBMFAFQFAE.RCAEBDFDXFDDOAAAhAEAEEBBDCACSFGAhAFA.dHDFAABAPADGhAAAaCGEfAFFCHBD..IBGH.gCEBhAHA.KCHHhAIA...,2,-27,3,30
fHZSKCGbETONDXecPAUFLIYagRBdJQMVW,LFCFaECABBFF.dADB.QEFHMHFE..VBAFHBDBSCFAhAAACBGBEBADOBHDDGCAeHAChABAAAACFGDF..IHHEhACA..YFAE.JFFAfBBBhAGAKAHB...hACA...,1,-10,-32,22
CeBbDfcGdaFSWgVQNHJAPYRLOKZXIEMUT,REEELGCAKCDAZGDA.EEAA.UAEGCACD..BAHEDBCFGDDH.aBDHhAAASCGE.hABA.WHFAVBAB.QFADhAAA.JAEAAHBFPAHB.XEGAhACAIHHF..hABA...,2,-41,-18,23
KEWTXAFORbHCIGYdaSgMNDfZcQVUPJBLe,FAFCOFAHHBCBGDFAaDAB.MCIFDIFCZEECQBEF.UCAFhAAAJCHFLEBHeFBAKHDGEABAhABAXAAGAHCB.CGHA.hABAIHHGdGEF..SAHB.hAEA...fDDBhAFA.,2,-16,-13,3
MBHKQXeFCbPcaGRUfSTJLZEVWgDIYAONd,OGBEMDCGKACD..XGFACFGB....PHDGGBFGRFAG.hAAASCBFLBECZDAAhABAWAHBDBIDAFABdACBBHHEhADAQCDE.eAAFFEEFaCFFfFBHhAAAEHAE....hAFA...,2,-23,-16,7
YGZUWSPIRTfVaFOXLcdCMBHDNbEQeKJAg,GFDFUAAD.SACBREAF..fFFGaFBBOAEALCDFhABAdCEGCBBBBHHCDEHDECGChADAKBAFAEHHZAFG..IHCBhAAAVGCC.FCGBMFID..NBIG.eADC.hABA......hAIA...,2,-22,-10,12
AFXUWcgYaMRZeDCHTVbNJPQISfLBKGOdE,UCFB..gAAF.MCGFZADEDEIHCDABHEEFVEADNEIE.QEFDhAAA.SEDDhABAfAEHBCAChACAOAHHADDG.FECAXGGCWFCDYCCGhAAA.eEABJHBEIAHAhADA,2,-24,-23,1
cWfPLFBRKMHbITXeQSAZJDaYNdECOVUGg,DDIBaGEB.dCAA..ODCHUEDGGAFA..gAGAhAAA..cFAHPADDhABABCDAREFAMCBHHABGIGHHhACATGFD.eHACAHAD..YHBGhAAACDGCfDECKFBE...hABA...,2,-26,-12,14
BHGfYQRZVWKSLbJeAgMaPFONcUXTCEDdI,MDFFaBAF.FHECOCDE.UFFBXGBH.EGHHdHAB.IAEDhAAABADHHBACGAGChABAfEGERECH.WBFChAAASGHHLDDDeDBHAECFPDAF.hACA......hADA...,1,-9,-19,10
OWVICeUAGcSFKTMXQYBLNZaRdgPEbHJDf,SFHBFDGDMIEC.QCCFBGGFLACEaHEA.dGCE.EDBGJBFEhAAA.DEGCOFHD.hABA.IHAACGBDeECAAAAGhAGAKCAF.TFBFXAGDYDFFZBBA.RABE.hADA......hAEA...,2,-22,-14,8
JaRbGTdWAEYCDgINcKZeVLXPQfSFBUOMH,CEDADCGA....IHEBKBCFVEDC.LCABQFAE.FABFhAAAOHACMAHHaADFRADDGGEHhAAA.dDHGEDHH.hABANCGGZAEDeGAE..fHGFBAHD..hAIA......hBAA...,2,-31,-15,16
DHgVdeWXGPCTMZNcYESIFKBORUbAfaQJL,aGEEQGFHLEBEHFBHdGBH.eBFHGAFATCBHMACAZEFE..hAAANIDF.EABH.SAEHhABAKBDBBHAGOAABhABAbAGBAEDBfDAGDDBG..gFGBhAHAWEDH.CFEA.....hAIA...,2,-16,18,34
HEULfSZNgPWDVeFIATabQXJdCYcMGKROB,TGFGaHGC..QFAFdEBGCDAF.MBFFKBAGBCHCHDGFUAAHhABASEEHZDDF..PHCAhADADIDEeFCHAAEFJAHF.hAAA...YAFEcDBF.OCDG.hAFAfDDE.hAGAWEHB.,2,-46,0,46
WKYEBReSVbLPNXDJQcagGHfAMTIOdZUCF,MBHBTCBCdDCD.UACCFBGGKHDG..BBACSGFGLEFG.hAAA.XFADQGCFhAAAaBEBHDFAAFAFOFBAhABACACCEFCGRAEB...eBAF......hABA......hAEA...,2,-25,-18,7
GPUaCSXLTgKIdbBWNAVMcRZOYJeEfDQFH,VEEHMCDFZEAH..JCCDEAAF..DCGDHEEBGGAHaHGG..CCBALDHBhAAAKADCdBAFBHHHAIAERCFBeADGhACAFCAD..SAFAhAAAXAGF.........hAFA......hBCA...,2,-36,-7,29
XfMIYJCRQaBZceVDETGPbSKFHNLWUAOdg,OCEAdFBF..fHBDMDBA..IFDEJBBG.CFGHRFAFaECAhAAA.BAGEZEEFeAEAhAAADGFDEDHD.GBEBSBBChABAFGGALBAFAEIF..YHDAhACA......hADA...,2,-29,-20,9
BaFXgETHWUePAdOLfZRCNYMKQDGJIVScb,LCDDRDDECCHC.MBBCKEAFDIAGGCAE.JEHH..VACB..hAAASFFFBHFCFCAC.hABAXFBH.EAGEhAAATFBB.HEGHeAFDAAHAOFDDNICD.hABA......hACA...,1,-21,-32,11
DYSXJFPefRWMUgcIHabQOEALCdNGKBVZT,dAGGKFHDBCDHZAAADDEE..SBGFFHBG..eFEERABCUFEE.hABA.IFAB.hAAAHDACbFBGECAGCGEC..hABANDIE............hACA......hAEA...,1,-35,-43,8
TaOXUbJKPBRedAFMSZYfgWGEILHVQNcCD,FDBHZDBH....fCCBGBCBEFHBHEEBQDFCCFAE.DBBEhAAATBEGaHCG.OEHFhAAAXDDGJBHBBADBhABAeADEAHBHSCAF.YHACIAHBhABA.NIDF...cGFEhACA.KAGE,2,-24,-8,16
XbRBLYGJgaWQDHSUdZKIMfATNPVCcOFeE,TCEHVDFC..CBDF.OFBC..EHGARGECBCHFGGAB.JABDaCBGhAAA.QDBHhABADDADUDDEdAGCIAEB.hAAAADIFPHAC.cFGF....hACA.FAGA....hADA...,1,-18,-33,15
OSDgNEYcRaAJCGFXbeIBdfWVTHLMZQUPK,CBHHFHDA.eCHHBHBCdEAF..VAEALEDCZBAA.QGGFhAAAUFGD.OACASECGhAAADBCHEGBC...cBFEhABAAIDCJEAB..XCDH...fGEGhABAWHAG.TDGBhACA.,2,-44,-14,30
FTPYJSVKQXDUGagWdIRCMOHcLEfNeAbZB,BEHBTFEDJEEF..SHCGKFBD.DCEHUBDCGADB.aDFGhAAAdCBCRDAH.OCFDHBAGEGHFhABA..eAACADAFFEHBhACA..PAHB.QGGDWAHBCGCB.hADAMEAFfGAGhAEAZFCH...,2,-26,-4,22
LNHWFEJZOBVYQdTgIcDPXeMabSCfRAGUK,KFDEHCDFEBCGZAAG.BBGAQCFBdDHA..TCAG..IAGGhAAADFADeFBBaBABCHGAAAIDhAAALGFEFGEA.JEABhABA.OHFE.YCHB.gGCEhACA.PCCBhADAMAEASFDD.,1,-8,-22,14
IRWgQGUeaEPcTSZCObLfVdXKBFMJYNDHA,RBEFQECBeEFF.EGBETBBBZFFD.OEAALACH.dAAABACEhAAAFAHDMBFHJEHHDBGEAGEF.hAEA.IHAF.hABA.WHAC.........hAFA......hAGA...,2,-35,-23,12
MfWIaPNZcEYTJQSKGCLeRUHgDFBXAOVbd,OCFCdCAEMDFF....fACDIECD.aFHHZFBA.EFHHJFFHhAAAKHACCGAG.LAAEhAEA.eCDBUDCGDAGBBGBBhABAADHF.WBFCNIDB.YBBDSBBB.hAEA......hAFA...,2,-37,-14,23
IePQARfDLgcHWMFUYVTJECSKBXOGbaNZd,DAGBLFABHEGHMECDFAAHUCDG..VAAGEGCC..KHGABHCHGAGEhABAaGEHZCDH.eAHBhAAAAFHBRCBH....fFFGhACAcDAB...YADECADESGHHhAFA.OBFHNDIA.hAIA...,1,-7,-23,16
VQcSgDHXGeRYWNAITCMPFaEbZJKUOfBLd,TFDCMGCCFCAF..aCEHEHAE..ZEAEJDEEUFFG.BHCFdAEFQGGAhAAASBGHHAAHhAAAeCCH.RAEB..NIEHCDCCbABBhAHA.KDHH..fGAHcAGE.DDIB.hBAAXACB..hAGA...,2,-13,-12,1
eTHWECXGgUNfMbKZRSQVdYOFLDJcBAaIP,aAGFeAEGHEBACBHH.GGBBUBCG...fGHEMBAHKFEAZECHSBBAhAAA.dFGFFHFChAAADBIFBCFDIAEChABATGAHEDEC.NDAB.bCAH.......hACA......hADA...,1,-8,-29,21
fLDAHedGgRPJNaOcbTBYWISEMCZFKXUVQ,HEFDdDBCRDDB.JCABOHCA..TCGCBADG...IAGBhAAASGGDMEDDCDFAFAFHUCCFhABAQAABDEIHAICEeFAFhACAGDGC.NEAE.aCFB.YACG.hABAEHGCKCCE.fBHGhAEA.,1,-1,-25,24
QbJMgcPKAfLRXFZdCBNVYIeESaHODUTGW,LEHDXGBGdHFHCCHGBGDA....VDAEICFEeAFASDFEhAAAHEBADACFTADHhAAAGADC.QEGFhABAMABD.cFEFADEHfHBDFABD.NDAGaFFFhADA.....hADA...,2,-23,-8,15
UdQMNBKaJTWRSeZGCAHPFcgObXfVLEYID,HAACFFHDOBAHXCEHLBHBEGFH.DEEBUBGE.dEHGMGAEBCDDhAAAKDFHTFBG.SEAFhABAZCBBABCG.PADGhAHAcBEE.fFFEIHHANIAFJHDAeECGhAIACHAD.....hAAA...,1,13,-35,48
TaWIQVYPDALCgJdNEfHGXMRUBKScbZOeF,CDHCJEHDdFFE..EEDDGCCD.RDAF.BBHFKBAF.SGBH.hAAAZEADFGCD.aAEAIACChAAA..YHFGhABAPHDGADGD.NAEH.fAHCHBAA.MFEHhACAcDDA...hADA.OBBA.,1,-21,-25,4
AYHSIfQOGJWCTeVFEPBXaUMcZKDLbdNgR,HBACSCBAQBGHOAEFJECE.CEGA.eDFFFGEG.EECFBGAAXEGDhAAAMIBG..KADADBGAhABAdAGFNEAG.AFAF...fHDBhACATDAEaGHDcACG....hAGA......hAHA...,1,-15,-27,12
IKSaVUZCfMXLbEHDgceTYWNPAdFJGRQOB,FBGCJCAAGAEFQFECBGDDKCCC...SDFGaGFEZCGB.MCABhAAALAAEHGACDGHFhABAeFCETDBB.NBBH.hACAAEACRCEH.IHAFCFAAXEGEEFAE....hADA......hAEA...,1,-13,-17,4
eAQaJPKVbWZGIHFTSYNCMDXfORBgUdLcE,aACFKFBC....VCEHZCDBHEGB.SEAFCACGMIBG.DCIBOAEChAAABBGFdGDFLDAGhABAECGFeFBHQFGEhADAbAAD.ICHD...FBBH.YGCGhAEA.fGAAhAGA,2,-28,-17,11
QDGTdgBPXCNIHOZfYaRbSEAKVMeUJWcFL,VDDHUDBB..JFBBFBBG.LDGDDCAF.dGBDBHDH..CAGHHBDGhAAAOFHH.ZEFBfDAEhABA.aHCESABAhAAAKHFC.MCIB.eAGBWFADGBCDhABA....hACA.gFDCNACB,1,-24,-27,3
eNJQMgRbHZdAcLKFaYSWDPGEVUOIXfTBC,KAGHFFAD..aBAASECH.DBAFPCEFEFAA..UFGAOFGFhAAA..IDBBhAAATADABDGACAFC.eHAAhABANEEAMIACRDAG.bBBAdGDA.ACAA...YBHBhABAWAFE....hACA...,2,-35,-19,16
aSWVBgPXJdIMEFHTZKGLAceRUCQDfObYN,eCCHCGBADAED.OEED....bFEAaBFA.SAAHBBACXAGDhAAAdDHCMDAF.EHAGhAAATDBAKGGBAEED.UDGHhABAfGCG.WABHPHDG.FDDA.hADA......hAEA...,1,-26,-30,4
JXYeLERZdSVHOfTBFAUMCcPWNIgDQKbGa,MBDACFBH....PDFEIDEE.DEABQCBBKBCF.hAAAGAEHaHBE.JFFAeCHDhABALHCEEGGEZECCSAAChADAOHFCfGAHFEDFABBCWEADNBBG..hAEA......hAFA...,1,-20,-25,5
GZFURVLJBMNSbQaHEfKdAcXCIDegYOPTW,CHDAeHAE.OBCCTAGAGCEDFEEA.UGFARECBLACFBFAGMACGhAAASGHD.aFAFhAAAEEBB.fEHGhABAACEBXADADBBB.YEEDPCHFZBAH..hABANDDAbAEA....hAGA...,1,-9,-14,5
SYbDEWQXMaIgJAPTLOBUKCNeHFRfdGcZV,LAAEOABHBHBBUFFAKACCCGAA..HBCCFEGC.RAGD.GCDDZEAE..hAAASGDFDGIBEGCEQAGEhAFAaCBH.JEEHhAGAABBENEIA..dEBB........hBAA......hBCA...,1,-19,-23,4
DMKCJHOVBNESILgaFdeTWYARfcUXQPbZG,RFAHUEEEQEECZGCCDEBE.KGGHHAEC.BHAEECCHLABG.hAAAaHCCeABC..TAFChAAAAHHBfCCBhABA.XDGDbCFAMEDDCFDC.JCAD..NAIEIFAEhAFA...hACA...,1,-13,-22,9
NWZePXHAJaFBLRSEKgfDCIbUdYTOcGVQM,aGFHBAEBLECHRCFEKGFE.DABA..CGBE.UBFCdCAD...OBCEhAAAGDCDMEAHZAAA.XEFAhAEAAGAF..JHCGEDDGhAFA....IHHBYDBF.cGGChAGA...NDIG.WFFEhABA..,1,-28,-45,17
LTfSYKegOabDIcAPQNHJUEMWCGFRZVXdB,QDEHJFEC.EAGGCGAHFDADZACH..dEBFBCEBLEHH.TGDBhAAASHEC.hABAKAGEeAFD.aGBDIACChAAAAGGDNEAC.MCCH.RCGF...fBBChAEA..ODDBhABA.,1,0,-54,54
eaWGDJIRBdCFbOATEgVQLPYcHZUfKXSMN,ECFGQEBELFHH....PGFAHFFFUEAEXACENDEGeACDhAAAaEDEDIAA.JAADBAHAhABAFAFD.AICCTADChADA..YHCCZDFE.fBHGhAAAKHAC.SCDGhACA...,1,0,-27,27
dCFSDYbWgcQTJZLIANRMPKafUBOEXVGeH,RBAHMFGFKCFF.UGCABHGE..ODCGEGADGEAHdAAE..FFHDSEGHhAAADEFF..bEAChACA..gAEChABA.TBGDJBGDIBEFAGECaACF.fDADhADA...hAEAeCHHCDDB,1,-28,-36,8
RHMbBeGUIDSfEOWYPQJLCTdVFgNacKXAZ,ZFFHRFDAMFAHeDAH.UGDGDBEF...EDFGODFG....PCCFhAAAJAAHCHHE.dBADFHFCaCGAhABAKDCHAFCF..BHBCSBFGhABA..WAEGLADC..hACA......hAHA...,1,-24,-39,15
RHecOEIVTbULdKBSGaZfQXYFNgWJCMPDA,eDADOHFEEHAC..VFAHUAGB.KEDHGAAEZABB.QDEGhAAAFGHD..NDGE.WGFChACAMFFDAEIF..HDCHIBEHhAAATAFF.dADE.BGDAfDHGhABA......hAEA...,2,-30,1,31
DbNSTAOBaRUJVdYIQfFLMPWHXGEcgCeKZ,OEDAaDBA.UDGAdAHCQGDBLFAA.MCFFHAAEGEGChAAAEGHFCBFCZADBDAGD..SBBGhABABHAEJCAF.VEABhACAIHCCfADD..WCCF..hAAA......hACA...,2,-22,-7,15
IDXafTCSWAHQFdZeELPJKUMBgbVROGYNc,FCFCZEBAeABAEGAD.LFFFKEBBBHCE..VCDERDDFGACG..hAAANDIC.DGFD..aGCCCGHCAAEGhABAQAFB.hACAPBAHMCIDbFFFODGF.IGABhAAAXAFESCCDhABAdBBG...,2,-16,-15,1
SFaPRdZVOWbBXGDeTcIJUAECNLKYgHQfM,CDADKCBFHFECQACC..SHAAaGCEdCGEZCEHOBGHBHHHDDEDhAAAeFBC.IAHBhAAAJAFGADID.ECAGLFAFhABAYHFGMDDDFCEFRABC.......hAEA......hAFA...,1,-6,-23,17
KICGJWTdUNFgbEXMVAHfLecBPOZaDSYRQ,HFECLDGFBHBEZFEFDIFERDBHKDDECFBB..GBEF..JAAFTCBBhAAAUAGHFADG..EACChABAMHACABEGeDHB.OFDHhACASGHHQDEC.WAFE.hABA......hACA...,1,-5,-34,29
dOfCMNDFAYQUXZGWaSTeIBREgLHcJbVKP,QFEGUGBDZBDGGGEHaEAC...eACEIEGERDEF.EADGHDBDhAAA.JAHFVCCHKBAF.hABAOHAEMFADDEIDACBHWBAChAAABEGHLDHB.cBGB.dGBFhABA.CHHH.....hACA...,2,-10,-8,2
dXLgOADQJBfSGbEYCeKTRaZWPUNIVcFHM,DEADJBECBACBGFCB.EHBG..CGHF.KEBGRBBD.ZBED..UFDF..hAAAIBAFFFAD.dHGHhAAALBADABIHQCCBhABASGGDeFFEaAHB....WEFEhABA.....NIAH.hAEAcADG.,1,-13,-43,30
HQPUCGBWDVTeYLJcMKfOAIZdbgESaXNFR,dGGGEGFG.aDBEFADA.REDH.QBAG.UDGGBCDH.VAGBeAEHhAAAJBADKHAA.ABGFZEBESGABhAAA.HDBHhABAPFEFCFHA.DAHFTDFG.LHFGhACA..fACGhABA..,1,-17,-18,1
YdLBFAXEZPJcODWUMHISVTNfGCbQaKeRg,EEEAJCFG.DGIDUBBH..HCAB.SGCCVFBD...fHDBhAAAGEGACGEEaCEBhAAAKCCBgAGChABA.YADEBADEAAFF.PFGFOCAHWDFEhACAIAHA...hBAA...,1,-22,-38,16
RFBKLPgONIbJEYDdTUAcZQVWeCGMfXSaH,QGEEeHEACFCH.MEIDSDCEHEAGFCDCKFAFLACE.hAAAOAGFIBEGEBAGDBIFhAAAdBHEABAHZEEAVEFCfGADhABAaDBCBCFHNIAD.....JHAE..hABA......hACA...,1,7,-28,35
dPBMWVYEgIDceKLaQfNAHFZSRJXGUbTCO,ZDAGSEEAJFBD.GABA.UFBACFDGOAAFdAEBBFHD.MIBAhAAAVAGH..EDDGDHGChAAAKAHHLFFG.hABAaADD..NDAAAHEE.HBEEFEFA.XGGGhADA......hAHA...,2,-36,-10,26
FgfbaYQXRIOGCNAWceSdEZUTJLKHBMDVP,eFFEdCCGEEDAUBADLBEAHGCGDCFFFFAB......bGBAaBGFQFGEhAAAIHAECFAFABAGSCGAhABAZDCD.hAAAKGFFBAECMADEgGGG..fCAChACA..hAHA...,2,-23,-17,6
PCFfNDgdQMOAaISRGLJEXHbUecWTVZBYK,SFECLDDBEGADHACHUCAHeEAE.TBGABDFAKFBH.CEHH.hAAAFDECDBFFdCAH.MFHBhAAAAHEFRFFB.GGBF.XFAChABAbABA......cAFFhABA......hACA...,1,3,-35,38
dfDIQZTUgcHXCSPBAYeWKNFbLOGVaERJM,eDHHKAGFFFCFOCCEGCAC..aACHEDECRFBA.dADBDAFDZGFG..TDAEhAAAUAAHHEFG.CCDFBBHAhABAAAGBNHDF....hAHA............hAIA......hBEA...,2,-34,-17,17
NHagRTPEBbKOCfSDILeGUMJFWQdcZAYXV,XEFFVDDA.HCAFaBBG.RECG...EHDABHCCKGAF.CABHDCGALAFAhAAAeCDGGADHMGCEJEAChABAFGAHdHGBAHIB..NIDH.PCHHhACA..fEHAICCD.WAAFhADA......hAEA...,2,-18,-11,7
DTMaRfAeGHWQXNCJYIPFUVgEbZLScKdOB,eFFGGEBAHDBHQAGDXAFHCHDEJDEG..IEHDFGGEUBBGhAAAEBBALCAFKGEBOHBEhAAABFFHDFBBMIFEfAEAhABAAEDH.WAHB...PDDAhACA......hADA...,1,-13,-18,5
dHLPANSBQReGcMUXFVODTJCKYfIbgaEZW,SDFCQBAAGAFEUGGC.FFBAVFBGOGFA..DCCCCEGAKADDhAAA..fEDDhAAAbDDF.aGEDWHDGhABAdADFPBFCBHAAeAHBXBAB.YHAAhABA.IEHBhACA..,1,-10,-22,12
FZNEODBCbGfWLAdMHgUJeVaTYIXRKSPQc,MAIFUGFBeFBD..aGDC..IAEFRDFAKDBGQAEGhAAAFBAAZEDDECEEBBAE.CGGA.bACHhAAA..fFDBhABALCGBABIHdACC.gGAF...hABA......hACA...,2,-21,-21,0
WaOXQdPfEJDBMHAVKCGLebIgFcZTNRYSU,VDGDCHCHGCAE.LAFGeCEB..IBCDFACCZCDGREFA.UFCHhAAAaGAC..OFAGdGHCEGABhABABBAG.MAACACCC.hAEAgAEG.TGDESGEHhAGAQGGB...hAHAfDDGDEEC,2,-13,-11,2
WOIMGcYBQKPLTZDUNVSgadCERFJXAefbH,eFGBHDAEOHDGMADGGDBHBCCHKGBELHBGDABH.UBFA.SAAFhACAgDFHaFCEhAHAEFDERBCEFDHDABIH..bACGhAAA....WFFDYHFG.PAFGhADA.....hAIA...,1,-8,-15,7
DHNaIYGJcTdRFCMOASeQbUPVKEXWBgZLf,eDCEUBGBKBDDEAGFBDGALEGHHEAB.aGDBGEBB..TGFAhAAAFBBDMDAHABCD.SACEhAAAPAED..XACBhABA.WCHBfGAFDIAG.NEIEIHDDhABAcFGF.dGFChAFA...,1,-6,-29,23
HRXJeFWEQcaSZDdgLCYPOKbGUNIfBVTAM,HDCGXEBHJEGFFABG..EHDG..QADAaBAEZEEHdADBCCHH.OBHDhAAAKAGGGFBFUBED.hABA.IHACBCCEAFBEMIAAhAAAREGF.eHEESDCBDFIB...hAGA......hAIA...,2,-17,-8,9
SVEKAZYLCcBDQgMOHXPWUTefJaIFRdNbG,ZDGHCHBHDDBHMFFD.HDBH..XCFHUAEHeBAA..fHFDhAAAJFDHFBHF.dAHG.hAAAGFCDSHAEhABAECBGAGBFLBAEBEEF.gADBODAH.hACAWDHHaGGC....hABA...,1,-8,-34,26
MEeWZNVaAUHGQXPDSKJOBFCRdTgfbIYcL,HDEDGEFGQDAGDBGCKECBBADHRDGFdGBC.TAGA..gAAFhAAAbACF..IBBEhAAALCCGEFCEWFAFhADAZGDE...aEHFAIGCXAEDSHDE.hABAFCGG.CEEF....hAGA...,1,4,-25,29
aTBLUdGbMFgIQNXRKWCDAVZcYOJEPSHfe,VGDEZEBAOCBA..EEAESGEAHABHeCGFBFFFdGAEGADAhAAAMCHBFACAQAFBhABA..RGAAKAADDFDAAIGChADAJAFGfGGDaCED......hAGA......hAIA...,1,-1,-28,27
QEKZbAHeJFIOCVWfXGcYMUaDTdBRSPLgN,eACFJCBA.OHEACCGG....VFBEfCFBGCEE.MECHhAAADAEFBHABRBDBLFEEhABA.QAGEhACAEABGKGHHAFHA.IGAC..cGFBaDGE.SAFEhAAANBBE.HDAEhADA..,1,-14,-26,12
gdSWATEaYcefQMOCLKbBHXINZGJDFRPUV,aCAGeGCC.MADECBGALEFGBCFCHCAA..XEAGZAEGJFHBFHEChAAARGDEUBEGdEEF..SBAChABAABDFEGAA...hAAAfBHAKHGANABFPDDH.....hACA......hAIA...,1,-17,-18,1
GVFePCKINRcQYHJdTUbXADaZgEWBLSfMO,DBFGaBFCZAAAEFDG..BDCBLFAH.MEIBOFHDGFDHFEAGeGAEhAAACAEF..KCAEIABHhADARDDA..YHDAhABAJCFHdGGG..........hACA......hADA...,2,-37,-23,14
NKBdcfSZQTFJeGVXgDaWCMYHAIOLPRUbE,OEBAREEEUBCA...ECFDBHBAdHDH..SGCCTGEA.FFFGJEABhAAAGAEH.VBBGhAAADCGBCDHG..MDABAIDA.hABAIGHE.bFADNADDKHGA...fFCEhACA..hAIA...,1,-5,-47,42
BUbSEPKLdTHVWCOgXQRFcNYaGZMAIfDeJ,DGGDeCGDUBBFEHAGKCAALAFF..HFBE.CCEFOEEFQGBHhAAAFAAA...NEIAGEBHhABAZAEAACCAIHGChADABAHHSGEB.dDAD...WEEEhACAXDBA..cBGHhADAMDID,2,-31,-24,7
PRHKECcDLSQIUXAVJbTGeZFfaYgBOWMNd,VGCCTDFC..ZFFCaAAGBDAE..OFHHMEAD.dGACRCDGHCGBhAAACCGEDDBELEBH.hABAQADHXBBBAHBDhACAGEDEeBFCfEBH...hADA.WAFE.NCIC..hADA...,2,-21,-10,11
OfYXFMKRPAUQNEDbIcTGLCBdaJZgVHeSW,UBBEEBDFDGEC....IAGBGDGEBBHDdEGHZEAEVCAHHFDAeHAChAAASAEB.hABAOHECXDEGKCHDACGFhAAANACF............hABA......hACA...,2,-28,-25,3
EDGbAdOIHgBYfVCRQUKeTPJMWFZNSacXL,dGEBOEDHHBCHBCGBVCFDRABB...KGAGeAEE..JCBHMGFGFAACZAFGhACASBEB.hADAaHFG.LEEGhAAAEFHD.DBABAEIB...IHAGfEDA.hABACEAG.TDACWHCA..hADA...,1,-18,-28,10
BILdNUTZfcRVOaXJKYHMGbFPAWCgEQeDS,CACCQGGEDFBB.SEDHBFHGLEDEdEBHUAAHZFCGRBDAOHAEhABA..aDBFXFAGhADAKAGH.MAEGFDHFAABBhAAAECEA.IHEG.NBDF...fGGGhAEA...hAIA...,2,-42,-17,25
AMdbRLKgXcTSPZEVOfJWUeGDIHBYNQCaF,MCAGRCBHLEFEKBHF...XAEHTFGBZEBEEFHB...OAAAhAEAfHCFJAEEUGDGhAIADEDBBAHG.YAAHhACACCEHADBC...gGFESCGD.hADA.PEAH..hAEA...,2,-28,-26,2
NYbfdXQZKVagBCETLWOJeDMIcUHAPRGFS,REDESCDA..NDBF...fACFQBGAKEGCaGBFBBHBhAAA.CCAGEGBFLACChAAAOFFFDEBE.MIFGhABAIAFDHGDEAHHEFEBBdBBHXGDHgDGGhAGAWBBG...eFHFhABA...,1,-6,-31,25
ATMEdPGFOWgYJIUecVHBNLKXSaRQDCbZf,EGAFdDCFFFCA..OGCA..gFGBIECG.eEBDHBCEhAAABHDHKAFAaGHHQADGhAAADEAHCHFBZEFAfAGEhABAADACMABC.PFFH.YFAF.hAFAcCAG..NIBB.hAHA.SCHF.,2,-11,-9,2
JWdUBbMQGSHEZaXYLTCeKRFVANcIfDgOP,..IDBBfCDGDADH.OBFD.JGAEUFGB.BBABbGFG.hAAAMFFHGBACHAFGaEHHhABAXFCGLECACDHHKGABhAAAFAEBAACC.NBIG.gDECWHAA.SAEChABA...hAGA...,2,-24,-8,16
aUSRILAeVTfXGEKFZQCcNbWgdDHMJOBYP,VGEETGBE..GDAAFDCAZCAH..QCEFCEGF.bABFdAFChAAA.DBGG.MEIBOAEGhAAABFDDPCHFSFEHhABARDCDAHCAeFFEEGGHKBBENIAD.....WDADhACA.....hAIA...,1,-3,-23,20
AQUSbOGVRJKNDCeIWfBaPYgMFZTXHdcLE,UACESGEAGGCHRCDE.KCGDDBBH..CAEH.eHFA...IDHDhAAABEEAaFGC..PFCBhABAMGAE.ZAFGXAAGhABAdFFBEDCDACCCOAHDNACH...fDDAhAGA.YHAAhAHA..,2,-26,-22,4
dUegDWYNbVBIEKFAMXTRJHScGLQZCaPOf,TDFBHBFGGCBE.QACEZCCEaHBGOAFCfEGG.hAAAdFECUACADCAFYGAAhAAAVFGBBHDH.EFAEAEIDMIDChABA.XGGA..JBAFLAFChACAeEED....hBAA...,2,-10,4,14
NYdGALPDFXZBgHaEVfTUKWJRcMISCObQe,DFAHZEEFBDBGHECBaGFHEDGA.....VBEEUGCD.JAADMDID.hAAASFEEOCDCeAEEhACAdCADAIHALBFAhADAFABBfHAFKHGA...WEEEIHAFhAHACEBCNAED......hAIA...,1,-10,-27,17
MGNLaUfcZdIQBRHJECSbVTDYWKegPAFXO,XAFDMBCALDFCUCBD.ZFGF.dDCDBEDHHEAHJFGDEHCA.SCAFhAAA.TAGEhABADAAEWADB.eFBFhAFA.AIHG.OCCG.NGCDaGAHfGDFhAHA.IDGGCHEA.hACA...,2,-41,-2,39
XfTRSJUAMVEPabLcIQNgBGYeKODFWdHZC,VCGDEFBF..aGHHLBEF..IGDAQFCGBAADeBBHhAAADECEdAHGCBAA.TAEGhABASFFHAFGB.MDADhABAPDABNICB.gDFEKGAB.WCAEhACA......hADA...,1,-15,-38,23
VGKAQeWFYCBDfLgZHPbRXOTINSdUJcEaM,eGBEFGGBCAAF.BEGGLCCDZAFAHABA.RCEF.TFDE..ICDEhAAAdAFGJCGB.EHGGMDBHhACAKBADAAGA..QGBDhADADCHD...fDDB..hAEAgDAAXAGESFHBhAHA,2,-34,-15,19
TaZJfRMBCHWDbVPFSdUIcLGKNegAXEOYQ,XDGEODDA..TADDJDAD..MFDABAAEHGDGDDAFVAGDhACASBGD.dADCIGEBhADAGEBGKAAFgFAAhAFAEDDCQGGGaGFDREFECCBH....bFCDhAGA..FAHD...hAIA...,1,4,-20,24
RDTNAZHKYCGeVaQFBIUfXMPdJSOcgLbWE,KBBFCBGGGDEFeFHB..QGAHBGAFUGGCMAAFdDCA...SAGFhABAOBCCLCADhAAAEDCHTEEFAIBC.ZAEHVFDDhABAaHDCFGGH.fDGH...hACA......hADA...,1,-2,-29,27
YUAGSJgHZaCBQVcfdPObMRDXKELTWNIFe,SGECHBFAaDAGBAADQCFE..fFFDOCBEREACDCAGhAAAKAGEEBCBLADChABANFAB.FHAEeHEEADHAJHFGCEGEdBEChABAMFEC........WDHBhACAIBEA...hADA...,1,-12,-22,10
WeGDPHRXCVBIaZKfFdSLgTQAbJEUNOMcY,JFBHUEDF.OCHFMCFH.........WHAADDIBPCBDhAAARADE.CDGABHGDhABAZCADKAGCFAHDSCEAhAAA.LGEATGDHAAEDNDCG.eDDH.XAFBhACAIABGaADH.hADAgFGB.,2,-28,-22,6
NKgYMZLcbGJRIAOXdWDfUFaeQCHETBPVS,ODDFdDBHDADEUDFGFDFA..eACAHBAGEHCGBAGA...SGHDhAAAKGHHMCAEZBFALHCAhABAGDAARFBEAEEFfHFBhAAACBHA.PFFG.....hACA......hAGA...,1,-12,-31,19
eaVGbCNKcMYZSOIJTXfBQgURPHDWAEdLF,EBEEdAAEeDFBGECGCEHA.KFGG..MEBHZBGHSEAF.OAAEhAAAIDDE.TGCChACABAHEgCDEhABAUAFB..PHEEDDAGAHHG.aDCHbFAHNDAG.cGFChADA....hAEA...,1,-17,-24,7
IbAGgFSMaYPHODCdcfXBKVWeELQZUNJTR,GDFESDDHMEDF..aABEHAAC.CDAHdFADXGBGBCEHKBHHhAAAVBFHEFEBLFGBhAAA.ZCACNIAD.JFEDIHHAhABAAFIHFEAAOAFADHACfADD..hAFA......hAGAeBCA.,1,-8,-11,3
XaJDCLcYZTVEGUQWHAdPMKebfOSBFIRgN,MIBEeHDEODCBBABDRAEA.....gAFEaFAGDEDE.LAHBhAAAZGEAECHD.QEFDhABAACACdFGH.KBDBSDAChAAAIBBDJDADCGCH.cDDE...hACA......hADA...,2,-37,-8,29
DCbXFAegWSZRMfYaGBETQIVKLcUNdOPJH,eGBASFAEMFGF...aFEDBCDG.TEADQEGB.hAAAKBHFLAEGUBDAdGDChAAAPDEDDBABCCBFXGAGhABAAIDCWFHDZABB.fCGD...hACAEBAHIHHA.hABANEAD...,2,-25,-19,6
TBULHGaJIXDYAEMdPFeNZWOfgcRbSQVCK,dGCCeCEFZCEAOCBF..fFECRGCA.QAABhABAKADEBFFHHDGDaHGG.IBADhAAADDCBADBHEBFAMFBDNAIC.hADAgAGDSFAHCHHF......hAEA......hAFA...,2,-24,-20,4
aYKdPANOFQfGRUHISceJXgZWMDCVBELTb,FGBCGCCCHFECSEAGJDAC.ZADHMABGCDHFBGGBLHFA.hAAAaEDEdBAF.AIEENFEHQAFFhAAA.fBBDhAGAIHBCXAGGgDGGDIGC.TCAGhABAYAHB..hBAAOGDC.,1,-8,-16,8
EIgAfXHcUCBDOaSNVJTdKMPZReFYGWbQL,HEBDUFGGCHAGDAHH.aBCF..SCEA..NAFG.JHBAKGDAZAADhAAAeAACGEECQGGHhAAAEDCH.AAGDXDGChAEABAEFTAGCMIBAFACD..WAHH..hBEA......hCAA...,1,-21,-22,1
QfCOcPJSFZBLdGUabIWVEgRDYXMHTAeNK,eBEFQGFDCBBG.OAEBJEGD.ZCADBBGGdHAHUBGE..IGAEhAAAEFGGRFCC.DFDHMAAChAFAAIBG.KDCH..PDAGhABASBBE..FACEaCFHbFDD..hACA...WCFA.hAGAYAFC.,2,-36,-3,33
TCORZJIaMgNGDWLcSQUEPAdKYfBFeHbVX,dHCHKBDABHAGeCCGHEEC..VGCGTAFCRABH.JABC..MDEGhAAAGEAGDAGD.LDHBhAAAQEEEEECCAHADFGHFCHHD.hAEAZDAEaGDA......WBHHSBBDhAFA....hAHA...,1,2,-30,32
eUCbcBEVXLDWPIdFJKNHASGYQMZgRTfOa,SEDHQCEAMEHDRFFG..OCEGaCCFUGBDCHEFBFAA.EHAAhAAALFFF.WADChAAAIAED.FBCBhABAKEBGADHFZDACTCAHfAHEbAEAXCGAhABADDIH......hACA...,2,-22,-16,6
JDAVIKFEWcfBRQMaGHNUdgZbXOSPLYeTC,KBBHFCCCEDBD....fDGBREEFMICCGAGGHDDEUGAEZABCOFABhAAALBFG.TFFGhAAACHGAADGF...WHFGhABAcFCGBBDANACB.gDAB..hACASGGEPAFAeFDBhADADBFF..,1,0,-22,22
bcKBaAIMRVJNPDefFZgUSdXLQOCWYHEGT,MGEGVBAF...JAHFDFDA.FGHHUBAE.dFAHQCED.hAAACFAHHGCAGCCGTAFFhAAAKGHBBHDF.IBFBhABANABB..eAHHfEFBSFGFhAHAOHECEDCH.aAEBAEID..hACA...,2,-36,-6,30
SYAWIbQTfcXdDKMLBRePCJOgaFHZGENVU,..IBDFTBGA..XFEEdBFFMGDCBBEAeAABCAAH..ODCGhAAAaFFAHGAEZDFGECADNCAGUCGFhABAAGBB....WHFGhACAbCBDQDDB.DIGGLFADhADA.....hACA...,1,-5,-18,13
ZBVGfdHWXgMEDTacFYObAICUSKePQJRNL,CCBHUEFGKCED.QGCH.RBDG.LCADBEAGGBBAfEGHhAAAdADB.HDCBXBGBhAAAMFIHEBHHDEEDaHFCFGEBOABAhAFAABAD.SGAG...hABAPBEANDIG...hACAWHAAcGAG,2,-28,-9,19
AgQaYTIXfdFPDEOCBWUGKeJRNbHSLcZVM,QFBETFBA..XBCCdCAHDFECCABBUEGBKGDC.RAFH.HAFFSAAChADALBHHZEDBAHFHaAEBhAAAIHHB.fEAAhAEAEDEEBHHG.WAHBeHAG.bBCDMFFDhAFA......hBBA...,1,-4,-18,14
TcWGNKdOfBJYaCXRVPQIEDMAFgLUHSeZb,FEBELDEAHEFFSCHHZAEE..TGGBGBBBKGCFdGCGOBHFhAAAfAEHBEACaBAAhABARAGH..PAAGhAEAIDCDMFEDAIAGUGDEeFHH.....cFABhACA.NFDDCADF..hAFA...,1,6,-24,30
BPKDTSdWRHZYFVgICXfLeJaMGQAUcNObE,UDDCOBAEBCBEKEBD.DAGFdAGC.HFEHFAED...VCDCCGEH.LDHBhAAA..JCGBMDAFhABAQGGFAHEB.hACA.cFBEEABCSHAE...hADA....WAAFhAEA...,2,-60,-13,47
gKSZAbVdaIRHMGFecTQOBLCJYEXWPNUfD,dCCCaFGDHBBFFBGD.eFCGQEEGBCGACFFE.EDHF....XAABhADAPFBG.UAEFDHAAKGHBhAAAAEEH..IHBFhAFAMACE....cAFBODHFJBAB.NIBH.hABAfAHESGEAhAIA...,2,-27,-18,9
QgATPeDIdRGYScMLZHCBVWObEKXNfUaFJ,TAEGDFFHdGCDRBAH..SDFDLBHFZEACBECD.OAACECEAKHFGhAAAXFGD.NICD.hAAAfGAC.hACAaEFFFAHH.QGAGADCDIACBYCDHhADA...MGDChAEACHHB.WDHB.,1,-7,-25,18
GHAeSfKgDPdJcEBVLCIRaYbTNFWQZUXOM,SDEHKDDFDIDC.dHBHJBCEBHFH.LDAACHBB.RABG.aCGH.hAAA.TBFCFGGAZEFEXGGBhABA.OCHFhADAMAIHAGAEeAFE.fFBE..hAEAPBADEGEFIEGGhAIA..,1,2,-60,62
ALFUMbfPQeXKdcCaTSOYEVGgIRJZDBWNH,LDCEMFGB...fBAFeGCGKCBDCBFDSGHFODFBEABAhAAAGDAE.IGFBhAAAJADBDDIFBFABHAEGUDGBhABAQAGBcFCBaHAE..YHDAhACA.....hABA...,1,7,-33,40
aBDYXOPRHGTICgQcSAfbNKVZUMWFLedJE,...fHFBKGGEZADHMCCBFDEGLBAFdAAH.JGCGEDGDBFCChAAADCGAOHBCHAFCIFADhABACEEB..QFCEhABASCBAAFBF.NIABVEFGeAFAaGFH..hAFA......hAGA...,2,-28,-6,22
aWVXZebOBTDRgfQKJSEAILUdMGCYHPcNF,LECC.MADBCDFHPACEFBFH..aEGCVCCH..eAADhABABHFBRAGD.QBAGhAAAKGGHSGACIHAHhABA.GEGA.cAFDNIAFWAEFZFAA.OHCEhACADGIDfHEDhACAACHG..,1,-17,-20,3
QUDWcbAOVafJRMeFHLKgTBNXYEIGCZdPS,aCHDRFBFMGFCHCEC.LFCBKCDCBDBG..XFAGEEAB.CCADdFGGhAAAQABCDAEC..hAAAbBCGAHEAVDFC.eADEhAGAFEEHNBEB..IHHG...PAHFhAHASHGA.hBAAWDAA.,2,-21,-14,7
QTdcDeGAXHJYZIfVBUNREKPLFagCbMSWO,JHFEZFFB..VCCDUDDG..EAAHKFBD.LADAaCFH..CHDAMBDChAAAODHH..QAGChACAdGDBDEADGABGhAAAACBHXFAG.IDHFBHAD...PFHDhADA....hAEAbCFBSGDE.,2,-31,-7,24
QBEKeWbfIYZJGTMDaSCVgNOdUPcAXRHFL,RBEDHDBCFABDBBGAECAHeACC.....bFGDIDCHZFDEGAGGhAAADHAG.CGAH...VEFDhAAAOCFH.dCCFPDAFhABAADIFLFBB....KHDE.fEDAhADA...hABA...,2,-41,4,45
YZOUMBAecTRaEIWNbDfgKGXLHJPVQdFSC,TBGCaABB..EFAE..IDEF..bEFBDFGEKEDDXFBAhAAAHAEGJHAGQGEHhABAFDBFCHHA.OBBBhACABHFDAAADcDBDNDDH.fAFHgACF.hADA......hAEA...,2,-29,-16,13
cKJQPdbVHTAOLfMWDZNBYeSEURagCGFIX,LFDCMAHFZDAHBACCeCHHEEAB..UGDHaACDGGAHFCCD.XCEAhAAAKDFGQGGFhAAAdAGD.HEDAAGHAWABDhACADAGDSAEDCHHH.IBAF.hAEA......hAFA...,1,-15,-21,6
aZTXdSQJAMDFCWVcbHfPYBUIgOENGLKeR,MBDHFEEHCCFA...VFEDHFBH.....PCBABCHCUGADhAAAOAEEECEALAHBhAAAeABDaEACTGFCdDGD.JEHFhABAAEEFDIGE..WFAFfDAB.YACChAGAIACG..hAEA...,1,-18,-28,10
YedaXIMNFbJVScZCgQRAKDGBWTLfOHPUE,KDEEBGGBLEAFOCFHUAAEeFCE..dHDB..aGAHXBAFhAAA.MFFGbGCESDDBhADACCDC.RAEGAEAGDACAhABA.TGGHHCGHPDCHEDGAIBGA.hAEA.NEIA.....hAGA...,1,-17,-20,3
IRPbNdLfDMAZGKVaOcEgTHJCFYUWeBQXS,KGDGOCGBEBGC.HABFFDGG.UEACBCBA..QGGB.IDDGhAAAPFACdGHADCFDAHAGhABAZABC.aEECTADAhADACCAF.eHAASHAA...NAEDfHFFhAAAMFFHcAFF.hACA...,2,-38,-4,34
PcCJATaXbNeWdVQHEFDfgIYGRLZSMOKBU,aECGXCGB..eEFDdFDAHBCFEFAEFHCCDBAH...IAEDhAAARACELFHDSFHDhABAKFDBBAACUGBCPAHBhACACBBHAIECTDAD.bEEBNDCF......hACA......hADA...,2,-18,-13,5
POTYWVgbISaMCRLJAFeGENKQZcdHfDBXU,FADDEBEEKHDGQEEE.dAFFDHFGBHGFXGAEUDGG..OBBHhAAATEGG..VGBEhABAIEEG.SBGEhAAACBFH.JDBGADDENCAGHBAA.fFAHhABA.WDFEaAHD.hACAMAFG.,1,-20,-33,13
SGPNRQUYVTAELDfIBcbZJWeaXdOHKMFCg,EBAADBGBBDAHZDBH..eDDAaFDA.dAEHHGAEFHDG.CHHE.GEFC.RAGF.hAAAQADH.hABAUEGCYFAHADEAIBAEhAAA...cCCH...WHCAhABAKCCEMCID..hACASAGB.,1,-6,-29,23
DLKPaeCVGOgJTQWEHcfSUIdMBZYNXRbAF,FAAHKFHHeFEACDDH.GAGEOHFC..JCBAQFADHEAE..hABASAEHUDGCMCFDhACABACCZADE..XGCDhADAAEFG.DEAAaGAE.....gGDGhAAAEGEAIBHHdBAG.hABA...,1,-21,-24,3
GIfHVdgMNKDSWQBZcOCUFbeaETRLPJYXA,GDAHHDFHdBBHMGACDEIHQAGBBHBEZAABCGGG.UDDE..FACDaHAAhAAAEGDALHFG.hAAAJCAHAIECVBFCKABESAFDhAEAOEFEeDDE.......hAHA......hBAA...,2,-15,-13,2
IaKGNAHZbRcUSBWgVQTJfYFEDMdXLCPeO,HFEGRFFHUACBSDBCBFEB...VGAGQGBHJAAB.FAAHhABAEBFDDCFDMIDE.LFHBhAAACEHG..ODAEhADAIEDFKAHFAFBFZAGH.WAEF...hAFA......hAGA...,1,-2,-41,39
cLPUZWdODIKbMeQTJFGXABafCVRYHSNEg,BCGGCGDDRCGF.HDBH.SACCEBEFLBDDUEFBZAFBdFAADDAGKBDE.hAAA.MFIHeAAFQGFFhABAFGHDAGEF.aEADfCCBhAAA.NBIG.cABGOHBCIHBBhAEA....hAFA...,1,-12,-28,16
ANMaYDQEJWZLPSbUOFdHXVIcBKeCgfGRT,aBGBQABG.EGACZCAGLBFGSHAEUFFAFFGGdEAFXEBAhAAA..IDHEhAAAKGEAeABECCDCfDEBhADA..RCEDADIHMIFADAFGWHDG.hAEA.OHBE..hAFA...,2,-21,-20,1
SXTgeGdIHKFDYRLUPVNOMEJaAfbcCQZBW,...bAGBQEFE.ZDBHBECGXFDDgDEGdBGDHBCHhAAADFIDRGBGLAFDhABAUCBBVAEBMDAF.EABCAABECHHDhAAAWHBGeFGFKGHHPEAB.....hAEA......hAHA...,1,-6,-8,2
HeIbOSKdaWGcCQMfVJYNULXPDZFBgARTE,TCFGeDFFOHCA.dFCBaHEAGBAG.CGGF.MFAE.JACHNDIE.hAAAXFGFZAEA.BAAChADAAEDGEFADIFEChAEA.KBECcACHVGAEYBBF..hAFA......hAGA...,2,-22,-16,6
aKWVPXTEfcQOGSBHMNFgAdIYCRZUebJDL,dCHGCEAFRABC.eCAH.DEDCaBGB..KGAF..VEEA..PADAhAAAEFCD.QGGChABAOHEEBDCHHFCEFFADAIBGICFHhACA.YCCD....hAHA......hAIA...,1,-23,-42,19
eBORQaUICbKDMfZYTHANGLFXgWJEPSdVc,LEFBFGCH..XBEFJAEAEFCHdACCeFFFBDBFRCBA..UAAEhADACDDE.DBIDMCFEZAGDHEAEhAEAAIEA...NEEB..hAAA.WDHFSHGCOHAC.aGAH..IBAEhABA...hAFA..fEBC,2,-34,-13,21
FMGBcdRXIgaLfHEPNJDAYeSVZbQOUTKCW,eACEZDGFOBFEKGHDFCGFBADG..dHABRBAE...XEDAaEACLGAGhAAAECBD...NEEE.hABADAAD.AFIH..SDDChABAbFFD.UGEDCDEE.MGAC...hACA......hAEA...,1,-25,-30,5
fbEPSIDTYWGOHZBNLQVKcFARMXdUCageJ,MIFEUFAACADG..aBGE..eDCA..bCAEEFGC...IHHHhAAADGDFTEFC.GEABhAAAOAGHBBBHQBBHhABAcACFAAHEdHDDfFHCSFCAWAEBhABA..NAIC.KGAG.hACA...,1,-13,-32,19
MEFXUNDeALWPBbHgfTGdVZSYKRIQJOCac,LDBBBHCHHDDATFFAGAAF.ZEGBKDGHQDADOBFEaFDGECGEhAAA.FFFBUACH.DIAGhAAAAGDC..PFBB.hABAgAGEdDDHSAGE.IHHFhADA.CAFD.MIFG.hBAA.XGDD.,2,-9,2,11
VgSEfbWOTDQLeNXPRYZcGdUFaCHKAMIJB,JFFCVAFC..EAGH....fCBFOFDBQAAGhACALEDBXFAERDBCZAEHdDAGaHEChADACAEFHGFA.MDIBhAAABHHFSBACTGADDAIHeCEB.NIABPDGFhABA....hACA...,2,-9,-8,1
FeXKcGICJVANPgQbZHWTUDSfaREYLMOdB,...PDGFgAECZBABHFCCUEEDSCDBaCAF.EADALCHFhAAAdAGEBGBDFABAXGGAhAAAKCEGIHBBhAEACCCGAABG.NIDB...WBFFDDDFfGHEhAHAMIAG.eGCG...hADA...,1,-7,-16,9
abfVMJeEYLZUPTIKcADNRGCXFBQdSgHWO,DCAFGDCACCCE.BFFFdCFEHEGFaAEG....VAACMBCC.JFDDeHEEhAAALAHBZEGHTDAEhADAKGAA.AHBB.REAGFAAFSCGAhAHA.WAFA..OFFHECDG.hCAA......hCFA...,2,-24,-14,10
deTNQaFbLfWXAREDcSIGYOgUPJBMVCZHK,EADGDBAH..SHGGGCBBOHDAUCGFBEDCCBGBHDGH.dFCDTDAHhAAAaABFLFAH.hABA.XFCGAIHEIFFHhAAAYFEB.JBBE...ZAFE.KGAHhACA......hADA...,1,-8,-26,18
fJBCQUWaXeNPRLTYgDFKGZOcdAEIVMbHS,EDACMCCEHBCH.JCEEQDED.aGAENGBDLEFB.hAAA.YHDGDDIFKAABOAFAhAAAABEEIBABSHGAhACABDACCGDHXGGB.eAGF.hADATDBHFHDC...hAEA...,2,-20,-17,3
dKDQEBRAWTIbCeHVMFPScZGXgLYafOJNU,TABDCGBEHFFFFAGD..SEFAZBDDGBBCLHAE.aEEGhAAAfFDGJBDB.hABANIAB.dEAHDAABQGGAhADABADFAFEG.bAGHeDHFMGBG.....hABA......hACA...,1,-2,-23,21
ZRadWITFcYBUbSKgeQDXCLfJNEOGVHAMP,ZFFGaHDC.dBGH..TECDFCCCBEEE.UEBFKBHDQAEChAAA.DABCCABCLAEEhAAAJGECEDBH.OFDD.hAGA............hAHA......hAIA...,2,-47,-38,9
GEAXVaKUQCYLWPcgdTMJHZeRfbIONSFDB,XAEEKEFFQAGELFAG..PAEBdHBHTBCD.HCEBhAAAeBCFRBAD.IDAHhAAANEICDGGDBHECEGCAABABaCHBYEHHhABA.cGEDMABC.ZFAH.fDDEhACA..SFGBhAFA,1,1,-26,27
AMQXWagdHcNYEVGefPbZIRLDKTOSBJCFU,XBBDaGAHHBFA......NDCEEEGFeBHD.fFAAhAAAZFDFLAEDDFGFTFDEhABABDAFCHGFADHCMIFEQABEhAAAgBEF.cGAE.....hABA..YADEhACA...,2,-31,-12,19
CgdLDbFcGTZaIWJYOVRNEePBSUAMHXfQK,XFECQAACKBFECFEDLDHF.DEAGbACFGGBHZAAHaDHFJAFEhACA....OECFhAFANCCD.EHGCBDEGAHFHfEEBhAGAdDFEFFAGIHHCWHAG....hADA....YEBFhAHA.,2,-31,-14,17
RBHZLXUYDWIbAQgeTKMNPSJaGfcVCOFEd,eAEFTBDEMCCD..SFACJGFC.aDAEGDDH.fAHChAAACAHGEHFGRCGDHGAGhAAAXCGEDGEHIBBDhABAACAEgGCHKEFDNACF..cGGAOEAHBDDGhAIA......hBAA...,2,-15,-9,6
AJGUEdgcICMSWQeaFPBYXKTODVRNfHLZb,JCCHEFFHdABE....IBABSCDC.eDFAaBFABHAGhAAAKAECDEBBRDGFHFEFLHAChAAAACGFGDAA.UADChABACFDHMFIF.QAGD.FHFE..hADA......hAIA...,2,-22,-19,3
VBaYCPScDOTZbJXNKfRMgHeEIUWdGAFQL,LBAFVAGD.aGGACDBG....SFEAOCDGZAGD.XDDEhAAANDIE..fFBHhAAARGBEMBCCeGEGIBAHhABA.dDEFACIHFFAGQADGBCCG.PHFChACA.DEHD.bGAAhAFA...,1,-11,-28,17
APCebBgJZMNTSDFKIRYWHcXVUfQELadOG,CDEFBECCZFBB.MAIB..TDADDEIFFACCKAFA..RBEHHBAH..hAAAXFGCUGDFEEGFdAAGhACAABHD.eAHH.JFEHSHAEhABA.IHGCWCDC.fFADhAEAQDGB.aADGhAHA...,2,-31,-24,7
ENMDFeJWfTIBgRPCYbSHLdAGUQVKZXcOa,QCDGKFEDZAFB.OBGFECDADDAA..FFCDeEEEJCBB...TGGHhAAABBBFRGFA.CGAE.SBAAhABAdEGH.UEADhACAXGDDaHBGNCIA.MABC.fAEHhAAA.....hADA...,1,-21,-26,5
SWXeMbYUAZNHEOJFVIQRdDKgLCaGcBfPT,ZEEDEEACFACDQFCB.dCDFKHFCLAGBaDFCBGDH..TCAHhAAASGBD.eCDChAAAMICE.bACGACACNAEDHFABhABA..OCHFIHGHDFFCCABF...hADA......hAEA...,1,-8,-31,23
EbPGANSVdFUQOJgRHafCDeMYXBWZLIKcT,SBADVFED.UDDGQACD.OCFEgFEAhAAAaDECDHAGMAIB.XFBHhABABCAF.LBCEhACAIHHHTDGGEFAEbFCFAGIHFFABJAEA.fHGBhADACABF...eAEEhAHA..,1,5,-28,33
ZFBEIgbGfYUdJDcWTXeNQPSHCVaORMKAL,LBDCFDBHBFAD.EDEC....bDGFGCAFUABF.DBIH.TGAChAAAeEEBQGBAhAAAHFCHCGGCaGED.MIFCAFAGIHHEhABAfAEA.dAHEWAEEXCDE.hACASGGG.hADA.OEFE.,1,-1,-11,10
LTcePaGJFQAOSURIYWVNDfHbCBMEZgdXK,OCHDSBCGRACF.....IDADVGEADCAFHEFFBGAHMGAChAAAZCEF.XDDDhABAKGCHLABDeBFAaHAAGEADhAAAFHECAAFC....YAGHfACDhAEA...CDHF...hAHA...,2,-19,-16,3
ZVEfeKMQRDLSWCOgBJdFYUIHPcaTXGNAb,ZDFGVEAAeHFA.KFAHQBDDLDDH.CHFFBCAAFDBF..UAFGhAAAHEGD.aAGHTADDhABAGEDEAACE.EAAGMIAEDACCSAHBhAFA..WGDA...hBAA......hBDA...,2,-20,-15,5
QeYWVAOJETaRIgGdXFfHLcNUSPBKMCZbD,JADFTDFE..aGGBRBECGCBE.dFHEFCGHLADDUBACBEABhAAAKGAACAEADGBA..eAAHhAAA.....WHBAhACAAFFBEBHB.XGACcEEH.SAFChABAMAID.bFDH...hAGA...,2,-38,-14,24
TcNQDCKAPBSdIMgLeHXGWUOZbEYRaFfVJ,SDDGMHAGLEAAeCEEGFCF.UADFZAFCEGGGRCAG.fFDChAAAJHFE.TACEhABANCIEDFFC.CEAE..AFIHBGAGhACAIAGBXGED.WCCD...hAAAOHAEaBAA...hABA...,1,-5,-23,18
MdfDVCcAJOGeTSaZILKRUbQYXEFHWPgBN,GCDBTGBC.aEGBZDGBKFBFUCCF..QABEEBEG.HADAhAAAgAAHBFHCMICAhABADAEGCGEFAHHHeAHBLDADhAAA...bGFEFGCE.WFAD..dAHE.hAFAfDFA.hAGA...,2,-12,-5,7
cZXFBJGLeARbHVaWDEYUSgNMICKPTQOdf,HEEFaFEE.EADEUBAASCBB.MBAFCCFEKGBF.QEADhAAAdCGDZFCFBAGHGDDHLFAHhAAAAAHHRACH...WEHFhABADIDGNAIAIDDA..PHFG.hACAfAED.hAFA...,1,-15,-18,3
DXTFGSbAYHOedcNRMVEIBPLCgQZUJfaWK,HFBBeBBAdFHCRDDDMBBAEBHF.BHEGLEDA.QGADZAEHUCAAJGFEhAAAaEAG.DAGEFAGB.SBAFhAAAAHIF.YGDEhABANBIC.VCDECDGA.....fHEHhACA..hADA...,2,-27,-6,21
NeFUcdRJOSXKEYAMBTQGIDWafHLVCgPbZ,BCFBQAFADCAH.aADFHEEA.LHAECGED..bFFFeBBDhAAAFCBHdFAFOBFAKDEGABBCMHEAhABA.TEABIHHHhAAAfDDAPCHFZCCHNIEF....cCGEhACASHBA.hADA...,2,-24,-7,17
QJgGdVNebOFIKLMTYWHUfZDaPCESXcRAB,QGFAJHFEGDED.dFDG.eBCDFEAHLFFAMDAB..TBEChAAAHAADUFCCDFGECHADEBABhABASBEG.XCDChAAAAHHCBGBAgBGHNACFOAHB.IEBHhACA.KEEE..hADA...,2,-19,-8,11
LIJFeHTUSbZKYMXfAOWaRNcQdPgBGVDCE,aCGARFFDQABD.dHDFgGAEGBEHDEDBEECCLEBBhAAA.JDDCHBAE.TFDAhAAASFAFKDHDMBEGhABAAHIB.NADDBHHHIAECFGFD.....hACA.eDBC...hABA...,1,2,-20,22
fXDPUKWMNESOcagVILCReFdHGZBQAJYTb,JBDETFCG....XDEBDDDAUABAKCCDMEEC..SEGBhAAAOFHH.aHBCIBEAhAAALGCCCFADFDBChAEAdBAEZEAEBAHCAGGFfHDDNBIG..cGDDhAFA....hAGA...,1,-27,-35,8
RWSJVcMLbBCDEHFQfGIAYaXKZePTUOgNd,XGCGZGAAeDCCUAAE..OHFGdADBRBFA.SFFE.hAGAJABAMFFDBGAGDEEAFAEAhAAA.QDCBhAHAIHGEAGBEaCFCKEHF.........hAIA......hBAA...,1,-31,-32,1
GcLBMPUFgfRJYHQATdKaeXSbVZECWNIOD,KCDDXBGA..VBGHCCBB....NEBB.DBAGLGFCMGFGFCAEhAAARACBHFCBAAIF.dEGDaAEHhABASAEGZFBH.hACAEGADIAFHOHEEBCFDUFDEJHFG..hADA..YAADhACA..eEEE,2,-15,-15,0
fJMDWAPRKbEgaYUcFdQLTISeZNGCVOBHX,KCAEEDCB...aAGDUGDBdFFDLCDBSAHHZFACCHGB.BHHEHBDA.hAAAJFAFMEAC.AEIBRADGgABAhAAA.FEEBhABAIABDeAEENEIE.OHDCDCAB..WFBBhACA......hAHA...,2,-26,-13,13
cTGQgPWXBOCNVAJIUKMYLbfZaDRedEFHS,UBFHKGEEMBCBLEBCZADD.DGFCdGAGHABC..TCFAQDGFhAAA..PFBAhAAABCAHNEAAAIHG.JGBA..YEHDhABAfGHAaACFeHBG.EEEGSCCAhABAcAFB...hAIA...,1,-16,-23,7
UKVPHNEQAMCWZBdRbecaYJDGIFTfgLSXO,CFFHBDDHdAEE.eFBC..aDEADGGHGAAFFDGC....TGCBhAAAfGHELBDASHBChAAAXCAFUDADhABAKFHB.HBGHEAHFMADEWEEF.ZFEB....hABA......hACA...,1,-18,-21,3
GOLZVYUCJWaebSNQTcfMABREgKFIDdXHP,BDDCEBBEFFGHdAGG.HFEGGCEFZABGUDFF..JFCBeFAGSDBEhAAAQCAB..hAAAfGACAIGEKHBCDFIH.hABAPAFGOAHFLEEF.CACBaEAG.hACANEIC......hADA...,2,-17,-11,6
JIVGHRONELeXQZgWdPbUMBSFYDaKCAcfT,TFAGVFGF..GACGHAECRDBA..EAGEXEFGZEBEdGCEUBAGhAAABGEGSCDEhAAAFBEA.DGGDCHEGAAEGfACChABAJCHF.IHHF.NBICLHAAhACA.....hABA...,1,4,-20,24
QYBcTXZDAfRSVFEKWOPGdHeaIgMLUbNJC,SHEGVBEH.EEEDOGFC.dCHAaADFMCAEUCFC.JFHDCGBFBADAhAAA..TAAEhAAADFFEAIBGFAGGKDCCPGAEhACAGDAH..eHDGLAFA....hAGA......hAHA...,1,-22,-23,1
IJFTcWRZDYdfVPMAOCgXSQLGNbBKEUaeH,OAHFXDGBLGCGGACDBHHAEBDDUGGDeEFBHDGF.FAEFTGCDhAAARAAHZDAE.DABHdGACfCEFhACA.MDAAhADACDFC.SGAF.NFAHaGEF.IBHBhAFA...hAAA...,2,-11,1,12
IWGLeHTgYOBNfREDcUKSXMQdVJFZaAbCP,CAHF..PEBFGEECLAGHHEBB..gBDHBFHBRBAEDDEHKCBEhAAAMEAFdHGBFDFAZFFHADFD.hABA.IEAFeABG.hAAAOACGEGEH.SAGD...hADA......hAEA...,1,-9,-24,15
RYcBKHDdZaJgTGfASWLPFUXONCbQIMEVe,LDHHFEHHUGBG.OCDE..CBHFQACBMFFHEDBF.RFFB.BACBhAAAHCFADAIFZDAAJFBG.hAAA.TBAEAEHB.SFAChABAWHAG.NEEC.IAFE.eBAFhABA...cGGChAEA.aHCA,2,-25,-20,5
VERXPUWKOFHeJCGTSDQBNZYcMaAbdgIfL,dGGC..fGCDLCCGEGDDRAFFUFFAKACBOFBBeDFAGBAAhAAADAFCBCAFZCCFMFID.hAAAAEAB.IEFH.hABA.PACGFCHFCECFSEEDNIAHaAHF.bAEChABA......hACA...,2,-31,5,36
eJcWVTgSKbUXfCGMadYEDNQOBPARIHFZL,HDCGZFAEeDECJCGH...VDAESAHF.KADCUGEH.fABAhAAAMCAEdGHCDBBEhAAAQADFBFDGABFEIGFHhABAFHBELFFETGAGXAFD.CBHE.hABA......hAEA...,2,-26,-11,15
cGVAbQaWTIfFRBLEXUdDMHZOgeJKPYNCS,QGEFaBBD..TAEFFABCLFCHUGAEDGDEMCCCZCEGOHFGhAAAeFFEKDED.PAGBhAAACFFB.GEAAAABHIEHFhACABCHHEADEdEAF........hAFA......hAHA...,1,-9,-28,19
cIBDSMVTUaNGfFXCWebgAZPQLOEKHdJYR,QCDEOEBGKFFEHFADdACERGAEBEBA.DBEEMHCC.UABDGFDDhAAAXCDAeCGHABAALAHFhAAAEGHH.cFGDhACASAGE.aEABfAEFCCBD.hABA......hAEA...,2,-18,-14,4
GPBNeQXTaIUfdFSOZLMKRcCbEgYDVHJWA,BGAHeCDCQDEAaDBH.UGEDdCGDFHECOCBBLADG.hAAAKFGFCDHAEABBDBAGHCCHhAAAACHE.GCEGPFBF.hABANACD.IHCB.SCACMFIB.hAHA......hAIA...,1,-18,-20,2
DGRFZSWCNAMQfcVLUJIbagBeXKETHOPdY,QBFEVADF.JEDDaEHB.BABCKEACHBAAdGFEGBFEZFFCSAHBhAAACCBE.ADDGMHEEhABAfAHE.LFADhAAAUGAC.IHCBeADC.EDDD..hADA...OFHDhAFADIEE...,1,-7,-22,15
eYPBVgcEZDdJQCfSFHUNRbAGMIWKTaXLO,GGEDMGBAKBDBaABCLFGF..OEABeAHDBACCVBEBEDGAhAAADAEEdDFF..CCCCFEEHhACAHAABREBFAADETDBF.hAFA..PFHF.ZGCG.....hAGA......hAHA...,2,-19,-9,10
fHZbRMGAEJISCcLWdPNOaQgeYDVUBTFKX,EAADSACFLBDGdBGEOFDF.QGADgEDCeDFBhABADABHBGGGFDAG...hACAfAECbFGDMFACAFIFhADACCEAPEAHaAGA.UGCBTCGHKDCF...hAAA......hAEA...,1,8,-31,39
CXVgZHBTMUPLKGFAJdEYbNefaDWQIScOR,EDFH..NBBE.aCHFDAHF..QCCC.SACChAAAcDEHRFDF.CFBC..XFGChABAgAEEBHDHTGAHhAAAUGADKAEGFDGFdHGBeEEDfABDIHHFOBBHhAGA..ZCCDhADA...,1,1,-26,27
ITXcZNJFYKQRAPHdVWSfgLBODbUCeMaEG,HAFCVBDF.SFCALGDGBEGGDFACCBCA.MFAFEFGF..GCEChAAATBAEXGAC.hAAANCIC.JBGF.KABEAHED.PFBHhAEAfBAC.ODAE...hAFA......hAGA...,1,-5,-29,24
VaTJYQZWEPMLUBbRAcDHFgKCSNGfXOdIe,DHCAFHCECFBCGDBF.OFHBdAGFeCDB..aAFEJFGBZAAH.EFAAMAAEhAEA..UDGHRBEBAHIH.hAFA....cADGhACAKBBCSEGE..NICHfBHAhADA.XFDAhAGAICHH.,1,-10,-46,36
XBYCDGSbaAUOcIHVQZTgJLFEedNfWMPRK,OBBHHBACZFEH.JDBFEGFF.dFDE....fBGFMEIFKHAAXBGGhAAABCHHCEHGDDDGGDDDhABA.SAEChACAAABCIGGFTFBEFGDHeFABPCCGRADAaEEA.hADA......hAHA...,1,-14,-16,2
UZSLgVbOePRITHGBcJDYfANdMWECXQKFa,MCCFEBBD..CHBEKGCEFGGEUADE.LAAFVFGB...OCGFhACARADAHCEHGEECBBGADAAGhADAADDCdAGFQEAGhAEA.SGFDeHBA.TDCG.hBBA.cFBD..hBCA...,2,-24,-13,11
RIHZQcgVSaLeGdECUTFANYOJDXBWPfbMK,ODAGDDBFBGAD....PCECMAIFRFGDZEEH..QEDHhAAA..gGAAhAAAVABCaAEF.LEAAhABAdEGFCHCHFBGBYDHB.XACFfCEGhABAIHHF.SEGFhAFA,1,-16,-33,17
EgJFUWfKReQVcDAXaPBTZYbSOCLNHMIdG,XBFHBCACZAFB..SECECFGGHBCGdAHAGDAAEEAC..FGACUEGEhAAAKAAGRGEGeBBG.QFCHhABADIDEAEGA.aHDChACAPDDB..YAHB...hAAA.ODHD..hACA.MADCIAEA,1,-7,-10,3
JeSVZAXHFLTGbPWfEKIDCNBOcRdQMgaUY,FEDDLFECGBEH..PBDDECBFKABGCGAF.BFGG..OCBFhAAAdHEBMDIFaACG..JFCDSFAHhAAAZAFCAFIH..hABAXGEDbFBD.IHHGDDDENADD...hAIA......hBAA...,2,-23,-23,0
NOBYGKVgLfebaPAHFcCIXZDTRQdSEWJUM,FCBDCHFBZDAGDDDC..QGABEGED.UDGGMAID.BBGBKABHLFCBhAAAeACC.aCDAAEEFHFFAhAAA.XFBHhABAdBGFSADA..WCADNEEC.ODFEhACA.....hABA...,1,-24,-28,4
AHEGXbUacFBNPdYZSVKRCTeOWLfJgDIQM,HABBEDCDGAAAXDEGUFGDFHECBDDB.dAFCSDHH.hAAAKGCFTCGCeFAFWCEEhAAAfFDC.DFFDhACAMBAHaEAC.NBEBPGFAYHAA....hADA......hAEA...,1,-7,-23,16
AZVIUCFRGJDcKPMNHEaLTWQBfYgdObXeS,ZCCGVCFEUCGF.FFHBJDBB..KBGC..MCCEHFADLDDFhAAA.QGAFhABABGFGfABHdHGHOFEDhACAeBCAAAFCCADDDAAF...NEEC.....aAFEhAEA......hAIA...,2,-32,-20,12
adPbYVFOIAGRJCMEQKDXWHZBTUSeLNcgf,GDCDCCDD.QGBDKEABDEEGHABEBBEDUFGCLAAD.gBGEhACAdGAD.PHEChADAYCEC.OFDChAAAIBCG..AIGCMIAAXFGFWAEEhABATEAC.SAGEhAEA,1,-1,-46,45
CfGVLUNWEYRgZTMPaAdOHIQXbSDJFecKB,OBBHHFGDXCDCDAEF.FGDHKGBCBCAGCFHE.GAEDLHDAUFADhAAAEDEAREEHZBBD..MBIFhAAAABBB.QAFEhABA.SGEC.cDBDNABB.hAHA..YFAFhACA...,2,-37,-7,30
dZNGPVUbQHETYaBIXeLCDKJfOMRAFScgW,SHBA..cGGBdACCZDFFGDEDUAEFQEDHhAAAEADGTFAABHCGeBADLAHHhABADFDEKCBHOAHFhAAAADDFWFAFNBAC.....PHFC...hABA......hACA...,1,-7,-27,20
cHSVAGOaIPXQNeUTYMZCEdLBKRFgbJDfW,OCBFaDFG..XDBHeDHFUAFG.MADHCEFHEGBC..dDEAKABChAAAFGEFJHFEDIBC...hAEA.fEHChAFAHEAFSABFVAFGAHEDPCCANAAGZECBBHHD..hAEA......hAIA...,1,-14,-19,5
WIRQGgXTKEAUMPcDJOVNBLHfbaedFCYSZ,UBBGMCAADDADOBGDBFFCLECA.HFADaDFGFGGH..CHHDSAAFhACAZGBC.hAAAIFGCREBGgAGGhABAKBEAAADA...cCDBNICF..fGEBhAFAeABCWHAG...hAGAXEGB.,1,-14,-23,9
aCWJAQXFKOZcNUTEPgdGDBYMHLbfSIRVe,FFFEZADAUDCBEBFB.dGGAGBCGBEAE.HGAALHAESFED.hAAAIAGAVDFA.aABBhAAACAGB.ADAE.KBAC..NCIA.hADA...gEAC.MEEG.hABA.fFDGhACA..WHDA,1,2,-43,45
EDHXPGfROKTUYIMcVABaLWdeQCbSFZgNJ,aCFHLCCF.eDEFCHCFFFFEZABE..JACFDAFH.HFFHGBAAfHCBhAAAOFABKCGCTBGFhABA..UECAIDAChACAMDIHAAAABHHCdAEB.SGAFEHEC.hADAXDGE..hADA...,2,-19,-17,2
YgSUQNHIFdATLEBVKZeGWDRfCMcXaJObP,ECDBKGEAeDBFDIGC.RDCH.MHFG..aAEGJCAD..OHAE..hAAAbBBF...PDHHhAAAgABH.QCGDhABAIFCBAAGETEGABHBEZDEBfAHGhAIACBFE.YBDGhBAANABBFAHD..,2,-28,-11,17
eJRSMaGfVdbWCcBNgOQTHYIDLPAZXFUEK,XGAFFGFCUBEG.KABBRAGF....MEAFGDED.dFCECACBBBAChAAANDAB..OAEFHCBBDFEGhABA.AFIH.eHFCSGEDhAEAaFFCfHDH.WAHHgGAHhAFA....hAGA..YEAE,1,-13,-33,20
fdDYZbAKFeBHVUETPGWcOJQINCLaMRgXS,KEAFBFBGHBCGEACCGCDBOHDC...QFFACFHGMBIF.RECDSCAAhAAAdEFEDGCFZCACAHIBeAHDhABA..TAAFhAAAWEHB.JBGF..IAFEaFDB....hACAfGAC.hAIA...,1,-16,-23,7
dCLTVWaZHJQfKSgXNFIMBUDbRAeOYcGEP,eBHFOEFEGACDdFBG.LCDG.VBAHWBDAZEEB.QGAGhAAASHGGNFAB.MEDGhAAABGGGDADG.AHDEECAEhABACAHCaHGE..JAHB.KABBXEGA..hABAIFDE..hAGA...,1,8,-40,48
FAXEcUgIeTBJLZQSbYGDKWfaVHNPRCMdO,EABAUDDD.eDBFJAHFZEDE..SFBH.GGEFKDDEfFABhAAAaABCHBCCNBIACHDFdFHAhABAADGF...XAEGhAFAgAFGBCCCLHAG.YCADhAAADIEG....hACA...,2,-33,-9,24
RGMcJYTAPgBeOUVXfbDaLZHKFCIEWSdNQ,BBCDOBBBUGEE..VCEG..XDDEDDDFZGBAKFHHFBGA..hAAACDBG.EACD..SGCDhAAAdFGCQAGFhABAMFBA.JEEFAHGE.eFAEaDHFLADBIAEB.NBAC.hABA......hACA...,2,-41,-10,31
dcTfYFbWgSZBHCEJRAPLVeOXNaKMDUQGI,VFDGXCBH.KAGADAEG.GBEH.dBBCfBAGFEBH.hAAA..gGEGhAAABDHBCDEBEHGEAFBEeDGBOHAEhABAMBBCQACCcCGF..YEAFhABA.WFDE.SDDEhACA,2,-31,-12,19
KUMPCdEOSgWLYGBAbRFNcIJZaTVHfXeDQ,FGFB..NCDB.JFBAZEDD...aAFAVDEEHDAA..eABDKGBFUDFChAAACHHF.dABBEHAESGHBhAEALDHHBBGHhAAAACCF.RACE....cCAHfHEH.hACADCIHMAFC...hAIA...,1,-18,-26,8
cAZfELXUFMGBSJKReWCHYTdDabgQIOPVN,ZEAGEBCCLFEBFGHDBHBG.KGGARACE...CEHBHFBBdFEGDDGF..aAFB.hAAAQAGEOAHD.hABAVCAFAAECUCAG..hACAMDEE.SAACeFGF.WDDDYDCChAGA....hAHA.gGCD.,2,-25,-4,21
PGSBadXLbKZVcAHJYMfCgFQEIWURTONDe,JDGHMDBH..CAAG.QAFG.EDEHIAEHRDFF.ODCAhABADICAeHFG.SABFhAAAaFEBLGACKEHBZACDhAHAABHHHDAEfBHAgGGGFECF.WCAChACA.....NIBHBCHHhADA.,2,-38,-4,34
TNMcdJVOLDCUBXYEGZbfgaAWQSePFRHKI,QDACSEDCFDABHGCC.KFBG.TEFDMFHHJBFH.OAHDhAAADDCABAHC.EAACZGAChABAbAEBaCBF.AIECeFFDhACAIGHB.dBCF.CEEF.XACE..hADAfBHA.hAFA.WGBE.,1,-7,-17,10
ANEFQafOYgHDTVIWKUXLCSbZBdcePGJRM,FDGCaGAE.OGAEHADGDCCC....IFFGKAAHXCEALDBEhAAASEACZAFGBCAFhABAeFGDJHFCRABAAHDBEHEEQEAFhACAfEEA.gAGBWFDB.hAEACACF......hAFA...,2,-21,-11,10
BXRCbYPFIVEQdLSTfWOeMNcUgZGDKAHJa,JGACBCGG.CEFG.....PAEFIEHE..VFFAdFABSBBBhAAA.TBDBhABAOEDA.eBAEhAAANGED.gDADDIAAAHAGaDDH.XGDH.hACAYAHHFDACEBGE.fDGDhABA,1,-27,-41,14
UEMOfdZgQLHRGYFVeIBJDSKWcTAbCXNaP,XBDFaAGC.UGBCEFDBMDAD.dEEHQAACHAAERCEAFCCHIGGDhACABFGA.DFEEKFBDhAAATDAGCBEC.NIED.PHEEhACAZAGH.LHAAYCCH....hADA.eEHB...hADA.SCHBAFAF,2,-19,2,21
IaJGKELegZUScPdTYHFWNOADbBXVCQfRM,DDFEBHAHCGEH.RABG..MDDE..JCBBKDAHLADEZGFA..SEHDhAAAdHGHHEDEFDHDOFBChABAADDA...VAFChADAfAAD.aHBE..EEFD.eCCDhAEA..gAGHhACA..,2,-34,-27,7
eacQCfYOFSGJDXPEKRIBWMUAVdNgZLTHb,VECEdHDHZADC.HBAAeAAHQCDE.CEGC.fEAFhAAAFAHDGFAFXGFAKGGGBEABhAAAUBGDAFDE.LAEEhACA.bCCEaHAC....YHDAhADA...SFGChAIADIGE,1,-15,-20,5
AdcVRKegJFXWLYQONDHPIMTBCZfEbUGSa,dBHAREBBKFECJFHF..FEHFLCAG..QAABDEFHHAFFMABAhAAABDDHCADGZECB.EAEFUBGFhABA.GGEBAIAEeHEGhAHAXGAH..WEGFNAEB...IBBEhAIAfCCH.hBAA...,1,-22,-25,3
WeYaADHbOGPKfMEZVSCLRdQFXgNUBTJcI,HECHOEHFKEHF.EBCAVGCGLAFA.QCEBXBEHUBAAhAAAJFFF...IGGBhABAeDAAaAADAIBEDDDD.hAAA.PHAEfAGA.MFAFCHHE.FEBHhACA.BEEB...hACA..cACE,1,-12,-16,4
UKVIYBfCHSWgDQJOTFAXLaEZRdbcPNGeM,aEHFRFGDdFBA......bCFFPEEBGDDEMAIDKCBB..IFBFhAAABBDFHBEG.SCBBhAAAWADG.DDDDhABAOFAHAGAGEHEANACBeHFE......hABA......hACA...,2,-27,-18,9
GRCLIWQAceHdBDbKNYXfPTSFEZaVgJMOU,eBFGHBCHdGGEBGDEKFED..XAABTDFBEGAAZDFH...aAAHVCBBhADA.MAFCOAFChABAGADGCFHBLFCBhACA.IEAEADHEDEIBYHFEfCHESHBEhBAA...hADA...,1,-12,-16,4
XYUJKBZfNObFRSdCELIPgTaAHQeDWMGVc,QEEFDGAAMIDAGAEB..XGBCJCBF.BEAAZDEAOGFEhAAAFAAHSAGHhABA.CHECLDAEhACAIFDETABDAHGHeDFEcECCKHAENBAG....hADA......hAEA...,2,-25,-23,2
ZgAQTPXMdOKcHYEGDVSfBWNJLIFUbaCeR,QGAHTBFC.MEACOGEGHGDAEBDADABH..SEFAhAAABBDENFCDLAFDUEADaABEhABACGGEeCAAZCCCAIECdHAFKAGA.hAAA.....cCGF....hACA......hADA...,2,-16,-15,1
GDOXJgEMAaSRIHLBecYCKdNPTQFbfZVUW,REFELDFDeBDB.CHBE.KDACdEAE....PCFGFEDHZACH.VAAFhAAAUFBF.DEAH.OHAEhAAAJHEA..MAIHAGIBaABHhACASAFCBHEG...NDHE....hADA......hAEA...,2,-32,-25,7
WeGLCKOMFUSIaVgcYAfEZRJPbdBDHNQTX,ZAFEJFFD.dBDAHBAAQFAF..TEAGXDEAeEDDCABCKHCEhAAAOHAA.UCGDIDAChADAaAAA..VADChADAgGGBAAGG.fFDHEHGC..hAEA......hAFA...,2,-31,-7,24
cZGTfDELNaXYFSWebHJMUAVKRIdOgQBPC,REFBOFDAQAFFBEAG..CHDG.GBCC.DECFLCECaABHFFDD.hAAASCHHeCHDJDAHAICGhACAVBBF.dABB..hAAA.gFAA.PFHH.cGEChAEAfGAG.hAFA.NBED.WHFG,1,-17,-32,15
gRCBXSKEeFOaJWTIZLVHbDQGMfAPYcNUd,...PEBDNBGC.dAGHCHGFBBEE.KAHBeBAF.FHEGOAAHhABAJDDE....TFGChAAAZDCFLDHH.hABAVEABDCCAMFADABDB.cEFGREEBSHCGhACAEBEEaDBG.....hACA...,1,-25,-27,2
cQJCXLgDYONVUBfdPaZeIKWTAERbGFSMH,RCBAFBGAMDHHQEGD..XFABDCBDOFABUEEFBHHFdAEHaABGhAAAZECDKADC.AAAGGCEBhACASCGE.HGDChAFACCDCLFEBNEIA..fFCAhAHA......hAIA...,1,-17,-21,4
RgfFScNdHbeLWAGQCVKOXIDPYTJMZaBUE,CEFBOEBHDDAA...TEDGMABABEHD..ECAFRGAE.FCFD.SAAGhABAdBEGHAFBeDDDhAAAACDDQAGBKGGG.hAFAIHGAPHDC.JDHFaBBGfACDhAEA..NAIC.WHAA.hAHA...,2,-27,-15,12
eHDGKCdIOAUZEWcLMagYBXbfPVNSQTJFR,UEBDEGGHLGBCMDBC...aABHBBHG.XEEHPCEESEFGhAAAQADCJAAChAFAFADAHDBEGGADKAGHIFHFhAGAAIEEWFHHcACH..YHEGhAHA.....hAGA...,1,-16,-17,1
YQTdeABZUWbIHfXCEcODNFPGJMgVSKaRL,UDDG..IEDHXGCCCHHG..EBAADACFFCFDGEGC.MFBBhAAASFAC.hABAKADAaAEDLAHHhAAATDBGdGEABHBGbAGDcCAENEAG.JEGB...hADA......hAEA...,1,-15,-31,16
RXVQgGBJbfceKCAUSNHLPYWdEDOIaZMFT,SHGAHFCALABC...PEFEdCGHEBBEOCCEaGBHFEDEXBGEhAAAQDBCBAFChAHAbEGFfDBGhAIA.eHDACADGAGFENCAADIGGIAHH...hBAAMHCA....hAAA...,2,-24,-1,23
NQaAdXfDHRBWKMIPgOELFYJVCeZUbcSTG,dGDHXBBEDBGABCAHKAEB...MBFF..gAGFEECF.hAAALECDFFADJACB.VGEChAAACHHF.ZDABUEGESDGBhABA.NEIEAFDA.fABHWCEDOHAEhABA.....hAEA...,2,-38,-21,17
ALRdPefIcQZMUCgYJXbBTKHFNWSGODaEV,RAFFeABB..IHFGZEBCCDEB..JFGDXACGBGBC.HEDCFDHF.hAAASCDGGAFGDIBAhACAEEABLBDFdHAHfEHEhAAAMFFB.gBAD...hADA......hAEA...,1,-9,-28,19
HDUARBLSbQMYgJEFTeIVOCWaKXGNZcdfP,BADHSBDCQAGFMIAE...JEEFEDFCFFBEeFCG.IGHHhAAAOCECCABF.KBCDNCACdCBGhABA.HCDDDHGAADDBbFFFhACA..TDAEaCHDZGBC.fBFFhADA..PHAA.hAEA...,2,-37,5,42
BGfJEHYNeFdULMRTSCPOVcKAgQWIZXDba,QGFDZGCCDFECBFCBJCEAHADG..eCBGUEGEMHAERDAF.SAEAhAAACBHA.OEAEhABAKABHACDC...WFEFhACAIHHD..aADBEGABNCIC.FDDA.dAAC.hAFA......hAHA...,2,-25,-25,0
EIgDBHSXRUTAYCdOMVNQfFLPcKGaWebJZ,CAFHMFBC..VCEBQCCELCDFKGDAGBAAeABG.ZFGDECHHDACDhAAABAGDHEBBRFGHADAEOHAChABAFHAG...aHEGWAFDhAAAJAHD...IFFA....hADA.SEAFhAEA...,1,-5,-27,22
TXLOKWDEgJURdIaYcCMNSGfHeQPBbVZFA,TDCHLEBC.KBGCDBHFEGEEUBED.dHFFaCDG..CEGF.MEAFGDAChAAAHAAF.QDFChAAABBBAZFEGAAHCXGCDhACAOACG.WCHH.JADG.IHHANDIESGADhABAfHAH.hAGA...,2,-24,3,27
GKTLJUEVNMdDeAYSaQPOFbRIcCfWHZBgX,aAGBOEEH.RBCA.CCBB.HDAHBFHEGCGAKGGHLHCGJAAG.UDEAhAAAEGCBMAFA.eCFFhAAAABDDSECFFGHD.hAEA..IABBfGFC....hBDAWEAD.ZBGD..hADA...,2,-44,3,47
XJHWONQDGRYgcBCSZfFTEdLUAbKePVaIM,eDAHaADA.MCBAHEDH.OBCFDICEGBGARBFF....cCAFhAAABFEBSAEBhAAAZFGBTGAF.EGEBdHDHADDEKABEhAGAIABAWDBHQGGHCEBGFAGA...hBAA......hBEA...,2,-17,-6,11
NBWQSTKUMEOHPgcXJaVRZdLADIfeCFYbG,DEBCeBECCHHB.FDCAGGBHBFHF...QBGAKFDFEGAA.OABBhAAAHABE....cGDDhAAAJEEAaADD.ZAEDAHIBIEAHhABA.bCFENDAESGGF.hADA......hAEA...,1,-20,-30,10
LNXIEfMUYDbWgPQdSAZGHKFaCReOVTBJc,GCACFGFFCHDC.OAFBBFAHLAAE..NHEBECGBMDCFDCCA.hAEA....gAGBhAAAdAFDAHHCZDGHKBDGeFEGhABATEDBXEGA.IADFfBBAhAGAYDDA..WCHBhAIA.SDDC,2,-29,-28,1
EPWNGbdRXUZSYgaIeBcCTOQDFLVJKfMHA,EFFD..PCDDGEBGdCFHUACCZDFE.SAABaFGG.BEHFhAFACEBCOBAAFAFD.LGAChAAAJFHDMAIFAGHAbAFEXEDFhAHA..IHHC.eCAF.hBAA......hBCA...,2,-24,-13,11
FYOGIJELMRbeBcXZVTAHWCQKadgfUPSND,CGDEQFGEdBDG.UBFBSCGBFEBEGGBHEGHH.LBBEhAAA.MABEbEEFBGAAhAAA.XBAH.hAFAZAFGACCGKEEHaECC........fEAChABADGAE.OHAEhACA.,2,-31,-20,11
SMbTaXBIAWVLFJOcRKYNQDHGdZgefEPUC,VCDFJDEE..RFAH.KGDA..QDCEDBIFdADBZDGHeAEE.EBBFCAAF.hACA..MAIHaGFFBAGHhAGAAGGBFHCA...OBBFhAIANCACHEGD..fEBG.SHCGhBBA...hAAA...,2,-32,-21,11
CYaKdSbIcWJNZADMFPEGBORQeHXfgTUVL,DAFHFFDFEAAEBFDG.RCFA.HCAB...fDDDTBAGLGFAhAAAaFGH.dECBSBGBhACA.IGABhADAJABCNIAFAAGE.MDID.OAFHeGBGXAGEhAEA.....hAEA...,2,-25,-23,2
VRbfdFIeYKNPDgXWZMaUEOQLcJSATCBGH,BDBGGGBDRDDEdBGDFDDDeFEA..KFCDDCGE..XAEBMBCHaAEEhAAAUGFD..EGHDLAAChAHAJEAD.SHBAhAIAABABCDAC.HBBA.fEGFhBBA......hBEA...,1,-28,-29,1
IgDKeFZdYJVGLfOcaRNEBHQUSWCbPMAXT,XFCGTDGF.DAHDeFFB.dEBA.JADCVBCH.LAFBhAAAOBBCaFDBRDAHEFGC.BAEDhABAHCDCSGHHhACACAHEMAABIHHBFHEG.YHBAfEFH.hABANAIA......hACA...,1,-8,-16,8
NMJEUBAfYXSLbQVKRWdacZTIeHCOFGPDg,XCFGLEAAQCDFRCCB.dGBHaFBBZABDeAFCCFGB.FFHDGAGGhAAADACC.MDIDJBABEGEFhAAAAABB..SEFDhAEAKHBGTEFFIHHG...OADEhAGA.NIADBGED.hABA...,2,-25,2,27
bYFTfWAGdNHPaZLKRECXJDUMVOceSBIgQ,GECHHECAZFAHKBHBCDHADAHBMHAE...OCDEeCBEBGFF.QCEChAAAFBCATBAHAEAEdGCHhABAaGHFRDAA..JABEVGEChAAASHGG..IAFE.hAFA......hAGA...,1,-10,-23,13
DaXdbOMfPUAEZBTWHJKLNCYeFQRgcISGV,BFHAHEAGJAGFKDFBLFCB..CFHGFACERAFG...IGDFhAAAGBAEDEEDdGFAMBIFhABAUACGAHHHZDDA...TCAHhACA..WFADNIABeAEH....hAHA......hAIA...,2,-45,-15,30
CNTbGeLKOWQMSfagJRVcDZXEdHABFIYUP,FCEFUGADCGFG...TADEeGBALADE.KAHDOGFE.hAAAQEDGMBBFaEFEREBChABADFAA.ZAABdGGABCEHhAAA.IHDANCAC.WDFH..fCCChACA..gBGGhADA,2,-33,-26,7
dFcWSYOQbgBLXAaIJeRKEVCfTHGNUPZMD,JDFBRADCEDAC..CAAC.HEFDGBCHUGDH.MEIFFHAA....SBBChACAQDDFBHGHhADAXABFAHEH.ICHGhAAAKAGE.TGACPFBGDAGEdEAC...hAEA..YFHHhAEA...,2,-42,-3,39
AECUWZXRcSMBdJNeGQYOVPDbfLTFaKgIH,CFCCUFGAZFFC.RBEC...MHDABAHD.dCBHeEFEGEBC..OBAChAAADGEDLFADaHACKDAFHAGBhABAEADG..XAAChABASBDE.NIED.QDEB.hACA.YDDH.hACA...,1,-16,-26,10
MKfdPNEgCAGRbDYOSTQZeXVUHIJWBFcaL,RFAFDGFFOEDDQECDZDEH...eBFCUADAJCBBBGHA.FCBDaHGAhAAALAGFKDGE.dCHAhAAAEBCG.AABA..bGAASHFGhABA........hACA......hAIA...,2,-29,-28,1
NScDCOZRPbVgHaefTEYAKQMBWUXLJFGdI,KDBHMFHFUBGELBCGGFDFdFEE...IDHFSACFCHBDZCAHhAAARADH....PFABhAAAgGCD.aBGBhABAeEFGEDEE.AIGGBDDGWAEC...FBAHDAIF.hABA......hAFA...,2,-25,-14,11
aMCBADSLEURINQFJWgXeKdVbPGTOYHcfZ,LEEFEADCRFDD.QGAFFDDC.JDCHXCFB.eDAHhAAAKBFAbADB..TGGBhABAOFFC.HAAEfHBDhACAMIEA.CAHEAGFEDDIB.SCADhAAA..IBBGhADA...,1,-9,-34,25
OCaAMTYEdLJNXDKSIVBZcUQRFHGbfePWg,TEGEEEBEdEFALBDD..NAFEDACHIBGBBAGFZEAH.QGGBhAAAHAABfHGDhAAAeDCD.gGDEhACACBADAEDAJAHDKGDHSCGA.VFAH.hABA......hADA...,2,-25,3,28
XbCHIPVNJSTKLOGWUgDQBMYcAZRfdFeaE,ZEDDdEFBFGDEaDGC...ECEFCFGGHABE..IBBDVAFE..JDCBhAAASDABLHFCOEADhABAGAEBWDCDhAAADADC..BCHAMFIHAFFFfCDDbACB.hABANIAD.KGGD....hAFA...,1,-7,-27,20
FTBfbCMgYPSVeRUaOZXAWNdQLIEcJDGHK,dGCDQFCGEDEG.DBDFKGABBHFACHFE.MFFG....gAABhACASFADeAFDhADAUBEDZFGHAHEALBBDhAAA.IHHB.cCGDGEBB.hABATAGBfDEChACA...,1,-23,-37,14
KOaRUIfCWDBgcVeNQHJGTSAYbMXPZEdLF,MFECXDAFZGEEdAGBFEEE...OCBBRGCGUGAE..CCFBBCHB.hAAA.gAFAhABAeFABHABAJCCCSECFhAAAAACB.bFDCEGGBKDDE.aADAWAHHDFID...hABA......hBAA...,1,-11,-25,14
HOSLTbFCaPIWYXUMKZQgADNVdRcfEBJeG,DDFHdACHRDEBEADABBHE.GDCASGGC.LDCFFGHBCGBF.IBBDhAAA.XAGFhABAMIDCKBFGZGCGAEGE.NIDH.hACAVBAD..fBEA.JDAF.hAAAeBHH....hADA...,1,-18,-35,17
bVEeaJPWINBRKMCYFZTHQDLfcUAOSGXdg,SADGGAAGdGBC..VDFBEHEG..aEFGJEDF....IGHFhAAABAEHMDIHCGBEFCDDHBFGhAAADDCBLAGBhABA.fFDCADCEOEAB.bCAFeADD..hACANIAB.KHGC....hAEA...,2,-14,-14,0
fOKIUbSDeLgVHYAZdPEQRWBGNFMcTaCJX,dCFFEEDFRBFCBAFA.FBCDMDCF..aCADXEGA..fEFFhAAAIAFCSGGGhAAADHGELEDBHACDhABAZFAH.WHDG.NCAECGEGOECB.KAHBbEAH.hABAeDEG....hACA...,2,-30,-13,17
ZJWgRbCBXaeDVQIKPdcLNUSEHTMFGfYAO,ODGHJECB.REBBBDDCaAGC..DGEF..QADGKEAD.dHEDhAAALAAGSAGEhABAEGFAMFFGFBBH.GCEBhABAAEEDgBGDCCAC.eFHFICCB.hACA.NDFE.....hAFA...,1,-21,-35,14
LcfFdZReCVEJKTXBNSPDGYHMgWbaOQAIU,UGFCLDCHFCGAZBADeCHB.EEEGKFCD..TGGCBEEC...SAGAhAAADFFAGACCMICAhABA.bADBaAAGAFBHfCFGhACAdFAC.CHAFXBBG..hAGA.YGCG.hAEA.WHBA.,2,-42,7,49
YCeMaLOIEbWTdZgDcRVUGFPHSNAfQBJXK,QDGFJFCE.KGCHCFAGMFHFLAED.EHGE..TADFhAAAdCBFDAACRCBDGBFAFDBDHAGFhADASABFAFEBBFFCXGAFhAGAaHEEOAHD.IHBB..hADA.WEHB...hAIA...,1,-17,-18,1
XfaUQWNESAOYVDMZTeBKPcdGHIJLCgbFR,VCEGZDCDBAHF.KBBGdDBFHADCLHFC.CBHG.FEEDRFAB.aDAFQEGEhAAA.EADCADHCDIFEhAAA.MIBGeBAE.hABAPEEHIGAAJECH.bGFA..fAFHhABA...WCAFhACA..,1,2,-37,39
THfAPgJQOICWbMBZDLRdXKEYcFeGSVNUa,JFABOCAF..CAEG.MDEGDADB.dGFB.EDCBFDED.GCAD..hAAASAECUGFEHCGFhABAfACGAGDB.hACAgGBAQAFGWEEC.BAGH.hAHA......hAIA...,2,-32,-30,2
JILUYXSHGPaRMAZECcTfgWbDdNeFVBOQK,CCAETCBA....fFBH..gGDGhAAADCCFdAFGFGEFBFGDKHACLADDhAAAXECASHAGhABAHEFHaDGAAGIBEDEFWADB.NAFGOAGFIABA.hACA.YCHB.hAHA...,2,-28,-21,7
CNLMOQZPaEedBGfVRSgYFUHAJTKbXDcWI,TEBBKCDFDACE.....IAAECDBFMFABZEGHaHFC...eGDGhAAAGAED.VCCESGBBhABAgDGHFEEFADHGhAFAbFFE...cCABWBFC.LHAGhACA......hADA..OBBG,1,-9,-36,27
EDdOCRPTUBKGVgcIWbJZMaYSeXfLFQHAN,DGDHCGCGRFED.UDEFBBEEGBBC....VBBC..IAGChAAAJBHD.MBIF.aHGGhABAeDGDLFFAHDAEEHAGhAAAPFAFKAFE.gAED.WCAFhACA......hADA...,1,-28,-33,5
YegBbPZJXUFAGTNHVOCafRMWSdIKDQEcL,GFBBTGCC.HBFHOHFEaEAARCDB..SAGAKFHDDBCD.QBBChAAALHBAeADAhAAAgEFGBAHCbFFDPFAGhABA.ZADF.........hABA......hACA...,1,-10,-12,2
VNWZJBHKgSXcMaDUAbOIFRYCTGLEdefQP,OFADFDGHCDDB.GBECdAFG.QCBH..VGBCZABCBGCHhAAAKBAB.gAGEhACASEAAXGFBhADAMEFHDAHFAEADIHHE.RCGH.TGGD.hAEAEABE.....hAFA...,1,-5,-39,34
NAEZJCUVSeOTQHXMYRdDfKFPBGIabgLcW,EHFEZFDFUGGC..eACAOAFFQGCAHAAG.MDAAdEAGKHAAhAAABHAGGADCICGDhAAAaFFH.gFGGhABALCHD.WAFAADIHCAHA.SECG.XEEBhACADDAE....hADA...,2,-23,-8,15
GJFCMIOcZUbNRgEPQeTHWLfdaDYXVSABK,BCFDJFCH.CGFF.OFFEZDBD..UACBRABB..EBADeCHDHAFBLFEFhAAAdDFDDADA..XEEChAAAABBFFAFA..MDAHhABAIHAF.NIEB........hADA......hAIA...,2,-41,-20,21
NKGYFfJBWLAMEOgZUVQbeHSXIDdcCaTPR,EAFAZFDGUEAD..QFAGeBCBHADDSDDBDEHHdBGCCCAG.PBAChAAA..NAIC.KDFDhABA.FHCGBAABABEHMHFEhACAOHAEgDAE.bDGDIHHEhACA..cAGDaEEG.hADA...,1,-4,-26,22
TYQRacbMEdXLDAJOCBegIPUWFKSZNfVHG,OAFHCGEEBFAH...eHFG..PAFDFCCGKGDCZEEC..fEEHhAAAHBBE.TEBEhABAYAAE.aDBCMDIBhACAEAHD.dHBHLDFADDAFAGGCgAGEhADAIHDESGGAhAEA...,1,-14,-31,17
bBfPcHWMGSQeFJXVRCaNULYDgTOAKIEZd,EEEDZEBCBHGC..fHFBHABGMHBASEAFQAEGFCDAhAAAJAHHRBGB..CGGEUBAEhABALAAFDGBG.TDEHhACAOHAEACCFKFGEdEGHPACA..cCGChAGA......hAIA...,1,-8,-16,8
EIXcMDYTHeKWQJUFBORdgGbVfZaCNALPS,LFADSGCBEDFF..XDABDFHHHBCBeDFDKAEE..QGCDhAAAFAHHBCFBOHFAhAAARBAFdGFC.gDCChABAbBGB.ZABEaEBDAFIBIAFA..MDIFhABA.....hACA...,1,2,-24,26
MbTFQgIGALUSDcXJNfdORPWVKCYZEeBHa,UDGFDFCE..JHDCdEDF.ODADRBEE....VCADKAAECHBDZDGDBHHDhADAHABG..MCCFhAEAFGBD..QEEChAAAGGCDAAGG..SADAcAGA.XAGEhBAAfGHC...hBCA...,2,-35,-21,14
QfWRPHeYDXMaNZJTBKGVOCFEcAIbUgLSd,UCAGSEGCdFGC.QAFARFABHDDEDDFGMCBAZAAA.BGDB.KFAFhAAAODHFCHBD.FAFHEGGChABAAAHH...IEBChACA.gDDHfHCFWDAC..hADA.eACAaADF.NIDH..hABA...,2,-29,-6,23
aJcHgYVAQLPdXefDbRWMBUCFKSZOITGNE,LBEFXDDADBGGRCAEMAIB..BFHCFGDAZCFDOADDGEAEaBBB.hAAAHAAC..gCGHhABAAFDEQGGCdGAFeGDChACAfAFB..UDAHKDHF.IHHDhADA...NIADEBFDhAFA..,2,-9,-8,1
dQebLGVXacDNIYUCARSWBMETZgfOKJPHF,SDDDMBCDZFBF.OAAAKFADHBDD.dEGGeADALHFGGGCFhAEAXFDCaHFEDBHHNCFE.hAAA.ICAHCHAG.hAHAAEAABBHFEBBD..fDGE..hAIA......hBAA...,2,-23,-19,4
CVaFNZdEGAbRWgJeSUfDLQXKMTIOYcBHP,RAFGJFAGUFDFLFEG..XFACMHDC..OACDBABBHCFHhAAACAFD.aCCFFAAGZBDHGCEHhAEAAGID..gGGDhADASHACDIAEKCBFIEHH..hAEA.YBBF.hAGA...,1,-11,-34,23
UagEHLReVAdKOMNWDSPIYBcGFJQTfCZbX,dAAAKBDGMAGHDADD..SEBD..IEAHBGHFGDEHhACAFHCATFGCCAHGZECCUAEDhAFAaEDEHAACLHCGhAIAeAHHAIHE.OFBC.NDAB.WCCA...hAAA......hABA...,2,-24,-23,1
YeMPKLXCJIBNGDZOcAHbUgFWTSfVaEQRd,HBBEUEBAFHBCTFCF..SBABaBEFEFEGdAHA..MCDAKEACLHEEhAAACHHEBFHCDFGFOEEAhABA.AADGgGABhACAfAHEQFDG.YADEhAAA...PDDAhABA.,1,1,-48,49
JNMUFDHSaGEdXfgcPKQLAZYVCWbIRTBeO,ZDBGCBAA...IDHERDFDBHCHeEAF..OAEFMDDFDCCAHEFEhAAAGAEFEBBAXAGHhABA.fHGHhACAPCHFKABEQGADAEEF.VGDGWDBH.hADA......hAEA...,1,-6,-33,27
YNIUVQXAOTGMDKdaZCRfgeEbSJHLBPcWF,OBFEGECGMABAdGEDZFBBCBHA...RBAB.eBEBEDDG...SFGBhAAAHDGBBHHA.PAEAhAAAcCBG.FHAENDAC.IAGAhAFA.QGEAAECGDIDGfABBhADA.....hAIA...,1,-12,-25,13
XTAYZNHJEcbCdGRDWgFOLKBVPMfUeISQa,ZDBBJDBC.EDGE..CHBBGFDHDIAAFFFB..LBDABDHA...MABBhAAAfAAA.hACAeDABIBHH.hAAASFDFXCFFABIHNDAE.cBCFdGHA.WAFChACAKDEA.....hADAPHFE.,1,-19,-32,13
EHINYfZMdCFGDUeTgKXOaLQcRBASPWbJV,SECA..WEBBVACFHBBA..IGHAfFFDhAAAZGAAdBFGFDDCUGDChABAgGEDKADAXBGEhACAOBABQDGDBAGBAGBBJDHH...EFAGMFAFhADADAAA.....hAEA...,2,-18,-8,10
BTHbSALFNGeCRUIdPDWYaKgcJXMQZOfEV,LDCCGBFAeDDBUFBCdBAGDIGE..aFABKABF..JFCDMHEC.hAAAZAFGfGGHhABABEGC...bFEDADGAFDABhAAACEHCIBEC.WCBBcACE...hACAXFGA..hACAEBHD..,2,-42,-4,38
RTUPXWcKDfBGZNegLOVAIYEFdQbaCMJHS,EBDGQFAA.aBCGJGFA.HEDARDDGUGFDXFAE.KHCGBEHGhAAAZABF.NAEB.eHEGOFDBhABAIAHAdCAGMBIDhACAPAAHDCDC...fDGE.gAFDhADAACGE.FEAGhAEA.CDEB..,1,-11,-15,4
eEbXYWJKPGOTfaCUFgNBHVDIZcRdALQMS,QFCFeBBFEFHB...XDFEJFFBKFDCGAEATBDEaABACGBC.hAAAFHBCBADH.DDCEcGFChAAAACIBLAGH.hAEAMCAHYAFA.PBBB.fGGBhAHANIAB...hABA...,1,-4,-27,23
SAWYVFeGERHJdBDgUXCaOKPcMLfTNbZQI,VAFCFDCCGFDH.RFADHDFCJFDCBCBA..DFCEUDGGCAFG.KFAHMBBBhAAA..LABEhAAANIDB.ZDCGQACFhABAADDG.eAHDEHGE.......hAFA......hAIA...,2,-36,-9,27
ESYOefPGVbJMTFXUWgNQcBRZdHDLAIaKC,aABDCCBH..SBCBeAFAGDFG.JDAEFCEE.XCGHUFAD.hAAA...gADFhABAQGAGBHEFdFFDDAAFhABAIDHHKAECEECEfEDHbGFAMIDG.WBFAhADAcEBC...hAGA...,2,-25,-16,9
RHIbGQaANYfCWEDLcUZeVKFPXdSMBgTJO,...NCCB.fGFG.EEDCDBAALDGDZFDGKDABFGAFdHCFBDDChAAA.JBBFOFHBhAAAIBEHQDDAhABAADIBCHACUAGHPAFA.SCGHgEAD.hACA......hADA...,1,-15,-38,23
dbAYTaNLJRfFEOXVQcGeMUISBDWgHZPCK,TEAHLAGD.JCBHFCDE..ODDBQFFDGEGAMABASHBAhAAADIGEHAGFCADB.KAAFhAFAACAD.NIBDRDEC..XFEBhABAeDCBBGBH.WADAPAHF...hAIAdFAEaDHDfBBDhACA..,1,-4,-14,10
PNJMHbcWDaBQLfKFGdVeCOZYSERTIUXAg,...PGDANADBHABD.....bGFEDIACBEBBfAEGhAAAGEDAeBGBCDHDOBBBSBDHhAAATFACICDChABAAIAEJDFHMBAF.WBHBaEEGKAHH.FHGG.ZAFDhACAEFBB.....hADA...,1,2,-20,22
GFOdKIRaNQAZcVeJUWDPBSMTbLYEHCfXg,VDGDJGDG..DGIDBDBF..MEAELBBAHBFF.CAFA..XEDGhAAAFBBFOFFA.dFBDhAAAIFADaADF.ABHFeGDAhABAPHAC.SAFFTCEDEHACfAHAhABA..KGHHhACA.NICD..,2,-26,-23,3
aVRZWELXFAPHeJOQDCbNMcBdTGSKIgYfU,HFEHJBDG.OCHHCHHG.MFACdHDBGEEF.KCBDICBEhAAA...fADFhABAVFAHRCECZAAGLDDGhACAAAIB.QGBEDCID.cAGBBDDG.hAAASGHH.hABA...,1,-5,-31,26
AeKYJaBWMDSIPFZHLGTfbdcRQEUXOCNVg,KBFGJBEHBDHFMDGB..DGHB..SBFBFCBBHDDD.GEAB.hAAA.fEBAhABAdACAQGEAEACGOHDGhAEACAHCNEIA.AICEeAFE.aCHDPAAH.TGADhABAcFBE....hAIA...,2,-24,-24,0
RSVdXABUNQJcFOaELGKPTMeHDWZgYbIfC,UAGGQFFBFBED.aFBBGAAG.KDCAPBBD..MIDGhAAADDEDZADA..bFAEIAHFhAAA.CGDDSDFBhABAdEGHBEADNHED.OCHDEADF.LHCAhACAeFEG.WEAF..hAEA...,1,-18,-22,4
dfUaSLcXNAVIMWYbTDPHCQEGKZeROgBJF,VCFCMEAF......bDCDDBDAHFFEEABFZFFDOBFDBCDHdBAGUFCFhAAALFBF.XBCEhAAAAHIH.IEHEhABAYEADCHCE.KHAA.eCCD....hABA......hADA...,2,-34,-7,27
gIFUdETBAbaVRfYJWCSZLKOHQDcPeNGMX,aBDHRDEC..JAEGCAFBZBGDLCCF..OHAGDABB..eGFGMFCEhAAA..XFCAhAAAFGHFdDAHBABEAIEG.fHFBhADASEAFKGDCQBGA..hACAPBFH...hADA...,1,-29,-36,7
BTcIHeVbPNfMgdaQLZUERFOKJCAYXWDSG,XEEFDHBEBEGG....TCCHIGCAHADAeBCA.bAGDNCBE.hAAA...MFADaHGCQAABhABAZFFEUCFHEABAhABAOEGF.KDAFAEEH.SGAB.hAFAcDBF.fBFAhADA,1,-7,-30,23
UXGRNFVKYWIdBTMEcLagHefPSCAQZJObD,JAEBDBEEUAABGGBB..REFF.FGHHKAGE....ICAFdDCABHEDhABAMBIFLDAB.hAAAHCEHfEEHhABA.SHAGADIFOFHDXGCFNEAB.hACA.YAGHEBHH.hADAaABE..,1,-22,-29,7
POEBeSgHTWFaQbMKXAUdVGYDcZRCLJIfN,dDGCGDECDADERFBDCECBLBAC..JDBE..IHHC.hAAA.NAIC.PFBDEBDABABBhAGASAEFHFDAFGHBhAHAQDGFKBBF.AGHGUAGC.YDADhAAAcBFG.fHDDhABA.,2,-29,-26,3
dXQSOZBgYRLHbKaINMDceJEFfAPVUTWCG,VFAFTCAE..GEDGQFEEZABCBGGERABCHBFCKCAB...aEFAhAAAMDFGDIFEeGBGFCCDAGID.hAAAPDDHUAFCCHFGdAGB.hACASEAA.......hADA......hAEA...,2,-25,6,31
cBRJSWdQOTPfeYXNDHVAKZUbgMCGLEaFI,KFGDUEDDMAIHLHBC.EGHHFBAD.BFDDSAEFQCDHhAAAODAD..fHAFhABAXABEHAGBhAAAAHEDZAEA.CGFHIEGH.RCDA.dFAD.eFHHhACADCAH......hADA...,2,-30,-5,25
RSdOeNUWDbFTXYLGIMPVEKcJBZfHCaQAg,SFECdGCFOBBHUAEGDADD..FBEB..XGGALHAAMBHBhAAAEFGHKABF.JFAAfCCDhABAHAGF.CEFCAAHChACAgCAA.NIED...WDADbDFE.hAAAYEBG.IFGEhADA,1,-25,-28,3
IWSUKbBLeREAYgGcHdZQPFaTMJXOCDfVN,GADFHDDEQFFAFCFDMIBG.JFCH.CEBC.VFFG....IBDEhAAAUCABBECARAFCABAD.hABA..gGAChAAAdGAAaDAG.OABGfHEDWEDH...SDFEhACA..hADA...,1,-19,-20,1
ABcgdNaVTZLCRMJGOFPUWHbYKXQIESDef,BBEHdCAGaEEGZEGF.CAGG.RFBHGBGE.FABEUDAG.HDCDKGGA.XGDHhAAAEFFH.eBAChABAAGAG..NCCH.LAHBhACAMIFG..OAFG..WFFB..hADA......hAEA...,2,-28,-20,8
QIJOVWMGYabEHDceTgFLCKBPXNRAZdUSf,ZDCFdEDBUGABQBGD.OBCGVACDGBAA..bDAHDFGGhAAAeFGFFGHDLHDChABAKBADBHDHXEEBhAAAAGEG.IHAGMAFDEBGA......hACA......hAEA...,1,-14,-21,7
XOHNVZUeBGLCSFDfbEMWcPIAgJTdaYKRQ,TDBCaFDB..RGFAOEDAHCGDZGFC.eFDHBBBGCBCA.FFACDAIHECHHMBFFhAAA...PFAHhABAIAEF.AACDJCDGhAAAdAEBKCAF..NIBB........hACA......hADA...,1,-13,-35,22
XaTYEKHcBPVeRbWfUSCIZNLGOJdQgAFDM,FBCBXEGC..aABGECEEHFBBBHADeFGBRABE....bDAGUBGAhAAA.IGEHhAEAZGBC..NFBDOAGFhAAAQAEAAHGEDCIBTDEBcBAH...WGCEhABACDDF......hADA...,1,-13,-23,10
EaRJYWBdgTHeXbKDIAQLSUGcMZfVPCFON,SHDGUADHGEDFMBGDZCEE...VADHCABDFGCG...ECACaCAChAAA.JEHFBGAH.dGGDhAAAHDEB.eGACKHEAACIHhACAcABBOEAGNAIG......WFAChABAgAGC..hAEA...,1,-7,-27,20
IbGSaHDZTeXOWQMUFcfYECBJRALNPdgKV,LBBAdAGHKGEB.VBGBGFAF.HBAFDFBGZEDBeAEB.OAAAhAFAMADCFGGF..cGGChAHAECADBABE.ADEA.NEEB.hBAA..IHAESDDFaFFB....hBDAXGBFWFFE..hAAA...,2,-31,-5,26
aSfdOQBHUGbVYXcADPJRTZWgEFIeKCMNL,DHDGRAEAZCAAEAAGFAAC..KGFE..CDGALFED..SEBFhACAOFABHFGHGAEAhADA.bCCHXCEGhACAAFFCJBHB....WHAGIGCEeHFA.MCIBhADAaAGG.fGFGhAEABADH...,1,-18,-28,10
SCRPFLEcXZGANVbgJOYfeBUHaQKTMDIdW,VFAHJFCE..OEHBeAAEHDGH.QEEHMHDAdDDFSCCChAAACBEARCCH.LDABhABAEBBBZAFD.AHAF.NIDD.bAEEhACA..fDACBCHA.KGHBDIBE..hADA.WCFB...hADA...,1,-4,-24,20
VZBHGfMPKODYFENUdcSXJAeRgabCTQIWL,RFBCaDCGCBAH...QADFLBHFBDAAHFFBMIAGKFHF.OCHFhAAAFEFH.EGBAdCDBSFDHhABAAIHG.eCABbADA.hAAATDEC.IAHF..WCBHhABA......hACA...,2,-47,9,56
JcXVYFeBgUAbGaIEPSDfNRHWQdCMKLOZT,aBFDEFDFDBCD..RFAHQEDDdBDCKFFF.OBBDJCGH...VADHhAAAFAGEBEAG.AGHA.hAAAIHCB.SHFEhABAfCAENEIECAGEMIDA.ZFBD..hABA......hACA...,1,-17,-43,26
RWNHMFgdCLeYaVIJcODEUQKBbZGTfAPSX,SBEGXCFHRECH.HFFH.FFDDCGGGeDADaEAE....JAHDDDCChAAAEGABKBCEBDDE.ZBABhAAATBAEAEIH.NIDHMAIBhABA...LFFCIHHBOAGFhACAQDFH..fGAEhADA,2,-30,-12,18
PKJLOSXEDRUZFWVdIBYaHbMTefAQGNCcg,QEEHCCCD..PCAFJCAGLACEOCEG.SECDhAAA.XGDAhABARACCUGEDFGBCdAGGBHBCHDFGbEDGhAAAMDFA.fHGHAHIBcAGA.EDDFDIAG.hAIA......hBAA...,2,-16,-16,0
EGXPcAUKOIbSVaYMQdfBZTHRFDCWNegLJ,KCDBOGFA..SGBFaDDH.MBCCfDGEBGHGZFDEHAGDhAAADEAH.CEBH..eGCEhABALDFEEBCFGAEChACAXCAFAGAHIDAG..YBFGhAAA.dHEF.FDCHNIDB..hABA...,2,-32,-2,30
CIHYDSUXMdLcRGVgQPBNFbKfTJaWeEAZO,OCFFCBDCHDFFDBAEUFCB..MIFGLACBRCCC.GAAGQAGChAAABAEHFAHFKFADTGBDhABAaFHD..eFFD.hACAAGAHIDHBYFBCdEHE.....hAAA......hAEA...,2,-26,-9,17
OJaAQMgPYfSHNCFXTEZeLbIBGVWDKRcUd,QDFGMABC..PDBHSGCCHEGHFDFGEEADZAAHLDCBhAAAIACDBAHGVDCChAEADBBEKEEDUGGCOBCEhAFAAHBBfAGANHCB.CEHHeHCA...WAHHhAFA....cGAChAGA.,1,4,-25,29
dVDUQLgOKFRAaBbWeXSCfTNYIcPJMHEGZ,aGFGBHFB.eBCDCDAF...TAGH..NFBD...IGAGhAAAJCEGEGBBGABCdEADDEFDLEHHhABAKAHHAHHB.XFCAhACASDHFfADC...hAAA......hABA...,2,-44,-22,22
SKWDUeZgAJBHNcfXPRTFQVECIYaMLGbdO,HBAF..fCEHPFAH.RECBTFGDVECG..EACGIAFFhAAAaFGELCGHdBBASAHDhABADAADeBFDAAEGBADDhACANIEHFHBECEFAMIFE.GEAA..KCCChABA......hAGA...,1,-1,-6,5
dDOFMQcSXIJKAZeRWgHGUPfCTBbLENVYa,ZADAeFDAREEDHBAEUFAE.CFCA.BBCD.LDBGEGAG...NCIE.aEHDhAAA.DDHDFHGEMAIBQAEGhAAASHBAICGGhABAAEDE..gCEEfAGB..hACA......hADA...,1,-20,-32,12
JfdeHaCFSMRPcWDTYEOGbAZUQXNILgKVB,QEDBXBEHLBCFKAAHBGHB.dHFHeCAFHBDHFGCBRCGB...hAAAPEFADAGDEACCOFFHhAAAAAFFUCAH..IHHEhABAJHAC.CAGCSBGAMAIB.WEBAhACA......hADA...,1,-11,-27,16
KSHeMYcVbQOZaLDFGgPWRTNUdAXCIfJEB,CAFHJHCGBEDFHDFF..MDCA..VCCHOHCEaAFC..LABAhAAAFHAGGEFC..WDAFhACARAADUADA.dFHAXBGAhADAECGG.SGAA.cFGDhAGA.....hAAA...,2,-30,-13,17
cLYTRMWHaBeFgfIGPXZVKSbUQNOJCDEAd,LADCTFDH.MFIBHBBEBGFBFGHF..IFBBXCFBZAEHKABDhAAASABCUCCGOFDGhACACHBEAHFCdEDF.RAGHaGAHhAAAeHBG.fFBB.....hAGA......hAIA...,2,-22,-10,12
VJNDdceSXPBKaETgWUOFAIfbQRYCLMHGZ,..IDGFQBBBRBAD.CFBCMAFBHGBEVFGHDFGB..dGDBSFCEhAAABEEEEAHH.gAGChABAUCGBABEH.fFAChACALEADJEHFeAEF.XDDEKABCaGBD.hAAAWADF....hAGA...,1,-13,-15,2
FMLAdZNVKcPTBfOQaCYUeGXEbIRSJgHDW,dFCBVCFGKBAA....TEABBHHBOABGCEED.UBDEeADFGDEHhAAAEAABRGFE..SHAAhABAJBFE.DACDFGADhAFAAAHEZECH...cAEDPHDG.fFGFhAGAaDAG..XEGEhADA,2,-42,-3,39
SBbLdfePGMcJEHUOINVQCYAXFZDaRWgKT,FAFCaGBB.RFCB.KAADBCACLEFE..eCFEMBCGEFGFHDCF.OHCEhABAVDAD..CAAA.XDAGhACAZCDA.gFGDhADASHAAfAGDPEED...hAAA..JCDAIHHDhACA..,2,-22,-19,3
cYMFgZaeBGJHQAbIRVKCWDNTSfUPOXEdL,RCAFVDAFCEGC..DGCG..SFFAUAFH.OAABEADD.dCHGLEEBhAAAMDDH.FGABaBCBhABABDHEJHBC..AEFG.KGHDhABA....WAGFfDCH..hACAXEEC.YFHBhACA,2,-47,-23,24
KbcUBFWCSLeaDMYXHTIPZJfVAOEgNQdRG,OHAGEBGB..QEEAdDBGKEGGUADFFDBFCAHALFEF.DCEBhAAAMAFB.XGFAhAAATGGA.IEHEhABA.JHAEABABgAGFGACCBABH..WDFChABASGAC.hACA.aEAH.,2,-36,-11,25
CNAcUKHMfQGTdaeSDWXEPVbgJZIOYFBLR,KFFGHEFGQCAGTGBFeCAEDHCG..ECFBPDAB..VECEhAAAgGEHZAFC.IBDGhAAAFADBBHFECAHHAABEMDIBhABAdDEBSCFE..XGAFhACA.....hADA...,2,-18,-10,8
cAJICNaVBEORZLfbXWFgYSGdQTMHDUeKP,CADHaGDFBFDD..EBBAOFHBLFFF...XADHFCCASGBHhAAAdGGDTDDFHDEGhABADCIDKAGDADFC...NCAE.hACARFADfAFG.WDACYCBFhADAMAAE.PHDEIAHChAGA...,2,-30,-21,9
HOJPAZKBdSRMYLFDcfQTbVCIEUNaWgeXG,BHBAdCAARCCDLEHBFDBDDGAC...QGBG..bEGFVFDEhAAACAAA.EADDUACBaEAE.hABA.eAGDHEDHOAHFhACAAGFFKAFCMIDC.....fAHAhAAA.NDEB...hADA...,2,-40,-1,39
FUTSbEagXdLNWfIVDZQCAHYcBeKGMOPJR,HBFDBDAAKBGFMABG.ODHBRDCBFHGC...SEDCEACB.XFDHhAAAdGAELFFChAAANDBF...IBABhABADCBECHAAYFBHeAHBPADAUGGHaADE.fAGBhAIA..hBAA...,1,-15,-27,12
APXfObFgRMaGdJcVBKeDLEZCUWYTHQSIN,XDGBOHBGFAFARBDA.GBEA..JCCFBGFHDEEBLCADhAAAEEBCCCAG.UGGE..TBCDhAAASGAFADIFPDGDhABAfGBH.MBBCdEAGcABGhAEAKGFFWHBA.....hAIA...,1,-20,-25,5
OMTSfUPGdeCZLRbDWAIVcgQNBXEaJFKHY,VDBCQCAD.BAACXAGGEEGEFGAHHEFE.MFAFSGCFhACAUADEdHGBCFFDRBEADFBBAEBD.hADA..IHDHhAAA.gBAHaEEBKHGEYAFCfDGBhABAeHDE.LCCHhAEA...,1,-3,-15,12
OSDMUbGCKaWgdHEPfRFeVXJQIZNTABcLY,LDFESBFCDADEUGEDCBHD..KFGHaEAF..dGCGHCFH.fHAFhAAAeEBGJHEAZAADhAAAAEDABCAH.OACBhABAMFBF.bECC..gCCBEDHH...hADA......hAEA...,2,-33,-17,16
RJMOgYGcBXCfbdHUZESeIaLKVPANWFQDT,FEDEDDFARAABOHEEGADABGDG..CHBBdFFEZCGB..EEAGeFBE.LEHHhAAAVADB.AAFF.QAAGhACAMCAF..hADAgAGAXGAFbAFFSGACaGGA.hAIAKDBA...NIDH..hBAA...,2,-19,-11,8
GcLOCDQbHXVRZeIUfTABENYaKPdSFJWgM,BHGGEBDE.aAAEKBGF.dEFAFFGE..JEDBMEBCLBAH.DACEQGAFhAAA.bFCDhABAVFADZCDC.eHFAIBFGhADATCCE.AIDE.NAEBSFEF.hAAA.WAFE...hBDA...,2,-29,-24,5
GYLKdBNMTeVgRPQCUEXHObaWIZcfASJFD,FAEEDEABLBCCKCCHBEED.MIEG..eFCDRDDB..CGBH.EDAGOAAHhABA..bGFGIEHBhACAZDFAAAHE..SBHBhAAAGBFCdGGBNEAC....TABCPAHFhADA......hAEA...,2,-25,-24,1
MFRHcKYAPOSfEJQNWUVBgebDIXaCZTdLG,OADDEAAF..JADAQFFGUECB.BACFeFGBDGCG.XBFFhAAAaDGFZCBE..TGEHhAAAdDDDMIDA.FHAA.hACAHBADKBHHAIACSDHDNEIA.WFACbGAAIBCChAGACHHC..hAHA...,1,-11,-22,11
aHgYLeWQDSZPCAfTGEUcXKdVOJbNBMIRF,TGFFEABEUGFG..KBFFdBHA..JDBCBDFDRGAC.FGCGHAAALCDDhAAAQAGBDAFG.SFFChAAACEADABBF.fDAGhACA.XGDDOFHD.MEFAhADA..aHCE...hAEAeBEE.,1,-2,-38,36
MTAJNgHPWFOGVREeQUYdKCBLIDSafbXZc,JEFAHFED.FEAFGDACRAGB.EFDBQCEB.UBAHKBCABAAChACADAAEaEHHfGHEhADA.XAEFhAHAMBDBAIBAgFCD..PAHF.hADAOHDE.eDDChBBACHHFSGAG.,2,-14,-9,5
OXWBFCJbYAVKaMPETQDNgGeUcSHdfILRZ,KGDAaBDF.EBEBDIEG.GCCCeDAD..UCBFSFEGHDFEdGHALDHHhAAAZAAGOAGDBFBBCGBH.hAAAbGAGAFFD...VAFHhABAMICAQCAF.cABGfEDAhABAIHHG...hACA...,2,-15,-2,13
NYLHZUCgSWVdREGMeAQPTKBbJaIfFcOXD,QACBKGBHBBGD.aFEAFEBA...ODHF..NBIELBGFhAAAUBAD.CHDBSDDGhABAVGDC.RFACMFHHhADAADGATEFBJBBHfBECDFABHBDB.WHAGhAFAEHGA......hAGA...,1,-20,-31,11
eVZGIKCHSagRbJWFdMEXODfLAYBPTQcNU,BCACTBAFQGBH.UEDHVAFDZAECKEDAHCCGSHDAhAAAaEHF.RFAC.JHFEdGEBMAAChAFAXDAC.DCIFhABAACIHPDBB..eDDECBBB.WDHDEEGD.hAGA......hAHA...,2,-12,-10,2
BMZWgEeNKDRLAbfSVGXJCcTUQaFOdHIPY,SCBDXEEE.CCHC.UFBB.FACAdFGBHCCC..ICCAhAAABHFFMEIDZFBDEFABKAGBRAAHhAAAAEFH..VAEB.GGDBhABAcCFF.aGAH.......hACA......hADA...,2,-24,-17,7
gSPLKAfHadcBbGTVORWFDIZQeCMEJNUXY,aGDFBGCBGBFGOCCAFACEDEBF..ZCCFCHFH.EGGD..UFFD..hAAAXGACSAGFhABAPAADACIBHDEC.dADHhACA.......cCBH..hAEA......hAIA...,1,-27,-38,11
TNJKfDXZIcSQAdMFEObLPBgeURCYaHVWG,FFDFOCDALCAHBGHGUEBGCCFC..aGFBHEEH.GAAF.hAAATAGBNECGKAGEDHGGXGDHhAAAZADB..SABAhABAAIAAdFAGMADGEDHDPDHFeFFE....hABA......hAIA...,2,-25,-10,15
EdDHVTWeXIYOgMcFCSUZKfBAGJQbLRNaP,QBFCRFAF.aDBHEAGB.HBEF.TFGGXEDBOAAHhABAgFFCMDDHFHDCSBBAhAAAZBBDBEGCAAEGGGAHhABAJEEF.NAIADADA.eHEA....hACA......hAGA...,2,-12,-8,4
DESbIPRNLJXCKTdVQaGYMcHAOUFfeWBZg,UCFCFCBHeBFDZFGFDBCD..SGCH..IBABhAAAREEBNDAE.LFBDCHHG.hAAAdBECaBHFMBDDAACDOEHFhABABDHB.EGBHJEEFXACDKDAF....hAEA......hAFA...,2,-33,-25,8
ZbMXaFBSKDEYceLIGdQCWNVUHTOJfPARg,ZBGBMBBCFGDEKFFFDAFD..EBGF..eGACLCCHGBDCCGBF...hAAAVBAETDAH.OAFGhABAfEAAABIFbEGH.hACABGGA.SABEIHDGdEEBNIDH..hADA......hAEA...,2,-21,-21,0
dNWbOQAfEeCMUZgPJIcLFBTaKDSGRHVYX,eGFGMDHDZEEF..PCFFJDBG..LFCDFFAGBDBHKBFHSAEChAAARAAD.HEDHhABAXADBdBBF..WCHDhACA.QGBHAIFGCHABIHHCcBDDDEGD.hAAAYAHHNAIG..hADA..OFDD,1,-19,-22,3
AbOLJRWIMSYBaGTEHcePgZDdFQKXCUfNV,OFBBJBDG.RDGD.MFAABBBDGGCFHAEHeACBZAAD..DGFEFHCAQDGEhAAAKFEC.CGAH.hADAUAGG.NEAEAECH..hAAAWCDA..SEDCaEECEAGE.cGGEhABA.....hAEA...,1,-15,-30,15
bNPaFAgREYcKZIDfQeGUWTJHLXCdOMVBS,ECEFKACFZAGHDIDA...QEFGUEBB..TCBAJCDDLAAHhADACEFH.dEBAMAACSGHBhAEA..PEHFhAEAAEHARGDG.IAFHfBFGeGDA.GAGAhAIAWFAF...OBBAhBAA.,2,-25,-19,6
CIHbFENYPVRaTMGceOfXJBWQAULSdgDZK,UEEBdBAADGIFCHFH.HAEF.FCCBEADF......NEEE.VGBCaFHB.hAAAMAAGGEAA.eFFFhABAXBFABCHAAACDgCBEhAFA.IHHE...hADA......hAEA...,2,-34,-24,10
fCYgSDcadTFBXbJLQEWAZIMHPOVGNUeKR,ZCFEHGAGOBEBVDFHUDBAKFGG..RAFE.CHGD...SEAChAAADAFFaABA.FACGBHDA..hAAAXGFCLBBAEBADhABAAHHCMDEBGDCCNBIA.eFAH.....hAEA.fBGGhAGA...,1,-10,-26,16
WUNIeHcLCEKfZTbRJgdSAVGMXPFDYaOQB,VDCEMFIBFEDE..DFBFOADCBDHCUADB..eGCGHBABLDAAhAAAEHFEZAFBRFFGJCHD.hAAASGAHAIAA.hABA..PCDAaGEH.NEGGCBBDfAHChACA......hAEA...,2,-20,-20,0
GOHWaUKJFCbAfgSdETPILcXQeDBMRZNVY,SEDDTCFD.LBHBQCBADCCCBGGBRFCGZAFA..NEIG.VGAChAAA.GBEGHGAE.hAAAaDAD.KHFAFDAHABAGdACFhABAIEEBeAGD.MIDG.WABACFHB.fGGEhABAEGEH...hAFA...,2,-9,-1,8
KZFeJaCMXHUPgITcEWdLNRbBQYGfVAOSD,DEEHFDAAeCFACGGG.HGAEUAAD....IEEGTGBC.EACFdBFDhABALDDFRDGH.bGFGhAAABGAFGAEFAEABOADBhAEASFACKECH.aEHDXGED..hAFA...gCEGhAGA.,2,-37,5,42
bFDaIVXGeMANgZUJRHOEWKQfSTLBCYPcd,ZFGDUBGAREBHHADDEHGA.QEEB..TGAHCDAB.PFDDhAAAdBHCFCCF.aGDFIAEChABAXAAFGBBGhACAAAGE.NEDB.JBFBOFFB..WFADfDAGhADA....hAGA...,1,-6,-21,15
aKLJQZTDgGEbFMARdXSWINOBHecfCPUVY,dAFDSGBG..IEDDBBAGeFFHCHFAUCFHaDAH..LFDHhAAAZCBBDGEF.EDECFABBAIBEXDBFhABA.NAIE.hACAOFFG.HGAAcBEBfDAChAAA.YADHKHGA.hADA...,2,-28,-23,5
YbWNOIUQXafcDFgMZRLeVPGKdHCSABTJE,BBCDTCGBJAGB..EGBG.....bDCAOCDF.QFBChAAAXAADaGHDDGADFEGBhABAMBFCLHDEhACAeFCGPADFdADHSBBDAHFCNDAEfEHC.hAEA......hAGA...,2,-36,-2,34
PKSTDUCZgfRdHQYBLGNEMbeOVcWaIFAXJ,XADAKHGCDIBCZCCGRECF..HFFCBDHBLABF.EBGDMBBDeCCGhAAAOADC..cGEChADAaEGD.AHBGPEABhAEASECH.CFEGdAAF.QAGGhADANEED......hAFA...,1,7,-42,49
LecXJMZDHSdWPFfVbECNGUOTQAaKYIgBR,KFGG..gDDALFCBeECE.JBGHDADHHAAGSDGGhAAAdDAGFGAA.fFGGhABA.bBEAECDCCCBEUGABhACAOAHFAFBFIAFHBHADcGFHMIDC.WFHHhAEA.....hAAA...,2,-22,-8,14
LCRTeHDBPXZOKfcSbadYQFgUVGEANJMIW,MGFELHFAREBB.eBADBHHHZEBEKBCA..SFGEdBBCFEFA.UAGEhAAAEAFG.AEHG..IBCChABACHAADDEC..OCAHhAAAfFEC.aAEC..YAHBhABAQCDD....hACA...,2,-35,-24,11
fDVKCGRTdJYZBEIQMgcSAOWbPUeNLaFXH,OEAF..bGCAeFCCLDFAFACEHCEAVBAGKGEE..CFFERADCJHBEhAAABEAA..EBABIFCHhAAAMCCF.SHGChABAAIGGUAGCaHGAfBGH.DEEF.hABAdGAA.....hACA...,2,-17,-13,4
aVNKJebOBfdAcGFWURMXSgHDPTIEYLZCQ,GGCHUEGHRBCA.SDCHDBGE...IEEFEDAFLFEHhAAAQBABaFBB.KFADeACChABAbCGDBAEDAEDH.WCDEhAAAgGCH.TCGGCDAGNAIE.fHGHhACA..dGGEhABA...,1,-15,-18,3
JVfBOUAHGTeYSLKFNgPcbDZMICRXdQaEW,TEAASCFF.KAACFGEE...NIBF.PFAC..bADGMHBAhADA.CEGD.dEDCaGHFJEFAhAAABDDBOCEEHADAeBAFhABALAHBDHAC.ICBBXAGBEGGBWABHhAEA.....hAFAfHGHAIEC,1,-10,-26,16
NYZFORBTUCPIXadbJHDLKMEWSAeGgfcVQ,GBAH..cDAGNAEH..FFGEOFFCBDFDUBGC..hAAAPGBAaDBE.dDDCJGCEhABALBAA.MAIHhAAAEHECAFCDfCFD.YHEAhABA......hACA...,2,-33,-33,0
DKYXAZVPSgdbGReJNIfMcTEBHLaOCUWQF,VFGBSAGB.dEDAGAABRBEH.eBFHJGFC...IBHAhAAAMAIBEDBFLFAFhABA..aFAEODCDhADACHEAQAADDHDEKCDEADIFPADHgEEA.hAAANAED...cDFDhACA...,1,-3,-29,26
gMecTCRFGIaWPKLOfVbdBHXESNUAJDQZY,DDEDZFCGMFBGeAFG..CBCG.FCEAGGEF..IGHCaDFF.KAEEhAAALCHD.OEAFhAAAfABFdDABBABFhADAECCESDHFNDDAAIAC.YHCGhABA.TAGC.WDBGhAIA..,2,-27,-24,3
YQHFeWRgfCdGOcaPATLZIUEXBKMJDVNbS,LDFBZFBBUBEHBBBDKAAAMBEH..DBHD..VFAHSGFHhAAAQCAEHEGHFHEAeDADhABARAFC.CFEH.ODCDhAAAaAGA.AACEEDHB..XACB...hAEA......hAFA...,1,-16,-27,11
COJRLMGeVgKcYBWUXaEZfbATFdHPDIQNS,FHGGHADEDCCEQDCF.CGHERAAHLGBGGGCH.eACEKCFBBGADhAAAXCFBaFGGEDADZDBGAFDDhAAA...dFFFNAIC.SBABhABA.MIAE...gAGEhAFA...hACA...,2,-20,-14,6
cDFQAPgUOGKVXRdabeNCTSMHfLIEWZJYB,UDBGKDGERBEC.dBEC..eEEBCAAH..MAFAHDBFLCGFEAAFZGAEBGGEhAAAFHDE.AHIB..OBDHhACAXACF.aHGCNICF.hADA....fGBBWAEC.cEEChAAADCBB.....hAIA...,2,-33,-21,12
FTOMgbaeXCJVDENPISdZAWKYUQHGBRfcL,KEFEQFCBBCCERFGB.LBBG.FGGFOFAEMDFC..aABACEDEDHDGhAAA..EGAE.NIBB.hAAAIBFDdAFCZDECAFFE.hABA.....YAFC.HCAFhACAfEAF..hAEA...,2,-45,-19,26
ZRVEUcGBXWDeMYFafLgCbNQPTIAOJHKdS,HGAEdDHGSDFHVCGDUGGGGGAD.BFDGXFDBeBCAFFAGhAAAaCBGLADACBBF.hABAQCDHIHHGADDBhACA.KDAGEAACDGGDMICG.fEAFhAAA..NADD....hAEA...,1,-7,-18,11
JZKGcLFDSfMWgdVTONeUEHBIXQaYRPbCA,KECDGCCDFGDF.SACF.MEAHdBGCTEFBOGBGeGFEhAAAUBABBBDHQADDhABA.aHECPDAFCBHDAHDH.hAFAJFHDcDFD.DIAEfGAEWBBD.hAGA....NAICIDDEhAAA,2,-36,-12,24
HcSbWGZBXPDKLQCaRUTAYIEgJfNVdOeFM,EGDBJBDA.....fCACVDAE.ODBCeGFAFGADHABG.hAAASDFCGDDGBBABhABAPEGFDDHFKAGHCHAGaFBFhAAA.RAFGADDA.....gGEBhABAMDGDWACC.....hACA...,1,-10,-31,21
OMSQLNGePUdEaTAYDIHgZbXfJKcRCBVWF,DBACHCEAZDDCXFBHKCFA.RAABBAHFFHBA.OGFEQFFF.hAAAGEAHUEGHEAFBAHAF.hAAAIEAC.fACDhAEACBEDMAEENBICeCACPDDB...aHEChAGAYHEA..hABA...,2,-32,1,33
EPAMDYTdFZaQVfGUWcOIXLRbNCHBKgSeJ,MCIHTFCEZBEF..QCBDGGAFUCAGOAACLDGHRCFBCGGGBEBAhAAAKECGeFFD..hAAAPAHDABGGDADG.FAEC.hABAaHAGfCDG..WFEHIHHAhACA..NCAESEHHhACA,2,-26,-9,17
dORfUcDGPXVKAHZLNMeYCSEJTWbaFQIBg,ZCFBLCFDMAIH.CGHE.EFAH..TBCC..bAAFFAACBAFCdEBAOGDAhACARECFUCCFDCFD.hADAGEGGPHBAKHBAAEDBHAGHhAEA...NIEBSGADaACE.hADA......hAHA...,2,-14,-8,6
WMBLGXZPQeDKRONTfUVbgIJacCSEYFdHA,BAAFGEBDZBCGeHCERAGD.OBAG..fACHUEGF..hACAbBECJDDFCHAB..EHGEdFFEhAFAAEAH.MIDGLCAAhAAAQGAADBGG.KDHH...NBBE....hABA......hACA...,2,-24,-15,9
MEZIYfKDeUTaWXAJdbBOLGHgSNRcVQPCF,dAFGOEFHGCAEHCBASGDGRBGD.QGFGCBEBMCABIGBEhAAAKCCGDAHH..TDFDhAAAaGDDAAIBBAGCLABChAIA.NDIG.PHFEEGBFfECFUABF..hBAA......hBCA...,1,-9,-15,6
ZMKXbDWaHTNAQFfSVBgeUcIYOLPCGJERd,FGFASEDGBDEHUCAB..IGBFLCHFCDCCGADHRFBD.hAAAMDHDKBEDDAGGHBAHAHIF.hABAfCFC.hACAeGFGODDH.EAFDdAAF.XEAGhADAaGEH.NBIA.....hAEA...,2,-33,-9,24
eZDTBJOdUAaSCWEPMHGXYbcRVNIgFQKfL,SECHEBECHCABGGCH..XADCbFFE.REGD..IBBAhAAAgDDGKFADfCEBhABALBHDDAAGJHBGhACAOBBAUEEAAHIH.aBHFCGADMADA...hAEA......hAFA...,2,-20,3,23
FfYTLNJgbWUIZBMDScGHaQVAXCdPeOERK,dHDHOCDARDEGKCBGFABB.....TFFCJBHH.....WFBDhAAAIABG.MAFGhAAADDHDSDEGhADAHFBAaHGG.AAIBCHHHEBEGfAEBLEAF.gGDGhAGA...hADAbEBF.BCCG,2,-30,-25,5
bJKPXDTMUNEagRAdQSOIYfZVGWBCecFHL,SCDGODAG..IEHBZEEAGACDCEDB.eBHBHCEEJBBHKGADhAAADIAEUGEG.aFBCAFAHdGEDhAAA..QABEhABAfDAEBECGcGCHFGHHLAFChAEA..XCFDhABA.MIFAEHCA,2,-11,-1,10
fVFYXcUBOIPZGQeMELNaRCAJWTKgdSDHb,JCDDKEBGdEDEHFFA....VABDXCAFBBED.OBFEZCGBGGABhAAAMIACLABAhAAA.NIEF.CHGEAAEA.TAFHhABADFADFGBA...YEFCIDAE..hADA.eDDE.aFFC.hACA...,2,-20,-20,0
SBVCZEcdYfMWFeJRgONHGbTAQIKXPDaUL,KAFEXADEDHEGLDBBBDFHZDDB..EABDdGHE.MCCDFFDGeADFhAAARGBG..OAAFGDEBhACAAACFQAGBhAAAIBHAaHGESFFH.CEAC.fFGFhADA.....hADA...,1,-18,-24,6
IFfHbTERKNVXMaAeLgCdSOYPJWBQUZcDG,eFACLFGDdEHGOFDCJADFBEEG..ZBCBDDGGGGAB.FAFBHBAFhAAAEBAH.KAFA.XGCAhABAAIHGCDAH..SAAChADAPFAH....WCFC...hAEA......hAHA...,1,-24,-34,10
QTBcVGfHaSLYKUMdDNOFgWIbeEXJPRZAC,CFFCBFBF.GDDEHECDLAFBUBADDFGB.NCHE.FAFH....ICAGhAAAEHAC.JEAHPFHFhAAAAIFC..QGGBhABAVCGF.fBBB.SBEFhACAKAHHMEAA.dHAH.hABA...,1,-15,-30,15
DSXQgJdZfFPaVRHAUebIEBNYcCWTGLMOK,UFEEeEAAEBGABEAG......YFDDCCGFTFCD.LADFhAAAKBACDGGFQBDAhAAA.dGBCfAHEhABAPEHBaCAERCBBAGIHNACH...cGBCMFFFSEEEhABAXGGHZBEFhACA...,2,-35,-1,34
EIeUMdRBPaHSDXWfAQbNcJCYOKFTVgZGL,QBCE..cAEBCEEEKBHHFGDCTCEEZBAH..GEFAhAAAEGFDeEHBdGBCBAFGHEACSHCAhAAADFCC.hABAWBHBADADNEIC.JBAH.YHAE.gBBBhABA.UEEHhACA...,2,-24,-9,15
NcSTRgCHBOGadMEQJVZDPfUXWYFALKIeb,LCGFeDDA..bFFFSGHD.TBDDREAFCHDHBGCGaEAEdGABhAAAEAFCQBCHhAAAZEEHDIAGUBBAXBABhABAFFDBABHAKHDGIHHF.NCIA......hABA......hACA...,2,-15,-10,5
RJTGIPUZfbEMAcVHBeXLgCFNKOYdDSQaW,HGFGeDDELFGFCGBDKBFB.dACAQADGREBBGBEDUBAGZCBAEABBMIBEhAAAAAIBBEGH.FFDFOEAHhABADDIF.aEHF.JEEFhAEA............hAFA......hAGA...,2,-32,-2,30
eVNAKcSBgLQTEMWDUYbRaXHPfGFJOZdCI,SBDFLGDGQACCMDID.UAFCRGDCHDADGEAGJAFGZECEhAAAIHHCeEGDAADCKDFEBBAHhABAEEDB.DFAF.aDGFXBADhAAA.fDDB.OAHFhABACDEC.....hACA...,2,-15,-3,12
ERADgOKWHPcQLdZUbTSJBNaVXCGfYMFIe,DFBFKBCFHDFAQCEDLCEFdABHZFECUGAH..SDHHhAAABGHDaDAB.CHCGGAEDMIFGFACAhAAAeCCHAHFA.OHDGhACA..cBGC.JFDFNEAC.....hAEA......hAFA...,1,-14,-18,4
UXdcgSJfTDIVCYPAHRWFNbaZKELOGBQeM,RBBDFDAD..aABAEGDFLFCDBCCF..QDDGUGFHdBFBSEDEhAAATAGF.DDGCIGFDhAAA.CABGAHIHNEICKEGDhAEAeFBF..MEBDcDGG....hACA.fCEBhADAPFDD...,1,-18,-38,20
BAEgKVLGYMaSQNCbRfPUDeIWFcZHJTOXd,EBDBKBGEGCBC.MEAFSCFD.CGHCRDABfFFBhAAADCHDeHBG.FBCAZABHHGCGJAFC.hAAAODDGdGDFBADBAIHA.hABA..LFFBaGADNDIC......hAIA......hBAA...,2,-20,-11,9
ESPZKfgYQRUBcLaOVJHAeCdGITMFNbDXW,eCHDGACDMBCDFFDDDFFA..EEGBZDFAKEAF....fCGFhAAAYEDB.QCAFhABABDDCLADGaHACJDCDhACAAIDACCAC.IHBA.NDFG.XGGBhADASGHH....hAAAgFAD.,2,-17,-8,9
gTLIdUAFGHSBQXcOZPJfaMNVbEDReCWKY,HGDEBDBDQFEBXFGEOCAFZCDGJBHHaCCH....MFCHhAAANAEC.EADBeAGF.KAAFhABATBBHICHFAHHCSHEAhABAfGACDAFFCEFH..WAFFYEAFhACA.....hACA...,2,-17,-17,0
FHYeJdfKPDZbASXGBEOWMTaLVIURgQCcN,SBBEBACDOECDMGECLGFA.UAGAQCGC.hAAACEAAFAGGeEFGJFCHKBAFDAABhABAACDEEGBD..WDDChACAaCFC....IEBHcADF..NFEB..hABA......hADA...,1,-27,-36,9
fEbFeBJNTQadWVDCZcXMSYLROKAPGgIHU,GDBEHEBCEGEFFEEBBBEH..JHEEQBGGdADEDDHD.CDADXAABhADAMCIH.LHAGhAEA.KGGBgBAFhAAAICCCfFAEeAFFaHBC.WFFE.hABA.cBGG.SFGGhACA,1,-21,-22,1
BARWOISZgJUFQYPeKHGbMDELdVcXfNCaT,OAAHZAFGUDGEFCGE..QDCDeFEFHFBDMAADDIGALBEFhABA.dFHAXFDChABACBBEBDBEAHAAIGHChACA.SBBEYAEC.PFAF..hADA......hAEA...,1,-19,-30,11
NFCUPAOdageZKGcJWSQVHTIXBRYfLDbME,dEEEeAHHGBGE.JADGQGDC.TAAEXDCDBGHChAAARBAALHAEDACEEGAFNBEG.hAFACGGAAIHE..aCFDKAAESGGDhAGA.IDCCfDAGMFFEhAHA....FCEGOFCHhBDA.,2,-21,-17,4
caZTPMRfUFbAGWVeKJDXgdIEHQCLYOSNB,VCBCeCCCDFEF.dBFEEFCDHEBBLAEA.OFEESGADhAAABEEFZBFEMFFARAAAFEHFAGHDKACChABA.JBHF..XFAHhAAAIBBDCHHENIADaGED.......hABA......hADA...,1,-13,-19,6
FWDTNLPgRUXCObEKdMScaJVIHAfZYeQBG,ZADBQGEDFGCBDFGB.LFCB.RDDECBHFEFDE.KBAGMABG.aCBAhAAAVBFE..ADBEeAFFhAFABEHDGDAH.hAHA.TEGANIEH........hAIA......hBAA...,2,-37,-20,17
ASWBRJaVENQdYFMTCKfDcOIPeGUbgLZXH,BBGGaFDC.EEDHdADHFHEGMDCA..CHHD.KFFCDGGA..OCFA.hAAAeBAHUBAHLHAChAAAHGACAECESBDGhABAJHECNECF..QEADTEAH..fEGBhACA.IAEGhADA.,2,-45,-14,31
AIHONWTXDdKGYJagEfbRBLQPcMFUSeVZC,HDADOHDGTCGADDDHGEAA..aAAFEAAFREDCQGGDhACA.MFCHUAFCSAGEhADAVDGFCBDBAFEFIHHGhAAAXADHKGEH.YFAFJCAE...hACAfDDHBFFD.hADA...,1,7,-26,33
RgPJQBfCUdSVEFNbXDaLeTZOHMYcKAWIG,GCCARCDD.JCHFBAGH.UDGDSFAEFABC..XAEFhAAAaABHeFFBZDADHADAMIAGhADA..KFHDACHG.IHBHhAAAQGGHCGDHECABDFDB.OFFBcAGF.hAIA...WEBH.hACA...,1,-19,-21,2
SBGVIKODTeYEAPbNgJHWXRfLMCUaZFdcQ,...PCBAgGEDHADGRCFEMEAB.UEBEZEDEFDAHdBBHSDHDhAAABBHBGGAFIBFHhABADGGCeHFG.AABB.NADHJDDAhACA...fBHECDEG.aGGC.hAAA......hACA...,1,-10,-14,4
eWZdVbEgcfQBJADNaOSHUCGLPXMKITRFY,aGFHHFDCGABEXBACKADE.RAGH..FGHFeCFFZGACdBDGEGBD....hAAAfFCGQEAAhABAAIHADDDFSDFGhACACHDHLAHDMCIHIGGH.WAAF..hAGAgAEHcBEB.hBBA.BEGF.,2,-5,2,7
GIFfQCAYZaSNcJHbPTUKVWdMREgOLeXDB,aEDDSBBC..JBGBHCFG.bFBGPDCB..KFECdABBhAAAMEDCEEABLFFHhAEAeBDADACGBGHDFBDDCHAFAEIHNIBB.hAAA...cAGF......hABA......hAFA...,2,-31,-19,12
KONIQgbRUPFSMYACTdfaVcJZWXLHeBEGD,TECBdCFBaEBF...JHBAZCAG.LGBABADBECGDKFGG..OFEChAAAIBAF.QEEFhAAARAEFFCCBMBIBAHHBCAHHfCAEhABA..WFAFeEEEDICG..hABA......hACA...,1,-17,-32,15
SaXcZgCbGLFVUNfMKeHPAEQYJODRdITWB,QCFBJFAA.DIFCdFEF.TCCGBAHDSFGF.hAAAXDAHcABECFHAGACHhAAAFHDC.VDCGNAGG.hABAfBBGKAEF.PGAAECHBOHFAhACAWEHB.aHAA....hAFA...,1,-11,-28,17
SdLDJUYgTBGfQAMPFWNRHCacKEIeOVZXb,MCEDFGDFRDFG.HGAC.aHEGKHGA.EABF..eEACODBFXFGEhAAAdFGDLDADDCBGJABCUCFEhAEA...gAGEhAFABAHFfCCBAFFB.WBFG.CEED.hAAA......hABA...,1,-5,-36,31
ISRQVDFBgWeYUJOHXLbPdCKTNMEfcAZGa,aEGCSGGE.RABH.QFECFGDC.BAEGeAGDUDABJDFBOAEDhAAAHAAFbAGDdHADKGHDhAAAMIFGEGBA..fDDChACAZEBGIDADDGAB.......hADAWBHH....hABA...,1,-6,-23,17
WBKEJbSdRPLgVAUeHIGDCXaNTMYOFfcZQ,HBBGGAFECCHC.aHFAMFEBFABA.ZFFEBEBG.KEEFJHAG..dCCHRAFALFAGhAAAAFGC.eEEEhABADIDAXFBA.hACA.TDAEfCHC...WAADhAEA.SEHHhAFA...,1,-13,-41,28
UNPXELSFTBbMHYeKOJAdWZICcgVaQGRDf,dCGGZDBCCGAE..VACFQEGDDICE.UAFG..NBAE..EGGCSDADhAAA.TBCGhABABDHBMIFGHGEEeABChAIAOEDCAIDCcDFBaGBGfAGD.hBAAXAAF..hAEA...,2,-41,-7,34
JWUHCZIBeVRPDdgSENYcKaFLXGQAOMTbf,OFADTACD...JDCEHFEHZAAF.BDDBRFCH.dCGF.EFBH.NAAE.KAGEhACALHAGQADHhADAAEIHMBBH..fCGFhAFACAFEIHHHeFEGDEFCSCCDhABA..YHFGhBAA...,2,-34,-6,28
gcYKAQeDVWNCZOIafMJTEGBXHdLSFbPRU,eBCADGGF..VDADCBGAZEGB..ODGDaFDG..MABAEEDBGBCBhAAABHABHCDCdGAHFACGPHDChAAA...RDBH.UGDDhABA...........hAFA......hAGA...,2,-24,-23,1
JQWOMCdbHSUGDcfZETLXgeaKYIBRVFPNA,JGBAOAFA.dCDCSEEFDACF.ZACGLHCE.eBAFhAAAKBFHBFHGRCGBFGGEABDGMFFDhAAAHEDCUDADGEAAEAHD.hABA...XGGC...aDDB.hABA......hADA...,2,-30,-15,15
XVKTFJQSAPCNRYWOdMbULcfDHeEZBIaGg,CCDARCDHOFAAdGGD..UCADLACGDFGA.EBGBZAFGBHAHGFAD.hAAA.VGDGKABGFEEGSGGHhABA.PDAGhADA..NIEBMDFGcDGH..eHCCaBBC.hAEA......hAGA...,2,-30,-20,10
VBEGgYZFUTXDJCPRKdNfAcSHQMIWObLea,HBGDMCDA.OCCHLCABeFGDaHDGBGDDGFEBZDDFFGAGUDDBDCAHCGBG.hAAAKAACdAGF..AFHC.QABFhACA.IAEHhBAAbBEFEBCE.TCGD.....hADA......hAEA...,2,-22,-3,19
XTdCgaPMIBZUHESKfRJeOWQDFLYVNbAcG,XAECdDBHCGEC..aDGHMDIB.BDGHHBCCKGAEJFAF..OCBEhAAADBABFCHHLFFHhABA.NEEC.AAIBTGGGhAAA..IHHHEFBESAEEfDAEhACA.eFCH.WAFEhADA.YCFE.,1,-17,-30,13
cYaMTeSQCfXBOJdVUPAKgRDHbLWIFNEZG,KCCADDEBHFFGLEHBFCFBZFAAGAAH.aGCHMBAF..eECECCHC.hAAABFAAdBBG.UAEAAEBC.hABARCFC.IHEG.hAAAEHAEcGFB..SDCHfAHEhABA......hADA...,1,-20,-28,8
FOPUgEYLbeIZXABRTHJWdcaDQCfVMKSGN,TEFCJEAD..dDFAaBCGDGGH...QECGCEHEMEAAGGAFhAAAFHCA.OAFGUAEE.EEDChABALBACeCDGIHHBhACAAHFHBBHA.HBFC..fCAFhAAA.KHAA..SBBDhADA,1,5,-44,49
KJaNMGDeQIAVcgBHZUfObXPTCELYWFdSR,VEDFBCCFHFFG.UAFDOHEC..PBAHECGALAEChAAA.FDBDdFDEKBDFNIDHMGAEhAAADABGQGBGhAIA.IBBEADEHZCFEfEBH..hABAXGGA.CDEE.hBAAWBBE.,1,-11,-33,22
QHMcXKegCTbZWOAPSFDRUJYEdfINVBLGa,FGDBDDDBUEAFECGC..dBAH....NCIG.BAGCLHAAQFAGhAAAHADA.XDDEhABAeGDECBAH.TFGEZABDAEFASFFEhAAARBDA..fEBDIHHDaBHBhABAMDAC.cGFChACA...,2,-27,-16,11
UYFfPDAaKQTEWIOZJeCGgbNBcdRMSXHVL,aDBEKECAEHGE..OFEDeAECGBFG..gDGHhAAABHBCdACESEAHhAAAXBDEVFACUBACFBABfAHChABADICAAEFC.WFEHIHGH..CDDENDIEhAEAMAFG....hABA...,2,-30,-8,22
SYdRFAOeHVIcfbCDaKNGPgMEXUWZJQBTL,HBCDVGAG...fBFHDDCCKFDH.GFDBMBBC.UEAGZAFBBFHAhAAASDHH.dAAFhADAAGGDeDFAIHAACHHB.hABA.aGFHPHCE.EDFAJEAC..LAFChAEAYCAEFGHD..hBBA...,1,3,-29,32
OePXYbgUdaCKJFSVBDHTfLQWcNZRGEMIA,OGDCXGBB....bCFGdADG.KFEDFDDFBAHEHBBDLAADhACAQGAH.NACFRAFCMFFGhAFA.AGGCeCCB.hAAAPHEEYBAFgCEFaFGACHHF.JBHHSFFGhABADBEA..hAIAfGAE.,1,4,-14,18
dHQXEcabBZLIYFANgWRPKGDCOTUMfJeSV,...NBHC.gFAF.RFEEGAAFDBEGTFFDMDFE.JDDDSDBHhAAAdAFB.QFDEhABAEDAEaGCCBHEAhAAAZBBCIGABAGIF.WDDACHHD.OHAEhACA.fACHhAFA...,1,-9,-37,28
IFKTMVNCcHBDPESYGRWZJgXUdeLAbfOQa,OAADaAEC.KGHDTAAG..MFBACGAABFGDDEIH..EAEDSCDChAAAGDDFZFAAXAGHhACAeHDCAHAE..fCCDhAAAFDAFNEECHDFC...YFFF.hACA......hADA..WCCD,2,-27,-17,10
KbBeOQIWXZPCAfSJVEcYFHMDGLNUadRTg,JDCHVCFC..ECHBFDBBHBBCGFEBLAEGUABF.dEEC.RFFFKGACBAHChAAA.QAEBhACA.XEDCCABAADAFSDAHhAAAMIFADFAFNIAD........hAFA......hBAA...,1,-19,-20,1
NZUQIAYEKPJeabGDCVXTcdWFOLgHRBMfS,KGDBJFAH.eEEAGDBDDGAB...CADA...VACHTBAB.dAABFGGHhAAALCFHHAFFBEABhABASGHBZFBD.IHCBhADAADEA.EFBG.aHFGcCAF..hACA.WFHB.OBHDhAEAMAIDfCDB.,2,-18,-13,5
VNHPIfLGYROSFeQKdAWBUXDcCgEJaMZbT,UBBCXBBCCEBH...EEBDaGDFZAFE...TDFDVAEGHEFAhAAA..PFFHLHAEhABARCDHSACChAAAFEDGKCGAACABBHHEDEIHgGAD.MBAB.hACAIHDA..hABA...,2,-22,-15,7
caBRTSVfUNFJICXAPeHWOGDbKLEgZQYdM,eEDBHFAGODCGGEAAKCBCEFEEZCABdCFHMGFCBHDARAEE...SHGEhAAAfAADFDHFCHEHAFFChACADACCLADA.hABA......YAHHaEEA..hAEA......hAFA...,2,-24,-16,8
PcABZOEQbJGeVUdaFDSHfTgXRKCNMWIYL,BBDBZEAHQCDHJFAA.eAGFUABAFGGHHGFC..TBBBhAAARDDDCCHB.MABG.IGEBhAFALDFBAEIBOHCChAGAEHAG...bEEAdAGFaAHDDAADSBDEhBAAfHDB....hAEA...,2,-34,9,43
efRVEWJYNCbAMUDPQKOdFIZGgHLTcXaSB,UFEBDBDGKDCCOBDB..dHEFFAEEZCFCHBGHLFAF..TDAHhAAAXEFCBDFFRBAF.hAAAEHAC..JECFCFHFACADMABAhAFA..IFCF..cGGAhAGAeABD.fGBEhAHA...,1,-21,-33,12
dLJFXEZbOYacGeSIRUWKBPfNQgVHTADMC,CDDAdFABLECGFEHBZECD...OABHaCCEGGEHeAFG..RACEKCGDBCBFhAAA....NICB.gBGHhABAHEGFDHCEMEADhAAAEACB....cADF...IFEGhAFA...hACA..WHAG,2,-25,-22,3
JbCSLGfIgZBeATcFKDEVaMYROHUNXPQdW,FEHFDHBAEFCCMFFH..RBEEHFGHUBBH...XCADQFADJAAE.hAAASECALFAFGDDHhAEAIBEEBGFDhAFAAACDKHAAaBGAOAFG.PDEA.WDAGhAAA..CCCC...fGGAhABA,2,-21,-13,8
MFECDUILbVGBXZPHSQAYaWKcRfJNdgTeO,aDEBKFBCRADB....JDCFdFFG.eAAHFCGCCGHCDEFG.LCHBGACFBAHChAAAZGAA.HGAEAAAB.hACA....cGEBhABAfDAH.NEEG.OCAHMAFAIHHChADA....hBCAXBBGSCCH,2,-25,-19,6
QbgCcDdNUMPJEIeKXBAHTVWZFaYSRfLOG,VDBCFHFC..aADARAEELAAEGBCE..QDGECFEA.DCAFhAAAdHGBUAGAMCBEEEFBIHAGhAEAeFDHBGBHAEIDHCGDhAGA..ZCAD.fCED..hABA......hACA...,2,-22,-13,9
XMJePRfDLQAVYSgECbNGZTOHBdcaIFUKW,VADHSBED.EEGHCCACGEGC.OHBABHHHdHAD.IAAHhACAKDFBMCCDPEADhADADFDCABGA...bDBFNGAF.hAAAZGEG...cDEDaDADFABG...WAHHhAFAXAEF..hAHA...,1,-21,-28,7
XfFRAMdHYITBeEJCNaDZUQOPSVbGKLWgc,MFFCHCBGTEAHBGBC.eGFCJDDD...NAEH.aADEZFCG..QGDDhAAAOEFGSABBhAAAVBFD.KBHBgDADhABAfCEDAAGEIHHHCHBGDIFE.PCBAhACA.....hADA...,2,-23,-10,13
POWUIQEReXZaYfTSCgMbcGKAdFVLBDNHJ,dHEDLFGHDDHHHBFHOBHDUBBG..IAEDQGAA.eECBhAAAaEDF...fADDhABACACDbGCCGDAAKFEBADIBhACABAAF.NAGEPCCAEDEH..XGGBhAFA.....hADA...,1,-5,-25,20
BECAdgZQIGMPWDFfeXcRTbYSHaKUJVNLO,dDBDZDCBGEEBMFCBDBACeBEC.RGAG...TAEESDAAHFEHUAGChAAAVAAF.ODGDhABAEHEEAEEC.QBCHhACA.IDFHWAFEFGHDfEAEXCFA.hAAA......hACA...,1,-7,-10,3
QTdfHBXFWYRALMcDJUKbCEgNGeSOZaVIP,MBECJFCF.KGFCEBBEGBBH..OEAFaDGG...IEGDhAAAQGCAdDEEBACBhABAFGAGRDAAACABLAGHDAFGCHHGeEEGhAAASEHH.......hABA......hACA...,1,-20,-34,14
FgRCGYWKEQSNeZUcHfXIOaMbBAJPdTVLD,JFBHdBEALHDG.FDGGCEFDGEDAKEAF.EAFCQDBBhAAA.SGGEhABANCDFUAACHDAGXEECODHHhADAaAHDMFABBHADABIH.PBBEDDDE..gGGGhAEA..WADEhACA..,2,-23,-15,8
aDQPYAFcBUWfRJCGNIVgdbSXHMeOZLTKE,FBBBUADBREEFGAFG..NGCD...VFBFdBACSGAHhAAAHADDMEID.OEAGZDAEKGGBDEHFhABA...QAGDhACAAABEBAHG.fHDD.CEEAIHHFhAEA.XDFFhAGA.eCBG,2,-21,-11,10
QAdIXZLHMGNKCPWUEJBTOcSfDYFbegVaR,dAFCXGDELECAGCDBCAAB..UGBCBHAH.ODCBSGFDhACADADCFFFAeAHF.aBCGhADAABGGIAAG.hAEAMCBENEHEKCDHECAB........hACA......hAGA...,1,-25,-33,8
ZgfePJQcDOMIaWbHFETRXdYGUBSNKLACV,VACFZABG..eFFCQCGFDFDAMEDE..aAFGHAFF.EHECXGEFhAAAdCCFUFAESFFEhABALAADADHGCHCHfEAFhACA.cCDDIHHF..hACA.WHAAFGBB...hAEA...,2,-26,-10,16
KCQZJafARbPVDSUWBNdXIOGYeMcTHFLEg,RBEFVCFCDABG..UCCABEAD.dCAB..OFHDGEBA.MBDDHFAFhAAAFFEFEFFD..CGHH.ZAGHhAEAaAHFAEHC..SGDHhAFAXGFH..IAADeDGD....hACA...cBEBhADA...,1,-18,-33,15
SRNVfeOYPGHEXIaTWDMFgULJBQbCZAcKd,dCGCSDFHRCAH..VEEDeCBH.OHDEGACFHEDFEAAA.aAEChAAADFADMBIHFHAELCCBhAAABHHACHADAADFKBAF.fFAGhABAPHFE.IGGBWDHB...hADA......hAFA...,2,-18,-10,8
aDIZeBHWLEXgMAVTFQcGCKYNbfdJSUOPR,TEECFACBQDGD.GGAFKBDCNBCG.dHFF.UDCGOHEAaCED.hAAADEDDZAEEBBAH.HAGHhAAAEBADMGDGAGACCDDE.fEAFhABASEGE.RGACIDAF.hAEA......hAFA...,2,-21,-7,14
AJXOPSYILZeUcTfVERabMNDHGgdWCFQKB,XECGOFEG..SEGELGDGeAHFUDBH...cGAHhAAAVADBEGGH.aAAANIEHDACGhABAHAGFGAEE.hADAdBCEWGBGCFFCKEGEAAGD........hAGA......hAHA...,1,-12,-17,5
eWcPTOEADSIKLfMXVZbFGCaRJdYHBNgQU,DHGCSDEFLEEAMACFZFAHFDBA.GAEGCAHHRFAC..dDBHBABDhAAAQGDA.eBAFhAAAPAHBEGGFACHCIGDFhACAfAFE.XDFAaGED...hADA......hAEA...,2,-33,-11,22
QcJZRfVXbMALUDOIKFGPaWdYHENeTCgBS,DFBEODFFKGBCGAAA..aBBFdHBDEAFHeDCECCHB.BEHF..hAAASFDGJADE.hACAZDAGVGECXFADhAAAAIHELAHBFADBPHEE.YEHHNDAG.hADA......hBAA...,2,-22,-18,4
fUDYgBbHNLZQCOFKEWVTaMdcJGIXeAPSR,SCDGUBBEDIEEBFFHHEFB.LBCFZEAB.QAGFhAAACCGC.KCABEAGEVFBFMEHFhAAAdAEGGADCIEEDhABAACAC.PHDC..fFDE.hACAbFBD.....hADA...,1,-3,-36,33
PMKQAVTNcUfHSGFCdLBYbWIaJZgDeRXOE,TABGUBCHHFBE.SGGFGAEFCHEFBHGC..bEEFICDHhAAAJAAHZDAC.DIAAXBFChABAOCHH..MEAGhABAAHHDNIBF.FFCCdDHALFFGaFAH.gFADhADA.....hACA...,2,-10,-8,2
cQHNVWGRSKEdIAZXBOTYDJaLgMPFbCeUf,ZFFEXABHBGAFOAABDDBB..LCFGMBHD.FFHD.CEDFeGAAhAAAUDBGQBEHhABAHFEFVAFC.RGBEEFDCACEH..hACA.JHFGaEAH.PEFGfBCH.NAIESEEEhADAIADA.hABA...,1,-10,-16,6
bXfDCNYRILdOgKGEAZWPMJaUQHcTeSBVF,ZCGFMAACUACEHADE.eEEHBFFEFFCG..XFBBCDDARBFA.LHBGhAAAdHFBKHAEAAFC.JDHHaAFGhABA...QCEHhAIASBBFfGHADCCH...YBBFhBAA...hAHA...,1,-20,-23,3
UKVAdRXHIJBcaTOPMbZWYSEDNCefQgLGF,RAAGHDBCBHDAaFEG.OGDEMADEZDEH..SGBBEFBG.NBIA.hAAACDHAQCAChAAAGBCDUGGAABGGdHAHXBABhABAJDDF.PAFG.WCADDHGEfBHAhACAFDGF.IFHGhAHA...,2,-30,12,42
SWYMPcAVZFCKQHILfJNGbEOegRXDdTUaB,VGBGFHCCCADC..HFGDLABG..fAFGJBFDGCAGECAGeFFDhAAA.REGF.DFEAdAHEUEBChAAABCDFSBAEhABAMDEDAHIB.ZDFA.IAHF....hACA......hAGA...,1,-12,-24,12
GdbHBZFRVLAOJgCYaXNPeQfUIMDWEKcTS,JDAGCFBB..aCBE..XCFHeFDD.UGBEMBED.DEABKFFH..hAAASFHFdABDBEDCFHGEhACALEFBAAFE.gAABhACA.PHACfBHEEBGF.hADA......hAEA...,2,-45,-30,15
NeRVWUCSfKaLbAETDQPOdBGgcFZIMJYHX,EBCETEBADAIB...OADFBEGBGEEE.FAEEZEFG.IABAhAAAMEDBHAAFXAGFhADANDAG.eDCGRCDC.UGGGhAFACHGASHBGfGDGaGHFAIBE....hAAA......hACA...,2,-18,-11,7
aEFUGSYgBdMQVTPCIeOWAbKRfcLJDZHNX,RGBALCBBZCGDHBAEXFGBFCDDGADF..SADHBHHHMDFFhAAATCGA.PFFBhAAAIGGF..OCABhABAAGAEKDAD.fGCCDIEG.aDDE.EAGAhACA.gGAFhADA...,1,-19,-20,1
AcYdgGZLbQUNVTfIDEBJaKSCPeRXOFWHM,dCCAGECGLHFGUDAC...TADAIHBHBEFEKBGGCGGBRGBCFGFFHCFChAAAAACF.....hAAAgDADbBBE.hABAQAGHNEICDAEEaEEC.SGAF.hADA......hAHA...,1,-7,-27,20
RMSXBbcUZdTHGWAYKeaNEJfVFQOPCDLIg,eCBEaBCH.EGAG..JGBGFDAB..QBDAOFDECACH.LEFEhAAARBFG.XGFChABABHAGbGFEUAFGZDFATEBAhAAAWCAFAIHC...NIDH.fDBE.DICGhACA...MAIF.hABA...,2,-18,-12,6
BGfFMbWgCEVSUDOPJKeTYZAINLcQHXdRa,LCBDQEGHHGDCRDBDBFEHGDGA.FEDF.MAACbACCCHDCEAEHUAGAhAAADIAG...OFAHhABAKBGDeGAC..TDDBhADAAHIDcAGAaDGAfHGHWDCE..hAEASBBE.hAFA...,1,-1,-19,18
YVWZGREFeaHMLPJBAONUdKDXCbcSgfTIQ,OAEAUBEGKGAHDBDE..CFFD...SDEE..TAAHhAAAIHBDQDCGhACAVEEBGBAGFHGCeEHBhADAMCFGJHCGAHIFdDHC.bECBfCGB.hAAAWAEE....hAIA...,1,-15,-38,23
aOPLFRBSWKIDZYTQXJGdcUEVfMegNbCHA,OEBDFFECBHCAKEGEDCACZBCH....QBFGJAEFGGDFdFAFUAGDhAAA..EDGAMABFhACAeBDB...NEIG.CDAGaFAHhADALABC..SHGAIHGDTGADhAAAcEFC...hAFA...,2,-29,-25,4
NLXSUdWJRGABbOafZQKIYePgECFcMHVDT,BBFDaADAZEFHQDEB..KAHFIGAGeABGEGAE.CCCD.FFGFhAAAHEDHDEIFLCDFhABA.SDAHhACAWBDA.JHBGAHDFfAAGPHEEMAIDNEIEXDGFhAGARABC..OAEAhBAA.,1,-15,-19,4
HgDeKPSRWcCUTfNLVbaOYJFMIZdXQEBAG,GCEHDCEGKBGE.SCBCRDCG.CAGAUFAATABDLAAC.hAAAaECFOFBD.FFGBhABAIFGGdGDHEAECBDABhADAAFEE..eHEEWDFEcAEB.NIBB..hAEA......hAHA...,1,-12,-36,24
MTGFWNXUJZPACEcbRBSfIKYLedQaODHVg,CAACEGBDRBBC.BEFC..SCGCKCEELAAEdHBF.QGFFhAEADFDCHDAF.MFIBFGHB.XGDDhAFAZAEBAEIB..fEGAhACAeCDDOBBFTGEANAHC.....hAGA......hAIA...,2,-23,-19,4
bLKVdGQWRUNFBOSYEAfTCIMZeaPgJHXDc,TDDHCAAHZAFC..eEAEaDGG....JCBEHACBDABE.LGDEhAAA.dGAEGFDDQDEDhACARAEBNEIABBHCSFHDhAEAABCCMICE.gCGBXEAGKGAG..hAAA......hAEA...,2,-22,-5,17
CPcRAUQDLVWFTGgeaJXMIZOYNdEBSHKbf,QDDBVFDF.FGDBTBDFGDFCeACCJAFC...MAHBIEAGhAAAZFFBOFBF.hABANAGC.EABFBBAASADBhAIAKDDDCHHC.PFBFACCDDDIF.WFHH...hAAA..aCCB...hABA...,1,-7,-17,10
GKACMFgNBWdPJUfbETXDIeHOaRVQcSYZL,FFGBBCFFdGAFUGBH..EGDFDBCEHBCCRCAE.QDAG.SAAEhADAZGEEKEFDCAFB.MCIHhAEA...NDFG.JAHDhAAAfDDE......bEAGhABAIDGFaEGA..hAFA...,1,-23,-46,23
QXMHBVZYKdFEOWaAJUgIDfeTRcNPSLbGC,UFEADGAEeABHRACE......PFABSEGELDFCbCEGGGBDhAAACGCD.QAEAhABAMAEEBEGBVFFGhADAKCCDFBABEAHDOEACAICCIHHD...fBFFhAAA..hABA.cDCD.,2,-26,-1,25
OPFBSJfEdUKTNRaCQgADcIWZYHVGbeLMX,DFDG..IAFAZEADHGCCGDFCLAECMDADXCFF.hAAAFBCBJBHBdGGDKEBG.NBEACHAChABAAEDG....YAADhACAbGCE..PBBHBFGE.EHGC...hADA......hAIA...,2,-25,-16,9
VXaeERTbDFIfPLBHSNdgYOQAZcCKJWUMG,ZDFGKBGAUGFHMAFGGEAB..VBCDXGDE..EEAHTCCEhAAADFCEFDHF..fGBEhABALACCSBAFhAAAdGGHYBECAFFCCGDH..aCAFeHAE.hACA......hADA...,1,-15,-28,13
RBcSCTbdJWPNFfUKEQAXMLIHDZGOYVega,MBBHLDFHDFGGZFBAOEDF..eDECaGCHBFHDCBHD..TAEChAAAdBAAJBEE....hAAANADC.FFAGKHEGACDB.XGAGhABAIACC.....YHEGhABAgGGDSDHBhAEAWCCD...,1,-23,-39,16
ZYRfWGVaedTBLSDCKcAIbgPQFUOMNXHJE,..IEHDbDAC..QEEEFFDGUBCE.MIEGHGBAZBFERAFDGAAEhAAAaBCFdHBHLEHFhAAACHHBAFGD.gBABhABAOHDEXCEDEFBEfAGFeAHBSEAAhACADGAB....hADA...,2,-8,11,19
KMDLJUSYEPOAGcFRZagCIdVfTbWQNeBHX,FBGCZFEFaCGCCHHF..dBEE..TDAGQABBBDCBKGABDGABUEFBhAAAEEGG..AAGB.GECEhACARABE..IHHDhAAA.VFCHfEAGNAFC..XBAGhABA.....hAEA...,2,-38,-8,30
aFJHAfMXSgBDETKdcLORWGYeCbINQVPZU,XEAESBBHBGCAEECH...dEEBOFFCGBEHeHFGCHGG.IDGBhAAAQAAHZADFaHBAhABAFGGAAGAH.MIACDGAHcAFBhACALDACYEED...NBIE.hAFA......hAIA...,2,-20,-16,4
dZLVJfYAeUWbQPHgEXFGIKSBNMCDRTOac,UEAAQGECHBAGECHDGBDG.KCBDBDEDCDHD.DAFFOHACdGFBLFDFhAAAJAAA.AGED.eADEhAGA...WAHBhBAAbCFD.....XDFHIHAGSFCBhBHAMFIFaADF.cGGAhCAA..,2,-28,-14,14
GdAcagLOYKWIbRVSJXUMCQfBeNTZEHPDF,aAGFLBDA.KCAGIBACRFFB..JEDFUGFC.MECHCFBABAFChAAAeEFE.ZFAHEDHBDDDDhAAAdHBFAAED...ODDGhABAWBDG...SACFfGDDNEAE..hABA......hACA...,2,-35,-32,3
OMNQCIeREdXaGLWFcSVKTAYfDbJBHPUgZ,DIFABFFDUBFGOHFC..QDCBCDAF.REFC.EBEDdFABXDBEhAAALHAG.FGHFSDHFhABAKBHH.AEEFfAGDhACAHAAEPFEBgGBEMADC.hAAAIBCG.aCFDhADA...,1,-7,-47,40
cDPCVbaKIfOHUAWFdgTeZJMQEYLBNXGSR,FCGCdGBGeCEEMGAG.EEDEBDEH.GBAARABEDDAH...CACB.aEHBKEHD.hAAA.OFDHAHAH..hABATAEFJAHHQGFGhADALFFHSDDF...PHBAhAAA.IHHHhABA..,1,-24,-25,1
ZVSPAGEUCYDKeMJgBOLcQIbWRHfXdTNaF,ECGBCGEEDGIBKGFC...eACDMEFEBEEDLDCD..IAGEhAAARABEHGAEdAFEaADEFEAESDEChAAAAEIBGECEJBAF.hABAOFFG.........hADA......hAEA...,2,-32,-22,10
GPBYaNXCSZDcTVMOJgQdIeKELARWbHfUF,RFABHFACUEDEGADBBCAA.aHGA..CCDH.DDAH.TDEEOAEFQCBHhAAA.IFGBhABAEHEGAGHH..fDHEhAAAFHDCNCIA.XBBBSACC..hAGA..ZCFB.MAIFhABA.dEABKHAG,2,-36,7,43
HLcOTAfGIdSXgMJZBPYbDFaUWeQNEVKCR,GCBGdBDHSDHDMAFFZFFEBHGD..bAGFDGDF.FDFHUABDQCAGhAAAEEDH.CAGFLABChAFAOEAHAHEBIEGFhAAA....gEDD.hACAYBHHWADH..hAIA...,1,-12,-39,27
OFbCMHUTVcedAQgIRDKfGWBEYaSZPLXJN,QCFDRFCEDAHDGBBEECBA....SAEGPFADLGEChAAAXGGCOFCF.hAAAFAFBCEEDMICA.TGADhABAcABBAACGIFHBKADHfEDBBDHEaDEAhAFANIED.....hABA...,2,-20,-17,3
HgRKfIcVbSBATeUGQPEFDNJMdWaYCXZOL,eFDGQGABEGDBDCCAJCFF..dAGH..aBDFCBAEZDAGLCBDHCGHKHAAhAAA..IABGhAAAbGFE.BGGHADBE.TDCHhADAPACCFDHFMCFDWHFAXFAAOAFC.hAEA.fHCFhAFA...,1,-2,-26,24
JGXQRZLHdPecOIAMEaFCTbVKBfNgYUSDW,EGDBaHEG.FECE..CDDE...VBFGKGBFBAEE....gADChAAAUDFGDBBFJACDQFGFhABALFCHPHAEhACA.eDDEIAGCACBDMDAD..bBFA.hADA.YHFASHGAhAAAWBBB.,1,-24,-41,17
bGKEHSZIdRgfLMTFQJcCUAOPWYXBVNaeD,ODGF..WCCHBDDC.aCBGDEFEGGDFHBFAZGAC.dDABfAGAhAAAMIEG.FFBAhABAJABCCCEB.AHFA..XFFEhAAAeADCKEEA.SCHBREDHLAFC..hAEA......hBAA...,2,-22,-18,4
gRaSDVBNCKeAJEFPGQYOXfcdbHTZLWUIM,FBFCQDDEOEFF...XFAHdDAAHACBLFGHUGDEMAIFhAAAaBCGSFCBhAAABABBKDED.ADAFPAFE.hAEAYCECfHGHTGECIHAEDIAGCABC.hADAEDHD...cEBDhAFA..,2,-20,-16,4
cKdPHAVeMGETWXBIOSYFaRLNfUDgbCQJZ,eFHFMEAEGBGCEDAD..XDGBOFACFFGHLECDUFDGDBBBhAAACACDJFEHKHAGHAAF.TAFAhAAABCDGSAFDhABA.aACEfHAD.QCDBhADA...hACA...,1,0,-28,28
FGUZISHbLPBafTMRYgdJXcWNEVKOQDCeA,GEBFZBFEHGAELDCCBDCGaHGGTGDG.MBDCRDFBdEHA.JBAHXAGHhAAA.NEAGKGHFhABAOAEG.CEDAeAAEhADAABCBICAA.SFGCfHDH..hAIA......hBBA...,1,-8,-22,14
WCaKDJcLfSBeMVAUZEYPRdIbOgGXTQHNF,UGBHEBAHREFE.dGHA..OCEBGABC..TDBDHEEBFAGA.aAFHhAAADIAALEAABAAFMBDAhACAAADD.ZFAG.IHEEhADAbCGD.QGGFNBEGCBAC.KCHF..hAEA......hAFA...,1,-8,-19,11
YBbFPdWUHTAMLJRXCDQfaeENSKZGgOcIV,JCAFCBFDDEEC..QDED..eECBSBGDZBACOGFGhAAAIHHEBFABFAGCdDCCUGABhAAAAHFFLCHDRABCaEHHKFFDhABA...........hABA......hACA...,1,-17,-47,30
NWLceFIgDCbUXGJVaTBOMSKZdPAHEfRQY,EFACQEGD..NAICLCDFeBCHFEAHDBIHUFGGGBEC.hAAAaBAGBHBE.MADEhABASADBdCABAIGCHCEChACAfHAHRFEF.cGCACHAGbAEA....hAAA......hABA...,1,-3,-28,25
ZabfQYGLHREMUKOCecDIXPgTBdFNWAVSJ,VCBCZEECaECH..QFEHLBBARAFGMHAGKABC....CHDADGIFhAAAICGG.PACChAAABEAAFDFC.ACIH.SECAhABAJHAG.fAFB.YCAFhACAEGGDODBAeFHHhAHA.cDGE.,1,-12,-26,14
UMFcZLSWBAbfdVCJYIXRQPaDeEGNOKHTg,dCGHCEHF.JEEA..XEBBRFCH..aACHeDFH.GGCFKCDAHFADhAAATABHUGGAMIFChAAAFBAD.ZAFALAEGhABABCDEAGGGfGAC....IHEDhADADAGEEBABODAHhABA...,2,-21,-16,5
VOAQRBMTXgLJFfHeGKcdbEISCUDZWNPaY,QCGGBFDFMACA...TCEDXBGAJBAAHGACeHECKCFFdECH.hAAAECCFIGGE.hAAACADHDGFHWHAG.NBDH.aAFEhABA.ODAFAIGCLFFC.FBAE...hACA..fGABhABA..,2,-15,-15,0
aKeUVMGJEcWSQIDAXfLFPdbBRYgTCNZHO,LFCEFDCFdBCBBEFGRBCC..TDAFCHDG.ZGBCODADKGGG..UAGEhAAAMAGH..EDEGSEEDhAAADDGGAABB..hABAfEGC..PBHH..hACAYACEgGGAhADA...,1,-18,-52,34
XCFSKbAYcQBgEJTVdIOPRfUZHNMDGeWLa,QEFFBDFEJFBG.dDAD.OECDRAEGUCBHHBBC.DFBHeHFCaGED.hAAAFACBKHGC..ADHB..hABA...YCHHhACAEHAA.IAGEfAAAMAFFLFFChAAA.CEADSCEFhAEA.,1,-7,-37,30
ARbSKCQgdPXeHVWcUDIMfNZTYEGOFaBJL,SCDEKAEGCABA.dEAAeCECHABH.VEDAUGEC.MDIFZEBBEAFAhAAAFEFA.BHFDLDCHhAAAAGHG.QGAChABAXDGBDIBG.IHHCfDAA...hABA......hADA...,1,-15,-28,13
bBJKZRFUfHLNTdWXSMcACODeIYVPGaQEg,CHDHeCED..VAGBGAEB.aFGEQFGGEHFEBBAD.KFEGFEACUFAHhAAALDCHdDBFSABAhABA.ABFBOCEHhACAICHF.YHAA...PAAAhAEA....hAFA...,1,-24,-26,2
HGLEPQNZRbOTMSfacAdDVXYWCBgUIFJKe,dEBBVAEG..XACFCCCD.BCHBUGDCFAEDeDEGGEEFLEAGhAAAEGBG.QGGDhABARAAFOHDC.MBBF.fCGFhACAcAGGAHHFDDDEWFFE...JHAGKGAFhAAA......hAGA...,2,-19,-7,12
IYROLMGXZPSbaFAJQDTNUdBCWEefVgHKc,JHAGQEBH.DCHFUEAFdDBFBAHEEAHH..eBGD..VFEEhAAAKFDB...IBBGhABARBBEMABEZGFC.SBEHhAAAFAFCAEEACGCDfACB..cEEAhAFA..OEHFhAEA..,2,-34,-28,6
LgfRZXJHOebVWGUacDPdIMEYNKCQFASTB,SDGELHAERBGDZABDHABH.OGBGeADA..VFEAUDDBDIGCdHGDhAAA.MIBEEEAGKDCGFBFCAFHFhABABAAGXDAH.hABAbADB..WEHH..aAGAIDFDhAEACGEH......hAHA...,1,3,-21,24
IXQMCOLSAcWKNEPFGYDaJUgZTeBHdVfbR,KEEFEBDEFCFEDGBA..UGGEZDCABAFC.dHGD..VBAERAAF..QGBAhAAAMAHHLEAEhAAASFGAAHEH..hACANAGC.PEAB..aADF.....hADA......hAEA...,2,-40,-27,13
CGBZAHJeKMNIdFWUQEbLDYXTPOcVRgfaS,eCCDKEAEMACHdBDEFGFD..QGDAEDAFLCFADEEG..XBDHhAAATGBB..PBFGhAAAVAGDRFAA..fABAhABACFHBBFFEADID.JEFAIHGA.WADChABA......hAIA...,1,-12,-30,18
SLOgEaTVWYXNGDHeABfUZbcMIKRFCPJdQ,UCGHZFFBMEIFKGBD.RFCG.FFGH..CCDH.dBEGLCAH..OAAHhABAECFG..aAAATDBAhACA...VFCGhADAXGAD.DEFEAHFFfAFBIAGA.hADA......hAEA...,2,-35,-35,0
cgaAMWCEGHRIJUDLFQBSfZXKbOPTNVedY,CAHCEECAHGBARBAE.UCDFFDABBHBEZFFC..KEGAOFEE..TABAhAAAeFHHdDGF...hABA.gAEEhADAAABAMCECIHFADIEASDGCfAGHXECEhAGA.....hAAA...,1,-14,-38,24
KBaGTHPIfZNMdAFUgYJcCVLDeWbSRQOEX,UCGEJBAE.CAFH.DFED..eECH..SDFCREAH.EDABBFHDhAAAGEBETBBBHGFChAAA..fCEDhABAMIDGAEDEFAGE..cFEAWFFCOBDC.hACAaGAHIAHG.hABANIDD...,2,-31,-26,5
UcCFedZRXaEPWVLDHIgOYbBQAJTGMNfSK,JECGTGGFGCEF..MCBA..SCADUGACFACCeCDAhAAAdHCBRGFCEAFF..WFEBhABADFGAHAAC.IHAAhAAAOCHBBAHHACDBfFADCEAEaDEE...hAEA......hAFA...,1,-15,-27,12
UaWTRgECdOANVFZBXYHKQIJDScfbLGMeP,FAEDBGEGHEFAKEFF.QCAFDCID.SHAA..fGAHhAAALAACMGAGhAEAUGGCTDAAgBFHhAGAEBAFdCDGAIEEZEDBXAFAIHGB..bFCHhABA..eBHH.aDCDhAHACCFG...,1,-3,-30,27
TSIJWFPBNKRgfcXDEYbaOUQeGAHLMdZVC,MCEAZCCDCAGH...SFBFJFEE.FCAABHHHREGB....fADChAAADEAEEBFB.aGEFhABAOFAFUDDHeAFGhACAAEEBdAAD...IHDA..NAIEKADEXDAChADA..YHEEhABA.,1,-9,-54,45
FVLZdSgfMRJAQCOGeBUEcHbTNIWKYaPDX,CDDGOBBFBAEH.UEFGHDFB....TBEDNECA..KBAEaHCEDBGAhAAAFDDBZDAB..SAGBhAAAMFIB.RFAFABAFeADDhABAEGHH...IDHHWCHH.XFDChACA.....hABA...,1,-28,-32,4
TfcIYBARbPZgMVHeaWJLKDUOFCQSdNGEX,RCCAZEDEMCFAeABE...JBEDKGEF.OFGHCGGF.dEBEECCD..XABChAAATGBA...hAAAIHAGAEHA..hACAPAHFHDGHLAEADEAF.FEEFNBBGcGDDhAEABFAC....hAFA...,1,-9,-37,28
baNBfYXPVCcgMAKUQEITSJDFedGOHWLZR,KECEEEFH...TBABDCCAdGCAHADGLDBCZFEBaEAFBAFD.XGGBhAAACHHCMHBE..AEFAUAGEhAAAIABD.JCFEFCDChABA.eEGHOEAE.....WFEDhADA......hAEA...,1,-7,-38,31
OPERdbLXSKCGVINYHJTQeDWafAZUBFgcM,UDAEFEGFMCIFEFCC..dFFHLBAA.KGBCCHEBGBCH..hAAAVAEFIACE.hAAAHAGDTFEFeDDADDDDhABAaGAHAAHFBDAGOCHDPHCE....hACA......hADA...,1,-10,-32,22
fTBKMgQbHROLdYIUSaVDJFPXEcWANGCZe,CEHBeDCHBHCEMBAA..QAGAHGCGRBEHdGGEUEDGaFAH..JCAGXDAHhAAA.EFHDABIHNAABhAFAGBCDZBGH.KABAOEFChAGA..YFFB.SGAHhABADIAG....hADA...,2,-30,-1,29
CRHTZSMNOefEGbLdQcAWDPKFUaYIXVgJB,DCGBFHAEUEGD..IBDA..XDAFJCACBAHFCCGGRBCEHFCHhAAA.ZFFCMACAeADEhABAEHGGLHEC.hAAA.dAGHAHCDKGAFaFDG........hACA......hAGA...,1,-29,-33,4
EWYOSdgeJPXVZDHGMCARbFfUNKBLTaQIc,FDGHUGDBBDBBLCAA.QEAGIEAG.EEEGOFDC.hAAAdBCDJCHF..PHCChAAAXAFF.DGIH.hABAMBBAADEDfGHCKCEGaGGB...cAGFhACA.SFAAhADA..,2,-35,-25,10
BJNKUXaZSEFWcDbeOYVQRgPCLMIdHAfGT,TGGDBEEDKDCC.UAAEZEABFDEC..DGIFeAAA.OFFBQFBFhADARAEG.CEGGLHEAhAEAICCHABIHGBEHhAFAXFCBEAGG...bCGD......hAAA......hABA...,1,-21,-30,9
QRTIbCVFeDLGUPXAHYONSaWJfMgEBdcKZ,OBAGaDHH..JCCDMCCCBFAEdDAA.KGDDQEDD.RAEF.hAAAIHFB.bFEAhAAAFHGE.eGFCDFEGUGAHhABAAHBENABA.SCEA.fAEDhACAEGDHcAGECDDG....hACA...,1,-20,-34,14
IBCXMOHKGPgSFTUdbeafWYZREcQJLDAVN,VGEABCDDMFCF.HBEGKDCGGAAD.SEFAUGFAdDAEaABFhAAA..fCFBhAAAZEEEEGAD.JAECAAEBCHDFPHAAhABA.FDAG........hADA......hAHA...,1,-22,-28,6
KUYXBZTWgODSEJbVHCLdReMIaAPfQFcGN,QDGFFFEFGAABUAFGBBFDZBBG..TDAAODBD.SFFDhAAAJDDA.bGACCGGELHBAhAAA.dDGAhABA.MFIDAEACfEDHKFBH.WACCDAIB.hADAEHGC.....hAEA...,2,-21,-16,5
YDLGKcQRMOabWEXdfUJFSTBZPIAeHCgVN,CGHAVFDADDFH..LAAGGEAEKAFD.RBBF.MDGD..OHFChAAAaGCG.ECFAdECD.JEADSABFhADABCDD.IDDDhAEAADHGHAEENIABYDHD....hAGAcCAB...hAHA...,2,-32,-21,11
NYVGBFALIHgdcRWeCDUabTEfPJMOKSXZQ,LDCAHFFHdAGHRDDBeHFGCHEG.UGCE..aBDATEFD.EBEFPDAHhAAA..MBAChAAASBBDXEBCNDIC.hABAYCAEBCFHAICAIHAAWFAD.DECFfCHGhABA.OAEAhACAKDGH,1,-21,-27,6
GCKXFbDeAdBcQgMVJHTPNUaEOLfYWRZIS,BBCAQEGGMEEAHFBB..PBDCaDADLFFD..hAAAfAAERAGHSAEChABAKDADFEDHDGGGAHIFdHAD.hACAgBGBJEDF.TFAD.NACAEGHHhABAOCDCYFEB.hADA...,2,-19,-5,14
aAbEDTJUNHMeCXZgIGOQFPYWVSLcdKRfB,DBEHUAACMCADCCGG.ZEEBGGBH..OBBBQEGEFHGE..hADA...PBEFhAEAYCHDSDBBhAFA.dAGBKFBE.BAHHAIHCEEEDNAAHXGAChAFA.IDCG.hBAA...,2,-34,-25,9
LeGbZIAgFdaUYEQKPDSMTJOXCfcRVWBHN,dCFGUEDHEDBEQADC.KABHDAEE.MIDAOHBGCEHA.REGBBAAChAFALGBCGCEHbAAC.hABAAHIBFDBB..PDABhACASAGB....XDDHhADA.fFGGhAHA...,2,-36,-19,17
PaOBLGADeEVTNXdKWRgHbYcQJfIMFUZCS,DCBFeCFAEAFE..TFBBdEDFKEHD..REFHHBBG..bCFFQAFGhAAA.fABFhABAFCCECBACPHAAaEAGBEHEhAEAAADC..XEBDWHAAYFEFhAHAJHDGIHHH.MAIDhAAA..SEDC,2,-35,6,41
VeKAWabZFOHdXcRDUGJfMgYBLTQNICPSE,aAEEFCBEdFBH.RAFF.GCFA.MCIFBGEDQCAACHAD.SFGHhAAAeACAAGGDZEFCXDDBhABADAAB...hABAUFAEJBHD.YHDA..NIEH.EACDKCEDhACAOFCC...hADA...,1,3,-37,40
AfOEaYGXIZRFbBHVLcUSNQPCgJWeTDdMK,EBCDaGFGGBCGZDGH.FEAGHDBE.LABESGHHQAGFhAAACBBF.JFDCTCFBhAAADBFFMIDEAFEEOHAGXGCGhAFAIEHEBHAH.cBGF...NGADPADGhABA...hAHA...,2,-11,-10,1
ORMTCWZEGJBDUcgdbNfPeYFaLSIQKVXHA,MADFCFBEZFECGCBFDFAB..UFDGdAAB.....fGGChAAAPHACFAFGaHAE.LBGHhABAIEHFKCFDXBGAhADAAAEFOCBB..WHDE..BECCcDFGhAEANEIE.....hACA...,2,-32,-23,9
DOXSCVcdNUHYARQEfWbIPTLaGFJMBgZKe,EABB..fCDF..ICFCPDFALFEFhAAAaGAAFEDCMBHDBBAFKDBBOFGBhABASEGACDAEVFBDNIBDUGGChAAAAEAFQAGD.WFHHbACB..JAEGhAIAeBCF.DGAF..hACA...,1,-10,-13,3
cBUVAbgMXDGWZOPLHaQEdICfeJNRKFSTY,MABDDABDZGDGLBHDHDGHECEECEFD...eDCBRACAFBFD..SEEGhAAATFAE.BHAEAFHH.hAAAgAGCXGEGOECFhACAPACFdFADIHHEfAEHKDAFUCCFhADA.....hACA...,1,-8,-15,7
AaeFXKMGVSLEJbWTUCcPdfBOIHYRNZgDQ,eGFAFHCCMAFHGBDCLGECEGCG..JDFB..TABBUDACCAHDdEBGhAAABBCAHECE.NBIEDDCEhABAABADaCHD..KGAF.SADHhADA.WEEEcAEF.fAADhACA.IGAChADA.,2,-38,-8,30
aEOLeNfCMFgWcJHIXQSKdVDZYTGBPAbRU,UEGBOEABeFAG..CFECFADB..gAGBJHFG.HABFhAAAXCECQDDHhABAdBADDEIHTAEF.BDHFhADAbFCH.EHGCLBGHMIAC.IFGGhAAAVGDG......hABA...,1,10,-38,48
HMJRCaIgLEbXWVFcBGTASUQfePYZNdOKD,SEFCUABAeFGBZFCEODAAHBGF.MICERGCCCEDF....aBEBLDBChAAA.XCEBhAEAFGGHBGACAAHAfEBFhAFANACBDBIF.IGAGEBBE...WFHBhAGAcFGF.TBFGhAAA..,2,-29,-18,11
aENCAUGJWBIXKgLZHQPbdceFVODfMSRTY,JGAGBACH.KAHBLGEAZFGHHAEBQAFA.dBAEFBACDDDEMEBChAAARDFF.aGBEEEBAAHEA.UACBhAAA....IFEDhABA...XCGH.bEAChACA......hAEA...,1,-26,-33,7
ICSEaVZMQBJLGWPNcFbATDHKgdYfUOeRX,DCCBHAAFdBGEUGBBRGCA.CAFC...aBAHZDFDBFAFJDCG..LFEFhAAAGDDF.....PAHFhACAFGADAAEEKGHH..hAAAfHGHeBBEIFCAEADDMEAF..hAEA....WFGDhABA...,2,-40,-12,28
GTfIEZaUbcdQYWMBDeHPXgKCVSRFLNOJA,TCFBEFGFUCGG..dFAEQFDFMFIBeDAAHACF..gAGEhAAAKHBASFBFhAAALBCENEADAABA.ICAFhABAaAGE.cEFDBBBCDGAHCEDEFHCC..OFHDhAEA.....hACA...,2,-14,-7,7
cFaXgeSJTMZEOLYBQDAKHNPRGbICdfUWV,HEAGRADCGDGGCBBCdHDBUDAA..VADFFEDG...aBGDXGEEhAAA.eBAGSFGHhAAAMHAC.EFDC.ODEChABABCGCABIBKGAHNIAF.IDAF...fCCGhACA..hADAWFCA.,1,-11,-29,18
YQKUFVTRdfWgbMJDSaOHCLBENGAceXPZI,XACHZAADQDGGUGGC.FHAE..VEBDRDCDdFAB....fDHEhAAAbBEH.MFFHhABADGHDOAEACAEB.hACABAHHEAGBACBFPFFHIDEHTACG..hAAA..WHAA.SAHBhBAA,1,-19,-20,1
WfKJUCYNIDZbdLRXQVAcaOgePBMHESGFT,OHDCeDFFMCBEHCAAGGABFDEH..TGGCKAGGCAEA...IGBAhAAADDBAdEAHRDGF.QGGFhAAAAACGaGDABDHFSEDBhABAJAGD..NBAFbEAG.....hACA......hADA...,1,-12,-19,7
EPRNeQAVFdILHXbUgZTcKOCMWBJDGSfaY,FFGGdGBBHCFFUCGAZAEHTABF..OEBHCHHCBCDBGCDG..hAAAaAABECAGRDAG..NICH.AGIH.hABALAHFXABE.hADA...cEECMIAGWFFDSFAFhAEAfAGB...hAFA...,2,-20,-17,3
IcFZDXCMQGfSBEeAWaLYgTUJPbOVRdNHK,aGBBLDFC.TAFBJDFD..OAAGVGFG.dBFDHACBKHEGFEDBhAEAXEBG.MEADhAAAGEGCBBBCADHG.WHCGhABAUBCFRFCA...........hACA......hAEA...,2,-33,-9,24
NABIcJeYMVGXWgHLZSOUadCKRfTbPQEDF,BDDDJDDH.MECFGDGG..XACEHDAHSHAAUEFDCBGH.hAAAKBAERCAF.TADA.hABAQGDFDAFGNDIGAACC.hAIAIAHHeHDA.YCFE...hBAA......hBBA...,2,-32,-10,22
ZINQdOYbWAPVcRSKEXGHaefFMLBTCUgDJ,VBBCSEAD.EEFHXCFH.HFBAeCEAFEABMACDLFHFhAAACEHCDIGAZGAE.IBDChAAAdBHEOHCE.hABAWABCAIBG.REDE.KFBE.fGGBBHAA.hAFA......hAGA...,1,-9,-23,14
beTdGcfYENBQIMKROXCUHLVZgFPJaSADW,DFEAeECEdAECGBDF....fGBGYACD.BFHEIGEDhAAAKGECODCH.hABACBAFLHEGVEABgDGAhAEAJAGBACBE.WHAA...TGGAhAFAEDGCMDAH....hAAA...,2,-38,-4,34
CeGENfQXOLPAIFMZHUSBbWdTYaRKJDVcg,MIAEHEFFSCCEBDEGdABA.aAADKBFHJAFHDCHB....gEAHhAAAeFGFEFDCQDBFhAAALCHFADAFIAHDhACAFFAF...UDDHWAECRGACCHHH..NEIEOAHFhADA...hADA...,2,-23,-6,17
VXCOgERLSKcPBeAWaYfFJGUdNTMHIDZQb,aDABFEDEUAGE..TFGFMDAE.HAAGDFHF.ZGCG.QBEDhAAA.XDGAhABAgACBEDCFSGBFhADAKGECBHDCeFBHWHDAfABE.dEAAhAAAIFDDCCEH.RAGD.hAEAcDGBAFFG,1,2,-32,34
KBURFTZdNGYaHAEfXbPOJLWQMIVgSDceC,XBFCOFBELFHB.MDAAIDAH.VABESAAFhACAeGBCBFGEFEFDdBFEhADANECBGGDHaHEAEEAAPAFAhAAAJAHH..gGAGDBIDCBAD.KBBA..hAEA......hAFA...,1,-9,-10,1
fNRcIKdXYTZBECQebFGPSJMLDAaOUVgWH,OFDDVDEG.HCBGRDAE.KGBEdBBB..XDACTFCF.BBBEEAHD.hAAAQFFDFADA.hABASAHDLHFADGGChACAAAADaBFBgGAG.fCDHhAGAcGAHZDFGCBGD....hABA...,2,-21,-4,17
QGbWZEYRecVDdOLJMTCgKIUfHNBaXFASP,SBDHQBEAGDAGZDAARFFH.eDCGDDHHLFBHMIBG.CCCF.hAAAIBCEUBGBHFDHhABAaEGHFCHFAAHD..PFABhACAWGCEEAAD.YHFG....hABA......hACA...,1,-14,-15,1
ACBDVUEIPOKJTQLbWFcZHMNfXGRYeadgS,DECBEGCA.OACEKAEG..JDEFQDDH.LHDCbCFAFBAEZDAFhAAAHFAF.MAACXGEAhABAGAGE...hACAYCCEdDCGSHAGCFDHBGGE.IHHBhADA.....hAFA...,2,-17,-16,1
ReBcQTXFSGAIYdCVZULfNEOJaKbWMPHDg,dEFCVCCHUFCH.LBBCECGA..OFCEKHFC.MHFADFBDeCEAhAAABAHEQAAHhAAA.XAFGhACAFDAESAGAIDACCDHFNACFaGAD.PFFG.hABA......hAHA...,2,-38,-9,29
XcLFZIHaOEDfBSbYMACeQVWRGPTgdKNJU,CFHEQGAARFCA.GADCTCEFKHDAUAEDLDFB.FDBEZBBDhAAAHAAHEHEEBAHHSFHBhAAAMCAD.AFAGeAGDhACA..WHAG.dCHANAIG.....cGGFhABA.aDCDDGHB.hACA...,2,-27,3,30
IfAJBVDdbEXQecUWPRHFaMOZKSTGNgYLC,VCEEdCFHEEAA..QAAEeABFUGGH.RGAE.aFGFZECG..TEBHhAAAGACA..NHCFLEADhADAIAEDAEHADBGAXAGEhAAA..cADG....hAGA......hAHA...,2,-25,-12,13
MEagOXBQAUSNVFTHGWPZCfKdYDJIRLceb,SAGAVCFH.HBEEGADDZFAHKCADdEABDCBCRDDGLAACeHAEMIEEhAAAaCBD...XFFChABABEGAAHIFUGDEFEDD.hACA..WDHBCEHHfCDAIHGA...hAEA......hAFA...,2,-14,-13,1
DOFVYKBbJCUAeRGcSIZQEgaHXMNTPfWLd,eBCAGBFA.SDBAIEDH.QGAGEGCAHCAB.MCCAPFGBhAAAfHFH.hABALABADIDCFCGDKAGEhACABFHCCGBCAHIB..REEDcFBFaCFB.XCAChAAANBIAWFAD.dAFF.OAHDhACA..,2,-19,19,38
PdFUYMWIDaCeAVBERKHJfbgZQcNXLSTOG,EDDDRFCDKBEEHFAF.JABC....bBBDQCEF.NCIE.SEEChAAAGGEBdAGHFBHBhABAMBBFDGFFCGHCAAEABCCChAAAfFAFZFCF.XFFBOCGD...YCADhACA.IHAAhADA.,1,6,-44,50
KWQPdFLSegYNMIDTcaBAEfbVURXCHGJZO,EEAGVGFEUDEG..CHBEHAFAGCGCZEBAOHBGKDCA...QABDhAAAFAAFSAEFhACAeAFA..NGAF.IDGDhADADDDHaADFAHID..fCBF...hABA......hAFA...,1,-18,-24,6
AebRHUZJaVGdBXPTOgKfEYcDLQSNMFWCI,eFEGHECFUBADZBDF.JBDHaCAA.GAGCBBGG...TDAAKFGFEGAGhAAADADGLAEEQGDHhAAAMBFDCHHBAGBD...hABA............hACA......hADA...,1,-17,-34,17
OaURJDZQIgeWbKBYXCcFPfHdLNTVMASGE,GBAGEBBFUFFADIGEZADCQGAC.eAEDKDDDBCEB.CGDAFGAFhAAAfAFB.hABALGECTCGAAFIBODHFhAAA.aHDCIEAHWEEGXABBhAHA.cCFE.PDCFhAIANDCA,1,-16,-47,31
cJTBHeOfUQgWDPXKZVRdEGFIbSaNLMCYA,TAEDeDFDOBDG.UAAAQGFB.DFEBPDDBZGAAVDFGhAAAEGDAGEAGFEAGICCDhABAaAHD..MFHHhADAAEDGBCAGfCFD..XBGAhACA......hADAKHEG..,2,-21,-4,17
cfSIAZYVaBeKUWdOXMbGRDENLHFgJPQTC,VDCGaEEDBCBD..KHEGdCEB..MDIBREBFDAGEEGDCHGFG.FBHHJBEChAAA..QAAHhAAACBDDSACFAIEA.eEAHhABAOADB..XFFBNEAC.PHAEhAEAfEHEIDGB.hACA..YAFC,1,-15,-28,13
DGcZUbEXKedWVPAfaISgFLRBHQTCONYMJ,aFFHSAEELCBFHCDG.CFHB.ODGBMBIFGGCDUGCGXABEhAAAeABFdEBD..PAFAhABAAHBHfEFAhAAA.FHGEBDEFNBAGDAHDcAEC.EEHF.KBHBhACA.IHHG.hABA...,2,-11,-8,3
cLEJAVBeRPgKYHIGbWfMTUXDSaCdNFOQZ,eEDDRABFKGDEHCEEGAEG.....fBHETEBFDIECaABHCGAEdAHGhAAAFDBDZGAALBADhABAEEFAAHFEBCAG.gGGHhAAA..YFFC.IHHFhADA....hAEA...,1,-10,-30,20
YMRcPCdOgVEGXQAZNHJbIBeaTfDKWLSUF,HFAFJDEABEAGeFFE.TBAGKACF..LAAHSGEA.FADBhAAARFFDCFCCdECE.VCFCEDCG.hADAQCDAZGBC.hAEAIAGHDGAB....WBECMICE.hAFA...OFHFhAGA...,1,9,-39,48
JFcRfMWgGbQZXVPYSECdNLaKUOHABTeID,BEEETAEHDDAC.FFCDREED..MIDAGAFCZCBG....VCGDSBAGhAAAEAAG.CAHDdEHEhABALEAAKFAB.UGAFhACAAIAEeBBE..IGHBfHFF..hACA...WDAA.hADA...,2,-33,-15,18
HfAaRYCJQGZbgcDLUSPIMXdWNOTEVFKBe,RDGHCBECGDEGZABC....bBFFDCCB.SAFEMICG.dCHANCDE.hAAAEABE..KFADBDAAhAAAeCEHAIBC..aFCDQCAChACA.cGADUGGAIDDHhADAOFHD......hAEAFFFHfCFD.,1,-4,-25,21
gRNEcDCdAMHKJfFGXTOPeSbQVaLYBZUIW,MCFFKCAHFGDCGABC.OFGHSFBFQGBGLAFGBBEChAAAUAAF..IEAChABAgDCDEEDBCGEHHFFAhABAfAGDTCGAeHFAaDGF...YAEFhADA.WHAGhAGANDICDADAAEEA..,1,-7,-22,15
NeGEVQHOJSXFLgDaZIUcTYWRCAPbMBKfd,MEBHBBFDKCBHdAGCGBDG..EFEHQBBFJAAE.SGFFhAAALGAGaCFEIHHEhABAUGGE..TEAHhAAAYDGH.CAHAACIDfEDHNEAA.eADChAHAOFCD...hAIA...,1,-9,-37,28
OKGbMfLCQeERPXSTIFJBVgAYDZcaHdUWN,ZECEaAFCHDFGdEGEUAECOCAFGAAB..MIFACHCF.QFDChAAARDAH.XBBBhABASAGATGAAFCDHBGFDhAAAAFCDDECCcFFAKHDA.......hABA......hADA...,2,-27,0,27
JUQCdeWTgPHDOEVIbZcSMLAfXYGBFaRKN,XEEABDEAFECHKAAAUBFG..dAED..TDCGHGCGDGHH..hAAAEBCH.VFABZFFDMDAChACAAGHH..fHEHhAAAaHACRBFC.NABGCDHH.....WAFE.hADA....OAEHhACAIFAA.,1,-9,-31,22
UJBSMdAKTgbLceNXRDWVGFCEHZPQfaOYI,KFCGTCDHLBBE.eBFGRAAGDEFEGCEAEDADHFACZDAD..QGGDhAAAOGFEUAFHBAHGhABAMAIFAIEA...bEFEhAAA.XGDDFDHFfDCFaACA...hAGA......hCAA...,2,-14,-5,9
SCEdOZQDNIXcgHefWVGKbTARFJLYaUBMP,FCADLFCHUFCCBFFHSFHB.CAAA.dACAZCBGDBID..IADBhAAA..XBFEhAAAHGEAfGAGhACAGDDHKHGAABCBJAFDMAFGEFFGOFBBQCGEhAFA......hAHA...,2,-36,-14,22
EdAMQSKRbJHWINYPgcfeDOXZLBGUFaVCT,SDEARFCGHCBD..IBED..NBAB...PDEGhAAAfFDEDIFEODAHhABAXAGDBGHCFGGDCACCTGADhAEAECACAFGEKEAD.WDCFYEFG..cGBChAAA.eDHB.hAFA...,2,-24,-23,1
JIKDeOVUNFRCBScbEZgGfXYWQHLATMdPa,MFBCaGAC.KAHDDCBF..eHDEUCCE.RBFBBGFHSCAD.EBCHhAAAZFGDGDGC.fGBFhABAXEDE.QCEBhACAAAEFdABHJFAA.IAFCOHCE.NIADCFFD.hAAA......hACA...,1,-4,-33,29
SXMGKVPAfOCaRWZceIYTQbFDgUNLEHJBd,OACDaFBHZBAA...eBEC..IGFATGCHFDFBDIEAUDEHhAAALCAHEADA.HEGDBEHHhABASAHBMAIBKFCAACFEhACACABGcGAC..bDAGNIED.....hAAA......hACA...,1,-17,-22,5
bMeLNWPIQZAHcVOdDgTEKFRCJaUSfXGBY,HACGODDCdDGBDCFGECEH.FAHBCFAH...aFEEUCAB...SHAGhAAAGBAABGBAMFHBhABANICF....IHHHhAAAADHAVGDCKABGRDCB.JAFE..fEHEhABA.....hADA...,1,-7,-39,32
dECNJgOZHBTePAGUIVXcKFWRMDaYLQbfS,UCDEXECFKGCB.RABD.DFAFLBGD.QGFDSDACEBADhAAACFDE...JDAHZGFGBHCHhABAeCFAAAGA.GAAFhAAAIFEF.FBHDMFBHaFBD.fFFDhABANEIA......hADA...,2,-36,-3,33
BFUHSeEDMaYONdWgPZJVfTAIbGCKRcLXQ,GACFRGDELFCEQFACBDBCHACGSFDGEBAH.MHCAaBHDODGBhAAANFEH.dAGAPCFAhAAAJDCG.VCACAABECFAG.hADAcGGH.FDECDGIH......hAFA......hAIA...,1,6,-14,20
NWZHbFEMXgDfRGaOeQKITVJUCdBYPLScA,ZBGFHGFCFFEFXDCBDAAF.RBGDGFAFOADB.KADE...IBAChAAAJGAGCAEE.BHAC.hABAPFEASCBHhACAADBH..NIBH.EGHHfAFCeECC...hAGA......hAHA...,2,-43,-3,40
fIUGbQMOKDVeCWPSZcBXEdaFHgANJRLYT,JFBBLFBF.TDFDUGGEQABD.KDAEDCEF.CADHSAGEhAAAZEDEBAHEEHEAhAAAdGHCHAEFADCCRFDDIDABhABAMEAF.eFFBcGDGaDHDFBBC.gAFGhACA..fDDDhABA,1,-19,-22,3
NVOQXGKUMTCAWBDdcZgJaIHPFeSfYbRLE,DFFFdECAZAGH..aBEFHEFHFCBG.SAAG..bEACEFADOCGDhAAAGBDA.MICAhABAAABHBEDEJFHDeCAARGAALADChACA.QGGFKBFHCACE....hAHA......hAIA...,2,-27,-2,25
POCANKeJBIZVGDSXETWdaYbcLHfMgRQUF,KABFeBHHBGHCZEDDDABB..XFDDEHBEdADB...aBDF..bFFFhAAAHDFH.MDAEQCCGhACAFFBGCBHAAAGC.IBGGhAGASEAF.....WHFAcEBHhAHAfHBD.hAIA...,2,-31,-28,3
YPcXVLIfdMeJUHKBZCFQgAEbTRDGWaSON,TCABDHCEGAEC..aBGBSHGA.OEGBYEGDhAAAXAAFLBAEdBHEJCBDhADAKBHBCDDD.QFABhABAAFIBEEDF.WCEBNEAE...PHDE.hAEAIAEE..hACAMFFF.,1,-7,-25,18
BQTDRGOJfCdcAXWHEUVKbNgLZFaIMSPYe,HCDGEEEEUCAG..VGBAKAGG...gEBCLHDGaADGSHGGhAAA.eABGhADATCFFDFIFOBBBhAEACFCGdDDGABBA.XAGF.bEGBFFHDMFAHBGAC.hAFA......hBAA...,1,-4,-29,25
OgXLRdIUBGMcPDVQTEJFeZKfaACYSWNHb,CFCESGEHHCED.OHAGLBAA.IHEHBBEAGBAAhAAAMEBCDAGCVCGB.EACBJFADhAAAFGGDKHBGAEDD..NAEF.bEGHhABA..REDHdBGB..cAEF...hABA......hADA...,2,-19,-10,9
RJMBbdAIOUYZXHeEaDVCcLTNPQWfSgFKG,OFAFUGBAZABBHDBA.eGDEEBHFDAEH..VAEHCDFE.LHEGhAAA.NCHC.PFGBhAAAfBCGFFEFGDBHhABAMABDBFFEdAFDACFGIEHFYAHH....hAGA......hAIA...,1,1,-26,27
BTFDagSNPICKcUWLEVGHeXJMOYQZRbdfA,FFGDDAFE..aBCESFDC..PEEDKCAEUBGALDHBhAAAEDCFHFAFeDBF.JBADMAEChAAAOHEEZBEHdABHAIBCBEDChABANEIG.CHHE.....WHEGXAGAhACA...RCFBfFCGhADA,2,-25,-12,13
IJXNdcHaPRLCbDMGBWSFQZfOeEYKTAgVU,VBADUGEB..JACBdEEE.HGAGRBGD.LAEBDBBH.MEIFBAGFFHEChAAAZFACODGF.EECEhABAKFGEAAGD...XDEGhAAA..aAGDCBEH.......hABA.WEAEfGGEhACA..,1,-4,-53,49
DFbOKISGeRAEQZfXadLBPMVHNWcUTgYJC,EBAGQEAAZDAE.aABGdGBD.BHAG.MFECVAGBHBFA..hAAANDIGUFCGTGEAJADBFADChABAKDEESGGBhACA.eDFAAGFHfHFH....hAAA......hAFA...,1,-7,-28,21
HAbQgfKRdESUPTIOBYXFaJZGcMeDNCLWV,QECAKBFBEDBD.UGGH..PHAEIAEGOABE.BHHHhAAAXGADFFDBaDDCJBBHhAAAZAGFMADD.DAHDCFACVFFFhABAAHED..fBFASCCEYCHBhABA....hACA.eEFF.,2,-16,-15,1
TONUQHgJGdaeZFEARPSbCLVXWYKfDIcBM,SDDHLEBFXGFCKBBE..DGCABDCBMCFGOABG.hAAAQEGCgDAGhABAdGDEeDHBEAFGABDHPHBGhACACHAD...WHFCfCGH.IEEGhAAAcBDB...hADA...,2,-40,-21,19
UdeDIWKHCMaRXFGPZbVgQBLOYTfSAJcEN,JFFGEFDDdEED..eDBDDAGAKBHHHFCB.CBBE.MFABRAFE..FCEGGCBGhAAAZDCC...VADChABABAAFODHH..hACAfHADSDDEAIHCNCACWHBG.aGGH.hACA......hADA...,2,-30,-15,15
ADFVfgEOUZWTGXMNLRISHbJcQdaeKBPYC,DGCGVGFGEDAG..ZECFGACH..MDBDRBGFSFFFJCFF.hAAAdDCAaADDBBAH.CGAAAHIHhAAAFAFC.OABF.hABA.WDHHNIBHLCHH.....hACA......hADA...,2,-34,-23,11
HJaPgeXZSFLKOTcQWMIUfADBEbNCGYVRd,EEAFCBACGCBAREDG.HGDEJHEC...aEDEeCFEZAEEFDGALDDE.hAAAKAAHTFGC.QGADhABAIBDGAACHBDDBhACA..NEIA..dHAB.PAEG.SDAEhAAAODAHMIFEhADA...,2,-16,-8,8
WADPXSEBeRcTJGdZIbQKCaFYLUfMgVONH,XEBFBACGeFABRFFC...JDHBdACCZGCGQFDE.aHCCLDCAhAAA.fCCDhABAgAECNEGA.HAGBhAAA.DABBEAEGTDFGIDADCHHG.FFCEMDBGhAEA..WBFAAIFA.hAIA...,1,-10,-24,14
gLBZWFOMIKSVUJbDYeHQCfaPGXdTNARcE,RBGFECGDLEFBZEFE.FGAEMAIB.KHAASDAAUEAE.JBCEDCBEhAAA.eDDGHDDBQGGChABACCAG.aACEPEHDhAAA.XAFFTECCACAFBABG..hACAOHCG.IAFFhACA.,1,-16,-22,6
GUcbMeZKPBJNTVgRADSYHCIWfEOLaFdXQ,SHFEHBGBCGBA..IAABEGCBLDBCdBCDGDAHUACAbDFDhAAAMAFC.KGFHBAHGTFDGhACA..RBFEYFBChABAfDFGFEHF.XGAH...hADA......hAEA...,1,-3,-23,20
QeAgRfcEFaGJOPVBIdHYXTDKUWMZNbSCL,RBDBEDAHFEFEGBFA.OAHFBAAGHAGF.XEADDCBEUECGMGDChABAZADBSGADhAAA.CABAQGGEhABAAAFEgCBGaEFH.PHCCIGHH..hACAdFBG.....hADA...,2,-38,6,44
YHJRSeGgcDWIfCONZKEAQMaLBPXVdUbTF,MAEBLFAFBDAAXEGHdDGD..TGGGHCFESBDHhAAA.eBBDgABHhAAAcFEBDAEGfAFDhABANICBKGBA.AHFFaHAG.PDED.UGCGhAHAFACB......hAIA...,2,-26,-3,23
RBcCTZaVUHMPFJWEbIXdNeDLQSAOGKYgf,GBCEKAHD...fCAERDAFBGEACBBDZADHaFEA.HDFB.FGAHEGDChAAA.XCEFdFCHDHGA.hAAALAFC.AHFCYDGHhABA...gABFhAEAcABA.....UGBGhBAAMDIH.,1,8,-43,51
AbPFHIDUSNMCKLfTdcgWRQYZJVGeEOBXa,FEBEDAADUGCFMAIDLFHB..fDCDdBBE..gADChAAARFFEZCECGCAChABAEEFHBHAFAIAEHADCSGCAhABACBHHKAGE.cCGCWHFG.....hACA......hADA...,2,-25,-22,3
EZTRUdfXDALBeNgSQacCFOJMYPbGWHIKV,LCFCeECC.SDGBaEHHFEAF.OADHMDBG...bEDDHFCChAAA.IBCAhABAKHBGEAAGZEAEUAGFdAEDDACABCABhACANIDB.gGFBCHAD.....hAFA......hAHA...,1,-8,-22,14
STXAeEdcVOKNYJfDBZGgMRCIbUFaWLHQP,dFACVDCDOHEC.KCDBJHAA.BBACZBBBGDGC..MCBDhAAACCABUBGHaEHF..LAEDhABAQFCC.SAEBhAAATAGAeHFGEFFB...NCGCDDAB.hABA......hACA...,1,-22,-24,2
FBEbCTGMJfgILHYXZARDdQOcVeSNPWUKa,dDDCQCEGOAFB.eFAB..SEAENAAG.UEGEFHDGBBFBhABACCBFMIFAJFFG.ICCChACAHGCCXGAFhAAAAAHGDCBB...PABC.KAHBaDGEEEEGTEBEhADA.fGHAhAEA.,1,-10,-31,21
EQecbAOVRYGKBJCLXPZSaWIfDdMTNUFgH,OEBGRBDBGGEBBFHGCACF.LHBE.ZAAHaFBE...IAFHhAAADDIBMDAHUEFFFBGHEGFBhACAeBAB.AFIFKHACJCCC.hADA..XEAGSFBGfCCEhABAdFEB.NAIG.....hAEA...,1,-20,-23,3
PDVeFaCcYHIATBZUEJMbXKOWNRfSQdgLG,BCCAEHEA.MFIDKAHBODDARBFD..QEAELEAFDGEAFBACCFEHhAAAHEBA.ADBCTACHhAAAJHAE..XAGBhABANEHAdABC...PHECeCHBcGBDZBDB.hACA...WEHF.hAEA..SADC,1,-14,-17,3
ZVYaHLSQDMTWICFUbgREcBGfeOPKXNJdA,ZAGHaHEAHAFESABAQCBDDDCG.MFAG..IFCBhAAAUDGARADBEFDCGAEA.fEFFhABAOAAAPHAChAFAKGGDNEAF.AHHE.LFHH.TGDD.hAHACGBDFCAG....hACA...,2,-13,2,15
KNfdWbJMCIHLgVZRFUeDTESBGOAcQaXYP,aCGAXABD.KEBDdBDA.JFFE..IHGEHFAGLFEFhAAA.ZDAARGCAUCGBDBFCTBBFhABABBAFAAGD.QDDDhAAANEEB.fADFMAFACHHA.FAHB.hACA..EFGA.SDAFhABA,2,-22,-20,2
RZMPNgDWdTcKIHXBLAJSFEQCfUYGbVaeO,JGEESFDB.FGAFEDCG.QCFHUAFGGDDH.aBBDOFAHhAAAZFBH.MDBB.hAAANBCB.gFGFhABADCCEdFCBKHCGHADDBHHFACADCDHBfBAA..hABA......hACA...,2,-29,-7,22
PZTJVbedADBgSaKHMGfNLCOEFUIRXQWcY,BBCASEEAHAFFMDHFGBGGLEDC.CFBB.ODCCFHBERCAG.hAAAXACA.WBADhAAAYABEZGAGJFAEeFHHhAFAAIEEDGGEKFDA.NAIA.IHHA.cAFGhABA.....hAHA...,2,-16,-15,1
ZHdgIcRBDOUGTFQJCaXPMbfVNKYSWeLEA,ZEDEHFABdAGH..gEEHRBCGDFAAGGCFQDBB.CACEaAFHhAAAPDAE..fBAFhABAKGGE.SGGChAEALABCACIBBHHC.TCGDFCGFMAADhAFANICFWCDHIHAD.hAGA...,2,-19,-17,2
UEYICPeMGFNADLKQVgXbHRWSTfadZBOJc,KFCFQFBD..VFFGXAFCHAGFRDBETFFFdBAHBHEFOACDhAAAUBDHEEEA.CCABMICAhABAFGAFAAAGLEFChACA..WEHHaDAB.ZCEG.YEAD.hADA......hAEA...,2,-15,-1,14
BPWDbFdHUgXMNaRefTJAOcIVKGEQLZYCS,ODBAVAEA.KAGFQGGBLEBDZAAECCGH.BFDHDIBC..FFDBdGFDhAAAHAAFUDFB.MICGhABARDBF..eDDE.fEHChAAAAGIDIAEDEHEESAHB.hACA...WEAF.hACA...,2,-32,-6,26
SIFbDCMGRLBdfQHATWVYUNOEgPZecXKJa,VGFGUGCHEGFB.ZEAGeEAF.KCCB..SDDEFACGDBADGEDFhAAALBEGBDHBdAAFQGCChABAADBATDGC..hAFANAED...gCEEcFFA.aBGCCDAG.fHAHhAGA..hAHA...,2,-19,-18,1
LMcADEdKXbJHFRCaQSYgBVeNWfUIPGZOT,dEEGKFHH.JAAGRCFF..CACH...aECHQGBC..SHEEhAAABHFDeCCC..fGAGhAEAIAGHPCAFhAAAODHBMCDA.DDBEXEDGFBGA.hAFA......hAGA...,2,-39,-33,6
VJBQDWSPIHLZAEUTeMdbYRXKaOCcNfGFg,EEFEeGBEdGDGRECG..KAGDaBFB..CAAF.....NEAHGBAHFGFDVCAAhACABAAH.DGCFSCHBhADAHBGHAHHHMFFH.hAEA.XFGBOFAGfGAEJAED.hAHAWADC....hAAA...,1,-23,-25,2
RQFXTcUMfKZeHADIaPOEVBGWJNbdgSLYC,DAEEaEFG.ODACBCCHGGCF..JBFDdAAGLHECCCGE.QEFDhAAATFADMAFEhACAKFBBZBAAAGIB..ECEENAHC.hABASEAC.FFGF.....hACA......hADA...,2,-35,-23,12
fdFMQSWcKbJUeDLCENXZROaHGgIVYBTAP,dDAFFABBQDGGSFEHKEGDUFAC.DHGALBHH.EGADNEFG.hAAARFCFHACBGECGIAADhACABCEDAIAE..MADFhAEAbBEF.CAGD...........hAFA......hAHA...,1,-11,-30,19
VfUZaMBXWHdLRYbGPICAgNcKJOTDQSeEF,...NCFG.KBHF.OFEBQECHeABBEDEAFADGUBAB.MEHHhAAABDDF.XGAEhAAAdBGGLHCCRGFCGCAEIHAGhABACAFHAADB..cDGDDGGDSAGEhACA......hBBA...,1,-19,-24,5
OICFZfaJNLBcYTeSHVPMEdWgGAURKQbXD,RFAGQBADDCDC.OCFGCGGCFCAF.ZEGB...JEAHBHFD..hAAATDCHSFDHhABAPEFHMIBA.EAFGdAAFhADAGDEFKBDBbFDHXCCCaHAC...NBBBLAHHhACA..hADA...,2,-30,-4,26
NUMGKPRgbVEYBeAZacCSTJFOHfLWQDdXI,ZEAFaCCH.CDGF...SABCJECE.HBDGLCAGDHAGdFEA.XBGFhAAAIFGEMFAEhAEAKAGG.REGF...bABGEDDGhAFA.BGDFAIFE....FGCA.fCEFhAAA.NDIC...hACA...,2,-41,-11,30
XECObHKJgADLVaPFZQTWUecdNSfMBRIGY,VCCFFEDDZCGB..QAEBUGGEdEBA...SBGHMADGBBAAhAAAIBAHGCBF.EFAHhAAACAHA.HGFG.KGCGADIBDHAChABAaFEG...TGEH...eBFBhACAfDAC..hABA...,2,-24,-22,2
KUPBaVHAXOSFQJgebWDYLTIfcRMdZCNEG,SFDGJAAC.eBFGDBGALCEB..fABBhAAAMEIFdHFBCEBFEFAHGFBHhADAUCDHaEBFACCB.XEEEhADAFHAA...........hAEA......hAFA...,1,-20,-40,20
gJaFZTVeKLUfCOWGAIdXMEBDNHRYPcQSb,XAEEBCCCDBFBREDG......PAAGQBGE.SHAEhAAAJBHHZEDHTEAChAEAKEBHUGGFCFGG.OAEAhABAAHIDICCDdGDEMDAHEHAGHCED.YHEGhAFAgABC.aBDDhAIA...,1,-12,-30,18
NWLDXTSJKPEOgGVIMefZARdHCQaFUcBbY,HDFDQFEAaFAAUCBABBHC...bEAANAEG..LHCCDDDESGGHhAAAKBGG.OABChABAgAACGGABIHHEhAAAMAEEeEFEAEIFCAHEFGAHWBCA....hADA......hAIA...,1,-11,-17,6
aZFWLcIPXSNODfEbMQTRGeYdKJBHUVCgA,aBBFZBAHFFBHLBFC..IAGGSDFBDDFE.EBAB.QEDGhAAAGDDGdHGDBHAFhABAVACBCHGDAIDG..PDHDhAAAXEAH.fFGFMFAH.eADDhACAKHCG......hAEA...,2,-21,-19,2
HWQaMPKVLFUfSOXEbcABeRTGCZdDNIgJY,BABDRBFGCFGE.ZEAGdBEGDGFF......NCCE.IDGG..hAAAJFABHGACQABHhAAAaCCAMACGKDAFLBEBhAGAUGEA.SGGGEEECAEHEeHBAgBGEhAHA.YFFChAIA...,2,-31,-25,6
CAVgMLGHDTPFaQeYKSJZXNUBfWIORcEdb,VBFHMEIDGCBF.DGEAFFGD.aDDFQACHKCAE.SGAChAAAXDBHBFFChAAAfAFDODHFEDGBdAFBhABAABFH..LHDE.PEAEeABA..hABA......hACA...,2,-26,-19,7
DKOUVWSgLEcbAeQJTaYRGZfMXdFBPCHIN,JDBFTDCB..RGCGGCDEMEFF..FEACCBGFHFFADGIHKACD.OAHHhAAAUAAG..SAFChADALEGDEBDCAIBAeHFAhAEA.aBHDfGCA..BDFBNIDBgBADhABA.cGAGhADA.,1,-13,-32,19
WTefMQRFLEZcJDVIdCKOSaNYgAGbPBXHU,GCCCBCFDHBBAUEGHeADEQAFGLEFGEHCAJEBA..IHGGhAAAdGCCCGEEKGAF.OCABhAAANBBB..AHADXCAGhABATGGE.MEFBRBGD.FEAD.DBID.aCFE.hABA......hACA...,1,-1,-13,12
NbaZRWFIUgTLdOefYMDAHCBGcPQEVXSKJ,CAECBAEDGEEDQCEB.EHGESEDCKDDD.JBCBaAAGRAGHFGDEhAAAUEGDLBABhABAdGBB.eFBDMDAHAHHE.PCBHhADA...NICH......WAHHhAFA.....hACA...,2,-26,-16,10
DAQHKMecOVGRCbaZUdSTIYENJWFfPBLXg,HCCAeFFCOEDDGGEFCEFEZDBBdGAF..TABBIAAC.EBEENDAA.hAAA...FHGCBEABhACAXDEBAGDFMIAG..hADA.cAFAbBFEaHBGSECGWBEC..hAEAfBAE.hAHA...,2,-21,-8,13
ZDRMLNeAgJEXUKVbQWdcfTOIFaSBYPHGC,JACEUBDA.KGDGQFBE.dCCBfCGG.OCABhAAAaAGEBGHH.PEFAhAAACABCDGABLCCFhADAAHGF.EFFDbBAH.TFDEIBHDFGAHSBFDhABAYHFG...hAEA...,1,-18,-44,26
YDXeUHZgKBEFTQNOPICWJabVMScGRALdf,dFAADBIBeFHBHFCGKDHFBBFBEBDF..FDCEQCEA.OBBHhAAACFFCaAAH..MFCBSHAAhABARGDGLFABYFFBhACAUADEZAGB..NAEBIHHG.hABA.WDFG...hADA...,1,-19,-21,2
BYVWHDfTaOIdNRcMGSKAEJULCQgPZebFX,UDCACBCE.QAFBZBGHFGEHBBEB..VFGFDEEE...fCEDhAAAaECC.dGEGRGAAMAABhABAKADFAICA..EGAGJFFGhACALBBD.eAHH...XDGEhABAWCDAODAD.hACAIHHG.,1,1,-43,44
KdgGXWDTaRIcQfBHZbLNUAeEJFSOPMVYC,JEBFSFGG.MHEECBCBdGHA.GBDGDECCRAFE...QGDDhAAAfBAGBABCZFAHLADDhAAAUDGHAAFCFAHDPDFGhABA.KGCEWEADaBBF......hADA......hAEA...,2,-34,-12,22
SfQLPTFYIMNUHRKGBAXcEdCgbOZJWDVea,XAAAdGFGCDAA..OBCDZEGBDAFD.eFFFaDFG...QDAAhAAALFBAFAFBMHBGUAAFhABAKEDFGCEHBHBBAAHFEGHBhADA....JADDSEHBfAHEhABA......hADA...,1,-15,-30,15
ULDIbYJKEgXGVFcRQPCHTafdSOANeBWZM,BCFDMAEBDGDG..IACC..JBAFKHCGEBGAGDGAFDFGRFAF.hAAACEAGHDCE.aBHFfDCBhABAdGAC.AAGBeFFEhACAWAAF.LHEG..gGEEhAEA...XBBGhAFA,1,-20,-35,15
LaQGKZWCPNOYMTRbBXJfDASdceEUIgFHV,SFDHdGBEECEG.UFAEFABHLEFGGACGKFGHCDDB...OBABhAAAMBFE.RCEABAGDJDADDGIDhAAAAGFB...eADC.hABAHGEAaHEE..........hACA......hADA...,2,-27,-24,3
HAaJMBPIVgKDTWGQOYUZXNLfFREdSecCb,aDFCBGHE...VBABKFCADGFCGCFE..OBFAUECBZAEDLCEDhAAAFABA.EBAGeAHBhAAACEACAACA.MIEA..IGADhABA.gDBH..WEADhAEAYHDENHCH.fADChAFA,2,-33,-30,3
YbXDNGSAeHRLOCQFUIdWZBJcEMTgVfKPa,RACGCDEHUAGAdCCABDFF..EBCHMIBG....VFAGKEABaAGG.hAAA.XGGGDIGCGEEDhAAAACEDeDDDHFCELBBFhABAFCAC..IGHGWDHD.JBHBTAEBhACA.fGEChADA..,2,-24,-17,7
JdIfSEDXLFHYeWCQcKMVRPgNZTAaGOUBb,OFBHUAAHBDHBdEEA...SFEFDDCALBDCHADDeAHFCCGCKFCFhABAMEAD..VFGHhADARFCD..PGFCZDDAAGADaAFAhAIAGAAE.........hBGA......hBIA...,1,-17,-24,7
NZFQTbaUDBfEXcVWIgHAPOYdCGRKLSJeM,OCDECEFHRBAA.KDBFLGCC..eFHHMFBEFBGC.QGEFhAAAaGGHDEAC.BBBCEEHH.hAAAXFBE..hABAWADEIEFGADECdBHCSHAGJHAANAEH.hACA......hADA...,1,-27,-33,6
YFaBdOUVfgbSWcMLPQEDIAZRKHTGXeJNC,KAEHTGBGGDAC.eDGBJABD...CDCHFGCABGDB.UDFB.VADEhAAAbGFG...SGHHhABAMACHQAGBhAAAIGGHAEED...RDAANBIAdHAD...fBAAhABA...hADA...,1,-13,-30,17
LdBSMfZeHNbKUWRYTgOPACaJDIXQGEcFV,aCBHDBACQGGFGAFAFHFA.dEBFBDDH..MFEDZABHeFEGHBDHNEAGhAAAKADF.UFACRCFCTGBEhABAOEHF..AADACCCDIHDAhAAA.........hACA......hAFA...,2,-18,-18,0
XTePaFbCNJgOELDRIYGQAKMWfZHcBUVdS,KGDHMADHZAAGBFCEdGGB...SBEFeDCEFECB.CAAF...JAHFOGCEhACALAFFDBGHREAD.hAAAGEFGAGFH.fBBGhAEA...cAGA...hABA...XDGHhACA..,1,-36,-37,1
HfPZJFEcRMOUSgYKBeLNCIQTAXdaDVWGb,dEEGVFDEGDFA.HDAGZAABJEBBFHDGEADD..MDIFOAFHUAGEhAAASAAH.hADAKGAFeDECCHGH.ICDHhAEAAIBADBGE..fCCB..cGFDhAFA....hBAAYCHHBBEB,1,-12,-25,13
YHLVeBDQbXCdaIJOGWZKMgfPTFERSUAcN,...NBGE.LADDBCAF.DGFBQFBDCDHCdFAA..ICFHhAAAOHEEZEDFKECFMFEChABAPCHF..FGGGSABAhAAAAAGF.HFFGeHAAaAGF.JCCCgCAFhACAEEAH...hABA...,2,-31,-17,14
fKSUCaMbcGHXOdQTFBRWYZIgDLPNAVeEJ,EGBCJDAB.KEEBUGDF..aACG..MCFHGAAEHCCHOCFAdEGCQAAChACABFHD.RADC.hADAYAEG.IECBhAAAgBGCPHEAAEEFfHADhAEACFAB......hAGA...,2,-22,-20,2
VEROaLBNdDgSAUFbXcIYZWQeCJfHPKTMG,UFFDFHBA..XDAC..IDDBZEBGQAGAJCFAHBBEhAAAKBCGMACEEEGGRGFGOHAChABAaACG.BEBHDGAFSDDChAAAAGBE.cFEGWDFGCAFH..fBAGhABA..hAFA...,2,-33,-20,13
ZNQUdCKebVYHGAIaTWLJFXPSMcRBgDEfO,TEGBLBEG.FCACSACFMFFG.BCFGDGAHEEDDZEBAQGAFhAAACFBC.eDBEhABA.VAFAGGDFAFFDaHDAhAEAXGBD.PABGcGGEfDGHhAAA...OAFGhBAA.,1,-4,-31,27
BJQSGWRAaVKCXDFMUbEeIYHfgNPOTdcZL,KDFDCEGHDAAGMIAE..EEDDeCAD.HFCA..NDCH.TAFHZEADBGGChADAJCDF.GAEHABBHaHEEFFAHhAAA..IBBBhAEAfCHEOCHFLABBSBDG.hADAWFFD....hAFAXGGB.,1,-1,-29,28
POUWQATRZHNFdeXDSgEMYVbcJGILCaBKf,ZADAFBBHdGDHDDEC..ECBEMIEC....VECCJAFDLEGFhAAABGFFKDHB.OEBA.QACFhABAAGIDHGAGXAGBhAAASFAE.gBGHYBAF..hADAcGFEIHADCHDH.hABA...,2,-36,-20,16
HBNTDMXIefWSKcLGbZVJQCEUaRYPdOgAF,FCBAHBFGBADCDBDDMGBG..IEHCeCBBSBECKEBG.hAAALDFBGAFGZFEFhABAJHFECDHAaHAA..PHAAhAAAdBEGAGGH...NBAAfEDHWFAG..hABA......hACA...,2,-33,-18,15
QPfTXHNIEdgbeVcUCSKDLOAWaFBGZRYMJ,aADHBAGFZGCCMAAE..QCFF..PECHTEDBHEGFhAEAIGGAdDEGeBHDhAFAUBABKGFFDEAGACBH.WFAFhAAA......FCCF.....hABA......hACA...,2,-29,-29,0
YSXVUEfHJcRIaBONLDQGZCgPTFeKMbAWd,dEAFXFFEEEDBHABFREAB.BGBBLEFCDAIF.GBBACDGC.TADAhAAAeHFAMDIHADGA.SDDEhAAAfHBHIBFFhABAaAHBNIDD.gFFAFBABKEDF.WHBAhADA......hAEA...,2,-27,1,28
efASRFMZXUWcCaVdYLJBQKbGIODgNTPHE,RFGDFGEAZCDAUFCA..CECCdAHCLACBBHDE.QGAEGAAC.DEEChAAA..TGACEAGCABAD.hABAMFFD..WAEFhAGAaAFB.......YFFC.hAAAKBFD.OCBH.hACANIDD...,2,-35,-17,18
QgAfXILVKDaBEPNYJUReGOcHMZdbCTWSF,XCABVCAC.KAGBBAGA.EEFA..PHDAJFAC..eDEFhAAAGAEAHABCdDCECBHH.SHGAhAAAFHDAAIAA.LFFGhABADGGG.aCGEUAEAOABE.MEABhACA......hAEA...,1,-16,-20,4
WJfIDecaQFXVHYdGBMObUZNPRKETACLSg,SFCHJFEG.DEFHaCFG.FAAFHCFCGACHBADD.OCBChAAAUGAHZGEERGEAEEAE.CABELAFChAEA.gEGGhBAAWEFEeCCH.XCACdGBC.MAFAhACA......hADA...,1,-3,-29,26
HBXMQgRAINWeYOVaCbDEKTSGdcPUfLZFJ,..IECDNCBF..eGCGOHECCEEFDIGGKEEC.GDGCdCHCUFGGhAAALDAFZAFB.HBBChAAABFAGMBEGQDBBhABAAGCAWAHB.aACC.EHBEcGDG...FABGhAEA......hAFA...,1,-15,-20,5
KZHVXWEgdNJFaSLDUCGYRMebAOQBTfPcI,BHBHTGCB....fFECIABCKEBAZDDCHABE.XBGGhAAAEBGFNEAC.aHGADEDAhAAACGAC.RFFBeBDAAAEC.OBHDhADAPDHF.WHDGgEGBdDAH.SDBChAEA..hAFA...,1,-15,-20,5
QePEJISgbCLOZMcHRUfdKVBYNWDGFAaXT,aDABQGDG.EBEGIDGF.SGBHgBAECHFBZABEhAAAHGAG.UEFEKBHHBDCEhABAWDAGDDFCAFFGTBEHhACAPAFGLFEA.cFAGfGHAhAAA.dDDANEIG...hADA...,2,-27,2,29
IFcBQbHMCaTLfKdOGARXDWSJPZgENVeYU,RDDADFGF..JFCFZEBG.EGDAeAEG..UABAFACHBGAFQBEHhAAAHFFE.MBIBCEBF.aHAELAADhADA..dDBHhAEAAIFC.SFHDNBIE.IAGA.hAGA......hAHA...,2,-32,-21,11
WZIgFBCdMfRHNSTLaeGODVEcYbUAQJPKX,JDEGKACHZFDD.FECDBBEG.MCIDRBEEHGAA..SEDGhAAALAABaFGAOFAB.ECABhABAbCCC..AHEFXCBFhACAIAGB..CGGE.fGFANAIC.eAEGhADADEAD.cFGF.hACAYGCE.,2,-26,-9,17
WXUKYZODGPSfdcFECBVTIQgHbeLaNRMJA,XDEDUCAFKCFFZFFGGDBC...SADHdAGAEABFBHDETBAHhAAA..QFBChAAAbEGDaGAF.RDDBAHHGYAFHhABADIBE...PAHF.fHDFhACACFAD.IDDFhADA..,1,5,-36,41
VIXaBWdLKQDJgUSOcFCGPbeAEMZfTYRHN,EABCMIECZGCA..TCGDRADCHEFB..VCAEXDCE.BCFBhAAALFCGDAGC.UAGFhAAASBAGOFABCAEFPBHBhABAAACDfEFB.IEDAaEAF.hAEAKGHB.....hBIA...,2,-19,-13,6
NYXbHSACGeaRcWIdUQgfDTJPLEBOZVKFM,CDCDGAGGRFCG...ICEEdAABQGFEDBBC..TGGHhAAALFADOFADKBGDMCCChADAXEEGSDDEhAEAAABAeCCFaGED.WDAFfCHA.JHBChAFABEHH....hADA...,1,-20,-25,5
ZLTKPFIbDHVMYRNQdXUcefABgOWaGJSEC,BDGEODBDaBAAGDGA.EADHLDCE.KAFGFAABDFGHVGCAhACAMIAGRBEC..dEDBUFCHhAAAeAHBAHHH.JFAFCAHE...hABA.....PDAHIDAE..hADAYFHH.XACBhAFA,2,-33,-15,18
dMfaHTQgbFARCODeUJIXLPEBKVZWGcSYN,OGEEeAAAUCED..ICAELEHHEHCEBDCD.ZFBEGAAFhAAASAHDdAGEfDDGhABAaFFH.TDGBhADAQADDFBEDAIAACFFCDFACJEABKHDA....hAAA......hABA..WDCD,1,-7,-26,19
ZcgJDfWARKdaPVGHbYLeOMEFINTXSBUQC,KFFDdDCGaGEFGAEB.HDDALEADMECF.FGHB..IFABhAAAXACESACChABAQBFFCDHH.ZDEAJHFEWAAFhACAADCC..PFDH.bBBCYHAGEHAE.hAFABFFB....hADA...,1,5,-23,28
RJXQEScUCVdZWNHBAgDTIFabMfOGKLYPe,TCGHFDBHMGBA.GBCGLDCH.eBBFJHCA.QGFHhAAA.SCFFhABAUFGEdAHCNACHAFFADGIF.IAGGhACAaEEG.OEABKABF.PADF..hADA...EEHH.CGEF.hAFA...,1,-8,-31,23
JNOQcPZHEgVCGBRTYDAWSbKaedMFUILXf,SBGCKGBDeCFEdGDAMFAG..UABEXBAA..JEFGQFDDhAAAZAEGHEACEGHFhAAAgGAE.VCGFhABABDDCTADAAEAAaGGB.IHHC.fDCHhACA..hADA.cEEACEEF,1,-3,-25,22
bFfcNQYRKJUDXeZEMLCOgISWBATHGVPad,HEFDVDAA.dCEC.FDBF....fAGFNGAF.QGEChAAAKHAEDGIFeACDZBCCECGHhABAMDFEOFEA.SFBAhACAAAEAPHCCbADAcGAC.YEHBhADA.JADE...hAAA...,2,-28,5,33
fPKACQdLSBEOJYZHeMbXTgUIDNWFRacVG,QCGDLBAFSEDFBAEBOEEDZFFAMECB..TGCHhAAAUBGEDEGAFEBBRCCBVBDEhAAA..fADEhABAAHHHCHAAEFAF.JHFE..YFEFeAFH...hACA......hAHA...,2,-20,-15,5
YgaJKMGXeEdVbOBNPLCUQSWRcAIfZHFDT,ZDACHCFDDBFCTDAF..aGDGMHBGGBBDeACBEGAHdGGA.OCDDhAAABGHGLHCAhAAA.CFAFSCGDhABAcBAFAAFGFAGE.YFCAKEEG.....hACA......hADA...,2,-27,0,27
YEZVFUfeNbKgIRPBLOHQSAWaCTXcGDMJd,aGHBTBCBGEAH.DBAFdAEF.ECGFZCCCFDEDeCHFKGGE...IHAGhAAARDAABHEBLBHHhAAA.QGCEhABASAEFACABCHAEcGEC.MAGD...hACA......hADA...,2,-20,-17,3
BIWEaKQdPJAHSZbCeFUgNRXLGOTcYfMVD,SBBEZCGHeFFFFBCAUCAC..RBAFLDDFGDEHOFCC.hAAATGADfHBBhABADAFGBGHDIHGFEBFEaDDGhAAAdAFFACIH.CEEA..XEACYHFA.WABEhAIA......hBAA...,2,-22,-14,8
ZEXdHFaefgGVcJbLAOMDQWKNUCBSIPTYR,MCDFDDEEQDAEKFGC.UFGFBAAB.SACA..hACAIGAETGDGZAFDhADAXGCEFGHDeEECgCGBhAAAVFAD.JBBCACIF.OHFECBEA.YADChABA.EDDB..hACA...,1,-18,-32,14
KfSdOZeBHMGRYUXcbQCETFPLVgJDWANaI,aDDCKFAEdDFFZBDC.HEFAREGH.UECG..XAGFQABF.CBHA.hAAAEAAAFBEGLGBChAAA.gDAEhADADDCEAHHBIHAFSGEHBCACMAEG...hAEA......hAFA...,2,-24,-24,0
MFHJKgYROULXZTNeEWBCfGVcPdDISabAQ,QGCGFFCHKADA.REEFUAFCLAHF.ZDDHeEAABEHDCBDEGAAAhAAA..VBACdGGGSDDBhACAaGEE.hAAAAHHEMAIH.JDFAYFAF.XCEBhABA.EHGC.fDAEhACA,1,-15,-28,13
AHPbdINDXQZKgVWLfUcOMEaBJTSGCYeFR,HCAHdGCHDEDAQGEBKADA.VDGHLCBBUDDD.OAFGEBHBBABDhAAA.SAFChACAGDGECACCFBGEACGH.IAAFhCAAXGBC...gACHfFFGhCDA.MIDE...hAIA.aECH.,1,-7,-27,20
GDTCVKZMIQfLebOYESPWXFdRagHUBcNJA,DFDDTABGKHDGZEAB..QAEGLAFH.ODHBEBBE.PGEChAAAFGFGRBDF.HDAFBEFHNCDEACGEhABA..CADC..MBABhAAAfHBF.YAHHSCHFdEEB.hADA..aHAE...hAGA...,2,-30,-8,22
UEAJQPYBCIRLcHGOFfgZVDKSNadWMTbeX,QEAABFCFCGFBLDBCHABCGAEC.FGFBfAAEhABAVDGDSCCGdAHEMHBATAGFhAAAXCEBAHHBPBABhABAIEGDOEEBDACAaGAHbGAA.eFHH.EAEAhBCA......hBDA...,1,23,-26,49
McOBRSIdUJVQLPKEGHFTANZYDbfWaeCgX,.ZAFGDACB....fDBHaGBACFDE.MFEGBDBH.SAAFhADAdCGAJBBCLFAHhAAAEEHHGADDFGGHAAEB.NCIG.WAHBhAEA...gCFA.cGFChAGAIDEH.QGDDhABA,2,-51,-19,32
SLJPeOKdMHbDXBQCURGENFcZfIVWgAaYT,aECDTEBBLBFH..JHCGeBCHKBDEdAACMFHHHFFEDCHFBHBBhAAACGAFGCBBECAA..FGFBZAFFhACA..IAHFhABA..WHFAAGIFSGAF..OBHFhADAXEEG..hACA...,2,-27,-12,15
beWQIPcTMXNdLURZFaHOgAVSDBJYKCfGE,SFGAJDHF.KBHFCBEDECAF..eFBCQEAH..hAAAcAEEMEDCdBGFLCDGhAAAZABFFGGDaACAOFDDhADAABAFDEEGBDHH.fBBGWHAG.IHADhABA.XGFGhAFA.,2,-38,-24,14
VQDcgPSWRNOUIbAYGMfdXeEKHTJBLFZCa,MCEFdEHCECAFHEGDBFBCFDAEZBBB..aBGBDCGE....PAAHhABASEFBRFEBOBHD.hAAAIGAHAAHEGGBFeFCHhACAJDDH.CAFC..........hABA......hACA...,1,-4,-40,36
DeSWMRbVFgaLEITfcKQJHZCYONAGUPXdB,UDADdFFCDHAAeFHB..SGDFMABARBCD.FECELHBA.hAAAEBFDICDA.hAAATCAFfGGEhAFAQABFJAHDCFFCNEEDGAEFBFDD.WHEG..hACA.gCGChAEAaGAG.KFAA.,1,-7,-30,23
ODAMWSUBHcJdFXGTCZPNQfIeEVbKgYaLR,SCHDBBDEHAFBdCBGFFDAGDACCHEGZGFC.QCCGeFBE.EFHFhAAAKDDH.aAABOABEhABAAADA.UAGBJDHD.XGFDhACA..PFABfGDE..hAEA......hAFA...,1,-12,-28,16
HbfMIGVJLDBZSaeTYOERAcFdUXKWgPNQC,dFEEKBBC.....PBEDQBEBHCAHMHAGIHAEGAADhAAAJDGDBHHASGGGhABAaDCF.TBGG.EDCFhADAREDHAIDCFEGCXDAHNGADCAFE.fFHAhAAADIDE.eGAE...hAEAOBAB.,1,14,-20,34
CUAgaPZMNbWdQSLYTJKRGFfVEeHOBIXcD,aCBDZEAHMEED....NIEF.dGFGLBHFTBAE.KDECFADGEFAAeCFAhAAABADC..IAHBhABAXEEA.DDDDCECCAGHHhACA..PHAG.QAED.hAGASFGHYCDE.hBAAJAAHfDHC.,1,-16,-21,5
fGWPRVAJMKTgdZIBYbQXcDOLNHSUCaEFe,KGEFTBFCZABBBEFD..QDDGDDDCLBGFNBBF..HFAFhAAAUGAFEFFE.FDAB.fHEDhABA.WDCDhACAVFGBAIHC.MBAHIDHBbEBG...cAGAhADACDHBaAFG....hAEA...,2,-32,-14,18
UOVMECaFLIZRcSPdHGKJNbDTWXAQBYfeg,BHGEeFAHUEFCMCCB..CGAF.FBCELFDCRFCH..SEAEhAAAdBDCKAAE.JAFBDBID.XAFHhADAADEF..fGHChABAODEEaHBEZAGD....PEHDhAEANBIC....WACChBAA..,2,-40,-22,18
JHLcBgMDOVFQXUSbKYdaNTERPCIGAfWeZ,eFDFHBBELCFFBCDDDHGC.VFBHFBAB.QGEA.XDAGhAAASBFH.bEBFhAAAdDDG.NACFEAHBCHAEAEHG.fGHChABAZFEB..cAEB.MAIBhABAKEGC.....aEAHhACA...,2,-38,11,49
PIWeMCODQfcYHSVLKTZaXFBdUREJNgbGA,..IEEEeECHCAACQAGA..fDABHBCASHDGhACAVBFHLFGDhAAAKEGHZEABaEFHFABDBGABhABA..dBBG.EADENIAB..bECDAGEHWFHHMAEEDFIDhADATCFC...hAIA...,2,-22,1,23
LTfaKBOSbYUGVQFEMePRZIXgCcNAWdDJH,dFGDDHGGHBEGLFCDaEDB.KHDCBEBG..OCAASCBEUAGFQDAGhAAAMHAE.hAAAeDEEPABG.ZFFEhAFAIHAGCEHFABID...JHFEbFDH..YABGhABA.FEEB.hAGA...,1,-10,-24,14
IBWTPaMfYdHRSZOcQEeFXLbgGKACNDJVU,DIDGUCEFBABA..TBBHaGHD..MHEAdFEGREAD.ZFCF.QAEBhAAAEDACeEDGXCEFhAAALFGF...bADChABAKAHD.AABANCIA..IBHA.fHAHhAEA.SDGEhAFA,2,-28,-25,3
bXGQICZSgPOdBYENFAfeVHJLWRcKDMaUT,VDGFHBGHLDFH.REBCDAAFUBCF.XCAHIFHECHHEZAFAhAAASGAD.OCAEhABABHCD.EBEHAACGfGDHhABA.eCFFcGBCKGADaGGH.hACAbEAA.....hADA...,1,-16,-24,8
ObdfXVACTRGHEFLUPYcZJQDWNeaMSKgBI,TDCHRCBGHAFHFFHH.LEFHUGFF..PHBCZABGDBIB.eHAChAAAMAHDKHDABAAG.IADBhABAOCAHfECGhABAXBCCCAFHEFAG.JEFE.....hACA......hADA...,2,-20,-16,4
bCBETHeNWLfIXaKMgGQJPVFOZURcDYASd,SFBECAFCBDGCHEGFeECELEAE..IGGBaACG.MCCGhAAAQGBCJABGFGACZAFChABAUBBFDCGHAAIDbEEDEEGC.hAGA...NIDH.fBFF...hAHA......hAIA...,2,-19,-19,0
YCGPdbUEJVTKBFaXANOWIgHcRLMSfeQDZ,OEAH..IHEBHCCHRCFALHEGMDHDSEAAeAADDFGDhABACDEGdBGFEBEE..TGBFhACAFBCEABBG...WADChAHAcFBD.ZAEFYFHHPBAB.JEEHBFFDhAAA.aHAC.NDIE...hABA...,1,5,-28,33
RdSBVMZaANODHQYgKPTWbIUJXCLfcFGEe,OGCCHABGQAGGKDAD.TFCF..bCBAIFFGhAAAUBFDCFEFLBAAfCABhABAFGAGEDEG.eEADSFGGhAAAMEIHABFCDHFE..YHFG.hACA.WHEG...hABA...,2,-36,10,46
cPNWATCHGabJQKUXYERMdeLVFfSZBIgOD,CDEFHCADGGBBJCEBUCGH..EAHHRFGF.MBBGLAFAFHGE.ZECFBFFFhAAA.ODAADABE.hAAA.PHAEACCGTEAEhABAaGFH.QEGG.XAEBYBBChAEA....dCGH.hAGA...,1,-7,-18,11
aJXMKOVPNRfBQZbLAYeDdCHESgIGWcFTU,DCADdCFFHGFCEEBF.SDHHGBEEFGFGaAGA..MBBAKDAAOADBhAAA..NIDHBEGBhAAAZEDBbFAGAAFECBHH..IABBhAEATGBG....XCCBRDFFfHBBhAFA.....hABA...,2,-35,3,38
TVNbePdUELGQOFgMCWZaABHXSIKRJYfDc,BCGEHDBEXACDKFGERBAB...JGDADAEE..VBFCeEDHdHABEFFBhAAALAAB..hACAOAHFMDIDCGGBaFBGIEFFhAEA.fFABNDAG...hABA.PHAE..hACA.QCCGWHFA,2,-28,-6,22
HeNgIEdTBZaQDfcSVbFMKJWUCGRXPOYLA,eCEE..IEFDTBADBAFFaAEFDEBB..SFGDhAAAFGCHKBBEUGGEREBBOEDALCDFhAAAAAIBHFDBEBABQAGChABAfHADcBGFbCFEMDAFCADD....hACA......hADA...,1,-10,-16,6
TLBMSWFZINXDagAcROHCebPVQdfKJUGYE,OAEDeAAA..VGCCdEGFJDEFGDCD.EAEBBCAB.MDDHSGFHhAAAFAHF.ZCGFXGADhAAAgAGEAGHCRABB.hABACCCGQFAF..fEABhADA.KHFE...hABAYAGF.,2,-27,2,29
PEBgCUTNebQcLJHOVKWdRSfYXFMAIDZGa,DDAEGDBBEGAH.BHFCUGCEeAAG..QFGFJCGDHAEFOEHDhACAKBFBdACC.RGBA..SDADhADAfCHAXAGEhAEAABAEZEEF..PEAACHHG.....hAGA......hAHA...,2,-26,-12,14
JDKeBAXcIPWfCSHMbQgdRFOLENGVYZUaT,XAAC..PBECCCGDHFACMEGFQEGFdCBHRFDBLDHFhAAAEADBGDDAZFAFaAGADIBEBGHHhABAAIHC.IAHBhACAfABBSAEEbEBB...OHEEhBFA.....hADA...,1,2,-22,24
YgGKNDXZBRebHPOAWVCEFJMUQLaIcfTdS,VEACFFGFMECF.LABGaBBD....fHCBdAGGSFDBhAAA.GCCBhACANEHEDGGBBAGAeFAB.bDEF.hADAOBHDAIGCCDHG.EACE.UAEC...IAAGhAIA...hAFA...,1,-14,-25,11
gKFITSVEULQbeDCdRZYXWfNBAHPJacOGM,HBFDJCBA.ODAFGADHMFIBKHDC..FCGESBHH.VFDEhAAAUEFGLBBGhABAeHAGDBAHCHFHRGAAZEAA...hACA.WADCNAADBHFHaDDB...IHHEhAGA......hAHA...,1,1,-30,31
KbXDUSJCPBWdEHeAcLfQZVMgGRNFOaYIT,LCDBQCAAVBFCMDIB.GEECFGGH.OAFEaEAE.IHCEhAAA..KFHBDCGGhABA.SDCHhACACHAEBGEBWBAHdAECEGAAAEHDZACENEHC.....YGAChAAA..XABAhAGA.,2,-30,-12,18
cMNgLTRDFXOKIdAHaGSCWbYVeEfJPUQBZ,HDAGaEFEGFCBCBDE....bGEEVAAEeDFEEDCE..JFABPCEAhAAAUGCGBFGC..hAAAMEIHLCACDFACFAGGhADAXAFAIAECAAFGSEFFWHDG.hBIAfABF.hCAA...,1,-9,-17,8
edJWLDYcNOIUFfXQKSgaTZVGAEbBCHPMR,BHCEHDFFMCCCdDBHLEEFDGBH..NBAE.UBFH.FGAG..fEBFhAAAQABHKAGChABASAAFaGHHZDDFACHEEGCEhACACFGA...eHDAWADBOBBH..hADAIHHE.XDGGhAFA,2,-33,-15,18
cSdGAUJTfCXbVOBMYgQEWZNIRFKPDLaHe,UCBDTDGFCCGG.....XCBDOFEHMHAEQFAF.hAAAZADHIFGHFHCAKABDLBFGhAAAaAGF.HFEChACASAEDAFEC.fABHBHHF.hAFAEFBA.NDIEDBAD..hABA...,2,-45,0,45
GFIgBVUabPEeAHRdDQcYZJfWCLXNTSMOK,HDFHDIFCQFDEZGAAJCDG..CDBE.LCEG.XGAChAAANEIC.MEACKAFGIACFhAAABFBBUFGB.PACBhABAAFAAdHFH...fDHA.TAFBhADASEED.OBAChABA.,2,-39,-10,29
AeKDXMaEVBOgUQJbdCSPWHLFRZYfIcTGN,eCADXCDGEEHDBFCDUACF...QAGGdGFCCAGE.SFEGhAAAHFAE.FFAHZEECYBDFhABAcCFANAIEKHDC.hAAADBBH.aGHHOBABgCEB...hABA......hADA...,1,-4,-23,19
ILWFZcGaMUYQEVOfRPgXJDKHeTNSBCbAd,LBACZFAAaFFG.UDEFEHAE.OHEE.RBEA.PBED.JBAEDHAGhAAA.KDHB.eDAHSHEChAAABHDFAFFH.dGGAFADAhABAMDIH.QDAEfGGD...hABA......hACA...,2,-26,-24,2
MNUGJAPcLCQSHWBgVETXfYRDOZaKeFIdb,LEACCHADHFECBHHFEBGG....XDGFfBCERAAAZFEDeBFFhAAAdGCDMIAGGDAFAGIHQCDFhAAASADEWBHFhABA....gGGDYGACDIDGhACAKFAH..FADANCIA...hAGA...,1,4,-22,26
bfTNZREYgSGXACaIUFOKdHcQBVLeDMPJW,CCEBUDAGFEED.dDEGHGBGBGFDLCGD.MIFAJACG.....hAAAbAAFfEGChABA.ZGAEEEBE.gCCEhADAXBGAADDHIFACKAGC....hAEA......hAFA...,1,-25,-41,16
cHNbTEYMUCDAIRQOXBKdLafZFPGeVgSWJ,QCCDBGAEKGEALDCGaAED.ZCFHFCGHGABHeFFE..SBADhAAAJCAF.NIBD.EAFEhAAAMGAACHCD..DGIHAIHGIBHDhABA.OEBEdAHEfDHGhABA.....hACA...,1,-25,-26,1
CGKHJIDOecNfPBXESZVRWUMFTAbYaQdLg,aCHDQBABLFACCFEDGCDDHFFEDCBBOFAEeAAG....fCDDhACABHGGEAHHSDAGhAAARGBGMAEGAEEG..hABA.YDHBKCCDJBGBIHHFNHAH..hADAXAFB..hACA...,1,0,-25,25
OXdTVWMfDFIRHLJCQGgNPeacBYEbAUSKZ,SFAHOBCEdBBC...TBADVEDF.MDCHDAAA..FCGFRDEEHAFEhAAALHAEJEDFCADBQGGAhADA..NIABaHFAhABABAFFECHDADDEKAGA.XEAG..hAEAWFFA....hACA...,1,-16,-19,3
cBFPGdKEDMVQWALbOJgSHaIYeTCfRNZUX,LCHDJGBGHAEF.aCBHeDEB..CGAARABCZDAC.UABFBGHEFAHBdFAFDGGAhAAAMCDG...VEDGhAAAACCDOHFC.SGAFhACA.IEHAfAEB.hAEA..cGEE.hAGAKHBAEHDCWDDC,2,-26,-20,6
CfeSUJHANVQGPLEYBbaWMFTIKdDZgcORX,QBGHGDFCEBECBEAHaEEF.FAHBKEGCDGIFZCAA...OABChAAACEDFeABCSGAEhABAHGCAAIEG.PAEGLAAFhAFAbFDH.MDCEdHGF.gGAD...hADA......hAIA...,2,-14,-9,5
BNbcAVFdWDLUXfOCZHRKYJTagISEQMGeP,VAEBFCDBDGCC.LACCUGFE..OACDZGCEKGGD..JCHHaGAF.hAAA.SEAAhABA.EDEBMEFCGGAHhACAPBAFBHHB...cAGAAAAEXBFDhAGACBBF...YAHHhBAA..,1,-24,-30,6
MEgGVYNJDCPUfROaZecXSbAHWdBQIFLKT,HBCGdHCDQEDGFEFDLHDAMAECGFAD.VAFEJBEHCACHUDBDhAAARFGFZAAH..eEHHSCGFhACAAIACBACAIBAEhABAKFBDEDHB..........hACA......hAEA...,1,-6,-19,13
AWHOIPTcLNZMabJDeKYfdBSQGVCRgFEXU,OEFFTBEA.LDBHMIEG...JAECeBHBKCHB.dEBEBBBFQFGBhAAACEDE.FBACEFHDhAAAADBGIHAD.hABA.PHCAcEEBaFDCDADHSDDEhACA......hADA...,2,-38,-15,23
PgJdYNKTGUcbALBeIDRQVaOEMHFWXfCZS,LBCGBCFDeEBHDCGARAAF.QFDF.OAEAMGFCFHCC.hAAAXAFBCGGAZCAHPDEAhABAJAHB..dEGHKHBAGDDChAAA..........hACA......hADA...,2,-28,-26,2
XADaRCGgfPFTdSbLIEZcHVMUKWQONJBYe,aGEECEHDGAFC....fAGATDCHdBAHSCEHhAAALFBGIHDBEEBFZFGDcCABhABAMBIHKGGG.QBDAhAAAOBBABHCBeDAFAAFDDGAH.gEDGhACA.FDGE.hABA...,1,-5,-15,10
KVRaDUQBWdPJXEOMcZHAgeSYGFLbIfNCT,eDFFGDEDLGAE..ICDECAADKACGRCDH.UFFHBGGFdEBD.hABAXBAGMAEGZAFEAIHGSFADhAAAFCHB.hACANIBH...aDCBDGBGWEHHJAEG.....hABA......hACA...,1,-22,-25,3
dKYHCcQBJfOGMTWeFVESINXDRaLPgAZUb,ZCFHUEFBdHGBHDBGCECC.BCBE.OFBCTBCAFADB..EHAGSBFEhAAA..XFEChAAADBIHaBAHLHDAhABAABFAbDABKCHB..YAFCcGAC...fABAhABAMAFCeFHH.hADA...,2,-34,-9,25
VFgPNTGBCaQfbdEOSWLZRcJeAYDIXUKHM,DFHHUGCBHECDFEFG.....gBCETBFABAHDQBFFhAAAdAAGEDCA.OFABLFHBhACAZBAH.JEAHACABIGFHhABAKGGF.MEEGNBBBCFDC...aAEG.fGBChACA..SCCChADA,2,-21,-20,1
HgeZXWOSbDILGTfUKFARPJEBNQacCdMVY,JDAGEDAEBEHD..QCFDaBFC.CHCD.VEDEHFGHZGBAXEDChAAAOAFG..DCCAIADAhABALABGTFAChACAKGGBADGD.RAFG..NCBFdGEA..MBIF..hAAA......hACA...,1,-6,-27,21
NKZgEGXLbAdQeCYOWBFcHPSfVIDURMTJa,dEDCeBBCCGGH.OCEABEFBHGAA..PEACSBCC..hAAAIEECDBFCMICAJGEEhAAAaDAAKGAE.EHBA.XCDGhABAAAGC.WAEEfCFD..hABA......hACA...,2,-45,-21,24
JbTGVHNWCIcBgPfQXeEARZdaUYOMSKDLF,RDGDdGDFUFDDMCCG.DIGCLCFC.FGGHJDBCGEACHCGHCHBABEEFhAAA....PEABhAAAXABA.AAIBaCAGhABASADE.KGGCbAECNBAD....IEFAhABA...hACA...,1,-24,-29,5
bcIGWZCANQVgDdSaEfYHBPMReLOKJXTUF,VEGFdCEDaGBF..EFEHHABA.MEGBRFBDOAFEKEEH...JDDDXEAGhAAA..TACBhAAAFEHBIBHHhABAZBAHAIEA.NIDFDCDHSGADfDABBEAD..hABA......hACA...,2,-24,-14,10
fLFXAdIQWVECUGHMbaNeBJcOKYTDRSPZg,dFGBQBBFEACBGAEEHEBA.MAGDaDAGBAGCJHFG.KEBBDAFBRGDA.SDHBhAAA.PHAAhABAfBHA.hACAXAADIFFHCEDA.bADH.eDAF..hADA......hAHA...,2,-22,-9,13
RJXPZUBgdLfDOHEaSMFKAQGIceVNbTCYW,GBCFeHDG..VCGFbFDA...CCEGREEFXDBD.ZBGHBDBHhAAAdAAADGAGODDB.EGGEhABAMIAAKAFG.AAFHIDAAhACATACC.JFHDUFAF.fCAAhACASEEC.....hAEA...,1,-10,-20,10
KYeUZRFbHdMWagQSCfVDLAENBXcTJOIPG,EDHDXCAF..TAEHJAAG..OAEGPHAAGCFG.hAAAKFCFUCCHFECAdHBDaFGFgAGHhABACAHA.hAAAfABFDIFAACDBBFHGcGEG.IEADhAEA.eDEH.hBDA...,1,-5,-31,26
gEeRZMfTINKOdLaXQWSJBcVYDUAHFCPGb,CGEAGCBF.EGEEZBBGMADATBFD.KAECdDGH.LCAF.hAAAaBEGXDECSFCFhAAABHBH.VEGHUGGGhABAAHAEHDBBFHCE..gAGHfABF.hACANIED.OEEC..hBAAWBAD.,2,-35,9,44
dPUfRYgBJDAWTbcNCGKLIXaFMSVZQeOHE,TGEF..bCDCCDHHGEBHKFCBLEHH..aADHMBCFSHBAhAAAZADCQFEChAAAHAFAEBBFdBAGUGGEREAFYAFChABABFADAEGFNDDHICHB....hACA......hAEA...,1,-6,-10,4
FSMfYAOgcJZBVKDTHWEeNbUCLQdaRGXIP,OEACJBCDZFEA.KBDFHCFC..eGAGUGBBLEFFdFAFGAEHIEHChAAAFBAG..MIFAhAAAfCBG.ADECBGDEhABADFFG.EAECCDED.aACB.PAHF.gGGHhAEA..hAHA...,2,-25,-21,4
VcbAPWgEaIGUXTDCQeSOJHfMKBNZdFYLR,...PEFHgFGB.EEADaEADUBBHXCFFDGCB.CADA.QCFGhAAAOEDDJBCHMACGhABABHGEdDECLAHBhAAA.RGAC.cAGHAECBIBAAeECB..fHEFhAHA..hAIANEICFAFC.,1,-3,-18,15
eBEfFJgYcDVbOLdCRMXPITQKASUHZaGNW,SDCHUFEHHDBGaACAGEAG..eAGBEDHFFFHD..JFBHgAFAhAAADBCBODHDCEEAMCAEhABA..IBAChAAATGEHADAEZBDABAEFfHGF..hABA......hAFA...,1,-14,-24,10
OJFAgMBfHcDbGPTNEKVYdaICXQSUeZWLR,MCBGBFCBHCGDDIACGFCFTFFF..KGHDdACE.aAABCHDD..SABChAAAZAFG.RBFCFDDEhAEAfEAG.PCDFhAEAEFACIDBBUGCDWFHHOADEAHAE.cDFDhAGA....hAHA...,2,-27,-8,19
HUgSLZAEDQRBbXOKdfNGJYPCcaeTFIWVM,QFBCBCDBOFFHKDFEdFCBGBCH.JDHDCCHBeHBC.FBFGIACEhAAA.VFEDhABAHBBF.SACEhAAAAAIBDAHH.XDGDNEAC.YFADaDDCMBBDhAEALBAF.EGGGhABA...,1,-10,-24,14
XIKVJNUPfdBeQCWcTZOGgAHYMabSFDRLE,HDACaAEC.SDHHREEALFCHECCG.XEEGKCEH..VAABhAAAJAFFUGGAdCGHBDAGCHBCTAAEhAAAOFAH.AGIBMIEAhACADACGIHDH.fAHG.hADAWGAC....hAGA...,1,-17,-22,5
LJOCKXfYWQFDaSgHZETABGcNRbPdVUeIM,GDGARGCAdFGHUBCHeAFA.MAACLAHD..OCFGCCFA.fBBDhAEAQDBBaDEFhAFASGBFHDBDTGEFhAGABBAD...NIEH.......hAAA......hABA...,1,-3,-36,33
gIHeSdKCRfVUbYAEWcPLFMTZDNBOXaQGJ,EGGF..PBFEMFDEDIBEBDAG..XAGDaFBFGCDC.JFHBhAAAIBAAHABDSDGDhABAKGECCDBARBDF.fGAGhADAbGAC.AAFHWHDCFDGF..NAAD...hAFA......hAGA...,2,-25,-12,13
CNWUdAIGePbOYQEcDSaLBfgRVZFTHXJMK,eDBAOEACEBBCDAAFLFBEBFGA..RCBEZGEATAFG.HGDGMAHHhABACAEC..UDGDADADGCEGhACAPHAC..bGACcAABhAAA..aBBGfHGF..hADA......hAHA...,1,-8,-27,19
HCAVUZMPWIbDedcJYNEQOagXKTRGBFLSf,UABHMIDE....IBGCeAHDdHEH.JCFDEGDE..QGAAhAAAaBCGKDCAGBEEBFGASEEDhACACFAEZAAB.hAAA.WDHDDFBAcAEDYHAE...NAEHOEFDhADA..XCCChAEA,2,-27,-25,2
VegUbQAdSFDLHIaCPWcMYXENZBGRfKOJT,FEEEHGEGCAHG...PFAAMEAE...XAAHZBDCRGBG..KAADJAEEhAAA.eFDFUGGHbCBAAAFA.hABA.DIAGLCHBhACA.IHBFaFBG...WDAGEADGBCCDhACA.....hADA...,2,-34,-14,20
UbNYSZQfcaKVJPWXTdMgLARGOFDCIEBeH,RFAFGBBDOGEEDIAE.EEADBACA.HAECUDGH....YEDDhAAAQGGA.aGCEhAAAVBAB..JAHBWCHFhABAdBACMEFH.AFDFCAGF..ICEChACA.NIDH.SDEFhABAfFEHKEBE,2,-32,-10,22
YTQGbVcRBCZDeIgMUPKOSAEfLHJFXWNad,LCDAFBDG.XEECaEGHdAAB..QGAHVFAF.BGCBhADADAFCeABAMIFAKEAEACIFEGEFhAAAHEDD..JBAHNDIC.hAEA.GCDFcGGHCAGF.ZAFE.IECAhABA.PDHBfBBEhAFA..,2,-15,-8,7
VPTUQcWMdARbCeDNJYZIGfagEXLSFOHKB,RBGBeEFFDGHF...JCAHZFBAGEBA..aHAEXAGGFACGHDCCBDHGhAAA..TBAAhAAAUCDBQGGBhABAMFIDdFFAAAGACCDFIBBF.EGDFOAFB..hABA......hAIA...,2,-18,-14,4
gUPXMaFJORKdBHCZYecfEVWLGQbSNITDA,UDEBMADHFFBAOAAF..RGDAKEGDBHHDZBGFeACD..EDEFVAGFhAAALBBB..QDBHhADASAEBIFHDhAEAAHHHXGADJFBBCAEHfBAE.hAGAWAHB....hAAA...,1,-21,-32,11
CYHQOKEaRGPbdZLBWNgIUTfeSDMXAcFJV,FHGACGADHBFEOBEEKHEE..RDBE.GDAB.dAAABEFA..gFFChACAICAETFGAhAAASDGA.XGAChADAAHIDJABE...YFDFaFBC..PHBEhABA.LAFEhBAANDDHfFADDDDC,2,-18,-16,2
CUPcOBEIQTfGedZYgXRKLVJWHaNASMFDb,FCBCDBBDCGGDUGGF..OEEFEEAF..QFCDGCCBdEBFZABA.hAAA.XAFAKBGBLEEAhAAAJACG..aGAEAIDGSAHBhACA.bAEHPDGDBGAA..hABA......hACA...,1,-15,-37,22
gESATZfbOWcUPLIaGHKdYQRCJVFDMXeBN,TBAAZBGFOABH.UDCGLDEG.IFACHGDEKGABQADHhAAACAEEFCEA.DGCHMIFGhAAAeEHFBEBCEGFBfECEhABA.bFDHPFFGdAHC...hACA......hADA...,1,-9,-28,19
cYBCdHXWMVJeQNAgLDSbREGTPaZOfUFIK,LHAADFDFREEFGBCDaABGZDCB..UBAAKAGBBDBAdEAEHCGB.MIDChAAAJEFG..eFEBAAHCSAFGhABAEGHD..hACATADBfGGGIFAD.CBCDXCFChAAA....hAFA...,2,-28,-13,15
KfFgZPdXSBRMJTHcOebNULVEGAYQIWDCa,QEFDDCEBKBAG.FBDHZFFEdAGCBBFC.RCFD.MEBD.HAAD.hAAAeFDFbDCD.LDFEhAAAEBHF.AAECIHEFhACACEAD.fGHCgGAD.SADFhABA.JHFE..hACAOCCH.,1,1,-27,28
GgJUMRQeKFSfNWVbDdHEPOZcTCIXALYaB,aGBCBADBGAEFUFCERAAA..KDDEFFFB..SCAB..hAAANIEF.VGECdCEBHAGHhAAAECGFOABFZEGB.TECFhABACFAGADCH...LFAD...YFFChADAMIAG...hABA...,1,-2,-33,31
IJdUcZKPESYDOWCeHbMaAVTXFgNLGQRfB,TBCGFAFDLAHB.QEGERFBABEFEJHDCdFAEZBAHKCCE.EADCSHAGhAAA.DAFBhABACFEDeAACHCFCaGHFAEDGgGGGhAAA.fCBEIAGAcEDFhACAPHCA.ODAHhADA...,2,-22,-10,12
cVMXSWLIKDQOUTdHbCNaAYGBFfEZeJRPg,GDACBHBGEHCEJFGDREDC.......gFDAMEAGXABDhAAASABHLDGBhABADBIBUCDFdFAHbADHCAGFAABBFBFChADA.eFHH..cCGH..IAHDhAFAKADC.TGEHhAGA..NAAA,2,-36,-8,28
CcMWHYBTFADdKQLeRXVSgPbfaJEIZOGUN,DDBGKCCAQEBGeADGRFFG...SGDF..gCGFhAAAPADA.bFDDfFFFhAAA.ECHFhABAIHBBZBFDOCABNCCBCBABMCABYFHBBEEBhABAAHCB......hACA.LGAEaABD,2,-16,-5,11
PLabMgUSNEGKOYWVQIDXZeAFJHRcCfBdT,JADCHFAG.CBEDBHEGdFFELDEE..MBIBUDBGSEGBhAAAGGABKAADOCDH.hABAVCAHDCCEXBGEhACAAFECFABARAFD...fHGFTGFDaHBE..hAEA......hAFA...,2,-28,-15,13
RAJGFEDYfPZLKUIBegVXONWdbSQCTMaHc,GDDCEAGHDBFB...fCBFLDDDUAACBHFDeDGB.XBGFhAAAOCGDNCIA.dDBGhADAQEAE.hAEAMBBEaFFDHGAGAAHGFGHDZGACIHHEWACECGFE.hAFA......hAGA...,1,1,-23,24
gfQTMaHeUcGPSZFAJWbBLVICKRNDYdOXE,JBFABCCFLBACCAFA..RDAGDHDGOGEG..EGFGQFCAhAAA.TDAAMIEGeEDChAAAGCCFSHBGhABAFHAAAHIH.VBGF.KFAAYHEG.hACA.XADFaAGA.hABA...,1,-19,-27,8
UGXaKTHJEABbORVIFQfSMYLDPgCdcZNeW,ODDDVECD.FBEFQGEA.MAADDADCCHHD.ZDGD.eDBHhAAAGCDH.XAGHhABAKBAFHGBGABCFBGAA.hABAIAEHSHAGYFFCgAGHhACANBBE......hAGA.aFFH.,2,-30,-12,18
QceMPUWDSYXOaBAKVGRLJICbNgFEdZTfH,GDBBJDBF.CAAH.....gBACdFFGTBGHQEGAhAAA.eFDBPAEHhAAADAEFXAFCOGBEACBDKEGChACALHACIHHFNDEBEFEGfFAChADAMIFE.WAFESDDGhABABCCC..,2,-32,-4,28
fVYZNPEBJQIRdFMUCeDGTLKObAHgXaWSc,HFDCaGCA.SCDD..fACHZAEDPAHDJCFBQEAHhAAAdHFBMBIBUFAEhAAADABBLHAEKDCGAGGG.XCAGhACAVBAD.NIEFBGHCFAGGeAEHTDFH.hABA......hACA...,1,8,-15,23
XeFIYDbVTJORKAMZLcNUgaQHBCGWSEPfd,ZDDALDGFUGAB.aDEHBBFEGDBG.EBGAdCCB.FEHFDBDD...hAAATAAFJHDEKHGAAIDEMAFHhAAA.....hABANCIC.gDABCCADSHEE.fGAGhACAIFDG....hADAYAFC.,2,-45,-5,40
KEOIGaLRfWAceVBXNSUZPbYHFJgTDdMQC,VBEFBFFFSGDF.ZADBbDABHBFFFHDA...JAADDBHFMDBBhAAAKAADEFGH.OHAChABAIFHFLBCBhACAfAGDAGIHXDGENHEB....YFBBhACAdAGBCEEG.aCCH..hADA...,1,-6,-30,24
cdRQWgXISHZNPTYaFBJGfbUVADMECLKeO,MDAHLEECKDCB.OABFdBEF.RFCE.QBAF..WFADhAAAIHCFZFFH.NEIE.TBEChABA..aHFEBBGEhADAfCGCbEAFAHHGCHDG.eEFB.XFCEhAAASBDDYAHHhABA...,2,-30,-16,14
EJGdDaUWZPKRAMFgIXYCSNfBHcbVTQeOL,FDHDXAFFCAGB...SEAGBFEAHBFA..VFGDTEBAhAAAOAHFLACHECEDdACDhAAADEEGaDCFUGGGZFBEKBADhABAAAFBMEABIHCH..fBABhABA......hAEA...,2,-32,-3,29
QJFbHKVXALdCaRGTZUDfWPMeYOBNcEISg,dBBAaHCAGBBBZDGBDAEE.......PEDAMAAEeDDDOBHDhAAABBGBEFAF.SFBBhAHAgFGEQGEHhAIAFADAKCADAFDB.RBEH.fCFH...hBAA......hBDA...,2,-30,-11,19
JVOIHBKSQeYMNLZaWDPXFCATgdEGRUbcf,TAEAdFBHRGFEUBBC....bFGDJDEGODAB.BFDEKAFF.QAADhAAAMDID.ZCDChACADDAHPHBGFHAG.AFIHEAHDhADA...fGFC...hAAA......hABA...,1,-1,-51,50
FVgXIBZEHfOCJeUPcKWYbDRMaANSdQLGT,dBGHGEGEFEAG...XEAGBCBHEFDGOCAE..eFCDUGDAhAAAKEHH..bCEFMBBAhAAAABBFQGBGTGFBVDEAhABAIACF.fAHGCCAF..hABA....cGAChACADEBA..,2,-25,-21,4
RNGZSbfCOVLKUaWgADPHFIBYTEMceJQXd,DAFEFDGGBEHAEFDB..eAAHJACA...dBDBGBBASFGH.hAAACECCLEAHaGGFAAFEHGCEhABATCDHQEDBhAHANICD.ZBFG..fCHG.KEFB.hAIAWABH....hAAA...,2,-30,-21,9
CORJfTQWegXBADVEYNGUMdHcPSabKFILZ,DCDFEEDEGBAAdEBCHAED..SEGCKFFFLEGBCHFFRAFH...fBBGhAAAQFBAeAHFhABABHAAAADC.VACGNDIA.hACAUGGGMHACaAAG....FEDDOAHDhAFA......hAHA...,2,-12,-4,8
OEGcBIUgXNYKPFRZdMbTJDaVLHCAWQSfe,SCGEOBAGGEFGBAHBUBEG..NIEF.KGAE.RCCB.MBADJHCA.hAAADFECLFHHAHBE.hAAA.fCDBhABAEDAGIAHEgEBH.YEHD.hABAFGDG.ZCAB...hACA...,1,-20,-22,2
MWKDXCIfOTVYPAegaSGRHFEBQNbUdJLZc,eFHDSHAEGCCGRAGDHCCFEFBDBFEB.QBAANCFG.dGEHhAAAJFAAZADCMADCDAGAIBHBhABATABA..YHFGhAAAAFIBFCFH.UEGGWEADCBADOGDC.hACA......hAEA...,2,-9,0,9
BGfSeCHZcOIUbLFdYXAaVQWMJREPgKTDN,.aEGEVFCD..QDAEJCAA.EAFFKABEDGEGBBGD.GBEChAAASBBAHGFAOEAHhAEAIABDLBHHhAFAdDEFAECCMICE.RAGHPFAB...NHEH.hAAACEBE......hADA...,1,-18,-20,2
DBNWLaVfXdAEbHGOJYKCeTPZQcgFSRMUI,ECCFHADBGGCDOBBDKDGECAHC...eEDGTEEHZAEGQABGhAAA.FEADMIDGDFIFBFGHhADANHDBaGBB..fAAFhAAAAFCA.bDGB.PDAHSAHHhAEA......hAFA...,2,-16,-10,6
gQUGXcTFEdHLRMSDBCbZeIfOPKAaJYVNW,aDBEVDGH......NHAD.QEBDUBGFGADEXCBAhAAAFEGBdAAEHGCCLFEHhACASAFACGHC.eABChABAIFBHPBEBADFH.YFAF.cGGEhAFA.EFFDDAFGBCGChAGA...,2,-21,-9,12
PCbdfgRXaIMBeZJGYFENDKTLcQAUOSVHW,SGBHVDAH.HGFGCGCCdAGCRBEC..XEDDMDCEBHFA.ZEEGhAAAJDBE.FDHH.DABGKABAhABALAEEAHBDOEHD.hAAA....WBCAfBBH.aFBGhAIAIHDG..hADA.eDEA.,1,-11,-29,18
BdcWQaUGeCRSZTJMYHXObgPNfAFIVKDLE,VGFALECB.BCCCdAEGQDGCGEAGRGFAZAEEMADFHAAAOFDFhAAA..gEEBhAAANBCC.FCFFDABFEEHDhACAaAHDCDACSHCATGBAXEEB.fCAEhACAAAIF.IAGEhBAA,2,-7,-7,0
PaADGJdEMCgZLTefVbWcYQFKIHBUNOXRS,JGEGMBGBZCFDLDDD.eBCGVBAF....bDAF...hAAA.cGAHFGFCIDHGhAAABDDBOAEESABChAEAAHIHDFDF.EHAECEAG.fAEF.YEEAhAHAKCHBNABF...hAHA...,2,-39,-7,32
fZeDSIHEWGdaNVPCUOFbQRXKYBMAcLgJT,LBCFTADH.ZAABeFFFDEAFHCFCGBGCdDDEaCBB..VGEECFACFDDAhAAAQGBFKHAEBHHEAIGChABA..JBEE.fEGEhAAAEFCB...NEIG......hACA......hADA...,1,-4,-23,19
OdAEHbGTeJLWfDQXNFaPMICUSYBZVcgRK,HCEFTGFFLGFE.DFAANDEA.aAACMBAECHCF..UBGFBBFBZBCBhABAVGAG..gCAAhACARCFAdDCCAAEBEFGGeGAChADAJDAB.....WHEA...fEGFhAEA...hAAA...,1,-5,-24,19
YRMfUFOaBTeSdDNIgZHbcKJCWXQPLVEAG,RFBDMBAHUCADFBCFBDDD..eFFEDEGA...IFCCZBFGHFEAKCHHhAAACABD...QCEGhABALFAF.AHBFfAHAhACAaHFE.dGEG.gDAH.hAAA....cGGHhADA..,2,-40,-15,25
IMJBGDNgHCZVaWAKFPSUTYEQdXRcbOfLe,KCECSCEFUCBC.EAGCdDHA.RGBC...OCFCeEGD.MDDHBDDEhAAADBAEHAFGZFFFaAEGAIGCFACEhABA..TCAG.hACAXFBDfFABIGEC..NEFG.hAFACACBWEFE...hAGA...,2,-25,-15,10
GgQTfOZFdbaPEMVBRHNYcAIeXWDLUKCSJ,eFFDDFAEUGABCGCB.GCDEQAEF.ODDFdDABaDHD..MFIHhAAABHHFHCBD.NIBDAEHAhABAIACH.LHDAhAAAKBHHSDFCTBGCZBAAFFADEABC.hABA.RDFH..XBEFhAEA..,2,-14,-6,8
MZXgNGdJbVIBcKWEHSARUfaCQDeTFOYLP,UBDBCFGDDDFB.eFEH.FEAHLFAA.MHCEXGGGGBAHJDAChAAA..VBFGBHADKHAAhAAAEEDHAIGC...aCHBOEAGhABA.ZDDHdBADIADFcEGH..SHBEhABA..hACA...,2,-30,-19,11
RCHPEXVNUSIKLTaWGMQgJbfBYOZDedAcF,RBDHCBBFHAFFECAB...VFDDUFDH.KAEELEDE..aCFEMBAHhAAAQBBFJHACBDBHhABAOEFADBDFAHIH.FHAGXGGFhACASGGFIFBF..WAAChAHA......hAIA...,2,-32,-19,13
aGgTKDEVFNLdeUSOIQXCWPbZRBAYJfMcH,JHBGMFABHCGHGCEDKACH.EFFH..FGFBdABHUEBEOFBA.QCABhAAACAAB.PEHHhACARAECAEFH...cGBHhAEATCDH.DCABNIEDeAEC.SDDGhAIA....IHHHhACA,2,-37,-7,30
cTLCAXgWEaMeRBHdOVNZGDUPKJIfYbFQS,XGACEFDB..MEFGeCDFBDDGdDGBOAFHZEAFDCAAUADH.hAAAKCGCIFGA.hAAAfACFFGFDSAGAhABALBABAAGCaCECHFEB.NCCE....hACA......hAEA...,1,-8,-34,26
XGPcIEKbDeTVUdRYZNaBOLFMQCJASHWgf,HBGF..gFDDfGGHGACB.ICAAbDCEDEADTFBGhAAAdDHARDDE.NCBBBACDhABAFGADCAAGADCC.SGGGhABAXGEDEADGKGCFeAFEYHAA.aEGEMCFGhACA.....hAFA...,2,-12,2,14
TCXBWObYGUNecMQdRZLDaIHFJVSAPKfEg,KDCBEFHB.CGEH.BAHD.OABGGBEG.eAACQFADRAGH.LDFHhAAAaGHDHFAAJDBASBCEhAAAADHF.fEGBhAEAXAED..WHCA....hAGA......hAIA...,1,-18,-36,18
GPAYUdfebJaILRHXESWOgZCFMQKNcDVTB,dEBCeDCDaCFFLFFE.HGECEAAEOBCFCAEDMICG.KAGBDAGGBDHHhACAABAHUBGF..JFDG.hAAA.IDDHXGGHhADASDAHZGAAFAEB.NCBD......hAGA......hAIA...,2,-26,-15,11
XLITdRHDKFCPfcYAgaOBUMQGVEbeNJWZS,ODBCBHFCUFCAGBGC.EGEBeFEA.JACFSACC.hAAAXEDEIBGGTGAFhAAAHDEEDIACFGGHfAFAhABAAEBHaADA.QBCANDIG..hAFAWBAF....hABAdGCACGAG..,1,7,-39,46
LdUOgVETQWBHFDIJbceZPfMARSGaNYKCX,SCBHGABAaAHHKEECCFHB..LEFFUGFC.OFBEEAFBQGAFhAAABCHEFAGADABEIGDDhABAJBDG....hADAeAADfBDDMFABAHDGNDDDdFHE.TEABhAEA.WDFEcGGF.hAGA...,2,-23,-13,10
OTENCGeDISFPbcJdMBLWUgVAYHRfZaKXQ,HFABRBEFZDGFKFFBQEGH.TECBCAAFGDAADDBCFACC...hACAPGDCJBCBBADBUCEFhAAAAEIB.aAGF..OHAEhAFANICDSBAGdAHAMEEF......hAGA......hBBA...,1,3,-32,35
XUabCHRLYBGIZPdVWfSNODcQKTJMFeAgE,EFFCXFADUGCE...CGHHHBCHLBCDGCEFZBGDdBAG.VBEFhAAASEHF.DFFDhAAAKFADTFCEFHGEAIAGaAEAhABA..YAEEBFHA.IDAC.hACA.WEBANICFcABGhABA...,1,-13,-24,11
CKALcVdUDOSWRbQIJENXBFZaeYHgfMPGT,VCBCDCBDOGDC..SAHBRCDC.QFDEIFAGEBBGhAAABHCCZEBBaBGDeADEhABAHEAH.fFGChAAAMIAGPEFCCHHGAIFGcAEBUGGGJAHBFABG...hACA......hAGA...,1,-6,-12,6
ZYEGNRcbPBefSXMgdaUFVHIDOJLTWACKQ,KHGCQEABEFFG.RBDB.....PCFCBHCHSGADhAAA.MEFCgBAChAAAdHFFUBADFGAHICGChABADCDBODADJFFC.TFCGADBHCBHE.YAEGhABAcFBE.fHEBhACA.aCEH,1,-19,-27,8
LSCJGFbZeITMYQEBNcgVOXKDWRfPdUAHa,aGAGLBEB.JDAEFFEHZGFGeACC.MDDFEGCGBBBA..gGGDhAAAOHACKAHBDBHBhABA.RCFDdCAEACAFHDFBSCDBhACACAAG....IFAE.hAGA.YHAG.hABA...,1,-14,-34,20
KCRQHcPMIFdUEYOJXAZeWbBaGSVNDfTLg,ZFFEeEGBBFAAGBDA.SBGADDBELCEECGDFHDBDMCAEIHEBhAAAFFDG..EHAAODAHhABAAHHB..aHEEfBBHhACAKAEA.QGAHPAACdEAF.hADA....YEEChAAA.,2,-37,1,38
gbPLdQaNMKIBfCVSeUGcRFOXDETZWJHYA,...bFFCdAFG.QFEEaCFB.MAIHIHCCBCBBCAABSECBhAAAUEBH.RBGHFAEBhABA.XGABDADBECGFTGBChACAZABDJHFEAEGBLEHDNEEC.KDDC..hAEA......hAHA...,2,-27,-2,25
CWKMPgTeYQcXHFfOSaGJbUEdLZRVDIBNA,KHEEMAED..TDBHQAFEHAFDOEEGGDAGJFGD.EDGEdADEhAAAZBCHDBID.IBADhABAAABBCGED...gFAGhACA.cEGE.FFDCSFDEhAAAaHAC....hACA...,1,-5,-31,26
TRKHDEeJABWOFCgcMGXYQaSNUVPLdZbIf,OAAHCGAD..MDAEXCDCQFGD..aAFGSBFFhAAANIDD.VECGLDGBhABAdBADIDHHhABAfGBFKEABDAEGEEEFAAIDBHBHFDBHcBGF.hACA......hADA...,1,-17,-26,9
ULMfNbeDCRcWVAagOdPYIXJSEBGTQFHKZ,OECFdADB..ICBDJABHBBEDGGCB.FEBFHFGHZFGDUAGEhAAAMAIB....fAFFhAAAbDFC.CHBHREABhACA..WDDFAEGGgDDB.PHDEhADASBAC..hABA...,1,-20,-29,9
aeDWJIXVRbfSGBZEFTNHYQUKgcOPLCAdM,MEBADBFH..JEAEVGDE..RAGF...SBCFBEGEFGAEHFFBhAAAQEFAKCAG.OFAHhAAACACC.AICAaBFAeDDHhABAIBAD.fCFCEFEF.TBDEhABANIAF....hACA...,1,-31,-35,4
cPYJEQXCWGKTeHZgSIdVMOaUANDfRBbLF,DAAABEAEFFAE....PABDEFFA.CHBE.KDHHHADHZAFD..SBDDhADAVEGD.MBCBhAEAODFB.aBGBAAIHRFCFbFAChAAA...LHDG.JDDF..WGEAhAFA.....hABA...,2,-38,-17,21
UaHGNVbXSCOfgYPMRAQFLdDIZKWeTJEcB,QCGHdGABDFDEZBDH.KFAH..eBHFEFEGBDEHUGEBGAAA.hAAA.bDAECHHB.OBBAhABA.fHBHhACAgAFAMFHHAEAB.FAFHIDCB...hADAWDHH....hAAA...,1,-12,-36,24
PcFSKOHLENgXIYMVaWBCdZTUQReGAbfJD,JECEDACGFHCE..OAHDLDCB.EAEAXAEA.MAAChAEAVBFB.BEGAZCBEQGEBhAFARBAFAHBB.PHAGhAHASGHD.HFEHIDGDaAHF.hAAACBBFdFFB....hBAA...,2,-25,-21,4
HdIFSXAMDUCfJORbeWcVTBaPZGLEKNgYQ,DHFGCAEC.OBFAeHCC....VCDCTEBABCHGZABGGEFGKDDC.hAAA...NDIAQEFAhABAHDAHIHHBFHAAAHDDhACAUABC.fHAF.RAFC.WDAFhADA...aCCG..hAFA...,2,-27,-8,19
DefAdUIVWOECZGLcNXFTgQMRSbaKYBJHP,dADHVEBCOEAF.ZAGHLDBC.XGGBTCDHMHEEhAAASEGCKDFB.JAFHDICGhABAAHFA.UCAF.IFCAhACAWHDGGAAD.NDAC.FFGE....hAEA......hAIA...,2,-24,-19,5
XdegBFVSQWRDOZKEIcaPHYMCbUNAGLfJT,LCACTACH.dDEBeCDHFFGB..QGADDGIHKFGEEFEE.aEADPAEChAAA.HFCDMAADhABACHHG.UAFCACEE.fBBGhACAXEAC.BDHBSABGWGEG.ZFEFhACA..IHBDhAEA...,1,-1,-27,26
SPRXLCaQHdIBKEcAUVgZOFDJbGWTeNYfM,VCEGOCBA.FDAEDHEEGEFC..eGAE..fHCBhAAASFGGXCGBhABACABAQECBdGAABFDCKBDCADCGhAAAZACAJAHHWADE..NIAH.MFIB...hABA......hADA...,2,-32,-9,23
CWUHLGdJBAbDQMEaRPfIScVeYNTOXgFKZ,DAGEQABFEEDD.aHAERAEF.....IHFCSHCGVAGDhAAAeBBB.TGFEhAAAgCEEFEABKACACFEDUEAFhACALFFEdEHEAHHEMEEEcEEAOBHD..hABA..WDCB..hAEA...,1,-10,-19,9
CFYaILHANXETcUJSPOKMVRfGZeBQbWDdg,XAGAEAECUGBB...JDBFSABA.KCDCMAEA.RBAEZFDEhAAABCADQDEChABADEGGCGHAFAHH.aHEELFEDhAAAACHFNDAA...PCCBfEHAeBFHWEAFhABA...gGFDhACA,2,-31,-19,12
JAcWNdIaUKXFbGVefHSOMQRgPZCDBTELY,...NFAD.dFDA.aFACKDEGFAAAGACE.eAHFHDGD.OCDAhADAMFIFRGAGZGFCBGGELAEEhAIAABAG.IDBGhBAAXAEEfDDBQCACCBHADIDGEEGAcGDEhAAA.....hBDA...,2,-18,-9,9
OIUMKeREGYVFCDdfSQXPWJHNLZaAbcBgT,BBEETGDAUAAE.KGAEREBBEAGB..GCEBFCDDCAAE.DGFH..dFGHhACAQGGCXADG.hAEA.JDFGHECE.NIAF.hADAaAHFADBA...........hAEA.cAFFICBHhAFA.eHFAfEGH,2,-27,-13,14
CFTMPLOXAUJSRecBHfZNgaGYEWdDIVQbK,SBABeDBGBBFFHFDCZDAA..aFAAEABFdFGGDGAG..QGDEhAAAKDFACHBDFADF.TBGDhABALDHBAEEFRACE..NDIE..hAAA.YAFCIGAHMBAHXCDEJHCAfCCDhABA..hCGA...,1,-1,-21,20
ReJcfKXVSGBTgQILaZHPYbEMdFONUCWDA,eBABJDBD.KBGB..SGCCGCDABGEAQBDEaGGA.HDFHhAAA..bFBFMAEEhABAOEAHCHGGAHBH..fCAFhACAXADCgDGGIHDG..PAHDhADAEAAGNIDFDCCHcDDChBAA...,1,-9,-32,23
KWIEbAaQNVPJRZeYcgFSTXDUGOfHBdCML,QCCGVCBG.REAHZFCBeHDC.....gAFFhAAATCGFXGFAGEGCfAHAhABABABGdGECCAFCMCADhAAAKEADEABAAHAH.aDFDJEEAcECEDGID...OCHFhAEA....hAFA...,1,-10,-11,1
dCDUAEKHZLQISBJgYPVeXNTOcbWGFRafM,KCADZGCGQDAABGGF..JCCE..gABE.VCEDhAAAXABG.OCFDhAAAWHEAGAGChADAREBGMFIDDBEGAAIDEFAD..IHECSGGEeBHFhACAcECAFHBG..aGAGhADA...,2,-39,-2,37
ETbMDfaQRYWIFdZPAXGUCVgOcLSNHeBKJ,GABGCBCC.ODHDSCECHGECKCFDEAAA.MFBCDGGD..QGBGhAAARAGD.IAHAhADAFGACZBDBAEAB.UGCChAAAgFDG.cDCAeBAD.BHHC.hABAbCFA.aFAH.WFFEhAEA...,1,2,-40,42
LTCRaXSJWGDgAYHQVFeBMPEdOUfKNIZcb,QGDCeACCMDDHdFGDOCBE..KCDEIGADZBGBLFBDhAAACAAFRAFF.aCAE..XACAhACASGDAJFGDDEEEhADAAGCB......YHFGFCHHBBBGEEEHhABANFAD......hACA...,1,-16,-23,7
fKBFMbDdWTEXeQAVLZJRCaYOHGUPNgScI,LAEHZGACCFBA.OACDGCCGUGFE..PFHBSGABhAAA..IBFFhAAAKDHBBBBFFGECMEBADADCTBAGhABAEDFHXCACAIFE.JHCG.aAHHNAIGfEFGhACA...hABA...,2,-24,-22,2
PEaHeWLXOdSANMJTfZKDQYIBCgRGbUcFV,JAEEZCAFDEEG..QBGEBFDECGHB.GGEHUFFG.FBAA.ECDGHABEhAAA.LCDChABAOFCFdDBEAAFD.MAAGKHCG.hADAIEGCRAGB.....cDDHhAEAaGAE......hAIA...,1,-23,-29,6
LeOVNSgGcaHXAFCJBPQMWbZUIRfDEdTKY,JEEABGAC.MGCCZEAHUBCERBBD..DADCdGHAKBDBLAAB..hACAOEFE.SHBChAAAgGCBaGGFAGAHFAFBhADA..QAFEIECE.ECFB.eCADhABANAIA.....hAEA...,2,-35,-25,10
ReQZdXJNEfYCDVGKOFPIgBaMTbcHAULWS,UACFLBAEREEEZCEEJDEH...EGAECDCHGBAGKGHH..FECD..hAAA..IAHFhAAABHFATDAEHGCGAGIBSHDChABAdAFGXDGAfAHEDGBA.PAFFhACAaHGC...cEGGhADA..,1,-20,-27,7
DVMHRKTXNdeEPZbaBWcfgAYJCUOFQGLIS,CFGEUEDGFGAF.LACG.DHBAMBEHHFFBKABE..TBGHdFECECHDhAAAZBACBDCC..fDAFhAAAACGB.JEHFhABAOFCH.IEADSEAA..hADAXGGCNIBD..hAEA...,2,-53,-7,46
YGTUFBDKgCQdHLJXAZWMeRIaVfcbSPNEO,MBBGREDE..aBCEVFDA....bDABSAGF.ECFBhAAAOAFAGDADFGDFDCAChABACHHDQCGHhAAALFADACIHeHBEIACAfHGF..NEAAYFBBhABA.BHFHhAEA.KCEH,2,-22,-13,9
agIBMGdZbEHXCeWJLUSQOcDVNYRKfPATF,aFGABABGGDAEZFFDECADHBCF..eAFCLHCGQFCGDDFHNAIE.hAAARCDEKBGGADAB..FGGHMEIBhAAAdACBCGCB..JEAFOAGHhABA..cBCB...fHDHhACA...hAFA...,1,-13,-16,3
HAJgDSPWaUdYEMCcfKOGbQTNVRFBIeZLX,DBGHSFAA..aGACdFHGEEBGCBBDKADBOAACGEDC.QBFBhAAATDEE.RCBABCHHhABAIFGELHAEhACAAIEGJCAE....WAFE.MHEGbFFH.NDIA..hADAeACEXDFC.hAAA...,2,-36,-1,35
FBYUaLOcITegPCWJESfHDNGZbKMRXAQVd,dBCFFDAHBCBEaGGF.LEGHOCHB....TEAHeDDCCABDJEDCEGCBhAAA..HGCEDCEEZFEFhACAMEIHAIHC.QCADhAAA.UAGBgBGBWACE.SBDChADAfHAD...hAEA...,1,-4,-34,30
ZagSQYEBUHACLFGOdbTDcMWVReIXNPKfJ,LGCGOCCEdAFBDAAG.MBFERGBG..eAAD..IDGHhADAXDGBKDDFJFFBZEADaHGESBBGhAEA.EFDChAFABBBEAGHHCBDE.FEAF........hABA......hACA...,1,-29,-31,2
AZREagMQFSNLGXIDYfVBOUcJbKWHTCdPe,RADDEGCFMHBAFGGF..LDFAGDEGDBAH..VCCBUCGD.JBCHKAEDhAAA.HBAHdGGDAFBAaFFB.hAAASFAB.hABAXAGBIAFCBCFB.OHDCWBBDCAHBhACA......hADA...,2,-31,-5,26
cDaFXAGREVeLTQWNSIZdBHMOgJfCbPKUY,GBGEEGBBLEEBQFCA.SGFCICBABFDBMEBBOCCHhAAAJACA.CHADKAEFhABAUAGHDAFGFGGFAADBeDDGhACANDIGdDGE.fGHC..YAADhAFA.cDCBaBBB..hAHA...,1,2,-30,32
cBIPKUgLRVdOSJXNfQFCMAGZEDeaWHTbY,ECHBaBHDHCCE..TGAF..YEBDBAECIACDhAAA.KDEAUAEBRFCCdDCASGGBhAAAJBEE.fEFDhABACBBGMFHFAHEGDICAeHCE.cABD.hABAPFCCLFFH.hACA...,1,-13,-26,13
AbDMOJeaTFZRcWdNGLgIUQPEKSYCfXVBH,MAAFeECBFBEDZAFCREFGdAAD.LDABUDCF..QBBHKGEG.hABACHEH.fCGGhADABCGDAHHF.DGGGOGAAaHFE.hAEA...WFEC.NIAF.IHAG.hAFAEBEBSAHBhAGA...,2,-28,-27,1
XHNDgMGSQZBFUYPCLAWOKIeRJbfETaVcd,OCCGeBBDRFCD...JABEEBHD...aEFEdHAFHBFBDHFGMFIFGADEhAAAZEEABACA.FGGCUGDChAAACGABAIBA.KAGE..fFEEhABATEBG..XBGENIEHSCADhACAPBAHLAFEhBAA..WDEE,2,-24,1,25
ESQeBWKdOPMVAFHbUfGaYRXZLJcDTNgIC,FADGUFDFGCBDRADALEAFDGFA....TBGGIDDF.EBBHhAAAeEFC.BBBCKBGBdGGEhABAMECFACFD.HGDEaHAE.hACAYHFGJEFC.NCAECEEC......hAAA.SHAGhABA...,1,-20,-21,1
CJRAGIeHNZOMLadSWfgKbTPUcQXYEDVFB,eBEGHBCFOAGBMEEHLCCHSAED..fAFDhAAAKFEB.TCAFcFBDXDGAhABAEGGADICEVDABhAAABFGBCACGAACD.NICH.aEEG.dAHAWEAD...gGGGhADA..hAEA...,2,-18,-4,14
YdIOcPeRVfGBXUZCNTQJDFgaLMEbHSAKW,KEDFdEEBOFGDeAAARBCG.GAAABHAC.ZFAF..CFAF.QADAhAAAFGFGLBGHMIDG.bCEAAEIH.hAAA....YDCDhACA..IAECcAGF.fGCGhABA....hAGA...,2,-49,-3,46
AWKSMgYVdNfRJXPLGbUIZFeCTaEBQHDOc,KFHFMEDC..VBCGdAFBRABF...JHFCLEAAGEAB.UBGH.hAAAFGEGCCHHEEGFBBBCDBADAEED.hAAA...SHBAhABANIAF.XGACIGDG.ZBDGaADA.hABAQDGD.hADAcCAH.,2,-22,-18,4
JNVaGSKCbOAPIHRBDXMEUWfgTcdYZeFQL,HFFARGCGDBEA.EBCFUEGD..fBGG.TAAFdBBEeCFAhAAAQEAFJFAD.aGEHhAAASEDEbGACACIBIBEChACABHGGMCAD....gDGGhADA.cDDFhAEA...,1,-3,-42,39
FfNQJZKBPcaYgbLGXVDIEARCdWeOHUMST,CGAEeCDCHDEEUEGD..SADDFAAC.QFGDZFBBBHHBaFADhACAbFCC.LHDAhADAGCAFDAIFADGCdEEGOHDEhAAAMAFG.fBAF.JAEAcACD.hABA......hACA...,1,-7,-21,14
VWLIKSERJPHFXcbQYNTBCOMgUdaDeZfGA,VGEELBCE.SBAHJBGF.HFABFEAH...XDGEhAAAbBBG.QAGChABA.NCDCBHDCCDEHMADGhAAAUGGBDAIHZEBFAEFDKCEDEHAG.REFG.....hABA......hACA...,2,-26,-3,23
KGCfZXNUMJBWELHFITAbYDSeORPcVgdaQ,DBFBSEABOFGB.RDCC.....PAAEVAFGdHGF.QGDDhAAAKDACCDGDZEDH.UABChAEAMFAHBFGELAEChAAAIDGHACHBeECD.aCCAfBDB.hADANCIG.EGBD....hAIA...,2,-25,-14,11
WNURPgFAEOfMJQcTeKXZGHSdVLDIBabYC,OGCAJEDF..QBEHTADE.KHFGGDEFHABG.dCAGDHAAIBHDhAAABAGC.aCCCbBGDhAAACGGH...UEAARFADFABGhAFAECAAMFID.eAFHSFHD..hABA......hACA...,1,-1,-25,24
egQKaATMDVYGdfBEZXJCLOWbNRHIFcPUS,TGECMABDDFGE.GDAFBCHGEEBA.ZBDECDFELGBE.OACGhAAANEEHRGACFBAC.UGGAhAAASHAG.QAFAhAIAADAEdEACfFDF..JHEG.hABA......hACAWFFG.,1,-10,-33,23
YbaROCFQJfGgTIAPEcWSXLUKHMDNVdeZB,EGCDSBFHUDDAHAFHMAEC..DFHFdFGGeEBFZDABBBBB.aHDGhAAARAADCACC.FGEGQEDGhABA..fDGFhAAAgACBAIACcADB..WDFAhAIA.KBHFNIEF....hBAA...,1,-16,-26,10
cPOLDZfCVYdBgIaQFAUGREHTSMbWKNeXJ,RBAAEBCGHGCE.MDDAKAFDeEAD..XBGFJEDG.OFFChAAADGDCCDHDdHFBBFBG.aEFAAAADGCADhABASEAF.hACANADD...cGCHPECE..fAHChADA....hAEA...,1,-10,-33,23
PQXWcfgRCZGBFVeTbINHdUJDaALMOKSYE,OACGSFCB.EAEEXGGE..fCCARDEBCHCDBFCBFBABhAAAVFFG..TBGEhABAICGFHCBCdBACDAGChBCALEEDKGDA...PHAEWEBF.cAGAhAAA....hABA...,1,-17,-26,9
ReTcPYUQGbaCDNIAHBLfKFXdVJEWSgZOM,LHCCFBHBdDAA.JAFEEGBF....SCGFOCCAMDGHRBBHeFFGhAAA..TFDFhAAAPACAUDDD.bABCaFCGhABADEIDADDFBHHG..fHFF.hBAA....KAEEWBHHhBBA..,1,-24,-27,3
CeNPSZHWLcaEITdBOUYVDAJfQFXbGKRgM,QBEEFGFBGAAGKAGAMEIH..CDEB.eBBB.SEDEhAAAZCGFHFCDLFBDaHFA.hABAEADEIFAABHHD.hAAAOHAC.YACHACEC.fGCHhAEA.XCGBhAFAgDCE.,1,-5,-24,19
eZNAabKMcJTfRUCIEQBLPGSgDdOHWXFYV,aGBDKDDEMCCA..TCCAUGFA..EBFGBEFA.LHEAhAAAGEAASAAGhABADBGGdBACOFDBXCAGFFAGeBEBhABAAIDCJCHDCAEEQFGH....hACA......hADA...,1,-17,-25,8
DcTaEBfPHFRQWNbMSIKOYdZJGAVCLXUge,VACACBBELFGB.UBGEDDFB..aGGEEHECBHCF.HCAEFBDBQEDChAAA..hABAWGBEMFAHSHFGhAAAIFBCKDAEdFAGZCFHADFB....XAEFhACA....hADA...,1,-24,-28,4
YOcPfDaGFbBVeMNZKHCISTdUAWQRXgELJ,RBAEXEBHEBFG.LAAEJFAE..OFGD..PFGFhAEADFEAFDHFBHBH.MFIBhAFAKCEACGEEIEEG.hAAATBBEADAF.gBFFYHAAaAFA.hAGA......hAHA...,2,-40,-31,9
OELJXcRQUdIMKPBGZeFfYVNASgaWDCHTb,SAGDaBBH.DDDCTCEB.OGBGJEHHRFCD.UFGGdDAEKFEAhAAABAGBGBAHFADB..hABA..fBFDhAAANAIAAHHF.CDDGEHDAXDEEIDHB...hACAMCAD...ZECChABA...,2,-23,-22,1
DdAIQJGVcPRCUFeZfHOMLWTKBNbgSEYXa,JFEGVGEG..RDCF.CDHE.FBCAZBDE..HGAELBBDKCAFBABC..hAAANACD...SHGEhADAEFBE.aCGCAHAAQEDBhAAA.PHBCfAFAMBAF.hABA..WEFE..hAEA...,2,-42,-19,23
AESdQYMBGRFHPXWZJceLaOfUNKVDCTgbI,SAAGdBCDMCIFBHABRFEEHCDH..XGGAJHDCLCGH.hAAAODAEUEFEVFCFhABADCACCDFH...TBFDhACAIHBAEDDCQDABFAFB...WAFChADA..eAHBaHFC.hAEAfADA.,2,-12,-5,7
UZgfDEHTbLOKRaPMNVdWXAQFCGcBYeIJS,CDGGBHDB.eEGHSABBZFCCDDCA.HECELADCRDAFaFGF..MAHFhAAAdBHEAHHAGAEC.IADEhAGAgAAF.hAIAEDFBTGBCKBDG.NIDB.....WHAGhAAA......hAHA...,1,-1,-36,35
aMGRTIXKPOHDWFgLeJVfBNUSCEdZbQcYA,GCFATEAE.KGHDHFFGDCID.FDFBLHAA.eDCFfCHEhAAAUABC.CHACdCDEQAFDhAAAABCFaGCB.IFAGhAEAOADEWDACVEDBBHFDSHEE.EAGGhABA......hACA...,1,-5,-16,11
bZRgOVTXJDNCPQEBKWSGFeYadULfAHcMI,MAADZBDFOABD..VDEHJGCG.DAEA..CFBF.QDBAhABAKGFBGAGAFBFE.eFHFdDFALDAAhAAAADHCHGDEbBBG.hABA............hADA......hAEA...,1,-13,-34,21
aPJBIZgHTGKFdCEMNVLbUQYeRXcOWDfAS,aGFCJFEBBHHAZCBE..HBFFKBDC.CDHA..MFEBLDAB.QDFFhAAAeABCRFADOFFGhAAADIBE.SAFFhABA.IAHBTDCHdABA.NAEB....hBAA......hBDA...,1,-16,-39,23
EbIDKJgLGaYdefQZRcNHUXTFABWCMPOVS,BHHFCACE.OAGDSBBD.EFGDDEFEKDEALABGGBGEaGBChAAAdFCEeFGF.ZAEDNICBHADFhABAXCAGAAGAPFBAhAFA...........hAAA......hACA...,2,-40,-10,30
HLFAIQTONaKcfSgZVGPbCdWDMUJXeYBRE,TFEDOHCEKDEE..SGAGZACCGCGECBGFDEEGMCCB.UAGDhAAAXABHBDAHHFAEhABAACIFQDAH.aHFEhAAAfGFG..PDHB.bADFhABAJDDFeFBA...hADAEHCCIHHA.,1,-6,-8,2
KYPNDCTHGSVIUbOAgZEeWFJdRQXLBcMfa,EBEGFHFCdECFRCGD.LCCEMFFB.KBFC....NCDE.TDGBGAAGhAAA.SDADhACAVGAE.IGGDOAAHAAFGhABAeGBGJDABBFFHaGAHDIGCCHHB......hADA......hAEA...,1,-17,-22,5
RSIBHQODGaUbdKeYLZFNgEcfCAPMWXVJT,MCFBVBAH.RCAD.BGGBHGFC.DHCGGDCA.aAEAUEGD.dBGDeCGBhAAALABAZFEDFHACECDFhAAACABEACEC..XFAGhACA....SCHBOHACKDGE.hADA......hAHA...,1,-5,-27,22
KXITcECBaGLJPNfQeYSbRFMDgVOWAZdHU,ZECBHEAFUCGDKAHH..TFDBEBDFBABD.LGFEJFHH..fADBhAAAeDBB.bDCEhABAMIAC.DFAHgCAChACAOAEGACACdEFDXGFHCBGB.aDHF..hAFA.GAFE..hAHA...,2,-23,-7,16
gNfVJLQSWdYBEHTPICMaKADZRGUFXcebO,ZCEBRCDHFDGAeCCB.OAFC..fGEGLCHHQDAHhAAASAACdGHABGFDEACFhAEAPHAGIGADCDGHMABGhAFAKHBGDFGH.UAFAcGGENBBC..WDCDhAIAYBBC...hBEAaGDDAFFH..,1,-4,-20,16
FbLeHJPVWDEZfIGdgNaXQSAKOMCRTcYBU,KEAHCHEGRDBG...TEEHBGEBUAACLBDC.HECB.JAAHVDGFhADADAIHZCEAGAEH.dFAFhAEAaHAG.SGGChABAADDAMHAE....FGHD..eHFA.WHBAhACA.....hAFA...,1,-6,-31,25
KINDXeYfGRTMgZdcJaVALWBFUCPOSQHEb,BBHACCEF.OEFGQBBFHGDGKCADDEGFeFAG.GGCHREBFTBBEhAAAMAHHZAFBdAEB.aDDChAAAAFADLABEFDAC.hABASGGBEHGANCIA.fDDG.hACA......hADA...,2,-14,-11,3
KXUAZbGMgTPfcDHCROEQWeBdYJLIFSNVa,GGCDMCBF..TGFDPCFG..DACECCCBRFFEQEDA.hAAABHDCdECDJFADLBHDhAAASABCaGCBKBBEADBEZAEGhAEAbCDG...fDEBcAEEEFADWHFAhAFAeFFE.....hAGA...,2,-25,-1,24
DVTGYRHKcabXUPEIfSWJCMOBLFNgeQZAd,dBBFDGFHGCBHHEDGKDDC..aFABUFAF.EHFAIHBF.SABFhAAACHDFMAIBBEAEhAAAFEFCeACCZDGHAIHG.TGGHhAGA.RBEG.XADBWGBE..ODHFhAHA......hAIA...,2,-24,-15,9
QIUEHaJKfMdLYTeXRgOWASNZDBPbVCcGF,SHBCDCCFBCGC...VGFGCABAFHEGQECD.ECEHJBAHhAAAKDAAMGEE.LEEAhABAeADCXDGHhAAA.gBBDAIBGZGAE.cAGBIFAGhADAaHCE.dDDB.TAEFhAEA...,1,-1,-41,40
cSIbRHFYXPZOETgVMBCGKaAJQdNDfWLUe,QBCADAAHLAGHeFCB..IBCBRBFDFGFG..XGAChAAAODHFEFEBTCAHVEADhABABFEFKCDB.AHHCNCIEfCAAhACA..WAFEcGBE.bFFH.hABA......hACA...,2,-21,-16,5
OEVIdZgGCacALSFbWYNKRPHDUJQXMBeTf,SBBCFDHH..bAAA..NFAFKDDCHBDF.DIBGQCGGhAAABFGGTAGAEHGGdGDBZFCACHHChAAAaAGCLCAF.hABA.WFFE.YACC...PHAChAHAXGACMCCCeCCDhABA..,2,-24,-10,14
agMYOQdTIXKfASGJReUCFbELDVHWPZBcN,JAECUACE.CDFD.ECGALBHFHFFCZDCG.BHED..aGCEMCBBQFFFhAAAdGCA.XGAHhABAAIHCRABBeEFC.DDABPFBAhAFA...NIDBOBBH.IDDChAGAfHAHSFHHhAHA.,1,-19,-27,8
TfeVLWEBbRAdcCFJOMPSZKHNGDaQUXgYI,CCDHODBG..MBDASEEEHAGBDEFCaACDQDAG.hAAAUFDFgGBAhABA.IBFFfGGHhAAALHFGBBBFACCEFFAG.PEHHKGAFNABB.XFDBhACA...hAGAYAHF.,2,-22,-12,10
dGFJMbaEXAgcOIDZSWPLKHNYBUeQCVTRf,OBFBDEGCZBBA...SEACLFDBKBHBHDCBBAEHQGEEhAAACEAF.VABCRGAGdGFEFDHHhABA.MIAEaFHBACGDIHHDhAEA..PABAYGAA...hAAA......hAGA...,1,-1,-41,40
OSIDVCMHPFefdZNgTQKcaUEbRAJYXGWLB,XCGBGGAHLBFHBFCC.SCAFDCDHCFAE.MFFBFGEDdEGHhAAAZDDBTEAEKGGE.aCDBhAAAUBAHEGHH.AEEC.YABAhADAOAEF....IAHG..hABA......hACA...,2,-43,2,45
CadbfOMZFGYIKEWJATVgNRXPcHUQSeLBD,TGCFVBEC..RDGD...XEFCHFAEUDCHSAFBeBAHDIGAhAAAaBHHdACGOCAAZFED.hABAGBDCIAHCEAAAADADhAAA.PDBB.cGGHBGGD.CAHBMEIHhADA......hAEA.KHEG.,1,-5,-9,4
cUbTHJaIRCVNOdBWFGXKZQYeLDMgSfEAP,UCGHTBBAHFBE.JBCCaECA..RCAH.CAEDOCGHBEHDGDEG.hAAAKGADQFEDhABA.LGAGDACASAFChAAAEFHHAACCcBGFIGGD..NIAH.FHCEhABA..YDBFhAFA...,1,-19,-24,5
BXdGKIMTfNSaFUEAORgJcLDbWHYVeCQPZ,OEFFREAG..JACEDCDDHEDFeCECCAADZAGHBDAD.dHFHKCCH..MIBGhAAA..TGGFhABANAIA.FCAGEGBGAGBB.LABAhACA..bCEBWFAE.....hACA......hAIA...,2,-28,-28,0
SgGNIBbZLETKcYeORaFVMHXQACfUWDPJd,UBBFDBCAdGDHGEBABAFALCDEEEDD..KAGHeDFARFFHFBEBHBABhAAAAIDE.CGGF.....hABAfEAAJFAGSDEFhACAIDHD........hAAA......hABA...,2,-35,-30,5
ISBNdQYPLXCETcJKeaZWbDfGMVgOUARFH,FGFFSEACdCEG.QEDGLCAAEBGGJBFD.KEBFZABH.DGFFMBAChAAA..OADDhAAAUDFAAAIBHGAEBGCFNAICXGGBhADACHAG..eAECaHCE...WDHHhABAbCGD......hACA...,2,-33,1,34
OAbQNIXVEZYFMfRcHLeUBPWadGJCKSTgD,QFBFXDAHZCCGFACG.RDEG.LGFCBCEF.aHECdBHCGAAFhAAACDCEKFHB.TDFF.DCIFhABAAICA..IAFDhAAAEGAGMAHHHBAEeADEPFFHSGCH..hAGA......hAIA...,2,-23,-1,22
cfVRCJLaEONWUBHZTMSKAGeIFdDYPXbQg,eBDGdGGGDAAB..XFDCQCGA..fBCEREBGCCDD.hABAJDEGEGAC.OAEFhACAWGFA.BCBEZDABMBABhAAAAFFGFGEH...PAFGcAGGaCHD.NIBD...hABA......hACA...,1,-19,-29,10
MHBJIQPcAefFUXYDSTgdCVWaELbNKZROG,eCFFUDEEDBEA..SGGDdABC.CAFD.aCGALDAFKHEGZDAG.hAAARBBAMEBCBGGC.IDHBhAAA..PFCHhADAAIBAfFGD.FGEB.XFCFhABAYFAB.....hACA...,1,-24,-43,19
QLNWYDfTERICMFOgdUaKeAcPBHSXVbGZJ,BFEFXGGBGBCHZFADLHDA..NCIGDADAEDDGRBBA.CGEF.FDFFhAAAdAGDUDBH.KGGAAFDCHCGHhAAA..bGACWAEBhABA...YDAAIABF.OHCEhAGAaGCB.eAFA..hBAA...,2,-31,-1,30
BNcIKaUXJedQASFMTVHbfLPZRGYWDCEgO,MDGHHBBELAACRECB.GBFGDGBDEBCCODHDBHHC...IFAGhAEAaAACUAGEJEDDdFEEhABAAHIFFGGB...bFBHhAFAfCAD.ZBEDCBHC.NEAG....hAGA......hAHA...,2,-23,-10,13
GEBgUJcONLHKFRAWbXCPTQYfVIdZMDaSe,XDBBTCBB..QADD.VEDFdFACZECB.aAABSAHHhAAAeADDEEHBBHGBhACAgFAHUCGFOAEEhAEANAGALDHHKFFDAIACCGGG..YBADIBBBhAFA.MFEH...hABA...,1,-6,-16,10
AgFBJdDGbcCRaMOHEPIXNYTfWZUVLeKSQ,FCEEdCCDDBBBGEAE.CABF.aBGBHDGF.EDDBXFEC..TACAhAAAZEBHUADDeAHBKHAAhAAAACCBBHCC..cDGBhABARGEG...MIFCIAFC..hAEAfEAG.hAIA...,1,-15,-31,16
AZXeHOICYUQVRKMcNFBbaDJfLgTPEGdWS,ZBFFHCFBCEAF.UCCARFCE.MEIDFAAE.BBAE.DHFCJHFA..LFAChAAA..TGABhAAAEHBAGADBdCCBAFEGOHCChADAIDAH...YAHBKAGE.cGAGhABA..aDDC..hAEA...,2,-35,-11,24
UJQWHBYgFRcfMLaIZTAVKEPXdCSDGbeON,KDEGEDEBdFDEDDCAGAED..bCFEeECDUFACQFGDBDBBFBCA.hAAARBAC..MDADaHFG..hAAATAGFAHECXFADhABASBAFNIDD.WGFE......hABA......hACA...,1,-12,-26,14
ZFEHBOdeKcWfDUaXbVJRAgCPLGTMYSNQI,CDBFLHECGDEA.TCFEMAGB...SABFQAAEFAFCBFBFhAAAdAHAKDDA..WHDAhADAUEAD.aADBXEGDhAEAbFFE.JBHHABEHgFCHNDDA.ECBFhAAA..eAEFDFFC..hAHA...,2,-25,1,26
HKQBgYSJAVbXWULOMNcFEDdTPZCRaGfIe,XCFEUFCDLDEC.MAFCFEABdGGBZABC.CBCFGCDG.eEBHhAAAKGFABCCA.SFGEhAAAJADCAFHE.bDAChACANIAHDFFD..PBFCfBAG.IAHHhABA...hADA...,1,-20,-32,12
LeCdTSVZaPXKbGEcDIQABWgFYNOHRMJfU,BCCGFCDHODFCRFDG..JDHFLFAB.eBBDCBHBdDFE..TADBhAAASBBCZFDFaGGGhABAKFBH..ECGEDAAEIAHFhACAAHGE...WFFCNAEEHDAEMFCDUAFAhADA.....hADA...,2,-33,-15,18
TBfXNcHEQWGFDLIYAMdOZUgaPCeSKbVRJ,dAFFUACCaCFFCEEH...eAABKCFH..REBD.TEDFBAGG...XEBFhABAHBAFEGHDGGBBhACADFGG.LFGFAIBE.hAAAMEIHOHDEPCCESAHH..hABA......hAFA...,1,-1,-40,39
WEDKMGINBJfeFaLAHCPSVgcOYURTQZbdX,CDAHSAAF..gEEFOCHDRBDDZDABdHCB..EDCADFHHKBFHhAAAMIAEGDGEBFECJBAAhABAeADEFFAA.ACFCHGDChACA..cAGF.TADG...hAGA......hAHA...,1,-13,-24,11
aQULMENYKbfJTdGDFgIZXBVRSAOCeWPcH,CAGCeCED....PCGHaDFFLAAG.EAGENAAF.KEBCJBCHTFCDhABA..DAIFFHGEhACAZFBHBHDHRFEBAEEBOAEDhBAAHFAFMCIB.fAFE..gGGHhBBAICCE.SDHHhBDA,2,-31,-20,11
GMfQFISHXZeYBPVEJADOdKLcaCWNgURTb,DDHHdGFELECHCEBA....NBAH.UADDRGAG.bEFAGAEA.hAAAQFFHIHACSCGHhABAHCCDeCAHBAGGhAAAPABD.EAGEADIDKEEDaEAH....WEEDhAEA.MDDG..hAIA...,1,-17,-21,4
WFPaCDKBbJZGTeAQEXRISNgLVcdMHYUOf,EGADXCGBREFH..SAFELAFAVFFEdCAFHDDB.UBGDhAAAOHAEFHDA.aECFDABGBBBChAAAJAEF.TCDCAHIHQDBFhAIAgDAF...MIFE.fGAHhABACHGH..hACA.KGDH.,1,-5,-17,12
DaAfSINbKUeVWLYdHMPOQEXRFgJCBZGcT,SAAE..NGBHKGFGVDFFLHBCHDAGMHBGOCDHXADBhAGAFCBD..CEFEBADAhAAAZAFG.GAGCDIEGACCGIHHHhAHAeBAFdBFC.ECGE.....gFDEhBAA..hBBA...,1,-14,-24,10
AHRdeXIZLVfTPODabcBSMENFKWgGQUJYC,dCBAeDEHZGDGLHEG..TEDHDBEAaABGBBFE.SBDHhAAAEDGGFFCBKCCCGBGChABAUFGDCDBCAAECXGAFhACA.fHGFbFADMAAF..NAEF....hADA......hAGA...,2,-25,-13,12
aXNTPdWCIZEbGUDQgBAOYKMJRHceVSfLF,OABAMHCERBCC.HAFB.eGFCSAAGFBCH.aFAFXEDBhAAA..TAGDPHBGhAFAWACECEBDEDGH..bFFFhABADBBFBHHC.AEGEKEDF......hAGA.cCEEfAHEhAIANCICIDBE.,1,-9,-14,5
IbaUKHQENOTXcDPRBLCgFAVZfJWYMdeSG,ZDEHJEDC.MBIDdCGEGFAB..IEAAUADGHCAAQBBFhAAAEGHH.TFCEDACHBGGFhAAACHEGADDF...fHADhABAWAHFeADEaGDEOFHF.XGAChABAPAFC.....hAIA...,1,-8,-23,15
NMSDWbOFCHLAKdRUePgEcJfQVIXBaTGYZ,KHEEUBGEeFBGEDCD...JBCAQGEC..IDFHhAAAaFBDTBABZBAHMFAD.hAAADHBEbADFFDDFCHHHAEFAdFGFREFA.hABA....cAEA...fHGHhABABGAF...hACA...,2,-27,-18,9
XSAMIaGbEZFeJWPBOHRNVgUYCcLDTfQKd,aCEFEDCAFGEG..eHBG..JBDCBCAAOFAFHCGD.RDCHVABEhAAAUBAA..CCHD.DEACQDFChAAAKGGGSAFGhABAMIFE.IFFB.......hABA......hACA...,1,-16,-40,24
ZLdBWEFMGTcRUHDbfAYXPVaINKeCSQJOg,XDAEaDCF.KDGHeBED.CFFA.QGAAOBAFLBHFhAAAdEDDBGDAFFBHGADFRGDEDFAHACCChABAPGFC.NCAB.SADEhACAJAAE....WCHBEHGAMIAChAGA.....hAAA...,2,-22,-13,9
NHVIRFPbXTBMLUCAfZOJdYgWeDSQEcKaG,OACGJDBA.dDHC....gEGFDCGFSBACQFCAhAAAKGGGGDDAVADHIHABhABAFHCC.bAGHBBEHhAAA.LDCFAGAEfGHA.WFFDhACAEGAB..aGFH...hADA...,1,-23,-29,6
MRVfSOYXgTECDdPaFUZKeQBAJcGNbLHIW,JEAEGCEFLGCAHFGHIEAG.MFFBVBDB.OHFChAAAgACHCEGA.DFCDdADFhABAaHBEFAGAKAAGBDGFAEEE.hAAA..NDIG.WCAGSCACTAGAEECE.hACA......hBAA...,2,-30,3,33
UYcRIOPQBNLTDFVWCMXfKEdaAHSGZgeJb,HDAHSBEGGEDDeFFEJACEUGEB.RCFG.IDFF.OCAFhAAABHCENCADLHDGhABADFID.FACHCBHA.MAHBhADAKAGCEAAAdGAHAIAA.ZEDH.......hAAA......hBFA...,2,-20,-8,12
IBWFKGCeHSQJDEPTVLabMcfOANXgYUZRd,XFDFUGFFRDFHBECCFCAD..GAAHHBBEQGBHDBGF.EAFDhAAAPGAC.TGFAhAAALDAB.MAHHhABAcFGFAEABNCIE.ZDCEIFDGKDGGCCDB..SAFEhABAaACAfDDDhAGA...,1,-8,-17,9
NOELDQSfRBFJWCIbGcTPYUHdaegMVKAZX,ZCAFXEBBEEHHLAFBDIAA..QDFFSDDHBCBEFGFHCAHGhAAAIBFHGABH.PFFHhAAA..YEAFhABAdAHEaEHDMEAFADHB.fADE.hACAWDDH....hABA...,1,-17,-31,14
MWFSXaINZBCQbAOdRHDUPVgGeJELfTKYc,RECHDFCHUBFF..VCECGBAB..eAAEJFAFLEEHKFFB.hADA.MEAESHGGhAAAIFAEBDAE.QEGGhABAOEEBPDHD.ECCA.fAHEhAEA...hACA...,1,-28,-30,2
fWZBUcRNYeKbACEJFVQdSGPgaOHDXIMTL,EHDGJCGF.FACFdDBB.GEEA..PGEGOBCEDDEC..MACGhAAATBGCLFBDZFAEBDDDhAAARAFG.eEFEKGHBAFDCCBFFSBBDhABAaBAB.IEAC.fHAHhAEA..hAFA...,2,-27,-22,5
eBJVAgTNYPOKZfHIDCLUGdRQMXFWaSbcE,TGFG..NBDGOFDDKGBHHDDA.CCAGLAAAGBEAdBBAMAGFhABAFEBD..SAGEhAAAEEADBEHGAIEG..PHFGhABAIBECRDGF.QFDBaFAH...hACAeAHF....hACA...,2,-16,-15,1
NDYQGAUgfFdcPTSLOeIZKbCVBXJRaEWMH,UCADFEEAdGCG..TBGHLBDC.eBABZFCGCHHBBBHC.RGDC.aGAHhAAA..MAFEHDFDDDDFhAAAQABDAGIH.hABAfBEHSEGHKDDH.XFAFhABAWEAD.NIDH.YCEAhACA...,1,-6,-36,30
QHfPDTREUKMXAgGZaNecYdSCIFbVJLOBW,ZBBBaCDH.eCAFdBGG.CGBG.FGAA....VCGDOBAGBGFHHEDCDIGE.hAAAEHEA.KDHBMFBCAADG.hAAA....gFDAhABAcAEG.IAHDJCAFQGGGhABA.fHCFhACA...,2,-35,-23,12
eIMaWDRQHPTKSGOgXfCEbYNUFdBcZVLJA,MEHFaBBC.DFDBRBDFHGFG.KHDGOCBC..XEACEHDC.hAAA.NCEFFADEBCGCZFFHLFFEhAAAABBD.WAHHhABATGACSHBC.fACFhACACAGAbDACdEEG......hAFA...,1,-17,-26,9
ZXREGgJTAVBFSCdeUWQKcINfOYMDLabPH,BDCDFADHCHCC.eEGF.QACCKEEG..IDGDOHBADFBGhAAALFHDaAEF.HCAGhAAAXCGCREAB.gAGBhABAAGGHdAGE.WDDBcFDC..NEIE..hABAMBBD.bFEHEABH.hAIA...,1,-22,-25,3
SCXZLPdMcJHDOAUQVEgbFTKfRWYaINeBG,UBFFEDEAFFCCKAAE..RGEC...aGECeBFGGEEFCBCHLABE.hADAMCBBJBCBDGID.AIBA.hAEAQGAH.hAFAbEFAfGAH...WECH.hAAANIDDBAGCSAGEhAFA...,2,-34,-22,12
NQbJHCIdMLBAKEUDWVgYeaRSGOTXPfFZc,UAFFDCEA..VCGDeDCC.REGDGGCDOABC....TEDBhAAAfBBEFAFEZEADQACFhAAAJGFG.CFFGIDAFhABAMIAGAIFAKCDFEGAC....gBAGhABAaCFDSECA.hADA...,1,-7,-23,16
eBRGfNOPJCFMLTQdHZXISgWUcaYKAbVDE,DBBHeHAABFDGREAHGGEF..OEADJBBHFDGGMCAD.LGCGhAAATAEH.dDDFZEFGXABBhAEASDDD..hAAAgGFH..cACHYCEChAFAAAHD.EEFCNBAG.CAHF...hAGA...,2,-32,-9,23
KZYUETcDJWGQNIdeOAgPHMfLFRXSCBVab,HFBELDBERBDGCHFEBHAHVEBD...KAAFZBCA.EADGDDIDGGDB.hABAQAGCdAHAeEDGABCEhACAMEIBFDAE.SCAFhAAAaGGF...YFEC...hADA......hAEA...,2,-32,0,32
RfMaEdZcVCTSPQeUGIDHLAbBJYXOKWgFN,BEFGJDCE.OAAFKGFC.FGGGRAAE...MCEBECADZFAC..VDBFhAAACHCG....SFHBhAAAQACBUCFGhACAGGBBDAEB.AIFEbAGD.....YAFDhADAWBFE.fEGBhAIA.,1,-30,-40,10
abANKePdHWQCLSXIVJRfYZTgDGBUEMFOc,eEBDHDDCCAHDLCEA.SEFCVFCDRBBGZGFGDGHDBGACUABGMABEhAAAFGFF..OAFChAAAaAFH.ABDCKEHBdDBE.XGCDhAEAIFGB..fDDE.YFAFhAFA...hAGA...,1,-9,-24,15
YHULKPDMAfcaFTEgZeIJQVBNbOdRXSWCG,aHCGTFBBZEFE...eBCEJCFE.BCAB.ODCARCBG..SBAFhAAACEHEHGDCUGGCKHGADFBAhABAAABAFGAH.EAEGIAHDhACAQDFE.bDAGdAEC...WGBChADA......hAGA...,2,-38,1,39
EUAfKRSBZIeWgVFaTNYdObLcCGHJMQPXD,KDEHBGBBZBDEeDAE..VDGBTGEB.dAHGOEABLBBECHHA.hAAAGBEGHABEMIAGhABAXEGADEDF.ABAHSEAGhAAA.IHHGFBHFaGDENADD...hABA.cGAC..hACA...,1,-19,-23,4
FDfHLPNKbdOASWBCGIYUXRcZQMVTgaJEe,SEDFBACGGGEDUAFFREDEZBAF..QCBCMAHB.VEFBhAAAaFBD..EAECDIFAHCCEhAAALABAKEAD.dGAAAGDDCEGBhABAXCGE.gGCA..hACA......hADA...,2,-19,-15,4
XfZaBUQLJeMbDdTKCIRVGWPcNYESAgHFO,FCEAOGEGZFFDBBHGLBDG.MEEEDAFGKCCDCEDD..REBB.GEDGhAAA..PBAD.hABA.NCBA.SGAHhAAAAEADHFBB.fAHCaADCJFHD...bABB.hACAIAEBWDFA.YHDAhAGA,2,-35,-16,19
RQdeOcMFILZNgVXKEATYJbGHPUfCWDBSa,TFCGJGEEHFBD.UADFCABABCHE..SDFFREAFdEHA.OABFhAAAMAAFFDEH.LFGDhABANBIG..gAGFhABAVAEDEDBEAEAD..YEAE..hAEA......hAGA...,1,-18,-31,13
dJBIcMTYAERgQSZVaGLKfHPWNDUOCeFXb,RACHSABCZFAAGEGAKEBCHBFA....NAEF.UFEC.CDEAeCBDhAAAXGDFdHADBABDhACAICCDMIDGAFEEEDHF.hAEAQBGG.aGHB.fGFAhAAA.DBFD...hAFAFGCH..,1,-10,-18,8
aNWDVdgJXScbQGZeRAHfTPOMCBUELIFKY,HBAHTBEHMFAE.CFGEBDDAECGFLEBC.FCAEKGEA.NAGC.DHBGhAAA.dACB.XFGDhABASHACbFEH.QADChAAA.eFDFACIHfAGB.hABAOFABIHHC.hAFA...,2,-27,-17,10
ERYQgUcFefIJTaMZNVBCWdALDPGHXKbOS,DFADHDBAKFDASHFG.RDFC.QBBAUAFFeABEJCHDMIBChAAAZAEFBBHFCFDD.AGBELBADhAAAXFGHEBCD.hABA...gGGEFGAB.fHAFhACA.aCEH..hADA...,2,-35,-5,30
PbcBgURdDFHTLGEfOIKSWMVJXQeCAZYNa,ZFFDaAEA.....bAFFBFCA.UBDERCAADFBHTEEGLECHEDAB.hAAAOAAC.SCFDhAAAMFIBJHAAXDCGhABACFHAAEED..NIAH.gGEG.HBGFhACAIHHG.KAEFhACA.WAHH.,2,-19,-13,6
FNSLbHZXACYMGOPfdKDRWBaeVIcgUETJQ,CDHBMAGFGBBD..OEACdFGAKGABRDGBBCCC..aEEHeABE.hAAAVFDDIABD.hAAAUDAFEHAC.QAGAhADAFAHBSCEBHGCEADEA.fDFAhAEAcGGH......hAFA...,2,-18,-18,0
QVOUIdWTDcMePJHCfbFaYGgANBXSERKZL,XFBFRFBCLBDA.QCAHUDGEdGACDCAEMIEC..eABEJEEE.hAAACBHB.FAHDGCEA.hABAAGHCBEAFEEHHZGDGIHHFhAAAWFAF...PHCE.HCBGfDDHhACA...hAEA...,2,-18,-11,7
QdFYcDeLHZGTEKfAUVagJCWbPOXRBSINM,aGEGCFGD......bFBBOEDBBAAA.NDCB.MDCA..QBGEhAAAdFHAFAHFDBDALBAHhABAZDEE.TACChACAfDACUGAEJFHDXGDBIAFF.eEEGhAEAEGAHAAGF...WACChAAA.SCEE,1,-15,-24,9
YESHZdMPOJBfLWATeGUCcgXaFDVRQbKNI,eBFFUBBBCFHF..XGDAFCFD..DAEBVCBG..QAFDhAAAbEBG.KFFFIADGhAAAEGHH..SEDBhABAHDGDdHADMBABODABBFFBLHAEhACAAHHEcAGA....hABA..aHEC,1,-17,-26,9
WeAIDHcJSRYTQXNGPbLOFKEgBCaVfZdMU,HADBJHCC.RAABQAGGGCGGLAEAFFACKFDBBDCA.CFCE.aCAHZFAHhAAAMDIDUABH.AGIB.DFFAhAAA.SHDAhACA..TGFAXGGD.bDDCEEEF..hACA......hAFA...,1,1,-28,29
XBVgHGYQfTbZLPNRDJIdWOaUKcFSMCAeE,EBGGVCAAHBBH.QEBF.TDGELFFG.NHEBRECBIEEGhAAAdABH.WABEhAFAUAFB.KGAAFGFBMIEGhAAAAIBABGDD..gCGA..fHGHhAGA..hAHA...,1,-20,-22,2
KgYBZJcPVXOUTeNFCWEIMDRGbSQdAafLH,LBFAKFDFBCBHZDEHJGFG.....VADCOEDA.UBCFeHFGhAAAFDHH..CBBCEBGFMFAAhAAA.RGBC...SHAEhABAAACEaBAB.fDDG...hABA..YDAFhACA.PEHBNIDF,2,-34,-30,4
IGaCORbFSJXYfdcQMZgHWPNKVAEeTULDB,EEHDTEDEDEDD..BABBaACH...CDBD.OADFFAEC...SHBEhAAAJEFH.fBFEhABAdCGHMDCGZGACHDAChADA.PHEGKAADAFCBeDADIAGA.bCGH.hADAXFAC..hAFAcGEC.,2,-37,-1,36
BRGQIOeYWUaXbdSgDfNATKLEMZHcFPCJV,LEAAEFABZBECHFGDFFDECHDGBEFF.RBBHGEDEOBDC...eAAFhAAAUBBEaHBEdGAA.SGEAhAAADBFCAAEAMAIFJAHF.hACA....IHHHWDDC....hABA......hACA...,2,-39,-2,37
YSGXLJEBOAVbMdgTRUPKeHcCWQFIDfNZa,MIEGdBAARBGFKFGAHDAG.CEFD.FFDEDFHB..ZAEBSAAELHACBCCChAAAABFF..VGBE.hABATBGHUEAB.eFDGhADA.QBCANIEB.aGAH..XACAhACA....hADA...,1,-6,-32,26
RXQTEWBMUbCcHPDagOZKfVYJALFISdeGN,FFDFdCEHGAAARBCC.QGEFTCACBGBBMDCF..CAHEHAFDhAAADHACaAEE.ZFGDKGGG..hABAfDDEJABEADHDSDHHhAFANIAD.EDEBWDAD...cDGBhAAAOHCC....hBAA...,2,-25,-9,16
bMAFCEDWXdOYgRTIQfZVSaGBJHNcLKePU,EDCEDBDAdGDD..OAEHRAGF.QAGEZEADSEFGGFBHBCABhAAAHCABLFCDhABAKGFHPEHDMCCCAABFCACA.XCFHhAAATGGGIDDEfGAE...hACA.aAEA....hADA...,1,1,-30,31
UXGTagEKPFMCZDIRHNVeAcSQWdBYfJLOb,SEBAQBBGdFDFBCAB..JHDEOAEDUBGDGEAA.hAAA.TGDBEEGCFAEDCBGBIGHHhABA.NDAAAGGDhACAcGGF.fDDHXEEFaDCGKBADMAAGhAEADIFCHABC.eBHHhAEA..,1,-10,-20,10
GKgcNWQBMbEePfadAYCXDTLZSOFIVJHUR,CBDDDBIBLGCAODFD..FBECJDDG..HDBCUCAERFGHGGBB.hAAAKBAENIEB.BFAH.MACChAAAEBFAeABC.aGAHhABAADBE.....XDGASAHFIGGDhAFA....hAGA...,2,-35,-23,12
TIdYDbCXSLEKfMJRAFeUWPOgQVcNZaHGB,eDBAUDAFOFFHQBAG...NHEHHBFATBDH.dDDHDEIHCHBALAHBhAAAEEFGKACEJGAAABFCFHGEhABA....WAFEhAAAgABA.ZFAEBFDCIEHGhACA......hAEA...,1,-14,-20,6
CFJaRgVfDcZIBLEdSYUTOGPbKWAeQHMNX,HCCHMIBG.CEHGFGEERFDE....VDBBDIAEZCADBABBLCFAdBGFUADEhAAAOAAA.GAEDhAEAKGHDAAGG.eHCG.XEEGhAFAaEHF..fEEDIHHDSECDhAHA..hAIA...,1,-12,-33,21
EJQebLHgKVOPMFcAfTGUYXaIRNZCBSdWD,TFGGUAAD..aGDDRFCGZCBDBEAC..SAGADIFG.EDDGJFFGhABA..eHCGHBFAKABFhAAAVDCFMAEE.AADDfBEDhACAXFADIADACEFA....hAFA......hAGA...,1,-10,-38,28
YMadACOgWTfUJSNFcGHIBQKVZEReLPbXD,CHFGOAFE..TCFBUBBG..SGAFFAGAGEDABGHHVBBHhAAAZFDF.EFFDRADAeFCDhABALDEC..PEAHhACADABGMAAHAGHF.WFCDNCIC.....IEADhAEAKFFC...hADA...,1,-12,-24,12
PaREFIeLSCcYKfOJXMWNZTVUQDHBgAbGd,dBFHaFDA.EDCCFBCFLGDE..CBGAKGBCJBBE..MEEGZDEAUDAGhAAADBIDBAGCAIDG...GEAEhAAARGDEeAEASCAGhABA..cGGEYFFC.OHDChACA..NAIA...hABA...,1,-12,-37,25
LQSgIFKaWfHXUbGZYBAdNeEcORJCMTPVD,eGBGEDDDRCEG.MAEF..TFEBDFFCLDACQACCSCFChAAAFEAFKGAF.aFHDHAAHUGEChABAZFBBBBCEAIGGdEHGNEED..hAAAOAFECHHE.........hAEA......hAFA...,2,-15,-6,9
DYKWZRQcUgdTIJfEONbPFBeSMGVaXACHL,LFCFDGBDKFGFZBFCRFFHQAEG.UBBBdACAIEHAhAAA..fDGGhAAAODDE.NBICFDEBeHDGSEBChABAMAEAaAGEAABFCACF.HEBHWAHF...hBAA......hBCA...,1,-11,-29,18
IdgFCHXcSDMQYWOUPTNEVKGeRLaBZJfAb,dCAECCEEHDAGSDCFDIFC..QEGFOBFGUEGC.TFDFhAAANGCFEDDG..GAABhAAAeHAGaABGJHBEABHH.IFAAhABAXDEF.MCCGYADC...hAEAWAHBKFAABHHH.hCAA...,1,-8,-20,12
dDSBHWFMcQCaONKAGbLJUIeTRPZfEVXYg,LHCEUEDBeABATEAARFAD..ZCAEVDGB..XCGBhAAAdCCDSAHHBHGAFBEFMGCEhAAA.CEEA.aGEHNBBHAGIBJAFChABA....PBAHfFHGEAGF.DDIBhACAcGGC...hAIAKGAF..,1,-3,-22,19
eSbIUCgfNMPEHKBWOdaYALcGQZTVXJRFD,GABCTGAE.JDHBDHGG..eEFB..SDDGUGABCADA.gBDDhAAAMBAFHBECBDAGhABAdAFFAIGGQAFAhACAZDDHXDADbDGHNFCFEHDCKGDH.aBBF....hADA......hAEA...,1,-2,-19,17
YXPKaRMcZAegLICOTbWDUSGVNBJEfQdHF,eCEGLBHDOHBATBEGDEFF..GAAHBEBAEHGCdFAFFHFG..hAAAPBACKEGAMEAAAGEDCEEHUGAHhAAASBGE.hABA.NADD.fCDE..YGFEhACA.aDGH...hABA...,2,-25,-13,12
bMQegCEPLSXDaHUBVTIJFcYNKWfAOGZRd,ZFBHdGEDMBABeBECCDHHLAHF..XBABHBDHBEFH.IFBGhAAAFEFH..NEADKHFAhAAAAGAFOHFERACF.gGBAhABASGDBaDBE......hACA......hADA...,2,-31,-24,7
dOaWGANSYMCUDTZKcVQHBgfLPeREXbIFJ,SHBGCGFGDAGC.ZAGHKFDH..QFEBBACCLBDBeAEDXBBFhAAAFCHF.dHEHhABAOFBFaDCDAHHC.MBABhAAAcCAHHDFH..fAFEEBFC..hACAIHHD.JBBHhABANEEF.YFAF.,1,0,-29,29
YRgTNIHMDaeQSAOfPCbcEUVXFKBLdGWJZ,OFDDCDEC..EHGAUFGGFGEDBCHAdBGCGCAH.ZFBFRBAD..TAGHhAAAHDEAaAHF.eBCEhAAAQEGFABAC.hABAfGCEPFAH.bEAG...cADGhABA.KGABWACE.hACA...,1,-3,-34,31
adWDMRPKXcHCbOQSLJETZVfNAGIFYeUgB,FBCBUFGDBHHFdCDBDHAARAEF..KCAFHDBF.CGEB.OCGHLHEA.hAAA.EEEDZADA..VEAFhABANCAA..AEDC..GBGChAAAIFHC.eHCCaBBB...MAIBhACA......hADA...,2,-34,-17,17
NAOMfSgDVUeWKYaLXbGIdEQcTPRJFCBHZ,MEHBSAADDABC.eHCCKGEELEBCGEACEECC..QAEEhAAATCEERFFD.CAHDBCBDhAEANCHAADCF.OHCE.fCCBhAIAgADC..WCFA.XGBChBAAIAHA...hBBA...,2,-33,-7,26
VRDQEOUbGIXePWdTLMFCHSfNgKBAJZYca,ZADDaAFA.DCCD..OECFUFDFGCGA..IFFHeFBBdABBhAAATCBFMAGFCHHFSBAChAAA.NEBEBHGEhABAAGGH.JCGH.VADBEDEH.....bFDHhACAWAHB....hBAA...,2,-33,-12,21
VLTRQHJWEFUgdIMSbCfZNAXBOcPaGKeYD,OBAEaHAEGCEBKGCF.DBAHLDAC.RFFCHEDHEFHBFBBB.UEABhAAAIAHDMIECSCDChABACHHAZCEC.XFFDhACABBFCeFAF.YABC...hADA......hAEA...,1,-12,-23,11
ZIUNgRTMeYcFBKVOWQGdJSHCEAbfXPLDa,XEABDIBAZBBDUFBFRBDF....MCHDeFFDFGHDBBDAKGEHOCAGhAAA..GEGGhAAAdGCASAFGEDDDAAIB.hABAfCFALCFGIAFENBIG..hACAYABEWDAF..hAGA...,2,-28,-26,2
ZeEAYRDdLOBXPINgWUVQKCabSJHMTcGfF,RFGFLFGBBCCA.XEAE..IAAD..WHAChAAAVFDEQAGChABAKAGECAEC.SBCChACAHCFAMDAFcBDE.FGEAeBEFAEFB.DIBEODFGhADANDBE...aEHF.hACA...,2,-34,-10,24
FVWTNUJARGODLfPEMSaHdZCBQcKXbYIge,ODCADEBDLAFA.EFECaBDG.ZDFBBCHH.QCEGhAAAKDAAbEAE...IABChADAeHFCFBGETCCGUGAFABAHhAAAfHFFMDIDSFEDdHCHCFHD...hAEA......hAGA...,1,-16,-25,9
DcAJQNCVSOUYFReEKabTMZgLGfIBdHWPX,JECHCEAF..SGFHUAEF.RCCE.eDABEEHD.KBBB...aHAAbECGhAAA.ZGAAGEED.hABABHEEdBGEHACC.hAAA.WAGHDCIFAGEG..NAIG......hACAOBDH.FHGC.hADA...,2,-24,-18,6
NVZbHfEGDRgTIJCLSFWePAQYBXOUMaKdc,QEBDXDBBUFGGMBEB..dABBVEFGHFDBGAAARADH.TAGBhAAAIHAA.CDFFFBGGhAAAWFDH..AAFGBCHAhAHAKGCDNEAE.....fFCCDCDF.hACA......hADA...,1,-15,-17,2
CGNMWLEYcDRbSVFeaPTQUfHIgZOBXJKAd,CDAEMEABLCEC..EBBCDBAGSDCFFEBE.aGEEQEFChAAAUBEBHDFCZGBGBFFChAAAKAHHADIFNADD....WFBAhABAcBCB...bFAGPHBE.IHHBhACAOHEC...hABA...,2,-32,-7,25
MWFIPfeUZaCgSDEcBGHXdNRKOYLVTAJbQ,QFCBMGEAFBAH...IBHAeAGFZCBDCDFE.DFAFBBBAGDDDhAAAHADGdFHEKGAALHDEhABAAIDAJDAE...WBBEhACAfGGB.aFGAECHBNAAD....YFFFhAGA...hADA...,2,-18,-17,1
ANKJbXScfHLCDeROZIMYTGgWVaQFBPdEU,KCFGJFFB...XDAESCEHHFEHDGIDOADB.ZGAGMADEhAAATAADGECA.VBAFhABAFBGAPEHD.hACAEFAGNAIG...bDECfBGCCHHG.IHABhAHA...hAAA...,1,-8,-27,19
gbVaRATPCNEOKLdfMGHFDQJZWcIUSXeBY,CAEGOFHDKEFF.LDFGdDBBGCGAHFCB.DCBCZBBC..IAHDhAAAXFCBBBFF.bDBAhABAaGBFAADH...NCAE.EGADhACA.fCGHMIDCFGHD.WFFFSBFHhAAAgEAG...hABA...,2,-29,-4,25
XIRaKLJZeBdgOfDGFTCNcVMUQHWAbYSPE,SEGBXGGFRGDC.LEAHZBAB.dADCOCDDGEEAFCHDCFCG..hAAAVAGHUGAC.QAFChABAAFAB..YBBHhAAAICCDaDEGKEBGBHHCDDGB.NIAD...hABA......hACA...,2,-18,-15,3
JSOLYFGNQRTKEdBXbcAaUZWMDeCVPIfHg,aCABZACHMBFG.DAEECHDG....ICGEHCFFJHCAOFECLFCEhAAAFDEBGBBGQBAEhABAKAFGEHEEBGHEXDGAhAAAAHFA...eFAFfBEGYABChAFA......hAHA...,1,-20,-21,1
RbWXQIDfedGLFTUECBgMVaHKYOJANSPZc,SCBEZECDRCBA..XGGFQFCADCAA.dHAFFCGEEGFGBGAEhAAAMIEEHBEHKBFDOAAAhAEAAADF...cAFFhAHAIAHDeDBHTGEACEGFaFHF...YEFGhABA....hACA...,1,-4,-34,30
VQWJcfHEYOMKUXINadABZCDPLSTbGRFge,BCHCZECCCAECLDGDSCCHGACGFEEA..eFDGQGCFhAAA.JHEEcAGBHCAHEBGAhABAMFBBKGADUBAANCIC.hACAaGHBAHIF.DAAA...PAEH.bGDC.hAGA......hAHA...,2,-16,-2,14
egEWHDRXcMaUNIKdSJLfQBCZbGOYPTFAV,VFDDeCFHEBCF.DBHBRAEH..MCAEUGFGKHAGdGBH.LAEFBABECGGA.hAAAZBABGDBB.OBGFhADA....hAEA....YEHH....hAAA.FDDHAGAFWHFAcAFGhABA.NIAD..,2,-29,-28,1
ePVBOUISbHaXYEDFTLCZdKMAgfGcNQJRW,GEGGQFECRFBHeABABFAD.OCBBUCDA..SBGDhAAAaHBAEHFCFECGCAHDZCAB.KGFFgACGhAAA.fCGGhABA.NEIG..JAEC...WAHBhADA.....hABA...,2,-29,-8,21
fJaAICVQPdNbBTHeGEDYKMcUSLORgZFXW,CBCCVCEGdEAGBHGB..HEBFGCEAEAEHDDADKECG.MABG.UFGAhAAASBABLBHBRGCAZDGFhAAAXCBC.fHADhAGAABHEIHAC.QADGNEEE.hAHA......hAIA...,2,-27,-9,18
TLSbHEBgdFDVMOfXPIaAURJZeYCNcGWKQ,JDECeAGH.CHEH.GEAGKFEC.QCBELDCFHACCEAAA.dGAADFGGhAAAMEEEOGCC.XAFBhADAIHHCAIGCZFFAhAEANBAA......WAABSAHHhBCABHDC......hBDA...,1,-16,-21,5
aUDROdMQLWAYTNgfbXEPBCSHVeGKZIcJF,TEFC..gGCB.XAEGEAAACDECSAGBhAAA.VCBBGCBDhAAAKAEAIDHHJFEGFBGDDACHhABAOFCDMFABWEFEAIFAfHGBBGHAeDABhADAaFEH......hAFA..dADC,1,-11,-24,13
IKPNHZXAJDEeaTFLBdCYQVSWGRMOUbcfg,ECCBTDDDFGDC..dBDHCCFH...QDFFSHACRCAD.MAACUGAEhAAA..fGHEhAEAKHGE.PBBGNAEH.hABAXFFFAACHDGGGaCHFBDHC.WBFE.OFCFhAFA.cGEHhAGA...,1,-19,-29,10
BSGPOWfaDcCFgdVJeQKMRbYIEZXHLNATU,UGADSDFBOAEH..aBDACAAG..FFEDdBBG.JGBEKDBE..RAGH.hAAA...IGGAhABAEDHBHAFCAAEEBHED.hABA.WDFBfEEGDGIH.cDCGeDADMCAEhACA..YCAFhACA.,1,-26,-41,15
PUHQOVGaYbARFKLdXfZeIgJBDTNcWSEMC,KHDALFAEdAFDZDDGeFHD..JAAHDGBH.TGDF....hAAANBIE.SCEEhABA.EEFAMCHHCDEDPBCBhACAQGAGOCHFaCBD.AHGHRFFEfADHhADABADF....cFDGhABA.,2,-43,-11,32
AULVaFeEQCNdHgOfWBGbMSRPKXDIZTJYc,UFGHVFFH.FBCC..eDACCFDE.dAACHDABOFAEBHDF.GCEAhAAASADDKAGC.XDFAhACADCHH.ZBFCJADAAHBHEEDBhAEA..NIEH...fAFBMBAH.hABA......hACA...,2,-28,-12,16
QOPHXEUfTMAIZJWbaDFdCNGRBcYLegSVK,ZDCAJBGF.aBEFFABE..dEGBGEAGBGDGLEAH..eECEhAAA.SDHHhABAKFGGQAADPGEAECGCTBDAhAEAABDB..IHHCDFDFCAFC..NICB.cAGGhAAA....hACA...,2,-39,-20,19
DZINUfKSEQLAFcCYVXTeWHRPBgGJOdMba,CAEGVBBG..TCGAeEAHHAFCRECE.BEFGJBDF.OGEGdHFFMBAFhAAADCGHZFCD..IAGFhABAfGHA.SABChAAALFABAICCYCHBWGFE..PBBFhACA...gGCEhADA,1,-17,-26,9
WHeRISKEDJgLXaNBQVdYPGFCcTfOAbUZM,UADDMACGHFDFeBHHRFEFKGGB.DGBDLEDE..aAHFQBAAhAAAdBEAGCBCCEAAfBGAhABAABCEZDFB.SGBBhACAEAGDJAAB.NEIGBHAD.....hAAA......hCDA...,1,-10,-17,7
eOXVJRHPdWGAcDCIQKFSLEZgBbYNMaUfT,DHGECEDEKCECFAEB.LEFEZFEEBEBA......NCDC.MFABaHCG.hAAAUAAE..fDAAhABATDFE.OAHHhACAJADA....PBHDWHFGAAIH.IFGDhADASFHHECEA.YHBAhAGA,2,-45,-41,4
cCEaYgLDXFedPAMZJTBWQOVRSKNGfIUbH,ZAADTEDBBDEA.QEBBOCEE.RAFH.SBCEGEFC.IGBAhAAA.HCAHhABAcACECEHBaFHHLHCAhAAADAIFXGFHeFADAHHGMFAHJDHF.KAEC.fDCAhACA.EGEH.hADA...,2,-16,0,16
edbPTQXgHAUGDfBRCaELNOWVMIYKcZFSJ,UBFDDCBGRFDC.CAAH.LDFG..OEFFMDBFKDDDFCDB..SFAFhAAAdHGB..TAFDhAAAXCAAABAHBAEChABAEGDB...NECA.WFHDIFHG..cGAEhACAeAHH....hADA...,2,-50,-24,26
TEQISaDOLcFXVANbBdYWGRfJUKgMHZPeC,BEHFdCECGBAAJHAG.KFGAHEACZFBB..CAAF.EBDD..QACChAEASEEHDGFDLACEhAAAFDGGAAGD.NDGG..bAGF.hAFA...WFDHfBAA...hAHAMIDG.eFHFIHHBhAIA.,1,-10,-34,24
AfIYbHTQGBcZNMdUSRFOXDWJECLPgaVKe,..IDGFHABGQGCCBFCAZEAHdDCDSGEH.OBFHhAAAXGFFJECAECHBCABGLAFGhAAAaEAD.eADHhACAAEGBfBAE..bEFATGGEcGCEhADAMAEA....hABA...,2,-17,-17,0
FfcZEBdKIWGSObJgCAUaNYPVMDXLQeRTH,UCFEaFCA.....PFBDVDGFXADCLBAD..eFDFhAAARFABFBBFZFFAdCGBKBCF..hABAIHHBSAFChACAJFFHAEEGNAIE..DECE........hADA......hAEA...,1,-23,-27,4
OJXNSCZEDcFfKgaeHdIWPYBQTAGLMVURb,MFFAUCFARAAE..JCFC..SGGGCGGB.DIFAFBAA.KEDBeFBBhAAAHFAFdCDG..PBDHhAAABEBETFDGhACA.AAGFLDHHOHEENCAA.EAHD...fADBhAFAaEBF..hAIA...,2,-31,-24,7
UPFZEHOMXGQVfgDBJRcKIaLATNCSWYedb,CACGSCGA.eBEDdBFGPEDFZAAHEFBB.HBAB..XFGFhACAVFFCDGAGBDDGJCHH.hAAAKAFELHAGABHF.hADA.NIBD....YFCC..FCCAhABAMEAH....hAEAfEBH.,2,-19,-15,4
PWQIZRNJKgATMXDbGfHeVULOEcFCSaBdY,XCDGDFBEGDECHABAeCBGUEGHLAFGECFG.CGCC.BAEE.dGBAhAAAPAAEQAGAhABAREGHKHAA.ADAAMFED..hADAbDACOFFHSGEDaHGE.....hAGA......hBAA...,1,-6,-12,6
EQcLJRWFgPfdUDKOGAeVSCZaYIbBXHMNT,eECBSGCACCHB.ZBCFaBCC....IHAGXAFGMIFEhAAATFFCEAGC..QDFFhABALAACWEEChAEAgFGFdGAFDDDEOBBBAFHC.YDAFhACABHHA.NCEF.....hADA...,2,-21,-21,0
XMPGgRScJdIUHECNTQWafABVYZLbeODFK,BBBAVAFE.ZBEDLACFOBHB.FAAH.KFFEMHAA.GEFCREBH.hABA.JGDAdDCCHBDHCDAHQGDGhAAAaFAB.ABAH.hABA.eADCDICG.........hAEA......hAFA...,1,-21,-22,1
eYXQMDTcaSWKHBRNdVZOfJELbUFgIGAPC,eBGBXEBHDDBD...aEGDSCBE.KGDEBAFHdGAEZEFAhAAAJBDHEHBGLABGUFEGFABBhAAAIHHCAEAC.CAHFMCAHhACA..cAGDRCDHNICH.fDFHhADA.....hADA...,1,-16,-30,14
dYQBUJVEMGfCORXLDgZSNFaWTIbHcePAK,dDGBBDDAJDCCEGDA.GEAF..CBCDRAFCDADAZCAFFCBE...aAGH.hAAA.TGFAHDGHPHAEhAAAAAFE..KFCG.hABA.UGGDMEABfAHEOEFELABEhAIASCADIHCHhBAA...,2,-33,-12,21
EePDcOUNJVIbLZQXBWFfHaKdGCMATgRYS,TEEGRDEDEGAA..DFBAOAGB..UACEVAAGLBBDZEAGBDHEhAAAFGEHHGEGdAGGMCIHhAAAAAEBSDAA.PHAAhADANDHA..........hAFA......hAHA...,1,-17,-31,14
FNaYLRCHTIMfWBcbJPegDOSdZUXGAEVQK,VECFFABC..aEEBLACDHAEG..TFAAIAGE.MEIBhAAABHFC.JCCEeFFHDHCESFGBhAAAUCEAACIHEBAFKHGAhABARCFCCDAE...fFAGWHAG...hADA......hAEA...,1,-14,-26,12
YOcbgZWfGNBQXVTMCHLDRJEePSIKFUaAd,ODEF..gGEGZDBHGBEBBDGGQAAH.TGFHhAAAHEBDRBBE.eAEAhAAASGAFIDECFADEhACAAGFCdEACYDHBWDHHNABBMHBEDIAE.EDAB..hADAKBHF..aDDH..hAGA...,1,-5,-13,8
EFCORKSgXWDLJTUcVBfPYAIaebQHGdNZM,eBBBHDCCdAEBMFCDEHFGFGGHRFCG...KADGSBDA.XAAAhAAALEFA.TAGGhAAAVBGHBHAAfFAEhABAADABaGGA.QGDE...NDEFCACCODADhABADDDF....hADA...,2,-13,-12,1
gQUbBSTYaXeNJZCFRHPdMOGcVILfADEWK,EEHDKFGDQFAGBEBE..SGBGaECEeHCEZADFCGFDHADHdDGDGABGhAAAIEFDAFHADAGGhABAUAGF...TAADhAAA.NEEE..FHGE.MFAB.OCAEhACA......hADA...,1,-14,-19,5
NDXdHVLBaTRCOcKIQEfPSegUZGWMJFYbA,XGDCdDHAHAAABFGGRACE.CGAF.KCAD.QCCGECCA.SGHBhAAAeGCAUBEEZAGHMAEGhAAAFEEEAIBADAIF.aHEETEABhABA.OHEEcCAC...IEEFhACA....hADA...,1,-10,-29,19
GgJeRaVUWCFcPSTMbADYLKHXQdNBZEIOf,DBFDLDFHHEAEdHDFBABHEHGEOAEG.GACAeBACaHACUGBBFDGHhAAA..SGHHhAAAMDACAGCAKEEHXCGBhABAZAGH.IHFC.fEEA.hABA......hACA...,1,-17,-18,1
OMPdfgVETcbJQaCeHDGFWBRLKYIXZSUNA,OABFdDGB..fFAGVAEE.EDEBTGDG..JFCFaFGDhAAACACCHAEBDDAF.FAADRDEGKHAChABA..IFGHhAAAXDCDSCCDAGIDMAIF.PHEAbDAD.hADA......hAEA...,2,-18,-17,1
PYTdHfLOcaSFeGVCMKRBNEAQXIJWUgbZD,QAGDJDHH.UECHZABEDECA..PGFEdGDHLCCEhAAA.ODFDSAAAhAAAFGBD.eFABCAFCRDAD.BBCAhABA.AADGIDGH.gAEFhAIATAGBfHGBhABAaDDAMIEAKEHB.,1,-22,-29,7
MWQVONLKTBIRdcHDAaEgfYbUSZXeCPJFG,EBAD..fCGFUECGZAFB.CBEG.FDHFGEEF.QCCChAAAOFEDLADDBAFEdCAEhABADGGDgFBEhACASHBGPHECMFAB.WHAGKAEHIHHDhAAA.cEFFAHBC.aBBFhABA...,2,-27,-6,21
VNfLQMODTJZPCSgEBeGdcKURFbaWXAYHI,HDFGVCAB.LCDE.MAFATGEEJDBFZEDCCACD..SGBEhAAABAEGGGBHdEDHUAGBhABAFABDaBGAXEGAhADAAADF.IHHCfGHEOFAHDIFG...hAAA..ECCE.KCHD.hABA...,2,-11,-4,7
SGTDHEUBeLPFRfIYbKWVdgONJQXcAZaCM,ZDGDMFBGSGBBDAHBHCDGBEHBLDCGFBBD.RBFA....fBDEhAAAIFGGKHDEdAEDOCABhABAQGABAEGHCGHAEABAhAFAUAEF...eAAC..YFFFhAHA.....hAAA...,1,-4,-29,25
SdQOBKYWgCVPeIbDGJLHXcARUZfENFaTM,UGDCZDFAEBFEFFAF..MFAHQABFBAECKDAG....gDDAhAAACHDFeGFC.DBIHLCDHhAAAHADFAHCCfCABhACAaBHDSBAGOFHD..WHFAICGAhAFA...bFFFhAGAXFCC.,1,-10,-23,13
QMGUFTdXNVfDAOIKaCcgJYZEBWLRbPeHS,KGCDaDED.CBGD...JDBAZFDDBGAFLCAF.RDGB.eAAGHBDBMDHBhACAFGAD.dBEH..XGFChAAAVGEE..ADGBOHBChADAIABG...gDBBEFBE.hAEA.WAFESAGEhADA..,1,-16,-33,17
JZUcQDMFENHdVSgfYXIGROLebCKTAWaPB,aAGABHFFZEFAQEFD.DAADFDBAECBGHFDE.dABD.SHDGhAAAgGCDXFADhACAIBEHRBEE.ODBHhABA.LAHBCHHCAAEF.WADC...hAFA......hBAA...,1,-22,-24,2
feDXdRTgCSZbKVFPMEYcaBLNJOGHAIUQW,UFCDQGGHeADEdABGRCDB..CAFEZBAGKGABFCEH..EBEG.aGEGBFFBhAAALEAAJHEGHAGFhAGAAHFB....fCGAhAAADEBE.........hAIA......hBAA...,2,-35,-23,12
XCeQYKDgRASWfUJdLMNVGOIPZbEHcTBFa,SEGFUDFCdABFLDCFMACA.GADCOEBD.ZEDBEHGCHBFChAAABCBFaCCGCHEC..QAGFhAAADDDCAFHAJBAFNIDBIFADhAFA..cGACFHAC...eAEAhABAKDHHWFEGfGHEhAIA...,2,-17,-10,7
QfbHaRNWMTGZEBFXUcPIODCSdeVJAYLgK,LAFDQBAAHDBHaDEH.RAGFMEEAZAFBFHCAUGGC...IBCGhAAACDGASDAD.hABAeDCFAEIBKGBD.NEAE.TGFHhAAABCAE.XEGE.OAHDDGFD.hACA......hADA...,2,-19,-11,8
ZaYWFXPTgdBLAEVIbUfQKDHCSeMGOJRcN,VEECUCDCKFFA.HCBHCBAE..eFAGMGBEGCCBRAFC.ZACGaAADFCHHhAAA....PHFGhAAAdHABAGHGEDAG.IAGFhABAfHDB.DDIB.SGADhACA.cDFF.YADEhAIA,2,-26,-15,11
ERITdVPacgOBDSAHUCYKQfMXGbJNWLZFe,CBDEQCBE.MHAAGDAH.JHCCLCGBFFDERAFC.dAAE.hAAAPAEFaFAH.OGEAhACABHHGDABEAHHD.HCGDhAEAYEAAKGFH.fEEHXBBG.NAIA..hAFAWHBAeDDE..IAGEhADA,2,-26,-10,16
JRPOKgISBQdFLHcbEZDMVANGWCYaUTefX,GBEDCDFGUFGG.eACH.JEECODBH.KAEDIHGE.BHAChAAAdAGDFHDGLBAHhABAHABDEDDHMEIB.AHDFNGADaCGGhAAA....fEBH...hABA......hADA...,1,-19,-36,17
GSHIbRWePOEUXgcVYaNMQfJDZBLTdKCAF,SBACHCBGRFDHeGFAOBFEUAAH...XEABVEAE.aBDHQDGBhABA.JAGHhADADDGHBAHEdFDEADIF.FGGBhAAAIAEDPHAEECAAcEEF..MFFBhABA.LAFE.hBDA..CDEA,2,-18,-11,7
IdAMSJfXFeVROTQWUCYaGHZPEbDBKcNLg,JDEEFEEDRFAH..OHCCQAFE.UGGDCCCEGDAA.HEFChAAAZDAAEEHFDAGHKEDDLBBAhAAAdAHEACED.SHDChABA.fACFXGGCeACA.WBAFhABAaCDEBDGG..hACA...,2,-18,-15,3
cLbdUSYEVZMKNJIPDXTOGgWAHCFefBaQR,HCCCeCDCBFDAaGCCQBGGRABHLBHBUCAG..SHGAhAAAEFEAMIAEKABCJEABDFFDOFHDhAAA...WFAEhAEAAGHDfDFGdGGG.YADC.NIAD.hABAXADA..hAGA...,1,-7,-23,16
DPGYQEgeBUZCFcRbVJKTfSaLHWINMXAdO,DBGHGFCDEFFC.eDEGBBDACAGE..RDAE...JCAFTBFF.SADAhAAALEDHIHGEhAAAMACDAHHB.dAHAYFHHhABAQGAD.gBBD.ZDFEhABA......hACA...,2,-33,-15,18
gTIVaJDAFXEQWNfHCZeORLbYGdcKBUPMS,EDCGQEAH..fBDHHGCEeDBEOEGHRADC.LCHHhAAAbDFCdGHGBAAGUFADPHDChABAMFGBSAHFhABAIDAHaDFAABCB.FACB..XGAHhACACFEH......hADA...,2,-8,-5,3
gNMBebHTCcYGLPJKdRQVSAXFOWZaEIfUD,OEFHaFFB..EADCUAEEDAIH.MHAABDEHHBBD..CGCCGCABhAAALAADKBFHdHGDQGGAhABAAEDAXCFEFEGAZEBChACA.fEHAeHDGcGAC....hACA......hADA...,1,-9,-26,17
XcIDPEZLdefYQKSGgNTJFRbCHOAVMWBUa,MACGUGFC..aDDCXDGH..IACAEGDBLBFH.hAAAdHGDeBAGQCCChAAASGCANBBCFHAAbFABCEEDADIBhABABAEGDAIH.ZCGDKGGEgCEE..hABA......hAFA...,1,-6,-31,25
ZLCADeUSVXKRbQYFBOdPNWGEcHJfMTIga,eDHBSBAEKHCARAFC.QDDABGGD.OFGFdEBC...PAEEhAAAGBCCHFCAJBADTEEBhAAAIDBDaABFLCAFhABA.AIEADCHFXGACYHAA.hADAWCFBEGDEfCFEhAEA.,2,-24,0,24
PWENJRVTOKFLBYGUdXcCgfMbAIaDHQZeS,aCEGQEDCZDFE.SBGEEACA.RADH.TBAEOCAEFHFABGEAhAAAUEBCdGHG.CCGCMFAGhABAbAFA.DHAAeHCE.hACA..WFADNIABKDHD.......hAAA......hABA...,2,-21,-14,7
fVFWEUTYKDeZIGaXLdAMbQPSgHCONcBJR,MGBGQFDE.SCACHBDGNDAFBACFJDBA.REEE...VAFFhAAA..EBAGUFABKEAFDHGChAAA.IHDChABAXABAAHBF.gGFHCFHA.ODFEFCHB.hAEAWAEF....hABA...,1,-18,-23,5
PCUcWTfNYKSGIAeVbRQBEDFaOdMLHgXZJ,eABAVBEC.RFEGBHCG..DEGDOCFALDDFHCDDXACGhAAAZCABCAGC.UEAD.TGAEhABANAAGKDCF...IGHFhADAAHEDEDGB..aFHDMBBD.PHDG.hABAfEEG.hACA.SFBA.,1,-10,-13,3
fRPCAULgDTEMJdFXZIVYKOeaQWGbcBSNH,UBGDDEAHEEDDdFEC.FBDEZFED.....IADHVDBH.OFCHhAAAaAAF.GBGGBGHBHGAEhACARBBGCHHA.AADG.LBFFhABAMFGF....JDDCKGGC.eCAB.hAFA......hAGA...,2,-29,-9,20
PCIHZXBTUEfcgMJVOAYDFdQbNaSRLeGWK,DDDCFECFdGGFQFED..aBBBLAGFGEAEKAEGCEAHZAACBCHHhAAAEECE....fAEEhABAMCABJFEHADDENAIERFAC.hABA.eEEE.IHCF..XCAGhACA....hADA...,1,-23,-29,6
YMcGIdKQERUVFbPZfTgaeCNHOLBSXWDAJ,MFCEGDBHdEGDEGEAUCBFFHBAZAFD....TGDFeBCECAHAOAEBhAAABHGD..SBAGhAAADCHFAIBE..cFAFhABAIEGF.KFAGQGGA..hACA......hADA...,2,-35,-22,13
NMfCHGETSIgXWQbLPVdDBaYOUJKARZFce,ZEAHeEFAMEFBCADD.HBBEECEG...SGADXDDG.QGCGhAAALFBFdAAABAFCaGGAhACAOEGDKAHDFHDCfCFEhABAIAFE.WDDB......hACA......hADA...,2,-21,-20,1
JcdaRFVPTBUCQHeOMZIYXGESLKfDgWAbN,JEADaCGE..FGFD..VFCGBHHG.UBAGCHFE.HEBE..OCFAhAAAMEDGZGBA..ICCDhABAXAFDEADDLAEDhAAAKAEC.DIAGABBHNIBFdACA.TEGH.hACA.YEDC.hABASGGB.,2,-36,-3,33
DEGNBcIPTKZWfLedHAOQUFVgMXYbaRSCJ,OBDGQFECUBAEFDGA..MEFG..XAAEaGGC.CGABDDDHhAAAEAGGBHCE.IDDFhAAAKGCBZADHfAHGhABAdEADADGA.YDBHSFFC..hABAJHFEcFDC..hACA...,2,-38,-23,15
CSgXBDQJecGfFZVRaYbIWdALUMENKHPOT,MHDAECHDHACD.OCFBCHGH..XEDBDFHFJFAA.eAEAGAAGhAAAZDBBaAAF..IEDAhACAAHBDLCHDKHBASGFHhAEABACBfFFBFAHF.YEADhAEA..WFHHNCCB..hAFA...,1,-13,-18,5
GTUZINXdaAJfWCgRbDVFcKBQSeMPOELYH,JDHBCHAGRADD...DDAFFHDABGAE..QBBC.eGFGMBEHhAAA.EDBFHFACGFCHhABAZDFANAAEdBBDAFAC....hACAfDDEWGFA..gCFFhADA......hAEA...,2,-42,-17,25
eHQPORZJCEMfKbIDAGXUaWdTgcFNLSVBY,XEGFUABBdGFB....TCGFFBEDSBGDBGCFHCDBOBAEhAAAZAFACEBA.MABC.KFAFhAFADGIFAGIHGEBHaGAF.hAAAgFEA.NIAD......hACA......hAEA...,1,-13,-32,19
WgNROKLDFTUYIMEaJeVfScBdPCZHGQbXA,...NCDC.KDEGLCHFTDBE.UBAG..IABBMCEHECFDeEHDhAAA..SGFAhAAABHBEdBDFCFAFZGBEQBGDhADAAEAAgFACDIEGaHDGJAFA.fGFDhAEA.....hABA...,2,-22,-21,1
GAadDIfFUZPcgNeWBVJXYCRSbEMKQHOLT,DCGDFCHHZAAB....PFGB..cEDFeEEBBCCB.hAAAJDADXGEE.hAAARFBEEACFMFDHHCDCOCHBhABALFAFAGBEaABEICECgAECNEIE..hAEA......hAHA...,2,-33,-18,15
QdZgLaNTYVFbARUDSGJMKOWcECXHfPBIe,DEBAJEFF.KGFF..OFBAEHCA.HBBFBBGHQCGCZCDDLACDhAAAaABB.....NBIA.hABAYAFAFGAB.AEAFSFHHhAAAGEGGMBDGCHFGfHADhADA...PADFhAHAeFAE...,1,-22,-25,3
DWCHfbXRAISZEgUBcKTPYeNQMFdOGaJVL,SFAEZBCFUCFEBAGHKFGF....TCACeGACMHFG.FCAFhAAAdAGA.ODDE.hABAaHDCLDHHCHHAHACAfAAChAAAbFDFAGFG.EGBDcAEBNBIC..hACA......hADA...,1,-10,-30,20
YEKHOPGVJATBabDRLecCNfXUZIgQWMdFS,BHHEDFACeACHCCCH....XGCAUGGFZBAD.QDFBhAAAMAIDFEEA.SBHBhABAKBAAOAEDVGCE.AAGHaCEGhACARDAHLAAC.NAHC.IHACdGGGEGAB..hAEA......hAFA...,2,-20,-20,0
gFLVbKGHIJAQaSeRXcTPOCEBNdWUZDYfM,QGCAeCGBRCBF..XGGDTFFBCCBFEEDCBECF..dHABUAFChAAADBIBMACCLCDBhABAKBDEHFDCIHHGAAAG.hAGAaACCSBBFOEABNBIE......hAHA......hAIA...,1,-12,-16,4
ZbPCLJFOUEKRXHMVYSNTcgDQAWaIfedGB,aEAEeACEGGDHZEGFCAHF.LCAE.OAGHUBAHKEDCHDFCMAGFhAAASFDC.NBBB.hAAAgFCDAABA.hADA.fHBDBFFFPFABEAHD...XBDGhABA...hAEAYHDGDGGC,1,-9,-27,18
FZAdbCWKceGEMaRBLOVJNQPSUTIHfgDYX,dDCGCDAAKCCEeFAH.EGEARDGBBACA..LFEC.JAFGNEFE.QAADhAAA.SBEDhACAIHHFHEBHhAAADCGAFDGAADEB..bAFB..WDAFMAIDaGHDPFDFhABA....hACA...,1,-11,-43,32
IPUQMDJOKXadbNeEGHWFZLTfBYSRcVgAC,CCBBUEGHDFAG.OHDE..KGCDdEEGeBDCECGC.GCEFHCBDFHAELAAChAEABAFC.RFEH...hAFA..gACEhAAAIBHFMEIFaFDHWBAFfGAE.SDDGhAGAAHHHJEAD..hAHA...,2,-31,-11,20
EPWVAJfDBeLGRMKCdTNcZSIFXQObgaYHU,JBFEDGIDLEAHGDBF.MHDCCGFE..dEHC..TCDAZFDBSADFhAAAFAAE.OFADhABAbCFBaFFE....hAAA.YAFGECAG.PCHDAIHEBAFC.KABBhAHAcDBA.IADAhAFA.,1,-24,-33,9
DJUXWgLOIVbYadQfZeHFNPKGTcCAREBSM,BCFFMFFGUGDC..XEGHLEABOCBE..VAFBhAAAaEBDdBCFZBCDFBBDKHBC.TGGFhABACAFHAABF..EDFCDEFAhACA..JEEF.IEAG....hAAA.YAHHeHAA.hADANIEH...,2,-30,-20,10
DGfQALNZCRTIgKYbPcBOHdFUMJXEVWaSe,LFEDCAAFRBBC.TDFEKGGA.....bADABHFD.OEFAhACAdECAFBBCMAIBXEAChAAAEHBC.aHAADEBDfFHEhABAAAFFZAFD..IDDE...hACAPFCA...hADA.cGGC.,1,-8,-40,32
UXRbcIPDHZafTBGAgMVKFJLQSWEYCdONe,MDCEFCBHQDDF..SCBFEAEDCDGF.dFAHOGCAhAAAeADEREGD.ICHHhAAADFFAaACD.BACDAIGAKGAAJFEH.hABALHAANCAE...XECFcGGA.hACA......hAFA...,1,-17,-31,14
PBTbMgLWcOZNHUVaYeAQKIRDJEGXfCdSF,QDEHRGECDECFGAEHCHFF..FHBEBHAD.MDFFLAFC.ODBGhAAAHCADaEGAAHIBKDAFEACFhAAAdCGH..SDDHhABAbABA..gEGH.WFCGhABAcFAC....hACA...,1,-18,-28,10
RgEXQWSfCINdAPKDaZUGcMYbOJTLFHBVe,KEGEaFGEZBFEUGDG.GCAHMFEA...OAHBLABH.FEBBHFFFhAAABHBFVGAEeAEEEBCGhABAQGEG.hACASDDFCAEFdBFEAHIBDFCG......hADA......hAGA...,1,-11,-23,12
gbFHUNCEOKDTeJZMWfBLGIYARaPVQSdcX,aFEHVGCA..dEBF..XDFDFDHBUAFAEABCKCDA..DIACeABEhAAAMBDCBGGFLCFChAAA.IHHDAHIDQFBHhAEASCDB.gFAHNIAHCCBH.hAIAOAFA.JBAFfEEBhBAA,2,-26,-24,2
CBMOVGdgebJSFWfENUQKDAZYcIaTHRXLP,ZBGB..IBAGaFCHREDGLBDGBHGHVCFEdFAC....eDAAhAAASDAHFGGH.EFEBhAAANCIE.UADCKBAHAFHBTFBChABA..XGDHMEIBOHAC.gAGEhACAWABEDIAG..hAIA.cEEFCDEB,2,-19,-13,6
NGOBfeKXUTRbDIgYcCQAHWFPSJLMEZdaV,HFGFFBAA.JCAHECHFZFDGdBDG...aEGHGCCDBFDG.eFBCKCFEUDAHhAAATABB..DIBEIAHHhAAA.gAFDhABA.CHEGAICAWEEB.SGBGhABA.MACC.NIEFOEHFhAGA,1,-20,-28,8
OXSLRZKWAUYfVNcJBbIdeCMPGDaEQHFgT,UBGDVBFG...JEBGBDEA.dEGGCGHEGFCDEEAG..FDCFOFABhAAALHAC.KACGAHFB.hABA....YHFGhAAAfDHE.bADDeBAG.DEIBQABDhADA...hABA...,2,-32,-31,1
EPXKRgbQdHFGWaDfULOAVCZMYBTIcSeJN,VFBDCFFEZACGBHEF..TCAC..SCEDeAFFEACCKEEHhAAARDAB..QAGBhAAAHGFAGAGGDGIBUCGFhABAAEGHMDIH.IDDCJHAGNCDG.XGDH.hACA......hADA...,1,5,-31,36
eFcHdSVXKbLTYGUJEaMOPDgfICQNWBRAZ,ZDCCeDFGFAACHFGDdHCB.XGBDLCFCGCDGUGFC.EDAG.aAEEMFAGhACADACC....fCBDhAAACBDCQDGGhADABBHGAAGE.SFAC.KGFD...hAEA......hAFA...,2,-32,4,36
WAIfCMgbKSEXeZVaTYUFGLBOJcdDPRQNH,CAFFMCAEKBCD...SBDBeHBEZFDC.aBFGUDEG..LDFAhAAABADD.JFFBDBIHQGCGhABAHCAFAFHF.IFAChACA..fBGGEHAAXDAEYFHBhAAAFDDH....hABA...,2,-46,-9,37
UVfKeNTbagRSdHACGQWFJXDEcYLMOZPBI,QFCGFHAEDFEF.EDDGLECCZBCA.BHFEIGGFUAADKAGHhABATCGA..aDAGSAFEhAAA.AGIBCADAhABAJDFAXCACMGAC....OFGFhADAfEFC.NIED..hAEA...,1,-12,-41,29
NQbDcPYSKUaGJXLTEBfedWVCgZAIHMORF,HEFBRDBDFGFA.QFAFDGDB...cCCBSDAD.aAGGhAAAJHBE.XBAFhAAALACABFDAdEGHCBHEADECIAEDhABAMFEH.NAHG.PCCAKBFB....hABA......hADA...,1,-9,-35,26
eDMRPcINHXadVLCFbgKfSGYZUQOBJWAET,eDFARAFC..IGGBHCAAaAGCdCDHLFGHCHCD.FECCKBBHfFBEhAAASDFHGABFhABAZEBAOBAHBFFGWEADhACAAHIBEHEG.DGDB..MECANEIE...bFAC.hAEA......hAFA...,1,-4,-20,16
PQRFYNbLAgOTJdaZKSDHVfGICMcUEXeBW,OADAJHFCZAEA.DCBHHDEFGDCD..MBIBEFCFBBHC.QEGHhAAARABDFDAF..bGAChAAAADCETGDHKECH.fABBhAHACHED.XBFDeCGB...hABA......hADA...,1,-17,-21,4
XNbCTVIBdESfQgKLZFOJcDMUHRePaYAGW,XACGCBBG..IFHHBFEBEFBGQCGEKHCELAFBFDAH.hAAAOEGFDCDDHGBCeEADhAAAaGAHABAF.GECD.hABAbACAdAHE.SDCEfCEE.gGGGhABAcGEEMBBD.hACA...,1,-13,-19,6
dPLTDHFfSaJUcAZCWKbeOBIQVRNXgMEGY,ZAEGCDBEKHFCOCAG.BCEHQFBH.RAEB.NHCB...MBAChAAAEEAAdFFDLFFE.hAAADGEBHDFEFDFESCADhABAUGAEADAHeDDBIAGH...gCCBhACAYABE..hADA...,1,-18,-33,15
BRYDZfWPHXVSFbAgMTLOKUEINJaGQCdec,MBAALBDEUBGEEFDA....JEDGaBAGGEGCdAHABHHH.RCEEDADGhAAAZCAC....WFBGhAAAXGAG.SGGFhABAACEDOHAAKAEHIHEBCGFG.YCABhACA...PCCBhAGA.,1,-30,-31,1
MIWbDKPaFcdNGJYSXQgCfHLUeBRTVEZOA,MAHB..IFEDDFAGKAAF.FCEBdGBEJDAF..SFDGhABAQCGACADD.HABDLCBChACABGADTGCGZGFEAGAB.hAEAPFHHNEEF.........hAFA......hAGA...,2,-34,-23,11
ZRNYUEPGIgcXJSOfdBaFTACDKLbWVHMeQ,CAEBDGBBLDAB..VDFCeDCHRDBEUBDGEDGCGAAB...hAAAIGFGXBAFOFFAhAAAdGGHFFCHKHCC.HAFBhABAMDABNCEA...YAHH...hADA......hAHA...,1,-10,-29,19
RULdeDGHIOPAaKcfYVMSZbEFBJTgQCXWN,KBGH..fFEBVADGZFGH.EAHBBFEBTABE..CHAC.NAACLDFAhABAdDDDDCAE.IDCEhADAAGED..aAAEYEABhAEA.SFHB.FGDBQDADhAAAWBDA..hABA.eGAE.,2,-37,-3,34
MGAEJPLCZFgDbSVKHNIRXcTOWQfUBeYad,EFBAJEBCLCDEFDAF..DFAD..SFFCHFDGRCEC.XFADhAAATAAH..OEHDhAAAfHCFBBHEaHFEhACAdBADABIDCHCG.ZAGF.gGGFKCCB.IADGhABA....hACA...,1,-20,-32,12
AcRGVMWBEeLXFIfdbYJaZQPNTSDgCOKHU,RECEMHCEBBABLFFAFAFH.dBGD..JHBAQCBE.PEAHhAAASDAA.hABACADBKAHBADGF..cECEhACAGGEF.EDGHeHFA.XADEfDDBhAAA.aGAHNIAHDDDA.hABA...,2,-42,-6,36
fTWLJONFYGQVRDeAcdZgbBHMPCEUaKSIX,ZEAGBFBBHAECMFGHCDBCUGFGKABC....SBGEXAAF..hAAA.TGDGLEEDhADAOBEHFBHD.QGADhAEADDGFAHAE.gBBAECCG.IDGFhAFAWHAANEIE.....hAEA...,2,-25,-22,3
QdFOUcMGTeENZJBLDaIHSPYgVACbXKWfR,XGBGKGDDRAGD.FGFGUAEE.GDABEEECZCCBLFGBDACD.HABChAAASBFF.hABAPAAHYFEHAFAECAEF.hABAfCAHdAHC.MDDGNEIGBDBA.aCGChADA......hAGA...,2,-20,-9,11
TQZEJKSGRFOedbXMWLHDBYfNgcCaPAUIV,UFDFVDGD.ZDAF.KAAHSABB.FCDHdCHA.MCDEHBEADFAHhAAABHAG...YEBBhAAANACC.CAGAAEBBIGGEhADAQFEHEHBE....RDDAOAEAhAIAeADCWDAF...hBDA...,2,-31,-13,18
POTUXaACGfYLHEbJdRcSVDgKQZWIMeNFB,CCHFGBDGLBBAEAGEdGCDRDED...SFGCVEAC.DFADKHACZDAAhAAAMAAHeBAC.BHGAhABAOFHDTBFAUGEBAGHCfHEHhACA..YAGDbFAH.hADA......hAEA...,2,-28,-4,24
PJbXDfaETICUGBASLcOgeVdKZMHNWFYRQ,SFGBLEFAOFBFeDEF.dBECKGCFMAIDHEAE.FCCCRGDGQCBHhAAAJACC.DABDaAGGhAAAEACDCBHFBGEH.AGGF.hABAcAFF.gGGHNIED...hAFA..WEAD..hADA...,1,-20,-23,3
UObZdTKANfYcRWSHVLEGDPMaCegIQXBFJ,...NDDH.fDGD.RAECHEAEVGCEEEEBDACBaGCF.eGFEhAAAgDAE.IACDhAAAXCDHBHAEhABA.UAGGZACDKBADACCGWHFASHFG.hAEA......hAFA...,1,-5,-32,27
XUQTafGYcWNgPLVAedBJIbRDHKMEFCOSZ,dEFDJDGH.RGEGDFBAKACG...FCGBCBHF..ZFAFUADB..QCDEhAAA..TCBAhAAAaBADGGCF..YBADhABANDIA.LHAAAHAHBFFG...IAGAhACAMEAE.SGGEhAEA,1,-31,-41,10
WAIRQfEBFYbLJTaPHDdScVeUgZMKGCONX,RFBEEADGFEDCLCFF..TGFDaDBFDCHFdAAA..SEDBhAAAeAHFZADAMCIBCFAA.OCBChACANHAHAABC..fHFDhAFABEAE.YBBAPHAE...cGGFhAGA....hAHAgCEB.,1,-14,-20,6
DMgIHbOeETAJKRGdXSFaZQNBULfPcYVWC,JFFDKGDEGDBB.dGHESDEHFCHF.aGDFQACChAAA.BAHAUBBBfFBEhABAcBGG..VEAHhAAADGGBICFEOADGeDHFAAGG....hABA......hACA...,2,-32,-28,4
NJDTMagWYEcCeASPBbFQIORUZfHLKVXGd,SGACBEFGFBHH.OFFDRACBZFGDHEAA.LGCEKEDAXACFhAAAdCADDIBCaBFD...hAAAgEGB.hABAEHDGCAGCAAEAPCBDQCEHICHC.fAEFhABA..hAHA...,2,-30,-21,9
cgEOTHAGUVDMQabKeINXdPRfZCYBJLWSF,UBAHMIAG.QDDBKDCB..eEEEXBGBdBFFRFDCZBBCBGDBLDADhAAAFGGB.EACCTEBDhAAAACGH.DDIFIHHHhABAPAEB..fGABCFHH.WHAAhABASBHH.OGAEhACA.,2,-21,-21,0
GRSMLTIfcedQgVCFAbYHaNOXJZUWKEDBP,HDAGOEEHXBBAUDGG.KGAGDIBEGGDHRADC.SCGGhAAALBAF.TAGG.fFCHhABAcGGDQCCGhAAACEGEACAHaHGE.ZBFGBAFFPGACMIAC.eFFGhACA.....hABA...,1,17,-27,44
QcSGWRTNIaXDYgUZBdPefbAVLECHKFOJM,EGBACCFFFDHH..JAFB..QCBEGFEDRCBF...TADFaBABDDIHhAAAUGGFBHEBdAGDeAHFhABAAGDELBADKEDA.MFFDhAAASFAF.IBDFgFAGhABA.fHCHhACA...,1,-20,-27,7
RZbUODCHIPfSBVKdLYgWXecAMENaTGQJF,EFCAaGCFGBADFGDE.RADE.UBBB.DAAAIFGB..fBFFhADA.BCEDhAEAdDFFgDAEhAAAeFAHAIDCMBIBNBIETEDE.JFADZFFDCGHA.SAFChAIAKGEG.WDEA.hABA...,2,-23,-15,8
WVDKfFYAJUSZBaQcbMeIHgCdPXLNGEROT,UEDDSBHFZBCCBBABQCDB.MGAEIDBEHGFCCEFCdFHChAAALHAEGGADRBGBWCCDhAAA..KACEYACAhABAAFBC..cGEDbAFBgEGChAEA.NBBG...EAEA.hAIA...,2,-26,-5,21
UTPFgCVESJLBGKWYeMdXbDcHNAZIORfQa,OGDAQFBCUCDGFABC..CEBC.EDEHLDHDBGFBKEGE.eCDFhAAAMDAFdAFHDGBB.HAAFhAAANEAG.ACGH...IHDFhADAfAHE.aHCEPFHF.SCCFhAEA...hACA...,2,-36,-15,21
DeFRGPKBCAXgTIHWZEaOcNYJfVMdSUQbL,XECHTBFH.HFFGEDHH...aAFAOAAF..NDAAJCFGfACChAAAdDBA.UGAGhACALAAEeFEHFAEBPCCAhAEABAHFCHEBAGBDgDCEIEFG.cGGGhAGAMIBA......hBIA...,1,-5,-16,11
BcFfdNaTeEVWAgbZRDKXQPUJMCHLSIOYG,ZDDEDEEAQCBFUGAB..JDAECBHALADC..IHGChAAAOHACBHHHFBFCdACHhABANDEF...eDGHVFFHhAAAAEIBRFDFKFCG..MAFCSBEG..hABA.YCAF.hADA..fEHE,2,-32,-19,13
aUSDfVcYPIdTJCGXEFMLRNbgBAHOKeWQZ,KABEQEGAUDEE.DBIH..VFCH..PEABdDBB.CCCHEECAhAAALAFA..bGDEhABAACIHeFGHZACG.aEACfCGChACA.IFEF...hAAA......hAEA...,2,-40,-17,23
cFERCQOdJXagMDLGeVTUPYABbWHNKfZSI,BHGCHDEBKAFAZEBD.SCAGFEGHRBGB.CHFE.dDAC...JACBgEBFhAAA.DBEFeEEHhAAAUABAABAG...NIBD.hAEA..IBEFEDGDXFCDaDDF.LAHHhAFA....hBAA...,2,-42,-16,26
LZDEegcQBTJMfXRUPWOYVCFKSdbINHAGa,LFFBDBDCEFAA.eBDCQGEEBCAEMCHBRCCG..UAFCOEDFhAAACEGH.KFAFdECE..ICFChABAABHGaBAH.gDAGhACA..cAAAJHBA.fGHEhACAXBBFYFHBhADASDHBNAIA,1,-26,-36,10
YRTaUKNDeOfIXLbEgQSBMZCdPHWFJGVcA,TCEDaEFB..UECEKCGCDGAHeCAA.OAFD..IDBFhAAALAAAEEEBSAHHhABAZAEGCHEFdABDHEGFFGGEJEAHhACA..cEACAIEC..YHAGNDDG.hACA......hAEA...,2,-19,-16,3
WAfUCXVBTaGbRMePENdLJYgZKFHDISOQc,UAAEVDAF.BFECGGEFRDAD...eCDHEADALEHBJDHHZADAKBADDDDFhADA....IBHEhAAASAHH.OAFFhAHAcFDGAIDAXCDBaHAE...MHDChBAA.....hABA...,2,-27,-23,4
DPLZXWUfHFNTSEACeIQaGcdKgRbOBJMYV,CFAGQFEHGDADKBHHRAFFBDCC..MABEDCCALFABZEFC.hAAAXDEGfGGEhAFAFACA.SHBGhAGAeAABICHDdFDEbBBGJFHH....PBFFhAHA......hAIA..WFDD,2,-18,-18,0
RXKgCVGFfeBWHZLSAYPJOadIbEMDUTQNc,JAACaCBA..dFBEEGABDFGA..UEDC..QEEAREBFKGHD.CGHAFBEFhAAABDHEZGDCAAFC.OEAHhABAMDDE.....hADANIBF.XADH..gDBEhACAfBFBeABALFFBhAHA...,2,-39,-16,23
VASbDHUOcJadCZTWILfgePYMEKFXNRBQG,DGAAOABB..JAEBCBEBZDCG..TDECLFGH.eCHBMBDHhAAAEGDBKGFD.FCADXGEBhAAABAHFGDGCAADGSAFBhACAHGBC.aHACIABA..fCCFhAHA..hAIA...,1,-27,-29,2
eZAKUXVWcYbQJPNaELRTHDdISOgCMfFBG,KGACXDEC..VACB....YGCEQGFGJGFE.hAAAPHBCEHAG.RCFDDAAHhABASDCF.gCAFhABACFHBMBBFBFECGBGCeAFAAAFFcACFhAEAaEAC.....hACA...,2,-26,-14,12
CNdSIXBeEMFWVOHQgZUJDYaKcfLRGPTbA,CCGASHAEBAHA.EBFDFGHF...OFFDQDFFZFAD.DIDChAAAKEDAfACEhABALCBCRAEBTAGC.bCDHhADAABBCdGEGXGGDMAAH.WGAE....hAEA......hAFA...,2,-36,-19,17
LOKFRgPGBdbMfeEDANcaYWICZSTVJUQHX,aHDE..IDFACEDBZDFG.SDCH.JHDAQFGHhAAA.HADHLBAAhAAAOAGFFAEGRGACgBAFhABABBHDMGFEfHAFDCCHAAFA.YDADhABA.WCED.hACA...,1,-23,-31,8
dEfbACKTIXOJYVDRMFGUWLBagQPecHZSN,CCGCKAHH...TDFCXBCC..OBCGJFEB.DACAREBEFDHDUAFChAAABAHBQECEhABA.eHFAHGAGSFFAhBAAEAADAEAG.IHDEMACE...WBBDhCAAaDDAgGGHhABA..,1,-26,-30,4
TafKGbUVCOPLQRFgcSADXHeNBdJMWZIYE,HCCDBFGCdAGHJAFEZFEGEGCE.....aEADKDCFUCFHOEAH.QABFhAAAFAAB.SEEDhACADGIHeCAFNECCIHGDhAEA.fDFH.bBECCEFA.hACA..PHAC.hADA...,2,-28,-20,8
OIQXREHKfVeGSTFUNJMacWdBCDZPgAbYL,LECHOBFG.QGFGRACFEDFF.HAGDVFCDSCCChAAA.FEGCUFGBMBBGaCBHhAAAdAFGCHAEDIEEgEAGhABAAGAE.IEEG.KCAH....hACA......hADA...,1,-4,-34,30
HFXfGBPLRWUMdgAVZJTOIEYNcQSeDCKab,VDBGTAFF..OFFGEFCA....NHAH.QCGGDDAC.hAAACGHBKFDGaGGBFEACGADBhAAALDECRGAEMABCAAIFIBADhABASCBCeFEC.XCCFBHHD.hAGAWHCA....hACA...,1,-10,-25,15
NPXMYdcBVHRFSGZAKDIeJbCWTgLQOfUEa,KBDCeDCHCAHG...TBECQGDE.UDFDNHBF..MEEEdBADBHGFhAAAVBAE.HAFFSFGAhAAAAEAFDDCF.IEAGhABAJFAB...bAGFWDCHOHFC.EADAhACAaGGA.....hADA...,2,-28,-15,13
DBIGFbSaLMCcQKEVJWRHAZUeYTOPNfgdX,ZFFBeCBHODAD..PAHH..fGBCdADABEEBIAAEhACAFBAESDDHhAAAaGGDLDDFCFHHKGDCVAGHhABARGACAFGC.UADHTGEF...NEICDBGH.MAFFhAGA.....hACA...,2,-26,-3,23
FbMBUCARdEIWOZXVgKfPaNeDTLHSQYJcG,EGBBOEAGZDDC...VFFEKBEH..aABBeDDHDADA.LHBEHEGFSGCEhAAAQAFGJAHHhAGAFAAFBEBGAACFdADG..hAHA.WCFAfCBF.NIED....hAIA......hBEA...,1,-17,-20,3
cZKEbYWdVagUPJTGLMOeRFAHDfNSCIBXQ,HCEHDDDF.SEAHBDGHQBEAKADFECAC.....bFGDYFGFhAAAdABH.aHBGgGAFhAAAUECF.JFFDhACALAHBMAECREDFFHCCABBGCHEEcAFC..hABAWCCF....hAIA...,1,-3,-23,20
aRZfEgBVdSYKLNTJIUFCMHXPWbOGAecQD,eDCCQEAEDGAFZEBAEHDABAAF..SDEGLAEGJHDGFAGHHECHhAAA.XBBBhABA.PGFG.hACAOAEDGDGCAIFGaACAgBBFYCHB.hADAKHAC.....hAFA.IGCD.,2,-31,11,42
IJLKMTYgBVXdEUSODAbGNcQfaHeFWRPCZ,GCADQDCAHACAeFFHFGGARGBGZFCELFEBKAAG.MDFCTEAFhAAABAAHXACBdAFAEEADSAHFhAAADDIHAHDD.hAFANEED.fHGF.aAGACECA....hBEA......hBFA...,1,5,-19,24
EXBWDPZCQgafLTKAdSbRIeNHGJOYFVMUc,dBCERBDAeDBGGEAG.JEDFOEFE.FFAGMCAHUGEC..XFGDhAAADHCEZAAE..CDFH.aHDEhABALAHDACED..hAAAIFFD.NCIG......YAHDhACAEGHBBFDC..hABA...,2,-25,-25,0
DCSGOdcVeRLbfIWPKXaZNYBUJHFMTgQEA,DCHBCCGEGEDGOACEdAFD..eFEFLAAC..IFAEhAAAKCDDaEACZDFCBGCGHGAEFDDDMCCFhABAQGFAABIHSBEAhACA.RGFA.fCBA..hAEA..WHAG..hADA...,2,-36,-8,28
XZaLBEHQeKTPUNbFMSdGDWJgfACIcYRVO,CDCF..IAHHRFDE.OEBHZCFAaACBLDHFBAEEHGBAKAAAUAEHhAAAFAAD.dFFEDAHBJCCHAAIF.hAAA......hAGA..cFCEYFFC.XEBChBDAECFD..eCAFNEDB.MICEhACA..,2,-31,-11,20
HgeQECFPRYAfXJLDWaGbBKSTUZVMNcIOd,XFCGJBCGLFCEDFFE.GAFCBEDCKBHF..UGGAZBABMAADhABA..IEAAhAAAHGEEQCEEFABG.hAEA.YBHBAIBEfFAEWHAG.SCCFhACANHBFdDDH....hADA...,2,-27,-15,12
HUGKRBeFNbdPTZWEXcfAQMaDJSVgLICYO,QAAADEHH.SDAHLFBCCDBAOECGUGADKGFFBHGFFBAGhAAAdFGB.ZAGF.XAEDhAAAADGAMBIH...aCDChADAJADHgGDE.IGBGHDDGeAEGhABANIAH.....hAEA...,1,-17,-30,13
aLGJKRbgFVHBUPXTfDcSMZCWAQNdOeEIY,QEBBOBDD.EFFGIAAELAFFKCHHRABDFDHBHDBB.UAFBhACATAGFDGGB..MFEGhADACEEFAGEHdBDAeFHH.aGEH.hAAA........bGACBHHH.hAEAXGCHSCBFhAGANEAC...,1,-9,-18,9
JUDKHaAXfWeNITgBEQZCOPdLSGYbRMFVc,XFGCeBCE..NEAB...IGCDBAAFEFAHZABH.CFEFODEAhAAAdHDBSDFGGADDRDAFhADAMBIFFHEC...cFFAhACADIAA.HAFDAAGAfECH.WBHHhAEAgBBG.hAIA...,2,-19,-17,2
IKFBDaQZCWeMAdfEUPSONTbcLYXVJRGgH,ECFEUDGH.OBBD..TGGALFDDVBABRADHHFFCFEDBBHADhAAADAGFQFAAhAAACHEE.MAHBfBHGhABASDDGcEAH.JFEE..IBAAhABA.KDAD..aAGAhACA.eDDEAIHG,1,-11,-13,2
GYgEQPXWFJVDbSfBLICTRUcNaZeMHOAKd,KCHDdDEAGAEBEGAB.QGEG..PBABFCAEJFCDVEBHhAAADABC...SFGBhABALEABIHHHhAAACEEEUGEAaBEBeBBEMAFC.ABBG......hAEA......hAFA...,2,-21,-21,0
aSEVDcMbPLHRUOfIQKgGJYCNZdTAXFBWe,XEBGBFHAeBGD.EFCCDGDG...MACGLEEBHBBBOFEAhAAAIDCGKAGGGABHhAAACDEFZGCAABBBFHAG.SFAChABA..cGACPHFE.fCAHhACA....hAEA...,2,-27,-21,6
IdGURSgTBKLAWJNfZDMPcFYQeHEObVXaC,JEFGZCDCMFBB.FDAGQGDA.HBEHEFCHOAAA.hAAA.bBBBaGHDCGGEIAHFhABAUAGHSECEhAEABGAGAEBB...fEHADDAFcDCDVFEFdGBE.hACA......hADA...,2,-25,-13,12
WMIbBaDOSFRfNAVEeZQdPLUYJGcHgKTXC,EFCFZEACQCAALACHUGGHGGEDHEEATCGBCCFD..MFBDhAAABAADDAEEFDEDRAGHAIDEdGAB.hABAPACE..YBBDhAIAcEGCKDCE...WHAAaEGASECChBAA..hBEA...,2,-14,-1,13
SbLfQEWVBNgOdAIcaGRUJHCKeFXMTDZYP,aGCBUFGAHEEHCBEA.eAGBFCBF...MBAFDIGEZACFSHFA.hAAALCBHQBGHhABAEBEFBEHDOEFHAGHEIHAFhAAAGFADKHDA........hAEA......hAFA...,1,-10,-33,23
WdNPUTBAfQKCVLeFcDSGIgZHaJbXMORYE,KBAACDBCLDFCFGBE.DACGSCEB.GEEBIFCGHAGHhAAAaGEA..XDADhABAMHAARAEE.EAEAdBABNIDD..hAAATDCCAFID.fGHEeFHDgDDDhABA.....hACA...,1,-18,-23,5
HdSINfeXTbDaCFBALEUcKQJRZVOPgWMYG,UCADKFADRCAHZFCCOAAE......PDFEMGBCHDDA.hAAAIHAGeADAbFFBDGHDhAAA.aBECFCEBBGFGEHBA.hABAQAGB.JCHB..WCCB.hABA......hADA...,2,-24,-23,1
JAKCDXSHMRYGeEbVZdPWNULTgafOBQFcI,DDDBSBBBREGHGGCBEADCZAAC..dFGD....PFABNDEDLFEHhAAA.aFCHfBEAhABABBHBFGAFIDABhABAKEFDCEBCMAEEeAFCbCFE.WDDD..gCAChACA...hACA...,1,-12,-22,10
HcBeNCGYIDgMFZXdKUTbaEWfPSROVAQJL,LFFGHFACeBCECAHDGEAADDCAFAFAZCAB.KGFHUAAA.aDDEEDEF.hADA...fAFAhAEASGDHOHDChAFAAFFHJDHHBHHEIBDGMBAFdDGD.WHFE..hAIA......hBAA...,1,-18,-20,2
ZMUVNbXPFGQKAfSRJWdOaIBEcDHCTYgeL,RFDGdCFDOCCHaFFE.BABEEEDC..HAEC.CHAF.TGAB.eAEFhAAALBAFZAGD.MHEAhAAANIEF.XCCGFDAFKEEEAEHEhADASEGE.IFAG.DIDEhABA......hACA...,2,-24,-22,2
DaOGFVAfRSKZCETXNQbPYgdBeLUMJWcHI,SABEKDADEDEF...XBFAQBGG..PFAEhAAAYBBHBCCFLFCAhAAA.MBDBJAEGWDDEhAEAIGGEDIFAOFEHFHAGAFIHfDHAhABACFGBNBIC....dGGH.hACA...,1,-18,-27,9
dIGPDUfFRXZcKeYSJOHBMLaAgVbWQENCT,VABDQAEC.EDADTFDHGGADDFIFFAABZBFCKDCC..SHEAhAAAJEFABHHAaFDCADFF.hABA...gGAGhADAbCFACGGB.PAFGfBGHcEBD..hAEA.OBDD..hBAA.MDHB.,1,-3,-13,10
UWERfIFLeXcMCgAYQPdDSOaKZbVJBNTGH,QCDADEHHOBFFZDBEJHCE..BCBHGABHUFGCEHBA..RAFDFAABhACALFAG.eAHBhAAAXFAFMIECCGFGABCE.dFEBhABAaDACKCAF..NAIC.WEHH....IFDGhADA...hACA...,2,-24,-12,12
NeTdPSYEfObBMAcLQRgGDaWUVIXZKJFCH,LAFBQGABGECHDDFBUGFF..VFGDZAFHKDBFCBHFHADHeCDFhAAATCBG.SABChAAAEEGAOBAAMHAGhAHAAAED.....cCGEaHCE....hAIA....WCAFhABA...,1,-1,-32,31
NgHPWLXdGRYcCaOAMKDEZeUJIQTfVbSFB,KFGFEEGEUAEDQAFG..VBABSAHBBEDBHFCHLFEFhAAAdHADRFFH.CFHBaCAAAHHADFAAZEAFhABA.IBDD.hAAAfABFNDDB.PDEG..WBHBhABA.....hAEA...,2,-20,-19,1
PVNQYeBAEUTObWgSfDMGIXFLKZdCHaJRc,UDAGODAA....bEEBSFDB.DGADMIDAGBEGhAAAIAGFFGFDKBAAZCGFdGBBhABAaAACJAFCRBCB..PAEFhABANCHC.....QGGFBHHGAIDE.hACA.EEAE....hADA...,1,-13,-22,9
GKIYCbERTcDNAVHBOXZQSUaPfFgeLWJMd,BCGHZBBFUFEBaAAH.FGACLCDH.MDAAKFHHCCFF..RFAEDGIBAADB.hAAAHFEF..XDGBhABASAEE.fDHChABAeAFEdCAE.IHAHEDDG.NBBD..hACA.OHCC..hAEA...,1,-18,-34,16
NIcJLTbXUDSZQEdWBKfCYgMPGeRaOFAHV,VBFG..NABE..JCGDTECE.UGFHZFBHdHFHBABACGGC.MADHhAAAGACF..eFAHhABAaCED.ADIF.HCCHLAEFhAGA.DEEEEGAFKFFCfAGD..hAAA......hACA...,1,-17,-27,10
NgKPZGCeRdXIacBObDHTMUVSQJAEYfFLW,EEEEFDDGLGBE..gBDAKACEGBADCHBHdAGG.XABGhAAAIAGF.BBFDhAAAOAHFDHFAMIACUEBAVGEChACASFACADADfEGDPDHDeFEGhABAaFAH......hAFA...,1,-7,-28,21
TeKYAgcJMBFVRIPaLWfbXONUSGEDdQZHC,JBAAMDEBBCFCFABG..READ...aAECLDFB...fAEGhAAAXGDHUGAEhAAASDCBEFGADDGFdHGFQDBBhABACCHDKEHBAECBgAGEIDHG..bCDDhACA..NIAF....hADA...,2,-37,-16,21
BCcYaHLPMUAgXJWNQISTdZOefDFbREKVG,JDEAQBED.SDAFTDAFOBCDDHFERDBG...KAADBHDChAAACGGC.aGAHLAHFhABAUEGEXBGB.hACAIABDZGBGFAFDbEFE..EBCCcECEhADA......hAEA...,2,-26,-16,10
SeFTfJHAQZdPRDKgVNCObYXIWBUMGEcLa,QDCGZBFAdBACRFED.DDIBKCBE....NBCF.ODFE..XBBChAAABAGFGEAFhAAAEHCALCEGaAEB.FFEGhABAJHBCAHBHPHFGCAHA.IAHCUGGGMDDChABASEAD..hACA...,2,-28,-16,12
ZWPcLFUOVXJQCMSRgEAGeDIadHbfYNTBK,eAEFDFCBdEFGHEED...bBCDNHDH..BDBEKHAEZEGD...PAAFhAAALEAHFBGGODAHhACAVAFDQACDhAAAMIFASGDHEDDCABBD.IFCGaDGD..hADA......hAEA...,1,-2,-30,28
aCfcgFENADWGXMZUHBVQYIJROPedLTKbS,DFBBGAEAMFAFUFGABCAGQGBA..JDFFOBABeHBCLCDEhAAAKAGH.aFHHhABAfCDG.hACAcDBHEEDBABCFWAECXGDA....hAAA......hABA...,2,-35,-29,6
DMVWdLFTUEaCgbePQGYOcfKXIHBRNAZSJ,ZAFCJADA.MDEDdECELCFCUDFC..aGHHCEEH....eGEEQGCGhAAAOBBEKEHHXBBFhABABHBB.ADAGDEAGFHDA.hAAAEGAG....bCAG......hABA......hACA...,1,-27,-33,6
WKeUXQAZCVYdHcJDLaRMOENgbBSTfGPFI,ZCBDVEFFdEDF.HAGHDEBDLAEFaCAF.RAFH.MABG.EGEE..hAAANCCABEHETGCF.fFAGhAFAFHCGKABEeDDBhAAAQGGCAIAA..CHHA....YAHBhAHA..OCGHhAGA..,1,3,-31,34
VXGCgSDKAPBJOFUaRfIWQbNLYeEMTHcdZ,BDFHODEFUBFHRACH.....IBAEbBFELFAE.EHEEhAAAHEFGZBAF.VEAFCGGDDEIBhABAACIFJDDD..fHBDhACANADF.MAECTCBF.dGGH..hAAA......hABA...,2,-28,-13,15
HBFRITEDSNVOLMPcZfAUaCXJYdWKgQGeb,UFGGCFEA..JAFFdFEG.KCDBQAAFGDBGHAAHFCCH.RAEE.EDHFDGDHhAAA....NHCB.OEAHhACALEADMIEGZBDFhABAACIB..aADBXGGB.....hAGA......hAHA...,1,-16,-25,9
HCWMRZgAQfObVIUFaEBcYKdTJDGXNeSPL,OGBAVFAF.UCFBFABABFEH..KCBFdCDGDABEGCFG.eAFEhAAAPFFHLHDGhAEACHBH.MFHFZADBACCA.QAGHhAAAfBBEaEHDEEBG.....hAGA......hAIA...,2,-37,-9,28
ceXQZHJWTVfKSIgMUBCbLPEDNdFaGOYRA,XBBHQFGEZEFEHBAA.JFAB..VADHKADG..SCGBhAAAgFAEBGEHCGGBLHAAhAAADEDHNECA.dCACFEEBhABAaHECOCDEAEGC..cCEDWAFE.IBHBhABAMIDE....hACA...,2,-21,-9,12
BUafRIbeYPWVOMDSAJLHcQNZKdGECgFXT,HBCGQAEFKGGGEBGCFFFEBFDHUDBA.REDH.eDBG...PAAChAAAOHAG.MAIFADIHJHAGhADALBAF.NIEFdCGChAAACGEATDFD.IEAC...hABA......hACA.WCBEDAGC,2,-17,-13,4
MRbgOGLXKPHfNVESDCIQFeTJUdaZcAWYB,BBCFMBCARAGBOGFC.LBGFXCDDKHAGHCAG...fGHChAAAEAACSCHBhAAAIEAGeFCAUFCBhABAdAECaDCHZFFBAACG..WDAH..gGADhAEA....hAFA...,2,-25,-11,14
BcDAYUaVZFEKMTgHJXIbdROQPGLSeCNfW,UBEGVEGF.EACH..KCDHMECBHFCD.JADE..IGAFRBAE.hAAAQFEDLAHDSDAFhABACHGH.hAAAfCFCBEEFDAFAYCAAaGBHTGEEgDGAhABA.XGCDhACA,2,-23,-23,0
PKGTQfUWVSBLgEdcCZAFIHDYXeJbNORMa,HGBEDFADeDCBJDED..OGFEaHGC..KDABQBCBUABD.SAAFhACABCHFEFGDdGBGhAAACBGEFEAE..XGCEhACANAEHMDID...PDDGfDGC..hADA......hBBA...,1,-24,-26,2
ZQCGMPgHBILbUDacXOEAVeSfNRKdFJTYW,SDGARCDBFHAA..JHFCTBGFZAAD.CADCGCAC.MFFChAAAHCGDBDDEbEAGDAADaGBEOFEBhABA.AIAE.eFDAhADAKAFFdGGF.........hAEA......hAFA...,1,-12,-32,20
HgWdBLfIOXKTSNbADJMVFUeRPZYacCEQG,DFEEMDHDUADBRBAE.ZGAE..aFDG..EFHHQEAFGAGAHCAAhAAAdDDDLBEG.hABAfGGGIGEBKABHhAEANADFAIFE.FECG..eAAE.cGDDCHFH.hAGABGBA....hAIA...,1,-16,-18,2
VLaOPNCdFHWRZgeDUIAQbSXcYTJKMBEfG,QFEBSFAB...XADETFDFMAGHBAABGCGEhACALCCFOCDHCDACdBECFEEAhAAAHGAG.RDAFgAGChADADIBGAIFAcGGFKGHHEABE.fAHA.hAEAaDHFNIDD.....hAGA...,1,0,-7,7
QEdIfAHYOJgMCKPLUcaBSZbXTGFRWNeVD,HADCOFBDMFFBKEEDLBCCaGCE.ZGDEbBAHGCEB.RDAF.NEEDDBHDhAAAdAAG..AEIF.gGADhABACAGG.UDCChACABHGHSHGE......hADA......hAEA...,1,-12,-28,16
aOVYLHWJcAfMQeCNKbGFIdDgPSZTXREBU,MDCAQFFB.CGBB.KBCGFBBHDEFH.SAFGZAEHRAGHBEBFOGAEhAAALEDB..JDGFhABAAHHFeABG..bEAAhACA...IDAA...gGGGhADAXDGEEGADaHDE.hAEA...,2,-40,-24,16
ZcdEgLMGSBDJRIHaYCTeUXANfWbVKQOFP,...NBFE.fDHE..bBAHKACFOEDHZFEFEEBALBGHhAAASAHHBHGHDBEDIADBhABAaEAHCGGH.UFGFhACAADCAVGBAQFAHFBAH..cDFCMAFG.hBAA......hBCA...,1,-14,-18,4
WEBbAQOJKXDRgSfVcGNZTYMPFLUCIdaeH,OCAFKAHFRDEB...SFCFVEAC.GAFAZGEGMBDHFACDCDDCdAAHhABAHEEBBGCHADIHJHFEDGAH.hADA....fAHEhAAATAEG...YEAF..hABA......hACA...,1,-25,-33,8
NPbEOaHBdFAGKeZTIcCJXLDgWSfMUVRYQ,eHCCTCGFCCFE..LEECDCBE..SGBEMADHUEBBVEEBhAAAQAGE..hAAANBAHEDDCaBBFdGGCAHGBKBFEICAFhABAXDAG.fGAE..hABA.PEHFOAEBBHHGhACA..,2,-23,-12,11
EKSWBDQIeJLCbNAfPXMGVdRgFHaOTYZcU,XAADVEDF.RAEB.FAHDHEAB..TAEFZDGBUEDG.SCBAhAAABEAFDIGGICCEhAAAeFHHCHADAIEC...PCGBhABAMHCA...dFHGaDFDOHAG.cEADhACA....hADA...,1,-6,-35,29
XVZcSHgRLQYOWTbDACFPUIfEKJaeBGNdM,CAEAFFBHUFDAEDEH..KEGC..aBBEBDDF.dADFMBGHZGFA.HEAHLAAFhACAODAA.TFGEhAAAABBE..IGDChAGAfAHEeFFGNIEH.VAGF...SDCDhAIA...hABA...,2,-33,-16,17
GRHLCfFKZAJbIaVEQMYcgedXSPTNDUBWO,JCDGaCDF...QACFMFAD....gBAEdDABSDGEhAAATCGEDHBCBHBHhAAAOFEERGFACADCKFBFAAFDIEEHhABAVAEE.EHFCeDFBXAGFNDDE.WFHHhADA......hBAA...,2,-33,-7,26
dNgAXHVFaUDKbfECLWQcZBRTSIOMYJGeP,VFFCaEHH..DFBHKFBE..ECBFCBBE.LAFD.QDCAhAAABBDCRDDESCAHhAAAMBBEJHCCeAHFdBGHAIACFDGAbEEF.hABA....fFAGcGGC...hACA......hADA...,2,-40,-14,26
DNbaVJfBAGdQEYZHcWKMLeSgTROUPCFIX,GACBEDAHZFAEHBFFKBABMCDHLACC.SGGETFGAOGAEhAAACCCAFHEG.DEGG..aHBGhAAAJGDCBEDBQBGAhABA...WCEH.eDAB...hABA......hAGA...,1,-12,-23,11
XAKIaSTHOUcWdBVZeEMLQbNDRJgGPYFCf,KAAGSGGBOFFB.UAGEdDCFBGDBZBBA..eEBGEFAH.LBFDhAAAQAEHDDABRGDEJBHH.hABA.PFAFFCAFCGHA.ADDHaFFGhACA..TDFF......hAAA.WHAAMDIB..hADA...,2,-28,-13,15
QXWKMFPbcRLUgIeZSEVOHNYAaDJCfGTBd,JCDACBGDGGABBCAF.dADC..QEBBKEBFFEGB.....PEFDhAAAbAAD.LGBGhABAUDDEeFHHSFHHhACAOAFA.NIDB.AIEEDBIBTAGF.XBBHhADA.MFAD...hAAA...,1,-13,-27,14
cgefXILHPDRKZQEadCATbSUNBOFMVGYWJ,TDCBUAECBHGA.FAAFMCCE.GEFA.JFABeDCH.IHAFhACAPAAHDDHHKEGHZFDDhADA..aAFFCDBCAFIFNCICOHBEhABA....WCEAfGDBhACAXAGA....hAHA...,1,-9,-45,36
KdeHXDRUWVPTIbLECMZOFGcSaJQfgNYAB,dDBEHACEDEGHUEED..VBGBIBGE.ECAFCADDZEEH.FGBDSFAFhAAA.aHGEhABAfAAH.hACA.NAIEBFHEeBCBXAEF.PEHFhAAALECBOFDDGCDFhAEA..,2,-36,-3,33
USAWKGDagNcQJVYECIRXBFeHPbfOdMLTZ,KABCDFED..aBEG..NCEG.QFGF..VFFECDHFRAACBDDGhAAAFCFEHEAA..fDAFhABAOHBGMIEAZFAGABHChADAGADHJHAG.IDCA.XBBChAAAbFEHdCFC.....hAEA...,1,-15,-20,5
WLeNXgYZdEUOfJGIRPBHCcSTAFMVaKDbQ,MHBGVADH.DDFD..QEGGLAFAeCDB..XBGGhAAAZCBFdDAEODGBfFEFhABAIHGBPCBFBABBhAAACDHBSDDGFCGAaAEHKFHBNHBDYDAFhACA.....EGHFhADA...,1,-14,-17,3
ePKUCMIDJWcRfQGESHXaLYNAOFTgZdBVb,TAGBdABBBEDG.eCHDUCEE..CEBB.IADFDGHH..JFFHRGDGQAADhAAA.hAAAEFBHSGBEhAEAaDCGNEIG.OBFBFFFA.ZCBAPCAFMAIFfHAFhAFA.XGDHhAGAACID,1,-19,-43,24
CVLRcZOXHFBaMIWNEKGTgQDSUYPdJebAf,CAGGLCBAZDDAHBEAFGADBDHBMEGD....IHGCEABCKGCFGADBhAAAQEAHDFFBSEAFhABAUCABdAAHJHACAIHARCFEhAEAOGDG..aEEB.....WEHHhAGA.....hABA...,2,-23,-10,13
fWIOeKTJaSUcPgBLVMFQEXHCGANbdYZDR,dABHDEGDRGBA....fCABODCGeAAAKBGD....aDHDSBGHhAAAUGFD.PHEEhABABEBGMEEE.hAEAEHBCCFEHABIF..bAEBZADEIAHDJFAG.cCCEhAAA....hACA...,2,-37,-25,12
WeDKCRAYOZIGVEJNXdbHFSafBgMQLTUcP,ZCEFGEABJDAH.dACCHBCBFGDG....aAEFBBAA.QGAFhAAALBDHTGAGUGDF.hABAPBADDEIDCHGAAGGD..hACAIGHE.NIDFXAGDSEGBMFFEhAAA.....hADA...,2,-33,-5,28
dCLFADTaVNJOEBSgWbfIGXcQPRYUeMHKZ,DBCFaCDF...JFCGODAGBDHH...SGDC..gFGHhAAAfBGB.hABAIAEAXADAQGGBhAAARCECeEAF.KGAFdHBDCCFDAHFD.TABChABAEGEF.WEFC...hACA...,2,-40,-20,20
BEegDJSXOfMWZALINGTCFYVbPaUdHRQcK,LGEEGABHFDEEVABB..aGCHdCGBRCAHKGFEBEDD...ECEFDFFAhAAA.SAGHhABAOFAHMAAHAGBD..NBIC.CFHEPEBDhABAHECH.eAEA......hADA......hAEA...,2,-23,-21,2
ZFNLXSRgcEAdOKYIDMUPfTVJCHbWeBGaQ,KACFDFBDUCAG..fFEF..TEEA.JAHHCGCCHAFHhAAA.eDACaABCFGCDhAAANDHASCEDhABARGEC.EHAEOAFBMIDCPEBE.WFHHhADABADB.QDCChACA.XEGB,2,-26,-25,1
OfKRebUCFgVaNPGADJBZEISXMWdcQYTLH,JFBFEECG....IDGAMBIFdDEA..QBCDLABFHADChAAAfAADKFGDeEAEhADAUGFDFGDAaHBC.PFAChACADFIDSAGB..cADA.hAEAYAFCOHFECDDD.hBAA.NEIGBCHE.,2,-12,-6,6
bFNIEdHWOVKAGaYTCBgcfLUQDXJRZeSMP,GEGAaFGD.CAAEBEDD..fABHQAFADGCERCADSAEFhACAPFAD.FFEDNEDDdCCBhAAAOHBCAFCC..gAEBhABA.LHCGJACDeCFBIFFAhAGAWBHB....hAHA...,1,-13,-30,17
KaIDPELFgecMRSBAUNOCYXTQfVJGdbZHW,OAAECCFG..TGBFVGEA.GBBCZBGFHGACKAFE.DDDDLEDChAAAeEFG.MDADBBEDNEHG.hABAXDAA..hAAAJAHD..WAFEaACAEFFB.....hABA......hADA...,2,-24,-15,9
aROHGEeUcYPJBWMVdIgbSQACfZFKTLNDX,CCHFFAACLBACDBGG.RFAB.GEAE.EGDCeDFD.UCCD..hAAAPADBBBEEMAEGhABAIDGGSFHDhACA.AEHAKDADNFEDaGGEOGDC..cCEGhACA.WHCG...hADA...,1,-28,-29,1
PHbgfGKcIaEYSMZBWUQAONJeVXdCDFLTR,OFADJGBA..eDDGdCEADAGGFBAF.RGDEHCBC....fEBBhAAAKADEaDGG.SGFEhABABFGHUAABNADB.CGCC.hABALBHB...TBFA..hACA......hAIA...,1,-31,-38,7
TdOCeMKfLHJXAPVbYDaBgcIGUFNSEWRZQ,VBBDDEEHBDGA.....IHGBFAHBNGAF...EGCHRADCZDEAhAAAdAFFCCFHKGFF..LAAChAEAXGGDAIEG..bCBBhAIAaEAC....cFEDSDHB.hBBAWABC..OEBHhBCAMFDA..,2,-35,-28,7
OTLCUQNaJARDVcXbEeFBfYIHWZMSGKdgP,DFEGXAGEeBDEBEAD..IGCEHEGBMBBDSEFFhAAAdAGFOCCFLFBE.hAAACCABNCDFACIHVGDA.EHBGhABAfDDFZCEE.KHEC.TABCaFAE.hACAcGGE.FGAH.hADAYAEE.,1,-1,-11,10
AHVFMbIERfLJSKdNcTPUGOZXQCWeBgYDa,FAAAMCBEEBCHRDDB..LAACKGFH..dBHGTDGAUGABGEDGhADA.OBFFXAFEhAEACAFF.WFCFBEABgGGEhAFAaDFH.AGAF........hAEA......hAHA...,2,-30,-21,9
UfCWgHENBQPebLYXKIGMVDdFaSARJTZcO,JDDHZBBHOGEE.UAFBCBHEHACA.BFAAeGACLGCAKADDGEDBhAAADDGAdCAG..aCABhABAAHHA..RCED...TCFDhACAfAAHEEAFNDIE.......hAEA......hAGA...,2,-38,-14,24
WGbIYFKCgcaQJETLeVSfZHOMDRXBUANPd,dFAGGCBC..bECCIABC.KAGECDEFaFGE..JFFHTGEGhAAALFDF.VBFDhAAAZBECMAEADCIB.BCAFhABAAAFB.PHBE.FCCF.....gDGAhACAEDDGfADEhAEA.REGD,1,-23,-26,3
KRLSTcFOBWPDAVQIaEMGedfXJYgbZCNHU,QAEAEEBBGBDAdHBHJEHF.....gGEBCGEDUCBEKAAGLACEhAAA.SCHBhABAFHCCBEFCDEADABBBaAGGhBAAeFGDfDGE..XBGHhAAA......hACA...,2,-39,-8,31
QeOEJZTXWHLCcVaKIfDRPgMGBYNFUASdb,dDFHeFADECACZBFH...XBCELCDBCBAH.aFHB.KEBEDFFBRAFB.MIDChAAABACD.FAHFSGGAhABAOFAF.TFCFhACA.HDAEIAABfCHEPFFB.hADA......hAEA...,1,-21,-22,1
KPVebODHdJYSGfWagMUXQZFCBLITcAENR,EEHHKGCEeDBCDBFH.dACE..JBABGEFG.aEAHUGBA.ZFEFCHHHBAHEhAAALEDC.TAGChAAAABHFRCFG....hABA..PECCOCBDSBABWFAF.hACA.XGGA.hABA...,1,-23,-30,7
QGNcLZWVCJAbUMODBFgTaeIfYKSdRXPEH,MFAGDEDDFFAC..aEDAeAEH....fAGHSCHHdBDBhAAARACHECAFQCGEhABA.NGADZABBCEEEAHIHbGCEBGEAhAEA.IGGAKAHDPEGB...cAABhAAA..WHFA.hAEA...,1,-15,-34,19
BNbWDIcMSeCXdaKLgVEYfUQFPAZJOHGTR,ODADTAGA.BBAG....NDCBDCIFIGFE..SEEBhAAACFCBdCEAKBHBLADAhAAAEECHfGHGFDHHAAEGZBBHhABAJBCGHGCC.bEAFMHACaGGH..YABDhADA....hAEA...,2,-30,-20,10
MGPZJNLSOUHFVRBTAeXQCWdgKIbcEDYaf,eDAAXCFHCHDH.dBDAKHGE....IBHEECFFDFAG..aAAEMFGFhAAA.GDABZEEALADChAAAOFAHUFDAhABAFFCDBBHEQABE....WBCAhABA......hAHA...,2,-36,-13,23
cgZbLAIXHBYKTDOQVPeRaWfJUGEMSCNdF,HCEAKFBEOCAGQEBH.VBAGeAHFaGGAJBEH.GGEH.hAAAMICASGAAhABA.CEHHdFFGFHAGZEFGAEAGIADFhACABAFDDDAFPAFCWAAC.EHCA...hAEA......hAGA...,1,4,-26,30
OeBfPJdVKURYMTQZNcCDbXFHWaAgGILSE,GAFASGAEeGFEBADHJABA.KHAG.UEFAMIBE.ZEAH.CEDC.XAAHhAAAFCCB.HDCHhACAaDHHAFADLHDC.hAAAfAFGdFEC.YCFGNAIC.DFIFhADA......hAGA...,1,-18,-26,8
CEZBPRcYFLSTANKMXVbWfHOgeIGQaDUdJ,KGFEMAGB..XADDVEDF.....bFACfBCEhAAAHCAFeDEEIHAFaBHHDDDFUAAFhABACAECBDBE.cFBChABAFHAESFHB.AEEBNIEDOFHB.hADA......hAFA...,1,-6,-30,24
WbNODYSHaVdMETZBKXRGPLFUCcfIegQAJ,JEBE..NAIA.DGBHHACB.dEAEEACFBEHDKDGB.GFCBLFFDFHBCCAFHhAAA....IAGFhAAAeCBBADFH..OGFEhABAaGCEMABF.XAEH....hACA......hAEA...,2,-46,-21,25
MAeGaXCbVRLOBEQJcNfZFgDHPISTKYWUd,aEDFCGHGRDCG.BEHH..QFAG..JAGF..fCBHhAAAgGDADAIHHEAGhAAAPHCATBAD.KGGFhABAWFFCMDCAGACDXADHVCFCEHAC..hACA......hADA...,2,-26,-14,12
PbWHaCdeVgXNFZEOLMRAcQSITDGfYJKBU,QFGDSCGDDGGFGBAF..JDCHUBGD...WEDAhAAAaAAEdEAG.eAHHXEBDhABAFBDBOHACMEABAHEEhACAIFEGfHBHBHHG...PEHFhAAACDDFNADDLBEH.hABA...,1,-3,-34,31
UJCLdSZgVPaMDNRIBOYEAQbHTGFXKcfeW,QCGCTADG.FCCFKHDA.eDFHUECFCBAHLFHDSACCZDCHhAAA..VGFGaHAADBGChABAIFABBFACECEAABHAGBEGhAAA..cDAFJHAAPBAH..hABA......hAFA...,1,-13,-16,3
XWSIaQGOAZcTHgVUeRPdNCLFBYMJKbDEf,ZAADHCGFUEBEeCDEdFECLFEBBCDD.JEBBDAHFECAB...XABChAAASFGD..hAAAIAHCaBFH.QGGHhACAAIEC.cGCEgGAG.hADAPDHFCCCGMFAHKACGfAEHhAEA,2,-51,6,57
ZVdFLJeQEUTWaBAcMGROYIDKCbXgSHPNf,MDFHRCEFOAFEDEAC..KGCDCDGH.....XGGGHABE..fDAFhAAAdAAFFAHDeBDDhADAQGAEEDGE.TGCFhABABFADABFE.cEGCIFGE.SFAChADA...hAEANIED...,2,-39,-16,23
OJHegEbKVfZSDAMPNCcLGWQaXTYdFUBRI,MAEBCFGFLFEDGDCG.QEGFaACC..TDACdBGGBHHHhAAAOHAGHFEH.eBAAhABAgAGHEGAGKDAB.ZBBAhAAAAHEHNAFAXCGE...FHGC.IAFAhABA.bDDG..hADASAHB.,1,3,-3,6
MbBUXKaLJATFZWPefVcSYCdRDHGIOENgQ,ZFDDeABB..VDBHSCAFdFGBHAEDGDGCECHH.QAGAhAAABHGBKBCHLDAFhAAAJGDATDDDFAHB..fBEBhACACACCDABH.OFAA.MIEG..hADA.XGAGADGDWGAA.hAEA...,2,-17,2,19
GOXRNHJVQAUcWgPaFEbdDfZIMYCSeLKBT,UAGE..gEFFaABD.FAHFdDGEDEDAZFDBMAACSCDGhAAAeBBDKEAABHHF.OEAGhABAXGAHHFBHJAEBhAEAAAFB...PEHDfBDBCGCFTGDD.hADA......hAEA...,2,-29,-11,18
WEYFRHCeDJdKPLIZTUaGNAVbcXSgMBfQO,VAEHXBBF..MCABQDCE.EEABFCCFRFFE.eEFFdAGFKCHDhAAAPAHFZGCCaBAHGGAFhAAAACFH.SBBChABABHBG.fEDC.WEGHCEEB.DGIDhACA......hADA...,2,-18,-14,4
cPUMDdaKZFeYbTNgfSEVJQHRIGXBLAOCW,CDAH..PFGDMDDADHDGKFBD..ZAACFBAE..eCFE..TDGDhAAAfFEH.EAHBhABAJHAAQDADhACAREACGADDBHGGAIFEOEDB.WADHcFGCaEHFNIAH.hABA.SEEFhACA...,2,-36,-2,34
MWGPBaYCIJXHbeDgZNEdQTOSFRUfcKLVA,MFDFGGABBCBGCFHF..JCBGHEEE.DDAFZFFHEAGBdEAB..QCEHhAAAOAACFBFAfBBBhABAKDGE.AEHEPEBDhACAIEDG..XGGG...hAAA......hACA...,1,-15,-39,24
QYfJCOWdXHAZLBPgTDbMUaSFEVNcGeRKI,BDCFTBGBDIBE.UAGEaFAG...FDEBEDCC...VGFGGFBHhAAAeAACKHGAQGAAhAAA.fFDDhAEAJBACCAEGdFACADAHZBCA.PDHDMEIH.SGDDhAFA....cGEEhABA.,2,-47,12,59
BNJcDXaYGZfbAQWLTMRVSKPegUdOHCIFE,QECGTGGC.MADDSGAE.KDBEeAEGUEEGdEHEHAFGhAAACHHBEBAEJABADIBCXFCBhAEAaGEDZBECAGGF...hAFA.WCCE.........hAAA......hABA...,2,-27,-16,11
AUQSBYXDJegHNLKGbCFIPcZETVdMOWfRa,UDACBEAFDBCFeGBGHBFAKEEG.GGEH.CFEG.IGGHZGAA.EBAEhAAAdADB.MDDB.OBDFhAAARAECAEDESHAGhABA.XDGB.gACDhAEA.NEIG.FBAF...hAFA...,2,-25,-24,1
OLPZXTGKcDeAHQCUaEBSdVJWFYbNRIfMg,QCFHUFFBEDEABFCFSCHB.dBABJAFAFHAE...NAEF.hAAAfABA.hABAMAADgFGChACALHDGXECEKEAHeCHDADAHaCDG.WFFDbBDC.hABAODAD...hADA...,1,-7,-31,24
MBIPXEOVUaAGRLFdNbTHCWegcSZQfDKYJ,GBDARABGdDGF...bAAFTAFF.HFAFeFBH.SAFBhADAQFGFfGFDhAEAKECGJCEFBDADXEGAhAHAOHCEaDGGAAAC.NICHCAHH........hBAA......hBCA...,1,-10,-18,8
KDTXLEVdScGafJWFCZUMQNbYeAPBOgIRH,OAEERABGHFADKDDBDHCGLFEAdFCEGGEH..JBDHFEGE.ZAFHQEAChAAA..NAAGeAHBhABAAIACBHHH.IBAAhABA...TDFB.ECGGSCEBhADAaCCHCFCH..MICChACA..,2,-19,-18,1
MJNgdLaIeFGbPAcHXQKREUBSWOYfCDZVT,XBGCKGEBEFAD.UFBBBGHD...OACACHHGDFGFZBCH..VCCChAAAMEFB..NBBA.LAAHhACA.IAHChADAeAHF.FAEBbFBDAEHF.HEFDSGEDhAGA......hBAA...,2,-30,-23,7
SZUWQPcKYVDMabgNLGXATdBOeHERfIJCF,dECHOEDHHGACRCAH.JACCFCFBZEGB..UGACQAGE.KCDCDBBEhAAA.MHFE.aFFANCBELFFFhAAA.ADGCBBAChABAeAFCECHHCCCD.SCCE..hABA......hACA...,1,-16,-33,17
POBCbfXeQHWDMEaVcAgFYGNLdJZRTKISU,FCAAGCAEdBFAZFABKCGHUAGDBFEA...CFDH...XADBQACChAAAHDCCMIDA.aDEFhABAAHDC..NEIE.RFGFSHAAhAEAOHEE.fECCDAGAEDGA..cABAhAAA....hBAA...,2,-32,-14,18
BXcGEAMKCVeaLdONbHPJFWDfRIYTZQUgS,CEBGeDGHdADG.OAFDHFCDFHGEDBCC...RCAG.TGECQDEG.hAAAUBGCBDEE.cFBAhABAEGFFAAAC..KFAFaBBH.hACALEAC.NBIEPHAEfFGBIHHEhACA....hADA...,1,-17,-26,9
ZgDSLWTeCfHMKQEOVbRNFUBdcXPIaYJGA,ZACESGCFLDFHeEHBCFHAHCDB.KGBCQDAD.VAAEhAAANAHEFAABBGFE.XCDEhADAaEAC..JHFGhACAgAGADAIB.fHDDODAA.hADA......hAEA...,2,-22,-14,8
SFQKJNYTHcdUBMbRGPaLOfWDVCIAgZXEe,XDFHEHDEFGFE.KCEH..JCAH..TBGAdAFFBECA.MFFAhAAAGFAF.PHEEhAAAaDGGLBBGOCDHfBAFhABADGCD.IADBAHIBZDDFSAHHhABANDIA....hACAYHAA.,1,-12,-23,11
cePHTRVBSZIJbYOULFQCGaMENDWfgXdAK,eCCEHGFATBEGBGEEZEAD..JBCBOAFFUGBELAHDFDHD.hAAACCAEGDEBMDDHDBBE.hAAA.fEAChABAXCACAFECKADC..cGGB...PHBEhABASEDG..hACA...,2,-27,-11,16
VDEMgefTYCHGbIRSBQNPOFaZcdUJWXLAK,KCEEDGADMCBBeFGH....TACCCDCDGDFGRDECBGADQACHhAAA.OGBAFGBAaBAHdDDAhABAJEAELBHH.hAAAAHHBEAFF..fHDH..YHCGhACA...hABA...,2,-39,-11,28
YVUeHXDMIRASQTbgNPfacdLOEKZCWBFJG,QEABTDBD....bAABNHBHaBAEdAGGEFAE..KFGGZFGBBCGBhAAAFAEFJDFCGADFVEDEhADAeDDD.DBIHMAIDhBAAAABCSHAG.PEEAfCCDhBCA.OHBACCDB..hBDA...,2,-13,-4,9
CHTQMFLPOAZUNKbBfgGXYJaVeEdWSRDcI,ZCDBUDAAKDAFBHDGGGAH..XAEGaGGH..EACFSBAGhAAARCFDDCDB.CBHBQDFBhABAMAIFFFHHLABDhAAAAHAC..fFHCYAGH.eEEB.hAEAWDDF....hACA...,1,-8,-40,32
QOWFAZLfNIeDKdHbRMYECcPBXVGgSUaJT,LHCG..fAABeDDEdGGEREADMECGCBCEBGDDGFAHUAEAhAAAaFHH.QBDGhACAFEGEABBH.IHAChADAHAGDEEEDcGEB.PDFA..XCAAhABASAFB..hAEA...,1,-11,-25,14
GAWQZdOeCbfBFSTENDaHULPgKXJVMIRcY,QEEGOGFG.CBBCBHBESHBA.EAHFaAEFLABDhAAAKDHD.JEDGIHGHhAAARACC.GCAHAFAEdCEHfGBFhADANAGCDAIDHEBCgACBMIFC..hABA......hAHA...,2,-21,-16,5
fHOTRAVcZJdFKbYNgaSLDXEeUMWGQBIPC,ZACGdCHGKFED..NCHA.aBDELCDF.DIACEDAD.MFABGGBDhAAABDECCDABHCEHRABH.AGFG.hABA..JHBCFAGAbFFDSEAGhACA..XEBH.WFHBhAAAIHHH..hADAfDFA.,1,-14,-27,13
cCfWBSHabLYdOAUTRNGIXQeDgPKEVFMJZ,TBBARFBCGDDB.QAAHDHBCKGEA.FDADZBFF.CECG.BDCCHBDFaAGFhAAALFEC.dDAGhAAAAADEUFGDIAHHXADAhACA.eHDE.......hABA......hACA...,2,-27,-11,16
YVLOECgbaBeARWKTGFXPfDUHNZcJSIMdQ,RDDHKGGAFCCH..XEBFDICGHCFCZDFA...SAFDMFHDQADChAAALAHBOBAFhABACBABaGFBBHBDAFGD.TACAhAAAfAGF.UFADNCACJEDB.dCCD.hACA.YFFF.hABA...,1,-12,-17,5
ZRWOXVNbFLKeUgCETMSYaQHJBIcGADPdf,DEFEdEEBZBDEOFHF..VAAGFACELGBG.KFFFUFBH.hAAACDADMFFFSECHhABAQGGABAGHGCAFhACAAAGE.fHFHXCFE.bBFG...hAAA......hADA...,1,-19,-34,15
YNTRUcfaZICBHdJEDKAXFWegOSGLQVbMP,XGCCeEDAOBBALCEE..QGAFMEIH.PCEAhAAATDCBRCAB.UAABfAEBhABAIHGFHFGDhACAEFECADGDFHEGSFAH.bADGcCCHhADA..CAGEBEACDAIF.hAGA...,2,-7,-7,0
LZJbfKFNXVaAGRDMdYSeQOHTEWgcBUCIP,RGBCdCFCeECEOCBBHABG.EEAE....gABEBGACIHFGhAAAZFGDJEDDKCGA.FAFHXAEGhAAAAIHCDBAD.MICAhADAQEGD..TCGCWCCG.CHAD..hABA......hACA...,1,-16,-22,6
DVcdXeOWRTISbJCZUFLQfHGaBMAgKPEYN,KFCGEGFDDEGBdDEA..eCCHRCBD....IAAEJDHFUAEH.LHAAhAAAQAGA.fGCBhACAaHGEBGGGADBHgFADhADA.NDDF.XBBFTADGCEEFFFAFhABAMEIB....hAFA...,2,-27,-27,0
APEdefOKTMZHcbYgCLGQUWIJDaBRFNSXV,EEEBdABCeEECKCBB.MDFAHCFD...bDCHCEAGGADD.QGGAhAAAIADFJHEEaGCDBHAGhADAFAFC..SAAFhACAACGEfDCG..ODHF..hAHA......hAIA...,2,-25,-19,6
cUQMNKCdABFfWReLgHEOPJbTGVZSYXIaD,FEEAREDCeBEHLFBAHGEEEADDOBEC..JCABGGDDZBBH.SAAFhACAXFAHaAGDDEBGUBBAhADA.MIBCCDHAAAGH.hAAABHAF...gAGE..hAEA......hAFA...,2,-21,-13,8
IKEeCGUXPafTQZDAdgYJMSBNHWbLVcRFO,dGGAJGCCBCHFHFADLECB.REECFBCHKAEGeBBEGAEEUDDBaABB.hAAA..QDAGhAAAAEIBMAHH..SGDHhADANIBF..WFGF......hABA......hACA...,1,-6,-48,42
OLcbNFBEgSVGRQdePKfTMJXaAYUHIWZCD,HEEAZEFFDDHBOBHBLADB..bGBCBFACSFHHRBAFdFCHKHCATBDGhAAA..MFIDhAAAaAFFAGGAUBGFCDBBFABB.EFBGhADA............hAEA......hAHA...,1,-10,-38,28
BQDCEXAbPJMSWLNORFIKaceHfZgVTUYdG,JDEAMAFELGBARABF..FHDEKGHFeEGHHAAAZEAG...VBDFhAAAUAFB.GCCCBCGECBHBhABAAIFG..SFFHhAAAOGBAaEFBfDAH.....hADA......hAEA...,1,-21,-22,1
LVadZCXQgJAcITNYGKSPOeMWDUEbRfHFB,TDGEGAEFKDFE.OACHMDEHDFBA.UAGGEFGERECAHABF.LBAFhAAAdDBHCHEH.QGDBhABAACHG.IGHChADASHAAeFABfAAGFBDABFFE.aFAChABA.XGGC.hAEA...,1,-4,-22,18
KSNTbAHgCEceBLOIUWDdYGZJfXaMVFRPQ,CGGAeFDHLHCGOAEBUDBGDFAC..GABGZAFE..JAACaHAE.MFFFhAAAFCGD.RAGB.KEEBSHGEhABA..NGAF.hADAAGGCEDEABDECIDAF.WGAC..hADA......hAFA...,2,-43,-14,29
TeHEXDWdPJVNgGQSIbOfaUZYKRAFcMLCB,MGCELAHHBBFAeFDEHACEDFHFdFHE..JADD..NIAB.GAFChAAASFAFOFAFaAADUCAGhABAZBGB.KHEG.AIHECDECTCDAhAAA.EFFG.WCCD.....hACA......hADA...,1,-11,-24,13
XDJRHQdZeETKBgNcGAfFbLIYUCOMWPSaV,FGABLDBAUGGE.CEGC..MAHBSDAB..XFGHhAAARCDGQFCFdGACECBEBHEBhAAANBAG.ABAA...fFDFhABA.YBFDOBCBPACAhABADIEA...HAFE.hACA.eGDAKCHF,2,-16,-13,3
XHVZgWbedUSLEFOYMBaPcQRDGKACJfNIT,CBCHJDBA....IBGFXEGC.HADAZAAF....gEBGhACAbGAGdFEELCFAhAAAFAEDODEBBBBAaFFBPFAGhABARGAE.KHGCAHGGNBIC.....WHEGhADA..SCADhACA.MIBC,2,-35,-5,30
UYdJAOTIHERcSXaFWfBLeNZKGQDPCMbgV,OAAFTFGA.HDDBRBAC.SHAAFEEFBHCDLBFAZAFBKAHH.DGBBhAAACHGFMCAH.VDGFhAAAUDAH.dDGHAFBHIDCEhACAXECDaABG.eHDE.....hADA......hAEA...,2,-19,-13,6
PEVWLTUAgGZQIMbCFdSNJKBHeDcXYOafR,GADAZAADMDFEFEFEdECH..JAFGKGCHBHCCDGFC.....XGDBhAAAOHFGRACB.EEHDVCAGhABA.LFABhACAAAHGQAFG.CFBD.SHGC.eCFChADAaGEH..WEAF.hAFA...,1,-24,-26,2
OWDUfTAZRBYIbNJKSXeHLQaFGcVdPCEMg,BBFB..IBDBJFHFKDDA.SFCEHGAELFFDFBGEGGEDhAAAdDAD.EDGHMACAOABBhACADGEBUBBFAEDERGAANADB.QCGHhAAA.aFCG.....cAGAhABACBFFWCCG...hAIA...,2,-22,-14,8
LMQEXYSANGUHVICZWbTORJaPecgDBFdfK,GBDBVEDG.CHGDZBBF..TADFOFEAaCGE..eGAADABFBEHFhAAAdEHAKADCLHBChACA.EGHFXGDDhAAAADCFHDAFIAHAbCAH.......hABA......hACA...,2,-22,-14,8
LOFCYTIfdNgXWeEMASRZDVBKHcQJUPbGa,SCBFRGFCZECABHABHBAFQFGB.JCEEUBFG.GACChAAAaEAEFAEACFAG...IHDBhAAANCIG...WDFAhABAEHCEDEEA..KACG.PDDH.LHFAhACA...hABA...,1,-12,-25,13
JHcGUZPYWMAXBLbdCRNDaVTgKIOeEFQSf,LDEGCABGRCAB.DAEBaDEA..TBAEKFAF.OHCCEGBF.QGGAhAAASACBfGBHhABAJHCE.HAFBhACAGAEDUDAHZEEAYFDCAAAFBECAdGGDNBIG..hAEA......hAFA...,1,4,-23,27
LbdefWHSJKgEGAZBMaFXcCVYITDONQURP,BEHBMEEGFBBECCCB....VGFETFAE.DDFEOFCH.UBEDhAAALFCH.dGGChAAAfDEAWFHBSAFGhABAKAHFGBAAAIACaDAA..YEAFhABA.IACH.hACA...,1,-27,-34,7
NfCGHEAFaBWXcRZYDKOUPdTeSVMJLIbQg,FGCEaDFCBAGG..XBFFRACGZEDF.DDAAKFCHUFFF..TFGBhAAASAEF.MIEChAAAICAC.QEAFhABAfCECCAHEECCGADIF..cABGhABA.OHAC.eDCFhAGA..,1,-24,-35,11
URVYOKBbMXGPcDZCAJeaEISTFWNHQgfLd,JCFEaBBB...EACFTDEH..FFGAHADEQGABLGFCdDCEhAAAUGCARAEC.ODABhAAAKHEEMBBFXDCB.hABAGBGADEECAHHC.IHAF..WCADhACA......hAEA...,2,-31,-1,30
TFZaDAbBWXdPGQHICecUKYMNELfVRgSOJ,BEDGXEEEdBFFGFAFHEAD..CDEGeHDCKDAEMAECLCHB.hAAAVAAASGFBhABA.JCEFFAEADBIFAECAWDAChAAAQABH..IHHC.cGCGhADANIABfDHEhADA.OFHH.,2,-20,-7,13
UWQPaGOdDeEXTHLYcVfISBJNCKMRbAFZg,FFGCUBCBQFDAGDAEDEEB..EBFFHFFALACG.VGAAhAAAIAHDBDAHCBAFKDHDMIDAhABAAACCZAEH..gCCEhADAPAABdHCF..XAGF.YDFGhAEA..SAGDhABA,2,-19,-17,2
MLSbfRQKcPGDZYUaTXHOFJgdIWeVNCEBA,MBBBSCFCRFBG.QGFGKCCFGDFEZADDUBFF..TDBAhAAAOACGJGACdHADeABHhABACEEFBHEBAFEALFHBhADA.fGDBDEIDaAGA.FAHFIHHFhAAANEEB......hABA...,2,-27,5,32
SdaZUcGYECTKfRMWLHAVPObNeDgBJFIQX,OGEEeAEBDGDABAHGFDCF...QEBFdCHCZAAG.GAEEECAFCHHA.hAAAfGBE.hABAMDACHFABAIHCPEFEhAAAgGFA.IEECSBAEaAFA..hABA......hACA...,2,-28,-18,10
XdDUaEcLJQNFgHYWAefSMOCPZKRTbGBIV,SBADCHCEKAEE.RFBBGDEHBEFE..VDCBXAFE.DDDAhAAAaBHDEFFDLBBChAAA.QCAFhABAFFHDgECBHFGFAGBAMCDCOFFB.TBFEhACAIEAB....hABA...,2,-24,-15,9
MUNGfDELFJedXPKWTIObVACBgZSRcHYaQ,BDGHSAFDHFEBaACHMEDDGFAD.EDBELABC.FHAChAAAdBEFPGEGKHCGIBHChAAAbCCC.AHAHCADFgAGGhAHA.ZEFAcGGDYDBFNBAADDDG.hAIA......hBAA...,1,-12,-15,3
PBaZXeHSRdADKICfEFVJNgcLQGTObWYUM,DHECCDGEFAAE..VBAG..JGCG....gDGDLBEAQDEDhAAAOBEF.hAAA.bFADUGAGBADFXDBChADAeGCCSGGHAIDEICCE.EHFAcAGBhABA.WEBEYAFEhAEA.,1,-20,-42,22
DNQXeSJGAgLUcdTMabYFHIPRKBEZWOVfC,UFDBdFCDaGHHFAAA.HCFFRDEGBHAFZEAH...OABACADA..DAHDQAEAhAAAeCDD.SCBFhAHAAECB.LCHBhAIAMIFGIGHEEHDAfFFGNAIG.hADA..XDCFhBAA...,2,-29,-24,5
MSPVXOgHcCNLEBKFDJTfdAbUIRQGaWZYe,UBCHQGEEGGCFZCCEeAFDMBEA..SAGGXBGEOFAAhAAAHFGHCDEALBAFhAAAKCAHJDGHdHAH..AIAEbEAEhABAaACH............hACA......hADA...,1,-12,-16,4
eaUREdDcILPgTZGMfYSBVbNKWXAHJOFQC,JFCEOECH.FEFHCCDB..UBBCdBGCDDAD.LEHB..TGGDhAAAMACE..SCDFhAAABEHEVAFHKBAEABIFHFAFhABAaHCE..EGAFIHDG...hABA......hAGA...,2,-38,-34,4
DNaKPVIHZUdOEeCFWfgcJRTMXQLGBSAYb,DAIBaECH.KFHF..VAGDZGACdACE..eFFCCFFB.FAAG....hADA.fHGBhAEAJFCCMAFDLCBGBFADAEBBNDEAHBCHhAFA..OHECEDFG...WBADhAAA...RBGD...hABA...,2,-42,-12,30
NBHSAefORYDMUKXJQVZGCIPFWcgELdaTb,eEDBOCCBDAIBKAFF..QBEFGDEDCHDB.FHFA....gFGAhAAAECDDaCAETEAFhAAABBHGSGABhABARCGB.MCBF.XEDCJABEIFFGhABAPADDcGACLHFAhACA...,1,-11,-26,15
GZNTPcVHeIKRDWgQbOAESFBaXfLYMdJCU,FBGBBGCC.aCEBXABFLGEGdEGH.CFFG.GAEHZDCE...NCIA.hAAATFCF.VADFhAAAIDAE.KDFADGIDhAFAgDBHQGAHABBBfHADhABAMIDA......hACA...,1,-14,-34,20
gNXZdBIHUPTMJDOEcQWFVGeaCYfSRAbKL,LABAXCBEBACCUDDEMDAB.DHAAEGEA.QGBFhAAAFFBCGGEHCCFG..SEDAhABAACCFKEGG.NDIGIEADhAEA.HAGB.PHFC..OBDEhAAA....hACAWADA.,2,-33,-24,9
ENDgbXcGdaPSMOJULefCVFBZYAQWKTRIH,KCBATBAAHAGH.EGCFDCDA....XEEDGEBFdDHA.SAGDhAAAMDABOBCAhAAAJHBEUGEGLEHFfADBhABACCFDBBAAAEEHWDDENABDgGAF.hACA.aGHB.PFAHhAFA...,1,-10,-22,12
edOHIYWcGXbAKEDTNFZJCfLBQUVSPRgMa,EGGDTDGBFFCA..ZADDCDBELAEABHBC.QEECUBFH.SHGEhAAARDACMIDCdAADIABChADA.WECHhAFAXEEF.KEHBDBID.fCCDhAGA......hAIA...,2,-30,-29,1
TafCVAIJBMLYUPbSKOeWEDZRcQXFgNHdG,JGCABGCFLACEUCAE..SDEBKCDH..OBHFeAFCDIBChAAAZCFFQDBDhAAAFGHDHABCdHEFaGADCFAFADHHIHHFhABA..MGEE...YBHHhABAWFFA.EECA..XBBGhAGA,1,-24,-28,4
CXZfJHFUdEcODPAGQLgWbaNSYBTVIKRMe,GCFGLAHD..bBBBaAAG...SFHDTAEDKCADMCFBhADAeFHBCGCDZEABHFDHdEDCcAGAhAAADEABAHEC..QBBGhAEAWEAHBEDFRADC...fCHEhABA......hACA...,1,-10,-14,4
gVbTUZNJOIFLSECXBAMQaGeHRcdDPWYKf,QBEDaGFHGDAHHAGFRDFCDBAF...PFFAKCCB..VFAGTFCAhAAAZFFE..OHCEhAAAIAFESCBFhABAEBBEBHHCAAHDMBBAeDDEcADC....hABA......hACA...,2,-16,-8,8
DfLZQFNJSHdIGPAKOBMVXCeRcUTEYbagW,OCDHVCFA..eBBEUCAG.EABA..aGGCDFEEZEFAFAGA..NEDC.hAAAJFAHHEAB.ICAAhABAAHIDMGCE..CDHA.TAEHhACA..bBFC..WDDBLHDEhAAASHAA...hABA...,2,-33,-6,27
XKHQELGDcaTgJZUVbNSMfPFIYWBeRdCOA,XEBAHGDCQBBGLGEEDICC.TDDAZAEEUCAG.VGAGhAAAbEAG..MBGDFEEG.IADAhAAABHFEdCDDCAHEACHAEABAhABAaGGD...gEGCNDIE.fGAAhABA...hAEA...,2,-14,3,17
FbcPBGTJYKEQdSLVZaWRHNIXgDOCMfeAU,FBHH..PCCFBEGGJBCFKFEE..dCHALFBFZGDCRBAF.HEDF.hAAA.XAEAOAFHCBAFhAAAMFIDAIFC...cFAEhABATGGH.EDAHSHAAaADF.IACChAEADGAD...hABA...,2,-31,-18,13
DaKEQYZCfMNWHFgVROAeJdGBUTPbcSILX,JDHDBGCF.UFEF..TFEE..PAGDSBAHLCBEhAAADEAFEBFEZBEHMBAChABAHACHFECCREAC.OGAChAAAAIBCeDHF...........hABA......hACA...,2,-32,-26,6
fdQTIOGLeXYMVEFgBKJARcbCSUPWDZaNH,RADECFFCUBDFDFEDZCFB..HGBGdDHA...TBGBGDAC.eECHMACFhAAAEGHHBFAG.AIFE.SGADhAAAaDEC.fDDDhABAIFHAXEBB..FHEEhACA.KCBE..cGGHhABA.WAEC,1,-18,-29,11
YBTFdRJDLQZPXbVUMCaEfcIgHGOASKeWN,eFAD..NCBABDFEdBDEDCBBLADGQBGGZECH...PEEAhAAAVFGFUAAB.CFEF.hABAaGCC.EGGA.fFCBhABAICDEGAGCADIHSADE.KABHhAGAYFAF..hAEA...,1,-12,-29,17
DHgeVEMZaQfbSBYdXJPUNCRcTWOLFGKAI,HEEFeGEAMCGHaBAAQADE.SHCEYECHJEADUGAAhAAA.RCAG...cAAHhABATAFE.LAHBhABAFBDHAGIFDEEHgDGGEBHBfADBBHHF.XCAGhACACEDA.OHAEhAFA..,1,1,-10,11
RECGfQPeTZNADBKFSbWJcYXMHdIagUVLO,KDHHFCCC..SFBHJDCG..XGBFMAIFdDFG..aDFDVGEEhAAARAAD.GCAE.hAAAQADEPAFCTFGAhACAAEIBBAFH.WHAGcADG..IABEhADALHDCODGFhAHAEDABCFEG...,1,-18,-19,1
BTUWcFXLgMAaNEHGQeCbfOIDYdJSRZVPK,aHCGEBCBGBEA.CBAD.fBDE.DCFCJHBCRFDE.VGFCKAADBHFAhABAUEAA.FFBBXECEhAAAMBIDHDDG.QCADhACAeAHBIEHHSAFA..hADA......hAEA...,2,-18,-16,2
bcRfQJeXYGPaHCOIFKTgVEANMBUSWDdZL,MDEDUAGDDBCEZFGFLFAD..RFCEJBEDXCBDGBAEHAAAhAAA.CBHC.FGGAKAEE.TGBEhACAEHFEBDHC.dHADhAAAfCFC.YFFFaCCFIEFHhABAADAASDGA.hACA...,1,-4,-31,27
EMWBLNVKXaIOUcHYTASRfFQPeZJGbgdDC,SFFBRBBGFCFB.QBBDZFFGJACC.GGBBdHCF.EAFGMDEBhAAABADF.LBEHhAAAKHFG.XCGBaGAF.hABAIHHCOAHD.....cECAhABATDGAAIBAeCADDFAC.CAHB.hACA...,1,-9,-30,21
XIbOASLWBRgEJCPVfGceMFYQUHNZKaDdT,SFEALDABREDFEHFGCAFF....VEBGGBCD.eCHFFCDEQBBFhAAAHAFGNIABaBBGDAEAhAAAdHDHIAHHhABA.AHCFBEHGgFGGPBGB.MCAD.hABA......hACA...,2,-17,-4,13
XADcYSfNaQIBbHCWZEGKFLMgVPUJOeRdT,DDIHSFDH..NICD.QDFCBACCHFECCCBGEDDHKEDCFADEMDABhAAA....VBFGhAAAPFGF.OAHHhABAdCCBAHHA.fBBDaHAG.WEAHLBAHhABA..JACC...hAGA...,2,-28,-10,18
dPZcNbHXMCDVYFKLWBaRQeSUAJOfIGTEg,OHBEGBFAEDCDdEDEZBAC....NDICHEDBMCFGDIFA.FDFCWEAHhAAABFGG..QABChADAUFACADBF.IAEHhAGA.PHECcAEBCHBA...KAGG.hAHAaFHD...SFFDhAAA,2,-32,-20,12
HODIEFKdVecTLgZWRGQNBXbMfSJUaCAPY,HDCDOHBCDBIDFAACdAAD.eGEGLCEGZADGRFAD.GEADBFFB.XEGAhACAMIEE...fGAAhADASCGDUEEGhAEAACFBIDABKAGFcBCG..WAHFNHEB.hAFAaEHD.....hAHA...,2,-15,-15,0
XLBfDbHWPTZCSgKQVeAJFEUaRNGYOMdIc,FFFFaFEHGBEGMDDH.dABG..XGAFBGGDDEBEHCFC.PAAHhABATBGB.ZFAECBFGKEHHhACAeDHHABDD.EADB..NCEAOAEAhADA.IHHF..fHAFhAAAWCBH.SAEEhAHA,2,-29,-19,10
befNLGEOgadZIWYSBRJKUMVPFCXHAQDcT,DHAATGFEeFDC.LBDBODEA..dCDCZCAE..IDBChAAASBACJHBG.MHECFAGACBFBhABAAFBGQBGDhAAA.fDHENFAHEABAWFFEBAGF.KFGG.hAEA......hAFA...,1,-16,-28,12
YFAEOKNPeQMGHgBIXcCRVJDdSfUbWTZaL,KGCGeFFHQBBCHBEDBEDC...XCCGRBFDVFGD.dCACSFAFhAAAUBGC.TDDBhABAaGACFABC.AEGCNIAFMAIDhACA.IAEDCHHE.DECBfEHChAAA..WHCA..hADA...,2,-25,-12,13
VTIUeBWZgXPGHKLDSNbcJAMdYRfOQFCEa,MDHBdCHARFAD..QAFFFFACECCD..aHBCIADG.eFGFhAAABABBZDDFXADEhAAAGABEKFCHSCHBhADA.NEGC.JCFHAHIDfECECHHG.TGDHhAEA..WBAF.hAGA...,2,-35,-6,29
USXcBKIGOgYfVHMRDFNeLQbTaJCWPZdEA,SBDGXAAAKGCAOEBG....gBDEfGDDhAAAMCGFFCGGLFFEhABA.bGAGaDDCWCBGhACAPHFGdAFD.ABIHUDAGIGGCYHAA.hADA......hAEA...,1,-19,-23,4
CWLHPVXMdYDZEcAJGONReFSKgUIaTBQbf,GCECRBEDeACF.KBBAUFFB..TEGBQEADCGDFHFAH.XAFFhAAAMABDDAHB.ZGAGAGGHODBAhABASDDBIADEhACA.BCHH.WHCA....hAIA......hBAA...,1,-18,-26,8
SGYUgDIBNHEZcXfFPQAVdeTRKWabOMCJL,eEFETEAGKCEE..aDECMBCA.LDDFSABAGDAAUAGFhAAADGFABCADEAAHZAGHXGDGhABAFGHDACCE.dHAH.WAEBhACACEED...YFFCNIAH...fCCAhAHA..hBAA...,1,-12,-29,17
bIUNSXJOGEdVPLKAgWTMeaCZfFRcBDHYQ,TCAEMCEH..aGFBCCEFZDGF..FBCBBEFDDDGFHAFAQGCChAAAUEAD.SGEHhABAOCHBdHGBLAFCAIAC.hAAAWCCBeBAD.RFCH.YABG.IBGAhACA.XGGGhBAA..,1,-10,-19,9
EaRJLOQCXYSePNcIZTBVMAfbUgKGFdDWH,UGFFGACDDAADEEGG.RDAHLGDEQBDECDFC...SEABhABAeCAE..NICHIHAHhAAATAGABGCC.ACBAbDEAhACAFEDCHAGB..aADG.OFCA.hABA......hACA...,2,-22,-6,16
YPIgDaQfbUOZSMNLVAHBGFeCEdTcRKWXJ,BHGGGEFCFAABCAFGdCDFREGD..KAGA..JEDH....IDADhACADIDAaABF...QGAChADAUGADSDAChAAAMDDBLCEGAEBGHBGFeFHHTFEA...hADAWBCF....hAEA...,2,-40,-18,22
ZJMgGIaNTCRQUOKfHAcPYXFEDBLdeVSWb,...PADCFCFGECCELAHFdEAB.eHEGSBBFZBAH.MFEGhAAAgEEDGECAaFGEhABANDDG.RADA.UGAGKGEBABHAhACA..XEGEDAGG.BCDB...hADAWACFIHHBCCFAfGHGhAAA,2,-25,-5,20
UJRVTAfDZIHQPBdcMWbOEGFNLgCYSeXKa,ZEADHDCEBABDdABHMBFEOHCAGFAF.LFGDCDFF.SEHHhAAAXFGEaFCCJCAH.hACA..RAFC.ADHHDICEICCChAAAPCDG....WAEF.EEFC.hAEAFHFE...NCAE..hAFA...,2,-28,-12,16
eBEVSfaKTFYWGRcCHdMJUZDNOPIbAQLXg,LFEAXGABBFGAECCE..SDAFKCDBFADGGABARFADHDECMIFAhAAAZBEADAAG.NEIE.OBFHhABA..IAHGhADAADHBeAHDaGCETDBCWGFGCBBC.....hAEA......hAFA...,1,-10,-19,9
WHaQeYcdAbUXZOEFTKDCgLVSIMfJRBNPG,XBAFOHBGFFCCDCGELADH..VFGHSABF.hAAAMAGHREAABAHEGCEChAAAWADBaGHF..QFDEhABAeCBFdAHAAFAFZBEBKHFCICCH.JHBChACA......hAFA...,2,-24,-7,17
GKRBJVHdLFNbcQDSZWIeAMUTEXgOfYaCP,UDBDTBBAECHF..OBFF..fAAHaBDDGFDDREDHBGFAhAAAJHAAHEACFAEG.NAIA.QGBGhADADIFG.SCFBhAHAIAABMAEEXBCCCDACKGHB..hACA..LFGBhAIA...,2,-21,-1,20
ZRXAEDQPUKSaCMfGWNLBFVcTJegbYOIHd,DBAAQBGDKGBD.SFHFaFGB.CFDBGACALAFBFAFGTDCChAAAeHEE..bEADIFEEhABAZAAH.XDGAhACAAFFA.UDAAMIBGfHDDBCEA.hACAJBCG.OAHH.hAEA...,2,-17,-10,7
NMcdWGQKBSZLeIOFCTbEPRaXfHUDVYgAJ,MFECdEEDQCBDKGEDBCBE.LCFC.eEHHFCHDTCEHhAAAEBACaHAGHGDADGBD.gADFhAAAJABG.WDADhABASBAD.IHGDCFBB.RAFGfEBDhABA..hAFA...,2,-44,7,51
aBIAMQNTFWPSKVObYXCHcLfJREedGUgZD,QABCTDAH.FGBASAGDKAFG.OADDXGGDCFHBHFFFhAAALEFGJHAGeFCEhABAUDCHDAFFaDABADDHMACHhADA..PDFA..YAHHfHABhAAAEDGE.....hBAA...,2,-16,-13,3
KJbGDHaBSdVCTFeEUMRYLIXWfZQNPAgcO,OCECKDDDGAGEDEEBBDABdDBA..CAAFFGHDeFFA..UADEMIAGLFFFhACA..IGCBhAAA.XCBFhABAfGBAZGFEPEABADGFJFDB.aACGSBBChAGAEBHD...hAFA...,2,-32,-26,6
PdIZSDgWNRLMHJBfCUcbAKOYeGFVaETQX,OCHHGEDGaADD..TFAFQFAAdABGZBDGSFHFhAAADHGC.NAFG.MIDGBBBEfFFChAAACAHDUCGEAEDBKDAEhABAeACCFGFDEFDD.IAHE...gDEHhAGA..hBAA...,2,-25,-8,17
UHCTfPELSDNROFbQBKVGIgJAYecdMWaXZ,eBAFMCCE...aFHBXGCEUAGE.CAAH...TCCCEFHHSCAFhAAARFBFOBFHFGEBQGAAhACABEAH.GEBFhADAIDHEAFAD.YAACWCDAfHFBhAEA.DBEGKEFH..hAEA...,2,-24,-11,13
gOHZGVaXWYbCDeSQMEdFAPTRLcJBKNIUf,REBELFCABDAHKGEAUBGH.OBEBZACCGBGC..VABDaHAG.hAAA..XGGBhAAA..WDDGCHAGSFBDhABAMIFA.FHDCAAGB.PEFG..cBAAhABANADB.fGGDhADA.,2,-45,-13,32
ERZPQDdMTgXfGaAIKFCJebVWHLNYBOcUS,FHBGCFGB.eFGH..VFEDLBBFBCAGUFABSDEH.EAEDhAAAZBFFDGEFMABA..hAAAXAGBGBCGAAIDIFADhABAKHCA.WCCH.....NDICOCGBhACA...hAFA...,1,-14,-39,25
AIgKWebSFBUQdcPDRZOGfHLTEYJXaVNMC,KBFCeAFEFDCBUAAB.dGCEDFABZGEGGAAD.HCGDEBFB..JEFAXFCAhAAA.aGFCNDBB.hABA.ADAF...WFAHhABASEBF.BCHH...cEEHhADA.....hADA...,2,-37,-27,10
DgJCWIfdaVOZLcbeGNHBQTAYKEPSXRFMU,KHDESBBCFAAG.DABECHHA.....fEDDVCCBZCGHLBFEhADAeAFFHEGHBBCChAEAAGEGEGCE.XBGEhAAAUGAG.WEABaFEE.cCCB...NIAB..hAFA......hAGA...,2,-35,-9,26
CYBWDfPZXFeQTNILGcRSgJOMbdKHEVAaU,CGCBBCFEDDIF.ZBBD.FEFFeECE..QFBG..NAEHGGEBhAAASHGGOCCEhABAdAGH.HCFFAAAGaDDG..hACAWBEEfFHA.XADBICAHhACALHAG..hAHA...,1,-27,-30,3
PObHfCeGVDLZUgRcdKTSQEaWJXBNAMFYI,MFEBFDEB....IHCDPBBAHFGHeABDGADHDEDDLDAFhAAAUEGDREABdFBA.TBEFhABASECBaFFBJAHDBHEAhAAAADIH.....OAHD.CHHH..hACA......hADA...,1,-14,-19,5
fGLJaeHUDcRTBEWKMQYZNPbSXOFVgCAId,dGFBLDBGJDAB.aDFCUDFC..DAGARCCD.EBGF..KGCFQAABhABAZACA...NFAFSGHFhADAXAADFGADhAAACHDFIGBH.fGFE.hADA..eCCC..hAEA...,2,-40,-26,14
PFNVAHdUBfeLcDYIZGJRQMCXWObKSgaTE,UBCFeACHDECAZFFFGDBBRCFF..MBIFCHEF.OHEGKBGF..aGADhAAATFAC.EBACFAHFhABAAHAH.BDHDLFCBhAAA.IAFAQFCBWFFGSDADhACA.....hABA...,2,-26,-26,0
OWTAZdDXLeJKfVERCQNFaMgPYGBcbIUSH,ZBECXDEFLDFBKDBC.EFAE..RFCAQADHFBBFMIFA...hAAA.PHACBCHFcGGHhAAA..IGHBhABASAGCOADAADIFeFACVDCDCHBFaCAHYAHHhACA....hBAA...,2,-20,-20,0
USfMLQXWKIbHCRPJeFDATgcZBEVNYaOdG,TCGEZDGBBBAD.EBDH..VCCC.aFCGdDBE.SGBDhAAALGBGQAEBhAAAKGCHHGEECEDFRAFEJFFD.DAIBAHAH.cCABhABAODAB..fABFMEIBIEFFhABA.....hAFA...,2,-20,-13,7
FcaIWXbBeZfRTDOMCEVNGAUKPYJLQHdgS,KFDFJBFDLACFQAGAHFBCdECF..FGACaGFF....XAAFhADABBAEfADFhAAADAEFMHEG.CEHCEAHHGCDHhAFAACIF..PFHFSFGEIHAAeCBF.hABA......hAGA...,1,-13,-25,12
HMDWPTBKdNcXFLEAZVGSbJaefgUROYCQI,ZFCGGDAHSCDBJEFF..aGBFeBGDUADHRBBDCFHA..HBFFDAAC.hADATAAFKAHBdFAGXAGFhAAAFAEFAEFA...fEHAhACAOHFE.IHECWHAA.BHHAhAEA......hBIA...,2,-23,-15,8
ZCKEAcePMODXBNbWVILGYQRFJgUSHfdaT,eBBHMGEEDAFABFFD.....NFAB.VCFALADEGCAFQCGGhAAAJAAE.SCEDhABAdFCEZEFCKFBDEFHBAIAC.hAAAPHAAXAGA.IHHG.FAEHhBDA..gGDBhACA..,1,-16,-20,4
PJMQVXdREATODeGcULfKHWCZINSBYbgaF,DDDBGEAELFFEHCEBZDCF.SDAFBHDE..gBFDhAAAaEHHPACAQABHhABAXAACdHDBACHGTGABhADAcGGHfGGE.CEADNCEG...hABAFAGA.MCCFECHD..hAEA...,2,-23,8,31
fJaWQLORPDYFGIcAdSBKVEeTZMbHUNgXC,dBAGKCCBEBAGZGECMIBE.HCFEUCFF..XEAGJAFG.aGAELGFEhAAA.RDAFDEEBhABAYEEAFACE...hACAICDBAIEGBGCH.....eCCDNBIG.hAFACBGEWAAE...hCAA...,1,-10,-31,21
eHTKfbVPLdMcUAREXJSQgFODZBYWINaGC,EBGFSHFEFBDE.OEEBBBCC....IGEBGCGCCBDGeFAHhAAAKEBHVBAHdEDDMACGhABAAAHB.RDGF.QAEAhAAA.DICGWBBDNEAAaGBEfGGE.hABA......hACA...,2,-26,-19,7
cMSafCVZgdRYAbBHFETOUJLDKIPNeGQWX,BFGBFEDFEHFAOBCA.LDDDDGFAKHCC.....NABFeHEGhAAAQCFD.XADAhAAAMBGBSGAEhAGACCBEVDAH.dBHGAABB..TAGBIEEC.WCCFhAHAcGAH.aACG.hAIA...,2,-34,-26,8
NcbFUWdgeGXSPRYVHaLQfKTAEBZMOJDCI,BGCCOCBDJCFGDFGG...CHBG...IBDE..bFFCUFEEhAAAdHEHGADE.hABAXAACSEDChACARAFC.HEGFQCGH.KFAFACBGZEABMDDDhABANDABcAFG..hADA...,2,-41,-11,30
bfYOXeAJZEGBTHaCQcFgVMKDdLPUWSRIN,EEHDGBAEBGGBaEGC..QCCBFAEB.MFAFdEDBUGCH.hAAASGADRFEBbADG.hABAOCFEACFBJCAHTBGBhACACGHG..cABA..KGDFDAAB..hADA......hAGA...,1,-12,-28,16
WLFDOUdKRCYgGcXETbVSPZaeANJfBMHQI,JHBABAFFHDBCQEAELAEAFCAE.DFDFOFEF.dCGCRFGBCAAGGBABhAAA..EAHDTGGHhABASCFFaFAENAIE.hACAIDDD.KGEG......hABA.gACDhAEA...,1,-4,-40,36
dOUXZGJMRCIeDLFENcaPAQKBYgTbSfVWH,BBDATDEHSBBD..fADFHAFGUDEBXDAEhAAAGEAEMIFGIGFGhABADEHBEABEaCCAAGABQGCHhAAAgAFA.....WEHFdGGH..hACA.OHCE..hADA...,1,-6,-26,20
fDdCMXPYBSTbOEcVRAaLGFHQUJWgZIeNK,LDADHADEQCAFUCGB.JFEHZBAAeDFAKCEFDGGFdAHG..MAAEhAFA..PHCABGCCSGGBhAGAOBEGEFGG.hAAA.RDBD.ACFFaDCD..FHACWFFEIFEChABA.CHHD.....hACA...,2,-19,-8,11
DRGPLKSecENUOCbBQWMafJZAVdYIHXFgT,dACEHECFFHBATADHDGEA.GBACLEBCSCHB.eHFGhAAANAHA.CGGEBEFGMFAH.fHBBhABAAEIF.YAFChACAXAEF.PFHBKCFHEEHDOCFFhAAA...WCBAaDDF.hADA...,2,-34,1,35
BWJCAeaSFdYNEfMKVQZgDcTGRbIHUOXPL,aBFFdGCGEBFC..MBADQCCADGGB.GAACRBCAHEAHOFAGhAAALFHBBFGBCFDGeAAGhACASDHBFCHF.fGEChACAVDED.cGGCIHEG..PADGhAHAAIAA....hAIAKAGE..,1,-4,-21,17
PIEBaCAgLJUTVfDSYFOXGeNMQHRKdWbcZ,LEBGJBGB.TBAEDAFGFCBB.GEEEeHEEMGBCHDCFKGBBdHBF.hAAA...bCDGPAAEhAAAEADBaAHH..CHGEAEAHgFGDhABA.fAFASADH.hACAOEHDNEAA...hAEA...,1,-5,-28,23
FfHRSCTZLeVXQINaGEPgAbUKMWBcJDdYO,UCBDMBGBBFAEDACH.dDBHFGAFHEFG.CBAG.LGFA.eAFAhAAAVFCD.QADDhAAAaDAHEGCH.AHHHKAHH..hABAJDFAfHABTEDH......hACA......hADA...,2,-30,-25,5
OeZfUPcTaXMGLNBgDdQCSJRAVWEbYHFIK,VBCCECGEHDAB.FHAEOGFEZFFB..UDDHTDEAMBCD.LADAhAAABDAHDEIBdEHEQGBDhAAACAHHRFCA.ABGCbEAAhABAIHHH.fBAAcBGE..aACGhAFA......hAGA...,2,-28,0,28
VOQRDZUXcfHdbANPeaEBLGMgKTCJSIFYW,eBHFEAFGBCGHGABFKFDE.CAAC....JEDFFGGA...VACBQGBGhACADEAAZFBH.XEAChAEA.HFFBAFGEaDGEhAAAMEIBSBBDICED.....hABA......hACA...,1,-10,-41,31
XfMgPSDGYFcCIVZOWBEKeaNJdHULbRTAQ,XDDHMAAG..SCHBDCFEFFAD.CBCCZGEEOACFBECBEEHBeDGHhAEA..aAEGJHAGdHGBhAAAHBEBUCAG.bAFAAGBCfAFDhAHA..gGDBhABA.YHAG.hAIA.cBCD.,1,-10,-21,11
YFOQWEeBJCXVZISNPGdbcgUDAKMaTRHfL,MBFDaGCCHCADLHCGOACFQEAC.eDHHCBACZAEGNADE.dGFGhAAA.bEGBUEEH.DBHBhAAAADFBKEDFTBAC.fGHChABAFGABECFG.BHAD...XAFFhACA....hAEASGHH.,1,4,-9,13
dbIDfXTgOPJBVSHCRYNAFGeQacLZWEMUK,eCDBaAGHZDGDMAAD.dBGEDAAF...XDDFTGCB..OEGHhABABECCHFCDCGAC.NEBC.hABAAHIHFBEC.QDBChACAcBBG..WFHHKFEH..IBBHhADA..gADHhACA..,1,-23,-25,2
KTLAbZfIPSMBNadEcWDVgQFHXGYCeORUJ,ZCAG..IEDCMFDCaHGEdEBG.EAGCDBGAQGCEFDHH.XBBHhAAACFBGOGEEJEHBKEBEhAAAAFFD.....fACHhABABACBNEACVCFH.gADHhABAYHAE....eAFDhACA...,2,-37,-5,32
HUQNYaWCfObLgcKVFMTJdGAPESZXeRIBD,EBCBXFDHRBGH.DBDHUFDA..QDFDaEAD.CBADOBEGhAAALAABKBHBMECCTGAFhABAdGGEAEID.SAEFhACAIHHEBCBH.NADH.fAFHhADA....gECFhACA,2,-35,-20,15
HNTPbeZAMgdDEQXSVUcJLIfCWOFKaYRBG,MAAGdAHGEHDG..SEHBUADHLABBCCEH.FGBBaBDBBFDDHFAChAEA...TGFEhAFAeFHBADDGDBFCQDEAhAAAXEFCcGCDJEAGfGGEKBHBYBBHhAGA......hAHA...,2,-18,-18,0
TPXHdfDFbWVYOBeSKgUQGCIaZJcRNLMEA,TAAAHBFEDDCF.FGHD..VBEFBEFASGGAKABAUEDCGGAHhAAACHADZDAH..RCCDMCHBhAAAAFHBdEAA.....WGBAhACAeAFE.QADCIFFCaAGC.NIDF.hADA..EBAB...hAEAfHEF.,1,-5,-13,8
APfFNVMSKQaBJEdRLHZXcbTOeUYgWCIDG,FABGVFFEMEBD..SAHHKAFCBDDC.dCCBLCCCZDFC..hAAAXFBETFFAeFHHhAEA.UCGGWBAFCGDEDIAGhAIAAEBF..fAFE.NEEAaGAC.hBAA......hBDA...,2,-28,-21,7
ENBAYUSIXQMHDGaVdTeOgWFcfKCLPRZJb,UBDEXGADQEFBDDCE.GAACdECFOHCAFBGFKFAELBAAhAAARGAAZGEG.JAHD.EDFBAIFASAGEhAAAHFGH.hABAaEEHTAEF.eDAF.....hACA......hADA...,2,-15,-5,10
eOQfDBUXKgSGaWNJTLIMZACdYFVRHPbEc,dHFFFEAGHBCEEBHD.OAAFQBDBBDHAKEDBSGDB.aCFDhAAAJCFGLCABMIBECAHF.hAAARGAC....PCCBhABAeHFEDFFGgFGENACD..TFBHhBCAAAGA......hBEA...,1,-1,-26,25
YMBLfWgJOVbGaCdQXNARHEcUeFPDKTISZ,RDEFHGDGEFBA.eECE.DAGAKHDA..SDFAMAHDLBDC.hAAA.gBBGhABAOCACbGAGCHHFQEAHhACA.AGDGFACEPFHFIHBFBHFBfAADhACA..WAEHhBAA..,2,-33,-8,25
bQWgPdLeMDIHGNRXEAOKaTBYJfCUFZcVS,KCEFTBEFBFEF..JCDHCDAAZFAH..VFAG..SABGhAAA.QCGDhACAPAHBdEGCMEHHDIDCIBBDhAAAHGCA.NABFEGDCOCCF.aAGBfHFBhAGA...hADA...,2,-32,-21,11
bIFHAMSPLfGgWXJCUDTNdEOReKQVBZcaY,MCBASHDGLEHDGEAG..XBGCCFFBDADHdCFDOFFFhAAAKAABBCDAaGAH..IFBFhABAAGEE..PEHHhAAAfDBDJAEAUCADEGEBeAFE.QDDGhACA.cADFhAIA..,1,-4,-33,29
KLTfBJdWVbASGacIZMYRUOCHNDQPEFeXg,aHBEZACEMCFF.RGFA.OFAGHEAD.DABBQCGEFFED.eDDDhAAAKBDALDDCBAGCJBADdGCEhABAVAGDAFID...SDAAhAAA.IACECAHA.NEIGEGGDhAEA.....XGAChAFA,2,-19,-17,2
TWKQdLDAZgESYCFGMRfbXeOIUBPcJVNaH,ECAFCDCHFFGDRFDB......XCEDIFBBUGAEBDAH..PABEhAAAJCHF..aGDEHAFAhABA.KDCDLAFDhAAAADHAZFFC.SADD.MIBAfCCBhAEAeABBcEDB.hAFA...,1,-15,-35,20
ABVNRIYKDESZLUcHXWagMFfOQeJCdbTGP,BAHGREBDKABB.EGEAZCDDLFCFHFFA..aAFGFAAG.OCEH.QCBDhADAeEADJHDCCDBCdDGAhAEA...TAEHhAGAAAADNAIG.DFIB..SADF...hAIA......hBCA...,1,-23,-26,3
PdQIVOcSRKYXeNaEATMCLDGUfbgWFBJZH,CHGALFGDGCCEUFEB..fBAA..bFABWBFEhAAABAHFZDFCdACD.ICGBhAAAOCCGSDBDhABA.YGAG.eEEDNDICAHFFTBADhABAMAECDIAC..FBEDhADA...,2,-28,-9,19
KUaRCGTdVcFMOfNXEIPAbQHgJZWeDSYLB,QFAGHEDCZBDGeACCDCCHLFFDKFHD.RAGB.TCAFdBBBFEDDMCIDhAAAOEHF..XCFEhABAECFFAHHB.JHBCSBDHhAAABFBFCHADcGECNABF.....hAGA......hAIA...,2,-19,-8,11
NFcKeLbfgZBVWJTQMPYSXOEDRaCIHGUAd,dHBFFCFHeFHBLCCA....fGBAgFFFZACDBBAChAAAJEBGQAGBhAAAMDADSEBDEABFDIDEaECGIGFChABA.........hABA......hACA...,2,-42,-16,26
NJGbMcVPLAZYOIBgQUCWESRXeFafKTdHD,ODBDBFFFUACF..EFEERDDCFGAFKAEHdCAE.DBHHGEGG.MAFChAAAVGCC.LADDhAAAACHEZGDC...IABAhAGACFBESDAAeDFGfHFF.hABA......hADA...,1,-20,-35,15
ABeYJCIUXQLdMaVEFbPGTWZDfSKRcNOHg,eAEECGDFUCFCQCAD.MHEGVCAHFDFBGACBZFBB.DDDGSFGAhAAA.KACFhABANIEBHFFCAAIFBHDGIHAHhAAALDDH.EBEE.......hABA......hACA...,1,-7,-34,27
NGHBfIZOKCYSMdRXDFWbTAPgQELecJUaV,QFDELECHeEGHJABF.UBFA..VADGHDAFBCHHZACDCGEAMCAHhAAAdEEDDAIB.FAAGbFGHhACAAIDG....EHAGcCEEhADA...NIAH...IHHHhAFAKGAE..SDDFhAGA..,1,-12,-19,7
CHMTfQBeUAWRDcNdSEYGgXOIPVLZFabKJ,RFFHDGCHdFCAEHFAGCAF..XCEHOFAB...VCBHZAEGaABChAAAKAEGHBGDMCIB.fGDGhAAABEEAAGEE.NDAC..hACA.SHCA.ICGGPABGFFGEhAGACHHD.....hADA...,2,-23,-7,16
RNeOaWSgHVPKJBdGCMQXTAEIbfULYZDFc,EEHD..fFECLAHBDEAAFCAHRDEEOCAE..SGADhAAAHEDGPACABFHGCFBCMAGDhAAATBFF.IBBChABAUGEH.ZEBD.NIDFaDHF...WAFEhACAKHBC......hADA...,1,-13,-23,10
gNTDXEBYefAVPSQKGIZUJRdHLWCOFaMcb,VCDGQFAG.KDCAZFFCRCFD.LEAE.CAGDFBHDaFEFbACG.hAAA.TABEDICEEAADBEGGhABA.eHEEAGHE.SHAGhADAIHHHdAGHHFACOCHF..hABA.cFCA..hADA...,1,-7,-24,17
PJUacHWeRTQEDGBOAVCNXYbLdgIfSZMFK,VFCDCBBC..XAFCLCCEdHFH..IBGEZEFCFADFJHAAaHFG.hAAA.HDADRCFA.EBAHDDDHhAAAOEFGADCF.NABB..hABA....YFFGfCAE.MGAChACAKHAA..cDDHhAGA..WEDH,1,-17,-30,13
ZfPJVCFOKXgSdGQBIDeALUHcNMaRbWYTE,LFDAUBBB.HCEBMEEDaAEERAFA.....bBBGTEAAZCGFJHBAhAAACGGFFCHF..KEAFXGEHhAAASHGAdDFCBFCAhABAIAHAAACB.NABHEDBAfGAE.hBAAOAEH...hBCA...,1,-8,-20,12
afdgHERZFQXbDUSCOPITAGWVJNBcYeKLM,VEFGJHAGBADC..eFBCLFAC..fHCBHGEAEBBFFCGHhAAAXAGA.DACBhAAACDEDOBEGTADHWABDhADA..cEGDYCEGaAHD....hAFA......hAGA...,2,-29,-26,3
gVWRDBEZLcNOUbeGSYHFfXKdCaAPIMJTQ,MHEATBAE..QAAE.VDEADDCHBHEB.ZEFCNCED.hAAAUBGHGDAESHAChAAAHACEFAGCfAEChABA.KEDHaDDHAHIFIHGAWDHH..hACA.EEAH...OHBEhADA.,1,-6,-30,24
KfRaONSVXQDgLYZJeEdCWFITUcBGHMbAP,KECCRCFGOAAB..SCHFQBCCDDBDLEBFZACD.JEFHhABAEFHDdAFBCBAE..FGDAIFHFhACAUGAFBAEAHFCDhADAABGA.aAHD..NIDB........hAEA......hBEA...,2,-41,-11,30
HMPWgEObCcfGTVaIBFeZRUKJDSNAYXLdQ,LBBAQBFDMDFG..PEAAEHFEODBDCBAEGGEF.TADChAAAaEEGBADF.FBGEhAAAeGAAZGAAKAFFSEDAhABAAGFEdEHC...gCCEfCAE.hACA.IEGB.hABA...,2,-22,-3,19
fPKFDUZJdMHRbXgeNWVBTESLIAaQGCOYc,aEACQGFHGDDB.CBBC.OADA..fAEAKBCGDICCJGBEdDADhAAA.MABERAAF.XFCEhAGAeEHH..VAGDhAAAEHCEIDDEAFGB.PCFEFHFC...hACA......hAIA...,1,-14,-17,3
DYULBEHbFMgCVePfKTNRWcJQZSIaXGdOA,DDCGLDFFHEAFMFFECHDF..eEBDKCHDRABAJBBHZGEA...SAFDhAAAaAEEdHGFACADBEGAhAAAFECE....PHBChABATECF...NCIG.WCAF..IHAEhABA....hACA.OAGDEAHB,1,-16,-24,8
HgIQAJBNPFMKeTDXUfdRLWcOSVZaYbGCE,JECDBGFC.FDEDeEFDDIGC.UBEH..dGBHLACCOBEAZAAGaBHF.hAAA.GBAC.CGEG.hABAHCAG.IEGDhAAAAIFCNEIA.KEAA.XGDHWHAA...SHAGhABA..hACA...,1,-23,-38,15
XKDULMcQSIWFTJgdCOHRbYNVBAEZGPefa,ZAEEeBAEaBCHDGEH.UGBGMHCC...SEDFFDFE.JEGFCECAOAFHhAAA.RCAE.NBAAAIBAhAAAEAGB....fFAHhABAKHGELFFDICGA.WCEHhACA......hADA...,2,-42,-29,13
DdEQALGHIZbWBYeUNPcFMRCOfTKaSVJgX,LFFGGDDBZACHBBGFUGCC....NADGFGAHREAAOBAD.KBHBhAAAaBBB..JGFGXFCAhAAADFGA.dCECAGAF.IHHAhABA.bCFAYAEA..eAEChACA...MCCHhAEACHAH.fHCB.,1,-14,-26,12
fAYdIbHNJZLEWVQcaGKMXRBPTUeSgDFOC,dAFEHABBZEEFEAFEQBAGaCEA.KDGBMBIHBAHAUGFH.SEDAhAAADDCGCFBA.AABBIDDGhADAJHAGLFDBVFBHhAEA..XGGD.RACE.eEHBFEAB..hAHA......hAIA...,2,-17,-9,8
ILPHZWGTdENRfSaKOBMXbVJcgQCAFeYUD,FBABUBEHDFEDLCADHDEGGEBEEEGC.RBEA.SDDGKFGB.MHCAhAAAXDCB.JDABhAAAcFBB.CABDAGHGIHAChABA..ZAGFWDHBNIADfFDHhACA.aGGC.BDBGhADA...,1,-18,-19,1
ZUbBNOLMRPJHcIdYeSTGEDQgKWVFXAafC,aGGGZDGFBGAFLADBRCEBHABEdCFD...SEACEEFHQAAHhAAAKHAG.VGAGAHHF.CFAC..hAAA.NEEA.MIDE..hACAPECFIDBDeBFEDEEH..FBAH..hABA.fGFGhADA...,1,-10,-24,14
XJQLAEFTSCaYBVObZGWPgcRdIKfDUeMNH,TCGBaFGHBGCD..OCBAZAEEGEDG..PEAFRAADKCFDDADFhAAAUGFB.eADEMEACHFCHhAAA.XDEHhABAJFAHAHIB.SHAACFHC......hACA......hAGA...,1,-13,-31,18
RYTJNHOUAaSIDFdgMCKVWXELZBbPGeQcf,aEDHDGGCdCHE..CEEFKEAF..XACHLBGFZDDFBCHAGCAEhAAAQBBHRCFF.JEHDhAAAHFBF.AABEFAGEgADBhABAWFAD.PHCGeHFC...cFADhACA...fFFEhAFA,2,-25,-21,4
bCAYdgaUfXIRMLPeBKVQcSOTFGNWDJEZH,dEHEaGAH.UACH..IGDELHFABECDKFBA..QCDFhAAAOBDHFABBGBAADBGDZEFBhAAACHAAAEFF...fGDHhABAXADBMDIH.eFBBSAGEhADA..WHFA.hAFAEBHF..,2,-26,-23,3
XMIYJCDTebEfRFaKANSOZPdVBcUGgHLWQ,OAAEdFEBBFBCUFDAGCGELCGF..QAFGMDCCJFBH.hAAADDDG.TCACEAECFGHDhABAKBBEACCE.ZECF.PHAChAAA......cDAF.WAHHhADAIHHACGGF..hABA.eACE.,2,-24,-13,11
YWPXeETIQFOfDZHbcGdKCLSNJMAaUBVgR,aFBDUAGABEBFRECF......PCBCeEEHIADEFEAA.hAAADACDHFEBGBGAKEGBSADGhABAJAAFAHGA.hABA.gCDAWFADEABH.OAFG..hBFAfGBG.hBIAcGGDCFHA,2,-31,-21,10
dMfEFWgVJXTbLKDHBCcGYROSaUPQANeZI,eGFEdHEBMDCFEBDEFGAC..VEFA..XBAGLBEGHDEAhAAACFEGGAAGOEDBaGBHQDAEhABAAHHA.NIDFfAFBhACAWDEC.......hAAA....gCGEhADA,1,1,-37,38
GQZdIEgeKJCcUYBAHSWDfFMRXLbOTPVaN,SECBDCFEFDGF.RCAFLEFHOECD...VAGHaCEHQGAChAAAdEHEEBBE.KGGGCEEDUFADhAAAAAHAHBAAMACAXDAEhABA...PADCNIDF.ZFDB..hACA......hADA...,1,-9,-20,11
fCLMOgDNJcIaeFPdUYHSETXVGBRAZbKQW,KCDEQCFECACE.LFEDOHDCDDFCJEAH....aBDHFGAAdCAFhAAAUFFBSEBBhABA.TFGCXAFAhAAABGFDAEED.ZECD.WAHHfEBH.NABG.hAEA..eABC..hAFA...,2,-47,-11,36
KXZPSadGcOFRWbJUNfLCVAITgQDEeMHBY,TDBCDDEBMHEA.BECHKACHZEFF..SGDCaCGEGBDAFGACRFCG.hAAA...JAFCNBAFLBFHhAAACBFGAHFB.QCAGhABAeBAH...YFFC..hACA......hADA...,1,-18,-39,21
PFEQYCNcWKGAdbReDOJZXgHVaMUfILSTB,RACFDEDBOGCAZADAHCBE.MHFCUGGD.LAEBBFFCFEHD.EAADCDFA.hAAA....NCAC.KHAChABAGGAFbCAH.XCFChABAVAGB..aFFA...SECEhACA.....hACA...,1,-15,-23,8
ZSEdaBGeYPQNDbcMCfORHgWLKIVUJATFX,TBGHZDFGEABHBGHB.GADAeGEGQDCH.DCCAcFAHhAAACADEOEHF.HFAFhAAA.LABFhAFAKHDEVDBDAHEHFDFHSFGCdAGB.aAHF...hBAA......hBCA...,1,-4,-21,17
VgfaKeMbWEZNYDLdBHPUATCcOSIFRGJQX,TCBBOFHBFHAG.GBBHQFFH.XAECVEAAaEEEeGAEhAAA.MDEBEHEGZAGBhAAADIDABDGH.UABBhACACABCIAEARBFA..fHADKDHB.hADAWAFE....hBAA...,2,-14,-13,1
ZUbYISQPKeMXaREcDTVdBWFOHCJgfNLGA,UDAE..IEGBSGGFKDBFMICERDCG.DAEGdAEE.FHDAHAAChAAACHHG.JECE...hAAAfHGHNAGELCHFhABAACDGZAGBQACGeGCAaGBGEHAG....hAHA......hAIA...,2,-22,-17,5
RZNgBbUKWDcTEQIAeCLOaJHMPfYSXVFGd,LDEHOBBCHBGDMDCF....YEEFSGAD.FBAGhAAAdDBERADCZEAHBGGEKDDDWGAEhAAADHGCEHDA.AIFCCDHGaAEAhABA.fACD.GBEC.NDIE.hAHA......hAIA...,2,-24,-17,7
gHeDXGNTBWMJfPILUACVbEFOdcaQZKRYS,CDBEEFCFdGAE..QEEAKCHH.SGHBHECDeFHDGAABhAAATBFDBDAB.WDDChABAfGEHLHEGACBGFADGhAAAaGADZAFA..YCAFDDHFNCDBMEAFIABChAGA....hAHA...,2,-33,10,43
DeEfUgZLIVBTRSNWdFKcMbPJQAGCaYOXH,CGECOFFBDBBF...EABGUAEGZFCBLCFCBEEH.REAH.SHBAhAAAdCDGKGHF...MHFAhABAPAEGAHAAGDADhACAaDAB.HCGFeBBBfCCBIEHG...hAAA......hADA...,2,-32,-15,17
AgILYeCbEUaRMGTPKNQBWDHZVFdOcXJfS,LFGFCGCGUEDB.MABFGABAKGEF.BBDEDHAAHBEFZAFH..FHECdAGGhAAA.XDBE.hAAAJACESEGAhABA.ABFDIGGD.eDABaDHF.PAHDhADANCAE.....hACA..WHAG,2,-27,-26,1
WgBGTLOJAXNMSKDfQcIUCPbEVeRYZHdaF,XAEBSBBHDGEGQEDF.UDGFPECF.EEEAeAFAhAAARABD..ZCEGaEBFFDABhAAAgGABBHAELHFGhABAJFHHAAFCKBAFfAGFIHDFCEHG.YAEFhABA....hACA...,1,-11,-21,10
RHMeVcaSbLDAfOFEBYPgCKUZIQJTNGWXd,FFCDEGCEBCAA..PHEGCECDZAFE...QAADJDEF.TBGHhAAAGEGE.XAAChABAdEAGHCEB.MDIDhACAeHDAaADGSCCCDDCEfEBFgGABhACAIFGEWAEC..hADA...,1,-7,-32,25
BgAVFReIDPHWLNaGcdMbfZKCJOXSQUETY,REACDEIDHEEALHAAGBEHMDCBZBAEKHBE.CHGF.JFGH..OAEGhAAAQEDHEGEB.BBHEhAAAAEIB.FDAHIDDAhABA..NCAHdABFfABHSBGD..hAEA......hAFA...,1,-6,-33,27
IaBNMcdQGESLgVKXfYRZUPFDHWeTObJAC,aABAMIAG.dDACQAGGGCFALAAEKCBB..XFAFhAAARFACZCDDFHFGDIFG.eFEATBBChAEAOCHFAIHEBHDBEEECSBEDhAEA.fFCAYAHD.hAFA......hAGA...,1,-12,-14,2
SCYVLgFfPOaGbUcdKRJXNZeIHAMTEWDBQ,MBCDTADEDFDB.BBEBQEGF.CDEFLCBBFFHFOAAHaGBAhAAAUEEAKFEF..XAGGhABAeEADAAIH..SCHHhABAYHEGfABH.PHAEhAFAcBDH.dHAD.JHDGhACA.ICGG.,2,-27,-5,22
QJcLZSgedOXMaGCbPAIBTNWVHKEYFRfUD,TDGDVGBG..EAGFRCBGUFCD..JCCBZFFG.eABAOEFD.hAAAaGABCBGEAICG.BFACHACGhAAAKBAFFFHBDDFBLDFChABA.SDAB..XAEHhABA.MAIF..hACA...,2,-26,-11,15
GAZOcBPMYgdbNXeVIfSKJDHUQLCWTEFaR,OAADBADFMCHFdEDD....XBGFVFEF..SAFGhAAAKFGBHFAFQBEGhAAACEBF.TGEAFGABaEEGhABAAFAFcCBEYCAANDIE.ICFADGDH..hACAWADCEHGC....hACA...,1,-18,-26,8
geHWNPAEdUFGCJKBDSOaVMTZXLQcIfbYR,EADHdEEGGAACKFFG.BEHBDBBB.OGBC..VCDEMDFAZFBCQAGDhAAA.ICDDhACAfCHAbGFA.hADARAFGeHAA.NEICACCH.CHFB.aAEG...XDBHhAIA...hAAA...,2,-32,-7,25
CVbWSXGaULMHAEdIDeBKfQJRYcFTOgNZP,dDAEeDACKGFGQFGARDCB.FFCETGAEOBHBZAAG..CBAF.VCFFhAAASAAE.hABAaDECMDIFEBFDBGFDhADAfAEDJHAG..cFABPHCC.XAGBhACA....hBEA...,2,-23,-11,12
KDTMCHWBLPRfdUbcAEJZgFQNYOeGSVaXI,EFCBZFDFQACG.OCBBGAAH.aFGHKAAFDDCECBGAHGFEhABABAHGLFDHRFBF.hAEAfCHCdDHEbDDAAFAF.hAFAFDEE.eDAB.SBDA.IFHEhAAA...hAGAMFFF.,2,-29,-4,25
KfadgXbIVAQNCMYFEJZcUTDBGPHSWOLRe,CADBFHDGZFCBUEGHBEHHHBEH...OCBERGFAeCEEKEAG..dCBE.hAAA.XBAGVFAHACAH.hAAAMBBE..JAFGDCHBhABAGDDF.SBBEfEEE.aHGEhACA.IGAA.hABANAEF...,2,-27,-18,9
SGHFLWRXTYNfJQBMdUKVbeOgEIDcAZPCa,ZGDGaGBEHDFFLFFERADH...XAGCTDAH....NHEHQAFChAAAMADDKCEBeCAHhAAAOABFIFBEAFEHCHADSDDGhABAFDGAfHGH.BHAA..hABA......hACA...,2,-25,-5,20
XCTQWEeNVZdLUbMfaBAPJOKHRFGIYSgcD,JAHHHBFEGCAESABD.DFIBCEDHQACFEAEC.eHDAhAAANDEGdFFHLCCAMIACaDBAhAAABFFCAHAC.KEHFIDHDhACA..gGBFcEAA...hADA..WAFB..hABA...,2,-31,-11,20
aOCEeNfFHbITWAQZBPJKXUdcgYSRVDLMG,BDABJFCF.KCHDdEFA......gFBBRBAHLFADMDEBhAAAaBGF..CHFD..eCDGhAAANCABHDFF..IAEChABAAAFGZAFE..PABE...cFGEhABASGHFDDDHEHAE.hACA.fDDG.,1,-21,-35,14
BdSYfTEGOWKJLXVUPgFaAIeQHMCNcDbZR,eBDGHGCGCCDCDFFGZAFHBFABdDAG....SABCTFDAGBBChAAAOGFGKGHDLEEEhAAA.UEBCgAGEhABAABCAMBIF.NDEH....cGEE...hAEA.YHAAWACE.hAIA...,2,-34,-12,22
IaPcWAMDdQSTbfYBXHNKULJReFOCVEZGg,DEECQFBE.SHAGTEAG..bGDCBDED.XAGDhAAANBBD.UDGALAHBhAAARGEAFACBOBBHhABACCDHEFFCgCAEIAEG.cGACAHIH.MFIBhABA..fFDHhAGAKFDCeAEE..,2,-23,-10,13
NXBSFPZQRIHfYGOeJbEAcWVCUgKDdMaLT,VCDCCDBHKGCE...MCHHLBGB..XABBSGFFZFBHRGEChAAAHABGGAEHOBAHhAAA..eFADJECEAGAFWDHHhAEADIBCdHGD.aFAFBDBFFEHD.....hABA......hACA...,1,-9,-22,13
NPTQIHeJXUFMVDCWSKORBdbcELgYfAZaG,ZBEGaCGGGAAF..NDFE.QDEGeDCFUABBVDAH.CHHDKGBGhAAABGGB.dDHG.EEADgEGChABAAGDC.IAGDhADA.JHDGMAAHSCDDbGAG.hACA......hAEA...,2,-34,-1,33
SIQcbaLUedZfCXOHWEYPBDgNKFTGRVMAJ,SEFBQDCFaACHeBCD.ZBAH.CAEC.OEABHFCH.EBGABAHHhAAADFEGKADBFCFE.GGDHhAAAMFFHACIFIGBBLEHDhABAdBAEXGAH.WCADgDGDhABA...NIAB...hADA...,1,-6,-14,8
gHVGWEdKJYZbcRNLSeUPXFMBADQfCIaOT,QDGBCGDC.aDDCgDAH.GABDdCCBJFBCZFFD.hAAARDDCLBHDeHDAPCABhABAFGAGAICEDHBGOAEAhAAATBGC...WBCEKFHH.....cGGEhACASCAC.hADA...,2,-28,-11,17
dbFKHGLaMVJRPWXDUIfZQcBAgEOYCTNSe,EDFDCFHH..SBEFdAFBKDGCGDBELFADMCBERGBA...XFGEhAAAIDBB.QABChAAAAEADOFFHNDEEbFFB.hABAFDFG..aACC..JDDFDGBFfBGDhADABHCA.....hADA...,2,-21,-10,11
aEZBVWMHUAfFbTKgeCLQGNXYDIRdSPOcJ,FHGEKEHHCFCCLDCE.QEFDXAADDFGFRGAC..dABHOBDEhAAAaAEBBEHE.MICGhAAAAHAETFDE.GDDBhACAYBFASAGC.PDAFJCAH.hACAEADCWEEDfHBHhADA..,2,-22,-21,1
LERXSCTVdFDUANYaKHJQZecbPfBgGIOWM,aAFGHEDHZCCGeACB...PGFABBACIBDAMFAFLECDhAAAEDGF.RBFDCBHBdHBH.FFECAHIBKBABhABAQEAD.hADA.fAEAOEHFSGHDDIFA.hAEAUBGB.NAAB...hAIA..cDGE,2,-21,1,22
gDIGAMCVURBWcSdaPFHNXOfKZJQELeYTb,MHDECDACUGDFBCEF...SADGdAADaFEG.HCGF.NGAB.ODBFhABAZDCA.EAGBeACDhAAA..TBCADGGCIBAHhABAAIHCRDFE.PHACfHAHKAHHLAFBhAEAgGGC.WAHBhADA.FFAB,1,-14,-21,7
XUDPJdBOIASECNefZbYTRWgKVLFGHcaQM,CABBeEHFZFFC...TEAGRAFDKEDF.LCDGHFAH.aGECMADD.DGEBhAAAJAADBHFBAEFF..NAHC.hAAA....fBEGhAEAbGAG..gAEF..hACAFDHH..cDBFhADA...,2,-33,-25,8
XHZJFQWTfPMGdANIUcYECbeLaBVKgDSRO,UEEGEFCF.CECH.eBFFLCCEaBCB..BHFEKBGF.SCABhAAARDAF.XEFAZABGJHFGFEHHhAAAQDCD.hABAfADBMHAGADIF.IHAF.bAGHhABADAGG.WHBA..hACA...,2,-34,-8,26
DBMGHIRQfdcPKNLVObSZaCJgWUTEeXAFY,DBIDBECBHABGREEAdAEAKGFDLBHD..bEDBZGBG..CHAB.JFHBUEAHhAAA..EBCDAHIDMFFGhABAGBAC..fGCAhACANICB.SGGHaAAB.TBEFhAEA.eBGH..hAFA...,2,-24,-23,1
UcAZefTPGaERFDHYdSVNILbWXgBKOMJQC,eCHHTAGBGBBA.EHBCFDGCHDEBdBBDVEBHLAEA.XGGGhAAAKCDGMEEDQFAChABACHGBADAB.fHDHhACAPFFA.DEDDSAFD...hADA..NAAB....hAFA...,1,5,-25,30
SUOABGfVYDbgJeXWRCFPNKcdQHZLETMaI,GEAHVBAC.DBIB..JFHDeBCE.RDEECGGCFGCF.KDDAdCACZAGBEGCF.hAAA.MDAD..aBGHhAAASBEBAHHBBHAG.hABA.fCCD....bFAD.hACAWECG...cGEFhABA.,1,-21,-47,26
VfbgBEdWIGPCeQLHZAcYNMKXUaJRFSOTD,...NDCH.XBBG.UCEHaABDREEBODABDAEG...bFECEGCFhAAA.dBDBGDBACHEDeAHBhABALHDGHCGFAGIDMDAHhADAKAHFFACA.SGBDfHGBBHHGIECEhAIA....hBAA...,1,-8,-20,12
NAVXCEYGcgOKJUZdPBMHaDTIFWSfRLeQb,CGEGEDGBGBEH..OEDFUAAHdGADBBGBHEAATCAAFEFC.SGFFhAAALHDAeDAEhABAQFAEAEED.VACDhABA.XAEFcGGFKAEE.....hACA......hAHA...,1,-9,-25,16
XZFJCeYTQdBKHLUMgVASbPcNWafREODGI,SCGB..cDBDaFDE.EEGCOEAGDCAF.GABFhAAAIGABFBAHCGBF.TCDGhABABFECKBEHHGEGUGGHhAAAMFAFACBBNIBB..fEFDXAFBeABEhAEA...dGDH..hAIA.gCGCPHBE,1,0,-11,11
HWDEGfLXeTcMZQIdJKPFgOARbSNUaBYVC,SDACaDDFBBCB.CEFA.DCFHGFCFLFFHeBED..MBBBIACHhAAAKAGE..FDHBgGBGhABAOGBEAECB.bAFBhAEA..NDAC...YFHD.HCCFhAIAfBFD..hAAA...,1,1,-47,48
LKCeXaUNVSHTARgOYfZcdMWBQDEGFJIPb,ODHHZEBGdHDFBABEDHBCGAACFDGC...JCDD..IGHGhAAALEFFKDBACADA..XFAChAAA..aGFFNICF.hACAHAFA.TBDEAHHBgBFHfHAFhADAMAIF.....hAEA...,1,-20,-37,17
SETBZLdfYKgWVCGHOPbDecAFaJRNXIUMQ,FDFFRADC..XFEBUGBBMEEB..ECHHBABHdGDEKAAG..VBCFhAAACCFGHEAA.ODCEhAAADFFFAAGH.aHFE.IHBAhACASHFA.TDADfAGB.hABAWDACPAHB.cADFhAFA.,2,-49,-10,39
ZJDONVdGefAFbMUIYLgcWBQSRHPTaXCEK,FEEEMAAHUACFLGAC.....gGEEBDAHSFAAhAAAHCDBaEAACFDDEDCGJFFAOAFGhABAdDHGGGDFAICGICCChACA.cBFCRAFC.....hABA......hADA...,2,-34,-7,27
QLUgKeOcRHTAMYPECNWFVXDbSZBadGIfJ,MFDEEBDA..CGAGFFFFDAHFZDGD.dAFGGBBC.JDAFUDAD.eGEGhAAAOFDFHBCHAICA..hABA.NIEH.XCGChAAABACFaGBEIFHC.......hAEA......hAIA...,1,-23,-34,11
bXJPVFUKfQSdDYLWNgBHCTROIacEZMAeG,GBCHJAAG.FGGCUFFEKHAA...QGCGSDDDDCCALEEBhAAA..NEBEBEDHhAAACFAGOBAF.aADGEADChAGAAHCE.XCFB..fDGEhABA.YBFCWAHH.hAHA...,1,-24,-46,22
TOKWMfUNYbeHRDCIJcdLSgFXVQEaGBPZA,KEAFMDDBUBDF....NDHG.eAABHGBARGBGDBIHCCAG..JAAGdEDDLBFFhAAAFDGD.XBCEhAEAQGGD.aACAhABABGAF.AGFBOAFA.fDBChBDAIBGASCBHhAFA..,1,-26,-28,2
DbedRBLUaCEfHSTMZWIYPJgAcOFQXVGNK,FCFFVFBHGBAB.DIDEdEHABGFCUGEE.CDFB.EAGGHBAC.MAEAhAAAZFBA....IADAhAAAPBDG.AEDEOCHFhABAQDDDKGHDeFADaAHDTDAF...hACA......hAFA...,2,-29,-9,20
MLTWfOSNFEgCYbUcJaXBVGIQKDRHZdAeP,eDCCMCACLGCC..fEBESGFHEGECCDECUAEChAAAaEGABABB.GADDhAAAIHHBDAGAZEEAAFEATDBDhABANIBFFGHD...gBGHcBGDXBBChADAKHAAdEHAODAH.hAEA...,2,-10,-9,1
PGbZTgJNdAaLOfSHMEYcCDRBeKVQUWIXF,LEAEOHBAHDDDEFAC.CAEABFFCeBCAQGECUBBE.IGCGhAAAXCGE.FAGEPEFAhABAZEAC..JHFEACAAaADGhACASAACMDDGcGGFDGGGKCEE...hAGA.WAHD...hADA...,1,-1,-21,20
gNfFATVDcEHGSYeCQMUPWBdRZIaXLOKJb,DBFDEEEFHCAGGDCASBFGCACD.MEHHUGGABAACdEBCZAAFaBCALHBGhACAOBHBKEEEbFAAhADA.....NDEFAIFAhAEA..cGAHeAFG..WFHHXAFBhADA.gGDHhAEA...,2,-33,9,42
LHFdgeCVEbRWSGYNQKOcaXfUPBMJDZAIT,TFBGLFBA.dAHCCHAG.EFFEREGF.GAEA.QBBEKGEHaABCUAFHhAAABAAEDIGAAGIBIEHAhACAHDDFeDAG..WHDGhADANCAF...OGEC.fGAEhAEA.MEBC..hAGA...,2,-18,-15,3
MGUKOeWcEAZDVXBNQfaJSgdFTHIPYbLCR,ZGECVEAFBFFF.QGBC..aEDESDBCdGFHFBBGTAEFhAAAHAGH..PBCGhAAALDACCBAB.GCEHhABAKDEGeEAAWHAAAACCDGADfEGF.IAHHhACA...hABA...,2,-23,-12,11
LcfFdEXIQOHCRYZUDaMJGbeNBAWKTPSVg,KEFHTBCF..SBHBLDFEFFFAdGDAECAEQEBB.hAAACBGFZAAFDGABaBBAGEDChACAeAFHAAEE...WECChABAgGAD..fHGBIHHE.hADAOFBB.YCHFhACA.,2,-44,-4,40
QXSDAOPRIGecKYECFNBdaLTfJVHZWUbgM,RAECeFEFKDFC.EDBDFFFEdFBD.LAEH..JABDHGFCUGCEgABChAAA.MAIDhABASHACDEFGAHCHICCEhAGAGDBBCEADBHAAaHEA.fAGA.hAAA......hABA...,2,-43,2,45
INWVecBAZSFURQJYTKXEDgHPOaLGMCbdf,FEGGRDFGQCDF..JFAAKABHDDFEHFFDOHACaECD..MDADhAAACABH.dBGH...NDBG.hABAVCCFBHDHAGADZAEGSHAAhADA.YFHBTFEEEBAB..hAAA......hABA...,2,-44,-3,41
FbNPMHXeQALgJTGcUfRZEDYVCWSIBOadK,LDBGTGBE.UBGBZCAHEGGHDGGB..CEFB.SDFDBFHC.OEDFhAAAaBBE.FBGH.NADD.hABAMEABHABAQFDDhAAAAECC.JFBH..fCDF.hABA.YACC.hAIAIHHE.,2,-33,-6,27
aMCHDRXABcdLWPUfZSbOQJITVEGgYNKFe,dAEELDBHUBCEZCGFSHBG.QEEHTDEDGAAChAAA..gAAFhAAAKHGAeGAECAHAHDGD.DIGGhADAAGFGBHABcAFGfGDBbADDOGCC..hAFA......hAIA...,2,-23,-11,12
XEbefdaUDcNOJATZYFgWCLRKVSPQGBMIH,ZAFCFFAECHFHKACF...SCDDQDEDBHCGHBBB.EBHFeGFAhAAAaGGA.DGEE..OHAChAAAACFD.TAFD.hABAgACBLDAFPEFEIBAAXECGhADAfGDDcGDHhAEA...,2,-42,-8,34
UcfKTEHgeDSCOZFIdWQBAMbGYLNXJaVRP,MDBHGBFELDCDJDBD.RFFG.UABHKHCCHACAeHBA.DEED.CBHD.FEEDhAAA.dGAHBHFFAHGA..hAAA.NDEH.XAEBhACA.aHGE..cGACEDDF.SCAFhABAIFHG.....hAHAWAFE.,2,-36,-14,22
gPeBNJMKLfWbXRZSFadDEGQIVAYCUHTcO,CEBEHDFD.TFAFOFFHeADABEAG.MAGFLBBD.WCDDhAAARCCASBAD.hABAaDFEDHFA.EGCHIHBBhAAAAIHEYAHB.cAFDPEHFKEHHfAHAhABA.ZFAG.hACAFBCG..,2,-21,-12,9
cKADZgEaSIVQfOBXTWRHNbCePdYUMLGFJ,DGFFZAFBEFBB..IBBAQAAE.BFFAXCFFRDCFHACCCEDC.hAAAeDHBdFBA.MFADLDADhABAFHGGKBHBaHGAfDAFhAAAOFEA.WHBANAIG..bACB...hADA....YHBGhAFA.,2,-35,6,41
LCVPWDOEBaTeKJbFcYfXHgdSIGAMRNQUZ,RFAFQGGCZAGFLFEBCDBH....VABGDGGCBCDE.aGDBeDDEhAAA.JHDGFAAGfFAHhABAHCBDSDEAhADAICGAAEHCMBCA..NAIAPFCC.hAEAEAFF.KHAG...hAFA...,2,-25,-9,16
TBYXVLPAJebKIFQZSGfgdWRUaOENMCcDH,eGBAKCEFQDAFGBFEdCBHRAFH.OADF.MCIBDGHHTABAhAAA.BHFEVFGDAGEAJCHBhABAIHEAZFAC.fFBFhAAA.WAFCEEFDCHAC.....hABA.YCAF.hADA.XDCH.,1,-7,-17,10
IHEgbfTJCBFLVZUYdNXAaWPScDKGQMReO,aFDGSFDH.DCFBGABG.RGCCeAAFIACEEBGH...hAAAfFADCGGFFDDAZFAFdAEGhADAAGHE...WHEAhAGAKCDBMBAB.OHEE.gAGAhAAA.TDGDLAHHhBDAYHAA.,1,0,-30,30
QObRGDKYUAPEJIXBMHfeVNTSdCLacWZgF,JDCDXGEDBBEH.HABD...eAADTBGAdEFHCAGDLHAChAAA..aGHBZFFAFEBGOAFGhABAbFBEDCIDKDADAFADEHAChABAMACH...fGEGNAEC.SDGDhADA...hADA...,2,-29,-11,18
COcWPEBHISZJgXNDVaGRQAKTbdULfFMYe,KDAGdBCBLEECMADC.CAHB.OCDC..PDCDBEGAIGBEhAAAZAAD..XGFHhAAADIDAaEEG.GEAChADAACFGUGGBFHCG..eBAAEAFESFHHhAEANBIE......hBAA...,2,-33,-18,15
XNEgFKVIfCOBPSLRWADdaZUHYGJcebTMQ,dBHCZCAAHEFEGCAEeBCEMEDGQGDG.ECHBFADG.KGDBIHAFhAAACFHAOACHSAFChABA.REACAIGGUFFEhAAA.cGAEXAGE....gAFFhABAfGHEBFDChAIA..,2,-19,-10,9
TSAQOYXagECMGFIBWfLcKUNDVRHJPZebd,QEABODBC.aDDACGCGFEAH.BBAELBHH.KHGADBDHHFFAhAAAZCFAdACFTBADAEGE.hAAAXGDGMICGGFEBhABAWADE....fCGA.cABAhAHA....hAIA...,1,-19,-39,20
NGfJcbSTBYaQHFgLEeRDZCUdIAXKOWMVP,XFCHKACCMDCE.....VAAGGDEHJDAG.bECHBFEH.QCFAhAAAFHGCLAAHhAFAeADERAGFCFHEdGAEAGABPEBBhAGAfGFH..SFFGYHFG..hAIAaAHF.....hBAA...,1,-11,-14,3
aNBWRYXEFJfePgcTUOADMLQGVdSCbIHZK,DIAGLHDCQCBAdFAASEGA.CCDC.HCFEZACAKEEHBHCEhAAA.WGFERCFG.XAGEhABAJAAH..fAGFhABAgFAF.TADHADEBMADEbEECIHHHhBIAaCAB..EHEEeCCDhCHA..,2,-23,-12,11
AWfJdSFCMPeQGZRbOLEDIVBXUNgaYHcKT,JDDHSGGH.CGAB.MFFG.eHBGQBCGRBAELCFEDAHHBDGChAAAUGGF.aFFDHADHhAAAKEACAGCFdAGBGEDCODAHhABAEAFFIDGB..XBAC.hACANCIA......hADA...,1,-10,-19,9
MfcKCUZPESIRNLGBTWXHVDeJOFgdQYAab,aGEDMDEG.KAAGCBDGZBED..EGGGRAAD.LHCAGEBFBEGH..hAAAXAFCDHCA.OCDHhAAAdAHAAEAB.bDABfGHGhACA..PGCGSGABIHAGhACA.WEFE..hADA...,2,-30,-29,1
dCGbLNFVAUfOBYMRQSeHaJcPXWKIETZgD,OHEEBFEFRFCD..eACEHDFC.JFBH..XCCEKAFFEABFZDAGDHAGdGFHhAAAGECFLBGBhABAFAHDACCA....fADEhAAAMBIFaBBAWHFA.....IFAFhAFACHHB...hABA...,1,-19,-23,4
eMCDPZRLbYIfAXKJQgaWNOFUHGSTVBEcd,XCCCJCDB..QABEaDFH.OHDAFFAFUGCEGEGEhAAATACCEFAC..eAFBhABADIFCRBEGLAHF.hAAAIDBGKEHFWBAF.SGGGBEFEcGADhAEACAHB.....hABA...,2,-28,-8,20
dWKBgDbFEeSNCGUOXZYRfVTILacQMAHPJ,JBEBdDFHBGGC.DGFBEGGE..eBECCEHBGGBFUCAF.ZCBH.RAGH..hAAA.VFAGLAAFhACAQABDMEABACIBHEDHhABAKFEC............hADA......hAEA...,1,-25,-29,4
CQWUBLcfdVPaeJZTMDNFAYSEIGXgRHObK,SDDAEEBFGAECRFFGHFFG.OBHFKBAGCEHE.UABDBHFHLEBBhAAAdGDA.aHDGJCDHZADBDBIDhAAAFAGG.AFBD..IDGFhACAXAGF.........hBAA......hBFA...,1,-10,-32,22
WUGTdeMAbVZJIRYNaCEDPSXfBKcgHQOFL,VGFGJAFA..REFG...aCCCEDDB..DGAESACEBAFAKBAEHCFEhAAAOCEALHBGhABA.UADGdFBFeAAHhAAAAFIDZEEE.IDHACCAD.fGGG.hACAgCBFFAHD.hAHA...,1,-12,-26,14
CAeXIUcPdZOERfJYDQWSbVNBGaKTHMLFg,eGFGXBCHUGCGdGFHZAAC..OAGDEDAFRCEA...JDEBDEHBQDGBhAAA.SABDhACANACDBAGHKBHBMADGhAIAFECEAIACIECF.PFBH.fBEHhBAA...hABA...,2,-32,-12,20
AMcPQfSEYVDOGJCIReWdZFbXaBTHLKNgU,MFBFQAED.EBAHDFHFGBGECAGGRDED.dEEBZACCFDCG..XBAGhAAABHGGTFCE.hABAKHAAUDCAAFIH.fDAChADASDAHOHCGeAAEaAGALAHHhAEA.NEIG...cGGFhADA..,2,-26,-2,24
KJgWSebZAYNdDETaCHFULQBIXPOcMfGVR,dEFBDEBFECAEaGAH..HFCEFEDALAEFBHGH..ICFFOGECMDABhAAAGCAE.KCCBJCFAhABASAAFeHAEAHIB.hACANCIC.TEGECADD.XABAfGFA.hAGARAFE......hAHA...,1,-8,-20,12
WLJHeBOSaGfFPNMIcRQKdTEUDAbXCVZYg,XDGBVADE.ZCCH....gGCELGBGJFGFeBHDBAAEhACAaCBCFFGGMEIBIABHhAAARAEEKEAD..ECEHACCAbDEFhADACDAB....WHAGOHAC.fGHAhAGA...hADA...,2,-27,-7,20
ETORceHgLBKWPUXMYaJDAZVCfFIQdGSbN,CFBGFBFBdGEEGEEG..SAAFEEAERBBBHBGFBEHEKADC.UCEAMIBGhAAA..JADGDGHFAHGC.ZGAEhABA...IEDChACANDDC.OEHFeHAG..LBBB.hAGAXAGA.aGGAhACAfBDE.,2,-30,1,31
GOIPaLVgDTZFKNbHRBAMSEYCQeXfWUJdc,SEBDEEAD.CBDD.eFDH.XCEAUGEBdDECOAAD.hAAAIHABPCHBaACBhABALFHFDDDF.ZFEBKHBEhAEAbAGFBCFEABEEMADFfAEFWECC...hAAA......hACA...,2,-32,-13,19
WBgDYHFOJVXeAGfCaMEbZKdRSQTNULcIP,CHGGMFCGZAEG.KGCGdGDE..RBEC.QEADUBADLFAB..IBADhAAABHFGDCIHHDCGhABAODCCJDHH..XGADhACAAAHHGEGEEFGDSBDC.NAAD.WADFhAFA.....hAFA...,1,-14,-30,16
VbMQLWYDIKPfcaeFCgZUAREOBGNJTHXSd,EBAFBEHFGGDFJDEH.HEBAdCGD.MDBCLCBDDAHBKAFF....hAAAPFCFfEGFhABAeADE.CGAH.ZAACAAID.OGFEhABATDEE.SGGE....hACA......hADA...,1,-14,-34,20
OgcXNKYMHLQeGfbFDRdCVJAPWUTISEZBa,UDDBSFCGBBEB.OFFB..XCGGKAECMDBHLGAChAAAQAGAeADDbDEADIAEhABA.dBBG.CEHBAGIFPACBhAAA..IGGDaGHHNDIA...YAEChACA..fCEFhABA,2,-43,-15,28
aAJPZcGbDLFTMYSXIOQeBVfKdUCERgHWN,JHFAZCDAGDBGLCFDMBDG..SCGHXFFD.QCCFhAAAeEEHBGAGKDAHCDABEBAAhAAAgGBDHBGHNIBB.aBBGhABAAIHC.....PADADAFEYDHBhABAIAHD.fEHAhACA..,2,-12,-9,3
aHZOWKMIcgFEQAXTDGYdeLBPRfbSNVCUJ,XFEGTCFH.GBDBdFBBBDBC.RAAE.fDGG.SHBEhAAANADDCHBD.aFAChABAZEEAOBCHMHEG.IAHAhACA.gDADEHCEAIGCDFID.eGFAhADAbAFE......hAEA...,1,-16,-25,9
SFQeZOJLdBcCARKHIDYPVbNgMUfEXTWGa,HBGBDEFG.VEBB..NDBG.UFGG.EAEGTGDEGCBB.SABAhAAAQAECOFEHhABAJABAdGCGBEEBAGGFICCBhAAA..YHAAbAGF.MCAFfHGHhBAA.aDEG.hACAZEFGCBED..,1,-7,-17,10
GXCWMaDNcQFOBSAYHZgeUfLKTJIVRPEdb,ZBEAeCGDUFFAKBEF...JBCBRDBBEABE.GFDFCGAC..MDEFDEIDQGAHhAAABAAC.hACAABFC.HGBALHDAhADAIAFB...dDAG.XDGAaDDEcAGFhAEASHGA.hAFA...,2,-31,-17,14
OWMfYaSeJINbFLCVPAgXBRHQGEdKcUDZT,BDCHHCEFEGCFKGGFUBFCDIDEZACD...OBAHMFIH...aEBGSGAHhAAAeEHD.JEEHhABANAIC..FGGHLFCDhACACBBHAGBDRAFD.dDAG.TACE...fDHChAEA...hAAA...,2,-30,-14,16
JQZSRYXKWOBbNeTfgGLAEaDPFMVCIUHcd,aEHBDCHDMAIB..IHCGHDBDdFECQACCZBBARFGD.KDFEBFAAhAAAeEEBTAFBGEAGhAAAACAFFHAECHHDUAEA.SCBGhABA.YAHHWFDD..OABGhAFA....hAHA...,1,-6,-21,15
gXJQbPSNEGDKdRcBWALVHYafUZOFMTIeC,HADGaHCEZBBGMABE.eBCDCFDB...JAHHQFBC.SBAFhAAAEEEGGGABdAHAhABABGGEAFGELDEChACAfAAEFGHDTAFFXCEANEACKDBAWHDAYFFFhADA....hAEA...,1,-9,-12,3
XGHTYDcgfWORMZSCJNabIPAeQFdKEUBLV,FDBHdCGCEFECUDFCBAAGLADBGDAC.HAEHDCBE.....gCCBhABAOGBAMCAFhAAACHDEaHFE...IACFhAEAAAGBKHGGXAGH......hABAYFHH.WAHBhAGASGGE.,2,-38,-12,26
gFPfWRIMKDeVAaGECYXBQJOcbTZNUSLdH,aEFGGEAB.EFFGXFDDBHBD..JDCAOAAA..bABGZAFEhAEA.SECFhAFALAGBdHFFgGGDhAGAFDHD.PBDDfCAGICHBDAIFAGEHCBBDYHAAhAHAQAEC..hAAA...,1,-10,-18,8
JIAdQVKODbfaULSWRgPNeBEXZCMTFHGYc,VADGKGGDOFAE..DDIB..aAEELGCCRCEH..NBBC.eCBBhAAABDHA..EABBCHCHFAHDhAAAGDDB.JAHDAEDBdACAhABAfHGH.SDAD.hAEAgGAD.hAFA...,1,-16,-39,23
VcNYdPSEfTeLHBGWAZDQFKOgCaJIbMXRU,ZDEDFBCEKHEACAEC....aGGBJFGH..MGAERFBD..UDFD..hAAANAIC.dDAA..EDCBeBHBhABABFHEAAGC.QAAFhABA.IHAEbDDH...XAFDhADAcAEA.SDDBhAHAfABF,2,-39,-39,0
QTAeEFJVbRBOgSIfcUNCdXPDaZGHWMYKL,eDBCFBGE..JDECVEFCBCCC..OFCB..SFCFhAAA..cBGDhAAACADBdHGHDCAFaBDCHFDB.hABAMDAHKFFFLDHBADIDEABH.bDBGIHAEhABA.fGHChADAXGAD..,1,-5,-44,39
GabLXFATSZIeNCYHRKDEWgJQdfUOMVPBc,TEGGZBADeDDD.CEHG.HGCA.RCBFKABDDBAHEGAD....WBFDhAAAQGFB.fCGHhAAAMBIDBHHBaAFAhABAXGADACEG.NACHgAGFdGCA.hACAODEHcEEA..hADA...,1,-10,-30,20
XQAbFgZCPGfKVcLMaWUETDRJONeHYIdSB,FHEEZEEDCDDFGAEH.KDCDLAFF.MDAHUACGDDHFJDDC..hAAAeAACHDGFdHGHBCHBhABAABHB...PHAAhAFAfCBH.aHAGWFCAEEBF.....hAAA......hAEA...,1,-24,-36,12
PgAWEdCTXZQbSLfVRJcIGNMBOUHKFYeDa,EGGATBBGZBEH..QBAASFBALHAGRGFC..JBECIBGBhAAAGDEBBHDDhAAAODCDKEAFFGAAeDBAaGFBAAFGhABAdBACCEHA.fHAD..NCEC.MAIBhABA......hACA...,1,-10,-12,2
ZCVYUAMDLFTbWcegQKSXIdNHPBJGORfaE,LEFGFDBG.TFDFbFGH...eDCHQCFHKCAC.SGABhAAAdAFEPBHBJFBAhABAOHAAaHCCZBBCCADAUGGEhAAAAGFAMAEG.DCAFWDAD...XCEChABANAIABEFA...fABFhAHA,1,-4,-25,21
NcLDReBdgMfWSPQVGIAaOCYbKHUJTEFZX,aGDDCADBKAFFHABA.UGACEABD.ZDDE....XFEBLFHDeDCAhAAABGFDdDGHMCFGSHDGhACAQDAAIGAChAGAAAHH..YADCTGGF....hAAA......hABA...,1,-20,-29,9
aZAFLSOHePXIUECMGKWNfcVYJdgQDbRBT,FCCHLACBOBFEeAAB...XFGHEGDD.CEFBGFCFhABAKFHHfGFGVBEAJFAHQFAEhAAADDIF.bEEGhABABAECZABG.ADEH.SHAG.IDFBhACAMICE....hADA.WAFE.,2,-14,-11,3
cHdCXELfaPYVSbRKAWMITJUGZOQNgDFeB,MAEHJEDEGBCHZFFB..QBABDGAEBABFHGFEdFCGCAGC.LAHHhAAAaEGA...PDAAhADASFEF.RDACAAAGhACAIHBFTBGFNAFCeAEG.EGDA...hADA......hAIA...,2,-20,-13,7
CHdLZbFABWNMRUIfgOGQPcSEDYJVTeaXK,BFDGMFDERGAGUADB....IAGFOHFAQAABhABA.SBHBhAEADCABVCCCTCGDaGBD.XGEHhAAAKBGFdEHCZDEHAGEDNBAH...fCCEhAGA..gGGEhABA.,1,-18,-36,18
gLIObTRVfNUCPXdSFGHKADMQJZaYWEceB,DEGCJGACZDEE..aGDF..EDCDBBFHLCABOEFHRFFG...VCBGhAAAUAEG.CAAAdAHGSAHFhABA.GEAGhACAADDAQGDC..cAEG.IHGChADA...hAAA...,2,-31,-28,3
eWEBRadfOPUFMKNHgAXcVDCQIGLTSZYJb,XEAEDCAFCDGG.GAEALCFFZCCF..JHAAeBBH.BFBDREGDdCAAhAAAOFHFFABC.KBHB.hADAHEDBABGEQGEChAEA.SAGEWFADfHFH.hBAAMABE....hAAA.cDCG.,1,-4,-30,26
QENaMOLPGBXIZbAJedcFWYDHTCfRgSKUV,dBEAFGBDDGEFHDEG.CGBFRBAAKAFF..UAGHQCBD..NEIG.MAHBhAAALHDEBGACXEFGhABAZEACADDD.eABChAGA....WAACfHGBSHAAhAEAaCECOEBC..hAIA...,1,-20,-35,15
TYIODFBRdHgbAKLPaEVJcUXSfCMQNWZGe,KEAFLAABEBDH.JHBCUAAB..SEFCMIEC.QDCAhACAZGDETEEDOEAHhADABDEFHBGFACCDaGFAVBFChAEAfGBFCHFB.NADH...WACA...hABA......hAIA...,2,-26,-12,14
TGgdcOIPDQBURFWYKHXSLeMACfVbZNEJa,CHBFVAEA..ZBFHEDDAJEBC..GEFEdFGF.OABBDIDGBADCFCCGKDGChAAA.HEAELBBGhAAAAADC..NEIAaHAE.hABA.gAGB...IHHGhACA.....hACA...,2,-45,-14,31
WQARPDKIXNJCfYHZMBbSVeUaFcTOdLgEG,DBHBKDBE...XECEJFAA..CEHAHDEGMDAABBEB.SAAHhAAAeACAFFDATGGDhAAAdFFBLHAG.EHEChACAQAGFAGCD.IHDBNAGEfCEGhADA.YEAEhAEAbBCEaABB.cGGD.,1,-17,-22,5
BLCgMNTPeSHGaWEOVUZJFfRAbdYIXKQDc,dCBFXECFQFBGBHBBLBAHMACG..TBGGSHDGhAAAaGED.OCDEUGGBFEFGhAAAREGFAAFD.ICEHhABADEFDcACBCDBH..NBBH.HAGHEGDF.....hAGA......hAHA...,1,-11,-15,4
aeIXMOERLFZGJVQcYSUAKbfPWDdCBgTHN,KECC..fFBEDDHFCFAB.BACGHFDDaGEGeACF..IAGGhAAAOAGHEHAEFDFAJFHDhABAQGGH.SAAFhACAAAIFPCCBWBEDTBDHMIDE.LEAFhADA...hAEA...,2,-30,-18,12
SWJQEPBDLeYOAbgHKIMGTaRZcNFdUXfCV,HFGHKGGDMEDHaADFRCBBZADG..FFABdCBE.UCGFXFDH.CABG.SFAHhAAA.JEHHhABAPBHF.BCAFhAAADDAHLEEHYDFDAIAE......hACA......hAFA...,1,-25,-32,7
IHUGEYgBcbPOSZFdfVMRTWeKLNDCQXaAJ,HFDCEFBEBFHA..PBEAOFEHZBBHFACAdEAG.MAIFRAFF.eHFChAAAKAADDGGD..CCABXGAEhABAaEEA.JEFAUCBGhABA...YCHD....hAFA......hAHA...,1,-11,-37,26
OSdWNGeZcKDfITPAbRQLUBCFHXYEJVaMg,QDAFUFBFFFGEHBCDEAGF....aDEHMBBBODHDdFFGGAEFhAAAZDFHKACFDFCF..fCHEhABAIHHFPFABhAAAbFDDBACC.XCEHJHCEgBDChABA..NEAA....hADA...,2,-16,-4,12
cUJeBSAfDVCdRYaHbXTGFIMgKQNWEZOLP,VBBEdBCCaECF..HGFA..TFEBGDAGMCFGKHCGQAEAhAAA.EEGALAFGhAAAUEDFBCHDSEHFhABAAIAECAGA.YHAE.FCAF.gEAGhACAWBAF...hABA...,1,-13,-16,3
cgdeSXWKNBATVDOULfMaFYCHZERPIQJGb,DHDGLBFBMCAB.FCAGHCFGREBC..QGFHJABDGDBC..bABAhAAAdFED.XAGAhAAAKHCEAAHEOBHFaDDC.CHBGECEHhABAIBED.cGAHSFGEBHHA..hACA......hADA...,1,-12,-16,4
PgKDdLXUMYRAIZHEGacWFOSeVfQBCTNJb,HCDGaEDH.FAHDOBCHSFBE.eADGVAEHBFFDCFEB.JDHB.hAAA.PEAHKBBEDCAHdHFBhABAUGAFMCHH.ABHCEHAChACA....WHDA......hAAA......hABA...,2,-31,-23,8
BdIKMQeSHEUDfFRVYgXcLZbCOaAJTWNGP,TCGCGAECBGAE.dGEDMECBQDCGSEGDHAADUEDChAAADAIBFDGH..YACAhABAXDAGZFAHCHCAAHIHNEIGKCCChAEAeCHB.EACGfAGA...hAAA......hAEA...,2,-13,-10,3
DIVSPKYCgEeXHcMANFbfdQLOBTZUaWJGR,FDDHdBAFOBFGBBCDZADFUECB..JCAHDFIF....SHFAhAAAKDGDCCHH..EADDHDGDhABAADDF...bDBDQFFBhAAALAFGTFEHaHCC..WFABhABAIHCB...hACA...,1,-22,-44,22
VIAeOZRLBcMWGNgbaPHfUFYEXTdCKSQJD,OCDEZFDEBDBF.MAAHGAAF...bBGD.HFECUGAEEFAEdAHAhABAKGCBJDFG.DEIDAEECeHFAhAAALEAG..NADF.hABAaHGG..fDCEXBCB..CCEF..hAIA......hBFA...,1,-9,-32,23
MDdgGWTUXbLRIeQEZfYaJFOBHSVPCKAcN,MAIDDCCAGEGEUFEBLAGDeFEDZEAH...aEDBJDDG.BBACSFHBhAAA.VADDhABACAGDAFAHdAHE..TCAChACAbFCD.RFAD...ECBD.FADEOHEC.hAAA......hABA...,1,-8,-23,15
VOSXgFbEDLKQfeYIBRNaAWcTUMdPCGHZJ,TEBEdACDGDDH.ZBAFJEFFOGCE..SCADFCGADGBFKAGAhAAAfABG.hABAIDDEBAFCaGGCWAHFhAAAMDAB..CAFDXGCHEFGGeCCANIEDAIGEPEHBhACA.gBDEhADA.,2,-37,-11,26
gLHRZOdXBTQIFYbSDaKfNMJPWGUCAEeVc,EGDEVCBALCDF.RAFF.ODGHdBAGBHCFTAAAFEBF...SBGGhAAADIEGKFFBMEEEhAAAJFAD....PFEFhACA..WFADCBEBADHHeAFE...cECDhADA....hAEA...,2,-33,-28,5
SGYfQaXJgVKTWZLIDeROcbBAMECNPHdFU,CFFCHCFFUBCBGCBC.QFDGJAEA.KAEEZDBCDBAFRFCD.OHFAhAAABGGD.ACHF..MBBAhABAECFB.dHAFFAAGSBGEhACA..aFHF...XBGEhADA......hAHA...,2,-43,-5,38
PgFYfQXOdeUAZCTIJVRDWNEHcBbaSLMGK,CCEGTAFF..JEEBRFFGDBAG..EBGABFDF..SBCHhAAALEAFMCFFKHFEFAEFfBCFhAAAQGAAdDHChABAAABG.ICABVDGDHDAAaHCE.....hACA......hADA...,1,-23,-27,4
dPRISgMKeVCJTZHabNXDLFBYGAOWUcfEQ,OEHDUFAGECDCdAAF.RFAD...SACHMCGDKCDF.eFHB.JBAFhAAAZFCFHFEBaHFE.NAIC.LAEAhADABFDE.AFFH.fAEDhABA.ICGECDBG...hAFA......hAGA...,2,-30,-13,17
cgCAXYOUbLeFHVQSJITBEGPZDaWNdfRKM,OAEAUFEFeAHBHEFE.QFBFJEAA.TAAHBCDDGAFEhAAAZBDADEEB.aABCdBHCKFAFMCCHhAAA.CGHEAHEG..XADFhACAYHEGLFHHSDDC.ECABhACANIAB......hADA...,1,-2,-21,19
TCdGNeMgVJIHXacBFZPRQAKODbUESfYLW,OECBDHEEUECB..SBBCLAEFCBFB..GBGE.MEDGhAAAJBCFHGAEaHGCBBEHhABAFBADZDGFRFDEAHHEKHAA.bCAGhACAEAGG....fFAAWAAC..hADA..NIEH....hAEA...,1,-17,-27,10
fKQbLDaVAETFIgOJBWYSCMZdGUHNPceRX,EEGCFBDHOFBGBEBG..SEDEMFFDZAGFGDEFUGCFHACG.hAAA..PCECeBBHfGGHhABAKHGGQAGBhAAADACAABGHIBADJFAHCAEH.NDACXFGEhABA.aCCB....hACA...,1,-10,-15,5
RQJAXPTCSYbGOHBFNWDcfMdgEULZIVeaK,XDCBCAAE..bFEHOHCE.FCADDDAF.MFBEdFFGEAFBUBGGhACALBAEZDDA.eCHFhAAAKBCARGAAAAGC..PEBDhABATGGD..SHGA...hADA......hAEA...,1,-13,-32,19
GXfOIBUMeVHRSTYWQJZEaFdCDLgNPcbKA,XADGOAAFBGADUDDF..eAFCRFCA.SGGD..hAAAYAGHJECHZBECFEHFhACAdAAADDIDLEEH.hACANIBH.cGGE.ACCBfEAFMDCE.hADA......hAEA...,2,-29,-22,7
FSLcaOZKRYEfPIgWJDQUBVMdAeGNXCHTb,eHEEXCFECGBB.HEEEFADFLBHD..OCDHKBAHRBEH.fBEBhAAA.IHBGhABAgFFEDCBBQGGGhACABCCDdFACAEEH.NCCASADChAGAaAAG.YAHH.hAFAEGEDWHAA.,2,-26,-2,24
fDOaCdgXVJHbBZKRNQUScTLEeMFYIPAWG,GEBFOABGdFFF..XAFHJFAE.BGFBKHDGRBEEUBCC.TBAFhAAAEBCA..FHBGPFABhABAADED..DEGCCHHHHEGDhACA.NIBFSDAGeBBDMAADIHHHhAFA..aCGE.hAGA...,1,-1,-37,36
gFQHfJaBARGKUedMTPcZVLDCESWNXIOYb,RAAEKFCCdGAEMHEE..TEBEZAEADFFE..EDAC..SCCBhAAA..WFEBNDAE.hABAIAHAODHF.bADHhAAAQCEBHEGFaGCDAEIBeABF...PHAEhADAcAFHCDBH.XDEEhACA.,2,-24,-19,5
WGSZfKFdHeXNQBgLIRYAECUJVTMOcPabD,CEHBJHAE..MBBEOCDG..aGAADEGFGEEAZEEF.FDDGdDBGeAFAhAAAQAAABGDDLCAFhABA..YAEAhAAA..EBHFTCGB...PEHFhADASCEEfFDEhAGAKHGG,1,-29,-39,10
STNZacMXIDfJBFOURYCVKAbPEdeWLQgHG,EACFdBGGeBADLFDAHBCAGCDH.SHGCNEDBZFBD.MIAChAAADIEABGADFFAD.RFGFCFFFKDHHhABAAAED.PAEC.QCAChACAaAAF..XFDD..hACA......hADA...,1,-2,-23,21
aGXCeRLHAfbSDMcBUZgFYdTNKOEQWVIPJ,SCADDHGCBDEGZBACFCFF..dFDAKCBA.EECDQAFG.hAAA.IFHHaDBCCHAGLFFEhAAAfAGDMIEEhABAUABB.TFADODAHPHCEJBHB.eEDEhACAAGGC.gGGGhAEANBBB..,1,-7,-27,20
UZSQdOCKRJXaHePGNALfYTDgEbMBVFIcW,LAFATBAB.EHFCMCGBBHEC..VFGFFDBF....IBBHhAAAUFADSCEFhAAAdCGDCGABREEA.aDCFHADFeFEHhABANBAG.YBFC.DADD.....hABA......hACA...,2,-24,-10,14
KcUXaHVbedJMPLEYGNDOSQWfIBTgFRZAC,CAFHUDCHHECCeEHDdDBD..MCADEACFGBDF.OGBESHDAhAAAQGFGIEHChABABAFETFADFAAFAEIHKAHHhACAXBCEaEAD.JAHH.LDGD.DGIDhACA.fGCChADAgDFF..,2,-16,-3,13
PLGQMWYgdaZIBcfXDbOKFUNTEReSVJCAH,HDFEGEEEMCFG..gCCGaBDBBAAD..XFFCOCFCFFAFhAAAUGAFEBAHRDACeFDFhABASGHHCHHFLAFAhACAYAEC.dHCB.IBDB.DFCG.hADA....KABC.hAEA...,2,-8,-4,4
cMgDVdUJaAXRefEYOWPKICHNZSTLbQFBG,XFEDRDFBeFBB..EFDBOBEE.KABDCABBZBEELGAGFGHBGDAHhAAAMIBADEGA.dDBDaFAHhADAAADG....fFADhAAAYHDGIDHFSGGE...hAEA......hAFA...,2,-27,-21,6
eEgVRbNGQTPCfcdXMAZDLHKUBYWaFIJSO,ZADDDDIFKEFHBCFF...aEFAJDDE..SABEeDAF.EFFFRFBEGACHhAAA.QBAHhABA.CHHEdHAHhACAADIHHGAG.WBBHIHEEgBGH.hADANEEEfAAEhAGAMBHB...,2,-44,-19,25
YcBKLVPaIfGAeWNbJXCMOZRFSDTgEdHUQ,eHCE..bDCFJBADCHGDZCFBRDBH..DFGFECADHAFF..QFGEhAAABFDHKDFFLBHHhAAAaBBAfAFHAIGC.WECDhABAMABG.OFABSFED..dFHGhAFAYBHBcCCA.IFAHhACA,2,-24,-10,14
OZGATaDIQRfCgcULMNYVSJPEKBHeFXbdW,aBAHQBDE.CFGF.UGCBLFCEMGFC..VBFFJHBGKGHDBEFDhAAAFABHdGAGZDAGGDAFhABADBHD.RBBE...fFAAhAAA.NAIE.SHFG..hACAEHEC.....hADA.eAFEWADC,1,-8,-21,13
VTaOCUGMQcRELIbPgdZYeBWKNFJHSAfDX,XAGCTEBC..CGCHGADCQCBGEHGC.LFDH.IBDFhAAAgEFDdFFHeDEChABABDABKAGHNCIAJFAAAIDGDCIDhAAAaHAA...MFAB.RABH.....hABA......hADA...,1,-5,-20,15
CLgDaSZfIRQJcUVOBHKbTeNWXdEPGAMYF,FBBDCHBFDADAZAED.REAF...QFCBUGGEBEEFKCBB...TAFHhAAAeAAF...XABGhACAEDGBAHDHLGCChAAA..SGGDJAHB.VDEA.OHCEhAHA.NAIGdFHC.hACA...,2,-32,-15,17
YaODLQGCcENgBHMTXJKVfFeUAbZPIdWRS,ZFDCdDGERCDBSCFC..aBAADFFAQGADGCADEAADBDAEhAAAMBIHJFDH..fGBAhABAFGGDAFBA.IFAAhACAOAEACFFG..NAEFTACE.KHDCeACGhABA.....hBFA...,1,-20,-26,6
cVZQRKJdPUELfAegOIMTCFSWaHbYNDGBX,OCBBTDCH.FGEG..aAAGHAFG..bGAGDFCG.GCEHBFGHXBCChADAVABEZGAEKHFGhAAAJBGFdFCD.EAEBAAEEeEEGhABAMFIHCFAB...SGFGNEIC..hAFA......hAGA...,1,-5,-17,12
AXVSBgaQRLGHJfYPEeUMCNbcFTWIOdDZK,VCDCSGGD.BDHCQAGGGAACJFDB..fEFHhAAAEBGHUGAB.CHHANCBEFDCH.hABA.TFGCOAFGDCIHhACAAAABaAEHRGBEHABG.YCCFeFFEMADH.hAEA......hAFA...,1,-6,-11,5
HRUJIEOgXWbDBASZdVaCLcTGKFYPeMNfQ,dCFFCGGALDEBGAABFGDD..eCHFMBFGQBCFHFACRFFD.ICAAhAAAEDDGODACXFCHhABADCIHAHFD.ZFAB.VAFGhACAaHAC.....KDBGNADB.....hAAA......hABA...,2,-10,-7,3
BNdbGgCQZDaVcUWIYeMPKALHEFOXfRJST,EAFFXACBRFEC..SCBABGAGdEFEGBDECEEH.DBFCaBAGUGCBhAAA..IDHDhAAAeHFCMFAAAFAEFHBGfBABhABANAEE..gBGCZDGH.WHFAhABA...YFAGhACA.,2,-39,-13,26
QbHAdIYZPUFXWSaTLGOVEecBRDJgfKMCN,dGGDZGFCUBEAFCAA..SCGBLGACOCBB..eBBEhAAABEGEDFEG.JFBCKABCMIBEhABACBHH..QDCHhAAAAFHH.IHBBPADAXCEHhACA.WGBGaAFA...hAEA...,1,-30,-36,6
JTRcCXAOGPUaWSLNHYKdeVbDBMZFEfIgQ,GEAGUBEC.aCBESCBGHAEFKFFEdEHAeGFADEDABABA.ZEABFHDEhAAA.EABA..fGCBhAAAIAHE.QEEChABA.RAGHCADFXBAGAIAEOCHD..hAFA.WHFA...hABA...,2,-22,-12,10
cEaMUDKAHPJLIWbBRdVNOZYQFgXTGeSCf,JEHFLDCG...IAGBbACG.dBDGVCDFZAADFEGD..hAAAXBGGTFABSGEHhADACDAEEFAE.aHCGhAEADAABKCFEAGEGHFCFBHHBNAIG..QGFDhABA.....hAFA...,1,-15,-18,3
bSDNOLeXFZAQYgHGPUfcRaVBWEJKCIdMT,QEDGHDCAUGAAREGFBBBD.EGEFKBCGdACDMAFC..TDFChAAASGDGOAFBLBFGhAAAeDADFAGAZBADAHID..hABA..gGGF.fCGBhABA.aDCHWHDA.hADACADB...,1,-13,-18,5
BHATdWDQKEPbFXLCJNVOYMSGgcfaIUReZ,TFBDdACCDBECKCDB..EFFFFGDCLHAG.JDEDOFFG.hAAAMICAgDAAhABA.fBCFhACAIBABUCGDeEHDBBHDAFDAQFAG..hAAA...XAGBhABANADDSDDFaGHD,1,-7,-30,23
LOYdfXGHCUQZIERgFJWKSeDbANBPVMaTc,BGHFVEAC.MBCB..TFGBOGDAdBDAGBEDHAADUGDDZDAHRDFCFHBGhAAAKAGFDCIF.AACE.aDDHhABA.LAFCXDEEhAAACHFH.IHAFEACE.....WAEBhAHA......hAIA...,1,-9,-20,11
WfQZOKDFEUBYbHPaITCNeVJcXRgGSLdAM,MAABQEBBKFBF.DBGAEAFCBADH.HCECaGFE.CABG...eEEGhABAJHFG.XBCAREEF.hAAASDDDAAHGZGAG.hACAFDGE.UGDGYCCEICFCNCIC.cDAGhACALDADfHBHhADA..,1,-11,-19,8
BTGKWHRIYCUPXAfdJMcaNOVQLbZDgSEFe,dFCFMBEHaFGG..VCFDLABH.DAGGEEAEBHHDKGACHAAB.hAAARFGFCADCUGDF.ABBHJADHhAEAOAFAZAFA.FHCEeDEChBAA..WCHB.IDCG...hCAA......hCFA...,2,-28,-14,14
IJPYdQcVGHDAZEXMLCgBFeORKNbSTWUfa,EEFFMFBGLBBABHACFAFHOFEH.KCGBSGHD.UBBGhAAAfDBE.hABAIFAGPDHFdGFChACAQGGE.cCDD....hAAA.HGAGDCEFAAGC.CHDCeBGHhADANAEF,1,-28,-34,6
UNWSIROcYHBLaPbgFeZdKEXMTGJQAVfDC,VGCCDCGEUCBG..SCCGRFBE.ODFFHDFFaAFE..hAAAPACAFGHHZABAKBEBMEAFhACAGAGGAEHC.fGHEhAAACEDH.IGAG.BBAC.hADA......hAEA...,1,-18,-30,12
fbKBYEdQIXegMROcVLWFHPUCTZJSAGNaD,aABADFCCKGDABBBF..EAEFQGBB.eDFERCAAVBFDLEEDhAAAFGAH.HAECUFGBTFFGhAEAZAAC.SCDFhAFAADEH.NCCC.....fEAGhABAdAHAIHHFMICG..hACA...,1,7,-33,40
KcHWaUTbEdMVOBJYAFPfNXSGIeQCgRZLD,FEDB..fDAGSBDBGFBBeABHQAFFCHEDZCFHKAGCHABEhAAAaCFEUFFHEDCAdGGHMDCBhAAABBHAAEAB..NIBD.IEEBhABA.........hABA......hADA...,2,-24,-8,16
XDCEOZTGbAeFUWQSaMLJPfVcRHgYBKNId,FDDAUDCGQGFGMEBFLBAE..fGBARGFCHAEFBEGGhAAAKCBCdBGACHBHZAGDGEBHhAAAAFFF.SAEBhABA.aEHD.PABC..cCAG.hAGA......hAHA...,1,-16,-24,8
DKTVfMJZWSgaLABXYcRFCNeHOQUGPbIEd,BHDCXBBFRAABFFDG..CAHCHDFAUFAG.GECC...IDAChAAADFGETCDBMABEZADChAAASHFCLAGHAIGGhACAcAFH.OFFE.QGAHhAGAEGGA.KDDE...hAEA...,2,-35,5,40
eACEOMKURNGIJYgTHfcWBXLPDVSQdabZF,EGBEODGDUDDBRGCAGBBD..JBEC..TFABHEFBfCBEhAAABGGDLACCDACB.hABASFDCaEAC.hADAFDEGAHHEMIACKAHBNBAA.IEHD.cGDAhAEA...WAHHhAFA...,2,-33,-14,19
YAKFQILeRfMZEUHPbNSTgDOcBdCWJaXGV,FFDGQDGGeEBFRAEH.MBCEZAGH.HGEE...NIAH.SBBEhAAA.TGFCDABGOBEEhAAAdDEDCEHE.WCCHaBAH.hABA..XFAG......hAEA...YBBFhAFAAAID..,2,-28,-13,15
aTfVEMRdeKBWQFXLUIJbGcgZNOPSYHDCA,aBCFVFDB..REDHdHDHBABH.FDEGUDAC..JADGGBGE.ZAEBhAAAOBEESFGAhABADBABACDD.EGBD..eDAFhAAA.QGGAIHHH.....cCGEhABA...PHAChADACHAD,1,-24,-41,17
MXOFNfACQdWBKTUHbIJDgYZeRSEVcaLGP,dEFHKAHDUFBHHEADJDDD..DBEFZABHRBAH.EHDG....VEEBaBDELAEEhAAA.MCIDhADAFAEAAHHE.CHFABEHFhAAAIHHE....eCFGcGEF..hAIAXDCCfCGAhBAA...,1,-22,-40,18
XYLBZgWFTQROGfPMVASKeUDHEdabCNcJI,SAAGeDCBDFBHHABEdDHC..CCFF.JEFB..XGDDBHBHZBDEFDCAhABAQCGARFFF.hACAOFDDfEBBhADAPHFCVFAB.AAEAKBDEaADA..NAAE.IHHEhAGA.....hABA...,1,-12,-20,8
PLNEeJBSgVGbKaMXDHTAOQcRWIZfYdFCU,QFACRDBEZFGHdBFD.FDGDCCAE.LDEH.EGHBBCCB.SFAEhAAAGAAFKDCAMADAhABADHCAADAH.OCFG.hACAIAGCfFEB.PCHFNIDD.gGDGhAHA..hAIA.aGBH.,1,-13,-40,27
YMPdDHFOcZVKLJEBCSTfQAeUNgIWbaXGR,UBCF..NGBH...IGCGaHFARAFA.MAHDDBBEFEDC.ZCABKDDFhAAALDCEJEGH.BEHGhAAASABE.hABATEADAGIFeHDGgFED.bAEFXADFhACA...hAIA...,2,-41,-23,18
aZYeIDMCXcOURNFJgLWVSdAPBfTHQKGbE,BAFDTBEBKBAE.GCFCEDCDZGFG..eAHBMCHF..CHDFOFCBhAAANABA..JHBALCCGhABASEAGAFIHHDADhACAQEECaEEHDADD.XAGA.cACEhAAAFHFC.....hAEA...,2,-18,-13,5
KMdULWTHSYBbXeZVNgQFIPEaOCGJRDfAc,MEFFUACHLGFCHBAESEAGBHAGeEDFZGBG....NAGAFADGhAAAIFBA.aEGGCABBRCDHhAHA.AAIBKHGCdCDHTAFEhAAAXDGH..gBAD.PHFEhABA.ODABDGGC.hBAAfBHC.,1,-6,-13,7
SPTAdWRaBZfYLDcVNHgbEGeCQXIUKFJMO,dDAGaEEAZECALHAG.DHGEVADFHCGF.EGDGGGBD.CABBQGGGhAAAICDGUAGHhAAAKFADFCGCMBBG.PDEDhABAADDBBDAA..fFBC...hADA......hAFA...,1,-11,-22,11
UTBZMRJVaeObHGSgPdCLYFfXDKAEQWNIc,ECACQABB..NBHG.UGBGZDCHMIFARGFCaCDD....OBFHhAAAGACD.SGGEhAAAPCADdBHELFAFhABAFEGCDAFAADCCICFH.BEFB...hACAeEEB....hACA...,2,-19,-16,3
ABVWQabIedNYKHELRZMODXcPTSFJUGCgf,VECEQDBC.aHFAeBBG.dGBAKEFEECADRFCBZACE..MABAhAAADDAD..XBGDhAAATAFHJFHBCHAFADDG.BAHBIBADhABAHGDGOCEC.SFAFhAFAFEEH......hBAA...,1,-9,-19,10
ZgKWaFHNTELcGSCbfMAdBPXRQYIODVJUe,BBEHXEAFRDEG..QDBGOEFHJBCCeABE.ZGDGKBHFFAGGHGBAhAAA.EBABLFAAhAAASEGECCCEMIFGdAGFIDDBhABADCID........hACA......hADA...,1,-22,-23,1
eZFJCPAVDbWHcSGgRKYMQNBEaOXLdUTIf,DAIHHFCGGFDFKBBAMCEABACG..OAAGLCDGdHBDUDFC.hAAA.IHDBZEAEFGHBCDBDhAEAPFADADDE.bDEESHEAhAFA..RAEANBAEEAHDaCCH.fGHAhABA...hAGA...,1,-14,-16,2
dZeBENOAcIMVFGHPbDCQWUTaKLJfRYSgX,MABHFBGHGECFHECEDDIFQCAFUBEBKEAFLHAC.RABESGGAhAAAdHCFBBHEEGAFOAEGhABAAHGE..IFGAhAAA...PACBCEHCaDDAfGEAhADA....hAIA...,2,-28,-14,14
XdOYMgVQeSLaFWKTEHbcZPRUfIABDCNJG,CCGDJFDEdEGD..OEACMFFB...QAEASBFEFAAFKDBFEAGChACAHAAAZACB..RCGFUGGHhBCAAHIFBGHF.DEDC.XADBhAAA.VFCH..aCEH..WCCAhACA...cGAHhAGA..,2,-24,-22,2
ATbCaNYgJDPIeWXBOLMdSKcUGFfHQRVEZ,CGCAaDCA......gEFCJGAADDGCeEFDBACFLABAhAAAdAAGKBFEUCCDFDAB.QEBBhAEAEBFGAHFF.TGGEhAFANCAF...IHAHXEGBMIDCSFDBhACAcBGD...hAGAfAHE.,1,-20,-27,7
XfHdZRTLKGQFVIYUPSEWcNDBbeCaJMgOA,XGDBdEFCRAECLDBAKCHF.FCGE..VCBBUABB..EGHB..hAAA..NCAEBHEHeACGCDFAhABA.aHBE.MAEEAIHCZFABhAAA.TEGCIHFC.SBGChAIADFDB.bEFE....hBAA...,1,-20,-25,5
NDFJAfBGRgTHZLQMCXSaYKUceIdEbWPVO,GBCFRBCAHGFCLCADMABFCGAB.SEEBKFEGUDAD.eABA.dHCDhAAAEGHF..PAGFhABAOAHBNAIC.DDDDAEGCBFBHhACAZGDAaEEAIFDH..WACEFGAH...hAFA......hAGA...,2,-23,4,27
bJEcYIVSCLRXZKGgBFAdDTfOQNaWMePUH,dCEFDCAHOFCHQFDA..aAFGMACDUEFHJDAF...EGHBICDAhAAACBHC.LFDBhABARDFAKHAABBAAFDBBADGCNBDA.hAAAeBBC.....PAHF.cGGChACASGGD.hADA...,1,-24,-30,6
MHKDFXZETWUOaBgVNISQRbCAGJLPcedfY,JEBFLAED.eHCEdEGDMFDBDGAEZDDE..EAAEUDAHBGAD..hACAVFFGSADBhAFA.RBCDAHIDPAHH.hAGAfBAEKEEHFGGHXAFE...hAAA......hABA...,1,-27,-29,2
bDWZNFEVTfeISPaHXGAcQgRCLMUKJYOBd,QGGCCGCDLBFEKGEFJDDD..BEABDEAAZCCDFGDD....VAFBhAAAeEEE...IACHhAAASBBF.aACDhABAXGGFAFFB..cCGDMFAHYABFhAEAdHAH....hAFA...,1,-24,-43,19
XcfJZCHUgebSNTBOYPdKARIQaWVELMDGF,RDDDaAADEEAFLFCF.DBDBXCEF.JCGDZDEH.CHABHDGDhAAAeBCC.SAEEhACABDAFOEHF.dHAFAAIBIGDFhADAQAAFWGFAMIDC.FGGF..fBGAhAHA..hBAA...,1,-11,-33,22
GOAfbgEPLaRUKZYBQNCcSdXIeWTMJVDFH,...bGEGEHDC.LCEFaDGG.KDBGZEBDQFBHCAGCdBFH.IAHBhAAAeABETEEEhAAAMAGHDBDHFBBFOEABhAEA.AIFA.PCHH.UGGCBDDENDACSABBhADA...hAFA...,1,-10,-16,6
cfEMbUdPgDJSHGZAYeKTIFQBNWLRXVOaC,eCCCKDDHFBFCQAGBBCBC.LEGBRDBD.OABCaHEG.fFEGhAAAMIFG.dFAGhABADBIBHFBDZAAEADHBIDEBhADA.WHDGCEADEHAE.UEGH...hAEA......hAFA...,1,-5,-37,32
QYHXOZWIPEgBGDRaKFfSCbcdVATJUNMLe,UBFELBFFeBAFQGCGHGFAZFAB...ICHHEBDFBFCADCCAhAAAKEEDFGHHCDBE.dABDACIF.JEAGhACAMABE..YFFHhAEAOHCE...WDDB.....hAAA......hAFA...,2,-24,-20,4
FGCRcaYMUPOSEXQLbVJDAdHZfKNgeBWTI,dGHCHBCBKEADeHDCBDEFTCFCGDCA..CABERAFE..aABCUEFHOEGBhAAAEFAFLEBHhAAA..JAHHDGIFADCF..hADAfCAE...gGAAhACA.IHEBhADA...,2,-40,-8,32
OHQXIZACLREgaSBNcbVWMdKGYTUJePfDF,CHDHREADEDFD..SBGEBHGH...NEBG.VADF.MIAEGBDHhAAAUAGEeEDF.fHFHhABAODHFXABFhAAAAFHEaEGH..WABAKDDD..TGDADAGGHCAGhACAQFFB.hADA...,2,-23,-12,11
IFZYBWCgXdODfNaSceEQGJULbARMTHVPK,RDFBTDDGHBAAKCHB.ZECBBAGE.CFFBdHFBOAEHDBBA...aGHFeEBBhAAA.EGDHJAFALCCChABAAIAE.MDAFIHEBhAAA.FABA..gDGDfFBChAIASBGG.hBAA...,2,-27,-21,6
CTQAHUJcdKRBWObeYDNVgESXIZMafPGFL,JBBBdHDBRCEHBGFA..OBHD..eEHFDGEA...VGAESCBBhAAAZDCG.MBAAhABAfAEDFFAELBEChACACAABAGDA..UAGCKHAC....WDDF.hACANAEB.EEFCaHGAPADHhBAA...,2,-33,-20,13
QgZAMXJTVYDHFELIKCbRGecSPOfWaUdBN,JEFFTDGC..DAEHFBBCLBGDKFEG.RDAC.eAEF..SAFFhAAAOGACaDBEBHHFhABAQAGHADAA.MIFAhAAAXDDB..YGFGIACACCFDbEAGhABA..PHDChAHA.WAHH.,2,-39,-8,31
WOTEUdVDRINBbJcMHFXgQePfLCZaSKAYG,GADDTADD.UFDGDAGH.RCECBGGD..bFDGMCBGHDEA.FCAEQDABhAAAeAHFLFHFhAAAaAHD.AICCOFAFhABAEHACIABD.NIEH.cDCG..gDGAhADA.CDDDSGAChAEA,1,-4,-19,15
KeYJUXHVRgLdOGIDMBbcfEWSAZCQPaFNT,CHCDaEDDFFEF..KHDC..JBDHHCCH.RDADdCGCOEAGDBCGBAGA.hAAA...fDGBhABASABCAHBHQGGBhACAPGFG.eAFGXGAE..LCFChADAMFFC.EBBDWAFFhAAA..,2,-37,-24,13
cINGLWTRDYXVSOaJbKFeQZCUBAgPEMdfH,EEECMCBCdHCFHFCA...ICHFLBCGRAFCDFADXBGG.hAAASBAFaEHFJDAGKHGAhABAFEAGQDEBhACACHHFBFDDADBGfGAF.NAAH.WADC..hAIA..YFGDhAFA...,2,-33,-9,24
YAcEGORPITSeMNDBUQXKdFfaWCLHVbJZg,GDEGRFEE..IHAGeGAEDGGBBHCFQCCDKABE.FBEAaCDGhAAALAAGHCFAJAEEZEAChABA.ABHA.EEDHOEHFhACATEAHMIAC....NEICdHFDCHEG...hAEA......hAFA...,1,-10,-16,6
ENaFBRITJGCVKLQMgYPDcWbdUSfZXeAOH,ODDBEGCGFDCF.BHBBRGFE...JBABCFAEKBEGLFFH..MAEEhAAA..PFEHDBCG.hABA...bCFESBFChAAAXCABAAIHaCGB.IFAATEGH..hABA......hACA...,2,-48,-28,20
BPaGdKObQgVYAEMcfeLDXJHZIUTWFSRCN,MBBDeFDHLFAHDEEBHFBBZBGBUDFA.FAAESADC.CAGCBFGFhAAAGBCG.KAEFOBFHhABAQGGA.hACAgAGEAEDBECCEfHGFIDAB..hAAA......hADA...,2,-23,-22,1
eBaVbGSTPQNdUYJLEHKRcXZWAMDFCOIfg,MGFCCBGB..OCED..fBGEBHGDaFAFGACESEAFhAAAQEGDNEDD.hABAdGDAUFCBLAAHhACAKCCC.XCGAZABGADFEDDIDIAEFeFAH..hAGA......hAHA...,1,-17,-24,7
AYcHKUNWPGOIVZBTXfSgbFdMRCEeQaLDJ,HFGDKEDEUEGG..NCCBGFBBOADAZCCGBDDF...XCADhAAASCACFABGdAGBCCHH.hAAAeEFCQGBAhABADIDGACIF.....cAGEIHBD.fADFhBAAMFFDaDBH..hBFAYBBC.,1,-7,-28,21
AJQXRWdDgEbUHOKZSYVNeGLFBaPTMfIcC,QAFBRADAdDEADAAH.EADBHFGDZFDA..SCDGVBGH.eCAHhAAAFDCHBGFG.aGAAMFFGhABA.fHEBhACACDADABCF.XGAF.WAHH...hABA......hACA...,1,-6,-36,30
gZKNfCPXVGSBMLRJeIAYTQEdbFUOcHWaD,QFFDEACFFAGC.OBBCHDEGaFAFZFBGKDDFCHCG....XFCEhAAASAGGBCAEMAAGhAEALFHFJDHFACIF.YAEDhABA.dDCCbAED..WFFDNIAFfDBAhAHA...hACA...,1,-16,-19,3
QAWGNMZVTdIDcJObXeEFRgSCBHKYLPaUf,GCEEZEBBdBGGDACDOCBC.eEADREEF.SGCBBFDF.KAAGLEHDhAAAUGGC.AFIBMDCChABAIAHE.JCHHEDADhADACECEHADA..PHCE...aGAHhAEA...fBDBhAFA.,1,-8,-36,28
BgSAWNCUYIbDMLXFRdeZHGVQTPcafOJKE,CGHAUDFC....bEDALBED.READdHADeBGBZCCHHDAGQAGDhAAAPHAEfGDBhAAAOEHD.EACHSABFhADAABAD.WHEGIFAD.MIFAhABA.FBDD...hAEA...,1,-7,-27,20
NIZBWAdHDYbRCKPaEFGOVUcLgTMfXJSeQ,dHCFHABGDECCRFGDKFCH..aEGAEBFHGAED.UAABLEAD.hABAMEFHJFDG.SCAAhAAAeEADQGGHhADANBIAIDDGBDBFAHCFCFBFODDA.....hABA......hACA...,1,-18,-20,2
MRQYTaUdCcSKGXfNJZbODAEgILHVPeBFW,EHCGLAEGHBAGeDGBBFDDFCEGRADE..QBGETCAF.dGACCDDGKFFAhAAAXFEB.fDDAhAAANIAH..hABAJHFE.OCGFDECBAIFAIHHAPGACMBAEhABA.aFAGSDAHhACA..,1,8,-31,39
JOaHeEIXMQVZAWbcGDKSYBfTFUdPRCNLg,...bFBCDCCE.KFCBSGFABAHBFAAC.UADGdDBG.RCBD.LFEChACAOHDCHDFE..hAAAIGAEQAGChABAAHEEGCEH...fAFCCDDBNCAGaBBG.hACAEADC.MFIB..hADA.WHCG.,2,-33,4,37
fKIEWFGPQDVaCdbTeHLgJBSRZANcOYXMU,OACGXDGGUCEBKCBG...EAGGFAABGEGEDDAF..CGCGdFHEeEBBhAAAHBEHJHCE.BFAHZBAAAFFBhABA....cEDChACA...MAIH...fHDHhADA.IHAHhAEA..,2,-30,-24,6
TDbPUAXVeRCZdSBYNOFHMLJWGgcQafIKE,eFDFZAFBBFBHOCCDMAACLBFD.JCAFGFEF.QBBGhAEAaAGFKFFD.DCHFPABDhAAAAEBGRDDEdFAG.SDHHhAFANBIG..WEHDfHBHEFAB.hABA......hADA...,2,-25,-19,6
VLIDTEQSCgBJRUZWcOPHadbFNKeYAGXMf,XDAAMEACLAHBDDIB.EACE..QDEASCFDCACFBGHGhAAAUGBGZFFGODDHHECGhAAAdBFFbBBCFBAH.KGEEAFAAfAGEhABATGAA.JHFEWHDG.aAGA.hAEA......hAFA...,2,-19,0,19
SMYPbgBVZcFIGLRQEHWCXdAOaNfUDeKJT,aACAUDAA.DABEeDCF.KDFGSBHD..PFGFBHEAZEFGhAAAIHAFGBCBRAABQGCAhAAAEGHDCDFA.hAEAAFFFfBFATGBAMDDHbAGF....hAFA......hBCA...,1,-20,-25,5
dFSUNgXDeMKaGPABIOHYWJQVZcCbRTLfE,OBABHCBGJDHHZEEA..CGDB.RBEBLDBDdCFEUGAD...XAGDhAAADAFAKGGF.GGEHBBAC.hAAAIDHC.QCCChABA.cGBDTADF.fDAEhABA.SFDEhACA,1,-21,-40,19
TaNbULeMCPXFKRScGEAZIfDYJQBVdWHOg,ZDFCDEIFQAAFdEAEOBCD...aCFBUGFHMDAHCAHF...FGBF.hAAASDBHEFCEAHDE.hABAIGGDJAFHBCAAHDDFhABA.gDGF.NBED...eABChAGAXCCBKBHB.cGDEhADA.,2,-30,-23,7
NaKcVHRPOBUMITECfSQDXFAJYbeGZLdWg,JDGHeCEHGEEALFHD.dFBH..NBDA.aCAH.KAFAHDAD.OAHBhAAABCCDMHCGEBAFCGCC.hABASEGFDEIB.hACAAGIBZABGcGAC.PAFHIHAC..hAAA......hABA...,1,-12,-29,17
DNcXfegRWPKVBAFIdZTGQHCOJYEUaLMbS,FBEDdDFAZCDDQGACCFBC..JHAGUDBG.LFEDMFIF.SADChAAADCGA.XGGGhABAeADARCACKHFEBCGDhACAAIDE.IFHH..TAAFOAHDEAGAhAAAaEEA.....hACA...,1,-12,-35,23
COSbafTIFVZAYDWdNJQLHReMEKBGcgUPX,DDCFdGCDJGFGQGGA.RFDG.MBACBBEHGCAHUBBB..CEAA.OEAFhAAA..SCGGhAAAaDFG.TGAEhABAIAGC.FAEBAAGDNICH.HDEEeEFAKADC.hABA......hACA...,1,-16,-32,16
KEHGZFWaSNeJPCVbDAMLUfdcBQOXYIRgT,UCDFdDECQACGOFBA...XGBBIHBDRBFBKBAC.EHEAhAAA.HFGDFDACaABBSFAFhABAJFFB.CECCDDIBhAEAAAHCMBGH.LDHDBBHH.gACChAAA.....hAFA...,2,-27,-10,17
VXIOYRfCLNGcDaFBAegMKETUQZbPSHdWJ,eFCEKDFBEBEBQDGD.ZBBHPFBGSAECdABG.JHACIHBDhAAARAFA.CHHGLAFAhADANCAADDDE.BGHBhAEAMAAE.UGGCHCBCWDBD....OHDEhAGA.fDHEhAHAcGDC,1,-21,-23,2
JfHOIgCGDXKPMVARWYNZceTEBFdabSLQU,RCED..NBDA.eGCEBBAHaGADLHDE.UBGHfAAC.hAAAOADGIHBACGGAXCBFhAAAMADAAFFCZFECEHCGdAHGhACASBEH.JCBB.....hBCA......hBDA...,1,-22,-28,6
WBQSgGfObYPdEHDTFXUcZaIJVKeALNMRC,MBDACEFGBBGG..QDCFGDAC.OEAB..bGECPHBChAAAEDCADAGA..FFFAXADBhAAAUCFBaABDIDHChABAKGEGADAG..NAIG.RABH..SHBAhBAA.fFCAhBBA...,1,-17,-32,15
LeHVIbagWRNQEJMFYKDPfGCXUTZdAOBSc,OFDBSECDLEEGeDEDHACC.VEGDIBGB.aGGBhAAAgBGARABG.hABANHAF.JEAEMABHKGABDADChAGAfAGHGCDFCHHE.......hAAA......hACA...,2,-16,-16,0
QfOKAWYCBeFXILDRbTJcMaEUPdgHSNVGZ,CCCHFABBLEEFRDBA..JGCCaAGF..UAFDdAEGHAAF.SDGDhAAA.NIAF.ZDFBhAAA.QGAHhADAKGHDAFBBBFFGIHGE.DFDEcFBEMDIBPADDhAGA....hAIA...,1,-23,-35,12
aZNEMKRCBPJfALDgObYIXcUedSHFWTQGV,DDACOCDD..IGEDXCBB.UGADSEBGHEGBFAEGQGGDhAAAGBFCaABGNBGE.hABAMBIH..KBBCBFCEhAAAfCHGAIHA.LHAA.gDDBhACA.cFAHhADA.,2,-42,-11,31
IPDMSUAGCLbaRdYeHgTOcVZFWJXNBEQKf,CFHAaEBAdDFEHBFC.OCDFZCABFADD..XGGFEHFG..KGCBIHEDhAAADGBH.MFBBhABASCGEADAHLAFChACARDDH.gDGA.TACDWBAFBAHChAAAfBBG..hAEA...,2,-40,-14,26
JUZcKIASQXFCLgOaMNBYdTPbWGERHDefV,QBAECBFGLEFG.OCECMAAG.BGBGdAGD...TEGA.hAEA.bBBHEBFEHFDBDECEfFEChAAAUGGHKDDCAICCSFAChAFAFADHaFABNAED.......hABA......hACA...,2,-23,-16,7
LXZWRdAQJSUNEBVDcgCKfMbaPFeGYTOHI,JHAESDAG.ECGGDHFE.CECA.KGDC.MAFHaABE...FEFCGBEGhAAAOBACHCAAIGHHhAAAXFAG.RDGFAIHEhABAQGBDBAEF.cAGF.fHEHhABA.eBDHhACA...,1,-29,-30,1
HbdUKJeZMOIDgPNLXEGYfaCTVQFScBARW,HCBCUGBEeAADOFBHDFAA....NGCFEHFEGGDH.aCCETABGhAAAQDFCFDFEBAFAhABAAFEBRADE.dEAFKBHBMCIB.hABAIAHE.PHCC...XADBhBAACBBBSGGEhACAWEEG.ZDAC.,1,1,-16,17
LVJfGUBcTYMaIbEPSWgXRHZdQONKACeFD,eEBADDAALHEC..VAAEJEEAUEACTEGB...aCDAEHBGhAAA..SCGEhAAA.gGBAhADAXBCFHECHdEAGNIEDAGEGFAFHBGGDMAIDIAHChAEAWABC.....hAGA...,1,-4,-33,29
fIKCcVLJWHQDXdGMaUBPSEAYTbORZNFge,TCAGRAFEZCAHFHGA..eFEEKCDF...CHEGLAEAHFDEDCEAdDHGMEDHhAAABABCSGAFhABA.ECFAAAADOHAAhADA..NCIAfDDD.IACEhAFA.JHFC.WFCDhAGA...,1,-19,-38,19
LCWVbMQBRIcHZNaUYFfTASPXOKgEeGJdD,SFAGXGCGKEECeEGD.GCCCdHGDDAFALFEH.VBEBhAAAMAADBEBDIFHChABAHABEaHBAUCBCYAHDhABAFBFBAEAF..OBHBEEHDWADE...hACA......hADA...,1,14,-35,49
aWgVSJRAHKeIbNGMcQdZFODUfYELTCPBX,KCBFeEHF...IGBBNIEF..MBACQACHdFGHZEDDFCEChAAAOCDH.DAIBUCGAhABAfBFBEAGG.LHAGhAAACFBFBCCBaACAVCAF.RFEDACFF....hABA......hACA...,2,-29,-14,15
MIcERGNWSFTdQfCKJXODbALUBVePYgHaZ,UGFHBCFEeEBG..PCDFHADHMHBC.EBAHGDAE.hAAASHBAFFGBdAHGCFEAXCBAhABAbAEEABAB.LFAFhACAYDFCaHDE.IHHF.NEED.hADATBBA.KFFCDGBGhAFA...,2,-20,-5,15
begHYKfIBaNQcTSRUGFCAMPEZLDVOJXdW,EGABLACCDEBA.JCCHdGCE..eGAEHFFAKFDABCCH.QBAChAAASBHDGAEBhABACBEDAGHD.MFAGZAFBXGFHhAAAWHFG..YCHFaEEA..NBBC..hACA...cEEGhADA...,1,-19,-25,6
QSDZIOALFBbKaJcfWVPXTeGHMCdgYNEUR,FCGCBFBGKAHBJDAE......fDFEVADB..TGGBhAAAHEBFCFHH.dACA.NHEH.hAAARDECSFGEhABADBAC.IHBAAAGBaEDCcBDEPFDB.XAGFhACAeHAG.MFAFEEAF.hABA...,2,-27,-25,2
SCVPAWIMbBQYUEeZaRKcTFXfGJdHOLgDN,MFBEBBFBUEGAZGACKCEFFDDE..GCGAdBACLEABDBCG..CGDBABGHhAAA....ICCHhAAAQGFG.EBABhABAaHCE.RFCC.XAEB.fCCAhACA..OAFAhABA.SBCEWFHH,1,-20,-33,13
PNfHFaTcRIDgZJCQAbOGSMXLdUYVEeBKW,OCEBSEDFLBAAdBGEUFAFEGGHBHABKGFB.....NAEBFFCHhAAAaBBHRADF.DIBEZDAACEHG.hAAAABBCGBGC.MICChABAXABF.eFEFfFFA.hAFA......hAGA...,1,-12,-32,20
UHACWRXKVJgQIYefZDPETcBGSNaMdFLbO,RBAFVBFDQGDC..eFECZCECEFABTFAGBDCF.GAEDhAAANICH.MFEEFCBFOADFhAAAAAHCCGHA..KACBIGGDhABADEEESFCDaAFA...dGGC..hABA......hACA...,1,-9,-22,13
REIgdUBFVafPJZeKYCTMAbScQWDGXNHOL,SDGCQDABGECBHEBCLGBAEFHDdAFHUABHBDBBaAFEJDEAZGCGhAAAKFFECDAD..AGAG..hAAA.bBBADGGH.NBIG.IGHAhABA...FHEE.fACFhACA.....hACA...,1,-7,-17,10
fFYNVQKBdIUTAJCDOMHELeaPbZgSWcRXG,CFCGMACGLBFA..PEDBZDDG..SFGGRBEGGGEFFBBAhAAAVBABQGADhABA.KEBHBEHAdAGD.IGABhAAAAFFADDIH.OHEAeDDE.aHBE.WABEhAFA......hAGA...,2,-38,-4,34
GLQNHfWbSUDBXCJZeVAaOgRcYKTFdEMIP,aCGGOBBA.RAFG.KAEFFEEDEBAE...MIBCGDAELFFCHFCBfGGHhAAASGACDFCEhAAABCEACGGEZDAEAEIBgCGAhABA..YHDCdCAF.IACDhABA.NEEH...hAFAWHFG.,1,-16,-21,5
IeLVadDFcYMWHfSBgKUEAZCJQRGXPTObN,CHABRAFCGEAG..PEGDOEEC...IBDFeCAFaFDCDAABhABAFCGC..MEIHfDEBhAAABHCAKBBFACDGJACGhABAXCFA.TGEGNCCE.dGGE.WDDDhACASAGG.EDDDhACA...,2,-37,-12,25
WcdNeALCFfDITSbJaZKMREBHVQPXgYGUO,LAAHFEEDDDAG.TEDE..SFBAJBHFZACD.MAGDEGBGBGEHhACAHBCDQGGHhAAA.PAHBhABAgGGE.YCFHODHDcEAGhACAeFADfAEFIHEBKAEBhADA..,2,-34,-8,26
WRUIAJFPadNXEKgGLTDVcfZQCSOHbMYeB,JHACFCFGdBCF..EFDHKAAELCFDDEGE....VFFDZCCDCHHBHFBHhADAMCADBAHD.RDCA.hAEAIHFD.ADBHaCGEhAAA...NBCH......XAGFhABA....hACA...,1,-35,-40,5
LMYUeIcKCNQWHGbFJOdgRfSXTPaABVEDZ,EFECZAFGMGAAUBCG...eCCEKFBE..CDAH.QEEEGAFEFHGCdABFhAAA...fDHGhAEASBAFPHCChAFAaAHFAHDDBFAGDIGEIHAE.WGFAbDGD.OEBGhAGA....hAHA...,2,-29,-13,16
acLKNRBYTCDUQgSJbIVdAXHPeFGEMWfOZ,HBAAFGGGGABEEHBCMDEFOHAGZGFG..LBFEKFCEBAEBCECDDCGFQBFAhAAA.SDAFhABAIEABAHEFeFEFhADAfABBaAGA.NADDRDGFYBEF..hBAA......hBBA...,1,-9,-21,12
cWLAMKUeSbCVZGYfHIJTNFROQXBEagdDP,KFDEeEDECGCE.GCACHAAF.JCHDFDCE..QGGGBGAGEAEBdGFBDDDG.hAAA....PCFFhAAALHAA.AADDSABBhAEAbBGF.VAFBfDAGTGEH.hAFANDIEOHFC..hACA.aHAE.,2,-26,-5,21
JMdVfBYAPcSKLRNCQZXUGgHTDaIebOEFW,SDDFKFGFRCGH.CHHB.QFBBZBFH.UCBHHBAHDEEBIAHBhAAA.OFFDhABAEACFFAFAJFDBMFFDdEADBADHhACAACFB.LCHB.XGAH.hAAA......hABA...,1,-6,-40,34
BKMaDLEVZHXeOUCYQSWNFcbPRGTJfgIdA,BDHDaFAFLBEAZCAHeGDAUGGA..QDDGSDDBFAEA.hAAA...PABAhAFATABCfGDBhAGAdHGBACGEMIAEDFFEEEGDXGBH.OCCHCAAFNDAA.hADAbDFE.....hAHA...,2,-24,-5,19
JHFWSgTeKBMRNPQOIGZVDXdEcaCLbAfYU,UBFAHEDDFDAG.SGFATGGDBBBGMCCG..RDAD..QFCDhAAAOBGFZEBDDDIHdAGBhAAAECDHaABGLEEEhABAAHIDfFAAJACE..WFFF...KHCGNICB.hAEAIHAC..hACA...,2,-22,-9,13
fDKPXMBbaCdFJQcgVHGOISYATeNLWZURE,eBBFLCFFUGGHEGBEDDCBKEDD...MEIBBGAA.aEDBFAAC.JAFEhACAQAGA.hADAVADBOHDE.IEBHhAEASEGAAGEHTBCDWAAFZFDB.fCGGhACAPFGFCBHH..hADA...,2,-30,-19,11
CYdSNMWFHeRVZJLIXUPKbgAcQGTDEaOBf,QGGGGBBBDIFCOBHBCHDE..SHAAMFABHEBCREAAJAEEhAAAXFGA.KGBDAGEGTBBGhABABEEEdAADFCGAeADGhABALDDCIGEDbEFEECABaCEE....hACA......hADA...,2,-14,-2,12
ZgEAdYJLTDSCRBcINHVbWPMQKXaGeOFfU,dEFDJEBCLBAEDGGBRABC.BDGC..IAFEHFEE..bAEFMDIHhAAA..QGBChAAAKEAAGECAeCAFfCDGhABAgAGFABHH.YHEGSAHBhACAcDGE....hABA...,2,-31,-20,11
DULNbBRQKGIYdcfVPeFgXESOZJCMAHaTW,TBFGUEDELCAF.BHDGRFECGCBEdDCG.fAEFhAAAeBHHFGHH.EHAAOBEGCADFAIHAHDFChABADGCB...NCAG.KGABhAAAIAHE.YFDFPABGSGFHhAFA.MFFGhAGAaDDF...,1,7,-29,36
dXOaRTGVcPDFBENUYZgfQCKSeAbMLJWIH,LFABJCEFHAAGdCGHOCEC.RCCD.GGAB.VEGBDBDGBCBChAAAEAGE.UGCDZEACQGEChAAAKAHBSFHHAIHGMDAGhABA..XFFC...cDGEhABA.....hADANACD...,2,-27,-5,22
AIBfLEObHCFcgUWVeDMdKNJTPSXRYGaQZ,BGCAEAGAHFCFCAGA.FFFGUDEH..eDBDdEBDKABBJBBG....SGABhAAARFFA.aCEGhABAAAAG.LDDAOEAH.hADA...bBDC......WACEhAGADDIBNICD..PFHDhBAA...,2,-43,-19,24
NbSHQAIFPOLcEDYJUKRedMWgZBGCTfaVX,FFACOFCDEDCC.DBDEUAAE..RCBBdFHE..MFHDZEFBCHAA..TBEAhADA..fAAFhAAAVFEF.XBGHhADASHAG.ADHFLAEC..hAIAcBEE.KEEB.hBAAWEAFBEFB,1,-18,-48,30
IQeRDFUXAgSfbPBTOCYZWNcVdMaEGLKJH,SGCF..fCEFBDHBCEDGZADHNGAD.dBAG..MAIHhAAAEGGDKGAHHDFC.IDCAhABARAFGDGEH.XFFChACAAFHG.PAEEOCBDWHCGaEEF.LCBDhADA.eBBE.FGHDhAEA...,2,-31,-9,22
AHNbOYFdKBJCaXePGUTRIgVMEQLWZcDfS,HEEAOADGFCBHBGCCJACH...CECB.eAGBUAABRFBB....IGGEhAAAMFFBEAGF.LFBFhABAZADFDDIDAFAC..NEHG.hAIAdGDAKBEHaBAB..XBCD...hABA......hAFA...,1,-18,-31,13
AZgOaNJPKdeEbGMFfLYQVRCXUWDITcHBS,OBGBaACE..JCFAKEDD.eEHFEEFFGCADFBBDLAAC.QEAChAEARGBCUGGHDGAGTFEFhAFABAADAEIB.ZAFCNIBH.hAGA.dCEA..fDECYAHH.CECA..hBBA......hBEA...,1,-13,-22,9
MgLIFKWDYTbSaUCJXfHPcOBZANGERdeQV,GADCRDEBQBDCMHAALAAFKGCF.DGDGTBAH.aEAGCHFBfAFDhACAHBGH.hAAAODAEBHHDAAHENIBDECFFhADAeADE.IFHHFEHD..YFBEhAHASGAH.UGEF.hAIA...,2,-16,0,16
OAXZGMHWDUJQTcfBKRbIYeCFLPgNVSdEa,XABEGDDCMCHDHECEUFGD..QFGBTEAA.cAGDhAAABAEHKACD.IAAEhADACHDDLCAD.NDDDSGADhABAaGBEOAGBACDBDCID...fHFDhACA...hAEA...,1,-4,-29,25
PbcIFARaSTgfECONBMVZUKYDLQdWGJXHe,aDDCSEGC..TCAAECEF.OGFCBFADZACDKGCALFBFhAAAdBHGJABBHFEAeAFAbEBDhAAAFACH.AEGBRCGD.CCEAMEADhABAYHFG.DBEC.....WBADhABA......hAFA...,1,-11,-19,8
YMJGZHFTLdCRXUeQfAVgNObaEIDKcPBSW,VCFDOFAG..EFCBDHCA.KDEEBFAD..SHGGMBIHJADBZDAAhAAAFFFBdDAH.CBBD.XBAFhABAUAGC.QGGEhACAABDF..gEGBaHAEPEEB.hAAA.YACC.hADA...,1,-20,-37,17
OTCdXREMBHfAPFUYVJQNSacWbLZDGIKeg,FCHHVDCGQCCA..NCGC.aBFF....bAEBDAIDKABBOAADhAAAdHCD.EHFCMDHFhAAAfFAGAIGCUDAGSAGAhABALFFGZFCBIHAAgDAGCGHA.hADABHAD....hACA...,2,-18,-15,3
VXaYGRSgACIQNfTdMPDHeWOFLBcZUKEbJ,QAFDTBFC.MDGFDHDCHEGH.OEAFBFHBUBCGKADEEECChAAAVEAB..XBBEhABAaCHDRFEBABAB.CAHGNIADfCAFhAAAdEFG.PECG...FHGE.hACA......hAGALHAA.,1,-1,-10,9
RCgSLDUJEbXdPWYHaGAMVBOTNcZKFIefQ,MEFHVDFE.BCAA..TEABZAEDKBGHFAEA..eHFAQCADhAAACECGLEABDGCEEEDGdACH.hAAA..PABC.hABA.YDGFaGHFOHBGNAIA.IAHGhABA.fGGEhBAA..SCDD,2,-23,-20,3
PDANeSGJXbTUcELWfHYCFIBMaZRVQdOKg,SEBGJADC..TAAEECEALDHHHGECCHAA.BFFHZFCDQCDDhAAAdGABOAAGgGDDhAEADCCDAEGC.eCBAhAFAXAGFbAEAWEECfCAG.YFFChACAMHFA...hAGA..aCGC,2,-14,-14,0
ARDJcXWKPYTgQBeZbSdVLGOaCNFMIUEHf,DBBA..JCGDXGCDKDEH..TAFBBBFFZCFBdDAEGABEhAAACHFFMEBA.EHAGHFAF.AAADRFGDhABAPEDB.QGGDhABASDACOAEHNCAH....FAGAhACA.....fFDDhADA,1,-16,-26,10
SCOfQFdbNWTHgcGPARXaILKBeUJZMYEDV,XGGGaDGALAFCBBFFUAAGZEDG..MDEGDEAD..CFFC..ODCDhADAQEAC.FBAHhAAANICD.HGCCGADAADDHKAHDhABAeFHDJBBA.EGBF.SGEA.fDBChBAA..hBCA...,1,-16,-21,5
CROcFYIBDNdSZfWAHPGJaEebgMLKXQTVU,GCEAEEFF.eHEAMEDBLAGDQCFDTFBCCAEF..OFHFhAAAFADDIEHFDHFEdCAHZFBHhABAACCHHDAAaAHDKAFAXAAChABA..........hACA......hADA...,1,-10,-19,9
BcIePNCYJGdWAHQabEgTFSKURZMOfDVXL,QCEHaEFH.EBHHFCHF.UDADMDDHOFHHDABFLEFAhAAABDDB.IDAGeBBACAHDGECEhAAAdACHACCEHGBETGAAhABASGGA.KFAFfHEFhACA......hADA...,1,-4,-28,24
FQVZYDRcBOMgESefHaKPWLXUCTAbNGJdI,GEFEdEFBQEAAZCAADBEHREAGBGHG.MBAGEBGC...eAECaCHDKAAAhAAALCDD.XAGEhAAACEECAIAC.JGDCIGDEhACAFCAG..YHCAOAEG.fCFDhABA...hADA.WFHB.,2,-25,-8,17
KXNZcFfWOCSJVHUTgePdabDBRAILGEMYQ,LBADMGCAKBBHZFADFFEAOFAC..CCEH.JDDCHDEC.UAGAhAAAeEHHdADHDAFFADIHEGGEQCBEhAAA.XGCAhABAfECD.SCAD..hABA......hACA...,1,-28,-29,1
TgQLAbMPUZdWRfKGFeDcHOVaJECNXYIBS,MCGDUDEDdBFFRFDD.KFHHFBCB..DBAHOGAE..JFAFEGGF.CDAF.hAAA....XCBDhAAABDDBSBEBhABA.TEAGgGCHAAIB..ZAGFfBCDhABA.cFFHhACA.,1,-22,-62,40
JMPcSYOdHGUfVTgaKBbDNFZXWACRQeIEL,QFBBeEDAEBFCLCAAMIDC..SABGdABDGGAHfBDFhAAATGFGKEABDHGAFFGAhAAAZDDAABIBCAEAJDHD.PAHBhACAOCFE..UDABaECG.BFFG.XFDDhADA....hAEA...,2,-12,-1,11
gdbVNWRKXIeBfHSOTGcCaQDEFLPUAYJMZ,MDACZBBFdEHA..VCFCREADKACE...eFDDBFHGHFFFTACBCBDH.hAAADAGAFAGGLFEFhAAA.ACECJFAEbAED.XGBAhABA..SEFFOFGHaAFC..hACAEBAB.....hAEA...,2,-22,-15,7
MbNXVYCLTdDIJFWAeOcKHgQUZaEBRfGSP,OBCAHCAFUEGDZCAGBBHFRFBCGAGC.MACAXEGA.CFCG.dDDFhAAA.DBAFFEDCABBGKGAFaGDE.hAAAEGHD....fGBGhABASCCCNACF.YFFF..hABAIHGB.JBFBhAHA...,2,-38,-4,34
bMJOEFfLZVSPeTDUNgCHQdRGcWXIKBaAY,MAIBEBACFGCEZECF...SAFBeDEBDHGCUAFECGEB.HEAAQBCFhAAAdCCG.RDABGCGGhABA.XGGChACABFHHABHC.JHACfADB....hAAA......hABA...,1,-8,-32,24
eNCWGTLYfScJUZEPIFXDKABRdgaQHMVOb,BGAAdDAFQDFCMBFB.OAAAeADCCDCGGBBFLFFH.SCGChAAAUAGHEFEBFFAFhAEADFHDAHDHaGGB..bBAB.hAFA.WHCG..fDGF.cCCAhABA....hACA...,2,-41,-9,32
FXcMIUJgENPWSbZAeOVDTHKQaCfLYRBdG,OAAATCBB.KBDCCFCC.LBHFBBGE.FCCFMEEB..UFGFJAAE.hAAAECEA....WDEEhAEASHAG.hAFAAEAFDIDGaFHDRGAGdGBHXGFHgEEF.NBBC.hAEA......hAFA...,1,-27,-32,5
bHXYNfBTeAOZMGSUELKagQIWFRdcDVPJC,ZEFASCCGUGABLGEAKFBC..QAFCFCCBdDGD.VFDEhAAAJAFA.HACE.NIEHBGHBhABAeEDFAEBF..MBBHhACAaCFG.IDHARAAC.DAIDCDAC.XDEAhAEA.....YHAGhAHA,2,-32,0,32
EcMbgVUZYPFGNSWDHBTAKLaCIRXeJQdfO,LFBFCGHERCDC.eAADJAHB.QGFH.OAHBMHAA.VDEEhABAZABDFEBAGECASEGAhAAADCECBAEBAFAH..hACAKFEHaBBF.XDAGEAEH....cGGHhABA....hAEA...,1,4,-44,48
cEWIOTbHBQDRUPNaAJGgfdYVZMCFeLSKX,GCEGdGHEZEBGMDDACEDGLADA..KHAEXCAFEFFD.OFAHhAAATAAHBHFD.DGCGhABARAFGUCAB.aGCFgGGGhACA.YCHFFHECSBEGhAAAICDE....hAEA...,2,-32,-14,18
UGYZaXAOHLKDCgJITQdeEScRBbfFMNPWV,OEDAKDGFCEDD...JGBCQAEC.eBADSBEDhAAABCHGFHGGMBCD.NCIG.PBBGhAAAUAFG..ZGFAaHAAhABAAAIFDDBB..IFHEEBAF.RFDCfDDDhACAWHBG...hABA...,2,-36,-23,13
MCZUKOeIaRfSGNdgFJVLTPWYEHBcQXADb,DFGACAAGZFDDOBED..aCDBRDBHGAGG.dGHCJBFDLABEhAAA..TGGA.hAFAPAHFEGDDBBCDXGAGhABAAGGBMFFH.KGABIEAC.SFBAhACA.FADG.hAGA...,1,-23,-30,7
AKQaMNIWCdJPcSUTYXVERHLOFeBfbZgGD,KDEDaEGC.MHFC..IBBCdDAE..JAGBSDCAUEGC.hAAATEAF.VFEFhAAARBAEHFBEFHBGBCDFfAEFhABAZADADDGGADDDNICHCHHBcAGF...EFCChABA......hACA...,2,-24,-18,6
KDeJECQANBFgaPITbSOfHRWXYGcZMUVLd,BGHAaABE...ICFESCAH.HDEEXDGAGGCBMADFhAAALAFE.DFCAhAAAJFEECFGBABGDFAHBTCCDhABAbECDREAD...cGGE..UCAFKBHF.EABHhABA.NICB.....hAEA...,2,-21,-3,18
QEKTJNHVbcABZMWDIXUeGLdgSROYaCfPF,MHFCDDEDUFBGGCGELEHFdGDERDBG..OBDECDGF..FAAAEFAGKDADhADA..JABDHBDG.hAAA..VFEBABIDBFFGhABA.IAGDeAHDSCCDaDDA..hAEAfADH.hAFA...,1,-16,-27,11
AVWTRDfYKEZdSgUNQXCbIHPFeMaJLGBcO,TEDFDGCDKGADZDEG..dCCDUDBEQFAD.CGEAHABGFBABMEIBhAAAJHFGBHCA.ACFBRDGHhAAAEBEC..SAFEhABAXFDA.ICACeAFEaGGF....hABA......hACA...,1,-6,-38,32
aCKfVBdLQWgHEPbZXMFDYeAcSONIRUJGT,SBBFOEEERGACGCDFCGEE..KBGCBCBHQEACHACAEGGFZDEChAAAMAIBDGID..AAFC.IECChAAAJCEA.fAGChABALHAEWCDD.....bFFHhABAFEABeACGNEIAaHCE..hACA...,2,-16,-10,6
SVdXeIgNRMPaETOfFCBbQLUWGHJDZcKYA,dCEEeDBH..IHDERDGBMBCC...aHFGOAHDFFBH.CGCGQEEHhAAAUBCEHAAFDAGHKDDFAEAFhABAXDGD..hAAANCCBEHAGfAHABCAD.WEAE.ZFFAcGDDhACASHAG.hADA...,1,-8,-25,17
GgMFYKSZfNAJcCaQODWELbdHVUTeXPRBI,CABDQGFFDIEA.LDDCdEDGHADDTABDeEFBRCGDBBEH.GEABhAAAMHBCFFACSCHFhABAZCAEAIHA.aGBHOAHFhAAAEAGC...........hADA......hAEA...,2,-22,-16,6
LdZVebFUJQAfKRSMPEOYTGNWagHIDCcBX,KABCMCGHOCFFGABH...aECFHDBECBHHBGHAdDHCeGAG.bBBAhAAAJHEA.AEEF.RFEGSBFEhAEAEFAD.NIED.ICAEhAAADIAE.LCCA.FDHFfFCFhAFAYHAG...hABA.WAEE.,1,-5,-20,15
aUOCVAMBRcNXZQYPJbgLWefDFKIHSdGET,MIACBCBGRCFF..XFFCQGGC..JABELDED.hAAAeHBCDCGEFBEHKBECHEAFhAAASGBAEACFaDCDOFAAhABAAIDC.NEIAZDDAPAHF.....hAFA.....WHEGhAGA..,2,-26,-18,8
XaLQYWcfMIKJENVSPgZTHeDUOFACRBdGb,RCBBBHEDdBEDGEDGaCDHLGDC..QFFG..cAFGhAAAfABBKACFECGHhABASAHDZEAB.hADAeDFEDFFEOCHDCFBDYHFGMIAE..NAACgGAGhADA.hAEA...,1,-5,-29,24
EXKMFHLefURbVaPINOWgBAZYTDCJScdQG,ZEGFTAEHDHBC..CBDB.SGEH.QDDGXFDAMABChAAALBAF.eBGHhAAAfFBFbEGHaCBFIGCDhABAODEGBBFEAGAD.JCBD.dAHG.EDDDKHAGhACA......hADA...,2,-30,-8,22
bQOBHRKcgXfCJZUDGTdLVeWaIYSPANMEF,ECBEQBGABBGHKFCE..XBBF.CCAEUDEFDABGdDEHLFCAhAAAeHFAaBBA..IHHEhABASAEDAEBAFFAFhACAOHAEHAEH.gEGHfHEH..hADA......hAEA...,2,-36,-15,21
SePGdbafERcYLXWHOKVTUDJNFCBIZMAQg,SFEHGADFdGHGaGDFRDBBLADA.HBAAVCDHDAIBFGFBCHGGBHAHhAAAZDAFAAGA...QEGFhABAeCHH.PEABhACAEABB...cGCBWCFH.KEDE...hAAA......hACA...,1,-6,-22,16
KeMTdcFCIZREPbQHOBAJSgLXYGDNWUVaf,JDBDLCBFGBCHDGAE.UEFB..aHFGKGDAMDIFdAAF..CHCD.ZAADhAAA.EAGDQDCEhADAHDEFAHABSEGHhADA..YAEGNDDA...fGGEhAEA.eAHH.hAEA...,1,-17,-26,9
YSdVGcUPRQJTHaIXMeFKDZCAELWONgBfb,EHDAOAFEBAAD....bAAAdBGC.GCCCUDFCRDDHQFADhABAHGAEaCAC.XGFBhACAFGGHKEAACHECAIBGLAEHhADA.NAIE....fCBASAECcEGAhAGA....hAHA...,2,-19,-15,4
NWPQBTXZHGAKJFdMaLcRfEDOIeVCbSYgU,KFCGFCBDdAAHMDIFLGCG.REFG.DAFG.OHDAeAHD..CDFC.SDEEhAAAUAEF..hABA.NBBF.QGGBhABABCCCTBGEHDCBGDAEAFAD.aDDC.fFFDhACA.IHHGhADAbFAD,2,-39,-20,19
SaCEJgNYBfeWdHPFDATIXVMRQGcKbUOLZ,XEEGMACEGFCHKGGG.OCEFZBEF.CABG.EBAD....NAIABDCEhAAAfHBB.eAHBhAAAdGAEHAFHDIFAAGAB.IHCGhAHAVEAE.cDBHLADE.SGDGhABAaHGG...hBAA...,1,-10,-23,13
LCRefZWOAXIHYQMTaNdGgEDbPJBFcVSKU,HEDAMEAH.TGEHdACCEBAFDGBG...JBFHFHAE.SFDHhAAAUAAACHBERDAG.ZDGD.AIEAXEBEhABAIDHF..aADGNBGA.hAEA....gGGBBEEBKCDGeFHHhAFAfAHE...hAGA...,2,-18,-17,1
MGIUXRQJFKbeTcVNALPSWfODCdgEaHYZB,LHACSEEEOADGCBDE.dBFDEBADHEFGBBFFMDCGGDCGUECDhAAAQGABKABG.hABAbFFETGED..hAHANIDHACCA...fAADDIGGaDGA.IEAGhACA.XBGHhADA..,2,-17,-9,8
RJGBVPXdfENFOHeWIAZUCSDYQLbgTacMK,CCFHDEFALCBA..gFAGaGGH.KDDEJACEBBFC..hAAAXGADdBBAEHGCFFFAhABAOHCGeCADAFIFSAGAhAAAQGDG.TEEHMAID.GCGC.hACAfFBB.hADANBAG.IECB.,2,-19,-17,2
NfTORBCJFVecZPKYWXHQUGALagIdbMDES,LADHaGDG.dGAEMEIDEBCF...NDDD.TFEABHFG..FBFGVDGDhAAAZEEA.KBAF.XGCChABAUACEAEBD..IBADhAAADIGAOAFA..REBHCGGGcDEB.YBFAhACAWAFE...hABA...,1,-5,-34,29
SUWTRdAGaMfIcbOePJDKgLZCHVNXBYQEF,GBBCaBAE.MFIB..fHGF..bEEGOFDAhAAAPAFBKDEALBHFhAAACGDBVADBBBGEQGAFhABASGGCTGECAIECeDAEDEDHgACBhAEAHGAE..XCGAhABA...,1,4,-21,25
KEYVWbXfFcPDBMHLAIRNeZGJSdagTUOCQ,RGAEZDDAGGEHSGBBdDAA..aFFAUAGE.QDAFEDEH.hAAAVABCbACBFAGD.DDGChABAHFGBAGEG.eFDBJAEBOBBFhAGAKFFFWDHB.fBAE.BAFGhAAA.....hAIA...,2,-12,2,14
FDEdJKWfOXVABaZSgMeQCIbLUNHPTcRYG,BCDCZECCSCABMDFA..QEGBCADELHDEUFBHHAFCTAAFhAAAREGHGCDH.DCCEhAAAdAFD.KGHHfFAChABA..OFFBAGCH.aEAA.IADBhACA.NDEA...hAGA...,2,-28,-7,21
SIAFLMdRUZECVQJKYDcbBPHNXgTGfOWae,MHDAdCFBRFFAUBBGZECA..EAAC..CFAB.VACCKDHH...DEEEBHHDhAAAHBGB...XGAChAAATGBAGECHhABAOHFEaEGEeACEACCH.FAHF.......hAFA......hAGA...,1,-19,-27,8
UXDIRHMGeEJYLaBbgQSdOKANTFWcCfZPV,TFECFAEDCCHB..ZDBHUCFE.DCBDRFECGDDF..eCDHEHDGLADDhAAABACGQGAChAAAdBABABHE.NADDfHGFhABA..PHACICCFMAGBaDHFhAIA......hBAASGHHWBFE,2,-17,-17,0
SLBGQdfDUWEOaCeZTgNbJFYRPMVKHcIAX,XFBBBEFAQAEBDBEF.UBAEEGGACEFBZEDD....NAAE.FAHHhAAA.RFAHMHFGKCBCHAGDhABAAIGALDGHdGDD..hABAfDDEaDDB.eAFD.gGADhACA....hADA...,2,-23,-18,5
ARFOMVgSKUXCWJecfDQEGHZLaYBdNTPbI,OEGBMCCD..VAFGKFBEUEDC..CFHBeFADDIAGGADDLDDFhAAABCHDdCAE.TFFDhABAICDBAEFF.FDAAXADDhACA.WHEGfHGF.EAAChAAAaCHDNHAF.....hADA...,2,-39,-10,29
ZSfPbDWLBRgGMOeUCFTEcKXaVYIAHdJNQ,dHGFQCAEZGBC.SGEH..bEBALBGFBCDGGAEEhAAAeAEDCHCBEDGHKDDAXBAFhABAaHGA.IFHGhACAACIHJFBEPAAG.DIAEgAGGhADAOFFG......hAEA...,2,-25,-8,17
KdNTWeOZASDMgEfcQJHFXbIaPGYURVLCB,MBEAEEBH..QDEAJCCAHFAE.FEHD.XGBHaBAFGFEHRAACCDAG.hAAAdAHE...NAAHeCFGhAFAOBDC.SGEHhABA.fAHCIHECYEFChAGA.....hADA.LDDDTDBD,2,-3,-2,1
FRaNMbCLHTPeIZQfKOAgBJDWYcUGSXdVE,JABBDBBG........YHACUDEFSFDAdEFBFCCCRAFC.hAAAaGBB..MDAHCEBDLFHDhAAATGFGeEBChABAIHEE..fFDEKAGDAHAHBCHAcBEChACAXADC.NBAE..hADA...,2,-35,-31,4
GDPAHTBRYKJSaMQZEOUFgCXNVLdbcIfeW,TBBBRFCDKGFF...aDAFZCAC.EAFGFFBD.CHED...VEGFdDGB..hAAAIGFFeBAGDIAGAHHDBDEBhAAAJCFA..SEADhABAMEAB..ODDH....hABA......hACA...,2,-38,-27,11
gAFaLdKfcNGJIUTbSPOZHDWEVeRMYBXQC,FDFDdEFGKAAB....NABEGCCAIFHCUFAE..TFAAhAAASHGGZDAEDHECEHCAeADEhACA.MCDCBADHCCHHAHIBhAGA.LHAAfAGC.cEGE.hAHA......hAIA...,2,-30,-22,8
YLCEAVePbQdDcNBaJGfHMTSgXKUIWFORZ,eDEEQGBBdFCFDGIBBGGHGACGHCBF.TBDCSBEE.hAAAKGADIEGDFGFDZAABCCHGhAAAAAEAPAHF.cEEHhABANAED..fEEBMCAF..XBFHhACAWHBA...hBAA...,2,-27,-5,22
UReQJOfKHWDVLNcXbYFZAaEIBdCSTMgGP,aGCHBHHB.SFDDMBDBGAEEUCBEREDB..QCAFJAEB.hAAAKEADDBGBLHFAhAAA.XDGHbFEFFHAAABAAhABAIABDCADF..gAGBOBHF.hADA..fEGDhACA..,1,-10,-33,23
HCYTGQBEKacRSNAedDLUXPbfOgVFWIMJZ,eEDEDBGHUDCG..bCAGOFAF..FBGAMADGHGCG.TEAEhAAABCBFKGFDaHGCSFGAhABAAEGBLCHD.PBCEhACA..fAADgCGGIBEHhACACBBC.QGGChAHAEHAG..,1,-7,-34,27
HGWOVNecFKAdfbQCEgJSDTRIaPXZLUBMY,dGHCQBBAECBB.JHFASHCA.DADGTGAFRAEC.IHDChAAAXDDCLAEBhABAMBAEHEFEGEEBhACAOHAGNEBHeAGBFCFEACCGCDAC.aCAH.....hADA......hAHA...,1,-8,-12,4
STcLBYCeWHDRIQPVZNaMGJfKFgOEUdXAb,TACELBCC.BFAHCGCCHAGBDHFEREEC..ICAEQCDHZDDAMFFFhAAAGGAH.KCABFBEDhABA.EFABXAFBhAAAAIBCSEGH.eEAEWABCNEIGaGDDfDGBhAIA.....hACA...,1,-6,-19,13
bLSKVPIHfgcXEAdZaReJNMYOGCWTFBQDU,ZCBEeEBGJCGBMIDE.GBCFCEHA..FHACBFAA.DFFCUABFSGDGhAAAKDEB.ICAGhABAHFCG...fHGBhACAgGGAcCGEEAEB.AHAHaAEANAAE.hACA.OAFG..hBHA...,2,-33,-18,15
PHUWgBceNSZREfOAKCMVXDaLdbQTFJGYI,MHBEDFBFLAACdFFA.QDCFTAFAFBDBGCGG..IDEBhAAAPEFBHAFHhAEAUEAEBCBGeFCBZBCCRDGBOAHDhABAAHHECAHB.aACG.JFCC..WFAD..hAFANIEFSHAGhAFA...,2,-14,4,18
YRcKEPWNfbMTIQgFDAdBZOVJUaeGLSHXC,BGBCOGEGJHCEUDFA.GADAHBDCCGHERAAC...KAGHEAHH...hAAA..NDAG.MACGTGBDhAAAQDBE.hABAgEEADDIFABGFdHEH.aBAHSFBChADA....cGGHhABAfCCGIBBA,2,-32,-9,23
LIZeDUCFANRPdYbSMQfXaHTJEVWKOcGgB,RGCEdGHE.SECHMCBBQCFC..XCFDaBAGHCCEJAFGhAAAVFFGKBBEGADAhABABADDIBHCZFADDDIHFGFBhACAAAAA...NDAE.PAEAfHCH..hADAWECG....hACA...,2,-19,-7,12
NBfFWeSPcRLECKaAIYOGUgJbMHDTVZdXQ,OGDCUAEH..JFEEHADE.TCEAdDBEQAACBBACFDGDSDCDhAAARDDC.EDAFhABACHBGAHDD..IHAFhACA..YHEAgAGHMAHBDFIH.hACA.XFACNIDHfDDEhADAWADD,1,-20,-45,25
OWXCZMIFeBaAHcGSRQUVbTDNJPLgKfEdY,GGEFQGEEUCBA..VDDGDCFHJDHBLCAA.KAAHdHBDOAEGhAAACCHCZABA.FGHDBFBHhAAAAEIBHBEC.REBDNIAF..hACAfAGB.EEDFWAHH..MFABhACA.aADA...hADA...,2,-24,-6,18
VMaILCHDbZNGWAKYQXFfOJgTdcSRBEUeP,QGCDXCFBFDHDJCDG..dAEBRGFGBABFeECH...MDBDLDBChAAACHAA.DDAFZAECNCAFGFEHhABAADADKBCD.OHAChACATEGGEAHD.........hAAA......hADA...,2,-34,-6,28
NdbFHMeIZVDQLRcSPfTgJCKWUGBEYOAXa,XCCHaEDF.dFGCFHDGHFAGeADEZAEFDCCELAADRCAG.SGEBhACATCGG.CHDGKBHHhADAUGGGBAHFEDFDAABAMEFChAGAQGAG.fAHG..hAAA..WBBC..hBGA...,2,-17,-15,2
OgDQFBSfGKYUCTZLeIHbRAMWVPJNcXdaE,MDDCVGDE...JFCH..XADGdFFAECAG.DEDABABDGBAGKAGA.hAAAUDGBZDEE.eAEE.hACAIFCD..hAAAbEAFAHACNCEDaHFE.OEHFgGGBFADFSGADhAFA..CABE.hAHA...,2,-18,-18,0
YOfaWVSJCbBEALZHKIMcQTRXNUDFPdGeg,HGEEMACA.QFACRFBCUAGC.DBDGdBECeDDA.ODHHaBAF.SACChAAACGGBBDCCAEEGLHDGhAAAICCHTAGEhABAFEFE.......gECGhAFA..WFHH.hAGA...,1,-15,-34,19
HODYSEUJTgVGPBfebXLCZAdMINQWFRcaK,MDEFQEGFFCBE.aACFOBEC.DFHFEEBE.JAED..TDFAhAAAGGCBBAGFeBGDLEBDhABACHHGAHAEdBBCNAAC..hABAWFDDKDEH...SGGD..hACAgAGB.hADA.fADF.,2,-30,-5,25
QYgVcLWFXBdERJbAePISaNMKCDOTHZfUG,eHEESBAGMDFAKBCHCDBC..DFCFHAADZFGHGADDQAFE.hAAAVECGLHDAFEABBHBChAAAEGDGJEDEAFGD.aGAFNEIG.hACA..OCEE.......hADA......hAEA...,1,-12,-18,6
bHeKLRYIOWAEFVUQaGMSPJgCdBfNTDXZc,FHECQADFGDFAMGCCSGCB.JDCCCAGHBBAF..NEAA.hAAATDCADGEB.XBDAhAAAZFFHHBAE.LBGFhABARGAEIEAG.AADHECAAaFHD..PBHDhACA......hAEA...,2,-20,-11,9
EFBVMbDXcLWJZTUHfYORAQPNdgeKSaCGI,QAAEdDEGKDBF.SHDGGACEEHFGFGHHBFCF..bEFGXEGFhAAALDBHJAEATAFAhAAA.UADEfHCFhABAOEDDACHFNCAE.eDFG.CHAF.MFIBDDDF.hAHAWAHH....hACA...,1,8,-34,42
VKZYMXSWNRDdPUOCQHacLTJgfGbeEAFIB,FDDABHDAZBCEMBAF..SADCRBBDdFEFUBGDCHDE..HBGDLHFGhAAAJHFC.GEAC.hAAAEBDGAFIBIABBhAGAKDHF.XEBFDEDD.ODGHcFGEfHAFhAHA...hABA...,1,-22,-23,1
dMaJZGBXHQbUITEfgNPeALWDRcOYSKCFV,LFEDRDAFOGBC.SBDEFDDA.dACCMADGZCECBFGBHAGHUAABhABAEEAH...gFFFhAIA..NAAGAAIDhABADFCGKHAECHHC.aGCDXDGAIBGA.fGGGhAEA.WDDGhAFA...,2,-36,-16,20
eJXQbURCINFdaLMOWDZVgAPfKSBcYEGHT,KCFDBAGGEAAAGABB.eFCCJCCD..QFGFREGHCDED.FEAHaGDEhAAALHCEOEADDBIHhABAZACEADIB..SHAAhACA.HCFDTEDF.bCGFNIEHMCCDhAEA......hAFA...,2,-21,-11,10
FZCRdTIBaLXYUEfWcVeAGOMPNJbHKDgSQ,GFCHMDFD.JCEAKEBB.DBBCQCABZAFA.dGAETCAFBHHEaAHHhAAALHFE.XEGFhAAAEHEA.fEDEhABAcDDFABBDOABAbGAG.SAEAhAFACDDB.YDHBhAIA...,2,-23,-19,4
QCDOaEIURMLKSZAfcJFVTeHgdGXYBbNPW,JADHTBDBHGFC.GEAEBGCA....NADB.QDFHDDBD.hAAAECACUEEHMAFEKBAGSFDGhAAAAIBAFCGF..hABA.eHCEdFHAXAGEYCFC....hABA.WDBHCDDG.aHGC.hACA...,1,-11,-31,20
XJeFEYbNKQSfGCAUMBaVZITLcROPgdWDH,MCDFVEDB.ZAGFLCGDRABC..OGBEdCCADBAHHBEFeHBGEFHD.hAAA...NBBCKHGGSHEAhAAACAFF.AGEGaEADhABAIAHG..cCAFWAED...XEEAhACAYDHH..hABA...,1,-9,-34,25
TdZQgbDISRcCXWeOPKHLEYVBNAJGUMfFa,JFEAGACC.UEFDMHEAFAAB..dCFCQGAEDBGC.SCBDhACAREABCDHC.XGEEhAEAOBAHKDCC.LBBChAAAECHBBFDGAGAB.aBFB......hAFA......hAGA...,2,-43,-22,21
YBcgVDOINdTJRWQKZebPaSUXAfFGLEHCM,GCAHHADDCEFBBDGB..gEEDDHGEOGAEdABF.RCFEQGBBhAAAKDCAZABB.PAEChAEAaAGD..SFDEhAAAAIFGLFHFEEHF.MBAD.....hAHA......hAIA...,1,-13,-28,15
SeLXHdfcNRCDTJOMQZPUWVgbBEAaKFYIG,aBGCKDAHFHAAGEADLFDAdCDG....NHEB.DDHD.OCCBMAAFQEGFhABAUAGA.hAAA.VADBbAEDBHBGhACAAEEB.SBBDeEHHfABFCAHE..hABA......hAFA...,1,-8,-33,25
aQABDWMOKgIFTcdUSLNfYVbRZeJXCPGEH,DEIDOFHFKDAC.FGGHdHEBLBFH....fEGChAAAVABFRFDBZADFJDEH..CFCCEAGGhAAAHBFA.AHBGBECG.hABAMIAGIHCHUABBSFAG.hAFANAED......hAIA...,2,-27,-23,4
DZTdCNRQcEWBYebPOGJVFHSfLMIgAXKaU,aFBADACBdDEA.RDCH.EGFCBBAE..eBHF.OAFDJHDCHAGHSAAAhAAALDBDIBDChABAACID.KFEFZEGDCEAF.hADAQADD..cCCC.YHAAhAEA...hAAA...,1,-20,-32,12
QCaIdScVLKZJHWEPGXUBbDMfReTFgOYNA,CGEAaGADdGHA....SFGDLABBZEAGHBDFEEECXCAHhAAABDDEDBGHRCGHFFED.OAFFhABAADAHQGAE.hACA.IFCHKCHB...JACD...hAAA......hADA...,2,-41,-9,32
XWVBREcKZNMFTLaAgHGOQUPICbJdfDeYS,HCFAOBBFUFCC.CBDD.dBFBDEBESGEC..VEGDEEDEKADFhAAAMDACLGAGhABA.AIEAQCFHhACAIBBFfAEFYFHDWAFEBBHDZEEHTEAEhAEAaGBB.....hAAA...,2,-29,-7,22
HRJcGfgYOWAdKBZPaSbNDIMXEUCVeFTLQ,KFGEBGDFZBBHSBHBDABG..MIDGUCAG.eBGDLEABhAAARFGHGDEA..gFDGhAEAOAAAAFBDaHCCIEEEhAFACAFC..FDDBQAFA.cGGChAIAfADA.hBAA.WCFG.,2,-28,-17,11
PGVKgAMYFSQHBDReIdNOfUXaZECJWLTcb,FBFGQEEFDHFG.RDBFdADFOEDE.UEACXBAB.aAHHCCBBLAHBhAAA..hABAcGGF.GGCDhAAAKBDBAGDASADCBGAB.IEHChACAfBEEJHCC....hABA...,2,-36,-24,12
NaeILDUSEQRMCYAPWcXfBJdZKbHTVOFgG,...PCFHXEAEBDBGdGEFZACFHBCB.VAGFFFGCGGABhAAA.eHEADACDSGDDhAAAQBGFCAEEAEAGcGAChABAKAGETECFOEEGaBAE.IHHA.hABAEADE.....hBAA...,1,-9,-12,3
QFDEIUfNaYHALWZPcXbeVdGBCgTROKMJS,LEEDZABF.XCBFbCEE..eFFDdADBCFFGRFBEKAHH.MEAFhAAASCGD.DAAFhABAIBDEUGBENIEFHAGHhACAADAGPEHD.........hAGA......hAIA...,2,-24,-24,0
eNFAIgcaHWfbXSLYMVZGCQKBTDOUERPJd,..IHFHaGGFHABF...fGADSADBMEEBZFCBCCBBBBFBhAAADGFAUAFGEBEBPCGDhABAeDECFEGGAEDD..WADChAHA..LAADYFFF....hAIA......hBAA...,2,-27,-18,9
UcaOZGNBFWSCYJDTLeXIgEbAPKVHQRMdf,KCACHFDAQEGCdFBGUBDCOAGFGGDDBECHFAAE.CGCC.DFIDLCEEhAAA.eEAFIHGHhAAAEEEFAGBH.RDFGMDADhADAaADB....NAIASAEA..hABA......hACA...,1,-16,-25,9
QDJOFGZdIWKPUbXTMfSYLEAcCgHVNReBa,CADEHGDERAAH.eFEEBCGEaAGG..DIGGOCECZAED.dACGKEGGUFAH.hAAAXBADMGDA.SEBChAAAEECA.AHBF.hABA..gGBBNCIE.FCCGIHHAhAEA..WBHB.hAFA...,2,-41,-9,32
IReTCbFNgaYEUJHKdWDQXZPLAMGScOVBf,SBBHVDCE.BGCFRDADeDGH.CAHC.bBFD..FACB..NACH.hAAAaAFHUFFGHGEA.KGADhAAADIBA..XGBDhABALEBEAGDD.MIFE.OAHH.IBABhABA....hAIA...,2,-32,-15,17
OXNQIPRBECbdSUWDTHGcAeMYFLaJKVZgf,MGBCFDBBLAACKBFCZEFF.OFBE..QCBFRFGDBHCHECFFdAEChAAA.SHAEhABADHECHAEAACHHaEHH...JHDAhACAfGAEIEDDCBBB....WCBEhAEAcDAC..eEEAhAGA...,1,-18,-28,10
gQWdVbfRKFDMBNPSCcXTIAHLYGZaEeUJO,LCEDZBFAaCCB.eBAFUFECOBFA.QGAHdDDHVFAGREGFFHFGhAAA.BGCE.SGDHhABACEAC.cCBDhACAXADB.AAAF.HDFCEBAC.WFAC..hADA......hAEA...,1,-13,-27,14
WKTeNbRQHdLDYVEGOfFUMBgZIPXSAaJCc,CGDFKGGC.eACERBFAHCBDDGAF.EHEGGBGG.FBAGBABH.ZEFHXECGhAAA..SGAAhAAAADDHaDBB.cADBhABANIEH..QEECYDAF.OAFGhABAfEDDMCCC...hBDA...,2,-26,-19,7
NUGFEAdCLMgaJDIcWXYVQBeSOfHKPRTZb,LAEEMCDG.JDBEIEEF..XCFGVEBH.BEEDhAAASABFHFBEKBABTGFHhAAAZGFG..NIAFFABAhAIAdAGDCADFDCCA..cEGF.QCBDhAFAeBFGfEHCPHCC.hAHA...,1,-12,-26,14
IabeSZdCUfDEKgQTLNGYcXFWABVRHOPMJ,VCBGOEHD..MBFDaACG....SCCGCCGCDFFB.KGCGQGGAhAAALFBENAHAGFAHhABA.XACEhACAAFFGHBDCPAAFIAHAeFADdDHGEDAB..hADAgGEH.hAFA...,2,-17,-12,5
DQGOYWEZMIPaHXLARUgfbcJBSTFVKeNCd,RBCEUACA....gBGGfHDB..JHAEBAFH.FCEDhAAAVFEFKEGCCCHDDFAHOHAChABAEABHZDAH..MFAAhAFAIHHAHGFAADDHSDFB.NAEH.dBBGhAHA......hAIA...,1,-21,-24,3
SgYDOGHKaXBLZNJfVEFbITdAUcPRQMCWe,UAEBREBGQBDFMDEC..eFFASGBGDDCDHAAEKFGFBEFBZAADJAHBhAAAEFCC...FGEBIBHFhAAAAFIBCAGF...hADA..YHAEGDDHaEABNCAC..fGHChACA...hAEA...,2,-16,-15,1
JLfaDBYTeSUEVdXCIGQWNgHbFAKZcOMRP,KHDGZCCEMGBARBEELFADDIDG.BEED..eAAGUCABdHGB.CCAAGCFEhACAQEGA..hAAANAED...gABChABAFBHBAEED.OGBAfEHCaGGHSDDEhAEA....hAFA...,1,-24,-26,2
fPDeFCJNVacdGZBWEKOMHbYXRSILAgUTQ,TFBGQFDE.DDCFCBAA...JCHFVFFCdEAEZACCBDDH.ECBHKDDAhAAAHAGD..XGGFhABAIHEHAHBD.fDFChAAAFGCH.cGACOAFG..MABChAFAbBBGSDFBhADA...,1,-15,-27,12
aeZFQUDcGNVRgBbLKdJCPMOYXAITHfWES,TDDBHBFAEGEC.aECCeAAA.FBDBDCBFGGDHRDDEBGHBLFBDhAAA.KEGBJACEMAFDOHAGhAAAAEIH..IAHAhABA.fCGBSAGE....hABA......hACA...,1,-6,-32,26
VXUPgMWJaORCecFSHKIGdNDQYbfBTLEZA,XFFGUDGGMBED..aCEDCFFG...FHFESBBCKDBHGACCDFCEhAAAQDGF.hABAfGBDTGBAEAEGhACAAICAPBFAJDAB.OCAB..cGEHhADAdAAH.....hABA...,1,-13,-34,21
VHCEXdJMLPRUOfKNABWZcDITQbgYSFGae,BCEFZDCADBCCQAGB..gBFESACAFHGAGCFChAAAaAGA.HCAD.CGHGXFBAhABAdFDCJBAHMEAFhAAAPEEHUEGAKHAEAIDAIHBF...hACA.YHDGECCE.hABA...,1,-5,-25,20
IaROVSdQFNZWHABegEfKGMcTUXDbJPLYC,eDHDEDAAGABHMBFCUAAADAIF...JBDDPBGB..CEFARGAASFAHhAAA.FGHFhABANFAD.HFDGAADHBHHDKHBGcECGhACA....XGDH.hAEA......hAFA...,2,-37,-16,21
PUcYbfDOBVKaJZWMRHAQXeLCdGTgNIESF,QDBGLGAECBEGdFGEGAEB..TABBIHCB.FHEGUDABhAAA...bFDFfBAChAAADAIH.OCGDhABABBADaCHHWFADMIFEACCAgEEGhACASDEG.PHAC.hADA...,2,-26,-17,9
GcWOLeVaUYBNXMdIRSfTQHgFPZDCKbEJA,GGDFOCFHLAAGaDEHUCGE.BDDG.MAIDdDBASBAFhAAA.TGAFQGDChABAFBCGDAFEKGCF.EAEAhACAAEABeBECYEAB.IGHC..hAEA......hAHA...,1,-14,-32,18
CfAaMITQVHYdNOcbSReXDGPEBKFZJWgUL,MBIBQFEEHBCBdGGAOFBG..SAFGRBDBeABHDIGEEFECKAGDhAAAFHAAZDGH..gAADhACACAEEABAA.TEAGhADANIAD.XGDCBCHEWDADfCEBhAEA.aEEG....hAGA...,1,-12,-20,8
BIaFUWODgLKeSVCAYXHcRTfMPZQJGdbEN,XGGGRAEFMHDC.ZFEDGCBE.dDGHNACC.BADH.FFEAUAFFDHAA.hAAAKDFE.eBDFCHGAAEEG.HGAEhAAA...fEAAhABAJBABEBGA...IEHA.OEDFhADA....hAEA...,1,-19,-32,13
LHVKCOFaXQEBbYRGfdMAZcJSPIgDTUNWe,JCDCSFDA..IFEHDAFFUCEB.eEBHLBADHBAAKGHDhAAACHEGFGBGQAGEhABABCBERAGD.dDHAMFAGAGAF.hACAZDDA...gGGH.NAAB..hADA......hAEA...,2,-26,-19,7
HbDNcYXAFRVaPfKgdMCLWIBEZSeUGTJOQ,VBCGaGGH..KDFFdFBBLCHHBFEDZAFHUABGGGEB..JEBDHBAFhAAADAFE...NEAC.XGDHhAAAFEEA.RADG.fHBDhABACDGB.EDHFeDDF....hAIA......hBAA...,1,-8,-29,21
VIDBJLWTfRgNOYZaEbSeGMUKdcHCQAPXF,FCGEDIBCBECBLEBC..TGEFRFGDOGCAZFBG...aCFBSBEBhAAAMADB.dBAACCBCAHBChAAAXEAG.IDHChABAWAEE.fDDDNBAC.EACF.hABAeFFEKHEA....hACA...,1,-25,-34,9
bYNfVXgBCQKZTPcHFeaAdSRLGIUWEOJDM,dFFCRCFBLADAUACC.EAAFJAEE..DICC..MFDF..bECE.hAAA...fCFAhABAXCDBBHGHCEHFKCBD.hAIAPEHF.cCABFBHFAEDEIHHHhBAA..OFAC.hBBANHCH...,2,-41,-18,23
MAZSWcaUDXYBPVEHfTgFJRKCGNILdbQeO,SGBHaFFA.UEEGDCEHXBBGBGAF.EDBCTADB.hAAAFFHFKCFDGBBEIAHFhABALCADQGEDhACAeHEEAGDDcGBEPBHFfFAB.hAAAJADCCEDD...NDIC..hABA...,2,-15,-12,3
SbgWcEOJABIVNFKYaPXUfeCDQLGZMHdTR,VFEBFHDCKHGE....aEFAUCEC.eADEDDDDLBAAGCACHDGFhAAAdAFASEBBhAAA..bDCDWAGHhABAcABC..JEAHIBHBNEIE.XGAGhACAfADDCFFD.MAIFhACA..,1,-19,-21,2
OVgfTEdGKCbLYWcMXaJHIRQNSUPFADBZe,DFIBeFAGOBFC..fAEEdFFDGFADCBABLEEC.hAAA.YCAAMAHDXCAAhAAAJDFAHABGIGFHhABANEAD.SDCHFHACAHHFBAFCZGAA.gACDhAFA.EHGAhAGA...,1,-14,-19,5
dTaOeHQJcZYEGPVDWKRNbMCfXISBgULFA,aGDFOECAHDFE.QCCGJAEGZBFE.EADGGGDB.DEADKHFGRAAF.hAAAMBAC.XAGHhAAASDGCBGBDLADFhACAAFAEdFHETCAAeFFE.cEEC..YHBAhAIA...hABA...,1,-8,-14,6
dBZLPOcSbEXFRTfDYWQNIeaHCGKVgMJAU,BBGHLFABODAHSHCG.EACAXGFA.FDGBRCCDDGGGhAAAQAAAIHFChABAaGAECAHCKBEG.VCGHhACAgDBDAHIH.dDDDcEDETACB.WHAAhAAA.NEIE....hAFA...,1,-17,-24,7
eOXgPcBaYVGNCdJIQbEZHAWUFDMRLSfKT,FGCEMDEBLDFAKBGG.ODAB..XACG.PFGBhAAABBHDVBCA.CHAGJFGHhAAAIGBC.bDAEhABAECBBAFAB.DBAA.fEEETDGBeBDAaHDE.hABANIBFdGDH....hADA...,2,-27,-25,2
WLdgeGXADYNMIJHPbfKFQCBEVRacTUSZO,DAABMEAHHBDB....fEBHQCGAECGARGFCaBGGUGGFZGAEhABALHBAdBBCGEAFhACAAACFNGBD.IFFC.hAAA.PEFAKAECBDAGcBAHSGEDhADAOBEBWADE...hAHA...,1,-1,-12,11
VQaEMIUWgOcALTKRCGdZXBJDHPFSeYfbN,LBCETADF.CDGCZECHBFFGHGFAFDCGeHAG..fAFBhAAA.VEADQCGAhAAAMABAUEFBOBAHhABAACDB.KFDBdAHEJFHDDDIHSAGE..hACA...YFAEhADA.aBBC,1,-11,-14,3
DgJfOLZNSdTGBEcCIHYMPaXeKAUVRQbFW,UFGEQCDAFCAD.DAFA..JFDCODBFLBFASFFChAAA.dHEBBDEAEEADCDGBIFAFhAAAMBBC..XGBEhABAKHACACEF..VABGWCAC..fHDFhABANAIEcGGF...hACA...,2,-40,-26,14
VOYFgJNcTMWZEebKGfPRSXaABQDdUCIHL,QBAGdDGHCAGBHBEDLCACOHBG.FGBFJAFA....TGGFhAAAMDDFEFEBKDAAGEBFhABAfCED.RACCXGFDhAAAaHDEAAIHDFGC.UCGC.YFFC.hACAcDADWABA...hADA...,1,-3,-17,14
bQPJMOEGUcLRgCAVYeWSBHFaITXfKDNZd,eEHHBBHCFEAG..TCDFKGFEDHDAdFEF.QAGC.JACGhAAAOFCA.UGABhAAARBAGCGBCAIAC..VADB.hABA.SGEHaABB.IDGFNIEF.hADA...ZDDC.MDIBhAFA..,1,-28,-30,2
LYBbfDaSUIcAKNXZEJOGRHCVFgPMedQWT,XGFBEBEEGDFEHCCECBCG.FEEB..MDBHdHDDQGAGhAAALFDDBDEADECDUAEFADDDNDAA.hAAAZCAB.OAHD.hABAgDGBPCHF.WBAC....hABA......hACA...,1,-4,-27,23
ISNPUAJHLbCQgZDeGEOMXdVWRKBcYfTaF,HAFGLFCACDFGZBAHDIDEGFAHEBFG..MHDCVFGH..KCABBACFhAAA..fCHAhAAAFCCCIHDDSDEChABA.PBBGACIHQADEgEFB.hABAOFAH..WFFDhAGA..,1,-13,-32,19
EQdaOZKfXeCcAHRBPWYGbLSFNMIDVJTUg,HBDABFFC...PEGHGBCCLCABSEAEMEFDDGHDJFDBTFAAhAAAUGAF..EAAGdBAChABAOAEAfDGEhACACHHDADFC.RAFG..bFDHNBIE........hADA......hAEA...,1,-7,-20,13
GCePQYFTEfNUZLcJRDASBOHbWKadMIgVX,BDGGOABEHACAKDFB.MFEH..VGCACHCHQBGAFAFA.EBAFhAAAUDCBZEEH.JHFGAHAGSEAGhABA.aECFhACAICAA.gCGBXGGH.GEAAhAAAYCCGfFGHhABA.,1,-7,-35,28
NBKUWaAEITeHSYbgVLJcXPQOZfDCRGdMF,TDFAeDCAHFFD.SDBC..YCCHbBFH.VAFEhAAALHCE.cAAChABAPCAFOADAhACADHDCCBAFGFAHMDIFBAHEKHFGWCEFAHBDIFCDhBCAXFGA....hABA...,2,-24,8,32
eZacLREKXDTdQMWbSPJIGBNCFOVfUHAgY,eCEHZCCFaFFGLBHH.REAAKBBBXAEAdGFE.MEAH.SGGHhAAAIAAHBBEFhACAFGDHODBDUGCE.ABAD..hADA.YFHHDBBFWBHD......hABA......hACA...,1,-22,-33,11
XROLJdCWIKaUgQGMTSecNFHYbVDPfAEZB,EAFHZAAHBGCDRFAH.LDGHCFHC.KFAEUBBAGCEGMIDA.eGEGhAAAFAECHACB..bEDEhABADIAG.AHHCOAHFhACAdCHC.aEDHQCEF...SEAFhACANIEH...hAGA...,1,-13,-20,7
aUGBYJLWHTXCEcKQIZbDFNdgPSVOfMRAe,UFDCBBDGJBHDHEAD.CFGD.KCBBZBCH..FFAAdAGE...SAAChADAOFFF.MIEEAAEHGBEGhAAALAEF.XDGAhAIAEGED..IBAHDBBF.NIAD..hBFA....PDDHhABA..,1,-20,-41,21
QAVRHSXWgPceMIbUCENKOdBZTGfYJLFaD,HCBHXFFG..PABAeCAH..IEDACHDBKCGABAHH.ZFDChAAATGCH.GAAHhAAAJAEDFHAEDIAEAHHCSHFGhAGAcEGFMIEAEEFCdAHA.fFAChABA.aCEC....hADA...,2,-23,-15,8
WPLSVOeIaZNUTRQFXcGgBEDbfYHJKdACM,MCABLHBE.SDCEOHEGeEBBaABE.ZBDA.UEGFQEFGhAAAFAAA.XFAChABAgAGBDGIDfECGhACAJEDBACCB.WBEA.IAEFNIAH.hADA......hAEA...,2,-24,-16,8
LHPdQSgKADEUbMGFIcaYNCBOfTRXWJeVZ,EAEBUBECGECAFHFC...aBDHCBCHBEFE..TBAARFAD.XBGGhAAAJEHH.eEFHhABALDAEdGHESFAHhACAAIDG.DIEAIAHH....hAAAYAFCNABD..hADAOEEB.,1,1,-45,46
eCVGEcBZdSLMXPOFKIbNaARQgYUDWTJHf,QAADUBBEDFGG.JADCeCEB.GAFCEEEGZBFGLAHH.hAAAMAAHXFGD.hABAODBHIHEAaHBGAGEDhACAREBB...gDCDTGGACAEFBHBG.hAGASEEDFDGGNIEF.hAHA...,2,-15,-11,4
KIfMcCVPSJLTEWgRXaeFDBAdQHUGYNZbO,QAFFHBCD.UFFBNDFAOHBEKBCE.MAGHCDGB...SEAAhAAATCAE.gEGDhABAaAAGeDDHDBIFAHBGdAHGhACAGGAFZFAE.fEAE..cADFhAFA....hBAA...,2,-19,-17,2
LeIWcDJOGTQYbURMCdZEHfKNFVPXASgBa,BHAGLDDAeFFG..IEAHDADDOEBFGBDF.QGFEhAAAUBAFRBEFdBGEEHDGKGEFNBAHFAGGhABA..XDGAhAAAgCAEaHFE.WCHH.....cFADhACA....hADA...,2,-28,-15,13
LfYRITZFaEMKVWXBNDUGCPJObgAQdSceH,SDDGeCEGHABGLFBERGDCZADG.EGBHMAABKGGG...XCGBhABABHEADAACUFACCDDAOAFChAEAADIHdBBG..fHGHhACAIEHAaGCD..WDFB...hAFA......hAHA...,1,-18,-23,5
YgOSNTVCdIERJaPefHWcGAFUDLKBZQbMX,DFDHKFEEQAAHMBAH..XCFCODDESEBHhAAA.TAEEVGFCCCHEEHDChACAaGBHeAHFHBBBWEADhADAAGEBFAFFBCDDbEFANAABIHGF...JDHBhAEA.fGCChAGA...,2,-15,-15,0
bSTgUGPdBDeMKfHAQRVXICOLcWEYNJFZa,VBEHCGHGLCCF..EBHDJBEGFDBG.ZFGD..SGFDhAAAUGAAdHDDBAAFDDHFKEAHABBB.QDDFhABA.XGAGhACAcACB.NCIG.aEEC......hACA......hAFA...,2,-32,-31,1
eTUIVBaCZYFAXPKdcfGLWgMESODNHRQbJ,XGCCdEBCGFDHLAFCMFAF..SCFBOEFCDECARACCQDDGhAAAeBCEUGGABFDGhAAAaHEC.CBAD.FBHFKDACfBAEhABAEBHD..NEAG.....JDHHhACA.IHHA.hABA...,2,-24,0,24
HaQAIWdVZXKRJFgLfeTCDbPMBOGcESNYU,dDCBZEDEKBFHFFGHLAGH..eAHFCBBEDFIBMEAE.OABDhAAAEGBA.SADChABAUADGQFDGAIHG..hAAAIGAA.WCHH.RBDD.JBAFfGGFhAGA.bFBHBFBFhABA.NICF,1,-32,-34,2
LWCXVHYefZMPTQgKDcESNGIROdJbFaABU,UEEHLBCDCHGC.HFFD.eCGBMDEATFBBQAAF.DCIFhABASEAFGDBERADAdEAChADAFBADAAHEBHBDXDDDhAAA.fBHE.....hAEA......hAGA...,2,-28,-8,20
AJHfLEIRCUQgKaYSMNGFWDBZbOcVdTPXe,HFFAECFCREDA.CHABUFCG..QFGEKBCB.SGEHhAAAMEDGFCGABAAFZGAGOAEEhABAdAEB.TDBFXCADhACAAFAGfBBC.LADFIHHC.hACA....aBFH.hAFA...,2,-29,-11,18
NTBKFYQVfASDdHMWECPUROegbZIGcLXJa,DABHdEAFHDGBECBC.UGBHOFDDeCDC.ZFEFGEBCLAAD.aBBGhACABAGF.KGFEFAGFQBEGhAAAAHHHMAIBCDFG.PEEAhACA..........hADA......hAEA...,2,-35,-9,26
cOWfSCaHeQLdYPGFJANRBXIgbMUVEKTDZ,RDBCBFDD..XDGDIBBAMIEC.EEADKEFE.ZDAB.OAHDhAAAfGBA.CBBBHADGhAAALHFAdFDDPAHFhABAJHAEAADF..bAFD...TFGDDDAGWGEAhACAaDEH..eDCF.hADA...,1,-14,-20,6
SNaHRIAGDBfPZdYeLCVXUbOTFgWKQcEMJ,DDGGBHDDZDAGdBEFLEFFCFGB.UGACOFFH.FCCFKADG.ECAGMADGhAAA...SEHBhABAaAAEREGH.AFDAGCAAhACAPBFE..eCCEbCFC......hAAA......hABA...,1,-26,-31,5
NabUTBcESJLPYfgZOWeIRKXGQACHdDFMV,dBBCFABDMBHFaBED..UEAABFDH..SEGFJHAGLBDA.hAAA...fEHAhABAgDEEZGAGeDAAhAAA.KHGEXFEH.ABIFDACANADH.cAFFhAHA.EDDBYFFGhABAIHHE.,2,-35,-28,7
IHKLTadPAcGNCOYRBQXeJZSUWbfFDgVEM,GDEAOCHHRFADBHBD.eAFGSFDGUACC....fGHGhAAADCBHEDCEMCADIBAGhABAKHGEaAAG.AECDCEFCQEBChAHA.XGCAWCCEFAHFgDGEhAIA...hADA...,1,-13,-34,21
OaYDFMcKAWTZBbgQUEGVNfdCeLJPISHXR,TAADZBFCBEDB.QEBHEDFEGCDA...VEBFdGEECEHBeADEhAAAJAFC.SGFHhACAHBAGOABAaAGADBHF.MCIFhBDAAHDF..bFFB.NDDB.fFHG.hAAAICCH..hBEA...,1,-9,-17,8
CUHONLdaQJfVTYFgcIDRGWbPSXeEKBMZA,CAGBUCDDHEADOGCGdHFH..JFEA..TBAGFAED...IFHGhAAADCDBRABH..GCEDhAAAbEAH.SBADhABA.EHCEMHECABIHaEHFfAGB.hADAYADA.cDFEhABA.,1,-13,-48,35
YCGJRBFSMNPQXDIeLHVEfUbWgTKOcZdaA,CCFCJBBDBFHH..MFEGQEAC.DGDDIHGE.HBFDhAAAVAADEGAEUFEB.hABA.bACBTDCFKCED.hAFAOHFEdHDDAHAF.RCGBSAFCNCIAeFBG.fADAhAAA..hACA...,2,-32,-9,23
ZQUPRaYWXbGITNeAgfCDdcVJOMHSBKEFL,CDAFDDEDdGCH..JHACMDCCBABC..FFGGLBEGZAAC..UCFGhABAaDFC....XGDBhAAAIAFG.eFFDhACAADCD....cACGHEBCKAHB.EHAGPFHDhAFA...WFFHhAGA..,1,-27,-47,20
PDWUQOgIXEKRLBYaTNbeAMFcfdSVCGHJZ,FGCBdDFBSAGGCBBE.HEABJEFFDACAUBBC.QGGEhAAA.OHAEIDBEhAAAEFFHKEDBLFAF.hABAaCFENCEFADAD.MACAfAEC.ZEGH.hAHAPDDF...hAIA...,2,-42,-6,36
LfNSYZHGMPJKBdbTagODFAXQVIeUcCEWR,VFDEeAEECFFA..RCACLBFA..NEBAZCCGMAFEKEHDBACHdAAH.hABA..TDFFaGEHDCGDhADAAHHFQGBGhAAA.IBAAEBCCfECCSECCYAHBhAHA....hBFA...,1,-15,-38,23
JaBAfTICYVSUbZWMQDLPFHNEXOKcGedgR,TBDGCHHH..SGFEZCACMDIHDAAALDFAHGEA.EHCAXGBBhADAKECAGBBH.dGAGhAAAJEEEAAEH.IBBChAEA.UBFGQAFBFGAH.cCAH.hAFA......hAGA...,1,-9,-20,11
HIcJTFZQEGYVSfaBCWDReKNPMbXALUdOg,UDAGODEGHBGF.JCEDFAGA.EDBHGABF..VFCDaAGGCGEDDCIBhAAA.KFGBMEID.AAAGdFGAhACAICAHZFAE.SBAEhABA.fAFEBFFD.WFFFhACANIBF.....hAEA...,1,-14,-30,16
XBgYSUCfeFKdIPTGZAEMbODNVcWHLQJRa,MBADOCCCDHDA..VAAAHCBH.LEEAJECG.RBEABHAF.hAAASGHDfDGDhADAFEADIGED.hAAAPFAH.TGGAABCGNICD.QAEBhAFAXCGA.....hABA..gGCD,2,-26,-14,12
YEKCJIODAbeRHVQdLcWXgfFTPSBGNZMaU,RAEFVFGBdBHCLCCF..XAFCFEEC.SDGEhAAABDAHZEGFMIFAaECCUABHEGCE.hAAAJHCADIAAADDB..eEABhACA.QEEG..WBAC.fGABhABA..hACA...,2,-37,-11,26
VdHbXaNfJgKCGPIUZcMTeRQAOYSLWBEDF,SDDEBDGGFFGGHFAA..aFAFJABDCDAHGECC..IDCGhAAAZABATFGE.QAGHhAAAOAECLHCGhABADDCHdHEFNACB.fCHGPEEHMCFCAIHEEEFHhAIA......hBAA...,1,-8,-30,22
cOHdWCPKESUaJTARLQeYbMZNBDfVGIgFX,RFBHLBFBQEEEeDAE.MEHBZAFDDHFCGECBFDAB...OHBGhAAAdAACCDHA.EEABUCCBJACEAAIHhABA....NBBB.BBBDhACA..IHDE.....hAGA......hAHA...,2,-28,-20,8
McdYeVFONECQbgJILaRBGKWPfDHTSAXZU,ZBGBMDIDdACE.eCFFVDEAFGGC...EBEACBADQFCC.hAAAJHDEaFAD.BEAFGEAChAAAPEDHDBBATAEFhABAADIHUBAC.OCAE...bFGD.IAHEhACA....hADA...,2,-25,-15,10
TOGVaPXecfMNCQUJgKBYZRHLbIFdWEASD,TEBBGFDFaEAG..eHBAMBFCCHGHQDDFUBABKFAG.BCAChAAA.ZBEALEEChAAAFFAHdGGFAHFHDICGOCHDPCFAhABAXABFfBDENAEH.YHAE.hBAA......hBBA...,2,-11,-10,1
PIEbCWBUYLNdcTVeAXFfDaHSGRgJMQZKO,XBDFDGECHGBCGBGCRBFF.MAFFZGACKFFGODABECBE..CBACBHHEhAAAUDBALABGhAAA.dGHGVDABAFFE.FFCEhABASDEGJHEA.......hACA......hADA...,2,-22,-10,12
KgHaGBbQAWMPFDeNSXTfUEYJIOdVcZCRL,MHECFCBCDAEF..SDGE..XEFETBDFECAGIGDChAAAOHAE.dDDHVBFFhABAZFFACEGGLAFEhACAKEAHaAHDBABHAIDGeFHHfAGC...hADA......hBAA...,1,-12,-37,25
LCYHTBDPVKgdURaMXcNQASJbFZIfOGeWE,JCCAFDFAZDBC..OHBAeFAALGFCHBFADBAD.KAHDdGFC.UEBBhAAAMBAG...NIED.AHHASAFChABA.hAAA.IBFGfEGFWCADCEEABCBD.hABA...gBCAhACA.,1,-28,-37,9
SVTNeCGBJRaLKAbDgHEQYIfXPdOFUMcWZ,DCBAEDDG.QEFF..IGGB.XGBCPACGOCEGhAAAMEIFZCABSGAHhABATFDEeAHDBHGAhAGAJADEaGDCADAHHCFH.fABFdDDGFAHFWFBBhBAACAAF.....hAIA...,2,-19,-13,6
IHPCNAVdbSKEeQTaOcBMLZRYJgFfXDWUG,dDADKGEDEDAFQFDF.OCFABFBCZADCRBDB.JCEHFABC.DEFCUDGFhAAAHGAE..CHBAAABESFHDhAAA.aFAGhADAMCDH...gAGBfGFCXGGAhAEA.IBBAhAFA.,1,-11,-47,36
XaPGNcVCMdAJOeWUDQfBbRSFLHZKEgYTI,JBDDeFDG.DCBDQDGDBGHH.RFDBLEABZADAEEHH..TGAFhAAAICBA.aAFDPCDEhABA..cAAGhAAAMIDCOEEA.WCCFfGHAhADA..SAGBhACAKHBA..,2,-32,-19,13
DdQRaJPOFWUYTBgKSHGCMAIeLVbXEfcNZ,LADEXFEC.EEDH....fCBBNIDHZCFB.DBFBdEBCaFHDhAAA.OGAGUCDHBBADhAAASABACBHEAHFAeDHBhABAbBDD....cDFDJHAE.FAHB.YEAAhABAKFGB.MIDG.hACA...,2,-19,-7,12
TKOCVJUfcaHRWSQDNbLdEeXBIgGZPMYAF,KFAACFEDUFAG..aDEGRAAB...QGEEDDGELACEeDHDBDEHhAAAIABA.ZAEAMICChAGAAHHCFCCG...OAAHhADAfGGH..cGCBSECHhAHANFCB.dBED...hAFAEDBC..,1,-26,-32,6
WeYDgJVUKFbORZHGcPQaBEAfMNLITXCSd,MCDGLBEF.TGBCCAHDdFBG..eFEBDBAB..JAHFVAAD.FAEAhAAARDFHHDAEGDFAPHDChAAAaEDB.BCCFAADF.IHHEhABASHGA...WDHB..hACA......hAIA...,2,-22,-18,4
VUETbeDIHBPMZKXLNdCJWQORYfFGgASac,aADEVDFD..UDAFEDDF...eAACHFCGBCCEZBAHKAHDLCGHhAAACCFCQADGOGBGRGEAFGHHhAAAAFDA...SGAGhABATDEFDDIFMIDAdAGB.WCAD....hACA......hAFA...,2,-17,-9,8
QOYCJdPZHEVUTIRLgAcMWFNefGaSBbDKX,MHFCFFDCeBAAGCCDBGADDGBF..KHCEXABA..QAFEhAAAOAFGCHEGdCACHDDGhABAEEFEUGGA.IEBDhACALBFAAADGNBICaEAE...SAAChAEA...YDHHhBEA.,2,-24,-23,1
DgSPNJdcbKGFACfTZOEXWaILURBQYVMeH,CCDEZGEC.EHAEaDFALCBFBAHA...VADBeABDHDEADCAH.SBGChAAAJEAD..dGEEhAAAKFGAFGGEAHDDOGAAhABA..IGCA.REEGMBDA..hACA......hADA...,2,-37,-10,27
NSZCbLJfIBHVGEOQYPWUdTDXFKgaReMcA,SECHZCFELFAH.JGEABCCB.GGEFQBBG..hAAAYAAGUAEATAGBhABADEFFKCEEREFG.eHBEAEBGCHEG.hACAIAHF..EDDHOEAH..hAAA.dEGF....hABA...,2,-28,-13,15
dIHYAMENXcTWCaVJBRDQeSfGKOgbULPZF,MEIFXFBC..TGDAaFGA.BFAFDDEBQACDeECAGAAChAAAKAECOBGFUGEELAAHhACAPCDCZFGHIDFDhAHAAICAEGAF..WADCCHDC....JAHBfFFEhACAFDCH..hAHA...,2,-14,-10,4
AGeRaZDKJbWLTgHdOcUVfQBXISPCYEFMN,RCEDaDGDZABE.DHCAKFCH...JBBBLFAF.HDCDdGEDOAFFhAAAUGFDQCABhAAABBHBSACE.CEEG.hABAEEGCFHGEAGIB...eDDETBGA..cFABhAFA..fFBAhABA,1,-13,-46,33
UaKCfWJVHPQDZYdTSNIAEFOBMcXRgbGLe,FHEGBHBGMBEDRCABGAADLDAHUFDG..CFEG...JCDCHDGBDFGG.hAAAZAEF.dBBF.NDDE.IHHHhABAAHCB.OAEGhADA..cGGDXCGDeAHB..KGBChAIAWAAC....hAGA...,1,-23,-26,3
VBQIdJeDTSAaMfbGERKcCUPWHFLNZYXgO,aCAAMEEEGCFEKAHD.UFDCHEAD.FFHHLAEEZEDC..XCGAhAAAODAHBCEGdGCFeBAGhABADAIFACHHECDARDBACHGA..hAAAPACC.NIAB.gGBD..hABA......hACA...,2,-23,-2,21
LHPINWVDAFERZOXMTJecbaBQgGKUdYSfC,RFFGOFGFMAGD...JAHHeFBA..aGAGBAEBGADEdBCFSCDGhAAACEGF.LCHBhABAIBAHVCABAAACFDBGhACAEHAEZFDB..cGECbAFD.KEEE...hADA......hAFA...,1,-8,-29,21
KABTcEHCfegFZbPGYORMJXdWQDaSLVINU,BGFATECBEADG.HCBCCCBH..eFAHZGBEGAGCOCAH.MIDGdAGEDGGAhAAASFFCLHFGhABAIFAFKDHHAICC.fBADhAAAgABCFECHbCEG.....hABA......hACA...,2,-15,-11,4
cHJQPWCNfGAETLDSFKVUdXZRBYIaMgOeb,TFGBDGDHFACB..KDFGUAEB.dFDHRFAHBEHH..IABHhAAA.MBHDeAEFHDABhADAJFFH.QCDBhAFACEAF.NIABAHACSAAD.XDCGhABAaCCH.OAGF..hAEA...,1,-5,-48,43
KBeTgfVJaPASLWQNEYIcRZDUFCGdOXbMH,SEGDQECAEFEG..ICGBRBEADBDGUAABGCBB.OHBChAAAMICEKGHDBACDTGABhABAgFED.hADAJAFGaAGALEAH.YEHHcEAB.hAEAFECHCEHB.XBAGhABA...,2,-15,-10,5
KSdPAOFDgCNfXZIMHeYcGUJRbWQVBELTa,OCDCFGFDDABE...CHDD...XGCGMBDAHBABeAEE.GCDBhAAARFGFQFECBECAEBCEhAHAaBHBKEGHdAAF.ACIFfGADhADAIHHC.YFACJBBF...hAIA......hBAA...,1,-10,-28,18
LOVEAdgJZeTKIMXfQHNacFSCURBPDWbGY,JAGFeHEA.KBFHMECF..QABHHCDCaACE.FFFBUAACBEDFDFFChADAGEACLGEGEDHHAAIHhAAAdFACZADH..XDGEhAFAfHCH.NBACCCHF..WHAA..hAHA....OCCBhABA..,2,-23,-4,19
ETMJDSQBYURIbXNfCHaWcAVGFLOdKgZeP,FACDLCCHOGAEKEGFZDEDeAED...TDACDEBFBDGH.UGGEhAAAIHAB.bGCGhAAANAIG..HAEE..hABAcBABAAGGdDDA.EAGBSCAF..hACA.YHCGfHGFhABA.aDGA,2,-31,-13,18
QXKfcSFEZUNObRTDdMeaIPYBWCVJAGgHL,HBACXEAGKEECSFBCZDBC.OADCTGCA.DAHBdGDBMDDGhAAAaGCH...IFFDhABABGADCHHDAIFGLHFGhACAfEHAFEGAUADH..bBEE.eDAGhAAA...WAFE.hAEA...,1,-12,-20,8
EecXaFKTWCUBMGIRHPZYDALdJgONQVfbS,dGGHOBDHQCEB..fFBGSDAGeCFHXBBEhAAAFAEBTFGHCABHUFBHBFCBhAAAMCIHIDHEhABAHAFCZEEEDDABAIAE.JBBH.NIBDEAGEKGEB.....hABA..WEED..hACA...,1,2,-21,23
PCbFcMgBQNfZRADHVGTXJYeWOadLIUEKS,DBCDHFFGGBEFJBGD.eFDGOFAHLBADEDDA.KHEA..SCAFhAAACHAGFFAG.MECBhABABDDCQABEhAEA.fBEHAGHETDGAWAAEIHECPHBAhAEA.....hAFA...,1,-23,-25,2
OYBXaeGRfdILKWZEHSNFDUPJMQgbTVcAC,CDCAODADBBED...eHCGGDFAdCECKAGCZGAEECGEHDFB.FBBADFIB.hAAAUAAEJFHB..MDDFhABAQDAE..hADAgAEEbAFE..cFDFAIBG..hAEAaHEA.fBHChACALHEG..,2,-23,-11,12
VIfHaZRMOFdQcYBAgbCGNEePTLDSKJXWU,CAGCECHB..eFAALCBGDHCG.SFFHKDEC.JAFBUCACVEAEhAAAHEEC.aBFEMIAGhABAOADBdEEAQABAhAEABABFAFAA..........hAFA......hAHA...,2,-39,-15,24
LGbgTVIOPHEJBeAFQcKXdRUSfYCNWDZMa,FCAHQFGHKECB.RBBFUBGBSEFD..CEDFDCABZAGDaGBBLFCAhAAAGBBD..TGAAhABAIAFD.OABGhAAAPBEFEDHFBEHEAHGC.dHDFNICH.MAFEbEDD.hBAA......hBBA...,2,-20,-11,9
bKPVEdYINGUWeFaDCAQMgSTZOLcBRXJfH,QDEDSADBZCBDLAEGRDDD.XFAAHDGDKGCD.EGFGIBCFhAAAUAFA.FFGDCCAGABBAhAAAMBAH.OHCChABABAHH.fCDH.PBHF.YBBFhACANIDB...hABA..WFHH,1,-2,-25,23
TWaQVFEZeYIcLUOdHGbSMXNJKPgfCDARB,TFDEaFDH..FBDFEGFHZEFF..eHAE..IGBAUDBEdAAFhADAHAFCbDEA.XCABhAAAKBEB..gAGHhAEADIGCADDFBABCWDHHYCFA...LFAFhADASBBAJEEF.hAEACHHH...,1,0,-20,20
VcMCEGfFSZBdLPTaNORHeXIJQUYAKDWgb,KFECDAGC.....bADGMAEB.EBFEFCFEBFDBdEAELEHDhAAA.aBBBOCHD.hABAHDEDIHBAQABGhAAAAIDE.WDACgCDFCGHDfFAHhADA.SHBChAFA...,1,-28,-38,10
KaYfUHMgcROCbQWNDGBIFLAJTXZedVEPS,XFABdDFCEHDG.KEDFaEEH..UGFAHAFA.MBCBRGCA..CCBEQCEDhAAADBBHBDADFGGDAGADZCGHhABAPCHF.SFADhAAAfAEBcACAOABC..WFCDhABAIDAC...hAEA...,1,-19,-24,5
XNLSHOKEefUVdTZbDPgIYWAFRaMcBCGJQ,FAEAMCEGBBCCGCBD.QFEELGDGHECCKFAG.EDEGUGGChAAAdAACZBECDACA..gDGBhABAIDCFAEIHaBHFCHBA.hACA...JDAFXGBASAHBeBBCfHGHhADA..hBBA...,2,-24,-4,20
JGZacRFVUWKBIDAEeXQNdYbfgPSOHCLTM,EEDAeGAG.QEFDdGCB..fDBBPDAEHBFECBCDLAGHhAAAMCAGJADEZFFAaDDAFFABhABAUGGFKBEBBHHG.hAAAACAB.XECANIBB.......hACA......hADA...,2,-23,2,25
dIZCeSWEacUMDXJBPRVgLKFNGAOTbYHfQ,OFBDTBFB.HACAQDDFZFEFCAAE.eEAESAGF.aDGFhACAMHAE.DHFEBEAAhAEAVAAFKGGCNCIC.AECCfFDEhAFAdADEIFGHEDDE.......hAAA......hACA...,1,-17,-19,2
PCgUNZKGdIMbDTAOFJLYXEfHaVeBRWSQc,ODFBFDAALEFB.EGDDfEAF.aABCBCCB.SACAhAAAQGABCCHAUGAHhABAKHDAIAEHhAAADDEAAHHFJAFEHGFC.RECBcBGHPECC.NDAD...hACA......hADA...,1,-15,-29,14
gWFaONdTILCRHUXYKMQVDSZPbcJfGEABe,BBGCeHEAFDFHOCFBdHABLDCHRADH.UAEBKABAMGAA.DHFGhAAAZBAE...PDHDhAAAJBHDEDABAABB..aBGD.hABA.IHAACFAF.XEGA..hADA..YEEFhACASEED.,2,-43,-18,25
eAfLYFPREQMZKCSJWXgVUHOTDaGIbBNcd,LECHFGHHEGBD.QCFFKEEC.SBCEJGDC.XGAFhAAAVBCFUAFCHFEHDBAFhAAAIHGF.BBAAhABA.NADFeEHDABIDfEAA.PDHDhABAMBFCCCDG....hACAWHDG.,1,5,-48,53
TYaCWIOGfZALKdJHDbcSEMQFgNPeRUVXB,LEAEJFECHDADDCBCSADE.QBBBFDHF..PACChAAAUGDBBHBE.hABAaGHDCHBGIGCAhACAOEFGfAGDKCDHdCFC.bDDBEHFG.MFADgBGGhAAA...hAFA...,1,-10,-28,18
JGbaURgDfENBXFTSYdeVIPKWQLACZcMHO,CDFGMHDCHCBHGCEEUABF.DGCB..EBFGXDBDFGFB..SFAGhAAAdDGAeABGIHAHhAAAKBEF.LAFChADAAHEDZDGHJHAEaBBC.fGGBBEEG...hACA.YAHH.hAEA...,1,-19,-20,1
EZCKHBaeNMYUGQFdVfSJcPAXIRgWbTDLO,RBFG..bACCDBAE.EFEBZECH.KFFHBECF..eCDBMADEUAGFFBCD.hAAAVFAF..SEHFhABAJBAFADIB.IHBHhACA..WEGBLBEFCAAB...hADAaGGH.YFDFhAHAdCFH...,2,-40,-14,26
dKAcLVRfPXbYEGaUDJCHFeZBTWISQNgOM,VCEARBCH..XDGBEHFC.UFGBCHAGFBBBBAFF....IBHFhAAASBAGQEBGhABAOGBEKDAGAGFD.hACALFCEfADBPAAAbEEE.aAHHDEIHeBFFhAEAWGBAMIAEdCDC..hAIA...,1,-13,-19,6
MbVGPKFBLNAefRIYcgHOQXTESaZCJDdUW,RABE..IHGF..cFGAHCABXGDDEFFD.aDCAJFBDhAAAUGACMIECGABFhAAAFEDDLDAGACFFeAHBfFGFhABAgAGCOBFHTDFCCECHDCIF..hABA...WFAF.hACA...,2,-11,-7,4
XZeNcOTJFIRLSAHKdMEgWGaCQBPYfUVbD,dCFBMCEEEEBGGFDD.CEDH.BGDH...fFFGVABHDDHHZDAEhAAAeFHDOFAFFDDCIHBFhAAASGHHKAFGaACAhABA..PADAYCBE...UDGDhAFANICB.....hABA...,1,-12,-23,11
XKbRYZUPVHWcdOGaBDCESTIeFfJgMLNAQ,KFDDRGDGUEFFHGEG.dACGGBCABGAEDAEF..SABCeCGFFDBD.hAAAJBEA.LEAHhAAAAAFFQDDA.XGBDhABAbCFA....YAFC..hAEA......hBAA...,2,-27,-26,1
FMgDVLCNefdKBOHYAQXaEbTZWGSJIPcRU,aHBETGEAGDBG..SBBGJBDE..IFHCPFADUDDBhAAAMEFF.DDGECBCFeAHHhAAAdAEGBEGF.OCABhABAAHIBEGAFZDDB..cEGDFBAFLHEGhABAfGCGKDAD....hACA...,1,2,-28,30
VARZUSaINbPTEWDeLgJGFQOYcCBfHMXdK,RGAAUGFB..IEEF..PBCETFGHDDGBLAEHhAAAGEAAFHCAOBBCCAAHHAFChAAAdEGFKBGEACAE.aDADEDEFeHDChABA...........hACA......hADA...,1,-12,-30,18
MSLGcKgbRCfBHDEIOZFPWaJNAYXQVUTde,XFCEQCFAUAGDeHAA.LBEFKHFERFAB.CAHAHFFCDBAB.OBADhAAAFDAE.aDCDAIHC.TFAFhABAdDFEMCCA.SAABhACAcACB...fDHGhADABHDA...EDDH..hAEA...,2,-30,4,34
EVgIFMYbULXSGBeOQPKWZTJfCRDcHadNA,VCFFFCHBMADG..UCCELDCHGFAHBGHCQGGAKGDGZABC.hAAAJAADCEEC...DAFBaHAChACA..dAHEAFFFEAGHIEAFhAAA..XGFHOHBE..WFFDhACAfCFG..hAIA...,1,-13,-38,25
WZKBNJMFTAHRGLdbQgODfCEYPeXUacISV,HDCFRBEFdAAG.QBCHDHBG.EAGGeEAAXEADaGHB..SHEGhACAVEGHKAAEBGEHhADAMIAE.TAEAADGB..hAEALADE.bCGDfCHGCEED.hAHA......hAIA...,1,-1,-28,27
MGDXfVQbaPTNSKEAZILBYcWdOgeFJUHCR,ZDDFLECFBAGF.......YHAAWFCD.dAAHeABDhAAAJFFDHCDGRBEG.DAFGXDGEhACAQBGBaGGC.hADANEIA.KFABAEED..IDAC..cADBhAIAgACH.CHGH.hABA..fHDD,2,-30,-24,6
dXFAGTVeWYQKEJgNSfHORUCMaDZcbBILP,VFEEeBBEQCEA.EHCCNCDFHGBEOFAFCACG...MIFGhAAAZDAEBADELGFGdAGFAIDGhAAATCGBKDGC.gEBBhABAfFAFaADADFIHIAHH.FCAEhACA.WEEGSBAGhABA..,2,-21,-4,17
RgQTAfCVEOeZDSJHNWPLXYdIUbcKMFBaG,CECHEEEEZDGDDFAAHBAF......PABCXFEFdGBHUGEGhAAAKHCCBBFH.RACBTFAAhAAAAIAEOCEG.eEHFSAHFhABAJBAHLAHB.ICCDMIFEFAEGhACAaGHD.....hBAA...,2,-19,-15,4
fZIcbJTMeKgXCaFVdALPBGQNOEHSUYWDR,BDABQBFDEAGFUEEFDFFBRADF..ZFAE..IGAHJCBC.MEFChAAAeAAG.KFHHCDBEFGDBhABAABFH..LHDGhACA..NFADSHAA.fHGFhACAbCFA...gABAhAFA,2,-39,-19,20
RLUAdIeMHKTabNSFCQcBPWXGYgDJVEOZf,eFBDHFFBTBDH..aBBDSFDEFECDCABCBHFDXAGAhAAAGBEHDDDAECBHOCFEhABAZFEELEFEUFAEIEHGhACAMDAHKGHH.NADHQGCC.WDDGhBAA......hBBA...,2,-22,2,24
LWIKcPYbedUJZSCTDHFfOgQXAaGMRNEBV,aDCEMDHF.REBH.EDFHLCAGKFAG....PBDCeAFEJEFHCCCDHEGFhAAAFGDB..OBEChAAAQFDDAGIDBBBGIDAChABA...YHAAdDEFSABEhAEAfABH...hAIA...,1,-16,-24,8
LRfDEMBSIJNgZUYWcCPHQeVTGOFdaKbXA,REGFEBGDMBBEBBED...JFAFZBFA.UEDE......WEEHhAAAPDAFHDBEeHBEhAAATABAOCAA.FAGEhABAdGGEaGAHKFDD.AICADBADSDFBNAEH..hACAYCHBCECD..hABA...,1,-11,-34,23
DXaPBFAcIeWJMHCgTdYZRONEGQSbUVKfL,eAEDMFGBHCFECFHC.dDCEZAGFOHAAGABGQADBSDGGUAABhABAKFFHDIGG.aFBDBEHChAEA.AGBCIFEHhAGA.JFHBTEDA.YDABEAGA.hBIAfAAC.hCBA..XGCH,2,-16,-8,8
QGeSEBOMTDANFJIUYfcWXaRPVZHbLgdCK,FCEHJFEA.UCAD....fAGCXGBDREGHZCCC.LCHDhAAACAFFGDCGSBAFhABA.BGAAMFFBTDADhACAAHAHNBGE.IGDH.WBCEaAAEPEADhAAA....hABA...,2,-28,-22,6
AQSIJWHFbYMCDgNfdOcRBLaXKUTVGEZPe,SFGCJFAAHADFFAACMEDH..DGFB..fFBCOFDGBAHDhACAaBAHUCCH.GAEDhAAAEDACeEHFAEFHICHChABAbGAC.CBBCdGEGLDDAKEAD....hADA......hAFA...,1,-8,-24,16
VaEXGFKIgBbdDcOCfYLQSNRPMATHJZWUe,TGAFHCDHZBAF.UEGDaHDE.EBGCGECD.KADHBHAEdCGFDCCDOFAAhAAACAAA.LHEChABA.SACBhAEAPCADMEHDJAEG.......eAFA.hAIA......hBCA...,2,-18,-17,1
FgWLYXcMZCVTDbGUIRAaJfOHKBeENPdSQ,JEBBOACDBACC..EEFFdFDBFCEALHAA..XGAChAAAMEGFZAAHCHEFDCABGAEAREBAABGC.hABAHAGHKHFA.eFHH.hACASCHHgEGH....cACEhAGA.....hAEA...,1,-8,-33,25
ZJfWPCcgNOMXaIHARKbLGdVUDYEQFTeSB,KAABLEEFGDFCdAEGUECGDGHH..ECGHFAHD..eCACBAFGJDBD.hAAA...fEABhACACAAE..NDIAXGAEhACAICCDAADGbAFAQGAC.SHDEhAGAWFDD.cBDFhAHAMFGB,2,-42,-32,10
bJRPAcXYSgDZKVLBWUMaFCfTQeGdHOINE,XGCHSDEHZBBAKCGDBEHE..UCCGaGEG.CGGD...QBGHhAAAeDAHGADFdDBHIAFDhABAEGAHJAAEADIB.gEAGhACADEHFLHCAMHFA.fACHhAHA.OEEE.hAAA...,1,-5,-25,20
SdIZLaUAJBOeXFRGTNKCHfYPEbMDWgQVc,JAEAODAA.FBFEGBAF.KCEGHEBC.PABEEEBCDGEBQGFBhAAA.SCGAhABAIFGAaFHDAEACXEGEhAEA.TGAAfCHCMEEE.WDADhAAA.....hAFA...,2,-45,-16,29
dFEfNRGTHWPeOIBUbXYVMKZCAgJaQSLcD,JBEESGDGLFEDDBCH..EHFERDABHADB.eFFGIAAChACABGBHUAGF.XAABhADAVCGHMFADZDDGCHADgCDGhADA.cEAF...fDBBhAEA..hAFANIDH.WGFE.,2,-18,-12,6
HQSRaYBMPcWZVFTLbAXNUGCEKJDIOgdef,XECBUDEDCBGB.KEGADCDB....IAHEdCACeHFC.HABEhAAAQGGHRFAA.aGBDhAAABFHGMDBH.cABEhABAZGCG...FAEELAFE.AIDE.EGDFhACA.ODDA..hAEA.SCFE.,1,-7,-25,18
gMePQOZJYVbULWfDNHESBAKGCdaFTRXcI,GDADCDFDFCAH.RFCH....IBDAeBAEQFFEZAFB.VFAAhAAALFAD.DABEhAAANCEBHEDHEFFAAHEHaFHD.hABA..XCGHMIEC..PAFG.hAEAOFHF...hAFA...,2,-21,-9,12
OCQIfTdbEVcHLRaYeMXWKAPUGgSFJBNZD,UCAGSBCAFCFCBFBEDFDG....CHCDQGFG..hAAAIGFGTEAAbAEDhABAEAAAHDDE.aBHFeDHBhACAMIFAXAGH.KGEDAAHEPADBhAAAJDBA.OEHDfGAGhADAcGAA.,2,-43,-5,38
WRQUGbDdZHaNPEcgOLCVAFJeSKMTXYIBf,FBBBSGAHMBEE...TFCEXECFBBFFREFHGGAHdFHGaABB.hAAAEEAFODCELADFhAAACDAHACHC.KCFF..ICCEhADAfFHCQGEEDBIBNIEB....hAEA......hAFA...,1,-5,-29,24
YPEZAWfQITHDCNMaOGVXSgeRbcLJKUBdF,QEDGHEBFCEGC.aCEAVDDH..SEBHeADGRFGFLHBGhAAAJAHFKBBCBEAEdCBHFAGAEBADhAAAABAH....WFAFhABAIHGA.DFAH.MGFG.XDFEhABA.....hACA...,2,-19,-16,3
BQJFGcbYICTEZVdULXODHWgSMafAKNeRP,KABBRBDHBGHGFGBDGEDD..bFDACDCBZCEGdCHGLEAA.OHBEhAAADAFD..gEAHhAAASABAaADBABADeCAAhABA..PHEEcGAG..YAHHhABAEAGG....hAGA...,2,-39,-13,26
TCMREaHIgYdWAfSOUPcBKDNLVGFbeXJQZ,SEFHOCGHUEAGBEBF.DHGELFHFFGCD..eCDFJHAGTFDHhAAACAFA.RACGHCCHhABAIFHHdAHCAGIDfCFChAAAKBBF.VABH.....XFAChABAMIDE.EBHB.hACA..YHEA,2,-24,-12,12
ZEGQDBHeWdPFRcXCAbTNgJMYaLVIfSUOK,TBDHJDDF..aCFBLGDE.IFBDSAHF.ODAHhAAAEEEADIBCBGHFeAHBhAAAdCCFFCAERGAC.CHHBNABFMIFEhABA....YCHFUDGCKACA...hAGA......hAIA...,1,-25,-26,1
EaJfVFIGdBQYeARPOHbDcZNTCWMSLKXgU,RBCGOGEADDAEZDGD..CBGB..MFABKBAEUEBB..EEEG.JAEDFAHFhAAAdCBFBGEF...hAAAQGAFAABA.hADA.PDFA.HGCENACF.TDBDSEEEhABA....hBEA...,2,-41,-24,17
ZCEVNGQWOaKHdbYTMSfcgJeIADXUFLPRB,UDAAFCEBRAAHBADGEFHHGGAF..QFAEOHDEHAEEdDGA.TEEDhAAAMCDF..SGEBhAAAfACGJAFGAFDBDAIFhABA.XCEE......hADA......hAEA...,1,-10,-37,27
DeZUXVGOaWbfRITPEBMcAQgYJFHdLCNKS,QDBHJCACHBEBdGFCLBCE.CFEHKBGDeAAAZAABUEBB.GCGAhAAAaDHH..fHAHhAAAIAGAEADHMIDEhADAAIAEFGCHDEAHOGFC.....WAHBhAEA.....hABA...,1,-14,-19,5
VXOMNELPJZbeATHURfgWDCBFKYdISQcGa,HADAUBBFREFB..fHDHDDHBBEDB.KCBD.dCCEQGBAhAAAGDGEXAAC.OGAAhABAECFCJAFEeCFHACEB.hABA.TEAACAHHFHAC.SACE.aFHDhAFANFAH......hBAA...,1,4,-34,38
fELDXHbgWKUYMNGTdFaceOVPBCQSZARIJ,JBDALEABHDCB...bADFKGHH.UBAAMEGDGGABFCAE.eFEChAAAVAFHBAGD.CHGD.SEHFhAAA.AHDBIFDHhABAEEAHDACE.WFEHNAIGaHDE....hABA......hAFA...,1,-18,-20,2
gUeGHbfVYCcJMNOXZIaKFSRDBTEdLWQAP,UEBBeECDGDDEHAGB..VEEGCCBFMIEAOBCGZAFBKADD.FCHBDDDEhAAABGHBEFHHLABFhADA.AIEE.bEADfGBChAEA........cAABhAAA....hAEA...,1,-14,-29,15
RIBQdDCUJHEMLfgGSFTNPYbZXWAacVKeO,VECDeAEEOCBG.BGDADBCACAAFHDFHLEADGEBD.SBHHhAAAFHGG.PHFGhABAZCECAFFCaBFCKHAEIACChAHAdCAHEFGA....MBIFfCEFhAIA..NIAH....hBAA...,2,-24,-13,11
gQLRSTZUAGEXDedWYFIaMKCBNfJcHObVP,EDBDXEDDdGBC.FBDCaDFC..KFHDBAEB..JHDGOAAA.hAAAVGDGPBGB.QFABhABALAHDSDDHhAGATCBDADEADCABWBBAMBIBCFFE..fHGHhBAA..cABGhAEA.,1,-22,-35,13
FMaeIELHBQYVcXRTZdGPJSAbUKWOCfDNg,UBAGOHECDFIBFBCH..MAEBeFBA.EGDABCGF..QBEBhAAAVDEB.XCAHhABAZGAAdFBD.PFFGAACAKHFE.hAAACAHC..fGAG.NACB.IAFGhABALDEG....hBAA...,2,-39,-10,29
eaNOVfXBKCATYEWRbgIdLMQZGJUcFHPSD,EFBERCEG....IBDELHFAZAAHJDDAFEGDHAFE.DBBHaDDHOEGDhAAA..VAFGhACABGDHAGIB.TACA.hADA.YFEBWHAGdEACQFAB.hABA......hACA...,2,-23,-23,0
UXYQDPZbJAWNeLTIfBMRdHagKGSFcCEVO,eADATCADBDEE.dFHAHAEFKDAA.SGGEFCHD.EEFGVECGhAAAXACF.DHAEZGBAhABAAFFFLAGHMACBaHAC.hADAgAAE.CHEFYDDFQGFAhAEA.JBFGNBICfEBAhAIA.,1,-12,-13,1
YXZaWgUVJFMTDbOdNAGCELKRQIceHPSBf,GECGECDHKFDC.RABDQCFH.eHFESFAHBFFH.fCFGhAAAXAFCaGABhAAAUGFCFDAHMDAB.DHDGhABA.OCHHAFIFCEEG.LACC...hABAIDBG..hAGA...,1,-12,-34,22
YMXUbeBZdNLVQKaFJRASfgGOTPIcHCEDW,SCEBGEBHOEHH..TFGF..cCECCAFDDGFDMDBHhAAAXBGEeBACZAABdAHChABALAEAKGCFFCCBAEEDPGDChAAAIDGEEGAE..WACH....hAFA......hAGA...,2,-21,-14,7
EcNLYWRABCJbgeKVTXUSfFIOdPHDMGQZa,BABHCCBA.JFBCeCFE.KEEC..XBEHSFBGFHDCdDABDBABGGDBhAAAZBAA.aEABEHGAhAAALBCHREFG.AFDE.hABAbAGBTEGH.IHAFOFABMBIFhABA......hADA...,2,-22,-20,2
OYKTZELCdQaBgUWAFIePJGHSMbRXVDNcf,eDEDJDEBHFBFMCCDRAAE.DAID......NIDH.OBABKAHHZBDELEHFhAAA.QAFFhABAgFGGACHHPFCDhACASDGBXGEAfDABYDABhADACAEDBFAEWBBE...hAAA...,1,-9,-31,22
fCUTBHcMDVgZOPSeLAQRXbJGNYIFadWEK,XDDFGGDH..ICBAdBDBEFGBKGDBCDDEBAAHHAAB..MADAhAAADEAHZBFD.SCHHhAAAeBEAAACFQFBGhAHAJECBFGADaFHFfEFB.cBGE.hACA...OFFHhADA...,1,-7,-21,14
RVNIaATSbKgYfJFPBCLQEUMGZXHcOeWdD,SAAGKFDD..gCDFJBEGBHHALDEBEAFE.UFAGhABAZFFAXEAGhAAAHCGFeCAEdCGADICAVBABaAEGABIDhACA..YHFAFGGBCDAA.MABA.OHAChAHA...WCHHhAIA...,1,-12,-18,6
cSTIOfDEHJUZbMBXAWQFVdNaeLCgYPGRK,FHDGVFFGdBCD..eFBCCDBE.....PCEDGFEH.KCFDTAFDhAAAOEAC.DCHBHDAEhABAUAGHMHAE.BDGBhACAAEEF.WACHaHACLAAEYHCG.SHFAhAEA..IBBEhAEA,2,-39,-5,34
VTaFWIANeGYDZgOMCcRbBKLdJPXESUHfQ,eDCCDHBCZABEOHAC..CFEBRBFFBEEDLDCHJAEC..EHDESFAFhAAAUGGHHDFGQGGBhABATABA.aDACFDAFhAAA.AGDE...NICD........hABA......hADA...,1,-19,-30,11
DIQOgRKHLdJFVTNEXbcZPUWafMBGCAeYS,SBABQAGARACGHFABdHDH.FHDG..TDGEXAFBZEACUGGChAAAaFDGBHHGAEDE.DGGDICCHhABAKAEFLDCAhAAA.NCAG.EGAF.cCACfEGGCFEG..hABA......hACA...,2,-20,-8,12
BNaPCgOdHXWKJITQMDcUbfZYeEALGRVFS,LHDGRBBFFFABBBEBaACB...CAGD.dEEGHEFAKACE...JDCFQGGGhAAAMDBD.DGCBbDDFhAAA..ZCFB.EHEAAHHCSADHhABA..NEDGOBHDICGChAFA......hAHA...,1,-27,-30,3
facMgbTIXJSNGReLFYPUHOKACDEQWdZVB,DADAQDCDZDDEBBEEaHGC..MDCH..gGDD.hAAAIAFDJBBASAGFhABARCAFFBHHUAAHHEFGAFGCEDFHhABAdHBDfCAG.TFDCXADHhADANIEBeAHFPHAECGGG.hACA...,2,-23,2,25
EVHTKcUFYdgIaBbNPOLXZDGeSJWCAfRQM,QAGFMEFFHCFGKFAHFHACdGFF..IHHEaDDABDHB..PAAFhAAAOCBD.XFBAhAAAZCCFDGCB..SAFBhACACEGDAABFEBCE.cEGEYACC.NEEA.eBEFhADA.fAHGhAEA..,2,-30,-9,21
GEZPSdICReNHAJVKYUgXcMLTfObBQDaFW,JHFAVAAG..UEFF..XFBFLBAFOBGBBFDCQAFDhAAAFHACEFFF..SCDChAAAdDEFCCCG.NADHAFEAhAIAKFAB...cGCCMIDCfGHChBEA.aDHFWAHB.hBFA...,2,-37,-24,13
CXLeUGJAWKTYODbZdMgBacQFNEfHSRVPI,TGEEDFIFZCFHdCAH.BAFCaAGE..FCAG.ECDDHEAH.RECH.IHADhAAACDDBLABEGEBAhABAAFFB.KEGB.OAEFhACAMAHF.cGGE.fDFCPHEA.eABAhAGA.....hAAA...,1,4,-35,39
CFISBHLaJcXePdZETAUGMRgYONfKWVDbQ,MICERFBFOEDCKGEE..DCDGQACB.FGHBBGAHLBFAhAAAJCGFeBAHZDAEAHEEGDBHhAAA..gBADhABA.fEGDbAFECGHEIACBaGAB..hABA......hAEA...,2,-39,-6,33
KXGLeWDdNaYUCIBQbAgMTEfRJFHVSZOPc,TAFHEACCRDEH..FAEDHCEAZCAD.ODCF.KGFBXGBDeBACdFABhAAAaDHBCEGDBDHH.AADAMIBGhABAfDDC.hACASGDGPEEH.cAABWHAC.DBGB.hAFANIEHIAHG.hAHA...,1,-11,-18,7
bIJTZKCWQSPgVDUEHdcXOefGRBYAMLaNF,LAGFFFDF.JEHBTAFCZFDA.KCABQACB..SFFBhAAAVCDF.DHAChABAEBAEHCDEdHCHOFAHhAAAfDHCBFBDAEADMICE..aDACIACFhAEA.CHGH..gEBFhAFA,1,-23,-25,2
QPMIBALJOVbFKRGZDNHEeWgaXcTCUdYfS,JCFDODAC.FABAKECBGBCHZBBGHEGB..eFDDaFAF...XCFAhAAACHCFdABD.fGFDhAEA.QGAGhAFAMIFEBAGGAAHFLFEE...hAAA......hACA...,2,-42,-8,34
WIgbLKABCTUXJeSRdfaHFQVDcNMOEYZPG,TFDCUFBFeDCC.RFFE.dDHAHACEFCFHDBBHMIBE..EDCCZAAFGEAChAAA..gAGAhACALACEBHHCCHFESEFChAEAfFFB.aCCG.....hAFA......hAGA...,2,-18,-14,4
eNDXPJKEMGOZTFYHcRBVCfaUQWISbdgLA,eCCHXFAEKCABGFBBZDDG..FAACHBFHBBFFCHHAUAADQFFAhACA.SHDEhADAdFFEAAEH.DBDBPCHFhABAEBHHOAFA..YAFC...hAEA......hBEA...,1,-15,-27,12
fFcTDPQZHgNLUKEWARdGXSaMBJVeOIYCb,RFEAdDDFGCADSFGGBBGC..eFAAOABACEAB.FDGCDFIFZEBHHDEAhAAALBFGKHAC.AHAFXAAGhAFAaHFE.MEEFhAGAIBAG.fHCFPHFA.NAIC.WHBGhAHA.....hABA...,2,-26,-12,14
cQJGeBOVXLYCMgWfDRPUSEIZaKdNHTbFA,QFGBJCFEBGEE.OBACLDCD..MAFB..fACDhAAADIDEUECBIAHFhAAAZEFHdAFHHBAAFCHDAHCHeEABhABAXDAFCEHA..WHEGSGAHhABAKEDG.NAGG.....hACA...,2,-28,-17,11
FOHKfLGagPDVXeUbYEdATcSWZMQBJICRN,TDGESAFF.MEADBAEF.CDBHFABGOCGDHBCALDCChAAAGEECaAGDDIEAeGCC.hAAAbBAGEEDF.AIACZGAAIGHChABAKGHF...fECF..hACA......hADA...,1,-11,-26,15
MALNGfYIZbHSgaBUJdXCEKDeQcORPWFTV,GDAD..YBEEIAAB.HFAHSCCHBCHAdAFACHEEEDADhAAAeFGB.OACFhACAPHAETGEE.AFDEfDGGhAEAbEGDaEDDXFACKAHFDGIBRCFHWABHhABA......hADA...,1,1,-26,27
aWNUQgbGfBOeSCRAHcDdPJIZVFKMXTYEL,HCAHdHEHJEBDZEEA.KBGH.MFDF..XEGAEGBFLBAE.hAAAaAFGUCBB.gGCFhABAfDEBOAHBhACACGHAAIEEDHEG..IADA...FAFBhAIA.WEEBNEAA...hAAA...,1,-21,-30,9
AgRbaYTBJOXMQIVWcPKNSZEDULGfHeCdF,RAEGaAAFBHDH..OCGFMFGF...VFAD..PBBHKEEHZFCHhACADAGALAEHGCEGeBHHhAAAFGFDADCE..bDACJDCDhABA.IHHH.NCAC.EACF....hAGA......hAHA...,2,-21,-20,1
PNGSWVaIZJRDdULeXMCOAfgbFBYEQcHKT,...fHCDbGACBEBE.ECBBHACB.KEGBTFACGEECSAAGhABAaBFBZAADDCGFdHFHeFAGhAAAXEGGCHDA.AGDEgADAhACAFGHD.cDEBNBIGIEDDhAEAJAHD......hAFA...,2,-3,-3,0
TMCcLbUGDdQeRAIEJSOBKgXPNfVWYHaFZ,JFGFSBCGBAGG.KFBB....XDGFNDEH..fEFFhAAAVACD.HFGBhABAaGEFFAAHMEAB.CBHDLEEFhACAUFBFDICEeCEFIDBD.EADCOEAAhABAWFCH.....hADA...,2,-29,-26,3
ePRGXgdKHUENVaIFLQTWMOcDSZYbJfACB,BBCGRFAFGEDDdHEBKEAHUABB..EHAC..aGGCFECHLAGB.hAAAQBEFMFFGDCAHSBDBhABAZCAC.hAAAJAHDAEADCEHB..eDDB...XGGBhACANICD.....hACA...,2,-30,-18,12
XYOANcQdgLHaUZIMBDSJRbFEKeVPCWfTG,QCADdFAALDACUBEBMFCCBEGD.DABESACA.hAAAJEHBbFDHKCEA.eHAAhAAA..CBHFfGGEhAEA.XFBCACCENEGGHAGFaDDEIBAAhABAECHHWAFC....hBAA...,2,-32,-15,17
WaIgYXKdfZBRTJPAEUQGObNMHcVFSCLDe,UBDGQBCDOGFGMBECHBFH..VEEGFCAFCAHALFAG.hAAADIGEaHAC..YABEhAAAdDHGfEEBhABA.ZFAABBHARABB.TGDFAHHE...EHAGhAFANIEB...cCFAhAGA...,1,-6,-24,18
QadCfNYKLSWRPTDgMBOUEeAGZVFHbXJIc,GEBBZECHFEGDHAAEJAHF.QCDAdBEA.CCHB.NGEF.LEAFhAAA.SCAGhACAPGACDCCAMBGFBBAC.EDBAhAAAAFIHbFBH..IHHBaFFH.KHDA.WEEEhABA.....hADA...,2,-28,-8,20
JMKBCdFEDIXPWSOeGLbTcVfRHQZUaNYgA,MHACCDGGFCBC.DGFC....XEDHSBBFGEAELBEEhAAA.bDDAVGFA.RAEDZAAAhABANIEHAEHE.BHDD.IECChACAOFAEeDBC..fAHAhADA.....hABA...,2,-32,-15,17
SQbaLZXYOEfIFVcCDReTNWPKgMGUdHAJB,JBAHBGAC.QAFELCCFZGBAOFGDEFFB.FHEC..CHGARAEAeDAAhAAA...TEEAhABAPDEEKBDH.MFCBdAHAAFIHhAAASCAC.aDGA.fABFhAEA.....hABA...,2,-35,-8,27
WcKYZOJUdMERHfQgVGLNFaeSAPTXDIBCb,TAEDDICEBGEC..CBCF.....bAEGKDDFZEDEUGDE.MFHFhAAARBBFQGGGGCAALAGHhABAFFAB..SCFFhAAAAGIFIEFBYCHDOCHDECDEfBAChABA...hACA...,1,-23,-27,4
CUMSATdfOeGbFYWgLXNQIBHZJcREaDVKP,dGAAeHCCGCGGFFEG.....gDCBXEBFQBAHhAAABAAHZCEFJCAHRDGDaBDGVGDAhAAACAHBUGGF.ADFAOFABhABAYAFC.NBCF......IHHEhACAEDDGDAEAPBFChACASGCF.,2,-20,0,20
JUQLgTCVAMFXaESNcIKGPYdODfWZeBHRb,MDFFXFGH..aAGEEBHD..SEHBIDEA.GCAFhAAAdEAAOCBGDFBEZBEABCFBhAAAHGDAJEFDQGAGhABALABACAHEAGGCFABEKGBGYDDFeHFA...hAEA......hAFA...,1,-2,-15,13
GJDXRMESPFgZNAIacbVHUfLeCTdBWKOQY,aAACVDGFHCDB.LHCAeFAHdAECKBGAQGCAGDFGDCACMCCFhAAAEEAE...FABAZFAGACGC.hAGAIADDUDDHCHHDBAGHhAIAOEHD.....YAFD.hBAA......hBBA...,1,-1,-18,17
GUHOXMTQAeKZSCIEYBcfRFdaDVgPbLNJW,ZBFECEBB.EDHHBBGB.RGFE.FHBGdBCBDCDD....VDFC..PCBHhAAALCAF.JEDHhAAAUGFD.OFABhABAXGAATABE.AEEGKAEDSABC.hADA......hAFA...,1,-30,-37,7
fOTRFcXZaYgLIMPBdSQGbAWEUKHVJCNDe,UEFEKFADHDBFCCDD.eCHH..OCAHFAAEZGFC..aFBGLEDBhAAAMBCD.BHAHdHBDSFHBhAAAbAEGACCG.EAGAhABANDDHDIFARFDD....XCGAIDAA.hACA......hADA...,2,-29,-12,17
ARQJSNULKEXFVeYPbWTCgdfaIOBcZDHGM,RCCGSGFGLFBFEFCCFACE....VDDAeAGB...PBABhAAATFBBdEGC.aGDEBCAEhAAADBBC.MDID.ACCHNCEDhABAKGHH......YAFECHFHIBEChABAOHDC...hACA...,1,-22,-23,1
IRUNJdVCXATecEDYgFPQaHMbGBWLfZOKS,TACHeFFCDBHB.FGCHaDDC..HCBGGGCHBHAGLFGHOAFGKAADhABASFAG.hACAICEBNEEAdBCFCHGGADGBYAHBhAAA.QBAHMCFD.WBFBhABAZEAC...JEAC..hACA...,2,-14,-14,0
PHgKZaDOJYCEQceBWTIVbdFMURNSfAGXL,LCHFHCBEZBFADGIBOBADCFEG...EDDAeAACBGGE..TDFGhAAAIAHHdGBGMEADhAEARGAASEAGAEID.PACAhAAAKBCEaGGH..YFEFWFDD...hAFAFCCB.NBGG....hAGA...,1,-13,-21,8
PgNQIDULYeaBJfHcXMVbKZWEdAGCTORSF,CBDFTDAFRFCF..FDEE....PEDEQDAGDAFDLBBEhAAAaGHB.BGADHAGBMIAGhABAKGAEEABAGCGCOEFEhAAAgGDG.NDCHIHHD.hABA.eAEH.fCCEhAEA,1,-17,-26,9
UKdTDNGQZYAIbEMHfRWcaLPFOVJCSeXBg,EGEGHGBERDCF.aFFDLABBODDC...CEAHeBGDBHHCUAFF.dEABhAAADHAGQABGhADAACIBMEIF.fDGBhAEAPHCCFEFCSFDGKADBNAAG......hAGA......hAIA...,2,-17,-16,1
gIMBYeFETXdCANfDbLJUGZKVWHPOQScaR,DFBAJEAAGBDBZACAKGGG.HEEA..QEDCSABHRBABMBGBhAAAeHECEADA..dGAFAHBB.hAAA.fDHGhABA.LGAEWHFGOHBE.aBHFBDDBhADA......hAGAFEHF.CCED,2,-28,-11,17
WMTSFRVdOEAHCBLQaKbJNeZGDUPfXgcIY,BFGEQBBAKHCG.JEEFZAEC.GCEADBEAUGAE..XBBBhAAA..gDFGhAAAIFAAMAIHFCFAdGGEhABAAEDDCDGBaAFA.eCADPBAHfECE.hABA.cGGD..hACA...,2,-38,-14,24
PCcUMGOdBfZgEARDLbKWYIJXNFeVSHaTQ,DBDCKGEB....IDCDNFCH..FGADeEDHHAGD.QCCHhAAACHAEUADEGAGABHGDfGEChABA.hAAAEDABLBAD.bFFFWACC.XEGFhAGASFBC..hABAaGCF..,1,-18,-34,16
TEAMSNPbDCFgKBXVGdRYIWUfOeJLaZHcQ,MFFDSDEF..PECHCHDCFFEEKCCEBGAF.GEGEdEAGRDGD..hAAA.IDDG.hAAAfACBOBFEeDAEhABA.aGBDHBBEcABGTBFD.AIDCDAFChABA......hAEA...,1,-23,-28,5
CZKTGFNVRagMLQWEPBIAfDdeHcSOYbXUJ,dBEDeFGFHCBBOBACXFBAUDAE..CCEC.TFEBGGAB.FFDGNIBD.hAAA..RBGB.MCHDLAAChAEAEGHDBBACAAGCDGFDSAGEhABA.YDDCbDDAKAEG.aFAB.hAIA......hBCA...,1,-2,-10,8
SGBYbREQWNefJKVgXUOdCLDPAHMcFaTIZ,HBADFAFD.TBFFZECBBFEG.RCAF.EEGG.NEDC.JFAH..KGFH.VFAFhAAAUACF.dHGBDAFA.hAAAAHHBMEEH.ICDHhABAGCGA..........hACA......hADA...,1,-16,-41,25
KPYBGgINDMZLTFcRfbQeEaJSAVCdXUOWH,dEDBXCDBUCGHHEAHKEHH.BDACGGEF...IEADhAAADCAAMFHFLHAEFHECRABE.hAAAfFEFQAGBhABAeABDECDC.SADEAHADCGFE.ODDHhACA.WBGF...hADA...,2,-21,-6,15
ALYcEQTadIZXKUDPegVJSMOHFbNWfCRBG,LBHBEABH.TBCCdBEEZAGD.KGFDDGFDeFEE..JEDAMBDDhAAAFCEE....NCBE.fGABhABABGADAIHC.QDABhADAIGGAXGBDgGCBOAAGhAEAWDFACHHC..YAFEhBAA.,2,-41,-15,26
VRfNcKJAaGgQDHXTMeSIPULZFEYOWdbCB,aEBFQECAHBBEMACCeDAA...SBHFUFFDFHCAEDDHOACAhAAAdBFBBHAAVGFEfBFAhABAKAADAEGF.DCBChAGA.IEHHLAHBWHAE.CEFE...hAHA......hAIA...,1,-17,-18,1
XREFGYBCJeQKTZNfVHaDgALWSPOMIbUcd,LFHBSCAHMDBBUDEFdGFE..EHAAFFCAGACHBDHBCAEHeFHHhAAA.KFCAZCDC.VAAEhAAADGGBAHDH.OAHB.hADAIDCGXAGC.JHAG.....hABA......hACA...,1,-22,-25,3
cGDgUJVSAFHdQXeBRZPWbfMONCTLKYaEI,HDAHXFGBBAHBZGBG..bEGBODAC.CCFE.KBCC.EEDFIBAChAAADGCDJFFB..ACCBFAAHhABAdDFHeCDB.PFAEhABAfGDCMIEELAFAaAFH...hACA.cAGH..hADA...,2,-28,-10,18
ASJMBWVGYPcdHegNZKCORQULFDaTIXbfE,MHFGBECGGCGG..PBEFdAAGHFDEeFAHZCAGKAADCBEERGAEUGCEhABADBIF...aBCBXAFFhACAEFFEADDH..SAGChACA.JCHDWGFA....cDAAhADA....hAEA..gDED,2,-24,-19,5
YJUPKBcAIMTbdLNHRgCOFZEGeDfVSXaWQ,MFEEdDCFHFDDREAE.ODHHZAACGCDBDBGG..SFFHXGAGaCAChABAQGAE.hACAUAECPHCEBBBCAEGCIHGChADALAAFCHHDeAECfDFA.hAEA......hAIA...,2,-12,-12,0
RCVbTEQJfXacKDSFIYGWOeZNMLUgPABHd,HBDECHGF.TGGCJGCE...aABHKBAGDFEHFAGHGDAG.OAHDhAAAZCAEMFCEUDFGAIBG.BACFhAEA.dHADREABECEF.hAFA.XDDG.IAGCeAAELAHHhADA....hAEA...,1,5,-37,42
JebAYPOdFCUQWRBZXLETfDVaHNIcgMGKS,OFBGdGDDCBDB.UCDFRCFHBHCGLDAD..EFBHDAIFHDAA..hAAAIFFHMACD.SABDhAAAeAFCAFDEFGHHQDGAhACA.WBEE.ZGAE.fGHAhADANBIE...hABA...,1,-20,-31,11
NSIfQHMKOXGLdJRCgZTeWEaAPBFVbUYcD,FGCHVAFCUBCF..DCDE..SFHDQBAHKFFBOHFEhAAALCFGREFFCGDB.ZDAEeEAEhABAaAAF.BDHC.bFADNEED.hACA....fDEEXAGCdADB.hACA......hADA...,2,-22,-21,1
BSOdNYJHeGCgRDTWUcMbFaXPLVKAQEIZf,QBBBEEFHZAEDBBGASADB.dAHAJDAEGBFECAAE.DDIDhAAAUGGCMGAEFGBDPFEBhABAKDHB..ACAH.IDDBhACA.OHFCNEEE......hAFA......hAGA...,1,-15,-48,33
NbSDPMAYWVeTCGZQKREJgIFXdLOaUfcBH,VFFBCEGGZFCB..KCCBEBFG....JDBHIBAA..FADFLBDFhAAAUBGHBHHEbFACDDFEhABA..AACD.eEAEhACAGEEE...QGAG..hAAA.XBAGOHBCcEGAhADA,1,-17,-46,29
WATSaXUIbGROEDLfCNeMYJBdcgVKPQHFZ,aFEAXACD.UEBFIGDF.GBBHOFEHDAECCCHEeAEBhAAAMIDCBDFB..dHGDhABAVDAEPAFAHAFGFFGAhACAAACHSFHFEGCB.fAAAhAAANEED......hADA...,2,-23,-12,11
AHeFCVOKdWfMbTPSEZcBIUNLgGJYDQaXR,eEDECGCHKAFF.dAGH.MCEA..TGGB.EEEEBFAH.IDBAhAAALAAEGGEHhABADGAGaEGAXCGAAEAGHCBDOAHFhAEAfFDDSFDBcABGgADChAHAYHAA...hAGA...,1,-15,-30,15
eKPRWMTLJDSNfXdEAGcgFCBbQHIZVYOaU,GADBFCAEBAADHDFEZFBD.OCAHUBFF.KHCG.RCDF.MFAH.LGEChABASAAE.NGCHdHGHhADAAEAGCEFH...ICCBhAEAaHFC..PDCETGAA.DAIF.EFHFhAGAgACG.hAHA...,1,-5,-35,30
ATLbZQfCcNMGEBgFdUVSeDKaHIPWOYJRX,LDGDQGDCCHCB.MCDCEAHF.BFAB.FDFFUBCH.SFHBhAAAKEDAHFGD..ICBFhAAAPEAAOFDFhABAJAHDAABFZEBHNDFA.dAEB.DCAFaGAD......hACA.WADC...hACA...,2,-18,-17,1
ZOfagcKRQVANLTIUCYJGFeDdHEBMXWSbP,TGAEUFGACDDB..GECEDDABdECC.HGDGBACDMDBE..SBAFhAAAPBFB.OEAFhABAfEGB.cACEhAAAKCECRFEFAAED.ICHHFAGCXEEG.hADA.....WCCFhAFAaABGgGGH.,1,3,-32,35
DYPgMTeNHIJaBSFOALcQCbGZWVUKdEfXR,LHECQGAEGAEFZFEFUABCEFCGRCADDEAE.....PADChAAAMGFGNDDD.HABDJDEABHGEhAGASFAG.hAHAAHADCEED..WCHB.KGCHfDHAhAAA......hABA...,1,-14,-27,13
bFZMcOHAVeQBXIagNJCURPEYTDLdKGfSW,eECBQBGBBAFA.aFFBJDDG..RFBGEEAADDIFLGEE.KBBBhAAASGGC.hABAWAEDFEABMICCHABBAHHChAAAIADACHAA...PAHHYEFChABA......hADA...,2,-34,-21,13
VOWIFfHZPREMALSJYBKNagGXeDQUdbCcT,SGDCBDAEKBHH..aFECXGGC.DAEFQBBEhAAAdCGCCBCH.VFACOFBDFFHHZCEChABAPCBB.MDAFhAAAAACGLHAAJEDC.NAEH...eAHB..hABA......hACA...,2,-25,-22,3
eIgJHXaSTDGWPMEANLfQKVCUbROcBdZYF,LGAEKCEACDGA.UDDHOFGFBACF.ZAEGeDAC..JGEAaFAADAAHhABAGACF.MIDAhAAAAHEHQBBB.hABA.REEFdGAAFCHFIEAA....hAEA......hAFA...,2,-38,-25,13
bYJBPdWCIGORVLUSQXaMEAcNTFfZeKHgD,TACBFCEEZCADKABA..DCAC..JEHBBBHA.dHDDCAHD.ODEEhAAALFFFSFBEhABA.aEABECHHAGHB..fCDFhACAHFBH.gGAHYCDFIAEHhAAA...hAEA...,2,-37,-35,2
PgKdfaEBQeYZATWDSGbRUHJIVcOFCMNLX,DGBCSBFHGCFCRABFHDGH..JHDGIHHB..OFAHhAAAMAAHXGAFhABAKDDBaBEF.BDCC.eFEDhACAAIGATDAAbBDB.........hADA......hAEA...,2,-37,-22,15
DUFBcaRQKYbMNIWVXGSTJHEZdAegPLOCf,eBHHLEEGCFBE.DEIHFFGHBBEA.RAAD.QBDEKFAG.MBAGhAAA..ICHHhAAA.XCDCGGBHSAFEhABATGEEEACEAEAAPDAG.fDFChACAaHBGbAFB.NEAGWHFAhADA..,1,-19,-36,17
SbTYZNKgXCeLMQfUHDFVaBdIOAPGRWEcJ,GADFRFCCEEHF.JEEG..TEAHZECFKCACCCHH..LAADMDDGUGGDhAAA..DGADFEACBDEEhACAdHAD.ACCD....WHEEhADASHDA..NBBHeHBGfABFhABAaCEA.PBHFYAEChAIA..,2,-27,-15,12
YgCJfAaSEPIceOVKUHBXWDRFLQZNTdbMG,aEGDEFEE....ICGBeBEFKACE.UFAHHAABBBCGXFCDhAAADFIBLHDCZDBG.dDFGhAAAMADFGBAECFHDADIBSAGChACAOBHF.WEAD.FHEE...hABA......hAFA...,2,-23,-11,12
EHRYTBOZeSJDWdGXacIFCQLNMKVPbUfAg,EGEFREFGBBCHZEGF..eEADDGDGdAGEGBDG..aCABFBBD.CBFEQFCChAAAMDEG.KCGGVEAAhAAA...UGGHhABAAFIH............hACA......hADA...,1,-23,-41,18
BcHPaMADCQVbLWEXTZIfYFdegNOSGRJUK,DCFFCGDH.QDCALADHEAFEZFFC....ICGCFCHFeFHBOHBGhAAAGDBE.RFFBJAABhAAAUABFBEEC..cEAChACAaHACACCE...WBEC...XDGAhAEA...fHFBhAFA,1,-21,-26,5
gFSZNHADRBVMXPGJEIbWaTOdQUKfYceCL,RFDCBGBAMCBGGDBH.EFFH..IAFFaCAC.OAHBUAFEKHFGhAAA..fAAHhAAAeBAGCEHHFGDHSDABhADA.ZDFAAFBADAEDXGFE.bEBHWAHHhABAdDDE.....hAEA...,1,-19,-25,6
RCHPFVeBMEfNZQTbdIXLODJcaUWGAKYgS,KDFASAGHCAAB.FHDCBDDB.MAEGEAEGZEBG..QGGFhACATCBCdFHCLGCAhADADDGBJAAE...aCBFUGABhAAAAIDGRBFEHECAeBEDfFFENDBG..hAGA......hAIA...,2,-19,-17,2
RKLCgfcYJEDFaMGAeBWHPZQSXOTbINUVd,eFFBBHGCHFBAQAFFSCAAOCAC..IFHGUACCdDGChAAALBHBCFCF.fDDBhAAAYHCEDDEDhABAMEABABBC.PBEC.TACGNBIA.KHAG.hAGAgGDA.hAIA...,2,-21,-5,16
PdORCIXaWMJeSVZNQKcgTbBFfYALEUDHG,EADDDAAEHDDBdAHA.CHDD.aCBG..MCEG.eADCSEAFZGFGKFBA.hADATDFABBBCFAHFAFDDGGCFhAAA.RFAFXFFEhABA..........hACA......hAEA...,1,-20,-37,17
KEIHVDfbcdRSWaZTGMFLeYXCOJPBQNUAg,EEGDVDFFDAEF......fBFCbDDDdDBHRBFG.SBAAhAAAZGDGMFIB.FHBGLBAEhAAAXECDCGAA.JDBBBAFChABANIEBAHHG......IADH.WAHHhABA.aEHD...hACA...,2,-22,-15,7
JBIfbDPGVWMcAYHFeESTdOZXQRCaKNLUg,FBHFSEBHOHFAZBDHRBFB..CBDG.KFGGUGGABDGA....ICBChAAADFDCGCAEMBIBhABAACFAHGBC.eAAFhAAAdEDGaACA.LHCEfCCEbEFGWFADhAFAYAFE....hACA...,2,-30,-13,17
CBQZTcDJXLHPOGKdWNVaRfeFbISAEgMYU,EGAGMEAHUECCBBCGZCFFDFEH..LCBFHDEDGBEFKAEG.dDBA.hAAAVGFCaGGAeACB.hAAAFAHHIDHAAADE.hABACACB....cFBDJHEE.....hAGA....OHBEhABA..,2,-23,-13,10
cCNdDFKJgBeZULHPARIfXSQVGEaTYbMOW,RBAGXBCAQFFHGEGG..EDECaFDDTAFC..YEAGhAAAMHAC..WDAFhAAA..CHADdAGDFEBFKHFAhABABCHEeDDDLFFF.ABCEICAAhABASHCA..bBED..hACANAIA...,1,-3,-20,17
cGeRdKYLbNIfQPaAVWMFTCZgXHBEOUSJD,MFCHCDEGZCAFHFGBBDGBUAGADIDE..GFCFRBBE.dAABLFFDhAAA..IAHGhADAPEADAABHFDCF.XAFDhAEASFDFJFAH.eEHHKDHB...YADAhACA.fCEChAFAaADE..,2,-19,-14,5
IRBSdNPACZULKQgObGMEDYTHeFVaWJcXf,ZCCCKCDBQCBAOBHHGEBFDAGH.HGDAeDADaAGA...JFAHfHCDhAAABBBC.dFHAhABAAFGECDAHUFEE.bAGHEACEhAAAFFCC...cABBIHHG.SCEEhABA...hAEA...,1,-13,-20,7
dAeTLGFONPKbfRVSYHEcWDUMgCZQJIaBX,LBFEODHBKDDDRFAD..SBACEBBA.DADEUEAF.MAADhABAZFFGQDCAhAAA.aEEABBHCADHFeCAHhABAFGEHbBDA..fCFFYHAAcGFAhACACCCCJHFG...IEFChADA.,1,-7,-42,35
YQEOfTGLHIXWRUDeFMcZJPdbNBaKCSAgV,VAEHQBBC.OAFCGGAHLAEFIDDERDFHDDAF.MCFEhAAAZCAHdEFDBHAGaGHBCGHFACAChABAEAAE..HDBCUGEEhACAeFEB..cAGA.....hACA......hADA...,2,-12,-11,1
GNFLKWaSJIVRYbQgOHDUZeEPCMfTdcBXA,GBBAFGCBLABAKGEA..SEEAJEFBRAGF.QBFHhAAAOEHBDCCDeGAE.EAEFCFDE.hAAAMIEA.dCAGBAFBhACANBIA.aDDEIHAC..YDAFhADAHEGF......hAIA...,1,7,-39,46
gZaeVfcbGOIRXLYSABTJNEKFWUMDCQdPH,TEAHJCEE..EFGEFBBH.UAGGCFEE.dGDEHBBFZDFB.eEAB..hAAAVADD..fHBHhABA.cADGhACAOHFC.IEEEXDGESFHFhAAAAGADBHHFWHDADABE...hAFA..gECF,2,-27,-18,9
QJUNOSGAYKDMWfEXZgcCITBaPFeVHRdbL,DAFHMIDCECACZEGF..CFDA.BBEA.FHAAeDFDHCCBdAGFLAGFhAAAUCGE.ODADAACHKDDF.XFDAhABA.IADHhACAaGHDVEAH.RGDA........hAFA......hAIA...,2,-28,-22,6
GVYTWIfNALKUdcbZeJXHBFgEPQSaMCRDO,KDEHUCBBdCGGZFAF..eFCFHCEABHFBFFFAEGED..SACBhAAA.aHDCCHHCOABChAAAGBBE.TAGG.hABAIGCGfGAAADAB.cAFG.JEHBhAEA......hAFA...,2,-30,-24,6
VLDaJeHIZBGOfQMTdEcUKCSPAXgRWNYFb,XCFARDBF..NEIG.FFEGLGDGDAID.eCHFHGBCZBDEBAFHhAAAOEDCMCAC.EEBHKAAChADASGGHABCF.hAEAgADDWHCG.bDDGaAFG..IABChAFA..fAHChBAA,2,-31,-22,9
QYVWbFCABKEGHZXRcegSMPOfNJaIdUDTL,KFAHGDAFHADEZACHRCBC.eAGDMAIB..OHBGJCFD.dBABDIECLDFGhAAA.QFGEhABA..WHEEhAAAFFCEAFFAXFCC.gABF.hAEAfFGFIFAG.hAFA...,2,-32,-13,19
FUXGEbOMBIcagWADNTJRCHdSPeKZLVfYQ,DEDGTGEECBFF..HFABSDFDKFFF.ZFBBLCEG.VAABhAAAYAEE.QBABhAAAFHGCUGCGEEHDhACAbEGBMAIDBADGaDCBACDCRDACdGDC.fBGEhABAOAFA.....hAEA...,2,-18,8,26
XdTVEcRAaOSgWCfIJKYPUFLbQMBGHNDZe,OFBFSFGE.CAEF.IAAB.KBCEPCFGLDDAMIEAhAAABAEBGBCGDFHHeCAFhACAXFFGdHEBTAGEhADAEHACACBBaEEB..fFDAJDAHFAGG...hABA......hACA...,2,-24,-17,7
eGWDbKLJQEgOaYAcBFSfMCXZPNIUHTVRd,BGGBSBAEMAGBZEEG..IFHAHCBGTABDRDEAdFBCeAEDhAAADBABLFBFEGFH.OHDAhAAAAADBFAGFCDCB.NAIE..hABAUGCCWBEH.KAHB..gCADhABAaAEBfCHG...hACA...,1,-9,-13,4
HQJADOWIaXNeFZKGRcTUSgfCEdVMYbLBP,DFEDOCEB..IFFBaHDG..eDFHKBHHRACDUBAH.SFBGhAAACCFCdFBG.MBEEhABALFHHBGHDQDBFhACAABEGXCABFAFA..cGAH..hADAfAAFECHF.hAEA..YHDG,2,-37,-24,13
RMATBYGJOLVScHgIbUEFdQDNeXZKaWCPf,TFDABDEEGDFG.JDACOBBC.LFHHSCHFgDBBhAAAUACHdAGHDBAH.hAAAXAEBaFCB.WHBGhABACFAD...fGFAAEEFYFHBVAGFhACAIBADEEEG.FHAC.hADA.eEBD.,1,5,-25,30
NRdeXgIKPTaSEFCWQYGVbJfHUZBLcMAOD,OCBFDGIBRFFF.dGDHeEDB..XDDGKCCA..aBFFFGAHCDGH.QABDhAAAGDAG.JAEEhABAHAACUCGGBHCGMIDChADANBIG...IGHD..SAEChAAA..EEAD.hABA...,1,-12,-28,16
MfSBQTOaVUAKHZcbeNdCRWILgFDYEJPGX,KAFAHFGBZCACeDEEdDGA.RGAALFBCFAAC.EFFHJEDDGAEB.MBADhAAASFHHBCCG.hABA.OHDCaBCEAFFH.NCIGCBCBhACA....gFAFDECC.XGEAhACA...QCEEhADA,2,-33,-1,32
OFCIdMAGPDVYTNSbHgKEBeWUQZJfRXLca,GEBBDAEE..TCDGSDCCHDFAKCAGEBBHBDAGUFFFQEBFhAAAZGCGRBGFLABEaAFE.hABAFGGGdHCBAAGF...PABEhAIANIEDeFAB..fBHC..hBAA......hCAA...,1,-8,-15,7
gTDXdNCRBVOZYQEMaIJfPSAFWGKLceHbU,FDGHKEHFLEAGHDADUFCADBEFdBHC..CCAFBCCCOBAA.ZADBEAGH.hAAA.aAFD..JEEFSGHBhABAAIEG.GEEChACAeABCTGAF.XGGGNIAF.hADA......hAHA...,1,-9,-39,30
AJUSHZfEcYLWFNQIMbdKOgBDRGaVXeTPC,UAFCZFDEEEDGLDFH.FDBBNDAH..MAEAdDDEKAEF.BFHDDIDAaBFGhAAA..eHBCTABFhABAAHHGHAAA..cCGBhADA..WBHHIFHF.OEBHhAIA.....hAAA...,2,-36,-19,17
OQYgDHIJMdAbScfFUPLGTEaVXWeNZCBRK,SCBBFGGDUCDFGFABEBEB....VFAHXBAC.eAHHhAAAZFECCEHFBFFAKAAEOAFChADAQAEHDIFAIHDBhAEAdHBDABBG.bDDAfEHE.TDAFhABAaBDH....hACA...,1,-15,-21,6
gKdEbYIDaXHSWOZCGeQPMFLUcAJRNBTVf,JAHDRABGBGBH....TCDEVEDFKHFGEFEB......IDBHhAAAXAFCSFAGhABAODAAZCFECCAFQAEBhACAMEIHFEABLHAAcGDHAHAF.fGHChADAdAACDFHD.aGGB.hADAHCFF.,2,-31,-12,19
RVegCWdOPQKbMUXYIHZNDSTGfALJaFEBc,LECHJDFG.EFGBBHHCRCDC.eCBA.CFAH.dACF.QAGBhAAAKGBH.MEFCXACChAAAIHADHFFANIDHDBBBhABASEDH.fAFEACCBaFAE.FAHBhABA......hADA...,1,-12,-39,27
gaTSDBHQMIKYAGCLWOZeXJbdFcRVUfEPN,CAEDLFAAZGEA.eBEEJEDE.dGFB.FDAARABD.UDEE..EAGE..hAAA..gAAFhAAAaDABSGGEDIDGBAHBhADAQGBHIDHCKBFBAHBFOCCG..hAEAcDGE.fFAAhABA,2,-33,-29,4
OIBaJEZfTCYRUMWVKPQgcLAedXbHNDFGS,eHFGXCAAHDGDDBEDFAHH.GEDA.SCBFODDHBHDEhAAAEABGZFBHTBGBRADFMFADhAAAKFGB..QFAGhABA.cGEAADDDdDFG.NDIA..aCFH.fABFhAEA.CAGC..hADA...,1,1,-15,16
XOgPJYbDSZeUIMcQCTHLaAGdBVRNFfKEW,BGCHRBDFFFDB.EEDG..OCBFJACG..DCCDSGGGZBGF.eEABhAAAMFIH..CABALCHDhABAAAGAdCAC.NIBB.fFBFhAAA.XGFFYAGD..hADA......hAEA...,2,-42,-32,10
BFVdEDfMcUSHbNZARXKgCeTOWGIQaJLPY,RBBDXGBAKEGH..eECHOADGGDACQEEHLAEBBCBAhAAAdAHADAGBMBGF.SHEAhABANIDF.AIAGCCEATFEDhAAAIECFaDHF.PFHD.FAHBfACDhABAcACC...hBAA...,1,-12,-27,15
aEQbGDHYIKfRJeUNcZMBOdCgXLPTWFVAS,SFFBEEABGCCEDIEEHDBF.KCHBRADDeHBAUAABZAEHBGHC.dFFECAHDLDADhABA.TDDChADAVCFEACAE.aABFQGCDhAGA.IHHBfAGF.hAIA.cEGF..hBDA...,1,-12,-18,6
JbFREBeQYHKNMXdTOfGgDcWIaZVPLASCU,UBGCJEAG.REABBACFQGGD.HBAGMBADdHAB.OCGFGEEAhAAADFEB..IHHHhABAVAEAAABA.CDEF.FFFBeCCDhAEA.KEHDNBIC...TGCGfDDD.hAFA..WFDDaGAHPBDEhAGA.,2,-22,-10,12
gUTCDXaNJIOdcbfMHREVGLKAePYBSQFZW,eBGBBBEBSDAGFHGEZEAF.UGFCCACHDFEG..aBGC..JGDAOFAGhAAA.dFHA..hABAfCEDHCDDVABBhADALCACPHBG...WEDCXDGChAEAIAHG...MICChAAA..,2,-36,-14,22
IPUQDOYRKMBFCLcGfNHWbEJTagZAeSdVX,SHFEVFBD..XCBHUEEDOBDCKAHDBGGEFGABCBABGEDBhAAA.HBFBEDAGTCGBhAAA..aACFAAECIACEhABAPAEHDGIHMEIHfHEF.hAGAWFAFgFBBhAHAdBAA...,2,-31,-4,27
DCMbWdafQFRPUcNLXYAHeVKBGZgOEJITS,VCACGDBF.OAFEEGDA...TFGBSDGADIFA.MIFChAAAdFCDaCACFAGC.UABALBAChABAAAAFKGAABFACJFAAIGHAhACACDHE.WFDERGDC.....NIAHHAEBhADA..eAEDhAFA...,1,-2,-12,10
OGEDPLHRQCVeUYgSTXZWMNFcdfAbJIBaK,JFDEaCEAGEDB.DADDLBEH.RDACCHFCeBBB.UFAASHBEhAAATGGEZAGFMBAEhABAFDDG.dAAFAAIDBGAFhACAEAEE.HCGB...QGGG.hAIA......hBEA...,2,-25,-13,12
cPbEdSKODQWfeYZAFGCILJaTNRXgBMUHV,FEAHCBFBLFFG..aACCRDCHBCEGUDCHHBEG..VCGBbFEE.hAAAECAG..KDFDQGAFhAAAeHBAAHBG.IADDhABANABG..MIEA......hADA......hAEA...,1,-24,-30,6
ATZLIgaPQXGENHfWBMcVJCKebdDFRSOYU,LAECaBDA.QDGDXDFAECCBHCEHBABBVDCB.KBHHeHCChAAAdDAGDBCHFHGGSCEGhADAOFGDUGCHAGCBIHAFhAEA.PAFAfAAC..hAAAWFFA.MBBD.hACACEED...,1,-11,-14,3
UVaFcPObQdKDANeRIWGMZfTSCYLXBHJgE,eAHBRDDGGBBBMFHHZFBH..SFBACBACLAEGBBFFHGDAJCACEFGEhAAAUFEH..FDACOADFhAAAdGAADDFAAIFENDAAIHHAhABA..fCFA...hACA......hADA...,2,-27,-6,21
AESaUCLNVTgJWQIeFbDBcYRKdOMfGXHZP,aEDCLHBG.VCCETCFE..JBAFIBHC.FCBEbBGHhAAABGHH.RAAAKGAFOGFGhABAMAEGXAEEhACA.PFAAAGGDEEHHCBECNFEH.gGBB.hADA.WAHBDDAFYHEAhAAA.,2,-30,-11,19
TBLbWESMPRVGHCZOFQKIUDYeNdJfgcAXa,aBHHBDBBLGBCEFFA..SCFBMABFREFFHAEBCBCEZFADFDCCKAEGDAIHhAAA..eHCAdHAHfACAhACAADHH.XEAGhAEATEDDPAHFOFHF.IAAEhACA.NDAC.....hADA...,1,2,-34,36
UfXgebCQOETSFDGHIYcRPVANadLKBMWZJ,aFGALCBABCECZEBHJAFG..UFEA..XBFBeDFG.CHGB.EGCDhAAAFEEGDBAF..HABBhAAA..IFAGhABA..YFADPEBAAIFGNICDMADAfBHAhACA..gFDGhABAOBBG,1,-32,-33,1
dOCSQPVYUbGANWMDIKXRBgeEHLJcFZTaf,MHDCDGEDKCDERCBF.BDGD..eAEFHFFEJAABFACGZDFA...aBHBdBAEhAAA.OFAB.CHCD.hABASGGE.hAFAPGAGVEBEbAEAACIHNIAD......WEEGhAAA....IHHAhAGA,2,-36,-27,9
WQKcMZAVdFICUYDPeEGbJXfBSTOLNaHgR,dDEFFAFFCBAAUAFH.DIDGEEFG..GBAG..bEACJFFG..XEDHhAAABFEF.SDBGhABATGAA.LBHFhACAaECFHACHRADBKHAEMHEEAHHFICCD.hAAA......hABA...,2,-29,-15,14
RaDAJTbQPXfMZOYCSIgHGUVFWNEBedcKL,JHAATFDB..QAAE..XCCFMCDCZAGFCGAAICADhAAAHDBEGGEDFHEEEDFGhABABADCeAEAKDFDLFAAhAAADIAGADHC.fFGBSFCF.gDAAhACA.WFFEhADA.cGGF,2,-19,-17,2
PGfIZCbOHBRYEFeUcMLDKdASWJNgVXaTQ,SCAEJHAE..VECGXAGE.QFGHGCACIEHBhAAACCFDHDADRFBFFAHBeFEDhAAAMIDADEEE.AABGWADChAHAaABC..TGGDfDHGOACABHHDhBAAECDGcFEE.dCGDhAGA...,1,1,-19,20
GEeJLIFOCgNUXSQcaBTPWVMbfYKZHRDAd,GECCJCFCLEDBOAEG.CAHA.UGBC..QCEBBAFF.hAAATBAFPACFVFFGhAAAMFGH....fCHGhABAZBAFDEIDAFHHEAHDeDAB...FHECNCAC.hABA.SDFGhACA..aDCB,1,-1,-31,30
MdXZNCELWGPKVHceOUTYfJFDgbIASRaBQ,aFEGBDDA.QFFHdFBAZAFG.EAEELABCGAGEKCAFHDBCeCCFhAAATDGD..JFCBDCBAhAAAIGAHADBGSGGDhAFAXABCCFHA.WFEDPHCE..cBEChACA.....hAGA...,2,-18,-9,9
FUPgCWbDVZBQHJaNdfMGALSRIYeTKEOXc,LFCDRDEEeACG.TCBDKHBA..EGGCOAABFGDF.UEFCCABDDCGCBHAChABA.QBEAhACAHEAFJAFC.aAGAdCCHfHFHhADAAEAH.SFHBYAAF...hAEA......hAIA...,1,-12,-24,12
egNBbTIZXOWUALJDcVHFKEQGaSRPCdMfY,DABEVEGBHBDH.KGGGGEAGRFBG.CGDFdCCHMFEC..eACABDBB.hAAA.IBAEODFGAHBHhAAALCFGJAFE.EEEChABASHCGfAFF.NIEH.....hACA......hADA...,2,-36,-14,22
FWGDTLBVbYEMOIfZNHSJaKPCcdAQURXge,QGAFUEECRBAG.eCEGFBEFGDGALAAGBBHAVGEC.EEEHOAFAhAAAZCAEHEAE..hABAaABACDHAAHID..XGCGhAEADCAC..........hBAA......hBCA...,1,-1,-35,34
gLdPDYTUZOEfFCcJXbeaVSQIWMKAGRNBH,GDAEBAAGHDCCLADGdGDHDCHFTCGGZADA.OEFCECFD.CCCH.XCAFhABAaAAF.SAHBhACAIHGDMIBChACAAIHCRFAH.gFDE..PFFGfCEChAEA.FAHF..hAFA...,1,-11,-15,4
VGOJHSUeWQcNAYECZXfMRPLdbKTgaDBFI,EBDGXGDFRFAE.LACCKCAA..aCCDBAGHFGEF.VDDCGDFGhAAAODHHHAFC.SABBhADAeBABQGABhAAAAIGCCHDGMCIDdGGH.bBFEDAEGICCA..hABA......hAGA...,1,-10,-11,1
JfISbRVaAXdQCBLgZOTeKNEHcUWPGMFYD,QFEECCACLFDAZDAEeCBC.KDGEHAGBUFBAGAAB.MBFDhAAADEEGIAEBSHEEhABA..RAAAADDGBHHBgAGBhAAANIBHEFAA.PEHFYDHB..bDAChABAaCDF.OGAE.hADA...,2,-19,7,26
KCcVHQPWYUAGadbRENXeSMLFTIBfOJDgZ,aCAHREBAEADC..eFABMIDELBFG.FDHFIEHHODCEJGFEhAAADDCAKABD..CAHFHABEhABAPGDEUGDG.AFFE.hADAbAGF...NAAETBEHBCDF...fGBEhACA.gGGBhADA,2,-18,-15,3
acLQfZOINVYCedFUEgDKXRHTbWMAGBJSP,BDFGSEFAaFHDLHCCZAAC..OECA..IAFDhAAANBEB.CDDGFBCEUFAGDCGChABAXGCDRDGHHDAF.bCAGhABAAFFD...GGEHcABGfCGAhACA......hADA...,2,-23,-21,2
QYTBSAJDXFdKMPHVCGUbeWaRIgcEfOLZN,DCDCdDAGMGBAHGACCFGFUAGD..eEDAREFF...IEBCECCALABGhAAAZABDQAGFhAAABHEEAEEGFHCCKHEC...hACA............hADA......hAFA...,1,-28,-33,5
aZRgJNCeSdVHfYBQWLOcETAXDGPbMIUFK,XBABDCIFGEBF.MBBEUBFE.KFCCaHEARFAH.....JBGFNAIE.hAAAeHAE..VFFDhABAHCACBADBQFGBhAAAODCC..EHCAAEAA........hACA......hAFA...,2,-26,-18,8
KGRadSOHDPUEbTZCLYNQJWVcXAeMIgBFf,eCEHMBDABCCBKDHFGAAHdGFGHCGD.DICEEHBAZECBCFGG...LDABhAAAQAGC.JEAChAAA..WCFFXGEChABAIGHF.FABGaFAHSAFE.hADA......hAEA...,2,-22,-20,2
FQZEJdVDYNUSfHcCLbAKOWXReIGaTMPgB,OBCEXCCFRFDEGEAA..TGDAMABEBHCBFCGFZBEHdEHEDAFChAAAUDDFHDBB.CDACABGCeAFBhAAAaHGG...PAHFhAGAEFFAJABE..YHFGNBIA...SBBDhAHA..hBAA...,2,-16,-7,9
PNAcHBeQbFMfTJCEKdVLOIGSWZYgXRaUD,BFGDeCBFFGBCMDAE..JAHHCFED..KEABLACEGGAB.ZFEG..hAAAXECFUCEEDDDDAAGGHBCChAAA..fBAAhABAEGHHOBAG.SAGA..hABAYFHBaCFE..hAGA.NIAB..,1,-16,-36,20
RfBUJEGAIPFLTWOacXeDdZNKHbCVQgYMS,FCHBTACAOFCF..aGGEeBDDZCCCKCGCCHAG...QGEEhAAAMACDSGGBREAHBAHCEFCAhABAAFEDLDAH.hACAXAFBDAEGdEGF...bFEH...gCEBhAAA..hABA...,2,-29,-11,18
QbMLfBROYCeVgUKXcISHFEaGWDAPJdNZT,JEHBdCEFZDAE.QEGCLCCDBCHGRGAC.CAAA.VAAG.KADEXGDEhAAA..IFEEhAAASGBFEAGDaFBAhAHAGAEC.DCAHAHHBNAIGMDGF.ODDFhACAYHDGeDAH...hBFA...,2,-23,-16,7
dWOKMeFUQfDgRCTGLScEVBXYabPJIZNHA,OECCKEDGMAHHUBFA..DEACCGAD.LFGH.EACHXDGEhAAA.aBCGPGCChAAAJGFA.IAFDHBABdHCFhABAFBAHfDDD..RCDG.SHFGhACA.BEAD.hABA...,1,-13,-32,19
DCSOcRgIaKbNXHAZWeVEYUMLdGTfJFBPQ,ZCACeBGDEABEMFBBGEDB..JACBBAGBDGFB.SDGARECF.hAAAaHGCKAGC.XBDHhABAAAAFVEADLCEEhADAdEAF.fFHAFGGECCAAcEEFIAEA.hACANIBH.WCHB...hAIA...,1,-14,-19,5
RZNgAWbGJQEFfUVePCcdKXTSYHMaBDLIO,GEDFJDHH.QABDEBHB.UAEEVCADCBHBdGBA..KGFBXGGHhAAASFAGMDIBhABABGDFLDAAOAAAhAEARGDG.ZCCFADGA.FEEA.eHAG.....hADA......hAHA...,1,-7,-23,16
fcHCBUKGREPXdgLOeDbWNSFAVTYaMQIJZ,TGEAaCBC..MHCCJCHB.ZCFGHBCABFAHUEEBRECG...EGBCdAEFhAAAOAABDBBA..NIBH.hABAFBFA.AHADQEAGhABA.IHHFCAHHKHGCXDAC.hACA......hADA...,1,-14,-31,17
dMabIBZLWXNFTEHRKDQgPeUcOSVfGCAJY,JEAHMFEH...aHFCBDCDZAAH.LGCE..XGAEhACATADEHCFCRCFDDCEDPAFAhADAUAAHSGGChABA.fEDFADDFbFFEIEAENIEFEAHD.gACAhBAA...hADA...,2,-25,-13,12
DagSFNKORZecGBUEIAXVLMYfJTWQHPbdC,VBCELEDA.MCHHJGDG...QBECHFAEdDFDCBAHaBACFAHBOGAEhAAA.eDAFGDADhAAAEHGEABBG..fHGFhABAPGDADIDCSAFBNADB...hABA......hACA...,2,-21,-12,9
cUGOJBNKVLQTRbDfdCEYMaPXHIAFSeZgW,eDEFZABA....gCEHUBCFODHDBBHAVGBGLDAFhAAAQGGHTEFDDACACGHDEHBEhACAMDBD..aCCFPAGHhAAA..IHEEAABFSGFF.hADAWFAD..JFBC.hAFAKDHB..,2,-25,-10,15
WGagUScBNdMRZYPLbIQTEKFJXfeVCDAOH,HBCCaGBB.SGCABEFCdDCARAAFZGFA.LBHDQBFHEGADFEEGhAAA.JDAEXFGChAAA.eHEGCBAEOAFGhABAgADA.NEAGMCIDbEAAIACG.hACA......hADA...,1,0,-22,22
BIHJAZQTDdcMFPVUGCSgKeObNaXEWYfRL,TDEADGCEMBHF..FEBGUFGEGFBH.CBDA.KBBD.ODBCaBADEFHFhAAA.....YBHBhABARFEHLFBDBACDhADAJADFAHFBdAFE.PHACSAFB..hAAA......hABA...,1,-7,-40,33
EHIPfDBSVNLQRgGYUCJeMZaFbTOdcKAWX,EFAHHDDB...PFBHfEFCBGHF.SAEALCFCQAAEhAAARBCFGEGCCGDAJCABhAAAMADAFCEETDBC.hABAdGDHAHBGWHCADIEGNBDB........hACA......hADA...,2,-19,-5,14
JTYADNCVHcWPBXQaFIgSMeZREfUGKbOLd,CCCDVACGHDAD.....PDHDXDDEFHCE.SHEAhAAAZADCEEED.UFACKABFOGFChAAAdDGATFCAAAHA.NAIC.BBHChACAaFGE.IDFH.eFADfBAChABA.....hAEA...,2,-18,-12,6
QMXPKSHFLAURBcfCgGEZbeIDTWYVadONJ,RFBFBHAGCAAB.GDDHZDFG.eHDGDEEB...TBCG..VCAHhACAOFCBQGGChADAMAFCKAACHAFGAEAHUBGDfHDDhAEAEHGG.bCCBIFHG.aDAFdGAChAFA......hAGA...,2,-16,-11,5
VMEGcJCbAFdIHaWOLPRKSfgNUBDQYTeXZ,FAHFHBFEOEFBLEFA.KAADSBDH..fFAFhABAgDBDBDGHDDGAQGGChAAAeBDFXGGAhACAMFADcGADCBFHAGEHaCAGWFDB..PFBBhABANADB.....hAIA...,1,-18,-23,5
NMYCFeOVJQEKDAcGUbPSZdLBTIgXHWfaR,UBGGSDFFdECBBCDB..IFHBHFFEaCACMHEG.FADDVAAEhAAAEGCH..DABCAHIHGGADhADAZAFALBBF.hAEAgCCGXDFGfBEDNIDBCHAF.hAAA...eFCE.hAFA..QCGC,2,-21,6,27
TXHYMNfVPdKGBaOCREIgbFLDAUWceZSQJ,UCCGeGCGZBEHQBGG..TGGHXFFBMCEH.NABF.fBAAhAAA.dFCGhABAKBHDBEAHaBBCOFFGhAAACHECEAEAIHAEFGAFADIH.SDGA.hAGA......hAHA...,1,-16,-24,8
AEbdISHGUNJKOCTYXRDaZcWfQeLVFBPgM,dAGFSEDCGECAUGGEKBEB..CDBB.XBBHDIAGZFFG....hAAA.fFAGhABAeGBCFBAEBAGGMFFFAEIBEADFHBEAhACAOHFC.....YAHBhAAAcDAHLEEEPDAB.hABA...,1,-3,-34,31
YXKMFSeaTWIERQcDAbCHJNOGLZVPgfUdB,HBFBJAAAGDDCLFFEZCGH.VBCD....fGHAhADABFCDKHGASCHHhAAAaGFD.IHBDECFDQEBAhAEADCABAFAHCBEBNABEPHBC...gAEChAHA..YFEFhACA,1,-18,-28,10
JFRdEXOUYfPQeLZaSKGMABVDcbINgCHTW,DCIH..ICBECFDAHGAE.JAHDFCGD.RACB.dEAE.OFGHUEAF..hAAA...fFCBhABAPFGDLAAFhACASEFFMFIDAADCBHAD.bGCG.NBBHWAFHhACAEEEGXBEF..hAEA...,2,-27,-21,6
fPREYdXOFNJbLgVBADCeZUSTHcaIWQGKM,CBFBUCGAHECD..aDBFQCAHGFDBKBCAMACA.RFEB.dAGFOBHDhAAAJDDE.LBAChABABBAADABCSGGEhAGA.IHBBfHBDEBEDYEEChAHAFGHDNEAG......hAIA...,1,-6,-30,24
RIeKJZQANVYcGaHPOCdLbWUMDBfgXESFT,VBFCGBCD.aGDDHCCD.OGFGLDAFUGADBBAB.gDBChAAASABEFGFARFDBIHHEhAAAJCGDZGAEAEEA.NCBA.hAEA.....cAEBCHFDWACCDEEG..hAHA.EDHH....hAIA...,1,-11,-14,3
dcLgDCaESVFUBTfHRQZYWAbJMeNPGIXOK,JDFBeBAGGCCCOADG.dHEDLFBF.DGIDCAHGaDED.SDBBhAAAFAFFBCAAHABAhAAAZBFAAFHB.MAHB.NAIG.IHHDhABA.XGBHKGGF.EDGE..hACA......hAIA...,1,-23,-26,3
PDBWIUegfZcEOAbaSQHVMXdGLYKFTCJRN,SDEFHFDHMCGHGBBDKHFG.CAEBRDAEDFACBFHHUEGF..eCHFhAAAZAGBEACDAGGH..aGADQGAGhAAAdAGH.LDAGhABAFABG.TFCH.....hAHA......hBAA...,2,-21,-13,8
XfAOEdDZGRFWLKSbCPYgcMQHUaBTNIJVe,ECDDdCCAZCFDRFCD.FDAFKBFA..CHDH.....gDAGMBBCUGGGhAAABAHB..TGAFhABANGED..VAAEeFCEhACAAHFEDIFCLAFC.SDHBPCHFQGAHhAAA.aDEDhADA...,2,-26,-22,4
QdCMRFGAfVBaXIEWOJKHePbTgZSDcUNYL,BGAHXECGECAH..OCGDKDDEHGEC.eABATGCBZCABSBGAhAAADGFCUACF.NEIALHAAhABAQDCFCDGCFAGGhACAAFAGfAAA.IHHB.WAGFhAAA.....hAFA...,2,-26,-9,17
EbQLPBYMfeCOFaXRcdZUISJNHgKWGDATV,TGDAEEEFLGAA.BBEHMBFD.CCGEFEBHaDBHRGFAZBBE..UCGBhAAASFGFHCCHKBGCDDDHhAAAAABF......hABA............hACA......hADA...,2,-44,-26,18
RONVbeBgCJMKPLTEAQXZYaFdHSGWfcIUD,QEADZBCHFFCHdBAGHGFCSGFEGEDB....fBGGhAAAIAGHDEADNACGbFDHBBHHhAAA.CBEC.JDDGMIAAhABAKADCLFHHAIEE.XBDGaFAD.WAHBhABA...RGAE.OCEEhACA.,1,8,-19,27
VXARbTdPYKcMCOeBHIEFGaSJWDQfNgLUZ,TDBCdBDBKFEH..MACFOEHD.BGACEAGHGGAH..JFFFhAAADGGDQDDChABA.fACAhACANBBGUDGHXECFABHAPHAECHHF.IGDFSEADhAAAWAFH.ZCGD...hABA...,1,-12,-30,18
HbGdKCINRUPODcgXVJESfAMTLYaBFWQeZ,TBADaAHDBGGH..QEBBeCCBHGAAdFEHCBAE.RADBUAGCDDGB..hAAAXEAAJFHH.EBDDhAAAAIDEMEEGLHFGFFAH.hABAbBEB...KEED.IEHA.NACH.hABAcGBE...hAHA...,2,-15,-11,4
MKEbaCAHBFdVSJYWfRTQDNZcLIXePOGgU,FFDEdBFESGFC..JFHF..fCCGQCACZABGhAAAIFBEeGAGOCEHhABAUAGDMHAEKEGAaDAHHCEAhAAABAHD..WCCBDGEB.LABA.hACA....XGFHhACA.,2,-31,-17,14
UaKbYDGBEMPOAHVRgLQCfWTJcFdSXeNIZ,REFDQEABCGBC..TGCAJABGFFHBdDDB..eCDHZAACUAFAhABAKEFFDICABEAF.MEIBhACAAAHA....gBEBhAAAfADBcCGDSECA..hAIAICCFaHFE..hABA.YGAG.,1,-21,-30,9
JAgCQbMZKYUaEINPHOfXDBRdTcGFSeLWV,CGCBMFEDZEBC.UAFH..aACAECDE....IGACHDECOFFEhAAADIBABFGDdCBETGAHhABAGCEGFAFESACChAGAeAAGLCHD.......hAIA......hBAA...,2,-29,-21,8
gcCZaXNbRJfYSLWDUAKTFOPHIGBdEVeQM,KECCFDEFOBFCHBEFBFHG.EEAEeBAF.MDGBCAHBZACB..aFACXGCBhAAARCBH.JAGFfHBBhAAA.LFHFhABADHEAACADIHHCdHEF.....hACAgEFF.hADAcFAC.,2,-27,-12,15
WObfQKPCgAJeUVYIFRBSdZTDLNXMHEGac,JCCDeEBH.UDEA..IGDEBADHSABCdGAEZAEH.DCCCLEFHhAAA.MBBFhABAHGEAEACHGAGA.hACA.aCHBOCBB.bFCHfHGFhAGAKAFF.CEDAAFFF....hAHA...,2,-29,-17,12
HdaJAcgNTBUIXLCRMfVZQOWYEeDSGKbPF,...NHEH.UAAFLCCFCEGBRDCE..MGCCZDDDQAEA.hABAOABBEAEBDAFGSHAEhAAAKHCEFHGCdDACJDHDAIBE.hADATAGBBBGC.IFFC.XEADhACAWAHH..eFFG.hADA...,2,-31,-19,12
ZgBPcQTMNaYIKVOSWeXLCRAJfFbUGdHDE,FBGBUCBGdFCCDAEAZACCBDGH..QEGH.MIAENIDB..hAAAaFDEKFAD.ODCEhABAeBFGLDADAHID.hADAJABCfGEC..bGFAECCCPDDAhAAA.....hAEA...,1,-28,-31,3
dCFfWBeXRQNUMYHOgDcaGbVALIJTZEKPS,JGEGEGHBKEEF..SCGCCEBH.FCAHBAFB.XBCDhAAARCCCQGBCMDABHCGFhABADABD.aGCD..bEFAABBBTBEDhACAdFAC.fGFANIDD.YAHHhADA....hAEA...,2,-29,-29,0
eNcWKXJBFPdSbGEgQRTIHMVCDZLAfYaUO,aCGFOACD..eCAE..NCBG.KDAHBECDdAFFGFEHEFHD.RCEDHABGhAAACEEHDGEELAHDhAAAAEIHUGBE...XDGChABAFECCSHFAQGBHMAIFfAEEhACA....hAFA...,1,0,-35,35
fFaNESKHAcYWgUQVJDXMRLebPdOBGICZT,......YAFEWHBE..QEDCDIEGRDEALCCDhAAAeBCFdCGAOGCEBEACCACBZBEChABAFGHBaAAD.SGFFhAAAAHHA.gADBJEAHMDIB...hAEA......hBAA...,2,-26,-26,0
ZHOSTVNBKMcXECPfDRGFQbdaALgIJYWUe,LFDHJACA.UAFEeFDDZAABOHFA..VDGDBBABKCCGXEEEhAAA.CCDH.DAEBhAAAFGAAdFBC.AFFDIHHHhADAHBFG..SCCFMAIDEDEC.fDEHhABA...hBAA...,1,-27,-30,3
GNERFDUKeXgfMQbOcYCLJWaABSPVTZIdH,BEDFVBCC.ZAAHHEAFGEGGEDEA.DCIF..KDHHeCEC..fHGDhAAAMGAG.OAFEhABACACCLEFDaHCCAFGCSDAChACATADEdHBDFAFAXFFC...hAIA......hBAA...,2,-22,-7,15
NXIPULTZaWCEHOdMAYVJcQBDbKgFeSGfR,JBFGQEBDBBAB.KHGEFACDGAAF.RCDB...XDEBhAAAUAGDZAEHCEGD.EDHDHFAAdFFBAHCEhAAA....YFHBhABADDAA..eHCAfECHIHAFLHAAhACA.aAEG.hABA...,2,-29,-9,20
MgJfCFdVPTILDKBbNSeYZaGHOWEcRAUQX,QECDXDDC.MBFBJCHF...CFACFGHBVAEH...TGFChAAALAHH.DGGFKCAGhABABCBDSHBChACAZGBCHACFEAHDAEAEfAAFdGEGIEAH.eABAhAGAaFFB......hAIA...,1,-15,-18,3
AZBGVMDfcgRKFWJXaHSbEIYLCdOTPNQUe,BFDHVEFE.MDEE.DFAH..fAGHRBAH.FABCXBGEhAAAaFDBHBEBSGHBhABA.EAECYEAFhAAACECHOHECNICDUCCGAGFCZACB.cCGAKHAA...hACA.JEEAIHHFhADA...,1,-13,-18,5
aOLdATZNceHUCgPbQIBJWVKERSYXFfGMD,ZEDCeHACHDADCBBB...PHDGQBDDBBHE.VFGBKBCAECFDSBGChAAA.FGDAMFABhAAAOFAAACHD.NAEB..hABAUDEHbFBDJADC...WFGHXCAChABAfDDDDIDC...hACA...,2,-12,-12,0
NLIRKBDQAXOYJVbZfCPGSMFHTWEUegcda,OHEAVFCG.ZCBACCCG.GFBH..SCHHMAHBFACCHAEFhAAAEEAGUCEHeEAA.dEFDaAAEhAAALBAFKFFC.DCIHhABAABHDXGAG.JFHBfGAEhAEA..WADE..hABA.NIBFBBDF.,1,5,-18,23
ZXTFHfWEBbeKAQGacVNLdISOPJYRUMgDC,QGAFaCDG..NBHC.dDBA.SDGAJFBH.UFDHDAFAXFEAhAAAHACFEAAGBHGEhACAKACDABAE.VAEGLEAEhABAIDEFOEHD.......hAEA......hAHA...,1,-13,-36,23
XTUEgJAVeHRaPFSdWKfBLIZNQbYCMDOcG,VCFDRACCFDGF..dECCKCAELCADZECB..QFFFCEEE.DBBChAAAOFGBGEACXGBGhAAATAEF..EAHHAIHAeCDAhABAaFHD..SDCCBAHGNCIC.MICEhABA......hACA...,1,-14,-26,12
GUHEIAdTaYQKNXbPVcSLCMZOFfJDRBWge,dBAGaEEE.QEBDKBFF..XBAEVFEELHEACGHH.ZAGDhAAAOEAGFCBADCIDBGBAhAAAeEFEHAGHAAEA.NIEB.bGAGhABASEHF.MADGfBEChACAJGDG..WBDB..hABA...,1,2,-30,32
VKcgefMLCBNRSYdDaQWJZEbOAITGFHPUX,TCGDGDBCFHAC.UFFEKACHeFGHLADCCEEHBAGERBCC..dEDADGCFhAAAQAABZECF.hABAOBGFAAEAPCAF.hABAXGEB........hACA......hAIA...,2,-33,-16,17
LHUZJETOKGAcVNXBdCFSegMYIfRDPaQbW,VBFBXCFD.BACGCEDB..eEHBMAAF....fDBGhAAAPHAAQGFDhABALFADHFEHUEBAZCDHhADATADEKBBF.cBBHNEIESBFFIHGADAGGhAEAaBHF.....hAFA...,1,-4,-16,12
YRVPEGCOAIcZJXHDLSMQUBadegWbNFfTK,ZDBAXDADLACG.SEGAQGEGBHEAdCAFeDCC.hAAAgCGENGCFFCFGKEAFRBAEhABAPEHH.CGACAEEHIHAEhADAJAECDIAAMBAGaHGC.fFCAhAAA......hABA...,2,-21,-12,9
UHNDGWbBIeECFPJdfaTSZXOAKLcVQgYMR,KAAGVABAQFBC..MEEFRBDFHAGFGAEEBEFAECHHCCCFFHEEhAAAdHGBaFGC.ZEAFOEAHhACAAAGHLHAA..hAAAYEHDDDDD.......WADEhAIA.eFDH..hBDAfBAE.,2,-11,-11,0
KdPXZOWIgFQYTSUMJaHbDLAcGERfVBNCe,GGABEFEHRACB.BDBAeFAHdAGGZCFEOCBA..IFHDQFGBhAAASAFFMFCCaADAhABADBBBADEE...cGEEhAAANIDDCABH.KAGG...WEDF..YDEGhAIA....hBAA...,2,-25,-21,4
XBJLHYDRQMcfCbEaUdFAGOVgSWPNTKeIZ,VFACSCHD....NEHE.TEBDeEFDZABAXCDC.hAAABFFHJAFHLAHDhACADIAEMACBfDAChAAACDDHEDACdFDEAIEC.OFHD.WADE.KGDA.IAHFhABA...hADA...,2,-20,-17,3
XARSIObBNPEgVCdJHUFDKMaQeGWcfTZYL,RBFCOAGDBDHA..EBDDVDED..dFDBHCAHDGBF.KCCE..aAAHQGAGhAAAGBBG.fAFChABAZGFE.LHFAhACAAEGBSAEGIGDGNDACCHDG.FACE.MCIDhAFA.....hABA...,2,-32,0,32
YEGKTDFJaQNBXfICVOHgdPSeAcRWZUbLM,REABZDACLACBMBHBGBCHDFHB..FCFDaAHFBHEE....fFDChAAACFFBOABBdAEDhAAASGFB.AACHWFBFhABAbECF..KHBAJEEC.NDIE.IAHFhAFA......hBAA...,2,-35,-16,19
LQMCFJDHURfcTKBbAOWSZYegdaGVXPINE,OCBAZAGFeEEHdBGBGCCC..XEFGIHHHLEADhAAA.MFIHCCACDEABHGDEhABAfGBCTEBGBACFhAEAABGFSAAAaHAENDEH.FBEF.....hAFA......hAGA...,1,-11,-26,15
HBJaOUXcVMGgedNfYIEbDQKZLCATRFPSW,REEFFCHB..SAGCBCCGJAFE.UGGE...XCAHMFFFeCEHhAAAdDGD....fADEhAAAEADFDIGAKFAHCFCCAHCAhABA.TBGE.PDCAaABGOECB.hACAcGCD...hAEA...,1,-24,-41,17
YKZAWPdfeaHNXEbMCTDgOIQJVLRFScGBU,dBBDeCCEaFFGHGEG.EBAHCHGF.DGDA..OEAEJBFELFABRGCA.hAAAFEEESAEBhABABDBDKDHBAHID..fDGBhACANAED.MAID.TDDE.IDABhADA...QGAAhAGA,1,-15,-30,15
eOWXMTUSgDRLaKdQbZNPJHcBfYCVFGIAE,EGDDOBGH..XFABUCBFDAAGLAAGdFDBZFAD.JFEEBEGACDEEGAEDhABA..ICEBhADAAHGDeCACMFIF.hAEATCGBSFHHaHAEKECENBBH....cAGFhAFA....hAIA.YHCC.,1,-1,-33,32
GQfTNLcdHOVCegbBFEIXaUKZAJPRMYDWS,JFADMBFD.DBGAGADF.QCAETCADLABCHDFBCDDDeFEDhAAABEDHEFHF.IHEChAAAaCHFKGCHAEAB..RCGHSFAFhAFAfCDD.NGCH.dHGBOHAE.hABA......hACAgCCH.,1,0,-10,10
HEdgIXAaFMcTORUZBLGSQCYNDWVJKefbP,MBCGTGCERGEC..BGCFGEEA.CCFEDCBDJDEF..KEGEeACA..hAAA.fAGHhABAHEAAdAHAICAGACCGaCDDFGHHOBHFhACALCCESFBFNABH..WHBGhAAA.....hADA...,2,-25,-18,7
PfHDgKaOUdSQLGIRNeCMJAZWFXbVTEBYc,ZAFCXCAH..VFCFBHDE...PCDHHAADDEAC.aCCAhAAAdAGEQFFDhACAIFFBRFAGCADHAAGGFHGE.TABBhAAAECFB..fDDEKCFFSEGE.hADA.NEIC.MAIF.JADChABA...,1,-11,-19,8
RdASGMNCEYeaUFcgQLHPWIfTXZbVOKJDB,MDFECEFB..EDBGeEDDFBEB.QAEALAHHHGDE.IEAEhAAATEEBZABH.bDAHhAAAKBBEBAHHACGHSFGAhABANIEBaHAC.UGBE.......hADA......hAEA...,1,-17,-19,2
eSXdLJAbFEgRMVcaDfOHNKWTYBGIQPCUZ,EBDAREAHMACF..aFFDDBBFHBFF.KEDFTCGCBBHEGAAA.hAAA.PFGBCFAAeEHFXEDBhABAdHCDAAEG.bAEC.hAAA..FGEDcDDA..OFCD.hACAWADDIHAE.hAFA...,1,-9,-27,18
cAIfMJDENUBVHbOeRYXSaWgTZCFdQKGLP,MABHECCCBHFAHEFE.ODFAeEECRFBG..XCDDSAGEaACC.hAAA..TFGAFHBCKAFAhADALDBAACFGJEACDGIDNBAAUBFChAAA..bFAGWBBC.CHCD....hAEA......hAFA...,2,-15,-10,5
LDbGScORZAaFBVUWXEPfeHdMCJYNTIQKg,FEBABGBCUBAGEDED..eCAEHFCC.dAGHJDHB..TGFBQBEAhAAAKHAELDHHDIACSGFDhABAOAEBAFAEaAHD.hAAA..XEBEMEEACHCH.YADE.hABAIHDD.gGGGhACA,2,-23,-15,8
FfYBJdXIGQgSDMCLcaHUOTeRZVAKbENWP,EGEC..NCCG.FEGABGFCdBDDGEBF.QGAEgADASDAChAAADBHFLEHBhAAAaGHHUAGGOEDAeABChABAZGACAIAEKDDE..WBAH.....YFDHhABA...hAFA...,1,-9,-30,21
gSJCATWaGVHcPOEBFUbKYDRdfNQMLIeXZ,aGFGHGAG.OEFDFDBDKDGHRBBCdAFF...QBGFIHHBeABChAAAZFDBJFHB..TBCDhABAVDAD..EAAAUAGAhAFA.DDIDfDDDMIBGLEDH.SDFFhBAAAHFB..hBEA.cFBDBADB,2,-12,6,18
JNBQeSWHdDEOFbTUgKAVcZGIRLPYfCMaX,VCADZDBCRAGBLFDA..fFAGCACB.MFIDaCCEJGAAhAAABDDE.QFEEhAAAeHEGSCFFdCGGDBAEEHDGhABAFBAC.TECDKGHBAEIH..IAECYACChAGANIAD.OHAE..hAHA...,1,-13,-15,2
ZNTQLUWBdcSGVIHKeFgaOXfCARbPJEMYD,REBDJAEDMBAHZDFB...QBCBLBBFBAACdDFFGEFEHGAAFDEDhACAaHCE...OFHHhADACEDGAAFBEAHBDAGH...NCDA.hAEAWAAB..SHEGIGAEeFHHhACA.XAFD.hAHA...,1,-2,-29,27
bNVTEMIBSaZcfdUHWKDFCgPAXeGOYRQLJ,eDDCOBACRDADLFEH..JEABVDGDTFDH..EGGBBHHEhAAAaBCC.ZBDH.dCGGHADGhAAADHBACFHGAGCAXGAGhABA........YDAChABA.NIDFMBIFcGCDhACAWAEE.,1,-1,-43,42
IXNTdVRWODEHeaBQCKfZcUGYPbLgFJMSA,XCDCdECHRBBGDIBE.HFCFBABFKEGB..ZFFEUAFBGAGG..bBBBhAAAFDAG..MFFHAIEE.hAAANDAA...TFAEhADAWABE.EAFH..aEEGCGDH...cGGH.hAEA......hAFA...,1,-9,-29,20
LRfbYOeBACaHQXZWVSUKDEdFJGINTPcMg,aGBEXBGHZDDH...SAEHDBGDEFHDFBCCJDDD..GBAChAAATCAEMAHHLGCAhAAARGEC.fHGFhABAOCFHAICGCFBHHABC.QEGDWABE...hAFAKGABNAIE.....hAGA...,2,-17,-1,16
bRCWadJIUPSeAgLcXNZHOVBMQGfTKDFYE,LDEEXCFBZFEGVAAHBFBC..QFFHGCCAKGBGDIAEFCADhAAAEBEGRACG...CCHBdEAAhAAAIAHESECFhACAAGIF.NEIG.MIDA..YAFCWFAD.aADHhAEA......hBGA...,1,-17,-21,4
ZDdWGSacITEBNJKCRUYHLQOXMAgbeVPFf,eBBAFGBFDFAAdGAGGDFC..aEAC.TEFBBDHGKAAA.CBCH.RFCFHCDFhAAALFDHOHEGhABAAFIF....bCACfCGFhACA.SADEECEFUAGF..hAGA......hAHA...,1,-16,-31,15
GXgNEcWLRaMKdPYTeFVQCUIJSBAOHfDbZ,HFBBDGDAGDEBXBDFEDCF.LEFA.aCACdFAG.PBDEhAAAeAGHFGEECCHH.UABEIFHGhABASEAFBCBCAHIFhACA.OHCEfDGH.....hADA......hAEA...,1,-4,-30,26
WCBIKUVfFEadQRHSYNXceDTJAMLOgGPZb,MEADLEFHGADCZBBGCEDCKCGB..UEAGFGBHdFDCRAFF.HBBF.SFHDhAAA.XGFHhABADDHHAICEOAAAhAEA.gFDAWBFEBCAC..IHAGhAFAEFEC...aCHF.hACA...,1,-15,-29,14
WSGONQEfFLMVXBUZbHCdPDeJgAYcaTKRI,aFBGRCAB..SCFCODCA.QFGHFFFEMCIBBBAHZFBGbDFACAGD.hAAA..DBAGeGCGJAFCAACEhAAATADF..IDDFhABANIBF.fHDHXABF...hAFA......hAHA...,2,-32,-14,18
YMBfHUbDNSaAJQecGPgIXKVFWTRCZLEdO,QEGHeACAGGDF..IEDCKBHBFFBBRCDELAABdCAG.MACEhAGABEGFUGBADEEFSAGChAAAAHIFPCEEXGEHhAHA...WCCF.CBEC..OBHFhAIAfDCG.NEIC.hABA...,1,-4,-35,31
SOfNKdFJcUTAIRgWbVLHaEBMXYDGCZPQe,RFED..bADHVCAE.LBHBEGGDBDHD.MFAGDGADZAEH.eEDFhAAAfAGA.KAAGhAAAFGBFJEEHUGGCAIFEIGAHhACAgACB..aHCG.....hABA..YDAAhADACHDA.SDGD.,1,-11,-15,4
HVABJdPMeaQUSDOXfNLbGEcTKFIgZRYCW,dGBCMHFAeDEFUEEEOEAE..XECGLDGHECDHKBDCFBGBZAAFhACARBAD.CGCH.HGAABCCEaAAAhADADGAH....NCIA.hAEA..bGFA.........hAFA......hAGA...,2,-27,-15,12
cKERFBWJMbUIfVQAHYeTLXZaGPSgCODNd,eCAFXGFBGACD.SGFCOECGdBECKGDBFDGBBCFC.JEFChAAAUAAE.IBGEhADAQFAHAIDGHFADTCCAhABAaFHDCDBFDIGC.NAIC.cFCE...WAHBhAEA.....hACA...,2,-21,-11,10
bTgSaNJQFcZIBLEVURdHWAXeGDKOMPYfC,eBHFDGFCMEDG..fFDGCBHD..TABCaCDC.QFBBhAAAZDBCLAAAEHAERCFEhABAHAFD.AIAAXFGEhABAKBEFPDAAgFAESAGCNIDF...hACAFHFC.BEHAdFFC..hADA...,1,8,-22,30
bKeQNZFDdYAgfIXLaPHWSOMcBEJVUTGCR,..ICBEXDACLGBGaEEA.HAEBSGGAMAAHBHFFhABAEHEEUABBTEBCCGAAKBFGhAAAeDEBZDGBDAHFADDC.fHGHhACAPECD.cDGG.....hACA......hAEA...,1,-7,-24,17
UHCeOdaJKRbWQgBAfFTSGVDZLIMcXYPEN,FEFDSGGBGBEFZACDLGCA.MICAXBAG.EHBGNBEHUCCDhAAAHEBA..CGACdHFBhAAAKBACREAH.QDFEhABABAFFfEHCDAEEIFDD....hACA......hADA...,1,-13,-19,6
KcPYGbNIZeEFaTOdVCAHgWRBfMSUJDLXQ,HBEERDEBBDBASEAEUFAG.JHFEDBADLABG.KCHH..hAAAPDHBGDDE.IHAAhACAEBBFFAGAOEDHhAAACFADAGFA....WDAEXGGG.QAEGhABAcDGC.YHCGhACA,2,-29,-29,0
VSaXHcKPObUQeDJECYWTRLgBIZGfFNMAd,SBAEaAAGHGAAKDBFOEDH..UCGEeFBBEFCCCGGH..TCEFhAAARFEFBHGE.ZBBAFBHHAAFHdAGBhADAXADC.bEFAhABADGIF....YHEA.LEADhACA....hAEA...,1,-16,-20,4
LeHIFGXWDJKbUPdCAaOZgSNfcQEVRTMYB,OBCFSAAA....fDFGEAHHTEGABBFCHEDDIGCGhAAAGEAGDCFDKAGEUDAEhABACBDBAHHBZAFF.cDCGhAAAQGGBMIDA.eEEB.WBHH..hACA......hADA...,2,-31,-1,30
KJLOVHARPMIUWfDXeTcNEQSgYBCaFdZGb,RFFFMAEEUDBADGEA..eBBC..TCCCEBHD.SDGHhAAABFDAFDEAdGAEZBEDKGCALBAFhAAAOBBBAEHB...IACChABAfAFANIABQBGHCHHF.aEBDhAIA...JFHB..hBAA...,2,-24,-17,7
VWJNKIRBAeOcXfYEGZdSHLTgaQPMCDUbF,ODAAXAEB..EGGBZCAGdBFHLFFD.TECDgGDAhAAAQBGHMEDECGBFUAAChADAFEGE.JHAGKEADIGHGhAHABAHBACIHeABC.fBCFSEBDhAIAaFDGDEGG....hBAA...,2,-13,-11,2
BLRPHAUcaCeTNYZESgDFGIMdKWVJQXfbO,UGCGCBGB.eFFETEGCZDDG...ECCADGBHFFDDMABDKBAA..JEBFQAGEhAAA.XAEFhACAbAEHBGGDRCBFAIFGaAHFhAAA..SADD.IHHBhBAAWDAFOABG...hBCA...,1,-20,-25,5
FRTeSUBVMdEIgOPALNCcDGWXZJHfaYKQb,CADGGADAZECAHFABaGHFKFDGFAFB....RBAH.eBABBGDCMIDGdCGF.EGAEhAAAOEHDAGGD.LHEEhAAADFBEJAFC..fCGFhABAQCDGbBBF.......hABA..SDHHhACA..,2,-22,-8,14
ZUMDbFcaYKHEGQNABRIeTWSfXVJPOCgdL,BCFHRECDeBFCSEEC..fHGFXFGA.VAABOFBChAAACHDHLEFEMCAGDCHHhABAbEAFaDAD..KADBECDFhACANDDF.TAEB.JHAC.PHFCdHAD..hADA..FFGBcAGFhAEA...,2,-21,3,24
cbJVSGCNQXRDYTIZWEOUHdKfAgaFBePML,aCAGBDEC.eAACMFBFLFAG.JHDEVFDD.CDDE.QEGBhAAARDFCDAHD..TBEAhAAAZBCBEBHBHABGdHAHAAEEgGGFhABAFCBB..cCFFSEAEhACA......hAEA...,2,-19,-13,6
DXbZFUOdIESfAcaMYgRGVeLKBQHPCWNTJ,aEEBMAEE.RCEC.eDCFBFBHHABF.CAFE.TABBDGHFZBFG..FFGGOFFFhAAAEHEA.AHEA...hABAgGBALEABKDHDhADAPBAHNIAD.bAFE.dEBF..SBDBhAEAfEEG...hAHA...,2,-13,-13,0
EMCDOUBPQIGKaLYZTXdFeHcWJVbgSNRfA,MDFFCADGDGFH.BDBC..QBFGKEGBLAAGZDCFdCAAeBGHHFADhAAAJGBG.....bEEEhABASAGE.hACAfFAHADHEEGHFOAFAIHHF.YAEDhABA.TDCEhACA..,2,-27,-25,2
dOZMSHEeTFPgbWQYIUNVcGRJBALKaCfXD,KHCAaEDF.CFGD.DCBCZECAHEAE..ECBFFGGG.....bAEEQAFChAAAUDGA.NDDFGABDhABABCDHLAADhACA.fGCGdFHAOEABMIEESCHHhACA.....hADA...,1,-19,-23,4
fLaMBeUAJdRTHPSgNIZbCVYOcFXQWGKED,dEDBTGCFHBAF.SGEB..IFAFCCEFOGACcDCBhAAAQDGH.KAGFhAAAEEEF.fAEFhABAaFAAMIAGBHHGAEAARCGBPACHgABBZGFCYAHHhADA....hAEA...,1,-10,-22,12
FaWDSPbZcegARQMEHKLUfVYdJBOCTINXG,QGBAMBHDHCDFLFBHUBAF.VABEdBEDBDDB.OEABhAAATGGA..IEFFhABANAIEFGABDAFG.SBADhAAAPDHHZFDHcGEHAIAEKGHB....fDBEhACACFFAaGDH..hADA...,2,-28,1,29
JQAHbPETWVaDgdZBIKYfRUOFCNGLcXSMe,HADGEBCE.VCDBDACEdEFGZEADBGEFKHEC.RGFE.FCFGGAGGLGAG.hAAA.XBACMDEHQBAGhAAAAFFE.TEBChABAaDHD...YAFE.fHGHhBEA...hABA...,2,-17,-17,0
gMFOTQDHAYBWVNGPbSJeCcZEaIRfKULdX,BDFH..NBFCGGBDSCCG.eCAHZDAEICBEREBA.hAAAKAGHdAGA.XGFDhABAgACGFEHBTADChACADIFGAGAG...YGBGPGFAJCGF.CAAE.hADA......hAEAaFFB..,1,-18,-27,9
aOQbfLMKJXHDYEgGWFNPRAUVTecIZCSBd,TDCCeDFGZBBC.CFCG.BFBC.dBAAQDBDLDGHMDIHKHBGJFEGhAAADEAB..EAFHgGCChAAAFAHB.RACAAHAG.hABA....cBEDaACEfGHChACA.YHDCNEFC.hABAPFABIHHH,2,-15,-14,1
DCfgSWXNBTPLQEecGJdKIaHUVbRZAOYFM,FBACDCEHCGEE..SDBG..NEHABCFHPHAC..EEBCGCGAhAAA.JBFDdGADaFGHhABAVABDRECA..AFAHMIFGhACA..fEFEWADDLAEEeAEEIHDFhAAA..hABA...,1,-5,-50,45
XOAfTbWEPGLKgcaQZBYDdUHSNRVIMeFCJ,TCEDEHAEGFEH.LBFDKFAG.aCAHZDAABGDGDIDEUAAB.hAAASFGHRCCDICGHhABAMEEFCBBEOCHDAAFC.hABAfAGBPBHF.cFAF.dHFHNBDDFHAGhADA.....hACA...,2,-20,-10,10
BIMeWNCXQKbVgGTPDHLadEZOSAYUJfRFc,UEBBRABDBDFHeGEA..CHBBKCEF..bACHGFBB..PAEEhAAALEHB.dAFFEEFAhABAOHDESCHBhACAAFFG.fHADFEAGMAIH.WHFA...hAAA....QCEGhAEA,1,-12,-39,27
gSABFOTLbWKdXeUJNHEIVRMafQcYZCPGD,OBDHLCAGKGCFeEED.UAGHJGFCHAGBEEAA..RDGB.MACAaFDH.hAAAQFDAZFFH.hABACBEDDIFGAAEHFABD.bFBHdBAGhAAA.IGAF.fDFG.hADAYCBB..hABA...,2,-29,-7,22
YPaDgIHZcXbdfARMWUeTNGBQOLCJVKEFS,RDBGMCFCeFABGBACBGEFLDGBCDHA.KAAAFECG.SGABhAAA.aGFDDIEGIEFAhABAZADBXBFG.hACAdACAAAHFTGDBNCIE.OACF.EAEG.hAAA......hAGA...,2,-29,-13,16
aTVPREAHDCbQcKLXSJWFINOgGedBfUZYM,DDFACCAH.QAEHKDDALFFE..JEGHFCCGOHCGGEBEdAAABAFChAAAUDAGZAGB.MIDChABAVDDF...EGABAGGA.hACA............hADA......hAEA...,1,-29,-37,8
VaALgRZPecJHEKBTXSOGIdQUFCMDbNWYf,RGAAZBECeBGDHFFBBBDEXEAEGFDB.dDDDUBAF.FFDADFBC..hAAA..NIBD.fABHhABAADDELBHB..cAGFhAEAEGAFKAECOHCECDAAMAAE.....hAFA......hAIA...,2,-25,-8,17
fcPJSVKDAFOBLbNeQGdRgXCWIZMHTUaYE,OCCGBEHELFCA.eAEGdADFXAGCCDBDZBFE.HCGFaHGC.hAAAEEBB...fAAEhABAJCDFKBBBAHHCFHAGQGDAhACARDFB...IHHHMCAF.UDEEhAHA.....hABA...,1,-7,-25,18
VdgKWREAJGaXBbMHONIFTUDSCPLYZeQfc,GFAHaGHDBADFHCED.IGFBFGFCDBIF.CBDBLCACZCCH.eAHBhAAAQGAF.hABAVAFHKHGAEEAA.AFIH.hACAJAADMDHFODGDNIAD..SAEEhADAfCEE.....hAIA...,1,-3,-29,26
IKEWDHLfJXScbFdRYACMaUPNOQGZgeBTV,aDEHUABA.OEFHGBBCZECFeEHB.BAEG..IGBAhAAAEAAFHAFFLBEEfFAChAAAJHFE.SGFDhACAFEGGRCDCAAGA.MIAC..NEAE.gGGDhADA.KFDDDICE...hAFA...,1,-4,-20,16
IMUdCVRGcDWNXHBAKESaYTOJbQFZPLgef,SGFDTDFB.OFACQAFB.FDCBPDEBLBAChAAAeCAFfGHEhABAMACECBACRBEADDIBNIBDBADE.KEDHhACAEHGEJGAC......gCBHhAAA.IAHBhABA...,2,-25,-9,16
ZBMebgLEQSPRDWHTJaCKFfVAGcNUYIXOd,GBDAUFGB..XAFHOFECdHBH.MAHBeCCFLEHBhAAAEACESEDFRCBBDCGH.TGDHhAAAaGAGKABC.FAEAAIAG.hABA.NCBA.IHFBBAHEgCGA.hAIAWEAD.CFEB...hAEA...,1,-9,-26,17
STYdRQLPIKFbUOgXfaMZGHENcCAJBWeVD,JFDEBEFF.eHCGDCHF...SABFdGAGRDBCLCCCKGDCFCCE.OAFDhAAA..fAEFhAAAMEBGHGFEEGGHCBHFAADDhAEA...TFADPABG...bGCG.hAFA......hAHA...,2,-34,-23,11
VKCIAFOTYSfMaPQeGBHJLZDdbUWREgcNX,TACDSACB.MCEEQFBD.eGEGBFHALDEAhAAAZEDBDFGFdBAAUAGEEEACNEIEKBAHhABAAGABFAEAOAED.hAAAfFFBaDGE....PHAChABA..JCCFWFFD.hACAcEBECEAH,1,-5,-26,21
dHYTESAXILBZgDCfOKFNWeaRGUQPVcbJM,XFBFLEDDBBBBDDBA.OEABKEDEFHDGeADA.GBEFUAFDQAAChACA.hAAA.PEFHVEGBJADHhAEAMIEAdGACYCAA.EHAAAIHA.IGHAhABACDGF.fEGBhACA..,2,-23,-6,17
LegEbCNJSPTWFGafIcZMRYKUOdXVQBHDA,eDEEEFDC.CAHC.SGBB..TBACFADHaCFB..fGGEhAAAZFGDRAFGKABHOEAEhAAAdGBHQAEABHDCAHAA.hABALEAE.bEFC.NEEG..PABAhBAAIGFAMBID...hAEA...,1,-1,-29,28
LgWNPGFaAEXZKTVdeHIMSYcBfRbDCJUQO,XGEGZFACKACHdBEEHEFG..SFGDBDBARAEGCEDG.UCAGLGAChAAA...gBAAhABAWDDG..NIEH.hAAAPDDA..aHACAIBEEBHHeBHDIHHBhACA.....hABA...,1,-5,-39,34
SdPNeTHKOWaEAXFJLRCYbGQUBfZIgMVcD,XFFCLEFGCFCDGBBCBCDEZDAG..IFDCMABA.DBFEdGGDhAAAeHFAKHBA..OBFAhAFAECGGABIDFAAD.RGAG.QFDChAGAgDEESBCCNAEB..hAHA......hAIA...,1,-6,-31,25
ODVbWGIPFUYcQMfeCNZJXHSREgTALBdaK,dEACaDGC.OFEBDFCA....VACCGDDFFFFE.UABA..QBAGhAAAMFCDCADHJGFGSBFAhABARBFE.TGBHhACAABHEBHAHKAFC.IDEB.PHDChAIA.fGHAhBIA..,2,-35,-14,21
SIYKXQUeCEZJcWNGFaLMVHfPTbRBdgDOA,SDFDKAGFUACD.eCACCCDG.ZGBE..JEGH..NEAD.FFBCaAAG.hAAALFAEHFDF.TFGGhADABBADDCHF.AFFH.hABAXACA.EAHD.WBGDMDAF.fHABhADA..hAFA...,1,-7,-49,42
IODCSTARGeFUcBPbXgKZdMHJEaYVLfWQN,GCDHeEAGFADGUEGEBHEB..XADCZDDDdFGCHAAFEECD.aHAELFADhAAA.WGCGhABANCDF..OBHDDBCFCBHEAHIHhACA............hAEA......hAFA...,1,-25,-27,2
NWQcOZTKafBCMIeVHFUbASYXPDLdJgERG,XFCDDFAFdGCA..EBDGRBAAGEAA.QDECOFGBTAADhAAAaAHHBHHF.CCFBeADEhAAAFAEAAHHDSEDEhACA.LBHBgGFFNDCH..cDAFhADAKEGA.MFIH.IGEFhAHA,2,-19,-18,1
DWGQbZafOeAKEXFVNMdSTLRUBCcYHgJPI,KEDCEEBGFFGHMFAE..dCDDLDHFBFEC.CBECHGBGJHAE..DDIHQABBhAAAZACE.fCAChACAAAHG.NEGC.hAEASBAHUAGG.gAGGIHHEWDCChAFAaDEE....hBAAOHDE.,1,-3,-38,35
LcIJKGSMYUNVfBFbPDWOCTQeaXREZAgdH,dFBBHFACLFFGJDDHKCAD.SHBE.MABGNBBFBGGD.FDHDhAAAPBBE.DEDACBHDeCDGhABARAEGAIEA..gCGAhAAAIHAE...YHFCfGEChACA.OAFG.aHGEhADA.EEAA.,1,-16,-30,14
DEMKBdJbYXfaVcNZICAQPLFgWURHSeOTG,LBFDFDCEUFCDHABASBCG.eEBAOBAHDEAH.KHGGJAAF.hAAA.XAGF.hABAaGGAcGCE.IFFAhACACDHCAICEQBEEWADC..GBGChAHABGFGYFABNEIE.hAIA...,2,-26,-18,8
eENYZObAPTKSDFMXGBRQcdaCJgILUWfVH,KFGBDGEEMEBFBHBARDEA..QBCHdCAH.CCGE.JEBBLEFEhAAA.UFCAVAEHEAFCZAAChABAAHHA....SABChAEAFAHB....cEDH.aHDChACAWHFG....hAFA...,1,-34,-36,2
RLWHeEKcaSNZbAgMXDCGIYQFTVfBOPUJd,XBGGCFDEGCAB..QAEEFBDE..VEEABHHGODAFhAAAJEHFdEAELDHBHDEDEGFHhAAAKACD.aHEESBHBhABANEDC.AIAADBBEIAHGTGBAUGAF.hACA......hADA...,2,-12,-11,1
GfgdaEAKbPBCXTLeHZDYIFOVUQNcRJWMS,KDDCBEFECHAC.LBACHEGFDADDFGGC.UGCGQAFC.RFBD.MAFDhAAAGAAAdDAAAEEF..hABAbFEFTAGB.eCCDhACA...IGAF.OCHFhADANBIE...WHFGSGDHhAAA,1,-18,-32,14
fAIBTLJDKYHCSeOZFUgbdPcGXRVaQWNEM,TCEGLABF.JHFCKEADHEEE..SBEEOGAGZAEAFGGA.hAAAUACGdCEF.GGABhAAAXDBAaHFC..NAIEMDDFhABAIDHF.DFIDCEGB..eBBD...hADA......hAFA...,1,-6,-25,19
FNEQHRLITUOKVMXYaGPJdZgCbcBDWfASe,SFAHFEHD.QBCDHACFRGAELEBEUAGFKCGGXAGDhAAAGGEFdACFCHEHBFFGfFCBhAAAAFDHEAFH.OEFGhABAMABF...aHAE.......hACA......hAEA...,1,-8,-27,19
HVEfFGIPZeCYgKJbWNQBcOXRLMTdSAUaD,aBHHDABHEEBFGDDC.ZBDACFGC..KHAA..JHEE....bBDFNCCGBGAEhAAA..XGDAhAAAMAEEdCAGADFCVAGBhACAIABE..eCCBgFGE..hADAWEFCcGBE..hAIAODAB.,1,-16,-29,13
UXORIWSeDAdfCFGEZbaLJBQPTgKHYVMNc,CBDAFFDAZDBHLAHDBGGE.QCCF..TBFCKABCHCFFhAAAMDEHUGGFRAAA.SFCDhAEAAEHAdHAD..fDFGhAAAEEHHaAEE.PHDEYFAF.NBBA.hAFA..OADA.hBAA...,2,-30,-10,20
TBAZDVPWICNcfGXRJeQgKOELUdSHbFMaY,VDAF..IHGCCADF...fBFBGDDGRAGHJFHFeDBBhAAAKABHEHBC.dFECSGDDhAAAFDGFMABCYFADhAFAADCCDCIF...PDCG.NCBB..XFGEhAGAQGAB.hAHAgGFD.,2,-27,0,27
WJIKVMNbUQHRBeDFPTcXZEfCdYOLSgGAa,aHCCJCAB..KEBGMCFD.UABARDEFBGCB..eBHBDIFA.FFAE..hAAA.TEGEXBGBhAAAEAEFdGDHLEHH.hAEAGABHIHAC..NIAD.bDBEQCCBhABA..cGGEhAGACGAH..,1,-8,-33,25
AGHeVPZbIXJYFgNBdKMWSCELRaDQTUOfc,eCCAZABA..IHFAJBHFFEAH.BEFB.MCAGCBACLDFF.hAAADEHDTFGG.OEAEhACAAIFCGGCHHAGD.hAAAVGACbADE.XDDB..YHAAhABA.dCBGKGDE.EDAChADA...,2,-18,-12,6
MVHcgaNTFWfSQeRIXUDdJEGbLKCBOZAPY,MCGFVCBC.HDBE.aFFCTGAH.FGEBfBHC.SFHBhAAARAGFIAFDDGAGhABAEABHLFDFCEAFBFCHAGHGhAAAcBDC.gABFNFEF.eAEChAEAXGGGJHEA.KADH.hAIA...,1,-7,-18,11
gbFDJRLcXKdeEAIBYNQCPSaZUHWMOfTGV,BDEGQACDCBBE.aCFCUGGD.HGCAOGFAGAFE..VEAHhAAAFEACRCAGLHAGhABAKEGG.eHEGAIAE.IEDGhACANABB.SDCC.WCHHfFDDhAAA...hAEA...,2,-29,-19,10
VeYMGCJDbKdAZcXOESBaLUFTQHWfNIPgR,XDFBEFBHBDFDUBBAFDAA..HFAA...NEIC.PGFE.hAAARAGF.VACCeEDBMICAhABACDHADADG..KAHDAIFGOBEBhAAASDDBLCAFTFEH....hACAWFFEIHGC.hABA...,1,-9,-28,19
OUHRWYVAbTFCeIadfBNGDLSgKPJEcZXQM,FDFHeEBGdAFG.BHBCDCDDLBFE.SGADKBCCJDHHZDDHMACHhAAA.HFEBREAG.VCGHhABAABAC.CHHF..fGCFhADA.NAEA.gCAEEFAE..hAAA.XGDG.hAFAOAHD.,2,-43,2,45
NDSGMTcKZXQdgAeILbRWFPJCfUYHEOaVB,LCEGRFEGFCGE.CDAEUAAAECCE..OFBDBGCDDEEGGADH.MEIHhAAAKGGCZDCF.dFAAAABFeCABhACA..IEHHhADAWHEA..fDEAaAGB.SGAFhADA..cGFHhAEA.,2,-49,-15,34
SPIVWgRNacUbYFJZTAHeEOKGDXCfQBLdM,EHBCOFCBKAFG.DEBC..CDFEBBBHLGFE.dEEDSECHhAAA..PAFBVFGDREAHhABANCAD.UADAFAHHJAAGAIFGHEEHhACA..eEAD.fGDAMAIH.hAHAWHEA....hAAA...,1,-13,-33,20
AJOFNUbYEBPdWTcDCILRZGeHXKMVfgQaS,FGDFUADBEBAHdABG....TDABDEDHCHEELBHDZAGDHEFEMCDFhAAA..VEEEQGAChABAAICA.NAFGBHGDhACA..cGAG...IHHFhAAA......hAEA...,1,-6,-49,43
dBOgeHbCcZaNVKIWPUEFSLJGXDMRYfAQT,dCEEBAHCOEADeDHDCGHGZGCG....aBBCKBBA...IAFHhAAAUGBCSGEHhAAALCGFXCACRADEAFDC.hABATGGBbDDA.NBIG.PCABEEDD....hACA......hADA...,1,-17,-31,14
aCLNAHZFOTBWSdIfGgKcDMReXQEUJbPVY,FCCABABHdDFCGCDFKAFH.DGBBRDBH...eEAFQFGEEEGB..hAAAUGGDJHDE...VECAhAAACDHEAFAF.OAEE.hABASBAGIAHA.fGCGMBBH.hACA......hADA...,2,-40,-18,22
SdgXADcWQGaZfLYHIbUJKTBOCPRVFNMEe,DBAFQFEBGEDHZBGDLAAFHEAHUGGAJCHDBCCC..CGDFRCDCVFBFhACAFBBC...NEAE.MICEhAAA..SBEEhADAdAEFAHAD.aEDGfDBBIGHHKCEG.hABA......hACA...,1,-14,-15,1
eEULKSQHJdcOWRYAGDXfFPBagCZMIbNVT,GBAADGFGFGDHBEBHaFHFZGAC...MDGB..NDAF.eDDDLEEGhAAASCGEHAFEdAEChABAOHEA.RAEHXEBHhAAAfCGCCACF.IBBD....hACA......hADA...,1,-5,-41,36
ITPXeLRYMDUWOgNbcaJHKGfFVdCBQSAEZ,ZECHTDBCeDAB.RBAE.DBBAUAGH..OFHD..bBDFaBGHKGFBhAAAFFEG.dCHABEFHAAHGEHBGhAAAXCFGLADBMFADhABA..NBAA..cGED....hABA......hACA...,1,-20,-26,6
SVGLBIDcbCfRXKWAOdQeFJEaUNTZgYMHP,OAFFdBDDeGEAFDBCEGCA..UDFDZBGFMFACHADF....SGGFhAAAGAACIHAFhAAADBAGCBHGRFAB.XDDAhACA.AGAEaFGANEEE....YFHB.hADA......hAEA...,2,-24,-15,9
cSgMYZBDPaLdQFJGfeUbCNVKXAORHITWE,OAEBHCGDTABG.EFEDSFDE.MHFGZGAGPBEHhAAAaCGCQBBFFEADfGGAhABAbGBE.NEICKAEEhADAACAHIAHA.WEEEYDCDDIFGdGAG.hAHAeFAECFFE....hAAA...,2,-21,8,29
KPQNJgAIDHeSdZWFYRLfXVOaUbBMGcETC,DDBHHAGFeACESABBZEGH.FEDALFDBVEAC.aCEHUDGFBABDhAAAMDBAEGFD..CGBAKAGGhAFAPFGF..NCIG.AADC.hAAA..dCFHWGAAfBCAXADE..hAGA......hAIA...,2,-18,-15,3
DMLXYICQZVGdBAEHcUePJOSFTNgbWafRK,ECBEHFFFUFADJAFCFBBH....TADG..gEAAhAAAaEFBKDGEDGIBXDFGhABA.IGCDCAAEZFDHdGGGhACAADEFeACGPBFCSGDH.NCIC..hADA.WHAA...hAEA...,1,-19,-25,6
bYFLCWcSMKIBXANQaVTgOHZJUfGRePEdD,aFCCTFECHDFG.ZGCEJBDGUBEG..GCABeBBFdAHGDHCCFDGDCHHF.hAAA..SABEhAAAMDADKACCBECEXFABhAEAACDA.NBIA...........hAFA......hAGA...,1,-19,-30,11
PVJcKEZHBaURgMfQeSbLAGTdWCFNYODIX,dCACCEBCFCHFOHBC.DECB..IBDE..PCCGJFEGKAGGhAAAHFEB.aEGHRGCEMBABhABAeDHBLABChAAA.ADFHTAFBNEDB..YCDG.hAFAXGAB.EBBHhACABGDC.,1,-18,-31,13
HMeTSZPVNcbWGUCfBRJEOQYXFdLADaIKg,DFDDaDDE.KGAGHADF.eHDGSEHBZABD..NDGC...bAAGGAGEhAAA.CGACfBAChABABEFDRAFEECAAQEADhABAXFBFLFHDAEDEIHGFMIAAPCDChACA...cGEBhADA..,2,-25,-3,22
IgBSPJVEMTGceQCaOfRZUDNXYALbHWKdF,HFEDKFDFFABBBCDF.JDHFMFFGGCBA..QBFGCAAG.hABAOCEHfHAFhACAZEAHDGAB..NAEDABGB.LFDDhADAWHEG.IHGHPCCH..EADH.hBCA.eBFDaAFAXGGEhAAA.,1,-10,-35,25
VXZYRfOBacAgTNJLEMeSbFUQKdHWIDCPG,TAFBLDFD.EFBCMEEA..SFHHFFAEKAAGHFFCDBBBCHAFGACAhAAAZBFARACDBHEAACABNIAB.hACAeHBAQFDEhAEAdEDEIAGCPBHD....YCAFhAAA...aHGC..hABA...,1,2,-16,18
IYUGTdZHaPgXJOWeQLRASENMKBCbDfFVc,SDBEMGEGBDGHDBACFAFC....IACBGACGZBFG.aGBGhAAAPEAC.XGEAhAAAOFHDeEAGLBBAhABAAGAHKHFGfEEB.cBGE.hABAUGCAdAFH....hAEAgCAE.,1,-10,-19,9
JTLHCGKeDUfOINRcXbPVAFadQMgWSEZBY,FEBGaBAF.MABD..SFBCZEEBBCCF.JFFALACCHACEGCCBhAAAKGHHDCGAOAGD.hAAANBIC.XDGB.hABAVGAEAEADdHEF.gGAAEAGCCGGF..eDDHhAGAIHHE..hACA...,1,-16,-17,1
ADZVdLJFPWcKHTfMSGCeEaOUBRQbIgYNX,ZDEALHAAJHCA.FDEG.....PFBCKFDGTBEE.MAEChAAAGBAA.CBHCaFFHhAAAUCACQAEFhABA.gGGBXGGBABIBDIEA.dACCWBAEhABA....fCHAhAFA,2,-51,-8,43
EAJbKHGTVCWaYZMeIRcXOUSPgQLBdDfFN,KHEGTEGGCADF...aDCAMAFA..eAGFRCCG.OFAASCGAhAAAQGEDdEGHFEBHAIAEbAAAhAAAHGBG..WCEHhABAICACUCAEPBHFBFEAfGGEhABAEGAG......hACA...,2,-33,7,40
fZWLKNHADJIRdeEFSOCgbPBXaYMUVcQTG,JADEREGDeEBE..SCCGOBAH..CBCF.....bGFGPGDAhAAABDGF..aHBAMIAEhABA.VBFDQECChAAATFAB.fEHGWAHB.LBAFhABANIEBAAFBDDCG.IAHChACA.EFFE.,2,-35,-12,23
VECQAXKgRJBMTGeOPWFdDfSIabHZNcUYL,XBFGKFDFRBDABEFBGEAE..OABFFDGCDBDB..SGGEhAAAICBAHEDEZFAD.hABANBAA....YAHHhAAAECHBCHFDAAHGMEAF..TFGDeDAG..hABA......hACA...,1,-21,-29,8
QedULXaRAPIOBGWSMHCZcDbFJKfNgYETV,OFBHBCGDSBDFHAFFZGFEDEDFFGAHKFBC....gACHhAAATCAH.eDHHLHFGhAAAaEEBAICG.IABBhADAMBABCAHGJCBHNAFE..EEHD.dGEF....hAEA......hAGA...,1,-9,-28,19
RADNacXIbdBfFYJTZOMeLSGWHPgEKQCVU,aAEGXCBB.dFEGBBFF.FEGDJFBBZCBC.eBGFSDDFhAAAHECBEHAAKDHH..CGHAUAAFhABADAHHIADF.hADA.YFEBTGGBMAGB.LBADhABA..WAHB.hACA...,1,-14,-30,16
EAaSKRTHFPLMXCZDNWJbOYUgdBVfGcQIe,aGCCRCADFFGBLDDE..XCDADAHHJABD.OFBC.UAADhABABEEBGAEFIAEFhAAAAFAFKHDCHDGF.MAIFhABACHHD...NDAE.WHAGgGGAdCHE.fECEhADA..hAGA...,2,-31,-20,11
PLGfTBWCgaDEZIKUNVMORFedbHSQcJAXY,XCAALCDDTCAFBDED..CBCBDFDBEFHBKGBA..UBGDVFEHhAAAOHAE.FGECbCFGhABAHEADQAGDhACA.AAEC.PEFC..fEBAhADAWACEaAAF.NBBBMIAAdGGA..hAGA...,2,-19,-10,9
UVBCdHALEDRcSeIFQXaTYZMJKgGfPbOWN,ECEBREBAeAGBFEAA...QGGEaEEE..ZGDAMDDAJAHBKACCfGCAhAAA.OEAHhABAUGADCABGABEFDIEA.IEHChACATFGG.gEEBPAFF.WBBFhADABDDG.....hAEA...,2,-28,-22,6
XOaYINGBSdQFRJAegMZfbUVPCDHKWTcLE,eEECZFGDUFCHCFHD.HBABKCEG....TBCBEDDAOFAD.aAEHhAAANABF..BHBFdACCRAFAJHDGhAAAAHDF....MFFBhABAbAFA.DCIDLGAC.IHHBSDFAhAFAFEBG.....hAGA...,2,-29,-6,23
OKRJbQCBYfSDHPFTUGZNWAdVMcageIXLE,dCGFVBEFMEDA..aEGBeHAE.LEHHKACC.RBCE.QCBBhAAACFDHBEAG.fHDBhABASFFGDEBBFAADTAGHhAFA.UGADNADBAGBEIHFCEHGG..hAAAJEEF.....hACA...,2,-28,-5,23
EfMPgXICURaDOZbVQTFdeKAYNHLJWScBG,HBAHJCFD.SDEGBHBHGACHEHDGMGDE..XFAGhAAACAGCaFHHDFCAOFHH.VCADhABAFBFHeBHB.ADCANAABhAFALHDA.cEDC...PBHDhACA....hADA...,1,-13,-27,14
UBfESNJAbMKZLOQePDFIVWXYHCRGcagTd,KAFALAHHQEGGDEDHFGGE....IBACXAADCFEDGADGhAAAaGFH.dHDDfGCGhAAAECCB.SGBDhACAACHFMFADeDBDPCEH.VAEE.WEAFhADA.....hABA...,2,-25,-18,7
TOXKDSELQIfUVJFaWMBGcbHeZRYCAPdgN,dABBTECBKDFCDHGA..LADA.IHFDfCCBUCEAhAAAFHBCaBHDBCBG.GEEAhAAAHABBRFFGABEB.NHAF.SFAEhAEA.EBGAQEAEJDHB.hAFAMIAG....hABA...,2,-28,-9,19
PaBgdOXSLJeCMbAfGHVIEWRNZKQDFTcYU,HDDBVBEG.ECFC.RACAKGGBFHBE....TEEGUAAAaHACBCADdFGFOCCBhAAALDAB.CHEGAHBAhADAfFAB.hAFAIEHH.NABHDBCGcCGD..gGGDhAGASECF.hAHA.MAIF.,1,-10,-20,10
eIbALWfdUSPOMNZYgcGTQCBFKEJVHXDRa,LGFAdBFGSGGFODBEZEAD....gBGDTAACCDHBFGCHhAAAEFAEHADD.DEHFhAAAeDDHAGDBUBAHNAEHGACChACABAHEJCFF...XGACIGEH.hABA....WFFEhBEAMIFE..,1,-2,-23,21
VOfHdNZGLWQKJMeISAUDCBYXFERTagcbP,UCDACGBBBDFHFCAA..RBCB...aEGF....bFFEOAAGHBAFdAGHhAAAZGCELFFBhAEAKBFFMIDC.IBHEDACC.hABAEFAH...gEBBcECC.fAFGhAGANHDF..WFADhAFA.eEFA,2,-35,-17,18
MAXZEeJBNdcfYaRgHWVTbQLKFSPCDUGOI,XBFGeFCDBDGDdCCH....fAFGREGHHDADTGEELCAGhAAASBHBDIAGUEDHhABAIHACAEAFEAGEcEGEhACAYAAC.gEECbABA.KAFCCHHD.hADA......hAIA...,1,-2,-19,17
OQBJIgESbCeaYZRcfHMLXGKUWPdAVTFDN,TFFHFDEBDHFE...OAGHBAGD..JBABEFAC.CEFF...eDGFhAAAaCBDRADHHDBBLAAChAFAKHAA...PCHDhAHAACCC.VFCHNDIE.IHHHSBEG..hABA......hACA...,1,-3,-47,44
AbVMFEPBNYTOJfRedWKIGLDZXHUcagQSC,MFHFFEGAECDGBAAB....TEBEOCFARABHdBHEKAFGLEEDhACAZFFCUAFA.aEBF.SBCFhADACEACAABB...hAAAbFAHNIAD...YDFBfGDB..hADA....WFDDhAEA.DDDC.,2,-37,-18,19
QIKRcEMLbFYaUdBeSHJNGVgOPDWAfTXZC,TEECXDDC.ZFDDQADE.RCBAEFBAMCGB.FAGAaDHDBACHhAAAHBFFJBBH.VFGDhABAgGGD.PHBAhAAADFCHAFAB.IAHGKBEE..bFAHdBABSCADhACANDAE..hAEA...,1,16,-24,40
EGAgYcMebWXFZPRNKIfSJdQBDLaTHUOVC,....gDCFMBEDbDCD.FGDAZGDERBEEKBAG..SHAChAAAdEFDDGAA.TBGGOAFAhAAACHHCACAD.eCBFXGGHhABAIAFAfDAAJABGLEFGaADB..hABA......hAHA...,2,-16,-13,3
RKbQALIBdOWDeJPGMSXZaTNgHEFCfcUVY,BHBFdECDDEHDeDCDGEAEMBEBZGDA..aEFG..TBAGHAFCCDAEUAFBhAAARGFE.KDCEQAAGhACAAFGH.IFAChADAJABA.SHDGNDIG.FFGA...hAEA......hAGA...,1,-4,-26,22
ebTdKVIUOJcLHPDNRBYgGESAFaXfMCZQW,XEEHMFHFZGAE..eABFdBGGKCAF.UCCFOEEFLAFEDCCDBAGAhAAAGEACACGF.FHGECADA.hABA....WFDFhAAA...........bABGhACA.IFHAcCGDNEIChADA.gDCHSCHB,1,-11,-39,28
PISRLfYUdbaNegAZTEXcHFKCMQBVGDOJW,ZBCDEDEEHFCGKCAE.CFAEBFHFDEEG..OEHFJBAA....ICHAhAAASFAB.LHCGhAAAfGAGUAGDhABAaDBGeFGDAECC.TFCAcADAFBED..MIEEhABA.....hACA...,2,-28,-25,3
deGTJRaSOXCMIEcZBWNbPYAfDULFHQgKV,DIGAUEEBHDDBQBGBKADAdGFDGAAERCAC..aHAESHCGhAAA.OCEGCAEHMIDChAAAIDGHEGHBBAGBNAIE.hACAPEAH.AHECfABHLFAH.FECDhABAeDCFTCED..hAEA...,1,-2,-19,17
BVeARWXGNZOHPJKSLaMEQgUDFcCdTYIbf,XBCGZBFEOEHHHAEHKBDD.LEEB.EHCEQEABhAAADHGACCGEdDAA.IBAABHADAEGB.hAAARFEH...NGAHSABEhAEAaHBAUDEF..FADA......hABA......hACA...,1,-14,-24,10
WUfbeOcMaJIERNKSHBYCPZFgAdQLVTGXD,LFHBGGAFDDIBUCBCeBAAOBAH..MGDAaFEF.EBEEKFCASDCChAAABBHA.CFHGZAGDhABAFHBAAHGGQEAChACA.TDEHWBBE.fHEFJAFD.hAAAIHHANEEB..hADA..YFAD,2,-27,-12,15
CagAcIJNdKXMWHYFTGUZOBDPbfQeELVSR,JFBDKEAEMCAAHDFEFDDDGDEF..ODAHDGCE....PFFHhAAAfGGE.eBEGhAAALAHBSACDhABACAFBADBAIADDNICB..WAHBYHBEhABA......hACA...,1,-19,-37,18
KXbHVUSOAcEWRdMQLYBeIfCTgJPZDNGFa,EFAFRDDFdBAELCDEBDHC.eDFACHHD...TBAGJBFA.ZFDEDACFFEHDhAAA.KEDAHGAA.UEADhAAAAADAMIAG.IHHEhABA..PFFFaADE.....hACA......hAGA...,1,-14,-43,29
gWfCRVcSEAdTULbOYDaQJXKNMIHeFPBZG,UGDDOEAEDCHH..aEEHQDAH.KBBHMICC.eBCDhAAABAGEZADCGADC.hABA.fCGFhACACABCVFABEGGGTGGGLEFAYGAC.NAEH..hAAAIEHC..hBAA...,1,-19,-31,12
KVXHgDYOPGBZbIUNeFJMTCASWcafELRdQ,SFFCaGEGLBEBRAFF.dBGEKCCGHGFC.DBBFOFBEBGCCZDACUGGHhAAAFFAHMDAH.AACA.fCCDhAAAEHAA..hABAXDBGPDHDIACEeHCCCBAG.WHAAhAEA......hAFA...,2,-19,-17,2
YJIZaedSfENRcFOXCTLVUQAGKWgDMbBPH,GCFEKCDGDFIFBGCAHEDDIFBG.aHACSFGD.hAAAEEBDRBADOADC.hAAACCEE.TBBALHDAhABAUAFEWCHBMBABYFHFeDFCNICB..FEEH.hACA.QCCChADAAEHE...,1,-4,-27,23
ULJDCHBeIWgPOZcATQfYbFVKRNEXMGaSd,TFCCQCAF....fCBBbFCAKBAERDDA.EFAFGAGGhAAAdAFCUEFGDAEHBGAHeBHDIBDFhAAAgGGHOCABhABAABFB.....YHFENIABaFAGSDHHhABACEEGPHAC..hACA...,1,2,-12,14
bAefVPHaQgIGSUFCRMBXZJdLcTYWKODEN,eBBEVFCA.HCAG.QEEGGAAFSCDGFHAECBEBBHEHJGFGLAHDhAAA..TBGChAAAYFAEOFABhABAEGGDAGIDaDAA..IEHDMEEA....hABAXAEB..hADA...,1,-4,-24,20
RQHEGIVaUJOfYNWXgcMPDZALbTSeBFdKC,TDDGBDCEdCFE.CACD.RBEEHGAC.GDGAVDAD.UAAH.fDBHhABA.NIEF.XEFAhAAA.cGBEhABAMAIFDFAG.AFDBLADCSBHFFGEEKGAFhADA.IHHD.hAHAaEEH.OADD,1,4,-36,40
ODeJbQWdPHSLKfCURFIGYVATgEBaNXMcZ,EBGGaEED...MDDEOCBGDEFH...JEBAQGADdHEHHBFFSABAhAAAfGFFUACEhAAAFFHD.GBAEAHCHBAEChABAXFCBeAHBWGAELEHB.KHDACCAD.hACA......hAGA...,1,-3,-21,18
OfLPYSBVEHcNFXUaReQgbJWKMIZGCATDd,dFBHODECLAGF.SGEBBFFGEFCEHGFGFEEC.UCAAeBCFhAAAQAFEJEHD.hABAMIAGIHCCCCDAAAAHDFADhABAfADD.PAHD..cADGhACAaFAH....hADA...,1,-16,-30,14
bYQJIdAZHKDVTPfCeEWSNFXaBcLUGOMgR,KFFGTFBCCCDE...EAHFSGBF.FBBDaDEB.LHEChAAAODAB.gACFhABARCEHQDGAIAFGhACAAHCEDGID.VDFA.eHAGNAADBAHH...cDBDhAFAMFIBYBBFhAHA..,2,-43,6,49
gDALWIfHaYBNZUVdJERPbcGeSMTKFCOXQ,LCFG..fFCFaGAHBBGFZDDFUGFEdAAEJACCRGEC...hACA..PDHFGDBGhADASCBCMAEGKBDCOFFAhAIAQCDDAIHE.IFAD.HGCChAAA.YHAAhABA.ECFE.,1,-12,-30,18
EQSVaJPIBZLGbgYTMFdKNfWAHXRUDcOCe,RDFFDEFBCDCF.EGGD..QFBC..SCCGJBCA.BADAhAAALFHFbFACTBEHhABAdAGHNAAE...AGIHHCABhACAXEDBOHCAeHDCPBHH...hABA......hACA...,2,-30,-16,14
FJVYScTdAIaMKbDNPLUEfCRXWgGZBQHeO,aFDBKAFFDGCGLAFG.UCBBEHFGRDAG.....XGAChAAAgFEFZBAEBFGBQGGGhAAAeDFGFEDEVCFG.hABAYDAFSHCA.TBGFIACEhABAMFIBNECGCHAD....hAEA...,1,-13,-16,3
KZeHSbYNTaUJgQOAPLXCDVRcFIfMdGEWB,XDFHDGCGRBEA.FDABMFHB.GBAGEFBCKCDFHEEH..SHEEhAAANEIE.aDHFJHBChAAAQABBAEDC.hABACHADIHHA.dAGEBAHAeCEHTACHhACA...OFABhAEA..,2,-23,-16,7
gAFQacDHOTNSdJCZRYKEPbVeGLUXIBMWf,aCCFDAGBOFBC..TDACdHCFZCBGKFEE.EAGG..VDFHeEHFhAAAGAABLACE.hAAAICGHBGHDMAFBhABAWFCFADADFBHH..cGEC...SBAFhABACAHB..hAIA...,2,-30,-23,7
IbWBgKTMaULfROVYNSCAdDPQXEGFHJZec,dAGGDFCAQGGGEDAFGDDHHAACZBCA.eHDA..bDADBHBFKEECMAAHhABALDCF.RFGB.hAAAOCHDNAIESADBhABACAEDXGCH.JAFC.......hAFA......hBFA...,1,-1,-17,16
KJZTERfbYHOPCIMBaWcgUNVASXFeGQLDd,SBBGFEDAeFGFLBCAdGCDKFGD.ZEBHRADB......fFAHhAAAbAGHOAAHCDDGBHEAhABAaAEA...gDAChACANIBFADBA...XDGFDDDE.EAHFhADA.YHAAIGEBhABA..MDFF,1,-15,-28,13
LHQNJDBCAgVWeZbIUKRcMdYTEOFPGSXaf,VEABZAAEUBFC.RFAH.dBAA.EDCDOFHH.GCDESGGAhAAA.aDGELHCChAAAHFDHNCCFBAEDAGFEeEAEKAHBMDIFhABA..FDDAfCAFDIFGCHAG...hABAWAFEIHCB.hACA...,1,-6,-21,15
gZXUGfRSDMeYNHbdJOTPWIcaAEKQFVBLC,KEFEQGADFGHDLBCFCAGAZECA.GDAA.RFDH.DBIB.MEIBeAGBhAAAHADDdGCC.OAADhAAA.PHECWBAFaAHFhABAAEHHBCCE...XGCFSGGF.hACA......hADA...,1,-14,-21,7
JSaAZRGFVLIeCTHcfMbdNQXBgUWEKDOPY,ZBDDFGDGLBEGCHFCHEAH.MFBBdGDGQBBD.BEHAUDFBhAAAEDFFDCDD.PABDhABASBAFAGADRGFA.IAGAhAAAeEAE..fAFH.NAIC.gGGBhABA.KCGEhACA...,2,-23,-18,5
TNeAFXUJaDGSdWYEKBfZbRQLMCPcHgVOI,UFGAaGDCGEDFdBHE..EEDCKCGDZADHRADHLDAF..CBBGHGCEhAAAOBBFTBFBAEIBXGBDhAAADIGE..SDBBhABABABCfAHGMFAD.gGGDhADA.....hACA...,2,-27,-9,18
CbEfYOgZeDAPQNTRJLFSUadGVWBMKHIcX,QBAGRFFDFHCC.aEDBVEBG..BFAGMBGDHCFA.IACGhAAACGAE.ECDAfABFhAAAOEFBeEHDABEC.hABANAEHJHBGLAHH.dEHEWBFEKCCA.cGGChABA.....hAEA...,1,2,-31,33
SJDeNaKHZcBTEMIdCbARLVQYPgfGXUFOW,LBCCVDED.QBGF..gCBDGDEBXGGGhAAAUADCFAHHOAFAhABAJFBHDGHHeDCB.NCAE.KEHBhAAAZFDBBGDA.MBAFCFHDADDA.....YHDGhABA.WAGDhACA...,1,-1,-37,36
dGLRWFIUbXMgKJPSfCBQeOTHAVYDNZcEa,DDIFZFCHEDBAdCAGLCDD.FCGHbFEG.MAHDKFGH...SDEChAAABHCDeBFETADBhABAAIGC...NDAEaGBDhACARABCIFAF..XBBGPFEFCAACOFHDhADA....hAFA...,2,-33,-15,18
LOcUagABHKMRdTfbNWSJYCPXGIEZeVFDQ,HCGFRDEGdADE.TGCD..NIBB.JFFH.CBFEGBCGEABEZAGD..FAFDDFAChAAALFHHUGACAIHCBBBAhABAKFAC.MAEC..hACAfCCESDAGPAAH.XFFChAFA....hBIA...,1,-10,-26,16
REFaCTdPOGISLYfNUZeQgXWBbKVMHDJcA,RBFAEBECFEGA..aBAFCABD.dFHAGBDALDDA.....fHDBhAAAUFBEQFFGhAAAXGABBDBGKACHMAFChABADCADAAFGOHDCSFDA.YEAAhACA......hAEA...,2,-32,-22,10
NWXPQEegcGHZVFSUaMKYBORJICfTbdLAD,DAFGXADHQDBA..eEDEGDGGZBGDVCACUAAEMEFDhADAKGDBBCFHRGBE..CBFBTBDAhAEAdHGFABFA..PFAHhAAA.EABA.........hAIA......hBAA...,2,-24,-17,7
NAaDTYZbKHCGUJcfIPVReXWFOQSBgLEdM,DDADZABCHAFAUEEE.JFCF....ICFBRFFHeDEFFCCD..OAGFhAAASCAHLHEGhABAMAAFAHFAaBBD.TEBAhACAKEHHCHEG..fFAGXGADWCHHhADABHAG......hAEA...,2,-37,-15,22
PUCMHOeGTYNdEQfXBJZbDVgcIRALKFWSa,KDFBSABBUFFFHACCeFEEGCCC..NAGE.dDAE.EBAGfEAHhAAABGBAZAGHDICAgADChADA.IEHGhAHAAEHE.FDDE.aBHBCCFFMAAETFCH..hAIA......hBAA...,1,-19,-23,4
NGADXKPYHZBVJgfUOTIQLbMeFRSCWcdEa,XDDDKFCFHAEHZDACBFBE..JAHDUAAG.OADETGECLHDAhADAeABD.FDGASHGAhAAACHBA.dEGEaEGHhAEA.AAIFDCDGYACHfGAAIHAH.hAGAMDIH....hAEAWFHHEEEH,2,-38,-16,22
QBTgaRdNMUGDfWAHKYXIVSCEeFJObZcPL,KBBGXDAG..IFDESBAGCCEA.FFCF..OHAEhAAAbCDBZBGFLEAF.hAAATFGCgGAEhABAdHEHUCGHfGEAAADF.YEGFEEBH.hABA......hACA...,2,-31,-12,19
BdeMRVWYHZADfaIPgSTQCXKLJNUGEbFcO,DHEAaCAE.....PAEHSAFA.QGEEXDCCLCABhAAANFAFGCGAEACAhAAAFGBHBDFHdGACMECCRAGBVEGDhABA...WFDD......hACA......hADA...,2,-28,-15,13
OENXbQcCDHYZPJeSAFKaTGWfMBIUVdLRg,KGBCaCBDGDFAMDABBACEUAFD..dCCGLABGRDFC.EFDEXBEEhAAAQGAG.DICAhAAAHFFG.ZFDFeFHHhACAAIHEFBAGfDDH.IDHGOAHF.hABA......hAEA...,2,-23,-3,20
HDURcXQgACISdWPeZYNEKJVTfLBbFGOMa,SAADdHBFeDAAZFFDEBHHKCAE....JEEBTDEFBCFAFCDBMFBAhAAADBEA..UBGCXFAGhABAAGCG..IABEhADAPFHF..NADFLBBBOEHDHADF.hACA...cDGEhAIACGACWAFCfHBH.,2,-19,-9,10
MRJYNgEOefZTADIWCPFBVXLUQHdScKGba,DBBACECEBDGHLBGHHBECdFGDKGHHGGCB..MDADJBEH...hAAANABH.ODAFZEEFAAHA..hABA.IDCDFCBGXAAChAGASGAD.aFFEYHFG.hACAeEBBWAFE..PFDFhBDA.,2,-26,-26,0
OJLbGQefMRFUdDgWcCPYXTaIHVSBEKANZ,ZFACODDCLDEHGAACQCBHMIEAFEHB.DCAH....gFBEhAAACHFEXBFFaFDFhACAIEHFHAFEBAEFhADAAABDJBCAeGFG.fHADdHCD..cGGFhAAA...YAHBhACA,2,-18,-16,2
CPAKNGeSMcUbIQLdOEagJYTXZWHfRBVDF,GGBDMBAEUFBHQCEELCFCEADB.aDCBJDAA....TCGBhAAAZEFA.HFFCBHHFhAAAFAFAAHGBeAFCbBAFOEABhABAXBCE.fGEFDIFECEED.NIBH..hACA......hAEA...,1,9,-24,33
HDLBNKGFEXJWCbVRcgPdfMYOIAaTQUeZS,TECBUGDGZEFB.HBEHBGFBGBBGEBFH..XBBGCAGDRFAF..hAAA.PACEfAAHhAAAMIDGOAHBACHD.hADAeCHHDDEF.KFAA.FFHD..WDHHcDDAhABA......hACA...,1,-14,-18,4
ATfIVCcOPWZEDHFMLNSaBKegXJUGbQRYd,TAGCVEGB..OCBHZFFFDACD.HDABLCCHaGCD.KEEHeBCHhAAAJGBC.GAEA.REDDAHFFhABAIAEECGAG.PAHDhAAA..ECHFMAGFNEICBADB...hABA......hACA...,1,7,-35,42
EARKBGXVJCUYHFILDMQSeWabZPNdfgcOT,KEFBXDDECDCD.UGCAHBAE.FAGADBCB..QBEHSFGFhAAAaDHHZEAD.dAED..hABAfEAAOEHD.hACAAGBDBCHEGAGCJFDF.IHGHeADD.PABGhAAA....hAFA...,2,-31,-12,19
AQKgIEVbRDHBdULCJSMWcafeTYOPZNFXG,QEDDKDCCEGFE.RBBHBEAFLBAC.JHBCMICA..aAEHeGBGhAAA.OBFDZAGDFEGFhAAAAGGCIADFDFAFdFBFCFEC.hABASEGA.fBHC.hACA......hADA...,1,-23,-30,7
QDFTLNMZJYfPHARBgXOaWceUbVEKdISCG,BDCFXEDEaGEB...eBDEUFAD.EEFDdEAB.CBGEDDDAFACELBFEhAAAZGAA..fEHAhAAAADGF.OHEEhABAWBAH...cDGBKGHBSCCEhABA..TBBCMIAAJDHBhACA..,1,-24,-35,11
STUOcbfdAPVHFKQEeaYWgBJRXLIDNGCMZ,HACGQEFHaFAA.....gABCRCECXGGDLAGFhAAADGFFCHBBMCDBTFAFUAAGhADAbEDHAEGA.FAEDKEHBEDCBeAHDhAFABEAC.NIDBSCHBOEEBdGAC...hAGA......hAIA...,2,-4,5,9
gKDEeJNCLbTGIUcAXWSPaVfdYZQBFMRHO,SCDGaEGC.dBBAQFBABEGEFFCBHFEEOCCG.DGAFJAEChAAACEEGLBAF.hABATAFEIHHGAGIFPHEEhAAAfACD.YAHBMBIF..hAHAKDEC.ECBD...hBAA...,2,-35,-11,24
ZVaSXCJLKMeBWUIQbRFTENAHdGfDgcOYP,dGADDGDCOHECZAEB..VABC..SCECJGEG.KAACBDHChAAAUCBFQECBhABARGAEEACH.AFFG...fEFBhAEA.gAGDYHFGaEAFhAEACEBHMDID...IGGFhAFA,2,-43,-25,18
UZXFDSNKMTeGdVRLgPfcYCJEaBHWIQOAb,UCAHFGFDDGEHKDED..eCDDdGBARGEALEBF....fBFDhAAACAACaAEGBDFGHDGFhABAQCGBAFFDZEAESBHBhACATAGE..gCAC.YFFChACAJBCC.IFCChADA.,1,-20,-38,18
DXcRBWIANKUOVPTSaZFMfdgQYeEJLGHbC,UGGDOACG..VDEBSCFD.FAADdAAC.QDBChACAEGHDJECHGAEDCAEGDAGGRGBGBCCAhAAA.AIACKEGGaADHMCIFhAFA..fEDDeBGD.LHCGhAHA.....hBBA...,2,-22,-14,8
cZaHQTbfgOPCARBUGWMLFNVXJeEdISKDY,UFCFMBAHFDFH..XDEAEBCG.dBFBKDGCDDIDZFCF.HFAHQGGGhAAATAFD...hAAAfCCGOFHBADEDBAHBhABALEABJBBH.IACD.SHDGhABA...hACAaAGA..,2,-23,-18,5
IPFdWLCMBZTGXfDeYbNROVAKUSgcaEQJH,UGBBSCGB..aGFDQFCAHAECFDEHdFHACFAGBBECGACGhAAADFHDeAAG.NIBH.OCABhABA.AHEHcCFHhACAIDCC..LAHH..ZEEH.hAEAfCAG.hAFAYAEC.,1,-3,-29,26
RMIGPLCANXgEWadKJDcTFHYBefOQVbZUS,XDFHEBDBdGAH.KCGCDIFG.FFGBBBBA.eDDBOFHD.QCFGhAAAVFACZAEGUGGChAAASBAGMIBE.IFDGhABALBAF.AEHA.NEAB..aHCE...cAFFhACA....hADA...,1,-16,-33,17
dXKZacHQMAWPVFefCDLbBIgSJTRGNYUOE,VBEFeEABDEGG.LCCBBBAE..IDBESCEC.JFHDhAAATAGCGEEGUFFChAAAOBAGEADA.dHCDKCHBaGAHhABA..QGAGADHCFADAfCAGCACCRDCF.hABA......hAGA...,2,-21,-5,16
dcLTSICfYRGeWHFNMEAZDJKagXQUBPOVb,JACFKADE..aEFGQAGDBCFA..ODCFdCECLDGF.hAAASHFECBABRGBGeHFAFAHDhABAEEBEAAECDCDGUGAB.hACAPBAH..cFGGIEHE.fFDAhAAAWDBF.MIDChABA..,1,-9,-44,35
gNMTDfIOBdcZFJQVKeRUSLYGCPbaEWAXH,HAFEMDDEDGCGOFDHBDAGZBAC.QEADKCHB.eGFCSFFAhAAALCEHCCBHaBFGEHACAAEGhAAA.NIEH...fACDhABAIEGDdDABFEFGJHAG.REAC....hABA..YFHBhAEA...,1,10,-38,48
CFdPeYXNgOfTBDMZIUAWbHLJQcKaESGVR,HDEGJAAC.KAHBEDAGSDCHGGAF.CHCH.dBGC.eEBA..XADAhAAAOCCAfGHChADABGGCDCCHMGBGIFGGhAEAAHHDLCAB.aAGBFFDENEIA....hAFA......hAGA...,1,-20,-22,2
ADUKJBSGZbEfeYVOPCTMgcXFWIRNLHQda,UEBBBBGDSECBZAFA..EACGeDCEVFGDCGGB...MDCChAAAXAAF.FHAGIHDGhABA.NEEF.QEAGhADA.AGIDKDHHbBBC.OACE.hAEAgGDC.hAGA.WFFD.,1,-23,-26,3
RbCfSNXTeAKgMIWDHOYFGEdPQJaBULZVc,MCEADDAGOEFBFDGHGDBB..EECCdAEBJAHHBBAA.ZFFARBBGCGDD.hAAA.SABBhADA.TFBBKCEAIGABhAAAHFDF...QEGCLAHB..hABA.cAEA.NIAFAEBFhACA...,1,-5,-43,38
VPXdNOBaQFGKLYgZMcbAETeIDSJHRfUWC,EAFCTBFCDDEH..HCFCUDDG..CFHH.VDGBdBACBHBG.QGFDhAAAFABHGGAFKCBCgGGGhAAAMEAG.AEADIADBhACARFAE.fFAH..hAFA......hAGA...,2,-25,-22,3
JBQEecbCPKGITgLHZDRVAFSYUfaXMOdNW,SCDDUDAG..aFGGMCCDOEDAdEFGJCAFBBCE..QAGDhAAAeAEFCAGC.KABDTFDDhAAAHGAARFDD.AHIF.FHBGhABAfHFFXBGHNIEFWAFD....hACA...bCGHIGHHhACA.,1,-1,-35,34
NQHgVEWKJXcLeGSaDIZTYAFfbdRUMPOCB,FCHDdFABMEACOECEBBCAHAEE..EFDCJGAGLEHHGACCDHGGZADFAAHGhAAA..RBAB.CABFQDFEhAFA..gGEFhAAAKHBAXBGAeCEASCBGhAGAaEGC......hBAA...,1,-11,-21,10
PBGOQcSfVWTNbHgEeDMIJRCdLFXaZAYKU,KBCBUAEFBFEHGDAE.OHFGSHFE..VCGDTCAAhAAAHCCFeHBEDABFIFFFhAAAJCGDdECGFAGB.aEHDAACC.hAFA.PHBE..fABF.hAHANAEC..EFAFCFDA...hAIA...,2,-18,-16,2
TMQCNRDbOJBFdHWYePXcgELGKIfaZVSAU,TFCHCHAARBCA..ODHBBBCFFBGF.dHGHHAAE.eFACXFAHhAAAEEECKGDFaFEA.SCADhABAAAHCMACG.NAFE.DFIHhAAA..JBDB.PEHHgGFG..hAGA......hBFA...,1,-17,-27,10
GNdfOTeUVAcJQIgLDbHKXFERWaCYBZMSP,QGBHLACAHCDHFFFHRBEDaEAC.BHGHSDBDGGBBdAHEOAABhABATDFC..eCBGhACA.AIFGJAFADGAFbBAChAAAEEGECHHEMFIB...fFFE.hADA......hAEA...,2,-21,1,22
DTdPNVOEfKGgMCeBXWRbALHYIQJZScaUF,HABBQAGFJECHZEFGaDDG..DIDEdBDH...VEFAEHGEGAEDhAAAMFEDBEBBRDDAAAHCLFAHhABASAAAFCHBNDAEKCHHhAAACDAB.....eHAA.....hADA......hAEA...,1,-12,-13,1
GULbJXWfeBTKcNMEDYHaAZRSdOQVIFgCP,RADHdBFGQDAEFGGD..CEHEUGCDJAFA....XFFGhAAAeEDEKBAHMEEDDCCBHAGBhAAAAHHDSGCB.IABGhADAPFADLADDfCHGBABBTDFAhAIA.....hAFA...,1,-17,-30,13
UBMRfbDGKTJFWgIceHdZQLSVAaXYCOENP,XCFACCCC..EABFUBBCMFAERGCGDFGFKFGG..FBEB..IEEFhAAAeBHFdGCF.QDDBhAAALAEEADAFaGAFNCICBBFHhABA..fGFG..bFGDhACA......hADA...,2,-31,-28,3
bMFXKYJCSTAfLgaZGNUERVPHWDIedOBcQ,LECEaBFHZBCH.UGEGEGGH.RABCHFCB.DDDCICAF.dEGDhAAAOBHBQFAAhABAFGHDKBAFCAHBSHCAhACAAAAEGEAG.NEFG...PAEGBDHFMAED.hACA......hAIA...,2,-14,-11,3
PBZEOSRYFIHMTcaDgNWQAKUbefLVGJdCX,KHFCeFFGLBGFGACHJDACCAAA..BCADZDDHOHBGRFCH.FCGDMAIDhAAA..aAAGDCFH.hADA...NBIAAHHBfEBHhACAdFAB.EFGCSBBG.IHFEhAFAcGABQBCDhADA,2,-36,-24,12
fPgBEVJDZALKUMOIHSGeaNdTWYXQbRFCc,UADBMDCHHAGFeCHBdDED..TEED.XADGQAAEhAAAFGHFCEHGfFDAhAEABDDHJAAHDGBDAHFHOEHH.hABAIGBFSGEDaGFFNIAB..YFCBhACAcAGG.EEAF...hAGA...,2,-27,-5,22
MPEbQZRdJUAWcCBeTHgNLKVYSaFfIOGXD,CHAFBHEGHAEFLABDKDGB.SFGFFCAGOFFCGAEE.MDIFhAAAEGDGQDCGhAAARAGB.dAGDAEDHcGAAhADAgABE.NIDH.aDDF.fEBGhAEADEBH......hAGA...,1,-14,-27,13
LQgVGYfbAcIFeRNdPOHWZBDJCTaXUMEKS,FDFDeDEFdBAGOCBEZEGBBBEADACC....CFAB.aGCHUCGD.MHAChAAASEBF.QDCGhAAAgGGB.hABAGADBfGAEAABBIHEBPFDD.WAFEhACA.....hAGA...,1,-27,-33,6
MDHAPYNgGTZRJFSaECXUOfLebBVKcdQWI,...PFBANCAEGCGGRABA.FBBE..EHCACDDD.OFFCLCFFBGAChAAAKGDAQCDGhABA.MCHDDABEAIFCgCAEhACATEBGSHAGXAFB.fGGGhAAA....hAEA...,2,-35,-10,25
OBIRQHNCTSXgLcWfEKeUGDAFMJYdbVZaP,MCIHdAABZDBC.OAECRFCFHCFD.CHGF...SFGALAABfDBHhACAECCAKDGC.eFBFhADADFFDFGCHJAFA.bEACPAEBhAIA.BFGAIHAANEFG....hADA......hAEA...,1,-1,-34,33
bPMCENSLGORTXHeDZBVgAdIFUafWYcJQK,FCCDaBGG.....fFEB..cBCGKADGMIACEEAELGFEhAAARFACHBFDDABCBDEDhABAAEHHdHGHIHAGhACA.WFAGYAFCJHCAQDFGCBBHNAAG.hBBA.SHDEhCEA.OCHFeDDD,1,-5,-13,8
URMcAXKEJYCPGgWdIVQOSZDbaFBTfeNHL,XGCFECDA..JEABCCADGDECdHGB.QABHSBCCDFAHhAAAaGCHBBFC.eCHHhABANACHHFDEUGGA.RDACADDCKAABhAAA.PEEGIHBEOCFEFBGD....hAHA.....fDCEhAIA,2,-14,-14,0
UWXadCLfIGObZEecYFPRgAJNSMQBTKHDV,JADASBDEBHAG.KECBDGHF..UGFC..aCGCLEABhAAAGCCAZCADeEEF.FBAARFEBABAChAAAQCGA.hABATCDD.WADECHCDIEHEEHBA..hACA.cAGA..hAIA...,2,-43,-12,31
WRUFHgBNZQPMeSaLDbYXfdAJTOCIEGVKc,JDFDOAAE..EGBEKHCE.RCFBHDAABHAHZEDHQFGE.MAIBhAAAaCCBDIFC..bCDBhABAXAGDAHAG.TAEGhAAACFBAIAFF..cDACWFEH.FABGhAEA.NEIC.....hAGA...,2,-37,-9,28
RBOWdfZFLEKCagDeJVXcUHPSMTbQAIGYN,GGEHRDBGOBAHdCDEZGBCFDGH.LADAKEFG.CAAC.DIBA..JAHFXAGEhAAAHFAF.MBFFhABAQCAH.IFDHhACANGDFBHHGEBCE...aFAA...hAEA......hAFA...,1,-20,-26,6
dJMOXeLfAWgUPbIKVYBFcDaEQZGHTSNRC,UCGC..IDEHKAEDBFGAFFBHDIGEaGFF.ZACCHAAE..TEGAhAAASEEH.hABACDCF.MCDD.eAFEhADALHBAADHEPHCEYDAF...EEDFhAAANEAGJBBH....hAEA...,2,-36,-19,17
PSUTfdKMEXLcQAJDYCVFZaHOBWGNegbRI,JFAGDGGBCAEGZAFD..HDCEBDBEGBAE.eCFBRBBG..SBHBhAAATBGG.KEEGMFADhAAAEGEA.XGBELHDAhABAAACEFEHBaADA..ODGF.....hABA......hAFA...,2,-27,-20,7
ObUPTcfGegJKdZFEBWCASNHYaIXRDMQVL,SFGAHCBCaGDBREEE.MGBGLEAH.OADEbCCG..TADBhAAAfBABGAFAeHEChAAAKDABFHEAECHDBECGhABACABAAHHEIHBADAGE........hABA......hADA...,2,-20,-3,17
WXUKMVRSQdFeYcZaJbgNCTGEDOfIHABLP,BHGELBFA.XCBCKAGERFADdCDE.FCFBeDFD.ZEBE.JABA.hAAA.NICF.CHFAGGADhAAA.DGDCfDAAhABAAHHH.UEGAMDIBQBBEaAFA..hACA......hADA...,2,-39,-13,26
TBHXRDYNPFKQSabJEIGCgOfAdZcMWVeUL,ZECEMEACeGDGUAAFLCAEBFBD.RFGDDEAH....PDGFhABAKCECSHBCaFED.hADAEAACIHBD.hAAAGBDFOAHHdGGHWDBG.....hAEA......hAFA...,1,-22,-32,10
GegCDTMAcQPBWVdSfFZaJREXHIULYNKbO,QFBFBFAGdEGDFFCEaAFD..RBDEHCABLCAGKGHD.ODEA.hAAAeFEBCACGDEDCAHHFPEHFhAAA..SCCGhABAfHADJHCCIAEG..NAHC.gABAhABAMADA.WFFBhACA..,1,-7,-35,28
AQOdWEXaBcVgUDZYGbIMCNPRJfSKHFTeL,QBBDOHEAdCAB.EFGCBFCH..VFDBDDHDZDEFGDEB.IAADhACACEBARABG.fGADhADASAFFKAFGFBGGhAAALAEFAICA.aDBD......hAHA......hAIA...,1,-8,-44,36
BZJYPSKIfeHbdDWNGAVaXQUEOTMFLgRCc,aAHDQDDC.OAAAMCCEFDBGLEGBCGADBHGAJEBD.SHDEhAEAKEEF.ICHEhAFAeGBEdGGF.DCAFNBDDAGFAhAGAVCFB..XBBCTAAC....hAHA......hAIA...,2,-31,-24,7
dYNVZgSJKfCEcHWeMBPIFLRUTbOQaADGX,DGDDGACEdEFG...NDFE.ZCCE.SADCKFBDCHCA.HAECMCHFBBBGhAAAFABB.LCHBhABAUGGDOAFFaGHHAHABXECEhACA..........hAHAYAHH..hAAA...,1,-18,-41,23
NPDbMESgYKLQWARedHCBcGVTZaFUXfOJI,RDDFdEAGBHCHGCCHZCAE.FCHDUAFF..OEBF..JHECPGEAhAAADEIB...EACESGAEhAAAKBAELHBGhABAAFFC.CHHF...TABFfAHA.NFEH.hAEA..MAIB.YDGHhABA,2,-43,-25,18
CcLDGaOWPdEAHUIeNYKSJMbfTgZXFVQRB,HBCBUBCHeCFCKHDCMAAE..TEEEZAEAFFAHRDAFBGHGLEECDIBA.hAAAaFGE..ODHDhABAdGCGACFF...NDDASHEAhACAfBBC.XAEBCHHB....hADA......hAHA...,1,-19,-23,4
PeCRQgZGJYIEfUSNTFWXLBVdDbMHAacOK,OFDFKFBECGFH.RFFBZAEGGBEA...JAHDIDHG.EDCHUBADhAAA.SGCAhABAFCABLAACdGAGDFGCHGAGhAEAAIEA.aDFB..eBDFYFHH..fHGFhACAWBFABFAAMAEAhADA..,1,-20,-26,6
UQfOHCSLIdMWNJXKBAYbgZEVaPcFGDTRe,...bACAEHEC.aEECFEHFDFAGRDCE...eACGUGEE.QAGFhAAAOFCCCAHDLCBAhAAAMCAFJHAGKDFCBGBG.AABB.ZDABhABAPDHD...cGGF.fHCFhAEAIHHG.NAGC..hACA...,2,-19,-16,3
RSgEQKXCZaJfHGdLWIbeFNVcDPMUTYBOA,SCFDEDBEKAFH.CGAC.aFCBHEDD.dBCBLEED.IDGAhAAAeDGHFDAG.cAAGhAAADCAHMGFA.TBCEhABABDCHAIBC.RAFG....gGCDhADAZFAHfHFH.WAHBhACA...,1,-11,-37,26
eXTaLEDCYbcUIAZOVfBKJQWdHRNSGPMgF,ODBABBFGKCGA..QACCdGADHFDBSGGDGAGEMGEAFCAHhAAATFBDLDCGCCEB.hAAA.bGFEIABGhADA.AFIB...fEAFWFAE.NIDH..hAEAPEEE...hAFA..eBAF,1,2,-34,36
VBKZPReIgDHWaLJNFOfQUXMYbAcdEGCST,EBCDCCDB..SFDABGBDKBFFZFEARDBD..eBFBDDBB.HFABLAHHhAAAJGFEFABFOEEG.hAAA.fDHChADA.QAGAMEIFACAFdAEF.....hAEA......hAFA...,2,-37,-18,19
JbdgUFAYGXDKCQZfVPBRNEeSLWcTaIMOH,XBAFDCFHCBBF.ZACB..VGDERAEE..EEFDeFADLEHH.hAAATGADaDGHMAIBOEDBhAAAHADEdGECFDCBACEBKCGGhABAfDAGBHGGWCADIHHF...hACA......hAGA...,1,-9,-24,15
MXRBcadNgPSETFOCYDGfKVHZQIJLeUWbA,MDHDBDHGdCCG....NCFA.SCAHFEAE.CFBFDAFGKAACVACChAFAZFDD..QGFBhAAA.JDDAeAHDhAGA.UGGDAACD.XGBGaCGGEFCH.ODDBhAIAfADD...hBAA...,1,-29,-32,3
YCXRPKBTFdGVbNHgcMDZISUOWJEaQeALf,LCHBCCGBRFFH.KDBABHABdGCGGGDB..bECGHAFA.MFCEhAAAIAAGOFADEBEChACAQACC.hADAAEGGfBACYDDCPDHD.FEAFNDDDDGIFhABASCBC.hAEA...,1,-7,-29,22
YGFXCcPBMLTgNZSeIWHKEVfUAbQORDdaJ,OEEHdBDEJFGD.FDCD..CAHG.BGGBLABD..NAAB.ZGCCeAGHhAFAHDED.ECFEUGACAAEG.hAAAQBDEDICC.hADAaDHH..YFBCXBBF.MIEGSGABhAGA...hAGA...,2,-31,-22,9
AIKLOaBRbgPfXEHFTMYVQcSJCGdZNeWUD,LFFGaDBBBAFA.RCGD......bBEBgGDE.XEDEhAAAEABBHDBFTABDhABAMADAYBDFhAAA.QGCE.JCABCAHDdCEFeAHBDGIFhADAIHHGKDCAPFABhAEA.fGGC.,1,8,-20,28
efMdOKPaNUDLZJICTBEYbXScRGHWVQgAF,FAFGMBBAKBEF..aCGHUCBELFHHZEFC.CGFA.BBHF..EFDA.hAAA.XGCBSCCGhAAARGEC.HEAF.WADEhABA...........hABA......hACA...,2,-50,-25,25
QAcMfLORTNYgdbEPZXJBDVSKFCUWIaeGH,MEACLGACREDD.TCAC..NDADdFACEGFFZDECBBGB..VACEhAAAFABEUFFA..IBHEhABAeDHBHFBHAIHCfHAHhACA.OAFGbBCA...PFDAhBAADBIBSAAFhAEACCFF.aHGE,1,-8,-17,9
LZbEPVDWQKaHAOJNBIXeUGgRdTFScCfMY,OBEEJEEEBAFD..eBAGUABDGEGC.dDEASHGChAAACACB..MCIFZGCAEFCGhACADGEDKGACAEBG.IEAGhAAAXBGE...RCCCFGAHYHAG..hABA......hAEA...,2,-30,-30,0
CPZSQLcaJbWRNAYUIFBgDEHMOXTeVfKGd,UECAFFAADCCFMCBG..OFDDeEADKHBGGAGG..CBFFZFGFQGFAhAAALABAJBADRCFGADDEhAAABDEC..EAHHXGAChABA.fDFASFFDaBEG.hACA..NDIE....hADA...,2,-24,-22,2
NaROfULPXbMKZSYIdDFgQceCHVEABWGTJ,GCEEJAEH.aEBDRDAAUBBHLBBE...XAGCKHBAZFFH.IHEBhAAADEHD.FGGBQAGDhAAACCCH.EFADhABAAHACWACE.OCHHbEDD.SHAAhABAdDGF.....hACA...,1,-10,-29,19
ZSIUGRDJPfXgBAQHcWYNLaEKCeFTbVOdM,HDEC....YGCCLBBFECDAeFAC.FGCE.VAFChAAAMBFASFGAhABAUDAGGEEHRACHDIEAJHAC.XACBhAAAACID.WDFEaHFA.KGHF...CBBD.hABA......hAFA...,1,-9,-24,15
dMDGOVYcfBAHKTLRESNZPQXCWabeIFUgJ,KEDGRBBAEDADZEBF..QAFDCBAC..aDBAeGDGFAFC.UDEEdGGBGBCHhAAAOHAG...hAAA.YHFGBEHBACIF.hABALABESGDENCIA...PEABhACA......hADA...,2,-35,-5,30
DGRYcFQAeIMXHSTfUZVPdbKaENJWBCLgO,MHCGSHBGUDCEZBGDdDFFKBAA..aHFEJDBC..BAADLGEGhAAAOAFFDBGC.RFAEFADHhABAACBEeCAB..XAEBhACAfFGC..bEFAEFAB.CEEE...hABA......hACA...,2,-34,-18,16
ISLZDPdJOCHQfBYFcXTKNgREeWMaGAUVb,VCDCSDEG.LBAGDGBBdADBCHDFQGDG.BECDhAAAFABDTEBFKFBDRAFFeEFAhABAMGFGaGHD..UAGFhAAAIGGHJCHF.fDAA.XADFhACANBAEEHFEAHAH....hAHA...,2,-23,-19,4
aPIdRQJSAEHBLWFMXZGTKNgUfDeYOCbVc,EACGHCEGLCFHFEBCZCAAGFEDKBAA.UABBDDCDODEB.CHBF.hAAAbAEC..aFGEIHHGhAAAdAGH..JEABBHABhACAMDDHNICF.eHCCYCHBPHFE...hAFA.SAGEhBAAAAEE...,2,-13,-12,1
AfRbWFQODLPUGTXaZSIEHdMVCBegYKJcN,RDFDFABGQCBGDGCGLCEBUFAHGAEH..XAACZGDEEDCFdFAAhAAAMEEHBHGH..hAEAeAEDKFGE.NCIAADAHfCHEhAFAOFFH.aHAEIHHD.CHCH..hAHA......hAIA...,1,-13,-19,6
FPEfGKYVSIWXNbMZUJdLDCaAHeTcQRBOg,TDDFQDFC.OBDCFFBCEHFCGDACKADD.SEEDhAAA.IGHGNHBFMIACJFFChAAADGADAADHeAHDBHCEfCBAhABAYAECWDDFZAFF.dABACCEB..aEGAhACA......hAEA...,2,-13,-8,5
MbJSTILQGVcWEeAUZfYPXaRdNKDgHFCBO,UFGCZFDF....fDCHPDBARFCH.dBFD.DAGCFBEABDHCMCBChAAA..SABGhAAALFAD.QFGGhACA.cDAHeBHBAADDXGBEaEFBNAEDKHEACFFDOFABhADA...hABA...,2,-23,-15,8
ANGYVLUMgdaXfeITEbWCRQPcHFBOSKJDZ,GCAHLACAUAGEdEABaGDHeGBE..EFGGCABFREFE..QDDHhAAAHACGFGGHBFAFKGADZBGHADFD.hAAA..VGEE.MDAChABA...........hADA......hAFA...,2,-26,-9,17
ITAQKVCBgbLZMWGNXYREUJHaeScPDdFfO,QFABCHGGBBEBLDFBMCBDGAAF..NDIA.REEDJDGFHCBESDCChAAADAGEFFAGOAAHhABAAHDGKAHH...VGBChACAbAEB....WHDAEEEFaBBAeCHB.dHAH.hADAIHHH..hABA...,1,-6,-15,9
CLZGWbDPgecBERTXdHMQKUYaSAfIVFJNO,VFEHJFCB..CCDB.GAEB.DDBGeHECBAABRBFGdDBGHEAB.QDEHhACAKADAUEED.SDHDhADAABAE.fHGHhAEAIHAGFEHFLFCB....hAFAWDAD..gBCEhAHA,1,0,-51,51
SedHLAcRNDUMgZGfQbCITaJXYKEOPFBWV,RAFFDFHHMABAZDAGGBAF..QGFACHAC.IDEAhAAATGEFaCGC..XDBFhAFAEFCDFEEBBADDSDGAhAHAdAGDABFD..NEIE.fBBB.YFBFhAIAKAAE.WFFEhBAA.HECF.,1,-10,-17,7
eVSTgcXPKNZOLADbREQGJdIfMYHCWBUaF,DAAAEGBEGCCGdEAE.MBFCCHGCUCFH..aFABFFFB..SGFFhAAA.TCAGhABAgBCAPEFEKAFC.hACAZFBDAGIBbABE.JCFC..fACFhAIAWFDHBHHGeDHH...hADA...,2,-39,-3,36
fBZeYUAdJEWQICDTFPLVabGSXRcOHKgNM,EEEGQCDHDBFC.FBBBLDDE.aGGAGAGA.SGBFhAAARBAAHDBFKAAEMFGHhABAZGAG.eFCEAFADdHFFIFHBhACACADF.PADCXBGAcDAE.gGDGhADABBED..hAGA...,1,-12,-19,7
gYNQRBTOIacZdSEbPUADGCWLVHJMefKXF,CHHGLCFDHFFE.MCHBeCCEKACDFFBG.....NEAF.BEBDOHAChAAAIGDFZAFAdDGHSBGEhAAAEABH.PBDDhABAAEFFDDBA...WFHH..JHDAXGADhADA....hAEA...,1,-12,-45,33
EULeDgXFTGPaRfMJdbOBSQHWcCZIYVNKA,LCDHDEGCFAGAGECDaBAC..MHFCdCCBBGBDQEGC.HEAFhAAACFHBZACAVAFCKGDDAFAFEFEAhABA....eBABhAAAXCFC..TGGFfADH.hABA..ODAASBFHhADA.,1,6,-36,42
cZNTVYfHGLPbIFaDeJCUEARSdQXWMOBgK,dFDBXEGHOCBEBBFDKAGD.ZDBG....TGFGVGBAHBAAhAAALABC..IAHEhABADIDGCHAGEEGDSFEChACAMBFD.NEACfADF.bCFAeDHBhAAAAHIB...WECDhAFA...,2,-36,-6,30
eXGFJZcDaUCYdMQEBPIOfWKARgVHLbNTS,VGAALCCB.TEFGSDGC.GAAAFBEDJAHHZFFGDIACaDCGhAAAUGDE..CADCMBFDhACABAAFOADGKHFAAHEFHEBChAFAeDHB..XAGDdCAGEGBGIHGGhACA..fEGFhAGA.,1,-11,-12,1
RLNPDcIXKCMfgYJeQVEObZAUHaBFdTGWS,aCFABECF.FDFAdBDCGGCFREADLGFG.DIEEIAFB.CBHA.hAAAfDFG.hABAJABBVBCG.EEAFOECFhAAAAGFG..........hABA......hADA...,1,-36,-41,5
TWOVENLRHePfdGBSQZFbUIMDYaJKAXgcC,XDFHCHEB..TABGOECA.EADBLCFBHFAA.eAEAhAAAfGGHBHBBQDCDhABAZAFCFHDGIBADhAAADGIDaFABAGGFcCAD..NDHG.dCFF..SDAChADAMIFG..hAEA.KFDF.,1,7,-29,36
NCfQIPUHbYZEJLFAdDSMaVBWGTgKcXORe,SFFDMADBBDFAGAGGKEBE..OBDCRFGFeEAECCBE..QBGGhAAAUBACHGBGZDFCEAFFhAAALHACdGFCDEEBaFABhABAWFAA...cGGA...fABBhADA...hACA...,2,-22,-7,15
acfKIEbNCVRGDMOHTXYUWdQgSAFeBJZLP,eBEDZAACaEABKDCA..EFFACFBHGDFC.DAAEMBGD.OEBFhABATAGHXEDB.hADA...YCBDhAEAdBHGSEHHAFABBFHAPGCCcBDEICAFhACANIEF....hADA...,1,-22,-31,9
INbfERKWXPTJHUMcgSGABQFCOVZDdLeYa,FDBFCHGAZDEDDGFDLAAA..aEDG..ICAB..bABGhAAAEEBBKAFE..XAGGhABAPAHD..TEGAhACAJHDEMCHD.cCCHSGCHBHACOAEHhACAdGGDNCCDfEAEhADA.WDDE,1,-25,-32,7
eabZKIQERJYfBMWSPNgALHUVTOXCDGcFd,UCDDVCEE.OGAE..XGADCGDE.DAED.FCAFdFFHeFFFhAAAaACAZCBH.KAAGIAFBhABA.RDBHJEHBBHHGhAAA.MIBCSAHFPAFA.AIHATABBhADA..cBGE.hBAA...,2,-34,-19,15
MaKdTNgRVbJYQEceWOGUHICXZBPFDSLAf,aCAFdEAG..TCBDRDEG..VFCDJBFG..QGFGEFAH.eAAAhAAAOABEGECEUAFHhAAACHAFBEHCDHGEADCF.fEEDhABAKFGG.gADF...hABA......hACA...,2,-32,-7,25
WYdNPbVgDXMGLcTBORAJEFCKZUefIQaSH,FHGACEHDUCBFeEEG...QDBGaACG.HGCAdHCD...NDDH.hAAAbDFFDCGCGADFLBCEhABABHGDAGEAKGAHZECCIGABhAAASAEE...WCAF...hABA......hAGA...,1,-9,-31,22
eREgaYZALNPFIbSXTBUGcfHOWDCMJQVdK,LGBGFCGB.SDAHTEEEUCCGGAEGHGBADGAH.JABCdDAChAAA.KGGFRDCD.EABAaFHFAGAD.hABA...IFHAhAEABHEHcCGGOBEGCHGCMAAD....hAEA......hAGA...,2,-24,-15,9
dLeTVgcJCbYKNWOPQaBGUMZIAHFEfSXRD,ECABXEDARDFF.DCEBdHCH.LCEC.eCCHgAAChAAA.JDBDCABGKEAF.OHFChAAAaGDFBAFCMAIHIFHBhADAAFDHFFHF.TCGDcGAB..NEAEQGBHhAEA..hAHA...,1,-15,-33,18
RILSbZCTfNEYQcOPdWeGXVUFBgKHMJDAa,aEEFLDEGZDBD..CDHC.NGCB...EACBQADF.OBCBhAAAPFHHdHAFeBABXAGHhABAFAHHBAEEKFHDMBBDhACADEGDAGDESDAD.fGAGhAAAWEAA.....hAEA...,1,-24,-26,2
bMgJRINTPaKUQHAEGBWSeYCVcZfdXODFL,GCGCBAFCSGGHeDEFCEACZBBGdEFD.DECAFGBCLADD.MAIBhAAARFFDIACF.hABA.NCBE.aBABKCFHUAGDhAAAHFCHAHAH.EHAE..WFHH.....hACA......hAHA...,1,-15,-25,10
GAbKFafcDdEMUSLWCIeQXHYVPRNTBgZJO,FHDCaEEB.DEEHdGBA.UGGBLFAG.CCHA.eDAGHADB..VAEChAAARCABBFFCZCDA..JABEAGGAKAHDhAAA..EEHHMHFGhABASHDC..IACA.XCFHhAFA..YAHBhABA,2,-40,-18,22
TEGVBOHCdgeRIbKWUFQYJAMPZcSLDfNaX,ZACHLBAGDBEG.aEDDEHFCGCGCBGAFHCFACGAB..eDACRCBDKFGGFCFBhAAA.QGFDhABAAHID.MECBSFCHhAAANIAD.TEEAdAFB...IEABhABA.WHBA...hACA...,2,-25,-10,15
SOYdfXPVgGQDaeFbNTHURIcLCBMEJZKAW,OGBEdHCD..PADEVDDF..GABCDEEBFDCD..TGFChAAARBAALAGBBFAAJBECAGCG.hAAASCGA.hABAfFGBQGFDaDABNBIG.IAHFhABAMDAF..EFGG...hADA...,2,-21,-20,1
WZfVBObUGSRCKEacAdPTQNMgILDXJeHYF,dGBEQBAHMFGDLEHBDIEG..JEBHHEBCFEDEZFGFBBDHUBDHhAAASAGG.KACFhAAAaGDEAHAG...NABH.IBAGhABA.XEEBWAHF.fDAAhADA...OCDEhAEA.,1,-26,-33,7
PEKcOTDFeZfLRQCAaXVBHIYNgJdMbUGWS,XGAHBHGEHGAG...ICED..NDDDdEEGMCABbCBFGBGEhAAA.SFBEhABAKAGBTGCFeBBFfGHGhAAAREEBCDCAAIACaEHDYABC....hAFA......hAGA...,2,-35,-5,30
YMHRQSOabWGPdCgJEILcBFAXNeDUVKTfZ,eCADDEEEKAACZAFAHDAEQFCE.OGFGbAFB..GDGGhADAdCFCCDCE.JFCHEBBELCCEhAEABHHDAIFA...NIED.TGAGhAAAfAHAMFFGSBDBaFFH.hBAA......hBCA...,1,-10,-14,4
IFbeDgOMRScWBfEUHKLPXJVQZAdCaNGYT,aFDBGBBD..TCGEFGDBDDFD.OFGFRBEF..SFGAhAAABGADEBGFKEAAXCCFhABA.JHFE.ZEADCAEBNAACICAAhACA.eAEEMEIHcEEEfGFGhABA.....hADA...,1,-16,-33,17
ZSCdFBEOcHIagQbYfUMKVAPLTXeDWNGJR,TFEFXCBC.DAFBGBDF.RAAFSGAFdHADBCGAOBAAhAAAHEBDaHBCQEDBhABA..fCCGhAAAUFGCMCADAEAHLHEAeGCGNIEBCEBAEAGEcDGD.hACAIADG..hACA...,2,-10,-7,3
eTdANXJWEHUbPfaYSZGcRgQODFMKVICLB,XGEDECEGHAGHUDCB....fCEGSBACZDGBGGCDhAAARCBFOAAGDDAFMFIHhABAIFADCFFBBFBGeGAAhAEAAHHB.NBCH...WDFAaEECcGCEFGAH.KGHHhAFA......hAGA...,2,-16,-11,5
ASFEVefHdYKDUZNgXGLJPIBQcMOTaRWCb,EFEBeECEdACFDBGHZCFE....XBDGGDBAJBEEBEGG.MDIFhAAAaAAF.CAFC.AAGC..SEHBhAFAFHAGHCAHKABH.hAIAgGGGIHGAOHCE..WHCAhABAfCCB.hADA...,1,-20,-30,10
EYWAbCDZdOcNXBgJGePHLUMIfTVFQSRaK,DHGCOAFC..XCGEJECBGBDGHAAGLAABUDDG.MHFChACAIDAH.TEGHhAAAFHDCQEGGhADA.aHACEGAGAFFCCEAEcGEHBCCF.eBFAfFAGhAEASECD..hABA...,2,-29,-8,21
ZNOBKcfEbFRSCPAIVHXdDeaLQWUYTGgJM,VGFAHBFEdDDC.DCAAeEBBQFFDUCDDGAEDMAFC.ZEEGOHFChAAABAAEKACC.EFABFFBFhABA.SADBhACAAIDA.IDHHaHAC.YHBG..hBAA......hBBA...,2,-19,-18,1
EaMCTJABbZRWUfFQNOYIGcgSdXeVHKDLP,BADGZAFHUDCGQBGB.OECEIABDGGEH.SAAFhACAeFFGKDHHDBDAEEABCDCEhAEAAEAH.RBEB.FHBC..cDGDhAFAdHFBXCED.LDAHaBBCJHBC.hAGAfAHE.hAHA...,1,-8,-24,16
HbYNMcgaWBZJeQDEATfCdXUISFKPGROVL,CBCHXDEHUAGF.FGADGFAB..ODACLCAHHAAG.bGEAhAAAMEEE.aHGEZAGBJEHDhAAADICA.ACDGdFCCKADCRGDA.hABA....NDDH.cEGFBABEeECG.hADAEHAGfAFAhAEA...,1,-6,-19,13
cKdTSeCXDFVfUENIAYWbMRHQGBZJLPOga,...bBCDMECD.HBBEBCBFLHAAOFCBaHFAKAGHSDEDhAAA.CFGDDDFAfDFHhAAANIEB.AEIHRFDHQAEEhABAJADAPAHDdDAAeFFG.FGABEGEG.hABAIEHH..hACA...,2,-17,-8,9
RULXfFgCPMKHdGeDQABNcZVbYaSEOTIWJ,BHDGZAAC..VCDAaGFA..OCFF..IAHBRDBCLBAChAAAFEGBCGCGMBHFHDADdGBGDGHFhABAAEAD....NAIC.YHCGhACAEHFG..JADAfAFGKCAA.hABA......hACA...,1,-21,-25,4
UQYAJbPHFSBVOKTgedfaMcCZXDGEIRLNW,JEECHEGBBACAVEBA.KADB..eHAGdAAAMICGCGHF..DBGCGCDFhACAREBH.LDAFhADAUAAGAAGC.FGEC.SAHDhAFAOAEB..TFDF...aGGH.hAGA......hAIA...,2,-42,-6,36
HSdJGaBOFAMCfLVIRQNKXebgcETZPUDYW,CBBBLECERFAE.KGFHeECE....bACAECDEZBGDDGEDHFDHJACC.hAAABDAG.FGAGABHAMDIBhABAICDE.QAAAhAAAXDFETGGBYDHBdGFG.aAFFOHAEhADA..fHADhAHA,2,-24,-19,5
IaXJZWKMeHTNSfOUQcbVADBCYFdgEGLPR,CAAEdHBFGCDCLCBCRCFG.aGHHZAFG..KCFAMADDHEAE..TGAChACAfAGD.OEEFhAAAUGGF.QEGDhABAcEAF.AIECBAEAFGEDECBBIACH.hAEA......hAFA...,2,-18,-8,10
dXRUHYFZCbeVAfPGDTLIKNQWOgEMJacSB,GFDFDGDFLAAHKCEFQAGEOEEC.EDBCMDDA..aBADBAGGhACA.RGEAHDBFFDHFZFBBhAAAeACAAACD..fEAGhABAICHHNCCBWHFA.....cACDhADASHAA.hAFA...,2,-23,-17,6
ZfBKOLbgFXUHYaGSdVTIeARQCJPcMWEND,QGGHCDEE.JCAGMAAG.EGAEDCFFBGEBOAHDLBDChAEAFAABHEBBaAHBGCBAhAFA.SDGAhAGATGDBAFFAPAEANICH.fDDEKGGC..hACA......hADA...,2,-27,-19,8
NSAZCKXDReYgGMLbTWQdVIBEOcfJaFUPH,KACHDFDGeFADGCDALCCE..bGDGQEGFdEBABHBHEFGChAAAOACA..fAFHhABAFGDDUBGGPBADhAAASCAFADDD.CAHH.XGGC..gDFHhACA.MIEEhAEATFBGWFAF,2,-14,-12,2
OPdKEUITeQXagAbYCZVWJRGcSMLFHBDfN,CEDAZCCH.JBFDGBCF.SGDELFADFGFCBGGDDICA..NCHE.hAAAOAAC.dEGDEHBGhABA.IAGBeACEaBHHhAAAbDAD...YACE....hAIA..WECDMBID.hAFA...,1,-18,-37,19
RQBPScIgLKXHJdbeNfTFGYUOZVWDECAaM,RECHQCDFBEAG.SDFA..gBECKHBCJBABdFAFhAAAeAAH..TFGHhABAFGHBUGEBOFFHWCHDhAAADBGB.AEBEMAIH..IHBE.hACAHCBD...fAHEhACA,1,-26,-30,4
BgGPQVTUZDKAYCJSXaRLMfFIONeHcdbEW,CBDFXFAERCAB.LDGDFGGF..ODDEeFEDHAFAdFCE.bBCGhAAABEHGGDBHQAEGhAAA.UGAEDIAEAHAChABASFFFMDIDIADEEAHB.WCAF.hABA......hACA...,2,-33,5,38
UeSVXfbTLBACWYdZKPNHGJEIagDORcMQF,CCACdADBZFBEKDEGHDFAGAAG..EEAAaCDGDIGGREBE...QFFFhAAAUGFAeGAGSCDDhABA.VAEBfCGEhAAAbAGFBABHAAHAWHBANIBD......hACA......hAGA...,1,0,-25,25
OEfPCJTQZeRYWIFHVdNGAaXScUKMgbLBD,aGBHSCFG.UEFAMBFFLHACBBCGDFHFOEDFEAGCCHEG.JAEAhAAAZCAC..RABF...hABAIFFGFEBGdHFDAGCEKEBGhAAA..fBDAQCGC.eABE.hADAWEAFNCIC....hAEA...,2,-34,-9,25
LBVKSGMUdZCFYQfTgPJbXIWNAaeRHcEOD,RGBAHEEEEEGD.DGBELAHDBAHBKCDFGEEA.MADHdDBCCHDD.FCEAQEAEhAAA.TAEChABAJCHF.XCAGhACAIBBHAHHG...aGHF...eADG.hAEA..OFAH.hAGASGEA.,1,5,-32,37
QaWgHIDdFBOeJYAEfSZKNMbUTLVRCcPGX,EADESGGFKGBB.MEDAUBAF.LFDFCGDFGCAEQFGAhAAA..WCHBIDEFhABADFCHBAGDeAGDAHHHZAAGhAAANAIC.bADH....TGEF.cFAGhACAaHDE...dDBDhAFA..FHAC,2,-15,-14,1
VSWdEBJaePCfTUDLXANGKHgcOZQIFbYRM,GGAFKDBFHFFCODAEQCGAFGFG.RBCD.VDFGdGACBEEF.aACAhAAACEEGUAAF.DIDEACFE.hABA.NHBD.ZBFG.IAGAhABAMAFG...EBDF...eFAC.hBAA......hBBA...,1,-10,-22,12
YMTUFCabXGcfBESIOZJWVeLDPdgKNHARQ,QDGCMCFBFACF.aDCDGEDE.BHHDIAHHOAAFZFFA.hAAAVGBGDGADdEBH.KBHBhAEAAHHFTDACCHFH.cCDAhAAAfGBD.SAFCWABG.hACA.....eADEhAGA..,1,-4,-37,33
CJfDSMXIENbHeFOTUQAcVZgYaBLRKPdWG,VEABZEEGaHBE..BGGCKCEG.dEDGGBBE.CBHE.DBIH.MBAHXADGhAAAEDHD..HBBBhAAAFFACOGEC..hABA............hACA......hAEA...,2,-42,-33,9
PgYcDACeHdFKXIVNEMJfQBOLGUaTZbWRS,eCEHdAGDFBDFKEAG....XDFFIFFD.EHCAMEEH.JHFAhAAAQAEHBBFGOFAFhABALADD.aHFChAAAZDAGRDGDSGAG.gBAGhABADDIFAHCECCBH...NAIG.fABFhAEA,1,-20,-31,11
XcOMEUYGTPINfeQSRWAbdBgHLJVaKFDZC,dAFFHGCALCHHJDCGKFAE.FCDBZAEA..XABCMCBA..EEGGUGBFhAAAGFEF..TDAChACAIHHDeHEESABGhAAAACGFBHHEaEEECHAGOBHD...hADA......hAEA...,2,-24,-11,13
XWgVFbUBHKZOYILadNPcRCDQTfAEGeJMS,EGACeABA.MHDASGHF..gEBAFFFDBEDBKCHHZEFGOBCEhAAAIAEBaCABdBCEhAAA....NAGGPHAEhABACGDHDDAFfCEF.ACAGXAGFhABAWAHHUGGA....hACA.LDDHcDGH,2,-25,7,32
KPDJONSGUIBaLdcHZWfAbYQeFXCRVTMgE,QGGDFHAE.CEEC.VDGD.MAFAKDBAJABA..OCFGhAAAGGADBCCEaDGGLFDAhAAAHECDZABGABABeAFHRDAHEFEHhABADCCC..UGGFIFAD....hAEA......hAFA...,2,-25,-7,18
RcODSHJZdPWeMEXaIUVYLfFgQbGBNCTAK,KABDOEEDHBFHZCFFdGAD.eAEFMBID.EEAGaHDC..UACBLFDGhAAAFAFC.QDBChACABGGBCEDCACHH.DADF.SEHBhAEAJHAG.PHFGXBAHIEEAhAGA......hAHA...,1,-10,-31,21
SWQJBUOcaNAMLVbXZePYfKEDCTgHIRdFG,MBAFLDHD.VCBAZBEHeGDC...PFACfGAChAAAKCCGDEIHTBEE.IFFAhABAFHFGSBBFhAAAWCAFBHHAOCHBaGDCAIEEXAFBEAGB.CECB.hABA......hACA...,2,-25,-14,11
VgLHbRIeXZBaDMQWNcOfUKYJdPEGFTASC,CDCDLCAAHFDERBDF.eEACZBGDBGHAMGCGQAEF..NAAD.hAFAfEDHKHAE.hAGAdFHEEHFEFHEASBBEhAHAgABF.XAGDDDFF....hAAA......hABA...,2,-28,-17,11
GVMfXERUZbagFcBPTSAKWQCLYHDIeJNOd,KCEBCHFCHADEDHCC...eDGFJBHF.OCFGGEEFMFAE..EFADRABBZDDBhAAA..aCAHgGAGhABABHGE.SEHHhADAAABGLBCHIHHDNIAD..fAAEhADA...hAFA...,2,-37,-15,22
gSFZLYDRBPeXWAaMITCNKVdJUfHEObGQc,aFACMFGB..CCCF.KACEdCFCUDDFHGBG.EGGDOFBD.GAFEhAAAQAAG.SDAGhACALBBGDEHDBFHHhADAeFHH.AAFHIHDHNAIAfEDB..hAEA......hAFA...,2,-27,-26,1
BQLcUfJVRCKEAYGOMHPNITaXbdgZDSeWF,GBEFOFFCHEAF..IHDATAFDaCBFXEAC.dCCAhAAADEGGSFDAhABAeGDGBHHALHFA.hAAAcGAEfADFJACACCBDAHGGMAIDNEEF...hAFAgDDG.hAGAFHCC..,2,-14,-9,5
ZWebOgIMJCSFHUNTGRVABdKQPcDEaYfLX,BDEFdBFHKAFCQGGEDGGG.EECFaEBCLADEZCDF..eABEhAAAbCAB...OEAHhAEAgGDAMIDASDGDhAIAUDGENCDB.TCBH.....hAAA......hABA...,1,-21,-26,5
RLebYEFKSdBgCUaMPDZHfQATJOIcGXVWN,JDBCOEAGGAEA..XBDA..NAHALBAAeHAGEEHDSEDAhAAAdGDCBHHHCFGAUGAGhAAAaGEEMIEA.ZFAAhABA.HABAAADGTGEB..ICHHhADA..WEDA..hABA...,2,-31,0,31
FYHWEJAQCecZDTdNgSVLfKPRIBOGXUMab,eECADGCAdDEB..SAGCLHEEKCCDRBDCBHCFGABHUGGDMCIFhAAAFACEHCAD.JDGHCEAHZFFAhABA...TAGAhACA.....gGAEfAAAhAAA.OFAB.aHDEhACA.WBHBAIAA,1,-14,-28,14
MYVbFRNICAgcWeOJPKDXdEfLHSaGQBUTZ,....gFABeEACPHAGDDDBEGHFHCFAGFDBQABAhAAABBDEZAGFVFGDFAAAIEEChABAAEHF.OFBEhAEAKDACfCFAaBDA.MICA....hADA......hAEA...,2,-23,1,24
UaTRBKHNeLbGSOfgYIAXcMQPdJDFCZWEV,XBEBMICCdFEEDBBCZDAG....EABAUCFDaFED.BDDDHCFBLAEAhAAASHFA.fHADhAAAIDAGAFAA.hABAQGGFPFACCCDEWDHHRFAC..NBIE..hAEA......hAFA...,1,-14,-27,13
VFLebJgMIDdNARTWUfPcOaEGXHBKCQYSZ,REDETFFBUEBC.......fBCEOBBGGBDHXBEHhAAABHBHQGAHhABASFHHFEBAeHDCJAGHMIFGhACAIAGBDDIFADBGPBAHaADFKGEF.CEEE.YDHDhAAA...hAFA...,2,-21,-9,12
YBCfcNgIVAKPdUQZXWTMbGSORHFLJDEae,dBAFUEBDZEFG..TACEMBEGGDBB.OGAAREEFFBHHDGCBeHEGhAAACBAD.....NIAD.hABAIHHAAGGB.KCEFhAAAXCFF.SDADLAFCaGGBhABAfBDG..hACA...,1,-26,-31,5
UVYQKgEbHARZLWDGdXTBIFJfaOPNSMceC,LCAFDFCDdABABDGGFFFH..aDEGOEBA..SAGEhAAAeFABCHGG.UGCH.QDGAhABAKBDDEFFFACIBZFDDWCDChACA....TAECIHHA..fAHChAAANBDFMCCD..hADA...,1,-17,-43,26
BUMcQOagSACEVWfPKeRYJFLITdNZGDXHb,VGEA..PEDHKBDD.eHECRBEF.JCBHFEAELCGBdDGDZAAH.DAABhABAHGAEBHBF.MDIDhACAQAGE.aFFAhACAAAEFEAGE...WBFD...IFAGhADA....hAFA...,1,-16,-33,17
CQSfLTOGMNdbUgYPWceAFREJIKDZBVXaH,RDFAECGCKFDHDFEGBDAE..aDDGHFGH.CFAE.SHFELAAAGBCDhABAdADDUBAG...hACAgEAFPHACeAHBhAEAAHEHFGCF...IHAA.XEGHhAAA....hABA...,1,-16,-33,17
MWCfebTcZgDRGLBNKHUJFIaAPXQdVSOEY,QBEHSBCEEGCEMAFG...CDBDeDGFTBGCZBAARFFGBDADhAAAHGBAJDEBaHAC..AFDCdAGBhABAOFGD..WCAEhACAfBGD.bEAGcCFCDFIB.NIDHKFAHhADAIADG...hAEA...,1,-2,-20,18
KMFBLDPNAEWeTQIScGaYVCOHfgRdZbXUJ,EGFGTDAG..QEBESCBEaEEGCHDBHEEGRBEA.ZAGBbBAFUFAHhAAA.MBIDBDHHDIFChABAAIBAICCDGACHOFHFhACAfACBdEDC...KGAF.FHDA.hADANAEHWFFE...hAFA...,2,-8,4,12
bQIAKfLMGdXCBYFUaSEPcZTONJVDWHeRg,LACCGDDGCBFCFAAASCGB.EEFFZEAD.ODGF.JADDhADADEDC.HFCFRGFG.QGAEhAAAAHCA.MCCGhABAXAGBYHFG.aAGA.cDBGhBAANICD......hBBA...,1,-18,-29,11
TLaWVOHEABcdMSUKRGJXgNbFCYDfQeZIP,dFCDSDFERBEFGBAC..XGEB..gACHhAAAFDAFDDEBQAAAeBGHPEHHhABALECH.aGHDhAAAOFFBAHACMAFCKGAD..NCDFCEHA...fACHhBEA..hBFA...,1,-14,-25,11
PBNEUCQcHSaWLGVJgDfXFRITMYdObAeKZ,eECBKAFBZEAEBBBAUFEECGED..HBDB..aAAGLFGDGCDD.JFABhAAADCIDFAFG..TACFhAEAMBAHdCHA.ADBC.EHBChAFASEFF..WHEA...hABAfAHA.hACAXEGD.,1,-17,-26,9
YgPeKOLTJdSGWMaQUEbXFHVNDAcZfCBRI,ZGAGCBBCRCDH...IABE..gGGGKDFBLCFCdBFBSGDEhAAAMADDQFGEhAAAEDAAFEHFVEAC.DDEBhAEAADHGBFAHeAECJHECaDFDXGCC.NACH.hABA......hAHA...,1,-6,-27,21
KOdYLPfMgJIAeGWcHBbXFNCTURSaVDQZE,eBEFGECBHDACBAAGFFDDCBFB.UFGFRCEE...VCGHDAFGECBB.KEHDhABAdABF.LFAFhAAA.MICCIACFhAEAABCH.....WHCE...XCCBhAIANDFASBGEQGGBhBEA.,1,-7,-39,32
dMFbCWEGKLJDUQfHIgTYBVOAcXRZePNSa,XFDFZAFAeDCH..SGDHMIEA.CFEB.EDGFGCAAKFGBDFBHQACChAAAHAFE.IHAFhABAgCDFBCHDhAEAOBBDAHFF.PACGdGHAFDGHLHAAhAAAfGCAYBAD.hAGA...,1,-4,-11,7
bZXIWQMTRCDLfOHEGBAVPUcNKYJSegdFa,VAEEUEBFKEFH..JEEAeBHF..dDBEFABBZAAC...XFDChABAIHFF.MDBGhAAACGGDDCHBLADA.hACAOEEHEHACAIDCNDACSGCD.aFAH.hADA.WFHH...hAEA...,1,-29,-36,7
IORTHbPCAEXDFUedfGQYVBgKJLZMSNcaW,XGDADDBEFEDE.UBGDdGCAGEGE..QDDDBBCGKGAALAEHhAAAZAAHNECE..hABAaADHOAGFHEGHCEABABIHEACGhAGAfFAG..gGEEhAIASGHH.....hBAA...,1,-9,-29,20
ZYKdCUbJGfeNFOWLMQSTIPEXAVRcHDBga,VCBAHBAEDFGH.BDEEZAFFdEGHUFBCGEEC.eFBCFGEBOHFEhAAAMIAG..QAABhABAIAGF.EBHBAEBGRDGDaBEFhADA.CHHA...fADHNHAHSEAFXBGEhABA...cDDChACA.,1,10,-41,51
VGODMNWaPSFTeCJUBRKLZdHbYIXcEAgQf,QBGAVBAH.DHFAMICG..aFCASAEBeBAB.CGACUDEFhAAABGADKCCFLFFGhABAdAEE.HECBIEHBhAAAEHFEACHA.gDED.fGBBhABA.NICF....hACA...,1,-18,-22,4
PfRGZSTLOKUbQeJdDBIcaVFAWMgENYCHX,MEBAECEB..CBFHHEFCXGECRGAE..GAACTBCCKEBH.QGEBhAAAdCHEIAGEaDDHAAEFhACANEAG....fAAEhABAZAGB.SFDF.LFGHhACA.bFBHDGIFBBFGhADA..,1,-5,-13,8
GPbEIgHfJWYRMDdcLXAFSNUTKZaQCVBOe,SGBBTDCF.KBABZFEC.CDGABCGCeFEBGAFA.EGGEHGAEhAAAJCCB.RABHMBEC.hAAAdDACLAHHAIDGFHFCNAIE.hABAQADB.OFDH.IEAHhABAWCFD.DIGC..hACA...,2,-15,-15,0
NPBLRMQITdgfJUKHVYZWcOeFaCAXGbSED,XEGCSHCCDIDGBDCG.RBEE.MECCQFEBdBBE.JACFUGAChAAA.KGHDHEAAVADBhABA.ZGDAcCGE.hACAFAGEAFAEECFCLAABIAHEfGAEhADA.....WHFAhAEA..,2,-23,-5,18
BTJVKdgYbXfSICOEeMHRDZUPcGQaWFLNA,BCEDJDFB.KGGHdBGH......gDFFXBDGSGHBhAAACBAE.EFDDHFABhAAADEAB.PDBCGBAChABAaADBFHAAAIFE..VAFAfDHGeFCEMCIFhABA......hACA...,1,-27,-29,2
BOdZEAXCbJMUNaYRfVLTcHDPQFIGSWegK,XGCHCBHA..JDFGUEGH..aEDHRDDHLBDCHABFDAEEFGBDhAAAICBG.SGADhAAAeGFGBBEGdBHAADBBMIFEhABAfHGD.cFAF...hADA......hAHA...,1,-17,-41,24
UaWEBTgKOYMPcRfDIFGXHVCbAQdJLSeNZ,JHBCLCBH.eAHFUBCDECABBDAH.KBGFMAEC.RDDDDCGBGFCBhAAAHFGD.CHEAABBCdGHC.hAAASAFEaGBF.hABA..TDEC.OABA...hACA......hADA...,2,-36,-19,17
RIcVDLEdCHbGFNWOPaYATKeMfJSgZBUQX,KDFCeDHFMICG..JAFDZDBCBEDEUABERGDG.....VGFADDAGdABChAAAHFBEGEBCFBFG.hAAAODFFaAGA.AHHG.SEHBhAEAQACE.IBHG.LFAFhAFACFFCWFAD...hAFA...,2,-22,-14,8
SBDJXTMaEVHOKcRNQUAIZLGeYbdCgPWfF,LCHBGGEFeDFGdCDCCHAE....PACGFCABDGED..TDCChAAAEGHHHCFBKAGHNCBDAEBHZAFGhAAA....bGAGfABDhADASFECBFDCMBAFaEBD.OFFHhAEA.....hABA...,1,-13,-20,7
KUOXaATbCYceZGWEJIgDNPSMRHLVfQdFB,TEGGCCFE..eHDCGEBAJFFA.DBFC.SCBARBCBLCAFQAAGhACABBHCKGBC.XGEGhADAADHC.YAEFhAFA..WEFEgEEDMABE.fGAEhAGAFGAHaEEH..hAHA...,1,-21,-36,15
PDBYKUgfeRQZCAMIObXHNVTLcaSEFdGJW,OAFHHAAEVDGHLEFA..SCCCdABGJDADDGDEBBHFUGGChAAAfGDA.hADAeDEDREBFCAHAACDFbEAA.TAEFhAAAEHCA.FGAH........hACA......hADA...,2,-30,-9,21
RECLeWNOFVBGZXTKaPfdSYIbJcDUgAMQH,HEBARFGBEBHB.CHCELAHB.eBEFNCEEFEBDBGHAZACB.KCBA.aAEAdGDDhAAA.SBAFhABA..IFGHhAAAJHACDDFBAFIHMBAF.QGECOAFF...hACA......hAFA...,1,-18,-24,6
PFbBTRMHOeLCANJWgfdVXEGcYKQISUaDZ,JBBH..gGBAdEBH.EBDAGDGCKDFF.SAEHhAAAUDBCDEAHFGGEBGABRBGHMDEBhAAAOFFBLADCCHAD.hABAAHAB.fGCB.XDDF.hABAQACFaFGG.hACA...,2,-26,-17,9
BcdIOGUMCHgVWJNLQbRPYXDZASFafTeEK,SBEGaEDG.eABDBCCA.dBHAOEFFUGEFCBEAHGAE.gAGDhAAAVGAC.NDDHLEHBhACAQCFEPFEBhADAXDAGAFADfDBEKBAE..IHHFhAAA.MACChABA.WEFA.,1,5,-27,32
DVCGgXaEFZNfcOBeITJLSYUKbHPRAQWMd,MFBADADCGDCF..XAEEaCFCZGBE.....fCDAhAAABFHBICCFTBBAhABASBBFUDGFKHCEbFEDhACAPFFFAADDdAHECAFHEAHBcGGCOCAHJFAH..hAAA......hABA...,1,1,-30,31
XYTIgKQaJEUVNcHbAOLefWCdMPGZDRSFB,OBCBLDFH.eBHDCBHFdGEHMBACZDAH.DDCEFAFHBAGF...XEAFhAAATECCKAABJHFE.hABA.UFCG..NDIA.hAAA....cADDADHDWGAG....hACA.PDDGSCAChACA.IFHH,2,-41,-20,21
GfFgeAcNZVaLOQdKJBWbIMHERXUCSTPDY,ZBFHVEFALCAH.OFCDQFCGKGFABBHAIDCH.hAAAMIACEFECRCCEUAGECABF.hADASACBDGID.hAEAfAEEgFAAAEEGaBAD...dFAAhAAA......hABA...,2,-25,-21,4
VFZIgLdABaTPMQHNCRDbSYJGfeOEWKUXc,TGFGQEBF.CDHF.DAEE..SABBGAABODEAEFFAUAFHhAAAXFBFFFDDZCDALHAAhAAAAFIHBHGGaDAAPBEChABA.MFIBNEAA.bEEE.....fDABhADA.WBHBhAHA..,1,-2,-24,22
acYBgfZDWbHAUSLJOFQXEVPKdNeMTRGCI,SCAAOEDHFAFC.QFEH.EBGBVFGB.KCEAeFBAhAAAMAAGTCEBGEACIAEFhABAaBBC.YHAAhACABEFF.ZDAEDGFHWFHFAHCH..LAHHhAEAXABE....hAGA...,1,-13,-21,8
QKXEOTdSFARcBYLaWZPJICNGbfgHMVeUD,BAEDaCHFZABAJGDA..CEHG.GDBB....bFFCHBAC.VBGFhAAADHBAKDDBOGACTAFGhAAASDAD.hACAAHIF.cEAB..YFFCWHAG.NIAB.hABAfCFG.hACA..MDAG,1,-26,-28,2
QOHUBEfFMSaRZXeKgDVCdbJPTLNIWYGcA,QEEEHABHEHGGMGCERACDZAAH..KAEHDDGACECA.dHAD..JCEHTEBAhACALBHD.IEAHhAAAGAEBAFIF.OEGFhAEAfHAH...FFHF.SBADhABA...aAGGhADA...,1,-17,-20,3
fHWELeDSacNGFBdgbQVOKTCUZRIXAPYJM,JFABMBCBHCFELGFGDDED...aFAAGCBCBHBAdADCQAEGhAAAOFDBKBAFCCAGUFFERDDEABGB.hAAA....fHBFhABAEAHDSGAFFABE......hABA......hACA...,1,-17,-25,8
JERfcVLaXMUIHOeGdPTgWSFDYANQCKbBZ,CCABKCFFBEADEGCB..REAA...VEDCLFFA.MAEBHCEGOBAGhAAAdAAFTAGC.SADChAGAFHFCACIDQAGBhABAJHFC.fHADaDCB.IEGHhACAeDHH.gCCDhADADIAC..,2,-27,-5,22
NLefIPGJVaKYMCgUDFcAEBZOTSRdQXHbW,BCGATDFDdDBF.HACC..NBIA.eHAE..fAFEhAAAGGEHaFDGKCBFMAFGCHGDDFFDFAABhACAAHDCZCCHSCFFhADARADD.XEGFWGACIHBE...hBGA......hBHA...,1,-13,-22,9
McYZOJQGXbENFgdeTCRfBaVKUIAWPSDHL,SDCHHEFGLGDGMHCGZADF.QCBEXFGF.EFAGFCBDgAGChAAAeHAGRACEBFAAhAAAaABBKGAFADGCDEGG.OAEAhABA...........hAFA......hAGA...,2,-22,-10,12
YECTHZVLDPbRKMASJdNBacWfQUIOgGeXF,dGBEaHDA.....fDCHQCEHUGDBIDACGBEHFGHDhAAAEGGCCDCBZBGHDFABRAAFMCBChABAAADE...JFFENFDFBCCChAAAOABC.eFAA...YHAAhADA......hAEA...,2,-22,-15,7
fTeNDGAgJKBPMYdRcHaWXIVECSQbFZULO,KGBHMEBCRBAGHDDA..aABA..XAEHEBDFSFAHFEBCUDGEhAAAOAGDeABEDFFBAFABJFCEhAAABHGEdFGH..IHHGhAEAQAGAZAEB..fHEBNEAC.hAEA......hAGA...,1,-13,-16,3
afGeJCgLHKMYSEWBNbOPXcDdTUZRAFIQV,FFFEQGFA.aDEAGACE.eCADJEAACADELHAA.hAAAKCGCSBAAhABABFBHOAFCXGBDDEGCTCEAhAAARAFGAFEGIDHA.fFAEhACA.MBDFYFHBhABA.NEEA..,2,-32,-16,16
AGUYgcWVbHCfIJBFRKeQXaTPdZSDNELOM,GCAGUAGH.....gDGDVECHCGFB.JABARFADKBBH..hAAAQAFA.hABAaGGCdBDHDDCCEDAHMCCEhAAAAGIH...YEEHcDDA.WHBE..hAEAfHEBBFDD.hAFA...,1,-22,-38,16
BcbPDgSOHCMaKWNVFTUeIZGEAfYLQJXdR,LFDCQDGBdCGBBHHA..PAAEDCEHSBEBOHAACBEE.hAAAKDCF...NGAHFACBhAAATEAA.eFHDIGGEhABAECDFAIFG...fHCHXGEC.bFEBhAEAMEEEaAFF.WADE.hAHA...,1,-11,-36,25
PULeCRQOgIcESTFDfJVWGNKYXBdMHAaZb,ZEBAUCDFeABGQEGAODEE...IEAEEBHBFGGA..DGCBJACChAAA.GGCDKAADBAGFhADAHAGFAHDG.aBBBLCCAhAEAgGADSHFGfEEE.WCCDhABAYFAFMIFE.CFFC..hAFA...,2,-19,-13,6
fRQEJYVULAXGeDPcBHdCbIZOaFTNKWMgS,eDEFDDGABBCEdGCACCAGZEBE..FAGEKHFC..MFAC..SDAGhAAAQBCEEDEGVGEChAAAAAFDGGAF...hABAPFFC..cABBIAGAaAEDTGAEhAEAWABF....hAGAfCCGYFFC,1,-13,-36,23
WGAOKLFegZYHcbdfQPJUDMVSITRCENXaB,KADBFDBFeFDDZBAFHFCDdDEG.QFFBUADC.MDADSCAChAAA.RFGH.EAHF.aBFFBHCDhABAAEEHOCHDLAGHhACA........YFABhAAA.fCCEhABADGBD.IHHECBFB,1,-8,-29,21
AGbedZBEFQIPRNYXgVTMODHSWfJCcaULK,eEFAZCAGFBECQEBEREAA..XFFBVAFCOCAEDFIFHEDBhAAASHDG.fBEGhAAAJHAACDHG.aEEGhABAKAGEABBAdEACIABG..PFHD.hADA......hAEA...,1,1,-30,31
ePGISaVYcdZMJUXQNATRWFLKDBOHbCgfE,TEGARCAELCFB.BHFAOCBGHEDFCGEF.ECHFeAHBGACF.aFHDhAAAVFAC.dACFMFAHhABAXDECABHH.FAFHDIBChACAfGHA.SDBG.hADA....YAADhAGA.,2,-26,-9,17
bIeFKgGVZdYTaQCSUMNROEALfBHJWPXcD,LDEBHDFAJFCC.XAGBDFHD..eDAFFGGEGABEZAAA.TFAEhAAAaHAGCDDD..MIBAhABAOBDA.AIFAfHDHhABAPADG.IDAAgBGEdDGBSECAhADA..hAEA...,1,-17,-22,5
BCNEGJAIagQcFOZTXSWUbPedVfDLHRYKM,aHECQDDB.FEGDOABDZEAF.TBDAXAFA.SGDFhAAAUFFFeCHBVABAhABADAFAHEAG.KAADMEIFhAEACDEHEGCFAFCA...IDAFWAHH...hAFA..dBGB..fGEChAGA,2,-21,-12,9
WOaZYJHREQeAXCTDLMBPVKNbSUcGdfFgI,XCCBDBBBBEFCKCGH..SFFBUEAA.dGBGFDDH..IDGHhAAAOGFCZGAEYEBAhABA..HADFhAAAQAGBCAFG.MEAHNBIC.bFGD.fABHhAEAaACBEFGE.ABDETGCBhAFA.,1,-26,-32,6
RVOZWdFPLXAbCUBDTEeaSNgMYJQGfcIHK,CCFCBCHGDBGG.eCBD..SEEAMBFAQDFDGDAC...hAAAIGFEKAECRBCFOFGFhABAdGABLEDHAGIB.hACAbAAEEGDDaHGE.NIAFJCDGfCGH..hADA......hAHA...,2,-36,-6,30
DdXRZceIGCLHJOKQfAWEaVBTUYNbgSPFM,aACCTEBH..UCCF..NHCD.SFACMAGB.DEFHXBCHhAAARBGFeEHHGGADhAAACHACLFFEOBABKCAEABBCEGFHhABABDAD.bBGH.gGGB..hABA......hACA...,1,-14,-23,9
VLbKEJZCYOGaMDdXNcSPFWfATRegBHQUI,RGFGBDEFQDBEUDGHLBADKEHH.ZGBECDGCGAAD.aFCEdHFBhAAA.XBCC.hAAASBGCPHBEWAFFhABAAEFHeFAE..gBGE..hADA......hAEA...,1,-25,-31,6
gOUBZKSWdcVPDNXLIaJMFeTbGHCYQAfER,EDDARDBFOBBCUAFABCDCZFEC..KAAEdDAE....VBGFDGEELBHHhAAA.IABFhADAaHAGMAEG.eFDDhADATFBC.HGFCYHFAAIAESDFHhAEA..cDDA.hAIAXBEF.,1,-18,-19,1
cgJMIWKGRaLfBPbCEDFTVQXSNUAHOZYde,ZBEHdBFEeFHFJEGD.MDCDKGBF..GECCRFCFLCAHBBCC...CFFGFAHDhAAAQDAC.hABASAHB.hACAAIHCOAAGYEECICDHaCCFfADHhADAEAGDDFIB.XGAHhAGA...,2,-25,-24,1
BVKXHMbWGNcFQTdUCYLeODJZPgfREASaI,aACAVFDEHFCA.MFABGBBH.FGCHdBADCCFH.eDCE.DHFGJAHBZBGDhAAA....fHFFhAAAAGBDICFHKAECXDBGhABA.NIED.TDAD..YFFChAFAOEEA....hAGA...,1,-16,-28,12
gATKRLObJacIdNGVFPSZYfHWBXQeECUDM,KFFGRDEHLHECOHDA...aBDFdBACGAAAFCCEZFBFHAFDBAFCQFCChAAA.eEADhACAEDGEDAAEMDIDABGG..JDEDhADA..IDCH..NEAC.SHAGhADA.WCGHCBCF.hAEA...,2,-40,11,51
KGLHEJQTCVgbRUPXWSAMdeYFBNaOfDZcI,eAEEFCFCBCDFOBBDZEFF.KAADHDBH.EFHBQFGF.CHFD.hABAbFADRDFEUFBG..hACAXABGADEEMIBA.YAEGhAAAaAHFDDAHIBEEJEDD....hADA......hBDA...,2,-19,-18,1
QZGbHWeLMPSUTdaDRVfgIXAYJECOFcKNB,EFAHCCFFFEABKADF..BHFCGFEHHDFELBAD.SFBHhAAAUECEdBACaBHFDICAVAFChABA..fHAFhAAAXDGAACEDOCBG.QGGGWCEH.hACA.MBCH...hABA...,1,-6,-32,26
CbFaYEWAXKVJeBNIRTPSUgLdMGQOcDZfH,VAFDBFGCREBF...SGDGUFFGLECFdBCEGAFGOCAEDICEhAAAZABAHBADCFAE.FHGAaAHFhAAAEEEH..AFED..XDGAhACAeBHHNDAA.........hABA......hACA...,2,-23,-12,11
JWOgFbVBKZdSIGHeRATMDLYQCNaEfPcUX,TAEHDIBALBEC.CDEE.ECGG...PCAGXGED.JCCHhAAAOGEE.bECGBGDChABAZEAFSDEEhAAAGDAG.eABCAIHEMEHDNIABaHGE.fAHEhABAUCGDWADC..FFGA.hACA...,1,13,-35,48
OLaCMZIfHJWNRYKGEQAgUTSXcPVeDFBbd,TFCASEBE..XDAHVBFADFECFCCHBEAGdACFLHFEhAAA.MAGDIGHDhAAAfFFBJCBANACBKHAEhABA..EBHBAIEG......cGEAhAHAeHAGaAEDCBDB.WEEC.hAIAYBAD.,1,-3,-27,24
DMSOVadBUZYWgQfLRCPJXKeEcAIHGTFbN,HEACTAEFFEEG.DGFGOHDAdBCDBEHFZCCD......gBAChAAAQBGAfEFEhABARGDECHHD.PBHHhACAKACEEBAHAHADGEAGMIAEaDDG....WFGHhADA.XCEEhAEA..IGAD,2,-19,-18,1
DIAbKWMPJELReUXZNcOaSVCYTgBdHQFfG,KGDEMDCEEEDCLAHD.UFCBZACA.OBBBaCGACBAD...TGFAhAAABCDEdFAG.QGGChAAAFAFBDFFEAEIBPEABhABAJDAE...XACFNIADSDHD.hBAA......hBCA...,2,-29,-24,5
VdBJFXHfbCMZGeEDSURQIAOPTYgaLWcKN,TCEBaDECLFBC.KGGHdBHE.BGEBJACC.FGCHHGACCAFCZCCFeBBDhAAADBBG.UAFC.QDGChABAIDAAAIAE..hAAAOFFB..PHFC...gEAAhABA.WFFEhACA..,2,-33,-16,17
STNEVAdPFZcKLOXJBCQefHGRDgYIUbaWM,dDCGFDDEZGCAKGBALAEF..JADACACF.eFGBGFEBDFCG...hAAAIBACaDGF.SHCAhAAAEBHBACBH.OAHDhABABABE..fGACgAFA.YDEGhAGAWCDC.MIFEhBDA..NEIE,1,-30,-50,20
UKNLZVBOQAGSWfEaFeCbIJHYgPcMDdTXR,SEFBEGHDFEAD.CCHG.JCDBHDDF.....PBBBDGEETBAFhAAARGBCKGHBLAFEhAAABGCDOHEEAADH.GADHhABAaHFCICFA.cEBBdDGGNCIG...hACA......hADA...,1,-10,-29,19
MYFWGOHDaKbcRQUSXTNZCBefELdVgPJAI,MEGHFEAFOABGHDCGDBFA.KCHDREEAUBDD..SBDGhAAA.TGCD.CEAEBGAFhABAfHEHdCAF.hACAPCHFAHHEIFHAYGBGWFFD..aGAHhAAA.QGGChAFA.NCCA..,1,-18,-39,21
aKTOIGebXWdZFHYDSECLfRAJgQPVBNcMU,QFEHVCDG.BAFEMFBBUDCEKACA.ODHHGGEB.XEGBhAAAZAAAHBEA.DIAGSCGEhABALDAHAAHEPAEGhACANIED...cDCHaBHF....hAIA......hBAA...,1,-13,-26,13
fKaQULYEgOSMdTZHWRcCBFeGXAVJDNbIP,VFCDJBDE..DGFD....ICBGKCFBUDBHLEFE.hAAAEAEASBBBhABAMGFGTBFCZEFCRGAABHHAFHGC.hACAeEACAAEA.PAAAaAGA...YAHHhAEA..OEDDhADA...,1,-5,-35,30
QGfPbZWTVHCMLEIRaeNYSdODcKUXgJBAF,FHAAQFCBGBBG.....fBCAPDAHZEGFTBGHhAAACEDH.EEEGaAAFeCADSCGChACAdHFFDBBBKGBDXFEEhADABAFCAGIH...WDDEMIEGIEHFhABA.....hAEA...,2,-29,-3,26
VBYPGDOMTaeXKJbSUAHcIdgQNLFWfCRZE,HDBBdAECQDAALAGHFHECCFFG.RAADEACGBBBGGEGCMHDAeCHFhAAAJEDC...UGAGAGBH.hAAA.gBEAhAEANADE....fEDF...hAFAZAFD.....hAIA...,1,-10,-21,11
CTOHMNFXSaRVcAWQDYLUegIGEBbPZdJKf,DBCEUDBEeGFAGEEABCCBZAFB.KABACAHEHBGD..FBHF.aBACVEEChAAA.AFAG.QDGHhAAALEDFEGAEdADAfHGFhABAOBAH.NIAF.XBED..hABASFAG.hACA...,2,-24,-10,14
GKeTLNRUZaXdDOVgYFcQIBAbEJHSPfCWM,EGFDSBBC.CBFG.MCDEGBGAeEDALDAGRAACZBGHdGAFOGEEhAAAVDAC.FGBD.IFAFhABABGGBAAFF...bCDDhACA............hADA......hAEA...,2,-27,-23,4
KPQVeROaYZDTSWgJBCdGAcIUNXLfFHEMb,UFFDXDFGLFCFFHAG.MDECKBGB..QDAHeCADRDCEOAFAhAAAaFCE..ZFGBDBDGSAAEhADAJABB.BCDDhAEACBGGAEHE...IGFB.HADG.hABAEBBD.....hADA...,2,-28,-8,20
YJPWDKBOLUZQfFINdeXVcCaEATGHgRMSb,TCAFHCBCMDIH.SEAEJDFB.DEEBKHCALADCQAEFhAAAIHEGeCHDXFAEhABACAHGAAAGGDFGbCCFPFCFhACABGGD..OEDDfHGF..hAIAFAHF.....hBAA...,1,-8,-15,7
aGTFMJULCSgRKXIZWfNDAcEbePOQYdVBH,EGGCeHAG.QECHdFEGBDFFGABCMBCBUBFBCGAC.RGDC..XAAFhADAIGCB.ZADBfFFBhAEADIAEAIFC.PBDDhAFAVAFG..aBAH.......hAGA......hAHA...,2,-26,-12,14
eOfdScQRXZHbagWEBPFTGDJIYNKVALCUM,LBGDMFGF.eACFOADGdFFE.QECCZDDHaBEF.EHDABHGHhAAATBGGDAFG..IEAHhABAYDDC.VAABhAAAAIACCCHB.SHAC......hACA......hAHA...,2,-33,-18,15
dJeUgMIHOfbENACVDXGBRTSLcaWYFPZQK,CAFBXFDBBEFB.RCFG.LBEG..aGAEFHAEQDBGhAAAKABCdFHE.UGGDMEDFIADAhABA..fEAChAAAEAGDAHFHDIAASAEH.cBBAhACAWHDAZDBBeEEEOEEBhAEA..,2,-36,-21,15
WXLBUFODRIJgdEQYPHZNeAVcMCGfaKTSb,VFGBCAHHGEDE.KDBBSCAG..XAFHBEFHOECHhAAADBAARDFE...JEAFdGHAhAAAEDECQFAGhABAHBCCeHCCADHAMACA.TGFH..WAHHhABAUBDAFABEYHAGhAHA...,1,-14,-15,1
JdUEGcPLYaMNbARVKfZXQCIeHgTBOFDSW,REBCKBCGZABBQAAF..IGEGeEAAHGCEBBHAOAEAhABADFFC.JEEAUBECEGGD..hAAAPBHDLGAAaBEDMDAChADAAGHAfBAC.CHHE.....hABA......hAEA...,2,-40,2,42
RBFILZJGeXHSCKNPWabgVEMdfTADOQYUc,DDDCOEECUADCBCFALBHFZBCFGBAG.HGAAKHFG...NEIE.hAAAPFBA..aAFAhABAVAADMGEC.fHEFhACAAGAFQFGA.RGCA.IFCHXDEEhAAACAEG......hACA...,2,-27,-8,19
KXTWOMceGRCIFgQDLVZHSfNJABEYPdUba,EADHdAFAaEFAKFCA.....XCAFTDDFMFFFeEABGEDAhAAA.CHCBFDCDDAGHZBGDHABGhABANDICAAADBHAGUDAEWGFAhACAOHAC...IBBD...hAEA....gGGDhABA,2,-21,-18,3
WVYHTJKADgREaUOZSbPMFeCNcfIdBQLGX,DBIFEEAEUBABOCGBZFDG....SDEHMEDEFFAH.CGGB...hAAA.NDDG.fHFDhAAABAGELEBHXBDFhABAVACETCGDAIGA.aHAE..eHCA.dCAFhABAWEHH....hACA...,1,-21,-28,7
NcHQWVOXFERSJTKIaMebPACdZYDfLUBgG,CFBCdEBBDACFLAAF.BGBAGEEHHEEDQAGCVAFA.FGHBhAAASCDGKGBB.hABAMCIDPBDFAHHFfGDAhACAUGDE.NEAGOBBGEDAC....hADA......hAEA...,2,-26,-18,8
QFeTXgOSHVMBfWNGabAIULYKZDdPEcJRC,LBCFZDFFDFAEdAHEEDDE.RFCD.FHBG..TBGAODDD..VGFChAAABACH....fBEHhABA.WCAHhACAaCCDAABF.ICAFKADCPEFECAEB.QGADhAGAeHFESGAFhAAA.MDID,1,-14,-39,25
gRLPcJZINKVSQeHOXFGDAfdBUabWTEMCY,BHADUBEE.aGCG..TBAGCBAF..REFALBDDJGAAZDGD.KHCASGHHhAAAHCEA.ODDBhABAFHGEADABdAGG.ECBHhAAAMFFD..gEAA..IAHAhACA...hABA..QDAB,2,-24,-23,1
gGfDQIWZXMeNJASOYCabPHKUEcVRFLdTB,SFEGOBFE.CDAE.aFGGHAFHKCCBUGDHEFCH..RBBDLEHDhAAABDFDGDAADEEGIHDDhABAZABEMCED...JFAHhACAAGAF.......YAEF.hAAA......hABA...,1,-10,-36,26
QeHEDfWXcLJTOaPMUFAVZIKbgdRNCSGBY,VDBGKECAdFAA.RAEC.CHFG.BHEC..eBHDDACC...XABChAAA.LHACTAAEODDAhAAAMADCAGBAIFEAhACA..bFFDSBDAQCGGfDGGhAHA.cGGHhAIAaHAE,1,-38,-46,8
ADQLKUYdSeVHNJaFXCWZORgGPfbMEcTIB,LFEBUEGCdFCA.SBEEHACG.JBCDFBBH.XDEHZFAEOBHDhAAARBFC...PHBGhABAfHAD.MAAEhAFAEDADIHGFAGACKDCGeHDCNACBCDEE...gEGDhAHA..hAIA...,2,-23,-11,12
feMPcbJdEYSKCBADURQHNWZgGTXVOaFLI,RABBQCGEHDFAZBFAGDDA..XFDHaGGBFHBA.LDCChAAAeAFE.MACG.cBBGhABAdEAASADBhAAAKGGDBHBADFGG..WFHHTAFC.IFCDhAHA..fBAGhABA,1,-5,-33,28
CWbXGJUegdTLPIBENaKZRfVAMDcYOSQFH,MFAADDIFOEDEFAAGHAEC..CCCG...XEDFUFACdADBTDGBhADALGEGBCDCaDEARFFBAAHAhAEA...SHCAhAFAQAGF.bAAB.......hBCA......hBDA...,1,-22,-33,11
CWEUPBHKQFZbANVeGDfaSYJTMIgcXOdLR,VCEEDDHH..SGBD..TECBIDACXBBEhAAAdCDHRACE.EEHFBAAHHGFEFEEHhAAAZFAFAGDFGGEBfCAEhABAaCAA.JAECMFAE...gAGHhACA....OAHDhACA.,1,-11,-13,2
ROCfeNcKVXIFgSZHEQTYadDbBWUAJMPLG,JCDFMAAELHAERBCH..CBGB.eFFBKFCG...VDGHXEFBhAEAFAEAZAAFHGDG.ECFETEBGhACAdFAEDAGABGDEAIBA.hAFA.OBBBfADENEIE...cBGBhAHA.IHHAhAIA...,2,-25,-15,10
RcEYJTeLVBFZOIbAKPGMSHfCaQgUDXNdW,KEHDMCABHBCA.CFEF.QGAEDGBD.dABHRCFAEAAHJDEGLBFAhAAA.BBDHFAFCOEAAhAAAIGGFAGIBSGCGhACAaHEC.XGFCcEDC....hADA......hAEA...,2,-32,-26,6
TCPKgbQDfRSGOAZedUNEcHWJLFBMIYXaV,eFHHUCFHEEGDHECALCAEBGBFMIBC..XFAHaDAB.CDAH.hAAAPAHFKAGD.gBCChAAADIAASFFDhABAAABANDDH.JABGFGFD.IBFGYEDF...hADA......hAEA...,1,-16,-23,7
UdAacDTGYCJVLHZNWfFSObBIQKXePgMRE,aEGHDDADGDGC.CECF.JFABHBDFZAFE.....fGEBhAAASDDDBCBFKBCGPHEChAAAMHBGEDFH.ABIB.TCADhABA.LCHFFBFGIABCXGCGhACAeFAFgCEAhADA...,2,-28,-13,15
XVADYTGMZLSUNKHBgbcCEIReWJaPfdQFO,DDEHTABCZBCELDGF.UEAGNDGCKDHBBFEA....cFDChAAACBHBRGCE..eAAAhAAAJHAEaBDE...PAGFhABAfHFFFFAG.OHACADABMEBE.SHFAhADA..hAEA...,2,-31,-26,5
NcKREJfDICQeYVGPHOBgFUTdAMLWaSbZX,MAAALGFC.SGCAZCCGXBGHKDEBRBGFEEFC..DEAAQGGChAEAeADC.VECHhAFAHBAEBAGCFFBEdAABWBBFhAIANIBH....fCDF..CHFFYFBFhBAA..hBDA...,2,-21,-12,9
MRHDAfYPGFdLOQXCKeWaESBVUNZJcITbg,...PDEGFGDBdAFBLDBDQDEBCHAA.KADDeAAE.aAGBBCFFhAAA.UCADJFHDTDCBhADAMFGBREAG..AHHH.fEGChAEA.OHCCEBHHNEIA..IABDhAEA....hAIA...,2,-30,-15,15
QfYbEgRIFHOdMVUDBJAeXKaNWPGLTcSZC,XCBFKBDD..aBGC....WAGBGEEE.LCBBhAAATGDDZFBBCAEFQDGFhABAfBDDEHBCgGFHhAAAIAHDFHGAdEFDMAIHDDADAACHeFBAPCAHhABASBEH.hACA.YDDE.,1,-6,-8,2
bILfUgQGNFeREXOScVDMKAYPZWCJTHadB,ZCCGCCGHHABDBBHHLHACUGGAGECDFEAFeDED..RABA.EFHBSGBFhAAADECBAIFC..PBDEhAAATGCE..bGEChABAfAGC.NCAE.XDGE.hABAcAGF...hACAMDDF.,2,-19,-16,3
fTOJgBQMCXNaLIUbAcVWKSEPYeHdDFRZG,VBGBSHEA.EDCCeFDC.DCABRAEBZAABGDBEOBHHBGAAQFGAhAAAMABG.CGECaEADhADAUBBF.ADEHKAFEPHAChAEAdFHGTGEC..gECAhAGANIAH..IBEGhAAA...,2,-18,-1,17
fEUSMYBPbWNIeXTOgQVDZRFCJHdaLAGKc,KHAGEFFBUABBMEHHBCEA....bCCC..IACEeFADTDGAhAAAOFFB.QEBFhAAADIFCFGCFCBEC.dBGCABGD.hACAfCCASEEF.WAEENBAC...hABA......hAEA...,2,-40,-17,23
JcFCOUBfbXREGQVagMePSALYdTZKINWHD,dHDFKAGA...ICFGHCCHDDGEFGAACEEFBDBD..XCABhAAARFBEGAABVDCF.aEGAMEIHhAAA.eFGFABAGLAFEhABA.TFFBNIAB.JADHUAEG..hABA......hADA...,1,-11,-22,11
QWUCbfLcDYSZTgRXMGFJNAKBEIePaVHOd,BAGBECFE.eFACaCAEHFBHOAHDdDDD.QEFDCAAC.LABAhAAADAFDSCAFhACATAGEXGGGGFEBJDDGhADAKDHHIHDHWFAF.UBBA...cGBBhAEA....hBEA...,2,-30,6,36
INXAVcUOPWbTBYQFHCLSfeDERMKgaJZGd,VEDCUBEEOFAH....PBECTDGGBDCA.FFHHLHCAhAAASCAFfDBFhABAeAHBDGAAEACCMHDEhAAAaEFH.ZABBdGHENIEHAABFWCAC...QECDhACACDGDKEAA...hAEA...,2,-18,-10,8
eOSBVFKUZXWMbCJgDGYPRETALdcIHQfaN,dDAGHDAEQEFDaBCBOFEHBDDF.FHDGKFFGUACFZDFEMFIH.hAAACGBB.DAGCGADCRBGHABGB.hABAIAGAeFBHSGHHhADA..WFAD.JAAD...hAFA......hBAA...,2,-27,-9,18
bSKdYXTDgANGQMcHUCFOeZJLIBEaRPWfV,GAEGMFBAHCCECHHGFDCBeFHD.LAAGEABARFFA...fCAGhABASDFHKHCGdEACXGFHhACADHDEAIAG.QCGBhAEAOAHH.IGEFaEDD..WBAGhAAAYFAF.TAEAhAGA..,2,-32,10,42
CPLWADOMVFgQRSEZbeUJfKacGXIYdTBNH,MBIDFGEGQACGRCED.ZGACeGDC.JEBAaEEAGAAB..hAAAXCGAIHGHdEAHhAAABCGDCEDDLCBGhABADDABOFADSGHDEAGB..fFHEhABAKBGE.....hAEA...,1,-14,-20,6
XFSeNIZUWbHcECYAfOKMdDPaVgBTLRQGJ,OBDBMAGFdEBADFAD..aEHDBHDD.LBHDQACEGGEDhAAAFEGBSBAGhAAAeFBBIEFGZFCD..WAHFhABAHAEH.CCBFAACEKDEH........hACA......hAFA...,1,-23,-26,3
UNJeFKYWgfTMEPOaCSbZGVBDcQIAXRHLd,RDEFdAFEUCAGeFGD.KHDA......gFBDfCDBMIFGhAAAEHAA..OAABhABACAGDSABAGCGADEFHhACAIDDDAFBBXDAALAHBJDDF.FEHFWAHBhADAaFAH......hAEA...,2,-23,-17,6
GLQRUBPScFZWMOfIETHegbKAJVCaXdDYN,VFAFaAFH..DCBHGDCGRFEH.BBDB..SGHFFGEFMCAFOCEEhAAAICHAEABBTGBEhAAA..gGGGhACAKEDHCACCdDDBNBAC........hABA......hAEA...,1,-22,-35,13
IMaDHKfAgSTBOPbdERLFYNGUCJWXcQZeV,SBACTFFD.BHCDOFABdCCFLGDCFHBGGADDUCFHJDCA.hAAA..XEAChAAAZCGFIBAGDGBFKADAfFDGhABAAHHF...gDAGEAHB.hABANIDHCHHEWEEG.eDAGhACA.MEIH.,2,-16,-6,10
OXTQfSMaYHdGgBUIEPWJDecCZVRFNALbK,KGHHXGFBQBAD..MABEaHCGdBDDBAFDUCGFEAHBJDDEDGFE.hAAA..CFCFZBBBFDADAAGGLEHHhAAAODDFSGBFhABA..YHCE...hACA......hADA...,2,-29,-28,1
QGIfBdLHUMSPFeRCWcXTNZKbagJVYDAEO,OEHFQEGFGECHBHCDHCCAMDADFCGGRDCG.CGAD....XAAGhABANBEDKCGA..aAAAJAEChACADDBDAGGHEADB.IHEGhAHAfGHC.dHED.SFCBhADA.PCDA.cGAGhAEA.,1,-11,-31,20
egCaSdNDRLGcEHIJATYUPWQZBMFVfXKbO,TAACUDCFQBGE.BEAAMFDBFABAfFAH.hAAAbBEGeFFD.CGBBaBDEhAEAdEFDRGEELHAGEDBGJAECAHAEhAAAPEGD......WACB.hAFA..XCGAhAHA...,1,-16,-20,4
EDQZIcRFMPfKHCYXgSTBeNLbaAJGWOUdV,JCCEOGCE.dCDADGBEZEADRAFB...FDFAMBIFKCAG..HAEA.CACD.hAAAXGGH.SEEGhAAAeFFC.LEAGhABAaGHFAFEG.WHAE.....EABHhADA.IGEG.hABA...,2,-33,-32,1
IUSQHXedDKbTEZAYMRJCBcgLNGVaOWFfP,RFEEJCFECBCD.BECALAFC.GDBBaEFC.FEAH....PACBhAAASDGDHGEEdEAChABADCIBKGCFEGBHZADB.AIGC.hADAMAAC..NDIG.OADFIAHD..hAGA......hBAA...,2,-27,-24,3
VDHBReGYdSXIWZKNfUEgCcOPQMAaLbTJF,aGHBLGEG.TDCHVABFHFBG.eFFCdBGGXFAGhAAAZAFFKAHH.UABBCDDG.OEFGhACAMAABAHEAFBEHDCFDBHAAhAEA....YHAAIHCC..fEAFhABA..hADA...,2,-24,-17,7
ZUHdbYSWBPGQNJEXDOCgKATLVMFaRcIfe,LCFGFCBBRFCA...IGCEeDADUCEHHAFCdACHSCDHhAAABGGC.GGEDJAHHDEIHhAAAOCBD.KEFAAIHAMIAAhABAaBAHfFAA.....hADA......hAFA...,1,-6,-38,32
cLOJAQKdYEFebMBZDXHgWaTNSVPGIRUfC,QBFGKGBDEBDF.FFGGeFCBBEAGDGADHAAD..aGFASHAEhAAAGAAEUDEGCHEELDDFhACAAAFEdBFH.MCCDXGEGhAAAgADF.NAICIEED.hACA..fGHAhADA..,1,-2,-27,25
cIXWOYZfELGFNeQdgCbVJUATBPMDHKRaS,TGBCBGBGDIAG.HBCGKAGARECA..SEEB..IBBChAAAOCGBZAAFEGFCLCDChABAFAFGQGGChACACEHAJDAAAHHHaHEG.XDACfACDeDDDdGEG.hADA......hAEA...,2,-19,-15,4
dCFVIERQgASNBJcaGLWOZHXDTYKUbMPef,SBDGJFFDGCBBLAHDOHFE.HEBFXAAFDBEG.TDDGhADAKAAGMFAD..fAGHhAEACEFC.FCGAhAFAIEHGEEGGQGADAGIB.BGDGaADG.hAAAWCBH...ZFFAhAGA...,1,-12,-22,10
UEIRLcPXgFQbJHATOaGNVWeZBDfCYMKSd,aCHFGDGE..VFDEeGAA.DABA.CADAKDEFUCDE.EHACLBFEhAAA..XAAAhAAAFCCGQGEGJEABAHIFTCFHhABANBBGBDFEMDAC.SAEC.hAFAIHGC..hADA...,2,-26,-21,5
ZGWfRDUSTCeVAaMKOYBbJdIXHNcEPQgLF,KAFHOCGFBEBGdCCCHAAA..EGFA.QEADLHBCFFFEZGBGGADBhAAARDDBDDGEUCADCABCAFDAMICChADA..bFAGIHHFhAEA.XEEF...NAIG.hAGA......hAHA...,2,-31,-10,21
KBERMSQLOPJWdANfeUZbXHcTGaDIgYFVC,eEBHUDCHZFFGHEEDGGADDCDD....gAFHFAFECEGABBDHEAAEhACA.MDIFQAAHhAAAOEABJHFEAADH.fFDGhADAXBGEaEAFIHCFKDFD.SADAhAEA..WHDAhACA...,1,0,-32,32
HBEVGdbZcYTWRQLJCaDfMUgNIFPKXeASO,SFBHOEAGHADGBBGCECGCGEFAdGFGZDFA...TBBBQBCAhAAACDHADIBCUFDCIABAhADAFGAEKDDCADGC..cEAGhAEAWAAF.......LHAGhAFA..fAGDhACAMEED,2,-29,-12,17
DSHOfeWNTYaJEGcCPRMFIdLgKVBUAZbXQ,ZGCGXGAGSDDDHCCD..eACA.TCFDaBBFECGF.CGAHMAAAhAEAFCAGIFGG.hAFALEEDgAFFhAIABBGBAHGCDDBFfFCGNEICJCEF.....hBAA......hBDA...,2,-23,-6,17
gFdDbQNXYOMUaAKHCBVZSEWeGfRTILPcJ,KABHBAAAZAEHEDCAGECFRFCD.LDAG..PFFFJAHDdGAADEIHhAAA.QAEDhACA.XCFEMIEEABDDCGGAhAAASEADfGCDIHHA.FACDhAEA..NDIC.OAHFhAGA.aHAA.,2,-23,-22,1
cNTQAdPYXBCMILFWfUHODgGRVSJEKZbae,dFDCXCBGCGEELCBFFGFG..UADDHAFHDECDRDEE..SDCChAAAKGDFZDEE.aHAAeAGFTGGAhABAACAFBABE.MEIBhAAAfADA....gGADhAEA.....hACA...,1,-21,-25,4
LWUFAeGZaBVbNQHJIcEDTfMSdCRPgXOKY,eFHDZABHaFGEBFAG...VABDQFDHHECH.IBDFhAAADGGFTAEGMAFD.SCGEhADACHEBRCEA.gDFHhAEAKHBA.WHFAADAE..NAIGcEEEhAAAfGBG.dAGB..hBAA...,1,-13,-23,10
gdCfARMGODJaQPUVbeZLBWcISHFENKXYT,RFDDOHCGDIFE..QGBCVAAA.ZCBCBCDC...IHHGhAAASCEEFCGEEDEDhADANAIC..KFGC.TABBhAAACAEGfAGA.AIBEJFAAPAEE.eEAEhABAWEGF..cFFChADA..,1,-16,-41,25
DRgfIPFZSNWYEeCOXKAUJGdaBMQHLbcTV,JBADdFACMHEELDFC..TCCEDFCHRDBG.....IGCAhAAAFAFASGFE.hABA.YACCEHCAOEFEhAAAACECaEEGBBHAQEGD.cDBHhAGAgABBfBGGhAHA.NIDF.CBFD,2,-40,-30,10
HOQNgKJAVGRPedXCBbfTWaSYLEIZUDMFc,VDBAGFDH.REAEdHBBBCGH....TCBDSGEGLEHBhAAAIGCEDDEGFABEOBFBhAAAQAGFKBDBAAGGeHFAhABACAEA...fACFaEEG.ZEFEMBABhABANIAF.....hACA...,2,-31,-6,25
OGFdgNDaXIZQLSTYWJMbcfHKAUVRPECeB,UFCARGAAEDAC.CBAB.BAACGCGA..FHFCdACFDAIF..aAFAZDDC.LAGDhACASCDG.hADA.TFGAJFFFMAIFhAAA..fBBDKDBAAHIF.PFCG.hABA..OADF.hBDA...,2,-33,-18,15
RNDbfMOTHUAWVZCcXJYLBaSegQIKEFPGd,VCBHCCGG..XCCCLEEABFCB.eABCQGGE.hAAAEGDBFEHDdGACDEEBbAFCMEBHhABAHABGAFGDZADE.JAHHhAFASDFCKHEC.......hAIA......hBAA...,1,-7,-30,23
ZMGeOBDRfbANaFWUTQCYEHSJdLIVXcKPg,FHECTABAQDGF..CAHHEGEBSBFAJDHB.dEEAIDDEhAAAXFAB.KABAZECAhABAMDAAOGACBFDCDADChAGAfGHANCDF..UGGBLHAAhAAA.cAEG..hABA...,2,-24,-17,7
ZTOXdQYfSCMNHaRLWgIVAPGBFDJEUbecK,BDCGJDCE.UBGAeGEEZEAF..OCBGdEHE.QFADSBCChAAAMCIBHEDGLAAChAEA.IHDDhAFAAHHHFBAFDDDAEBEGKGCETDFHXGEACBHCaHGE...hABA...WFAD.hAGA...,2,-26,-13,13
LWJcXKZIPdfBNYOTSDHFMaUREAQbeCGVg,eHAAGEAFLCFDJFGF.KHDGZCBAdECDBGEHOADEDIBEHAAC.hAAAFDHFMHFG.aGAGEAHBhAAAACCC.CADE...WDAChABAIGAG..NGEHSACCRBEB.hABAQDGB.hAFA...,1,-13,-21,8
RLBZHJeCDGWTSAdVKPYXIcEfbFOgNUMQa,VFGHKFBG..XCCFEDBF.FBFGOAFHUEEE.MEED.RACBBAGFhAAAJHAADEAD..TDFDhABAADHHdAAG...ICHDhACA..fEHANEAG.aDAA.hAEAZGFGeHBE...hACACBBGWFFD.,1,-8,-32,24
YBAWVeaDFQSbRKTPOZLHdCfXgcINUEMGJ,eCCHFEBAQAFAREDC.KAAAPHBG.LADCCHHE.XCGEhAAAIEGEUBADhABAECCCMCAHJHFGBFGHAEFHaGDDhAAADAHH.SFBGOFAFdGGGfBEBhACANAIE.....hACA...,1,-4,-27,23
fSdaYbgGQMLDBTHPWKUcJIVRAXEeOCFZN,XBFBEABC..OGDGFEAEZEFASEBEdBDE.aAAHgGAAhAAAMHFCBHAGTBABhABAHBGFPAEB.hACAKEEEJHCEIGBHAAECCHGDfGGD..hADA......hAGA...,2,-25,-14,11
FSQKMYXgeAVWLDZHJBTOcCUfRGdPbNaEI,LBBEZAAHHFDHBDHDTDFECEBD..UACBRFACdDDE.....NAAA.hABAaHFGEGHHSHBAhADA.KDEEYBFChACAXAFBAGGDDCCB.cFDD..PAHFhBAA.FFFAMIDC.hBFA...,1,-11,-26,15
GMOPTFfWaQKgZLRCedYAIHVUEXcDBNbSJ,VDAAXBCA.DEFCBHEE...SACDMCIFOFGHTFFChAAAFFDF..aHDCKEEFLBAFhAAAeHBEdDGHAGCFIHAChABAHADGEAGG.cBGB...JDBCfBAAhABA..hADAWAFF.,1,-12,-34,22
JZTPeNCSAMVbfDcUGXKEIWYLHgaQdBRFO,MAGBVDCD.DBAAGAAD.KCGDEEBG...IHFCLBFCaEDDhAAABGFH.RGACODADhAAAJBHDZCCAeFBBCHHCADIB.fADHhABA.XGGBYFFC..hABA......hADA...,1,-19,-26,7
GKCaIYfUPQXHNRJcOgdMWbSVeZAELFTBD,FDFEBCFAKHAGaHAA......IBFGfGGAQCAHhAAAXCBEREDD..JFHBOBEBhAAAMACG.SFEGhABAeCCGAAGG.TDGHCHFAPAHFNACHgFBEhAHA..WABGbAFA.hBAA...,1,-20,-31,11
dDQgaVNOfRPceUBYKTIAXFHEGLCMSbJZW,XECFHCADGEBGLAGFMEHH..SEEFJFBDZFEG.DACEaADChAAAOBBARBBE.PFFDhAAAeBADBAHHKAGCAFAFCDDC.hABA...WHCA.......hABA......hAFA...,1,-19,-20,1
bOCBGdgHUJPfKMFeZRLNWXDAVScEYQTaI,SHAGECEH.QAGCaCHFOFECCCCDBHHCdCAEUGBE.JAAAhADAfFGD.hAEAMEFDFAFAeCCDLFAChAAANHDFDIGEABBGcCEA.IAED.hAIAbDBEHCFB..PCHFhABA.,2,-27,-8,19
QICYDSLeEVaJHNTMBXFPZgdbfAORKUWGc,RBCBKEFFGEEEQBFGCAFG.DCCEeDHF.EABFaBBG.HEBH.MIFChAAABAHFFDDFPECBhAAAZGEEdHBHAHDCOBAH.hABA.cEGAIHHDSCAGJEAB.NAIE.hACA......hADA...,2,-15,-10,5
SGHbMBKNTgFRUXeOWZAYVdELIDaQCJPcf,VDAHdDDGEDAA.LCHFDFGG..CADE.JAAE....fFCFhAAAHGCCbBCEBAGE.hABAKFAGNHBBTGGGFGGBXEEBhAAAOAHF.ZCDGAAIB.IBCE.aHAChACA......hAFA...,2,-30,-11,19
cNKadfSMXTBDAQgGbUOEHIJFLVPCYRZWe,GACEOEECHGCCFCFDLFHBCDGDZAFA.eFBHKEAAdBDA..fAAHhAAAXABDBHAAhAAAABFGQFFCUGGCECGEIDHAhAEA.PEDDWGAC.aEBBMBAFDICCgAGBhAFA.hABA...,1,2,-19,21
HdIfSEDJWMOXRKcNbCaBAYVZFgeTLGUQP,VACHFDAHeGBA.GBDHUGFBHBFD.dDHCIGFEEFDA.JEEChAAAMEAF.OBADhAAAKBBD..NDIG.CFBDAABCZDBDLHBAhAEA..fACBDGIF.XAGEhABA...hAFA...,1,-13,-18,5
XKDJdYVZcHUONfeFPMCbEAgTGIBRQSLWa,GDDCBFCCSAEBLFBFaAFDDCHDdBCCZDGFUBAF..NBIA.eAHDhAAA.FBDBCGHAEEEFAEAA.hABA.TGFFRGDC..hACAXGAG.JDAF......hAAA.YDGF.hADA...,1,-13,-31,18
WRBTEZCXfcMUIDVGgFKaOYJSANeLbHPdQ,eACHLDDDHEGDdDAHRGCEBDEEEHBEZEFG..CCAG...XACFhAAAMFAFICGADEFG..hAAAVAFFFFBBKDDFaGGG..hABAOFABYAECAEEDPABH....hAFA......hAHA...,2,-18,-15,3
YIFUCKNXgeQSGROHJWEfBPcdMDVbAZLTa,ZEDHTBBBaGBA..FEAGKBFC....XDFHQDFG.SFABhAAAGACD.OFHBhABAJBHFEGHFBEDBPAAFhAAAdAEGDDIFAFCG.YHDGIHAA.CCCB.eHAAhACA.....hACA...,2,-26,-16,10
VZTDRYIaWHbULEdNfCSPJOQFXgMGecAKB,VFBHTGAH..DDBDRCDH....aEHHHFFHLACAEEHDdACBfEAChAAACAFH.SFFFhABAPBCFOFEHhAAAFCGEgFCGMFADcCECAIFABDCF.IHHBhADAWBAF....hAEA...,1,-17,-19,2
dPNcKRHXYEDBWGfLaObTSQUeFAZCIgVJM,CFBBVAAEdEEA.......NCDC.RABFHDGBEEAG.BDFBGGEDLAFAhAAAaAHF.TGAEhABASGAGQDCEhADAFAFFAADGZEECIHHA.JHCGcCEFKBDG.DIDChAAA...fDHGhBEA.,1,-9,-21,12
UbcQCPHDKBEVJGIFXOeaRYATMLSfZdWNg,MAAELFEAZCGHdCBH..NCCH.UDEA..bDBFCHGEHEBH.DBIHhAEAKAAHBAGDEGDDGDEDhAAAFAED.eACA.aBHFhACAAHADSGEHfGAGWFHH...hAHA......hAIA...,2,-32,-5,27
gNLDVCKdAfIeObHBTUGYEFaScZRWQXJMP,eGFEHFCAUADEEGCHFDEESEEE.RAAB.XDBA.JAAFhABAPCHBLAECCGGFKBFChAAAABFD..IHEFhACABGAATDBBaGBB.WFHHMDIF.NDAGDAID..hADA...dCCF..hBCAOHAE.,1,1,-15,16
HZQGeAKTJDaEfcIVNFPWRSLYCMXBgdbOU,JDFHEHBC....IAGDVGDG..FEBGRDBGLEHD.CBFGBADBhAAAgACBdEFEOABHhACAZAAHQGAEhAEAADGGKFDBDDDG.aDGA.fHGFPFAB.SAFDhAGA.XAGAhAHA.,2,-33,-20,13
CKaBEZYNTGcAeMVgLFbQUDdJHPOfWIXSR,MBGDVDDF.FEGE..UADAdABFHBDD.OAHBfHDH.hAAA.IEAFXAABhAGASEFDCDHEBFGFZBFHhAHATGACAAIBLDBFDBCDJFDB.....hBAA......hBCA...,1,-17,-26,9
HYWXOgEdUIQDNLbJGTAfVKPecSFMZRaCB,KHFAeBGFFFACMAACZADF.REAB.BDDDHFDE...XBDHOCFAdEHAhAAAICBF.NIDF.LBAFhABA.JDFDAIAE.hAEA.PCHDSGBAaAGACGHC...WCCFhACAEEEEDBBG....hAFA...,2,-36,-8,28
RUfOIJcGFNWKDMASYaCTBbXVPHQgLeZEd,SDCHCHGEBACC...VADFQEEGeHBEZDAHdEHE.UGBFhAAAIEHHJAEA.FEEBKECGhABAAFGD...aCCCTAGEhAAA..PCEGgBAELAHBEHGE.hABA......hACA...,1,-21,-26,5
EHXNUCedaSbWPIgGZBTKOVcYLRfAJQMDF,JBDEQDBF.MHAEFHFAEDFCHEFFUGACdAGBaFBC..SDDDhAAAPACH.GBAGhABAZADFKEED.OAAHhABA.YHEALFFAAHHADDIBCHCEeAFE.IACGhAEA.BHEGhAIA.cDGE.,2,-17,8,25
KBGTVOedSMIFbCQAgYaDZJNWLEPHcURfX,aBEDDCFFZDBD..JHFGLFGBHBGH.UABCXBAGKBHF.BDBBhAAA.GEACTGEDOEFChABAdHABMAGFFGDHCECAABEF.hAAA..NAED..EFEDPEDB....hAEA......hAFA...,1,-7,-32,25
ZOFBgXeCDfTcdLSQIJUMHEPYARGaNVKbW,aGEFVFFG..KFCBZGCCBDDB..eEBCCBDE.DABC..TAGEhAAAdBBBLBEEQFAEhABAIDFAMADGEGHHADDG.hAAAGABCNAIG.WFEEOFAB....hAEA......hAFA...,1,-21,-26,5
BNeRgVaTdObJYGDQEcWKIMPASCZfXFLUH,CFEBXFBHUAAA.BEGARCFB....aAEDdCBE.JGDCGDADDGAB.hAAAEHDCKAEE..MFIFhADA.AHBD.fDDDhABALAHBeADFTBFHOGBAQGGCIHGBhAGAPABC...hBAA...,1,-17,-28,11
IMSgFPGTbWBOZLDYfXHNCeJVUAEcKdaQR,KGECQGGCMFCA.SCAEFBHFGBCH..TCGHBHEDOFBHhAAADEDC..fFCGhAAANEAA.CBEHJHAAhABAAADHdBBGaFDAIGHA..PDABbDEA.hABAWABA....hACA...,1,-22,-29,7
NTFZcbGQLSKRBJedPOaECVHgXfUAWMIYD,MCAGDGGHFFBBZEEHGAFALCFG..KEDDREBEBHACdCAG..aABEEDAChAAAHBDF..fHCHhABAAFGA.IHHAhACANIBD...TADF.QEGChADASCHHJAFAOFHDhAAA.CAHC,1,-18,-35,17
IgaebAFKMdORQPJWYDULHSTcEBZNGCXVf,MFBGdFCEQDEH..JBEHDEBCUGBFSCGEEAEGBHEFZFAFhAAAGAGCCBDD..fABChABAaFGEADDH.FHGAhADAKABFRAEA...YHFGLFFG..cEEEhAAA....hACA.XDACIHEE,2,-23,-9,14
CHKeDPMQBIONfbRYZTGJWVSdUFAEcgLXa,EEAGLBFG.aDCHCGGEHACE.DECGMAABQAFCODHB..hAAA.NDDB.bGFA.RFABZDEBhABAJHAASEGAhABAdCBBAAEH...gGEGKAFEBEDE.fCADhACA....hAEA...,2,-24,-11,13
cdaVDXLKQCZgSfJNPOWbHMETRUFeGAIBY,BFHFdDGCaAGCDADE.KBBHCABH..ZEAF..SGDE..fHEHhAAAJBDD.NDEE.hABA..OHAAHBCEMCIBhADATAFGFGGAAFDEIHHE...hAEA....cEEAhAAALHAGgCGF,2,-51,-14,37
dbQeOKcZMPCWFLINVEfDTaXgRJYHBAGUS,UBEHdFBCQGGHKFEDZBGB.MBEC.CDGG.FACBLAAF..hACAVEADDCIH..TEDChADAaHFC.RBBA.HDCEAAIHSHDGhAEAODHD.cFEEIAAB.fGGDhAEA..hAFA...,2,-36,-11,25
QBSdMeYWZOJLIKGRUVFAcfPaTXNbHCgED,...fFAGaHDCXCBGHFGD.EDDEDCFDBDHEMFACeAAFZFFHLAGBhAAAIGECRDBFUACFhABAAFDATAECCFHG.SHAGhAAAWFBA.KGCH...FBCCNBIE..hACA......hADA...,2,-21,-2,19
YbcBGKFCASJHafMZgOedDTXPVRWQLNUEI,JBDAaHEGZEBC..eFGHdCHGDCBA..TDDD..XCEAhAAARCAGLEADEADAIGBEhABAbBGF..cFDChAAABFGAFAFE.CACCAGIHSACCMIAE.OHAEhABA....hAFAWECENEIG,1,-25,-36,11
GQSaMVJUbZYgLBXNdROKcECTWDAIfFHeP,FCCBeCAEGEFAQGDBMAEB.UCGBZBGFLFCDBHAHdHGHOAEDhAAAEAAH..CEECDAFCIEDAhABA.HEGFaDAH.hAAAVDAH.JABGYFHB..XAGFhBAAKGDG....hBEA...,2,-17,-2,15
WOZLIQJRABKMeCSEaVXcPYDUbfdFTgGHN,BBFHMHFC.eGEECHCB.EACG..VAAD..PCBBUDEHdEBBFDHDGGAHhAAAHAGFOADBhAAAZDDA.QGAAhACAABADaEAH.XEGHDDFEfBBD...hAEA.NIEH..IAFHhAIA..,2,-26,-1,25
ZYBTcUbgXFQWSMVNLCAJeGOKDfdRIaEPH,eHBGOAHDDABBdBCARDAD...ECAHZADCBEGHUECC....gFGAhAAAQGGCSFBDhABAMAHHLFFChAAAAFCEKAFEaEFBPCDE..YEDB.cBEHhACA....hADA...,1,-17,-36,19
HIAgKCBEXZWUFTOVaLQcSMDfJRbeYNGdP,CDCDEEDCZDFAFDBA..OBAGLHCE.QADHMFBE.DCAHRGBAeHFAhAAAGCGAHFFEAHBDKABHhAAABCCEUGGBaAEHSGAChABAJAHD.bAFBdGAG.IDAD.hADAXAFB..hABA...,2,-15,-3,12
TMbJKHEIUcVRaPefdAQYWLNZgFDGSBCOX,QCEBLHEAZECBDGABGBEHBHHEOACEXFAF..TEGAhAAAMADGKCBC.HEFGhAAAUGBB.VCABaBABfFEEhABAAAFA..NEEG.SDDEhACAJFFH.IAHF.hABA...,2,-26,2,28
fVBAdOISEUNJPbcaWgHZGTKXRQCFMeLDY,ODEGSCDBUADA..JFFB....PBFGbDFE.aHECHAAAhAAA.ZFDDKEEFREAEFBHBhACAMABHDGAB..fGAGhAAAADAFEGBD.cGFA...GCBGhACA...XDGAhAGACHHE,2,-33,-20,13
UZLdcSVWFRaXeBOMAICEKGJQHDYNPbTgf,CABBGEECHFDEDBHH..NECG...TDAHUBDDdBBA..SDEAhAAAFDGHXAFBBHHGhADAAEEBKBHFJCCGQFAFhAEA.PDHDfDAE...hAFA......hAGA...,1,-25,-33,8
MbEOAJNHPcGYfBIdaWeXUVTDLFSKQRgCZ,HDGFGBCDBFBAdEECaHBGXGEH.UABGTGGCLBEC.hAAAFDEBSEAChABARFCF.ZAGFMAEAODGBhACAAHIBNAAG...cFAGfDBAeADEDBBC.hAIA..KEHHCGGG...hBBA...,2,-17,1,18
JUHYQdOTCgKWLAGXEBaNZRDfMeFSPIbcV,GCFAEDECBBBAaAFGRDAH.DIEC..eCDFFCCE...SFCGhAAA..PEEBIHFHhABAVEADJEHFUAABQAGEhACAdGHACHCBKAHBAFFEZGAA.MADG...hABA......hADA...,2,-21,-9,12
NEMZAdPSaGLYcfgebQBUVHJCFKOXWDTIR,SGFGLCCA..fEAFeDFCBHAAUGFAHBCEFABAXEEGhAAADBGERGAE.EAHFACGEdFHEhAAAaFBC.GDEF..hAEAgCAEQECHCAEHKEHH.WABC.hAFANICB......hAGA...,1,-4,-11,7
aSMRgDNHAEZLKTOecBCJdXPWUIYQfVFGb,ECHBKFDGOBFCBFGHdDCD....XFADUGBBQACAhAAAFDBEaEHF.RGEEDABBAHGB.ZBFBTACFhAAA..CCAG..hABA.WCAF.IHDDfEBE..hACAbDFFMFAD...hACA...,1,-23,-38,15
VNJaKGDRSTYOAbPBUXgMZCfLeIcEFdWHQ,BFEFUFECMGBACCAGLHEC..eDHDEHBA.FDDBdDEHQCAGhAAA.JADGaAFADAIHSDCHhAAA.OEBHhABAAHBAXABFZBCGIFGCcBFD..WHAAhAHANAIGKABG....hADA...,2,-29,-21,8
FNOPTZbfQVLDWEGBSMcRUJAeaYHKdXICg,eEDHaBDAHFFAdDFECDAHFHCC...OBGDZFBBQACHDACDGDAFSAGHhAAAMADA.UGGBhABAAHHDKBAD..IEHFhACANAIC...PFAHfFDH.hAEA......hAFA...,2,-24,-17,7
FBYaDHdIgGbOAZJTRXQCVfWUESKNLMPce,ZEGHRBGBCDCE...VACFUADDKAFELHAC..MEAHeFDEBAADhABADBAF.dHCDGCAAOBEDhACAAIHA...JEEHXGEGhAAAQBGE........hAEA......hAIA...,1,-28,-30,2
eXdcFPQHAGUDIfTLMRYbJZEgKNWOCBSaV,UDGDDABB..TEFCLHCCREAA.JFAAEHGE..KABHOGCEBBDF.hAAAaCAC..eDEFXAEGhAAAdAGDFGGG..QCGEhACAAEAG.fDDBMCEG.YHAAhADA...hABA...,2,-39,-12,27
ROQgFHLGEaYAfXNVdIBCDWPecUJbTSMZK,XFBAdCCHBFGEDAFC..eBDDUGEFJFFE...SAHBhAAAZDEGKEABRACC.QDAEhABA.FADALFCBhAAA.aBABAFEAfGEE.IHBGhACAPAHD.bAFDMFIDhABA...,1,-15,-39,24
KeUZJYbcPgMOWEdGLSHQNDICATaXBRFVf,aCFBRCAHFEGC..KEFGZECE..JACA....bGDC..PHEEhAAAOAHHEGBALAAEhAEA.QGAHhAFADDDBAABBBGDHeAFHUBGEcGGA.MIEGWHAGdCCAhAIASCBH.hBBAIFAE.,2,-38,5,43
VSUTZLGEWHPJKQfIODeRXcdgMBCYAFabN,aAHDVDFD..UBAHZGCGGBCDHEEGKGBEQAAF.ODAChABADIDEXBDD.hADAdEADMAIHBHHAAIEGFGHBhAEASGADEAGBJFAHIFDDcFGD.CFBE.NAAB.hAFA......hAGA...,2,-32,3,35
FGLeODdPbgIRMYAaEHTSKNVCXcZfBUWQJ,HBADKBGGCFBB.ZECEBBADUGGB.QADDFDFG..LGAAhAAADCHBdDEF....PAFAhAAAIEDBMCIHAFHCaCCEhABATGCG..VFFD.....cAFBhACAWDAD....hADA...,1,-10,-51,41
ICTLSJOXUQdaAfRgPbeZENHBDKYVcMFGW,RBAD..bABBZDGF.HGAEDEEAKBFH..VDDBMBIFGAED.CABB.hAAASEAHOGFCUEABhADAdDDCfAAGhAEA.eFGHNICFBCCBFHAGIHDD.hAEA......hAFA...,1,-8,-21,13
eQAEfKPFDRGHbWMdCTBNYSZOJgcaILXUV,KADEDACERDCGGCGEHGEA.MAGFCCBD..BAFESDCFZFBF.OFEFhAAAJAHD...aBDCXEGBhAAAeFBDAGGBfABGhACAFBECdBAF...NEDE....YAHHhBAA.IHHChBFA..,1,-9,-35,26
RCALNEXFUKaVZeMgIGbcQWfYdJHBOTPDS,EECHXDABFACB.UAAFKGGCZGCG..eFDAMBBHGCEH.QDCHhABA.fHGBhADAYBHFHADFhAAAOHCCDAIHCBHDAHACaEEAIAEAbAFF.dAGFBFDAhABASGGE.hBAA...,2,-25,2,27
SDPEcbICXOVZgGeFNLJKfUdWaRHBAYQMT,MACEDDIBECDE....IGBACHBC.OEHHZBGBeFAFLBEGhAAAKBAAdHGBaGDBBAFAACCHTEEDhABASAAE.hAGA.bCFAXFFC.VDBCFDCD..NBBA.hAHAfGDC.hAIA...,1,-18,-26,8
BQNfLdGMJWASXeHFabgUYOPVEcTRZCKDI,eBDAaFED.UCAHODEA..EGCHRBCAKABGDDEDBGAC..fGCAhAAALHEAMCGFhAAAAEEBSAEEHFEAFABAbDAGhABAPBHH..cEGBCEBD...IHHFhADA.dAHGWAFEhAEAYFBD.,1,-13,-15,2
ABJYDKWMIbPgaGceUVXQRNLfTFEZdSHCO,BBEDDGGBKAEEMADG....ICFF..PFEFaGBHeAAGhACAVCCF.RAFALBABhAAAFDDBEHDGZCGDSGGBhABACEBGAAHF.JCHDWEFF......hADA......hAIA...,1,-24,-38,14
BRGPVWTISDgfFaNcXOCQHKZbUedALJEMY,JFDBMEGFBCEAGADG...VFBETACCDFFB.FAGF..NDAC.OFFChAAAHAAE.ZFBBeEHFhAAAAHFBLCAFECCB.RDEA.hABA..IBHC.SBFHhACAaBHDCHHAKCCD......hADA...,2,-19,-13,6
FKOQRIfYSZTPDVaUMdHACWJNeLcGgbXEB,JCBHeEBDLGCAGAEB..XEGCBAAAOACFRBCH..IGDBhAAASBFE.ZEDChAAADCIF.aFFHMEAHdBADAIAAhABANCIA.bCEE.EHGCFDGF.KGHF.....hACA......hADA...,2,-27,-6,21
aJTECWdbLeAFYGgNcQOPZRKVSXIMHBDfU,GBBD..cEFBOFDF.ZFGBVBBCXBGE.MAFEhAAABBEE.DEIHUDACaFAHTGDHhAAACGFEdDEB.eCFAhABAABAEFHBG..NADFQGGC.KEDE.hABASGBH.hACAfCAEWAEG,2,-14,-13,1
SJdgPaRCYMNDbQcAOXEILVfZWeBTKHFGU,ODHDEDCFLABFZFEHBBFAKGBEGGDD.UDFDJEBFdDCH..hAAAaBEGCDGA.MDABDAFA..hAAAQBBDACIF.hADA.IHAD..fADBhABA.WFDDeBFATGGHhACA.FAHD,2,-31,-23,8
CIKFgTHOacVDEfdQMNJUReSAXWYPZLGbB,XBFH..WHACZCCHLGEGBDEHKAGA.TFBCHABAaCFAhAAADIDCdAEE..MGDChABANCAARAAA.AFFG..GEADhADACFGCIAHCFGHD...OEEGEHEAfEHChAEA....hAFA...,1,-10,-24,14
JGDcIUXTbLZMeEOQgVfAWKRBPaNFYCHSd,RBCGaABFFGDEHEEB.dEHAJFAHGBDE.DDGHUCGD..TFAGhAAALEBCeDAGOAAHhABAQAFH.fHDDhADAAFFABAEF..PHFCCHADIHHB.hACA......hADA...,2,-42,6,48
KOQTeIMLaFbYXSBNHCGEDUdcVAWJRgfPZ,JFHBRBDC....fAAHKDDBQAADeEFHLDBDFFFG.hAAAXFDBSADBhACABDEACBHBDCFAdDHGAHBH.gAGDhAAAZFBAIDBAMFAHaAGGNIEH..EADC.hAFA......hBDA...,2,-36,-2,34
MWXIYPKJRcFbQBLAZfONGTUgDHCaeVSdE,ZFBGOEFHGCEFUCACDDDBHFBG..aHFGeAHHdDAH.EAFE.MIEEhAAAIFFH.KBDE.hABA.JHACFEHDBDECAAGC.hAAATADDCCAB.WEHBXAGE.YABEhAFA....hBAA...,2,-32,-12,20
fJVPeLCOgYUdMNIZbSAFTKGRHBEcDaWQX,TAFEKDFGHCAD.BBBEDCCD.QEDG..JFFCeHDGCHHHOAAFhAAAUAEHMFCFZEACSBEDhACAABIBFGHDEFGHaACFhAAAXGEH.PHAGLAHF..YDEGhADA.NAIA..hABA...,2,-22,-7,15
VZHgMAcQJPKfNGWTBIEbaUDCRXSYLOFde,QGGDKDBAGABFBHAGEBCG.UFGERDAHSFCCLDFGdHDDeDDChAAAHDDBMDIH.ABHDJADChABA..fCFBhAAA.TAGHaGEDCEGFYHAEFFAE..hACA......hAGA...,2,-15,-9,6
baZXMSgYfNWdTcOKIJRPFAEVHeDUQLGCB,EHBAeCFHUCBDQDCBLAGHBHGG.aDGDMEEB..gACGhAAAfGFAdEAATADChAAAOHCE.IAHDhABAJFADFFGAAFDB.DACDCAFF..ZFCASCFFhABAWDHHKBBF.....hADA...,2,-13,-11,2
SfEGCQZgdPRHAcFDaMKVXWLJbITNUOYeB,FDEGDCAEKDDF..XCBGLHFE..JHEATGCA.OFEAhAAAeFBBBACE.EAGBhAAACHBGQCFHhABAZFFC.dDACHECDAGAEMBBGWEADIAHANCCF.hABA.SEGGhAEAfBEH..,2,-28,-24,4
gIcGbKJXNHWUeOdVaQSLBRMDZYfFCEAPT,TEGD..cCDHKFAF..JBBCXBABHAEDUGEG.dBHGhAAAaEBCLDAGMACAZBGHhAAAFEEGAHAD..IGHHhABA.GFCHWHAA.eGAG.OHFChAGA.SCEEhAHADABACGHH...,1,-14,-15,1
fASCeTFBIGDcLJaMgURYXWZQEKVbOdPNH,CHEFTCFFBBGGGBBE.LDFFJACCaHEC.UADBRCBF..XGGBhAAAZEAHKAAD..OEDBhABAPGAE..HEGDhACAAFFCSBBFIAHGDCIFgAGE.hAEAQEDE.hAGA...,2,-17,-15,2
XTDLWaUCdJKgEFfBMeIRScHbQZPGVANYO,ODDBTBBB.LABAUEBB.dFGDKHDGEBHHBBDB..eCAFICHChAAASCFB.hABAHFABZFFHPAEGhACAAFFBNHEBDECBCAGCFFHB.MEEAcCDA.....hADA......hAIA...,1,-8,-27,19
dcMNXPSDgRbfTYECGOQWLVKJAFeBUIZaH,BHEAUFDFZBECaEGAHABCdAAF..MFIH..XAFCDEDA.bEAAhAAATEAF.EGBHGCCBhABA.QGGDhACALHEGKAEE.ACIFFBBHcGAE.SAHBhAEAfAGFCFEB.WADDhBIA..,1,-16,-23,7
dcQRPYCANHDBeOWETSJGZUVLIMbgfKXaF,DBGGOBAAECEA...JFDHZBCFLBFGMCID.....bGFCfCGAhAAA.XFBEhABAFEAGdGBCcEFHhAAA.RCDF.YCADAIGCBAGHeCAGSHFChACA.UEFD.IHAGhADA,1,-19,-26,7
AJBcSUgHbDEReNZFGTPVXKWfOMYQdICaL,BEGASCCEHBACDGDAeCFGFAEEGDBD..TGGHVFAEKAAAhAAAODDGMHFC.QEGBhACAdBHCaDABAECFJHACgAFEhADA.RFDF.NAAB.......hAHA......hAIA...,2,-29,7,36
QHSYBGLbTXdWOMNPEJcRZUFagIACVfeKD,CDAHVBCAKAGF..HDFEBAAFGFDHLFAG..XCBFODEDMEGBhACAEHFCRFAH.FAHFICHGhAAAAHDCDGIB..SDABhADATADHdDDGPCHB...cAEAhAGAaABG.....hAFA...,1,-11,-23,12
PCfZRAEHcadVMWSgQOUIBJNFLbDTYeXKG,HDDHaBFH.MBBH.SCFEQEFFODGHUDBABHHB.hAAAFAHFDGHDTAAHXFBDhABAKACEGGBHCAEDfFAAhACAAEEBECGGdGAG..WHBA.ICCGhADA.NAIG..YFFFhAFA.,2,-24,-11,13
PEOVNUKHgFDQGTbZJfMXeBaIdScYCALWR,LBFFREDFEFBB.OACFUCAGKDCEFEADDFGCGCFA..ZGCGMHFAhAAABECF.dBAC.SHGChAAACAHHAHDH..VADEhABA..gCGE.bCDD.fAHGhABAaGAH..hACA...,2,-31,-23,8
EXcSTCIFgbBWOZHVYQMdNKaLfUDAPJReG,JEHBeEDHGBFGEHEG..SDBCCAAB.FBBGBDCDZFFCHDFChAAAQACAdHABaCEAUGAEhACADAFCABIDREDF...XEAEhABAIAHG....WAEGOHEE.hACAMFAG.KAEB..hAGA...,2,-28,1,29
OfTIXdJUANFeWcgaYKBGHREQCZbPDLVMS,eGDG..gAACaCBABEBGHBGDEHBGCBEDZFBCDGBFLDFBhAAA.MAFAfFFChAAAIABHdAGH.AEEBNDHEFBDAhADA..cDBFYDHBKCFB.....hADA......hAEA...,1,-12,-24,12
fdNRTVUJBCgMbDEXaPKYHAWSeQcFZIOLG,SDAEeGFGFCCAZBFELFEBGDEBdAFFTBEE..UGBHCBBEMDDBhAAADACA..EBAAaGAHKDBFhAAAAGGCQCGDhABA.IGBD.OACA.fEHEhAGA...hABA...,1,-10,-27,17
SLPYKXZAaVCBeDbdJEcGfRMQgTNIUWOHF,aADDVEGDBGAB..DAFFdGCD..JCFDEAAGGBAHRFFF..MBIHhACAQEBH.TAGBhAAANDBFUAFF.OEEGhADASHDC.YABC.KGADAIHC.hAGACCHAeDDB...hAIA...,2,-31,-10,21
EALZKIeCOJaFDPMfBURcTVGNHXSgWbdQY,ZCBCeEDCJFFFFHAG.DAGC..MCHDBBGHUAADRACC....VFFChAAAHBEH.SEADhABA..WABFdGDCYEBAhADAAHEFKFAA.IHADCDHAaDDG.fADChAFA...hADA...,1,-19,-40,21
PfDcNUbXSBFWEdaAVIKOeTCLRZMQYJgGH,KCGAeFDHLBBBMBDD.QEGCJCGH.HEDFDIFAUBAB.hAAASEADBGHHFADBdGAGhABAABFD.OCABCBHBRFFE.hAAAZFBH....gEBB.fHABhABANIEB..hACA...,1,-10,-37,27
cEUgZbTefVNQGaDPSAKJFMILYHWRdOXBC,KHGEFCDGMABDLDDHHEAARBAE..dGADOEEEBBFD.EHCAZCFG..eGAAhAAA..fEBHhAAAQAGDaAEBDGHBAEID.hABAJACC..IHEC...WFFGhACACHEH......hADA...,2,-33,-13,20
YXTSNfLMUEgOQHaPRbJGIeFVKcBDdWCAZ,XFEHTFGB..SECCLBDAMAABEAAA.OBBBQAFHhAAAaDGD.RFDDbCDEIGAGhABAFBCEKFAABHGHWHAEhADAAIEGZDDE.NAEDfFBB...hAEA......hAFA...,2,-14,-11,3
bdceARJGfTBSDCVILgWaMONXFYEZKHQUP,JBBHGBDDBFBFCDFALGBA..aAHDOABEFBED.ZEAEKADCQFFFhAAA.UCAFhABAdEFFAGCB.TGDEhAAADICEIAHE.MFIHXFGG.EHAEhABA.PDDH..hACA...,2,-45,-11,34
bHGedMaPFQKJABcZXRfDVTgOWLSECNUIY,BABFZFEBRACHDFAC..VEGD..OAAFSFADCDFC.UAEEhAAA..IGHFhAAAHEBFdDEBaGABFBCD.KHDAAGCF.hACAfDAETDGCLEDBNAIG...hADA..YBEGhAEA...,1,-17,-38,21
JQUEADWVdFKMIYcORgBHPaCZGfeSNbTLX,DHBAdAFEFFFCKAAE...MDAB..IGFDOCDBBBAAHBFDCCDBZABDhAAAeDBB..SHBChABANADF.TCGAhAEAXFDB..JHFEECBEAEEA.WAHH.YHFGhBAAcEBH...hAHA...,1,-27,-36,9
gQGLPHJNUEIdbTcaBDWefFRAOCKVMZXYS,KFADVEEAZFDC...SDCEGBBBHEAAUACFEHGG.dGDG.TCGChAAAaBFHDFEA.eDHHhAAAfHAH.AACGCFHAhABAMABB.XGBHYAEC..gDAGhADA...hAIALHEG.,2,-18,1,19
QUCRKNdcgDeJHbOIXTLfGaPEASBWFMYZV,BDBAFEFBMCCEZDEDUGGD..CAFERDBFdBAD.DAGHeDHD.HGCCOAHDhAAA..IACAhAAALHAAaHBCAFCD...hABAYBAHKADB.NEAG.JDDD..XDDBhABAfEHAEGGH.SDAFhACA,2,-37,-21,16
GMEdNOJDKVSRAgIQZFBUbCWcaXLYHefPT,QGEAFDFDBGGGUBFBCBHB....aGAFLEDDHBEHeAAE.hAAATCGEMAEHECBAOCCDhADAKGAD.SEGAhAEAAFAA.IGHF..WBACcEBHhAFAXGBH.fFHEhABA,1,-19,-44,25
CXKWVGbLPZfTeIDMHYSJdEgcNAaFBOQUR,FGAFQEGFCDDB.KDGC.GABELBBAZFCHeBEEDFIDHBFHSFEHhAAAEGFC.NEAA.AEFFBHDAhAAA.OFAAhABAUGGD.XCAGWDBD....bDDBfEGFhACAMADE...hABA...,2,-29,-6,23
SdOZbTUYQBaWeGCVFNJMHXKIPELADgfcR,DEGB..gDBDRECEOCAB.ZBGF.TAABQAGA.BAAGhABAaFEFGGAFCGAH.hACAFGGBMBEDHADFIHEAhADAEDEAAFAHSEGGdGHC....YBCDhAEA...hAAAeCGB.,2,-36,4,40
TKMOgfUcWRbXCDIQJLVYdGAFEPZBaSNHe,EFABBABF.SFBGHCFEKCCBMCEB.OEHHUGGBRCDG.CHCGDFFChAAAIACHLBHDdAAEABEChAEAZADAaAHD..NBCC.TFEBhAFA..fGAEWFCD...hAGA......hAHA...,1,-18,-31,13
WDdGHVRJSXeTZOCaLMUKQcIYPfFbBENAg,DDEHdCGHHACFRCAB.JFECSGAB..TCACCGCELGFChAAAKEHBQFBG.hABAIDEHfACBhAEABAHFEBBEAAFG.gCFHWHEC..XAAGhABAeAFGOHEEaAEC.hACAMCIF.,2,-30,-14,16
cdNLAgGMBVaCWeQZfOEPDUJRXbYSKTIHF,MBBEaDFC..eAGHQDDFZADD.OGDADFGEJDAARFAB..XDAEhAAASGGD.KBBAhAAAICACFGBC.NIEDAICChABABAFA.CHDHEFCGbAFGHCGDdABF....hACA......hADA...,1,-13,-23,10
GODAEgBQeIWFZTXdYPbVMRfCKJcUHLSaN,BECHQEGCeBFFFEGEZFCCdBGG....PGEGMCDFfDAHhAAACBBB.KHACJBAHhAAAHABAaHCC.OCEFhABAACDEEGAH.WAFC..XAGF...hADA......hAEA...,2,-36,-17,19
AQJIeXTCgOMGLUYbFHKNcSVBRDdZEaWPf,QABAJAAE.eFBACGEBMAEELGEC..UBECFHBEKDBEhAAASCHDRAEHDIGCdAHGZECEhAAA..EDEDaDBC..hAIAWEAFACDF..TGGC...OHBAhBDA.....hABA...,1,-19,-32,13
faVHIZBLPMcNFCYOQAgWeGTSRdJKEDbUX,eEECSFFFRFBA.KGHFDADA.UCCC..fGBAaCAF.hAAAIDCABEHAMIAAhABAFBGACFAFQGGHhACAAIDE.GAEFTADCdCFHEFDF.XABHhAAA.ZDFC...LBADhABA,2,-23,-9,14
BYOeTLGHSWcDZfAFagPMXVEQdRINKbCJU,FFGEaBDB.MFFH..EHEAdGCCRBGF.KABE..CCECBEADeAGHLBDHhAAAGCBASEHHhAAADFAEABBD...XEEBhABAIHHHbGBG...YADCOFDDWDFAhAEA...fGAEhAFA,2,-32,-29,3
ScOLBAMCeDPFdUKTQNZWabRHXVEgfYIGJ,eDEADCECdFBDKGAD..QGGEZAFC..aCDEHBCBEDAE.fAFDhAAAGEBDSACBhAAALFEHBACFABADCHCBPHFGhABATBAC.WCFAXEGE..YHAEhABA.IEHFhAEA.,1,-11,-31,20
JOZcYBHTgAdGRVKLPMNCUFXfQDeWSIEba,GAEEVCFD.KGDFLFCGMCID.UGGCFFGH..QEBBhAAADCCDSBABEBCA.aEAHOEAHhABA..ZADDBHBHhACA...........hAAA......hABA...,1,-24,-38,14
GfSbIBgdLHPCNQFTUEAWYReMKcOXVZaDJ,RCFEeECGMDCDKGDD..ODEHZCAGDABF.GBFCSADCBHFALBHHhAAACGAE.FHAETGFHhAAAABEA...WAEAhABAXEAH.aACBbCCF.ICAGhACAHFGD.NIBDEFGG...hAEA...,1,-16,-17,1
RdNSPALGfMZgFDWHbYKTIQUXJcBVeECaO,GBCHMEFBFFBADIBEHAFHKABE...QCBDXEGA.BEGBEGDG.hAAACABEOBHF.dAEChAAASAGEABBH.hADAZDBDWFDHYEADIGGAcEEHaHAE.PDFAhAEA...fHGBhAFA,1,-16,-27,11
SLHFRCcAIfQMYNKgEePXbBdJGVDOWUZaT,QEAAMDFGKCAH.eEED..XEGEbCAC.dGBHGAAFhAAAOABFZFCF.SHAEhABALAFGHFEHCGHCIEHHhADAYEDENDEDgAGHEGHBBAACDGAHaGGH.hAEA......hAFA...,1,0,-13,13
XOCHfDabPQYgcWeNIBTEdMSJZULRKAGVF,GDEBVAED.OAEDHEEBDDHD..aHBAQAAB..hABAYDCFgCCDhADAeCABNEAC.BGHH.TAGEhAAAMFIHSCHBUABFKHFGAGAGCDDCPHBAhAEA.cGFD.EDBDhAGAdFFH..,1,-4,-13,9
VLTSZQbYdNWPMFeHDAKJfBacOgRCXGUIE,KEGABEBEOEBDRBBCGAGC.UFFBEBEELFEFZAED..QGBAhAAAdAGD..PBABhAAAFDDHDABGAGIBaDEECGDA.hAEAXBBF.IGGGSGHHNDDAMFADhABA.....hAIA...,1,-16,-28,12
KNXBbSdGMgREWIOcAfVCZUFYLDQHaJPeT,CBCGZBFDUBGFFAABDIDA..HFAH..JADEeEDG.KADGBFGDdFCAMIEGhAAARCBB..EEDHOCAHhABA.AFHG...hACAfDAELGEGaCEF..PHFGhACA.NHAH.....hADA...,1,-15,-48,33
FeRgKSMXALIGBYaPfNbWVEOJCZTQDdcUH,GBCFBFBDaGHF..NDIG...VCDEEHCAODAAZAFA..TBAAhAAADEECdFDBHDACeEAD.hABAKAAASFFFhACAAIAG.IHDGPEGFfCGHJCHFCADA.hADA...cGAHhAGA.FGGHMACC,2,-13,-12,1
KTfgQYNdVWCacSeMAOHDXFURLZPEGbIJB,HFCHDDCHUBDCLEBCZAGH.GACF.JEHHKFCA..TGAEhAAAQEFHdAGACGGDSCAAhABAMICEACBA.XCFGhACAFAAGEDAFBEHE..fGEChADA.NAIE.WGDA.aFADhADA...,1,8,-44,52
RFeDdKBOJIbETMWCNQcAPHfYLZXgUGSVa,HCDELFDCXDGAUAFCGCBG.SFHHRABDDGBGBGGAOHDChAAAIHAB.EAGAhAAAMAIBCHCA.QACFhABAAEAGfFEDYFBFZEAGaADCFDDA.KDHD.hABA......hAEA...,2,-19,1,20
BDFgPULWXVeHKSAOJEZdaQfYIcNGbTRCM,EBADZEECaHEG..QGEG.IFACNEAEGBAB.RCEGBCHBhAAADGGAFAHHUDBFLADHhAAA.XDGChABAeABEKHBEAIACOFCB.dCCGcGGDCHHF.MGCGhAEAWBEH....hACASBGC.,1,-8,-10,2
IMECTASQPGZNDVbUBgecOYWLFJHaRfdKX,SBHHQGEAZFBBDEIB.UAFDBAFFeCDDOEBGLBBC.hAAAFDGHaHBEdCADKBFAMAIHhAAAEHGGAHAH...PADHhABANEAA...bFEH.....gDFGhACA.cEAHhAEA..,2,-24,-19,5
UZXDPIQMSLdfOBgTFWbcAJCGVHaERYKNe,GGBHHDDCaAGGEAFFKFCHUABGZBDC...DEEFQAAFLFFCOEAHhAAABDADFCHD.bGFAAIAECDBBhAEA.RCFC...YFBFhABAXGGG..IFGFSEBG.hADA......hAEA...,1,-13,-18,5
VgWKOPbXLSHAFYZGJRCUNcQMBITfDdaeE,ZBDHGEGACCBC.UDECQBGABHBA..TFABDIGAdEAE.EHEAVADAhAAA..KEGFOHDGhABA..PFCChAAAbDAELAHDACDFFHAG...RABD.MADC.IABBhAHA...hADAeEHH.,2,-28,-2,26
RESLZQPfYIMcNHdJUCgGVXbAFaOTKBDeW,aCDBOBDABACDDFDF..eFAAEFHF.ZFGDQDCD..fFDHhAAAIDABMBIBhAAANAIEHAEGdACG.CFAFVFEBhABAAAEEFHCAKHAA.SDAHYHAAJCGD.hABA......hADA...,2,-24,-9,15
cSaCDbgARdZfQXeFOEYMNLVKHJGUPWTIB,ZCAFXEBGOHEC..EFFCMGFCLCECKCEEHDDEJABC.GABHhAAAUGAD...TAGDhABABDDDaAFAbFAE.ADGDfFHChAAAFEGE...NIDB......hACA......hAEA...,1,-6,-22,16
ZDgdAIReWSQKVTMBYGOcJEaLPFHfNUXbC,eACHQAGCKBFB.MFBFBCACGEFGOHAEEABGLFFGHFCHNEBB.hAAAUECH..CBDA.DEAFhAAAAADCIEHDSHFChABA.TDGGcBBHJAHH..aCFC...hACA......hAEA...,2,-26,3,29
USTgBHJbOCAacWLEYRXDIMGVfQeNPZdKF,aFDFLCFB.EADCXCBBDIAA.GADFQCCFeFFHZDEAhAAAKCHBSGHHhAAABCHBJCAFCHHFACGD....WABFhADAIGAEMGBANHADFABGTAGB...hAEA..gFGFhAGA..,2,-22,-12,10
QJRKXdYSCeIDNcPabWOUgMEVLGFBHZfAT,QDABKEDDdGHG.SEGFCCDADDCH.....PACEhAAAaAGGOHDEUAFAEDEALBFGhAAAFHGAHECDZDAHADHBTBABhABA..JACG..YHBAIFFHhABA..NAIEWFFDMHBCBBBGhACA.,1,7,-37,44
TgXMERcdaBGAJVDLQHWPYfNOISbeFKCUZ,VGBGDDCHLGFG.HBFE..PDBAfFBEOECESCCEhAAAeBAGFEABCAHETDGChABA.MEEBcGGHhAAABADHGBGEAACFWFADIACH.KFHBhABA......hAEA...,2,-21,-16,5
AVWUSePfagDLHKCXJbFIOBYTGMZENdQRc,VBCGUFBGeAEG..aHEELFEFHEADKEFBXCDBFABB.BABGhAAATGCCMFHHEFEBdCABhACAQAGAADGG.hADASCGG..fGFGhAGADDAE.CAHB...IHHHhAAA.,1,-20,-21,1
COFVcAQYaPbBTEUJRKHMDeZLXGfNWdISg,aAGABAFG.EEAFUBAGKHCC.DAFBZBBE..GDGC..fFHAhAAAdGBHSEBCODEEhABAFEEDAIBEQBGEhACA.bFFFRACFMEAHLDDFNIED...WDBHhADACCFA.....hAAA...,2,-27,-9,18
TDaWCPgdEYQRXSIfGFKNLAUeHbMJZOcBV,UECFeECGMDBEZBEFBBABDIBC...CHAB.dEAG.EABHQGFFhAAA.RCAA.SCGAhAAAGBGGKGCGAGECbADG.JHEAhABA.OGAE.cGGFaACG...WEEEhAEA.....hABA...,2,-33,-11,22
NARTVLMQDgUZSIXFEPGJOYaedfKBcHWCb,TFAAMEBHDAEB.ZFDFSECC.FEFHPHFG.GBBGhAAAOGDC.aCHFdAFFfBCChAAABHCCHDEEWAFEhABACFGFACAG.....RDGBLADHgCGEhABAIHHF.ECAFhACA...,2,-20,-15,5
PWYAEbHReUSDQLXKcdOZICFMVGBagfTNJ,HADBRACEeDGBDHFCLEADKFGEdDBHZFBHFDCDGGCFBFEB...aBAFTBGFhAAA..JBFE.hABA.PFABAFGB.EFDBhACASEEB..cABEIHHChAAAMIEC.....hABA...,1,-16,-25,9
cSCZGMEgVHfXQBdRPJeObDUFTAKIaWLYN,aFFBLAFC...NEGA.CAADZGAAGBACEEBFHADD..XACAhAAABDFHdCAHJFDDeDDBhABADCIHUCFDAIHGKGGCIEHDhACA..YFHHMAIB.fGBChABA.RCCH...hACA...,1,-18,-20,2
FcdGWKEIfLTaAReVPZHSJbYgQMOXBCUND,VDEDZFDDHDCH.SACHJFAB....bGDEgCGChAAA.MCAHOCHHhAAABHFFCCDBDBBCdHAHKFGAIFCFhABATFACAAEGRCAE.eAFAYBEH.XBABhABA...hACA.NIBB..,2,-28,0,28
JTHgXeAZVbEIDUQRdBGYNCfFWSacLOKMP,ZDCEEBBGUFCDdGEGGAEH.CGFA.FFAB.SCEELFABMDIBhAAA..JADEHACBXDFAhAAAeBADABBF.IDGHhABADIGABCAC.fFFAaFCDKHGG.PDAChABA.....hACA...,1,-10,-32,22
BLSDZCJATIGaMWgXePYKcRUFdVOQHbfEN,TBACaCCC..MEGF..XBEHeGAAKABARCGHFEECOAFBHDAGhAAAEEHDBFAELAGHhAAADHBACGHEAICCIECH.hABA.WADFYDAHcGGCdEEA..QAGDhACANIEF...hABA...,1,-9,-17,8
QHCLXTVMaESgJPZUWYBOfGFNdAKcDbReI,DGGDRACCQCDHCHBC.LDHBTCAB.aGABEEFA...SAEEhAAAJHCGUAFEBFFEhAAAOFCEFCAAdACGAHBEKHFAbCEC.hABA...eBFAXDAGMDIFgEBChAHA....hAIA...,2,-22,-15,7
XOKAgdECDWZNLHGcJUeQTFPSRbBMfYVaI,dBECEADEDFDFZBAAHGDA.GEAAUGGAQEEFTFGF.FBADPAHDhAAARCEA..BBHDhAAAMADEVFADXDEEhABAAHEH..CCCG...WFCE..cABAhAFA......hAGA...,1,-1,-28,27
FBeLHbCKTgDYcINfJXVZRPWaMdAUQEOGS,QCFGEEHDGEDABGGCHFBDCACEKBFG.DACFIFFD.JDHDZCDChAAA.RDBDaBADMEABAGAE.SCBEhAAAFHAA.eEDBhABALAFC........hABA......hADA...,1,-18,-22,4
gfSOKQWFdPANGUCTHIMZVXYDJLRabecEB,UEFHCCECHGCAMCEBZDDG....VEAFDBBFJCCFLABE.aGFAeAHFhAAA.EGBBBBCD.hABASEFAKADFFGDDAGIH.hACANBIA...IEAC.....hAAA......hAFA...,2,-34,-26,8
LXfdYSZWgGceRFHAKIQTJBPVNMbEaDCOU,KGAFTDAFBCGA....VFCDMCFHEFGECBGFLFBC.dGGDhAAAZEEHGABHeACCRAFDAEAB.hABAIBAF..hAAAQCAANIEFDCIHXCCBSCDH.hABAWHFG.FDHD..hACA...,2,-32,-5,27
JTbRPScXLFBWHYAZEGKQOMaVfgDCNeUdI,EHCAKEBHMBBH..aEDE..VCDDDAAECHHBUGEEdBGE...JAHDTCCHhADA..RACASGABhAAALGCEBEBAhAEAHFCBABBEQAEAOFFAfGHCNBIA.hAHAbAFBXGFH.hABA...,2,-18,-18,0
IfPTbKOWcMgJFRaNHQZYCLAXVDSUdeGEB,VDEDDECBdAGG.GBACBFAG....ICACPEEE..KDDFOABFhAAA..MACChAAAFHAGRBEGaHEGQEBAhABA.CDHHAAEESGGBEHGC.fCHChABAWHDC....hAIA...,1,-23,-39,16
ZRgSaVXEdceIHAPWBUMQbKONTYCfGFLDJ,BDHFUBDCQCGFOADA..TEEBCAGAFGFDLFCDDIEGZCBGRGBA.hAAA..SBAChAAAaAHDEBAC.dEEEeHFEAGAFMADChABAKEBB...fEHC.gCAAhACAcEGE...hABAIHHDWBGF,2,-18,-15,3
APJaCIWGbgdcFNZLMDEVSYQHOURTKBXef,aCGDCBHFGDDC.dCDBFECGLDHDMGBEEGHD..SABAhAAAHBAEOFFDRGAABGFHeHAGAICC.hABAPDABJCAB..IHHChACAWABE.....cEADDEFDYCDGhAAA...hAEA...,1,-8,-25,17
IGYLMaBHVDFNdRQWUXJgKSbCEZTcPAfOe,OEBFeFFAGDABLCDAMHDGBHFGHAFADAABdBCDRADC.QDFGhAAA.XFAChABAJBHFSEHDCCADEHAC.TCADhABAAIHE...IHHA.aGAFNICH.hACAUFEF...KEEEhACA.bFCD.,2,-24,12,36
DYaWBFPfATKUMZgSHGdOcEIQLNVCeRJbX,TAEGKECFMCAH.ZABASCBC.dCGEEEEHQFDGhAAALHEGCAHHeEADRBFG.JFHDDDEAhAAAaHAEBFHGFACGAECE..hABA.HCDE..OEADIAHE..hAGA...bFFBYHAGhACA.,1,13,-40,53
XNQeVdHLPbDcTYUFBJaEZWGSfOAMgRCKI,RCEACHGCKABE..IEAD..QEFFVFGBHFBCLAHFhAAADICG.TDCBUADAFABBhAAABEAHJAHHEGBG.GBCHhAEASEEGAAGDMEIBXGAGdGDA.PCCBhAGA....hAIA...,2,-14,-13,1
XdBAJEUGeDOQcLKCaMfTWHRVNZYPbgSIF,UGBAeFCDQABFLEFAKDBCMAEA..TCFARDEGZAFG..PCAFhAAASAEE.hACAFABEdHGDAFCC.EEHFDGHDCFFDWCDDhBAAHBCG..NBAE.gGDBIHEDBAHGhAAA.....hBEA...,2,-17,-4,13
PODKABcZEgdIFJCeQYNTabfSGMLHRVUXW,BGHEEDACdGAGFBFH..JBCECDCC....eBHBQCGG.TDDBhAAAfFFA.hABAMFEHLFCARBAC.hAAAXGGCPHFEKGBBAHFH.ZEAA..YHBChACAaAGASADBhABA...,2,-32,-20,12
HMGYaFUPIOSNXfbVDgKdBLAecWCTQZJRE,eEEBCBEFZBGD.RAADHAEHGFABFHGCUGFF..IEHFOBDH.SAHBhAAA.XGDDhACAfBAH.DDIDhAAAKDFBdDAFBECHAEFF.cCBDWHAA.JGAAEBFFaDAHhADA....NABH..hAEA...,1,-10,-23,13
CEMHWUNTPFASYQDbXaReVLcBZIdKOJfGg,SCDHQEADDBIB..aGEAeAEBLDCDBGEDdBGEOHAAhAAAJEFFGBAFCBADMIFAUDFBhABATGAEFAEG.AEIBXAGDhACA.........hAAA......hABA...,1,-15,-30,15
bOdAVefYFNScPDGgWRCTZUJIEMaHQXKBL,VBFGeDBDFCCD..SACHDGEFGACFRDEDZEACUGFG..EHAGMFFChAAAHBAF.KHFABHABhABAOEHDABBH..NCAC..hAAA....PBGDCHEF.....hABA......hACA...,1,-18,-28,10
PRLJbQCcTKBUNMHEXZFagdGVOWYefADIS,DDABSHBCRBFELCCHQCEH.CFED.TFDHBACFMAHHhAAAEGACZAAHFDCB..dHFDOFHDhABAeACCAEIBJHECKEECHADAhAFAaGGA...........hACA......hAGA...,2,-20,-18,2
ZUFKeNfBXEYMgLHPDdAWQVbOIaGcCRSJT,QCACODAGGCFGCBHC.REBF...SDGEJBAAZAFE.FFCGeFHDhAAABADHEACGMEEGLEDHhABADFFCAAAD..bGCAIHAAhAEA.aFFHTGGGNCIA.XAFFhABA...gCCHhACA,2,-21,-12,9
RHfGZMOXTgWcFNSEJUDPCLYIKVQAdaeBb,aACAeCBBBFBF.HAGFfEFAZCCA.MHCAXBAF..hAAATGGD.cAFGhAAANDICEFFADHECLDDHhABAIAFCKCGEAAEERFCF.OCAH.FABESECEhABA....hAIA...,2,-21,-6,15
ITEcJFPbRULAeGYWCHQODMdZXVfKaSgBN,eFFDGBBFCCHD.QDEFDFEH.MHAGdBEAZDBHXGGFKAAD.aAGChAAASEAFBFDHIAEFhABAEBCG.FHECRDFGAAHCHDAEhACA.fCGDTGAC....cGGFhABA....hACA...,2,-33,8,41
IBOULJEdCQNMFDTaeZPcGgVHRKYbfSAXW,XCCDBABDOBFCLABGdDED..QFGFFAFGaGFB.ZDBHGCGChAAAHBCHKFDE..hAAAfCAAACAG.hACAICFHJEADCAEADIAE.PHDG..cEDDhACA....hADA...,2,-33,-16,17
AJNHSDWaOIbPeGdZEfKTRcMFCYBXQgUVL,JFCGHGFA.DAADOBAF..IHAFeFABGBFCZCFDKCCATFGBhAAARDADFCHDBBBB.QECChABAgADBLADAhACANIDD..WCHB.aDCA...hAEA......hAFA...,1,-15,-17,2
NMDHCYTVXZaBUEOFebRgWPJdAfGcLKSIQ,GDGGLHBAKCFDSDEHQCCEDFAFHAAE.CFAA.VEBDaGEEBGBAhAAAOADD.FABAeAHDhACAREGD...gDAEhADAJAAHAAIF.IAFBMIFE.XGCHhAEAECCD.....hAFA...,1,2,-23,25
QMVODZeTGHcXSdPYaCgBLWAIFEKUfbNRJ,EBGAKCGGUGFH..NEFC.QECF..MBBCDHAAeCBAhAAAGCAGHAECSGDFhAAAdEACaACGBBAGAAGDICCGhABAFEGE.fGGB.bCFE...hABA......hAFA...,1,-20,-22,2
fXNTYGPJeSEHgFVbQLRAMZWOCcBdIaKDU,MBEBODACBCAHdAHAKFBCDHCA...UABC..fBFEhAAA..XFGBhAAATEGFPDCDSFEFhAEAEBGEFEAHQGAHAABACGEBIHAHNDDD..GADBhAGAeACFgGGAhAEA.,2,-31,-19,12
LVRKPHUAMdXaOTBISGfYZJWFQgCcNEDeb,dDAHXFFAaAAH.BBBCGBFAZEBF.FFCGCDDB...EBDBDBHBLHBEhABARAEF.HFGHACCGMAABhABA..IAHBhACASGAB..fFAAWFEF...hACA......hADA...,1,-10,-45,35
KTEMXQCdaONUcDGJFeYSBHPWZRLbgfAIV,VFABTGGF..ECEHQGAB.CCAAdAEBOCBF.UAEHhAAAGDEDeHEABECDPDGBhABAWACHLDHBhACA.fHCFIAADXBFEaBCFDEFF.hADAYFDB..hACA...,1,-2,-32,30
fLKSNTZgGFVIEXQJWOCUAYcRMHbDPdBea,RGDAHAGFDIAABEBAaBDALABB.KCEDSBGGZFEFFDHD.EADBJGBGhAAA...CGHFAAIFMEEChAAA.dGAHeEAC..hADANDIA..GCBH.IBAB.XGGDhABA.WAEEhACAODFF.,2,-25,-21,4
eWgUJKGcISYBCDEaZHdbQATPLNOXMFfVR,TCBBLCBB.ODEBMFDH.FAGBRFECeFABUGDD.GAEG.SAAGhABACDADEHGAZAAEHCGDhAAAdAHCAIHGXACBhAGA.fEHG..gBDChABA.cFAHBEDBDIEChBEAaFFF..,1,7,-25,32
gLKJQRNObACPaUZXHIEMYWBdeVScFDTGf,aGHBXEGCHADAEFCA..MDAGBDHCeFCGSCABDIDEGAEGhAAALDDGKGBBQAGAhABANICDAFGA.CACCPEAHhAEAZBFGWFAHdBBH.FGHHfFFG.JAAEhAAA......hAFA...,2,-15,3,18
XQSYfaAWPOEcTZCULIgRbNMJVBGdKFDeH,OGFGEEGGZECGLCAERAAD..MAFEJFADBCHGKCGHDGCEHAEHQDDEhAAASEACaACC.hADAAICA....cGDChAAACHBFIEAF.NICH.dGHA.....hAEAeABC.fGFDhABA.,2,-27,-19,8
eEMRcIPbCAUTKZWBgGNDLOaYJfSFVdHQX,KAFFZFCHBGEHGGDBDFBHLDEC.aCBDJADB.FABDdGCC.QAGChAAA.eBBEhABAREFEICHDCADB.AHHF.hAAAWFEE..OAFHYCAD..fDAChABA.SAGChADA,1,-25,-48,23
RYIdXPNaLAZDUVfFQOCMHSebcKWBJTgEG,ZGAGUFCCFFEGQDAF..OAEGMAFDHDECSCCHhAAAbAGB.KABABHFB.TBAAhAAAEBADGGEH.hABAICGDdGBCNEICADDGDIDECDFDeDAD....hABA......hADA...,2,-28,-1,27
dLWUEPZFOKcSDTRJMXQfNaBYIHegCVbGA,LACGECACZGCC.OCCASEFADIGAREAF.MDEA..QEFFhAAAaGAHBEBEHAFCCGHGVGDAhABAAFEBUGGB.FAABKHBGhADA...cCGB....XDDChACA.fEAEhADA.,1,-17,-22,5
gYPNJXaMdFeOLHBfAWIVcDRKUESTCbZGQ,VFBHDCBFKCFE..EFHDCEHB..GACC..gABE.hAAA.PHDGJDDGXADFhAAAdAFDeEGBLFFFhAGABFDBAGID.cBFASGAF....hABA......hACA...,1,-18,-41,23
WMJSeDXRUZYOHCTFKdgNfBaLPAcEbQVIG,ECCEVEABGFAH.MEBGeABF.DDFGUEFDOHFGCABC..TAFEhAAAKEDHdAEF..NIBH.aCCGhAAALAHBAIAG.QADAhADAIEHFSHCGXGGG.YAHHhABA.FFFCBCBGhBAA..,1,3,-33,36
JPCaAFgRZEIdQBDKTGbWOLNUMXVScYefH,FCGCZFBGdEBHDAGAGDDCOGFALHFA.UCEDVDAH.SCBEhAAAeCAEHABGCHBCAHIFEAEGhAAA.BCHBKFGB..TADDhABANIAB..MFFG..cGFCfAGDhABA....hACA...,2,-28,-7,21
gdJGPTLHBVKfEIUAQZceDYbRNOMFCXWaS,ZEBCeDABDDAARFCG..MIEAFHGE..CGGC...aABHdHABGBDBLCGFhAAABGAGKAFCECHH.IEEBhAAAAACE..QBCEhABAbGFA.ODHFSACG.JAFAhADA......hAEA...,2,-39,-13,26
DNaLbdSHWMQCUOPcVJKFgeTEfBYAGXRIZ,GAEFRCECZFFCDICEaEFE.LDFCdAEGHBACMDAEUDBF..OBAGhAAA.VEAGKAGCeHFEhAAATGEHBEGH.AADD.IHAHhABASGBACHHD..cFCE..hACA......hADA...,1,-11,-26,15
PRAVcYDSOdTCBaeKGQgXLMJNHZbIFUfWE,VCFDDHACdHEB.BFCCKHGAGCCA..XABGMIAAHADDZCAAFEABhAAAUFAA.EBAFAFEC.SFFAhAAAOCEGCEGE..hABA.aAGGeFGB........hACA......hADA...,1,-5,-43,38
YBJKgfUPCdSQecTMLRFOVZDNAEWaXIHGb,aAADHFEFGDABBCFBJBBGKAHH...UFABdADHQGED.hAAAeAGDMEIDFEGCOECGhABADHAEAEFB.XDAFhACA.IEGHYFDDPAEACCCB..SGGEhAAA..hACA...,1,-21,-25,4
WUgVRDGJIXOTNdFYZPBSHabEfLAMKQceC,QGEGCBFAUECF.RGBCDAEFGAAC..JBAFXFFG.ODHDhAAAdBFFFDDF.ZDFEBHAAhACASGADaCHBEDEGAAGChADA..MDCFKGDF.cAAAgADC.hACAIHHC..hAIA...,1,-23,-28,5
fWZcdgQMFRTLCeaONJKXEIYBUGSHAPDVb,DCEAVGBE....bDGDZDCG.dCAB.MAHDREDBLAAC.aHAChAEANBAH.KCBB..IEGFhAAABHHCSEBDhAFA.ADDC.fGGCWCHB.QBEDhABACAGC.OEABhACA...,1,-29,-32,3
dNXDfGeAgVbZBFcPOYIQUKaTSRJWHLCEM,VCCBBGGBFBBD..OEHHQDFD.UADEaCGARDADHGBCCFFA.hAAAEAFAdHBF.DAGAfCGDhAAAACAFZABE.PDDDhABAKGEF...SGFDWAFG.MCAHhACA.NEIC.....hAIA...,2,-28,-18,10
VDUENKIROcQSAFMeTZPbWfGgYaCHXLBJd,FFGFMFFEZAEE....bBEHGDBE.aDEGCAHCLADHdHDH.hAAADDBHNABG.KGCG.IGAEhAAAOFAH..SEHBhACATCGH.fFEAgGGA.XABChACABACH...hAEA...,2,-32,-22,10
dIDBgJSQOeCYVfWTXLKAPNHEGFcRbZMUa,HADBFDFARDCDZGFAUDGB.aAADDBGG..BGHG..JCAGOFAF.hAAACCHF.VFAH..TFDBhAAAKAEE.AAHDPDAGhACAEEHH......cGCE..hABA.MBBCIHFFhADA...,2,-35,-34,1
ZXcbAPSVFNIHCUEMDdYGfJgQaKTLBROeW,SCEAFEECHAAFCGCD.MABHdGGCGAEB..gGGFhAAAQDGFKDADBFCEeHCCZDAGhAAAXCCHAHAE.PFEAhACANIAH.IGBDDADEfCDBaAHFRACGODFEhAEA....hAFA...,1,-9,-11,2
cALUTNfBCJaHVRGePZYbgXKDdOIESWFMQ,LDCCUCBF.TEGABDHDaGDH.REDD.eGCGZAEC...gAAFhAAAKABADIFA.IBFChADAEGGC.FGHDQCEFhAAAACIFCHAHHECC.VFAFYAHD.dEAGOFFGhABASADHMAFC.hADA...,1,4,-22,26
dISLCQMWNeEXDHPUcJafbZTGFgRKVBAOY,ODAHdFCFLBFC.MBACNABG..eFDCDDGEHCCCUCCH.aHEEZCFEhAAAFGAFKGAG.BHFGAACGSGFEhAAACGGC..hABAQACFEEHB.......hAEA......hAFA...,2,-31,-24,7
MOPBAcFZRQDdXaKYNEIJULHWGSfVTeCbg,FFCFZAFFQEDBDDEC.dDBGKGGD.EAEGIHAGLBAAGGEBhAAA..SDABhAAAfBADTEGBhABACHCFMADDBFEHAEID.cGAFaEAH...NAIG..hABA......hACA...,2,-33,-22,11
ZWBJfcIaVMdAYKEDHRQSCFXeNUGTOPLbg,KAHHEAGFDBBHRABC..QDGECGAA.FFCCXEDH.eDHDhAAANCDH.GACA.TGGChABAOEEFLFCFhACAgGGBBAFCJCADcEABaFBH.MBIHAGADSDDChAAA..hABA...,2,-33,-8,25
CcJZdTIHafOBDNPeVAbYGQUWKgFMXLESR,GCACQAGCKCCAFDEDMBBCLAGB.RADE.JGEEZFGDdEGBHECFhAAAOFBHBGEHDGDD.eDDChAAAAFAF.UDAD..hABAXABBCHHE........hAFA......hAIA...,1,-18,-24,6
WZEGXfHIdTMVcFAOYeBNUQPKbaDCRgLJS,eECCUFFAQCCAKAACDGBA.RDAH.LEGH.JAFBSBHHhAAAZADB.EHCCfCBAhADAdABHTAEDMIEChAHAFHAGAAGABCHGNIED.aHBCCFDD....gCFFhACA....hAEA...,2,-28,-10,18
AZNMIVQOKDUFCPBcWHgbfEXeYaGTJSRLd,ZEDEMFBCQCECKAFC.DAAEFCCDBBHGHFEE....gDAGhADAEABDeAHFaCADJFGDLHAChAEAAHIF.IAFDhAHAUDGBCADAcGCHfCCG...hAAA......hACA...,1,-22,-28,6
DUCYLPVEbAOHGFdWIXcQgTSaBeRfNZKJM,HBCAFHACdACEXEGC.QEDCSEDHeEAERAGDZFFDKAADMDIHhAAADIBECCHF.LHEEhABAEBEBAAFGGBAEIFAHhACA..gGDABAHHJADA.....hAGA......hAHA...,1,-4,-16,12
QJgLcbZfXVaSNYGTDBRKIUWOHPCEdeMAF,QFCGJFDHLCHBZBCF...VEFBSDCEGBACDCECBHAGhAAARBGFUGAAOBDACAEE.ECABhABA.dGFHAAAG...FAGAhACA...gDEH.fFAEhADANIEF.KBBA..hAEA...,1,-15,-23,8
KJbDMECUSVcWNeYFOGXRTAfPBQLIaZgdH,BBFFQBCGLDFHaFED.dFHAHDFAKEEDDDCFCFCGUAFH..SABAhAAA..WCAFhAAAeEBDFGGCOBHDhABARGAEAIGEIEDHJHEC.MABCECAF..NEDE..XAGBhACA.fCCBhAEA,1,-19,-24,5
VCNWGeSIUHJDZTAadFQYXROcBKgbLEPfM,dBAAQEEERCFBBGAF.KDABLHDA..fCDECFHH.hAAANCIC.eDDB.IEBEhABAHGBEDBGHZAFAAHFBFADGhAAAOACBgBAC.EECBMAEDWAGBSHAAhADA..hAGA...,2,-30,-11,19
CNZTKdHSGVOPAXgcbEDQYafBIReFMLWJU,XFEC..gDADEAFB.DCDCaDFABACAeCBFFBGCMIBChAAAJFHB.CFCEZBCD.KGAEhABASDDEOFHFAHFB.hACAbGAGfAHCLFFHNEEG...TDGBhAAA.dABG...hADA...,2,-18,-18,0
YReTNSMCcWOZGKUAdQbEfJgXaBDLHPIVF,QEBDEFAE.JDDAaFEH.LCBAHABEVFFFRFFGeAEE.SCFHhAAACDHDOAFGKHCChAAAAHAGdFCA...fABEhACABEACIBHD.FBAHNIABMIFCWCDE.hABA......hADA...,2,-18,-8,10
ZSfcgFKXQOECPGbdAaNVITBHWYJRMDLeU,VEEEBABBHDCF.JFAFMFIHLFHHUDADZBBG..SCGHhAAA..fBFEhAAAFFGHQAEHhADACACAPHDEdEEEADIH..IDDDWBBDDICGgGAChABA.OAGFhACA..,1,-21,-25,4
QWYUBMLTbZEgGJORPecHaNASfVIdXKDCF,SGDHVBAE.dCBDDEIDFHAGQEFD.UEACMHFALADHhAAAZAGHECECgEBEhAAAOBHHRFCH.PEEEhABAeAFDaGGH.ABIHIHACKABGCADEBAFG..hAIA......hBAA...,2,-20,-7,13
TFMZeKaIgWHJVdGPCfScQLbUBDAYRENXO,EDGEOGCEFAAE.ZAADKFBE..aAGA....IADBHEEAdCFDGFDFhAAAfFAHQGADhAFAUGGEDDCGADEFNIDBMCCEhAGAeAEG...gAGA...hAAA......hADA...,1,-15,-21,6
bCefBKQOUMLdGDAPHIRgEFXYcJZWSVNaT,HDDEREDCFEAC.XBAF..JCDGSADG.aAGHbAGDCFGHBCDChAAAKBBA.OHBChABAMICGLADEdBHEAFCDIHHGhACAEHFE.ZGDC.WFAFTFGF.fAAFhAAA...hAEA...,1,-11,-29,18
SaTXeYcgEULNVDQJFCPfIGbMABHZKRWdO,BAFCZDCBRAFHdGECOFEC..SBBCaCBD..eEAD..hAAA.gFCDhABALEFADAIHJDDAFAHBCADBIHHAhAAAMBBEAICA.KFACWCHHXCAE.EHAE.hACA......hADA...,2,-32,-27,5
gUMEcGBAVCNQHfOReKXPaWJIFdSTLZDbY,CBABQFGEHGBARCDF.eFBBKGGG...aDCGJDABFGEH..dDGGLACAhAAADACA...gAGEhABAMFFDGADHhAAAAIACVCFFOAHDXFCFICCA...hADA.SBBGhAEA...,2,-23,-13,10
eCYKgZORAHbEUWaFdVTIDcGNLMXPfJBSQ,ECGHaEHH.dACG..VADEDICCGFBB.LAABPDCFBGFBhAAAeFHBCEABKABC.ZGAAAHADHCDFhAEAUCGFFEEB..IAFBhAHAMBBH.XFFH.SBHBhAIA....hBAA...,1,-14,-24,10
ecLYTVRgWKfPaCUNdAEHQJMBZIbDOGFXS,ECFFQGFGBHHBZABHDHAGGDAAFEAH..SBBGLFGDTAEChAAARDDHKBDE..aHDGNIBDHEDFhADA..ICFFhAAAOAHB.eFFE.cDAA.gCGHhABA...hAEA...,1,-13,-16,3
VLQSJNFKYZBCfMeAbcOWEXIPTgRdaUHDG,OECHXCAD..TBBGdGHEHBFH.VFAAQGDH.hAAASEFFFDEBKADFBHFAhABACAFGfHGBhAAAMAFAADHG.WBAFIFFHPAHHaBBFDGAD.GBDEhABA.NDBG.eHBA.hACA...,2,-18,-6,12
YNEfBKMLcJZTGaPdCVFDISRUeHQOWXAbg,...bEADgDGC.EGGDKCBGMAGHJEECZAEEGDBBdAAACHEHFFAGhAAA.SFDHhABAUGGEeCFGOBBA.AHAANIABhACABFDB..LAEH..aADGDFFFhADA......hAHA...,1,-3,-30,27
QaRJLeXUVMFHTSPGKWcYbCOAdZfDNIgEB,dFDGDEFC...IBBHEAEGBFCBRBEB.LBABeFHD.UCCCMCIBFHAGhAAASAGB.hABAKADC..cFFEhACAbCAACGFEAFFAZAGF..NIAD.aFDD......hADA......hAIA...,1,-19,-32,13
SeXJLabOMNPBWQKCATRZGcDUFgdYHIVEf,TGAARBCBZFCADBAC..UABDdHGHHBEG..EHEAeHACLECAhAAAaFFA.bCDA..NCAE.BAFEhACA.KEGGCAHFAAAGFEAB.hACAIHHDSDFA......hADA......hAEA...,1,-17,-25,8
NVMCHeQTKIBPfJSFLGWAEaYDbRZcdXUgO,EHDEaDFH.DCGFZFCA.dBBBUBBE..OAHHMFGBHECGeEHFQAEEhAAAKFABBBED.JCDBLFHDhAAAAIHC.RAFG..hABAXDACNIBFCEAB........hABA......hACA...,2,-23,-20,3
dEZVANKTGeMLcgDIOCQPWSXaUBfRHJFbY,TEFGMEGDLFCH.DBFFIHBC.QBCBhAAASHFGXFAGaBBGBFAChAAAfFEEHBGDFCAHdDCBhABAZCFCADEDNEICKHAEeDAE.OACG.CHHCWBFEhABA.....hACA...,1,-1,-19,18
ADRMXeFKGScWJaYHTZgbPOBfEUVILCQdN,MFBAeDBDKGECGDDF..SDDFJGCAHACC.ZAGH..gBAGhAAAPABGBHGGEHAC.hABAUCEAVFGBCAADQGBFhAFAADDGDIEAFAGF..WAHHaEHF.....hAIA......hBEA...,1,0,-24,24
fQCJILZdPKGDabMYHUFBSeRVNTOgAEXWc,XCFD..WCAGQAEC.CBCHLHBCdCFCPDHHhAAADGGFMGDGUDAHBEDDhABASEEGVFAD.NAICOAAGhAGAAEAGEHCC.JFHBKBCCaFDC..bGFE.FAFAhACA......hADA...,1,-7,-21,14
WRgcMLOCQeaVDTdbPEXUAHIGNFSJYfBKZ,HABDGAEHFEFBSDGEJEAD.BFFDKHCEZDGDRBBHMIACLAEHhAAAOAAGQECEhABA..eCFDDIEE.dGHAhAEA.bFAGEBDFAHEDIHFFfGHA..WDDBhAFACDACaCGG....hADA...,2,-18,-4,14
SAUBbIXQfVgeWPGKDYZEdNcHRMCTFaJOL,BGCBXCEBQGAC..fEGGeCEHGBBADGIHZAAAhABAdHFHNDIGHFBH.RGDAMAIFhACACAABFFFFOADFSCCDhADAAEHB.IAGFVAFE.WEAFKDAD...hACA......hADA...,2,-9,-3,6
ZadRCLUTVEbYIGABgHcMSDWONJXfKFQPe,HBFCSGBGDCBEOHAC..NIDB.XECBFDFG..PCBGhAAAeEFDaDAB.CGEGLABGhAAATEBDEABEIFBAhACAAGGBBAFGMEHD.JEEHKCDGdAHE...hADA......hAFA...,2,-20,-16,4
aKITZUHXENDQWYGVROPgbcCAMJBFSLefd,JBFCSGCBLCEHeBEH..dEGEKFGHZCBHUDBEEGDD.DCCGQGADhAAAGAGERFEDOEAHhAAA..PCABhABA.gGFGCBAGMBBG.BDDD.aABE.hABA......hACA...,1,-11,-21,10
YOCRPSJHKFTDNBZcMQgLdUGAEeVbWIafX,EHBGVDEB....bEFBaDBF...XAFGCCDEREBG..JAAAKGHBhAAAFFHFDIBEBDAGZABGMHAChABAQAFAdCGHADADeEDDhACA..fCCGPHEC.SHDEhADA.NAIC...hAEA...,2,-28,-11,17
DfdACSQcGgVFbLXWTNBMUKEJHYIZPaReO,CCBEQAGHGADHFFEBLDBD.TCEEBHFFMIBE.KAADhABAEECAHDFD.ZECDaHGEhAAAOBHFdACBcFFDhABAVDAH.WGAG.NIAB........hACA......hADA...,2,-19,-6,13
PQEZbcIOTGSdMNCAefWBUgFDXYVJaHLRK,eFGFBCGGUEEHDBFA....VBCDaACGHFAELEBHKGHHQBAGhAAAZFED..IABGhAAATDBHdAHCNBIAAEFA.hADA..gAECFEAH.JDHDEFDD..hAEA......hAFA...,2,-24,-12,12
UcKLFPbDdVWZgMCHIAYTfXeSRJQOaBGEN,TABCXEDC.RABD.JDDF..QBGABAHCEEBH.UGGBLDGFhAAAFAEHDEGEdCHAZDAFMHFEhABACBADAGFF.eDAF.aGCCNIAF.hAAAKADC...PCDA....WGBAhABA.....hAGA...,1,-17,-18,1
KQCNgPXGeJUVbEWdOAZFRDISMaLfcTBYH,FAFFDIGGMFDBLDBG...TFECBCFAKAFCCBCA...NEAG.XAAChABAGDCDUABAhAAAEHGGdDGEZFFERFCB..IHBEhACASEBD.aBDAfAHG.hAEAYDAF..hADA...,1,-25,-29,4
XRbNOQGMVYPWSAaIFETKdCZJLcHUegBDf,aBCAECGHdEDBZEGF.LABGUBGB.BFAFDFAC.RFDH...ODACMECH.hAAA.VGFG..WHDGhAAAICCE.KHAAhACACEEBHFDAeBEA.fHAH.NABD..hADA....YCCAhAGAADID,2,-42,-20,22
USKbDRHcYMJGLBTWfZXOdPINVeACEQFag,QAGFFAEDUDGF.KHDADGCEHCAH.MEFAJCBA.GACCLHAChAAABHHH.TFCFZFFAdAGGhABAIGFA.eFFEhAAACACAEHFGaCFC.SBACREAC.cFAChABAfDEC..hACA...,1,10,-33,43
WePScOZYIDdMUgbNKGaJBERXVHTQFLfCA,eADASBEFZDAEDFHFMFAH..UGBH..gFDEhAAA.KBCHJFDABCHHRCFFHAAFhAAATGGBFAGEfCDDhACAABHDcABB.OHECIEHH.dCFGNCIE.hADAaGBD.EEAE...hAEA...,2,-18,-12,6
ILYVORKeCUHdWANcfQGEPSXbFMgTDBZaJ,...NGBF.QAFGGDCB.EDCBSAFBbAAB.MDAHDEBFBGEChADAaBBBLHEEhAAAOEFEKCCECHBDdCFDAHIFcCFDhAEAPFFAFACA..gGGF.JHAAhAHAICCA.YAHHhABA,2,-26,-3,23
SLVbcBCDQPRJKEAGTOYMdeFaNHUXWIZfg,TFGGOGFCdBED.FEDDaDGB.HFCBUAADXEAEZDAB.SCCEhAAALFFC.cABBhABACHDCDCIH...RAEEKEEBhAEAABHBMADG..NIEDIGAB..fDEBhABA..hAHA...,1,4,-40,44
TXeZSUPIMKDRJYCfQaHdLgbEFAGBVONWc,GDCCBADAOAAG..NAAB...TGFCeBEHSEHBhAFAUGBCMBHB.DCCA.RAGBCHGEaCCFhAFAHFEDdBFALECAhAGAEGADABCE....WBBDXEGE..hAHA......hAIA...,1,-11,-28,17
GYACEJUXcNgVDBHSOdRWfFQaKeZPTbMIL,CBFBJBDFUDGD....XGDF..gCDADEAHBHBDSABBhAAAODAHdABCREBHhAAAFBFHKHFEZEBF.TGFDhADA...MFFGLHAAADIDEAHB...hAEA......hAFA...,2,-34,-33,1
CaHTNfLFbWPMRBQGZAOJIVdUXYSeEcDgK,ODAAJCGB.dHEFUFAF..SAEEeFEFEADA.DCGC.CFFBHBEFhAAATCDHLBAAhABA.FHAAPBACBEGBGECGhACAAHGDIFHG...XDABhAAA......hABA...,1,-13,-37,24
MVKCQSLFaGTEZXcDNJUYHIRWbePfAOdgB,OAAAdCFGMIDAKGEB..QBBAFDDFGCFGEAFCZEAD..DAEDJAEChAHAHEDA.RBGFeFAFhAAAAHHABBCHSEHHhABALFCDaDHFcDAF...YHFC.hAIA......hBAA...,2,-29,5,34
QMSgNbdRJCVceULEfPFYDBIKZTaXGWOAH,MACFSGHB..NECD.RDDDCADB..VFFAUDGH.LBAGhAAA.EFBGFBADBAGCICGHhAAAKHDA.aAFEGAEAhABAAAEFHFAF.QFCF....hABA......hADA...,2,-27,-23,4
eGRZLWCKJaBYdOVcbfTFAEMgHPUXSQIDN,EGEGMCGDHACEUGAASDEA.DFAAeBAB.ZFGDLEHFhAAAKDCBJFDBBCHBdCAFOFDHhABA.cGACTADFhAAAAFFCXBGE.NAEH...WAFECCEH.hACAaEEF.....hBAA...,1,-8,-31,23
GScNfXQDaBLKEdPeWRMICVgbHYZFJTOAU,SCBE..cDFGXFFDDACALEBFEDFF.dCDAhAAAWBECMBAC.CFDH.bDBDhAAAHFGHFABG.OHCChABAADEGNEIE.fAGABHCHKHAC......hAFA......hAGA...,1,-19,-26,7
DPabfCUBYcgXZHJWFTReQAIVNKGdSLEMO,VCAFKGGFGDCF.LFAFMIAGDGGAaGCH..CBHBBGBE..hAAAgCFEZACFHAFFJEEGhABAFABDeADGAFAB.IBHEhAAASDHHPEHDfECF.hABA......hAFAYHDCWFFF,2,-25,-10,15
XFYeZaEdcBQUGHAJOTDgCSfKMbRNVIWPL,OCAGTDFG.DDDBCBBF...KADGRFGD....IBGCLHDGFGAHhAAAZFADdHDBBCGAGEBHhABAAFEESEGBMADFNAEA.hACA..PAFG.XCEFaAFB.EAAEhACA......hADA...,2,-39,-11,28
BGCHJdfOTRPYVeWXNZSUMgDcAIaFQEKLb,FGGHEECHKCEHBBAA.HGCGdHAF..OEEERBED..VDBEeBDC.XAAFhADASBGEMAFEhAEADADBAGHF.QGAEhAAA.LFFCCDBBfHDD.TBGGhBAA.WGDENAED..hBCA...,1,-14,-32,18
aHdGRWEBOceTFCDPYIAZfKLQUVgbJNMSX,KCGGUEFE..VDBFJFCH...MCAGaDABHABBdFEA.GBEBRADABHBDhAAAeFHHFGGC..CAHD.DAGEhAAA...IDDDhABAABBA.fFACLDAFgEGEhABAbFDF.SDDEhACA..,2,-21,-19,2
aCdNDBUFSVgIceZMHLQWOfKGPAXTYRbEJ,XGCGRBEBEHCE..CAFE.dBGBBAADUEDEFCCC..SFAFhAAA.VBCCIHFAhABAZFFFMEIFLEAH.hABAQEGEWACEKDFCAFHH......hAGA.YBBFaEEHDACE.hAHA.cAGE.,1,-9,-32,23
TFHBGaDPgKMCOUJYVedNfRLIAXESWcZQb,EFAASEBEZDFA.QCDAFBHDBDBDDACFKADC..CHCE.UGFFJFHF.hAAA..eHAEdGAGfGEBhABALADBACGF.XABDhAGA.WAFAcAFBHCFH..aAADhAAAMIEC..OEEBhAFA..,2,-24,-21,3
cJUfdgIBOZeLKTbEXHRPADCaQFGSVNWYM,DFDGCGHFFFDGGGDB..SGAGVACC....NABGMAABhACAJCAFdCFF..BBFAOABDhAAAeCGHKHEGECCDHDEGhABAAEIHaGAC....YAFC.cDCGhADAfFAB..hAFA...,2,-30,-30,0
CfMcOVGKWTgDZRdabHFEAQIeUJYSNXLPB,QDCCUEGE.SHEEXDDGBCBEMFBF.OHBEKBAGTAGEhAAADBHHZAFB.dBACaEGEhABAHEBBAGAHeBED.NGEFCADFhACAfAEG..cGCHWFFF..hAFA......hAGA...,1,-16,-25,9
FKAXMCLNaTWYDEgPcBGUVIZdeHbSfJRQO,CDHFaBHH....TBCHDEGFECAE....PEBHBAAAUFDFhAAAZFFAdAEFHADE.SHAEhACAJAABOHBCAIGAMDAHhADALEDF..YEHHcAGEIHFChAAAfDCF...hACAFCFB..,2,-32,-20,12
OAWecZTVIRDaCMXYKPHNgQBfFULGdbJES,eAAHTCCDRGCC..DFIDMGEG..KGABHAEBQBDGFEADLAHBhAAAGAGAdFHE.ECAHAGGGZABBhAAAIHEBXEAChAEAPABCBDFC.fEEGbGAEOEFG..hABA......hAEA...,2,-13,-2,11
IRUQYbFKASGaZeHcVNTWLPDECXBgfOMJd,aBHDeAACHGCE..VEEGTDEALDDDEFGCBBFGOHBA.JDBBhAAAdBBF.IAGAhAAAQAGAbFAF.ABDASHGEhAEAZADBcCACNIEFDAFH..CGHH.fCGEhAGA.MIEA..hBCA...,1,9,-17,26
dAFKWCBJabEDeYHcPQGVROINLSgTXZfUM,FEDDCHBFBAGH..JDAFEHEADDID..HDCE.QADHVACA.hAAAOABBLCCGSGDChAAATFFCZAGBMFADhACAAHIB.aCGC.eEFA.cGGARGBGIBABhABA......hACA...,2,-31,-8,23
LIRQgGEZDYaXBeHVCbNFWPSfUdMTJAKcO,KCDALGDGQFAEECDFDDIF..aCBGBAACeAAGCEBB...NEAB.FAFFhACA...SBCChADAdEFFTAFAAHBCIEGHhAEAgGDEZAGDYGFC...XCGEhACA...hBBA...,1,-9,-40,31
UfeEKLYHNBICcDOdQZSMaWXFgTRGPAVJb,JBCEUCCA.ECGFLDGDHEAFBHHCCEHH.DGFCdDDC..ZABEaBAHFHBERGAA.hAAA..ADAE...fHEBhABAeAFAKHEA..hACAIEHGQAGESCFFMCFDgDAAhADA...hAAA...,1,-18,-29,11
UZOCHfGgPcdbeLaWBQSTYKJMAXFIEDNRV,FDDFEAHHDEGDRAAHZAEE..CHAB.HDFHGBBC....PGCEdEEGeHDGhAAALEAHaFHFBEAHhABASGHHKADHAGHF.NIBH.hAAAOGAA..cCGFbAED...WADChACA.....hACA...,1,-12,-24,12
cXQCbOPIKUZaeDLVRTdAWEHYJfFBNSGgM,EEHHJCCFBDGEGBCB.MEFD..XAABCCHD..OAABhABAKGFAaHAELFAF.hADARDBGTFBCdAEGAEEEHFDDhAGAFGGHNAEDSFFE.cBGAbFDH.IFBHhAHA...hACA...,1,-6,-29,23
YgaHBZPRQNWCdGLVDMFcEbIXKUefOTJAS,SABHaHCGZABB.RFDE.QFAB.CEFGGADHDDDFFCFGbBDBhAAAKDGEUGGG.eDDDhAAAfHBB.ODHBhABAAIEC..YBADBAGEWDABdAHE.MIFChADA.....hABA...,2,-24,-15,9
LeaNcdgSZRUWHJDOFGTABCQPIfXVEKbMY,CHGBQCDH..IFCFVFCGEGGDMACHLCHH.aBDGhAAAdAEDZDABRDDDHBGD.hABAJHAEDCAH.FHAAADBFBGFFhAAAfCFDKBAF.eABC....NDIA.hABA.cCEF.SFAFhADA,2,-23,-14,9
TgXVHULSCDNIBMWYREZGbQJeFKafdPOAc,TEAFVCAA..UFFFCDHD..DAEABCGDMEFDRFBEZAED..QBAChAAAeABG.aGGGdEEBhAAAAHIH.XAGAHECFNIBD.hABA..IHACECEAbAEEFACFKEAFOHEEhADA......hAEA...,1,-3,-17,14
SRDOBZIJVQWXYcCNEgUaMAPfbFdKLGHTe,...PCEFFBEGKDCFLCHDGDFAeCCGSEBDDIDE.BGEGhAAAJGCE.QGFGhABA.XAGGCHAHEBGAaABEhAAAfADHdEAE.TCBD..OFHFhABAIHAB.WCAFhACA..,2,-31,-12,19
HXDbdILVGFEONJAZUSaQWPcTgKReYCBfM,SGDDQABF....PEGBTFACKCDDRDDGCFHEBBGDHBBBDICAhAAAdAEDLEBFFAABEGFGJAHFhACAACAGaEED...gECAhACA.eDHBfCFDMAIFIAEChAGA...hADA...,2,-19,-8,11
JSaHBXEOIfQMGNRKDLcVWTPYdgbFAeCUZ,CECDJCADHFGDBHCD..XFDH.EABGOFDF.QCGFhAAAMGAERCDEDAFFLFGHhABA.VABAPAABhADAdAGFFCDEACIFeAHFSFBF.fFFGhAEAKHAE....hAFA...,1,-12,-24,12
dPgLVCaYTeNHGSJMFbcOBAIKZUfEDRXQW,KBFEZDBEUGECEFFH.DDHBRCBG....QGAGdABALFCDCEBAaDGEeADGhAAA..HABGSGADhAFA.MCDEhAGAFHGAbFDFBHHFAAAH.IBHDfCGF.WAFEhABA.....hAHA...,1,-10,-34,24
TcNDXYbUVgQPESMFACfWGBLaOJeKHRZId,CBECGDECBDFHLFCEaBCF..JDHDeDBGKGAAHBFHZBAC.TBAChAAADAIH..XGAGhAAAbADF.UAFAQGGBhABAEGGAFDHF.AAGGfHDB...hABA.WHFG.IEAAhACA.,2,-32,-1,31
MPTSVgCGcIOENDLAeFYKbUWHaBQfXJZRd,FCFAKHFAUAGHHEEEaECDBAEC....XDACJEGF.ZABCMECChAAASGGG.CCAE.hAAAIACFEGAH.DDGGhABAAIGE..eCCG.WHBAfFBFdAGB.hACAPHCG.gBDAhAHA,1,-18,-50,32
IgBZHOWbCDacFPeMXQfKRdGLNJATVUYSE,UFEAEGBFBHECZAAHHCEA..ODAFCHAFDIDG.FEFH.MAFHQEBChACAKHGCGBCGLADGhAEAACAD..TAGHhAAASGGHIDHD.gABFWCHB.hAFA.cGCB..hAHA...,2,-29,-19,10
edPMDTZQELcCBUXWIFfbVRaKNHSgAJGOY,OACDdCBFMBECZFFGLEDHBEHC..UFCBXDGHFAGC...hAAAVFAARBEDKFABHCEDADHE.hABAJABE..eBBDDAFGEHGChAAACEDC...WHCAIHHBaAHD..NBAASGGChABA.hACA...,2,-36,4,40
aUWJXgQScBOANKLHEYZfeTRCdIMbVDFGP,LDFAHEDEECHBZADFTEDBdGBD..MFAFVBADDAAF.GBBCUFGEJFAHhAAAQGEA.hABABGHCAGCCKAEA.fDCChACACBFF.bGCA...aBFE...hABA......hACA...,1,-10,-14,4
NGIFbRTKEYdBUQgLHcDWASVCeMZaPfJOX,SFEFCFCBZCAB..aEFDJADA..OHEAGCGC.FGADRCDFEAGDhAAABDEA.QBAChAAAHACHDAIBADHAMIDC.fAGDhABANEIG.IECBKHAE.YGFAhACA....hAIA...,2,-30,-25,5
ZDEWQXeANVbcCfYKSdgUIGMJPLHTBaOFR,VFACCDEGKAED...dCAEUFFDGABH.MEFBJDAA..LGAGhAAABHDEODDDZBGB.EAFG.hABA.XGDDAAAD.hABA.cCEASBCBIHGC..PFAGhACAaAHDDDIF...hADA..WHAG,1,-15,-40,25
BJPROQKCVGfcIXLYNTUdHbMAWZaDSgEeF,ZDBGDFGCEBHBBCAD.RFCB.QFCAKBGB.CDCC.GEGC..IAAAhACALAAATACHhAEAdGEAMAIBAGAD.SAEGhABAFGHHODEE.fBEFXGAC.NIAH.hAFA......hAGA...,1,-24,-32,8
MeQgJWcFYGVOdSEPAaUfXZKTNIBLHbRCD,aBEHXBCAZABB.KFCA..TGBHBBHCHDEECAFG.DCIFeDFAJAAF.hABAFGGFGGDDdAGEEDDBAIHAUDAHhACA...IHADhADALFFE.MAAF.QEABhABA.gGDBhAEAWAGF..,1,0,-28,28
RMaEWPHYIVLCOBZgDAQUGfeFTcNdXKSbJ,UFAGeADDFFAD..TABEdGDAKEBE..SDDBJAEC.MAIHhAAAaCGE...EGEHHFFEhAAAVAEFLABHhAHABHCHDGHFAFDC.QDFE.fDABhABA..NEEF...hAIA...,1,-14,-29,15
EBJePSaWIDdOUNKCbRcHAgVQYXMGLFTZf,VADBQDAH.MFHHGDGALEEHTAAGZAGDBBGFeBAESFEHhAAAIGCBDADGhAAAOHACKGAFCDDCRDAGAAFE..hACA............hADA......hAHA...,2,-25,-19,6
HcRYPCZDWdfaegEUbGSAVIFTQOMLKBNXJ,VACETCAF..MAFCLEDD.KFABXFFGJCCC.RCADCDFHDHFEhAAA.dCGB.eACEEFCA.hAAAUEGASGBDhABAAAIBFFEGOHBC..BDDA.NEIEYHEGhACA.WCFEfAFDhABA.,1,-16,-22,6
eESJDGIdagRHcPZFNfbVUCTOYQBWXKAML,MFHFLFAH.eCDAEBCHDHCAdFHERECEHEEDZAAG.FEBC...fDGDhAAAbGDG.VAEAhABACCCFOEEA.QAGFhAAAWHAGACAE.SCAHIDDFaEAH.hABA......hACA...,1,-14,-15,1
edAEbQYXWaVIZCHgLPDcSBfRKOGUFTJNM,QAACXBFE.aBGBZCCF.CGHG.LHEEDGGDBEHAKFBC.UEFGhACA.FAEHJAEGMDCAeCEDhAAAEBHH...WDADhADAIGED.PEABfHAHRBAB.ODHDhAFANIABAADD....hAGA...,1,-15,-27,12
GHPdYEcFNWJRMfOVKXLQADCgIZabUTeBS,CCHBZBBDUDBDeEEG.BGCFGFCDHBGF.dAAEEAAEFHGA...JBDGMACChAGA.OEEAKGABQGEAhACADEIF.aEAChADASHDG...YFHFhAHA.WCDEfEDEhAEA..,2,-42,-13,29
XKfQRdVPOgDWTNcEFGSAbYMUBIeZJaCHL,MAFDBBCHZEAF.CHHD.HGBCLDDCKDCDQGFG.dBCDPAFAhAAAOFHF.DEADTFFChABAEBGDFEFC.ABAH.UGCGhACA.IEHGaAHF.fADDhBAA......hBBA...,1,-16,-36,20
bHYdKLZIESNOFJWfCPMcQDgXRUBeTAGVa,VBBHHABHdDEG.KEHBLEDBEGBF.ODFBFEBE..JAHBCFBBMICEhAAADAAF..RFECeADEhABAAHHEaAECZDGF..IHHHhAGASABC.fAHE.QGAChAFAXGCDBBEDhAHA..,2,-28,-14,14
GXUDdHECeZBgFMWaRNVbOIPfSYJKAcTLQ,TCDBQDEH.GABHDEAAEDGGCFHDBCHAMFBE.RGCG...NBCB.OHAChAAA..IFFEhAAAfBFFSHCGhABAKBAFAECAXFAC..dHGD.eGAChACA..gGGGhABAaAFA..,2,-28,-13,15
LCAMTcKbNIOYVPRfEHDdBaSFWgGXUeJZQ,MFDEKACD....IFGCOBEHVEABRFDHHAFHBGCH.FGEHGDABhAAA.UADGeAAEhADAJBHBQGGFhAEACBAB.ABBH...........hAFA......hAGA...,2,-34,-28,6
XOUZCdFTYQNBRSHVeJKELgPIfaMbcDGAW,XABHZEEDdECDFBHH..QAFCBEAFHABAeHFAKEGA.EDEGLCDEhAAAIGDD.fEAGhAAAaGBC.cDBFhABAAGGD...OBHDCBAD.TFFBYADChABASHAE.hAHA...,1,1,-33,34
KMISHYDgXBacfGeELWRVZdbJOFCNPUTQA,MHEGSGGGDDFCBBEE..aGCAGCDALBGHRFAEZBAEdDAA.OACFhAAACFFH.UAEAADIFKAAAhAAAHEEH..XDAAhACAfBAB.WCHHJAFA.FHAG..NICB.hADA......hAEA...,2,-27,-8,19
fRCAMaHgZQOFIPEVTYUdLXGcebKJBSNDW,MDDEHCBGZAEEFABA.EDFB....VFBGUFAGLAHDGEGEeHDChAAAJGFABBFESBAFhABADEEC.fFCFhACAABIBaAAH..OEAB.IEHA.hADA......hAEA...,2,-31,-10,21
KIQgNZdFDVbYfLOXJMcRSHWGEABeTPCUa,eBFCCHCBKCFC.QGGBZDAF.dDGADEFAVAAG....bCCGfDCEhAAA.LFBHhADAXABAMBEDhAEASGFAWEFFAAGCBFDHPAFA...IFFGhAAAFFAH.OEHFhABA..,1,-9,-40,31
TINHgDSdLZabcJQVWEUOeKPBRGfYXMACF,TDCCHABBDFDH.dCHGaCFC..JDDC..QABCEGBH.UGEChAAAeBDEKAGBBGHBRGAEfDAChADAMFADCFFGFHFAIHHAhAEA.gDGASBAD..hAAA......hABA...,1,-8,-32,24
gLRTBOFHUeVZaIJfdbDSPCANXcWGKYMQE,XGEHGGBBKDBC.MBGBEEGFLEAD.BDDGFAEHeDEFhAAAZCFCIHCDJFFCdBBDDCIHhABACCDEAAAF....cACBhABA..WAFEYFBC....hACA......hAFA...,2,-31,-31,0
YCdZOfNgDUecMRVTaEFBGHKJPXISQALbW,LBHF..bEDBCCEHdEAAZEAAOCDE..gAABhACADHBAeFHHMAIBRGDG.aBGFhAAABBDEKACB.XDCDhADASBADWFFGfFFD..cGADhAEA.EAFC..hAFAFHEE..,2,-33,-15,18
RTEbSQGNDOXfcAKVZCdeFgMUHLPIaJYWB,ZFADdAGBeEBHFBBDUEGGHBFC.LABE.aFFAJBEEBCBFEFDA.SEDChAAAGGDHDEBAOHEGhAFA..fAAHhAAAADGB.CAEF.MDCA..ICHChADA.....hBAA...,2,-31,-20,11
CQROfSNXbGAgYDJVFTHLMcEPBeKIUdaZW,DBDAJEDA.FCDGLGEA..MBIBEDBFBCACKFDAUGABdGBFZAAA.hAAA.CBBH.OCFG.hABASAEEXDFHAHGFhACA...VDAG.....cAFAhADAIAHH.WHFAhABAfGGD.,2,-39,-35,4
GXMOVDZgIabPQAdCJcfLUBHWTESKReNFY,CDCDJEBCLCHDBHDC.HBCA..TGGEKBFCeBAHFABB.GFDHhAAAMFFG.DEEAZADB..gFAEhABAaGAE..hACAQBFGAFDAfGHAUGECEHAGNAAC...hADA......hAGA...,1,-3,-28,25
GLZXPcAQbYSfgJaEOMVeCTFdHWNKDBRIU,QECASBBG.JAFCaEEA...EFCFMHEA.CEBC.TADFhAAAHBDCKCGBDIGGBCFDUAACLFFAhADAXAGEAIEEfEFBhAEAODABeDHF.FGADNIAF....hABA......hACA...,1,-11,-22,11
FDOGdTfQZeRYNaVMEUCBbgASHJWIcXKPL,SEFHHEECJAHD....IEBCKAFDPEAFFFAHGADEhAAA.dGCCfDDHhAAAeCAERGDC.aADFEHGACGCFBABDhACAABBG.XDBF.LHDEDABG.hAFAOAHB...hAGA...,2,-19,-8,11
MFPITANLJHBOUQXfVbGKeDRCgZdYaEScW,JAGBHEAABADEUDEF.QGGG..VCDBGACAKCAFDABFhAAACAHCdGCC.EHDG.SFFDhAAAMHECFFAE.ICABhABAACCBLFFEOBHF.XAEB.hACA.bFCD.eBHH.hACA...,2,-33,-5,28
CcfFDATMQBJXKaOZIVRbSEHdeGUWLYPNg,TFDHQFDE.JBCDXCCF.aBEDIDFC.VFGBhAAAbDADHAAA.eDHBhAAAUAFCLHFEhACAPFBBCBAEfDFCABEFBDHEKCADOHAE.SAFBhADA.EBHBhAEA...,1,0,-21,21
NWQJGFBMZKSVeafbHDcYRAdCEXUTgLOIP,EDEBUAEDLEGHOBHD.....IGDANEEE.QBGChAAAGCAGFACBBCACKFHBeHFGhAAAbDADDCDFRDFBAFDDCAECTABBhABA..PHAAMFIB.SCDGhABAaHAA.....hADA...,2,-18,-14,4
DWZadGMfPQFRBHeKNSXbOJcCEIUVLAYgT,TEAEDEBEZDFCdBGC.GFBFMCBE..QDFGBGHBKFFE.SAAChADA.bADEOCCGhAAAJEDD.EBACIBHBhAEALHCAADIHYHFAaAGAFADA...eHAGhAFA.XFGEhAHA.CDDF..,1,-14,-24,10
ANcISdUFeOaZbEfVgBYRMQGWCLXTJKDPH,..IGDHUCAHeFDBZEEH.EABE..VABGBFFH.MFCBQCGGhAAACFAA.LFAHhABAJAFEKGHFHDEEAAGDSDDDhAEAdDHA.aHFEfAAEYAEB...hAHAWBEGDICA....hADA...,1,-5,-30,25
dIMXPSKNVTeUBcZCLYfOEQaWJHFGbRAgD,DFGGMCFD..XFBDKEHD..VGBGUCAGBFAFCGACLCDDhAAA.OAFAEBAEQACFhAAAaGDD.WFGDhABAHBFHGDABAHHDIADBSBGHeFFB..hADA......hAFA...,1,-15,-30,15
CgTAHeJGFdXQDELWaVKNcIMRZfUBPbYOS,HAADeACEFEDBdDECXAGBDAIB..LAGBaEBB.KCBGNDHA.MEHFhAAAZDCHBAEH..hAAAbGBCSGFFhACA.CADCAGIFJFFB.QCEAEGCD.WBADhABA......hAFA...,1,-14,-32,18
KPAWBdLXbRNMTJHDeGQcICUEZOYSVaFgf,dFBELHECRGFC.TDDBHCCBeAFD.QCAFCCBHZBGHOFCChAAASDHDaFBH.fHCHhAAAAEAHBACHXADDhABAbABCMAIHDFIBIAGAEFFE.FFEE..hACAKCFBNEAA.....hADA...,1,-1,-16,15
ZdgaEDCTROQAVGWPYeKHcIJSFMfbLNXBU,GFBF..WGCGeBBC.HCFC.JGFESBCFFAEA.hAAAfGAENDABBEEHdHAFhABAEEADDCEEREFCAAAH.VBEHhABA.KADEMIFC....XDCDhACA......hAGA...,1,-15,-32,17
CMQTEYAJFVBUSedIDcKNbOXRgLfWaHZGP,FFEBUCADeDFBDBEE.KGCB..OAAERBAC.LHBCaHGA.ZEFDCBEE.hAAA.QEAEhABAECFCADDDBEEGdBHA..IFAAhAAANADB.....bFGHfECHhACA..WFCG.hAIA...,1,-29,-31,2
URKJVPSDCQHZYWXNgMGdfEABIeFLacOTb,BBDHFEEBLAEDODFHUCAAKCAG..JGEG..SHDChAAADAGFHFBFZAAG..XGGHhABAMDDDGBGGEEGGeFADhACAaAHF.TBFE.RFBACEDB.....hAAAWADCNIEF....hAHA...,2,-25,-14,11
XgLMHeIREScTAVdaCJZBbUYPOGDWFKfQN,dFFAaAECZGEABDGH.UFBDODAFGABF..FDECQCDDhAAA..gAAFhAAAMEADeHFAIDCFhADAECAASEEDACIHJFFCPFCHDBIF.KAGCNIAF...hABA......hACA...,1,-17,-22,5
IgbSLJDOZAFUCWdcVQGfRNeHPBaKYXTME,UFCGdFCHQAEARAAGHAFEBHGFKDAC....XDEFTEGAEDEGhAAA..IEHBhAAA.SABChAEADCDHAAEDCHAEVCAHfHGD.eHACaCGEMFFFhACA..LBCBhAHA.OHDC.,2,-12,-7,5
YTPRGDSLBgQFEdHIKZfOcWXCaMNJebUVA,TDCGGBACSFCA.LCCBBCHDgBDEhAAAEHGEICEEKHBCOFFHhABA.XCAGMBGHJACAhAAAUEGDAHFFYHBEDBFGQEAHFAGAdFGD.fHGHhACACEEB.aGDDhADA...,2,-24,3,27
gbGdLFSTJcXfMHOADYPQVBaEZUWeIKCRN,DFHHQABHBDDEZFBBeAGH.KFGECADF.RFAE......gADBhAAAdAGBSAAEhAFAJHEA.XGEBMDEDAAFA.hABA..VBGFECCBIDHF.NIAD.bBBChBAA......hBEA...,2,-45,-9,36
QbFRfBMTEdNCGLOXPIUZJaDSYcHAVgeWK,eCBGQGBAFBHDBHBFECCD..dCFBCFGELBACOBAF..IFFGhAAAZGECDAGA..SECEhAAAHADHAEHE...hABAVAEHKAGCfFAF.MEEBNEAC.hABAPFHB..aDAFhACA...,2,-31,-6,25
FBVPHJMAcRaQOCYDXEWfNZKLedIUgGTSb,aHDECDADDFFB..EBAE......fEGDNGCBKEFELCDAhAAAdBFBUECB.GBADhAAASEADBHHBHFAFhABAMAIDADAC...RDBEYHAEXGCHWDDChACAIHHH.gACEhABA.,2,-32,-25,7
bPVCcMeLENOUIDZARSTFXYdHGJfQgWBaK,RDDFSBFGFFAE.dEAGHGCEGBBEJBBF.QGEHBGHBKACC.VEGBhAAA..MIFAEADFODEBhABADCIDAFFB.TGBBhACA..XAEDYAHHfHADhAAA...WBADhABA...,2,-44,4,48
GcZSaFDIPdeAVOXYTBMUNHgJECfKWbQLR,XDABBBEFUBGCHDFC..EDAHKBBGQGEELECDRGFAGDBAhAAAZFDHaGADDACD.dEFDAAACOAEAhACAMDED..NADE.hABACFFGfAHA..WHAA.SGHFhAEA.IGADhAFA,2,-19,-16,3
dXDMTNPfWcUVKZCLIQgJRYOeHSEFaBbAG,XEDFMHFA..TBDF..PAHD..WAAEUFFGhAAAVFAECCAGLAEDhABA.IFBAQEFFhAEAgGBAYBCFOABFSDHBhAFAEAFHBEHBAAHADBBF.NIBH.KHDGhADA..RAFB,2,-21,-21,0
VQHDdaRITGCWUAEKLFefBNOcZJXgSMbPY,EDGHKEDHLCGFFFDB.eFCBBACG.OCCBZAAGJBEH..SAGHhAAAMFIB..PCADhAAAVFGF..DEDGaFFChABATAEDCHAD.AIEANDAEgAGE.YHEEhACA...hABAdCCE..,2,-39,-7,32
KOSeEQZTbUGPgWcadJNfXVBHFYADCRILM,RGEGLDFDMCFC.SCGEQEDFZGBGUACHGABA..PFAFhAAAgADB.hABAaFHHNDAF...fDGChAAAXDGDBAFCYFACADIBDGDHCDDBIAHFhABA....hAFA...,1,-19,-22,3
MHdWXNfFaeQYBCJSRUgDEOAZPKLbGVcTI,ZDFGKBFBLEDFGACA...VEAHIHADdBBG.XBFAhAAA.FFBGaAHHeCAFQGGFhAAABHGECGDGSEEDhABAgADCOFFAABEG...cCEChABAMICGWFHBNIBF..hACA...,2,-23,-15,8
BYQaeDRcNLSGgWOCMAbTXdfVUFIKPEJHZ,XGFEdCGHUBCEKGFC..JCBFBAAG..aGCEDEAERAAG.LFAFhABAGDEHOAGD.hACAMGAGAFHCTDEAFAEG.hAAAEFCF.......YHCGhADA..eFDE.SDDChACA,1,-13,-47,34
BKNcGdVTQLPIbOeMSWAEYZRFfDJHgaUXC,ECCAZDECFACEDDFE.HAFHUGBHCCAE..BFCEKDBFGFEH..TGFChAAAQAGELFABhABA..IEHChAAAeFDHSCHBAEFE.fCCAaAFBNBAG.hABA......hACA...,2,-31,-18,13
SZbYBFXQOWeLPKMIDfgATUcCaHRVJEdNG,UFCACAAFHCGBRCCA...VCCDdAFAGEEC.ZAGBBAFCFEAG.OGBEhACALBAEMBBCDIBEAIHEaBGBhADA..EGHBSFFDhAEA.........hAAA......hABA...,1,-25,-29,4
RENfAVOXIDMYGCBgZaJHUWQTdbLPFeScK,OBAFDICEMGDEGCCBBFBC.ZEFAHBEGUAGAQABCdHGDLFBChAAAeEFGKADA..EDAFAABE.hADAXGACCGBA.aDCGhAAA.JHEC..WFAD..PADAFHDE.hAFA.SDGAhBAA...,2,-18,-5,13
SGNegDMFUZXQTKaJWYfbVILBCROAcdPEH,dGGBEFHHHGDGGAABeCEEMAIDUAADZBDE.QFADKFDG.aHBCJDAHhAAA....YEDEhABAfHDD.bDEAhABAIDBD.CAEEAADBSGAADDDE.hAGA......hAHA...,2,-21,-11,10
cINYbJKEHXgZUSTGOACBQDLaVWfPFRdeM,BADBQCAHDDBALHEGaDFB..VGAE..PAFFFEHHeDDFhAAAMEEA..NACF.JFFAhAAAEGEFHFACZABASGGGhAHATABGAAHG.WAFAfFDB.dHBDhABA..YCFChBAA...,2,-18,-14,4
RSgeFIPNfUKDTAcXHCGWLQZJBdOVEMabY,XCBBGDBB.LEEHQAABZBFAdDACVFDD..MDGBbCFA.hABASHGAFGBH.hADA.IAECPABGfAGFhAAADCFGAHGBCAHFBHHDEFDHYFFCgGAAhAFA.....hAGA...,1,-2,-17,15
MVNRbSOQFKZPDUYXGAgCcWdHeTJLBfaIE,CCHFdGFBHEADJDBH.BFFB..aEDFMABA.RDDH.OAFBFHEE.ZABCDCGBhAAAUDGA..XBDEhAFAAIAC..gAGBhAAAeBBDLHAG.EAGCNIED.SEHFhAGAKGCB....hBAAYEAF.,1,-8,-30,22
FHTWXVIbOJZNULdMRYEgGcSaQeKBfDAPC,CDBBTEDC..XDDE..bCABJHFAZAEALBBCdCEBMFHDhAAARFCE.EHECGAFA.hABAaFAGeGAGBCCBDADHAADEFHBGhAAAWHAG..IAHH....hABA.NDIC.....hACA..gDGC,2,-23,-9,14
KEZNYSbHaJdTLIfGOcWPFXgAVQDeCMRBU,QDAHDDBACFDF.BBCGKBFBZFEE..SEECHEAHdADFLHDAhAAAfFHEOCHDhABAPBFG...FHAChAAAAAIDMCBAUGDCNDDHaEEAIADG.cGGChABA....WAGBhACA..,2,-32,-27,5
XIAPVNEdMKZUaBHWcSJTFDOfgbRQYLeCG,VFBAEDGAdAFF.ZBAHBGGFHEEB..SADBFHGCDCFA.ODBAhAAA..fECChAAARAFFLEFGCGBGGCCBhABAACBANICFMBAFKEHB.aACF..WFAF...JBHDhABA......hACA...,2,-23,-8,15
SQZOWPKfGUFaCYBXHTeEdJVDNMRbALcgI,LABE..IEBDSFCCZGEAODGFKCDBUGBFaGDHBHHDhAAAHACHEBFDdAAGDFIBMAFHhACAAGGE.QBGHhAEA.fFEBCAGDTGEC.eCDHNAIE.cGAEhAGAWFAFFCBF..hAFA...,2,-33,1,34
OUeadAbNBSTFXYcQKCHRDMfJgZLIWEVPG,BFADSAFFFCGG...XCFDQGGGKAADHECGRDDAMBCDfBGBhABAZACFLAADhAEAIDBHEDHHGGAHhAFAOHDAaBFGdFGFAAIF.TBCBCEBGDGFD.WEAD..hACA......hADA...,1,-1,-18,17
QSJOLMXBKacWVEUTGIHgfbFeCPNdDZRYA,JBCGLGBCBHEH.aCBC....VEFDEGGGUBEBGGAHHEEH.hAAA..fHBHhAAAeDAEPCFGNBAG.DBGAYAHHhABAAAGC..SABCMIEAKBBE.TEABhAEA.IHHEhAFA.bDDB,2,-18,-15,3
FBAMWJQdCHeSPTgRfELKUaNcZIVbDOYXG,MICGQDFGdDCHHEAASGGH..gGGBREAELBBEhAAAUBDFNDABZGAG.IBGHhABAbGAGOBAH.XEGEhAAABEHHAAEEJFEHCBBCTCGF.KFEBaAGA.hABADICG.....hACA...,2,-6,-4,2
PCFVRJAGSaXObTcEQUKgHeIdNZfBLDWYM,aGCGOGEE..TAGEQDFC.KCAHHCBGeAHHIHEGhAAAdFADZDCHLAEGhAAADGIHWFGF.MIFCFADFJCFDAEIFSABChAFA....XFAFhABA.EABHNCCHBEECCDHA.hAFA...,2,-21,-5,16
RPUBHXgJDGeEYcAaZfTKCVdMIOLSbNFQW,ZFAHKGCGCGEBdGEH.MABCLCFA..SFCBFEBGRCDD.BHGAhAAAHAFAJAEGDABC..EDEDhAIAAHGCaBBA..fDBDhBAA.TBCGOFAH.NAAAPFFAhAEAgCGH...hAFA...,1,-25,-32,7
YfZWOVAaeDECcgMBSRQNdPbTJGIUKHLFX,DCIDCGDG.MCHFBBHF.RBFD.QEBFdHGB..TCBCGBCHKGAAhAAALDAF.XGFAhAAAfEDGZFDD.hABAOACAAHAC.EBAAcGBESGFC.hACANIAH......hADA...,1,-22,-32,10
BSKLbHCYTWcfdUIAJGDEgeXMQOFNVRPZa,DFIDeEFDMICEOEDF.FGCBRCFCZEAF.BFGGSCDELBDAHBBFhAAA.CHHE.TCBDhAAAfBGAUEDCAEHEEFAD.hABA............hACA......hADA...,2,-32,-24,8
UBONQHdFESYbGLZTceKMVgRPCDXaJIWAf,UCCABEFFOFCHHFBGFFFA..SDAFGAGCTAADeGFCMACFhAAARADGDGAB...aBGGIHHFhAAAAEBHQDGChABAEDAH.bDDB..cGDDKGAH.....hADA......hAEA...,1,-7,-23,16
AcVfYQLbUDeEIXOBZHSRPFNTdCgGaWKMJ,VBBBQCFA.LBAHUFDDDFADIGABBGGCHAEC.RCFA.hAAAPEDCFEHF.NICH.CHHB.hABAGACHKHAA.AHHCfCCChAAA.eAFEEEAG.ZFCASADChACAdDHE..aGGG.hAHA...,2,-25,13,38
VJcINLMWeOfZGFXBDSKAdbgTPHUaERYCQ,dAAFTBCDHDDB.ECCHCGEE...QGEDJCAD..IGHAhAAALBEGMHAGeDABZFFFhABAFDGHXCFCBGBADBBBhADAAEHA.gGGBaAGGREBG...YAFEhAEANIBFWACE....fBGFhBAA,1,-12,-13,1
JaQXSEUKdTLGOFfVHDCBePWRbINcZMYAg,JBBDaCGD...QGCHSAAEKFGGdBDFLBFBFHACHGDCBFFChAAAeECHREAC...NAEDMDABhADAAAEHXDDF..hABAEHGA.TCDGfGAGDDIHCEFDPBBHhBAAIHHD.....hBGA...,2,-24,-5,19
SCLRfgMbPEZFGWXYBJUTQAVNeOIcHdKDa,VFBEODEE.HADEdBHGKGGADIDC..CAHCLFGDRDEA..MICEhAAAEFDCZDACFADDGCADhABA..WFAHBBFEUAADhABAAGFAIHAFSCFE.fFHAhADA.....hACA...,2,-30,-9,21
dSGDcTZAfCLHFYMORaXIgBJWKNebUPQVE,CHEDLFEFHCFHFBDBMAEH.RCFD.aFBG..XCBDBAEEKGGFeACBhAAAUBAB..QAGFhABAEGBAdAGD.DBBF.TGGChADAAHAHODHFJHAE....WFACPEEFhAAA......hABA...,2,-26,-4,22
dHKIAEfOGJUcMFbLPVaXTWNQZgReYSDCB,EDEEGCFAUAFGMCDDLBDF..VCAFaACG...XGAEhAAATFBD.QAGFhABAZGFEeGDCSFFEhAAABGHBdHFDKACEfBACOEDD.....hAFA......hAHA...,1,-11,-12,1
IbcUXZSRGCafQJOEBFgDKPMWVeNYTLAdH,dGCAHECD..ICAHUAECSGFCRECG.CDAD.aGHHQBBAhAAAECECBAGEDGFDKCGHMBIHhABAeABB...NIAB.LFAHhAAAAHAA.XAEGfHFFJCHD.FEEAhACA......hADA...,1,-17,-19,2
PgUVbREDGQIaFOCTSNLfZAdHYBKJXMeWc,HFBHBDBFKFAEMHFC.eAGF..PHDEUEEFVABDREDE.EGABQGAFhAAA.aGHFhABACDAANAIEZBCBADFB...dDGHhACAXADF..WAEE....hADA......hAIA...,1,-11,-29,18
ZPNBIJVUgLDYOeTKGEHcbdCWMSQaRAfFX,XEEEZGAEBFGB..JBFCUBFG.DADFeABGKHFG.HGEG.dEAD.hAAA.MAEAaDCFAFIFFFCB.hAAAIBBE.LEHDhABAYEEEOBDD.EHCACDAE.SCAGhACA...hADA...,1,-20,-35,15
aUNOJFGYQdZTAXgLSBbecEDfPIRHWVKCM,XADFLDDBSBHBBDDC.eGAGEDBDDIFE..PHFEhAAAIAACHAEBKAGEMEAEhABAaFHB.OFFCGBFGhACAdACBAFBF.cBBERFCFWEFDCCGHNIAH..FBCB..hBFA......hBIA...,2,-23,6,29
AFUSeHaXOgCNWDLcMRBTIfGPdJKbYVEZQ,UAGBSCFCeBBBHDFCODAA..CABEDAFBMBEBBGDH..TEAChAAAGEBHJHEAKBDHVDGBhABAEGFG.ZGAAAEAB.aACF.hAAA.NIDB...WAEE......hAIA......hBAA...,2,-22,-21,1
AcCaIgYXWdUeSQJNMGROPBfDEZFHVLTKb,CHCBaGHH....IACHXFBA.UBABQDDH.JFAAhAAAGBFA.PFFHhAAADAEGZBACFBDDHGEGLBHBhABAKEGBAIEE.gEACdBHGSBEBNAEFMFEHhACA.BHCDfHADhABA..,2,-20,-12,8
PdXAGZDQWgacBfFOTEVRSYCHJKeNUbMLI,GCDDDICGQGGGaCBFBFGBFEFB..EHBGREBH..CABA.JFBC.eACEhAAAUBDBLEHBdDAAABHFZEDHhAAA....gGEChABAfGAGOFABSAEE.KDHFhABA.MAIF...hAFA...,2,-22,-15,7
dLPBIFKNJQbTGXcHAfaSMYUDCWZVEgOeR,SDDCMFBBUBCE.CFAA.ZGFA..EFFAOEEEdGDGBAEE.KBAAQDADhAAAGBEDXGAAhAAAAAGEaHEC..DCAAgDAEhABARFCF.IHGGNABHTCGFfEEHhACA.WEHBhADA...,2,-33,-17,16
HVFJMZGcANdELfgRSXQYeBOPWUCDbIKTa,dHEDEAAGLFAFREBB.QDFEBGEEOACHUFCBCEED.DACEKDFGaBHFhAFA..HAEA.FBAFhAAAMBDH.ZFFGADID.fCEFhAGASGAH.XGGF..hABAeHEA....hAHA...,2,-32,-14,18
ZgcAIeHRPEVLCfGXUSDKOMaJFYdNBTWQb,HACHECEALBCHCCHHGEEFUGEGKGBG..aBFFJEAD..FHGGdBAGBBAGhAAAQGBHZEAG.AHHAeEEEhAAA...PAEChABAfAHC.SCEHMAIF.hACA......hADA...,2,-23,-16,7
YATDSUKQMcGFfXIegCBVbNWERZHJPLaOd,SHEGQAABMBIDGDAA.FCGGIEBDCEFD..BFHFhAAANHEB.RBBG.HACFJACCaBABhABAOFDG.dDEHAIHEDGEGhAFAUAFGKAGGfHBH.eEADgFCFhAGAbDGD.ECEF..hAIA...,2,-19,7,26
AgRGfWYeCaXTKUVQSOBdIPHNJDZMFcbEL,GGAH..WDAACFFCaABH..KFDFQCFBBHHA.dBEFHADDhAAADAFCZCAEFGAHEEHFAGGE.hAAARBFD.eHFCUABGSEDChACAOEEF.NAIG.MAFG.....hADA.cEAD..hAEA...,1,-19,-24,5
EAeDcICGMJLURdHZPVKgNbOQXWfYBTSFa,eBCFDDDECFCH.MFEGLCFHRAGH.ZBGFKEAH.....NGDHQAEBhAAAfBCATFGEhAAASHEC.FDDBAACBIGAEhABAJBAD.dDAE.PFEB..hADA......hAEA...,1,-20,-35,15
QKXBATCRcVJPOYaFeZNSbDUMHEWgfIGdL,REGHJBFFOACG..aDAAFFDBZEEF..SDCGDBIDHDCFEBBA.hAAA...fBGFhABAIGBFLHEAhAAAKGEAAHACTBDGCEGA..PAFGNIDHMBBB..WEAFhABAdGBABAFH..hAHA...,2,-24,-20,4
AfLEaZcdRgKJSWIQHXFDYCUPNOeGTVbBM,ECCCZCGBdBBGKHAC...SGBEQBGEFGHHCAGC..UDEGOAEBhAAAeABE.GEGETFEDhABABGEFMDIHAIEALCBDhAAARDDA..gGAG.WAFBhACAXFBADDAD...hADA...,1,-13,-23,10
cbJHLQgFaISfKdMZETCNWPUeDBVGOAXYR,XCFBRBEC..bGECJBABHEBC.LBAFFFAF..IDEFhAAASFAGdGGDEEHHhABACHBDNDIE..UBCGDIDGBECAhACAOEEGACDD....cGBD.aFFBKAHBhAAAMAIF...WBEChADA..,2,-25,-14,11
GBZNegUFdbXCKHYEaVMcALPfTISWJQODR,LDDATADB.SFGBJGBE.DCCFRCDAGABABGCAZBFGeHDAhAAAFAEG.dBGB.CFFGKFADECAHMAAEhAHAADAE..PEHHhABAIHEF.........hADA......hAFA...,2,-34,-19,15
OURbWSdDZXYaIAFEKVBeQJMPcfCNGHgTL,KAGEBHHEeHCGMCFF......PACDCCDGGFAFHDEDLHBAhAAAOFAARGFGSBBChABAZAADXEGEaFGAIEAGhACAAEAAFBGH.EADE.JAHF...fECBhAFA...hAAA...,1,-17,-18,1
VBUYFcEKSOZfdAWPbRMTGCQeHXLIgJNDa,...bEFCRDFGGFDH.eCAFXBAHLHAAJCCADHEAVACCBEBChAAAFAGGKFAAOAFAdDDCAHHGhAAAMFCH..CCHA.IDHEhABAaCFG.cGGE.ZACC.WEADhADA......hAEA...,1,-8,-27,19
IcbSfORAHEMGZaUdCTLBPFVDgYXQJKeWN,EAAGZFBCdEFBLCGDBAADFBCEDFEB....XBCEKGFF.eHAChACA..NDAC...cFFChADASCEAREAEMIFEhAEAaBHBCAGA.....PHAC...hAFAgGGB.hAGA...,1,-22,-43,21
YQbSUKeHfDGFVAIMJWPacBLXOEdNTgZCR,JCAGaACHBEEHLAEC..EHDEdEHE..TGFHCBHHRFCF..QEEEhAAASEAHKCFAHCFEhAAA.DDADFHFGADBAIECBhABA..MBAGPHAEOFBB.hADAZDAG.....hAEA...,1,-18,-30,12
eREKQFPgMGYSTWBHXOcAZdCINUVLDfbJa,ZGCCdBHACFFGUAFCLFBFDAAA....JDFGRBCCKGCH.FEHFMDCE.hAAAGABFSEAFhABABFFHHEAHOACGAIHG..hAGA.IHHC..NIAF.fDEHhAHAaECF.EGED...hAEA...,2,-31,-21,10
RFfdeHKUMaVLIYTcGCBgAEQODXWSNZPJb,EGDDDEDB..SHCEZEAHJAAD.RCAE.FAHBdGBGHCBA..MBEEVFEAhAAALHFG.IFEHhAAATCFHCAFCgABBhADAAFID.QCFG.WFAFhAEA......hAFA...,1,-25,-28,3
CdfUaBOHWDAJVQNGPXTgbMLKIScZRYFEe,VDGBQBBH.GAFETFCAMHAGKGAF.SEAFRCCA.hAAAFGFGEACDCHEG.dBACfAAHhAAABEBGHAFGWFBChADADGGHAFFF....NAIEgDEDIHHG.hABA......hADA...,2,-21,-5,16
BWbfKTAaRICUMZQOeGFcYgHDVJXESPLNd,aEDBCAADUEBBZGCC....eBFFGCCHFFGG.....gFFChABADDAAJAHHEBACSACAhACA.LHAEhADANEAABBEF.WAFE.KGHBAHHGMAAG..cCGEhBFA....hBGA...,2,-34,-28,6
KGfHeMWXIcJYZFPdbANBCSTUgLaDQRVOE,BDHBSCFEUGAGLBDHQEEHRBAA.ODHDGGEFHDBD.hAAA.MFBAIBABhAAAJAFH.YADHFAHFdDADAFIDhABACHHETGAD.DGDDEEGBKGEH.fAGHhABAeHCG....hACA...,1,-9,-12,3
gXJSHKbLADGFePcICdYREMBQfVaUWNZOT,DCCHFDBFeEEF..IHHEdHGDEFHFBBCCQABH.aDFGUBGEhAAA..ZEDGOFCDhABATGAAXAEFhACAHAFGKFGGABBB.PDABCHABMDABfHEB.hADAWBDH....hAAA...,2,-26,-21,5
DdXVPfCFQSeKbRWZTEANMGLaOgIYHcBUJ,MEHBaBGF..OADG..IHDBHGCCUCCFJFBADAGGdFGDXCFHhAAA.fBAAhABAQAABSFBGhACAKCHBWBECZCDCAFFFNAIA.LEAF.cEEAhABABHADCHHEeDAE.hAHA...,2,-21,-14,7
gVSERKJTZYDHBCfMeOaUQAXPLFWcdNIbG,LBFDFAGCdEAA...bEDDVADH.RFDD.JAAGZFFCDAEA..BHCFhAAAMFFG..ODFChABAUGGGADGC..XBBHhACAPCCH....NIAH..IBDESHFAhADAKAHB.....hAAA...,2,-31,-24,7
QEBYfAgJDNZcFVLGCPebITWdSRHaMKXUO,DCDFZGCEFDADLFBEGBCGCABA...eEFE..bFFFIHHHhAAA.dBGFSGBHhAAARFAAaACA.KADE.XBAGhABA.OAGHEBAAfFFBAHHENAIE.hAHA.cCEC..hBDA...,2,-36,-12,24
KQfTSRMOYgNJLXHPVcECaGIbdBADZeFUW,DECHeCDFUAFHKGFA..QBFB..TABASDAEhAAAODDE..NACDXEGEhABAVFFECGDH...IEEEhAHA.BBBGAEBHFGAC.fDGDhAAAYGBE.....hAIA..LADH,2,-31,-30,1
RAOUXeQIKTZFfYCDaSELGNbdcJBHgWPVM,XADGQEDHKDFHZBAD.FBFA..CAFEDIDGSHGELAADGCDDhAAAdEHABGCAHGAG.hACAWABEMEEB.ABIFeCFEhAEAIFHE.fFAHaCCHEHFE.NAIAcGEChAFA....hAGA...,2,-24,-16,8
FJfeLDCHbUVdcSAgNQKYPZEIRMWGaXBTO,QEEAKGBAZCDCRFGF.MHBGGCAABCEEFFEAeADA.LDADhAAADBBEHAGDVCCFdAFGACCF..hAAANIDB.EHEG..IFHFhABAaACA.OAHHfECHCABH...hADA......hAEA...,2,-14,-14,0
cKCGPfeTFYVHdXOWAZaNLgRJBEMbSDUIQ,ZFDAaDEELACFJADF.BBAHMICG.DFADUFDF.QAFDhAAAKAEEGBBCeDBD.FGGEhABAVCGHdHADOADDhAFA.AHEB...NAACEFHFSBHHCGBB..hAHAfDEC.hAIA...,2,-31,-12,19
ZQAFPXDbeORBUIGMTdScfELVJHNWgaCKY,FDEEDEBBOEHFBHBHUDBFGCEB..MEABSBAE.EFEFhAAAJEGDHADA.NIBD.aAADhAAA.KADEQDCHhABA.AAIHXGFEbFCAeBHD.ICAEhACA..dCCFfFCAhADA.,2,-33,-13,20
BFPeIQUWDLfadJAXHgZbYRSMGCVOcNETK,XDGCHEDCZACBRFACGACDCGGF..OHAEEGHBKHAGBBBD.eAEHhAAAUAAELFHBdEEAAGCHbDAGhADASAHH.hAFAMEBCcAGDFHDA.PHDG..WCADhABADFCG......hACAaCDE..,1,-1,-13,12
JWgQfVdPZbDTNOaKGHFRUSAcILCYEeMBX,LEHDCHCB.EDCDMEIHBAFBJAFB..QEEGdABHZEAGDBEBTGCGhAAA..aEGFGBBBhABA.REABABBCIFEGhAAAYAGB..eAHB.XCAEhACAfADB....hACA...,1,-17,-38,21
YFPeOCMgSWXHGBVLJUKcZbNRDTaIQAfEd,EFFGdAFHFCDF..OBCFCGDC.MIDASGABHCEGGEBEBEFALFCDhAAAKCADZAFENABH.DBAGhABA..aGHDACCB.fAAGhAGAPFHB.WEEFJCAF......hAHA......hBCA...,1,-9,-39,30
QZLDGAHPKCBFNEVTbfJWacMRgIYXdSOUe,KABHFCAHEFDE..VDBC..TAFD.JCHDaGAH.MGBGRABC.hAAA..IFFDhAAAXGGESAFAhABAODCBeFAFLCHFAIFECEEEBHCFfGHA.hABA..cADB.hACAdDAG..,2,-22,-22,0
UcKIDCgfMFYVeZTJNQPLHbAdEXaSORBGW,EFDCXDFA..OAEFGGBHUBAAIGHCDIBC..CEAEMIEGhAAAVCAEZEAG.TAEGhAAAQBGCLBAChABAHCCFAGFCSCGCBGGDKGAGFEHF....hABA......hACA...,2,-23,-2,21
FHKgfZNbaBUVATdQWMCcEPXGJDRYOSeIL,QDFEMCAG.EEAHXEAHGDDCRGACOHBG..SBDFhAAAeFHBLADBhAAAKGGAZABDNAFCaABCBBGEAGDGdGFChACACBAE.JAHFDIEA.........hAGA......hAIA...,1,-15,-17,2
UHYSZcbWaFPEJgQXDIfOCKRMdATGBeNVL,TDEFBGAFeDDA.LBBEHFBGZACF.bAGDaCGD.FGCG.EFHBgBAGhAAA.DEAHhABAfAEBKHECdGGAAEBC.hAEAGCAFNIAF.YFFF.SAAChADA.WHBG.hAFA...,1,-8,-14,6
gSWdDKEcVJPQeaNBAOHLCZGTXbfFURMYI,LHBGZFFEGEBBXDAHFADBRBBB..MCHF..gGFChAAAdHBFDAGE.KAECEBEHcDGAhABA...JAHFeAAFhAAABCCBABGHCHHCTDEH.fABFhAIA.YGCESGEDhACA..,2,-27,-17,10
YQXNATRGOaKbeUCgMfVPBFWJZLEIcSDHd,TCFAOHACKEBF..UDABCBAA.MABD..VBDEFAHBJACHEFGA.hAAA..SGFAhAAADGEFHEEDdDGFXEDAhADAAIGGaAHH...gGAGBABBLDAEYGBChAEA.NIEH....hADA...,1,-8,-24,16
bOWDEVdHgZCBANUXFSfJYPGMTKaQceRLI,XBDBFGBB..SAAGJEEA.GEGAKGAGaHECeACELEAAhAAAIFDB.OGDEhABADCAAdGGFZBDAAICCNBIAfAGGhAFA.MICCcAGBRDDE..WAHBhCAAEFDF.....hABA.gCBACCCG,2,-21,-14,7
ZCWIMgFXdJTLcSNAQKDUBaeYHbGPREfVO,DECCUABFBCBHeDEHHFDHGEAGREAF..EDFCOAFG.ZGCEIAEDhAAAMDID..FDDBXGGEhABATGGASDGBhAAAAICGKAHB.aCACPFFGCAEG.dBBF..hACA......hADA...,2,-27,-5,22
HZgEVeYWMfNCLQJISaATRcDbBUXFPdOGK,RDGBDAADBACDFBDA.dEDBKHDCZFBG....EAGDeAEG..MDDBCHADLBBGhAAAQCGB.hABASCAAAGFG.hADATGGHbBFA.XFAB.GEEHhABA......hACA...,2,-33,-31,2
DcfVAUNYBIePXbQdWHKEMRJCFZgaOSGTL,UFCBBAEBeCEE..PFAFXBAEdADAHDEAEFFG..MDBDhAAAJHFGFCADZDCB..OHEChABATABGDAGG.fEHEhACAADDH.NDAE.IFGA.WAFGhAAAKHBCCFEG....SDHBhABA,1,-22,-25,3
YERGdVAMbICDUWOZfJKeacSNXPHTgBLQF,MDBACEDAUBEDZFCB.KDEB..aDAH..SEAG..NHEHHAAAhAAATGFFBAHFLBHDhAAA.FBABEFGEdGAChABAbGACDGEH..fCCAcFGF.XDGAhACA....hADAgBEE.,1,-17,-26,9
KcDfaOXNSTLZMCBeAPUbgdYIEVWJGQHRF,UGAFdECFEGAG..JEBGHDGF.FAHFKAFEDAEE..aBADODAG.hAAASACFZEFBCACABHDGhABAADFD....bGDAIFEChACA.GCDB.....hAAA......hABA...,2,-40,-32,8
JcaQXDVCGNRSBbTdgHFUEKLOfWPZMAYeI,eCEEJCAF.QEBCDGEBGCFGRCCEBGFF.dHADFCDGKCAEOHFChAAA..fHFFhAAAZABEAAIB.IEFAhABAXAFACAGHSADCTGAB.....hABA......hACA...,1,-15,-35,20
YNOKTILZSRDJMebUCAWBdcEFHPGaQfVXg,BGDHEFEEFABHHCEA.aDBAQDGA..XACB.hAAANIAD.TBFHZFFBDCGGeEAHhACACBBE.dCDC.cGFEhADAfEBE.gAECOHBCIAEEhAGASDGA.JFHDhAAA.MBABADFB,1,-12,-26,14
cBdQZCTMYaREDJKHfWIXFVgGObPSLNUAe,eCGDBEHCdAHCZCBDCAHDMDEG..REEB.DAFBKGBHHECA....fABDhAAAIHHBFCAGhAAA.GEACOBEHSGFHhABALDADAHDB.cGFEYBBC.hADAaEEA....WDDDhAEAXGCA.,2,-24,-15,9
RAcKUGDHFgMYIJSeCdWZOfbPNTXQEBVaL,UCDFHCBBFAABMIECJDFA..CBDE.dHGHZEAA..OADA..fCHGhAAA..hABAPFFETGADXGCHhACAECABBFHGaBHFAFFG.KBDHgAGCIGBBSFEDhAHAWGEG.hACA...,2,-38,-19,19
PWSIFHdDGKcRYXBOZMbUJVfLgCaTeEANQ,QFEASCDAFDAFdBCEKBFA..RBGFBEFGMDABUEBB..hAAAJFBELEHHaGAHEBAC.hAAAAICE..PCEHHGECDABChAEA...YDHBOABH....hAFA......hAGA...,1,-22,-28,6
HVAOFeBYgcNCaQUfWMPTGDZbIKSXLdJRE,FGEEeCGBBCAD....gEEBCDDDQBFAUADA.MHBGhAAAGFAFDCAGZDBDKABGSBEFhAAAdHGDEAHBAIEC.OBHFhABA...NAEHaEFGfABB.hADA...WHFA.hAGA...,1,-24,-26,2
CUTXQBMJfWgFYSEPGKHAORaVeNIZbLcDd,aFECVFFG..eEAAZABALCDGDBHF.dEABTGADBHDDMAIDhAAAJAAD....fGCDhAAAFGBBECAEKEEEHBEHhACAABFG.OGFE.NAEBICCECEHB.XDFHhADAWAGB...hACA...,1,-8,-28,20
VPgIDHGZQLTSJOUBREceWMafYAXFbCNKd,FCGCCGGHdCEF..VDEB..IEFADFCHHAADZFDHLADD.hAAASHGCUGAFBEAEhABAEAFEeADA.MDIFhACAaEHHABIDXBBCKHAG.......hAAA......hACA...,1,-25,-32,7
adZURbGgIFKXCcVeJBAYWQSOELfDPTHMN,QBDDOFFDLBAADCGAHCABMDDAdGDERAGHGEBHFEFHKAADCAHHeEHBhAAA.AHHH...SHFGhABAfFAGTGADhACAaDAA...........hABA......hACA...,2,-24,-18,6
LKfWDCOBAaJgUYVZGENHbSTPMIXQRdceF,aBDBJCFD..UAFBZGFGEDFE..HABA.SDDFPFAHMAABhABAQDAB.dHDDhAAAcEFCFEHBKGAGDICCCGGGBBADhABAAFBCVFCC.bBBD.....XAEFhACA.eCHB.hADA...,1,0,-24,24
VPLYQdKDXMReZaGJBCTcNUfSAFOgWEHIb,FEDAOHCAEGDC.HAGH..VAFHLFFHdBBC.DECGMIFEeCCEZFAGhAAAaFCEBGGFCACA..NCAG.hAAASAEFAHHH.hABA.WDFAPCHF...KDAFXGAHhACA.....hABA...,2,-26,-11,15
GWREcFaAYdCUZMLefQOKDgHVPIXJNbBTS,CEBGUEACZEEBLCCGeDFC..QAFGKAGDDCHH.HCDD.ICBHhAAAJACA.BFGFhABASEGARACAEHEAFHGEABBAdECEhAAAfHAH..OHAA.gGGBhABA..hAFA...,2,-42,-1,41
SQZRHABFTbDKfcEIGOeVYdCJMPLaUgNWX,FGHHTEAFDDGE..KDEAEBBF.GDFC.OADAVADD..CGFD.PDCGhAAALBAF.UFAGhAAAWFED..QEGDhABA..RAGHBFHHfAGAIHHBhABAeCCBJFCBMIAC.hACA...,2,-24,-13,11
dCXZRcfOHYTWVESAMBKeNUGDLIbPgJQaF,MECBKEHHUBFELCBC....IGGFPHCE..JGFCFEEFhAAACAEE.ZBAD.RECD.fEGHhAAAOACG.TBGFhABAEHEGABIH.BACG.NDAGDIGCQGAH.hADAaCCAcDED.WDDDhAGA..,1,-18,-33,15
agWNRXHQMILZBTcVUKAFSdbGeDJfCEPOY,SEFBGFBHDACECAFFECBE....ODEAaGBC....gBFHhAAANABC.XABAhABAMEHBIEEChAAABHFBVEBGAIAGFAGEeEHFPCCHWAHH...hBAA......hBCA...,1,-13,-39,26
STURAZdcaEIfKLYPVDWbBJHCXGQNFgMOe,ZECAdACDEDAFKHCALABH..VCGHDBGDBHADHCDFXFFChAAAGADCFFAFMHAC.SBFChABAUEGFACHEaHGGIHHBhADA.fBBEPAAH.JFAGCHEE.hADANIBF......hAFA...,2,-27,2,29
NVcLgaXYKGCTSUdZbPMfHIDEAWOBeQRFJ,BECBQBBBFHGG.JFAC..VBFFLHBG.aACAXBCChAAAGBEGCAGFSCABhABA.dFFHPFGFhAAAfDDBDFIFECHHACIBeHBA.RFAE.cAGDhABAKADA......hAFA...,1,-16,-18,2
aTEHXVJfNdRLDYIBWAOePGKSFUZgcMQCb,ODFDeCEBGCGAKBCF.UFAAZDBA..MEHBCAED..aDAGHFCDJBAC.hAAAdGACLGFADBADBAEEhAAAAGCGFAGEQBFDhABA..EGDH.fDDENEIE...hACA......hADA...,2,-24,-14,10
LWZBYSfQePKUONJVAMRFXbgdaEGHCcIDT,RBAAXFFEdADFGCFCHAED..CGAB.DDDDLFCFZCFBBGAE.SCAChAAAQDDAKABENIEF.hAAAABDBMAIB.FHEGaAHDhABAEEAEIGHC....YHAGhAEA.....hACA...,2,-25,-11,14
CAdPgSOZGaEYfUFMRbQHWLTIBJXcVDNeK,dGDCSCGFGBEBEFEGUACG..RCBAHAACLBHBBDEHJFECXEBGhAAADFCF..NIAF.KAGEhABA.CGHEAEHEOHFE.hADAaBFBfHFH.MEADWEDF.IGABhAAA.cBAChABA..,1,-14,-30,16
aIWMNXBfOFPGbAZdCcHeQYELRJDTUSVgK,ZBCCCHCAHBGHQFEHLEFHDGAHUECB..SFABVBADKEHB.hAAAaGCF..MAFBBDBHhAAAFGABbDDEAIHA...eACEhABA.ECHFJABAIHHE....hAFA......hAGA...,2,-22,-18,4
FHVEOJKLYDMcXaRQTNIBbgfGUCePWSdAZ,FGEGVDFDOEBG.LBHBDBEBMABF..aADGRFBH...TGAHhAAAIBFG.BHDDhAAAfHGDCACF.PBAChABASGHBAAGBEDFBKFCHYAHH.QDBDhAEAgBFGeEEDhAFA..,2,-27,-22,5
YWXKGETZAeJNOgSQBRdIFfDUMCVHabcLP,JAACODAB..QGAEBGBFdAAHFFFCDEAA.UCDB..CAFFaDDEhADALHCG..PCHBhAEAXDGA.EGHHhABAAFGDeFCE.SGHBIGDHMFBGhADAbGDC...YAHDhAEAWCCC.KBDC,2,-45,-19,26
aOCVJbHRZXMISfNYQgdcUDFPeTGEKLWBA,aDGBCCAG..JEAFRBCHZFAH..MDCA..IEHC.SFCDhAAAfGGAQBAGhABAdBCDDGCCeDHDTAGGhACAKEFF.BHGFABAGOCFGHFDGYAEHhADA......hAGA...,1,-16,-43,27
FDJIELGHRMeKdYCNfaAcPWQTVBXOSgbZU,...PDFFTBGHBAEDSADFZAAHUGADDGDB.EEHFLEHHhACAGCCDMHECeFDFdCCEhADACAACaGADAHFDQBGAhAFA..XCAH.OFAA.hAGAFFEE.....hAHA...,1,-7,-17,10
cDgXRMBfJZCbAOQeVFTYLKaNGSPIUEHWd,OCACQDBEFAHFLDFDKHBGGEGA.SAGHUECBHABGdBCDhAAADGABRDEFBGBFZEAHAFHCeHCAhAAATGDH..aAFBNEAAEBAFhABA....gDGC.fHGFhABA..hACACBFC...,2,-17,-2,15
VOINgACcZESWKGbJaRUBLPYTDdMQfHeXF,CFEAEDFGKAGFGCCE..JBBFaFGE.BEFGLFDF..TAAChAAAdBECMHECQAEChACA.fHBBhADAeEAFFCHHIACHAGACSAHD.WHFE.hAAA.bDDA....hABA...,2,-40,-8,32
KSHgZTIPQBORFaAUbJEVXWNcLYMDGeCdf,UFEFJEAC.EADE..XDGB..NEDFLAFBMACFGGBHhAAACCHC.dBGHKAADHFFDZCBH.hABA..TBDGIFHBhACABEEEOHACaGAHAADE..WAFCDDBH.fBAGhABA...hAHA...,2,-31,-7,24
ZagWFGUdJKTbREDfIBPQYcLVNAMSCOeHX,SECACECCHEECZBCC...aAFGFGBFGEGCdEHEKGDFRBCFDBBHBFAFQGBGhAAALAECAAAFeAHHhABA.XGDH.hABAgBFFWCAG.......hACA......hADA...,1,-1,-37,36
PXDBYOCULSAgZJadbKWceVRNfEIHMQGFT,JDHDdEAAKGEH..eEBHRCGF..EBBEHGDCGADHFABB..XADChAAABFDBCGGFLAADhACASAFEAIAEZCDEaEEG..cCDGhAEA..NEIE.MIAC.....hADA......hAEA...,1,-14,-25,11
UJAKdMCOEHRbGIgeNSDYfWTcVLQBPaFXZ,KEGHCGHDHFCGGBCA.eGDCDDCD....fBADTBGBLBABhAAABEDFaGAFFFAGXBDHhAAAJHACAADEdCEA.EGHHIBFBhABA.NIDDSACC.WDHBhAFA.....hABA...,1,-18,-25,7
bYfZIQNTacGdMLVHSPWeXRJDBKUEAFCgO,CHBCOBDE....bBGDfDGBZBBF.QEBBhAAAaFDAdBFGMADFLFEGHGFESEABhAAAeBBBRGBADAIBKAGHhABAAEEEFBAHIACA...NIDH.cGCAhABA.....hAEA...,1,-14,-15,1
DTEYHaeMZWQPdScLbCFUfAXBORGJgVKNI,XCAGOBFDGDBG..JEABVACBKEDHDDDEEHFG..HEGFMFIDhAAAZEDD..QCGBhABAdBAGcAGACHGFfBCBhACAAEAG.BGFCNIAD.IHBBaFAH.hAAAeFCB.SFFEhADA.,2,-34,8,42
HQPXOZgNRVLSIYeACfGWcaKdDEJbTBFMU,CCDGGBCD.aEGEDGHD.JCABBGGF.MABDHEBE.QBGEhAAAOHBGZAGHRABALEEBhABASEAFeHAGABIDWEEBhAAAKEGF...dFBF.EACA......hACA......hAFA...,2,-22,-20,2
PLQAMeGISUWYgNVZaJCfTFEORKXHDBdbc,GCEESFBDUACH.....gFAFNEHCaAGB.JGFGCGEBFAABhACA.RCBD.KHCCDBIFBAFChAAAdADF...cCGFhABAPHCE.ADDAMDGHIDCH...WHFAhADA.....hAIA...,1,-28,-33,5
EWLKXMYSQVZGfHUcOIJBCTeFDbRPNgAda,EBFGLGAAKFFH.XAAEMIEC..QEAAVDBH.GCBHhAAAUAEDOEHDBHABeBAFhABADBIHRGEG..PDHHhACAAAAAaEFG.SGDF.fDFChADA...cAGFhAEACDAFbDDFNIAB.,1,-6,-22,16
bZVGRXJcEIKFdaSfUPMeLgHQADBCYTWNO,BBEACHAH..TEGGOABAZBBBGGCF.RDFH.JBFBEDCCFHCGdBBE.hAAA.SECAhABAUGAEeAHHLAEE.hAAAQGGBAEEEDFACYHFGNDACXGEH.hAFA......hAGA...,2,-22,-15,7
eOdFDTBJRPEAVNYKCXMGgSfLbUZHcQaIW,VGDAKDDGMGDG.GABBSCBB.LCFAZGCAQEAChAAAIFAHOCAC.hAAADCIFTACFBHAAPEFEhABAAAIBNEEFCHBA...fHGHbEDGUGGAaCAHhABAeAFE.JCEA...hACA...,2,-16,-3,13
UcVKeWAaIfCNbPHZXSRgJYFBQDOMdELTG,aBAACFDC......NBHCHCBEZECCSEEERFAB.JHFGBAEDhAAADEABMBFAEHGC.LADHhAAATFEAUABDKCAGAHCC.hABAfDEHXCGAFHACdAFE.....hACA......hAHA...,1,-20,-24,4
PcNVIAYRXTHWOLbGDKdeCSJfZUaQEBFgM,XGABHDDALGDEGDCCdBHA.CCBDSBEEJGECZADH.UEAGhAAAEBAFBAFBFACH.MICGhAAA..NEHAAFCERBFAOEEAhABADIAA.KCBHaBAB....PEHD.hABA......hADA...,1,-5,-20,15
eANdPYDWKEZITbOGQFgXRBUCSaLMVfHJc,dCGHDCAAKFDDZEAC....IHADTAEDGCGAFGEF..XBAEhAAABDBFCGFFLHBGhAAA.MEADVADCHDCChABAJDDAAABC...PFFGWADFEGHF..hACA......hAGA...,2,-28,-22,6
geTWRBQcdKSAEFfHCPVZaOXJIDYGLMNbU,FGGGHBABCACA.ZEDG.XBFEDBFALFAB..MHFGUAAATFAAhAAABCFH..dEDFSAEAhABAAFGE.EDCH.hAEAPDHDOHDEIACA.NIAHeGDChAEAWDCF....cFCDhAFA..,2,-50,-10,40
KORZSFPfcGdbLXETHIeWJVYQAMUBDNCag,UGABDAEACDAC.KFFCZFGF..FCEE......PDCHfEABhAAAGABFLEHHhABA.TBBAHGDAWBGBhAAAJACCQGEDACAGBEEFaHACgECBhAFA.SBGBhAGA...,1,-26,-32,6
VbXHDFSALZGeUBfOEMdJQgWIaCNPRTYcK,ZAFFGCBBUBAGOFGFdHGD.QFAH..ICEEhAAACDGGNAAE.TEEHKHDAXFEBhABADFBBAEGG.BBHAEACEMAIDhABAJBEG...aCCF.....PHCEhAEA..cEBAhACA..,2,-33,-20,13
ZdRMaABQCJHLWgYEKFfbDOIPXNGTVcSUe,CAFALADC....gADDKCEDfCCEDIAC.OBHDhAAAXAGHGEGETEFFhAAASGDEUCBFZFAAhABAMHBEAEIHBEDAHCABYHEGEBGF..IABFhAHA.NFCF..hACA...,2,-33,-4,29
QXKTfUcJDLHCPaMeAVNWbRgYOZSGEdFBI,VDAC..bCBDRFEB.OADFZABEGCGG.dGBEBHDF.ICAChAAAKGDDUAGBJHFGDABECFEC.hABA.MGAGAFDG...hAAANAFA....WCHD.....SBHBhACA.FHAAhADA...,1,-27,-33,6
LVSMCdbaQDfTGZBIgANYXFUJcRHKEOWeP,XBCCFBFAUGAB.RFCE.HFFA.KEAAEAAH.eCFGLABB.MDDHhAAAdEEHQEAFhAAA.fHGDhACATGDDBCECAIAGNBEF..YHACcADBWEEChADA.SHFAhAGAaGGADDDG...,1,1,-33,34
COFBESceJZVKfTMIRPGWYgUdabAQLDXNH,DDFDHFCGCAAA.FABCBCGCSEEE.eAADVGEC..KEBDMACHhAAA..PAHDGFAFhADA..gGGHhADAUDBHaAEFAIBEXGAC.NCCFEDHBJDHDfAHEhAGAIAEBWDDC.hAIA...,2,-37,-1,36
XMVgAOHGIJDURcSYZTPeNKdaFWbEBQLCf,GDGGDAFGUCBBSAECZCFH.eGCGdGBAFHGEEBACBDCFLFDFhAAAXDAD.MIDChAAAAABCOBHB.HFEFhADAIBGB.JDED.......hAEA......hAIA...,1,-13,-32,19
QVHETAFbIJZCBGcXfYWRdeDLNPKMaOSUg,FBADJEEGBBFCGFCF...XBEB..fDBAhAAARBGHdHGFDCEDLCCDKBDDMAEGaCGAhABAOABA..SFHDhACAgGAGQGDD.EBBHhADAAFHG.IHBHCFAE.hAAAcEBD.,1,-11,-33,22
ASbWBIRGaLZMPcXNHeUKEJdTfVOFYQDgC,SGBDBFACGFBBZCAHMEAC..XFCAeHEAEAAEdGFF.TABHhAAAVEFG..FHAEDAFFhABACCDGAAHHIAHA.hACAaHDCPCFCHDCEKCHFJADA.fCDBhADA......hAEA...,2,-15,-12,3
BUAEDbdNKGYQOZceXCVFJaSHTRgPIMWfL,DECBdDCEKABAGBGA.QEEHOFHDZCEEeHAA..CHAEFGEGJADHHGEAhAAA.RCAAIABFhAEAMICALBFE.hAFAABEHEDHHNEIE....cAFBXEAB.hAIAaAAB.....hBAA...,1,-7,-29,22
aeYWABJMXELbgIVUDcNCHROTGdKQSZPFf,BAFDMACBLDGD..IABGVEDBUAGEDCCBCAHDHEABOGCEhAAAdADGKBAB.SHEAhAAAZBDCFDFH.fDHChABAaEAHeFGFAEEF.XEBE...hAFA......hBAA...,2,-37,-13,24
ABORYTMUKfEZLaDIbJeGdFWQXCNPgVSHc,REFGTGGFKBGHZBAD..DIBE..JFAFdDEB.QBAF.XFCGhAAACHEE.NFEB.PCEHhAAA..gAFDhABAHADCAADEBHHDMAIDECCHIHEB.hABAeDBF.FADDWGDChACA...,2,-43,-5,38
gDFVJULEYNKSQMXdCWfTPZAGHaIbORcBe,HBDDaEDA.OABHBBHAeGFAFGFDUDFCLBAF.EBCGKAHBSFBAhAAAMHAACACF.TAFAhABAAAGEGEAH.IHHHhAAARCEGDIEE..YHAG....hACA......hADA...,2,-23,-20,3
NcMgJDKeUVdTOEGIXABFRQaHLYZPbCSfW,BBDERFBBHACBLDAHZEFHCABD.SFEB..NBEF.MCHBDCAFeEEBhAAAUABEdGGH.TCEDhAAA.GGAHhAEAAIEAaHGEPCEC.fEHCWDDDJAFA.OFAHhACA....hAEA...,1,-10,-24,14
aVegfXOKGMYNDbWZRFILAUESPJBcCTHQd,UGEGSDHBBCAF.CFEH.QDFB.dDCAaDDD.VAAAeHBChAAA..XBEBhAAAKAEFMDBBNIBB.DAGAZEADFGHBAHIDJDGFhADA..TABGfGGEOFAH..hABAYGCA..hAEA...,1,-18,-28,10
WYcbAaZLESBefNQDOGMXVFgJRIKCdPHUT,LCAESFBHBBFBeFEAQGGHGAFAMCDHFDHDRFAE.CECC.dDADhAAAHEDGUACF.WHEAhABAbABE...AFABaEHFEHDCDAAAhADA.OAFA.......hADA......hAFA...,1,-5,-20,15
VdegGbQUJANMPRSfHLIBXcZOaCTWEDKFY,MHAGSEHBLCGFBCFHZCAB..CBDEECBGDDCFKFEB.FADCdGAG.hAAAGEEC.QAFHhAAAAAGGNIEH.fABHhABAIDEBODDHaHGA..WEAGeEHHhABA......hACA...,2,-33,-20,13
WIDVKCJBdeSRcQLGHUXPZAgNfOYFabMET,...fHFFODEGFDCHMDHDEEHF...IBBDKBAACBDCBFFChAAAdGBEREEDLHBCGAFGXEAChAAAAGGH.NBDGaBHFhABAWFAGDCEH.eACESBFG..hABA......hACA...,2,-47,6,53
YHebZDKfNacWXCVAMEdGFQgBOISTLRPJU,MBHFGCCHFGGHBBCF.SHDGRDDDUGABHAAGeFHHZFCF.KAEANGAF.hAAA....aDAAcAEHhABA..CEADAFGCdFEEhACAOEHDTDAE.LBHH...hAAA......hABA...,2,-24,-8,16
ZPXYHBJKNbEMTdOeSIgfVaGWFLUADCRcQ,CCCDRDAHZFGH..XEDFBFDHKGEB..EHGAdCFBOAHH.eGAGhAAASAGG..hAAAIFHFVABAaHAAWEAGhABA.FADFAEDCDGGFcGDD.....hABA......hAEA...,1,-26,-40,14
YUMdJSAEGCgTWfHIcFbaQKZVPDNOeRBXL,GFAHTEFG.HBDBFBEA.QGGEKECH.PBFCDHEGOHCChAAABAHEXFEFLCEAMDBDhABAJAABSDBFhAAACHAH.WHDGIBBFbDFE.ZACB.eAHBhACA......hAFA...,1,10,-22,32
aODUSfYWTcFKGAMZHPIQRbNgVLJBCEXde,MDEDZEFHHGBA.QBCGRFFC..gADALFADBFHFhAAAECABdHBBaEDFDDGCSACEhABA.WFFDhAFAFDFHKAGGAFDB.IFCBbCFA.NIEHCGACOBBBhAGAfAAB...hAHA...,2,-24,-9,15
CPIBaXOUFAGVReSfEbdJHgQNKYLZDWMcT,RFACeBFAEHEC.dBEGHCAAQGDEKEDBZACEDIAGMACA....CAHABFFDhAAAaAAHUGBAAABC.SEFBhABAJCHD.gBBBhAGA.YHFCWAFH....hAHA.cDBH..hAIAIHHG.,2,-34,-4,30
TSeAbXNfBFLWZKVaEHUDROQPdYIMgJcGC,XABGBFGHFECGLAFBKGAG..VEDCEBCBHGEA.DEAHRCAAOAEHhAAAdBAA.MIAGhACAJHACCEFGSCGFhADA.AAFC...bBGDNEHEfHDBaFBC.hAAA......hABA...,1,-18,-28,10
JUIBWCLAfYdDXgOeKbQEcHVSNaMRFTGZP,dECDDHCAOBDFeAEEKHFG..QEFBEBEDHBAE...VDBFaCGFMDIBhAAAFAGHZAAG.JFAHBAHBhABA.CEGGAGGE.fGDGhACAYFHBXGED....hAAA.cCABNDAE..hABA...,1,-14,-27,13
OFCcXgaYMEALIbRGSPdTWNHeBZJQVKDUf,LHEARBBHGFBDdDEBTEEDHFFF.BBEGZDACJAHHKEHD..DABBOACHhAAAFEAB...CDGBXFABhABAaBHH.EBDGIHABhAAA..SGHB..hADANADB......hAEA...,2,-27,-21,6
SGFPXRKYCeNWLMgBOcbTJdHADfZUEQVIa,DDBGUGEAEEGBQDCB..VEAASAEBFBCGRFDE.KGAECBAA.hAAAeAAHLBHBBAHFOCFFhAAA..bAEDhABAJEHHADABZGACIHCFaGHD.XDAD.hACA......hADA...,2,-18,-18,0
CRGJOUbBZPKdNASQLgWcYHITFVefaDEXM,LFGD..gDFA..YDAGIGDGFBFFhAAAfFHCECHBMCBARFAGhABAJDBHUFDGBADEKACGABCCSDDFhAAA.QBGD.hACAcBAF.TGAEhABAeHAGDAFCCHFC,1,-12,-41,29
EDBAcfSRLXCHOQgNFIWTbKZPUMGVJdeaY,SFDHRBBCCEGE.QCGEFAAG..TBGAZBEHMEACJDDG.hADAaABD.DFFGBFBDfGGAhAAAHGFEOFAHhAEAgGBD.NADBICDHKAEH...hAGA......hAHA...,1,-11,-35,24
KdgPJRacSfWZMOCDGbTBQUEYIXNFVeLHA,KBGDdBFCJADBREEE....aBACSGAEZGEG..CFDGGEAEhAAABGHBEBBB..XDBBhABAFFEEeHEGAIFE..PADAhACAfAHC.MCIHDDIF.QDAGhAAA.IHAAhABA.NEDE..,1,-24,-35,11
DTBZLCMPXNWQHRbIaAOcGJUKdgeFSEfYV,GAFCUEGHKGBEeDAA.SHGAEBFF..VDDBDACDBEHHhAAACAEA.MFED.XFBAhABANHDDHAAB.RADHIHBGhADAAAAFJAHD.dFFAFEAA..YAHH.hACA......hADA...,1,-3,-30,27
RCSGWEbADILBdPYZKegUJXMTfNFVaQcOH,DCFFLDFBBFGCdCDCZDAAeHCE.UBCCMBIB....NABD.FFBChAAA.aAEC..OAGFhAAACBACGGDDEFBFAFEC.IHGDhAGAKCAGJHAC.fFHE...hABA......hACA...,2,-42,-20,22
NIWFZSUHTeLRVKQGPagEcXMYBAdODfbJC,OECFDHEA..JDADCBCD.....ICGCZDAHHFEG.LAEEhAAARBBDKEEG.QCEDhABAaHBG.EBHHXEGDhAAABHHAABBBfEHE..NACDFFBEhABA...SAHBhBAA.,1,-16,-48,32
GFCBRQNDJEAZVXYSaHfIOPdgLcMUebWKT,XEDBaDFCHAFDOFCFdBBCLCGD.MIAEbBAB...KADBTGGGhAAACGBBBGHHQADAhABADAGCACFF.ZEDFSAFGhAAAICHA.PFFB...cDAHhABAWCADFHAG...hACA...,2,-36,6,42
gENOZCXfGLYRAUDTdJKWceFVMIbaQBPHS,DBGCJECB.KDEF..eHAGFADB...MHFCaGGD.BEGDHFAF.ECFEZACFhAAA.CBBHGAEFLBADhAAAAGGCdEEA..WFDDhABAIFAF..PFFBNIEH.OBCHhACAfDHGYEHH.hABA...,1,-19,-34,15
NPWCaYOgGcBSXbTEQJKLZAUedDVRfMHIF,UAGDdEBHRBBGHGCCFDGD.....NDIG.CHCFODAEGEFEBAHF.hAAASGABXDDDEBBEhABAQAEF.hACAKAAEAGHGDGGD.MFAHWCGBaADC...cGDDhAEA....hAFA...,2,-42,-12,30
THKEVMJXbNCPUeALGafOIgDFYSQWdBZRc,aDADOADA.DBCEFBBF.QAEEdFCGBEHFZCEHRCGFHFEA.VDCGhAAAXDCE.CHHE.UGBBhABALCABfAGHhACA.IHHASAHF.TGEGhAAA.....MBGFhABA..,1,-10,-27,17
YPGHaCZEfeODWFgNbLMXTIASUVBRKJcQd,UGDDVGAE.RBFF..KECCJCBF..dBHEGACBHCADZAAEEFHF..eEEChAAADAFE..FEGD..bBFEhABAMEIB..IHFEhACAAHHDBAEG...cCCF....hADA......hAFAPCCAaFDC,2,-29,-20,9
YLFSZMdQWGUgDKaJOTfCPcNXHVIBeRbEA,FGCBMAAGdACAGFDFDECG.KGAD..JCFGOBDB..CHHF.NBIA.HAEAhAAABCFEREAH..AGGC.LBBBhAEAZFED.WCGHhAFAaCBC.....fHBH..hAGA..cEGAIHHFhAHA.EFBC,2,-43,-18,25
WGOYKTcPHCFVgJZQAdBEeIUfLbSDXRaNM,EEADeCEAUDGCLAEG.SHEGDECBRBDD.MCBDGGBDOFHBhAAATCADHECFFGGHgGADhABAQAAHADCEIEEChACA.fCHAXAGEaDDHhAAA......hACA...,2,-20,1,21
QJeRGgKDYBLCUEXHOcWIfaZSMAVdNbTFP,VAFHdCHC..TGGHFCBE.QFCCREEDGEBCDIFELBED.hAAAEAGEOACG.IBAChABAfEAESEGBhAHAMIAEADBCNAAD...JEFD..KGHBBBCHhAFACHDF.....hAIA...,2,-25,-5,20
LWRgCfUBdcQVbDFIHXAENPMZGYOaTSeKJ,EDDBMECAZAFHGDAG.OADFSABGKDGGLFFBRFFHCBHD.BHHAhAAAdFCCQDABhAAADBAAFFHBHFDFAHAG..NDIAaBDEhACAJAHH.......fFEChADA......hAEA...,2,-22,-15,7
LWYHBGROMfNVJbCQgEXZcDTFSIeaAdUKP,UAFHLBBCHFFHBHEAGCADOFCHMEBB..VEFBCGCG.EAFFZAAEhAAA.TDEGFDDASAAChADAeFHHAHEBKDGE..hABAPBHB...WEAE...fFAGhAEANEAG..hAFA...,1,-3,-33,30
OTDaCIPgFNXGEAdBZbSUcYLQVeWJRMfKH,dDDAZBECSGFEUCAFLAFG..eBCDJGDG.MIACHEAHDGIBCHGH.hAAA..IGADhAAA.FEFENCIAECGBAEEBBBAFhABA.bAFAQABD.WHAGRCABfGDGhACA...hABA...,2,-26,-11,15
FKQIEOVPDfHGXdBAeCJSTMZUabWNcLYgR,CHFETFEGUCGA...aGBH....NCBF.LABH.RDGFQAGAhAAAOEAHDEBEHFFChAAAXADF.AIHASDDDhAGAbFDH.WBFDgGBAFGDH.hBAAKACG.EEEE...hBBA...,2,-30,-17,13
HYXdZQbUEfGFNAVJLKecCgWaTPBOISRDM,JCCFeCGH.CHAA...aEEFBFBA.OBCARCFEMBFAHCCF.XAGAhAAAdHADZGEEUEGF.hABAEDADGFDH.AGADKCAFhACA.WEHHTACE.IAAHDAFG.hADAQFCBfBBGhAEA.NIDB..,1,-18,-20,2
GKLOYVcIQBaeHJFbURWTANfdEMDCPZSXg,dGCFMBBDCBGEZBCG..SFFBGDECLEADVDCA..IGDAhAAABBAEaGHB..HAEGhABAFDHH.RFABAACEEACCDCCA.hAAA..PFHDgEBCOHDE.cCFHhAEA.....hABA...,2,-26,-6,20
MHNAcXWJZKUSCRIgFfaTGEeBYdPLDbVOQ,XEFCZEAAKBDGUFEBRBDE..FDAB..aGAAEGAA.BHHBdHBHLBBFhAAADAAE....hABAbAGFOAHFMCCD.NIED.hACAAGDDJHEA..SDEAIEDEfACFhAFAeADE...hAGA...,1,-24,-29,5
XJQOHgFbWCceaRSPVMILKfZYNBTAGEDUd,DBGCdEACQCCBOHCGHDDEFHGC..CBAB.aGEHRACF....SCEEhAAAPCFB.IGGEhABAfADC.NAIEBFHDhAAAAHIFEHAGUEAD..gGBChABA.cABBMIEA.KBFEhAFA...,1,-20,-27,7
EPIBfdACMQHXUSaLDOgWVJbGZeNcRYKTF,CBABQEBDUGAA.LCHFDDIF.OBEA..gBDChAAAJGFGGBBHeFEENACBRDEF.hAAAKDFE.FDAAEGDF.IHAHhABABGCAAHHEMACE.SHFGhABA.aAHD....hAGA...,2,-38,-5,33
XQCSfMTDRZIGYOWVBPKJbaNFeHdAcUELg,UBDCEFADLFDBQDGECEBA...MCACDFFDZCAAGFCHOAEAhAAABDAHKGGFJBFE.aHAAeBBAhABA.AHCD..XBEDhACASHGG.fFAFTDGA.IABFhAAA...hADA...,1,-21,-25,4
SdJCEaRKMfYAbGTQcXWNUOPFBIgVDZLHe,GFEBTADC.QCGH..cCGENAEAUGBH..FGGEBBCEhAAAVFABDCAFHCCFdAFBCBFHhABAaCAGMBBBAABF..XEFChAAAOHFEPCCHIGDF.gAFBhACA....hADA...,1,-9,-17,8
eadPTfWGgLUOKHVFIEZNCQABbYXRDJcMS,BCEGXBADDCBC..MEFEaEAC...dAFDTACBGEBDLEHBhAAAKCGGHGAEFDEAZGFCNGCHCBHCAEAB.hAAA....YHDAhABAJABC.....cDDC.SHAAhACA..hAEA.fBEH.,2,-30,-8,22
DeQEBCAfLWgFOZVaXPdcGITbHKSRMUYNJ,LFECFEEGZGFE.XGDGdBGEGDBC..IAGFTACBKEGAhAAAMEDE.UACG.JCHFhAAADIAC.EBADAABFfEBEhAFAOEAH.aCBC.....cGGChAIASDDC..hABA...,1,-18,-31,13
GEfXbgPLCUBOIVTYDHaJeWAKZdFQRNcMS,KFAGZEDFFBGARCCF..MAECECEA....XDFA..PDGFhAAACHADBAACOBDG.hACATBACDBCCaGGAJEEHAEACQFBGhADA.NIED.SGHHhABA.fBHEhACA...,2,-43,-30,13
ZXNdFKPGbUDAWVJYMOfgHEBSaTILCRQce,VCEBMCFG..OBAFHDAGEBCABHGA..TAFCCCDBREEB..eFBGhAAAZAABXDGHFDHB.hABAPHCGbGBG.DIAGAAHHJCCHhACAfGGE..aAECQFAGhAAANDAE.....hADA...,1,8,-21,29
WKcOLGXDCZYVQEPJeTUHNIaAdgFSBRbMf,dBHCSAAHRACD.MDCFKGHBOBED.GGCBXDDCDAAEZFABhAEAVBGH.EGGHeCCDhAFAUEGHHEEGaAEGABDH.FBEDhAAA.BDABWAGFLGBA.CHAD...hACA......hADA...,2,-13,-9,4
OVYRAXLHIbSWFGUgZfEQDJdBPMTaNecKC,LADAHCAHSEEEFDDCGAGGZFBBEAFGQAAEDIFABFFDMGFGhAAAaBHD...eHFGCACBOCEGhAAAVEADAEIF.bFDBWEGHhABA...fCCB...hAEAdGDE.NEAG...cCEFhAFA.,2,-13,-5,8
BQSEcIPRaCDOYVMJWUAdLFfKZNTHgeGbX,FFCHKECAZEEDHEEGGABFBHEAQACD.EGHHcFAH.hAAARBFADAECOAFE.YBABhABAMIBCUCCFAICALDCAhACAfEGA.NAAE.eFAD..SHGGhABA..hACA...,1,-3,-23,20
RfNZEDWLPeSgCbTcKHIVYXFOJGQadAUMB,MBABBGFARAFCZCGBDABFLGBA..SFDHCAFF..TCBGhAAAKCBGHCEF.VEAAhAAAXGGD.OFCGhABAQACEaBBGAIEEfDEBEHGCPCHF.hACAeAGF..cGAHhAFA..,2,-29,-18,11
DHVYWZMEUBcLGgaJFIfRdCbQKXOeNSPAT,HDAAVAED.ZADA.ECHFBGEHLHBEGDAHaAACJDGD..FFDARGAAdAADhABACHHG..QCDEhABAKBCH.XAGFhACANIEHAAIF.DGGHMCID.....gEDAhADAIFHAbFAC..hAEASAGB.,1,6,-15,21
FeWYZPUbfTNMXSLCKDBHJQEROgIacAdVG,dBEAFAADeDDGZEFGUDBG..TEABMBGHLAHDCGFG.BBCDhAAAJGBGRAEA..OGAGhABAaHECACCE.....WHEChACAYFFC.....fECDhAAA.NAICSHAGhACA,2,-45,-21,24
LdcIGAJWHPMeDSKTbfRgCZBOFVYNXUaEQ,HDFEMAFBDCGGSECB.KBEHTBBH.REFHZEBEBGGCOABAhAAAYBAH.XGAEhAAAaHDGEHAA.LAEChABAIHHBAHDFPEEB.eDADfAGDhAIACHHA.....hACAFDGA..,2,-15,-13,2
aAOBGNYPcJLQKEgVfeZHWTRbFUXIMCSDd,BBDBGCCF...PBABJDAAKHFG..EGHH..VEDEeAGBZFADhAAAHEBD.TEFFhAAARCGBFAFD.IHEC.hABAMAIFSACFDBBCAFAHYHAA..hABA..cGGF.hACA...,2,-41,-6,35
ZHYVKUAJISRcPBEObGNfWLadXgQCeMDFT,JDGHRDCFBCAH..OFAFGGCD.....fFAGhAAAaADBdFDHQBAECAEGDEFAFABFHBFEhADAVAEE.AIGC.IHDChAAASFGE.ECDEWECC.LAHHhABA.eFHHMIAA.hACA...,2,-25,-15,10
dSRANPfIaJDFWEYgOUGbLTeQXMKVZBCHc,...PABBIHHCDEDD.EDDC..OEFHUGBBLEFHhAAA.eACGMEHBVBAGhABACEAHdADDRBFEAFFDaCEE.FAHDgEAChAEATGBFKHDABAHBSGHHfEHEhAFA.....hAAA...,1,2,-34,36
ceHGJWaYgUdMCTFRNLfKSVDPQIbEXAOZB,BHDCeDCFGGDBaDFG.UAFFdEGCCADCREEELBAA..KAAHDIGEhAAAQFBBEDGE.hABAAAGGOAHDZDAB.JCBGhAAA..WAEDMBEANIAD.SFFD.hACA..IHHFhACA...,2,-43,-5,38
aVQJCKPdTYegIfSRAFHWBLGOcEZMNXUDb,FCDABACHOFECEEFEZAEF..MHAGUEBGDAAE....aHGEJADAKAGGhAAAdBBA..eHDA.hAGA.fEHGhAHAAFFDLCDBGDBDNBAC.XBGEbGAC.CHHF..hABAYHDG.SDGFhAIA,1,-20,-28,8
CQDWfOeJdgNBTMZXbYVPKULAEFRaHcSIG,REBAaEDAHAEG..SCBDIHFECDBAQFCA.DGGAfBAAhAAAeBFCdCCBNIEFMGFEhABA.XBDGhACA..YCHFPHAEUDGEAHHAEFAAFABA.hADAWHAGOEAHBGFD.hAEA...,2,-12,-10,2
cRSeJMLNBaZbFCQAdKGgXOYHITEVWPDUf,dDCDKBECGDECOGCEHADGEBAB...VEFBDCHBUGAG.RDCF.eCAChAAAMIEEBEAD.ZAGHhABACAAEACCD...XDAGhACAIHHD....PEHDfCFChACA..SAHBhADANIAD,1,-28,-29,1
cbTZQgKXNHPYGBeAICRdWDLEMfSVFaOJU,CBCBRFDHDBBDLCEC..EDGEMCCH..SDDFaAAB.JFHDhAAAUFEB.TGBHhACAQAFEXAGENEAEHCEBhABAGDDFAACG.dDAA.fAEFODBDcADGhAIA....hBAA...,1,-10,-27,17
eTMbPCaIgZSWYURJKXcABVGDEFOLQHNfd,GBDCEFDDFAAC.QAADHCFCdGGB.eHEGMFECCCAA..aDHBZBDDSGDDhAAAUFAHKCAFAAIDDFCB.hACAOFAB.fBFHhACA.TFFE..ICCHhADAWEAE.....hADA...,1,-16,-23,7
BEcdDeYfFVRQZJXSTIagUPMHAOWKbGNCL,OFCCKBCCGEDBLFHHEAGH.DCHF.eEBCFHDCQDAEhAAAZGBA.SGHFhABAIBBFUBDAMCIFACEDWAEEhAAANACHBDGG....YBAF.RFFH.hABA......hACA...,2,-21,-18,3
cdFOMGWHBLIReQCVTNZAJaPSYUfKEbXDg,JFEAaGBG....SDFHUCGEEADB.DBDFdDCAFCEFGGAH.BABBhAAAIAHB.QCABhAAACHHB.NCHAAHIFhABAPAEA.KBBDbGCE.XAEE.hAIAcABB.MFAEhAEA...,2,-34,-33,1
CbcIVEdSGATKaJMXQYBFgHODfWPURNZeL,KCHBJAGH.QAFDFDCE.HFFCDDBF...fHEDUABDZGEELHAChAAACEDC..hACAIABCdEFAAGDE.aDAHhAAAMFIDXEBDBAED.WHAE.RACH.eFAAhAFA......hAHA...,1,-9,-33,24
eSgZHLPOfXTFGWdJYIaBADVQNEcCKURbM,VADCQCDE.EGFFKEFB.RAAD.MIAGeGAASEHHZFDF.hAAALFBAOCEEXDAChACAGAEFWDAFdHGBJDHDhADAIAAEBDDGAAGEDFFGCHCA.UCBC.HCFChACA.fACHhAFA...,2,-10,-2,8
KfcRGZIDXLJVAPMeETWFgdOCHbQYUaNSB,MAGHEBDFFCFFdCBH.HFBCQGGHUACB..aEEFSGBChAAA.BDEG.fHCDhABAGGEDDDABXEAGhACAJBHHAFIFeHAG..WFFCCAAH.NADDcCBChAIA.....hAAA...,2,-21,-17,4
NBWXVZMOITCGULFDgSdaPeRfKEHJcAbYQ,QACBBDHC..XBAFZDDGOCHBTGBFCAACLHAGhADA.DAFCdAGFeGBCREFFKCDAhAAAJCDGAEAH..NIEDMFCAhABAUFGDFBBH.SAGAaEHDfBEB.hBFAEGDG.....hCAA...,1,-10,-19,9
EgMRGdeWSbXOYQCDUTLfPIcAJFKBZNaHV,FCABKDEBZADAHAGF.EGDCMCCFGDBC.eABGSHDC.OCAFhAAACEFBDDEALHFGhAAA.IGGEhADAcCGBAABABGAHVEGB.dGAAXCCB..hAEAYAFC..hAEA...,1,-3,-34,31
ZDeUfQNGSVOBHRAaWFcXbKIYLdMTECPJg,FACCXECDKCFHLHDCdGFD..MAIDCDDA.JBEHZDGB.DAFAUBABhAAA.QEABhABAGAAEODCHBHBFAHDEaBFGbEFEhACA....IFEEEAGH...eEADhAAA.NEIE..SAHHhAEA,1,-19,-26,7
TKWFcEOgYXDdaIAPBUJQfNGZeRSVHbCLM,BGHCJCAE.QABFGDEBeAFGREDEHFAALFHBKCABFDHF.EHCAOFBHhAAA..gAFGhAAADACCdHDDAEBEfFDEhABANDCH..SGGDCGGEMCFC..hACAWBBE....hAHA...,1,-9,-25,16
DcPCJgIWYEdOFRLTUMXAVfSGZQHeKNBba,VADBGAGE.ZEFAQAABKECDBCCFDAEACDHB....JEGB..hABAIBECEDAEdGBCODEFhADALDEDUAGCAAABSGGDhABAeDDD.aDAHgGDGFGDH.hACAMFAHfGBGhADA...,1,-3,-35,32
KVWMORgHPTCFaIAGNBdeLYZQXJUfbSEcD,GBADBHFAeCDGLEBDQEAFJDGHUFDH..SGCDhAAADDEBKAGD.MABGOAEFhAAAREEFPEHDCHHD.IAGGhAFAAAIHdABF...XBBB.fDDEhAIA.EBEEWHDAhAEA..,2,-28,-24,4
OLYSHcMUdfPKXFCITQZRNBGaeADgbEJWV,DCEGEGFE...VDEHOAABLBHFHDBCMBDCdHGD.KCFFFBBACCHG.QGAAhAAAZGACBCBFaHGEhABAeEAC.ABAD..JAEESEFAhACA.fFABIFHENDAD.hADA..gGDDhABA..,1,-11,-26,15
GJfdeECNZWBgLTaSAHMcPIRDFQVXKObUY,HDAAMEBF...IFCHFFEDQBBBKGBDOACDUCGD.JAFCdGFChAAA.EEGGCHHD.ZAGBBDEHhAAA.LFCBaBABAHGGPAFHhABADFIH.....XEEC.hABA......hACA...,1,-7,-35,28
KgQNGaScDRZBfPYLHFIdXEeCTbOUAVJMW,MADDKFCHQAADGDEF..SBGADEBGBGEE...fBAHhAAAPCFFHAFGdHGFEFCGhABACADEOHDCADEEJAEGNHBBaHGAhAAA.RFAD.LFFA.XEAHeBDB.hACA......hAFA...,1,0,-17,17
AKbDCRSQMYVZBeagGHNXPFTUJcWLfdEIO,DHAASCEGMFCEZGDGeFGF.GCACHCCAXDGBFAFDUAADJFEBhABALAFG.EAABIHCBhADAODADAADBCBHDQDGDhAEABHHD.gDCBNCED..hAFA......hAHA...,2,-15,-12,3
LPBTWZUIYHAfbROKQMaFSgeNcXDdEVCGJ,RFBBOCHFKEGF..MDDCaADC..FEDB..SFAFeCFD..hAAANCCA.DECCdFFHCADFJBEEBAABhACA.ZFAFUBAE..hABAHGCGAIFG.fAGA..gFEDhACAEGHF.LEHBhAFA.,2,-38,-11,27
UHGNAXfgDYTSERBVPcIQFdZMLWbeCaKOJ,XDEADEGA..TCEFSBDABGFH...VFAHIBDEhAAAQFGDFFBFMACAhABAbABCeFDDCHHC.aEAAKAGEhBAAOCAEJBBH.........hBCA......hBFA...,1,-6,-43,37
SLPHXgfBENGeAWJOCUMbcaRQdZVDTIFYK,JEGHCAEDUGDD..MADC..aCEGRBCHdCGDZAAH..DDAFFAAF.KHEELCHBhACA.HDFHhADAXFBCBHABEHGAeAFAhACAADDD...OCEF......hBCA......hBEA...,2,-36,-32,4
JTHZecVgBQMEPKAOCDbRNWXUIfSaFdLGY,DIEGRFCF..XCBDUEGH..SAFDdBGCLAAGGEBATFGHhABAZAACeCDF..hABAcGACBDAHEHGEAAFHCEFA.hACA..NAHG.fDDBaCAAFEEF...YHEAhAEA...hACA...,2,-21,-14,7
VaGeFOWCJRTMcBYNdEPQDgKAfHUSXLIbZ,HDAFSECEXGEHLFBFZGBEGCEBOBEECHHFRACA..TABChAAABBAB.dGEDEEEGDEADKAHHhAAAAFGA...fFCFhABAIDFEaHGEFCCH.MADG...YDHHhABA....hAHA...,1,4,-30,34
fBSdUXVORNYLIcZgeCaQWTbGMAEJDKPHF,ECAFJCEH.DAFAKAGB..FEDGBFHE..SBFDdDAEUAAB.OFFEhAAA..RGDELDCFhABAIEBEZGBE.CCDBQCGGhABATGAAMAIHAAIFHABD..fAEEhADANIED.gGGBhAFA,1,-27,-33,6
YDBgFVPWRLeMUSCKZEdcJTaINGAOXHQbf,OACEQCGD....bGEEfBDHDDHFBFCF.FFCBVCAEhAAAPABB.LGFGhAAAeGAGMGDESHBAhACAZBFGEAFGdDEDTEGCNDIAABAC.XDAC.HDDHhADA.gAGChAEAWHAG.CGAD,2,-17,-4,13
QJCWUHFSETdNZaKYRPgIAVLecBObDfMGX,LFFCeEEAOBDGDBHBMAFEGCBD.QBGHCEAAHCDH.SEAHhAAAEGHDdBBDZGBCKGHF.hAAAPFCBACFGBACCXBAGhABA.JHDG..WDFA....hABA......hAEA...,2,-29,-1,28
VSHWePETIKFQBUXGCMAJcbDdZNYLRgaOf,JBABDFBEdGFFZFBC.LAGF.RBCG.aCCH.ODHHSDDG.hAAAeHBGEABGKHBGBFDHUAGFhADACBBC.AHHC....hAAA.NBIE.fDFC..WACEIGFEhAEA...FBEDhAFA...,2,-33,-33,0
fVaKEYSeTZAdcIMHbBXgWLGNDPCJOQFUR,dDEGMFHFBDCG..XBGGLABEGEBFDBFACEHH.QBCHhAAA.UGACfGAHhAAAaCADEGEBeABCTGDEhAFAADHBIAHEHCFFgGGG.WCBChAGANDIG.OHAE..hAHA...,2,-33,2,35
UIMKLRNVbYXGAcaTSQdDfCHEBeOJPZWFg,aAEASAHH.QBBADGCGHCEAeCAEOGAAZDBA.FHGGgGGChAAAMGFEKAHHRABENEFG.hABA....YHAChAAAACEGTCFD.CEAFBHBG....WDADhABAIEHH.LEDHhACA,2,-25,-8,17
TERDFLcZPBIgCAJbeOGYaWdUSQHVfXKNM,JBEAOAACGEDH..aEABUABFHCCA.XGFAMIEE.ECHFRCCCDHBGhAAAFFCA.LEHBhACA..ZGBCBDGCCEEBAACEbBFFhAAAeAFEdFGFQEAH....hAEA......hAIA...,2,-16,-4,12
FKZgNMRLXSeAIYVQdJUfCEOTbDPGHcaWB,VADGJGFA..CGCH.OEEF..TAAADAIBGABGHAGHaAEGFGCGKDAFhAAA..ZCDHMFIHhABAXDAFAGHF.IDFBhAAAdAGE..fDFBEFBA...hACA......hADA...,1,-25,-29,4
gNeCGTVKUPcZABbEOWaMIYdJXRFLHSQfD,BCAEOBAAMFEFdHBFRDEBFADG..LDDFHBGHSGBHQAGChAAADIFAeADGGBEAKEHB.hABAUCCE..cFABhACAAHGCEAAAaDHDJHEGgCGA..CGAC.hAAA......hAGA...,2,-18,-3,15
acgAEDHFISVZNdRXBKWMQfGTJLebCOPUY,EDFBFFFC..SHCGZEAHdEHCRBAEBEDAKCBB..MAAEQADEhAAAGAGELAEBCHHB.hABAOECFUGCGaGAHAGEHDIGEhAGAHAFCNEBC..fBCDeFFB...hACA......hADA...,1,-9,-18,9
UVCQHOEgYKGPbDXcIRLZeadFNJWAfTMSB,TDFFBGCFUCEF..CHBFHEAEEAFA.KCBGGBAEDAHH..XABChAAAIHFALHFEhACAeFEGFABAJAEH.ADEBMDIFhADASHBAOGCAYBHD...hAFA....PFABhAAA..,1,-17,-24,7
OgHEVaeXIRcWbFMLTJPfBGUZACNQDdYSK,QBDADDEHdAAHKHCC.HGFG.aCHBeDCDRBAB.....bFADLGBChAAA.TEFFhABAfCGGBFAC.UAFBhABAAAHHCDDGSADCEFGAIDAC.FBCEMDIDhACA......hAGA...,1,-12,-26,14
FDegUKENJQSMBXHITYRcPdZVWLfOGCAab,aHEGDIEGUCFB..EDDDQFABBBHFHFAE...IBCChAAATDCARBACdEGEZGFALAEHhABA.fDADhACAOADFAABHFGCDKCHBSHAGXEGE..hADA....YAHHhAAA.,1,-9,-32,23
YOgbPeIEaLHFRCAZNJGcTfXSdKWVDBQMU,ZBCFJHACGCBB..TBEA.XDAFKBFCVEEEBGBHUAAAhADAOFEC..PFAAhAEAIAAB.aACAhAFA.FDGCAEHCfGHGdAGBDIFEMHFG...hAFAYHBGgGDBhAGA...,1,-15,-32,17
IbJKVSeCfBWaZDOYdLETGHUXNMAPcFgQR,FFFGRDGB..JCAESHCA.CEDBBDAAaFBCDACE..dBCHEAAE.hAAAHEDAUAGH.XCFEhABAMAGBAAIH...PFHDhACAgGGG.ICEGKFAAfFCBhADAOHBE.YHAEhAEA..,1,-22,-39,17
caBQZGIRbKEdgLOVPAHXTSNWYCMeJUfFD,HACBSGDB..NCFGCEAFMEFF.UAFDFEGFDBHFBBABGFAFhAAARCCEKDAF.dGGD..ODHBhAAAAIFGXBAB..hABATGAB....WHAG...hABA......hACA...,1,-25,-38,13
TRebWdaPVcBHSDgFGYCXQJZEMUNLfIAOK,TAABRBECeEFD..dDCEaGCH....PACABHFCSCFDhAAA.DFAEFHECCEHHXBDBhACAQDGEEAHBMIAGhAAA.LBBDIDAFOGACKEEDWDCBhADAcAGAgGGBhAEA...,2,-34,-14,20
RfQaUVATMCHBeEKGdOWcbSLYDJZXNIFgP,MFEHHEBHeGECGABDdBAEODGH..cAFFSAGB.hAAADFAGJHFGZFAGXEDBhABANCIE.IDGDhACAFDDAgBAGRACEfHABaHGCACEA.CCDG..BEAChAEA.WFFE...hAAA...,2,-21,6,27
KCAFHZTQIDRbcXEMGNWdYPUegJSfVaOBL,HBEDZADDQFDDDBAGRBGH..XFGAMIEGGCFCdDBAUGAEeHAEhAAA.SDAAhABAaDDHBHHDKGFFFEHDIFBGhACA.cAGCNAEHWBAAgABA.hAAA......hABA...,2,-24,7,31
RDUaTbVfQMYCJELGKgSNFWIBAOZPHdceX,ZFEAdEHAeBAEDCDFUCEF..TBGB..VFBFQECChAAA.CEABEHACLBADhAAAgFEFSAGChABAFADABCAEAHEF.HCDE.cGGCaFABMFFG.hABA......hACA...,2,-34,-7,27
cNDGXCYBTEfMgPKbaOSUdJVFWQLeIHRZA,DEFDCEGEBEBFECCE...MFAHKECB..OFDDdGDEFCBELACG.hAAAeBHFIABHHGFGABADhAAAGDEEXBADTADFhADAfEAE...PHACSGBDhAFA.UGGCWAGFhABA...,1,-23,-26,3
VaXcIALMDJgfUGKdCHbZEYRWeNFSPTOQB,DCFAJECF.UEACKCBD.HCCAZAEH...EFEFREFD...eHEASBGBhAAAOAAHBFHA.aDGGhABAIHHGLHAAMADBhABA..fAFDCHAFbEDB.WBBENCAE.hACA......hAGA...,1,-12,-37,25
QaRZXAPLECecSBJIWVTKMGOdgUHbDYFfN,EEGFeDCFBAFB..IDGA..VABGTFGCMFCCGBAEhAAAOEHDdAGFHCEGbFEBDFAFhABAFAHDQEAEhAAAZACCAHIDCHBD.JHAAKFDD........hADA......hAEA...,2,-15,-10,5
gYUIOeRTJENAdHacWLDPFKbCZQSfBXGVM,dDAEaCGELEEHDABCFECD.KGGBZGFG..SFBDBDHDGAEDMACEhAAAUEEC..IBBAhABA.eEBEJHAAABCEhAAAHAFG..PCDECCDC..XGCFhAGA.....hAEA...,2,-39,-10,29
PFOMQCYAdNJbaUSHWcfDLKBVETGIgeZRX,JDADaAAFHCBF....fGFHDAFHKACGVEFCGADG.IFDBhAAAeBHBRFDDFGABQCFHhABAADDC.NEIESHBEhACAWAFH.BHAD.gBBDhADA.....hACA...,1,-12,-27,15
cQURMbJGSaVDINHCKZeBfPFTLYgWXEdOA,UADBRFEBMCFGGEEB..VCDFDCBFHCCCKBAA.BDHEFDGGLAEAhAAA..YGBAhAAAXGADdHGDAABAQDAAhADASAGCNEACCHHE....fEHAhAFA....hAGA...,2,-25,-21,4
DTIZRNbfCLeJdHYFgcKSXPABOaQGWUVEM,BGDEQBGFUABD.EEDHDEAFZGEC..RCFA...NDCE.CCCGLHFGhAAA..JFAFdGBEFABEhAAAKBFCXFGE.hACAOBABaFFG.WCCEMBED...IGGGhAEAfDHC..hABA...,2,-38,-30,8
SYKNFBfcGWAPCTedVZUDHJRaQgbXOMLIE,TACDdDEEZDGBUBBG.HFCDaFED..QBEA.gEGHhAAAOBFEMAEEEEDDSAFEhABANEIABEBC.hAAAcCAFAAIBCCACDGBDREADXGCD.ICHBhACAFGED...fDDBhAEA,1,5,-31,36
fZIBdYCKVSbPJGeWgRLUOEXMHANFTacDQ,FHEEaADE.QDEEZDCCBEAB.dDDCKAHB..SAFE.JBCAhAAAeGBA.gCGGhAAALEHDOBAHhABAXGEHAHDHTFBEDFCEIBBFCGEC....hABA......hACA...,1,-17,-40,23
UCARfdSODHKeBJTQZbXLcgYEMVNFIaWGP,dCDBSFCCDIECHABAeAAFBEFC..TBFAQEAGZGFG.LHAGhAAA.gGGGhABAMCBFFHAGIDHEhAAAaAFE.WFEAPEDDCDDDACDAOAEGbCGD.hADA......hAEA...,1,-16,-17,1
VFJZHUMBPbSEYWLgDcfQeXdKaGCOATIRN,TGAERFBEFBBGHAEA.BGGHSFEG.ECGCLEEADDBFQCEEhAAAXDABaBCCCCHGAIAEhAAA..NABH..JFHHMEAFhABA..PAFE.WHEGfGEChACAKDDD.IDFHhADA...,1,-6,-33,27
NJKcGeITWQaUHgARYfZPOSVXBCELFbMdD,RDBBZGFGOBCCSFFEBGDB.LHBC.MADBdBGHDFAB.JHFChAAAKEAHGDEHeABFIAHHhAAA.TCFDhABAWAEE.UECB.AGABfAEHXFGEFCABhABA.NIAB.....hACA.aDDG.,2,-30,-7,23
FbERfMIQWLNTePUSXOZdDVBJaYCgGcKHA,ECBBMCBF..QDEFLCCCeFBFSGHHZGFCDHCAVFCGBAFFhAAAJAHFCEFCGAGCKEADAHFDFADAhAAA....fACHhABANCCDTGAG.PDDD.....hABA......hACA...,1,-14,-18,4
ebcPIEFgLMSdOWVUAJDKNXaZBRCYGQHfT,KAFGXGCCBACGRBDDGBFC.HFGFeEHH..bBCG..PDAAhAAAIGAF.EEEHLGCAhABAMBIDSADChAAAWCFH.AIACDABDZFAHCBBGfDDCFFCAOAHDhADAJCAHaHEE....hAEA...,2,-21,12,33
ZUXdRLIKGcgDJSVOAWYeMafPTNEFbBQCH,eFCBaEAB...TCEFEGAFFDGCBEAFHEEHUAABdGGHRBCFLFHDhABA.KADCgAABhACADAIBSAGBAADCMIDC.hBDAfFBBNEGA..CDCFIHEDhBFAcCEG......hBGA...,2,-26,-5,21
QJOBCNbAIEVFTfGSRHMDWYgdecXLZPUKa,VBDDFGBHGDBF.RFCAHBFCMAEGDGFD....gACEhAAAdHCDeDHBLCAHhAAAUFFCaBBC...JFBECFACAHIBTABBhABAfAEDSHGEWHEG...cAGEhADA....hBAA...,2,-26,-4,22
NZLDeIFQAWXbBHdEOURaMgJCGfPYVTcKS,XGDBBDBGdAECEGAHUCDC..RBCD...aAGCJHECGDFE..hAAA.PHAGVEGFKAADhABAZBBDDIFCFCGE.AAFHbEAGMDFFhACA....CCAF.fFBDcCGFSABChAEAeAFA...hADA...,1,-3,-30,27
RXcSgMbWeBFCAELUTJIKVHDaPYfQdNGZO,LHEATDAB.JDAAKFDCHFBHDDGG...aFGG..fGFEhAAAdAGDZACHOAEDRADB.XAADhAAAgGBDMEABhAEAbAFAeDFABACFAEEB.IHHA.YBAAhABA.NEEDSGADhAFA,2,-16,-12,4
NVDQXfdRbHPWESMLOGTFCcaKIZYBUAgJe,eEGBVACD.QBDD.dDADbFDAHGDCEBADLCHHOBHBTGAFhAAACDEEKAAE..IGBHhAEABAFEAFEEJBAG.DEDHhABAfHGH...PAFFMDIH.hACAFHDC.aFAG...hADA...,2,-8,-6,2
ZVabIPDOSgLKGXeCTJNdfHBAMFQRWYEUc,QEAERGAAEEED.ZBCFVADB..bAABDCAA..OGEGLDGFhAAAKEHBGAEDCHHH.hABAJHACdDABBHHGABGEFHEAUCFDhADAIFAB........hACA......hADA...,1,-9,-29,20
NHgPBGSLZebMCAVOJFIRaKcEYWQTfdDUX,JHECFADBRGAC..KBFDEDFH..QCAHdBGBDFIF.UEGFHCDDBAHFhAAASHECZCCF.eBBDhAAACACHAHDB...OCAHhABAaCGE...cEGBTGAE...fEAAhABA..hACA...,2,-41,-17,24
ZHgNQRdTJUWCVYbcGASIPDEBLeXfaFOMK,SDCCDFDHEBDB.BCBCeDAG..XGACaBGGFEEA..MIDChAAAHAFC.NEGE.dFHGUADChAAACBBA..VFADbFDFAEEELCFAhABAODHD..KCFG......hABA......hACA...,2,-19,-18,1
VNHALPMbEKBDUaYWTIOcRdgCfQeGJXFSZ,MAIDKFGGBBGFUCDA..aDAG..TEBHOFBCRGBA..dFGDCHAH.eDAFhAAAGBBDFACCZBGFHEEHhAAAAHFH.LACC.hABAEHCE.DIFC..IHHE.fBBGhAEAJDFASAHBhABA...,1,-14,-24,10
CTLVRNWFOBZXbgYfcePMDJQAdaSIGHKUE,aGDASCCHHAFDUFAGCGCG.LDEARBFF.FBCCBABBZDAA.bFAH.hAAA...fHGBhABAeFEDMAFADIDEAAADIGHFhADAKEHHECAE.TADC.....hACAWFFC.OBBBhBHA...,1,-5,-34,29
LaBXWDVZOeEcITCfJGMKFHANgbSRUYQPd,...NAEC.SBCD.UEGDPBFHdBDDBBGEDEGAZBBFEAAB.hAAA.IFAECFEDGEAAhABAMIDGKADCAFDBRGAAQFGChABAaCEE.WACBeHDC.fCHAhACA.FHGE...hAFA...,1,-11,-31,20
RBSaDcdOWMTZKIgGXVQPEeLFbCNfUJHAY,BAGFSGABaBDD.DIGGOEEH..TABCZCFHKBAEGEEBhAAAQFAGEFBGFDCACCHB.fHDFhABAUGGC.AHHG.hADA.RAEGdAHAMIBGIDHDgDBG.XACBhAAA...hAEA...,2,-22,-14,8
EBPQVgaTSFCGAHYdfXDLIRUNcbJKMeZOW,dCDGDFBCRBBGUEAE......NEIA.JCHHeBGBZFDCEABABGFF..hAAAQAFGaEAG.hABAFFHHCHBHAHGG...fEDDhACAIHACKADAMAID.OADG.hAAA......hABA...,2,-35,-34,1
XbUTMOFdJZCKRVIABfNQaPcWYEgHLSGeD,BADHQAECaFHD.....PEFF..WDACEABELAHDhAAASHEGDIEGUBFDhAAATEBCMEDGFFHDdFABhABACDAAKGADIGFCADDFfGDCNAIC..cGBDhACA....hADA.YBBA.,2,-25,-12,13
dTJeONLaMPQXfEKUWHSgGRYFbVBDICcZA,JEFEeDCFLAGDMAAE..QBDAEDDEUADA.HEEA.SAGEhAEAGDBCFGGEBEHBhAFADBBECFDHAHCCTBGH.hAAAOBBHNBAG.XGECfBHEgGGHhBAA....hBCA...,2,-26,-8,18
ESeRGCXLWYDbFPTZQAHNOMgIJVcdfUBaK,HBFEOAFGMFDH.JABBVBDB..dGHCUCGEBEHAEABCRCDBCGACLFHBhAAA.DFFFFGEHZEABhABAAIBG....IEBDhAAAfGDC.SGGFXADGWFFBhABA.....hAEAYAFC.,2,-25,-17,8
LdWCZQgcKAYOSRJXDHBIMVTUGFfPNaeEb,SAFCRAGBDGCDBDBE.MCCB...VBGFUFED.FEAB..fFEBhAAAaACH.ECAHhABAdAACZACFQDGBhADAKFCAAHHE.ODDBXGBCTADFNIEDeBEB.hAFA...WFHHCEHA.hAEA...,1,-12,-29,17
CYLfEJRTGQadBIVgDXcWPSeNbHKZUAFMO,OFCCCBGCLBAD..JADDGEDGdBBGBAFBVDFC..DIEAXBCAhAAA..PGFEhAAASGHH.eFAFhABANDEB.bFBDKEEGADDBMAFAEBGA.....hABA......hACA...,2,-48,-5,43
JQHbAZDPUIMdWEGTNKCcefLgSBVROXFaY,DGBAUFEHdEBBEBDGGBDC.KFGGCDHA...eAAFLFAHBAFFRGEEXCABhAAA.FDDEaCHBhAAAJFHH...QAGDhABAAIDEIHAAMDCD..WCFB..hACA......hADA...,2,-36,-24,12
HZMQDPSVXfTRAONIUFgebdaKLBGWEcCJY,OACHUCEAFDCF..eFADdHCBKGACGAEB.EFDACBBD.HDEGZFFE.DGGBhAAA.SEHHhABA.fECAhADAAAECNAHA.ICHEaACCBHHG......hAAA.WBAD...hAEA...,1,-14,-48,34
SgTPZWRGFAYQfBOXcLNbMdDaHeKEVJICU,QCFFBDGCOFEDLEBE.MIFEdDAFaAAGHFBHKEDBJEGDCBBD.hADAUABE..SFAGhAEATADA.ZBEGWAHBhAAAFHGEAIDG..fFEANCIG.DFAFEHAAhAFA......hAGA...,1,-5,-33,28
VGHRPSbQDBEYIfeALgdNJWKXFOZTaCUcM,dBDBJDFC.KEFDFFCAZCBE...CAGF.MGFGHEGBRAEG...SCFAhAAADCBHBCCG.EBAG...hAAAIFAFAACALHAChABA..NICD.OHFGaHBG...cDEHhAEA......hAGA...,1,-24,-44,20
YHXGQKCeMOaBRFLdZIbfWNcSJPEATgVDU,TAEDDHDEUDDD.HAABGEAD.KGEAeFAGaBHD.BGHBLABDhAAAZAGH...fHBBhADANICB.JDDCAFGGgAEEhAAAXEGHCBGAMIEE.....hACA......hADA...,1,-4,-36,32
bBKIUYCFWAXdNQLSfgVcePJMHRTGaDEZO,dFDGQFAFLBGHSFGF..VACEeCDFMCCDTBAAhAAADGFHZFAHBHCGICAChAAACAEAFAHDAGEC..fABDhADAPDDA.JBFD.......hABA......hACA...,2,-33,-16,17
RQTOWAUIdSZceDBbEGFfMHYKLaNPXVgJC,dBDBZDBBeBHBBFDEEGCEFDECHADG.LAAHaABD...PFFDhACAVBGDCFAF..TGCAhADAACEFUFFA..IHHHhAEADAEAGDAH.MEIDKHAA...NIBD..hAGA......hAHA...,2,-25,-11,14
PIFcEeQDCfMGHgXYNbaOZLVARKTUSWdJB,KDECSEHFdABHBDHCFCEA..EAHFDGGD.CDAB.MEIBHACD...hAAAXAGB..hAAAYFBEaGBHODEHhABAZCAAAGFGUEAHJHACIBEH..eFHHhACAfHFD..hACA...,2,-46,-13,33
CEJOHQILFVaYRUSXTeKDbZBfPGWgNAdMc,dEGHCCAC.OGAAQAGCFGGB...aFFFRCCFUAFE..XFDHhAAAeFDHKBAHDIECBEEEhAAAGBBA.NEDBABEDEABGJFADhABA.LAEH.SDGE.hADA......hAEA...,2,-35,-12,23
cNEFHTLAKQDRVXgGOefBYUIJCPWadZbSM,KHCEDAABREGB..XCAAODAC.BEGD..UGACJBFD.CBFH.aECEdCCDhABA.ZGDA..MFIHhAAAEADC.FABBLDFFhACAAHAD..gEADeAHD.fGGAhADA.PBHFWFBE.hADA...,2,-29,-27,2
TJPRQHUXMIaFAdOGfVYBcWLgNKDCEZeSb,OADGVCFA.BCGBLFCFKFCD.DAACCDDH.ZABG..eBBG..hAAASCCAJFGH.hABAPFFBQFDGhACAHDAEMEEBIDBAAHIFfAFD..hADAWBFE.EHAE..hAHA...,2,-44,-15,29
YGOTCIARcWQPgNUbKBDMJHLFVdEeSfaXZ,RFDAQFBC..PDCBUGGGBEDGMABBHACDVCAEEABASGADhAAA.XAFFhACAGBGCCFFFAIFCgBGHhAEANEAADIBA.JEFAFGEHfGHCaAAB.hAEA......hAFA...,1,-6,-17,11
QFHTCIeAMUfGROLgDNJYdacBbPEVKZXSW,UAGEGEBERFEGLEDCDGAF..JHFCaADCBAAG.ECAFKCBAZBED.hAAA.XFAHQEGGhABAFDHF.CCCC.ACAEOHFEhABA..YBHH.dACHcFCHhACA......hAEA...,2,-28,-22,6
MGgWIBaKQLAHZdNSCDOYeUbJEPXTFcfRV,HCEDZCFGSBADOFAEeHACUECD..JDBAEHBG..TFGFhAAAFFFHRBCC.MBEC.gABGhACABAAEKEADAIGCNIDDDEGChADAPEHB...fBGHWAHH..hACAIEAC..hAEA...,1,-14,-23,9
VLAYMHIUBNXEPcZeSbQGdWCTORKJDFgfa,MCFFUFDCBGAC..NBCE.EGGEZBGH..eBFHQGDHdCHACDAG.hAAARFAHDGGAFBCB...aCAHhAAAAHBE....IDDFhABAPBDHSAFC.WABFOACAhAGA.....hADAKHFG.fFBD,1,-29,-32,3
QTEPBMXUAaJSdDRNGgfbLOcZVHKCYIeWF,JFGHSBEC.dBHGDDDERDFB..GEDG..fABChAAALACFZBAFKECACEBFeFADhAAAFBGA.EGHFMIAEACFANAED.OFEFhABA.....cCGC..hADA...YGAChAEA.IBDG,2,-36,-14,22
NdcXeUDJVOHCWBSIMfbLTARgKQGEPaZFY,KAABQFFGEFEC.aGAFFCAH.dGAH..XACFDAFE.OAAHhABAHBFECGGBBBFCMCEDLDDDhAFAAIBA.gCFChAGAZCBBNEIA.eCBFJHDA.WHEGSDFAhAAA..fAHEhAIA.,1,-20,-24,4
DQeLKBXTFJGAfSVCgaNZYHPWMIdOcRUEb,VCBCCAED..aHAAZFCBHDGF..MEIFOCCBRFEEUBFFEAAEDDADLFAFhAAABFDG..TBFGhACAJACGAABF...fBDGhADA.NIEB.WHEGdGGH....cAGAhAFA.bEEFeEEEhACA...,2,-25,-5,20
LMfDISCEbeBYgFANXaOdJZRUWcQHGVKTP,aGBBOACHZBFA.UGBC..QDBAGDDEKAHDTAACLEAFhAAADEGACGHHEHFG.BBAHFGFFAADDhAAAdDHARBDD...HADEhABAMEAFICFCSFEFYGFC..hADA......hAFA...,2,-16,-10,6
WdSYgPGTERQBbMfKZHaLDJFXIVAONUeCc,UGBDCBEGdFEH...SFGB..gBGFGBACECGGQDBEhAAABAFFMFFHfAEDhABAKECFHDDADAADhABAFHFCIACBACCGeAEDWEHBTGAD.ZDEAaAHFhACAXBBC.NEIG.hAGA...,1,-5,-27,22
NYUMeSZKgBVJFHWbQfcGIRXEATdODLCaP,dECFDBFBCHDBaGAD.......NICFUBDGSEEC.KGFHBCAEhAAAFGBDHCBGQEGFhABAGAAHRAGHAADGLAGFhAAAMGDG.eEAE.gFGB..hABAWHEEfFAChADA...,2,-29,-28,1
RCUDcXJKdOFbEQLeBNSfTWGMVaZYHPIgA,RGACCDDBDBBB..XEACdGFC.ODCCFECB.QFGHeAFEBDHFhAAASACE.hABAfDGBTACCMEADhACA.ZGBGHBAGIEFGAFFFcFDC.JBEEhAAAKBGF.EHGENICD...hABA...,1,-12,-29,17
POKbgFSBNAURMEYefDCJdTWcIVHQXGZaL,UADHEBGB.eHAADIEEdFGA..TFED..IBCAHEABXCEChAAAaCEFLEDFhAAAKCAGFGHFSFBFhABABHEGAACBRDFAfAHGCAFCJCAB..WHAG..hACA......hADA...,1,-5,-35,30
YUOCRDAcMXKWBQLeENJSgdZaFGTHPVIbf,XDCHBGBCeABE.EEDGSHCA.dFFGFHGCHBEGIEAHhAAAbBAF.UGDDCAEDAFAAKGAAhAAALCDG.NAIG.gEGHhABAaEGC..PBBDfAGDhACAYAGHDCCH....hAEA...,1,-5,-27,22
cXHUaBLOTAFgWdDCVJZIeRYSNfEMbPGKQ,FECEdBEGDADECDHE.ZBBDRBAA.....SGDGEGAG.MCGDbBFF.hAAAKGAA..QGGBhABAXGGEHAGDBADFOHCEhACAAFFD.WFCAIBAH.eDDBhAAAfCDH..hAFA...,2,-38,-22,16
BYOCTeMFZQRJfgGaKbSLAXEDdPHIcNUVW,DDEAdEDEHADE..IAAFUDADBHGHCECA.eFFEFAEF.RFAH..JAAHhABAGDGA.aBCHKCHHhACALGAAAAIH.XGEFhACAPHCA.NAIA.....YDDChADAMDBBfEEFhADASAGB..,2,-39,-13,26
ROMegYPWQDCLKfZGAXbFESBJdcTUIHNVa,XBEFEGGHBGCHdAGHUEGCHCEE..aCGARDBFMBCE..eEAHhAAA..PEFCDCDHCHHAKACEhABAGAAAFHDASAFEhAIAJFAH.IEEENEEG.OECBhBAA......hBBA...,2,-28,-10,18
QGCgMeSUHRFfPdKIYTWEDLOVJZBNAXbca,XBADaFFHGCDA..MAACSEBBHFADRBEBFGFBdGACKDGA.TBAAhAAAEDDDLDHBhAEA.OAFGJAFABAEGhABAAIHAcGCGCHHAeHCEfEBB...hACA......hADA...,1,0,-18,18
bZcAgdUXQeEHIDYFVMSWPJGLTORaKNfCB,UGEEeBAAEBEHDFEG.FGFB..MAEG..SAGDJCDA.TDAEhAAAODFEKEHDCABEBDBEhAAAZFDDAABDdFAD.XDDChACAQGBC.IGHCWHAC...hADAPBFG...hAEA...,2,-43,-18,25
WTIUFZLBdRbeANSXcJCOGfgHEYDPMQKVa,XAAEJAEGGCACHCDD.DHGGQEGF.KGDBaAFDTCDFhAAAUFBDFFFE.BADDhAAAdBHERABBAFIBSHDAhABACHHE.OEAAfFFGEAHFMFADIFCBhABA.....hAEA...,2,-18,-12,6
OQRAfLebEVPXDagJMHTSBcWGCUdNKZFYI,LAEEEBDC.VEGFPCHF..aGDDMFGHHAAFBDFHGBEEhAAAdAABKHACZDBD.FEAHICHEhACAOEDD.AIBCfDAGhADAeDAEDFFB.........hADA......hAEA...,1,-2,-31,29
XTNYKJbMOUDECfHgBScLeAGRaFdZQWIVP,RAAFaAECdCCGZCBF..QGEG..WEFFVAEA..XGGChAAATDFE..KEDGMBDDhABADDDA.CGCHHCGDBHADSEADhAAA.LCHBAHABIDABhACA...YFAHhADA.bFDD,2,-25,-18,7
VHaCRSNTAXMPKUGOZBbWdgQDJILfYcEFe,XBAGMEAFKBECGEEHZDEDBCHG..dDBADECALGCG..hAAAfGAAEBAAFDDA.hABAeEHDaGHBCHBDSAEDhAAAAADFOBGF.bEFD.gAGE.IGCAhABA...hACAcDAB.,2,-20,-14,6
WBcXJSLAIKTCYMDGRaQFUZNVfeEdHbgOP,TCCAMEADDCDF.GEEDaBFA..UFCDZCFE...VFFDeABFEBAEhAAAdGBFHDADOHEEBDHHhABAJADAAAIFKDFECAAF...hAGAYHAAFDBD.NACB.......hAHA......hBCA...,1,-9,-21,12
LAcWCadVBIRTZSNFHPegDQMJfUbKYXEGO,CABFaDDCBGEE..RFDGZBCGFCBHHCFH..PBAFDGHF..MFBGhAAAUGAHKACBEAFG.LDHHhAAAAAEBdGBH..TAGEhAFAeCEA..QEAF.JABAfDEGhAGAYHFG.OEHFhAIA..,2,-33,-12,21
JNLaIGEePdAQCBKFUOSbWVMYXRfHDZgcT,QBFBBCFFUAAE.SGFG..VDDBXCCEHEADDBDGhADAZDAFTDGDJCGDLHFGhAEAaHAAEBAA.dFEBAGHBKHBGhAFAOAFG.MAAGfAGH..hAGA..NIDF....hBAA.eCBA.,1,5,-18,23
XVFJYAZeKGWbIEOUSCMLTfBPgRdHcQNaD,KAAGGDAE..ICDAUDGBCABELDCC.BHFEgFGHhAAAdAGHHECBQAGGhACADICGFADFAHHA.eFCH.hAAAEFFHOFFETFAA.PCFH.NEAHaADChAEA......hAFA...,2,-20,-19,1
ZDbUTICaMLRfBWHedPKQGcYEAgSJONVFX,JHFAVCGBZBEE..DCFBUABF..CEDFLEBBBCHHHEAB.dGEGKBDDhAAAGDDFEBAA.AAEE.SGGChABA.OAFAhACANAAC.FEAH.XGCH.IHHBhADAaHAEMCCF..WFFFhAEAeAFC.,2,-26,-20,6
NIAVMYdPCfOEUKDScZWebHaLFTJBXQgRG,VDFCMBDEdDEH..CHHE.EECHDFDGZFAH..eGCCaBAH.LACDhAAA.FAHFTGCFBCEAQEAHhABAgFGANAAHhAFAAGGE....YADGOBBFKAHD.SGFDhAGA..hAIAWHCA.,2,-38,-7,31
BZSJQACWLaEXgOYMRTGeFKbNcUHIDdfVP,CFDAaFBD..ECBBOADGRFEH.GCDCKCGF.....NBAEUBFHhAAAIADEDGGA.dCHEVBBBhABABHHC.SFBFhAAAAFGGLHAAXCCBMIEC.eAFA...hACA......hAHA...,2,-33,-14,19
CNGXIUOHegMSWDATJfdaPcRLQbBEVKYFZ,TCAHdDBHaHAA..RFEC.LEHDBFDF.EBFFKEADZACEGABFUFEAeDFChAAA..SCFDhAAADIGAAFIBJEAH..fHCBhABAPBGF.bDCHFGHD.NBIE...IAHEhACA....hADA...,1,-11,-23,12
IOcPVEZDfgWeXFCLTJbaKSRQdAUBYHNMG,UDGDBACCHEFHGEAHOEBA..PADDVAFCZCCC.DIEAfAAFhAAA.eHCChADACHHFJBADaFDEKFADSBGBhAFARFCCADIF...YHFGMIAG.IGADhAGA.cCBAhAHA.WBEH,1,-10,-25,15
cUfEVdDOgKJRHZCIPWMeGBAQFLbSYNTXa,LEBHSBBFTABA..aBEEUEEEVFDDDAAH..KDFCJBFChABAREACCBHH...IHAEhAAAMFHDBFAF.AHDGbCDGhADANABF...fHEHEGGBgCCGhAGA......hAHA...,1,-26,-28,2
LAHUWPdBFDQJXGgEOceaRCNKVYIMTfSbZ,HDBHUFFHdCEHBGFGFBBCDBIF.QAACGDAA.OFDFaABARFCB.CBDB.hACA.KGAH..IAGGhAAAMEEG..TBFHhADAfDDESGGE.....hAEA......hAFA...,1,-21,-35,14
QVGZAIFaJYfcEeKTUBODNLPdXWMRbSCHg,aAABJDFA.......fCDFeADGTDDCUBGEBBBBDBDGLFEEhACAdFGFMIAASBCHhAAACDCDQGAFGCAGhABAAAFCFGHDEDADKGCGOAHDNEEF..XGCHhADAWFFD....hAEA...,2,-19,-17,2
SUfaKMEYgCFQDALbeTPWOBHRIdXZGVJcN,LCECeAGH.TEEEOCCH.BEAAHDBCRDGFdGACXBBBGDDAhAAAJHACSADFhABAUGEBaFAGKAEGEGGD..CGBADBBDhACAAHIBPDHF.ICAHcAEG.MABA.hAIA......hBAA...,1,2,-18,20
fdgbNYSKCMaWLXIPAJcTBEZFOeHDRQUGV,JBGBBDEDZABCOBEE.DACBREEEGDAA.dDCD..NEAGKDAEaCHD.hAAALHBE..hAAAPFCDAGGFEEFFHEBChABA............hADA......hAEA...,1,-35,-39,4
NfWcJTBRePZDCHMaLIXbAFOEVgdGKQSUY,EAEEdFCEKABDUGFF......fDCFJBBHBEFFeEDHZEGHDFADhAAACACF.MDBFLBHBhAAAXCGEABAB..FHAEOAEChACA..gBEGQEEGSGAChABA..NCCFWHCAhADA.,1,-29,-34,5
WbYfXMBOcCFZJVKNEaDeRSUTLAPIHdgQG,HBGHdGDDQBGEGCAB..bFEFXDAABFBGCACGZGAEKFBDEABGDAABRAEHhABAUEGH.LADBhAAAIGHE..gDEFhAFA.fGHG.cAFGhAIA.....hADA...,2,-21,-4,17
aXQNFMLbBecTYWAVKdUgSICJPRDGOfHZE,KEDEdGCCSCCGCCBD.RGEG.GGEBHDAFEEGDQFBA.hAAAMAHDBABDeBBEcADDhACATAEFAEFF.UDGDhAAAIHACDBABOEABfAGBaFDE.NEIC..hABA......hACA...,2,-15,-14,1
bJRABXNecETHVDLdfPZUWQCFMaOKgSYGI,BECFeECAEHCGHABFDADEdHCF.ZBFHUBAHCADG.FGABMBAB..KBEGSFCAhAAAGDGA.JFHDhABAAGGHXFDE.hAEA.NDFA....cAGFLDDC..hAAAPFAB.aGFD.hABA...,1,-16,-25,9
OYfVIPdTLgJBGEARecFCKNZDUMbHSaQWX,eCACFEADKFEFDCHF.UFEFMAID..HEAFQBDEOAEB...hAAAVDFDdFHCTDEGhABA.JAFABHCGAIEACACF.NIEFZBBFhAAA.aAEA....WFCB..fFHChABA.IFCEhACA,2,-27,-24,3
fZIEVYaWLAPQDcHbMGOdNegRTJBKFXCSU,DDEEHAFFMBBGdHDHeCCH.RBAFBEGCKGEGFECC..CAEF.SAAChADAUGGGZFBG.EEAB.aGCGABAD.hAAA......hABAPAHH.cGGAOCHF..NCCDJEEAhAEA..IAHEhACA...,1,-25,-27,2
IVDNLdZacTJROKgbECPGUSMBXQHWfYeAF,VBFCDEDBLBHD.ZADBaECH..TABGJEFAKAAH..EGBFCEDD.hAAAUGGHBCBH.QACEhACAHCEB..fDAChAAAAIECFGGDdHAF.cGDG....hABA......hADA...,2,-32,-25,7
EHJUPReIAXMWgLYdKQFBbTfDZGcVONaSC,MFAALCEDKBGGBCEETFBB..DCBBGABC...OEABhAAAaGAFEDCGHGDE.PDFGhABARGECeAAFXFGFhADA.WADAgDGB.YAEEhAAA.FFEG...hAEA...,2,-25,-11,14
XODGfSCAUNIaWZTHKEcbFdLBVMJgQeYPR,UDBFaDEDZFGBKAGA..EAEGFGCF.BEGC..JCGB.eDBHRACADCABSDAFhAAA.CAHGADDChABAIGGE..hAAATABE.bGACLEEFMICG.YFAFhABAXECD..fCFHhACA,2,-48,-27,21
QLXNIHfDSCaPYgAMBecERVbGTUOKWFZdJ,eFCHEDBARAAA.GEFE.UAEGOFBEKEDCFEHFdAEDQDEFhAAA.LCHHNBACHBBHDGBFhAAAaGFC....YHAChABAADBBMDDGBHHC......hABA......hACA...,2,-19,-16,3
QWaSbgJUdYZNEPFRKLfcCeXDVMIHTBGAO,QBEFaGFC.SDGEJFAAdBHAZBAEEGHHRDFH.LCBH.hAAACGAADBADMEIFHFEBBDEFhABAAFEFOHBC.WAAEhAEAUAEC..NEDBFAGAKHACfHCFhACA.eDAA...hAFA...,1,-10,-22,12
ITbOKZCNBLQWfAMPeGRDUJFXadVYHgScE,eDFHGDFEDEHBUAEDFAGD.dCCEHACB..SCHFEGAE.TCAFhAAAKFCECCBDLHDEhAAA.fCEChABAAIGCRFCEXFAFaAEGYCAFIACAOHBChABABHHAMBID..PFHDhAFA..,2,-18,-9,9
BNSbYUcMRLQOEKfVPTXDGHWeJICdaAZgF,ZDDCFGFCBDEDSEBHUEAC.RAEB.LAAG..EHCAKCFEfGGBhAAA.PHEChABADGIFHDGH.JAFECDBCACAChACA..bCAAMCHBOFDHXABE.WEADhAEA.....hABA...,1,-12,-34,22
FOSCBfJZKPRMTGebILWUdQEHaXDAgcNYV,...NECE.FBFE.CCCHBEHAJADH.KFEARCACGEFA..eEBFLAFBhAAAdDFDQACDhAAAEAHDaEHF.DBBBAIAC...hABA..gGFAYEAFOFEHSGADhABA.fGDGhACA.MAFA,2,-29,-24,5
SeYLNXBGfMVAQHTWJDdUbaKRgIZCcOFPE,HDCDTEGBJHEC.DCGEdFDE.UBEGKGAH.RABHZEEF..CBECFEGH..hAAAPAHHEBBG.SGCDhAAAeCAF.LEADhABABDHAMACCAECB...WFCD.aAGCcGGDhADA....hAEA...,2,-30,-20,10
GFAaKSEIMRPBNHQODUWCLdXYZbegTcfVJ,SEDBMFFDREBD.BGCDQAGBUAGCLABBdBDCZDFFeABChAAA..gGFBhAAA.TAEHfFAEhABAJDAFAHEEEDFDIHHBNDICDIBC.CBEH....hADAYDHH..hAFA.cGCD.,2,-12,-12,0
ePWQDVHUGMadRCKbScILgFTXEfABYOJNZ,OHEEJECGZABE...eEEFQBFADDCBHBDFUEGHMADE.dCHACCCF.hAAAKHBG..SHGGhABAIBFCLBAHhAAAFDAFTGAHfGGDBCEG....PHCEhACA.WAFE.hABA...,2,-23,-20,3
ZCXWBAPfRNSaUbQMeOgHDdcGLKJTYFVEI,RDBEaGFFQEFA..MAHHeAAFOAAFDIFEdGBBGDADKAEH.hAAATADDFAGBEFEDIFDGhAAACBDDBCHC.AGBFNAIESEAGhACA....bGCC....hACA......hADA...,1,-19,-27,8
JeXWOQRNfPUHgCBTSdZEbVIYaADcFKGLM,FDEAGDEELFBHMBHHeAAFOBCB.RFFA...NDIA.UAFFHGACCGAF.hAAABCCD.dGGEECAHIBFAhAAAAABF.KEAAJHDChACAXGDH.WBDB..PDDHhADA.SBHHhAEA...,2,-28,-4,24
CASbJLQeNZPFIXKHUYVdGaBMTgfRDEcWO,JGDCeADEZADDFFFH.KEBFHDFE.UGGCdAAHBHCB..TBABhAAARDCGDDGG.EFBH..OCCAhABACHBHAADDLBFA.hAGA.PEHHIAGGXAGD...hABA......hACA...,1,-22,-33,11
XTOWdVcINDYSgeQGaJZFBLCfMAREPUHbK,RADAEDGAUDDHHAEA.KBACODHFdGFG..VGAE..IFGDhAAADDDD..SDBBhAAAeGCAGABGaDAHFGHFCEAGAAHHXCFBhABA..WFEFNICF..YGAEhADA....hAEA...,2,-24,-18,6
KEfOgJCILYDGZFSXWATPUeRBdNMcVabQH,TGCFeCCERDGBBEEH..MDCF.aFAHHFBGKACB.fABAhAAA.JBFACDDBIGFFhAAADBAFGDADSDFChABAAAHAdFAG.cEGAQGGB..EHGAhACA.LAEE.hABAZBFA..,1,-9,-13,4
FDKNSYOQRPBUcfTWGIAEgJaHbCdeXMZVL,JBFEHGEA.dDCFMIECZBADFBGA.KDGHSABF.OADHhAAARECGBGCBUEDETADAIGGEhAEAEGAE..aHACCEBDeHAAhAFA...XCGADAAANEIC...hADA......hAFA...,2,-24,-18,6
HWGAeJgdBUECDcIfKbZMXFaLOSQRYNTVP,eDDGdEGABCABUDADCECC.DIAE......IAGAKEGBMHBCFBEDhAAAaECDLGFG.hAAA.QAGDhABARABE.NCAH.PEAD..WABAADGAgGCBhABAcGGH.fEEDhADA.,1,-30,-43,13
AdTFZfKVHaCYODWIQRGbeSMBEgJPcXLUN,dBDATFCCZDFGKGBB.HGFGaCBF...CHDG.DBDD.QFFHhAAARBAE.bCFCeFCG.BAFGhAAAgFADPDAFLAGHhABANICBABBEFCAHYEHH...IAHAhABA.SDEDhACA,2,-28,-2,26
ZXeWIbfLHMEOgQVPABSCYURJdGFcTDKNa,BHHFCCHGUDDAdCGC.GACDFGBB.DCDDKAFDZFDC....eAAG.hAAA.IHBDLFHBhACAECAFQGEHhADAAHFH.SEBC..JCEBNEAAaGCDWAHHhABAHCFBOFAB..hACA...,2,-39,-16,23
OGedEQJDFKbWPLNUfMBXaYRSCTHgZVcIA,OFDFdDBEQAEFFBBC.KAHB..PEABLGFC.NDAC.MDEChAAABBCE..XGFChABAaGCDRDDA.SHBAhACATCGF.gADBcAAC.ADDDeFFGhAFADFFC.WCHB.fDBGhAGA,1,-18,-32,14
bYPNBRZJGaLKWOVIUdATCHgMeDQcSFXfE,TGECCFEDHAEH..MBACDDGF..QCBBFEHBEAGE...bADAPHCEhAAABHCFREAH.JDEBaDGBhABAKABHODCB.IHHDhACAAEDBeAHBcGGASEAF.fCCBhADANAAG...hABA...,2,-19,-12,7
WXEYbPMQLcOAKaCdgeITBGJHDUNFZfSVR,CDFCeEFGBACDGCAEHEAADGHBFHECZCDG..SBAGVABA.RGCC.hAAAEHAE...PFCEhAAAMADEQDGDhABALAFGAGGFaCHBIBHH.TBDG..hAHA......hAIA...,2,-30,-2,28
MZHLgFPKbOcCYRDQfWUJdEeBXANSTIaVG,SEGGaCFEGGAHHBCHFAHF.KEGAOACECHHE.DBABQDADhAAA.UAGDdHEBBCCGhAAAABBCIEECMFCALAFHhABA.PDAFcADFfCHEhACAEGEGNIDD.....hABA...,2,-26,-12,14
GNOAaLMgcXQFJdTUKIZEWBVDPRbCYfHeS,MICC..gCFHXCFF.FGHHJEACUCBD.KADGEFECBAHHhAAADGBFRAADCAFB..HFCESADFhAAAOHACADAHaDHH.hABAQGGFIHEH.WAFGbEFE..eCEFhACA......hADA...,2,-20,-14,6
VGcBQORSHeEXKMCANUfDIbWZaPTJdFgYL,UGECDGEC....bABHaHBA...JDBCFADGLBFAGAFABEHFhAAAOBBASFBHhABA.eECEKDFG.AIAGIHDChAHAWCAD.ZGFEdGHE.....hAIA..YFAGhAAA...,2,-45,-16,29
fJdeADNHXTUWMgLScVPQOFZKGYbRIaEBC,HCGBUDFFMEBFSBBF..VDCFOAFAFAGF.GEDA.hAAAbEBHICAEEADGCCCGdGHChAAADGHF..XBEAhABAgABD.PAEHKGFB...aGDDBDEEhACAfGFG.hBAAAIBE..NAIC,1,2,-38,40
McOdTYKeWDNEgLCXPQFBHAUZaRbSfJGIV,ZCEGaCDB.SFFEGDBEMFHDdGEG..KFBCeABHDCDD.EDGELABBhAAAXGEGQAEHhADA.BBHBAFAFbAEEJHAChAEAcEEHOFHD..YAAD..hADA......hAEA...,2,-17,-17,0
ZNdcJLVDFCXQefPTRbOGUIMESgAHKBWaY,KGGCBCDF.aGHDZFCC.dCEGLHAGFAGH.CFBF.eEFA..PBBFhAAATCBD..OGDAhABAUABFMIDEEDFDAHGDHAFBhACA..NCAC.JCHBDEBFfADF.hAAA......hACA...,2,-31,-16,15
UgSRBceALCbXGaHZDPQJEfNMOVITYdWKF,CDEEXGDHHBEGDGFF..QDBCEDAE.MBHHOACB.VEFChAAATGBE.WFFBhAAAUFBBRACA.BAEH.AGAF.hABALAFB.aDDF.JFHHNAIAIHHChADAdABG..KDADSHAAhAEA,2,-19,-11,8
JPVMbeIDTfLCgdKRYQZGHSaBNXAWOEcFU,OFDHFHDGUDGH..VAADMGAG..eEADDEAELAAFdGEA.hAAAKCCHQDDAhACA.GBEBaECEBBBHhACAAHHDWFBHEGGB..PAHHIADC.CAHA.YAFDhADA..SGGEhAFA,1,-10,-43,33
bJWDOKAfRXBVIYEdUQCMecLHTGFgNSaZP,RBACXBFCBGGE....IAEGEFGGQBBD.MEFChAAALFCGGEBFNAGGSDDBhAAAPHBGJAFADDAHhABAABHH...fGGGdHDBCECBeDAB..cACAhAEAFHAGaABA...hAIA...,2,-23,-15,8
TgfQYZDeWbKCRFPGSMHXNdOEcABLIUVJa,BBBDLBHBUDECaEDE....TGBEfGDDQGGHhAAADFAGeBDGKDGAFEBAGCAHhAAAMEAHHFGF.NABHEGBBhAGAACDGIADB.....JBFE..hABA......hACA...,2,-32,-4,28
fRAYIKXLWDFQSVCBMZGOgNcTHUJEdPbea,KCEELAAGDAID.SHBEBFHAZEEEGABFOFFC....NCCEHAGFhABAJEAC..dGAHeFEDhACARGEE.AEBBXDDChAEAFAFA.CHHGMAFD.cDGCEDDGaHDC.ICAAhAAA...hAGA...,2,-29,-14,15
ACVYIgbJUPLXQOGBfESdKWRZFTNecDHMa,CBEEVADG....IGAH..bEDBJGEGUABCLDFChAAAOFFCBDAB.ECCEdHBDhAAARECF.TCFF.eHFEhAGADIAEaBAGADDG..PAHFXAFB..hABA.fEGBhACA.SDBH.,2,-27,-13,14
OVFabPJXQGRHdfBAKWICeENTMLgUSZDcY,KAGACACC.ECFHMFBB.LBEEUEADZGFEDGFH..OABGFGCD..hAAAaDCAJEFGGEGEHBCEdEDAhAFAAABF..eCFFTGADhAGASEAE.YAAF..hAEA......hAFA...,1,-17,-30,13
VbeSgcEBWHDXPUTGNCMLKIAdFYQRaOJfZ,dAHCFCGBREFAJFCCZAEE.....eCCGSGBDEAAF.HBBBXFAGhAAAUBEETGGAhAAA.CEHCKBADIGHEhACAAIDA.aDAF..fEEBbFCHBFEDDAEANEAA.hABA..MBIH..hADA...,2,-20,-20,0
PKeUBFRMWLYCcfNOZaGdHgVbSTXAEDQJI,DFFEQBAD.JGDAIHDH.KFDGUDECFEBE.READMAIBhAAALBEG..CAGC.fDDDhAAAODHHaBDEdGGChABA.HABD.gFAGSABEAFIBEAEGhADA.BAHEcGGE.hAGA...,1,-26,-27,1
eHdAVXRKafCZMYcETNGIWDUBbPgJQOLSF,RAEFaADECGGE.ZBCC..MCGFEGEH..GCFADHBGBBCF....gGBAhAAAOBAHSEBEhAAAFEDCeBBDADAHKFEHYAHDhABA.NDIG.IAHG.WGAChABA......hACAPHFC.,2,-48,-2,46
XJBdHGaeOfDZREbUTYgKFQSCWINAMLVcP,VBAFXBGF.BDAGHEFHGEADaGAEOAGFDFFCZCDC..EDEFTGAAhAAAKEBA..SAFFhAAACDHA.IHEDhABAAGHBMACELBCC...cGCDhABA.....hACA...,2,-28,-18,10
cXZKOEdGBLMfSUbgWVDCQFRATJIYaNePH,TCCHJFFB..aACCeCFB.HAEGZCCHECFDBHGG.MFFHUDAGbFAChAAA....gGAEhAAADEHHCACCFHCEADBH.IBAChABAPDHFKCGC..OCHF.dECDhAEA.fHAHhAFASCED.WAEE,1,-5,-30,25
agRYSKQcOHGUXEbCLWBVDIdFMAeNZfJTP,eCDBZGACJCAB..aEBFRGFC.KACD..OEDGUAGA..EEGACGDBBBBEhAAADGHB..dAECACGB.TGDAhAAA...PBAHhABASCDE.HDBF.bBGB.LFFEhABAWDFD.FACAMFBFhADA...,2,-29,-19,10
QEMXIHcKJBATNZWePbROYUSLDFGCafdgV,ZFFGeGEGRBEEUCBHLACA.FAGBCDHD.dCCF..QFAEEDFG.hAAA.IEEAKACFAHAB.hAAANBIA....bFCDSEEEhABADFCF.fFDCMBAF..hADAcEABJAFCBHHHWHFAhABA...,2,-29,-28,1
QCHPgSBTAeYJNLZcUfDOabEFMGVKIXdRW,eGEEJCEGLFADUCFHDDBE..OEFH..aBHFEDCBFBAAMEIDhAAAKECH..dEEDQBCBhABACEAD.HFBF.hAAA.SADGAADHNEHGfCAGbGAG...hABA.IFHBWAEEBHDAhACA..,2,-40,-5,35
GSIELfWMDYdZBFRCcbaPAgHJOQKeVTUXN,JCAFOAAH.KCEBeFFE.UEDAGEFA.EDHDLAFB.hABAMBHBYECDdABBFCBAhAAACGAD...aHAEABFG..hAEAQGDHXGGCSEBHfCCFDIAGhACABAHBcBGG.hBAAPDAD.,1,-15,-17,2
efSOBcYbgGHKQEZRWDdFLACXMJTPNUaVI,MECEJFAE...TBGBUADH..aEEHVFFB..eCHD.OBAHhAAABFCFbACGGGEBhABAQGADRCCCDAIDdHBFFDHDhAAAAHAD.CBAFXGDH.ICDA.hACAfDAESDGDhAEA...,1,-9,-21,12
MaZCWYRHBOLeEAUcSKbFfQgXPDTNIJVGd,SCAFFHGAQCCA..XFDCDEBF.TBFDJDGFGFCFhAAAMAFACCEDRAFCBBBF.hAAALHCAAFBDKFFEfFHAhABANABB.IHBE.VCBBaGAHWDHBhAGAOHEE.eABAhACA...,2,-20,-17,3
LCUVcXJBMNKeDATfSQEFdGZOPHWIgbaYR,SDHFQFFGdCFGOFDCHFAD.ICBAaBDHLABC.hAAAUFAGXDCABHHHNIAHhAAADDAH.ADIDEGDHZCEFPAGHhAFAWACB..YHFGCHGF.JAHDMBCDhAHA......hAIA...,2,-15,-6,9
UXKVDPGHSJEAYaBCceORMZfgNIdFWTbQL,aCDEBFEB.eAABMECBZDFH....fCBCIBGBFDHHTFEBhAAALADB.XGAEhABAKAHDPABAHDBAhACAJDHBAAGGCFAHOHDC.gGADNIDB.hAFAWAFB....hAIA...,2,-29,-13,16
SUIaZeAEMXdbWgLfRFVBcCTOPQGDJKHYN,MEIHdDFB....bEADLABB.fGDAREFFBECBTBCEhAAAOFEGGAEHDECBJAEAhAAAKHCG...NBAGSFHHhABAaCHBAFDB.XFCEFDDECGGEPDAHhADA......hAHA...,2,-28,-13,15
bODJVCIgWGMKBcAeHRUdPSfTZFLXaEQYN,eDAEHGEAdDGF.SBDGZEFCLAGHEAAE.QGCG.hACANAEA.ODDDDBFFJGECCEAAIHAEhADA.gGBBhAEAMBIBBBCHAIGG..PFFGFABBXFAFhAAA.aHGEYAEGhAFA.,1,-10,-27,17
VCITeEQUYbNBWdFPAcfMLXJHgRGSOZDaK,MBDDLAEHHDGHRDFCOECEZCAFDEFD..KAFHCDAE...eCEFQGCAhAAAUGGH..NHBDBBBEhAAAFAGBPFHF.fBCBhABAXADBJAHFSCCD.IHFChACA...hABA...,2,-19,-15,4
ARbWYNdCUaOBfZDeMKLPJXgVIGEQTFHcS,RDEG..bDCA..NHBF.dEAC.CGHD.UACDBBFHZFAEDFGC..KHGCJFBC.hAAA...VAFHIAAChACAQDAA.hADAFBABSAHHAFIF.aBCHfDCHhABALHBG..PADFhAFA...,1,-21,-37,16
dEHWUYBZXGSPafRcFNAQKOCJTVeDbLgIM,KADGOFAACEDD...TEEADFGHLBAD..gCDChAAAdEEE.EAEEUFAEYHDEhABA..XCGEhAAASBBCfEHGcDGFAGAHJCBEeHFAhACAIHHEMAIHBHBDhADAPHCE.FAGH,2,-33,-20,13
MSdCBabRZKPYeDJLXUETAQFNgGOIfcWVH,QDGCFBFBGDCBOHCE..IBFE..fAHAhAAAWCAEHEAESFAHhABABFEHaGGAZADFKGFGYDADhACAJHBG.XDGHEABGAEFGgAGBhAAAVACFCGDC....hAFA...,2,-19,-11,8
LRVgMFECKQPYBZOAIWNbXaeTdDHcUJSfG,..ICHDNBBC..aEFBdGDCHDCHUCDHJHBAGDFC.LEAHhAAAVADAFAHHEABBCEHF.KAGDhACA..QGGEhAAABADCAIFE.bABBXECGDGADSCGGfFHAhAFA.....hAGA...,1,-11,-15,4
XgBecGIULVfFJRWTbEMDKYAQOdHCPNZaS,OFCFCCAAZCCG...XGFHBDHCeECHGBGAUEEGLABEhAAA.FCCHJFHD.REAH.TBEFhAFAMACE.KFEDABIH.QGAHhAGAdBABHAFHaHCESFHH..hAHAIHFFWCBDDEEG.hAAA...,1,0,-25,25
BVLXFceQTAUKPDHCaWGRNfMdJgSYZObIE,UDFBKABCDEAGHEBG.aGGAGDCC.RAFG.MBEBdFFE...gAGAhAAASCDBOABDhABAEBBBBHHDLEAFhADAFEGAeHAETGDB.ACIFCHHDfADF.hAEA......hAFA...,1,-12,-26,14
BdRXPeCZOcVgNIYAUEHaKQWfDJFTbSMGL,UFFGECCEHAEDQGCFDGFAFDBH...TAEDSAAHLDAGhAAABGAAdDFHRAGF.eCBCCEFGOCHDhAAAgBGC.hACAIACHYECBAIFEaGAHfHFFMEIB.hABA......hAEA...,1,-7,-16,9
ZfJbXTUYMadEGQKHDSOBFLWRCgPNAeIcV,eACC..VDCAJAAB.TEGCMDDBdBGEQFABHBED.OFFHhAAAFFFELHEERADG.hABACGAH.NAIEAIHAZEBF..XDABhACA.aBCCKEEDBDGF.gGCAhADA....hAFA...,2,-18,-9,9
LegdOZXQRFGaSUIcJTWDHbfEVKANYMCPB,MBEDCDCELFDDdDAFZDGFREGD.GGBD.UABHIGEE..JFDChAAADCACHAFEEDAHACHG..hAAANIED.BBFD.OABChABA.QFADFFAGSHAG..hACAcCEC.WADEhAHA...,1,-9,-41,32
CVJGOWAELFfIXSdYKabBMZNHgeUPTQcDR,LEFGFGBE.XECCdEECKCDEaBAA.BDABZGBGHBDH.eBABhAAAUGGGQGGEhABARBFH.CBGA.JACCWADChACAACIH.IDGDSGADMICA....hAHA......hAIA...,1,-8,-44,36
VFSOIHWUCgPLdJfNDaKEGeQBXbMTYZARc,VEFDOEBH.HDEGCDCC.LACAdGBC.JAAFDIEAKAGHEBEA.GAGChAAABHGCMCDBZEBCACAB.RFDH.hABAFABG..IFHGhADA..WEHH.......hAEA......hAGA...,2,-28,-23,5
fVKARTHQLONPZWUMEgaCFbYGDJecBXSdI,HACHLBFGODGHZCCHUFFEMIAA..EAGEaDGCFBEEGGAH.eAEEhAAABGHG.dFECfCADhABAKAAHADEEQEAGhAAANIDD...PCHF.CCAGDCCBcDAChACA.SCEDhADA...,1,-8,-18,10
dMVDgXZQLSeGWCJEcPBaTfAIbRNOKFUYH,REBCKCHBFDHBUGEFHGCG.dBEDMCAA..DDGHZEACLDBCGADFCDEGEGGDhAAA.BBAC..fGAChAAAAFFD..hABAIHAGbFGB.NADD.....ODAGhACA.....hABA...,2,-30,-22,8
TdNbXJMVFLOARBUaPYeHCDZSQGKEIcgfW,BCACUGFD.aAHDeDCGHEEGCHAG.ZAFHGCEH.KFAHIFBC.hAAA.fBAFhABAdDDDXFCHMFCDFABGABDHRAEADGIHhAAASDAGEAED.gEGCWHEA.hAHA......hBAA...,2,-23,-11,12
MSIXKUaWfADCbeOZTPBVGEcgdHQYNRLJF,CFACeCCEZDCEBFHEEGADdCFA.HEAA..QADARCAGLGFGFBAEIABGhAAAKGAH.aCHHADAGDDGFhAAAOAEC.PFFGhADAVGCE........cGGChABANEEEMAIH..XCGBhACA..,2,-34,0,34
aHdPIgcBRQVLEFfOUTGWbSKDXeNAMYZJC,ZAFAJBEAHDFDdGGF....ICCDBCEGQFAEECFH.OBAAhAAAGEBB.WAAEhAEAKDAGDGIF.eFFDAHCBMBBDhAGACDDGaDHF..PHDE.RCGH.LHAGhABA.....hAHA...,2,-24,-15,9
MeZLdNgFBAVbKCJWUaTcESQYXHGPROfID,KBCECGFHUCBD..TGAC..EAECSGDDQGCFHGFEhAAAGCEAOFCADBBCMEADhAAAZCAANAEF.BECD.ABHE.hABAJCEEaDGD...XBGCfEHAIHHDhACA..dABG.hADA...,1,-12,-28,16
NWMfYADLUgcTJKaXBRSeZOQCPIFdbGVEH,LFBHUEBH.TFGAKAGHaBDB..BEDFeCGDQAGAhAAA.IGAGdFFEGGADhAAAECCFHGDEMACCAEEGDCBBhABAJABHXADFSHGACDGD.....hACA......hAGA...,1,-14,-26,12
eQbJHVNaLPWADdgXECKITGMcBYZfSORUF,DADFdBGGEEDACCAC..KFCCGBAB.MFBFBDEBZFDEOGDEFHEEQDBBhAAAHBFE.aAFG.hAAALEHFAIDGIEGEhABA...TCBHYABCSAFChACA.eEAH...hAIA...,2,-35,-11,24
ZBEMACJPGDNHfaVLRUcbeXSFKgYIQOdTW,CHABJACDDHCCHEBB...aEFGVCGB.LADERFGBUAEH..eCADhAAASEDBKBHD..hAAAIDDHdBBCTEBAhABABHAEEGHFAFDC..PGDCfFFG.XBEGhACA...hABA...,1,-22,-24,2
JWdgLFGSAKPUMOfCXNIebVQYaZHTDBREc,KBGBUDAEOCEHCBGH....XGGBeACBQGDBZFAEHDECDIAEhAAABFAFRAEF.EBAHJBACdHGBhAAA.FAECAHFA.MCIH.hABAfHAB.NCCA.IHDC.hABA......hADA...,1,-20,-27,7
IgPaATEbROLSMWZCQYdGNBJDHXKFcUVef,EHBGODFDLDDF.MCDACHFHdBBA.BGAFDGHFKFAAUAFA..VAAGhAAAeEBA..fAEHhADAIDHCaBEBADHHTEEGhAEA..RFDDSAAC.WADFhAIAYAHH.NEIEXGEAhBGA,1,-10,-45,35
daVOgZHKSYLBDANWIUMefCGRPEbQJFTXc,..IBHAeDEFGBEBRECG.EBAHQADHFFFD..TEBGhAAAXCCGdHBHOABGhAFAHGBAKDGASEHFhAGABHFFAFGGNDAEMABFCHHC........hAAA......hACA...,2,-22,-12,10
TNeJfWSOGgQDdHARFXCZMVKaYULPEBbcI,XFAGMICGKFBB.UBBCLBFH.BDCFIFFD.eHFAhAAAJABBSFFBhAAAGADGDBIFABFACEDCZADH.aDHFYEFChABA.PHCAEAGGbFGH..cDAChACANBAE.....hABA...,1,-13,-27,14
TESILCRQHgKceNZdBYPUXJGFAMbVDWfaO,VFFFDDEB..aBDEEAAHLHAC.CBAH.QAEDHEGB.KCHFhAAANIEB.BAHC.UEAAhACAJDAFAAAEMEED.fCBDhADATCBHRCFCgAGC..eFCHhAEAdFFC...XDEFhAGA.,2,-23,-12,11
OHJBAULQfGFMNPYDTSCcKEZbaWRdgVIeX,QFBAFBCFMICE.....PABADFAGTDEECBEAKGEAEFDAaAAH.hABA..RDEG.dGGGIAGGhAAAeGCGHAECBCCCAHAC.hACAUGGCfDAD.YCHBSFADhAFA....cEDChADA.,1,-16,-28,12
ENGQRCPeZcMgHDITSLJKABVYbWFUdOafX,BECAVEFF.....bGEAUAAE.dHCBaEBBEAEBGAEF.CHAAZEFAhAAAMGAAHABHDECASADDhAFAKHCAAAHAFCHFOBABhABAXBFD.NBIE........hADA......hAEA...,1,-13,-28,15
AWbCMTQLXKSaDPIeVNOBEgfRJFHcGYZdU,CAGCTFAALHFE.KDDDSGEC.aCDBIDAG.hAAAeCECNAFCODHBBFACEDHDhAAAfBAERABF.hABAFGHDHEBB.cEFAYHCAdHBDAFFHWCCDhABAMAIDDDGB...PAHFhACA.,1,-8,-29,21
WSKQbYcIJfVUHLDXBgdARGNMFTCePaEZO,GAAFFBAGCDFH.eFEA.EFBFOHDA.KFCDbAEF...ICHEhAAAJFDAUCCADIFGBHAAhAAAdCDGAGDB.MEFC.aDAFhABASBFC....cAGBhADAfDAC...hBIALAHH.,1,1,-47,48
VeGRCTfdFDZUOSHPIKAQJLYENagbMBWcX,LGECECEB.aAFEMGCGBCCD..XGFAGDEBREBBCAGGdBAADGIFZAAAhABAOFFG.HFAFhAAAKBEDAICCJACH..NEAE..hABA.WEAC.eCFGFHFCSBHHhACAPHCE......hADA...,2,-21,-6,15
DVceMECXfGNISJWFZdTLbBRYaHKUAQOPg,QBBHOBEEDDGE.eEFA..EAAECCHFGEAASCAFFCFHTGCHhAAABFFFRDDHHFAD.hABAAHED.PAFA.gGGChACAMHFAfDBEIADD..WAFEhACAdECH.....hBAA...,1,-8,-24,16
MPQFcdgYNfIRbDUOCHESGeWVZTaKJLBXA,MDGFQAADFDAC.dGGE....NDDE.IEEBDGIB.CGBBSCDAhAAAeACCZFGBTBGFhAAAaAEBKAFG..BGBEhABAAEGEPDAE.gGDAYEEFfGAGhACA.bBBEOAHDhACAEAFC,2,-37,-31,6
AOYbKBFVeXCQRgNMJfGDZHUSWEcIdaPTL,OAHHKCDEBFEAFHEE..eAAFQEGFRFAD.MEDHJAFADGDFHACChAAA.SABChAFA.EFEEIHHGhAAAdGAGaCDC.TCGBAHHA.VDBG..CGBA.fGFAhACA...hAGA...,1,-13,-36,23
XZKILBeUCcDQYAMHdJSONPEaGTRgVbfFW,MHFCHCCFSGCF.OBAGPAECaBHDGCED.gABHhAAAVFFHFCFGZAEEhAAAIEEGBDAACEGEDEHDYFAFhABAAIGCdECEEHCE.TEAH.fHADhABAWFEF....hAEA...,2,-19,-3,16
GYWcCPRNIBKLdFXOQDEHAZMeJUaVSgbfT,eFEDJDHB.UDBA..SDCG..gCGDhAAATACEGEAE..YBCGhABAcFCAPAFChAAAIGAEBGFCKDEBdGGBFBAFODDADBIFAFGEMADGhACAaHDCfGHAhABACBBFNIAB...,1,-15,-27,12
edJXgPbSOaDUMYRHCTAENfBGKZFIcQVWL,EEBHBDDGKAECFEHD..QBBELCBFJAEG..XGFChAAA..gCEEhAAAPCHD.SFFFhABAaEDAMIBAHBDEAHHB.NCAEfEGGIACDWEADhAEAdFDGDHACUGCF.CBGA.hAIA...,1,4,-39,43
TNCeQaPXgMbZIWHLKAEVURYfBcFDSJOGd,UFBAREBFBHFCDEHF..ODBAdGEG..CDCE.aFFE....XBEAhAAAMAAGZAFDHBADKDGGAEEEhAEAEGGD...fEEFhABASBCAJAHFNIAF.eADA..PAHDhAFA...IHHBhBAA.,1,-24,-41,17
YTCbZGLVIcfXNOSaeBMRAWdFgEPUHDQKJ,FCGBECCDUDGHHEDGDIGG.KFBBJBCC..CCDD.GCACLAFA..hAAAIBHF.XGGDhAAASABEBFEHhABAAGGAdCBEQGBH.YAFE.hAEA......hAGA...,2,-42,-19,23
BTRVXNfDZdgeaAbHUMCQGYILKJSFWEcOP,UFGBMCCAGFDFLFABKHAGFDFA..EHCGODAEBBGD..TCABhAAARBCA..XAABhADAfDDBDAGCdGCGgCGAhABAAHFBCFEF.YAFC...IACAhAEA.SHFAhBAA,2,-38,-11,27
QdaKMGSRYIbVPWHAcCEgDeOFfBLTXNUZJ,CACCDECBFCDFBFFE.LGBA..TDFBUAADZBDGQEBEhAAAKFHB.GGCD.hABASHBGIDGB.hADAVAEC.HBAHAHHFEEDH.eAHDOHFENIAF.hAEAaAHF.MEAD.bFFEhABA...,1,-8,-32,24
NMLUJPXTQfgCcEIFBHeWVbKADaGOSYRZd,DCBAaCDBGAGCOFEF.RADG.dAGGLGFE.UGADPEHB.QFBDhAAACBBAEDACBEFFeACChABA..bFDHAEEGSDDDhACA.NIABXBEDfAAC.hAIA......hBAA...,2,-27,-13,14
KgIRaESdALbPCOFTVWMYfZeBNQXDUcHGJ,LBGHCBAAFFHB.TBAAMDFD..ZECDBFAD.QDCAhAAAUCGDHDADJFHFKAGB.RADB.EBEEhABAdHEBAEEGOHAC.hAAAVGDA..WABBfEADeFAD.DADDhACA......hAEA...,1,-16,-20,4
fDXITQLYSZbWFOVCHecUBdPMEGKJANagR,aFGHREADDAHD....XCEETCFGLFFCSBABZACEFFCDOEDBhAAACAFB..eACDhAAABGGAMECEKCADACDDfBHAhABA.IEHC..YHEAhABAWEADcADHdCEC.hACA...,1,-23,-30,7
PTGHBDIJEKZRLSaVbfXUAgYdONcQFWeCM,dACBOFCFQCFHFGFC.CBGB.MCAFGDDGDIFA.EFGARCEC..LABFhAAAVBAH..fFAHhAAAXAGFABEANIEH.eCHHhADAHGAGBGBG.KDCGSAEH.hAEAaGFC.....hAFA...,1,6,-26,32
RJZDLcIVUHXbYaGTEFOfAePCKSNgMBWQd,CEGHSBBE.MECEQEAF.RBAHDAAFLDFH.hABAICHBHAGBbDEFYCAHhAAAaCDGGGABFHGAAGCGhABA.eAECNEIEBGGFWGBA...dCCD..hACA......hADA...,1,-13,-23,10
aINMCJOgbDSfWBKHFYPREcZQTGVLUAdXe,dGBBaGBB.MIDE..JGDEODFADGHB...SDADBAGGHDBChAAAFFHDRABEECFCQBDGhAAA.TEFFLAHHhABAAABEIBBHNDAGCEFF.fAGA.hADAWEED.KDCD..hADA...,2,-28,-25,3
CXQbgTVfKJBDAMUIeRPOHGcLaWYdSENZF,MAHHeDCDRDEAHBCEGGAHLFDH.aGFHdCAC.NBDF.FDAH.CGAGQAABhABATGFG.KFBGhADABABBAGGE.PCCAhAAAWEDE...SFGEEGHF...XBGAhADA...hAEA...,2,-17,-7,10
YDQKPOGbcXdVFTJWNZUSLRaHABefICEgM,eFFFCCHD.EDDGMCDHDBAE.KFFDGEBG..XDACdFAGFBECTCAHhAAAJCFF..ZABCSFDHhABARGBEAGIDBAGB.fDFBhACA.IHHFYHEG..hAAA..OAEA.hACA.cFAGNAIC,1,-16,-36,20
TSOUPVcFZfgYXJDWebGRQHdCIMaBELNAK,KBADSCBEOHEC.UEAE..VEGDFGHDZCFF....fDDBhAAAXFECDIBGhAAAeAEDGACDHDAHCAFEMAIBhABAEHBGACGG..........hABA......hACA...,2,-28,-26,2
BOWJfRXTdAFPCSeYEKQGcHMLDgIVNbZaU,CGHEeHFCKDBF.QAACGABFHDEHDCGH..VDACZGAEBHDH.OAGBhAAAJFFERDDHdHBBAABCFGGHSAFEhACA.EADGhAIAMCIH..........hAEA......hAFA...,2,-29,-11,18
NbTWSGMgHePfEFYKIJLOXaACRQBdVcDUZ,CCECBFFCdGAA.DCIDUBAHZBBE......TGBESAFAGCDFhAAAMIFAeFAF.EHEEKGDHhAAALAFGaCGE.AABGRDBEhADAVEEE..bEGDgDBG.fFHChABA..hACA...,2,-41,-7,34
LNWdUeOCKZDEAHISgPBMXcFQRGfTJVaYb,HEDCSCADBEHAXGADQGCDRACGGCAFJCCE..VEGDhAAAaHDALAGDdAHG.hABAUGGBCFBCKEEFEAAAIBBChACA.MDFGfEAD..YFAFhADA...hAAAWBDE.,1,0,-29,29
HfYcaEFTBOGdZJLMPKebCWNRIDAgSXUQV,SDBCQBFCHEFC..fFDFaBBAFHAGBEBAOAFAhAAAZEDBMDADKABBeFGBCBEG.hAAAREBHABIDUGGHVBFHECAGdADChABA.PDHDNABD.DEDG......hBAA......hBEA...,2,-6,-6,0
dHZQYVJXGEgaWTMDICfFeRAUOcKBNbPLS,UDFFOCFBBGBG....bFBDLBEEdCAEHFGFQBAFhAAA.VGDGJAAEEBFEhAAAaDAE.MDEHDADHCEDBfADFhAGA.FHDAAGCANDICSCDF.hABAYAHHXGGD.hCCAWAFE.,2,-35,-3,32
dVXDRIaQMJLTUFZbGBECgWKNSHcYfeAPO,dDDBDFBDRBAAQGAFLCHH.FDAFZAEGGEGEBGCB.CFCE.KGGCHACG.hAAA..fGDChAAAADEEOFEF.XAFHhABAMEEAUDAFEGFDNAIG.SCAE...hABA......hACA...,1,9,-36,45
KfAdgHLNIXCMWaSJTFDRcBVPYGUObEeQZ,HCBHLCHFXFEHMADG...SHBAFEBEDEGBRBDBBHGFVBFEPGAAhAAAUGBE.EDFDeBAHhAAAKBCCABAEdFEA..NEICCEAGhABAaAFE...........hACA......hADA...,1,-8,-26,18
VNPLSIEOdYKJHMgaBGcZAXWbQeRCUDFTf,XAGDQGAERCBC.DABA.FHGG..TADH..NEDHSCDAhAAAIHFGdBADKGCBMEEAhAAABFHEGGADABECeFFFhAEACFFGfDAELAGF..OCBD.hABA......hACA...,2,-22,-20,2
VRaEBZeOCSfHbDPLWGKJIMUdgFQYATNXc,XEBGVFAD.RDGF.aEFGBBHE..eCCAOAAGCEBB.HCCEDDIBLHDGhAAAGGAFIAFChAEAdBBHFFDCACAD.TAFHhABAEGHFSGEE.fEEHhAHAPFHB......hAIA...,2,-18,-15,3
aTRNZUOIYfPACWbMegEcGKHBJLQSdVFDX,CHCBMCCE..eAGDEFFCGEAFBFFELACDdHCDDADG.aECCRAAHUBGHhAAAOBFH...IHHFhAAAfGAC.AAGE.hACAgGEGHDEE.SBDBFGHB.hAIANBAGYFAB.hBAA...,2,-24,-8,16
ZIFgSUeVYKNABCLbRHXdcPTDQJGOMfaWE,BDHALDDFHAFHdCAFTEBFDIFCGAFE.MHDCfBCHhAAA.EFEGFFAA.gABEhAAASGEGeFFEhADAKCAAAIGECHBF...........hAEA......hAFA...,2,-27,-24,3
cRPICfUaZWQNAeHDOFGSgTMBXbEYKdVLJ,eEABOADFFAGBGGEH..SHFAMCACBFABXCBChAAAEHCEdEFDLCFCREDHCABE.hADAfDAFaDHDQDFFhAEAAABDDDDB.gADA...YFCFhAIAKGAF...hAAA...,1,-4,-23,19
TRYWaJKISUNQZBgPdGLFVCbfcODXEeHAM,RFDHaADDKACA..UFCFQCFFBGGA.dABGFDDG..CEAB...fAFEhAAADGGDeCDFMGAAhAAA..TBADhABA.JDAFNCIA.ZAGHPAFALHFG.VDFDhACAOFHH...EEEEhAEAAAIB...,2,-27,-11,16
fUVCRgPGQXNBMFTJcDdYbIeHAWKSOLZaE,KDCALECBEGDA.VBFDRDADGADH..QGFFBDFFMABAFBAChAAA.TADAJHFCDIBAdFAHhABA...IEEChACAACBAOAABfEHGCAHBXCGD..NAIGYHAAhADAeGAASFFEhAGA..,1,-16,-17,1
CYAcRPFaJGQZKTOSHUIMNLWeXbVEBDgdf,RBBEFCEHGGEBQGFHKFEE..ODFASEHDHDBBUAFCMCDBLGAGhAAAeEAD.VDAFhABADEEEdABFCBBFAAIFaADG.hAAA............hAEA......hAIA...,2,-16,-16,0
LKTWCMNOIefAPFgQGHaVDbEcZJBYdXRSU,FBBFQEDHHCGDDGHBEHCGZDCGBAGC.dCFEXGCFUBAA.KAGFCHBG.hAAA.MAEDOADDeFHBhABAADBD....PFFFhAAA..aCCFbFADcFAB....hACA.JHEA....hADA...,2,-21,-19,2
MENFfgPTYSVbUKCdDRJeZXGIQBaHLOAcW,MAADFBDA....fDABPFHD..TBBESHFGhAAAUDBBCAFDDAEA.RDGFeBFHhABAXGEBGDCABCGF.hACA.LHBGAHAEEFCDYAEFKBBHJAHH.IEFChABAaGGE.OHAEhACA.cAGF.,2,-14,-2,12
ZMXVdGgeREHOUfCJYLFDbBSNWPTQKaAcI,ZAFAXDBHGFEBRDDA.HDCF.UCEBCEHFLADDDBAFBCCC..SAHDhAAA.NCAG.hABATGAHKGBB.aBBGIFFChACAdDHAEDAHfHEBJFHBFGDB...hAFA.WBBFAIHCMAAA.hAGA...,1,-7,-24,17
IdBDRXUagcEHQKZMFPbGLeJVWNfATYOCS,TEEGOFFF..SEDF.BDACDECAXGGGUAAF.hABAgAEEEDBCHGAEKFHFhADAMDDCFAFEGBAHhAAAJCFC.NBICADADIHEHRGAAaDAD..cFCA.hAEA......hAFA...,1,-4,-22,18
YUedLXbSTKWDMNHPOAZVJEFBQGRCgafIc,VADCFEGFQFCG.GABARFFAaHDG...IEEAUCBCdDFGhAAAXAEETBGFDEEDhABANAAG..HEABAAGA.EAHFhABABDACCGGG.fABF..cGDEhADA.....hAIA...,2,-29,-1,28
WPBNdebUfagTXGZFDRcIYMSCKOVJQAHLE,EBEABBFDdCBFeBDF.UAADaBHF....TGEFZEEFDGDB.RDAF.IHCAhAAAMIFC.CHAAOEEAhABAQCGALEAEhACA.NGAF.fHAFXGGH.FGGAYABGhAFAKAGEAGEH....hAGA...,2,-20,-20,0
APbBKWTHCSNFVIYeOXDLQagEfGMUJRcdZ,BBGETEEESEBB.FGDCIHHD.OGCEXABDhAAALCEEQDDFhABAEBCBfGAEhAAAUGGCJADGdHAFAAFFKDAH.CGGFNICBYDAFDABBaEBDMAIHhACAcDFE.....hADA...,2,-17,-17,0
AQEBOIcGCgYNZSaTLeXDdPMJbURVfWFKH,EBGFBGBC.OCEHGFAF.CGFH...NBDH.aDCELAHBDAFG.dGGHhAAAMBAGUABGREFE...hAAA.fHDDhABAKHCCAAEGQDFCIDAG.YCACSGADhAGAeBHH.....hBAA...,1,-12,-34,22
dJaFRVHGNWBYfLPQXUSeDOCZbAITgEcKM,TEACEEFEKBHH..dEAFaADD..FGHDHCDCGEDEBHFHLCBEhAAAXABGeACGDICCCBHAABAB.IEHFhAAAMAGD.JEEFVFAFhABA..NHADfAGC...hAEAUCAD.SGGEhACA.,2,-15,-9,6
WUAgdBOTEbVQCYMHRXGNaSKPcIeZJfDLF,BEHCOCAGECAB..QGBCCCCGHGBAGECDSFDGKGGC.IAFChAAAZAFCDEAHLAAGhABA.FCEGWEBChABAAIFC.dAHC.TGGG.VCFB.MDAHhACA......hADA...,1,-20,-22,2
HRCIMGDEJQKbFAWdNceXfaOPUVYgBSLZT,dGBAeFCEaDGCOACH.UAFFVCAB.BAFESHDGLFEBHGEChAAARABC.CCHHGDDFhABADCFBEBHF.QGAGhADAKECBFGHHAHAD.WBBD.........hAAA......hABA...,2,-26,-1,25
LNQSBWPaAgcJGIebdXFDKRMCVfEYUZOTH,JECEGCDH.eECGdEHADAIBRFAF..MHCCCAGH.EEGAUADDZAAHHADEhACA..LCAFhAAASGHDBHDE.aHFEAAGGcAGEhADA..bCDA...FFFH.KGAFhABA.....fCBAhACA,2,-34,-10,24
NCgfScYBFLGOPKIXMJbEDRWHUAVZaQTde,aDEDTCGD..eFCGCEDA...SCAFBHGAGAAHKBDEMIEChAAAEGBCDBFFRCGBUGAGAIBAVDAEhAAAQAFC.hABAdDCBfFFB.FGEB.PAFGhADAIABD.XGGEhADA..,1,-7,-25,18
DPLAYKTERZQUbFaHfJCMSOGWdIVBecgXN,TCEAECBFRFBB..UAEFFHFAHECE.CEHA.ODEAdDABBHDBeGFA.hAAA.XBCFDIECABIDKFEEhAAAQAFA.hABAaBHFMADBSFAD.WGFEIEHChACA.....hABA...,1,-20,-30,10
ZWRKeYHNdfUOPQECTaDcFbLABGMVSJgIX,GDAEMADG.JDEBXFFEZDFD..KHFAHCCEdACF.OGBC.hAAAPBABEFCFCAHGDCCEbBFA.hAAABFHH..SECGhABA.IDGDeBAFNIAB.fAGHhACA....hBBA...,2,-30,-21,9
WMTVOPJNUEZabCefQSgDYILFGAdKRXBcH,dCDCXFDDBFBAHGBG.MAAETACB.OFGFJDFB.NBAE.ZAEBhAEA.aHFGCGAG..fBEAhAAASBBFDGBEIAHEhBAALDFAAEBH.cBBH...WHCGhABA.....hBDA...,2,-33,-17,16
ZAPNTHDSCfIMGVBJRagdQFbXWeKLUYcEO,TCECDCGFCGAE...MICCBDCA.RADE.aGEEdHFFFADG...XDGHhAAAKCAFLFDE.hABA.UFBDEBBBACIBNBCESEEDhACA.IAGDJHBG...hAAA......hABA...,1,-18,-50,32
EdSaMXIPJOTLHYbBUeNCKGFVgQcfWZDAR,REAHSGFCMDGH...XAGEJAAGLFDHHBCBBDHEUCDB.hAAAeFBFCHGG.KEEDGAEBhAEAFDFCQAADhAAA.fDACDDHBAHCCEFHF.dHCFaHACPHFChACA.OADA..hAHA...,2,-22,-3,19
gAfLZYOTaKCJFUBdcRWXIVeQbGPHMNDSE,LBCHOFDGKBBGJBGHBEBE..RECC...XAECeHFGQGAGhAAAGGDDHBGFMCIHhABASGADAEADZADFaEGHFCAFhACAdDDH..WAAE..IAHF.hAFA......hAGA...,1,-9,-28,19
GDaVBFRKCYHETMAUSZbOJNPeWfLdIXcQg,UAEBZCDDOAFC..PAHDeBCFLGFGdDGA..ICBChAAAXCGC.gEAEhAAAGDCBDFFFBBBFhABAKFCHCABAEEHFMEIHSACENDAC.fHAFhAFAaGGH.FHCE..hAHA...,2,-23,-14,9
MBTaIgZUGPDecFNbLJCHRWfdOVXYSAEQK,EEEEKGAHBAFC..TAAHaCEH.ZECFUABADGIDFAHHLCGH.hAAAHFDARADF.dEBBXGEFhACAAAIB.MFABIHGAhAAAgDADeFCDNEIECGBF......hAEA......hAHA...,1,-16,-26,10
LFSCBMXOPcAdHEIRTeNVWGYKUfDQJZgba,dGACEFHFRECDeDHB...VDCDGCED.KFBFDCDEJADBZAAB.aFEDFHEChAAA.BAFD..MCGHhAAAXDAC.OEEChABAcGGFAAGG.IAEH..WABHhADA..fACAhAGA..,1,-25,-31,6
BJQNIFfPAGdXYcCMTUSeLDbOaRWZVEgKH,GEBEdEAG..XADFCGADMHDA.UFFBeDFBDDEC..aBCGZBFCEAFEhAAAKBBBBCDH.JCAHIHBChAAA...hABAFDDHAAID...YHDASHFA..hACA......hADA...,1,-31,-36,5
AXSBVeCGDHTLYOQJPKEcRWfIgNbFdaMUZ,BECAVACB.eADHGBACDGADHGEELHACOBAAQFDB.hAAAJCEGEFFERGFC..IAGEhAAAgBGD.bFBChABA.dDAFaFAE.MCIFAEIBCAFF......hABA.....YEEChACA,2,-25,1,26
gXRBeUbAHQcNZSPFDWCVOYfaLTGMdEIKJ,QGBGZFFAFBFEDIDA.CGGH...OGAEaCFEGEBD.dADDECADJCADhAAARCCFBGED.UDGFhAAAAHAENAIE....PCCGhABA..WABGfEGCMAEA.IAGEhACA...XGEDhAEA,1,-10,-44,34
TbYLUcDfPCOSaMGdXRJNEZeQgWHKBFVAI,TAAG..bDBHUEECDGEB...CEAHOGBCSAFD.aBCChAAAMAHDdFGE.RAEHEACEeAHHhABA.QEEEhACAHCCHKHEABGACAADHIEAG.cDDGfHGBhAAA..PHAEhAEA...,1,-13,-25,12
IGHRFLMVeQXSZbaAWgEdNTcYJfUDPCOKB,ECEFTDDD..JCGBUCAFDHAE...OFFFBDAHHECFFAHBMGAChAAAQAAGZEGH.AHIBdAGFhACANBAF...fEHAhADAPAFHKHDAIFAF.RFEHeADFhAFASDHB...hBAA...,2,-20,-19,1
QGZHAXVdgIcMNCTLPSeOUaEfJBRWFbKDY,dFHA..gBFCIGAE.MGEECCHCLFEFeEBHUABE.aFHDhAAAJBAEBHADFCEBKEBADDBBQDDChAEAHAFEADCC.hAAAXDGG.NICFSAFCEDAF.hABA.fGFEhACA.WDGD.,2,-24,-2,22
fXPgcHKOWBbAMRUdIGTaQLECeDFJYZVSN,UCDFdCGAGCBAQFBECBAH.FGFBJHBAZABC....VEDDNBIE.hAAA....fGGBhAAAXCABPAEAhACAHAEHKAHHBDGEAAGCMADFIHHEaHFC.LHBAhADAEEAD.DFFA..hAIA...,2,-20,-11,9
deCFZKgIQcVYaBDMbROGTLHEUNPfASJWX,JEBGXADE.dAAECGDCFBAGZCCC...KEFFQGAE.VGEChACABGAE.DDCGbEECOADEhAAALAGF.EEAFhADAUGGA..fECEAHEFeCHH...hABA.IAHFaCHF.hAEAMCCA.,2,-54,6,60
LgRAaJCVTUPNHBIGMKdfOQESXZYDbFcWe,JBABCFDCUBCDHCBF.BHHHGGCF..KBGBdFFBQEDAEDEC.hAAAZFAHDACEFDGHeBFALAAEhAEAAHAG..aFAA.hAFA..PBAHIGGFMIFGSAHBhAGA.....hABA...,1,-16,-29,13
ABXdgbaOYQRCDUTVJPZLEKScWHeGMFINf,XFCHdFDDaAEH..OAHBQCFC.DHGCUCBF.JAAAPAABhABALHFAKGADSDBHhACAHFAHeCHHFCFDhADANAEHBFHA...YBDDCGGH.ZEEG.hAFAcBGF.MIEAhADA..AEEH,2,-23,-17,6
RcODAGTNWgHVaYFSMPbEXBdQfJKeILZUC,GECETBAC...NCFC.HDDA.VFCBFHFGMCHHEGFEBGAA.dBFAhAAAQDAAKABCLHFGhAEACBAEOAFEAAIDaFAG.SADChAAA.XGAGeFFE...hAFA......hAGA...,2,-22,-2,20
QXBgfcDdHMWeNZFEITCUSLVKOaJGAbYRP,RBDEXCCDBDHC......fAFDdAAAMFBDeFEBFGEFTDBFhAAACAHHLAGF.hABAKEHFaAHFACHA..bADFPEDChACA..gGGADGHFNDAAEACHIHCBhAEASCFDOFBBhBAA...,2,-24,-19,5
XaOYNQSGbUHFLfIJCWBTKRVPgMdeEAcDZ,DIBCaGDA.OADF..QEAHGGCDHAFELEHFJCBFBDDGhAAARCDFgBACdDFB.hABAEBHDAHAEZFFC.NCAA.SBDChAAA.FHAACBBB.WFFB.KHDGMIFEhACA.....hABA...,1,-14,-18,4
JYMIaCSfUeQEBgARVDOXTbGFWZKNdcHPL,RFFFDHCAOBCE..XAAHGBAGFGAGZDFBdEAHHDEALADEhAAA.MICECGDHfACHhAAAeFHDQEDGhACABAFEADDH.TBDDKHBGNEIA.cAGE....hAHA......hBAA...,1,-15,-17,2
ITXQWDceJVSFYgAEZUaRNHbMLGfBCKPdO,EDEAaADCHDDBLBDCBHGECEAD.dDHC..TEFGQAFG.DCDBhAAAeCHBSBAEhABAFABBAGHAUGAGREAHMDGBKDAEIHHFhAAA.XFCFJHCG..YCADhACA....hAEA...,2,-16,-15,1
ZBQUJcCROYWageLKMdFVHEASGPbIfDXNT,SACGGCFC..bECCDEAH..TBDDBFHGQBGGhAAA.JFDBCHBDOAABhABAaDAFLECEMDIDFHGAhACAECCEAAIBIFAB.fDAFNIEH.hABA.cGADWHCEKAHFhADA...,2,-24,-24,0
QVIZFSEegJfODdMbcNAGWHRXBKCPLTaYU,GDGERFEABFCBKBHBLGDC.TBCHaAAH.QEADZCCCFAFA.hABASAEEEGCD.hACAJHAADBDEdBAAMEACNIEBHCEFhAAACGHH...........hADA......hAEA...,1,7,-40,47
fZeRQDcXLJUPOIbCHBadWGEMYgSKANVTF,TGFHFAAFZFEARFBB..QCAFDDGD.LCEDUCDG.IABGhAAACADHBAHE.dFBD.EAHFhADAMFIFSGEFhAEA.ADIDNAGEeBFE.JHEAOHAG..aDAChACA..WBCH..hAFAYFAF.,1,1,-36,37
KUTfPAYVFOgedIWZBQEcRHDbJLCNMaGSX,FGAGODDHdCBEZECBBHGE..EFGFHCAH.DEHHJBFGCCFC...MFEBhAAASBBE.KAFAhAAATACCAGIF..gGDFhABAeFHH.ICHHWCFA.cFAHhACA..LFFFhABANAEA..,1,-22,-44,22
PVcETXQDYBagbUeOKRFAIGSCHNdfJLZWM,SFEHHADBdHBDLAABMCEE..VFBAEFDBTDEC.DFGDhACABGAD.aDAAUBGBhADAOAEEKFHDAFBACGHENDDHfDBHhAFAZAAE..cGGC....hAAA.YEEC.hAGA...,2,-18,-18,0
XOVQUSKFNZMWJPAfagYDecHCEGLIdTBbR,aEBFDFFGeFEDHFFDEAEGGBBB.LHAGdAAABCBARAEE.ODHDUGGGFABGhAAAMDDH..JDECAICEfBHChACA.hAEA.YCHHCGADIEEG.TGDA.hAGA......hAHA...,1,-10,-17,7
ITJXYKaLZGeWMScbOCURgPEdBADFfNQVH,FBGGQFBHHFDHJCDBKAEF.LFFHGABHMFIDSBCB.hAAAOEHFCEAAUGACgCABhAAAEGFFACCB.DDAFfCHChABANAGE..IDEH.YAHFhABA..aCABhACA.WCFD.,2,-13,-13,0
gHEDUdCbLNOWQBaPVAefGXMJcRYZISTFK,GBCBJEGH.RDAHZFFBSCCBFFDD.KACAEABH..dCGFCHBDLDFEhAAAOEAB.BAGGaFDB.hAAAAADH...eBEH.hABAfCAB.MECDIHHGHFEFDEIFhABA.NIAF....hAEA...,2,-32,-13,19
SGVKDWTfeEXFgcCMRLaAHJIUPbZOYNBQd,HDECUFDDZBDHOAGDBBHGdFDBGCACKAEFDDAA....TGGFhAAAfBBHECCB.XGBGhAAA..FEHFCFHBMICGhABAaAFHAADAIABB.PHAENAIESGGDhACA...hAGAWDAA.,2,-32,-14,18
LWQFUVADaRdSYbJTIPEMgBXZfHKcCGeON,DFHFdCEE..SDGFJFAA..TAGGIFAA..MHDGhAAABHAFZDFGHCBGKCACCCEAGGCHhAAA.NBEBWBADhABAFGAHADCEaABG..YFFGEAEA..fECBhAEA...hACA...,2,-32,-28,4
BYbAdeEDCXOfURLSQJcHgVTFaIGZNWMKP,dGFADBEFCBBAOCFH.RCBA.LHCC.JBHFHAGB.VAACFFAGGDFChAAAZECDMIBEBDBHhABA.ADAC.EFHB.fGAFhAAASAEEcAEGaFCE...IEAGhADAKHGG....hAEA...,1,-15,-37,22
EQBDOSMGbPfZYIcRdFeWJgVKLaNXTHACU,EADADDFFMBAHGGBD.....bABHfGFCZBFD..ICEAhAAAdHCBFCDBeBGDhAAAWFBC.JDBBKBADLFGBhABAaHEE.NAIE.XGGFAAHFCBBCBGAGSAHHhABA..PFCChACA...,1,-4,-23,19
NYUBHdKPRDcQXOICbaVMTJFZgEASWLeGf,LDAFGACD..fCCDNIDH.BEGGKEFFDBAA.QCGChAAAXCAHOGAGhAAACHBD.aCFEVECDTGGChABAJACAZCCGACFGSEEDeFHD.YHAGhACA.....hABA...,2,-23,-10,13
dIAYODFQNGMVUCgSZaKcbEWTJeXLRfBHP,DDFBQBEBMCBB.CAADZDBDKACE...EGEEJHCELEECBCDFHCGBhAAAdHCFAADE..FGGGNDIE.UFABhABA..SAHFhABAaEDH.bCABTAEDXGGH...hAGA....fGAGhACA,2,-40,-7,33
fCENMYaOWIXZRQTeVGFdKbAPcLHBSUJDg,LACDSAADJFCCDCFG..CDEA.EHDG.MGDCOFAB..XDBHhABARADHQBFAhAAAVDEEFGHBKFHFADIHHADHBHCEhABAfBBB.aGAGIHEDeAFG.hACA......hADA...,2,-33,-9,24
WaXOMNbVIJRTUBEQGLKHPCYAeDFdcfZgS,eBAAFGAHdBDFZCGH..SBGAaHBA..MAFC..bCECVFEBhAAARCAF.UBECBEFAEECDhABAQFGHKDAD.hACACHEFABBEDCDH..fGBD.WADEhAAA.ODDHIHHBhADA...,2,-24,-23,1
BZaSfUeXJbHKLTQNMDdERcOIFAWgCPGVY,CHGAVEDBBDBE.ZFFA..SAEHUDEB.eDBD..JADCbAAAhAAAKBBGLCHD.hAAAQGFDDHDCdHADRBGB.hABAIAGG.AGIFWCDA....hABA......hACA...,2,-50,-20,30
YNAdTfKQRDeUMbBOEgPcSFLVJWICHaGZX,dFAATDEDKHDERFEG..UBAEBCCH..EFAB....PADEhAAAcGFEFBAD..VEBAhAAAJCFC.CCHC..HAECaDEC.hABA..XACDAICADECHMIFCgGDHhABA.SHAAhACA...,2,-37,-16,21
SIJcCfVaYGBOPLEDRMUZbgTdQWeNAKHXF,HCFDXDBBFEAASHEA..cEDBCADB..aCBEBHAEhAAAOEDBLFHFhABADCIFUFFFbBGHdBBB.QBEAhACAeAFEAHCFKBAGIFAE.fFFChADA...hAAA...,2,-27,-12,15
BUZLYFJESbaRAfTcIQWPXNdKDCHGgOeVM,TBBAQFBF..XAGFdHFFKBAACBECHCEHGCBDeEAEBDAGhAAALEGHFFGC.SHDChAAAaCFDABIH.fADBhABAIDHGNIABDGBH....OAFGhABAMEIF......hACA...,1,-4,-25,21
QTNbcDFRMgJCPVWXLEKdeAYaSOIBfGUHZ,aBBEOGDCBAAEGEDFZFAF.QDBF..NDFEDBEARABBgAFGhAAA.CGAD.WCEFhACAXGGB.EDGGhABAKEGCAAED.SGGB.fAGBhADA.TGCF.hADAFCGGMIDE.,2,-35,-1,34
QPaGfNcWYRKBXMDIFTAOUCSJbLHgdVZEe,CBGHJABFLEHBHEEAdAHCZCCB..QGCAGEFC...fFBAhAAAWACC.KADBMFBFhAAADGGHFCEEAHADUBEC.hACASBADbDAAEFHH.aFEB.....hADA......hAFA...,2,-22,-13,9
ZGEPbRNJIcKdUYgQDABFCVMSOLXHefTWa,FAHBMIFALEDFHCDAeEFH..TDACaADEEBAHRFEB...IHBBhAAAKBCAdGAEUGGG.hABAQCFDAFCACHDGSEAChACAfAAGWBFA.PADGJEHB...hADA......hAEA...,1,-10,-14,4
SbUKVWGPECdfRaLIDFJBOXeHAMZgQNTYc,ZDBCQEBE..NAHC.TBBD.SHFAUFBHVFECGAEBhAAAEBBB.CFECRDFAaAEHDCABhABABAFEOHAC.XFGAhACAADDGMDAD....YHFGKFAF.hADA..dAAB.fCFAhADA,2,-23,-13,10
FaeNDdKPTWBLgfSHQRZcOMbEACXIGUJVY,CHFCXAGCUDEB...JDAFFCHF..aFGFeABB.DECFKDDD..hAAA.TACBBHABLADEhAAASFEGQFGAhACARCFCOFCBMFIHABED.IBAD.hAHA..YHEAhABAPFDH...,2,-37,-30,7
JXHVBKICdfDLNcaeWEOSgTQGRPbYMAZFU,ZBDAUACCJEFDHAAD.BFEHKHAE.CHEA.dDHEDDGELBAH..aFAGhAAAeFBG..EHGCSDDGhAAAQFCARAFG.hABA..bBEHACCD.FAHHIHGD...hAFA.fGAChAGAWACC...,1,-28,-29,1
ZRICNQbEcYJWOdSaHAPFUKfeVXBTGgMDL,UADBeEEHBAGEGECCDCBHZABH.RFFF.CABF...QBGHECDA.hAAA.JFHFdGAGHACEAEAAKCEDhAAAVCFE...XGBEhAEAMEIB.IFAC....hAFA.NCCE.....hAIA...,1,-22,-27,5
dEAYQDKeFCUgJBZRbHIfcPMWaVONGSXTL,DFDGFGBBCFDGUBFC.BGHAZCEHHACA....IDCCfHEFhAAA.MEAEaGEEODAFhAAASAGDLBAChABAAAHEKBAAJEHF..bFCC....WFAFhABANIEHXADF.EHAGhACA.YEEC.,2,-24,-22,2
OZTKYVGCHbUNaJWdLIPSRfcXEBeMQFgAD,ZEFCTEGCKADCGEDG.HCAGNAAC.aGAEJFBD.LAFE.hAAASDDHcAGHXBEDhABABBCHMGDGQGGDhACAAECADHDGVBFACBCE..WHAAIHHDhABA...fEAChACA.,1,-1,-28,27
KaQcgOENLXZdTJSFbfRDUYGWMPCeHBVAI,KEGEQFCDOAHBLCBFZCBDdHBD..SAACFADERFEC.UGFFhADAGGADMBECeECGhAAABDDFAACD.aBBBECDGTEFDhAEA..fGHCYAHB..CEEF..hABA......hADA...,2,-21,-8,13
GcCZJYAOEgBILFNTfVSdPDUQbaMXReKWH,OEHFBECCFGEC..TAAFSBAB.dBGHDFCG.UGBDaDGF.hAAAMEDERGAA.eCAAHADBhABACGGG.JDAHAGFD..IEAAhAAANDIC..fDFEQAGG..hACAKAGE..WHEG.hACA..ZCEA,1,-14,-27,13
SNdCTPQbOVEUXDGeBFYaMWZALHIJfcRgK,HADAJEFB.REDCKDGCdCEC..CGBG.QGGA.OFAEUCAEDEHBhAAABHFGFAFEMAAAZFDF.AAIHLCCAhAFA.IHCDhAGAfABFSAHD.NBBC..hABA...bCFA.EGHFhAEA...,1,-5,-46,41
WcUPGYdSDHBNebLgFXTIQACKOVJfaZREM,KEADVEFC..JHAGZBCC.RGDC.MCFE..UBGCGCBEdFAADDBAHACAhAAABAABeFEB.LDFAhABAFADC.TGGBhACAAIAACHHE...OFFGaCAB..EEDC...hAEA......hAFA...,1,-12,-29,17
YGVDcaXAJKFLSZgINCPTEefWbOMHQdUBR,KBFHFEBALFAHZEBH..IBDHCEHB..ECCEeBHB..hAAAfFGCOFGBHDEHhABAdEEBBGDCRCBG.YBDChAAADIAAaFAHAHEASABFNADD.PHDChADA.bAGBMFIH.hAEA...,1,-12,-33,21
ENJSMgORVYIWAfGFDQdKXaLPTCceHBbZU,GCADFBBEdDDHKFBALEBA.CEGEHFDGZFFFEDHBSAGD.hAAAMFAFRAFD..IHBEhABAWDHH.AACEDGEFXABChAAA.aHDC.PAEDcEABBHHG.hAEA......hAFA...,1,0,-43,43
bSWUTQYPGBdVHFZfRgIXEAJCeOLaDcMNK,eFDFOBCCLCAHDFFA.MFCHKCHF.SGGDUGCA.QCCBhAAAGAEFBGHCdABDFBGChACARBAD.IHEBhAEAXDDBAHAHJDFECHAE.aAGAbEAC..YFFChAFA......hBAA...,1,-4,-30,26
FWgcRMEJfNXKbUVHaLYDCdBPIATOSGZeQ,OBDBSAFFGEBAZBAAFFFA..gBEBREBA.MACFhAAAJAHFXGECUGGHHEDHhABAaEAHLBHH.hAAADAFACDGHBHHAADAEeEAFWBDB...EDAGKFGEhADA......hAEA...,1,1,-25,26
IBeUYdVFKaTCWJXGQScHNZPMfDEbAgRLO,LGDAOEFHBBHGeDDDUEBHdDAFFCGB.KACBaACB...CHHF.JHAChAAAGGAF.QEGAhAAASEBDHCEChABA..NAFAMAIHEAEDACDA.IHHD..hABA......hACA.YFFC.,2,-22,-17,5
MZTADOWbJRXKUdPNBCVGgHEeFILYcSQaf,OGFCJFGB.RAEF.UBDDdGDGBEACGEBHHEFCFCHH.LBAE.hAAA.SAGGhABAQCGHMICEAHAF.DHAEXCCChAAAKCABCGDH..EABAIHBH.aAGAhABA.ZEBGWFHH..hAEA...,1,-1,-36,35
QERDLPUeGYbITFONMfZBaVXCAgSJWKcHd,SAEDKGECdGAHRDAB.DCDFUDDCGCGA.....bFFHFAFEMDFHhAAABCBE.aADBCBBAJCAFhABAHDGHQGBHhACA.EGDE.LAFEeAAFIHHB.hADANIAB......hBAA...,1,-7,-30,23
HaeIFZdEVbNDMWQUXPKORJBGSAYCcTfLg,CFDATFCGLBFH.HCCGeGEAFDHDEBEA...VCBDDBBCQEADhAAAXAAB.PAHHhABAKADEOHFE.BBHDhAGAAGFE.YEEGfCAHIHAAdGHGNACH.hAIA..MDID..hAHA...,1,-11,-15,4
bKGRJYcMLFVPEHCDAXUBSZgTWdQOfaINe,XEECSEAAZACD..TBEDdHEHOAEEaAGC...IDGEhAAANHCBKDFA..RFGDJBCFhAAAMBIFFCAFECAH.CECGAABFBEDHhABAQFACfHABeFHB...YHAGhACA...hACA...,1,-7,-24,17
NfBQKScEVCFXYgeTGbdOHLPZIWAJMaRUD,aEAHUADC.DEGABBDB.QBFCSHAEEHAAFGDF..XDGHhAAAeBBDGEDH.hABA.ODAG.LFCEhACAIGGGAIGCMICAfBFBKGGECBBB.YCAFhAAA...hADA...,1,-22,-33,11
UFGVdfgACDZOEXWPBJTbcLSYIHMQKaNRe,DEECOCAGEHAA...XGBFBDAD..JAGBTDBGLFFESAGBhAAAHFBGKBAGaFDFeBDHhAAAUFGHFGGHdBFGAIEE.CADF.hABA....WAHHcDDA.MFAHNABD.hAGA......hBAA...,2,-28,-12,16
FJBOaHGRSgdYEfTIWXeMPUZKACVcQLNDb,VGBCLCEH.DICEJADEBGBA.HCBGGEGCSCADdBGFEDEE.hAAA..IABBhAAAeCBCMBAHZAGFKEHBAIAECFFC.QGEBhADA.FFABaDDH.....hAEA......hAFA...,2,-21,-18,3
dKcLJWNGQXBPUTHEZYaDfObeSAVIMRCFg,MFHDCBBEdFFDLHBE..NEBEGDCFQEAGBHEGUDEBEAGGZCFAhAAADDBA..OAAHhABASABEAIHA.IGFAhAEAFAHDKAFF.JCBE..XECD..hACA......hADA...,1,-23,-25,2
CYDMBUPQNdVEbfeRLZIOSJXHKTgAGaFcW,aACCFBEECEGC..DEDGBDEEUFBG..QDBCdGAC..EDAAeADFhAAAREFELAFEZFAASHGChABAJHEC.KBHFAADG.hAAA.....WCCEYEEF.PHAEhACA....hADA...,1,-33,-35,2
TVWHgPZfIQLABYFMORGcJKCUebNDEXdaS,BBBFFFCHMBFDRDFDGDAF.KBDBUAGF.eDAADEIFdHDB..SACHhAAA.TGEFhABAWFAF.HDFFZFCGQBGEhAAAAIHGOFAHCEDHNDIAaADA.....hACA......hAEA...,2,-28,-18,10
KVJQUHbYZMLERXfaecOAINdGBSCFgTDWP,dDBHSBBACAGA.FFBADDFB.KAADQFFFHFAHZFGH.LAEAhAAARGDC.aGAFeCFGAHDBIDDEhABABAEA.WAHHhACA.....PCEA....hADA......hAFA...,2,-42,-25,17
ZWATgQHLPKCDcXMVYdeNaJFSfBbUOIERG,QCAFLFGBKEDCDIFAMCBHdAFB..aFGCFACF.BBGEUGBEOFBEhAAARDDEZABA...AHEFHCEGhABACEHE..XEAGhAAAeFADNCIA.SAHH.fGDHhACAIAEA..EFFDWHFEhADA...,2,-24,-16,8
KPbfIaMEUgBXRDNTCZeVdAOGcSYQWFHJL,GDFCSEAFQDCGFADHHBFCJABDKGFA....bBGBaGBDEGCEhAAAUDDABFAEDCAGNCIE.CEHA.hAAA.eFAHAHAD..YAEBhABA..WHEGfADAIABHhAEA......hAFA...,1,-6,-28,22
XKFBEbCceLRVZfQPOYNITUDdGHgAJaWMS,JCHFaHAA...MBEDKBACEAGB..CFEDLCBBRFFDZFDH..QCABhAAAOGBE.NDIG.IAFHhAAA.DGIBdFAFhABAGDFCHCECAIAESADFBEEB...hACA..eBAD..hABAfAEE.,2,-26,-9,17
WFAHTdKaRBLMcPNDEgeXYQZOGSbfUCJIV,HGAAKEGHBEBALBBH.MCID..PGBGNAAA.DEIFeGCEhABA.QAFChACAODEAGACDfDEEhADACDDGVBADAIHCTFGF.aDFAEGADXDCHhAEASGGG....hAAA.bFEDIBDH,1,15,-38,53
RIfBFgaJbOZLAQVGcUeEHYWSMdXNDPCKT,QBAHGBCBeEEDEBEEHDAH.SABGdGBHDFEHKDFCTGGHhAAARDAGBFAFaBHH.OFFGhACAAGIDUFFBMFAB.NADBCDFFIAHGhAAAFGBD.........hAIA......hBAA...,2,-31,8,39
eSWOaMJcBfEVCYbgLdQDTRKZGUPFXIANH,eFDFSBBDOAFDMCEHBDDH..VFAACHBF....gFFFhAAAdAEBDDDHTGGHhAAAKCBFUACFFGEDAEGD.NCIG.aDFChABA.JAHFEAHH.LHAG....hABA......hACA...,2,-29,-16,13
RYQXLSMfJdFDGOcNBZEbaIeWHgVAPKTCU,KGDBUGBEQCFDLAFEMGFGdBBBGDAE.OFHBBDFGZAAChABAaECA.eCDH.HBFEhACAACCDTAEFCHHC.XAGFhAAAfDHCDCAHNBIAIDAD...hABAWHDEPFFDSEAAhADA.,1,-1,-27,26
ZUaeRENPLYVWCTOBGHIQAMbKSXDJcgdfF,MCGBKABDDFAB..JEDDdDGAZAAAUEDE..eCAHRBEC...EBHFLCAAhAAA..YADChABACFBBBHHF.IHGBhACAAAIB..SGAHXFFGfHAHhAHAaGEE..NCIG.hACAPCCB.,1,-24,-41,17
WcUGdgVYHPNBQXFOEZMfReADCISJLTabK,DGAFCGFA..SFDCLHDGTFEEKCDHUAFEdCBC...VBFAhAAAHDAEBDDFQEGBhAAAFABCEDFB.MAID.eABAhABAAFBD.JHBCaADFWCACcFBE....hAFA.YEHH.hACA...,1,-14,-22,8
cQCbYfNRXUIBeKdFGOMEaTgJVDSLAWPZH,ZBBBQABFCFHD....fAFCXFBFIBGHhAAABFAHKEEGdGEFFDGDODDFhACA.aEAHJAAHSGGChAEAAGCDHCFAbADF.RDCH.UGDFMIEEEBED...hABA......hACA...,2,-20,-5,15
fCPRENMAUFOTGcbdeKZSQDgWYXIJVHLaB,OEAHTDBG.GBCEdAFGKGFBQGEB.DDIBgGBAhAAA.XGDDhABAIBEEJEEEHBAHBBDDCHHHEEEAhAAAAAIBFCABeHBGSCGAWADELCGHhABA..fABHhAEA..,1,-9,-15,6
TVFCKASDaLXRJBUMbQWceIgfdGYEHNZPO,SACHLAEAJFGBUDGH..QGAHeBFE..fHGHhAAAdDDEGBADECDHZCFChAAAOFEDFGEHABIHaDABBGAChABA.MFAC.cCAH...IGCHhACA....hAEA...,2,-31,-18,13
HFNgIcUCPVRdfMOYXKebEAGJZaWQSLDBT,ZFACaECH.QGGHLEEFDBHBHCEA.FGEH..NAIE.IBDDhAAA.CFFE.VAEHdDABfABAhABAMBAAOFGBKHAChADAEDAFABFE.JHACBDDGTCCA.....hAEA......hAFA...,1,-13,-18,5
dTFZJDHMfECVOAYKSPXgGeLUNaRIQBcbW,SCDAXCBEGCGAeEBHLBDC.UEFHNEFGRFBABHAChAAA..bABBdBFGTGDFhAAAJBAGDAEFMFIFCHHHAABCKAGChADAaDGAIEAD...cAGF.hAFA..FGGH...hBAA...,1,5,-24,29
aFIKLZScMEGTPgdUAHQObWNCVJRYDBfeX,HGDEOHFA..bBFACEDDRAEHBAEF..eDAFaDFE.KBADLDBGhAAA.SGBChABAEBHHPGACdBCG.AFFDNCAAJFFEDGGChACAFAAA..IHHAMIDG....gCCEhADAWHAG..hAEA...,1,-5,-30,25
AdWCRJGBHZcOYTDNIfaELKeVbSPFUXQgM,dCGBCCFERCBH.GDDCBFFE.HAEDZFBA.OGAA.DCBG..NCHA.IGFHhAAA..aABGLBADhABAeAAD.SDBHhACAFADDXDECMDHFAHBC.WHAAJAFC...hAIA...YFHBhBCA..,1,-21,-28,7
fdNXTQbPABcJDSUMaCGVOZEFIeRKgWYLH,JBEEUABA.CECG.OEBFZGFE..FFECRDEFKBAE.......hAAA.gCDChAEALHEGdGAC.NAAFTEGGhAFAbAEEBCHA.DDBHaEDBEEHF...eGACWDBChAGA.....fBHChAHA,1,-27,-40,13
DdIJCTagGFfVBZYcKXSLENbOUeRHPAMQW,MCHFQFDFDAEH.dCFCCFDA...aBAHFFFDBBBAZBCH.KHGALBFHhAAAEEAG.OGAEeCDDPDHDhAAAAIEC.IBHEhABAgDAH..VGACXBACSAFChACANBIC....hADA...,2,-29,-14,15
TdWEUcXBVgQIPFOMAZYKRHfaeDJbLSNCG,KBDDREBEHBADeDEFDGFGLDGF..NHDBGAGGdBFBECAD..XEAChAAABAEBQDEFhAAA.IGAChABAOHFCMEIDAFIH.YGCAaCDA.SABChAEACADG.WHAG.hACA...,1,-14,-21,7
UPbYcAdFeBgZOEMWJKLCSfIGVRNXDHTQa,eBAEBDEDZGBAMBEFKAFFLDAG.CFDE.IGHCGCFEVFAHhAAARCAB..DBIBHAFCQECHhAAAaHDG.UACFhABAYHFGAIAE..FFFHECAESAGBhADANCIA.XDGH.hABA...,1,0,-24,24
NbUZfOeTGXVSABHDRMcJPLFaYWKEQICgd,DAEHMEGD..JACHLEEB.FHAEaFCBKABC..EHCCCFDHdBGHUBFHhAAAZADD..OHFEhABATDBBGEEF.SAHBhADAAGABBBBD........hAFA......hAGA...,1,-36,-37,1
YZEULBfgDKWaNcICQGXFOJSAVHMePTRdb,HCBDeGDARAAGdGAHZDCEUGFHLAEEBFDGDEDAKCGF.....aHCEICDBhAAAGAFAFAADODAFhACAADAH...MICAhADAPDHDTEGG.EGBH.....fGHAhAIA..hBFA...,2,-27,-18,9
AZVbLXJYDESCRgaHGfTKNBQUIOWFecdMP,ZDAFVFCBLEHH.JCEEEADA.CCDARCEFHBCH.GEFCKCAABHHChAAAQAAGUAGE.IHBFhACAFFGA.dAGHAACAXGEHhABASFEDaGBHNEAE......hBAA......hBBA...,1,0,-28,28
CZAUbFNHIdTDQVafeYGcRJPXMBgKLESOW,FFEAHFAFdEADQCGD.VFFFaCAEeDFAGECCRGDE..JABCPBAHhAAA.BCCGKBEBSAGGhAAACAFGABED.hABA....NIABDIGCcCEBMDDFEEHB..hACA......hADA...,2,-28,-8,20
bMTfcUZRHIBgJXFGPNYaAQSKDCOLWEdeV,QFDADCCALFGBdBDFeADCMIDC..TFBDUEAEHCFA.hAAAIGHFBAGAJEEBXBBDhAAAPCADaHDCAHBCCFGFEAHFhABA...fECHcDDG...hABA......hACA...,1,-4,-34,30
QXeVADRCHaYfFOZMdgNBbPJIEWLTUGKSc,CGAFaEFDFGDBZAEB..dCEFBEAB..JEECEHAA.LEEFUCBF.KCBAhAAA..QGGChAAAeDHFAHHGDCGGHEBD.OABEhABAMBBC...NAEH.IAHB.WHDAhABA..SBHBhACA.,2,-33,-27,6
fNUIQMOTWYCEeFSaLGRdbABgVJPDHKZcX,BGAEJHACHCDCZFFA....XBBFUFGDQEBEOBEC.TBAGhAAACDGGFDDB..SDABhAAAaAEGRAGH.ADHA.PEEBhABADIACKFDH..fDHCMAEEEHFC..hACA......hADA...,2,-31,-16,15
dTCUBLRFMPDfKbaYQgeHZWESOVINcXJAG,dHDDCBGBLDHFRDCGFBEE.DDFHKFAE....aGDGQDGBHCBAZAAAEEAFhABAOACB..NIBH.hACAXGGHGGEBBAHEhADAMBBB...fGAH..bFDAhAAAgAEFSHAGhABA.cAGF.,2,-23,-5,18
LTQeIbWCXZDKEaPNOHMAcfBgYSFVJdUGR,BAFHSEGHJDDF.UFBGLCEA..TAEAQCAHhAAAIDCECHFAZGCG.KABEEAABhABA.aACF..OFABhAEAAEIHfAGBFGGA.GEDG.bGFADFFAhAFANEAC.MBID.cEBHhAHA..,2,-24,-23,1
BPOGfbNZHgDKdAFWRTXIQJMcUYaSCeVLE,RGCGTBGFQABG..MDIFUDDESGEGeBEALDADhAAABFBBGCAH.NABBZAAAhAGAgEGGKFFEAEEG.hAHAFGGHIBEB.cGBECEBHPBHFfDFDhAIADIAC...hADA...,2,-16,-8,8
SXgYEbVWBaOcAGDQUHdTMJCNILKFeRZfP,QDGAUFDHdAGB.MBFHCCAGLFAD..KDBHFBBCeHACRDEE.hAAAfADF.hABAPDDBSDBAhACAYFGFEGGG..WCFEOAGB.ACBBDAAF.hADA......hAEA...,1,-15,-36,21
FHQaKcbdgLOYIVJeXWCSBMAERNfPDGUZT,EECFRCCH....fHAHPEEH.DGBEGAEGZAGD.HBADaGEA.hAAAKBHHdBEDOABA.hABAIHHCJABEXEFAhAFACDCCMDHBACID..NEIC.UGBH.FAGG.cGEDhAAA.....hAGA...,1,4,-28,32
XBJAcgRECLeFYUPfZdWVOKbIHQNDSGaTM,REFFLBCFeBAC.UEEFZBFGdECFOFAHKGBG.HFBHDDAB...GAEBhAAAMIAABEHEAGIBECABCBAB.hAAAFHFG...fEHChABAWDAH.IHDFSGDB.aHGEhABA......hACA...,2,-38,-6,32
NUEcRDIFVeWMKSLdOGbCfBJHXTaPZgYAQ,UBDARAEEFABH.eAGDKCFD.dFFFGGAD..CDFABFAF.HBAFaHFCZFFAhAAAACCC.EBDDDEID..hAAAVDAHMFCF.SAHBhABAODDB.fHED...hACA......hADA...,2,-30,-22,8
MGDIeJLdTKWfERcCUgVXZbFOHYSaBQNPA,DDABJBHFLEGBKGEE..EBDARCCG..CBFE.UDGB...XAGHhAAAFBADOHACHFADaEAAhAAAQCBC.hABAADEF.IGDFdFDCfHGHgFAE.hABAbFEBBABA...hACAMCFF.,2,-28,-25,3
RCbZLHYISUJacDGMOKTNEfdgXWBFPVAeQ,QGBDRAEBCDAA.LEEFHCDBSBCFaBEHDCCF.MBHDTAFFhAAAEFFEdFHA.XGDGhAAABDGBPABA.hABAAHIBeFFB.....YFAEhAFAIGBG.....hAHA...,2,-23,-20,3
DZGfMXKWEBOILFTAJYcebSNadHPQgUCVR,JCCGeEBA...SGCAaAGCHCFHQBAFCCDFDIGA.ZDAAMDADhAAAKEEDBHCHOCGFFGHDhAAAAABG....cFEFhADAdHEFgFAD....RBEFfHADhAEA.XBBBhAFA,1,-25,-26,1
OTVPRUHJDCZYIfLSdaGWcKbXEFNMQABeg,eBAHTCCBRDFFHECF.CAGF.ZAFA...IDAGfCDFSBAGhAAAdACDaFGD.GEGGhABAKBGAEHDCFGAB.MFDFhACAQFAABFEAgCEB.OEBFhADA.....hAAA...,2,-15,-7,8
HGaARWQbSgYZXMBJNUeEIODfFTVLKCdcP,QDAESGEFZFAFBACBUCGGeFBA.EBHFDBEB.FAADLHEGhAAAKDAC.CGFEdDEDHGFEAAGF.hABARCEF.bBCAXDCDhAAA.MAECIHAF.TEGD..hAEA......hAFA...,1,-14,-16,2
dQGWOAFYVKfLRTePEHXcZNDJaUSgCMbBI,VFFHLFEB.TCDAECHFHBBF.ZEAFDGDFUAFASCBBhAAA.CEAHBABGIEDFhAAAdGHAQGADhACAOABA.AADAKCGH.RAEG.XGDDNBIA...hAGA......hAHA...,2,-16,-16,0
LPSQAXeHWOfGEZdJIRFVCcNKYgBbMaDUT,HGEAOCEHGDEDdEGERCBF.FHAC.CADB.KBGGBFAF.MECHaAACUGBBhABALABH..SGFGhACAADDDXAEHeAEChADAfAAG.EFDF......hAGA......hAHA...,1,-20,-31,11
YTAdWGXQVeOHcCJSgIfaRPNEBKLDUFMbZ,dGDFGECDQBACOAFDCAHG..JBEDSACC..fAFDhAAAaFHHRBAB.NCIGBHAFhABADCCCFHCEZEAGTFAHhAAAAHGE..XEFBeCHB...HACHhACA.ICGG.hABA.EDEG.,1,-12,-20,8
MYbLNAXGCPHTEIOWaSFgfQJZcVdeDKBRU,XGGACEFGHCGF..ECEAOGCA.SEDCgGGBQCAEhAAAJFAHZCAF.VBGHhABAdGDDDAEBKAFFBHAFMIDELAAGhABAAIBCTACHaAGAFCCD.fFFBhACA......hAEA...,2,-17,-5,12
SLUePYTKgJHXaIWNABQGdCDfMEbZORVFc,GBDEDFIHEFCG.ZCADRADA.FGCDLCAHUGGH..eBHB..TEEDhAAAKAAEHCFFaDHB..IHAFhABAAGBDBDCDdAGBCDDCMHCAhACA...........hADA......hAEA...,1,-21,-25,4
SEXdOAPJKfTBFQGeINHCLWYacVZDMUbRg,KGACTEAAFDEGGGEH..IHECCGCALACFaAEHZBAC.DGIDhAAAMAIBRDEA..SBHBhABAXBFAdEGHOFGDhACAJEACBAACNGCF.HADAWHAE...cDBFhADA....hAFA...,1,-16,-22,6
SdWAPHERfMLJIecZbCDVaTUgYQFOBGKXN,EAHDMDACLECH.eABBbFED..CBFEDAHDVCFF..UAAFQFFFhAAAFFADBEEFKBEF.hABASFHHAAIDRCEG.hADAIAFHaEAA.gEAEOECDNCIG.WEEDhACAfHGD.hADA...,1,-19,-22,3
MGPYWVHaSgNFUOdQJTLBKDeCEZbIRXfcA,GEFE..PDGDVAFCHBCB.aBAHNBCEFAHH..dFABQDDHhAAAJFDFBBBFDFIBhAAACBDCEFAD.ZGCEIEEHhABARAEF..fCACADIFMIAESAEFhACAUGGB.....hABA...,1,-4,-19,15
YbdWEfOcIZDMQNXSCUTeHARaBgKVGLJPF,BCDEVDBB.LFGH.JGCAFABA.dCHAEEAGOGDE.ZAFDMBGHhAAAQEEH.hABASAEHCAHGTABBAEIBhADAaHGEKDEH...YFAFWHBG.fCHChAEADAAHXBBC.hAFA...,2,-40,-17,23
VgPOELICHcNfdaRTQXBMFDGAWKZSeUYbJ,KGDGZCFCeDCGUCED...JGEC..VCBFOFBFLFFCHABA..hAAA..NDAE.dAGHaBFAQGGHhABABAAC.DICAhACAAIGE.SFBG.gADEhAFAEEHB.CCHFfHAHhAHA..,1,-14,-32,18
bAINVOeRUWTBSfKFDHCGMQaYgJZXdEcLP,VDDCRGBCUCFA.BEDAKFHBHBEC.GCAGMDBG.QGFGhAAA.aABCgEAFhAAAZGACEADG.LFHBhABAAIBE.IADENAIA.OFGB.eBBGhACASDGHDIDCCAHC..hACA...,1,-5,-20,15
gEHMIKJdGTCZAFXOQUYfWDbPReaNLcVSB,FBFFOADGQGACUDGC.....fGHGDCECRDBDaAHFLEDBhAAAVEDGBEHFEBAHIBDHhAAA.dCBACGBGXGGAhABA..YABEWFEHeDDEhACANICBSFAE.hBAAMAHB.,2,-30,-15,15
UcSTBdYNZFWHbCMaLRJeVQPAEfKGDIOXg,EGHDGDDADBGH.OCAFUDDF...TGGABEAAdBCBZAAAFGBDHCGBMAEChABARGAA..JBABVCFHhACAAGFF.KBGE..XGFDhAAA..SDHHNABD.CCCD..hAGA......hAHA...,2,-27,-7,20
TYKVLIAGPBDOUbReEWSgZQdXCfMHNaJFc,GDGGBFHHUAACRAEFeEAA..EEBC..SAADZFAEdAEGCGFFHAFDhADANIEH..FGCC.TFEFhABAKEFCLDBChAHA.AAIDDHCEOCBE.gAGHfHFFhBAAaGAD.....hBCA...,1,-7,-26,19
RELQDZVHIFKWeJBNAGfXcOCbPMdSagYUT,GCFEXECHCHGH..MGBGaHFA...UADCTABERDBG.LCDAhAAADIBGZAADHAGHKBADWEBFhABABHFC.AFBA..ODHDhAAAdEEFYDHH.EAFC.IHCBhADA.FAHD.NEAA.bGACSFFGhAEA,2,-23,7,30
IbVYREHNJcGWSCAKdeDBZUTLFgOafXPQM,eCFCZEFCUGECFADC..OFFBaGBH....XCDCQFAHhAAAMAIFbDEC..REBGEAAFhAAANCBH.GADHCABG.AHABKDAChACA.dCGEDAFGBHHD..LHBGhACA.fGHAhAIA...,2,-26,-5,21
gaAVUGJFdOXLfIcNWeSEBTZYMCDPbRHQK,UCAAFCGHdGHALFDC..ICCG..cGAAeBEHEDADhAAABAHDZABECCFADBAARECBKFFFhABAAIGCGADE.JEHHhAAAXGBH.fFAENHDF.SAHDhACA..hADA...,2,-29,-25,4
QFHKWARODfgePLSJXIcNECBVaGdbYZUMT,RDBADBFGeAFFLDFH..SBDBJDCD.XAAFIFHEhAAAEHGGCABF.BGCAGGCBhADAdGFGZCGFMFAFTFABhADAFBHDKBDGAGED..fCBF....hAEA......hAFA...,1,-13,-32,19
UINDAWfYGZSEFOReMTbdLgCVaBHcQPKXJ,...fEDE.GABBSGADOCEFeBBBMBHBTEFFhAAAdGADCGHHBFHCHGDAPAFHhABAKCCDXGEHhAAAIHHDNAED.DADDABAHYCABEDDE..FBHBhACA.READ.....hAEA...,2,-15,-6,9
LQYFAWMXaCTJKefDUOSBNGEPcgbdVHZRI,XEFEaDHD..CFCCKFEHDBIFUGCHBADEGAAG..PACDhAAA..gFADhAAAdFAAVAEHHBAFRAEFIDGHhACA..YEDEACDDMICETGGFhAGA.fAHAhAHASGGA..,1,-18,-31,13
cgBMTEJFbOSADdIYeZGWaKHXRCfQNUVPL,DCBBdDAFeFFCZAFEGDGAKFCBHAGDRGDG..CCED.QGAH.VDDChAAAPABELBBAhABABGAGMCDF.EEEDFACGhAFA.SGHHAHIH.IHEBaCHFNAAA.hABA...cFAAhAEA...,2,-30,2,32
EeXTNRQgSCVWOULFKJMADcHdIGfaZYbBP,DHAAdBCHGCEBZBEBBHECEGFC..eCBB..NHAF.QEFHhAAA.SDGEhABACEEGVCADOAAGFACEKBGAAAGAIHHGhAEAaCAH.bAFAXCCF.gGGAhACAWDDD.LFAAhAFA.,2,-23,-17,6
UbELKDOSYWCfgIcZeVNJQFdAXBMHTGPaR,MFHHHBBFGGEHRGAA.EBFBDEDFOCGD.SEBGCAFF.hAAAIGAFeBFHNABEFGFFhACAdDEGAAIDBHEDaAABLADEhACAKADF..fEAE...hAHA......hBBA...,2,-42,-5,37
GNfVKdTYDURAJCQIWMZPHOFeacbXSLEBg,CCGDQBEC.MICCZBABPFBGHGEGFFAG.eCGFaFGD.XCBGhAAASEGEBACGGADBhAAANAEF.KFFFYECBhABADGAHAECEJCCA.IHCCWBHB....hABA......hACA...,2,-30,-1,29
PZCWdBGHIKaSODQLbEAMTFgXJecNRUVYf,TACEXAGH..JEEGeEDD.RACAUFAEVGCG.....fGFEhAAACCGEBFAFICAHhAAASEEC.OCEChABADHGEQAECECAFAGGEMFIBcGABNIAF.hACAYDDE..hABA.WCCD.,2,-29,-3,26
dFBHNMcIfOgDVAEQRKeaZYPLGXTbCJWSU,RCAHKCBDeFFBZADHLFFGGEBE...XGCAbEDD..JCCASHAGhAAAFAGEBABBMFIHhAAAIFAC.fBHChABADGAHAAFAEADGaDFETDFH.CFCFdHFB..hACA...cBBFhAFA...,1,-8,-28,20
fZKJOLaWNDXcTUVMIGCBAbQPFYHRSedEg,QCFFFADBHCBHRGFGdGABEGFGZAAG..JEFGaECD..DAFB..TEGHhAAAUEDA.MAFECHDFBABHhAAAAGIB..PCAEhABA.eEAF.KAEFWAFHNIDFXGBC.hABAIEEG..hACA...,1,-6,-36,30
UBOXITEAaJfFdKeQYVPbNWgDZRSHcCGLM,aBEFFEDAKAHB..QGBB.VDFDPCFE..bBAA.hAAA.NBBD.DIECZGBGSEAChAAACGHBLFAEMDIDhABAUCACBCGE.OEEHTGFFAEDHfAGBhACA....hADA...,1,-21,-31,10
QadXYHEeVGTcDJZBPKWRSUObNfMCIALFg,LHCGQGGHdEGBHBBEEFACGBEADBFGBGAEKAAFSCGFhAAA.ODHFfDCDhABAMCFFAACAaHGEeEBC.hACA.TFGD.JAHDWHAA....hABA......hAEA...,1,-11,-25,14
ALgGBMQHFXJWRIKUdZDCPaeNbYEfcVOST,LFAEGABAMBAFHGBAFGHHJADD..RGDEUDFEdDAFDBIH..CBFH.aEFFhAAAeFBA..bFGHEDDGhAAA....fEDDhABAcAGF.SBGDAEBHBHCG..WFADhABAIBBB..hACA..KBDE,2,-31,-10,21
QWKNJXfFbaTdcBPLACGRUEIYMSgHDVZeO,RFGDEDCGMFDCHEDC.DBHFeFBF..OFABQCECKGBH.XAGDhAAAFGHHTABCBAFAAGGDCGDGhAAAUCBE.SHEGhABAgBEF..WACCNAEF.fDGFhAIAaBAHcEGA....hABA...,1,-10,-23,13
ESRTIHfAZKGeaLYgDXPWMCBcbVQFJdUNO,KGCCaABGLDECDCDB..XEFBMHCCCBHDBBEH..bCABFDCFhAAA.dFFBUAEB.EAHBhAAASAFBRFGF.hABAIHABAIFCeEEB.gEAEPFAH.cACEhAHA...QGGFhAIA,2,-32,-17,15
JeWfIAYQTKZCGSHadBMUVENLPcDbFRgXO,QCDGTBAF.KGCBCDGBHECGBFBAUEGEEAECLADD.DIGEhAAARAAHOAHFeHCGIFGAhABAAEBCZFED..aBFFMCEGhACA.NAIE...cGAH..FHAC.hAAA......hACA...,2,-33,1,34
CKMHSaBAGZQTRLfEeXJIbYcOgVDNWUFPd,QGAATCCG.RDAELEHHeEAF.JBFBbDFD...OFDFhAAADHCCUABCFBGFCADBKFFHSHFEhABAAAIHZAGH.fCAFhACAXDDD.YHAG...hAAAcFBB...hAEA...,2,-23,-9,14
WeTBQNIJAVPMLFKUSZOcaEgDRYbHdGfCX,MHDGKBADZGCA..OCAAEEEA.RCEF.HDCHGEAHCBBE..eAFBBCHAhAAAQEGAIABGAGIBhADA.LFGHSDBDhAAAaAECDEGCdBHCXGAHTGAF....hABA......hACA...,1,-15,-17,2
THBJVIPCbRKZOALFMNEYWGUQfaSgXdceD,MCEFEGGH.GDBCQCEC.SDBAgFDAdACDDAGDBGBGhAAAJAAC.PAGD.hADACFHEKEFHAICELHFGhAEAFFBANBAE.YFAF.fGGHXBBG.hABAcBGD...hADA...,2,-17,-16,1
bEKYUDQagXBJFHTGIAZdLRVOcNeSfPCWM,dGGBLDDHOBFHeBHB..SCBECBCDMFID.KGEDDCFFaEBBBEBBhAAAHECEGGADZCGHRGAC.hAAAVFFB..fAFBhABAbADA.EACG..YCAD.hAEA......hAHA...,2,-15,-14,1
AFCPdXBJWZcDKQITaUNfGSLgEOHbMYVeR,FAGBdAEABHBDZFFCKABCQFFB..TDCDUBGEGABChAAALHDEEGCCOEABHDAFMBABhABAeEFEABEHCHEDJDDCDAAB.hAEA.aFBDSFHH....gBBAhAFA..hAIA...,2,-29,-2,27
dPeISUWGgfVZaEOYAFDRXKNCLTJHBcMbQ,FDBFDAHBRAAFKGCELDDFHDEEBHBH..MEFEdBADeFAFUGFA..GEAGhAAAVAFB.ZADEOFGDhAAAAEAB..CHDHJCECbADB.hABA.....PHDCSFHB.hACA......hAHA...,1,-16,-21,5
TVFUEHQNDKSgGZdLBJcbAYWPaRXICMefO,...PFHDXEDF.CCGF.eDBAOEABFAGDEDGBQGFDhAAA.KEHBSFEFhAAAZACCBCCEJHAEAFDFYACGhABARBABMADE.fGFG.VGAC.NCADDCFDhACA.dDAGcCGEhABA...,2,-24,4,28
IbYXUgfQEPFNAaLKOVcZTDeBGdWHCMRSJ,LAFBOCEGZGBEeAAFGCCAHECD.CHAEMEIBSADA.JFEChAAAIDBH.XGEAhAAAfAHEEFEANCHGhACAAHHFaACB.KEAHcBCHBHEA..WABD.hADA......hAEA...,1,-17,-20,3
bGZcEQUWRDIaXOAMfLPBVYHgdeSKFTCJN,LHAGBHDGHCEDdABASFBHFEFC.CFAC.NGDF.ZCAC..EDAGUABAhAAARBFC.DFHB.aEGAADDHMHEGhAAA..PAEGhAIA..YAEDKGFBTBGH...hADA......hAGA...,2,-34,-17,17
gHCFYJUSIdTBPbZGDEKNMLRWAVaXQcOef,aGGFQCBF.eAFDHCFHFFHBUABDdGAEBHCDZCACDIBC.EAFHKFDFhAAAMAIHRDEEAHIH...VEAEhAAAOAHB.CADFJFFFhABAIEHC.PEEH.....hACA......hAGA...,1,-12,-22,10
aDeBgJcWbFCZUMEXdNROLIYHPVAGTKQSf,GAABTGDF.KGBGQFGC.aGAGDFCC.BHGB.JDDEcBCEhAAAFFABZFFC.UAEGhAAAMBAG.dCFC.NBICLEAGhABA.IHBGPHDEAIBCfCAHhACA..WDAChABACDGEEEEDXDGE.,2,-33,6,39
aFKGZdfWORCBVJXHbMQSAeNLTEUDgcYPI,LEEAEEEHDECG.....gGCEPBFCFGABKBDDGAADhAAAZAEFdAAAOEACCDABBHAGXFGBhABAMCCFAGBDTAGChACAUGDBICDF.aADAfGHAhADA......hAGA...,2,-27,-9,18
JcHTfKgZGaPbeUSCFQOIWMAXDRVdYNBLE,DCIFVADDdEDH.BDADLAHF..EBDEJFFBHFABKDFG.ZGFAGBBEhAAA..aCCCeGAGhABASHDGCAFBFFDF.IABAhAAAADAB.RAFB.NEIA.TEGF...hACA......hADA...,1,-19,-22,3
FCWSeYfVGORTEbBUJXaMHdgcIPNQAKLDZ,KFCBZCCBFCEECCAF...eFBD..fGEDOBAGREED.EBHBBEHDhAAAJEEA...aGHBdBFC.hABAIBDCQCAFhACADEACSHAA..YAEAhADA......hAGA...,2,-41,-27,14
QUHfVWIGZYBMeEdXLSbPgADcFOaJTCKRN,FECGJDGH.CBHC.KADB..QBBCHBAH..VFBCGFEDBHAHMEAHhAAAdGGHLAHBhAAA..bBEFAEDEDFAFOABAhAFAaFEF.TGCE.NIEDUCGBIBFE.hAGA......hAHA...,1,-13,-27,14
XZCGWcFLOfHbJVEBdKgMNYQeIPRSDUaAT,ZBEHCBHEGEEGFBGDLHFGHFCF..JBBABBCEKDDC.MCCD.QFAChAAAIEAESGHDhAAADGFGAAEE.TCGFhABAXEGA.OEDHfGAFECADNIAH.YADChACA...hABA...,2,-27,-18,9
KBbaYfeOVDEUZTGICSXHcPFgJNLQRWAdM,KGGBBBBD.aHFEeCAE.OBEEDCADZGAAGEEF..SAFChAAAXGAGHDAAFFFFJCDFhABANAABLAFERBFA.hACAdGDCMGBEbCFAfHEDEFHDIEBD.CHEF.hADA......hAEA...,1,8,-28,36
PNZWBFVcLedIYOafKDURXQTAbCESGMHJg,EDGGMAEBHFDE.JFBF..gEFGZAEEBDEGFDCHLAHB.hAAAIDCCaBADKABCDGIDhAEAXDAH.AGCECGDHSGADhAFANEIE..cGBCdHFF.fBADhAAA...hAGA...,2,-22,-22,0
FIHQXgPfYJZUeAWKCGbaBSLMVRTOEdcND,KBGBGABFBDCAMEGFRABE.EEHFdGBF..DEFHHEFGQFAD.hAAAXCAGgGEDhABAPDDBJBEB..eDAFhADAAIGGCCFGaHDESGGA......hAEA......hAFA...,2,-27,-13,14
adQCOXRUfWDgLPNeEbGSJcVTYIHABZKFM,KDGGaGCA.dADB..CEDERGFEUAGC.DGDELCAH.eABCGCAEhAAASCFGJCCC.TGABhAAAHGFAAEEEBDHHMFCEhABAOADE.WCCDNIBF...EFGG.cAGDhABA....hAGA...,2,-30,-24,6
gALPVNfSWZKHOJbYaFIdBDMCTcReEQGXU,VAACSEGG.KHBEOFBG.JDGFaBAC.dAFABBGFDGDACEEHRGAE.hAAA...EADGXEAChAAAUGGHACDC.LBDHhABA.NHEF.fCEC..WAHHhACA......hADA...,1,-31,-38,7
JGEQWPXITFAZUCHLOfbeYNRgBDcMVdaKS,ZDEFCECFLAHBOACE..eHBGRBEADEIH..MAABdCBHKGEHGAFC.hAAAECCBQFADhABA..WEHHIACAhAEAABIBHCAF.bFAAgGGB.BEFBhAFA.aHBCSHGGhABAJEDD..,1,0,-26,26
LGZOKbfUWSgTFACJDaHEMIeYPRXdNBQcV,DGBBHDAGEDDBMEIH.eGBGRBADdGFCBAGG.QDFFLAFCOCHFhAAAKBHBUFFB..SGCGhABATBAGCHAHJABChAAAIHHE.YBFB...XEAChACA...hAEAcADH.,2,-24,-7,17
YZOVeMPIABCNUfFSTXHcLRGdWEQDgbKJa,CBBB.UGACFGGBSBBD.HBFCLCEFdGAAEACGDGGCKDDEJHDEhAAAaFAAZDAA..OEFChAAAMAFA.ACCGBECE.hABAfFEEXDGB...cGDH.hACAWBAD....hABA...,2,-42,-23,19
TeGcZadHBQIbYMWfgSOPDLKNXUCRFAJVE,JEAAECDEGEECZBCE.dBADHGFGBHCGQEEF..YAHHhAAAMHBG..gBGDhAAASEABOABAhAFADDHFKHGENIAB.CGDGABDC.eAFD....aAGAhBAA.WDDCfDDGhABA..,2,-21,-20,1
ScVYMADOaWfUZIQdgCLKJGXBETHebPFRN,aFDHUABGZFAFdGAB.LDFBGCBDBADBHBFCeHFCFHGG..SCGChAAAVDBC.ACBCDEGHhABAfDHA.IAFFhAAACABAKEEDEBEA........hAFA......hAGA...,2,-31,-14,17
LbYXIUGCBAPaZRcfMHSJdDQKWONEFgTVe,aDBFZBFERDCD..MCAFHBAFdFDHDAAH.KGBAODHB.FAGFTEGBhABAeFAFLAAE.hACAXBCEIGEDCBBCAHHGhAEAcFAB.fAFDSGCDQGGBhADAEDEF...hAFA.gGEA.,1,-6,-16,10
EGZFUACVQNBPDgbSdOfecIKJYWaRLMXTH,QCACBFCDDBBH.SGDBdEEGeBHHKGGBJDFD....aAFFMDDAhAAAHADDZADAAFIDCHFE..hAAA..NEAG...PAHHhABAOHCAIHHE.WFCDXCBDhABAEBBE....FDDHhACA...,1,-17,-35,18
eZfSNXQVRLWaTUDBOcYbdAHCIgKFGEMPJ,CACBKAGGFCCHEFAC...MDDDeFGH.ZGBGSCCC.QCGAhAAALAADTCGHhAEABBABOFFC.bAEFhABAABEEgEEE.JFAENIABXDAGhACA..WAFEDHFAYEEDhADA,2,-44,-8,36
PDdALZecYGTHEMRVWaFUSgfBOKbCQIJNX,eEEDGCDCECCEMBIFRDFG...VFAFFECFSBABBFHCKACCCCBG.JAEGhAAA....PHDChAAADIDAAGHDZBFE..TAFChABAaACG...fGGGOHBG.IDGDhAFA...hABA...,2,-24,-20,4
VDeRCAGBIJfNPdWHFOZaYbETKcLSQXMUg,GAAHJBCB...PHACHDEEFAHB.ZFAAaEGGEEAEKFBCLGFGhAAASEEFMCIHVBEGhAAAeEDB.ACAA.BGGFIABEhADAfDAD.dHFD.WAHB..hABA......hADA.OEAH.,1,-3,-15,12
HQdgGWCLYKcRBZNDIEfTOFMJSeUbXaVAP,HCACdEFBGAACCEGHKFHHBFCGZDBDDIFC..EDEGOHDG..MBBAhAAASAECUBGEaGAFAAHBQFGFhAAA.hABALBFAcFFHIEAFfEDE..hACA......hADA...,2,-29,-25,4
JQbCBNMOeSHLIGXUAYEgPdcfDKWZaTRVF,EDFGdGBDDEAGZBCE.RDDF.FAHH..QBFHCGHF.BAFCOGCAeABGhAAASEDGLHEC.hADAXGADACIF..hAAAPFFEKDAB.WBBGaACA......hAEA......hAHA...,2,-34,-30,4
PVBJUgGZHbXEYKSWALMDcdaeCRfTQONIF,DCIHdCGDaEAGeCBB..CCCF.RFED..QGCDOGEAFFBABHAD.JBEChAAAUBDAZDDC.HGAEEBBE.hABAKHEGAAGC.MEEA.TAGEhAAAPDAB...gGGBXBABWFFEhABA....hACA...,1,-14,-21,7
IMEWBJHOLAgGYVaNfXTDFRUQPbecZSCKd,GCABaEEE..XAGDDFIHFDFCUGBG..PBCFeAHHSAFAhAAAKEABdBAE.EECAhABABHDCHFFDAIAGYFCAhAAAfABA..TAEG.QGGEhABA.ZCEACAEF..hACA...,1,-12,-21,9
dYDGJaZKEIQWHLbeSVBMXFNgPOcCURAfT,TDAGdDDFDEIHGACB.ZCGDKGDD.IAFGQCAEHAAALGAGhAAASADBBGGFhABAXGGBFGEB.PBHDhAAACHHAACFA.JCDHEFAGbFEH.MFCB.gDFBhACA...hACA...,1,3,-22,25
HdCcMRAYZeVOQJfGaDNPgLTbFEBKIWUXS,eEFEOAEAQABFGEFCDFIB..NBEELFCAFDBDKHCG.UAGEhAAASDAFCAEB.RFBAABCHhAAAZGFE.fCADhACA.gGBGTDDEBHHDWDFEdBHA.hBAAcACF...hBGA...,1,-10,-20,10
GVCbdKcZXaQfLIFHDeORYTJEBAMSWPUgN,MADCSCGBUGBDGAGECFCG..dGEHKDBFZAFE.aABGQGGChAAALDDGHGAEOBBAhABA.TCDCBHHFAICAgFEDhACAbEFE..cEAB.XBCGhAAA.fADHhAGADEIH,2,-22,-22,0
WBRVZDOTLEUfPAGMcKeJbgXaYdQFNHCIS,MFEFeECF..JGDEXBGB..aAEGQFFFFEFCHBEECDBBIGCBhAAABAGA.VBAFhABADCADOBAGLDDGECCGhAAAfCEH.AHIFcGACKHGCYBHBhABASAEC..hACA...,2,-24,-18,6
gRNSEGBLXHbKWVDYeQFIZfaOMPcCTAJdU,JFHDUCGD.RCAE.EBFHLFHHHAAE..KAHHDDFFeEABFACF.ZFBD.OEGBhAAAMFBE..CAAG.ADDDdGDGhACA..SGAEhABA.BEAFWCEDQGFFfHEDhADAPHCC...hAEA...,1,-22,-28,6
QPDBgKHfMNCeUcRIaSGdZVJOYFWETAXLb,XGFEQDFHDDCGKCCG.HEAC.MADGNAHE.UAAEREBE.SGHHhAHAZBDCJBAD.FFGHEGBHhAAAAIAALBEEBFAGCFFC.hABAeFDFaGEH..........hAIA......hBAA...,2,-29,-10,19
TSHLXgRUPecZFEIWbKOaNCVGMdDAQJfYB,QBDHJCFABFBG.SHEEHEDDLDACRDBDUEGBeGFG.FAGChAAAEACF...WAABhACAbABCKHEG..aEDA.hACACAFG.MFABDHBGAHIBfCEETBGA...hAEA......hAGA...,2,-22,-16,6
dEgUMTfYeGFXaKVNLcQJZDBIbRCSPWHOA,dFECEDFBUCABMACH....TFAEeBGDGFBHFAAH.aAACKDHBLCHBhABAQBEEDGGHBAHFhACAIFGACBEFSFADhADAPAHHHDCEADED.fADC.hAEAXGCHNIBB..hABA...,2,-21,-8,13
PMfJVcXBCRdTgHEASUNeKGOYWZDIQbLaF,SGBFUACGeEDHKGBHGCCB..OAFEZBFCDFID.QFFBhAAAaHFA.MEFGJCBH.hAAAXDBCBFGECFAH.dBABhABA......gDFC.hACAADEENDIGIHDA.hABAFADG.fAGD,1,-3,-41,38
BgFITEVGCWcfMNDaSJeKPYAHbOLdRXUZQ,HGFGOEHFLDCHRFBDZAAD.BFGFFECA.IEED..TAFHhAAAVAFEGCAACFGD.hADAfBBBNDDF.hAEADABCaHEASFADeFAD.KADHAHHF.dGEC.hAFA......hAHA...,1,0,-27,27
XQLGEYdAcOWZBTFSHCJDMPbafeINKUgVR,OCDAZAAFBFDBFDDBCFGH...DBCBMDAH..aFBDeHBC.KEBFUBGChAAA.RFEBLDABhABAGDEHEBHHAEIF...TACGhACA.SFFDJACCfHGH.hAEANIAD....gEFBhAFA,1,-23,-36,13
QdHfTaZcIbFGgeLDJOAYVXCRUSEKPWBMN,XGFARGBCUBEB.KFABBDBA..QDBAHCGFaDED.ZDEB.IAEChAAAFAGAeFAADACBAABB.hAAACHDF.EACDMAIH.dCGAhABAfFGG.......hADA......hAGA...,2,-27,-24,3
OgYGdNZRfSQcIXJBVEKDFHUAPbaeLMCTW,aDEHLFFA.CDFF.TBCGOAEHGDAAdGCGZDAESFHHhAAA.IABEBBGBEAAGhACADEGHFDHBAIEGeHEEMEEB.hADAYAGH.fGCEcFAB..hADA......hAEA...,1,-22,-28,6
XQTYFJLZKcOMdeCDAGUfNRWgVPEbHBSIa,UEEARCFG..VEABEADEBHEF..SFHDaBFD.XBBHhAAATDBF..FBDHJACAhABAKCHHMIACdGHCCCAFGDCHhAFA...fFFGgFAG..hAAA......hABA...,2,-38,-18,20
MNdCHXfWYTgDOabSFLEVcGKIJZeQBUPAR,MCDGdEDFCDHDHCAD..fFHG..TAGFDACHbFAGLABAhAAA.EGEHcDFGhAAAICEAZDBCeAEAhABAUGGBAICENICD.XFAAgGFEaEGC.SADChAIA.FBHF.hACA...,1,-1,-19,18
TAYDLENVXQSCIMeGPJBWfdcZObHgaUKRF,DAABLAHBEAHF.VADHQCEF.CDHD.IHGGGCAEJFGFhABABAAC.dGCGZCCFbDAGaADChACA..KFECFGBEACBG..hAEA.NICF.XEGH.SCFHhACAMFADWFHBfFAFhADA...,1,-7,-32,25
QRedPVGaFIKZcSYHWUbMTCJDNLgfABOXE,BAAGOAFGEFECRBEF.dCABGEGC..aGBBKADHZEAC..SABBhAAAHAGBUBDBMFFHJHFADEHFhABANDAG..LDCBhADAADIH.eBHD........hBAA.FGDD....hBBA...,2,-30,-10,20
aWcUfLPbAVISKQJeRYDdFBCHXGMZgETNO,VAABSBBE.QDGARFEGdCGDFAFBBDDACFAEHAEE.GGABhAAAMEFE.EEDE..OECHhAAAaGHB..cCAEhABAfHCFLFDAAEAB..IAHCeCFCDACAhAGA......hAHA...,2,-34,6,40
eaFZbHGXMALVCUJWfSOIQPgTRDYdEcBNK,VEAECEFGUBBA....JEFASECG..IAAChACAQAGHTBCFDGAFdHGDhAAABGGAKDGEFAGHZFAFbFDDXADFhABA.AEIF.fHABPHCA..hADA...YAEHhAHANGEDaCAH.MAIH,1,-21,-25,4
AOTgYebCUJaSPNZMVGBERFDcXLWKdHIfQ,OBFCTEBG..eAGBUAAG...JEFAPEFBZECCGGABBAEGFFDDhAAADADB.LABBhADA.KGHHIAEHhAGAAIFAYCHBCHHF..SCDHMIAGEDDC..cFAChAFAWHDA....hAHA...,2,-34,-17,17
abKJgZHVDWQPCIBRMLGSTeAOcFEXUdfYN,OFBAEBEGdGDF.....fDBFaABDKDDBZDABDDIH..QGGHhAAAPBBEBBGDMFFChABASEDEABIBFAFAXCFAhADANHEH..gGAG.WAAChAEA.IEGG.hAEALAFE.,2,-23,-17,6
OHeIYUbKAZdXcSLCQDJVMWEaRBGTNgPFf,ZFACXEEGSGDHLBEADGGA..MFECEBADBFAA.TCCChAAANACD..FDEGOGBChABAeBDGUBAHKDFEdHFDCCHA.hAAA......QFGH.hABA..WADCaBFA..hACA...,2,-25,-24,1
HQFWARNYcKBTdJSbaCEMLZIUVfXGegDOP,RABD..NIDH.KGCEBCDDdAGD....SCFHCBGFMAAD.ZADFUFABhABA..fHDFhAAAeEGHOEBAQFGDhABAAEFB..TFDF..JFABaAEDEEEDICBBhACA..XDBEhAFA,1,-16,-45,29
DKLeaEVPBcIARJCMUZQFNHGWdSgYXfOTb,RFBAMFACQDBFFDGAHAEGdAAF...SEFGXDDBOFFChAAADHDEKBFELAHBhADAeABBEHCGBCAGAIEECAEC.ZGEA.hAGA...WCDBfHAB..aGGHhBBA......hBDA...,2,-26,-11,15
CROWYXJZbGPHaFEDBcLeSfUKQdNMVgIAT,CABDOBDC..XGGGJHAAGDEGHBECFDAADAAB.BEDBLBGBhAAASDFGKGGHdBAHMIAChACA..IGDHhABAABDBRDAF.ZEAGaCCC.EAHD.fFGBhADANAEF...gFBHhAEA.,2,-27,-14,13
VNgcdXeBWKHIQCRJLYASEObTMDGPaFZfU,EDBATGCHGBFG.FGAHUDAD..VECHNBDA..dGHAeHEEKGFGHAADhAAAQADCRAGDLEFEhACAACBFSAFEhAAAMFBFDEEDaBAA.ZFFC........hABA......hACA...,1,-6,-8,2
eIDGCELYPgXROAbHVNSQKWUBFZMTafcJd,HBFESEDGQCDGUCACBBHGFACEMFAH..TGABaFFHJEFChAAAeAFBDCAD.GDGEhAAACHDBEHBE.LABG.hABAgCDEOFBGAHHA...NIEDKGECfBBEhACA..cFCHhACA..,2,-16,-3,13
SLKgdUAHNEWRBZPeIYCDOXFcGMfQbVaJT,EHAEBDGEZBFGeEAB.CBEA.XEGGGAAG.QBBE.VEBChAAATFGG.SAHFhAAAKGHDdHEHACAHWABEhAFAIDDA.DGEH.OADG.FGCBfAFHhAIAbFEF...hACAaEED..,1,-9,-30,21
DcfNLBGRHEAQSKPWTgIMCVXJYOeZUdbaF,QAEDKFED..PACFTFFBMDIHCDBD..JHAG.OACHhAAAZAFAUCEG.aGGHDEFEhABA.NDIC.LEAAhAAABFDG.RBABAHDFSAHD.IDDEhADA..YGAEhABA..dHFD,1,-16,-30,14
OEXMBURJeKNCHAbPcfSGWVDFdTILZQgYa,...bEABfFEB.SGAGGBADVDGBdGHGTBDChAAALGCEQBAEhABAaDDEEADCMFCCBGDCUAGHhAAAeDFGCHHCAABCcDBEDGGHFHCEIAFG.YHCGhACA.XBGAhADA.,2,-19,6,25
HDYFJGVCgPSIKacUMAWeOBQfZTXNLbdER,OFFBBAGGQEABZCCF..XBEFNABE.LDADhAAAdADGEEDGDIEEFEHFJHAGGDGEhAAACABH.SGCGhACAaAHHMCGDACEDeHAG.fGED.bCCA.hABA......hADA...,2,-27,-7,20
HbLYWZaXcDfJPMNTUGeFAKQECVRgOdBIS,EBCHCGGERECC.dEDCBBHDHAFF.LFHHZABE.aAAEDHEA...JCECPFGHhAAA..MAFGhAAANEFAUFAEGCAD.AABE.hADAKDAG..QGBH..OHBEhABASEGGWADH..hBAAcCGD.,1,-2,-33,31
FVNYgSWMaRDAbIGKUOZcJHTQeLBfXECdP,GFADUDFGZFBAHBBG.QCEHLCCHBHAFfADDEHGCCCAB.hAAAPAFA.NEHE.SAFChABAMAAF.aAGEhACADBIFADAB.IHDEKBEFODHFJFFH....hADA.eHCG...hABA...,1,-5,-18,13
SCaQWeEJAZgGHcKfLXIBPVDbOYRFTdMNU,GDGEKFCCLBAEBFADDIGEOEHDRCAG.FGEEMDEH..UBEBCBHH.hAAAQGAGEGDB.hABAAAFGHDDCfACHhACAIAHBVAEC..TDAG..SHAGhAHAWHEAZCGB...hAAA...,2,-21,-17,4
ZGLWPOJQgBaATEIFfCcXUeHKYbdSMNRVD,EGBCFCEHCBFBUCDF.HGEEKDHB..dDADMACG.REFEZABCLFCH.hAAAOFFEQBGHhAGABBAFAFAG.....hAHAIBHG.....XBCFhAAA.bGEG.SGAHhABA,1,-27,-38,11
PXUGJSHEaVOIWcKTfRBZMYNdgADFCbLQe,FFGGLCCCQEDEXGCCUACA.GAGCHDAEaGFB.IABAhAAAKEBHRAAFMDDA..hAAANEEDAAHFDGIF.CAEA.eADEhAGASGAGEBHH..OFFA...hAGA......hAIA...,2,-22,-5,17
KOPgMIGaWRTELYSbVdXNJDeHCfBcZFUQA,KFGAOCADMFDCGEEA.RCGDLFAASCFAdGHGJGBCHAAGBCEChAAAFCDGACDF...IHBDhAAAaBAD.EADGbABF.hABA....NIBDCAGH..fAHGhAFA..cEAG.hAGA...,2,-37,-6,31
VSCbYRXEJMUaOAHGePFTgIKdZDfLQNWBc,HBGFeCAGFFFHTFFDKCEC.DDADLDHB..QCBBhAAABHBHSEDBYEDDRABCEAGDhAAAJACCMIFG.UGAGhABAOFAHABBE.gFBE.IHHAhABAdFHEfBFChAFA...,1,-9,-18,9
ALCFWScaQKZRdPUHfBgTMNDbJGEYVXIOe,FGAASDBBQCCEKEEGZGDGRDFG..UGFGBAHE.MDECDACGJFDHhAAAEAFB....XAAAhAAAOABBAAHBLEABhABACAFB.aCHF.dADCfBED..hAIA......hBAA..gEGB,2,-37,-12,25
LPISgGRUFJeQBAXcMbHTCDZWYEfdKVONa,XGAGMEHBHEDFDFBCZCEH.EFADKHFG..OCAGaGDC.LAAChAEASBBHGAEFFFGGeDDAhAAABDDF.AGEGTADChABACCHFWHAG...fBGHNEIE...hAFA......hAHA...,2,-27,-7,20
ZJCONXaWLRDScbMPEVFfUeKGQABdITHgY,dBABTGAHHCEE..ZAGFJHFECDBF.ODCB..XFFGaGBHRAFE.hAAADBAE.SEEFhAAAMDIDEEAFFEGHeBCAKGCGAHHHICFBhABA.NICHLEAGcADB..hACA......hADA...,1,-11,-22,11
CMAODVREdceafWZGXSTbPNLHKIBQJUYFg,DBEDEGDAdDAGeAAF..aDDDZDGB.GCBE.SAGEPAAEHBGBhAAABEEGQGBEhADAUGBDFBFHMEAHAHHHOBCEhAEARGEG.fFFD...WFHB.hAAA......hACA...,2,-19,-5,14
AIgMeTfOGWCZDHKRLFVUdaPQNSBbYcEXJ,MBHFeHBGOFABGEAACBBDDAEH..KCFBRDCDLEHHUFGB.dBBDQADGhAAABBFD..hABAbFFFEEEH.AIDAIDDBhACAfDAG..WAHBFGEFaCFE.SAAEhADAXFCD...hAFA...,2,-28,-10,18
aWPIeUdGXTDbBLgKYSNcZFMHRVCfAQEJO,EADGJCEA...ODHFaACH.....IAAEUGEDXGAFhAAADGAFLBCF.gCFFhACAYBAHSAEAhABAZFCEFGGBMICEHEFC.CAHHAHCCWFABdEAHTDDAhADA..BEDAhAFA..,1,-12,-26,14
GYgHCSZVLEMOJNfPRIcFdKWTaUBAeXQbD,eDAHQEEFGAEEHADFCGDFZFFBLCBH.OCHHJCDH.fABBhAAAIACBFHBChAAAKHBE..aGHBBBAEbAFBDDDBhADASAHHMAIB.PFHD...hBAA......hBBA...,2,-23,-4,19
KLABRHUEbXPfFceNGICQMdSDgZTJYWOaV,BCFFHBEGUFBAEDED...XFGGFGADeHCGGAADCFHC.MADAhAAADDGAZDCHJFEB..ODDChABAaAFCKCABAAHA...RGFG.hAAA.....fABBIHHB.SEAAhADA..hAEA...,2,-36,-15,21
UHZSgYbBcKeafdRJIMWDANCTEQVXLOFGP,TGCAEGGH..XCBEFAFCUDBHHCEBZEEC.SAFA.hAAAbGAABCGE.eFHHhABAaEAFfBABhAAAdADGIHAEMFIHDCAGABBECHEDQCGB..hABA......hACA.OADF.,2,-28,13,41
aPgeWTMYJXUERBAfdFQLcNSGDKOCVbZIH,FCHHQAEDLFCHSFEFDEFB.OBCFCHBFZADDHGFA.hAAAaBCBeAHB.MFIFhABAJBFF.UDAHBCAAADGBfFGAhACAdAGF.NIABKGAGIAAF..hACA......hADA...,2,-30,-9,21
WZeGHFERVQXOBITKNdDLagYMPfJSbUCAc,ZAFHGBDEFCBBRDEDQEGB.OFFBBGGCTEBDKACHDFABaCAFhAAA..MBIB.JHAChAAASBHH.hABAUGCHADDG.cAEFWDADEABCIHHA.hAEA.dHFH..YCCFhABAfEGB,2,-27,-24,3
NdZbFUXKVSRLCYDfacPHBeOQEMJGAITWg,TCGF..gAAFdEECZBADFCCCUGGHKAGG.RBFELECChAAA.DIBAaFAGHEABBGCHhAAAQADBMACGAICEIHFHhABANDCD.XGGFCEHDfGEA.hAGA......hAIA...,2,-31,-7,24
ACdKaWfcENHJLZSMRGXUYbBVPFeOTgDIQ,dGBEaECA.....fBBHEBHBJADBZFADMCDEGGCD.UDFEhAAABDAE.FEGBeABDOFEFhAAADAGHAACACGHHKAHB..hABA.NDDC.SHGA..YACChAGA.....hAFA...,2,-29,-25,4
ISTYLdHRQZVBWecCbUOfGFaDPEAJXgKNM,JECDKCEGMHFG..TAFAdHCHRCAD..ZEEGBCAD.eBBCCGAAUAEFhAAAOAHD.GGEFhAAAFACBDEEEADDA....NFEBSHAGhABALDCH.....QCEGhACAWDHH.fFAGhADA,1,-17,-41,24
cRQILFMaYZgODSEKfGVXeUBdPWCAbTJHN,JEDHHDDC.RFBGLCEEFHAG.aAFCZABHDBACSEAG.KGFChAAAfGGG.hADAXACBBHHCdBEFCHEHAEBChAAATCEENCIG..IHAEMDIHOHCChAEA.EAGE...eCGHhAFA..,1,-19,-25,6
gSHQJUTZLCPMDNaGbXBecIdEAORYFVfWK,RAFDVFDDKDAFHGEE.UAAGLEBF.CABEDAFBaDDFGFAHBCDC.hAAAeDFBdGGBEAHD.AADB.hAEAOAHFFDFC...hAGAfDHESBBD......hAIA......hBAA...,1,-13,-34,21
ZGPRafSEIHUOCeFNYDgMVdXWBAJLTcQbK,JHAALEHD.QEDDKGGGZCBDRDFA.aAFB..EABCUABE.eHCEhAAAFGDADDDEMAEB.XBGAhAHAAGBG.TDBEhAIAGBEHSGGDOAEGCBAG.....hAAA......hABA...,2,-35,-2,33
BgaWHOURQDAXZGPVIeMJSELfYdFNCcbTK,XDFFZABDGBEE...ICHAMFCGSCBHEEHB.LADAhAAAdEBGCHBE.TFGChABAKGHDBADHaGCBOBHFhACAQGECABBEeFADYBADFHEG...cAGGhAAA...WFADhABA.HECH,2,-17,-6,11
AGSRWfEDZeQHBMXdILYcCTJaKUPFOgbVN,GCAASGGBRFEEEAHBeCDD.BBHFdDEF.LAACCHFG.TEBDhAEAKFCHUADC.OABFhAAAVGCCABCDDBADZAFFMDIBhABAIHAH.YBEHaGAC....hAHA......hAIA...,1,-19,-20,1
eLcFGXgAOYSMIVCQDHbaJZKTdEUfNBRWP,OFBGSDFE.MCDBCCDGQBGH.DAFDaHFEZFFBKFCFdGBDhAAAEEFHUBAGBGAH.PBFAhAAALEHBGBAGhABAAECCIGEEbEDD..fACANEAG.hABAWAEFcACA..hAEA...,2,-25,-9,16
NVJMfPEaZeFYgdCUKABcRLGbIDQOHXWST,BGECRDFALAFHGBDADHCGOHBCHFGD..SACGTDABJAAGMEAFhAAA..EAFDeDDHhABAFFHFdAHGKBBDADCE.IFBHhADAXFFH.WDFANIAB..fBHEhAEA..aGABYFFFhAHACBCA,2,-27,-18,9
VPHOWbSQKEgITNCZaDJYMXGeUFcLBdfRA,HFBEOFDESACBKFHB.EHDCTDCECCEDZFFA.DBAE..MBEEhAAAeEAHUBAFLHBAhAAABEACdEEFACFGVCGD.bAEChABAIDHF.aAGAXCAG..hACA......hADAFHFE..,1,-4,-18,14
cTSRPedZJaUMGCfDgQVKAHYXFINEObLWB,HAGHXDAHFAACEGGGLFDCBDEB...SCGCRDACdFCHZGAAUADEhACAGACF.CEHEDIGAQGEHhAGAAHBC..IAHEhAAA.bGEG.TCCE.eBAFhABAMFFE.....hACA...,1,-12,-20,8
KecJCDSPTfIWRMEgAQBZLGdYFNVHUbaOX,BDAHLHDEGGDDFAGEHCCAUCFH.ODFFKADH.eFACCAGF.DFIBSEGGhAAA..hABATABE.IDADhAAAMIAEAACHdDCCNCEF.aFAF..XGAAhABA......hADA...,2,-36,-19,17
KFTBfZENeMSQaYIGHLdWPDXURCOJAcVgb,VFDAKBGHFEGG.BDABEGAE....eCCAMGBCaADGGGDF.LFAFhAAAdCGEDCBDUAABhABAOCDHAHHA...bACAfDEHhAGA.NIBD.SBAG.hAHA...YDHBhAIA..,1,-12,-39,27
KRZaGfXWbPJLIFNQeTCMgESYOUBAVHcDd,HBBGdEABKDDCaFDGGGEH..fGED.XDAAhAAAPDFCIHAENAIE.hABAQAGDCACFMAFBSBGFhAEAYACABAACAHHCVGAGDCCAWHEGLFFChAEA.TFCDhAFAOEEA..,1,6,-22,28
bSeYTaMCgHLVQIOKFDRZfWEPABXdGJUNc,BEABdHGHUDDC..bFFASCCD..TAAAMAAFCAEGLEDEhAAA.ICEChACAKGEBFAGGDDBDRBGBWAFEhADAADGBGDGA..JGBGeFABaBDG...gGCFhABA..hACA...,1,-18,-30,12
FIgGPVTNYdDBJZOLaQEXefCcKUHARbSMW,SHDEFHDGGEFC...VABCTCGGdAFDBECEJACC.ZCFAaCCAEEFChAAA..eFAF.CHBHKDDFhAAAAIAGREABMBAF.IGGDhABA..NBAADCBBLDDHfFDFhABA.....hAEA...,2,-17,-17,0
aYScGQCNbEPBWdgTDJVKZMeIXRAOHFfLU,HDGDFDEHUBGBaBGC..SCACQGGECGFD...ECAGBDCFdABDDGAFhAAAKAEHMHAA.IEAHhAAAAHBHOFAAfEDDhABALAEEcGEGNIDH.....hACAWCCE....hACA.TDGG.,2,-20,-18,2
EZQGIUXgeFYLKVTbRMfACPaBWJcHNdDOS,aABBJEDAHADG.DDGEOEEA.ZFBAQFGEUAED.XEAGhAAAeAHFFDBA.KGGEbGAAhABAMCIF..CGEEPBBDhACABDAG..WFAD....dHEDEHFEhAAA......hADA...,2,-30,-12,18
XIQeERDSNFZTVdJGfBCYULbcAWPOHgKMa,OFFFKAAAMICA..aCHBQBGH.ECCHSACEhAAA.FFHBTEABdAFCJDBDhABABGGGCBBFLEDBhAHAcACAAIAC.PDEF.HDGBIHBGDGID.hAAA.NHAF.....hAEA...,2,-29,-16,13
TOdEXGcIZbPeCgQFNAHaYVUSMBLfWKRDJ,HGBGaDGE.VDCAUFEFBFHELBEF.KBFGDADF.OBAFdCACEHBEhAAA..XBFChAAAGBBAIFHDZGFCeAFGCEGChABA.FEAHADFGSAFEMIEG...WABChAIA.....hACA...,1,-12,-16,4
CcBeEfdAXWFIDHGRJKbZVOYgNLaSMPUQT,FEEGDBGFGBDCRABE.KGEHZDAD.OHBA..gEGHhAAALCFESHGAhAAAMFCBQCBACECGBAHAfABAhABAADGE.IFAGJEGD..YADChABANADFPAHD...hAHA...,2,-34,-17,17
DbWFaZIRVMeTdCUOJLQXSfEgKPNYHBcGA,DECDFGFHZABFRABG..eEGHdHBFOADFLEEB..QBFEhAAASBGC.EDACKEFG..hADANADFBFDGAEECaFBEIHHHhAFAMIFECDHE....XBAG..hAAA.fHCDhABA...,1,-30,-31,1
VOCXGSTRcDAfZbQPWIBdaYENJUHegMKLF,ZAGHQFCB..PECAIACEaFFE.EAED..UBAEgCEGhAAAMICC.KHBGLAEHhAAA.FGBAVAGBhABACEGFXACHTDCEcFGFDAIDAEBB.fGGEhAFABHHE.NBBC..hABA...,2,-24,-4,20
cOReNaMbKgGCLQAUYHdEPFSVDWfBXJZIT,HDGBdAEDFFDDVAEHDDEG.BAHGZBAD...TBBFOEEA..eEABhAAAMADHKDEF..CGGCLFHBhAAAAGECEHCASABChAEA.fDBEICHDRFAFaGHD...hABA......hACA...,1,-4,-35,31
eYIPSNRgTMXdKQcCaJBVbLEOZUADGHWfF,HCFHFAACeDEH..IDADSECHREACMFIHKFGA...QBCFhAAACCHABDAGLACBhAEAZFEFDAGCfHBDhABA..PFABNEHE.TGEA.XCFBhAFA...hACAaHBE..,1,-19,-23,4
SfCMdKAJWIObRFUGBaETHLPXgDYQcVZNe,JFCBOHCA.FECHUEEAGAECBEAF..aHGCHACH.LFHFhAAAXBABDBBD.QBGEhABAZAGBNEBA.SHEAhACACDDFMDAFKACEACFF.bFFAEFAH.....hAAA......hABA...,2,-24,-17,7
MgOFIHdCYaLbPVQGNDTZfXSWKJEUcReBA,MDCAOCBEFHDCdFAD..CEAB.aFEDLBGB..PDECGFEBhAAADAAATGAEZABGSHAAhADAKADEEFCC.UGGBhAFAeCACBAHFABBA.IBFB....hAGA......hBAA...,1,-18,-28,10
MXcOCTgaKNQVBbZYFEADJfPIGdHUSRWeL,JAHB..IADEHFCFSBEDRAFGLFEHMACHODHH.TCABhAAAaHEEQFABhAAA.bBFDFCEFABAFDBBDhABAfGCDdFHCeEEDCCCEKFAFBAEEEHAC.UGGFhABAWDAA.....hACA...,1,5,-14,19
MQCVONTHZGLeSbgdIaWXRcJFYUDAfBPKE,BFFDKBHFEDAHCEGB...OFDGHGCALCBH.eDAFSGBHhAAAdBGHaABE.RCDCJBBGFDDEDBAHhAAAAEIFMADG.VFGDhABANIEF............hACA......hAHA...,1,-26,-29,3
HLTXRNKdcBUSZaJDPQAMeWCgYEFbVIOfG,MDFGeCCECADH..EADGFBFG....bGCEOCABHDDBLBCHhAAARGDAKEGGBCHCUGGD.aGADhABADGIHAFAF....WCABhACAVFAD..fAHEXAAF..cDEEhADA...SGGHhAFA,1,-20,-30,10
CGLWPOfTADUHKRdEIQNYVabcJgXZSeMFB,UDFDRCFCdACF.QBBE..NECG.aAGHJAAFZECB...MACGhAAAFEGEBEEFCGFB.LFAHhABAOFBBAEIHDGHBEAHB.hAFA..IBEG..YCDDhAGA.....cAGBhBDAXGDD,1,-20,-47,27
UQZJDACRHLOfcWXVMITPGFBgEdNKSaebY,CFBAREFCLEAE.OACCfAAA..XBFHMHCGIGGBhAAATFADFAAGEAFDdCBChACASGHDeDDHbAGBhADAQCDADCDE.AIEGcGEFWEAD.PAHFhAEABFEANICDaHAE..hAFA...,1,-12,-15,3
fMaCPVeLUDdgEIZRYSXcNbGWFKHTBQJOA,aAADCGED..eDDGUDGADAEGdEBG..EAHHRCBE...SBCAhAAAXAEG....bFDDFDAGhABAKAGCTGBF.BHGEhACAQGGDAFIHfCFDMDAH.LFDChADA.....hAAA...,2,-28,-19,9
VTHagKRBDIcWPAQUEZLSGXeJNCdYfFMbO,ECFDSBCFGBBCeEHHCHCE..dFFBFGBFMDDBOHECHAFHKADGDEGGhAAA....IAAGhACAcGGD.AFFEZAGH.hABALEDFJDAFNEEC.fDAETBDBaBHDBFEDhADA.WFAD..hAFA...,2,-14,-14,0
bMeWERAGNaSXUBDIZfKTPdVJFYcQHCLgO,GCFAaABE.SCACXDGA.UFACBHGFDBEFZFEGKABEdBFEFDBAQEBBhAAAHFDHLHFChAAAOHAAMAIBeCAEEAGDhAEAAAIHIEEF.TBDE...hAFA......hAHA...,1,-8,-11,3
cFdEZIJPVUeSCTRbGfWXaOBYgLQHDAMKN,KAHBFFFDZCCH..IFGHJGAE..UAEBCBCB..RBFFGFBBhAAA..XDAHhAAABDDDLABEDDIHABCEMBADhABANHEFEGAB...eAEHTCEA...fHGHhACA.WHAAhADA..,1,-32,-38,6
YTCZdFJPbHWBLRUeDGKIXQAESagVcMfON,EEHHaBAB....VBEAMBFH.OBBB..NHDD.TGEHZEAHdCBHhAAAFDGB.JHAGHDGDBEADhAAAREDEDICGKBGC..IDCBhABAABID..SGADfEDC.CACB.hAEA......hAFA...,2,-30,-19,11
EVKSbMNXfFQGCZHDaRJOIdUYPWLgBATce,eBCGKCAHMDED..fEGFFCFDGAAHCAHFZCADDIEE...aGHDOAFAhAAAdCGH.UEAFPHCAhAAALFHDBABFAEECEBHHhABASAEA..NDDC.....hADA..XEDChADA...,2,-29,-17,12
KIHJLgMfdBbCQTDOFaAVNZYScWPGEeUXR,VECAZBDHSCAG..PGEEGFAHECAAeDHH.XAFHhAAARCDEKBGEHGAGLGFAhABAMAECBAAGCEFADEAEaHBChACAAIGCNEIG....WACGIBBH.fAHGhADA...hABA...,2,-21,-4,17
MWKJOaDEcGVefIHNYdRSTBbQLAUgXFCPZ,XBGDCCAAZFGF.KBDEaGBB..DIAGGAFG.eFDHIHFFhAAAHDCEdCCBRDCCBGGELABGhAAAAGAHUFCFPCHD.hABAMFFBOCAA.EABC.fBFChAEA.NEIE..SFABhAFA.,2,-30,-1,29
PBbcRaIHTDdWUAeMVfSYGFZKCQOEXNLJg,MFIDVFCH...SBEHFAEGZABD.CFFB.EFEELHDC.JGAEhAAABBHA.bGFAaBAFHCEEhAAADDABdECBAIEA.eACChABAfHADKAGH..XEGFNBAE..hACAcDBEICCE.hABA...,1,-16,-25,9
fgVXcDWKLQURABEbFadOIYTMZHCSGJPNe,BBCEFAGEOCFD..IGHBMEDBZACASBEBGEGE.JHDGhAAAeHDA..fDGChABAgGACXEEHhACADBAHKCCG...QEADAEAFEEEBaAAF.TGAChADA.CCCDNAEB.WEDFhBAA..,2,-25,-19,6
GEQAXLgRKPNCdSaJZebFDMHTYBUIVfOWc,LFFERGACKAAH.CCEDdHDBaDCB.ZFBE..FBDCDABEHFDGBCHFUBGF.hAAA...IBCAhAEAODFE.GAEBAFAD.hAAAXGGDNACH.SFAF.bDDGhAFAMFIB..YBBFhAHAfHFF,2,-31,-30,1
VJLgYCOZWETKdceDbBUXGfNRPFSAHIMQa,MCHBQBAD.aDDDVFCF.LDAACAFGZFCG.EGGBdDHGeBCGhAAABEBA.UAGEXGEHhABAGGEBNAIA.FBDBAEFCIAFBhACA..YEAF.WAAChAEAKBBF...DIBEfHADhADA,1,-7,-27,20
dfTRBZJKWbUHOcFLQMgSYXEaNGeVICADP,dFGFRFCCBCDDKFCAUABDHAFDOCHH.FDBDQCEH.SEADhAAAEAABaACBeGEAhABACHHC.AHAA.DICG..TDEGhAEA..JBFC.cCAHMIFE.XFEDhACANIAF...IDHDhAEA,2,-33,-21,12
CLdAYOHgDJKMVabReQfBTPNGXEUZWcSFI,HDDFJFFF.VAAFREBB..QACGBAFDTGABGAEE.EHCCUFGAhAAAZCBC.SDBAhACA.CHDGAFCFOBGDhAAAgAGBMEAFaEGCfDGHNAIE.XADHhADA....hAIA...,2,-19,-10,9
cXMZOfaVCDHRAFJKeYdWbGUPISQTENBLg,FHAGJGBG.eGEEdAHCGAADUCDD....SDBFQAEGEAGHhAAABDECLFHH.hAAAXFBEMDAFfEHEhABACAEFDBBAAABA.KHDA.WEFHIHEB.hADA.....gDCDhAGA,2,-35,-24,11
OEYFbZfKeCXgGMPWVDHUBSLQTdacIJRNA,OEEAFABHZDEBKDDH..eACE.CHFHGDCGMIDE...VBAHhAAADFCHBFAGLFHFdFHAaBFAhAAAIAHD..hABAJCAHAHCHEGAA..fHABXAFDgGDHhAFA.WCEGhBAASGEA.,1,-3,-44,41
FcfDGAKSEeJRXCbZQMPLUTOaNVHdWBYgI,SACHEEAERCCE.CCAH.ZCGB.MHBCUFCGOEFH..NAEBHDEEhAAABGHB...IHFGhABAFBAAfECDhAAADCGGKBEE.XAGGQFGATADE...hACAaHAC.WFAG..hABA...,1,-24,-26,2
JfDVKQNGRYLgeFMAZTcPXSHbCOdEWIBUa,TCFFXDCB.HFBACCBF.dAHAEGFDBBDGUFAD..aCAFDFECKEFHQACAhAAARFGHLFAFFEHFhABAAIFE..ZAEHSDDFhACAOAAG.IHHD.JAEGfDHGhAGANIAF....hBAA...,2,-11,-11,0
RSdVTAWGXOeNIQbaJDZHYgfCcKBULMPFE,GBFAODDF.eEHHQADFJFCG.DBAEZCAHHCAF..fHBFhAAAKGHFUGBCMBHHhAAAPADDFDFD..SAHFhABA.dHEHAEIH...NDAAaBBFCAGFBCCEhABA......hACA...,1,-6,-24,18
GgFaEXMdcWfUPDJObSeRCHVNLIQKBYZTA,FBEFECGGdHAH....fDGEDAEBOCBBSGFFCFFC.hAAAVFACNEIA..QABAhABABACDZBAHADCEaDDFMAFGhAAA..UGEFJEDAeHBALAFGIGHFhABA..KFCH..hAGA...,1,-14,-23,9
LQOCPNYfUSBIWeXcKZbFdETADRagGJHMV,DDGARDFFGGCBHCBCMHEGQAAA.CGAG.PBEA..fAEAhAAABHCDeACCKEDCFFDBhAAAEDABaCAH...JFFGhABAOCFA.YHFGIGAEXDBFhADA.....hACA...,2,-27,-8,19
QWaUZYDATFfSPGKLJOgbRHCdMBceIXNVE,FBBASBBCKEDG.ODCBREAFHGFG.CAFC.MFHHBGDE..IEEEhAAA..XCEFhAAAVGDEEBGGaFGAYHAAhABAADHB..fAHCLDAHbAEFeDAEhABAQDGD.hACA...,2,-38,-2,36
cUREWCQXHbSONMBGdDIfJTPgLeZYFaVKA,RBABCGFEHDAHOAEFBEHAGDEBdAAA..DGDDJEAH....TADAhACALGCGZEDHFAGAKABEAIGEEDFFhADAQDCE.hAFAXGGESFCFMIBGICCB.hAAAfHGFPAHH.hAEA...,2,-19,-19,0
JaUMFYdfTXSEeLcROAGHCgWBPKbNQIVDZ,GCDAHBGDCEFHBFADKBGGQABADIDG.ZGFCaBBDUEAG..FADGhAAAdDGA..TDCAhABASHACEFEBLFBBhACAOADEAFIH..gGGHWFCH.PBEFhAGA.....hAAA...,2,-26,-13,13
WLXgObaZSPIYVTfEcGKRBJdFNCDMeQAUH,UDCGHBBCXDEHOHFEZFFE..SGDH.IHBAhAAATAFEECHFKGGGBCGBhABAdFACFADGCFBCDCAHMAABAEBELAFEhACAaCED.PDHF..YHAGhABA.fBBDhACA..,1,-15,-20,5
UGFQVCSKcbTBNRaeOJWPLMIDEYZXAfgHd,HDBCGCGCFFHDCFBCKEED..bCFDBGAG.RCBA.eBFE.JEAFLADChAAADACD.EGFGXFEGhAAAAHIDdCAG.UADESABBhAHANIDB.aFDHWABDMICC....hAIAIDHF..hAGA...,2,-20,-18,2
cMLbOdTUJKXEgZWFeDVHGIPNfYQASBRaC,BFDECCCELEEEdEAHUCGHKBDE...EACFZGCE.FFAADGAFHAGDGADChAAA..IABGhAAA..fFHChABAAGIFaDAEMADCbFEH.TCABXGFHeHBA..hACA......hAFA...,2,-24,-22,2
AfgQWYPUFEbMVRJNHDcdSZaBeGXTKILOC,QFFG..WBFEUEBEFEGHMFEDREBH.HABCdCDCZCADBCHFhAAAGGDBXBFBKAAF.hABAOFAHAEIB.fBAGhABA...PDHDEHAG.JDDANADHDDGAhACA...cEDDhAIA..,1,-16,-23,7
SfFdYeAbUNBPQJcCDORXIaMHgGTWELKVZ,UDDBBACDQFBACEGD.DGGBXGDHMCEH.GBCB.hAAAEGAHLAFBKBACZAGF.hAAASFEHFEAEdADFAGGB.hABANIBDPBHHOFHD.IDCBaCAC.HBADhABAgGBH..hACAWEAD.,1,-3,-33,30
fSDVBYaPQNTWFZcCgGMJKEUXROLbeIAdH,dFEBHFEBDBCBBGBB.aAABQBDF..NADHFBFBCFAGMDIHECAC.hACARGBCLAAB.hAIAeAHHAEBESEFEhBBA.YDDF.WBHB.cGGAhBCAJHEEKCFB.OEAGhACA...,2,-24,-19,5
aLdgZDRfHQPOVGBXbIYeCATESNMFcWUJK,TEGDECDG..MGAEFAFBUGEDKCAALEGHdEBAZAAA.DHDCHDED.hAAAOEABBHBEXAFDhABA..IBHChABACFFGAAEH.NDDG.WDAAaCAA..fHAHhACA.....hACA...,1,-5,-46,41
GDOaCBTZYWcNQfHESbAFMPJKdUVRIeLXg,FCDGMFCHKDADUFEG..RGFELDHHGAFGDDHD..aGBBBADDZBFB.hAAA....WBBDhAAAQABGHCCHSFAHhABAAAIFdFDFIHCFXGGBCEGA....hACA......hAEA...,1,-23,-32,9
ZWJdAGPfScXOUTagNVBDbMFKEeRHQCILY,GABCSCBCOFCAUGEH..TFGCaCEH...VAFFDFIFFHAChAAAKHAAEDDCHADGCADELHDAhAAAZCGBJDAHAACA.fCHAhABA.XFAGNDDEBABG....hAFA......hAHA...,1,-8,-22,14
WJfgDaSVLXRANUcTQZFGBdKbMOIYPCEHe,UCACQCEFGADHKEGAOHDA..IGGBCEEHHEGDJAAEDGAGSDCHhAAA.hAAAXAFCADCETGAFBABGhACAMGDEEHCE.fDAGaCGC.LAHBhADAcECG.FGEF..hAEA...,1,-15,-25,10
dNGDWSCUTLVPOcYZIEgHeBaAFQJMbRKXf,QDDEMBFDKCBG.dHGHDGGACCHG.LHEC..VCADOADGhAAAZGBEEABCeEFCABGDFFBEJGBG.hABA...XAGHhACAfFGG...WAFESDCAhAIA......hBAA...,1,-24,-31,7
GJegRZELfVSODMBAbHUYTcdKFPQNXCaWI,UBEGTBCHKGGD..FEDHQABF..NDHCCGADaEEF.GECGhAAAJAAG.RAGH.EHCGVCABhACASGEA.MIFGhAAAAEHB.HAFHdGAEWFHHIEBE...hAEA......hAFA...,1,-15,-21,6
UWODTGgQRKdAHMfVIYLJXENSbBPaZCceF,MDHDVGDA.LAAB.EGACNDAB..BBEHZDAECGDDFAGH...UEAFhAAAOFFHDHACGEEBhABAgAGF.QACFhADAdBBFADGA.IDFG.XECAhAFASACE.aHGEcGGEhAGA.,1,-26,-27,1
XTPFDKGJfeWScBCAYIdERgQNUOHMVLaZb,dGGARDFAQBBBUCBBHEDELDABZCEA..TAEBDAHFKDDEGGAHhAAAeGDE..SACEhAAABHFCCBAFAEID.EGGE.NIBH.hABAODAHaAFF.XBGE..FECC.hABA......hACA...,2,-16,-3,13
GOJSYcQICAKBHNPXUFdaTRZLDgVMWfebE,HCCAXFGGdFCDaABFZDCCLCAH.DAGFgGFA.hAAAMAFCeDFEECHBOFCHhABASBGCQADGhACAAAAFBADGNIDFFAHHTDFC.....WFBDhAEA.....hAFA...,1,-10,-18,8
JgfVObZPdTRIYKaDBXUFNSCeMALcWHQGE,LGDAHACBQEAEGACDEGACJAAH..VCFEOCED.PDAAhAAATAED.REEBIHAChABAKHBABBAGXEGAhABA.UAGCSEDFCFACAEGA.cGFDhACAfEDE...hAEA...,1,-5,-12,7
LeUdFTXAWOcgJKVCMPSGRfYIaBEQNbDHZ,OAHFJCAH.KDCBMECHGEEB..RBBC...ICADEGEDQGGEhAAADCFALHDGhAAAUBGEdEEFXGAGAFFD.hABAgABBCDDFSGAFfAEBaAFGBABAhADA.bFCH....hAEA...,2,-20,-17,3
BYHZObXEWKJDfeVdTFgCSUaLNARGPIMcQ,RCDCGCBFMEAD.QGDHBFBEHAADODFFEGHH.JDAFDCCD.eEFDhAAAVAAG.FGHHCHFDSADFhACAUAGA.LBEEhAFAAECFcGBG..YHAG.XDGEhAGA..fEEEhAAA,2,-21,-10,11
HRIbGdPXEeLNacOTZKUfFDJSYVBAMQgWC,QGCFCFFERBEA.GBEHdBBHEEBDeHFGLHDGaBBG..ODCFhAAATGAEKEBF.FGGASGDEhAAABEFFADACMAEGhABAHDDA.IHHH.bCAG....hABA.NAIE.....hACA...,1,-12,-17,5
QVMSWdFaGCAbDUgBIJZRcOfLKNTYPEHeX,DBIFBDEDZCEDRDCD..OEADKAEA....TABCEGEEHAEE.QAAHhAAAMDCDdHFHFFGChAAAaCGCAEHA...UGGChACAIHDBfHCDLAGH.NDACeDDFhABASAHB.CBDG..hADA...,2,-30,-9,21
XfAIRYcKCbBFLJQgDdeEUTHSNMPZaGWOV,RBFDKFCHBFGDFDADLCEG..QCDHDAAFdGGA.UAAGSEEEhABAPFAHaDACOADEhACA...XCBFhADAfEHE.ABDFIHHGCHAD.bFBFhADAeEHBEEED....hAEA...,1,-20,-35,15
WRQDLEafTJXedgHGFcYUObVIKCAZBNPMS,ZFFCBHCHMCDGRCEADFCHLCHF..EGEDTCBA..eFFAhAAAdADBGGABFBCB.UEBDhAAAODDHIABEhAGAAAGCSAFGaEEB.JCAD......hABA......hACA...,1,-7,-43,36
KMWQXbRgLTFfDUJYGSZHEaCeIcONBAVPd,dHCFMCADQAGFRBBH.LCACTGFDDEFBJFECGDADZGAGaBGB.hAAACFAE...eBEFIAAAhACA..cEGHhABABHHAAHFGKFAGXDGEbFDD.fBDDhADA.SDFChAEA..,1,-8,-23,15
HQGXBaKdJSbfNRAeWIDMLUVYEZgCOFPcT,eHEEDEBAMFEFUECE..EAAHCAAC..FACB..TCGBQEAGhAEABGADaADEdEFB..SCDEhAFAfFHGACHGLHAAhAGAZEEFOCCGcFGCXGBF.KCAA.hAHA......hAIA...,2,-25,-19,6
GBdOeVHSMNFXADZLaRcWUYEgfPQJCIKTb,LAFDRBCDUGCF.EBCF....PAHFCBHCTFEBBFAD.OAAFhAAAeECCHGBE.NCBAAIDEhAAADEEA.aAEA..WADHhABAfFGB.IEBAGDGC.SDFEhACAMDAF..hADA.FFFH.,1,-2,-37,35
dRAHcETaZGIJVXSWOCUNDLbKBQfPMFegY,HECBTFCAZCEA.JFGDSDDA.OBBECADBDHAGKAGBBAGB.hAAAQBGBMEFBFBAE.hABAeCADdDBE.AEHGcGGBhAAAaAFH...IFFC.WFADNDIA.hACALABE..hAFA...,2,-26,-24,2
bKNaRAQJYCdecfBLPZMEWDVSTFgOHGUIX,QEDFJEFD.CBCF.dBCE.eEAABCFELHBAZAAHMAEFECHBDHAChACA..SACEhAAAFEHDOHCCUAGH.IGHDhABAKBGCaFAAAGAAfFCH.WAEHhAHATGFC....hADA...,2,-33,-21,12
MLDXYVgaJBCOFdRGZUIbPcAeTfNEQWKSH,TECGEBFFKHGG..HDBGDCGF....XFGBgBADBBGEFFEChAAARACFZAAFUDGH.IAHChABAPFAF..ADHBeFEFhACAfFBB.WADCLAEH..hAGAYHCE..hACAaGHDCGHB..,1,-12,-25,13
gfWSNTXdeHUFEPBOQbKRJVLZCIcGDAYMa,MBIBaDGC.....fBEDSBBC.XGFAdDAFeDDGhAAAHFBEEGAEBHDAQAEAhAAAKABCRFGBLFFFhAEAIDEFDCCDAIAA.WAHFNFAH.FEAB...OFFGhABA....hACA...,1,-11,-20,9
TOcfFJDHZYICNebQUEgVSABXLPMGaKWdR,BCCELGFAGCFCaACF.dFAFRAEE.OAHH.FHFCHCEA.IGAFhAAACECE.eEAEQADBhAAAEBACSHCAhABAACAHMABDKEHBcCCCDGBFZFDDYCHB..hAEA......hAGA...,2,-21,-12,9
bHRQOXcadMTZDNYGfICFSVKeJUALBgEWP,BFHCEDFC....PFGBHFDEQBAF.OADBhAAAXEABdBFHMDFCDDBEGABFhAAACEAAVGAAJFCDAAGCLECEhABAgAGAWHEAbFDH..aGAH...hACA......hAEA...,1,-14,-15,1
YIKTAdPURFbOBGCeMLaJWgQXcSNDVfHEZ,UGDDRDGFOEFHBCCDGCBB..MAADJFBE.QDFE.hAAASGGADBECfBHEhABAEAEFZEAEKACFAHBHFAHDhABACEABaAGA...XGCAcCEB....hADA......hAEA...,1,-25,-28,3
eZEgdYKORTFIVNLCPJbXfDUWBHAcaQMSG,aBECQFBHGABCZGDEdCEFKEAE..TDEFFGEC..VABDCAAGJFBEhABA..XDEHhAAADIGEBHAFAFIBMAIDEAEGOCHFhADAIAFD.NAHG........hAGA......hAHA...,2,-23,-19,4
IdLSNUTGHaOVKFPJbRBYcCXWgQefZADEM,MDDFdDEHSGFFUAFDHGDC..aAFDKGAAFACC..JCFBBEADCCCF.hAAAXFBE.QBAHhAAAfCAEAHAADDIBhABAIABG.NCIE.OEGF...hADA.PEGF..hAEA...,2,-35,-25,10
VECJLABbOfcKSMRIUgNYeDGZQdXPTFWHa,BGDGOACBKCCFRDEB.UCFG....NFAF.DBAFGBGGZEAH.dGHA.hAAA.XFGA.hAAAFAFGaGAD.CDAEAGAF.fGEEhABAMICA.gAEF..hADAeEEB....hABA...,2,-48,-21,27
VgRDHdTMYcSJWbGfFEaeZKOXAIBLQCUNP,BFFFQGGHUGGB...VDBEDBCEdECHMFAH..SBFHhAAA..WAABGEAChABAfGBBECCDaDGEKHCChACAOBHD.XFEFLAFCCADBNCCH..hACA......hAFA...,1,-25,-30,5
cfJPZIASgHUEDMbCdROQXaKVeTBNGYLWF,SEGAHDBGDEGFMCFDCAAF..dAHEOFAHQGGEKHGA.eFEDhACATABBBEAGGAEBhAAALDCCFCGEJEHFZECBACGFEBADhABAXADE.aGAH.....YBBAhADA...hADA...,1,-8,-14,6
WMYCfSKPNXHODULbJdEBgGVaZRITAcQFe,FGDAeCFBMFDACDAA..KDDA..XAEFHABADFIFUGGGLAFEhAAAJDCG.EGBBBACD.GBGChAAAaHFCZECARBADAEIF.QGBChABAWEHF.SDAD..hADA......hAHA...,1,-16,-20,4
NGBQdVfWZXEDRHOCUbecYgLaAMKFTISPJ,MDCDKBDHFFGA..TEEG..IABFSDGC.JABAGDBAhAAABBFH.dAFEfEAChAAAZAGDEFEGDIDCOFHHhAEACHHHeEAD..YHCEaHEAAEGC....hAFA......hAGA...,2,-38,-21,17
GfQAHNPBJWMXKOCeRabYDESFZIVTcdULg,HEGHBCGCMHEEOHCGREBD.aCEC..DACGEABBZABC....IAFBhAAATEDC.UEADLHAAhAAA..fBHAhACAAGFCNIEF.PDDHJAFCXCDCCHAE.hADA......hAEA...,1,-24,-26,2
VLKWGTfCQJcNUYFOPgIBdbRESDeHAMZaX,aDFEXCDDLBCAKBFC.GDBG.CBHE.QDGH.JFCDhAAAcGAHUFFDFBAAPHFAhAAABGAF.dEAFbEFASGDHhABAeFDH.ABDBMACEZAFBWABC..hAFA......hAIA...,1,-10,-19,9
eXDfEYRSBAWKCUHFNGaTcPMdZVQOLgbJI,CEDDUCCCFGED.GEAC..TCEFMHFGdDGGZBAG.OAABLFAFhAAA.JBHFeHCE.DEFHhABAEGHFSAHDhACABAEFAEGCHFBEaAFB...PFFG....hABA......hACA...,2,-22,-19,3
YJfDKSUFTHZBReNbXQaALPdgCcGMEOVWI,dCFFCCEEGDCAEDDB..OBBB..IHBDJGFA.DFAFSAEFhAAAUAAGFFGBZADCBFBFhABA.RGBGeAFA.XDGGhACAAHHFPFEDMIFE..WBGH.KEAEhAEANDAA......hAFA...,1,-14,-34,20
SCXVBTcdALegQMZOKEaWNIfJYPHDFRGbU,LDDDeFEHMDEFKCAG.ECEGaFBA....IAEGJBCBHAEADBHDhAAAFABGGGEFSHGChAAACHABBFGEdHADAABB.gCGFhAEAODHF.WDHHfGBB..hACA......hADA...,2,-34,-7,27
aSZgMFIKTJHBeRfXdGCEANLOVbcDQPWYU,OFDGVAGH.DGCHQDDA..PAAFUCAHZFAC.FGEAhAAAIADEKEHF.TCFBhAAABABF..fBCDhADAdAGDCEHGAIGALFAH.WCCF.aGHFhACAMIEEeBEF...hAEA...,1,-17,-29,12
VRFSbNMBIKZUcLXGDeEHJgTWPdCOaAQfY,QFABVCAF.SDCEMCHHBFDGKHBAUGGDLBFDGABDhAAADEAEeHAEEBBEJFFC.hABA.TEEEdGDDCCAFAAABfAGAhACAFAHD.IDDE...hABA......hACA...,2,-22,-12,10
WeMfUTLNDdOcBKGRgYVIJEbCHPAXZaSQF,ZCEESFEFFADA.MFGDUEGA.LDCBDDIHOBDCKGFDGCAAhAAARGAE..VAAFEAGE.hABACDFGHDBDAHHA.aAFCeBBEhACA..fFHGNIABBFEF....hAAA......hACA...,1,-16,-21,5
BRPQJOLdKeATYabgMCNEIZWUHFXGSVDcf,aADDMBAC..CFCE.EBGHZBFHHDGFGFEFDFDCBEABRCAE..QGABhAAALCAGKGBFAHDATABEhABAgGEE.NAIE.hAAAIEED.WHCAXCED.SECFhABA.fAFHhACA,2,-29,-13,16
WeSBGXHZLDNOCPdRFEaVUfbJYgKATQcIM,TBBEQDFF.MBCHSEBGGGAHHDCFLGEGDBEBNAIECAGCdGCAhAAA.RCEDFADEEEAHaGHBhAAAVBGB...fDDGhABAJAEAKFFFICABBDAC.....hACA......hADA...,2,-14,3,17
aZLUYETSFXNRHPMbBDgWAIcKOdVCQefJG,KAAHOBDBdAEA..CGGA.eFAGGBFGZDFFLABC.EEHBFFEFRFEBHAGBhAAAMBDBDIDGAEEF..hAAAICBHQCAFhACAfGAGJAHHUGAE.SEHB.hAFA......hAGA...,2,-22,-13,9
eAUZQMaDdFfXCSHTRLcBgbGPOKNIWVEYJ,UCBBMGAEDGGDFADC...CDBC.SABBHBFFLFEDBHCHGECBhAAAOAAGKEBG..IAGAhAFAEAEBeHAAAIGAaDGFhAIAdFHGTBCD..cGGFPAHDNBIC..hAFA......hAGA..YCEE,2,-26,-12,14
MILJECfDFZAdKbeURBPOcHGSWgQaYTNXV,KEFHeCGDBDHGOGFEGBDB..SEEHQAAHaBDC.TCAFhAAAVEBBLDAChAAA.JFEFEFADCAGFDGHHhACAAIGCdDDC.bAEE.........hADA......hAEA...,2,-26,-13,13
SbdQDCTYaBfFHeAMRPKcELJUXNZgGOIWV,RBCEKCEBLGBCUBGAZFGBOEEF....IBBESEAEhAAAdEBG.CHAD...TGEChAAAaGFDBCAGHDCBAAGDPDHDhABAEHAC..NAED.WAGH.....hABA......hACA...,2,-29,-29,0
AXDMIPKgWVUCaEfOTGJcLNReHFSdbYBZQ,XCABDIBGMGAC.KFAH....VACECAFBECHDODEC.GGCHhAAALAAC.NGEDHCDBhAEASAHHdGCGBAHBhBBAACFEIFFEPHEG.WABDfDFD.hACA......hAFA...,1,-11,-38,27
OQaISUAEFcYgPGZLHVdXMDJKTWNebCRfB,FHGA..gFBAGDCEZAGFHDAEdAAADCECJAHDKFHD..TDAFhACAeCFBCCCEBADB.QEGDhAFAIADAAAGDEFEFhAIAPFEB..XGBDMAAB..WHAAhABA.....hBAA...,2,-22,-14,8
HOBbeXZPYKFgVfJMcaWNATCIGUQLEdRDS,CBCHUCCALBFARCGDHGBEBAGH..XAACZEEEKEAB.FAEF..VGEAhAAAMIFG..aCACAAHBTFFChABA.IDABhACAQGAFdGAGDDFBSECB.eDDEhABA.....hADA...,2,-25,-15,10
HJTfDMYUWBabdgOLFceENVARIGSQXPZCK,GADGXDCFCBBBKGGDHDAD...JHBETGABDGGA..MEFCUGDHhAAAaAGFdCGG.LAFAhABAFBCAEAAHAGDERCAD..SFFEhACAPHFG....YAFFBFDB.hADA......hAGA...,2,-17,-14,3
KBLFgUQbZOYWNPHMfeJTcGRIXCadESVDA,BHEEFFEBUCABQGAAZCFA.ODFF..NIBH.MCAD.JBDFhAAATGGGGEBDREAD.ICHFhABA.CHGFaBBBhACASAAA.DEDCKAGCgAGFhAAA......hABA...,1,-15,-39,24
DAfIHSGLeMOaRWCYVgJFUPEKXdBZNTcbQ,HECDLDAAeEHFOFEHaACD.RAGF.CABE...VABBFEABUBGH.hAAAEHBEXFFBdFFGBHEDhAAANAFC...TCDDhAEAQGAHAAHCSBBDMFIF.....hABA......hADA...,1,-5,-23,18
fZVeMcHLOUDgJCIFPXYbNSQWGdaRBATKE,EBGFZDGFeHAEHFDFUBCCDECB..CCBC.FGGD...XEEB.hAAA.NBFC.SFAEhAAAGEDAaABCADIBTBAFhABAKGFGMBIBcGAFOACAgAEHIBGE..hACA..YCDDhAGAWDAG..BAHB,1,2,-32,34
QUNJfOaHKgcPFCDGdZXSTWVLeRBAIbYEM,..IBCEbFGF..EBCFQFBGUBEA.JFFEaAACHDEAKBHD.hABA..PAEEFEEFDADGhACAdHDHXGCFSCAHhAAATGADWCEC.LAHBBECFAAIB.MABGhBAAfHEH..hAGA...,1,2,-25,27
WdEZLgBUSICXcfVFMRObKDQYATePGHNaJ,eEDBGAAHHABEaEHFdDCEZFFBBFAD.SCFEXFBGVBEHhAAAFFHDMDDC..ODABhABADICCQDABhAAAAHCA.NEEH.EGFF.LAHFIHADfEEEhADA.KHGG..hAEA...,1,-9,-11,2
egJMBOLRNVHWdPAYKcIQEDGTZSUFXfCab,KGCHQDAHDDBAZBCA.SEGB.FABGfHED.hAAACGGC.bGBA.JCDEBEGEhAAAOAHBLFBC.hAEANBAAHAGHdFBDAIFCIFFFEEEE....hAFA......hAGA...,2,-31,-25,6
WaTKRPSVCOFLeYXQGAEgIfUMdNDBHbZcJ,EGDF..fCAEdCBFBGBHZFGHJCHD..aCEBRCEF..SCADhAAA.OAFEeBCBXGFFhAAAACIH.IAFHhABAMEIFDABAcEAHKHEGCGACFECFLHBGhACA.YFHB.hAEAgCFF.,2,-19,-15,4
dUScTFaIbZXKDNVAeJWQCYfgHPROBGELM,JHCACFHA......fFAEHDGDRDBDOABBGBAAMCCASGDEhAAAFEDA.aACBIAHEhAAAXAEAKGFGDCEBhABAAEAF.eAHH.WFCCYADCBHHCEHBC.hACA....dHED.hBAA...,2,-32,-8,24
cQCLTKgOFRSMUYGfeDbWdEaHVBPXAIJNZ,JDHBZFDACBAALEEH..TDACOCCCFDHBRABA...UDEHGEAHhAAADGCD.dBGCHADCBHCHhABAACDC....IGAAhAAAQGACKHGAMABAfGGG..hACA......hAEA...,1,-25,-27,2
gCdeGOIJFAUXHacDEWfTVMSNRYbLZQKBP,HCGFaGEG.ECAH..TBAASGCA.RCEHLACFKEDABBFEgCEGhAAACECAdGGDOFADhAAAJEBBACIBXAFFhABADDAD..fHCBMIFG.YABChAFA.bGFE.PAHDhAGA...,1,1,-32,33
NMOCFLKbcJHSgIQeVEBdXDRTUYWPfaAGZ,ZCGFOFEFFBDGKHGG..JCBDHDDC..IAFGeHBAEAADBHADhAAADGGE.RADD.UFAD..hABAPEFAADDGMACECCGE..hAGA....cGGGSBHB..hAHA......hAIA...,1,-22,-44,22
PMIgOAJFfTBHdWKNGSUERXYaVeDZLQcbC,JDDHTCAABGAA..dAEEKADCGEBB.EGAERAGB...aGFHDCCHQAAHhAAACHGE.PDDAhACAMCGF..OAAHhABAAAHEfGGH.WHBANDIG..XFFGhACAYCGBZFBH..hAGA...,2,-47,2,49
SRWJbMFUKEHeTfgdVCNOcPDLXAaYGBQZI,aGFBBFBBZBBBSDDH.RBAF.bAGDMICCUFAF.HDEA.eADEhAAAfGGAdGHCCCACOBDChABAPABGLDDDhACAXDGDAIAE...QAGD.IGEEhAAA...hAGAFAED.EGAG,1,0,-14,14
UGDIdCHZXKTBMFRQAgfYbcaEPeNVLOSJW,...fDBEbDFFECBH.eDECLHCCSAAAUAEDDIGCdFFBCAEGhAAAXDDHBHHCFHCCAIAA.hAAA..gAGChABAaFACNADGOBHFGBCEIABBKFAH....hAFA......hAHA...,2,-17,-6,11
IbBGHYgCaLeXDPUNKOVTSdJFWMEcAQZfR,ZGCCRFCCBEHCGBBEHAFCCFEFLBGDDDBF.UFGCKAAHOCCE.hAAA.SADBhABAFACAEFFEAIFC.fFAEhACA.IDEEYFHBaAHFeFAB...hAFA......hAGA...,1,-23,-27,4
bfPJCaUXMTKZRVYcLDGQEFBSgNIdAOWHe,OFAFeACB....PAAHCACAaGDGUCFDMICGZEAD..RCCD.VDEFhABALAADGAEBFAEChACASEDD.hAGAICHHAAHEbEFHfEHATGGBKEHHDIGG.hADABBBD.NECC...hBHA...,2,-24,2,26
FONWXDGBcUYZSKVeJbaTCEMgRIHdQAfLP,LECCOBDB.XBACDACBBHBB.UBFGSGDF.VBEAhAAAJFEG..aDADEGFCRFCD.hAAAIEAC.dHABhABAfBAANBIA..WHFA..YHEGhABAKAGC...hACA...,1,-19,-42,23
PSEeIOJfUdCKATNRHWFcVaMbQDXYGBZgL,RCAEFEEC..aABGMDIHDAAD.GCADBFEHLEBASAFB.eHFEhAAAJHDA.dCFH..AGHBHAFGhAEAVFBCQACFhABA..XGAFYHAAgDGGhAFA.....hADA...,2,-27,-14,13
SYGZBRJaLNOdeWXPQVDMHgFCcEIUAfKbT,KAAHTEFAGDCF.ZCFAJFCCLFFH.OEAFdGBCXCDDhAAAQADFDABHMDAGhACAFFHDEGCDAHGH..SAEGhADABCAGaAGG.NAIEeHCG...PFHFhAFA.gBFAhAGACCCB...,1,-10,-20,10
QULcXVSHKMaRIbTFDCNfPYBdGgAWEOZeJ,OEFBZBBGQGEGUACA.LCHD.XGBCVFCFSEBChAAAKAFCMDGBIDDHhAAAFAGECHGD..NCIC.fABHhABABAFC.GEABABBFECFB....hAEA..cGGA.hAIA..aBAH,2,-28,-13,15
MDcVSWbIFGYfQOXaLdEPCHNgKBTAUZeRJ,ZBCDRABCMEFADGCG....SBFD..bDCFFFFBGEAChAAAQGACOAEDaBABdGFEhABA.CHDF.HDFCKFHBBAHEhACAACCDJAHH...WEEGIHGC.YCABhAAA....hABA...,2,-32,-18,14
UeRfPXbFDgJYWMadZNEIOKQcHBGSVTCAL,UECFeDEHRADF..XACHFFHFDGDB...JDHFMAGB.ZFAHEGFDKCAChAAAHAEH.BHADSGFBhABACGCHABAH.LDAGhACA..fBGCPAHF.YCABhAAAaABEIHEH.hABA...,2,-44,-15,29
BOFecaLRYfMDbIXTNACEWUJSZQKHGdgVP,CGFDUEBFZBEDHDAHdBBD.....VCGDOHBEeAAFLCHHhAAA.RCDEMGEAIHABhAAA.TECAAAGAEADGSCAGhABAQGGCgBCBBHHC.FAGAhACAaHEADGCH....hADA...,1,-8,-23,15
THCJYORKQgZfABDVdWSNacFUELbGeMIPX,DCBHVDBHdHCH...SBFBaABF.FCDHUFGA.EGCCLFAAhAAAGADDMBIB.hABAXDDBCEBHJFECODHFhACAKHAGQGEA.fAAEhADAAIHABAHANADBeHFC...hAEA...,2,-28,-15,13
PJSYQCNVIOGDeHMBEgZbLdFaTXfKRWAcU,UBCCJEDC.QCFACAFE..VBGHIAAHGEBE.DGIBHFCDhACA.BHHGEGEAZABEhAAALAFCdCAH.TDADhADAKHFAAEIF.SGGC.NEFEMCIDFBED.hABAfGBG.hACA...,1,-5,-24,19
EWZTKFCQIBacVRNSJbPGfODLUHXAdYgMe,dGGFMCCFEDFDZDED.FAFCCGBCBACB..aGFDRBAD....SGDFhAAAPAAG.OAEAhABALAHHUCCCXBDGhAEAAFHGeAHFKHEGIGCA.NEBE..JFHF..hBAAfBFEDDEF.hBEA...,2,-23,-22,1
YBQTgKNcXdWHVbCfPOFRILDMUAJZaGSeE,aBAAGAFG.SEDFeEAABEFBQADGKBGD.XFGEhAAAdBDFVFDFCEGHOABBhACAFGGH.IHBDDIBEACADJCHBhAAAEFAG.YHDA.NAIA.WAEE..hABAbCCGfDAFhACA...,2,-37,13,50
TgXEeIACDWYcfaSKPOHQbLZGVUBFJdNMR,DGDB....YDHDaAEEKGGCHDAB.QGEHZCAGGGBBhAAABBBA.dABFMCEAhABATCEBEFEEeFAC.hAAAAAIBcABGSDCG.PBHH..hAEA.OEFC..hAFA...,2,-22,-20,2
HNdEJCYQBefLFUDXTcbSWOMIaGARgVKPZ,VCGFKEGFZEBG.dHDHCFCA.BHADLABB.FFADDAAD....TFFFhAAASBHD.hADAOADHaEEBRAEH.HBEBhABANICF.EBBH........YFHBhAEA.fDCAhAGAcFGD,1,-31,-51,20
FOeMQXSaBbJTYWPcKNdARLZEfgVDGHCUI,ZFFAECFC...VADEGCAAUDGCFCCG.OEGBeHAG...MFFBhAAAQDCHSAFAhABAbCAF.JFCB...YEHBhACAWGEG.KEDCABBEfAGDDGAFCADB.hAFAIGCA..hAAABHDA.,1,-16,-18,2
JZXRGLNaUQbTVeECYdKHfPOBAScFgIDMW,SAHHFEFDDBAF.MDFFZFABRBDC.LDHHUAECQCCChAAA.TGBCEAAGCHHHdAGDhACAKHEGHDABOHCGAEHFIACAhABA.XGGENEBB.aEGHeHEAhADA......hAEA...,1,0,-26,26
SgKbfJBNECQPWMeHARFVdIGLXUYTDaZcO,FACCdBDCGEFCUEEF.DBCFZFAA..SFBFKEHH..JBEEBEAChAAA.NCIC.CDCG.QGCDhABAMABB.AAGGRCEH.hAAA.ICHC.LHEC..hAEA...YHAAhAFAaADAcECA.,2,-38,-24,14
SOPcLTEYWFdGZDIMXNbVRafeHCJBgKQUA,SBABOEEELBHDEBFE.FBECZCCHDDDEMAIB...XFEEhAAAbDCG.RCEGaFAAeCAFhAAAHGAABGHFKADBABABPGDChABA...TGAGWHEGIFHGhABA..NIDB.CDAD..hACA...,1,-1,-26,25
XZULGYDWFQMHObJTaSBeAVdfREcICPNgK,dEEAEBAF.CCEG.....NDIA.KCHBZCEBLFCDDAGA.FABBQEAHhAAAMFHD.OABGhAFATAEEBDGF.AFGAfCCBhBAAIHEF.XECF.YHEChBDAbEAFSACHhAAAeHCG...,2,-47,-11,36
PUgINfYWKSDMaTBFXReZALQbdGJVHEOCc,QCCDGADEHCFEEAGACHEGUFBH..IABA.fGGDhAAAKABFDAFATFEHhAAABDFCFFCFeDACZEAFAHGF.dGEEhADA...JBDC.OEFC....hAEA......hAFA...,1,-14,-25,11
WKVfZDECgMJAObIHTdPLcaBFGSURQNYeX,OEBAHAEFdFGDLCDGaHAABEGBFFGG.UACBQAAF.eFEFhABAXGEHKCCAVEAEhADADGACCHAH..MBIDbAFE.hAAAIAGC..cFCD.SGHHhABA...hAEA...,2,-24,-14,10
VTUQIZRgScEAWaKXCBNLdJbHPeGODYFfM,aCFAXAGBBGDCLBABdFCDHCBAGGDB.OEEGFFAEMIFGhAAATACBUEFGZFAHSCCAhABAAGIHKCHBCBAA.JHAA.hAAA..eACCfBEH....hABA......hACA...,2,-27,-4,23
IERXQMbLBcOJCfNTPHSDVUFgeGYdZKWaA,RBBAQCCGLEHFBHDGOBFD..CAHA.TFGHHDADDACC.FEEDhAAAeAHB.GEAChAAAdGAHKDFCWHCAAEDB.XEEChABAMCFA.bACEfGFCSCAF..hACA......hADA...,2,-28,-9,19
KZPEGVeMFXRCgWHDYJBAOSdbfQLINcUaT,SCGHdBAFQFFELDAC..IDHCUAAGTAFBhADAPECGECEB.GEAAhAEAVEAFMAAERFCFCHHGHFFEDGDFBHADhAEAAEIF.OBDC.fGEGhAFA.NDBD..aHGE..hAGA...,1,4,-18,22
VFTDcWSAHIgbEXeQBMNJYLPdaGOKCfZUR,HCCA..bAEEXAGFBECCMFDF..NBABLCAHaGFA.hAAAOHEACBCEZCCCUGAFhABARFCFVEFCDCAB.SEGChACAAEEBEAEGeCEE..YHFA...hAAA......hABA...,1,-6,-20,14
YfBgeUSECHTZXcMNObKdPVGQJDLaFIAWR,RAAFBAEFeAHHUGGG..CFEFHFAEZFBFMAAFOHAE..KBCGVGFEhAAAGDDG.DDGDaCCGABHD.hABA....fCEHhACAEAFH.TDFANBIE.bDAG..PDAChACA....hADA...,1,-4,-36,32
POVXCHRNcDgbGaEFKdZfWLUYIJeBAMTSQ,SDBAOEFC.CHGG.HBCH.RGCCDFCGGBFAaFAD.ECAH.dEHAZAEFhAAALAAEUAGHIGGDhABAeFBEBHHE.AHABMCCAhAEAPCAB.NIED.cGAF.FEEFfABAhADAWAFC...hBBA...,2,-19,-9,10
XKMPcQHLZBWfVCAaGObgYNRUJeDTSEIdF,aEHHGGCH.OEAG..gCAERFFEUAGBDBCEEFDG.dAAFFBBHhAAAKGBCMEEEQGFDhADAZCFCBFBHVAFF.ABEFNIABhAEA..eHAGSDDE....hAFA......hAHA...,1,-13,-18,5
HFMZESfUTIBWDYgVRJCGPaXbNOdcQKeLA,MEHBZAABEEBCUFACBFEH..DGFB..VBEECDBAGABF..PEHFhAAAaECD...XEFBhADAbDDF.NIAF.dAAChACA.KAGHAAHF.SFFBfGAFIHDHhAEA....gACAhAFA,2,-32,-24,8
VGYZEaLfAgTBecRMbKWCFdSJIOHPDNUQX,TBCFBHBHRDGHKBEH..CFFDFFCEdGDG...SCABOEFHDCDFUBFGhAAA..QABBhAAAXGFA.GCAAhACAEHCEfEHEAIHEeAHDMAGFWFAD....hABA......hACA...,2,-36,-22,14
UGXFHJVWfKPYgbIALQaceORSBMCdTENZD,aFGEeEBD.OCEHRBEDBAGFdHDH..EDBHDACHUFAHFBHBHFFG.JAAFhABAVAAB..KDCB.hAAA.PEDD..hACAgADCADDGLHDGSHAGCHHDNAIA.hADAZAFB.XDGAhADAfADC.,2,-23,-6,17
gNWdEGRFQTKIOLfZUPCBSDMJYHbeAVXca,VACAXFEB..aGFH....gCDGdABCEAGERCGFQGCHhAAAKHGEODHBZAFCCEEDBHHFhAFASBCE.hAIADGDB.JEAF.YAAE..HCDChBAAAGEHWFCF....hAEA...,1,-13,-33,20
ScDMUOAbPfdZYRaeFKNCXgILQHJTBVEGW,...bGEGdHFD.RCEAaFFGeCDH.FACGCHAF...XDGDLBDFQAGChAAATFCCBBBChAAAEFABSDCFhABAMIBGAAGAZAFCKCAFNBFA....gGBH.hABA......hACA...,2,-27,-2,25
QbaGKWXVFMYdOfHPgCEScTRUeIDJBZLNA,aFGHKDBC....XEFGMCBAdEDHHGCECAED.SAFHRCFG.hAAAUAABDAIFBCADLFAHhABAAIHEGGBBFAHFfHGFhADAPDBD.EECC.TCGHIAGA.hAEA......hAFA...,2,-32,-13,19
ZgPeDIFcbdWTHfSLCRJOMEGBVAYQUaXKN,UEFHKHBEZFFDeFBBFAEC.dCFDHAADLAEC.RGEC.ODFGGBCAAHHDQEDEhAAA.hAAAaACDNCAADIGG.bBAFfAHAhACA.CGAFMEID.ECDF..hAGA.BFCG...hABA...,2,-18,-7,11
KPcMXTIUeJLDfAFQGHOZVaYRgNBbECSdW,QBAGOBACZDAB.aGCHRCEDBGGE..ECDCCAEG.SBGGhAAA.KGEDMHCE.XCGEhAAAIDHBUECFhABALFADDIFGADADFHACGDAF.YDFFhABA.NACBdGHCPAFA.hAHA...,1,-10,-25,15
FWXQLOUdAPbGRNHcTDYVMZgfKJCSBaEeI,GDCBRCAHHDFBDAAHMIACZGCAKCAA..CADBBECAEHGGFBFB...QEGEhAAAOAHBAAFC.bAGF.hABA...NCEA.YGDEhABA..fHGHSFAF.eACDhADA.....hACA...,1,-1,-44,43
FZfgREWePDVHQASbNBLCIKMdaXJYTOGUc,SFEABEGALHAGCDFA.MDABdAAB..JEAHOAAE.GDDEhAAAFFCBZACBRBEA.EHFAeDCFhABADAHD.QGGBhADAAFHB..NBEC.aDGG......YDHHhAFA....hAGA...,2,-41,-8,33
CGbBVQWKUaFJZLOHEDgRNTPAXfMSYIecd,MABGSCDG.eFABCBEGBEHD.QDEDKBEAFFFCZCAFHBCBhAAADABERCGF..TGAEhAFAAEEF.fGHAhAGAIAHDdGDAVAGDaBBF..LGDGOFHD.NBBC.hAIA......hBAA...,1,-12,-18,6
FdgBYUPZSAHXLGQaTMIKVbeJRcDONWECf,LEFAQAFFaAEAMFGB..KBCAVCACJDAB...DFFFOHBChAAAEAACFEDDBDEF.UGGHhABASHCAADDB.hACAXCFCIAHBRGACNAIGCFCCdGDF....hADA......hBAA...,2,-30,-11,19
SFVYGEKfTQWJBUDPdOIbXRCgAcMaeNHLZ,MBAGeCBHLFFGFEHFGBEBEHDA..KDCFQDFFBGFH.DBDEhAAAOAFAIBHHXEEChAAACGAGAHIH..cECGhABANCAC.ZBDGSEBDfHFF.WCAFhACA......hADA...,2,-31,-19,12
VFUPWXRSEAedbDIKYfQNgBCcZGLHJTOMa,dBBCDGADKGEGQGBGBDFH.CADB.GCBBHAGDJEGH..MFBCaECG.hAAAFAECUGDA..XGCBhAAASEDAAADHeBHBhABAbAEH...fHGHNCAG...hABA......hACA...,1,-14,-36,22
dWYIBNVFCPKDabLRfOUEJXTAeMgZGQScH,MDEAGAAH.SAHBdBCE..IEBFBHEGNDAA.CFEHKGHFaCFDLCEFhAAA.OFHBhABAJFCDXAEHhAAAAGGDgGBDQAGE.WCAFFDCDDBFGfHEDhABAEDHB.eEFGhACA...,2,-40,-3,37
CIBXdJNfYaVMeSFAcQLOTUZbgRHDWPKGE,QEACTDDC.ZDDHRAAGDEIDKABHGAFE.CCHH.XEADhAAA.dEGEfGGFhAAAaGDDMDAESAFEhACAAHBALHFAOECDbGFGgAEG.WAHHhADAIAHBBECG...hCAA...,1,-16,-17,1
FCBZcMHTKXAaWQGRENPYOSedDfIgJbVUL,aEAFGDEA.EAHH..PDEFSBCEdDGADHAG..fFBHhAAAJECF.VBAHUAGGhAAAFGGDBCBEMAEATADBhABAXGCEADDC.WBFBQGGFNCIG..hACA......hADA...,2,-31,1,32
dGOEKJSADTgePLHaCNBfcIXRQUFVMWbZY,DCAAeADBHGEGCCBC.BGAC..IGADRAEHFDBC.MFIDZEECdCGBOAFFhAAAKABG..AEGC.gGFHhABA.PDCBhACANIAF...fEFC.cFCEhAEA.....hAAA...,2,-41,-21,20
GWaZeFRTcYHbVXKfCBUNAgISPQMdDLJOE,SCHBQCCFMHEGDEECLBAH.OCCAEFDFaFGCeHDEhAAAFBFBTCGFHEFGXFBFhABAfEAABGGDAHAEPBABhAAAdADB.WHFAZAFB.REBF.....hABA......hACA...,1,-4,-12,8
NKLEUYJFVHOaWcZQBTARXfPSIbMgDCGed,XEGFSCAE.MEDFCBEHGGDD.dBAGLHBAUGACFDCAOFEChAAA..aAAAcADGhABAZCFEBEAAACHBPHFChACA..IAHDDEFEKAHBECEA.VDADhADA......hAGA...,2,-22,-16,6
YeHKWgZSAMaPbfBEFTOGNQVdCILJcXRDU,MACFaFBB.....fBGCBDADFDEATAFCGEDFNHDFdFGCLAADhADA.XGAHhAEAUABE.HAEHKDHHZECDhAAASGGEACECEHDC.OECHCHAG...hAEAIDDF..hAGA...,1,-11,-27,16
gAYcTeGaJVCMKFRSbELXWIHfQPUZBNdDO,TEAEGEBGaEEG..CBDCFHCESAAD.EEHBXCDHhAAAHBECPHDEBGFDDFIDAIHAeCCBhABAMFDAKGFCLABBhADAIAHHUCGHdADF.YAEC...hACA......hAGA...,2,-22,-1,21
FaZYReWMgUCAKNBXcdHbQGIJPODLTEfSV,BDEAdCEGQAADJDHB.OEGBDIBGLCEEEGCA..fADDhAAASDAGFCGAZABGhAAAeFAC.MBDBCAGFKGEHhABANEIC.HFAE.ICCHTCAHaAFA.WFFDhACAAAIFXGGE.hAIA...,2,-31,-10,21
ZUaFHLIdgXNQBcSVGRbTMefPDAJKEOWCY,EABBCBDAZAFAFEAFHEAE.LHFEdEEB..NDDG.BEED.SDGFhAAAGEGGTBDBMBACeDHFhABADDAEABID.KCAFOAGHhAAAUGCFIHAE...XCCChACA.....hACA...,2,-35,1,36
QHMGVUCTORJeLNSEPdaAKWFcBbXfZgIDY,FFEGBBGB..XCFAZCEADCIBQEACGBAHCADH.RFFG..LBAAhAAAEHFEaGCB.ADDBKHAGbFAF.hAAA....fGCGhABAgAGEIHFDMFIF....hACA......hADA...,1,-14,-37,23
MFeHDQcVNBfLbOCZYSJGATEdPRgIKWXUa,dEFCRAGFKBCCUBEF.FHEEeECD.DCIBQDAA..VDEEhAAABBACLDAHODHDCHBBhAAASFHHAHDE.hABAEAEEIAHC.aADBcCDG.NIAB.hABAbFAG.JDDF...hACA...,1,-22,-31,9
HYSCfWagZObFcNPTKJQRIVMXLBEeUAdGD,dCBGHDDHCADB.aHBCZFEGOCAG..FAAB..NAGG.KAGG.RCFF.IHGEhAAA..XFAHhACABAHBEADCAEDEDIACfFFHhABA..bFCFPDAB.TFBFhACAJHEGMAFHeDHB..hADA...,2,-33,-18,15
YRSEJQfZNKaHdTOcbWILXeCFDMPUGgABV,VFAERCBDEGEH...QBCCZGAAKAEFHDFBdGGH.OAAH..WACEhAAAXBGA.CFDH.hABAFFEBDFIDMBID.PCEEhABA..........hAGA......hAHA...,2,-31,-25,6
IWOgfJGVcbLNaZTAYURPMHKDQSEeFdXBC,UGDDRCFEHBAEKAFCDGAG..QBCCeDDHdHAHCBEG..OBGF.hAAAJCAHVFFB.LADChABA..aHGCABHF.hACAMAAE.SEDA.XEGAhAEABEHA.WFBH.fCEAhAIA,2,-28,-27,1
bXcMQJNAdGYRUEZgDSVaTWIOHeKCFBLfP,dDCBGEGARGFAZCFDSDAH..TADBODEBKHBCCFCFFBCBBCAFhAAALHDC.bAEChAAAMAIF.JFCAAHAEEBAFhABADBAC.aCHF..IEHH...fFAChABA..hACA...,2,-42,-9,33
ZASBdMgDXYOLcfUJNFaTCKEQVGPbeHIRW,BGCFMABFDEDGOEDELFADUCAD..FBEGaCCC..KBHH..EGFFhAAAQGEFGACFeEHHhACAREAFZBCHAFFBSFCDhADA.dDGCXAAFfFDGNEIG.CBHE.hAFA......hAGA...,2,-27,-14,13
bZAHVFgMEBUNGIRPXTSJcKdYQDaWCLeOf,HABCFBFDEFHDBEGH.GGEDRDBC..XBACJFBCKCEGdAGH.DHAGhAAACGACeAFE.OEDEhAAAfBAEABBG.MICAhABAIHED..SEADcCGEaBDGhABAWDHH....hACA...,2,-32,-23,9
MeJYTORZDGIBFSgLHbCVNdaXPWEcKUAfQ,QCBCJAFA.OGAEDFDCBDHB.FCFGLFEDHADD.CDFAdBFBhAAAaEGD.XFGDhABA.EADHKBBAAEDFMAIHhACA..TDAF.RGEE.IFADSEEEhAAA.....hADA...,1,-23,-36,13
YcNEBbfKTUMgOFVdIHLaXDSCeZJQWRPAG,GDDD..YEHDNCBF..BAFHKCAGMCGBOFGBdEBDHEAEhAAALCEFaBAHDAHBSGBDhAAAZGCC.QABAhABAWAHHAEIF.cAGA.EHDC..hAEA......hAFA...,1,-22,-27,5
XTDgUSRGLbQYeEdMHcCfWFJNZKaVIPOBA,DGGHSEBDLCHFQDCDeBAH.MEADHEAG.CAAFFEECNDHGZBBChAAAaGEH...VACAhACAODFDBHBBAABAgFDGhADA.RADG..YHAGECCBdAGB.fBHGhAFA..hAGA...,1,-12,-17,5
IZJEaPYHQUOeKNcgRSLTVGADMfCbWBdFX,DFFDCFDBBDCBdBAAFCDHZGFE....EDBDaCBDHGAE..UGCHKAAG..hAAA...NAHARACGLBFBhAAA.GADChACAADIHMEAFWAGB.IEHBJCFFQGGEhABA..ODAH.hACA...,2,-31,-18,13
VNBKfDSGQTgecMaXJAFdZYILCUPEHRObW,dAAAZDEFLEBCUDBDHFCGOFAB..bADGVBAG..KBHHDEGAhAAAQCFCeHCAMIFAhABAJHFAAGCF.FHBC..IAEAhACACAGB.EBHD..NEAEfFFDhACA..SFCBhADA.,1,-10,-23,13
UAWaGfBCHIJQKSROcbDMFdgVeNLZXEPYT,GBBBBDBFCABHHEDH..IGGHKAGAREBB.OAFGDDDG.FFDGdGAAhAAAVDAELFGB.hAAAEBCCTCGH.AICCaACGhABAfDHGSEEEMADANIEH....hABA......hAIA...,1,-10,-30,20
WaLHfUEgIOKQNMbGdXTCZcRPSJFYeBAVD,DBDDaEBFLGEEHEAAEFGF...OABHKHDGQAAEMDFAGADGhAAAdDABCDGGRFAB..SAHHhACAJEEHeCHBBAHHAIHCWEFAhADAUGAH..IAFA.XGCDhAHA.....hAAA...,2,-20,0,20
fNLIQCFUXgHSDZRTAecGPWbdEaOJMYKVB,GEBG..WABGbBAG...dEGAaEEEMEDBKAGD..BHEHLCAEhAAACHHD.UAGHXCDAhAAASCFGDBBC.hABATDAEAHDDeFADPFEFEAEHOEHDJHAAfGHAhACA...hACA...,2,-20,-19,1
OaQBREPfYDMecbVSGLKgAHdJNUXCWZFIT,dHGDJDHH.UFFD..XBAHCBEBZAFB.FGFG..OHCCBBHFEEDFhAAA....fBABhAAADFBHMEABeDDEhABAVDAG.SBECLADDAAIBNIDD...WEFEhABAaACF......hACA.PFAH.,1,-23,-28,5
PGbJadDKFMeOCHcEWTRNfgISVAYQXZLUB,QDAEZDEFBAEHGGBDJHBE.dCBDFEFA..MEAFOADEHBFHEHGChAAARAAE....fECDhAAASCEGAHHG.YDDFhABAXEGAPAHFDIAA.CFHH..WCAChACA......hADA...,2,-31,-12,19
JNUScBWZITEADQGOKPaCLRfFdYHVbXegM,GAEDOBAAKAEDaBAERDFD..FAGGdDBFHFFA..VFDDXDDGhAAAMFIB.JFADUFAD.BCEBhAAAIHEFAABA.DDIHhABACHGA...fCGC.eFCASADChAHAcDAB...hACA...,1,-16,-27,11
RJaTOGCMDBdWHcYVZeLgNAFfSPKUXbIEQ,SAGCKAADUEGE...XFDAEECDQAFFaGHF.OCAEhABAMCBFDDDC.dACGHEABhACAVBGBLFEDhADAAAFFFAAB.fDEFIECG.JBCACGGGBEFBcGFHhAEAeEAD.NIBH...hAEA...,2,-16,-3,13
YUKHAQGdVPcZNbMafgRTOFLSJDWCeIBEX,.GCAGdBBGVEDCZEFCMADE..aBFCRFCDFAHDLAEC.JHDGCDDAeACBhAAABDGA..EGBHUGEEhABA.AHIB.QCCGhAAA.NCICfGGBgCFBSHAGhAHADABE...hAIA...,2,-23,-14,9
RXYKPLBOSaUEVZGJITHfWgCceAdFQMbDN,FDDCMFFADBAERCBB..KDGGLCHH.BAGDaABGUAECZFBCGEFGhAAA..TGDBHBDG.hABA.fCAFhACACEEFABCEdGBGQGGENIBD.PAHDSDAAhADA......hAEA...,1,-20,-21,1
JaSGdbeDOILTVMRZfQNBEcXAgFHPKYUCW,HBGFKHEACADD.aCBEGABGdAFEDFDGLGBG..MIAEREFEZEAGfEGGhAAABGGD.EACEAHIFFDGAhAAAUEAD..SAEHhABAOFHDIDEC.....hAEA......hAGA...,1,-13,-30,17
TWegQXEcUJLPKHFIVAfRaCbDZSBOGdMYN,aFAGCCAADGDCZDFD..BCCBOAADGEEH..MIAG..TAGFhAAAeBECXCCHhAAAUFAFLHDGKHFCFDHDAABCRDBGSAHBhACA.dGCFWAEDEADA....hADA.....cBFHhAFA.,1,-8,-40,32
aLAfXHFZOebMINWdJDCBRVTKQYgPUEScG,HDCAOGBAMBFC..IBEGdCABDDBBREFDKHDAQFAB.hAAA.PAHFEAAGSAEFhACAaDFAACACFDDDZCAEeFDFhADA.NCIA.CHFBBHAF.TFGC.gEAChABA...hAGA...,1,-12,-20,8
DJUYaWeLfgZEFOIPSTGdBCVRbAcXMKQHN,XGGGMDEFHDABDEAAUAAF...aCGGLEDCZDGB.EHACOAEDhABASACGdHADCGHA.hADAbCGBAAGA..KGFDQGDChAAA.NADDYCCCfDCGIBAChABA....hAIA...,2,-27,-17,10
WAJDaFTQcOXBgfVeHCSLURPEGKIYZMdbN,JAEAFBDEQGGE..XDCEBEHHVFAFeBCG.SFGGhAAALDFFPEDBhAAAKGDCZCADMCIB.dHABhABAbBADACADDCGHaACBOHDEfHFBCAFE...hABA......hAEA...,2,-22,-17,5
gMcLCRHaISVYWBXEeFPfNOGTDAJdZKUbQ,dBBEUCBE.QGFEMADDLEBDHCGHaAFBVFCABFEB.eHAAhAAAFGGB....NDICOEEAhAAADEEEADAAKACE.cAGBhABAIAEC.SCFCWEHH.EAHBfFDGhBAA..hBBA...,1,-20,-22,2
NOcELGbMIXUKYPZWTHABFgSdaDQJefVRC,FADCdEBCQBDAeGDGRBEA.OFECEFEELHAAMIAE..XCFFhAAAKHGG.ZCAATFAFhAAAAHIDBAGDaEDGDHDCJBBHCABC.hADA....NBAG.cDGE....hAEA......hAFA...,1,-16,-25,9
MSWOJLBHFGfVZNbYeDEXIQAPaTcKgURCd,aEDATGBH..KHGGUADFdAEB..MFBFOEEHLAAG.BEHGhABAFAHHGDFG.hACAZCBFYECFeEAFDIDAhAAAXAGHAHHA.gBDACFHASDDEhABA..JGEE...hACA...,2,-20,-19,1
ZcNaGADbJBgLMSWPEFQYOCRXUHTdVIKfe,DDDHBDEELADAMFBE..SACAECBHFFFC.ODGBCCED.RAFGUCADhAAAHCGDTFABhAAA.IBAAeFHBcGCGhABANIBF.ABBH..JFAF..WEEF..hABA....PHDChACA..,2,-31,-15,16
JFfNDeBOPdLZRGMEXASCVTKbcIQYaWUHg,VGBEKGBC....bAGBQBEB.aGGDHAAA.JGEGfFEBhAAANIEF.BDDFhABAdEEHRAEFMAEEAEBBSDDFhAAACFBCIDADUCADFBBFDEEEPDHF..hACA......hADA...,2,-18,-15,3
JZbMcSVQTDgFKfUBeWOXPCaGYHLENIRdA,ZGEGMDFASDGH..TADAFACGKCCBfGCBBFEFOBGBhAAAXFFB.CHBCaCCDhAAAHFBFLCADhABANBIAdBAAAEBF.cAGGDAFF.eFEB.....hABAWABH....hADA...,2,-23,-22,1
dgOcCFIbMQUAaeLJHEBZTNGKVYDRWfXSP,aBGFeDAHHEDHEBBCBCDFZACFGAEC.KGACDFDCRGFG.XGBH.hAAAdFGFgBAEhABAOCFGFAEAMCIBAHIFLDEGhAAAJEAENIAF...WBAFSDGDCHGE..hAEAIAHD..hABA...,1,9,-27,36
JRNBgcGdIHAOCXZVUKFSEfDWTYMeLQPba,XCEGVEEE.KGHHECHB..DEBB..TADBMDHFLDCBhAAA.QACBhABAbFACRDAGBHGH.gAAEhACAcGEDdAHAADDAZGBGFFEGfHBFeBFCaGHF.hADANDAG......hAFA...,2,-10,-5,5
UEHcFgKdBXSJZPTGCbAfDVRIQLMNYOaWe,DCEGVEEHQFFG.LBACMFIFODDGeHBEUEADEACBFEAGhAAAKDDABHFH.XGBBhABASEHB.PAHDhAAACAHEADIH.RCAAIHHHNBHEaADF....hABA......hACA...,1,-18,-22,4
UAJXMDgWbLcCFeQHOISEKBZVfaNYTGPdR,JAHHMCDF.DGGC....bGECCCGEFHBC.HGDASABGBEAFZACAhAAA..fDCFhAAA.NEEB.YEEChABATFADdAFCAECD.WFDFeAHBOFFEIHHDhADAECACaACA....hAIA...,1,-25,-26,1
agbUQRdfXeAONZHETMKVBYIPGcDSJWLCF,ZADHTBAGMBHH.KBCHBBFH...PHDEGFAF.DGHHSEGHhAAALBFBCAHEgFDChABAQAACfDAGhACAeEEBAEIF.NDCAEFAD...IDEAhADA.JAHFaGFD..hACA...,2,-27,-10,17
ZCGAFVTSbgJKYHDeNBOWcdPRLaUQEXfIM,FFFCSDDF..bDDCKGGEHGDEDAHHBEFGOACBdBABLBAFhAAAQFABEFAEIHHAhABAMCIBZAEH.ACIBVBDAhADATDAA..JHACNIAD.cDGFaGEC..fADGhAAACAGG...hAEA...,1,-2,-20,18
aKYIVTJLWNSGFAPMOUXcegQfbEZHDCdRB,MACDODDBUGCG..eHCCQBGHEBGEDBBGRCECKHAE..VEFGhAAATEED.LAAFhADANCCC.SBFFhAEAAACEPFAH.gDBA.fGHGhAFA.....hABA...,1,-8,-30,22
AEKbUVTYLHfCcdMDNSOZIXgPFGJeaWBRQ,EADFUCDC...TDGALHEE.CABEMAFCSAAEZCED.XGDAhADAFFBFeAABBGAEhAEAQEGHAAHFKFDCbFBH.hADA.YDDD.fBHCDCCDIAFHhAIA.gGGAhBAA..,2,-26,-19,7
TfWNMVQgFecRHJZLUCEBAaPDIdGSYObXK,DDBAdHFBSGCFOFCB.KFFA..fHFFMBAA.QACFhAAAeAEGHCECLEDGhABAUCABBEEDaEHHIBHFhADA.bAEHWEHB...NEBE.FGAHhAGA......hAHA...,2,-24,-24,0
gPeALDafRTVbIFSXJQUcNWYEKdHGZCOMB,aCCERFFG..TBDE..IGHFFCAFSDHBXDGCJFAFQGAChAAA.UABGhAEAcDDENFAB.EAEGKAHHhAFAdABDZBEDMCCHPHCEAGCFfHEHWGCE.hAGA......hAHA...,1,-13,-16,3
fVLJBHRbMKgcUeITCFaGOXPDZEWNdQYAS,SEAHLAEGJHFCBHEEHFADRCCD..KAEAUDFF.eCDCCCHFFAADaDAGhAAAGEGG.OCFDhAAADDIFEGDF.dACAAHAG..hABA..fFDHMGFG.ICEDhACA.PHBC..hADA...,2,-32,-10,22
UAPcNRLFZSXdbJVaeDfKgMTOQGIBYHWCE,...NHDB.FGDBZBFDdGFC.JBFCeACE.KFCEMBBH..QCBFhAAAGADE..BFAHhAAAWGFECGHDAFDC..RFAFSBAFhABAXGAEaACBDAGA.fCHChAFA......hBCA...,2,-41,-26,15
LbEKHPURSJeYXGCNgVOfaDIAMZFdQWcBT,MAFDdFBEQBEDBBDCLEABEBBB.KBBDHDFG.UGGBREGBJECGXFDHhAAA.CBGB.NICF.hAAAOACF.DIDAAGCFFAGGhABA..WFAD.....cCAChABAPGDA.SDHBhACA.,2,-39,-5,34
VbeXWcNfPQKOMLDJCUEBSHTaYFIdRZgGA,eEACXACF..NBGG.QFDE.MIBALFCBDFIDCDEBUGFGhAAABHHCHCDH.hABAaBBDFBFCdEHGRBBDgFAChAFAAAHFWAHH.fCHCKGAHEADGTFEEhAAA.IBAG.hAGA...,1,-10,-20,10
VLaWdAZDHRecSYbFKTMNICJGPXUEOBgQf,ZBGHDCBGREBHSHFG.FCBETGDF.MDGBIFCAGAEDhAAAUDEGOCDDBGAF.hABAQAAFfACFhACAaADG.AGEA.eHFCcGGF..KHAGCBEEPHAChABA....hAGA...,2,-28,-13,15
KGRCdfTMgScabEHNPBWVYZLXUFOAQeDJI,DDAGJBFEGFBDCEFB..dHFHMCCD..SEBBaAAE.EGAGhAAANBEE.BBBD..VGFGhAAALBFEFEABAIEGeCHFhABAREDFTACF.....cFGBPHAChADA..WDEE..hABA...,2,-43,-11,32
OeCEIaUZMbGYdDfFPcJQXTNgWBRSKAHLV,HGCALADEODDDeCEECFAD.EDEFUCFB.ZACDGCBC.DFFGfAEFhAAAPHCAJAHHXBABhABA.TFGAhACANGEDBAAHKHAGACBHIHHGMIFC....hAAAYAHH..hBGA...,2,-16,-14,2
FdBUVIReaLNAQTZKGOgJMYWDCEbfSHXcP,QAFEZBBBKDFGGDCAOFFF..MBAHDCCECEAAEFGD..SEGEhAAA.XEDBhABAFFADBCHE.IAFEhAAAeFCBNDABABBHJHDG....WAHHHBDAdACBhAFA......hBAA...,2,-26,-21,5
OAIUKWYVTGgZXdBSJLMaNCReQDbFPHcfE,UCGGKECH..VAAATBCHGGDD.ZBEHXBAFBCHB.JFFBaGAChAAA..REBA.DDAAFGADHEFGhADAEAFH.AAID..IEAFhAEA.....WDDBdGDEMAAGhAEACCGD......hAFA...,2,-27,-14,13
fPRaWGAZTbXODeFBELCKUcIMJYQgSVdHN,TFFGOCGHFGBA.BHHDEDFAKAAC.UFBGMDAC..QACAhAFASGGEHAFC.hAAANEIERDDDaBCGAICA.ZAFEDGABeEEHhABALHEAIHAG.JEAE...YHDGhACA...hAGA...,1,-5,-20,15
GcdgAWaPfTNJeXOFZLDCYIQBHbURSKVEM,aFGBTFGH..JABAeADA.FFDDZGAALDDECHEG..IEDChAAAQABA.HEABhAAAUCGHSHDAhABAEBEHMCCD.dAHCAEAA.fEED..OAFGhAEA.DGIFBECGhAEAKFEB...,2,-28,-10,18
JRBbKeEdCNWaOfVUTFZGPDLgQcIHYXMAS,SAAGJFFHBCCE.eDEBdAGF...CGAG.aFBGOGCC.UBGFhABAZDBADGCHQEGEhACAHADDMAAEAAEGRBCHKDAF.EGGBhADANDHG....fBHETEBC.FGDB.hAGA......hAHA...,1,-11,-31,20
VcNCXYLDPdOgUQbIefATaMZKEBSGJRWFH,MFFBEECABCHFGBGARFCA.FCBFHBDG..VFCBCDABLHFE.hAAADGGEdBEBUAAAIGAChABAAAHB.aGGEKGAASBBEhACA.JDDCNIAH.......hADA......hAEA...,1,-13,-29,16
YPbNacATdFfQEIVOGSXJeCMHUWgKDRZLB,TCDHdGCDFDBC..EDFBOCAF.GFBDXFGHeAEC.CHGDMBAChAAAUAEDKAAC.DICCLHCAhABABFCB.PAHFhACAaBHBAAHC.IEHA.SGGEhADAWDAD...RCFF...hAEA...,1,-1,-39,38
AWdCTONUJIBLVPgefZESbKGHYcXaRMQFD,dAECTDEGUFEF.BCBCLAFC.VEBEeDEEZFGDEAAG.KBFEHBAAhAAA.XBGDhABARDACFHGE.DBEBAICG.CEAFOGCEhACAJGAG....IFHB...hADA......hAEA...,2,-35,-8,27
YdLHeEDUgWCRbGTOFSPAJcMaQIKZVBNfX,JCCBaBAG..KDDFZAADBDHA..XEDDdGGFLGBAHGFAeBFGhAAADFGE..UAGHCHDG.RCEE.hAAAbDFG.GEACFDBDAEAB.hABA.MFFHQACD.IAHFhAEAfADH....hACA...,1,1,-31,32
cLGfKZYgBISeCNPVRTHWAEOdUbFaQDMJX,EDFEUBFAFHCCDGAB..MBEG..XGGFLFFHKFECZCBDBEHFhAAAeBAH.CFEG...NCDE.hABAPEHFRDAB..TABEhADAAHHBOAHD.aDDCJHCA..fGAFhAAA.IACFhABA..,1,-8,-40,32
beGKgTfONWQRYLDVdFZAaMIHCPXUcEBSJ,aHBEHDEB.CEBEUBBCBFGH..SADFeADEKHCC...TCBHhAAAOBGFQFAAhABALHFCDAIDdCGAFAFCAABCIGADhAAAXGDF.EEDC.bGFE...fABAhAHA.NAIC..hAGA...,1,-1,-32,31
UAWNXSYKZJgbCaBGedMLfcITDHVQPEORF,XGGASCBHKDBDZGDC...JDEGCGEGBBGGdAFHLCHB.hAAA.IDGADABCQGAAhAAAOBBEFGAGACBF.hAEANIBB.gGGB.aBBA.eDDDMAEChABA.fEEBhACA...,2,-49,-10,39
HGQNLKDUJPWbMBOZFafICYgeERcSdXAVT,TBAFQGCA.KEAHDGHHUFFB..JDBG....WBBEhAAAMAFG.BHCEFCEEaGHDhABACEHBeDFH.EBGCRAGDdDCAhACAAAADHADA...NEEG.......hABA......hACA...,2,-32,-26,6
HBKUYTWDPcNbJaSGCRdAFeVIMQOgXZELf,FEEFVBCAMEID..OFDCZDCBLAAEBDACUDFF..TAGHhAEADAAB...PBDEhAFANEIE..JFAESGGFhAGACHCC.AHHFICBCgGFAEHDGKAFChABAWCFA..aBHF.hAIA...,1,-30,-32,2
dHRJfVLWeIMXTSZEaQKDGBPAUFcYNbgCO,FABH..NDEE.CADCdEFHRFFA....VACCLGCC.eAFHIAAAhACAMIAG..XFAFhAAATDFAEHCE.aFAAhAFADCDBBHHDACEDUGGGcBGH..YAHBhACA..gGADhAGA.,1,-24,-32,8
SRZgFdeAMWIXVKYLBONHGQcJEbTUDCPaf,MEDDXDADKGBHBBCHHAGBGEDC.JFFATEED.CHHH.PBBGhAAA..SAAFhACAgCEDdAHCAADAVGAChABAOHEA.QBEA.cEAGhADA.UEGEDDDDaCABhACA...,2,-24,-8,16
CHegdFbUNIPWcRVJGAaBKfLYXSMZTDQEO,KGEALDDE.SFACMAAFDEEFQAEFECAGHADE.eFAGhABAgGCA.FGFHhAAANAIC.IEED.hACAPBHDcGGF.JHBAAIHAaGADBDBEfABFhABAXDFHZBBACFCH..hADA...,2,-29,5,34
UaBWGegbYXNHOZVPADMKcRSIFdJTELfCQ,DEBBKCDARFFFFGCH..dEAFEABELGBG..CHEAQDFGhAAABCBBeAAA....bBFBNCEHOAEEhADA.ZCCFAFIHMBIBhAAASGGF.IHHGfADChABAWEAD.....hAFA...,1,-28,-36,8
WbReaCFXTOEMYBGgdKNUAJfPLHZQVIDSc,JGECLAEHHEACZADCQCGD.DFGFSBAF..hAAAcEBDbCBA.aCBGCDHAFHCAhABAOHBCMAHFBDADhAAAdGAG.KACAAGIB..fEFBIFHEWEEFhABA.XAGG.hACA...,2,-21,-21,0
PgbYaQDJdfEcHIXWACUZRLFGeVMNBTOSK,UFFDRDFBGBDCMIEABACG..SGACKGBB..PHEAhAAAbBFA.QDAEhABAdBBFfFDAEAHF.IAFEhAAAAGADCDHHFAFG...NAEGTDAD.OHAEhABA.aDFG.DDDB.hADA...,1,-6,-25,19
NebWCDOMgLKEQVZTRAGHFdXIfSaUJcBYP,FBADdBHG..XCBASEBGUECBBAHD....PGFAhAAAbDEACAFF.MDADLCDEhAAAKHAAEABBQFDHhABAZBEHABGH.IHGAfGDEaCCH.....hACA.YEAFWHFADACGhAFA..OEHD,1,-13,-23,10
HGMNTbXfVDPFIURgZJAKWQYeaCdLOcEBS,KEHDQBBFeFAAdCCELAGH.OFFCBDBCSBFHhAAAMIFCTGCAXEDHhABA.DAFBFCEGRGFGJHAAAFAFYEFChAAA.aEBGCADCEHDENABF....fFBChAIA..hBAA...,2,-24,-20,4
eTDdSVYPMNHfabBZgWAUJOLKGRcIXCQEF,OABFKGGFRDGD...XGDECBDFFFCB.DFBGdCAF....SEEGhAAAVBEA.PCEChABAMIBEHDAA.aGABhAAABAHD.gGGC.AGBFLADGhAEAIABAEEEEYCHBhAFA.NIAH,1,-34,-35,1
PLbQYCdXUeJNDWgFZaBERcVGAOMSIfTHK,SGBDTFCD.KEDHLCAD.QCECdHEHUBFBJBBBhAAADFHFFGFDBGGBEBGE.RCBD.hAAA.GABDAFGCOADBhABAMEID.IGAD.fEFFhABA......hACA...,2,-47,-7,40
XDWaHIeUSKRCTgVYPBAbfOJMLZFQNdcGE,OCGDLAHHZADGFCABdEAFEABA..DFEGaDDDHCDC.UGCCREGDCGBG..hAAA...TBADhABAVFEDBBFFAADA.JCCBMIFGhACA.NAIG..XFGAWFAF..SGDDhAAAKHAC...hAFA...,1,-14,-24,10
bMVWQUCOZdNJFTRcYBSKgIELeXfPGHDAa,aHFCVACC..UEGHCDGD.ZEBDdGHG..JBBEFFAC.REDH.BGDC.KAFGhAAAEAAA.LCHBhAAA.eHBGfCDFhABA...PDAFDFGFADDAMCCH..hAFAOAHD...hAGA...,2,-37,-24,13
CbcNRZaVAWIJBEFUKgPdMTQLSDfGeHOXY,JAEBBDEF.FBCGKGADdHFF..MEIHLABF.DGEAeCHFHECAXFFChAAACHCD...hAAA.NAEHZBFHaDABAABDEBHHUGCChACA.TDBG.fBGAODABYDHBhADAcACB...hAGA...,2,-36,-19,17
IMDVdOAETZeXQUYBGcHafCNRSPgWJKFbL,ZEAEXDGAUAEHGEFCHACB..aHCACCAA.SEDA..hAAAPDHFgBFEhABAKGDHFABFIHAD.hAAADGFAODDAAFAATCAFYAHDBDECfAGDhACA.WHFEhAEA...,2,-29,-21,8
fAEbNOaQPMLKRUYTVWXDCBSIJecZFHGgd,EEGHOFCH..QEAHLCCAUBGGTADF..XADFhAAABFDCIABBeGFGFEGFhABAHCEHdFECABDBNCIEMIAGhAAAKCAB.RGEE......YDACDFBF.hACACGBDSAHFhADA...,1,-13,-18,5
SJQDFBKLYegMVCaTdcGfEPNbRWUZHIXAO,SGBADFGBKEEBLDAFeBDH...MHBGaCCBdFHEGBBD.ECFAhAAANACBRAGD...UEEDhAAAIHHAAABDOHECQDGAhABABFBA...YACCCBFG.fAHGhAGA..hAIA...,1,-18,-31,13
IVAWCOGdXLZKPREUfeBQFcaTDJbgHYNMS,ODGFdAECLCADZDCERACC.ECGD..eGCEFGGH..aHCCDDIB.JBAFHFBChAAA.MEFFSHAEhAAA.AFGBCBGCGBBAhABA.KAHDfGHCBDEC....hABA......hACA...,2,-35,-10,25
dVeBSGLFbRYMAUcXOTWKaQZHPNgIEDJCf,UEAFXFACOHFAKEGA.ZACEHDCE.....gBAHhAAADDFGJEEAdBAGBGEELHAGhAAAFCFGRGBCAHIH...WAEEhABAaCHF...NAIECGGCfCDH.SFGAhABA..hACA...,2,-38,-12,26
cOUQXNSFPABGETWbHLgfdCRaVeYZIKJDM,EFDETBGHHACD.LCADdCBDCFBG.RFFFaGACeFFD.ZFCBKBEG.MDEGhAAAOABA.QCEHhAAASBGEAFIDBECFhAFAWEHH.fGGB.IHAFDIAE.hABA......hACA...,2,-19,-14,5
WPcCKTMGeadLgIQBFADObJHUVYXZfENRS,OEECHBCEUGAF..VAFFXEDBZBBE.EABASFAAhAAA..cGFCCCHAKDAFMABAhAFAeDHFdBGALHEChAHAIEABBDDEDAABbFDCYFDF..hABA......hAEA...,1,-14,-17,3
JBNVMZQHAUaOPWgLbYXcSCREKDFIGTdef,OFCH..WEEALBAB.XGDBSGCD.CADARCCEhAAADBGCGGDFTGGEdBGHhABAeEEEBECDMDEAZCADAGAGhACAUACGaDGG.PFAH......hAAA......hABA...,1,-21,-22,1
VOBEYGfIdNSCgeKFXJbTMUZQcWPAaDRLH,aCDGDIGGHCAABHHAGAGAdGAGCCFE...eABFFEHB..JEEHMGEGZABA.hAAAQFAH.hACAPEDERFBFOAFEEAEEIHFDhAAASHDGKDBH......hABA......hADA...,1,-17,-27,10
YMWHUeLDFIRAZKgPCVGTSQbcdEfBXNJOa,ZEEAKFFCCBFBGAEA.SHBAQDBDdCCGEABCBGHA.JCHHaBDDhAAA...MAFEUGEGhAAAeBHDDABFFEAFRGDEAHID..hACA..PBAH.......hADA......hAEA...,2,-27,-22,5
JIPUEBADNOaSgYfZedLFcbMRVCQGKHXWT,DICEaCAH...SAFB..gDBHZGFELDGFbFEH.hAAARDCBCBEFKGAAHABD.TEAHhAAAPEDFBAHDNBAFOCGBhABAfDHA.FBAHMCCE.QGGEhACA.XAFEhADA.,1,-10,-25,15
MceKORWABGIbXJTgQPLVaHfSYdDUFNECZ,BCCEGGBH..XFBBJBCAQEFCLAGHHDAH.SCGBhAAAdFECDCEFFGGDCDDFMAIDhABAeBACKAFF.ODHFhAAAAFIHIHHA..bDAC.....hACA......hADA...,2,-25,-22,3
WVBNdIKSFAYcEXQGPUZfOCMLHRDJebgTa,EFFBQCCCUFCGZBFEOBAG.LHDADEBHeADE..gBEGhAAAaBCABHAD.IFGFhABASABDAGEGYAFChACAXDEA.PFHDCEEAMEAH.JCHHWCAGhAAAdFBBFGBD....hADA...,2,-24,-5,19
UBDKEdZcWHINQagfPOXRMFYSCLVJebGTA,BBBCDFFHKBFGdAHCZBAGHAED.QDGA..gECAhAAAODEHXCAERCDGFGGHCFAG.hABAJGAA.eFGB..hAAATEGCADDFEEAEcGDENAIC..aHAG.PDAChACASABE.hADA...,1,-4,-31,27
NHYcgXRCDIUEOGVBTdLWZQSeJbaFfMAPK,KBCEHBDH...gAGBRFFHCFBDDFDG.EGGHGAEEBDBC.LEAFhAAAQEAB.SFDChAAAeABDaCHHMIAChACAAHEHYCGF.IABC....hADA......hAEA...,2,-31,-25,6
gHFeCKJSbZcWPRBVGQUMEDdTAYLIfNOXa,LCCD..ICCHfDGHOAEFaBFA.FFGF.eAGDhAAAJFAHZDED..cGDHhABAWFHB..BGCAQECDhACAMIEEdCAEACIBXEEFCADHKAAESGFAhADAPDAF.....hADA...,1,-12,-36,24
LKDAFPBfYHSMJONgXUdCVceQZaWGRIETb,FHGABEFBHCADMAEAOFBE..XDDBdFGFCDDE.eHCCQCFDhAAAaBAGRFFA.EAFAbDBHKABBhABA.AAEF...PAHDhAAAfGEASBCANAIG.gBFDhABA.....hADA...,2,-21,-7,14
QGDSMdeYFVBaKLRfOUgEPHINbcCAWTXJZ,XDCHZEGFDIBGdCEDFGCDBGFG..KBAELFBAOEHD..EAGGHAAHhAAA...bAFCABECTBFFhAAAGDABMIFChACAeGEGaCCBRACF..fCHGPDAF.NHAHCFFBJEEAhABA.SADChACA...,2,-22,0,22
JEQVYFTKHRaUNOCBAfZcGbSgILdDMWPeX,ZCBHGBAFSGDHLFCBDGCHMFEH.eCGFJFAB.EGAE.QGGBhAAAFDDFHFGDUDGFhAAACAFCADEG...bAFEIDAEhABA..WADC...PCABhABA...YFFFhACAKAHBaEEFBHAG.,2,-9,-2,7
bdcfWUeKVCNOGTBLFaJIPEXQADRYMHZgS,DDIFMBCDHBFGZAGH.SDAGdFAC..fGGGeEGBCGAHGACChAAALBDGFGDCIEEAhABAXEECRDFG.gAAFhAAAbFBF.cEBD...KADE.hACANIBHOFHFBCBGaAFG.hAIA...,1,-6,-14,8
NaebRXIYACBKFOfQLgHUSPZJWMDVdcEGT,CDHFBECBKAGE.OABGLABAHDGF.UFAAZGCAMCACDIEC..dGDBEFFBhAAAGADH.aBBHRCDDIHHAhACA..hADAADIHFEEGfCFFSCCEJFAF...cGGChAAAeFBE....hAGA...,1,-14,-24,10
JdCBIVXUGMKbRPDATSgFeaHYLQWcOZENf,SGFAeGACHEDHQBCFOEBE.EBADJBBFdAFCBEHD..hAAAIGGDUGBAMAEGhABAKHEGbCFEDEEAABHEFDBDaBEA.hAAA.....YHAGWADD..NCACCGDAhACA......hAIA...,2,-36,4,40
VXEBGgAFTJbHCdPfDLRSaMcKeQYNWUOZI,FGDEJEACHEEACHAD.dHDBDBDHLAFG.RABD.MCBB.KCEGQGGHhAAA.NDDH.UAGAhAAA.IGHHhABAEGAGBADBAFEE....PFBDfBAE.hACAaDGEeADG.OHEEhAFA.ZBBF,2,-29,-19,10
gWIJCeAUFYLOZHMDEQfabRVdGcNBXTSPK,UDCHFBGAOFDGHFEFMFBH..QBACaGGF.VFBDdBCHNADBhAAABFHH..XDFAhABASHEEKGCEICAFhACACHHCAAFCZDEADBFFfAHC..bACBhAAA......hABA...,1,-14,-26,12
GbFTXDIeKdVfaUEcLZOPWQJYgNAMHCBSR,MHAGCADGRCAB.GFDDFGEB.DDCBKGGG..VACEUCGB..LAADhACAZABH.OHFCQFBAhAAAJCGH..NAIGBEEChAFA..TAGDIAGDdEFDEGAB.WAFFhAEAAEDF....SHCAhBBA,1,-11,-34,23
bENeVXIOLWCUDHaRSKgZJcfAPTdYBFMQG,dBDAFEEDMEDHGEAC.EDGGeAAB..IBAFOAFHLFHBhABA.CDDBDECHHFEFSBHDhACAZAFGcGCBAHGA.hADAYCCFBGABNICD.XGGDaAHF...hAEA......hAGA...,1,-7,-25,18
BMDZKgAQICfPVRYFEecXLUdaSWTHbGNJO,QEEDCGGE..fAEERFBFEGHBeAFALFAAdDAB.aABHhAAASDDCHCDFNIEHBDCChACADCACZABC.AFHAPHEChAAAYBHF.FGDEcBGD..WCFHhADA......hAFA...,1,-6,-27,21
XUGOTKZVIBJADWFEPScMaYbfHdNLQeCgR,FFHFSDGCMFBH...aCAG..bABBdFBGLFCFeDDBCHEBRAFEGBDDhAAAKBDG.ZDDHIHHHhAAAAHEAEAFE...PABGhAFAcGGCHFFD..NAIE.XGCDhAHA......hAIA...,1,-9,-13,4
IRaTdcUbENXgDZLYQSBACFVOGfHeMJPWK,VDFAOEFB.HFCBMHCAJAFB..KHGGaCGEdCCD..UDCBEEBF..hAAA.XABDDAHDZAAC.hABALEAFSFDChACAAGGECADC.FBEAeHFC..WEAD....hADA......hAEA...,2,-28,-13,15
SYKbDURBZHWLTMEPXJdVIONAfceCFQGag,eACDQEAGGEAHSDCCKGDHDGIDBBAGHACALFGHECHHXEEChAAAdBGH..OBEBhAAAACGACAHHaBAC..gDGEhABAUGDF.....WAEETGGHhABAMIAC.....hACAPFFBIHAH,2,-12,2,14
fcYMDXBbPOVLgTQRWaNAHIGCEdUKSFeJZ,HCDDCACHUGBEKAFG.eABFZAEE.....fCGCMDDEDFGBBBHHhAAAOEACLEHFhABAQFGB.aHACNFAD.AADFEGCAhAAA.dHEDJHDC...XCAA.hABA......hAEA...,1,-12,-37,25
JDCdNLETcPUHYgBIWQSMVRaKebGFfXOAZ,ZABACAFHLBBHEGHB..TGDDUGCEHFGDBFGF.QBDChAAAMCFCaDCD.KDFDGEAEFBHB.hABAOAFAJFAHDACCdCAB.hAFANEEH............hAHA......hAIA...,1,-11,-22,11
fgcCVDGBZYbMIRTNALSJeUXKFPHaQEdOW,SHDGJFFF.UBFGKGCAHBGF.EFBAdEFD.OEBE.hAAA.WCEFfCAAhAAACDBBGABFBGEC.YFAFhABAIHAFTACAAAEGLCADXCCAhACAaAGGcEGHDHGAMCID.hABA...,1,-13,-30,17
MDedARLBVWbEHaXJfYCQPOgSKcZIUTFNG,BECCVBCD.EBBHHCFC..aAFDXGBB.JFGBCAEFQGFChAAA.OBHBhABAKAAAIAHFUDDCNDACDIAAhACAAAGDWEFF..bFBGYCABSFHBcADFhAAA.....hADA...,2,-25,-20,5
IKJgQNYEHZMRcFCLDOPdfSbUTBWGXAVea,eDCAKHACQAEAEHCCHBADRAEGFDFE..CHFDDFCHdGHG..SDDHhAAAUEGCBHAFGBAAAFFA.hAAAIFFG..hABA.NICBMAIFcBGEOACDPABG...hACA......hAEA...,2,-19,-17,2
WNZdQTOKfPGMcgAeRICVBSELaJFDUbHXY,RDBDVCCFBDGH.LCBCFFBB.DCABUFEEHFFA..XAFChAAA..NIBBdAFGODHDhABAKEED...fGGBhACAMHACAAIHCHHE.aHDCJAAAWBBE.....hADA......hAEA...,2,-27,-24,3
XJQgMTLFUYAVBNKZOIWGfdCeHSbEacPDR,BBBCKFBBZDFCOHDCGAABdBGAHAFD.EDCBaADH..DIDAREEGQEAChAAAMFGBLDDBFHACAEGChABA..IHHFhAAA.CEAGSBHHcCEGPFHF.JCCF.hABA......hADA...,2,-18,-13,5
RKbfBJdHNGDgYIEOUPaFAXZLVCecQWMTS,XFDGZBDECEEF..eBBFQCBA.MFBBTGEDRBEEKFHHBHHDhAAAdAAGHEECDCHDIAHFhABAOADG..PHDEhACAAFBELGAE.cEGCSCHH.hACAfAGHJADE.hADA...,1,1,-34,35
AUXNFICceWSBaLdYHbMgOVGPQETRfJDKZ,XEFFFEAFCHAF..eDCCBBGGLFCDHEDFMFCH.OACFhAAAPFEDEAEB.RBAHDFIBKABHAIGAhAAA.UAGEIGAChABASDHFdHFH...gADB.hACA......hAFA...,1,-15,-27,12
dZMabPIVDOfNERHGKLTSeCXUQcBYgJFWA,MBBGaFED....IFACDCEGOEADEBBF.REECKHDCLCHB.hAAATDCCCDECUGGCBCFChAAA..JDCBAGDEZADE.hABAPHBCNAEH.SGFHXCAC...hACA.....YCHHhADA,1,-30,-32,2
GDBLICZFHMbdgPeVNKXUJRTScWQYAfEaO,aAEFDACDBDCGLBBAZFDH.HDBDdAED...PGFGeFFDKGCH..hAAAXBGAUCGERFAF.cDFAhAAA...WHBAhABAAHHC..EBDB.OBAHIACDCCFG.FEDEhAGA.MIFC...hABA...,1,1,-34,35
WfOBYQRDSVXdZNFCGbMLTaJEIHKcPgeAU,UEAEOBDFBHCBRBGF.DEDE..SACFdADGZDGB.CFAGGFDHhAAALAFEJBABHGEE.KBAFhAAAPHAEAHBH...hABAfDBA..YCDG.hABA......hAEA...,2,-32,-31,1
gKeDAEYIXNSRFUJdaWCbGOcVMTLfHBPZQ,EGCCXGCERCED.UDDFdACBCEHA..GABFOAGFMCGB.TCAEhAAAHBAABGFC.ZFAFhAAAgFACDGAHAECF.hABAYBHHIGHCFHFC.WDGH...hAFA......hAGA...,2,-28,-5,23
ZGeSAEQBYNaCFKWIgJMDHURcPdTOfbLVX,EAFHBFBE.aBGHFBGE.KADB....IHADMDCHDFAFHABBREFC.hAAAdFFFODEGLFDHhAAAZGEE.SBDBhABAABCH..NBBE.CHHHWDAGJHAG......hADAPDDHfAGDhAEA.XDGE.,2,-24,-19,5
BWRUMCXLTVOaZIegGFNQSfYKEHcbAJDdP,DAGHBDAFUCFHMFDDLFAD..TFAAOACGZAFB.eFFChAAAFECE.QCCBhABA.SBBChACAYBBBKEHHEGEB.HFFDAEFAJAHDWHBECHHH...aAAHhABA.IHHF.hADA...,2,-24,-19,5
XVcOYZeJfHMNECSRIWQKdbGFTgDBLPaUA,VFEDOHAC.ZEEAeCFAHBED..EADHCDADRBCDQBAA.dAGDhAAAFFAADFAFBHHCLECBhABAaBAGAGAB....XGEHhAAA.JCHFMFBF.NDIASEFEhACA.KHGG..hADA...,1,-10,-23,13
cDBWUgLTfGbIeJPHVKaQAEXCRFdOYSZMN,XFFFCCHAdBAC..OFEFSCBAZEAE.MAFFDDCEBGAA.hAAA.gAGEhABALEEEGAEDIDHH.hAAAeFHF.JABE.PGCGKGDFAEIB.FEBAcGGChABAWHCG...fCEDhACA,1,-27,-34,7
VYWEDILeJgZUAKGFHcCdbQaRBTPNSMXOf,KGBEGDAAHDDFdABCaFGGRFCGBEEB..TAEASHFC.MDCAhAAAOBHD.VAAHhAAAEHBCLAHHeHAGZGEEAADGhACACAGGQADAXAGFfDCADIGA.hADA......hBAA...,1,1,-17,18
GYCAIeQBVRJFPOWKSETcXNaZHgbfLDUMd,eABFVABC.FDDH..ODHHSAFC.EFGDXAGE.hAAAaECBHBFE.bFEDDFFFhAAAdDADCFDDAGAHIHBDhABABEABPCDETDGCNIDH..ZEFHgACHhAIA..fBAGhABA..,1,-11,-19,8
LGJcDfMPHQdSAFIVUZCYgETNRXOKWeBab,FBCHUAAFCGAE.ECFB..RDFC.KCDDBEDGLGAEGGDFDHEG..MACAhAAAQDAD.AIDE.hABAIBFBZADA..hABATEGDOECH.aGGAcEEC.PBHDhAEAdAHCSBDBhAGA...,2,-36,-15,21
RCceFIUbHLEMaOJWdfXGYPQZTgKNDVBSA,RBFACCFCFACHUFBD.HFFHLEDG..ECAEaBGAODCE.dHADGGAHhAAAQABFTGGBhABAKAEADAEHBHECAFAHIDAGhADAMFID.......fDGBhAFA....hAGA...,1,-14,-34,20
KEGZRbQLeSDJCWaFgYAMPfTUdVNOIBHcX,MBIHTFABUAEB..VADFODDG.BDAFXBAEGEGEREEGLDHBhAAADFEE.JGCGhABACAACFBBGAAIF.dFAEIDAHhACAKFCHEGEE.ZAFD...eHECaHCC...hACA......hADA...,2,-24,1,25
UgOXEVYBadeJcWCFSZKDNGbIAMRfHTQPL,MDFFRDECHABE.QAFELDHBUFAGOFGHEBEGBECB.dAACeBBEhAAAJDAB.CBAGZGDCKFDADIDChADAGCADACDD..fFHGhAEAgAGB....YHBEhAFA.WAHHNIAHIHHEhABA..,1,-5,-16,11
PFYIeHXVJBDgTcEMCURbNOAfLZGKQWSda,LCCDKADCQGEBdBHAaDADFEEC..eFEGHBFH.JBBCDBCE.TGDHhAAAMBIDUFBB.hABA.NEDBAGIDZFGD.SCAGhAAAIGAHBGCC.EHFCCDDFOHAEhABA..WAEH..hACA...,2,-29,-7,22
YTRBWSgAfDGHJNUQXecIdPZFCEKMbVaOL,DCCEJEAH.UGGE..XFECeGBE.dGCGFDFH.KBFEMEDC..hAAAaFABLCEG.hAAARABBBFHFSCHDhABAADACfHEFNIBB.IHHFCEDFEACAOCAChACAWAHB......hAFA...,2,-34,-29,5
NDeMdBabPIcGRXQAUVESJLgZYCfOFKWHT,EBEEJHAGLEFBZFDE..CDDHFCAFHBACDDIHdECB.aABA....hAAAbGEEICGF.hAAARAEHAFFHSGAChABA.gBBBfAGDKHBGNIEFBEHH.hACAPEAHcDFA..hADA...,2,-38,-10,28
NMALHeGKgVBaUEfPCJIdZWFcSQTODRYXb,LDCGHFCCeCEGKGCDBCBAUBEFEEEE.CEBG.JHDGdABB.ZGAAFEAFQAFBhAAA.DFHDXAAChABAMIFC.AGFGGDGEhACA...aAHD..fDCFhAEAIHACSADChAGA..,2,-24,-19,5
NCbXBADcMaLQWIFVPJgGRZYUHSOedfEKT,MGBGaEHBLFAG..IBFAFAAAJEED.RABDUGFEHCFHSGGAhADAOCHB.dCCAfBAGhAAAKADH.NHAD.hABACHBGBCHEAADH.DBFGWEAG...PCEHhAEA.....hAFA...,1,-22,-25,3
BHOeGCZIMbgPQNAKcWULXVTEDSaFdYfRJ,KABAUCECLCGF..XACBEFCADGHDFFEDdGACRGDA.BAACeAEGhAAAZDGD..MCCA.hAFA.PCCBACIHVDACaAEEhAHAJHAE...........hAIA......hBBA...,1,-25,-33,8
dcgYUQOIANJHMBDFCWVReXLfGSbaPKZTE,JABGHGDCBEHECDDFRDGHLAAH..SFBDaFCB.KFCAEACHhACAdCCF....YBEChAEAUGGCOEEEhAAAIHAEAAFFMCFCDEEE.FBAHWAFE..eHDChABAfFDH..hBAA...,2,-32,-29,3
WNVZCKgHXDLUGTdJQFeabIYESMcBPORAf,...fCFHVCFDKAADHDCHDFGGLAEAUADHdHBBFEDF.eBADhAAAaAGG...IHHDhABAECBFMCIHBCDB.PHDAhACAAHIFNEAG.CGAC.XFFA....hABA......hACA...,1,-19,-21,2
OVdNIXAcEFgfCPRUGQJMeZYDTLWbHSaBK,FDGBCCECRDAC.QECH..eGBGZCCCDAECTFFCLHCCHCFCBHHDhAAAKFGBdAAG.XAGEhACAABAAEACC..fAFBhABAPBDC..JDAFMICA.WCAESGHHhADAaFHF...hACA...,1,-11,-26,15
HGXFDQYJOgZcILCRWAKaBPMUNVETfebSd,BAEHMFCBUBEDEBBA..eHBAdEEEHGFCFCDADDACQCAB.hAAAOFADgBGFhABAIEHCCEFCAGHH..KGACaAAChABA...NAEF.fEADSFDDXGFDhACA.JDDF.cDGEhADAWBCH,2,-39,-24,15
bLfVeOZASUDPJIGWEBXQTMHYFRadgCcNK,SEBADGAB..PEEEJCCCGEGEEBDG.BHCA.QBGChAAAHGBERAADdBGHCDBCKEEFhABALDEC.fEAHhAAAeGACAACG.IGHCWABATGEGMAEGaDCFhACA.NIEH....hAFA...,2,-27,-6,21
KXTeVLSCFMIdWfABZgHbEGUORaDPYQNJc,BADBHFDCECGBUGGEOAAGRCED..DDCDQDDG.NAEF.JBHHhAAAKDBFeCAH.LGCAhABACHBBFHGEMBCA..hBAAIHAFWCCEAGHE...ZCCH....hACA......hAFA...,2,-37,-11,26
RaUXVOEcHSFZeMPBKTALIDJYGdQbgNWfC,DDGHGBCBQFGD..bFAE..NCCB.fDBAREDB.hAAAaHEGVFAGOAADHCAAhABAZEECMIDEBHACKAFGAHHDJAEChAAAdACBCDHBECHF..SAHB..hAFA......hBAA...,2,-12,-7,5
eCHcBgUSXJGTLZOPAKWYFIEMDNabRVQfd,KCBGFEBFMBADDBEF....aFEHREDEQGGF.dBBGeFCHhAAACCCEBGAFUAGH.XGGBhABATGCGZAFCAFBB..hAAAIACDEEGE.bDCA...HCGF.hABA..SEAFhAEA..,1,-23,-24,1
bRJBEAdMUCcZQNTHDaFGXfYSWgVKIPOLe,MECCCAFBZDDC...TFGDHEAGDBAH.FGDDXAED.SDFHhAAAVFGH.IABHhADAOBCE.eBHHbAGHBCBDhAAAAGABUGBG.NIEFfADC.WCCGhAGA.....hABA...,1,-9,-35,26
KDaWPHbCQVINORGZJXLeBTSUgFAEYdfMc,dEAFMDHDKHCGDEBG..aFFCHEEB.CHBB.QAGG..ICBHhAAARABCJHFA.LAFChABABEGFSDDHhAAAFADDAHHAEGCE...fGBFcBFD.WCAGhABA......hACA...,2,-41,-29,12
UgWbVeJYNBTdDMEfOXGcIKSHLCAPQZaRF,QDGDZFBFRDBEFGFD.UCBE....bBCAVFBH.eEEHJEHFBDHBhAAAdDACEGGF.XDDFhAAA..ICAHhABAKACESAGGCHAHAFFBaAFF......hABAYABGDIDE.fAHEhACA,1,-18,-34,16
IUaLBgESeYbfWNJKdZRGMTDHAQFPXCcOV,FBCEXBGCCHGD..OFFGUFAELGFA.ECDCSDFChAAAeBBA..fDGFhAAAJHCCKEAFdAHAZFDBMDAGhABADDACABBCQGAA...cABBhAEAaAGABAEB...hAFA...,2,-39,-12,27
ZUgMeaQHbfCdYGWXTRKNDAEVIFcPLOSJB,EACHFFCGLBGF.OADHBBAEgBGC.eGAChAAAQBABHDDDfFFFhABACDEEdHCB.WFHHhACATFFE.NEAAAHHEIHDD.PAEGhAIASHFG...hBEA...,1,-26,-30,4
TZXMVHSBDNbKRAJaeUGLPICEcFWgdYQfO,eCHFGBCELAABCBBBFFEF.dGCA.QCDHTAGB.ZCBDXEAAhAAAHGFCBACC.NAGCKFAFhAEAAGAGJDGH.UAEAEHAC.hAFA...gEEGOBAHMICADEIB.aGGEhABA......hACA...,1,11,-23,34
ORgZeHPDVQbMAFcBfGWKJINXaUESLCYTd,FBAHBDEFGDEGKAGA..JFEDXCFB.UFBBLABD.hAAACCGHdADDgAGEhABA.HDBEPGAADEHD.hACAQGGFAAEAcGGEWBBEaDCD...ECCEhADA..SDHHhAAA..,1,-12,-39,27
OBSGPJTWZeYaHDFdXMcbKNgUAIfVRQLEC,VCDEQCDG.CBEBBGDFSEBB.JABDTCBG.eFFHhAAAaHFADAHDdEFBXGADhABAMFFCKGAF.UAGGADAD.hAAAIACB.REAGEHGAOHDC...hAEA......hAFA...,2,-37,-10,27
fPRJDaegNHcCKFGMUBIVXbAEOSdWTZLYQ,SFBEdCEHZDAEQGFCRBAE.DAADaCEB.eFHDHADG.KCHHMHCGhAAAUGADBGFB.IEFFhABAXEFAbDACABBDECBChABA..TBGFLEEFfGAGhACA......hADA...,2,-24,-7,17
NQSdZYFITDJgWcRULeaGMKPEOBHbVCAfX,XEDESEBFdHAFZECG.FGFHDDAH..JACC....cGDHhAAALCHDGABAKCDFEBBFhAAAHEGFCAFE.ABDEfCGFhABAQGCEIHHEWBFC....hABA......hAHA...,1,-19,-30,11
UbeAFTQSJMZaXcHWRKGDNBOYIdEVfCLgP,FEAHQCAGMIDGZADHaGGA..HCACKDHDGDEADHCCBABA.OEGFhAAAIGAG.EFCECHBDLAHFhABAUCCAACGBJAACXEEHhAFARAFE..NICD.......hADA......hAEA...,2,-21,-11,10
WMHAbKTYUCDZfXePSJNIOGgdcFQBaVERL,TEDHUDEADCGG.ZAFEeBED...JAAHOHFEdCCAFGAFBDCHEHEC.hABALCAHHCGHAADAKGCBhACACEGE....XGAChAAASFGG.IAFAgABG.hAHAaGGG...WAEChACA...,1,-9,-47,38
bIFdXaDSgcYMWeREHKLTBQOJZPCANUGVf,GEBBVCFG...IBEEdAEGaCBFDICESAAB...hAAA.gFFBhABAMHFEWACDeDADRGAG.EEDCKFGChADABBHEQCGCOHAGZACHAAEC..fAGHhAGA.XGDHhBAA.,2,-28,-13,15
WFECQSNMVROHdgTGXIUDbJZKeAPfcLYBa,...fBEBLDGHBAHFFECB.CEFFQCBHSDGDNHAFVGAEhAAA..OACBhAAAHADETFDCIHGHDDIDhABAbFFCKGHHAIAA..PDAFcABGaAGAECEA.MFAGhAFA.....hABA...,1,-2,-27,25
PMOfgIHQcCEXTNRaGbYLADSdUWBKZVeFJ,DCBCSFFAdFEDUCGCBDEA.ZADEFHACMAAH..OADC.hABA.IHCGHDAACFHGEFCHhAAATCBA.NAIGREAGaAFAhABA....bGFEAACEKCDGeBGF....hACA......hADA...,2,-30,-22,8
RPeAbLcMBWJZOYUXETSQCIVDKFHdafGgN,LDBGBFHAJFEE.ODHB.UBAFEDEEQFAH.CECC.hAAAIGEG.DAFBhAAAKBBEFAHFdCAAaGAAfADDhABA.NCDD.eEFBAIDA...MFDHhABAYHECSEAGhACA...,2,-35,-35,0
aCbXALBKNRIHGYegJUPdTFcQZMVWSfEOD,BAABKFCGRCEFHBBFeBFAUFFAdAHC..FHECQCBD.MIFGhACASGAF.fAFEhAAADFBBaGAHXADGhAEAAADELDHFGEDE.YDFCgGGGhABA.....hAFA...,2,-24,-18,6
AdBUONebFPSCaHWgKIEVTcMRfJDLGYZXQ,BBGFODCDeFGHFBFB.CFCF.HCAF.KGFEVAAB..MBHHRFDEDECALEEFhAAA.ZGACABEDdHCBhAAANABF.SAGEhACA.aCDEIHHDEEAF...fBBDhAGA...hADA...,2,-33,-18,15
KJQGdXcWOYTMaDfgVeLSRZPNHBEUbCIFA,KFAAQAAEdBEB..XEEFOFDBTADCDIGA...gBGFhAAALCCASEHDhAAAPFABBHGAEACChABAUCDBCDHEAHCG.JFFC..WAFEMCIB.aHEGfCAAhACA.eGDGhBAA..,2,-27,-15,12
NScTVAegUFWbZLYDGPRIJKQCfBXdEaHMO,eCEHUCAHFGFHZGDALBBDGCFE.RBGHKGACCBHF..BFBCdCCDEADGHFCDhAAA...MBBESEGDhAAA..cAFBhABAAHHE..WCADDDEBIHHG.hABA..fEHAhACAaHAC..,2,-27,-25,2
QHJCSfFbgXGZPTcVNeBARMIDYWLEOaUdK,MEFCDDBCLEGH.EACCaDCB.KHAEQFAFCAED.SECEhAAAFGFBXABGZBBATFEDhABAVBFA.BBFAhACAAFDA.IAHCODAD...dHCHfHGHhAAA....hACA...,2,-40,-9,31
MOWNQbXKSCEUVADGeYHPLcaTZgfdBIRJF,DHBCeBFHHBGFLHECaDAH.ZCAAdEEBBHCHRBCF.FABBMACC.OFDEhAAAQDGA.KAEFhAAASBEECFFCEAHHAGIHGFAHhADAPHFC.TBAAIHAA..NIAD.hABA......hAGA...,2,-18,-8,10
OJIScDTZQYXWHbERVMKFLedgCBUGfNaPA,OBCCSEFDDFFCZEADQDGA..XAFBHAEBRBBDMHAEhAAAKAAGFGHBeDAF.dEDChABABCHGfBGDhACAaGDBAEID.cGFETDDF.......hADA..WDAC.EDFGhAAA...,2,-41,8,49
ZABMVESFOHDgabINWcYUTQLdfCeXRPKGJ,VEEESAFA.OECEDCCE..aBGC..bBFA..NHEB..hAAA...YEBFhABATFCGdAABCBCGeCAGPDBGhADAKFGEJHDCBEACMEAHEGAG.gGGGhACA...cCEChADA...,2,-31,-18,13
DXdcUeGCAgWaTZEbPQHMLSfJVKOIYNFBR,aCAETAFBZDDB...EBEBQAGALGECJBACKFAA..OABChAAAIDDEFHDABGGD.hAAADFFAXFAFdEABeDFAhABAAHDBgDGB...WAHB.hADA......hAEA...,2,-23,-19,4
UDeTFYcZMIKRdbHOBGNAfQSLPCEVgaJWX,SEFDLHEACEBB.EBEH..aGHF..JGBEUGBCDEBF.FAACZAAFMEEChACAKHGAdAGG.OACFhACABCCBAAFA.QBFHhADAPDFA...WFFC...XBDBhAEA....hAHA...,1,-30,-33,3
eDLIZXOHaFMRVKbJPCAQYEdNgcTWBUGfS,QCDBEEBFdHAD....NDGC.gGBD.TAGFhAAAWFDBGBBDfEAFhABAeDAFLFFHZCGHOADAhAAAaFHBFAEBMFFFKGEF...JDFGAHHHBBAFhABADBBHIACG..hAGA...,1,-6,-12,6
LcTJFKeQgRCVMNabXAHGPDYZOEWdSBIfU,HAAFGECADFFGZBAAOADFEFFC..dHEBBBGCUAGHLHEE.hAAATFCBKFAEQCEHhABACFAHMAFC.aADEAGID..hACAPDECSHAEICHFfDAHhADAFDCB......hAEA...,2,-17,-15,2
JLMgTcaRQBIAbNdfECWOGFXYSVDKUPeHZ,dEGFCHEBGBEDFFBC..SHBAKEBBUGGDHDDELAEA.MDEGhAAATBBF..aHGABGADhAAAACHE...fDHChABAWEEH.YAFCDCCBeABF.JDDH.hACA......hADA...,1,-25,-30,5
KTbegDWQMIBCOafAcYXHJLUPZGVEdNFRS,XAAHHCDEUEFFZCFHEDAB..FFEDRAAFKDCDeFBC..DGBFMEBGBCHHhAAACHGA...aAGGAEAFJAHFhAAAGGEBdADF..SGADhACATFCC....WHCGICDGhAGA.fDHEhAIA...,2,-28,-13,15
ceKdYMWTFCIAOfUZLQPJaRVGbXgSHENBD,OGFGZGEGLEBC.JACHaDEF.RBFCGFAB..bFAEXBAGhAAASAADHDAEBHBGhABAeHDEKEGEMIAAFAEBAIGChADA..fAFH..PCFChAGA...EFEADBBE.hAHA...,1,-2,-23,21
LCBFIRKQEYgMecTHVSaJbfGOAXdWDNPZU,XDABdFAGDIEAZECCLEHBBHHD..FDEGKGBF.EACD..MACHhAAATFEAHAEE..SDEGhAAAJEGD.fAEDhABAOADHNDIE.CCFCIAHD.YHDAhADAgGCF.hAGA..eBAD,2,-31,-24,7
SfTXWDLKPcdZEHeGFOQUaNIMBCYbJVAgR,SGDBTDAH.DGFGKBBE.dHBDHCAGFGECUGGGaEDG..IBFDhAAAMFDCBGCC.CAAF.hACAJHAC.AEBHRABG.fGHChABA.WBGHPBGB.cCDEhADA.eADH.OAHFhAFANAIA..,2,-31,-18,13
DCfYVELWPFeGQcNRMTaZBIgAKSJdObUXH,JFEBdFDDUBFCHBDBDEFE..CCBH...VBFCLAAE.FEHHQFBChAAARGFG.MACFhABAaHAGBEFEAAFCKHGCSDBGhADAOEAG..XADHYDHB.hAFAWHAAPHCC..hAGA...,1,-17,-35,18
QfAZPLCbadgESNGIHeFRDYMXVBKUWJcOT,ZFCECEGCdCADSBEEGFCHHDBCRCDH..DBAFMIAEBAAEKAHB.UAEBhAAAJDAD...OHFAhABAQGFEADHE.LAHDhACAaFAGEABH.ICCH...FGAD.hADA..YEHHhADA...,2,-30,-9,21
JMTYPaGVfZgBceOAWERFHXIKQCNSULdbD,EFGAFBEBHDCHKECC.CDAH.UBGHdAGA..DFAHJCCG..MIBA..TGAFhAAAaBHD..VEFChAAAZFEBBADH.eBABhABAAGBAXABB.IHHCSFAC.hAEA......hAFA...,2,-32,-30,2
YVdLWORTeNAcIUPFfSXEaBKJHgbGCQMDZ,UFEBFFBE..SAEHaCBFBFHH.HEFFGDDBMCIDZBFCdBBELFAChAAAOHCCeABE.hABAAAHH.PGACEEAHKDEDJABEhAFACHHADCHD..WHFGNAAC.....fBDAhAGA..hAHA...,2,-26,-7,19
FWRTafXGdQBCeSIPUDOKJNEMbYHgLZAcV,FCGFTCED..aEADGACAdFCGBCCDCBFEeBBD....SGFAhAAAUFGDOEBHKDEGEAFChABAMAADHADFLAEChABAACIF.WCHFfFFFIGEDDFIDNIAD..hACA......hADA...,2,-34,-4,30
GfEYOVDBNeFSQRbIKXUHJZWPMcCATagLd,aDFFLFBGGGABECFH..OBDGDIDAeGFCQEDERABB.IDCHhAAAKHACHADEJBAAPBABhAAAMEIH.AHHFdDHCfGGChABABDDESAGBXAGB..WCADhACACFFF......hADA...,2,-19,-5,14
GCBbRDMWaLgfSKdTEeIcZUOFXNJAVYQHP,QGGAHGECCBCHRECG.MFCCLCAB.SBGGKDDGEHAEIDGDhAAA.ZFDGFCEDJCBBhABAAHAHVDGFGADDDBAGaBGEhACAfHBH.eAEC....hAAA......hABA...,1,-9,-18,9
bYFEUTcWGVeXgNRSJdPaQDLIZHOKBMACf,CFGG..fEGDFAFHUGAH...TEACGABCXAAARGEG.hAAAJEDCdBACQGBEhAAADEDGZEAC.OBDGMBIFADDChABAYHDC..EEGGcAGF.WCEAhABA.gGGBhADASBGH.,2,-30,3,33
TOZHQSDMegKALWRJBYVXcGdECaIPFbUfN,LDAARDADBGDD.XCGFdADBEBAH...aFBAFFFB.UAGC..hAAATBAFOCCAQFEBhAAADDID.MDIFhABAeHFAKHBEJDEGYAFE.cCDFCGBA.hABAIHGC..hACA...,1,-25,-28,3
ZYOfPMcIFBEAbWdGeVXTCHSgNaDQKJRUL,dCEHVEFGCEFDHEGB..SCFFaHDA.QDBGRCADLABAhAAAZAACOAHHMBEHIBHGhABABFCCACCE.WHDAhACAXGAD..TGBFDAFB.KFAD..hADA......hAEA...,2,-21,-21,0
HNWCPUQLcZYTEAVbSOMXIdDfKRgeJBaFG,VCCDSBDE.OCBDMCFDdCHE.DAGFRFEDJHBABDAH.FFADHDGFhAAA.CEDBUBGDLGFEhAAAZFAEEBAHAABC..IADBhAFA.fHDD..eDDEhABAaHAE.NAEB....hAHA...,2,-38,-4,34
JQRUcNeFbWLCVBOdTMPZIaYHGgEfAXDKS,DAGBJGEG.QCGAUEAH..eADFFEDFLFADBCBE.TCAChAAAMAADZBEG..IHFAhABAaCHDHGAAgCEDhACAEDFCAFDD.SEBH.RACCcFFAhADAWFFECHHE.OHBGhAFA...,1,-19,-25,6
FZUWgLTIcCYXefbNPaBAORVQHMSKEGJdD,RBDGHBDEKEGGGEABJBAEFFHD.ZABF..UGEFLHAG..IHAEhAAACBHDeFFB....hABAfAAEPDACAFDBOCHHhACA.MBFEEGEBDAGE..TEEDhADA.XFAAhAEAaADGBGBD.SDGE,1,-10,-25,15
OgKfLNUTZFQPJWHdAXGDEYVcbCaBSIReM,XCCHDAFHEDCG....VDGHCACGBHCHRDAB.MGDEKHCA.LBGHhAAAUAGDZADFFHGC.JBABdAADhABAAHAD..GBEC.hAHA.cGGCSEAHIFEDOEHF.hBDA......hCAA...,1,-19,-25,6
OYZMLAKagBHTCQNGeJRUPfDbdIScFWXEV,aBFEBGECHFBACDADGABGRACC..UFGCDGCDdDFBSAAD.FGEDhABAEFHD.OEFFMIAAKDFGhACAQAGEeDAE.hADAJFAB...fAAA.IEDAhAAAXDDH...hADA...,1,-7,-38,31
bSQTMKVZLOUIeJcdCYNPgRaWXDEBAfFGH,GBGCHDFFQAECMBEHKACBZEABLEDH.OCAFeGFAdEFAhAAACHHENBAF.RFCHaBAB.DIEABCDDhAAAABIH.bAGB..SAEEhABA........hACA......hAHA...,2,-16,-14,2
PCVWbSdZFHJABQXgGIKDfaeLYNTOMURcE,QFBFXBEAGEBBKFFCDIDC..eHEALADD.TBAGhAAAMBCERGAG.PBADhAAAVAEF.SFHBhABAZAGBFGHBAABG.ICCCaGECNBIE.OEEA.EAGE.hAGA.WEEC...hACA...,1,-6,-11,5
BTbXeUWfEDZYScVLOIKGdMgQaRCFNJAPH,BDADXCAFUBGD..EFHFZDEA..SAECLBCBKBAGMFBHhAAAQFCEaDGH.hABACHGF.JCDFHFABeFDDDGFDhAAAcAFEOAFA..dCHE.RFEDAADF...hABA......hACA...,2,-27,-2,25
SMTZGRENIKAXPaYJfQWVeUCFODbHcdLBg,XCAEaCDA..JEHHQGFD.eBFFFBFAbEBCdBBFBEHAhAAAMACE.TFADGGDDhAAARECCICHGACBB.hABAfAEAWDDACHABDCIH..LHAAhABASBBB....hAGA...,1,3,-31,34
cPGJeUWZagSBDIHAMCXdNYbEOVTRfFQKL,XEECdGDC..NBIE.ECGB..OCADVCAE.RCDF.FHCCLACDhAAAGABFeFHDUAFEaGGBhABABFAA.IAHDhAAAAHHCCHBA.TGEEKDFH....cFBG.hABA......hACA...,1,-15,-22,7
OaKQeEDTcLRCYWXHfAVJZgNdGFUMBbIPS,JEADZDEGdBAGGCAFFBFFBAHC....IACGOECFKGAFQFEDhAAA.DAEDTGFAhAAALCGB.CHAHXFCBhABAACED.NCIA.MEIBSHGAhAFAaFFAEFAG....cBCBhABA..,1,-28,-36,8
BeRMOIdJQGUVScAKgfZNTECXWDLbYHFPa,KECDZEFEEHGCCAFF..DGDDLABG.HCCGFHGABHACMHDEIHBChAAAdBAHGDDH..SBFChACAACDA.fDAGhADATBFHXEGEWGAC....hAAA.PDADaCFD..hABA...,2,-49,-7,42
SVEAIFJaQRWXcHMYKgTedDUGCOLNPfbBZ,FAGFQAAARBEB..XABHHBDCMBIBKEGC.TGBC.DAGChAAAUDBACHEDLFGDhADA.fEBChAEABEDESFGDAEFGIDDEWEAD...cGCEhAAA.....hAFA...,2,-45,-15,30
MeQXISCKURBVFDaGPLdOgAJcYZEfHTWbN,JEBAZDCFEAGHHCGF....TEEA..bACFMDHBeHBCIHCFhAAACBADKFAGBGFD.DAIFhAAAaEAHGAEE.dGGAhABAAHHDfBAG.QADAhABA.XGEASBBBhAGA..,1,-12,-31,19
MKfJgZQFTUHWYVDRCXLdOcaNSeIGPAEBb,EFBFBEEEKDFBJEBD..ZBEEFAAAUBBB.HFFC..VFGBDAIBCHEDdCDDhADA...OAFChAEAaAAB..SEAChACAeHCC...IDHCAEIHMFADfDGHhAFA....hAHA...,1,-30,-39,9
FcMDfQbYWRIPBCOJNHaLSXTdKAVZegGUE,eCEGGADDFFAADICA.QBAG..bADGRDEEBGDCOHCGJHFEhAAAHAABLEADXEFAhAAAdCGBAACH.ZECA..hABAEGHH.fAHGIFHECCDDaDDB.SGEEhACA...hADAKGAD..,1,-1,-13,12
ZBYFNfXGSALKPgORMacQVUTdbWHDIJEeC,LADAKGABOADBaFFC..QBFAUDGEdAAAHCBBDFFC.JFDFCEADBEEChAAA.FBBDfFAEhACA.SBFAhAEAgGGBMIAATGEEIHHGEECF.hABAeDDGNAIAACED....hAFA...,1,-17,-25,8
ZSaJKODWUdARBCLeMcVgIGYFENQbPTfXH,BCBFCBHGLECFeFFHMDAF..VEDFGCEGEBDA.QCGAhAAA.TACDfHFDhAAAHGBCaDDHKGGCWABDhACAAAHG.RBFB.IHHC..NIBDPEABhADA..SBGChABADDDA,1,-13,-27,14
APbYCgVWJfdaBeOUIEGMcXRTHKFZSLDQN,...bBEECCGCVCAF..JFEAdFCBBCBFeHFCOFBD.EADHMCIDhAAA.RGBCHACDZDFCSFAFhAAADAFEAFHD.gGDEhABAfDEDIDDA...hABA......hACA...,2,-26,-22,4
REASfeJFUYWQGDgPNKLaIXMBcCdbVZOHT,SGHHJDAA.FAAEUAGB.QACGGADADDFE..NEAA.hAAAKBFELFCBaEFFIHEEhAAAMFGHBBAD.hADACHHC.dAHAZDDFTGAAAEHF.eDDD.YDBHhAFAPFBH....hAGA...,2,-23,-22,1
QDPeaJNGEKYBcRLUFIdbWTVgCAXOZSHfM,ZDFDHEFGMCDGDDFAeBAF..JEBBEECCBHGARGCAFFABdHCF..TCBDhAAACAEH..AFIBOBAFhAAASCGE.fGGGhABA.aBEGKFDE.YAHH.hACA....cCCHhABA..,2,-45,-18,27
WGeXcZSfBMVaPLHIgNRdFAKQTJUCYObDE,KBBGTEAFCEGC...OGDGDDEBGFAB..XAABSBHHhAAAMBIH.aCEBHAEGhABAgGAGdHGHAHAAUDBBhACAEHECeEFGfFGHBADG...PHCChADAIDCG...FCGFhAEA...,1,-14,-19,5
RWaFGDMgOHLQCAYPJKbZNcfEdXUSBITeV,JDFBKDCHZGFC......NCEB.EDHDdAEFSBCGBDDC.TGAGhAAAVAAF..RFDD.FEABhABAGDBCDCFFMBDCOHFChAAALCGF.AIGEYEDBPDHHfHADhACAICAH...hACA...,1,-23,-29,6
UQgNBGRfSLFaEcCJdHZIWbeOTMKXVYDAP,QBBFBBACRCEALGEGFAGG..EEGBJDAHdDEGZCBF....IGCChAAAeHAEMAACKABCXGGEhAEADEID.AEIFPHDEhAFAgEFFNEBE.SAGC.hBAACBDG...WCFE.hAEA...,1,-12,-33,21
DAKbVEdReIXUfYWgGQTMNHLFCOaZScJPB,KAFBVDEAEGDC..dHAFeDGFUADC....fDCH.hAAA.YCAFGBACMEIDhAAALHDGOFCGhABASDDFJHFABACGABBCIBGCXFACWCCEhADATFGEFHAECFBA..aAGAhABA...,1,-2,-34,32
PcQXVYZLBeDdNCJWMTgIGAfFHKaSbROEU,FGGHKAGB..SDGHOFDGUAGF..PGCEQCBA.hAAA.VBDFLAEFhAAABABBdGAGCEHBJDAFTDBBhADAIABEAEFCaGGD..EHAA.XGDE.hAEA......hAFA...,1,-21,-29,8
bCLagSIYHJcKUQMOFGXReBNAZEDVTWdPf,EEAETAADdFFB......bCDBaDAD.IGECJGBC.UGBGhAAAMBBAGCFAeHAGBCAAhAAAZCDFDAGAVAGD.fGHChABACHHBSAEG..YDFAhACAKBHFODHD.FCCH..hACA...,1,-7,-12,5
GXRDeZEKdTHUafBFIJCQSWNVcYbPMLAOg,GFCDXFCBRDFEZAEEdFGFHCAAUFAG.BGAFFAAD.CHEA....SBFChAAAVCBE.bDEFLHDGhAAA.AADBDBIFhACAKHGAaABGJFHB.QCGG.cACEhAFA...MIAA.hAEA...,2,-17,-1,16
geKOANTXfDHJLCPWUFcVbISRMaGZdQEYB,XBFCHBCECFECUGBDFDHB.....VDAGIBAG.MADChAAAGAGAdDBG..EGGABHHGhAAAeEEFAACEfFGChABADDDHLHAA.........hAEA......hAFA...,1,-22,-31,9
QdCJTVaYHfWcbKOLDPUgeXBIGSZRNEMFA,dFEBJDEA.aEAAHFCC.....fDAFbCDGKAHF.OAAAhAEADCIFUBADeEBABFADSBHDhAFAZFGBRGBG.EFHHAIAGCBFChAAAYHAC.WFFH.LBBGhAGA......hAHA...,2,-29,-12,17
IPOZAcMFQWHVYGgfTRCKBXJESDLNdeaUb,MDFCFGFBQCBFHABGGEFG..fHAFTEADCEECBAHHhAAAEAHDLDHBdHAD.aBFChAAAIHHAZEAEAADC.WDDFhABAYEDBKEHHXAEFDBEH.UCAHOBAAhABA.....hACA...,2,-7,-3,4
YCgARPULNGTaZcFJHSbMfdIEXOWKVeDQB,UFCCGECCZDADFEHBHEGFMACHdCGB..EBGFOAEB..KAEGDIAAhAAAQFEGBDCACACF.hABAAIHGLAAB.hAFATGACaEEFSHDAICEFXEAGhADA.....hAGA...,2,-32,-9,23
CMTNGYLcABgKQbaOHfEdRIDVeXSFUJZWP,BDFAKABEQCCDaDDBHEAB.dFGGDABA..VGACSBDE.hAAAUGGDZFDFPBFGhAEA.CDGD.NIAHLCHFhAAAAIHG.bBBCEBDGeAFG.XEEG.hAFAWGCAMDIF...hAEA...,2,-17,-15,2
DZTUFQgOGAJPcdeBYIXMRHNWbLfSVCEaK,JFCHdBEFBFGF..XGGBMFCCRGDGHBBD....bDFGfCGFhAAACDBG.aGABhABADGBB.ZABAFDDGQAFGhAAAOCAHABHA.PDDF.eCAENDIE.WAHBhACA.....hACA..SDAD,1,-19,-24,5
ZdeaWFQKUHMfLYXEDbJCNSOPAGIcTgBVR,GEADTGGF.BDDEZEACdDBHaCAD...QBADUGFHHACGLHCGhAAAEAHBDGAB.CAGBSEEAhABAOAAGACHD.IDHBhACAgGBA..eGDCKEGGMBGB.hADA...XBGChAEA..,2,-20,-3,17
WLFZDKJbGPMIfdQTaERXCYgVBOUHeNScA,FCDHDEDAKFCCGBAG.MHEAdDACQGBC..EFEARGEECCDFVCGBhAAABABBOAEE.hAAAeFCBSEGFhADAABAD.LAGFJFAF.IBHDaHGEXCEFhABA.....hAEA...,1,-5,-40,35
bGRfJCQHSFVcKTDgOAEXdaYUBIeZWMLPN,XCGDaEDDBBACZFBDLBDH....NAGA.bCADGCAH.hAAA.fFFAhABAQFGASCCFhACAFBHHKFADDIECAIGEdGAFIAEBeFDBWAEEMAAE...hAHA......hAIA...,1,-9,-25,16
BOWbcNgTKDXedERYPfMGaLVSIAQFZJUHC,FECGJAFBHBACOCAE......bEFAgFEEDBHH.dAFBhAAAEEBARDGF...YEAFhAAAMABGaHCE..LGDChABASGBGIHHCAEBF.QDDChACACHHABBCE.NICBKADE.hAIA...,2,-31,-4,27
JgIABMHXbaKCOFYUTeLcfREVdWDQZPSGN,BBCAXABHaAAD.KBEDFHDG..UFEFLAEDRDBE.EEFFdGCCDCIFZBFDhAAAGDAE.JHFEADHAMFHBhABA.CBHH.TAGDhAAAeFAF...fDDGWADC.SEGHhACANEIA...hAHA...,1,-19,-24,5
KRSFHYVZOcfbNJBWeTIXPDALdMCaEgUGQ,dFFHMCHBCHEB...aFEGEECHGEAA.QDCGSBAHFBABVBGDhAAAOFHF..bFAHhABANAIGBGGD.TAEGhAAAIBEFDGDDAAHB..LACBKGEB..hAEA......hAFA...,2,-33,-7,26
WOAMXaPKBfbFYHQIVScTLNedEGUJgZCRD,aCCFBFDE.FCGEQDAG..IBFCSACCLHEGhAAANGCBdHAFGAEHJEABZEEHDBAAhABAAIDGMFEC.PDFAhAAAKCAD...YEHBHCCE..cGAEhACA.....hABA...,1,-17,-31,14
EWFTIBCcUfOJDVGXZMgYeabLAPKNRHdQS,KGGAHGFGQAEDEEBAFGABBCCDUAAH..ODHFJEFG.GBEGhAAAMBDF.eBACLEEFhABANICH.dAHGSDAFhABA.IGCAcDAADGAE...ZGAGhADAaEFDADFE.....hAEA...,2,-19,-1,18
cUgTbWLeXaHYDAQISVPNfEMZRCOJGFKBd,QGFDVCBH....NEHC.fBDAZGBEREED.CDGFJABGFCGGBAFHhAAAdAAGUEDG.TFAAhAFALCAF.aABChACADEHH.IAHG.EHCGMDIH..hADAKAFB.....hAEA...,1,-10,-27,17
fgIWZCYdENDRQFUXJHLcTSAVMOaBbePKG,VAEDMEEDBDGF..eCBFKCBHGAEA..IBAHhAAACADEEGBF.NBIA.DGGHFGACJDHDLFFHhABA.SDDHhACAAGAGOCAHaAAGfCGA.WHAAhADA..dAHC...hAEA...,2,-31,-31,0
GFebQVWJUcEXRYZITASdDOaHKNCfBLPgM,DEDGHFGBKGHFCFDHBDACLBBH..MCDFeGCCQAAE.hAAAVCFGJCGHUADH.hAAAEAGBREADIFFBhADAAFDC.SAHBOBAHNIAB.PHBE.GACDhAFA..WAHBhABA.YFFB.,2,-30,5,35
bCYNaeLJOZgdQDEWSVFPRXMfIUHAKBTcG,KFCCBGGFGAACCEAD..aDHHJCEC.ZFEGdDEH.DCBEEAGG...SDEGhAAAFFCBRACG.MIDAhACAUAGCHFAFAIHC.bADChAEAeFDH.LAAFOFHD.....hAFAWFFD....hACA...,1,-1,-40,39
RBNGPUbVHLESIWOACXTYDcJMaQKeFdfgZ,TEGCDEBEMBCA..aDAAQGEE.FFABfHCHhAAAZCFABCCH.NGABGBCFUGCCHEFGhAAASFFDOBAHCHHDhABAcDDDeECA...dAHA.PABA.hACA......hADA...,1,-4,-12,8
HVeaEbYMPGCKLcASFgBWXNQTORZdIUfDJ,SECFFAFABBEA...XCBCTCBARFDEZGEC.dEFD.IAGAhAAAfABD.HCFHhAAAaABFEBHHMDAFCEDAKAEFhADAAEEENCIA.OFAH.DDIDeHFA....hADA.YEBF.hAFA...,2,-21,-14,7
YgOPAcdFRJbBeCDHSNMEQWZVaGIXLUfTK,FECHRAFABEAAeAEGHCDG.MAABEGEEZABF.GEEBLEHH.fFFAhABATBDGKGAFOECHhACAAHCFdDAACHDCDICCSAADhADA.NIEB.WBBE.IGAEhADA..XBGAhAGA...,1,-13,-17,4
ADMBgHJcGULNKSFCYfbRPXEVaIWQOeZdT,MFGHHADEGEEFUEDCLCBEKCCHCFAC....fCGBhAAARADEECGFaFAB.QGDDhABAZGCCAHHCDBAF.BBBB.gGAHhACA.cDAANBIGSHBGFHGE.hADAPAAGIAHC.hAFA...,2,-25,1,26
CdLRcKVPeWaYfQMXZGTJDSOEHUIAgNbFB,...NAIC.bFFDBADCCAGG.LDCDRCBD.KBAAeAAE.aAEDQGFHhAAAZEDBGCGCDCHFEEABhADAUDEAAAHGdGCC..PHBGhABA...fFAA.TAFFhACA....hAFAOFHD.,1,-5,-21,16
QTfbLFagERJdOVZBYISWGNcAeKDPUXMCH,KAEFDDAGUEDCCBCE.HACCQFCA..bAGFFGFG..aFHHEAADhABA.dBGAODHFBHAHSCAAhACA.hAAAGDDBABAHXFAFMEIFfFAAhADAgGCG......hAFA...,2,-28,-24,4
YcVNfQCHGEOabdIULTePWgXZSJDBFRKMA,VDCGQGBA.GCCFaDAB.dHEFUFGAeDHB...gBAChAAASBGGBEAFhABAKHAGAAAFNFBH.CBCHHFBE.hACAEAGEIAHF.LBDC.WFGBhADAXGEDDGAH.MACChABA.cBEC,2,-20,-11,9
EcMdbKRCTABUgJFSHOPWfZaeVYXDGQILN,BAHHUBDGFBBCSCFDHEAE..OEGH..fECFhAAAeHDGVAGDXGAGhABA.DDGG.IEAHhACANAABEFEDMIACbGFCKCCGCHHCAEEE.PACCaGAE...hAFAQEGE.hAGAcGCF.,2,-15,-4,11
FdbMfOCeDALZIRQNJHPSGgEWYUTVBKaXc,ZEAAREEEQABGHDECSBCDGFBHEBHDUGGABCFAKADH..aDHDFGHHhAAA.dDAG.MIAECGACADEALHBAhAAA.ICAEhABA.........hADA......hAEA...,1,-19,-24,5
bSYQfBIHecOLZJNFCaWDMEgPURGdTKAXV,XEEASFGF.QEBDBHGCHGAAeBAELBFGZAGHFGEDCDBDDCDDhAAAEDEF.UACHdAECADAC.hABA.bDGBfHGFhAAA....IAGE.cFDChADA...NEIGaFAGhAFAMIAA..,2,-23,-10,13
ATRHcMEPCBdLGDZOWYKIebXFQgafJSUNV,HBBBEAGFBHDAGGEBZDEF.OCHDKDGF.eADDFHFE.QAFHhAAA.aHAAfEAEhAAAUEBBABADREEA.MBCECHDGDEABICHFhABA.XECH.JCAA.SGADhACA..hADA...,1,5,-36,41
SAWeMEaOXTNVYKGPQFHUgLbDZCBcJRdfI,eEFBEGCA.OAGF..XBBC.VCDEKADCPCBAhAAAFAGBUFGELFHBDFBABGEAhAAAcFBBdACF.IGEGhABAADIFMICE..aFAHNICDQCEH.hABA......hAFA...,1,-13,-24,11
HRIDAbNKXJGLgEMVUWTZQYadSBCfcOPFe,KGCDXGFDGBAHLBCGMBIH..UGECTBGGZAGD..aDEFBDBAhAAA.CEFBOGAAhABAeADARDAFAHHENADD...EAACQFDChACASEHDfFHEPDDH.IDDHhAIA.DIBG.hAAA...,2,-13,-11,2
RKLZIUECfJXYPBaOSHADVbMTFNGcgdeWQ,DDCCVEBCMCFH..FAEHGFBFdGFF.eEHBQGAGKBHB.ZBAEhAAAIEBBEHDE.JHAAhAAA..PEEABBBBaGFDhABASAHFADAE.NDDB...WAFB.hABA......hACA...,2,-27,-21,6
cHBTFCgKVWRILMdXGDebPZSOEYaNfUAJQ,JGCCHBGBBAAFTBAG.CFFD.KACH..VFBFRAGBLAFF..hACAMEBCdEFFDBBBPAFHhAAAZEAF.SEHHhABA.OADDaGGFUCCDAHFC......hAEA......hAIA...,2,-34,-9,25
LECJRFbNBPagfYKVAXHIQcOMUGWSdeZDT,XFCEQFBB.MAFHGABE..SAGCZFGHTADGCCAGJBCBhAAAbAFF.BGHC.aEGBhABAfCHE.hACAKDADADIHHGDAIHBE.ODFBWBEDDIFEhADAEDDFFHEENEAA....hAAA...,1,-7,-13,6
EDRMGSWAgIcFKLBVNOCPZTdUeXfJaHQYb,..ICDDKGAGLACEBDGA.VECA..OCBBCHFFZCGBdCDBeHBAhAAA.JFBGQBAHhAAA.EAGFDFIBMIBChABAWACEAGIB.FAGB.TGFGXGGD..aABChAIA......hBAA...,2,-40,-11,29
BLRSWfcdKPEabJYIHZFUAgVeQMOCTGXND,eHAAQDGGCBEA.GCAFDGAERFEF...SFDE.fABChAAAdDAFEAAHaGHFYFBBhABAZDDDAIDG.gAFFhADAMAHB.TGGGBCCEWAFBPEAB.hAAA.bDFA....hACA...,2,-31,1,32
WXYGLVADMIZCUOFNRfKbgeTcPEHSJBQad,MFGBZEBCUBGHFDEB.RBBC.KEGC..eDDE..TEAFEAAHHGAGSGAGhAAAJFGF.QBBBhABAaAEG.dGDGWEHBhAAAXADB....LDAFhACAAFFBDCGEIHHBOHDE..hACA...,2,-32,-2,30
VNSLBOCFagADXbePIdWRHKMYJcEGQfZUT,DCADXAGAeCFHdCHARGFC.HFBDKBCB..MAAHJBCE...GBEGhABAQAABUEBDNEAGSGADhABA.LHDAhADAODHDCHCHFFGGAGEE.IEDB.WAFEhAEAECBB......hBGA...,2,-19,-15,4
BARbSHYXgWfZUCdGQLJKTMENcOaFVDePI,SCAHXDAB.....fCHAZECGdBHCLGFAhAAAJCDHKGFCEADDOCBA.FAFDhABADBFCPDGHAFCDHGCC.hACAWFAFCACH.QAAHMIAENHAFaEAHIHHDhAAA..BDEC.hACA...,2,-24,-6,18
IdgJeDAYQbMEOHfSUFBZcWKCNGLaVRPTX,QECFMBFHHEBESEGHFFEDZBCC.KACDCHABGCGALAGBaDAHhAAARGBC..XGFChAAAdBGBJACAABADECDF...fBAEhABABGGGNIDB........hADA......hAEA...,2,-18,-12,6
MbGEAcZCXfUPJFWVaRHLYQeNdOgITKBDS,CDBBXFDHUEDB.FBBH..aGABHCGD.QFBBdGGHOCAHIAFBhAAAKHDG.DCEEMFCFhAAAEDDAAHGE.ZFFCPBFAhABAJABA...RBCG.LEADeDHH.NIBD.BABAhADA.....hAEA...,2,-21,-5,16
JYBacXgOPVFbIeTNUKLMSdHECQZDfRWAG,GEEHBBDHaHCG..XABFOAHFFBACeBDA.UGACKDBDLFEEhAAAdGDBCHHCZCFG..DEAGRFAAAIEEhABA..JAAH..gAFFhACA.PDEAIAHH.MFAGhAEAEGGB.....hADA...,1,-14,-28,14
FAPYaLOGREZdSWKNCDQgJeIcHBXVUbMfT,aBCGOAECGBDFRBACZCECdEFH..KGFDDHBE.QGEGeEHHHDBGBAHGhAAAUGCCMFAAFGABAADDLABFhADA.SHGAhAEACAAFIEFHXCGE.fDDEhAFA....hAGA...,1,-16,-19,3
MYSIHNTOEeUcKPZWADCdQJGLbRgFBXaVf,DAAHCDAEdGGHQDGEGEBFLBBARDEB.BGAHXDBB.aGDHhABAfAGD.hACAMDDEIBGC.hAAATADHEHEGeCHDcGAC.KGGDPABGhAFAACCEJDAH......hAIA...,1,-14,-23,9
aBDPbXgScCQRFANHOdGfVKZJLMWTeIEYU,OEEDdEDDGEBAKHDAZEBHLGFE.TABFEBAGUBDG.BCADhAAADDAFXCDB.hABASAAFCFABFHACAGGC.hACAfAGGJAGF.MIDCIHHGYBHBhADAaDGE.....hADA...,2,-34,-8,26
cgUOVfbSPDHFZRNCKWQJEAaMXedIYBTGL,aEDAMCFG.dFADBCFCLAADUAAA..OGBGVEFH...SADBhAFAHBBCRGBAKEAEJHECAIAEeDEFhACA..IAGDhAIA..YFHBcFGF..fDBHhBAADIDA...hADANBIACHCA..,2,-34,-15,19
cUaCGDAYWXSIHLedTgREKMfQZVFPJBObN,XGDFSAFBHCBGdGDAREFEKFAC..QGGBFABFBAHHODHBhAAA..cABFhAAAaADGCHHFGBEDAHBA..hAGAWDECLFFHeDAAgADBMHAC.hAHA..fAHAhAHA..,1,-13,-14,1
aCKZIYWREOSfJMVgQUGBePcFdNDTLXbHA,CDEBKGBDZEFE....IBFHRDCFEAGH.OEDE..fABChAAAMGEG.QGDDhABABDDAPCBFFADDDGIHhADAXAAFABFHaGAGSGGDJAHD..gGDGhADAeBHH.NEAC.hAEA...,1,-10,-44,34
RFNbIHXDSLgCWKMZBUTYAeQEdVOPacJGf,QFBDVACF.OEDCaHEEGFBF.RBAB.NAHEHADDDAFCLEEChAAACDAAMCAE.BCHCUGGBhAAAABFGEFHHdGEA..PBFFhABAfCEF.IHBE...hACASEAA.hADA.WFAD.,1,-5,-12,7
WSHZePbGULJNfdORgVIMQDAYFacEXKCTB,aBCEXGDC.KABFCFGBBEED.HAGFZCFGeEBFGFBFUFGDLFADhAAAJADE.dHEBOCCGhAAAgABC.MDDGhABAAHHH..cAGBEAEG.TEDE.SCADhACANDIC..hADA...,1,-4,-26,22
TUOQSDMCHVbRZNaIFKdWXcJGgeAYEBPfL,BBCBLEBBUEGBSDFADAGC.HFGFREBHZDDDaBBC..KBFAdAGGhAAA.XADAGGDBADAAhAAAPGDG.OCDFhABAMEADCBAGNEAG.........WHBGhABA.....hACA...,2,-40,-13,27
NdBcTFeXEUOIZYVLgJKGWQaRHbPfDAMCS,CGBDSGGABHEB.FGAFeABG.UBFEIGDAZFGH..LDCBhAAAJCFHGDAH.QACAhAAAaDAC.HAFChABAbBBGDICCAHFBMCIBdEEC.......hADA......hAEA...,2,-30,-13,17
YLIgGAUacbZQSNFHDBTPfMRdeJKEOCXWV,UBEAaEHDZECFQGGF.FCAEDCBFBHDATCGG..MFEAhAAAdACCJEECKFAG..EAHFCAAE.hAEA...XAFChAGAWBAC...YHAAIDHEAHIDSGGDhAHANECB..fHAHhABA,1,-31,-41,10
dUSVIXHNAcQBDCgGLORFTeEWbMPJZafYK,QDGFCEDFLHDERCFEeBBB..EACHMGFAZAFC.aEECKFFG.UGAGhAAASAHH.XGBFhAAAACDDDEAC.gAEChABAFCAC.WHDG.bEAC...fACHhACA.dDDFhAHAIHHH.,1,6,-34,40
TEgUJPBdabcIVHMXKSYGQWALOfRDCFZeN,LFGHODGB.DACEFDDAZCEDeBAC.EGCBUBBA.BHECdEAAaHFAhAAA..IFBFhAAAMCFCXADFSCHBhABA..YCCF.WAFAAAHHfAEAhAGACHABNEIG.gGBAhAIA.,2,-45,-10,35
bMTfdARCeHBgFKSYUWNDGQIPEJXZcVaOL,eFHBBGDFFGEDKEBEUAAADDCG..GAGC..PBFBEAFHZABG.hADA.aFFHOECALAHHhAEAMAAFdEGF.CBDBHFAEhAFASGGC..WDDBQFAAhABAIHCAXDFD.hAGA...,1,-17,-21,4
EcJPbSIZNBAfRgGOQFDdULYeXMTaVCWHK,RDFBOCEADFBELGAC..XAGAMCAD.VFFECBDG.KBBEEBBDhAAA..JDAGSBHHhABAZEDDAHID..fFAHhAAAQDDEdHADYHECaAFG...hABAWBEE...PHAEhACA.,2,-35,-18,17
IJRLBAUSbVZgFdCYOXKeWDPEQNGMHcaTf,UFCGVDGH.ZCBA.dGFFODCE..KAGADIBGEACBQFAChAAA.MAIDaEAB.IADDhABA..RFAFBEGFhAAAAGGBSCAFgADBFGDGCCFH.eBBHNDIG.hABA......hAFA...,2,-33,-15,18
KHTXUfQOLbVAZReDESagGNYPCcdMJIFWB,ZFCADIEAEFBBSDBF.GDCH..NADECFCBMBAF.IDHGhAAAFCAEKCEEHEEA.hABATGGDXGAHQAGFhAAAbFFBAFADRBBEeHCG.aAHBYFAFhABA......hACA...,1,4,-31,35
dfEZTOWgcQeILGbDUAFHSKVJNaYPBMRCX,FBEGKEAG..JAGBaEFD.BGADRGFG..dACEECGGZEFA..OFHB.hAAA...gFCChABAeBAEIEACLAEDhAGADDAGHGDASCBGYDDDMICC..hAIACACB......hBAA...,1,-25,-29,4
eHadSAbUORGJgYDMKfNCQWcVZBILEXTFP,UADEOBAGGGBF..JDFDDFDGKDHDCFBA...QAGBhAAA..VAADBDEFLDDChAAAEGGAFFBEeHAAhABAdAGHAHGE.RDACMCCCNCIE....WHFA.IFGEhACA...hACA...,2,-26,-26,0
QVUBDLHTCNWXRgYOecfFPaIJbMASEZGdK,SGADZEEBdAGAQFAGUEEGLCCHHBAATCDGCHDD.XGGDhAAARBGHOADG.eCADhAAAfFCBFFHH.aAEFhABAIGBAMDIHAHDB.KABDDEBC.....hACA......hAHA...,2,-22,6,28
ZREWVecQDdgSXBGKOCHNbIMFAaPLfUJYT,aBFFLFHD.UFDHTGEGRCAA..EAGBeFAE.DDDDSAEDhAAABBBGKCAFOCEFhAAACACCHFAF..IBAFhABAAHHCPDHHJDEEZGAC...cABAdHEH...hAFA......hAHA...,2,-21,-13,8
OgTdEeXfVQBMRHJcUDLAPKGaWSFINbYZC,KGDCGAAC.SCGCIEFB...bFEFCBED..ODBGdADGEEBChAAAeAHB..fGHEhACABHGEMDAHJGBCDFIHhAAAAIDCaDFCFACFZFADTAED......hAGA......hAHA...,2,-36,-10,26
SLGRaDcBbOMYegEVHZWQXJFIUdPAfNKCT,KECFSEAFGBEGDDIHBHFF..OHCCMFEGeFBD.VABBhAAAHAAC.QBGBhAAAFFCFUGGAACEACFAATGGChABALAHDaAFA..YDDEEDAA..WEEDhADA..JADA...hAEA...,2,-17,-10,7
HYCOEKFdWPQbDIgfBNLaXTMJZASGRceUV,SBFDGEDDeGBAUDCEHADB.CBGGKHGGFHBAdFHE..QCAGhAAAIADB.BFADLAAHhACATABAJHEAAEIDcCGEhABAOAHB..PFEEDGGGNIAH...MGAChAFA......hAGA...,2,-26,1,27
AKUWGXTLFfEJDZgSCIaOMBcNbHYeVRdQP,UGDDXDCFLEABFCGB.ECEEDGHB.ZFDDCEEC...OBADBABF.hAAA...NEGGHACDhAEAYAACRAGF...dFAChAEAAAGD.KDHH.TAEA.fGFAhAGASCHH.IHHGhAFA.aCCHMECD,2,-29,-15,14
DLBGXFEaTKVYAcdOSJNWQRMZIHeCPgbUf,dGCDJDAA.QADARGEE.MDDHZDFCHFBDCCAD....gGGEhAAAbAFGDEAH.GBGEhABAXAABaGAFKEEBVACBhAEAABBFSDAA.NICH.IHAHhAGA.eFFGfAFHhACABEDH..,1,-4,-19,15
PVMSTZQCOURfXaeWAJEBGgLNKbIFHDcdY,JDFEBBCAGBDALFDB.KAEDFGCADCBDdAAH....VFACTFGBhABAZCDG...CGAGOAEAhADAUGGC..fAAFhAAAaGFHABIH.EDHBNIAF.....IAHChADAcDBC.MFFD.hAIA.SBFA.,1,-21,-26,5
MDadKLTVHJXgZcIYRFGeNfABQWPSbOUCE,BBCEQCABSGCCUECA..MIEEaHGCKCEGLABE.TAFBhAAAJAEAZDAC..IHCGhAFAFCAAeFEEfEHEhAHAABIF.bCFAEHAEdFFC.....hAAA......hABA...,2,-37,-2,35
HVSOAEcJKNUYIePfRQbWBDZaGMgdTCLXF,EEGDJCFD.UBBD..eACHREAC.QAGABAHDDAAFZDEFMFBC.dHGHhAAACCHH.LDHFHGDEOBEChABAACADKGAA..NEAF..hACA.IHHF...fGAGhADAaBBB.....hABA...,1,-21,-26,5
fCcGAMWOaSHVNPgEQJXTDLIUBeZdbRYKF,OABFHFDGVCFG....gFBEEABCXEBGDBDGLEDGhAAAICDA.BBHFdHBF.hAAARCEAFFHHCHFHAIHEMBDGSHEEhABANBAE..JEHDeHAG.YDADhADAKAHH......hAEA...,2,-21,0,21
XYceAIaPFZKCWMJbUGENgRLQdODVTfSBH,aFCCZAEGCCGC..MACGUAADGDEB.ECECRFFAdDEA.DICC..fBAChAAAHEAB.cAGChABAIDHC.KDCDhABAWCDD...NIBBgGGF.hADALEBD..hAHA...,1,-18,-36,18
IZcOMCLTKGBeYRFDEWdNXASQVbgaJPHUf,QCAGVEAH.aGDFHDFC.UBDBIAGFOABB.MAEAhAAALEEAKEED.BFBHhAAARGCGEGHHNDEFABIB..SGFBhACAJADDfGGACAHA..eCCDDFIFdFAGhABA......hACA...,2,-23,-2,21
PSIKCQFTUHVRcBJgADbeYEWaNMXOfGLdZ,eCEEEEEG..aCCFMBFA.OFGBGADDdEBBZFGB.SCGGhAAACAADQACBTGAEUGAEhABAVFDHBEEBACAFDABFbFDH.hADA..WEAG..XDGA..hAFA......hAGA...,2,-19,-7,12
gSTYLfaQKPUHeWFdRNDJZBAXMcObGECVI,MEDBOCFHGCAC.ECGHIHCA.SGGDTGGCLADFhAAAQECCKAFGPEEFhABAUABDHAECFHAA.hACAdFACDDIDBHECAAIB.XCCECBBB.gFGBhAAA.fCAEhACA,2,-18,-8,10
eMVGfCDRQKOgFBcXUEaNJLbIdWYASZTHP,TECGHCCGeFEC.MEIDVABAGGBD.CGGERBAFKGED.FCGCBAHAhAAA.XAFDaHGANBFGLHAAhAAAdACBACIB.SBGEhABAPFAADEFGgEAD.EFGA.hABA......hAFA...,2,-11,-4,7
HeSTGVQdXJPFgMAcERCNOZfBYDKUWILab,RFFFCACCZFECBFEC.KADE..UAFELCCEHADDSDDGGBGCQGBGhAAAdBAA.JBABPHDAhAAA..MEIBhABAABIFEDFEODBEDIGGIHBFaAHF....hABA.....eDCDhAIA..,2,-24,-12,12
eRVFMNYfJKDOEXZTWCQHBLUIASGdcgbPa,dDAC..bBBHaDECeDHDRAGH..MGFA..NGCH.JCCHDGAB.EBDEZGBGhAAA.CBED.BHCHLHFAhABAAEEB..SHGAhAAAgABCFBADKFBGTAFH.WEAG.hAEA......hAFA...,2,-23,-21,2
ZNFAIGSeOCVRJTHQfLaYPXMBgKcdWUDEb,SCAGOABARBFGHFEAQAGFLCBBaHAC..XFAChAAABEFEKGCHdFDCDCECEAEAbBCDNIBB.hAHA..AABF..IHEAhAAACDDE...TFAHfGHCMDFAWEGHhACA....hADA...,2,-29,-5,24
QNLWISPYfBVGFJEMbUdRgeKCaXDOAZTcH,ZBAFTBDBQAFG.LFGBIDFGSFDG.hAAA.PBFGBCCCVDDEhAAAFHFAECBGMFBHUFACdACHhABARDGFeACCCHDCaCHBDEIFAEEBcCAHNDAG....hABA.WHAA...hADA...,2,-8,-7,1
baJSfQXcTNFBeLHRCgDWYIAKGUPMEVOdZ,KDFCGFBFMGBGOBBHZCAE...aHDESBFAQCEB.TAEEhAAABACHLECAhAAAHEFDCHADDACCIGFHhABAAHIHPCHFdFAG.JEHDcDBENIAF...FAGA.hACA......hAEA...,2,-29,8,37
CKLUfFHSTVRMZgIdcAaeQEJODbPGYWNXB,eDFCEECCDIGGGAAF....NDCFBFGECFADKFDAUGGDHBFCSCBChAAARBECZDACdHAB.AABDQGBAhACAOFFA.PDABhADA...XGECfCDG.hAEA......hAFA...,1,-20,-25,5
JdMRcVbKTAfYUGSZQXBgNWeOPaDEHICLF,UGBHZAEBQBGABCEA....NFBB.eEFG.OGDCDAHBHBAHhAAACACEFHACMEABREAAVBAGhAAAKHFA..AFHD..GDEHhABASHGA..gADC.hABAaFHDEDDB....hAEA...,2,-26,-14,12
CHXRLgOdEITAMPfNKGeWcaJZSDYbFUQBV,MBAH..NADGGAEFeEEF..aFCHSEEFDCBGFGFC.BHAEhAAACAGBRBFE.LDGD.hAAAgEAFdFAGEDDFABEEKDGDhABAJHEG....YFCF...hACAQBAD.hADA...,2,-28,-16,12
fYIcVKMbLOZPAReTBUNgESaQDFCdXWGHJ,TFEFBBHDUBDH..EABHSEAADBGCCADB.dGFEGCGGHEDHJFHFhAAAICED.KDBGhAAAbGACLGAA.hABAOFAGABBBNACF.aGHDXDGG.fCBChAHA...hABA...,2,-24,-17,7
VHMKefSFYODBJWbPXGEZTAULQRIdgNaCc,UDCHRECGdDAC...aEAHCHDFHCEG..KGCDSAAGFFHFDABHBGEHhAAAJFGD......hACA.bADAXGAChABA.ZACDAHAEQDFFNCIEMBEC.fGGGhADA....hAEA.OCCG.,2,-29,-19,10
LREeSZaIHGcYKbDVPAOCUgQdXMNWfFTBJ,CGCBQBAFdAGF.MAEF..fCFCBHAEREFDEDGGeDAEZBEBHDBHhAAAGDDCKGCBbFGFDAFEhABAAICG.ODAHUAACXFAHhADA.FHEELHFAIAEF..hBAA......hBCA...,2,-15,-1,14
MIFUfTGCDKQBOXZdJbHacgNYSeWRVLEAP,MDCGUCDAGDAEKBDABEAEOFFB.dCGBJHDEHABE..aAGF.hAAA.NIAF.eDHDREGB.EEEHhAAAAGAD...FBAGCFDHDADChABAXFAC...bDFH...cGBEhABA...SADEhACA,1,-23,-26,3
YfICKNcPBFMeAbSQXaRgZdJDUEHLVGTOW,SHFEXFECRBBF.dBBB.UFBCLDDEGCADTBGH.OHFEhAAAfBGDKAEA.hABANIBB.PFCDBGDEMACAhAAAAEAEaHAC.ZBEFDACE.EFHDWFFA.CGAFeEFAhABA......hAGA...,2,-13,-5,8
CZeLMJSPYATNRDUfQXKagWFOHVIEcBGdb,RCDGDHAGUDACQDEB.KAEEaFFE.FGCDHBAH.EDHHBACHdGFFZBFEhAAAMCAG..SDCDhABAAHHG.NADC.gAEEhAAAOGBA.IGAC...hACAcCGDCHDH...hAHA...,2,-42,-13,29
RAYBGIaMOgKZVNPcSJdLDTEUfHeFWQCXb,GCBGaBBB.MDFEODHBKHCCZEEE..VGBE..PAAAhAEASAFGdGGDDAIDTGFGhAAAEBFG.UACCeFAHFEBEhABACBDBXGEDAGECBEEG.......hAGA......hAHA...,1,-8,-28,20
SeZaCUIFMPOGEbJHKDAXTRcWQVdgLBYNf,XBFATFDA.RCCE.QCFF.dEAHgFEABBBDfEEBhAAASEADZADBCHBHhABAIBABFHGC.MIBAhAAA.GEBHEAGGJDHBHADEAACD.WDHH.hADAYHFG.aGAEhABA...,2,-16,-7,9
dUXGAOHSREVPbNFILTeDYQKCBaZMgcJfW,OFACSEEDREGH.EFHD..VAFA..NAIGLAFDDIGAKBBHBABChAAAMDCB..JFEFWCAEhAAA..dDFEXGBChABAAIDCHDCA.FDABTBDE..QGFHhACACDAAaADG.cDFEhADA...,1,-17,-23,6
LGSUKObVXQMPNTJcDAeCBHaEgFYWdIRZf,eFEHHEAHaBAHEEADFACGdAEFRDFC..LCHDUFDBKHFAOBAF.XDCChAAAMAIB.TGBGhABADCBEBDDB..YAGDhAFAWHAG.fHGBSAGH..hAAA......hABA...,1,-6,-29,23
RYVWeSgLaDAPCEQGHMKcTdFBOXUfZJbIN,CFFHGEEEHCBCKBGDdAAEOEHH..UFBHJEBA...IEHFhAAARBDF..VGBGSAFChABAaBGFAADC.PABChAEAMAFC.FEEGBCCFfHDH..NBIE.hACAWAHH....hBAA...,2,-37,-17,20
eENZfRUVSHIFXLMGPACbgTcWQKYaBDJOd,CFBATGFD..QGCAaBGH.BFHCDFEBJBDBOAEC.dCAEhAAAeAHBEDFF..ZABFfFCChAAA.VDAHhABAIHAGFACBMEEAADEFbBFE...WHEEhADAKHCA......hAEAYFFC.,2,-24,-14,10
FTKDcYQaUVbXWNMLERCBfZAIHgdSOGeJP,HBDGdDCESBADGEBCeAHFFBFG.DFFDQFEFaEHB.UGAFhAAAXEDB.WCADhAAANEEBLBBG.EHFChABACCBBBABFADGC.IHAD.gGGGhADA....hAEA...,2,-19,-19,0
TPKdGCZfRLNBgebVIaYcASUHXQJFEMWDO,SFAFXAFEFDGAEDFG..DDCG..OCFAKHGCdEBFCEHHZEDHREEHBBAAhAAAeBAC...IDAAhAAAaGCFAIFC.QFBHhABAMDAD.TGGEfBDBNIBH..hABA..gCCChACA..,1,-5,-42,37
VQILAUCFODbcRaWPfEgKMXNSYBGeZHTJd,FCAAODECDHBC.RGFG...aEGA....fFAFKEADMAAA.XCBBhAAA.NDDG.SHFChAEABBHC.eFEAhAFATAEFdCEBVDCDIHAA.LBAFhABAAIAGCAHFWADAEEHF...hBAA...,2,-37,-16,21
ERdDLUJcQaXYHFNeOIGMVgSbACKfWPTZB,KADG..fCDATFAGBDHHdBHEDFIBUCCDJHCG..QFEDhAAAXGFB.FCAFeDADhAAAIHHDMCCBSGCChABAAIAECDFGZFCB.LBDEaAFD.YEFEhACAOAHH.....hABA...,2,-23,-11,12
BRULOFJPGDYHfZKWeIASTNaXbQcgCMdEV,SFFGTADC..XFCHQBCDCEEA.MBIFEDADBBHHhAAALFACFAFAGBBGhABADAABfHAFKGHF.IEGFhABAADEAaHDEgEGEdHDHVAEC..ODAChACA.....hACA...,1,-4,-18,14
NbHYBOLCMQPTedIgUAcDZfRVJXaSGEKWF,ZDBERBBD.JGEAXBGD.GEAAEFADKCAGFAEHHAEDBDFDLAHFhAAAMFFE.QDFDhABAeGCAIEDGAIFEDGCDaABEhACASGGA.NIEDOAFG.CBAC..hAEA......hAGA...,2,-18,-7,11
OMTNXPQERAYDZUgKGHBCcaVfeJISLWFbd,ZFCCUBAHKEFEHAFBBCAEaGHH..eBEF..JDEDSBGBhAAAFGFDdEBA.MAFA...hAAAXGGBECHHAHBBDDDBCADB.hABAfAEALBBHWCHHOEHF.NEAE..hACA......hBAA...,2,-33,-18,15
ABYfDZOegdXKGNSTELbPIWMaQcRJFUVCH,BAHFDCFCeDFEdGFFKCBBGAAD..SEBDEGAFLECH..hAAAPACAIAGHMEFAhAAAQGFG.hABAcDDAREDFJCFGFGAHCDAAAFAF..fFHGhABA..OHFC.hADA...,2,-27,-20,7
DcUSPERMLYZdgVJaBNCTKfAXHbeIQFOGW,XDEHHBDAeFGHFACDODAH.GDBBDCEGSHAGRFDBLAHFhAAAdBGAJFBDBGGCCFFDKABDAGIFQEAFhAAA.hACA....WABD.....cGEHhACA.EDHF.MDDHhAEA..,2,-24,-12,12
JKAgWXZSEINTFDRLQVHMcbPfCeBUYdaOG,XADESFGC.EADF..IHHFFBFBDIBELCBDHFDGMBGFhAAA...bBADCDDBBGHDhAAAdEHEGGABKGDBWAGHhABATCDG..QECGcAGA.fABHhAFA.eFFDhAGAaABFAIACNAIE..,1,7,-30,37
NDXPcAWdVIFRKZBHCSaJgEYbTGfUOeMLQ,VCEHRDBEKABGHGCA..aCBBEFGA..TGCCUAFBMDAF.QGAAhAAADABEXGFGhAAAAHHA.dDCEFBDDCGACSBHDhAEA.gEGHbCFEfEFChABALAFC....hBAA...,2,-25,-5,20
TUPNIXARSGHLCBWcJMgbDKeEVFYafQdOZ,SBDFLFHFCEFHBBFF..JFDGMAIHDABDKBGG..EECCFDHBhAAA..aCAFdGGEOFADhAAA.ZADBUEACIABDhADAAEDH...RFDH.WHAE....hACAcCGHeAFF...hADA...,2,-43,-22,21
aHRdLeNFIKBQVMDgZAbPYEcXUCGSTfJWO,...bFCHEFCG.XFEDUBGHGAAG.SDDBJBEBaHAAdABHhAAALGFGFBGBBHGAMDCHhAAADCDBAGGEPFAB.hACACADDTEGFfDHAWAEE.....hAEA......hAFA...,2,-36,1,37
WPbGUFKSYOJDgNVTeZaMRBcECLQdAfXHI,XDAAHGFG..PBBFUEED.KGCBSAHDOFEA.DGAGVAFFhAAAeADH.ZDGHMFABhABABACCCECALADBhACAAHHG..fBAD...WFDDhAAA.FBFBYBHBhAFA...,2,-24,-21,3
QAPVHLgfcFCTXJdaDREBUNGSOeYKWMZIb,HBBBLCEG..gEGFfEBACHBH.JGEAdAGG.DADCBEEFhAAAUFDESAEAhABA.eBCBKAAEMBEFhAIAIEHAAIHE...PHAAFFBC.XCAGhACAaBHF.NIDB....hBAA...,2,-26,-14,12
HIadSfUJgKRTBNGECMDAeYWXPFVbcQOZL,eFCGXFEGFCCA....VGACQBACLBEBHAED.ICGDhAAAdAGEUGGCKDDFBDAHhAAANEAECHGC.DDIBAHBCPDBFhABAOABASHDA..fACFhACA.JDHD..hAGA...,2,-20,-15,5
NeVSbABXUfZgDJaTOPHLQIYMRWKdEGFCc,UBFHZAFHDDAG..TBBBOFFB.LBHBQGEC.MCIFhAAAREACdACDFFFACBAD..eBEHhAAASEDCBHGC.gEADhABAJHAC.aADF.IHHAKCCEEEFG.hABAcGAH...hADA...,1,-15,-22,7
AECDgHPFLRKTQZJaXWBcbOYSGeVINUMdf,CAEBDBIBHGACLFDGRFEB.KDCEZBEC..aEABBCBD.OEHHGACFhAAAeDDFVGAGUAAFMEIFhABA..AHIDEDABFHFGQCFFhACA.XBBCcAGF...hABA.SEFBhADAIEEA...,2,-24,-7,17
YUbIRXOSVNCefLGZWHQKEJATMDacPgBFd,MAFHDCID..aEAD..PBDBBCCEFAEFUFGHRECC...OHBEhAAASEGDCEAFLAGDhABAZAAEHGCCKEEFAEHE.TEBHhACAdCEHIHHH.NAHC.fBHEhADA....QCAHhAAA,2,-32,-17,15
TeRdXDHMKEPNZFOCQUbcIVAGLfJBaWgYS,LDEHBADFaFFG.....gDBASEDBeBHBdBBAHBEBhAAAMEAFKGHDPHAAFCAAOHAChAAAQGGGbABA.hABA..IBGGAHFEfCGGJFAAWBAD.hACA......hADA...,2,-18,-13,5
WQGXLCZfMPAgeBKFDSNbTIcOdRHYVaUEJ,BEFEFBDEDBBESGGH..NEEA.IDDGdBGDHDAG..aBGEhAAAJFFDGEAELAADhACAfFDAMHACAHIFKAGChADAbADC..OCABRDGB.YBBHEFAG.WDFEhABACDFC...PFFBhACA.eEHB,1,-1,-18,17
VXTdONKfSDUWHQERIaFZbeAJYCBMgcPLG,JCEHCAGFBDBE..MDBF....gEFALCGHXAGAhAAAOCFC.KGHBSAAChADADIEEHFBFEDCBRADFFFCChAFAZACAAHIH...YGDCPHCA....hABA......hADA...,1,-25,-37,12
VYBWZcOdbSCEfLUDFeQMAaRHPXTNJGKIg,HDFFTBGEJABB.KEAG..VDCABHCHZFFAdAGACBDF.LDDB.hAAAFADAQEAChABA.MAFCAIHAaHEGXGBHhACA.IEHD.gGDBhADAYBHBWAAF..hAIA...,2,-40,-8,32
YKZgWbSHTVXfMJFcRGINAUaCOdLQBeDEP,UGBHaEBC.ODCAQAEABGEE.EGGAKEHBZDDD.....WCAAhAAASAAEHAGDXGEHhABAJAEEFGGDRDAGIACHhAEA.AICGCEHH..dBBD.eDFA.DCGChADA......hAEA...,2,-30,-4,26
MLKZfRTAJEQVbHYUBWSDGcIPNdXCgFaeO,EBFAQAAFHCBEBEHGSEDDDAEAGGEF..IADChABAdFBCCFECFAAEaBFE.OFFEhAFAMFDDKDEGRGAAAHHGJCEF..hAGA.YCCDWAHBNDAG.eHEG....hAHA......hAIA...,2,-17,-11,6
SWegJAfBFCZDQXEYIcbGNMVKUaPdHTROL,FBCBZDEBDAEGEEEA.....IAAAGDACNBICKBFE...aGEEdAAAhACA.TGFHLCDBhACASEDFeDAHACHGBHAGhADACCGE.XDGA.bEBHMDDE.PADAhAHAOHFE...hAIA.WHBAfCCG,2,-15,-15,0
UcJLBFdEAOgNfSTRWXGHaQCYPZKMVbDeI,OCED..fDHCRGACGBGEaDAHCBFFZFDG.KHGG..bGEEeCEAhAAA.UBAHLAAChAEAdEBBABDE.gDCFhAFA.TBBBXGAC.YAFChABAMFIHDICAIEEDBAGC.hAIAEHDC..,1,-6,-19,13
bSTODQBUdRWYCMNPAVZfgcKeIaGXFELHJ,VDADZBCA....gDEAeDDAGADHEEAC.JHEE..bAEATEFBhAAA..DHFCBABEhADAdBACRDGHCDHHMGCCADDHKGAFaGCAhAAA..LHAA.SCCGhAEA.....hABA...,1,-7,-23,16
fGgbYJQKMTFWESNVXABDRCOLZPHaUeIcd,REDHOFFALCCBZFAHHBEFeAGB.dECGGAEA..bBAEJCAFMABAhAAAFHACEFGE..NHCFAIECCDHA.hAAA.aABBUAGC.IHHChAFAfGGE.......hBAA......hBBA...,1,-11,-13,2
TVdYHUcaACERPWKSGJNeLXFQgIMfDBbOZ,CBCGECCARBEG.KGFDGDDF..JDEALGFC.FBABIACChAAADAGGBGBDZFBH.dGACUDBAhAAAAHHF..SEBEhABAeHDG.QAFDMFAF.OFFA.hABA......hACA...,2,-25,-25,0
cYNRQbKEADTGSgHPUOeMZBdIWaFLJfVCX,TGBFGBEESEAH.HABDPCEAUEGHOCCFMHDGBECAhAAAdGGHaBGAFCHBfDGFhAAACBDAXAFBNAEBRABC.hABA.KHBADBAB.ZEFGIHHFLEED..hABA......hACA...,2,-6,-4,2
gNUZXHPSTOWFcQIJCLDVYBeadbRKGfEAM,MAIBUGBFZDBGHBAC.SBEAOAEFFABDQGEA.JEBBhAAACGGADDAFBFECdFEB.RAGH.hAAAKDFG.fDDAhABAACIF..NEIG....XGEHPHBCWDAFhACA.IGHHhADA..,1,-5,-39,34
QVSRfgCcGTJPMZbLXUOKeDYdFIEaWHBAN,VCFCRBGFCBCA..GEBA..TDCBJFHDZAEBXAAG.KEHHhABAeBABdGBEFGFAaFFHBADEhAAAAHIDQAEF.hABAfDAH.cEDDMEED...hACA......hAHA...,1,-11,-31,20
LENDTUeHPOcaQBAJWIRSMCZXKVYdbFfgG,JBCERACHMCFBZDFF...KGADdBGD.FFADGGCH.EDGCDHEA.UBAChAAAeCBB.HAFA.OCAHhAAAaDDCBHDGAICCIHHEhABA.CABH.XFCC....hABA...YHFGhACAfFGH.,2,-41,-9,32
IFCcOPBLMfKWQeHESaZgXAYDTNJRbdGVU,DHBCJBEA.REACGEFGUEDH..FEGDCHHG....OAAGLHBEMBEAhAEAKAHH...QABGhAAAeGCEEDCEZBDAAEAF.hADA.TCDDNCIC........hAEA......hAFA...,1,-20,-41,21
JcLFZTEAfdYIHSMKRUDaBGbCXWPNOgeQV,dCGEHFEFKFCARBBFDAHHBAGHGEGC..XCCA..WAAFhACAOCAF..gEBGhADAeGFCQABFhAAAJAFDLDDAZEFGEGAFAFAD.IAEFMCIF..hACA......hAGA...,2,-31,-10,21
GKXDOMbVTdUHNQacLSJYAFZgIRWCEePfB,FDFAZBEFRCBBCBFG...EHGAeBBBBACDGEEC.DAAAMADG..VGAAhADAdHABHBGD.aAADhAAASGHBJEEF.hAHAAAGFIBDD.fDDCKEHB.hAIAXEAC..hAEA...,2,-37,-19,18
BSZQFOgMKbDRGELCHAXeUNTWdcVfJYaPI,XFDEUCAF..TDEBdBAG..fFABaGGDBHCBQAFFhAAAOCFGKDCCDBCCEGFFHFCGhABAAHHH..WHBGhAAAcABG..YEHHIGAEFAGEMBIDhAEA......hAGA...,2,-28,-21,7
NdEeQZUKWOYgXRLcJDaTCIMHbVfBPAGSF,SFBBFGCDEHEG.eGFCUAAF.KDDAOBAH..XGGAhABARDDDJBCBDCIBCBFG.HAFA.hADA.fCGAhAEAADHH.dDBCWHFALBHBaHACMFDDBFGANAAH.YFAFhAFA..cBEChAFA.,2,-26,-17,9
ZIWXMfcPHTeYaJdDBRVGSNgbQELKOUCFA,ZACAXFBCMGFA......PHDETEFCeAHFJABHDEIHBDHHhAAARAEEGDBDSGBChABA..NHDF.gDDEhADAECHF.LFADKACECHCDAHIB.WCCD..hAEA......hAFA...,2,-20,-18,2
JGCKIgcWEFeHAONabUfMPVZLQSRXTYBDd,OFFEaACB.UCCCMDBEZBFCLEBE.QGEHSACChAAATGAABFDAJEBHGEGChAAACHDB.KFDF.IAGFhABA..cDFDFCGCAFCFfAEGhAFA..PBABhABA...,2,-47,1,48
IEVRCHODTBgdGcfeSaLJZUMQXNAbPKYFW,KCAEFEAAEGBHCDFB..DEACBGEF.dAFGGABH.eDHBLEFBhAAAUFAC.MCAE.NDIG.bEEChAAA....PCDDhABAIHHBHAGHgAGCfABFSGGFhABAaHFE.JHCE.hAEA...,1,-21,-25,4
GYIXBaeMJOAUQdPcRSHKZLWDNFTVbgCfE,QEGEdDCARBEFKADE.LCFGDHEG.TAAH..VCGFCGECEHAAhAAAGAAC..XDCBhACAeGAAMIAAAAHDcEAGhADASBGEZADGWHCAFEEH....gGGHhAAAIEEEBGCBhAEA..,1,-1,-27,26
AHULOdbQZXegVGJKfWEFMScCIDNBTaPRY,HCCCUGCCOACFdGBAZDGDeBBCGCAAKDFH..EFGFMAFA.CEAA.DAGHhAAABHHHaFEF..RCFAAFIDLAAFhACA...hABAXFCB........hADA......hAEA...,1,-22,-32,10
XgOYUESHbGVBcRCTWQZPMeANJFILKfdaD,FDCDKGACdCEGDCBD...OBBDEABDHFFEGBFCBGBGRFGH...CADHQCGAhAAAMIBCAADE.JAFEhACAIBAE.aAFGhAAAXGCF...YHFGSAHHhABAbCDF.....hADA...,2,-28,-26,2
KfdJEPBSAGRaOgYNQTWCLcUMIVHXbZeFD,GCAGaBEB.OHEC..gDFFQDGCCFHALHEEhAAAMDFHHGBCZDBADGABfDHChABAEAAEBCCDAEDENGCB.WADChACA..ICCFbAFAKGHBdFCBSAHDhACA.TGAB.hAHA...,1,-1,-11,10
FcATDRbgIZCBNeSMVdHYEfUWGaXLOKJPQ,DEHHRFEC....bFAEIEDF.CGEH.eBFC.MEIDdAAFEAEChADAUCCEGEAEaACCLAAFhADAOCEFKGHB..hAEAPHFCFHCCAAHFgBBANAEHSCFA..hBBAYAHB.XGFHhBBA,1,-19,-20,1
fcTDPYCHKNWJbdQSZXOeaRLVFGEBAUIgM,UFGEMBBB...TEDEDCDFCAGFHEFH.KCFEJCFE.dFBGZFAAeCCChAAALAAC.FHGEEADEhABAACCD...ICAFhACAfHBBPAFGNAIC...QGEAhBAAOAEBaFDF....hAFA...,1,-13,-26,13
ZGSRFXTIYUHNWAVcPdDOCQJeBEbagMKLf,VGEAdBBACGAA...eABABDGF.EFCB..bCFBMADB..KCCCZBFEhAAASAAFRFEE.hABATGAGIHHGYEBAhACA..NAEAAFAFDAID.OAECaCAB.fDHEhAGA.FDEFhAHA...,1,-18,-33,15
SXfIegREBaCdcbDLPTNQOZKAGYJHWMUVF,GDDCJEBBHCDHMCEEFBEA...SGHB.XGBHhAAAIHGERBBHBAHGaGDECCHEdEGChAAADEBHLABE.hABANDGAOFAHKCAGAIBCYACE..WHEAhAFAfAGBEDHH..hAIA...,1,0,-39,39
fcOZWGBYXPREIaAFgDLTJdMUSKCHVebQN,DAEELGDCdHBDUFEESDDA.HEAEVCGDeAHB.NIAF.ODCGhAAAGACFBDAHPCGBhAAARAFA...aBADAIHCFFCBhABAJFHBCGAD..QACCfCCC..hABA......hACA...,2,-31,-3,28
DAeGFWHUPNdaXLOZKcYRJQBgfSTEIbMCV,GACFFEHBUFDFdGAFLHBAKFGCRAAB..BCEA...SGHHhAAATBEAEABAMFFHCDDGAHAD.hAAAeDCGHAGD.aCCBOHAChACA..YBAF...gFAEhABAIGDBDDABhADA..WEFB,2,-27,-16,11
XYefRAaDVbQgSEPFTHINOBdKZUcJGCLMW,VDBHQABA.SFBDFAAFHFFBODHBdCGHZFFDUBDEGEDGhACACHCALFCGXAEGeHAEhADAAFADDAEA.EAGEIAHBhAAABFAG...JBAHWDDE..fFHChABA...hAFAaEEG..,2,-8,-8,0
dEZWSNDGgOMYACQTfRacLIbXUFHBJPVeK,QBEERGACLECC...IHFFXBAAUGCHBHHD.JADGeBBDhAAAKDGB.EBHBZBEGSGAHhABADFGH.gDDGhACAMCIDAFDHCDADaGDDFFGG..PDAH..hADA......hAEA..WAAC,1,-14,-27,13
OLTeRbaGBMZPJCADfdUSNYVEWQKIgFcHX,dAFAUCBCSGHF..NAFG.EEBFKFHDFGFBHECGLHACRGBE.hAAAaAAHBAHEZDCFCEFGAHIBDBAGhABA..VCGBQDGHhACAIADCXBGCeCCE.MAEH..hADA......hAGA...,1,-6,-23,17
VZcPNSbFBXUIfJWaRQCMYAOEdgeGKHDLT,EDCGdBGDeFCEGDFCDGACLHEGZBEF...NBIG.SAAHhAAABEAAUGAFJBDFRAAC..CAEHACFHKHBChACA.HDAA.VGFChADA..cECH.FBGFfEHEhAEAaCCA...MAFA.hAAA...,2,-16,-8,8
RJNgFZOAMcWKGDCVPESTbQLXdaBHUfYeI,MEBEKGGECBCB...VFCHECED....SADETGFCLCDGhAAAdCGGBCADHACC.fBABhABAIFCBJHAGhAAANCAEZEFCAABE...WAHDDIFG..bEEGXGADhACAaEBBeHDC...FAGAhBAA...,1,6,-30,36
FefLZYGOEcCRMDQNgKXbWJHBTaAUIdPSV,UFFHdEAASFFGeDAHLAHDZCGHGACGEGBF.CHHD.DAAC.QCEFhADAKFCD.XBBFhAEAWHAABCBD.AEGF.hAAA..VDCHFCEDOAFGMIEC....hABA......hACA...,1,-9,-28,19
HGPDFYWACKUeBZaOcQNIELfVTMXJdgbRS,CAHBeAFBBADBZCDH.OHBGQBAA..EFHFLFAB.hAAATGDEJBAFdAHCRECASGGFhAAAHDFCDIDCFFCCACGBKCHFhABAaEAH..IGFHMFIDgCCHhACAbBBF......hAFA...,2,-25,-3,22
geIcRPVSKNWEGOdMFLYJTfZCbQADaXUBH,DFBBaFCCBADCHECCeCEE.RABF.SFAF.KHECEAHHdFFDFGFGhAAAJCCHfDCFhABA.CDACAHHGUBGB.ICADhAAA.PHACNICHODHFLBEBhABA......hACA...,1,-15,-33,18
KQARMINGCWgHeTBELSbfYVdJaDUZOPXFc,RGBEMBAGGACF.CDCB.HDGBBEEBSEBF..fCAHhAAAYAHHdFEEDGHHOFAGhABAFCFHKCCEAHHB.NCAE.eGDEhACAEGCD.bCEE.aHAC.......hAAA......hABA...,1,-16,-22,6
NbRFSXCJaGMgPULEHDOWYeIdTZBcfQKVA,RFCEXFBCCBAB.GCFGMAGB..UBDHLABEHEFH.DDDFOCAHhAAAeBCFdHCFBCHGfAHEhAAAKHBG.AGHFFEEHhAFAJFHBaFADEHFG..........hABA......hACA...,2,-30,-8,22
AOQcgXDdSZKfPVeNMWCaUGbHEJYRILFTB,QGEDXFBDDCAEdBFD.ZDCFKAFC..VABEMBDF..CEAHUGAGhAAAGBGEHEFEJGEARBEFLAHHhABAFDAEBAAGAAEGOCEHhAGASHGA........hABA......hACA...,1,-1,-30,29
QLXPOGRZNgVWDUSBMIfAFbCeTYHJdEcKa,CBCATDACHBEEdFGA.KGDALFGB.XDDAGEBCNAAFVBCEhAAA.UGDBBAGGIBGHhABAAEIHFDEH...eBHHhACA.EFABaFABOADA.....hAFA......hAHA...,2,-35,1,36
UVYESQCRBFOTLZgJebGMDKHWAfacNPdXI,aDDF..PAHHdHFHUAFBEFDB...QDFHRACFBFHHOAFDhAAAZECFeDBDGDEE.MCBFhABADDIFKAADABBE.NEAG.IHHHhACA.SFAACFGD..FADFhABA......hACA...,2,-22,-15,7
eIYDdOTJgcbALPBEQMVXUKWNfGCFSZaRH,LAHHEGAH.MHCEVCGHKEDH....NFADGBCDSAEAhAAARGFAHCAAeCAADAADdGGFJHBGhABAgCEE.hACAAIFGBABB.QFACWDEHFAGG.aFFG.hADA......hAEA..OEAA,1,-8,-10,2
EBXRIYQLKbeVgAOUWDCNPHfTdaZMJFcSG,UAGGDEBACBBG.HEAB.dDFDaGDFZACF..FBFASECGGEDDBHAHhAAARFGD...QBDDhABAKAAGVGDGAIBGOFHDhACA...NDAEfCHAMDIBEAED...hAAA......hAFA...,1,-14,-27,13
IPKZXVEceHGDRfOFgLaMJbSATCQdUNWYB,TBCEdBFGUFAD......NFBDBGGHPAAEKAEHZFFF..XGAChAAAEDDGHDGHRCGHFCAHhABAaCCB...MIFCSBHBhAAACGDF.YHCGIDEF.eABChAGADAEBfDAGhADA...,1,-17,-28,11
XVfbHQDAYaUPZBSdRMCFeJWOGKNgcTLIE,aFCGZBAEdCEE.CHHF.FFAB.eAEEOCHDGGDF.KDGH..NHCD.TCADhAAALAEE.EFFAhAAAfCEF.hABAQACCAFBDPDAEBDGFSHCGMIBA.hACA..WECE..hABA...,2,-25,-24,1
MJZdIgLRNGafHYXFWPVeCETKBQSUAODbc,OFFGDAGHMEBFdFCALABCRABE..GCCFaHCG.HBGDFEFH.PFAFhAAACBCB..EAHFBAFAhABASCCGAGHH.hADAJHFGIGEB.NIEB.fCFEhAAA.XECAWEAC.hAEA...,1,-20,-28,8
EWgTDabVMSKUdBPZFYfXLeIJHOQcNCARG,EACCTCCFDDEA...aCFDMBHH..KGBFUFGFBBAEFCAG..XFFGhAAALFBGIAGEhABAOECGQAEEhAAA.NHABAHFBWFAF.bACG.SDHDhADA.dFDG..hAEA...,1,-23,-33,10
WMHePDdKfAQcTFOJLZCVGSgIERaNUXbYB,QAFCTDFB.FFGBOBBGZDFGGEDCSGGCECBB.RDCFUAGGhAAAXFBBBAEEMDAFhAAAHCABDACBKGBAAIHELHAAhABACHHA..........hADA......hAEA...,1,-10,-20,10
BeQMXDKPFJbLfcAYOEZHIdRTSGaUCWNgV,OGDAEDGDZCCG.HAGHdABCRACESFAC.aDEHCEED...NCIA.VEABhAAABHHCeHAA.MGFGhAEADBDCKCAF.FABDJHDGhAFAfGCEAHID.IDCF.TDFBhAAAWAHF...XGADhABA,1,-8,-29,21
GYZTHLaBEQDKVFgCMbJcPdUOXfNeIARSW,SCGBGGEHZDBALADBBHFGDCBDFDFDCBAA..MFAC.JDHFdFCEhAAA.XAEG.hAAAeCDBABGFRGAA...TFAFhABAEFEC.KHGCgAGBcEGD..OAFAhACA.fACAhBAA.,2,-32,-20,12
CZJdXIRFBYMUSbTecgENWQKGHVfDLOAPa,CACAJDBCdGDC..RAGHBBBBMEFG...UADGSCEG.eEADhAAAEGFB..QDFHhAAAKBFAHFGDVCACDFBAACADZGAAhABAXFBB.IAHFbFBA..gGGBhACA.NCIG.fEEEhABA,1,-17,-33,16
QMRHfDaTdBSCgOAWeUXcEVYKZNGIPLJFb,UDBCEEBDKDBCGAEB.LFGHJAEF.FDEEMFABRAAA.HDGHDEABdHCDhAAABEDG.CHHHAACDeFCAhABA..XBGEhAAA...VGDA..YDHHIBAAhABA......hADA...,1,-19,-30,11
LRPgNcKXDUaQVYWJbHCFAEBfOMIGTSdeZ,BCFFOCAAMFEAGEBGdDCCZAACLEDE.RAFD...PAHBhABANHDB.KAEADDIB..aDAHhACAQADE.hADAWAACHGECADDGIAHHeGAA...XEGHhBBA...hAEA...,2,-27,-13,14
LKXJPbUdAOVDRgHCIEfFZSQecBWGTaMNY,VBFBDIDCRCEDHECD..CGFA.ECAFFDBCZABC..eADDBAGHGFBHhAAAMCHB.LEHFKGFHJFBH.hAAAPHAC.dBAHADCG.hACAOEABIHHFSEEG..WFADhADA.aEHD...hABA...,1,-16,-18,2
BaKTHGICFYWMDSbVeURdALXJQfPOcZEgN,JEAFQFBB.OCBAEEHBBDHB.KCBETAEGGBDEIGEChAAAFGFC..MCFAhAAADEIBbCFD...eAHHhABAdHAHAFFCfHAD.cGGFNADFCABDSGDFhACAUDAB..hAIA...,2,-36,1,37
NUTHYJDfWPCcabRSdILBVFQEXeZKGOMAg,UBCFHAACDIDC....fHCFPGDGaCEESCFGhAAA.dGHEBHHAQFEAhABAEFBDeAHHKDADMFCGhAAAADDFTGABYAEC.CDAF.cAGFIDCBhABAFFBA......hADA...,1,-13,-25,12
cSXDPHgWOTCEaFRbUABefJNGYZIVLMdQK,BHHAeAEC.JFECGCGE.ZABFLDBCMGBCKEFFSCHBhAAADIFAHDAEOAABCADG.aHBEhADAFGAE.RGDGAIAE...hAEA..fAGHICFGdGGHXBAChABA.gCEBhACA.WEAG.,2,-30,0,30
KQMDIHbTcUZaAPeBJRSOLXCEGNFYVdfgW,eEBFRDFCLFADCBAE.ECADFACB.dEGC....gGCAhAAAQCDEMCCBICHBhAAAbAEC.TGCFUGGH.AAIDBHFAhABASDDF.XBGEYAGDfEEGhABADEIHcFDAaBBGhACA...,2,-21,-15,6
EPCKYUSLQbJNeBVgaXDOFZRHfGAMTcWId,TAEB..IGHBEEFB.KDFDUGABLBHFQDGBhAAAJEDFBBEFaCDBDDACZABDREABfEDAhABA.AACEMFIHhAEAdGFGCDDBSGAD.eBAF.hAGA......hAHA...,1,-22,-25,3
IGPOeKZBSNFMYCEfVbARdXHUcJLQgWDaT,RBCGXDGCUGBDLAAB..QBGADEBE.IEBDhAAAODFHKCGASEDDhABAMFBG.CGGAEBBB.VADDhACAAHEEdAGHJHAAaHFE........hACA......hADA...,2,-36,-12,24
YKOZLPBfdWbTMCcEGaFXAeRgQSNIDHVUJ,REACSEGBDDEHHABGUFFFKAGEZCCG..LAHBBBHAdACB..TGBAhAAACFACEBAH.GAEEhABAaGBB.AEGAQCABhACA.NIED.IFFB.VGCG.JECEhAAA......hABA...,1,1,-30,31
GKZJQdDFaNCEILBWbPMgYTOUecVRAHSXf,SDGDXCGAKDBFZDBH.dFAEFAGF..CAGALADFBABF..hAAAPEFFMBABTFEEhABAUADEeDEF.RGCGABCEfHGBhACA...JHCCDIBA.EHGCIBEDhAFA...hAAA...,1,-16,-30,14
RgecbCGDTLaJFPdZIHVOXYBWNQAEUfMKS,ECCDMEEDKGFHRGFC...eFCCCHBHGCABLBHHFFBG.dEAFHACE.OAHDhAAAXGDDBFFFQACBhAAAAEIH.SBAHhABAcAFD.DAGBaABBJHAGIDGChAEA..WBFD.fFGBhADA,1,-9,-25,16
YSPJRKTGIdaZUEALQFfgeCVcXODWNMbHB,LBCGFDCHeGEE.CGHB...XGAFOAAGDAHFMEIDBDEC..hAEASAAFRFAFKFFH.hAFAGBDCIDGFdAFEaDHBhACAEGCC.fBBB.gGDGhADAcDBCNIEB.....hAGA...,2,-40,-4,36
JLVEbPBAGQCXgZMcKFUDITWeYRHSaNfOd,GFADXEAAZDDEKBDHDIFG....IHAGTBCF..eEHHhAAARGDGSBAHaHEG.hABAOFEGLAEBEDGGbABFhAAABBHF.ADHFCDAFcAGFFFFGWHAA...hAEA......hAFA...,1,-12,-29,17
XZAOdbHeFQLcBaEWPGSMfKCNIJTVgURDY,OCACHDFDFGHHLAFABAAAEFDFGEBC.SEGGMDBFCCHC.hAAAIHAAVBCCRAFADIEAhACA..XGDHhAAAAIACdGAD.eFEGaFFH.WCCEKEHB.NBAF.....hABA......hACA...,2,-20,-9,11
aOQRfSDZLIbeJFMGHWEUKXTYcPNACdBVg,dAFDBAFDaGGBQGEF.RABC.SDFCLFFCeECFJDBFFDDHhAAAMBADHABGUAGCTGCHhABA..PCDChAAAAFFGCFHBOBHFDEFEIHHH...WEAHhABAKGAH......hACA...,1,-16,-17,1
DZVKOFBEITNMJQdeaYGWRCSALHUgcPbXf,UBBA..PGFAXCEDDFCCKBBF.FAHHEGBH...IGGChAAATGCG..JEAHdDGAhABA.eECGaBEF.WAEEhACACEGCADEBLAAC..cDAH.fHCFhADA..hAIA...,2,-37,-34,3
DKQRGeOaXEcgCBNZUWVJTdAfPbYFMHILS,...bEEEFGCH.MBBBLAAEKHGEGEEEaGEE..EDDECEHBZCDBUGBHhAEA.JCECAAHF...fAHChAFA..hAGAYADCIHHCDAAFeBBFOCFC..hABA...cEBBhACABDCGNCIG..,2,-42,-1,41
fLeFGMIYNKaDSPcCXEObdJgHUWVTRBAZQ,QDBHeHFAFAEFGCCAMGCC....IGAFKFFHSAGBhAAACBAGOCFDJBAF.HBFBhABAUAFH.TGGBAFHD.hACAfADGNIAHDBBC.PHDC.EDHBdFEChADA.WBHHBEED..hAAA...,2,-23,-6,17
CXSZcRObIYLEMDgNaQWVGHKTFBPAUfeJd,eCEGJAAA.dAEFCGAH.ZEDB.RFFF.ODFD..IABHLCHDMICChAAADIDG...aDBE.hADA.QAEAhAEA.VDCDKFBEBHAHAHGDfAGHSAGHhADA..cCDFEBCH.hAIA...,1,-27,-34,7
YDOeIEAGRdHfCScMbPFLVQBWTZKNXJgUa,dCDAHAEDSGGDMFFHFCGGLBAEBCABZAGFKEFCJECB...UFDAhAAAaEEGDHGE..OEBDhABAIDAFAAIDRADGCCCG..hACA..cEGD..PDAHWHAGXCCGhAAA...hADA...,2,-28,-15,13
WVdBPUGXYIJDMfeCgbZNAHLKQaOSREcTF,KFFDQBECOAGF.ECCAFEDD..dGECBBEEGEAB..IBAAhAAADBIFfGGGhAAA.CGACZBABAICCHDACSHBEhABATGAGPDHFYFFCeDDE..hABANADB.aHGE...WADChACA..,2,-23,-17,6
HIQBANDSFLVdTbgOeXGfECJKUPZcYaWMR,SGAFFDDALEAGdDFG..TEFHOBCAeHBGGBAE.CHGDKFGBhAAAPAAAZFCAaHBEMFIFhAEAHCCBBBDB.NAHGDGCChAFA..........gAFHhABA.fBHChACA,1,-10,-33,23
cFLPOGeWAKTRZXbMHgSYNICVfaBDQEUJd,TGEERAEDZBAG..MHECHCAH.SAGA..IEFDhAAACHCBfDFBDDIBQDAHhABAJAEBFBBAOFEAhAAAeDDFAIBCXGAD....gAGDhACANEIGBHGH..ECGG.hADA...,1,1,-35,36
QYaSHERXNKfbCPMTDcJWAIdZBUOGLgeFV,ZBFDUACBLECFeCGHFFHHQFFA.SCBCRDAFKEEHCGDF.hAAAMAABDDDD...WHEGhABAACFHBHBE.OBABhABAgGAD.aBEFXAGENDIG..hADAbCDH.....hAFA...,1,-5,-39,34
bYZBEaTUDeGQLRWINAOPSXJfcFgCdHVKM,SBDAJBEA.FGDEdCCCHDAEKHGCMFAEZDFFBBBH..aFFBDACAhAAA.QDDChABALGAARAAANIBD.AEEH..ODDAhAAAPBHB...fGHCCHDH.bFAGhAFAEEGE.....hAGA...,1,-16,-32,16
HGWSZJAIDbCTBUMgQcYLfFdEROePNaKVX,DDDGCFCAUFGCQBAA.LFGHFCEGdCCERCAHeECH...aFEHhAAAKABCHBGHGEEESEAChABAAHDE.IGAFhACABHCGMAIBgADE.fFFGhAFAOBGD.NEIC.WFADhAAA...,1,7,-43,50
fGSCcHOaMVXDbELRTgFNdZIQUJeKBYPWA,SBFBCCABHGAG.OCCAaFFF..MDDHDEGDEBAHLBFG.hAAATABEFEBGdHDDIFAChAAAQGAC.eAFEhABABEGEWFGHAEACfFEG.cCDAhABA..XFDBhACA..,1,-15,-34,19
ISWRDBLHXMTVbEKAJYQfgGUPcaCeONdFZ,QEBBGDDFUFCCaBAFCGHA....OAFAdCDHIGAB.hAAASACGDDBHBGFGXBBFhABATGEBECHFACAF.hACAfHBH.cEGDNIDDFBGH.WAFBhAAA......hABA...,1,-29,-33,4
AdXKaRNfWDMCQSVGeIPbEUTYOcHFBLZgJ,dACDKHAGRDCA....fGHEDAACMDAA.CHAG...QBFHhADAGCFCPDADEDGBUGGGhAEAOFCHFAGABEBDZCDBACCCXAGAhAAAaBBA.NIDBSFFD.hAFAIBAHbFBE..hABA...,2,-22,-17,5
ZCFELPgRNYOaDdbIKQScfTVHMABUXJeWG,UFGEXGCFeCADGDEFFDFE.LAAERFCB.OCBFdCDHKAAHSFDEhAEA.fHAFhAFATGABMIEAhAAAABBGWAHHCAGD..EEEBgAFAaDBF.IGHBhAGA...hACA...,2,-28,-5,23
UNRbecMXaBSgPDfYTZFEVWAICOLGKJdQH,CCDALEDCGAGGdFCAQFDDHFFA.UBDERADEeAAFMCIDBDEHSHEGhAAADBCB.TCAAhABAEGEBAHHDKDAB..JAGBhACA.NEAE.XFAC..aGHF...hAAAfBBD.hACA...,2,-17,-7,10
fNCSAaRXWZKBFTMDYLIOJQgcdeEHbUPGV,RABFZEDFFGEGDDFGLAHD..IGBFOFAH.QAADhAAAdADEEFBCHCEFUAEF.VCABhACACHHASGCH.hADAABFEaAABKFGDMIAA.JAHFcGFEeHFA..hAFA......hAGA...,2,-17,-11,6
MgBZWAGXCaDPIKHJVLSeYfOTRNEUQdcFb,GGEHaFGF.DGAEKABCHADCLDFCeDEGOCBBRGAGUGEG..QCCChAAAFECCMABCBHBEhAAAADBG.CFFF.JAEASDGEhAGA.fAHEEFCA...cBBAhAIA....hBAA...,1,-15,-27,12
NbZRTBDaHgYCGQScFAfdLJXIMUKEePOWV,LCECXBAGUDCEEHEE..eACA.OCAANBFE.REGBDGAGaHBEHGFChAAA..YFDDhAAACHEGGBGE..SDAHhABAAEACfGBHIAHAMAFGWBBEhABA......hACA...,1,-19,-22,3
fZOMWdIDPbHJKFXTegRNGaLVBSCYcUQEA,OGAEMEHFdAAGDDFGHFAH.FGCDeCBH.RDDBGGED.aBAFBFEBhACA.YCCHhADAUAEEADIB.ZAED..IACChAAAJAHHXGFH.NEIG.SBGEhABACBDE.EFGE....hAHA...,2,-24,-12,12
OLEgadNWDVIXTGSARUMbCfcBJYKQeFZPH,MCABCBAABADHKDFH..eBHHFBBFHFAELEFDEEHF.dHBB..DCEHXAGFhAAASHCEACEHUGGChABA..fEBDhAAAJCCDZFAE.OABANEEG.IAHB.hACA......hADA...,2,-22,-22,0
APHKBTQUbYEMDGOJVCSZFcILNdRaXfgWe,HFFBKDACQDGDUDBGEAADGBEE.OAGFCBBHSEEHhAAA.FDDBIACEhABAdABFXBFBfGADhAEAgFAEAFIFBEHC..YHFADICG..hAEA......hAFA...,1,-11,-33,22
RDZLJefGUgBQVOHcaPNWTYSCbdXEFIKMA,DHCEJGAAGEEBUAEABGGD..QABEHAAH.aHGE..NBIG.hAAATCDBCEDC.bADEXCCGhACA.ECGHKAHDhAAA.MHEAAHFF.LEAA.fBAGhABAOFEGWHAG.SGBChADA,2,-33,-16,17
SPDdGLCAcWaQVZgJHBIOebKfETNMRFXYU,aCDFZCADHFBGBGFB.eFEGKCAG.EHFC..MDFAFAHDUAEH.SBAChAAAdFHCLHAEADAD.hABAQAEEJDEG.hACAOABGfHAHNIEF..XDBAhAAA.DEFCCHECcDCBhADA..WGBE,2,-24,-14,10
ZJEXaGDCUVfIKcOQTgPNHYRWLbMFedSBA,JFFEaBACGCGG.DIFECFDAUAAG..IADDKDAC.QFDFhAAA.TGBChABAgAGAHCDBWAFBhACAMCFHdGADBGHAAGIHEHEAfAHE..hAIAcDBD.OAEGhADA..,2,-42,-18,24
BbWVeAHcfDGaPKLMUZXTgJYCRFEOIdNQS,HFEDDBAGGDDCaBFGLCCBMECH.ZDAH..TDGDJABARDGDFAAHOACGhAAA.dGFF.SHBGhABABHAD.VAFAhAIAAIDAcCEDKCCE.........hBEA......hCAA...,2,-20,-18,2
GJTYdDeVLRacNXUgMWFHQPCSOKfEIbBZA,TDCFdFABeFDG.LHDERABD..NHCF.XCBBUEFG..MAFEhAAAFBGGQDEFhAAA.SCADhABAfEACEHAGbCFAAEIFJABEDIGAaADC....hABA.WGBCCHHGODGDhAFA...,2,-17,-10,7
gYdHMefEaVDBGIcLRWKbFQZACJSPOXTUN,SFDDXFCCUAGA....gCCDdBBGMHDAEFAFVFAHhAAABEEEGFEHLEAEhAAARCFEKADAFCABAHIFCHGHJCCAPAFAhABA..OADENIEH......hABA......hACA...,1,-3,-23,20
KIOHaVWRANbgJTYSeGMCBdLXDEUQPZfcF,...NFCF.JBDD.SGDAGCDDCGHDdBEBDEFG...EFABUGAAQCADhAAAZABDFGGDKAHDOHEEhABA...aCHF.hAAA...WCHHAAIHTABAMFDGBBFD.hADALBAFfGEFhAEA.cEGA.,2,-32,-11,21
JCEBSKVaTARIcYMgOUGNDbHQPZeXdFLfW,REEE....IEHBMEIBOACEUCDDDGGCHCECZCADdDCEFBHHLHAGhAAA.JDABCACEBHAAhAAASHEEaGEFAGAH..hABA....cGCH..YGBEhACANBGE..QECFhABA.,1,-13,-41,28
KARBZETIgYDLOFCfdUWSaXJMeGcNQPbHV,BBGDTABA..IEEGDDAHLGBA.FGFFdCAGUDCASHGEhAAA.XDGDhABAMAHBeBFHGGABNAIG.hAAAPCCD.bABAKBDAABIB..EFAAOFFAhABAWAFDaGED....hACA...,2,-24,-17,7
QYVNXPfCIBASGDWMHLaKRceFEJTdObZgU,SGFHGBBHMHBALBCFRDGB.FHAGTEAFOEEAZFEBQAEAhAAA.NCIG.fAGGhAAABHHG.ADEBDCADhABAWDABKGGF.EABAbFDB......hABA......hACA...,2,-26,-15,11
YdOVMWaNXGIcATJeDRQgSHPKFEZBLfCUb,JHEAeEDE.QGCBHDAFKEEFZADABFHBLCHFCHHAUDAA..dABEOCCEhAAAMAEE..aDGENIAB.hABA....XBGFhAAAIBBAAFDBDCEGSFCHFGGB.fGGBhACA...hADA...,2,-22,-21,1
bARfDQSMdPGYcTHgUNXFLIZJeaCWEKBVO,DGHFMBHDdFCEGAAB..TBGFUGEAFDADLCEHZEEC.JACCCGACECEEhAAABHAC..VGBAhABAABBGQCCH.hADASEGFcDCGNAIG.IHFD.aAABhAFAKGHB..OEHFhAGA...,2,-33,-4,29
ANFCcKLTfDBUOWQIPegREYJaVXSdbZHGM,CHGGLADADCDF.UCGGOADGQCDF.eCABEGCDaBGBXEFChAAA..dFGFbGDGhABAHEDF.ACAENAICcECFhACA.KHGATABFfHAFBHEAICEEhAAA....hABA...,2,-37,-2,35
fBNFPcgKQaWGdOMbCXHVYZDUAEIeJRTLS,eBDGRBAHLDGHBGFDFEFC....gFCFQBAHaDDEGEAEhAAA.dEDEOAHDhAAACABEXAFAHACCZGEAhABADDIFAIHCIAGC.SFADfGGBhADANEIG.KHDG.MDDC.hACA...,1,-12,-16,4
gGKCHTcPOWLMBAebaXDQZUFRYJdVSEfIN,aDDFXBABZEAC.UGEHFAGC..RFED.dBFH.EEAB..IABHhAAAGCCHKGBHCHDA.HDGBTADHhADAOACG.MAIDhAAAACHGDIGG.JDHF..fEBDNCGC..hABA......hAGA...,2,-27,-12,15
fHPUYVLJNMQZbFRTGESWCADcdgaXKOBeI,DHDAdAGAaABAKBAGBAGF..eFABHCDHUDGGLDBDMAADZFCAREGD.hAAAGCBFSFADhABACHHBABCB...XADAhACAIBEBfDFC.....hAEA..YCHHhADANICB...,2,-32,-17,15
PKCEfcMHTAXGYVSRJNaUeBDFdbgIQZLWO,XFAAVBBF.RDCC.JEBF..UBBBDAFE.dDGF....IGEEhAAAQBEBLEEChABAPFFBCGGB..EAEBMACGhAAAAIHC.SAHFeBHDBACB..FEHH.hAIA......hBAA...,1,-15,-36,21
VZdSAQGegYIELPfMFXUTKDCBRWaNHcJOb,eEDA..ICDCEAGDLCBEMACEXBFEUGCGDCAFBHHGhAAARFED..aFBEHDBEJEFAOBBGhAAA.bGAGdFGHhABA.AFBD.QGGGYBHBfABHhAEA.FHAGCBAD.WAFDhAHA...,2,-16,-8,8
cfLVaUNQXAeYRGFbWBDdgTEMJSKIHPCZO,RDEEFCBABCDGdDEG..EGBGJGCA..KBHHHBABZFGF.OFAGLADEUAGChAAA..QGEHhAAAAIGE.eCEEbACCDIBGhABAMCAB.SHAGCGGH.fEBDhABANEIG.....hADA...,2,-28,-9,19
DgFSGbLPACWIdKcOVMREXUfHeJaNTBYZQ,CGDGdGDBKECEOEDG.RBFA.EAGF..UBCCeHDA..JHACaFAHBDADhAAAQBCF.DACAhAAAFHGEGBEGLAFChABAAFGAICHFMFFEXEAAHBABNGEB....hACA......hADA...,1,-10,-28,18
dRAPMEZCbUQXeDWcJGgOIfBLTYVaKNHFS,EBAHZBADCHAFUDDB..QCCHDCFE..JEHBGFDF.OBGFhAAAfGBFLADAhABA..TDAGhAAAaFCGNEIAFHFESEFHAFADMIBG...eAFG.hACAcABF.IHDEhADA.,2,-47,-7,40
ZPFMSUXRVQYcWCeDKdTgaJNLIGfEABHOb,BAEGHBGHOGECZFFCFCEF.MIFAUGAG..XCEGRCAH.VCABhAAAQGCA..hAAAcFBGCCCEDAHDdHFDgEFEhABA.aACB.LAFEIABE.hAEA......hBAA...,2,-38,-8,30
HDGBcZLfaTdMXSVIWNgCPQRUFAKEeObYJ,KDHHeGFAOEDH..bFCDHEFHBDBHZCBCLBFEaHAG.TEFEhAAAXADF.VAFEhAAAIGAG.gBDDhABAPHDC.........hABA......hACA...,2,-22,-22,0
YbaGTOEVJdRFWIPCQLNUAMKcXBeDHZfgS,MAACKEEFBBAGDFEAHCCHZFAH....SCGBbBFH..aFBChAEAOBDHEGGC.dGGAFHBEhAFA.IBEGCCBAQBEAhAAANAICAAGE.eAHBfDBE..gEBBhABA.TGEFhACA.,1,-12,-36,24
VKIMcaSgCATLJODZGNeYQbUEBRdHFXPWf,TDBCOFBGDBDG.ZFEGeDFD.QBDGUAGCBDCBHGBEFABH.hAAAPAGF.fGEBhAAAIDGDMIFAhACAcDGH.aGAH.CABDADAHJFAH....NIDD.ECEBhADA......hAEA...,1,9,-38,47
RINDQaJVfKcZGbOFBCWAdXPYgeLHUTMSE,dGCBXDBF..gBBDeGECLADGHDCCMFFESDFGhAAARAGBDFBB.QBGAhABA.JFAFKGHDZBBAODABhAAABEEGAIEEPBDCYFCBEHEANACBaGHD..hACA....fDFDhABA,1,-6,-14,8
WINKJLXdPTFeAcaZgOSDGbUCEMfHVQYBR,aGGBZBADOFFEGBCEUGDC..MABGHBGFQBFEBBACIFBAhAAAKFAEJDDD.dEGBFAEAhABAACID.SEFGhACADHCACHHE.EHAC..fHADYDADWFHHhADA......hAHA...,1,-15,-30,15
cUGJYfVXFeSKAbPZIRWMLdBCTagHNDEOQ,ZGEAREAGLCDAdDGGBAEECABC...aCAEHGFE.EADAOABEUEFB.GDCEhAAAJHBE...fHADhABAFAHFKGADACCD.ICEDhACAMAAF.gBGEDECC..cAEDhADA..XFGAhAGA.,2,-33,-13,20
IMLHFQRWBJKXGAPNgeCYZOVdTaSUDEfcb,...NHCB.CFDDZBGH.dGFHTEGDUADG.DCDH..EDDD..fBGDhAAA.ICFFhABAMICGHAAH.RGACBCFHhAAAXACAACCDeCADVCADSAGEhACAcEDGFGAB.WAFCKFFC..hACA...,1,-14,-34,20
OAQaSbIMBEfeYGPZRXNgLcVDUCJFdWTKH,QCDHaDCB.SHEAbFED.BGBFeBFBGBAARFAGNACF.hAAALDGDDCBA.CAGDdFCEhAAAKDHHAHADIAEFhABAEBHHfHGDPEEB.XEDB...hACA......hADA...,2,-17,-15,2
XJHLPEYaOUdIFQBRTZcgeVCbfAGSMWKDN,SGCEMDBGDHEC...XGFDLEFGEDABOAAC.IAHAhAAAQCFHBHHEhACARACEcAFAeFBBCDHFAAEAKFHDhAAAHAFBYEDAdECB.TBAE...hADA......hBEA...,1,-5,-23,18
UTNGHRAIXJDFPWdMacBYZLVOeCSfgbEQK,JACHFDCBdEEA..aEBGBGGC.ZAEAOHBA..SACBhAAA..gDFBhAAAQDGATAGEhABANABARGCE.AFCAXADBDAFGMIAA.cGGF.YFEHhAGA...hAIA...,1,-27,-36,9
APeXdfDVRBTQHFJMESNUcLaGWYCOKgbZI,eEEHdHBDDAHBRCDABGAAHEEAMDCB..ECADUABFLEAAGGEBCHGEKAGAhAAAZAFHACAD..XBBBhABA..fDDChAAAQDGDSEAD.NAIAaBEFhACAWHCA.....hAEA...,2,-24,-18,6
RJCUDTZOLdVMfEWecPKAHaSGBIYQgbNFX,aFBHBHDG.QACB..gCFFFDFCXECHCBBDTADHhAAAOAAHdDAH.fGFHhABAEAGFeFGFKDAGAHEHSHFAhACAIFACNCIARFCADAFG.....hABA......hADA...,1,-15,-27,12
gOSKDTIZQYBJeFUHbVARdWNLfaPCGXcEM,RABFdBBDLGBGaCGA.GDDBEGBB..OEBCSFGBDHDAZADFBAHAhAAAFAGE.UEAHHEGFABAD.hABA..fEEDhAAAXBECMDIDKCAD........hADA......hAEA...,2,-23,-17,6
GJVgELHaCOSPFUKYDdMcefXQTNRWIbABZ,BCEBZGAEJEBCEEEH.HDGD..OBABSADGUAFE.DBAHMEGHhAAAeDCB.QAGEhAAARCDG.bGFEADBC.VFABhABALEHDCDDB.FHDE..KBBA....hACA......hAEA...,1,-3,-33,30
HfDXUSNQEbZdMJFgKaBCRIeAYTOWPcVLG,TBGGOFEC......PCDAVCCAGAAFDBIFUEBDSGGBhAAAECAG.dDGHJAAAhADAFFBFKHFGBGAGRGACAEAB.cFEBhABALEHB.XAGFNADH..ZFCBhAIA.aFHFeEEE..hAEA...,1,4,-17,21
KSPWMQDJUXLVBYFRGEebTgdfcANCIOZHa,CBDCOEFDZGAAHFDHKACF...SDAAMDEFDCEG.UAFFLAEGhAAABCBFFDEGEDAG..TCGEhABA..dFFEAHHEIFHGhADAaAAG.QFAB...hADA......hAEA...,2,-32,-22,10
WVBRAOYdKZPIDTGQCSUJFecHNgLMfXEab,OBFGdEFHZFCHDBABGCAF.QDGHCCEH.JFFFeFBD.HBBGhAAANEBA.LAHDhABA.MAGDfGDEhAAAaGHH.WBACBDAAADFGKECGTGEFSAEChABA.....hACA...,1,-13,-25,12
aNKREMYcSfeFUZWAgQTOHLIVBdXJDCGPb,TDDGLFBG.BHFFJBEA.DDCGGABE..aGAHKCHBEABAMHEAhAAA..SDBGhAAAFEAHZFDGABAGOHAEIAEBhABA.dCHECDAB.PHBA.RDFBfHGHhAGA...WCCEhAHA...,1,-22,-28,6
cbQaFAEDKGSOHRLTJMWZfXeCVIUPgdNYB,ECBGDFABKFEFGFEHHGFCRGBCLBDC.MEFEZCACXGBAhAAA.VBFGIDAEhAAAUABHdEBCBABH.bAGB.hACAFECAAIAESDFD.OAEGWFADCHHChABA......hADA...,2,-14,-10,4
VFCeXABRfZHdOPGJUSLbEaNDgYIKWQcTM,RBFCZDGBdAEHOHAEGBADUCCHLFDE.EGEFaBAD..DFIF..hAAAIEAGKHAGQDBBhABATACD.MEEEVFDDhAAACHGDADIDBCFB.fAGD...hACA......hADA...,1,-14,-25,11
cgAJKSbaQOTLZYMDdEGXfIFCUWVReHPNB,JFHDKCAA..aEDFQDGCLFAG.ZBFEMIDCdFBBGDCB..hAAAfAHAFABCCHAB.hADAUFFB.RABGPBFDhAAABEAFgBCAADHG.SFFDhAEAOHAG.DAGEEEAE.WEHBhABA...,1,-13,-24,11
OdfWJBCIaEFKDReMPbULSgGXHVZQYTcAN,ODBEdEFGJADE.BBAA..aHCEEGFB.FEHDDGBG..eAGFMCCAUFCGhAAALFHH.SBHFhAAAgADHXDAGhABAZABBQGAE..cABGhAHAAFFE.fDDChAIAIHHE...,1,-15,-42,27
dOPcMWGUHCbgaVDISYFeJBNATQKZLERfX,QBEFKFBCLABCEBAGREGF..dDCDOFAH.MEHHUGDFCACG.aBGAhAAADFGD...SHCEhAAAFGAHBAFCTBCEhAHAfEEF.cDAC.HDCD.gBGHhABAIEFC..hADA...,1,-24,-30,6
PJCDNBULcGdVRYIMQfgHAeOESZWbaFXKT,EEAHZFGHaDCDFDED..KGCH..TAEG.CCHC.DCGABBBHLCAEhAAAdBACRGAA.MAEB.QGFGhABAHFEBADIDSEABhAAAXEGA.PCEH......hABA......hACA...,2,-34,-18,16
QPBVcLZSfDKdTENabXJUFgHRICAeYOWMG,OAADMIBAGCEHBFFDLADDZFCADDAFKABAdHFD...EGDD..hAAAaEBBXAFGFEHHRBCCAIHE.hAAAeECC.QEGBhACA..cEEFTGAENHAH....hAGA......hAHA...,1,-20,-24,4
TOECSLDRUHeQFgdKAVfbBPIWGXYaMNcJZ,VDDGBBGG....IEAFXDABMDBA..JECHZABETBCEhAAAEHBCLGEA.hABAUDGDQFGHhACAFEEFKECBACCEfAFE.WAGHaAAGcAGAhADAOHECCGAF.DCIF..hADA...,2,-26,-21,5
ZVHgYPeEGadAXNFfBTJLUScMIKRDObWQC,FEGFTFAGUCCD..SDHFMAGD.KFDGDCID..ODDEhAAAQFBBVCAE.HFDBhAAAPABCEAEDdBBF.AHID.hABAXAFDBDAC.JHBEIHAEWGFA..hACACAHA......hADA...,2,-27,-11,16
gERCfZHAUabeYNcQVTSJGFWOKDPXdBLIM,UDEBaDEH.eBAE..NCAC.QAFH..VCBHJEHDFHAGhAAAOGCEDACG.dBFELDBDhABAIGHDMDDDRDFCCABB.hAAA....fFFEAHAD.cGCEhAFA..SBHBhADAKHEA,1,-29,-36,7
WYEDSZCTOPaeRMLKXgcNBHdfbFIQVJGAU,UBGCEDHBDEEACDEG...OHBGeBBDLFBD.KAEFXCBBhAAA.NGAB.dHEFFAEHIFGHhAAAJHFC.ABAFSFDGhABA..PAFAMAFGBHHGhACAfCAG...hADA...,1,-34,-35,1
ABLEFOQcHRPgZbSJMKdUeTIfGYWCDVaXN,BDGDFDHDQCBAHFBDRCBGZFDF..JAEGdBBFUGDEeGFE...IBFHhAAAGEAGCEFFDAFAaABBhAAAAEEA..LEAFhABAEAHHOGFE..........hADA......hAEA...,1,-20,-24,4
dXHYKDPIQAEFRJCSMOfNcWUVaBeGLbgTZ,FEDHJEFB.CCCH...OFCH..NDIE.UBDGBAGCLEHF.hAAA.TFAHZAFHdBABHBADhABAKAHHDAAGQGEEhACAAADG.SCEHMIFG.fHBHhADA.WAEFeDCBbCFHhAIA...,2,-34,-29,5
STbeJAHZMNfKcVUaRYIBFECPGXWLOdDQg,MCBGKBFDUGEAREFH.BHHHEEDA..GAEFLHAADCAH...QACFhAAASAAGeBHDhABAACHBHDABZDDA..fDAAhADAaGDDIHHCCEHG.WDDCOFACdHAB..hAFA......hAGA...,1,-8,-25,17
HBZULEYXAQOgRfWPINKVSGebCcTFJMadD,QBDHREBB..PACCKFFCSHAGeBHF.CCAHTFBEhAAAJFGHMFEF..DAEAZCCChAAALEEDXAFBAFIHfGHEhABAIBAG.NACGVAGH...hABA......hACA...,1,-9,-31,22
AGSFcPeIbNUZXaWOdgRJDYQVTKBCHMLEf,SFEHFCDGeCAD....IBGFNBCCUCGDZAAB..aGFAdDDDhAAARAABDAFAQGBFhADA.KEGACHDEMIAGEAECAGGH.hAEAPDEE.XEGA.OEBDhAAA......hACA...,1,-19,-29,10
RSAZKFHXcDMBENgbCIfOPYLUVTJGadeQW,KADBFCBDHBFHDBFDBEDEEFFE......gEDFIEHH..hAAAOGDEPCHDLAGHhAAATFAB.GBBAhABAaAEGdABFQGGCSHAAAIDAZFAFMHFACCAF..hAHA......hAIA...,2,-24,-10,14
WHIQTdOPKMJEgFZDYNVabCXUcefBSLARG,RECCHDDGQBDAdACAOHFGKBHH...MAIDEGGBFAABDGCD..VAFHhAAACCBDUEAC..fBAAhABALHBGAGFBIEBChAEATEGB..gAFHYDHF..aBDDhAFA......hAHA...,1,-15,-22,7
AGCMHYDKFIXBcRbEJPOaWLTgNdSfQZUVe,CBGHHEDGDFAD.KBGC.FGCEBHHHRCBG...JADDOABA.LFHBhAAA..gFFChAAAdEBGfHEFZCBFeDHBhABAADIBMFAD..IGDF.bAEDPAEFhAGAaDAF..NIAH..hAHASEEC.,2,-35,-9,26
gPBYQTeAUdLOFGJSVbDMEHWRfXacNKCZI,LEDGOACCGDCGVFAH.DFGCHCBH.RADF.aBABKAAEZEAF..IHDFhADABGECQAGChAAAACIDFHFA.SCDBhABAMAFCEDGG.fGHA.cGEDhACACFGH.gCGAhAEA...,1,-10,-22,12
eUBZHJWgLbDYfCaFIXEGVMSQTAKRPONdc,KADEOBCCdDBAUGFEZDFCHDAH...JFFALDDFDADA.CEHCFGCHhAAAEAHBGGBH.SDDFhAAAAHADRAGB..hABANCBB.BCGB........WBAFhABA.....hACA...,2,-42,-25,17
gXeBfRKHcbPWJLSGYQUEVNCDIFZaMATOd,dGEFXGCCBAHARGAAKFADHAAH....PADHLACB.SBFHhAAAQAAGEHGAhAEAVBFCCFCB.FGFDMICChAFAAEGFgEDFeEEE.cCAD...hAGA......hAHA...,2,-19,-17,2
LbFKCPDYSaeITHUBWcMZNRAVfEGXJQgdO,EAEHJACH.dFCDLAFE.KCEFDCAB.SEHBeDHFHEBDBHAEhAAAMHDGZBFE.ABBGGGDFhABAQBGCODCEFAABCHHBhADAaFFA..IFED..WCAHNEAE.hAEA..fAGHhACA..,2,-21,-19,2
DMeWbdHJGRUgQTZELaAISFYCXPONcBVKf,SFDBFFFFCBDA.OEAGBHHDKAFD..MBIFeDBBdFFHHBGHhAAARBAGQFBHZABHLHAGhADAIHHE.PDDGhAAAcGDFDGAH.bADAJEAH...gDEChAEAEHEAADACNABF...hAHA...,1,-11,-18,7
BQDgfMeaWNXRbdUYFICVGOcSKTEJPZLAH,BBBCDCFDMCBHaFFD.....XCCEdDDAUBGHFBHBCEBDGGABhAAA..SGGEhAAAKADDEHGA.JACE.LGAChABAAFAB.gGEBWCEBRDGB.IEHChACA.....hABA..OAFF,2,-34,-18,16
cfeaTdWXLBKPAbDFMSNIJRQOYgUEGCHZV,DFFESGCF..JAADQCAHOBDHUAFEEAFHHFFF.hAAAVDDAeEBGdACGXGDAhACABAHEADHGMFAE.hADAIEHHgGGA.CDGD.fAAChAAA..WHBGKBGAFGDDhAEANEAE..,2,-44,11,55
daGeIAcZEDJFfMHbYCSTWPKQBgVOXLRUN,ECFDDFCBFAHBHBBG.CEBH...SAFF..PHFABAAEOGEAhACAXGCFUDDEhADAdAEDGEDFADBAZEABMCIFhAEATBGD.KHAGgGDGLAAFaEHD.hBAA.IBCA.hACA...,1,-8,-30,22
BFMIaPNgYGTLVeDRZSbAXOcJWUHQEfKdC,OBCBJDCBHAAG..QGEBEEEF.KGCBCADEMFHB.aAEDNBHGGAEEhAAA.LBABhABADCIDRGCESGFHhAAAAADGXDDD.UGAGBAHBIHHHPBGH..hACA....gGADhABA,2,-23,-17,6
RGJTeUbFKBAaNDQdgWLOPCcVfSEZMYHXI,DEACdADGLDDFCAFG..VFGHSDHBZCAC.MEHFHABCIFAGhAAAJBGD.eEFHhABAUGAAKHBEaFDF..gCEHhACAOCHD.PBBBfEEBEAHF.hAFA......hAGA...,2,-26,-17,9
WaFcfINbVQRJUXLBTZMDEKSAdCeGOHgPY,dHDHGBAGOFAFHEFA...gFCH..YBAHhAAAaCGFFCEBIHGEhAAAVCCAJEHFLAHHBACBMAIDhABADGCGKGAHCFFAeADCWAEGfDCC.hABA......hACA...,2,-25,2,27
ZAgFLIGQdCNYcWBHVXEeRTSPbKMDaUfJO,FEFBGGAHCBBD...NCDH.......YHFEBAECXEGAhAAAeFCB.RBABTDEHhABAPAEA.KAGC.DFBAaEHDhAAA.JCAHAHHB.LCEE.IDCDhABA......hACA...,2,-36,-31,5
cETbIKOJfePRXGWMFHSDgBLYVdaUANQCZ,CFACEHCC....TCFFICFG.JEDCeDAC.REBHGEGGhAAAFBACHFGBDAIDLAEChAAAdADDABBHZEDHKDAFOHBEXCGHhABAMCCG.BFFFYDBB....hACA.aBDH....hADA...,1,-11,-20,9
fAObWdLBNHSYMCTJUeEGXFaZPIVDQcgRK,ODFFdCCHLGAEHCBGSFCBMBCA.CEED.UGGGGAEBFBABaEGChAAAIEHG.VFABhAAADCIHQDADhABA.gFEDfGHAAHCHBBFH.hABA.NICD..YACEhAHAeDEC..,1,0,-21,21
HOeXNWAfFIJbKDGgSTPcZVLQUEdRBaYMC,FDCCJBGH.KFBCDFHDGBCD..SDDB..PAEGhAAAZCBFLDABUFEGEBHBBGEHhAAAaABC.MEIH.HGAGhABAXEGBNIDF.AIHCIDAATACF..hACA......hADA...,2,-29,-22,7
IVGScReBXfTJDdFKEbCMZHaUYPLOQgWAN,VEBGGDCA..RAFGBBAFXGEA.TBDBDIFEdBCA..KDACCHAEZEGBhAAAHFAB.aCGGUEEGhABALAAE.gEGGhAEAADAF.IHHBcBEH.eAFA.hACA...FHDG..hADA...,2,-32,6,38
ZTeWXGPKEQCRSYOcgHVFaIdDMNLAbfJBU,JCEFUEDBZBABeCDC.GAADKGBG..CHEG.SGEA.OGAEhAAAHAFAaGHHDDCFMAEChABAAHADBFGF...XEBAhAAAQEGB.YDAB..hADA..cACE.hAIA...,2,-45,-21,24
IXRGOYbSFUgfcBKVdNQLAWTEeHCDMJZaP,EDEDHBEGDEAEZDCC.aFBG....XGDHOHEGSAHBhAAAUFGE..fHABhAAABFDAKACANBAAACHCTACGhABAMGFA.PFACIHBEYAFAFDHH.cBBHhACA....hAEA...,2,-34,-13,21
WgJXRMENPOdaQYbefDGFISHAcTCKULVBZ,TDCFCCFBLAFA.ZFFGJAFB..REBD.EBADOFDDdAHA..aEFAQDDHhAAA.eCAGhABADFAFIGGEhAAAAGAB.KHBCBHHBgADFMBBA.NEIGPHDEhABA...fDAEhACA,1,-17,-33,16
MebZcAfPJLIVWSECKgRaNGDOUdFTYQHBX,JBFCVEEE..EADCCBFA...KFDDRFBE.GDCFODABdGFH..FBCAQAADhAAABHCG.MDIBhACAeAHF.ZAAFAIACfDAChADAIHGGSDDFaCFCDAGG...hBIA......hCBA...,1,-21,-30,9
bEFZGIYMaWHfQReKSOdTJVUXcPNBLDgAC,EGDFFADEZCDFGAAH.MDCAaFHBHFCD.RAGH.KFFHdCBCTECF.hAAAVAFDXGFH.hAAA.cEAHBGACDDAHhABAAIECIFHCfCFG..SCHHhABA.....hACA...,1,-6,-25,19
NEDUfbXWMSLAOBFPQcHKaVRYgdGJCeZIT,BEDEFCEFQABAKBAHRCFE.dGBECHHA.ZGEC....TFGHDFGGUAGHhAAA..XAEFhAAAMEBCABDGOEABHFEFaDBDhABA.......YADF.hABAgGBB.hAEA...,1,-26,-33,7
HbDPZXRdaEMSYeOQBIUKLfVFCAgGcWNTJ,GCEH..NBGGHEAHDCDEXGBDRECF.dGFEaABD.MBAHeADEhAAABDDBUCABKGGGLFHBhABAFBDAAAGC...WEBAhACA..TFEH.PCHBSBBChAGAOHBCIBHChAHACAAE...,2,-22,-14,8
RZdKUQeFTbPXHNBWcLGCSYVfJIEMDgOAa,aFBCZFFDKDCA.UGBCFBBF....TFGB..bACAHGCGBEABhAAALDDCGAGACEFCYAHFhAAA.VADEhABAICAEECADDIFGAHHCdCCB......hABA.....QFDChACA,1,-19,-21,2
EcOSBHMTXdZYGfVIPKQCNaReJLUbDFgWA,OHCCSBDHHCFEMAHDdAAFZCDH.GADFIGFEQFGDhADACBAFRFBF.JCCFLAFHhAAADEABFHAGAHEAEEFC.BBCGhABA.TCAE.fHGF..hACA...KEHBNBBA..hADA.aEAH.,1,-5,-20,15
fFTadXYJgHcBLOQZeRKMbDAVWCSNUEIPG,VBDFSBAG.UDGAEGCBGAGA.FGFBTEACdDAAJAAEHEEBhAAA.LHAEhABAOEHFeCCDKDCAbAECDFEAAFDCCGHEhACA..IGAFaAGA......hAAA......hAEA...,2,-18,-5,13
HDJgOUQKdNYaMfXTWAcBVZPbGELCISRFe,VFBCZBDCGCAB.CAFB.SACEREAF.HBBGJHBGUEEFKHECdAFEhAAA.aFGEMFID..hAAAXDECAAEHBHGFEAHFhABAIAHA.DCIF...OBAH.hACA......hADA...,1,-13,-29,16
cAfdXPTMYIgeFVGJKBEQZDLRCHWbSUONa,dBFDXGBGMCAF.....IHEDFBAAJEBBBCDDEBABZCGBLDHHhAAAHAECSCEDhAAA.OCCHaHFCfEEHhABAPDABgGGHeGFGKFDFDAIHCAHB.hABA.WFCA...hACA...,2,-34,2,36
DPCHfeKUAVdGcaTEYOZJLNSQRMbIXgFBW,dFDCGDGGaBEG.EFBBZCBBLFEF.QCBBMFFH.IAEDhAAAFGGFDBBFCCGGHBECKHACAACEhAAATABE.OAHFhABASEAD.XEGABDEBfGAGhADAeDDG....hAGA...,2,-32,-2,30
aKORBUZMYGCWcJbAdNTXDgePQIVLFSHfE,dCGCTEBDDEIF..eFBFQADHLACHSFGGHAAD.aBGDhAAAOAEABACFZCCAMFHBhAAACGECJBAHAGGH..gEDHhAIAIHHDfGCAEHDAKBEB.YFAFhABA....hAFA...,1,-11,-25,14
TfELBVWNDROCbZgaXFHdAeSJKGUIMQcPY,eDEAJDBAGGDHUFFE..MBECQDGF..PAADTBGEhAAALEAFBGBCNBAFDFDEhABACECC..ZFDH.aGCBFAFBhACAACDFKDHBIEAA.......hAAA......hACA...,2,-25,-18,7
JcATXCNbKFSaePfYRGBZWOEMUDIQgdHLV,CECFKDABFAGEeFCF......PBAAfDCCRCDC.BBCDhAAAOCHDUEFBDFAHQBGAhABAdFBDHEFBJHCCAADAXGDHhACA.SAFCaAEG.YFHBhAIA....hBAA...,1,-27,-34,7
GCQZBLUWecaFPSTbDNXYORVdAgMEIfJKH,MECAEDHF..JBBCHABHGBEACHFGBDHG.LAEAUFAFeBABaFCD.hAAAFHCE..SFGEhABADGECXGFAODADhADAdAEFABHHfCFEKDDD......hAFA......hAGA...,2,-27,-18,9
ZPEHLQXcSUfJOGaIdNMKWDYRFCAbBeVgT,BBEAVDCC.ZFAFHEAHQDDG..XCGGSFGBUACAhAAAJCBFOHFA.aFFChABAICGFMIBEDAGCFAGEhAAACBBCAEHCeHEE.TABA.....hAFA......hBAA...,2,-25,-18,7
dUGKBDZbHOLMXeYEFNcTJgRfVQPaASWCI,SEGGCEEBdDGGGAACDGBGHFDFLBCD.MCFBeADB.EAGHFAABhACATGAARAGB..QGGBhADAAHGEIDCEBHEEhAEAbEAC.OFAH.NBEG......hAAA......hACA...,2,-15,-14,1
gAOKZHSVUYDFQEJWdCaXTMPBcNfeRILGb,OEDGHAEGVDFEUBFDDIGA..QACD.EHEAdCCBaDHDTAABhAAA.BFCANBAAREAF.hAAAIGGD.LHAAhACAgGGHAFAGSEEDFGDGCCDDMIAG.hADA.fDBEhAEAeBBD.KBHH.,1,2,-23,25
gNYIWCaVcKGZTDQLSJHXOeRUfFbPAEBMd,BFBBdBDH....NABH.IEDC.CBGG.VFEBKAEF.ZEBEDICCLHAAhAAAHFGH.eBHDhAGAUBADFBBHADGA..MBIDhAAA..WDDCaGAHTGEBSHGA..hAHA......hAIAOAFA.,2,-31,-18,13
LCZgNEYPdMDFJVaSUAbXfcROWTeQHBGIK,XAAFRDCDOFBB...eDDGBDBFGGCBLACECHHDZEADEFHDdBDDMAHDhAAADFIFFCGC.JAFCSHEEhABA.AAGDfCFChAIAWFDC.HBCC.KDHB..hBAA......hBBA...,2,-19,-19,0
gYMSTOcfaNVEQAPZBbRLCdGWKXUeJDIFH,ZAFGREBDCAHH.dHGFGBABKBBC..eGAEDGFCHDEE..MGEESHFChAAATCFC.OFABhABAaDDC.EADEQDADhAAAAHDDBDDF.bEFEXEGEIHAA...YHCGhABA.NACB..hACA...,1,-5,-20,15
LgJdKBVDIAXEFTNeRUMQGcOaSfPZCHWbY,XAEGEBEDFGDH..eCBDMCFFGAGG.OFHHaHACSCAChAAAZAACCAFB.HFAAbEEF.hABAYHEG.gDAChABAKEADDACAAIFE.TEGF.REDB...hACA......hADA...,1,-10,-13,3
ZKQcSFWYVADTLHNMdOPXEbJCGIgRUfaBe,DCCBTAAHHFGD.dDECOEBFEBFA..CBDHGEAAIDFE.RADGUFFChAAABAAEKGEA.SGDDhACAFBHF..WDDBhACAAAEGMCIH..PFAB...XGCDhADA...hADA...,2,-30,-17,13
NMATgCDVFfdYPEUIBQecLXSbJRZOWKHaG,CHGBVABGdFBG...EGEFBCGB.eACGLEFE.XAEBhAAASDEGJECDZCEEKAFEaGGAhAAA.GECGABGEDIBGFGHBhABA..fCCC.YBADhABA.IEHH.hAHA...,2,-25,-24,1
FePdHJcYXVZTSUIBEAbKOWMRGDagNCQLf,KEEFODGDMCBCDACG....aDBDCFCBLDEBFGAH.dAAGJDHB.hAFA.XAGFTGFHSABGhAAABBFHAIDG.hBBARAFE.NEBC.eFDD.cDEAYBDD..hBCA.UGGHIDABhACA...,2,-31,-26,5
SLPWRVKeQHFMdUIZXNBOGDgJYfcACTbaE,CDABTDDG..EBFHLCFEREDC.KFFGHBCFMIFAUAAFZGBABCBFhAAADGGAJCHD..fECEhABAAGDD.aBBASFBBhABA.PFABeAFAFDAH.dFHAhACAIHHH.NAED.hADA...,2,-37,-4,33
YDPSJbeEOaXBWKHTIMfRNGdQVcgCUAFZL,LGCCDCBC.SBECeEGFOAFGBEFCKEEBHDAF.IBCFhAAARFBCdBHGQDBChAAA..cGGHhABACBEFAADBFHGEYHAA.JDHDaCAHWCEAMDDG.hACA.NADB.....hAIA...,2,-23,-22,1
abNVGfcTDZgUeXMABIdHSKJQELPFORWCY,BCFDHEDEKHEEEHFCLGCEOHAC..CAGC.aAAC..VCBFGCAEhABA.TADHDAEFUCGGhAAAMIBGADABdBBBSDDGhACA.QAGFFFABRFGD.YDHBhADA.bEDA....hAFA...,1,-8,-18,10
bZTFXHKUWYOQSdVgBRAPefLcaIMEJDGNC,eDCCLFDF.aBEHMBDG.DDIBGAGACGECZFCH.TGGDHEEGKBABhAAAUEEA.OBAEdHGHBHBAhABAAFHC..PEAGhAAAIAHDEGAF..NABF.FGAG......hACA.WCDE.SDADhADA,2,-18,-18,0
cPeRLZaSDXUQCgTJYBHFGOfWdANbMVIEK,MCCFEAHDKGCG..eDGBRBEC.LFFFZAAEDEGD.QGCC.hAAACBDBJAFAHEAA.ODEHhABAfBACAEIB.NAAD.hAIAIGHE.aHEESDDE.hACA..XGGEhBAA...,1,-27,-28,1
IdWNMFYgaSPeTVfDQXZLACOBKHEGUbcJR,OEFDKFEDHBDGUFAAJEBB...dGDEMHFEFAGH...aAAGSABBhAAAeEDE..fCHGhADAQBDALHAAhAEACADFBHGHEFHD..cDGC.IBBHhAFAWBBDNBIE..gDDGhAFA,1,-24,-32,8
IOAJLZEfBSFMaDRWKbYUGeVHQXgPCNTcd,LECCZFFCEABFBDAFFFDFMCDA..RBEGKHDEUAADGEAAHGFAQGAGhABA.PAHBhADACDEFTDGB.IAHEhAAAAFAGJDHBaAEEDCDB..WDBC...hABA......hADA...,1,-2,-33,31
MJYCOGdQZPUHTNAWRfELSXIFKecgVbDaB,RFEGEBGFLCAG..SEAGXGAFFAEHeDAG.VFCGDEFAMFIDhAAAJAAA..CHGBdCCFhADAZDBE..PHCGTGAEhAEAAAIH.IFHCKABAgAFB.bCFEBHEAhAFA.....hABAOEEA.,1,-5,-8,3
UGgQKBaZefHMCFREYLVdNbcXTJPOWASDI,DIAEUABAGDGGKHAEBDBHeGAG.HCDAFDGA.EFEFLGEE..hAAAVBAC.dADHNAEF.XAFHhAAA.PEAGhABAAEDESBDH.IFBEaGHDfAHGhACAMFDDCEFB....hAEAYHFA.,1,13,-44,57
OMaJHTEVDBNYcKGQCURFXdAPLefWSgIbZ,eHBASAGD..gDFDZFDCOAEFaEAFJACB..EGGFDFEAhAAABBCH...YAAFhABAKHAACEHBFAHFACHHPFCEhACALBAH.IHHBMFIHTAFF.hABANAICcCDG..hADA...,1,-21,-31,10
FdaCEGRbfMDVgXAYSeUJBPLZOWcITHQNK,SAAFJCDFBGBA.LGDAZDFF.OCCH..IHHGhAAAQDFFFAGBdBCFEGADRADAhACAMEAHDIEA..XBGAhADAAIECeBBD...WBBF.HDDFaEHFCHFE.hAEA..fFEAhABA..,1,-14,-34,20
QLAUIFdcVRHTPGZEOeSYXagDJMWNfBbCK,UBBHdDBBRFFBHACGGAFAEGCBOEHF..SBGCaEDH.DFCAhAAAMHBC..NEEHBHAEhABACHGGQEAHAGDG.hACAcEEA.........hADA......hAFA...,1,-26,-31,5
MOKWJRQaEUTedYADHLSGcFBNZfgPVCIXb,HBBESDEGGDFABEBCZGCG....PBHBCAEEXBCCODDBhAAAJFHBaBAH..UFDGhAAAeEADdGCCAIGGDEIBLAHDhABA.FGAHfBFAICFA.KEBH..hABAWCAF....hACA...,1,2,-31,33
bdEcPfNXAQJLRFVYSgBTZaMeHICUDWOKG,JCAHFAEE..SCEEBBGCZDEB...eHDACHCB.UDAGDIAA.KDEDdGGBhAAAEFFC.....hABAfBABAEHCRBBA.hACAgCGHaHFEMAFA.IHBHODDB.bDCDhAAA......hABA...,2,-42,-29,13
WPXSQZACTJFRLDaIYdBfKEUcNbGeVgOHM,JDAEFGCCDADC..aFGDdCBF.BFFBKDGF..UACB....bDEChAAAeHBE.OFAEhAAAHBEEMEBF.PFHDhABASAFD.AIFACAHELAHBIEDGfHFDhACAEBAH..hAGA..NCIC,2,-43,-35,8
dGOIfDWJZbBUSQMTKEgHVRPAceXFLYNaC,eHBALEFF.aEDBGDBD.IABHfAADDFGHZAGHUAEHhACAMGCCKCCDHCGHRADGAIHCFFHDhAAACDAG..OHBC.hADA..WEHHBCFASFDHQFAEEFADhADA......hAFA...,1,-10,-18,8
KGQZaLEeRCbBOYdSWMcNIUAXJVPFHgfTD,JECDFGEAHDDA..TBCDKCBAQACF.aFACLBFBhAAAEDHF.RGFEBACFdHBHSBFHhAAAMEEDNICFAAID.PAHBhABADBHDGBACCHHG.ODHF.YFAFhABA..cDAChADA..,2,-25,-8,17
FALaUQRVZXWCcEGNSbeTBPJYDOKMdfgIH,UFDBVEAH.ZEBB..CHEHGBCASBBG..eFECBFABJCHFOBDDhAAAKHGA.dEHC..hABAIBBGAIAA.QAEGhAAAWAGD.EAHBNIDF.TGCBDDACfAHAhACA...hABA...,2,-34,-22,12
BURegIQJcLKZaDPNdEXCMfTbSFAWHOGVY,HECHVDEG.UBBA.eFHDQFGELBFAKBACDDIFdDDC.CDHE.fGAChAAA.TGEChABAbFBHFFAD.ABECOBEEhAAABEEEIAGD.cEAGaADG..hACAECABSAEFhADA...,2,-18,-16,2
IDTOcRJfBebAWGdCXUYVHMSNQFZPgLKaE,GAGCCAABUFGG.HBCA.SEDCFFDFZAFFLCCGaFADDFGGTGEDhAAA..OBCAhACAJBAH.BDAEADGDXGGFhABAMEEAQEAF.KHAAEFDH.IAFBhACAfAHC..hADA.WFFD.,1,0,-29,29
aBSWMJFZbdQEUVXOCIgRHKPNTGYceLDAf,BGDDMAACFEHDZABDQEDE.UGGHXDBG.OHEChAEACFAGRBFE.HGAE..hAFANIBF.TCDH.cFCAhAGADECBAHADSAAF.JADBbAGD.hAFAdBBD.EEFD...hAGA...,2,-34,-5,29
TJKEMdgSOLbGNBUCRPaFcYWeDHZXVQIAf,TFFDKFFFEFBE..dCACSECALBDAGDEBBHHGRCED..FBAC.hAAA...WHACDGDFXBGDhAAA.IAEAhABAACCFMFIBbFDHCDBFcGAA..YAFChABA.eABC.hACA...,2,-36,-12,24
cDAGQbLYRSWfVMKTIFNXgeBUdZCOJPHaE,GECCLHDARCFB.SAFD..fEADVAAB.TBCFhAAAIEGDFHFGNBIGXEDChAAA.BAHEhACAdHAFCAFDPDDGaACAEBACAHCBQDAFbAGB.hABAWFHHKFGA.eBHB.hBAA...,1,-7,-8,1
GOdWIeHULcEPXNVDCgQAYbaJFRTfSMKZB,aAECFFDCRACA....SGCEMBBDBHDHGCCHdCFB.eFHFHGFAhAAALFFBEDDE.NBBADHBGhAAACAHDAGBA...JAHFKDHBhABAOFAB.IACCcGAH...XDFEhABA...hACA...,1,-6,-35,29
NQUXVPbLFZCRIfgaKeBWOASHDMGcYEJTd,DBFHGCCFEHAA.JGCCdCGD..QFGHUABF..VDDDLFABhAAAFFGD.CDAGRABC.IAGDhABAaEBDKHCG.BCHBAGFB.hAAAMFCA..YAFC..NIEF.XCAChACA...hACA...,2,-27,-21,6
BbdLCOHGVgYEScUMRWNFKAPTJXDeQIaZf,JBFBXAAH.DAGGeAFE.QDGAZEDBBDAAdFFECGFC.HCGFhAAAGBCA..VFAGhACAgEACEADH.SAADhABAMIDA.NEEEAADCICECaHGC.fAFGhADA..hBAA...,1,-17,-24,7
cOMKgBCXNaQRYPHdfTILUDFSVGWZJeAbE,EHGAOBDEKCGB.BBHH..CFFA.aGBGRABAHEAHdAAB....fDDDhADAIFDEDDIDFFGAGGDFhAEAJCDG.AEBCMFAChAFANAAA....YHAG...hAGA......hAHA...,2,-32,-31,1
VeWCKUHFbELTAGOMaDYScQgJRfdNZPBXI,MGAEDCAA..SFFGQDDDRAFCdECDZBCGBFGA..XGAHhAAAeCAFKGDBHCDCECHBABBAhAAAaADG...cDGDhABAfACD.IHHCCHHFFHDC...hACA......hAGA...,2,-27,-22,5
PbWCVXIRZaQKHMdEAOfgeBTLFGJcUYSND,OFAGeDHDBBBBLHEEGECHUCEB..SHGADDBA.hAAAPBFFCAGDIHAHhABAaCHFHDAHdADHACHE.TEGHhACAJADFNHAF.....WFCA....hAEA......hAHA...,2,-34,-13,21
MCSQdNHOUPcJYGIRfTWVFDBaZgKEAbeXL,eCCHMHEG.CAHA.QFBBdGFBHAEH.UEEEJHCA.GAAB.IBHChAAATBAFFCGABCFGaEEChAAAKDAG.AAFELDHBhABA.SHAGODFCPEAF..hABA......hACA...,2,-21,-10,11
HSgGLMZNUaXPYCeBETcOJFQAdfIRKVDbW,dABCRAEEKDDADEDBHEAEGADELGDEZEFH.UBADaBGE....XDAHhAAACBDGeFHHBHEA.hADAECGFTGAD.JDHHhAFAAEHDfHAB..IAGGhAIA.WFDHMAAE.NAIE.hAEA...,1,-18,-20,2
FNOVGXgSMbWEZTCcfeKUBRDQHYJPAaLdI,dBEEFAGCOAEBGGBFSABB.MEAHbCCHZDGF.CGEH.fEGHhAAAUCAH.BDCFhADADIAEHFAE.JAAEhAAAABBDIGGH.XBGGEEEGcGGHhAFAKECA......hAIA...,2,-21,-19,2
bBDLagYMSUAHeIOKPNcEGXdZWJTfFVQRC,eCCDOEBAKEAD....PFCHEADHdFFAZEGHJBHFFBBH..QGBHhAAACAGBDFEE.LDDHhABAaADF.MIFCAFACNDDD.hAAA..XCFD.fABChADA......hAFA...,1,-21,-40,19
MBYIHgePJDcSKRQACNEXWZLdbOfVGTFUa,EDAFZECDdFFH.OADFVFEBGBBD.FHAAaCAABABHHBFCeAGDhAAADGAESFHHhAAA.KAFEAAIDNEIC.XEBEhABAbFDD..fABH..MEEAhADA.....hABA...,1,-14,-27,13
SEYDPAaVQLMGNKbUgRTeOFcZICdXJHfBW,VCEAMBAHKDBB..UBBEREFA..eEDCFFFHZFADCGHG.dEHCHGCGBAEFhAAAEAAG.DDDCAAHGLECHhABA..bBFA.hACAOFAB.IBDCfAGESHBGhACA....hADA...,2,-32,-21,11
adebNVOAMXBYZGPHFQSRCTELcUWfKIJDg,XBFCBEAFGFAHHFFHQADBRDAG.EGFCUAAC.KFAGIEEGhAAAJADBDIBEaDHBdCDDeCCDhABA..NEEG.ADHCMIEAhACA..YFHBFAHFSFGEhAEA.CHCH.....hAGA...,2,-20,-11,9
ERgXNVLJcbdFaSfGWOTHIBDQMPYCeZKAU,EGCDXGEDLAED..JCHBdFFH.SHEGGFABOACBhAAATCBEHBEHBCFBDAHBQAABhABAMBAFCEED.KGAHhADAAHHD.RDFA.NBBC...cAGCaGHF.fGHChAHA.WFBE.hABA...,1,-1,-21,20
OgJWVHYeEdTbLMfCGSAXNDFPZQURKIBca,DACAZEDHUFGDRBADBFCC..OABH..JDEBHADF.eAGDdGFHLHAEhAAAMIDA.CDDC.hABAAFDDFHAEKAGH.aFAC..hAAA....gDGCWAHB..EDBFhACAfAEC.hADA...,2,-48,-20,28
aIbgTZYNcSLFDJGPMRUQeCHWAfOKdXVBE,OHAEKEGHdHCHBCDF..EEBF.aGHB..IBHDTAFCZCCHhAAA....cCEEhAAASFDA.FBABhABADCADPHDAMBCAQFCBCBDEAAEAVCGF.YBBFhABA.JFAD.hACAUGGDeDAF,1,2,-42,44
VGNfUEHSZdXRBJQWCFYceATKbIDLOMPga,TDGFKDDADFFELBBF..OBADMFAH.gFDFhAAAGAEFUGGBSAGBhABAdADGBEHEWGFACFDB.cFAGhACAAABC..ICHGaCDCfAEC.hAAA.EFCBXGBDhADA...,2,-29,-25,4
cedWUCDVOTMFHENBSQXZJYfGIaLAgRPbK,.RFDDKACEdDCECHAG.DEBBOBAE..FBCCHDFCBEHEQEBBhAAAZAFF.JAEBGCEE.hABALAABACIF..hACAgGGDPFHBeHCCWAGF....hAIA......hBAA...,2,-31,-29,2
HaMBDFgGKVcZPUXQdEYeJTSbWILRfCNOA,aDCCDHCAFHFAGEDH.KFAHZCFH.UCBFdAEGEDHD..eFBA..hAAASABC.hABAIAHHLADCfCCBhAAANIAD.AHCHBGDF...cGGHhAGAPBHB...hBAAXEED.,1,-19,-37,18
gMYRXZTCbLDPAESaGFOdNcIeQUfVBKWHJ,aGEHOEGB.dAFE..ICEBeCFAUAAFBCCDKDAFHDFF.JFAEhAAAMEDFRACC.ZBDHCHHBDABAhAFAAEID..SHAAhABAFAHD..cGBEfHED...hAGAWDCF....hADA...,1,-23,-35,12
BHDVaMfAQCOGbLecKZYSgRIPJWXEUTNdF,QAEFOAEDLGDEKGCCZBAC..SACCREFB.PHDEhAAAJAHFEDAG..NAGGBBBGhABADEDCMIAE.AHEACHHBeDBFhAHA.gDDDXFAF...dBHEFAAAhADA...aDFA..hAFA...,2,-20,-11,9
JZTMKEbRQIULYABgHGeOCXadSVWfPcDNF,BFAGGABAeAEACBECdFGE..SCDH..fHBHhAAADEHHJBAAMIFAEEDAbFAGQDAAhAAAUGEC.ADFCOBHFhABAaBHB..PBFDNGCFFHDGKACEIDADhABA......hADA...,1,-18,-21,3
gYOJbBEAcXVNeQfDGRMTKZHPUIWSdLaCF,XDDGVGEC..QCBBDGBGGGEHMFBBKBCEZCEAHDGDUCAEhAAAIADBdAGALFADhABAaAEDFGCB...OFFAhACABEDHAAHFeADE..fAAA.hAIA......hBAA...,1,-7,-14,7
XFQDTbGVaIHONfReZUMJAWLKSdYcBCgEP,LFDGSCHFdHEHBAGCCABB..EAADFDBEDDCBGABB.VFDDhAAAHACB.OAHHRDFDZFADMIFChABAJFHBADEF..KAEC.hACA....cDED...gGBEhAIA...hAEA...,1,-21,-23,2
XNdSIOGcVBREagDYFfHQMKbZUJWAeTCPL,eFFFTGFBCFCH..LCAAdFAFOAAGGBEFBDFDEDEEDCEC.FEDBQFAAhAAA.MAFChABAKCBEbGBA.JAECADHFPABChAEA.SEHHcBGE.aHBE.hAHA.fFGDhAIA...,1,-1,-36,35
NBDdFaWGJLIRKcOefPbUEHCMXVZQASYTg,SBDDTCFH.BCBGdGFEFDCD.GAAFICFDKBGEOFBBhAAAeFEH...fEHGhABAUECEEHBCCBACMEEFhADAZAGFQGGGAAFB.YFAD.hAEA.DICAJADA...hAGA...,1,-13,-23,10
DHTPBWGVSEFdJfLcUKQgeOXMZaRbINYAC,CGABDFBGHFGFBEEHGABD.EHEEJBCH.LHAGUCCFKEFC.eBABhAAAMGBARFCC....IAHGhABAAADGTAECPCFEhACASHGE.dEHA.QAGGhAAA.gGEFhABA.XCADaAEA,1,3,-27,30
XVCYNKBJTSGWUDLbPFdIEeHfARMagZQOc,aEGAQCGE.OGCGXGDD.CEACKGAGTCDE.SABEhAAAUFFEDAGBLABGhAAAPEAHdGGBEDCBfBBBhAEAABFBMAID......cCCAhACANIDF..BHAHWAGHIEFHhAFA,2,-39,-11,28
YOMCgGSNHXFLRPfKVJbAEdUBZWQcaeDTI,UGEFZFFFQGCEeBBEDDGA...TBACODACMAEBGEDBHAGFhAAALGAARDFEKFHBbFAFAHIFBAFGhAAA...aCFGhABACDCFSABE......hAFA......hAGA...,2,-28,-4,24
UREAfaTLGQIJVgeWZHCONSXFcDPdYbMKB,TBEFLHDE.GAGAJDBG.eDDHHGEACCBA.OAAE.SEGEhAAAXABCDACGdBGEMFAChABABAFCEFFAAIAAaAGAIGBChAAA.WCEBFEEB......hAIA......hBAA...,1,-11,-30,19
QOabDGLcNZKAJWgEdeMBPSCXRHYfTIVFU,JBADEAAFdBDBBFHB..SBGERFDG.HDGFTCEAFGCDOFFHhAAADHGA.GCABLCCBhAAANFAF.AAGHeHBE.hACAMABECHHGfGAHUCGGaFAB.....hAFA......hAHA...,2,-28,-5,23
eFHAaLdScgDbRXNWTGMYZIBKCQOUEPfVJ,aHBALBFH.dACESHGGDBHFRBAB.XBFD.TFGFhAAAMFDDIHHBhAAA.CHAC.QCAChABAEEHH.fFEGeEDGAGACbADDNADEYFAChACABHEE.OAHF.hABAPEEG.,1,-7,-19,12
BMSgVKNPJQRFfeTDbcXGaLYIZdUAEHWOC,EADAHDCF.OBHDBGHGMCAESGCD.KADHJFEEFDACeGAADGBF.hAAA..XCFEhAAAaGFEIBBBdECDAIFGCABGNAGE.RAFA.hACA....fEEBcCDGLDABhADA.....hABA...,1,-11,-31,20
aWCbQHPRIJDUGcEAegdfOVZMKTSFYXLBN,dEAEVEAAMDAE.KAHDFCHB.LAACBABD..aEGFCAGEHFGB.hAAAREEHDCDCGBCD.AAFCeFFHhACAfAEBZGBG.hADASDDC.NIBB.WCFA...hAIA......hBBA...,2,-27,-23,4
RcdXNWTeIASgaQLfEBbYCFGJDHVPKUZMO,SCGEaHBALCFFBHBF..CGEBGABDJCBEHDGBKCGB.UEADhAAAMADC.RCEDdAAF.XGDFhAHATCAAAAIFQEBGhAIAfEDA.EGGDFGGHDGIH....hABA......hACA...,1,-9,-24,15
RQXHJYbfNBOSAMCUagKZGFVedEDcTWILP,UDDGKAEAFDGFdGAD.DAFD..TCBALBAHRFFG.HGEE.JDGDbFDBhAAA..BADFACFACGAF.ZCBDhAAA..eHACEBGC.IABGhADA.........hABA......hACA...,1,-29,-31,2
GMSHdEYcANKZBfgbIJCRLVODFPTaeQUWX,KHEGBHGA....fDEFbBFD.CDHG.LFBD.DBBGhAAATBBAaCCDQFCEhABAUAFBGEADMGFESGAFhAAAdAEEECHDAGAFgCACIHHBJFFC.hACAOABA.FGCE.hADA..eBDH,1,-8,-20,12
eYfBXCAEGDUOPLIRTNKWbdVgJMaHSZcFQ,GDGAUGDALDACRGACKADD.dCFE..VAFAMDHHHFDAZFADFBBEQCEDhAAA.eBADhABA.BCBBAAGDDAABIECEhACANBEE..gGGG.SAHHhABAfEAE..hAEA...,1,-13,-29,16
gMUSeWVPCEdOGDKfaRFQXJZNLbIAHYBcT,HDAHBAGB.TGEBUEGEeCDG..WBAGCACE..OGCEDAFCaFFAhAAAREAF...QCFHhABAXBAG.JHBC.NBBBLDDBhACAAAFH.cGGDMICASDDDhAAAEAHH...KCGEhABA.fEED.,1,8,-30,38
UESePAIJTaCbBDKHGLXMfOYdNFRgWZVQc,TBCBCEEFDBAE..KADEHDAC.GEEDMHFC.fBAHdCDH.hAAAFAFGRFBDZDFDVBGHUAGBhABASHGGACAH.JFCDhAAABDBA..........hACA......hAHA...,1,1,-43,44
IMHQNAXbSEGaKFUDRgLCJZTcWfBVPeOdY,XGCFEHBAKFAG.UADFRABCLEAC.ZFFCTCAB..fHDFhAAABAGBPHEChAAAOBHDIDEHHBDGAIFAhABAbEACaDDF.FCACCEHAcEFB...WAHHhABA.....hACA...,2,-17,-11,6
CdJNGKFMbSLcHPZXTIUReWYQAVaODEBfg,aDFBEBCABFGH..CFAHdCBBJCFA.GACH.KHEGFFDB.MFIFSEGHhAAAHFADZCBEXGAEhABATDED..IAFGhAAAUDAHREDB..WDHBAAHGDIEE...NBAA..hACA......hADA...,2,-23,-20,3
KWLUXTfcRgIJeBMdabCANEGFQDHYOSPZV,EGAGFFBBHAGB.OCCASEFDZGEEKDEHLAAA.TECChABAfDADRAFB.JACEhAAABGHE.aHDEAIHANDDADIAAhACA.PCCAUEGD.cCGEIBAA.MIAEhABACAEF.....hAHA...,2,-23,-10,13
aMFSgUWXNDVAbTeQRGdPICEHJKcYZfBOL,eGFAQBGEGEAFdFDECBEGHBAAKAEGZAAHBDDDLFGBFDGH.UGAHhACAXGCADCFD.AAIDRAGBEHEChADA....cGAHhAAAfCCB.MEACSADE.hAEA......hAGA...,1,-9,-20,11
HUGWMfCOSTKNARQZFeVPJIDEbdXLBcaYg,ZADAeECAJHBCEEGG.dGGCBHHB..aEBHHAAFUBCAMEGD..CHDCSBHBhAAAKAGCAEDH.hAAAFCAGICDCDCEEXFDEhABALCFA.gEAEWEAD.OFEDhACA....hAEA...,2,-32,-17,15
TXMHYDJWOaKBIARfGSgbLFNcZQVdeUEPC,RFEDSBGGLDHDFADEZFACdEFA..EAAECCBF..MEBEDEDAJCCAOAEBhAAA..KBGCAIAA.GDAChACA..NEHA.QGCDhADAeHDA........hAGA......hAHA...,1,-25,-34,9
gTSRBaDOEFAVJCeYcILKQZdGHXUNPfMbW,JCDDCCFF..eDDF..IGFHLACAZACAdFEHGBAGXBGFhAAA.UEAG..fEHAhAAAMDIB.WHCGhABASHAEBGACDCGDEHFGABHH.cBAFKFDH.hADA.NAEH.....hBAA...,2,-34,-18,16
cTLDCJOHRgWZdVABSeFIKNfaEXQUYMGPb,eCDGFCAEKFBG..aCBDEBEAUFCH..MEEDGAEB...bFAHhAAATDFHLDHFDFAFCDDFhAAAOABAHABG.WFGDhAFAdHGFAHBE.BFHB.NIAH.XDDG..hAHA......hAIA...,1,-13,-26,13
aAFETeCNWIfMPYdHgcGURVJLbZXKOBQDS,EGECeGAA.CDDF...NBFE...IBBHMDCBdGBDHBGHGAACUFFBhAAAVAGFLBEH.hAAAXCAGBGHEDADEAIHATEAFhABAfEGD.YDDH..hACA......hAGA...,2,-24,-14,10
FWbeGUVYcECIgHQfJDAZaNdXRLPOKTBMS,aBDEdBABRDDELFEBKAHD.BCHBFGCG...eAAGGCACUGBC..hACAVFGBEDDHCAHGHADEQEGGhADADIDGAFDA..ZCFChAAA..NEAA..XBFHOFAH.MCCD.hABASGHH.hACA...,1,-8,-14,6
ZOQJCHPRcbMDBEFIdeAKXLfUWSYaNGgTV,KBGGLACAUCAE.SCFE.aDDDgEGC.ZADDhAAAODAC.CGDFRFFFbEEFhABADIDCFGAFdAAG.ABHAfHADhADANIDB..TFCC...hAEA......hAGA...,1,-27,-32,5
KLYWdHPQEIAcZGMNFeBOaURVSCTbfXgJD,ZGBCMBFHeBBHBAECUDDDREFA...CAHB.TGDE..XGGEhAAADGCBLCDDdEGFHBFEhABAEAGDAGHF.GBACOADFhACAaABA..SDAD....hADA......hAFA...,1,-19,-24,5
SJMZaFLTCYAHUcBWVPdXfgNEIDGbQKeRO,HADABAGA.VBAGXBBB....NFEDDIEGQDGG.hAAAKFDFeDDGOFBFSCGBhABAMBFFaBDDTGGGhACACBAGAGHF...WFDGdFACEGEAIAHD.hAAAGGAB...hABAJDAHFDAC.,1,-1,-23,22
VNPIHZJbaMBROdECLYGWSfeKcFgAQDXUT,QGDGDFABUDEA...VCFH..NACGHADAZDABJBCC.aFFCMIDEhAAA.BFCAdDDECBAALDHBhABA..WAFEhAAAeHAAFGHDAEGC.TGBDIDAB.OBFEhADA.EGGD...hABA...,2,-22,-18,4
HUBDCJgMQFWOZdAKLYceENIfaVTXbPSRG,KBAALBGHeFGH.EHFC....ICFAfFHEaEDC.XBCFhAAASADCHFBCBGEEhAAACBADMEAHFFBBZCBEACFCNAIC.hABAbAEAGDEADAIDQDGHOHAE..cDAFhACA....hADA...,2,-13,-6,7
HKADcBTESebROUFJZaVNPCIgdYfLMQGWX,BCDBTEBHSEEC.RBGB.OGEEUGAGZFFHNDCH..IEGAhAAAdADFLBAHGACBhABAXFDGAIAGDICAECADFFHFhAAAaAHF.CEEA..fGCF..MACHhABA.....hACA...,1,-16,-26,10
UGgHLBETPeZfdWADMQFXacSbICKOYRVNJ,MBCEFBFG..XECGaFFC..SAGHIHGD.CDFDODAHhAAARBAF..NAEGJFFAgDCHhABABHCE.TGAAhACAeACB.dDHGAAAA.DIGE.bBBGKDGA.YFADhADA.....hADA...,2,-23,-22,1
bfXcNAMSYFULeGdEaZKWOBTCPIJQHgVDR,SGACFGCGUBFALDADGCCGdABA.ZCFFOBACBDAFCDHD..hAAAJFHHQGGChADAHCDFDIAC.RFED...fHEBhAAANIABMBEA.EDBHWAFE....IFFAhABA...hAEA...,1,-16,-24,8
CYaSLdBDPAHKfJQWIETXgcVOMUeRNbZFG,KBCCQDBAEEFF...TAAFXAFBVBGBUCFF.eDDDhAAAbEDDZFFHFFBB..CEHA.SCCEhAAAdGHCBDADDCAAhABAAFAFfAEE.JHAC....WHBAhACA.....hACA...,2,-26,-14,12
JLFdWMTDfHbaIEKRUNYeBXAQcgPVGZOSC,QAFD..cEAGVDEBOHFGJABALDEF.FBBHhAAAMBBFDFHH.HDBBaGBH.hAEAIACCKGFH.NIABBDGEhAAAADHG..gFCDZADDCAHBWDHHfAHGhAFAEGCA...hABA...,1,-9,-31,22
aKDgfRLFXATMcbEPNBdYZUeCHQVSOWJIG,MFEHEAGFBEAGZBCBUCGEHGDE..QGAG.SBAGhAAAJCAFaGBDDABGRDEBFDCH.AIHGTDGEhABA.bADFNAFAdFFAhAAA.CAHF..OHFE...IGAFhAEA.KBBB..hAGAfGGB.,2,-27,0,27
WOCXPJcVDKYdaQREfSAIeUNMBTZLbFGHg,eBBFUBFAMGEGBGABLEHHGCBC.HFEFOABBCDGF..JEDDDHAEhAAAdAHCQDDChACA.EHECSADFhAAAAIHENADH.TAEAFEHF.WBAF....hABA......hACA...,2,-27,-15,12
KRJbHEDPBdAfgOUYMIWXeQLaVTSCcZNFG,OBGFUFBBMAIF..XGBDeDBELBECaEGE..SHGEhAAAZEGHFFFHKACCbDDCDIFChAAAdABEAFEB...fEAChADAICFF.QAEBCABD.cFDBhAFA.....hAFA...,1,-13,-31,18
IeBEJYHLXdbVGNFSgDMaQROPZUWACKfcT,CGCFKCCF...TFCBBGACJFEBLFFD.dGGDGABAFCFESBEChAAADCFBMFBCRAFDOEAFhABA..UGGHAAGAIEHBhACAEAAH.XDEGNBIE.aABE..hAEAZADB..WHBAfDAChAAA,2,-29,-27,2
NLZKCWgUDMAJSRdQEbVYaOTFIPGHefBcX,SEGEdGGAEGDF..VCGBaHAE..TGDDFBEGGDAC.HBAChAAAfFFDBDEENABF.hAGAKFBF.CACAUDCFAFFB.hAHARAGFQBAG.bBEB.IHHChAAA..PDDBhAIA...,1,-1,-17,16
HZFSPfTRQIOYUKaCMEdGVgJLeBAXcDNbW,DECF..bBFHHFDFFEDH.SCAH.TDFHIGAFOCCChAAAKCADCFGGdBGDGABBhAAAVFGDLFABAFCDXCCAhABANADBZACAPHFC...fEAHhACA.YCHHaBAB.hABAMIBA.,1,8,-26,34
GRUDaCWAZMbOeIEKSTcLYPXdJfFBHQgVN,ZACGMCEFeGAGKGFB...SDECLBHHXGDHJHFE.BEAHhAAAHECAQGBFhABANAHCGBAEDFGAaCFBCDBEAABCIGEHhAAAEADA..cABG.dFFB.fCGChAGA..hAHA...,1,-14,-22,8
XOaUgQNSVRYMELFDWcTCIBZAbGJedfKPH,JDEHeEFB.dDCEKGEDHAAG.ODAFUCGA.QGDD.SADHhAAARAABMFIFEDCFFAGGhABADCDETCGC.CCEHBHHBhADAAFBD..fGGCaFAH.NACB..hAFALHAG..hAAA...,2,-47,6,53
fdIHVbDAWUNMcYPJCLQKOGEeSZagTBRXF,UEBCMCGD.....PADDCBDGQEAAKFGF.OFECEBFEZDFChAAAaAHHBBHEFABGdHFD.hABAHGBGDIAAAHHA..WCCAhAAANCAE....JEEH.eABHSAEEhAIA.....hADA...,2,-30,-14,16
NTSLHXWIQRZVOBGDFfAMUcPgaeCKbEYJd,UEGG..gAGHaFEH.eFBCCBGHEDCAJFED.dABA.SDABhAAAXACGQGAGhAAAZCEABAFFDGGCADGAMCFDhABAKDCGNEAE.LAFE.IDAG.hADA.OHFE..hAEA...,2,-24,-18,6
VaSdBYfMgXEPIbKAecZRTFNQGWLJDUHOC,eCDCZCCBFGBHGEFELAECDDADHABA.OAHHVEFFdCGFBEHH.hAAAMGBAEDAD..IBBAhABAAHIB..cDCHhAAANEEC....WFHHCBAGaGAH....hABA......hADA...,1,-21,-23,2
JSBNcEfLCXKGTURbQPWadODHFZeIMVAYg,JEEGBAGC.EDHDCGCD.GDBG..RCAFQFGHaBDB.DCFEZEDFhAAA.MGFAABHC.SBAGhABA.NDAA.fFDGhAAAKHCA.TADEPBEFODDGhABAFHFEIBHE..hACAYHAA.,2,-42,-9,33
UfOPCWFLKbGHeJcYQdTZEIRDaNSgVMBXA,OEDBCDCFLBEBGCABHFAEeEBB.JAGHQABE.dHFHhAAAEEHHDDIFSACEhAAAMEGBBAHDACIHUGGD.hABAPFABKGDH.cFEBZAFH...IBADhABAaEDC.NIBF...hAFA...,2,-16,-13,3
VGbBZIPXACHOUYQcfNMSFaJKdeRWELDTg,ODABUDGHQEBD..fCABSADDJFBCdHDBeFFEhAAAEAGCDDDC.TGGDhAAA..gCEHhABAbBABBFEF.IHBCABIFCAEE.HGEENCAAaGAEWBBEhACA.LAHHhADA...,2,-24,-6,18
RBOMabdVUWHXcgAZSLCYNDGTFEIQKJPef,SEBACAAFDAGF.FCDGEDEF..KGBGJEBDeEEF.BDGCODHBhACAMBDGdDBF..UBAEhAAAXGEBAIDAZFGD.LBCGhADA..NAICIGFCfAHAaEABWHAGhAEA.....hABA...,1,-30,-35,5
eJHacKOCURbPDYIgVEBTdMWSFXAQfZGLN,QDAEGAEELHEGJGCG.aBHDKAHFUDBDRADD.DIAC..IBBDhAAAVEFA..TABChAAAdGHASHFChABA.AEEFZAFHNGBF.eDFB......hACAOBAB.CGAD..hADA...,2,-22,-10,12
QPCFRWKMdXIJSUGafTecDHELBbNOYAgZV,ZFFGVGFAQFBG.FBBDKDDE.dACFJAFCSFCDGDDC.hAAAaAFCeADF.HBEDhABAEBAFBEGFNICH.AIDECAAFMCAFhACA.IHHH.fDHAhADADIAEbBFAgECB.hAIA...,1,-2,-30,28
ARHUSFIdCDTLcYKOgPEJfNQBXVMbGaZWe,UDBFFBHBCFFC.DBADLECB..KCGEOCCEEGGG...JEAHQGBBhAAABHHF.MCCChABAaEEGZAAGAAIHHFEBdHEB.hAAA....YAEAfBEBXEGEhACA.....hABA...,1,-24,-39,15
QXJFPHAGdWIfKeDYZBTcbLOMgNCVaESUR,dDCA..fDBAKHAAeGCEZAAABDHF.TEEHLAFF.MFGFhABACHBAEACCUCAAQBAGhAAAFBGA.ADEHWFCBhABADFIF.....bAFBNDHGaEFBXGGH.hACA......hADA...,2,-23,-14,9
ZJYeERHaKXGLcDbTCBAgVQNWPMUIOfSdF,QDDD..PHBEMICCOBCGdBHCFFBBJADGEGACHBFAhAAAKEHH.GBAADEFG.TFDEhABABGGCACECVGFCUABEhAAAfDHGZCDG.eAFEaEEH....hACA......hADA...,1,9,-34,43
gKYSCQJeXTMBUIVfAaELNbdGFDcOHRWZP,LFHDdHGBFABHDCADHEBB.ZAAEKAHFCAECeDEC..XBDBhAAAMEGH.UGAFIBFAhAAAADHC.EBHBGCFEOCAChABAREAC...WFFDPFDF....YHAAhACASCDD.hAGA...,1,-13,-27,14
BPSGFOdCXfYILTVeWRZKQEMHgUbNcaJAD,DEFFBCCBGECCFFDBdAAGCGGE.....XCFAIBAG.LFHBhAAAeFFFZEAHKAGHEAHBHBDGhABA.UFAE.NAIC.hACAaGHF.PBDGODAG..fDEEhACA.....hADA...,1,-19,-26,7
cdFKJCNXMAIVZaSfEPQeYOTDBbgRUHGWL,ZBFASFFFEFGB.QGCBOGACBHDHRBAEUCFHHDCH.LBAHhAAAFDBHCDDE.MFFFIGGEhAAAfACA.hABAeEFEDEIHbAFE.gGADWAFE.KADEhACA......hAGA...,1,-10,-16,6
IVHbdNFRYeDCaBcWKXSZLEQPAJOfUgGTM,JDHDOAAC.UAFAGDCH.MIBCHEAAdADCREGBDFEFBCGHKCDBZFFHLHDGhAAA.ECAAQCAFhAAA.fAGChABAIHBCNAIAeGACCAED.aFAG...hACA......hADA...,1,-16,-21,5
RdcHYbUQZfgNVeEWAXCKPBJGMDSaOFTLI,CCEDKDFABHFHMBED..DDAAOAABLBGDdDBHHFFB..UFADhAAAQFCEZEFE.gFADhABANIAH.eAEEhACAAHIBXAEB.JBAESCFChADA.aBCBTDCH.hAHA...,2,-37,-15,22
KQCgacfEGDdASUOBMWXZJNHbTPRYLFIeV,OFCHMCFBZDCFHCEC..TCGGRABDFEHBeFFDQGAH.aEHDhAAAEADC.DDDHABDHBAGDhABAJAFE....NDAA.PCADhACAIHHEKGEHCHHCfBAE..hAAA......hABA...,2,-22,-18,4
YbBCTPLaSXcRFHENWZAOJVMQGdeIDfKUg,OCADMCAAdFCEDFFFKDAB..UACC....gFFEhAAABHHBTFBBLAFE.hAAASCGEXAFEFDFEhABAEEGG.ZFDHACEDJABG.....QDDBhABAIDDDfGAGhAFA,2,-36,-34,2
cEDWZQSBaYRHbGgfJMdeOVXNUPLFITKAC,EFDGDCDCQAGDBGBGRAAC.GDDE.JAAGdAFB.eDDG.ODCBhAAANIADLDGDFDADKDHBhABAAFAACHHH...ZEBFaGGBhADA.....YHCG...hAAA......hAEA...,1,-25,-28,3
FTYLfEPNJMQKSRGaOcDAUIZdWeCbVgHBX,ZADHeBHHCEEE...VGDABAFE.FABCLFBD.EBEDJGFEQDDDhAAARBFC.aDABDCDHhAAAAGIDUABEdFBB...hAHAWAGF..........hAEA......hAFA...,2,-57,-17,40
NHbGLfZegMAaDOBYWQUJKdPETSFRIVcXC,OECHBHAEQAEGKAEB.dBCATDEERCGH..VFEACBABHGFAhAAALEBAeBGBgACFhABAaCEEDDAB..UAAAhADAEAHDIGAA.XCACNEICfAGDhAIAAFIH....hBAA...,1,-7,-15,8
KAPNadZREOIMLHJUeVYQcBTGfbXgCSFWD,aAHHdCGGRDCH..ODBHLCEHHCECUGFHeFHB.QBBBhAAABHBCGCAAXFEBCACBFAGA.hAAADDIB.KAEEACCC.NDAAZGBEhABAMFAD..........YHEGhACA...hABA...,1,7,-33,40
EfOdcFZRJSNVQWXALIBYeKDCGagHUMTbP,.BCCHeCGFCDACGGBHHDAGMHEC..TDEBEGCBdABE.FADBJAACSAGFhAAA.NIEH.hAFAQEAE.hAIAAIBEIHHBDGGAaEDE.UAGD.fEGHhADAcBDE....hAEA...,1,-6,-36,30
degIHGJMCNVRLYUPFZfSKAQTEDbcaWBOX,QCGFEBDDDAEG.aAEAODGB.dFCCeBCGHCAEJFBG.CAHHRCACLFEDhAAA.PAGFhABAfFGAAFHD.bEEBhAAABDEH.IHHFMIEANHAH.....hABA......hACA...,1,-19,-21,2
YEPIVBbaSHDGMAcCWJXegQOFKNdRZLUfT,CGEBXFDF..QDDHKFGCdABAZDCELFABUBGD.fCFBhAAAEGAB.IHCBhABABHEAaDAHHACFDDCEABEEhAAAJAEG.eEHH.OHEE.FCBH..hACA......hAEA...,1,-13,-34,21
cHXbSWATJNGCfQdgUIYMRKFPELaDOeVBZ,TFADJFEFGABG..QCAEUFAB.MAEFKBFDEGGFLHEAhAAADAEA.OCFGBDGDZBDFhAAAHDGD.SFFBhABAAFFECDAA.fAFHIBHG.YACHhAFA.FHBEaBABcFDAhAIAWHAA..,1,13,-41,54
RPcANDFIeXdLGQHKZYUgCVJbaBfTMOEWS,FFEAXGGAdGDELCBFGGADHCCGZABAUAGFVAEC...aACFBHAHhAAAMAIBOCHH.hAAAEFHHRDGFAGEA.IBAChABAQCEDgEAFCDCD.fDFChAEA..SADEhACA.,2,-28,16,44
BVQFTIbDeAOcUXKZgSaEfHWLNYdCRMJPG,OBFAUDBEKEGBZBBA...aGDHHFDE.LBCEdDBACGEG.MABAhAAAJDFGBGFEFBGG..TDEGhAFADGADAAFA....hAGA.XCGEEACENBAG.PHAA...hAAA......hABA...,2,-42,-15,27
adCVHNgEZfOKRJbMBeXYLDUFIcGAPWTQS,TEBESGDA.CCAF.VGEEHDEG.EBHFOCDD.KDHBbDAHMBBFhAAABBBE..XAFGhABALAAEDIBEFHAAICCHhACAAHGEWAEDdDCAZGAGfEGEeAFA.hAFAcBGE...hAGA...,1,-9,-11,2
NgLWPKBbRXfYTQOGIZDaeJVCUESFdcAMH,MCBCHFEFLAAEKDGCBEEE.RCFF..XCDC..fACHhAAATAGAQFABhAEAIBFBDGADaCHDeBBDhAFACFDDEFGHSCAD.FGEDAIAAgGGHhAGA.WFCH.hABA.PEBD.,2,-31,13,44
AfeFJBOIDdVQKEHMZPGbLaUTYXcgWRNCS,eCGDFAECBCBCDGFDdHGBKCGE.HBBBZEDH.GECALGAEUAFH...hAAATGAAXFFE.hAAA...WCAFCCDESGHHhABAAGGE.fDFAIEEH.QDABhACAMAIFaABG..hADA.YHBA.,1,-4,-29,25
FSQeEUZMXCDLHKYWAROaTVdPJBNfGbcIg,RBAHaAABdCFDBDEEGAEF....IECDSDDFECGGMCCGhACACFEBLHAGHEFCKDAHAHEHOCHDhAAATGEC.PHAAhADAfGGE.gFABFAFG.eEEEhABA.XACFhAFADBCA...,2,-19,-9,10
TZEfBLXPJgFYHGKOecDAbIdSNCRWVQaUM,dGFFCDGFRDAB.QCGD.UGBGZFCGBEHHLCADXAGC.hAAA.JBDEFADCHBBFODCEhAAAeEHB.AAGESDFDhABAVGFG.MEEBTBBB.EHAG..hABA......hACA...,1,-7,-31,24
LGJCRBgOUVPMDQXeNaIYASdFHZbTWKcEf,dBHCHEEDZCCETACBKEHH.EFBBLDAH.GGCDCBEARBAFBEHGOBAGhAAAUAGH.MIEAXAEEhABAaDDGAGDE..SGGEhAAAFHAC.WHAGfEEH.gGGBhACADEAD..hADA...,2,-25,-5,20
OTeQVbfDNWEFBRHGPdCcYIMZLaXAgKSJU,SECDUGAFeBCG.QAGA..VCAFDDACEGHDBGECRDFFHBBGhAAAGDEHCEDCIFAHhABAMFIBZAFAaGGD.AHFEKAADhABAOBED.fHFBNEDA.FHDC.hACAdACF.....hADA...,1,4,-17,21
RBFGLPNWOMDTEHaVQcbfdZSIXJYgAKCeU,CGGBeBBBBDHFLDGH....PCDAOACF.DAGAEAAGaGHDhAAA.QFDFhABA.fCAGhACASEAHJBFCAAEFUGDHRFABFDEB.WFFEMIDEHCAG.hAEAcGAD.ZAFC.hAFA...,2,-32,-5,27
egKOCDBGTcWFELNQdXSVPRHbMYfAJUZIa,UFBAaGBB.eCDCKBFFDIGABDEA.GEFC..TABAFAACEAFAQEGEhAAA.dEADhABASHDARFEFHDDA.hADAMEAEAAHGIHCGCADC..LEHBhACA...XBGDhAFA..,1,-14,-24,10
VdfRPJGYgabMeUZEDXTSFKANOCHQIcBWL,OHCCHDGFQFCABDCCLEFFVBBHRAFBGBED..aHBCeEDDhAAAEAAFDGIBSBCChABAAAHBCFEH.ICAGhACAdEAAfDEBPFBBgGGB.MAFEhADAXADB..hAAA.FGGHNEAC,2,-17,-4,13
CaSdBZTUYAFgReNGbLWMPEOcfIXKQJDHV,FGEHRAAEeDFDGCAGLBHBMAHF...OEDH..IFFGhAAAKHFGJBDGDEAFHCCGCFHG.SGBHhABABCGC.UADDhACAACAA.NAIC...PDAAEGHBcDGH.hAAA.fGAChACA...,1,-4,-36,32
RHCWZFMEGDSLAKQTfOeadUgNXJVcbYBIP,TEFHeBDBUGDE..XFDDJCGF...VAFC..cBAChAAABCEDIEBHhAAA.PBAGCFFBFAFBEGHBhABADFIFADIDKHBEOACAgEAFNICB...hABA..YAHHhACA...,1,-13,-38,25
aHJVNRFBPEKbgZMefTCSWQYUdcXDAGLOI,LAFEaADFHFEG.VFGFRBACFGBB..BGDDECEC.KEDHZAFA..eBDHhAAACDGEQDBHdCGDDDBHAACF.hABAODHD.IHHHhAAANDAG..bFEDfEEF..hABASBBAYHCG.hACAXGBD.,2,-22,2,24
NGCeLZabQFOXHBMdADKISgUEfYWcRTVJP,DFAHKFBH..SGDHECCH..fGEE..cGGAhAAAVEFAJABCGAEGCBHBLFBFhAAAaEEEFBHBHCAHhABAMDEGAGIFIACFUAEE.WEDF....hAEA......hAGA...,1,-20,-26,6
JAHCfDNGedSIERZgcBFQWTbaVOMXUPYKL,HCACDEHHGCDDdAABEEDHZECCBBEHFGEH...TEABaBAA..MFAHhAAAXCGH.UGFFhADAKADCJBFACGAD..NAEBeHBAhBBAICAE...gGGA.hBDA...WFFE.hABA...,1,-6,-35,29
fRbOEWVGQceFJSNZBaHCIKDLAPdTgMYXU,dEFBMFBGUBFGRADD..OACHEABBGDBE..eHCGFACASEDBhAAANAIA.BHAAhAFACFHGDEGFAGFD.TAFH.hAGAXFEHfHGHbFAG.WDHH...hAAA......hABA...,1,-25,-28,3
fPgbYcUZaGOADQJNEBVSWKICXLeRTFHMd,DGIHJAEFBEFA..SGCFKFAA.CHDELDFEeAFGRDAEHFGBhAAAdHFD....gEDEhAAAbBAG.UAFAhABAaHAAADIFQCAA.NBBHEEGHIHDHhABAFEAH.fEDChACA...,1,-12,-37,25
UaIOTdJBcbGKMHfQeXYgSVFDRANECZWPL,EDDFCBEDZCAELEGD.UBFAaDFA..OHFGJACFBDAHGEAHKFHH.hAAAMIAAHFAH.eHCChABAXAAE.SAGFhAAADIEGNADF.IBHA.dFFF..hABA......hADA...,1,-19,-28,9
GIXbadeZgSLBJAfOEQKPWYMVHcRUNDTCF,EFFHKHCE.....PBADMCCDVEFC.HBDERDDCDAAGFCGEIAEHhADA..bFAGdGBAhAGAeAEGZEGBSGDHhAHABAABACBD.fCCCQDDFYAHBhBAANIEHCGHHaCAH.....hACA...,1,-10,-16,6
AXPMTOUWECQIYHdSfKLReVgJBZFDNGcba,MCCAUDGHEGGH..CAEDQDGEHEEBdAFCSCCBLFDEeGBGhAAAJAAB.BDBCFEBBDEABhAAANCAG....cCEEhABAaHCAAIHE....PAHHWHBG..IHGBhACA.fAHGhADA.,2,-35,-17,18
fWJLZPIHcDQRVBGASaXUNYeKCOdTbEgFM,aCHHUGCD.eACFOFCGdFGB...EEAAFBHBMDCE..JDDAPABBhAAAHEADDCAD..VGEEhACAAABE.SGBBhADA.XAECYBDGCGAG..gEGGhAFAfGHG...hAGAWFFD.,1,0,-46,46
ZMFJXYHKNTegfCASRbIcdEDGPBUWQLOaV,SFFDREGD..bCBCdCHEDFABBAFAUECAQBBH.hAAAaEGHMAEGFCFBXEBHhAAAHCFANBAF..eHCAhABACEAAAHAHEEDB..WFBFLHBC.OADFhABA.....hACA...,1,-10,-27,17
SJUXYFCADIKENRMgcHVQZOGbPadfLBWTe,DDBGKCABEBBGRFGB..MAFBHEEF.QBFEZAGDGECHaGHFLABGhAAABAEAeHCEUGAFXECFhAAACDHH.ADIBIGABhABANCAD..........hACA......hADA...,2,-26,-17,9
CEZKgTGeIaFPVLDdMYARHBSJNQfcWXUbO,RAEGHAEDBBAESADF.QCGDfGGE..cCAEhAAAUDEACHAFKEHDGCBEhAAAaGGHFGCDLHCADAGGMECEhABAADHANCAG...XBDCEABH...gEGBhABA..hACA...,2,-26,-2,24
UOBIENXKJRAfGWHdVMTPSFQDYbgLcZCea,GEBEdHAFMDBASFEEDIEC...bBCBLEGDZAFA.aBCEhAAABHAAEACA.NIDBKCACRAGBAFDF.hABAHDFC..PEHDhACAYAAECFAC.OGDCXFDDfEAAhAEAWCFF.....hAFA...,1,5,-29,34
GVePIDHbSaTcJLCQYZONEBMRAUFKgfdXW,UCGHKFAFdCDEGDAG.eFGBIHBHHFCHaCDH..JGFECAGCQAAHhAAAZFDF.ECEDhACAMCCDAEHH.FCGFfADFhADAXBABPAECDFFH...SCADhAAA...hAIA...,1,-6,-33,27
POSadNQVCYGBWTefMDFJEULAXKcIgHbRZ,XEADKABA..IAGGHDCGRFFDOBHHdDEC..VEAGGABFhAAABDGETGDF.hAAAfCAAFFGFEHCGAIBE.hABAbAFBSCDF.aGECCCCD....hADA......hAEA...,1,3,-37,40
MEITBJCFNgYDacZUdAPSRKGVQLHXeOfbW,RFCCKBEBGBGEQAGAHGFEOCEF..fEBAMCADTABHhAAACDAEFBBA..NIBDDDDDhABAaHGAZDEE.AGCCSAAFhACALEBD.XFFG..eBDChADAWEADBAHB...hADA.gGCA.,1,7,-17,24
LIPTSEbVYCQJWAgNDdXUaBRMcZfeKOGHF,DDFBXBAEBDAFRGDEZFBA..KCDFHBDH.IHAG.TFGDhAAAbFAG..CCFB.QAFAhABAAABE.dFFGaCHBhAAAfDBEOHAELEBASHDGEFGBJACEhAGA..WDFGNEIG.hAHAMDAHeBBB,2,-21,-15,6
IaZTKgdMCQYHLABOEfXGDPcUebNVRJWFS,BHFEEGFGGACEDCDBUEFAeEAB...VDGHREBGFABF....SCFFhAAAZAFBKDAD.MBEGhABACBHF.QGDGhACA...YBBFAEIFXBDF..hAAA......hADA...,2,-53,-4,49
SgNMKVRPeEOLGBFWQZUJdXaYbIHCATDfc,DBCASFFDMDIB.RCDA.eFEHLBGBBDCGFBGFZFAEdACC.aAAD.hAAA.IFCDAEID.hAAATGAAfADFhAGA.NIABKHGAECCGWABC.JEGD...bBEHhAFACECC......hAGA...,2,-33,-14,19
JNKLgQfXWZRAIEcMdGbTVUePCBSaHFOYD,EBGEdFBAGDEG..VFCDUAFCeAACCCACBEDCaEFA.HABG.FGGGhAAAOBCF.DAFBNBIG.hABAKGFF.QEABhAAA.XGGHWHFAAEAGMIAE...hAEA......hAGA...,2,-22,-22,0
BYXCWNUIEOdSJPVAfDcRaFeTGQgZbLHKM,DHACaCDE.FDEHGEEFZAFC.LDAHKDGE.MDCDBABG..CHCAUACFhAAAEEAG.dHGF.SAHFhABAJHFGAGEH.fCHAhADAeCAC.gGDB..bFCDhAAA....YAFHhBAAWGFC,2,-56,-20,36
BCRZcTOGgLeEXDSFfIbaAHKMdJUQVNYPW,HCAEMEHFUADAQCGC.VEEF..PBBFCHAFZAFGOEHDhAAAGGBHeBGHDECESFAEhABAfAACaHFEAFBGJDDHhAAA..NACHBBBB......hAHA......hBAA...,1,-7,-24,17
SeUYHbQEfTBLWdAgGJRNDaIKZVCOFMcXP,JFBEDCGCKEFHZBCD...CDFC.FCAB..MDHB..XGEHeBDDUFCChAAAHAGD.EAAABGAGhABAdGHAABFFRAEA...aEGGIHHDhACA.OBBHSFAD..hAAA......hADA...,1,-31,-37,6
gAbSBdJRCVMUQOXEWTLeafGFDIYKNZcHP,SCEAJABC.CCAE.UAFG.OCCFEGBCLBEC.aHFAhAAAFGDFDIDAKGFH..NFCF.hABAZFBF.HEEAADDFBFAEhACAdEAGMBIDXFGEeAADIDHH..hADA......hAEA...,2,-33,-24,9
PJKWMZcIeVERONfGUgdBTbCQDaSFAHXYL,XGFGLBHFJGAAKCGC.ZDDB..eEDHRFEH.OCAGGBAAdBEEBECChAAACAAD.QACHhABADAGGFFADHDBD.PFFGhABAMAFCIHHD......hACA......hAEA...,1,-17,-21,4
VHIFKTSbZcJPeUQBRXgaCEWGDAMfLYNOd,MDADLAFA.OGFCVFEGHGACKHCG.SDDGZDCF.JABDhAAAPBAA.UCFGhAAAQBFFBADBXGAChABAaEHFEDBFDAIDAIFC.NIDF.dFFF.....hABAFCAH.....hADA...,1,-14,-15,1
aQIPVXgcTZCJMRHALfdEbWGOFDYNBeKSU,dAFEEBGCGACAFFBHDEEB.BFGE.KDGCSCAGUFAA..QEDEhAAAIABD.XAEBhABATDGC..ZFFGMIFChACAAAHBLEAC.fGDGWBBDNIAF.hAHAaAHD.....hAIA...,2,-27,-22,5
OaPgSDXfZLJMYTQUEeRAcCFVHNKIbBGdW,FDFCVCEAKECE.BGFBdHEH..ODAA..aACBSFHFhAAADICGZAEE.LGAG.hAAAJBAATFACEFFFAAIBCEBGICHFhABA..bAECPFHB.fGCFhAEA.MBBBhAFA...,2,-49,-17,32
NeAbKTXZRMIPScHUWFEgDYfCBOGVQadLJ,KDEDXCEBZDFBRCAE...MGDE..IAACSEAH.HEFChAAAUGCAEHAADFAGfCBEhABACHFC.OHDEhACAQAGFaAFAdDDELEHB.eACChACAACIBPACCFHAGBBEH.hAIA...,2,-21,-11,10
eBZaNFfMUYVERJCgQWGXDdTKOLbAIScHP,SFADHEAHBCGDaEDAFCEE..UFGEEAGBCFCH....QEBChAAAXEFDdBCCKABGOAEAhABAAHEA.ICCChADAPAADZADHfEEGMBIF.YHCAhAIAJHFEWHAG..DEGG..hBAA...,2,-26,-11,15
PLgQJfOERbeCHNGATKYBZVXaMISFcdUDW,TCFGBDHCZCCA..aEABMBDG.FBAHUGFA.DADCLFCBhAAA.QGFHhABAfCCHREABCAHHNBCDKFCB.XGAHhAAASEGGWABF..PEEHOEHFhAGA.EEEH.eAHBAAGE.hACA...,1,-7,-27,20
TDWLfeESZUQXRNadVJGAKFHYBOcCMgbIP,FEFFHFDHBGCFCECC..MBBB..bEBATGBCDDDA.LAEDhAAA.eFFGECABUAEGhAAAXDFENHDD.dBGDVABChABAACCFKABC..OBHHIHHH..WHAGhAHA..SGADhAGA..,2,-33,-4,29
bSGXJWHFaNdOPYREgMCeIVLBfcDQZUTKA,SFBHXGEHHGBEFEEG.dDBH..OBAGRAFCMACAeFGBLDFGhAAABAHCDEDHZBAGKEEFAAEBJBGFhAAAaGHH....NICB.hABA...ECDACGAC.fDAB..hACA......hADA...,2,-34,-7,27
JIYCNMAORaTeEBFfQHGXSDdbKUgcWZPVL,OAGDRGEGeADFBDAHFEHHHCBDGCDA.DCGGKEEF.UADD...hAAA.gGADhABAZGAEVGEGJAABIAFA.hAAACDGGADIDaDEA.EEAFfFCC.SFFEhACA...hACA...,1,-17,-22,5
MRAWTbeLOZPVFQgYBcDKHdGSCENUIaJfX,TDBCLDEC.ZCCHFDHFQAFABGDEKAEFGEFESDABCBCE.hAAAEHGCUAGH..aABAhAAAXDDHMHBEAAEEWFFFhAIAeHACOABH.......hBAA......hBBA...,1,-18,-23,5
GHdJAeZTUBKXPbNCQRLFEDMaSVIfcgOWY,eFECTFGGBEDC.KCFEXCAD..bAACQACEhAAA.FAGHDDIDMIFEaHEAVFADhABAIEDA.cFEBhABAOADAGCDBHCAAAECHUFAACDGA..EGGGhACASDGA.hAHA...,2,-21,5,26
KBSeHTFCJfNbUPaVgdOXcWZMDELGYIAQR,KGDBBCFAeABGFBCG..CFGF.JDEE......fGHEhAAANFBH.UECFPGFAaFAD.hABAdCCG.OAFA.hACAXGBHWHCEMCIBLEAD..IAGHhADAAHIHSBGGhAAA...,1,-32,-43,11
LDWfPFBVXHUJbKcQTeCdGSNARgEZYIaMO,RBFCEGADZEAA..aBAEOGFELFCD.DBFG..fDDEhAAABHGBHEEDJABCKCEF.TDAAhAAAdHAFSGEChAEAAGDF.IDHDMADDFEHF.XBGAcCDACAGFhAFA......hAIA...,2,-30,-12,18
KBHIRJTCdVgXSeZaNPAGcYUFELDWfQObM,GCDGUGABFDACDGGD.QCBBMDEB.BGBDRBGH..CAAFdBCFXCGFhAAAZFGB...NBADAFHFhABAEAFF..LFCBhACAODCD.KAFAHFEFIEAA....hADA......hAEA...,2,-25,-24,1
IeZdBRaMPKYSDFCcGHEAXfNLWOgTbUQVJ,XDGCLABFOFBH..TBCEUEEBQAGAhAAAIFDBeEBHZDCBBFHBMBBBKEAFhAAASGHDDBADCAHCHFFGhABAACCENEAC...WHDAgADD..hAFA.JHDE.RCFG.aEDA.hAGA...,1,-8,-9,1
gVaKFbOXLUIRBCdYJeTEPGQfcDSWNHMAZ,ZGFAaEFD.FCBC..OBBBUCGHRAFGBCDD.dAECeABG..EGCCGEAChAAAQBFGDCFH.hADASHGCHEFGAECEKEDHhAEAXGAB.IHEH.YAAChAGA....hAHA...,1,-17,-38,21
bSXVaEfPILCeMYFOgRKZHBWTNDdUAQcGJ,QAGHJGAC.SDDEVFDG.EFFF..fEADhAAALFCDCADCMABG.FCDGhAFAOBADRAFAKBBDBHGFhAGATDGFDIDCAGIB.GDEFaCCHIGDH.YFAFhAAA...hAIAgAEF.,1,-10,-14,4
BHGIFSbYMfXdUPOJTNWcEZRaKgVDeLAQC,BBBDGGDDSDFCMCHFdBDHUDEH..JHAC..TEAEhAAANGAD.EBAHaAAGKGAFDCFCAFDHCCCDhABAFBDD.....hACAbEEEXGBD.OAEAWAFARDBE.gGEFhADA..hAEA...,2,-37,-8,29
LgDPfNTHKYbGZXMJOacBVWQECIRFUedSA,DAFF..NCBCHGEGKEBAGEEEZCDC..MABGOBHFBFEA.VAEGhAAAEAGCCDDF..FECEdCAAADHC.hAHALAAE.fEHEhAEAbBBF.aGAH.QGCGhAGAIHCG.eBBG.SHGAhBEA,1,-8,-29,21
BMGDeFcENPJAbdOQXgaWYZLSKHTUIfVCR,dDDDOBEDQDAH..aFGEZEGDLHFCKFCA.UAAFIGADhAAAVGAG.BCHEMDAGhABAeHBCEEAG.JADEAGECXAFFhADA.gDGAWCBESGFFhABAfECBCEFHDGIH..hACA...,2,-29,-10,19
GAObaLcQKBCHUFJdNPgXfDZTWYMIREeVS,OCEDLBACKFAGCFAFHEEB.FBGEdGDC...PGECXAEBhAAADDCDZBAGTDGC.MDAEhABAIABEEGBESGHHhACAABHH.aBEHBEAFNIAF.fHAFhAAA...WAHHhADA.eBDH.,2,-32,0,32
NVRJFUfBceSbHOPMdLYICKGEaDZATWgXQ,TGEDXBFD..QDGFRBBGFEDG.BCBHSHBAOEAFMACEhAAAdDAALAEChAAACFCCKAGFEHCEZFGF.ABADgGEDhABAJCEF.fFBAcGGA..bBCBhABA......hAHA...,2,-21,-12,9
YQKAZBgNHMSdacEJTDUWefFVCLRPXGIbO,ZAEHBHCBHDDHSBBAdFGEaGBG...EFEDTCBEDDDE..UAEDhAAAeBBEFGGHLAHBhAAARCGFGDADIHEF.hABAYCAFAIEAMFAF........hABA......hACA...,1,-12,-25,13
gcCBKAVbOMSTIdJXEaYPUfQZRNeGWFHDL,VDBFMBBF....TEEEdFGEEADF..aFCDUGDDZADB.eBHFFGHBDDADhAAALAFH.CDDEBFEChAAAABHHSCGAhABA.IHEHJABB.XGAFfHADhABA...NEIGWDADhADA...,1,-24,-26,2
DHVRJTPUbASNEKIZBegYWacOfLXGQMdFC,SFGGKFCABEFA.eAGD....gBEEaFDCODABLEHHhAAAXDBBMCAEhABACHHHDHEERGAG...PAAChAAAAEACIAGD..YCHBcDBDfHFBhACAdHBDFEDA..hADAHBCC.,1,-14,-31,17
NcYSIWLOZBRbUKEGJaFeXfPCQVgAHTdMD,TEFGMDAADDFG......NCCCSHCEIBBFLGFChAAAOAFDBAABUAGEKGBGhABAEFAFJBHDaEAB..FECAXADChACACFBC.gDDHAIBAdEGH.cFGDhAEAWHEG.....hACA...,1,-17,-32,15
CgNVKZXBYJcAQWMeDbHLTGaURFfdPOSEI,MEFCDBEEHCDHLCBAaACH.UEBFREAA.dHBHSCGG.CGEH.hAAAgFGCKEGH.hABABAEAJHBAAIGEeAAF.hADATAGGfAGDEEEDNEAC.XGGA.hAAA......hACA...,2,-21,-21,0
dgVOSbHNFLGfZCQWKBXUETADaIYJecRMP,DDAAaECE...JFBCRBCAdHAB..OHCESCGBHEEDFAAHLAFEhAAAGBGCCEAAKDEEBDDEEHFEhABAAHID...eDHHMAFBhABA..gCAE.NGBD.fGGAhACA.WEAC.hACAXGAC.,2,-27,-5,22
PAZLCQNEgIbaVTGMSXRJeKcFBUDYWfdHO,CFAFEGBF....IBDEbCFB..TBACMEFB..RCFBKGBABGGAhAAA.DFBG..fABGhAAAODEFAICELDAGhABAQGGAaDHFSEAEeAFAFHEC.YADChACA.dAHG.PDDHhBAA.,2,-39,-11,28
CbMgHOWVAfXNQacIKSLBGTYFePJUDRZEd,XCGCQAEC.aHAGKEGA.BDDDGEEAFAFB.JBBDRBAB.ZCGDCHAG.MCAHhAAAHEAG..VEBAhABAAAAA....NHBHSGGAhACAYEHBeHBADCCG.EAGE....hACA......hADA...,2,-31,-1,30
eELXFVPQJMcWRSdNCHDaAZfBOTgbIKYUG,BCACOBEH..TECE..bEACKGHBUGBBEDBF.FFGB.QAAHhAAAMCGBRAFE.dAHCCFEAaEAHhAAAADCHZFEF..IHDEhABAeADELEHH..VBDH.JCHDhACASCGGDBBCfHAHhADA.,2,-24,-3,21
fAZVOCgJUBGMPXbQNDELWaIKYRcSdFeHT,ODCACCCDUDEB.BBDBGFAD..MABF..XADDQFAEhAAADGGBLAHFhAAAaFFBIHDBKEHBRCABdAFF.FGGBhACA.TDGFAIHA.ZDAC......hADA......hAEA...,1,-19,-32,13
NfbcMBXadTFgPGeHKZCALREIVWQUJOSDY,LEAEEGBA.VBDDUAGD.JACHDCGE......fDFHhAAAcGED.XFGHhABAdGBHFEFG.GDADhADAKBAFAFBGIHHEOFDD.SAAEYFADMIFChAEABAGF.aFFB..hAFA...,2,-28,-23,5
TRHOKNIVEfUMXGJLgZdSYFDbAacPWeCQB,aFHD..PBBAeFEHQEAHBBHHRDDFHCFHOCDAKHEG.IABEhAAAEDACUGBB.MAFAhAAAJCCFLDGHZFFC.hABASHBCDECHAHHHCEHC.NAEHfBGBhADA......hBAA...,2,-18,-11,7
MSFYIacDNdCbKZRfgBJOHXWeVQGUAETLP,LDEHMAACFCDH.aABCDAFF..dBGHKAHDREAEBHBEHEBB...eDHBhAAAGFEBAHHG.EHDESDCGhACAICBFCHHCfAEGhADAOEAB.XGDC..WEFChAEA......hAGA...,1,-22,-30,8
VLcZUDTQGgHNJWPBMORSeIdbFYXCKAfaE,EDFCLDAFUBAF.QECEHFDF.JHFGBECG.OAEGSAHFhAAAdGBGFGHBCCDAAEBHaBDHZACAhABADFFAGGAH.gEFFhADANAIG.MBIFeDAH..IFHEhAEA....hAFA...,2,-18,-13,5
HTNKaGVfJDRdbFPQSgcBeEWOLYCAXZMIU,XCCEZCCHUBEGHDAHKEBF.GGAD..JBHDDBBGRGDCdHAHFFFAQGEChAAA.SDGAhABAgACHBHHFhACA.EAGEOAAH.CAGGADGD.MFFA.hADANAFGfHGHhABA...,2,-37,-4,33
FgVcPeKCBHfTaWdZbDLAXRIUQJOYSMENG,XFGAUBBCOFHD..SAHHMBIFGADGFHBC..gBABhAAAVFDB.PAFHhABAKDFHCBAGBAGG.TFAGhAAAaEFEdDEDZDAADEADAHCF.RDCDQACAhACA.EEBB.NIEB...hAGA...,1,-4,-14,10
HZgFLDKdXGMCfIEbaONYSAJVecRTUQPBW,JACBeGBA.RCAH.QGFEBACBHBGBFEDADFHBKFCGdDDH..GCEHhAAAMIBC.CAHD.EEFF.aGABOFAFhABA.SFGEhACAACCA.TAEGWAFC......hAEA......hAGA...,1,-23,-25,2
QGXBZMVHPJWDIAfNebUKcaERYgdCFTLOS,eFCBKCBHEGGHRCEF..dCCFFGDHLAFA.OABAGBFG.BHAEhAAAMFGDHEEB.PBCAhABADDDFfHAFhAAA.NCBC.cAGF.aCAHCEHE.SFCChACA.....hAGA...,2,-27,-15,12
OXcKGZEIFBYHSPLQbgTACMaDdVeJNRfWU,CGBAMBDCDFID.dDFB..eGDARFADUGEC..OBGHKECGZAADFDAEBEAChAAAHADH.LEEGhAAA.QABAhABA....gCCEaHGCNIADfAHAhAFAWEHH.....hADA...,1,-11,-48,37
LMBXIGNdbgJWVFRUefOCYcDKTaPASZEQH,ZCBAQDCAHAGBBFCHGBAGdACG..JEABFACH.eGBGCHFH.DAGEKADAhAAAaEGD.AEAD.EFGGLCFChAAA.MFFDIHHDhABANEIA...bDEHWHBG....hABA......hADA...,2,-29,-15,14
NDdPZYKUcSBFVfOLQWIMRTCGAgJEXeabH,EABGXAAB..eEDBaCGB.HBDF.DGGAdGABZAFGUADFBAADfHEFhAEALCHBIFAFhADARCCCCDHC.AHAEbFEHhAEANFEB..KGGEFGCF......OHAChAGA..MCCF.hAHA...,1,-4,-24,20
LQZKTFXEMBVSJbDGadcCIAWeHNOfgRUPY,eGFEHFGHOBAGRCDA.UGBGLEBDKHEGFAGDXGCB.EAFEhAAABFAF.JDFG.DCCChAAAaDABdDABIBADhABA.AEFGNCIEfEDD...YACChABA....hAGA...,1,-19,-31,12
gSADIQFJBNRHWYOEGaePXfKVLdMTUZCbc,QFGGBFHFREAEHCEGOFCCGABA.eHCC..PDCC.hAAAXFABKEEDLBHHhABAdBDHTBABCGAAgAEAhADAAHEEDABAIHCD.NAEF...EGFE.hAAA......hBAA...,2,-23,-4,19
cJAbSGMHaKDOVNgfFTBUeXYQIdCEZWLPR,GBGCHEDEDGAHOHAG..gCAATDCEeADDQCGFhAAAIBFBCGGDEGEFZCAFPGEEhAAAJABAABFA..MIFEhAEAaFACNIEBBBHC.XFAFYABHdDDFWAEChAIA......hBAA...,2,-8,-2,6
LRPAcHgBIYQEKVJSZNeGTObaDdFCUMXfW,HBFHBBAFQBEBKEHFJABF.ZFGBeFDFOCAEDGAF..FADHMICAhAAA.....XFBDhABAWFBDLEAEhAAAREDDADGEgEAFEDDESGFFNAEF...hACA......hADA...,2,-24,-22,2
ZYAVOFNMbdKCDHaGWERTBgPeSQcfJLIXU,FEBCMCEEKGAGDDBFGEGG..EAEGRADABCGGeABB..QGEBhAAA.JDEFIEFHhAAAXGABZBAA.AIBA.NDHACACBhAGAaAGA...TFDHSDCH..hAHAcCDE...hAIA...,2,-29,-26,3
EOTHJIaAeXbPLcUKSBWVNDFRYGdfMZgQC,eEHBXEGFLACFUAAB.KEABBGDF..VFDCDFECFBGCRAEAdHAHZDAGhABA...CHAG.EDFAOADGhAHAJBABACED....hAIA.bFBB..SHGGNIDH..fCDDhBDA..hBFA...,1,-21,-31,10
KQFUYLGTbRIfWJNOVPSgaEHeCMdAZBcXD,BEDEDGABKBBEUFDHGEDARAAG.....IDAEJEAF.OFAGhAAAVBDG...SGGHhABAaGHB.eACEhAFACCHCAHAF...XDEFFCAC.YCGBhAGA.TGBF..hAHAWHBANDIA,2,-54,-28,26
HJRDabgXETVAUOFZLNPYICcSdKfWeQBMG,OBAHLGEE...PAEECGBDSGDHKCFA.eDEGQCBDhAAABAFBMCFCJEFGDFCChABAaCBD.XABAEFFEADGAFAAAhADANCAC....IHAGfECF.WFHHhAEA.....hACA...,1,-23,-29,6
MKfRGQOLDVZSHAFWJcYNgbdeTaUCEPBIX,FDCGJDFG.....NGCD.dGFG.TGCACBGHBEAF..MCCEKHFCGAAFhAAALCAD.DFDEZDFEhABASDBBAADC.hAFA...WHAAcGAH...YAAGhAAAeBDAEGAEIDDGhABA.fHGD,2,-39,-28,11
AGfWELYQXJHCgFbeZDTUcPMBaRdONIKVS,GEAGEAHBLCDFQDEHHFBECHFGFGGEeACADADDUAFC.MAIHhAAABEHB.dCADOBCHhABAKBFHSFGBACAE.hACAfGAGWHDG.XAAFgDGBhAEA......hBAA...,2,-19,-12,7
BFMgTcaELJWGNHUCOSRYVdPIXZfeQbAKD,DEGCBCCCMBEH..TDAGEBFA.LACAJFED.GGCHHDBDCAAGhABASHBGRGAE.hACAVDDCdHGHIBCEhADAZFGBfAAG.QAGGAAFA..hABA.FDGA....hADA..aDFG,2,-23,-10,13
gTEULHfFBMcJDVANRPSaWeGIQCZOKdbXY,RCCASBAAeCACGEGCCEDE.ZFCBdGEA..XGECTGBBUAGGhAAALEBBFBEH.MBGFDGGEACDDhABAaACG..QDGChACAKAEBbAGF.EDAABFFCcFAB..NBICIAADhBDA...hADA...,1,11,-24,35
YaBOLXHfQUWgeITFPSJERVGNZDAcCdbKM,dFFHKGGAMHBEBBBBOCEGHCFE..QCCGUEAA.eFACFAHF.hAAASBBFEEDDGGBBhABANADDDAIFABDB..CHHE.YEFGhAAAaHEE.fFEGICAE...hACA......hADA...,2,-32,-7,25
TXKdINMacegVORGHbfCYUSEBZJFLQPWDA,KAAFdGHAMHBGeCBE..ODGBHBFHCDDF.UEAABBHCZABALFBFhABA.QAEDhACAPFDAACAE.TFDA.IDBAhADANIAHaAFG.........hAAA......hACA...,1,-23,-26,3
RIFTMeCgDQXJVEAdcaPKZOWLHNbSBUYfG,aAFFZABFLECGHECA.SGEHUABCGEGGFGBH.eBEHDAFDQEGChAAAJAHFAEGB.dCGDhADAKGDAOADDbEAHBAADhAEA..fAHC.IHHFhAGACBDB......hAHA...,1,-8,-22,14
WLHPUcIagGMAbOXeVQDdCFfZREBTJSYKN,XBADVFCA.DEAGFCDG.ZFABBCFE..JCHBSFFBhAAA.KBHBNACGHGFAUFBDaABAhAEAMAEA..AHHGOEDGhAFAeBAFCAHA.EHEGTDEA...WBDEhAAA......hABA...,2,-29,-23,6
ZCTeDdRBQIcEVMOKGPgUFJYaAHbSXNfLW,HADCSECCXEDFLGFGZEAF.TBAADCAGdGCA.BAHDIEHHhAAAEFHDMDAAGADFhABA.PHCCgGEChAAAFEAHaDDAbCEE.fABFCHAA..eCGFhACA.....hABA...,2,-13,3,16
QXBCgKfeTUSFdWHcbIOaYLMAEJDVRGPZN,ECFGDBDCRCBHZEAH..QDECBBBHCGEF.KHACeDAE..UAGEdGGHHAFGhAAA..bGDEaECEhABALCADMFABAIDCJDHDhACAGDGE.XECH.fAABhACA....SDDEhADA,1,-15,-25,10
fXGDVNFHTKWeMaCOPBcAgdURJZYLEQSIb,UDAHRDBHZFDHLGAAEDED..SGFG..fAAChAAAXFCDDCGAFFHFKBGFhACAMFBBCBECBFFHAACDdEGAJBDEhAAAIBCE.........hABA......hADA...,2,-35,-32,3
TSXGPbMcFaWRAgZKIECHQULJfBDeVNYOd,ZAAGEFDBHBECLDFABDCDDCCFeEFG..VEDFOABG.dFACSFAChAAAXDDFbFFChAAAFHBEaBEA..ACIHKFBHhAFACHHBJAHBNIBD...........hAGA......hAHA...,2,-30,-8,22
UcJVDOPCTMNAeLSfRHIdaBbFXYGZEQgKW,SBFDHDFCaACAFGDEGEAHZBFA..EBACQEGB.KABAhAAAcGABDBGEOHCChABACGHAMDBCADEFeFFB.fCCFhADAdGGGBAGBYECAWAEC...hAIA......hBAA...,2,-21,-12,9
CeWcSZDAfaGQFMdgNHBETJLOXPUVRbKYI,aAHDFHGAdFAAHCEHBGDEEDAA.LFEB..XFBGUCFDRADF.bABAhAAA.KGFACCBG...eGCAhABASAAEAIHE.hACAQAGHMDIFTAFB..ODBEhADA..YCCBhADA.WFADDIAG,1,3,-26,29
AZCHaETNdeXfcLGBJWIObYRQDMPgVUKFS,HEADEFFFdAFAeAHF.XDDELEHFGBCHJHBA.OABARCACMDEBhAAAVGDC..KDFFABBGaCHDhAAA..TEBChABAfHGFBAHCIACFYDGF.DEAB..hAEA......hBAA...,1,7,-26,33
SgFPEZTAbfVLIMHDdOXGWBNJUcCQaKRYe,VEGHMAAEHGDC.DEGBXDACBAEHUCCACEDB..KABBeEAFFCFGZGAAhAAAAIDELDFC.hABAdBBCOFFH.NAIE.hADA..cFCBaFBESBDCEHGAfBGHhAEA.....hAEA...,2,-27,-10,17
DXJEFLNabVKcgUARIGCWHPTOMYeSfdBQZ,RAAFCCGAHAFEOGAE..eCAEdCCCBGHADEHDEABEFDAH..LFFFhAAA.aEADVDGF.KBGChAAAgECBACIBGDDE.hACATBDB.MHAAfCFCXGGANIAB.hADA......hAEA...,2,-27,-3,24
dTbEOAKRfLYXFJZVGMHIcWSgUPDBaCeNQ,KAEHLDFFFGCEZCACVCBA..MHFGHFBA...IBFAhAAASAGG.UCEFDADCCDHAhABAQEAEdGHCEHAEAIFAfABAhAGAJFFE..cABHWHDC.BHAEhAAA.NIEH....hAHA...,2,-22,-19,3
VGfbTaBIYLdSeXMgZRPKCFWDQNJcUOAEH,VFEDGGDH...fDGATBDHBBHGLDBFdDGH.eAFGhAAAXDAGMABCRBCACABHDIGEhAAANEIC...UFBAECFCaBBGhAHASDDA.gBAGKEED.hAIAWHAG....hABA...,2,-31,4,35
dAgOQHTUCGPEJfLaXNcBDKeVZWFRSIMbY,OFGBHEFAUADAGADFECBFLEED..aECAXAFAhAAABGAHDAAFKGHFeCCGZGAA.FDGEhABAIBACbCAH.ACGH.hABAgGCFCDDF.......hACA......hAGA...,2,-19,-15,4
AYPJDFTUKdLeBbZCQEIaGXgWcMSNfHORV,JFDDTCDF..KDDFdAFFBHGECGDH..ECHFGACB..XEAAhAAA..gBGFhAAAMIECfBAEhABAHCAD.VFFCABACDFGCFBBAUGAC.bFFG..hABA......hACA...,2,-31,-15,16
WLQHJTGKZRUIMCPAOdfEgBXVNDacSYbFe,OEEAEFHFBEGE..XGGHDCDH..SBAEFAFBLBCBhAAAQFBDTEABKFDChABA.UGDFIAHFhAAACBBDAADCdHAFVBEE.aDACbAGHeFFH...WEEFhABA.....hACA...,1,-15,-24,9
OFQSLCZfaXIBTMRJADHWdeNcEYbKVGPgU,DBAHHEBDdDDEeDED.EBBBKHECGGEDUDGB.OBDEFAGB.LHAGhAAAZBCA.XDGEhABABDAARFAB.ABHCNAEF...YDADhACA......bFEA..hAAA......hABA...,2,-46,14,60
gYLBGEWJPXdUTSObAQDMNKVRFfIZeCcaH,MICGVDFH.RABH..FHGCZAAC.CHDD.HECCLAEEEBEF...JCAFPDHFhAAAdFCD...SGADhABAABGDDFIDKCDBeAHHhABAaEBHBAEF.WGCA......hADA......hAGA...,1,-22,-31,9
GIKYQfLDXebPBMaOWgAdVZTJFRcSUEHNC,VCCHZABEJAHD..FCGHRCCC...UFCHHDFBGAAFKFCG..QDAChAAADIBCeAFFBGHHhAAAMIDA.ODABAGHD.dFFAhABASHACCBHF.......hADA......hAEA...,1,-21,-28,7
YWXZLFTaVfKRCgeNJObMEIHAQcPGUDBSd,QFEGGDDGDGACdFGB..XCEGFCFD.aEAEKBAHRBADCCHHeAEAhAAA.OBHBMGAGIHHBhAAAADCD.cAEAhABABHHFSABB..WHAG.hADATEGBfEABhAEANADG...,1,-9,-40,31
PfHXYZEgVBJAOSWDKeTbINQGMcaRCdFUL,SCGCDAEBeDEG...TDCHIFFCQFECMIAARDAFdAAHhABAFBBALDHBHGDEXAGEhADAEHBCBEAB.AAIHOHFEhAAAKFCD.NADD.cDCACFCGfBAEhABA..YHFGhAFA...,1,-3,-21,18
bdWQURSZHaeGEBAFILXKcVYMOTNDCfgPJ,FAFCLDBBKDBG.VFDHMFEH...OFHFTAEG..DGGDCHHB.hAAA...fDFFhABAJFCFdADAUDFHSHAGhACAHAAB.aAGD.EBCDIHAFXGFD.hAAAYCHB.PDAHhADA.,2,-32,-22,10
VRCdKJAZBPbQfYIEUOgceTWHFGSaXMDLN,BABFQAEA..fADHEECAUFFEODHFeFCHHDAESBCHhAAAMGECLAHBhAAANEAC.CFHBdGAEAGEFPBADhABAICDH.gCFD...hACA.cGBH.WCEGhADAaEECDIEG.,1,-7,-17,10
BLUQWaFJgKNEfXDYCHeIPMTdbRcSGOZAV,BHAELCBGQBDHaFBE.FGCAKACGEGGHDEGG.HFGH.eHAEhAAAPBAFMHDC.dCFBREDGSCHHhAAAOAEAABIF.hABA..WCBHNCAGfEEGCBGB...hABA......hACA...,2,-32,-8,24
OIMTBAPHfZgdYLVUaKbGFcNQXCJEDRWeS,HAAFZEADdHDHLADHUBAF.aCFAKFCAFFEB.QGBGCBDA.DAFGhAAARFFEeDDCOHFE.TDBBhACAAEFH...PDGBhAIAgAFA.....YCHDhAAA....hABA...,1,-1,-43,42
DNUXFdecAPCfGLSaIWOHbMBVYJRZEgTKQ,CBABLGDE.aHGEODCEHCEBBGBCJHBEZAEEEAAG..KFFGDACE.hAAAUDBAdEAEACFEGAGChAFA.IFHBMDFC.hABA.....YACB...hAGA......hAIA...,2,-47,-19,28
LcKdfYRCUeBDHPNEQIZSaJXgWTGOVMbFA,KBCCdBEFREFBCDFB.UFAHBDDG..DCCFHBAF.EGFGQEDA.hAAAZBABSGBBhABA.JBHHgDGBhAAA..WAFEOHCEMFCAAHHF..fBHGhABAeHEGNEAGIBFEhACAaADG.TEGB,1,-20,-34,14
ZBQRgGEAfWbXeOKULDCYdPJNIcMFTaHVS,...fGABbCADeAAC.KFHDDIBE.dEEFJAFH....NDCD.IAADhACAFHEGHADCSCCChADABBHAREGFEGCAAFEGOHCEhAEACECB..cGAGMEEGTEBE.hAAAaGFF.....hAEA...,1,-12,-25,13
ERITeDQOKPXYcJSMNFWUbdVBgHZLAafCG,aFEGCEGB.GGBDEAAHRFCD...eBCEQCBFKCGA..XCCGhAAAJFAFSHGEFEAFbFGDBCAGhABAZAEALDEFhAAA.AADDfCFBDFIHODECcAGFMCIB.hACA......hAFA...,1,-6,-18,12
HDIRgUPQcENTfVdOYaZLebGABXSCWFKJM,SBDCCCBBFEDD.MAEAHCGH.RGAAUAEDQGFH.EFDDTFFHhAAAdBADOCEE.hABAaDAEeDCCAIBCBCHE.hACAXEFGKFAEDFIH.IGBE...hADA......hAFA...,1,-15,-27,12
bSOXZDHdGKYIWFPQJNTERVegBAaMfcLCU,aCCDMDFBLFCBUEBG..OGFCZFFDdABGKBBA..IFAFhAAAFAEF.JFEBEEGA.eHBEhAAABBHAAABE.CADD..SCGGhAEADDBEHAGH...WAEHNDAE....hAGA......hAHA...,2,-33,-21,12
MbPeBYgdLaSOfFZcHUQATWDXGNVKIEJRC,TBBCXBDA.GAACKCHF..EFGCCEGFMGDGeHACBBEC.dEAAhAAASADCOFCEFDFDhABAHGACADEEDIEAIAGBhAAA.JHDGPAFGgEBCfGHChACA..cDDF.hADA...,2,-21,-10,11
MZEWBYdXCLTPHAODgIbeVcKJFUaNfGRQS,DGEA..IBEFeACAKCHHUDBF.aEAHGAFE.SDDEhAAAMBHBEEEABAAGdDADLFBFhABAHGCCAACEOFGDhABAbECHJFHD.FBCB.NDIA...fHEHhACA......hADA...,2,-20,-17,3
dUCSRAYePOXJMHNGgLBVfDcbQIFTWKaEZ,eGFGODHHMEAGHEEBGBCFBCEEDFBE.QBGHIACGTAGGhAAAKDACZFAC..CACFADDEXDGDhABA.gFAHhAEAfBAD.FHAEEGDGSAEChAAA......hABA...,1,-6,-26,20
beFPEDHRVCdMSfBcXWJNZgQYAKTOGUaLI,KEFEOFAAUFBGLAEH.eFFFEHDADHGERAAFdEHE..MCEBBFEChAAA.XCCFJDAGZAAC.hABAQGBBAIBC.hACAaAGHIAHCFAHF.HAFBCHHE.SFFAhADA....hAEA...,2,-32,-5,27
KDXIWTQgUMEBdRHbCJLAfVSGOYZPaeFcN,SGBFOABFZGAE.eBCGFBFB..KFFBIEFG..TEBDhAAAQGCA.MCIDhAAABHEHHBABCEHEAFEH.fDDEhABA.YAGFaADFDIBGWDDGhABAUGGB.EHGAbEAG...hAFA...,1,5,-44,49
KcGfZOFUIWJVRdLabANDgYPQMCXeTHSEB,DFFB..PECCMDGDeCBGHAACBDAAGAEAODHFFEAH.IGFGhAAAJCHFdHBFLAAEhAEA.AGHD.YGAEhABACAHCSEBBcBFG.fGDC.hAGAWADH...aAFGhADANEEE...,1,-14,-32,18
BPWDLgMfECeKYXHATNRcIFJaVGUbSZQdO,RFGBFECF..VGBAUBGEZABBQABG.BEGGDCEELAFAhAAA.MDDCfFHChAAAeEECKEAEHGAAAIFG.hABATBDA.NADBIFED.JHEAaGAHhAEA......hAGA...,2,-25,-16,9
NCZVRFGAIbPWDeTQEfYUBXLOJcMadgKSH,..IFHCPECADBHD..eEBB.EFDGfBEBUBAGBAFGhAAAOBBBJDEG.MGFChAAAdGAGKGGFSADChABACHEGRACFABHA.WHAC.QDGF...hABA......hACA...,2,-25,-25,0
egPAcZLSMJKfCXNRaEVdTbIFOWYQHUDGB,ZCABLBHFSCFHMAFBKEDH..XGFEaFFH.dFDGIHAChAAAOAAG..QGAChAEAHBAADAGABHHChABAeAEHAFFEfGDECDDDEAHH.TEAA.FADFhACA.WCGD...hAGA...,2,-23,-12,11
QLgaedVbHYMFDBKZWScNfJCPXTAUOGREI,UABFOBCAEFCELHCE.eDFGdDEDVGFCHDAFFDCEBBEDKAGFZCGDhAAASGFE.hACA.fHAFhAEACBAF.XAGGACCB.IFAGaBHDMFEGDDIBhAFANAAH......hAHA...,2,-27,-11,16
BPYSOdUWbJRIfDLCGXATVNaKcFHeEMQgZ,TAACVFCH..KCFBHCFD.MHCGZAAABFAHSDBEOEFBUEAHhAAA.JADHRDAGDAHBCHGGAFEH.hACA..aGGCeFFAECDC.hABA.....PADGWBHHIHADhAEA.....hACA...,1,-6,-33,27
KCfMVQGUASDHRFcOgPXNLJIbTaBEYWZde,HBGDRAFAFFEH.OEFD..XCCHLFDF.IBBEaAEBBHGEhAAAECABZCGDdGADKGAEMDDChAAAGBAAAECFDIGG.gAEAhABANEIG.JEHB..YFCBCEAD.hACA..fACChABA..,1,-10,-18,8
XURHDOBCcEPIeQKGAbFZaSVJgYLdfTNWM,ZBABSBAFJDDA.LEGDdHEH.TDDEMDHHUAGB.HFAChAAABGAH.CCFFEDAAeCCDhABAKAGAAADA.aHCG...hACAYBCEfHABNDIG....XEAEhAAAOFHDIFFGhAFA..,1,-17,-30,13
RAcOZCdTWXUBLJFMEQeKIbNHDGgfVSPaY,ODCDCBFEdEBD...TADGUGGEBACG.LEEGMBIDeFFAhAAAKAHD.IHHCHAAFDADGhAAAfBAA.hAGASGAEaGDHADCE.cBEDXCGAEHEGNAHGhABA.gDAHhACA...,1,-27,-33,6
CMJLgVQUPXKDbAOSedFNWITRHcBEZfGYa,SBACdAFBFFFB....IBCCHEBBcGCDBDHAZDAEGADFhAAACHDA.LFHHhABA.QDEDhACAXGBGDABCOFFBeCFAWDAFEAABaFCGJBHD...hADA......hAEA...,1,-2,-33,31
RZbFGagWKOIVLMAeCDPQJXdTSEcfUYHNB,eBEFCECHDHGG.QFEC.dAGDSFFAEEAEUABB.HBBCBEGBhAAAZBEDFGHDaBGDKGCBIGCEhAAAMCIH..ADFGJFAFhACA......cGEH.YBAFhABA.NBICbFAH.hAEA...,1,-17,-25,8
YMAVJfeNbIHaPZTQCKBEDOGSRXgFWLcUd,VEABJGBA..eHAG..IHHEHECGaBFEZECD..QBBGhAAACEHFECEDGADHSGEHhABAXAACgCEGhACALFFB..cGDDYADCAIAC.NAIETGGGhAHAKCAGBAHEDEBE..hBAA...,1,-7,-8,1
KEUdLTOWfaNYVgXDeSbZIBRHPGMQJCFcA,UADHdDEBLGBEOGCC.aEFH....VFFADBEASBFAhAAAZCEEBGABRCAA.HABF.MDAHhABACAHCABAF.EGHD.fHFDhADA.NAIGXDBEIECH...hAAA......hABA...,2,-43,-4,39
NRYXLUWJPIbKDZSAOHVGBTCcFdMafQeEg,HDEEBDFBCHDBFHCC.aCFAeFGB..EGGFRDDDLAADUABG..PFBChAAAKBCHDAFF.ABHF.OADEhAEAGEAGdFGFMDIDhACAfAHG........hAGA......hAIA...,1,-17,-36,19
LSWOYEZIFPgaBfedbRCMAHXDGKNcUTQJV,HAEHXEAFKEACUEFE..QABGLAADSBBChACAOEFDEAFEIHABhAAAFDDFaBHFBHHHeFCAdHCFRBDFCCHFAGAEDCCAhADANEHA...........hADA......hAEA...,2,-18,-17,1
AcNJbLgTUCHXDYEWZRBdMaSPeVGfOQKIF,JFFALCBC.TGAECDFEDHCC...EGCERDCDBAHCdCFF..SEBGhAAA.eGFChABAfBABOEEAIADAhACAAFCB.NAIG.UADB.XBGAhAAAYHFGMIFAaAFC.PCAHhABA..,2,-46,-17,29
cPeRGVOfBZMFASKXgNbTLDIEYUQJCWaHd,SAACXFFB.....NEDGLFEFEECCQBBE.hADACEADaGDGHFGFdBEEeBCAhAEARBGFOAABfGAHhAFAMIFCFGACACHAKBFB...bCBCDIBE....hABA......hACA.YEHB.,2,-10,-5,5
YVTBSEZLJPRHdFWcOIaNQUDGXbCAgeKMf,KDAEMEBF..VEFBTFECBGAB..ECGGLBFGRDFG.dAAFFAEFhAAAOECBIAGAQDDBhADADGIHGDCGCAHCAHHA.hAEAfABAZBBC..PHDEcGFEaDGAhAFANBAG......hAGA...,2,-17,-8,9
DRSQPCUYJdIVHGcXBbZWOFNfLMaeTAEgK,KBGESEBECDGG.UGCFdFCGHAAHGABBBGFBZFFAFHFCLAEBhAAAeCAE.ADIFDIGARBFE..QDGBhAAA.JFABhABAcCCC.XGAD..WAEEhACANDAAMFEC...EACEhAGA...,2,-37,-1,36
ETFAJOZNdWaKgPeBIXcMUHCfSVLRYDbQG,OCEAdDGBKBBB..eFAFBBAD...XDECMECAHAED.CGFE.hAAAfGBASADDhABALDACDGCC.GFDBhAAAEHCGAFHH.JAFAWFHHPHFE.IDHGhABA.cEAB.hACA...,1,-17,-33,16
YgVKbaXZIPDLENCAMFTQRSJdOUWcBeHfG,MAHDFHFARCFC.dCAAUDCEBGFD.HEGFGAAH..VFBCKDAH.aDEAZGAAhAAA.DCEALAAAhABA.EGABAGFGQEGAhABAODCC.eAFCfAFE...hADA......hAEA...,1,-10,-22,12
beKXfUZCGEOQRSdNWYPJVDTFMBLaHIcgA,eBEAKDDBUDBGZACEEGAH..QFFFdEDB..NDDB...PHDChAAAVGEG.DCIHMEIBhAAALAEAHBAFIHCGhABAABCFXGAHCEGD.OBABSEAAJCGBBGCEhABA....aAGA.hACA...,1,-1,-26,25
JbDYQGFcNgdHaMKEeWUCBTRPOSfZVXILA,DEEHQBCGFFAE.....gGBAaGGAMBDA.KCEAEDAHUAAGhADABCCETFED.hAAAPHFESECBhABAfFAAXFEHAEFCbCGFcABGdAFH..WEBEhAEACHCGOBHD.IHAChAEA,2,-34,-15,19
PUcNaOQYHVXCLZDdJEAKGWBgIFTefRSbM,GBAHBHEEFAFFeEFDREFA.MIBAUBCC..aDDB..QECBhAAAHEGHVAFECCAB.LEBHhAAADAHH.EADCAGHBKEADIGDDhABA..SCGA...hACA......hADA...,1,-1,-46,45
DeJBMAcWQVXGNaRSPCOUdbETYHgLKZIfF,QDDCXAGBGDFCaGEE..RBFBCBEFdCBD.EFHHHFAFKFAEZACEFBAGDICChAAABHDEAFFB....hAAA.WABCNCCA.SEDChBAA.OBHD....TEGEhABALGCEfDAChACA.,2,-29,-6,23
dCfFBDJVgbEXIAYQacMKTWUZNPHGOeRSL,QDFAaFGH.KAEHUDBFZBBAHGACGACHOAAAeBHDSGABhAAACGGGBHEB.DDAHgDBHhAEAXCFHAFCB.hAGAMEEFNDIE.LHFAfAGA.FFDA.hABA......hACA...,1,-6,-20,14
LBXdfUWFNCMDEHKQZJgTRabAPOSYIGVce,SCGCGABCeAFELAAABFBAdEDGUGAGFFGD.CEEG.MCIDHAEAZBEChAAATDGG.RCABaGHFhABAADBD..OEFB.hACA...ICDA.cFDHWEADDBABhABAEGFG.....hAEA...,1,-11,-21,10
CUJXSYVfWERPecDNFLHbBOZKTIgQadGAM,MDDEJBCF...XFBGSECD..VFEEECHFRFEH.eBEChAAADBECFCAFLDABBAAFODFEhACAKHAC.IHHFhADAaEGCABACCHHF.UAGGfACD..WCCFhAEANAED.....hABA...,1,-23,-28,5
GaTQReFKICBcWLAfbXEDgOdUPZNMYJVHS,XDADDEGEdBGAUCCHZEFA....MBCHJADG.SHDGGFDH.hAAAaADERDAD..KHAACBGBBEDFhAAA.LGEGhABAABAFEGHH.OBHD.YGAE...hABA......hACA...,1,-15,-40,25
ZTaeJVQGNSMFADPcYIUBbWOHXERgKCLdf,DAID..PCDE..IGCEUDAGBEHDOGFGEAHFRGEECBAALCEAhAAAdABCZFBE.aEBCeFFGhAAA..JEEA.QAEAhABASHDGACCD.YACG..hADAWHBA....hACA...,2,-43,-13,30
TfAgCRPBFdSJbZecMKILVQXNEWaGYUDOH,REDABAAFdEBE.SEGGZADA..MDECKFBELHECQGGFXCEGhACAEGEH.aGCDUBAAhAAADEFD.OHAGHAECABIHhADACFAC.FCCD.eFAD.IBBGNAED..hAEA......hAFA...,1,-17,-18,1
QZVSECBJOWeKdPLcYFbRaTHUXfGNMAIDg,DEGCQAFCZCCE.EDDCCGAHBDAF..OHACKFFDLBAEhAAAFGHBREBFHGDA.UAAFGECGhABAAEACIDGESAGBhACAJADBdAHE...PFEGYHFG.hABAaBEG.....hADAfEAC.,2,-34,9,43
cAFIVPXSZfdBOCWJebagKLNQRTHMYUEGD,FDGBVCGB..XCBEZBBCdHAHBDDG..OBFCCFCE.JABGeDAFhAAAaGGC.KFFBLEBDhAAARADG.MDFHEFHFDABGhAFAAHABSHFG.fAEAWFED.hAGANEEC......hAHA...,1,-20,-28,8
PdgObcSADVRTaHIYWZUENCfFBLXMQGeKJ,DEGGRDADHABG..ICGDZGCAEEDA..CHHABAGFMDCHGADD.hAAAKFEFdFGC.OBHHhABASDABAGDAaCEA.WFFHhAAA..NIAH.FGAF.XABHeCAE.JFHF.hACA..gDDChABA..,2,-21,-16,5
BEIQOPeKWbDHMLadgYATJZVCGfRcSUXNF,TAAAZGCCCBAGGECD..RDACSGABUAFDFGGG.BCAG.IHHBhAAAQCCGOCFFhACAKGABDAEHLFCBhADAdDACAIDE.fAFB..cDGFEEEBPCHFhAEAeAAE....hAHA...,2,-19,-19,0
aLOcUHCWdIgQDZNKXJRYfEbAPBTMeSFVG,TEGBMBECFFEE.GEAGOAAF.HGDCdCDD.QDBHDICEKFHDRCBB.hAAAECFA.AADGBHBEeACCaBABhABA..cAEBhAAACDGD.IHHE.NAIGJACFYCHHfEEHhAHA....hBGA.SFCG.,1,12,-18,30
BJaeIcVONWFXRHCTQgfMPKELUbDGYZdAS,BHBAJCAD.eCDA..IEEEOFBEFGHFRFAB.HBBA.CAFG.TCGAhAAAQFEC.hABAMDADEABAUGGHDIDGGDEDhAAAdCDBAGEGSCCDaACA.cGCAhAEAWAHHfDBEhABAKAHH...,2,-18,-17,1
DHOSAgMUPaQNBIeTZCVKEcRbXGWdLfYFJ,UCADQBEGBDGC.eDBECECH.KACFRFDC.GEGALBFCFAAHDEAGHFABhAAAADHA...MIEGNFAH.hABAZABC..EGEG.XGBHhADAfGHG.ODHDSAHDhAEAaDDA.IGAH.hACAcGDC.,2,-16,-8,8
AHcTPNBCOSgYWeKUXaFZJdLVMDbRGQIfE,TCBDBBFHOACF..SGEG..YCABhAAAKFAFaDGGFAEGZDFBJEDFdBBFLFDDhAAADICGRGAA.QGGChABAfCEGAIBEcBFGCABFeFHF..XAGBhAEAMFFG.IHFChAFA..,2,-23,-18,5
UHJcAQCSNPgfKWbZIeTDOLXdMYaRGBEFV,CFBESBGG..PFEHKEDAZBAGeCACDAAELHAG.hAAAdFGGYDHHRBEBGFAHhADABAFEEHEE.VCDG.hAEAJHFGAIHG...NEAG.WAFEIHCE.OACChABA..MEIBhBAA.aEBGFFFA,1,-14,-15,1
agfKVDJFEMWBOecATHNUZIdRCSbPYGLQX,TEBAHEEFZFAC.dAHECAHA.SCDD..PFEGLBCEhAAAaCCGKHAEDGHBFEHF.MACGhABABHEAeHBGAHGGNCICRBEF.hAGA.GBFE..gAAF.hBAA..fGDAhAAA..,2,-28,-5,23
dCNgTDVXYIAMGRSKBEcUWJebaZfPOLFQH,MIECGAFAKACCBFED.UCBGeECHZABAOCFALFABHBBECGHD.TFEBhAAA..DDHFXFABhABAACAFEGFF.JEHDaFDHhAAAFDDA.dAGF..NCIA.......hACA......hADA...,1,-4,-29,25
daZUCgAKceYJWVbHNfLTXBSMOQIGPFERD,KGGHeCAH..JDEEVADGHGACLFFEBEDD.MIDGOABB.GAEHhAAAEFDDdHABZACFCCCFAEDG.hAEA....cBGBhAAAYFFD.NEIA.TGGA..SFAChAFA..IABHhADA,2,-32,-14,18
KEZLMTVPbYDBRNXaWfdAJgFSeIcGQHCOU,FCCDeCBEGCFAQBGFOEBBUFGF.KAAALHCA.MEEFhAAAPFCDDFDHBCAFhABAXDBGaAGG.dEECAGHESBDBhACAIAEBcCFHCHHE...EHAG.hADA......hAEA...,2,-26,-11,15
BWfGaIKYJCARUdSHgEDZXFOcTQPbeVLNM,UCEBHDFBEDDGDGAFZABDFBEG..OBAF.QFAEeEHBLEBFhAAAMHEEBFDFGADFaAHHhAAAKFEBCDHB.ADHEdGGA..hABAXABFPHCE.NIBF.....WDCHhAEA......hAGA...,2,-22,-6,16
VAKIEeFCLGdWTMJcODSNBaZQXbHgPfUYR,ECEDCEDHLCFEGAADdBGG..MHEGJFBEDGGBBHBC.QDBBhAAA.HACEPDHDhAAAfEGE.YFAAhABAAHCHIDAA.WAFE..OAEAhACASFFFNEIAaHDC..hABA...,2,-42,-5,37
ABQINYDfLMdZTWOKRXHPbGUCcSEJVaegF,QGFD..NHEFDCABMABBdHBHZCCGOFCGXGAC.HAFEhAAAGBCDCFAB.EEGBJDHDhACAaAHHFEEG.ADADBHCHhADAIAACfCGHLDBFKECB....hAEA......hAFA...,1,-7,-30,23
UdQPeKaBIHADgfLEZJYMSWGRCXcVTbFNO,.DDGDLCCCZCCB.MEACSCGBRGDE.CCAH.XBGC.hAAATFBCFAEGOFCEhABAdEEHQGGGKAGGBFHCAHHAhACAEADC.JAAD.WHAGcDAD...NIDD.hADA......hAIA...,1,-7,-44,37
RdQbGFZBTSILHJVXCgYPecODMaWKEAUfN,UBEARAGHdABAGEBDBHDC..SGGCLHEEJAEF..CEFC..hAAA.PDHDOCBHMADFhAFAaEEHKHAG.EABGAGGAfGAAhAGA....NIEFbAGB.hAIAFECD.ICCChAAAXGBDYCHB.,2,-27,-10,17
FADYUMVIaQcHLXNKBOTPEGdJSeRCZgbWf,DBGEUBBHMFEB..aCFAQCFBLFABKGGFBEBC..TDEDhAAAEBAHJFFA..eAHBhABACDDCZFAG...bABBFEBAhACA.AAGFIGDE.XADFOAEG.hAAA......hAIA...,2,-31,-20,11
HVLIGTFXKDCAZMcdbOJagURNSPQEfeWYB,MEBDdDAHOBDF..aAAHUGECRAFF..SEFHEAGB.eCEBhABABCFBLHCChACAIFAETDCBFAADDDIHACCCZEGBhADAJHAC.NEAG..fADF..WFEEhAAA.....hAHA...,1,-13,-38,25
XgHJVQKfPTFRUeaEcIMWYOGCSZdDbABNL,BACCXCFAHAAF.VAFAQFAD.KAEHPFGBFDDDUGGGhAAAeDECECBE..MFFFhAAAOFEFCEHHZFCHDDIDAGEFLEBFhAEAJABE.fCDFaHBEWBAD...hABA......hAGA...,1,-5,-19,14
SPGJdYIEHRTcMfVLaBCDZXQgOUKWeANbF,FDGESFEAGCACdGCHEBEA.HCDB.RFGB.TBGAMFFD.LAAEhAEABABFCAFH.DFABZACDXCDGhAFA.OFHHhAGAWHBG.NIBB..JEBDICFCfCBA.aDGEhAHA......hAIA...,2,-17,-14,3
IeJfcWBPFQUDOTaZAGLbCYRMHdKSXEVNg,LFGFCCACRGEG.HCDGSBFFEEBE..VABA..IFAAhAAAfBGGBBHBPHBAhAAAQDEBDGAC.hABAOBAAaAFGAFFH.YDHDMEIFKAHH..XECHhABA.eHAEhACA.JDAG.,1,0,-34,34
WTDINbSfAKgEPBVUdHYCeXMQOJFacRGZL,EHFCBGHEUDAEHACB.eAFHMBBGOFBC.FEFCRDGHLGBGhAAA.DAGCNEAE.SEDChABAAEIFKHEC..PBHHhAAAdCGBCCEE.JBAH.........hACA......hADA...,2,-28,-24,4
NBeKfLWVSUMgFRPJCQOAZDEdIHaTGXbYc,ECFEdBFDaBABGEDB...XBCG..YFDBBFAGKEAEhAAALFFASAHHhABAgEBHFGHHPHAAhACACCHHADDADFAFIHEE.......hAAA......hABA...,1,-14,-43,29
VRTPcMDeQJXaACLYFBKWHOdSbZfEUNgGI,LDDDFEDCKHFGHADFSAHHZDGH.EFGEUAGCGAEGRFBG.TEAChAAAMBAF..DDBGeBBChABA.JHAGAFAHCGEABDAC.hAAAOHEA.fEEEIBBC...hABA......hACA...,1,-3,-32,29
RGbdgLNCYWScHJIBDEAQVFXeZfKTaUMPO,FGCHXBFHeEEHZAAFKFHF...UAGEMAAARADB.dGEFLFHF.hAEA.CBHDSFAChAFAJFABBHEA.DBCDADDH.fDDEhAGAaACB.PHAEbDFF.....hAFANIEBWDFA.IBDFhAHA.,1,-18,-41,23
JfcTDgPKOAWYXdHUIeNBGLRbaZQSMVCEF,XGEDdDFCUBAH..eEADBHCBLGEGRCFGZDAG..MBBACECDEBECFEDDhAAA...JCAEfCHEhAAADAHD.KGCBAFCB.hABA....WBDFIGHF.NACFaGBHhAIA..SAHBhABA..,2,-33,-27,6
EdVGIKFZefXWNTDcbRAgHaQBOCULMPJSY,aDGHBDBB.UDGFLECF.JCABEBEGdGAGGEEA.FHBCfAAAhAAA.XFEChACAWADD..DAAHbBFEhADAABBCQAGA.CHGHMFAESDDEhAEA.YHDGhAFA.IHHF.,1,-13,-32,19
baUJgHcXVITdeWFQDKOACBNRLGMfESZYP,CGBHRDBBLACGGAEF.EDEHZCCB.....PGFEUGGGgAGChAAAHEDB.VGDAhABAIACA.dBAGeCHHhADAWFADQGAD.DBBDADHEBCEAhAAAMCCASDGFhAEA..aEAF,2,-18,-8,10
IXDdeZPKaBObcVSHLfGWTQAFYJEgMUCRN,FACDJDCB.EGFAUFEH..CBGE.RAGB...XAEHeDAFZADF..aDEChAAAOFHB..bGAChABASDGALFFEGCAGhACAQABHAEHCMDDDDIAAKGCHBHHG..hAEA......hAGA...,1,-17,-25,8
gGNSfRODIXBQZACaPULHKJTWEMbVYcedF,CADGaGAALFEBHBDGKAAC..JDCAEDHB.MIDG..VEAH.eCHDhAAAFGDGNEBD..SBBGhABAfHGBOHAEhACAIBHFBAHEAADBTEFEbAEBdGHA....hAEA......hAFA...,1,-16,-23,7
aDBbIVCNGOASPYfLgMcXJRdUKQFTHZeEW,SDED..YCCBLGDAMEBDXBEBdGGCKAGBTBAHhAAAeEEC..EABBDIEEhABABADDIHAFCCAA.hAAAOCHBAHDC.PFAG.cAGAUAEC.hACA....FDBEWFHBhAIA.aDGA,2,-25,-22,3
TRNPKUMXWZSEeQYCbDaOAdJHVFGLBfIgc,dFBGHCBBGAEEBEEB..IBDBTEDDRCBCKBFCUDGH..MEIFhAAAXFGHSGDChABAEAHB.eABCQAAChACACGFHaGAFAHCDFCGDfHCFNIDD.WEAF..hADA......hAEA...,1,-9,-15,6
FYJQZecdKNBRVLOfMSUWHaXbAEgCPDTIG,EDACCBHEDFFBGCGG.FCEAJHAAZFAG..dECABEEGLADHMHBE..hAAASBAFUBAAHCFAhABAaGFBAGAA...PAFEhAAATEGD..IBCBQGGB..hACAeEAAcAFB.NEEC.hAFA...,1,-10,-30,20
DFWHVYRCXJgLZISTMeUKNQOGfbaPEBcdA,FEAHVBFBCBAB.....XACHJDFDZACH...SAAGhABAMCHB.KFHHOFCFGEBEhACA.fEDEhAEAaGGDEBECBAHGcFFH.ABHEWFADHCBB....hAFA.YHEA.hAAA...,2,-39,-7,32
GfeTOKVdaCDRWFNSZJAYUMPcBHXILQbEg,UDDBMBFDBGGHHBGHLDAD.QABDEABBGCAAeEFHhAAATECGKHGEdHADDHBEFEGGhAAASEHHACIB..hABAYAFCcFBFIBEBfACB.OHDEhAEAaGDD.CCGD...hBAA...,1,3,-30,33
EVWBCSUaJQKTgYbGeMRPcIALDXHZFfOdN,DCBDXCADFFAB.dDFHEDGBBGGH..SCFFaEDB.QACAhAAATGBF..gACDhAAAGDDGMICGhABARBFCIAFBAIGGLDHHfFFAOCCHWGFGhACACAHE...KGBA.hABAYAEG.,1,-9,-18,9
HcYZARgEUeXBTQINVafFCGMPJSODbKdWL,EEAGeDBFBCGGQGGG..NACC.VACDFFCDGEEHMDIDSFCEhAAADDDA.KHBEdGHGhAAALDEGHADEYAHHhABAABACUAGAICAA.CHFF.PFABhADAOAFB..WHCA.hABA...,2,-12,-6,6
VSERHcAYOFNWeBDbPJGdQfUIgCaTZLXKM,OBFGFEADeBDABEEGDFHD...JEAAQEDB.UCGAIHCGhAAACBACZCBA.KCDFSAAEhADAHDGBAIEC..NACB.hABAbEBDGGEH.dBBCfGFG.hAHAaAEG.....hAIA...,2,-29,-14,15
dcbJODHGULfSZKEaRAYIQTXVNWFPgMBeC,QFBATCGG..XFEFVBEFFHACMEBGBBBC..dAFCJGEGhAAADGGBUCADSAAFhACAEEAH.AHBHIADGhAHA.PEHFgDGHCCCDcGBF..hAIAOABA...hBBA...,1,-19,-24,5
BRfCYXDLHFaGIUKcETPAVeNOSQgJbdZWM,VDBFOACF..QAGBJEDBZAFC.BGGACGFG.DCABFBAB.GCEBhAAAUBDFEGDH.AABE.SECFhABAdDGAREED.XGAGhACAaAAC.IEABKHAG...PFFAhAEANEIA...WHEAhAGA..,2,-22,-21,1
UXLDECNgZKOAbRcSQFWeIBTdGPaVMYHfJ,RCCHQCDEeBAHBEEBdEGBGFCF..aHDEMBEAHDBD.JBAELDHDhAAADHGACAHH.NICHKFAChABAAHAA..SFFAhAAAFACG.IFAC.PADAfGAGhAFAXFDF.EGCF.hAGA...,2,-21,-10,11
VAEMIcNZUBLXHPSdQfDRFaTWGCJKbOgeY,MBFC..NBFEBBAGXFCFHDBF.dADEQEGGRBGB.FDCGhAAAaGFBTABACAGC.KGHBhABAOFABeFAHAFFHIDDGhAAAZBEC...PEHFDICAWDAF..hADA......hAEA...,1,-15,-26,11
fVFOMZBbGdWLCJDQNITSAEHceXUYRaPKg,HADHeFEHUCDCaGAFKHEA....VBABMAHDBHCCdAAACGDFDFBBQDFHhACA.TGGFhADAEDGHXAGE.hAFAPHFCgDCEOABG.....hAGA......hAIA...,1,-18,-28,10
VDYLfWKMaZgNOAdTPCSRJeQGHXUbcBFIE,TGCBSABE.eEEHQBBGGAEFHCCCXFAFUFAGBAHGhAAAFDGGEHGCDEAGfDDDhABAKFCBMAAD.aGGHNIAHOBBBhAEAACGECADHREFE.cGFGYDFC...hAFA......hAHA...,2,-10,4,14
MWQdZXKTFcIGRNCAPebaSfOEJDgVHBYUL,eFDDSACAOGEGECCFDACD..HFBHBBAEUEGEMAFEdDFGZDBAKAFAhAAAFBGE..IBAFhABAGCDFCHHBADEDaBHD..hACAfGBA..JDADYDAFhAAA...WFFE.hADA...,2,-18,-17,1
IdOYXMQCcUaGFBEKAJfSgHeDTRLbVWPNZ,SGEGeGBCDGADRABF.LCDB.VAFBPBEC..IEAChAAAOEAG..MDHBhAAACDGHUBAAaAFA.BFGFAEEDJFFBhABAfHAB.HFAG..WDDEhADANDIA......hAEA...,1,-12,-34,22
XMVODbFGSdJZHCaeQcKERBNTIUgWPLAYf,XEADOFFFFEBBdEEEHEDD..eBHHKAFDRBBGBCDG..IGCDhAAAgGGF.PBDGhAAAAHHBMEAD.DDAGSCCDhABACFHF.cABGEBHBNIAD.TGCBhAEALABEfCFFhAFA...,2,-29,-14,15
TDFYRQEVONaXAWICZGScdPgeBMHKJUfbL,CDFFGBAHdEDE.eCHDBDHAHFEEUGFBLHAE.DGAEFAABQAFBhAAAEBFE.OEAGhABAXADBAIBEIDFBhACAZDBB.SDDH.PHFCMHACfCAAhACA.hADA...,2,-42,-1,41
bFLfBPcZYaIeXKMASWEQVDgJROUGCdHNT,SGHHQEEADCGARDFAGGADdCDGHFCD..TBDDFGHDLAEGhAAABAFDZABBaDBB.IHFFhABAKDDFMAIFAHEFEGABhACA..JFGDCBBA.fBGC.cEAEhAAA...eBAFhABAWCFG..,2,-17,-9,8
NOQBfDHWSKeRTPVEGICMacYAJdFZbgLUX,FGBHZAFGLDABUFEC.OBAAQDGABECDHFDCKADA.eDEAhAAATCABEGCD..CHAEMACEhABAaAHFAIHE...dEHEXAAGhABADDCCSHFAPDCC....ICFAhACA.cAFAhADA..,2,-24,-12,12
CXLUWOSQDPEdTHGBfYNKMAFVcaIbeZgJR,FHGCaHEG.eGDCZFAHRACELDAH..UDDEOBBGDIFCdEGGHCGFBCHDhAAA..fDCBhAAAKAHHAAGH.IHBChABAJBAD.XAFG.WECASGCChABA.....hACA...,1,-21,-36,15
MOAgbQJLaDWKXFCVYPfeEISHdUBGcZTRN,QBDGaBEH.DHCGKAGDFEGECHEH....VEEA..fEAAhAAAEEABHCBFBDHDhAAAGEEETFCDRCBBMAEAAABGJHAAhADAXBGH.eFBAIGHAdHGH..hAEAcBAB.NIAH..hAFA...,1,-2,-26,24
TICOZgaWHAENRfKGXeBLcbJPUFQVYSDdM,RAFFGAEGBHEELBDDJEGF.FHCCQBBA.SDHBhAAAMACFCDACZEGDaDEHAAIH.EGAEhABAKEAHeHEE.bDAC.hAAA.PFDG........hABA......hADA...,2,-38,-8,30
BOUJQYWVEHLIDGRTcNKPFMbZaXfCAedSg,eFBFSFBEBDGEUFEDQFFH..VBCALDDGGBAAhAAAcAAEKAHB.MAHBhAAAaFHF.CFAGAGCBOHCC.hABA.WHEGIAFGDAEETBDANEAG.FDHD.hABA......hACA...,2,-22,-8,14
HMGKPFRDXcYgfENaSLCWbTVAJUQdBOIZe,UFDHdABCBHCBZCCGHCGDKDDB.FGADDAIH....XGGE.hAAA.YDBHEADHSEEChAAACBFC.TAFGhABAAFHGQFDFeBBFMDADPFAB.RGFC..hACA..fADGhAEANICH..,1,-11,-39,28
ANXQfdKePFGMRCUJEgDTHcaVSLOZBWYIb,XDDFdDBFeGBAFBGBRFEE..UCAGECEFDIFCHGCE...aGADSACFhAAAOABEZBFDBEHGhABA..IHHHhAAAAIACfFAH.KFGFMFAGJADE.....hAHA......hAIA...,1,-11,-34,23
cZULIYQefATdbCOKWaHBJEVGDXPSRNgMF,dFEDCAGBKDDCaBED..BEBGEBGB.GGCD..PBCFRAAD.MAAEhAEAFACGUCGHLFHB.hAAAQGAFAFGB.hAFAOCBH.JHEEDGIFSAFE.hAIANEED.cDCH.ZFGBhBEA...,1,-4,-38,34
bMUNPeQLVSWIOKBdfEDFXCHgZTJRcYAGa,GBBGaDDF.MHAEUEADeAAHLGBA.SAABIGFABEHGhAAAEHFG.FFDGXDGGhACACFADZBEB.RACCAHHANAIG..hADA.PAHF.WHAG..KCGDDDFF.hACA......hADA...,2,-23,-11,12
EJAfYQLZDXCURTPNKgWSFaBdHOGcMVebI,QFAGDFEDCDBD.UAEGRBFC...TCAEKDGHSBBEhAAABEFDdEGEHGDE.GAADhAAAMFDHVFFBIDDAhABAECDH.ACIDfAGFZFABXBAC....hABA.NAEF.....hACA...,1,-2,-32,30
dbVIEGALNZgRWCQcDKBaPYXSfeMOTJFHU,ZGFARDCCCGHG.QGCF.KDCFaHAC..XBBASGDGeEFEhAAAMCCE..TAFGhABAHAFHdCHA.IFFChAAAADGALAED.NAIEWDADcFAHBABHYBAFhABAfFFDOHFChACAFHAC..,1,-2,-33,31
BMHbLEeDSOPgVcaGfQYdTJXWUAKRCIZNF,CGBAZDEHFBDGBBCF.MGAGLFHF.eABHDDIDOACA..hAAAPBFF.VFEBhAAAaECAGGCH.fBAGhABAYEAGdGACTBFF...WHFAhAGAADHBKHCG.NAEB.EHAGSDDBhABA,1,-14,-41,27
UALJHcaNWETYCfbIOVePZBQSKRXgMDFGd,LBEEJAABHBEG.aHGCEHBE..CHAB...IEFBeEEEZBAHBFGHhAAASEAGKFBG.XFCDhAAADDBEFAGAdHEBAAGA.hABANEAE.TCCF.bFFEODHF..QCGFhACAMDEH.cACGhAFA.,2,-20,-19,1
QMNdUSVKLbaWCRcZJeBOXgEFfIDAHGTPY,TDDDQEAH.MCEAdGFCSAGFLFDCaBAHCBBHZFBA.JAEFhAAABHGH.OHDGhAAAECADFGHDfDEBhABADBIFAABB.PAEA.NDIGKBBE..WCHD.hACAeHBGIHBE.hACA...,2,-25,-4,21
bCPDRHQTOdLFKgJNIZfGUEaeXWSMVBAcY,...bBCHCFBGDEFC.HFGBTCFEOADHFGGCKBAF..JFDGIFCGhAAAGAACUAFF.hABAEHDCeAHB.WEAHhACA.MFFCACIH.YFEF...PAEBhADA...dBBAhAFANEACaDEG.,2,-34,2,36
dgOFfUTSbcRCIWAZXGYELJDPMQBeHaNKV,XBEAGDBBLBCGDGFD.MBIHeCHFHGACKBADdGAEOFDCFDBHUEEFhAAASFHD.hABAbAFHCHHCAHGBEBAF.PHEChAAABDEB..NAEF.fEAG..cBBFhACAWABE....hADA...,2,-32,12,44
JMacFHXBVWbeCDTdKAOLSPgIRZfUYEQNG,OEDCSCAF..IHBBRFBHZBBBUGGGEGED.GBGA.aDDAhAAAFBED.BABE.bDAChAAAeAFCDHGC.dGEGKCGHAFADLABEhAFA..fBCF.hBAA..QAGHhADA.MDIB,2,-23,-10,13
bNUVLTGFQeaYKJWRXdBgAZEcHfIPCSMOD,ZFGBHFBC..IDCHCFFGODDEDEEEUDACLHBCFHBC..eFHHhAAAaFBEKAFDRBCA..XAGAhABABACFAAAHEGFF..hABAfHEDMAEB.NACF...GAGAhAGA......hAIA...,2,-26,-12,14
ZgEbdLcPReKXATFUWIGNCfQJYBDMSHOVa,FACHUDGHGEBFCBAD.QBECBGCHDIAE.MEHDHDAG..aAHDEAFEhAAAdGEBLBFG.hAAARFGD.eAEEKCCCABBGIHAFhABA.NIDBfDACSEEFOHDEhABA.....hADA...,1,-19,-25,6
XgLSeVPRaACQIYTcNUFEGDJMWBHfKZdbO,QCDHTCAD.UAGCFBGHDHAA.MDIFHDGF.KGEDZECHbBABOEFBhAAALFCC.eFAFhAAAPHFEAIBE.IFAChABAcGGH.GABDJACABCCFdEGA.XGBAhABA..SDDBhACA.,1,10,-18,28
UENOBTSCWJcKHVAZPeLfdMgYDbaFXQRGI,ZCACLFHHMIEGDBCGaHAE..FBADRBFB..UFFEEAFCBGDF.CDBA.JFADhAAAHDEG..ACCCeECBhABAfHDH.dAEGhAAA...bCCD...XBGA.hACAIGGHNAEBSEEFhADAKABC..,2,-33,-17,16
XURDESOCMVGQgbTaAfJeLcHdINBYFPWZK,eEDGHDDBdHABBCGBFCBEZAABKGFFRFCG...EEAECAGF.GCGC.QADAhAAATCEEAICELHFAhAAA..IHHChABAPDHD.WAFHDCCGMEBH....hADA......hAEA...,2,-29,-14,15
KXULSZCAEWIcTMgJDNdaefYRVHOGPBQFb,EEFB..IFAFMDCEDHFGdGFC.eEDHRECBHCGBOADFGEACBHHAhAAAFAAAKCCDUADELBABhABACAFAAIDG.TCFC.hAHANAIE.aHGE..YFFC...PHAChACA....hADA...,1,-12,-19,7
IbGSAYfRXHNdOTBDFgcLVaKZJQMCEWPUe,RFFDXCCBdDBHBAGADEFA..FGACLFFA.aCAHKABD.JCFGQGBGhAAA.CGDBEAGGhABAUADHeHDA.IBFFhACASGEDABDAYCFG.NFAH.gEDChAAA..hACA...,2,-53,-4,49
eCBLPSHWfTMaXDZGbAJVYNcKRdQUIFOEg,VDEG..NAFAKGEFQFAG.UBCFIHAF.EDCDCCAABGHBhAAALCAHHAGHTEFDhAAAXDBE.DABAhAEAZAGBAIFGJGCE..cBBA.FHGE.eADBhABASHFEWGAEMDIDhACA..,2,-24,-9,15
MZYeWDRNCJLFIcfEHKdPUaTOVXABGbSgQ,BBEEGBCASDFAQGAEZCACeFEHRGDE.CABHFEGD..fBGBhAAAHAEEKEADPCFChAAATFAE...XBAGhABAAFGHMIBADABD...NAEFIHHFhACA.dCEH..aEEG.hADA...,2,-26,1,27
bBEYUHTGacZWFKPSDdVJQNfeALMORgIXC,LFECMCHHRABG.XEBBBDEGUGBF.HFFATBGHGEABaADBZAEDhAAAKGED..DGADdHABQAEGhAAAfCAFAHHHOBABhABAgGDGCCCG.EGGD.WDFA..hABA......hACA...,2,-15,-8,7
JMVWHQCNcaSeTbIBYXfEZFRgDdPULAOGK,KBCDVFDDQGBF..NEDD.SCGHeBDC..bDBFIHHHhAAA.BAGDhABAYCAFfBEBhACAEGHHFGAFDECAdABFLDFFAIFGOFFGMDIFCCHH.cDAHhADA....hAEA.aAHF.,2,-28,-9,19
IMJbgBWCFGYQKUVXALdNHDeSOZRcEaPfT,dCCHDHEEeCCEZAFDEFGH..aCGG..TEBAJHBA.BCABFEAEGEEFhAAAKHCEUADB..AHHCLABGhACASBHBOFCChADAPEEF..fAGFIABDMEAHhAAA.....WHEAhAEA..,1,-17,-31,14
BJAWFDQVNHMPafgOGLdKCRSeYcXZUITbE,DGIBQDDFHCDBMHACaHFA...OACBdAHAKCAGCADE.eFCH.XCGChAAAIEHBTACHhABABBGHAGBC.FGFEPFAHhACA..fCFGgEGFLAADhAFASEAE...hAGA...,2,-33,-3,30
gFbIVeATfBQHSXMLCOUPNRDJGZKdaWcYE,BGAEQCFASFCGMEBGLHFAUDDCRFGF.DGBAZAFFdCCH.aFAHhAAA....cBAAhAAAYFCC.FADAIAHFhABAAHDA.fGEHCCAENCIA.KACBEABEhAGA......hAHA...,2,-31,-16,15
THVDNBEWfbcORMgICGdSQUYJFXKaZeAPL,LBEEHECDDGCDEBFD..fGHGOEAHMABFCFDAGCAA.hAAAQGEDUGFCFADFaDCAhACAeDDCAHEE.PDHFhAAANDIEBEGEWACB.bGAG.......hAFA......hAGA...,1,0,-21,21
WMOCgfBPTcAaLIUYQJVdNbKDGESRZXFHe,aDABUECG.QBGGdGGFKECGGGBDRFFF.FBECeAEF.ODBHhAAACBBCBFEA..TABHhABAAAAFLAHFIHAHJDDC.hABANDICDEFC..EFAF.SACB.hADA......hAEA...,2,-25,-17,8
aUfKdIRTCVWJHeFBOQGMgYZXcSNPLADEb,ECCGaDCB.KHEAdEDD.RBCG.CDGG.....JGBEFAFEBHHBGFCD.MFAFhAAAZAFBSAAGhABALABDACFADGHBUGFG..hACAIEBD....WFAD.eHCAhADAOCHF...hAEA...,1,-29,-30,1
aIdTQXJgcbAWYLeBMEDGFCHOKSRNZfPVU,LEFGBEBGMGBCDEAEFGEEHAFA.OADBKBDDRAFH.ZFAF...PHDChAAAaDHBdBAE..TECFhABAJHAC...cCGDhACAAAFFeEDE.CACF.SGHD.fBBAhAEAIHHB..hAFA...,1,-19,-38,19
AHgLKDaXGCIFMcWNTUbSZOdEBPRQVJYfe,HFBFKFEADDIHXBAAGADD.CBGG.FCAA..MHFG...NCEAUDBFhAAASBGA.dDFDhAAABFFDQDCDhABAVDGFfADAAIHCLHAGaABGcEAC..hACAWAFEZGFG....hBAA...,2,-21,-13,8
cfZOeKQALaRWbDIHEGTFNgPUBdVJMCXYS,REFGDAEEHBFEGCDGFDCG.....PCFCBHBHJBAHMDAFCFBG.SFBEhAAAZFDA.eGFChABAABHCaAEG..ICBFhACAEHDC.TACB.NIEHdHAD..YAAChAHA....hAIA...,2,-37,-4,33
ZJAeWdEbIYcHOfaBURNQGLDXVgTMFCSKP,eDFBdBCDEHBG..IADFHAFGaABG.BGGCRFADGDDGDGAC.VBAFhAAAMDEF.FCFCCHFDSGDDhABAKDBFZFEB.ACGA..hAAAbAFEOEHF.NDDC.XFGH..hACA......hAFA...,2,-14,-13,1
KUYVQBMDTHSFOdcCPEeaXRAbGIJfWgZNL,GECGJCEF...fDBHZFGHLHDCUAEHQGAChAAABBCDDIAEHGEAOFBAdABBCBAEeDAGhABAaBHHAAHA..IEEAhAAAgAFEKFABMEIHSACB.cCGDhAEA..ECFD.hAHA...,1,-4,-27,23
ZCfFAPdGMBREeLNaVSTKJDcbIYHQXOgWU,GEDHBDDEeABAaBBA...SFEHKGAFJHDA.DDHH..IAFBhAAAHFBBOAGH.hABAgGGFUCEHZCACCCHHhACAAEBAMFAFEEBB.NAAE.TGGHbBCE....hADA......hAEA...,2,-20,-14,6
SMfdANDCXIOJRLYUEGTPgaQBKFbZHWcVe,CACGXADB..OBDDLCCBUGAGEGAFGFDD..TGGAhAAAaAFEBEADKDHHFBAGhABAZDFCHAABVGCAeAFFhACASCFEfEFCAIGADIDG.IDBH.hAAARAGH......hADA...,2,-27,8,35
VZRfODCWecNIABTPbQdaLYgJMEXUSHGKF,TEBAQBGD.aACFLAAH.JFDEXEFBHCDCKBGGFGHBhAAAZACEOHDADEHBCGBGeHDAhACAIGABBHHDPDDHhABAdAGBMEAHEAFFSHAA...hADA......hAEA...,1,-8,-13,5
EVXadNQAKYWJTILHFCMPcReZGbDBOUgSf,KHGEJCFFLEAAFABA..CBHD.MBCBRCFDZFBGDACE..BFFDUGCH.hAAA..SBABhAAAECDF.aHFANAEHAEBETAGFhABA...IGAEPHDE.eADA.hBAAbFFAODHD..hBBA...,2,-43,-14,29
bWIJQPNBXSMGYdEOCRKTcAVLaZHefFgUD,LEEHaCGAHDEBFACDDGAE....IBHGQEBGBCDASBAHhAAAMAFBGDGCEHFCCHBGhABAKHACADGAZAEEeDAEUEGAhACAJAAE..XGCHOEAB.....cACEhAAA....hAGA...,2,-27,0,27
VPIWBSaOXcGMNHQJETfUgZeYDRFbCdKAL,VBEA..IHHBBHBD.aGDBODAAGBDBMFFCQDEFhAAAEHDG.UEADeFAFYCHBhABAFGHDdABEAGGFPCAEhACA..SEDFcGFG.NAEH.TGAAhADAfCHA..hAAADBBACFED..,2,-27,4,31
PBLWGHbaOJYgMIfQFcKNdRUTSEXeZADCV,CEDBBEEFGBCDHGEG.aEABOAEG..JBCAMIAEQBADhAAAKGFGdFFBRBGHSBHDhABA.XFBAeAABAGBCDIFChABALDDCbGBAIACDcFGFNIBF...hAIA......hBGA...,2,-20,-7,13
ATJMENgFRKOaSYQCbGBIUVPHLdceDXWZf,MHAEEEAEFAHHRBDH..KBBFOAAA..aFAAQCECGAGGBGEChAAAUGGFHEFALGBGhAEAeDCBDADBZADGAHFF.JBBFNIBF.hABASEDGCAEB.VDGB..dGHA.hAFA......hAIA...,2,-7,-7,0
EJUfMYDFSKBdbAcGXNQPOCHIVReLWZgaT,GDGAQCAB.CEHEHCFEICBE.VAEGLHAA.gDCHhAAATEAFUGDEhAAAfGFEDGIBFABESDEDhABABAECAFEGXFBGNAIEOHAGeAFC.aBBAhABA......hACA.EGGG.,1,-7,-8,1
TLRJbADXcaUSYKQZIPVfdNGCeOFEgHBWM,XBFEUDAHKGHDZGAG..VGAEdHEFGBBFCEFH..ODAChAAAFAAC.HFGBBBGAMCBEhABALEFAJABGAAIDDEIBaCGE.hACAQGDC.fEDFEEDB.hADA......hAEA...,1,-8,-27,19
IVYTcMgRPUEFDfWOBHCaKJZedNQXAGLbS,GABBSEHB..VGBGTAGAMDEHRABBUAEGEFFH..DIEAODDFhAAABAHGHEAACHHFKDBDZFEDhABAdGHCXCEBhAAAADFD.ICAD.......hADA......hAIA...,1,-7,-26,19
daEGWKBRFQOVLPfNZDMbIcXgAeSHTUCYJ,SBHHHAFBCCDBdGHGGFADBDDBFBFE..OAAFLEBF..hAAAfDHEDEIFIGEChABAXFFBAHHHUACFaACBhAAAEFFGKGEH.RDBE.........hAEA......hAFA...,2,-35,-12,23
MCLYZBabTgONKPfWSAGDcVEFXIQeHdRUJ,DDIHEBBCFFABQACD.HGFERFFGMCFFLFBEBEDF.aAHFTGBDhAAAOAGB.KAAE..hAEA.fHCFhAFAAEAC.cDECIEHA.dADECDCC....hABA.YHDG.hBAA...,1,-16,-32,16
gUPOMEIaCZKbcDJeXRHNTfBYVAFLGQSdW,LDEGGDBHQBBGSFDCdCGAUCBGMFAF.EFGDCBFBKHCEDAEGeGDEhAAAHFGH..fEAGhAAABBFFABIB.FBHFPHBGhABAaABC...cACAXADFNEIA..hACA......hAGA...,2,-22,0,22
GNSHeLMIQbURBEOcPCfgFaVDWZYdXAKTJ,KACGGDBEHFACMFEFQDFEUABHBAFBEDDC...OBHBCCACFBFGDGGGhAAAZFGBdDDF.AAIH.NBIALHEChABA.ICCHhACAcAECPCABfHAD.aEAGWHAGhAAA...YFFDhACA.,1,-6,-31,25
QVONBXEcCDSeHITdMKRfbaPZUAgGJLFYW,JHFALAEE.FBFHQAGCOCDFBGEBEFBG..DDEGHAACdFGBRACFhAAAaHCE.ZDGDAAEG.GDAChAAA....WBABhABA...NEEGCDHDIHHC..KGBFhACAfDCG.hAIA...,2,-33,-17,16
cNDREHMXOBVSeCZQTKFfGLbIdYaUAPJWg,JFFF..gFCADBABHDCH.OCFDBGAH.SFACCBDF.hAAAQBCDTCGGKBBBhABAFAAHLAFCdGGDaAEEAAEGhABA.PAHDNEIG.MFFDeHBAfDABhACAIEAF.WHAGEEGD..hADA...,2,-21,-14,7
IPCFYNAJHMeGUcbaDdOBRZVTQgWXfSEKL,MCEDUBGA..aEEGdBBHBADCRGBGZBFH..QBBG..gDAAhAAAXGGASFCFhAAAEFFA.KBEBhABAIHGBFFFCACAHJFAHeAHB....cGCEhACADFIHOABG.hAFA..WDDD,1,-22,-29,7
CgWNEaZcQGVKYDJUTMBdXPHbSFefARLOI,LBDDODAA.CHEA...NFCD.EFGEZACEGAFGKDGE.DBIBUAGBBHAEhAAAdHFHHBAB.FFDCAEDCREADhAAA..IFAEhABAaHAC....QFGH...hACA......hADA...,2,-27,-25,2
RCbeUODcIWSQLGfHXAFJYKdBMNVEgZaTP,JCECdDBBMFAF..EHAGZGDA..aFBATDFGRGFC..CBAHUEGDhAAADCAE..ICEAhAAA.SBFEhABALAFCfDDDXFGAAFFDKEBHBDBGNADF...hACAPABAOBBAcGBFhBAA..,2,-29,-26,3
FMAKSeYCJQLWDfPGXaEgcZdIOURTbVBHN,KBBHeHFGCAFD.LDFB.DFEDGEBC.aBEHgDADhAAAdEFHOAHHUAGE.TDCBhABAVGEABAABFBBFAGBFJDHBhACA..fDAE.EGAB..cGBDhADA....hAEA...,2,-28,-20,8
MISaUDfHeNKAQEVOJLdPFZWbCXBGgTYRc,EEEFOEDDLBAHFBHDZBDCCCGD..BHHFGBAE..TCCCRFFAMABChAAAaAFADDFD..eFGFhAAAKGAEAAFFJECH....hABAdHAHPACC.WCHB.....hAGA......hAHA...,1,-18,-27,9
IBUWEfHKVQRXYDTLdFSbMZNJCPegOAcaG,aAHBBCFG.ECCCKGCHREFA.DGGHLHBC.FAAFSCAG.hACAMCFDZEBCNADD.CHHF.gAADhACA.AEGDGEAAhADAIBGFfEHA.QDCAhAEA...hAIAYAFH.,1,-22,-33,11
GRfVbFDLCMaQZcdHEgKSPONTBXUJAYeIW,eBBBGDEHRBGD...fDBAFGEHDFDELDDGMCCAZAABHFGDKHAAOFBChAAABACAUGAEAAEB.hADA.IGGA.hAAAVAGFCAECaAHF..dDDGEBEFSFHBhAFANBAC......hAGA...,2,-12,-9,3
dMKJRFBfTDeaHVCYAOgQESXIcGNPUbWLZ,OFBHEAGF..XDBBGBEGUAAHLFAHdAGGKHFEJFFBBHCChAAADGEAHDBHCBBC..ADFASDEGhABAIADD..hACANDIC.PADA.......WAHHhBAAMDHBFHGE.fEHChBDA,2,-33,-19,14
LYUNEGITXDWBdgFQbSJKaPOAVecRMZCHf,eECAMBEHZAFBCFFC.HFFDLFHBUDAE.EGCB.GBACXAAFDIACBDGEhAAAFHCA..SBHBhADAaFAHOAEHAIHERDCD.hABA.fACC.IBGEdFHA.hAEAgGEG.hAFA...,1,-11,-14,3
RaVbLWZTUXOgIHeDSJKQBfPcAGNMdFCEY,MDHFCFACRDFB...aHAALHDEZAAB.UABFOEDHHCCGDAAHKCGCBCCAhADA...fEAGhAEAABHEdHAHEAEB.VGEAhAFA..WGBC..TBEA.IAGFhAIA.SEBBhBCA.,2,-32,-29,3
HMBIDNTRCOfEYWQFLJSVXbcgeUGZdKaPA,HDCHBHHBDBCATBEFRCCF.CGBF...EFDFQFGFLBHD.SBBBhAAA.VGDGhABAXAFB.gCAHhAAA.eFEHZAGFKACEAABAMIAA.IFBChADAOEFAWFAFhAFA...,1,-14,-28,14
OZaJeKQYPGNgFXADSCfEcVWLRMbTBHdIU,DCFBSHECEBDD...VCDBLFGDMFAA.bAFEBAHD.dADBhAAAICAHZBAH.aFABhAAAKDGFQGCEhABAPGAC.NEADFFHDACCACHHEfFGHcCGF...hACA......hADA...,1,-19,-21,2
HfbZeacAJLOMUdGNIEPSgWDCVXQTKRBYF,JECEODEE.dHBDGCAH.EGAFSAEEDABA.CDBGXAAChABAQBFE.KFFF.hACABEHHHGFEZABEaEDCAGIHMIDEhAAAICHG.PCCEWAFE.TFBHhADA...FFGA..hAHAfHGB.,2,-26,-4,22
ZafFXAHSVbQGNBLdDOYMJRKEgICTePWcU,SAEDQGBDBDDADGIF.OFHBMAFAKBCBEADA...CFDFeBGHhAAAPAGB..UGCHhABAaBBBFGFBAHFC..VDADhACAbDFCLFBCdGGERDEB.ICCE.WAHBhAAA.....hADA...,2,-19,-7,12
eWVcOZbQXBEMLAFGdYNRJUDSafgCTIPHK,FGECdEFBRFBHDBAC..SACD..gBGCCDHE..hAAATADHIGAGPBFChAAAeECD..VGDChABAOCDBQDABEFFEAFAENAEHaCAGKHGA..WAFEhADAZBEDBHHC.MIDEhABAYDDE.,2,-15,-14,1
eKIgaDWLJSGfcVXHUFQBTdCYbARPOZNEM,RCCGOBFAZDGF..EAACeBBC.KEGFaADFLDHBGFBF..VAFGhAAAUDDG.FGCHBHHEdFACCDADhAAAAFFGMCIHDHEG.SFAChAFA.XGEA....hAIA......hBCA...,1,-15,-34,19
RNJIPLAXdFaGSBMWKceTYOQgUVEZDfHCb,FDADSBDGBGEGKBHBeHDE..OFCHUFAHEHGGZCDH.HEDGRABA.hAAAJDAGLFGDABHB.hAAAdGAEaACG.MBIH.hABA..cDGC..YDFA.hABA......hAFA...,2,-34,-16,18
bdENHXAcJFgCGDLTKIeaZWSVOBfPUYRMQ,FFCBGCEDDBBGLAFDKEAAeBBBZFCE..SEGFBGHG..hAAAfAGBUCACMCIDhABAdADEEDCEXGFHhAAA.AEED.JHDCCEHH.IHADaGBHOBAHRAGH..hABA......hACA...,2,-23,-18,5
UAYZcNIgEVXJCKLHafSMWTbPQDBGFeRdO,ZCDH..IBAEEABCJAFE.KHEGLDGDHCEGaGHD..MCFGTFCFhAAAQDBEBCBHeEADhABAdFACAEHA..cFFFhACANIDH...gADGXBACCAEFfAHEhAEAWHFE.DIAG.hAAA..RDCG,2,-25,-16,9
JgAeCEXfcdRYHOBMNVZQbUKaITWFSPLGD,eGFEEFHF...XEADdCAAHCCDBECAMCGHZCEHQGADhAAAKBAB.IAFGFCHHPAFGhAAADHECAIDE.CEEBfDHChABARGDEOADB.........hABAbABE.aFCC...hACA...,2,-27,-6,21
OWeFNDdKLgVXSEPUcBRGCYHbaTJfAIZQM,QEBHOGBEFADE.DDCELABB..VACCSGFEhAAAEAGFUGFERDDFCHFGHAAB.aCHBhAAAJCFAAFEA.MDADeEEE.hADAdGADKAHH..........hAGA......hAHA...,1,-5,-30,25
fUdAOCeEIGYKZLcHMTVNPDRbaFWQgSXBJ,eEFGGCBDKAADLHBGHAEB.MGBE.VFFEDHGEaCHH.QEBFhABASBEGXFFChACAJAECdCHGAADBCCBEIHBFhADA..YCAF.cAAChABANEAA......hACA...,1,-16,-20,4
QTSKGXWEDbIYMdHCAcfJLNBgRUVPZaeFO,JBGDBGDA.UDFHZEEEFGGF..OFBA.QABCTDCCGAADhAAAEBDA.DGIHIHBHhAAAdFBEAAFF...fGGEhADANIAB.gAFH..hAEA......hAFA...,1,-35,-40,5
XYBTRVDCIPObNGUaSedLKWHJcQZAEFfMg,FCDEMHFC..XBACBCGGREBEDEAH..IHCEOBAAGADEhAAAUFGAeDBFLHBEhABAKDGCJAECZCAC.EFFAfAADhACA.TFEGCAHF..NCIE.SEEChADA.dAHA.hACA...,1,-12,-20,8
FfbURCLBVXTEQJYDKgZPdWIcOMGaHSANe,eEACFCCFUBECCBBB.BFAA..VCFE.EEEGJEHH..KGAEZGAGdHAHhAAA....IAAChACAMIFCHADB.AEIHfFGAhABARFEB.XCAC..hACA..QDADhADA.DEEE,1,-21,-43,22
EWXaUbSJGCYOceMAVZBdFIKTQgHNDfLPR,VADDdAGHKBDB..QGDAHDADDEFBLFHHECAC..aBGGSBAFhAAACHFE.ODFAhABAMEFGZDAGFHAGTFCAhACA..fGGDWEFH.UGAGhAAA......hABA...,2,-25,-19,6
dHIaWCLRBYNgfKTXOPEScJFDAGVeMZUbQ,eCCAZFBGQDBAdHCFHEEG..aDABCBFEBFHB....NBEHKCGGhAAATACG.OHEGhAAAPABASCAFhABAFGAGDIFCAHHC.VDEC.MIAC...ICHAhACAWDCA.YAFChAEA...,1,-21,-24,3
AXFTEcYRPWVDfbSMgJZGKdLNaUBCIHeOQ,XCFGFBEDEHAE.RFBD...VAGDDGHH..SAFEMBBAZGDGdDCGhAAAaADD.BFAEHAAAQDGFhABATDAG..cFFGhAAA..WCAC.fEEAhACAJDDB...KHGGNEIACHEG.hADA...,1,-8,-22,14
eaJZNLVKMHUXdFfOWAbCDREYgIPcSGTBQ,DFFERABCEGDC....IEDFSHFGBBBGaDGBZGAE.LAFAhAAAKDCFMAAHUCGH.FABAhAEAfEAEACEF.hAGACBHCPHAETGGAeHCAJBEB..NEIG...hABA......hACA...,2,-26,-24,2
QBVaMeGLEPRXHgNbJAOdWUSZTCcIYKfDF,OCGBdAFESBCAZBAH..TEDCCHBC..IFECKEHBDGGHFFAGhAAAQDGGBGBHMDCChABAGDBBLADChACAEHCCPAAC.XGGC.NDAEAFIHWAHBhBCA.YHBGfFBBhAAA..,2,-33,-8,25
UPFJcQNECWdVTKGbMOXZfLaIDeSgBAYRH,HDCFUGDBFDFHQADG.EEGECADAdGGGKBFGGBAE.MHBEhAAAXBGEZGFCaHACDBAHSAGEhABABCCA.AFFA.hACARDAH......cAEDNIDF...hAFA......hBAA...,1,4,-50,54
SDVTICgWOAUeQZKJREHdfPYaGFMbXNcLB,QEGGZAFEKCBGRDGB.dCAG.....PDCEGGCDFHAEMACEhAAA.XDEFLGFGhAAASEBBDAGEICFBhABACBAHOHACAIEAeBBE.HFBC.aFAG..hACA..cGGD.hADABGAC.,1,1,-34,35
cFSaZeUDECBPOfMXKYIHAdWJbRGLgTVNQ,JGAARGDGGADFLBDH..TCCHQBFCFDFCZFGDDFEDBDABOFFChAAAMAIB..KDABIBADhAAAAHABdBAH..bDFAhABAgEAG..NIBDaDCBEHAACFFC..hABAfHFB.hACAYAFC.,2,-14,-4,10
EQBSWdGcFIKfaAgOLDVUTXZPNeJbCHMRY,OECADAEDUGADZACH..eBFGJGBC.HDAGRAAF.ECCEBGFH.dFFBFDGGhAAA.KABFAAIHLFAFhAAA..VFDCXAEFhAHANEICMAFE.SHFA..WHEAhBAA.....hACA...,2,-31,-19,12
OWUIHFfdNQEKGeDXcPJVgaMZTCSRAbBYL,BEFBOBCCUEBEFGFD.dAFF..QCAGECDDGAAHeFDH.DEDDhAAAXEGDJBHF.aHDAhAAATGAE.CHHAABBC.hABALAFEIHHBfEEDNAIEKBFG..hABA......hACA...,1,-22,-24,2
AcFOJMWPGCVHgYLEZTXSDfUQdaKReNIbB,OHACJEBD..MBEGGABFHBADLFGHEDHF.TAGCDGFAUFDChAAAaDEGKGCGRCDC.IFAEhAAABHHDACDE...cGEDhABA..WFADPCCHCCHF....hACA.YDFGSADChABA..,1,-20,-27,7
WfJTFEgLDGdUHICRZXQPBNOKcbMAeaVYS,aDCDVAFH....SBEHJCBE.EADFLEAAdGFEHBGHCFGGREDFhAAAQGABBABFKACA.hAEAcCAHAIEE.WFFEhAAAFHAEDDHB..IHHH.PABDhABANDIE.MAFA.fGDEhADA,1,3,-42,45
LdfaNTWFUQDOHCGYAPBZIKMESecgJRXVb,BAAFKHFCMAAFEDFD..eACB..JDHHVEAFLHAC.aBEDTGGHhADA.FGDADDBCCEDDAIDEhAEAZECE.SGEDhABARAECdHAH..fDHGWAFB..OBBEhACA...YEAEhADA.,1,-13,-41,28
DVfCEabLdMAISPFBcTQNHXeYOKgJWRUZG,SAGCFDGGBDAH.QEGFHEDHeBAAOCAEKFAC..JHBAREBGZACChAAADCEA.CCHC..aGDDdAGBhAAAAHHH...IFGAhABA..PFFH...NEAE.YDCEhACA.WFHH.hABA...,1,-23,-30,7
SMgUAJZGBdXOHcCWQNIeTfaFKLYRVbPDE,JHBGBAEG.dGEAHCEBCCHE.QABG.eEAHaABAKGACRDCD..hAAAVAFADDDGECBB..hAFASADHUFCAAGHEGDEBhAGAcEGG.IHHG..FGGH.hAAA......hADA...,1,-16,-34,18
BgFVeMSCEcfDKTOHIYNGdQJUbLRAZPXaW,XDFEaDDHBHAE.FGDF..MEEC.EGCHDGBF.KADEHAGB.IDADhAAANCIAGDBCQGFBhABAUBDBLBAHhAAAAHIBPBBAVFFH.CAGG.fCED.OFFGhACA...dFAHhADA...,2,-15,-14,1
NGIYSUHPLVXfWMQKedBFERgcTObJZDAaC,aCEDGFBD.SEAEUDGHHABELAAFXGGEMDCA.KHFGhACA.BCHFEEACcEDChAAAOAFAZBFF.CBCCNFEDIHAGhABA.VAGHfGGBeGAE..hADA......hAEA...,1,-5,-17,12
JIgeOSEGRHQcFdYaLPXZDbfTCWUVAMKNB,MAAEKAGGBFDC..JFFEeBEH..EEDHRGEGHAADQBFEdFACaDBEhAAALEAH.XACEhAFADAEATCGHWHEEhAGAADAB....gACBODCBSDDEhAHAcGCC..FFFA.hAIA...,2,-28,-14,14
MAHfKJDQaETPGZNSceWRCLBgUXdIYVFbO,KGDDJFAB.DFBH..aCDDEAEG..GAAAZEDA..SFHHhAAAeFCCCEHDLADGBAHFXBCHhABAIHHC.FHDGbCGFhACAAIBGHCFE..QCEG..hADA.NIEHWBBD..hAGA...,2,-32,-18,14
YVAMdSRCTcfHWPXGJBQebKZDgNILaEUFO,dDGFCCBC...TFGFHECEXBGGBDBDeGAAKHECDDAH..IGAFhAAAEACEFDED..OCCFhAAAAGFCRADF....WDHDhABAJHCGQAGG.....hACA.gDAAhADAaBAE...,1,-16,-40,24
NLeTCUGDOFIVbJBYHKaMScPQEXfRgAdZW,dBGAZBDFLCFBCEBHGBAB.FDCB...VFAHbEDA..BHGDHAABMBIHhAAASAFG.hABA.PFHDEFDBfHGHhAAAAAFD.NAIE.UGACDDHDOHCCIHEGhACAKDAFaDDE....hADA...,2,-24,1,25
bVXOUdeagJYFIQAfBRPEWSDLTNKHZcCMG,BBFFEAGHDDAGLDCF.KAACZEDA.MCCEGDEF..XAAFhADAdFDEeEAB.aADDgEADhAEAFFHHAGGF.fEHGhAFAPAHF.WHDCSHAG.hAGA.....NAIECDDEhBAAOHDE.,1,-18,-22,4
MdJXeBGNfCEHUZTPcALVFWYaQObDIKRSg,LCEEFBHB.aAEGOFCG.DFHHIBCFRABF..MEBHhAAAXFECBGEBGAEGhABANICD.CHEG.HDEC.hADATDAFADDE.WAAC.QFBEhAHA.SGHFhAIAdHAH...,1,-25,-36,11
GANUJQRCaTZgEcOFBeVMYPKdILDbHfSWX,UBDAJBAF.CFFC.ZEFH..EAAFFFCF.BCEEMBGH..KCCALDAHhAAAHFAF.SHFGhACA.XGGAhADANCIEaHFC.TFCBOAGFeBHD..PEEHhAAADAIHfHADAAIB.hABA...,1,-14,-37,23
QGSCEeOgNbYJRDaKHXTIMFAUPWcdZfLBV,UCAD..PGFCdDEBLGCCQABESHGAeBABOFCAhAAA..NCIEJAACDEDCaHBChABA.KBGCHAFGXDGFhAEAIGAGMIFEADDH.WAFCfFFDhADABCDHCGCG.EHDG....hAEA...,2,-27,-5,22
cgRUZdONJQYPMaeABWfbVHILSKFDCGETX,BCBE..fBEFVADFLFEFFHFCDEDBGAGGECGC..XEAAhAAARFGB.dBCGJGAEhAAAQGADMCADAIBG.hABAWFFEIDFAKCABCAEF.......hABA...cGGAhACA.ZEDD.,2,-24,-18,6
NHVdCXMLJacABZeWKfPYDGSTOUFRbIgQE,eEAEKADD....PEEBGGAF.TBGDOFADRCDG..IAFAhAAAEAGAHGFG.CCGELBAFhAAAJHEEaADBBEFAWFCHhABAfBAF.SCAAFCEFgCBGhACANDIE....hAEA...,1,-8,-22,14
JSMFRcZPNULgeEICfVKYaDOHdbGBAXQWT,XCDATECE..SAFHREFBZCGH.UABGLFBD.EABChAAACDBAKEECDCCBHECBdCHGBFHDhAAAAAGE.JHACMBEGFADE.hAHANBAC.IGFA.......hABA......hAEA...,1,-17,-26,9
RUQEVGBgDCeIKFbOYLAXWSTfMPcHZJNda,SDEBTCCA.MAEEHBAH.ZFFDdBGFaDGERAACUFCCEFAE.BGHGhAAACHAAeADEFGEA..ODAFhABAYAHD.ADFGXECEhAAAfCCAPFHDNIEF.QGCHhABA..VCGH.hACADIAG..,2,-9,0,9
BDLUWTGdSIbPAZJKOMcNCHVEYaXgQFRfe,KADCMIFGCCGE.HBBF.EAAAaGBH..QGCEFFEA.REEABAGChAAADCAELFHFTADDdCFHhADASDBDIGHCAAGAOCDChAAAcFAB.VFCB......hABA.XAGA.hAFA..fHEF,2,-31,-6,25
NXKBPRQMIULHWCeOYVcfTSEaJgGAZDFbd,FCBGdGECKFHFBHBGRDFC...MEGHUDAHHDBC.CADE.eBDE.OAHFhAAAVAGH....TFBHhAAAaGAA..JDDDAIDGDFIHhABA.XGDAIHADLAFF.hABAWCADfABHhAEA...,1,-17,-38,21
VYEcRbZBSdagUfeKTQFGLAWHDNJPMCXOI,DICAJFCB.MDFG..OAGF..IEGGEFEDRBAB.BEADSCFDhAAAdACBUDCHKEAFQBAGhAAAFGGG.AFIDHFEBhABANIDH.CGCFXGGH..YADFhABAcAGE.aGAD..hACA..fGAC,1,-19,-39,20
GOaJbNCPHUVLQYcfdZIBXADSgFKeMRETW,DCDFFHDEMDBHEBFD.GAAFOEFA..aEFBJFDA....CEDAUAGGhAAALAED.QBAAhAAAfCDBIHHBhABAXGGDSHAGKDHFRFBF.bAGBNEAE.PGBEhACA....hADA...,2,-29,-13,16
MOSDGJcQaAgeFXfPIWdVKTCBLNbEYRUZH,FHAGXFFA..PDAAdBBHKBFA.BEEGLCFE.EABAUFBHhAAAMEFADAID.JHDGaHFEhAAAAGIF.eFBG.IAGAhABA..WDAECEDAbFFE....YAEDhABA...hAEA...,1,-24,-45,21
ObZcHKGWUaCSBLdTEVeAMgYFPQDXJfNIR,MCDCFEBADBBE..XGDD..fFAB.REGHZAEGhAAAcEAEHFDFKEDEGCDFhABAaGAECHHDBCBBdCADEGADAGGE.hAAA...gDGF.PACGhABANAIG.bAFESGHHhACA..,2,-34,-7,27
IQDUNBHACWGgafYRJPcFKXeMSETbOLVdZ,CCDAGBGC.aFBFRFABJEFCFGGG...KGDAMAEC..EGGBOACHhAAALAACdFDCQBEChABA.DIAENEAFBCBGhAEAADAHfEED..YAHH.hADAPAFBXGEH.hAGASDBA.,2,-38,-6,32
NQWJLKGCUIDRMTgSaYVcFXEfABdbHZOPe,dCABHABAOFFEeGCCQBGHLAGDCEAC.DGGE.MAAB.SEEEhABAaEBE.VEAGhADAFAACXFCEAHIHBCDDPHEGhAEANICHKCEB..IBHH..RAEFYHAAhAGAfBDC..hACA...,2,-41,13,54
bRQWOCeVJYIfaHKMcdPASFDBEUTNXLZgG,SBFADGFDBEECUFAC..TDECLBBHGBBERADF.OEABhAAACHDF.JGBA.fGFGhABAKCGHdEGDAACCFGHBNIBDZADEhACA.....QEGA..hADAWAAF....hAFA...,1,2,-49,51
AUKSTLCPXDOZdHfcBWIYQagMNEReJGVbF,UEBCTBBFCAAB...DDDGODHBdAGAHDGHBBCE..IEEBhAAA.QFCHhABAMFGFEAEDRCDGJFAF.VADEFAHHAHHBhACASGGA..XGACcCACaGFBhACA..NEEE...hADA...,2,-41,7,48
HXNDQCaYUFVJBZLEbceATMSdgIGOKWfPR,TGGFSDAA.dFEDGBEGKBBE.PACGHAFEDFDH.CADBUCFBhAAAJHBCBCGB..EHGChABAeCBFADDH.MGBGOHAEhACAfAGF.NAAGaEFDFFAC....hABA......hAGA...,2,-20,-20,0
FTZEcPaUGgdbLMIYRfOVABeJCWHKNXDSQ,BGDGeEACCHBAKBAF.DCEEFADA.ZDDD..EFFG..aAADUBGAGCFEhAAAdBDGLFBDMIEERAGD.hACA.OFHDAIFC.JCBGhAGANAEH....SDFG...hAIA..cDAB.hBAAPAAG.,2,-42,-7,35
XFDfUVYPORaLZWTgGcMbBSQNEJAedICKH,dHDDCCGGHFAEDFADUCAF..PCAERBGB.ZFFF..TEDGGDCDhAAA.MBBGBGBENIBBAACAeDDEhAAA.KHGGFAHH.fBEFhABAOBCGaFGELEHD...hABA......hACA...,2,-34,0,34
EXGHFYCeOKdBSfUTMbQWLRDNAcZgVIPaJ,ZFBBVABFaAEF..EAEBHCBA.CGFF.OFDEBAHDUDGEMHECQGAGhAAARABG.ADFH.IHHHhAAAJCGF.FFDDKECDhABA.SAHBTDED...WDHHDBAF.hABAcAFF...hADA...,2,-22,-15,7
cPQAdDXRBFMKfVebZJCIWHLYOSUagGENT,DBFBXACDREDFBBCBFHCE..KFGB..VEDAZDAG...CAHAHFAEhAAAOAAHUBEAGAGEEBAF.hABA...TGGChACAQGAHAHADMCHHfGFG...hAEA......hAFA...,2,-39,-12,27
NIFVTZUCKcGdOMYWSLDaEHRgeQbBPfAJX,JEFDXDDC.FGDGTACF..CCBAKCHHdAFHMEHB..SBFFhAAAaFDBHBADRCEAQGAFhABA.BEBAhACAfGACAAEFIGHBUEAFOHEEWHCGDAAAhAEAEEFCeAFE..hADA...,1,-10,-29,19
BcFOETJYWUHNIeAXMKZLRgSdCQGDVaPbf,XGFAMEEFKADFLBFAREAF..dDFGGEAAaCBC..PEDFhAAAbDFFBFHB.FCAAOACChABAEHGA.JCHB.UAFAhACAIABAAECA.SFFDDIBE.fECEhAAA.YAEChAIA,2,-26,-14,12
LXHfbgQaZJGNMVDdKISFcOCTAWPERUBeY,EEBABHDGLAEEHGFC..fBBCQBEHZDFDJEGBMAEHDHCCdCBFhAAASBFFFEEGCHHAAIBC.hABARFAAeDDD.XDAChAAAaCAH.NAIE...KBHB...OHDEhACA.WGBC..hADA...,2,-19,-2,17
EfKYXOScZNbBgPTaIQFCJRVdALGeWHMDU,LCEEeBDEHECAMFBGEBHHKGBA..XBAEODCAZGFEBGHETBABhAAAQGEH.hABAFHAACGEC...JAEEdEAGhACAADIFDADH...fEGBSHAGcEEFhAAANADH....hABA...,2,-36,-2,34
NAbecCIUGPSMgdJZRTHfEBVaFWLQOKYDX,eFFCCDBBGDDDMCDCdFCARCBE.HABCBBHF.FADGLGFE.QBFAhAAAKDGADDFFAACB.IGABhABASGHB.JFBAhAAAfHFF.aCAG.WAFCXGBGhABA.NIDH....hACA...,2,-27,-18,9
dFMTgIDBYHJUfOGaWZENbAXRLcCKQSPVe,LFBGCGEFKGAB.SHFAeEEC.FDAGTADCDFFG..BDEChAAAHCAGJAFFOFHB.hABAaCGEEACAABAF..XAGBhAAAcGAC..PCHDMFAGIGCBhABA.fGFAhACAWCAENHCH...,1,-28,-30,2
aCVXgcMQUDESJKeFZWAPBHGbLdOYIfNRT,BDHHGBDCLHBCdHBBOFFA..IAGBRBADCFCF..VGEChAAAXCDD.MEGHhAAAQBGADFIB.EABGhADASDBHKFAF.ZACCABFD.bFAG.fBABhABANAEFaDGC...hBAAcFDF.,2,-27,-4,23
VJBTWdSabRXHKECDNLePYcZgMUGfAFOIQ,FEECOFDAQFAEBDDCdGHE..SACDRAEAKCAD.EFGFCGDBLCHBhAAAeHCC..PAEChAAAZFAD.MABDUABAhAEAADFCIHHF.JDBEaHDEXCGDhADADCGB......hAEA...,1,-14,-27,13
cMBUNSGKCIbADVaTRPYWQfJFLZEHXdOge,VCAATDEE..RFAH.....PEACQAGEFGCGLAEAhAAAEFFAHCFEXBBAhABAOAAGeHEAMEHDNAIGKAECIGFFhACADFCG.aGADfDEE..hBAA.dEHEBHDA.SDAChADA,2,-13,-3,10
dEJZfUSaWObVQHTceNYPACXRLgMFBGDKI,CEAGRBDEMEHFFDHB..BFCFDGBH..dGDEEBEHZEEH..UAAE..aCBBhAAAOAGH.QFEFhADAHAGHeABC.NCIEAGAHhABALHBAGDBG.KAHB.IHGD.hAFASDBE.hAGA...,2,-31,-13,18
VGQXCYcNAEJHFeOIBbLdSaZUTWfMPgKDR,JCHBHBDC.FDAHeDBFBEGEdAEFZFFG.UBGE..fGFFhAAAMDDBKACE.DBDB.RFCHQEEBhABAXAAH.CAHG..hAAA.NHAH.ABBCECAF.ICFDSFEC.hACAaEBD.....hADA...,2,-26,-21,5
BEWJNUcMFCYfKZHTRLdSQIgbGOAXePVaD,eEDFaCGEBHAEEFGD....JBAFUADB.FHFACFEHKFADZCBCHFDELBFAhAAAdAGG.QCDHhABA..gEADhAAAODBDPHEEDDFFNEIG.MAEG.fHBBhACASBAFIEHAhADAAAID..,1,-4,-28,24
ACgaeBGKLSETZOYDfdbVIMFRWHcPQJUXN,aBCAeFCAGEDCLADH.EGGHTEACZFAF.ODCGDDHFdAAFIDHEhAAAMHCAFCFG.RDBE..hABA.HGAC.PFHDhACA.JAGBNAICAGFABDACSBBA..hAFAbFFB.....hAGA...,1,5,-16,21
GOCVfFPaHcXYeTbADdQLKZgUWRMISBJNE,DFCFdBDGKEGAZGEGUCBHRFDA..MEACBABC..EBACCBHB...FGHDHADGhAAA..XAGAhAAATEFB.AFDELAFFhABA.IHCG..NEAEOCEBhADAfCGBcDGA..hAEA...,2,-44,-21,23
FRZeLWOcJKEMBaDGAHTVSNdCgXbUPQYfI,TGFFVGBC..dDFCCFEB.....XBAFUDGBQBBGhAAA.IBGGhABAFDCCeAFEOFAFJFHFKBFAMFDHhACADIEEADADNAEG.....bEBG...fACDhAAALDAA.EGEEhABABAHEaCCA,1,-23,-28,5
XYGPOWTEFAdBVMQfRgUINKHcbaZSCJLeD,BAECMDEGRACFUAGD.KCBHHEGF.aGEDZAAGCECG.LFDE.DGHFhAAAGEAG.PAFChAAAOHCGECAHAFBA.dEED.hABAfGCH.IABANEICSBEHhACA.....hAEA..eDEA,2,-34,-13,21
SAPXIeTWYUgCQJDOfRMKEGcVFaBHNZdLb,XDGFeBFB..TFEBUDAA..QFDGDCACODAEMAEChAAAKFAGEHBGGACA.FHGAhABABGHFHCEFNABBdDDA.hACASDHDIGBAWHCACAADfAHGhAGA..cAGE.hAIA...,1,-1,-28,27
QPWHMTBaDedULIgFERfAYVJbOXZCcNKGS,JFDBXCDGZBCA...CBEH..KCBBSDBE.QAGHhAAAHEFABHDCaEBFdCGDIFADhABAgEABEGFCAFFBhACAbAAG..OADANADD.WHEADIEC.eEEEhAIAFGHDfAHChABA...,1,-10,-29,19
QBPeXYICFMNbAJSaZEUDHROVTcGdWKLfg,aDEDZDBCEBAEHFAC.RACC.OBFH..TBAFdFADKGGFLHDChAAA.QEGAhABABFFCeAHFIAHDMICGADDGSACAhAAADECGGBEB.fEGB.hACA....PGCChABACDAG..,1,-4,-24,20
INYfEPKCeMbZBAQDHOaUgFGLTXRcJWSVd,HBDGaHBE.FCHHLFBARGAE.JAECSCABdEHE..IDBEhAAAYGEG.EEFGCACAMDFChABABDDEAAFC.DAAGODDChACAGEBHXGGC..WABANCCF.hAHAKAGG.....hAIA...,1,-9,-28,19
aMcLBFZXKJeUWTDVQPAOgHfdGESYbIRCN,ODCDHCFBdECBGFEBSHDC..IEEBCCACMAECBBBEhAAAXBECKBEF.UABHDGGA.hABAQGBGAHBGEDAC.hACAYBHBNAIA.cEAB.LHFAhAAA.JAECeHFA.hACA...,1,-12,-18,6
YFOZBAeJfgLdWXDPVaKEMRbScIHTGCQNU,eDDBJEGBLFEFdDGGDAHB....aGAHMGACRFCB...SHBEhAAAICAF.HCEECAABUAEBhACAYBBB.OFHDhABAAGIH...fADG.WCAFhACAPFFHKAHD.EDBF.hAEA...,2,-30,-26,4
NGeJMQYVXBaSRFZTCEWfcPdHUOALIKgbD,LCHDKFEADGIDGDAFMCAF..QBEG..VAAGBHBDhAAASHBAFGFHTBCHhABACAGFECHHfCBGhACA.cFFFPBFHdAGDHFAAADIDIGDDhADAbGEEeADHJFAE.aDEE..hAEA...,1,-6,-8,2
ZTAQGMfgUWVLIEFbRHXNPYKCDaBcOdeSJ,MDBFUABHLFBBFCHHHDCG...XGED..YFFAhAAACHHGDDFCBEHHOCCGeEDHhAAAZAFBABHCGCABfBAAhABA.WHBEIBEEEHFANEAE.PFAB.hACAaAEA.SGGChACA..,2,-16,-11,5
KNMSZUaLPERWfDAgIJGcCXTbVeQHFYOdB,JECDGBAD.CEGH...XBGFVFBEHAFAOCDEBCEH.KFHHMIDEhAAAZEEHLABChAAARBBH..DEEEIHAHhAFAcEGG....eACE.FGAHNICHaDBCEHGE.hABAAHHF......hAFA...,2,-30,-4,26
BADFLZCbdHXKONGEJeRUWVagPcQfMTYIS,DEAHFEBACHABdDCD.KADBGADC..JCFCUAGA...aABA..hAAAPEFBQFEFhAFA.MIFEIAHDhAAABBBGAHHEZDAHHDGH..OFDDEFBB.WBAGhABA......hACA...,2,-51,-13,38
fRITKODbGSVAeBEUFaJWMCPNZcQLdgXHY,BFFAFAAE.aAHHMEAA.CDFC.ZFDDLBHFdBBCHFACRFAE.KDFA.DIFASGFFhAAA.ABDDECDChADAJADG...NEEG.cCCAhAAA..XAFF.IGHEhAEAbDAC..eDHH.hAIA...,1,-23,-31,8
CBFORKNPEXIbQfYSDeZTGcgAaLUMVHJdW,LEFBUFEHMAHFJDDD..CBEG.BBDB.OHCCKHGGEDBD...hAAA.XDABQGBDhAAASBHFDGADTCCHhABA...cACGAFCFaEHBdACC.FAFFNCIGIDFBhACAfHAF.hAFA...,1,-29,-37,8
QHgKeDLdTOWAXGIVbJCYFZPcSBUfRNEaM,XEFAVDAC..CGGDZAAESACF.BFAHRAFBaHACHBDDKCHH.hAAAeFDBLHFAOBHFhAAAAEFEGEDCIHAHJCCAhABAFDBF.UGGH.EBAHMFFGDCGFWAFC.hACA......hAEA...,1,1,-14,15
JKYZNFUODRCcIVQfSEebHWgALXMdPBTaG,XFAGdCBCBGGEGFAFKDEC.ZADEFHCCUDDDDECA..RACA..CEHH..hAAA.IAHFQEFAhAAAEHEE.HCADACIBMEIDhABA..aBHF.....JFCC...hACA......hADA...,1,-20,-34,14
QWPDKeOBIfUcSTMLbgRAEYdGZJVFXaHNC,ECGFGDBFZDAF.JBGDFEDDHGBG..CFGA.QFFBDIBA.eDADhAAABAEBUACHSBHBhAAAMAIB.LHEAhABA.RBCEABBG.dFFCaBAF.NEIEKHEA....hABA......hADA...,2,-29,-8,21
ZfbBYIFORUVENMPDcJKdgTaXGSQAWHCeL,HFDFCFDGZCBEBCGFFCHFUADC..EBBEMAAF.DFBFJHBA..dFGF.hAAAaCCCSADEhABA.QGGDhACAAHHDeDBBfDFAIAHDOEFCRAFA...hABA......hACA...,1,-21,-34,13
JDSGFeXPYNMCVQIWgHbaAUZfEBTKOdRLc,ZGCGEBBCBBHDKAEGdBCCREBG.LCFB..JGACDAHHFBDE..eBAFhAAA..PDEGMBIFCFDHhABAQFGH.hACA.IECA.gGGAbCAGAFFDfHEBhAAA..OEAFhADA.,2,-33,-30,3
ZJAaHgGXOedcCQPWKEUNMbTFBLYRVfIDS,aDGBGCEH.OHCCeFBHdAADQABDKFDAUCDDMEBA.TAEHhAAABADELHEAhABA.VAFADIGAJEGDACIH.hAFA..XEAGCDBBEFHB.FAHD.fGAChABA.IFEGhADA.SFHH,2,-26,4,30
TJcCBIAagPeSZfbYHEMQXGULODWKRVdNF,aHDGeECEZDDD....bCFCEABA..XDABUFAFOBDC.hAAAKGGARGEGdGAAFDBG.cBCChABABFFDAIGA..SGGEhACAHDFEMAIDLAEADAEC.WHCGNAAACHAA.hABAIEGH..hADA...,1,-12,-19,7
JgcXSRNAQYUIDZEaCHPGbfdKVeTOBWMFL,QADFUBAFDFBGZFAACGADHDFE.GFCBdEHGeAEDBCCB.FBFEJHDEhAAAXCAG.SHFEhAAAAEGDEBHH.aHDChABA..fDDGTEAHMAIB...hABA......hACA...,1,5,-43,48
OeRCGZYBMKWgIDHTbVQLAfdFacPSEJXNU,FGDCaBGB...SGGAJHEC.UCGAODEDeFBHRFBAGADChAAABADAKBAG...IAFEhAAADBBETCAA..hABAbCDDLDHF.AAHCfGAEhACAPDAGNIDHCFGH......hADA...,1,-22,-26,4
DMEfBbLKPHTCJZdFXeaWQcgYIGRUVOANS,DDAFMDFFBHHGKFBBHADB..CCGEdBBDeEHB.QAAG.hAAA.cCEHgAGBhACAGEAEUGEFAGGESGDDhABAfDAHLFFF..PDDBhADAJDDFFEHFaFABIAHEhACA..,2,-28,-12,16
PEgZFHceATLJKCRGafMBbdDUXYSINOWQV,TFCGKEGEGBDE.MCFCdBEEUBAD.SEHHIABDODABhAAAQEAG.PEFFhAAAEFBDFGDA.cGGEhADAAEHDJAHHCHHC..fDCEBBDG.DIBGNIAH.hABA.WAFB...hAEA...,1,-11,-31,20
WYOLFKUfaSdHQZETPJeXAcMNVRbBCGgID,MAABRDEFCDBG.GEFADDHF.OBCEFCCG.KAFBUGGB..SEDChABAHGCGZEAE.EHCE.TDAHhACAJACE.AHIFNBICBGBChAAA....WFAGfBACaBBG.dAHAhABA......hACA...,1,-9,-32,23
WKVHXGdfYeQTEAJUDMaRLCcNIZOFbgBSP,DGEEaHEALFFECBDD....IBBHZAAHODDAFAFABDHEhAAASAEHKEAE.HEAChACAdHFHeDGD.QFBHhABAEACAAIDGUAGBMDAG..cGGA.hACA.NIAB.PHAA.hADA...,2,-38,-6,32
ZTYODdfbNKAJgSPBIWHRMLCXFGeaVUEcQ,SFCDBBGHHDFBLFCHCBFG.XBCEFGEDeBAD.UBCEhAAAEAAFZEAHOFAHDIECdEHAhAAA..NDIA.ADAG.PECGhABAIAFF.MAIB.aCEDcBGD.hACAYEGD..hACA.KHGG.,2,-30,-9,21
gUAcCYPNKHXMSZLfdJQbaEIRDeVWBOGTF,CDDG..NBIA.KHACHDDC.MAEBSDGA.LBCAJCBFaGGFEBGFhAAARDAFDGHB..eFCHhABABCGFTFAFFFDFABAG.PHDChACAZFEBdAGD.IADDOACD....hAAA......hABA...,2,-34,0,34
QfPKdVGbCBZYUMaNHWcATDEXgOLeJSIRF,EFDBXDDBLBED.eDHDSACA.FBACfABAhAAAKAGEdFGAGFAFCBGABHHFZDFEhAAAYACBMFIFNCEH.HGAAhABAADCHDIBEOEFD.IEAH..hAEA......hAFA...,2,-15,-13,2
LIBXbZJeWRCgdMTSANYQGVHPEUFKcDfaO,QBFBVECC.HDGDUBEAKBBHDGAAaEDFLABBBADE.ZGEGJFFFhAAA.RFAG.dBHA.SADChAAAAABC..NIAF.hAFAPHAG..cDBH.IHHHhAGA.....hAGA...,1,-15,-33,18
HaTbCeDBROELQfANYJSKXdgUcMZIPGVFW,JCBHKEECdCBD.UFBHZDDEGGAB.FBFBHAGD.aADACADCDHFGBFGDhAAA..RDGH.EEHB..hABAQAAHAIEGSBEGhACA..XAGBMIAAIHHC.hAAA......hACA...,2,-34,-25,9
aJMZNTbgXFDAGEfWIVHUBcdOKePQYRSLC,GGDBEGGH..IABFVBGDBFAB.OCCBeCFGQEEDhAAA.REAASAHFhADACABHJBAFMEIFZEDCbGACXCCAhAEADAEBAAGD.fEHE.WADAhAFA.....hAAA...,2,-34,-1,33
SACcDaZGOFVYdNPeKHUgEBLbJIfMWQRTX,DAHDaCBCZAFDFCAA..dECCeHBGHEEA..EGFHBBEELAAG.JEAAhABAMABA..REFGXADDhACAACIBCGHBOBFD..hAAANDECKFAF..bGAGIHHG..WHEGhAFA.SBBEhAGA..,2,-33,-16,17
BJXIFScKNDeLZOaYdPHGAEQUMfTRWVbgC,ECBFMADBRECE...VGFACDGABBGG..JCFDFGGC..KBHBDCEDeEBGhAAALGAEZAEG.OACAhAAAdBBCGGAF.AIAA.hABAfHBB..WCADXABChAGA..SEGAhACANIEHaFGA..,2,-38,-14,24
dDIaMOTbgFVUEcNeXRfYGCJSHWQPBZALK,dCBBDDEHMBCDOFEH....TAGFFGFAVAGDUAEA..EFCDeEGHhAAA..RFADGDEDhAAACBDCJDAB.HADDQGDBhABABABGZDACADDFKDFH.IHHF..hACA......hADA...,1,-5,-26,21
ZCLKJbAQGRTNPXVdMWcOIDgEeaBUfSHFY,GBBGRDEB..PAABdHBFMDAD.OEFEDDCEEHGEBHHD.UBFFhAAASBDAFGEACBAB.hABAKHEGAEEF.QGBChABA.TDAENAIA.XAGDcACF.gEGBhACA.aFAHhADA...,1,-24,-27,3
WUfQRPcTFGMSDVBCIbAOJeXLKaZHgdNEY,JFFCeDCDLBEGKFEEHAFG.dDHEEDEF.UEAHRADD..TFABGAAChAAASAAFDBIFBHEDCHAFhACAIGHF.AAFGaGEEhACANDDC...fDEFcGEA.MICEhADAOADA..XBBGhAIA.,2,-21,-14,7
efRSGMZgVdLJKCIcBQAODWUbFHEYTNaPX,DDCHUEFAFHBAEADC....TFEBaCAFeGAARADE.GCCHZCGDdCAEKAFAhAAA..CHHFBDEHABAAOFCAhABA...bBFE.hAAA.YFAD.XABBfHDFhACASDDFMFIF..hAFA...,2,-39,-7,32
DFXAJaRGHTLdOcCVeWZQbfNBMIUYKEPgS,JFBAaCFGHEDDLBHFdAAH..OCCHCGHF.eDAHZDEFQCBHhAAA..fGHChABABBAFMDAHIFGChADAKGAHEHFG.PHAEDBCAACIF.RADC..cDGA.hABAWAHB....hAEA...,2,-28,-12,16
WVfbBOTcXCFgGQHaUeKASLRENJIZdDMYP,RBBCEDDA..JCHHdAFB.DFCFMEDA....PHDAVFGBBABEhAAAOBAF...TEFHhAAACGDHGEABHBFAaGAHKABChAEAAAEG.SCCCLFFF.IHHF.hADA......hAGA...,2,-29,-17,12
IYbTEcCNZGgFPKSAMQXVdOefaUJWLBRHD,XACGOAFF..aEBCJGEELEFC.RFGBHBCADCGC..IDDEhAAAbFDH.EHAGCBAGZFAAhAAAFDGAKDADAHBEMAIBdAGFeHFAhABAfGFGBFDH....cEADhADA......hAEA...,2,-30,0,30
FHfBcPNEXZMUKGbdYQSORWVLeJgDTACIa,CGDEFFDCBHCD....NCAEZCGBKHGGdFAE..SDBBRAGHLFEHhAAAeBFCDABH..ADAC.IDDChAAAHCDG.fGGAhABAEACC.MDIH.GABFYDHBhACAOFAD..WCCDhAFA...,2,-41,-16,25
LDJEIFUGZTYcaRfXdMSBQAHKPegNOWCbV,HEGDKABBeDCDOHAE.CBABLDAAEAEBFGHHZEFA..TBGH.hAAAaFEDRBFHfGABhABA.MADDBDFFAAFA.hAHANFABVACGIHEHYGAE....hAAA......hABA...,1,-17,-19,2
UGIZYNJgDbTXdKWeCBAOcfHaPESMRLFVQ,OHBAHABHaDEC.EEGAMBBG.RECG.FCGEUCGHZEBC..JHACDGGC..hAAATAFB.KGHFCCAAAGFDhABA...fEAEhACAPFFBLAAFQCCH.IAHBhADA.YHEGhAEA...,2,-35,-7,28
EDOWLSRGAdbJfFaMUVNCgYHTBQPceKIXZ,JAEGaCCE..UGDBCEEE.HABEBEAH..QAGDeECF.KEFCXBCGhAAAEGGB.DGFCOFBFhAAALHFCSDAFhABAADIFdDGG.fGAG.MEIBgGCHhABA...hADA...,2,-41,-16,25
ARYeELHNfVPIMDZTBUdCWcbQaKOSGXgFJ,RDACEBGBLFDCHGFC..VDBHMAFEZACGUBBFCEHC....bAABQGEGhAAA.KCFAhABASGECXFBDFEHBhACAAFIDNIBD.IHHGDDAFdEED.aBGAOGAC.hADA......hAEA...,2,-16,-2,14
YQXVWSaTBfPKJOMGIRDNLeFUZHgAECbcd,EBCFCACAdDFF..QAFC..VCACaGFCBEAGKAEC.OHAChAAAMFIHGEBBDFDHNIEHLDEChABAUGED.HEFAhACAADIB.bEBFXAGA.SHAEhAAAfADB.....hABA...,1,3,-35,38
YIDKLRTXFaefAMdOWbHQUCcZGNPgJSBEV,OGCCHDFCCGHCZACBGABE....NDEG.gAGHBHCE.EFFBhAAAICFDDFCGLADBhABARAADFFAE.aEGF.AICAdFAGhAFAbAFA......cGFC.SECBhAAA.KHAA.hAGA...,2,-18,-16,2
JbHABfGeIcSEFWKNOZXVRUQdLCMYagPTD,BFBEGAAEeFEHSAHHFAGC.KHGCOFDBZDCERADB.dBCGLHAGhAAAMEEE.aFFG.TAFAhACADIAAJHFGHFAA.ADAHIHEGhADAEBAH..WEAD...VBDGhAAA.CCHC....hAFA...,2,-25,1,26
CFSXPDUfZKbdNQBTYWMHGJLeVOIcARgaE,RFFFECAACAFD.FFCH....SBBDDAGGUGFAZDCAKCHH..dEDGBABHhAAA..TEADMEIFJBEGhABAeCGD.OADFhAAAAEGD.aACB..PFADfAGD.NIAH.hABAWFDH....hADA...,1,-19,-42,23
eITANREBJbKLZWMYaGPQDdFOXVCSHfcgU,RAGBBHEHKFFHZFCBMGAA.GACDDECE..FBBAVEGB..CHFD.SAHBhAAAHCAA...hAAAfFECUAECIHHDhABAADADEDEFJCCD.bCAB......hABA......hACA...,2,-39,-22,17
bTYBXEUeKGOcfNdDMFQaISPRgALJWCZVH,LDBHCHFHHFCD.TEDBBBDAUCAD.eBFHOHFE.fAHEhAAADFAHQEFAhAAASFAD.gBEChABAAHIBWCHBZFABVDGHXABGEBCC..KGDDhACA......hADA...,1,-17,-21,4
UaHDKgbcTSNGIJAVYZMCLWdPFOXERfBeQ,ZBDEMAEACDEELFFGdECEFABG...EEBDBGFHUAACaHBE..DGAFKBDEhAAA....gGDEhADATBGG.SBGHhAEAIEGH.AICC.WCDG...OEHDhAIA..fAEHhAHA.,2,-40,-37,3
OHTXAFZLfQcENJPKURVgDCadGBMeISbYW,FDBEZECDQBDDEGGG..JEAFKABFRABE.DGIBdCGDMBIH.eDABhAAASFDH..hAAAYGEAODFHXBAGhABAACGD.fFCAcAFANCCGPFFGhACA.....hADA...,2,-38,-16,22
BegCQTJHANcMKaWRISFLEVfUXGDbYOZPd,MEEBKCDARABF.FFACLEAF..EBBGUGGGDABEOCFHdGCEBBGEeECBhAAA..CGEGQEEBhAAAJCHHABHG..aADEhAEASEBAXGFE....YHAAhAGAPCHD.....hABA...,1,-20,-36,16
faTEAdKVDLFYXIBZNRbgGQMJceOHUCWPS,VDCDFHEA..XCEAZGCERCGD.GDAE.MCBGeACAHAGDCBHESGBFhAAAaGFAABAH.DBFHhABAIEEEBCAH.NEIG.hAAAQGGCOADAWDDD.....hACA......hADA...,2,-29,-4,25
QUFSaCPXGWNcfgJDALOMdYZbEHeBTIKRV,OABEdHEHZBAFEAFBBDGD.KEAEQFFD.FCDCCHBCGDEEhAAA..NAAH.fECAhABADGDHAEEEMFCAHAFGTCGGhAGAIHGD........hACA......hAEA...,2,-37,-22,15
DZSgPaKVUTBWbICNAFGReOYcHEMdfQXLJ,FHBAeFFAOCEBHCECdCAD.QABHJCCFZFBC.SEAFhAAA.PHACKHGAUAGAhAAABECCIABBCHHCAEFFYFBGhABAMDAB..LFFGDHEGaAHF...WBDChADA.....hADA...,2,-31,-7,24
VCJYIHWQGeKEfAFBNcbMTDRPaUOSXLgdZ,BBDB..NDBGMCFADGFEaAFH..UFEBOAGFLDCH.dAFFhAAACCAB..JCCFHABCGGADhAAAEDHDAFHD.FCEHTEAGhABA..SBAGXDGG..gEDHhACA.YFHBhADAIHHG,2,-45,-17,28
BIWdcJYXOeNRQFZALbCgSfEPUKGHTMaDV,CGBASCFD.EBHHKFFA.HAEG.TCBFaHBCBGHEdEDHJABGhAAAOEDC.eFBGQGDHhABAFBBGAIEALCAAhAAAfGHAUAEHDFACIEHF..WAHHhAFAYGDG..hABA...,2,-24,-22,2
aSBRHfGOFLYZIVWMUbENdATJCgXcQPKeD,TGGDCHAE..XDAEQFEG.KCAFeCGFDDGBBFCGRBDBHFGFhAAAGABHFABDLADEhABAZBGFIHAFMIDCEGCAhAHAAAGAJCCH...........hAIA......hBAA...,2,-20,-16,4
RPDLEJSBGfVMbIgFceOCTUHdNaYAXZQKW,QDECKBACREDALHFAEHCEBBDCGBEBMCEE....IAEHhAAAFHFAeFBECCCDUGAHhABAdFGDNABE.AACA.ZAFA.DGAFSFGHhAGA.fDHG.bDBGhAHAcCCC...hAIA...,1,-17,-23,6
IeKTAGgOCfFaYRcQWXVENUMZBLPSDdJHb,GBAGOCFDFCHHaAEERDDA..QBDA..VBGDUAAAZFFBhAAABDBGLHAGSAGEhADADCCGHFACIGGHhAEAKFHBAFFDCABEfFAB.cFCE.hADAWHFG....hAFA...,1,-3,-36,33
VKSXDOeRMFBZfIPCQHJWGAbEgTUaLYcNd,EFDDTFBDLDCA....NCEHKAACSBBADBCF.OCHDhAAAMIAABDDFIAFFhABACBDCQFFEHEADWGFChACAAAEEUFDCaCGB.dDAEeHAA.FHFEfAGBhADA....hAIA...,1,-2,-29,27
KegRNAICJEcXBLFUMZaPVGSdDQbHfWOTY,JEBDXCDALHFAUDADZCCH....aBBAVAFEdGBB..QEGAhAAAHDGFOAAEKHDGeAHDhABARFDCAAAA.EEEBBAEChADAMAGD.SGGDDICC...WACEhAIA......hBAA...,2,-19,-16,3
USQLEVIJGKcHFDMXAfCbdgBOPeZaTWYNR,CFEBdGFFBGFHeABBZABA..aFBG...TDGB..WCDGRADDSHCChAAALDAHEGCFhAAAIDAFGCGCKAFHFAFFhACADAIDAAHB...fEEC.OFAHhACA.NIDD....hADA...,2,-39,-9,30
GgASaMUWKVPeTEdHNJZIcLDFQBfYCbXRO,aAFEUEFH.KBFGeGDC.dDDFJGAAZCFB.LBAHFEAE.BFHFCABH.hAAARFAB.GCCHAADH..hABAMAIF..PADGhAHAEHEAIFCG.DCCAQGEFhAIA......hBAA...,1,-17,-40,23
MeYSgXaNTcLPdUJZRIQDKAHVbfEFGCBWO,HCADVEFA.EACHGBEHCFEABFHF..MHBGeDFESCDD.hAAAaABHNHADLFAAhABA.dECBUEADRGFEDIAAAADFfCAEhAAA.WHDAYAEG.hACA.gFDEhAEA...,1,-10,-24,14
WYAJMSfPLQTCZHBRKVUXFENgebGIOcadD,JDBASGGDLAACCEBA.BGDB..RBEBKAHFUCGEFCBB..EFGB.hAAA.eGAE.IADDhABAOFBDaAFB.dEAAhAEADFIHAHFF.MFFB.fEDC..hACA......hAFA...,1,-38,-39,1
eaMfcXLEZIBYAgFbPHVCSGRWNOQdTUJKD,FGBBHFGFCECF.SFCGGBAB.RCDA.OAECTBBBUGGD.DFFEMEFBhAAA.XAGBhABAEDFCBAAEAECCPEAF.hACANIBHQAEHKFDBaDAH...fCHAhACA....hADA...,2,-33,-2,31
VAYDKHUCZdFeMJbNcPEQXaWBOgLfSRGTI,DDCCUFFCCHBG.FCBH..MEBC..JAFC....NBAG.ECFFQGDDhAAAaAAC.BBFHhABALFBB.fDDGhABASFGE.TCGGACCEKDHB.ZECEeADBhACAPBCGWEADgGGEhACAIHDG,1,-41,-43,2
XIANaJgSPdbGYOHEWeMDZKVQCTLfFBRcU,aADCJCEC....SBAAdDFEGCCEHEAHEGCBeEABDGEG.KGHBCADGLHFGhAAABCBCRAGH.XEDChABAIEHGAAGC..hAAA..PDHDYFEFMIAC.ZCAE..hACA......hAEA...,1,-14,-20,6
XeDYSRKOacEQfTNWGMCbBJULZAgFHdPVI,FDGFHBECdHBHVEGB..eCEHDGAARABGKCAE..aEEDEBFG..TDABhAAAGFAF.CDCHBFHHhAAAJDDDLHDEADAB.IAHDhABASGGDOADAfAHE.hBAAWBBE...MFFFhABA..,2,-26,-12,14
IRLbUfaZTAgJBXcDKCWSEHFdPQGYeOVNM,JFEEBGGG.DDDFKEAE..SCECHBDGdBHEQDDGGEBAeAEAhAAAOFAE.MHCGhAAARABBLDHF.bFEBhABAfBBGaDAB.AIFA......hADA......hAEA...,2,-27,-23,4
PWIQMfedcbLKRANZFXDgEGJUHYTVSaBOC,ZADCFBAADGGEGEDDHEAB..TGABaDCGBCFACABF....IGDBhAAAfFECdCDELCBDhAEAKEFEAHCE.gGGChAFAEAEGJAHH..YHFC.SECAhAAAWAGBMAIBcACFhABA..,1,-23,-24,1
JdQYgIcfUEZaGAMFXVROSHTbBWCeKPNDL,FBAAVADGRDDEHBGF.BGCECGDHKEEH..DIEAdCBE..QGGEhAAA..IGHDhAAAfGADZAGFAABFMADBhABASDDCTAEGeEAGNDAC....YHFAhACA.gDGGhADA,1,-28,-34,6
fUaXNADWFdEYgMIbOGeZQLBRPHTcSCKVJ,FCBHdFBBEBBEMEFH..OHEAGAFAZCGHBDHBRCEF.HEGF.SFDDhAAACDDCJADA.UACChABAaCAF.XFADDICC.hAAA...gGAAeDDB....hABA......hACA...,1,-11,-30,19
KCcQXUGYWfLASBgIdMbVPZaEHRNeTDFJO,SGEABCCEdFGDMABC..VCEFZEDBHFADeABDDBIDFCHB.KAECCCFD.hAAA..QDAChAAAGAEH.fGBFhACAAHHGIDBHbFGF.PAGFaGED.RACB..NIAD..hAFA......hAHA...,1,6,-27,33
FLSITXeOCGNKJaMBAbDgEWcfHPRZdQYVU,DFEHEHDG.....fBEHRDGHQDDFUDFCFGGHLABFhAAASBGG.TBAEhAAAeBHBCADDKFAGJGACBBEDAHGH.hAEAWADCPDCF..dHAFIHHB.hABA......hACA...,2,-26,-19,7
KceAWfdgJVYROXMIFLEBHTbGUQNSDaCPZ,dBEFJCAF.RFCE..OCBEMGFELGBGHEFD.GDEBQGAChAAADAFG.CCFDKABHAABC..fDCAhAAAgDAGXBCEhADAEAHBBHHBbAFENIDBSDHB.hAEA.aHFA....hBAA...,1,-3,-28,25
SVMaXPCWJGBOKYgbFHcUdIDLeREfAZNQT,QBBHVABF.aECBXGCB.CEDE.JAGBBCEFKGGB...hAAA.gEEHhABAFGGCHCFEdEAHIAEGDAADLFFChABAEGAHAFDC.TGADMIDGPDABOADAYHEAhAHA..hAIA...,1,-16,-18,2
XMLUHRZJWDedINFacbPEOKBfQCAgTVGYS,VBFHSBAD.LEGBUBBDREGDZEAAJDBB..DEFDdHBF.FEEDaCGEhAAA.....PBBChABAKAGEBBEC.CAAFADEDhACAgGBH.TAEG.XDDFhACAMCIH.WEAD.hADA..NIEH,2,-33,-33,0
BAUNMYWEXRTJLGDPQaOFZHgbCdfVIeKcS,UDBHMGBC.EFEERBCELCADGDGG..QBBBaAGEZDDE.HGDAhAAACHAFdGGDVAFA.KFCDBABDhAAAAIHE...NIED.YEAFhABAXEFEDEECOHCGbADF....hACA......hADA...,1,9,-23,32
ZbMKRJAdLPTEHQBXOYIUVWGecNaSFDgfC,dFFFLFGFEFCFHBGDBFDEOCBBUAAGGAEFeDDC...aDADFAEDhAAADDCECGEDMIBA.KACEhABAADGF.QGGBhAGAIHEF...cBBFgFAA.fCHChADA.bDCA.hAHA...,1,-6,-29,23
TBCbdcEaRMDeKNGYWZSPUgOVJQHfFALXI,LGFATCGC.BFAFdDDFEADDaDFF..MACDDICCeGBE.KGFFNAIA.hAAAGAAEZFCF.UGGChAAAOBGFQAFGhACAFGAEXDCEIHACCBDB.bEEC....YBAFhABASDCD.hADA...,2,-29,8,37
aeBASUYZCWMLOcTHQNfdDRFPJKGEIgbXV,UADACBAGLCDGOHFCHFBH..QDFGdBHGDEHD.RDDHJBBHEEEB.hAAA...IEABhABAbGBG.XADEhACAaAGABAAFAHHDSCCD..WCADMEGFhADANCIAfGGBhACAKGAD...,2,-30,-10,20
HGDdCEFaQRMAIKWPBVSNUfJcTYbeOZXgL,KCDDBDHG.SCCGUBFA..JBAFTAFD..eHCAXECAhAAAHECCDGGCdCACCBDHFGAAhAAAaGGHMBBG.AAIF.WHAChABA...PFHF...NIBBfFABhACAYHFG..hADA...,2,-37,-34,3
GbfcFPDSMdOCeNUWJYKZATgLQEIVHBXaR,TEGFQFEF.EFBAVDCDBGHA.RAFEGACA..cCBGhAAADBAEMCIBCCAF.eCADhAAANAGC.JHAGKHDG.AIGEIHBEhABAaCEE.fFFE.FAEHSHGGhABAOFAB.WEEEhACA..,2,-31,-6,25
ATRCHGVEMdKeIPFgbJcfYSXBZLONUQWDa,TAGBCCEEHACAGBAA.EFGDdGHG.IEGDFEDG..JGBEfBEAhAAASBGFZEBFhABALHFAODEDNIAHWAHHhAAAABDCMCAC.KEAF.eGDG....hACA......hADA...,2,-16,-15,1
UQESGHfZMabeLJPTgARBFIWKCXNcVDOYd,BCGAFBDDKAGECDCB.....XFGFVGEADFFCdBBG..UAAESHEGhAAAHEAH.MDFChABAaBDELFDF.hACA.PEEDADAC.WDAGNBIG.OFAEEAGF.hADAfAFG.hAEA...,2,-31,-29,2
BHVOLTNXQJAWSePcKaIdMbYRFGCgDEZUf,SDEDeDFDKGAHdHEHMABA..RBCACAABDAGC.EDGHZDAC.BAFAVBBHhAAALDHH..hACANIDFQEBBhAFAAAID.PFHDIGCAFGDCUBGFfACHhAFA......hAHA...,1,-4,-37,33
WCNEPOLgcQfDeXZFYSGIATaHKBMbJVdUR,HAAEBDGAMCBBJCFBUGACRECG....CHFD.EHECOAEGLEBG.hAAAQAEFDGBBeCDCZFGHhABASCCBADAH.hACAaEHHbBBBdAHC..NAIE.......hADA......hBAA...,1,-12,-28,16
OWTYZgUDbEFCKJHASfPLaQNRVGXcBIMed,SFECLEHHQCDERBDAGDABBHCAeDFHdGCH..TBABhAAAZAAHDIBAEGAFKEAEJDFGAFDCaAGGhACA....XGGEhABAMFADOACCgAGBFBGECHFC.fADFhACA...hAEA...,1,-10,-11,1
HNfBCUTIDSMVXKOWaRFZQAgePYGcJEdbL,eFEDGBDBEDECdACDLBAGHGDGBFAG.CEEAUDGHDAGDSFGEhAAA.VFBFXAADhAAAKEACOAHHaGGD.FGGChABAAIBAgDAD..cADA.hADA......hAFA...,1,-9,-22,13
FeOHgAKVBLNZfdcDUEQXCYIRGTabJMSPW,BEAHZEGDdDAEDGDFUDEE..QDEDCACG.RACHGBGCaGBD.hAAAMIEGSAGAhABA.FAEGOAAFHCCFAGEGhADAKGAD.NAEFEFHFIHDD.....hAAA......hACA...,2,-27,-26,1
NZBfOTWHFDgGIdLAEVJeCcUbSRPKaXYMQ,JCCGCEDBUAGD..SABFRGEA.KEFEXEGB..MIAChAAAZABGBCCDOHDGHFBFhAAADGIDGDAALDAHhABAAGCGEAHFeAEH..PACEaFDE....hAFA......hAGA...,2,-35,-16,19
UKQBJfdINRAgaXPHSTELGeFCMcDbWVOZY,aGGCHCFA.SGFHLFCEeCEAMACHDEDH..bBBGOAADhAAAZDDAKABEBHBGdAGHIAEHhAAAREGDAFBCXAFG.EDDEhADAFHDECEAF...WDHD.....YHAEhAHA...hAEA...,1,-5,-20,15
ACDfSTYZGaOPXQcWVIKHBNUbFMRgeJdLE,CGFGDAGH..SDFHZBBBaFCA...XCCFQFGB.VBDBhAAAIDAH.BACGhAAANHBB.UAFFMFADeDHBhABAJBADdDGHAICCfGGB.TEBEhADA.YGAA.hABAOFDFWHFA,1,-15,-22,7
RAQYSUeHKdPFNTLGDXfVbMcWZOJBaCIgE,SFDCeCCCKBABdGAFFDHFLFFHGAAGDIBG..XCFAhAAA..fCDHhAAAMIACZDAAOFEHJBFABHFGhACAIHHGEEBFAIHAYGECPAFE..NABH.bGAGhADA.aEEA.CADH...hAFA...,2,-21,-8,13
dFbQYMWOZcJSUKeICNGEaPAVLDRfXHBgT,VFBCRABGHEFH.BCEBdAGDFDCCQEAB.MFEFZBADJEHF.KADHhAAAIDHF.CHAFEHGAhAAAaEFFAACE..DGDH.hABAfBAG.TAGEbBFCOHDChAFA.SFFDhAHAeCCB...,2,-30,-3,27
WEJKVOLSDGPUQTaHNdbXRceBgYZMFIAfC,CBHDEDFHKEABLHAA.GBADUEDCQABBaGGBHAFA.dEHGRFAABEAGhAAAZFFF.MCHDFHDGAHABhAAAJDDF.SABEhAEADCAB.NEIE...XBDH...hAFAeCFG....hACA...,2,-36,10,46
HAZfeaEGITbLSFVOMWUdCPBJRcDKQNgYX,ZEFAaEGDGFAF..bAEHFBCC..VEBDMBIB.dAFBBADARCAGDDEChAAAQBAB.hABANHEB.XFEF.hAAAAHHHfHDBIBHHSEED.hACAODAB.CDHB..hADA...,1,-19,-25,6
NbVLWeFKIcPQCGRgOHDATZBSUXYMadEJf,TFDGSEDD.UAAHMBHD.dFAHJDHH....fCDDhAAAbAEC.LBBBhABAeDBHKFFGIHAAhACAQGAFCDFHRGFCgADEDEEGACIFBHHHYHCGhABANCIC.WAFE..hADA...,1,-1,-28,27
ROeXZWAHaQfEcFdPVLgDNTKbBMIUSCGJY,HAACaFGH.QBFCEDCCFDGG.dECDLAAEDFGCKHBABEAAMBBDUAFAhAEASAECCEEC.JHDAhAAA.RFEE.XFBAhAIA.ACCBPEHDNDAB.IHBBOBHD.WFFDhBCA.....hABA...,2,-17,-11,6
RPWVSHGIcCdFEgaYQZJeODNBKbALTUfXM,LHEGUGFDMAFERFBD....VDEGSDGDGADD.CHBGFACFEFHB.hAAA.aCBCQBEChAAA.eCCBOCAHhABANEACBDHHAEDFfBBB..WBABIHAGhACAcGBF...hADA..YEED,1,-18,-19,1
XCUcIVYLFWEGRfKOdAeSHZbBQPaMTgDJN,eECFHEADBECBQADFaFFB.MCAADEFA.JBFDCAAE..UAGD..hACAIHDFLDDHFGADhAAAEGHFRDGFKGGDADHAZACGbDDD.hADA....gAGB...hAEA..cEABWHAAfEHChAHA,1,-21,-22,1
PHQETdBMbSZNgWLDIVfCURaKXeAFJYcOG,FCEEJAEF.OFEBHEFHQCAG.dGACBAEF.bFBBNDIELDDBhAAADGGB..IBAGhAAACHHGaHBA.eDAEhABAACGG...GDGGEHEGTABHSAGAhACA....WAFEhABAfGAG.,2,-27,-8,19
bKcVdfCJTWXHAeOFLGNBaRDIPgQZSUEYM,eAAAOBBCFGCELFBAGEACBHFDRCFG.DFFAIDAG.QGFChAAAZBDGSGGEhAAAEHAGMAFEKAHBdDFBfEHAhABACEDFJADE.XDDGAHAF...aHCAhACA......hADA...,2,-22,-17,5
cBYdUeFfMJRAXQKWOSPIZVDaNEbGCTHgL,XBGGQEGDKBBFOEBB..SFBEIABGDAGHEEGFGGADhAAACBDE.gACBhABABHCFdFEAFCCCfEDBhAEA.MIEAAAHB.ZAEDaCEDNDIC...hAHA......hAIA...,1,-12,-36,24
WMPDaTXANSVHIJeGULCKYZFdgfRcBObEQ,VFFDJEBEGGDB.LAGBCGCDKCEC.FBBHdAFB.RCBD.BACC.EEGEhAAAMAAE.DICGaAEBAEGE.hAEA..SGBDhABAHDDBeAHH..........hBAA......hBBA...,2,-30,-30,0
EUXHSBceZbKDCTRIYMNVPJfFGdWaOQLAg,EEAAHFFABHFGZDBDDEDGREEA.MABH..VCDCJAFD.GAGA.dAAFhADAOHBEADBA.UACBhAAASGADeBHBKDGBCADA.hAFA.TFBCIHHBNDIC.PDAB.fGDDhADAFGGFaBBC..hAFA...,1,-4,-20,16
XGDRVHYLeTMWZUJbCKfFBdgNSIEQcaAOP,ODCBXGEDDDGHREAH.HACHLEDF.eADHMFDFZAFEJHFACHHG.KAFChAAABCBB..NCAE.EAAChAAA.aEFCAEEH...GCEHhADA..YFBFWHAG...fBABhABAdGGF.SEHFhACA,2,-32,-9,23
OAbdXQeGCUTWYFaPgfDNVJHREMLZBcKIS,XDDGGFAHUADE..TFDEFAAHaEFG....PACHhAAADDBB.VCGFJAHHEGGELBFChABABHDD.KEBBSDEChABAOHAGAGGDdEAGCHFD.WADB.fHGFhAFA....hAGA...,1,-10,-34,24
DXeKYfIRaVUcSFLJPWTbdEMgQNHCAOGBZ,BBEGXFCFeHDCKHFC....fDABaBFAUABF.SFFChAAALFFE.JGAETCEHhAAAdBCCMAFGQFAGhACACDEGAIGC..ODFADCIB.IBACcCCHWAEChAIA..EBFG.hBAA.NIBB..,1,-18,-24,6
USVQBTLfGKXgdFcJZCDWeEAMaYNRIPHOb,aAFERAECHCAA.UCGDSACBBEDFLHAAKDHDdGFG.FGGAZCBGDIFGeCFHhAAA.AAFC.MEFD.hABA.IGHAOAAAQFAAhAEAGEAH.......hAEA......hAIA...,2,-27,-15,12
DaALObESfeIgKXVJHQRYBNcCMGWFUPZdT,OCBHSBDE.eCCFKHGEJDEEHEFH.QGCABBBB.CEDEMBBFhAAAGFBBUBGHPADAhAAA..ZFAHDEIHABAFEFHHhABA.fHEBIHAA..XEFEhABA.....hACAYHCGNADD,2,-36,-3,33
CdAcILDBNJVQPFGRZfOESXMbWgaKUHeTY,LCCHDDADBGGA.JAHHQCDBGDGARGAE.ZCFD..ECABMBIB.hAAA...bCEBWCBBhAAAaGEHKEAF..eHAGhABA.CABHAFHCIABD..PFEH.hADAfAGF.hAEASEBD.,1,-10,-30,20
PDXLVQaTJbZfUINgFCeAWROHBEYdKGScM,ODEFBHBFECEFKAACGBAC..MBFEXEFAQGGC.hAAATBDBZAGDfGEAhABAUGAF.IECHhACAgGDBFACDAAGHWDAC.HEAAdGCEcGGDhAEADDIF.....hADA...,2,-23,-6,17
FHYGOCdeEUSPWNXDMQfTKILBRbcaJVAZg,FAABGCDFdFAAUGCFSGAE...PADAXDEH.DCFChACAQABH.hADATEFDIAEFBEHEhAAARCBCaFGDABHGZECH.YBAFCAGDEECC.MICEfDGFhAHAKHGA...hABA...,2,-29,-12,17
CATBJNGVegaMYEbdILWKRHFPSZcQXDUfO,TAGCJFDEGDBF..VDBDeABC.MHDGEFFEdAEE.LHFChAAAKHAEHBFESEGEhABAQBCDDBBEfGGDhAAACCADBHDGNDDF..gGADaFAC...hABA......hAFA...,1,-6,-14,8
OWAPeVZTBdKEaHRcJbXgNfSMULCQDFIYG,VCDAZDAGBEGD.EBBHRAGD....JGEAXAGH..NABF.MGDGhAAAUFBCLCDHhABA.DFIHFDBCGGABhACAAIDAeFFEKHEG.aGHH.cADAfBBD.hAFACGAC......hAGA...,2,-33,-18,15
fZbgQFDJAXOWeNKdGTUSYMVaCLBIEHPRc,ODHHeDAEKFAAdCDGGEDFUFAB...MAFECAEDLBBHBAADEGGEHBFDhAAA.REDA.ZGBGQGGFhABADIGGABCB..WAEGhABASHBA.aCABcCFA..hACA......hADA...,1,-9,-31,22
XdeDFZOcRMQVBAEGWNfaJbTUILYPCKHgS,EGCEGGEB...fBCCaEECJAFEUDAELAEF.PHBChAAAKGGBHACD.XGEFhAAAdAHEDGCCODFChABA.RDAHMFFGBDFCWCHD.....hACA......hADA...,2,-31,-11,20
RVOCLDfgIYFUSWGMKHQTNePdZEabABXJc,JDFERDCGOBECLGAC..DIDC..IBCGUDFAGAAG.hAAAKGHBHFFG.NCEGdHCHhABAaGBDBGAG..VAFAhACACGGC.fDAAFAFAMAIFeDAD..hAAA....EEBCAHEE.hACA...,1,-14,-23,9
MRJeZcXWLEVQSPDCHIUOKbNagYdFAfBGT,BAGCTBBARCFGZFEH..XECDLEBBQGFADAFHHABDOEGHhAAAKAECaCEB..dDHAABAF.hABAMBGDeDDFEAHBSAHHhADACDAGIHCENEIG.FAAB....fEAEhAEA...hACA...,1,-12,-15,3
UFCDOeKbWYgVfJdTGXBIRLMcaNAZPEHSQ,ZCAGEDDGHGACUGFCDDGBeFFB.KFCE.....bBFCgABFhAAA..fABBhAAATEDBGAGGBAGCLDABhADAaFACABFF.PEHFSFHBCBBG.hAEAOGBE...hAFA...,2,-22,-10,12
TSZfMcXBEDFWOgPNUQabLRKCYHAGJIedV,GABGJHFE.eFGDdBFA.SGBAMBHBBFGBEEBD..FBDFgADEhAAAUAAG.aHECLEEHhADACAFEHBGFAEEEVEAHhAEAfFHE.cEDHDIACOFCD.hABA......hAHA...,1,-7,-29,22
IAJcRQZGBYKbULgFHXCDETSeNdPWaVOfM,JBHDRBDDQAGEBBEH.KDHFUBAC.LFDAFHGACCAH..EACFeFAHhAAA..dGDAaDDEVEAHhAAA..MFIFAFFG.hABAZGCA.....YAGD.bACBhABAXAEB.SDDDhACA,2,-36,-21,15
TJeZBIfFPXACUQgVSaWcHObMdLRGENDYK,QFCESBCH.aBGFHECC.MBFDRCBGEBAADHFE.KCGDeFECBEAChAAAFHAEACIFUGAH..hABAWDADOADGdHGBLAAChAEANIEF.JBFFIEHH.fABChAHACHEH...hAFA...,1,-9,-19,10
SHfdEaXMQTCIZDeWgYbBALVRKUPGcJONF,VDEHKGBDUAGG.GACBJDHF..FEBAHCEB.dFAFaAED..QGFBhAAACBBGZGCA.eCCBhABA..gAGBhAAABHDHADHH.LDAFcCACODHDfACDhABA.EHGA.MIAAhAEA.DDCC.,2,-24,-8,16
gHWFKPAaSLfeTQNbCcVEZOGIRXBMDdYUJ,aFBASFDELEEGeCGH..TCBGQEACCAGB.EGGGZABEhAAAOBBFGAEAXGCAhAAABGEBDIDCdAFCYCHHhABAJADH.....WGBGKHAGAABEfHGBhACA.NDAG..hAEA...,1,-9,-18,9
JIPFNQAcgXdVbZORBMGYHeWSfKDELUTaC,XDEFdGCDZAEEBDGGGDAFHDBG..eEGDSFABKGCADCCAUGAChAAACADC...JBFAIHFHhAAAFABBAHFC.gGGBhABAOADGMIDAfABA.LCFFhAFA....hAGA...,1,-14,-31,17
UMCTJQVZYcgDdKLfaBSNRIWbHEeXFPOAG,MCCGJGACZEDF......gDFCKDADLDGDBADFSDBHhAAAIBHEHFAFhAAAEAHF.FBAHABAB.CHFETFDDhABAQBDA..cGGFDCIHfBBAhABAaAFF.WHEA..hACA...,1,-15,-41,26
GacFLKfHBOeCXWgIAVdZJbPQTESDYNRUM,VEEFJFEG..QCADEACF.DIGERCFEMAFAGACB..aFBHLDDGhAAAKGHH.BHDChABACBEA.XBGEIDCBhAAAAFDEbFAGSBAB.NICB.FFHD...hABAfHEFOCAH.hACA...,2,-26,-12,14
bBEIfNWSCRHJaDQLOgPVFcdMXeZTYGKUA,BFEFEBAD...IBFCfECG.SGECCCABHFAHDEECOEABhAAA..PHEGhAAAFBEFdDHCMCHDXDEChABATCCFKGBH.AADFbGFEWAECaBGE....hACAQABF.hAEA...,2,-30,-15,15
PXAOJLWMBDgKHSFEZGVRdTbUCfcQaYIeN,LECEBBHHKDBHFHACEEAFZGFG.GABDdAEGUFEGCDFE....fHABhAAAaEDG.IHDChABAeDGB.PCAChACAAFIDJAAG..DIECSCHB.TEGChAEAcGBA..NGBD..hAAA...,1,-1,-51,50
VSOFbLaAQPEKfeIZNYWXBUCHMRGgJdcTD,EBABeAFEZDEF....NCEE.XEAGBDCCHEAARGAC.GCGGJEHHdBEBhAAATGCDDIEG.SAABhACAODBCFBBAbADGAHHD.hABAQGFD..fGDDhACA......hADA...,2,-24,-1,23
SCJROLeFAUVcTXdIYNKHgPDGfZbMWEQBa,VECEXEDB.dABB..IAFAKBFDHDFFDHBAZAGF..MCAEhAAAEEACBGBHCGFA.OHEChAAALAHBAGHA.TDADhABAgBCA..PCDE.fFGBhACA.WHBAhADA...,2,-42,-18,24
YDJTgQVSacfCNBXMRUZLWGKPFOHedAEIb,EGBD..ICEBDHGA.JEGBTDED.QCBDSHCEhAAAaADECABDBAHBRDGF.ZCADhACAGFCDKAGFFEEFOBFChAAAdDCGAADG.YBAD..cCGG.hABA.fAGBhACAMIFA...,1,-17,-27,10
FDdGgPWTaKAVBfXZHLbCeNOURJQcEIYSM,BGCHXCADZFFDHCCFLEFGeAED.UBGBRGCEQAGF.hAAAIACESDBFhABADDDBdHGHgABAhACA.PFEHaAABAICCbCDFCAHCJFAHcCGD.EFAChAEA......hAFA...,1,-8,-13,5
PMGCLaFKDcSORfZIEUJNVgWbBTYHQXeAd,MBFACADHFCFC.DBBG..OEEGZFFFUFAG..JCAB..VCGD.hAAA...gFAHhABABDCGHBDFeHCGAABAPFCEhAAAaHGCKCCB.SFGCIDAHNIAFTAGDhACA.....hADA...,2,-30,-28,2
cXaVQLZeNfAOKCBJGdDYSUTIbWEPHRgFM,ODEFCHCAGABFDBIFUGGA....TGCA..IEFChAAAbABG.EECHHCAGFBHHMAGBhABAaGHBQEAGhAAAZEADeCCAAIAABAFA.dCGGWEED....hACA......hAEA...,1,-14,-21,7
CSacQAOVKgfIFGMeEbYHZJTXWRUDPdNLB,VBCHKFEH....fDGBFAGBMICG.eADFEFBC.HECDZFFH.XGABhAAARCADDHDG.dHCHBEGBhAAACBEHaABHAEEH..OBHFhABAIGGB.YAHHWAFD..NEAG.SDAEhACA..hADA...,1,-20,-22,2
cgEeROCPINfKAGWTFUMZJabVBXDHdSQYL,GGCBFHFEUGBEZCBC.JEFA..aEGCBDADHADGdBGH..SABDhAAALFBFEECEOEFHhACACHHF.IDDEKABHAGGA.hAAAMBHD...XEAGDDGE...hABA......hADA...,2,-30,-19,11
KgFaMIefRGTdbESNYOAZcJXDBVUHLPWCQ,ZBFFJAAHBHHBHFDELFHD.CBHCKECCaDEG..MGCEeFADGAGAhABAdBCHECAD..SCDChACA.NIBD.AFFADIDChAAA..UFAE.PADC.gEFDhADA.fHFBhAGA,2,-33,-23,10
UIJSGPdTQELbfgOcVDNWBCYKRaAeHZMFX,HAGBMFDEFHCEXGAA.UABDSBEAdGFDEECG.LEABhAAA.bBAG..gAEHhAAAODDEDBIFNIDFCCCDRFGBADDEhABAeCADZAGD...IEGG...hACA......hADA...,1,-7,-16,9
UaPAGRFDeLVWgNQfTYXEdZcHJbKOIBCSM,RFABeCFGLDFH..gDAFQAAD.TDBBXEEEhAAAdAEFZFCDHECFKHEEBBHHhABACHHFMAHBaCEHAGAD.DGBBNAIA.hAAAfHFB.cACDJBDH.OEHBhACA..SDAFhACA.,2,-9,-4,5
NPIJFdbUBQTCWSYGZaHDOEXLRcgKMfeAV,VGEG..ICACFDEA.UBFCBDHGCHGA.SAGCZCDHHFAHDBBGhAAAOFBBEFHDLFCBhABARABHKHCA.MEAGACEGJEBChAAAdCHE...QGEF..YFFChABA.aDAB.hACA...,2,-28,-11,17
QVJYELCPZWeaBDcFXSbUfdGTANHROMgKI,RGDAOAACMEEC.KHEC..QBGF.JCABLFCH.hAAACHGHPFAFZCCBeFAHDAIHhAAAFGGA.SABChAEAUCABfDDD.TBEEAFFG.gEGFhACA...hAFA...,1,-25,-27,2
ZIfNULVOWSMCPBKGJReYabXQDcHFTEdgA,ZACC..fAHGUGFCOEADSAAD.CBBBBEGDKDFFJAFAhAAAeBFF.aHDGQDCDhABADDAFHFAEEDCEAHEFLCHHhADAMEIH.........hABA......hACA...,2,-35,-23,12
LBCHSPfdWFcODGYEXeVRMUbgKZNTQaIJA,LABDBCBCSEBHdEGAFBHDDGBBGDFE.EAGHeEBB.MFABhAAAbEDHZACB..QADAhADAaGACAAAH.CFDAHGDChAGAfBEAODCCYCAF...hAHA......hAIA...,2,-17,-14,3
edGgWHVTbFNPQMLcOAKREJUaICYSDXBfZ,EBDEJEHB.UFFD..CCCEDGBGBAAB.ZFAAGCEAHABF....TDFChADAFAHFQDBChAAA.MBBGcBFAhAEAADHCKGADIHBA.SGHHeAFBdCAC.hABA.WHEGNAIE..ODDFhAFA.,1,-23,-25,2
aMCOGeRFJdTfAWBZYXSVQgIDKLbcNEUPH,ZBAFXAGASCDG..VBEFQDGDDEIHKDAF.LAEEhAAA.bFCBEFGDHFGHhABAMCCHOEEDRAAHdGADTGEBhAAAACIHBCGCIGBD..cDDHhACANDAE.....aDHBhADACACH...,1,8,-21,29
JWPEDVFBGNeZHbSKRaAOfdgLTIcYUCQMX,ODAHdCBBLEAH..TCDCIFDDUFFHCHHE.MCAA.JHCChAAAECFH.DECABAHHeDHHhAAAZDBHHADHKDFBABGBfGEAhABA.cAGCYABG.XGAHhABAWFFB....hACA...,2,-29,-15,14
LRYPKVdBWeHbXgCAUGOcNQIMfJDFaSZET,GECGOEBD.QGFFMBHD.DCCHaBAEEFAALFHBRACB.KGEChAAABEHEHBEBXEEAhAAAAGAB.NAEB.IEAEhABAJBEASCAFYADE.dCDG....hACA......hAHA...,1,-9,-20,11
cIdZWBDPfOaTAHQXNGbeEJCgLSYKRUFVM,QACCXGGGGAAFEGEH..CGBCLAFFSEDFREGHFCHFMEADhAAAdEAFZCFHBHBHDICEOFEDhABAaAAD.AADENBIEJEDB.hAFAKAGG....cCDFWCBA...PFBBhAGA....hAHA...,1,-13,-17,4
FYBePGCSEcWfbNZKdQVDTOXgIUARJaLMH,aDDEMBFDHFFABHGBeAFGGDBE..SABDEDDB.fACBhAAAbBBEKAGA.QCGEhAEADEGBOAAGIHAFhAHAAFAFJHCG.FGEHCDGE.WFCD.ZCBG...hAEA......hAFA...,1,5,-29,34
RVUfXYcPCAWaBGNTFDJeHQMSgEbdZLOKI,BBBBTEECJBDA..QEAD.MFDDSFAH.hAAAEHDCZBDDKEFCIEHAhABAUDAD.fGGAhACA.cBBGAIBCaGGHNAIADAIFeEDF...hADA...gBGDhAEAdAAG,2,-46,-22,24
POBgNWZYQGERVJSKeMCLfUHdTAFcXDbaI,FBGAXAFBDBEF...aABCOEEA.BCBFNHCH.ZGCEGDGGhAAAREAF.SEBDhACAKACE.CFDCUEEETGGHAHIFbBCAhADA..IAACPAHF.....hAEAWDCB...YAFFhAGA,2,-42,-18,24
EdBQPNXRHTGYCcOfVAJUSgbIFeMaKLDZW,UGBCSHBA..IBBCFDCFMCBCLHFADFGBZEAHdEEEBAEChAAA.QDAAhABA.XEGDTCFDCADBhAAAOAHHAAFGJEHD.gCEAaAHFEABE.NADC..hBAA......hBBA...,1,-20,-25,5
GEUXYLeHFMTgBWVfIRdcKSQbJAaPOCZND,OGDECFACDFHB.UDBBLAEAHCFF..MBAEBACD...VEDDhAAAfGAE.IAEBhAAAdCGDSBADhABA.bCCGAIFEaCAB.NCICXBGBFGAD.hADAWCCCKGFH....hABA...,2,-30,-28,2
IaVdHAXGRYbPefDJFKcMUESLBTQgNCWOZ,XGBEGFDHRBAB......bAEEPFFFDDHHKCEBMDCE.ECGFhAAABFAB.TDCHhAAANEAACFECZACC..IHHChABAdBGBABBBeEHHFGCH.cECG...SDABhABA...hACA...,1,-7,-26,19
GUICZOYbVMefLAgTQNEPKBJDWHaFdRXSc,QEEGEFBCBHDGDGDAaCCA..dBEERBGD..SCAFGEEFCAAAZBCFhAAAOFBH..VCAHhACAfHFBLAHBACFHNBABhAAAJHEAFAFG..XGACcGDC....hADA......hAEA...,1,-13,-17,4
WXMRKfTIHbeEJGaUVCNLASZBFgPQYcOdD,BGBGFCBGQAFEODAADFAB..MFDDREEA.KFAE..TACChAAAIHBFHCFG.EFCGaFHHhAAACGGD.AEGHZADF.PEEDhABAdABGXAEH.eHBA....hAEA......hAGA...,1,-19,-24,5
UQICaFLdXOMNJTgcSWVEfPbBDYeARGHZK,HAFEUBEACHFALEDB.XEADMEAE.TAACSAAGhABAEFFH....fHGBhAAABACEYGCChAEAeCHDADFFZBGBKACCaFFAdCCDNEIE...JHAA..WFADhAFA.....hAFA...,1,-2,-30,28
SKIZDMTdEXfcFHWePaObRJgCUGAVBNLQY,BHAFLDAHQGDDKHFCDAAB.dDBG.EEFEXGDF.FDHBeADHhAAA.aAGCOAEAhABAJCEGCHGG.AFEA...NEIA.SCFBhACAMBAF.TDCHfBBHHBBE.hADAWFAA..bFBD.hABA...,2,-29,-17,12
TYIUJXRbEDOBdFLCcWZafVHQPeGgAKNMS,MFCHSFFB..IGGGUFBGXBCHEDGFBFAA.LBDBhAAACDGEZBAB..fGEChAAAQGDHPAFGhABAeABDAIHG.KDADNCIG.JAHHDACAdFDFFHGEaACG..hAFA......hAGA...,1,-15,-18,3
WZEYdPNSAMTUVQHJGLDXBeIKcOCbgafFR,MEECVDDG.HBDCLBBFDFHHBAGDKDGC.CBBD...aAFAFFABZFGBdGDD.hAAA.SADGhABAACHD.UGCHJDAA.eEADhACAOHAEfGFCEACC..NEIG....hAEA......hAIA...,2,-30,-15,15
JQPeIWZKcRUMbVOSFLHXGfBCdaDTNYAEg,ECEDQFFH.eBHHIBHHZBCCKGBDUFAD.MFFAOEHFhAAASCACFAGDHDDHXGEEhAAAGBAGBAEDhABACDCADEGC..TAEAAACG.gABE.hAFA..WHAAcGDHhAGA...,2,-18,-9,9
MCcREfbSeOFJBKWagQdGYVINZPADHLUXT,HFEDUEFEMGBGRBBGEHCE....SAFBFBBEKGHH.aAHFQBEFhAAAdHGBGCGG.IADEhAAANIBHADAH.DFBC..hABALAFECCADfCECeEAFJBHF.BDDGhABA......hACA...,1,2,-24,26
bcKNZXPMdEHWSQUVTADYfJBIFaGgOCLeR,DHBCJCDEBEHDFDDHGCEF..OBFACAHCLFGDRFAA..KEACZDBFhAAA.MCAHEHGCHFFAhAAAQABBUBABAHDF..hABAIHEDaDEE...eEAH...hACA......hADA...,1,-18,-30,12
YWeJVBLOPNEgKGTXaAScHZMUdCDRQbfFI,HCDGUDACDEDCRAACQCGG.FGFDIGCGeFAFBAEELDFBhAAAODCHEAHBKHBGGACBhABAXFGBAHHC.SEEDhAAAMIFACCCB..fGAE..hACA......hADA...,1,-5,-35,30
FQZEePYIgWURAabLNBDXdSTHcCVGOMfKJ,LFFCBDBBDFBGdEDEHEAG.VAAEMIEGKDGE..FAEEQAEAhAAAZBAG..EFGCPHAEhADA..IABAhAAAUGEHaAHFXGCGSDEGCHHBGAGA.hAEAODDA.eEADhADA...,1,3,-25,28
fGBROIDLYTPFAVNQZaWHdUEMbeXcgKJSC,VCBBZCFDHCBC.dFCAMEEGeAFE..XGBEKADBSFHDhAAA.CBABBACCIAHChAAADBFDLEEFPAFFACACNCIAhABA..aGBHEADA.cGFH...fFFDhACA.ODAHhADA.,2,-29,-16,13
AFfeKVLNCDgBRdESMIYbJUPZXHTacOWQG,FAAGKFAGLDACDFGFBBGE.dFED..EGCHSABH.MAIDhAAAIFHD.JDFAPEHFhABAZEAG.HAFHaDAG.hADAOBEH.WFCHAEBAfEEAeHEECHAH.hADAgBCD.hAEA...,2,-42,-17,25
LgacPfWOQFVAbHDSGMUZXeCKTJIREBYNd,DAIHMCEHUACCZFDA..eCGFCDFB..KHDCTEAG..RFFABBBChAAAdAGBaHBG...fACFhAAAQFAAFCCHAFECHAEGhABASBAB.JFHFIHHGNIDF.hABALDDF..hAFA...,2,-39,-4,35
PeTAdUVMBKHgWCaQSfZIObRDcXNFGJYLE,UAAGMCEHHABCCHEH.SHBGZDED.OCFCDDCG..XFBHhADAFEHFJBAFLFFHhAAA.ECCBTGGHhAEAACHGBAGHKAFBaFABIFAEbFCC...NAHA..hABA......hACAYEBC.,2,-41,5,46
JDXCAHENKYPVTBcFaefbRSUWOMGdgIZLQ,HAEBKDDF.VEEBTEFCFDBF...aDACeCHBRGAC.UGBHMICCdHGHZBFEhAAALBAGDAGG.ADEDEAGChAAANBAFBEHB...hABA..fHGF.SGDEhABAOEHH.IFAEhACA...,1,-4,-28,24
KHRUQLMCFYWZXbNEOBJfgGPTeDaIVASdc,dFDCHBAAUGAHLAEAFFHB.ZDDE.XGFEEAADBAEHJCHD.GFCHhAAAeDEC.DDDG.IGAGhABASAFH.RCAAMEGHhABACHCG.......WFFD.hACA......hADA...,2,-31,-14,17
fSJXGaNFDLQMECOYgAZTUdBcKWPeVbRIH,TBGHBFAFKAEC..eDAHRECEHDGB..fEGDXAAAGBEFhAAAaBAGDIBALECChAAA.QADHhABAMIBEECDDCDACOGBGAHHF.UGGEWHAC...hACA......hADA...,1,-9,-21,12
GbKFPTegcRZXUNIOECWYDBaLfJAMdQHSV,MAACHEECSCBBGFCBKDCF.FHDE.eECCRBCAUAGBOBEA.CHCCDADFhAAAaBBBLDHDhAEA.ADFBdHAFQCGAhABA...PEAH.cFGENIEBIFADhAFAECAB..BHAHhACA...,2,-15,-14,1
AXQLDfJVOgYGWcFdIRZTPaKCEHUMeSBbN,QFGALDDGDCGEJEDDODBH.GEGEFDBBdCHCZGBG..TGAFhAAAaBCG.KADDECDEMCGDhABABAAF.AAFD.fAEBhACA..YFFFWFFD.IAHChACACBBE....hADA...,1,-22,-32,10
dfXCZIWMGaePADbVKOYFHTLQSNgUcJEBR,DEDBVEFGOEBB.HGCCTGDDLCBGQABB.SBGFhAAANCGGUAFH.ECDEBAAHhAAAdFBECHHEIHHHhACA.MBIFeEBEAHGDKEEBFAEG...gACAhADA....hAGA...,2,-18,-9,9
gQfMCGEcdWDVXUFYbLRaHKNTPJeAZOIBS,ZCFBBDHFQEAHCBDEGCCA.dCECDICEUBBC.FFGELGBA.hAAAaGFAHFDD.KHAANADB.hAAAJAEE.ADIF.OBEDhABAIHHGSCAC.MFIF.EAHF.hABAWCFH....hACA...,1,-17,-33,16
gUFMbEVDKaBPNGTYIRXJfeOSCcLdAZHQW,HGFCQFAEUCBHMFCAECAE..DAFHBHBEGDBF..IAABhACARGEEfDGGeBFHCAEAhADALAHBAHDHZCGBFAGAVABChAAA..aGEBNEIGXGCB..SEADhAEA..hBCA...,2,-20,4,24
FcJNWAGQgOMHfbSKXaTCEZDLYIdPBeRVU,GDFGQBAEMFIBHAFE.SEGGaCAGCGCHZBDELHBGhAAAdHDHeDEHUEBDJAHB.AHAGfGGGhAAAKEBHEFED.ICHFhABABGAFFABAcADC....WAEChBAA.....hACA...,1,-10,-13,3
YMUEdCaALcNVgJTHGBRDePOfKSZbIXFWQ,LCBHVDDA.JEFDHDGFBGCF..eABAOEHFSBHBhAAA.bEBDFDEB.QADChAAAMCABEGDGCHAGADHF.NIED.hABATAGBDBEA.PFAHKCCC...IHGAhABA...XGDDhACA,2,-26,-12,14
OAVQUJSPKYgbaMTREGCNcdXZLDfWIFBHe,QACAUBDB.SBHDKGDD..gCACaAAFREBHCAFGdGDDhACALFFE.DACGhAAAfGHGFGBBBEBBHAGDhABAADEBPEFEMEFEEGAD.NICF.cGGH.hAGA..WFAF.IEDHhAFA,2,-23,-20,3
NREgSfKdWCYGFVDAJIeOaTHPMBbQcZLXU,JEEEOCFHHBDHBEAD..QEAGLADAXGCGUBAEEGGA.hAAASCAGdHCBCAFCFCGCAAHEhABAIGGE.TAABhAAAMIFE.ZAGD.RCCHKEGG..WFDG.hACA......hAEA...,1,-14,-19,5
edIHPVNWBCDZSTfFAOMRgYJGaUKbELcQX,MHEGREDC..JGBCUAFAKEAA.LECD.QABAdCEDHACHVFGHhAAABFGCDDDG.TADFhAAAACADOAHD..hABA..YDFGaHDEEGADeAEENIADCEEG.fBBGhACA..FBAHhABA...,2,-23,-12,11
BVXHMbdUGCScWfIDYFEQAKJOgeaRNZTLP,JAHFeACF.RCFFZAEELCDGBFDD.HAAC.dFBHCEAA.SFEBhAAA..cEEHIHGGhABADIFCFHCAAADGKEGHaAHDNIAB.hAFA....PFHDMFIB...bAAFWGAGhAGAEDCH....gGADhAEA,2,-27,-17,10
DYMBZLJNSQVFeIbRHAKPXCgfaEdcTUOWG,KDCBCDHC..aHGCEFDC.dHDHUEACGBDH.DEEEMAFCBGHGZDEBLDADhAAA..JBCCSBCChABAFFHDeHCA..hACAIAAH........hACA......hADA...,1,-34,-39,5
WACXILEHPegFfNUGJaYBMKZOTQcRDdbSV,CEHELDGFHBEE.eBBGFBBGUEAD.GGEFaCAHBGCE.KGAFZGAEhAAAOHFETDDGREACDDDEhAAASFFCAHFC..hABAEEEFfCAE.NIBF.MBDG.dHCDhABA......hACA...,1,-7,-22,15
XWGAfILSNZOcCUKaReMETHBPYbgQdVDJF,LFFDSBGDZAAEOFEECEDC..KAEFaBCGMFCDHEAE.BBHEhAAA..bBGBdDCBDDIHFHFAhABAGCACACABIEHHhACA.UGADEGDHTGGB...YCCAhAAA....hABA...,2,-25,-14,11
EANTMRUZfgWJHDLQPSXVecCYaKdBGOIbF,TCEAREAHUADGZCDG....fEACJAHB.DEHB.PABChAAASHGC.eEEFhAAAYHCCKFGCBCBDhABAIHHF.EECFMCAFgEEGLHAAhACAXBGECBBBaDGE.OBABhABA.,2,-29,-19,10
VXFTfGKWeBIYCDOUcbJQEPZMSadANHgRL,HCDHLFEGXGDCFDBAGAEEKGGHBEAGCHHA.DCBDOEAB.UAABhABAbDFE...EHAAPAHHhAAAMHDG.dADHAADA..hABARBGH.fDCG.IGAG.hAGA......hAHA...,1,-13,-20,7
cXLaeHIEFRYAQKNDBgCbGfdVSMPJUOWZT,QCADKDAADAGDBCHACDEB..GCGGdFEE.MICAUAAAZEBE...hADAXAFFaDCAHFADFACBhAAAAAHF...NHBFfFFGhABASHGEOFDB...TADAhAFA.eCFDIBEChAEA..,1,-7,-37,30
JGBXPQcINKHVRadCDbSYWeUOETfgAMZFL,FECBJFFBBABFQADE....IEBBKCBAVGCA.aBHDDAEFhAAA...SBGChADAeEFDOAAGEEHFTGAHhAFAAGAFZAFD.GCBH.XFCE.hAIAcDFB...hBAA...,1,-25,-29,4
CGbKgXAFTdYWaLeEHPZOcIfRNBMVDUSQJ,TEAGdFDHaGCH..LAAEEDEFHCCHZADBOCHF..IAGChAIAfHCBBFHGDCEGQBBGhBFACAAHKHGEABHC.FHEChBIAeACARCFB...MDGHSDHB.hAAA......hACA...,2,-18,-12,6
RSYWLEgIfUJTPNHdaDOcGQVXBZCebMAFK,KDBGSAFDLEFGEABE....IABHfDHEUFCFJAHHhAAA..TBDHHEAEaEDDhADADAHHOADAQCDDhAEABHDDeHFEAIBGFDFAWGFE..NAACdGHCcGAChAGA.XBBGhAIA...,2,-21,-11,10
cIVHJOEAegQNTaKCLbXWBUPMfYSRGZdDF,eCCBQEFC.aBGEKCGD.CEHELEED..bACABCEHhAAAMBABSCAFhABAZGACDIGEIDCEHGAEEFFDNAAH.hAGAXAGE.WBBEfFHC.hACARECC.dFAB.FHGE..hADA...,2,-16,-9,7
fQgUFKNYDTJBHaSOPbMEXGdRWLeZcAVIC,CDDHQDDHUGAC.FGFFKAABDCIBBAEB..SAFG.hAAAODAFPDHDMCCEhAAAEDAC.dDGALFDEhACAeHAAAABF..IACB..fGEGhADA.NCED....hAEA...,2,-41,-30,11
GUfCNYSTRLeZKIWgVaEbJPDOcBMdAHFQX,.FDHBQBFAGCBFUAEBCDEE..SGFFLFFBKBAA..hAAAgDABaDAC.hABAEBCHPHBGOFAHBFCChACAAHIHfHCH.YAAEeFHFIAHEhADAWAECbEEEDGDGMBIDhAIA..,1,-8,-23,15
LbYUJOTdVNgAFESWCZHIXGDBKfPceRMaQ,SFCEZBBFHEFDXCFCDFADBHDF.KBFC..fFAChAAA.eBABaBACbBDHJAEGdEHAhABA..VFGDACHAWHBGhACAIDAC.PBHDMEEHLADFhAIA..YAAChAEA..,2,-29,-5,24
LBNefVXWbJKdMEDZIYCFUQSOHGTPcgaAR,RACEBACFeCEC..XGFAJDGH..MHBEZCFACGAF..FCCBSCCFhAAAOCAF.TECDhABA...PHBAhAEAcGGC.AAGHNCIAfAFG..bFAChAAAKEGA.dBDAIFEEhABAUEEC..,1,-25,-27,2
JKETIPVBLHOFZdgcNbDXfGCMUeYWAQRSa,QBAFaGHD.EGEFPAAABHCHLAGFOFCD.dDCG..hAAANCFG.XEGAGAGGMEBGhAEAeEABAADASFAEhAFAKEEFIGGHFGAHcGEEDBIHfBEChABACCDCWADA......hACA...,2,-19,-10,9
IHQDCVgTaUbJMSeYXfPFKLEAcOZRdBWNG,ZCDBdDCCBEFAGCGEQGBACCBE..TEAHUAAE..MAHBhADASFFF.eAAAhAAAYGDGXGCBhABAFADDEFAFAHHGRAEG..IHAADAFDaDEB..fHGFhAGA...hAEA...,2,-22,-22,0
BUAODYGdRcZbeVCTQPagWHFXNKfIJSMLE,OAFGGDBEdAGCZDAF.eABHCDCG...TGDHQGGF.aDFChAAAgDEFHDDBFHBEKACHhABAIHHE.SADChAAAEBHFAFHEDCAAcAEH..bDGH.hACAWBAF.NBIGfBEAhABA,2,-25,-8,17
MSNYECAabfJDIXVeGQPTHULBZFOWdKRcg,aCCAJEFE..DGBE..IHEC.eDFFQDBAHEAABCAEhAAAFAAEdAHGRAGHMIAG.SABAhABAEDEHAADF.fDDGhACAXAEBPGDCTGGELGAGhAEA.OAEFcGGAhAAAgEGCNIDH,1,14,-48,62
OdgNfTWKHSbPIMEDGcCZYVFQAJeBULRXa,BGEFLGDCaAFE.dDEG.....NCAF.fACDKAFDHAGBSFHHhAAAIDCAEFACDDAHhABACGHH.ZDBD.FGAHQEFFhAAAAIDGeABA.UCGD.RBACOFCFWDFA.hACAMIFE....hABA...,2,-25,-7,18
GIFOZVLeDCbWPNXKREJcaQMdYSUfBATgH,HCBBGDDAFADHOFGBZFFFeEHDCBCC.....bBFANAAC..RCGBEDCHhABAaGEFdHAB...SABFhAAAfBEFAAGB.hAEAgGAFIHDCDDDAXGCDKFAA.cAGFhACA.MFIBBDGFhAFA...,1,-8,-9,1
dgTZWDEKPCcNHeRFVJUQYXOBbALfIMSaG,LAHBMDABGDCETAFEDFFC..KCEHCGFCHDCFFCHB.UABD.QCEDhAAAXACGBHHGhAAAAFIHSAEFaGAEdGEEZBAFhABAEHGE..NCAA..eHCG.....hADA......hAEA...,1,2,-24,26
DaZPBcHJOKQYVUMGWfSFALgEIRXCedTbN,EADERCFFeBDFdFGF....TGDFDAIBaABEBCBEHEAHKFCD..QGGGhAAAVAGH.MFFDhABAfACGFDHDACCD.LDDAhAAAgFCFCCEBbFADZAEB.....hABA......hAFA...,2,-22,-1,21
JAHXFIEQUcCdYTDWVSGLbeRfKBPaNOgZM,FCDDEFAFUBDECAHG..dHDDDFED..SCFDLFFFeBHHKBCE.hAAABHBFaGAE.OABFhAAAMABCHFFEQGGBhABA..cBFF..WADE.bFCHfBBEhAFA..hAGA...,2,-39,-18,21
dgDTQUaAOGFEVLSBNJZIMXRfKCHbePWYc,GDCEVEAH.BBAEZCAE.MGFERDGH..CABBHFDGeBDG....PHAEhAAA..cDEBhAAADDAAQEAEhABAACEB.FHFASAHBIAHDKAECYHBGhADAdEGH......hAEA...,1,-8,-32,24
fNHLgYOEQAWXebRCPVGDdBcMTZJaSKIFU,eCAARGAECEED..GBEHBAGBTFCCZACB..SGFFKEFCUBEGHFABhAAALEHBOFFEhABAQEBE.AABDXCABhAAA..PHDCdAFFcDFHhACAaEAGfABF.hAIA..NAIG,2,-28,-14,14
HYCaGTJMFKNcdPWXReBLgObIQfUDSVZAE,EAEAHAEG.CGFGGECBJFCG.KABBdHBB..XBDCBBGELAAFhACAOBAH.ICDChADAUGGADGDHSCFGhAEAAIEG.aFGCTFADFHFCNBCA.WAHH...eDEGhAAA.....hAHA...,2,-31,-6,25
NdaIVefSDQLJAFcZXBWUPOHMYCTGRgEKb,FEDAZAGDBHFEUDGHHBBCCFDC.GEAERBBA.KHDAdCFC...aGAHeAEGhAAA.DCFCJFBFAABH..hAAA..XGGEhACAOEBGMFIH.....gEGFhABA.EAEEbFDG..hADA...,1,-22,-31,9
DSEfKZUCNcIeWPgMbFdOaJAGXHBVQRYTL,HDDCQGBHRBFALCCFDAHD.EDHBKFFHCFGH...IDGGeGBC.hAAA.PBADMDDDFBAFhAAAOFABAIGGBEBA.TAEHhABAfAEBZCDFNEIC.cGFC..WEAFhACA.....hABA...,1,-14,-19,5
FPADCHKXYEdNTbaGgUBcSROWQZfJIVLMe,CECHKFHB.EGAEdADC...TFFDGBDGBAGERGDAQBBBZGBA.hAAAJCFALEEE.hAAAMDIHeFAEAFAFHBFAhABAYBAFbABD.....aEGG....hABA......hACA...,2,-19,-19,0
FaUPfVOQIbXHATJYReDENGLMgKSdcWBZC,TFGHRCDFeEBD..DDBEGDEALAGDMABGKGEDSHEG.hAAAdBDABGFECCCCFCGEUADHhABAVFBDIBBHHAFAAAHA.hAAAJDHBNBBA....WFADaAHD.....hACA......hAEA...,1,8,-30,38
JBFTNZMCUSbPHgDcAIKEYOQRGdfWXVaLe,EHBGOECEGEEEdBCG...XBDGLBHBBCBGFCAHZFGDMFAESHCAhAAAHAGDDCGFADEBKFAHhABAQAAHRCEE.hACAfEHEaAFGeGCC.......hADA......hAEA...,1,-9,-15,6
SdYGOaQKDZgEMfPVJbCHBLRcAIXWFUNeT,XDBFUABHeDGFdGBCGGAF..QDGADCADZCED.MEDDhAAA.VADECECBBHHBLBAFhABAAIDAFEAD.SFGDhACAOBDDKHFGEAGG.fFEC..hADA......hAIA...,1,-14,-31,17
OIbQgVJDTFEfcCMaPYBASNHGKURXWeZdL,HFCGGDCDRDCAeBEALAGDOAADQFAC.VBADDFHBEDHDhAAACFFBMFDBaDAHBBHA.hAAAABEESGFHhACANHEB.KHAGWAEB....ICCChADAJABC......hAEA...,2,-17,-7,10
bLHCAGTUOaKPfRFDSEcJVYdIZNBeMWXQg,TADCUDBEOFEB..aCHHKBGARFEBFGBEDIFC...EDCE.JAABVAAGhAAA..dGACZADHBDAAhAAAeHACXGGDhACA.QCEEgDGH.bFAGCAFEAIDEfFHChAFA.SDEAhAGA,2,-20,-18,2
PKcEYQILCTFJZGMbUWSXRgaeNDVfAHOdB,HECHOEBDBCCEKAGC.EFGB..QFEGCFHBFAABZAGB.MACF.UBEBhAAASEBDRDGD.hABAeFFDNBDGDIDCACBFdAEB.hADA...YEADICEA....hACA......hADA...,2,-29,-18,11
BFfaWdLgRGHDTAYcOKJQUeZVSPNEbMXCI,OCCFQCEBZAFC.SEAGEABF.MDAACEBFBEFF.FHFGfBGDhAAAdCFDLHAEhAAAgGFGHEDFAEIHKADHhABAUEGA.eBAG.NHAHIACBaDAB.WFBAhABADGGG.....hADA...,2,-17,-3,14
MFQcELOJASVbKaUdGDfXNeZTgCWYHPIRB,SFCDVBDB.KCBFdEGGGEDDDBBH..XGBHeAAATADFhAAACBFB.HBGHRGDAMADChAAAQGGGLAHDAEIDaDDGhABA.fGAANCAA..WCBH.hAFAIHHEcGDA.EABEhBAA...,1,8,-29,37
AEeXKZgFRdQIcTLHWPabfSCMNVDOYGUJB,XADBKDDGZBFHFFAHdCAF...QGBD..IFFEhAAATBGHHDFHaHCASDBFhABACAAHMHFADEEDOABEhACAUDBDBAFHAIGE.EEHFeFHD.gECGhAEA....hAFA...,1,-4,-36,32
NVIWFMOcBAaJLZbPfSDCKTEUXQGReYdHg,LEDHZEFC..bEBHPAEB.DBIHKFDH.UBGBQFAFhAAAeHEAdACAHFFG.gBABhABANBAC.IDFAhACAFBEHMCBHBHAGAGAGfAABCHCG.hADA...EHEA..hAFA...,1,-14,-21,7
CZdgcPOeHQDYJRBSaEbfWXGTANLUMIFVK,UEACMCEGFAFECFFC.ZBADdAFH......PFHHeHECDEFGRFEFBCCChAAAECDC.....hAAAbFAGfCBHhABA..XDFFACHFNBIG.IEDFKGCBcABGhAEAOACA...hAGA...,2,-43,-21,22
UfXTWPOYRNQbaVeLSgHDBFCIdZGcJMEAK,UGEGTGBFOCHD..RBEDQBGB.aHGCVBDESEAChAAADACCBGAAIBCChABAGDBFMABHKEGCfEDChACAXAGB.WDAENAAC.eFFF..hADA..gGBHhAFACHAG.dGHA,2,-17,-15,2
aNVXGHCURdAZJbWKQcfODMLeFTEPSgBYI,ZDAHJAAF.KAEF..QBEAODCCLHAGFGGG..EGCESGGFhAAABAEC.aBHDXEDFhABAGAFAUABBhACAADDA..WCHFfEHEMIDAeDBFPFDGhAFAIAHH.NDAACFFF.hAHA...,1,-16,-24,8
gQBSVPJOAYefTULHXbMRFdEcKIZCaWNDG,eDEDTFEAUACA.HFBBXDCARBFA.EBBCKFHHZFAACHDA...aGHFhAAADGABQBDDhABABAACSGFHJCAFADIDLCHFhACAMBBB.FHAGIEGB...WDDDhAFA.....hADA...,2,-25,-6,19
ICAOfLYVbTHeBEgcMURKQGNPdJSFDWXaZ,LAGHVABB.TECFBHGBEGDC..MBBGKAFBGDEBdCDDFEGHDGBFhAAAaECC.ZEEF.AEHGOCAFhABAfFAB..hAAA.bADDgGCA.cAEF.hABA......hADA...,1,-11,-29,18
ZOLFEDMBICWRfQXcKYNGgbTSeVdHUAaJP,aBAAJFBBZEDHLFDD.DDEGMBBF.BEADCFHFRDAE...QFGDhAAAKAFDGGEF.TBGDhAAASDDE.dAGBhABAAEGBFHAEEADF..IDGDXACB..NICB.hACA......hADA...,1,-20,-33,13
KDJUcSMXZNWdOVbHLIfACaFPYQEBTgReG,CEBBaFBHFEGH..QEFHBBBC.RABDKEDCJCDA.UBEB..SFEFhAAAMFDBZAGFdHEF.hABAOAAHVAFA..LFAFhACAADBB.ECCD.eFHHDFAB...NICB.hADA......hAEA...,2,-35,-15,20
ZPcFKGLNSTDUVYBXdWeMJEfCgQRbIHaAO,OAHFZAAGFDEAKFFFLFCB..SEAETCBBDEDEUGCFBGBBhAAAdBGFMBAF.EFFDCGADRBCAhAAAHBFF.AEBHPEHHhABAGDGG...NIEF......YBBChACA.eFAD.hABA...,1,3,-31,34
ADCfTKNaIeELYZcXSWgBVORFUdHMGPJbQ,DBHHCDBBKGFF..aDBC..EDFHLHFEZFCB.SBACBCCBRAEHdAGEhAAAMGCEGEAC..hABAJADDAHHG.TDFAeABA.hACAXFAF.WAHBgEGC.hAAA...FEHD..hABA...,2,-31,-21,10
HEJKLPRXVTDQSGMaZYUFdegCfNIbWAOBc,OCBGBFHDEEDHKFGDRBFG.....XFBHDIFGSDAEMEAHZBEFhAAAFGAFdHFD..CDDF.fDADhABA.IEHBhACAAAEHcAACJDDBLEGDTBGGaGDDYAFChABA..eABAhAFAgGDF.,1,-1,-34,33
XVDQeSgMCdIFWGNYOEfABTRKZHLPJUabc,BDBATGCHKDDG.ZGBEHDDBLAHDJAGBUGGC..aBAG..bBBDhAAA..VFFCeADHSCGDhAAAMBIHCFBCIBAEhABA..FBDGWFADYFAD..hABAEHEAAIHGcCABDFGE.hACA...,2,-25,-10,15
EgMYQSAKBcVNFOXHGWdIUTCPDZJfeLaRb,KGGAVDCEFAEE..OABCHBAFdACA.UEEGCHFDDBGEZECH..eAFDhAAARCGB..EHBEMBAB.hAAAQFFFAAHCBEAG.hABANEIAGGAH.TEAE...fDGHhABA.aCCGhADA...,2,-27,-19,8
EHAUPSObKIdLYBVGfcZCTJNgRaXFWMDQe,UBDDSDHDKDHDLEFFBBEEGCAB.ZGFCCGCA...NGAB.aDAFhAAAFDFDDEAD..EHACAEDA.hABAOAHDdCGF...hACAfABC..cGGE..hADA......hAEA...,2,-48,-23,25
EBSXbUIFZGOVKdgWLCTNceRDJafAYQMHP,MCBGEECHBGGG..SDAHUDGEFBDCZBAFGFAB.OHEGhAAAdAHELDDBCAED..hAAATEFEeHBGDCADaDEGABBGhABA.....YBHD...hABA......hACA...,1,-23,-33,10
PZFXOcRWHGDaIedLKMTYQSbJgAVNCfEUB,VEBECHAFUCAH..BGHFZEEG.FGFF..OHDARACCHCDAGAFC.hAAADABBaAGE.dCADMIBAhAAATGAB..SFAGhACA.gGGHAFABEEGAcGCEIDDGhADA.KCHH..hAEA...,1,-14,-34,20
IaVfLUPMTYZECDRObFWSgBNXQAdGKHeJc,KDCBJBFB...aAAFLEADUAEA.MBACZEDDDGHHRFGB..FEDF..hAAASAHBBHEEXADFhABAQDGD.hACAAGGFGDACeCCFIHCCPACB.EDGCCHFGOHBChADA....hBAA...,2,-24,-23,1
MWHEVBRKGISeAXYLfdNFgDPaJcbZOTUCQ,XBBALCEBdGBAFECA.DHFA...aEGDJCAHZAAEUGEB.MFCHhAAAEAHHBEBF.KAEASAFEhABAAGDB.NDIA.hACAPCDH.OHDCCHHDQBGB.hAAA.WEAD...hADA...,2,-33,-28,5
GIFBQUONCKPJMaEZWDdbeVSTHfAYLRcXg,LBFDRCCC.XGAAIEGD.QGAEUDCDCCCE.KBFEJAAChADAMBBAZAGH..dEHAbFCBhAAAeHFA..SHGEhABAfEAGAAFGYCAD..cGDEhAEAFCHFBFFD..hACA...,1,-17,-26,9
CNPXcWUAHReJYaDdLFEgQbZMBIGVfTSOK,REFGeFEF..JCFEaEEAdDBDFCAG..QACFMDDFBHAGGFCDhAAA..TAFHOHAGhABACABB.PAFCXDAEhAAA.UGGCAIGGDIDGEFAD.......hADA......hAFA...,2,-23,-21,2
EPHKIfWRFTCZYeaADLQGMSNObXcgVdBUJ,QBBEMBEB.SAGENGBH.ODFCXEFB.VBBDhAAAUECC.EAACPHFEhABAHAEBIHBAhAAA.fFHEWAHBFCFGCEAGeDAFDADGLHBGhACAcGFABHDDKFHB..hADA...,2,-14,-11,3
BNYMIEVSZfDARKLQdXPTgcJGHUWFCaebO,REEAQBADdBDH..TBAEJFBGGCEFHEBDUGGDCBHB.eHCAhAAABFHH.MBDAEAGBSDHBhABAfEEBAHHAKDDAhACALHCAPFAB.cEAG...aAAAhADA.NAEB.....hBAA...,1,1,-24,25
cJeGBQXUfbECKTWRDHdFOgVALPNIZYSMa,LDDD..IEDGZGFAMAIBaBEBeEEGGGAHBDACQCAGhAAAXGCGUABEhAAAfAGBCAFD.TGGChABADCFEdGAAODGHAAHF.NCFE.SDBHhAEA..cBBF.hAGA...,2,-21,-14,7
ENBVHgdMPRSWfJbKXIUZYTeOaAcCLGDQF,CDBFLDABDHDC.QEDGFBBGBCEA.VACAHFEC..dCFFMFIBhAAASAAH.fAHEhAAAJDCBKAFG.XGGFhACAIFAH.......YHAAhABAODFC.AADGEDGDhACANIAF...,2,-48,-8,40
AeaLfWUXHNOJGDRIZFPSCEKgYQbBTdVcM,eCGDLGFGUCCEXCBGHEAA..JAAGDIAGZFCGFBHB..CADHKGGAhAAAQEAB.TEFDhAAA.dADGMIDGhAFAfGCGNBICOAGFIEDFSGADEABD.hACA......hAFA...,1,-16,-25,9
JaAQGdNPSeIWXYCZcELOBUDHVbFTgfMKR,GECHdACCSAAHeBGB..IBBD..YCHFhAAAZFAFEGGHBDAADIGGHFEBFAHFfADHhAAARFCHAAHCQFABhAEAPCDCCBDEOBFD......hAFA......hAGA...,1,-12,-16,4
WFDNSMHCcXKZUBRePVdQAJgfOLaYGIEbT,JDCFOECBLGFEGEEA.EBBH..TAFGDAFGMDCAHFAFCAAE.KBEDhAAAZBGHBCAD.eEFChABAdHGDAAIB.aACFIHDFhACA.FBBCNEBEcAEC.....hADA......hAEA...,2,-21,-15,6
GDcfRSgWCHQTFYBdEXNbaVIUZAeJMKPLO,eFGHKFECLEDFGAEDDFIFRCAC...SCFACBHEHAEFFABCdDCFEHEAhAAA..NABC..aEACIGBDhADAAFED.MEAFhAEAcACB..fHGFWDFA.QEGChAGABHADXFCHhAAA...,2,-30,-11,19
NbVWZKTYaOgMeCRAXcLdfDBJFIUQPEGSH,XBEGdADCDBCBBEHGFFEE...QGAGEFACGGBFHFCG.VCEChAAAKBBGaCGE.OABAhAAAMABDeAFACGHCAEIB.fEBFhACAIAFFSDDANIDF..hAHAWGFA....hAFA...,1,-17,-21,4
JGCTMOKdNXbaDVISYfEQHBWRgZUPFcLAe,JDBECDFA..OBHFKBFD.dFAF..XDGGDFGF..SCBGhAAAEABHBEEFRFFCZADCFAHFACCGeFCHhABAGGAD.MIDChAAAaDEB....IHHHYFAE.fADEhABAWAEE..PHDEhACA.,1,-21,-42,21
TVCOdZYXJUPGeWSAIfBcLbMEgQKDaNRFH,BGFFLFBBMFCCEAHHKGAGDGID..RBCHHAFHCDDFZAAB....JGDCUAAHhABAGACHSCEHhADAAIDC...fHFHhAEAcDFC.gEGEaDHFFFAH...hAAA......hADA...,1,-23,-28,5
PCgeDfVYOXIKTWMRGQcUBAbHSaEJFLNZd,SAEDJEFGLDBAdGAE..CBGA.eACDDDAH.VFEA..XGADhAAATAFC..MIDAhAAAGBABQDBChABABFCHAHHEaBFBEDGE.ZGDGfEDF.IHHAhADAWABE....hAFA...,1,-16,-32,16
EgCLfMVUHFINKTRZaceBbYWSGXADOQJPd,DEFHQAGAdHDH.CEAFLCDEMFAEHBACFFBAKHGGZAAD..aGAABGGDhAAA...bEEBSEGHhAAAAGAE.PAEHhABAgACC..fAHChACAIEHGNIDF.....hADA...,2,-38,-17,21
aCgMKBTEYedbcLAZSIUORFXPHVfQDWNGJ,SEBBOCCBFGEAHCGHQDGA.DCDCNDAC.GFDB.CABDMACEhAAATBDG.EABHdDDFhAGA..LFDFhAAAAIEGIHHB.XGBGfEEBWAEAaFBH.hAIABHHF....hABA...,1,-11,-26,15
bgXDPWCIYdfaQOTVFNGMcARBZUKSEHLeJ,BEGBKDFDHECFLCAFJEHD...XGFGDBGACABH.dGDG.aCGCOCFGhAAAFBEB.GDAAhABAMAAEABHHRADH.ZDCCEHEG..hADA..gGAF....WHAGhAFAfBBD.hAGA...,1,-22,-27,5
PaKIDHMWQFAfELXZVcYegGORUNbSBTJdC,LCEAZDAH.VFCBeGFA.ODEFUCBB.SBHFBACAdGFFCAFFhAAAaABF..DIEAMDGHhAAAFEEC.AEAFEECD.XBCDhADA..gEAANICD...hAEA.bGAC....hAFA...,2,-36,-20,16
fPQdSXbFIDLYeWJRaUNGAVHCOTcKgEZBM,CEHFOEBCKCBB.ZEGBBHGH..MHACQAEAdEAG..bBDADAAChADALFFDeEAFJGEERAAG.hAAA.aDDEGECB.hACAADGA....TGBDEADESHCAhAFAFBGA....WBCBhAEA...,2,-36,-7,29
dXNWbAPgLUESBCRJMZDIHTeFKcVGaOQYf,LGFGSBAGBGAGCBHG.RBBGZAFADBFDHECEFDHF.KFGGGEBD.hAAAOHCEfGEEhABAdDAH.XFAC.hAAANDAFADHH.....PHACEACG.IHHAhACA.eBBEaEEA.hABA..WBFH,2,-24,-13,11
NLTfKDEdYgFIXGeUObZPAScBJQWaCHMRV,SFAEJFEA.QEEBCGHHMABC.RBCDLBBFKBHD.DFHDhAAAdDEHFAGBXFBHhAAA.UBBGOBHD.hAFAZGDEAAGDBEHDaAEF.NIBF......fBEDhAHA..hAIA.EFDB.,1,-14,-42,28
NgFdLOHZafGXcVKISQeUMJEPbWTBCRDAY,...NBCD.dFFGLGECOCCDZBECGCEF..XGADKHEGSFAHhAAAeBBHMEFCECAH.hABA..PAFCTECEhACACACEAIHAFCCB.fEEDIGDH..JAABBHCEhADADFAD...YAFChAEAaGGA,2,-29,-18,11
BDcOSfLWEadXRGNCbPZMTUFAYeHIQKgJV,HCAEKBEC.VGCCBEACDCFFOAHH.LECHEFGBdFAAGAEBhAAA.CEDG.bEGDMIFEFGEGAIEGhAAAeACC.QCGEhABAgFAFSCCEfBAG.aCCA.hACA......hAHA...,1,2,-32,34
GWPRBNgaMdSCJVTIAOHDEXLQYKFbZefUc,DHAAEBFELCAFQCEAKHFEZDBC..UECDGFBB.RABEBHFBhAAANEIA.MCIBdBBECAGETAGHhABAAICE...XEAChADAFFFCfCHA....WEHDhAEAaDEASABEhAAA...,1,-9,-35,26
UMXDOYIKeBCfEWGPJZVHdAcSgTaQNRLFb,SFBATCEA.QBDELBCBUFAADABF.OFFAKDBEBDHBhAAAEAEFGGEBJEEDHBFAhACAAICAaAGAFHAAMFHD.hAAAIEADCBAEfDGF....WADChAHA.....hABA...,1,-16,-18,2
WGdYMHSNReUbIJTVQgKEXaZfCPLFDcBOA,dABEMBHFHFGDRDDH.eDDFUGAC..JAHBQBBBKBEA.aEACfDBHhAAA.CGBFFEFGhADAcCEA.BHFFhAAAAAEC.....WACESGDHIFFEhABA.TGCC..hAGA.EHGC.,1,-26,-31,5
COKPENdScGgFWJLITeHBDZQRbAfMVYaXU,MCCCaCBH.UDBCKACE..EDEGdDGH.GGCBFFAALAGBeACCBAFHhAAADFIBZFGF..REEEAHBFVGCAhAAACCAC..OAHBhABANCCF.SHGA..WBHH..hABA......hAFA...,1,-16,-28,12
PNcRWObBGfKgICQMUYSdZLHDAEeaFTJXV,aDHDJEBG.....VECC..PBEGRCAGOABGBGEE.KDGCCAFDUGGBhAAAdBCCLGAAhAAA.AFIDFCAFXGAChAGA.NCCH.bFFF..fHCFIHHHMIBAhABASBGHDAFC..hAHA...,2,-31,-25,6
ASVNIGdfZXTUKJPFbYCBRQEWegDcLHOaM,SFBGVCGF.GEFCZCCGUGGAKHAEFDCBCBAA.BBCGREAD.EEDAeAEAhAAA..DDIFHGCEhABAaAAD.AADFdEEC..XGDHhAAA.TBEE.....hACAbAGB...YDADhACA.,2,-30,-19,11
MIeKJCWfFaHTPgUcbGdQZVRAXYDSBELON,XFFHDECDEABC.LCBBMAFD..eEEDCAGAFCHBHGBC.TGGBhAAAPBDE..gAGDhABAbAAC.QDFAhAEAZDDEVGAGAIFEBCDFIDAD.KEHHWDBFhAIA..fFDHhABA.,2,-20,-4,16
SgBGaVPYHOJbeLCdfAWXDZcMIEFRQTUKN,DDAEMBDGEBEEFBBH..QCGDKGEE..SHCGBBAFaFGC.hAAAVCFEHFDF.OECHhABAeFAECHGHAAIH.ZEECIAGBhACA...TBCHNABB.PFADhADA.JHFE..dGAEfDEEhAEA,1,-3,-34,31
OcJEXfaQLUWIBKRZAGgPMHSCTNFDdbYVe,GCDGMABEHBBFCFFFFFHHDBEE.dHFB..VDAHODEA..ECGAXFCAhAAA.aHBAUAAAhADABFFEKHEAACFASAGBhAFANHAD.eECCfADA..hAFA......hAGA...,2,-33,-16,17
HbdMXOKDNAZVIePYCFBRJUSTWEcgLGfQa,VCBHeBCHCEAG..BADGUDFB..SFGBEBBHLFCFQGDChAAAHGDCMAACKAFEDIAChABAAIAA.IBHCFAGE.hAEAJBFH..WBEF.gGGBfDHGhACA.aGHD.XEDEhAEA..,1,-15,-23,8
YGMZNfbOAcaWdgFEeBSLVTRJUIPCXKDQH,aGBEdEGCFGAEBHGCLBBB.RECE.IDDG.CFBB.DBIDQBGEhAAAGGDDMAGDZFFC.hABA..fCAChAAAAHEDgCAHEDDESABEVADETDFC..hACA......hADA...,2,-27,-19,8
eJDAWKdOcIPNaXfMSCTbYGUgHEVRBFQZL,dAHEOAEE..PAADaCCH..MEIHSFAACFDE..bFABhAAAUFGG.EGCFBCHAhABAQCDDLFGFDADBhAAAABCGKCABIAFHXGDEfGEAYDDChACA......hADA...,1,-24,-27,3
PDGFLVdbWBaYQIHCUeXKZSONTgRfcAJME,MCAGDDDDLEEAdCHGBGECQGCFHEBBCAGC.UDADKEDC.ZACCOHFEhAAA..TAGDhAAARAEBAFFE.EGABFABC...hABA.WBBGaDABIFHFXGGFSDGEhADA..NIAB..hAEA...,2,-22,-19,3
XMbJROUYNCAZIcKDHTVaBPFGfgdSeLWEQ,ZEFDKCCHDICEHGBG.aACFFFHDGAEF.dDECSFEBLFADQCBGhAAAMABC..hABARAFHUFABCHHBAIFE.IDHChAAA.......cDFChAFABECAfCGHhAEA..WCBF,1,-13,-40,27
PJQZIDSHLdNcAbWFBVMTKOGRXUECYegaf,FBEFVBEEMDEB..ODAHRABF..EGEHeEBE..aGCDfBCChAAAQBGEDFGEHFAFhAAAdHEHAFFFBGHEKHBA.XDFDhABACHHF..YABEJDCDIDAEhADANEEH.cGGC..hAEAWAHB.,1,-1,-37,36
eWSfAVCFIcEBRdKDZNQXUaYPHOMTgbLGJ,CCBEFDED.EACEBFBD.dFHAKAGHDEBGZEAD...QGEFaGAC.hAAAHBBAOFEDMCIH.hABA.TBDAgGCDhAAALDFEeAFDSHGGABAFIHHCNACHXGCDhAHA...hABA...,2,-34,-15,19
dJAWbVSTLKaMDEUYCROZHNfGIQPXgcBFe,VECGTCAE..KDABDACB.UBFBCHEC.ZGBEHABEGEADQGAEhAAA..XGFEhAAAcFGH.BAGF.eDEBhABAADIDSAFFaDGCMIDE.RCEAfAGFhABA.....hADA...,1,-13,-18,5
MZbGQXJLBSUWCIHADNRfOFVEaedPcgKYT,RDGHOGDAFGDH..EFEDdHBD.....PACGKDDEMFCFGDCDhAAAQAAAJAHDLHEAhABABBDHSEAChAAACAFHAGHEDBBH...fGAC.aBFCeCCChAHAcGGH.gAGEhADA,1,-25,-29,4
DZWfaTUgFYSXIOGeEPbLHNdMCJQcVAKBR,RDFFZABH.aBFBTACG.FCADSHDE.OEADGFBDEFGFhAAALAHFdEDB.CAFAQDDFhAAAAGIFBDACfAHEhADAYFHBICGGeFAD....hAEA......hAFA...,1,-8,-34,26
YEZSDFcNUHOGJAMaVWdXLQbBRKIeCTfPg,MCHBVFGF.dBEELBGDBBAD.KBEFeEAH.CHHD.TCBG..hAAAfGFF.hABA.YEABSBBEhAAADHDANIADHGBEJFDEAADFaEEE.WDDD.XAFBhABA....hACA...,2,-31,-22,9
LBQUZRTAfYSbEFMPVgaCdHWXKcGOIDNeJ,SEFHFGFHMEDE...VBGDaEHFCFDDdEAE.HAAEKBHH.GCAFhAAADHAA.eDEHBBDEZGAERBAFAAABhABAfAFH.hACAEECCgEAA.XAEBIGHHhACANIAB..LCDGhADA...,1,11,-33,44
VCBbeTRYWfKaIQZUOJXcSgANDHLGdPFME,HABDLABBdFDEFBGCEDGGBBFBeBEH..RFAB...fEFChAAAKDAGaHGA.QFAGhADAZDGHOADGJADB.SHAAhAFAAFFHDIFGMAAFbEDH.TGGG....hAGA......hAHA...,1,-13,-17,4
KMIBZRcGNETeXCQDAJfHUVgPSdYWaOFbL,JFCDUABG...VDFBSHGA.dBCCaHAEFEEBKBFC.BGHDhAAAZAEFRDAG.GAGCECDF.hAEAeEHHQFDDhAFA.DGAGAGAFgGEC.PAABhABAOHDC.LAHHhAGA...,1,-8,-27,19
KITUCDPOZHacbdASYVJEFLNgQeBWfRXGM,VFBEJCDALEBF..QCDBeHEEBACERAEGMCIFKBBDUGCChAAACBBHDAGC...OCABhAAAZDDCHAFG.aAEGcEFChABAAIAG...YHECEGGG.NIBH..hABA....fDBAhACA,1,-16,-25,9
OcKZUNJMGEDTFVbLIgCdYAXBPWHeSRQaf,XFEFBHFAHDFHRBDB.aGAB..OBHDKGBGUDBHMAAHGADE.hABADDADFFAALAAGhABACHCEACCBeEHDSEHHhACA.QFDEfAGG.cGGH.hAFA......hAGA...,2,-24,-13,11
VZRAHdGLcNBCJDQPUSFeTgOMIXfWKEYba,GFEDLAGFBDFFDDFDUBCFSAEA.FDCCeGFC.OBHFhAAAIACH.XBFAhAAAfDAG.EFBChABAYBAFaHBA.ZFAEAEGB.dHFHNEECCHHF..JHAEhABA......hAEA...,1,-19,-22,3
PWfZaBcKXFOEJbMYNRGDVICTLSgeQdHAU,UAGD..fDBHBDBEKEHDFAEBEGAHMACA.REFCGGCHhAAADDFB.IFCBTGECLDDBhAAAgBDBdBBHhABAAGIHPAGD.aABHODAH...hAGAYHAACEEC.SFCDhACA,2,-34,-12,22
KHSGaQFZbTYAWDgELPRBUXeMNJVfCIcOd,DHECEFCFRADAUEAG..MEAE..JCCACCBE..OFDDdDGAKAAEGBGEhAAA.FFFBZFEA..hADA...bACEAIAA.LHAChAEABHHCeDDG.fABF.hAGAIGAG..hABA...,2,-38,-30,8
IgUHfJVDCRbFZEYKAMPaBSTGXLcNQWeOd,aDGABAAHGACBLEFE.QAFCeEGBOEEFdHDDUDAFHDAGVFABhAAACACB.FCAGZDDFEHCChABAABCBMFBBSAFEhACATGGB...........hADA......hAIA...,1,0,-24,24
TKQCJREHXYNLDfaOUgWbeZVSPIGBcdFMA,KFGDQCAFCHCH.RBFBHEFC..NDBFLEEEDHAAaDDA.UBGHhAAAbABA..ZFBA.SHBAhAAAIAECBECDhABAcAGAMEIH.AACDEGAGXGGC..fDAEhADA.WBBGhAGA..,2,-37,-12,25
SIdYXPCMENDGgLKFbfWVTQOUHBAceRJZa,RDECJBEBZABA...aFBGSDGH.dBAGXGGD.CGCB.hAAAMHBEEAFG.DCBGLCCAhACAbFFC..fEAFhAAAWHCG.QAGBOAHDBDABAFEHIHHEhABANEAAKEHB...hADA...,1,-23,-32,9
aENLBSfAdbXTZWUDeIMQgKPJYcGHRFCOV,XABEZCAHDGFH..eCEHMHBCKGGG..JFAAGABFFCAG.CBHG.aDFGhAAALGAABDDBSGFGhABAAIBCdEGF.TAEDhACA..WAFBQEGA.gAGBhAEAcCCD...hAAA...,1,-16,-38,22
QVaSNFZDPIfbWMBGCXgTUEcAKeJRYLOdH,KCBBeECFRFCGLAEEdGEEHACEQGGF.aEADNEEDFBFH.ZACHhAAAPAHF.IAAEhACAfGFC.MIBChABACHAATCDC.EEHHAHHAYFFCOAFDDCCBhAEA.BDGH...hAIA...,2,-33,13,46
eafRAgODJGNQVYSPXCTFHcMWdBUIKEZbL,OBFEGECBQBFF.SABBPEAECCBCHFGHMDIHdHFBhAAABEEAKGAHZGDCeDAChADAfGAAAHDCDAGE.JADFhAAA.....NIBD.......hABA......hACA...,2,-30,-14,16
BVgGSKbIERZJfQaATPWLNUdDFMOcXHCeY,TCCELAAF.UGGHFFFB.OEBFHGBCCACHBDCEGAAE.SDFChAAAKBEAEEDAZBGHJFAGQGDFhACAAIGG..hADANBIGDAEDMEABeAFAYBBEbEGH....hAEA.fEGEhAFA.aGAD.,1,1,-22,23
cMKXDNZTaOFdRBVYCbHQEPfIAgLGJWUeS,GCBFJEEH.UFFBeAAEMIEADEIB..ZDACaEAF..dCFFBBBCCAHB.hADAHGBE.QAFGhAAAEFAH.PDFEhABAACCGLHEGSAHHKGBANDGA.TADC..hACA......hADAFAFC..,1,-7,-29,22
BZEKGagSMJNIVUcHdbPFXATeDOLRYCfWQ,eGCGDFECLBHBCCBD.QGABZBEHEFFAKCCCGCAH.aCFHSHGChAAA.MDIFhABAJACEIHGFhAAAUAGGdFAA.PGDGAACFTEDCOHCC...fECHhABABADCNIBB.cBFAhACA.,1,-11,-27,16
OSGVHRXKFIQNAgfcaDUePWbMLZEBdTJYC,...fFFFaEBAUFFDeAEH..WCFCLAGH.BCCChAAAdECGTBBACGCFOBABhABASHBE.hACAHADEKEFC.IGHCNIADAHIDDIFAMBBGEHEEYAAEhAFA.RDDF...hAGA...,2,-22,-20,2
ONZEDCJbIGBaPLKMWSHXdTgRVQUFceAYf,OFFAECCBDBDA...JACEGCGGBCCFLHDEKFCFMEFB..SBADhAAAHBFCdDEFTGAHhAAARAFFUGGH..FFADAECB..hABANBBG...CBBCaFDFXECH....hABA......hACA...,2,-28,-15,13
cPJRaCESDFbAVGBIXHTOgdLZUeNfMYWKQ,BEBEXAEBOAFAdFFGLAAGUDFH.eFDFMHCC..KDDDQBCHhAAAJEBF.CHHBDGGGhABAACAFGCEB.IBHBhABA..TBFFNIEDfGGBhACAWCAF....PDDHhACAEEHDSCCC.,2,-34,-3,31
UTNJWBfFPGedSaMXEcLHbAZQRCYIDOVgK,RBEDCFGADDFCOCHH..KGAHUFAB..JEDGBABB.FADGeDAEdEDE.hAAA..SBEAhAAAMAIBEGEC.LHCAhABA.AEHEZABEIHGA....gAGBhACANBBAWHBG..fCCChAGA,1,-30,-48,18
gPGSOWACeTcXFIBLKZNRfaYUVDdMEbJQH,eGCGXGEEFEGHBCEDZFBH..RAAD..aBHDUBGD.DFAEMEAFEBAB.hAAAJCEB..QGADhABAHACE.GDBFhACASGAHAHHECADF.IEGDNIEF..fBBDhAFA...hAAA...,1,-16,-29,13
IOGUXgRBFSeMPQCTcAbaYJNDKVEfdLHWZ,aAECJFEE..DBHHECFC.dGADLAACHFFHZABFGDCF..XFCBhAAABGHCSEABhAEAMIBECEHGADBF...bBCANECD.hADAKHAE...fHEFIHHD...hAFAOAFG...hAGA...,1,-18,-28,10
PDdWYIgAJNFZKHGeULfCVbSEaMQcOBTXR,JDEFFEAEHFFGGBEFLEDA.CCCE.SBCCEAEB.aDAGQBGGhAAABAHA.XGAEhABADAAEdFBCIEGEhADAACAEKHEC.UGGBfABHMFAB..OFDBhAEA....hAFA...,2,-28,-16,12
OMSCKJNZXgefUacBDVREGdPHYQLFAITbW,TEAEOGCA..CHGH.JCEAZDFC...eABBUEDBBECGDAHFRBBDEHBEdGEDhAAA.HGAGLAEAhAAAAADG...ICAHhACAMIECNAIE.fGFH.aFAB.cDDHhADA.....hABA...,2,-26,-19,7
cFYPTQafbLCeHRGBOVAgWDNXdZSKEMJIU,DFEBXEECZFGFKDGE..JABHUBCA..FBEA...TFGHhAAAQGAFaBHB.LFCBhAAAeCADHFAGBBGBAEDHNIABhACAEBAFMIFG..IEAF.PFFBhABA.CDEA.ODDAhADA...,2,-31,-14,17
JCXdNZSBWfHUeQgaGTPcOIADKbLYMFERV,DHCGKEDELFFEMBED.FAEBECBE..RAFF.JDFHCCBG...dFAHSACHhAAABDABHBFEeBHFhABAaGHD.GGEF..hACAcABFADIB..YHAANIBHZEGD...hAAA.WAEE...hAHA...,1,-18,-28,10
LCEUGeKSIMTZaPfOHAQdJcVRYDbFXBWgN,JFDDVAFH..DAIFFFDHBGGA....NIDB.EABFGEEF.eBBAhAAASEDC.hABAMCCEaEAHOBHDhACAAFFCdEBGRCFA.XCDHLADCKHAGIHBH.hADA......hAEA...,2,-37,-17,20
GIBQUJbDcVNLaPgWCfdTSYHAXZKERFMeO,XGEAEAGBRCCA.FBGEeFFC.GEAEBBACQEGFJACE.hAAADDDCNIDD.LCCFhAAA.aBCAWBAFCGBH.dDGBhABASEABAEEAKGHHOGCCIFEG..hABA...cAFGhACA...,2,-35,-10,25
KPVWJRSCYbaceHQTgMGUBNdIALEXZFOfD,XBBBFEDGOBFADAHD..KCEC..VDEBJAAB...RBDCSDHFhAAACDGA.aAEGeCCFhAAAHDAETGGBGGBDhABABEAAIHGBEGDA..fGAChACA...WCHH.hACA...,1,-15,-35,20
OgdIGEcHQSbDXWfANJeFBRaTKYLCUMVZP,JAGHBCFC.RCCFKABDCAEG..UDADZEGH....OAHHdDDDEDHFHEEHhAAA..QAAFhABADIDC..fEADhACAAFIDeHACaFFFTADEMCCA.PGBA..hADA..IHHDhADASGADXGDF,1,-25,-31,6
IHFBOGabQWDYXKSeTVcfANZUPCEMJLdRg,ZEFCUEFACCFA.EBDHLBBC.RCCD.IHHBBAGEGFAFQCAAhAAADGGB.KAFA.SCFEhABAeBAD.cGDChACAAHIHPHCE.MBIDdFACFEDF.OHAEhADA......hAEA...,2,-24,-16,8
eFDCUgaXYASMZGERBVdPLNcQbOWTJIfHK,MEBEECGCBDDBdDFALAAH..QGADOFAC.JFEDIHHHhACAKGGGeCACCHEFUAEBhADAXEAC.AABAGACBhAAAPAHB..cEGDWDFG...fCCBhAFA.DIAG.hADA.aGCF.,1,-19,-29,10
DGAbadCFHLQeVOREXPTMfYcKIWZSUJgBN,dCBFFDADQDCHOEBARAEG...EABBTEFAMDFE....fHEHhAAAKHAGZCFAJHEANGADGADFhACAAABH.aGGDCEAGLGAEhAAAeEHB..PHAE.IFFChADASACC.BFEGhAGA..,2,-21,-10,11
WcAYKedBUVCMXNgQaGHFPZTRLDfOESJbI,eBEEBHEDCFHEMEHD....XCEAQAAFGDAFFDEDPCCFhABARADGLHAEDFIDOEABhADAEGFG..SAGBhAAAIGEDABHEKABH..dDGF.NICBaGAD.hABA......hADA...,1,-5,-31,26
PQHNBaALSGTFbgDMZIdVXRUWCKfJcYOeE,SCDHFCFBDDCGZCAD.dDFD.RFFD.CGEF...KCBA..JHAEOFBBhAAA.EGCAQGFDhAAABADGAAGDLBADGABDTDGBhABAMICC.IAHHXAGH.fEHAhABA..cECBhACA.,1,-18,-44,26
ZgBHJIFPEUeNcQCKLTDXSRdaGMWOVbYfA,ZBDGHBFCFDGGEECCUEAGeEHF...QFADCGFD.KBCELAFEhAAAXGEEdGGEaGDBMBBGhABAOAEG.YBAFhAAAAFDDJHBG...IEFGNFEF.DDDESCAAhACA..hADA...,2,-36,5,41
OJUBDEVfIcdZCTWQLFYRegKXSMHaGNPbA,OHBABFEEDHGC..VBBA..IDEGZFGHCFAH.QCGDhAAAFDFBRDAG.KBCDMGCCaABGGFAFhAEA.bADEAAAHJADChABA..EAHDdAHC..WHEG...hACA......hAGA...,2,-26,-20,6
KcfGDWQYgFMSVZJEeTPRABUaNCOHLbXdI,BGAAUEBHCBCEHCFH.LFEHdCEFKAGG.GAAF.DEACQFFFhAAAFGGAMEDFZAFCEADEeBAFhABA.RGAC.AEHDNDADOFHDhACA...IHEGWFCD....hAFA.SEEEhAGA...,1,-19,-25,6
GPVWLITRQSaBAbdDXfgCEUNKOeZHFcJYM,dGBBDCGF...XGGDCACHEBBD.UAFGKFFAZBGFFEDC....JCAEMFEDhAAA.GEBE.hAAA.WBBELFHBhABATGEASAEC.BDDDAIDEbCFANBFGOCABhACAeEAF..cEGAhABA..,1,-22,-28,6
dAcJXfaePLGFgBQDZSHENCVIKYTRbOMWU,JEDHXDAA..eCFFLFBGFADFBCCADDEEZAFGHFBBCFHAKABB.hAAA.RCADMFHDdHEHADIF.aAFChABA....PHAGhAAAgGEHEFFHNADG......IHHEhABA..YAHBhACA.,2,-32,-21,11
MDGXCbETALVKegBJNfOcQZHWSdFaYUPIR,VFEHKCEHBECC..JFBDOCHF.ZFAGSAAH.dDFHhAAAaGGBUAFERAFAGAAGhAAACDDA.EHCAAEBH.LEEAhACAeADH...fADC...hACA......hADA...,2,-40,-19,21
JIONTBfbAXRaSGQKDMELCedUgYPFcWZVH,aGBEQBGE.KECHEDADLFEEdDDEUGFD....PHAGhAAAFBGAZABEHBAAICFGhAAANAEBBHECAAFF.RBEBDGIFCHDA.hABAeDAB..gEGE...hABA......hACA..WCCF,2,-28,-11,17
gMOcbTZFUGNLAHIPVECaSBdDJXKfYQeRW,HBAAVEDG.CCGDBEED.DFGCKCAB.QACAeAFE.RBFBMICAhAAAOEAG...TADChAAAFFBBNHCD.AEHG..IGGChABAEHGAaAHH..SGADJGBGXCDEfAEFhABAWHCA.bCCG.hACA...,2,-35,-7,28
gXMQNZaHWfTRcOIdYLUebADSEPVFGBCKJ,SBHDECHDFDCC.CHFG.JFAA..MBFBZBBCHFFB..fEHGhAAARFDFOAEAdAAFUECBhABAADAB.DDCE.VABCBAHHhADAKFFB.QGACaBEF.WAFE.IEABhAEA...hBDA...,1,-14,-22,8
KZaHQfRBDGEYWJNegIUOcTSVdCMbXFPAL,LACEaEDHHFFGRBGFBGFAGAEEEFCD..JEHHeCAA.UEAAOCCChAAATAAEdBGF..CGAGMIAGhABAFACAAAIHKHAE..fEEEhAGADIDE.NIED.......hAHA......hAIA...,2,-31,-2,29
KDNgRPIFaGYQSBVAeJXZHdcMCbOfETLWU,eBAHXGDCdDGCCCDA..OAAF.EEGDTAGFLBFCKFDDDAAChADAREAFFACCGCBA.SFAFhAEAAEDCZCCAMAFG.hAFAfFFEUGGB.gCGGIEEAaCHDhAGABHHA....hAAA...,1,-13,-15,2
OGAXYMcfVBNCPHDTWEadSQZLIbJUFRKeg,XABEMBAF..VCGBCBHAHFEE.DGAETBDA..EGHHSGGBhAAALAEBIHAFhAAAbGBCFEEC.KCABOBBDhABAADDHfDFFBAGDNICDaAHFdHEHQECBhABAJFBA....hACA...,2,-16,-4,12
EXfbWUVYILHNZPOcdMABDeCGaQSRFKJgT,eEABGCBFQEGGRAGBKGDC..JGAAgDCF.EBACbEFBhAAAUAGB..IACFhABANAAFOFEF.MCCGhAFAAFBCCHHE.FHCA..XAED..fGHChAHA...hAEA...,1,0,-38,38
WfaLGdIQBVNAcgESFeCTUJPZXYMDHRObK,ECHHSHAGFDDH.eEHFCCBD..UGDAJECBZCEE..XADFhAAAMADADBBAOGAE.hAAAKHGCfBEBhABALBFDIABCBGFGNCABAHIH...gAGHhAGA...YFFChBAA.,2,-33,-28,5
FPYNKLdgfVMSTQJBXRaZOeAcEUHGWCDbI,UEGCHBAFCCFFDAFBFAFG......PCCDNBICLHFE.dEFFhAAAVGBE..SABBhADAJDAFBEECRABCZEACAIAC.hAAAEDDD...WHBEIAGA...hAEAKCFGMGFAXGFGhABA..aBGD,2,-39,-9,30
BYdRJMfgceFOLDSTHNGCaQKAbIZUXVEPW,ZEFGXDAEEEBEBCAHdFDH..RBFE.MHCA....fFBEhAAAeAEGFCDFDGGATACGHAAGhAAACGHFaDEBAGCC..IHAFhABA..PHEE.WAFE..hABAYHEG.gBGAhADA,1,-20,-34,14
eICGSWRgDTMHPNBVQXAFLUEaJbcdKfOYZ,UACCJHDA.dFAHOEDGZBAB..CCHG.GCAD.SFGHhAAARGFCDFEFHCEBBBGB.VEAFhABAAEIHEGCF..aAEF.KACAhACA.eFDA..IHAEWAHH.MBFAhAAA......hABA...,2,-37,-13,24
QAGSJELaPYBNUIKVgFWDZCdRXfOTcHbeM,JCEALDBB.aBCABEGF.UDCHKAGFFEDCDGAE.dHFH..RABG.XFGEhAAA.OBFHhABATFEH...HAFGhAAAMCAFAGIFSDAHEDGFYHAE..NIAH.hABA.IHGB.hACA...,2,-36,-28,8
gHCAOWIeXaPKEJFVBfQDSUGdMZTNLYcbR,ODBDeBFD..XAAFKAHHFFFHBEFE..QDBBhADADAAHUBDD.dGHGZBADTGBAhAEALEHDYAGH.hABAREDBCHEAIHDDaCCAEFAH.JFAHSFFBhAFA.MBIHNADF...hACA...,2,-36,12,48
TDWSLcfUMBgCPYIObQdHGeERaJVZNAKFX,FADEXFEHDCEBLDAHUBAF.BHBC..CAEB....PCEHhAAAIHEH.QFGFhAAAHEBHGAGCEFDARBAGhABAaGGDZCFEAEIHKGAH.SBDFcAFD.MDGHhABA.....hACA...,2,-31,-11,20
YSagATFZeHKEWdLBONJGbVXIQUMDCRcPf,TAFGZBEHKEDDdGGC.BCCFJEAHGGEB..XDADQEFHhAAADDHD.RDBD..PACFhABASAGFADEGFCHB.EBHBhAAALHAG..NIAB.ICABCBAE.hABA.fACHhACA.aFHD.,1,-1,-45,44
XWCOKbANdgYBMfJTEFRHcLVGQZPeUDaIS,dBCEBGEBJAFGEFBF.HBCHLBAFGAEFZGDGeEFA.DEEEaGCGSCABhAAA.CHCBKHGChABAAFEGNIEF...MDABfBHChAAA.FCEF.REAA....cFGAhABA.....hACA...,2,-23,-21,2
dJDNQPUFHXTGYLRMBaCfEgeOcVWZSbAKI,dDGBDIDEQABBUGCBFHFG.HECEGCCCRCEEMAFGBFFC..aBGGCADG.hAAA..EEHDOAFAhABAVCABZGFCAGBB..JBBD.hAAA......XBFG..hACA......hAEA...,2,-36,-5,31
EMeDGVNQJPfXCRHOgadbWKLYScBUAZTIF,ZAAFTAGEFAGG..EEFAMCBG.GGABQADBJDAC..XEFDhAAARGCGODEG.aHGCbAEFhABAKBHBLFHB.hACAcEDEBEAAADDDIACDDEEH....hAIA......hBAA...,2,-23,-12,11
MIOQgNCSfDKcLaWAETeJURPYBZbFHXGdV,eBGHJCCH.REEDBBCEFBDEGDGG..VAEFMGAA..QGAFhAAACEAB.SHGEhABAKHBELFEDaDAAAEHCEBAHhAAATEAG.YDDDbAFF....hACA......hADA...,1,-19,-31,12
ZMXUILGOQAEBDSYeRbcVaKdgCTPJWfHNF,EADGSEDHRGAG..VDEFKCAACACG..JBFEHGFE.ZAECUCAFhAAAIFADGEGGADHFDCIBhAAAeHDA...bDCDdFCChABA.gDEB..WBAENCCDMIAChADA......hAFA...,1,-11,-22,11
dWfKXFbEMCLHGSIAPagRJVeUYZDOBTNQc,aCBHRFGFeBAEZFCH.BGCD..QFGGdDBGKADA.XAGBEGAHLAGFhAAAHCCCSBAEhAAA.IGEFhABAgFDBJACAVFABDIDCNBIE.cDEDFDDACCAFACEE.hAFA......hBGA...,1,-4,-18,14
EQNDPFcZSGYedXCVBRJLbIKAWUagfTMOH,aFFFTFAHHABC.QGDBDCHHFFHF.ZEAHGBCGeECC.CEEHBGFChAAARAGFJCAALAFDKGDD.hABAAIHG.UCAEMCIFNAIG.SAAChAEAdAFE........hAIA......hBGA...,1,2,-27,29
QEgHKXcaLYMSONdWURJfDZFIBbeGPVTAC,CBBFEBDGHDEFKCFH...aHBCMFFF..OFHHdGGDUEAARBFA.DIAGZADEhAAAFAHHBDDH.eEAEhABAGDCC...TAAAhAAAADHDgFAE.XGECYADChACAWCAGIEHF.hACA...,2,-22,-20,2
BQSCaMFEYRVdKgAHWLDPIOGbcZfTXJNUe,LHEGDEEEOAHBGEAFZEAG...TABEJBAE.eDEEBDAFSFHBhAAACGGH.MCDEhABAEGAHRGCCdHAB.KFFFAEIB.hAAAHAGD.IDADfCEF...hADA..NABBaFFG..hAGA...,1,7,-45,52
ZdaYVUQITMOBRJNCFfXcSgGbeKWPHAEDL,EDDFZBEDaBBCUBAC..QGCFMBHF.OFGBJHFC..CFGFFBEAhAAAXDAF.SHAGhAAAGFAFeHAGWBHDhABAAAFADFIFLFHHdACEIEAHTECBBACEhAEA.fFAEhAFA...,2,-20,-19,1
aSUcYJeXTdBVObfNKPLWFGDEHCZIQARgM,MAFAaDEG.UGGB..JBAHeDGBdGCCBGEDOBDB....bDFAhAAAfFDA.hABAKBGHLBFCFEBHEEEGCCBChAAAZECAABAH.gGGC.YFAFhACA.XBBBNDAC.hABA...,2,-29,-17,12
EeGXgaWRcSbdVDTCIHUKfPBFOMAJZNLYQ,JDACZAFGLHEE.EDCAeAFAGEAAaDHBRFDD..SDAFhAAAdDFEDFIF.CABDUACGKBAABFAFhAAAFEFHAFID..QGADhABAXCFEcGCG.....hACA......hADA...,2,-38,-7,31
XYQbMSZfPUTdARWEKCGgBOFJNcaDeVILH,RFAGEEFHCDCF.GCDDBGGH.OFAA..JEDEaHCG..DAFGeAECLBEAhAAAXAAG.QCAAhABAMDIH.SHGGhACA.fFHAPABHTGDDhACAAHFHKBHB.....hADA...,2,-48,-11,37
JGHLEaCQVTFUOgWdebXfZBDMAcRIKYPSN,RGEGKCEG..SDDGJDHFGGBHLBDE.CHBE.TBCAUBABODFAhAAAdGFEeDAEXECGhABABHHEDAEA.AEEB.IEADhACA.NEIAEAGGaAAGFFBG.gAGHhADAfEGG...hBBA...,1,-12,-26,14
MSKeUANcEJWCFRHQZDdbfBYGPaXVIgOLT,EBEGJGEG.FECDHAGF.DDIBdCAFBADEGGEB.aAFA..XDBHhAAA..IEFHhAAALBAGMIAASGBHhABAKDDCAEIF.WHEACDBD.QEDGfABDhADAPBEFOAHD..hAEA...,2,-26,-20,6
FUXCESBeGOTHJVIDdaKNMZAYcbQfLWPgR,...bFACQCAF.LFFDPBAAFEGCCAAHBHCBODEGhAAATDDCJBEC.DFACaHGAMEIFhAAAAHBH...cAGGhACAWEAE...gCGH.UGAAhADAEEEB.SGGBhAEA.eBCE.,1,-3,-24,21
RKOTQbNLIWfVUZXAPJcdDCYHaGSBMgEFe,JEEFDDECCBEFHAAD.GBEHMFAB...FCCCeBABOGAA..QFCGhAAALHDAfADHhAAAUGGBAIEAdBHAaGBHhABABEHFEDDD..KDAFNADH.IHAC..hACA..WBBBXGGBhADA..,1,-6,-33,27
SUBRefMIgaDKQNVEOWHZCAXGbJLPTcdYF,GEGEJFEGLBFE..TBBGdDAEFCCABCGB.eEDGMFDDIAGChAAADABH.KCFDQCGDhAAAECABHFBCABAG.hACA.PFHD.SHAEfGECNAEFOHEChADAWEADCEBA...hABA...,2,-22,-18,4
ALOZUVYCDcdGIBMQRHJgEKWFbXeSTaPNf,LDGDZCFBUBDA.VFBCDIAEGFCB.BACCQADB.hAAAJBABEGAEFHEAeDHDTAGEhAAAaABH...fDCBhABAAHGHCAFBdEAF.IHHH.MIAC.hAEA......hAHA...,1,-14,-27,13
YLaOeUdVgADNKcFJRCIQMGXfBPTHEbSWZ,KHACJGEG.CFBA...QDEAGABCBEEDHAAA.EBGESHGChAAA.ZAFGaDAEUGDBhABAdFAHAAIFDEAFFDGE.RBDAMIFChAAAXEGB....fHABhACA......hADA..bADB,2,-30,-16,14
MbGXeCNgEUJLISDcaKWFZfBARTQHdPVYO,QGFAdCCE..PFCAOBCFMGFEGCAA.CABAEAHFUAEGhAAALAFDSHFGhABAaHACFEFCBAHFAFIFHEDBhAAAVCGDXGBC.gABCIDHBDBAHhABA...cGCHhADA..,1,4,-31,35
IHGcTNREPWXCYJbagSBKQDMVeFdfLAOUZ,OGBCUCDEHDAHGCAC..TGBDEAFDXCFAJEFB.aFEFSABChAAABCDF.KEHHhAEADBADVAGBdGGEAAHAIHGChAFANEIC..PAAGYFDH...hAEA......hAGA...,2,-22,-10,12
THLAJCaPFKMGBXEdfURSNYeIgZQbOcDWV,JEFBCCFFFHGAGEAG.BCCBEFEC..dFABUAEDRABF....SDHBhAAAeCEHZEGDOAAHhABADAEA..VDCGLAHHhACAADAAKHCG.MIFA.fGDENBEB.hABA.IHABgDBBhADA..,1,-11,-37,26
dfSUOgQXIAGVbHDcNCRBFWMYLEJKPZTea,GAFEHADGDABDCECBRBDDFCHB...MFHBEABFKFBAZFDE..eCADdEFHSFAFhAAAUCCG.OHBGhABAgGAB.hADAIDFCAGID..cGGCBAHE...hAAA......hACA...,2,-23,-23,0
BNTfQCOcSDJKedXbHMPVGEFAgZaIWLRYU,ZFBEaCAFLFGBUDBFBEHG....fDFHCADE.SFBChAAADGGDKBADeHCCXCCFhABAHAFF.MCIH.hAAAPHAA.VFDGEAHBAFAHgAEEhACAIHHB......hADA...,2,-39,-17,22
BVKTIJaAYDGMWOdZHCbFeSUPfLRQENgXc,DBGGMFEGOHDCZDBEHAFC.FADBUFBB.LCFARFCFEGEF..XCFGhAAAVEGD.KBBHTCAAhAAA..aGGCAABCGACAhAEAdGACCABF.SEED.fAEHhAHANCIA...hAFA...,2,-18,-11,7
SUEFcRbWfeGDMLBOPYQHANdCaIJKXZVTg,CHFGJDAHZABD....VFFHTGAB.UFEFFDHHRECE.....hAAA.fCFHhABAeACGDIAEBBAGOECG.PADChAGAHCCCABBAdDHCKGCB.SAHHEFCB.hAHA..WAGF..hAAA...,1,-16,-35,19
CAHWDKeJfLPbEOGIBgMUNQZYFRcdSTVXa,DEDEeBHDLACGEBBDGDFABHBC.UDGDZGCCFCED.dEBDSFDHhAAATADC..aHGEABAAKDAAhABA.JBFG..fGAEhAAAOFGFICDDMCAB...NICB.hADA......hAEA...,2,-39,-5,34
NAGERQJCSTdcHYDLaUbKeWFZBOVMIgPfX,RFCCCGDHdEBFHAGDLADFUADCKDEH..eFEEFAAEBDBDOBHH.MAFAhAAA..IEHAhAAA..fABEhACAAGAHEGFA.SFHB.cGBBDIGCaFBGhAGA......hAIA...,2,-33,-24,9
EJAWcCagKNdGTUfbDHFRMeLVQPIXBSZOY,CAEGKGDBGFDDUEFA.DCGARAFF..LCAC..QBBBhAAA.IDABXFBBhAAASFAEOBHDEFABhABAAHHAaEFA.dDDCfABHFGBHMIFA.PHFEhAEABAHG.ZDBCWDHB.hAFA...,1,-18,-26,8
QSLKZREbcMYeAVOgWGDTHfaJINUPXdBFC,VAAGODGF.GCDADBEHHGCA..JACHUAFCdFBHBBAECBHE.LHCAhAAAKFDCZDAHEFGDMEAFhABA.eBEEAIHG...hAAA..WFGDaDDENEAGFDAA..SDCFhADA.....hADA...,1,-16,-21,5
REPMaYcBNTgCGIZHFVbJKDOedXQSAUfLW,LECCEABG.aFDDBBEB.TCFFGAAEHEEHFBFA.JDABOHAChAAAeBBBdGGGQGGChACASEDFAFIB.fGBGhAAARFAGMADGNDDFCHFFIEHH....hADA......hAEA...,1,-4,-22,18
fUXRCgAdeVFaSNBQLYOTMbGPHZJWKcIED,VAEHSDEF.BBAAQDBELADGOHDCMGEGGEAChAAAZFGHKCHDEEDEDGIHXDGChABACABGAADF.FCCHNEAE.TGCGhACA...PAHHWGDC..IHBHhAAAfHFH..hAEA...,2,-21,-20,1
LUMOdDZfFSBRAYgJEHNaeIWXQcGbCPTVK,JBEHECCCHADC.aFGFeFBF...IGDDXGDA.QEAChAAAGEEFCCHHVCAAhAAAKEECMBIB.DHAGfAHChABAFBAESCGBAGABNIEF....cAEAhACA.....hABA...,2,-23,-17,6
XDNfCGJBHbOWcREISdeTZLFAYgVPQUaKM,VEBGQCGB.aBAFKGFB.DDIB..NACD.CHBFBAHCHEFDOFHFhAAA.RGBE.EGDAdECBZAADhAAAFCCGAFFA...YAFGhABAPCCC.MIECXAFD...fACAhAEA..hAFA...,2,-46,2,48
AKTQBOWUaHFJbVNGPCILReSEMDgfdYcZX,QFAHBHFCUDGHFFBAJHEC....VDGHGAAH.CEEGLDAChAAASGCH.EDAAMIAGhABADCFGdABBZAFGAHCG..hADAKDDF..TFGHOAFEaFAH....hAEA......hAFA...,2,-25,-23,2
LWbAEIMCdZVNQJePROFcKXfTUGDaBgHSY,MEIDdBFAZCAE.QFCFJHEG.RFGFFFAHKDEA..TGADDCAGBECEhAAAHABGLABEAEAA.hAAACCHB.VAFH.NCCE.OHDChAFA..fEDGaHAE.SBADhABAbEEB.IFGHhACA.,2,-36,-11,25
NXFVHbaOeCWLDRcPMIUdZTBSfKYGgAQJE,QGECEBCAFDAB.HCDDOFAECCAALEBDDAAC.RCFF.MDFBdAGHBHHFhAAASHGEKABB.hABA.gFCDhADAADIFXGCEaAEFeAHH.WCDH...IFHHhADA.ZBFH.YHAAhAEA,1,-15,-17,2
SFWAacURKTCfbNLBPGDQXeHZEYIdOJgMV,aFAGUDEB.KBBECDAH........NCDHBGBGDICEeGBAZFDH.EDCDhAAAdAACOBFE.MAFGhABAVFGB.FDEGAGGHRDAD.hACA...fDHGLEHDQADGhACA..XBBFhADA.,2,-41,-18,23
gDOUMLABZNVCEIKcQRXfGTeadSFYJPWHb,BCEFVBGH.EFGG.KBAARDCAGBAH..aFDESAGEFBGF.hAAAJADCHEBH.DEABOFHHhAAAMBIDACDDZFCAIHHHhABA...XGEA.fHADhACA.dADDWFFBhABA..,2,-33,-23,10
WTAaYVGgcHPdSIfNZDMBOKELJeQbXFUCR,VEDAGBBH.HGFAdHCF.SEHB.IHCDfBBDhAAADFAGBDAAEFBFJCDGQDEFhAAAFAECRDGB.ACGGaFDFhABAgDAC..NACFMAIHKAHH...hABA......hACA...,2,-23,-5,18
ATMgZOYLFKCQcEXdDaSVfIUBWbPGRNJHe,TCBHMDHDZBEB.LHCGCHGG..QFCGEADCDAAG.aEEASBCGhADA.IGDGhAGAUAFABHEEPEFDhAHANBIAeEAB.ABBEYADHKAHBdDDG..WBBDhBAA.....hAAA...,2,-34,-12,22
bXWcTRaIgJGOYQLZBHFESNCfdPKMAUVDe,VEADDDAHeAHF....XDDFTFDAaGFEJAAA..GGCBhADAQABGBDFAEAEBCFBDdDEDhAAAMCIBAHAE..WFFEhADAIHHB.YAHDHBDGNIDBKEBE..hAEA......hAFA...,2,-19,-14,5
YfcPdMeLIUQKAZENXTbCgDFWSRHBOGJaV,EDHHTECF..CGFGDBFEFHEERAEBBGDA.GBAFaCBA....VCGDhAAA..fFABhAAAdAGBLDAHQDDAhABAAHBEXFGEWDGDSABCOHACcDAAhACAeHBA.IHHChADA...,2,-38,-7,31
FfRQBUPSZMgKDTAXGNJLHVCEeIWYOcbda,GDDGLACHCDGE.EEBGeEBF....IBBHOAFCdFGGFAFFRGDGhAAABHCCUDEESABDhAAAMCIBDAEB.AIEENEAGJHAAHACHhACA....WBGH.....hAEA..cGGEaHGE.hAFA...,1,-19,-21,2
XNTECYKPSJcUeOdaWLFDBHIbRZVgfMAQG,XACGTGAE..EBCHCDHA..KGCB..SFEAJEEF.eBADhAAAOBECaBFFLFHHhABADBADBAHCHDACRECC.hACAZFAFfHCFAIGCQDFANAEFcCECdGGBWAABhADA..FHEE..hADA...,2,-16,-8,8
AWbDUcTRNKHSMZCfELPJgGIQVeBFOYdXa,DGGETFFGRABHHBFF.ZEDDCCHELCBA.JEACgGFGhAAA.QFADhABABEHHFGADdAGDABHCUADGNBABKGDFMDDDhAGAEDEH....IHHAOHAC.aADA.hAHA......hAIA...,1,-9,-23,14
AbHEVefYcdRMOKSIJGPgLCFDQWBZXTUNa,HDDDVBDG.eHAG...fCHCdABGODBDSEAChAAAJFEBGDGAgABBhADALDADDHBABHHHZDDGTFBEhAEAaAHB.AIEEEFGB...RBFFKAGC.CFHE..hAAA......hADA...,1,15,-22,37
EYSeJGDcHUNOXfKCgBZdaWLQMATVRPIFb,RDEEFHGCEBCAeFDC.DDHBUGDB..OBECKEAECGAG.BDCHZCAA.dHAB.hAAALABDACIB..hAAAPAFAIEAG.hABA.SGHB..JACE.cGEGhAGA.NBIG.fCFDhACA.,2,-43,-27,16
HfMaIGcEQWgRYTPUJdONCbLeAZVKXFSDB,ZCBCXADBDIDCBFFEHCFB..MHAEaCBBGGAB.EDCDQAEGhAAARAFG.TACEhABAPAACdFHANEICCGGCeGDEhACAADDAKFDGFCGH....SHFAcAGA.hAIA......hBAA...,2,-28,5,33
QFZHcObGJfCPIMWUERaKBXLDgAdNSVeYT,SBBFVBFC.eEFDTDCAZFAHODGFGFED..CADHMIBGhAAAECCAKFDHBCBFLADGhAAAAFHCdGAH...NEIGFAHH.hABA.cDACfCEFIHHHWBADaAFGDIDChABA......hACA...,1,-13,-15,2
VBYUfcSCJaGLETdAPKgWZXOFIMQHNebDR,KDGAZFEGFDFGQACEHDBCeABBDEBE.BFBCUAGG..SAGEhAAACEEEGGBHLFGBhAAAEADFAIDC....WFHHhACAXFACMFAD.bAEH.......hADAYCAAfGBAhAFA...,1,-17,-26,9
EaCHWcGTQYbfBKDNSAMeIdgVORULZJPFX,eDCBdADFOCBGRBGHLGFGZGAE.FABHEFFBHBDEGCEH..TGBAhAAAQAGE.fEBChAAABEAFKEFADFEBhACANEEAAHFF.MADA..IHHC...hAHA......hAIA...,2,-16,-12,4
LaPCUXNeATKRSVHgIEcJWOfBMFZDYbQdG,KBCCSBDHHGAGEDAF..JHCGODFFBBFGFFAADADG...QEFEhAAAdEDCLFHBaABA.hAEACBFFXAADAGIH.hAFATBGDRBBFIAGFfHEB..MAIBhBAA.....hAAA...,1,-24,-25,1
ZWUYAbcCeDNVREIMBdafLHPQGOTSgKXJF,CACBDCHFRFCC.MCGFBCEB..dBACLEABHFCDQGGBGBBAOAAHhABASAFE.KDDGhAAAJHECZCBBUAGBABIDeAEBhABAEDEB.aGBH..PCHH.....hACA......hADA...,2,-21,-12,9
fINFAMWTXOScDRHGgdUYeaCBQLPbZJEKV,MGEGTBFD..SBFADEHHHEABdFEDUDDHeADABADHLDCGhAAAZFAAKBAH.IAHEhABAAAABOHFERBBG.....hACAgDAGYHDCCHHBPCHD...hADAEHAGNCIG.....hAEA...,2,-24,-3,21
EABCUeILMVQadSgRGXOZfKDTHPbFYcWNJ,UBCDeCFGLGEGMBFD.QFBFSAGGRDDCOACAKFAADAAAHGCEhADAFAGA..cBBHhAAANEAB..JEFGAFIBIFFDhABAdHGF.........hAEA......hAFA...,2,-29,-10,19
WRfDZaHdGYKSANcbQXVMICJBLPEUTeFOg,...bFAFQCBA.XABGMCGFCHDEJBBEBEFE.LGCEhAAAUDDBFAEAOBHFhACARFGBDDIH.ZFAHdAHCKBEEACAH.NAEBIGGDhADAEDAA.eHDG..fAAFhAAAaECE....hADA...,1,-2,-24,22
VbASPGOCBUeFXcDITNaYHQdLREZWJMgfK,SAFAOFBHBDFGFAADDFFB....TGEGaAAGHAFFdGGEECEAhAAAJCBA...MFFAKGGCAHEFhADACBDHUFAD.XDBAhACANEAC..QECD...hADA......hAEA...,1,-25,-35,10
DYVUWJSQbZdHaXELGAOCIBeNRPMcgTfKF,CDGDeCDBRCCB.MEID..TGGFFGFFDGEHUAGE..JCFG.QGAFhAAA.ZAFGaFEBhAAAECABLFBH.hABAAFIBBBEBNBCA.cABDfEAE..hACAKFAD...YBAFhABA.,2,-44,-17,27
QDfFUAMTJaIBPHcVXKSebZOENCYdLRgWG,TAFDaADHBCAA.HGDE..XDFDeCFEZEACOCAAEEEECHBCLDDChAAARFCBGBDGfDABhAAAAIFEMACF.IGGHhABA..cGGFSHACNBEB..hACA......hADA...,2,-22,-8,14
UOZdFYBWVRMKTQcbfDLSCNaEeGgJPAXIH,XDAFHEFDZCBEdGDDBHGBRAFEKABE..TAFBQFAA..hAAAbEEADFIFLECHhAAA.NBIE.aCEDGBBHhABAgCGGAAHCOHCE.YEAFMIAEfBCHhAEAEABA...hAEA...,2,-11,-11,0
AfOacMbRWKGSBJUVLEDePCdgQIFXHZYTN,OGDCMCFERFBG.GCFABAGA.UCCHLDBGEFBE.DDIF..eACAhAAAdACGQFGGhAAAXGACZFGB..NIAFAABFfAFChABA.aCADWFFDSFDEJADG.hAIA.CDFA.....hBAA...,1,-3,-27,24
cPeUJGAFBTXQMSYDbHKadgVWfIRLONEZC,BFGHQEFCMEBBDCDCHBDA.dAFF.VGBC..fEEEhAAARCAHODFAZAAGCHHB.eFHFhAAAGCEHABIDFDDHSABAhABA.YHCE.aAHH.IAFHhACA.NCCG...hAEA...,2,-37,2,39
ZFNeYIGJgPXMBDCHKcLAaSUdEfQbWRTOV,UGGAdAGHEFEEQCBC.RGDE.TGCFZBDFFFCBeCAB.IBBEhAAAGBFEJFAH..hAAAXCFBDADGCCAG.KHAAhABAAICC.fCDB.bGFE.OEAHhACANAIA......hADA...,2,-18,-18,0
KRDFfgAdMYQPBXCSeIGJTEaZcLbNUVHWO,MCEHQCAHBAFC.SAHBeCFGGBBCEBFFZEFHLHAA.hAAAUGFBVECCOBABhAAADCCGFFAFACHCdEGHXGDAhABACAGH.IACC.JCHFaEBH....hABA......hACA...,2,-16,-3,13
PJbfYWgZHRTAQVIaMdXGBLKOCeFESDUcN,VEEEaBED..dBGGBHCFLFAGKBEG.OFHHCEAD..EABGSDAAhAAADCCD.NEEG.JAAHhADA....fABHhABAgAGB.RDCFAIFEMFGB.eHACFGHD.hAEAcACE...hAFA...,2,-35,-19,16
YCTeRWVHKJMZNgSDbdIOBXQGaFLcPfAUE,UABDCBFGRGEA.HBFGKACC.JEDCZEFG....SGEBDEDGdHBFBBCGhAAAQDGB.FAEBhAAALBAF..hABAfGHGAHABEAFGeCFAWHAA.MCAF.hAHANCCGIGAGXEBH.hAIAaGGH..,1,-13,-36,23
QbaLBFORGYNEPMTgHcSCeIKUZWVXfDJdA,aGDCBDGC.RDCGGFBFEEEH..TAFGHBEECGHCeCCCKEAFZABD..hAAAXACCDGGDAHADLBHHhABAYEAA.NIAFMFGBhAAA...SCHB.IBABhABA.WDEE.hAEA...,1,-6,-27,21
bPaMQJXKgNZFAGLcOHIUfRTBDdYEeCWSV,GGBFLFFFOCEBUBGDRDAHDFAB..dABAECGHeDHB..SDBGhAAAVFCB.PBBAhABAQADCKHFGNAEF.AAHAIHHGhAAABFFD.CDDDaGAHMCID....hACA......hADA...,2,-26,-10,16
YPRCgAKaeGLIHQbMOfWXNBZcJSDTVdFEU,KBCFaGCFLEBEHEEHMBFG..OFFG..XEAEZAGFJABFDAAHhACAdGGGECAFUADAPACGhAAACHEE.AGDA.eDDEIHCGhABA..fGHCNEIASGAB.hAIAFDDB.....hBDA...,1,-6,-27,21
TMbXEZVdJYFQKAUNBWGSaPefgROHCIcLD,BGHASHFCaHGC.eCFARAFAHECC.CDHE.IFBHLDCEDCEAMBBHhAAAEEEEZACD.dEGAFGDHhABAQBAGKEADACHEUACHhADANHAD....PAFGfGAA..hAFA....cEDHhAAA..,2,-18,-10,8
fdcCWgQaJYKPOALbDREVBNSFHMTXeUZIG,DGCCVCBBBBGB.FBEFMFEE..eDFAUGABZCAGGGEF.dBGBhAAACHGG.QACEhABAaFADKABF.ADHGLCADhACARFFG.NEEF.SHAA..XFDChAFAIEDB...WAFEhAAA..,2,-41,-8,33
GAYHfEOdUXJPbRcLFWMegSTDNaVZCBIQK,HCEDOEBCXFAF..JCHBRBAGFDDHMGCCeDHF..SCDBhAAADHCEaGFHZADCCHGFBGABhABAKGHHAAAA.ECADdAHCUAFHhACA.....cABD...WFHHhAEA...NIBF..hACA...,1,-14,-29,15
NadbIEWRZTBgVKCUPHAQXFOcSMLYGJefD,QBDBXEABFGDESAFB.MFDBGAGC.fFFDhAAAaEFFdEHGEBACZACHTDAAhAAABBAAKAFFCHHCPEEHhABAAEEFOHFCLAHFJECBDDID.NIAB....hACA......hADA...,1,-9,-13,4
gJCEVOBTHdZAILUNMbWaGPfKcQYeXSDFR,LEDCMIEG.aCBEGCEB.KAFCQGGHeCCHDFEFFGFEgAFAhAAA.CGAH.OBABhAAABEBF.dHBFIHDHhABANBBB...WBBEfEAAXDGFhACA.RFDG.EEEE...hADA...,2,-25,-20,5
KCZeBDcPfGMNEVgHaLAIWdOYFTJbSRQXU,dBAFOCECFEDE...TAGHSGFF.QCGGKACCCFBBBEEFhAAADIAC...fBDAhAAANCIEEGECHBAAaFBFAGHD.hABA.IEGBJAECXEGEZGAE.eDAGcAEGhAIA.....hABA...,2,-30,-15,15
FEacAGbQgeWfKMIYUZLNTPOBCJdSDVXRH,GDAFQBEFeBGHKFFBMDIDUDAGZFAHLBAG..TBCChAAABHCDdAHCDFGHRFCFEDDBABAF.hABA...bFEHfDHAhAAANADD.CDFASGAF..hABA......hACA...,1,-5,-31,26
BfaIDbPNRLHeUZQYATVOJgCKGdEMWcSXF,OBCBCHBDKEEF.dGDD..EABBMBEB..SAFDBBGEaFBFDFEEhAAA..NADE.LEAFhABAHGDCZAGBAGGCJDFEGCAChAAA.XDGAIHHB......hACA......hADA...,2,-37,-20,17
BEXCdVHILUDagWRONQZfbKePTcSAGMFYJ,MHECFDAGBFDD..XACEdAFAHDEBLDEFaFHH.RAFHOBAHhAAAZABCKCGA..eFBFPDGFhABASHEGAFIF.hACA.YHAGCAHB.IFBADCAC.NIEFfCCEhADA.hAAA...,1,-9,-31,22
CZfOTbgEBMAKYPNaRWeISQJULcXHFVDGd,KGEG..PDFCRAFCeBCDQBCDLCEFHCGFDEABdBGBZDAFOHFChAAA..gAAFhAAABEBHAACCaBBBSHGAhADAJHAGUFFHFFDFCGAG........hABA......hAEA...,1,-9,-18,9
NYfgDAcSGBTWZCEQOVJPRHKMeUXbaFIdL,SEFBTGGH.CCEG.EECD..QAGCVBFHRABC.HCBFeEDGhAAAbFCEFHBELHDGhAAA.fCHChABAACAHBHEFOEADPFAFMAIDXADCICDB.hACA..dAFF..YEHBhAEA,1,9,-19,28
AdTOHEfGcbLSYCMQWaPFZNKVeJRgXIDUB,dDABHBCHEEDCGAEHLABESCHD.MEGDaHCEFCHDKCADeFCChAAAJGAARAFB...IFHChABABGGFADECOBCFhAAA....bFAHCHHB.QGDDWFFF.hAFA......hAHA...,2,-25,-1,24
ZBXJOVbcFaMGWYfTRPISQCAKDNegULHEd,KBFCDAAEeDAHLHDEdDFDZAEEBDGH..OGFEVBDB...FFCCMEIFhAAA.GEAE.hADA.YHCAfCAAhABATCCAIACFSBGACGGEAFFA...hAEA..gEEGhAEA.EGAH,2,-31,-19,12
LURKbgfGaBHMAOcCPXdEINZeQVSYFJWDT,OEFFCHFFdAEF..EEFGZCDE.QEAG.SFHDhAAAFHACDBAAUBFBKCAG..fHBFhABAaCCFMEIFADAGXAFEhACA.eEEDJECF.WBHH...TACAhAEA....hAFA...,1,-19,-46,27
WVBMHNaOEgcAKUYXQCTRIeFfLJbSDdPZG,UEBGQBBFCCDD.REAFFCEELAAB..SDHFDDFBdGEDZFGFhACAGGEDBGADHBFAhADANDDEOAEC..EAEFAEABKFEChAAA......YHAG.hABA......hACA...,2,-28,-23,5
RWMeDOPXcUTaESZILQJNVFBAGHCbgKfdY,CCEGKCDBdHABRBFG...MGEEOBAA....XAAGUEFGaFAEEBGChABAZFDDLDAE.hAAAJEEAVCAFBEBG.AGBA.hACA.......bGDCfHAHhABAeAFCDGIF.PHFA.hADASAFC.,1,-16,-26,10
WTQYeUfMFXVRgEHaAJKPbCDBISNOdcZLG,JFCCKFFHCBAFBEEE....SGAHdDHCZBCCGGEBQCGAhAAAUAGF.FCAE.RDDDEAFFAHCFDABFhAAA..OGCCLDAGhACATEBF.eHFAXFAC...hABA......hACA...,2,-31,-23,8
TSHFKONDZEebRQLCAaJcgdYfIWMVPUXBG,JBCHdHDB....fCGFMBIFUFGCGAEAHFAH.FEDHKAACOAAEhAAADCFC.ZFFH.EAGCeFDFhADAREAD.CAFF.ADCA.aDFG.hABA....gGEF...hADA..WBDB..hAEA...,2,-37,-14,23
LeHXdBDgGcfIAZONQTPUVbYFSJWRKECMa,ZBCDQBCDUFDA...VFFDFAAEJDAHKAFC..MFEFLCFEhAAAeFBHHDAHBDGDDFGFgAAFhAAA.GDDDhADAIHAHNDIG.....bFGDSGCHhAEAEAGC...aAHDhBCA...,2,-36,4,40
VZeQcXHKYFWJgaTIDCGbfEBAdRLPUSOMN,LAFGSCDBODAFMBGH.ZBBH.QGGDHFFHKBADFGAD.hAAA.JGCEaEACDCGCCEHE.GEEDhABAEDBGAFDBdHCBRADB.NBBD.hAAAeDFE..cAGFYHAA...hABA......hACA...,1,-2,-20,18
AcRYgdDJXKZWHEbIVQFfUaGLMCPOTBeSN,RDDGdBDDDBCBJEABZADA..HCFC..EDGEVGFEFBAH..UFGELABFhAAA.CAEF.OHCEhAAATDDEBEAC.SGABhABAAFIH..YGCEKFCE..WAHBhACA.....hADA...,1,-30,-31,1
JCPadMLGNOfKEgVeTHcIZSUDXQRYAWBFb,FCCHCHDDdDECMAIHGBBH..OGDAEFBH.eCGBHFGHZBDHDAADRGAA.AAEABDGGhABA....hACAJCAFaAGAfAFDhAAAKDAC...........hADA......hBBA...,1,-28,-31,3
THgFYAGbUDdaENBPOCRJZMcKSVQWIfeXL,UCFEdBABaCEDEGAC.BFGBCFHE..ZBFFKCBB..SBDBQEDHhAAA....IGGHhAAAeAFCXABEhABALHCGgGGGABIBGDCEDFABPHBERCABMAEEhABAWCAF.....hACA...,1,-18,-19,1
eDKGQASYOdacXERUNIMVTHFLJbZgPCBWf,OEFFdAEAaDEB...XEDFUFFC.MCDETABG..LACGhAAAJGCGZDAC.CCGABGAFhABAeBHDDIAEKEACAHHE.SEHFhADAEBAD.NICD.IGAHFBBH.bBFDWHBChAEA.....hAAA...,1,-20,-26,6
GETPDWXFBJVIedKZbaHLAUgfCMSONRcQY,UFDBCEEG.MBDASCCC.REAFQAEFGCBGEBGFDEFCFFHFBBBFhAAA..IAAEhACAKDEEaGEELAHFhABAAAFGfHAF.NICF.cGCB..TGGGhADAWHEA.XDDBhAEA...,2,-35,-20,15
ANQMVYXDKdORCaSZPWgHJEcUFTfBeLGbI,MAGDXBEEDHEA.dFFARBBA...CCAD.ZEAG....PCDHHEGFEADEhAAAFBBGBHCDGCECAIAC.hAAANIAH.QEAEhABAKAHBaBAH.SAEC.JDHB.TFDHhACA.eAHH.IHHAhADA.,1,-14,-21,7
RBGfLXeOIYMSEVJPQaAdcUbFHNKDZgTCW,UDGHFCBHKHDCZDCD..CGAE.BBHCGDEHLEBD.eAACOAAChAAAMHFASDDFhACA.JAHBPEEB.hADAAIAEdBCHHFGBDCFDgADH.WFCDhAGAfAFE..hAAA...,2,-35,-20,15
fcDUZLQOHWgeSYJbdRVGCaFIXENMPAKTB,BABHDECAUDGGZFABOBAHHGBG..eACE..JEFFdBGBGBEDhAAAaCBGFFACEEDH..MEFDhAAAAEIHKAGC...TCCHhABAfGGELHEGWBAC..SEGBhADA....hAEA...,2,-24,-23,1
gOAZSbPLRQJcUFVMTfdKNDEYaCBIGeWHX,ZBCASHECLAACQBGEJBHF.FBAETEDCdEDF.KGFGDBDGhAAA.EEABCEAD.BCFGeEBHhAEAXEGHAGDF.PDAGhABA..cFGFMHAG...NAGC.IHHBhACA..WHEGhAFA.OBBH,1,-24,-25,1
CQOPdLYfWTJAbVgDNMcEGZSeKRIHUBaXF,VCEGDGCCMFAB.GCECZCAFKDCG.HEFCBCAHFADBCHBG...OGAGhAAAdBGALEHB.hABA.WHCEAAEC..bABFhAAANAIE.EGFA..SGGAIEBAaDDHXAFEhACA....hAFA...,2,-24,-23,1
VWbMfIBTOgAeGEXJZKNHRCQYSPcLUadFD,EBAHXBCDKCEB.HAFFCBHE...SAAALEEAUGCAaGFBFHGGhAAADGHDVECD.MEAHhABAfDBBBCHAOFFAhADAAEABeFAF.....JABANEBE.QGEEhAAA....hAEA...,2,-32,1,33
FQUJVRNEYGgSHfTKeABMdLZOCbIDPcaWX,MCBEdFAFOFHH..ICGGDIEE.aEACXBCD.FBEAhAAAQEDEUFEE.hABAJFFCRGAE.EHBC.gAAChAAAfABAeDAEADGCBDAFCHHF..cAGAhADANEEDSECBKHEG.hAEA...,2,-25,-25,0
QKZdOWVEfFSIcabgeCARDTPNXHLYJGBUM,DFIFTAGC..XDFGLACDGBAFUGFFKDFCdGAC..ODAChAAAEBEFSEGAhAAA.IEBCbADACGDCAFGHPHDChABANEAG...YBHHBADAQGCChABAWFCF...hACA.fHGBaEEB,2,-14,-10,4
TFLeNKEdZfbYOagWAMJXPGICVQRSUBcHD,XFACGFCBCCCCRDAGBHCH.HCBEDHGAFAFDeAAH.KGFHZAGD...hAAA.fAEChACAOABEaDDAAIAAMFFC.PCFEhADAIFACSFCE....hAEA......hAGA...,1,-18,-37,19
YHZXEAdSGBfQLgFVbUCDIeMNcRJPTaOKW,SBFGBAHELEFAFGFC.UAEHDDIH.eCEFMAEA..RCBF.TCCFhAAAKFAAHGEC.XAAChABAAGBDdABF..QDFChAIA.gGBHCHBEIDGE..hACANEEA......hADA...,1,-24,-25,1
AKPSgafLDJYMGRICFHBXdEOTQbcVeNUZW,KGDDSHAE..fEBBJCAGGGEBRCCAFACDBFAD.XDDHhAAAdAGDOEEG.TFAEhAAAQCGD.hABAbACEVGFCeECDNCIC.WABCACHDaAFHDAIF..ICAHhACAEFGG...hAGA...,1,-9,-18,9
fgGbPeIWLOcKaFZBMHJTUYEANXRSCDVQd,XGDERFDHDCBA.dECHGDEB.eACALDDCKAGCZBFEMBAEHFBDhAAATAECUGGDAACCNEIC..hABA.CCDH.QGAGhAAA.gCAC.IAHEhABA.OEGD.FCGAhACA...,1,-10,-19,9
cNCZdYKReGgAfHbMDJTPWLUXIFOVSEBQa,HGDEMEAEDAGCJECE....TGABLFCBUABDIEHF.hAAAFAAHOAFG.EEAAhACAaGFFNCGE.dBFG.KFAFeCCAhAEAgEECAHIF.fBHC.hBAAWADB..SHFAhBEA,1,-10,-45,35
dSHOGTRXQgAfaeEKFJVNcYUDbPCMIWLBZ,aFGBEGBGKEEH..FEBD..VBBD..NAACUAFCDGEB..CBHEMAADhABALFDB.BDEChABAdGHEHBFFOBBCTGFFhACAXDGAAGAB.fHBHJAEB..YEAAhADAIHHC.WFFDhACA.SDBE,2,-27,-24,3
BNJHEXLYfKUdVOeQMTaIGbZWAgPScRDFC,SGAEDECEBEFCHFAGEDBB.LBAG.KEGHdEDH.eAECMDIHhAAAaDGEGBEDZGFEWCCEhAAAAFDA....cDAGhABACACHNIAF...XGGCfBACOHBEhACAIGDE...hADA...,1,-19,-24,5
VgbOAZGYHeEfcLXNCBQISdTFRPMKUDJaW,GCCFHBBDeFEDEACELFHFCHHCBCHF.SHCCTGAB.FAAHMBEChAAAKCGCDEGA.JFAAaDDGhABA.VDFBOFFBADBFfFCEhACAXAEBIHAG...hADA......hAEA...,1,-11,-18,7
gIFENfdVcWJBUKHPbDZLeQRMTYaAGSXOC,XDFAOGDE..CCCHFFCAEHGA..dFCA..VBEAJAECUAAB.hAAAKDACHDAD.PACAhABADDEGeFFG.MCEEhABAYCHBaHAC.ABCHSGAGNEEG.cGGEhAGABDCH....hAHA...,1,-16,-33,17
ACVUMZBGFeXaNcYWTKfQHbOJDSdEIPLRg,VEBAZCEDFGAF..eBGHaDAG.....NBAB.....YAAGhAAATFFDKAFFHGDCODHDhAAADFAAEDGELHAGhABAAGIBUCCEBHGHXCABfEGE..hABA......hAEA...,1,-17,-27,10
AHOFWGTUKSXbIdRMgafBLDYJCeVNEQZcP,FAGBTDEGUBBA..KGFF..XEBBdGDARBGHMBAG..fEAGhAAABBEFDGIFCGABVEEEhABA..ECADZGDAAIBGOCCBhAAASDFE.IHHDaAFF...hABA..YACChAIAeDHH.NIBB..,2,-32,-18,14
dRGOYQMgWUNLcVbIKAEZeFDCTHSBafXPJ,EGGBFEFCDAFEHBBEBGHBaEEE......XGCCdBACRGCEODBFhAAAMEIHUBFHLBHHbEAGAHFHhAAAZCCH...CGGG.SAHBhABA.PACAYEAF.QBFHhABA..hACA...,1,-2,-34,32
dHDCfBRXPGSWgOeEINZYFUTMKcVALaJbQ,aEGBJEHH..dDEBCBAGBAHB..XABFGEBE..SBHDhAAAOBDBeHDGEDEFIHFAhABAZAFAUGAGMAAF.hACAKFEHcADBAEBE.QBEHDFCCfGGGhAEAWDAFNEIC....hADA...,2,-30,-16,14
XVYMCRZPcfNaKWHLAdGbEFSUgQITJOeDB,dBBEEFDBUFFGQCFE..JBDEDEBEBDBAXACB.MAFChAAACEECRBGFZFAF..fFBAhABAKCAELAAAAEEEFFFDhBAA.IHDD...OHFE.hABA......hACA...,1,-18,-39,21
fXeTYacCHdVgPFKRZBMIGbEALNJSUOWQD,JCFFUDCH.QAAADBEB..XFFEeBHDaEAHHAAD.dGCBhAAAPFGHKCCBBBGDIGCBhAAA..EHECNIBFOBEFhADAfEADcADGCDHBFGAF.MACGAEGELFHHhAGA...hAGA..SAHB,2,-29,4,33
YPKLdZXIOTBcbfgHMFDUGWAReEQaCNVJS,eAGFQBBDCBCA.JHCCSDDB.KEBGLFHBZEGHOABGhAAATFAE.BDGAhAAAfFEAHAFFFEDADIEGhAFAWFDAEGAC..NAIC...YAHH.hAGAXDACIHCFcACAhABAMBBD,2,-31,-28,3
ABbVIDHXEMJQFGUdPCSKWegfRcNLZaOYT,BGHBVAGF.HEFH.ECAHJBEHFBFHGDAE.dADBCDHHKGBD.eCDFhAAARGFGLDCBZCBB.aAAEhAAAOABAAFFC.DICAMEEBhABA..QAGFPDHF.SHDEhAFA....hAHA...,2,-19,-11,8
NWAMCLEcfVdFKQIOJbTZBSRHYGUaPgXDe,CEABEGAD....VEFAFFEFQDBB.JCHBbCCDBBCFSABHhAAAHAEFUGGHaCGA.hABAXAABDIBA.eHCEhADAAIHCMHBE.fAFCKDFH.IADGhAFA....hAHA...,2,-43,-10,33
UZPVdeKDSEFMCRYaLcBGfTbgXONHWJQIA,ZCBAVAGDdFEF.DBEGECED..MFAERAAC.LHEEBFFEGFAB.hAAATDCBXABBHGDGhAAAJDHBAHHE...PCEAhAEAKADE...CHAEaGAA......hAFA......hAGA...,2,-29,-15,14
TPLYdZgJSBINeQDcMGKWXCFHObUAaEVfR,aFDDEDAARCFGLFFD.dCBCJHBABDFF..IAGGeAEGDGAGMFFAhAAAKCHH...XGEEhABACDDAOAAB.AGHC.VACDhACA..fHADPFBE....hABA.gGGGhACASAHHNCDB..,2,-34,-21,13
fNEAIBVXHMLaYFUSDCWbOJPGZcTdKgeRQ,VAEDHDFAMCFG.aEDDUEAH.CHCA.OBBAGFEFZFBH.dCAGKABAhAAA.eBHDfAFBhAAAEBABBHHGLFFGhABA.SHFADEEAWDCB.bCCG....hACA......hADA...,2,-28,-5,23
MWNIaPbTSUVcfgZLOBEJFCQGdDReXAHKY,KHFEMECE....NAGA.IFBB.aBDEbEAE..UAACVBCAhAAA....fHCDhADAgBAFOAHHhAEAJFEEFHCACGAGQGGC.dEGDDAIDXFDBhAFAABHB.WCDAhAGA..SDAA,1,-25,-29,4
McWNOdAHYIXFfgRSJDCQZbTPeKaBUVLGE,HDEAXEGCFBGGREAHDCDHZABB....TEBFeEDDaGGGBHHA.LAHFhAAAMIFG.NCAG.AHDFIAEBhAAA.SBAFhABACHEDPABFVBEH...EGAF.hAGAcGBDdHAD...hAHAfEEG.,1,-4,-17,13
IVHMCaSBEebPKNcZATDGOLQXFfRgJdYUW,GDCAOFDDLHFEFGGHRAEF.dDAEUCAH..VCEHHCGFCGACBAEChAAAEEEEeHBG.KABANAIC.hABAAIAADFIF..QABEhAGAXEAD.fGBH..YAHHhAAAIFGA..hAHA...,1,-6,-32,26
AOHKIFPYCDXSTUeZJdQMRENLVbfWGBcag,KFEGFADFCHACDHBG....SABFUBDBeHEAZGFE..QAGChAAAMGEGRFBD.EFACVCEFhAAA..bBBDGAGAhAFABABCaDGAACDD...IFHHXCBD..hAGAdEEF.....hAIA...,1,-18,-22,4
AfYSZHOgQMbLPBTGJaDVWUXeCFRKIcdEN,SBGAZAFFOEBE.QGEBMIEG.LACETCAEGCEGhAAADEDHVBDFUACC.CFHGKGFGhABAIHAF.EAGAhAAAAHBCfAHEHBADPEFABEHBaDBDeGAEhABA......hAGA.FHGE.,1,3,-14,17
WMgLdFHAabOTeQJSNZKXVUfcYBEIDCPGR,OBBFQAFF.SBBDKGGBUGAB.....fDCAhAAABDADDGFFCDGGGFDHhABAMBFHLEDBdACCHCGDAFIHhAEA.TGAGeABENBIG.....XAFBhAAA..YBEFhAGA.,2,-35,-14,21
cXQHgACMEBTURFGVPafIOWDKYJbdSZLNe,MHAATGBAFCGG.GBCEaFCA...OFFDKBBFJEAB..dCAELEHFhAAAeCEH.XAEEhABAgAAECFFHBDCGhACA.RACB.fEGBDIFGSDGCcEADAAEG.hAHAEADG.....hAIA...,1,-12,-22,10
SZAETgfVGBUPIbFWYdHKaRLJDQCMOXecN,EAFBTCDC..VDBHGBGGBBAGUFGD...IADAhAAAFGADdEFAKFHFaAFDLABHhAFADDIFCHCG..MAACOHAEhAHAeHDGcFBG.SFEDgBDGhAEA...bAGB..hBBA...,2,-29,-3,26
JGaDBgHbSTWLOReFXYNZCKUAEIfQMPVdc,EDCGQGFH.MCIDPBCA.dCHAGDDDBCACHFFGTGCChAAAOFACFCBCXDAGhABANIBDZCED.CBFDKAGBAABCIAHGhAAAcFAE..DACESEAE.WGBAhADA..eBBE.hAEA..fFGB,2,-21,5,26
BagVFCKPASTXGYJbdefMZEOQDNHWIRULc,SFFATDEB.GCBDJAAA.dBEHMCDHOHEGDCHH.HEAFREADUGFAhADALAFC.BBBDhAAAaAEHFGDHPHBCACCD.hAFAbDFEeAGFEABG.NAIG......WFHBhAGA......hBAA...,1,7,-22,29
CBOSabcDVdTgMfNLJXWRUHQGAFYIKZePE,FHAEKHDCZACHeAFF..CHAEBHCDaEGC..DAEFdFFH..MDDBLBFGhAAAJHDC.RBAFHEAGABDF.hAAA.IGHEEDGESAEChABAVDAD..TCGEfGHA.hABA.WACFQDEDhAHA..,2,-36,-12,24
GYTVXUgDRMfLEebBQAWKNPdHCSOIZacJF,KCDCdCDCCBBEOBFAZCFF....aADAJABCGGAH..VGAC.hAAAUEFFDBGGMIFELEAAhAAAEEBGBFEDAHHD..hABANEEE.SGGE.ICACcBBC.hAEA......hAFA...,2,-36,-27,9
YgAWZVUHXKPECQcTOaNFJfLBMbSGRdeID,ZGBEHFCCKFGCCADH..QGFDODBE.FEEALABBBAFB.MIDChAAASBHHdEFC.DDEEhAAAAAIHUAEEXDAC.hADAECCCaCGEJHAG.fBBC...hAHA......hBAA...,2,-33,-16,17
AEIJGScRFbDdQfNOXZBgVWUaYePCHMKLT,JFCFSFHH.FDFAdCAA.QAFEOEECBADC.VBAHhAAAUCDE.eDFHHAEAMEHBhAAALDDFAFADEABA.IHABhABA.cGCHDCCHNEICZFDHaGGH.CADH..hACA..KAHB...hAGA...,1,-12,-19,7
JEPTRFeDUMGLVAcZKOYBQISfCNdHWgabX,ZAFAKGCBOCGDBCGDQCAH..fBCGCHCEHECCaGHFJEDAhAAA...EGAFPCCAhAAAFAEDDDAFGEAGLABDhADAAEHF.IAGFdACHgGFBTGGA..hABA......hADA...,1,-13,-22,9
UKbadCfYAQXDLSJRZEIgBOcVGTWMePFHN,XFDHSADBZAEAEBCDBCCH..OCGBGDEFMDEHFDABUAAEhADAaGGG.dHGFCHAHAAGHDIBALFCFhAAARFAC.IBABhABA..........hACA......hAFA...,1,-24,-33,9
cRBGKHUIJVYNQDTFSaZdXWMPgbOCELfAe,eCDFBEAGKGBFUABG..JGFE..VFAB.QEFDTDCBFDGAhAAASHDG.hABAaAEAdBEF.XFCEhACAMCFAgGGGCBBDEAHHADBH.cDGF..hAAA......hAHA...,1,-21,-38,17
PZHEBDAQNcbTGJUgXSCRFLYWeVfOaKIdM,QBCF..NCCDTDGCJEEGUFAH..XEBECBHDLAAFhACAeDBCOGDCKABEMHBEhAAAHFGHDFEEADID.bAEAgBEHhADAFGGA....WFADfDBAhAEA....hAFA...,2,-19,-17,2
NIgGKCWaURAeQFcMXVfTSOdJLPDHZEbBY,FHAEXGAD..TEDGSAGGdGFFLBBCDCAAHDCDEBFBbCFGhAAABAGH..IBDDhABAKEACCDDF.UFFGAIFAQDGAhAAAMIEAfGCEOFAE.JDAD..hACA......hADA...,2,-24,-10,14
PFeSfAJNgQXICUHEOKGVBMDTdLWYcbaZR,JFGBQFDE.CCBCHBFGEEABKBBHBAFGDEBA.LADF..hAAA...YEBDhABAaDFEPHCCeGFEACGD.NIEFXDEAhACAUBDA...ODHDMABCdAHEhAAAWHAAbFCC....hAFA.FGAHSAGE,2,-32,7,39
bUFWadMYcJELfNADCZPXGQOgeIRKBSTVH,DFECZFAEGDABOBBF.eFECRADB.BHBH..VGEEHADE.FAABaCHBhAAAMHEA..JFAFfDHGhACAABAD.CCCB.hADAXDDGIBHASBFB..hABA......hACA...,2,-41,-11,30
SDWVNITQAZeGLcKXOEMfCbagPFYRdBHJU,eCFFLDFDKCCG.XBCGEEAC..CBAA.aAADFEGF..dAGEJHCASEBGhAAA.DEAFhACANADB.IEGBABGEZFBE.hAAAOHDGMAIH.fHGF.gGBFhADA.PADEhAIABGHH.WDDB,2,-39,-12,27
gMbPFWJaKSHNOcXCETLdRVQAIZYGBUfDe,ZFBEBDBCUADDeFAG.MAAFFCFE...aDFGKHEE.HBAD.OEAEhAAAXBCA.TFFHhABARDDGAGAD...YAEChACA.DEEBgFGEWHCE.NBIECHBA.hADA......hAIA...,1,-26,-37,11
caUEfLeRTSFgQJAHPdYMOVWKIZXCGbBND,dFBCMEGBOBECKAGCZGCGGDDE.BBBBDFDAUBCFLDAA.eFHDhAAATBFDFACAQDGDhABAAHIDHEAD.PAFAhBAA..WBAF.....CHGA.NICB.hBIAaDDE.....hCAA...,1,-10,-30,20
NKVgfFOCAHGPbDZaIXEYUcedBRJMSWTQL,GBDBDCBDZCDB.aCBCEFBHUFAA..eFFDRDFD.MEAHSHEChAAA.QABFhACALAAAKGDHfDHEhAEAODGBACDBPEDBICHH..cAGABHHB.hABA......hACA...,1,0,-32,32
XZOKdbSJDFTgYWBAcHNPfIRQCeaELUVMG,HFBC..NEEA.fGEFQAFGCHBG.EGFDLADE.MIFGhAAAXFBBZCFFKCDFSCDFhAAADAIDFCBF.gCAGhABABGHEAFBEIEECRDGFaABE....hABA......hACA...,2,-20,-16,4
IUWGLPgOEfBJcTZQbaHNXVeYDMKAFRdSC,FFGAdCDFSHGACCBD.UAAFGADGLDAHOBHFBEEATFBHhAAAQGCD.hABAaCGFXGEH.hABAYAFHDGEAMAFEAHDGIACCWBHBEFHH.cGGHhAHA....hAIA...,2,-38,-16,22
efIXKbPTCaODAYFJgGHLESNBVRcMQWdZU,JBHHGDBCHAAELFFA.SADGBGCEVBEFRAAHQGDDhAAAdEGCZCAAUFAGIHAAhACAKHFG.PDECCFHEDFFF.hAAAABGH..YAFC.FCCANIABMAEE.hAEA......hBAA...,2,-18,-1,17
AfICRNUEPdTbKeVBOHGYZgaDJXFcSMWLQ,CHDBUACFdAFE.KDGGBACAGDCAZDED...DCGGFCHH..MBABQGFEhAAAABHG.RCAB.EGFF.hABA.TCCGeFAHHCEDhAAAaHAG.XGBH.SFGBhABA.fAFFhADA...,2,-31,-25,6
IGXWEMSJQfLRbPCBHKAgdZOFYDcNTeUVa,dHEDFBEGDCCB..NADB.eEEH..aDCCGBGC.EABGSBCAhAAAQGFHLFCChABARGAGCFDF.BHBHAFAC.gDGFhACAOAAH.cBFG....hAIA......hBAA...,2,-38,-23,15
eGACSHFNYXOZUVEQWadTKgPLIJRfDMcBb,HAEDFCBH.XBCGOEDDZDFCEEGF..aDDCKGBDLHBGRAFH.MABFhAAABGHBeAHBGAADhAAAAIHESEAFUFFE.hABAWFFDdFAB..........hACA......hADA...,1,-9,-27,18
JOQdBgTPIfWFKbNeCUXcYSZVEGMRHAaLD,aHFCLABF.OEEDdEACBGGH.TCEDPBEH...IFBAhAAAFBBDKFFCeCHBhAAACAGEUGGG..XECGhABASDGFEHBCMACEAEACJHCCfACHhAFAbADE.NBICZCCF...hAHA...,2,-23,-9,14
DSRVFHNLBgbIJYfAdWMUaXOPKcGeCQTZE,MDEGUCCFOFDFKHGGGGCH..eFAH.CEAFZFGHSCGEhAAA.VADCHADGBHBDhABAICGAJEFEAACDdDCC.hAAAaGAGPFFH.cBABEDADDBBHFHBE.LDFAhABA...hADA...,2,-18,-5,13
MLGZEIbeJQSCYUFOgcNdVXWfHRPDTBKAa,LEGHGDBCZEFBEDEHeBEG..QAAG.SBGChACACACGFAADgCCBhAAAdFCAXGAHHFDHDFIBBGFChADAaHBCMIEGIDABJAEB.OAFGNDIEfCGFhAEA....hAGA...,2,-13,-5,8
fEDeBIGMXYgOWHcZNaUPTAQSFRLVdKCJb,QGFBSBBFFDGHRDFBdCCF..KGBHCCAC...JBECEAECBGGFMFCAhAAA....XCCDhAAAgBFCOHDEhABAHDAAZEAANCIA.aAGAPABGAADB.LHAAhAHAfFEC.IHHDhACA.WDHB,1,-8,-25,17
CbaKfJDWEMAcLVRYTHOIQNFPXUdGBSZeg,VGAETGAB..HADHOAEFQDGE.FGFHXFEDhAAAdBBGBAGHZACDeCFCCHCHbDEAfDDGhAAADCBH.MFAGhABAAGGCcAGA........hABA......hACA...,1,-5,-30,25
RLJVQMFCAIcZfdPDWSGXEYgeObBUaTKNH,ZFGDdBCGDCGGSAGHGEBE..EGDHeCCGBDEGUGAE.KGDARFGBJAEGhAAAQAAC.FFFFhACAAGFH..ICAGhABA..PDFE.YADCODFG.bDBChAIANEAA......hBAA...,1,-17,-27,10
eRaYfTSVbHJEOLNcDKGBWIgQdPXACMFZU,FCEGUBECRFFE...aFGA..TGBD..VFEDJAEGLAAChAEADAAEBGCG...gDDGhAIAdDACAHBHCBBGZDEGeBBFhBBA.SHEGEDBAOAHFKDGG..IHHEhADA....hAEA...,1,-15,-36,21
bALFYaVXQOIDNecWBKdHfGgZESJCTRUPM,FCDHVFDDOFHF..DCGEeHBABCEBHAFCGABAZFEH..SAAEhADACFBARDDE.MCCHhAEAAAHHaGGCQDFBhAFA.IGAHWADEdBACEBDG.....hAAA......hABA...,1,-1,-38,37
gXBSCEAWJfKaTUNRYLVZQGebHFDMdcIOP,JAGFKFBAUBFH..RDEHLBCFZGBGGDBBHGFCDFFE.dFBA.OAAFhAAA..gBAGhAAABGDAEAEBAIECaGGH..hABA..NBIC...YADE...hACA......hADA...,1,-26,-30,4
WaILdAFBSQYMEGNbfTUDOPKgVcXRCeHJZ,BCBHSFDGMBADGEAB..fDBBUFGEOAGBKCHHVACBhAAARFDA.HEFGZBEFIHCAhAAAAGBCFGHDEAGGTBFAhABADAIB..cBCACEAF.....hACA......hAEA...,2,-21,-16,5
bKWfFGQHMPSCLdTAIZNegEDUOXcaRYBVJ,ZFGFeFCFEADCDIGA.UCCGOEDA..aBGBBHAF.JCBFKFFBFCGCGBAEhAAA.HFDBMCCAhAAASACGdAGDAHEG.hABANAIG...XFDGYFAF..WDADhACA......hADA...,2,-34,-14,20
VfeaZFgcWRbSADOJNXLUPGTKdQEYCIHBM,OBBGXCAGUBGFGDGA..KFFGdHCFEFBDCHADHBEF.MFAGhAAAeBABZABEFECG..gAGGhABARFDDSADEhAAAAGIFDECEJHFG.LHAG..PFFHhACA......hADA...,2,-17,-7,10
YfEdcCBZTIOSPHDAMVFaULXGgeWJRKNQb,FHDCaFDHLHCAGBCFeFHBRDED..KBAEQEEG..YBEChAAAEDBDCFABBACHZEGHODBDhABASDGCDACAMAFAhBDAUGADXAAF.JAEANBIE..fCCBhCAA..hCEA...,1,-6,-21,15
HJeVSRNWBIgLXOGPfaKAbZQdYFcETMDCU,QDEHdADAFDFH.EDAHDBHDHFFCeGACRBFGBGAGLEDHGABD.hAAAaCCCAIBGZCBF.TFGBhABACGDE...JAFHSHAAhAAA.NIDBIECGOCHDKCAD.hABA......hACA...,1,-10,-22,12
YUCDJEfNIHWRZOMSPbdeGAXLFVacBKgQT,XEDDVFBG.BEHFKBHD..QADCUGGBCFAA.DACD.JFFGEAEHhAAA....NIAB.ICCDhABAHCEHZBAFMHCGhACASGHHdCFGAHADaDAC.......hAAA......hABA...,2,-32,-24,8
AMEOcgaIUWSbLGCQDFTVZPNfHeBKRYdJX,EFBGOEFG..aGEEUDBF..SCBHGBAHDGCCFGABTAFFhAAAPADB..HGDChABABEFCKADCRAFBdBAGAGIFMIAGhACAgFGB.IDHFLAHBCEDF..hBAA......hBBA...,2,-16,-16,0
KZSgcLEFQPCOWDeHafdAVYRTJMXIbBNUG,VFBERAAG..JFBCMEHD..XCDHBAGCUACEZGDG..SFFEhAAALEFFFBHFCAFH.hACADCBFHBGH.aFAHAIHEIDDEhAAA..NEIA.KBFDEDAEOFAHhABA......hAFA...,2,-31,-17,14
NCOXGbETDcMJSZfRVBHdLQeKYaAWgUFIP,UDDBFDGD....PECECCAEOGCA.GBEBEGBGDDDE.MBCHhAAAJGFGZGAA..VAEChABABDBHdGHALAAGhABA.KAEEAEIFIHAF.XACBhAHA.cGDE..hAIA...,2,-32,-32,0
MEQdUNCASJWGKgXfTaYBFOVbILPRcZDHe,SGCBJCCEGEGG.KBCA....fACBTCABBFHAFGDE.hAAAVAFDLCBF.hAAAPAHDREFFDFEB.MAEAhABAdACBCAHBAEFD...WHEAXDFFaDDA..YFADhABAIGBH..hBAA...,1,-18,-28,10
ZCUSFBPfKeXDTbNVLOAQWYaJgMcdEIGHR,QGCAaDGC.MBAEEHFCGFCBHBGBRCCECGHCSGAD.hAAAFEBCPEBEKHCGXBDFhAAATGEC..NADB.OAEAhABAAGBGJCAB...cBBC.IFHDhACABFFBDAID....hABA...,1,-10,-12,2
RGOUaSeEYTFBIPLdVcAMQJNHZDgWbKCfX,QCADHEBCZGBADDAC....bDDAKFEBXGCDGABDUGGGhAAASBHHeCGHEAGFFGGABHFAhAAA.IGAHhABAdCECAAIFMEABgBFCCBAD.RABAaFBF..hACA......hAEA...,1,-8,-9,1
TSFPUcDIAgaQZLRKVCBbEdXGOYHNJMfeW,aDGELHAA.VFGHBDDH.EEAHdEDAOBDCHAEFMCAF.eBHDhAAASHCCFGEDUBBBhABAIGHCAFFC.ZFFFhAAACGBC.XBAD.YACEfEBBhACAWAHF.....hADAPFBC.,2,-24,0,24
SEHUQIbTLYcagKCGdBfeJVXRFZONPMDWA,SHFCUBFAQFCE..IACATGGGLBAFhAAAaBFACGCEdFGFBEBBeDBEXFAFhABAFHAAODFB.NBAG.DEGFhACA.AICCbFED.YCHBgCCEKBCG..hAAA......hABA...,2,-35,5,40
XEDbHGWIBNLKUSRYAaPJfeCOcVMTQgZFd,aEBGJECH...CDHF.OBEC..MGCEQABBZADEdABCEGHBDEHBGDEAhAAABEEFLHBAhAAAKHBGUGGBSDFHhADA.AGGFeCDA..TCAFFAHF..hACA.XAGA.hAEAWEAD.,1,-12,-37,25
FLEJXMUAfOeaNYcVTGbPBCHKISQZRgWDd,eCFAaBGC.....NBEA.VBBA.TDFHbEGF..BBAHKHAESFHDhAAAZEADRFCEDAFDFABAhAAAJFCC.UEACAIFAOHAEhAEA....YHDCcAGGCGFA..hAGA.ICCCWAFEdBAGhABA...,1,-13,-27,14
eYQWTUVgZbKHPSDCAFBaMGRfIdEcXONLJ,FFEEMABAGCCERFED.dDHAEGAE..OACEJDCC.eAFHQCGAhAAAUFACZAADHAEF.DGIFhAGAAHHEaHGCIAHG.hAAANBBG...WHCA.......hBAA......hBCA...,1,-17,-21,4
JEAbGRTUCIBPZfDYSgaFVdcLeHOXQKMWN,RAEATCFFCDBC..BFEAZAFGDFEE..SEHDaDDC.dAHALABChAAAHFAB.OHFEhAFAKECHMCGHNCIC.AEEEUABChAAAIHCB.fECEFHDA.eEGHhAGA.WCBFEGGB...hAEA...,2,-27,-15,12
PELDgQRYZcVAHCGSbITfXeWFKNBaUMdOJ,GFDBSEBF..bBFETECE.eBHDFDFGKFBBBBBFMACHhAAAJBDFLFFHDECERADF.hABAZEGFAFAHCAHFXCAGhAAA.aHAGOHEEEGDAYAFE...hADA......hAFA...,2,-26,1,27
PQZEaLFIdcWXRJHNYOABSUeVGKMfgDTCb,SFBDUFEFGCAAKCAEMBAE..DEBECHHG.QCGFZDECLCCHhAAAFDFHdGGH.XECEhAAAJBHFHGAC.OAFGhABAACDGBAEG.eHCA.fAGHgADBhACA......hBIA...,2,-24,-10,14
QEODZFLCXNBbTHeVPcfWIUMaRKYGAJgdS,dDCDQEBCDCACFFAC.LCDC.CHAHBDAFTFFDHEGF.eEEBhAAAVADA..fBBFhABAIHDFUDFFhAAAMIEEaAFAKBHH.ADHA...SABCEHCC.hACAOFHD...hADA...,2,-29,-13,16
FaXJYTfIAHOgQNVZUPKcWDeRMBSCLEdGb,HDFBOFBCQACBZCCAUFGD.KDDE.DFCCMIEEBBAF.CGCEdDABFBAD.hAAA.aHAEJAHH..TAFFhABAAAAC..NEIG.PBHDhACAeHDALFAF.EGBD...hADA......hAEA...,1,-10,-29,19
dAYFKSTRPUDOEbGMgBXNaVHLeJfQICcWZ,FDCEKHDERDDEUADF..EBDEGBAGBGAH...XCGBaGCG.HGAGhAAALAGBeGFAJDFHhABAfEAD.QAABhABAIAGBWHFAAAFBSFGADDIB.hACAMAID....hADA...,1,-10,-35,25
DQSXLPKRVYUHfANTbJIcWageZCEGdFBMO,TGGFJEDG....IGFBaCHBZBBGCDEDdCDFBAAH..MAHHhAAAOHAGQEBAhABALFBGKCADRAFFUDADAAID.hACA.NIDD...WFFFEGBDDBCH.SGADhADA.XEGEhAEAYACEfAFG,2,-31,-16,15
ZVYPHEFKWbOXAQDdGfTaCRMcJNgUIBSeL,DHFCdEHCGBEE.aFGHMECA.JAHHUEAEBFDHLACBZBCC.hAAAVGCEHFBF.EDADKBAGhAAAOFFCAEED..fAFBhABACAFH....cBAHIHABhAEASHEG.hAHA...,2,-33,-20,13
ALSPUcgXdZCDYfFMVKRabeIGHWNBEJQOT,SFDFUBFF..XGEEdABFZCDECEGEDBDHFFEEKFAE..RFAB.aEEEhAAAeBCA..HGAChABABHGCECAF.OEBAhACALAHH...cAFF...YAAFhAEAMEIF...hADA...,1,-22,-31,9
GcUFaNPRTIKQBYgfJOZbdHSCXLDAMEWVe,EHDAeAAAGEDFUBGHFFFH..aBGERFCF.KAEFBEEF....fGBDhAAAZADBdEHGCDBHDGAGhAAAAIGCMABB...cDCBhACA...PAFAIHAGgGGEhADA....hBAA...,1,-25,-39,14
NWceRBJTLMVZXHEFOgUbaPCSQAGfKdIYD,KDGCdCDFDGAF....NCCH.eEDFRFBD.BCGBLFFBMBAGZEBDEAHD.hAAAFAFAUDBB..aGDDhAAASACC.hABAABAAGEDGICAD..WFADJFFF...hACA......hADA...,1,-23,-36,13
MbeKcFCNJLISTVfAUdgHYDQXORBZaPEGW,dCAGHBFEQEGCRDDBBDAGZFADEGFD..MEIFKCCDCHDBLHDE.hAAASBCDfBFAhABAAGAF.UGABDAFGOFGFhAAAaDEHGABF.eAFEcDGG.FBAFIHHHhACA....hAEA...,2,-13,-11,2
bIFJYHEdXVKPafgOTBMQURGADScWeZNCL,DIDASFEGeDDDZABDCADF.LEEB.FAFFJAFG.EHCCdEBCKBBG.hAAA.aCHHOHFABGHHMBAHhABARCFCAAAC....hAEANCAC.IAHGHEBFXBEGfCFG.hACA......hAFA...,1,-20,-27,7
IBGWRdPOcYfKSJAeMEFbXULgCHTNQZDaV,MHEAFEDAUFAFLADEHDGD.QEDGDADD.aCGBBCED.RCACdGFAhAAAOCBG.fEBGhAAAKBFGAHBF.eDHFhABAEGDD............hACA......hAHA...,1,-25,-38,13
bRKNFSEdTUYZfLMGXIPVegCOQBHDWJAac,aFGARFCDKGFC..FBGCEAACdCDE..UCCDZDFGMDBFGDAE....hAAAXGDAIHHAeBAChAAACAHFBCHDDHGGAADA..hABA..bADCSHAGfEFF..LAFFhACA...hAEA...,1,-17,-33,16
PcTYCOMJVBWFIdbDfNZXUERLAeKGgSHaQ,eCDHGEDCHEADaCGG.QABA.TDGFYABB.CFHBMADHhAAABFDHIGHEhAAA.DHCAfDEBhABAXAEBEFFDACEGKGAFPAHFcGFG.OAEEhAEA..WHAGFFAA.hAFA...,1,0,-22,22
aVLUbSNKWgZQTfcEYAGPCHeRdOBIDMJFX,GDBGCCEFHBABdACFBAFGDFDCMCAD..JGAAXEFF.aABBVGFAhAAA.LAHHhABAUGDHSGHBKEGAZBFB.hAFAfBEE.EAGEAIECeCCH..hAGAIDDG..hAAA...,2,-33,-13,20
VRFPOYHJAafUgIBZXcTLGdNbeQKCEMSWD,aCHBUBFDBBBFZDFE....TABGLDDEdGGF.eBFCKEAD.EACGMECFhAAADFBFREED..ODDFhABAJHFEAIDA...IHADhADAXEGA.NECA.CCDFSGDD.hAAA.WAFC...hAEA...,1,-22,-32,10
IDTcKMXgZYVCEWOHeGFRaPSJAUfQBbLdN,UFAHBBBBdBDBDIEE.KFGG..MAEFZDEE..CAHC.ODBCHGAEFDABRBAC.hAAA....SGDEhAAAfGFD.QDGAhABA.bBFCNIDHIECE.hACA.XGDG.hABA...,1,-24,-45,21
McVdITYBFfObESQPJDaZHGRCeLgKNXWAU,UGEDVDAG.dACC....IGEHBHBAFAHDODFCEBEC.QAAGhACADGDBZDDC.HADHhADACDBD.eAGDKCFA.NFDDAHBF.hAAAMAIB..TFACfGGH.bFAChAFASBAF.hAHA...,2,-42,-9,33
gRbWEOHISCMKDZdGYVcALfTBNeFQUXaPJ,TCEGBGEBFEBA.UAABaAGA....JHBAREFD..EGBCOBDG.hABASEHFKBGDDDIFZBDFhADAdACC...VEAGhAAAAHDHLHEGeEFHXBAD....hABAbAEBIHHCCAHB.hBHAMEED.,1,-21,-27,6
YQDbUfIOdJHKCZXBEPFRgVTAMLSWcaGeN,MHCGSEAC..aAAFeHCEQECFUAGEOEDAHAFBCFGGXEGHhAAABCBHEACCFCBERFAH.hACA..TADEAIGCcADEhAHANGBFDIBA..fDEBIABG.KGHBZCFAhADA......hAFA...,1,-5,-13,8
eagNDdFBGfObSUHKCZTXRPMWYAIQJLVcE,QFFDJFAHLBAGEAAD..eCDF..NCICFDCBBFFF.ODGFhAAASHAGHGCCZAEFhABARBEBMAFAAAIH..IHHEhACAaCGDDEADdACC.fGBFKEBBCDAD.TEDBhABA.WHFA.hADA...,1,-4,-22,18
MYAGBbJgKEDQceVZOPXFWfIUHCaTNSLRd,GAFEJAAC.KHEEQBFGeABFZACB.OGACFECF....IHHBhAAACGFCaECG.SBEFhABA.LBHHhAFAdHEHAEADBFEFEFFEDHACPDGF.fBDAhADA....hAEA...,1,-12,-44,32
QcPYFTWISaMbDUBegXdCZNVfRKLHAJOEG,OAADGGCFQBBC..cCEBFFGFTAFG.SADBhAAAMFIFDEGBeHDGhAAAdFAECEECZCFANADH..fECDhACA.RFBFKAHBADDA...ECCCWBADhABAaFGDBFEH..hBAA...,2,-24,-10,14
KWDVRXATZULafESeCQcONYIJGMbFHdBPg,ZAAALDAFEDAH.CEGF.OGEC..NIBD.JEECGCDG.FBCDBFBGhABAKCFG.DAGD.XADBhACATEBE..aFGEeDDDhAHAQAAB.IHHFMIEGdBHGPAHFhABA...WHAChADAAGDD.SFFD,2,-31,-9,22
XIMdHDbaCWUVFNJRBETgYZQfGLAKecSOP,KDHHeADBOHAA..PGEEMBBGdCDDHBBH.aCGGUCAD.FHDEhAAARFBGBEFE.ECADTFGBhABAZAFE.GECHhACAAIDCSHGAIAFDDAEACBGA......hAAA......hABA...,2,-18,-16,2
BKAaRDgHIMbLFPZVdWfOcQUeCYGSEXTNJ,RCDBDDHDHCFEMEEFFAEEZFAEdGGH...OHCCQAECUABE.eGFGhAAACFCD.GCAB..hABASDBFEHBA.hACATEGHBFHAAIDCIBHB....hAAA..PCFF.hAEAWBHB.,1,-18,-29,11
XYANMVWZIKFLcCHaDBESgUbeQJTPdfOGR,MCIBVBDD.ZGCG.FAFECDFHHGCE.BFBBSBDHUAAB.eBAAhAAAJEGB.dCFD.GDAAhABAXGAHAGGD..IEEChACAKAHFaAEA.DGIB.EDCBbDAG.....hADA......hAEA...,1,-18,-22,4
DBLeJRSbEFXWaPcdOMKYZTfUVAHQIgCNG,QBEHCCGHGADFLFECJDAH..RGECEDDBFCBH..aGGHdBHCKHAGZAAEhAAA.UGABAAAAHGCA.hABA.IEGHNDAA.hACADDFHBBBESDCDWDFA....cDDGhADAMEID....hAEA...,1,-10,-26,16
UQgGRZWSbcXPCEafAVTHKMIYeBLNJDOFd,VCEFTFCH..KECFMAFG..eABGLDAEDFBHFAFCQABDhAAARGCC.SBFEhABAXGGA.CFHGaGFBAHABHDGBhAAABCEFODAGgEAH.WEEC.hADA......hAEA...,2,-23,-8,15
FeOHIXcSTEUZDWJYRgQAaBMPfCGNbLdVK,aACCMAFB..CHFCGDDALEEF.dBGFFGAFODCBHAFC..XBAGhAAATACBZDGB.JEADhAAAgGCDAGIB.hABAfCFDNIEDKCAEeDFHSEAGDIAA.hACAYFGHBHCE..hABA...,2,-26,-5,21
ZPIFEHYcBLSCJUTaVfRKgMbQdGANDeWXO,DDBCeHCEOEEEZDFCFDBAHEAHBBCFLBAA.CHBH.UBGC.aFFHhAAAfCED.hABAKADCMFBCdAGBAIEGNAEF.XFGEhAAAEHGA.SCGB...hACA......hADA...,1,-18,-34,16
NTVIEAgYXcPCRSZdeOJUBGafFDKWHMLbQ,XFCCCCBARACG.ZBABeAEE.UGEAGAGC.aDFFDDGDKFFDHDCAhAAAMCCGLEHD.hAAAQGCCNACH.hABAICHEAIEC...YBADSDDBhAIA.dGHGBHAD.hBAA...,2,-21,-14,7
HdKFPXVAJITYROLUNGESWgBZeaCbcQMfD,JGACTCEG..RCECLBCEGDACEGEB.SADEBCACeEEDaGHFhAAACHGB...QAGChABAMBIHDAFA.KCCDFDADPEFChACAAIFA.YBBCOFFG.NIAB...WDCBhAAA.....hAIA...,2,-34,-3,31
gCRKYbXEWFPBMOZADHUIVdNLfaGceJSQT,UDGCdAAHLHEAGCEGeGBCSCCC.QDFGCAAEKAFA.hACAXADEFGGGMIBCAAGEDEEBhABAHCBG..IBHChADANFADaAHD.JEAAgACCYFHHEGBH.hAFABDHE....hAEA...,1,-7,-20,13
ZPMLGFOcSBHEJfbUDNTgYQCXaWVeRAdIK,dGCBZDCHMBBDFDDD..SCBFEGAD..JADCUCFHDECF...hAAATFGGQGFFhABAaGAB.eEFEAABB.KBGHPACAhAAAOCCABBFB.......hACAfGFENAIECEEG.hAGA...,2,-33,-23,10
CLSPNFeacgXQMZdYTEUOAKDVBbJRHGWIf,DDIBBEFFRGDCGDAE..fAACCCGC.SHGGhAAAFADGaGGF.XCEGQCCChAAAdAFAECAAAABCKEFAbFBH.hAGAJEHD...IAHC.NCDGcDAEhACAMIAA.....hAHA...,2,-35,-13,22
efUcBHaRDKCTJIWXSMOgZLYbGEFVAPQNd,QABGeEABUDEAHFCHaDCH.DAAEKGEC.CAHE.JEHF....ICGFhAAAXGEASEFEhADAOABELAHHhAEAYEADEDCE.ACCA.PBDF.dHBDBAGGhAFAWEHHMCEA...hAEA...,2,-35,-7,28
dGfZKEHCYIbePXMTRUFNgcOBJLWaDQVSA,dEGCGBDBKAFDHECH.CEEB.IGFB.eEBHPBAHMEEBUAGAhAAAFBAA....NICDODHDhAAALFHHDFABSBBBhABAfDAFZEADEDGFXGDH.hABA......hACA...,1,-13,-22,9
KdLcHZUDaYAESbRPgMOTeVIBNFWQfGCJX,SHDARBDFMGDG.OFGFeHBABFBB.FCAFQEDChAAAGBGECAFC.KCDGLAAEhAEAHABCDGAFACCE.EAFE.PBHFhABAgGFAIEAENEIG.WCCD.XGCGhACA....hAEA...,2,-18,-15,3
IGSLRJNKVafFZXTdeCWBOgADUQYHEPMcb,DAIHQDCEEDDG.MFFC..IACDSGHFLCGHhAAARFAFKCAB.VEBEFACATAFBhAAAeGECCHAEBCCFACDA.HAEEhABAcGDB.bCFENIEF..aEAH..fABEhAFA...hAEA...,2,-17,-8,9
VDOUZdgQMcJRHXBTEAbFfWYNKGPaILCSe,FACA..fAFH..WDEFKHGGaCGECFGB.eCECDFBGUGGBhAAAZEBDQABEhAAA.JGEEXCGBhABAEEABAEGANIBB.IAHDLEFAVGAG.dCBBcBAChABABAFE....YFEBhBAA,2,-31,-13,18
GHVcZBFIXWUCgJKTPRYNbQedSLDEfMaAO,HCFHZBBEFFBFXACCUDDE.CEAB.KAGA..TDCDRGFG...bFBAhAAAdDHGLHFEDEAA.hAAAEAHDMFAB.AACF.OADAhABA......cGCEBHCF.hAIA.WFFA...hABA...,1,0,-46,46
ORFZWDVbEadXHGAQITLecPgMJfSCYNUBK,QBFCLAEBeDAC..PCCGJFGBCAGG.UEGGBAAAKEEHRECB.FEBAhAAA.DHACEHDC.dCGFXCAGhABAACAH.IHDFhACATEEF..MFIBYFAA.OABEhAEA.....hAAA...,1,-11,-31,20
bgdEOGHPDCVfRaUJZMIFXYAQeSKLTNWcB,QGCGSDBHLAGH.TEEDcGEA.BBGHbFCH.hAAAdDAHGACEDDFCCAHBRAAEaHGEhABAUFAAMHEE.FGBBAHIDKEEChAAANEAC.EBDH.........hACA......hAEA...,2,-21,-7,14
UGTEFQCaZbVOgeXHRASdJPDBIcNWKfMYL,dBDHDDDABGBF..NCIE.KHBA..MEFDLEFHGCAHEBAHCHHCZBGBhAAA..OBEE.hABAXDCGAFDCPEBB.hAAAIGDCfAGD...YDHHhABA.FGDGaAGB..hACA...,2,-32,-31,1
XQWIMTAGYLEPSgKRdUNFDBOVbfaHCcZJe,LBAEEGGE.SFFERBDGUGBAFCBCBFCE.OFDDVDFA.aBHBhAAACDAD..ZEDF..JEABhABAQAGEMCIBGCADhACA.PHACKAAFDIGEfGGG.hABAHAED....hADA...,1,-11,-21,10
gPUYTZcGVFXLIDQHKeCRbJWMOaEfASNBd,SCEDBHFDdAAFUFEDZAFCGAAD.FHCGLCDADGFB.KEEEhADACHGAREADJCHB..MCDHhAAAOBBHECFE..ADAC..hAEA..PEFCTFBH.XAFG.hABAIHHB..hAGA.eHAGaGGA,1,-11,-27,16
gPUSCdacHOZGKLAXbBQNRMIfYDTFEeWVJ,BGHDQDBAMCDD...IGHFDBFHFGAC.eHCC..JACEUDGGhAAACCGE.dABBHGDAOCCAhAEAKBADAFFAXAGAhAFA.NGADRDEHfDGE....EHAAhAGA......hAHA...,2,-48,-5,43
UKMQBZYJdHPNFVCLcTGOeaXRDSWAIgbEf,..IGEHEGFDKDAEQEBAZEAF.dHABPAHFFACA.CAFGLCDGhAAATEDF.ODHHhABAXAACDIEGSCAGhACAAEHAfAFFBBBFJBGB.HECE.cGGChADAaCCAgGGBhABA...,1,-11,-24,13
WQLROMFVfJKZdUbYNGaPCBXDegTIEScHA,QFGDLAFAMFCAFBHF...JBDBdCADUGAA..NBCDaCGHBCBAhAAA.DGFAeFAE.IAAHhACAEDHHHGCEAHDGRDCGOABAhAGAKGAG..........hAHA......hBAA...,1,-19,-29,10
YJBWNfUCgSVGIcTMLdZPEDaHebFAROQKX,OBHHKDFH..XCACBGDG..fBAECGCE.SEFBhAAA.IAEChABATBCEMBIF.hACAdGGHEDCADAFFeFHFABGDQGAHJEEHNIAD.gEDEhAAAcDAHZAFB.hABAaCCGFHDE.,1,-10,-42,32
fdKIMNZRVbWTaFHDgYLSEQAUXCcJGPeOB,CBBEJCGBGGEH..eAEHOCFHBHHCKECEMGAAZFAF...RCAG.VAGBhAAA..TFEGhAAAFCABDGDGLHAA.hABASABGADIH.......hACA......hADA...,2,-33,-33,0
ITYSdAZVKRaXOcQEWHeBPLNMJFCbGgfUD,ZCCHVABDaFFG..OBFDEGHH..HCADeHDALBGH.MGAChAAAJAHHFECCCHAGGAEAhABAfEHCIACHSBEFhAAAAAEDXGDDQEECBGGC.bFAHDCIFhAGAYBAF..hABA...,1,8,-29,37
fQUNgVLdcYGAKMJBFaeSZPbOCDXEHIRWT,MCCCBABGFBGG..aDDFZGEE.OBCDDBAAEHFEHCEA..IHDGhAAAREAG..TGADhAAAQDAHUEED.gBFBhABA.dFFHcAEBAAIHKFABSDGAhACACCADfDHANADD..hACA...,1,-16,-30,14
DEVRMTIFPYNHbACaeZGOJUQLXdgBfWSKc,eCEGGFEBUAGCQBGCdGBHBGFHSACC.DFACEEFGMIEGhAAATACBFBAFPDDHhABA.HGAGCAAGaDDHOBEDhAFAXEAC.fHGH.KCAGhABA......hACA...,2,-33,3,36
DacegBUVALHbMENPfKZCTSGRdWXOFYQJI,HFAEMBBC.EBDB....fGEDZBAHSDHDRCFCdEFHOFBFhAAAQFEDDAFDaCDFeAFChAAABDAHAHHDbCFF.NICHCEEF.hABA.....WEHH.XAGAhACA...FGAH..hADA.JCCH.,1,-4,-20,16
BNKUYAbMQREeIVagfSZdOPCDTGHcWXJFL,QCAHeCAG.aCCFSDEE.OAFECEGBDACATGGBhAAAGECCHFFF.WEAFhAAAJGACFAHDLCHHhABAKHDAACFBMFBAIADAfFEHZFAB.dBEF.hACA......hAFA...,2,-20,-8,12
EOUMZRGbHSIKTWaYCLQJcXDNefVBAdgPF,dBHCFGDAOCAFMABBRGAC.GCFAHEFH..SADHKGAH.aCEDCCHEQDDAhAAA.hAAAXACEDBGFeDBFfGHEhABABHEBAGIBEACFZAFE.ICCD.hACAWHDA..LDDDhAFA.,2,-15,-14,1
MVLXDfPJCHFBEOedYWRGNAUIcgQaSKTZb,UDEF..IHCCQGGFSEDEKCAFZDBD.VABELHCAhAAADGAC.JAFDCGEGBHGGhAAAOBHHdBFD.RDGBADDCaBBEMAFGhABA...fEADFABGYFAF.hAEA......hBAA...,1,-16,-29,13
TDJUSdLZebQaAFWGOKHYEIgcBMPVCfRNX,GFDDOHFAKDAFEGAA....ICDFBBABVEBDCHHA..fDBEhAAAREEG.XAEEhABADAIDSGEDhAAAdHCFeACFaCDCAEADFDEE..WACE...YAGDhABAMBID...hACA...,1,-15,-36,21
XYVCWdILQbScMZHJagUBGAeEFKNRPOTfD,eFFAFEEFKEBBRCAH..OBGDDBGD....XBDGCACDdGBALDDFhAAA.SADHhABAMCIFJFHHUAACAAHAEEEG..hADANIDH.TGAA..fAFA.hAEA.WEGF.bAGF.hADA..cFDH,1,-24,-35,11
QTgYSCOMJNReIZEfdcAWLFHDKPUXBbaGV,LEGDFHFCHCACKDFFUGCDBAFCGCDH.QCAGTGCF.SADEhAAAMBAAREAGZBGHEEBAhABAdFGDAIAE.DAAC..PBBAhACAaEDF...YFHHCAHEOAEHeBHBhAGA.fEEEhAHA...,2,-11,-10,1
cXdPfSEHYLVBOgFeQUaIWRbMNZTDJGAKC,KGAFCGFCdBGA..SHGCEFCE.LFDEBFAEOBAFeCDAaHDAhAAARDDC.MCIDZADDDIDCJBBAABAHhABA....PEHHhAAAfADDHGAG.VCAB.FCGD...hABA......hACA...,1,-7,-30,23
AQIdTMNYaCRWcKeXfbJELDVGPZHOSFgBU,QBFCTDDF.MEFBaCBC..RBGFKFBCeBBG...XDBChAAAbFGDLAACDGAAPHBChABAOAEDSACEhAFABGFBAEIFNIAH.CFCBfEHC.EAHB..hAGA......hAIA...,1,-16,-18,2
aTJBOFQCWRMKUIGXNfZSDLEPYgdeHbVAc,TBBGJCFFBBDE..QEFERFBE.MBFAKDACUAGGGDBH.hAAAXFCEZFFGDACH.PCFGhAAA.dFACeFADhABAbADBAIHEOHEE..CHFGNIAFSDDDhADA.EAEE....hBAA...,1,10,-36,46
ZSCFaLcGUTHdMfOJVIKBDNePXgEWYQAbR,RDFHSGCGCCDD.LAAAUAEBdFDAOEEE..IABChAAADIECeCFC..XDAFhADAEFHHQCCDhABA.ABHAFAEAcFAE.HFGBJCAFBECANAIE.hAFA.WHCAYHAAhACA...,2,-24,-20,4
PcAQJLVGYRTCSdbaIfKgeEZUHDXBNOWMF,LEFCVFCE.GFABRACC.CAAB.dGGFaBFEKHAC.ECEAUBCH.DFGFhACAXDABBHHHOAEGhADAFEEAAEIB.....hAAAJHDCSBGH.IBADfDDGhAIA.....hABA...,1,-24,-34,10
CURQJedaHBWIEDbZFKMgVXAOPTfYSNLcG,TCCCSEAH.LFDGGCAECHCHUCDAJEEH.eCHHHAGDBDBEhAAAEDGDDGGEFBAEKGBH.MAFChABAgADD.hACAADFHOFAH.fABG.NIED.hAAA......hACA...,1,-14,-28,14
HMAKPWQcbgdYEIXRSVLBDNeCGZFaJfUTO,KFHHQGEH..gCFEECHBREDCLBDADABG.CGAGFBBHaGFCUECDhAAA..OEAAhAAAACBA.PADAbGAAdAEHhAFAXGGFBCDHNIEH.eHAA.....hAHA......hAIA...,2,-31,-5,26
SLZWDQOfYBeHPcEbKGFRJUaXAdCNVgTMI,dFGHVGBAMHEC.LEBHDBFE..QAAGOABBBFAGHEAAhACAEBFHKGEEGCDGFBDFJEFAhADAaHBEAGID...CAHCTDGBhAAAIHGAZACBfCCE...hACAeAHH....hAEA...,1,-5,-25,20
RcVIFfJeWKQTBdLObaNSGgPHEUDACZMYX,ZCFEMBBERADE...VEGHFFAEeHCC.KFFCBAGG.OGCA.hAAAaCDBNBAE.GCAGHBBBDFIHhABACHAC...XEDDhACAfCHG.WACE.dCFGSHAChADA.EHGGAHIB..hAFA...,1,-20,-22,2
QgIdLPHaJTOXSAMeKRNBFfZGCEUDVcbYW,MDDCKEBBBDGCZECBGADHUBBD..DGFBVEAH.....bAAFhADAQEDF.hAEAIAGBdEHAHEFHaAABhACAOAHD.AHHA.eAEBFFEHCCCCEEHB.cGGFhADA...WFADhAFA...,1,4,-51,55
FeTDGcBWRbIXSQdgCYHPKfLMOUNZAaVJE,VBBEEFGFFCAD..DGDHBACG.RCEG...XGGBQAFBCBGEHEABhAAAKDHBLDCHhAAAUDEFAFHC.eHCA.TGAFhABAWAFE...IFEFdHEF....hADA......hAEA...,2,-30,-22,8
BCcQWgRGYDTIeXdMaHfOFSbUNEAPKZJLV,KBAFJAFHBGGFCHCA..QBGHRFDF.DBEDeFHH.dCACMCFBhAAAHCBDFHEEUDFD.AAAD.hABALDBH..hABA.cFGAWAHB...YEADIGAEhACA..fHAHhACASECHEBBE,1,-27,-38,11
aJXANeIPLHEfBZGbOSTYUgRCQVWDMcdKF,eCHBLDBDHABAEECABHHGGBCDSGDCUFGBRFDB.CCFC..QGAAhAAADAACMCHHKAFGaFFFAFHBhABA....NDAA.fECFhADA..OHACYAFA.hADA......hAEA...,1,-12,-20,8
WKXMUgfNOREACbHPGIeLcQdSFJZYDBTaV,CBGBHBACGCDBeFCCLAAFdDACSCFHZGFABDHHaHEE..VGAChACAXBGB.MABChAAAfDCEOCHDAEBEIAEAhADAFGAHDFHDKDDCUEEH......hAGA......hAHA...,2,-22,0,22
FHROEIMVCKcbZgNQdUDGeLfWaSJYBATPX,TDGAFGCDHBBA.RBGD.OAEBMHFC..CEHA.KDBHZDBGQGABhAAA.dGGE.UABADABAeAEAhAAAfFDAaFAHSFGGhAEABBGAAFFGXDDGIFEG..cGDDhAFA....hAGA...,2,-24,-18,6
BWOXTNPcCLbEUadgJfAQFHGYeSKIMVRZD,HBEGGCBBSFFAKEHBMBCA.ZCABBGCBXGAA..NEGG.CFDFLAAGhABAUBGD.dHDHhACAJEABAIAGFDEF.YAEEhAIAeFEBIAAB.DIAGWEHB..hBHA......hBIA...,1,-9,-31,22
QHAIJBVTdgFeLZfCYPaObMGURcSNEXKWD,JABFBGGG.dCACFDEGLCEAZAFA..CFCD.aBDB..OADHMAAGUGAChAEA..SHEAhAAAEGCAKEHF.DAGGAAHHTEEDhAFAeEFC..fFGHbCBH.RGCC.hACANIEB.XEAF.hAGA...,2,-31,-23,8
VCBMPbWODaZAFRgJSeUGYNLQXIcTEHKdf,RCBDJFBHeABAGACHLBGD..QEGBXFFH.TEDGhAAAKFDHdFAECCCABCFCMIFA..hABA.PCABOBEB.hACADAAAAGAHFHDESAGEUGGH.YCHHhAFA......hBAA...,2,-19,-9,10
fYCWKXLERSNIDOVQZaAcJeFdMPUgTbGBH,eFEAFBDHdEFEUBCC..TEBABFABHAGB.CHHC.KHCELECEhAAAEDACRAFH.SHEAhABADHGCOAHDQFCAhACA.AAGBMBBBPFAH.gAAAhAAA.fFDFhABA.WHFG.,1,-12,-22,10
FOJRBbCTLDKQHYANSgUXedEfVWZaMGPIc,SCEEXCDF.dGBFEBFG...VDFGaDEBMAAGGCAG..hAAAIGGHOHBC.BDBHhAEACFHADDDDKBBAQFDAhABAAFIFNIDB.eACFWAHBcAGARDFC...hAFA......hAGA...,2,-33,0,33
NcdXfOWDBeYVAGQPIJRLSgTEaKUZbFCHM,QADFJAFCLEAASHEE.EBABaDDF.ZBAECDFCMEDDhAAAdGEGODGDDCIB.BABChAAAeCGHADGB.IGBDhABA.RFGB.KGGFFAGANCIA.fCCD.YEADhACA...hADA...,1,-2,-38,36
TDUKdfSNaBXLWeHPgYCJVAGcIZQROMbEF,GEDCZECBQBAHRBAAODHDEBGA..FCDEDGEEKGBBdBEC..SGFAhAAANEIG.aEBGXGADhAAA.eDBBhABAPBGBCEFFAGHHMEAD.......hABA......hACA...,2,-32,-14,18
FCHYTIGMcPBSEZJVAWOXfNaKUgQbDdeRL,OECFXCAG..aCACKDED.UFDHQAGHdAGCLAAECFEETBCFhAAAMFBF..BAEChABASBBGECEFJEHHAIEGNIDB.hAEADIAA.FGAG.HGEGIEHB.cCEAhAFA.....hACA...,1,-14,-22,8
LcbJFZVWNMPUaSTGYCQDfHeKAgEdBOXIR,dDGDBHHCOAFCRDEHLABB..JBCHZEAF..VFCCMDIBUFFAhAAATADC..CCEDDICAhABAHFCD.AHAFEAGG.IHFAhAAAFFAB.PCFGSADC..hACA......hAHA...,2,-38,-10,28
EXDcdQBARCgSFOTbHYPGWNeZMKfJIaUVL,CGCEFDAG.OCFHHBCCGCAE.eDFFKFHBJAFAaFDFLFHBhAAA.DAIDdBCDAGGDSGADhABATCGD..PFBBhAAANACBMBHB..IHFD.EEDB.hAHAXGCDBDDG..hABA...,1,-1,-44,43
VGZYSgbPTHBfcLFCKaNMIXROEDWUJAdQe,dDAGeDGFGDDEZCDH.SAGE..gEAGTGFEHCGFhAAABFHELBCChABAKAGDMHAAIHBCXCBGhAAAEDCFDACB.UGDCAFIF.......hACA......hADA...,1,-11,-26,15
BbUCRZcHWQGeAMPSdFNXVDYIEgJfTKLOa,SFAEFFHH..XDFBDAGGEAAH.JDDFKFGBLDBDBBGBCHEBZDEDhAAAHAEE.QGCDhAAAACIDdAEC..NEIA.YBBAhABA.IHAFfCBAOFFHhACAaDDD......hADA...,2,-34,-20,14
HaRLKUeEdXNIGJBVPZYFQOcDTWgCSbMfA,aGCEKFDHeADF.dBGDICEABHDG.ZBACQAADDGID..hAAATAGGCHFE.MEBDhAAAAAFFLDEAUDGGNICD.JDAChACA...PFFCFADE..cFEASGAAhADA....hAGA...,1,-21,-28,7
cBGVCPSgEAXMeRDZHUbfJOIYQKNaTWFLd,MEAEeBEHDEBDHBCCUGDBJCFG....OAAAQCBEKEHF.TAGGhAAALFAH.BGEChAEACACHSGGBhABAADIF.XDFEZEFHIAGHaAEBdGAD...hAFA......hAIA...,2,-29,-15,14
NRcIBPfQCXGUdeTDFJbLgSWKAHMaZVOEY,aHDAOCDA..EBBGRDBDBGEF..QDAACHCFUFFC.dBHADEFAhAAAbADFLABE.hAAA.SGHHhABAKBHFMFAH.YEFE.IGBBfDDEhAFAeAFC.FFGD...hAGA..WDDD,1,-6,-43,37
BTCgWAdIFRceXJSNQaYUMDPOKLVHZEbfG,FFDBeDFE..SFHFQEBEUFABDFECKCAEHABBZGBCEGEFGADGhAAABDAECAAGAAFF..IGGAhABARCEEJAEE..aGFDPAHFhACALBHH.fEEDWHAG..hABA......hADA...,1,-14,-15,1
gPZKbCNQVfIXSYeTUaFJGdOWEHABMDRLc,DEGGLAGF..PEBDZAABCHGHQFFG..VGFEhAAAIDDESEDAhABAeEBHaAEDJCCCdAHE.EACChACABFEGMAGDgACHKHDA.NAICfHCDhAAAYFAF...hAFA...,2,-31,-13,18
SNLBFEZfOPTAXabKDcgRWHCMIJYQUdGVe,XABAKBADDFDE.RAED.CHAC...MIEA..JFHFUEGGGCEBeEEFhAAALECDBAGFZEAAOAEChAAAAGFHaCAG....hABAgBGHICCCdGFC.SDAHhACAECDF.....hABA...,1,-18,-32,14
IEQeDWHfNJYCSBgALdUXPROMVTbZFcKGa,UGFHXFFFRABF..MFEG..VAEAZBFGFHBGGBAB.IGDAhAAAEEAG.DHAAHDCAhAAAJDEE.CGAFBHDHAIBGLEAChABAdAFHOADD.......cDGFhABAaFHD....hADA...,2,-20,-17,3
GHYJAgMeINEcSLKWVOCUDXFPdabfQRBZT,MIBGeCCFECGDLBDFKHAA.OFFDDADEFDEFdFCB...aAHFQBAChAAABAFHGCEHJGECAFBHhABAIDAD.SBAChAAACAHBPFCF.fEHARAEC..hABA......hACA...,2,-24,-20,4
fKBZbGIgHJEACPQMeDFUXdVNOWcSYLTRa,QBAGeDCEDHGEUAGDdGFEOBEH..SADALDCHTAGHhAAAaHCEBDGHbEAFGEAGhAAAHCFFAIDGMFDGFACFNCIAhABA....cBAEYFHF...hABA.KFGG....hACA...,1,11,-31,42
SBEOINaPYCMFGgRVfTWQAZKXLeJbHUdDc,KFFBLAACeEAHHAFAdGEBDHAEBBDC.EDGDIBEA..aEHDhAAACFHEFBGFGDDC.RCBD.hABATCBFABBCJHAE.UDEDhAEAOHDE..NIBHMGAA...fHGFhAFAWCAF...hACA...,1,-13,-26,13
REBYeQIUbFdMNJDgLSZGAWXcVTCfPKaOH,XEGBVFDD..CBCH.KGCCHEAHBHCDeCAGUAGFFADA..dDDGMCHDhAAAJBAH.DHGGLCCChAAASCEEZFEDAAFHTDEFhABA..aGGHEAGCIHABNBIE...hACAgEAA.hAGA...,2,-21,-15,6
LfDJKUASYGEVBeNOaTHgFZRPcCWMdbQXI,SFBEEGFHBHGA.OADBaDAF..HFCAFAFAZGCARCFC..CHBEdCEChAAAXBGELABEDECCUGGBhAAAADCC.GBEAhABA.eCAHgAGC.PEHFMIAEQEGBhACAIBCEKFADhAFA...,1,2,-19,21
eJWRdLgUNaCEMDFXfGBAYTHIPSOZbKVQc,HBCESDEEZGBAVEDGeDAA..RBFFdBAGLADE.UAAHCFHADAEAhAAAXGCBBAHHAHFE.IEEFhABA.PEHDhAHAODAEKBDG.JBHDWHFAaGGHMFBB..hAIA..fFBDhABA..,2,-23,-12,11
GJYLNWDXQAVCMTaeHfcFBRKgPOZdbISEU,MBBCeAADHDBGFCAGBDEDRAGBKFCD...OGFAdFAFSHAChAAAUAEC.GGDDJHEALEFGhABADBGGQEGChABAAADB.CFDBaCDBfBBD.....hACA......hADA...,2,-28,-13,15
bZLMJCePcADRYHTKdVNXUOaWfESIBGgQF,RCADTGCEKEFD..dHDD..XGAFOABA.aFFBEAHFBBCA.QAEFhAAAFHAALEGBhAAACDADeEFEAFCGDAFDHCDH.hAGAUGGHfCCDSABF...IAHHhADA...hAHA...,2,-36,3,39
TXMZCGYFfKgJABRWQEcLeDSPOaNdUIbVH,RAFDECGBeHFADBDF...SDEHOHBEdEFEUBCF..VEBDXDADhAAAMBEE.ZDGDCEACFCAGhAAAKFCHAIAG.BBAD..hABA..WEHH.....cCDEhABAaGECIAHD..hACA...,2,-28,-27,1
VaGPUDSEcTOfdeHQBbXKNCgIYZWFMRALJ,LEEGaDEHGCAGUABCDGCH.EGEC..OAFEeBFGBHBHKHFCCDFA..hAAA.IDBHZFCHFEHHMAAGhAEAAIGE..JFADSBBEhAFATFCEfCFG...hAGA......hAIA...,1,-24,-28,4
bUPFXBaTMcCDgGRNLeHEZdAQSJVYOKWIf,JCGFVBBE..KHBE....fADDUBBCFGHDBCAFaGCCMIDEhAAA.DBIBRFDDLBFChAAA.HEAGZDGFACAH.hABASAHFOFFF.WEGDIDEHPFABhABA.cCEGCAEF..hACA...,1,-26,-31,5
fEJTHcNIBaZgbKOQMYAdGSWRFDLCPeXUV,SBCFRGCCFBHHLCBBeDGH..UEFBVGBC..EGADHBDH.hAAANBIGBDFFaAEBZAFBKAEEMFIDhABAABGDdCAE..DADFCABFXGEDhAAA.fHGB..hADAJDDD.....hAHA...,1,-14,-19,5
AeOQaZUIFNCbDfXWVdRGYJPgBKLTHEMcS,QBADaGFCZDBB.UFDFFBFH..CADG.DBEB...XAEFhAAAdCHCRGBCGAACJAHHBGHEKEDALFADhAAAEABG.MIFChACAAGGDODEE.IGBDNAEF.fDAAhADA...hBAA...,2,-26,-19,7
HLZNMYgTGeKVXEWafDIPUQdbJOBCcRFAS,LACCZADCMEGD.TEFBeBAG..KFCEXCCG..aEDADCHHhAAAUGAEdFCHOHBChABACHHEFDHF.AGBHSGHDhAGA.NAIC..gBFFECEEIEAE.hAHA....PHCAhAAA..,1,-23,-28,5
NRFJbLVUXQcCGKWSOaMdPBfTeHDIZgEAY,RDBBJAFCLFFB.UACHXBAA.CECH.KDDB.OCHBMHDEBHHDhAAAeHACHAFHZADHACHFFFEEhABA...QDGBhACAWAAFSAHBaGCH.fFAChADADFIF.IGEBhAFA...,1,-25,-29,4
NGJbPZKRdaTXULDAHOQCSBIcfVYMFeEWg,HAEAOEDASCGCBGGB...fCBDVABEMAIFEEGA.hAAA..NBAE.JAFFPEDBhAAAKHDEaEAFUGGF.AGAD.hABACECD...YDBFFEGEgGAAZEED.hACA......hADA...,1,-4,-32,28
YBUNcAeZQILaFDXdgbTGMVCEKSPRJfHOW,QGECaAFF.DCFCXBDHdBAH.TGEEMAECEDGE.KEBGhAAAPAHBRGBE.HEFChAAAOBDBBDCDUGGCcABFhADAABIBeEFG.IDAAFFCGbEAHCHHC...hABA......hACA...,2,-15,-4,11
PKLYMCRgFJHZGAbSBWeQdVOUXfTIDcNEa,BCEDQBEBdEHAUAAD..XCAF.IGEADGDHEGEEKBHDhABALFFH.CCDDFAAChACAZFABADDFSCGAhADAeAECODFFTGAG.NEEHaFAAMEAB...hAEA......hAFA...,2,-37,-15,22
SaAHeGIRXLQcfgbNPOMFZKEUVDJTdYBCW,GAEFREEFQBGB..gFCC..NADFOECHhAAAMCBGFCFHKBEFUFGCDDIBdBAEhABACDDBaACGADFAeHEALFAHhAAA.fHDFPACHEDDDTDBABHBD.SBAFhABA.IDHFhAFA,1,1,-22,23
TWDQNdUcASZaKRbJBLXOfVeGHCIFEPgYM,SBFHaBAA.KEEDJGAGBEBHLBFE.OCEHeGECCCHFEDAHhAAA....PBAGhAAAMDIHDFFFQGAFhABANADCdGGC.AIEGZADB.XDGAfGDC.hACAHCFHIHHF.hABAFDAB..,1,-15,-24,9
TGHAgKbJBIDZVNeYRUECcFfWdQSMLOXaP,KHAEJCAFBFHHDDCFZFDA....eCGDRAAAUDEAEAGC...FHDAdFDF.hAAAMCBCLBEC.hAAA.aFAC..PDAFhABAHGFEACHG.IDDE.NBAB.CHHHcCGEhADA....fHDBhABA,2,-44,-24,20
QVABbYTOUJRSXfNeLWgGcPZIaFEdCKHDM,BBBCTDDBJBHH..RCAB...SHAGXDGAeAFDLCFFhAAA.GEGCcGAGZECFhABAFFFGCCDCKACEMABGAAGD.OHCEhAAA.fHGHWEBD.ICCHhAGAaGED.EAGCDEEF..hAFA...,2,-31,5,36
ZYXEVDNJMABaWeOKPHUcFSfbdCLQRGTgI,BFDGaAFG.eDBAOFFBHGBEFBAC..bABGLFDD.QCGChAAATGFHZAGHXEAHhABAEAEGDFGCMCABAIAEKADD.hACAPCFBSCEG.fGHGhAEACCCF......hAIA...,1,-4,-25,21
PFYIWgZMATaeNDOHVcJEdUKfXbLGCQSBR,aGHHeFDH.OFBHHEECVAEB..JABFdBBFKBEE..XEAChAAALDFECBHAQCABhABABEACRFFHFECF.IHBChACAZACHAHHCDAAFEDDF.fGDDSAGE..hAEAWDHB....hADA...,1,-10,-21,11
gWERJDSAYeBbGQKXaCITHNfZVdMPOLFUc,eAEABHDGQFAEKFCH.CCDH.TEECHFDEZBAEVCAEdCGCMEIDhAAALEAC.FABGcBGBhABAEHGCDFFG.AAAB.bGEEhACAaAHF....NICBPFAB...hAEA......hAFA...,1,-6,-15,9
QBXWFLTUPAecMbSGIVdERNaOKDZCHfYJg,MADFSCDBGGDBdAGCEAEARFBC...aCGBDHGGZEACCGEA..HDAAJABBBDEAhAAAFADEUBAF.AICA.hAAAeHAE..IEFChABANEIEKAGA..fEGC..YDHBhACA...hABA...,1,-20,-22,2
NXfETBYLbdMJCSQFKOUVZDAceRHIgPaWG,eDEAHFCH..IEABaDAFGAEH..fHEBTBCHBEHDhAAALCHFMFGBJHCASAGChAAAKFCC.OCCGhABA.ZEFFAHIFcABGPABE.NEAE.EEDG..hAEA......hAFA...,2,-15,-12,3
cWgaAVIMRXGKfdUDPJFBEObHNCQZLTeYS,VDEDRAFHKADE..UAAHDFBA..FHAGBHGG..OABHHDEECCHELFHDhAAA..TFGEhABAeGCGSADHhACA..gFBEABGBXAGBdHAB.EECGhAHAbDAC.NICB....hAIA...,1,-17,-31,14
ZWgbeBKCMYQdSGaOPLANRDcVEJFTfIUHX,RDECVAFCEDCC...FBDF....IBGDXFFEZABG.bFAGeEFChAAA.KABBCFHAMAIHhAAAQEAGdHFF.SHDAhABA.aGHDLFDBAADADEEHJFCDfDAEhABA.WCCEhACA...,2,-28,-15,13
fCMcSZXEWBAVLIQRKGPHaNeTOJgbFdYDU,LEGHQEDBKBFFHAEEeCEDOCHB.JAAGFDAG.DGDBfGGHhAAAMAHDZCCH.EGCFAIGGRFAHhAAAaEAC...NCGG..hABATBCCdACDCGFF.SGADBAFB...hADA......hAIA...,2,-22,0,22
UbWQZBXfgSFOKYHCJEMTPNGdVADeaRLcI,eCEHLEABUBCAQBDAZGAEBCGD.XFEA..fEABhAAAFCHDOCBFKAGEHAFBhAAACHFB.MFHD.NIBHdABHhACADFIBaGEB.IBAGWDDG...SFAGhABA.EFFEhACA...,2,-39,0,39
XTYcILgaBOGKeUPNAEWJRFbDdSMfZQCVH,JACBFGAEDBCC..dGDFMEFBQDEA.HAFEXDAA.hAAA.TEBFIDDDhAAAaCHDBGGAKEHFeAFGPBABhABANIEB.AHAB..EFADbBFC.SABChAEACHCD......hAHA...,1,-12,-36,24
UYPGaKTJcHbNAMEdeLZSIDgFOCXfRQVWB,MCBBdFCDZBDDDBGFFCHF..OEEACHAC.RACG.QFFGBHFB.UAAHhABAGDCA.aAGFTDAGhADAHFGDAIDA.EFADeAFEhAEA.LHEGIAABfDFDhAIA..WAHH..hACA...,2,-28,-12,16
CEfXaIAFcLZVUKPDMGdJTSHRNBQeYgbOW,LGAAUAAAKBDC.DEEBdGEC..SEBHHGFEBAGBeBFF..hAAAbFAHCBBEXGFFhABA.IDAFAEDEFDABZCEBhADAMDIFJDGH..NDCA...YAFCOAHD.hAEAfCDC.hAFAaACF.cDFD,2,-19,-17,2
BKGgLNEVIaXJRAZcOYeCdWTPHDSfbFUMQ,OCGDeEDEdBBA..TADBDADA..SCHFFGCBUDDCBGABhAAAKGCCLFHFEGGD.IBFFhAAAXABDAGIH..hABA.cAFDCGAB..WCADfDADhADAQGEA.NIAF.aEHD.hABA...,1,-18,-35,17
NDbecPJMEdIWRZUTYgHAFLKGXfaOCVSBQ,FDGDKFFBGEAC..fCBGCAHEBCCDDEIDeAFC..JHDCMADDhAAA.EFEEdBBBIFCGhABAZCFEUAEH..YHBEhACAAFCE.LAEF.XBGEhBAAaAAGSEDHNEIE.hBBA...,1,-21,-38,17
IXCBeHPJSMAGcWdEDFbNafRULTgYVQOZK,GBBDdGFEEDFH.DGCEFEHB..aEHFUBACLFGB..TBEBhAAAgBFHQEBEhABAOEAAIHBECEFC.hAAABHHEeFBDJAHBAABHWAHHbACF...NACD..hAFA......hAGA...,1,-15,-18,3
WbNaVDFHegcACUSdRJOBXGTEPfIYLQZMK,UDEFREBFBFAFGFBH.EBAGIEGG.LAEFZAGHKBFD..hAAANICD.DEEBHDAAeBBHAAIDdGGHhAAAXGCD.fAHEhABAYADD.QGGGMFAD.aFFHhACA..FEHB...hADA...,1,0,-29,29
SUdJcEbBKGFWaAPONVfQCHRXIZDLYTgMe,ODFFVDFF..CEBD.XDAHZBCF.LADE..gAADhACASHCCJAEDbCCBhAAABBGBFFHF..aCGFPFHDhADA...fGCD.QGADhAEAIBAFYFCGhABA,1,-23,-42,19
XbFSLNQMeTfGEIVZCcadUWgYHJBOPDKAR,XECCSDAELBHFQECD.MEBDfCAH.hAAAIFFBZGEGaABHUAFGhACAgAEAYDDChADABGHHDAIBAHAGFAACeDGHEDDGCAED.cGCB.dEAChACA.WHFG...hBAA...,1,-4,-12,8
CFTbBSNJdXKAIRfMcUVEPLWgaeDHZQGYO,RBDHMCAEUFGH..EGBDLGBC..aECEHCAHQGDDhAAAODFGTAGHSDAEhABAdAADKAECIEAE.hABAfDED.cAGBWFEH.DFGD.hADAZDGFCHHG.BHHD.NBIGAGAHhACA...,1,-13,-21,8
KUCQRHTeaGZBYgNWfVSLPJAIcOEDXdbMF,OABCDDEFdGABFHFCKHAE..UGDAREGF..HBFBeDCEGABEBBGE..hAAA...NADF.fCGGhAAASBADLAFEhABAAHBHEFEH.MCCCCBEF.QDACZFCF.hABAWFHD....hADA...,2,-35,-9,26
HJOKYUbIdcCPfBgMERGQVaLTZSADWXFeN,XBEBeBGHHECFKGEBUGGH.dDBECGCCBHHAMAIFGACF.aBABhAAALCCB.ZEGBhAAADAFANACD.OEFB.hABAIEHBfBGC.gEEEhAHAECCE......hAIA...,2,-39,0,39
XEAgTFDCeNRZHbSMJYGWQVPLIafBdUKOc,TFDHFFCEDBEE...CFHH.eBCDZBAFHCDE.SCGBJHFEGCFGhAAAQFAHLAHBIFAGhABAaAEEdHFF.OHBAhACAEACCACCENAIE.MCAF..WADC..hBAA.fCEAhBBABHAH..KFFE,1,9,-33,42
TXeLERHPOAgICVfNcKFSYZaDUbdQWMBGJ,.CGEE.VGEG....fDACKACHFEBFZBGDaBAGDBBB..dHCBMBAHhAAAJFBE...eEDFhABALDEGHCDCACIBIGHAhAAASEGAUADHQGADBAGDXGFDhABAEAFC...OBHFhACA..,2,-19,-18,1
VGgNCTBcaUSHFQRZXDIeWALdKfPMYEJOb,LBDHKBCAMFFE.JCBH..ODAHGEFACDEH.BDHB.UAGHHGDGhAAAQFCEXBGBIHHGhABAAFBH.dHAHhACAYAAEEFCA..bCBGNEAA.aCFFSFHBhAEA....hAFA...,2,-28,-8,20
NTCXadBUOFPQLSHEKJWYcgIDVeAfMZbRG,ZADARDAAGACHCEGA.dGCFBEDBFDFF.LCBCHAAFEGADKGDE..JFHF.hAAA.....WHAChABAYFFF.IDHGhAAADIFGAAECMCIF...NCAA.aBGEOCFBhACA..SDDHhACAcGGA,2,-53,-15,38
QZAbYSIaOcNRJeHVCKMTBWgEdXfULDPGF,SHAGOCGDRBDCHCAECAGC..KDBGBFEE.EACFdABA.UCFEDICE.hAAAFFGEAEEE...IADHhAAAaEBD..NAEFeFHHhABATFAE..WBHBXFDDLGDA.hAFA......hAIA...,2,-41,-13,28
APNGSBbCIYfLRKgDEVHZWFJQaMdXceOUT,GGBDBDDDCEHF...fCBDLFBDKFGFDFGEHBFFZAFD.FBDEaFEBhAAAXAGB.eDEDhAAATABHAHHA.SGEHhABAYFADEABE..WAEFMBIFdDAH.hADAOAHD...hAEA..PFCF,1,-8,-24,16
YOXZgKMfWERVIeNbAJDBQTPHSLGcFCUad,BDDGTGABHBDE.LHBEFEDBCCGD.UDGHaHGG.dAAE.OAFEhACAXCADKGGE..MDAHhADAEAFGRACF.eFEHAEFDDDBDQEGEhAAASHFG.......hABA......hACA...,1,-20,-22,2
LATZCUKOISEdDgQPYfFXBVGWaNMbRHJec,CBGGOFAB..SEHBEEFBDDIF.QBCH..PCAChAAAfEBCFBFDBHBChABAGFCBaEBGMAEGhACAHAAHJHFCLHFAABHGTDEDKHCA.IHADhAAA..YBBChADA.XEDDNADF,2,-24,-16,8
XcFENIDJLSYATKPgZeBUCOMbGWfVaQHdR,TFDFKEBHZDECBFDG..UBFECHDA.OCBDGADF..fBDEhAAAQFFDRGAEFGGFhABAEDAF.DFFELAHHhAAA.AIHAeBAEMACAbDDGaGAC......hAGA......hAHA...,2,-23,-20,3
XJLNKcQgBYDHUMPEOfAdRZIVFGCebTSaW,dGFAZEDFFAGFCDCH..eBBHSDFB..XAEDJEAB.KHBEhAAAQABCBHHAHAGDhABAMECDOEDEAGGAIAEBhAAAbEGF..aGDDNIED.....gEAGhACADIAGEDHH.fADAhADA,1,-14,-41,27
TfDaCOWXFBNgbKMYEGIPRHdLJeUQSAVcZ,ZECBTGEADFAG..CABA.OEDE..FFGCBEBE...gACAhAAAMIAAGBCFICAGhABA.RCGBdHBHLADChAAAeAEHSAGAcBACfFEChABAaGABXGGFKCGGPHEChAHA...,2,-37,-5,32
IaABCYKgQeLZcPMNfJOFXVDRSEUTWHdbG,CDACKAHB.QFAAZEGBMAGD...JHFGFBEDDECARDBD...UBDB.hAAAHDFGdBHCIBCEhABABCAEeAACLFEFhACA..cGCFfHABOFFCSDDGhADAWAEC....hAEA...,2,-30,-20,10
bANXZedCYEJaLcIGHfMDSTUKOgPFWRBQV,ZEDFdGGHCCGDJBADLACH.GEAEMDFEDGGCUFDH..OFCDhAAAFABHBHCG..bFAFAAFD.hAAA.eAHB.EEHHIAGHhABA.fBEBSHEGKHFGWBDHhAEA.....hACA...,2,-45,-19,26
PZKgEDIUVFdXYWJbHeNfOSCMRAGBLaTQc,BBDALGBGQDEFZCCFKAFEDBAGUAFH.FEAFdCGA...XFFBhAAAJHFGHGCC.eAAEhADAODAHMIAEACIHaECH.hAEA...cBBHPBEFIFGH.hABA..WBHHfHGFhACACGAD,1,-26,-37,11
JaCRTUXZAKHEFQSPcMdVIgDBNbOYGWefL,KFBDECEBFGBBQAFH..SBAAMDACdDEA.VEFHDHDGBHGGhAAAOHCCGDGG.hAAAeBACLBDCaHAECECD.hABAUDAAAGDA.cAGA.IHHG.hACANABHYDDFWEAF.hADA...,2,-23,-8,15
UGMYTWHNPgVLXAIJOSdfCbQBEFeacRDZK,OEFASBHBdBAG.CEBH.BCGA.FFAAeBDE.RGEEKCDBMCEF..hAAATGBCHGCANBEBVDFDhAAALFFG.AGAF.ICAAhABAJCCH.fBBD...hABA......hACA...,2,-28,-22,6
FUYdMAINLOVGWECKBJgHbaQXTZSeDcfRP,LADGVCCA.GFAFEFGDBCAHJAHBHBAF..aEBHQEFDhAAAXDGE.SDDHhABADHCERAFDFAAA.dHEFIFEBhADANCCFCDHHKHAA..........hAEA......hAFA...,1,0,-33,33
FQWVEXdBAbcNIUTKOGLZJaPgSfeDHMCYR,...bCDGIHAF.UEFDOFGDZECH.JAAEaBAE..gFAHhAAASADEeAEEhAHADBDDCBGFFGEH..QCGHhAAAEDGHBFEBABEANBEGKGGF......hABA......hACA...,2,-31,-20,11
eSMLBXTafcZWVAbEURGHKJIdOFNQDPYgC,EADARGBGKBCFdDGE..FDGGQGBB.DFDEPAFE..CAAFSCBGhACABFHC.hAAAaGGHZGFAABFD.bDBGUAGBhADA............hAHA......hBBA...,1,-34,-44,10
YGSAJCFcbMNXIfWVLEKOQgZeTHaBDUdRP,CEFFFAAG.MEFF..ICFF..VECBLEBEKCBEQBGBhADAeAEGaFHHBAAChACADAEFUGGEdBDGRGAC.PHDChADASAFF.AHAC.......hAHA......hAIA...,1,-26,-36,10
fKdeWTXaIcHBAQbgEJOZMVRFDLPUSCYNG,QBABEGDCZADE.RFCGFCDFDICCLCGB.UBAHSCFFhAAACFDFGEACfFAChABA.dBHAeFHHXGFEhACAIDDBBAFCAHABgCEBMIAAPEFEhADANAAF.TDBG..hAEAaGGB..,2,-14,-11,3
LCgObEWMHFVaceDXJSUAIGPQYBTKRfZNd,GBDGQFFGBGEDRADAZEAFLFFE.CBGH.bDEGMGAC.FCHDaDCDhAAA.DIEG..JAADADIDICBDhABA.PAHHhACATDAH.KAFEfGDCgGGB.hADA......hAEA...,2,-27,-20,7
DVAPcHUWFEaGdLSOXYQKebCfNgIBRMJZT,HGACFFCCGBAGLCCFOAFDQEEH.KAGCCCHB..fEHGhAAANIDHBAEFMHFEJEDC.hABADDBDAIEA.UBGH.aABGhAAAdACF.SGGB.eFABIEHBhBAA.....hAFA...,1,-6,-29,23
aUDgOBLHNGJAYTKcECdbWFIXMeQfRSZPV,TCGCEGEEdCGC..FDBGMFCE..QGBDRBCCSBABZAAEaFBAhAAADICEOFGFBAHGLAEFhABAHGAAJAEAAGADKEHHCGEFIACChAAA..fAFC..hACA......hAIA...,1,-14,-22,8
PcaFORSTQLWfUHbNVMIZegCEdDBGKJAYX,XCFDaHBA.FEBEOEFG.REBGQBGHLAHHUFGEHBAChAAAVBDBMFIFZBADCADDEFGHhABAdGBGDIEGBEAC.KDDEAAAH.hABA.........YADChACASGAC.WFFDhACA...,1,-15,-22,7
RPgbfIYJFDOKVaTMGAeLcdSCBHUEQXNZW,LFDHSDBCBDHEUAEGQBDFZBGDREEH....PABEhAAAbCAH..IGAHhAAAFHGEOHAAKHFATFGDhABAAEDB.dDDDCEHA.EHBCNBAA.WACF....hAEA......hAFA...,1,-20,-24,4
DSXWIgcPZbHULQCeFKdaBYVOANMGJTfER,MBFDJEHH..EECHDCIF...SFGFXBFB...ICBBhAAAgGABZEBFbDDHhABAUACB.QFEAhAAA.CAHEKDABaAGFBHEBOHDCAACHNADEfBAChABAWFAF.cCDChADA...,2,-27,-24,3
GBEeOPLCJYUTacNSMFVdfIRKDWHAQZgbX,QEBFZFDH..gABFXGGGECAFeFBHLEEGhAAA.JAFATCEA.hABANDIGSEAHhAAAMACHFCEGdGECIGGBDDGEAHCHBFHHCAHCaDGD.fAEFhABA.KBDF..hAEA...,1,-9,-23,14
dXEaAIRFLUcbVTCZPQgYeWSNGJKDHBOfM,FDEAUDEG..VFCGCABDZCAG..QBADeCHB..SAGGhAAAJAHBDAGHHDAAOGCEhACAMFADXEBDAFHH.hAAAIGHAcGGEPABA..YHAAhADA....hAEA...,1,-14,-36,22
CVNUWgfOSREGXcedPLaKJTYbBAHMZIQDF,MADDZCBEDFDHFFAF..CCHF.UBAA....fHABODHDEAHDhAAAGCFC.eEBChAAAPCEHKACA..JFHBTFCDhABABAGCAIDEHGECIBAHNIAHSAEGhACA.cCFAaFFH..hAFA...,1,-22,-28,6
FXSJZNKUeIfQYWGLcCATDdPbaHBVEgROM,DBCEdHABaBBHBCCD..EGDERFBAFEEF..SCEAZCFH.UGGEhAAAeDAHQEAHhABA.GACCcGGFCEFCTAEChACA..PHCC....hAAA......hABA...,2,-50,-8,42
YOJgIPFLUBEMNaQcSbeATVfXWZKdDGRCH,TDGGXGCA.KCFGdAGH.GAACRGFA.HGDCJCCG...PECHhAAAFDABBFEEMAFBQABFhAAASDDGAGAF.WHAGhACACFBG.ODAHLBHHEHGA.....hADA..aEEAeFFG.hACA...,1,15,-32,47
aYHcMQDSXOKWeCNBEFgdbUIGJTRZAPLVf,LFCHaBCCHGCGMFACDDBEOFHD.KGEGCCGABHHB.EDAGFABEdAGDhAAAUAFBGDDD.JACAhABARDEEAGGE...fGADhAAAcFGG.SADHeHAG.NBAA..hAFA......hAHA...,2,-30,-9,21
NPLbBFUGSYRMKJaXeQWVgECIATdfOcHZD,TGCBdGAGODFG.HEDHDFHFLABGBAFEFDADGAAHSEFBhAAAMEIHJDAH..aHGCXECChACA.QCCAhADAWCDC.gAGCIBHEAFGEfHEHhAFA.cGAHhAGA..,1,-13,-30,17
GNRASUTJgCIPMXaYfQEcOLbDZFBeHdVKW,TGEHJBHH..CHEF.MDDE..aAFDQADH.ODHDhAAAbDEBZDAABGBAHFACdGAGhABAKACEGECBAFIF.gDAFhACAIEGDXGGDEGGEDICC.FCBC.hADAeHAG....hAAA...,1,0,-26,26
CDHJISUdEXAPBGbYTaeZOgKcVWRNfLQFM,BCHAGDFG..TCCEZBGHOCDF.KABHVGDCRGCELFAFhAAAFFAEDCBBHACG.SAFHhAAAEHGAXADGPDGHhABA..YEACaFDG..eHAGcBAChABAfHGH.hAEAMCAF.,2,-24,-5,19
MbOHQgACRcVFdTeJUGZaWLNEPKIYSBDXf,RGDAVEABFDEG..dGGEeBDBGBBFZGCE..LDFAEFAC.KGGESBAChAAABAHCDABAMAADhAEAOEFE..HBBBAADCCAFFJAHBhABA...aGCGWHDA.....hACA.IHAEXAEEhAFA...,1,-16,-22,6
KGCeVIMTBXHAbZPOFJdUgDcLYRWfEQSaN,ZECGOBADFAHHdBBDUGEF..DFGALBFE.RDDG.EGHDQGAGhAAASGBDaDBDKAEDeDHFhABA.MAFCBDHGAHDF.hACAJDAD..gACA..cGDDhAAA...YDDEhABA.,2,-52,-1,51
RVNIKECWBeUfGDQYTSaFZcXbOLMdJAPHg,HECBVFDH.KAGA.CCADBBBCeDAGGBCF.DAIHTEEAFAFEZFFH.hAAA.XGAGOAAEMDIHhAAAAGHFRAEB..ECCH.hABA.UFACfEAESDFEaHEG...hABA......hACA...,2,-27,-7,20
bRYPVFdJCEAQULaMHBDGcgZIfXeNSOKWT,QDBGLBBHaBGHMABCHECABEHAGGEHZGAG...IBHHhAAAfAFAeFBBNEEG.OEEAhABA.TADDhACARBGHPDFH.dGGHCGAGADDA.DIDAXBBE.hADAKAAD..YDHBhAFA..,2,-19,14,33
NgXBHdLfMDFAWQcYZJaPRVeKGbCEOTSUI,QACBZFGBaDEA.RFEHKBAFCDHC..OGCASBGBUAGB...hAAAIFDHXACGBAFFhAAALHAEDCEEAIGC..hABA.WEAAcDADPDAAGDEH.EGHBgEEEhADAdHAD..hAEA...,1,-10,-28,18
AfcGBSYZQNCObPEKHMFUgWLIeDTdVRXJa,GFCFBDCCZEAEQBCFOGFC.EDBHMAIFUBGG.LHFAhAAADDGDdBEA.XDFCAHAG.hAAAfBACSEEFhABANABDCHAGKGCF.FCAD.IBGH.eBBEhACA......hADA...,1,0,-35,35
bTZRHOQMcJDUWeXFAEYCGafdKBVNPgISL,CADGaEGCKDGBBHHH....VGAA..gGBHLFDGZCCChAAAOAGBQAGChABA.MIDCDBCHWFEBhAAAFHGAAAFD.EBDE.GDAEdECF.IGGA.hACATDCC...hAEA...,1,-22,-26,4
IOdaHNfCbYZGSUTQLDeVXKBMFEJPAcgRW,RFCHOAFAdCFBHACE.CEHC.ZEDDGGEHTDAGDECFeBAE..VBAHhAAABADH.MDDBFGADEAGAhABAJCGDAGHC....gDDEhACAWFCD..aFFH.NBIE..YHFGhAAA....hABA...,1,-5,-28,23
ZXJVWbegQKOFcCISENMPfYALGURadDHTB,UAEARECBDDIBBFABZDBE..JCGD....VCDAeFHB.KAAEOHBChAAA..FFDBCBAH.ECBGhADAMHFC....hABAPFFBfAGAAGBH.aFFG.dADDXGBHhAHA..gCBFhACA,2,-43,-32,11
TdFKJGgWbREcZHIBeUQPCLYDaOAMNfVXS,MBGBVBED...SHCCFGFDKCCB.GDEE..bEECRCBFEAAFhAAA.HADBBACEeHFAhACAQGAFPBHDCAGBDCBHhAAAAFBBXEGDdBABJAFA.WFADIDHH.hADA......hAFA...,1,-1,-25,24
QIJVTeFSLAcDUaPGOHKbfBdZRWNgMYXCE,DBEDUAEHGBGEHCBCKCHDBFDFRFDG.....NEIE...MIEGCDCG.hAAAIFAHJFGH.TABAhAAASGAG.hABAAAFB.aCFHOABHdHBBWEHHXEEB.EACDhADA.eAFH.FEAF.hADA...,1,-21,-23,2
XFCNcRWHEYVAGZOLfJIBKPbQSMTaUdDge,ZABDOFHDLBFD.JFADBCFG.PFBCSCGE.MAEEhAAATBCG.dDAFeEFAhABAXEEBCHDFRDCDEHGCAHCEIAFChAAA.KHAAaGGGDBAC.FAHB.NIDD.hABA......hACA...,1,-17,-28,11
LCUgRZEFHIfVdTOQbJKecAYWPNBaGSXMD,...PFCDNIEBGCGE..MCCDLDBFUFGDZBFHEAADHADFhABAVBDH.TAFH.bFDChACAeAHHAICG.BAAASDEHhADACCACFEABdFECOFAHKHAG.WGFAaHFE.DBIFhAFA......hAHA...,1,3,-7,10
SDFHIdTgfPLZCXWcVeUROGMBYaKENbJQA,SFDFDEGDFADGHGBAdFGC....fBGGPAFFZDBBCAHC..hAAA.XBCA.hAAA.VCCEeCHDOFHBhABABBADaHAANFBHQCAEAEADTDEG....hACA......hAGA...,1,-17,-25,8
WPaOYLSATCBNFJQcDdVeIgUZGXbHKREfM,BBFAFAFDQACFdDCBeGFC.UEFCZEAFGAAHHCCGKHBE..EECHMAHHhAAA..aHFELFADhABAACIDCHDB.NEIADBBFIAHAhAAA..XGDHfEFD..hABA.OADA.SFDAhCAA,1,-16,-22,6
CeNPARJOUDZKLdafBbHVFMIEQGXcTWSYg,OEBFUCAFKGBCLBEB.dBCAaDECBGGCHEFCMDAHEAFHQGGFhAAAGAAA.TGDEhABASHFG.CBHD.hAAANAICABHDDFFG.fGDA..bABEIDGGhACAWFAD...hACA...,1,-20,-21,1
THYSALfOCeKUbBXRVMIgcZNdJFaDQEPWG,LEGHCFBDUCDC.XDCGRCBF..MIAA..gAAAhAAAZEGHdAGEFAAGaHAA.DAGCQFDChADAPBDETFDDhABA.SDDEABDEfGFAKFAABDAAhADA......hAEA...,1,-18,-33,15
MJAZFKDfUdVePBXEWcIQOaCYHTSLgRGbN,KACDDCCFdFGEeADEBAED..EEDF...IAHHOFDBCDDFHFGFhAAALBDGRGAA.GDAChAAAbBEGMFFDAFEG.fBAGhABA..PCHFWCFAaEGBSGEHhABA....hACA...,1,-1,-45,44
SMKCcfNWJGPeTDFQLIdaRYXEZABHbgVOU,BCEDHFCEVCAFOAAFUDEEKAEA...CCCB.....NEAHGEFEhAAATAGCDHFEFBGDLGAEhACAaAAA..YCHBhADAEEHBAEFD..SACHcFAC...hAEAfHAF.hAFA...,2,-28,-28,0
BYCVQPKGOTecXIEANZJMDFfbWHUaLSdgR,ZEBAJEEH.DACEFCCF......fBGFHFADaDGBdBAERBCDBHGGhAAACAFC.QGADhABAKHFG.ODHFTGCBeGDAhAFAXBECECBBAHHC.MCIF...WAAEhAEASEEE.gAEAhAHA,1,-11,-40,29
OWcaBFTgKXLIGfQJEYUCHbedMZDSAVRPN,RCEEOGCE..aACFFBEFKHCELCAAGFED.QEFGEAGF.hAAACAHEHBGBdEBADBABSABAhAAAAAIF.VEABhABANIEHBEEAXEDC.IHGHfCCGhABA.YFAF.hACA...,2,-25,-14,11
CGdLcIOTFfgbESWYUBKQRHDVXMNeZaPAJ,CBHDLBFB.OFFDFDBH..fDHEEEHD..WFAChAAABFGB.RCCEHFCADEBG.hABAXGADMDAGNIBFeAHBhACAaGGCABAHdAEB.IBBEgFDA.YABGhAFA.KGAG.hAAA...,2,-32,-13,19
JMefNTKLUFREdaQIDPZWbOHXGYAcCSVgB,CCFHSAGABGEB.eDAE..TABGLDHHUCDERFDGdBBHQFAFhAAAICFDDEHDZFADhAAAODAA...hABAXGGGAGABcDDFJHBENACBFHCAEAHH..aAEA.hAHA.WHFA...hABA...,2,-31,-1,30
dNTCQUWaDEAJFBVMcGOeXRSgPZbKLYHfI,BDBBMFEEGEBAeDCH.RADA.SFFFZGEC.KDGAHAGFdBADCEABUAABhABA.DEEEABHHFAFBOCDEhADA..XGGFhAAA.....PHAALEADIADHhABANDIC...WEEFhACA..,2,-31,-12,19
NMcWEKGgVPDTOLHQXabFCSZdAfJReUIBY,JCAGRFFCeAEDBAAF..MCAB..EAGHKDBEGEAE..PFBFhAAADIGEOFEEHDECXABFhAFAFDEDZACC.AIAEIAHAhAGA.NEDG.cDGC...WAHHhADA.....hBAA...,2,-35,-21,14
DIMgdHYfaKLPAXcRVJFOQNEZeCSTWbGUB,XCAHVDED.FEHHODHD..EAHDCCCB...TABAGDAGhAAADGDFIHCGdDECfGGEhAAAKGGDAACHRAEA.JADC.hABAQCFCeGCESADC..UGADhABA.BDCE..hAGA...,1,-13,-18,5
IgEbVFRMKLdYTXCNHceSfJQDBUOaPGWAZ,ZADBECEGFGCEMFFC.KFBBLDBC.dHGBXBFBHBGDeFBCSGEAhAAAJFFGBBBCaABF.hAAA...PADGhABAAGECgDAC.bFCH....YHAAhACACHAENEEF....hAHAfHGH.,2,-21,-7,14
DESGFVNfObgXMBeAQZHKRdCJYPWLTIaUc,QFAGKFDBRCBF.JCEE..PAABLEFE.aCADDFHDSCCHhAAAFCGC..NAFA.hABAOABG.XGFHhAFABBDEAGFEdHBBCAGGWHAAIAHFEFGE.fHEHhACAMEEF...hAHA...,1,-21,-41,20
SNCXAMFdbcUIfVBKLEQRYTGaHeODPZJWg,dFHEUGBB..VBEDLCBAREFD.GFEDaHDE.HADGDEBEZBAAJDFESEAFhAAA.hAAACABHAAIBFAHB.IADGhABABHHD.EGBC.....YFAEhACA.OEEH..hAFA...,1,-22,-25,3
SQGcRHNIVMAWDOBbeFJZUYgCaTELPKXfd,OEGBeAFHFFADUECA..CHFG.EAEDKADAdAHGGCDCHBAF...VCGFhAAAAABEBHEH.ZGACaBADhABALEHB.XACHhAAASHBA.RCBHIHHDWAFBDEFH.hBAA..YFFAhACA...,1,-9,-26,17
AGeNIYTdJEgOUHLMXRPcfbaSZQKCVFBWD,eEBC..IAECTAAG.EGEBUAGEHCAAMIFGRAFF..fAAHhAAASFHHZCGBCBECFDGFhAAABEECDDAEAHAANIADJGBE.hADAOACDPECHaFFFKGHH......hAHAWFAD..dGGC.hACA...,2,-23,4,27
bQFIHNOWdCJeBAfZPTEDRVYaMUgcXGKSL,ZBDDEAHHDAEFRGFE..aFGAMAAD..UAGG..XDGGSDCFhAAAQFFFHBAAOEABhABACBCDJFCFAGIF.TDDDhABAYGBC.gDFCKBFFbFAHFDBGNIBH..hACA......hADA...,1,-8,-19,11
fHYeDcaKWRGUFTJPQbOVILdgZXBACESMN,EFEDSEFB.MIECfCDE.eEHDDDEEaCAAKCGEGEBAhAAAFGAEJEHH.QBADhABAVDCF.IAGHhACAdAAF.ZBEHAAEACAGANIEHYFAFcGCD..WBFGhADA.....hADA...,1,-7,-24,17
HSKCMPFIYcVeWTUOfBAgQaDXbLZdEJGNR,QFGBDBGHLCABZFADEEGAGCBH.RAGDHGDASAACCAAEFADF.hACAIGAC.VDDHhADAWEEC..TGGGhAEAfFCCABBA.aAFBdHDD.NDCAMAIH.hAIAcADD...hBAA...,2,-10,-9,1
eIfdEKVQYMDCaGBNLFTbOWZHcPJSAXRgU,XFCARCEEUDBA..eFHFdFHGECAB.QCFGMAEGDFEGGGBFhAAABFACFDCB..TABFhABAOBAG.ZFFH.PHAChAAAABIDIBGBKAHHYAEDCHFA..NDAG.hADA......hAIA...,1,-5,-25,20
XDCcEKGLOfJNZTHASWMPUYbQgFaIeRBVd,MFAEUBBFQCEHFEFG..IBABeFBHBFHCdBEBDGAHEADGKBGEhAAALCCG.OHDEhAAAfGHA.hABAJHDCNCIETGGFAAGE..SFEChABAWGDCYDAAaECF...hACA...,1,-20,-27,7
USHLDZXCIPBKGFfTdNWMJeYcgbQORVAEa,aFAGSHBGHBACDEIFCFBG.BHCFGECB.FAGDdBEB.MAHDeBCD.hAAA...gFEEhABAQDGFODDChACAAADAEAACUGGBLHFGICEDKGAHfDADhADA.....hAAA...,1,-5,-26,21
gRHGTYNbXSdeVafDJAUIOLKFWBcCQMZEP,OBGDKCEHBEEG..CGHAZDABEAFB..RAADGEAE..NAAFSFCChAFAeHDC.aGCDDCDDhAAA.ADHCUEGDLFFHhAGA.FCEF...WAHBcECH..PBBAhBAA....hBFA...,2,-33,-32,1
NIJHMRdcSQgBLeWPXYOafFKGECAbTDVUZ,DEAHZBEGJABDMAHF..dHABQGCBBDBH.eEEC..XDCHhAAAaGGAKAAHGADAhAAA.ECADAEGEVGDE.hACAUGGGIHFF.cDBDSADGhABA.WAFE...hADA...,1,-22,-36,14
XFKdGbLEQHYROVCDZMUIWPATcgBfaSeJN,TGFABEAHSCEA..eHACJABEFHBEdFFBLDEChAAA.QAEBhABAHFFBRECACBHEZBCEICBDAGBD.hAAAcACHaBAHKEHBEFAC...OAHDDGED.hABAMEIF.WDDD.hAFA...,1,-1,-25,24
AEYeCZLfJabOScTNIgMPBRdXQVKGUWHFD,eFAHCBDBZGDELEAB..fEFG.aFCASBBFhAAATCCH.IEEHhABAMAFHBHCHXCFAhACAKGEGWAAHDBIBAHIBECGCbDCDNIEF...PAFG.hAAA...QACDhACA.,2,-23,-22,1
BHbcDKUVTdICARPfSJEGNXWFeYOLgMaQZ,RABHSBDAEEBH.GDFGXDDCFDDDOBCHLGEG.MFADhAAAZDAFBDHEHBEGDDIHKHGGTAGFhAAACFFDAEAE.PACAhABANICD.......WGCA..hAGA......hAIA...,1,-18,-20,2
EDZYVNBXGOHKSCQLMeWbJUAIadPfFRcgT,aGHHdFGBFFBD.RCDD.TCDFZBAE...VCGFBEAH.GAEDHEBCKGFBhAAACABC.LACAhABA.eEAD.WHAGhADAJHCEAEGE.IHHE..fBBGhAEA.cFEBDDGG.hAAA...,1,0,-41,41
eIBYCALUVRdNGTOZFEKagSXbDfHcQJMPW,LABFUBGCdFBCGDEAOGECFCFC.KGBASACB.DEBGhAAAHDDF.JAFCMAEHhABA.eHEABBECABCDRFCBNICFTEAGhAAAaGAH..XEGF..fACChAEA.cDGEhAIA.,2,-37,-14,23
GSZfACLNaTDKYbBEMIPHgXeJWcVQRdFUO,CFDBaHGADGFB..KCFCBDBD..EHAAMAFFHECE.eAAB.JEABVAAEhAAARACB.UGAF.GCFChADASEGH.hAEAADHALAEENEIE.......hAGA......hAHA...,2,-40,-16,24
IFbRGcdMXLDQSKfWHCgVJBAUeYOEaTPZN,eDBHOBHDEABG..TFDDZGCEFGAH.REFDGAEBdBCALBAF.hAAAQCEFSDDBhADAfHABCDGE.hAEAgGGABHHAABBF.aBFA.IFADhAAAMIDGDCCE...KFCA.hABA...,1,-6,-24,18
DYNEKeFJfUcGACOdQWMXagPSBRTbHLVIZ,dDBGMHDEaFEG..SFCCBHFARABG.HBDA.LDADZAEDDCIDEGDBhAAAFDGAUEEG.AIGGQBBEhAAA.hABAWBFEPBGD.TFGBIHAGNEACKDDD.hABA....fGBEhADA,2,-26,-25,1
aHDBWZfQFGMbXITARJcNKdYVCeLOPSEgU,RBADJCHBKHEC..dCCFCFCD.LHCE..OAFDEACG.UCCCDFBFZDDAhAAAFFGG...MAGBhABA..IDHBhAAAAIAC..cGGG..YHBAeFCGSAEBhAHAaFDABFACfADHhABA,2,-42,-38,4
LYJXMFeWOGTSENCPVZHADBUgRcdafIQKb,DFFFBBHHUAFDRADHdFAF....aACBQGEEKEGG.LEFAhAAAJADD.XBBDhABAFGCHeDECODFGGBAEEGHHhACACHHE.ZGAG.ABBF...fEDG.hADAIGAG.MIEChAAA.SGGC,2,-27,-17,10
OLPIUeZAbJQBaHYNDRGEKfFdgcTSVMXCW,QGGDBCGCaGFBHCCDDGEBGBBE.EGBAFGHF.dBCF.TGAAhAAAMDFFXBFAhAAA.OADDIHDBhABAeBAFACAFbBEDNBIEKAFC..cDGD.CAGH..hABA....WBBDhACA...,1,-3,-31,28
RdOMBaNFEPJTQfYLGHcXgVDAKWbCIZSUe,KEBFCECGZFACeFFF.dCCAMDBGBAED..FABDEGDD..JCHB..TCGHhAAAQAEALABDhADAHEFFXGAGhAFADIGGAAHB.IGHBSGDH.....hAGA......hAHA...,1,-27,-33,6
QLVcCefAIYdgZXBFEGDMaPWKRUJHNSTbO,dGDBXEGDECCCGBEEDBFG...MIDAaEDDKACCJAHF..HEBDSCDAhAAAODABQGGAhAAAVFAH.CABGAACAgCBFhABABEHGFGAD.PHCC.RCFFNAIG..hAFA......hAGA...,1,0,-23,23
ZbRcYJCdMEePLBVNUaKWGFfHOXTIgADQS,DCEHSCCBZFCEREAH...JAEEdAFC.eEFELAAFBHHB.UEAGhACAKBAG.FGDD.ODFDhADA..IHDFhAAAAFDEbFGH.CBDF.MCIB.EAHHNAIG.aBBG..fGFAhABA...hAEA...,2,-40,-20,20
CXEdRTGSKUcbeBHfFgZWYAQDONIJLPMaV,OAHDJBAHLDFF..aCEBCFBH.dBAFGGCBKADAUGEC..eAHHhAAABEFEFDCGZGAEABBGQAEGhABADDFC..hACAIGHHMDIBEGAB..SFAGhAAA.cDCHfHGHhADAgDAD.,2,-34,-13,21
CLOVZeEMAGDcBgFNKdSWRfIHJYQbXPUaT,DICEBAEBFEFGdGFE.RGCGHDBBQACE..XBCFaBAC.LEFGhAAAZBFGMFAAAIBGGBEDhABA..gGGGhAAAKCAESEDBIHAE.JGBA.PAEEhABACAHHODABEDDB..hACA...,2,-18,-14,4
gfTOUCXISDeBEPYQMVZRdKWFHGJbLcaAN,...fGFGOADCXBAEDDBEBEFGEDFEQBGDZGFA.hAAAdFBDKHCEFBAAHECCJAEELEAFhAAAABHETFAHCDADIHHFhABA.SHDG.eDCAhACAMCEA.....hADA...,1,-18,-19,1
VHGRAKEPNaLBZeWCOfFUXdDIMQgTcJYbS,EDGCaDDDLCFGBCFGZCBC...CBHF.FABEdADGDBAFMBBD..QFEBhAAATEGG.JFADSGBGhAAAGAEHKECDPGEEhABA.eFBGOHCEfAEFIGHAhABA......hAEA...,2,-27,-13,14
gEYUeXZADFbKJNSQGRPOfLHVcaTCWIdBM,FEFAKGBG..SDACQCDFGEGCOHBGLABEHDBFaGGBTECAhAAACDAE.dCEDgAGHhAAA.EAEHYHCGhAFAXABFAEGDDBFGNEIC.fBCEhAGA......hAHA...,1,-5,-23,18
BFKQIAJTXeVagUdcbDMLZCOWPNfYESHGR,XGDFVDAG.UAGDdGCDDAGF.ZEEAODBE...PBBAhAAAfHAD.EBCAhAAASFAFRBGF.hABAKEFHAFDBeABCaHFGcBACMEIDCGGD..NCHGYFBBhABA.BAEBhACA...,2,-32,-18,14
BScaQGURFHAbDgdCePLIZKVXEWJTNYfMO,DBAEdBHECCACeFFFLGCGKFCE...EAAATFAF....fBDGhAAAMADFSCHDhAAAQAEAUCABHEFChADAABEHgAFCIDFFZEAE.XGGEhAEANIAHBGDHaDEF.FHGE.hAHA...,1,-13,-15,2
bCSUIHXfcTedZFEgQKNMYGAWPOaLJVDRB,OFEDJGDE.REGDBCAHCBGD..UBDGHBFB...XFBChAAATDGHdGACZBBDFAHD.EAEDhABAKBAEMDEHAEAG.aDCDDDCBhAAA.SGHB...fFCChABAeHAA.NICH...hACA...,1,-3,-47,44
DFCMScZbPXNWgKGUBaEVAQRYHJTefdILO,RDGFJBEGeADH..dGAGOBBHCEHB..MFGHSBFF.ZEDBhAAAXEDE..hAAANDAEKHAGGABCBHHGEGDBhABAAACBQBGD.YFFFfCGChADADEDB.cEAF.hABA..PFHB,1,-23,-30,7
FCJUVIYGMTOSbfLcdBNHgDREXZaAeQWPK,eEFAQEBDKBCFFEBCJCAC..UGDF..IHBDMDDA.SEDEhAAALAHBBHGAhAAAHCGBDFGDEAEBaGBFAIFECBEH.hABA...YAHHOFAHfCAChABA.dGGBRABGWFHHhADA...,1,-13,-27,14
NYZTDVfSMPedQUKaAJIgECWXcRFBGbLOH,JEDEEECD..CGAF...XFCCFCGHBCBBLGFGHGFEZAFG.DDAFSCDChAAA.MBIFhABAdHCHKDEBaHCEIDAEhACAgACB..RAFBODHH.YFADhADAfAACeACAAFIF.hAAA...,1,-7,-39,32
YZJHVTWcXEaIBfQGCKADbPeLdMOgSFUNR,DGIBeEDBMDHDOBEE.FGAARAEHZDAG.HGEATGFH..XACFhAAAaCAEBBCE.QDGDhAAAKHAGAAHDLGAChABASGDD.NABH...YEDGWAHBIEBChAGACCBA.PDDGhBAA..,2,-26,-10,16
gQYUAFKdEZcBeORVbWPMLXJHGCIaNDTfS,KDDBEGEHBEFARBBE....VBGD..WECCLFBB.XGGDhAAAHADCIBHFhAAADAFB.SCAAhABAQFEDAGDDFGAAdABBeEADbEGHMIFACAHE.aHAC.hAEAfABA.hAGA...,2,-20,-17,3
LJfSNACIVBYgZEbTPMQeaDFOUHKcRWdGX,CGCCVBAFBBHF.ZCBEEDGG.....TGCAQDFG.eFADhAAADAEDUFGCKFGGRADGdABChADAXDEC.fAFFhAAASDHBIFAH..YFEFhAFAPAHF....hAGA..aDCD,2,-35,-20,15
RbESADWMJBdUOPHgQcaCZIFLeVGfKYXNT,MDDFJCDDBBFGUBFD.HGFE..QFGGaEFE.ZCBBIGAChAAAeHEG..fDAAhAAAXADFTBBBhABAEDGAABCCDADEdEEG.OCAHPGBG...CAHFFBABhABA.....hACA...,2,-22,-18,4
FKcRdOWBJSPDALYHQaNEVXUTbfMCZGeIg,HFBBQDBEaAEEEAHBUGCE...TGFBMEFECBBHZBBGGDDGhAAAeEABFAGCRGFEdDAH.BFAChABAPDEAAIFG...NAAB.hAFAbACF.fFGBKEHF.....hAIA......hBAA...,1,4,-15,19
EbRJaWcgTNfAZHLCUVYQIeKFdDOGBXPMS,HFBGUCGEQDEAeBBHFDDFDEAHBCBH.MIFESCFE.hAAAEGEAREBEJAFE.aABAgACBhAAA.NIAHAAHBhABACBEDIGHDdGHC.OFAH...hAEA......hAFA...,1,-18,-26,8
EDAeHTSWXgRGdQbfVOUCZMFPNBKIaYJcL,TAFEXGEE.REBG.QDGA.VFDHCGAAMDEC.FAEGBGHBhAAAaCBA.JEACLCHHhAAAAACBSHAG.gCCEhABAdABHfGCGZFFFKADEIHHFhACA.EFEADBBF...hAHA...,1,-5,-24,19
McgPKECOXJTHLAaRYdfUQDeSbZIVWNFBG,RECGdEGFUABBDGGG..eACEZAEE....VCECFCCFBHCA.GBEBhAAAMAAB...PHFGhABACHECJDHD..HFABAAGEaEEDhAFAQGFG.SEACWCBD.hAIA......hBAA...,1,-17,-36,19
IBVeSKfLXWZORTaPCQJGUHgYcdAbNEMFD,EECAFEEDBDHF..VADBKCDCLEBBZABBOHEARAFD...aCHFCCBCGGEFhAAAHGAE..gEFEhAAAdABFAAHH.bAFBhABAMICA.DEAF........hAEA......hAFA...,1,-6,-34,28
LAMZVRbGeNCdIHDTJcKfQUOSYBEXWPaFg,VGFGGGEH.CEDEdDBCDAGG....JBADKCHF.QACEOCFCBBHChAAAEFAD...XECChABAPDFB..aGCHFCDHhACAAGDCRAEEeFAD.IBEF...cEGAhADAUAAE....hAEA...,2,-38,-11,27
JYFCAMRDIOcENZSBGXUHeQbPVdKfLgTaW,MGFCDAEEOBAH..EFBCZBEEBEEDUDFDeCBA.QAFHhAAA.VGCCKGDFLBCHhAAATABA.aFBFWFAFhABAJFHBCGFD..AHHERCEA.NBIG.SAHBhABA......hACA...,1,-2,-39,37
BRVZKbYQJUEdPDNLOgIXSGFcHfaAWMCTe,MFCCeGECBCAAZGECKFAHQDCB.EABEPBCG.LDEChAAAgAEA.SCGDhAAA..hADAFGCBHEADAIDACBAARCAA.YAFCdAHADGIFNIDFIFGBhABAcFDG....hACA...,2,-32,-3,29
LUEKScBMHefNRYQdCVJDZWPTGAgbaXFIO,aEHHFGCDOEEELAFG.KEDCBFAF.eFBFRAAAdEBE..CDCFDBBFZADFTGEDhAAA.AHCD.XADGhAAA.IGGGhABASDGE..MDEGfGAGhABA..NIEHYAHHhACA..,1,-31,-35,4
MbTGRQIKEAYaNFXUOVPeBSfHgdJcCLWDZ,aHDCXFGG.UCDBVAAB.BHAFHGCAdFGAJACGLEAAZECAMFBDhAAAGCDD.IGEGhAAAAAGHFBBHOCGD.hACAeAHBfADECHHDDBAB...TAGHhAEA......hAFA...,2,-23,-7,16
DLWXBKCUQOVJgEcdMfbYNAFGZITaeRHPS,ZBFHTBABeFCD.RGFGHCBADCHDLADHBHAFKFDEUFFA..OAAChAAAVFCG..EHAAdAECMDIBhAAA..fDAGhACAbBEHAAGC.FFGAIFAEaAGA.SHGAhABA.CDBH...hACA...,1,-8,-16,8
fFaZLdVcBeMAOGRbIHWXDECPUJNYQKSTg,GCDGRDBFHEFFDIGCCBBAUEAH..JAFE..QGEEKEDG.SHCGhAAATGCFFAACaAHDhABAZACFdGHABEAC.AIEG.hAEAIADG.XDGFNBIG.fCAGhACA...hAFA...,1,-16,-30,14
LBWFfHeJZSOdNbETRYUDGKAPaVIgCQcMX,VFBBCCCA..QEADMBBD.LAAEFAFBHGFCJHCAZACDSDFHhAEAOEEAdAHGEFDE.hAAARAED.DIDGAHID.aABFIGGGhAGAXFDBBAHA.fBBCNDEF.hBAA......hBEA...,1,-11,-18,7
ZcdTfegMHYONPCUBaIJDFGWbSVAKRQXEL,QEAHLDCGZBGFdGFEeFADMBABHGFGOBBCCEABBCBF.aGCBDFHFhAAA.FGCDGABF.hABASGDHAEGHKCEGXDDGhACAEFFA.TBGE...fGAChADA.NEIG...hAEA...,2,-21,-8,13
KNWfSBbaLJEYCMVdTAgIXDHQGRFPeOcUZ,XGDDHAFEQCFFRFGF.eEHHOADAUCACZCFCKDDF.NAAB.fBDGhAAABFEF.LCAFhABAEHFGMFABdGBFAFGE.hAFADEFE.FDDH.cAGB...WBBHhACAaBBACHED.....hBAA...,2,-17,-5,12
aWITHCOcKJNSMdYQXUeBALfPFZVbRDEGg,LDBFFFGHZDCHRAAA.GEDA.aACETBDHCHBF.KCFB..NAFE.dCHEhAAA.QFADhABA.eHDGBDCAfEEEhADAVAGBDGIFWBBGIAFBHFFF.JDHDMIAAhAEA.....hAAA...,2,-22,-5,17
JaDOQcZKCLITFMWfSHYbABeXGPERNdUVg,BGDCXDGEEFAEdACDUFEH....VGEGaAEADCCD..QBEEhAAAKFBCCEEB.IDCEhABATAAD..MDAFhAAASEEEHBEAAHFHPHAARAGFNDIG....hACA..OBBB.hADAcGAH.,2,-18,-16,2
PVUAacTFIfKJCeODXdgGHYEQRSWLBZMbN,TGGCFGDG..IADEKADE..CEFEOBFCdHFDHAAB.QEFFhAAARBAFLFDDBDCBhACAMDEANIAB.UGAD.AAAFaECGhABAfAGG.eCEEDFFB.gFAGhAFAEACBSEHBWAHB.hBAA...,1,-14,-23,9
LJGWbEfOAFXHKYSIaNBQPcdgCTVDRMUeZ,HACCSHDGaBAHQGBCdCAC.CEEB.TFFGRCCH.MCHDZAFHLFHDhAAAJBBAGEBFEGFBhABAACIHKAFB..NAIC.cFAChAAADGEH...WDDEfBBG.hABA.....OFHDhACA.,1,0,-23,23
aNLEBGPReOIYMTbKgfdZHFXQCVSAcWDUJ,DHEEaFFALBDABHBFRCCG...eFEDOBAHMFBDKEBHdDDF.FBAFQBGChAAACDGA.AHAB.hABAUGGF.EAGGIEFAhACA...TFGHgEBBZFCD.hADA......hAEA...,2,-37,-17,20
KXHFbdfEeSVBPNQCROZYaIAJTcUGLMWgD,TDDAGEAHMABE.DGADHFCA.bAFDEBEG.eDEBBCBDQGFAhAAAOBBGaFAHIBBGhAFAAAACUGGDLHCGhACAKDGCdHCHSCDFNBIECAEB......hAGA......hAHA...,1,-1,-15,14
NUYKgBSDRaTcXAJCbZWPHLQEIdOeMGFfV,CGFCZDCHHDEGEAEA.dBFBMCCAGCAC..VEEEUACE.KGCGBAACDAIF.hAAAaGBB...TAGAhACAAHGD...JDAB.hABA.WFAD....PHEGIHHEhAFA..ODHFeDDD.hAGA...,2,-29,-17,12
EaHXKeJUOVAGcgQBRIbCYMPLSDZfNWdTF,GAFCQDAABAABRAAG.CECF.MECELBEDDGDGZCGB....fCAAhACANIAH.TFAEhADAaAFDXGGChAAAKGGEeFDHOACAAHFH.IAHBYCHBWDHHhBFA..dHAH...hCAA...,1,-13,-24,11
BPFdQAgbVILJaXeCcNHGYRSKfOMEWTDZU,VBECJACC..eHCCCAHG.HCEARAAC.KEFAMDID..TBBAUGEFBEEChAAAdGGAACGG..IGAAhAAAaGAA..NEDE.SCHHhABA.fAFBWDAC.DECGhAHAZFGH.FEAE...hAIA...,1,-23,-25,2
fYaIWNSQUdRHCPOFeBbKAGVXTEJZgcLDM,VBGBTEGA..EECDJDDH..ZFFGLCEADBCG.MFCHaFAC..hAAA.IHAESCCAhAAAQBABdEEBCBADPHFEhABAeAEABGHH.AFFHgEAFhABAfHAHNADB.....hACA...,1,-16,-22,6
YfDFMVZEgKAXebJCWaQIPcNOdUTHBLGRS,XBDHeEHDCDDH..QCFG..cFADdEAFHGAGBACFhAAAGABBSGEHhABAfFFCFAFBMCIBEAGDAIAChAAAJEGDICAGNEAF.OFDF..TGCDhAEA.RAGF.DDIDgBBAhAIA,1,-8,-14,6
BQUaXCVbWgcATfYRHOSJZDMFPNGdeIKEL,TBDDRDCAOBGB.ZFBGFCHD.GEEBdABHKAEBBABA.UDAGCHAG..hAAA.VGAE..gGGGhAAAADDB.HCAHhACADGDENAEDECHFaHGG....WFFCcCEEhABAfAGB..hAEA...,1,-13,-30,17
aTKISMUHEgbWfLZADXPYVQeRJdNFcOBGC,XGBFVBFG.RAAA.JFDE..dFHAFEADODDEGBCG..CFFDKCCFhAAASBAAHAFDEHDE.hAAA...bEBDfEADhABAADIFDFIH.PBHFeHFEBAEDTBDGMIAGhABA.WEEE..hACAYFAF.,1,-5,-12,7
EGfUNWZJeBTHbIRMCLgVdASXPQODKFacY,SHGEXFGG.QBGBDEDFFDAE.aDDBEBAG.GGADUACEZBEFhAAAeADABHBCHAGBbFFGhABAMEFH.CHHA.LBBFhAFA.gGDDAAAAKEGE....hAGA......hAHA...,1,-9,-12,3
VPGECAZOJBLceRdfIXHFUDSaMKgNWYTbQ,ZACDBHHHeHCAdDFH...XFGAFGFGSBDCKGBC..NBFG.TECFhAAA..bEBEQGCBhABA.GCAHhACACAFBAHABLAADfAHCHAGBaGAF.MAEAhADA.....hACA..WFFE,2,-22,-12,10
PQEbBGOfeVWCJDaHXTMKdINUFSARLgYcZ,RCFFLECE..gCCDZAAFQGAFBFDBGCAGeFGHCAECaGEFhACAXFFG.MBIDhAAAKAFBNDDFUAFD.FACChABAAHEH...PHFEEACHODHFWGAGDIAC.hAHA......hAIA...,1,-3,-18,15
QDENbgXWITSYPHFAaBGdMVUfLJZCcRKOe,BGABMDEGUBAHLGCCZEGH.REFGKAAH..QECEDIDG.EGBDhAAA..gBFChAAA..WBFASBDFhACAPFFHABDCaECC.dGGDJDABCDEDOADAhAHA.NAIC.....hBCA...,2,-28,-24,4
RZAIfcNVWECFOBeGDdUMaHJSPKgbYTLXQ,..IFAFfGGC..VGEECCGABDCCeDAEdBBF.MAAFHEFChAAASGCFKBAA.hABA.YBEETDEDXEGAhABARCFAAHIHNAEH.EAEFODDDDGBDUAGDaGCF.hACAJDAB.....hADA...,2,-8,-8,0
ZNFULbCDdHgWXYQJaBGPOIMeEVKTSARcf,RAFCZACAUDBBCDDHHFGD....XCFCJCFDGFADOAAG.MCBChAEAeBHB.KCCEAFFC..hAAA.fDAHhABAFFHDDGGBdHCF...WFAGaHECIHAE.hAFA......hAGA...,2,-34,-16,18
IZUfQNCDTPMaVWSXYGOAeFbKEJLHRBcgd,FCBEKFDFLDCCBGFDdEGDZECGQGFD.CBGC.DAAH.MEAC.hAAA.aACE.SCAFhABAXAFH.ODADhACAABHAEFAH.JCHH.REEAIHAFfADH.NIAB..hADA......hAFA...,2,-43,-20,23
ZVQdUIMCHATPLbXEOGSacKgFfBJRWNDYe,LDGHXFAGGGCDSGEH.KAHDfBHEBECA.RCDHDDGHhAAAeDDEZCBFQABFhAAAdAEFIHHBCGCGAHIHPFAHhACAOHACaDAFFBEANCIEYFFG.MBAAhABA......hACA...,2,-16,-5,11
bBOcQYZUVNSAgMWGCfEDHFKITLXJRPaed,MCAGGBEH.EEEBHCEFKEAALHDGRADCeBHFBFGFQAACUDAHSHGGhAAAADDHCEHF.FFHDhABAIADF.TGAGhACAPHBCaFHD......ODDHhACAcFDH....hAFA...,1,-7,-22,15
OUKSDXBeEbdWNCLfGgVZJMHIcFPQAYTaR,TGEHRAFAKFFH..DGEBBBBB.eAFEECCDdEADCBAGLECGGADAZDGFhAAAMCGH.HADBFGAHAEFDaGGFhAAA.ODHF.SDADhABAbBAB...NIADfGBFhACA.....hABA...,1,4,-29,33
dLHMbOefETPGJAcCINDWKVgYRaXBSUZFQ,CADHDCGBKDGG..VFAGRAFB.BBEAZFEC..dBBCLAHDHFAG.OFDAhAAAeCED..EDABTABGhABA.GEGGAHIDIAHGhAAA..WDAGaCCD.SDDEhADAFHFC...MICC.hABA...,2,-23,-19,4
JadSOLTWXYUBAFMbPgeKERIDcNCGQVfHZ,FBAHMDEH....bFEDPEHH.KAHFEBGB.DAFFCFAG.GCCGhAAAQEBEHGAGZEGBdABCOFFFhAAATEADWAEDhABAUAEHBDAD.ACIH........hACA......hADA...,1,-13,-26,13
YfRGBNJCFMIbHQgZOLdcAKXUVTDPeWSEa,XFDAVBDH.DBDAeAAA..EHFAaAGGRBBBBBGG..NFBHFGDFhAAAMEFE.HGAAZBGBLGFEhABAACABKDAH.PFABhAEASCFG.YAAE.fECAhAEA.CAGB.IDBAhAFA,2,-34,-15,19
gcMGNHaXWIVfeKYSPDAdBECTOQZLJFRbU,BGEECGBA.QCFFLDHDRCBHUACFMAEFHFAB..XAFAhAAAIEHFeBACKEDGSGCBhAAAPGDG.ADAAdGGAhABAEDFFOFABFAGG..cDCBNIEH..hADA......hAFA...,2,-19,-11,8
LEGbfcVBTIHNPXeWCDdYOKMZJaAgRSFQU,RFABQBCFEEFG.GEAG..cAAHBGDDICFGhAAA.HEGDNEDAeCDBWAFGhABADBEAdDABKGHFZEEHAAFCFACGhABA.LAHFfCHEPFFBCACEMICA.hBIA.aCEA...SEHBhCAA,1,-6,-13,7
DKETLRJABIbfcVgUFYSaeCQHWNPOMXdGZ,BGCD..IGEG..fEECgCEEFEACSBBChAAACDDBHDGH.PBHFhABAOAAGdEAHGADDhAEAKGGBLGAAACDGcGFH..YADCaGAF.hAGAeCCBWAHBMFECDBCF.hBAAECAD..,2,-28,-3,25
IHJgdEOGcQFDASNReZXPKTYLUfMBaVWbC,SBBEeGBGZCAEKGGALDEE.MCFCBHAF.aEEC..VFGBhAAACACAHBEAJEAHECACOAFAhAAAQECCDDIHAABD.hACANIAH.XDFA..PFED..hABA....YEAGhAEAWACE,1,-23,-34,11
QdeMaVRIEFfBSGUcWDCZbHPgATNYJXOLK,TCEHJEABLEHH..KDHBeACCaGHBRBADFDEHBAFCGGBH.UAAEhAGADHCCCHAHZBDEHEFHABID.hAHAXEBAOEGHMDFGhAIAIAHD.EADH.SAAE.hBAAWDAD....hADA...,2,-27,-7,20
AVUcINGbBQfJHdaZCWDTOeKSEFgPYLRMX,UGBE..NBGCBAEBJBAFHFFFdHGBZDBB..DFEHOCAHKAGGFDCC.hAAA.....PAHDhABA.RFDGXABHhADAAAAEICFC.bEAGaEHH.CHAA...eBBEhACASDEB.EHDEhAGALDHB.,2,-28,-16,12
BVfAXDGgIRHeaOPMLWEbdQUSNKCYZJcFT,DDHDGDGERADBHGEGeADD.OFCAMIAGEEEFdAHEQAEF.hAAAUAAGSFBDhABAKFAHCGCE.JAFETGEBfCBEhACAADIF..........hADA......hAFA...,2,-28,-10,18
gKeABaXGHFfTIdPcZNESJVbMRDUCWYLQO,XBAGFGBE..TEFAdEEEZFAC.SCECJAHD.MFBAhAAADBDCCHGCLHBGOECAeCAChAAABDCEaGGB.fAEBhABAIEAC.NAIE.ECDC.....hACA......hADA...,1,-21,-39,18
CIWYNVOLBEaMPUeJZbGDSARgTXcHQfdKF,RFDDXGFEHAGBdBDDKAGHCFFD.....IECC..YAADhACAOCCEBFEC.hADAMACCUFAAZGAGDDDESAAHhAAAAEBETDFFfHFHNEIE..hAEAEBEGeDHH...hAGA...,1,-15,-35,20
QJXbOBRNTVaGYWHMIDZPFfcAdEgKCSULe,ECACKBEBCHCCUGGB.LCGDQEBF..XDDFBFGHTCBGhAAAaEAG..GFAFhAAAHEEHMACAIDHBZBGHFBABhABAAABDSHBA.bACANIDDWAHBDFFFfAHEhACAdGAC..hADA...,2,-16,-9,7
fUdSBNLcPKJMgbZHCGFeDYRATEaQVWOXI,aCEFVAAH..OFFD..fBGHUGAHSAAHBHFCNEEH.hAAALADG.PDDBhAAAMDCBZADHHBGF.hACAFEAFDAFFAIEGEEHHXGBEIHHCKFGA...hAGA......hAHA...,1,-4,-29,25
YCNRFgAKODGdIefEaZBQbPLMTSHJWXVUc,KDADDCEFGADDeBFG.EHCAZDEB.BDDF.QFAEbEAE.LHAGhAAASDAAJGFG.hABAXAAFUACBCDGA.FFEAhADAABBB.OFHF.IHAB.aCGCMIFAhADAWHEA....hAEA...,1,-18,-26,8
PHBcXRTUGWVLYOSNFDIgdJaMKfQebEZAC,HEEEBEGHRDCBTADAGGEFLEHH.OCACFABGDAFCdFAGaBHFMIDAhAAA.KGCGeBEFEABCAFCEhABACCGB...XBGDhAFAVEAB.SDCA..NAAA...hAEA......hAIA...,1,7,-31,38
ITYAbQcUPOGEBZLadNeVfRFCJMWHgXKDS,QCDFUBFDOCCHEFFHZDFELAFC.dEACeGDARECE.FFACCGCBMBAAhAAAHAAHKEDH.DAIBhAAAIHBHAACA.bBFHhABAPHFCBHGHaCAG.NEIG.fADChAFA.JHAC....hAGA...,1,2,-18,20
facObSTHDCXLBAeIRFUMWYdJEGVPQKNZg,eEDHRBCCMFFGdCFD.ECDHGDAH..QGAFKCGAZFBE.aBABOHBEhAAA.SBADhABADCIHCCBEBGFHAHIFIAGGhACAFEAE..WEHDVGECNAAF....fAEHhAHA..hAIA...,2,-34,-12,22
TOZKPIdHVEMXFRBcNYUCALJGeDWSQgabf,LADEeFCADBBG.SCHDQFGFaDDC..TCFHZFFHKFBHdBFFhAAAEBEGFGAH.BECGNABE.hAAACCCEAHEG..JFDFgDAFhABAOAHF..IFHDMADG...hACA......hAHA...,1,-19,-23,4
ZRSAQdcPaOeXFCGbNDLKMIYUEHVJgTWfB,dFECaEAG.OCFCFGEHGBFCDFGF..KBDAMBCC..UFAGEHAGJECEhAAA..TAGHBCACSHGEhABAADEH.hAAAPDHFCDBFNIEB.ICDG..YBADhABA..gAGBhACA,2,-53,-16,37
XHMZeGVBDFCKUPRAWTQNJLcSbaIOEgfdY,TACHJDFDLDBG..SBAG.IGBEECCCgFAChAAAdAGAXGFDhAAAZFDHeFHDVDEBFAFFKFHHPABChABAWAHH..cCDBaBHHOHAE..hAEAfGDC.hAHAMEABDGGH,2,-27,-13,14
dDVSCBgKRPOJHEaWZINFLecUAYTfbQGXM,TACCQAGB.MFFEVCDDBECA.RACH.JDHHHAEF.EHACZEAChAAAFGGBeHBG.UAGChABAAIEEbBADXGEB.hAAADBBBCGEBKGDDaGHH.WEEC......hABA......hACA...,2,-12,-12,0
aCYTPQJgXBGWdeOMRVSAUcZEIKHDbfFNL,UCGDZDEAEBGCKEEFHEAA.DHAEFFGDLFFB.CBDA.TDBE.hAAAQBDGXCAABDHBhABAdGBCMIFGRFCAAACGIHHEhAEA.NIAH.aABH.PAEG..hAAA......hACA...,2,-34,-7,27
RfCISENGLQKaHdOPJcDXWVUgAFZBMYbeT,ZEAEMDIFeEECRFAB.CGCD.EFFBLBEA.KBAEaHDC.HCBGdGFCOACDhAAAJAAADEEA..VAFAhADAAHGG.BFCH...hABA.YHAAfCEBSEGANEHA.hAEAPAEA.cCAHhACA..,2,-21,-19,2
ebSFGcVTEMICLaPfgQNAUJBYRKOdWZHXD,JABEREDBdHBHHFAHDCGD...eHDAFAEEGBBA..TAEGMAHDLFHBhAAAaAHF..hABAgEECAGGABEAEKACChAIAZCCB.XFGASCHHEDHHCAAC.fGCAhAGA...hBAA...,1,-3,-27,24
SfPENQVFGBWZIKUCgDcXebRdLYAMaJHOT,JFFATFFA..SDCCEFDA..QBBCFBABBGDDZDEEhAAAKAEFCCHHDIAAeDBA.dHBDhAAAAGAEMCCGaFAGOFHDhABA.NEED.VAFA.IEACcBGB...hACA......hADA...,2,-40,-12,28
gDBcRYZFCLHUVEGTAdNOeKPWSJQMaIXfb,dCAFOBHFKGGH...SFCDMCEC.aBDDXDDE..hAAAbFFGBFABRABD.FGDHCDAELEEChAAAUGABEABGAGIHNIAFeEADhABA....WDFHIHHDDAEA.hADAcBFG...hAHA...,2,-39,-8,31
MaFfWbVNGDIcPRSJZKTYELgQBUdeXOACH,MBEEFGFB....fAABVCADDFGC.....IDHAhACAPDDFRGEGSFCFhADA.KCCFTCFDhAAAEEEFQAEBBGACeFCBABIFCBGAaBBAWFAFNACF.cBDHhAFA....hAHA...,1,-20,-36,16
ObceBYMDZaVXQfHNdSUTWAIgJRFCPLEKG,JGECRAAAFFEGLFADGCEH...OBADeFCBMFBHDAAH.ZAFAaEFCQCCEhAAA..hABAfCFGNHEB.hADASDCHWEAFAFIB.ICHB.CGBFEGCHhABA.cAEB.hAEABCCC.,2,-45,-4,41
VJMSDaZQXALPfRbTOHKeIBEWYGFNUcdgC,LCFARBEHOGAGHCADKEDEBGAE..EFGDGABDFDHH.UCABdABHCHCAhAAAMIECDEEB.ZFFCAEAF..hAAA...fHBFhABAeCCHIAHD..YAFC.hACA......hAEA...,1,-21,-25,4
bPcYgGKaFDNXWOMQICJfHeRTSdEAVZLUB,LBDGUGFFBABD..PDDD..gDFFaFFE.DDABhAAANCCG..OBGDQDBHhACAIFAAJGBCeCCEhADASBAHAEED.bGAEYBDCKGHH.WBHBhAEAMACA..CHAH..hAAA...,2,-28,-24,4
LRfCWeFXADcKTdVBUaMgOZQHEPYbGNJIS,DGIBTFAFBAAA.UDGDaHEC....OEDEZAEDQFEHhAAAHAECECBA....PCHBhAAAbCABGDCCIHHChABALHCACDADFDDGADGBKADFMACGNEAG.SHAGhAHA....fBGBhACA,2,-16,-15,1
BHMfXdgDVGKaYQCNALPTWFJbIcESZReOU,TBCCFGCB..IGAHSGBE.ZCEGREFGeEDBOEFFHAFHhAAAMIDGdBDGDABEKBACaEABCEAGAHHChABALEHB.PAAHhAEA..WHDA.....cDAAhACAEAHDfEBHhAFA..,1,-5,-34,29
KWXRbETMLIJFaNHQSeAUVCcYgfGPODBdZ,CABC....gAGCGAEFODHHBGHCZEBHKDEFRCBBTEFC.hAAALDDHIFFHJHDEhAAAFHCGaBABHFAH.SADChAHAACBGcBDFfGAADGIF..hABA......hACA...,1,-20,-23,3
LCTSWdEGIAZHBDUFOQVNbfKePRMaXYcJg,BHGDFDFFOFBHQADF..VABFbCFC.KBED..eCAAMHFAhAAAXEDH.JHCGhAAALDHBSAGFhABAWEAEEFFGADAC..DAHHfEAHaGCA..hACAcEEHCBHA...hAEA...,1,-19,-30,11
IVcDaBELbeNZOXRUTgSGdJHfAPWFQMYCK,FBBBQCEGCFAB.KHFA..IAHADFGGEEAGLGCA.hAAAeABGOFDHRCCFUAGChAAAgEGD..hABASGGEJADDAFFFMAGD..YFAFhADAaBEDBCHC.NIEFXDAAhACA..,2,-28,-20,8
HIYLBdCWZFfbQRVeTgEJaGXSDcOPMNKAU,HCFCLAHBdEFAZFAHFBCFQGCFeECF.EAGDJADH.aAGCXEAGhAAADEEB...OCEHhABANAAEKCBG.IFFAhACABHFCCHHG.fADD.....hABA......hACA...,2,-26,-14,12
PNcDWMOAGCBQVFKTeILHYgfbUXaERSZdJ,CGBFBFABFAFG.eGEAHDAA....fCBHXEDDRABDZDEGdGHCPHAChAAA..NICDDFFAhAAAMFIH.AGCE..QAEAhABAVCFGKAHHIADGYAHHbDAE.EABHhADA...SHFAhAEA.,2,-18,-16,2
KbJXcBIOdPWQTYZfDVFEeRCNHLAGSgUMa,SGBGMDECKAAE...XBFFBBGAdGBFQFGCZEGDDBIBFEFHhADAEDDF.CBBELDCFhAAAACDDGACH.aEFG.bFDH.hAFAIDAE.WFAFfGEGeABENBIA.hAEA......hAFA...,1,-6,-40,34
SaTgPUdWJQBNRHDVIFcELAYCGeMKXZfOb,GCAGMDHHKFACZEDG.OHEG..SHBCaCGC.PAEFhAAAdHADQADEhAAA.BCDGRBAGHFFFDABEIAGHhAIAEAHHAIDGCEFFeEDB.fDADhABAgEGH....WAGFhACA.NCIE,2,-26,-26,0
eOabBSLEMUVPRHKFWgfACTdQNIDXJGcZY,CHDBdFCB.QGFDDIGGGABFZBFH..eDGFOCAFBGHAEGABMEFBhAAAUACH.RDEB.KFCDFEHD.hABA...fEDEhACAADHEIAADXGAH.JBFG.cEABhAEAaHCA..SDCChADA.,2,-23,-19,4
KDcFEHabJAfMBPeRNOCSVIUgTXQGdWLZY,MEDGeBDHREFF..OFCACAAD..SCGCIHAD.UFBHTADAhAAAQDAD.hABAdACGWCGHLEEFhABAKAGCDBBBEAGGaGGBAIGCBHHBNDCH..XGCDhACA.....YFHBhADA,1,-20,-22,2
TUVRXSgIZLdHPGBNQAKYMbJCFcEeaOfWD,MFDEJGDE.FDDEEDDB..eAFCOCAA.DAAEUGEE.REAHSBAChAAAZAFHHADHBHGDQCGHhABAAEIF.KGHFCDFGaHAAhADATGCF.....gCAChACAIFCF.....hAHA...,1,-7,-38,31
HYDfWRSONMFBKgEebdUQIXTcZCPALaGJV,LACGJBDEHFAEDEGDRCEAOFFC..FDABBAGAKHCE.eHCAUAAHQDCGhAAA.TGAGhABACFEFABIF..aHGG.hADA.YHFG.fEAAWCEASHAGhABAMCCAEDHFIFHHhADA.,1,-1,-51,50
YfGROZCbLKQdNVDXFTaAWSUgBPcIMeHEJ,SFEBBBFD..PGAGMBBAEDHB..JBBEGECEREFCZGEE.hAAACCAGLCCEKECE.hABAQEAF.hACAdHGDNAEDDGIFXAGAaDDAACIBUDAGcGAC.eEEEhAAA.....hADA...,1,4,-31,35
QeTRMGWSEYIVgJcAaLDPOfFBXCZdNHKbU,aBBFLBCB.DGCGOFHHFAGDBBAHCCHAdDEHHEFC..UFCEeFAChAAAMDAFGGED.EBEDhABAIBGD..hAAA.JACCAADA...fGFANIABKCHH..hABA...QGAAhAFA.,2,-37,-15,22
EegLaBDdCOIRVSJbUHYZAfMFXNPGTKcQW,MBDBXCGCGAGEKAGA.QGAE.EEEFeHCCLFGFhAAADIEACEADRCAASFCBhABAUEFD.YAFDfECChAAANAEG.TGAE.gABEBCBAdCACOEHDhACAICEC..hADA...,1,15,-31,46
SdZMeUVcYTHDWLXKNabAgFfPIBREGOQJC,FEDH..PFAGBCBEEFFCOHCE.CHHF.ZCFA.MHBCeABCUAGAhAAAVBDG...TFEEhAAADDBBXABEKBADaDGAACCBhABA..IHHCQAGFSFAAhABAcEFFWHACNIBH..fAEAhACA,2,-28,-22,6
ZXVDASWBJcRTgLFdPKQGHaNMCOfIUEebY,BCGDRDECLAFGFBDAdBAGQFCCHGEE.MBBDCHAH..ODCChAAAICDFEEAH..eFDChABAbGFE....YDAFhAAA...XACCACHASDHHhACAcCGAgGBBhADAKFGEaHAC.NAEB..,2,-32,-4,28
BHdcDOZGULaYKCTfIEQePFWAJNgRVSMbX,JDCHREFDMAFBBAEC..HCBFDHFA.OHFEZBFD.LEEFKCHH.CAHA.hAAA..TABGIACEhABA.EDHDeFBDFHAEAGCEhAEA..NEEC.SAGDXFGA..dAAC.hAHA....cBDDhADA.aAGA,2,-35,-13,22
CWbdEIXUYgBMZDGSFAeRHVKaOQNTJLcPf,HDEGKDFBOECHTACGLAFC..fBEHCHFG.dAHEhAAAIADBUGCHBBAAhABAMDCCDIGAFCAGAGGBeEAFhACAVFGD...NDIA.JBHH....PCCBhAEAEAAE......hAFA...,1,-9,-27,18
VHOQXAdMLaFNbgfWSIGYcBPKTZeDUJREC,dAGAMBCBaFEBFFGE......bFGHgAEA.SEFChAAAYBACBGFGhAAAKGDAZEAGDIDA.UFBBJBHFCDAEhABAODEEACAG.NBIAICEDPHAE.eDAAhABA.EADE....hACA...,1,-19,-25,6
QDRUWICPcHGNOXbeEgBJFaMVdYLfKATZS,ZCBHSACADACGUGACCDFC..HECGGFEHOFBB..eAHDBCCChAAAaBEHMEHH.dAGCfEEHhAAAAAFBQGEDhABAIHEANAIA..bDACJAFF.....hACAFDHH.....hADAYBAF.,2,-17,-5,12
ARfLbJUNGZFBEaICWKgdeMVODXHTcPQYS,RAABLFEBUAEGGEEDBBAHEBEA..CBHGKDDEdEGBMDAD.DDBHXGDAhAAAHCCD..PHAChAAASHAE.hABAACAFJDBDFGGGaCGG.IAHA...hACA......hADA...,2,-35,-13,22
QMeURdYVJCgcHZPGEWDbTKfXSFOaBNLAI,MFBHeECGUAEBdCBH..JEEACDGHHGFC.GBAEDCFCKGHD..fABBhAAASAAAOHBAhADABHDHAFDH.QADBhAAA..YAHH..cAGAhABA..ECCG.hAEAWFAD.,2,-42,-26,16
WGLCgHcBKeZbYXJdVDASPUFIOQEaNfMTR,SFBHUBBEOEDHECEH....aEHBMABERGEE.LFEChAAA.CHED.HAFHKGGDZAGHhAFAXEABVBBHABFEFEEG.hAIAICHF.NAAD.WFHH....hBAA......hBBA...,1,-22,-24,2
FWMLTHPAdaQgGUfCVYZKXeSEIbONJDcBR,dABDaFCGGBEGCDCAZFFB.KBHH..SGCA..EGEDOCFChAAADGHFBBBHFFBCMBEHhACAHDAAPHBC.AGFGQDGHhAAAfAGFXAEFeADHIGAHhABANEIG.....hBAA...,2,-38,-5,33
MefYIDFXRCJOAgZbHBEQKTcSVaNdPWUGL,ZEGDBACBKABASAEG..NFCDdDEBUEFELHAAeHBE..hAAAIHHFDFIFFAFDRFAGJBBFhAAA.AAHG..HDDFEBHD.hABATBGCaCCF...PFAE.MBAFhABAfDADCEHA..hADA...,2,-32,-9,23
VOfUFHCbKBRJSdZQMAeaLXYgGDcWTEIPN,LEDAXGDEGCEBDAIH..TGGDIACA..PAABhABAVFADUAFDCGAF.BEFDhAAAJCCGdHDFMBBHaCGFgGGChABAEEAA.ODCFfAEF.hAEAFHAE.....hAGA...,2,-17,-14,3
IOAHYFdRBTQcKJZWGgLEUCVNeSabXfDPM,HGCGdAGGRBCBBFDDQBGD.KBACJFFFGEEDLBADEADHCECD.eFABhAAA..SFABhAAAaHGEXDABDEIHMECBhABAADDH.FEFA....ZAEB..WHBAhACA......hADA...,1,7,-41,48
BEOIdQNTXbHAVeRfgWaFUGMKZJYPCScLD,RCFF..fBDGaECBFCAD.MIAEKAGBZFDCJDED....CGHASCFBhAAADCDAOCHDdFAAQCBHhABA.XAFEhACAAABDeACG.UGFE.YGACPFHBBEEDhAAAIEHENIAD...hAEA...,2,-27,-11,16
fgQHcTSKXAUeIGLaENMbZWROYPBDJdFCV,UADDeEHBLBFHEAHB.MCACZBABREFEOHCABHECDBGD..dDBChAAACCHG.fGGEhABAHECD.TEDEXGABhAAAIGAFaGGH.NADH.bCCC....WBBEhACA......hAIA...,1,-17,-20,3
ZSaYfGdUKHLJPgbXEDTWFNMIQcRBCOVeA,ZDEDaDEAGAEHUAFFLEAC..PFAD..gBADhAAAEGGDDCHHFBAFMHDCICCAhAAAQDGE.hABABHGACHFDOEHDACCGSGAAfFCH.hABAKDAD.....hACA...,2,-29,-15,14
FQXLPUBJMbGTIZWRCKAHdDOVfESacgNeY,dHGDDEEAOEGDEFGG..aCHB....gGAFeDCGFCEGLFBBhAAAUBDHBBBBMABFhACATGCDIGAF.hAAARACCKGDEACABfDAC.NIEBQAGFhABAJAFC....hACA...,1,-8,-34,26
AQaebdCTLBZEUOMSPKIWJcHYFXfRVGNDg,aBDHdFAHLCEBBGFEZFCH.UEGC..MIFGKBBA..JHDEHAAD.hAAAXBFARAEE.GEAGhAAADIACADAHeDBCTEGChACA.EAEASABEIEEC..WAHBYAHBhAEA....hAGA...,1,-1,-34,33
BRUDMfEbgNHVaeYIXPJKLdFZATWCOQSGc,CDBESHFAGBFABEHFREAF..UCDEDCBE.EDHD....NAECHFCFhAAAVEFB..eAABIHHFhABAXGDG.PAHFhABALFEH.dFAFADFGWACFOAHDcAEAhAGAfGAC.aGGBhACA...,2,-29,-6,23
eCdGDMKPVIbSgfNBHEQaJAUWcTORYLXZF,UGBCTDFHODED.LCCDZBDGCDBFDGAAKABC....PFDBhAAAIHFA.SEGFhAAAfCHGHBFChAEAEBBAJFHDAFAGRADA..YEHBeACEMBAB..hABA......hAFA...,1,-15,-28,13
ECPADTSHFBeVbMagJWZNOQdKXIfGURcLY,DDDASFBBHDABBBHEeFEAMEEG..aBDHJBCAZAFH..OGCChAAAKGHBXCBD.hABAfADDUGFGcAEAhACALDFA.CABEAICCFHAC...bEFANAAGIAHAhBBA..hCBA...,1,-21,-23,2
VJHRbLOIdNFPXcfeKMGWYBgEQaAUTDSCZ,UFECSCBGZBCHHBFFLDGDdFCA.FCEH..XEAHeFBGMBEGhAAAGEGABACGQBAHhAAAaFHDAIEEDAFGCBACJAHFOAHDhABAIAEC.NIAH...fHFDhADA.WEAF..hAEA...,1,-2,-27,25
dgBZCJEHceMIUNAGbYTKWFXRfaVSOLDPQ,GEEFTEBC.FCCARDEF...aAACOABBLEAHDIGGdHCBBFCECFHBHBGDhAAAeDBGMAFD.UAGAhABAAAEBKDCE..fGHAhACASGGGgGDCJFAFEBEA.IADBhBGA....hBIA...,2,-17,-14,3
MXVaAWBGHcKNPSYOZEQCITLbfegFDUJdR,BCCGHGCGKBGGSADCOADGZBAD..CHFGLAAHeDCHDFBFdDGChAAARCFAMBEB..aGGHAHEHGFBBhACA.NFED.ECEBhABA..TGGAfEEEgAFF.hACA....FHBC.hAHA...,1,-9,-21,12
AgdCBXGSIWcYbHNZVLODRaKTQJPefEUMF,dEBCBFBHSCDB..cAGBHAGFVDFBLBCHDGHDKBAEhAAAJBED..eDGBUFCAMIFGhAAAAFIHCAFH.GBAA.hABAICHAWEAD.NACHOFEHaADG...hACA......hAIA...,2,-21,-13,8
CLaNReVESTWcQOHfFGMXbBKYIZPJdAgDU,UGEAaBDE.RAEF.EBHD..SCAF..TGDCQDFDhAAAfDFBFDCHMBAEhABAXCCGKHBGZAGFJFAHAEEDCCCEhACAeFFA...WEBGOEHDHAAABGCEhADAIHHB.dGCG.hAEADCAD..,2,-15,-3,12
KgRJNCOXEHdMSZFbAWfYUcPQTDeaIVLGB,...fFDEUADEQCFHDAAA.eBAAaBHFLCEChADABGAHRGFGCAFA.EAEAHDDBSEEGhAEAFFGAABAA...cFGDhAHA.PCBBIHCCKHEGgGBGhAIANAIG....hBAA...,2,-21,-18,3
caNIdRJEWGHUBXZCfKPQOYLMDbTeFSVgA,aCFFdFDAEBGGGCDGHCCABGFBCBAD..KBBCQBBELFAHDAGEeHAEhAAAFHFESHFGhABA.VDADACFGIAEEhAAAWEHH.UDGCZAGH...fDABhABAYACC.bEEB....hACA...,1,2,-17,19
fbUTPWcJgEDdeNBRZHVFOMXKGQILAaCSY,SDHF..fCGDTEDG.PEGBJHBCDADEeDEBhAAARCADZABHFFBC..MBGFhAAAXCAGKGGB.IAGDhABAAHABCGFC.bBCEcAGFEHEG.BDEEOABChADA......hAEA...,2,-22,-22,0
eTaIJGEPUbCfZFMBcYOWQLVNAdDgHRSXK,dEDEDBCBRDFFSDAE.KFGGeDAB.IEDEJBBCGGDFEGCH.hAAAUBEE..fHDHhABAFBHHBEAAOHAChAAALCEEAGAA.XACB.aAGGCAHBMACGhABAWFAD......hAGA...,2,-24,-22,2
ZCTVIHYFAJEeONgdKUaLBDbfcMWRXQGPS,eAEEOFAFdGDBKCBDLFFHBAED.DAIF....fAAFhAAAMCCHXABAQFDBhADAGCGASDEFhAFACDEAIHHBFFHFAAACNCAEUCFG..aBECWECDPFBBhACATGFE.YAHHhAGA.,1,-7,-32,25
fYNIdAMBgZFJCXSVDQEHOGebaUWPRTLKc,MGDGBGHFFDCD..JBGHCCGF...SAABDFBHHEEDGADGhAAAeECEaBDE..UBAGRFABLHFEhACAKEGC.cACBhAFANIBB..AAHB.........hABA......hACA...,1,-21,-38,17
SGYTFcRbJaEUXIVHPgBNfQMLeZODWKdCA,GDCETGGH.FBAARBEA...JAGFEDBB.UEDE..VFEDHACDBHHFhAAANAIC.QFADhABALFADeHDGZBDHDDADKAEEhAAAABIB.SDFH.YBAD.hACA......hADA...,2,-27,8,35
FBEeXZVIbQYNTJKaOSdMAPCcWLDHfRGUg,CAHHLBBCDCHF.HFFCGBBDFAFCECGEZFAF...VCEBQFGAhAAA.TFDGJEAHaHAEhAAAdACFADDF...cDEChABAWCCF...fGCG...hABA......hACA...,1,-21,-23,2
UIWLEYbDQAKOGcMFHSgJdRXaCfVTPeZBN,OFHFMBGBHEDC.SEACdEFDRBFECABH...VAACeEABBHHAhAAAUDCGLDHFEGGDDGED.hAAAAIAEKGGFFBCE.JGAG.aCDDhADA..fDAD..PHCEhAEAIAHF....hABA...,2,-33,-2,31
SVdAGaFCgMTHRWXeBIUfQYNcPLZKOJDbE,GCEECHEC.MFBDRCBFeDGHBCHAUFBB..fCBFQADDhAAA..NADH.LAFHhABAKGCFDBCGEGDEdAHAFEEB.hAAA.TGGAWCAFIGHHYBADcAGDhABA.....hACA...,1,-14,-24,10
aVUOfLDEMdNKCbFcgWeZGBXPYRQSTAHIJ,JDBBaAGA..UCFHLEDC.DAHHMCBCKABD.FFHH.....hAAAgFABeCGBZADEXFDHhACARDDBQGEHhAAAAIEE.IACBOFAHfGGCEEBGCBAF.hABA.WAEGBFFD..hADA..SGCH,2,-36,-8,28
CHgDefXRWTJYdUcSVNaPFbAEIOZQLGBMK,EDCAZBEHQGADLDBDGABHMBBDCACHDFDB.eAGFRFGD..TDCDhAAAdEEFSEHFhAAA.NICB.aHDC.PAGDhABAAHIBBCHCKEAFfFFEJGDC...YFAFhABA...hACA...,1,-5,-17,12
eGCNTMAYfPbaKgdOBcEVUFLXDZSQIJWRH,...fGAFbBGBKDBF.dACDOCDDBCDEEHDCFHGGLDFDhAAAZDEGSAGGQGABhABAIGGDJACB..WDHHhACAeBAD.CFDGMAFFAAFC.aHAEcFCA..hAEA......hAHA...,2,-19,-15,4
GdITOScUDHJLXAZYPaCWKRQFNgebfVMBE,ZFFEaBBC.CFDC.REFH.FBAB..eDAA..VBDGMFBF.EHDAdHAFOCHDhAAA..SAEEhAAADFDEJAGDAACF...PCGFhABAQADE..gDAFhACABDECIHHG...hADA...,2,-40,-18,22
KBZVdFULQDcGCAReEIObPNWgHSfaJXMTY,ECBGOBDB....bDADNHBB.HEDF.aAFEXDGC.MAEGhAAATCFBKBABBGHHhABAdHGFFACGLFEADIAACCECACHCIFHChAAAgCEFSBAFJDAF..hABAYAHB..hACA...,1,-3,-31,28
cdYJEWeDLbgBVaGOFQNfZAMPCRSTKUXIH,CECCTGCGUAFC..HDFCdAGBEDBF..DFFFLEGFBHBBGABDhAAAODEDFCABQFABhAAAZDDDAAID.MCAG.SADBhABAKGHHXGFHIFHH..JEABhABA......hACA...,2,-21,-10,11
IMHeZJWUCFabfRXOdASPVBNDYGEgLTQKc,VDEHDEIDGDFA.EBEFTAEB.QGGBKBCEMEADHAABhAAAeABBZAGHJHCE.UDBFFHGE.hACAaGCDRBGD...OEAHhAAAAFEHBGBG...NADF.......hAIA......hBAA...,1,-8,-14,6
OBQfeEgAYJKGDIZTWUNVXPbMcdRCSFaHL,JBBEKBEADEFBZDAA...UEGD..VDGD..XAGEMDDCRFEF.hAAACHEE.FAFGHCAG.BHGDhAAAQFCFeEADACAE.hABAIHBE..TCGHPAHD..hABAdEBHaGHDLHAAhACA.OBBA.,2,-16,-12,4
JIKHMdBLFgAVRZTQWbGYeDXafNOEUCSPc,ZBGDQEAFGBBDDFABaDFA...OEBACEEG..SGGGhAAAJFBBKEHHHFEGMCIHBAAHhAAAFHBGgABFhABAAIHA.TAGAYACCfFGB.EBDHhAEAcGDCIGEF.hAGA...,2,-31,-7,24
ISPRTgEbJDaZKFHUQGNAXcVCBYfLMWdOe,XBCHCDGABACBLAABdHGF..eDFHSBEHRFCDEBAA.DIACaAHBhAAAZEEHHAED.QDADhABAGEADAGAE.cGAChACAfEHC.MHAGIFHD..hADA......hAEA...,1,-4,-35,31
IGRJCgeQFbXNABTLPHfdDZKUcYWEOaSVM,BAAFTDFCHCFH.DFBFKCBAUCAH....YABCOEEDaHCEhACAMFCHGDCCRAEHCHDAeFFBhAAAFHGC...NBIAAGADLAFEhADA..PEDBdCHEWBBEEFHD..hAEASGAH.hBGA...,2,-14,-10,4
IMZEXfdBOWRQAYKJFScTCDUgeNPbHGVLa,KEDCJAFB.FCAD..SHDACCCD.DDCDUGED.eFBH..hAAAbAAAGAGGLDDHhAAAaACE.MGFEZFGHEFAFfCAEhABABDFE.OEAH.RDFGACHE...hABAYHBE..hACA...,1,-27,-30,3
OXZaNbPLeYEfgIFGKVCUTBDWAcHRdQJSM,RCCGdBEAQAEASGAH..MIFEOGCEaDGA....bFFAeEAEhAAA.EAFE.fCCEhABAgGBBIHHChACAFABEKAGACHECTFFGBEGBAFEDHCGHXEAChAAANICB......hABA...,2,-14,-4,10
bGfecgAOUICDBSKLJZNaVTHRQdFXYMWEP,ODHDCHCDBEGCLGDEZDCC..VFABRDBFFBDEMCAC..EAAFGGEFhAAA.eFCGAGIDDAFGhAAAKADG.aBEEQBGHhACA.XDDFWDDEfABFhABA......hAFA...,1,-20,-33,13
DNSTMAPXQgReKfFdJIcOYZHWBEGabLVCU,XFGBQEAERECC.KBCC.dDFF..IGEDOEGHZFCBBGBAEBAHhAAAaAGGLCHB.hAAACAGBDABENABBMDEE.ACCEeBDGhBAAfAEB.FCDDYBBF.hAIA.WFFD...hBCA...,2,-32,-10,22
HDcRJVKTOMIQSaAECGUgZbFeLWfdPYXNB,CBGAUBDFZAEH.FDAELEFB.dBAGXEFDHECGDAACRBGH..KEDDODHFhADA..IGBFhAAAQGADAIFEEBAG.hAGA.gCBB..eHFEWHDG.hABA......hACA...,1,-14,-38,24
AYBJUQdeXOPfWZMgLKTRVEIDHCSFbGacN,BHDFQGDDdADAOAAF..PECGZDEFLBGDKAGFRBBCVFADhAAADAFGHDBF.FHFEGDGChABA.aBEDADDD..hACA..YFHH.eAHHfDAAhADAMCAB.EFFD...hAAA...,2,-24,-1,23
YABEeFGMVRNbKQIcfUXDHWLJZgSaPCOdT,EGGGeBGFGDACMBDERFCEKGCD...QBAHIGGA.UAGHHBBDhAAALDEAZGACaEECCHEAdAEGhAAAAAFEBABCNIEF..cABAhADADCFHJDAH..gFDD..hAHA.SFFChBAA...,1,-6,-12,6
XeJDQMBKRGfOSCTVaNHLcEYUIAgFZWPbd,FGFFZEDD....bCCGdHCD.eECCDBAEBGCFKBGEGBCD.SADEhAAACFAFaFGD.LGAEhABAEAHDUADAAHHC..PCAHhACA..XGEDMFFE.fBGEhAAA.ODFDhABA.NDIE..,1,-16,-35,19
TYZdIUWbNXDegHKFafBSRQJcCOALPGMVE,GGDFEEAHZEEB.UCDD....NABDDFIDeBBDHECHaFBCBACA.hAAAQEGFJCBGCCGCLAHHhAGAVAFC.dGBE.IGGBhBAAXECE........hAAA......hABA...,2,-23,-18,5
HSgVNFUaWCPAfZLJOTbcdYeBRXDIMEKGQ,ZAEEODCC..bEADdADH.eFCBBEHEDAHHMDEBKBFB..GAAEhAAA.QEFHhACASDBE.gFFHhAAANAICaGHD.CHDGfCFETGAA.YBAAhABA.IHHFhACAECDE.FCGAPHEG,2,-31,1,32
HdYgUDKZFaRVbGJTAIEXcNSLfeCBWPOQM,EFFGXDGF..NEDB.LFCH.CAFFBGFGPFCE.OADBhAAAHBDFdEACUBAFDAABZBFGhABAFBBAaHFE...bGAChACAJBFG.AHAHSGGEeAFCMEIHKEAA..hAEA......hAFA...,1,-5,-25,20
bBTHEcVOQFMWXLDeNRUACfPGSdJaKgIYZ,CDAEGGCFdFDG.KAFF....IHFAbADDBBABHEGB.EBBGOGFAhAAAFBGC.XDABhABADAEFeFADRCFHAIFG.fHADhACAJDDEaABA..ZFBH..cAGF.hAAA......hAFA...,2,-21,-12,9
fTbaHZVOGJXERdNFWYDCPBgMILceSAKQU,QFABUEFD..bBBEaFFA.ZADAODDBJGEC..RDCGFHDCDBGFCHHDhAAABBAD..MFBHhABALAHD.eDFGhAAAKGEFfAHA......hACA......hADA...,1,-19,-44,25
NDYIWfeAPTVJcLgKbFQdHECUXBMGaROSZ,VECHLBCB.KFAAQADGdCAHHGCECAHHBBGAGAFCOGFEZEGBDFEAhAAA..IDBChAAA.eDDGAHAF.TGAGhABA..........hACA......hAFA...,2,-30,-29,1
WUXfBbHAaDRZYLCcGFeIVJPQKgOdMSTNE,DFFCRGFAZEACCDCD.FBHF..eAFF..JBBAQGGD.KBAGODDFhAAAdHBD.MFFCSGEDhAAAEDAG.XCGBhABABCGDAACALHAC..cADBhACA.IAHH.hABA..PDAB,1,-26,-37,11
WYOPSCXdRLAeVTFDUcZHbGgIMQaKBfNJE,eGFCTCGDDBAD.UCEBHFBA.GADB.MFFAKDHDBCCHJAAHEHAEhABAOEBF.CFEC.XDAGhACAdGAGLBCChAAAFGHFbDDG....IHHCfCDBNICB.hABA.....WAFEhACASAGEABBB,2,-40,10,50
SXJRUgZHecCODYPadFNTEBbLAfIMQWKGV,MBACQCAGGDCGSEBHRFFBZBEE.eBAECFACDIDG..aEDEFCAHhAAAEFGABCCCAAHE..IADGhAAAKEHD.JHEEgGAChABAOBHDdAFA.......hACA......hADA...,2,-29,-10,19
PFLcCHONUagDBATIVEYXQdWfJGeZMRKbS,VFECEBAF..QAFCdCCG.JDDEGAGCeHECZFBGRACESFAEhAAAFFGGLABBCGAAHFCBhABA.OHFEaEACDCHFBCAGhACAAGIF....YHAGXDDBWAHBhAAAMEIF.....hADA...,1,-1,-17,16
ZWJVIgYFHdTKcOLRbaMGUXQDPECNSfBeA,JBBCVADE......IGDGFDCCdDHEKBAGOCFDRGEA.MCABhAAAUAGG.DEFC..EGBBhABACFDC...NFBDSGGAhACABDAGAIGE.ZAGF.gCDA.hAAA......hABA...,1,-24,-43,19
BTSgAHVFNXUCRMPKYGOEDQadJfcIZbeLW,HCDGVAEF.FCAC.UAEHMEEAKEEFGDAG.DGADQGFChAAA.JCHHIFGHhAAAZFAHeBAEBGDG.SABChAEAAAHDCFHG.RCCFOHBC.ECGC.aFFHhAGA......hAHA...,2,-20,-19,1
CFaKSecINVAQUBDWGZJHEPRXgdOfbMTLY,BDEAGCAGHGFGEFCHREFHdAED.ODAAMIFCLBHFCBBH.aDDFKCGAhAAA.SHAAhABAeFADNBAF.AFADDEGC..WCCChAAAZFCF...........hACA......hADA...,2,-35,-9,26
TUYWGEafgRABPHKFZNSILMeQVOcXdCJbD,BCHCKFFFZEAESBEDLEHF..eCEGQGDDOAABdHABCAAADADAhAAAUBCAGCCG.aHAChACA.RFFB.ABIF.HAFEIBGAhABAMCBH...XCAD...hAHA....bFBAYEFChAIA,1,-6,-31,25
CEceBHgVUNLGQOXRDaTPSWJKfdAZbMFIY,ZGFGFEFECCAEEFBF.BDCFHECD.UBGGGBEB.OAAADAFH.aEFFSGGAhAAA.KGADhABAABBFMEAB.YFDBhAEAeADHNICD..XDAG...TABGhADA....hAGA...,1,-27,-30,3
NOQBdbIZGaeSVHcMFJUPKAXLWTCRgDfYE,LFHDTFBB.RBBCDBHFEAGB...QDECBDBDdEFGZACEeFAGSDDChAAA.HGFGhABAFGFFPHAGADIHCHDEfHADhACANAEFOAAA........hBAA......hBBA...,2,-22,-16,6
WDLVRFZMUIcJKYaBeNfTdEbGAXHSgCQPO,SFEGQFBFOFHFLBBB.VGACFHCEMABG.UBCHhAAAJAFEKADHBEFB.eEEBhAFATCFAECFA.ADDFXGFEhAAACHFADAID..IAGCaEHFNCAA.dDBH..hBAA......hBBA...,2,-17,-15,2
QKRFZAHDdOXeWNCSMIEfbYVcUTBGPLaJg,dCAEXGDFeECHCEED..SFAC.MHFCfGGGhAAA.VADEUCGCBHBDhABALDAAaDDA.JBAGQAGGhACAFGBDAFDGDABGOBDFIGEAEFFGYDHDhADA....hAIA...,2,-29,-16,13
AaFHBDRKcLgfGEYTNVJdMWXQICZObSeUP,HGDADGAFKEEELABGGCAD.EBGF..TCGDNDCA..JCCCMFHHhAAAQFGAZFCC..hAAASAEBeCAHAAGBBFFChACAgABEfHABYHBCWDEACFAA.hADA......hAGA...,1,-1,-31,30
QYJRCUSHMFPcLVZbBDdXTaWAfIEeKOGgN,EBAAODBEGEBD.QFGDJEFARFDG.UAGBSBCFFHACLCEAhAAAZADHDAIDdGEE.aCCBhABAAHAHeHCEKAEB...hACANAAC.CDAFMEEE..cBFHBHHG.TFAEhABA...IHGBhACA.,1,6,-37,43
ZCXfJcRTVbUMadEQWGFeOPLSYgBHKIADN,DBGECDHD..JACATCFB.UFADdGFHQFACGDBB.FCEBOABFhAAA.LFGBhABASBABBEHBKGCBAGGHXADChAEARCBH.MIACWFFE...eAGHhAAA.....hAFA...,1,-22,-33,11
egTSNZKWbLJMBVCUOIfXGEQAPRHYaDdcF,HAAGDCBHFFDETEDGZDEA.KGBDLHACBHHFCCGC.UBFC..OAEBhAAA..fGFChAAAXDABEGECQACDhABAAFCFRDGFdAGF.eFACNICH.WAFEMFAD..IHHDhACA...hABA...,1,-11,-19,8
RLeZWHMcFPfIEJNAUdGgKQDTbaXCVSBOY,UGECdDGCKCEBDAEE..aABECEHE..BBGHRDCHZEAF..HBCDFAHB...hAAA..fHADhAAAJHEGACDC.GBEE.hABAQDAHXCAESEHB.hABA......hACA...,2,-37,-36,1
cgLKENHPZXCbAVDRFaSYQMBOGfeUdWJTI,VEEFFFHD..aECFQBACBGEAGBFCeECHdBCG...JCAFIBFFhAAALHACKDHFEAGEhAAAPHCE.CHHDDAFChABASEEFOEBBfACFWABC..hACA.TCDENIED..hAIA...,1,-19,-20,1
DYKHCWOPEXVARZgTMBcJNSFGQbfUILade,ZEEFTAFFMDIB.BBAEJHFC...FCFEGECH.QCGAhAAAUDADaEGB.dCAEDAGGKCCGHFBChAAA..CFAGOABGhAFAEBDGAHIH...........hABA......hACA...,2,-34,-22,12
RaFUVcSJBIMXZDPOTCgdQLAKeNWEYGbfH,eEHBEGADGDBAHBBDaAFBFBDA..UDGG..SBHBJEEB.hAAAIGDAMAEADCABTDEHhAAACHHE..dGGCAAHCWDAHhABA..fABFcGGCBGBHXGCHhABAOADF..gCCBhAIA,2,-27,-18,9
aNAGDCXVMedBQRLHcZSYOFEJUWPbgIKTf,CBHFXDBA..VDGDeBHBdFEARFADLFCGZABB..SGDFhAAAFBDGEGHBUBAH.hABA.PFAFIHDBhAAATAEAaGGHAEAFGDBDBEFB.QGGBhAEA......hAGA...,2,-21,-9,12
EgDUQKBZPLYOCVeHAMXSTcdIJGRNaWFbf,MCEETFFDdAFF.GFDFRAAB..aDGEFACBEHBGUEAFBAECZDDGLEDHhAAA.OCEFhACACGBGeHFAHAFCADHC.cDAHhADAIEHC.JAABWFHH.....hAAA......hAEA...,2,-23,-2,21
CMRWdfDTeYIOZcXgGaJFBQEAULbKHPSNV,LGECKBAFHECBSFEBVDAG.CAED.MCGF.dAHADHGEeACDhAAAOCHDZGAC..XAFGhABAGCCHaAGFBFHEAAACbFAFhACANIED...fBBBIEEF...hADA......hAEA...,2,-18,-16,2
eYVIfHJCBANdTEWLaKPbFcXgUORSQZGMD,dABHTCABLBFE.aFDEKAEA.FECF..XDCEOGDCRFFGSFAAhAAAQACAMCAHhACADIEGeBGH.IGAChAAAfHCHCEEDAHIB.EGGG.WDFC.cBCEhAEA....hAFA...,2,-32,-19,13
JPUGSbRfMHdFVBKgZAIaYcXDWLOQTNECe,aFECXFEGLBDF..QCDGEAHHCBAF.JCACUGABGBGChAAARCFFMAEAHGAE.FDAHVDAFhAAAKGHBAIEC..IEHChABADAIHOABA..NIDDSGHBhACA......hADA...,2,-15,-8,7
fVZIaECeMAUXRQFcHNJOYDTKPGdbBWgLS,RDFDQAABHDAGOEEHDAECKGDDGBCB.BHHELCED.fGBChABAICAFCHGDMBGDhADAXGAAFEBCJFGDPAAAhAEAdAHG..WBDFgAGG.SDHBhAFA..hAHA...,1,-16,-18,2
FSBdTZMPUVgeKaRQbADCLfJXGIOWEHYNc,CCHFLDBD.JFHBIDAE.EFBAHAEE.NIBB.FGCDdAAGZABEhAAAMDDCUFFF.eCCAhABAKFEARDFAAAGC.DAIFGDEHhACA.OBFG..WGAGSGHHhADABBBBTECF...hAFA...,2,-18,-18,0
EAXfPdQgKTOLIGUbVaSRFHYNWeBMJcDCZ,XBDDdFABKBEDLHAGGEFC.UFGH..bAFF..aDFARBADFBHFhAAAHCAE...NABBBBGHhAAAcFBA.CABBAFEA..hADAfFEE.......hAEA......hAIA...,1,-24,-27,3
MEbOJgRNPCWBXYZGLDdQFAKeIaHfcVSUT,KHEGeBEBHFFG..fEEGSBCCMBCFEGCC..OCDAhAAAJBHHRFAG.CAFEBEABZGFELAAEhAEAQDDGAEDFIAFEhAHAaBAB..cCGE....TEGChAIA....hBBA...,1,-18,-19,1
BFReZHGTfOcMSQAbaKgVCLIPXDNJUdYWE,aCHBKGHHCFGELEBH..XABGJEDGUBCEdAFC...EGBDBFGDhAAAFCDD.RGDGZAFBHCFC.hABATEBAOCABSGEBhAAAABBD.gCAAIHHGDDID.hACANIAH......hADA...,1,-21,-27,6
gYITBSRFeaQAMCWHEUXLfPNcdbJKGOZDV,CBGAHEACUCCGXAEA.LACH..fHFHhAAANABA.dHAFbFDEJDFHKDHHZFAChABADICE...gDEAhAAAIDAEBACFFAHFeHDEAFHDMBIB.EHDAhAEA......hAFA...,2,-37,2,39
DGRUSbLOINHFAgaVWCTBPYcdJMXQKeZfE,VCEGCGACBACA......PACEdDHGXECHeCAGZEEADGGERFAAUGGHhAAALCAF.OHBGhAAANAIC..AECAaHCEhABATCEG..cAFFMFFDKCCF.EBDC.hACA......hAHA...,1,-14,-32,18
VZcWUPdfBEYLDaKbIQGANeHTMOXFRCgSJ,eDCHTFAGOFFG.FBAAREDHSCAG.ZCFGUBFHPHBChAAAfADF.hABABFEDEGGFLBEChACADCAHbGEE.IBCCADCFNEEF.MEAGCGAB...hAAA......hABA...,2,-32,-5,27
YDcCLKdEgRHXObPaeFSQBTMUfGNWZJAIV,VAEEDGAELDGD.dCEAEFFHHDCFODCBaCBD.FDAFBADA.MIEAhAAAfEDH.hABA.NHEHZAFAAHDFICHChAAACCAFKHAG.XABE.eHFC.SEHHhABA...hACA...,1,-16,-22,6
HUCJdVfbFLMPBEOZYaSTKAegWNQcGIRDX,eDEE..gFDGQDCDGADFICHERBAEXCEGhAAA.CHHFdDHCfAADhACAFEADMIBABGHEOGAEhABAaAGASGFFAGHE.cAEF.DADBhBAA.HFCB...hACA...,2,-11,-11,0
dgQTecRPOGFBLKDJYNWXIVbSAUCHaEZfM,UDADaBCCZCFDMBGD..QFCDeFHBREDCGBBHBHFBLCADhAAA.KBECDICENDBD.IAHGhAAA.SACEhABAABIFCEECHFGDdGAAcGADFDHFWABC..hAFA......hAGA...,2,-22,-10,12
fOMULeHPNZcBdWCgbFGSVETJYDKaXIQRA,MAEFUECBeDGBHFACZBAGBCBACGHD...FEAHSFEG.TAFFhAAAJAACDHCC.KBECIEHGhABAAFGD.ODAChACALAHFPHCC.dDFEbFED..EBHHaGHDhADA......hAEA...,1,2,-39,41
cWgSNLKMZOAQRTYfVGbUHaDIXCFJBPedE,TFCGVDEF..GBACUAAGHGEGDDHH.XBGGFGGBBCHEeEEEhADAEFCB.....cCDBhAEAgGAGLFBDhAFAKAEGMAACAEID.RCCH.fAGDaGDD.hAEACDBC......hAGA...,1,1,-19,20
BYbQZWUCfINaLRdeEKcMAVTJHSXOPFGDg,VDDBHACESEGG.ODDGFFAEDCAEBGGCQDGChAAAUGCFIAHHaCDGLHAChABAeAADKFCEADBG.JFAFXAFEhACA.PFHD...gGEAhADA...hABA...,1,-14,-25,11
fALEDGaNbJOWFYXRcKeVTgIdUZCPBMSQH,LGACDHFEGCCDaBBH..JADEOEDE.FHFCRFCFKAGB.eBAHhAAAVACC...IEHDhAAAdFFHCHEDMAIDHCFAAHIH.hABANBAA....WHBG.....cGGFhABA....hACA...,1,-24,-33,9
XgFYAfDLOUTNQcBedVGPCHEMRbKWSIZJa,DEEHOBAHUCDH..QCGBeDHDGDAEHFCDRAAA.KBBB.IEBEhAAAZGDAaCHF..FAGBfHAFhABA.TAGEhACABFGD.VFGHCHHBMIAASEEA.hAAA.XADFAEID.hADA.NAFE..,2,-16,-13,3
dAaPDgCVIKJSQUfeFcRGHMBWYEZNXOLbT,DCBAVFFGKABC..QACEeCEF.FDDDRFADMFGBBHAF..ECGBZECFhAAA.OAHBLHCGhAAAdAEFAIECPBAH.IFBDhABA..SFHHfAGE.hAIA......hBAA...,2,-37,-15,22
BAPREOfYWgMTXSLbHGIacCeVFUQdZJDKN,RCABECAEODCA..fDCA..YHCEMIBEXADChAAA.LEEFhABAHDFHaBGAcAGHCACAeFABhAAAFEABdFCDDDHBBAEDAHHAWDFHgFGHSHGGhACA.IGCChAEA...,1,-15,-22,7
VJXfPMeFgNHBZbdCADRSKIWaGEOLYcTUQ,RABCKEFB..aFCCEAGELAFG..TBFAUDDHQGAHhAAAJBDF..fFBBhAAAeFGFNBAGBHDFbDAGAGHDSGEHhABAICBBWEHBOCEA..YFEFhABA....hACA...,1,-9,-39,30
XJcVSYdREeCKABINWUPFMTGaDLOQfbgZH,BFFE..NBEDUCAHFEACGCCALDDFQCGA..bGDEhAAAZABAHEAHXGBChAAAVCGFdHAHEGEFKAGC.ICAHhACAMABCDBBGOHFCfEED..hAFA......hAGA...,2,-14,-13,1
fZbSGNadLgUOTQBHYcCFXDVKeWMIREPAJ,ZAGHGAAHaDCC.dGDDLGBGOCDFBCHGHAAECHGFDBGH..KBDGeDAFhAAAMCGBRFAF...AFFDJCAFhAAASHGE.NICB.hABA...UEGBYFHH....hACAFDCH..WFAD.hADA...,2,-21,-16,5
eRNdSgUAEfMIXVDCcQGFHJBOPaTZbWLYK,EHEAMCBF...XAEHDDBGCDHAGAFE.FAADJEFBBFDGOAHHhAAA.aACDTFGF.hABAZEBHLFDHKADBeEDGhAAAdGHG.gGADAFADIAHF....hACA......hADA...,2,-26,-21,5
FbSMHaEKYPTAQcIDeCVgUJdGROXZfLNBW,QGDCDFEHeBGB.CBCA.UFFGdAEHGDEDRADBZCAG.LAHDBGACFBAChAAASAAE.hABAMIFGaHGEKHBGTDAFhADAABHC.IGGB.JCDEOFAA.fDEHhACA..hADA..WFAD,1,-3,-33,30
SQPGfaHZJWdKLMVBUcbFANTYIXDCOREeg,TADEXBFE.DCBFCFCB..RDEF...eCDHQBABGGBDaHGAhAAAJBHDKGBHLACH.hAAAMEFGBGGHUEADFGDDADABhABAIFGDECDDSBGFfABE.WAHBhAEAdGAGcDAD.hAFA...,1,-12,-19,7
MVRgaHPXFUfLQITBAOWKbGeNDZESdCcJY,KGBHGDADeCAEDEFEZAFAdGAA..CGDC.JFDA..MBEDRABAHAFD.FHGAhAAAUDFFLDHHQGFGhAAABHCHAHFFODBBhABA.NDAC.SBAD.....hACA......hADA...,2,-27,-17,10
begdcPZDWVYOHQMACXTEKUfBFSNLJIGRa,TDFCUGDBFHGG.LBGHGABBRECB.eHFGdBEAZDBCDIBG..VCABhAAAHABH.AIBC..XFAFhAAAKBGGBFGH.SGAEhABAJFFC.aDDF.......hABA......hADA...,1,-10,-26,16
VQHcABPSbaKXfgCLUFOEGMJINdWDZeTYR,BHHGSGBAaHDE.KGHF..XAFGCBGFUBBD.EBBAGCDA.hAAAMFFFIDFE.hAAAdDCHDAFGTGADVCGHQEAAhABAHDGBABEDPGCGfAEE.hABA.FEACNIAB....hACA...,2,-17,-11,6
EJUXIGSObLMRaWFPdBgNDQAceZHTfYCVK,eFHFZDDEHAEH.TGFDCBBFKCGDUCDB.GFAFOEAB.MABHhAAAaFFH.FHDCBACBDACGAFGA.hAAA...fAEAhABAECCHJCHFIHBH..LBHHhAEA.WHAA...hAGA...,2,-23,-20,3
NUWSCaBeRgPdfXAZEJbVFQDcIGOLYTMKH,JCAEVACA..DFDAGFCFLHEE..TDFBKHAEHCFFUAGBCAFA.hAAAaHGEBBAF.RDBC.gBAGhAAA.fCHEhABAAHDBEFGC.FFAFIFAH.MAIHhABASHAAdAEC.hACA...,2,-28,-6,22
gbZcIUVYAFaLWXSefGTBERKJCHONMDdQP,LDEAXGEA.SGAHeACCGAFEBGHERDDHKFBHCGCA..OBCEhAAADDIDdBAC..QAFFhABA.gDBChACAcBCDIHAHYHCGAFFHWDHD.hADA.EGFE...NFDFMEADhAEA.,2,-28,-17,11
XVDdGFSUBaKfCIcTbeMEQNPHOWZLYRAJg,JHBGXFBC.DFADdEGG.FAFGBCDBKEBD.CEEE.....TCCFhAAAeEGFMBAB.QGDAhAAAHABAOCEDhABALBBBAEIB.........hADA......hAEA...,2,-42,-36,6
EOWILVSXNGDMefQCTHABJYPFUbgacdKZR,JGBCFEGBUABF..aEGDKEDCZAFA..OCECLCAA.SEDAhAAAGFAHMAFGeHDAhABACEAA.AEBA.BBHF..hAAA..bCFFdHGBEHAG.IBBH.NAEGDGIBhACA.....hACA...,1,-13,-41,28
HEKgaSIdOCAJZXfQTFGMYRDLbNcUBWPVe,XEGCTBDA.FABCMBAB..DBEALEFA..cECGhAAAWBGF...VGDEhADAeDBGKBHHaHDG.IGHHhAAACEAEACEAZCCC.QFAB..YFAFhAEA....hAFA...,2,-34,-18,16
VRcWJBYXHIMGQENgPDLaFKdUbZOfSTeAC,VDEEREED..JACGBHGBHCFDGACA.QGBGECCG..hAAAPFCBDGAFFAFHdAAEZBADhABASHGAAEIDCBHF.hACA..cAGF...WEHF..hACA......hAIA...,1,-25,-31,6
NdAOUSZfLMJVgFaBGcXWRIQTeDKYEHPCb,UCFFSBAGLFAGMFAA..VEFHFCGFBAABGAAF..XGBHhACAIHABTGGChADADCIHKBFEHADC.CGAEdGFGhAEAAFIBfDAEaDDA..WAHBQDCHhAAA....hABA..eECE,2,-23,-2,21
KZGTgIOXeWbHMCNRfLdAaDQBVPYESFcJU,DGBAQBEHBABC...VEFHECDDSHECJGBG.KHBGTBBHhAAA.OABAhAFAeDFAHAEBMIFANDICfACFhAAAAIAC.YFFCFAHHcEBBZEBAIAGAhAIA...hAGA...,2,-22,-20,2
TcLPFUdXYgMeabDKSOENQJVHRfWZABICG,BFEECAHBGFEDLEBFFHCE.UAEDdCGG...XAADMBEGaDAGDCIHhAAA..KECGEDDEQAADhAAAHGFCRFCD..fCFEhACAAGAF.IAHAcGAD..PCEFhACA.eHFA.hADA...,2,-25,-15,10
GaQHMUNSFOTLEbPBXKDWcdgfVIeZCAJYR,JEFBRDCCQEGBHCCDUGAEFBEF..LAFBEGBCBABFDFEB.dABA.hAAA.fFAHhADAeAHFAEBB.aGGHSHEAhAAA.TADDbAFFKBCF..WCHH..hADA......hAHA...,2,-20,-17,3
UgceCGDHfVQOdJAXSYFNKWBPZbaERLTIM,SEHBFEAEKDDFBHHGZAAC...aHBAECAARCDBLDGD.MAFDhABAgGDF.hACAeAHHCHHCDBGCHAEDQEAChADAdAADAHGFXDGEYFFFPGAA.hAEA......hAGA...,2,-19,-19,0
cYZbAeOFQMCRfJXIENSLWgdKaHGBDTUPV,FECEMDGFCAHD.RADB....JDDHXFBG..EGCDSBBChAAALABBdFHEaBEBHFGDhABABBGHDFAETGED.PDAAhACAYFFF.ADAD.OAGH.fCHAhADAIGADNAIA.KAADhADA...,1,-11,-34,23
YNRfZBaQKXMSEdCTAGFOIgceDHUJVPbWL,GBDEFAEHOCHD..IGFDeFFDDCCBHDAE.UCGFJEGF.PBAGhAAALGBG.RAGHBACGhAAAQGAFKDDAMBABhABASAFC.EHGACAFEAHIFcFCF.hADAWFFENBBG....hABA...,1,-17,-19,2
IPDgTQGLOXfHVSeRaUZcBCWYKdJbFEAMN,MBBH..NCFADCIFTCGFLAGB..fGBDSFHBhAAAeCFDRCABZACECGGEKDCCdGEDFGBAhABAAGIB..IHAAhAAAgDCHQAEH.XABFhAEA.aFFH.BAGBWHEAhACA...,1,-8,-29,21
VTYadABEFLXZQbOfeKcWGDUgNPIMSJRHC,FEFHLBEBQBCAOFADKDHBGDCA.UGFE..PHCGhAAAIBBFJAGDHEAChABACCAD..TCGFdCACEABAhAEAXAGC..fHGHWAAEDEAGMEIBhAEA..SGAHhAFA,1,-14,-28,14
gGCeHRdIBPJbAVWSNKcEXOLMUfaTQYFDZ,SCCGKDDEEBAD.LECHMFHD.aAADQFAD.FFCAhAAADAFBZFEDCHGBHEAFdAFFBADHhABAPEEFAGGF.NBIEOCFFhAAAfBBB...YBHB.hACA.eEHD.IADAhAGA.,2,-23,-19,4
XNAYRgcTQSJVBKLDdWbaHGOfFeMUCEIPZ,REBBTGCEQGEE..SEFGBCACKBHBLBDEDCFEdCCBaACChAAAGDDD.OHAChAAAFEAAMBIBCEAF.EGHBIHHChABAXFACABBG.gGEH..hABA.JDDH.WADEfCDHhACA,1,-20,-26,6
caQDdFRCSLgOTbfJWIeVZMEHYBAUGPNKX,UFBGGDAGKAACaAHB.dFHARFDCLBCF..TCDH.fBCChAAAIDABeAHHhADAMGDCECGDBHFDAFFGNIEBQAFGhAEADBAC.CHGBODDAJADC.WHAGhAHA......hBAA...,2,-29,-8,21
USfeIcEMgYdRODLXQbPBHZKNVGFCWJaTA,SAFDeHFGEBHB.MCIBdEFGOACD.DAGBXCDC.hAAAPBBDBEBBKHACVEAHhAAAGDGAFFEC.CGDFaAEHhABAAIAGfHCD.IHHHYCADLABChAGA.QDFEhAHA,1,-2,-33,31
cQLNCGVeYdAHfTBURgPaESIXOKbWZFDJM,HDAGTEADBGBG.UGCERDDD..aCEAIBBAKDHBZABH..JHDCMBFChAAALADGGEDHeFGDhAAAAIGC...fBHAhAEAgBDEEHBEOEHD.WFADDBBF.hAFANACHCGGD.....hAHA...,2,-13,-12,1
DQXFbOfUTPcJdNCEWLgARKSMBYVaIHeZG,SDGFMGFGBHHF...VCDDaAFAHCCAeBBDZADGDBGB..XDFAhAAAFHACOFHH.TEAHhAAAPFBA.dCAACDHALGCGhABAAHCGKABG......YHCGhABA....hADA...,1,-9,-30,21
NfcagdSITGQXbVMFJABPKRDUHeWYELZCO,KGEHDCBGUGGFHBCGeDBD..ECEHLEECODAC...fGGEhAAAaFFG.SHBEhABAIHEFQAGBhAAAVAFAMFAHAACCBCGD.PFAHWDDDCBBCcFBAhABA.dACD..hADA...,1,-6,-35,29
YEWDTCXGSNVUcZdgLMOFAefRHbQKJaIBP,RABBHBBHKADE.JGEGBHAG..EFAGDFEF..CGDCGADF.SBHHhAAANICB.UDDFhABAdCGGMEDDAHAB.eAFFhAAAfCAGQFFDIHHA...hABA.WBHB...hACA...,2,-40,-26,14
fWKZUTXALMaJPQIRSYNdgFGBVbcEDOCeH,aFAAJDEA...QEEHRCAH..SEGAdFHCFCEEGGBHhAAABDDD.bBGDEGAF.CHHDHACEhAAAKCACTDCCACID.PAEAhABANIBH..gAGHDIAGfABFhAIAUFCB..XFFGhABA...,1,8,-30,38
VEcaYPUXWHFBAbLNIGMKfDRZOQgeSTdCJ,LCAEGEACKFCEDGDDRCEBZABGQFFC..SAFBhAAACEGB.JEHFVEAF..hAAAECCCYAEE.hABAXEDFFHDCACAFIGFDMBAAfAHChABAOAHF.eCEG..hACA...,2,-25,-18,7
TgOPbGZfLdUXJEAINBKRYecWMHFVaCQDS,BBCFRDEEeCAFMICCHBFCFHAGCCCG...DBGH..TGDBOEECGEBBhAAAZFBCLAAHXFGHhABAAFCG.IHAHKHGE.hACAcACHaDCE.SAGEbAGF..dCDBhADA......hAEA...,2,-26,4,30
FcbdefaXMGTEDRBWSLAQgZNPOVJUIKCHY,QEGBZDCBOEEHUBFHKCBFHADD.FGCFdABAeBFF..aGGBXAAGhABAMADG.EFAABBDEhAAALAHHABID.NEEG.hACAPDHFIHHACHAF.YFFF..hADA......hAFA...,1,-3,-35,32
eTQAHOLdKMNRBWFIfXDZSJbEaUcGYVCgP,HGEGdFCDMDDERDBEFBCG....IBBCXGCFDGFFSBHDhAAA.EFADUADAGAEGhABACHBAgFFBhAAAeEFCACAG.KDBGBAHBZAGHaEHF......hABA......hACA...,1,-3,-31,28
OHbaMJEKRXPNZFDSLWIceBACGgdVTUYfQ,CDFEGCCAdAEC.UCGDQFGBHFEEMIBGKCAE.RBAF....XACEhAAANIAH.DBFHLGBGhAAA.IDDFhABABBGBAIGAgFACTAFAfHFD.hABAaDAE.EABC...hACA...,2,-20,-17,3
EUNFReLKAdQJZVaSbTHCGMIWcBPfDXgYO,dGGHQBDGJGCG.ZDAA..SEBCHCFDMIEA..IBAEhAAAcAAHBEEA.hABADHBCXEFAOAFGEGGChABAFAEDeCCGAFBE.aGBBCEHG.PAGF..hACA......hADA...,2,-34,-10,24
AedgWXaJYbCTBKfEUFSMOHVRNcLDPGQIZ,dCDCXFEFaGCG...JEHBCHFHBGAF.KEHHUCDG.FGCCMBCDhAAAHCAE.RAEELAHHhAAADDAHQFFDABACeEAB.hABA...gCFD...WBEEhACA.....hABA...,2,-38,-20,18
DZJWPQeBdKNIOTEAfYHgbFGLMCSaUcRVX,HBABFEAALDEBCACCUEFA.RACF.DGIHZECD...JBHBQEAFhAAA.dDDAICAEhAAAEGCEAAHH....fBHChABAYFHHbAFFSHFC.cGAHhAEAWHBGBABG.KGFGhACANCCF...,1,-17,-32,15
bDWSMaQdFKHTRCPXYALIZNcUJeVGfBgOE,LFFGZDBDUABE.VBGBBCHG...OHECEFCADAAE..MFADhAAAQBDG.FDABhADATEDCCHFH.PAEBhAFAACCHIHHG.cGAHJDGF..eHBChAGA......hAHA...,1,-25,-33,8
YDgKUPEGTAHFVLJWcZNSQfICbXOBMaedR,FFCGJGDEZCDEQABF..CHBC.OAEGMBAE.aDEF..dADADGFDhAAAKGHDEBHFGCAA.hACAHAGDLHBE.hAAAcEGFSEECIDCABFCH...hAIA...eBEA.hABAgGGE.,1,-8,-26,18
BRdMYWPSKALJCcfIZNXGEgOeQaUVHbDTF,CDAA..IHAEZACGGEEEOEEH.eCFBUCGBHCAHDHBABECEhAAARACEMFID...PHEEhAAAAHEB.LFAGhABAfBAANDHCECCEaAHB.TCDGYAEC.SCHBhACAKGHF..hAIA...,2,-33,1,34
BTUZSRWEFfdGAYbNVJPOcKeHDQCaIXMgL,...bAFBJGCG.OBBHeCDFDICA.QFEHaGFD.XABGhAAALCEC.BAGFhAAAUEADSACGhABAEHGAfCHCAAEGVDECcADFCFHAMIAG.ZCCF..hADA.....WBHBhAIAdEEF..,2,-20,-16,4
WHOfYeLAaZTJdKSDMGPUbXBIECcQgFNVR,TCAEJAEF..dAHCKFBBDGBCGCEG.UACABHGG.CHDF.QAGEhAAAFBAC.VEGHhABAHEEDOHDCeDBEaGGAhAAAMFAH...PEDBXDAG.EEGG.hAFA....cGAHhABA..,1,-11,-35,24
ATURWcOaYMbPgZSfdCJHIFBDELeQGKNXV,UEGARAGHODADMFAD......gDFEZBABfFBDhAAAdDCHCGHB.JHCAHGBA.BCCEhAAAEBGEQDDFhABAKGFAXACAAADD..cGFCaABBPFCGSCCEhACADIEC.....hADA...,1,-16,-19,3
OFDJULXVgMPIKfBScYGZTReECHAQbaWNd,aCHHdGGDDAFGLFEC..XCGEMBDCKGCBBEDE..SBBFhAAAGBBDTGCDhAAARDCACGEAABHG.QEBGhABA.NCAE.FGHD.JFAF.......hACA......hADA...,1,-28,-31,3
fEZXUGLAOHFcdSIaWbPeMJTKgQYCDBNVR,.FCDGSCBB.aFDDPEEA.MIFGJAEDKAGA.QFGChAAADEAEBAGCRABFECADXBGHhAAALEAAAGCEOFBHhABAdGCGIGAC.bFEDeFDH.TFGFhADACABBNEED.....hADA...,1,-16,-22,6
YMfOGVBDgdEKPLUbTQSaCceFAJNRIZHXW,JBHBRBEEZEBFHCCF..XEDGMBAAGDAEDFGF.EGHDKAAB.LFABhAAATAEF..SFGEhAAACEHA.cGDHhABAAAGAIACF.fHEBBHBAdEFG..hAEA......hAFA...,1,-1,-43,42
EXaYRTOJSDcgdPCeMVWBIUZFGLfQHAbKN,KEADXEBDRCCA..OBGHDAAGdFEG.CHGG.eHFE..MCHFVAABhAAABDDEZFBD.FAGBLFEDhACAQBBFAAIFEDHFaAEHhADA..JADGSDFB...cGGAhAFAWGFE....hAIA...,1,-15,-37,22
OFJeIAcGEYRbTaXQSZVfBNPCMLWDKgdHU,EHBARAAG..aDFDSBFBZDADBAEH.CEBHLAEDKHGC.dGEFUECDhAAAFEEEeACDAEAFGGBF.hAAA.bAGB...XBADhABA.fFHANAHCMBIF.DIEA.hACA......hADA...,1,-6,-33,27
aFBCdEYPMfZTAQGJDcXeURWVOSbLNgHKI,JEEGXCCB.RAAC.OGAELHBAHACAKDGCaBFDBFDF.CAGD.EFGAhAAA.MAFEZFFEAHHEQEAChABADAIH.eBBBhACAUEAHSDDF.NIED...FEEA.hAEA....dBEA.hBAA...,1,-13,-21,8
CfKBMQSVGTadYcWFUIONLJeHDEXPRZgAb,CBHDKDBBBEGFMBFC..QGDBGDFEdABF......YDAEhAAA.FFBFIHAGhAAALBACeEDFhAEADAFAEEDBXBDHRCEHAHGGSGGEaGAAWHCA..hABA....OEHDhAFA..,2,-32,-23,9
YgWHRTbIPZNdDOGVASLKQFaBJEXUfMCce,SABCQBGCaFBFBFEH...EGHFUEEHCDDB.eADH..hAAAgBFAHFGFbABFIHEFhAFAZEFBDBCAVEAFhAAAABBDKHAAFAEA..fCEHMIDE..WCHHhAHA.....hAGA...,2,-19,-15,4
SLOQGWVdBNUJDXePHZTIYMcfFRECKAbag,aAFFSBECLECDQFCEGDFAdBHAUDAFDDBF...PAHHhAAATCDA..IFHEhABAMACBFFHDCEEEAACH.OBDHhADABAEGNIAFeFAFYBADcGED..fFEEhAAAKBBF..hABA...,2,-21,-6,15
CROKWZSUHbaPJEQdGNIgAcVfXLDBTeYMF,VAEELFEB.TAFAeDEBFDBB.RGDG.KDGBZBACUEBA.HBCAhAAAaDGF.EGGDdAHE..NCIEACABhABAXGGH.DAAGhADAMEADOEAHSBBDJECB.IHCEhACA.....hAEA...,2,-13,-6,7
RDMAHUcfVIZYECgBFLabQdKNePOTSJXGW,.HEEHUFGDVBFBZCBBCDEFBBAD.LDBEQCGAdGAEKAHB.eFBEhAAAPGBG.SFADhAAAJADE.GAEHhABADDAHAGGAfBBD.EHFAaADGNEIG.XGEHhACA.MBBHhAHA...,2,-23,-3,20
YJOPcTZeCLNVgXAbFHEIafWUQRMdBDKGS,FGBCHECEEFGGaGAD.UAAFQEDB.RCBABDGHDBEBSGEAhABA.OAHDTAFChAAACDAFLBFFNIAD.hABAXEGAIHHDWHDGKADHYCAFhACA..cDBG.hADA...,2,-25,-15,10
PBMeRVbDQaKZIdfOTGAESLJcUCWYNXgHF,LFFHJBCC.UAEACDDA......NIBHHAGBPHBCMDGBhAAARBAEDFHH.KFDAZGAEdAHEOHEAhABAAABC..EEBHSCABhACA..WEHBXEACBDDD.hAAAeADE....hAGA...,1,-28,-29,1
KMUcGdWgaeTbOPJCELASDQfFYZBNRHIXV,DFGGQDGFFAAGBGBHRFABHDBC...XAFEKDCBUAFFGFCHhAAAdCCF.aABAeHEATBBGhAEA.OHDEJEAD.hADALCFFABDC.fGHCNGEH..hAFAIEEH.MAIFhAEA..,2,-43,4,47
SICNcbFHeYTXGgOEQWJBLfMKZUAaDVPRd,aGAHVFAE..dEBECCDC.....bBDCHBABeFHHXEFGGFDBECHDhAAAJHDGBACDLCADhABAMCIBKEDEZCEEACCBDICC.hAAASDFBIAHDFGGA.TAEE.hACA......hADA...,1,-7,-11,4
TSWgLPMFYHBUXcbDCNVREfOKGAZQedaJI,eFFHdDADaGAB..IDCA..SEEALEHBPBCAhAAAFHEABHCH.XECHhAAADCGDNHAD.RBBGOBHBhABAAFCGQAGFTFGAWFCAMBDC....YDABhABA...hACA...,1,-20,-27,7
UCNMXHGFgJcOeWYELBKbSQfdDTPaARVZI,ZCDDUFFCMGAEGBEFFHDC...JACAeEGH.EBBDBHBG.SCBGhAAAdAHCDAAC.aEDGAIGCIADChAFA..hAGACAHGNIEDXBFD....cFAGhABAOFHDWDHHKFEHfDCAhBAA,1,-17,-50,33
faXTRJZCQEcAMgOLeKVWDNYPIUGHSBdFb,MEFCOEFGLDBFKCDA.DAID..PHFEUFDGHADD.BCCBhAAAbAAF.aCFE.RFGHCAGFEBGGhADA.AAGGeGCC.NEAA.hAEAIBADdEBB.fHBB..hABA..XADAhAIA...,1,-17,-27,10
BSFQGLVOCZKPgYHDIRAcMbaXNTfeUJWEd,MHFCaAGE...XBEHTEBB..UBDBEEGHdAEFBEEA.FGABQDAChAAALABECFHAKECBhABA.PABDHGDAICBAhAAAADHGNIBB.eCHFSEEB..hADA......hAHA...,2,-23,-16,7
PUDVIRJAfEgeFMNXZHcGTYaLKWOSCbBQd,EEFBFAECMCBFZBAHHGACGEDC..aDGGKHAAOACB..bAGBBBFAhAAA.dGHGDCCDIAEFhABAAHHGeCFD..XABAhAAATECF...WDHHCHED.....hADA......hAGA...,1,-19,-25,6
JHFGVONPgDZacfERLbYdKTCSAIQMeWXBU,MFDDXABAUEACFEBHGBDH..VFFDOABG..PDHDhAAADEGBaHGE..fDFHhABARFEB.bECBdHAFhAAA.CEEFIEHCQAGFBCCGJCAAHAEFhACA.NEAA.....hAEA...,2,-20,-6,14
PHOedCYJBXgVKDZLGaUfSWIQAMFbTRcEN,MEFDTGDCRCCE...EGHFHBFD.OAAFCDDABBBG..XEADhAAAgCGADHAGGDGAhACAaEBCUGADSADChAGA.IECCAIFCFADCNCDDeFFCYHBGKAFELAAFhACA..hAIA...,1,-1,-13,12
JePOAKVZTECHMbNFYXgIGdDQRcLfaSBUW,ZFCACAFEHCBAMAIBFHFG....XBBFGEAGdAHGDCHFRBDDLDGBhAAA.aFDFSGHBhAAABBADJAEH.PEAFhABAAEEAKGCB.EEFD..NEIG.YADC.ICAChACA.fHFFhAHA.,2,-30,-13,17
KaJCHOASYGcTbFNMEBXgWZeRPLUfIDdQV,GBACTGEB.FCHDMCCFECEG..BAHC..XEFEZFBGRFFELACChAAAIDFFDIFCdBEFKDDDhABAaDDD.CACDHGAGAFHASHCEhAGAYAAH.cAGF...NEICWDADhADA....hAEA...,2,-18,-18,0
VMDETXPQSYAUgHOWbGBZRICKedJLcfNFa,UAEAOABGGCBHBFCBZGEECCGA..dGGFLHAA..fHBFhAAAFBBHMDEHDAFGXGEHhABAQBFF.hACAAAAH.WEEE.RABAIAHDKFFCcCGEaGBG.hAIA......hBDA...,1,-18,-34,16
CMdbeYaTQVBNJEWIFcHfPXgAZDGSULKOR,ZDAGDBIBUEGHKFBDRAAA...CCAF.dAGA..eDBHaEHF...QGCChAAABHHEEFFF.FEDEHADBhAAA..XAEChABAADHCSGDDMAHHTABA.JHEEIDFEhABAfDAA...hADA...,2,-33,-22,11
fFJCObaPGXEeRKATDdLQYVBWHgMUcZISN,DDHDQADHBCFDHEDFUBAAZAFC..SHDAFEBE.CEGEOGFGhAAAaACAGAAE.EHAGhAAAKGCFAHGB.TEDH.hAGALFAB.YAHFWDHH.MDDChABAIHHD...hACAfGCE.,2,-28,-10,18
VbcHPMQRdJCXIOfSKeUANBaTgELYGFWDZ,aDDGTGFFLHDG.FAEFDCGC.ZFDB.VDBEHAAB.MCHBQBDAhAAAdHAHCBGCOFEEhAAASDHBKDADAECBBEFFhACAEBAC....YFAHWFHH...cFGAhABA....hACA...,1,-15,-30,15
QJPLIaDWUHEfNFVYgeATZXCKROBSMbGdc,XFBHRDBGBBCE..MADGdBEFQBBELAHHDEGDHEFH.EHGAhAAAFFDE..gGDBhABAeHEGACAFCFBE.ODCEhACASHBGcAGA.IEADaAAG.WDFEhADAfBGC..hBBA.NEIC..,1,9,-42,51
LIZbVHSUJBcYfGPNTRdMWDQEeXgOCAaKF,FEFDLDBBZACDHBEHSAGDBHGG....fAHChAAAGEFCTDDBdEBAMABFWBCChAAAEEHD..eFDBXGAGhACAOHACAGDEIHDD....hAFA......hAGA...,2,-21,-20,1
XCJBFWedKPRIMOHESGAcgYDLUTQZNfVab,....gFFBDCCDLCHFQGADfAEAaEBGXDFAhAAABEDEFGDC.dABGKBFHRFDDMDBChADAOACFHAEGEHGEAGFEhAAA...UGABNBIECFCC.eCAF...SDFDhABA..hACA...,1,9,-29,38
BJFRSfKgQTaeWcdHMDEIbLVYZAUPXCGNO,UFGHXDFFCHDF.GADBBEDA..FDAGSGCF.fEHEhAAAKACFQCFGhAAATDCBeAFCdGAEDDAGEDCALFABhABAZFEHABADOAHD...gGGBhABA.WCBEMIEChADAIEAC.,2,-30,5,35
YWDbSeHQFAULEOIKgcBNXRfJdVMPCZGaT,EHCEOCGFKCBH.BEDHREEC.dEAB..MAAFCBAFGCBH..TAGFhABADEGD.eECCHADAABEGLEHBhACAIHAG.cGDAhADAfGCE.PFEDaGAG...hAEA......hAFA...,1,-21,-27,6
TQRObdJgAKIZPUDEeNGfHaFMWBLScVXCY,KFBBZDCBDGFEEBCG.GBGCHAFGFDGDBABB.LADESGHH..hAAAXBBCCDDBQGDDhABAOHAGdDACAFBGUCEAhAAAeFFBfBBGMFID......hACA.cGAC..hADA...,1,-17,-22,5
ZaGIJQEDgONUBeSKfAVXYPLHbdWFMCTRc,VEBDXGGD.LDCDHEEEdADD.FGGFTBAERABBZAGH.GDEGhAAA.JCHFDBAH..NDAABBFGhABASEGEAHBC.hACA.YHBG..WEAFMBEFCDECaGDDhAAA......hABA...,2,-24,-5,19
RDJgVaFNAYScdbIGMEPUOWQZeBTLCXHKf,SDEHdBFBGDDEMEBBUDAA...QCGBBHDHTABGCACGKGGFhAAADECE...gBGFhAAAFBACAFGG.bGFGEDCHhABA.OFHFZGAGXAEF....hABA.fEGHhADA...,2,-29,-21,8
EJLUATDKXCdWegMcIaYVZSGBQfFPORbNH,DFDEKACHCBEEdEGH...eCACMIDE..aAAGZEFDBEACFDDH..RGBCHCABhAAAECDHLBFG.hABAAGHB.XAGC.hADA.WHDGIHHASGAEfCGHhACAOGDA.....hAEA...,2,-33,-32,1
DHYQRKOUSEZIPMNJdgCTLAacVbWGBefXF,aDGBVAGBGEAG.BCAFeFAC.FBCFDDIDHFECQDCAKDACSABFhAAAEHCE..PBBGhAAANIAH.dAHECDECAHHEbFFChABA..XDGERAEHOHFCIAEG.hACA......hADA...,1,-4,-15,11
IeNgDXaRGHKEOSBJYWLcbUVZFTPMAQfdC,dFCHeFGHDBGDRCFFHAACKADG.EDDFBCCH..JDAELFHBUGACFAFEMFFBhAAA..AHEECFFD..hAAAIDAG..hABANDIEXADHaAHB..OFAF..hACASAHHWDEG.hADA...,2,-49,-10,39
HUCWgJbaBNdKGcVZfRYOEASXIeTFDLPMQ,SDEEeAACFBCGLHAEQBGFHEAGCFCH.JEFHBCCH.dEACKHEAhAAAGEGGZBGFRCDF.OBCAhAAAABID.TBADMAEA.hAIA..UFEC...WHAE...hBFA......hCAA...,1,-10,-14,4
TMJDOdZHbWLQPKCRIUFBcVgefYXSENAaG,TBDHJFFF..dDGEHAAFLBBDKAGGCDGCUGFCBCCH...VFBEhAAAeAEG...fFDChAAASADEAHCDMDIBhABADGABOEFEZBFE.QDDFIHHHFGAGhACA......hADA...,1,-11,-30,19
FcOYBZSRUAfaMDNHVEIXJGdCLWTgebQKP,aFGHDCDGHEDG.ECGFJCCFGEGCLGCE..TFBHeAACQAGFhAAAKDBCFBAB.ODHDhAEABAGBSBEEhAAAAEFHfBCBMBIBICFGdFAG.CFBCWHAGhAFA......hAHA...,2,-30,-6,24
gLTEeYVFUOafGJSMcQWXBHANKbCdZPRDI,KBCAdDDDZCADDFEDLBEHEEGA..eADAFAAHUGBDaGCBGGDF.hABAMCFAQCGBhACABAHEAHBHCECDRGFE...IAAFhACATAGCODAA.SFAEhADA.WFFE...hADA...,1,-17,-24,7
fUbgVYIFQRDNSEHWaCdPBTMXeGLAJKZOc,JEDAKGDAOAFC..UDAD..VABAIFHEFCED.DAHHECGFhAAA.HEAH.CHGBBFFBhABATFAC..MDIFhAEAeBDCAGCH.ZGEC.bAAC.....YDFChABANICF..SECBhAFA,2,-48,-20,28
fIXEZbGaCQSWHAOLYcgRMdeDPVBNJTUKF,LADE..cGEGRCCFMEHF.DFFBBAAH.TGAAFAADXBFAhAAAZACBaAGHCDHDSEEFhACAADFE.OFBBhAHAgEBG.dGHC.eEDGNAIG.KAEHfGDGhBCAICAG..hBEA...,2,-31,-17,14
BXRgcEFaYbPISWGKZeTMLODUAdJQfCNVH,JDEFQBDE.CDBF.VAAHBEAD.RFEE.EEGDFAHF...aBGHbAFChAAA....SFHBhAAAKGAFeHCEMEAChACALFCBDDFCAIHCfABANCIC.gGAChABAPADH.WHEG.hAEAZDDC..,2,-28,-10,18
KLVFWaDGfMECBRbNgSATJOYdZQHXcIUeP,OBDBZDADHGCA.XABCUAFAeEFB.KDFELFFH.VAEHhAAAaAAEDIEEMEEAEFBDBHAGhACAREDB...bCCDNBIG.hAAAAHHGJBHHdEAB..IHHA....hABA......hADA...,2,-25,-2,23
gfCRcFSTWIYdaKOLBXeEPNMVJGDbUAZQH,HBDBCGECFEBH.SFGE..TADBIGCCdDEEKGHDLEAFhAAABAGC.EHEGMDGHJBBFDBGAhABAUABEAFECQCFChACA.gGGGfBHG...hADAWFAD.aHDC.ODDBhAAA.,1,3,-45,48
RDbCPaGgfXcZMTNEBQKYHLFVISeUAWOdJ,dGCDDEGCCFFDaGGC..GABF..fACAZGFGMFAD.EEABBHDChAAAQBEDHCDFLCFEhABA..FDCDIHBEhACASEFGAAEEOCCBRBABPBHH..hAAA.XGEH.hAGAcGAH.,1,-9,-17,8
IZNHdDgaYEceUGBLfSFTJWVXAPbROKCMQ,RECDKBFDMHECQEFD.ZCBHHAGH.gEAFEBDDeAFGBEAEhAAALABDFGHDTGDEhABAWADF..AFEAPAEDhAAACHACICHE.dACFYCHB...hAHAcGADfDDGhAIASEEE.,2,-9,-6,3
QWfdBEDJXgaNRIUFOcHCMVAGePSYbTZKL,eACBSGAB..TFEEZDEDLCGBQAFHdDCGDAAHJDEEaAAFhADARAECFHGA..OEAGhAEACBBDAFID...PFAHhAFAKDAFBBDDEGHFNIBD.IGCH...hABA......hACA...,1,-4,-32,28
EBaAJNHebfZDTQGKWcMgXFUOdLCSVIRYP,JEFHeDEHZGACDEBB.GACBKBFH...MDGHFEBGUBAFdFHCLCCFhAAA.CCAH.SDDBhAAAIHCG.RDGBEAECADEHHAGFhABA...fGAE...hABA....WHEGhACA..cFDC,2,-39,-23,16
edPbfAYcELOKWVGISHCJUNgQMXZFBRDaT,ECEHLFEFKBAD.GAEHHCBHUGCAQABAMFHB.XDBFhAAABGFEDBFEeFGD.bDGFAAACOEAHhACA.IEFBhADACFCAJFAF...NAIC.FDEC.....hAEA.aBBA....hAFA...,2,-27,1,28
BMEJHaPDFRcLObCSTIVdZUQeYGXWgNfKA,BAEDEBEDHEEEaGCG.DCGFFGGERDAE..LHAG.CAAH.TDAH.hAAAIHDAdGGF.ZCDEhAAAeBHDGBAHWAFEfEEEhABAAIFCJACB.OAHF.SDFAhACA....hADA..QFBF,2,-26,-5,21
BATCIcJVGRWNdEeLKbUZMYOFPDHXfgSQa,CDCDJHCGGFAH.RFEF.dFEBLBFHKCHBUFAAZADH...OCABhAAAFGHFDECC...HACFhAAAgBBE.SHGGhABABBAAAIFGIAGCWBHH...eAEBhABAMIAA....hACA...,1,-22,-39,17
CVJfaIOdABUELQWFZNXMgRebKDTcGPHYS,EECEQCBCFHFG.ZCFFMAHHRGBA..eACGKBAEDGDG.GDAGhAAAPFHDHACF.CAEGJEEAhABAaAACdAGD.BFAD.hACALFEHNEIC..XGCC..hAFA......hAGA...,2,-17,-14,3
BNdeKLcaGSVZIFPHTAEUYOWMDQXbRCgJf,EBDCOAADDHBA...XDDDCGFE..JEDHBEHFdABF.KGDCLAGHhAAAaAEDGCBGZCCEFFAGhAEATAGF..AFHE.UGGDhAAAMEECQGAG.....hAFA......hAIA...,2,-37,-14,23
BgRDSXeFbQJYVcWLAIOUMdGEHPfNZKTaC,UDDBdEFCEAGDHABB....NEHG.KCHBCGDA.BGAA.DBAHeBCEFGEGQBFFhAAAVBAB.hAAA.LFAFAEACMIFE.hABAfDDEaBDF.gFBCSFAEhADA......hAEA...,2,-30,-20,10
RYfCUdaINecPXGgKbBMTFDZHWSOLVAJEQ,JDCAEADHRCDH..CFFC.UCFE..dHDD..aFHDeBFB..PCBBhAAAXAAH..KGBAhABABBHGMIECFGAHDDAB.hAAA.ZEAASBGEOEHDAGGF.fABHhAFAIADF.....hACAcFFE.,2,-33,-24,9
SUFefMXBDcgNbPCYWKHQJIZAETdGRVaLO,EAEBGCCCRGBC.aEHHOGFAFBEG...MIEEDACD....gGAAhAAAPCBE.CFFCKBAFhABAJEFGAABD.dCGFLHDEhADASGAFfBGABDAGNFAD.WDBF.IHHChAEA...hAAA...,2,-30,-15,15
OQDbFYGaAIJgEZCHNBPMVdTXUeWLcSKfR,JDDEEFEAZGBCHADEBHGA..MHDEdAHGUBDBeCACLBHB.hAAASAAGKCBHRDFGDADEFABBhAGAaGCBAAGE..CGHE.PFAFhABA...TFGCXEBAfEFAhACA....hADA...,1,-16,-32,16
dgTeaKGQWXObUFMcVfLDCRJIEZHYNAPBS,SGBETCBG.eBAGGCFG.XAGBOFHBUAEEFADDMBIBhAAAVDDHDHFE.CHDERFABEDAChAAA.ZAGB..YFCAhABAAIBG.BDECdGFEKACG.WBHHfABHhAFA....hBAA...,1,-8,-17,9
cRYQFJTUPbCGeNOZMBWVEXdgALDKaSHfI,KDHDSGDCHFDD..ICADRBDBFBHHUAABCFAD.GCFA.OHFChABABGGCEAHH.XDEFhAAAAEAHDDDF.fABBhADAQFAH.PEHFNCCBZEBDMFIBdADB.hAGAaHAC.JAEG...hAHA...,1,-6,-14,8
DIPLdOZVYNEFXbQeSAcCBJRfKHaUGWgMT,CDFGRFCAKGAHHDAFGCBF..MGFEDDIFLACEZAEAVABF..EDDDXFFDhAAA.QBFAhABAAHIHBCHAfGCAhAAAaHCE..WEEE..IHEDhABA.dCEB....hADA...,2,-22,-20,2
MWHLQDNedIfRKXabEAcCJVTSYOBUFgPZG,JDBGVFDH....TGDGOAHB.FGHHZFFHGCAEMFIHHFBHhAAADGAFdCFARAFG..KBBCaABGAFAC.hABA.CEEF.SDCEhAAABDFEUADC..WFFH.....NCICeADAhAEAICAAfGBAhAIA.,1,-16,-23,7
JfCXPHbTOVNBYgEUFdRecADKQaLGZSIWM,KAEFQFDALAADSCFCMIBA.JEBFXBGB.HEFHhACAODFFBDEDYACChAAAgFCA.FCCHhADAdDHE.RCBGABBBDIFEaHGEIGAGfAHECBBC.hAFA.PFHF..hAGA...,2,-18,-14,4
PXVFZOBCHaSAGRWbcfJNDMTUdgKeELIYQ,RBFC..bDBEJDBF..DFBFMIDCUADC.KABGeFAB.LBBAhAAAQEGB..PDDHhABAXCGF.FGHDBGEDhACAHFEHAGGD..WDHFNIADdAGH.gBAGhAAAEACCIHHD...hABA...,2,-24,-11,13
ABdCFQGRSPEXUWKOgYTVfaHJMeZLDIbcN,dBGBCDFFFAFBQFGE.GDBBRGCCSDAEEEABUBCDKECGOHAAhAAA..TAAAhAAAaFFBMADGLFFE.hABADBHBIDGENEBG.AFCDBCAA..XGGGhACA.WAHBhADA...,1,-5,-39,34
FYdAWPCgUDJKGXMcIRTfQVbSeNEHLaZOB,CABEDCDDKEHBMCHF..RBEH.QGBA..SGGFhAAAeAFFNAIC.LDCHZAAGFGFAAFEFhAAAgADFGCAA.hABAXBGB.TGDEfDFAEDABaEEEhADABHADdGAG.WFHH.hAGA...,2,-27,-11,16
XRYeSfIDNcCHgJLaUVKGMQTbOAPFWBdZE,FCDBBBHAZEFDREDF..eAABSGCH.DAEECAGEHBED..LBCChAAAaHFEKCCBMDIHhABATAGGAEAA...dCAAEGBFhACA..fEECIFAF.NEIE.JACG..hAIA......hBGA...,2,-29,-24,5
TFIgaJYcRWPEbXdDHVKCAZBQeGNSMOfLU,BDBBeCCGGDFCMIBCLBADFBAG..aEAEJFHDRGAC...EFAFXAEHhAAADDGG.KHDGAEEHQAFDhAAAOAGFfFEGhABAIFFH...gGEGhABA.WCCB...hACA...,2,-29,-21,8
LBMSDVUPKOeYNQcgZIHETAaJWbfGRdXCF,aHCGJBCG.......fGGHdFGBFFCDLDDGSEBHhAAADHEEUBAAOBDF.YEADhABAQAGEcABGhAEAZFADEHGA.AACE.WFDC.....hAAA......hABA...,1,-24,-32,8
XcKSPefYBLaDEJNgVGUbMIROQAdHTCWFZ,dDBDTGEDCFCGZEEG..KAAD..SAGGeDHBBDDFLHDAhAAADFCHEBEE.JABE..gDFDhABAGBCBMDFAICBFhACAOFABAIAEFAGAPFHFaFAH.....hADA......hAEA...,1,-16,-28,12
JCRZdHLecPDTUSgaEAQXMFOWINfGYKBVb,QGCFFCAHOEFA...IHGAGABAKFDBBHAA..bFADRBCDHDFFhAAA.eBFADAGHSGHBhAAAEEAAMAEANCIE.hABAfAHC.YFGFCABA.dFCChABA......hADA...,1,-6,-27,21
fYcQODUGZEHIdXRFBaKVNePAJCMWLgSTb,JADDMEEGLFAH..gBAE.SCHBhAAAfEHAQADAhABADDFBUGCCEBADdFBAFGFBBCHBaAGGhACAVGEANFDFAHHECHDA.WDAFbBBDOAAG..hAFA......hAGA...,2,-25,-7,18
RYabUJIAWZKScgMCdDXLHPTBGeNQFOfEV,KFCCSFGAMIDE.CCCH.DAAFHBEFBBDCGECA.eAFEFCGEOFFAhABAEACERGEG..aBADJCABhACAAGBF.ZCCEdEAB.PCHBhAAAQGAB.....fGGEhADA....hAEA...,2,-40,3,43
QSHIJFWPfYReUBVNdTALGcDaEKOXbZCgM,LCDCGGADaBDFEEBDKBGF..OAAFZFFGCDDD.MFHBHBAH.FEFEPACGhAAAREAA..BAEEhAAANAHA.AAGEDIDC..gFEChAGAIHHA.fEDH.UGBFhAIA.....hABA...,1,-9,-21,12
QUTOEGPXScNZMBYgACaIdWVJLKeFDHbfR,CAGEdAAA.JGEALACH.KEHHeBHDDEBCHFEHRDCFUADB..EFAFGGAFhACA..XFCDhAAASCEAZCFGBHHFhABAAIGC.IBBDFEFGfEAGTAEE..hAEA......hAGA...,1,-19,-28,9
UgXcOWAYSVBfQFTMeEbdPHKRJCLZDGNIa,SGHHBGHDFDGB.MECFEEAA..dGBDKFFFRABD.CBFG.ZADHGCCD.hAAAaBHH..XEEDhABAOCAFAFEB..fHFDhAFATACHeFADPAHF.....hAAA......hABA...,1,-27,-28,1
QYRVZOIUSJbcFDNKAgCeGdWXMEfTaHLBP,eFCDGADHdBDBMIBAEBBF...TFEBLEEABCCAQCEBhAAARAAHZEACOEHHIGHGhABASDEGJDAFFAGFKCHBAACACGEAhAEAfGAH..aGGH....hAFA......hAIA...,2,-11,-10,1
VBbRGCTMEPYKSOQXJeLWHUdgaZFAIfDcN,DGEBVFECBGCC.GCCDCCAF..MCECEAAE.KDEE..QGFEhACAXFBF.JEFEeAEGhAAALEAEUBBAaDHDABDDIGABhADA.fBFFNIAB...hABA......hACA...,1,-25,-31,6
PEVMBLWKYCNQDcbHTZFUGdOeagSARXJIf,RDBDJFDF....fGBEVADH.BGDBLDAEKBCA.CFFBDIGChAAAHEFA.FBFAUBGFdDDDaGHHhAAAAACC...IDHBhABAEHAEMHFC..NDAA.....cFAFhABA.....hACA...,1,-28,-36,8
GXRHAfbJDIZBTeVMLaKWPCdYgQcFUNOES,JGCEDHAAZDGBBDDE..eEEBLFHFKACG..CAAF.dACF.QCFEhAAAFBFAUCDB.EDBBGCAChACARBAEAFFE....IAHHhABAMIAEaGDFPFAH...cAEEhAFASGHH..hAEA...,1,-19,-34,15
JaFBAVPWgeQMNbKOCEcfZYTUHdGSRIXLD,VADH..PHECeDEH.MAFAKCCD.EDCCZGAA.UDGEdDBCSBGDhAAARDAB.IFDAhABADBADaGGHACGC..QFGFhACAOAAGCAFE.YHBE.HABChAEA.XEEB.hAHA.FGED.,2,-21,-1,20
TQAEHgYaJZbcfIDMSRFPKNOUWLBGXVeCd,HDCAaECDZCAG..bGCG....IEBADAIBSCAGFHBGKACDOEEBhAAAUAEEBBBEGAGChABAeHFACGHC.QEGGhAAAAFGC.EFDCYAFD...cGEEhADAMEBD....hAEA...,1,-6,-31,25
ANdcKSeCUWaXZIgDRTGJFYLBHbfVPQOEM,dDCBKDHFCCCAUDFH...aACCZEDC.DBIBRFBAGGDDFHBE..BAAGhABAHBFA...fEABhAAAVAFD.OFAHhABAAAHA.SHGAXEAF..TGEGhACA.JACGbBBC...hCAA...,1,-4,-44,40
DJORfLUQTSBXAZeHPadKIEbWgNVCcGFMY,ZFFBeBAEaHBEdFBB.KDDGEDEE......bAFANAIC...CGHFFHCAhAAADBECRDCHLFFFQCAFhAAABDABAAEG.HCGDICGHhABA..WAECcABG...YFHBhAGA...hABA...,1,-18,-27,9
aRKGUHBcYSVAEZbPXgODefCJNIWQLdMTF,EBBGZDFD..XFCCDGCDeHEG..CFHG.JBFE..IBEHLDAEhAAAMBCDFGAHREBE.KFGCUAGHhAAABDHFSFAHhABA.AIFEPCABOACAfFFEhABAQDDAaHEG....hACA...,1,-22,-23,1
ZNSJaKcABTQCDWPdEUIFgbOHVXfYeGLMR,TBBGQCAA.CGCA.DDGFdHFHUFBB.FBDAODFCHFEH.XAEAhAAAeCHDMAEGZACHSFAEhABAKDEFBAAAPCABhAAAgFGC.fBHE..hAEA.LFDBNIAHaAGEAHIHIHGEhACA,1,-5,-25,20
GFJMLYaUWVZPQIOCgNcfRBedDKSXEAHbT,HFBHGAGAFEEEJAAGLBAD.UCCCZDEDQFBAOHFACGDH.hAAA..gGFHhAAA..fAFDhABAeAEHKDBG.EFGCAEEBMEIDYAHBWEADIHAFhACANIADBBDC.DBFH..hADA...,2,-24,-8,16
QFgIJCPXTSUAfLVRdYaWeBcOHKMbZGEDN,LDBDVCAF.dAFFaDDFeBAA.BFFHHFGHKDEGMGAGGGCFDCFGFACChAAA..IAAHhACACGEGTDFEADDE..fECGhADA.WEADOAHF.EHAANBIC..hABA......hAEA...,1,-19,-22,3
DGNPUMHgVcABKaXQJOLCFfdTEeIbZSWYR,BGDCaDFD.JBEALDBB.CAAD.dDCFEFDHeABHZBED...SGHFhAAARAGHDIDAGACGUDFAhABAMEHFHFAF...hABA.gGAGAADBKHECOAFA.fECChAEAIEAHWFHH.hBAA...,2,-30,-10,20
DeOcJNSFGLaZQUMEKAPBfIYRdHWbCVTgX,BDDH..fBADRABEdBFEHEGDCDBDTBGADAGC..eECBJFCBFHFChAAALFEFZADHQEEChABAEFAEADIF.IGAEhACA..YBAFWEHB....hAAA......hABA...,2,-32,-17,15
JXWMSfOgHFLcDbKIYQTRPBAVUCeadEZNG,CGECeBBAdGABZACBGCDF.JECHMHFG..SGEEODGHHBFGhAAALHCGDCAD.KAFH.hABAIAHA..hAAATECDBEAAAFFCaBBBNEHGXCAG.WABChAFAFAFGYBEFhACA...,2,-30,-12,18
aTgPIQZcbeBdOWCJKXFYVGELAUDSRHMfN,DGDEHBCFMHEGaHGC....TAGA..gAEBPFDAIBAFhAAAQDFDbDAHBEHAhABAdBCACAHCXEBGhAAA..FHDCYHCAEAEFAIAASCEHhACANCAA.....hABA...,2,-36,4,40
JPDeAYXfURaZWQECBLIMHKVOTGgFNdcbS,XDCCRGEEZBFB..ECAFLHFAHDDBKDBBVADAGACG.FAABdDFBhAAA.SHBChABADBIBeDHDAGGEfCAFhACA.aAHFCFAGBHCGMEGB..OGCA..hADA......hAGA...,2,-15,-15,0
ZFcNTSKaGdOHXLMCeQAPUYIBJDVRbfgWE,UFDHBGAAJAEGRCDA......fABDEEED.FEHHNCAD.KBGEhAAAdAADHFAHLDAChABAMAEECBDAeHCE.ADGG.IHHChADADIGG....gEGEhADAWHDA.cAGESBBDhAIAaEAE..,1,-17,-42,25
AgRbZSdaYTJfKPOQCWVXHILFBUecDGNME,REEGSDAFdFBE..TBGEKABBOBHHQCAGCGHA..XGBGhAAALAFCUBEEhABADAAEGCCCMDCFEFEGAEIHbABAhADAaAGA.JHEA..fEGG..hADA...WDDD.hBAA...,1,-13,-19,6
MRaBWSDcTJEdLQOYUCIHAGbgXFeVfKNPZ,GAGGXEBHeGDGKAEB.ZABH.MECDBHEEDDAHJCHDLFFA.hAAAOFADUABDHDDDhACAABBBFBED.fGGBhAEA.RBFH.SDEAEHBE...YHFGhAAAIAHD...hADA...,2,-20,-18,2
aeQTHUMGSYBCNcfLVAdEFPIgKObRDZWJX,dFCCFBDA...IEECKGACODFCDDIDZABE..XBAAeEGDQDAFhAAAUFFGGEDChAAABHAGCAHB...cBGEhABALDAGADDB.EAFEgAFC.WHFAhACAaHGEMABA..hBAA..SCCE,1,-15,-24,9
TFZXeWANgRJQCKGBaOULPdMScfVEYHDbI,RBDACHBHGCGGOAHDLEFBdCCE..SGDF.VBEHhAAAEEBBDABE.IGDGhAAAFFFFZBABeFAFABCAJFAFKHGAhAEABADA..aFDAMIFAfCCG..hAFA..YAFChABA...,2,-22,-22,0
baQeFYMDZCROgTcEVfNPUIGXSKLJHdABW,BDGCaEEC.eBBCFFHDDAFBCCDG..RGCG...TGADEEAC..VEGHhAAA..NDDB.UAGCIHFFhAAA..SGBDhABAJBAEAAGD.bECAMGCEOAEDgDAGhABA.fDHAhACA.XAGH,2,-28,-24,4
KcHWEaYLgSGRIVZPBUQeTNMdXCJAfDbOF,DGBAOCHDKAEHHEEE..EEABLAAFSADAGCCBREDBICCBhAAAPHCG..BHABhACAUGGDQAGAhADAeFCDTAGCdGHGCBBAABBGFCEEaEAG.....gCADhABA...hAEA...,2,-11,-6,5
ZaEfTFDBgXKdGcJUSOAbIMPQYNCLHVReW,MFDCQEED.CCEBLDBBVBFDRBCDZDABEDGA..FAADDFABBHEBhAAAKHGEdACE.GGBDhAAAUGGESAHBhACAAAEF..PBFGHGACaAEB..fDDAhABA....hAFA...,1,-12,-20,8
MCcODEeVIJLKNSYBWfXHFdRGPbUTZagQA,CBDFOCBHDAGF...EGDAeECF..IEDEJGFALACF.hAAAKEGANABBBFHH.XBGGhAGAFBHBGBEAbFBH.hAHAZBAH..aDDAAAHEMEEFSBBB.fDGChAIAdFAC.PHFChBAA.,1,-22,-33,11
KCaXDQfYOIcPRBWUZTVAdeJgMNGFSLHbE,JDAHMAIDGDEAFDEFHAAF..EHGCCFGCDFBBQBBC.OHAChAAAIAEA.RFCFBHEChAAAUAGFTCGDAHGG.hACAgFCENADGLAGB..aGGG.YABChAFA....hAHA...,1,-14,-25,11
PYSaCBZIELRMeOdFgHKbQDWJNcVGfUAXT,TGFASDAE.BHADEDBARFBE..OHEGdABEFBFCHAFBKCHHDGAFhAAANFAB.GEDBABCC..hADAXEGFaBDF.CAAHIDDFhAAALHBGMAFAeHBG.....hACA......hADA...,1,-5,-31,26
HBFeASJfGUZMcQaXNCdPORTWYgILVKEDb,SFCEJACCGBFEZDCCMBBE...QGGEaAAD.CFBGODEEhAAATGAC...gAFAhABAIHFHKFCGhAAADCCDBEACACCA.fFFHcGGF.NBIAdHCBhACAPDHF....hAFA...,1,-12,-35,23
BOGXYeRNcWCdIFHKLTEVMQDaPgZbUfAJS,SHBABEDFGGEBeEBDRCGF....NCAG.CGGH..FDGFLDBFhAAAECCEMFDGDBBG.aHAAgABChAAA.UAEFhABAAEFBOCCG....YBHHhAFAWABEdGDG.....hAHA...,2,-26,-24,2
RKYcNVUSeEQBWXTbgGFAafdCDHPZOLIJM,aEBFdEEEDBECZDEH.LCAA..IAGFMDEEKBAE..NCBHUDGBhAAAEGAFBFCC..XCAChABATGFF.gGCChACAAIHACHEG.PFAHOEAG.JDHD..hAAAYABGcAGD.eHDAhAFA..,1,-10,-36,26
WYFVTLgKJGdfDbQCUaIXMRZBOEHScNAeP,eAFF..PDEEFEBALAAEKEACdGABDIFCQGFH.CFFCUBCFhAEAaFGHMCDFBEHFHAADhAAASFABACFE.hACA...WFHB.YADCTGCDgAGHhAFAJHCE..hBBAfBHE.,1,-15,-20,5
VNTbKASBPLRECdGDQUIefYZJcWaFOMgXH,SDGDLCGFEFFBdCAFDEABUFDD..eEBBZBDH..JFAFaCEDFBFGhAAAOABH.MCDHhAAAXGGAHADDNIDDKHDAAHHCBDHGhACACCHG..IABEfGAA..hADAcEAA...hAFA...,2,-28,-17,11
FGMJZBYENSgfOKVedRUWDQTabAcIHXPLC,HEDELEBECCFFFGAHMIFEZFBH.BAGE.EFGCSGGE.OAAEhAAAKADAVFCH.dBBChAAARGEGDAFEaBGE.ABGEIDAHhABAPCFH..JFAHgDGB.fCCGhADAWGFG..hAEA...,2,-28,-17,11
aDFVBMRgPUIefCWXENZJLdAQKYTOHcbSG,KEBETDCFHBAC.SGCHaCGE.DFAFBAGE.RAAEUGCGeBFHCHFGhAAAEFGCZEECdCAEAGEA..OADAhABAbGFE.FCHHMCDChAAA..IHHFfFAG....hACA.WEFC.JADAQBDChACA,1,-11,-18,7
EMHNdLUZSXYGBDICJeVfOcRWQTaPKbFAg,EEDGHGAALFBDZBCHXCAGGBBF.DGEECFCA.eAEGOEFF.RAFG.hAAATDGCKFEF.AACC.MCIBhABAdAHASGFAhAAABCEEIHHGfGCB....cEABhACA.aHDE..hADA...,1,-8,-20,12
ZELRaPWbXITHOAUMCSdeBYKGDNfFQcJVg,UACBCBABdAEFBGFFKBFAGFBD..DICEFDDA..QCDGhAAA..cAGFVFBEZBFChABAEGGGLBADhAAARCAA.aFAHPHFC..WEFAIAHDhACA.OEFCAIAGMIDC.hADA...,1,-19,-26,7
gMecIKCdGJbTfNFLWRDZOYaXEHAQVPUSB,VDFFSDAH.MFGDeBEC.KDADdABBGCBBJAHF..TCDBhAAAFAAARGCADHGA.OEBChADAaFCAEGDB..ACIBUGAGhAEABCGGgGACCAHB.fAEFhAEANIEB.LFHBhAIA.WBCD.,2,-8,-8,0
ITcQJfBEYDgMbPaUCOWeLSGRVZHXAdKFN,FBGGTCGCQEBF.BEFEDDAGMDDH.aGAGCGHAOCHFhAAA.LHACRACEHFEGACCChAAANACE.IHBD.hABAcBFBJHECEADC.bDDBWEHH..SFFAhADA...hABA...,1,-14,-31,17
ASDWRbZGXCTUPKYVLdQFHIfOJceNMBaEg,SACDRBFBZEDDGBAACBGF.UFGA..KCGALACAdGGAFGACHEDChAAAOHAEeDBC.MAFGhABABDDC.aGAGADAEDAEH.hAAAXGEG........hADAYBHH..hABA...,1,-19,-29,10
ZaFUMWPLEVJgfQeACHOYbIdcTDSGKXRNB,OCCG..IAAGdGAGDDIFKGEHRDDDZFAA.FAEEMFAGLBHFhACA.EHGAJFFA.QAABhABAAECHCDAEHACF..bDFHhAEASGCH.NAEFBEDBaHAC...hAHAWADG....hBHA.gCGF.,2,-29,-6,23
eTXcHBGKaMOPDVgLQNZJIdFfbYASRUECW,UDBEEADC.CGFH.eFBF...TEGGXDEBBGHAKAEAMACFOBCChAAADEDGLGDEhAAA.ZBFEdEGHfDAAhABAAIGCSGCE.cGAAaHDE...PAHHhABA....hACA...,2,-45,-8,37
TLJWYGCSVQDFPUgNObdXIcMKREZaAefBH,BHABTCAHLFCG.JCEGGAAH.CGBHVFGHQADGhAAADBGEFDGE..UDBHODCDhAAAXGGDMFFBKCEHhABARABFEHDEAGAH.eAFG.fEFB.WBAFhABASGDH.hAHANAEF...,2,-22,-14,8
PEKgQMTUZeVHABSfRWYGbOaNXCcLDJIdF,BBACSFEFRGBGGDGCOBDH..XADECHFFDGBF..dAAFEAGBhAAAQAFCMEADTCCDhABAUEAB.eDGHACIHfFDFhACA..WCHBaGGH..NCBA..hADAcCEEIHHA.hADAKBBD..,2,-22,-22,0
WXCIURVLOfEJHcgaYZGQDNMBTSAFKPbed,FFAHKACHeGBGdAEA..CCGB.UEGBRFDE.LCCG.EEAGJDCAHAGFhAAA..aAAC.ZBAEDIDChABABHGHAIHG..PEEFhACA.XECBOHBE.fGAEhAEAgDFB...YEBHhABA.,2,-48,-6,42
ZPRBeJOCSNIKWFbTdgfHDaMXVLYGAcEUQ,EFCFQAGHZFFCBCFGJEGF..CAFA...IFBGFCABdDHGHDBEhAAAMHCGLAAGAGEB.hABAUCDCeFAHSCABhABANIEF.KFDGbABAfAEHDIBG..hACAXAGDYDFC.hACA...,2,-22,-14,8
ZAHfQRdCPOaNGWgDLEcTXJFebSIMYKUBV,QBCFRGEGdCDH.CEFE.aABAGEGADEGCLEBGEHAC..TEAFhAAAFGAF.eFDFSAFChAAAMBABKAGEBGDCAEDEfCGHhABAPBBD.OFFH..WHCGhAEA......hAIA...,1,-1,-38,37
TBQJHRCgSDAEGcZYXUKLMVbfIdaFeWNOP,GAAAZAGDUCAGKDDALDEHMDAB....VGDGIGBC.hAAAFEHHNBIA...OEBEhAAABGBGQEFEhACAHGEGCABDSADDDAHFADCH..cBFC..hADA..XGCHhACA.dAFE.,2,-20,-20,0
NRfaceKSQgHdTEILYDWPbOCGJVMUZAFBX,BEECXDAFRCAA..aCFCKEEH...SFADQFAEHDGBhAAAEHFALBACDGGH.hABA.bECBCEGGJAFGUAEHZFFChAAAAGEB.FHCEcBCC..dECEIHHEhACA.WHCG...hABA...,2,-17,-12,5
eMQdUbRaTCYcKgVXPJSNGZDFLEIAHOBWf,OAFEBAFHeCHDdDHERCCDCHHE...KCAF..VEDB..XGFBhAAASACGZEABDFCBLBADhAAAEGED.ACEGfAHGhABAMBBA.bFAH....aGCDcGCChADA.JCCDNABBIHHAhAGAQGFA,2,-31,-14,17
gHeFGOKJEDYVQULSMZWadRcTXfCNPBIAb,HFEBFBADKCEFJCAF.DDDAQEFG.UGAELABE.ZAGBhAAAaHGAdGCCRCBF.XDCGhAFACEAGBCHH.AHHFeBCG.hAAAODHFVGCCSAHF.MABGhAFAcEFF.fGAGhAGA.,2,-23,-21,2
LfVJSbYFAaEgHKRcOPWCUdDTGMXZNIeQB,aGEFEFDFHBDH.KBGBRDACOABA.CDFC.dFGFGGADMDFBNDAAeAFGhAAABHGDLCBE.hAAAVEFCSBBBhABA.YFBBAFCC.......hAHA......hAIA...,1,-19,-23,4
BRKOaVPTWNSDQcXCbUELFfYeMgGIHdZAJ,JEDDBFAF.RABCKBGEOAAD....aHFATCEG..SDHDhAAADIAAQAFEhAAAXGDHCFGBUEAB.FCCGhACAfCDEeFHHMIDGIGCGdBHA.AHAHWCFDhABA...NAEDECAEhACA..,1,-20,-35,15
bRfKWTBCGEXUNaPQLADOgecJHFSIZVMYd,OACCeAGHHAEHFAGGZCEHMBDB.dABGRCAC.KEFFBDHAGGAF.EDGAUFAFhAAA..aHFGLFHFhABAAGGCDEAF.JHDE..hACASECA..IEDA.hAAA.bDAF....hADAfBHC.,2,-31,2,33
HBPWCeUAMbNLYcGDZfXKEVdTFQJIROaSg,MFAELCDCGBECDGHHZFACKHBE.dBHAFBCD..JAEERAAF..OEEHhAAA..SFDEhAAABAHBCBGEAIGE...YABBhABAfDGH.XADBEEGAQGEBhADAaGAH..PFHDhACAWDBA...,2,-27,-26,1
XRagcPAbWYBLfTdQGUZVDeEFISHMNCJKO,...bFECBGHA.fGAAQBDFUCCBDDGDeCAD.ICHDhAAAMHCCCAEAJAGFKCBGXGAFhABARDEF.cABBhAEAPAAD.AIFE.WHEATEGD.ZEAGEAFGhAHASADF.hAIA...,2,-21,-17,4
IERDUMceJKOgbAaWSQGYLHTFXZBVfPCdN,SHDCGBCHLDDGHAFAFDADBGFE.VGBCCEDBdBAD..IAFHhAAAEDFBDCHBUGGG.hABAMFCDJCABKAHF.OFHHhACAACEGaADG..........hADA......hAEA...,1,-22,-25,3
DCUENXVQfdSIKeRHAbYPMGBaFWgJTOLZc,...bDCDMICE.GBBEBCBDFFHBJAFFLDHFDGAHUCFC.EACE.hAAA.VACGdAHCIAAFhAEAeHDG.HEDEAGFFaBHDhABATGACZFAF.CDEBXGEESFFB..hACA......hAFA...,1,-1,-20,19
GMUaeKIZRSbTCQNEFfABdDgWXJHVOLPYc,DACCXEAEHBFBLBDH..PFFGGBAGMHCCUFEAeAEEhAAAIHHGZBDFSCAGhABACCCBEFBC.AEGEBBBEhACAdHBB.gBGAJAHH.ODDHcEGEhAAA..KGHH...hABA...,2,-14,-5,9
NTaSMEbfWYeKVcHdCAXDgBFZOUIJGPQLR,XFAFDAACBAEHZGFGUFDCGEAF.LCDCRABHaDGG..ECED.hADA...fEHAhAEAYAEA.KHCEVFGHhAAAdBBECHBDADAA.OAHF.IDEB..hAGA......hAHA...,1,-23,-26,3
VCWEPQaGFfNZHdIgMJBTDUKLXebRAOYSc,OCDBSBBF.CFHG.EAAA.QFBDGFBDFADCZCEHdHAHMBCChAAATCCHUGEA.LAGBhADAeCADAHHF..YCFHhAAAWFADaEHF..fHEDIHHBBEAEhAEADAFAKBHH....hABA...,1,-3,-22,19
fIgVNXDKAHLZQYTFSPaJbdBMERCGOeWUc,ZEFFQCGBFCBB.SGFDaHFC.dGGFMCFERBAHGFAFeFDFUFAHhAAA..IEEHhAAANAEG.XACBhABAKDCHAEHH.YHAA.PAFCBHBDCACHcCDBhAFA....hAIA...,2,-31,-12,19
JTKBQMeGAdZbEPDUFWXCLIOVNYcfRSaHg,dECBEGGGUBEEFDFF..CBDELHECOEFC....VDBB..hAAANADF...fGAEhABASCHFaBBGHFCHhAAAJHEABHCAMFIHACBH.ZAFEDACEICCB.hAFA.RBGBKCCE...hABA...,2,-32,-8,24
baHcNSXMfPUIJADGOCgYTZEVLQFRBKdWe,DIGEGAACCDHG...TGACZFAEEEFHLAFE.QGFFhAAABCAAKGDAdEABeECBaBFHHEEChACA.SADFhBAAMABG.fBFHICCBAHBF..ODDGhBCA.....hAAA...,2,-51,15,66
VcfUFRQYDTLKbgCJNeBdPXOAMHWGEaZSI,MHAAGEAAZABASCHD..VCCFfDDARFGDDCIDKGEDCCFBeFGDhAAA.BGEHXBFEhAAAAADHEBAH..IAFAhABA..FEACYAHH.TCBChACA.....hACA...,2,-39,-8,31
YBaXJZCeAFLWHQGPNcDVdUTgESfIbMKOR,LGECQFFGGAAD..NACBDCGBUFAG.TCGBEBBHSECEhAAA.IFBChABAMDAGKBEB.YEDGhAAABHCBaBHDXAGGCHHCADFBWAEA....hAIA......hBAA...,1,-18,-34,16
WZOVSeGFXcAKQNBdYURJMLHDaPCfEITbg,QFGGBGDCdCFHRDCGLBAEDABH..CHAEEFBC..IAHAhAAAbBDF.ZFFFOCHDhAAAVFAH.eDAH.XFDAhACAKEHHUAEFMAECaGED.fCCATCAC.hABAWHDG....hADA...,2,-26,-10,16
DHCLRQeYcOGFZMUfbNBWSTAaKXdPIEJVg,KCCCdDCBEEHH..JCGDDIAELABARCFB..eHDAODEDFBCGUFAFhAAA..fAGFhAAABBABSAEEhABAAFIFaGAC..IFBE.gCADhACACFEF.cGCD.MIEGhADA.WHFE,1,-27,-36,9
PRgWAfYKMZDTSaXebVBLFJCHcUdINOEGQ,KHBGMGDADBBH..SCDDeDCCBAHBJCBHHBEG..dDHAOFGDhAAAEGBB.GEEGRGFCADFFZBFHhAAAaEAD..XADBhABAbACC.FAHFCDHA.........hABA......hADA...,2,-25,-18,7
JcUQCeATMbWGEXHFBdDgYaLfROKNSZVIP,TGABMGFAGAAD.HDAGBABBDGEFaDAHRGAGKDDCZEEB...VBFEhAAAJDCBUBEB.CGGEAGIHEEFGhABA..dBBDLAFChADAOHEE.IHHA..cAGF.hAEA....eFDFhAAA...,2,-29,3,32
gOGDHZBUcPLaQARCWdVETINSXJbFYeMfK,CCHAVAFA..EGGG..TEGASGED.JAAAbDAG.FHDEeCEFhADAKFAGGBAHDBFCBEAHhAEAUEEGLFFEAFDH.hAAAdHADNDDDMABCfDCA.....hAFAOGAG...hAIA...,2,-21,-9,12
VJTQEdXIRKZFUfMDeaOAgBNLcbYSCGPHW,BDCHLBAD..bAECCHFCHBGD.VCDBTABA..EFBFICGFhAAA.RFCAFGAHhABAMBCHDHEAaFFG.ABDGcGGEhAAA..SCFDWHAG.JFFAXFCDhABAKDAC.fAFChACA,2,-37,-12,25
aKRFWHeOSVBTIcbDPCELYJdGUfZXQNMgA,aDCFKGDEFBAGHAAB.OFFGBDEF...TBGH..IFBEhAAADGABCCEF.LEAFhABAdEBEGGDBZADAXFFBhACANEEHADAD.eCCC.SCHF..hAEA......hAFA...,1,-16,-36,20
dHaCQfgJYRPLNcWBITFVSbKGODAEZUeXM,ZAACUCDBMAHFHEAC.aBAFCFDB....QFGGJFFB.RDADLDDGhABANAIABHDB.IHEBhACAFGAB...SGBHhADAbAEEKEEDDADGAGAB.EDGDdAFA..fHGFhAAA...hAEA...,2,-24,-19,5
NJMYbIKVCHdeWZGfASRTLQBUaFOEcXPDg,RFAATBAEQGEA.BEFCFGHBOFAG.EDGFPBAA.hAAADDHHJHBAMBEE..hAAAICEFKHGECCECdHAHWABEhAFAZCAAAEAEUAGC.aFEF.....cCBDhBAA....hBCA...,1,-22,-29,7
ANIMRPCHXGaZOUFVJQTbYSKeDfgdcBLEW,MHDECGDAGCCGZEDAFADD..VEFD..QAFE.TFAGhAAASBAF.hABAKBDCfBBAhACAgGAABHBAECFEAIEGNEEDIHHE..RCAF.hAAAXDAEaAGCOFHDhABA...,1,-18,-22,4
TCfYbIPFUEQgKNeDZMaRBXJHAcSWOLdGV,SEDBLFHBGBEFCDFA...bDAHIFBH.FGGHEAAAhAAAKBDGeHBCZBABRAFCBFEFhADAHDGFAEAHOFGHdHCF.hAAAfDCH...YDFGhAEA......hAFA...,2,-24,-17,7
NeJMOfDXSAGEBZHPRKcaCVQdgYLFIbTUW,BFGAHDCEKGGBaFAA.QAFBdGBHLBDHFEGB....TEAEhAAANCIA.MAIDDCAFXDFBhAAAAEIFEBBBZADHRFCA.CHDH..hABA.gCBA.IFEB.hABAWHBA...eABChAFA.fAGB,2,-22,-9,13
fOJYSZNdFILCQTMDUcGRgEVaAWeHBbPKX,HDCDBECBKAFGOEHB.JHCCZABF.FCGCCHAC...QEEBhAAAMFGHUADBREGH...ECGGAIHAeEADhADA..PABDhAAAXFCGSFEBNIAD.IEAFhABADDBD.cAGFgADFhAHA..,2,-30,-21,9
LCGfcAJObNHWEQIFVUegTYKZRPdSXBDMa,OFCGHCCFEGGHFAGAUCFG..eDAD..gFAGTGBEKBAAhAAARBAF.dGEGSFHBhAAADDEELFHFCFFGGACHhABAfBDAAIAEbFDHWAHBIDBA....hABA......hACA...,2,-29,8,37
LUdfBANgSKeVGRbIQaZCMPTDFHOJXcEWY,.SAFFKFAGGBADRDBE.QFDBZBAC.MICADAIHOGEChAAA.XGCFWAFEUGGDhAAABAGHAABF.eFEEbCFA.hACACCHDFEAH..cADAEADB.LEEEhBAANIEB......hBDA...,2,-15,-13,2
WSbXGeaBEFRTKZCOHAIVUdYcDJMfPQgNL,UGFHdGBEDEBGMDBA..QFGGLBECSEEEGBAHaDFGBHEBhAAAEACB..FFAERAEGKEDAhABAOAAHAAGA.IDHBhABA...YHAG.fFDEhADANEAAXDGE..hACA...,1,-19,-30,11
QWCdVfLSgXHEKURBJMAaTYFeGPIZNDcOb,TCAAeFAGGACD.ZBACDFIDOHFAQFAFCDHA.dHFBVDEDhAAASDFBHDAGKAGCBDHEhAAAAIFAFHCGPEEH.hABAIBFC.NACFbCCBfBHA.hABA...LHAAhAHA..,1,-1,-11,10
KaJXAgUTCMFRdcfQSYEPGbeLZIDOHWBNV,UACEMIEGdDDAQEFC..SADEEGCCGBAGLBAEhAAAIAFBOBEE.hAAABEBBKCGAaDEBXDGGhABAAFCECHAHFHECfCAF.YFFGhACA.PHBG..hAGA.eAHBDGHH,2,-15,-6,9
JFBVTKXHgDWRLONQUGdPCYAEbMfaZIcSe,EHEGMCECZBFH..SGGGeEBEFHAEBCBEKDDBHDGB.DGEHRFGDOABEhAAAUGBHdDAD.CBCEABADaDDAhABA...JFAAXAABhADALAHB..NAIE.......hAEA......hAFA...,1,-17,-27,10
eOZBUEPdgFAaNHWfcQVDGMLJbXKTYRICS,aCDFHEAD...fFCCVGCGGAGEMHEGLBFD.XGABhAAAKHCARCBCSACChAAAOHFEUCAAEFGEdEEGhABAAGGANFAB.QAGA.DIFEJABC...hAFA......hAGA...,1,-3,-10,7
ZdXYLGRIASEONFBMCKUPWTeHaVbDfcJQg,ECFEFEEFCGBCKCAD..UDAG..TAGBHAGF.aEEADBAA..JABAZGEChAAAdHGHLAEBGFDHAIEEhAAASECBODHDBFBHhAEAMCAGeCCB.fGAE..hAFA......hAGA...,1,-13,-31,18
VgUXYMbPHGOTFZJeDQaBWEILNcfCRAdKS,SEAAUEGEMABHHAFDODDDZECH.DADDaAGC.BGCC.EACCIEABhAAALAAH..hACAfFEHCCCERFGBAEHEKHCAXFEHhAFAPHACFDDAeBEB....WAHHhACA.....hAHA...,2,-17,-17,0
PGTMVXRIdCALebWcKgDFUJfaOSZHNYEBQ,LDACeFCC..bBCBKEGC.FBHBUDAGaFEE.OHDEZCED.HEGFhAAAEGABBHGAQAGDhABAGEBATGAH.MACEhAGAXABERCEGCBBGAEEE...WBEF.DIDE.hAIA..SBAGhAAA..,2,-19,4,23
APIDTQLScXJHaOGeCgRKbFUYWfBMdENZV,DDDFTBGDQGCA.LEABXGBAHFGDaGHDGCBFhAAACABFKEFCUAFEfAFHhABABCBAMBCEEEGAVEAA.hAAAACAGIEEESCEGOBBGeEEB.bGEC.hADA......hAEA...,2,-16,13,29
OKSGdDHaEUgVcACTJFQNfbIBYRXZMWLPe,TBEDFACHQDAG..bABBBAHBREACZAGBLEDG.OGBEhAAASHFCdCGDDAEBhABAaDECEFGHgEFAhAAAAEEACAGG.fGAEIHHG.MBBD..hAEA..WHCA..hADA...,1,-2,-31,29
RJVGgSQDafNXEKPLZMHBbdCWOFeTIUYcA,VBAGSCFF.DCIBaGCG...XDEDKAFCLEAC.hAAAMDGHBAHBCCDBOABFhAAAFHFGeEAH.IHDChABA..YHEAADDEJBHFQAEBhACAfFBGEFGC....hADA...,1,-20,-36,16
ScegNEaUdGbWOVARZMJFCfQXPDLYITKHB,ZEACFGEBQAACDAGALEHH...TFFCHDEASGAFhACA.eBFCgBDChAAAaGGFUDACGCEDhABAbCCBOCHFABIBRABHJHCGCHCD.fGBAYAEE.BEEBhADA.....hADA...,1,-5,-6,1
geXfOQVIALbFEUcdTNPaMGSBKDZCYWRHJ,FBFCUBBBdDFE..TFCEaCAH..GDCGSGGHKAGEZFGBCHDA.RABC.hAAAHEAD..JHDGXCEFhAAA.fEFAhABAOFAB.IAHBABIF.EADG.PCHHhACADCED....hAFA...,1,-24,-26,2
HAPgIMaJLTCEGObNRZYKWXVSdBcfDFeUQ,..IDFBMEFAaCEBLBFE.CEDFGEAAOAFFRFDA.ZCADKGFGhAAAXABAdBDGBABGDIGGhAAAeDHB.QGCHhACAAHFGPAHF......JHAE...hADA......hAEA...,1,-21,-23,2
MAcGKfaIdLYEXZWbUTRCFSHOBePJgVDQN,KGGCaGBELGFAEDHH.ZCDFUFEA.CDBCHCCFOHCEBAGEeBFD.hAAAJEADDDAD..MDAAhAAAACBAGACFdABC.XFCGhABAbCGH..FACEPFAF....hACA......hADA...,2,-27,-8,19
CPYOXGRFQMBNgdAaKHScfJDZWeTLIVEbU,KEEEHBEC.SFEAJCAHZBGH.eBACLGDCIFHH.VFBHhAAAEHGAUABD.CCCD.OEDAhABA.XDAFhACAFHACBCEFdAFFAFDGaFACDEADWHEA....hADA......hAEA...,2,-37,-5,32
QbRAPedVLHTJMZXWSBgFIEKNDCUOGcfYa,eFGHdEDEHFFCMHAGZGCC.SAEABCEDFBAEEBGGDCID..UABAGEBFhAAA...cDABhABAYCEG.aEAAQADHhACAAAHDLFADXGEF.WEHBhADAKAAF.NIAHCCGD....hAFA...,2,-16,-12,4
QVCTYONcGAZgWDEaFbdIKJeMPSXURHLBf,ZCDGDFDAFDEGdADBKEBD..MABE..SGADREBDBAFH.QGGFhAAACBHG.OBBFhABANDIC.AIEG.EHAGIEEAhACAeBBG..XGFEHFCALBHHhAGA..fEGAhAAA.YHDA,1,-24,-37,13
VMIQfPSEgUBXCbAFTGZKdYDHaWeNRLcJO,GBEGdDHADDBCHEEHaDBB.eGAGLHCE.JEGDVADH.MAAFhABAfGAC.EBBEhAAABGGACCGB.ACGDFAFAKADENCAChABAOHCE.IBBAQECE..hACASAHH.hAGA...,1,-16,-18,2
aPOCRSWYTHdIAEJQgMDKfLGBVbFZUecXN,JBDBQCCF.MEGFDGDBKFFFLACCBFBH.FBHBZBFCUGCD.hAAAeEEB..XBAGhABANDBC..OAABhABACEHH..SAGA.TDFBhACAIHHEEDAF.fCFAhAGA.,2,-45,-26,19
AaMbCZgXJIPQeDRUcEOGfWHVYBSKdNLTF,aFBHCCECZFDE....XAEBJCAG.QGEHeFADUBGEEAAE.hAAAOEGDGDBDfBCHhACA.HDDFhADAYHEGSDHBNBAB.FAHFAFBE.MCGFIEHFhABADECB....hACA...,1,4,-38,42
eDQGTELWNXfFObZgdVMaKRJUIBPHCYASc,eHFGGADDEEDGLDHD.XDECfFAFOAAGZCCAgEGChAAAVCBB.KBEEhABAJFDFIHBBPEABCHHEhAEAAAEADGED..WFFD..FCGAMIAE.hACA.aBBBBBHHSADDhAGA.,2,-14,0,14
ATQBfgSNDGKYeHLIMdcRUaZCXJEWOVbPF,BGCGSGCDDFGAGAEAKDECHGFCLCACMCFA.REDH.ZABH.CBDC.JEAFhAAAOFAF..PHEChABAAIFETEFA..hAAAfEBBNEEE.eABAIDHF.hACAdAFFaAHDEDAHWHAGFECF.hADA...,2,-17,-7,10
YXfFHbMKBNUDVTcJGCIgWOLZASReaEdPQ,RABDEDBFdFEC..QFEH..YFADFCABHAFH.KABAUAEGhAAADCCGTDGHGDEDCGGFhABAIDEEOHCCAEDBeHCGhAAA.PFAH.fFCHBHHE.hADA.cGBBJFHD..hAHA...,2,-32,7,39
UfaDSMTcdXHFeARIOVZKQYJLWPCbBNgEG,RCCHOEBGZGFCKHAA..JABFLFEF..PGFGCBCCBBACEAEFGBEBhAAA..aDGEMAFChABAdAGCFHBA.ADAGQFDAhAAA..YDAFNDDH.gDGFhACADACA..hADA...,2,-34,-21,13
GbSDAUFYWCTfaXZORKILPQMVBHEedJNgc,FADHCAEF..aGGCXDFGZBDA.KAFALBHD.QEDChAAAMIBABEHHECAHdEAANICH.GFCDhAAA.SGHDhABAABADUFBG..WCCGfABA.IDDAhAEA.PCFGhAFA..,1,-20,-29,9
MebXGZDBdfPFQATORWgUJVILSYNHcaKCE,TAEBOFFARCBA..UDBA..IAFGSAABHGDCaCHHEDGChAAA.MCABeGDAXEADhABADGHHBACHdAHCfDEDhACAFECEABCA.WEAD......hAEA......hAGA...,2,-37,-9,28
YcgAdBGRUWaKTHNfFDbCXJSeIPMQZVOLE,BHACRDDCUGCCKGCEHCAAFADF.DAFE..CHDA...SACEeAAB.hABAMCEGQCFAhACAZFFAOHFELFHB.hAAAEEEBYBHBABFEdCCEaAGA..fBBBhABA.....hAFA...,2,-33,-12,21
RMWeLFOXQJHfdbTBYDNPgGZISaCEUKVcA,MCCHeCGDOEDH..QFGCHCAEbAEE.TFCEBHGFDACFhAAANBBAGACBZCEF.aAGFCFAD.hABAEDEGKHDA.AIBA.WAAChAFA...FHDE.fDDG.PCHFhAIASGAA.hBIA...,1,-12,-18,6
HJAGQaeFOCIKLEXBdVZfRgMbNcSWDYTPU,GBDEQBCCeHEGCFHALGBCECAGBBBBdEAHZDFGRAFH..MEGB.hAAA.NBBG.SDHDhAAADEAF.TAGF.hABAHGAGAIAEaHCCOADAIGFG.KADE..hACA......hAHA...,1,0,-25,25
VOgALFTZMKYDSGfQRNdXIJPUCcHWBeEab,FBGHZFFGMBEAKABG.DAAEGEEF.RDCC.dAHA.JCFHCFAEHGAG.BDAFhAAAEDCB...aHGAOCBAhADAADIF.LGAChAEASCDENIDD.IHEH....hABA.cAGA..hADA...,2,-34,-31,3
bSTCJBNeXHcfVQWKRYgMZUAOPFEDdGIaL,OBADEBACdCFGGGBBLFDD..SAGGTGFDBDCCeDAGXBGDhAAAHECCfCCHhAAAVFAF.KGGGYAEEhABAZCGDAAEHDIEA.IFAFCEGDNCCF..WEHBhACA......hADA...,2,-24,8,32
ARVBZMebKFWEJaTIdGcNDLPgSHUfQXOCY,BCADeDEHKACFFDFC..EAGCaCGB..dGCGGADGDIGA.LGAAhAAA.SHGChABAfDDCODAEAFAHRABDMCFEhAAAWBFE..JGFG..IFGCNEBE.PFAGhADA....hAFA...,2,-34,-22,12
eDEGFIdHBZUaLSYbQNVOKgcMRXfAJCWPT,JBCDCHBC....TFGBEGEHFBFAHBAE.UCEAaBBB.LDAGhAAA.SDHBhABAQFAEOHEEKDGDMBIHhAAAXFAGfGGBAICC...WADBDGDG.hACAIFDG..hABA.BDEH.,2,-30,-11,19
TOLecPHKNVdZGbIUJRXagBQFMDACfEYWS,CBFBEEDA..SFFGLAHHeEABHBCHKHCAdGGBZCDGGBAEUACGRDFAaGABhAAABHEA.FAACMAFGhABAAHHB.....WHFChACAOBEG..cFCF....hADA......hAEA...,1,-17,-23,6
fZcVaMOSCXIQPbWYLUHRgBEJFedANDGKT,DCDBGCDCKGHFZEDEaHAE..MEAB..CCGB.XBFAQABF.hAAA.bFFBLAEEhAAAHBAABFHHFCABAGBGfDFDhABAOBEF.SEBHIHFG.PADChACA..WGBA..hACA...,2,-45,10,55
MIgQHNeXBOVbdcGDURWSfAEZYTPJLFKCa,ZBAATBGCLDEB.KHAAaFAF..MAFCQBEAHBGDXEAGhAAABEHAOEFF.hABAdBAEDBDEWEEFfGGHhACAAEBAEHGC.JGBACCCANACBeDAG.....hAAA......hABA...,1,-7,-25,18
bRfgBVPCYHXaEKTDSOFWNZdMLeIQcJUAG,REAHBGDFCACA.HCCD.XCGAaGBD.EDABKCEH.DIGCFBGGZCAAMFGBhAAALAEC..IHHHhABAQEGHJFAFAEEDhACA..fBAB.PEEBSFEHhADANAIAdHDD.eACA.hAAA...,2,-27,-11,16
BTbFACJdHfEcRNDPXQYGZMLOSVWeaKUgI,CACFJGBCHEGF..EDCBRGAGDCCD..QACCGBEHMDEFOBFAhAAA.SHDAhABAeAFEKGEHIBAEBFEEFEGEdFAGhAEA..fDFGNDDDXGGALEAGhAAA.aBDG...hAFA...,1,-4,-24,20
MZDNEadfBOLSQgIFVYJKPcWTeHCUGbARX,REDCMGBGDCIF...aEEFdADFBAACLHBE.QCCDFHBCJCAGKCFAhACA....PFHHhAAA..cDBEhADAeBGBHBADCHFBGACBAGGH.NAIG.fCFEhABA.SAGEhACAIHHC...,1,-22,-29,7
DKHXINOTSfURQEZLedCJbABGFacPgMYWV,BHHHaEHF.....gGEEMCFCVDDCDGAAKHAEHDDC.XDAGhAAAIEAHOBDGhABATACDUDGA.EHAAhACALGDCCCBFAICC.FCAC.YFHF.hADASAAC.hAEAfHDF.,1,-13,-20,7
DHCEZOKLFPUcIWaBdbAMfTGgSJQXYeNVR,TBADSCCG.QFBCeAHBREEBCFCEZEAHOFGF.LACEhAAAFGHFUADBIBABhABABABBAIAA.fHEDhAGA.JBGBXCEENDIADEEBKBDAWHDGaAHFMDFBhBDA......hBGA...,2,-23,-5,18
RcANOEHgLbdaVXDTeMPfWBJGYZKFQCUSI,ECFDHDGFLACAdGAGaAEE.DDIF..eDBAMAHF..fFCFhAAABFEGJGAEGDAHZGCEFABFUGGHhADASGHFIBHEhAEAABAE.OCDA..bFFB....hAAA......hABA...,2,-30,4,34
WOAeMNDFPTHbYEgVaZRcXUCJSBQGLKIfd,eAHFDFCGFCDDHCCC.EHFCaEHBRFBH...UGGHCACFBBADLAACKAFBdFEEhAAAACBA...MDIDTBFDhAEA..gEAFhABAZFAAJHAC.SEGDIGED....hAEAfAEF.hAFA...,1,-12,-31,19
adGEHWXKAFSQODJfMYcCgPZeILVRTNBUb,FFAGODGFDCDH...MFADCABDZAEBLBDA.RBABBEEHaHGAdHDHEGDDhAAAHDFH..XGGAhABAACHB..SCADhAAAfDDA.YBHHcECDeAHBhACAIAEG....hACA...,1,-31,-33,2
LNgGETPcFOSUDXQWICbMeBfZAJRYdHVaK,RFFFdBDFHCBBKDAGLBGHGFBFEACE..TGDBFAFHOBHF.DGABhAAAXGGB.IAAEhACAMDDCBHDAADECVFABhADAaBAH...NFED......cCCHhAEA..SEEChABAWAFE,1,-18,-36,18
SGaDPLAQbYMOBRTWVEfgXZHUJeNcdFICK,QGBEMAFGBACERFFA..VBEG.EFHFXCBHZBBH.HGBChAAAJFEGeFACdEEFCCGBSEAGhABADABGAEFG.OADDhBAAfHEF.NAIG.IHHDaBDB..hBBA......hBCA...,1,-11,-26,15
SUbNJROaPAZCTQfBVMXdHFKYcIEWDeGLg,CAEETACHBHHE...MICAHCDD.FHDCKBFG...IFEChAAADBGFGDBGSGHDhABAUABGJEGBaEAAZAGHQDFBhACA.fFAA.XCCEhAEA.dAFB...hAAA...,2,-37,-2,35
KQXbMTHUfZJeEBaLAGdSYONcDVIPRCgWF,SFDDOAEFDGGD...VCDFRDGB.CBCH.FDAF.QDCFhAAAMAHDUGEAZGAG..eBFBhAAAaABDAAGBGBAG.YFFChABANEFC..IHHCWEAD.XAGDhABA....hADA...,1,-12,-32,20
DKdGCfLWJTOabBSgZNVREYMIQcFHAeUPX,eFECXEFBdBCFCCAGLBBD..TBGCOFBGBEDAZGDARCDCMDIFhAAAQADG.hABAFBGAACFFPFAHDCABKGAA.hAAAGGED.fDCC...hABAaGDH.SAEEhACANEIG..,1,-15,-17,2
FJNBbeTXIcVDOQGPgLHaKWURSYZfMdECA,JGCGBDAB.eFBE..TDAAXFEF..IEFGDGGEOCEAhAAAQBGBGABGLAEEhABAKGGAUABDSAFEhAAAfGBAEHDGAEIFFDDHNEDB.....hADA......hAIA...,2,-27,-21,6
KPTHVgUZLYMRbOWQdFcADIfGSBJENeXCa,DAGCGDFEBCBEJDCH..eDEACDHD.KGFGHAED.UAGEZDACMFABhAAAOCAF..dGBGFAAEAHED.hABA..SDDBhAAAEBDAaABE...PFHF..TEGAhACA.gBFChAEAYEAF...,2,-35,-18,17
dgCTELOZfQNJIWaGXDcBUPHKeMVFbARSY,RCCGSGCEdFEE.CCHH.LBGFZBCG.QEBGJFAH.IABGhAAAaABBGDFEDAIFBDAChADA.UGGHKDDDMIFChAAAFHAAAAFC.TDAG.fADFhADA......hAGA...,1,-24,-30,6
DdVMYGQEPTgJXFRUcKLOfCZHSIeANBWba,BDGHaAGG.dAHAMBHFGBBF..EADFTFACXCDH.FGEERGFEUGDGhAAALCAH.CCFFSFAAhAAAAAFG.hABANCIGDGDDYDAA...PEDE.hABA......hACA...,1,-24,-25,1
EGdeIUWHYBRJXLOPaMAbQfKFgVZSNcDTC,QDBEFCEFZAAH.SADHDAGDCADF.EGCEeHFE..IEGBhAAAUEBGHEFGBHAEJBHFhACAOBFA.aABE.hAFAAFFDfHGBKHAG.NDIC.cGDG.hABA......hACA...,1,-29,-30,1
XJBCAZKgcHEPfbSaGYOVWFUDNQTLMRdeI,KBFHHGEEEFFC..PEBF..fHGHSBDHaFBBODFDhAAAFHCCUCCDDCBGNAFALAAAhABA.dCAAIABChADABFDFAAFC.ZAGH..gCGH.hAEA......hAIA...,1,-15,-27,12
TQbFRJfOBNKcUAaYgSHXVIWMCEePZDdGL,aCEGSCCBHABE..XFFGVEEFMEABCFBA..EAGAZADFdHCHTCABhAAAQDGC.hABAFGAHJHCAOBABKBFAAGHHIFBDhACA.WBHHeDCB.DEEE..hAAA......hABA...,1,-7,-16,9
bLESVXUNaZKcJQAPOBTRgWdIHfCYGDMFe,BDBDRDAHdGGBHEEHCCHBGDCCMADF..eFECLCHHEAFF..SACGhAAAVGBEUAEHaHGEKABHhAAA..JFABAHAFOBABhABA..gGEAfDFBDCCC.FBABhABA...NEEH...hADA...,2,-19,-4,15
HSeBgEFYRQVCaTGUJWbfPLIKMOXcNZDAd,HFAHSHECBDBHEAHBRACH..CAEE.aEFAUGBB..JAAB..fAGFhAAAPFDFKBDGXFFEhABA..cFFAhAAAZCAHADEDeDFAFDDB..YAFH.hACA......hAGA...,1,-18,-27,9
GJUeXRTEZgLKWFaYCQdBDSHNbAfPIOVMc,..IAAAMDAGJAEHUGCH..eAHDRDEDZCCHKFGB.FAAFCHGDdBGEBGFGhACAHEAH..ADGCOGAGhADA.GDCDhAFATADH.ECBD..WEHBaFHFDGAF.SDGAhACANIAF...hAGA...,1,-11,-32,21
YILKJDVBQcdNXPMCGOFWgUZSaAEbRTfHe,EAGHTAEHHDDH.eBACLFHBKBHB.DFEGBFBBQCCFdEACXFGHhAAACGEHFAAF..UAGChACAaBDEAEIDRDAH...fHDHhABAIGGCJDFGcDFEMFDD..OCAEhACA...ZGAE.hADA...,1,4,-15,19
WHFGaDLMCdbSKUNRJIegcBTQEPfZAYOVX,OAEHVEFB.HDAGFAACGBDFDAGCLDHDdFAH.KGEDRGBC..JCAFeBAChAAA.BEFDEDDE.fFAAhABAACCF.XGGGhACAMBIFCHHESHDA..IBHGhADA.cGBEhAFA..,1,-13,-27,14
TAbOCEXVIRLfBUdZHaWSGKQNJDFMPgecY,CDBFXGDERGDG.LEAABGBEUDDBZBAHHDGB..SAHHhAAAKAGBNIAD.DCBCMACFhAAAeACATADE.ODDGhABAIAGH.fCFBaGHDWGAC.QFGBhABA..hACA...,2,-47,2,49
FZcTRCLfPUHbOAdXQDEMJINgGaVBKSeWY,XGAFEDGC..JHBG..IFECGBEGBGAHSHDChAAAeCCDFHFAZDAGTBAGhABACBCB.PDFAbCADACABDAGAhAAANCDBaGGE...WADGcEGE..fAHEhACA...hABA...,1,-6,-32,26
dJfbcITXeEUgOSVGAYRaQCNBMKLHZPFWD,aCCAQBDHBBHALFHDZCAFFEDA..DBHDJDBC....bGDATFEBhAAA..XDGGhAAAEGBCUBFASGAChABAAIAGCHEGKEAA.HABDPACGfAEB.hABA..IHHFhADA.OHAE.,2,-23,-4,19
AVfIXNDCTGSUKLFOgcdeYWEPQbJZRBaMH,VBDBXFBC.DDAECDHBGEAB.UBADKGHFFAEH.OCEEhAAAdFFHeGDGEBAG..QEGHhABAbGAG.JAFCBBGFhAAAaCHF.AIGE..NIBB.LEFD.YACHhAIA....hCAA...,1,-18,-22,4
SOgYcaQdWFGKRDMNeXHIVCfZTUELAbPJB,JFFHOEED......gDCDaBEEdHGBFCAHRAFB.DCIF.MCDFhAAANBAG.HABA.CAHGZFBFhABAEFACABDFBDGFSEGChAAA...YBBDWFADKEHFIHADhABA.fHDDhACA.,2,-44,-20,24
ZEWYFVfJDBKOdTSaPcRIGMAbQULeHgNCX,QAGBeFFBHAACCECAEDFCFEHF...JAEABDCG.KEBDdDADaEEHRBDB.hAAAMFFCUGCFLACGhAAA.XGCDhABA.ZBBCYAHBDGGGSHEEIHHEAADG.hAHA......hBAA...,1,-15,-19,4
EQScTZNgaeUbPJAYfKCOMHWIRGDLXdVBF,KAAEOBBBMEGFHEDG.RFAADHDAdCDAFFHH..QGGGSEBHhADAZACD.aAABeFCHUAFDhACAbAFAAIEA..CEGE.IHEEhAEAXCECBCCD.EGABNBIC.....hAGA......hAIA...,2,-23,-7,16
CcEYWaDUgFVSKPNXbTfdOBQGHMAZILRJe,ZCDHLCECRAAG.eCBHCAHF.ECAFaFAE..DEIFFGCEKGEA...XEEAhAAATDFGdGGDBBAFhABAQBFDMHACAAGEIHHEhACAJDAA...YFAGWACE..hADA......hAEA...,1,-26,-28,2
BRKYFgAZcUVXdEfaeMCJTDWQbSHPIOLNG,UBCFVBEC.EGAF..aDDCCCHC...DHBGQEGCHEBA.OEAAhAAANHEFBCBG..KGCEFBBAhAAAAFDCZGFAdGAGMGFG.hABATDGBWAFDSAGG.ICAFhACALAEE...hADA...,2,-34,-10,24
FNgDXbOeQdGfJBYMLKPWIVcaZTUERSAHC,FHDADBCHOCEFdAGGGDDHBGGFLFAH.KAAFIEBB.hABA.aBDHTBGBEHGEAGFECCBDhACAXGDA.eAABhABAfADDMIBAWDAD..cECChAFA..UDGH.SACEhAFA,2,-31,-22,9
JVKIfUdEabPMQRFOASDGeCWHZBXgYcTNL,GAAFCDBGHDDABCAC..gFDF.TAFFLFFFhAAAKECFUGGHEFAHaBHFMICGhAAAQAEHFDDGAIACSEABhABADBBEeHAAXGGEYCHB.cDGAhABA......hACA...,1,-6,-24,18
dNVURLceKWDEQXHACIJgYGfMbFaTSBPOZ,CGHAJEFEGEDF..MIAAaBEF.BBGBZCBGdGDEUEAHLBGF.hAAAKAACDDFA.QBDBhABAACID..IHAChADAfHGBFEAHSHGGOBBBRGCEeDDBhACA.XFGE.hAEA...,2,-29,-21,8
IRgNAdCXcWUVDBeQOfHLMEbJKGaTSYFZP,CBGCXADHUCCG.BGFG..QDAEOCHDHABDMGFAJAFCaHCAhAAA..TFBHFDGCZFBEhABARCEAAGEHdADH..WBADhAAADDFDLHFA.EABHKHGGSAGEhAEA.....hABA...,1,-7,-24,17
CDAKaJHdBRQeMgbWTfVLOcNIEGZFXPSYU,JEBCBBAD.RCCH.QFEEMBGH.....gGGHhAAAbEFE.TAEFLEABhAAANBIC.IHGEZCDAFABFSAGBhADACHCBDAIBAAGEaADAHFCCdGCCfEAEhAEAOBBG.EHDG...hABA...,1,5,-25,30
cMgadEIebTJfSFWRGHXCQPUBYLAONKDVZ,KBDDZFDAMADAdHFD..EEBDeHAE..TFFCSBGG.RCBDHBEBhAAAQGCHBDHCACAAhABADEGA.VAABaEHDIHHAhACAfBGAWEEGCEDC..PADA.hAHA...YBBChAIALAHH.,2,-27,-4,23
VNRPBfMIEZKDJcgYQCTOFaHLAWGXUSedb,GBACUDAAdGGD..NCEB.BCEH.MIAAZDCDJHEE.....hAAA.gBGHhABACGAAFAEEaEEHAIHCXCCH.hAAASAECeHAA.bFBEPFFGEDHFKABHDEADhABA.cACB..hACA...,2,-29,-21,8
JQIedVEHgXbUaRCcNAKDGLSZPOMBFWTfY,KADGDCEBLCAFZDDD.OFCBMDIFBAAEFGAH...TCABhACAJFFH.eFGHdBGHVABChAAAEFAFHDFH..XEGBhABA..aFCHCHHEAHDCSHDA.hAEAPAFAWDFC...hAFAfBHC.,1,-15,-24,9
KZQfIcLAOeYGCJgVXMbNaTUdDBPSHFREW,OEHHGAADCAFG..VGCAMIDE..aDDBTDAH..DAHHBGHChAAASDAHRFCGKDECQGADhABAIEEDABCDeEFAhADAJADG...bAGFNAIC..dAAA.HCFHEDDD.hAEA......hBIA...,2,-17,-9,8
cHTIFZDKOaLNUGMAWCVgEJSBXePdfRbQY,VFGBJBBFBCGE..eCDBdEGF.RAEH..QEAHHDDBFGADDAEDKHDELBHDhAAAGGDBACIB.CADFEFEAhABA..SFAChAAAfCAB.YHAAIACB.aHGE.hACAMBAB....hABA...,1,-3,-35,32
YHRgIUVMQdAWJGDPXbKOTLaZeCNFcfSEB,GACEDBCB..XFCCOEGFaGAFZFFC.CEEC.FFAH...SBEAhAAABBACRFCDUGEGMEBAhABAAAHC..JCFEKDFAeAFGhAAA..fHDFEEAC...YADEhACA....hAHA...,1,-18,-44,26
KgUNDRcBQWEISXaTAJPZfCVeYbLHGFOMd,ZACFCGGA.eDHHLEAEFCGG.OBBCKFCCUGADDEEBBHDD..QEEGhAAAEHEE.SAFGhABAXGBFADDAJHEEhAEAVAGD..YBBB....hAGA......hAHA...,1,-26,-40,14
WUADgcdPIMTZXBOGHJQSLfVENKCbYaeRF,DAHFdEFBMBEBZBCABDAGGFADHGBA..QGFDSEFGLABHhAAAEHEA.CAFHaHACFDGAAGIFhAAA.....gEBChABAIHDGXDBA.JBHFfAFGhACA..hADA...,2,-38,-12,26
cFVWHOfJRCBDPYIAUNgQMEKeXTLZbaSdG,UCDDQAFAKGGG.eHDGLHCGZDFESDBBdAAHFAEG.VAAAhAAAOBHF..JFADCHABBDBFhABADADE..IEDFhAIAAFFG.MGDEEAGFXECGaGHB..hADAcBECfEHGhAIA...,2,-40,-5,35
UfCJMSRcXEbTWGAZKDgVNeaQHdIPLFYOB,DAGDVAGDeCHF.HECGdFGFLECAFBAF.BFABCGHDMCCERBBEEADE.hAAA.TGEEGGAFABHAKDBAhABA..NIDBaDEGIADHhACA..OAABJFADSGDDhAFA......hAHA...,2,-21,-12,9
PRXeTKIGYQdBSCMFJObHVULcfENAZagWD,ZGFAaBEB.DDHHRDFA...eCEBKGGFGDABdBCABAEEMAAA..FGAEOFDHhAEAHBFELCAHhAAA..EFAEAIAC.gBBEhAFA.XAGH.IFHChAGASEGD.CAGB.hABA...,2,-35,-14,21
MGPNeCgSJDVbUBfYIaXAHdQcLKEOTRWFZ,HCFBQDEBLACHKCHB.TEAHFFCEMAFHGGAB.eHFCSABChAAAVAAHBFHBIHAGhAEAACEBdAGDOFDEhAAAZGFGCCCDDEBGfAEE..XAGChAHA.EFGC....hAIA...,1,15,-26,41
IfPRbaWSOJCKYBcLNVQUZDgMHeEAGFXdT,FCDFTFED..IDHCRFAA..aABFSBEBOBFCCHHHBEEChAAALCBD.NEGA.UBDChADADAGB.MAEG.EHDEhAIAAFEFdFHC.fAAF.bFACWBBDhBAAYHAG...hBHA...,1,-25,-28,3
CZYGLEOcUJgSDWebFTHfXBVAPIKdaNRQM,KEEBaCAD.RBDH...QCCBCABGGFADLDHDOFAGUCGE.JABEhAAASEAC.hABADBFCeHAEFGFD.HFEGhAFABCAGAHHEIAGFMIAAEBCF.cGDH.WCEHhAIA.....hAAA...,2,-32,-6,26
HUMTFAReCEdDISQLPgGJBcbfXNVaZYOWK,RBEDeFGBEEGH.DCAD..QCAALBBBGBDGBEDD..bFAHXAGGhAAA.aDGAOGCChAAA.KAGGMIAEhABAFCGAAFIDIFADSBBEgGEEfGHEhABA.NACF....hACA...,1,-10,-28,18
MIZScVOBdLEWAafCDYHbUKRQgeXTPJFGN,CHHCDFBAHCEGUABFKBDG..RFFC.QAGF.eDAAPAGHGFBDhAAAMFEBSEHHhABA..OCAHhAAAdFACEHEEADEBaHAEfBBHgDGCXFFFhACA..FCCH.IHHDhACA.,1,9,-41,50
fCLaWdKGYJHSgVMEQDFTXZPcBRNAbIUOe,UBFAOBDECHHF.LAAB.dHGDKBBEJDGHHDCE.SEABhAAAMFFFDDED.FHACZGBABFHChABAAACH.eFCDaEBA...hADA....WEFHYAFCECAE.XEAChAEA....hBAA...,2,-30,-30,0
EJXeLFaUKVCHdZMRPIcTBDfgWObGNYQAS,EECHJDDELCBHFFAD..aCHBKHACHAAH.dCDFMAECRFFD..IGDEhAAABGHHDGEE..hAAAfAEHOHECNAIG.hABAAHFHXDAC..eBEECEFC.cDFDhACA.....hACA...,1,-20,-36,16
PJaELGVbMQCHNgXSRWKdOUYDAIfZcFTBe,ZBAGFAAFBFDCeAGB..aAEHEAHH.LHAEGGEFMFEEHACGXCCHhACARDADdAAD..ODDBhABAUDAGDHGGAAIB.IFGDhADAfGCE..cCGD.PFEDhAFA.....hADA...,2,-18,-11,7
HZDVOMGPCNXUgIRBKfbYeSJLWdaETcFAQ,ZABHDHFAMAFCGEGC.CDFB.UECFRFCH.BBHEKDAA......fGAAhAAAeCADLABGhAAAdBFFEGFDFDGA.AGBH..hADAQCDH..OADFXFGEhACA..IEEAhAFASHCG.,1,-21,-37,16
BLTDPdKOgbXcfGWIZFUNAVHReCEYaJQSM,REDAEFDF..aHGGQCDABCBALFBBDHGGKABD.OAFE..hAAAgBGBXFACfADChACAGABHIDDHhAAAFEHBADAEHDACCEHASGAFMDFAdHCDWBADhABA.UGDDeFFF..hADA...,2,-13,-1,12
bICKLWTXPOUSJMNfAQEgDcaYGHdeFRZBV,QGCHEBGCDEAB.aCDBHFGF.eDEAFFFBRAFGBBEC..VEAAhAAAIBBECAEF.LAAFhACAXBACOFCDhADAJHFEMEFAAHAEgDBF.....hABA..YFFDhAEA...,1,-16,-24,8
QOKUgfZDBISMWabCVPNTFRLXJYAEdceGH,dGEFGECFOACHKBBHUAEHZDDABAGC..SBHBMBIH.aHDAhAAACHBA....NBHA.TDADhABALBAH.JFAAhAAAADGCeFAB.gFGHDIFAICEAWACBhAFA..PFHF.hAHAFADE..,1,-21,-29,8
CFWZMHIDTBEeSJLNKRPcUfaOgQGdYAbVX,VBGFCFFGZDAGHGDA.DBCCBBDB.SDDFLABFKGADRFAHUGFChAAAODFEGABG.AAFEFEFChABAMIFE.EFBGNEEC..hAAA.fBGD.aADA....hAGA......hAHA...,1,-21,-24,3
ABFfPHGQKLCEYJNOgRTZWdcUSXVIabDeM,BFGGFFCEHAACGGADLBEBCCFA.EBGGJDCCOFFH..TAEChAAAZEAFdEHG.SGADhAAAIBBC.DDAEABDHQGEChABA.KEAA...gAGBhACAWAFEcDCBXDGAhADA..,1,-21,-24,3
BNKfTaCgIcSHULeMJVRbOPWEFGYXdQAZD,BHCHKGBG.aFFBCGHH......IAAGHEBGUCEAMCCFJAABRACE.hACAOAGF.EGAEGAFEhAEA.XEDHhAFAABDBDIEGTCBHSHEGLEHBeAHB..hAIA.PFFAFAEG.dDDBhCAA...,1,-16,-19,3
CcTASeDWdgHXUJfNOLGYbMPKBFQZVERIa,eCGHDEBBdHBFHFGHUDDGJDAD...OBBFLFGBGEDEMCCDBAAAhAAAFAHH.ZFBB.VADDhACARADACCAD.ABGE...SGEEhAAA.XCGGfGAA..hADANEIA......hAFAYABE.,1,-2,-28,26
GCcLADKNUYJSReEPdFQZWaBHVTfIgMXbO,KFGDUBDE..JDEFRFCAECBB..FBAFZBFBBFCD.HAFETEAD.hAAA...fDCEhABAICHGMFIHOCCGhACACHGDAIAEDDAD.SHDGeHAEQABEhAAAaEHFXFAH..cFFFhABA.,1,-26,-27,1
IXRQOHaKEBZMUJNSTWCdAYDLbFfcePgGV,LBCCFCGEeCEFGECAVDEF..RDACHGAAEFHFBBBBZEGB..JAGFSHAGhAAA.TGEGhABACGDBAGIDDADG..fEABhACAgAAFQAFF.KBDDhADAMICA....hAAA...,2,-20,-6,14
YOIMNXPUZeQDTLBFSAERaHKgJdGWcfVCb,RBDHKACFdACEGEBG....fAAACAECOBHF.MFGH.XGDFhAAAPFEDZBEBeCBBhAEADGIFLAGBBDAHAHBDEAAFhAAAaFHDJFAD...WEFC....hAFA......hAIA...,1,-16,-34,18
SbUcdJCIXTBZOLKfFPMAENWgeYQaDVRGH,ECBF..gBFGeDDAQGADDBCAREDCGBAESGGA.hAAAUAGCdFHGJFAHCHECXABAhAAATGEFBDDCOAEBhABA.KDHB.FFCGACCANECCaFFE......hACA......hAFA...,1,-6,-18,12
MVXfSOaIdLYTCHcZBFgNeEJPbGQWURAKD,KADEMEED..XFFHSHAC.aAGGIHAA.LABBhAAATBBHCEBGZDDEBAEEhAAAgFBEEFGF.JAFEhBAAPCEC.bDFAWCHHAIBGDFFDOCEGdABF.hBAA......hBEA...,1,-18,-23,5
WRHGEDPZQKeJUFOCdIaASbcVgTfYBLMNX,SCHFVACA..TDFBBEAELCCFMAAB.XFDHhAAARFAHEEHFDIGGQGADhABA.KGGFJHCEOEDAhACACEEGaGGEAAGEcAGG.gADGfFCDhABANDIG.WBBD...hAEA...,2,-22,-19,3
TdYMHENLWbVBGgDSCFfKXJAOQIRUPceZa,QAFHRBBEUEFF.eFDEaAFC.dDADHGCELHDG..VDAHhAAAgAAGDGGFFHACKACChABAAIHAIDDB.ZDGHhABAMDEHEHAE..NAIGBACBSCGCCFAC..hAGA......hAHA...,1,1,-22,23
UbHZcCJdPXaKVLNEYMARgWTDIFGeQBfSO,RGEETACFFDGGGADB.BFDGOAHH.UFCAHDADCFHC.dABCaCCEKDDAhAAALCAHEHCE.AAIFDGFFhAAAIHAC.eFFGhADASGBF.bAEB.ZFFF...hAEA......hAGA...,2,-16,-14,2
WaFMTAQUbCLSBIKYZNeOXcPDJVEgfHGRd,QAFCCDBCLEAABCHAKAACZFBE..eBCEODFC..XAGFhAAADIDAECDEHGFEGGEBhABAdCBAaGDHMEABAACESGBHhAEAIADB.NFEH..JDDCfFGBhAHA......hAIA...,2,-19,-15,4
ISVLdBRHWMDAaYTXFcPJGONgbEZQCfUKe,aBDFTCFF..FEFDJBCCODAE....NDAA.EFADZFADCEHDKCGChAAASEEDLFDHdGHChAAABBBARBAB.MFCFADDD.hABA...cDGE.PHCC..hACA......hADA...,2,-37,-22,15
IMCdZfAeXELWTDKUcSYBGHJbRNOaQPVFg,XFACECEFLDACDCCF.KACH..UBEBSEBHBCHGHFDERDFCOHBEhAAAaCAH..PAAChAAAVFGDFAFE.IBAGhABAdGHEADDBeEEE.WHBGcGDA...hADA......hAEA...,2,-22,-10,12
PJXWfYVbgETIZFUONCHGQadKBLAMSceRD,MFBBSBAGRBCB.DCGBJHFG....fEEAVCFD.EDBChAAAZFCBUFBHOAAAHAEHhABAQAEGdHADKGHHAHEC.hACAeFFAXGFD.bAGFIAHGCADF.hBBAaBBHBFGE...hAGA...,2,-24,3,27
MRXQWJLCNeSbZHGBcPYEOVdgKDaIfTAFU,FCDBREADQFFCLAHFCDFF..SCAEZFBFBGHH...YCFGhAAAOEFCdBAG.DFABhAAAaECE.TADEAIEGMBCEhABAJHBG.NIEB...eHEE.....hABA......hACA...,2,-33,-21,12
XCfEMOFPTUacbZdJDRGgKVYWeLNBHAQSI,SEGGXEDA.EFBCFEGD.UCGH..aAADZADGDGIHRFAFKCDHVADGhAAA..eBBBBCDGAHHH.hAAACCHBMIAA.OEEFhACAPCAH..bDACJHCG......hABAYHEG.NHAF.hADA...,2,-27,-18,9
aBIFMGbfHKNJdCTDAPWXeQOYSgRLUVcZE,XEGAOACD..SAEDLABBVECCEDGABCAA.MGFGhAAAfAEFHFBEKAHHdGBEhAAACHAHDDFHAGGDeAHH.YEADhADA..gAFDcCEAaHGEIHHAhABA...hAEA...,1,-18,-23,5
PQSDeOdZUbJacKBTEGINWFAHXMfCVRgLY,XGFEMCBE..CFGARAEBLBGF.QAAADEGCdHCBZDADbDCHhAAAaEECBDHB.TEAChADAEAAG...GADAhAFAIHAHNHAHAFEC.fCGF...hAGAYFHB.SDDFhACA,1,-14,-33,19
MbaUQSCRIBZHYeDJOKNGEXgTLdAVFWfPc,FCBD..fEBBMEHHUFABQGEF.RBDBBBHGZBFDeAAEhADADEIDKCADEEDEXAEFhAHALGACAHHC.PABGhAAAbFDG.CBFG..IEFHJHDENBIG....hAFA......hAGA...,1,-13,-25,12
ZRKcXMCWOfBVeAYaQdgHNISDGPLTJUbFE,aDCHdGEGHACE.SGGEDEAHGADELGACJFDB.FDEEEABEZAAHhACAKHEAMCIH.OAFGhAEABFGGACGE.QGAAhAAAIHBC.......PCHDhADA..bBEE...hAFA...,2,-34,-5,29
JXbDefaKMFcYZWVGSIBELAHNQTOUPgCRd,QAEEOADAUCEDCCDB..dFFF..XCAFeACFKHCE.MABHhAAAFGFFZDCHGEAHBHAAAHACHBGBhACATAGG.RABGDICChAAAaFHD.....YEFGWDDGSGGDhAEA..IHHFhABA.,1,-1,-32,31
NeISaCLFcJMHGTZbURfPQBKgADVWXdOEY,VDDCdFAAEEDH..eCADaBDB.LHDG.FGADMFIBHABDTBAEhAAAZAFHRFCG.QFFGhABABHHBAHCBDGGCOHCE.hAAANADFCECF.GBEDfBDFKEGC....hABA......hADA...,2,-10,-1,9
TNUDcFEKGdYPgRLHZaOQSIWXVAfBJMCeb,BDAHCDHB.eBHFTEDADBAF.FCBAKGBD.GEEDdBFD....PGFAhAAALCBBZEADaBAGhABASDDA.IHGHhAAAWHAA.XGCFfADGMAGBNAEFEDGBhACA.....hABA.YBBC.,2,-24,-17,7
GdRXZYTHBbOfILUDAMWJPQKeSgcENaVCF,MCIFJEEB.KDBDeHAC..SBBCECEA..NADG.aHEACAEAGBGEhAAAXEFD.TCDChAAABEACOBBDLAEEhABADABFAFCAPGBGQGFD.....hACA......hADA...,2,-26,-22,4
CSJFVHPDELKINgWMTbfOQRacYBUZGdXeA,SFDCVADB.DCDEEBBFLGFCKAHD....IGHHhAAANEEHMACH.TDFE.hAAAOGACaFBBBCGAZFDDdDAHhABAABEGCDAC..FAGB.PHFEWFACfHFBhACA....hADA...,2,-29,-22,7
fIFVYeLETCNAQHdDXbUPGgMBJKWOSZcRa,QBABHABCXECHUFECGCDFBHDGKGBBSCHHZAFC.aEADhAAAFCDHeCAFEDBHCDFFAHIHDFFBhABA...PHAEhACA...MCCDWHFAcGFEfDGHhAAAIAHC....hAEA...,2,-33,-3,30
COXBAcPagfMSHDZWeKQNYEdbITGRFLUJV,aHEAMFFCHDGBZAFBKBACQCAB.EBFBdDCE...bEAHIAGFhAAAGADCFGGGJECDOFAFhABAAFAH..PHDEhAAAgBCBDCAHNAIC........hACA......hADA...,2,-17,-16,1
QHMIJTAVaUECgbDSYeBWRLXFdZKfOPcNG,aBGAEGAE..CGHC.DGGF..SGDCBEEALBAHdBEDZDCGOFHFhAAA..PHDCGEBEhABAHCAHIADDTABChAAAAAGCVCCGgCGCeFAD.XFFBfGEGhACA.cBFHMAEC.hABA...,1,-11,-13,2
RcWVHSLJEFIAfQKPBYGUbgNCZeOMTdDXa,KDBGBGCGUCGA..NCDA.ZEEH..eEEFMADCDCAA..RABG.VBEAhAAALFCF.FFDDAGFEQEAChABA.hAAA.YAFG...gGGBhABAOHFCdFHA.aHBC.WAFEhACA.SDAE,2,-35,-23,12
NCBdXOeGMKYSVWDEULJZbQgRPacHAfFIT,FGEHTGFCBGFB.dBAFOABHGAEF..MEAHKDGD...VBFDhAAADIGGEDACLECH.hAAAbADFQDDBhABA.PFCDaFFAAEHAfACGCFAE.XGAHhAGA..SADDhACA,2,-26,-25,1
DWOFMHYZcVTCNBdefREJPLGQSAIaUXgbK,aAADXDFF.KHFAOADC.HDDFZEDHVADACGFBBGAC.eAFEhAAAEDABLFFGGCBCADHB.hACAIAHG.bABHhAAADIFG.MCID.TGCAdGCAfGAGhABA....JFHHhADA..SCHH,2,-16,0,16
daDZGVEMXCOTFfLJcNYPRgIAeSKHbWBUQ,SFDEHBFFBAEGUFGBdCGCZBADEAGG..MDCAOFCDFEBDLAHHhAAAJBAG..NCEG.PHFGhABA..gDAHhAAAACADKGAD...bFEHaEGEDIAEXAFChACACHHG..cFAEhABA...,1,-12,-25,13
QFdABPJOUCTWESXaLfRZDKMbHgcINGeVY,JBCFCGHG..EFAF..XCEBaCDG.LGDGZDFDMBBBHEGD.hAAA.IEEBeAFCQEBGhAAAFAFEAIDCBGCHOBHDhABA.WCADSACCfEEEDIFCKEHBhABA.....hACA...,1,-21,-30,9
HZVeQFEDSJdcgAbGKWPNOCRLTIfMXUaYB,KGCB..PAFCOFEARBDELCHD..TEABMGDAaEEChAAABDFDHCAFeCBGECCBDGIFhAAASABEdHEFAABEGAEBhADACHGBXFAC.......hAEA......hAFA...,2,-35,-2,33
BKYMFAVTDXLSHGaIJRgbcdNECWPOfQZUe,TEBCDGECLADA.HCCEGDEC.IBHHJFAHRCAB.bBCGdCFEhAAA.CFHF..OHCChABAfAAE.ZGBABCHHhACAMBDAAAID.SGGBaHEA.NAEHEDGB.hAEAPCAB...hAFA...,1,4,-24,28
PXKbIUEDTdOgAFYBZVQeHRcaWNMJfSLGC,BBAAZCCEeEHHHDBDREEH.aBGH..MAGF..fBDBSEADhAAALFDACBADKHAG.IHCDhAAAEEBBDADDdAHEAFECFEHDhABA...YAFC.cCCANIDH.hABAJHEC.PEABbECH.hACA...,1,-3,-18,15
MeOPIaANZUFfETCDHYQKXJbcdgRVSBGLW,UGADEACF.DFDGQGFH.JFAAbBBBdCHE.RCEF.BAFELHBAhAAAeCFG.OCAC.hAAAaBEGAABCZGEEFAGACFGBHBDBhADA.KEGD....cEDH...hAEA......hAHA...,2,-33,-5,28
KGEcfSJbBNMZXRUdYWHLQAFTeICaOPVgD,eEECaECF.OCDG..gCGFDGDBKFHHGCAAEGHF.SABGhAAABHAEMCFFXGFHhACAUAABdAFB.WDAChABALAHBAGFD.IAFECGCD.cCCChADAfEHA.NEEE..hAEA...,2,-24,-21,3
TICAFJSeafGQgHLXKVEYOZNcMDdBWRPbU,FEGGSEDDeDBFGGABHCEDKCGE.EGECOAEFZCBB.MBAEDCADBHFHhAAARDDFUGGHCAFEABEHJAGD.hABA.aDHD..fCAAhAAALHAG.XCCF....hABA......hACA...,1,-15,-20,5
CXYKScUefPNBWLaQgAbMGIRFETDHJdOVZ,MDFGGBEDRADD.FFDFDCBAdBBD.ZFED..XEFHSHGA.UDAFhAAAeGBC...NIBBBBGAhAAAaDHFAABG..EDDGJCAFhABACGAE.KFAD..fGGHWFHB.LHAGhADA..gDDGhACA,2,-28,-24,4
EPaegTNGHXSKYVCWIfAMcLZRBdbUOQJDF,LADDBFGCdFCHOBCDJFAD..EDFHeCAD..TFCGHAFGXEEBhAAAKCAACHEA.IHDFhABAAFGHMBIBRAEH.UAABhABAFGADaABD.NCIESCEGYEHF..hADAWEBEfGHEhAEA...,1,-16,-22,6
RKAQLEeSTWZNaGfbBVIcXgDCYOFJPUMdH,EAFGTDDCZACFGEEC.BHABVGDC.XDAGCCBGFECF.UCGChAAAMDIHRBCC..AFFELABFhADASBAFaGGDIEAHhAAADIACOGAG..dHCH.KHGG.eCGFhABA......hAEA...,2,-19,-5,14
EbVSfaXIJceURLDOFWCdZgAPNHBTMKYGQ,HEAHBBAGMEADKHGGQEEE.ECEASDBE.XCFBhAAAcGBDUACGhAAAREDCOHBACEHE.dGGFAFHDTAGFhABAbADF.aHDEIFBAeBBDDGAB..WHEAhABA.....hAFA...,1,-8,-24,16
DTgeFLAKYVMfbOGWBNRaIZSQCdEPcUJXH,KDGGMDDDOECAGGAHBBGBRBDGZEFG..CFFE.dCAB.EABAUBDH.HGDAhAAADAFCeBGHAEBH..hAAA.fEAGhABANBAA.aGGHSGAC.PHAE.hAEA......hAIA...,2,-37,-12,25
KcZMISLPYdATBVHFCNfQeXEDUgOaRWJGb,TBGFBBCDHEFB.FBECCAAB.QEACeFGBEBDC.DFDCUFDH.aDAFhACAJHBE.KBAHZDBBMFIFhAAAIDEGLBHBdHAD.hADAAEDE.NEIG...........hAEA......hAFA...,1,-15,-26,11
CWgdYIeHbRPcGFJOAEUXLNVfSKQZBaDMT,EEBDUGBDLAHF..fEFGQFFDaHGGDCCE.MDDBhAAATBCGCGAFdHEH.eAFHhABAbAEARDAA...cFDAhAAAJABEAHIHNEEF..SBAB.BEHAhABA......hACA.gCFD.,2,-12,-8,4
aXUIcKHeLTdYfQJFMBgRbODWNECSZGAPV,aADCXDGG.UFCAKAGFeFEH.dEAHQCDGMDCC.BHGEhAAARDGDOABHDGGANBAF.CGHH.hAAAGCAEACHE.PAGDhABAIHAG.HECB......hACAYFAF..hACA...,1,-18,-29,11
fJCFPUKNTHbIgASZGOVQWLeBadYERMXDc,SFHFGGBDQAFBLBDDeBBCaDAE.EEAGRGAC.DFGF.JDCACEGFFCAGhAAAKCGH.HFEB.IFDHhABAABIFOAAGBCFHhACAMFIBfBGB......hADA......hAEA...,2,-18,-15,3
BTFZRfDGEPWCVcXAMIKeOUgdHYJNSbLQa,MDDFKDCGeDGFUFEEdHCFHEAD..JFADSAHBLFCCBABFhAAAFAEGRBBHGEGG.EGCDhAAAPADE.CHHA..hABA....cCBGAADB...IFHDhADA....hAGA...,1,-12,-43,31
eUNRZCSAcOHFGdQVPJXfIDTaMBgYWbELK,OHEGGBDDdDBB.QGGBVAEG.JHDCIDFD.DDIBhAAAMAACBDDH..YFEEhAEAEDABKBCBeHAEhABANAICZFAF.CFFAAIGA...FECHfDFH.hACA.aBBH...WDHDhADA..,1,-20,-25,5
JHXdLFeZRNgOUGWSKfaAMBPYTDQcEVICb,MBDBBHBF..TDCBDBGCEEGH..CBFCHFEHLECAZAGHRBBCOGCChAAA.UBAE.SAFDhABAfHGDAIFGQCGHhACAcDGH.IHACJDAHdGCENABBWAEDhADAKAAF.aHGA....hAGA...,2,-24,-8,16
VOCbGLTdXBAeIYKMDcaWgNFHPJSEQZRUf,eCDHKDHFDGCH..aBGF....NGEFHAFHSBFDZABF.UFFChAAAOEBCCCBFLABGhACA.XGCFIDEAhAAAMIFA..cADGFHAEEFAH....hADAfDAC.hAFA...,1,-19,-39,20
gCNbfMVUEIFRWHcdJPTLGDYXeZaKOQBSA,CHCH..fECDMEGHUCDAECCE..RABHHEAEJFFCLAFEGAEHDFHDhAAAXGCH.aBGBhAAA.OCAHSFDAhABAACHHNBAD.ICHCFGEF.WEHB...hABA......hACA...,2,-19,-17,2
ONBHCcZJTdeMFUEGVYLWaXDbRfKASQPgI,SBDEQFEH....PDBBODDFHADHCEHFJDFDdHADMBCFhAAAFDFCEHGA..GEAEhABAYACFaHCCDHDAfFCHhAAAAEAF.IAGFBGGG....hABA......hADA...,2,-31,-15,16
DYAQdgIBLZFSGcWeTXbNOVKHRafJPCEUM,dDFGBHADFCHDGDCH.eFBETGAF..XABAOCDFKDCFhAAAaEHB...JGEAEAFDDDBDhABAAFGBQCAChAAALAECSGCBWHDEbAGB.NCAC......hABA......hACA...,2,-26,-20,6
WFOfNVAUTPLSagDQCHZXeMGdIRcYBEKJb,UEAELACG.SFEHDGFCCFDHZCCA.MDAEGACD..dEAA.hAAAIHHB.RAFFBDFDhAAAKBABJCFCFHCCOHBAhABANAIE.AFIH.aBBC.HDGFeHFCEEDF..fAHGhACA..hADA...,2,-38,-1,37
YOHGKbUNBAcVfDRJQXLgCaWFSeIdTMZPE,VCADRDBGQABA.LGFGCFEBFBHD.SGBCdAAFMAGHZDCBhADAEAEE.HGFAKEFHNAHCAEECDEHDhAEA....XGDDhAAAaHAA.ICFH.PBAB.hAFA......hAHA...,2,-27,-6,21
HOBVcSNIaeUAMGXTKJEPQLbfWgRCdYZDF,GACBKGDBEFFD.LHEA..bCBHgEECCBEA.ZAADDGAGhAAAFDHBOBAHBBHASDDChAAAIHABaDEGAGDDMFAChADA.TGADQDGD.fFHGhABA.WBBChACA.YAFC.,1,-7,-26,19
VAMUYZGORbJWeLfKSHNXaFBEcQTDdIgCP,UAGEZGBGOBABRFEA..JDAFLBBB.SGGGHCDGXBBChAAABFBFQBDDhAAA.dCGDCHHHAACDMEFGhABAbECG.eAFCKDGB.aEDC.....EFGGhACADIBG.....hADA...,2,-30,-11,19
bBQCNeFfdALJUWMTIHXKDPZVRgaGYcOES,UGEETBAGHCCA.KCGEZFGFRACE.GDBB.OBGBEFCDBGAGNCIE.hAAAeAAFdGAELAFEhABA.MAEDDEECPEHHhAAAVFDF.aHAESDADCAFEAIHE.WFCDhACAIEAF...hADA...,2,-18,-3,15
ZDQSLcBbdPAgJYVCNRefTUGWIMaXOHFEK,JDCCVAAF..RDGF.eFGHUFCDGGBD.MFDAaADE..HDADKBGADEDAhAAAQAACLAFEhACABHBDdEACAECBCAHH...hACAfCDDIHHEXGEH.OAGHhADA....hAEA...,2,-24,-11,13
JLTYRfXOHeAgMUDBGQCdFIbScENVWPZKa,MEDBBFHBQDCDFCAD..SCGHEAFF.VEEDZGEAaAHBhAAAJFAF.LCAHhABA.TABCfHFHhAAAXADFeABGAGDFDIBCCBFCICCGbDFH.NDICKCEFhADA..OBHDhBAA...,2,-16,-13,3
DPVFIZHQcJWBKGXSAgedbOEaTRMfYUNCL,dHAFEGADRFFFMCDG.UDABLCAH.VAEBFDFBZCGD.HAACQDCHhAAAJEDH.BHHFhABAKHGC.XCGEAFBF.hAAA..eHCEaAGA.fABH.CFEA.hAEADDIB.....hAGA...,2,-25,-16,9
GcgFDVCBdZbOXRLTWEQHKJNUMfAPYSeaI,SADBaDFDGBCCFAEEDEDHBHHA.ZAFCXFGALDBCEAAGKEFChAAAUGCD..ABCHeFFBhABAIHFB.gDAGhACACCAFdHCHOCFCWBHH......hADA......hAEA...,2,-27,-24,3
WADZSadJOHNVXTYURMLPQGeIKfgFBbcCE,ZEFCSFFFaGEB.OAFG..VEBEXACCUBGDMCCGhAAAQEGG.eAADhABAfHGFBDDHbEABCCBDEAEChABADCIBdHCD.NCDF.YHAG...hADA......hAEALEADIFDF,2,-15,-4,11
TAVJKLDaFQMXWgIPNdbcESBZOfHeRCYGU,KBCEaEFC.QCEE..MICA.XAAGIHDCdBGCEGBChAAASGGHZEEAHCAHRBGHhABACFDHUDAAAHABLAFChACADECG.gGGGPGACNAICBAEG...hADAfCCD.hAEA...,1,-5,-22,17
UTWXEMdYRaHKDPGNfeFQZLSbBVAcCIOgJ,CFAEOBGFUBEH...XDCAdBCGRFBF.KFEADAAHGBAC.eFHFhAAAFGGCLEEGBACEAAFC.hABA.IHFAJHDA.hABAEGDBMBIHaCFHPHAE..NAEBZDAASEADhAEA...hACA...,2,-31,-7,24
MNTLPJBOcFQaGXdSIUeCAgYWZbKHDVREf,....gFDCZFCGKCCCDBBDEGAGMDAHLBFCBEEC.FBAAQBFHhAAAGDEBXDAFhAAAdACDUGGBCHADAHGE.WFHBhABA..bFAH.........hACA......hADA...,1,-17,-33,16
MfegOYXKRDcFLGZQIEUPNTaAJbVWSBHCd,VADHSACB.HECHMEHHeABD.OAEEKGFBDBGGFFAHGCBGhAAAZFGBEGEHUGDG.TGAAhABAAEGHJCEABCHE.hACACEAB.fDFE......hADA......hAFA...,2,-28,-13,15
FDMIGWBEYKeORLTbZfHdPScANaQCXgUJV,QAFHXGDEUAFHFFDHDACF..GCDEEDCE.KCCFOEFFhAAATGACZEAF.dBAGSHGGhAAAAIHCCFHB.JDGBMFABhABABEAFRCEA.LBAE.....hADA......hAEA...,2,-19,-16,3
AYJTOeILHNcFdKURVQWXfPEZgCSMBbGaD,TECDeHCCLEBC.HAEDNGEF.dDGARADFQAFGXCACEBBAhAAACDADBCBC.aABAABAGJAHFhABA.IGADhACAFHFGKCGH.UGGBfHAH.....hADA......hAEA...,2,-21,-4,17
EFfWPZUYIOQBHVRSLNdDGbeXgAMTaKJcC,aECDKFCCCEHG..ECBCFAFG......fHFDZCAAUCEBOHCGhAAABAAAHAEH.SCHFhAAALFFHDABFhACAeEAHAAID.TFGE.WHAAIHHC.hACAQEAA.hADA.NCEA..,1,-25,-37,12
APFEVfMcJQTKgZYRHOGCBIbaWeUNDSdXL,FDDCVBEEMABD..QAAEKGCEZFAFHFGFCGHBBDDD..IAEHhAAAaBHF..eDBDhAAADCCDdCFHAIAGEHDC.fGFDhADAJEFD...YEFAOAHF.WGAGhAEA..SADDhACA.,2,-30,-17,13
VgXaSZQUFJILOREcGDMWHBKYdANbCfPTe,CFHGTCGC..eAHD..XFDFZBEFFECHJAAGIBAA.hAAARBDAEEAEDIFCMAGBBFHGKCBGhAAAdFAC.AGBE..fAHGhABAVBCF.SGAG.LADEhACAcFFC.HGFANEEE.hAEA...,2,-38,3,41
bFgNYXQSRcEMDKJfZAGBUIaHCTdVeLPOW,UEFHaHDGHCGHCGAC.dFGDLCFG..OBCAFCBF...gEEFhAAANHCH.QFAAhABARACBEAACKAEEZEBChAAAABBBBDDG.IDAD.eAFE..hACAWHBG....hAHA...,2,-36,-7,29
NbdTQVOSEHRFaGfYcCeZIALUWBDJKXPgM,LGDAUDGABDEDJCGFKADD....XAEBMAAF..dHCDTDCGhAAAOBCHHABDRECB.hABAaAHBGEAA..hACAfFEHCAHGeAFHAIGEDGGCNDIGbDAD..SFFDhAEA...hABA...,2,-23,-19,4
ETUgDWKZRIQYJfGdacAbLFXNSMeVOCPHB,FCBHXEEHMEEB...eACEOCFFHAGHEBGGUDBA.DGIFKABCIEHGhAAAJECD.dBBHAGIFLFHDhAAASGAFCHAFBHDDhAEATGCD..gAEFWBAD..hAHA......hAIA...,2,-33,-7,26
UbfKMBEPQLYcATaSWNCIFegDVXRZdHOJG,SGFGCEEAFAAA.DBDAREBFdBDHHECBGDGCUCECKCBCBGDE..EEAFhAAALDDEABHA.aAEAhADANIEB....eEFAhABAXAGDJHACMAEE.......hAIA......hBAA...,1,-14,-34,20
OHBbRDXUKAcMefEPCdIYVaJTGFLQgZNWS,MAFDeDHFECBBdDED....VEGBTDDHLEABQBFCZGCA.hAAASGEHBBBDDDCHXAGBhABAAIAGfFAAhAAACACF.YFCF.JADBFBDBNEGGOCAHhABA......hACA...,2,-22,-8,14
WKYgPdIbLRDNACTfFeSVUEQMaGZBOJXHc,CCGHFCFA.eECGSBHBUDAC...EEACMBIFZFBEBAAH.JCBEhAAAXAAF.HGEChADAKGGE.PHBEbACEDFGAhACAAHIBTEGGQGEDaAEG.OHAE.YDEAhADA...hAHA...,1,-14,-21,7
GHKDUagVIBNSeQdRFPOYCXfWAbZLcJEMT,ZEDDJADF.EBBGGGDBHAFBDHGAUDDD..aAAB..VBAFBAEG.eHAEhACARFACFAFGODAH.hAAAXDBBAHIFLCHFhABAMFFEKHBA..NIEF.SEGD..hACA......hAEA...,1,-9,-19,10
UNFOPXIJCAMGcdBZSEagfVeWQTbHLYRKD,MDBEGCECBCGGZAFHSECG.EABBaGHH.VDEH.QFBEhAAAbDADLHEChAAAKAEADACGNBIC.FHEAOHAChACA.XBCHCBHGABAA....cGAHhABA....fADDhAHA,2,-43,1,44
TBVNWCRdeQYSDOUbfFEKHALPMZaJGgcXI,MAFEJBBCGEBD..XECABHGH.VDGBCAFDdHBF..eCABhAAAQEGBDICAUABDFHEGhAAAKAEFADDA.ZCDG..aDAEhABAIHHC.WHBCYAHB..hACAOFFB.EBGE.hADA...,1,-8,-35,27
NfZPUCKbgOSdQTMaABIRVEXYWLFGeHcJD,RGBGEHBC..XAEALCAGFGGHeBFA.HFDEJCCA.DEEAZBADCGHGKEAEhAAAOAHBQABBhACA.MIEAAIEGBFFCIGAChAEA..WEEENDEF..fECAhAFA..bEAA.SABEhAAA,2,-31,-13,18
IeZdUCfPQTNWXHRVODGbKMAgaFLEBYSJc,aHGCLCEEBAFD.JDAC..eFFGdGBHCEFCQEBD.TACGhAAANDIE..HACHRCACOCGFhABADBFEKFGBAEDCFAHFSGADhAAAIGEB.ZGAAfGFG.hACA..XGDHhABA...,1,-4,-38,34
gKHaEdSUMCRZXBITPVAYLQFOeDGNcJbfW,QGCFFAGDDGIDGCBHJBDD......fBABKAAFEGEEUFBGhABAMFAAZEECBAHC.hACAPFFCAHEDOEAHNAAF.hAFA....cDGAgDGEdADH.SAGDhBCA.CHHGIDBDhBDA,1,-17,-31,14
AEfQcMUVReLFNabZBXSCGWYOPdIKHDgJT,QEEBMDHFUCBB.RBCBFCEA..aGGCBHDHCABB.GEGC.OEADhAAAPFAHdAFFKCEADAIHhABA..JGCGADAHECHB.hAAA.fADHeABF.NIDFZECE...hADASBFE.hAEA...,1,-14,-24,10
EcUQLZJGFVfdWCTHRIBXPbYNgMKADeSOa,DAAHeBCBOBBDEFGDUDAFLAEF.ZBFAFAAH.dBFDCFHB.RFAEBHDBhABA..bGBC..NCIA.hACAKGGFADFF.SGEHhABA.aDDCJEEHfDGD...hADA.WHFAIAHAhACA.PDABMIAA,1,-19,-20,1
YRQBVJMPHgFfaLZUGbOIXDEAecSCKWTdN,eGFECAGBKFBE.dFCE.RABHBEFFMDAF..HBDFFHFCLBFEUDGBGGCFhAAA.OABBXGABhAAAAIHE..SCCDhACATDAANDEG.QBGB.....hABA......hADA...,2,-26,-13,13
GMDcbLFPVKHeQgYSRZCBENJfWTIadAUOX,UEFAXDGCDCBGLEAEFACH..KHBEHFADeAFCQGCHhAAA.SADEhABACCEEEEACJDDB.TCDDdHFBABBFMAABhABAPAHD.YHFEBHDAfFGFhADA...aBGEOABChAGA.,1,-15,-21,6
MfdWLEGXPJTHVZeKBCIaYDAUbgRFQScON,UBGBRDBCQADGOAAG...MIBCdGFFEFBAGAGG..JADBTEFFhAAAHCEF.ZGDABCBHhAFAaFACDBBEAIHCFHAA.SEHBhAGAfCACLHDA....hAHA......hAIA...,2,-20,-8,12
IYLdcEVaGONDCPUXJHeQFbSRfBKWgZTAM,MACFLEFHdBEH.VBGHGFAH.DDADCAHBUBDGHGDCFEDC..RGBEBCBFhAAAKBHB.ZEAAAHBHIAAGhADAEABC.aGGANIEF.hABA............hAEA......hAFA...,2,-25,-25,0
gAKbZRCWPGdaBHfLcUQMIVYeFSJXOTEND,KCGBZEEGRDAFCGCA.GCCFBEEB.LADC.QAAHIAHE.eFCFhAAAFGGC...SBHDhACAOFAHEEAEDGGFAAAE.hACAWEHHdBDC..fBBE.MADAhBAA......hBCA...,2,-50,-7,43
gWedZARGQUDPLIMFVaHfNEXOcSbCJYKBT,GGEDDGBGLABDMBBEFEADHDCE.EGFGODCC..SAHDhAAAJAECBDAC.gGAGhADAeCDEACGERDGH.PHDChAEAaHAA.XBECCBAD.YDHH..hAFA.KEFA....hAGA...,2,-23,-8,15
cJEXHTQYIDOaNMSGgBCKfZdPULebAFVWR,FCECVGDCRAAE...EDBGHAFE.QFACDBAG.aEGESAFHhAAABADBKGGAZDCAUDDCLHCEhAAAAIACJFAC..XACHhABAICABOBHB.MDIDCDGA..hACA.dGGE....hAEA.eHAE.,2,-9,-6,3
cGgJefZOQSMdFAULPRKEaDCWINYVTHbXB,LDAFRECDKAFF.ECBECADB.....IEFCVBBDHEFABFCGGAGEhAAAJACCZCEA.QFGEhAAASGABdHADABAAaHGAhABADIGC...YCAFbBFE....hACA.cGDE..hAGAeEED.,2,-21,-12,9
BEYcOGRJgMdPIDafTAWCXVHNLbeKZUSQF,CACDVAGBLAFA.KDGCUABA.FEHBEGAC..OBEFRDAC.MIDGhAAAIEFG.DDDChAAATFABACFE.XDDHhAEANICF.ZGECBHHA...cFGGhABA......hADA...,2,-42,-22,20
IGTCbMcBfdeRDNUaPWVOAHKFEXgYZLSQJ,HEFCEHCG.XGEBZEGBSBCBQBBEGAEACEBA..bFAGMCCFhAAABDEAdGAC.DDEHNAIGUAEBhAAAaABB...PHAEhABAWFFFAIGGFCAHgCGC...hACA......hADA...,1,-2,-14,12
OcBLRYAfHJeNCQXPgdbaWKZGFTEUSVDMI,HDDBeDHBCFFBQGGB.XCBDdGBHaACDZAECFDGFECAFUECBDAGHhAAA.MICEOHFCBACChABARBABAGADNAIA.....hAEA.bFAGKDEESHBC....hAFA......hAHA...,1,0,-31,31
MLeYGDgCAcJIbZWXSEFRPfHTUBQdKOaNV,JDEAZBFBSBAG.FCHBfFAA.HBABBEAHdACChAAAKHAEOCHFaFGCMDBChAAAeHFADGAEAGGD..IHCHhABAXFDGEDDD.TAFBNADHLHFA.hAEA...YFCAhAFACEED..,1,-6,-33,27
CIRNVFgcJHWLAbEdTZQaGfMKOeDYXSBPU,dEDGZBCGaEGGMFCF.KAEGDFDF....SGHHBBADCGGDRFAD.FDAG.hAAA.JDEHLAAEhAEA.AHFCEEFGQDADhABAfBCGOHDEeBHFPAHDICEB.hACA.NADF.....hBBA...,1,-23,-32,9
PYeSEQgVOCbLWRXJaUTBIdNcGHDMfKZFA,eBCCEACD.QFDBOEEHCFCF.LCFE.XFAEaGGABCEAhAAAIHGGdBGAGBAAhABAMDHDZGAGFCAHAIEGSAEFhADA..bDDEJHFCNIBFDBAG.KAFC.hAGA......hAHA...,1,1,-20,21
JIZcKOeTBaAgHPYWUDMRGNLSbfQCXFdVE,HDCC..PFFBUCGERBABGFABSGACQABECHFA.dDBFhAAAJAEFIHAGKFFCeHAChAAABHGA.AEHEWAEDhABAMADB.LBFA.fDFFFFHD.hABAEAFEcGDE.OAFAhACA.,2,-18,-4,14
UZKLBXCaWgbTQIReHOPFAENGVSMJDfYdc,EFEDVFBA..JAHHDBFD..dAEAZAAGBDDGCHEA...aDBF..bEFFhAAAQDGC.hABAeDADPAGHABBCSACBhAAAfCDEUGAFXCAETGGDIEAFhACA..OFDHhABANBIGMIAE.,1,-12,-37,25
EcOUJHgBYbGMLIRSPXWKDZadeNFATVCfQ,VGAAQCGH.EAGGOCCCHGFGBFAHGAADMDAALFEFhAAASEDHXDEEDFCFdACGhAAAeBFCAFFDCBAGUGGAgAEBhABAYEAC........hABA......hADA...,2,-12,-8,4
BbPeMQEDgNFYSGRHUKJcdLaWIAVZTOXfC,TDCCOCDD..CABGBEAFeBBE..EEFCDIFGFEHDGGCBHAFEKHDCdBDBLDFDhAAAaEAD.AGAGZCGHhACAXCAC.bCFGhAAAMCCFNABF..SHAE...hADA......hAEA...,1,6,-32,38
YSLcOQZFWIbDBHgRCUeKNEdaGJVXMTfPA,SDBBLDBDQCEAFGHD..IABCDABFBGHHHDEGhAAACAHEKHEAdDDCGDCGJHBCXAGFhADATFFEAAEFOAFBhAEA...WFFD..gGAGhAAA.....hBAA...,2,-26,-24,2
YWZRCUfOQgHaJGIDbPTKdMBAeXSVLNEcF,XGGCVDDF.LFCCEGAF..FADCZDDCRAFHUGFCOBAEHBADhAAAJAFEDDHB..TDGBhABAMDBBAHCBeFAE.SFHHhACANCEH.WHCCCGDCfAAHhAAA...aEHD.IADChAFA,2,-18,-15,3
FbaKcVZOJHIGUMfESDeTCAPLgYXNRWQBd,LFACXBFARACABAEE.FCECKGGEZEEDOECBHABEUGGA..hAAAMBIBSHBAhABADFEECCAAAHEG....PFAFhAAAYCHF..WCCGdDADcGAB.hABA......hACA...,1,-12,-41,29
FLeETPQZVfOWRXCHbSKNBDIdgYaAMcUJG,UBBHFBGCLGEGeEHB.EAAEQGDF.ZCFEfBDEhACAOFABRECEHAEGKEAHBFCFhADADIBGdDAHaDEEAHAGMABGJDHF.hAEA............hAFA......hAGA...,1,-3,-33,30
SQBNVafKDCUdEMLGcYgFAbTeRXJIHWZPO,TBBFeFAARCDA...JGAAHGEA.ZBABOAFESAAFBAADaCFGhABADCCCdFEB.ECHHMEHBhACALAFAGEEAYHAGhACAAADBXECB.IEAG.WADHhAFANEIG......hAGA...,2,-30,1,31
edBUHJXIMCcaYSZfFVODQKTALGEPbgRWN,LEECEFFG..PBBERBAFeHAA.BGHDUBEGJFBAMFID.CABF.hAAAaHDEZDAH..VAFBhAAADEGGKHAG.AHDA.bACB.hADA.gAGB.NIDB....XDDChAEAYFFH.FFAHhABA...,2,-24,-14,10
UfOcNITQdBEeJFMbKSGRVCWLYXHZgAPaD,DEFAUGCEOAEB..ICHEdGACBFHAEAEBFGFB..KEFFRFCF.CCBD.hAAALCAHHDBGAHGA..hAAAaFAB..fDCAhABATABE.JBHHSBGC.WHFGhABAXABA..PEHFhADA.,1,-30,-34,4
NXGTPBdUAeWaQMRVSOFfbKIgEcDJHLYCZ,aBADREBBOAEH..FFCFKGGEEGEH..DGBHJHACHEEALDCAZAAFGAGGhACABGGEUAEAAIDA.hADAQAGEMIFC.hAFASABB.fEGD.hAGA......hAIA...,1,-23,-24,1
GHPcNeKDZYBUfdAIbRXgOVTLWJQaFECMS,RFCEXCBBOABELCAF..WACGaBED...FGFAMAHFhAAASBGDHGAA..hAAAcEFHeDDHKEGADDIF.hABAYHBAUCCEAAGDIHFGgEAD.JAHHhABA.CGEG.....hADA...,1,-7,-29,22
RVCfLgNFAbdJPQXDUSGIaeTOEZKMBYHWc,dGDEQAFHDGHDUCDDSADB.aFGHTGBD.ODAHhAAAKDHDMICG.HBAFhAAARBGDCABFLFFCFGCGADEAbDDG.hABAJACEXFAF.......hAGA......hAHA...,2,-33,-4,29
NFcIWdgZSRQPAXUJEaBVKYDeLCHfbGMOT,XCGGUCFEEAABBDAFKFBA..DIGELEBHHFECGABEOEDDTADHhAAAFGFE..IACEhABAdHCDSDABhABA.PAFAAAFBaDDG..eAHBCEEB.MFID.hADANIAD......hBAA...,1,-12,-18,6
cZeCYgXNObGEaSLdHVMfIBKWQRJTPAFUD,DEAGZADHCFEC..XFACOBGB.GBBD.aDGFdDBF.MFHDIBHAhAAAKFAFRFBF...TEEBhABAABACFDHF.eFDD.hAAANACHEGGESGFB......hABA......hACA...,1,-11,-39,28
RFcWIDHGLdCMVJZTOQNfYKgPbeBUEaASX,RDEBFBDF....IDBFDFBGHEFEGABDdCAEMHAGZGBC..QECHhAAA.NBIC.KHGEhAAA.gBGDhABAeAGHEGGGAABCSFED.WBBBCHFD...hAEA......hAFA...,1,-17,-33,16
LgEWGHYPdDSTaNOMFUQZcCVfAJKReXBbI,JEHBeFEBBHABLAAH.ECDDHCBD.dCGEDAEGaADHMCHH.FGBChACAUEDBQACDhAHACCACABFC.KGGGRGDE.XAGAhBAA.ICFHgEAD....hAAA......hABA...,2,-34,-7,27
YWgaKXHZJLTceMVDfGCPNQbFSEIBOdAUR,RAEA....gBFAKDEAZBBDLEHFeCHFVEDDDGCBGDCChAAA.CHAE.PBCD.hABAQAACFFFF.hACAEFBDIFAGBHABAEBEYAEEaHDE.XGGChACA...hADA...,2,-30,-3,27
eGWbaALFZXYNMQIBdOPTcUSCRKfHDgJVE,FGEFZCAC..XGDGMAAFBCBCdGFE..OCEHTCGD..UDFChAAACGCEKCDADFAA..JEBAEHAChABA.GAEF.aBBEhACAAICANEAE..IHHHSGGH...hADAfBFF.hAEA...,2,-46,-15,31
UBdGOTLMQcgRHfeXYaAENWSICbPFJDZVK,EFFCSGGF.CCEG.PCFG.DEAFKEFDBDDGdFCGGAAGhAAALGEAQBFEhACARBAA.fHADhADAeFBFXDGEAIHGIEHGFAAG..ZADH..OAEGhAIAMBFA.gDCEhBAA.,1,-12,-24,12
GAUJMXaFIEObgCSTKHdeLNPfBVDWQZRYc,JDAGaEFH..FDGAEGFH..OCADCCHE.KADGdGBA.LDEB.hAAA.fGHAhABADCAEZDGFRADC.GFAHAAAA.UAFEhACAIAHHSCDG..eABCNIAFBBBBhADAWFCB....hAGA...,2,-35,-16,19
FJBGbVfLXAgPZUWeaTQOREKdCYINDHcMS,ZGECeGDGQAFGOCDDKAAAdHAD..CAHE.IFFHDIEG.MFBAhAAASFGBBCDCVBAFhABAXCFA.ACIBUADHhAAAWDHD.RCAG..EHBE.HEAA..FDEA.hACA......hAEA...,2,-18,-16,2
NAYFBbaHEWJKfLDcTgCMQdUSeGVORXZPI,BFEBaGGGHEBCJHCA.KFEHLCDE..TGBBCEGC.QAFAhAAAUEBBGAADRABBZCEA.hAAAIADHAHHHFAFCEFHBDFAHhABA...MAIDdAHA.eEEE....hAFA......hBAA...,2,-33,-1,32
HFQWcSALJZCDEePUGdTBOfMIYRXVgaKNb,ZDFGCBGFDBABeDBC.UGDGGFABBAGE..OCDFMCBC.RDFH...hAAAXFAGaBCB.KAAEhADANAFG.HADG.QGFEhAEASEACABIBECFCPHFE.dDHE.IHAEhABA...hAIA...,1,-16,-24,8
TASHMGJEPURYBWKfZQCgdFcDIeaVLXONb,HFEBJEAD.EEAAUFDHBFDB.KBCBQCGD.dDDBFBGDDBBEaAAAhADALHBGXGBGOAAHhABATAEF.AHHGSEEEhAEAGAEB..YHFGWAHB..hACA.CGGF.....hADA...,1,-17,-23,6
AODIZHPBGYUMegSbTfCJWXEVQNaRcKLFd,DDADZBBEBDHGUFGH.MGAA..eDBD.SDCATGECJEDGEBAEhAAA....NIAH.RGAGKGDChABALAFDAHFFHAGD.hAAAPACE..gGGHCCDCXDFGaABGhAEA.dAHE....hBAA...,1,-10,-30,20
GKVQODMBFeECUcWgTXLZIHNSRPJbAdYfa,dFBEaCDCGEGAQBGFDDAB.BGHG.eABFCBFDUACH..gADBhAAATAGE.ZEEHIEEBhAAASGEDRFACJHDGhABAAGDHfDBH.KAGEOBBH.hABAMCIHcDFF.WFADhAFA..,1,-10,-22,12
MVdfUSPZCGFcHYWTaINLgKDReXbAJBQOE,BAHEQADAMAGHdDBASAAFZFAG.FFBFHFEF..TEEGhACAIHCHLDDEhADAKBBEDDDGeHAGAIGE.EDHDUADChAAAPHFGCCAF.cAGDaBHHREGF.XCBFhAGA......hAHA...,2,-16,-10,6
NdRCPaAEMWeYFDXgLJKOQIHTVcGSbZBfU,MCEEeAABDGIDLEGHKADC.OFBGHDEF..VDBHSBGEhAAA.BCBGfGAAhABAdHDHCEEBAHAGEADAFHEGgAGHhACAIABA.TDGEbDAC....NDDH.hADAaGDB.....hAGA...,2,-23,-8,15
NMJBIgfHWAaVTFUEdcPSQRDZbXLCOYeKG,VCAHTBAA..FDHBdAEE...SGDFDFADZFEA.LBGBhAAACGBHeAAA.GDBG.hAAAJFGFIDFAfGAEhABAAIFGaEDBcDDH..PCCG..hABA......hAEA...,2,-38,-8,30
BKPOCTUSLQcFfYIHRbXNMDgeGAdaEVWZJ,EDFDZEBEJFHHBAFB.KECF..OHDEUGGGLABHFAFB...hAAA.fFEFhABAIEHFHADBRBBC.XBGAhAAAMEAEDDDGeEEDdCHAaACGWHBECHAD..SGCFhAHAYDAF...hADA...,2,-28,-20,8
QNYfCPEWTOcFLRBJXVUZGHMDSKIAedgab,eBBGdEDAaDAEQDFC..NDFC.fGBGCBHF.EEACOACFhAAAFDDHBCAHJEHHUFBAhABAHFGBDAEE.SHDChAAAKFADAICG.gAGC...hACA......hAEA...,1,-5,-41,36
cdYCDKFVaJXROTLHgQbeIAEMfNSBWUPGZ,MBEDSFCBBACFUCFDZBDBdGAH..CHGD.FFGB...aBGDRGCCOBBHhAAAHBAAQDABhAAA.IGEDhABAAGBE.NDIA.WFFE.PAFG....hABA.cGGFKAFE.XEAGhAEA,2,-39,-19,20
FGSJTCgeVQHNbPWMBRLAZdEXUKaYcDIOf,EFGAKBCD..aEEBDFBD.OEEDFFAAGAED..SAGBhAAACBAC.eAFDVFGDNIED..hAAA.PHDCBABCLDCBhADAAAHGdDBH..YDFCIDHG..hAEA.fBDGhAIA...,2,-38,-23,15
XRQAPMbGHYENKOBWadgFfZLeUCSJVcDIT,MCBEHEDHEAAEKEACBDHCaECB..FDGHLDEFCGHF..JBEHDEIH.hACATGGDQAGGhADAAGCFGAFGOEAF.WHDGhAEAfACF.eAAF.SAHBhAAAICCD.PFAHhACA.YHBG.,1,-13,-15,2
aVABNCTSDJROdPHgKcQEIXZMWYLbfUeGF,BCCGTFCCJEBC..dHAHHAGDKAFF..QACGEBABZGAE.MIEGhAAALGFEUEFDeBGHhABAGAECFEAGAEHFCADE.DIEGPCDFhAEA..........hAGA......hAHA...,2,-29,-14,15
UKDGQTVBSWgELeJYCOXFRZNfAMabcdPHI,MHCCaCBD.dEABHBGBUAACDGID.GEEB.TGBBVDFGSBDGhADAECAHLACGJFADCDED.hAAA.ODCDFDDGZFFAAGAG.hABA............hADA......hAEA...,2,-29,-10,19
OVLHAIBJYfCUcZGRMPebNKdgSWQDTaXFE,BAACJAFC.CAGHZEDEMABB...eHDGKBDAdEHA..SACEhAAADGAG.XEDAhAIAEGDFLDAGICFB.hACAUCCA.GEGEPCFCbFBC..gBBFhADA.WHFChAEA...,2,-52,-8,44
HXDRAUCgOdBGVcKMbFNPEfaSZQIeJLYTW,CGFEOABDBFCGGBDEKHCE..MDGHFACG.EAEC..SAHHhAAAZEGDeDDHLDAFhAAA..WHACDIFEABHHdEHGhABA.bBFBNCFG..fHADIFADYBBFhAFA....hAGA...,2,-38,-21,17
HEYNKXACPeVWDgTcSZOfGRBQJFIaLdMbU,CDDCeFGBDABC...TBAEZFAAGBFCBEAEQADFFFEC.aDDDhAAAdEHG.MIAGUBGGEBBGhAAAKGAD.AEHG...PAHFhAEAWFHB..cGECfDBC.IHHChAFALDCF..hABA...,2,-25,-23,2
OaGSgFVEfKdUXACMZRHeTBWJLYNbPDcQI,MBEDHAAAeDGBBEABLCFB..YFCC.NDAD.DIAChAAA.IABBOCEGaGBChAAASCCHFGHDEHDAKAEEhACAdGHGAFDBCAHB.TAGB.WADC.PCHDhAIA...cFEHhBAA..,2,-28,-17,11
OJEMTNXFUcYeZDfVPAGgCHIQdbRSWBLKa,CBBAHBGHdHAH.SDABBGEALDECOGAE.EAAEMFAG..TECChACAFAEAUEGFeCCGZCAGhAAADEAB.PHFGAIHG.hABAIFFF........hADA......hAEA...,2,-41,-14,27
WPVdaMEQTUKNCXJfgcSeBLbZDAHFOYIGR,FFEHODEFGDDFRFAB...VAEGaCAGMCEE..EAAEUEGGCHGG.hACA.JDAF..fEDGhAAASDHBBCDGhABAZACBAIAGIHDG.WAECdAHEKECF..hBAA..XDAAhACAcGGF.bAFADGDD,1,-9,-35,26
aRJVONYCKMXDPHLBWZQSgTUcAIGFbeEfd,GCCAeFCAdCBBJHAAOHEE..CCGDMBAADFBALBED.BBHAhAAAZEFDSEABhAAA.TAGGAHAFFDHBfFGGhABAaFDD.NAGAKHBEPADG.WFGHhABA.....hACA...,1,-21,-34,13
eBYECgZRDKFLUPGacIXbHTJOfMQAdSNWV,SEFGVCBG.BCHGEGBCZFFBDBBBKADFFBFCLCAD.UFDAhAAAaDGC..XGCChAAA.TBEHfABDhADAAGADdGGFeEAACAHC.......hAEA......hAFA...,2,-30,-26,4
ScEDVebKWRFBAQYfLdUPIOZMCTgJHGXaN,QEDHLAFHUFCAOCFD.ZCBDCADFJFHHHAED.GGAB.hAAAaAADSEGChABADBIFeHEAKAGCFCAAABHCdEAGMEBChACAgEGH....NIADEFFB..hAHA......hAIA...,1,10,-35,45
JMRHTeQOCSPdYKbfgVULIAXaFBZEcNDGW,XADCaACEBDHFZCAE..ECFCDCEHGGBB.MEFCRFDBeBFCCGHDSFCChAAAdGAGKAAD.fABChABAUGGFAFGE.FCDDhAEA...WAHB......HFBFhABA.ODFB.hAFA.bFFD.,1,-18,-20,2
SZcNJbLfMQeWXgdKDBTHYCOGaIPRAEFUV,EBFCFEEAUABCZDED..JEBDLHEG.QAEEeBBF..hAAAgGFCKDBABCHHTAGDhAEACAFFODDHaFGEIADAhAAA.ABIFSBAFcFDF.fHCBhABAMDDE.WEHBhACADIAA..,1,-23,-31,8
PRAYBgENabICXLUQcDSZWGMOFHdJfVTKe,BCHFEFBA.aACFCAGFLABA..QEBGSDHBZGACMDEDhAAAODDAHCAEdAFAfHCFhACAVEFHKAAD.RFFGAAFHhADA..NIEF.IHFD.cAGDDBCFWEEDhABA.....hBAA...,2,-21,-18,3
JLBAIZHaPXgMfQSGONdVcDTWYUKbCRFeE,ZAABHFBEaGEFXDEC.MDHHSDCDGBEDdADFVAFDDFGD.hAAATCAHUGGACEAHFGAHeEDEhADAEAACBCCBAIBE.IHHBhAAAPCHFfCCB.NHAD..hAGA.WFFD...hAEA...,2,-22,6,28
eZTgHDXKaRYcMdIbWSPCfVJEGLFQOBANU,eDFGTCADHBAA.DGFDaFAGRDBD...MDGDIAEA.SFEEhAAAfEHAJHBAEAHDhAAAFDDCBFEC.NHCFZACAhABAKAHDdGHCPDCE.CHHB.......hADA......hAEA...,1,-15,-21,6
RdJEXcSFNMbPTfeBKDGIUQHWZaCVOYLAg,dBEGEECF.SCGHFBEE..MAAE.TBBGeFCFKCBC.DDBBhAAAGFDHIGFGQGAGhAEAZEECaAFACGDAOHCEhAFAAHHF.JAHF.NDDH.fABBBHHF.WEADhADALEEE..hAGA...,2,-26,-10,16
DILfReabdcCNAMWEYGKXHVUTBJgPSZQOF,EFDDKHAGHBEDUACABEEFJCAA....SHGEOAFBFGFADAGCLAGBhAAAREFE.eBAHhABAaGDFdEAF..NBICAIAEMAAGhAEA...WBGBYEBF...hAFA......hBAA...,1,-26,-32,6
QDPSHTCJeVLFYZEBaKGfNWUbRXOIMAcgd,dDDDQGCDDAEGHAABJEECLFCC.FDHFZADABAHEaAAAKEADGGCDhAAA...fBGDhACAWCDG.UGGAhADAXGGHMCDCADGHgECE.PAHDhAEACEBF.....hBAA...,1,-12,-26,14
JHBFVOTDfKLGUQCYEdaRAMcSPbeWNIZXg,MIACSEBE.eFEDIGBCZBBA.JAFEBFFF.OAEChAAADCAEKEEGUCFE.CGHDEABGhADAdDBAAGDE...PDHFhAAANEAC.HGEG.FADH.fDDHhABA......hACA...,2,-32,-25,7
gWdCPNXSbAYKGUOcVMFLHRZDQETIJfaeB,KDGBUGDEOBAEMDAEHAEGZFBD..DAHFQCFF.EBBEIHHHhAAA.aFADeGFAhAAABGFAWCHH.CDEDXEADhABAAFIFGCDGFDAC......hABA.LAFF.hACA.JHAG.,2,-27,-13,14
RfJDaHYOWQZeNCVIKbcLFXGSEgTBMdAUP,UDABRCDFDAFHHABEOEDGZGCC..CGFD.KAHBLGBEGFEB..EGADBCCEhAAA.dHADABAB.JBDAaDFEhAAA..QGGGhABAeDAAIHHB..cABB...hABAXAGA.SDHFhAEA,2,-24,-21,3
WQYbAMIcadUCgHGTFPZDRXfOBJESeLKVN,MEIDaHCE.UCFBCBEE.HABBFGGAZCBC..XGFCOCFDBECGhAAAEEAELAFE.KHBChAAANDAC...QECChABAABHFdACG....gGBC.hADA......hAEA...,1,-16,-40,24
FWdTQbfELKSXGNRPVBIOYDcgaJUHAZMeC,eHFGFABCdHFBQAEH.EFEHLCHFSCHBXAFChAAAGDGERCDFBGDFOEAHDCGFhADAgDCCUEAHAFFHCCCC.hAEATBBB.fHBDKHAG.NAAHIDFEhAGA...hAGA.aGGA.,1,11,-28,39
eXVKNUTOLfRaADGISYgBPbdJZQCcFMHEW,GBCBSBCBBBHCdEFCZDDE.CHEC.FHEEHDGFeHAGKABFUFCC.OAABhABALGAE.fEABhAAAAEAEDBFD.IHHChACAgBGCPHAC..QEGAhACAMADA..EFFDWBDHhADA..,2,-20,-18,2
CZHbKVGeWTDAaMLfUYIcENSPQdOBRXJgF,LGFAUGCH..IAFENAAH..SBCBQCEAOBEAhAFAXGFGFCEBHDFAhAGAKACAeAAHDIDEAGGEaCCF.hAHAMFFEYBBF..EEAFBCHDRBGHCHAC..hAIA......hBAA...,2,-24,-10,14
bHWJUQVLKMIPCETegfcRFABSDdaXNOYZG,BACESCCFdECC..aAEDOGCAZFECHAGFUDEFLBADKBFEMABGhAAACDFB...EHCGTGAFhAAA..eFACfCDEhABAcGGAAFIDDEIHNAIC.....YHEAhAEAWBBF....hAGA...,2,-26,-20,6
WVITdgNfMOFCbLPAHXcQKeDERUYSaJGZB,XAEBKCBHeHCADAHFUAAA....SACGaHFEZCBEBFHB.hAAA.IDDCTEEEdBGAhADA..fGBHhABAFGCECHAE.bDFGAIDEcEBEECFGYGFC.hAHAWFBCNAIG.MFAD.hBAA..OHFC,2,-23,-15,8
QAHegUSaFGZdKXDBPEfMCNRTcJVLOYIWb,HFDHeHCGUAGHFBDGZAGHKCCGBBBF..EEGFCGFARCFB....TECAhAAAVFAB.LABEhAFA.IGEBQCAFhAAASGHHaEDA.XCEDDABAfHGHhAEANDBG....hAFA...,2,-22,-15,7
TZfSceGYgCKADIRMLNVPXUBbJWFEadOHQ,DCIBRBBGLAHH..VDFBUEFFBGADJDAB.EDAF..dFDEQGCChAAA.ZBCBcGGDhAAAeABC...GEBAhABACGHGABFDMIFG.XBGBbADEaDEG...hACA......hADA...,2,-23,-21,2
NDUbgATJXZHBCELVfKPaIQcFOWedRSMGY,XEBBHBEEBFGDLBGDKADF..PGACIADD.FCDFOEDAhAAAeFHH.dABGMCAHhAAA..NCICDAECbFFFACID.hAHAJFADCHFD.....fFEEaDGF.hAIAWABD.SHDGhACA.,1,-23,-27,4
HPOQKATERebCDFIZMLXUWBNaJdfYScVgG,TDGGREAHCCGA..FBCCZFDBLGFCUCDDBBBC..aHEEJDAFdFDE.hAAA.SAGBhABA..VAEAHGFAPAAFhAAAKBDCEGBFDIBEMACEXDDA...hAIANAIE......hBAA...,1,-19,-21,2
gcPbBXNWMdYROCJQKGESAHIDTVLZaefUF,DAIHLCBFeFCDFEEE..gDEA..bAEDBHAFXCBFhAAANHCDdAEA..OABChAAACHHEJEAD.KBGB.EFGCAACHIHEDhABAZDCB.aBHH.....fADGhAEA.cEGDhAGAMIBG,2,-41,-26,15
ARUgTCGBXFOHLSEIfZeNJDKdbaQPVcYMW,RFCBTACBGDAA.BEGHOCEDHACFLDGHSHGAEAGAIGEHhAAAZFECeAHF..DAAEbFABhABAaAEG..QECChACA.PBBHcCEEMFIBABBGCHAD.fHCBhAEANCIA...hAHA...,2,-14,8,22
JDCZQgBTNKHEFeRLWVGdPUXAMcaYIfSbO,aBDC..IHAG.SCBEOAAFDAGCCFGFZEEFBDGHKCECFFBBhAAALFBAVFECdDDDXCAGhAAAACCH.MFIHhABAfGDGJHCA..QAGENDAG.hACA..eABCWHFA.hAFA...,2,-33,-16,17
JGLZXHVABNKReDSEFMQIcgUWaTYCPfbdO,KEABeDDGEDGAMFFB..QAGG..cBGGUBDATGDEhAAACBDB..PHAGhAAAdCCGOEECJEGBLCBDhABAXGBDAAGC.BBAEDEAHSACChAFAgGGC.WFBA.fDCGhAIA,2,-29,-19,10
TGBNDWAHgUeCVLEFMSYKQbZOfdJIcRaPX,UGFECGBALBAGMFBD.KFDAZCCF..dBGAJAEARBEH.....aHCATGGEhAAABEGF..DABAADADeFAFhABA.FHEC.SECChACAbCEC.OFFGIDBB.XAAChAHAWAFE...hADA...,2,-37,-26,11
SWDZFGgXEYaUbVHLKfPeTBcOCQIJNdRMA,DFEBZEBFGAEBEGAB.aEHBUDDB.HAECLEDGKGFA.eCDGTCGChAAABABF.CFAEIHAHhAAAJBADdCCBAIEE..FFCHXGGGhADA.YHCGfFGB.OABAhAFA....hAHA...,2,-21,-13,8
gXMOUbVJcIGSQZdDfYFTNREPLWaKCHBeA,MDEGUACA..JFFBGBAC.SFEBQAGADAIFFFCETEGGhAAAEAAG.LHBChABAKDHBBGAGADDFXAFGhACA.OEAHVCEFIHHBfGHC..hADA......hAEA...,1,-17,-34,17
GcBEHPFCXNdQUfZeSTKbaMRLgADVIWOYJ,VBACOEDF.GEACBGEAHDFFFABB.CGBD.dHFBUECEeBDC.KCEGMBEChAAALAHF.ADAADAEGhAAAIEAH..hABAJFFEEGHDXGCD..NCIE.fCCGhADASCFE.aHEE.hBAAWADC.,2,-35,-6,29
DGRNeXQPUfMEVOLcgFaAWHdKJIBbYTSCZ,HEEHKABGBCGBTFBFZEEHGEBGeACF..XGGDUEGD.EAHFLAFFhAAAFAFGABAF.JBDBIEAFhAAA.SGEDhABADIDG.RBDBNDIGfHGF.MEAFhABA.....hACA...,1,-4,-31,27
eOSfZQNVXBYJbGKPIDHTCAgMcWLRUaEdF,MDFCLFHHUBCHaDDG..dHGBOFCC.ZCFBQDADhAAA.XEEFBABAJEAFhAAAKEGHDHDCCBGBACAE..WADAhABAEFCFSGAF.NABD...YAHHhADA...hAGA...,1,-29,-35,6
WDMSEReQAXOdZNGBKTCagIFYJVcbfLUPH,XFECOECGZBDCGCBHKDHD...CGAA.aHAGFDGE...JAAEVBAFhAAA...fGEAhABAUAGGPFHDDBGAMGAChACASFCH.RADAAFCHBAEFIHFFhAAA..bFFH...hAEA...,1,-22,-23,1
ZCgNUWGKIMRASLPEYTXDdfFVHcQaBObJe,SAADLAFCEBBH..XGAGDFGCdDCDFGGBHECE.QGDAhABAaGEHBCFE.OAEBhACAeDADZDFGgCGFhADA.WAFEIHCHAGBETCBFfAAHhAAAcGGHCFHG.....hADA...,1,9,-31,40
gJDeHABXEFVLWYMOURQIZfNdKPTScCaGb,BDAGEFGFLFCAMFBAUEEAQCAB.ZGBCdEHAKAABTBCAhAAASDDACBHC.aAFDGGADhABA..JAHBDAFGhACAAFAG.FHFA....YAEDOCEEfCBEhADANDIE..hAEA...,2,-28,-11,17
YLFZgPIHBVdTafeWGDAUbCSNRXOMEKQcJ,CBFGSEDDRFGF.MBEAEBHBKDFF..JCDAFBBAZEFE...IABDhAAABADEdGBDaAGAeAADhABAGDAEDECHADDBNHDB..hACA.OHDCQCGCLFAD...hADA......hAEA...,2,-30,-21,9
KJMOXASIGFPcVUCNfgeTZWaHYbdDEQLBR,SEACGABEFFAF...VFCGUFCBCAAD...NDED.eFHHZGFEHAEAhAAAdCBDDEECLBAFhABABBFDJACEMIBC.AEEC.PHAEhABA..fFFHTAGE.aAHDEGFAhACA......hAGA...,2,-24,-6,18
NcGJbDYRUSXKaPLdTfAOQZCEBHMIFgeWV,QGEDECBAHAAEMEAGFACE..eBBD..NDDBGEEBDAACRFBGXAFBhAIAaGABLHEA.hBAAfGCEOFFGCEDEBHBAhBFAgAFE....WBHF.hAAAJCCA.....hACA...,2,-14,-9,5
VQfAEDGWJKRbLCNScPXHUTZBYOMFadIge,DHFEJGCE.KBAALECG..CFEF.SHGA..XFBDhAAATFAFZACFODDChABAaBEAdAAGeAEC.QBGChACAAFHEECBF.WDAHNIBDPAHB.BGGDhAEAMIFA.IEHHhADA...,2,-50,-9,41
bZdPDUTBIGEAFCcgfSJYHVeaOMLKXQRWN,CBCH..fEGFJCGF.HFCHeCDFOBABLAFEKAGHREAH..hAAA.bCBAdGFB.DFEEBGEAhABAIHCEAIAEFGHDSAFDhACAaDAD..MAAC.XEBDhAEAWAHHPBBG..hADA...,2,-35,-12,23
McdQWePKINVZOEgDSGRLYaXCAJfUBHFTb,JFFHBGHCHFCBFCBC..MEEHQBEF.eAFEIBHAZAAFEACChACADAEAGDEDLCFDhAAA.aBEB..AFBAfDCFhAIAUGBH....cGEE.hBAAWBAE.KDAD..hABA...,1,-2,-42,40
EAIWcGegLNabVHJKTRPSfMXCFOdYUBDZQ,..IDBEGEEBLDAA.aBCGbAFEJGDCKFEB..RCFG.PAAEhAAASFAE.hADAMABGFFAGdDGHBHAEDIGAhAEAEBGGcGCC.gCCB..hAFANIEF......hAGA...,2,-28,-18,10
ACELROZDSGbaVQUIgcYTWfBHJdPNXeKMF,EEEGOGEGDADH.GADB..aHGEVDCBQGBCUAAE..IEAGhADA..YGDChAAAfDHEJBHFdEADhABAPHCCXBBHKGAEAAIDCCDE.....hACA......hAEA...,2,-32,-12,20
aeKZBFSCHgAGEJOcQbRIXMTfUVPYNLdWD,EHEAJABB...ODFBQAEARCBG.MFDBUABD...PAHHhAAALFFB.DDEBKAFHhACAFEAECEAGAGIHGBGC.hAEAIGEEfEGFNAAGaHAAeECB.SGGHhAFA...hABA...,1,-17,-29,12
UMaZfgeXSVbRWQDLPYAOKCdJGIETNHcBF,CFGCGCDB.ECBHTEBDHAFAFFFG.aAACZBEH.eFAD.XABChAAASECF.bGEGhABAQCCEDGIH.hACALHCCAEEBOHAGKBGHIADGNACHBHGGMDIBhAHA.....hAFA...,1,-10,-12,2
UMOcQJPgafdZBCHTSNVGKWYRLADXIbEFe,XFDBEFEEFEHB.UBGCMDCG...OGDCJACB...aEADfFAFhAAAdABEBHBHCAEETBEBhABA..SCGEhAAAVGFC.KECEYHAGAHHFDDAF.IDDAhACA....hAEA...,2,-34,-32,2
VfSHFRCaNQPZGDgXeKAIEdbMcTYLBJOUW,dBDBMAAD..TDEBBBCHOCDDUAGF..VCABSHAEhABA.FDGGCHGBQFAFhAAAGCAEDDFBXAFEhACAeGDCADDD.bGFAYCHF.WHAGRFCG..hABA...aACG..hAFA...,2,-17,-11,6
BTeEbSgWYFGOZUaVNIfLRMAJQPdCHcKDX,JAFFdGAGHCEF.DAEATABGEGGE..SAAA..gCGHhAAAFHCCODCFUFGHhABAaCGG.IGADhADA.fEDEMBFEAHECCHFAKBCABCDA.WEEHhAEA.ZEBF.NIEF.QDAEhAAA,2,-36,-12,24
fbZcIAXNKMgURYQDeOFHGJdSCPLVBTaEW,XFBGKEHBUGFD.RFEE.DEAH..eHBAFCEH.GDBD.dHFHCGDELABFhAAAVAADBAFA.aCFChAAAEFBF.....hACAfEFFcAGEAAEHMEIH..YADEhAHA.OAHFhBAASADD.,1,0,-40,40
BICAbVeKNWQSEUTHPOMYZRJgdGDcFaXfL,VAAEKFDAQBAG.UFFGTGCCHAFGOEACZDBD.RGFAdDCDhAAADAEEaDEGLCGD.hAAACDAFAAGBNEIE....EHDEhABAMCIF....gACBFHACBFEG.hADAeDFA....hAIA...,1,-11,-12,1
IBYXFgTDOdUeEPcHQbaVKLGARfMZJCNWS,REEAZACCCABB.SDAEBBDH.FFHDDDIH..dGBFUFBEEEED.HAFBQDFEhAAA.aHEGKDBEhAAAAAEG.JHDE..IAGGhABAXGGH.ODAB..eCCG.hADA......hAEA...,2,-39,-16,23
RCWMgQLNdcJeBaTYKPDbGAUZXIHOEfFVS,XEDDOHACFEEHRFAD...CDFA.MADDLCCGdDHC..eAFFTFBHhAAAKBADDCGEGAGGABBCUGGEhAAAHACE.EEACSEAEhABAgGFA.NEICBBAGaDFD....hABA......hACA...,2,-17,-9,8
eIJaNMgUWRTdBGKFSHALPbCcOQYfXDEVZ,LEDCCHFD.OFDEQDGE.XCBHDCGAEFHBVABEhAAAeFCH..JAEGMIACUABFhAAATEAEBGGHFFEAADHC.hABA.PHEC.bAEBcAGD.fDDDhACAIAHC.aGDD.hBAAWEAD.,1,-7,-38,31
FaZPdgMJOGEHQbUcRBIXAfCSeTYNWKLVD,SFHHTBEC....NEDE.KDFDDGGAaCHBdAGDMHBAGBAGEGFFHDBHhAAAQGED.hABAbACFcAFG.BBDEhACAIEGAAEEBfFAAYCHH...hADAWFADFBBB....hAAA...,1,-7,-24,17
QGOAceWBgaNHIYMFJLPfTDVECRSUKXdbZ,eCDCBEBBaCDGHFDH.MBIBFEEDLAHB..fGFChAAADFIDCAEC.SEBDhABAKAAGdHCFZBFFQDFHhACAADAD.WHACIHFAJBBEPAEAECAG..hADA..XGAFhAAA...,1,3,-37,40
YBWQZGURbfHDSPVOMAKcdLCEeITaNgJFX,dGEGEFDD.eCFE..TFFDaGAE..JCCFFGBBBFHAQCFFhAAA.ZAFCRAAAHEEGDDADVABChABAAICAKFACCEEB..NIEH.gAGEhAAA.XADF...hAEA......hAGA...,1,-18,-20,2
REJgCKQDXUBFZVOHMcYTdAfNWLPebGaSI,...fDGGLFGDeDFFGFEBIHCGJDCDKGAF.DDEHBCBGhAAAFBHBZAAGOHBCHEADMADEhABATAEEAHIH.NCDG.PBFChACA..aGAHSBBEEFHFCHEAQCADhAAA....hABA...,1,-3,-17,14
aDZRISecfJOFdLHKNTUEPAQMCbXVBYWGg,QBDBCDCD..XFEFBHHCGCBGaDBHZAFCSBHHhAAA.eFFEfACHhAAAOADGdHBFLEGHhABAKFDGNBACEBGFABBFMIEE.VFCBgGEAhABAIGAE.cCCA.hACA...,1,-10,-17,7
GXEHBWQMAYcNCbKgUFOJZaLeVfPRSDIdT,...NEEB.KCCG.FAGAJACGZGDE.eEBE..VGCCRCGFDCFD..dBFGhAAAGACFHCCHBABChAGAMFAD.AIFACFFF..UAAAhADALAHHSHGATGGF....WGCChAFA.....hBAA...,1,-19,-29,10
RNBZOCfeVaFgAbEGQSDcJYUXPMIWKTHdL,GCCFDGEB.JEFDUADG.MEDDKAFHdHEDRAAE.ZCAH..CGAB.eHAChAAAFCAD.AFAH...EEEBSABAhABA..hACAXCFHIHHDHAFCNAHE.BHHC.OCHFhAAAfFCFgGFFhACA.,1,-23,-33,10
QONJeUfYFICAbHDcXZRMVaSLgWdKGEPTB,HFFHDCHDZEEBMEFC.SBBELDCDdAFDGGAHEEDDBBCGQCABhAAA.JDDHfEAEhAAAFBFAAHIBXEAGhABAaBEHKGGC..OCECNIEH......hACAYBAHCFHE.cGAHhABA.,1,10,-43,53
KeVQcPbENFOUXGAgLTDaRCBSfMYZdJHWI,TCEHRCGBCFAA..BEDBMBCGZBCCHCAD.KFGFQFFG.hAAA.bECDEDAAOBGFhABAGGAHAIGGDFADaAFESAABhACAdGBGJEEH.eADC......hADA......hAIA...,1,-10,-24,14
MaADLEIBfFdHbRcOGSgQXJYKPUVTNCWeZ,LFCAEBGHBDHDdEEFHAED.RBBBOBGDGBCESFBHQGGFXDEGhAAAKGGEUAAC.NCAG.hABACADE..eAFFMIDAAHFGDAIDhAFA..fHAB....hACA......hADA...,1,-7,-24,17
gAcCVBULKIbXNREOZJdDPYSHGTfFeaWQM,VABELDBH.KHBE..IEACXBCAEHBCOHDC.ZEEFhAAADFHB.SBHHhAAATEGCFAGBaGEDMABCAEEBBCFChABANAIC.dECE......YDDFhAFAfAGG.WEHBhAEA...,2,-42,-8,34
VdbTcWZKPJXGFNORgCMfeHQAUYISDLEaB,UCFFSEFFDCDBLGBABAEFdFHG...TBACZAADKBFCJFBDFGFChAAA..RDCB.CEDA.MHDChAAA.HAFDAAGCEACAaABA.hAFA.....cEBCXCDB.NICB.hAHA...OAHDhBAA..eFFE,2,-33,-13,20
CLOMJQbKRWYHaNScDAfEVPZUIdTFGeXgB,VDADUDBCdFEF.FDGGeAHH.BHECOAAGQGBE.RFGFHDDFhAAASBECDCBAADDBEADBhABAIGCA.XAGDhAEACHAGMAGDKDHHaHGE......fEHAhAFA..hAGA...,1,-4,-46,42
YceXKaRQEVMNSAFdOIfZgLDbGCJUHTBWP,dGDHOBDHZCEFDCIFGECH.CAGB.HABHBDAB..PEBGeFGFXBGGhAAAKCGF.aBBFEHAGhAAA.MAEAAEIH.FGGHfFBEhABALDAD.JAEF......hACA.WFAD...hABA...,2,-22,-18,4
eNEaUBGTRXHcfQgJOYCILDZASFVdWKMPb,FCBCdCBGKHBEMEDA..eBBEEFCA.BHGAGACFREDE.HGCC.fAAFhAAAQAFFJCFEOCGFhAAACGGD.DAIDAIFCSFABhADA.WFFCNCAGaDDG...XGEChABA...hAFA...,1,-18,-26,8
WeNBYIXaQUVHbcGCORLSEdATDKfgZFPJM,TCFFKFECZAFCFCFB..MBCF..eHFCNBDG.BEHG..XFGAhAAAaDBE.UGAGhABAVAACbEEH..CHDB.OADGhACASEAGdAHEABBDfBEFJHAA.hAAA...WADB.hBAA...,1,-18,-33,15
RNLeYHfCJMgXBOGZQdEUWAaKbVPcTFSID,KEFEVCEE..TGDCFEBF.DEAALHBG.eGFGfBDDhAAAMCDBBFHFODCDZAEEEBBAhAAAUBAA.AACEaHGA.hABA..PFADSDAFICGCNAIGCEED.JAFChABA......hAEA...,2,-26,-11,15
NBFHfACGRVObELSXWcZTKPUdJDaeMYQIg,CADCVAEB..OBEDEFGG.LEGB.SGDAXFEDZDAChAAAKEEFUFAFdBCEDDGGMIFChAAAIHBCBCADFBHDhABAAEEA.GABE..WHEA.TBAGhABA.aGAG....hACA...,1,-19,-28,9
KefZESANPQVRbgJIHUMLdTcDCBXFOYGWa,QGCFVAFD.RBCG.JFHHHAFHLAAATDAGDEFGBHGG.ODEDhAAAGCADKHAAfFDAhABA.SEABhACAAADGbDGDIABFMIDECFFC.FHAG...hAFA.aAHFEECH...hBAA...,2,-12,-12,0
bAcgBNfDZOUdMGQTHWeFVEPLICaSKJYXR,BGDEDGBCODFHUABGdGHCGBBFHDFG.FAGGEAFB.LFHB.hAAACABH.aFDAKCHHJDBERGECAAHB.hAEA....NBACZEBAhAAAMCFC.QFAA....WGAGhABA.....hAFA...,2,-32,-14,18
BJWEOaGfAFdNXUgVCRbeQTPDZIHYLKMSc,dBGBUDDACHGE.eHCE..QDEGDCFCZCBDHGFGKCBD..MAAGBAGAhAAAEADFaADA..AGFBFFCChAFAXDGBRGAG..PEHFhAGAIABE.SGAF..hAGA......hAIA...,1,-25,-29,4
NOUdFTQWDXGEKZfBAbJcHaReYgVPMILSC,JCDFHBCC.aHBCeFAA..VCGFMIFCLBBFCEAG.UFAHdDHGFGDAhAAATEEFDBBGEGGCKGGDBBFBhAAA.ADAD.RBEA..hABA....YHAE...gBAGhABASFDDNADH.hACAWFHH.,1,-21,-23,2
NATWXcCJPEgIbLUKMFZeGSfdRQaVBDOYH,XGEFCBAF..PBCEEGAB..IBAFUBFCKHFA.FFEHeCEBhAAA.SCGFhABAdEAGRDDE.VDBABAHBDBFGhACA.OCHDNCIC.AHHDcEACbGAA..MADAhAAAfADH.hABA..aGHF,1,-5,-32,27
HFVbNWSUdXIgTCcGPBQZJLDaRYAeEOfKM,eCCFOEAHMCHBFFCC.....VFDBNDIE.UAEEdEEF...IHGHhAAATBACCHFG.GADHhAAABHBBJDFH.aBAFhABAADHDEHCAKDAD...WCDAXAGE..hACAcFFC...hADA...,1,-22,-26,4
QNFLVBcODXCIGYAWHfbJZeMKdETUaSgRP,HCABJFAHZDDBKEDE.dGBCUBAB..aHEGRDFF.QGGGLHFABECDhAAAOAAE.DCFACHCD..hAAAGAEFAEGB..fCHChABAMBDB.SGDF.NADH.hAIAcFGDICCD.hABA...,1,-14,-35,21
DQTAGLUMCcOHVNBIPKSbYJaEgXRdfZWeF,LDEHMDBD.OEAHVBBABEECKCHH..SDBGJAEG.hAAAEBAGRGCAdHGFZADGFGGFDIACQCGHhABAAFID.hAAACFFD.NHBF..IFCB.....hACA......hADA...,1,-24,-33,9
INHWAMLSRQYCEGbeVOTPFcXgfKBaZDdJU,SFCGQGFFEDCEeDDA..OBBCFAGH..XGEHhAAAKAFEaAAGdCGBUBABHFBAABEEMDIFhABALEFGCHDF..hADAbEDE...PFAHfHDBBDAADHGGhACAIEAH...hADA...,2,-17,-9,8
UZNVKWaDOIFbQcfESYPeLRBJHCXgAGdTM,GDBDdCFDMEBEZFCAKHBCDBFE.FABC..QBAFEFAH.SDADhAAAeAEDBBHHCGEGACDBTGGBhAAA..NIDH.aHEChADAOEFG..IDHFfGGBPHAChAFAJFBGgAGEhABA..,2,-26,-21,5
dJRCUIFGQLbPKEXaZeOgTNWHMVfSBADcY,DHCAdHCHRCDCUAABFFBC.GAEDLBHB..KEDDEABBZFGD..OHFGhAAA..gCEDhABATEFAHADEMDACSCAHhACAAGFDJEAH.CDCDIHAEQCGA.hADA......hAFA...,2,-22,-16,6
YJgMcfeWSKTQIRXFALaZVGbdPBCHUENDO,ZEGDGBDDdCAEBAHGCBCCHGEGUGBBDEEA..OHBE..JCCGMAIFhAAA..eEEFSHAChABAQABFICAFhACARAFDAFAA...aEBB.bEFE.EAFE.YDDFhADA....hAEA...,2,-37,-13,24
VZABFDPQLKWMCRdHYbafGIEUXeSgNTcOJ,FGCADAIHQAAGKGFA..CCDFHAFBaDEHGDAEEAAC.UFGASADGhAAA.TEEGhAEAOAED.ZGCGAEIBLCBDhAFAMIEGdCGGfADAIHAE.eCCDhACANIDD......hADA...,2,-20,-12,8
IOSVYFHBTJcWdbZfALXKPECeRgNDQGMaU,KAGECAAARCDC.DCBBGEFE..MFAAUDAGOGCG..SGCGhAAAFADFBHFC.TAGAhACAJCHD.dGAAZCDGABCGLFHHhADAEHGC.eECGQAAHIAEH..hAGA......hAIA...,2,-39,-11,28
IEBRbGWgJCMAHKDVLOXZPTcSQYNfFaUed,DBCCLFDGOEGBXDCGZECA...TGAASHDC.hAAAQBGCNHEBFAFAaHDCdBAChABABFADGBCFJCAGCHHAMAEAhAAAAEFCHCGD.KEAD..PBEF..hABA......hACA...,2,-34,6,40
gfJNXHVcSDbMdBaTYUOFPQAZEWILGKeCR,ZAEGEFAGLACBKEHFRCAD...JEDCHGCG.SCDDDEIHMIDEBBABhAAAaDGB.UAGBFGAGADFBhAAA..IGDHhABACABC..fACHXCFE..cGGChAEA.dHAB....hAFA..OFCG,1,-21,-25,4
JFWfHRTUNcCXKeVaMOZQDAEGBbLgSPIYd,BHEELEBGSACA..YBGFdDGCJAFA.FHAEHDAHUCDFhAAACFDDKDDHaHFE..OFHFhABADCAAAHCE.EAHH.bABEIGGDhAAA..fFFENEIA.XFAChACAMCDC...hABA...,2,-38,-4,34
LgbWFAaXDNZEGIceKMHYQfOCVRSBTJPdU,XEGDDEEGZDCDGABA..IEBEKEADMFFEQFDBhAAA.fBGHhABACHDHRBECTGGBdAEC.gABChAGAFHAGADHD.NDDBEGBEeBAD..YHAAhAHA...SEEChAIABAAE,1,-13,-31,18
cCSfQZILPYTBHXdaeUEWJDbOKAMRFgNGV,MCAGFGFCGCBE.CCAF.QADBLCHB.PGEEBAECHGBGhAAAaGAC.EDDEDBGB.bCEHKAFHhABA.AHAB.RDGB..NEDC.SBDGhACA.fDFDIEAD..hADA......hAHA...,1,-18,-23,5
NSWIbCcGgdVEDFTXAHOUfYaKRPJeZQBLM,UFGFaGAB.RGAE.eHFAZAABLEEDMHCA..SDDC.hAAAIEEGbCBHCAEHGBEFhADAdEGCEBBEDAGGFDACAEAE.fACBhAAA.KFBE.PAFGBDDCNIDH.hABA......hAEA...,2,-19,-17,2
RJOCHcFTBDEIGNPWMgbYVKAeLaUQfZdSX,aFBGUEECZACDdBDF.RCAF.CGGC.HAGB..FCADDIECGDEA..PGAAhAAAMAFE..bGBEKECAhABA.AHIB.LCEEhAAA.fDGESACC.OEHBBABENBIAhBAA......hBBA...,1,-20,-26,6
RgYFOIDMTAafZLEXPQKbcdJBVeHGWCNUS,aFCFLDEG.XFDDKDEGdGFCBDDC.eBHDGAAG.CCHESEBAhAAARFAFFBDEDAGFAADG.hAAAfADFZBBD.hABAQGGFJEHH.WCDCNCAG.UGAE.hACAOAFE.MFFEhACA...,2,-24,-16,8
aXMJKCRgHSIAbUPELBTGNcOeYfDVZWQdF,UGCDEEBFBFGBGAAE.OADHeABADHEEZEFH.dDFDFCFE..MICChAAACHFDHAEAAFAB.LEAGhAAATFCE...NAIG.fEEGhABA...QAEAhACAaGAB.JAHF.KDCC..hAIA...,1,-9,-25,16
XGHJaeSAKZFDPCVdgTRWLBQfYMEbNUIcO,FGADCACEdCGGRABDLHCABFDC..QFABMAEF..EAGBUCBFhAAAOFCCGFEFHEECJHDChABAaDDCADIB.DAAH.PDABhABATAEH..fDHG...hAEA......hAGA...,1,-6,-32,26
EfeLQUJSNFYIZacOGDCHVdBXMTbWgARPK,RDBFEBBBeAECUEGH..SAACFDDGZAFA.OFHBDCHHHDAD.BFEHhAAAXBEE.bEDAhADAAFCFKHAGLHBE.hABAJAHDIHGAaEABCBBB.dADE.TGCH.hAEA......hBDA...,1,-12,-20,8
LDUTAagWOEXGRbSYZKVdfPMQICFHecJNB,aADBOCAHGDFAREEA...SGBHKGGCdABGMBDHCABFHCCC.JFHDhAAABHEHDFBF.AIAGEBGFXAFGhAGAZFBH....hAHAfFDEIHDDeEBGLAHH..hAAA......hADA...,1,-6,-31,25
TdFReQZAcYODICLPbfJgGHVWMXUNSEKaB,OBBEDFGACAGD.LCHB..bECDJGBAGEEGHAFEMFAD.hAAAUDEHECDDBABDdGGE.hAAAFEAA.eBDGABBEcCAHhABAIHGA.fCGH.WACEhAHASHDA..hACA.aEBE.,1,-21,-24,3
DaJFTfbNRgdBXULSAIcMKQZYCHVPWEGOe,MCCFKFGEQEAGZAGFHFDE....PBFHEHCGGCAF.DBIBhAAAFHFGTFDE.NBCF.hABAgACEBGHAXCGDhACASFADAAHF.YBAHCEEE..hAAA.OFFAaGGH..hABA.fGBB.,2,-11,-8,3
QERCIdXYAcGMVOTUPbHDZJfFegaKNSWBL,MDFDTGBCUEAG.HAFDDDGCZDCG.FGGCaABBKBBA..SGGBhAAABAEALFFF.hADAQAGBCDGAXCCAhAEAADBC.cFCAOAABPHAEfEHG.hAFA.NEIE...EEADdAHAhBAA...,1,-12,-21,9
RWGZdcafOTYCQSKHMgANPXeUBJEFLVIbD,XAEEUEAABHDGFEEELAHD..IFCCDFCGGADAdHGHaBDHhAAAOAAE.CGED.SCBHhABAHFFH.AIACPHCAhACA..EDGBREGHWEADfAFEhAAA......hABA...,1,-18,-31,13
RWPAMSNVQCGfFZYEOHeaLBdDIKXbJcUTg,MFBESEDH.QADEfDAHFCBBEGCBHFFELBCEhAAABHHGDHDGXDEAJAGH.hAAAUFFBRDFEAIAGCABBZBGHeDCFhADAaGAB..KBAD.........hAHA......hAIA...,1,-9,-15,6
VWEMIKYabTDQAReBcOPZSfNUHLgdXFCGJ,BHFDOGEGSAAHUCBBLFAGdEDHCBDA.GADB..JDBFEEEEhAAAMHBGKDHB..aABGDEIBhAAAAHCD.eAGD.ZFGFfCFHhAEA..NEAA......hAGA......hAHA...,2,-35,-26,9
TBULedIJbYScREaAFCQKWMGfgNOHPDZXV,QAAGKGCAGEEF.....NCGCOHFCDBGDXCDBBFDHeDBChACAdAFBJDAG..SGABhADARABAAHHE.FEHDMIBGhAAAfAEB..PBHD..hABA.ZEAE....hACA...,2,-25,-22,3
JVFSOYdILECcPQDHaUATgXeZKNGbfRBMW,TFGGeFCGKCGD.GACCRCEDBHAB..MBBBJCBB.FFHH..SCHFhAAAOHBGdAAFLADEhABACAHH.QGCEhACADAFF.aGFHAIDC.gECCNEACfGFAhAEA......hAGA...,1,-15,-29,14
FUNDScHJWOaLEMebZCITGAXPVYdgfKRBQ,XCECVCAB.dGGBKGABBDCGFGDF..UDFBDEFBHACH.JHAGaGGBhAAALAAB.eEAGhACACFCFGACGAFAB.PAFAhABAfHED.QBGFNDIG.hACASEGG.hAEAWFBA.,2,-26,-22,4
MRZGCcaWXVJUegHDQSLOABbFfITPEYdKN,BBBHFBGG..TFEDEEBCKFGDREAD.GFBB..aBDH..XADDhAAAUBAFeEHHDBADSFHHhABAOAEGAFCAfCEDhAAAIEEBdAFFMIDCCHEA....cDAGhACAWDEA.JCHD...hABA...,1,-20,-27,7
LBRfMQDFcWgCVKAGIPTdUZbaNHYSXOJeE,GDECTEDA.dBAHUDAGaCGA.HABG.SHEGXEBHOADDhAAAEBGCBDDF..MDAGhABADGBEFFGA..cEGDhACACHHHAGGFIDHHZGAAYAFGeHAGRAEH..WHEAhADA.....hAAA...,1,-7,-11,4
SQUYKcWIDeHEBdPLFCTMGNAZRXgfObaJV,XCGEOHEE..aADDSFEA.QDDCKEFGICFChAAAeBABBAGAdGBFPAFBhAAACDHHTFAHMCCBABCDZBAHhABAfFHC.JHECUEDAYBBChABADIBGEGGG..FAGA.NDAC.hACA...,1,-3,-22,19
XdQADFJNReYHScPTZCEUaLWOBfKMbVGIg,DBDFJBBH.RDGFHFAH..SFCH..cAADTFEEEDEHhAAAaAGBLGDGBBEGKFAChAAAbADBGDEH.IHGAhABAgAFFdADBACAHeCCDPAHFCCHE..hACA......hBAA...,1,-2,-24,22
CIBSHObVJRgGQdcDeaTKYLfAWPMZUENXF,MEIHEGADFFCHBDAG.HEEDOECA..VAGFJBGBGAAGdBCFDEHB.hAAAeHFAKGABLABFhADA.AGEBZEAEXEGHhAAACGGD.ICDDSGDD....hAEA..bAEBQCEDhAFAaFFH,1,-10,-30,20
XgFHNeJEQGfUbKYIMcLSTdOPZCDBVAWaR,RADEXFGAHFAEeDHH.EGEGGDBH.fCGHKEEEMBADSHDGhAAAOFDFCBBADBABADCEaBCChABAFHBAQBDAhAAA..YAFCIHFHcGGDdAGFBFAChABAWDEE....hACA...,2,-16,-5,11
AWCdJGTHKeaDfFUgXOcRSbZYPVNIMLQBE,dGGCGAAHHAACeEEDaFBD.FFBGUFDE..XGCDRBEFZBGF.VAFBhAAAMIBGBDAAAFIF.CDCFKGHBhABADEBBODAA.SAGEhAAAbFFB..NAIAIHAA.hABAEDEG.....hADA...,2,-18,-2,16
bHUKLAJVQBNEMZWYecdTDCXafFPRGIgSO,VAEABHDHMBCH.ZDFFeDCE.dCHATGBHCGHD..aFDAFBDGRDAG.hAAAGAGE.SHFEhAAAbBAGKGDG.AFAAJBAHhABAEHAE....WHDAcDDADDGD...fFCBhACA..hADA...,1,-16,-30,14
OFULPfcVbdISgBEMQYAWJXDKCHaNGTeRZ,XDEGKEBFCBBC.HFFCGCGGRGBG.ZGBEOCEAUCDD.LABEhAAA..PAEGfBCAhAFA.bAFESCAGhAAABHEHMDDDAIHGDGGDNCBG...eABE.hAGAcECD...hAHA...,1,-3,-29,26
JeHXfNAIODMPFbYUBLcdTWQagVKSZGCER,OGEEMIBEFGAEUCBGLEEA..dHADQCAAVDGH.KGGDhAAASDAFZBFDGABBhABA.ECDFeAGF.HDDBhAAA.NBBHAFCFDAIH.....bEACBFAHhABAWDHHCBHH.....hACA...,2,-19,-4,15
RTNYVbPEeUSWDFJXQOKICaMfAHBLGcdZg,BCDFGADHZGAGRFGB...TEGBVDCEECBAUBFB..DAGEFGEHQGDBhAAAKFAC.aEGAMBCFhAAAHEABdAEF...hABANABC.PCFC.SCAFXEDECHHEABBG.hACA......hADA...,2,-27,-3,24
QIUdaFALWeOXMbSBfZCVTNGEPKJHDYRgc,LCFFOGCE.MFIFBABDZAGHCEDE...TBBGEFFEKGHH.DCFAREAFQGDDhAAA.hAAAIAEGaDAAAIDGeFABhACASGGD.fDDC.NBAG.hABAPAEA.YDDChADA.,1,-6,-54,48
gYEcLZRTMeJBNbGXWUCFIDHfVaSQKdAPO,OGBCEGABLBCHZFEARBGB.MBBBBACF.GADGXDGE.CCFADFAEhAAAVBAH...SHFGhAAAdFEFAADG..gAEHhABA.YHDA.eFHDhACANEICWFAD.FDFB..hABA...,2,-28,-12,16
HIebGOBDKQYEARaMFVPXWNcdSLfJCZUgT,MCBAFDEF..XGFH..WFFAdFCHLEACCHHD.ZBAChAAAUDDD.TEAGhAAAIBGDeGCGOHAEhABABACCDAEAKDHBEBDGaBABNIBFfFGBHAGH..hACA......hADA...,1,-17,-24,7
JYUXCOBFIKGPAbEgeQLMRHScdNaDZVTfW,EGBEQGDGRFFD.HAGHSBEGdADGDBCFZBEH..fDCFhAAAJFAFUFGC.XFDFhABACFFDBBAD.KAFEAEDH.eCADhACA.MCIBaCHD.TBBH.WHBG.ODGFhADA....hAEA...,1,-13,-22,9
MQNLCPASTZEKJfIbaYOcBRFdeDUHXGWVg,SABCTGDH.KFDDJEAG....IGGDaADGOBAHBFAEhAAAdBHGDDDAUGGDHCBBXGAEhAAAVAEE.QEEBhABANEFECCHD.ADFGfBBDYEHHFHAAeCDChACA.....hAEA...,2,-28,-5,23
cELTYOZWGaSdHfBQRNDMgKFVebPUJIXCA,EEFDLFFA.TCEGZEBEaAEG.HCACBCABQCGBDHCCKAEEFECEhAAAeHAE..PAGDhABAIBAC.AIGCYEHBhAAAOHFESCBHfGEBMDAB.hABA...gBEFhACA.,1,-15,-25,10
XUaTYLRGWFOEbegDcBVZAJPSIdMCfHQNK,SDBAMDEBHACEQDFDKFCA.aCAGLGFAGEACFHCEhAAAEBAFeHAEDIGGBGHHADHBIAEEhAAACAHB.XAGHhABAYCHHOEFCcGFBZABDdAFENIEF...hAGA......hAIA...,2,-18,4,22
KYcPOeIXEQgbfAZWSMGNRDJaCBFdUVLHT,SGEAGDBGDAEBCCADBGBF.UCEBHEEBKAFF..PAAC.hAAAeEHFIEAC.hAAAEBAHgAFBhADAACHEZABFMFFA..NICBaAHFFAGA.LDEC..hBFA......hCBA...,2,-32,-10,22
UXRIASFLdEDCWTQfgJNYbGHeOMVPaZcBK,LGDEdAHACCBH.QBGDJFBF...NFDF.GFDHHAABMECGhAAAaACABHFAKFAFRADDAAGH.SGBHhACADDEA.fHDFhADA..YBAE.OECAhAAA....hABA...,1,-3,-52,49
AHbGXKPYaBOfQTVgUcIRFSCLJZNEdMDeW,HCDHXECHKDHFaGBEBCCA...OHFCTAFAUCFH.RAAGFFGAhAAASAAB.JFAEhACAEEAGDCCDAIDC.GFEDhADAfAGD.........hAEA......hAFA...,1,-25,-31,6
LGHePbQTWJadCYcVDEMZRUNfABKFOXSIg,BGDFKBAGFAFASBGALEEBHFBB.eEBEPBAE.TAEFhAAAaGHFCADF...VDAFhABAEBFDMEGFREFF.NAIC.AAGEIEEEhACA........hADA......hAEA...,2,-30,-19,11
CbUTaEKOWXMHFSIgVRNeYJQDAfdZBGLPc,dAHCBBEBLFAFCGEB.UDDCaHDC.KGGAOCBH..XABHhAAAMBAFHCCEFADCSHDGhABAVDFB.RCFFeGBChAFAQGAF.AHHEfAFB.hAGAPAAA...hBAA...,1,-20,-23,3
beFVPCRLKUZJDNfEXgWTdBQOSIGHcaMYA,FEGEVAAFRECCLDAH.ZBCAJHEA.DBGEEHBG....XDEDhAAATGDDBAHB.hACAOACASAFChADAIHGGcCGA.MGECAAAA.eEAGCDDCKAFB.hAEAfCGAdDCH.hAIA...,1,-19,-32,13
URJPWCMZQNfYIXOcTEbgadeGKSDABFVHL,FCFDLFCERABB.JDAFCGBCZGFA..QGGG..fHBFhAAAIAHCXGCAhAAAODDH.EACDaBDFdDEBhABAKHDGADDDBHFCHAFCPFFGMCIF..cGAHhADATDAGeBBDDFAB..hAEA...,1,-18,-19,1
RZIEaGSdNVgPDeCJOBQTfHAbFWUcXMKYL,FCGAUCFEMCCFKFADLFDEZBDB..EHEEGBACdFDH..VFABhAAADHBGCAED.BABB..hAAAfAFDAHIF.hADAbBABXCCF.IFHBaACFgGGGhABA.JEFC..hAEAOHDC.,1,-2,-35,33
EUBDZfAWMJKVNRbHPcXeLTIdGagQSFOCY,JBGFVCCF..REAFHEEC..XGAAeBAHLHAAdHEBaAFASBAChAAACCCF.EDGBhABADGHBAEAD.KACG.NAFA.cGGAhACA..IDDHgFDC.OBDAhADABAAC....hAEA...,2,-27,-21,6
ecaIKRJTLZWMfGgDHUASXdbYECVQFONBP,dGFFEGHH.CHAD.QBGDFDBG.BAHBeFBEaGABKBAA..RCDBTACChAAAZBGHMAEH..fHDHhABADAFDAAAB.XEAAhACA...VDGHNICDIEEG.hAEA.WFDG...hABA...,2,-48,0,48
FIBMYGdLXERfQWcPAKDeZObJHgSUCTNVa,DGHDOGBGHFABUBDBCFCB....TABAaAGFBCBGMEEDGGEHhAAALAGDEEAA.RCEDQADGhAAA.cBAChABAACAHeEDG.....JDFGNEICIGFDhAFAXABF.....hAEA...,1,0,-29,29
bUAWNVdHDTgIOSYJEcCBLFRPGfaZMQXeK,VGDADGDH..TGGDOACH..JCEDCGAHLAFBFAAE.GDGGhAAAaEAFZAFH..QDBFhABAeADFKEGFAAHFNAIG..hAAAHADDIECEEFCFBEFF..fHEBhADA.MAIF.hADA...,1,-9,-22,13
fIPDWAHVgNScTZdGXELMaCYbUJQOFReBK,VEBESBCA.ZBFDXAGGLEDBCGFE.UGAA..OABBhAAAFGGDBCAHKCCEIHCChACADFFGAABD..NDICdEADhAAAMDAH.aEHH...bBED.....hACA......hADA...,1,-24,-31,7
KONBVaGCAHEWbIgQdPSUFYLJRcfeMXTDZ,HAEFEGFH...bEBFIHDD.QBGDPEDFFACDLCCFhAAAJFGH.RADGfGAGhABAXGADDIECKDGABDHFhAAAaDEFACBDdBAC.SAHB..cFGFhACAMEAB....hADA...,1,-9,-24,15
COZHDPSNVbWYBQRKMIfceGJAFgEdaULXT,EBBFaGAELDAD..XGBHOBBGDIGGPEFH.SCDAhAAAbFDFBGFERBFCKBGAMACEhAAAIEHH.fHGFhABAeDEGAIACFFHFgEAFdCDCCBAD.NADF.hACA......hAIA...,2,-31,-5,26
FIDONSCLEHBPgZMVfQWTeXRKdGbAJcaUY,JFDCUEBA.FABDOBEA..CHDGLAEFEDCEBEHFZCFE..VEEDhAAAQACE.hABAeAAFKHGAdAGCAHCDaGADDAIDhADAHGFC..PEHDMAFCfFCEhAAA...WCAHhACA...,1,-21,-33,12
JBNUgCGFIYQOcMPTHAVKbfZRaSdXDWLEe,VAEGKEAHZFFD.RDEH.dAAG.DIEAEBAB..BGGAUCCFGCAB.FEAChACAIAEA.QAGHhAAAOEEDMDFEhADATGDHAIBC..aBBAXGACLHAENDIGCDGEYEHHhAEA...hABAcECD.,2,-17,-15,2
ZVSHMeYaOKJWTcLdDBXGACNUFQPRgbEIf,UAEEQGDFRCBB.EECGZFDBHBCEMBACaEGC..KGBC..JBHH.hAAATGACdDHCDCADBAEAhAAAADFHFGHHPCAF.IGGDhABASGFDeCFF......hACA......hADA...,2,-39,-6,33
YeXRcJOfFgGEQABbIZNHaSKDVUWMLPCdT,BCEBZEFCHABFaGDH.SBGAKGEC.DIAGUBAHLADEdFAFeBHHhAAAXEBG.JHDAFDFDhABA.EDDHADID..IGGAhAAANBDD.MBAHCEHHTGAGRBDF...fGHAhACA..hADA...,2,-32,-7,25
BcHGRWeIYUEKVAgTMfZPFaNQCbLSXJdOD,MEFDZEEGaCHF..QEACLAAEJECFDHGAHFCD.RCCCeAHHhAAAIBFHEACF..KEHHVCCGhAEAAAFD...TGEDhAFAfBAGFGACCBBESGGHdHAFcAFD..hAGA..WHEG..hABA...,1,-13,-15,2
KfCITPXAdgaOUNeZQHSFWEGcJRVMbBYLD,dDDAOCADUCGBZCGFHFAFFFFB.GBAF.RGFA.VDCGBDAGLABChAAAKAGB.CHHH...IFFGhAAAXAFGAHEDaAFBhABAeGAE.SCCC.EHAG...hACA..MIDC.DAIDhAGA...,2,-19,-17,2
AOGbIVPaZUQRfBDFgHdYLWNCScMeXKTJE,OBFCGGCF..IBHBaEBEZGEE..QADGREFADFCAHABFdAACLADAhAAACCBA.SDDAhABAeGAEXEGEhACAJFAHAEAC.PDDAfHGFBHBD.....hAFA......hAGA...,2,-20,-8,12
eIJZHWfMXVSGdaRcgTUbEOQNFKPAYDCLB,DDDHBGBFeAFGZCCHHAFE.MGECVBDCdACBREAF.....TDGGhAAAEDGGOFFAFHCGAHIF.CABHLHCEhAAA.IHHHhABAJCEHfBAASDACaDBD...hABA......hAFA...,1,-19,-24,5
QHUPZGOAbDgcNWJELMeRdXIKFCTaYVfBS,DECA..gCBB..cDAHJFCDEGFAMFIF.dGDFIBHAhAAAFCGF.aACCfBDChAAABBEAQEEChABAPAFCZFFDAAGHNEAEeHFAKACFCBAG.TCFFSFADhABA....hADA...,2,-28,-7,21
ZOLPCNASTcUGbKQMaYWIFVgEDdeRXBfHJ,TGCDUFDGKBHD..aFBB....IHAAFAGCEBEBDDCC.eBAFhAAABBAHHEGHJBDFOHFEhAAACCGHAFABGEEG.MABGhAFAVDAA...dAFC.XDGEZDBC.hAIA......hBAA...,1,0,-37,37
JgWMAGaKHcRUbTCYIdLENQBfFVeOZSXPD,GACAaDEBHFFGREDCUEADCFCH..dBAEEHBGQAEGBHGD.FGEHeAHBhAAAOHAASBADhABADEBE.JDHFMACBABBBKGEHhACATBGH.........hAEA......hAFA...,2,-19,-16,3
eQDKFVMdCNWPfXaYLRAUTJEGHgZIOBcbS,JEAEEFGDGCCFHDFFZBBCBGBG..SADEQAGFFHDEMEADhAAACGCG....PAHFhAAAfDGH.XADChABAaEEH.LFEHACAB.gFCEhACAIHHHcGAChABADIGEdCBCWHAA.,2,-24,1,25
BKQJLNgCDVdESTIAUWFMYaGHcXeZROPbf,UFBCMCDAGCACHFFEeBECZEFHRGBC..OEFA..PAFGhAAABFDHQABHhAAAJACCLDEDCDEFDIAG.dDABECGAhABAIHHBACCFFFHF.aBGE......hABA......hADA...,2,-19,-6,13
CYbDXESgGAfeMBUIaKdcZVONLHFRWPTQJ,MFIDUCDAKAADdEFFZBBB..OFAAHFBDFAECREFH...TGFDhAAACCBADHDE.ECAFGAGG.hABAAGIH.eBHBBFDHaDDD.hABAcGDB..NIEBLADE..hACA......hAIA...,1,-2,-34,32
bPgEURIDYfTQAeLFcaNBVdXGCHOSKWMZJ,FFBGaEEBBGFHdEGEGAABHBFH.KGFFZAAH...JHAC..PAFFhAAAEDABRCCF.DCDF....hABAfHDDAHHA.hADAeACGNHAHCEAFOCEHMGAGbFGD.....hAEA......hAFA...,2,-32,-7,25
acVBAfTCIXKdeSOMZQbYgPLUERGFDWJHN,CABAXAACdFCG..OFFGZDCFQFFA..gCCGhAAAPAHDLAGFhABAEDAFFBFGDCIDHADD.cFABhACABHEFAHADfEEHIADAKGHBMEIB.YHEAhADA...hABA...,2,-40,10,50
BJFOVXKSHMEAIDGbTRcPLeYafgQCdNUZW,GGEH.REDGLDADaEBDQABHdCEDZEBHBHDHFAAE.OFEGhAAAKBHB.HBEEEBCHAAHCDEEE.hAAATGGC.PAFAhABAfEGDCCCD..NDAG.WHBG...hADA......hAEA...,1,-15,-22,7
eCMfETNBGHUWIdcLSZYKFOPbXQRVAaJDg,aBHFDCGFeEHB..MEFEEBABBBGEUDDEdGCBLADFZBAH.KAACFAFFhAAA.OHFE..hABAXFEBQFGDhACARFADACEGCHDHfEAG.NIAD.WAFE.cEBFhBCASADH.hBEA...,1,-10,-38,28
FdYAMcNXZEGfBTHLKeRUJSWIPVQbODaCg,MIEAXABGZACB.GGDBBFCCHBEFLFADRCADUEGDJECG..SAEAhAAA.ICHHhACAQAGB.DEEBhAAAaEGACBBBFFAHAEAGEHBETGCBKCCF..eFFG.hABA......hACA...,2,-18,-2,16
gWILaKPOGQZdMEfYRFbeHUBNAcXJCTVSD,JCDBTCCE..DFFF..IFAELCBHaGHBOFAB.GEGAhAAAQEECdDGFEHBChABAYABA.bBEEhAAAHABGBHFFAEACCBHGSGAAWFDH.KGDD.hACAMBID.FDAC..hADA...,2,-17,-17,0
IfgcWUaAZHNbKDBTFQLOPMdGJRVXEYeCS,ZAEBHCBAKFGGDEGBBCBEFGCFLAGD.OAAGMAAAJHEG..hAEAXFDFEDBD.CEAC.hAEASHBE.hAFA.IGHEfEECWBCEUCGHABHCNIED..hAHA......hAIA...,2,-43,-23,20
FTCJZGIOcBdHAVgRDEWPNLKQMfSUYbaeX,VEAHRDCFEBCC.......NEDG.LACCQFGCfBGBhAAAUABB.aGFHFFECCHDCJEGHhABAICEEBCECAGCDDAABKHAGhAGASCAAeBBD...XAEEhACA......hAEA...,2,-31,-15,16
CHMEXagRecSOYQNbUKWBIADGLVTfJPFdZ,GCFALHBG.VCDAJAAHFHCC.ZDCBMGFG..EAEDaAAEeAGBhABASAGF.QDBDhAAANAIGKHFA.BAEGhABAIFHAAHFCDFAHfEGHCFAD..hADA....gDAGhACA,1,-21,-33,12
VgYafOCcdRPTIFQMeUWBSJHLbKDEZXANG,GGEFVECG.aDCFOHFCdEBA..RADD...IHDFMIBCUABEhAAABCEAJAFCHABA.LAGFhAAADFEAEGCA.AFHGgEADhABA.fFGG.CBHH.hADA......hAEA...,1,-23,-25,2
acVUIYOEWPAZeQDdJFSLKRHTMBGXgCNbf,ZFEDQFAEDGGHFEAF.KCEEHACDBHGHGCED..CEFF..NIAD.bFBHhAAA....aAHD.hABAUFGBIEHC.hAAAEECGWBAAAIHEdAHCJADASCAELEDF..hACA......hAEA...,1,-14,-29,15
fPFGDQCeVRYEAHcTJLdZBKNSgaMOIWXUb,TDDCJBHBZADG..BECFKGDD....SFGBMFEC.IGAAhAAAXEAH.UBAEhAAAbDBFFBBGGGDD.DHAAhABACAECeFFB.RBFGAABG.......hACA......hADA...,1,-18,-38,20
VXCHBcFQgUYKbEZWSdJNPMTOLRfAGaeDI,aFDCeCFC.DEGE..ICACCFCEBCDE.FBGCUFGG..KCEDZABFdGAFhAAA.JABCMEBA.OAFChAAALHFG.fEFFhAEAAIGG..XFAC..hADA.HFEH...hAFA...,2,-41,-28,13
YVgWIQfGRKSANXeaCPZOMUJLEbHDdcBTF,eFCGCAGCZDAF.OADHUFEH.LEECHAAGdCDCBBGA.FAAA..VCFAhAAAIGBB.QGGDhAEAfFHAKCEGhAFAAHBGaFCFMDID.EAFCDIAC......hABA......hADA...,1,-14,-28,14
MSVHTNdefJBIcQYEgLWUAXaKOCbPRDFZG,KGAHOBEGCGFG.RCDEZBBBGEAH..MEHBSBACHGCCdBAGeDDAhAAAJFAC.BAEG.QAGEhABAEEFH.LDHDhACAAICEaGHDDGAFTBCBNAED.IDAH.hAAAcGCB...hABA...,1,-13,-16,3
QIaSNFbTUCRKXLAfZGHDWVBYegMPOcJEd,GCCHDCBCBDAFeGBA.MIBCOECF..JFAGQFGEhAAA.aGBHSGFAhAAA.bAEATCEGhABACEHHKBABAFFBfGED.ZAGHWADCYABGhACA.....hABA...,2,-29,-25,4
IZMLXTNcAPWKRBeOaHSbCJUgQEFDYfVGd,KDFGeAFCOCCEHGCCCBCG.UCGHEABH..FFACDDBE....VGCEhAAAIGGFLFFBTEEHhAAAADBBRADE.BDEF.SABFhADA.gEBBfHADdFAGhAEAMAIH....hABA...,2,-32,-11,21
PWLQYVeSbNcFKUOZgEaHRDTBMdIJXCAfG,GBADLBFFQGABeEBD.SCFEbACB.FEBGKGDBOAFChAAAZEEAaBHDRFEFBADChABAMAABdGGHIDFECHADACCB.hABAWDDH.....NEIA.....hACA......hAFA...,1,-12,-19,7
UcIGZPYdTSBLOfNMVbEFHgKXaCJeARQDW,QGDHDCGGUABBGEBEZFAHdDDF.BDABOFECMGFC..EHDCHBAChAAA.KEFGaDFCCCHHAAIFRCAA.hAAA....IAEFhABAYAEESCEE.fAGGhACA....hADA...,1,-23,-29,6
ILTaBJbMKWCVOPZSHfgNFYQReDGXEUdAc,LCFHBGAFMGCCCDHG..ODBDSCAFHAAB....NEEG.QBFEhAAADAEF.EBDHhABAAHIDIAGHTDBHbEEAhACAKDAD...WDDFPHCCZFGB.fHAFhADA.FGHD..hAEA...,2,-26,-21,5
BcXCgeKTFMENdVQOIHPGDRLZSUJaYWfbA,BEDFCCAHKGGB.MGEE.dAEEQCDCHBBDDDBBZGBAUAGB..JAGHaFCGhAAA.....fDBAhABAADIH.XGDAhACAeHFGEAACOCHHIEFCPACE.hAAA......hADA...,2,-33,-25,8
UFIWcfNaHbeYGQdPTXZDKEJSMBALRgCVO,RFFBCABHUADHFBFF......IHEH..cDDCaGACHDBBhAAAeAHFQBCEhABAdGCFXGFHDEEB.KGAHSDAFhACAAAGDLDFA.OBAHfDHGhADAYFHH...PEAEhAAA.,1,-17,-33,16
DSAKEcTUHWPLRaBJXNGOCgIQfeFMdbYVZ,EAFAUGGDHEDGLCECaCGB.BCAB..NADAGEGCOHAACAFGQBABhAAA.fFAFhABAMAAEdEBGbDDAYHDAhACAZFDB.DCEBABIH.KCHH....cBBFhAEA.....hAEA...,1,-5,-27,22
DUVKJZfCWLcBRSGgAeMPEHaTNIdFbQYOX,eEHDEADBHCEE.aGCDIECA.dBAHbBABQAEB.hAAAXGEDDFGCKFAAJGEGhABACGCCLAHBBCCBSAHDhACAAADBTCDCYFAH.OEFFhAAA......hABA...,1,-17,-21,4
QWTXgAcKFVGLJaSdMYUBbPOERCZfNHIDe,KDDGVCAGLGEE..SGBCMBGDUBDHBAAF.bAEDEBHFhAAA.CCAEZEABHFEFDIDAQEGGhACA.WEAAhADA..XABBAFEBFAGDaACEPDHD.hAGAfHBFNIAHIHHChAIA...,2,-26,-13,13
RCVAFdBPgaMDceZOUGTKSXfYHNLIEQbJW,FCBHdFFFBFBA..aEHDMCDBeGCCUBECKHFA....SAGDhAAAXCACHAACLFAHhABAQGCAJDDGCHHBAACCDICChAEAZAGHOHEG.fEACIAHBWFCChAFA...PBBGhBAA.,2,-31,-16,15
BCUFOHJGVKWEMLPebQTfYASZNdIRDcagX,ZDDDdCCCDEEAaAGD.BHEHFEBC.HGBGGGAF.KHEAMDDG.LAEGhAAAeCAAQAAGhACA.TFGDfFGDhABAAEAF.IFAB.cCGA.CCADOFCAhACA...hADA...,2,-23,-21,2
MHFRXSgOUcWbBIeTLQdaYZADPGKNJEfCV,DEBAKDBEEFFECBAA..HGAARGEG...SHGEOFBGUAAF..hABAbAGDBDHF.TADBhADAdADAaFFCZGAAAEHDNDBBJAFA.hAAA.MICEFDEE.XFCA....hABA...WFAC.hAIA...,1,-16,-25,9
cVTESfFKXdBMRLPgYCGZHDIWUaeJQNAOb,OABDVBEH..ECCHSBEC.FHEEKHAGdEHEBAGELAHBhAAAPAAECHCBZDAA.HFDAhABADEGCUFFGaGADJEEANGBF.hAAAAFAA.....bEACfCFFMIDE.hADA.YAHBIHHChADA...,1,-14,-19,5
FXIGSOZPNHMDAURVKQbYLedWcBagCTJEf,RABEQBBGLEEAdBFGBGAC.CDDD.EHCCFEFEGFAHZFDC.HDAAMIBEhAAAABHFKGGE..eADBhABAaCCE.TBFHXBAChAAAOAFANAIE.DCAH........hACA......hAEA...,1,0,-26,26
VNIQAOKURHLFZPMDegBYfCdGbTXEScWaJ,UDDCRFAHLEHFFABGZAECDIGG.BACG..CHDBdFGBGBCD...hAAAXFEGEDBB.SAAHhAAAaGAG.NAEB.hADAAIHAKCHBHDDGMCDA..eHDAfHAHhAFA...cGEAhAGA..,2,-35,-19,16
aSPcJIMReWGACHBFDKUQTYZLgEfbXOdNV,BCGGKFBBQAFCZAAFEEDF....XEAANBDC..VBABhAAASGHD.JFEGhACAIFECRADF.eFHHhABAAICECAHGDGAHTDGA.LHAAfACAhAFA.dHEFaGFD...hAGAMAEBWCHB,1,-22,-24,2
ZJbGgEBCWceOYNMVIQUHaTdDfKPSRLFAX,JBDAGDGGBFAACCAG..eEED..OBBFMHBA.QFEHhAAAHAEAaCDCDGGFKDHH..SDGFhABALAACABBDXGAEhACAbEAE..WAHBNADD....IDEAhAIAdGAG.fHGFhBAA.,2,-45,-3,42
PKNOLZFWJVcUTBRdCEQAbDXHMSGfagIYe,XFGGMDBGGADD..aCDC..IDGHeBAFKDBAOFFBhAAAFBFEJFBCUECC.BABChADACGACAHEGDEFCSHAChAEA.fEHCPHACNAAD..LAFChBAA...WHFA.hAGA...,1,-17,-31,14
gFcDHXUKdYaVbTJZBSWQLPGMAEeRNCIfO,eDAAREFECCBG.OCAGFAEC.DGDBHECF.UAAHKHGGdEEC..aCEF.hAAA.TGACBHCGSDAGhABALADAMDEEhABAAHHF.IEHB.fFFBgBGHhADAcAGE...hAGA...,1,-20,-37,17
bdLIVAaCDEOPWfeRGUQgFcNYHZJXMTSBK,CCGCEGCA..OFCF..PAAFeGEGRDAAGDEFUBDC.FEBH..hAAA.NAEBZCCGMIECBHGGhACAKCACLEEEAFFBDFIF.hADAfGAD.......hBCA......hBDA...,2,-29,-27,2
XYNSBdcDJAKVTPOUGfQaCWHRZbMLFeEIg,VFFEOABH.UGCBQCFH.CCBA.HDDGZDCB.LBEEhAAA.EACBIGAGhAAAXEABNBACBEBG.DBIBhABAAIHAKGGE..PBCA.aHAE..WFADhADAMEEFeBHH.SGFDhAEA,2,-31,-13,18
ebOYTGLgEMKBHfVQPNADcCUaXWSRIdJZF,DFGFCFFFUGBG..XDEGRBAH..dAFCJBAEeAHH..OAEAhAAAGGEFEDHHMAEDBEBFhABAHDCEQGDAhACAABAHaEGF.SBHF.IHHG.hAAAFFCB.....hABA...,2,-26,-23,3
PceEabGYUCZNTOIAKfVHMSBLJFQWXgDdR,KECCVADGMGFE.LCHDFHCE..XDFEdGBCRADC..eGDGhAAAEDAHGABCCAHC.TFFEhAAAICAFADEFSFHHhABABCDGJCFB.QAGCDIDE.aFDGYEADhABA...hADA...,2,-22,-19,3
ENKZLXJgQUBMbdVICcDfPRTYGHSaAeWOF,eCCDOEBCFHGAKDECLAFG..JFHDQDGHBADBdAFF.ICFEhAAACBBF.DADBRGCC.hAAAGEDAaBGC.AAGANEAEZFFBhABA.....XBDG.MCABhACA..cBAG.hAIAPEBB.,1,-14,-28,14
XCbGZdPfNUgTMYEaAeQBcLJIDWOVFSHRK,QDDHLFECJBFCDGCE..OCADSBCHHGAAKECFCGFDZBGFdDGDhAAA....PBABhAAAUACBMDCG.EHDAhABAAAFDBHHE.IHABFGGH....hABA......hACA...,2,-42,-12,30
eEYRbUZOdfcaQTMNJCADKBPgHLVGIXSFW,BCGCHFEHVBFGGABD.SFAGFEBB.eDGHEABHRCDHZECDOADGhAAAdFEG..aGHBMEIDhABACHAEDDDG..KHGA.LHAEhAHAWCAB......YAEChAAA.....hAIA...,2,-17,-13,4
aYFEHMNfDbeWZdXQCAKIJSUVTPLcgGROB,KBDASEDCUAAB...TADGLGBEGCAFRDBEBAGBFDHFEAGEhAAAHEFBMBGFDFAFeHCGhABAdFFFQFAH.hADAIHHB.PHCCcCFBaABBNCIG..hADA..fAEDhAIA..,2,-23,-6,17
XDfJPTQCRdMSHGbeZUOAFNcaVWBYLKEgI,FBHFaCDBBCGCKFFE..ECAD..XEFADAGC..JBCFQDAEhAAA.CGBDMIBGhABASHEA.bFCGeFEBhACA.ZAFC.AIGEcABDYCEA.IAADhACAfCEA..hAEAPFHDdGGD,2,-44,-23,21
LHJgBCYAWPXEKGbcfVSNQTRdODIeZMaFU,XECHGDBA..fGDGSCADQGGBdFFADIBEeBFFhAAAMBGBUBBELBBAhAAAJEHBBEBHAAGAEDAH.KABCbAGDhABANEFEOBHB.aEDFFGAC...CAFCWHEGhACA.....hAEA...,2,-9,-8,1
bMLTHeYgcVWUCJEXIKdQNSBOAPGaRfDZF,aFCFDDGEFGAELFFAHACA..eGEA..gCECVCAF.UBAFhAAAJDEH.EHBEKAGCdAGDSCFChAAABBDDAEBEPHEChABA.RCGH.fEGHMFAH....hABA......hACA...,1,-4,-28,24
ZGKYQPWSMVNDOFeRABdIUJgLHTbECcXaf,BHHFUGEFLAHBHEBATCCEEDDA..CAFA.XEGBZABC.KBABQCAChAAA.SGCHhACAMAFBDAACFHDChADAAHBDIEFAbAGDaFFHfGABPFAG..hAEA......hAGA...,2,-20,-18,2
bdBXEcTfYAOGWgLNVDaQSZHIUKMPeRJFC,OBEDGCBGLFECDGHH.SGADHABHKFFFMEBEeBDBFAEEhAAAdAGHBGDCEBHD.TCGEhAAAfBAC.AIFGNHDDhABAaHAGZDFCIFAA...PBAHhABA.CHFH.....hADA...,2,-25,0,25
CRSfTWLeVGFJYcBXdEPDNUaKgHOAIZbMQ,ZABGMEBECCEG.RAGD...SEEG..TDFHeHBCFFABJACBBFBHhAAAEEGE.DFFB.aBDDhABAKCGGHFCFAACC.IHHBhACA..QGGHLFAF.YDCDhAAA..XAEBhAIA.,2,-33,-25,8
WLRbXOPZJAcUFHSKNCQBgGaYMeDdfIVET,FADEHFBAKGGACFHCBCCEGAGG..MBBCDIFGdAAC..IBFBhAAAEDABLDEDRGDA.ODHDhACAZAGBAFFESFAFhABA.NEDF.QBBC.gGAFhADAaCAB.fGDGhAGA.,2,-25,-20,5
CWdOAQacJLPUgIGYbFHXNVZKSBReEMfTD,aDFGJBGBLDEF..UACCGCBEFEHBXGFGZABEKGAABHGHhAAARGAG..MBBBDHEGCDACOEEBhAAA..AAFE.QAGBhABA..PDHDIFCBbFCH.hABA......hACA...,1,-21,-33,12
QaINPGbcAeRYVJODWSBHfXZUKdLFTgMEC,eDBGRAFG..JDECOAACDIEA.BBFCHGFCZEFBUEBDdFDDFHBE..hAAATABCMAHBCDAG..hACAaGCE...NDAE..hADA.PEHD.cFAEADCDWFFE.fBDAhAAAKCCE.EBAD.hAEA...,2,-28,-24,4
XgMcCPDeUKdOAEbfWSTGaVJLNZIHBYRQF,EFDG..bDBASAHFGDFG..JACANDIEZBBGBBGH.RFCFQGAEhAAAXCEA.MAFGhABACGGADACAKHGGAHFB..TGAFhAAA.aFAGICBC..FDBE.cEEAhABA....hAFA...,2,-25,-14,11
XceIFCgNDVMKYAPfWGEUaTBbSOQHdRJZL,...fEBFECGETGDFBCGC.SDHHOEBDQBAFhAAARGEGZCBALACGXFGEhABAeHAAIDEDhACACGADDBGAMAAHKAHBAEAC.WFAFaEFG.bADC...JEFGhAEAFFCE.....hAFA...,2,-11,-7,4
LVdRfJCHYWONcXUgeTQaSMbFGZDEIPAKB,BCBEVGFC.dAGC.RDCF.JBADHFDF..OGBEXFGC.eFAFhAAAQCFB.MAIBhAAAbACEFCHDDEBEPEDChABA..ABABfDAACAFC.YHFGhABA..WHAGhACAcCEH.,1,-30,-31,1
LbQRgNPWUeMHdXFEDGBIOAKcYZCSTVJaf,KCGBZDDHCFBF..SFDC..JHEGaCBHLAFDQGABhAAARAAD...PGEAhABAeCHBdDAHEAFFDDAFBHBGICDChACAAGCD.YABGTACH..fAHGhAAANAIE..MIFAhAFAFFFA..,1,-9,-37,28
HAgYSVdIfGeBWCJaKFUNRLcOPQbXMZTED,SCBFdEEBGAGABBCECHBD.KAACFAABRFAC.OFGH..QFFBhADAXDDHTGCHhACADIBCAGIF...gAFDhADAIAEGfCDCWAHH..aEAEhAEANIEB.LFHH.hAGA...,1,-16,-39,23
ZQYJIEgfNFPAaUdVSBTeDCcGWLXObMHKR,UACCdFFDBCAEDAFHGBGALBFC..OEBDHEBCRCEA.QABEhAAAJFDB.EHEC..hABAgFFEfFAEhAEAFAABaEGG.SHCCCCBDXDDC.MFIHhAGA...KHAAIHHDhAFAAAHE,2,-34,-15,19
GcLefDCEFdOITYbPNHUWQgJKMSRBZaVAX,GEDGLDEBDAEHEDHHdBAC..OBCG..TGFA.PCCFhAAANCCAHGAA.WEFHhAAAQCFF.KHAChABAMABCSAFEZAGDAICE.eFFECHHHFDDHIFBFhACA....hADA...,2,-22,-11,11
KcVRNaZWXFTMQYPBEOdLbgCefJAGSHIUD,SFCDHFAFDCEFKBBARBDBZCAAFGGG...MAHFQGCGBFFAEEADOAFHhAAA.LEFGhABACBBHeHFGAEFCUDAB..hACANCIC.XAGB....YAAEhAEA..dGEEfGAEhAFA,2,-23,-18,5
VDCQOUHJdWMBFELTPYagIXZAKcRNbSefG,REGBSDDAGBAEDFCEOBADHCEF..dHBDMEIFEBGG.LGCEhAAA.TBGEPACCgACGhABAXGDFAAFEcGAChADA...eAFCfDCFCEFHQEABhAEA...WHEAhAFABAACaCCC,2,-22,10,32
JaIRdOTNWQMAcFHULVCebZPXSGEgKfYDB,FDFHHBFDUGDDCEFGZECB...SEADEAEBKBGE.DIDABFAH..hAAAJABGaBAGdCCD.TGGAhAAAQBCD.AAFA.hABALAHHeCAHXGGBfEBG.IEHAhABA..OCHFhACA.,2,-34,-16,18
NXHZbAPSQDOVICFMfBYEeGdTURLcJgWaK,SFBADAABODEG.CDDH.FFGBBBCD..EBEAeFEBGCCEdHCDUDAHhAAARBAFLHAC..hABAJACAaEAHKAGG.XGGFhABA..........hAFA......hAGA...,2,-36,-28,8
cUeaAQdGERFCBgVNXSLTWHMZbPJfDYOIK,QCEFEGBGRCBE.CHCCBBCCVAEF...SGAF.LGFAhAAAHEECMFIFPDGDhABAfAAE.hACAOHEAIEAAKBHBeEAGADCGdFCD.FGAHNIDHWADEhAHA.....hABA...,2,-18,-17,1
QMZLcDfTWKFOdYPBEIGUCNVXgHJSaeARb,RGCCMBEFZDFBDBCG..TFCGKEAB..FAEAOFFG.dHGDBDCGhAAAIHACCHGG.XCADhAAA.HAFGSABDhACAaBBFAFABQCFH.fGEChABAPAHFUDDANACF..hADA...,2,-49,4,53
AEfXPGdKcOLITFQJVSgHUWZBbMNCaeRDY,XABAdDBGOEDBLEFCFGGB..JCCCSAEE.HGFChAAAUGAHBBHEMABECCCGRFCChABADBGAEBEG.GCAAhACAKEHH.IHADQEEG..WHCGbACAaAAHhAGAAEDD...fHDHhAHA,1,-12,-26,14
HBSfYLRAaWdUPXQFCMgEJTDeVOZIbcNKG,dDGGUAEGQBBAFEFH.CDED.EDBH.DIGEVFAAZACH.....hAAAIGGH..hAAANIBBKBHBBAEF.fAFChABALGEGACBEPHCCMBAFJDFAOAHF.hABA....cCAHhACA..,1,-23,-35,12
FBEQdeONRYgITHaMcCbJAGXVKUDLSPWZf,XGADKDHBLEAB..SGGAZABABFDEECCDdBBAeDGH.hAAAREBB.IHGAaBEGCEACJDEFhAAAAHCBUAGD.DDGFfAGDhABAOFFB.NIDH.......hACA......hADA...,1,-19,-34,15
PKUZWEdbOQDFJXBgCYIRVSHAeLcafTNMG,eEDGLDDB.aHGATGGBGEAAKADHZAEEEBBDdAAB...QDFHhADADGBFFDGE.BCHGhAEACBFDIGDASCCFhAFAAAIH.NICDMGFGPDAB...WHCA.OAAAhAFA....hAGA...,2,-32,-3,29
UgQDaMcKdFTfXPJENHZWVbCGYBeOIRLSA,QCAHDGAGMGDE.KBFBFDFD....TEEBXBADEGACZEGBhAAA..VAEBCCCBBBEChABAeHAGIHDASAAEhADAADEGaFAGdCHG.JFHDWFHHbCCH.....hAEA..OACG.hAGA...,1,-15,-21,6
aEBgUcbAWMOFHePSfVQKLCRGTJYNXZDId,OCFCHDABeAEB.SAABVAADLFFDCHHDGACA.JFEDXGABhAAADDGF.IAHDhACAaAGDEDHD.BADAUGADhACAADDCFEHDfEDHQECA.KAFD..hADA......hAGA...,2,-21,1,22
IcJUTXSdRMaOeEBPHZfYbCLDANQKVGWgF,KGCBGECBFFFB.JBGDUBEE..SADEdFAE.RCBC.OAAFhAAAeHEEBGBHHCBFZCGH.hAAA.fBEGhABACGHGDIAC.AFIHNIBDQACE..WCADcAGAhACATABAMIEGEGGG.hAFA...,2,-26,-11,15
HbVKXYTLCZJURfQgNaeAFIPdDWOMESBcG,FDGEdFBBOGDEEDBE.BCAHHAEF.KACF..XAAETGDCZEEAhAAAJAHD.UGAC.QGGFhABAaCEDAAFE.IEAFhADADGIFMIEC.SEGF.bACD.hAEA..LEAFhAAA..CAHB,1,-13,-37,24
dGSPEMUKZVHeDgNRXYBCcOAfaWQLFJbTI,aCFDQFCGLEADFAEF..JAAD..TDDHdFGDGEBBEGHFKCAGhAAAHBDDDHEC..NBIA..hAAA.XGBDCCCE.hABAAAIHWBGBIAGCSHFGMIAG...hACA......hADA...,1,-12,-29,17
cNFQIZGHYdXMbDLJeTSWKVPaACROfBUgE,CEHARGDCBHBBUGEC...EDGCFCFAZDBDHDDE.dAGHMBBFLFAD.hAAA.TAFCKABEaHGAAAIHOEDChABA..gBCChAAANEAG.QFBDIACHXGGBhAEADBBH.SCCEhAFA,2,-29,-21,8
KOdXBNWCSERPHceYIZgAVTLfFUbaJGDMQ,VFDBTADH..FAADaAHHGCCD.DGBFQGDH.dDEEhAAABAGGCGGAEDABPCHFhAAAeDCBIGBDAFCCUADBMEAChACAOAFD.XBAFSGHH.cGFDhAEA....hAHA...,2,-28,-8,20
OBYFXHSfQMgZGLTAaVPNIEKdJDURCcbWe,aDHBVBFE....ICBBKABEDDDGUFGARFCF..CAGH....hAAAbFFGOFAH.BFEBhAEAFAEBSDEChAAAMIBCZFBCLBBAAADHEGAD.......hABAcDBF..YCAFhACA,1,-26,-40,14
GCEaWATIcbZQOYXgHFKRfLMUeVPSdDJBN,TEDH..cCAGQFGE.OAAHXBEDFCFDKHEGhABALBHHMBEAVGAAhACAPFAG.SFEGhAAADCCHNAEB.EHAAABDB.IGHE.ZDDC.HABChABAfDACeHDCdAGChACA..BDDC,2,-8,-5,3
XJAWBSQaPgFfVeZbINMDCYHOEdLcRGUKT,SGFEaDFE.FDEHfDAEZABG..IBFEDBAGHDCHhAAAEGDBdHBFLAHHhAAARFFAKBGEJACCBFAF.QGAHhABA.PCCFeCDGMIFECDACOHFChACA...cEGAhADA...,2,-18,-16,2
XFcTSCOedNQAbIMEUfHZYRPaVGBDKWJgL,MDAGUGFBZCAFRBCE...aEDEVEFF.DGCFJABG..LAEEhAAAFGCF.SHDGhABACAFB.eBFGNDCD.AGDEEABHhADA..fEGA...YAHDhAAABHHAWDFC..hAIA...,1,-24,-43,19
edVcTUNODQKLECGXZfFbSJWYAgRBaHMIP,REDHBEFDHFBBMDAGeCBCdHCD..VDFEUBGBDDAFKABCLACE.hAAACAHE.ZEGFFGGBSECAhAEA.JBCEAHIBaBFEhAAA.IBADTFAH..OAFA..hBAA......hBBA...,1,-10,-30,20
XNKBHJUSMFYQePdTCgDRcWLAVaGEZfIOb,aDGAGCCHZDEA.OHBC..XBFCKEAHBGHHJACGMAAE.QFCAhAEAeFGDdCAETGAHhAAADCBCRFEALBHDhAFAAFFBEDCH.bADE....NICFSAGGhABA......hACA...,2,-21,-7,14
AdEcZGCaNIgeTQDSPFXWfJYbMOVKULHBR,EBBDGEEE.CACE.aGBA....IAGDgCFHQCGHhAAASEAGXFBChABAfDDHJEBAMAFFOFFFhAAAKHGALCBEBACFABDFcAGF.NEIEeBADhABADEAFFEHH....hAEA...,2,-13,-11,2
FYIUAEgMfZOSLceCQdGBRVNJPWHTXbKDa,EGBEMGDAZBEHLACD.CFBC.QDAHBGADRCEC.JGDCHADGTCCAhAAA..bBAHKBBCaHFChAAAIHHA.ACAFOAHHhABASHBAcGAHdCHE.....hABA......hAEA...,2,-17,-17,0
MVdWPNSBCTJUGHXOAKaYgcDZeIfLQbREF,aGBH..gBCHZAFFeFEALBBFQEADEADBFABH.dFFB.hAAAPAEGSAHHhABABFDFCCHHUDCCHGDEOHEChACAAIBEKDEG.DBFBIHHG...fAHAhAAAMEADNDIE...hAEA...,2,-13,-3,10
SVUecYBEWNLbTIRMOCDgAfHGQKXPaZJFd,HDECKBEC.XADAaEDFFAAF.dCCC.UFDCeHFGBCAC..NDAA.bAGFhAAA..RCBC..CGCAADFEfGBGhABA.PFGDhACAJBHBSGGE...cACBhACAEEAE...WHBAhAFA...,1,-5,-45,40
OKdNUcLRbJABMEGPfIZWXgSYQFTVCDHae,EEFBGAFC..IFDFZDAFXABD.SFGHQBGHhAAAVCDBCHGBHCBD.eAEChABAKHBANIEHcBCA.hAAARGBGAADAMEAD.WBHB..YFHHhACADFFD.....aGEDhAIA...,2,-12,-11,1
MgKGdHDJOPVcUSAaRfXLeTEYWCFNbQIZB,RFFHLFFEeCBA.EAEECFCH.FBDB..QAGGBAACMDEDKEEEHCFEhACADBAAOEBB..hAAAPFCD.UDAGhADAAACEaDHFXAGBTAEANIAHIHHB..hBBA......hBCA...,2,-22,-18,4
NAeYgUQELORXPTICZWfaGMBcDVHJKdSFb,eHEEUCGHEBDDRCGB....TEDECCBFZGBA.aAGCBEAB.DDDFHACFhAAA.JBADSGGBhAAAFFAAACIFQCEAOAFG.hABAIHAC..fFEFMFIF.hABAcADF...hACA...,1,-9,-40,31
AIcfEbBPVOFWdeUaDQYJSTXMGHZNgCRKL,..IDCEfGDGBFFDODBG.dEGDaAGADAGAQFCGhAAA.SAEBhABAMBFHZFFCNBAGCDAELHBGhACAABCEbEBAFBGD.eBBC.YHFA.XBFDhADA....hBAA...,2,-24,-20,4
CBYLPdOGSANbgaVMcKEJFIWHRfDeZQXUT,...bBCAVGCC.KDACJACGFCEDHFEB.DBAFQCGC.hAAAUAADBDHH.LEDEhABAdAEBOFGBAGABgGCDhACAMFIDEDCFIHADfBGE.XGADhAGACFBD...YBBFhAHA,2,-30,-16,14
dLeEFTWIPZRSbJDCBXafUGgKVAHYMQOcN,HBDGQFFEOHBCdDEGEDEBFGDH..IDHBRBFA..JEABCHFDaDBEhAAAGAAF.KFHBAFGDMBBChABALDAEeFAG.hAAATAGE....ZFBBDHGA.BGDAhACA......hADA...,2,-14,-14,0
XfcTZKGHRCgQebAEYLPVDOMIUdBSFaWJN,LACDDIACMCDF.UFCEdAFHBEFBFGGA..aBFH..JBHD..XEAHhAAA..fFCEhAAAZBDFKBAD.RCABCBBBhABAeBHBAIGA.PHEEIFHASFFChABA...WHAGcEEHhACA..,1,-25,-46,21
QfeZdGIEBTUVYFJNPDWAKHOcSbRLMXaCg,HECFSFFFRCFFMDAFCBBA...QFFBeBEAZFDHdDBGEBDDBEBEhAAAUGAEFDHFJAHHDFID.AACBKGBDhABAOAAB.LDDChABA.aHGC..fHEBIAEC.hACA......hADA...,1,-14,-18,4
MgQdHJDRcWNVAZGaTSBFXEfYKILUeCPOb,ZGEGGBDCSDCBBCGGEDHHKAFHLBCD.UGAHeCEBOGFGhAAAMEBDdCHGHEAAJBABDCABhABARFCC....NAAFAIHAFGEHhACA............hADA......hAEA...,2,-26,-14,12
cKOIWGDafSgPZHUCQNRVAFeYbLdXJETBM,eBAFLCDAdBECEEGFTGBD..BHGDKEAEOFFEGCCEDABCaBBF.hAAASGBGZBGF.hABACAHGRBFBADACFEEC.YACChAGAJFEHMDIF..IHHFfCBAgGEGhAHA...hAAA...,2,-23,-10,13
PaYJLRbANFDMXcGTBOSfEIgQUZCeWdHVK,DEEAXGADGECEBFAFOBCG..SFCAEBGF.QABFhAAACFAHdHAFKCAGaAABLCFFhACA.AHEAMFIBhAEAfFFDIDCD.ZAEGWHEGPFGD.hACAYAHB..hAFA...,2,-31,-23,8
AYCEWZMJOgDGHeKbPINFBVLQfaTRdXScU,EBDDZEBBJCABDIAE..HAFCKBFE.....IHDHBEFEQGDGhAAAaEBEdFGC..XBAChAAASGGEAEFHCGCCOFHFhABAeCDE..PHFE.FABAfDAAhACA....hADA...,1,-27,-34,7
APUXMcWdBETfbYROKHQLGNgZJaSFICDVe,XBFBMHFCdFFHBBDB..EGFG.TBCG..fGBGhAAAbBAF.OBFHhABAQFCDGAGGNIDFJEEEhAAAaEDHSDADCHABDEAHAFHFcCDEWCCF..KADEhABA......hACA...,1,-14,-26,12
POIWXBLCDGFeSJQTfgZRbKadVcEMAUYNH,UFAEHAAGODHF..IHHEXDAHCHEEGCDGSGAFhAAAQDFCTGBCZCDDhABAKAAHdDHAEHGCADCF.YAEEhADAPAECLCAAFGFBfEGEbFCDaGGB.hAIA......hBGA...,2,-6,-2,4
OdDXJUELZSBfQgYCAIKaNRcTWVMFHPeGb,aGDCRCGH..TBEEMCCCHDFD.GBAEdHGDXEDDEGHDZAGHSEDGhAAAQEBGCCCHAAEGNIBHhABAVAAF..eACGhAIADFAHLADEBDDB.fHBHIGBB.hBAAcFFF...hBCA...,1,1,-7,8
EeMBTdSYXgfcbRFZHOCAIKVWPGDNJaQUL,KFFAVEBGGBDF.DGAHaBGCLDBH..MBADBACFSFFHhAAAXAAD.fGAAhABARDFEHEDHAEAHIHHHhAAANIDDQBDB.eBBHdHBB.gEGBhACA.cFDD.hAEAFAGA..,2,-20,-2,18
cJTBXQGMROENWbULZfAYdVFgCSPeDKIHa,VDFGCGBD..SHGAeHCE.DFEBIBGEHBBH..aAEGJFDAhAAABHFCGABAMEEAEAEFhABA..NDDC.UGACZAFEAFFFhAAAFEACKDAD...XCGA..OFHDhADA..WHAGhABAfDDH.,1,-9,-20,11
XeALYTCGcEDMZJUfIWBbgVPOHNaSRQFKd,LFDACCBHGCEBDIECMAID.UAFB..IGABBHGC..bBBGhAAAVECB..ODHHhABAaBFGRGFE.FGAE.dDEHAACF.hAAATDBDEFGEJADBfACH.WCADhACA......hAGA...,1,-23,-25,2
OgWEMTLXBVPHeGRNaKSDIZFJcUYCfAbdQ,dEGCQFGGOBAE.EBGHLFDBBABCHFBAeBECRDDC.KGAEDCCBZCFGJADAhAAAUDAC..CGADAICG.hAAA....WFFDhAGAMHFE..........XBDChAHA...hABA...,2,-32,-19,13
cTJXRWISgDMONdZHGVPLBbCUAafQFKEeY,QAAGKECFEDDE.eFFB..TBECRDBHSHDGDHGCMABGdADGhACAHGAAVAGFBEGCCHHFAGAC.hAFAaFFCFEGEJBBB.XGDHhAAAIDFA..gAGBOEDF..hAFA......hAIA...,1,-4,-21,17
LEbWNSDGIHQPXdZJBCKUYMOcgAVTReaFf,VADBTGBD..REEA.eBEAFGBF.LACD.EEAENAAA.DIEGHCFGhABAQEGAdGHEBHADUEEGhAAAMBBH..OFABhABAAEIFaAGE...fADCbCBD.WCEAhAFASDDGIHHD.hACA...,2,-20,-3,17
UIdeDTfXZAbYVgKGFLaEcSNQWRCBOHPJM,VBBFKEBEFBFH.LHFEEBGC...SEEH.QBCEhAAACHHCHEDAMACEdGBCDAFChABAfFGAACBF.hACAbGBCgDGCaBFHWBAFBEBGOEAB..hADA......hAEA...,1,-19,-26,7
PXZFebHMLfSUVRBDWIYJENdCKTcAQgaGO,aBFEOBEEZECD.FHDCHCAGLDBAUABDBEGHDEFG....IBAEhAAAJHDGEFAD..CFBE.KGGChABAAAED.QFBGhACA..gGGHPADGeFFDMAIHSEGAhAHA...hAAAWAHH.,1,-21,-32,11
fNBdbMSAHJYZIRLaCWPTFecUgGOVKXDQE,JEBEZACFLEFD.CFAC.TCAFFDHD.UGBEOHBAKACCDDDE.hAAA.EFCCBEFEdBGESAEDhABAAHHEHAFG.RCBD.hAFAaHFC.eDHD..cGGF..gAAEhAFA..hAGA...,2,-35,-18,17
aBLEDHMYGQNbgOcFeTSAVKIRZWXPUJdCf,KHCCRDGFZDEF..XCCBJBAE.dDBCCDAH.BFHFLECBDBGH.HAFFhAAAMABG.GCECQFABhABA..bAGF.hACAOAABeADHAGEBIHHA..WFHHhADAfHEFEAHDNIAH..hAFA...,2,-37,-7,30
FGCOXeBZPSMdNgUcWVHbTDfIYELQJRKAa,aABGCABE..OFGFBFFHZFAC..MHDGdCDAUBFE..VCEChAAATCBCDICA..IAHDhADALFHH..QEBGhAEAKHAEAEBHFHEG.XBBAeADCSFCEhAAAcAEG....hAHA...,1,-23,-32,9
bJfCWaXRVSgdNZPBDFALUHYeTQcEIGOKM,LHFCUAEFHDAATAGBEHGAGEDH.KHEEMAAC.JEEECABGaEGAhAAARCDC..SBBEhAEAdBHEZACFBHCCAGACeECHIHAGhAFAODHD.fAEH...hAHA......hAIA...,2,-14,-11,3
ZXHEOQSPUVDNLFMYCIgdKfeGJaAcbWRBT,...bBFCRDFHTDCC.ZGAAXFEAHBBAEACGOCAC.PEBHhAAAUAFHDGCELEHBhABAMAIHIHFAhAAAdACDfDFHeEHF.aAGCAIHE.WHFGBEAESHAAhADA.NEDCCEEG..hAFA...,1,-1,-10,9
KfPRAEWOYNdTeabVgGULQMcFJBICZDSXH,OFDDdAGAeEAF..VBCEGEDE.LBCHQDGHMAADFAGFhAAABCFDZFABDGGDHDFGKDAFhABAfFHAAGCH.hACAEGBDWEEB..YAEDaBBB...hADA..bFFD...hAEA...,2,-25,3,28
JCMcZIGXAELWRSHQYgNdFaKfODVTPBbeU,EGBBRFCBHBEH.QEGE..YFCHNCAG.dBAAFCBFKHEAhAAAODDFDFGF.PAAGhAEAeEEFUBEB.CACHZAGFhABAICHCACCB.SHAEfEAFBGGDhAFA.MIFC..hAGA...,2,-22,-13,9
ALTfSBCePDcOGVNMZHREbJKQaUYIgFdXW,LBEGTGBD.SABBCHGC.eEGFDEGFOCDEGGAHMADAhAAAZDABEBAAKDBBUAEFIFDGhAHAFEHBdAHA.AFFBBAAFhACAPDDE..NEEC........hAIA......hBAA...,2,-22,-21,1
YdBHQSbIcGaZgFAUROLDMPWCENeTKXVfJ,RFDHLFBHMDEE.CDFB.ECCDeAGD..XAGDJACEBFEE.HDCHhAAASCBD.IFHEhAAAaEHDFCAHOHEChABADEEGPFAG.TAEDfAHGdABHQGFHhACA.cGAChAEAZBCEAHHC..,1,-5,-22,17
WLGDKFbNMCcQegZTJOdARUaYVHBXPSIfE,aHDEHDEABFGCSDBB.EFCFLAFBDHDGFBFA.MCED.CDGHeBCHhAAAgACEZEAFOABBhACAAFACRFGF..YAADhAEAPAHF..IFCEWAHH.KHGGcGAHhAFA.....hADA...,2,-26,-7,19
AONEBeLDQXHdfIJRYGUcVFSKWgabTMPZC,OCBFBHFHDGABHBFEdDAH.JEECRDGB..GECDUGAGFHGA..SBCBhAAAKADA.aABHMIDGhAAA.CBAGAFDHEFAELDHBhABAXGCD.IHHF...YBHHhACAWAFE...hACA...,2,-29,-24,5
JNaMSAKUdeYFfPDEQgCIBHRTbLZOXcGWV,KCBCeDCEFGFFDBAH..QAGACEGHBFCGHAEERCFB.LHCEZACAODABhAAAGCAE.JAAAMFIFhABAAHAD.dEDE..fHGFhADAPGAE.EFDE......hAEA......hAGA...,1,-21,-23,2
DCUTFBWMEbcHKadJNPRgQYVSGALZXeIfO,XBEDeDFGOFCBDEHD.UACDBHBA..EFHBHDBG.aACDJEFHRGEC.hAAAQAGB.hABASAFDAEIBIAHHhACACDCAFDAFMEAHKHDAdGBF.......hAAA......hABA...,1,-21,-22,1
YMHGEdPBcOgFDbNKJfZIQLRXeCTaVSWAU,UECBHFBEEDEFBCBCODHDDFFA..KHDAJABF.ZAEGLBEC.hAAARGAG.CGGAaDBC.SGFDhACAABIBMADA.dFAG.hAAA..gDFHFGGDNCAE.fHCFhADA..IDGHhABA.XCDC,2,-36,-16,20
GBCPUJIHOLQERcgAeYDZfVXNKdFWbSaTM,DEGFZEDA..XCBCdGCEFHEA...SEGBaFCAGCDFCHHBUGBBhAAAHDAELADERABA.hABAABIFeAAHYBFD.hAAA..fAHANEIC.WFAF.MAEGhACABAHC....hACA...,2,-21,-11,10
UGLHPKTJQECDZVbcNFYXdMIgROSeAaWfB,aAFBBBBGLBHDHGACKFGB.QEDDCHAAZBBH..VEDA..hAAANBGGFDAFdEACMABGRACGSEHBhAAAAIHG.UCDHhABAGGEFJHDG.DDDEbAGFcGCC...IBDGhAHA...hACA...,2,-11,-9,2
MDZEbdQKHXPNUGcJfYVaBOLRIeSTgCAFW,MGEADAHBZCDCdDEDKBDCHCAG.....NBHCGEAGfAABaAED.hAAAOFGHLABGeBHHhACATGCFAFEB..FGABhADAbGFEXFCH.PEAA...hACA......hADA...,1,-7,-28,21
HAKLIYCOaESMPdVUZNegXcBGDfQFbRTJW,KBCELDEGCHCB.aFAAMHEA..dAADUCAEeFFF...gGABhABAXBFCBEEFhAAADAEGFDCFRFAF...WBEAhADAAAFAODGF.SABCPFDD.NIEH.fGHChAHA..hAIA...,2,-38,-29,9
LefQdUDFAJHMPZTCOXgIaSGNbWVYBcKER,MGFETDEC..OBAD..IHAGaAEBGDBA..WACGhAAABHDBEGHHeEFAfGDDhABAdACAUAGEAICEJBGHhADAPDDCCDCH.SGBD..NBBEYFGDhAEA...hAAAKAGC..,2,-21,-16,5
BJPNRgMXFSfYGALedWbZDcaKOQIVCHTUE,dGGFZEBADBBHaCFE.KFHH..OEEF.QCCGVBGDHDEDUBAGhAAABCCC..JHBCRADDMIBChAAASBEC..hABAfHFBACFCeFAEWAEEIAFA.CAHE.hABAEEGG.NAIG....hACA...,1,-9,-31,22
MZAbKFXDfJgGBPOTeHLWUNQIRVdYESCca,FAFCDEAA..JGAGBGHG.OAAAeCDDLFHBUEEG..QEAEhAEAVAFA.dHCFSGDHhAAACCDA.aFFBhABAAIGAXDGB..fBBFhACAgBBA.....hADA.PDFAWCFC,2,-34,-26,8
OTeDPGWZUcIJQLSdbfBCRNEYMXHVgAKFa,KAAFaGAF.eDCGDCEGGEFAUFAE...JCCDLHDE.dDGGBEEHhAAACADFRAEB.EHCA.MCAHhABAXAGFHABEAHHEFGGAOBFAhADA..WCBC..cDGA.hABA......hACA...,2,-30,-17,13
OHMSZKJaeXBIREVbPFUWTYcCNLdfgGQAD,OAFBMBEDKGCG..eDFFBDCFECAA..VGFCFHFCUGCA..hAAATABDCCDBdEAE.GEAGhAAADGGASBHDhABAaAFDXDFC..IEHEPAHB...WABAhACANBAE.....hABAfHAF.,2,-24,-15,9
ZAbeGNJgEFUVacYROTWdSPHfMXLCBIDKQ,GEDEJEDF.FGGFUFAG..aBABRBDA.OBFCdFFA.HEAAMCIHCDCEDIBEhAAAKBAG..ZAGDAHAFeCEBhABA..EDAG..hAAAYBCESHGAPDHF..fABBhADABAGE...hACA...,1,-16,-32,16
fDKEYFLbcJWIadeBUXGOVSZTCRHNAPQgM,QDAEMBHBDBBG.KAABFEAALCEF.JEGBIAFD.hAAAeDDGUGBDGFDHhAAAOAGFSBADhABACHHERACAACGD.fGCGEGED.YHFG.hACA..WCCCBDFG.hACA...,1,-17,-36,19
CUGRdPeVbgLKTXIAaWSQFMJcDYBOHfENZ,aGFHQACH.FFCBJCGDDDHBODAA.HEBGEGFBCAHBRABEeEHHhAAA..VCAFLHAEhABAKDDG.XAFBhADAIGACAIHASEADMICEBEFAfAFEhAAA.....hAEA...,1,-13,-24,11
TLNHRPaQCIbWUgdGVMOfKYFcJEDBeXAZS,SCGHLFEFHADCRFBF.QEACCCEF.IGCEbFDDUBAEhAAAdAHEGAEBOAAGKGFChABAFDDGJEADBCBD.AHHETDFDhAEAaCCF..WFFEgFGC.hACA......hADA...,2,-18,1,19
AIKTaBcEJLdbGCMWVSXUNefDQgOHZYRPF,KBGEBBHDEEHFLCAG.dFAECABAMCGB..VDECUEAAeHFChAAAQFCCHECHZABCRBCAAHEEhAAAIFHB.aAEAhACAcBAH.JDEF.....WHAGhABANIAD.DGGF....hADA...,2,-29,-9,20
cLZgGMCITeDJfaWXYAHFUENOPBKQdVbSR,FAFAEDCD.OEAFBAEHKHCG..dGED.SEDARACDZCFBMHECCAED..hAAA.eBADDDGCJBBCaFCC.hABA....XCAGhAAAAGACNAIG.......PFCHhABA.bFGH...cCEGhACA.,2,-43,-30,13
SHeFJDCEKVXAfZaPGTBUcLgQdbYRWMONI,ZBFDaHAGGEGEBHDCUDCC.LEADQDAH.dAGARACEMABFhAAAOACD.IBAFhAAA.eDECDGFEEHFAXEDChABAAEIH.fGED....hACA......hAEA...,2,-41,-12,29
YHaCNTFRXIJfMWLOGEcbAdPBUQSVKgZeD,dDEHUAFCSFDGKBDFZFFF.DDBAHFDB.CBBB.FDHD.RAGH..JFAHMAABhABA.OEBHEABEAADEBHGChAAAQDGF.hAFA.eFFGaEDBNEAAIBEE....hAGA......hAIA...,2,-33,-20,13
gYQdIeXFTVfSOLZGUHKJBMEbPaRNAWcCD,CAFCDCBC.QBGCeGEEFDAH....VAGFSEDH.OFAAhAAALEFEUFGGJABHhAAAMACGECEG.aDBCAHIF.gGADhABAIEDC.XCDEZACHGEBEBGEHhAGA......hAHA...,1,-12,-24,12
gYSbKFQeDHVINLAfBEWUPROcCdXZMJTaG,EHGEUFBGRDDF.OADB..dAHCMIAGTACBGEGG..gGBEhAAASDGEKAFHQDEDhAAADFIBHCAAIDGEhABAAACFBBBDPAFECGFC..XEAChACAaEAGYFFF...hAEA...,2,-14,-12,2
PICbULeMZNTafScdgJGHBXQDAKYVROWEF,KAAAVEABRDDH...OFDGECGG..FGBDCDEBLACAZADE..aFGAhAAASBAFdGGA.hACAJHEABCEEDAHFAGGAPDAChADA..IDGCUGDDMFADfCCGhAAA.cGBE.hAEA...,1,-23,-29,6
AKeSEJHLIGaORZDWBfPTXMdbgUYVQFCcN,SGHHJBBDHAFGGGEBRFABZDDG.BGCE..TADCMDFGdEGBUABGhAAAQDCHCHDF.hAFAAABBEEABIFFA.hAAADCFCfADA.XGAC.hAGA...YAHHhBAA..,2,-24,-18,6
QHgTGOeKEdPXFYSDZVbcIMJNLfaCRAUBW,UACDBDBGHEDFGEDAKBBCdCDDFGADDGAAZADB....VDAG..hAAAIHFCJBHB.LBFAhAAAaAFC.CDFEAAGG.hABA.gFFHeDHH.EHAG....hADA......hAGA...,1,-24,-31,7
UYMIaXFfOZPdVgTGKAScRLWeJENBDHbCQ,RCDCeDBDEBAB.BBHBHEAGQABDMEFA..aFHBXDDEFHAEOAGFhAAAdAGG...TADChABAAAADLGEE.JFAFhABADFFFCDGHIHFHfBBBZFCD.PAEBhADA......hAFA...,1,-7,-12,5
WCHbfVeMYEdNBLTJARgGPaUOZcQXFIDSK,RCAAGGEHUCGGZAEGQBFG.FEEEDABDKAHHHEDH..VFAHhAAAMIFEEBACBACGLBDFhABAJEAF.ADIFaEAA..hACAXFGDSHDGCFCG......hADA......hAEA...,2,-33,-6,27
LHIMWfCQAbeBJXaONDREYgUFPVGTSZKcd,BDCHXFGBaBBE.DBBFRAGB....EGDFUDCFFDAH.GBEDZFFEKFBGLAFEhAAA.HACHhABAIEECMIEACDGAAHIBeABChAAAOCAH..gGAG..TFEAhACAcDFAfHBDhAEA.,2,-24,-16,8
WNDCfGQVXPdSAJURMLTcZaFOgKYEBHbeI,RGACTBBGZCFHFGGB..OBFFKEEB.BGGGHBAGeABE..IAGDhAAADCEHCFBE..fEGHhAAAVDAH.XGAGhAEASABEAHDEMFIHaEHF.EFDC..WDDFhAEANICF......hAFA...,2,-30,-18,12
SdNaKERYTZMGfCDUFgeLIHABQWXbOJVPc,BBDHXCBGJEHF.....VEFGSDGEdAGGKACG.EAFDREDBZFAChAAAGDECDCIB.UGAFeCCEhABAHABDAAIH.QDAGhAAAOHBC.NEDCaGGH.......hACA......hAEA...,1,-8,-19,11
FKEAZXSQWIVNDdLMfPabGBHeTCYUcgORJ,XFDHQBDD...VCAHDFCBMIAAaHBC.BBCDHEFDTDAAhAAACAHAUAAF..OAFEhABAJGCGFHGEEHGGAEEBSAGDhABAIDFA.dFADfFGB.PACGhAGA.eDDF.hADA...,2,-17,-9,8
bXWFSZJafHLPUKEeDcYIdANMBQgCRVGOT,MFDFBCFGCECBRAEF.GAAG..OAAC.XGAHSGGDhAAAJFEC.aCHFHCGHLADBhACAKCCHECABeHBA.YFEHhAFAAGAHNIEB.QFBC...hAAATAFE..WEHHhACA..,1,-16,-25,9
CfZGOgbUcPdQDMFLeBJVIKNRASEXaYTHW,SGAEaAEBHCFFCFHE.ZGECGDAA.OAAAgBBG.UEFBhAAAPCDHQAEChABADAHB.MAHFFHGGBBBGhAGAJCAHIEDHKFFFAAIDXFCA...hACA......hADA...,2,-21,-10,11
KeIgVHRbYDAaNMPJWFTBUQfdOLGcZSCEX,MCBGJEEC.FCHFUEBG..QFGAdBDGLACEZFCFCEBF.EEDGKHBAhAAA...eGDAgAEGhAAAHAGB.bCACAAIHNBAEhABA....TGECfBBG.OHEEhAGAcGAF.SABEhAFA,1,-11,-31,20
HLgYEeWcTfSNZRCFbIAQXOGMaBKDPVdUJ,QAGCXBEBGECEMIAABDBF.KDCHDDCA.dFGBUFEAJEAFLHEEhAAAEAAA.eAHHhABATADESACDhADA.NEEF.CFCDIHHA.AGGAaDHD.hAEA......hAFA...,2,-28,-17,11
aZTWfFNdLHBIXMGODUcJKPVSYEgQeACbR,RDEHaHECZECH....TCAHFBHDdAEBHEFFBGGFMFCHDBBF.UBGH.hAAAKGAHSFHHhABAEFDFQAAHAIAA.CDEDfAEChAAA.IHHEOCDG..PDAHhACA....hADA...,2,-45,-1,44
YAfHDeMPWLCdIZaRJUbFBcSOKGETVQXNg,HFDFMAFALEDFdDDHaBDG.REFD.UBADBBEDOHFCGBAA.EHBETAGHhAAA..QCGBhAAAXDGFNEACYFHBhABAAHHE.DDDCWFFGCACC.....IFCDhABA...hAEA...,1,-12,-20,8
SVeBLbPaHGcJYFMNXdKRTQgAUZDCfOEIW,DBBHCGCC.ECFBSGFA.BADCLGFE.aBEAHDCCJGAAMIDAhAAAdCABKCFG.TAGBhAAAAEDH.ZFABIEEAhABA..WHEGeAHH.bACBcAEBFEGE.hAFANDIC......hAGA...,2,-24,-21,3
aHUgQPKTXBGLZMNFEJdfVAIDeRSWCObYc,DDDGRAFFCEGA.ODGD....bFACaGECUACAQFAA.KACHhAAABHCCLAFAMIEEEDEEhAAAdGCAAIHAeEBE.SGGGhABAcBACgDEA...hAFA...PBHFhAHA...,1,-22,-28,6
IZCUTVOFWJdQDbaeASNLfBRGXHEPcKYgM,LBDCBABDRBGFGGEDECGHKGGH..MADAZGAGCCBCUEDG..ODAHhAAAFBDHdHAFDFGA.eABChABAABEASCAA.hAFA.NCEA...fBFA...hAGA......hAHA...,2,-32,-30,2
TKUgFBMCHXAYNLIZaDRSfPbEcdVQOeGWJ,LHFCZGAEaBBE.DABARCGB...SCCG..bGEEEGBDdCEAhAAAQEEBeADEJCAFKAGEhABAgADCBDDFCFFGABBAhACAIEHF.fCGD.PFDBhAAA.OCBHhAGA...,2,-31,-19,12
gfLFYTdeOSCKZaVcMDNAUQBGJbWXIPRHE,QCAHBDFEJDBA...XDFHREDAHADGEHBGLGCC.TEAHhAAAeHEESEADhAAAKAGCVACFDFIDAABCbCGFIHGAhABA..fBBD.FGGAOBHDhACACAHD.aDEB..hAEA...,2,-13,-13,0
XMWCKTYEBaJVAgGNRUQefODLPdbcISFHZ,GBEDUGDAeCAAOCCBDACA.LAAB.dFGGIGAGSEFFhACAFCFCZEFAMEIBCEDH.TACBhAEABGGA..JAEGAAHEgFAGhAFA.NEEE.fBAFhAAA...cDBDhABA...,1,0,-43,43
QAbYEaBZTCLFfNSgWRDOKdPUVHcXJMeIG,EGFAZFDGCEHELFBG.FCHBSDEB.RAAHKHBAUBDFHAFAhAAAJBAHMEDEGDABAAEA.aADHhACABAHC..TFAHhAEAgGAGDGIFdHFD....PAAGhAGA......hBEA...,2,-33,-5,28
EWGeCdXAHRZULaMDYOIFcSgBVKTNfJbQP,HDEBZADDaFCAMFHH.DBDAOCGBFGBB..SDABVBAF.KAAChADATFGH.JGACQCCEhAEA.PAFGhBAAWBFFeHEGCDHDAGEFLFCHIAHDcGEEhBCA..BAAF.hBIA...,1,-18,-20,2
ESaKbPJYQNgBXfeROcVUCAIDLdGFTMWZH,DAFELGBEdFFDGABHFAEGMDFHZECDHCEE.EBADKBCH.JBFGQEAHhAAABHGC.fBGHhABAeAAD.OHEAhACAUDAH..IEDH.SDHBhABA.aHAE...hAEA...,1,-11,-27,16
DeEHNJGLRcCUXQMFOYSTaWbBPdAZVgIfK,VBDC..gBCHKFFC.EBFBJCBHLFAGRGEG.CHFAXEFGhAAAQAADOHBAhABATCGHaCAD.BAHDhACAdGBBABID..IHHHDDDHeAEENCIC....hAAA......hACA...,2,-27,-8,19
UBDJHScCMYRbFPeLZgNTQVWdIGXfAaKOE,KGBGUGGFDAEAHEEH.CGCC.MEGHRBGD..FCBDeAACZAAE...TCEFhAAA..QAEGhAAAdBCGXECEADDDEEHHJEHHhAHASGED..bAFE.PHDChBEALHAA....hABA...,2,-18,-18,0
BAWdKUCDJRNEfeQZMTbSHcGOLYaVgIFXP,dHBBCBFHDGACJDAA..RCBE...EEGDeDFGZBCC...MACESAGEhAAAHECGOBCGLFEBhABAaBHD.IAEH.hAAAXBGGAHCHKFHFNBAC.fGHC..hACA......hADA...,2,-32,-26,6
aRYbUeSdPcDGgJNVFOKHLEAQMCIBZTWfX,MAIDCBBCBAHHZACE....TADBXDDFRCFD.UGGAdGBEDAFCGDAAhAAA.JHDGFGGB.HDDFhAAAAACEQDGChABA.fFCAaDABeCCHSDHHhABA......hACA...,1,-13,-29,16
FHVUBYAEOJRNMZLWDIeSabfQdcgKXPTGC,ECBHRDGBMACAZDCBLBBE.DBIHIBGG.aCBBfGEChAAAdCDAKEBH.XAFEhABATGFGFFDFHEGDBHAEhAAAAGIFOGAC.NCAESCEH..hACA......hADA...,1,-12,-30,18
ZMgbcYTdAFKeOESfDBWRQCINXHGaJUPVL,eDFBSFGHDBCCBDHAQBDE.CFCG.IBGHHAGFaABDJGDChAAAUGEC.LDAChAAAMABF.bDFETCCBhACAABAGFGABEEAAREAG..NICB..XAEF..hADA......hAHA...,2,-33,7,40
LCBdKaGPXVUgIRTYfMeQHNEcFbSWAJDZO,DDCAOFBGCHFG.KBCHGAAB..XBEBUEGFRGAG...fCADhAAAQECEEEGFFCGGhAAASFHHABFB.hABAJFAFBFACaGDF.........hABA......hACA...,2,-37,-36,1
MVZgFRbDWTfHGPBEJKAaIOLXSNYcedQCU,ODAGLHEE.XECDSHCA....NAAC.eCCECFFBUBGHhABAVDGBZCCAFGAGDGIFfAFHhAAAHFAFBBEGKCFEhABAAAFHaBBGIHHD.YABG.dEEChACAMDHD....hACA...,1,-8,-19,11
XgEMSHYcWJRaLVUIANQZdeDOCTFfBbPGK,QCCGeFDAOBFFFFBCBDBHGAEC.KFFBEHBGHAGH...hAAA.YACCcBAGJEHFhAAAaHGELBAChABA.IGGBAGEFNIEDDEAHCEEGTDDA.PAHFhAGAMIAESABEhAEA..,1,1,-25,26
UOYTEGHbQeLDZBWgAINRfVKcaXCJSFMdP,RBEEKDFG..aEABJCBGFHEE..dFBFUEGG..OAAAEEBA.HGFChAEAeAAFLHAADDCEBFFFhAAAAHBE....IAFBhAHAfGAH..cEDFCCBFMFDB..hACA......hADA...,1,-32,-35,3
IDBLSHQaPgVOEcARNKbWUTGXefZJFCdYM,KFDFUGGAGCECeBCEZBAFCHFG..dDBFMEFADCIH.BBGELACEHFBCaAHFhAAA....gGAFhAAAEDDCAAFC.RAGF.hABANCAC...TGGFfHDF..FBCEhAGAICCA.SFFChABA,2,-26,-11,15
DAcEgIWeJGKQSRFdZXUPOYMbHLVNBCafT,EGEB..IBGHJFGDGADFSEEF.FCAFdFDFZFAEUEAFhAAAOGFCMHAGHABHVBAFhABACAECaCHD...fDCFhAAADBIFADDB.WHAA.KFGE...hACA......hADA...,2,-26,-11,15
BFMeAKRZdCPOQXcDUTGbHWYIaNVJfgSEL,KABHRBEDCAGD.QBFA.DHFCTBBA.HGEGIFFCaBHDJFAFhAAASAEC.hABAEECEBEABMDIFADDAdEEDhACAODAGUGCC..WHFA.VFBHfADFhADA....hAHA...,2,-20,-20,0
ZeNfYXVEdGJBScCUgFHTIPROAKQDWLaMb,KHEEQDEHDFFELAFCaBFF.ZDDF..fFCG.XCBChAAAEEBH.JEAHBDHEhAAACHAGUACAFBBCIHBEhABAOHCEABBAMCHBeAEDNDAEdGGE....SGGEhACA..hADA...,2,-37,-5,32
AQVZWHgYPBCITbJGLKEXDRNedOMfScaFU,VBCAHCCE....gFEGBBHECGAE.TEAEGFEB.KABEEFCHhAAADAFCeDHF.MFIHhABASBFBaAHFADAGZACC.hAAA.PHDEJAGF.XDGE.NBBE.fEEDhADA..hAEAFDED..,2,-26,-4,22
AMObTFaLKJPVcDGgQfHBWIEUSXCZeYRNd,MECDTDDELBEC.KDGHPGCG.DBIDQCAChAAABHCDEACEUAEECHHFeFEFRAADdGGHhAAAAFDFFABF.aFAF.JDDGcCBDhAHA..fGFAWBGH.SHAGhADA...hAIA...,1,-14,-24,10
SdLOcTBJeYQCAaMUDHNVWbPEIGFgZKfRX,aAGGDECGHCAA..VDCD..bEFGECDEFGBDZACEKAEH..XGFDhAAALBAE.OAGFhAAABDHFJBAHQGDChABAAGCDMIBA.NAIG..IHHAfEHCSEAGhACAcFEGeEABCGGC.hADA...,2,-16,-12,4
KZNWDeUJOScLCgMPbQFBfEaVTdARXYHGI,XGAAHCFFKGAFZDDBDCFC.UCBG..OGFESGGHCDHG.MBIBhAAAQDDF.hABAfBBBaHDAdAEBAACD.hADARDAFIAEHeFBB...cGDB.hAHA..gAGEhAAA..,2,-22,-19,3
PdgOIDWLTCKBMHJVGfcAQeSYaUbEZFNRX,QFAASAEGUGDAECAAZDCF..RBABdDFFOEEGDIAE.LFHFhAAACGHG.MBEAJFAGGEEDhAAAAACDaGFF..NCED.XCCDhABAIHDBKAHFBAHE.....hACA......hADA...,1,-9,-25,16
XSbdgJHfECYeDWaKGPcTLFMBIRONQAUVZ,ZBCAXECBSACEdAFCHCGF..CDHGeGCGDACDKFEFGEEH.hAAATGAFMHACBBDHhABAIAGEODBH.AGIH.hADAUDBDgGFHfBAAEAGA.aHGG..hAAA......hABA...,2,-17,-15,2
QFKPOdYSECANMaZRJTXGLgDeVWUIbfHcB,aHAGRCFA..TBAALFFHDIEG.eDFC.UDCCIADBHAABBEHAhAAAFDDFKEHHdAFC.SBGEhACAEHAAAFFCZFAA.XEABhADA..gGGD...hAEA......hAHAWBFEfHCF,1,-4,-40,36
XKgEVBdaRTNbLfIJQMcZCOGSDYHWPAFUe,FADBXAFDKAGF..EFBBdEDA.RCAD...TCBFLBHH.JAAGhAAAMDFFCCCHGGDBDEHH.hAAAHDFBACIDeGDG.BEDChABAaHAAfAEAIHHE.....hACA......hAFA...,2,-40,-5,35
LAHaIecVETJRdQWDNGKUXYZPBgOFSMfCb,aCFAeHBA.EEEHRDDGdGGBDFID.GBAF.UFBCZAABBDEC.FCCDMCIHhAAACFAEAGHH.HFDH.IAGFhABATCGCJACENEAG.hACA..KBEA.XGEH....hAAA......hAGA...,1,-9,-32,23
ITLDZJPgbSVYBQKFOfWdMcAaRENUeXCGH,EGDEeEBBGCBAHAGDTBBDDAGAZAAB...JGEE..bFGDSEDBhAAABHBGKBFB.ODFChABAdDDAAFGFRACCXAEH.hAAACACBIGACPCHF..YFAD.hAEA....fHCBhADA,1,-6,-21,15
EAGLPbSINVdaeTHcQfKUXgRFCZDWBMOYJ,LHCGSBGBVCCEdDFA..eBDHHFFHQCAEKBGCUAAHREBGFHEEhAAADEAHBGAC.OHAChABAEEGGAHIB.GEGE.hABAPFBGIADBaABE.....fGAFhAFAXAEB.CDHE..hACA...,2,-11,-10,1
MdBUQEAWCVGcePaSfTKLXZYOJbRNDFHIg,CFBGGDGA.eDBASDCHKGCALFAHZCEBOBHBJCAG.RGFA.FAGAhAAAHBABMIDCdAAFBAEChABAQGDAAFCG..hADA.cGAHfFEDXAEC...hACA......hADA...,1,-9,-24,15
ZOFIAaPeQUMfSKdEXNJHVGTcCRWBgbYLD,aFGAeEBA.MAEHKHACdAED..EDGH.JACDGAAG.TCEGhAAACABCRFGHBFEB..bBGDLHAEhAAAODCFAHGBPAGHhAFA....fFAH.SEEDhACA..hADANBIC...,2,-30,-22,8
PTXbdZLCQAHUMRecYfFKIEBNSgDJVGaWO,MFDCeCEE....fEACKBHDBHHBSBEFDAHBGFEHODBAhAAA..XGBBhAAAdADB.CFHDADDBHGBAhABAUGEAYHFGEBAFNAGE....JCBBWEFEhACAPABA....hAFA...,2,-36,-8,28
dQbfUJKZTCLHOFVXaYMENASPegWIBRDGc,eCAE..IGGHDAIBdGAHQDGEUECDKCCCZABECAEF.LBFBhAAAOBEF.FDAG.aDHFEFFBhAAA.AHIB..SEDFhABAgGADBDBG.cGCDfHCDhABA......hACA...,1,-23,-32,9
TZFYMVEOdbJfcAQCLPBgaRHeNSWKXUGID,CBFELGECBBHC.RDDCeEAH..SCEFKGCBGABDDCBCZCGHFACEhAAAMBADODFC.dFGFhABAJAFAACAD....QGADhACA.PFDFaCCE..NIEF.WFFDhAFA...IHHGhAGA.,2,-45,-15,30
AEgTDeIWVNJLQXGFdHaOUSMZCfKcRBYPb,EGDEDECCeHBE..VDCAJFBA.LAAAGAAGHGEEOBHFSBGHhAAAZFGDCCFH.KFADBFBEhABA.PAEAAGGEIEFChACA.QADEXCAGaHBA.MCCAhACA.fFFEhAIA..,1,-6,-24,18
fIQEXMLCDbHSPeWVYcGUNOKdRBgZATJFa,TBGFJDDF..FHEGaEED..QACG.ECHFXEAChAAACHHH.DBBEHAFEeBDHhABAVEAHYHAGUBAEKFFAhAAABHGAAIAA.fDFBIHCA...MACGhAGA..SCEGhABAWFHB,2,-37,-20,17
GaEWNSTXLdFROCIQZVPeKDAfMJYHcbBUg,JBCCHBDCBGBFUEAA.aHCC..EDFB..SEDGLDDHFBABhAAAOAAFQAGHhABAZGFCeAHBAFBC.MEEA..hAAAbFGDWACC...XEGACHDG.IGDGhAGAKDAGDFFF..fCHGhACA,2,-26,-21,5
GNfVPWRCAIaLYXSBHJegETDQKdcZFMUbO,aGBCLDBE.XAGBBABAJCDG..EEBCDAFEKBACZEEC.FHEGUGCAhAAA.OEHB.hAAAGAEENBEB.fGFAhABAVDAG.WEADAIHESDGGeDFHQACGhAEAMIAA..bBAChABACCHH...,2,-40,6,46
TJVLMbDYeQcBAEZOHGaIXPfURCgNSWdFK,ZCDFGGDFaGCG...XDBHUCAGRGFE.CAEE...SBGChAAAdEEDFBGGTBCDLFAHDBBDQGAEhAAAAIFAEDFG.hABAODABIHDH.PADANDIGKABCMDEEhAGA......hAHA...,2,-17,-12,5
WBcKSNEUfFbOYLeGDCHVTIQPZAXRdMJga,dEBHMEAGaAGGBHFD.KAADECBB..UCGBFGGDOFCELFDEeCCGhAAADAFH.HBGF.IACAhABAQGAA.ACDBXAGFhABAJFAF..cEEAfHGBhACA.YADHCAEC.hBAA...,1,-18,-30,12
bSNKacCBADWROUfYeGTHZEFJgPVIXLdMQ,DBAGRBGDOEACUADH...eFDAGFEHHGAEFBHDJACC...VCCChAAALEDF.MIFAhAAASBACKGABCCAEBCDAhABAAHFDfHGDZBFB.EEHHgEAEhACA......hAEA...,2,-26,-9,17
FLHTgJCScQXAWVOIZeEMRdPBNbYaKUfGD,VEEBODCF.ZBADECHBdHAH.BFEF..NEDG...aHDCKAEAUFGBhAAAGCADLADE.hAAAHBFGTEAHCCDBSFBFhABAQGABAEHF.IBAG.eHFAhABA......hACA...,2,-22,-17,5
PKUXAFZDIYQcRfTMSbBWECJGLNVOHegda,FAADZDABDIDAQFBFRDDD..MHAASDDGBGHA.CHAHLAEGhAAAOCBAHAEEdFFAKHGGhACAACAH.ICEH.hAAAfDAHWCGBEABGJGEGNCIA....gGDFhADA..hAFAaDFF..,1,-22,-25,3
TRbGXFSQDOAVJCYWMBgaHKPdNZLIUefcE,VCBEJEAF..CADE.MBFGBHHB..HGAGdCFDZEECLEFA.UGEGhAAAeABHEABERGCA.XEAChADA.FGHBSDCHhAAA.DCIBADGD..WBEGaHEE...hABA......hAFA...,1,-5,-44,39
agTXfALObHBFGDIePKRCNMQZVEdYWcUJS,LBFGOFHBBBBGDABCeACAKDED..CBEF.MEGFZBFE.dDFB...hAAA....WDEDhAAAJEACaACG..gGABhAGAfGDBACDGFFHB...PBBHhAHANIAHEFFD......hAIA..YGAA,1,-30,-41,11
GeAEHWaOIRZSQVYNJPcdbgfXCLBUDKFTM,HFGHaFGD.RDEGQFBF..YABBPBAB.dGFGfCFBhAAAXGBHCDGBLAFChABABBFDDEEBFCCHTEAEhAAAMCIDABHH..EAHFOFFHIADASBBEhACANDDE....hADAcCEC.,1,14,-27,41
IfFVWBNaYSTPcgDUQbCGKELAXedZRHJOM,dEEEHFEBJBCGOCEA.MFDBFBHHBDAG..NCAC...aDDBTBBChAAA...gEGChABADGGAQAAFhABAbDBECHAFKHGAACFBeHFGIFBAVFAF..SDGDhADA...hACA...,2,-33,-17,16
BKaWQXDTIJbFZRLcOeYENfAUGCMdHPgVS,UCGACGADdHDHHFEG..PEDCSAADBCDC.KBFH..QFAFhAAATFBA.IDAChABAbDAGZDFA.LFHBhACAOBDF.eBBB.NIABAGDD...MBFGaBBFDIAEhABA....FGGBhADA...,2,-20,-9,11
SBRLKAITeGVOQDYMgEcdXWaUPCfbNZHFJ,TABBGECGOCAE.DEHBMEBD.EGDAXAGGaECE.CEEB.hAAANAEFHGFGFEACBGFEKCHFADDDhAAAeACEQCEBhABA..YFHBdDABWFFEfHAHhABA......hAFA...,1,-1,-31,30
RVTbLKgWDMdBEPNOJaAZUQGXeCcYHfSFI,UDBHXBGECEEE.HEDHFGGC.RBCF....VFADLBBC.KBGFhAAADABFBHAEEGHBODGBhAAAAAGG.QAEFhACAeCHF.fHFBTFDA.gDAEhADAMDAHNABFaFCH....hAIA...,2,-39,7,46
CMHeTEILdfbBRAPZcKUFJNXGYOgVaSDQW,ZCDFKABCUDDAJDFE.GGCD..OGCC.aAEFSCCDhAAA.DDGCQDAAhAAAMAEEeBFGEAGGIHHHhAIAfGGDBFCGAIEEPBAAFFGE.XEGEhABA....hACA...,2,-34,-26,8
HOcWIfPSEFYDNAGeQUgCaTXZdBRKJLbMV,QBGHUFCCCBGG.aADGZCEH.RAAC.KEEELAHHMFBH..OFDChAAA..IFHChAAAPBBBFDHHDEBDADDBeDCFhABA.XGFABGADJGEC......hABA......hADA...,1,-13,-40,27
EQdcGHYTZBgMDOWbIfPaFJVLCSeAUNKXR,KDBD.EGBEQBGC.dBAFHAFFTEEGBHAGDIFEbEFB..hAAAPDCGaBCGFEHDLHAChAAACHHHACDC.XCAHhABAGDDA.gEGBMICGIBABJADGSGCEhACA...hABA...,2,-19,-1,18
edYUBSMEDbHNLOXgcCWfZaTPIFJRVKQAG,GEEEdEEBBBEFSDFEDIACHGBCLCFEOHAG..XAEEhAAACGGCZBBB.aBAD.PCCGhABAFAGGJAADRDAA.KFADAHIFeACChACA.MDIH..NEIA......hAHAWFFD..IHGHhAIA.,1,-6,-29,23
ZTeSUVYGHNQFAadCcWKPOXMLRDJIEgBfb,dGDBCGBDKFFGOEHH.LCABRCEADCCA.EAEEBCAD.ZAFGeDCH.hAAAUAGCGEAFHABCFDHDhABAAFEGaCEB....hAAAPABCMIBG...JHCG...IHHDhAEA....hAFA...,1,-9,-37,28
bNHPfOUFMTDBKZYVcRdEWeIaQCAGSgLJX,SHCGLABFJAFB..XDFF.HAAHOHEGMCCHDEEGhAAAKFAFVEBFdHGDEBEHeFFGhADAaEHDADDC.GEEC.hAEANAEB.fBHEFBHFBADG......hAFA...YHAAhAHA..,1,-4,-26,22
UeOLGYgSEaAFKQVbHZWPXCIfMcdNRBJDT,KBGHVEAAZBDB....XBAFCGAHMIEC.dDEDRAAB.BHEB.DGGDeEFGhAAALGAAGFDFSADChAAAAFAGFACF.bFGFhABA...HAEGWHAAICCA.NIAH.hACA......hAHA...,2,-32,-14,18
FRMbBYGgQALOCNdPTWKEfeXZHSUJaVDcI,CAHBdEEA...TEBEEEEEeBAFZABHUAEF..JFHFaHBGDCIBFDGDRBFHBEBFhAAA..gGGAhAAAAAFCLABBOHCEhADA..PHECKAHH.XDCD.hAFASHBC.hAHA...,2,-28,-21,7
cfTVeYEAPIHdOBgKaWCLNSRQDGMJUZXFb,HDDDdDEHBBCDKBGGCFHBLCGH.RFAAGBAAMBDCJHDG..ZAFAFCAFhAAA....fGHGhAAATGAFeFAEAIGGOABAhAGA..WABB.SHGAhADAUFDG.bDFB....hAEA...,2,-30,-16,14
FbgPGScREBKWCHLZVOXTMeJNQYIfadDUA,FCDE..PDDGSHBARFFCBEHBCHHCLFEBZBBB..XFAEhAAAeBHFQAADhAAA.IDAAhACAaAFGDACAAHHGgEAAEHDAWBDA.ODGHMAIH..hADA..JBAB..fGBFhAEA,1,-11,-33,22
WeBgAbMEaDRIZfSFNVOQKHLPdTJcUXGYC,EGFFDFCERFEFZFAF...SFEFFFAHOAEAQCFFLCECdCCAhAAATACB..JDHDXCABhAAAGBACCHHDeDDFhABA.BAGAAABC.MECBfHBHKHGAPDHFhACA......hAEA...,1,-8,-27,19
PQWMbKcgTSfRGJUIANeZaFHEXLCYVdBDO,ZBADFGEFEHGGLEGD.CAFB.VBBHDIAG...ODFFQDCHhAAAMFBH.KCHB..gBEChAAATGDGRADB...hABAJAHBAIFAaFBC..YADEBBHC...hACAPDHD.WFDDhABASDFF.,2,-19,-19,0
VHFEWQOgbSeITcdMDKJXRYAafZNCUGLBP,aFFFZBCACGHCGBAFLFBDBABFHFEB.FDGFEEAB.QGDGhAAAOAAB.SAGFhADAeDBGIAFGTCEAMAIFhABADDHFXEBFADDA.fADHNEAA.hACAPAHDgGCDhADA...,1,-2,-17,15
RQaWFGdUcNCBYbDESgXIOfVPKLTeAJMHZ,MDEFRCAAQFGDFHBAGBAFdAFE..UGDFCBEBBEADDCHB...SAHFhAAAXEAGOBAGhAAA..VFGBKDEAeAHBhABAAFFAZDFCaABA..WEDGYFAG.hACA......hADA...,1,-19,-21,2
FbLYDGSXCdPQceUgEOZJfKINRTaBMAWHV,HEGDVFEC.FGBBLCCBGACDCDFDdBEH.QFAHeAHBUGDDEAAAOCABhAAA..fEHEhAAAIEDB.NICDaAFGhADAABAE....YCCDDEACPBHF..hAEA......hAIA...,2,-15,-13,2
OEVGIDUZBbHRTXMLQAgfKecPFYdWSNaCJ,KACDeDDEFDCDdACF...SDBDCGEF.ODHDEAGAGBEChAAAUAGCZFBEBDADHGFCTGGAhABAMCCALGAChADAABAH..fHDD....YCHFhAEA...hAAANICFaBBHIFFH,2,-36,-8,28
WdeJQYXINBVgPRfLKFMATZGCOEDSUHabc,GGEFCCBADCAH.HCGF.aBDE..bFGFdDBB.eHACQEBFhAAA.XAFEBAFEgCEAhAAA.REBGKBAChABAABACTGADOEAHEHEC.cFDG.JBCAhABAIADANDDF..hACA...,1,-8,-17,9
FAYTOQfKMaZWXcLgDPEVJbHIdReNGUSCB,OGCEKGDCMFBHZDFB....XBDELAFADHFCEBCA.JECGIABBhAAAeBAFGEAGhAAACFFBFCHB.AGHC...TDBChADAaCEG...WAFEPHFC....hABA......hACA...,1,-16,-38,22
decNWfbSJPGYRKHQUZVaMgFEOLXCTDIAB,BGHGdCHCeBBH..NCBH...fFDD.SDEAhAAAGFAHYAHBHADHQGBGhABAUFECZAAE.VGFAhACAMIFGEAGCXAEADIDEAFFGWFAFPDEC.hADA..aDDB.OHAChAAACDCH.IEAD,2,-10,-3,7
OAHJBXCSUQfaedMNTbVDPgcWKZRILFGYE,JAGBXGFA.UDEHaABF..dDCH..MBFG..NIDB.bEBBDADAhAAA....PHCEhAAA..WFBAKABGIFAHhABAFEHFEBDAADBFBDFDCFFDSDAC.hAGA.fGGDhAIA...,2,-49,-23,26
UPNQbeOJMCBAYXTRZIcdagLKEfFDWSGVH,XGADRGFEZEBFdAFDLFDBKHGE..EEFBDBBEGADAHDGHUCDAhAAAQGCF.OCAFhAAACADBABAF.IAFBhABAaBGEFGAH.SBBB.NAHG.eCAFBDFE.hABA......hACA...,1,-9,-13,4
RHeDaOPTKGVfcdZEIXLFNgSYbJMUWACQB,QFGBBGDCHGEGaAAEOAAB..KADCGBDA.VBGHfDDFhAAAZGBGEFACICBDhABALFCFFAGH.SCCChABAYFFFMEAEADBBREFGDAIDcAFG.hAHA......hBDA...,1,5,-23,28
WINbQJRgKYFVXOEGeMHBLPDcdfZUCSAaT,TEDF..ICAHQACAJECGKHFGFGGHOEBH.ECFDhAAAMCEGLHCEDEBBdFHEhAAAUAGEAEHC.aBBHNGDH.RDGF.hABA....VABG.GGAHBDDF.fAFBhABACAFG..hAEA...,1,4,-37,41
HVfSPReNYJOcgQabDGILMBZAKTCWUEXdF,KBCBTGFCCEHE..UGFDdCADFABA.HEDA.SAHFRFCHeCEG.hAAAJAEBODAF.QAFEhABAaEHFDDGELGAGhAAAMAIBAEFB.EEAD.fDCC..hAEA..YFAFhACA...,2,-39,-3,36
DLWKbIQZMdBOHgNURYTEGeAaCXfScVJPF,XBDBSGAA..JFFGFBFE.DFEFKDFDQACAdFCBHBABUAFEhAAARFFH..TBADhAAAECHFABHG.CDFG....fEBChABAcGDCPEAHWDHB....IDDAhACABHHE.NIBFeAEChAIAaCCD..,2,-24,-11,13
daQKeRNbITBUVAYGcOHZJgXLWMFfDPCES,GCFEHFCCZCBHJFAELBEE.FGHBfAECCEAB.EAAFaHDChAAA.KCHHeHBGRDDG.IDDGhAAABACCAHAC.OFFHhACA.XDACDBABSHAAdDHA..hABA......hAEA...,1,-11,-25,14
VWHYZOENXCFQJaURAGMdDcKbfLSTgPIBe,GBAHdAAGKEDFLAFGSEAB..TGGGgEEC.BFHEhAAAVCGHHAFFZDAFOBBAhACAEAHDCABCJHECREEFDICAfGGBhADAeHAC.NDDCFADEUCCHMIAG...hADA......hAEA...,1,9,-4,13
GdUHCJPLcNZBEOTfIFQegRbKAVMWDXaYS,VACADFHF..aBDFGCEEHBAA..CAEBLCFAZFACEGHB..OHDEhAAATGEGFBAD.eBHDhABAgGAG.KDADhAAAACCF.XEEAdHAB.......hACA......hAFA...,1,-16,-19,3
GBdIQTcSbWHERZVXJaKeUgNPLYDCOMfFA,BCHEdHCDQEBHSAGCHEEEZAAF.VABGaEAB...KCGHUEFGhACA..gAEBhAAALCCBCGHHfGGChABAACEFIHBA..cAGFEGDHXADA.hAIAeHFG....hADA...,2,-27,-3,24
KBDNLTGCabIeMHWZJOPSYQfgUAXdVRFEc,VCBHRGFCEAHD..BGBELFBAGACC..CDHE.aDFAeABE.HGEChAAAJBEC.OEEG.PAEGhAIAYEED.QAAFhABAfHBFAFGEFEAADFGE.....hBAANIAF.IBHC.hAEA...,1,-8,-21,13
BHbDYMLJXOECPafAWGUQdcRFZeVNKSgTI,UCGCdHDFFBEBZFFG..eAFEKAGA...SCCHTGAB.BFDGhAAAHCADDCBDMDEBLFGBhABAOFDHCEEA..aBGHfCEDhAAAACIB.GABHcACG.NEIG.IHHChABA...hACA...,1,-12,-36,24
ZGVRdLYWESbAPJHUDCNfeKFIBQcMXagOT,HFCCCGBC.eAGFFCEGQDGBMDHH..XGFHOEEFZAAHhACARAAFLEABEAGD.ADEAUADBhAAANICD..fGGBhADABECGaHCC.TDCA.....hACA......hAEA...,1,-11,-24,13
eAEXBVQdPIMNRUOSTZbJfWgLCGKYFcDHa,BCCFQAADdDEAMBIBRBFGUFFH..SGACZDAF..fDCChAAALAAGCEHDKAGEhACA.FGDDHGBCAIBCXDGEhADAIHHB.TAEAWEAD.gCADhABA.cGEEDGIDaCDFhAEAEECC..,1,-18,-19,1
DFKQWHfEPXGAMabdcNgIUBSCLVZORJYeT,MFAEdFCC....NEIG.UCGFBBCDCHECZADBRAGD...JHAAeEDE.hAAADDACKHFGHAEB.EEABhAAAXCBDAGGE.aFGChABAgGEE..IACCSABFhADAOGBAFGAH.fEEGhAGA,2,-35,-28,7
TEPcOaCUSMYXbHWDFVdQgJGfINZRLBKeA,EDDAOACAUBAG..MCCG..XEBCHEFFDAHDdFECJAAB.GDDChAAAIFGAZCFGBGAGhAGAAIFATAFEaDBCSGCFhAIAbACB..FCHH......hAAA......hABA...,2,-28,-13,15
gVUPCKTZeXDNGYfWMbdBFQLAHIaEcORSJ,HDEGaCAC.OHBARDEC.JBCHVFCB.UGFCKACEZFAG.DCFCGBCBhAAA...fFAEhABAMHFEBBACFAHDAEBHEFGAhAAA.SAFGCEABeABA..NEIE...hACA......hAFA...,2,-28,-14,14
WPELbUNORXAZJTeGDdKSYVMBacfgQCHIF,JEDBeABGGCBEDCGFKEFD....SEHFVFCF.BBHBaEAC.hAAA..fBDDhAAACDCCFGAH.EFAHUGGCNABFOFFBhAGAACCEZBGF.....YDDCMBBH.hADA......hAEA...,1,-20,-28,8
QYZHIObBTWdGPUNAXCfgKeVDacRJESMLF,XECBCGAGKFEB.DEGBRCCG....SBDELFHBQBBAhAAAZDGDOECH.BBHBdDAAUAAEhADAAFCDfBGEhABA.gGDAaBGCEGHFMIBEFEAHIHAHhACA.bADF..WAEEhAIA..,2,-25,-21,4
McedWJFXOIKCYAEZfQUVTgNDSGRbaHPLB,ZCEHQGCCUDCF...TCBADCBGSGAGRDFHHBFCBAAE.hAAAMFHDeHCAdAEHJADAOFABhACAKCAD.AEDFEFEBVCGHhABANEIA....aADH..cGGF..hACA......hAGA...,2,-34,5,39
QHFRgUNcODfaKCZESGdWLTYPbVeMJIXAB,QGEHFBDHRDEA.UADCOCHFDIBEKCBFCAAC..ZFGHGCEDLFBGhACA..TAGEhAAA.bEEGeAEA.ICBEhADAACADBGAC.NHBF.cFBDaEAG.SABBhAGA....hAIA...,1,-21,-25,4
GZJgYUbHWVOXTfEDRMdBQICFaLeNScKPA,JGDEUGFAHAAAOBFG..TBEBDDIBdDACBFAF..QFDEhAAACBHGaEFE.LCCHhABASDAAKHAAAAGCgGAChAAAbCEG.WCCHfABC.EHCGhADAIHGH.NDIA.hACA...,2,-37,-14,23
CIZQdXJgcfPERHKGeYTVBNbUFaSDMWLOA,CFGGQEACdDDB.JHAA..fEGBRBDFGCGC.eADC.VBADhAAABAAA.NGCBFAFEaFBDDCEEhABALBCD.ADAG.hAAAIHDBZGFG.XAGE...hACA......hADA...,2,-26,-15,11
SJONgMHYZPAULReGQFadDTcKEBVCIfbWX,LFCCGAABFECDaAFGDGGD..KAADBGEGCDEA.....IHADhAAAfEAE.XCBDhABAJCDAOEFAgGGEhACAHAFEZDADABHFRGCCeHCGQDGF.hABATBDGEEED...hADA...,1,-12,-20,8
fGZTaEKUCRPLMXDIJeFbWAdHQYNSVOBgc,QEEASBCBBFDH..gEBCGAEHaFAFKHACCEEBLHFGhAAAXBDEDDADIDHHhABAFDGAAFHDHABH.hACA.NECAOBBBfHCFEFGH.UAGD.MIFChAAA.....hADAeBAB.,1,-8,-13,5
WdEFXHagDSGUcYTJObLNZQeCfPKMRBVAI,dDBAFCFGHEGBaHCC.SDBGGBEGUABC..TBBHOFGHLGAGhAAAZBGBCHAE.fEEEhABAMFIFBAEFADIDWCADhACAXECD.DAGD....JHDGNAAE..hADA......hAEA...,1,-16,-19,3
IdUeQOSHGFabYLVXBTMKRJCAZfNEPDcWg,ZEBHEBGGDDGA....gACFdFEHQBDASBGDFAAFaFCDhACALFDGBEAEMEEAhADAKGHBCAAC.AEDG..NAFC.PCCHhAEA..IHFAUGAGOHFG.hACA......hAGA...,2,-39,-11,28
AgUVTcdBJRZXbGYIPOeKFLNWQfEDSHMaC,VCAHTCAB..BGEDRGBEZAGHGDCC..IEEBOCGBFAGGhAAALFAEQACBhABADIECSACEMIBAaHGAACHGhADAUFGDdFFD.JCCA.XAACPFAB.KEGE.hAFA......hBAA...,2,-9,-9,0
KCYPQAeSNbFJLGfgTdWIDOVcHRUaZBXEM,eGBCSFHHFFGGGDDH..TDGDdAEBDIEGOADAHBAGaDBHhAAAZDDDBEBC.EFFBCAHB.hABAQGBHAHHD.hACAbBDCfHCFIBBGcBGF.XCAGhAAAKBGGNDAE...hADA...,2,-17,-2,15
KDBENaPGcOMARefgUbIQJXVCWHYSZTLdF,eCBHUDDHQBAG..JGAGVGCGCEFFHAEAZBFC.LDEFhAAAFEAFBAGDNEIG.GEFGhAAAMHEAADHF...fABChABAIHHHXACASDAFKHAADIDG.hABAaDCD.....hACA...,2,-16,-15,1
bfMRZFcKGdWIDAOXYVeJTaLEgPNUSCBQH,XDDFVGCC..JDFELCHF.ECBA..gDCFhAAAUGDBCHHEHADEMABFFGABGAEFhACAdAAEDGGHACCAeGFEhADAaDAHSDFHBFAGbEFA..fHABhAEA......hAFA...,1,-9,-18,9
gVNKLJCEYeaPDHdcWfOUGZARbSIBQFTXM,RAEFSAAFBGHGFAGA.MECB...VDFFKBCBCEHB...eDABhAAADDAAdBHG...cEDHhACAOGCEGBBBhADAAEDBQEEEXAEE.NEAAEHGA..aCGA.hAEAWABC....hBAA...,2,-49,-4,45
bGgYdXAWeERaCOJPKVQUMNTZIBHcFDSfL,eDAEaFAH.OFDEKBGAUABB..MIEGZEEHBCCGHAFCDEAFLDHFhAAAbDFE.GECAdDDEABCBRGAEhAAACAEE...JFHH.PACAhABANIEH..IEBASCFG..hAGA......hAIA...,1,-2,-28,26
ECeDOLIGQXcfJTWYBUgMNPbVARaFKZHdS,aGBDFGFCZEEAHFEGdBBBCCFC...eFBBLAHFGBEDQABEhAAA.XFAFfFDGhAAAJECCTADHBAHAMDAFhABA.bCCGAEIFSHEGDDIDIHAEcBAChABAYACC...hAFA...,2,-15,-9,6
gTQbPLUeYNIBJcRaWAGVHZSdEfKCMDFOX,HBDCSDBBdEFGKDDFCGGG.DEIF..OAFA..TFAHQEFDhAAALABEUBEEeHEEhAAAIBCHJAHFaDGFAGIFVGCGhABA.EBHFfDBGXEAH...hACA......hADA...,1,-18,-20,2
AKgCdBYMbfOXGSZcEeRQUDINWVHLPaTFJ,KDHDCBHGdGBDMGEC..OACGGABGZCFAeBFB.UDDBDAAF...hABA.IHFGNEAC.hAAAHCDFaGBAFGHDAHIFBCCAhAGAfADFSBEEEHBE.QEGHhAHA.LCBF.hABA...,2,-23,-18,5
ZBDHTYCfMNVSbIUgKFeJELPGQRcOXaAWd,dECABEAGDCIDHDCB.CCEB.MFHD..VEGHSBGFUABBFAGBJABEhAAA..LHCEhAAAGEEERGAEOBHDAAGA..hACATBDH...NBAE......hAEA......hAFA...,1,-26,-29,3
OaJCLYDUeEPdbQFBZIRGKVTMHNScWAXfg,XEFFODAG..CBABLBFGUFAB.EEBFdBFG.QBCChAAAZEFA.IHFAhABAKHACTACCMCIHHFDASCABhACAAHGHaDEGDAFAPEDFBHDG.....hAAA......hABA...,1,-18,-21,3
aXBPRIfbeSCZJdcYDNAgTVQLMKUGOWFHE,VEEAQFGD.KEBCUEACGEDAODHFHFAF.aADDBCDFRAFH.hAAA..fHGFhAAASBBBCDEFdADBDAIFADAHTGDEhABAMIFEEDHB..IBHF.eHAGhACA.....hABA...,2,-18,-8,10
YdBegKMUZCGQJFWEScLRVOAXINHfbPaDT,XDFFHECB..PACHaBBD.DBIDdFCBBEEEKHCGZAEAGBFAFGHB.hAAASGHD.hABALFAHOFFBIHAFhACAfADD.YBAFMDAHCDDA.WEHBhAAA......hABA...,1,-24,-26,2
MaFPdAHgJEQWXIYLZUOVeGDTbRSKcNBfC,HDBBEAFA.QABF.XFDELFCFOHBCeABFDEADhAAATAGFSEEDhABA.cGGBBGGHfCAAhAAAMDDEFDHDADCDJAHDIDDCUADG...hBAA......hBDA...,1,-12,-17,5
baAZfPeYMUVRHDSIQLEXcWFOBCNTKJGdg,ZADBeFAEMCAFUGGBHDBFDEDC...SFEAQGAHLHBAhAAAEBCF.XAGFhABAFAECCDHCKGDAdBBB.aHGGACAB.fDEAhACA.YBGFIAAGWCHHhADAOFDA.BCED.hBAA...,1,-7,-30,23
cdKVDeMXUIRHSCTZPWaEbgNGOJFQABYfL,BCEELFFCKGFHDADGeCDA.UGBEHGBACAHF.ZCBA...aFFAbAAHGAGAhAAA..FACAAABG.hAGA..fHEDhAAAdEBFMBBE.IDHH.SECAhAFA.TGGB..hAGA...,2,-28,-28,0
YRFQTBObXPIeZfKaEUDHScJdAGVMgLNWC,MDFCLFCA.CAEHFCBDQBBC.TEDGBHBCXBGGhAAA.eHDEfAGHhAAAaEEA.EFHBDBAHSCADhABAdGHAAGAD.gGAE.NCEHRGEAhACA......hADA...,1,-20,-35,15
XLZFYOUTEBfgPKaHJdSNQWbVAIDecGCMR,DABGeCEFGGCBMCDBLGBGFDDG.UCGETADFBHFA...hAAA.fAGBhAFAPFHHaAFAHDGDdAAGNIAFWBBHhAIA.AHHA.CDAF..XBBBYFCE..EEBBhACAKBGD..SFFFhADA.,1,-14,-15,1
CLZQaATYDNRdIFcVGSKBeHWJfPEUOMgbX,TEAHDAGARFCA..FDAGGAGCBABE.eFCAHBGFJADB..EECAOGFEhAAA.MBAFXFFHhAAACCBBLDFB..hABAaFADAEDBNIAFICEG.cACESGAGhACAfEHC..hADA...,1,-2,-40,38
SUNPICODBeEdJYQWVcFLHfgAGTXRZabMK,TDADRCFBZEEF..aAGCMACE..KHACUDDH...IDGFhAAACEAFDBBGBDCDdFGHJGCC.hAAAQAFH.hABA.WCACFBAEfHABAFIB..bFBEhACANIDF.OHFE..hADA...,1,-13,-47,34
BdIHFQPCREgOZMaVLTUfKceYWbJDXNSGA,BAABdACDFGCHQGFARECG.EDDCZFGBMGBCaDGG..LFAHhAAAUAGCKCCE..eABDbEFG.hACADAGE..SEBGhADAIDAF.CDHEOADCfDDD..YFAFhAFA...hADA...,1,-10,-34,24
LNRaOPIMcHJTYGVeEBFXfgUKSdWCAQbZD,QBEBDDDELHDERCBA.OFFGMHCEHDGD..JAAFGEAAhAAAEEACBHHBfBADhABA.KAHHSFBHhABACACFAGGFNIDHaAFG.IBGF.YAEEFEEB.hAEA......hBDA...,1,3,-38,41
DUbOLFJRQdYTPeVIWXSCKNHEBgMAafGcZ,GBFEZGDCDAGEUBADODCH.LEAHFCFG.JHCAdBHA..TBDDhAAAeEBE...IABDhADASFFE.CFBFKAEAhAAAHFGB.BEEDAHHB.fAGB.hABA......hACA...,1,-11,-43,32
WYeNMXUgaGVDbFQBZcHEIATKJOSLdPRfC,KABESHDAdCHERCDB.CDAF...eEBDMAGDUGEBGCCG.VEABhAAADAFBFAGEBHAGHCFHAGEBODHBhABALCCF..hAAAfBBG.YACANEAA.aGGChAEA......hAFA...,1,-21,-24,3
PTgRfaGdMZFcIYQVLEBKeAbXUHOSWNCJD,XBDDUCAAOFBG..SEGACAHF.DGEHTGEAREACaAHHGAAAhAAAZCDAFEGE.IHGGhACAVADC..EHGCBEEDhADAAAABHGAENAGE.........hAEA......hAFA...,2,-23,-17,6
LAcYERPOeTZSGKWVbFaMXdIgCDHfBUJNQ,EGGDOFHHZCCBGBGCKBHB....bCDDFBAA.aDADdCBC.CAACHAEDhACAUGABJAEGLHAChADAAGFDRCED.TGED.SEGFhAEAMFIF........hAGA......hAHA...,2,-19,-18,1
VdSfgRQaNUcbWOIZDBFeMCYGJAEXKPTLH,XDEHKADFLGCGHGBGdDGG..SADDRAAFQDDEUEGC.hAAA..cAFEbAFGOCCBhACADCAHBFAAFGAHCEABYABHhAAAAEIH.EDDHTGGDfCGH.hAEAaEBFNICH.IHHChAEA...,2,-19,-3,16
gCZKXFPTdcAJVHMGfIYUDERNSbBaeOWLQ,HBFGMAAGGCCF..YBCEDFFGEAHFRFCBSDDD.hAEABHFEaGGDOBBAhAFALEABCGAGKAFBXEGBhAAAFCHD.dAGFAFEB.fGDA.IBAEhABA.NECA....hAHA...,1,-4,-24,20
FRUTBQgPMKVHJYGLfXcDbOaISWAENeCdZ,EDCGeHFEdAAFZAGH.FACHRBFBUFGEBDDH...QFABMFAD.KBDEhADAJCFDLHAG.hAAA.XGBBDBBBOFDEhAEAaBADSEHBACHCCHEE.TAEF.hAFA......hAGA...,1,-20,-27,7
ceSRIKOfNbEXYQAZDUMgHdBJVWGFaCLPT,DFCFMFGDdDDGBHDF..VBAEFCGFLBBF..TGFFhAAASGAGRBFEKEEEOHAChABAbADB..EFBEXGDBhACAAEFEZCCF..gAFCWEAF.CAAF.eADAhADANBIC...YDHBhAEA.,2,-28,-17,11
ZNWPCSMKUXFTELJQGbROafeBdgcVDHIYA,ZAAC..NDBH.CGDCKCFBUFBG..FBHHEBGHLFBBGFEH..OEAHhAAAeDAEBBEGdBADVADGhABADGFB..HEFGAHEE.SAGChABAMEFA.XGGC.QDDChACAaHFE.fFAEhADA,1,-18,-25,7
aYVQPdJGbfKSCDcOLHZUXeIgEARMNFBTW,MDCBFGABBHCG..TBGDaDDE..QABFJAEHGFEHKFHFDIEChAAALGDGZBAC.eCEEhAAAgGABRCAG.hACANEDB...WEDA.PAEGfDAEhABACEBG.OAFG.XGDGhACA,1,-7,-29,22
edLJEQgHSKOGfRWFPUZCcMIVBNTaYAXbD,XDDDDGFBLEDB.EACCQFGD.SGBEhAAAGDFAfHGFFAHBUCADcGDEhABAMIBAIAGAhAAABBEB.NCDF.TCFBADFBdCAFHFAGKABAWFADCABCaBHDhAFA......hAIA...,1,-7,-8,1
dVUeKNDSPGCTaBYQXZMHFREIOLfbAJWgc,JECD..gCEAdFHAUCAF.KAAA.DBDGGAFC..CFCDaHDChAAABGFG.QABHhAAAMBHFRGFCEECEOFADLEABhACAAFFC...WCCCeBEDSEGAhADA..YHDAhABA...,2,-34,-14,20
YSfLGdUMRgcVKeNWIJPaAbFHCDXEZBTQO,FCCHDFIBEGAFBABB..OACESDHF.LDFFUCEAMEDHhAAARAEA...VCAAKHAGNEIChAAAJFFH..AAHGCDAH.ZFAChADATAGA.fEGF..gGEGhAEA..hAFA...,2,-33,-27,6
JZAETNKSbOBCHYaWMcgeGUXLFfdQRDPIV,TGEFSFBH.BGEEHBCF.aCHDMFFGeBBFUAGFFCFCdGAFDDEG.hAAA..IEEAhAAAZABHAEFCKGHFCHAH....cAEBhABAXADF.fHDDQGGG.hAHA......hBAA...,1,-1,-43,42
UOZePfcgDSMTaVGHFdBWIRYXCLNAKbEJQ,EFDHJFAB.UBCEZFCH...eAAH..fCCBDAFCMEAF..aHFAhAAAHGFC.BFEBIGBEhACARAEBCCBDAGEF..QCGEhAAAOBFF..cEEF.SEHFhADA....hAEA...,2,-33,-31,2
FeSVPGYLbBICaJTNEWQHRdZOKUgDcXfAM,FFEEVADBGEAH.LCBCBDAAaEEBJHDA..ECGFHAEEZBBFKDHHhAAADBAF....fDEHhAAAAGCESHAEPCHDhABAbGFE...CGHFTGACQAGH.dFFDhABA...OFAGhACA...,1,-10,-16,6
gGWZBEefYSTOaQNbVdAMLRPJDXCIUFKHc,RCCFJCAEDGFC..CEGF.UFCFHFFGGBEDBGBE...EAABeEAE.SAGDhAAAaGAD.QGDHhABAbACG.dDDFhACAAHFCMAEGXACAKDAD...WFADfDHEhABAOBHD.NIDD...hADA...,2,-24,-13,11
PKQAcBfOTEZLVgJYRFHMDNbXdWSCGeUIa,BCBGTBDEZCCH.LBFEJFGF.FFGCMBIF.DFAD..XEAChAAASHDCGGDDhABAUBABaACEKFBG.ABFCODDEhAAAECGG....gGAH.hABA......hACA...,1,-21,-38,17
KcfCeDPEHWUdSJZXVNaOTAYgRbFGBIQML,RAFEGCCFQDEGKGACCEAG.DIFCHGEE.UABHSCGAZDFG.VCADhAAAOHAE.ACAB.gEGAhABABEBBMAHHfGCChACA.eACA.WCCH..hADA......hAHA...,1,-20,-26,6
bcAHZXLaBRdVTCeFEYgQUONPfSIWJMKDG,ZADALDCEBEGFdAABTEFAFGGH...EBGHQCDHUFCH..hAEANBAG.SGDFhAFA.JAHHMDID.KGABhAAADFCD..bBBCAFHAXGADaHDECHHC.YBBFhAGA....hAIA...,2,-37,-14,23
QANTJIREePSbcZaHWOKfVGYdCMgFDLUBX,JFCCEGFA..eDAC..SABGZEAGaBBGHEEAKAFG.GCEDdDCHCHHG.hAAAMCCCDDHD.BAHCAFID.hACATGACREAD...hADA.bGDAWACE.OHCCfBDA.hAAA......hABA...,2,-38,-3,35
RIDEeGBbAUCWfgKHOVMJFcLPXSNQZYadT,CBHA..fFEEHDAGMEEBFBEELBBA.SHGChAAANIDDZABGdGAGRCCGDGGAGDGCADGBUGAAhABAKHBCJAFG..cDAFhAAAXDGH....YAFCIACEhAEA.BGCA.WFEHhAFA...,2,-22,-7,15
QEGbSHLWPDeBUIaNJXgCdZRMTFYOKfcAV,VAGBQDFG.EBDASFGGLHDCDEAHeFBDUBAH.aGCGhAAAXEDC.dHEBhAAAZFADRBBEFACAKFGBAHIDbBEDPAHFhABABDHH..IHHF...NBAA.hABACDEG......hAFA...,2,-13,-10,3
RWYBfJVCFdLTHMPXDaEeQbGcUAOSgINKZ,SDAE..gFCDKBEAZFFERDCFBEAFfCAH.hAAACEAALCEFTABAHFAHhABAMEGFDIDGECHBeAHDhADAbAACGAEDAFEB.OFHHIHHCNICB..hAEA......hAFA...,2,-21,-2,19
VTZdHMPDbQgIeCNYOWJFEBUGRaSLKcXfA,TFAGZAFGHDEH.MBDFDDFG..QBDGeAAACCHE.OFHFJGAGBHHHhAAAGEEERGDG.aCAEKEAEhABAfBAHAGGA.hAEAdHAD.gAFD.NAAF....hAFA......hAGA...,1,0,-24,24
CRcYUEFXdMaAfSIVBNWGZLgbJKHOeTQPD,SAFCVEDB.BDCHGBEDLDFGJBCDHGFAOEDC.TABBhAAADCBBCAEB..RGAA.UGBDhABAEABCFAGAMCDAAFIF.fHGHhADA.IEAENAAC.gFGChAEAeDEG...hABA...,1,-11,-13,2
BEegFIKAUDbVJWMHSOaQZXRCfYGTcLdNP,DFGGJCFDHADEOHDEZFCA..CGHH.GABALCED.dAAFBGAEECGH.hADAeAHF.FDABKEAFUGGAhAAAVFBHSDHHhABA.aDDDXBBG.YADGhAEA.NAIG.....hAHA...,2,-28,-8,20
agbIeNBfZXTLcCGOVUWRYDFHKdAQJEMPS,JBBBEECA..MAFC..aDGG..ICHCBFBAZGFCLHFChAAACEEGGADDUBED.WCAEhABADAAAFGAHHDAD.KFGAAFDFQEGEhADAPFDFSHBGeHCG.fABFhAEA...hAEA...,2,-34,-1,33
PaQbACKEIfUWGSXJTVegZNRMODLBHYcdF,EACGUDEDGDEA..XFDETGBAeEAGZFBDRCAB.DAAFBGHDHBBHhABAdAFEaDGFAAHC..CABG.IHHBhAEA.fAFHhAFASEHB.JACCNAIC.OHFC..hAAA......hBAA...,1,5,-33,38
QGEHReYOIXAVPNbCKJFWTUfcBLMdZgDaS,VAEH..NABHKBEEFAAD..UDBABFGGLEFDMECG..dGCGDGIFhAAAQBCCGGADEEGFhACAeAHD...OHDGhAAAAADACAGE.TCFDcBGE..aGAB..hAGASEDB.hAIA...,1,-20,-29,9
JUIRDQOMdZBPaWGXcATFVNgbYeSHKELCf,TADHVBDA......NDAC.bFCHeABCSAAGHEEEKBGECBGEUCGHhABADHEE..MCIHhAAABCEA.PCACGDBGhABAAIHCgFFCEHGA.fGAAhACAIDGF..OHACdFAFaFEBhADA...,2,-15,-3,12
RIFEDJdgZYaXLcCWUMGVTbNeAPBHSOKQf,HBFGSEGEKABHQFDBRAFF.FEACEDEBDGAHdAAG.ZFBFaGBCXGFDhACALADDCBDBMCDFhADATGGB..NEAC.eEFEhAAAAGFH.BBAD..OFDF.fCBAhAEA...hABA...,2,-18,-12,6
NgRBTKVPAbGDafcHeMWdECSYXZUOILFQJ,GDDADFDD.aFBBHADH.eBGHMIFAdFGDCAED.SDAHZCGHUBBBODAEhAAAFAACQDDFhACAJGFE...NCCGBHAEhADAKABEAAHF...fHFHcGBD...hAFA......hAGA...,2,-22,-16,6
cSGgOMLAZCFbUQVNadBWDfXREHTYeKJIP,FGAFQBEH.aFADdCDG.BFFADGHFREFFEGCGHABBeADA.KCHBIDHGhAAA.SFDFhABAgDABMEAChADAAEFDCBBH........bEGHNICBfAGGhAEA..YAAEhAEA,2,-36,-26,10
bSNIHfDGXEQZUTRaMOKVcJCWgAFPBeYLd,BAHHLDFEdCGG.SGGDHACHDECFEEFBUACH.RFCD...OGBEhAAAVDAE.CEAF.ADDEFAADeABDhACA......hAEAYEGHIHGDfBGF.XGAHhAAA...hAFA...,2,-39,-17,22
FZgJTNGBWULOADabYKIfCReSQVEPXMcdH,aFFBKCFECHAG..eBAD.QAFD.EHGEXGFB.hAAAMEIFcDEBdBACZAEGhAAATBBAGDCGBHDC.hABALFABAEGEDAEAYBCDfECE.SAHBhABA..hACA...,1,-18,-33,15
NOgTUadMZSYPDeFVEXBWcKJfRGCIQAbHL,LCDBOBFCUECFdEAHMBBHZGAA...SGCHDBDAFCBB.EEGEhAAABFFDKFFA.RGFC.IAGDhABAAFID...NAIC.hACAaAAC.eDDEXADA....WAFEhABAfCCGCEAD.hACA...,1,-19,-38,19
FIZSDMEOHLNcJTbfPWYVaABGdXKeQgURC,dAAGXABEKHAG..eGCGQGAFUBFD.CFABZBECMDIHHDEDLEGDhACAJHFG..fGDChAAA.PCAChABAYDADAAEABFHGgEBC.ICCGhADADCIB.EEED..hAEA...,2,-35,-6,29
ETNeILMcZCQDJgOBXPKSFARGYbVWHfUad,RAGHGFBH..bADCVBAC.HAFAUFCAdEHCEABHeCEB.IEBFhAAAMGFCCDDB..DDIDOHAChABABHHCKGAFAEABfGGEhACAaHEE..NBAG..ZCEF....hAAA......hABA...,2,-22,-3,19
SCXQedURZWGfPNBLcHEIbAYVTKJDOMFga,TECCJBBF..DDIHFCDC..aFFDSFHB.QBAEhAAAeGCAUCFFZAGBGEAAhAAAfFFEBAFHHECAhABAIGBHAACBKHGAMADCCAHCdADG..WHEA.hAFANEEBEBEG....hABA...,2,-20,-17,3
dNfOZSDTePMLHEbBGWVIXFCAQUJgYKRca,UGEHJDED.KCFAREAE..dAGBODHDZAAH..DGDHeCBH.LAADhACAEBHB.BEEFGGEFhACAVGACFADD.ADDG...hADAgBCBaFGA.fAFB.hAFA......hBAA...,1,-24,-30,6
bYFCOKfUWgaZAMSHLDTVcJePEQXRBdING,SEECDHEA..VDFEeBCCEAAHQFFARAEH.BBAAhAAANBDC.bGAGFEAE.KHCAfDAEhABA.WDDChACAaGACAHHDHBGHLFFGcFCAXBGAhAAA...ICBGhACACFHH..,1,-17,-20,3
cDEGHIMBUQPJSWZCFNRVdXbOeafTYKLAg,DCEAEHAGHCCFMFEBBFGGUBGA..QBAF.SEGHhAAAZFADFDAANDFC.dFEE.OFAChABAeACG.fADDhACAKGHBADGD....gAABIHHF.PAHBhAEACCFF....hAFA...,2,-44,2,46
WHUKCGZDLQgFcIaNVMTYBROdSEebfXPJA,HBEGUEBAKCAACEEBDGEBLAHB..FCCD.aBHDVEFD..MCBFhAAABDFFRGAG.OHBEhAAAEABE.eAEH.XACChABAAIFCZEFD..........hADA......hAEA...,1,-30,-32,2
BNbfKICacdZVJFPeTHUMgSYQXGDEAWROL,ODFBBCAC....fGDHKGBFCBEDdABFZGDAJCED...FDDBTGAHhAAAUAGA...gABGhACASCCFQCGBhADADEIH.AFHAWHCANEAC..IHHHhAAAcEAFPAFAhAEA.MDDF.,2,-37,-18,19
ICgDAPSWUcOeTXdafREZHbVQYKMLGBJFN,SBAEUDCHeBGBdADBRDFAHDBB..VGACKBEFMADE.BCHEhAAAFABBCFDDAHHF....PFDFhABAOFFE.aAGAEHBEhACAQBDH....LFFAhAHANAAEDIEE.WBDD..hAIA...,1,-19,-20,1
LDUMTFfAVBJgKRZdCINcQPXHbeOSWaGYE,JFFDKGGBdEBC..CDCA...IDDEQBFDHBAAeCHH.SADFhAAAaAEBEDHHDEGDMEBDhABAFGDHAIAGBFEF.ZFBBhACAPAGFOAFA......WAAChAGA.YFEH.hBAA...,2,-30,-23,7
daDIeFbXRHYLMQTJCcKVZGgBPSOAEWNfU,EFDB..fAEBaAEADBHD.eBDHFGGDRCEBLCCD.QGCAhAAACBABKCAFGCBCPEHBhABAAFGG.NBBE.dHADICGGhACA.XFEFMDIH.cAGF.hAAA......hABA...,2,-31,1,32
bEMZSFIDXfQgKCPVLGWcTYdBOHNAaReJU,eGAAUEDDMAGBFEGBDCEG..QACGKBBG.CAAH.LEAEhAAAGEAG.TGDEdEGHBGGFhAAAOABAAIGGaHDGRAGBEHGCIAHDhAEA..fEEG...hAFA......hBCA...,1,-22,-25,3
YEVNZcRPAUKTafXHbdBeFLQDMgGWSJCIO,KGBGaBGEHEBGdAFEFBDBDIGC.GADC..SAAFCEGA.OEAEhACAEHBCZABH.RGEAAHADTDGFhADAXDACBBBGeAADhADAQGGF.MFFB.JAHHIAGDhAFANEEG....hAIA...,2,-23,-10,13
fCdKYJZaDOXVcUgGEIBPWHATRLFSebNQM,TAAAFFGGeAFC..QFFFCCAF.dBDFKDEBZEAHDCDGOFDDhAAA.XCFHVFADUBBChAAAEAHFBHHFHGEEADIBSHAGhACAMABA.JCCHaEDH.....hADA......hAEA...,1,-9,-25,16
bfCUPRYcJaIdMWANTXVEeOgLQBSDHFGKZ,XDFCeFCCLCDABEBEHFGFKEACZGBACBCE.UGGGRFCD...JAABaCABhAAA.MBIHADID..TAGDhAAAEGABQAFAhABA.DGFFFBDAfCDF..YEEChACA...hACA...,1,-19,-22,3
BOeUdbTNRgQEPDWScaZIVFCHfKXJAMYGL,GACELDDBOAFCeBFEdDBE..NEHA.RGFEQADADFFB.hAAASDFCaCBHZFDFIHCAhABAFBABCHEDHGAGfFAChACA.KCFFAFFAMAAABHAA....hAGA......hAHA...,2,-20,-10,10
PTNAYIdegUGKQZFOBaVRfCMXWJEbSDLcH,dCDBeCFFUFGFKFBBFHGABGDF..RBAD.CHBD...MICE..JAFGEAEChAAADABFLDDH.hAAAHAGDTDBCAFGGgABBhADA..ZFEHODHFaACEXCGHhACAWEAD.SDAFhADA..,2,-37,-17,20
WFUNeKVYaJDPcLAgTGMbIZQOEBSCfRHXd,GGEDMEFGZACFQCFGBEEG.CEBHHCCCdHGDFGBCeADGKBBB.aGADDEAChAAALFFC.AIEEbBAFhAAAEAFB..SFGGhABA..fAGBWAHF.NCAG..hAEA......hAGA...,1,9,-43,52
cHAagDZLPUdVBGOIeNJFTXWRMfbYESQCK,aCGBDGACLFCB.UADFBHEBGBAAeFBFFDEH..TEFGhAAAXGGG.MDAEhAAAfDDHEBCG.CHHHKAHHhABAAAEFZAFCdEHEIDHBWFED.RFCFSABDhACA....hADA...,2,-23,-18,5
dSDTfAGRcLaBFZQKYIHbMPJgOeUVEXNWC,RCDAaGCABFBCZEFC.KBBCHAGD..MGCAJAEB..OCAHeHAAEAEG.hAAA.XGAC.hAAACBCAdHGDSGHDhABADIDGABBD.cAGD.FCAC.IHEC.hABAbFFB.....hACA...,1,-22,-27,5
EbFRQHLXacZgJKCdPTNUDVBSGWIAOYefM,eEEGMDDFFCGDHAEBLBDGaACHZDAG..KGGGCGGE.dGBC...TAGHhAAADIEESDAHhAAA.IHBBADBCfGDAhABA.ECHFbEFG.XABF.cAGFhAEA....hAFA...,1,-7,-43,36
HDFbICQfAcMaXdgKYZURJVLNWeOTPGEBS,aHEAXABC.dEGEKGGCZCEHUAFH.RABGLEEEeEDDOAGBGDAAhAAABEBCHECBDIECFCCChAAACCEDACIH.MFAD.JFBDNIBH.hABA....WDHB.....EADEhACA.IHHG.hADA...,2,-19,-12,7
bfCISOXHMYcUPgZEAJeLQVTGFBNadWKDR,LDEFTACB.FBDEBFDHdFFEDIEERFEF..CAHG.ODAGHCGDMECFhAAAUAAA.ZBED.AGIBJBABeGAEhADA.QDGAhAEA..NIADKFADIAHCSDDF..hABA......hACA...,2,-23,-20,3
XBIaDZGbUNYgQdcRSPLVKJMeHCEATWOFf,TDDAFDBHBACF.DBHHGDBC.UEGC..NAIA.QGDGhAAA.dADCSAAHhAAAVAFEKBABJFAFMHEACHHDAFFFhABAfCCB.aFEE.ZAFD.bFCD.hACA....YEAFhAEA.,1,-3,-50,47
KWJHIXaRMUNCPgEBSAQZceLFTVYGfDbOd,QBAAeDDBFGAE...TGCCGBAEDDECdDFEKFGEJDHBHAGBaHBE.hAAAUGGD.CFBD.PAGFhABAEDCHABEALFEHhAAA.fGAGOCCAIHHBMABC.BACDhADA.SAEChAIA..,1,-11,-13,2
LOTeUYbXRPVEMIWBdQaSCKNAJGFZcDfHg,GDACFCCADGGBHFCHLGCA.TEFGUBAG..XCEHRACGEDEHMDIHhAAABBHAdHGB.QBAHhABAaFHDKGAA.NAEFADDDZAFHhAAA...fEAD...eACGhABA.....hACA...,1,-4,-15,11
BCZfXgQAPOFMIHeWTacKGJRVUNYDSbLEd,FFACHEEGeEEFaBHHGDBGRDGD.UBEEDDEELACCBHAFZAAE..XGCHhAAAAIEAMEBE..TGFEhAAAJCAB..YFHBhABAEHBCCBAE..fBHE...hACA......hAEA...,2,-25,-12,13
YbKBPTMCcZOUDgFHEXafWReASJGIVLdNQ,SBBFGGEBLECBdDFB.QAEAKDDFBHBHMCFEZAAFDCADFFGDhAAAEAHD.aEGARADHAFIBIFEHhACA..YGBChABATEAACDDE....OAFA.gDAAhACA.XGEDhADA,2,-21,-18,3
cVLEBCKRQYGUOPXSIJHaMNTeAFdDbgWfZ,FAAAdDFHDCBH....bBDB..fADAVGFG.LFAGhAAACBFAKFAD.RGCAQGGGhABAGDCAOHCESEEGhACAJCHDMAEGNBIGACCF.gAEH..hADA......hAHA...,2,-23,-20,3
JfETWUeBZCMROFgcbLSdGDAIXaVKQNPHY,aGAHKFDBQFAFHEFE..JFAAEBBETDDAeCABZAEB.CECERFFGFAAFhACA...bGBESCHHhAAADCEEAIGG.IHFChABANADF..fCBHBHAG.MBEEhAIA.ODFA..hBCA...,2,-18,-17,1
PfAWVDebYIEUNSCHXLBdgOJcKMGQTZFRa,DDEGeAHH...IFCAUGADCGHEHAAC.BBEAOFEBKDCA.MBAChAAA.TCDCFDAGaEFEhAAAfGAB.hABAAAFCVGFCbGEC.EBFANBIC.XCAA..hABAgAFB.hACA...,2,-31,-20,11
eIbYBHRLMCUdNDGAVfWTFXZQgEJcaPSOK,VCBHTDBC..FACFQBFA.EFAFJEED.aAAHSBAAhAAAKFBF.eFDEIHGFhABAbBDFBGHH.LHCGhABAMDGDCFHCUAEBDADAAGEF..fDHAhACA..WHCA.hAGA...,2,-35,-8,27
HcNXZATVSJQFKgRfBCOWaUdbPeMYEGILD,SGEDFBEFKEDG.RCCEBHBACDHF..aHFCdHGD.eEBG.EBAEICAEhAAAHACC..NCAAZFFGhAAAAAEG..TGAAhABAQBFE.OAHDWEGD..UGCE.hABAbBBD.MAGD..hACA...,1,3,-44,47
VNEfRCLeFQOIagbZXYMPHcWKBAUTdDJSG,dBCDSBGDGBECEGEGCAHF.LEAEFEBA.ODGDaCBAZFFDMADGhAAA..HGAAKBHBBHADhABAAEFADICAJADG..VGBEhACAfEEG.eFHHIHHGXAAChABAcAGBWDAF..hACA...,1,-7,-25,18
eUMWHNbQIZVYcBPCgdaTKXAEGfJDLORSF,EEFGGEAHDAAG.RBACFHFAUCCDHGBG..QBFCZBEF..cEGEhAAABADDCAHG.dFCDKBGGhABAADHDLFAHSGAFhACAMFFHNAEF..IDDC..YEHBhAEA.aBBB..hAFA...,2,-34,-4,30
JCaLWcZMTRVXNebSGBdQUgAEIFOKfYDHP,EGGGFCCCOFEGKFAD..DCECHADA.CDGDLGAEZACHMFFARAAB..hAAAXBFAeHEGSGDFhAEAdBAEUGGBAACFIBHFhAFA..fHAHJDEGaEBG.WAFEhAAA..cGAD.hABA...,1,-16,-27,11
cQJXOgPAGaVeIHSFEMfTWZNDCKRBbdYLU,aEFGeAEDHACCFFGD.MFIF..TEEHZFAHCABCBDAAdGAALCADhAAA.UGCBJCCHXGFChAAAOBBDAABG..IDDAhADASAGEEDGG..fAHAWCFE.hADADFIFKGDB....hAFA...,2,-27,-7,20
dRNYSbFHZMUTOGefIAJCcWVKgQEXaPDLB,CGBCVEACKDHH...QBAHECFF..aHFCLEFDBADFdEDGNAHC.hAAA...SAEHhABAHAGDUCAH.OFFChAAAfFDCAHHE..WFADPEHD.DBIFhACA.YBDF.hABA..FGAH,2,-38,-6,32
adbNVFILRQUZCPSMEYATegcOGfKJXHDWB,TECAeEGDOAGB.KFBAJAGB.DFHFaHEAdCEG....bABHFGAAhAAA.LABARADD.hAAAUGEBCHCEMFAFAHDF..hABAgCAGfEEA.WBHHNBIC...hACA......hADA...,2,-29,-18,11
XePBJVKbZCSEfdWgHUDRLQOcNITYFaGAM,eBAEJEAA.KDGGCAAE...EFBGdCGFHFECRFDB.LAED.ODAChAAA..IDDChACATAFCFHCEACDAXADEhADABHHE.ZFFAfHAHUGAADIFE....hABA......hACA...,1,-15,-36,21
FKGYbBOHcWQJUVSLNfXIeMdPTAgRCDZEa,RAAHCAEFDCEBEHEG...KGDBGEED.BCHAOABFHAEB.QGBChAAAJAGB.SAHFhACALAAD.NADEIHHChAEAMFDGdFBAAGAAaEBCFGGD.......hAGA......hBAA...,1,-5,-49,44
gDJTAWQXacUEVeSGbBOFYPHINKLfZCdRM,QEDDaFBD.EDBBeECGGCDHOACBFEGCHADAKAHDZEGDCBBGdGHChAAAMGDEDAGA..ADAEXBEChAAAUGCDSBGAhABABFAEIHDFNCAC.fAED.hACA......hADA...,1,0,-24,24
cMaObIDKSLCREVgYJWGXZNQTUBHdefFAP,MFIHaGAA..OCAADDCFKDDELGFE.ECFHVDFC.JAAEXECAhAAA.ZAEGQAGChAAABDHHHDAAeFADhAEAAADEPHCEIBEACABA...gGBBhAFA.YFFFhAIA..,2,-21,-16,5
BOfReXJAgYQMaZPbHCNWUVIdGFETKLDSc,QGCBaABBZDDE.HBEECCFC.UGFCdFAAEDBBKAABDDCB.BEFBRGFCeADHhAAAAAFE..MDBF.hADA.NCIA.IADFhAAA.FDDDSHCGOBHDfAGHhACA..gEFAhAFA.YAGH,2,-23,-19,4
BTcNISORUYFgJPdCfbDLAWeQEGHaVXMZK,eGEGQBBFECCBGGAFHCGHaAGG.MEIBKAECBBAH.TCFHhAAAIDAGREEE.FFEDJADFhABACECEDICAAGIH..XAGAhACANAADSFBH.....OAFHhBAA...gGFHhBCA,2,-24,-6,18
CXVRfHEBbUNJWPYFgTGdQMOLKADIceaSZ,DGHDeFDDZDCACHBC.RFAG.HBGBBAAAUDAE...JEEA..PAEBhAAAFAAFGACHdGEA.MFIHhACAKHAGAGIB...aAFFSGGDhADA.fCEFECAFNAHG..hAFA..YACHhAIA...,2,-40,-12,28
JEdSFTNBYLCVcHegbGKPQfaZUOMXWRDIA,JAEBdGECFCCFBHGHLEAB..CDBEHFDFeADGGCEBKBAG.QECBhAAAaAGE.OHFGhABAMEEEREAEAIBAEAGESFFGhAAA.TGAF..YFFChACA..cABFhADA...,2,-42,-5,37
URBWTYNQHXcJIgFdCEfZLbPVMAGKaOeDS,KFDGeACDDIAEUCGCBAEB....TGFHQBGFHADGJFDFFGAG.hAAAECEDLBBF.hAAA..VDEGAGAEaBBHSHFEhABAWEEG.NDIG.IEAD.CHAA.hABAZCCD..MFIH.hACA...,2,-30,-8,22
ZHOdPCgeUFAMWXEcQYIbVGaRfSJTNKDBL,XGEDQEGH...IAFEVDBFRADB.SHCA.hAAAJBBBKBBDLDDChAAAZEFHODHDCGCBeDADAGDBEAGDcACAhABA..YFAFaEEDfHGDhAEADCAFBEEGPAHD.FHAGhAHA...,2,-20,-10,10
PbIAKZNGYfOTFEUVMLXBdQcSeRCDgJHaW,ZCEAGEEEOHFAECFCMCDFBCAH..dHBDQGBA.eEHBhAAADAFDHEBAaAGE.PABChAAAACCDKDAA..NABHfHGBhAGAFBGCUEEA.LBBESGAF.CEHH.hABA......hAEA...,2,-26,4,30
PaEDVLYIHeKFRJWcAUGXbCTNgZBQdSfOM,XCEHTGBC.ZFBHdACG.OFFBMFFFEAGDLEDC.HAEHhAAAKHGAJBDBAGHGGBAE.hAAACHDHBGAFSBBDhABAaDGFDBIBYDGB.IGDG.eFADhACA.....hABA...,1,-14,-15,1
NRgCYAESBTbfHGMIQWKZdPcVFJaULDXeO,EAHFTBCBHCEB.GBBEMFAC.QGDHZFBGdAHA.VFAFFHGEaCAHhAAADGGEOBABRCEC.CEDGAIHGhAAABFHC.fFFGhABAIAFBKDGCPHBC...cCBChACA......hADA...,1,2,-15,17
CQMAcadNbgReTSOFWPVEJYHXfIDLKUGZB,dDAB..NEAE.RFBASDEDFDBB..PCFAEFHHHBFD.XGFHhAAADEGGLABGhAAAUABEBDHGCFHBADDA..aFEFhACAeEAFOECD....WHBAYHBAhADA.KGGH...hAEA...,1,-19,-26,7
DEdeUbVYLTgFXKGAOMZBNWHCcIJSRfPaQ,MDGDBFBGHABB.CHDB.JEAGRAED...aDHBQEGBDAEA.dDDAhAAAeBDE.UGBCbAGFLEAFhABATCDFFAAHKFEGhADAABHAZFEH...NEIA.IHHA..hAEA..fCBFhABA..,2,-21,-19,2
dMDKIOYBJQZCUeaPESTGFAbRVWHfgNcLX,RBFBVEBEHEBG.....fGHANBEH.LDBCMDHBIBBHhAAAOHACBBBEhAAAQGAGCBAGaAHBSEADhABAGEECADBEbACFcGFBDBAHKGHBJADG.eCHHhACA.EFEAFHCE...hADA...,1,-3,-7,4
JTaVeXOFEDKAcRBSUNQCIYdGHMfbWZLgP,RAGFUCGHCBCG.dAGBHAED.MEAD..fHBDZFFCLECHJBBF.hAAAaBAH..eGFCOHEGhAAADFBGKFADADIDBCDHSADBhABAIEGAGEDG...WAEHhACA......hBAA...,1,-17,-32,15
DgaRIYNOWPcFBZHMVJdQXUSKCTGEefALb,DCCEaDFC.REFH.....IFCHODAC....PFCHBCCEHFGDhAAAMDDC.VCABdBHGQAAChACAUAGGSACEhABACBFFEGAH.eHDAAIGELFEDbGBC.YADEhAHA..WDEDhAFAFFHD...,1,-7,-22,15
EYCUJQDVcSIKPeOfMNBFbdGaLZAXgWHRT,XECDHDBCRAEHEHBAUFGEDFEF....SBBHKHEGeBEBOFAFhAAAMAIHBFFHFCHFGABGhABAaACAAIHE...TAFFhADACDGCJAAB...cEEHfHFF.dAGEhAAA......hBDA...,1,-12,-20,8
OKPMYbADXRTGVfFEUISQBWeJgaLcNdHZC,RGDGVCBFFDFA..UDBCQGGD.BADBJAEGLEFGdHADHBGBCABAhAAA.KFDFMDAD.AAIB.hAAADGAC.XAEDhABA.TEEHfHBB.IHHFhABA.SCCEhACA.eABA.,2,-28,-12,16
aAZOQECgIXPKVBeWTJcMbNULHGfdRYDSF,QDBDCEHC..gBGGIHCGKCGDBDCE..TAEDhAAAJGEAMAECUEFHLCAHhAAAfACERABADGIBFGADhABAaHBGAEEBEGHH.XAGFeEDC....hADA......hAEA...,1,-19,-26,7
XRWDGbALOJTEfYZcgaBCISUeVHPMFNQKd,LHAGOFDF.EFFAZCFF.aCCBCAGH..SACCeACAHFBBMEDChAAAQGGC.dAGDhAAAWCEADDABADEH.fBAEhABAcECH.BHADIFAF.VBABhABANDFE.KHEC.XAEHhAGA..,2,-14,-14,0
EBbYCXHJcaUALOFWRIeQDVTKMfPdZgGSN,OHDGFEEERCAB..eGDEVBAH..KCGHMCECdABFGAEF..hAAAEEFFBHHGCHACHFBHaFAHLCCHhAEAIAGEDABAhAAA.TDDCPEHFSDFE.NDIAXGGHhAEA..hAFA...,2,-20,-16,4
ePYWJOgIKQAdbXFGMfVRNEUaTHBCScLZD,dHEBXDDGMDHHRBAEUBCD..HEBBBAHCSEEDLCFGDGAEhAAAeBFG...WAEChAAAOBAH.IFFBhABAAHBF.bGAEfDFEEHFGaGEH.CHHFPDAHhABAgAFD.KEAA.hACA...,2,-22,-11,11
QOcEHRfDXGKgNSeVIaCUPMBFYZJWATbdL,dFHEOFCCECACHDCARBCG.DHCAKHDE..SABCeDAA.aGADCEEBMCIFhAAABCFB.FABGJAHFAHGGLAGDhAEA.QFAAhAFAcGEDfDGA.gAEChAAA.IEAFhAEA.,2,-35,-22,13
RJGZdHLOUCBKQWXAcDFaSPIVYNTbgEMfe,DGCAFEBF..aDDHSFGF..IGDHVCDG..NBAF.TADEhAAA..ECABfAGFhABAJAFGdCHGLFAFhAAACHFHBABHKGGEXGEHAEIBcGAC..YCCFhABA..MEEGhADA..,1,-29,-30,1
cCfMeWNSdTRgbDEJFHPXKZLAOIUQYGaVB,OBFBUBACQAEHGDDEBCCH.CDAF.fFEG.eCFDhAAASDGAdHAHREACDAGEhABAFHACHCGDKFAGABBCIGGChACAaHFEMABC....NIEFgCCBhADAJAFA....XFGEhAAA,2,-27,-7,20
WCRVMeANaGYDPQbLZBOKfdUXSEgFTcJIH,aFFAGEDD.DCBHQDCDLDECBGCFOBEFKABAdAAE.UCGAhACASCCCEGBG.FFAGhAAAJGDAHAEACDAH.MBABhABAAHAG..NIAH.bGEGfAGH...hADA......hAEA...,2,-18,-18,0
dAeJFVMLRBHNZQDWcUgECbTfYSaIKXOPG,FBGEMBDFBDAEHAFDZDBBDCAH.UEEGCABE.....TEADSFEDhAAAKBACOHDAGDGGhADAACEEeHAELBBGNAAB.hAFA..cGAH.bDEBaHGE.XDGHhAHAPAEG.....hAIA...,2,-31,-4,27
OJHEAXgcGCaZMeBSDYPRIWTUfdbNQKVFL,XGBBGDEGCAGBZFBBBFGG..DBDARACC....TEDCUEGAdBBChAAAQGEDKEAFFGDHLCEEhABAHAGFECAEAIAC.gCEDhAAAMIFA.SFAF.PDHDhABA.IHHDhACA.WDAG,1,4,-30,34
EgWTSbFLJIBfQCMdYZAaeXPNOcDHKUGVR,XFGGOFECDEDEUBCCGABD..VAFDREAH..ECAH..TDEHhAAASDHDLHEAhABAIHHBfCHAhACAMBIHdHAHZEAEADABaCCEPHAE..HAFFhAAAKBBF...WFDD.hADA...,2,-10,-5,5
RgPcBNXFSQHeTMWIVDabUdCGJYEfOALKZ,KGGCRBCG....PDADBDAHFBHB.SFDAeFFCMFEH..hAAA.IBABDBAHaAGBdCDDhAAACHCBGAGA.EADGhABAABBCZFAB..cGAHNEEF...HDDChACAWHFG.....hAFA...,2,-46,-14,32
WYMNZAgcOJeBUfSKIPLdaTDGCXQVFbREH,ODGBJGEABAGFUFCH..KBEBLBDF.aGAHDFAC.CHED.QAEGhAAAFAAH.EFHFhABAHCBEMIDAAEAEeCGHhABAICAB.dBHA........hACA......hADA...,1,-20,-56,36
WQFVJZLCABSfgUeIHdTODbaENYRXKcGMP,BHBGSCEBUDAEHDDDdGGDDDID..aFDHECGH..RAGF..KBCEMFADhAAA.QDAAhABAJFFCCCEB.AFFGeADAOHEChAAANHBF..XEDH.cABB.WCCBhAEAFBAC.....hABA...,2,-32,-9,23
ADYdISGWXQCZNTBPMgVReaKEOJHLUcFfb,DCEFdCDBGDGGQGFDCGEBZBABBHCB.MAGDRDBHKHAC...EACGJBCBhAAA.LFFCFEEGABGD.hAAAIHAG.SDGAhABANAIC.TEAD..PHCChABAeABCaFDF...hAEA...,1,-17,-28,11
GFDQVZJEMPYWUXAeCBITdNLgbSHKaRcfO,CAACTDCAdBCFLCAD..bGAEKFCHaCAERAGB....OGEEhACADAEGQFFGZEEE.hADAEAAGMIBAPBEEUCDHhAEAAHHGBEGE.NAIA.SGAGfACD.hAFA......hAGA...,2,-24,-9,15
QJRgBEbHZXMNcYLGDPeWUdCaTSKFAIOVf,ODBHQGBGRGFABEHDEEBCZCDA..MAEH..NABCLGFChAAADEEFeAFC.UAGFdDGFaBCBhAAASEEF.AADBIEHHhACAfGCA.......hAEA......hAFA...,2,-36,-20,16
CMBWVOZLRHQedTEDbGSgJfIXAUKFPcaNY,FECHaHDA.CAGB.BDEC..OHFGZAGHHACBdBDE.EFEGDGEHGFAF.hAAASAFDJBBD.hABAIEACAFGFKFAH..hAAA.NEIA.MAIDLABFeAFB.TDFF.hACA.bDEE....hADA...,2,-42,3,45
VgHYDfIACTcLObGWQKFBXeMSZJRdUNPaE,TGFHOEEDGDBC.KEHBBFEH.MCAFJBDHdAFBUCDG.aHBAhAAAEHGCHCFDDAAAACBACCBBLABAhACA..QBGFhADAFFBGSAGB.NEIC....hAEA......hAIA...,1,-8,-34,26
ZaEOdWgNSVMbCQRLeYJGAfDPITUKFHcBX,DBGCTFDHKGCFHAAH.BDFHaDAHdCEF....NIED.MAIBCEDE.hAAARGFGeEBHGFDDAHCHPCAGhAAAFADBZFAD..OBEChACASEEE....bCCCLABGhACAYEHHJDHF.IAGGhADA.,2,-14,-14,0
TAFJIMOZUSCYbBLfDHKRdVPGWENQacgXe,FAEGJBCC.MACFZEAF..UGDDCCHE..BDAFLEGDDDEE.HAGFdFGBGDCAhAAAEAAC.QGEDhABAaEDF..XCCChAAAAGCBSAGAYADCKHAG....hAIA......hBIA...,2,-31,-25,6
HXNYgVIeJACETOQFKbWdGDZSPaRLUBcMf,EEEGOBAAFCFF.KHEGdACCZBEA....SHAGaCHDLGEEBHHBhAAAMFDDHAGD.NBBG.VCADhAAA..eEADAGBGCHBEQDEAhABAGECGDBAFPHEE...hACA......hADA...,1,-9,-22,13
FdaKPJZALVIbQcNReYTBHDUSMgCfOGXEW,LABEVCBC.QGCFRCFB.TECEBAHBDFFF.UGAChAAAgBFACGGEGACFEFHBhAAAFBABaFAH..JHCCADBAcBCFhAFA.eFGD.SEEBhAGAfFCB.....hAHA...,1,-12,-30,18
XWSGaHELFYRgbTdBAVIUZcNQKDfCMPJeO,UGBFZFFBQCEGKEFD.CABC.JDCE..ODBF..SFAEhAAAaAGAEBGB.FGGBRACA.hAAA..TACFBHECAHIFhADA.IHBDDCADfAGGMFAFPEDHhAFAeABD....WAHHhACA.LFHH.,2,-33,-10,23
cEGKaQFOTYXMJSCUIeVgBHWNRZLfPdADb,DFDAEDFAGCCCQCFCFGGC...OBBDXEACSGGHhAAA.CAFE.IHCFhAAAeDABBHECHABERFBHfEGFhABAAEHEcBEBaAHBMAIBJBAFgGAFhABAZACH.LFFD.hAEA...,2,-18,9,27
RfDIZFbAUgeMVPdJQKBcOGXYCSHaNTELW,UBFHMFEAdCDEKGGCBDDFGADH...XFGECACCHEED...TBAFhAAAEEBFLEADhAAA.RBBADBABFEAEbGDGAEGG.hABAeDFA..........hABA......hACA...,2,-34,-20,14
SfPZGaJbXLcNHMYFdBEWVCUOQgReIKATD,DDBASBAHZAGHGCEA..aEAFJBBEXFFFLGDG.HEGHhAAAFDCAEHCA..CBAFOECBhABAQACA.gCFFhAAAeEAFAGIFfAEBcFBEMIFG.hACABAGH.WAHH.hADA...,2,-18,-11,7
CXcNDJFYQGgaWfKdTSPZIVeUBLROHEMAb,XBBBDGCHFBACGGDD..aGBDKBFHdAEF.SFBFZEBCeFFGLAHFhAAAOEGDECEEAGAECCDGhABAJEDG...gAGHhAAATADF.ICACBDEH.MEIB.hACAcGFH...hADA...,1,-12,-25,13
bfGJegFcNaOTZUdRXQSDWVHIEKLPACYBM,CGDFMCHHGDEG..JDBCeHBGFAHF...aDCDOFAEUCGFdBBERFDF.hAAA.QGGChABADFAHHADG.EACHKGGFLBFBhACAAFIFBDAG...fBEENAAH...hAGA......hAHA...,2,-20,-18,2
LIYEeGZVHATCaFODcMgJRQNbBKfSUXWdP,TBEFaDGA..DICEMBAARFFG..QDBBBGGFSGDGhAAAUAGGdCCBIHABeEECZFBChAAAAEIHODAEJABC.KEFFhABAfHFBPAFGECHF......hACA......hADA...,2,-28,-12,16
FNMXGSAgVOCQfWEBUTZLHKIRbJaeDPcdY,VBEHODFH..CGHC.QECG.EAAFTEAAHAEGIHDFhAAARAGDaGAC..DDBAdGGAhACAFBBAMADFGEEFSEADhAEAAAAC.WCHH.BCBC...hACA......hADA...,2,-32,-7,25
cfJIPWDgOCKUHaFGAMQdLSTReYBVXNbZE,MDFBQEGAdBACLBCBRDBHBBGC...XAEDZGDEEBEBJAAE.hAAA.IHFHDAIFCGAHHDDBhAAAFAGGGEGC.hAEASEAH.eEDH.YCHHhABA.....hAFA...,1,-5,-28,23
MNLbCWJRBDYXcIdVgGQAEOfUHSTaPKeFZ,ODEAHEBEaCDDKBEGZGBELACB..CGGHJBEABHEFDAGA..XEABhAAAdDGHGAAEAAIFEBHDhABASFFC.hAEA.TGGD.eFECNICFWDADYHAEhAFA.....IBBDhAGA,1,-19,-30,11
IXcPRgJeZaNCFSHdfTELVQDBKbMOAYWGU,GBBCXDCGRDEAeAEEZGCE..CDFF.HFGFdGHG.EHCELAHDDBIBBADDhAAAMCBCAHAG....hAAAWBADIBFF.hABAPEFCaFBESGFDTFAGKACA.OBAHhABA.....hACA...,2,-17,-11,6
aAMHNdFIJLTYKOECfXVGZbSUQWBPDRecg,HEGDFFEHLBFETCEAKBAEOCDB..CFAA..VDBGZEBHSDGEhAAAUAEBBHDBDADBeHFAhABA.aFABACHGMFFF.hACAdHAFIBBH...JFFC.fADFhADA.XGAHhAGA.,1,-18,-26,8
TZODPRXEIeGfCagYNAUKBFJcWQSbdHLVM,UECBKCGHFFFE..JFFBQEBD.dACALBCA.MDIHhAAATCDCOBADRAFAXBAFhAAAEAGH.GGABhABACAEFaDGF...NIDDAAFCBHGASEAFbGAC.hABA......hACA...,2,-34,-9,25
BfVPbQWREJOUYNgLKedZaXMDAIFcHSTGC,FCBGSAFCGECFCGACBBED...VFEBQAFD.RGEEOCAHhAAANBGCKDHB.eCGBhABAZAABMDCCDBBG.AIBAHEAAhAAAPHAEEHCE.JAHB.......hACAgACFdDDFaGGA.hADAIHHF.,1,-3,-10,7
CfDNPIGdbMUcLQEHYaBKSFZAJXeTRVWOg,eCEHVEAC.OAHF..CHAGDDIH..IEABdEDAUBACQABDhAAAHAEFBBHEKGHBFGFHhAAAJDGF.RGBC..fCDChABA.PFFHbACBMEHFEFBC.SHCEhABAAAGC...hADA...,1,-19,-24,5
WbLcRgUTCKZPJXYGMDIeAOfFQHNEBSVda,OBGDQDCGHBDEEBFASEEF.aAGGWHDC.LABChAAARFGBUAAFKFBEZEFEJFADhAFA.XGGBMDAGDEIBhABAABCCFCHBNEAGBGFD........hADA......hAEA...,2,-14,-13,1
LIWTKbFSgdGZARaPXEDefMOCHcUYJVBQN,aCEAEGDGDFGC..eDCCOEBFCEEB..UGEDJACH.BBCBLAHFhAAA..TEAHKEEBSAEHhABAdDHEAHAF..hADAXAAFfDFDcAGFQGGAhAEA.IGACFGBD.hADA...,2,-35,-23,12
LBaHWKcSCOQMNfFJDXTYdUeRgAGEVbPIZ,VCCH..bCGBZBGFaFCEKABH...CFFH.ODBE.QAEBhAAAMFABFFHF.DDAF.YGFGhABAdAECeDBDACDEEDFDhACAIGDABHAHcFABSAAF.NIBF.XBBBhADA...hADA...,2,-35,-5,30
HZXUFOcNbMYRTaQLECgIBJfWGPSVDeKdA,HBEAZECEUADFFEDGOACG..NEIC.MDHFRGEE...QGBFhAAALABFEDGCIEBEhABABEAA.fCCBhAGA.WFFDSGCHDEIDKAHBAHAHXAGEhAAA.cCCE.hAHATGAACHHE,1,-16,-25,9
UFbEfdZORKYVCHcTMPWSGaJIANDgLXQBe,DGHDLBCABADCUDCHFGGFEBGH..dBAEZEBC.ODEFKGEF.CEHD.HFADhAAA.MCIHSGAChAAAGAFA.aDAGACCC.NAIG.hABA..XFFBeHAAfACD.hABA......hACA...,2,-34,-11,23
CeKYLMHVSaUfPcdEWBTFGNIZODbXQARJg,RADHCHEDKABAMACF..HDFD..aBABUGAE..fAHChAAAdDECEAEBBAHGTGEB.GBFEhABAIHGDOFAChADADDIH.QDBFABAF.gGGHhAFA.eCHHLDAGhAAAPHAG..,1,13,-40,53
WeHYSgcZXIaPdbAVfUECBMNJQTLDKORFG,UBFDEAADBCDDMIEC..JECFQFAH.LECCKGHFFFFDeBFChABASCCEZACE.hACAaEGEdGAGAAAF.CCHFDIDCRBAD.hABA.WADCHDEA..YGDAgDAFhADA..cGGF.hAEA...,1,-10,-22,12
SODVHLaWZPefUcCFXdBYGgITMNAJbKQRE,KDDHQEEHRAEB.EFBBDACCLCCFZCGB.eHFAUGEBFAAEBGADhAAAGAED..TBADhABAAFAF..JHCESHAAhAGAODGFaADG.fDDHCECD..hAAA......hAHA...,2,-44,-9,35
ROSXgIJAKHfYQCWLeEDNFUTZGcPbVBMda,HDDGQAABLBBEDEGGFGFATAFC.GEAB..PBEHhABABFHGaHAERFAA.OGDChAAASAEEIHHChABAKHDACAHAWAHHeDACECCGZEFA......hADA......hAHA...,1,2,-23,25
UVfGeAcXJKNYDPQRZWFdLSCEbOBTMgHIa,JEAFKFADDGCE..RCDCFBCBdGFDLEEE..SEHDhAAAEBDABDBH.MCIFHBFCaBAFUAABhABA..GGEBhABAADAGNDIG.QGCA.CFFC.OHACIECChACA.....hADAfADB.,1,-20,-24,4
McEPZRLNUQKFVdfOJgeaBDIXHSGTWYAbC,MBAHEFBFRAEE.LBDB.UFGGFCCAdCHEOHCCJDFH...aEFHBHDChAAA.DFHHHBGFGBAChABATBBHAIAE.CAHBPFAHhAAA...QFCHKACC.fBFChABAeEEDSGHHhAGA.,1,0,-32,32
PGQTaKLcAHIJDeSOFgBCVWYbRNZfEdMXU,HBFADDFEOFHFFDDGCBDB.....VAADbFFH.ZBFC..dHBHXDCEhAAAUAAEQDAGhADA.aEHBLFAChACAAGACJFED.SFFFBAHB.RGAGfADFhADA.MIEE.hAEA...,2,-17,-13,4
MJUHYcIKDgOSEbaWZdQNeTRBLFXCfVPAG,MEDFJEBFHAEE..IBCCDHEE.OBEGECBD..aFEEZEGBdABBhAAAQCAHeDFABEDGhAEALEEFCHAF.fHAFhAAAAIEC.YCGDKDDCSGCHhAGANIDBFFAB.....hABA...,2,-23,-22,1
VAXTMIKdeUZFgLDENfYGWBRCaSOQPJcHb,TGCDMADDKAEB..UBEFZGCELBBBDDBF.EEDB..YBCHhAAABGADaDGH.QGGAhAAAPGFA.HBGDhABAAIEAIAHE.FGAFfEAGRDFCCBAHOADAhABA......hACA...,2,-24,-12,12
bAgcfCNEJMLBTadRZUSKVPGYIWXeFHDOQ,...fBHCCBFDECBHLADBBHFAaAFFdBHCZEGD.KEECGCDEhAAA.ICBEXGDBhAAAFEBCDAFAbACFAIHC.gDGAhABA.JHAETGBE.SABGhACAPFHF....hAIA...,2,-33,-2,31
NIWPdHJRbeGXOCZYFgSEAMVUTQDfcLaKB,VEDAUBFFDBBD.LFFEBACB..IHGGdGEHHEAG.RACF.eBFBhAAAOHAGCCCE.FHGEEEBFhABA.AHDB.MAEE..hAAAfAHCaDGEKEDE.WFHB....hAEA......hAFA...,2,-45,-13,32
IKPbOCUNQXJZWaeBfLEcFSGgVHYRTMAdD,DECHKFCCOEEGUAAG..QEGEZGCE..aDBABBFHEBCCFEAFhAAASDDG.VFDAhADAHAGD.TGGBhABAAFADdHBB.ICEGCAEB.NACDXEGAWAHBfCDBhAGA...hAIA...,2,-31,-19,12
RHWOIfXdKBLaeYZGVEFJMSbTDQUPcNACg,CDGBHDDD.ODGFXAFDBGCCLADBeADAGDAAFBBG.JBACbFFAhAAADFIB..UFBDNICB.hAAAAIDG....WDCGhABAIAHH.fGFDdHFBaAHF...hACA......hAFA...,2,-23,-17,6
eEPbDAVOTdgMScJFUfXHQZYaCBWGNRKLI,TGBBdFBFMEIH..SAFBFABBUBEFHEEDQDGGZACD.CEDFBCDHhAAAGGADKAHDIHGEhAAAeCBHEFHH.DABAAAFD.hAGAgGEA.fAEGaEGD.hAHA......hAIA...,1,-10,-17,7
YNXdPHecfTECSVQLBJMIDKRGaWOAZgUbF,UBFGFEBE..XBEEHDDDeFGH.TBCBCHEGSACC.hAAAQEEABGEAJEAFDIBEhABAKGACGAAGaDGEAACB.hADA.ZEBFYDHFdAHA.fHBFhAAA.ECDB.MAFG.hAEAIHHH.,1,-8,-9,1
JHfTXQaEcIeWSFPBgUbLZGdAYRKODMNVC,KCACOFCAMAFF..VBEACGHB..HDEG..TBBFXEABhAAAQFGDEECF.IHEChAAASHAAFFACBAHEhABAgAGELDAGdADCABBADEEEfHFHhABAaHBC....hACA...,2,-25,-11,14
DELIUScQbFCaPeZHMAXWNgRTfOKdGBVJY,XAFH..WDDFRDEG..OFBDdEAFBHGCJCAA.EGAEUGDHhAAAQCGAFHGA.aBAFhAAAeECGHEFAAAEE.gACDhABAfDAGKBFFGABFDIDCIAHFhAEA.SFEDhAFAcEGD..CAHH,1,-21,-22,1
VGCHPbFAdQOJgLBWYSaDNKcRZITeUfMEX,dBDDJGCCLAFEBAHE..SGABDBCEKECC.ZFFD.eDACMEADhAAAEBAAGBGGHCFGFGCBhAAAQFGBOFHF..hABA.gCDEaEDF..NABH.ICABhACAfGECCGBDACCF...hADA...,1,-8,-28,20
LXaRSMbAGfZWEYTCgdFNDIPUcJBOQVHeK,ZBFFEEGH.CAHB.dBGGFGAADDFF..UGGFBBBC.QEAEHAAGKEEB.LGEAhAAARDAC.MDDDhABAAFDBGADE..YACChAGA.NICH.IHDH...hAHA......hAIA...,2,-31,-31,0
fDeQNBGLHRJOCEgKIZPbMUcTFAaYSWXdV,SFFDXDCEdAAEDCDD..eDFGBEGEHAGFOCEECGBC.EGGGIADGhACAZGAE.MFIFhAFAUBACFFFAAEBE..aFCGYCCEhAGA..WAEG.....hAIA......hBAA...,2,-37,-18,19
AEabTJWYBXLKdUPMIfGgFNZQHOCeRSVDc,EGBAaGGB...JDEBBADCLABCUBAHMCHHGBGC..FAFCQGGChAAAHECH.CFAFeDBAhAFASGEFDBCFABGDTGEFhAGAXCEG.PHAE...IHHGhAAANIAH....hABA...,1,-7,-36,29
CEKLUNWfQSbYPXaMGIBdcVFgHAZRTDJOe,RDCDDGEGeBCGKAEELHCG..UBFC.NIAF.fBABhAAA.QDAChABAbEGBXEAGGDGEBBHHdBGHhACAVFEFFCDAAIAAZAAHODDB.CAHC..SGHHhADAaGAEMACE...hAGA...,2,-15,-6,9
TPWXadRDEQFLSfGINAHYcOCUMVbZegBJK,HFDEOBCEMCIFZDBBBAAAJCDC..KHBA..TGCE..XBAChAAAaGGARDEE.EEBFFCAHhAAASCGH.hACAfAGFIAFDAHAHCHHG.....bAGDhADA.PHFCDDBALEAFhABA.,2,-27,-19,8
bcLdGUfWaAIKgMNDeFOYVTCJRHSZBPEXQ,KCHHMFBHDFDHFACH..OCBH..TFEDCFGC.RBEHZEBFBHHHEBABhAAAQDEF.hABALACHdDGEfAHAhADAaGAHAAAA.NIDFeEHHVAEC....SHEGhAEA..PDDBhAEAcFGD,2,-36,-15,21
GIZXDOcMNfTPeHaLUJRgCSFEYKQBAbVdW,dGDDGEBDZACCDEEFMCHD...TACAeFACaGHBUCCH.RGEGSAGChAAAFBHHKCDA.AHIH.VBAHhAAAXFAC.NIBD.hABAfHAH.LFFHCCAC..hABA......hADA...,2,-27,-7,20
bJKQNCgXdTGOcMZUfaVLBIePYEDWHRAFS,FDACSGDGKEDA.CFBF.dHABGCEDMIEGZCFAUACH...aHCCVABBhAAABBAG..eAFChABAPDAGDGGE...RFFEAAGFhAAAJFAC.........NHEB..hABA......hADA...,1,-28,-30,2
IEYeFOSgZGQWUPHVAbBTafLXRdcKMDNJC,BHAATBCALDGB.dAFGKBHBMDEFJGFECFAE..ECAAFDFASEADhAAAZBAFGEDBQACEhABAUGCC.PDFBhACAAADAaAEE...fGHA.XEBEhAHADCAFIHABOHCEhAIA.WCHB.,1,-6,-24,18
aHgAIMTVKDYGdJPFRZcEXBfQOLUbWeSCN,TEBFKADFDCAEGDDA..PFGDFHFGRAFD.EAACBHBF..fBHAhAAAODHD.bEDHhADAeFAGCCCH..aAEEAIHEMEAEhAAAdEACJDEC.........hABA......hACA...,1,-7,-36,29
eEUAcOVaSJgDCfYNbRWQBLMPTXHdFZGKI,OGCASGFHDIDE.CGCF.....fCFGNDEH.RAAHBDHFhAAAMBACXDCChAAAHGFAdBGDFDCGZEGHKDAFEFAFAEABaACAhABAJHAG..bFAHLEFGTAGD.IADChACAcFEB.....hAFA...,1,-4,-27,23
GdEVSMgTPHIORBKQJfXbeaZCDUNYcAFLW,FEEFGAEEEGGA.MDCH..TCBFHFFCIAHHRAGDBEBG.KCHDQDGFhAAAXABAeAADhABAaADBDGAAUGBD.cDDHhACAWFCH..dAFCgGEGOBAB.fEAAhAEA..hAGA...,2,-14,-6,8
REJFHeGIOWYBcUPADXdCKLQNZVSMgTfba,DEGBdCCGCHEFQBGCZEAH..MAIB..fEAHaHGA.hAAAEBCHFDFAeAAFGEDFhABAIAEHOABEBDDFhAAA.PEHFXAFGKFDBVGAASGCBhACAbFEH......hAEA...,1,-3,-27,24
OSQDBZTaebKHJMEPFXcfdANRLCgGIYUVW,RDBCLCHDCCAB.GEBHUFED.OBCAQCGBBBAAZCDA.aHGEhAAAKABHHGCGEGACFAFAXGAFhABAdHFDAADH...IGGHhACA.WAEE.DDAFeAEB.MIAGhAAA.....hADA...,2,-24,-11,13
ZBIDacHWSMfCYQJdgKROVLEUFAeXPTNbG,eHFAXEGE..TGADGDDEBDGCaBHBHCACSCAF.hAAACFGH.YBFHdGCAKDDBRABChAAALFAFEAFG.AACCNICBhABAbBFGIHHCDEIH.MBBAfEAFhABA.QFEEhACA...,2,-13,3,16
PYbaKceSZTdEOBVFfIJHLQGCRXDUWMNAg,...PEAEbDFHKDBD..eADGZADEEECFOBDBBABEFGAD.JFHFLEEFhAAA.CAHADADAhAHAMEFGAHDD...aHDGSCHHhBAAdAACfEEG.ICGAhACA......hAFA...,2,-29,-28,1
CPUXRWOaBgMEDNfZLYGIQeFKcSTdbJHAV,CHBFXCCFRDFH..aEEHMEGD..DADEZGBCGBAHQBFBhAAAFBFB.KCBF.TEDBhABAdHFHJAHBAIGCUEADBEBAEEHFhAAANDIE..LADE......hACA......hAHA...,2,-35,-9,26
dOLQHaAIPNURcEDGYCgSFXfVMWBJKebZT,..IAHDPEEGRBDCDECG..GGDD.CGBC.SFCEhAAAFCAG.XGCGfAAFhAAAMBBF.BHEHKAHFbEAGhADATACAOCHFLFFGaHGEAGGG.cAEFhABAEDBA.gDGAhACA...,2,-38,-1,37
YBFONZdEScATJXbIDRCHGLUWVPQaefgMK,TEGCJEFB....IAFGCBDHHDDCLHCGUGCF.VAAAhAAAaEAB.eAEE.gDADhADAMFIFKCBHFBGENGCF.hAHAdDDASBGAABACDADB....WCFGhAAA..fGHChAIABHAEEHFC..,1,6,-40,46
EfKZWOcaDRBbUFVdQCGTINeLJYHPSMXAg,EDGAKEHDOHCCDFIB.BGGDUDAD.FGCHdEDHGACA..TGAAhAAAeFFFLBFGhAAAHBDESBBCAHGF.fCAEhABAWABF.cAFAREDF...bCFEhACACGAB...NCCA...hADA...,1,-17,-28,11
McUDBNIRCPXAEJFOWSgKfQZLVdGbaYTeH,FHDESBAFKAABZCDF.LCCAGAFE.aAGF..eDGHMDIBUDBEhAAABHFD.RECG.CADGAGIBEGBF.hACAJDGBOHAA..hAEAfEAG.dBEF.....hAFAYAAC..hAEA...,2,-28,-25,3
EeZYWQXbDRVAOMLCHaJBTdgcPGSKfFNIU,MABDLEDDHECFBCDBdACE....gAEFPACCGBAEhAAASHGCKGEE.fBHGhAAANAHEUGAC.ZEEA.hABAYEAD.XCEEbCFDDCFFAIHECGBD..hACAaHDE.....hAFA...,1,3,-24,27
KDcUEMVeYJQfbWANFLCHRTBSGgaZdXOIP,LCEBCHCCRAFH.BDGASEFFGAABaGBAZABG..dEHCOAFChAAAKDDE.DGHFEHDA.MAAFhABAeDAA.JHAC.fGFEhABAAFAGFECC....gGGGhACAXEGAcDCD..hADAYAHB.,1,-12,-24,12
aIDZAQYBEUJCRbfKPcXgWNVFHMLeOGdST,BADGEFADUDEHCGEG..RDDA.KEBA....XEAD..WEGHhAAAFHGGMDIDLCCChABAeBAFdAHC.SHDChACAaCCCDCEAZGAGAAEF.JAFG.....fFFBhAAA...hADA...,1,-27,-41,14
CLbQfgVTDUcZSXeWMHAFdaNIJEBYORGKP,FGECdGACaBHD..JEDCEDEBBACC..RGBAKBDGCDHD.LBBF.hAAAQGEGVADCUAGChABAZAFB.SADEhAAAeDCDMBBFAGIH..NBAE.OHFE....hBAA......hBIA...,2,-40,-9,31
PJBNdXZGeQKSEfFDcHTIMAORbYVUgCaWL,OECBRDDE..bAAFVAAA..CGDBLBEEJAEA.BAHBdDEHXFGFhAAAeFGF.KHEChADAfFAEDEBD.hAHAHDBBIDHAACCCYDHHaGCD....hADAWCDC....hAIA...,2,-36,-16,20
EaHgdDTZFRbVOfSAPKLcQBUYJMXWNICeG,LCFFQGEBBBCDJCAD.MAFG..XABE..NBHCCADFhAAAeEFGGCAGaBHFdBFChAAATGBAFECFRFAH..OCDFhABAAHHEKCDH.UGGGIHCGEGEGDDIB...hABA......hACA...,1,-13,-17,4
CYDOTAMNfIZVgFaGPcJUHKXBWLRbESdQe,MAAB..fAEFVDEH.aCBHGEBEJDDBHBFFBDHGLHAChAAAECCBdAED.QFGAhABACHFDDBBFAHBH.ICCFhACAFGGA..PAHFcGFC.XEAGhADA....WFAFhABA.SGDH.,2,-19,3,22
RSFHELPVdMODJfKTgZWAeCGINYcaQUXbB,eGCGCFAAGBAH..IFEE..YDDCaEBGUABEBADBhAAASAGHEHDE.LDFGhAAAdAFBMAIHDICEKGHFhABATGAFgEFAAFIFQAEFXGBHFHGAhAFA......hAIA...,2,-17,-17,0
IRbXLQCDGcYZefKUFPOBAgMWSaVdEJHNT,MGEEaDEG.dCGHEHCEHEBA..TCAGRABDLAFADECFGFEF.hAAAZACCKHAGUAGGOHEAhABABHHFgDEBhADASEFCNEIG.IAAE.bCCF.CFAE.eHCGhAEA...fBDDhAGAAFHC,1,-10,-17,7
VMLIWSBKaNPEgfJFTdecRQZXUDOYGAbCH,CHBEHBAELDCESGGCKDGA.aGCA.EEEDJBAA..dBEDeEBARBGHQEABhAAAZAEEDFFB..hABAOHFCAAIBMIDEBDAFhAAA.......NGAF.fDFEhACA..FGGAXGAGhADA.,2,-31,-11,20
gERCZdJTUefOPDVYbcKAGWXNMaFILHBQS,XCEDMCFHFDGBLBDEBHBG..QACEEEHFZCBH.JFGFUGAEhAAAeBBDOAHD.hAAADAFAYGCAKGHHADDBGEDGhABANBEF..aDDBIDAHSFACCABA.hADA......hAEA...,2,-21,-11,10
LgdfCaTDcOBReNWYGKFSIAMEHQbZVPJXU,ECAEQCEGZDCD.JDCHLAGF.dADCaCBGDFGFBFACeHEG.hAAA.NBBB..GGEBhABAFAHDIFAAMIBEbCGBXAAEhAAA.gEGBCGBAOAEAWDHHhACASEEFADAD...hADA...,1,-16,-19,3
bBYRESDOQPALGFZdaJceXIMWVgUCKHTfN,FDBBaABG.eFFH..XDBDMAGD..VECACGFGKHBE.HACGTAAChAAA..fDDEhAAABAHAEDHBDAEBPAHHhAFAAIDAZACHcEGG.WAFHNHAFbFGD..SGEDhAIA...hAFA...,2,-16,-12,4
KgVYCeEASMIdNBJZXfcOHRFUDTaWQbPGL,SDEBMFFHdDBABGDGZCAE....fDGDOBCFHBEGFHBADBGGhAAATAAB.aEEBQGFHhABA.PACAhAGAKGADYCHBCBBCAFBDNEEE.XGGE.hAHA...cFGAhAIA.WCFELAFC,2,-14,-9,5
bfSGELJaFdOZWPBRITecCDgAVKNYQXMUH,VDEFKBDFQFFD.UGCFfFAHGDADLABChAAAaBDDdABBOAEAZBFBBHAFIHHBhAAA...TCGAhAIACFACADIH.XGCDMFIFSFDChAFAFCBH......hAGA...,1,-9,-20,11
ZNOHCeaPFcWDLIbUSgYKJVBQRXfETMGAd,ZECGHAGDCAEB.eCAF.FECDDGDFLCDAUFGC.SHFGKBAEBGAG.hAAAQEGF.hABAXGACfBDEhACAEDBHMBBEAIBG.NAAHaFEBPBFC...IDABhADA...hAFAgGEF.,2,-46,10,56
SAFXGeBJaKODfZNcEVWPLdRCYHUMgIbTQ,FFDHeCCGBFHHKFCGDAIBZACA....ECCCVFGHLEAD.CHHH.HDEGhAAA.MBEA.IDAAhABATBGGABADJFADaEEFhAAA..OHDC.fABFcGEE.hABAWCEEdGBA....hAEA...,1,-27,-28,1
IPaMYDUdBRfQOZgLAVWJENbKFeXHSTCcG,JGACEADDKEFF..eBDCHDGD.CABG.GCEA.aFHBMCAH.DDCGhAAAdAADBBFHQDBHhABAOFBCZGDGAIEC...hADA.NAEF.FGAHSGHHIHHA....hBDA......hBHA...,1,-25,-28,3
WNeZTLUSDRbECFOgJcQGXAPBMIaKYfHVd,BFHDaEFA.KGBEHEDDdCDH.eBDGLCADDIAGECCBFEED..OABGhAAA.JAHBGAAH.hAFAAHIBMAIDIGAG.hAAAfFGE.NIDB.TGFGSFBBhAGACHAD.....hABA...,2,-41,-5,36
WRfYKEUaPIANQeFSVdbTBLCHXcJMgGDZO,QFDCeBEAFEEFdEAGBDGEHEGD..XGFDMAIDDHDCZFAHOCBEhAAARBDHKBAF..UAGBIHAAhABAAHHA...SGHHhACATDBECAEEJAACWADC...EEBA.hADAaHCC.....hAHA...,2,-21,-9,12
VcYLWQdKFgDZCGIOMSAfNUPaTEbJHBXeR,UACCTCEDEGBF.HDEBBDHB.eEBDRAFG...VABELHDEhAAAQAGAFBAGDDGECHGFOECChAAAAGGG..fFAAhABAaGFGXGCD.WFADKDDF...gEGEhABAIHHESEGEhAFA,1,-16,-25,9
gPFWbJRBKcZeUANCYTdXGDLESHMaIVOQf,CHCCdGDAGFEDLBECHCAGMBDF..IFBEQCGF..hAAAgBEDPHFGFGAEhABAbDFAJBBF.BFGBKGAFeAAAhAAAAEEC...NAEDXEDCDFCC.EHDChABAaCAHOHFE..hBDA..WAFE,1,-3,-17,14
PRDbNeCEJUfYAXcSaLVHdTKQIMBFgGZOW,XCCASCEGLCFEdFCAKAAA..MEAEFEAEZEFH.OGBChAAARGECDADE.eBCCEGACJBFGfCAAhABA.AEIFaAGGhACATEEGBFHG.WFFDNDIGCEGB....YCAEhAAA....hACA...,1,-8,-30,22
cCJKfZQPbOMTFERADHUaYgdILSWBVXNGe,HBACaEGB.dGABLBDFSEGBBHDA.XEADeABECBFHKDDFQAFBhAAAOHDAFEAAEFCEAHIBhABADBHBUCAH.IFHEhACANBIC..JFDEPBHDMIAE....hADA......hAEA.YFFFWAFC,2,-13,-5,8
TdNPGaJDWIRSbBOCfMXeVLHQgZFcUYKAE,dHBFGCAEaECB.DGGERBEC.BFEA..CACA.XACDeCACLEHDhAAA.QGEBhABAFHDCUDEBAHHBEEEE..TAGChAAANAEH.JCHBSDGCOAFHMDDH..hABA.gGAAhACA...,1,-11,-27,16
GbdZLCEUTJDFYKXHVcgBARWeaSOPQfINM,eHAGSFAHOACFQEFE..NEDFGGDHdCDBCHBATABEhAAADDFGFEAD.KFCEXDAGhABA.HEDBcBAAhAAABHHBAGCB.aAGGPFFAIHFEZAEE...hABA..ECGE...hACA...,2,-20,-3,17
IcVJZdQXAfDTLOKeaRNUYBGgHCEPFSWbM,TGCAOAHDKCEG..aDEDREEE..UEBEBBBFHADEEGHDFAGF.SDCGhAAAMDAE.IFBEhABAJHECdHAHABCDDADBeDHBhAAA..NBIEYEGDCBAE...PCABhACA....hAEA...,2,-28,-19,9
KEASYUCGPTZFcLbMDXfVRNHJIaeBOdWQg,SCFDCCCDGFBDZCFAFGBELHCA.DEHFfBBB.hAAARFFGHCAEIAHFBACEhAAAOEDAQAGFhABAEDAHAHIHUABBPEAH...TEDC.MCIDhAEA.....hACA...,1,-1,-28,27
XeWHUKgBaJdYADEZCTcFMGfVLNPbORSQI,EGGBZAFCCFCBFEFBGCBH.LGFE..PAAFOCGBQFAGhAAAeEAHUACDgCCChACAaHAE.dHCBDABFhAAATAEHMIEGfEEAbAGHSFHBIEHHhADA....hAGA...,1,-10,-17,7
bICcEDfHgUTLPSGWFaBXKVARdNJZQMOYe,RBADdCABZDCDQFEC.MFCDeFDHCGAG.EADBHAEDUFGCLDDGhAAASEAAGDGCaGAB.hAAABEAG.XABAhABAAABAOBHF...bFEHDBID..fAEBhAGA....hAHA...,2,-22,-2,20
dKWJEMCPbXDQNaHLITFcZSRegYAfOVBUG,VEFABBFCGCCC.dAHAJFBEMFED..CADB...XFGDhAAADHDEQCEGaHBAIDAAhABAFCAGZAFA.SDCChAAAgACEAGID.OCFDKHAE.EFAGNIDH..hAEA......hAFA...,2,-30,-21,9
JUSOXTYbLMcVRPDHdgKeZCQANBFGfEWaI,BEEHFGHBEBBGaHBG..UFAAODGD..TDFHLBBH.VGEAhAAADDACdDDC.KAEBCACEAAHBhABA.GBDFIHFDhAAASEDDXGCHMEIFRAGD.PEAH.hABA......hACA...,1,-14,-27,13
CBVFHPaEGUdXANgJbMRfZcYDTQLKWeOSI,JBAFMDBCZEFADAIB.LDFDKECC..eBBESGBABGADHBFEhAAAaECA.GGED..hABAXABBADHF.bGFEhAAAfHBHTEABOAEGIAEGFEGFECGEhBAA......hBBA...,2,-26,-18,8
aDbXCPIeGZFRBWcYNAEHMQUVLOfJgKTSd,HEEGUEEFLBDGJCAEKAGG.dBABDBFB..CHAB.eEAB.ZGCEBHGGhAAA.....cDAGhABANABFADIB..MBEFhAAAOEHD..fHGBTFBGaHDCXCGFhAGAPADA....hAIA...,2,-35,-30,5
dReSTBJbVKFcZAPQGYIWCOXHfgaNLEDMU,QBECGBEC..ICADCEFDHCGDaGGDEBGEDFHFdEAG..eECDhAAABDHDJACBVDBF.KGFDhAAAFBADAAIF....PABAhAFAWHBGXGEB.fDDGhABANHAF.....hAGA...,1,-4,-29,25
VdJDSIRecHgGAQPKfUZLWXaTYCBEONbMF,QEBGKADCUECGLHAAaAAB..TBBDCCHG.BHAHOBBHhAAAMEDGFBFDdGFH.SAFAhACAeHFEHEFEAFIHZADFhAFA.XGCAECCGNCAA.bBFADFBB....hABA......hACA...,1,-2,-22,20
gJWKIbPXMcfZSQRDEdUGHLeNFaBTOYCVA,JAHFKCEH....IADDXFDF..MDIDZFGBRABH..DBAGdADAhAAAGDFAeFBDFCFFBBHAhAAA.OGBCCGFGAFAB.gCCFhABA.PCABSHDG.hACAEDDE..LFBChAFA.aAGG,2,-33,-15,18
USJZCPKNRATaOLDdBWceQfHFIYVbEgMXG,TBFDOCFHDCCD.BCHHeACD.HEDDFGCF.IFGE.VEADhAAAEBDHMFAE.UGGChAAASBAFCBAC.hABANDIEAHADdGAG..WHEAfHEFYAED.hACA......hADA...,1,-4,-42,38
RMNXAGOTLdYcQfVWgHEaJBIZFUCebKPDS,TAGELDDE.dGHCQGEH.VEBHgADF.hAAAaHBABDHBZBGHCAAAKCDDDCAGhAAASABARDAD.hACAXEGDAHFGGFCBOCAB.fEEChABAEEEG.IHHEhACA.FBEC,1,-6,-18,12
YKOUWSbLMcdJZQBeCNRgPHTEaAFGXVfID,GEBGXEBD..fAGDDEGFKADBUAGGSAAE.MBFDhADAdGHGZCBAQGDDhAEABHEECAAH.gCCEhAFA.HFFCEDHBAIDC.IFEH.OFAHhAAA....hACA.WBFFcDFE,1,1,-32,33
TZHSRfbQKJaPBgCXFGWeOcULEdAVDYIMN,DFHBMDEEZBABHGEGRBFA.QCAGKCEF.JAFGBHAB.CHDH.FFCHGFABhAAAeFFEUCCE.hABAdAADAEFE.IFABhABASCCBaEGA...PFFD....hACA.WADC.ODHFhAHAEADCNIBB..,2,-32,-6,26
ZKWNAfFcMdIaYVESTOLXbUQPHGRCDeJgB,FCBGdGHAaDFBEGDA...OEAELEDA.XGADQBDBGACFhAAACEGEDABHeHFEBAHCZAGHhABAKGCHAFCFMDDC..hACAIGACSDADTGFB...bABHhAAA......hADA...,1,-3,-36,33
SDdMELQPUfZRCXcFYeTIaBJGVgNAOWbHK,OFCBHBDASEEFDFGC.ECCDLBEFUFBCZDGHRABHCBHHFAAAeFFBhAAAaAFG.BBGC..VGEAhADAAAGGKFADMCIF..hAEAfDFB.....YDAAhABA.IHHBhADA..,2,-30,-11,19
YWcUEZFPfSIJGVbeOKHaTAXQLCRNBDdgM,LDFHRBAHDFAA.dBCCMHCG....YAEEUEFAZCEGFBHDSHBGhAAAGGBHeDAHhAAAKAGCHACGaHEE..AHHECECDhABABHHF...WFAAEDEB...IDCChABA....hACA...,1,-13,-34,21
YTaUGBgQJDcEACZRPfNeSKFHXVLIbdOMW,ZBFCREAE....fHEDSFDDKAEFXCBALAAFdFGEMCHFhACA..TABBhAAAUFGDBBBHgFADhABADIBGEAHBPEEFeDEF..FGACIAHB.hADAWADEaDCG....hBAA...,2,-31,-8,23
CZKTSBGIRPJXQbaLNFDYOHMgeEcWUVfAd,ZFDDSFCDGDACRADA..JBFDQAAGLEGHFBBAODFFMFIDhAAAECHD.....hABAWFHDfCDAhACA.dDAGTDCFBEEDIGAG..hADA.PHDCaAHFDFIF.hAEA...,1,-8,-29,21
ODJQVNFeTXWaIKUGbRLMgSHdZBcfYCEPA,JBFDQEEA.FHFETEGG..XBCEaGHD.KCBDUCCChAAARCFELAFASGAChABAdFCABABH.cGABhAAACCHAEHACACAA.DIEGNEIAeHCAIDAC.MFAEhACA.....hABA...,2,-28,-15,13
IZVXUSGacTMOACWbNfFdHJEBLQPDeKYgR,CBGD..NBCG.FFEAHAFHBADELDDD.DADHeDEAKBAD.RFCBZCAFUFGEhAAA.GEAEaHAA.MHCGhABAOCCGAIGC..fEEFhACAEFHB..YHEG.IABAhAAASAEFWAFEhBAAdAHA..,2,-43,-1,42
MATJYRgCSZFEXDcQKULBaHIdVGfbeWONP,JEEFREACCHCA.ZECF..EBHBDAFB..KACBBBGHHBEF..dABGGEFChAAA.eBABODADNEIE.hABAAADA....TGGHhAAASAEF.cDDHUGAHICDEhAGA..fHAHhACAbCFA,2,-49,-24,25
cXBgedCWTEKURAMfOHFbDISaJGNQZYVLP,MAHFOFEFHFBEFHBC.DHFG..SBDHJAAHGEEFQBFDhAAAZCCGLADEXFBEhABABBEC.dCCG.TGGGhACA.EACA...KAHHABIF.fEHEhAFA.aEFF.NBBA...hAGA...,2,-27,-8,19
AFbdSBDRPgXQINWceTfOVaCZGMHYKUJLE,dABHBGGGDFCARABA....XECBICDF.....NBGG.eCFHhAAA.fEAChABAaGAGCEAHGFDHHGBEKHFALAHFhACAFCAE.SHFGPBHB..WAEBhAAATEGH.ZAEDYHAGhACA,2,-28,-21,7
KOTXHFGDeCcUgZJVLYIRdbBQaAfMPWENS,MDDHECBBKGBB..XGAHFABCGGEB.DBGACGGEUBED.JCAEVCFAhAAA.LEFAhADA.RADHBFAAaFAAAFIDfGEGhAAA.PAHDNDDA..SEEDhAFATEEEeACC.hAGA...,2,-24,-19,5
gJPWeLbCSIHYdEXcOZfUQGTANaRBKVFDM,RFBDBFEEFGGG.DAHH..JCCCeAFH.LACGCBBC.HDFEdBFHEDABhAAAXCCC.OAABhABA.ZECBfGEAhABAQGGHADGBKEEDMEAB....WBHHhACA..SHDAhADAIHAH..,2,-51,-6,45
cRZJXdKPfDLYESAaQIBFHbCWNVeOMTGgU,QDBFFAEACEEF...VEEHMBHDGAGCUBCCZCAFdACCKGAEDFGH.hAAAEAAH..AGDABHHHhABA..HFCB.WAEDhAAANDAG.eHFA..ODHD...hAFAgGCG.hAGA...,1,-7,-43,36
ageUWABXQDETMZJYKdIVLHPbSNCROfFcG,XCGEQGDFDADHMACE.ZBGHKAGDdGAALAAHHAAA.SEDFhACANCCD.OHAChAEAfHGHFEGDaHCAeDDBhAAAAGEGBFAC.ECDATEBF.JFFAIHHDhAFA....hAHA...,2,-30,1,31
WRbAXPZcIeOfdQaHSGMCNYEgKBFJTUDVL,XCADZDEHeDHBdAEBHAAGGBAC.MECDNDGC..EBHBBACFTFBDhAAADEEDLHFEhAAA..WHEGABHDIHADhABAOADDfBFA.SGADhABACGDDKCCC.JDDF..hADA...,2,-16,-16,0
RLMQOEUKTaCXFIJYZBHAfWPVbeSGdgDcN,...PACCVDAASAGFGCAE.DFFDRFGHMIBE.QEDBhAAAOHBCKADFCHACFCHBhABAIEGBJCCE.BABFhAAAADGB..bGCEeDDHdAGH.gGGC.hACANAIAEFAB....hAEA...,2,-33,4,37
gUPDQIHJFNEMRfAZCSVOXdKaLbBYGecTW,SFAGOBCHKAEHLDGHBBDAGGEF.eDDHTGEEUCAHDAABhABAQBFBHGAGFEAHMFDEhACAAAAACDHGdFFB.aABEcBDChADA..WHAGIHHF.NBIG..hACA......hAEA...,2,-20,-8,12
MVfFGCIRUEHQYPLcNZOTJgaWAdSDXBKbe,DHGAKFCAeCDBMBGH.FAEBGEAH..CBAFUGGCHBCEQAAGhACA.LEEBhADAZGBCTDBDaHAGAAGGdAGEXDGHhAEABFFC....fCAC.hAFA......hAIA...,1,-13,-36,23
ARTDIgHbdKVEGNXWOSCcUfLaJPeZFBMYQ,TBGDDAFFHACB.dFDHKEEDEHFAGABD..XBGHOHEGSDGAhAAACEHGUEAD.fCEBhABAaCACeHAABEEChAAAMEACQGBHABAG.IFAAhACA...gFGEhAEA.,2,-20,-19,1
MOSFJWYRbLDPZeHdUcfXTgaQIAGBEKVNC,EDBEKBEHCFEG..OCHDFCCH...JGECRDGDLFAGZACEHGBGdAGEUABBhAAA..XAAFhADA.TEABQGFDhACAADDGBDFGMAIFSHGA.WEEGYHBEhAEADIAE....hAFA...,1,-3,-39,36
NQCcdXWGeVJLFYRUbOZMIBAHafKPEDgST,HBEFKEEHDIFASAAC.QEGDCCDCdGAAGCEFVACBFAHDREAFOHDChAEAZDAC.BGCAhAFAaBBG.fEEEhAGA.PAHFEGHDNAAD....XEGEhAFA.eFCB...hAHA...,1,-2,-24,22
VRAGWLgQDaTCHZfFEXcbISeJdPKNBYUOM,GDGGLEFBQFBAaCECHBACZFCDFBFGXEDD..bFABhAAASACDJAGF.hABAdDAFNEIEBDBDOFAHMEHBhACAAIHADDEECAEA.fAAG.cGEEhABA......hADA...,2,-16,-9,7
PMGeRZUcdSICJfXLBTOVKEQFDaANWbgYH,...NDED.gBFDHEFEMGBAGEFG.eDBFRCAAUAFDdAHEIEEDhAAACBAE.fBBChABALEAGBHGChAAAOACAEGABDEIFAIHEWGCAPHBA.SECHhAGATACF.....hABA...,1,2,-20,22
WZUJQIbfMOgXTGEcdNPLFBaReDVHKCAYS,SCDGZBEGUGGE.QDGG..fDFDOABCTGGBhAAAEDAFdCCGLFBEhABABABHRGAGDEFFKDACAHADJADCIGCBhADA.gAFA.XEEBhAEANBIAaAABeHDACBHA..hAGA...,1,-3,-26,23
WFBSZgAPHOXCVYaLMDeGREUKNJdQfbcTI,HCCFXBCFCCHG..aFFFDBAFGAEHRAFA.UBAHKEDGdGED..bFAHhAAATDGC.FFAGBEHFhABAZGAEADEEOFDF.hAAA....YFHBMIDGEBBD...hACA......hADA...,1,-19,-22,3
ZWMGORNDEbPXTgQUdJKCcaBAHYFVSIfLe,HCCBFBDE.SFFCLCBBeAGFMABHGGCHOAAADHEGEDABXCFAhAAAQFGBJAFCCEFFBCHEhAEAACCF..IHHChACAfEDA.ZGAANCIGPACC..hAIA......hBAA...,1,-4,-21,17
LSEPgGTIeBCFUXNYRMAbfdQZDaWVHJcKO,dEGFZBEBaHBEHCDC.JDCFOBCBLAEE..EBAF.GBGCIACHhAAACHGHFEAFUGCF.XGGHhABA.NBBE.MDDDhAAA.AGHAfGEHDCCG..cBGChAIASGAGPFFH.hABA...,1,-8,-30,22
PBVfFKLGMeCUHacZEdRXgWbIDOYQJASTN,SDADTFBH.BCEAVEFEFFBE.KAGCGACD.eBBBCBABHEEEhAAAaHCEEAHHdGGFXCCDhABAbDDB..DGABOACEhACAYBAFAHEFfCHAMAAA...hAFA......hAGA...,2,-24,-5,19
eCZJMUILWFdAVSTOHRXDYKPcfgEaBGbQN,TECFHEFBRGBADADG.KBFE..fEGB.aBADGCDDhAAAQGGDeBAHCABBZEAHMDIFhAGAIAFFLEBAhAHAdACBAIAG.OEED.YCCE..hAAA.gCGEhABABDCG...,1,-15,-16,1
YcOeCESIKfNHQbBXLAZdPFTVaWMUgJRGD,ZBFAdHBHFFCCaABE.UBGAREFB..GCAGDDAD.OEEH..CHGAEBAGhAAAKHBEHCCE.BAHFhAAAAEHG..TDEBMFID.hABA..JBDC...eFHBSHDAhACA.fDGBhAEA..NACH,1,-18,-44,26
LTIHfUWaDRSVNXdBKGJEgCMbOAFQecZPY,QEGBeAEHZEAALEHHHABEUGDADFECRAGHVEAA..dAAGKDDAJDAChACACHAA....OAAHhABAFGEC...PAHDhADAIGBHaGGCXAEBBBBB....hAHA......hBGA...,1,-10,-28,18
XDWVdCAgEUIKHBPfTaLFeMbOcQNRJGYZS,UFGGHADHBGAC.TDCHLAEF.MCAHOEFFQGAFhAAAJHCEZBADDDGGdDBHCHEFAIHA.EBAEhABAKBFA..aBGEeAFEhAAA..NEED....YFBC..hACA......hADA...,1,-22,-24,2
CfAJFQbTPRGdOXUIeSEWaYBKLMcNVgZDH,JBBDQGGF..TCFARDGFdFECXEAFeAEA..SECFhAAAaCFFBDDBMFDBhAAANFEBZFAH.CAHD...AIDCFHGGhABAbABG.OAHDEGBF.KACC......hAFA......hBAA...,2,-25,-14,11
KATIGbOBUEPXfCFNDHWRaSJgQYdLZcMVe,GDDHOGEABBFHEAFD..XABCCEDC.DGGBHABCREBD.aFADSAHBhAAAJCAB.QGDEhACAdCHCZCCCMIBGhAAAKGAFIFHB.PCCAfAGBhABAFDAG.WECD.LHFAhACA.,1,2,-29,31
PGMTBFXbKfASCVRWHacEgOIeLJZQNUYDd,CACAVBBERCDE..HAFEEFHH.OEFDLFGFZEBC.QFDDUAAADGID.hAEAdDAE.MAEAFHACKEHDhAFAACGAaGBH...IDEBhAAANIDF..........hABA......hACA...,2,-24,-21,3
EYWOaXPbfVZRMcSDBAJLFCTKgINdHGQeU,FAGATGAHKEFA.....IDCHdGBFQDAHECAB.OBCFhAAAPEDD...VAGBhAAAMCIFSGFDhABADGHFBACCABFDCHHGHBCCeFED.WDHHXBFDfABHhAEA....hAFA...,2,-32,-15,17
VKMFTEZOXDNAHGfgbQWJdPCcIeRYUaSBL,GDDA..fHAHQAACdCABPFGDCBFB..IHEGhAAARFACaBEABDCALEFAhABAMIACECHDZBGBOFAAhACANADD.gBDD.WDAAcCADhACAUGGGKHEA....hAIA...,2,-12,-11,1
fQbYKJMSIeWFNXPaDVBUGAHdZTLEROgCc,dFFELBCDEBCD.OCGBCFBB..QADBKFADJAEA.SDHFhAAAeEEFFHEE.XDEChABADFDFBCAFAIAEHFCF.hAAATCAERBDB.gAGAfHAHMEIHhACANDIG..aGGF...hAEA...,1,-12,-24,12
DHWabSYXPBNLOZeQcfFUdTVGMCREIAJKg,KEBGDDCBHDDH.aBFGSAFE.XCGENCAGLHCAeBEGhAAAQCGBFEEC.hABATBCDGGEDRFFAIHAEhAAAACACWADF.bBAFBEGE.cGBC.hABAdBBACHHF.....hACA...,2,-17,-8,9
HEJQTWfgPYOFKCLNIcMSRGAXdUaebDVZB,XEDHdBCEeCEGDIBAZAFDBBHHHFEA..EAFCQFAB.TDAChAAAgFAB.hABAPAAFFHEACADDICCDhACAMEDCSGHHAIACaDFE....JFFCfDHAhAAA.KADEhACA.cAGD.,2,-14,-6,8
KVfHTSdONbGFUEYgCaeADLXWMRBZcIJPQ,XEABMGACRDEF.BEGAZBDD....JABEQBAAKHAE.VAFFhAAATGDFODFB.hAAA..bEDDUGGAEHGGCECAhABAADCDDDIFLADH.IHAHPBFC..hACAfBAE.hAFA.SGGE.,1,2,-30,32
fEVgGIdPeDHCMaFTBcNQSYKXWJULORbZA,ECEGGCCDdCGA.DGGDHGBAMBDAFGGA.BABGQFACKDBC.JHCAOAEEhAAAZEFG.ADEB.VAABhAAA..IFADhACACHHBaDFE...NAIASFFDYEAC..UAGEhACA.....hADA...,2,-32,-2,30
ZAaXIHNfEdPUWYJgQBKDcFLTRGSCOMbeV,aBFHXBCDHFAEEAACdCGG..UFEE..JBCBBECADGEFFFGGLEABhAAA.TBAASEEBhAAAOAFBeAFEAIHA.hABAIDAENCIA.fGHAPHBC..hADA......hAEA...,2,-27,-16,11
bSfVagUKIXZAPHYELeDNcGOTQWBJFCMRd,HAAFLEAHeFGHDDGHGEDGOCHHQAGDBEDH.CECFdCDBSFFDhAAAVFAH.aBAGKDFGhAAA.IAEAAAGB.hABA.PCCG.EGCB..NDIC.cGGEhACA......hADA...,1,5,-40,45
HPYRQCFbXfNSUgWEMOTDAVeBGdKcJZLIa,VAFCeHFCdEBA.KACFJBCFLCDA.HEFCREAGCFFA.FBAD..XGEChAAASAFG.hABA...gDGDhACAMBIBDHACAAGCBCEFcGEBIADFaAEH..hAFA......hAIA...,2,-39,-14,25
HPOSZdeQXDIfgVUWNEBLaFKTRYGMAbcCJ,CBFAHFAG.ODDDdFGFQEABDHGA..IBCAVABEUFDAhAAAEBHFBAEALDEGaAAGKHAAhADA...RFEHMDIDhAEAAHBEcAGFSBFH...eBBDhAGAfGHG.NIADFBAHhABA..,2,-17,-16,1
ACSWJYTKgIVGdBaOLZMEQcDRbeFUPNfHX,SBHHJEEG.KGDEIDBAGCBCBGHHLFBDZAEBEHAEQACBhAAA.DGGDbAABhADAeHCGFEEA.UAGDfAGHhAEAAFHBCBAC.YHFAgFDG.aDDGhABA.MDAD...hBAA...,2,-22,-14,8
QIUOCXWZeNJGKfLTbYcERVSAgdPBDFaHM,dEABDFEGFAGAMAGB.UDDDCGHB..ZBCC..eABFGDBFLGEChAAA.TDGGbGBGEAFDRFADACCAhABA.BAHHHCGDOHCChADANDAG.KADB..fAAF.cGEFhAAASGHH.hADA...,1,-8,-29,21
EHSMYQcIUTRKLedDVgGNfbFOZaBCXJWPA,ECBFHCCC.MAEGQEEEUFEEKGBEeABEDIDE.VGCAGABB..hAAAfFBHFGGAZCABaBHHhABACDDHJBFE.AHHCSGADhAAA.........hACA......hAIA...,1,-13,-19,6
UMZJHaAGQSTWNPgVDCbXYIeBEfKdRLOFc,GEAATGAC...NAFA.VDGH..CDHC.XAAAeCCFBABAEDDGdBDFhAAALHFG.FBAHhAAAcGGEMGFGZEDGaAGCSGDFhABA.WEAGDHCCIAHDhABAKDAEOFFB....hADA...,2,-17,-14,3
PVSBTFZDMGgHdfcRYENeULIKaQXOCWJbA,VCFDBFEEZDFA.MFBBGACE.HEAH.dGHGfAFGhAAAREDDEAGDUBACLGDA.hAAAaCBAOHAECAGB..hABAWEAFAEIBSAHB.DGGBcECBhABA.YADHIAEEhACA...,1,-4,-29,25
EdGKSeVTBUQJNWDFALYcXbaIOgfCHMZRP,LCEBXBGA.aCADOACC..CHCAHEAGRCCFEDGF.KDCE.VDGDhAAABGHC.JAABDBAFFGAHABHA.hABA....cEEHhAAAIHAB..fAFBMGDCdAGGSGHHhACATEAHNIEFbGDGPBBAhADA.,2,-22,-14,8
UMSRPOBLZWfcQaKCJdYTNEGbgAHIVXFeD,HEFBXGGGeFABDFAEUCDE.MACCRAGBBGAG.ZDCH..cGCGhAAAKADDCEFF...JBFCdEHGhAAATBADEABD...hACA.bAEFAIGCIEHG.FHDE.OEBChABA..LGCGhAIA..,1,-13,-18,5
YWTEIQbFfPJScgLaOXBeUKdVRCGMHZADN,DEEC..NBBH.TGBFEEHB...QAECFAHFJHDC.SGGEhAAALCECODDEhAAAXDBDBGBHKDGERABECAFEGCAChABAZEFEADDBIDAE.bFDDfGFDhACAgAGB...aBAChABA...,1,-6,-22,16
MPGJNVTcUabQXYdZgRSKDHLEOBCWefIFA,GGAFJFBH...NFED.TCBC.UEFAQBEE.dDAEhAAAZBEGSDCAhABAKFDDHAAAEAEEBBCACHHDeHDAhAAAFGHDACACMGEA.cAGEbCFA...YDFGhACADCAF....hADA.WAEC.,1,-12,-13,1
XLaMNDefWFZHSEJBVIbPUOKdTCQcRgGAY,XAEDaEAG.DGEHeCDD.FCHHHAAEEGBCBFGFIGFH.UBGChAAAOFHFdDEATEAEhACAQAGDRGAC.GGDBhAAAAIHELDACMACBNIAD.fBAC.hADA..SBFDhABA..,2,-12,-6,6
YMBRHEgIfePQVLaSDKFbAGXCZUTWNcdJO,XBGFCBFAZADF.UACB..TGAG..NHAH.dGGD.OBAChAAAMFGBBFEFEEEB.IFCGhAAAeHDEQCGDhABALBABaDCAKFBEADBFWAFDYAFC..hACA......hBAA...,2,-30,-20,10
KWgeDfaVANULZMBRJTHObGECcPFXdQSYI,LFEABADDJBAH.TDFDHGCCGDFA..EBBDCHHC.FEBFQECChAAAIAGEKBDEeAHDhABADCAF..aAEANAADMIAAhAFAODCA..cDDB...PHDAhAIA.XBGAhBAASFBF.,1,-9,-25,16
EcbZOLaQCMSFXVYGfHUDJKBNAgIPeTdRW,..IGBATEBEdGDCRBCC.EABEZBAB.LFAEaBEG..MEFAhAAAFGFHVEGB.GCEHhAAAfFFDDIBGBADChABAAAFCeFHH.cCDEOEEBCAHFYDADhADA......hAEA...,1,-10,-24,14
NXOgJKdWVQBbeFcCIZaRDLSEYGAHTUPMf,TDGCUBDAMGBC..XDAEOEFDKCHBdBFDQGBChAAA.BBDCFCAHIHHHhAAARGFCDBAALDEBEAGCAHEFHABBhABANADB...WFAC.....hABA......hACA...,1,-18,-27,9
gRMIATLbEcQKWFONdHUVJCfPXaZGSBYDe,LCHDEDGHKDDD.FBDAOFBFdHABUDCE..JABHCFFD...XGDGhAAAaACG..SAGGhAAABHGAeACEMBBBhABAIBHDAGED.TCEEbGFA.QFFFhAFA.NEIG.fFADhAFA.,2,-37,-18,19
SOgBYEQHDVNLfJAXUbCKMIFGPacWdTZRe,UACACHGDKAFE.MEFFGAAE..aHFEdDHCZFABRFEC...OAHHBBHGQGCGhAAADCGDLFDFhAAAAHHA....ICDChACA.FEBEcCBHeEAD.SEGHhABA.EAFH...hADA...,1,-23,-28,5
deXWVMLfKNCBHJGbPFDEURYASTOZgQIac,SFCATCCB.OAACZDGHQABF.aEAAeDDAXFEChAAAMADGLBFAhAAA.KGFCBGAD.hACAJAFBbGBGDBIFECCA..YHAGIEBE.hACAdHFDfEEDhAEANEIECAGA...,1,-3,-27,24
cCINPHTaUSeVfYdQJgDZAbWXEBLGFRKOM,XFGBLDAHRGBAKBDCODEC..CBHD...IDCCHCAAaEFBhAAASABCVFABdEDAQABEhABAJGFCDIGEABCHECFEhAAABHDE.MDFAPAEG.....hAEA......hAFA...,1,-15,-23,8
UFAeXTdcPBQHMNZgOIfKCRJVLWSGDEbYa,TCBAdFEGBBHF.MEDAZFFEOHDC.KDFDRFBHLFGD.hAAAGAAAECGAaGBEAIDGeADChAAAPAEH..NDAE.fACEhABA.CAGGWFADDBFDYDHHhACA......hADA...,1,-17,-26,9
CcHbeDQBgUGAJTPZWfKNOEVdFSaMLXRYI,TEFBZABBKDFC..OFHHdCBBFFDB..MAFCXEAF.RAFA.IAAFhAEACHEA.HECHhBDAbADF.DCEEBAACGEEGhBEAADID.JFBFfDEF.EGADaEHFcFGEhACA.....hBFA...,1,-14,-21,7
TIHcFMVXGQbWODZUYfAJaPEKdCRLNSBge,aHGAECFHdCCBLAABBHHB...eBEAHADCFBHDMIBEGDDDQEGEhAAAOACBDAEAZEAEfABFhABAJEBFKEHB.CCHGSFFDhAEAIGDC.....cGAGhAGA.....hADA...,2,-23,-3,20
VGRgeXMEdTSIDUPcfNQFABJLbaZYWOKHC,LEBAZFDGOFBBCCHHGFDDRCEC..XCBFdBDFSBGChAAA.DDAAPECE.hABA.NIEDAAHGBACB.aHGChAAAKGAHgAEAeDEEEABCIHCHfAHEhABA.FEHF...YHCGhAEA,2,-28,-13,15
HMCSNYDcJaEWAKVdTFPbgZGfXBOILQeUR,dBBAFBDH.....PFHDZFBDXDAGBCEHLADAQGFHhAAAUGCCHEFC.MABGhAFACCHBSFFCDBBFaBGFEGDFhAGAKEAG...bDDCgDECOAAHIAHHhABANAIC...JHEAhACAAHAB...,2,-27,0,27
LeKBVgGZCOSIPbUWQFNYDTcHfEXaRAMJd,MBEDdBCGeEGHBCCCGGBDZEAE..CHEF.SECE.IBEGhAAAPBHFUGFA.hABAFBADDFIDHGAEECGGaDFBhACAAHHAKABCODAD.WADENAEF....YCGFhAAAfAHE.hBAA...,2,-30,-12,18
CALPHJafXeNKEBFUWdQcDbYMRTOgZSGVI,HGBEJDHD.XAABKGCEBCEHUEFC.dBDGDDBBMAGD..OGEEhAAASDAHGACFIAHChADAABAC.aFHDeFADhABAEHFGFECGQEEF...YCCHhACA...TBGBhADA.,1,-5,-42,37
VCWIXUabEDgcRBQLGTdOFMfNSeZKHYPJA,CAGGXGABUCBF...aCDCDIAC.RGFE.QGFDLECGGCGGhAAATAFDFDAH.fDGBhAAAeACCKGCG.YECChABAABAC..WCADIACH.EHCG.hABABGEFMIDASAHHhAEA.,2,-28,-22,6
KRUTbJOdecGEVALBMIfFPHNWDgYQSXaZC,BAHHMIFAFAEHHGFC.DIEAQGBH..SBDBhAAAZABFKFDATCFCOCFEdEHCcEGFhABAEDEBLDADhAAA.fAHAWFAEXCCDCGGG.bGBC.hADAJBBD...eADEhACAACIF.IFFH.,2,-13,-2,11
fJbMSeLRYAGPOdgEBKcHWVFZQINUXaDTC,GEACOEBFdBHAEFDFKAFBHEDA.FBDCZBBG.QDDHUBABDHFG.CGHH.hAAA..JFAFSABAhABA.eHEGYEHHhAAAAICEBFGH...WAHB..NAEFaHCEhABAfCFGMDDC..hACA...,2,-22,-20,2
ZDRAdPBMYWOHSTNKaEeCQVGcbfXgIULFJ,dFADMEEGOFEAHBBDSADEKADC.EFCCQAAHGBED.hAAA.fFHChABAgGEDIGFEFDFEZGAEDCDFhAAAPHBCBCEDWCADaBFCCDBC.....hACA......hAGA...,2,-20,-11,9
VaeEXYQSDTIRMBPWcLfgZOGNACdUJFbHK,CDCHUDAAFGGB.KGCH..eHCCEGHB...QBGBSDFHDCCERDCEBABChAAA..PFAFhAAALAECZBADODFHhABAAGBHdHEH..bCGFaADCXACDIFCC.MFIBhACA.....hAIA...,1,-19,-26,7
RLUFNOgKeVaEJWHMPTXIDZACQSdcGbfBY,QDAGdDBAGFDBBAAELFFBFAFF.OCFAKCHB.eABAEADBHDEGhACAMDIB...PHFEhAEAIFDD.ZBAACHABSHCGhAHAcFAEfHBH...hAIAYAEG.NEDHaFHHhAAAWCCB.,1,0,-26,26
WSFVMHfEeNGLCBcTQRAUJaOgDdbKXPYIZ,UCDAOCAFDBACdAGE.KABE..XCAF..ICCBhAAASGCBMEDEEGEGeFDHhAEAGAGCCHFEBGBETGAEhAAAAHIB.aGGD..PFFA.ZCEAWADA.hAFAHEFANAIA....hABA...,1,-20,-21,1
IPYHDRWNUGbMLFeTVQAcXEOSCKdaBfgJZ,EFFECDACdCCABHBC..JDHDZCCH...IHHCHGACDGEF.RAGF.UAFEhAAAGACBMABFFGFB.hACA.TEAAAIAA.XACEhADASAAFfGDD.PDHFhAIAWFAC...LHDAhBAA.,1,-23,-33,10
WTAMPVLXNYagBcRdZHfCbDOGKESJIFQUe,MBGBLGAG.XDFDaCDFBAHE.dHGFZADFHFAECEHE.DDAHGDBHhAAAEACF.SFAEhABAFAABeFFEAICENIBF..gBGEhACAfFEGKHGEIDHDQBBC.hACA......hAEA...,2,-27,-1,26
APSYJMcKGXDNCFZLBWgEfeHQbRTVdIaUO,SAHDMEDEKBBGGGBFDFCC..CBDBZEADBDBH.EGHBeAAD.HGDAhABAQAGHRDGDdAFEaCDChACAAACAJADE...NBAALFFBhAAAgEEBTCGCIHHH..hADA......hAEA...,2,-15,-13,2
OREXGFecNAYdQBCIgLJKaUTDPHZbSWfMV,dFCECBGELAFDaABA.DFIDZFGD...SCCDMDBGREBC.EAEEFFEEhAAA..eCGFAIEGBADEhABAIFEHKBBA.TBDHhAAA..HDGDfHEFOHAA.XGABhAGANCAG...YAHHhBAA,1,-15,-36,21
bQeVTJHaYASdPcZfLIGROFEXgCNKWBUMD,SDBFdDFCZBAFLFBFGEDGFCGA..XAABCGEG.KAGEUGGAhAAADBIHQGBDhADAeADBJAFA.HDFEAEEF.fDCHhAEAOFCF.EHGA.NCCFBFHAMCAF..hAFA......hBAA...,1,-8,-24,16
JYAfEXIOWbdHMQBPcNKUVaCegTFSDRLGZ,EDBEOAAHdACAHFFDBAHG.....NEEEUCGCCCGGeCEB.FHEGSBFChAAADGGGLFAFJGAEAFAAhABA..XFCChABA..WADHMBBA.cCCCaDFB...hAFA......hAGA...,1,-23,-33,10
NZfEeKaLYXVUgCOdWcBPFHITSQbMDGRJA,ZCDHeECCaABALBFA..XGBEUBAHCFFAOHAGdAGHBCGCFEHHhAAATEGB.SEBFhAAAMGAADAFEJHDEAFADEGEAhAEAKBDD..........gCBEhAFA..hAHA...,2,-30,-27,3
ZQPHLXJMFTcKWECOdNVaYgGRSebDUAIBf,BBAGQBCELCFBJDED.FFBF.KHDGEAAC.dHDF..aHGCGEAEhAAARAGD.SCEEhADADCDDADFB.fCHAhAEAHEGFMEAHTGGDCADAOAAAYAFGeEDH..hAFA......hAGA...,2,-20,-15,5
ALDNUVJePXHIOQTgCBbaEdWfRcMFYGKSZ,DDGFUEDGeBCEHGFC.OCBEQGGH.CCGEBGADaCGHEAEFdABGRAAAFEAFhAAAKFED..ZFBBAAGH.LAFEhAAAJHCC.IDCGhADA..........hAEA......hBAA...,2,-28,-23,5
DYUbJHGPMgcZXdFLTVNWBQKeRIOfECaSA,DHCGUEBAHFGBGFEBMECAZADH.FHECLEAH.VAGBBHCAeFCEhAAAIAGA.OAADhAAACCAAaCCEAIDE.JACG.hACA.PCHFXDGG....dFAG.hABA......hACA...,1,-13,-23,10
WKFOINgAVabedJUEXCZHcTfDYBPQLSGMR,VFGDaGDE..dABBEEEHCFBD..HDDH..TGCBDHAABHGDLACFhAAAGAEDRBEAKFBCOCCBhAAAIGAGAHHC.JADEXDFFhAEAZBAF.........hABA......hAHA...,1,-15,-26,11
YaTJPGcNFdVBISHZDUCbERWMfLAXKegOQ,eABBQBEF.aCAAJAFH.GDGGFEAFdFGGBEBEHDCFDHCGCAAB.RDDD.hAAAMIDCAAGE..KACEgCGChACAOAHF..hADA.PHAANIEF.SFEH..hAEA......hAFA...,2,-33,-13,20
LPbAVUJWCaEOZFDgKQeHcMSBIXYNfdRGT,UCFGCCGH.EHBCZBEH.DEADKCBCHBCB.MEEHSHGE.BHAFhAAAIGCC.XGFHhAAANEABdFFDRFDDLACGhABAAACF..WBABaAGA...OFHFhABA...FAHF.eFAHhADA..,2,-30,-18,12
PMgFDVYHIaBcTEXNGQOWReLKbSfACUdJZ,CGBFJABDZDAE..MBABDGFDHEFCBHHE...EADFGGCF.ODCFhAAAeAGFKAAA.SCAAhAAAAAGCdFGDFEBHIEEBhABAaFDH..XGGANAIC..WFADhADA......hAEA...,1,-27,-36,9
UKJafNHdIZRSVQOcPXbDCLWGBAMTgYeFE,TGGCeFDFEBAA.UDFBaBGD..HGCGZEBDRBDAQECB.PBCChAAAXAGF.DGHFhAAACGADLCABBFAHAIEAMCIBhABAFFFGKAEC.fDEBIDAESGFBhACA...hABA...,1,-10,-17,7
fDbWQYXBFeOPLAcdNZMKJGRgUVCTHSIEa,dDECZBCGKAGBRGCAUFGG..TEEGHEAHEAEBDBBB....QEAGhAAAXBBCBCGGOHDChABAACID.MACE.GEGEhAGACAGHaAAB.fDDH...WAHHhBAA...FGCG..hBCA...,2,-29,-15,14
ZedKbCRDLMfgcWPVHGQJYETFXIBNOSaUA,eBFAdBCGKGDHCEEF.DAHDLEGH..MEEC..gACEhAAA..WDAFPHDChABAHFFHJEAHEEBEXDCFhAEABGBFSAAFAFFAbCFA.fBFAhACA....cGBEhAFA.,1,-28,-37,9
FOWSAKacPNLfRZMVUTQCbGgeJEXYDHdBI,KFACaCDA.....PGDENABH..LDEGRAEAZBAD.UGBHCEFDGCEBhAAAJEHD..EBFEDIGEhABABEBCOCDHABBE.MIBChACA...........hAAA......hAGA...,1,-26,-45,19
UJKCVDLGdSQTYMPXWNcZegIEaFBObfRHA,JACECEAADFIFGFCD..dAHAQCFBMEEG...XCCChAAANECC.eHFCEADHFAAAhADABAGH.fCAAhABARGDAACCDKAGFLFDCSCHH.TGAA.hAFAWFFEcBDE..hBAA...,1,-6,-36,30
OITJPfKAXYZBVdMLNWFcDEQUbSaCGegHR,XEEAZECEdAGCLCBCFACA.DGFAEBCB.QGCBSFHHCCEHGBAAhAAAeHBG.RAFD.IFAChAAAJFHBKECCAFABBDDDhABAMAIB..NBBF....cGDFaHEE..hACA.OAHF..hADA..fHAD,1,0,-27,27
cBgYdVPfDIKSZeQUbEAaFGWXNORLTJCMH,aHCCFFGEGAGG..XAEDRFABLCAAJFHDHDCGBEDBdAABVAAChAAADGFF.KCFDZEAA.eHDEhADA.UBGGAGEFOAEBhADA.CHHF.gGAF.fFFGhAEA...IEGAhAGA,1,8,-37,45
LVMQGYXeEUfWgSIRAdKOZPDJFbcTBaHNC,KEDBZBDFDFGFFDGH.....TGDDBFFDaDBCHCFGLHAEQCBDhAAAGAEEXFBFhABAeADFUAADfAGFhACASFHHAIFAdGAEOADA..bAGFCHHC.MDADhABA.....hBAA...,2,-15,-9,6
XVUOGPHbJKAZMRDBCNfWQFTLeEdcaISYg,RBEFCDAG.....fEBCFDFDeFDDEBCAdBCA....aHFCIAFHhAAASEHF.XAADhAAAUGGHOHAEhABAGECCPBHDJAHHAIACDAEGBCFFQEEBhACALCBGgEAAhACA...,1,-5,-29,24
EMKfXdNHLVYJCAGTFSRQgcObUZWDaIePB,FBEBSDCARDAF.QBGFOHFGUEFDZECGDIEE..aHBCICCGhAAABGDC.KEGHdBBBhAAALABG.YDADhACACAHFTCFAbGDGeCCBEHAC.MBAB..hABA......hACA...,2,-29,-6,23
AdQECaHWgGLSIBPcKRfDTXVMOUNFJeYZb,QCDBaDDBHFAAGACDLEFEBHHHKFGBRFFADABF..VEADUDAHhAAAJAAHeHCGZGDAAIHAEAHHCCHB.hABA..SEGChACA.IEECPADAcECA..hACA......hAHA...,2,-22,0,22
fAdNVIJFKBWEYUPaOCcSDHTMbReLGgQXZ,dFDCVCFHJACG..BBFF..EGACUBACOFFGCHCE..DFHBMIEGhAAA..eFAGGCADhABAQACCZBFBABID.FEDFhAAAKCHD....YBHHaGHF..SHAAhACA..hAGA...,1,-26,-34,8
CSJQXeLWGKPOAEIcBbMDRUZTFaVgdfYHN,EEBHBCGGDFGBZGFA.FFCD..aHBCdEAFHCCA.CEHF.SCDDhAAA.QAGBhABALFEBKCGAAIGC.IHHDhAAAMICGTEGDgABCfCAHNBAAXFCDhABAWFAH.OBEG.hACA...,1,-8,-39,31
ZfDNCaIeXUQLTJdWbcOGgHREBVFYMSPAK,KDFGDIAECEFEeCFE.UDCGLCEG.dCBH..bFBCOHEA.hAAAGAAFHACGEGHHFEAHMGCEhAAASFFC.hABAAICCNCAC..IAHCXBBC....hABAJDHB.WADE..hBFA...,1,-12,-32,20
IZLJHeNRBCbKfdgWGEOUTFQMYDAaXPVcS,XBBBVEAH..SFGGLDECeFEABDGFKABCdAFEGDCGhAAAUEDB.FBAHMIEAAIGAaHAGhABA..IAHHhAAAZGEGNDICCFBD...gBCH.ECEF.OGCEhAEA....hAFA...,1,-3,-28,25
ISbFQEXPdLMfAeGWDNVKYaOJUZHgcTRBC,GBEFDAFFKGAC.ODCFUDGG.ZFGFHDDF..TCAEBADFCBAGSEFDhAAA.FHBG.hAAAEACEdBBEMIDAAIEA..hABANHCF.aFAB..gGGB...hAEAIAHD..hABA...,1,-7,-50,43
VSJKCQgOLNEGWAMeIYaFfcPbHdXTDBURZ,MADAeCBA..aGCBFHGE.....fDFDbEBA.dEDGTGGGhAAADICEBBEEZACGSAHFhABACBCC.QGEEhACALABDNHABEDEGAHFFIBGA.hADAPFFC...hAEA...,2,-34,-17,17
FEaIPMCWTKJeSbXNLABfHdGZVOcRgYDQU,BDBDHGDGdDCEZADBODEERAEDDEAA..FBHBEFDF..aBBG..IGAAhAAACAGC..KHGGSBFEhABAXEFFAAAEfHFHhACA...cFFG..hADA.QBBBhAGAMEIF.WFCD.,1,-27,-32,5
ZEReQHWPAGOUdJfCDKaTLYcIMFbgXBVNS,OCDGJADG.DEEEKEGALABF..IHAGMFFF.FDFBXFBGhAAABCAH.SEAEhADAEECA.eEHHhAEAHBFCAEHH.UGGHCAFDYFDBgGBBZAGF.QABEhAAA..hABA...,1,-14,-37,23
FHWBIOCRLYKEVDZNAXeMbafGgQTUSJPdc,eAAHaBBFGBDCQDAAUGEF...JAHBdFCCFGDEBAGH.CDGALDAHhAAAKHGCECEHDDIHAICG.XCCFhAAAMBIF...hABAfAFF.SEFEcFGA.hACA..WFAG..hACA...,2,-30,-24,6
TOHAbgBXSDCeVQRLFdZYPJWcIMaENGKfU,BAHEDCIFCHDG.QGGFLDEEZEAC..PCFE..JFEFIHEAhAAAaACD.EGAEKHAChAAAUBAFOBAFABFCbEEG.hABA.XGGF.SAGCRDAE.hABA......hACA...,1,-23,-34,11
JEQHZdPDAGMOLSFIBUKaVRNCfXgTbWcYe,GFEDOBFAFEEHBBCD.UBDCKACG.RAGH.CCEA.....XGDGhAAATGFF...bDAD.hAAA...WEHBcDEDhABAJFAFHBAH.dECCDAECAHDEMAEEIHHHhACA...aCHDfDFFhABA,2,-32,-26,6
RDCYITPWeMfBJcVEdLGFgSKOXQZHAUbNa,UCGBaHCG.RGBA.CFAF.....TGFBeCAAMEFCBBBD..JDCBEGFDhAAAGADBSCGAhABAKEGA.QECDhACAACDA.NBBDDCECIEEEPFFGfDAAhAAA......hABA.dGAC.,2,-30,-16,14
UVCAXPBGOEQILHTefYRZbJgDSFaNdWKMc,BBCAOCADECFCLEDFHFEE.eFGHREBCZAFAJFBBDAAE..FAFEdBBGKAAFhABAMEAH..VCEGhACAACEE..XDGEhADA..PADBIHHFYFFDSHDGhAEANDIC.....hAEA...,1,-14,-21,7
QBZYbPNfVGJWMLcSTIERDeAgaOCXFHKdU,.aGBGCCDBFAFBHBCG.UFGHBHFCZDAG......bCGFNAHG.GAAAhAAAMAAELFEHhAEA.SBBFhAFATFDFIAHBDIBEABFE.XEACKCFH.YDFHhACA....hADA.fHGH.,2,-30,-9,21
JPABOTCcXDKZFHREYNWaeLdVMgUGIQSbf,TGEGXBEH.KDCDHDFD.RCCF.EABA..NACF.aGHBdAHA.MEBHhAAAGEAG.IEHChAAAQBAFfGCChABAPFCHAIHACEFBDIDE.YAEC.eFFDhAIA......hBAA...,1,-10,-18,8
QbICWVcABPTJMZEKXdaYHUDFgNGSRfeLO,TEBFMBCEKGFC..dAAHHCDEDIAA.FAGBGACARDADLHFGQEEHhABACCCC.VAFGABAEBDHGhAAAZGDCaEAB...YCHBhAEANFEHSFAD.OFCFIHHBhAFA......hAIA...,1,-6,-19,13
gOabTDCJcGAULMKQZWSHXRFdEVBeINfYP,LBBGQBEEZDDFSFADRBFAFDHH.EDAEeACC..fEDEhAAA.PDHBhABAgGGBOABCTGAGhAAAJHBGAGFBUGGBMBADWFDDXBGABAFHICCGhADA.NAEBaEEAhBAA...,2,-18,-8,10
ZcBFfaHRQCWPYSVOJeDbGEgMXILAKdNTU,dGABTBCCZFFGBBCB.FCFEaBEA.HEADRAAB.CFFC....YHCAhAAAOEFADEDB..hAAAGEGCMBEELCEFhACANAIEfBAE.PDEA.SFCAhABA....hACA...,2,-39,-14,25
CVLeAWacQSgOBPYMURHXdJTZGDFbIfKEN,aEBBQGBH.OAAHBDFEMCCCHCEGdFGGZEEGFHCE..fDCBhABAEADACBHE.LAFAhACAACAESFBHhAAAYFCCXDDCTDADDDABIHEDKGHD.hABA..NCIEWBBE.hACA...,2,-34,6,40
eNLRfAWdPXJSDbVYgGIUKMTFcCQHEZaOB,dBGHJGAA.DHEG....VDEDGEBC.IAECKCCCFHFE.CHHD.EADEhAAAZEFA..BABEeCDFhAAARBFE.ABCH...XEGDhAFASCAH..gDBEMGEA.hABAQGDC.hACAaHAC..,2,-36,-23,13
HDYWbPdFgCBRMOGKIAfXUTcNeSaZLVJQE,UFECTFCBeBEB.ZDCBVBBA..QFAADEAF..WFHFhAAAdBBHCCAD.REGFMIEEhAAAGDEG.ABHA..cCAChABASAFELFBD.ECHDYAHBhABA......hACA...,2,-22,-15,7
UgDOAEeHTFYdVScXLbNCRfKWQBPGZJIMa,eGDGHAFDFCHHdAFC.SAACLDABCHCEKDEDBEDCZDAC...JAHDIFGEhADA.aCDGgABGhAAA.AACCEFGChAEATFAG.YGEA..cEFGhAHANICFfBBG.hBAA...,2,-38,-15,23
fQAPUdVcHZBEYTeFGWROXNKSbDICagJLM,dHGHHDCCEDABTAFAGEDCRFAF...OCFBKGEFSGGDDIBG.hAAAaBDCgCBBhABALDHDMACHAGACUCGE.VACAhACABEACeAFEFBAB........hAIA......hBAA...,1,-6,-7,1
TFcLWGOZVKRJYSBDNPMIdEAfgeXaHCQbU,eDFFXGBGCBAC.UBAGFDADLAHD.GBCDZEFCVBFHRGFE.hAAASEEDDICG.hABAMAEFIGBCdHGDEAGEhAAAAAGFaDDH..bDAETEGD....hACAWFAF....hABA...,1,-14,-20,6
PEbcKaOZNMBDXeVGAFRHQTdIWgSJCUYfL,FFGFREBEHBEEQBBEdFGF..IGBASFBGUAAALBHDhAAAEGEG.KDECaHECOEBGhABAMEDCDBDDeACEAAIB.TGEChAFA.JHAACDAEfAFD..hADA......hAEA...,1,-7,-21,14
fSQCgRNEbaWdVYZDABTOPXJKGIeLHUMcF,TBAFOBAF..JCGFKAGA.GDGELDCAMICCFFFD..QFDBhAAARADAEGAA.aFAFdAAFhADAVBEBDIBAAHHABAEF.hAEAXDCG....eHCEcABFhADAfAGBCCHE..hAIA...,1,1,-31,32
JWVFAeQNDXLdCEBacIPgOZKTfUGYSbHRM,QEGFDFFHLABBCGACBCGD..aGDD..IDAHODGHKGHBhAAAUEDASFAGhADAHAFCJACFFAABACIDeBFAdHED.hADAEECC...PHAATEBC..fADHhAGA...hAEA...,2,-22,-22,0
ADRBQOCHWSEGUNecFPfVXKYabIMLZJgdT,BEHHOBDHCHHHHBAD..SDFDUADGeGDEFEHH..VGAAhAAAKGCDaBAA.MDAFLAGDhABAJHDE.dDDAABHBDCEGhAAA...QEBD.ECAEcFFAhACA.....hABA...,1,-21,-31,10
fQNZcEOWTgIeCALaRbHPUdFKJYSGVMDXB,LDAEaFBDHCEBUGDCKAGD..SDHDGACHMCABBFDFQBGAhAAAZFAFOHCGgGGEhABAIBAAAGGD.RCEBdAHEhAAAYBBF.DIAGNIEF...ECCE..hACA......hADA...,2,-20,-1,19
IZdDLeGCMOcPBEAUfSKWYRVXFTQJbagHN,UBBFKEEBRFBA.FEHD..JCCD..aHAEHBEEZDAALFBGCHFA..hAAAMABAOCFEBAGDAACD.hABASGGB.hADA.YGFAXAACbAFGIHDE.hAEAeFADPEEA..hAGA..WFHB,1,-25,-30,5
AdQCLNGHMBeKYRVfSXUOEaFgJPTZDbWcI,dBGALGDGHBCFBEACKBECRDAA.SFDAUDFB.OAAAEABEFAHBJHEEhAEAZBBA..DBBH..hAFA...bGAGIGAFhAAAAEHGCFBH.MADCeCEH....fHGHhBAAaGGA...hAGA...,1,-20,-26,6
cYUSTNdbgWLIVZaMXJAFBOQDRKHPeCGEf,OEEHQFFBDBFCHCEDCEBEGCDD.EHAC..fGGChAAAUAAESAGDTGAENADCdADGhAFA...bFBAWBBBhABAIAHEZCAH.MEIDXDGHAIDGBHHD..hBAAKHCA.....hBCA...,2,-9,-8,1
QPLWBKCFeUYNfAODGIVcMaHXTJRSEdZgb,OABGGGBF..IDEGMFHFHCFH.TFEHSFAA.hAAAdBADbFCBQFGEhAAALAFABCDECAHGFAEEYEAEhABAAHEDDGAFaEBB.XBDCEBBB...gDFHhACAWCHB..hADA...,1,-3,-20,17
ESMUcHTRdFgVWKAfZXLbNJCIeBYDGOaQP,XFFFLFHFJHCC..eBACDDFEGACDODEAQAGFhAAA.EGCHMAIDUDAChABAHDAE.dFCDFHECgEEBhAAAKDDFACEC.fBAA..hABA..NDIGCHAAICCEhACABAEF.aGAB,2,-14,-12,2
dAfBFgeOLQXJaGVEcPWUMNCSITKDYZbRH,FHAGOBDALBEA.QCBFaHACECCC....PFFAhAAAMCIFSHFEhAAAKFAGDDFCZBADRGCEAAGGBDFFeAFEXDEChABAJDAFGEDG.cDFD...NABBCBBBhAIAIHHD..hACA...,1,-9,-18,9
CEBPdAJKeNcRaQXfZSFVUWHDMOILgYGbT,KGFAeHDARCCF.QCEGZAEH.FDAEUGBHDGEE.MBABLEDA.hAAAGABFCBDEBAHBPAGDhAAAAFFF...cGAHhABAXDAH.SEGGWCHH..IHHDhACA...hABA...,2,-49,-4,45
KBXNeMbWZgaFAVcfTOSEQYRHUdDCGILPJ,VGCCTDAE..OABHSBGC.ECCAQACBHFBHDFFGCADChAAALFABKEDE.NFCFeCGBhAAAMIFCZGDGFAHFACECfGAGhABA..UGGAIBBAJDDCBDADhADAWAFD.aEGA..hACA...,1,-2,-16,14
HDfERWCABQZPecIVbMgTXJNLdKYFaUSGO,BEGGQBGAZCAAeAFA..IDCBMHEE.XFAHJCECdEBE.hAAAKFEHFBBESACBhAAA.HBAHDABGfHCDhAEAWHEGCGGHAFCDPDGB..cEDDhAFAgAEF..NCIEaHGEhAGA..,1,-23,-24,1
eGaFETRZJWNOBdHLPVAMSfCUgIYXcKDbQ,SGACUAAH..IDDAXDFDDCGDeBCGGEAEFHBARDAEZFFGhABA..JAFEOHDChADA.dAHCHEDB.PHEChAAAAEFBCDHD.gBAEKAEDaFCF.EGGG..hABA.NBICBADE..hACA...,1,-2,-23,21
PcMCXGgFJLdSVQAeabfOYIREBKTNZUHWD,aAGHOFBG.RFFGBCAFTDGC..ZDECHCBEDAAG.MAFDGABFJGDGdGHGhAAA..SHAGhAEAAFFAfAHGEGAEKGDDhAFAUABH...cECBCCEEFCCH.LEAFhACA......hAEA...,1,-11,-20,9
bJPVCYHeRLGAFUWdgDKEZNTSaXOBfQMIc,FAEFdDFFDFCCKAADZCCF..SCCB.OGCEQGDBhABAMAAA.IEGH.hAEAJAHDVFFG.CHACeBEGhAFAGDAGAAGH.UGGEWBBFgCEA.hAHA.NIBF...aGBD.hAIABAGF.,2,-27,-23,4
APafRGTgSIUZJYdENLVcBQDOFKHCMebWX,aFCAREFCGBDH..SAEFZGAAJEAC.EGFFLABHBDHEOEEGhAAAFAFAKGHDHBAD.CGAAMDAFhABAeGDE...XCDChACAAEEC.TGCEIADBdBFB..cFGFhADADAAD....hAGA...,1,-15,-23,8
OAKNFSfJaGILZUDRBVECbWgdMcYXPeTHQ,KGHHFAEA..JECCaEAC.LFDHUBBG.BAAE..VGEACBDF..hAAA..bCCCdCHAMADGhACAXCFG.eHAChABATFFH.QBGEODAH.AFHASHAChAHAIAHFDGCCEBEC.hACA...,1,-18,-35,17
NOMRfgeQZEDCUcAXIPGdaFLWJTBSKYVHb,XFACGBFGaFAHFADBLAAE.JEHDBCEB.SGHFhAAAKHEAHCBFOFCCMAIHfGCAhABAeAEFEHBCCEEHAFBAPEFBhACA.TCBH.....hAEAYEDH..hAFA...,2,-36,-5,31
YEBILSHTgKNeAFfcUZXVQDMGbRJaCWPdO,FBFEUCBEZFBEQGBAGDADRBAC...CHGHdFEHEGHBBADCLBFGHDFGhAAAKACEAGGB...fAGFhAAAXGDEMIAChABA..JDHFaAHFWFAD...OBAHhABASFAF...hAFA...,1,-6,-27,21
JDRYedOUALFMIKETPVGCWZBfHNbcSagXQ,MFEGEEFE...TDAHVGBEGBCF.CFAGBBBFHBCGcGDHhAAA..aAAGgGGEhABAJDBCDEIB.RBGHeFBHhACAOBFALAFCFGGCKFDE.WDDGfEADhADASABA...hAEA...,1,6,-23,29
IdagHBYeWfPOECAVKGRSDcLNJbZFMXQTU,KEHDSCBELDCF..JDFDFCAH.MCCCXEAH.QGCAhAAAIAADaAFGBHFGhABA.eAFE.fECDhACAOAHFADFDGGCBDGGEbABA...ZDFBdCFBhADA......hAIA...,2,-25,-19,6
UaGMPJWTSbNHKOXeYQDRLcdIFEBgVfCAZ,UGFDGCEFMCGHJACE....SAAHHDAEKCDBeHAGDAHHLEEDhAAAIAAGBGADVFBChACACFGDACDA.ZFCH.aHFEWADEhAHA...NAICOBCGXCAE...hBHA......hCAA...,1,-16,-24,8
dRGLTgDZXIYSbACcVaOMBPFeEKUfHWQJN,CEGEVCEE..aFCCMEBHBFFE..FECHECBHKACCHCEE..QAGBhAAAJACAdHGFLHBChAAADIDAZEEG...IBABhABAYABFAAFAPAHDfGGD...hAHANCIA.TDCCSHAGhAFA..,2,-25,-18,7
FGeUZfLCXaIROSDVJgEMWQdAPTKHcbNBY,TEEHKDEHHDGB.....NAEHBAAFFGBFUAEBZBBELDAAhACACAAC..IDHHhACAOFBGDHCCJDCEEGDEQGEGhADAABBD..cGGC...YDADhADAfBGH.aGBHhBBASAHB.,2,-30,-14,16
gJNMWFHLaQTGbBSXDEcIYVAKPUZdOfeCR,KCGFZDEAdACEOFADCGDF..RFAF...JEHDMAFGFBBG..HCDHLBAFhAAAQAFD..hAAATFFGBFFBXDAEhABADCFCIHHHAHEB...PHDC.fCBEhABA.NCIGaDDHhAEA..,2,-37,-17,20
OgPAJHKFQVTDXGCENLRYbBMfeUSdcIWaZ,HCAEQADDDFHBCAECLFEFRCDBBCAD..MHDGeAFFdCGB..IECDhAAAaHAAZFGDOAAAhAFAADIBKGFBFHAC...TABAhABAEDGHNGAD...fCGA.SGCBhADAWCCD..hAHA...,2,-26,-15,11
AYRQMZGdbFaHXWgDJTUPKSOfLceIECNVB,QDFGMBACZFEGGDEFdAFGFHFEHFBH..XDCHDBFEJCCEUCAGhAAASDBF.fBHGhAAALHDGIHHFhABANGBFABCB..YHAEaAGA.WABEhAHA.PEHDKADC..hAIA...,2,-29,-4,25
ZTbMaNBASCVRODgUcHGEPYLedfQIXWJKF,CEGDVDDBDAEC...UDGEHFBCGABFEEEBLCECdGBH..IGGChAAAJABHKGGC..FHEETCAHhABA..aAFEACGASHAGhACAOCAB.cAGA...hAAA......hACA...,2,-32,-16,16
BRAGVCOIFeEXTQYdWgZDPHJcLKMSaUbNf,CFGFOACHFEAB...ECGG..QFDDdHGFZFABDEEHHCCALDFBhAAASAADaAHF.NICDBGAAhABAABBBGADF.IEHGhABAeADCTCGH.WEHH...hADA......hAEA...,1,-19,-22,3
fZOXYMdBFPUaARDJHebCNSQcKGEgTWLIV,DAIFeBGHCCAF.QABBGDCB.EFEH..TGGAIHHFZBGFOGAGhAAAMFCBFBEC.PEAFhAAAACCGJABG.HDCH.SDHHhACAgBEB.LHAGfGFAhAEAdFGB.BHAD...hABA...,2,-21,10,31
TDYUeQREJbdNSgICZVXaKAcMHLGPWBfFO,MFCCHFAGLAFFGGBFBCAEFFHDDGFBUADHRCAG..EEFBdEGB.SBGFhAAACABC.XFGHhABAAIAGPAHF.OEDFhAAATCDGQACD..JEAB..hACA......hAEA...,2,-23,-10,13
VFAPeMWQRbJGdNYHaXCcBfDEUZTLISgOK,MCDAREFFGABAdHGDHGACCFAF.BDAGEEDBZCFCLEEH..IBHFhAAASABA.KCCFhAAAAAECeHAAQAGAhABAbBDF.JDFCaHEC.fGAHDFBC...hACA......hAEA...,2,-19,-12,7
bDAENHGRITPYCcWdfQMgVZaeOULFXBSJK,HDBFRCFB.TAFFCBDEdCAH.MFIBZFAE..eHCCOEFGLAFCBDDDJGDChAAADFIH.ABCB..ECAH.hAAA.IGGB.hABA.PACA.WHDG.fBHChAHAgDDEaGGFFCHF.SEAChABA,1,-22,-25,3
XIBDMVSeTbFAWaUgCKfOdJHPZQYELcRGN,UBDCKGDHOAADHEACZEEF.EBGDLBGD.RFGBGDBDIBBGhAAADBFHVEGBeEADTGADhABAAFIH..aFFBCGDB.fADChAAA.dHAH......hACA......hADA...,1,-15,-17,2
HPVTLaYSBbdNQEDeFZIgMOcJUWRAKfCXG,KDGACCGGGACAHDAG..TACALHAE.aFBASGCCBGEBdBEA.hAAAQGGDDIECZBAHMAFGhABAOFEG.cBGAhAAAJEFC...WAFFAACHfBGD.hABAXGGF..hAEA..YHAA,1,-12,-23,11
aSWPGLOCIMFYRHXKEcABJDZQfbTNVeUgd,JBCHZDEBQDCE..bAEETCADeEEE.UGAEdBAEaHGASBFEhAAA.PHFGhABAOEAB.CFDBICEEhAAAMCCC.FGDHRDGBKABGAGCHDIACNAEF...WFFGhABA.....YBHBhACA,2,-21,-13,8
WHJRYNgdLMTVFXIePfcSAbBEUZKOaQCDG,BGBCUABCODGBCFAFGDDDHEAH..RBBC...NIEB.dAADLDDDhAAAMIECFHBEeBDE.fHCFhAEAAHABEAEGZGFAKDAGhABADFFD..JAHF..gEGA..hADA......hAGA...,2,-24,-11,13
FgKUaJfMdLeOBZcPXCNQYITARSDGVbWEH,RGCEGDDF..bEABHFBC.KHFEUEGGaABFMAHBdCADLAGBhAAA.BEDE.ZABCcBEBhAAACCFF.QDADhADAIHHCAFFDDIAC.EADA.FFGA....hAGA......hAIA...,2,-26,-12,14
JCgcTfYaLWGQBZPMOKUHRIdNbFeVEXSAD,JGDECHFF....TFAHaCCAGCGGBACEZBBE..MAGHUDECREAAdHAHhAAAFHCA...EADGAGGEDAIDhAAA..fEEDhABALBADQAFAOBBHKGHHNIDBeFCGSBHBhACA...hABA...,1,-4,-30,26
KPMcNLeaZBHTDGSRbVgYdEUOQFCfXAJIW,JAFFKFGEMDDCLEDCZEED.BHEDHABD.DGBHGCAE.RGAC.bAEE.hAAA.VABGdDACEGHFQGGDhABAFFCH.CFFGAAIF.hAAA.WAHH..NCIG.aHEESAGBhAEA......hBAA...,2,-18,-13,5
WBIbELUMdSfKeQYGDaJVAcFRXgCNHPTZO,FAFERBEGCGFH.HCDDZEEG.OHDCBDBG...EGHHMGACdBBH..KFFBQBBAhAAADCFG..JFAHhAAAAABE...XCGAhABANAED.TEBBIHBG.LDHHhADASEGBeEBAaCAC..hACA...,1,-18,-26,8
fMQXeZOPASDYWKIRNdVTGbcgUJBCFLEHa,DFAGKHFERCFGdAHAGBCE....gCAGUAACBHABCDGEEFFDaEAH.hADA...MFIFeDDEhAAAOFECAEEDSGCAhABA.IAEANECG.TABE.cGAHhADALBEC..hAEAfFHA.,2,-23,-20,3
dFPLIGfNYgeCBAcJKQaODXHbEZVSWRUTM,JBBEQGGH.aBHFODEB.HCGFbGAC.EEAAZBAG.SAAChADAUAGDMDAGPFCEhAEALGFCGAEGNAAD.hAFA.eFBFBHDAKGDFDEBD.....WFFEhAGA.....hAHA...,2,-18,-1,17
KTIUGMWfaYAVCBeDEcPRdNbLFSJXQZOgH,BBCAeBAEDAIHEEGDRBEHdHAD.LECCFAAH..JECBQGEEhAAA.OAEDKEAHIAGChABAMCGFaEAD.ADACCGHE.hACA.NBIE.SBHDZGDE.....hADA......hAEA...,2,-40,-16,24
eISKUOFfRTacJWNXGAQHBDgMYCbdLPEVZ,BDEGDBAGMCDACHFFLCGH..VDBBZFFCeCAAKGHD..FGAFRECF.hAAA.aACAJEFD..XAGEhABAADIBHAFC..bDDFhAAAEGAB.SBFD..fACBhABA.WHDG.hAFA...,2,-27,-24,3
ESNBecZXMGaWUdgJKYPOCVQRLADIfHTFb,DICAHCBGFFADECGABCBHZEABMHFC..aGHDdFCH.KACE..OEEChAAACABD.RADD.IFGEhAAA.TAFDSDCHhABANIBH.XGEAWDFG.UCGG.JAFAhACA......hADA...,2,-35,-11,24
ZgcSBVAYRfFeHDQWKGPMNaOIUTXCbEdLJ,RFDHeCCHHABADEEGQGFHGEAC.MDDFOAEDUBGC..CEHEdACBhAAAJEAHZCEF..SGFHhABAAAHGfDABWHCChAGA...KAHHaAAHIHHA..bFBDhABAEFGE.....hADA...,1,-6,-21,15
abdRYIMOfZHJTGUcWPDLeQBASFCNEKgVX,SGEBFFFGEFAA.KGGA..VAAH..aCEGdCDGRCAF.MAHHOBHHhAAAHFDFGEEHUBEA.hAAAPFABDADEeGAAABBGCADF.hABANAIG...XCCDIHGBZFBB...hACA......hAGA...,1,-7,-12,5
OQAGLZEXaIBJFcPRYKfeHUWVdTNMbDgCS,.ZBDFEDCHaDAEBGGH.FEFFRFDBKAFHHAED.UGDHdCFD..MBIHDABGCHBE.hAAA.SABChAEAAGID.LFFAIAHEhAAAPFAHeBBETCGC.....hAFANEAG.OHFC..hAHA...,2,-24,-21,3
PVfSagOXRWFCMNYDTKHEBUAJebQcLZIdG,eFCFQCGFLBDGdADHGABE.VEEFaAHFXGFGhAAA.RCAACEEANDDCDIGGKFAHBEGGhABAAGBD....cEAAhAAAIHDCSHCGOCFEMACGTAGAhABA.EEHF....hAEA...,2,-15,-15,0
MeRYgTPCFZXIUHBcQfWadOLSJbDGKNVAE,MDDDeEDFRAAD..TBDECHEEZEAF...XGDDUCFCHACE.BHHBhAAAfACHdFGDLAHBhACAbFAHKDHHACEFEAFEgFFEhAAA.ICGD.QCAFhABA.OAFGhACA.DIGC.,2,-16,-13,3
MeVGJgZDCfQAESdXcPITLHaRBbWFUYNOK,EGBGSHFEdFGE..XDCH..cACFTAEHaDEABHAAhAAAFAFH.UBAB.OGDGhABAeDHFVGAGJAHBDIGGhACACBACfFEDAEEG.IEAE.hADAHCCFWEAF.NDIG.MFIFhAAA..,2,-24,-6,18
RDZcCaVYUQgMWeXGPfISBKHTNdEJLbFAO,OBCBRCCFDBDGZCFA..aEDEUEFF..MAFF.eAGFXEAHhAAAGGEF...IDHBhAAASABDBDDDKHCAhACAHEAFdAHCEGEBJBAB.FGGHACHCcEGCCDAF.YABChAGA...hADA...,1,-5,-27,22
DKOXIHbBMdCRLNZVefaGEgFWQcUYASPTJ,SCDETDCE.DBHFKHAA.OAAAHCFBBBBHMAFG.CGABRDBCLEGBhAEAZFGD.eGDAaAEAEAAFhAAAFBFH..QBBFhBAA...cBGFADABPFFHJEBH..hACA......hADA...,2,-26,-4,22
FeQBULRadSXZDTJcfbEGCYWNPIHAMVgOK,VFAFOEDF.KAGCQAADLCFFRBACdFGD.ZBCDDEAD..JFCA.hAAA...bDBDCDHC..hABANAED.ICHCHBEBAHFD.hAAAMEIBeCAFBGGFaHCE.XADB..hACA......hBAA...,1,-6,-29,23
YPQcRWZIbGVgFEOdCafXAKNHJMBTDLeSU,HDFGMFFBDGDDeBDD.SAGCUAAG.QFDFRBGHZAEDGDBFhADAFBBDOEBFCGHH.aGGEhAAAAAEBKHAABBHH.YFAFhABA..PEGBIBED...hAHA......hAIA...,1,-1,-33,32
EJIKScDTBMVCfbOFZgdGHLQYePXRaWNAU,EGGCJDCB.KBAFDFFH..BDDH..CHAH.OCGFZBBAdDAAHFBB.LAFGhAAAeAGFREGD.aFEF.hAAAADFF.SGGDhABAMDBB..bBBBFHCE........hACA......hADA...,1,-20,-40,20
dNIRbHJKWVQCYTGSXBaOAeMDPLZcFEUfg,DDGBZAFAECAGUAAB..dHCHRADGHDAGKGAF..QEGFCDHA.GEBHhAAASGACBCEBaBBAhABAAICGMHFE.LFEFhABAFGGHfCGE..IBHChADA......hAFA...,2,-36,-14,22
WBPRIdNDFeAVXCMOJGQKUZTcEgafSYLHb,CEABJDHFKFGGZECH....EDGAaCFG..SCGCHCADBHGERBAE..hAAAdADHDEAB.AACAMAIDhABAOFDBGACFQGABhAAAUEEB.TEEB.fDDFYHAA.hAFA......hAGA...,2,-23,-22,1
eZLGHEBSUgJMIacObTRPWfFNXAdKDYQCV,KCCBDCCCQCGGCGAB.ZFCFHFEABDABUCFC.MBAEaGAGOCDEhAAAREAE..fCAAhAAAXGFGAGGCdHAHeAEEhABALHDGEABFSFECIHHB...hABA......hACA...,2,-27,-17,10
aMJWAODeZFUYfPBRISHQCKXEcgVdTLNbG,OEFEZEEHUBDA....fBFHBBHESHCEHDADCCACXGDGhAAAEDAB.VCDHhABAdGAGTBACLAFEGAFEhAAAMBBGAGHBDIGEFCHFREGH..KDCF...NABB.hAHAaGGH.....hAIA...,1,2,-15,17
JSgHORUDbVaXfLMITAeFNWdEYPGQCKZBc,FGBHdCBDEBFFGCCC.QFGGKHFCBFFE..SEBHHACGOAGBhAAADIBE.aFABLDHBhAAAMIDEAHIDeBAD.NAIC.hABAYEADCGEC.JABG.UEDC...hACA......hADA...,1,-4,-27,23
dXZROgQNAbLfSTBIEVaFMCHJDUWcPeYGK,LBEDSGCATFCFEDDA..FFBGHAACDDAG.UFAA.PFFGhAAAeDGBKABC.XFFHhAAAOAGB.QAFGhAEAABIDBDCDaGEDMIAGCHHC.JBCG.WAHH..hAHA......hBAA...,1,-13,-20,7
QOPVSMENbXWFGIZDcLYfgeJaUHBTACdRK,RDABKGFCQFDCOFCF...SCCEMCHHEAEH...XDGEhAAAFCAEZEADDABELAFFhABA.fEEBhACAeAFHUDEBBADEAHIHCHBA.dGHCNAIG.WAHF.IHFDhBAA.cGBBhBBA...,1,-19,-24,5
FAKcNEbMdHQeTGaOXYUDVRICLPJBfSWZg,KFBBEAACdHEBHAFF.QBACGCCCOCHBUFFGDCIBRAFHLFBDhAAA.BCBEfACHhAAASADGZDEGADCCNGEF.eFDBhABA.aEBG.YHAACHHAWEAF....hACA......hAFA...,2,-12,-12,0
SOdTPWGIECAFNBJZMebXDLYVHaRfgUQcK,FAFEJDADZBCAMDDE...eEBHDDHHLADEHGCGRABEUEFCKGDB.OAAHhABAdHGF....TFBGhAAAPHFC.IEAAhADAABHFBFEB..XDDCYAHB..aBABhABA...fHABhACA.,1,-4,-41,37
AJRGPXDQCSVBabLFMWcHdKefNIYgZTEOU,RDEEXFCHQECG..SDEAaAFCFABH.MCFEHGDGKGGBNDBG.hAAA..ICAGhAAA.ZEABEADBAFFHJAECDAGCBCFEhACA.WCHHcEGGfGGD.hABA.YBBC.hAEAOHDE.,1,-7,-18,11
EDbQJKPRWSFOYegIMNVLTcXUGHaAZBdCf,ZABCBDCFdDECEAHBDGDE..JGFGKHDE..RFBE.FDAF..OBEBeCFG.hAAAMIECLCCD.hAAA.XDFEUGAFaGGGhACAABBHCFFC...fEAAPAFG.SABEhAEAIHHA...hADA...,1,-31,-34,3
JQEgVWIALcCYdUeZbTKFSBXaGfOHMRPDN,CFCAUBCHZBCG.KGBHBHDEGEFA..OEAAMDBD.DFGF..JAHDEBAHhAAA.....VBGBhABAAEEELFDB.hACAdAFCTGAGSAABaAGG..fEEFhADA.PFHHhAEANEAAWFHB..,2,-35,-32,3
AegPFWRJSXcBZLIKNDCbfMYdTGHEUQaOV,eADAFHAARDDA...JHDASBBBBABFZCBGLAHDKDHD.DGBGCDABMAFEhAAA..dCFATGDBhABAEGGD..aEECAHHC.hACA...gBGEWEAD.IFBAhADA.fFFGhAEA..,2,-41,-25,16
BDbZKaXRSLUINfEeQPdWCATVMOYFJgcGH,MDECOHBAFGAD..JDABGEEGBEEGZEGDaDBE...RADB.LBAEhAAAUABE.IBFFhABA.EEHBeAHDdDACCHHEAGBETCFGhAAA..gAGBDGFH..hACA......hADA...,1,-18,-33,15
KdgBYeRELVDHAcbaZFOCXJUIMPSfWNGTQ,aFDDZGACFHGG..CADBUCEAMDFE....SEGA..hAAAfFAE.hABANIADGCABTBBBKDAHhACABCHCYEEHRFGDEAAFDGFBABGGOFBCIAHGWADHhADA.dAFG...hAAA...,2,-33,-20,13
BbeXWIcOGHKJAEMLFgdTYVCaUNDPRQSZf,EGDFLBBDFBBH.TCDHCCFA..UFFGDEHFQAFCZEABBAGE.hAAAeACH..IDDHhABAGGEDKEFF.ACIHMAAFhABAdAEE.aFBDNIEHSDGAfEAGWHAAhACA.....hACA...,2,-42,-2,40
JPMWCaRHZgNdKbeXADSFUTBYLOcQGVfEI,DEEGUDECBCCBLBCH.QAFFVFBC.EEAFJCAB..MIEGhAAACCEGHFFAZEGDdABGKAGA.hAAAeAHHAHHB.FGAEOABAhAFAfFCB..IEHG.PHDChAGAaAEH...gBFGhAIA,2,-31,-12,19
QFELBSPDcZaAbJXfINRKeMWYCVUGOgHTd,JBHFXBCB....IHAGREADKAGCMFGHCFDE.GCEDHCACTFFAhAAAFBADBEHDSFAEhABADHCEZECAAEEC...hAAAfDEE.NBBH.WHCA..YFHBhACA...hABAOGCCQAEC,2,-21,-13,8
MRgdHTcNJEUDZKbCQGIOSLWeFfVPXAYBa,BEHARBDEdGDCHEEG..NCAB.JBHHUFCDZEAD..KABECGAE..GBFAhAAAOAFGLDBA.hAAAFGGHfGHChAEA..PABGADDH.MAIF....hAFA......hAGA...,2,-34,-27,7
WZADBUIKSJVERHQNgcTYfXMbPGLFOadCe,BHCAKDAC.JCDCEACB.RFADHFCA..QCAH..gCFAhAAATAFCXEFBhAAAMCIDbGFALFHBhABAOAEGCEEGZEBGAEHDIBABNAIA..YFAFhACA.fACHhAFA.,2,-34,-11,23
ULedSNFbVTAfHZIYEgCJRMPQBaOKXcWDG,HFBHZDDAECAGCAEFRGDC..MIAEBEEB.KDAGXBEC..DAGFLCHDhAAAeBHFdCDBNADDFGDChABA..TABHAFBDIHGHhACA....gGGH.hAIA......hBAA...,2,-31,-27,4
ZEBTNgIYOcabCMfLDPGSeKWQHVXFJARdU,UBCGEFCABBFA..TGBC..gADCOAFD.aDECCDABLEFHhAAAGCAGKABEHFDHhABAFHAEAAGEdAHA.IECBhACAbFFA.DIGGPHEGWFAF...XCFAhAAA....hAIA...,1,-17,-24,7
UFNHAdbVXMfILQeWgDEPSJTcaYKOCRZBG,VEDAXFFC..MFCDLAFE.QBAAeBBEDBEASGGFhAAAJADFaDGC.ODAGhABACEADBBGDGCEFhACANDDGAABC.fFAG.IHHDEGHH.hAAA......hAEA...,1,-15,-29,14
OVMRSdHNTPKJQeYfFCEZbBAGUXWaIcDLg,UCFEaDFA.DCAGLABF.OGCCRDCHdEAAHADA..NADGKEEHhAAAQGGF.eHAChAAAFGHFZBEEAFHF.XGABhAEAIABD.........hAFA......hAGA...,1,-28,-31,3
EQARTIBgFaVSWGLdOZePCDUKXcMfYbJHN,RDCGTDGHBHEHFHGE..VEDDGBAF.dCGHeADF.DGABKAACMIBAhAAA...YCBBhABAbEADHAEH.EFFCAGIHaGHHhACA.SGFH.WAFH..hADA......hAFA...,2,-25,-23,2
IDaBXLfCFVeEOSWMZcRNdATPQbGKJgYUH,QBCBKCCD.JHDAgFGB.UAFDHFGD.DDFEBADBhAAAXAABLDEAhABAfDBGFGCGEACBSGADhAGAWEDG.MBBHcFAHNIDB.AAHBbBFEhADA......hAEA...,2,-31,-19,12
RTBQbACOVFIdgZPJeaXUMfDScGWYHELNK,OBAEVBBH.FDBFdABFZFBE..eFCEUAGEDIAEGDFAHDEELAHHhAAAKDDA.RFAEBHHBhAEAAAAACEAG...IAFAhBAAPADC.XGFD...fEHAhBEASHDGWBEA.hACA.EFHF.,2,-36,2,38
YDRHbZcdQTXNKCaIBMVUPOGWFAeSEJfgL,SCGAJHCALBCFDGGDHEFCZEBA..dACFQBEE.TEADhAAAKEHFCGAABHHG.hABAUAFE.OBBEhAAAWAEEAIGEEGEFfFEE..gDEGhABAYAHB....hAIA...,2,-33,-16,17
ZHAPgYITKFULdMSRDQcCXeVJfWBGbNaOE,....PHCCgGCG..TAFDFEGFdCCCSCGHhAAAQBEGCEBFeBDFfFAChAAABEEBbFGDaBHHEFEEhABAACBHIGFFKAFCMIFCDABC.XFAGJABE.hAIANAIC......hBAA...,2,-10,-10,0
BfNZQCGKSIebdXUDLHATWJVMRcEPaYFOg,JBDHMBFA.RFEG.EBBD..aDCAODAF.BHGEZFCFCCGHGFCFKACH.hAAAeHACdHAHDCACHCFFAAFA.hABATAGB...hACAWACCPEFA.FEAHNEIA.SBEGhAEA...IHHBhAHA..,2,-21,-19,2
EBVTCURWdDcINXOLQbSKaGgeJfPZMAFYH,HGCCEFFABDCETCBGUCGHRDFA..DCGE....NHCD.OBAGLBAGhAAAbADB.KFAD.aFCGgFBChAAA.fHGFhABAMBFFABHEFDAF.CHGA.cFGB.IAHEhACA.SBFFhAGA,1,3,-41,44
VdegbaYHFCKZQPEATOURcLBXWSMfJDNGI,UGFFREFABCBA..XEDBSAAA..MACADCFEGDBFhAAAdCBDeAHFaFAEHFBF.CHAGKBEEhAAAQGDEAFFE.hABAOAEE.LAHHfEHGIGHChABA.....hAGA...,2,-29,-17,12
ObSPNBVfJMUeRaWDIEGZYTLCXQHKFcdAg,ODGBSHECBGHH..VBFHMIDCRACC.DACGGAAGZBDF.TFGDhAAACGCHHAAH...KGADhAAAcDDCdDCAACGA.gFAGhACA.NBIA.JAFCaHBEEEHH....hAIA......hBFA...,2,-27,1,28
fEWHDCPJMZBYeFSgGNcTOLIRKVUXAdaQb,dFACQDEDECACHFDECFCG.MFFCBHBC.eEAFSEBHGABB.TAEFhAAAOBGDLBAEhABAKGGAXCCGAHIFaHDEfDEBhACADAEG..PBAB...hADA......hAEA...,1,-8,-19,11
OVDHLYbMNAeXfGEcTIaWBZgKdSPCFURJQ,XDEHGFCBECEF...TDBGIAEAaAHB.BBBDZABAKFAFPGCGhAAACHGF..FDFEJHACOCAGhAAAHDADLHFGhABA.MAGBAFHG.fGGHcAEA.dCDChACA......hADA...,2,-15,-11,4
MaQBUWREbIgSYHNXJdfAcKOGLPVDTeFCZ,KHCELCDADFEE.eAECCDGH.ZFCD..aAHBQGFD.UCAChAAAEFBG...IEGChABASBDA.NACDdHFDhAAAAGBDOAHFGDBH.TBAHBADF...hACA......hBAA...,2,-35,-24,11
ONKcSGWVeEXITRMQaHCBdLYDFZAgfJUPb,JFFFUFAE.ODFAKDEEGBBH..VGECeFAH..EACETEGBhAAAQEGF.CCBFdGCAhAAALAEG.DHCGhABAABABgAGHPCAHcCGFSCDHhABA.XAEBIHHGhACA.MICCBFEC,2,-15,-8,7
EKFeIZTOaXMJVNfPWQcCBgLYHRbADdGUS,DHEGUDBAKDDFFGDFZCAD..OBCC..aFFCMACA..JACA.hAAA.VGFA..NIBD.hAAA..fEDDhABAQCGHBHBGLGAAYBEC...hABA......hAFA...,2,-44,-33,11
GTRYIegDOAWcKbJMHULPXQECdSBfFZNaV,KBCAMFEHUDGALCAH.QCCBdGABSCAFFBHHZADA.aAAEhAAAGEDC.RAFGeAAAhAAADEEEAIHG..bGAGJEAEPFGHhABACGGFBHHA..NAEH.......hBIA......hCDA...,2,-26,-9,17
PFdSGIBODTQeUXgMCfaWZcNRYHVEKLJAb,FCAEGDACBAFEDFIH.QDFCeEEBUGGHMIDC..aDFAZADAREBH.hAAAHDCA.EGGDKBEFAIACdABChAAASABE.hAEA.IAHFOAHFXGCDCCHHcFCE.NEAC.hAEA......hAHA...,2,-30,1,31
NCRXIMUdgTBDVPefSWQFJHAGEOYLcaKbZ,OEHHLCCDKBAAZGBA.CHFB.RFDE...XFGEUAFCdDBF.BHBAhAAADGCCeEFC.SDDBhAAAFEBDAAIFEHDG.aBBG.hABA...NAEEMDFCVBFAfAEFhABA.WHAG.JDAB.hACA...,2,-34,-11,23
cbZKSACVDeQIWPOdTUMgLBNGFERJYfHaX,CFBADEGC.eHFAQCDG..ICAFOABCUFGFLDCGhAAABHADFFCCEHCEJHBE.HABGhABAaDGC.XAFFhACAZAFGAEAD.PFFCMAABNEFG....YEAHhAEA.fAHAhBAAKCCD..,2,-27,0,27
BAQfIXeZgJLVHRPEGCFDUacSbTKYMWNdO,QGFGXFBDZBBELDAFHEDB.EHBGCHHCDAIDUDDF..SAAFhACAbABE.TBFChADAKAHDMEIFdDDFBFAGhAEAfFCEIHFBeBFBJFFA.....hAAA......hABA...,2,-17,-9,8
GCYgWODVPcbKIRefLMFTUZBJASQNXHEda,QGFDXFCBdHABaCGBGCCH.CADH...gAFChAAAOHECDAAGVFAE.PBBAhABAKFEAIFAHRFDF.hACAfEHGMIAAFDAC..TCDBBDAFABBHSFFEhADAECGG.WAHHhAEA..,1,10,-33,43
AFXLKaSPBOebUZQYHcGfTJIMVRCDgEWNd,XFGCaCHHBDDF...eAFEUEACZDEGQFEEHABFGBED.hAAAJFBCMAFHCAAA.EBBENIAB.hAAAAGDDKAHB...SHAGhABAbDAG.fGGBIHHADDDChADA.WFFDFADF...hACA...,1,4,-33,37
WLFEMdgDcJUCZQPOXVNafIRTeAKSBYHbG,BCEAHEFHGDBDLCBBECAGdEFADGADUGAACBGCZFBE..OHDG.hAAA.XABEaBABRAFDAHHH.hAAAKHDA.SFHHhABA.bAEDMBDB.......hACAJCHD.....hAEA...,2,-29,-11,18
LVECdZFBeNJYfXbUOSRTMIPQWGAKDHagc,DHDEHCDA.aABGLBACEBCH.CHGEFECHBHDC.eBFG..NAEC.JFEChAAA.XGABOEFGRAFEhAAAMIFA..IFAHhABAPEAEQDGE.AAIF.KHAA.hAEA....gCAChACA,2,-37,-16,21
ZNGPHcQDVWdUYTELBfeaRCFXASMOKJgbI,OBACKCDH..JFAH..IDFAZADAGEFEHAGDDCIBdAEC.TFGGhAAABDGB..eCBDhAAACEDAAGCAMIAE.NDBA.PHCChABA....cGFC...hACA.WFHHEABE.fBBBhAEA,1,-32,-39,7
ePZYMFXWIfORJgDbaHScQVBCUKALENTGd,EECHTFAFdHFDZABG..FGDE..XEGFfDGAREDH.DDCEaAFBhAAAHACC.QGGGhAAABCCDCCHDABGHLHAChABANAIAPBADMFCGIDAHgAFB.SHAAhABA..hACA...,2,-18,-12,6
EDUBNKgHfbeQRIPGMZJSLXCFcOWVdaTYA,EDHDDACBBBHGKBAG.HDFCeDAA..RBDBGBAAMGFCZFAFLFCHhAAA.CFGD.FBDF.cGDHhAAAOFHD.dGACaAGHACGF.hABA....NFDB..fAHEIAFCSFFDhADA.hABA...,2,-33,-16,17
fdGMCeUgRNSQBHTaWDAXLFcOEJPYZKbIV,FDFHOHDGEDBD...JAHBZAEC.KGGB..VCBAdAABCHFD..eAEChAAAREDD.QEGFhABAHBCEaAHF.AACDLFCAhADA.PEABIGAB.fGCGhADA.MEID...hAEA...,1,-18,-25,7
WcLEAPadNSBUGTQYCeOXbIRZMHgKDJVfF,aEFESGFFGCBE.QCEBCFHA.eDAGOAFA.IFDFhAAAMACCHGAA.DEHFhAAAfABFFBAGWAFAEGHHhABAdBGHBDHB.TADDbEBE.RGEGKDDE.hAGA......hAHA...,2,-13,-8,5
ZXbCFfLQWdBeHKDAEcUgTGaYSVROPJMNI,EEGHUEFCGBCE..SDBEVEADOABGMAAD.ZAGDCHHGFGEFhAAAQGCCBAHBHAEDhAGADBCAAFBF...gAEBhABAaGDH.PHFEICHB..XECEhACAfEEHWBBGhADAKBBD..,1,-6,-34,28
RGFbAHLESBgIQXYKVaTPfdWDUJMNcOZeC,EBHBBHCF.QBFFKHGE..aFEBfGFEdBDBDADGUCAEMAIBhAAA..OGACCHHAREEEFBBDhABAAIBAHDEGLEABIAAEhACAXECD.YADF...hAGA......hAHA...,2,-32,-11,21
geOadSQHVbNBZcCfWDMPKJLIFTEUAYXRG,XEDDGCDAOHEGdBACHFBF..NCGCZFAHCGGADBIH..KAGBIDFDhAAAFBAH..EEBGAHEG.hABA.RBCGaAEGSDHDhAAA..bDAEBAEDcAGBfBBDhABA.MAIH...hACA...,2,-22,-16,6
XPARKTNFbSZMULHVfDGBJcEIdWOCgeaYQ,KCDBTCGCFBGDZDBH..MFFDHEFADICCBAABEBAH.dACF..CGHBaEBHhAAAQGAD.AAFGRFDHhAHASEDC.hAIALGAGfHGFJCCCIAEG.hBAA.WBFFOEGB.hBDA..gAFH,2,-27,-14,13
GDKbBLcRSQIYWHUJOVNXZEgMaAFdePCTf,dDHACBGEGEBGKBEEBCBFLAAG..RDCDQGEF..hAAAIEFEHEAFOCFFhABANEHAXCDGEHCEMADChACAAEIHeGDA..fAHADAIHbCABSAEChABA.WHDA.hAHA...,2,-26,-16,10
OcFLVgKRGWQPEZIBTaAXbfNCdeDMUSHYJ,XCGE..NABCCHHDeAAG.UEEBSECDHCABOGAEhACALHBEKADCRCCAQFGDhAAAEEHDBHGHAAGGdDECDIBAMAEAhACA.JBGHFBGG..GACG...hAIA......hBAA...,1,-7,-18,11
SVWNcKXBeAZPMREFdLHUDJOGfabTgYCIQ,MDBDEAGFFDGEdHBD.UGGADFEAGECE..aAAC..TCEHhAAACCHBQGECVFGB..hABANBCG.KCEHBDADZACBRAEGLFABhABAOECBfDGB..bACBhAFA......hAGA...,2,-16,-14,2
PGWgCDRdfQENYZVaBTLHUbFcSAKJMIXeO,JFADMFFB..eEDBODABGACD.CGCF.DGGH.RCDHdGCBEGFDZCFGBBCHhAAAHAABFAHH.ADABKHCG.hABA.XCFD.hAAA.WAFEfCAB.NIAD.aDCA..hACALDHH..hACA..cFFA,1,-11,-30,19
IDSgNbOHPLGReAMCdTUYBZVEQcFJfKWXa,CDCGTFGGBBCAZGDE..VEBF..QAFCFAHBKABD.aFGFDCDEhAAA.SGEFhACA..bEBAHDDGLAAHhACA.eAHHMDBEdBECEAEE.cGAHhADAfHAHIDHFNIEB.hADA.OEAH.,2,-14,-10,4
XYTMegVFJQSGWEBAKPDcCHLIaROZfNdUb,DBEGHEBFLDCCaBEBZBCFdFGAUFCH..XAFBMIEE..eDHDhAAAFDFCSHBAhAAAEFFD.AHIFKEADCGAFIBCChABAfBAG.NAIE.YCAH...hABA......hACA...,2,-30,-17,13
gZTPSfQOFDHaYGVecbKJNBLXECUIdMRWA,ZCACSEBDOFDBFAFADGHBHFDF.aGACVFFE..eCCGKCEFBFBFhAAAEBACCDBE..IAEEhAAAMBAGAIHA...TDFAhABAQCGD..cAFENEAC..hACA......hADA...,2,-30,-22,8
EFKNXTYBQbdZICSOVGJLUfceWHDRPAgMa,MAIFFBEGKEDF..TFCGBGFFdCAF.ZEGHCAEGOBEE.JGFCLAHHhAAA.UFAAhABAeFAHDDDGAFIDaABH.EDCAhAAAXABA..YEEG.IDAAhACASGDH.hADA.fHDH.,1,-19,-39,20
McYfQTKDJOPedaXAWEbRLINVHGgFUSZCB,EAACLGEG.VFAEHBDC.FHEAUACHCFEBBCHG.MEDG..hAAAfDEBKDABOGBAhADAdBAAAAGG.bAFA.NEIE.SFADhAEAZDAG.cGGA....hAFA......hAIA...,2,-31,-16,15
aZMDYRXPQTUNAWEIVHCFBLgcGKSOdefbJ,EADCHFEFFBBCLDCC.GACFKGHHOFEDfFAC.aAFAhAAAMCHFDGIH.XCEEhAAAQBAGUGAGWEGBhABAIDACCGCEBCHDgECE.SAHBhABA...hACA..dGGC,2,-18,-12,6
GMHDQXcBZELYCPNfFUKagTRbIeJdOWVSA,MDCAHFFCXDGGBFGDLBDECHAF....fABEhAAAFGDDKDGBaDAFTCDF.bDAFhACAeBHBOHDESGADhAAAAFCDQAFHEGHHYECG.NACB..hADA.gGCChAEAIBAF...,2,-21,-9,12
gGIVRQSWFXJdOaBbHECUKcLMePATZYNDf,TGGGZAFDDEHBGFBF.RBCC.SDDB.FCFB.dDHAaBAHhAAABBBEEGGDCEAFUEAHKHBA.hABAMIBCAEEA...fCADhAAA.IADBWAHH.XGEFhABA.bECH..hACA...,1,-28,-35,7
UaPCdYAeZSWfQLVGFIOKTNcBRJgXDbEHM,SDGFQFDCGACEFECH.KFAFTCDFBHEARCED..XFGEhAAAEGGEMDIDUAFCCABEdDGEhAAAAABHeFEHZAEA.fBCHhACA.IEAANBBG....hADA..cGADDCIFaHBEhAEA.PHFC.,2,-8,-7,1
AIeYJbOaZHdLDUfcMSTPBCQXFEgVRKWNG,eCDBJCAE.OCBHHFDADEDCUGEA..MFCFSABEBGACCDFE.FAEEhAAA..EAEERCFBKHCE.hAAA...NBHCAEBBYAHHhAEAZABCdGHA...fGHC..hBAA......hBBA...,1,-28,-30,2
DESNPATfFacYdeUHZRCBGbgXKIWVLOQMJ,TAEBFDDA..aCGHdEFFHCAF.RECBBBHAgDAG.KBAAIHADhAAALFDAMIEChABAJCDFEBGF..PGFGhACAfHGDeADECCCCXGAA.WAAEhAEA.OHDCDAGEABBG..hAGA...,2,-22,-15,7
fQAEDegNcIdZHPMBaORSXYbTLGFWKCVJU,DFAHeFBD....NDEH.IEGBZFCC.HECCBBGCaBCDOCCDhAAAXCEF..TGGAhABALAFEFDAGCBBAJCAB.hACAfHGFEEFE.dBAFMICASDGEhAAA.....hADA...,2,-39,-3,36
VHeFcMAELgGQdOaTWNPKYfDRUXBSICZbJ,LDDHGBBEdCGDaCGB..TEGE..PACBKGGFDDFDXADFhAAABAACSAEDhACAZFFAJHDEHGAAFFBHMDAHhADAAABFEAGE...OEEH.WHCA...hAIAfAHC.hBAA...,2,-18,-17,1
GTAQMHOKcDfLPXRIBegUWdVNEYJZFCbaS,MBABOEBBDGFFLABC.RFDDBGFBUCGAdGGC.EAFEZBCFFCCGCCEE.hAAA.SCHFhAFAADFCHFBDKDEF...fEAFhAAAIHHEeHAA.WFFE.NAGC..hABA......hACA...,2,-33,-21,12
JVDSXEgebHRCFYQZGBUINPcMKTaWLdAOf,JCDBDAGCEBAG..eCABHDFAFAAFZFCA.BECEUGEA....IACFhAAA.NIBH.MEFAhACA.aGBAdGGDACFDOAHDhADAfCDH.SBHFXGAGRAEECFAG.hABA..YFFChAEA...,2,-34,-22,12
SKVDMENfXAdaTRgFbWOCZIUYQePBGcJHL,aBAARBFHFAAB..ODFDCBEE.ZEABUGGF..QFCEeHBEBBCAhACAJADDLEFGKCHBMFHFhAAA..EECA..XAFHhABAAGABdDAD.........hADA......hAEA...,1,-26,-34,8
IcZGCYPSVHeBbUgdaJKDWFXTQMRLAOfNE,OCGHEEGEZEBEGADF..CEECSADEHBADbGDE.UFDHaAAGDHAAhADAFBCBQGAEhAAALDCEADGA..IHHHhAEAcGGG....YBAD.eCHBhABABFFCdAGH.KBEF..hACA...,2,-21,5,26
fQSVaDUIBbGFAJMecCNTYWEKgZXRLPHdO,JCAEeBFG.CADC...TGAGEFHDZEFB.RDCC.HEBC.dGGCOBADhAAASAAGaFAC.UCEAhABABCCHFDHDABHCMIEE.hACA.NAEDKGDBLHAAfCGF.DFFB.hABA......hACA...,1,-13,-22,9
PBHWdaLDTQOEgUSNZXcRMGeYCfIJVbKAF,BACDHFGDaAECDIDA.ODFBEGCA..UEFESEDFZBCG.XBBGhAAAMEBB.GAGEhABACAAD.IGAGVAGBADEA.hABAWCAD..LFHBTGDANECE...hADA.cDDH..hAEA...,2,-38,3,41
aEMgKdcDSJBQFWbILONTCGRPHUXfAeVZY,VFFHaCGG..EDACMACCKHAE...dDGFDHGCBDBAFHDE...IAAChAGALDEB.OCBAhAAACGCFRDDBHBCAXEBAhABAAGBD.eACA.YDHFcAGD...SAGChACA..hADAWHAA.,2,-38,-14,24
MYKJeFTBZXWDfUgbEIANGcOHPRdQVSLCa,GCFGHBGFdCEGSDAFLEBFaBDBMABAKGFHFEBCBABHZACEDIAA.hAAA.UGCCEHDEIGAChAAAAHHEOAFGREFE.CBAG..hAGA.eCDB.WCHH.bFCENEAC....hAHA......hAIA...,1,-11,-13,2
MBCZIVKQgJWRfYbOXcGeaDHSLTdEFPNAU,BADECGAHZCEF.KGGD..JDACRBGH......bCAHOCHH.GABFhAAADFDDSGAAhAAALGDEdFAFFCDEAEIFMAEChABAQEEB.fBBBYFHB.eFHBhABAaDDD.....hACA...,1,-27,-30,3
VgFBIaNKCdGSWMOTPEXbUfQLYAJDHeZRc,DGCHZEEDRACH..VDCEBFAC...aBGGKFGBdHABSFAF.hAAAMHDGOEGF.TCABhABAXACEUECFQBGChAAAADEC.eBAF.....hACA......hAEA...,1,-30,-34,4
VeMOLBaPQEIYgKTGcHfAbZdRNXCJSDFUW,dAGBXFDASDEDFCCH.UGDC..VCFHeCGFLHBAhAAABHBHaABHEAFE..IFHGhAAAKACBTEAG..hABAGDAEcGGCHACGAFID......hACA......hADA...,2,-21,-15,6
XgNSEebQHCOZWKIBYacMLDTGUJAPVFdfR,VBFBFBGHdFHG.RAAG...XFGA..NEDA.EEEB..eCAFhAAAbBBEHEADCGEF.OAAGhAEAKHEABFBCaHBEMDDFhAFALCEHDHEE.UGAFAGAHfEGH..hAGASACE.hAHA...,1,-9,-31,22
ZcUQMYXeATHPFEWJfLCbaNSIdGVBDKOgR,TCDAHBGFEADG.JBCBLDBH.aHAAIGCFdAEHGFEHBEFFhAAADBAHKGHDOAGDZCAH.hABAQDFDMEEDeFADhACAAHHHFBBAfGFGNAIA......hAFA......hAGA...,1,-2,-19,17
bPIQSXLEAgHNUZKcWTfRBFGVeDadMCYJO,HDGHZFBGKCFDTEEABBDCGDAHeDBF..dHABMADCCFDDOACD.hAAA.IHDFQAEFhAAASAHHXGGAhABAABBDUFGDfCFF.FCABaHAE...hACA......hAFA...,1,-2,-29,27
HbOTEMRZIGdeJFNQBLaCgWYVSfAcPUKDX,UGFEXDDDOFDF..TACFRCGFGDAEdAGDFCADBBBGLCHHhAAACDDC...gGCEhABAVAEHAEEA.PFAFhACAKAHBDBABECFH.IGGANAAB.aGEFSGADhAGA...hAEA.fCCE.,2,-24,3,27
SJHgFaVbAQWeBUKZOCTMdcYXEPNRfGILD,eCACKFBEZDGFCFDD.dABC....XBEAEAHDRGEGGADADACAHEEHFDAG.hAAAaEHB.ADHC.QGAHhADAUGGHMIAG.PEBHhAAAIAFG.SDEH..gAGBhABA..hAFA...,2,-22,-14,8
JTQFEIBAUHSCaRcfKbDLVeMNWGgdPZOYX,SDEBRGDGKFBCLBEDMEBBGAAA.dBGAPBCCZEFG.OHEAhAAA..JHACFAEAIDCAhAAABABCAEIDCFGBaADGfGCChADA.DGEG.eAHBgGGHhACA.....hAIA...,2,-31,-13,18
FXKMBJSdfNIQAEcYbPGegTVaZDLUWHRCO,EDGH..bDBCGAADeAGB.TFDGZFEBDBIHUAFCHBBA.RFBDCABFFHGA.hAAA.MAFDSEAGhAAAdEHC.ICDFhABAAHIH.PHBCaGGH..WEADKDAEBBHE.hADA..fDEFhADA..,1,-3,-12,9
XFIedATJBaUZQKHfENCSWDMGgbLcPOVYR,TABHaADGZFBG..HDEDEECD...SHAAMFAHGEEDLCCDhAAAPBEEOFHB.hAAAYAGHXCGEIBEDhABAAHECBGHDKCDFNCACDHEAcBAH.FHBAeABFhAIA.....hABA...,2,-17,6,23
ceEIHQgCRMKYFDOXBPWJSNdZLaVAbUfGT,UAAAGDFCeEBDEGBCQBBFRADH.MFBCFDBADFCEBAHGJAGDdDDFhAAA.aDACAEHC...fAFEhABA.IDHEhACACHFCOFGFPHCCNDAG.....hADA......hAFA...,2,-43,-1,42
DFbZdfJERYQcGeTMLHNIKUgPASVXaOCWB,XGEACAGBDFAH.ZABCdAEA..EAGEQAADeCHBLEAGHEEGIGHEhAAAKFDA.UGBAhACAAICAaCDCBBDCFCACfGBChAAARCFG..GDAHMBGD.NIEB..hACA...SFFEhADA.,2,-16,-9,7
cEFYWMTZDBOQPSCLRabeVXKfHdUIJAGgN,GBCG..cFCCFCFFMFGH.ZFAADAFCBDAAOFGH.QCEHhAAACAABLEEFaBADhABAeACEKFHHdEAG.IACGhAEAAHAANCIC.EBHB..WHCGSDCBhAIA.....hAFA...,2,-31,-16,15
aVYUHGTNJMdWPLfZREOXSDCgKIFAbQBec,BGHHeBBG.aEFEUEFCHCAAGFAB.JDBEdFAA.LABERBFC.hAAAXGEACCAGKHDEAHHB.QCGDhAAA.cAGFhAFAYAEE.MDIDPECB...hABAfDEA.hACA...,1,-9,-29,20
VDdEeONCGBRfAQWMFYPJcSIgbXaZTLKHU,MFDBFGCG..JFGFSFBB..ICCCXDAGZAGFKEFGhAAAHEAHDCDGdBCC.OEHDhABAGAEGBHBDACAE.hAAAQAGBPABEcEDAaHEALDEEhACA..EEHBCFEG...hADA...,1,-18,-21,3
NRegGIHdDVSAMFWaObZUXJBLTQfYKEPcC,MCADaAHBZCAGUFGB.BDHHLHDE.QEFGKGBBEBCH.CFBFRAAEhAAAeDEA.GEBDhAAAdECADAGFACEBFABBOBEHJBEC.hADAfCHA...YFAFhACAcAGA.IHHESHFAhAEA..,1,-16,-21,5
LeVTAaQCGYKOcSgFDZdNEXJPRIBfHWMbU,aBEBCAEGKDDC..OEAB..SBHHFDEDdDGCEDCHJCAE.RGDE.BHBEhAAAHFAHMHEGLEFEhAAATCAAAFGD..QAFGhABA....cABADBBC.NEIG.hADAIECFfBGHhAEA...,2,-35,-23,12
ZCVYSfeRXWAbFEBPOTGLDgMdKUNHcIJaQ,ECDGBCHC.OCEFLEFCDBGD.MHFE.UAGAHBBE.JDAHaCBCQGEEhAAACAED.SHAAhABAfHDBeDHHhACAXAAAAEGGFAGAPDDBGFAFKDAD.IFGHhAAA...hADA...,1,-11,-22,11
YACdWZXKMNeJgQLTUBIFbPSaOHcDRfGVE,CEADZEFEKEGBMIDA..eACEJDCE.LDCEBCAG.FHDC..SGGGhAAAaABC.OFBEhABADGBEGBEF.EGGBhAAAADHDXBFB.NCBH....gGAGhACA...hAFA...,2,-36,-34,2
caBeYVOdfFZPWLQASJHMCDUKGNIgEbRXT,SBGCJFFBHDBHDBAAUAAE.GEBF..NEHE.EDHFRAFB.XGGHhADA..TEDChAAABADAVGAEOEAHFGEDhAFAPACG.LHBGMEGFICEBhAGA.gCBAhAHAaCCA...,1,-13,-17,4
KdgBTARULDcJGafHNVebYWPMSZIFQXCOE,UCFGLDGBDFGDGBCEaCDFHEBH..eACE..bADA.PBADhAAASFHB.IHDChAAAXFEBCHBAOGAGhABAdAHGBCCD.AEAH.JEEHfGHA.hAFANIBF.YCBFMABC.hAFA..FAHF,2,-17,-11,6
YVCRPaBbLNeOEIDgKMJXTUfdGWSAHZFQc,HDABFECBQCDAVFCERBAE.BGFHLADBOEFCEGGD..DGDGKHEGhAAAMADAJAGD..TDEHhABAdBFESCBChAAA.AAHA.cGAHCBHGaHECeCAD...IDHEhABA...hACA...,1,-11,-19,8
ADSBeYQWRUIOKFPGCZJNcXELVgdHTfaMb,SGCEeDADQCEGUBAF.OBCBFFEAGAEBCHFAZAGF..JEHB.hAAA.NICF.EAAFLFAHhABAdGCH.TCEDfFFChAAAMBDDAEAGDIACBCHEWDDFIFHB.hACA......hADA...,1,-10,-15,5
bVRFPOLDTcXeWHNfKMCQSZEdYGaUIBJgA,RCCAFFGCOEAEDAGG....TDDHXGEAHFADKBCC..CDCC.SGABhAAAdBDBaAAHBFDDhABAAHHGVCGBLHCC.hABA.cAEF..WCFA.fDAChACAZFCGECAC....hADA...,1,-13,-31,18
VdGDKOFJCaWISEMfYbgXUPRZHBAQLNTec,LDGFeBAHdCDBDHAGKDAFOEDD.FHFACCGHaEFD...SFEFhAAAECDGMIBA...hAAA.bABHXGCDhABA.RAFCBGHGAAGDTFAGcACGJAHHIBAGhABA..fEBGhACA.,1,-15,-40,25
aBdbXPFGHWKENYeDCLQIRSgTcAMfOJZVU,MDBAJFDDZDACUAEG.BACCdBBF....XAFHFFDGHCGBKGGHEGBEhAAA...eBBACFFHLBHHhAAAIGGASFBHhABA.TCDDAAIFfHAD.hACA...aFAB..hADA...,1,-26,-35,9
WGdSBUJCbAPfYIcaMZNDTXVKOHFELQeRg,...fHCBIBECMCGHDCGB..XDAEVBBHHFAFFGFEQACHhAAAeFDDRFGH.hAAAgAGBGEEGBAFBhABACCAHPFAB.aDDENAICOCAHEFCALFFChABA.....hACA...,2,-5,3,8
GZfDBMQAUISJEWCcTeVdLXRYOgPKHabFN,UBGASCGEEDAE.CGEH.eFBCLDAE.RDGF.OBBCKFBCHABEhAAAbFGF.GBEAZDEHBHEHhAAAAFIFJHBC..TGCDhABAdAGBXGGGgAED.aHAC....hACA......hADA...,2,-12,-5,7
dLWHEeZMOaXFBYJAINVgPGTDfKCbUQScR,VEDBGAEG.DGBDCCDF.UGDB..SCHDRDBEdBBDHEFAEAAHMAHDhAAAaFHB..BAGAAGHC..hAAA.IEAENDAE.hABAgGAB.TCEB.KADC.hACAcCBH...hADA...,1,-19,-24,5
AEXFbHcgJfIODWdQVRSeMGBLKCTNZUaYP,EGGBFDFFHDBE.JFCDOFAC.dCHCQAFHSCBEeBBAhAAABEDFLFHDKAEECABAZEFChAAAaABGAECF....bGBAhABAfHDH.DEAFWHAGMBIF..hAEA......hAFA...,2,-26,-18,8
CLKGMBPfAdEaQDcYIebRHZNXOWUSgFTVJ,dEGEEGBHDADA..IBFCRDBCHFEAZBFC..OAAFUAAFFEFATEBEhAAA..CBDFKHDGBEEBhACAAGAA.aGAD.QGDChADA.eAHB.bCDC.XACEhAFASGHH....hABA...,1,-7,-32,25
ZeIBDLXWVACNYTHbGMEdRSFKfOQJcUPga,CGAETGGDGEDF.dDABRBCFFCGC..KBFCQEFCUABE.aGAFeHEChAAABHEGLDEChAEA.XFCCAAABHAEEMCADhABAEHCA..SHGAJEDB...hACA......hADA...,1,-16,-18,2
SFbTRYJBOGDQZLEdCWfeXUAKNIPVMacHg,KGDC..IEBGVBDG.aGDGHDFA.FAGGTCDGRDABBHGHDCAHLHCGhAAACDFA.eCCDhABAABGBNEIA...MACGSAFFhAAA.YAHD.JABG.OFFDhABA....hBAA...,1,-16,-36,20
FbQUPcGNHTESeRfCWJgXdMLIVYZAaDKBO,aHEGBFDE.FDGCQDGEUAFH.GECBHBADEDDESACHhAAA.eFADfGABhAAACDDCgBFAXGFBhABAdBAEIHHD..YFHBAFBBDEAC.hABAKDCF.....hACA...,1,-9,-24,15
BJPEIAfZCDOLNgbSUcQXKVWTdMaRHGFYe,CFDFDBGALADG..NDDH.SEADUGAH.QBAChAAAKEAB.VCFBdGGBaCCGHFGDhABAFBABBAHC..EEEEhAAAAECFOBHF.cCDBWHEG.MFFH.hABA...YAEEhACA..,1,-17,-40,23
KQUeMaYIFgTXfWOGSbZDdLARNCVJcEBPH,CCDAJDDBBGACHAEH.UGEAeCHD...aGCGFBHD...TEAAhAAAXACCOHAEGDEChAAASEHBDGHBAABHVDAChADAEBABKGHD..MAFCICCG...hAEAWCGDdHBD....hABA...,1,-18,-26,8
AOCMVdHSFQDYfGeTbJUgNPcBaKZWRXIEL,CDBBdCAFHEDGSDEFFGAD.DGIFGBEB.TABCUGAH..NDGE.hAAABHFDZAEA.XEAChAAAEDHF.AGHAMADCQDAHhABAfGGEJHDA.......hACA......hADA...,1,-15,-25,10
SLFIgXBUVWOJCTPMHGRQcedaEYDNbKZfA,FDFAXFGABDDBUGFA..OCBH.JADHCFBBMAFARAGF..hAAAQGBFeBBDEHBA.hABANEEGZDFE..ABHESBEEhACAIAAGWFAD.....PHFEhACAcACBaAEFDEIFfCCEhAGA,2,-52,-9,43
XKfWNHEFegGBJSLRVcPCaTYDQdAIbMZUO,MADDUCCHOFCFKDGG......NIDHHBFEFBGGGDACBFHAJABBhAAASFEA.hABALHFGREBC.PACAhAAACAEDTGAGDABFAGAHZGFC.fEEDhAFAECHHeEHHcDEEaAGA..hAGA...,1,-13,-22,9
FcLegMWUETJNZGaHXbVPfSdKDOACIRQYB,CEFCQGGDBFHGLCAHMAAH..UGBBJHAC.GEEEHFDF.XBDAhABA..PCDChAAAfAGGKBBCAAEFRBGDFDDBhACA.eDBBEDCB.NCIG.aGGCSBBCDIFE.hABA....OEABhADA..,2,-27,8,35
QRKZXOPVTYWAMaCNebFEfJGUcgBIdDSHL,CFGEeECFFGDD.EBBFGBDEUGFD.BGAG..dEFBHDAFLCDAQAAChACAZAEEXEABhAAAOAEGTCGHAIAEMEEBNCIE.hADA.fGHA.JFFH....hAIA......hBAA...,2,-13,-12,1
QTCeSYfZAdcOJXbPgHGaRDLWNKFEIBVMU,OAEFJAHB...XFEB..PEGBHCAAaGBHDIDELFBFhAAAKDHDEAHDBBACVADEhABAMAAA.QGGAhAEATBBFeEEHfGDCdDDG.cECBhAGA......hAIA...,1,-14,-27,13
ATWMZUeQcNJOfCaKLFBbSdPVgRIEGDHYX,MHDAeEHDQGDF..NDABOCFBaCAHFBGEBDFFdAHA.VAAGhAAARACEEFAG.HDGBADIBTBDDhADAUAAE..fHBDhAEAKFBESHAGIHHAYAFE.hAFAWEGD....hAEA...,1,-10,-18,8
QOLMNScZEUTgBFHXCVbAefKWdDYIaJPGR,KFGBdBCADBAB..aFADJAECGDAH.OADALGEA.MCEBhAAASBCAZBFG.TCGEhAAABDHDHCAF.hABAXDFDCABAAIFAeHBCfHABIFEAQAGHhAIANIDH.EDFDhBAA...,1,-22,-25,3
BbJGKLVcQfNTXSIFWDAdZHPeOCMgaRUYE,dADAZGCGHBDCOFBFMEDARAAH.UGGHBFDGGBGCKEEA.LEAFhAAA.QBAHhABANDIG.TEBAXBFHhAAA.IDDHDAIFAIEG.CGGCaHFC...EAGEhACA......hAFA...,2,-38,4,42
fGKcIdORQEYPeVZMbHJDFagCXNALTBWSU,BEEDSADEUCFCGFBH..KFEBdBDCRDDAEGAEeDAFMCIBHGFAhAAAJBBHFABB..CGHBAGCE.hADALBEGfHAFhAEA.OAHFPHFE.......hAFA......hAGA...,1,-17,-27,10
PdUAFXCeIaLYcbKHSfZBGWNQEMRgJVOTD,CHEAaAGCLABH..bAAFHAEG.SEEFZFAGGEFEQEABhAAAMCFHRACG.gFGDhADAOHCEDDCHPHAGhAEAADHAeDDB.IHHEcDGABDDFEHAA..hAFA......hAHA...,2,-19,-1,18
MLaZgPbXTBCVIYEGKURfQFeJdDOAcNHWS,HDFASEDFMDCBLBDDZBDE..bFFHTBEBBCBACHAGIGHFhAAAGBGE.KABERFDFFEBBhAAAeHFGDBAFAIBG..WEAFhAEA..aFHD..XBGFYAEE..hABA......hACA...,1,-7,-18,11
FJWeHdYSQRbCALXgEZaIfBMDTKcVGOUNP,LGBEXBDAZDAD..fABBBDDFMFGDKBFHGGBBUFGDFCHBhAAAJAFC.eEBAHCGBSADEhAGAQABCCHBAECEDhAHADEFD...cBBHNAAG.dHFD...hADA......hAEA...,1,-5,-14,9
IdVHNUFMaPgJYbSKGLTeZfDcWCRXQBAEO,EDEHOFGFdBEHHCAGUDGB.FHGE..aFDGJAHB..SAFBhAAAKBAEGGABLBBFZEAEDGEG.hAAACHDGQADGhABAAFFA.IDEEMACAgDGGYAHD..hABA......hAGA...,1,-13,-19,6
MIbEfQcGJKgLdCFWXPOBVaADHUZeTSYRN,UGDDZEFCSFAGRAFG..MEDEEGDBQACDGABEKGHDdDAGhAAACDDFFBAH...XBFGhAAABHADAEIFDFCEeHAG.hABANAIE.fCHC..cGEF.hADAJEAC..WFFB.hABA...,2,-30,-15,15
LZUFABPeMGEWaVDfQOXIRYSbcCNgTHJKd,BECFeGFEEACBaFFE.DECG..OACDRBFB..SAHHCFBG.hAAATGACKDHBZCDBAHEDMBADhAAAVAGHQGDGhABA..IFDAcGAH...NBBE.JCABhACA..dCCD..FGHDhAEAPDHF.,2,-14,-13,1
QWfKLDJZNEdOAPHMIUFGTYcSeBVRgbCXa,HDDCUABGFECHGCAE.TGCBSBEGVABE.RGEA...gGFAhAAACAGF.aFGAfDDDhAAADFCEZAGD.NBHG.hAEAECDA.ABAFMBIF.IAFBcFAHBEFAhAFA.....hABA...,1,5,-35,40
FgUOcMYAZKVDCNQRIJSeWfPGdBaHLbXTE,KEFFDGFBQGGARDBD..JAFCeBDE...PCHBBHGCHFDBhAAAXEABFBCEOCHFhABAMDGBACAC.CDDG.ICCGhAAA.SHBEWCAF.fFDFhABA.aAGE..hACA...,2,-45,-25,20
LREKIdAGYTfSOPeVDbMHQNgFZUXBWcaJC,GEEBTEGD.OHACeEAG.DAABHCBA.QADEFAGGZFACBCBBhABAaAADJHCELADB.hAAAKGHHIGAHAEEG.hACASCGGbBFG.gEEF.hAFAXGGACDBDdHEF..hACA...,1,-12,-13,1
ReXSTFGAZOBNEWVcULIPKfaDMJQdbHYgC,OFCEBAEBEDCA..VBCCLFEH.KCFGaFBBDABH..MAEAhAAAQGAFHGFACHEDRDEESEGGhAAAFCACABAA.NAIC.hACA.UGGFIHCHfACAbAFA...hABA..gFCBhAGA..,2,-18,-18,0
NLcePDGYCXfBdUERHbSAZIJFWQOKaMVTg,ZFBCFFBCOAGHMIBA....TADDLAEBeDAEDAAEGEEBhAAACEEABAHAEBCDHACHABAHICHEhABAJGEC...KAGGhACAaHAG...NIEH....PDHDfHGHhADA....hAFA...,1,-16,-27,11
CIKbEeWgSTLNdJYcPGRQaUOfVBHAMXDFZ,MHCCDCCEFDECZCGB.KCEEeBGD...SFGGLADGJEAE.hAAA...PEADhABAQEDHOADGBAABhACAAACFCHCCEHFATGGD.NIAD.dAHC.YDDFhBAA..cBCCaDBF.hBBA...,2,-28,-27,1
cHOIVFQARDGUeNJZMXEbaWYLPdKCgTBfS,GEAAUDEGeBCCZEEBEECC..aAHFLCAEdDAFKAAG.CCEBBAFE.hAAASAACOCHHIGEDhACAFHGAAAIB.DGGEMAHFhADA.XGCHbFAA..YHBAhADA..TEGAfBFHhAEA.,1,-10,-30,20
OXVKUNQZSEFALbDYRTCJIecHgfdPWMaBG,DDCHRFDECDDG.eGCCHBEBdACA..MCAAGEAAOBHHKAFFUDEF..hAAAQGBCEBABLFHBhABATDAEJAHF.IADChAAA..fHEFaHGCBAFE...hABA......hACA...,1,-16,-22,6
EOgKCNDHTeQFbAYLGWVacBJRZfdXSIUPM,LCDDVCEC.aAAHBBHEZCFE.dBAD..XGGEUECCMBDCEHBC.hABAKFGADAFG..eDAHhAAAFDADAFCB...YGEEhACA..WHECRADE.IHAH.hADA......hAIA...,1,-21,-38,17
ASKgTeDZOEafLJUcWRNdMVCFBIHYPGXQb,KGDAeFDCDBGDZAGF.OEACEGHD..LCAFUGGHRBDH.MAAG.CGFE.hAEABCAGHFACGABGhAAAXBDBAICESGDAhABA.aCGHfEFB.WBHH.hADAdBBEIGBFYHAAhAFA...,2,-28,-13,15
SJLbXQUIcBYDfKPCEVagMRTOHWGZNFedA,LBBFQBDDUGABBBAGDAFCKCGG.CGAD.EBGC....VFFFhAAAMFCCRDAB.OFHFHAFAZBBHhABAFHFAeADBAHEH.SGDBhAAA..JEDEIDHH.hACAcCCC..YHAGhADA,2,-38,-13,25
EaCVgKSdBZUcLPMNFfDRWXHTbOeQYAGIJ,GCAHJEFD.ECFBCEBG.KAEABBBEZFGD.LAGHMHBA..FAAADHGA.hADARBCF.XECAHAEHODHFhAAAeFFFAGCC.aAHBSGCChABAdGAG........hACA......hADA...,1,-8,-38,30
QFfeUcMgTDGECOAVdRSXbNPLKWBHJIaZY,REFAXBAE..NEDALAGHBFFFHFAD.aBDGQABBhAAAFDGGeFCHUGGGMFAHTBDEhACAEDEFAABD.dGHC.SGBFhAEAKDAAJAFC.IGEF....hAFA......hAIA...,2,-21,-13,8
YJeDGOZbRMAQVLdXUWIgHKaPETFfcSBNC,QFDHVACG.LDBFdDDHUFCFIHAFHBFDKFFC.ECADfGGEhAAA.SBAFhABABGAACDHB.eAFAhACADAFGOHEERCEHAEHGWBCBaABH.....hADAPFHF...hAEA...,2,-19,-19,0
UEYKaQMGCXcLJNOHDWbVAdPFZIfSgRBTe,dGAGZCDBSGCERDEABDAF.UCAFKACD..QGGGCAGCLGFC.hAAAOCHDDFBC..VGCGhABAAABCFHBC..IAFFhADATEAAEHFC.aAACMCEE.XCDChAEA..cAGEhADANCIG...,1,-23,-26,3
eZUHFgJNPIEWQSLGKRXBAafDMCTdYcbVO,DAGGMFGHCCHA.dEDA......bDBCOADGZCFDHBACFCDCJAHD.hAAA.PFHHECBDSCADhAAALFDHRFBFAHAH.fAEEhABA..TGBF.YEHFhABA.eDFF.hACA...,1,-20,-25,5
TdABMfXPRNbHgGOJYFWeQEKIZLCaUScVD,BBGEMHFC...XEGCRDFEHADDOCAF.JGBEFGHD.eBABhAAAEDDBKBGEZFBCCEDD.aFFHSFGAhAAA.DBAChABAACFBPADA.bBBB.....YHAGhABAWHAGLCCFhACA..,2,-37,-12,25
PEHIRSfXOdKQCegDLUNBYZVJWMbAcTFaG,FEBEaAEHGGBDHGEASCGA.OBDEQBBG.CHGCgDFEhAAAUEGBBDAAZGAAhAAAJAFAMGFAABAD.PDDDhABAIADG..fCGDXDDBKAFEhABADDAD.....hACA...,1,-16,-20,4
UBNCJKafPRMVTEWgcZQdbOAeFSHDYLIXG,FDGEDGBCLEDAGBEEUCBGBACE..JAAGKHDC...aCFERGAEMGCChAAAEHAA.....hAAA.gBBBhABAQGFDOHFE.AFAASAGGIAGA.hAEACGGFPAEHWFAC..hAFA...,1,-27,-37,10
bQadLBfNWCOGYXIUDMVgKHERZJTePScFA,QFBHaDHBBCDC.....fAFHCGDDODFFGAEFhAAAICHEDDAAMABGKFADEEAGhABAZFEGJCCG.eEBESBBChACAABBD.dHGHWFHH....YDEFhADA...hAAA...,2,-26,-25,1
IEcKdfGCPgBHRVXLeAUWYNOaDTFZSJMQb,UGAG..NIEDDIACZFFASEGC..MADBQDCFhAAAbBEH.EEAEKFGCdBAGCCHGBCBAhAAAVAFBLHDGhABAABBGOGDA.TBCDFEAHJEBA.....fGCEhABA..hACA...,1,-2,-41,39
BSQaCVIPeJYcfgTGOUbMNdFZRDLWAKHEX,HAEBECGEBFEHQEAE.aEDCCFCHVADHeHFC..JCHD...hAAAfBACGDEHOHAGhABAMIAEFGEGDCAHABBDKAHFhAAAIGHHYABCTCBF...NICBdAGFhACA..LGAGhAGASFACcCCF,1,15,-18,33
CVXdYgZaUeNIKOLFAJMcQEBRbHSDGWfPT,JBCFQDFBBGAG.HEAHDAIH.GCAF.fFCHCEHHdGDFZBAF.hAAAaHBE.eAACKEFBLAEFhABAFAEFAHGGMEIB.EBCEhAAARAFB.WAHB.PAGH...XFFGhCAAYHEG...hCBA...,2,-45,11,56
eMUgXVIOYAcQCPfDGNbSJFLaEdKHTBZRW,CCHADDAAGCCB..SDGCFBACLEABEFHHHABGZFCDRFGH.eGAAhAAAUADD..VFEFOFEDhAAAABGDQDDFhABA.fEAC.NAEFaHBEdAGBBEGFhABA......hACA...,2,-18,-2,16
bLQUCTSaHGPEIYJWXdDFAcKMBZgfNReOV,KDDABHFFZABD....gECHRBFGeFGDOFBBLEHF.CBCB.hAAAaFDBGCAD.EAFChABAIHEAJCFG.dAFFhAAAAFFCMFAH.fEADNBAC...hABA......hAEA...,2,-33,-21,12
NSfbXaLPYEAgUGcQTMJFOHIdVBCDZWKeR,GABAQCBDMCFEOGAAHDECdEAABGEDCAHEDGHFKBFD..REEE.SADAhAAA.XEDChABAPBHFAAHH.gAAFhAAATGBHFHDEIHGA...WADChAIA.....hADA...,1,-16,-27,11
fFPOCUbSJLZQXDNgdWMGBHYTcIaVAeREK,eACDEGFAKDFAFHFC..CEAB.SGCGLCEDZBCBDBGB..dEGHMADChAAABADEHFBC.TAGHhABAIFEB.AEDERBABOHFEhACA..JAHH.NAFC.WCHH..cGGAhAAA..aBBD.hABA.fGAE.,2,-24,-10,14
eAICYWfcbLDGPZFUONHEBgTXJKMQVdaSR,CAAG..fFHCLDBFGFEFFFCA.OECCNBFC.BHDDTAGHhAAAKAGC..MFABdBDGaHEAhABARADDAACD...ICAAhACA..WBHHDEAHUCGF.gGAChADA...hABA...,2,-38,-12,26
FaBAGgJPXcRZVDKCETNUIWdQSLMOeHbfY,JDCGXBBDZFEG.KECC..EBHDUGBG.dCACLFBB.MABDhAAAHEFG.fAGDhAAAFAFDAFFC.GGDFhABAcDGFDIGG.TCFGIHHESFAFhACA..OACB.hADAYEAF.,2,-31,-1,30
GSHgYUXZceQNDARLdCIaPJWKbfOMEVBFT,RFAALABFCCBF.aCGCJDCE..KEED.OHCEMHFEBEGH.GAEBhAAASFCB.hABAgAFCXFEGeBBEhACAQCCCACHEIEAEWGFGEACC.VFAFhAAA.....hADA...,2,-38,-10,28
FJRESIVabNHMBYefZdDTKGLPUXQWgACcO,CFGFFDHDRBBH.ECEC....SDGAaGGBHGBGMEFHeDDDZGDC.DIBGhAAAGBABLBAFXEABhAAAQBGGAAGH.hABAOFABIAHFNBFGBHHGdADBKDDF...hABA......hACA...,2,-20,-4,16
gUXIfKLcMWHSOZaAReDdbPNCYFJVGTQBE,eEDAdGEE....bEACNCIE..FHBEGBEDBCEA.ECABUAEB..hAAAIHGDKFAHLBAGhABAMDCESEHFhAAAaGGHDEHB.CBCHJGAE..QDADfEEDhABAWAHF....hACA...,2,-31,-11,20
RDfFONbLcTXdWZEeYIUVGHMSagQKBPJAC,RDCFFACCOHCALAGD...XEEAdACGEAEAeAHFUECAGAAGhAAASFGE.aBAH.hAEA.KHEABHGGACHCDHBCfHABhAAANDIC.bBFDWFAD..ICEBhABAMEHHgCDEhAFAQEAACFBC,2,-23,-23,0
CNKLaTXfJHcdDYeAUOIEMPGBWgVFbZSQR,OCBEMAIDBDAA..VAFCZEFDQCCD.CAAAKFAFLDHHhAAA.aEAGfACBhAAAcABD.DDFAYDFDhABAeGCAAFEGEBFAWHEA..FFBARECH.NEIG.XFADhACA...hAEA...,1,-14,-25,11
ceTDNMSHEFJKGUBVRXgYIALCPbQOWZadf,LBDDCBBE.QGDHZFDAaADHdBEEeEAFDCHB.MFCAHGAAEGGCFEFChAAAKCECBHHD..XBGDhAAA.gCAChABAAEADOEHDfBAENACBSHAAUAGFhABA......hACA...,1,-3,-30,27
aIHeKfXAGgZbQUNWCORVdSLcYPJBFDMET,GBGEZFAHUDDFCFCARADAdBCD.LABF..PBCHFGFG.DFEEEAHDhAAA..aHAAeCHDKDAHAHHHhAAAQFCF.hABAOADASCFD..YHFGhAIABFHA......hBAA...,2,-33,-17,16
JPWOCNTFbRdQALgVSUGZHMeYfaEDKIBcX,LBFGVFFD.SCAGGBABMCFFeDGH..aBEADHBCKCGAIDDDhAAABFAB.XABBhAEAJHBAODDF.CDABFEHFhAAAdGDEABGC.ZFEHfAGBEFAA...hAFAWABC....hAFA...,1,-13,-25,12
QSTLcREbVUNCZHXMfAeOYWadDBKgJPGIF,eGDAODAB..aCBHDABABFAGKBBA...JAEEGECA.IGFGhAAAFCGGTDED.RAAE.hAAAEBGEUDCEZCEH.MIBGhACAfHAHAIFC.YHFGdGHG...hADA......hAEA...,1,-19,-29,10
dERaTFMWAgVePYXBbOcGSNLDUfIZKQJHC,VGFGeHDC....PACABBEGOCAH.GFAHSGADhAAADCCBUDEBICEChABAKDHDHAAEEFGBaDCHFAHHABFCgDGDhAGA.bAFE..NIAH.fGCChAHA...QBBHhBAA,2,-26,2,28
RILSXZgVNfPCaUKQBTcdYADMeGbFHJEWO,eDCGFEDFHGBEEGEGRFADSABD.ZAEANAHC...CGHA.KABHQDAFhAAABADFdDFEDBAFMBIFhACAJECHODGH.XBDGhADAfAFAaGAH.UGGC..YFFFhAFAAIEC....hAGA...,2,-22,-13,9
BVFNIfCGgPUMdcXEWZKeYDbHARSLJaTOQ,LDHFTFEC.QBAAFFCF..IADBfCFECGHGGBGChAAAUFBAMFFBdBABXFAHhABAEAEEKAHHDBEFAEFASCDFhACAaDBEBHHHNEEGgAFF..hAFAWHAG....hAAA...,2,-20,-12,8
HAPCNaYWVGZQXUEeROIMdJDBfTgbFLScK,CEAEaFEE....VACEQAEF.UCAGEAHFOFHHdDHGJHAEBEDDhAAA..TCFGhAAAFFABSABEhAFAKHAGHFEDAGBA.NDDA...WCDG.ZGEGeABD.hAHAMDIDDGID....hACA...,2,-25,-16,9
MWVSBOTHPbgcNLeJQCAIDKGfEFXdYZRUa,DBBGKDFEECADdHAHRFEH..MDID..VBEFSBCGBGHD.HEEEhAAA....gEAEhAAANHEBeFAFJFCFCBADADAGIAFChABA.fDDAFDHHXCCH.hACA......hADA...,2,-38,-24,14
aEKSAGCRPfcIdDTgMNJZXbYeFBVQLWUHO,CGAFRFFF......fEEHdCEDDBEGMFEDJBBG.ZBAH..XDGFhAAAeDHBFGFEBFABLACHhAAAUECEHBEA.hABAOHAEKHBGAHID...cAGFIBHHNDAF.hABA..bEAA...hACA...,2,-28,-23,5
HCfESKcOZXBYPbGQgLDJdWVRUaIFANeTM,TEAGHACBCAAA..SDEAOEFEBADD....PEDBhAAAGCEDQAEFhACAgGBFDGFEdAGBRFADaHFCICBDhAAAACGEMAIDKGGH.XFECLEHB.JCBFhAFAWBAF....hABA...,2,-28,5,33
gHCdWfONAMKbUPJDFRYGVLTaZEQIeXcSB,KDBBUFBHDHEARDEDGBEDLBFBZABG..QGAFeHDA.SAAEhADABHHECAHFdEGEOBDHhAEAADDE..MBABPFDAhAFA.FDHH.........hAAA......hABA...,1,-27,-28,1
fIOTaNPAHVEZcKUJYbWgBLdCRFeMQDGXS,EDFCKEEDUADB..bCAGBCHB.LBGDCHFBFABH..QFBChAAADAGEGBAASAGAhACAOEHF.aDHDAHDB.HEDHhADA.cGGAJFGF.WHAG.dAFGMECFhAAA......hABA...,1,6,-40,46
VZQgHENdLYACbWRfaOTJFMBcKGDXSeIUP,CEGAREFEOFBDFEEB.BBAHKAEFGCEF..DDFCeGBEUAFAZCBHQDCBhAAA.EEAHhABALHCG.AAFAfGHAhAAAaGGHJADBMBIFSBAF.hACAIBHAPFEH..hABA...,2,-37,-19,18
SeXITgJBDZOQGfaUNVAcKWYERCMdLbFPH,KECCEFFFRCADCAAD..LEGFFGBFHABE..SAFAXCFG..TEDAhAAAJCBEBCFA.DDADhABAQAGEGFAHaACGhAFANIDHAGHH...YEHHMFIDdFEE.PBHFhAGAICDG...hAIA...,2,-25,-4,21
fJFRXHWLTBCadKgQEUNIOSYAcZebGDVMP,ZADHGECFMHEEJHFCRBGD.HCBALCADBBHGdGADKAAA...EABC.UAEHhAAAOFFA.SAGEhAAAAGDH.bFBHDIAEhABA.fEHGFDDH..WGDCCHDH..hACA...aCCB.NIEF.hAFA...,2,-19,-19,0
YCegKWXaBVSIFGQbcDOMRZUHJNPdfETAL,CDAGKEAA..aAGASFEGGBFG.QBBDDBBHRECH.HCEBJFAB.hAAAdHFH.fHABhAAAACIDLEHHeCHB.XAGAhABABHCGIACEbECHcACFZFEEUCCDhABA......hAEA...,2,-20,7,27
OeHdZVaAESNLPQGUCIFbBTfMgcXYKRDWJ,SADFLBFDGFADCFEB.FCCABGEGMICG..XGGDhAAAKDHBDDBH.ODDEdHGBZABGAHCCEFBEhABA...QAFEhACAIFGHfAHCYFAF.WAAChAFAJBBB...eEEB.hAFA...,2,-33,-16,17
KJBaZQSXVgYIeCAcLfOTbUMWENdDRPFGH,LGECTAEA.UCACEGEE.DCIFFACGHADDBGGEQDFD.hAAASFCBgGADhABAIGAAACDFfECGhAGAMIBGdAABPEDGKBFGaAFAXCGAeCDD.CEHGcGCHhAHA.OBBHhAIA..,2,-9,-6,3
OZWEVXbHdRBUDIMeACGSKgNYcLQfJFTaP,CEFCGCDBKGCB...NAAF.LCBF.JHEGTGFD.PGBChAFAOAFH.ZDDHEBBE.hAAAXAGEdACFUBGGDDBFhAGAMBABAEIDSECC.cEGCfGAAhABAWHAG....hAGA...,2,-35,-11,24
UfCaEKHdFObPBIYDgNZVAeLGWMRQcTJXS,LCBFMFDARDAF.QFGF.JCHBSAED.UCGEhAAAaCDAKHBAdHBBFDCAPDEHhAAABHHB.IAGFhABAgAGHZFEEAFIHWBAFTABC..CGBFEGDDhABA......hACA...,2,-28,-20,8
HeMBWJSXDbcGZLdfCPOFKEUAYQTgVRIaN,TGBAVGAG..RGEA.aDDGHCAC.BDEGSCBFDABFGACBdHGFCGFChAAAFAGAKEAD..EDGEAFEEQADFhABA.hAAAgBGE.IDGA.eDCDhACAMFFE.WFAE.hAEA.XEGA.,1,-4,-20,16
CGSRABULfeXPTNYHdEKaFMZcIJVObWDQg,UGBCeBDE...XCEFPDCB....TBADHCAEEACGaGGGFHBAhAAAMIFC..IGEEhABAJEHDOFAHDDDEgBGHhACASFFBBGEGNDACdEEF.KAAF...hADAcDCDWHFA.CAEBADHF.hAEA...,1,-15,-17,2
PJcaGHRDYSUdbIEATZMVFWNefgLBCQKOX,MBDBVCBD.FAEE..eABGLDAHBGDDCBFBQFEH.KCFEhAAAODFH.JEAFaHAGhABAGCGGDCEFSABHhADAUGGFdHAHEAABAHDFZDFC.fHGH.hADA......hAEA...,1,-15,-20,5
bAFfEVCNKUGIWdRHJcBDYXeTSLaMZgOPQ,ECBECBHFUCCAGDFE.dBEDHEFHBEDBDEADeEAHLHAEZAAG.OADChAAA..bFBDAFCEFABGhAFAfBHE.KHGGhAAARFDD.JFDFXCGA..aAFGMIFE.hABA......hACA...,1,-8,-19,11
IGLVNFBYCEDAPTRbOQJfaWMgdUSZKHXec,RGBAQDDB.aGGFMDAE.dFHCSAAGHCEHeBBAIEHChABALACE.NIEHBECBhAAAEFBDDGFBAGGD.TCAFhACAJAGH.fAGG.WEAD.ZFCF.hABAXACD..hAEA...,1,-18,-20,2
ZHQgOPVMUYXeBLCRJDKbEdcfGNSFTaWIA,HADEQFGFOFACMBCDUDAH..eDEECDHDDHCAKEBF.dBAG.GECChAAANFEB.SAEGhABATAAD.aEEFIAHAhAAAAIBEPAHB.XGAGBDDD..JGEC.hACA.....EHFGhADA...,2,-27,-4,23
NXUeWVfdRIBZAHcLOKGMQJTECFgSbPDYa,HAEGLHCCKGEBMAIDJECC..ECDGFDFH..SAFEDIGE.hAAAaCAFNCBBUDBD.eHAAhABAfFGA.hACAIFBGADADOCGFQDGHCGHGbFAG.PABGhAAA....hAIA...,1,-12,-34,22
LCbWHRDgPFKSNJadVAOUGfQZIYEBcMXeT,GGDFQAFHZADGECGEMIBE..eBABCGGFHAABDEGBFCEFKFAAJADDdEADAIGEhAAA..UDGG..hAAAfAHGIEDDBGEFhACA.XDAE.....hABA......hACA...,2,-28,-15,13
DeKOaJFZSGRPBICUEHNgLTdXbQMVcfWYA,eHBEaGGEZCDDGEEA.BECDCBGHUGBFECDCHABCLBCDdCABQBGBhAAA.MEABhABAfFECAGHAKDGF.FAABhACA.PAEGIHHANAIG....gDADhADA...hACA...,1,-8,-22,14
QKcaUPLHdDCAVGBXIfeRNMWYJbEOZgSFT,BEHCXBGFeDBARBBB.MACF..JEGHEAFGZFDB..FFDDKGCDaCFELEAFhAAA.DIGCCFGDABBFhAAAGADC..fADEhABA.NICD....bEEFSFBEhABAcEAH...hAEA...,2,-36,-24,12
FEVCNLOAZPBKDRQUMHWTYSXcJIbdeGgaf,ZFBFBCEGDCDGRAEEUGECHBGH....TFEGSCHDJADA.dBAGeBBBhAAAGDCE..fHGFhABAEHAE.CGADOEDBhACAKBCDMAAEWDDEXEAF.IHHEhAEA...aEEAhAGAFEHD..,1,-7,-29,22
bBLaEKHDGYeSMQVCXfPJcIARgOdFWTZNU,ODEHdAFCFDHHZGFCUBGCBCAELDAE.KACBDDGB.GCCG.hAAA.eHFCMIBCCBFDXFAHhABA.JECFAEABRAAEhAAA.TAGGaFGGEGEFSEAH..hACA......hADA...,1,-20,-32,12
BXEbLNQRWYdKMSAVTZCcDJOIaUgfeFGPH,VAAECHHGDCAB...OBEEUCBG...eDDCGCGABEGHEBFFLAFChAAAREED.dHGBSGAEhAAAAEAC.ZABAIHBAhADAaHBE.FEBD.HFED....hAEA......hBEA...,1,-19,-31,12
XBbHdEgFfCRMaVPZcLSTGUKIAJYQeNDOW,QFDBDFFEOEBHBAFAdFBAEBAF..FHGECHFBRBDC..MDCG..hAAAPDHHLGDCSAEEhAAAGAGGIACAhABAAIAAeDBGXABF..bBBG...hAHA.fAHChBAAaEHD...,1,-22,-25,3
HATEgSMLcfbeUOYBJZCKPQFXaRdWGNDVI,TEBAEHCG..MDAHLCCG..bBGBUFFFBFGBCHCDKBGHFEBFRCDEhAAAGABH.DBABIGEGhABAAIFA.SACGhADAfGDG.eFAD...OEEAhAAA.....hAEA...,1,-16,-36,20
CBQeXMDWFdARYbfcVGEUKaHLOTIPgZJNS,RCCA..bEDDVFCE.GCAGUBGHKCCG.HFGBTGGC..PEBBhAAAJABE..CAHEQCFGhAAAMBCGDAEAWCEBhABAAGAB..fAFD..cCABhACALHCAOHBC..hADA...,1,-7,-22,15
YNfHeVLDWRTSKFEPZUOcMbCAagBdIGJXQ,BAFAdDABGEFCJDCH.QAGH..fAHEeEBADGDDTGABhAAAKEHD.FACHEADFhAAA.UEEAOEHFbCAF.hABAAEFBIHEB.NDDB.LHDA.hABAWFADSAFFhADA..cCGA,2,-33,-13,20
WCHfEcDaTJLNYQPgdBMXAUZRFGeKVSIbO,RADHFFFDeDEFKCGF...SGFFOAEAHABGEBGB.DDIB..TDBChAAALFEF.QCAHhAAAgABHMIAChABAAGHFUDGFZECD.IAHGCBHDfBEAaGHDNBAAPGAGhABABHHC....hAFA...,1,-12,-13,1
cPTVDJLIdaYEMWAZgNQCOFKBbHUXGfeSR,ZBCHQGAGCBHB.FBAHBFGGHFDEGEBASDDARFED.TAEAhAAADBAHJBFFLHDAhABA.IAHGaBBHEDHD.hAAAAEAANCCGKEAF......XDFHhACA.eFHF...hABA...,2,-39,10,49
WILJSEZfVbBUDKFdgGMcXaTCPHAONQeRY,OBCGQACARFEG...IHHHLHEAEAGHVBGFBHDDDADAFAAFhACAdAAEMFDG.aDEACGAFAIBEhACA..eGACJCEB.fCHGhAFAKCCD...gFGChAGAXGBE.PCCB..hAIA...,2,-24,-17,7
NaCUdTLJHRQbAfGPcIOXgBFDMZKeEVWSY,GBEF..ICGCXBCDFECDDFGFKBAEEFDF..SFAFhAAAaABBUEAF.dEHETGAEhAAAHGFEbACH.fAEAhABAODFBBADEMIBGeFHF..YCEBhACA.CGBD...hAEA...,1,-11,-25,14
DFdXWeVcHMKbLNPCfRIOAaJZESTGYQBUg,aCDDEEBHGFCHBEGC.DBEDdGBE..eCAEVFEDMFAD.LFHBhAAACCBCRADG..AAIBZAGHSHCGhABA.YDFEhACAgDAAXAEB.cGFE.hAAA.KABC.NEIE.IBHEhADA.,2,-28,-18,10
FeEgNbBKRYHOWaLMfdTVZSAQPGcCXUJDI,QADFGBCDCGFDUDBCJFDE...DBGAeDFC.EBFA..NDHC.BFHAhAAA.RCCFOABBhACAaADGMIDCdHEF..TAABhAAAVEADAICG..XEEAIHHAFGAF..hACA......hAGA...,1,-8,-32,24
IPNWgOXdeBMRAZSDGYUKJQbEaHLFCfcVT,ZBGFSADGDDBHGCECUDDBKGCB..QEGBEBAG.HBGHhAAACACG.VGBATGGBIFADhABA..NDAA.OABDhAEAXECCBHHDAFHC.......hAAA......hABA...,2,-35,-11,24
FUBeDgEYbVSLJTGRNWOKACPQcXdfHaIZM,QBEHdBDDHEEAZBABFHGGBHAADFDH.EBGF..VCBFLEHH.hAAATEBHNBAF.KFAFCEEF.hABA.XGEBIHDGhAAAMAHF.eFAF..gCCGhABASEHB.....hACA...,1,-17,-18,1
IcKOQdeVXPFHZaUfLbENWGMSDBYTCAJgR,RCCDKDEBOFFDQADF.dGBDXBEAHBFCUGFFLBAD.hAAAEHAENACC.MDIHDEGEBHAGhABATFBA..CEDGABBBIHDChAAA.cAGF.....hAEA......hAGA...,1,-14,-28,14
dOgBNKeVIbSPUHaJZAWLCFTQMRGYcEfDX,LFCBFFEDMDHHGABBEABBDHFC...dGAHOFFCBEDFKGHB..hAAAeAEH.ICGHhAAASCFHUEAAaCAAAHIDCFEChACATEAA....YCHBXGFDhABANADG......hACA...,1,-20,-32,12
CdNIGgBHbeKOZYJMWfDPSQAFXcREVLUaT,XEFDECBHLFDCUBAECGHD...dDFBGAGGBFAGHDCHKGDBZACAMHFEhAAADIFE..QFAEhAAAFBFCRGAA.aDCENCIC.IBAFhABA..gACH..hABA......hACA...,2,-19,-13,6
aZNJYSAGdcbHRgeMUfPCTDEQLFVIOKXBW,GFEHdDECHGDCeEADMACEUCGD..CCHEEGBBFDEHOACBBAGCZDBFJFCFhAAAAHHA....RDFB.fBDFhABATAAEDEIBLHEAhADAKBEG.aAHB...NBBG.SCCBhAAA....hAIA...,1,-5,-19,14
aMfCITWBPdcGZJDLVQgAFSUKXENbROYHe,FGBGSEFCUBAH.EACERCFGHAEA..MDCDCHFE...TFDFhAAABFEDdEDFZEAFJAFGDICG.hAAAQGGFAHAFKDAB.hABANDDFOABHaAGA.WHCA..PEHFhACA......hADA...,2,-29,-9,20
FbBaJKEYWASeZcCNfPVXdUgHMTIRQDOGL,ZAFCCBAB.....fDDCXCDCdFCDHBAAMAFCRFFBDGDFLBFEhAAABCFEKGAGEGGAAEHHeABEhAAA..NIEFPDFEhABAUEAB...IADFOFHFFGEHaCAC..hAEAWFFC...SHCChACA,2,-17,-17,0
IDUFbKVYZPEAJROXHTCNecGdaBQWSgLMf,RCAGXEEHCCFC..eGEAdACGQCED.SHDGhAAAMACEIGBCDFBGFGAHKEDAhAAAZAEAAHHGOAFCNCIC.hABAaFGABHGBLHAGfDBH...hABA......hAHA...,2,-35,-14,21
WPOTdcDXJEgKAUaBfRLCQSVGIHZMNebFY,aFEDBDHHLCDECCFB..QECCSHCGGABFHFAAMBBFhAAAeFAHFAGE..WDHFhABATFFFDCAFXEDBhACAJHCAECAGAABE.UGGF.fAHGIHHH.hAAA......hAEA...,1,-4,-26,22
YUIVGSKgHfCdZJMXREaNFPOAeTDQcbBWL,eBDCQAACBFGGLDAEUCGAGDABSGABKGDFHFFHCDGEZEEBhAAAMFID.EBDFFBACAGBADAFBhACA..bBFE..IHBAhADAfHFFdAGB.XEAAaDFB.NEIA.hABA......hACA.OFDB.,2,-4,4,8
ZdgVSNMYOXfQWeCLBGJEbAHRTcUPFIDKa,TEAAUEACFHDG..DFHHKBAFdEEB...SAHBMCIH.XBDAhAAAQBDDCADEBCAHhABAEFFGABHEHGBC.PFFBhACAIHHDZBBFgCGENAAB..hAFAOAFG.WEEEhBBA...,1,-1,-47,46
UFOdcHANWTgJLfRMCaEZVKPYQBeIGSDbX,TCAFJBCCLDFF..RFBBCAGCEGCFZEEHKEAF..QEGFhAAABHEB.GACADBGAXEGFhAAAFCEEdBHA.HBABAIHEWEADhABAMDEF..aHEC.......hABA......hACA...,1,-5,-35,30
eLRfOKBJHPNMUEDTVGaCYcAIbZXgSQWFd,ZFEDXGCGSGGBFACD.dGBARAFC..KDEEJAAAHDGF..MBFAhADAEAABDAEBGCCB.CGAGAEGEhAEAIFAE.QGGFhABAWCFE.fFCDBHDCNFAH..hACA......hAFA...,2,-24,-24,0
AXecYNdfWZgQFEVDbKPLCTRUHBGIMOaSJ,XGCEeAEA..NCCC.dDFGZEEFQBBA.FDAHDBBDKBDGCGDCTBGFhAAARAGBBGGGMGAAhAAASGGEAACA..fFHGhABAEACD..PEAH.LHEAhABA....hADA...,1,-20,-29,9
WLFXVASPEZQacMTRgNYdBUIGJfDeCKHOb,EBAGQGAD.aDHBTDCB.RDAD.NEIA.dHFHBEFEUADAGCCHhAAAJEFF.DAFACHDDKCHDOCBHhABA.LFCAhACAFHAAADGB.ZAFG.MBBEIAGFfGGEeAAE.hAIA......hBFA...,2,-23,-1,22
DHBPdYgWSfabNTeFIcAVKLJXCOGERUMQZ,VGCALAAB.JAGBCHAAGCDB.UAEFMFBB.DGEABCBGdACD.hADA....gGFHhAAASCDDaAHBNFEHeHEAhAFAFACF..AFAAKEFAOFDH.ECHF..hAGA......hAIA...,1,-25,-31,6
TSHZbfIFeMQBCRdLNUAcEODaPJVXgWYGK,EFDCaEDE...JCBCVAFA....XEAH..gGGChAAAGGDHKBHFTGDEhABASBACHDACbABEhACAFHAGeBDGMFADBDGECAEERDFB..NEICAAAADDDA.WCHHhADA.....hACA...,2,-20,-6,14
dWIOgbFDEaMCJBZcQGYfPNAeRHULSKVTX,RBABLBDAKGBH.VDGFdCEAOFGF..FBAADFABMFBABEBHQGABhAAAGAEF.fCAEhABAAAECUGDC.XGDDhACA.IAEAEDHBCDDF.JDDEYAAChAHAeFFD...SDFHhAIA,2,-28,-20,8
BHIJNRPTdLWVEfSZGcXKCMFgbDaOQeAYU,BHGDHFAEJBDCRDDEdHABLGFG..EBAFZCEEGAEDKBADFDHDDGFB.hAAA.aDAEODHD.hABAeDCDABIH..IEFDhACANABD....WCCEfBBBhADA....cGGFhAAACHAGMAFC.,2,-29,-26,3
AQUTXfWFdbMCHBgYDNZSLceRIGPJKEOaV,QGECUEBA..XBFFFGACdCDBMAFCCBDHHEEDBEDC.DGGEhAAANIAD.ZBADLEGBhAAA.eABFIDGGhABAPBHDJBFCKDDEaDBDADAH...fACBhAEA.WEFG...hABA...,1,-18,-22,4
gdOPHBNDaUKMFAETVWGeJCLQSIfRZcXbY,EEEDTDDBGCGE.CCAG.SABF.RBGDZADGbGDGdEAFHFFADDCEhAAAKGEFADFA.eHAGLBBGhABAfDADXGAFhACAYFAA..OBFGBHHH....hADA......hAEA...,2,-16,-1,15
IcKeJOXdFAQMUBGRWgHaVfSLZDEPTCYbN,QCDHMEBABGFARCFEHFBD.aBBG.SEAFDAFEEFCE.CHHB..hAAA.NCAG.KEFB.OEEHhAAAXBCCFBFEAHFH.WDHBhABAfGBB.LBFCPADA.bFGFhABAIHAC.eCAAhACA..,1,2,-37,39
YWBIQRGHfVKZgPJdSMLTAFacCEXeDOUNb,aDBACFGG..eDEHOAFDUBGF....NAHA...bBABBGFAQDCChAAAGEBGfADBhAAAKAGCZFAH.JEDEMCCGhABAABCBEEHHDIFA.YACCIHHE...hBDA......hCAA...,2,-26,-22,4
KPgGIAeaXbESFDOYRUTJNLdcQWHCMBZVf,XBCEEEFDDAFC.RFAG.UABB..JDFFdBGB.QEBA.hAAA.CHFABABAZEGFKGDAPBHHhABAGCCDeFHHaCAH.hAAAFDBG...OEEHNIDH.LHAAhADA.cAFG..hAEA...,2,-26,-17,9
DJBaERgVIMdQOSZGLHATUCeKXbPfYNcFW,UCDGCFEBKGAE...XCGF..bAAG....PGAEhAAANEGA.FACCDIBEBGEFRCAA.hABAIGHGMFAEODHBhACASAEEGAEGAEIHTBAEeFHH.fGFAhABAWAHB.aDFFgGDGhADA,2,-45,-18,27
DPFaeIVBYEHOXTMZAQGfKbSWgCJcLURNd,GDDDKFCE.SAAECBBALFFDRFCGDDAEFCEB...aGADeEACBHFGhADAEGBGHBBC.OAEGhAIATAGHMCFAADAFQGGBhAAAfGGBbACBWDHB....cGAChABA....hAFA...,1,-4,-30,26
VHQODabLYJUPgfdGSRKTXNZWEcCMBIeAF,FGGEVFDEQFDD.DDIBaBFG.LAEFJHAC.UBAE.hAAA.gDBChABAdACAGDEBRADGKCGBNIAB.EDFBMFIDhAAABCAFAAHCOGAE....YAFChACASHFA.XBGAhABA,2,-35,-5,30
TFDVMGOPUNKACYfLBbIaJWdXgeRQcSHEZ,CGAE.LAABBEHEaCAFdEHG..eFCBQEDEHFEBEBGDFBFEMABChAAAOEAAUDEH.AIGC.fACFhACAJFAF.XGGChAFA.cGDHSAEH.ZBBHhAGADCCC.....hAHA...,1,-17,-18,1
cPebJKUBRCYEFHNfadgATDGQMIXSLOZWV,DDCEQDGBMBBA.SFBEZEAD..VAFDeBDCKEHDBGFFhAAARECD.EBBAFEFFHDDD.hAAA..NDACaGCHAFADIHHHhABA...OHDEcGFE...hACA......hADA...,2,-34,-10,24
FXeBDPdEGMRYKQLfANScVagUTWOCJbZIH,SGDDVCBF.UBFAOBHB.JDFDZFFD.FEBCBHACDCDEdABAhAAAMGBAKFEB..LAEDhAAAAEDA.aBBGgFAGhADACEHH..IBFFeEHH.EGHH.hAEA......hAFA...,2,-31,-30,1
LOIYMFPZSVfDUJRXNdQaEcgACKTBWebGH,KFEFTDCAeBCH.HBFBLHDG.ICAEFFBCSGHHhAAA.DAECRFGDNGABaCHD.EABChABAACCECAHCBHCDGAEC.hAHAOABEMBEFPFFGfBHA...hAIA......hBAA...,2,-18,-15,3
eaVOWLSPQYAHCKNcBTEZRXMUFDbgIfGdJ,CFDCKCBBBCEBEEGE.ZCAFRECE...UCGFDAHH......IGAEhAAAdAFHeFFCaGGHOAAGhAEASDDE.QABDhABAAIAAHGACTCCFFHDG..gAEHhADAJHEE.....hAGA...,2,-28,-20,8
PIEFCJNUbDRWfVZXdcQLYAGHegOKBMaST,HCFBeHDEKEEDBADD.SCHB..IEBCCCEHUFABRABDfFGBhAAAZFFG.XBBEhABAdHBHLAAFhAEAAAFDOGAAMBFGaBHFPDDHEDFAFHACJHFG..DACGhAGA.cGGH..hAHA...,1,-2,-29,27
PDBCFXbYVdHIGSZLQaMWKNUfJgETRcAeO,eFAHDGDHCHFA.FEFB....XDADVFCFdCEBHBGBGDAHZEEAQADBhAAAMIFE.KABFhACAUAAF.fGGBhABAEDCA.TAGDAIACBGECYADESAGChAEA.....hAIAaFHDNCIG..,1,-10,-17,7
YXNVGgDHbEOKQeRPATScLfdFBMCUaWJZI,TCGELACC.FFDFMCAFUGGF..aFBEJDCAZDDF...IDBHhAAAXCGCGGEHhABAHBAEEBEDKBFEeABA.hAAAAAGG.fAGG.BHABYCFFhACA.NIADDCCC...hABA.OFFA.,1,0,-16,16
JRfQcSZeBUEbXFPDHdTGMOCIAaLVYWgNK,LHEAVAAH.....gBDANHEHKFEG.JFFCRDFGQBEGhAAAZBFDBCADEAADFGBADEEBhABAdEAFMIAE.IDHAhACAAICEaAHH..fDCBcEAD.SADChACAeGAA...hADA...,2,-22,-19,3
WeYdJCaREVULZOcGXfgKFTBbPSIAMDHQN,DFHHHAGBQBCDeDBFJFCD.RCAD.UFGCLHBCZEDFGAAB..hAAAXEEBKCFFBDACPAHBhAAAAAGDMIDE..WACEhABACFFD...aGHDOFAHfGFA.hABAFFCG.SGAFhAGA..,1,-7,-12,5
CfPSUJVNWHbZRLXTQBOIMaKAcDYgEFdGe,DFFDEDCBFCGGeEHF..CFCG.SDAC.UAGGNEAEHFEGZDDEREBDLABAhAAA.XDDBhACAQAAGBHHFOCCAhACAIHBFMIBGAEIH.......hADA......hAFA...,1,-19,-30,11
AZaOdYgTHNVUGCPLcFReISDbXBfWJQKEM,ZCACaDCE.OCGDdFED....TAFCHBCCVFAECABDLHDARFEBSAHBhAAADEBFBCCFJAECEHAEhAAA.ACAA...gGGBhABAUCFD.cABBeFHBXADBhACA......hAHA...,1,-7,-21,14
ZgHAcMedIfaSWJbPYBTRXCGUKLVDOEQFN,MEIDdHGFaCFC..SGDG.JDBBYGAC.BEGHhAAATAGHCCCE.UAAFKADEDDEFhABAEHGGFADHZFFEAHBHIEEAhABA..fBFDWAFD.PCBBhACAXGAA...hAGA...,1,-23,-41,18
fJZeKITUYHNQdCSVcgXAGOPRFWLEaBMDb,GBBBOEECFGACEGEAMICC..DBFGJFBBKGHB.UAAHHAGF.dEFFhAAACFDD.SDADhABA..gCGEhABAADEHWACEBFDDZDBEeADFIHGDTGEG.NIAF.hADA......hAFA...,1,-10,-31,21
eSEUgFcdJIVXQWLRPTGANODHCMaZbfKBY,DCEEHDDECFEB.aDGDZBCBKFAG.BAAG..SGFHUADFFHGEdEAF.hAAA.IEADQFDFhABARFBC....TBAEhABANIADOAHDMIBGfCAFEBHHJDHBWADEhACA......hAHA...,2,-36,-13,23
DNVdWcSRaXfPIYgKLAZMJGEObFUTBHeQC,ZCEEMAEFJFFBGGDD.EBFGOCBB.UAEFBFDF.QEGGhAAACAHH.NBAGVBBHhABAdEHGSACHRFAB.hACAaFCHXCFG..IHAAKAHBAIHG.hADAFAAE.....hAFA..eDDD,2,-30,-2,28
KfWNJaSgbeMTEUFALIXBRdGVCPYOcDHZQ,LABHXCCGdGFFVCGH..CBAG..OAFEHFEAQEBFhAAA.KADANEICSEEFhAAAeHBGMDAFECEHFCFAABBAhABABHHDGEAE.cADGDFID..fAHEhADAaDABbECH...hACA...,1,-3,-23,20
bBHRKZIdXMOUWPNfDYFJSTegQaECGLAcV,VEFEBEFFKGBE.ZABDdDAG.OFDHUBFD.......PBHDhAAANCEG.DEDGFEHFSHAEhABAeGFG.aBEEhACACEBFAIAAHABC.XCCGMAEC..fBAAhAAA...hAEA...,1,-24,-45,21
VQgZIcSPaEBWJNMRFHCKGeXAODTfbUYdL,OEBETFGA.UGGELAFH..QACAIECESHAEhAAAaCADBAFF.NBAGFGEBhABACGEAKCEA.GAGGABCGDEEE.hACA.fCCBdEGDgGBB.cAAGhAAAWDAHMIFC..hADA...,1,-18,-29,11
ECFJcBNTVbZSGadARMeDYOfUPXWHQKgLI,MBDDDEDAOEGFUGBD.....XAGBQEEELFAHhAAAEGHBCBBB.JCDABEBC.TAEBhAAAZBAFaHDC.AAEHeACFhABAfCAC.HCFCKCHHFGEC...hABA.cAGA..hACA...,2,-30,-15,15
WSIDYLPRgCEcNOTGJfVFUaQBZMXdAbKeH,eCBCHBGBSFFGDHCELBFERAAH..CAFGECCEOFFB.GCGAhAAAfDFGFDDGQEAHhABAMDAHAFCGKGAGIADAhACAPHFC.NIAF...JGCAaGHDBBED...hAFA......hAGA...,2,-10,-7,3
SeFPEUHNLdTJcKWfQaZRDXgGCVbBIYOMA,SCCFFGADEACE.HADDdDGD..JECGKGBB.QGEHZFFBDHCGGBDDhAAAbAGBBCAG.ICFChAAAMBBBAHHDeAEEhABANDIELEEA.cFAGaCCC.....hAHA......hAIA...,1,-3,-23,20
OYGeZTIVgHdbWBSfNULPJcQMACaFKEDXR,aEGEKGFFEBBH..DCECOCHHeBCDZEBH..TAEF..IGAFhAAAHEAFdADGBHEHhABASFDDNBDH.PDDEhAAAQGGDMCADCHGAFDFB.REDD..YCADhACA....hADA...,2,-25,-13,12
OBWEZAGIJLTYFQfNUHadcPbeSKMCVXDgR,JCCGTCBD..FDHHQBFCUEAB.HDGBdGGH...bFCDKGDAhAAAMCABCBBD.DAAERDEF.BGEHhADAZADC.AEBF..IGAChAEA.LBBCNICH.cGGCeBADSHAChABAXEDB.hAFA...,2,-33,-9,24
GQgIfKRBSFMLOEdbUXaZHAPNDCTVYJecW,.DAIBCBGE...VCFCeDGBGABAQCAB..IFFChAAARDDHBBABMFGDEAEH.dAFGbEADhABAaHDAZFCDABIF...PHFAhADANAAH....JHAC.....hAEAcDBEfEHChAGA.KDDG.,2,-22,-15,7
ECbZKFePHGLQNaIOAMfTXVgURJBSYdcDW,TDGAXBEE.UCBDRDCCBHBD..SADAdBCADGFH.EHAACHCEZFBAhAAAFEEF.HAEFLEGBhAAAaAHB.AGIFMGAC.hABAfABGgGGHJAHDYDAD.hACA.....WEAGhADA..,2,-23,-12,11
FJZDXaSQLPGIKEUBbdMYgNeOWcRTfVACH,CCAHJDCCDIGA....aAFHLBHHGFDHKDHDBDEH.MGDG..hAAANHAF.eCGF.OACBhABARAAGTDAEABGD.FAGAXGAHhADA.SFCDIHHC.EDCC.hAAAdAEE...WHFChAGA...,2,-36,-28,8
cPfdKSAUHWOLZVYFXBbQEJTMgICeDGNaR,UCDHHBFGOFDBLBHDZEABFEAABFHE.EGGBJBAE..MAADCFFDGGCHhAAAaBCE..RDDA..hABA..fAEBhABASGBFAAIB..WFFFYAFH...hACA......hADA...,2,-33,-18,15
fJQBMNbDPXcgHVTCORdeIFSAKaZLUWEYG,ZCAFUCFFECCAGCBA.QAABMEFHDEGC...XEEEhABAHFBGCHAHOAFBeAEESHGAhADAKHFA.WGCAhAHAJAAEBAHH..NIAHPBDDcGGA...hAAA......hAEA...,2,-31,-2,29
bCPIUDaQRSJgVfZMXWKOdFHTBNELcYeGA,CGAFUEEHDFDF.RACD....JAEGVAAB.ZFEHMCFA..KCDGOHEAhAAAHBFGBGBA.LEGFhAAA.eAFChACAAFIFICACQDABSCCD.fHBDhABA.WDGBhACA.dEAA,1,-26,-39,13
OMIeWXKPcBJNVfagCGbZDQLTAdSUHERFY,dDCCUBBGHGCCEDGF.FBFB.ODADMFFHeGAAKHAG.BEBE..JFGFhAAAVAFD..aBAECADB.hAAAZAGHQGGDhABAAABG.SFDBIADE.WHAAPEDG.hACA......hAFA...,1,-21,-24,3
HAXdWPYaOLMBbEQTcFRIgZfKGDeUNJCVS,dCDA..PCDCOBHFBABDEEGH..QGDCFDAFRFFHZAGFKFADDFAFeACChAAA..NDCC.CCAGSHGChABA.hAAAABFBXBFHaEGAMIBG.cGADfEEAhACA......hADA...,1,-16,-35,19
dUOXGSfBMJHZgVbQINTcReWAEDYKLPCaF,DEHDLEBCCHBH.aCGEUGEDGGAHBDAFMIEE..ZCEE..gBDGhAAAQAADNGEH.hABAREBE..AAFE.EBBBKBEGdAFHhACA.SEAD..fAGHhAAA.....hADA...,2,-45,-13,32
OFHcaLKENCMBJTbVSXQYDAdfRIPUGZgeW,dFAARDGHUCBBGCGGZAFB.eFED.FACAaADELDCH..NHCF.BCEBhAAA.TBAFSACFhAAAXGGGDECHAHIBIAGGhABA..WBAF.OAHF.hAFAKEDGMIAA...hABA...,1,-7,-37,30
PfdZLIUeVXHTRBSNCaDGAWFYEbgJQMOcK,FCGFECBH...JDBEQCED.OAABKGAAdGEDZCGHUABFXEAGhABAREFG.BHBDCHHD.hAAAaGGAAICG...WGBEhACA....gAEAMBCG..fGFEhADALFAC.IAHAhAEA,2,-51,-15,36
XTGOJCYMBcRHSadeNPEZgQKVALWFIfUbD,LEAFFDAAUEEC.XADCGACA..OFADJFFC..CEEFBBAEhAAAHAEEdGCC.eDHHPCFGhABAECFA.ZECHKAAGAHIF..hAAA.fHDBDDIHMIBCSCAGhACAaAGA.gGEBhAEA...,2,-31,-3,28
aCTRFBQLeXcIbDHPONVYZGMEJdSWKfgAU,aFDCTCBGBHEC.LDBDeBEH..XFEB..cGGGhAAAIEHCHABGNICHZAFHhAAAMEEGdADGKCFE.AICGCAHCFGGAhABADAEEPEBH.OAHD....hACA......hAHA...,2,-30,-9,21
GHQefbDEZJOKdXgMVCPLAUIBTaWNSFRYc,BAHGTBAFaEGB..SDCBFGDH.RFEHGFAHeBCFDEDGEAHFJDADhAAAKADA..dGHGXCEGhAAAMFCE.CDHCAAFA.IHHGhABANDDF.cEFFfGAH.OADAhABA....hACA...,2,-39,-6,33
EKJHcICUZDTAQeMWFBRVOSgbLdfaPYXGN,QEGBMDCDBBEGREEASFDE.LGAEaAFC.XDBFhAAANAAC.KHEGJHCGIBEFhABACGAF.DACHADBBeCHBhABA.FGHBgAFBdBBH.fHAFhADAYDDDEHAAcGGChAEA..,1,-16,-34,18
EJaIAYUXNTcQgFOdLDSeHCGRMPWVZfBKb,UCEDTCGAQAAE.FFFGOAFGDAGG.SEAGhAAAHFCFCHHA.MDCG.PHFGhABAWDBF.ZFCEBFHAKACHEEHFhACAJACG.AICE....NECH.dBHG...eDCFhAAA.....hAEA...,1,-17,-20,3
GgALfHTeUdFSOJDcYMBREVWXNaCZIPbKQ,HACCeDDGdBGHOAAHDBAE.MHCGBBDD.RGDE.ECFE...XDDEhABAaAFGZDAH.IFAChACAKHBAGDGAADDETGGF.hAAASAHD.cEFEYCCFNIBFCDAH.hADA......hAFA...,1,-11,-27,16
SgfDNQbCKLXWIAGZaPHMdFVTEJUYecBRO,GGCFZDCBaAEF.HAAGFAAG.TAEH.UCGBeBFHBEADOGEGSFGGhAAADDAD.QDDGhABACEBGLCHDXAGBhADAAGAHMHBAEBCE..YHFG..hAEA......hBIA...,1,-7,-27,20
CIQGbaEZSRMXBPfgeVWNOKUDTcYFLJHAd,CHCCGDAD.EHBASBHDRAFCBBDC.....gDEHhAAAVFEDOABGDFABTADChABAFGAGJAAFHDFCdGFHIDDFhACA.QDAB.aHEC.XBBGhADA.fEGHhAFA,1,-16,-23,7
KQAebNHXUfFdZWBEVGJYPcCSaOMLgIDTR,eEBGHGAEUFEEFGAEdGGABCAGGAGA..JFBA....PBCGhAAACDDBSCCFOABHMACGhAGALAEEDEDCTGDAhAIAKBEHAABH..NIDH........hBAAfGGBWFFC.hBGA...,1,-20,-35,15
FLIZHSEAVDeOgbGJXNdaTCfcWYPMRKBQU,eEGBOECFGEEG.JHBCNEFE...dAHACAAD.....fDAEhAAA..cBCBhABAPBCAMADEKDDFBFCGhABAFBEDIGBESBGFAHGDDCBB.gAGHhACAaGHD.YEHHhBCA.,1,-15,-53,38
eOdHbANVaDZLRKYfFEQJMUWICScXBgGPT,aBHBZACHLCFG.KBGEfDDBFGGA.JEGDMECC.UBADhAAACECBSDAFhAAABHEGGFBBeBAGdHAHAEBDDGCChABAEEFA.IGAC.XACA..hACA...gGDAhADAOAEG,2,-35,-23,12
IGJfdgAMDCTYEWeBQSaPKZNFROHUcXVbL,MEBBTDGB..EDGEeCFCBDFD..QGAAaGGFZCDD.FDCEHABHhAAAXACALHAGhABAIHHGJAFA..fGFGhADAAFBEYFEB.WBAFSGCEhAEA..PAFE.hAIARFCF...,2,-19,-3,16
TJVUHNEACYLKWFZMSdBPIOXDQeRafcbgG,CFBAKAAFZBFGMICEBAGD..OGDGDCCF.RCFG...aEFD..fCDGhABA..bECHhAAATEBFUABDEHGGAAEDLFHFhACA.FAGAdFAG.IAEBeFAD.hADA......hAFAcDDA.,2,-40,-12,28
BGAHWNMDQFUEgZVPaOCIeTSfKbLcJYXdR,HAEEMCAEFGCDUDGCZEFHaCBA....CFBE.eFEH.SBADhAAAKAEGLCEAJECBdEAGBABBhAAAAHGHDCEFEDBC...gGGBhABAOEEH.IHADfGAG.hACAYFHH..hADA...,1,-8,-43,35
SNVUFGgKCXPLHYaIRQWZADbOdcTfeMJBE,OBGFTDDC..MBCAJBDHBFEA..NEAC.FHFAGCGG.CBAELHBChAAAaFAARGBA.QGGFhABAAAAFDIDA.cBFBhACAEAECUCACKCCCXDAB...hABA.YDFH.hADAWAHB.,2,-47,3,50
CUQVgYSPZNBEceGRXDbdWMFaAIHLJKOTf,HABEJCFH.OFGDCHFH.UGADQCCB..gCFDhAAASABEZFEFBAEAeFBEhABAGGABDECGdAFDFFHFADIBICDAhADAKEAAfEEG.VAGH.NAAG.hAEA......hAGA...,1,-6,-24,18
CJXWQfSRHYUgdBOFDcZMVLAaGIETPKeNb,aABBEAADKDBF..eHDCCBHB...JDFDQGEARAEEHDBD.UDFHhABABHABFEDDDFDDZADEMAAFhADAAFCD.GEGA.ICHHhAEANEAE.XBDCSCCA.dGHChACA......hADA...,1,-9,-28,19
RQPMdTIOeJKaXgHfCYULWEABVDcNbGSZF,VDFDDBBH....bBEGSHCE.ZDDHQFEFhAAAMAAAdAGGOBCAJGAEKDCGaEHBhABAHEAFCACC..LAFEhAEAAHGHBFCENBIA..FDFB.......hAEA......hAFA...,1,-20,-24,4
NFVAYWSTEaPOUGcdgXfQRHZLCJMDbIeKB,SBDDEGDH.OABDGAAH.dHADXCEFfEACQGABhAAAZDDGCGFD.MGDAhABADIGAbBGBeEHB.KHDG.hAAAFEBCADAE..WEFAPAECUAEGcBGD.hABA......hADA...,1,-5,-15,10
VUgTPeKaHWONcdBfYGSMDQIJRAZECbFLX,EFBBCFEGLDCBUCEF....TFEFKHFEHBFHOBBHdDHGBHAChAAAGDGASDAGhABADDABQAGERABCAIBE.bACAFFAGhACA..XDCH......hAAA......hABA...,1,-15,-26,11
aNcVgePSTKWFDZJXYbOHMfCILRQGAdUEB,EDCCaFAH....VAAHPGCC..TDFHFAHHDDFG.ZDAFJECC.hAAA.XGGDOHDEHAEChAAAMFEA.IHHBhACAQAEAACHAdADGNDIEeABCSGGCKBCG..hAFA.bFCCCBAG....hAHA...,1,-7,-12,5
EKdAgQIUeTWNHFRPGLMOBYbCVDZaSfcXJ,QEADeBED..TEFGHCDERAEGLAACOFCDBBCDCAGHZBBHSHCGhAEAfFFBJAABhAAAECFGAIFG.UFBFFEGA.hACAPFHFMFEF...YEEFDIGCXGAHhADA.dAHA..WFADhAFA..,2,-4,-3,1
UZLJNacXRMEDAIFdYKWPSHeQBCfTgObVG,dBDBKEDG.SHBEHGBCBAAA.CCDF...gEEGVCEC.ZCEAhAAALCBBaACG.XGFFhAAAEGEDAHIBFFAGPCABhACAeBBDfAHC....OAHFhADA....hAEA...,1,-12,-28,16
RfOeKDGZCFaMHdXQVEUPAgJNYTSbIBcLW,JFCGTEAD..SDCABCDFLFDBRAEE.OABEDIFCZBADCHBAMFFFhAAAHGAEdADC.QFGBhAAAEDGAABAB..hABAgAGBbCFC.IGGAfGEAhACAKCAGaCED....hABA...,1,-8,-28,20
RNDEQGKbfXeHPcFSMWdaLJIVBgZYAOCUT,CEDEUCAERFDC.EEDHKHBA....XGEDeAHBHGFCFCGF.MBBFdABDLFADhAAA.JEGHhACABDFH.ZABHACDHOFBFhAEANAAGDDHF..QFAF.fBFChADA..SDEBhAFA,2,-33,-19,14
VFfdPANTLKOgBUMIRHQDGbJEXWCeYcaSZ,TGECKAADBAGB.UFFHMBGB..RFAE.QBDBGBCD.EGADCDHB.hABAeABF..aDBCSEEFhAAAZFDH.fEAGhABAABCAOEEA.IDHGDIBC.XGGDhADA.YCCFhAEA.FHCC,1,1,-38,39
YDZQaNUgWJMVfBLPGbXedSAHEKOIcCTFR,KDHFOGCACAAA.FDDCDGFHZAFF....aEBAUABH...JFHDMAFBhAAABHCFLADFhACA.GGAHeAHDSEBFhAAAAAGDEGGG.TEFDYCFB..hAHA..NCAA....hAIA...,2,-40,-31,9
PTJbKGWZLHeCVMIRBYSfQAcgXaODFdUNE,XDCGDFGCFDCF.UAAHEAEF....JEAHKADB.GFCDLCFGhAAACHBBMIDCBBCC.SHEGhABAQBGBAGEE.aDFChABAdHAD..PDABTGGEbGFA..WEEChACA..eDHH..hADA...,1,-12,-34,22
RMeIHdcJBCFWLTYZPbafSOXEAQVGgUDNK,GFEBDHBERDBB.eDAFHGFCJBCBFBDA.LEFGZBGH..aHFCSAAFhACAEAAHACGB.VAGDhADANHAF..KFCCMDEH.hAAAIFAHBDEBCFBG........hAEA......hAFA...,1,-21,-22,1
HFOUQcIMSbfagAWeEVRBXZLdDCTKYNJGP,eBCEEDAHRFDD.BCHFZCDELBAEDADG.KAGHJAAD.GDDAFHFEUGAChAAAQGGC.MIBChAAAfFFF.hACAADIH...XFBCCEBA.TAFA.hABAYCCDPADG.ODHFhAHA.,2,-28,-19,9
IJBGHYONKCWfeSVgPdXMTRUEFaQbLAcDZ,DHFGJBDCBDDBGAEE.HAAH.ODEHCHGE.eDHBSCGHhAAA..PGBEXFAEhABAMEAHUCBGEBGEaDCDhAAALEFAAIAG.IAHBNIDB.KFDAfACDhAEA..dDAGhACA...,1,1,-39,40
BZGKEJbaeAMQFLNWOfgHVRXICUcSYDPTd,QFGFLFEFOEAGHFCFRCDA..CBHFUGAHSFAH.DCAChAAAdACBGABBEBCHJDFGaCGDhABAACFE.NEFC....gAGEhACAIFGGPAAD...BAFFhAAA...KDDC.hAEA..eFHH,1,-8,-17,9
LJIeYQBNVHAfbMGPSOXDZEWRFCTgcadKU,MEAHGFDH.OBFFXDEHDAEFZAAF.RCCF.FCCB.CGBB..TAAHhAAAaAHFUFAH.JDHFIEHFhACA.QGDDhADABHBG.NBDFAIGAfDAE..hACASEDF.hADAEGGG.WBFA,1,-20,-28,8
GDPMYAbFJROWCIQNLfESBVHgXKTUdeacZ,JHDGRECFODAG..CFFC.QABELDBCEDGEBAHE.HCEHKBBEUAFFhAAAaGFE..ZAEAGEBChABADGID.MCAHAIDAbFABhAAA.FEGGIHHD.SGADhACA......hADA...,2,-30,-7,23
IJDMgaKYcfATPBZNCWdbLXRQSUGHOVeFE,TGFAZCDGCGFC..dEBGLAEGRACG.UDECHDFGeCAGEFCGDIAEaHCEKFCGhAAA...fABHhABAAAGCBCHB.NCHC..hAAA.XCAGSFAFOHBA.IHGFhABAMAIH....hACA...,1,-8,-33,25
efHZWKEIVJYObLaCGTcRASDQBdgUMNPXF,DDDEBAADUEEEMCDH....XBBFFBGEeHDAHGAGKDGAEGBDJBEA.hAAA...OHFChABAaBEDCCAC.TEAG.AECEdEHChACAgEAE.NGDHZEFCWAEE...hABA.IHHB.hADA...,2,-25,-24,1
gDWMbaAdNQTZSHLBefGEKFIcXCROYJPUV,QAEATFEB.SFEDLAAGfAGCEACC.KDEEhABAIHHECCCF.YDCChAAAPEAGVDGFhACADAHFMBIDACIF.NCAABGGFeGAGcECEXBBC.hAEAOECH...hAFAgDFH.,2,-6,-4,2
GdNeYbAJLKFfPgMTZHECXUBVDaQRcISOW,JCBCFCCD......gFAFZGACEDGHCEAEBECFDAAC..RFFDSDGGhADAOAAG.dBEFhAEAeAFBAEEFLHCAhAFAKFDGMBIBTFCC..UGGE..aBBB.hAEA......hAGA.cBDF.,2,-32,-17,15
ZHOVCEKaPAUdWGMJBXSYFecIQTbgfLNDR,dACHGEEDMIFEBCGD.SAEEFDFGeHCAQFBF.hAAA.TABE.bFBBhABAfCCCLDAEDAHFhADAHAAFCCEBEHEGKAFHAAAB.UFGDWBHH...hADA.YDEFIGHBhAIANAIA...,1,-5,-24,19
OUeBLHIARZdYPSWXcNCGEgfFMVKaQJDbT,RDCEdFGH.SFAGXGAF..CHGA.EDEFFAHHKCAF..QBDEhAAADAHBOGBEeEGHBAACHGCAhABAADDAZBCEPABF.hACANEIE.fEBH.MICAaAFD.JHFA.hADA......hAEA...,1,-8,-23,15
WMPSfQCFEZeBRKNOVaYHIDgGAJUdbXLcT,dEGGXEAALCCE..TCDFMAIFSEDECDHEZBAD.BBAAhAAANADH.OFBD.hAAAaADCHFECDHDEAHIDbFCD.hABAcBGG.WHFAfAGC.FEAGhACAeEFEKHFG....hABA...,2,-19,-18,1
ZATdMQHgcXfPYJFEaRGeNIODLBSUCbKWV,TBFBdECHMBFB.HEGH..XGAF..YBGDhAAAJFEHaAAEeEDEIBBADIGABEAEhAAASACBCGGEKDHDZADHhABAAIHCcGAGFAHFEBCFNIBHOBAH...hAFA......hAGA...,2,-13,-12,1
SDCeaIWdVYNGgJFALBQPTcZXbMKHOfRUE,QDDDTFDA.ZFBFXCGGKCABHABCRBABUFBASGGA.hAAACFGE.IGHDdGAGNAED.hAAAJCCCAGEG.BADG.PAFGhABAcDGF.MCECfHEFDCCB.aEAHhACA......hAEA...,1,-7,-22,15
TAKHRWSFfZbJNOIEaXBQVeYGgMULcCDPd,KHAERFCAFGAFZAAC...JDFFOAEA.EBCHaCEA..BBAD.eCHBhAAAGEDE.MADGhABALHEGCHFG.DEDA.hACAdCEHAHDDHAGDSFFHfGHE.IFBGhAIAXDAH..hABA...,1,-27,-30,3
EDWcKgQJRYSbUATBIfPNVMXOGZeLCdaFH,BHFG..fCAFVBAB.OEDCeDGDCECHaCDG.HAEGEGBB.hAAADGEGKCEBJHDE.SCHBhAAAABIB.TFAFhABAIHHBMACCZAEGFDEAgCGB.hAHA...YDHFhAIAPABGNEEE.,2,-41,2,43
PGCVcHWdLDJMYebKQIUOEXTfSZaANgRFB,RCCCBHDAGGDFCEEFHBGHLEBBDFCH..MADEeEFG.KBAHUAAGEAEB.hAAA...XAFFhABASBDEACID.FGHB.hACA..PFFD..WDAD..YCDDhAHA...hADA...,1,-23,-34,11
NDZaMfdVAGTbgPLSKBWQXcIYCRJeHUFEO,TGDE..gGCESDCFKCDDQEEF.IAFHhAAACEBDREFBHAFBUACChABAFCAEOAHFNCIC.aEAHhAAAfCGGAFHE.PHFEBHAGXACAhABAJHAADEDD..MCBHhAHAdEEG...,2,-14,-14,0
fENWaLMHUXZKdBDAIYVTgPbCJGeSOFQcR,VBGFTABA......PBCCbCEHCCHFGGAHOEECFFAFQAEHhAAARDAE.fDGGhABANIBFLACEUDABhADAXGGFKHGCBAGEIGEGYDDD..hAEA..eAAFSFGAhAIA.,2,-9,-6,3
fNbFHMQIOPeDXTgCRUVBJWZEYdaASGcKL,GEDELBHD..fAEFNBEE.HACBIFGHeAAHXAGEhAAACHHCRFCB.VDFDhACAJCAHZAACdHGDaDHFAIFEKGAAMEADhAEAOAFHDFCF.........hAHA......hBAA...,1,6,-30,36
QEANZdCLReKUaGVWgMHYfPBTDcbJXOISF,ZDFCdFDCLACGRFFFUCCH.aBGAGFAD..VFFGMABCHEAD.hAAA..PCCADBIHbADAhAFAJCHF...IAAHhADASHDGEDEA.AAHA.NIAD.CHHF.....hBAA.....WBBFhBHA..,2,-20,-14,6
ZefNFKcdULCIPJVHXEAabTQWMYDGgBROS,aGBHTFBH..MIFCDACFBGGERCFD.OAAFeCDBFAFB.KFGBdAEFhAAAUDABLEDB.hAAAIDFFPABCJAHFhABAXAGH.ABFDbACDWECH....YHFAhAIASFFDNDIGCFFC.hBIA...,1,-17,-28,11
cRdABKIFTDJHQgabfXOCEUNPeSGYMWLZV,KGAAFFAHDEBAQCDA..aBFD..bDFBXFEB.OCBEhAAACEBFEBAGUAGF.hABANIEB.eHBC.GCGAhACAMDAFZEGDcGGHABDBBACCIADC..hAFA...JFBCfHCFhAAA,1,-17,-31,14
MHXKeUgFdAOfVQCYSBZRPLaGEcJDTWIbN,ODAGVAAC..QAGHSAFEBGFCRFFALEFEGEAGJEEEhAAATGBE..IECBhADANDEBHACG.KDDEUAAChADAdHCFAAFGCFCE...YHFGaBGCDEEF....hAEA.MDIH...hAIA...,2,-10,-9,1
LJIbYDNEPXAWHRcSBFKMfdOVZTgGUaeCQ,HGBCSEFCKFAEMCGBdFBHZBAAGBAD.UGGBeGCALAHBhAAAJADC..IBHGhAAADDFDEDAGAFHARGFABCFGODDFTDBFhABAaAEC..CABC.....YHAAhACA.....hADA...,1,-10,-13,3
JXQYNZfLRHAIOdaGFMDbWBTPVESKCgceU,OFEDdCBDaAFA.GCAFDHCC.BCGD..VEDAKGACCAED..eBGBhAAAJAFA.QGGBhABAZFCFRAAC.ADEEFEAEMEGDTABGhADASHGA........hAAA......hABA...,2,-31,-21,10
ZdfRHMaFcDgQSAELVWKJCYBeUObPGTXNI,EAGFLGDAKBCF.JCGBBDHC.UEAHOEACGEFE..NIDDZDDFhAAAdAACRFDD.HADDFGAEDABChAEASDFF.AICCCHHEhACAeCBC.TAEBfGAAMAIBaBBG.hADA......hAFA...,2,-18,-16,2
CdMFUaHLGAegKfBcYZbETSDVXJNWQPIOR,KGCGBAFBZCEHEDBHDBHB..JAEF..QFGDOEHB.dBBBFABEaEAEhAAAHDCF.LHBChAAAADEFeACE...cGFHhABA...TBGDSGAF.NIEBWBHHhABA....hAFA...,2,-39,-22,17
WgAQJSLdCbOPDIaKNZYVXFMUGBceTEHfR,QFBELFADCAAG.OFEEDCBC..KCDBZBFB.VBDBFDFAMDIHhABABHAHeCBH.EAAGRFBDAFGHhACAdHEH...ICADhACAaFGD..XAEA....hADA...cDBFhAEA.fFECWAFC,1,-13,-34,21
dbeIOUcJMVQZXCDSBYNfLARETKgaFPHWG,TDFAaCDBHEGD.GADFdACBeFAEUCGDMFIBQDADZGCG.CAAGDEFDhABABHGD..NGAH.fAGGhAAALHCGAGGFECCBhABA.KEDA.FBED.WAHBIHAD..hACA......hADA...,2,-11,-10,1
fALRPSJTDWdeYKbaNGFcEMgXHBZQUICVO,LDDERGEC.JCBDDAAH.eBCGKAGB.aBHBFFFE..MDDDHFBBQGBChABACBAE.OFAHhACAAFAHSAEFhAAAdDABbCFH.NIDF....EEEHBEBG..IACGhABA....hAGA...,2,-36,-15,21
PTVGMDKdbZXYQICUfNROgeSLWFBaHJcEA,TGECGCBCMDDG.dEGGXEEG.QCABIEEECAADhABAUCGARADC.OAEEhAAAeCHBLHFGWHAABABEhADAJHBEAFCGDFAF.KCEAYCAD.fAGDhACA..gGGHhAEA,1,-10,-24,14
gTaHWELGSMFOBKbJVZeYfRUDAQXNdCcPI,XAEGCGHD..IDEAaDHB.EEBCSEDC.MACDhAAABGFBKFHHJFAHZFCGfFCChAAADAGEABIBdBAGPFAHhABATBAHLADA.FEGCbCFBeHDEhABA....YHBGhADA.,1,-23,-25,2
KUTQZfdXVeaIJYgcGRBCMPAOFSHNbWDEL,SBGEHDEG..bAACEABELDCFKBEDQEAFdAGBeAEBaEFGhAAAIDAF.gGGChABAcGGBGGAFhADABEHACFABACDBOBBBFHDADBHF......hAEA......hAFA...,2,-20,2,22
AXHCLSPNdVRYQKDfIaMTWOgFbGZeEUcJB,HCCFLBDHSFGBdFCERDAHKFFBDDIF.aFAHMACC..OCAFhAAAFAGAGCGAEFFDUAEFBCCChAAAAAIFCABC...PHCAhADANICH...YBGBIHHF...hAFA....WBAFhABA...,1,-7,-34,27
aTMKFCWNYOQDfEZLeSgdPRcbHBVXUIGAJ,aEGATBCF..MAABCDAH....NFBF.OHCC.DDEEEGBFZBBDhABAeEHDSAGDhACAdGDHPAFFRFAFHEEB.BCHHhADAXAAGIHHAJAHFWHDA..fAEChAEAcDEF..hAHA...,2,-23,-17,6
QbcHXMBFLJYgVAGRDTSUKdZfEeWCPIOaN,DHGASEDBUEBCZBFDECFH....CBAH.IGHD.ODAFhAAANEAE.QACGhABAHADHBFFHLHBEhAEAJDHH.YAHFAABE.......hAAA......hADA...,2,-49,-16,33
CHKdXSYENMIcGLRBVTFaDeJAZObQgUfPW,ZCAGQCADUEFH.....fEAACCEDKHBAdAFC.SGDGhAAAEEBC.IFFAhABALAHHRDDABCGDFAACDACAhBDAAGBAbACB.PHAEXGEGMEIH...hBEA.....cGGDhBGA.,2,-42,-2,40
SJBTUDCGdXMEANOPfYVHeWRZagKbQcLIF,OHFG..YEEEeGCAZBED.aBDHKBBH.QAFChAAALCAFSBGAhAAABHDHUDBHDDADCABEdGACXGFFhABAABEBfFFBHFBFgACBIDGB..hAEA......hAHA...,1,-16,-23,7
fTXWCgJSBeUGDVZaFAHKMQYNELdRObIcP,MCBBQDAA.EHBARBGDODDG..IBGB.fBCDhAAATFEGCABBSGBBhAAABCAFeFDEDEEAhABAaGHFAEIFYEHFdCCGPADAXFAC.WDDChACA.....hAHA...,2,-35,-12,23
KcbeADZEPNdXFISBaHQCMWURLgJOTYfGV,EAACdBHGFEEFBCBG.HGFCCEHA.UBFBLACC.ODCDTDCCGGAHhAAAKACGeEFAZBAH.XGBChAAASHGGMIDEhAEA....WCCE......hABA......hAGA...,1,-14,-32,18
fLBaITXYFgeKbRGOJUPdCQEZSVMNAHcDW,DCGFLFDEBDDA.aBDF..XFCAFHBEeFHHKADGGABG.OEABhAAAJCAAdHAD.EDABSCGEhABA.MADAhAHAAABCHFGFfFBCIBHATGEH.hAAAYDDGbFEH..hAIA...,2,-33,-14,19
dTCHAXGMESDPgfQNBJIaUVRYWKOFbLcZe,XBDBMAFGDHGE.......fEAHNIBHBBHA.IFEChAAAVCAH.RGBAKGFBFDDBLGBGhAAAZCFGeAEEdCBFhABACCFGHACGAACB.EFGA...SFEBhABA.gDGChACA...,1,-17,-25,8
HaLGNePIfdUVbJBDEWYXQCKFAMcZROTSg,ZACHTDFGSHDG.HEFEGDACeAAHIDDDdECBUBGCVABBhAAABBFGDHFAEFAHXAEDhABACGHFABEB.RFDAaAGANAEF.hAAA....PHBCfCBA..hBAAWHFA....hADA...,1,-6,-16,10
JaMdIPfBOFXTWGAZLEKVQgDcUeNYHSCRb,ECEEVGFEDHFC..UGADeBABHEDE.CAAA.RFBBaEEH..MEAAdBHA.hAAA..IBFEhAAABFACXAEETACFADGBLADFhABAKFAC.........hACA......hAEA...,1,-26,-27,1
fIEPdJgWAGDRTBXSFbZVCNUaQMKcOYLeH,DDFFBHDGFBACZCBG.CDEH.UGGF..MBHFOAHFLGFG.HACAhAAAEDBBdGAH..gGAFhABAAFAGGEDGRADDTEFDhACA..SAAENAEBKBFB.eBGDhADA......hAFA...,2,-29,-16,13
cQGVMINaAgDKWfPUROHFYdBbJSECTXZeL,KEFB..fCCCRBCGFGCDBFHCSEAH.TDEEZFDHeFAFhAAALBCEQCGAhABAMBHHIFGHhAAAADDD.gGCHDIGGWAFE.PBAH.OFHDhABAYCAD..hACAbAFBCEBB..,2,-40,4,44
XPWITZdcQMBgfFESGYUAKRJaCVeHLbDNO,KCDBaACG.eAECLDFHDHEG.OFBG..XFGB..hAAAIHBCTABHdDAFhABAMBEHBHBCgBAGhAAAFCFGSHDGYHDGAEFGJEABCAHBHBGD.PEHDhABA....hAFA...,2,-25,-20,5
gYcGWNUbVXCdSAMFZeBKPLDIJEQHfRTOa,MEBBZAAHeCEBBGECLFBDDDFE..JBACQGEC.HADGhACATECEOCHDaFFD.hAAAcAGE.NDDCUGGEhADAXAEH.CAGGADBA.KHCA.EHGA...hAEA..fACBhABA..,2,-37,-5,32
JUIWQXKcLCMYGFAfPHRDNZeBdTaEOSVgb,HCDGRFEEDAFBZABEBCAD.TGEE..aEEGSAFG.VEGDhAAAJGAEUDAF..hAAAIHCBXAGDcABAhADACCCE.MCCDFDHHAHHEPBHD.eEAHhAEA......hAGA...,1,-14,-39,25
KJLZRcFHSWfIaVOPbADEUgeQNTXdCGMBY,EECBUCBA.QDFD..NHAHdBGCMBAFBGFEKHGCZGBERABAFEFAHBFChAAA..SCDGhAAAfAFFaFHDPFAChABAABFBDEAD....eBADCDDE.....hACA......hADA...,2,-28,-18,10
FWaYVHZOAQRNEcbKJfBdIMCSUgXTLDeGP,QFFCRCCEEDAD.KCEGBBGEdFBC.CFGCUGDA..gADAhAAALAAGeFABFAGFaCAG.hABAHDFGAFCF..NCIC.cDAGhABA..fECBSGCEDCAA.hACA......hADA...,1,-19,-31,12
gaZXOYMDNLVbJfTFARIHWdcPCSGQKeEBU,HGCGdFFBCFCFGAGGQEBG.eAAGUBCAaAHHOEAGMEDGDDIDLGAAhAAA..VBDEhACA.fFGBhADAAACAIHHDcGGC.SFADKAFFEGEBBBABhABA......hAEA...,1,7,-27,34
UEMZAGJaebYXRCgNdTcKPBIQDOWHfVLSF,aDAFeBDC...XDEARFFCCGDE..dDCBTFCEKHAABCGA.DAEChAAAHBAB.LCHDhAAASFCDEFAFAHHDGABFhABAJFFFYHBA.NABH.cAFE.IEFAhACA...hAGAWHEA.,2,-47,1,48
SDWVRLQABTdPZXYFOCegUHJGbIENaKcMf,BHGGTGEAZEBE.FAGDOFAC..CHEBUCAGJBAEGADA.EDFFhAAAKDHD..MCIHDABARADBhAAAAHBAXGGH.hAFAeAFCHGAGIDAENGDH.fEGChABA...SDDDhACA,2,-46,0,46
IJaLTBPeDRHgZWFcKNACUXYQbdMVGESfO,CFFEUCDE.QDAHdGEGMDACGBGG..fFHAhAAAOAEHJFBFaEFD.BDHGDEEAHAAAhAAAgGCHFHGG.hACAKABFAAGF.XBFF.YHFA.hADAEGAESAHBhAFAIADD...,2,-26,-9,17
fLFJaMTNeEXQVOUAZgdIBRCKGPDbSHYWc,ZBBCdGHGRABHGEAEDCGA..HFCF..YEFD..fAEFhAAALFDDFEHFJEECaDAFhABATAEH.eAAEhADAEHEC.QGGDOCECAGBGIHABCCHC.hAEAKAGG.....hAGA...,1,-13,-17,4
CcWSaNLfPeIMZBEXURdDQYKAFGTVJbgOH,TEAGJFEA..ODCECDDH..SFFDLHFGeAFDZBBGBGCDhAAAUABGDGGEKCHHAHAHFDGEhABAGEAG..gAGFhACA.WFDBfFDE.MAABhAEAXAEF..hADA...,2,-36,-25,11
YLJaNQcAMHKCVeUZDOgPWRfFSGTIBbXdE,HDECKEAAeCDCDFCHOBEG..PGFARFDFFCAB.GAAFBHGCdFAGhAAAEEFALHBA.hABAJAHBNCDAAFHGCDFCZFAE..hAAAfABHSDCG......hABA......hADA...,2,-30,-12,18
YFGdZVNBDeIAHgMWcQKPfJaEURbTLSXOC,MEBDQGDHKEHD.JDEHUDDC..RCAELFAFSHCAXACHhAAAOAFG..FBBDdHGBhABAZGFEBGCCDGECAECCWBHFhACA....fAEEEAEACCFF.YAAEhBDANCIG...ICGFhBHA,2,-31,-24,7
aBJUeKTLdMgVbHNCIGQFAXWSOcYZDPfRE,XDCDSCDD.OFDAZBDFDCCF.RGBEBAHAeDBBKCHD.LADGhAAAMACE..VFGFhAAANIBHCGCAGGEDAIEA..hABA..YBAHEFABaCAG...TBFEhABA...dGAG.gDGChAGA,1,-11,-23,12
QPOAFaSGCIDKfcJVWbZRTeBNMYXHdLEgU,FFFFSFEFCBGC.KFAEJCAB....bBABZCFA.RACDBDED.hAAA.YACBHFBDdFHGhAAALAHD.UGGEhABA.QCEGABIDIHAFfGBHhACA.cAEFWHEG.hABANIBB...,2,-45,-6,39
GfQNeCTZKULOXPFJIWBEbVHcaDSAdgMRY,dDDBMIDARBABGGEF..NFED.CDHGZBFCLDCD.OADCXFADhAAAJDAFBABEEADCHECChABADBIBADEA.....hACAgGGDfAGHeHAA.KAGEFFGAIGEBhAAA.WDEAhADA...,1,-3,-35,32
KNGQTXMVcRfAgbFIDaOBHdYLEZPWSJCUe,FGFHaCCEHFCGLADGEBFD.ZEEE...SCCCUCAGeAFGKFCBNAAF.hAHAGCEB.TEAAhAAAMHFGRDFC.ACIDIHCGhAIABCABdAHC..YEHB....hABA......hACA...,2,-21,-9,12
KbeSaWTFHPXOfBAMIDYUJGLdQgcVCZNER,DDAGJADDGDEGdBFF..QDFF..cAGGCHHCEABEREAHKHFGhAAA..eEDDSGAAhABAaFFE.TDABhACA.FGDBXBCEfBBEAICAMAEC..hAAA......hADA...,2,-28,-19,9
aDLHQRKSEVOBdCTgXYMJWfZGANUIFcPbe,UGDEFEGA....bEDCDDHF.LCCAHGDEKGAEEAEEBCBGdAAFCGGHTBFBhAAA..XAGHhADAMAECJACHZEBEAAIF..hAGA.IBDEeBEDaDAH.SGGHhABA......hADA...,2,-32,-16,16
FdJGbAeSIEVYfNWDTRgPQUaLKXBHMZcCO,SHCAEEGE..VCAH..NAHADEEFTECA.RAGHQGFBhAAAUBDGKBBABHGFMICAhABACDAFFFAFJCCA..AGBA.eFFEhAAAfGAG.PACCaFCB...hABA......hACA...,2,-40,-5,35
BMLPJUKDIQHWSXCVZEeARGafgbdFcYTNO,aFCD..fECGdBEBFCBF...TDECBHAGLBAChAAAUADDKGABQFGHhAAASFEBCEABEABHAADAGBGChABA..bGCENEGGMEIDDCGGIEAG..hABA..WAFE..hACA...,2,-30,-11,19
CBYcNVGOMXfPUbdRQALTSZWEIJDaHgFeK,LEFETAGD.SDAEEADD.DCBAaEFAHAEFeGCGKAGHBFDEhAAA..NGAH.OABHhACAMIDC.fFAHhAEA.bAEDdACHADDBIFFAJGFECEDE....hAGA......hAIA...,2,-23,-21,2
MQaUZeGIJAbDYcgERPXNTCLBfSFKOWdVH,DCBE..gGACRFAE..XCFGTFDCLDHHhAAASGEGFDBGKEFBdBFGMIAEhAAAaADHeEEEGDABAHHCbEAChABAEACECABDBCACOAFC..WHCA...hAEA......hAFA...,2,-27,0,27
ERHcXFYZMaQfCeNTgLbKJSPDIGdAOUWVB,UEFGBBEGRAGDHCBHFEDB.ZABC.MHAAQAAF..eAFGTGGAhABA.LEAHhADAbBFGSEDHDGEDGCFAhAEAOFHD.EEAHYCCDaHFCNAAE....hAFA......hAGA...,1,1,-21,22
eTOUJSGVCbKIZFBLdYAXQaHgMfPWcNRED,aBFEMFGH.....PEBENAEH.DAEFeDDE.OHEESFEHhAAAVEBA.CHCFIBAGhABAFFHDBGDALABBhAAA.AGFE.HBGFfADEcDABEDDEJCHDKGBDhBAAdGAE.....hACA...,1,-9,-30,21
bKUfYSPVQaNDGCMHcZJBTXegEALFIROWd,LDHDRABGOCFC.dGAFUGFFSBBG.QBEEDECCMFACHGBGhAAAJEAGBBHDeBABAHHAFGEBhAAA..IAGFhABAbCAG.fEGA..YEFHhABAaCCCCAEE.....hADA...,1,-15,-22,7
SbPERcHZGeINFKfdUWODXLVgJBQaCAMTY,MEAGTGFH..SAHDEFDHHAECGCEGeCBGFEGFKCCB.fCHEhAAAdFDBUGAE.DBBCLAFFhAAA..gDADhABABACACBDHABAAYFHBPFAB...hACARGCA......hADA...,2,-12,-11,1
XYIcLMHJUOFZBfRTSbVQDeaANgCPEdWGK,CGBFEFGBdFFHKDEB....XDCF..cCGHMADAHGDEhAAAJBCH.OBDGBGBARDAHSAHDhABAQGEDDDGFhACAAHIB.NDIA...PAAHWBBD.IAEDhABA.FAGA.ZFCD..hACA...,1,-21,-22,1
cDKAMZLTafSHOCUNQJWeYEBVbFdIGgPRX,MCABTCBA..aHGGSFABHECC.CBCE.QGBG.hAAAJBFCeBEBBDGBbFGDdBDEhAAAICGHPABB.XEDGhABADIDAKFGCAAHAfGEH.NADB..hACA.EGEC....hADAFHBE..,2,-14,-12,2
XUPVfaYQJMbCTGRdWIBeNDELOASKFHcgZ,SAFFHEEHZACBXAGGUDBD..VFEBaFAD....JDFCbAGHhAAACBADGECE.dGHChAAAIBBFBHFAeBEFhABANCACECDGAIAC...FEFA.cGBC...hACA..fHGFhABA..,2,-13,-11,2
DbUGJXZSKaLWFTRNfVgPQIACEHBecOMdY,EBBEBBDE.eEEHOCEBdDADDEIFUFGA.GEACZBFCKGFBLAADhACA.FCHDTAAGRFCFVAEAhADAQGBF.hAEAAFDECAHAMFFB......YDEChAAA.....hAHA...,1,-7,-29,22
NGAgLVeUDWfTaOKHEBdIYRCbPXcQZMSFJ,VECCDGDC..TDCAKAEDBGBDdCAH..RBEG.CGFB...XGAAhAAAZAACMFADJFHF..AFHBLEHHhABAUABFaHDCEEAD.hACA.IDAA...PBFCcAGAhACASCCGFEFF.hAEANIDH...,2,-29,-17,12
SaNTdVgOfFDcPYBAQeXCHLWbJRIEUMKGZ,XEDELAGDJBCF..EBBBMGECKFAHGBEBZBAF..SGHHhAAANDHC..dDBDhAAAOAEDfGFChABADHEAPEFGAEAFeHBCCEDH.HACA....WEADhABAIAHAaHBE..hACA...,1,-14,-24,10
ERCOMedTDScIYVbJaFXANGHfQLUKBZWgP,GBFAQEGBUCCGKDCDZFAD....gABDPEHDCDAD.MAIFhAAA.dFBDSAADhABAIAFB.VFCDbFDHFGHDhADAAHHH.HBDBBAGEEHACOFFBDEABJFFF.NAHC.hAEA......hBAA...,2,-17,4,21
KfeBUISJHGCTRMDgaANWPYLZVdOQcEFbX,...NDBF.PFGFLBBCdBAE..QBGHEFBEFGAH.KAFCBGFHhAAASFDFHAFBCDHGMEAAhABAgDEBACAFZFGFOFEBhACAXEAB.fHED.eAAEhADA.ICCA.hADA...,1,-10,-18,8
aNZEAXJFDUOBYKTLbVGMSPWedICfRcQgH,JGAGUFCABAEEKBEELEGH..VGFGMCAF...SCCDhAAAeEBECDAC.RAGF.QAGFhAAAHFEH.ZBAAhABAXABCFGDDDCFB.TFAC.PDDGhACAWBBE......hADA...,2,-33,-19,14
bUXKZQLOTVCHDPGdRAJeNgfaESFMBWYIc,JEACeAFF.....fFECEFFBMDEABACG..YBAGhAAAIAFCUEADKBBFZDDChAAALAHB.TGFGhABACHCGDAID.dDDGAEIHNEHGaHCC.SEEEhACAFGCA......hADA...,2,-35,-17,18
OIMVTSGNFURcgWBLZAXDfeHKQbCdaYPJE,DAGAHDDBQACGdCHEaACB...JDFEEEBH.OHAGMFGBSCDAhAAAFAFDRGFE..gBCHhAAALFHBAIECeBAHhABACBGFPFAB.IHCF.VECEhABA.NBBG.....hAEA...,2,-23,-8,15
CUGAgIcdENOJYXeDZMRHTfQbVPaWLKBFS,..IHEBdDAAEFFBJCEE..eCABDECEZBACHEEG.TFBG.hAAAQAGDPGACLEHBhABABAEBSGHBhAAACEFEAAED.cABANIAH.YDEEXAGAhACAfCCG.hADAaGAH.KDHB,1,4,-30,34
YDFbSNAgXMREZHBWQOeCcPLKUaTGfIJVd,XDDHEGGDHCCDBBBH.OBAHCBACLHBAUGADGBEFJAEAdDBBFFHDhAAASEEC.hABAAHDAMFFBZFCAeAHHKEGGTEADhAAAIBCEDGID..NDAA....gCEBhACA..hADA...,2,-21,-1,20
LBDbeHEQKMPJGUfaYTdIFCWXANVOgcSRZ,VBBDOFFG...SAHDLGBCBGGEDHGAHCAGQAGAhAAAMBEHGFBFaADGdDFCCBAEAHEHhAAA..NEIA.RCFEeFADhABAKBEG......PHECfACHhACAIEDF...WBAFhABA..,2,-17,-17,0
fRBOLbDUPYgNQEaHMFeZIcWVASCdKJGTX,CFHGJCDFGFBH..XAGDBHAAODAGDGDF.UAFA..PFHBhAAA..YBBEhAAAQGED.aBFBhABAMCEDFCBHeDFCZFFFIHEHVFABABBESAEChACAKAHB...hABA...,2,-33,-13,20
FJbMUKaHcADgfdGVSeCBQTZIRLOEWNXPY,DAAHdBHCSAEEeCDCBAGGZFFCRFCG..EAAB..XEBDFGHBMCCGhABAKEGEHDDG.AIEGGDAChACAQGDHLHAAhADAOCAD...WDFC...NBBD..hAHA....YFAFhABA.,2,-43,1,44
FbLBCWgcTUKGODfHeSEdaXQPJZRIMAYNV,VEAELADD.CGAA.....gEGCUFGBGBAADGIHHABDhAAAEFCAdAFBaAGEQGDHhAAAZEEDRBDGAGDEFGAHBCFH.hABA.WHDAKCHF.fDDGSEEB..hABA......hACA...,1,-2,-23,21
bHCTRZMaODPWFSGeBLKYIQXgJNUVAdfcE,dHADEABGHDDBCFEAZBAF.aDAF..OAEHDAEHFCFFGBGELGFC.KCCHhAAAQGGD.hADAXFABJAFGNICBAEHD.fACEhAAA..cFAEbDDG.MBIBhAFASGCB.BAGChABA..,1,-10,-20,10
bWgMGZUecDaHLRACFOYXdQSJNfKVETPBI,OBBHXGABdACH..SDDHJHFE.KDBFEDFABADB..hAAAIAFAbDED.MCEChAAAZBAAeFHBDFDFHEFGhABARGCEAICCCAFDQDCD.fHADhADA..PAHD.hAHA..WCFB,2,-27,-13,14
MbHBQXKNARYeTDJPLWFdUZIScVaEfgCOG,eEHHJACFLECAdEEDUEBCZGFA....IBBEVAEE.EBFBCCHBGBAChAAA.MDGFhABABHFF.KHAAAIAA.YADFhAAADEIFFHDC..aEAHOAEA....hABA......hACA...,2,-36,-17,19
TeSYCKQMZLFOJHRBGIWEcbPfUAVgaDdXN,aABEdBGA..TFFCeHFECAFAKAAD..ZCAELHAGFEDEHCGFGBCAhABAEHAE...bAEBfGDFhAAAAEEHDGID.SEBBhABAYCHBODADBFAH.....hACAcGEC...hAEA...,2,-21,-8,13
WNVKbBPTHdOUYLCaegFEfIcQARJMXSZDG,MBCFZFCBDFAHGBEG..VBDABHHHHCACUGACLFFHCEHC.hAAAeEHFEEAE..IADChABAAIHGJAAA..SBGHhADAKGEFPAHBOAEAaGFD.FGEB..fDDGhACA..hAFA...,2,-31,-10,21
IVLeWRdEYFNTAbUcXMOgGKfDaBSHQCZPJ,UCEBXBFCOADGKCHH...DHCCBHBBHAAAQGDFZCAG.hAAAJABDIFBDLEEAhAAAeAHHdEBCEGGEFGFEAIHAMDAFhABA..fEGFCECAWACH...YHAAhACA...hAEA...,1,-16,-23,7
THIAMWBgbaOeJUXRdScYZVQGCNFPLKEDf,BEFAaCFA.JFAARGDEdDBF....SDDFZEECVABC.CACGFGGALBHBhAAA.KFBGDIDG.hABAHAEGAEABMIAA..hAEAWAAB..gCEGOCHFeHEEcGGDhAFAQCEC.hAGAPHAA.,2,-29,-10,19
gOCWJScdDUEPQFHGBLKYNaeIMbZfAVRTX,RFEHTEFBODGF..JAACdGDG.DAAGUAFB..EBFCFECAGCBGhADABEAALGACKFAH.hAEAaCHDMAIFZADFAFIBXDDFhAFA.CGHHSBBEcGDD...hAGA......hAIA...,1,-17,-32,15
UCcIFWDNVePBSfbJGHTdQMgERYLXAKOaZ,aEGFZBCCCFAD..FGABDGGD..eAFGBFGESABG.JDCFGGBHhAAA.HDDEQBEHhAAAgBFBEGFHLCAFhACAAAIBODBFIHHCWEHH.NABD.fFEFhADA.dHCDhAEAMCIH.,1,-7,-37,30
IOLAGMEPTcRQbgfHeUYBDWFdNCaKXJVZS,MHFGEFFC...TEDHRCEEQDBF..fBBEhAAAeADEUGCCBADFDBAA.FFBHdAGAhAAACBEHaFGEJHECSCHHhABAOAFAAHEBGCEH...PCAB.hACA.gBCChAIA...,1,-12,-18,6
bUCHGYTAEMDORPNaZQdKegBcSILWVFJXf,MEDBDBAERDFH...aFACdECA.eADCBEBE.SBDBLEEDVAGFhAAAJEEF...XDABhABAfABF.CGHFHBFDhAAA..YCCCAIBCOBABNIDHKGHHIAHChABA.WHDA.hACAFCHD..,1,-19,-25,6
QaPLdOZFRGIHJcebAVgNCYBSDXMfTUEWK,VDBDCEDHBABE..DGFGMEBD..UABEKGGF.QGDCLFFEOAEAhAAAFBGEGBDGHGCAhADAJFAFeBCC.ADDA.NAAA.hAEASCFF.XCGEEDHBaGHD..hAIA......hBAA...,1,-13,-29,16
WgDTQAEXLNVYSCbGIRdMZaeHfOFJcPUKB,XGEALACBVEFD..SGBBGAEDdFAFZAFC.HDCDhAAAFAADJHDCPBAABDFCDEFDhABAADEF.NEAG.CHHC...bBEChACAICHEaDHB.OHACKDAC...gECBhAAA..hAEA...,1,1,-23,24
YXZDeNRPCIULJdgGTQOFcSbfMEVABaWKH,BFFAKAAAHCAHZDCFDGHFRDCF..CHFCLEHFdCEH.GAEETDAAFAGGhAAA..SABEhAAAMEAFEGDC.AGAD..aGADXACFhBEAeEHB.ICHCgAFC.OHCGhAEA.fEEHhAFA.,2,-38,-4,34
dQHFacZPWeYfGKRgSDTEIOBMACbUNJLVX,CEHEUDCCLFDGdFFCFABAZBCD...eFBHGAEAKDAB.RCGF.DHFGEEACBBBBhAAA..MEIHAHDA.hABA.JAFHQGBDhAAA.aAHFPAHB.....WHFAhACA...fEEHhADA,2,-34,-30,4
AKVYPWbMLIfJeDOGHZRSdcQaBXTgUCFEN,KFABVDBE....PAEEMBAGLAED.JEGBDCIBOFBBhAAAZDAAdGFD.aACHXAGGhABATGCF..UCFAhAAAEGDFADGA...WFEBbEEGIBAG.hACA......hADA...,1,-23,-29,6
MAOHREYaSVZdDWegGJPbCUNcFfLQBTKIX,HBEGECEC.aDFHSHBCdGEDDDCG.eAEEJEAE.CDCGUGGA.FEEGQABEhAAAKBBG.IAHHhABAAHFFOCGFRGAA..hAAA.YDAHZFGD...WAHB..hABA......hACA...,1,-16,-26,10
YZgEacbJeSdQfNGBCUOMLIKWTVHFDPRXA,ZDCGaBDE.JEHHdEDA...QGFHGABDBCGCODBDLGBEhAAAKCAE..TBGAHFFFDIBGhABARDFEAIBC.EAGGeABEfCAFhACACAFBMHAA.IEAA....hAEA......hAFA...,2,-22,-12,10
FcCKQWAVgfNTMHIeJZSELOdUXRYbaDPGB,VECG..fGAFMAGD.HEDDJDAFZGFCSGHB.hAAAOBCCdHBFXBBAhABARAEEaCBCDDGABAHACHEHWAAChAEAACIB..gCED.IEHHhACA..LFGDhAGA...,2,-21,-19,2
UWTeYgFJcRVMECZabdQIBKGDHPSOAfXLN,XEBCLBFBUFAF.eCABFAEEJDGBRBCG..MFIDEABECBHGZFDE.hAAAdHEHQGCAhADABABC.DECESBHDhAAAACCH..fHGFNAEH.WEAD.hADA......hBAA...,2,-30,-19,11
TCMPERSaJBHNQfgGLZKAFdbOVIeXYWcDU,dEDBODCHeAED..XFDE..YFGH.DHAEUAAGhADACBGG.MBFFRCAGSGDDhAAABBGFNEHGQGAGhAEA.fBDCgABGLAHBhAFAAEHGFAGAIGEB.hAGA...,2,-27,-25,2
BeQWdDGLVbSEMCfNZgTUHPKYIOFcaXRJA,QGEAdAFHDDEALEFHSDFE.MCIFfDAAZEAETBCChAAAHABB.KECDIEFEhABAOEEBaHFERGAGAIAABADBhACAeAHH...WBBF..bGAGCHHG.NEICgADDhAAA..hABA...,1,-8,-15,7
BVFWLfQDeOIPaJEXZGbTRAcYUKMHCgSdN,UEEGKCCECBFF.dHCHBGGFFGHH..LCEEDEDF..eEEDOEAB.hAAA.aCGBEFBHZGAAGABAhAAARCAB.AAIH.MAIHSDHHhABA.NDDE.fABF.IEHAhABAJADA...hAGA...,1,-19,-40,21
cbYHFJgPUTOLfVIAdNeDXWGCEKSQMBZRa,dDCGDEDDGABGEBCC.QEGHZBGDaGGG.....bAFDFBAFJHCEhAAAUDECLDAHIFAChAAAAEEFeAEFCAEB.KAHHSHAGhABABGHD.RGBE....YHFGhACA.....hABA...,1,-13,-17,4
QYGebONFCJgXERPfHIcBTDMZaAKUWSdVL,KBFFSCFBLFEGGFBHOAHHFGAH.CDEB.JECH..EDBHRACBHCADhAAABCABDHGCZGFGABACdADH.hABA.QDEFhACAeCHH...NIAD.XCCFIGAEMIFGaAEG.hAIA......hBGA...,1,-8,-21,13
WBaEIQGXPVZURfKbMTSOHLgFdNCJDAYec,eAEFBEDAEDBCQBABGGEH...PDHDVBGDZBCA.UGAEhAAAREEDfGCH.hABAKDCGMAFCSAGFhAAAOCABLFFEdEAGJAHBACFHcGFD..hABA......hACA.aADB.,1,-7,-12,5
DYbMNKCTJLAfVPSUZHROIBXFEQGWdecga,VCFGSCEA.UAAFRAADOECBBCHFFGEHGACB..eDHHhABAaEGEDGHHMDDH.KADF.hAAA.CFAE..TDDHhACAAAIFfEEBPFFHIAHGEGBEdGGD..cGAHhAEA...gAFChAFA,2,-26,-17,9
SDCOVbBXEcPQAHRNLfgYMJeWKFGadZTUI,HCEBRBCGLFAE..YEAHeEEAFAAEaFGAdAHC.UGGGDGDGCCDA.hAAA.ODAEBHGHECGGhAAAQGCFAICG..hADAfADA.MBCDKGAB....hABA......hACA...,2,-34,-15,19
HgZGLTSBFMJdcDbEINQWKVCPRAUOXYeaf,OHACXCCE..eCBFaGFF.HDFFGEAFLBACBHDGFBAFdAHEDECEhAAAEHAA.IAFChABAQAGGVFDDCEHBAHFFfHGHhACATAECSFFEMDAB....hAAA......hABA...,1,0,-17,17
dITaJFfPUGCSbcVWKOLMNHYQDegEABRXZ,RBGBdFBB.aGDDJCCF..FFEAUADCGACG..CHHA.SCHHhAAA..VFEAKAFAMFADhABAHGAGDAAEEGHDBHFChACA...ICGHfAFH...hAEA......hAFA...,2,-44,-24,20
bRfXdVIFMGUaeKPYcNCSJOETBLHWgDZAQ,QBCHRBFGdEAAFBBG.UDFGKFEB.....PDAH..NEDC.hAAACBHGSABFhAAAEGGB.BHGELADHhABAgGCHAAHAXGAAIGBDMFIHaDDCcEFFhACA....OFHFhADA.,2,-33,-28,5
VAGTfPYcORFEaHbeBWJNIdDKMZSQLUgCX,GCBATBAE...fDGA..cGGHFGDGaAFDeABEhAAABBHGJAGFdADAKGDFMIAAhAAASEGAUGGGCHFFACAHPDCChAEAOABBEHAC.WFFDDFAHQDDChACALFBC.....hAFA...,1,-2,-20,18
cAdTOXCLEFeMKGWRfVBDQPgJHUNYSIZba,dFGGTACGODAG.LAFGeFDBMFADKABFGGAFRFFCBBAEDCGAQECEhAAA.JCEEHCDChAAA.YFBBhABAZFEFaACDAEAHCHHGFCAH.fEFF...hACA......hAEA...,2,-15,-7,8
TOYXDRJdfLNgBASZHKeVaCEbIUcFMGWQP,ZFCGHFCHeBACaDEDCCBGEBEA..UFGCFFAGGGED..PBFGhAAATCCEOEAA.DAFAhABAdAHC.fDFBhAAALADHBBBEADIBKDAG.IHEB...hABA.MIBE...hACA...,1,-5,-25,20
DdYEQbBOMKgcXaNJCVRWAUefLGTZSHPFI,UGAEeEFFGBDBZBCAHEEDFCBCDBBBdAAF.QFACOAFG.MFIDhADAKDBB....XEGFhAAANEADCAGH....hABAWDGBAADAfGGE.SHDGhACA.ICHAhBAAEADA.BEDFaGGH,2,-20,-10,10
ZPCTYLVBaeUKgDXQdEAcGHfFNJRbIOWMS,HCBDFGBBREDB.OHAA.MGBGSAEFZGEECEEA.LAABBBAFUBEDhAAADIECdFHGAIFE.GCEBhACA.JCCBbAGF.IEAAhABA..TAGBaADA....hADA......hAGA...,1,-14,-27,13
XbTPWLFdUNVKMGZBEOeRaAJfDYHISQcgC,JDAEDGFHHBEF.SAABQFEFCEED...TBFGLEABhACAdFACUACGKHCCMEIFBAAChAFAeDAEADEF..IDHEhAGAXACD.WEGBFGHDNIABZAGF..EFBC.hAEA.....aGGHhAFA...,2,-20,-16,4
OQDZGIeFWfgUKHXBbdSPJcTaEALMRVNYC,RDCEVFBGCFAB..DDGEZAFH.GBDGFGFD.....fGGAhAAAUGCBKBAFBBDFdCBESBADhABA.PAHDhACATAGFEGEHAFGGLAEHNEAC..OFFGhADAIHHC.eBBHhAAA...,2,-49,4,53
cNMJHGEaSIgPWOLYZBKbTdCfVQFeADXRU,XADFUEGCMBDEHCEBGDAD..EBHFSHBE..hAAAPCBCOABBYGAAhAAABAHGTFDACGGCfABAhABAFCGAeCCGAGFFDIEANACFIHHELEHH.hAIAKAFG.....hBAA...,1,-5,-16,11
OgAXCPfZdWTSYcIbVJaLHRNKBeEMGFQUD,CHDFZADBdFGGSGAD..IBEBJEFGLAADHBAGKCGGEHDCGDABhACAQDDBDGCCABGGhADAXGAF.PAFAhAAAfGGH.WDFCTDAB..hABA......hACA...,2,-27,-19,8
PRSDBALEFbMCJYgIVXHQONUWGedTKcfaZ,LBHDFEABMABF.CGAF...JDGD..IGHBHADDQDDFhAAAUFDDeCBCKHBG.aGCARBEFSEAEhAAAAHHD.hACAEABGYBHH....XGFDhADAWFFD.....hADA...,1,-22,-31,9
PDQebTXgAMCVNWKYOGIZBJScaULRHfFdE,CBEGVAAHKHAG..GDDBBCEF....SAGFaCBCUFGGRAFCHFBAhAAA.FBHHdAAHDDFD.QGGDhACATGDGACCEMFAChABANIBH..ODAEICHG..cADGhADA.EEHB...hADAeEFH.,2,-21,-19,2
bAFHSaELZTCeQfKJDgPVcINWRMBYdGXOU,HECFSGDGLCAHZABG.eADFKDDHDICA..gAGChAAA.PGFCcAEENFEFRCFAhABAMFAC.BGFEdGACOABFhADAABHHFEGGaHAGCHED.QCAF.fHGFhAAA..hABA...,1,12,-36,48
bgIeSXCBKcWQLJHOGUNDTZEFadRVPMAfY,...bGFGIBBB.SGDBCGCHBECHKABDQFFDhAAAHCDCGCGGNADB.DAIFECGCdEAAhAAARDDGMFIFAAFC.fEBAhABAYADAXCAALBDCOCAHhACA......hAIA...,1,-11,-17,6
PKSZIWJgGXORQHABbYMDVUdFacNeETfLC,BADGMCAFUGBCdGBDFAHH....aHGAeCFHEDCD.LAAD.hAAACHGG.KEGEZBCGJBBAGEADhACAOAHBHEGFABFADGGC.hAEA.NIAB...PEEFSDDC..hAFAICFH..hABA...,1,-9,-40,31
FLcfdEXgAOZKBMUeDaVJbNRQSCWPIGTHY,ZEDEMDDBDIAC..aCFAJBBC..RAAF..CDBA...IHEBHGFELEEGhAAAdCFD.EADGADACOEADhAAAKFAAeAFG.NHAD.hACAQGGD.PAFC...hAHAYCHB.fDDDhABA,2,-36,-21,15
XUZJQfKCedMEVcTDHBWaAGbSONPIYLgFR,GBGCSGDHOEDB..IAGCLFFARBDHZBAGfBFAhAAAeFGHMCGHVCAFDDFHBGABhABAAFBF.bGEC.NBBF.YFAFhAAAFCCA.XDAA...JCHHhABACHAD.EABC....hAEA...,1,3,-16,19
dXGaZVDAHEMbBIgPWURScJeCKNLTQFOYf,EEGDMCCHBDDC..IADD..WADGRDFG..SGFHhAAAeHEGCEAF.LBFGhABAFBBHOAHHfFAAhACAdECDXGCHaHBCDHDCAGAC.bDDD....gGAAhAAAPAFA.cFFChABA.,2,-43,-9,34
ZDHbIfcaLXUROdNESVeTMWCKGQYJPAgBF,BCAHDDCFHEDH..bACCIAHA..aEEDXGBDOBFDdHGBhAAASDDEeHCAMHAEhABACBCHKDAHQEAChADA.PDDHAACEgGFGZCGB.fDGDhAAA.cAFHhABA..,1,-13,-29,16
CVZeLGcIHfXTKBWgODPFJSEadUbYQMNRA,CHGBeFDALCHDGBCCHAFD..fHEBTDBGBACFOAFBhAAAFHAE.JBAHEGEBaHAEdBDGUEAHhABAQEEFMAHFNDIEAEEChACAZFAC.IBAHKGGB.DGIH....hAAA......hABA...,2,-8,4,12
KJEGdNADIMYfXePgcOFVaTQBSZbLCRWHU,DIAAMEFE..XAGHeDCD....gBCBOEFEVDBHhAAAaBEABGFFZBDFLDADhABACHHERGAE.UGGBEAAHNEEAABBHfGDDhACA..PDAH..hAAA.....FCGEhACASHDGWFFE,2,-14,-10,4
NSUHbcVOEWKATPGdfFLgXReDCBQJMaZIY,GCEFdCBGLFEBRFBGeFFGCDGDBAHH..MBBCZBFA...NIADUCCChAAAHGAG..bADHOCADhABAEGGF.AHHF..TAGFhACAfACEFHEADAFBaEGESGAG.hAAA.WFAC...hADA...,1,-10,-16,6
BYIdDbQAKNWHTEURGfcPMZJOSVCeLagFX,KBADHBAHEEEDRFDCGAEE....PHAAMADHJEBE.SGHBhAAAVDADLEGDhAAAFAGABHEHdCGFDBBAAHHDNEAG.TCCBhABA..fGBEOHDCCFHAaAGCgCGHhABA...hACA...,2,-21,-7,14
IPRKLJOBZfYTdDVACGEgbcMeFQNHXWUSa,GFCDEFED...bDFEMCIF.QAGFHBDEXCBDSCBDhAAAIHAHKDEHLADHhABAOAAFBACAfBFGhACAdAFBAEAHCHFGeCFAWHEAaFAC...JHAEhAFA.YDGBDFFE.hAAA...,2,-7,-4,3
eRJKFYBcSLaIfDXUNVbTGPQCWdEOMZHAg,eFHBJDFF.FGBDBFCALCCA..IEBADBBGUAED...hAAAVDABGACE.CHDCdGAGhABAEGEAODFCHAFHAHHHKCAAhACASAAFaHEE.fAHANCHG.hAEA......hAFA...,1,-19,-28,9
CPWFTfZYOKXeAJQcbdSHBVgNaGEILUDMR,QDECdBECBGEG..VDFHaACFGGAH.EGGHIGCFhAAAUBGDMABBRCAE..CAGBFABAhAEAfEGC.OAFAhAAAKFAFAFID.bEACSHGG.NIBDDFCChAFA..WFHH..hAEA...,1,-11,-30,19
fgFGMYWQUeVAKaBJNRLbXPTEcCZDSHIdO,KFEFJCDGLHDG..PHAEEFEFZCGDSDBGHDAH.dABEhAAAOADAFBFBGCGChADAMBBA.QGFDhAEAeFHFAIBEBAHHbFAG.XBACCCDFDGIH.fGBFhAAA.....hAFA...,2,-17,-4,13
IfECeLcOgYbWMUFDNdHVBAQRTXaZSPKGJ,TCGFXDFA.ZEBDSGAAGEDC.JFDBEEAD.LBBEhAAA.OFHDYBDChAAAMDCEUCCFDGGDNAIEdFHEBCADhABAADFDQGFE.aAGAIAGChACACCAAeFAC......hADA...,1,-6,-11,5
BKZOQYFHbUdCLIPEVDJcSRNMgAeXafTGW,eBFGXCGF..aEBHGAABKFFBZBBAQECCFFHF.UDAGhAAAdGDGCEFFIGAG.hAAAEHGCDABCSAEBhABAMEAFABDA.TFFHBHBAODFAYDDC..hADA......hAGA...,2,-32,-11,21
aFDQMcRfXVKZdULIbWOGYSPJTeCHNgEBA,FFEEQGAHRADF..XCFEKAEDZCACUGFHLACF..IDGChAAAOFAFSFCFhAAAJEDD.CFHG.gABFhABAAABDMAFE.cAGG...dFABhAFAWDBG....hBAA...,2,-39,-18,21
FZVGNCESYdAWMcUQTJHDLgOaPRKbfIBXe,MDHFUAAFQECHHAECDCFFLDCB.aCABKCDB.fBGBhABABCHBFGFBZAAAVFGDCHAF.hABAEDAE.dHAFAFFCTEAEhACAOBFB..PHDCIHHEXDGC.hADANAEF.SGDHhAEA...,2,-19,3,22
TdQbPYcNHWfLBXCEgISRVFZeOKDMGaJUA,dEBDQADF..bGEG..PCAF..cEFGNDGEHDCHhAAALADABHGHEGADIBBBhAAASDHDFBGDOCEHhABADACHMCFGaHAAAEFB..YFDBWHFACCAG.hACA......hAEA...,2,-24,-7,17
DHFbSQTcRLECJOBVKfeUgdXWYAZINMPaG,ZDFAMDACGADDDDGDHAEGFGCF..QCACRFCECBBF.BGFEKHGCUACChAAAdHFH..XABFhAAAADHE.IECHhAEAaDEDSAHBLAHHJFADfGAGeHCG.hABAWDDB....hAGA...,1,-17,-18,1
CIBJcQGXKRZeHSFDAYUOdEbLTfMNaWgVP,ODBCdABCLAEE.MFEBaGAB..VAAGCDBGBEEE..QDFEhAAAGCGGKBFHZFCCHFBBhAAADEIFUAEAECDEbGFCNIBD.hADA....WDADIHGD...hADA......hAIA...,2,-19,-17,2
HURWDGSMcYeEVNgFdBQIJaCbfLAZKXTOP,KFBCXAAGODEGUEAD..DGGCGEDAMEBE.eADE.ECDEVBBEhAAAFHFABCHA.JHAGhABACHBDLHEG.hACAAAHDTAEEPFFG.....WCHH.hAGA..SBAFhABAcBGB.NEAG,2,-40,-19,21
JOHIRdMFGaUQbLCNeETPYfgXAWKVcZSDB,VADEZCAHBGGE.HFCAdDDHMAHFFGAHGDDBUGGH.LADD.hAAAeAFAEDAFTGCDhABA..YCHHhAAAfGAAAIHA.KBBBSBAEOFFAaCGHCHFD..hACA......hADA...,2,-17,-8,9
KEVIaAWRUFfYNHOcbSMLTXDPZdCQBJgeG,RCDAFFGH....fCHGHAGDODEC.SACBLBCFXFADhAAADDDBZBAFQFBDhAAAgGGGKAEBIBAHhABAAICA.WFECNEIAMFFHdAFBCFHH.BEAFhACA.....eGCGhADA..,1,-5,-26,21
gGKOTadVfBEJQILHXRYcNWebAFMPZCDSU,FGADMBCHZAAEDFAEUAGCGDFC..KFEDaGCE..dGHCBAHA.EADGhAAAQCCFLBDGXGAFhABARDFH.NCIG.hACAeEAG.AIEACHFESDDD.OHDEhAFA.....hAAA...,2,-35,-9,26
cLJTEFRMHZYNSPaXfBGKQedUDVAICOWgb,CDAAOADB....bCCAJEFF.FBHDHGACZEGF.SBGHhAAA.aGFDXGDDhAAABEFHGACHKAFDeBBBDBAFAFHDhABAIEDD...gEADhABALEHH.EGCFMEEB..hACA...,1,-19,-24,5
CLXfdFIOJNVgWbeMZUPSBRDGKQTEHacAY,CBFEXEDGFECB..OEADJDHB....VBDF..bABFMFAFhAAAUFEEBGGG.RFBDKBAAhABAEHBC..HEGBAHIHLBFHhACAIAHDNADF...eDDGSHDAhAIADBBHQADA.hBAAaDGAfBHA.,2,-14,-11,3
ADVORFEQJITdXLbNYfPCBcGZaUMSHeWgK,DEACOCAAEFEH...JAGHdGBBLFFC..NDBB...PAAChAAACAHBBBCAGFAFUCFGMABAhAAAeHEEKDAB.AIDCFDDHhADAIHGE..TCEC...hAFA.YEBGcGGFaAHFhAEAWCHH.,2,-54,-5,49
TCILPYXGOHBNcQaVAgEWMSfdeRUJKFbZD,ECAFMBFBdBEBUFFD..KGHDFBBBDBBC..CHCALEAF..hAAAXFCFOEDDBCDAhABAQFAGAIHA.gGEAhAAASBGBRCCEbAGF..TEBGhACAIEGCYADENBIC.hABAaCHD..,2,-31,-26,5
IECgYMPVZLBbOJXdRDTKNSWcHQFfGUeaA,CCFHMFBBZDAABGGB..JACEdCBHRFCC..KDFH..SFFChAAAHCCEFAGBUCACAEEH.EHEE.hABA.gAGGhACA.VFAGOCHDDIGG.TGGB..WBBEhADA...fHEHhAEA,2,-35,-32,3
KCWQAHaTLfdYSXMIFDOeEgVbGUZRcJBPN,HEEATBAAdAAD.XDGAFDDCDEGB..ODHHEEAB...VEAAhAAAbECDGBCD.UGGHhABA.ZAGBJAEFBDBGhADAKGDDCHBHAGAH.fGHCMIBE.IAHFhABA.....eFFDhACA..,1,-1,-19,18
dPBWOIagFNDRZQfYHVKcASJbCETXMUeLG,SECAJDFC.EABBMIAE.LEABdGACBDGFOFGBaAFDFHGAhAAADGCGRCAH.ZBDF.QAFFhAAAfEGFHBBDhABAKFEGAHBCCFHB...TADF.eHCAWFCE.hACAIHHE.YHCChACA,2,-24,-15,9
ZBYdgbIJMaEVDFCAKcTQXeSORWGNUfLPH,KCEETAGGQACG..eFBASEGGOAFHGBABhAAAUBAGLGACZDBEBGGBdEDFhAAAIHFCMIBGaAFCDEAFhABACHGCAAIHcGDB.WCHHfCHE.hACA......hADA...,1,-15,-20,5
cJfSMWGQFCOARdNPEgHeYIVLUBZKTXDab,RBGBdCFGEAAAHGBE.eAAC..VFFEBHEAKBDDXDCHDFCF.aBCChAAAJCEB..MGDAQDAChAAACEAFAGHC..PAHHhAEAIAEB........hADA.....LHAAhAGA,1,-24,-30,6
UcQNTDLRBedZCMgKHaJfbXSAGYEVFWIOP,ECBHVCFHFDHB..OBCGUAEB...QEDGDBACBGGAeFEHhAAACFGAKDAD.HDCC.aFCCJHBChAAA...XCCGhABASFABABGE.WHAGIHHG.NAIC..hABA......hACA...,2,-34,-25,9
LDaRBcfbNJKGWMPgVEFYITXOdQHCZeSUA,DCGDRBEBBCBD....bFDAKBGHGDAEMGBG...VBCEEFFEFGAHhAAA..IAGBhAAAOACGQGEHhABACHGASEHBAICAaEBENIBF..WACEPDHD...hABA.YAHB.hAGA...,1,-16,-30,14
CZcROQaPgLSXfdUbJTDNVeFEBWKIHMAGY,CDHFZEADREFH.OHCG..QEACaFDC.LABHSBAHhAAAXCEGUCGHTACBhABADAFDeHBGFAGABHGAKFFEMFIBhACAADDD...cCDGfAAG.hAEAdFEC.....hAFA...,2,-23,-21,2
QYPKgTECJfHWNZbceUBLGRdXIaDOMVAFS,FFDFSEEHQFFAKDHF...EDADJFCBHAFGZBAA.eABBBGGALDEAhAAAdAFD.aFCHDBBAhAAAOBDBABED.PFAHhACACDAD..fCFGNICD...cEADhABA....hACA...,1,7,-49,56
HEZGWCJDfXMdTNROeKYBLQUaSVAPFbIgc,FBHH..gADEHCCFGAAACGGF.fFAEdHCDRCECKCBFBFHEhAAAUEGD..SFDHhAAAAFFH.PBFBIECHhABAEADBJHEEMAIFOAEALFAF.aGBA.hACAcBBADIAG...hAIA...,1,-2,-22,20
SMTbYUCcEFdLNPgOHfXWJAIKZGaQVReBD,KFCDaFFH.QDEFRDCG.BFDBMCHH.TGAGUCACCHAC.FAGCdAEEhAAA.LCBF.hAAANBAH.OADH.fFGEhABAXAGC.AIDGIEHEZDFH..hACA...eHDEDIGA.hABASBFG.,2,-26,-10,16
BHUQETcSYGFdVJIeKARWNZgXLMaDPbfOC,RDBHZFFDLADGMEDCDCAG....PEFHOFHDCAHC.HFBF.EDBChAAASBADFABA.hAEAJCHFeBGDAHHH.gAEFhAHAaGCDBGHE.TFDAcCCA...dEAGhAAAKAHHWFDB...hBAA...,2,-21,-13,8
CFIdYZgMbJWHcOELaNGeUBRKVDSQXPAfT,TDABFFDFdADBZAAB..MIEG..JCHHHFBH.EACEaGAGNCCHUFDGhAAABFGC..KCDCSGGGhABA.PDDAhAEAAIBGIEBF..YBHH..hAFA..bEEB...hAGA..WAFH,1,-13,-48,35
JgRUDBIWLSaPTOKbdeXGZENFfMCAYQVcH,QEAAHCBDJAAARGCA.BBDALFGF..aBBHODFBKAGAeFCHhAAAZAEEFDAHCGEG..AACEVFFGhABAUGAGDEID.SAHHhADATDDEdCFHEEDHNIED......fGAGhAEA..hAFA...,2,-23,-7,16
NfBSDMKWRdVEYabXUCOFQLcZPGeIgTHAJ,JCGDBDDF.DAEAKEDDdFDF..EFFD..aEGGUACC..CCEBFHGELFADhAAA.ZAEBeBEEhAAA..IFHBhABATBBFABAESBHBRDAB.bEBDXGDHhABA.OHAA..hACA...,1,-27,-36,9
KGaWYTZVSCIAEcDBQRFfUNgOHPXeMdbLJ,DCAGBEEFQEEBRFCGFAAE.UFAEOFAHHBEA..eADEMDHHLDHFhAAAKAGA.aFFDWGDAhAAAZBCD...CBDFAFIDfBGAhAGA.NIBB.PDAA...hAHA......hAIA...,1,-24,-25,1
caULWBPgDCRZIeYOVQNSGdEMJFAKTfHbX,KFDETFGDHCAF...XFGCUFCFLDDGBCGEDBGACBDARDAFZAAAeAHFhAAAOHAG..NIEB.hABASDDAdFFG.hACAMGACFBBFAGAF.bAEFaHFE.WAFC.IEHFhABA....hACA...,2,-30,-5,25
SQfgLEGZPIJaAMXKRNUWYbdDTFHVCecBO,XFCEKEAGUDFD.......YCCCDDEFFADAHBAA.hAAACFCHBGFFQGGDhABALHBGEABFPDBHhADA.JCHBAAIFMIFANAGEWEEB.dHBHeAAE.SBGGhAGAfADH.hAHA...,1,-5,-38,33
DAPgacGOLHITFUYbJCSVXERQBKNeWfZdM,aCEFGDFGHGDGFBBCUFAG..JDDDCAGD...VGAEXDFD.hAAAQABHKDAFeAGB.hABAfDDAMBFHAIHC.hACAPDAGOEHDIHHD....hAAA......hABA...,2,-23,-23,0
cSHfdXgBWIVJEeNRKUGZPYLQMaDAbTOFC,TFGEFGEBCDBB..HEFCdBGDBEAE..VFAAJDBA..EFCEeAEChAAARGAAGABDZDDELADDhABAMIDA.AHHC..OBEEhACASBAG.XFEF..IBBAhAIAKAGC...hAAA...,2,-21,-15,6
FDURMTdKHVIXNOGBLZcPfgbJCEYWAQeSa,SAGBFEAHRAAD.MGDGdHCFKGFD.HDGBXBDEGBEALABAhAAAZDCF..fADFhAAAJCHDEGBEAFIDQCAAhACADECF.TDDEIHAABFAFcGGDhACA..bGEE..hADA...,2,-18,-16,2
IEdDCeQBbSJcFTgAOKMZGHRWUVPNaXYLf,KDECGEBGRECF.UBAG..VBBFaGEGLDFE..IHEDhAAADAIDCEDDBACE.SFHHhAAAJACCTFGGAAFHOBEEhABAMBADHAGB.PFADNEAC..YHFAhAEAdEGF...hABA...,2,-22,-18,4
BOMNZCPIfRWeJYSdFaDHKTVbLQGEUcgAX,OACGMBEHZFAE..CCCE...IFEARGCEJCGF.dCFADAHHKDBF..hAAA.TABELECGhAAAEGFC.UBAGABHGBDHF.hABA.fGAGeHCGFAEA.aGGH....hAGA......hAIA...,2,-39,-19,20
gEROKBVPMdTUSICaFXfcDNLYbGZQWHeJA,EEFFODCBKCGA.BABA..VDBGdAGFSHCG.CDGA.aHBGhAAA.XFCADGFBLFEEhAAAGAEGQADHhABAWCAC.JFAFAAHFPABG.MHFC.hADA.UGGD.FDDANICB.hAGA...,2,-26,-16,10
JgBROLCVWfYUGDXTZcAIPFSeNaQEHbdMK,FEFBSFCCeHBE.QACEHBCCdAABJHECBGEFLAFHCBGG.hAAA.fDHChABAUDAGDIAGZDGDABFFIGAAhACA.aCCHMDDHRGFAWAFE......hBAA.....YDDChBBA,2,-23,-16,7
XaEYOUNfPeWIBbcFQHgZdVTRCDKGASLMJ,LDEFMBFA.XFAEEBBGOFGB.UCGD..fACEhAAAeDBCBEHGFAFCQFCChAAAgDGF.dDAEhABATFAGCHADDFIBAHGDaADFPHCEWHCA..IHHBhABA....hACAcBBC.,2,-16,-12,4
QFSbNTZgWCaEUdcPAGfRBJODKXYLIVMHe,GEBAREFGOGCEKGGELBHDMCDH..QBFBFEAD.SHEChAAAbACCZAAH.CBAAaFAHhABAEDEAdGGD.AFCDBDCAhADADEEDIDAH....eHAGNBICWHFAhACA......hADA...,2,-28,-11,17
FHdRYTVOfWNBQaSXPAbcIDUJZCGEgMeLK,..IHHFUBCGZEGFGADBEGAE..MAAAeCFALFCEFGAFHECHhAAAdAHERFFA..TCAGhABAfDEFBEEESACChAGAXGCD.AIFADDIFCEACKBBF.....hAHA......hAIA...,1,-6,-22,16
UeOHZYDTfgJIdCRLVFEBPMWXAcKSabQGN,KGEESAFFQCGBUDEFHEAGZDAADCIBTDDB...JACECBDELFFAhAAAEAHH.MHAChABAAAGBaHGG.GAAChAAAOABDYHACIBGAdCDBFHEABEHH..hACA......hAHA...,1,2,-25,27
BHDIgANUVaKCfWFGXPREZTOJYdeMbLcSQ,UADGKFEFCHCH.FFGEGAAF..XAGERDAGZAFH..OFFAdFBAMFFFhAAALDFA.SFBGhAAAHCAGDEEGADFCaGGChABAfABC.EEDB.....hADA......hAEA...,2,-26,-25,1
aRSWCPDIZHGBMKTedgXVAQfUNOJFELYcb,QGAGUABEOBFHFGGCLBHB..bCEASAEChAAA.CGEC.DDADHFFBBDCGhAAAMEDFTFCEdGBEgDBFhAHAXACBfEED.JBEE.hAIAEBAD...aAHF.hBAA...,1,-17,-18,1
aZQNHfLTPXdKEVMbBYDWcIgACSUOGFeRJ,UFACODFDeHEARCBAZBGFHCCE.LDGF..XAAHhAAAEDAGMAEGBBFDDGCCIACAhAAAAEEDCHGCGEAA.FADFaBAChABA..fFHGdFEEKDHB...YFDFhACAgAGA..hBBA..SAHB,1,-8,-17,9
eOAYMSZXcPQNBaWLHKfTCUVbFRDgGIdJE,SACAXDCH.QFGBBAECLEEBKCFH.CBAAUAGDFCCCDFBDhAAA.GECEdEGEEDADOAFGhABAAFIFZABB...cCAHhACA..PHAGaHEGfEEEhADA......hBAA...,1,-21,-27,6
FJZVMCEWHLcebAfGIKaNDQSOTBYXPgURd,GDADKFFHDDAB.SBHDBEFF...PGDGUBEGdGCFZACHMEFAhAAAEBHF.HGAELHFGhAAAeAFFfHGDhABA.aFFANABATDCB.....hAEAgACDFBBB.hAFACGAF..WHAA,1,4,-38,42
TPJVIfaLgXUGdDFSEYHKAZNeBcObMQCRW,eBCEBCHAODDEQGDGRGFG...TDEGVAFE...aDCBLDBBhAAAXBBGdBCFSAFAhAAAHFCFABBHNEAE.MEAFhABA.PFGB.IDHB.gGAHhACADABA..hADAYEFG.,1,4,-21,25
WMCdfOPbBKLNXJFegHQYVZSTGDIUaREcA,CEDGdFAC.OEHHBFEHLGAG..JAAGFDDAHCEGQBADhAAAVFBAZFFHGGEB.hAAAUCGGaDBGRADAABFA.MAIDhAEAfEBG.KABEeHCASAEDhAFA...DIAC..hAGA...,2,-25,-6,19
MOYCBUEGAgaHLXFTRbScJVZfQIdKPDeNW,HEBCLADCTCDHSEDH.JHFAZFED.QAFHhAAAKBAGDHBG.eABDMBIDYDHHhACABBEDECFHABDHaHACXFGAhAAAFDAC..cGGAIDCC.NIAHCFBHgFAGhADA..hAEA...,1,-5,-26,21
FWZTEMIXYfbVNGKPLJOSDgURdBeQHcAaC,FECCTDAEMBBH....IDFEXBFB....bABENEEBGFDBhAAAKGBELEHDhAAASHCEDDCAUAGCdGAGeCCEhABAcGFHAAEDWHFAEHDE..YFAFhABA......hACAfBHA.,2,-16,-4,12
LTUCbBKGVgRADWPQHcMaeSFEZdYNXOJfI,DAGAQAADMDFA.aFCCFEGF.ZFEFdGFH...XDFFOBBGJDCHhAAAIHAC.TCAChAAAUGCHCDABKDDA.GAEBhACA....gAEBAFIB.hADA.WHFAcGGHEDHFfHCDhAEA,2,-50,-1,49
JLFVQbPfKHNBZTGRXeMIACODaESYcdUWg,OBCFEEEF..SGBBdHGBUFAD.JAAHFFEG..QBFDhABA..bFCDPDCDhACAKAAABDAHTGEDGCEDhAAAXADGIBHGCEABDEID.cAGAgADBhACAfHGH.hAFA...,2,-28,-11,17
NGdfgHIPQTObZYFARacKDVBESJMCUWXLe,aBGGKGDDDFIFBAFF..EBDHMECB..UAAFLCADGDACdFFEHDEAhABAQABEOHFCZAGHhADAAIFEVCDBCFGG...hAEAXDGBfEDGIHAA.bFCH.hAFA....YEHBhAAA.,2,-28,-12,16
TFEeBbWCZAJONIdaXVPMLDfcRYHKgQSUG,JAEGOFCB.dFGBaCED....VCCCLDAHDEBD.RCGDKGCGQAGChAAAUGGF.FBBGBABEhAAACHDBZFEFAGFF...IHHEhABAMCDF..fBBE..hADA..YFAFhACA.SAEG.,2,-36,-18,18
OUfTGDIHCYSEMgbRVWAceXJPFNdZKBQLa,XBADJAEG.FGEBdCCF.ZGEGKHGCBDAELCEHUDGA.GCCChAAAHFCH.SFAGhABA.EDHBMAAG.gDDGhAEAbACC..WHAEACHG....hADA.eAEE...hAIA...,1,-2,-40,38
cGfFBPUCWbgaQSJXAYZILDVMRKeTEdNHO,ZDACDFDBMAGFKFFH..EDDEHEAHGABFFBCCBGGAUAGD...CFEG..hAAA.bFAGaAAG.SEEEhADAAFHGLHCEeBBDhAEAdCFH.OAHFfCADPHDE...WAEHhAHA.....hABA...,2,-18,-18,0
OfgbLTQXRSdKaIEWPeHBNGCYZFcUJAMVD,MHFCVAFA.DGAB..OBCE..fFCFLFABXEFGhAAARBAHdBHCKABC..aCEGIGGChABA.EFDDPFFGhAAAeCBBBDHGCDEHFAEC.JABEAGEG....gDBHhAGA..hAHA...,2,-31,-16,15
eBYDWCSTLGdFVJcERgfKMNaAPOHbIXUQZ,OFCBHFAFXGFHZFFFBBCADACB..CBGFLDEFdCGBFEDF..JDAEhAAAECABRDGBKAGE..NEIG.hAAAABBH....IADAhABAeBHFSAEB.....hAFA......hBAA...,2,-33,-26,7
gPRQVMIJLSeGZDdOUNXKBHcYfWEATabFC,TFBFFBBGCFEE..RBDH.QADA.MIFCIHCFLEEChAAAeBFGDCAC.OAGBhABAUEGFKFAABGGCHDACYAHBhACAEHGAAHEG.aDCF.PDABSAAC.hADAdDFF..cFDDhAHA..WAFE,1,-14,-19,5
PCEQUYNWgMVXKAdaefGTDbFSJHZILBOcR,dEFEeAECGAGCDHGGFHCCSEAB.HBAEZCBC.BGHBODFDhAAARGDEEDDBQEAAhABA.NAIA.MABC.KFCFhAAAACCAfFDE.JABGLAFDhAIACFHF......hBAA...,1,-11,-21,10
UcfTdeOAbCLEXgGPKMNQSRWYDZJaBIHVF,CBEBLEHH.XEEFGCAHMGEE.QGAESEBChAAARDEADHFEJACBBFDBHAAEFEAChAAAUAFBTGCCOGAEhABAAIHA.bADHEAGHKGFHNAIC...WCAF...hACA......hADA...,1,-6,-14,8
YacQZDfBeMEVdTbORHFJPWANGCIXgLSUK,CDHCXCCDLCGFUGFAKFAC....aBCAZBGH.DFEBBHGEeFBHEDCAhAAAdABH.OFHDFHAE.hABAJCADAAHFGFDB.hAAASADE.QCACfDFAhACAMEIDbFCH....hACA...,2,-27,-17,10
WZaHYKdJPREcIgNQbeDCSXLBMUVOFATfG,GGDDZGAAaDBB.HADAdAAE.RDDCEFFE..IHGAQCAE.DDCAhAAACEGCLAFEBHBFMFABhABAUECFOCFGADGG..hACA..fADE...KFFF.hADA..cBGFNDIE.hAFASDDE.,1,2,-27,29
YWZaTdJVgXfcFHMLIAKeODGCEBNPSRUQb,OAFBGCBEEACEBHFD..SGHBQEAD..bAEHZFEEaEAHhAAAJDCC...XACFhAAAfEFCFBHF.MAHDhABAACBAeHACDIDCCGGDNEIE.RGBC.....WBAFhABA......hAGA...,2,-28,-2,26
fTeSXJVUFEdMBIPLNbcRKADCHYOgaWZGQ,HEFHOCABaFAEZEEEQCBH.eAFCXCCHUADCEABFBBHAhAAALFDH.NCIA.hAAAbFADRCEA.AHGCCCBB...hABAgBEEfHBHSGGE.hBAAJHDC.dABHIHHGhBDA..,1,18,-33,51
EIXYHaPGbeQBUMTOLFJVfWcdADZKgCNSR,KCAGCFGAREBB.EFHB....XGFCaBGFGEAE.QACEhAAABDCEUACCOCEDFBGDJAEEfGDFhABA.WAFEhACAAFEGDBAD.ZBADSDGA...hAAA......hABA...,1,-10,-41,31
AYGWUebXROQLTPgaKcFBdDVJHfSZECINM,GEBGeBEERAAHLFGB..PDEHKCDCFFDEBBBCDHDGHDBFhAAASAEA.CBHBMCAHhAAAAEIF.UFGCODABhACAgGDAaHBCdDDDfCHCIHABWCCBhABA......hACA...,2,-33,-9,24
aUNGRWegXAHZEOBLMKCQdYTfcSVDJFIbP,EHDABFCDLEABCEGB.dFEDTGFH..fHFFSFDBhAAADDDDJEABFAFC.ICGGhAAAaACEUCDGGABGhABAeHBGAFFHOFCH.MBIDKBAD.cADH.hABA......hACA...,1,-4,-36,32
ZEWeCMNHASVfgOGDRXTBQFJbUPILadKYc,VBEAOCFA.GDFGRCAFBHHBFBCE..UEDGLDDD.dGBGKHBAhAAAZBAFEFFECEEF..MADChAAAAFAB..SBAFhABADIFG...........hABA......hACA...,2,-41,-27,14
bKRYMdQPNGcZWUCDgIXJaeTABVOFEHLfS,BBBDVAED.OEBEHDCALBHD.SGGARFEHMBGHQBDHhAAAGAAGZGAECHCADEAGhABAIGEE.XEAGhAAAeCHHAAHHFHGA.fGAA.KACChAFA..PFFG.hAGANIDD...,2,-30,6,36
YBWQHCPgNUbZTVOLKIAdRSEFJDMcfXeaG,RDFAFGAEDBAAMCFC....XDDBeEHDaBEHGAEDBBBEQDAHhAAACHAG..gFADhAAAbEEH.VGDAhABAOACG..KDBHIAGESBDGhACAEDCG.cGGFWDGF..hADANIAB...,2,-29,-14,15
QcfPTMbZgILEaHBSVOeGRdCDWJUKFANYX,.XCGCQECE...fBDGTFECZEAALAFBhAAAEAAGaCCCBADHOCHBeGAEhACAGBACCEHCDECAJHBAKGHBAEADcGFAhABAMIBC.IAHDSBDAdACF.FAHDhADA......hAFA...,1,1,-11,12
fHGKICedUQgOYFLWJRETVDabZMBNASPcX,SBHHXAFFHECDGEBCKDBC..CHEG.eDAHdBAB.UCDG.OHEEhAAAFFEELCHBhAAAREFCTABGaEAH.MIAEAHHEfAEHhABAIADHYBFFEGDHDAHFBDFB.hABA......hACA...,1,1,-19,20
KYGLTPgcZWNdMIRJXDHbCOFAVUEBQfSae,EGBABDEF.QGGEaEGFKFEC.LHAG.TBCHgADChAAAZCGHdDADIDAAhABARFACDAADCFEE.ACFGUBGE.fECHhACAeAFE...YFHBcGEC.hABAMIAG.XCCChADAODFFSBBF.,2,-10,1,11
NLHAYfTWBFDdIbORVPEXUSgZGKeaJMCQc,TFAFBGDHdBBB.ODEFRFFH..VCAEEAHH.UAFDZCAC..KAEEeCHFhAAA.aDEBCDGEQGGFhAAALABCAIEAfGCFhAGADIEC.IHHFXGBHSCFHhAIA..gEBEhABA,1,-18,-33,15
KbXUSCOFdaWPGTELVRBHNgDAQfIMeYZcJ,QFBCMCDGZDEEKDBBUEFH..CEHH.OBBDdAHA...aAGEGGAHhAAAEACGLEDBhAAABBBFHFFHDAFGAGGDIAEAhABA.eDAD....YBADhABA......hAEA...,2,-30,-20,10
APVYDKFHaNgTbIcQGUWSCOMRedBXZLEfJ,VEGDDGBGFACF.HBDB..aBDD..NCIG.TABG..IEFAhAAAQGAC.GAFChAAAUAFDCHEAOEEBhABAeBAHBFGHLHDAEGDCAHIDKDCD....cGAHhABASDAFMCCF.hAEA...,1,-5,-30,25
REaZHfAJQCDWSNMgOGVBPIdceKTUFXbLY,JBCACADADICC....SGCCMDAEGBGCBBBGdFADKFHH.UDFBhAAAFFFCLEDB.hABAEAADaEACHAEBAAHHQGFChACA.NAIC...OFHD.IHAAhABAcGAHeDAGhADA...,2,-40,-17,23
BgcXYUKWOIGaAbMREeJQHdFCfLDNVZPTS,MGCAEDBD..QAFHHBDDdAHACFHHDDHFZGAATGCFBCCD...XBAAhAAAKGGDOABBIADFhABAAEAGRDFA.FFFCLAFBhAAANEIA.SEAAYFAD....hACAWDDC.aEEB..hACA...,1,-13,-23,10
OBdTeHbGVSQXDINUKAfCcRgJYaZPWELFM,CACCRFBF..JEGHaAAH.ZFCE..EGDCFEAEBBBD..dDFHHAEFGAEBhABASDAGDEIH..hAAAIEDANIDD.AHAA.hAEAfDCB.YAGHWFHDMDBAhAFA..TACFeHCC.hAHA...,2,-30,-23,7
MTCKPbUEWJcGLRZBIfNYgeXFVAHQODSda,OAFFdAACaDDA...CBCBKECAUDGE..EEGHJADE.GCBELADHhAAABBHB..ICHHhABA..YHAEhACAXCABAGGGDIGCMIBATGEEWEEBZFAC.fGHChACA..hAFAeDAD.,1,-19,-32,13
IUgReSDcFaNALKfOHZVXEBMYdWJPQTGCb,KAFGHADCZEDEVEEGBDHDdCAH....JDAGTBGBGGCH..IDDBhAAAUACG.eHEEhABADABHFFAEAGAH..ODHFhACAMFIB.YEAA.PHAECDEC..hADA......hAEA...,2,-42,-8,34
YMeJLDaPXbUZScfFHNETdIAQWOgKCGVRB,OAEFKCCAGEGGBBABeABCDHDE...aBHB..XEEAZGAASGEHhAAAFGBBHDAEEBEEIAHEhAAAAEGH.QACEhABACDBGVECCMAFCJHFE..bDGB...fDDDhACANBAC..hAGA...,2,-25,-6,19
cNTZIRWdVXDCKGfSPQYAeOUEHJaMLBgFb,ODFAUGEAEEABHACE.JFHBaDFC..BGBHFGHD....bACBTEAEhAAA.ZDDAIHBEhAAAdAGH.DGDFCBAHfHCFhABASCGEPCBDAHFEMCEE...cBAGhABA....hAFA.WEEG.,1,-18,-23,5
dgRYHTVXUeSNaQfECWPcMOABbILFJDKGZ,BACCLACEDECEKCHDdGBHRECG.HBEG..VGBEUFGG.eBAB.hAAAaDCGEADA.CGHF...hABAPHDCOCCAAGAF.FFEGhAGA...ZBFD.......YHFAhAHA...hAAASFBCNEEB,2,-34,-19,15
LZfWXdJgTROAKUNBFScMIDYEeCbHGaPQV,KAAEBBHBFCHHSDFE..IDBAEGCACFFG.HEDAGCBGhAAAaHFE.QAEGhABALADBfGCChAFAdFHETACEAIAGUAGDMCAFDFBBeDDG.....hAHA......hBAA...,2,-27,-6,21
eSQBJUFMYLRVCgZDHNEdWIPfbAcTaOXKG,aCCCKCGFGCCC.eADAQDFGBBACUFFDFHAGMEEF.LABAhAAAVEAH.CHGFDFAEhACAEHCGdAHE..IAGAhADAfCACAFIFOFCF.XAEHhAIA..SEHBhAAA..,2,-28,-18,10
bcNTSMGEeQOXdUHgLBZYKVJCIfDWFAPaR,RFGD..bGBCTBGA.GEDAeADHXBFEdCCDHAAEBFBCZEGHKCABhAAACAEHDEACFFFDAFBA.aCCHSHAChAAA.EDFGhACA....OAFG.gEDHhABA.....hADA...,2,-17,-12,5
OcAZLJBMNVXaWeKTRHbQFSYdPUfDgIEGC,LCEGMCAE.XEFHeCFFKGHD.HGAAFAAHdFCEUDAFDAIDEGFDCHFE.hABAADDF.ZCAGBABC.aEGAhAAARFAFSAFBhACA..fBDBIEHBOEEBNEEA.hADA.TAGA..hAEA...,1,-15,-21,6
OfYLbFdWVQCgPXZaENSeUIJDAcGRHKBTM,GECEKBEBBBHHOBGBLEGFFABG..dBECQABDCHHG..hAAAPFAFZDAGEEDHSGFDhAAAIHDEAAHDHEFChAEA.MCCDfGAEYAFC..WFHBhABA......hADA...,1,-9,-39,30
RYgTJIMZQNCDGEefUBXKHLSOaPVAdbWcF,dGCA..bADDFBAHRFBE...TCCBJABDZBFBCEAB..GCFCEHDCUGGChAAAKAFALAHH.hABAOFAHPCHHAIFE..hADA.WAFC..cFGEgDCGMEEBDBBChAAABFFC....hBAA...,1,-17,-18,1
fBRUAcIMDPVFSGEYZbdTCQKXONegLaJWH,MCDHVCBD.GBEBZAFC.dFEGQEGEKCAA.OGDC.eEADhAAAaGFAJFADHABGfABFhAAABFDCAIAEDBAHSHEAhABAECGG.TDGGCHHH..XEEFhABALAEC.WFBH.hACA...,2,-14,-7,7
NWKcUMOCZbeSVYAdPGQaFLDHTXgfIJBER,dCGFQEFCLFHDHDAE..TCDDXABF..IEBChAAABHCAEGAFRABHKEFFMAFEhAAAZFAASCGChAEAAIEE.aFDGFHAEDEIHfAEEWHEE.OBAHhABACDDE.....hBAA...,1,-14,-20,6
gcTYOfVKbCdEAGHZDQIRNJLWFXBeaPMSU,ZCGFDDDGQEFERADDLAABFFBHBEBE.eEADMEFB..UABF.hACA.TGGHOHBEKDCHhADAdBFHAAGH.IHFBhAAA..NICF...XCGEaAHF.SEEDhACA...hAFA...,2,-28,-23,5
IGgFZVfTJDaKQdYWHEORBCPNLSbAeMcUX,eGDCUDCEGFEHFACBZDEE...TAEADGIBKAHFdABDHFADRGCE.BCFGhAAACHBGLCABABAB.XAGFhAAAIHFE..hABA...fDCCJCGF.aAEB..hAGA...WCHH.hACA..OBBH,2,-18,-17,1
TZSXEaDWNFdfMGbeBIQCPAOHcgYVURJKL,OAEFHDDH..gGADUDAGKABHZFFGEBCD..DGFEFEDA.dGCFfDAEhAAAGBGCBGAChAAAQDGB.ABAEcGCFhABA.RAFA........hABA......hADA...,2,-37,-4,33
HJAYLPcfKVOUWZFIdXgTQCBGSNaeERDbM,LFED..cEBFKCGFVFAH.UABBFCCCdDAG.TDEAhAAABHGBGCAF.hABASAEAaAGAeGDCRBGHhACADFDFMEIBACID.fHFDWFHB.IGBFhADA.XACEhAFACGFC..,2,-35,-7,28
fVNMeSgcCHXdELZbKQWRIFGYJTUAOPBaD,OGBGBBAHDDBG..VBCEMAED..eDAHSGCH.CBGB.hAAAdHBDZDFFKHGC.WEEHhAAAFGAB..JHEAAABDaDFF.hABA....NAIA...gDAGhACA..cAEFEEEB.hADA...,1,-30,-43,13
WSfDGZOEXgbJKNMaRIUTcBeFLVAYdQCPH,dCEFQFFACFEDHDGB.SEDDGCCCOFBDEDDE....gBAHhAAAKABDMAEERGEATAGGhABAeDADFAHDLCFGhACAAHID.PFABDBDC.bGCG...NIEBaEAAhADA......hAEA...,2,-10,-3,7
MBUafKcJgWRFADLVQHedPCYZEITNGOSbX,LCEHVABG.QGBAHFDHdCFECAHAZCBD.EADG..IDDBhAAANAAE.OEAHSGGAhABAXGGHBHEDaFFDhABAcAGFJCHF.WFAD.AFGF.PHAC.hACA.YDHD.hAEA...,1,-12,-17,5
fSRFKQGWAeHdgaXPUNJTZDVYLBMObECIc,HBBHaBEB.UCFF.JGAGDDGE..LAEEOEEFEHGECEDH...hAAAICAASDHHhABAFFAEKEGCQFFChACAAAHHdABH..XFCDNIAD......hAAA......hACA...,1,-20,-40,20
GWZMXYLBDENSFOKVgebAcHCaIfTUPQRJd,CBECaCEF....IEHDTEFH..QFAAREADdACCGFDFMEEHhAAALDDABCGGEADCFHBEhAAAKGHHeCECABBDHCCDfAGBhABAJAFG..WHCA.XABBhBAADBBFSGHH..hAEA...,2,-23,-3,20
REgPfTUZMAJSXWaVYcIHNdeOBFbQLDGKC,SCAHXFCF..aCGDVECA..IBBEHACGeCGHODAGhAAAFGGHQGBHhAAADIDCCGFGRCEF.EAGF.fCCDhABAUGGEACEBJAEEYFADNBIGBHBB....hACA......hADA...,1,-9,-18,9
QSNOAWTdELGFBCIXMecJZVDKagHfYRUPb,dHDBEDDBFDFFCEGD..MCAFeEAD.ZBECDIAC..KDBFHCEERABD.UECDhAAAQGGBOBCGAHHGLHAAhAAABAHD.IEHGhABAXFAH.........hADAcBBH.aGGB.hAEA...,2,-31,-20,11
VQaBOXUJGWFRbAKEISNeTdLYCfZcMgPHD,EAACSBDH.eFEDLCBC.CGEHZCFAMEAFHEFCQFGEhAAAaFBCBAGFXGBDhABAJHBAGDADFBFDAFBE.IACFhAEAdADBfGGGPBBHDBHB.OEEAhAFA.....hAAA...,2,-14,-3,11
JCPgKUTBfHEdYMbNLZOaAWRGFIDVQXSce,GDBFFECBDABE.QGBB.SEGHeGDACHAGKBBABACEHCDChAAAEBAEdAFFMIEC.LAEBhAAAZEGDADBB.IGEDhABAXEECPAGD....gBGGhAEA...hAGA...,1,-14,-30,16
KEaALCYVOBXDbHeZUWgfTcNMFQSGRdIPJ,CGCDVCFBBCCE..DABBHAGHZAEA.UGFF....fHAFhAAATCEAMACCSFFAhACARAAHdGAC.JDCBKEGGACIDODADhADAeEBG...WCCC...NEEC..hAAAFGHD.....hAGA...,2,-24,-17,7
dHKbfNLGZTOVRBSIcMDPUXYJaCFegWQAE,dADDHCBDKEDH..fBACLBAFZDEFOAFCBCCG..IHHGhAAADICAUAGE..YHCChABAaDHF.FEEGeDGDhAAA..QEGDEGBH.NEAA...hACA......hADA...,2,-33,-20,13
NQRFVSMgHdCYfLcWDJUaBOZXGeTPIAbEK,KBDDQBCGFEHB.MADAdDADCGADLHBE.DFFCaDFGBFEDZFBDGGEBhAAATBFGAIFA.EHGEhAAARAFC....SBAAhABAYCADWDFAODEH..eEBA.hACAIAHC..hABA...,2,-25,-24,1
TWeYaSBHfPFGVDJOcbZEICRNgUMALdQKX,QDAHTEAA.eAAHaABDBFGHHEDAFCCGGEDGDFHB..JHCCODBGhAAAZBFD.CCHBNADBgGAFhAAA.MCIHhACAAFFCKCGF...XGBDSGHHfGHAhABA....hAIA...,1,-3,-30,27
XLSPAQCIKcFZWdTebMEOYVHBDJGNaRfgU,CAHBKBEFZDCGdEHG..eBHDMDGB..OBBGHFBHJAAGGEFG.aGAGhAAARDCEUAGD.LFAFhAAAACAHIHEEFHDE..hABA...WCDEEBCFBAEEfAEB.hAHASDAH.hCAA...,2,-22,-17,5
gEYLcSfDeIANZRCJHXbTQBKWGMdaOPUVF,ZGECJEBDHCDC..bCAFBABGGADDMHCCdEEF..aADCOHAEhAAAUEGA.FCFE.EDCBLAHHhAAASABCDCABAFAHCAHBXFGAhAEAKEEF...WGAC...hACA......hAEA...,1,-2,-31,29
gFNcXPGeaYQJVCDOHSAMbBEKfTdUIWRLZ,MDFFEAGAKGAEdADH.UDGCRCEBLCAH.FFGEXAAF.eGAGhAEAaGDFQADBhAAA.CDCFDBIDSCCGhAGAAHCDBGFD.fFCDIHHE.WHCA.hABANCEDcGGD..hAHA...,2,-38,-22,16
WIXPLVRZCdNbQJMYaKfOFUHESTgecGABD,DDBBXBCFLGFAZDFF.dADF..QEADJECH.aEDEKBBHOCHDhAAAUAGEHDDEECACSHCGhABA.eHFChACAAABABEGAIBGG......hADA......hAEA...,2,-43,-12,31
PKJGUfbBVLXZCNSFcgIWOAdYeTMEaDRQH,dECBTEAFEDAC..DDHHHABD.JAGBUACHBAEGLGDEZDDF.CFAF.hAAAFHFG...gDFAhAAAIBAAAHHHMFDBhABAaDFF....PHAEfGAG..hADAXBGESEHHhAFA..OFHF,2,-26,-25,1
eQPIXAYVGdKFaOWUMDZcTSfLCHbgRNBJE,VFFCGBBA.KGGFFAGFODEC..UAAAMADADCGDZFCE..SCEBhADACBGD.HEAAhAEA.REDFBDHAEAAFeHBAhAAA.IFHAABIHaBDH.WBHB.fBEAhACA...hAFA...,2,-29,-21,8
JNVYeUHdAWCLMIQSEKcZFfBPbDGXRagOT,CBGDMBAH..SGDDKDHHZDCABGECDBABREDC..OBFF..hAAATFGDVEAHeAHFhABAUFAEdBCCLHFGEHEGFAEDhAAA..fBCDbBAH..aDEA.NBIAAAGAhABAIGGE..hACA...,1,-7,-30,23
RLDfBaOePHdbMIGZYWKgcVXJACEQSFTUN,CCEFEEGCFABCUEBA.LCBCDFFCBGDH..aGDD..OCHDHAFGMBBChAAAZEBG.KGHD..hABAVAFCAEECSGADhACA..NIADeDAAPFFB..dGGA..hAAA......hADA...,2,-40,-10,30
eMJXNVGKEQLTbSAfCcHWUgYZDPRaBdFIO,CAGGHFBCUEFDZCEF.RABDBEHCFCBD...ODABeECF..MBAEXGGAhAAAGGEF.EAEFLHCAhABA.SDDBhADAAGDBfEAGcBFF..WAHBDBID.hAEA......hAFAaDDF..,2,-29,-21,8
YNZcOHWLTABXFCDgGESPMfKQVdbIRUaJe,XECDFHAACCFD.DHBCGCAE..ECEASFGAMBAF.QAGGhAAAVGFAdCBDIEHBhAAAaGFH.eAHBhABAZEDEcCCA.OABGLFAFBHHGfEFAhACARADC..hADA...,2,-23,-9,14
IDeRTYFANWPMcUKfXQHSZOGCdJBaVgLEb,...NEIE.MBED.UAGBKBEFQBGAZFGBCCAEBFAA...VAABhAAAEAAG.DEHHRFCB..FHAGAGFD.hACA...PEABhADAfCCEXEECOCFEJDCHaHAE..gFEEhACA..hADA...,2,-36,-17,19
XQRAEdOgNBfFPGYVUJMDTHScLCKZIWeba,EHAGdCACOHECBABFFAGGGEDB..UFEFMDCCDBCHHGAALECHhAAACGGEKCGGZAFA.eAAGhACAXBGEAGCG..NCCH.hADAfBDG.PDAB.YHFGhADA....hAEA...,2,-40,-7,33
fOdeNELRcJVIUWGFABYXTbaHZCQDSgPKM,BDGDXBBEaFBHHECBZFCF..DFIF..SACEKBGHOFABdAFDhAAAEEFCRCDDJBAD.UFFHhABAFCEHABIH...TDAFhAAACHDA.....PFGDMCCDNAIELACEhABA....hAGA...,1,-16,-25,9
OGgYCeKMZIdSDPJAWELaTfBNUXRFbHQVc,EDABaGFHBEHBUABH..FAGFHCCA.QAGHOFEAGCCBCEEBKFCBZAADhAAAdHEHDAADAHHA.LDHHhACATGAE..XEAChADARFBG...bACE.....cEGHhAEA....hAGA...,2,-20,-15,5
RaGbAcOdVDNKTYLeMfWUECZPFQJgHXIBS,dEBAVBDDDGGG.KEEFLHAA...MCHBfAGDUBABCFACZGFChAAAFCAC...JFBGXAEGhAAABDAH.SGDDhABAaGEH.ACHBNHED...eDDEEFFE..hACA......hADA...,2,-41,-22,19
AKWfUdaCRFXVceNLZEIPDOHBQJbTMSGgY,KGBHUBDBCGHG.FFGD....VCDAeCAHLBABEEEH..IHAFhAAADGEFBAHB.QDGDhAAAJHCC.MACChABAgCGA.AGIHfAGGaFFHXDBHhAGAcEAE.NABB..hBCA...,2,-36,-29,7
ZbVXgESOaYINRJDcCUdLFAKTeWMPBfGHQ,KGDETEAFeBDC..MAGFBCAHHDEBQAGCZACE..XGGGhAAAEDFAODAEaHDENBHGDFCFhAAAUECCLEEA.hABAAGIFfFAE..bCACSABChAEA.IGGDhAFA..,2,-15,-11,4
MJcCZedYFWUQDTHbfIRagSAEOLGNVKXBP,ECFFLHDGGEFAVEBCBDAG...JDCDCDAGdFHGFBHD.UBGC.DHAEhAAAHABG.IAFFhAAARBBC.SHBGhABAABBCNEEH.KCAEMABCeEHB.YEDB.hAFA......hAGA...,1,-6,-30,24
XTEPMaGLOJHBbWcVSNYKRCQegADZFIdUf,ZDECFFHFdGEAUBBF....XCCHTECCEBGHMCFC..aGABLABDhAAAHGFABAFHbAEC.hADA....WACChAAASEFB...KDGCCDHE.gFAFhAFAAICAfBEGOFDHhAGA...,1,-23,-24,1
UAPRdfGXJCVWObIaKMZgNDeFHEQLBTYSc,REDCdAADGADFCDED.OAAFaBDC..KHGEZGEG.DEAHHEABLAHHhAAATAFF..SCCBhACAAFFH.XCEEhADAWDHBMFDHNECC.eDAEEGAH.BEGG...hAEA......hAGA...,1,-10,-30,20
GNJSaQdDRAObVfKFeHCBTXMcEgUZLPYWI,VFBFFBAFeEDC.BCEDMFAF..EDCHZFDBLHAA..YFHFhAAAIHHDGADFhABAJBHD.SBBHhACAQAFGRDEEAEDFfADA.CFHG...hAAA...XFBChABA..,2,-24,-13,11
NbGWDRXZIfLJgYedAPcKESUHaVOMBFCTQ,KEGDUEDDHCBFOAGBMAACBDHH..FAGDCHDE.QFDBGBBADADFhAAAZABE.LFAFhAFA..JAEDYDHHhAGAAGHFEGFH.aHGA.NICH...READIBAGhABAgBDAdAHA...SEGGhACA,1,-11,-21,10
XYMPRKVJGHDbNOBaTedFLcAWZfIECgUQS,ZDECEEGCUCEGSBBG..MFACREBBJFDADAAB...OBCHhABAaBHHdAEDFAGELDADhAAAAGHA..IGDAhACACACB.XGGCPFHFKHAA.....hADA......hAEA...,1,-20,-39,19
LABQNKRCcbWFETHfgJPYUMZaIGDdOVeXS,BABBKDECRACG.CHBC.......bGCEEDABHAGHJGDE.UGGEZDDGGBBBhAAADDIFdCAA..OFAHhAAAXEBHAEGA.QAGFhADA.NICF.WCCB..FGHF..hAEA......hAFA...,2,-28,-24,4
TeFRWDPBICfMHSVXZLGOAdYbQNacJgKEU,dCDHQEBBaEGH.JADHEAGH..UBAFFCAADEBDBEEG..CBHAHECChAAAXDGHLHFAhABAAHBB...NBBDKDHDTGEChAAA.eAGFRGAA.IHHFMDAH.SCHBhABA...hACA...,1,-14,-26,12
JLUaZgWBOfRDASbKYQePcVIXEGNdTHCMF,SFCAKFBAeBEH...VDFHEHDEdCCAHBBACHBH.MAFALAHBhAAAaEBEZGBABCAH.OEGBhABADFIHAIBGQBEGhAAA.IHGGXACENDAE.....hABAFHGE.gAFBhACA..,1,-12,-19,7
MJHKegWafGNRVPQFDbLXZIBEYcSTACdUO,UGEEMIECHBAEKBGD.eEFC..aAEGNADH.RCAA...QBEChAAAFDFHDDEDLEHFIGBDhABABACDEECGSGGEhACA.ABIBCHCAOFBF..JGDCWECBhAAA......hABA...,2,-45,4,49
WegIGKOXfLAVZRTYBSbHPDaCcdFQNUMEJ,VDBFTFAB..BBDGHGFGDDGGaCCE.dDHGQAGGUAAE.MABChAAAEGCCeEBG.IAHGhADAKFDGOFHDfAFGhAEAAEHFRFFFSBBF.PFAHcEEFhAGA...NICF...hBAAJDDA..,2,-15,-7,8
QJNVPIgZLWTXaeSEdYBAUbfRFcOMHKDGC,UCGDRDEGOGCAHDBEGBEHQBBH.JACAVABB..IGHFhAAAZFADLAAD.hABAXGGCaHBGEFFHBAGFhAFAAEBAfAGDFFCEMIFGCFHF......hAIA......hBAA...,2,-14,-10,4
UJgRDGKXaPEWVCBSdObFQNTAeIcfZYLHM,eDBH..fDDBLBHFMHFAJHBEDFCCKBCA..aAFEPDDChAAAEGFH..CDBEBDGBhAAAdCAGFFFAQACGhABAAHAG.IEAGYGCEgFGB.hABA.....XAFFhACA,1,-18,-39,21
HGYaZOTQeFdEVPMJDCNLAXBgKIcWRfbSU,XFGABHDDKDDF.....IECAREFGSAHFUBAAHEEAhAAAGACHZBEC.QGBChABAeDAHFHEAEBAEMHEADGCChAAANAEHABHG...cCCAWBHH.....hABA.fGAChACAaDGE.TCEF.,1,2,-22,24
AWdaMQFTSYVPCcbROGUEfLIeBZDHXgNJK,dFGAMBCFFCFC..TDFFSEAA..PAGDCHEF.REAGOHFGhAAAEEDELAAE.hABABBHCDIDCXADHhACAJGAAACCA.WDDHaCBC.YGAAbDFA..fAEHhAEAeFFA..hAHA...,2,-36,-7,29
UNOXQKabAReEJdFcTGSBVPCLDIWgfMYHZ,EBCAJABB.dBGCFAHDGEAC.BHHFCHAALCEFDFCC....IEHDhAAA..gDBFhAAAMFFFZDDCNACHQEGChABAKABF.AADFeGBESGGC.hAEAWAHBfAFFhAFA.YHDG.,1,-21,-32,11
gSCcaIWAbfPRKMQUXYTGOeJFdZBEVNHLD,...PHFAKCADMEBEUDEA..TCGFOABFFBBEBFBB.EADDhAAAHEFD.DGAFCGACaHDChABAIFCE.ABGFfAAFhAAAQAFAXEGBeHBA...hADA...JFHBdBHENAFE.hAEASEAC.,1,-12,-16,4
QKWNAVCbMUTZYOPdFfRBaXSEeDgIGcHJL,VBGBCGECUEAE..ZGAA..OEFAdBCERBAHBEDA..XBCEhAAASGFFDAIF..IHGGhABAHAEHQEABhAAAKABAAHBD.MEIH....PDDHhADA.aCFC.EHCEeEGBhABAgAFE.,1,-7,-30,23
HDaMZPFBCLcfVeQAWbORSJTEdgKGUXYNI,OGCCRCFE..JHFGdAGAKADHUADC...XDEEIAFEDIFChAAAZCBBBBADLDAFhAAA...VEEAADDHWFFAhABASAHF.EABHYCBBHFCDaEHDhABA..MIACCDDH.eBHHhACA..,2,-30,-16,14
fTGNAOdEWKHRgJPabXFZcYQDMVeLSUIBC,EFACKGCGHEACRAAE.JBAGaDFB..FAGFZDGD.QFCDDBIF.eBDAhAAASEFDBDDGCHAF.hACATCDDAIEC.OEGFhAAA..dDAHgAEDbGFE..YAFChADAMEIF...hABA...,1,-6,-36,30
QEBZFOYCfgdLWHXbMRNVKJAGPSeacUTDI,GGEFSFBAaBEBUCAADCCH..EEAFZDEBOHCACADF..dDHALEGFhAAAHGAGMCDDNBICKBDDhABAAEEHeAFG.IAAGhACABABAFEEF.gAED.WHAGhADA......hAGA...,1,-7,-30,23
RcGZNABaHEJKDCFMXObdfgLeYWTQIPUVS,BAEDHACHKFCBFDDC.OFEHdBBFLDGH..eCHB.TBEDhAAAQGEDUGFCSEEEhABARFAAZBFEAIAA.EHBGhACADDIHMAFGfDAF..WEAF.hAAA.IHHG.hAEAPAFA.,2,-26,-5,21
VbOcFWGMJTBEgSZaNHdPLfAKYDCQXUReI,DABHCEHGUDCBREED..eFAC..VGFAOBDF.FDHHMBCG.BHAGhAAASDBGZBFDHFCBhABAdHCFLDAFAAHHKAFH.hAAA.....YACD.IHHDhAEAWBBG....hAFA...,2,-38,-27,11
ABbIEDXWYGFMPfHaeZJRdVLgNOCTcQKUS,BEAGEBHDDGGB..XFFEGEAFFBAD..MBAAHCCGeCDERGCA.hAAAdGCCLFFCODFECAGBhAAATAEGKCAG.AHIFIHAGhABA..WEBE..fDGBhACAaBGE....hADA...,2,-34,-13,21
UIRNDEcHOTBLPgFAGMKSJVbQYeWaXCZdf,KBEESABH..JBBHVDACQEECeEGD...aFDHCADHdGDEhAAAUFACRAGDDIGCHCGFBDHHhABALADF.gGGHhAAAADDAMEFDWAFDfAGD.NIAH.hABAOGAE...hACA...,2,-21,-19,2
BcZDPNSIJOeYMGfKLabXHRCFUVTAWdgQE,dCGCQDCGEFEHZACA.DCAF..SGAHJABB.OECFMFEFKCEEhAAAaCDC.HDGB.FFADhABATBAHAHCBBGGGPHFAhAAAIAFHeAFE.fDAG..hABA......hADA...,1,-19,-29,10
QFHEZaJPLTYeRKAXbBWfSVOUgMIcDCdGN,XBCHBBGGSEGHUEFA...MDDFIDADDCBBGADEhAAAFGDHHBFEEGHHZCFG.aHBAhABAJHFCLFADeAFEKFBChAAAABBG.fABHOFFHCACENCCG.....hABA......hAEA...,2,-22,-4,18
XfYDAQaNdGHPKFcgJVWBOSMLREZICeUbT,aBAEGGABHFCBFBCD..JCFFVDEEBDCD..MEIHLBHHZEAEeAEChAAATFAH..fCAChABAABACdHFFKEEFgADHhAAAOHFCSBGAEFGCCHAG....hACA......hADA...,1,-9,-15,6
LUNIYgTfcaMQKFRXWOeVJbGPDABSZCEdH,BDACZEFFdGCDLEEGUBAC...ICGGTBEA...fACEhAAAMFIDKAHBFEBERFBBXGGBhABA.eBEBhADAJFAF...PAFGAFFFEDGE.NBIE...cCCAhAAAQGECOACG.hAEA...,1,-19,-24,5
XaKUVDBLHbTZdgeMESOIJGFcYRQCWNPfA,XGADKFCHDDEEHEEHZECB.dGHC..MEFHECHH.SBAC.hAAAOCFAIAHFJAFCFGGFhAAARBBHCABC...WDBChABAfEAE.AAGFaADFBEHC...TADChACA....hADA...,1,-25,-28,3
QTPVOSHRcgdKLDXAJNCBGMIWFYUZefabE,JBBACAGBGGEB..MDEAFDEHUCGFZEED..aFABEACD..QCAHhAAA.TFBBhABAOFBE.RAEFcAAChABAgEGA.KHAGDEAHADDFBHHCIHCH.hACAeDAGPBEA..hADA...,2,-26,-20,6
KYdOIAeJQCSXcbTGNDVPWHLfZRUgMaBFE,JDEGQDAD.SGCCXDBE...TFGGDFGEVAAEhAAAHADELBFAfAHAhAAAUFABaGDEBGHAKEFEdABChADAAGGHCHEH.bCDC.NICDWFAH.....hADA......hAEA...,2,-39,15,54
RgZYJMWQfcUNaBIAGFTbXLCPedESDVKHO,GBAHFCFG..TDAAbDGF.LEDD.CAHH.dEBG.EEEGDEFGhAAAKGGDHBBERGCGZAFCJGFEMEABhAAAQFAB.hABA.fEDGNIDDBHAGAADC......hACAeADASCFChADA.OHACWEFA,1,0,-11,11
ANOcZKIfYDVGEFPSBeJWRMgHUQbdXTCLa,OEHHKFFA..IGDDDIAAGCCH.EDAHSACABBGDeFCAhAAAJFAF..MIEAUCDHhAAAQFAEdCHACHFAABFGZBAFhABAfAHG.YABE..hAFA...FGEEWFHBhACA...,1,-6,-43,37
eDbfIdBVAHFXcWGCaUYQKTgNOLEJSRPZM,FAADXAFBGGCDUEGCKBGB....TAECODAF.LHDAhAAAEDFHRDAH.ZDCCDDDBfBHAhABABHAAADIBHFGDCACGaFCAhADA.......YBCG.hAAA......hACA...,2,-26,-15,11
SAWHOTMNVQIeLBdXfbCGUJPZaEcgFKRYD,HCCAOCBHTBGD.MEFCVACD.QEFGeBBCdFCHXFGEhAAACAGAUFCC.ZFAFEGHDFHFEhABAKCGCDAEE.AACC.IGAGhAAAfBEF....bAED.PHEEhABAaFFB.....hAHA...,1,-3,-13,10
YPEJdQMKDabOCVcTfWeINSLAFGURHZgXB,UEFBZEEHBFDEEABD.dAADKDDEDIGA....OFABCADC...TEBGhAAAeAHHSHBAhABALBEGAIHCFCABRAFH.XGEEhACAJEHH.MBIBaHAG....bCCC.hADA.cGBEIFAEhAFA...,1,-16,-38,22
aRKBDQbfcOTFSdPMENCGIVZXgWALeHYUJ,LCDHHACGJFHHRDEDKAGG.BCHCDCGH...QEGD..hAAAfDHEOABCFHGAhABASFABMIDGNAFCGDAAhADAVBAFXAGE.AEDFeFCBaGDG.hAEA......hAGA...,2,-19,-19,0
QJTcCMaHfDKXVeYISPBFNRgbELOWZAUGd,dCHEQFBBJEDD.CFEEHBAHDDBD..KBCFeHEC.SAEGhAAAFCEERFFD.EEGFLFHHhAAAWCEC.AHAC....hABATADDMIAGfAGB..XFAAhABAIDCFNIBB..hACAOAFGZCFG,2,-33,-14,19
MZTEXRgOLHVdIDJYecKPbaFCGBUSQfWAN,MCGHEBEGRGDE.LAADHCDEdFAHDCHD..JCAGeBEFKFFC...aGBDFHAAhAAACAHBBEBA.QFGHhACAAABFNACB.TBBGhADAXDGA..gFDG.IGAGhAEA...hAHA...,1,-16,-28,12
bPJQgKNWAIFeOMZCVDXLBERYaHGUdSTcf,FEDFeFDGOCBEMECAZABF..DFAEBDHFEAGG.aAFHGGBF.dAAChACASGAC.hADA.TBEHfHCDhAAAJFFAKBBCAAIBIHHCCHHD.XDAHhADA.YFFCcCGB.hAEAPADD.,2,-20,-17,3
QJNfVXEICgOWKcDeZUSGbMTYALRaHPdFB,LGACRGCAHBCGdAAHBCBHQCFDJFHD...VDBFEBCGCAABOADAhABAKEFG..DDADZFGHUBFChACASAHH.hADAMEIHAEDHFHECfEEE.IHAChAHA.....hAEA.WDDB.,2,-42,10,52
fWgRHIFPTCGBcSKMUDLOeaNEVXQJAZdbY,dCCB..bDEF..fGCFRDAEFGBE.CCFGBFFDKBACDIFE.OEGHhAAAeAHFEACA.XGFEhAAAACDDZAFG...gFAChABAIADC.PCAB....hACA......hAFA...,1,-32,-36,4
QEVbFeCaZgAfHLJBPSWRcMNTKGdUOIDYX,HBBFLBADJBHDBHFASAFB.REFD.MEDEKCCBGBGEOHBCDBEFhAAAQFBH.hABAEFEBFAFFaBCAAFDAfDAGhACA.PFHHWHAGNIED..dGDD.hAAA......hABA...,2,-23,-16,7
IKaNUYGTJWbZfcgEXeOQLBPHRVMFDSACd,CCDGdHCDKFEGUCFG.GAAC..JHACZDDD....fDHAhAAAEFHHOBHDBAEBHFAHhAAAMDABDAFCAFGF.aADHNCCA.hABA....WHFAgBFC.eFHFhACA...PHDGhADA..,2,-36,-24,12
SEIHOfcTGXJdRYgeLDWNAaMPCKUQBbFZV,MADECAAAUCECBBHD.ZEEEEHCCHBDF.ODBD..fAGGhAAA.GCBChACAdHGBYCADgFGGhADADGGAAAIHKEAFFGDHIHAEXAAEJCHDeDFC.hAEA.WACAaHAG...hAAA...,2,-18,-14,4
AgYJaeGIBRSbdXcHFQUNKfPMWEZLOVDTC,JACGaCEFGCABBAHB.RFFB.dEEEHGAA.FAFGQGBHKEGE.MDDBhAAAEACBOEAC.hABADFIFCFBFADCH.eFHHIBAGhAAASCAC.XGEAcAGDNEEGWAGDhACA.....hABA...,2,-32,-13,19
dNgaIFQABVLJTEHUDeCbOYcRfXKZSMGWP,VBCHTBCH..UGEBCFDD..ODEARFADKCGC.ZEFGGCEGdGHAaGAGFAAAhADA..AEAE.BHHGEAFEDCFEhAAA..eAEA.hABA.cABGSEACPHEGNDIA....hAEA......hAHA...,1,-18,-25,7
LBSCJKHFbNaOfQgZREeYDVMIWdGPTAXcU,XGBAUGFABGAH..JCECKCCF.FBEGaACB....QFDAhAAARFEGEDBDDABB.MCHFdAHA.hAAA.TDDDAADGLBADhABACFAH...NEIAOHAEZADGYEHH.hACA...IDFGhAFA..,1,-24,-26,2
fFUSYGcJQPKbEHDRMZTNeLgdXVaCBIWAO,FEBHUGDCGBDGQGBCKHDE.HBABREGDZBAETACALAHB..hAAAXAGHCABDBAFDAHCHOECChAAA.SGGEhABA.YBFF.JHFCEGADDCEHMIFAhACANEAC.eDFF..hADA...,2,-23,11,34
GJNCVOTcdRSWfPHeDBIYZXMFbQUaKELgA,JFFDVCEC..ODBCdCBERFBC....SAHH..fABBhAAAHFFHBADBZBBGhADAMEIBbFCDUAGBKABGEAFEhAAAAFEDCEHC...TFAEWHAA.DCFHIHEHhABA.....hAEA...,2,-33,-14,19
fESXLHDPadGOQcJbNCMVARIZYgFWUBeTK,RDACZFFGFGGFBEFF.KCDBEGEDLFDFHFBFDACH..dDAFQADGhAAA.JEFACCHBAABA..hAAAIBGE..hABAYAFHUDDG.eBBCSAGEXEAHhADA.aHFE..OFABhAFA..,1,-6,-43,37
XfOWgUKcbNaHREGDeBSJZYdFPMQTVCILA,XBGCOFBAUCAHKGHF......bDCEaGBC.EHGADCABSAGFhAAAJBAC.dDDFMHBChAAAQEGGCDGAABFB.hABAfABCgEBGNAIC......hACA......hADA...,2,-38,-20,18
YQCTDAEbefSLPJHZFIKgNVRXBcUaMOdWG,EHGAeECALDBAHABDZGDEFAEGKGBC..VCFCBAFD.aAGDdBBB.GGBDhAAACEGAACEG..SDABhAAAJEFH.NEAC..hABA.....XAGAMBIDWDDEYDAFhACADFID....hADA...,2,-21,-19,2
XNODBILfPGMAbVZgKRWFEJeQScTaYCdUH,ZCDBRFFGFDHDEABC..eAAAQGCD.SEGEaGAECEEF.dAHGhAAAUBDHHEAFOHCEhAAAIGHDLAEE.hABA.fCCEMCCDAEDDgBGAJFFHcAEFhAGA......hBAA...,1,-12,-20,8
XbVDcEFAMWUJIaRSCGTgLYfOeZdHPQNKB,MBCEUADF..aHDASFCAGDGG.LEHFOEAFZDEHdBGFHDCAhAAAQECDBGFFXEAGhABADGAHFAAE.AHDHWBBGhACA...IHAACCCG....hADA......hAEA...,2,-25,-23,2
SLEJUMdYbZOXWcGBTKDPFgNHfRIQeCaAV,VBFBLFEE.UACEMDDDdCHCZABA..XGBBGEGCKDAFDDDG.hAAAFHAGHAFAREEF.IHHChABACFBEAGAG..ECAEbGDAhAFA...OCBH.BHAD...hAAA......hACA...,2,-24,-9,15
gFQDKVUYWGcBfeIHAPTMEObZCaSXNLJdR,MEEEODGFZDAA..SGHHLAFBJCAAdBDBRGBG..QFFChAAADBGCKEAFUCCBGABFhABABFDDIHHBAGGH.hAAAEHCACACFaBADXFCG.FBHF..WFFFhABA......hAEA.fCFC.,1,0,-28,28
acRBFDPELGITOMSXAUYVQCHNWJZfebgdK,UFDDVDDE.CBCC.HBEC..JAEHeBBB.dEHCKFAEaFBCBGHB..hAAAFHDADEFCLAFEhAAA.IDAEMCIDACGF.hABAQACBZCAA.gGGG.hACA.PHFCEHBE.OHAEhADA.,2,-50,10,60
BZRCadIcNFMPfLKgGbXAQYVeDWSTOEHJU,VEBGDAGG..SHCGEAFE.UFEGZCCACFHBdDBD...IFBFhAAAFADHMAAD.LFFFhABAKABEGAEAADHAeHAEhACA.TGGFOEGDBEAFcBCB.NBIC..hAEA......hAHA...,1,-19,-25,6
LFKABcMIVJRWbSgXYTdZGPUQaCOeEHDNf,BDFDMABE.JGAGREEE....SHBA..gBFEhAAATDBHZFAEUDCGQGEGhAAAOHBEeBADEBBCDGIDhAFALFHFFBHHADDGIBFFWAFE..YFFDhABA...dBCBhACA...,2,-33,-7,26
BYMHIbOfcSVgADPFJQCURNZWdaXLGeKTE,FBECJFEC.CBBF.UBADZDBG...dHDBLHFEGEAA.KEFGBHHFHGBC.hAAA.ODEESCAGhAAAADDG.DCIHRAECaECFXFAGhABA..ECHDMAEG.fFDBhACA.....hABA...,1,-18,-33,15
RYcPdfFBTOeCXaIUZgDLSWVQEJHbGKNMA,RCAH..PCGFFAABBEHD..TBBEeEEDCCGFaDEB..UGGFDIBESFGAhAAA.hACAVEBHQFAFhADAECADbGFGKAFBAFFAdCCA.fHDBIAHELABChAFAHADCMBIB.OHAEhAEA..,2,-13,-11,2
dUOfIQNBTMHXPeJKgVWLZDGFCcEASbYaR,SBCHaGHH.UCFEIDGEBCAEHFAEeFDEKAEF..gEDEhAAALHCCDGBEhAAAFHGGCFHGAACERCBF.dAGHfAEHhABANBAE.MBIFXEGEPHBC..hACA......hADA...,2,-23,-19,4
eKTFbfXRZDOUQICMPGHJLVdABgaEWSNYc,aFFHEFHH....SDDG..NAIGeCECKDADFGEC.XDGGhAAAZDACOAAD.IHBGhAAACCGBMACCPHAEhABAJDGDdFAHACCEBCBB.gBDEWFED..hAGA.....YAHHhBAA,2,-40,-21,19
CIVEDFdagGbNMefZKQHPYORALSJXcUWBT,SACBXFACUCBDBEEB...CCBAEHFEDBFDaHBA..GEABhAAAMIFAZABCKAGHQDGFhABAHEFAOFEHAAEGLGAAhAGA.cGGFIGHEdBEE.NAEB..hAIAfDGB.hBAA...,2,-20,-19,1
EIUFCdaMcPeNWLVKDJTQRfOGHBSZAXgbY,XACD..gBBGECAH.IAHFFGEHaGBGMDDAhAAAeHFCLCFDDGAH.hABAQGACOEFGBBFBhACAAFHGbDBGCEAAdHGD.cEECNGEFKGDDTCGGhAAA.fAEAhABA..SHBA,1,-16,-20,4
dIeLWSgRTBAYaZQODEKVXPCGNJcfHMUbF,ZCEAODBDKDAB...VFEECCCEGADF..JBDBHFEFUAAHFAABdHBDhABALHAA.SEGAhACATAGBAEHDaADAhAGADEECXBGE.NGAH.MDFA.IHHHhAIA....hBDAgGGBBEEF,1,-10,-20,10
TAGIZDdFSWHPgfRCaXUKJLBOVYecNMEbQ,GCCFDCGGdDGHFEBHSEBB.HDFC.fBADCCEDaABFUGGBhAAAKFFB.LDAFhAAABHDF.YHCEeADAMFFBhADAEAHDbACA.AIACIHHBPDDB...hAEA......hAHA...,1,15,-42,57
aKAEZgQXDUcdPNOeJTYIbGLWRBCVfMSFH,EDABQGDBDBCB.dBEDOFDEeFBFJCHD..IHEFLBCFhAAABECBCDDE.MAHDSGGDhABAFCFBKGBDAAAE.ZACHhAEAXAGB.PCAFNAIA....hACA......hADA...,2,-31,-22,9
QEHCFIDbJKVOWAgBTNULZfXaPcYeGdMRS,BFBCTCDCLAFE.ZFDEaCAB...PEBBeHFCdADGRDFHEFEBhAAACCHBFBAC.DEFCKABH.hAAAOHCCAGCHUDDAfAGAhABA.YCHHSEHH..hABAIGHA..hADA...,2,-31,-26,5
TRZbMfKeWISgLUVPDJaEXGQOBHdYCAFNc,FBFFTCECRBABZFFC..MCHHKGAB...IBDGLCCH..PABFhAAADDAHEABG..QFAGhABAOHFCBHDDhAAAYGFGCCHH.ADDDNIAF.fAEDSEGEhADA..gDAEhADA.UEEH,2,-38,1,39
AXaOLIKcfMGPTSZDCQbJgHdeVFEWNBYUR,OCDDKFCEMBBGGGAF..TCEAZADEQAAE.JDAGhAAAgFFCeEGHEDFFBHHEhADAREADaAAHLDAChABA.IHHHfBGHSHCChACADDIFCFAH.bAGF....hADA...,1,-6,-22,16
fCPdLJcNVbGKBQDYSHTFOMURIZAeEgWXa,EEEAXCEF..CGBELDGBJEHF.VBCBGEBD.BHADhAAADEACSAHHhAAATAGDFGFCMDBA.RACCAACCWABChAFAaHDC.dHBH.NEIAKAFHYBAD...hAHA......hBAA...,2,-29,-12,17
GIfLEcRHOZKPTNXQYCWUdgVMJabeSABDF,BCGADGHBGEDELFBHEADE.HADGZCGHKAGETCDA..QABHhAAACGFDUAACdEGCMECBaEAH.hADASDFBADIF.hAEAfCCEcDCHOHFEPFAF...hAGANBAC......hAHA...,2,-17,-7,10
DSIXYZNBHfTebdKUQFPCRJaWAcVOgELMG,ODEHEDGHGEBCDADE...SBFB.XEDAYHEChAAABABEHAFCTCDChAAAdCAHKCFDFFHBPEBHCDADaAGFAFAAhADAVDGBMAIDZBCDeBBA......hAEA......hAFA...,2,-12,-6,6
ONgHSRFaIGLEXWbPJMYQCBZUVTDdefKcA,OEBHHEFHRECFFEBBGAEFLACCEFEC...XAGFPCCCMHCAhAAAQCDFBHHEZDEGhABATBAEdGGC.KHGAACAFNEAA.hAAA.SHDAaBBB.WBHH...hACA......hADA...,2,-10,-2,8
eEWVSUGHMACPaKJNZTRXgdFbcLYfBIQDO,CDEEaFGHKFBAZEAD..RADG.dBBC.FGEFLACF.BGHADADAODEAhAAAEDHB...VAFGhABASBAFHECEMDIFhACAAFACJGEG...XAGB...cECAhAAA....hABA...,2,-47,-21,26
KXHfMAQSbOdEgeFaNTLGYDVPJCWZRIcUB,QCBFOFGDdEAG.EBEDFDCA...aFBFLEHF.YFBEhAAADIAEJADAZFDE.RAAF.hAAAIABDBDFEKAHFfGCAhADA.MFFFAHEB.SAFAhAEA.eFADNCCF..hAFA...,1,-23,-31,8
XKPcYAaebQDBSGOUdVZCfIFRJgWHLNEMT,aACDQABDBDHAGECBdBGDZFAF..CBBC.FBEFRBFC.JHDCHGEA.LHAAhAAAEDFF.XAEChABAKFGF..YDDHhAAAACAHDAFASDDE.....hABA......hADA...,1,-12,-34,22
TYOeZUSaRAPbdJMgNCDLXWGcQVHfKIBEF,.dGCDMFEACDGBLABEGDABQGBHHDCBKGFGBBHDEDFEFAFG.TGGDhAAAOFAH.eBDAhAAAUBBD.aACGAFIBPCBHhAFAbBFA...NIDB.DBAD....XEEFhAGA....hAHA...,1,4,-21,25
KJCTNSOXcgMUbYPHEdQRGFZVWfaLBAeDI,eCDBDEEHKHDACFFD....SHEEOCAA..XDACMICCUFBEhAAA...PBAHhABAHGAEQCFAhAAAFAFFZAGD.VFFHfEGEaABAACIDIFCAhAEANBIGbBBFEBEB..dAGH..hAFA...,1,-2,-23,21
ARIDQgMBWCdVULfPaSeYKZcTNFGJEbOXH,DBBFMCBFCGGD.dABDLHAC..aHDASFEBKFCDZAEA..TFFChAAAFECGEBGA.OADChAAAACCDQCEHBEGB.hABA..WAHHfDAGeDDD.YCDAhACANEIEJFAF.....hACA...,2,-29,-20,9
eSQUHGEPFIZcTJdAYaWgDBRbCMOLKVXfN,aFCFDEBBBHBB.RFDB.CHFALFEA.KCABfDFB.hAAAeADDUAFHHFGFPDDChABAIFFB.TAAAhAAAAICGgCGG.OACFVAFEXCAGhACAQGAC..hACA...,2,-34,-14,20
ASWIfCPEBKQcgHZGFJNdXRObVUeYLMDaT,SBBA..IEHECFHABAADKFECgAFFZBGH.FHBAhAAAdACFOBDDUCEEeHAGhABAMCACDHGCAHIF.fDAEhABAEGGDHFAG.JFDC.XFAG..hACA.RCFC.....hADA...,1,-22,-25,3
bgWRJYTNLeOSKFMCQHVPXDdUIcaGfEABZ,ZEBG..bEEBRAGDJBEF..TBFFLCAAeDDDKEHBFGAC.MCIDhAAAHGCG..XBCGhABADIAEdHGB.IEADhACAaFFCEABCBGADgGGH.NADFSHDGhAIACAFF.....hAAA...,2,-23,6,29
UMJbQCdIcLEPGSFReXNWZTBfVYagHDAOK,OEEAKEDFUGEA..JFAECAFH...dBBALAHBEGGC.GAAFhAAASBHHFCEG.XGDChAAAZEAHBDCC..VAFDhABAaFFADFADADDG..MIECIHHC..hABAcACAeHBANEEHfHADhAEA,1,-25,-30,5
JVTGPaOZeUYBfDCEdXgHRbKAMFcILQNWS,FDGALAADQDAGSFGD.JAEDTGBA.GEFAhAAAOCCFZFDHUEAGBCCDDDHFhACACAHGXAEBRFDDAAID.hADAIABBNDIA.WFHBPHAA.eCFChAEAfDEG..hADAEBBC..,2,-25,-9,16
gZaQSbRDULPeTJfcWXMCKdVNBAOIGFEYH,ODFEGDBDEBFDHEBHZGFEaFAH..SACFRBACDGFDLADCeCHBTGAFhAAAJBEB.fEFFhABAXGGFCGDGKEAF.hAAA.NIAF.BBDH.AAIB..FFDD..QBGDhABA...hAEA...,1,-5,-8,3
KJLQGbBSYEdUWTcgeVRDHFOMIfXZaPACN,KFDAQBBHBGBF.SEBDEDDE.dGEHUAED..TAGBhAAAeAHBRAAEDADGHCADFEFEMFIHhABAXGGHaCDDCFCEJHCAhAAA....bGACcDFA....hACA......hADA...,2,-25,-12,13
RGMQYVfCSUINeAadBKDcJLTbXgOWEPHFZ,dCFHKEBBDCBGLECG..XGDGOBDFEGEEHFFHZDAFGDDHhAAAMEAD.VADE.CHADUAGGhABANIDFACCH..BABA.hACAJHAG...gDGAWDAF.FGGA.hADA......hBAA...,1,-15,-20,5
OBTgZCEKdeVXPRYaHLGDfIUJMFcWNbASQ,SDDGQBFFBGGBZCABKBGFdFEE.eCBF..VFBGREBHaBBAGEFChAAA.DAEFIDDAhAAAMICGFACF..NBAAAAHChABA..OAHFCHDGXDGHYEHH..hABAfGAE.hAFA...,2,-21,-18,3
POLQSegGXCMbBdRTZFKWfNUJEHcIVYaDA,OEDCLBFE.SHCGeBBHGAFGCECABFFGTFBD.KHGE.hAAA.NBBC.EAHDHCECIADBhAAAaACGAHHD..QEGAhABAMFABdEHCFHDAfGAA.cCCGhAFADBAF.....hABA...,1,-12,-17,5
CXaNVIGSeRgEMPLfTUKOBAbDcZWFYJdHQ,DFHDZFADFACAdABAHAED.CCGD.aGFF...VGCCIDAE.eEDHhAAARCCDEEFELHCAhADA..TAGBODCBhAEAABABbAEDWEHB.JAHFNCIE.SGABMBBH.hAAA..fFFGhAGABHHE..,1,-9,-19,10
LKEQVFRBOWMAXUPJNGfeDcICgSdZTYHab,UAGGJHFGGADBeDDFDCAD..CCAC.dHEHZDCAHABBLDFBKGBB.EGCGhAAAQEFC.hABAFBDABGADOFABADIDPDADhACA..NDICIAAA..SCCEhADA.aCHBhAEA...,1,-15,-29,14
aLNGAPJDRMXgYKCWQbBeIdFHOVZSTEUcf,DDBBRCEFMGCE..XCGHKBCE..QBADeFBFFGHHHEDGhAAAOHFCSABHhABAUFAGaFHD.LAEAGAGC.hAAAACEFgGCCCDAABEDG.IHFE.hABA......hACA...,1,-14,-21,7
KSCELIOYRPaeTfcgGJdHXZBDUFQNMVAbW,KFDESGGHCDEH.EBEDLBHH.OADFRCCFeEGF.fBFDhAAAGGEDHBACBFEGhABADAGFUFABFFABMFCBhAAAADHEIBBEaHDC.cGDC..dDGCXDABhACA.NAEH...hADAWDAG.,2,-25,-5,20
AXSbeCgaRPUVTWHKZBJcEYdfNILMGOQDF,SBEBeFBHCHFG.RFAF.UFGA..VFEGTEDDHCBA.BCHHhAAAEADEdDGF..NAEHMEFEhABAQCAEFABEAHHD.XGCHhAAAaHCC.KAGF.cCDB.IFAHhABAOECFDFIB..hBAA...,2,-15,-13,2
YfWEPCTMSQaOGgDKVUbRBIZcFNXAeHLJd,LAHBJEBG.dBDA..fFFGEEFETGCAMABC.aCBBODCHhAAA.DCBEUGCEhAAABFACIHAAFGGHAADEeEEBhABAHAFH.PEFACGAH.SCDChAFA......hAHA...,1,-21,-27,6
bILPUcfQgFHWOKSJZCdYVaXRMBAGeDETN,eCHBEGGC...TBCDIBCHLFDGUDEF.QBAEhAAAHAEAOHAAKGHBJFBHZAABCEAEVCEHhABAXCGFBAGBAHECDIDAhAAA..bDAG....fFDGhADA......hAEA...,1,-1,-23,22
GZLKbMVQBAYWaNgfcCETDSROPJFeXHdIU,aHFE..fGCGCCHE.DCIBOEDGJBEB.XCBGdHEDGBBAhAAAKAEH.MEFDQEABhAAAAAIH..WAGBhABAcDGFEEAD.SFDDFADGeDGD.IACBhABA.UGAF.ZFFChAEA...,2,-20,-13,7
MBQOYgAePbWUVGFTfJREXLIKHdaNcSCDZ,eDDD..PHFCUGGAFFAGJCHB.RBEHLBBAKBBDHGAG..aEAGSAHFhAAAZBFB.MBIFhABABEDA.QADHhAAAOACGAHDH.bFFGWFFF......hAGA......hBAA...,2,-26,-14,12
LBAEdGPcNVCSJYUXRKebMaWZOHfTDIQgF,dGAHGABF..NABD.SAHF.JFAFUGGAREEG.KAFHMDDChAAAZFCHOCBBHFCEfHGDhABADAAF.ICABhACAQDDF.FEGEADIBEHDA.PEAAhAEACGEFeBBG.....hAFAaBGD..,2,-25,-9,16
FbPdTQKXNDafLOCAcJZIEWYRSUMgHBVeG,ZCCCEAFDRECBSGFG.UFBGMBADBHAGGCCB.FEFGdBGCTGGEhAAAKABDDEBGLAHFhABACEHG.ACBAJEAB..hACAIBDA.....WAFE.hADA......hAEA...,2,-45,-16,29
cZBMNRIdPAETSDQWLbUXHaJfVKgGeCYOF,ECEFDDFBLEHBUAABHAFE..aHAE..JFFDKBGCeDCHCDCA.FDAABBCFhAAARFAB.dCAAADHH.QFABhABA.XGEEhACAfGDE..GADG...hABA......hADA...,2,-28,-23,5
cQbWXNFCfVGRdDLZYIaHOKTgeAUJEPBSM,UDFCJDEGBFCBMDBA...QGAG..WCAHXADEhAAAFHEC.CFEG.GACAhAAADICGZECHaFGBKGGH.eBAEhABAAACHEBHD..SCGEbGAG.fEADhACAdAEFIHHC..hABA...,1,-9,-38,29
LGHSWPgIRUadJVeKYDOFBfcCAZMTQENXb,MDDCQCGF.EAAFNEAH.LEAHHEFBSHDE..hAAAgCCFIFABaACGhABAVGEEeBDCKEEEDAGEhAAABAHGCHCCAIHEZCGF.XFCGGADH....hAFA......hAGA...,2,-15,-6,9
ETcCMbfYKeIRBgUHPQVNJdDFAGLXaOWSZ,XDGDaBCG..OFECSGDEEDCHCCAD.MDAG..fBFAhAAAKFAGRAEDBHGBUFBDhABAPHBE..NIDDdHAHhACADEEAFAHDLAGBTABGYEHHIECF.hADA......hAEA...,1,-17,-20,3
XZUFLVbGIKSYJcaMRfWCQAPNDEgBTHdeO,DCIDEEAFBFCEdCCD..OAFHUCEBFGFFLAACGABAKFEB..SADGhAAAJHAE.aHAChABAREBECAGB..ADDD...hAEAPHFETEGCHDECeHCE.XBGFhAFA......hAGA...,2,-28,-19,9
PfWAMGQegCLZYaIDBbHOREUJXNFTdKVSc,QDBBCDCEZAEB.aEGCDCGD.BDHFHFDFRAAE.EBHB.UABG.JADEhAAAXEAFFHAA..hAAAKGGHSEEFhACA..fDGBADAAeGFELHCG.hAHAIBHB..hADA...,1,-10,-44,34
PHYXLDQWeSKcAEIUgRJNBGbVZfFMOaCdT,EHEGUDCGRACG.BACCGDDBZGFA.FBGG..aDGBdGGH.HFCDLAAFhAEADGAHQAAAeCHHKAGHACCAhAFAIEAE..hAAANIBF....fGAACFGB.TBEBhAGA.....hAEA...,1,-14,-25,11
XIUQYdgCAGLZRaSVJNDMObBKWeEcFTPHf,LDDDZBBFRCFE.aACHJBAH..DDHDOEGBBBFEKBAB..eFBGhAAAEHCA.FHACHEEH.XGGEhAAAQAGEdGABCDADhABAAHHBSAECMAFC.bFEHcCEA.hABA.fEDHhACAIBHA...,1,-12,-28,16
DWAfTgVIdCRUJSZLObEBNKcHeGPFaXYQM,TGCCVFBD..CFFC.JCAFLAHH..ECCHKADHeDFCGCADhAAAaFGF.QAFChABAMABCACBC.IGHAUAFAOECChAAANEEC.PHECYDFADAIF..WBBEhBAAfABA..hADA...,1,-8,-25,17
KALeMaFIDOfGVYNTHQWdbXPZSBcgRCEJU,MFBCaDCB.DEGBOFEDGGAH....VEGFTACHHFAEdAFHXAAEhAAASCEAgBDGhABARBABCHFF.EDFAKHGGhAAALAEC.IDACNAICWECE...hABA......hACA...,2,-23,-1,22
TJCWLZUGbegOKBESQfaDPYdRXHAIFMcVN,MICGVECD...JDCCLFGHZBAE.UCEDGDAEeFBDOEFEhAAAKHEEBAFGEABC..QAGChABAaBCDDAAC.PGEEhAEAdAHGXDACHAEHAIGA.FBBB...NDIA.CDHB.hAIA......hBAA...,1,-5,-12,7
KRgIZSabLHcVWNeJCQBdUFXYTPMDOAEfG,EDFBGDEGRBFE.ZBDD.aCGCHABE.VEDHeAFEQFAGBAAFdHCBUEAFhACAFHFE..YFHHhAAAMDAGAIAAKHGG.SBBChADAcBACNIAH.CEGE.......hAEA......hAIA...,1,0,-16,16
PIXHEaSUcdLgZCTBMWbDGeQRYfOAJVKFN,KBEDFCCD....IGGFHDBGSFAG.dAABgAEGhAAACEHGTGED.BFEH.hADAMDIFDGGAeAHBQDFAhABARCFFfAEBOGAAABHDNIAHEFDAaABELHAAhACA.WHEG.hAGA...,2,-16,-16,0
YVFKGHdcCQaSLPDJUEOBNWbgfIZeTXRMA,FFFHKBGAdFEHCBHF...QACALCACDFACEFHD.BAAD..NAFC.hAAA....bFAAIHABhABA.TEBChACAMEDEAEAC..YHECHEGDSHAGhABA.PBDGOBBHhAGAWFDHfDGH,2,-48,-20,28
fSWaBUcYRDPbdJOTENQMKFgIVGXALHeCZ,LCEAHEBHZDEESBBFaAADBGGB.UFFAREBHDGIHdCCF..JDABTAGDhAAA..EHEAMDADhABAFHAC...IGDBhACAXADAADIHfGAA.cBEFhADAbEEC.NICD.KCCB..hAAA...,2,-33,-3,30
JVLSDeKNCaQWFBgUZYObdHERMfATXIGcP,XBBCGAGGJDDDLEDF..DBDDKGGCaFGHQAEAhAAABBAHZFBH.OHFCdAEDEFEHMFEChABA.TAGD.hAAAIACD.VEAHSDHHNIAHFCHD.hAEAYFAF.bABBhAFAfCEGcCEF,1,9,-27,36
QDZgfcSJVEGCKMdIHbNFOWLePXBATaUYR,UBEDRBDGZAAF.....fACEJFFFEBHDGEAHKGEF..IBAHhAAAHGBGFEGA.LADChACAXCGHAIAGaDDCDFEASHAGhABA.VEAECHHA...MADGhAHA.dGGC...hAHA...,2,-17,-14,3
LRNYCdXgDKFeEWGBQVfaUIJHTMOAcZbSP,ZCAGSEADLBFCREEC.CBAH.dCECDGHB..KGCAeDEAEAAF.BFFEQDBGhAAA.aDFAJGCGhAAA.MDIFAFIB..PADGhACAXFABFAHD..WHAGfABBhADA.IHFATGGD.hAHA...,2,-32,-19,13
CEDIKgLdNPbYSfWZXFaHAMJURBeOGcQVT,MCFDUGDHeBGDGABD.QGEBCDBH.DCGGKBBCdDDC..PECEhAAASAEEZFAHFAEHhABAAIDCBCAH...hACAVDGBEHGCLCHH..YHAEhAAAfAGDaECH...hABA...,1,-20,-23,3
HfSNOQYZIMgcDLRFBeGKdWAabCTUJXVPE,aBBDTBCB..JFEF..XCFCEAFCHDBCSGBD.hAAAOFBAQDGBhABAIHGBcACFLBBDhAAABHHBeFAEKAFGAFGECHEGPHBCNABHMGEGDAIF..hAEA......hAFA...,2,-18,-11,7
SfMOVcNHGYZgdKWBIPLCAJbXDUeQFETaR,JEBDXGFC.DBDBQFEB.EDGBaGCG.RCBD.MDIBOBEChAAA..VBCDNBICHDFDhABAZBEDdAAEBHDELHAGhACAACACeEAF.FGHHSGAHcAGE..YDADhADAWAECCEEG...hACA...,1,-2,-23,21
BTLJcCRSFOHEMPVYbKAXgQWUNGdaeIZfD,XFFHQCAFUBEHdECHeHAC.ZFFEBABALDDCCHCHRDBBFAHHHBFChAAA.EABGMBDHPAEGhADA....YEFChAAAAHID.NEEE.aHEE.fEGFhAIADFBF......hBAA...,2,-32,-1,31
ReVgOTJdYZLSUabFMXIGDEAHcCNQPBWKf,CDHAQBCCBEBD.KEHDRFDF..eCBEOAGFdGAGZAEGLFAG.hAAAaBEFMBACGGDHAHIFHDFFhABANAIE...fBHChACATDAESAAF.FEEBDDAD.hACAEFCF.....hADA...,2,-19,-12,7
dCLDePNZAQUFIRVgSfOBGWEXKbcHMJaTY,UFCFFCEARFBE...VACESHBG.BGGBGCEG.EAGEKABDhAAAHGFCMBDBaBAFdDADDDHBhAAAeAHFZFAFAIDA..QGEDhACAfCCGWEFE.....hABA......hACA...,1,-15,-26,11
IKWfFLSRTCUYBJeDcNGPaZHEQOMgdXAbV,VFFAKFHFFBCA.LFCERBCE..CGCHBDAEDAGBGCACZAFFHEAGEDHB.hAAAOAHF.MFEBhAAAdDDHAHAB...WHCGhABATDEH...YHAA.cABGhABANDGGaADA.....hACA...,1,-12,-33,21
eZaHdEQDFfRCGWNSJKUVbYLIMPcTgXOBA,aFHBdGCFDEFA.FBBGCDGBGDAF..SDEDUADH..VGCGhAAALDHBMAIF.TAGChAAAOFFFBDABAHABeABHhABAEFAFQAEE.fHFFhABA.WCDFKGAC..hACA...,1,-17,-37,20
eUJNTIALMEFSXVKfZDdOQCGRcBgWPbaHY,EGGFSEAHKBEH.DGFHdABE.CADB.GDCDBHEC...PHBGhAAAHFAEeDDGJBDE.IDBGhAAAAEIBMAFGFBAD.fFFDhABAODHDcAFAbCGB...aHAC.hACA......hADA...,2,-26,-22,4
WNeAUaDBcRPHYdZGXOMSIVLbTQJEfgCKF,DFEDBCCHRDAFHCDEZEEEGGEB..XCGBOCFG.MAEE.SFFGhAAAIAFCLBAFhAAAQABCfHBFhABACFCDKHBAFGHD.WEAAADAFaAGE....cCEHhACA....hADA...,1,-7,-40,33
CacdWPNGFYSfEBQADKZIbUeXgLMRJHOTV,KBACZBAFUFCAeEDGLDHHRADC.HEBDTFECCCDE..dAEF..hAAA.NICH.FHAC.SACDhAAABGDGAHIBDHFCXBGDhABAMDAB.ODECaDBG.PHFCfAHEhABA..EEAB..hADA...,1,-14,-26,12
aGKBCOYegVWAEfZRSDUXIHcTNPLJFMQbd,ZFBCSFCCUACDHFFA..TGCFLDCEFFGAMBDBdAFCKDHFBBGFhAAACAHH.OABGeBAB.hAAA..gCEGhAFAAIHGfHCBDAIDXGGGIHAC...NEBAJBBFhAGA.....hABA...,2,-25,-8,17
fOXMaQdPRAgULVZKWYFebHNDcGSTECIJB,UBCBLFGFKEEF.FCBHHAFCDBAEGACA..SCADhAAACHCDBDGD.XGAEQFAFhAAARCFHAHGAZEAEeEDH.NEIE.hABAEEHB..JAECMABC..aFED...hAFAdAHE.....hAGA...,2,-21,-7,14
FKCEDfNRbWAcMOYdBgSGIUZaPVTLHeQJX,MEHBOCCFdBEABCGAGEACUGBFZFEB...aBCCTFEH.eBABhAAAXCAC.CGDCDAIFhAAANEEHRADG.AAHB....hABAgCFHSFAF.IHHA.hABA......hACA...,2,-27,-26,1
PIfCXJKROaQAUWgBVGTbZMDFENLeYdcSH,UECBBCCBGBEGZFEBDAAG.FGEFLDHBdCACHEBB....ICBGhADACAHHXAFF.KGGDhAAAaAEAADIB.....hABAWBEB...TGCBMDHBeABC.hAHA.cGGH.fAHAhBAA,2,-35,-29,6
XYPbHfNSdaRIMJFCLAOZDUEKTBQVeWcGg,OEHDZGACDBBEKFEDBHCE...QAFBeDFCGDAD..YDDDhAAAHADFSGGAhAAARBAHMHEC.CFHFACAHTCGAhABA..WAFAcGAB.XACFhAGAfFADdFEHaCFH..hAIA...,1,-17,-21,4
JLcTOGSEDPFdaQXCWBKVUeNRfZYMHgAbI,JDAHLEEH.OFBASHBGDIDGFCCGQCGC.CBACBEDFhAAAKEGHUAGH.eEADhAAANEFC.ZBAFHBCEADHG.hABAIAGD.TGGDEACCaHAEXEGEhABA.....hACA...,1,-20,-26,6
VcOTbCKUDZFfHRePQYAdNIWGSBaLJgEMX,dCAH..IEFCSHBCaDDH.LDFHEBGC.XCGBhAAAOBAETFBAKFCGDBACFHFGhABARAEHQGGAAAHG.hACANEACBADBMFABcDBDCEHA..fAAFhAAAHAEEPEHDWHDG.hADA...,2,-18,-7,11
ScWDeMOFXZAbVHfCQJPNgUdLEGYBKTIRa,HAEEQFFCJCAH.....PDBFUECDEDGBBDECKGFDIBBBhAAAaCCF..SAAAhAAAWAEA.DGGGOFAHhABAFHAEAHHC.fHDBCAHB.gBGAhACA.dADC..hAFA.YDDF.,2,-28,-10,18
aMfPSYHWNTcDbGLJFQZKIOURBgEeACXdV,XECAaACD..MFCDSBEGHCEDTGEEDFGEGEACLBEEhAAAJAFGFGGCQCAGhABAKBBDOHCCBEGGEDCAAGAFCHDDhACAdAAFfHGH.WFAB.NAIA..hADA......hAEA...,2,-20,2,22
OSUgBIWfdDLQKVMeZTXNRcaJGbCPFAHEY,EACESCHHUGEEBCBF..IEBGdAFGDHAC.QACAhAAA.KFDDeCDDXDEBhABARDGHaCEC.JAEECAAEAEADOHFEhACA.gFGC.fAHChBAAMAIH.....hAEA...,2,-40,-7,33
cICGFLKHbaBSAfEgRWNYPdMVTeZDXQJOU,EEADRCAC....NDGA.PFDB..dHCFTGGGeBACDFFH.QAFDhAAAJCBFUADGICGEhAAACDECLFAFHEEGhABABHHCAHAC..fAGBgEBHMCIF.hABA......hACA...,1,-8,-30,22
GBgDXHPAUcaFLINZeWETKObCVRSYJQMdf,aAGDLEEEZFAB.ECFCOBCD..VBACRFEH..SHGChAAAJGFAdEBFGGBBBBBCXDFFhABAAFABFAEF.eDAFhACA.TFCCCAHAMAAGDCED.PADA..hAIA......hBAA...,1,-15,-20,5
caXgEROCdGJNZHAeSYVPMTFUDWIQLKfbB,eDBASEEC..VEEHMAGHUGBADDAAQGFCKDHBBCFG.hAAAXEBARAFGdDAGGBABhABAJCHBHAAEAHGD.PHBChAAA.FBEFIHHFLEAFfHDDhACA.....hACA...,2,-13,-11,2
XYOTNQBcSIWLeDAKfCgMGbVdaZFEPUHRJ,KBEBCBCAGECHdDCHFHDAUAFE..RFAD...JEAFOBAF..TGGBhAAABAAC..SDGFhACAIDHEeDDEhABAAICG.MIAGaHGAEFEEXGDA..NADD.WBBDhACADCGC.....hAIAfADD.,2,-35,-21,14
RYCEIdMbNgBHTUDcXSZVaQLFGefOJWKAP,RBFDEEAGMBAB....NCBFBFDCTFDHDAAE..SGHDhAAAZDDCQGAAFCBCeAHBOFGFhADAKGAGAIEG.CDEFIEBDhABAdAFHbGCE..........hACA......hADA...,2,-27,-26,1
eQMGLRcfZBOWUXJTgdPAHDCVbNaSEYKIF,HFEDDBCCCAAC.VBFG..aDDDSEBB.EAADIDAHhACA.FFFFMDADRGBGZAFDWDBEhABA.UACETDGAhADAgDGAdCCAAAID.NIADKGAAeFAF....hAEA......hAFA...,1,0,-27,27
PAFVQRSZIXMCeYKfgWJDacNbGdEHOBLUT,FFDHQEGEZBGF.MCFBCHGDKBCE....gEAEJCEH.hAAADCBEaDAE..NHCHdEDGhAAAEBAG.BADELFBBhABAPAHHAFGF...SGAB.IHHHhABAeAFDfFHGhACAWCAG..,2,-35,-33,2
FGIfbQCUaLNPOBgedZEHAXSYVRcTDWJKM,XFDHSDHBRCFE.DAEE..KHAGGBCA..bDBFCDAEaCEDLFFGhAAAOFFFeDABdAAGEHBChACAABBDVACA.TAGChABAWEGB...MEDEfGDDNIEB.BAHBhADA.....hACA...,1,-6,-20,14
YbNfLeRWCPXaQJZOUFGcSDAEBgMKIdVHT,ECGGMHCAdACGHDEC..TGAF..YBCH.fFDBhAAAeDDBWAFGCCAGaEBHhABAJDFBOEHDGAEBDHGAhACAACFDBAAFICEA.NIDD.LHEG.hADAXEAE..hAEA...,2,-27,-1,26
aMJZVgDITEdScUFRKBLPOYCAXHeNfQWGb,HBDAeEEEQAAEGDDHMAHHZBGHDBCBEBEDdGHGUGCFKGAABFAF.hAAAOAAHACDDXGGFhADA.NEAG.fGDEhABA.aEGEJDBD........hAEA......hAFA...,2,-16,-15,1
CGUKYeLRWVJcXITHaPMQSDdgZAfEONbFB,EGHHOEGBFBEF.BCFDGEDAKCAF.LHAA.RAAH.VGAC.JCDFhAAAXEAC.TBGFhAAAPBFAMADHDFIFZBBBhABAAFFG...fHEDCGGC...hACA.....eCCDhAEA.IGBA,1,1,-43,44
AeMXKbYTWQNSdHEIGJFOagDUcfPZLRCBV,XEADKEED..TDAAQACFdAHEHDGDEDFAGGBFOAFHaBBFhAAADABHUCCD.fEGChAAAZGAELGFAhABABHADAADAMIFEYAFAWHBASFCEhADA.IGHG.hACA...,1,0,-16,16
fHYAJFRUMQLeZcObaPGVXIKESBCgDWNTd,FGBGUAEHMCIBeBHDZCDH..OFHD..bABGaEFD.GBCAhAAAVGFE.KFDBBEAHDFCD..hAAATDAAHCACAGEA.QCFHhACAPFAHIHFDEAHFCHAD...gABFhABA..hAFA...,1,-7,-20,13
ATDOYQUfbLHPNBCMaIKJcEZgdGeXSRFVW,DCCGQFGFUBFALDAAHDBBBHAC.MAFGKFFB..EEECgABDhAAAdAAEGGAHSHCAhADA.VBGFhAEAAIHG..YFAEfBEANAIA.IHFHhBAA.cFDB.hACA...,2,-34,1,35
YBEGfQLPVSdcTWMbORAUJgFIHKZaNDeXC,JBCCFFDCHBEAZCDG.aAAADFID....XDACBHBAEFAAGDEHhADALFGBSGGDhAEA.dGAFTGECMIBE.hAFAOADAABHGIFHCKCAECEEH.fBCHhAGA..PAHH.hAHA...,2,-34,-10,24
NVDTKOWQZAXedcCJLSHgfUbMRFGaBPYIE,eEBBdFFGJBCFHAED.UEEARFCHGBEFBBCH....IHGGhAAAEHAGDEEGKAADOCAC.QDGGhABAAADFCGGB.SBHBhACA..fEAAMEABaGCD.hADANEIG....WHEGhABA...,1,-5,-46,41
LAHFbKRacGYTBZEMCOgIXSdfJNUPVeWDQ,FDFGKEEDREBDGDCCBADA.ZACA..EAGECDAA..OHCE..XBGChAAASAHHdEHCJCAChABAUFGD...PFAHhAAAeHDCDAFD.AIHC.aBAC....cDEFhACAMADC.....hABA...,1,-27,-33,6
METedKRUNYWXPCHaOJIGZASQDFcbfgVLB,SGBCFBGB..fGECLCDDBFFAEGAF.eAAFKEEEUCBDhAAANCHC..XCEAhAAACFCGOAEHJAEEIACBhABAAIAEDEIF..cCAEgGGB.MAFEhBAA.dDHE...hACA...,2,-35,-17,18
RFdTXGDYQVbNgJUOEZBaKMecASLCfHIWP,SEGELBDCHCEH..IBDFPCABdGGAGDABQFAAhAAAVFED..NIADUAAGhADAZCGBBBAEKAGBeGAEhAEACAHFWDDDFHGEDFIF........YAFFhAGA...hABA...,1,-1,-16,15
ARgdfSNeYDEVWBXPZFHQJaOGcIUTCbMKL,RBDGdGDC.SGAEeHDCEEAGBDGBZCFHHBBD.aGHFOAAH.GFBFhABAIHAFCBHGMFIDhACAABFA..fECFhAAADBBE.WBADPEECJHEA...cCCChADA......hAEA...,2,-21,-13,8
ZeSEXYaFNBWVHAbJLRTUfdKgcPCQIDMGO,LEAEUDGBKFCE...PABEQGAADIAGGCFAeABDEHDEaCCA.hAAABGGEHAGH.AIHARFDDTAEGhAAAdFBA..CGHG.OADHhACASDHHFEAGWDEB...bAGBfBAEhABA..hAEA...,2,-11,-11,0
VLCDFdbaRGMNSXZEAPcUJBTefYKgWOHIQ,UEDGBEBEeCBGKHBC.OCHDQGGD.LACCCHBDdAGGaFABGCEDhAAA.MDCHSFHDhAAAXBDCEFEEAHAH.hABAJHDE..fAGF.WFFEIACFhABA.DDFC.FBDEhAEANBBG...,1,-8,-33,25
dNbeAaVKCcfJLQIYZMPWFREBXgTODSGHU,aEBFVCDG..CABH...JCHFLEDD.QBGGIAFGZBAEhAAAMFFAFEADBGAG.hABAXBACTFFDDGIDhACASBDGUGCHdHFDNIADAHGD.KGEE...fAEHhAAA..hABA...,2,-33,-20,13
VIKfNZHQOWbgeELTUPJYMFGRScaXADCBd,DICEBFAHdADCKBCGZEBCHFDG..QCAHOADA...bDDEEEFEhAAA.LHACUAGCJDHFhAAAFEBA.SHGEhABA.aCBCAGBCCABGICGBfGGE.WFFDhACA.....hACAeFAD.,2,-30,-20,10
TZIfKcSPAOUDLREBVeCFJXHbgMYadWNGQ,DIGCLBCABAAD.VFDCFEHDHDCG..MAGDaHAC.dDDHGBDBhABATEAGZFAA.KHDGSCAFhAAAACAE.OBHDhABA.EHBGCADD.JHFEgDFH.NAED.hACA...fCBChBCA.,2,-29,-12,17
KZFQdCaTHIRGMDUSYeXgVOEWLfJPNBbAc,KGFCZBAHFDFDdDCG..CBAB.aAAAHEAB.GADGDCCGUGGB..SAFChAAAeADE.XEGEhABAOHBAEFCA.LCFChAGAPGCCBAHHAAIH.cDEEIDDAhAHAMICA.....hBDA...,1,-13,-29,16
DZXTEJaISGPeHbgCRcVLfQANYMBOKWFdU,MFDGOEGBFCEHdCBFZEAF..EACG..aBAFSCEEGAFAHFGDhAAACGAGRFBE.LACH.hAAAAEIFBHEDWFEHDDIB.hABAJAFAIAHF..eEAC...hAEA......hAFA...,1,-18,-26,8
ACTdQYVfLUPBJNOgHeGRWEZIFbSXcKDaM,TEBAQFCD..VDGDLCBF.BDEEOFFH.gAEHhAAAGAEFRGFGEACChAAAIACDFDHFSFFChABAcGCG.DFAHACDFCEACfDCBJAHH..hACAeABD..WHAAhAFA...,1,-10,-21,11
PQULFTbZCHMNBSXeaIGWJKRfOcdEDYAVg,VCECQACH.LFEHFHCEZEEACCAGMEDD.BCFBeGBCaFAEGABFhAAAKEHH..OEEAhAAAECCDDEAGAIAG.UGGHbAFAHCAEhABASAGA.IFAB..hABA......hACA...,2,-18,-9,9
FcDeCSGfPJEIBHAYZNTaKdWQUXgOMVbRL,ZAFDaCHH.KHBEdBBHUABB..OFFE.MDDFREBCFFFF.DAFBSHBChAAA.PDADhABAIHHG.ADIF.TCEBhACA.XADBbCAG..eAHFCAGAfGEEhAGABEHG..hAIA...,2,-38,-30,8
dZQRDAGLgKUOWNcEBCXJYPTbfSIHeVFMa,GABCLBHFUGEGOCEF....NAIABAGFCCAHJFHF...TBEAhAAASGBH.hABAeBBGFEDCdDACQGEEhAAAAHIFKDGBEHBEPEAD.IAEA.hADAMDDB.aABADGHB.hAGA...,1,-20,-27,7
dXfLVDZAUJgFWaTPQSKNcHEeOGRbICMBY,JGAEFBGE..aABAQGGD.KADHNEBHHEFB..eCBFOFCAhAAAGDEGRBCC.IDHGhAAABEHDXGBBhAEALAFG.DABCABBCWAFCTDCB.PHCC.hBAA.EHDACCFB....hBGA...,1,-8,-25,17
VUIbPLgaRNZeJWYfAEXBKcSHQTDOMCGFd,ECEDBFCCKDCFSFEE.HCEEDGCFCABDdCAGUAFH..IBDDhAAALFGBRGCAeBFGhABA.JFAFfDGBhAAA.AGEE..XACB..cFGEhACA...TCBEhADAMEBH..,2,-50,-15,35
BHdURMgGEbaceWADSJIKPYfNFVTOLZXQC,SGDDJDGB.KBFE..PBCB..fFAAhAAAFAGGVECF.TABEZADHCHHE.dFFHhABA.MFCDEAACaFADcGEChADA.ACEE.DCIHYEBC.ODDAhAEALEEHBHHH...hAAA...,1,-10,-31,21
YUaGgTOdZPDWNFVfeIBHSLAbRKQMJXCEc,KEEEQGEGMAED.JBCECBBB....EFGGUEABGGAFOBHDZAFCDIDAhAAAFAAC..eDGBBFDBhABASDDCAGAARCAH.hACAXGBGaGGHdCFB.NACH.fDCC.hAHA.IHHD.hADA...,2,-21,-17,4
UTBQFeAcbZCVgSLDfXWINdGJEPHOMaYKR,ZGACCCAE.SCCBDAHB..XCCE..IBFDhAAAdFBCGFEBJGFCEEFAOFCFhAAAaDACKCGGTABDBABFFAFBhABAABCG...bDAGgECALEFEWHFAhADA..NIEHMAFA.hAEA...,2,-22,-19,3
EXQGgcIWZLFVHCMdJPTYaUONKDbRfASBe,BGFFeGBGEABHGAFG...IHDELFGBFCAHHDBE.MBFBhAAAdCCDTEGCaBHBNAEFKADFhABADABA.REAAAHBHXDGAhBAA...........hAAA......hAEA...,2,-35,-5,30
eECDagOZVGMHRfJdcBbILWPYTKNFUQXSA,CBGGDDHD.ODEDZCBBGGEDHFAB.RFCA.dGHEBGABLBBC...hAAAPDACTDECKGCCFACEhABAQAFAAAFG.hACAaAAGMIAC..cGEEIAHE..hBAANAIC...SDDFhBBA.,2,-33,-8,25
JQCfNYaOKUIcHFXVgALBdPRZMbDeEWTGS,dGEGZDDCDFBBeCCF.EGAAGEGE.QCADCCAB..YBEEhAAAaFDBOCHF.IAAAhACAHGFAXABFhAEAAHCDBBEFMFFB.TAGESDFF.hADAJDHH.KGCH...hAEA...,1,-13,-22,9
QcaZeBFADNGbUMIgWSKVfYOXdEJCLHTPR,DBBAGBDGUECGMABA....IEABSAGDKCFG.fBBFhAAAOFFE.EDHDCHBAHADBhAAATFFB.PHBChAFAQAGBaFBEBHHFAHIFgBAGWAHB.hBAAYHEE..hABA...,2,-38,-5,33
EXMNbdIBDVcGHZUWfFaJQOACSgPYTRLeK,CCBBSGGE..PHAERGAELCDCKAFB.MFFE.dCBGBFAHhAAADAFEGEDGUEFHFDCEhABAJACAADHC...YDFGhAAAeACAEFDD.NIEF......IAHEhACA....hADA...,2,-41,-15,26
UXBMfdIcQRFAVTZgLJbPKDCYGaWNOEHSe,TEEAZGBCLCCB.JBABKGGG.CCAEGABH..NDICHBEAhAAAUCGABGDAMFAFdFGGQEAAhAAAAFFB.gCCGhABADEFCaABA.EGADSEDHeAEE..hAEA......hAFA...,1,-11,-24,13
RdVKPZOCHIMGcDBbeNYEWUSQTXLgJAfFa,FFDEaGFG.dDBHKCEEZAGBHCGBGADCBHBE..eFACEDBB..UBADSBAFhAAAQEDGXGGBhABALAEC.AFID.hAAARGAA............hABA......hACA...,1,-20,-25,5
JXKSPONaUgVdRGbAcMBfCWZHITeFYDELQ,MHFACGADZBFCHBAD..eDAEDFDE.EFAFJFHHSABD.OGBChAAAaCEHUGDAdEGGbCFGhACAAAFCBAAC..fAEDhADA.WDDHIDCH.FADB.hAGAQGBG.hAHAKGFHNIEH..,1,-20,-27,7
XBcegPdTILZCQNfVGFHUKAYJbWRaSOMDE,JFBBREEHODBD..DHECBACDeADDdGGBLFFGZAFC..CGAE.QBAHhAAA.VAFGhABAFDGEKAAF.ADAE.bDEAhACASDDD.EGDBcEAG..hAEAPBEHIFDH.hABANIED...,1,-14,-40,26
PJUACgTIeDROLSaFfMVEBZQWcKYdbXNGH,CAFBTEEGDFEF..RFBB.SCDH.FGDCMAADBFAGZBDHQAAEhAAAKCBEdFFC.XBFEhADAGAGAHDAEUGGFABFAhAEAIHHBODCHfHAH..hAFA......hAGA...,2,-29,-20,9
aeZSRACITVMfbUYPOGLNFgWdcXQKHJBED,TCFAVDCC..MFBHUDBE...OHFCLEGHFFEFdAEBQAFDhAAAKAAEBBHEEGCHDGGEhADAaBBG..eHACSCCChABACBCA.IFFBfBECPHDChACA.NEACWCFAcDGD.hADA...,2,-25,-22,3
OLSFCKHgIcbaXfdARYPWZUBNDeGJTVMQE,RCEF..PCBHZFGHBAEHDDFF.eAACGFAH..JEDHVACC.EHFGhAAASDCF.hABAFAGECFGDKBHDHGAGIHABhACAaEAH.dDDEAIEC.YEHHNDIG.MAFGhBAALCBC...hBBA...,1,-15,-16,1
ETZSJVGBQMHNdObXPeLFDAUKCgcaRfWYI,CFDHaBCBRDEC.......fDDAIGHBZCBHSBABhAAAGACDMAHFHBGBdEBGXGAChAAAeACEFHAE.DAFAhABAAHFBKCADgFFC.YFDBEFAE.hABA......hACA...,2,-28,-2,26
MdREBZcHDFPWUAOLJQeTfCbXNKGSIVgYa,LDHDeDEFCHAF.XFBBKCBAGABH..IHHG.VBAHhAAAaCFAdGFA.BBADhAAAHAFCDBGAFEECUEAEAICAJABChAEAfEHGSGAD.gGEDhAFAMAFAEGDD.cCEF..hAGA...,1,-14,-20,6
GJWFAQbUBScYDHRCdZKeMaTLEVXNOIfPg,UDEHBDCCSHCGDAAGHFAF.RFAF.CBBCZAFGKBCE....eDGFaEABLCCFhADAEFDA..hAEANADHOBAF.IHFDhAAAfHFDPEHDJEHBADDD.QGCChAFAcAGE....hAGA...,2,-23,-21,2
WHIGeCDcZUXKEPMAJgQLVaYNFbdRfTSBO,JDCDQCGCLEEDaGHH..FAGDRCAB..SEDBBAEEODHHhAAAHACAGBAGDFAB.UGGDhABAKHBAMEIHACID.YAEChAAA.dCCHfACGWCFD.CGAB.hADAXGDE..hABA...,2,-28,-12,16
DXMWgZHLRQcIBAJENOPFeVSGTUbaYdfKC,EFDGOBEGFDGD...SCBFGACDTGCCUDFD...aCCBfFAGhAAADCAD.MADFhABAgAGHLEDFhACARFAFIGHBBGHEAIECNECCeFGDYAAECAHB.WDDChAFA.....hAEA...,1,-8,-23,15
YFAGKQaUfXSdIOWCceENDMTBPZRVLJgHb,GEDFQEBEUEACSAFFdCDE.OCBGCBABEHBG..DAAEBACDhAAARAFE.LFFHhABAHGECFDHFaEAH.IFHAhADAeACF.MBIB.TGDF.PHAEhAEA.....JDDChAHA...,2,-17,-10,7
EOUNWgKVJDfHdPYQBcXTSbaGIReAZLFCM,LBHDFFAEEFFC.UAEH....gCCDKFCFDCABdGFHQGCAhAAA.XCEAhABASDEAGADDhACAIHAGACIHCHAEMIFCNABA....JCCFfDABhADA..YFDBhAAA,2,-41,-27,14
dPNLORHAYKIUQZSJegTEGMcCFaDfVBWbX,KBCAQECDZEBC.SGAGeDHDEGGGGAEDMFFB..CEAAaBAGhAAADFFFBAAG.XCDAhABAdADCNBGGLEHBhABA.OCAEAEAFICAH.JHAA.cGDChACAfCEA.WHAAhACA..,2,-30,-12,18
SENJCcTILRVDXHFaMWQefAgKBGZOPUYdb,KCGDGFEBOCBEUAFC.dACEEAEA..CDFH...IEACREAEDAIHFHEChAAAaFGE...MEEDhAAAeBDHAHAFBGFG.PECBhABASDHF..NIBHTAGAXBAHhABA......hAEA...,1,-23,-30,7
KdWDYORcaJHMXbBUIVZTEgeFNQCPLfASG,SFAEGADEKABHdGEEDHBE.RGAC...aBGEJCFDHACD..MDABhAAAXFDEBHHGUDBHhABAZDECEGHD.FBAD.QAEGhAAACEHH..fBGDAIACWDFE..hADA......hAFA...,1,-9,-33,24
IDKYXbAFPgZWEQfReJCLcSGTMadUOBHNV,FAAEZFFCEDDAQEFG.RBCE.JHCGLHAESDBFMEBCdACBUAGChAAABEGF.HFACIAEChADAKBHF..bBACAGBGPFHDhBGA.fHEFCHAAcAEDaHFEODFAhBIA.....hAAA...,1,-2,-24,22
EQgIaXdLYHCVTKUZAGDRWeNBcFJMfbPOS,GAABDFFARABA.eEDFBCHHJEGD..MBGF..PAFFEEDFQGGGhAAAaDCB.LAFChABACHHFKGEBAHCF..NAIA.FHCEhACA.fCDASDADgEAChAEAIHAC......hBAA...,1,-21,-27,6
CRQNgXbUIHGVfOdFScDAeLaWZJPTBYMEK,LHFAaGCHZFFG.JAEFBBGC..EBCBRCBCQDFF..hAAANFEBXCGFUACBIHAAhABAHDAFGGADhAAA.fGGHOEEBSAGEADIBWEDC.hABAPHFEMGDACACB..hAFA...,1,-15,-20,5
FdHEPTbIVMJcYAaCQOBWSNKfgXRUDeLGZ,aFGGCDGABCDB..SHGEKDDD..XFEARFCGeAGBZBBDFAFF.hAAAdDDHHCAHEAED...hAAATABCIFAGMHBAhABAJHACACIB.OBAB..NIED....fAHChADADAIB..hAEA...,1,-9,-40,31
KJLQfbNaABEPGZTHUdegYOScRFWVIMDCX,BEEGEAFFZBBBUCAE.dABHeFAH.OEGDRECBFFGC...VGDCMAGFhAAACDFA..KDDBLHEEhACA.QFAGhAEANAADABBH...PCHDHAGF.....hAFASHAA.hAIAICDBDIGA,2,-23,-19,4
gLbdKNRZVATEHUfPSXeIDcCWOaMBJYFGQ,TGAGHBCFUFDH.SBAHXEGGDEAGCGHG...aCAAMFAHhAAABAFCJCFEGEDA.hABAgBFAdEEBNECGZAEEAGGHhACAEAAA.fADC.IDHGhAAAWHEG.FHGC....hADA...,2,-17,-14,3
IMCFKYRVGAaQJfELeUSPgBWXOZTDdcbHN,JDFDLCHD.eAFBSAADBEDBOFCBDGBB..dGGEHBCChAAAMDCCCHABKGGA.RFEFAADHQDAHhABA.fGCFhACAUBACgEAFWHCA..TAGFhADA.NBBD..YEHHhAEA.,2,-44,-12,32
ANGEOBKaTJeMZIdbYDUCQgVWXfFHRcLPS,GGBDBAEEaEHBJDEAZCCE..dHGBDGBFUEAA..CBDF.QACDhAAA..gECChAAA.VFEBfFFFhABAFBBBRAGH.LAHBAGDBEDAD.TAFChACAIHHHYCDF.hABA...,1,-15,-31,16
gUXefZFTPdANaDQVSOYMKHRIGJcLECbBW,DCEEQABHOHAC.KGHDRDFG.GEDBLDCDCDDGBHBEUGFF..XAGChAAAeADAFDADdDAHAAAG.hACAaDGE...SFCGhABAMDEHIAHEJHDG..EFAH...hADA..WAFDfBBBhAEA.,2,-32,-9,23
LAVCEeTUWOGQfYJDdMHFXNKIPbcBZSaRg,CFBCeFDAUBEAODHF.GAAFQAAAJFAG.DGGDHBEE.FHAEhAAAXEGEKGHD..hAAAIDDHPHCEBAGEhADASAFERDBEABDFECHFfHDBMEFH.cDABhABAaFAH....hADA...,1,-18,-19,1
PZLVNGDdgWYMBKfSEbIaROecUJFHCAXTQ,TADHQBCH.LHDCVCFA.DBBBdCBF....gBFGhAAAMCADKGHHSEEDhAAAEEABaHAGRDEH.eHAChABAcDGD...FAGGAAHFZFAEWABEBGFAIHHGhAFAOFFA...hBAA...,1,-12,-19,7
AFgSdCTEGMZHLNQabWYXRDcfePIJUVOKB,FFABSACBdDGC.EAFAMIBE.ZBEDHEFHLCBCQGCFhAAA.aDDD..WBHHhAAAXBBD.DIGEfGCFhABAPFAFICFDUGGDKACAAIEACECC.NBAC.hABAYEAC..hACA...,2,-34,-1,33
ETLVYScRZeJNKMAdQFHgIfODBWUbPCaXG,dAECQDEBFCBCHCFE..IFGEOFFFDAGABHCFUGBHCACEaAHD.hAAA.EDABLCCChAAA.SAFAhABARDCC.JFAFMEHBAIFAWHEC..XABAhABATEBH......hACA...,2,-22,-17,5
OTSQecFRKgDPLWCJXaVUGYIZfNBEAdHMb,MFBDOEBD..QCFEeHFCFEFBKBCEDGGELFCC.CAHB.hAAAJBHDaCCEVBAB.UAEGhAAA..YADEhABAIFDEfHDH.BBBEAAHEdHBH.hACA......hBAA...,2,-32,-25,7
aCOQIWJdKSGLDbTZXRcBPHYMVFgNAefEU,EHFAUBBE.ODGHQDGD.JADEdFDDKEEHSGBGGBBGDGGAhAAAZBEERFCB.BAHBHBFAMEIDhAAAFHAAAABG..aACACDAG.hADALHEE........hABA......hAFA...,1,-6,-31,25
UbOWGgAcfDKPNIeJHQdLCZETYBFXVRSMa,DIDAKGAE....ICEDeEHDHCAH.dGBHCEHHZGFETAEEBAFBFAAChACARCFH.MCGD.UCCGhADAOCBD..gFEEhAEAADAD.PAHFNDDCJAAHEEEB...hAGA......hAHAYAHH.,1,0,-38,38
cBAGTQMNCRIEHeKVWOPLUgXdbZYfFDSaJ,QGCBMGCERCFF.EEADHBCB.KGHBOADALHCAUBACdAGBZAGBhAAAFBADaCEF.BFGFABFBTEAEhAAACEDA..IGHGhABAeDHH..WABEXDGE.fCCDhACASGGD..hAFA...,1,-14,-18,4
AJXKBPGLeCRMYDbTWEdHZOaIFgcNUfVSQ,JFAFKGFBGAGGLFCFeABC..MEFADEEG...TBDCEBDGdFBEhAAAHGFCZEFGaFDBFCBFNACD.hABA..UBFCfCCEhAFASFFCAGAFBHHCCAAG......hAGA......hAIA...,1,-13,-18,5
OdKDRTEWUBASMYeLPfNJIZVaGCFcXQbgH,SBABeECFLAAC....NIEFZFBBaBFFCHHFFDEFQEFEhAEA.HCCCOBGBhAAADCBHEAHBBEBFAIACMFEBhAFAfFGHIHFEVACF.XAEF.hAGAdBHA.....hAIA...,2,-20,-13,7
XQeVUcCFHTPMEGDAYdZRfaWONKLJBgbSI,dDBHRGBC.aADGOBDF.KBBBJEEBBFGG..SBFAQCFAhAAAeGFAUDBFFFBC.HBAGhAAAMDADDICAAIGA.fGAGhABALFEHIAHEXDFFCAFA.EDHF.hABA......hACA...,1,-11,-32,21
cPgGBNULfFdOMEKWTSbIJCAZaDHRQVeXY,ZECDaDFDHBAHQBECeDCE...XFFAPAEG.BAGHLECBhAAAFACGOAHDEGHBWHEGhABASFEC.IFADhAAAACFGDBHB.YHEA...cBAChABANAIEfADEhACAKCCE...,1,-12,-18,6
JNKAUfPETIDFYVgeHQRXZbCSMGWaLcdBO,UDEAEBCHDFDAFDBG....VGAAHGACRAFE.XABEZFEE.CHFDGAEHhAAALCAB.dDGHBEHHhABAOAAAKGHDAGECfGHChAEA.ICEDeFAC..SCAChACAaHDE...hAFA...,1,-18,-22,4
TURQLJGZaOYXCKAdPNHBbEVeSFfDcIWgM,dDADHAFDBDGDVDDCFFDHDIEG.....ICHCMBDAUFGBQABChAAALFADJEHFaCFGhAAAODAH.CHADAGFBNEFE.hABA..EEBGeABFfGGG..WBHBhADA.....hADA...,2,-30,-21,9
FgacQPZMNRUEKHIXJebVYWGLTSDOCBfdA,FDGDaABC.QGBCZEBCRDEB.KECGHGBA.JFHHVBEFGAFA.LDAEhAAADDBBCHACBAGDAIFC.hACA....gAAFhAAAMBIB.EADH.XGGF.eFFDhADA....WFADhADA.SBCA,2,-30,-8,22
ODZIEGWaNKgHSbeMLBUTfQdFRVPcJYCAX,OCFHZACCEEGCGECC..NHEFHABDSAAFMAAHBEBHUFACQGGBhADAdBGDFDHHRGAA.hABAPAGHJDDF.ACEDICCHhAEAKAEE.eEEBfDAC..hADA......hAHA...,2,-20,2,22
FKXVGgPLHZBUEDCOSINAcMTQdbRaJWfeY,MFAAdGEGaBBC..JBCCeAEC..FGCHVGFAGBGA.LAAHhACAZCECEDBGDIBCOEEBSACChAAAABIFQGFHhADA..WCHHKGAFXCCG..gAGAhABAPAEA.BEEEhBAA.IFCE,2,-21,-11,10
TgWKHJMZcCQABOLSeXFRUPNEbafDVIdGY,LGAAXCFEFFAGRBAFUAEF..ECCAaDEADGEB..dFFAGAABhAAA.TGFBKABEMCDBhAAACDAGBEEHOEHFeFCF.hAFANBIC....fFGBYDBB..WHEGhAHA.....hABA...,2,-23,-22,1
AcRBWVPGaUKeMFEYDONXSZHLbITJdCfgQ,BGFBVAFD.aAAH..UEBDeEDGFCAB..DBDAOFEH..NDACZBFEhABALDHD.ICDBhAAAdHDDCHBCQDGBhACAAIHC.RCBC.PABCMGBEEHGASHAAhABA.....hADA...,1,-19,-27,8
BDMcGKHINJRObdgCTXAeQaSLWYfUEZFPV,eDBCSFBBLFDB....YDBGfCFH.EGBFhAAAPEFGBBAGcAGFhABAKAHBHBDC.IABDhAAARADAdGGAgDGHCHGGAGGAQGDB.aEAHWDAFhACA.ZEEFDADCMFIBhADA...,1,-6,-12,6
bKOYGQcBfDedaPJWCELXNZSMAgFIVUHTR,FCEAVEEDHEFG.RFBAKEAEOBCE.GDBEBHBGDIEGdAFF..JEHBCAGFLADDhAAAZBAB.AFAB.hABAIDDF.UBGFhAAA..YABBfHDB..PGEChAFA.EAHHSABEhAEA,2,-36,-13,23
GBIfHQJDCYcNUbOdVFRSXeAZWLTPKaMgE,LBBHTEFG.aEGFMCIBGDDGBECEHGACDBCH.CBFD...NHCF.UGGHhAAA.dADCRAFESDDEhAAAAAFAZAGBKBAF.ECAH.hABAQFAC.cACF...hACA......hBEA...,1,-11,-21,10
MdTcOaVIQDWXFPABfJYLESNUGbeRCHZKg,BFGDJECELBBBEDABUECBGAEB.RGDE.CFADKCBC..dFFHOHDGhAAAaDGA..QFAGhAAADDEEFBHB.AADFSHAAhABAeACG.........hABA......hAEA...,2,-47,-16,31
UAaQEHOKYbFRDZBJGWgVCfTSIePMXNdLc,QACEECBEHCEAOAECKFBGFDEHZECC.BBHHJCAH.GEAE.VEGDhAAACGFFSAFChAAA.eEHFPABAMBHDhABAXGCH..NIDH.....cGEHhAGAACIH..aDFF.hAHA...,2,-26,-8,18
XKVGBLJIDWTHZcdESUFObYRfPCMaAgQNe,QGAGeCDAKEBGBAGDLAHF.IHGFDIECHACE.ZGEAdDBEhAAAEEEBUDDDFCAEOBHFhAAARABCfEGG.MBADhABAAABAXFACJGCCcBEGSDGF.hACAPHAE.aGGANEIA.hAEA...,1,-9,-11,2
KfNZUaWHEdACgOMLRXFSbDGeJIQVYBTPc,OAEGRBCCFFAC.DFDFGDAD..JHEGVFEFBADD....TDFChAAAKDDHZFFA.aACHEHCGhABA.CACF.LCFGhAAA.SAGAIHAH...PBABhABAfHGHNECA...hBBA...,2,-37,-24,13
RDCNMHaSgOXGFecVETULdJPZIBAfYWQKb,...fCGEQFAEKCDERFDEDGID.CDFFHAAHaFHBOFABFAFGeADFhAAAVBAH..EHCCTFDHhAAAUCGA.dAEBZDACAABEbFBHhADAMFFG..SGGD...hACAXDDG..hAHA...,1,-1,-16,15
KJFgQLfdeIYSDUEGTXcZRbaNCOHVBPWAM,KFHDFDAHLACEeDCC...SEDADFEFEACFGAEF.XGEDhAAAcBGEZEBDaCAB.hABACEHCHBBGBDHHAHAEgGEHhAAAdFAB.IAGEYHAG...hABA......hAIA...,1,-19,-24,5
cQdRTNgFDKYBSZMAOfCPHXEVJGaLeWIUb,OBEHCDGBHBBB..EFDBJAGDLBAF.eFFDIHGC.UBAAhAAAQAGHdFFFRGAA.hABATGAHFEAHKGEFYDHBhAAABDCA.SCFDADID..XACFhAFAaFAG....hAGA...,2,-31,0,31
DXPFJUdbKRYaGZHTeVSgBCILQfENOWAMc,MBAEXAAHFEBD.dFEAREGH.GBFGZFDH.HFBHeAEF..SDAFhAAABDEACHBF.QGGBhACAECAH.WBEDAAHDDACGhAAAPAHD.........hABA......hAGA...,2,-40,1,41
DYbgBQSeIZGaMTROXVCPEFKNUWAcHdLfJ,dBDFLAHFDHFC...bEDCBGBG.eDHHIHGAGBAEaCBCRCFH.hAAA.OECCCFHH.EHCAhABAKAED.UGAHAACA.fGEAhAAAJAFA.QABBMEAF.TCEGhACA....hAFA...,2,-23,-23,0
TIfDeFKQYAWVSgdHLcCNGURBOZMEabJXP,VCACdFBCHDCG.CFHBGAEFBGAAZFFC.MBFEEAAA....JGEEXCGAhAAA.TFCBhABADDGGKFCB.ADBBSEGChAAAgDEENACFOADH.aHACIHFAhAHA...eBBEhAIA...,2,-26,-18,8
MQZNJXWHTLKVdIAaUcYgGFDRBPebOESfC,UEBD..gFBGFCGGDAEEBHEDeAAF.ECDF.CBCA.QFGBhAAAJFFEHAFGKDFCdBBCAAHFaHEEhAAA....GCEEhABA.bADGSAECMIAG.XCAHhACA.WEED..hADA...,2,-27,-17,10
LZJQGYSEFgbMdIKcWHaAfNDOeBPUTXVRC,DDGGBGFCUFFD..TDDCRCCFLEAHZCBHQACBGADD.EDHBhAAAFABB..MGBEdGCF.hAAAIGHE.KDABhABAWEECHAFEADAEOHCCeHAC.....hADA......hAFA...,2,-27,-13,14
NIFYQOfHEZTAdVMUGaDbRXPeSLKBWCJcg,MBFBUEFHDIDERBAF..eCHDKBAGBGDD..CAHHJEBB....hAAANAIE.FGEC.OACAhABAEDBFZAFFAEDA...dHABaGDHhAGA..XBDCSFFELDAD.hAHA.cGGDIHHDhAAA...,1,-25,-43,18
VbRYcSMPUKFAWTgJCQXZNaEOfIdBHDGeL,TFDHCEBGZGAA..EGHHOBBB..dFECBHGEGCBDeBGFLBCEhAAARGAASBFFMACEKBGDhABAADCCJFFA..QDGDhAGAaADF.fFGCDAFE...hAAA......hABA...,2,-30,-14,16
QcZdLWgREJXBIVAbMHTPNGOaeFSKYUDfC,HDFCTGDDGAAC.OCDCeCAFSFBEKHAGDGIH.QCDAhAAAdFCDLBFCWBHBhABARFFFEADFBHFHAHHHMAFChAAANCHEFACB..UGACCHCE........hAEA......hAFA...,1,-4,-18,14
cXgTGKWOLCJVFIYfdSaBbAEUZPeDNRQMH,EBBFZAEGDDIDRFDD.HFFC..XCFHTDDBKBBFLAHF.CFBDFADFhAAAIACFdFGDBDCBhABAAICEeFAFMCAD..gCFBhAAA..OHFCJFDF...hABAfCECaEAG.hAEAbGAG..,1,-14,-19,5
gAVGCfTbPQZDBHLRKSEOaXMeFYUdcJIWN,CFDATEGH..QDDHBCEHRAAH.SFADEDFH.OBCGhAAAMCDHFFBBdHFFJBGBNIDH.hAAAADIH.GAED.fCHGhACAZCAFDAECKFGCaDACXGBDeEED..hABA......hACA...,2,-29,-5,24
JQEVHfcMICLZeaDPOWXYTSGbBFKRNAUdg,dAFAQEDGEAABHCDHMICECFHD.ZAEDDHCGODBH..XEAEhABATCGEGBADFACBNAIA.hAEAAHHDJGEE..fGEBhAHAIAAGeHACWHBG....YDGDhBEABADBKAHH...hBFA...,2,-27,0,27
EZPfSIFedWVQYDCJKaUGNgMHATObXRLcB,OEFGRFDCBACAZCFE..SEDFeEBGdAEE.VBAADGIH..KCADaGCEhAAA.UBFH.GEAEhABAMIAEABBB..XFGEhACAEAGB.IHFDFCCC.WAECCHFH..hADA......hAIA...,1,-19,-35,16
YGNBPETWcFdKbLDXfgZHMaSROJVQIUACe,CEHEeCCGGBACBACH.EGFF..TACGFFBDdBEHKFFDLFAFDAHH.hAAA.XECDZDFGMEEDhAAASCEGJBAH.hABAIAFBADGG...NIBB.cFGAfEFBhABA.aEAH..hACA..OAEG,2,-32,-13,19
PfFAMaERHVeSWbIBXdQUKZJTGLYcNDOCg,EAEGVADG..SCHH..ICACXEDCUEGHKBCAJCFHhAAALHEE.NDCA.hAAACAHCfGHEhABAAFEF.aEBHeDDABHFEdBHEQCAD.hABAZGAA.....hACA.YHAA.,1,-10,-23,13
JdLaEQgWADfSMVOXUNFYZPKGBCITHebcR,SECHMEDH.OFFDXEAE.FAGHZFABGBAFCDBEHAGDeEFHhAAARBEDdACEaBEFEAAB..hABAgDDBDFIF.hAEAfHGHNEEG.PHAEBHHD.IDADhABA....hACA...,1,-11,-19,8
fPLBXgGSUAFOKaHMEeCJIbRZQVNcWdDTY,KFAEHCGDMABACBCE..JEBGRBECZBCD..VBAB....NICDdEHChAAADIEA..TGAC.hAFA.fCBAhAGABAGAXFEFSGEEAEADaGHHEGCGIHAE.hAAA..cEDGWABE.hAFA...,1,-29,-32,3
LeNXHVUITKaJDBbWGSYACEOdfPMgcFZQR,CACHODEDdAGG..MAEDFBGEZDAA.LBAEeEFEHFFDUGGCKCADDEGAhAAABGDDGGBHAFDAEDCH.hABA...fAFAhACAPFBB..gAADcFAB.NAIG..hADA.XCCEIHHFhACA.aHDE.,2,-30,-10,20
XBOZcAgMQeRNEVGTWDLHdfUSIFCPKJbaY,MBHFQGDBRFAC.EAGFGGCB.TDCCDHGALDAD.hAAAHDFGfACAhABASABACCAEKBFBbCCDYFGHhACABEBCcGAD.ACCB.NAIA..dBEG.IEAFhAEA...hAAA...,1,-3,-19,16
EaRQGLAOTeXHfFYVZdBcMNUPJSCWgKDIb,TAACHFEEFEAC.ZDDEdGBGBHBEMDDDUBBA..SFGHhAAACCAC.KCFADGIFEDAEQAGEhAAAAEFDeAFE..XCDBhACAfGCDcGEB.NDIA...WABEhAFA.ICEFhAGA.aHFE.,1,-10,-37,27
JYFHMaEbcCLfZQgBIKSTUGeVXdAOWPRND,OBAFRCCCDFBF.FEFDMFEH..EFBD.CHCH.ZDGBBECCKAGHUADF.hAAAGAAGeFDBdAEAAGFF.hAAA..NDDF..JHFEaGCDhACA..LBHH..fGHAhAEAIFHDSGADhABA..,1,-21,-36,15
UBVSfFdeCALGWXZJOYgDTbHIQPNRcEMaK,LEADGEFAZCAGJGDGOAHF..DACHHEBEQBDARBEFMHCGaGADhAAABHGF..SABBhADAFAAHCDGGAIHE..XGBFhABA..gDGBIEEANBIAKAFEhAEA..UDBE..hADA...,2,-34,1,35
ICAQUENfVaSFZBegTOWYRDMXLcHGbKJdP,QGEHEBGF..VEDEaBFCZDBFBHAHeBAAOACHRDDF.MBADhAAALFABHFACKEHDPDHFhAAAAAFHUGGD.SDDChABAFAGE..gGGBWAHB.DAEAhABA......hACA...,1,-10,-14,4
GcNLUJESebRgQHFITOMWaXAPVDZdCYfKB,DDBHCCEDKGAFGCFE.LADDJAEC.eGBERDBGHEGFFABH..OAHBhAAAaFCE..ACCCZFEDfHGHhACABDAC.NCIC.SACGhAAA.QCFG.MCIFhABAWECG.PAEFhAGA...,2,-28,-24,4
ZbXOdafATVDYSLNUBHWEIFMCGPeKRJcgQ,DEDDLFFDBDACHEEFECDHFBGAGABH.KBGHJCBB..QGADhAAAXACF.dGHGAHEB.TCDHhABASGGC.hACANEED.WAFE.MIDGCFCBeGAE.RAEBcBAGhAAA..gEAChAEA.,2,-18,-16,2
LKTXBaESURVeZYWIHJNPcAQGOfFMDgbdC,QABCGCADOGBCFEBBDCIHdGFBLAGH.KABDTEGDhAAABFAAEEEGSDEEhADA.RGBEZBDEIFDGhAAAHFEDNEAA.AEEF.MEIDCGHH.aHEE.eAEB..hACA......hADA...,1,-6,-16,10
MXZTWfRdENOUYGIBQaKecSPLJbVDFCAHg,MBAETBGDRFAE..dFDAEECG..OBEHUBBGGGDFBFGD.KEAHSCCFhAAALAEFJEEAhAAADAEGAAHCXGAC.hABA.WCFENEIC.IDAHaCAB...PHEChACA....hADA...,2,-41,-4,37
GOLfcNgHCIJYQSBTDRPbaMeXUWEVKZAdF,FEEAGCECOCAELCDD...fAACgAGGCAFEJEHHhAAAQAAF.BCFEhABADHDAbEADeFBHXCGAhACAEHGAVFDFADBCcGGCIFAC.SBEFhADA....hAEA...,2,-22,-14,8
RbSMaGdUcDXNJWQeTEBKVPfOAYFLHZICg,FBEFLCADZEEA.CCCCRCGHMGBC.GGDD.UCAHDECEXAGAhAAA.JHAGeDFCEGGC.hABABAAA.PAFGhAAAOGCAAHCF.HBEB...bABASBCBhACA.....hACA...,1,-20,-22,2
ACfEOeBVDTIRSJWGMKgYNQULZHbXcFdaP,EAACBFFGDFGCRBCC....SFAHJGACGCBFKHDC....gECGhAAANAIC.LBFBhADAHDBHXDGHhAAAcGGF.aHGE.ADGBCEDAeHEGIAFBYAHHhAEA......hAFA...,1,-24,-29,5
KgPFCLUSNGdHaXZDRbJQVBcIMWfAYTeEO,TBFCOBBFKACE..FECDLFDCUABDGEGCHGDGaFBFDEBFRFEBJBHDhAAABHDC..MIAChABAAHABeDDGEDDC..CGABSAFEhAIAdCAH.XBEA...hAAA......hACA...,2,-24,-8,16
JWHCdZEVXcATIQefYKRDOSgLGFUBMabPN,QEADeBFAKGFHDCCBSCBA.LDFDFAADMAEDaHDG.hAAA...NADAHFBEhACAdAEDEHAG.cAABADIDIDFAhAFAfCHG..OEHB..hAGAgEGEBHAC.hAHA...,1,-11,-31,20
fEBPJGCgKdXTAaFONWYcQebDSMIVZLHRU,FCGAOECA....NBBB.......WFAFQFCFhAAADCAFSGEBVGEGZCEFhABAHABB.RDFHEBEBBAHEhACAJHBACEAEgCCDdHGF.AHIHaGAH..hADA..cCGA.hAEA.eHBG.,1,-12,-24,12
FRDecBTfZEKJQOVbWHYLdCPIgXMNaUSAG,GAEBRFAAeADHBEECZCAHJBBA..OGCE..bEGFHBFB.dAHEhAAAIGDGXDABMFAHhAAAaGGEAEIBDFFD.TCEGhABAEFFGKACF..WHCGCAFCNIDF...FDDH..hACA......hADA...,2,-21,-5,16
HbWcAdQCeMZKYGSUOBTJfaVgNIFEDXRPL,dDCBeECGMFDCKEAFGGEBUACD.BAHH..JGCEaABA..VAGHhAAA..IBEGhAAADEIBRFAF.HDGF.cBBFhAEACBAHSGHDOHCCgGAH.hABAECFCLAFFAGEA.hAFAYDAD.,2,-25,-1,24
EdbRGgCNKLJaeIPHQXDYVSZMWcBfUAFOT,FEDDODDBdBFCRCGHGBAE.CFHA.KGHFLCFC.eGEGPAAAhAEAXAECDICA.SHAChAAA.MEFEhABABEBHAIBC.TBCHEAGG.gGAAaACHIHDHhADAHFEB...YAFChBAA,2,-28,-15,13
VQZDYdPINKEJHMUWaeGfCTBXORSgLFbAc,VGBGZABDDAFC.dDDH....PAGDKEHHEGEEMCAH..aHCAeCBBhAAA.CDFABEDDRADDLDGFhAAAFGFFAGAB....hABAQABAIBGFNFBDJBED...HEGDhABA......hAEA...,1,-14,-30,16
EaVYAeSfgRbZOIdHGFKCXcTBNQWJDPLMU,eECCSDFCREFGZABF.dDBFFHDAKAFF..CBHG...XAADBGAEQAEFhAAAJADFLFHFhAAAMGCAEEED..aDABAHBGfAGDhACA.gGCBIHHH.hADAcEADWCEGDGGF.hAEA...,1,-24,-30,6
JFNADOQdKGSVeTcgbYEIMUZLXCWBHafPR,DGGCQCCAdCCBGAEDSBEB.eAGBTEAH..gFAGhAAAEAACMFEHUDGDhAAAZEDGLHAGCDACBCHCaHFChADAfACF.PEHFFFCDAHAAKDEBbCAFYHEEhABA..hACA...,2,-11,-11,0
UYcCHPbZFBfATEMWISVDRXGdOaQKLJNeg,MFBDSEBFDAEBGBCGOHEA..aAFDKBAH.LDFF.hAAAJGBGgEEGhABAUAGECADC.bGEGZCDBBHCFAIDCECCDhAAAIDGG.XCAF.NAIA..hABA......hACA...,1,-15,-26,11
GRBCgMXWTHEPDFVcfQUIeAZdYObJSaNKL,dCGBOGDASGFGKEDALAFDGBADRBCD.CBFF...MBBD..hAAA.XCGDTDABPFABhAAADEAHFGBD.fEGFhABAIHHEAADE..bEDFaBGABADG.WHDGhACA..EEBH..hABA...,1,-13,-26,13
cGbfMOUYJeFaEZKWIQTPCLdRNXAVgHSBD,HAAFSABGDGGEGDAFMFGB.UGCE.eFABEAECKDCF.IGCHhAAATBFDLEFChAAA.dADGNIAHAFHEBHHEhACAfFDBOAHFFHFCWCCE.CAHH..XBGChACA...cDDAhADA.,1,5,-44,49
CATDbEKJUgdHaWMLZcRGQNXfSFVIYeOPB,TDAHEGADUCEH.HAEEaADB.LFGHZFDHGDGAQBAF.hAAAXDAGFGBGIDEHhABAeFEFBDHADCIBKAFHdDCAhAAAMFAB...cBBH.fFFEhACA...SHBAhAFA,1,-5,-14,9
FTMXBJZUgYDeESdGORQCcPVWbAHaKLINf,aCDHKHAGLCDG..fAAGFECFMDIFBEACJGFCZFDFUGFChAAADCHD..EADAdADHRGACCCBH.hABA...PEEGhACAVBEFABGEHAGD.IBBCNCIE..XDAChABA....hACAeGAE.,1,-11,-22,11
ZgGaIWXSTdbDNFKUYBQLPAfMJEOcReHVC,JCDAEACERCEDHDAD.ZGFCGBBE..IBABSBGE.TGFEhAAAdGCFDIBAFHAAKAGEBGDChABALEEAAIHEOCGFhAEAeADECAFCaEHD......WDHH.hAHA......hAIA...,2,-24,-15,9
FDcHKWBUdZATXIbRCPgOeSGaELQNfYMJV,TCCAXFDB.RABF.CFFG...ODDAeBEGSHBAEAHD.hAAALCBDQGGChABANEHGMACEJEBBFBDE.DEIHhADAKGEFBAFBdEEFABAE.PGAGaDGDYHCAhAEA......hAIA...,1,-13,-15,2
URaSNVMHBdEWKIDYZeOFTPbLgJfcCXAGQ,UBAERBAD..aCEDVFFGHGBA.dADFKEDADAGGZGCCFFFE.....hAAATECELBFAJHEE.hAAACHBDAAHF.QCCChABAMBIBBBGDEFAA.IDGG...OACGhAGA....hAIA...,2,-24,-22,2
bDGgVeYPQfTFKdNACZEOScLWHaRUMIJXB,CBEAOBDBLADCHEBAREFD.UDGG..MDDBJFFFBAAEDBBD.GAEHhACAeHFA..QGCFhAAAFHCAKFAD.AABGSBGHhAHAaDAG.IEBC....hAIA......hBAA...,2,-33,-24,9
DRLUbacMTPVEIeYXFQdHSGZACBfONgWKJ,CHHHBCDB.OGCG..gEBHJCCHLADGaGCD..MEEChAAA..VBGBEBDDeBFGhABAXGFDdDAGSEGAhACAAIBE.fGGFKEFADABFbEADcBBHhADAPFHFIHAHhAEA.FAGA.,2,-26,-26,0
eIRKLMHUTdZYOWGBPNgDSAaJfXEFcQVbC,JADEXEFA.FAAFQEFB.CHGF.IAHBKDAG.HAEDhACAUFCBTDBDdCDFOAHHhAAABEDHPGCEhADA.DDIDABGHfBADEBDDcGAH....hABA......hACA...,2,-42,-10,32
FUJeNRSZAHbBIOETLWCPVcKDYdMGgaXfQ,BFFBOBABLGAA.CECB.VFCGKCAD.dBDHGCDHaFHD.QABDhAAAFFAHeCBH.SFAEhABAAGGDHDEAECHBTGEHhADAPAAG..DBEEMIBEfHGF.hAEANBIC......hAFA...,2,-17,-12,5
XFfQEgbTdMGJOeCDURBScWZPILVYKANaH,aAGFXAAB.FDFEQDEA.ECACbDBHdFBFGACD.hAAAOFFECDHDDBIHBDCBhABASCHBZGCCIAEAhACAYHAEAGHF.HDDF.fDAGMIAC.hADA.eBBE...hADA...,1,-14,-18,4
EfJcYVOFHLMaGgXIUebWDAKRTQPCNdBZS,TFBBCGGGBBBDZGCA..EFFB..JAFFVBEC.HCABMADHaHGEGEBBhAAA..IDHFhAAAeEADDIBCKDDH.QABFhACAdEGBSBED..fHADhAEAYAHD.FAGAgCAGhABA,1,-15,-28,13
CKGSHUVgEDPdIANFfaBcLQeJbTOWMRXYZ,FFDGaCACBBBCQBCH..JFACOFGFRDED.ZDAHKEGC.GGCBhAAASAFDHAGHUGGAhABAEAGBDDIHdCEBADDFNHAB.LABChAAA.eHDAbDAE.MEEE..CGAD.hACA......hADA...,1,-5,-13,8
XeLCNTAGRKEFQVYHSPcBIagZJWdUMbDfO,KEEEFEFDQAGBHAGBSEBDBACG..aHEAZFCD.JBBCUEACDDDA.hAAAOCHF.LCDBhAAACGHEAAFHEGGB...YABFhADAIHEEdHAFMEABfCFC.hABA.eDAE...hAEA...,1,-19,-23,4
gWGZILYaKOTFbUHDRfPXEceBMANJCVQSd,JFBDQADH.SEEHdDFGGADGLECDKDBAODHDFCAHHCDAhAAADHDA.RDGDXAGChABAEAGEBBAF.MIAECHGH.hAAAgGGA.IBBHaDAH..hACA......hADA...,2,-39,-3,36
fcLYJZXdWOHCAMeESPRIbgNTGKBaUDVQF,EADGSHCGRFEG....bDCCNCGAGACGBHEGDGDBFCAD.LBFEhAAAJAHDZBAE.dEHCOFABhAAACEECeFAC..IABChAFAgFDA.aBAG......hABA......hACA...,2,-28,-15,13
NLbgDAdKJQSIcRPUaBEfXFGCOHZTeVWMY,KHEESGCERBCB.UCDHaBHHBADE..fGABFBAHGCEAhAAACCAEHADEZFAD.eAHDhAAAMEIBLGFCDGCFAGDG.hABAdDAD.JEFE.IABFEAFC..XGGDhACA....hAFA...,2,-27,-7,20
TcBSNGVKMaHfUDXQLeCgPYAOJWbRdIZFE,JCAHRCDDdAHEZBBFFGBE....EFGEBAADGGCHMEHBHCFC.DAFHLCADhABACBGF...hAAAPHDEOABA.WECAhAGATDBB.NBGC.aHAC....fFFEhACA...hAHA...,1,-25,-29,4
eKfGBcSIFEPQgDVdLNOaYbCTXJRWAZHUM,UEAAeHFAGAGABDHH.SBCEEBAF.QDDDDEDEdCDHOFFFhAAAaABBCFHB..TEADhAAAJABC.ADIDHFDEMFHHKAFGhAEAICCE.FGAHPHAG...hADAgGDB.hAEA...,2,-32,-1,31
fNGbOgDaWHScKIZUMdXeCRVLYJPTABEQF,QFGDFAGDGFEHODBEaCEB..SADCKBACUGAEdDFBeAHDhAAA.CGAGLBABhABA.JDCBACCHBEAGEDGGNEFEDACFhAGAHADH.IHHBMIAAXGCA.hAAA......hABA...,1,3,-30,33
gBPVbfGHMTFdSOUNQIARDaZXJeYCLEcKW,DCBCXCADeEBHLDAEKCGB.BGGGVACHGBEDHFADFEEGSABChAAAUGGH.QFDHhAEAIAFBACFAaEHFJFDHhAAAEAGG....WAHB.....hAFA......hAIA...,2,-22,-17,5
DRbQgfEXcWAUFYSPdZCTMBaKIVOHNeLJG,FFAFSDFFdBCDZGDC.MCCCBBAF..aCBHKEEE..OAHBHCAAeCEChAAAJGBEGEFGDGGE.hABA..bADE.fABFhAAAEAEEXCGAAIHAYEHHCHHH.IDDGhABANIAD.LFAFhAEA..,2,-29,4,33
SgBFTQDaREdNbGYMOXJHKWfIeCVUcLAPZ,ZEBEBHHEQGEDaGAG.RACH.dFEGGAGCMAEA.JAAFKBEG...hABA.fGAGhACACCHGUABEAGGG.SFFEhAEAFHBCDEDF.ECEE.NDIE.OEEA...XDBBhAAAIAFG...hAIA...,1,-1,-43,42
eJKRNGdDEIACLfXFcSMBPYUVWOTQbHagZ,CBAAXBDGFDAD..MHCEBDFD.UCAAOFFGQGDF.hAAAaCGEeEBH.KCDGNAABGEGEhAFADGDCAEEALAGHhABAfAHASADGYFBD...TEDHhAGA....hAHA...,2,-37,-21,16
GdeKObMQJaDWTANHXgCUZYcILSBERfFVP,XDABUGGBZBEB.....IFEEBGDEEGAERCGFFBBEGBBEKDDE.hAAAOHCCMGACQGGHhABADAAEACGB.HAEChACACADHLAHFSHAGPEFC....hADA......hAFA...,1,-8,-30,22
PTXYGdUOcBfSRCEMaVeQZIALbgJKFHDNW,LFFFJCABHEGBDAGC..NGAD...TABDXAEA.dCBFUFDHhAAAOEAGBCGASBHBhAAARDCGMICE.aABAeFBFhABAZCDBAHDAKCDCFGGG.PHAC...cCFEhAEACBFB....hAFA...,2,-18,-17,1
YIHTPWgbdSZJNGfMBCAacEKFLXDRQeOUV,aGDCECCFLEFA.DBFHeFBC.UBAGVECHIAEAHAAHTGGEhAAA..gDEEhAAASAEFJCHBfGAGhACACCCBACEAFGGHQAGGOBGD...hADA......hAGA...,2,-21,-15,6
UHaCLfDeNXcYQVRISdWMObZGEAJBFTgKP,FBBETACGKDEBHAFF.LHEGDEHBeCDA.XAAFQEBAhAAAVGEGIFGH.hAEASHAGMIAGOAFGhBAAZADDAACGBBHCPCHFCEECcECCYBAF.hBFA.WDHBEGEE...hABA...,1,-9,-12,3
GKSFQMZYfBRgNAeTbIDPVdXOaECHUWJLc,TDGBDDBGdDGG..OFBECDAEHBBE..UAGCLHBAGACBFCEEZFFChAAABGGF.RFBEAAAFeHEGhABAIAHB..XDAChACAaFFBJACASDDG.MFADhABAfDEC..hADA...,1,-6,-32,26
aDHXWAYdRgOcCNMSPeEBVQZfGbJFLTKIU,dGBFRCBDOGDCCACB..SCCGEBEB.BGEDVCGDZEFCGEAAhAAAFBAD.KHGAUAGHDAFAHEDGhABAAHGB...cABGhAEAMEAA..eDFE.fGGDbAFA.hBAA....LFADhAAAaGGA,2,-35,-7,28
FfJdAGVIKBcXUYgbHPTROEeQSZLNaMWCD,VFAFBCEAUECA....bDGHHACDRBCD.OBGBEDFB.eAABhABASACCLEHBMFFBhAAACAHFFEFHJAFHdFBGADIBIBAEhABAKHDE.XECE....hAGA......hAHA...,1,-18,-22,4
