aVJCBQTUgLeEDOIKXYZFcNfMPWdbSGARH,HDDFaDBD.JGEEBHHAUGAHeADH..EDHHDFDH.OAAFKAAFZAFHFGGGhAAA....NCBD.MIAChACAdDAC.SAGDhADAAIHACEBB.QEEG.LAHBhAFA.IHEA.hABA...,2,-33,-16,17
VWTGKdaRIbADfZQLNMFOegSCXBUcEJPYH,ZFDGQDACMCCBFAACOACH..SGAFCGDGBHGGUBGBEEHB.hACA..JDDCHDDG.hAAAVADCTFGEdHGBIDAHhADADGFFLFCDeHCA.XCGEYAEEhABA......hADA...,1,1,-28,29
JYBHNDQKUPgWAeTGZVcfLIRXEMbaOdSCF,eDACGACFZGDE..VFGBLBFGREDG.MCAEaCGF.dABHFDEABFFChAAADIEA.KDGBUFAC..hAAA..gFABhACAABIHTCAF.IEDG.ECEBSCCHhABACHHE.....hAEA...,2,-23,-17,6
WNYRQeXSPMOZEfgdDLaIJGcVbCTUHKAFB,BFED..NDDGRADCQCGH.SGGAMFGHEBHFdEECaBDEGDADhAAA.VFAFhABACGAGTDAH.KABEAHFH.hACAFAAHWADEeFHF........hAEA......hAGA...,1,-23,-29,6
OHYeWgBLbJDcGFETdaSZXMIRUCNPAVKQf,QCCBOFBBHDFEeHDABGCHLAHDDAABFGHH.EAAFdDADZFAAMIDEhABAIBFG.CFFHAEHEfAGEhACA..hADAgDABbCCD..cBBBaFEB.SFFDhAEA..hAFA...,1,-10,-25,15
AdNJfKTVIgSQOWMZHCUXLEBecDaFGPRbY,JCCHTGBC....IBGBSFAF.QCAChAAAOEFGMIAGCDGBLHFAhABABAACDBBGGDDGRBDB.ACFAdFGEhACAfGGGKBBC.gFBE.hADA......hAEA...,2,-40,-13,27
SKIJFZTRUePDOfACLNWEYHbQBGXMgcdVa,CAFBLGEA.ECABHCBFBABEMBFB.dFGCVEBDaBHD..KGDDIDEDhAAA.ZBCETEDGhAAAeAHDDAEEAABCNEAC..hADA...bEFAQACA...hAIA......hBAA...,2,-26,-21,5
LfdJMHZAcCGYEbBIQKeSVWaPXDgNFTORU,CECDEGAHBFDAKCCC...eFFCSEDC..VABDaCABDIGEFGHDRFADhAAAUAGA.LEGDhAAAdDDHJAFF.MFCH.ADBH.hABA....YAHBIFHA.QGDDhACA...hABA...,2,-40,-18,22
AOVJaDKXNISLEQZMRGgWTHPCFYeBUfdbc,JFFCKGCD....IAGFEDBFZBBCGAGC..TBBCCFCEFAEEBDAFhAAAUEBDdHED.AGEGaABAhAAAXFDHLEEAhAEAMIDARCEA....WFHHYDDG.fACFhABAOFAHDBIF.hACA...,2,-34,-14,20
ABXKMGcJPSQbEfeNIUVHaFOgYZdLTRDWC,BFCFKBDHMGACJBFC...QBAEEEEA.eBFEUBAHHDFCFGGE.hAAAOFDGZEAFdGDBLDAAhAAARBDF.DHAGAIBA.XGGHhABA.........hABA......hACA...,2,-40,-8,32
AbZHREfINagMBOUPTeWQYFKDXLJSGCdcV,ZGFGRDDFEABD..IAFE..aAHFMCGFBFFDOEBGTCABeCHBhAAAQGCGFBABXFCAhABASAEF.hACACHGGdBFCADCCfBDGNBHE.....hAAA......hACA...,1,-20,-24,4
XONTQKUMDbaJYgdIRGVHecPASZCWFEBfL,CCAHFAFBBGEGLGCA.OHFCQCCHUEGG.MIBG.DAHBaACDhAAA..JACGdECHRBFBHFFAhAAAeEADAEBBZGAE.EFBAXDEBhABA.NIABKAHF......hACA......hAEA...,2,-23,-20,3
JVSHIQegdFLZWEUfXBCYcTKORaMAGDNPb,GDCCDACB...NBHE.JEGHHBAHQEDFeAFBFGECZDBH.EADEXGGFhAAABHEA.CHAE.TBFDhAAAKCEHODAH.hABAMCIFAHDAPCHD.SFAH.hABA......hACA...,1,-12,-28,16
ZgKeBaHTWbdCLNJUASXFfIMQYEOcPDVGR,XFCEFHBGMDEC...EEACOFFH.DCBGVACGGDAHZFFHKAHDhAAAeABAaCFC..TAFDhAAA.dEGDCDDA...hABA.JDHBAAHGSFAGICAG.cGGAhABAgGAG.BHHBhACA...,2,-25,-13,12
CIZOVXfUdAPHKQbcYLaSDRFGeNTBMJWgE,HDAGQGBC..bACBLDEBDCIHFDGFGFEFNBBEBECAMAFAhAAAJAAF..EGACCBHCOACEhABAXFCDUGGA.dDGChACAAHHHKBFFaCDG..........hABA......hAFA...,2,-17,-12,5
CIAbYSaPZHdMfgBENKXWFJeDTRLUVcQGO,SHBGaCFCZEDC.MDFGBABD.EFACXAFHFADB..JHBCTGFFhAAALAFEUBCG.hAAAQEADCHGE.hACAABAGYEEA.dGECfEGBhBAAKCACWECB.DCGE....hBGA...,1,-5,-38,33
XOMVYEPTcUGZCbHKQgAFSIaJDdeRNLWBf,FAFBSAFB..aEDCdEBGRCCGLHDCBCDBXFCHMDABEAAChAAA..PBAAUDGECHAGhADAKHGE.AHAHDGEAeEBF.hAAA.NCAA...fGGBVDEG...hABA......hACA...,1,-18,-31,13
GXOUFLNbZdJfPISYgBVTDQHERCcKeaAMW,GBGAXDCHFGEELGACZCCGdFBF...JAAF..PABCSHEAhABABHAA.VADB.hAAAQEGGEEEACHHGKGCFAAEAhABAWAFE..........hACA......hADA...,2,-28,-27,1
QgcOJWVZIaYSGUDRKBfbCNeFHXMLPTdEA,QCBCOGEA.JFACZDBF.aBGF.GADCDHACRFFGBHEG.CEDB.hAAAFFAFHADFMIEG.PBAAhAAAdABBADFC....hABA.WEFAIDHGSDDD...hAFA......hAGA.KAGA.,2,-30,-19,11
TaSUdELfBPKFIGMZXeAYDbOCVQRHcgNJW,DACBOAFBCDEC.RFFGHDCE....NHCB.JAAC..aAECUDAAdFFBLFAHhAAABCGCFDGEMIAEhADAZDCHABAC.....hABA.bAGF.....cGGDWHFASGAChAEA..hAGA...,2,-33,-33,0
NLeHMIFDbRJdTKGPgEfaWZcOCUAQSBVYX,QGAFBHCH..XAFCLAAFeFEEMCDHDDDHJDBBKACGGGEHhACA.EEGGfHFDhAAAZAEECFDAAEAB.SDGChABANAIE.IHAE...FEAHhACA.dCCB....hAEA...,1,-10,-39,29
NbdHaQBgEMSXRDeOYUJLZAITcFVWCPKfG,TCBCFCFCCFBC..KAAEGEFG.dFBAQEGEBDGEMAAGRACC.DBEEhAEA.eEEFODEBUAGEhAFAJHCEAHHC.....hBAAIHHE.....cAGAhADAWFDD......hAFA...,1,-20,-46,26
RdVIMASgfWEKBCaLJNDObFcXUPeTYZGHQ,SHBG..gGGDEACGKFAGBDEAaFBHLCFEhAAADCDCFGEF.XCBAeFFEZCBHhAAAQABFdAHEMBAFAAFChABACHECNEED.OAEA.cEBA...hAEA......hBBA...,2,-26,-13,13
VJgDYLdXZRbHCEGWKFUaBcOITePSNQfAM,JAABDACBLCFEZECF.HEFGCFHGGBEHKECHUGEBBEAE..OADEhAAA..TGFHhAAASHBAQEEFhACAfEAGMDBGYFAFdDCF....hADA......hAEA...,2,-32,-24,8
RKTVHOZQEafBLdPYeMIXDGFbNSAUWJCgc,UDACJAFB.CHEF.RFEF..KECBHDDF.QDGGEHGE.BHGHdBCDeDABhAAAXAABFBHF.SGBGhADAADDG..hAEA.cAEBTEGC.OHAEfAHAhAHA......hBAA...,1,-29,-33,4
QGDFcUCZNMbTdgfKWYRXPIBHJOEeASaVL,SEHBaDBDLDFCDDEFFABD..UDFACADBZGAEMCFC..dAGCKDBDhAAAREFF...XACGhABAIHEAJGBE.OAEGhADAAGIB.QGGGNAAE..TEDAhABA......hAFA...,1,-22,-28,6
VJWdUXReYgaTAIcKQMLbPfOSCDEZNBGHF,KHBGMAEHLDAG..fGABSEHDCCGDZEEABDFHGGEFhAAAFAGDJFBEUDAG..hABAeABDaBBEACIHQACEhAAAOHBEDDDDHGFA.......hACA......hADA...,1,-19,-22,3
ERJcaSDTZAKfWXQeFVGBIUNCdHbYLPMgO,KHBGXCBCQEGDFGCD.GAEGUADDdBGGHCBC.LGEAhAAAMECEEHGEJBAE.SAHDhABADFFFAIEA.fEAAhACA..eEABBDGCCAHBPEHD.hADAOAAB.aGAH.hAEA...,1,-6,-18,12
KWQXJHaDLTNgbBIGfSUcCdYFPVZMROEeA,QGBCJADGHFEHDGBCLDEB.TGGE..gCAEhAAAIAGGGACChAAASCHDCDGB.FDDA.PHAAhABAMABB.EBBEAEADWBFGaHGA.BEBCfAGFhACA....hADA...,1,-14,-24,10
FaRTcOgBCHSfAZYDEQUdGePXbKINMVJWL,DHCEEEHBdDGBGAGA.eEEEXDDA.KFABNCAE...MCFGJFBEFCCEhAAAaADD...TABGhABAOHBC.BDBDCGGESBFFhADAAHGEZABF..YAFE..hAAA......hADA...,1,-25,-28,3
ZegWcRIbXfEVFKMHJCNDGASYBUOLQdTPa,BFEDUFCAQBFGdHAD..aAGDZGFAeEAD....gCBChAAARDDGICBAfEEBhABAEACBFHFEKADCMIEAhACACFHC.DAEHAAACSDGE...hADAOFCFLBHB.hAGA...,2,-32,-15,17
VcHWQOTBbgRfXeYDKLENSdGAIUZJaFPMC,ZEFHJEGH..FCDBCDHCHFBF.QBDDBBABREAG.eDADDBGC.EGDEdHEHhAAAACAC...UCAF.hAAA.MFIB.cAGChABAOHAE..TABF..fFDFhABA...KDHHhACA...,1,-9,-47,38
AYGeEQSZPbIDfVFcHXdNLORCMBJWagKUT,eFEFQFCEZBBC...IDABDAAFFEACHAGBdFGELFBDhAAACHHGBFHC.aGEFKGACUCEAADBEGDEFhABAEAFGSCHDhABA.fACB.cBBFNDDAOADEhACAMAIF....hAEA...,2,-20,-12,8
GYfRQTDcWeKgXAPUBIMHJLENFOCbVdaSZ,BHHGMECGLHAGFADF.CEAA.VGCG.dGACSEFAGBEARCAE.hAAAQGGF.hABATBBDDGGEeBHHXFAEhAAAAIFE.IBHGEBBEOAFG...hABA.ZADA.fGEAhACA.,1,-19,-25,6
XOTdINJgBcDZLfKQMeUEFaCVRWbGHSYPA,XDCHTAAD.dAFBJFFCBHED..ZGBGKHGAQCEDUAACFDBB.hADACAFAREBEGCGC.HEEBhAEAPCABAICG..IGBFhAIANIEFDCCG..MAHB.....hBAA......hBCA...,2,-20,-18,2
GaUfEdXKLDgSeYJZMbFHPWCBVIATQOcRN,TDCHQDAC.OEGDREAH.GBCHfGGHEDEA.XACBhAAAKGBDDIEASAGAhAAA.JABEZFEB.hABAbAEH.PCHHCGEHBEFAIBBGADDBNCIA.aHAEhABA......hAGA...,2,-21,-9,12
DYOLZcGWJeFSMAQCEVgfdBRaKPNUXHTbI,QGAFEGFH..fEHEBEFCKEBFUAEGTCFCDBBEOBCFhAAALHECZECG..WAFAhABAJDHHFFDC.AICE.CACCdEAGhAEARCCE.aCHF..NAAA.......hABA......hACA...,2,-28,-12,16
VMYdNPgOWLQbDETcAUJFfZHeSBRXKaCIG,UGGDFDCDZEEGeFDDBBABKCAD..CHDD.GCDH.MDCHdHAB...hAAA.PBEDOAHFLAEChABADGFBTEGAAIGG.hACAfFAASGGAaBAA..ICGFhADANAAFQAFEECBF..hAFA...,1,-18,-31,13
JfVeSICgUPOGEBHYLQMNTDacRKbXFWAdZ,dDBDZFDFJBAAeBBG.CBGD.UFADGDFE.HFCHLGFC.MIAAhAAANAFADAIF..RDEGKADEXGAChAAA...AADFSEHHhABAIDBHOBFEBHEH....hABA......hACA...,1,-15,-35,20
fSNaJdLbCEeIDRQVZGKcUYFMXOATHPgWB,HEFH..PDACgDACBHEASAABJBAG.LGBAhACACAGEIHCFDCFDVFGBhADAKFDHUADE.MFIHhAAAXAGFAFBE.WFAFfCGDaDGB.dDDFhABAEADF.....hACA...,2,-21,-19,2
gAbFPWQTVGNcZdYRCOJUDfLBISEaXKHMe,FHBGQCBCGAFAZFEBRADA..CGGD.JFBCDIGEBDBB..SEDEhAAAEDDC.XFCEhABAMCBCAACD...WBGHhACANDAE.dDAC.OHAAUGGCIAAFKFHB.hADA......hAEA...,2,-28,-23,5
GMCOYagUTRZWFPVQcNKLJHEdIefAbBDSX,BAEDXCBFMFAH..CFEF.ODCG..aBDDTABGRCGBFHGAQGCGhAAAKBFAHECCIHDAhAAAAEAHDBFD.GDGEhABAUAGF..PABA.......hADA......hAFA...,2,-26,-22,4
gceAWNYMGSfVbCBLTOZKPIdJEFDQRUXHa,...NDDG.GBGA.VCDHCCFGLHCGOBAGZFFAKDBHdACDFEABRGBAHEFHhAAA..aDCHgGAFhABAABIB.MBFChADAfADBBEEC........hAAA......hABA...,1,-23,-24,1
KBUYTGZgHPMdRVXDcLaOIQNfFSWEebJCA,KFFBUGGGGCGAZEBDHACGMCCHdCAG...RAGHDGDAaACA..QGBDhAAAFDDA.SDDDhABAEDHF.JBEEAGAGBAAFhACAgGDB........hAFA......hAGA...,1,-23,-32,9
WZFcLGBdaeMNQKVRCUPSgEXIYJODfHbAT,ZEFHLCCHBGABeAECMFAHKCGD..CACBUFCASFFG.ECBDhAAAXBAB..hAAAJHCEDEAAbADBADCEFCGGdCHAaBAGhABA....NIBB.......hABA......hAEA...,2,-42,-18,24
FcAfEMeDZYHLOPBXTSgaJGICdbQWRVUNK,EGFHDACGZCCBHGAALAFEBAEA..SDABaGDGGBFGCCCHQCFGhAAARAAB.NFDHFACGhABAfFHG.MIFGhAAAOEHD.XAGE....hAGA......hAHA...,1,-18,-26,8
LORWaTgUPHISDFJGEeZMfCAYBNKQXdVbc,BFDGQGBCdCAB..VBFCLDEB.RABGaAFFUGFHHDAEDAFEFDEBhAAAJHEGEAHF.MDIBhAAACDBD.AIHG.KEAD...hABA..XFBDODGF.....WFFEhABA.....hADA...,2,-43,-8,35
LTCMBSFHdUEcDQWAeGVPNgZabOIXRYfJK,eEGHGEDH..VBAEPAFEZFDH..OCFDXGEA.RCAF.JAEEhAAAKDDE.LAAEhAEAMDADFBHBUGCGEFCDDFFFWCHBhAFAAGID....aDBE.......hAIA......hBBA...,2,-17,-17,0
YXONQfKEDdHAZcLRMWIaSgBeTUFPCGVJb,ZFDFLFBBMEDE.aGDABHBH.UBCFCDHGGAAC..JAECXDDFhAAA..QGGAhAAAEAGBDGHHAGID.RCABSDGHhABAgADH.FCFGbFFB..NAIE...hACA......hADA...,2,-27,-17,10
bIaASTZgCKEUWecLNJBdRYfODPMQXGHFV,ZBCFKEGDEACGeFGF.LFBDBHDFdAFFRBEF..OCAHDCDH..MIEGhAAAXGDEGEADFCGE.hABA.ICBDAHHC.hAAASBGACEFA..WABEcFGD.hAFA......hAGA...,1,-26,-32,6
aCDKRPNeZdEbTVQfOSLcgWFHXMGYBAUIJ,UDACaDCD.KCEHRAAC..eFGFZEGFdAHE..EGAH..TAACVCEEQAGAhAAA.hAAASFHHcGBDFAEBhACAMADGBGFGACCDCHEGDGAH...NEEE.fEEEhABA....hBEA...,2,-30,-17,13
ceGFLBAZMXgTbDJWQKCHPIfdORNSaYUEV,ZFEEXFDB..bGFADFIB..QCGBHBGBIAFCdAEHOFCDhAAARCBF.aBAGECAFVDAChABAeAAE.FFGDBEEGhACAAAHEMICATBCC.KHAACGCA......hADA......hAFA...,1,-5,-15,10
aZEPSXgcfHRFCGbJQODKAIMNdUeLTVBWY,MCCAUGBCLAEGBAGC..aEAHEDAC.SECEXGGG..hAAA..fBHEhAAARGDGGCFEJBBAQDGHhABAKHGGAABE.dDBD.VGCEWFAFPACA..hAIA......hBAA...,2,-21,-18,3
gIKOeJAfSGCZDdUENbRVQaLHMBXPFTYcW,GEAHCFCFDAEH.dDBBUEEDEHEE..RFFC..QABGLBHBBDAAhAAAFBHF...TBBAhABAWHAG.KCEA..OEEAhAAAJHAEACAF.ZAEB.........hACA......hADA...,1,-11,-48,37
EbOSYLUHBPCZfMJAKDdNQWXVTGeFIcagR,dGCDQCBC..VAEAeFFCFGGEIAEC..aABDEGAGhAAASEEAUCFGPEDDhABACDCFZEAA..MIEAhACAADEHDCIHNAIE....XABA...hAAA......hABA...,2,-44,-6,38
VGUaOQfeCRcdPHgSBLJDEbYNMKFWAZXTI,XDCBVEFH.UGGGQFAG.CDEG.dAFEHAACBBDDDAECEBHFhAAA....NCIAKBDAhAAAABBEIGEF.GEBGhABAaCFEfGCHeDAF.RDAE..gAGChABAJEFA...hACA...,2,-25,-7,18
SfLUTMaVZbKJdBIeWODRcQFGHXgNCYEPA,LCCHTGFB.VBFGKDBEBHAC.eGAEDEFCQGFFhAAAGAEEHEDFXGAECBCE.hAAAEBACAEADfBAAhABAMAEAaBDFZDAB..........hABA......hACA...,1,-16,-19,3
fZgJCTFNdEcOPbWaBXHYVMQSLKeIRDGAU,ZEFHJAFB.FCBEdBBB..EHBCODDH....PAEEaGFDBDAEhAAA.HCGBMEIBLFAHhABAeBAFIEDFhAAADICEAACE.fCEHCEEE.cGDEWECD.XEAAhABA...hAEA...,1,-18,-36,18
FXeZYUREAgKIVCTbDaBNOLMJfQdGHSWcP,KHBGCFDDDGHFBCDA.LDABMCGB..QGBGdBHEHGDGSBCFhAAA..cDAEhAAAFEFCeAECUACCAGGCICFFhABATAGDNEIAOFFB...fBAGhABA..hAFA...,1,-25,-40,15
dbCMKIGDgQPYTZBeJVNHELARfFaXcWSOU,RDAGFAFB..aGFDXDCG..SCGHdFEEMAEFKAAFGEDDhAAAQDFFPBBGTGCEhABABDABeHFA.NBIALHAEhABAfAGA.WFHH.UGAECCGCIBCFhACADACE...hAFA...,2,-17,-10,7
QBVFaIgHdXDcAPLUSRKbeMZJCEYNGTfOW,LDACRBCFeDADZGDAEGAEGCEB..OGFCQFGAFEFEIAFAhAAAdHAHDAACABEE.SBBFhADAMCACCCGB.TAGFhAEABFEG...........hABA......hACA...,2,-43,-7,36
QIDYcWFCGJTEgefbXNHKZdBUOaLSMRAVP,QFDHDACB....WEAFGAGE.JFAGEDCBeCEBXBDAhAAANIBFZACE..BGHAhAAAOHCESDAChABAMCHBAGHFIFFA.......hACA......hADA...,1,-21,-44,23
AMQgONRVCeXUSbfJEGdZFDTIPaWBcYHKL,QFDBOGEARDCB.eFBBUAEG..bABEJBAC..dCADDIGAIHGHhAAA..aAHBBCFFhABAHGBAAFHGMEDE.hAAANAIACHEAfDAA.EEEEFAFE...hABA......hACA...,1,-9,-34,25
BdNSaHcgRfPYOQJKWLeGXEMUIbFCVDAZT,TADCdEGDaGAF..HFCDRFAG....fBACPDAC.OHEAhAAAJAFEKHGEeDHFGADChAAAXDEAEBAF.IAHHhABACCFHAHEGBCHA.SEFDcDCC...hACA......hADA...,2,-27,-10,17
KWCHJNcXfDSBOdQUGIAYgVZFebaTLPMRE,VAADZDEDeAEG..aFBATDAD.LHCERGFEKAEBHGBE.JDBGhAAAXABH.SGGAhAAABAHBOEFAhACAUCGAAFFBFBGCPDDBMDAFCHAGfADEhABA......hAGA...,2,-16,-15,1
ZJCLUVESFfBQRbcDaAMIdTNeWHKOXYgPG,MHFGTGBC..eBCFKEGE.OBGD..XBEH.PDAEhAAAGAEEZGFELDDDhAAAEBCGFAGBBEEGQEEFhABA.cGBAACACIFACNBIEYCAFhACA.CBBCSHAGhADA..,1,1,-33,34
QSNbOfWTCFIdGAXHMVcREKBJUYDagPZeL,XFCAVFBG.RDBA.KCCHBFFBUBED..aGBHZGFA.LBADhAAA.QEFEhABANAFAOAAC....WCAChAAACCBF.FGHHIHAGGAGEMIDEEAGEDEIH..hACA......hADA...,1,-18,-22,4
LWKgTEcRBXUdMFPOHaCbSYfVAGIQZDNeJ,QAGHDHCEeBGHLFFGKHGE..TAAFRFAFBCDHdFCEFABDOFAFhAAA.HDDEaBEACDEHSCCFhACA.fHDFhADAAHFE.IAECNAAAgDBEhABAEEGF......hADA...,1,-4,-38,34
GTWAXFUYIOcLCKDfdVMebJNBEgRQPZSHa,XFCAUGBC..IDCHLHAAKDFFDDEA.dGHE.MBCEJACEBAHEhAAARCCDZAGFHBADGBEFhABAAFHAFGFBOEGF.CCAG.hACAeEAB..NEEG........hAAA......hABA...,1,-8,-34,26
ABLQDJCfEVbSTHcGFMZYdKeaRUIXNOgPW,LEBEQEGDCFDG.EAGE..SAHHHBBAFCFDMFFBdBDHaDDAIHDDhAAA.OADChABAPHECAHHGBDAHJFFG.hAAAfDDATGACcBAGYFAB.KFCDhACA......hADA...,2,-25,-10,15
aMXeTIBGZJOANPdcCERWgDLKQbfSYHUFV,dHBHEEGDRBAEDCCA.LFFFQAGH..SCEHUFAGFDDAMADGhAAAXEBH.eDAHhAAABHDHZABEADGG..PFFBhABACAHHKGHF...fECBYCHF...hABA......hACA...,2,-29,-21,8
KRSJWGAQaYZPTBFXfcEULCIHbDdeVNMgO,aGFCZAADBAHE.FEFCXCGE.EBECCGAGHCCF.dHDF.eAEEhAAANGADMIAG.OBAGhAAAKCGBSBEGhADAGCAFAIHGQEFA.YEBGfGGChBAA.LFBGhBCADAEC...,1,-7,-28,21
SNOgDBQUGRIaAEdLTbFYWfXeZPHJcMVCK,EEEDdGDDLBHFFCGF....fCEEXCDBZFFFJAAEMDIFhAAACAEAKDAH...NIBH.DBBAhAAABAFEQGAFhABA..UDBC.IAHFAFIF...hACA......hADA...,1,-30,-35,5
bOKMeJIfgSCUVQBDRWaYcNLFXEAdPGTZH,GEAHZABHOCFEeHDC.JEGF..IGHCSBDBUEBGBHAAhAAARAFC..aHEG..cBGBhABAFGAHAEFG..PADFhAAATCAD.KABBMIFGCGACDGIB.NAEF.XEEChADA.....hADA...,2,-24,-13,11
PfAUdCSZGgEaYNHeTLXbMRIOFBVJcQDKW,UGAFdEHAZCDFGDDEEHCE...aBBBHCFDLHFAXCADRBEAFDBDBFCAhAAA..JADEDFAAKFGAhAAAfBGB.hABASGADNBIA.bACEMCAFIHFChABA......hACA...,1,-14,-21,7
gPXdSfBWNJZGFLKEAIUDVCTcHebMQROYa,UAFBDFCFCCBA.HBDB.eDBBMADBRGFE..ODFEaBFC...XBBBhAAAdEDHSDHFhAAA.BGFCNCAC.JEAB.hABAFHGAKGCHABBD..........hACA......hADA...,1,-21,-47,26
XUFTCKDJISdHPQbOEBVGRceZANWMfgaYL,MCCAaHBGLABCUEGH.FAFCCDBC...KEDCDFFB..JEHBSADEhAAAHCBA.QGCHhABAOCFFBFCGGAGGhACAeHEEAHID....fEDG.XGAFhAGA...hAAA...,1,-22,-32,10
dNXVFZJHPWcbAQKeELTGgICaMUORBDSYf,QGGDKEEDECDG.LEEHGGABCAFAMCCARBGD.DIBG..SGHBhAAAfGBBdBBEXBFBhAAA.FBHDZEAChABAPDAC.cABBABIDTGFB...hABA......hAEA...,2,-24,-22,2
DMXgYRFTcQSfILHeWJZaUbCNPVdOKGABE,BFEAMBHH...XEFFRAABFACC..QDEESBEALGBEhAAAeDABZGDCaCEGCAFF.VFGFhAEAOABH.AHIDEHBEhAAADIBG...TACFIAFEJAHF.NAIE.dDDA.hAHA......hCAA...,1,-12,-20,8
VOUHMQdYTaBPLCDSfWcgXNbFIZGeJEARK,KDAFOBDGMFCHdGHG...aEGGBDEE.CCBEDBHFSFEB.hAAA..fCFHhAAA..cDDHhABAXDAAFABEIBFFGGADEDDEAFIFRGDGUABEQGGChAEA.PFAFhAFA..,2,-33,-24,9
cDSMJTAgVGUXNeLbZIWCRYEQfKHBdaPFO,VEBHUCBHeHAG.LHEAZFEHCAHA.EADBKDEA.dADCFFCE.DGGASAAFhACA.MCIHhAFAAGFFXAGG.hAGAIFAGREGBfBBABBAFOCEF.hAHAJCHF.....hBBA...,2,-30,-19,11
PCGUOceKadHDZVXTFWMIfLbBNQYEgSJRA,CECDGDDCUBDH.OAEA.KCAAaAAFHGFGDGIF.ZCFG...XFBDhAAATFAE.MCCELFEGhACA.BHDANIABEABAhABASAFBAEBF...cDGG.hAIAdHAD.....hBAA...,2,-35,-11,24
PBOeUEJLXAGbcZRgIFVQMDYdTHaSCKNfW,GAFEZAADRDCCFEADMDDF.dFGCHGCA.SEGGKEAE..WBHHhAAABCCF.UAEEEACAJHAGhABAABHC....cGGHhAAAIEEG.DBBB.aFACCHAB...fHDFhACA..hAFA...,2,-32,-27,5
HGRBVcWAaYTXMEDSLOdebCPfJZQUNFKIg,TGBCMBDHDAEC.LFEGOAEA..eBDECCFH...JHDGQAAChACAFDGHKDEBHDAGBHHGhADAVAAFAHEFXGBEhAHA.dEBA...bDFA...ZAFEUGGEhAAA......hACA...,1,-12,-16,4
XJUWLfFZaRTYIESNKObgdGHAVCecQPDMB,VFEECAFB..QCAEMIAG.JCDBLDBGFGGG.ZAEETFBAhAAAIDFH.SBAEhAAAKGDG.gEAGhABAdABFAIEAPEFADDHD.UBFBaGAC...EHAGhAEANIEHbACF....hAFA...,2,-19,-17,2
bdHGeCKREZLVcTWYBaPAIgDfJMOQFNUXS,DACBMDEBOAEDFDBG..UDFC..SEBAHAFCCBBE.RFFALGBAhAAATFAF.BEFBhABAAEAB.IAGAJHEAXACBhAAAdCGBKDAA.ECDB..cGGA..hABA......hAFA...,1,-27,-31,4
AUOJBNHQfaXVKGCWbDMecYLdEgRTZFPIS,UFCAOEGHBHBGHEAF.QADDaAAB.KAABCGHCDBDAMAIH.eEDFhAAALDADdCCD.RCDCFFFFhACASHFG.hADANEIEfCFAXBCC....WHFAhAEA.....bCGBhAFAEAFE..,2,-39,3,42
TDZGLaYONVgUACBSRHFbJIMfdPcXWEKeQ,BBEARBCFFDHH.JDDD..MFABdGAH.....XEBGKEAAQGDDhAAADGCCLABEODAAhABAVFFDAHHFHABE..hADAIBHDfFFF.PBGFECEF..hAEA......hAFA...,2,-30,-27,3
WRSIFcCQOUPgLXNAYZaTdMDfVeHGJbBEK,ZDAGTFCEMFDH.DGFCeBFC.HEEAGADFJHAABDBDKABHRCFC.FAAHCHEG.hAAAQGGF.hABA.UGAGgADChABALEFAAIFEaCDD........hACA......hADA...,2,-27,-11,16
WISTcYVURHFQXaBLKCAOJZEdPGMfgbeND,ZFBGEAFBGBGEMBCH.....fCBEeAEDDBIFSHEAhAAATEAGVFDBHFFCXGAGhAAABHCCKBFCOBAAhABAPDFC...NADGIBAFcDDF..hABA......hACA...,2,-25,1,26
XBdATUacLKbYHQDNVJfFMIeZOWRCEgSGP,TFCAaGFCLACB.KCHBHFFC.NEEH.JAFBFACG..MFAHIDCFhAAAOECA.CBAC.EBHHhABA.GBCHBCBFAFFCcGAAhAFA..........hAGA......hAHA...,1,-16,-45,29
WQMLcKRbOSDIZXfCGFJAUTYdBgPVaeNEH,UCGCdGFCBCGD..VCACaBAD...EGAGHDEA.MACGLHFAhAAAKAGEOGBAIFFAhABAZCCBCGHGFAEE.AGDE...hACA............hADA......hAEA...,2,-36,-36,0
gdMaJEDbCRBVcXZHSFNAOUfYGeQIWLTKP,ODACUCBCGGCB.QADELFDDTFEHKEFC.PBCChAAAdBGCMAAF.EHGCDBHDhABACFBD.BGAD.cABBhAEAXDDFZBFFFFAAAHAAYFFGIGHH.aHAEhAFA......hAGA...,2,-19,-14,5
aJPZBVcYfXRKbECHGSgMWeLUATIdNODFQ,dGFCOFCHQCEH..JAAABHCFVDDB..fAAChAAAKGFH.CHHGHDBHGAGGhADASBGAMFIHLEABhAEAAFFANDAAaBCA..cADD....hAGA......hAIA...,1,-18,-31,13
ZfWYKRePbdaLFOgDNJICQcASVUHBGXMET,UCCBHCBFXFDHMFFDZDAH.....YFAARAEEeEHDdAACFAAFDFGGhACA..ICHEhACACHGHQADGAHHDBHAEECHHhAFA.fDDBKFDFaCFH.OHBC..hAGA......hAHA...,2,-24,-13,11
HaRZVETeUJKAOdMLIWFCBQgGYSbcXPDfN,MEGFLGEAFCABBHAAGBDC.SABG..bAGHcAGBhAAADBEDHCBF.aAAEZCAFhACAEFCFeDCB.KHCGAHEHdAFEhAAACGAGQCGE.XAEFNEFA.hABA......hADA...,2,-25,2,27
LERSUKJfYDeFGCdTMBQcbOZNHAXPVaWIg,VEFHaHBG....IGECLAEAEEFBSFCF.KBBAhAAAJABHDFIBGEAFdHDHBGADhABAbAGHOAEDZCAAAAFCXCEBhACA..PHFC.WADD.hADA......hAIA...,2,-25,-18,7
ULPRKDJMQTbcINHfOeEASaWCdgBGFVZYX,SAFBCFEDBBHAGAAFZFEFUDBHLDDAREGB.KAFBDDIH..JDAFQABDhAAA..hABA.TFBAIHGGhAAANEAG.OEHDAGGB........hABA......hADA...,1,-22,-44,22
WdSJRHANXgFaecOZMICUTBKYVPLDGbQfE,XCBCFAFBeECDZFGF..CGFHBFAAKBAF...VCEHDDFCQGEEhAAAEGCF.SAHBhABAJADGAIAC.aEFGMDIFhAAAUBBE...PEAFLCGB.fABGhACA..hADA...,2,-39,-20,19
PTXRUNFbAIBDQOeJLaEKVfSYgWZdCcMGH,BAEDDECDeEDCLFCEKAAB.SFHD..gGCChAAAdCCHMDBFGAFEHAEGXFGHhACANIAF.FEAHIBAHhAAAOBHFECCGfCHAWFFF.CAHC..hADA......hAEA...,2,-23,-22,1
fBMQYTEXKOARdHeUCaIcSNGbJgFDZWPVL,dDAFeBDGCCFF...IFAASFGE.GEECJAADFBHBZFBD..hAAAVDEHLBBA.hAAABGACMFIB.TCCGhACAEHGAKABCAHGHRGBC.aEGD.....NAEFDIDEhADAWBHB.fDDEhAEA..,2,-25,-18,7
RCNSafBOUQeDYEJcKdWgXZVTHMLIAFPGb,GEAHCFDD.SHDCBCGAQGAADCBBEEGF.JBDCdDDF.XADGhAAAZBBHHFFG.MCAFhAAAIHBDAEIB.FAHFPHEChABANAGE..aHGGfAGF.eDDEhACAKABH.....hABA...,2,-18,-17,1
BEaegRMZONIXHWGcUfKbYVTQJLSPDFCdA,BEFAEEED.eBBAMDAGZFAFODFG..IAGAHFBBGAEBhAAAUEDCKGGEbGFA..TEGEhABALCHDSBCGhACADECDCABEAIDG....aAEF......hAAA.NDAF.cEAB.hADA...,2,-33,4,37
IcQBaNePHJWLTXgCSGDUZREfAFdMOVKbY,MIAGODCHKADG....bEFH..IHEABBHGaEDD.eAAFhAAAHCEELAEFXGFBhAAACEHD.DFAA.ZABBEAFHAEEDFAGChABAdHAB..YDAB.....hAFA......hAIA...,2,-32,-12,20
CKJAYaTfFWdNcDQbeSLGHBMRVUIOgEXPZ,TGBCFHBGdHEBDDCG..eFGDLCEHGAGABADDVDCG.IBAChAAAEEAC..ZCGBCAEAAIFAhABAaBAE....fEADhACANDIG.QGDCSAGAMCCEhADAOFBC...hAEA...,1,-12,-33,21
aTMUFNIKOHRJXgfVBCWZPdLcSAYQbeDGE,QCBCeFCHECCG.MFFAUGFH.FAAFIAFEKEAF..HDBEhACAJEDB.XBGF.hAAA..fEFDhADABDEBCCGDPHEG.cEAHAEHC.DGGETADEhAFAOABG....hAHA...,2,-39,-10,29
WNbQPGfIKdDJSOLYcFMHgaReVEBTCXAZU,UFDH..bCAAQGAHGGAHKFFFJBAASEAC.OEEAhAAALDAAFACAMEIHhABAHAFFaHGAeCFEBBDEhAAACHHDABBB....WFBENBIE...fAGFhAFADEEG....hAGA...,2,-26,-14,12
MSXNCEQfHZegULFYaOcDPBVJAIbTKRWdG,TCBCKCFCRFFDGCDC..SGCACEBH.QAAFhABA.ZCGHgGBChAAAFEDCYGFGOAEGcADBhADABABE.AHEFIFHH...dBBDhADAXGAFNAIE..hAGA.fAHE.,1,-8,-26,18
TJbSZDHIaMWdGOeKEVYRFfCNLXABPgUcQ,BFDGUCBCQFGCJCBC.ZEACDAACHAGHMBFAdACB....hAAA.eGCAKGEHECFH.hABA..RGAGCHGFNICHAEFA..hAFA....gDADcGAB.bEFE.hAGA......hAIA...,2,-48,-17,31
OCRUMKXFYHfVcGadAZBPNWDQSbTIEeJgL,BFDD..PDEHDGHFSBED..IGHEeBBDJBGBhAAALHCG.OAAFhAAACAGCMICAFFABfFAEhABAcDGAdBEFNFEF.bACB.EFCB....hAFA......hAGA...,2,-43,-25,18
IYHODcAFQSWZJKPgMVNRCUbETLfBeXdGa,QFCESCFCZCBAJAHF.KEGG..MEECRGEEUFAD..EDBCLADAhAAAeAAHdBDHaHBEIGHBhAAA.OFFGhACAADGE.FFADWBHB.......hADA......hAEA...,1,-22,-30,8
YDEMfPJBNgWZHAGFeKdQLScTaURbXIVOC,FCCGeEGHdHCBLFAE.SBBHTEDHUGGCRAEA..bFEBIACBhAAA.OEAGhABAYHAE.DICAfGAGhAEABDCANAAFgCGEZCGBACFDKAFA...hAFA......hAHA...,2,-26,-8,18
WXEDbcOTSRKadIZVCBFMYfLGQAUeHPJgN,eADGHFDFJBGH..NCIE.ECDH..DEDC.OAAHTGAD.KHGEdGGAhABAZAACCCGHBHEAMAFH.LCCAhACAAFGBUCAC...hABAgGCH.XFAGSAGEhACA......hADA...,2,-26,-21,5
CRaBNWGYUJMKeXHbgOEfAdLcFVDPSTIQZ,LCCHFCFCDCBG.SFFDQAGFZAAHRFEB.BFBGGDBDUBEHMCIFhAAAKEHD...XGGFhABA.HFABOFAHhACAAADD.dADB.........hACA......hAEA...,2,-35,-19,16
GcDKJPSILOMAQEegbNBCYTZRFHWfVUXad,QGGDeCCH..NDBCBACBTBAF.FAGCHFEA..WDFHhAAAfBAC.XAGEhAAAaFCA.dDGBGADEhABADHCCPAEFIFAGMIFAgGCEhACA.CFHE....hABA...,1,-11,-24,13
DYRNCJgKAPXTQFcdbZaWUfEMLIGBHVSeO,XCGCTFCA.FFDBdHGB.ZACGUCBB..MCHBLHFABGADHCDAhAAASAEGeFEGDIDAhABARFABCAHDKGFCACFGQCAGhACAaAAC..fEEB.ICEGhABA....hACA...,2,-30,-10,20
BcONPQdWMIaJSKZDGUXeVTbLCFYAHEfgR,HDAGEHBGRAFB.OACE.QGFHMEFCJCCCZBABDBIDUDFE.XEDHhAAAeFAF.TBAFhABALGFE.CACBADHAgFAGhACABHFA..cFCFNEIAWHBASAAFhAEA...hADA...,1,-10,-22,12
gRSMWJYafPXZBLUeAQHdENFOTGVICKcDb,dDAFEAFBFABDOFAG.GCGGCCEG..DBHHRFFBMDEH..JEEH.hAAAaGGHXBEF.hAAAZGAABDBCUABHAADHHGAEhABA.TDFF.KDCB.....hACA......hAEA...,1,-20,-35,15
OVNBAXgPTDHICaFYdUGWRcSJeMZLEfbQK,XCBCTCBC.DBFACHEF..FFGDdFGH.GECCRFBF..JBFEZEEBEEFFhAAAQACG.hABAKAAFNDEBAIFEHFAB..hABA....IAEH...aGABhACA......hADA...,1,-17,-38,21
QGfXFEKeHULOCVYBWTSIDMRAagdPbJNZc,aAFBdHBHJCEBZDGF..GBAGFAGH..KFFAUDDE.CHAG.BEAH..hAAASGBBDCDHAHHB.hABA.....PECBhACANAADQAGE.EGFGeACC.OEHFhAHA....hAIA...,1,-23,-49,26
ZOWLHIBeJaERMVTDYNXPGbFcfAQdUKSgC,QFCAUFCEKCAC.SCEEZBEBLAGBHBAGBADDJAHHRDBA.MEAFhAAADICG...XGGGhABA..GEAGhAAAFEGCAIEACADBIFFEaGAD.EHGA....hABA......hACA...,1,-1,-40,39
WDJQIAOHMPCURZecYVXBLFESbgafNdGKT,MAGDUGGGRDDGZFGF..eBGD..VFEFBFDGFBAFEAAF..SCDHhAAAaBEF.dFBCGDAChAAAKCCDDEFCIAHFhACAAGIB.OHCECHDGXADE.LAHFhABAfBCC..NEAG.hACA...,2,-21,-20,1
ZFMDALTJVWdINePGQcKHbRSaEUfOYCgBX,LFCAJADG.dBCCeEFEQBFAKGDFHFFHSEBCUCCA.hAAAOEFACCABBCGAFHAAAHHB.hABATGFC.IAEDhAAANAIA....PDAB...hABA......hACA...,1,-25,-34,9
SOCdcgZfBIPKTRNHMXGVDUFLQeJAEbaYW,EAFBaHBG...SEBBCHGDdCGGZABA.BEGGKFEB.RBCAMEAHGCACDBHBLCCGhAAA.eAFChACAAIBAbAAD...OEEFhAAAfEHAPFDH.TGGC.NAIE..hADA......hAEA...,1,-11,-26,15
WFRIONeGUSZMfVCaJBDTdQYgPLAHbXcEK,XFDHEAFBFCBC.RBBC.OFGFGDAC.ZDFDMHBC..CDDFJHFEBAAFhACA.TCGBdAGD.QGEGhADA..hAEAYAAD.LCHHABIBbEBGKDEAWAEBhACA......hADA...,2,-23,-18,5
gMNXGJQeDRPUKbVWHfcZSEIYOCTaFBdAL,MDEBXFGHGBED.QABHDAEGRCEFUABEKFAE...bFEDHDBBhAAAZDAA.SBGEhAHA.IGEFhAIACEHDaGGEFHBEABED..NIEFeCHB......hBAA......hBBA...,1,-14,-19,5
ePQNYVFdgIDAKaXLRHWUOSZfJcbGTCEMB,aFAALADGHCBAUAEDSCBDZDEG.JAHD...GECDTFFEhAAACHAFBHEFeHCAQABDhABAVFGF.FAHBIABEhAAAAIFE.KDCE.RFAE......hADA......hAFA...,1,-11,-16,5
PJaLHKdScUBTVGIeXWYEDCZfMORbAFNgQ,FHBGQCBC.aACEHGEC.dCBBUGFEBACBGGBBeDFHXFAChAAAEAAFDAFDZAGBMCEDhABAOEFCAAID..PAEAhBAALDAD..KEBEcECB...hBBA......hBCA...,2,-25,-5,20
DcgRAdMVUBaLeNTCJFPEYGbfXQHSOKIWZ,MFCFUADCBFBBLBAD.eHDECGEGFGADEFFG.GBCA.XAGFhAAASFGB.OAFChAAAIHHEZCACDEEGhABAcEGF..AIFA.aBGHTABAJFAF...hABAbCEA...fGCAhAHA,1,-15,-37,22
beJTXIUPfKMGQLgZYFOBAVdCWSaHRcNED,CCAHSAFBHBECRFAC.EEBGDHGC...eDDDTGDHUAAFKAHB.MFBDhAAALFFFZCDFFABCBAEChABAADDBdDGCaDAE..NDAA.hADA...XFGAIEHG.fAHEhADA....hAGA...,2,-28,-9,19
OIVGRAcHgYbCMedZJETfFUXQLNaWPBKDS,HAAD..bEFHeFACdECGECDBTFGA.UCEAXAGGLFFDhAAAaAACBDAFKCDFDIAGIHAHhABARGBEAAFC...YFDBhACAMCAFJAHBfCHA.FBEF.hACA......hADA...,1,-7,-11,4
dbCfKGFVXOTcUAQNYeWSaZHJMPRBLgEDI,QCBCeGEA.SCGGHECDJAEAMDCCBGBGEFFADHAEdCGCCHGHKAGAhAAAFBBC...ODAFhAAATEDBACIH...NAFGaGAHhABA...........hABA......hACA...,1,-24,-33,9
TWMKcHARdJILNgQVFCSGfEYOaUPebXDZB,RDEDJCCHLCBC.QGGAFCHFCGHDGGCFEAEE...OAAChAAAUFCHeBHBDFBH.ZDAABAEAhACAMAAEKDGFAGAHdHDD.hADA.IAHE.....NCFA..hAGA......hAHA...,1,-10,-40,30
feGVIgJLZadUREKDTbSNYHMXPQcCFBOAW,eGEAGEDH..VCEHIHEHLBCFdGBEUAAFEAFG..DFBBSCEGhABA.NAHE.hADAMDAB.PDHDhAAACAFCBGGHACACfBDFJEAE.aAHF...hAEA......hAIA...,1,-15,-29,14
PgTISOLYaMRUcXZAbNEJQdHWBeFfCKVDG,EHBGQAADdACGBBDEeBED.FGHBCEDDKBFAGEED...PDAHhAAAIAAHLHDAhACAMEGH.RBGFXDCChADAZCFEAIAG.NGBF.JEHB..fHAFDFACSHEGhAEA.....hAEA...,2,-37,0,37
VHbOYAEfUJQZaXFPKeCNDLMBWcdTgSRIG,UGBCQAEGZCFCFDBAKCFH...CHFGLGAABBCCdGFA...TEDDhAAASAGCRBAFVFGFhABAOAAG.AAEF.fACBhAGA.aHCEXEECNBIE.DFAHhAFAcDCBIFHE.hAHA...,2,-41,-17,24
PLNbgYRIHOGKdTVFSJWQXfEBAMcCaUDZe,MBFHaEGDZAAELDBB....bDDCgACB.REDHOAEAhAAAKBHFTBDFSHDGhABAQEACfFGFhAIAAIDECGHADGFHeGBC......hAAA......hABA...,1,-20,-29,9
PZcUbNDLEdYXaFRAOeJICWKVfTgGMBHQS,JAABCFDGKBFH....VAEF..TCDCGEFGBEHBHEAFQGAGhAAASCHHZGFA.hAAAUCAGDHDCdDDE..hACAYAHD.FADAOCBFeFFG.IHHDhADAfABDMAHF.hAGA...,1,-14,-30,16
AMTLGOKEcbWBdIRfQPYeZaJFSXHVDUNCg,MIFGTDACLFDE..KGEHEDEGbADEBAHB.RGCA.QCDBhAAAeDBFJADC.FGGHXBAGhAAADBCDUDGF.gFAAhABAAHBBOCFGWBDDIHCC....hACA......hADA...,1,-16,-21,5
cAMHRSGPYFLZdagUQNeXbBVTDOKfEIWCJ,RFBGGEAHFCBCZADCaHEG.UACG..eHFABHGHDIAGKBGG..EDEBCDHFAGADhAAA..MEAEHBABSDFEhAAALDDAdFGDhABA..gGEC.....hAFA......hAGA.XGBA.,2,-28,-12,16
JMPKZTabXIFdVAgGNUECYOHLRScDWfQBe,GAFEEGFC.CGGAHABALBGHRDDF.DIACQEADBCEDeBBCJDHFKEFFhAAA.ZCAE..aADAIFAHhABA.dGCFAHBANAAEhABA.OHBESHFAfFFAMACE..hAHA......hAIA...,1,-15,-20,5
EXebLWTDVUPKQaOBRCASZdYNGfIJFHcMg,SEHBZDAGdACBGCFC..IHGFJFCHFFHF.MGEC.EDCHXCDFhAAALBFGDIEEVFABhAAA.KCAAOFAFhABABBBBCAFEACCD...fHDBgFDBeDFChABA.WFDCPAHFaBEH.hACA...,2,-19,-19,0
NeKECLIVFaDHSWMdcTYOfAUZGPQJbXgBR,ZACFQAGHJECG...XABDBGFBRAAFKHEALFCE.FGGAhAAAHAFCMBEDdDGBcGEHhABAOFAB..fGAAhADAAIHE.UDGA......hAEA......hAFA...,2,-43,-16,27
gDAIcYNFaELbURJGHTMBfCSOdZKPeQVXW,..IFDGNDDG.FFABaCEB.LAEARCBFGDEHHAAEBABAfFGAhAAACHFB.SCHFhACAdBHEPAEGVFABhADA.XGDDgBDEACCDEEFFJHCA.MAAHhABA.OFFE..hADA...,2,-18,1,19
eKUASEWHGDBXfIdJZNLCRPTMcYgFbQaVO,SAFBECFCGCCEBGBE..ICDAdEFGJAACZGFECGEGRDAHMAAFhABA....gDAFhADAQEFD.ODHFhACA.KHBEAHDFDAIHNBBF......hAEA......hAFA...,1,-23,-34,11
BFcUDfIYHPJadVEONReCASKLbZXTGWgMQ,SEEDLCCHXFAGGAAF..MBHBBGDDFAFBDAEB..IECEhAAAPCHFaGFDEGGF.hABA..REEF.eDABABHAZAAFhACAWFHHQCED.fDAEhADAJHAAODGHCHHA.....hAFA...,1,-9,-19,10
TGBSWdVRAHfXDCbUEQeJaMcgNPOFIKLYZ,XFDHDAEDCDHD.UBFCeDAB...aEFBMAFA...NBCG.OACBhAAA..KADFLFDBhABAZFGDBEDCSHBChADAdCAA.AFHDHGFA.EAGG.JCEE.hAAA......hABA...,2,-39,-21,18
OKfJaPTeUCXFRQVENHbdMcIgAWDSYGBZL,DGHHGEAHLGBCKCAH..JHBCaDAB.eEBECGHH..FGFDQBBAhAAA.EFFFNBBDHCCGhAAAMEEC..IHCEhABAAFFESDGCZCFCfAGETAGF...hABA......hACA...,1,-8,-35,27
PYEeaRSGACQfWdBDXbOVZJFUTIgcMLKHN,QGGGdHBHBDGBDGGEOAAFZACG..FEFCUGCB...ICFDhAAAMCDDLDADhAAAKEEBHACC...PDABhACAECEHeGCEaAHFSDGAACAGCAHA.fCCChADA...hABA...,1,-10,-40,30
KWYNOALcXBCTfJVeIEbaRGSPUMdFZDgQH,LDACBHHGCGFD.TGGC..JFAGeBBGEBHB.REBFGBEG.hAAASDHFUACAdGDGDEHFhABAQAGGKDEC.hAFANEEAAFGDXCBC..fEAAhAAA......hABA...,1,-11,-48,37
aNPDJOeQVMYXTdLHIFGAgBUbSKWEfCRZc,UGGGSAFBKGCA.EEBGRCEDZACD..aBGDDGBD..eEEG.QBBGhAAAMAFE.TADAhABALBABFGGFAIDGBFBBhAAA...fHEFNCIG...hACA......hADA.OHAA.,2,-44,-5,39
NLPIHXUDFVeSQBcRfdEKYAZWCaJMbTgGO,CFDDMEGF..TEEBOCDBLEAHHCADDCGCeCCFBBACRAFEdAAFEDHBAAEHhAAA..aHGE.JCHBGGBFhABA.IAHDhACA...........hADA.FGCH.QADAhAHAKAFD,1,-18,-31,13
QIUdeLRVabEZfTcSJBKFOXWHGCDYMgPAN,QCBCdGFCeDFGREDA.aACEZDAE....fAGFTGCDSACHhAAAJFECBHFHKFBDFBGAOFAFhABAHGCADCFA.MEDAhAAAAGHF.NCAG..........hACA......hAEA...,1,-15,-24,9
gfAIWcYTdZCFHEBMXPGVaLKSODNQbUJeR,..IFDG..WFCA..TCFFZCBDFABBECCABHGAXFGHhAAAGBDELEABhABASEHFDADEQAGFhACAJHDEeFAD.fBBCADAB.YHAGhAHACBGDMAIF....hBAA...,1,-27,-29,2
aJGgCFSAQNELRVHObcTBUeDXdZKYMfPIW,EGFCLDACRAEG.OGEA..bDDGBCHDDEIDdACGKAGEMFIH.hAAA.IHCBaFCFJEFEGAAFhAAACCEDAHAA.VFABhABAHCGD....TBEEXFCA.fDBAhABA..hAEA...,2,-29,-12,17
aCGFMcWKSbXEAQgDPfeUOdBLRYITHJZVN,QAFBDACBeDEDdGBABCDALDACRAAF..IFGCHBFEJHFCZEBFhAAA..aEGCFGECMFABhAAA.KFDDSDEHhACA.EDGAAECD.........hABA......hADA...,2,-27,-25,2
AeTNJVdZEbCOKDMFSUHIfYRWBPcXGQLag,eDACTDAC..JEHBdBBDZAFBCDEF...DFAASGHBHADB..hAAAIGFGfHADhABARAAEBHCAXBGH.hAAAGGCDaEEBAACEEBHB.......hACA.KFFE.MGAC.hAFA...,2,-27,-14,13
VCeLKRcMgXZOdBAIQPSJYfEHbTDNaFUGW,QCBCJCCH.EBFCHBEG.DDBFFEDAUEGCVGAACHAD..LBAEhAAARDGHMBBAZFDABBHBAAIH.hAAA..SFEDhABA...fADBNBAA.WHDAhACA......hAFA.KGAC.,1,-17,-39,22
LMcWIOUAQBNVFDfKGZERdCbHTXPJSaYge,BHHGVDAG.DHCAGFBBZAEC.RBCA.dBBGHAGH..XACD.hAAA.JHFGSEDFhAAAgGAGMIAAIACAhABAAFID..NCFCFFABEEHFCFFB....PEGBhABA...aCGC.hAEA...,2,-28,-10,18
dGgXNTEALZWPRIUBSODQVcHCMeJbfaFYK,LFBBZAADRDCCBAECDECE.QGDFHCGHCGGH.MABHeHBA...hAAAJAFBbADC..FAHFdDFEhACA..XGEBhAAAEAHFAHHAPFAB.SGGF...hADA......hBAA...,1,-11,-30,19
WbUcCPZKSEJIARaOXMBgTLYGNHQVDeFfd,RDEDaGDDOBABBGAALBFG..NECCHAFCDFGDFABD..dHEBUDCBhAAACGAEZDGBKDAD..ECCGhAAAAGIB..MFFB..hABA.....gDGD..hADA......hAEA...,1,-30,-40,10
LMUgGCBQKZNWFYAPIaSefDRcbJHEOXdVT,aHBGeCCH.DAEERCCC...JFEAOBEA.dBACVAAEMFAF.GFCBhAAAQFCHZGFEFEAAAFHE.hAAA.SHBGhADA..fDFFHBGHEBEC.....hAHA......hAIA...,1,-18,-25,7
VYBNfAeRZaWQgMCJXTKOPIEDcGFSbdULH,eDACZDDFaBHDQAAB.CAHA.JFBBKDEDOEAB..PHFEhABAEABCDDGFFDHD.dGBFHBEAhAAABAFHAGGF...WCFBhADAMFHD.IDBG.SHEGhABALFAD.....hAEA...,2,-24,-23,1
CGHFQBIXJYSEdLTNDRPOAZaUMcfgKWebV,UCCBMCCA.....fCGAKFEHeABFCBGBFHGEBGHE.JEBFEFCEhAAA.LHBADEFA.hAAAPFFEAAEE.ZAFGaHAChABA....WABA......hABA......hACA...,1,-30,-53,23
PUQeJKTDORHYAgCEfdXcSIGNLMWVFBbaZ,EEGDXGBC..IHEELCFGMIAAFEFBaABBZABG..QCCHhAAAJFHBKCBA.OGBGhABARAFGAHFE.CDAHdFACSECDhAAANCFEBHHE...PADD....hADA......hAFA...,1,-17,-25,8
LVZAECJGfIcNTBXbaFKUYgeHROMDSPWQd,JCAFGAFE...fACGIDCC...TFGHBEEGXDGBhAAAbADD.FFCBYAAFhABAHGFEMICADEFBPHAAhADAdAGBVABAAIHECHEEaEHD.KFADeFBE..hAFA......hAHA...,2,-14,-10,4
LYGMZceIbODACPgdXTWEJKQFRfaBUSHVN,CFDGdHBH...XDFCTCGH.EAABKBADQDBHFAFD.RADABGHFhABAUEAD.HEDBLFEHhAAAMCAHeCFEODCADGGDhACAAGGG....WHAC...aBBA..hABA......hACA...,2,-39,-2,37
aMGXUNCDWQeKREJOcZBfbSFPTVHILdAYg,aHBGXFGC.UGDEDAGFQBCF.eDGDEAEC.ODBHhAAABCAFbDBAFFDA.VBGBhAAALHEGAHAF..MFCBhABACADCKBADRABB.JAHF.fCEA..hABA......hACA...,2,-22,-17,5
VEUNcJGBIWYfKdRLCSQFgPZMDXeAOTbHa,ODACHEFHEDCDUBCEJHCE.BFDG..IAHG..fAAEhABARBDHSAAHFGBDZFFChACAMGBCeBFAAFIBaGAH.hADA.NHDD...WADEYEFCKCHBCHGA...hAAA......hACA...,2,-25,-22,3
ecRHMZBWAJYQXCgTGUSOadIKEbPFNVfLD,JDACQCGC.CAHDGGDFSFFGdCAFKEDEECGG..FACGVEBBhAAADIEE..RAEF.HABCBHHGhAAAAGABXBED.hABA............hAGA......hAHA...,2,-51,-11,40
MeRQJLDNHCWFAaZPcVgBfOXYdbSUKTGEI,aCFCZAAD..VDBDBFHG.ODACdFFAUAFFGGBF..MDDCRAFAQDDChAAADIAC.CBBAABAEhABAPCHD..cADBhACAXACE.SGEDKFFB.EHGAhAAA.IGAH.hADA...,2,-26,-20,6
ROcGMZdBHPgWUSYVCFfKENeJQbTDALaXI,aAADREFHGBEGZBEE.BDHDHFDD...PCCHUEBASBCDhAAA.CCAD.fGHGhAAAEFHF.JCHBQAGChABADADCADFCXGBH......hACA......hAGA.cEEF.,1,-16,-29,13
MHTNPabLODGRfUBIXKcJYegZEQVCASWdF,SAFBdAFBFCHBHDBG..TCDEaBBAOHFEGABH.REAABFFBhAAAXGECKGED..JCHFeFFAhAAAEHGE.CDAFAFEGMBAF.hABAPHAEDIBGIGBC.....hABA......hACA...,1,-14,-17,3
gSANUQeJFbTYcPdCVGBXIWRKZDHOMLEaf,UCGCQFCAFCBF...TBAA..PHFEVAEHGBGEhAAABDEE.XFGEhABARACAKFFFHFCFMICAEFACaEEFSCADhAAAAHHDJDBB........hABA......hACA...,2,-32,0,32
QNKOLbadVYPFRfMgATJZcIBCSHeDEXGWU,JADGZAADBAHEHFEHDGHBEDGG..GCDEUFCA.KFBELBAD.dBHEhAAAPGECFDCA.MIFAhAAAAAHE.....IBGEhADA.CGADSAECWCBCNBGE.aCCBhBAA......hBCA...,2,-32,-29,3
bPJRHeWXFdDgKGCZfOIVMBEaLSYNcQUTA,JGEARDBGeFEE..FCDBDBBHGCAG.ZGAGOGAC.MADGBEHGhAAAaGEHSADChABA..NCIEQCFDhAAAACGFbAFA.PHFA.XACCdEEFKHDACBBBhACAfFBB.hAGA...,2,-27,-14,13
EcFNXGTWYUdJReZCVHSObgfPaIABMQKDL,QEBCLEACFBAHGDGA..TBGGUCDAJHBERFBFZFFEHAFGhAAA.SBAAhABA.OFFHfCCBhAAAIADEBEGGDIGA.......hABA......hACA...,1,-7,-39,32
IFBAYWHJPUSbCDNELdMRZXGTfKeacQOVg,HAADJDAC.UDEBCHEA.EHCEdBCHZADAGGAF..KHAGeAEGaDCDOHFGhAAA..gFFEhAAAFEHHACAH.PCFAhABADCCALAHH.MGACXDDB.hACAcEGA...hAEA...,1,-12,-26,14
cZHSaETeANKJWODdgPMbGIVCRQUFXLBfY,JCCHOFCH.dADCMIFAGCAD..CAGHRDGFFFFE.BBHG...hAAA.fCAEhABAZFDFaBGHeFHHKAECDEEH..hACAgAAAPFCB.......hADA......hAIA...,2,-46,-24,22
JNARKLZEUeHcBgdCDFGQTWXSPbOafVYMI,RDEDKDBDLAAAUACDHFCGBAFD.dHGFCDEGGAGC..QCGEhABA.TFCChACASAAB.ODFDhADAaEAEfHAHMIFGNIABAAGHEFHH....hAFA......hAIA...,1,-24,-26,2
WENJGYdQaXbZLCIUHfSMABPDegRcTFVKO,BAEDDEFHeECBRDGDFDACKCAA....OAFDEAGBGEAAdFDC.aACBZBBChAAA.CHAH.UGEH.SDDChAAAAABE..hABAPFFH..cAEH...WCHHhAFAYAHH.XFAAhADA,2,-39,-36,3
TCPLgONbMYJSeGBfZXWVQEUdcFaHRIAKD,TCBFCAFBLFEC..OEHDMAAB.JDFHeFCHBFBDZDAB..XGAGhAAAQGGFEAECdHFHhABAFBCE.HECDIAHGhABAKACEDBIFNEEH.SHCAfCGF...hAHA......hAIA...,1,-15,-16,1
gSBLdCITROWcKeNQDAFJabVfMPHZEGUXY,FEEDaDCD...VCAHMDGBZBGBUADD....XAAESAGHhAAALFHDdGBFCABEIEHGhAEATGBH..OAFBhAAAKHGAeCEBDEDHAIEA.......hAGA......hAIA...,1,-23,-33,10
XHOTCGbMKEaILUeYAJNRdVgFQPfBWScZD,JFBBRDAGdGDH.FCCEQCBF.BGGBSGAGZBEDDAFA.OABChAAACACG.GBGGKHDE.hAAAaGGELEDA.hABAeEAFNBFG..........hABA......hADA...,2,-37,-29,8
YQVRJGPXTBCSAEbeaLgUDHWKFfcZOMINd,eCCHLCCHUAAFDAFGKEECFFGH.ZBAF..MEIDdCGD..QFDEhAAARFAEJHCG.GACFhABATADFSHCGhACA.AFIFaDAHgGFB.fAHChABA.IHAEhADANEEF...,2,-36,-8,28
TcefLOUIdWbYAJGRXQVMKHCZPDBaNgESF,JEGHRCDFQBAC.KFFGHBAH.CDEEZDBBBFAA.aCGEEGADFHCATADChAAA..eACBhAAALHCEIFCAbBFAAIHGhABAXAFE.MHFCDGDA.SEAChABAOAFA.....hACA...,2,-19,-15,4
KGeSgRTaBQJPHMLVXNFYfDCcIdObEZUAW,GEAHSDCDRAAFBHDAQDDFHBECLGFA..XCGHhAAAFEGFDADCCGAGdABCODCAhAAAbADAEFFD.AFACKAHB.hACAgGDE.JHAAMBID...hADA......hAEA...,2,-18,-15,3
eMbHcLIfEDPFBVCNWaAYUKQTZdORXJGgS,KGFCTCCBOCAF..XCGFGAEBSDDCMDFDHFAELAAChAEAECHH.DAFFBECDhAAANDIAAECFUGEFdHCFJBBC.hAGAeFABIAHFfEEH....hABA......hACA...,2,-23,-4,19
CUKRHgJYMWcTNDaPZFGSXBAQEdVfeLbOI,EFHBdCFCeEAGLEDBOHFACHBC..UAGGRCAGHAFG..JCDAMIDEhAAA..TGFGaFAHFACEhABAXEAFACCA.QABGhAAAfEGCKADC...YDFGhBAANDEADCIF.....hACA...,1,-12,-15,3
dVOTKZfFQaPUEDGgNeMXIbHBCcYRSWJAL,LDCHdDBDOEDEKCEBZAEEQBGA.UACGDHFEGCGEhAAA.NCAG.MEGH.IHEFhAAABCBBCGCC.cFAHhABA..YABESCBDAHIH.fEEEhAFA.aHACEGDHhAFA...,1,-20,-36,16
VBfHaZKWSACgEFIdMOGTQYURXLPcDJeNb,EEGDFAFBdDGCGDBE.QBGFRECDLABDDGIDeFEG..VFDGhAAABHAHaAEDKDDC.SAHDhAAAAACDIHAAOHEAhADATBAC..UEAA.....cACDhAIAJDDENIDF....hBAA...,1,-2,-25,23
PaZMTCSVeYJWAQIcbHNEKRGXDLOfUdgBF,QCBC..IFFCHABGKFCFRAACDAFHOBHDUEAHgBFHhAAABCCHFEHBZECBTGGFhABA..CBHF.SHAGhACA.VEEHeBEDWAFC.AEDD.NIADEGHFhAAA.....hAEA...,1,-11,-33,22
bdRPGVNfJBCIOWcgDQKZULYTHeaMSXFEA,dCFCREBHGBCF..fHBHJBAFBGGG.CDCD...OEHF.hAAA.WGBEDIBAKEEFLAFAhABAHAGDMFABXACDhACA.AFHE..VGFENAAF..IHEHhAFA......hAGA...,2,-28,-28,0
YgAQJeGBRVSMWLNPaCbOXEUHfIFKcTdZD,QFCAGGCBBAAFSAGBMAGFLACFaCBD.OEABUGGGHABGhAAAFEEAKHAATCFFhABADIGEAFDE......hACA.eFAFRADBNDIECFGAEDDE.fEGF.hAFA......hAHA...,1,2,-22,24
dSTfBEGCIaMQXeRVKFUcDgAHNZbJPOLWY,HGFGZAADJFGFOACG.LFDBdAEE.SAGCTGBCBHEChAAACAAEaCEE..QDEGhADAeDCGKHBEFFBCDBGDAAGE.hBAA..PEBA.....fAHAhBAAEFFAIBEC.hBCAMBIF.,1,-19,-29,10
BOdQgSWRDXPNTVAHCYfUJLFbZGacKIMEe,CFDDUCBCFCAH.ZEFAGCCHKGGH...EAFDBHBAdHAD.QCGGhAAA..WABEDBBC..hAAAXECETGGEAEHCHAEEhABAJHDA.LGAC..aEFCcGDDhACAIBCEMDDE...hAGA...,2,-33,-13,20
PRbHgcSWAXdDeYKTFaGOULNJVCfMBEQIZ,DDFFKDCD.FEACaHAEGBAHLEFF..JCHBCBHABBAE..EFHHQACChAAAZFCD.RAFFHEABhABASGGDAEEHXEGHhAEAdGEA..........hAFA......hAHA...,2,-39,-22,17
UOCDZMRfVFHcKgEaIAQPbNSdGTJeYBLWX,QCBC..NDHEdCCGTAEHeAABBAAFLAFEUEFGDHFAhACAZGBCREDCFGDBKEAF.aCGBACGCSGAAhADA.hABA............hACA......hADA...,2,-34,-31,3
cVGNaSFgOEPbWAdTLMHYUKJCZDXIefQRB,dGDDLAEHMDEBUCFDCCDCZGAC..DEBC..eFBHREECBBGFGABF.hAAAaAAHFABA...EGHFhAGAPEABAGGE.TGGAhABAKCGA...XCAAIHEC...hACA......hAEA...,1,-20,-39,19
QAUYKdOPDTcfNWVGECJbMLHRXZaeBISFg,KGFCOCCHDCGD...TEDF..fAEGVGAA.EDAGCEAGJBDAhAAALHAA.HECAhAAARGFCaDGHBCDEFBAFAIEG.hABAdAGFNIEB....bBGBMDIFXEGA.hABA......hACA...,2,-20,-18,2
WFHNBLgQebYGDTROfAUKdaVcIMCXEPJZS,KFHBdEHAaDAD..IGEECHCF..XAGEJEEE..ZDAFFDDChAAABCCDQFDBhABAeHBGGABFTGFFfHFFhAAAACFFUACCMCGFECECSDGE.hAFAWECB....hABA...,2,-36,-16,20
dRVgWbfcNXABQaJHFGSDMKLUCYOeZPIET,BFCFQGGDJCCG.HDCDFBGD.SBDC.DGBBKDABLAGDhAAAUEFBOABCZCABIABChADA.EDHFTGAChAAAdGEA.RGEA........WAFEhABAfEFE.hADA.NCIEAEEFMFCF,2,-46,1,47
OCBfAFVaQcJUTZGSdHPEgLNXebIWRMDYK,FEHBQCCBUBAEZGFCSFAE.HEEBEFBCLFEDhAAAeAECICHBMFAFKHBEOAAEhAAABCEDAAIHaFDH.cGFDhABAJBFGdCCA...PACA...hADA......hAEA...,2,-21,-14,7
TKZHPUOeabCLfENXRAVFWYIJQSgDMGdBc,VDAGFHBG....IGECJHAC.QBDHDFEGdDGFBHHGKAFCHCBBhAAAUAGE...aDGHhABALABCEGGC.XFBAhAAAACGCSACCMAFF......hAIAcCCF...hBAA...,2,-33,-29,4
TEbYBNAIgeLfXFUaGDWcPSZVOJRHQdMCK,eGEALDACFAEFUCBDDGHF....PGBCZCEEOGBAHCFFMFIFhAAACEFB.KBEBEHBEBBAFhABAACAD...IHFEhACAfAGFaEBBWAHHSBAE...hADA......hAEA...,2,-33,-27,6
fULKRECYGWMSBPAQNaVbXTOeDFJZgHdcI,aGFCXFDH..TBGDDDGCZABBHFABdGGD...fECEhAAAUFAFKHAACDEBGACE.hAAASGEDBBEEABAA.hABAVEFGOFFAeBAD.JAEE.....hAEA......hAFA...,1,9,-39,48
QIYVRTDLePHOKBZaSWJMbGAgXcdUEfFCN,XCBCUGBCFCDB...QFCG.VAEBDBBHeEGD.hAAAHFDBOGFABAHDaEEEhABASADGMIFEGBGChACAAFFBdCFDfHADCABB..IEAAhAAA.....hADA...,1,-14,-35,21
MgZULTFQPNKJfERaVBHXebDGOISWdAYcC,CFDGMECGZAAFLAFCFAAD..QGFGKCEE.EBGFaEECBGBDhAAAeHCADGADGBGEOADFhACA.SDHFhADAAGBG.gFDDPEAAfHGF.hAFAHACD....hACA...,2,-23,-19,4
bZIYPfUWeMcKAJBLRQGSXdFHCVgEDNOTa,JEGHBEFALFCERFGDGCBC.dDDACCCA...EHAGDBAF..OHDEhAAATDADZAFG...IABChADAfGCHeCHDhAEAKAFCAAFE...SBGH...hAHA......hBAA...,2,-48,-19,29
bKVNZgWBQYXdROLSDMEGFCHPecTAJIfaU,JGEAaHBG..KDCEZCAFBBFC..QGAGdGFFLEFADDGCMCEBhAAAEAHH.GABFFDGGCACD.eAEEhABA..AAEGUECFhAAAbFCD.....NABE.......hADA......hAGA...,1,-20,-34,14
KNZEBDLMJWcVFQbOHaIAdGegSXPYRTUfC,dHAFeFEFSCBC..XGGBRFEFUBFDKDBHEAGFLDCEhAAA.MBBEJEDB.VFAEhABAFHGEOABAIHFEhACAAAAF............hADA......hAEA...,2,-38,-23,15
JeURCNIfcAPgKMSOaWLQHGEBdXVbFZDYT,KHBGOECCLDAGHBEDGCACEFGB.dEGFVCGFFGHDDAGE.JACFUBCBhAAA.CGAG...fHBDhAAAPGCA.MHDGhABASABF.QAFFBCGA.hADA......hAEA...,2,-20,-18,2
BAdbJDPZWIORTfQNMHLKUVYFCScXGageE,JCCHZFDGOBDH..RBEGQGAEHCFCKHAGUAEAFHEA..CEAB.SFHHhAAAGDGEaAAC.hABA.gDAEhACABFFGAHIBDAGEIBBD.fAHEMACE.hABA......hBDA...,2,-32,-15,17
ObIMNUJWXdCRDcYaBZPKGSfQTHgeVALFE,LEGHFEEDEACD..OBEAIFAD.MDDAUDGH..JBBCXGGEhAAACCGE.DICAaFEEhAAAZFAAKAHB.GDAFhABAfDDFHGBAeADGAGGGNADF....RBAB.BCAAhACA.....hABA...,1,-5,-26,21
cJDRSgKFNPIbWOVQdGHTEBLeaACUXMZfY,XABHMECGZABG......fCFEcFAG.DIBESGCHhAAAFAGD.NFEF.IGAAhAAAODFAdGGFTGGGhABAEBDEBDADaCACAAFF.CBHF.......hABA......hADA...,2,-31,-30,1
XDVYHCLOdbAgeSWRNGUTQfKFIJBPaEcZM,SDCDRAADGGCHQAEFFFDDBBCD.EEFHMFBF..DDEFHBEEhAAACAHHdGGEABAEeDEA.UFGDhABAfDCEKCABPACAhAGAaFAFZCGF..YAHH...hAAA......hACA...,1,-10,-17,7
ZATYXORPQUHVKSEfWedcIaJDFMbCgGLNB,TCGCXDAC.RFBF.QCDBHCDF.VFGHEFFEeDHB.dABGhAAAaAABDBGBFFEHMIDA.hACACACA.LEAEBAHAAAGA.hAEAOHAA.KBBB.fAGCIGEG.hAFA......hBAA...,1,-9,-14,5
eBUYTCMaKZdFNRcLAEPXGOgJHQDIbfSWV,XGBCOFEFHAFEDADG...IEHB.SGGGhAAAeEHDUDDDCCFDKEBHdBBBNIEHLABDhADAEAFH..PCAHhAAAJHAAfEDABCGFMCCD.aFGHFADDAAID..hAFA......hAHA...,2,-17,-16,1
OQeLGfCKYUVSAEdDcFMWHbBTJXgaNPRZI,DGGDFGFHHAGHBCFH.JBBC..XCCA..NCGAZEBHOGBELDDFhAAACACA..KFBC.hABAUAFDAHEBdGAEMEIH.hACA.bAEBaHDE.IEFG.GAAEhAAA......hACA...,2,-36,-19,17
GHYRUgSXCJPfADKBeVacLEZINTbMdOWQF,DFEAeCAF..aGDCEDEFZBFA..TAGGMGEAdADAOFAD.QFFFhAAAGCACHAACYECBhABARDFESHAChAAA.CAGA.JACAAIFABDDFcGEC.ICDFhAFA.NEIGWCFB..hAGA...,1,-11,-17,6
gJMZQYCbeKSHGDdaONLPIRTAXVUFcfEWB,VCDBFGFCEHDE..BCAGMABEZCGD..CDEA.eGEGKBFE.HAAEGDBEhAAADAFB.dBCFaEHD.LHBAhAAAREFGAFAB...XEBDhACAcBGDfHABgAGC...hADA......hAEA...,1,-15,-23,8
IWBFgZPAXfMCHTedRbJOcQGLSNDYKEUVa,MFFFCFFCHCAFdBFGRCGD...ODCHGGEFLBHDSEECDACGEHGEhAAAaABEBCDB.FGCDZBAChABAAAIF.fFAEhAFA.TGCF.bBDDQAFF.hAGAKGAD.....hAHA...,2,-16,-16,0
KLIPJTHBMZOUgDYEbaeNVFQWRCGfSdXcA,LCCHJGEABHCA.MCECZCCB.UEGD.DHDCEAFF...eAHFVFADhAAAQABB.hABA.CGHDSADEhACAXFACAEFFKCADIEEE......hAGA......hAHA...,2,-37,-35,2
cESNUDaATZBPGVWOJgIMLeYRCXfdHbQFK,TGDCBFDDGGEF.OEBHJACG.MCEFeEFC.CEDF.dAFHQGAGhAAAKCFB.EBFENACEDIAAhAAAAICGZBAF...PCCEhABA..WDHFIGGC.YAHHhACA....hAGA...,1,-23,-39,16
PUdfMTOIEaAeFZSRQYNCWbcgHLVJGXKDB,eDCHFEHBRBAD.QFEE.CBHC.bADFHBCCLFDBGCAGXAGGhAAAKHAADACE..BAAChAFAdHABTDECOHDCIDHAhAGAEGFDAIHE.SGGE...hABA......hACA...,1,-6,-22,16
VREgTCHAMcONGFZPfbUJIXdSYDKQBWeLa,OCHDFGAHZACB.....fAFDbDFAUEBD.JBDB..XGGAhAAASBAD.DFFGhAAAKBAGQGGGhABAeAFHaHDCECGAgFDB.CBCFMFBH.cCFBhACANCEEIFFF.hADABAEA.,1,-15,-24,9
DTPJNHEZBOXRcLbVMFSCGWAeIYfKadgUQ,eGEA..fEGDKCGCdEBGUBDGTBDD.JHDAEBADBAAAOHBEhAAAREAB.LEEAhABAMDAACGHGAACFaAEAQAGChAAA.DDFBNDAE.........hACA......hADA...,2,-25,-20,5
DSACEdTeNFYZIBPgQMKXUGOVWRHabJfcL,CEFAdFAA.eACDFAGEZFCBBGFF..QAAFKDGEGECG..OHFGhABARAEEaHGA...fCEFhADADEEEAIAA.EAEC.hAAA.NABA.IEHE.MBDH.XEAChAEA....hCAA...,2,-33,-33,0
BQGUKecFMaSRHfYZTALCJgIVdDbOWXNEP,LEGHCAFB.JAFCIHFC.dCFAOGCC..XDAAhAAAEEDBQACHhAAAGEDA......hABA.eCAFMIAAaCFBRACEfBHGZEAB.hACAADDBDBABNEIGBCGAKDHD..hAEA...,1,-21,-27,6
QACHIUeDXWKRJaYZfVbcFOELTgPGBdNMS,HDBHUDACDGBDKBBCRDGD...aFEFZGFA....VAFEFEDDEBCELADBhAAA..PCGFhAAAdGGHMIAC.AIEECGDBIAEFhABAXFAH....YAHHhACAfCAA..OCEFhADA..,1,-16,-35,19
HgaNOCeQBWPKAdJDUcfIGZSbFTXRELYVM,DFDCUCBC....fGFBZFBBFACCRFDHLAFBMBEA.HDGBhAAANCCC...OEAHhABACACBBCHE.KDDCAIGC.JHDA.hAEA.cDDAIBAHSGGGXGACYBHHhAHA...hAAA...,2,-49,-10,39
TVDFPCAGELKbUQMcfdeWgOaHXSRJYBIZN,ECCGKDCDUBBB..MBHHdEFD.eADAOGCCHBAB.XFEFhAAARBEEBABB.IGGD.hAAANDIC.DICGFECGCADEAAHHLGBEhABA..QFAC.fGGGhAFA...hACA.aHAC.,1,-10,-43,33
XHWgVISUJNdEGecBAbQfRCYMFKZDTPaOL,QCBCCFDDFCAB.DIGEaCCGLEFG.HBDCVBFFSGABhAAAUFAE..dHEDeEDFhABAAAIFREEB.KHDA.TCGChACA..OAACWAFE.IHHANGEB.hADA......hAEA...,1,-11,-35,24
YTZJEGLASebaXOgWHfCNcdIFDQKBPRVMU,eCCHXGBCOEFGHDEH..CHDD.dFHGFGAEQADEKFHD.BCAAhAAAVAFFMACF.TCGEhABAJBABEFDAAGGFSFBEhADAaABA.fAHE.NIEF.DGGBhAAA......hAEA...,2,-32,-3,29
fCdOPbJNDeWLaAEXBGKcVRZMIFgTQHUSY,EFFBBDHHKDCERACBZGFA..MDBHFBAD...QGCCSHCGCAEFdEEFhAAA..ODEAhAAAPAHHJEAD..DABHeFCChABAaGAHACCCGAEF..IACA.hACA......hAEA...,2,-27,-27,0
LRbSTfWQBVaKIMDAHeZONgFPGYXdUECJc,HDBGOFFCFAFBGDAAdHEFCHBD.LDDE.RACG.TABAQFCAhAAABDGEKFFADAIBeCHDhABA.NIDF.....hACA............hAEA......hAFA...,2,-50,-13,37
cgPXSQKCVfEbMdZRTNYaILHOFUWJGBDAe,eGEA..gDACXCFG.SFFFCDBD.EACHbBAAdDDChAAAZEDGTGCC.aEGAhABAIABALCFGFFBBhAAAUGAEJAEABHHGAHHDPBFAKHCAMAIF.NDAE.hADA......hAHA...,2,-18,4,22
VKdWYXDgLURIQNcFTHBbSOJEPGMZaefCA,VFEEKAFBdHAD....XCFFLFHDRCBD.IECB.QFEFhAAANIDHFFACBAEDSDBChABAEABA.PACAhAHAZGAEfEDF.AHHGDAAFcCGEhAIA......hBAA...,1,-19,-34,15
faVcASBIPUbKdgEHXCeTGNJFDWYZOQMRL,BFEDUCBCKFGBEDCAHDFC..CHBFGFBBJFAFFAAF.DHECZACE..QAFFhAAARBECLGDA.hABA...fCFGhACAcEAA.AIGGIEEE.dDAC.eABAhAGA.NCIC....hACA...,2,-28,-15,13
QJUaTFRfIVWdLXYBcSbOCDGMAENKgePZH,EAFBKHBGeAFEHFCCJDFGUBED..FHACRFGF.....VBBGdEFEXAABhADABHFF.SFDFhAEAODADCADEDAGAAHEA.hAIA..NAAA.PCCBaGGF....fHCBhABA...hBAA...,1,-19,-31,12
IdeSOHfTcJQLCBUFPDbGYXAWZgMENaVKR,ZAADMHFGaFAHRCCC..dFBHOHBCHEFG....TABAQCFChAAACDABFHCC.PEDB.DGFAhADAbAFAGACF.AIFA.hAFAEGABKEHBSEEDfCCCJCFA.BAEChAAA......hABA...,2,-9,-9,0
CNRbMLBDZJeAFQUaEcfXVWHPISgOdTKGY,FEHBQFCAUCAC.aHAEEGAD....fGGDXEEDHGCEhAAASAFBOCDGKCDFhAAACHHHRCFAMFFE.BBBChABADBGGJABGeCABADDH.WAHD.gCEBhACA......hADA...,1,-18,-23,5
OaYBNZeWJESbXAKQPTfCVdUDcHLIMRGFg,QGBCTCBC.CECC.dEDGDDDGLFFG.MABGFEFCaACCNHAB.hAAAeAHH..EHFESEAFhAAAAAFCKBCE.fBFFhABAUCFHcAGBIGHF...hBAA......hBBA...,2,-32,-21,11
abHDFZVPWGETAIUgLdKOJfMQcSYCeRNBX,UCBCdDCDKGCDODGD..JAACMAFH..QGEBSBGAhAAACFAA..RBCC.BADG.hADAaGEAHAFDFGABZECEVDGFhAEA....WFHH.EHBAAHIH....hABA......hACA...,2,-31,-28,3
OKXbePLdDFBfMEaGIgJQVcZYTNHWURCSA,KAADXDACeCHDLEAFFBGF.BADCMACFGDCD.JHFGVDEAhAAA..ZFDETGGAhABA.HFBGRBDECFBDABCB.hADAOHBCdBDBDIBC.aGAC......hAEA......hAFA...,2,-20,-17,3
AUBCFVKXMNgPEdJGSLWOcQTfDYRaeIbHZ,UGDGCBEAKDHB.MBEA......PAADJFAELCBA.hAAA.OHCGQFFChAAATDBGDACCRFAFeAGHhACAICHCZFFFAEFGBAHB.XCEDEADASEEDhADAWBAC....hAGA...,2,-32,-27,5
MWbSUeZTLIEKgfANFOPcYBXVRdHGJQaCD,OCCH..PFCABFEGRAFHHCEAGABFJAAF.CFHA.DIAE.MADChABASFAGZFGH.LAAFhACAKGEAAFBBFAHBXDFEhAEAdBEBaDBE...WFFB.eHCE.IHHAhAFA.fHABhAHA,1,-15,-29,14
QRJWaZUGgSAMXbdEIKLTCBeONPHVfDYcF,XFDBdAFBEAAALEACBBGH..OCHFHGDCDGIFFCBA.QCGFhAAAREAF.JEGFWAAGhABAZDDB...UGFFSCBChADAMADGKCEACGBANIAF.......hACA......hAHA...,2,-33,-3,30
DXFLSHZgRIQUMfYdEVKGAOPbTNBJWCace,OGEATCBC.BAGCCFAG...aAABDHCAFDFAHEFE.RADGUEDEMIDEdCCEhACAEAAC...KCBFAHAF.hAAA..NBIG..JEAFcBFEhADA.eHEASFCH.IADHhAFA...YEEAhAIA,2,-30,-28,2
BUZFJeAXIGdCfPORYVDgHKbQcaMESWLNT,XFGHdGAHCEHB..OAACRDAADBDH.HGFEKGDA.QEDD.hAAAMDCESACChABALCABBFCC.ZAGHFBGChAAAAFFAfFAEYAEE......hAFA......hAIA...,2,-42,-13,29
UMgZFLWARKGQdCJaBXESHDeYPcTOIbfVN,KBBDQECBdGAD.CDCBBBHBSFFH.eCEB..YFFHhAAATEAG..IHDHhAAAfBAC.UGAAhABAZEGFWDDDAAFGJHCCaBFBXADAEDAFDCCE.PFHBhACA....hADA...,2,-25,-25,0
AIWaSQYBOfZRULPcCDgHVMFKGXeTbENJd,aHBGQGBCBEDCZACGUFEH.LACGCEAH.HAAFFDGDKAGFGAGChAAA.TDEEEHGGdCDBhAAAACEC...SGDEhABAfFHE.PEAEDDACMEIB...hADA......hAEA...,2,-35,-8,27
URaegIFHVCfYQTBGbDJZOdNMSKEPcWXLA,aDAFeGEA.FAEFHEFA.CCGG.QDBFBHEBDBCCZAFGdDGASGAEhAAA.KCBEECDG.hABAPDDB.XFAChAAAAFDG..........hABA......hACA...,1,-35,-37,2
beaPJIZONYUfMQLSRAWFGEDTKHdcCgBVX,GEAHTCBF.KCBDdHEHCFGG.BCGD..XADFeBEH..aAAEJACFhAAAOFFE.UFAHhAAAMHBASADHhABAAAGGEBGDDHFGHDEE.........hADA......hAFA...,1,-27,-30,3
LJgAfTDZSHWGOBEKRXbUPQVFCNdIcMaeY,TAFBZEEEHAEC.GCBHOCAABCHF.KBBEXEFHUFADQGEAhAAAVDADFEDHCADDdGHAMHEAhAAA...aCHD.hABALHAEAEACDGDD.EDDE......hABA......hACA...,1,-14,-16,2
PcSOLBEdbNfWJMeYUgTHCRQVIAZFDaGXK,FGGEDEFAGGBHKEBE..SGDBBBDAEAADdFAF....fBFEhAAAMAEGUGFATBCEhABACACBRCDA..QBGEhABAAFHCZFEHaHBCcAFA...ODFEhACANEIA.WDAF..hADA...,2,-36,-20,16
WaTPJUGHIBdEDNZKFLCOcbgQRAeMfSYVX,MDEBSHBG..VBFEXDGH.aAAFJECD.UACGHGDAhACAdEHEDBEFZBABLAFChADACFAF.OEAC.hAAAcCCCQGFGABGHfHGFWHAG..hAEA......hBAA...,2,-28,-20,8
FTefPbNBaQLZUASJgMRYGXKDVECcOdWHI,JCCHMECGGBECKAHB..EDHFOEHB.dAAFIHDD.eABFhAAAfBGE.hABA.PFACBADGLHBAhAEAAAEGSGGCgGEBRAFBDADBCFFF.cFAAhAFA...FAHF.hAHA...,1,-18,-29,11
VbXKdRBcHNQIYAPfgEMFCOSJZeDGWLTaU,...fDCDEBDHMEADOGCGZGBEDADGLFDEUDEB.XAAChABAKBGGBHFDHAFGNADF.hAAAICECADBF.FHGAhACACGGBSABF.eEHB.WFBDhAIAaGAB......hBAA...,2,-35,-10,25
VQADcBCTXZLHEfKFIObJMegPWRdaYNSUG,DAEDCBBDZFEEECDB..FCEGOGAA..JDBCeHFE...PBAFhAAAdGBHaAEC..SDBHhABA.UDFAhACAQCGEAGGETAFHLFADfHCFIACFhAAAMAIF...WGFAhABA..,1,-27,-42,15
ePBXIWDFMNCTUGQHcdabZKLYEVJAfSRgO,SCFCRFDFeCCHBCAG..XFABDBECFDGE.MCIH..TAAChAAAUCACHABG.dDGGhAAAaFHFbDDDKAHBEGGBACGGOEAFhACAIAHH..CHHD......cEEAhADA....hAEA...,1,-4,-36,32
UOVRHFIQDPGJBfcKgdLeAaECZTSWXMbNY,aEHBCHCHZEFC....SGEBMCEC...NAFE.OBCDHBBDFGAHhAAADACGJFBABDAHKAADdBGHhABALAFEEEDG..hABAXGGE..YHEE..hBCA......hBEA...,1,-19,-45,26
CWdRQAgKZOHLTaIVceFDJYEGBUXSMNPbf,KCFCZDBGHEFCLFHBaAGB...VBAAFAAFDHBA..JGAGEFCEBAGChAAASCAG.MEADhACANBEE...fGEAhADAdEAFAIEEOGEEIHHF..eDFAhABA......hACA...,2,-32,-18,14
LIMNDQFPAESUCeYGgBJTcafORdbWVHKXZ,SFAACFEEGCCDBGBF..TDGD.aDDCfAHAhAAA.dCBCbABCHDGHXGDHhAAALBAEMHACDFBChABAQDAFAIFCEAFDYFHBcGGG.OAFChACA.WFDE..hADA...,2,-21,-13,8
SMJbNcUDXKFETYCZWaAgLeOdVQBGPHIfR,LEEGdAABBCFDGBCAHADARCAAMIDA..JHAA..NGABDBIHKHEEFFGChADA..TAAGhAAAZAEEAGAC.ODEG.QGGAhACAIEAASEEH.UCGEhAEAEGEACHBH.aBFE..hADA...,1,-5,-30,25
PCaSNHLEYZMgdJOAbVIDTBFcUWQRGfXKe,VAADDAFBBBAF.FDBBUGGE.REBG.GAGEKAFD.eGBA.CEEG.SCGHhAAAHGFGLADBhAAAEGDCZCDEMDIF..hABAdADGABCC.IGAF..WDFB..hACA......hAGA...,1,-24,-25,1
AXIOVRYQPeCNbWdMJSBUgafcKTFLDZHEG,XDACOFBBRDFE...QDEDCCDA..bFCDMBDC.BCBAhAAAaFFCKAFDFHDELFCAhABADAACHABC.EGGGAAGEICHFhAEAPFADNACBdCHESGHH...hAHA......hAIA...,1,-12,-24,12
WXbGDBgeSacYCPVIAFRQJfHEOMdLKUNTZ,QCCBJFBBHDEH.MFFCdDAELBCG.KAHDTEBAZDGF.hAAAXGCADDIHBACBSAHFhAAAaGGC.CAFEIABFhADAAEDD.fHGH.EAEBhBAANICF......hBDA...,2,-30,-28,2
fUgZDdSOMPJcbHXNLABQFYaVRIGTWECKe,BFCFFGFC.aAGERAEFGAAC..TDDHEDHFKGABeHAA.UGFEhAAADDCAdHCFMCAG.JCEA.hAAA.bEAG..NADDAEBG.hACA............hADA......hAEA...,1,-30,-33,3
QcEBeNgKXAdJLUHZMPfWCYRVTSaIGObDF,JFFBUAEGHBAEZCEE..MHFC..fCFACAAB.RFACSAEDhAAAaGBGGABEDDBBFDAHEEGEhABABFFGeAHB.KEDAhACAAIGEdEGF...PHBC....hADA......hAHA...,1,-8,-34,26
FWRfUXJaTPGLYbeAIZMOKgEdHBScVQDNC,ZFACKFAGdDBBHCEHBEDHVCAE..DCHFFAEB.RFGF.UFGH..aAHHGACHhAAALAAE..hAGAeGCAAFGHMIAG.EHEEhAIASHFA.NAIA..CBAA....hBBAfCEF.hBCA...,1,-10,-39,29
cHOXCMAEgVBdTISYfJNDLbKWZaFUeQRPG,ECFCBFDDdGAGSAGE..JBDFDECDLFFBKCBEZABAUGGEhAAAeCBFRFBFGDDBHDFCCHHEMDAFhACA...AHCE.TAAGhAAA.fAFFWHBGFBGF....hACA......hADA...,1,-17,-26,9
CZEODfVMNPgJdKIeaRSBHXWGQALYTFcbU,LDACFGFCUECCZCBGDGACMCFD......NADH.PHCEhAAAdEHEKHDAaBFA.BHGGHBFChAAAGDGAABCD.cECHhABAEGBB...OACAfEFBJBBC.IBAHhABA...hAGA...,1,-23,-29,6
BZKTPfeGcXWRYFELOHADQCIbMVgJNSUda,DEFACHHG.MDDFJBGF...UGAFdDBGBAEDZFDD..KCAH..TFEAhAAAeCDE...GACEhABAXBGBRGAA.EFHBOEHFhACAAAEF..bBBFNICF...SAFChAAA.fGFEhABAcEDBFAGA.,1,-22,-34,12
DQbYNVFSCOKLUfIWEHJXTacdeAZMBPRgG,ZFBHMBFHBHHDREAH.DDEHQFFC..bAABVCGB.CAAALEDFhAAA.UACChAFAWCCCECBBHGDG.TDGGhADAdHADAHIF.GAEF.NEAG..SDFFhAEA....hAFA...,2,-28,-7,21
DQOEWHCNRadYSKXeBJGAbITZcfgFVMPUL,TCBCZAAD..fEFGFGCD.MDEGPBFA.LGFChAAAOHCAEBFECHAFRADBdEEBSDCGhAAAKFAEBABCAAFEIAHEhADA.gACADDFC.HFGBhBAA......hCAA...,1,-23,-24,1
AJIHKLMbWFBSZQOcGDUfgCaPXdNTRVeEY,JFBBHDAGLAACMHCAFFCEZAFH..OAADDEAE.UBFHCHFG.XGGEhAAAdEDBREGB...eFAHhACAECCEAIHEKCCC.BFGGhADA.SEEB......hAEA......hAFA...,2,-45,-14,31
PSHTUDIQFAGVZWcMBeaLYCXNdJfRgEOKb,VDAHZAADMAED.BHEFLCHH.XABBdCGAJFEA..RCCB.EGGFhAAAKHAC..SGEBhAEA.TDFDhAFAIAFEFAGGAFDA.........hAAA......hADA...,1,-16,-51,35
bHXQJAOaMSLPRgZEWYeFUfTdGCVIcKBDN,MEGFLCCHREAF.EGCDeACGUBGA..TAAEdAAFCFHA...IFEChAAAKEFHBHEG.DBFHHGCAhAEA.JCDAABDASHAGhADAPAFA..ZCGHFFAFfHGFhBIA......hCAA...,1,-10,-37,27
MKUfNgIdeFJVHEAZWGOCcQBPXDbTYSRaL,ZEBHOFEFCGAGBBBEDBGH......bBCESDDE.aGFBhAAAMAFE.KBHBUAEFhABAfGHG.gEAFhAAAIEGBFCABHDDAACID.WHBA..hABA......hACA...,2,-46,-34,12
eANEGPDUZaLMOJcRdFBQbKISgCVTWHXfY,GEAHDAFBZBADLGFCOGCERDGHBGADKCCC...SDEEhAAACEDC..TCGHHBBG.hABAXGADfCAGhACAAFFAEAGAaGGC.MIAGdGCB.QAEE.hAAA......hABA...,1,1,-37,38
MWDPeaFcbfYUETZgSOVLdJBCGKXIARQNH,QFDHHFACDHFGeAAFaDCE.FDBE....bCAGUAFAZAGBOEHDhAAAdEGDBFECKABHAIDAMDFAhAAA..WFAF.fFBAhABA.TBEE.SGGDhADAJBCE....hAEA...,1,-17,-31,14
ABWCEIUXdNVYgFfHJPbMSDcKZQTaLeRGO,CBBDUGBCdHGF...VCBBFDDGHGAC..JHDAMEFA.DCEEZADA.hAAAaGGALFAC.hAAAeFFFOFAHABEAEDAANAEB.hABA.......fEEEhACA.SEGAhBAAcBGFKACB..,1,-23,-38,15
RWXaCYUfTGQZgHDdMecJKLIbFSNEPAVBO,VFEEBEFAOAAB.RBCC.XCDH.CEHG.UFBCGAACQAFEhABAHEBBDDFEdGGHMBFGhAAA.eFADKAHBbEDBhACANIEBEHCCAFAD....aDGAfADA.hADA......hAEA...,1,0,-28,28
DNFQSPOgHZaIdfVAMBLcJCTYeUEKWRGXb,LHAGJAFB.TBBFUFAHKAAG..RBEHGGEHDACE.QCGAhAAAOHFEHDDFIDAAhABAdBHEAEHB.MFFECGFE.hAAAEECG.XFAEFDBE.PACA..hAGA......hAHA...,1,-3,-41,38
dNVIYLQHOafbcRPTCKBSGWJgAFDEeUMZX,EGCDUAFHZBABdABE....IDFGLEHBHGFCaDCE...fADDhAAAbFEC.PFCAhABAKHFASDFDhAAAGAGEgCCAAGDDDGAHeDABMFAF...hADA......hAEA...,1,3,-29,32
NQKefDJYPgAFMZOdGSWIXTRaEcbVBUCLH,MFCFZDEDdBGFGABG..IFCATGEGEADA..VBBFCAHHLEDChAAAHGFGKFAFDFBDJADEhAAA..PDHHAHEBOHAEhABAXBEA........hABA.cFDBBDHA.NDAE.hADAfDAG.,1,-2,-21,19
dfAEKWQBLOaNUTHPMCSDRZXcGFeVIgYJb,EAFBQGBCBCHELDCCODCC..aGHDTAAFHDGD..MBDGhAAACGDFDEABZFDHGEEDeDAHIBHFhABAJEBF.fGFEhACAAADBKGHB.NCCB.PHEC...hADA......hAEA...,2,-24,-4,20
gABMdDcbISETLKaGCUJVFYHfRWQZOXPNe,dAGEDACB...ICEHSAHHLBAAGADGUGDBFHEEHEGFhAAARFAHQGGCODACXBFHhABAeEBEADAHBCHHbGAA.hADAEEGCKFAACAFD..........hAFA......hAGA...,1,-13,-17,4
OCTGVeYQWJBEbDXgadZHFfSNAUcLMIPKR,UDACMDEBKCAFCBBA.GBBF..VFGDeABC..QGAFhAAABCHAEFHFDHCGaAEHHDEBhABAFFBB.SDGAhACAABEELDFBIGDGOHEETAGC...hADA......hAFA...,2,-25,-15,10
fSLaMRcTWUZgNJbGCEBIKQOYXDAVdPFeH,VDAGdAFBFDEF.HCAELAHBMCHB.REFH...TGFAZBAEJAFBCABDBGEFhAAAKAAE...QEABhACAXGDCAHBE..hADA............hAEA......hAFA...,2,-33,-27,6
OcQYKefJFTHAMgEGUIdNWbBZCSDVXaRLP,MHFGGEAHdEAF..NDAF.BCCBZGBE.CFEB.DEIH..aAGCRDEBLABChAAA.OBGDQGCHhAAA.KDFHJHFEHADDhABAAHAHEBEAIHAA.SCGEhACA......hADA...,2,-34,-18,16
OIDXQbdZYaGLWgEUTFRVPAfcKeNBCJSMH,KHBGeAFBBGGACCED..MDAGOCCE.DAIHXAAE.QDGDhAAAdDGFaFHFLFEFhAAAEHBAFGGEREBAAAGA...fAHAhABANCAG.SEACIFCCbBABhABAGEEA....hADA...,2,-37,-12,25
ZEKabVIGAUHJfeFNQWOLYgDMPTRCSBcdX,HADGJEEG.FCHHQEABLCABDGEF.MHFAPHBE.RACBBBHAhAAAdDCGXABBZFGBKFCA.hABAaHAG...IFGHhAAAADEFfCAF..WDEB...hACA......hAEA...,1,-19,-30,11
cagMLXJEdWBFPKDTUNGAROVQHIYSeCfZb,RDBGVAEGHACC...SGAAeGDCCBCHZAAFaBBCLDAA.EEEChACAdEHG.FCFGDIAC.UDGEhADAAGECOGFC.IFAGhAAA.fHDB...hAEA......hAHA...,1,-21,-27,6
aIGUOecLDXAFWQTdNbZSKHVCRfPJYgMEB,QGBCdGFCZAAEKEAAHCDBREBG..JBEGMEIHEBAA.BHGBGEGAUDFChAAAOFAH.eEDEhAAALAEEAADCFGEH.TGBDhABANDDB...........hABA......hACA...,1,-12,-23,11
fWebTPaIYOXKSdgAGBRDVEULcNZMQCJFH,GCCFBFCFRDDBDDAGUFFG.LFAAZEAF.MEIFCFGFHAFG..fACHhAAAeCEE.TAEFhABAPBAG.aGHBIBHHhACA.OBBBSHEAAHAAcGCDhAGA......hAHA...,1,-18,-32,14
QaXObHKLVcNIeBTFYfUWDPSRJdMGCZEgA,QFCAaGDD.OAFHHGFGLBFB.VBCGcEBGhAAANCACBHACFDABUGGG.hAAADDIDPCHHSCCEhABAdBBCCFFG.EACGAEEH.XAGE.IHAGhAEA.....hABA...,1,-8,-20,12
CUHAVgBYLRXWIKSQNEdeZTFbMfPaOcDGJ,BFDDLFBBRAFA.XCBFKEBE..SBDHEBECZEED.FEEFMFDHhAAA.aGGGDABHCDDAAEAC.hAAA.VFAD..YADEhABAIEHBNAIG.dHGD.eACH.fHDBhACAOAGD...hACA...,2,-31,-22,9
fgCGJYDTLWeXcOSVMPaIANUHBdZKbFREQ,HEFHdGFHZCBAFDDDQGBHCFAHGAEH.DCEELHEG..eEAFhAAAOECHMBAGaBBHAGIDBFDAhABAKACBEHAEJAEA...hAAA.WDHBXDFA......hACA......hADA...,1,-12,-28,16
XOCAPMeSUNWQGHLgdaRZBETVKJYDfIFcb,eCHDUGBCQAFCLAEEaCFFZBAC.EDACTEEH..JEFADCABhAAAFEEHXECF.hAAACHHHMFBFNIEH...hABAHBBAdGGBBBHH.......hABA......hACA...,1,-18,-23,5
UGdQHcIWYLFTfONgZXBDSKJVbPaECMeRA,GCEBHBCF..ICGHLECFFEAETFFDOEHDZAAF.XADChACADGAHSFGFhAAA.VFCEaFHFMIEEhAEAAEEAQBAF........hABA......hACA...,1,-19,-24,5
QJZVCSRWHeOTcPMLfbGXDIUaFYNEKBdAg,QDACJDACZAFA.SDFFRFFAHABC.eACCOEEB..TFBEhAAAMIFALFCDhAAAGEFAIDDBaDHF.hABA.NEAEBDGDAEHHCAGGWHAG.PBHD.fBBEhABA.DFIFhACA...,2,-18,-14,4
CbWSLERNGcAFdVPBDOgUMeTfaZKIXYHJQ,FEHBdCFCBAHDOHBCUFGE..MGAGeABA..aFDAKDDD..IBADhAAA.XBEAhABAYFAF.QGDHhAAACGFHSEBCEAEF.NAEFADAHDCCD..fBHAhACAJBAF.WDCEhADA...,2,-42,-30,12
TAFKdRQOJCXIZebfSHBVgGaLPNMDUEWcY,dDABQBDGJEEA.CGGFZFAAeHAG..SBHBHACEBABCGBAGhAAAaAGHLDDDMFEADIEGhABAEHGA....cCEDhACAAGGCKHECXFAA.IDHAhAAAfHAB....hADA...,1,-14,-28,14
WgZTEMLRFSGXUACbJIaHNfBcPVQKdOYeD,CAFBJGEAHFBDBBAB..VACGKAGA...OEGHDFDEZCEA..MEEHhAAAFGAB.GBAC.ADHCaFHDhABA..fGCChAAA...PDBEdAHEWDFF..hACA......hBAA...,1,-18,-56,38
HTAKJZcVLIPEBagRfNFGUCYSebXWQDdMO,KDBDJFBBZDCFLCFD.EGEBBEED.RAAC.FFBDGGEHCGGF..eABAhAAA..XAFHhAAADFABODHDADHB.IHHEhABA...PCDBaDADfADBhABA.NAIASFGEhAFAWAEA,2,-42,-39,3
XEfOdYVUeJAaCLZgGBQRPKDIFbMWTNcHS,LCAFZEBHBEEEQAGFRGBCDBBE.FDGBMBEE...TEEHhAAANAAF.HCGFEBDEOCCChAFAdDCC..YCCChABAeFGHAICACBBG..gGGA..hACA......hADA...,1,-22,-29,7
TdJIQAcWUHfPERYNZaSKgBDLVCbGXOFMe,UCBCHAADEHACRBFHZDDHSEBD.BDGFDADCCHBBGECD.FFHFhAAAMBIFTADAdHGH.IHEChACAAAGE.fGGGhADA..NBBFKFCBgAGA.hAAA......hABA...,2,-47,4,51
ZNBEVgRYJdXDOeALKHFUPSGTacICMfQWb,LDCHKEHBHAFEUDADSGFCGECGaBHDCHHG....QAABhABAbBBEBADC.EHEGRBFFdHEHhAAADFECACIBFHBA..PDDGhADAIFAC.MFFGfHAH..hAEA......hAFA...,2,-15,-15,0
dDJcABaGETMOZVUfbKYWgXQNeRSPCFILH,BFFCEDAF.MHDGOHAEZDEA.UBFEKGAD.......WFHFhAAAgBEE.QBBBhAAAeECARBBDCAHEFGFFhABAIDAALGACDACCAHHEaEGG.....hABA......hAFA...,2,-44,-16,28
AWVfGJNMaKHbEUZXOTBgDSYIeRPdLcQFC,VAADJFEF..MBCHHADB.UCGH.OFBABGGASGDDhAAA.eDFCdDAHQAGBhAAACBEGAGABGDAE.aGHBhACAEDDA...........hADA......hAFA.XFEEDBAH,1,-13,-34,21
fLBSPIdTagcGDORZWKJQHUCbVAeMXYNEF,MAFHXCBC..EHACLDECBEDFSDAEdAEDaGGAGECEhAAARFEAKEHB.QABEhABAHBGBCEAFABAC.eBFAFACC.IEFDhAFA..cGCF.DAGCWCHH.hAAA......hABA...,2,-29,-1,28
NPJbegQBVUMHcEFKGRSTAICDLYOfXZadW,CAEDDEFHLHFAODBBZGCAdABE......PHBEJAFFeBBEBEGEhAAAMDAHHDCE.EGAHFEDFhAAAGFCFRDGF.AAFAICFFhADAfBHG.aGGE.....NIAF.hABA......hACA...,1,-16,-27,11
VCfESRbMgGWdTDKBXLJNecAFHPZIOUaQY,FCFCHGFGZFGFUEDG.QADACACG..SEBAMDCFGAGChAAAdGAADDACBACFLBBAhAAANBAGADDA.OHCAhABAaDFF....YFBFfEEH.EAFAhADA......hAEA...,2,-39,-10,29
YUSBVMPAJeaWNCHTFKbXdZgOQGEDcRLfI,aAABCFDGFCHF..KECGdCDCZEGB..QABBDBEFLFAH..IHHGhAAAUBBDBGDBMCFDhACAJAEA..eEBF.hACANAEFHGDCbFED..XCGCOHBC...hBAA......hBEA...,2,-29,-21,8
QMcbWETJYXONGeLFaZPDBRCSHKUAgfIdV,..IFDGQCCB.MEEE..WBEDTFGD.XBGFhAAAOHFEGAGGhAAAeFBDFFCEaDAEDAFACACDKBAGgBEBhABAdGAD..cFGBEDAENIEB....hABA......hADA...,2,-34,-2,32
XHAgBfDeJWdNKITZLMScUYEbaPOFGQRVC,BFDGDEFHeDBBJCAA.dHCF..KEAGZAEBLCHDMBBG..UDGDEGFA.hAAA..aHGAFDEFQAGEhAAACABBHADE.ADCA..hADA.fGAG.NIED.SCAFhABA.....hAFA...,2,-37,-24,13
UdOPfMLZVYGAbXaWNTBFcSJEgKICDHReQ,aGFCTCBCBDFB..SAAGEDCD.KAECIEHHDDFA.HACHhAAAQGCAOFABMAEAhABAZECGVGECAHBDXFCAhACAFBGG.JBFACCAC........hAIA......hBAA...,2,-23,-20,3
NGfbVOPXQIeaDdcRWYHZLTKCgSFUJABME,EAGEGAFE..VCADODAE.QFFAIEFD.eFADdAAFRECBhADAHFBG.LABGhAAAKCGCSHEA.hACAFGBBAEIFBHEBMCCCNDIEfCHA..hADA......hAFA...,2,-18,-13,5
dULDgGOKfMVPJWATZQNacCXeRIFBSbEHY,ZCDBaGFC.CCBG.RDAF.BCGA..EAHBdHEFUDFCDBAC.GGAH.KBADMAFEhAAA..JAEBAGBFQEGChABA..hACANAAF.eADG.IHHD...FHBEhBDASDCB.hBHA...,2,-39,-30,9
gMEaLDGfHBRXeFWTbCSAYZNcKOIPJQdVU,ZAADKHBGOAFEJFGF..dFAAUFFA..EDFAaEDFLFDH.hAAAGACDBDAEeDHBhABAFDDG.TACACDHHAGCD..hACA.NCCE...cAGEIFAD...hAAA......hADA...,2,-33,-32,1
bWVAYTSOCcMFRBagUZLdPXGHKQNDEIJef,SGFCOAFB.MCAABCAE..aECDZEAELBFDdHGHGBGChAAAKDACDFFEEABCeFFG.hAAA.WBHFACDCTGCAhABAFFAF............hAEA......hAGA...,2,-35,-25,10
aBegYNADUOCFQdWcKLHMGZbfSPRTIVJXE,DECDOGFACHEH.dEEFKABELBAD.GAGAZAFHSFGFhAAARGAC..ICCBhAAAJBDB.aFBGBFDBeGDG.hAEANIEB.AEEEFBHF.........hABA......hACA...,2,-56,-17,39
IUYdXCOEScFPAaQLVeWgBfNTGJKbZRMDH,aGDDLADG.eEDCBGAA.TAFCKBADZFFEMDBGDFFGUFAH.hAAAdHEDCFHHOECB.hAAASEEBFCCFABHF.hABAQGFD..WHAAgACHhABAfCEF...hACA.NAIE..,2,-33,-30,3
XOGJMTZSWIKBHUFgYDAQecLbdafNRCEPV,QDACeEEGLEABaFHB.RGCC..CBAD.EGDC..XADDJDDGTBBDhAAASAGF.hABA.IAGABDGDHCBHhAAAgCGBAIHE.dAEENAIE.....hABA......hACA...,1,-16,-22,6
TdBNJbFLGYIXVCDPSZHKfeQOcERAUMagW,MBDHaHBG...TBECdFFFJCBA.LBAFGEEH..XGBAhAAACAHADHECZEBEKCAF.fAHGhABAOCEA.REAAAGID.hAAA............hABA......hACA...,1,-18,-43,25
ZgATCSUKWDPdLXBbHcOVRNYIGEMJeQfFa,TGAFCFCFKAGE..DBBALDGB.BBBFHFDBVCCERDAF..IAEChAAAMAFCQFCFhAAAFFFG.aDACAICASCDFhABAWFFD.dDGF......hACA......hADA...,1,-17,-40,23
VDYBJEHgNUFbWLSXQAeOdRIcTPKCfZaGM,dAABRAAD..TADEKGCFCHHFZAFGGDFC.MDIDDDBABHAAHFAAUAFEhAAA.FDDCLEFGhADA.SEAFhAEAAIAAOFDD.....cGEGaDCH....hAFA.JCFE.EEBH..hAGA...,2,-42,-3,39
IQYSNcbDPBKAaMRfGLdFVZOWEeHUCgTXJ,MFCFREBHLEEDFDEEZDAAODCG..eCAECGAD...TFGChAAAIHHGSHEAhABA..cAFHDGBBBAGFhACAAFFGaDAFfBDBGAAF.....hAAA......hABA...,1,-24,-33,9
OdgDNPUGWRAFHIMCJZQLYTKceSBbafXVE,FCFCHFACCFBD.JCDAZBDBLFEA..TFFDKABGeHEG.BBHGhAAAaDBG...XAFBhABAEBHDdBAFDGAH..PEEAhADAGGBFAEBFMEIDcEGAfCCGhAEA......hAIA...,2,-29,-19,10
XSKVQRfDHTcWZLMdEAgBUJFbNaCGYOPIe,UGGGFDCD..aABDGBCC.OHCEIEHBeGACKGGG.RBFADGAHhAAAHAGF.TAEFZADGdDAEhABAAEECBDAA.JAABNEFCCFDAhADA....PEFE.....hAEA......hAFA...,1,-11,-30,19
DIQbVCdGLYcERWXNFTMOPfKAUBSJgHeaZ,UGAFJCAFHEEAeAEADIEA..QCBG.CFFCLAAEhAEAEECFRGCCXBGBFGGC.TGGEhAAAMEEGODHD.hABAKCFCSBCD.aCEBIFDAhAFAdGAA......hAIA...,2,-22,-14,8
cBYWAOQRLEfJSeVCagGZbXTDFUNHIKPdM,QAEGRDEDEFBC.JDEHSBEF.eCAHVAAF.CHEFGCGGhAAAbAAE.DCDDNDHEKHAGhAAAdEBAMFIHBGCA.AGGHLHAAhACAgAGG.XGEA...hADA......hAGA...,2,-17,-11,6
IOagNSVXYGdRMWDPeTKJbZLUFAcHQECBf,QFDHCCEABFBG.OADHaGFA...SCFAXEECGAEBhAAAdGAEMBCBDADGPEHHhAAAKCBCZGDAFEEA.AIHAHAEEhABAECAB.ICAF..NDIC.REAG...hACA......hAEA...,1,-4,-32,28
IAaNLJEDbgHBUQTPdcZOReCKYWXGFMSVf,LCCHDFDCHCCCUAAHTCAHdHCF.ZAFERGEGeAGH..KDBDXGBHhAAAMDAF..SCGBhABAIGAEAFEBaGHBJACAhABA.EDGCBGFD..PFFACHAE...hADA......hAEA...,1,-7,-29,22
YIPHVDfXFcEeWaNLCSgdAZKbUQRMBJOGT,ZDAGUGBCQEGGBFGEGBBC..TBBC..IEEAhAAAPFBADIBGFGEFEBFBeAGDhAAA.aBDFCAGBdADA.AEDBKBADhABAMABC.OGDC..YDHHhACAfEEB....hAFA...,1,-20,-25,5
fTPOgUbEAHXeMFNDWKSaRVLQYIcCZJGdB,XBDGFFAGDCCH.KEFERECHLBHH..IGHCCFHC.GCAEhAAABBBC.TAGAhABAOHAEbGDGAADFHEEB.hACAeAEBWDEF.SGAG.aCGC.hAAA......hABA...,1,-11,-38,27
QLVJBITebfcaUHCERADYONdXWGKMFZgSP,DEFHOGEAdBFHGEAAKDCGZEDG...SDFBQAGFLBCHhAAABEHFeAAC..fHEFhABAaFAACBCH.AIHENADBhACAMIFEFDHB.VBEF.JHAE.....hAIA......hBAA...,2,-26,-16,10
BWTgYGHERUdVJZDQLcFKSAaebIMNOfXPC,eCCHMCCA.OEFG..PDEDBAACTGCHGEBCHAAE.hACAEAGHUAGAdEHCJDABDEEBLFFGhADAKHDE.AEAHIHFEhAEAfADBCCBH.gGGGRFAF.hAFA......hBBA...,2,-20,-4,16
bGURdFfKAMLONEDZIWTVQcXPgSBaHCYJe,OAFEEHFGZFEG...TDGEQBFF.XADBSCCGhAAAaHDCHDBECFADJEBEeHCEhABAbDFG.UGGBRAAF.fADGhACAACCEMAIBDGAC........hAAA......hACA...,2,-23,-3,20
LFAYQUCMINTRGdEWXBZbcOfJVaKHSgDPe,QCGCMEEC..NAAE.RCDBEGHFBCGBZADG.OEAHJDBE.KFCGSGGBhABADBAD.LAFDhACAFFFG.AFFFCGBGICBEhAAA.dHBFWHAG...XAGAhADA.fBBAhAEA.,1,-18,-48,30
gaOWVMLJUXAKbcFEZeYPHIdSQNfBDTCRG,KHBGFHBGEEBHeFAG.HBCCdGEA..QADABBHCDEAGRDFFGDEF.hAAAOBAHMEIHUBAAhABAAIHCZCCF..IAHDhAAAfHGDCGGG...aEEH......hACA......hADA...,2,-24,-14,10
YEMdHZcDbUQCNFTBRgWGIVOJKPALeSfaX,SAABXGBC.MBFGdAFBHCFH.ZCBBDIAGUFFBQEBAhACACDDFFADFBFCARFEBGBDChADAOAAFKDHB.AGADfCBFhAEA.EHCENEIEWHEG....hAAA......hACA...,1,-11,-22,11
BQDKgNMPTJbUYVXOFSEAdaCZfcGIeRHWL,dEHACHCHZEFCGAFA.eDBCHEAGBFFDQAEGDFBD.KGDEMACChAAATGAB..bFBDUCBDhAAA.XACChABAOBBEFHFCSHGCaFDBfAHEcAGE..hABA......hAIA...,2,-22,-6,16
ZeTQdRfOFHgPDGJXWcCIYbLBMaVKENUAS,SDBDeBDGQDACRBCE.ODEHFDHHHFFEDBAAGDGGJADC.hAAAXAGECHAF.bGDGhAAAMIDE.KEECEFBAAHHDdCGBhABAfHAH..WDDDICCHhABABABA......hACA.NIEF..,2,-21,-6,15
cRJYOXIGBVfHEPAbDTMSWQLKFZUCeagdN,DAFBMBDHQGDDKCGFZEFG.UGAG..aGGAdGGGRCAB.OACHGFAFhAAABEEHHAEEAEAD..SAHBhAAALHEAFHAChABACCHD..eBAD.NEIA......cDBDhABA....hADA...,2,-31,-10,21
HEbIPZQBJeCFUVXDKRGTgYONWdaSAfcML,MCCALDCHHAGFEGDH..IDEEQGGEBAECeCHFUFFGDCBEhAAARDAE.TDAAOAACNABF.hAGAaHECAIBA...fGBHhAAAcEEC..PCFD.CAGA...hAIA......hBAA...,2,-17,-13,4
CXDSRfFeALdbgNPIYJaMKOHVUQEWTZGBc,dDCD..NDEH.IAGC..JEGBMAACKGABHAACUCFCEEAGZFCCBBEHhAAA.CFACDFIDRBBEeHFAhAEA.AFHFLFAAhAFA..PDAEaBHD.OHCE..hABA......hADA...,1,-15,-37,22
DKXZcVdfLRaPFUEGIWgMbJBOAYSTeQNCH,TGBCeDACCHDH..DAAHZAFH.dEDFRFDG.FCDEUDFBGCAE...IACGhAAAMBCEBECD.hABAOGACSGGDhAEAQAGAKGEBXEGA.fAHEhAIAaBBC.....hABA...,1,-6,-39,33
fGgbZIeWMFNDYKXROTHSVAQdCPcEBaLJU,QGAFCFED.ECACaCCFLECCJBEHGGEHZEGFeACE..hAAAFBGFNICF.DFAFKBGFRDAD.TFDAhABA..SGDDhAAAACDF...dABFBFAB...hAEA......hAFA...,1,-7,-39,32
DXTQYUVcBPgEbAReINCOGWMJSfFdHKZaL,RFDFeGEACAHD.GBDC.MAADSBCG.FEBAdCGHKDGGaFBBLAAChAEADAHHXBBBhABAQGAB.UGGBhAFABAFHEBFBAHHBNEAG.JFCBfEEB..hAGA......hAIA...,2,-26,-16,10
UFCPTQIYcHefWZEOGJgSMDRKbaNBdXVLA,UGAFCFED.QABE..ICHHHBFGeGFEfGAAhAAAEEBEJDEC.MEDADBDEKAFChAAAbADGBABF.dFHCXEGAhABAAAECFGCC..TCBEWEED....hAGA......hAHA...,1,-10,-34,24
ZNgLHQecWKMUETCGObYDAIfdPBXSVRaFJ,dHBHXGGGRBBAFEBD.ZCBFLAGFHEDB..eDEGKGGH.MABEUEDDTAEAhAAA..CAEHOAAGhAEADDBDAHACICHDhAGA.BFHCaAHD..NEIE.......hBAA......hBCA...,2,-33,-10,23
aHORDUGFPNQeYLIEXcfJCBKMAVZbTdSWg,VGFGTFDH..dDDFSFFE.aCADOBBB.UADHhAAAFCCGNBAFeGCC.IGAAhABAXCFA.JFBBKHDAhACAAIEEZAFE..gCGHDIGG.GEAFhAEA.....hAAA...,1,-13,-27,14
DUJfFXCHWbLSBVZMNeGcIQPdYgaKORAET,DDFFUDACFEACHEDALHFESBAAZCGF.MBHHeBBA.GECEhAAAQGGGdAGF.aDDGOCDFhABAAAACEAEC..fHAHhACACHBA.BFHB.cGDC..hADA......hAEA...,2,-23,-18,5
QZKRfPXecTAYWOEgabFBNSIdUGDHCJVML,OGEAEAFB..aEBBBCAG.SCGFUDFGDAGAHAABCHAC.MEIHhAAAZBEDKDHFRFCE.XAAEhAAAeHEAACDD...gEAHhABANAEEdHBF.GBCE.LAEChADA.....hACA...,1,-14,-17,3
eQYSRCDXbOMgFKVPEdBZaHNTJWcILAGUf,UAGHeDACQAABRBDD.DFFDOFBDMBFG.KABA.EDGGBFDFhABAHEFDNDEB....TFAAhADAJDAE..IFAGhAAAGEGASECCCHGA.XGCAhAEA.....hABA...,2,-35,-6,29
gSOYPFIGCJdDMLXZQaeKUHBfAREbNcWVT,RDAGEHBG....NIEF.VEFC..SBCDOAEHFAFECEGFdAAGDDDHLBAFhAAAZFAH.aFABhABAKFHFBEEFAAHG..bADGhACA....WCBBTFCF..PGDChACAICHFMAIFQFEChAEA,1,-20,-34,14
XgfJaIRcdGADbYLPWTNQOZeEMHCFBKSVU,DACBLGEA.TECCNDBB..ZFBGeCCAEDAD.CEAH.BHHG.KAFHhAAAVABA.UBGD.hABAXEEBJDHDaHAERGDAdGAGhAAA.AIHG...PDFD.....hABAOAHHMAEA...hAIA...,2,-29,-16,13
HFCNRGKVQDPMYOAEagZBJcXbUIfSdWTeL,EAFBaCFCZADABHAC...JCABXGGG.UECDICDG.hAAAdGHCeHAAHEEECHEENCAGRABAKHEAhAAA.DCHBMCBEACFB.hABA....cDGEfAGB..hACASAHF.hAEA...,2,-31,-23,8
OXPgNQCEDaKHZYRGLWJAdbeVTBFMSfcIU,eCCHTADCMACH..SEEG..cBFFUGDHPAABhABAQEDDDIGAKCFAhACAHGDEZDABYFABhAAAREGF.WBAHJAHFAAFEbADBBDCA.fGBChADAIHHC.....hABA...,2,-18,-6,12
eBaIcCVfUSHLPTGMRNOXAdQbDJYWKZgFE,QGBCDEFH.JBADKHAC.FCGHBHHEaAFG.CABB...UBBGHCEDhAAALEDDTECEMFGDhADAOFHBAAIB..dAFF.hAAA............hABA.WDADEEHB.ICEFhACAfDBF,1,-22,-56,34
ONHJcWRdUXELMIVKPFZBfDaAgQGeCTSbY,QFGHCDHB.SAGDOBEBHDCFJDAC.RABHdCGC.EGHFIDHDhAAAKDAB.PACAhABABHFEaGBDGECD.hAAAeHAA..YFEG....hABA......hADA.WAFAXGED,1,-11,-26,15
XVMgfSNITDABZUeaPRKCGFWbJcYLHQOdE,BFFCUBDGeDHFRFBDGDCBFAHB...JBFELCFHHCAE.OBBFhAAAEGHH.MFEDSACDhAAA..NABFDGAAAIEGaFAHhABACGGG....bGAAcAEB....hADA......hAEA...,2,-24,-22,2
MXZIbaHJLNeFSEKcTgVCYDABOQdUfPGWR,OEBEQFCAdFFDUGCEGBBC.MFIBZBAF.aFAHHACC.JAGHeDEBhAAA.EACEKDDCcGEEhABA...VBFDhAEADDABAFIH.BHAH.PHEA....hAAA......hABA...,2,-30,2,32
DFKTQAOUHVXcdSMWLBYeaNgRCEJPIGbZf,UAEGVBCD.dFGF..SEBFMBDBLAHHBACF..eFCBaGDDREBEhAAAEFGB...JEEFIDAHhABAZDFAFAFGKAHHAGBBOEEGhACA..........hADA......hBAA...,2,-29,-25,4
ZCMgOedIAVaFNTQHbDfGEJBUSKcLWYPRX,VFEEaAFB..FBCCQDACHBAFDDDDGEFAEAAF.BHHGKCFGLCHHhAAA.PCDDhACAXCGAZFBBCAEC..hADA............hAGA......hAHA...,1,-18,-40,22
bZSUEfQKegaVPBOIGYNTCXALDcdRMHFWJ,LFCHDGHHRCECHCAGFBDD..JACGSFAF.ECAHKBHHaFEHBHFGhAAAGCECTGBECGHFABBE.hAAAdEGB..MAIH.hABAZBGFfECF.eBEC...hABA......hACA...,1,-19,-24,5
RGMDQXfCgSYTIeHAaLKVZUEJNdPOBbFWc,aEEDLDCHZFCF.JGDGdBGBBAABFCCD..RACG.MDIH..DEABQAGHhACACHFF.SAEChADAIHHGABACKBEB.hAAAEEFEOCGF.....bEAD..hABA......hACA...,2,-35,-34,1
CAZPFdIDNSRHfGeKWXEMYTaQVLUOBbgJc,ZDAGFAFBDGCCSFDDHFEFGDAEKCFC.EEDCMAAF...TFGDhABAQBCCLFEBhACAUAAEBGAFJAHBCHHFACBE..hADA.dHADIBDC.NAIEfHBDhADAeDHH.....hAEA...,2,-18,-7,11
UeODPVAEagYWTIfXHBFdLCbSJGMcRZKNQ,EAFBaHBG.......gDDGTAADIEGBXFGCHAEFhAAAdEAACCEBSCGAhACAGAAFMIDAZFFEKDACNHAFQDGFhAAAUEAFDBGAADDC.WFED.BEEB.hABA......hADA...,2,-14,-6,8
ULMZNARgbIJSCXEQdTYeHPVOBKFfWDaGc,RAAD..IFDDJGBG.CAGC.QBEF.dEEHeGFGHBGBPCBDhAAABGHCKEADFAHDDDEChABAaAHF.GABF.LCADhACAMCDDNACFAHIFSEHD.XGCChAEA....hAFA...,1,-21,-24,3
QELbVKgGWMOfHPTeFRSDZaUcIJXYABNCd,CBBDQFCELFFCKEBFGBBC.ODEFHFDBeABGSEGFhAAADAFFUGABJAHDAIDEBGGAEADD.hABA....bDCFWEABhACAMAAF..fGHC.FAFG.hADA......hAEA...,2,-28,-7,21
ScBZLWMdbEKJCQTaUVAgIefPYGDFNXROH,eGEA..PCCHGBGCFBECXBBAHDFBBBAGZEACMBEFdGACEGHDhAAACHAE...TFDGhABAaFEGAHHA.IHCEDIGENACH.hAAA............hABA......hAHA...,2,-23,-20,3
fIYWXAHFEBNODLTSCQMPUbdJeKZagVcRG,HFEEFEHBEGBBOEBH.LAFFCCEG.MAEFPFBAdCABJAAEeGEGhAAAKAHDZAFG..aGCDVBAEhABARDFA...IHDEhACA...WAECAFIB...NDAGDGIDhADASDDD..hAAA...,2,-21,-14,7
VCENPcIAFYdDRXBbTSUWeZGgOKQfaJHML,FAFBdHFHRCACBEDA..TCEASHFA.UEAAZFFCGFAHhAAA..OBHFKDHDfABHhABAaAACHBCBMFFGhABAVAFE.EGDF..NIAF.IDGDAEAHDECE..hACA......hADA...,2,-31,-8,23
DHPOITUagfFWQMNCKJcGREdYSZXAbeLBV,eEEGLFCADEBHHFCFOBGHUAED..aDAAFGGCQABGhAAA.CHACKHGEcABHEHCE.hADASFADAAGCBBEHIDEAhAEA.fEHENAIARCEEZCAA...hAAA......hACA...,1,-16,-20,4
UJBHaNbcIWgDGQTPAYKOFLMSCZfeVREXd,OCCHMEGFZDCH..eBABEEAB.dBGABAADHAEB.aGGB..NEIE.IHEAhAAADCEFGADFTGAEhABAAHFDFHCALDDBhACA.SFFCCCAG..fCGEhABA.....hADA...,1,-14,-31,17
TLZgUDPKSMQeJEcGOfNCHdIFYWbBVaXRA,LADGUFDHDIAE.SGCG.MAHHeEBD.ECCHGAAEhAAAOBHDCFHGHCDFFHGA.WEADhACAVAEC..aGFDAEHDZAAEhAAAKDGD...........hAEA......hAFA...,1,-18,-31,13
LJSIFfcADCUdagTXMZEKVYQNPGbRHBeWO,DEFACFCFUFEEdDCF....TBACMEIFKEAH..VGDE.QEBBhAAAGBBBRAGHBDEHhAAAOAEASADEhABAFAHDAIHGaADH.ZGAE..NDIE........hACA......hAGA...,1,-20,-33,13
gDAbOGJTQXHWcMPFdeLYafNIBCUSZRVEK,GECFJDCH.QAABHEFEMABGFGHBeBEHLAEC..fHBFhAAABHEECDHDSGBEhABARAGDEFADKHGCDIDEOBDBhADATBCCXBFC......hAIA......hBGA...,2,-21,-12,9
DOKbIEcgLVXWRNGTAQZMeUFSCfYJdPBaH,QFCAeAABFEEA.SCEECCHB.JACDBFDE.HADBDAAFOFFGhABAKGGFEGBBLAFEhABAXEAFRAGBGCBEhACAAHHAMFAHUGDFdDDFaGED.......hADA......hBCA...,1,-12,-15,3
WXfFLCdPbEYgaTMJBISAeRGDKZVUNQcHO,eEGHGDFCKEAGUAED.QAACOABB..XFCHFHBECAHCdFADhACAEDEF..aCCFTCCFhAAABHECAFIBZAGF.VADEhACA...NEIE.WBHH...fDBAhADA....hAFA...,1,-10,-29,19
DcWYNLKOMZSHIFPRUfCQEBVTdaXbGAJeg,JEEGeFCH.DBGH........cFCHNEGAKABHZCDHHAGDFEBDhAAARABGCBADBBHH.dAFFbAEFhAAA..AHEE....hABA....YDADLFHH.SDAGhADA.IDDFhAIA.,1,-35,-42,7
NTSZWRCBXePMLJgdaAQFDIHEbYGUOKVcf,DDFFHDAGEHGEGBDC.OAGDKGCD.VAAC..NAAGZDGBCFHGBGBAhAAA.eHEALCCHhABAJGDEdGACQAGEhACA.bBDB.UGDEfDFASGAB.hADA......hAEA...,2,-15,-13,2
KHFcPILfUABTMeQRSWDVdYJaXCgZbNGEO,MEECQAEGRGCE.SGEEDCGEdAAB.aAGFCBBDZDAE..GEBGhAAAEAGG.KEEAFGFAcDFAhABALFBE.AIHEBBDAhADA...........hACA.eDAH.WEHHhADA.YCCH.,2,-33,-14,19
AJSfaWUVHNFODPCZeXLMRIEBdcQYTKbGg,SDCDaHBG.UBDCHDDE.NCBHDBAACEEGZFGDLHFE.RDBBBAEHhAAAQAAH.hABAKGEBbDGHAEGBJBHH..hAAA.fDAGFAGG.OFAB.eGBAhACAXGDBMIBE.dDAChACA...,2,-14,-13,1
CVXaPGJSZfAYFLgTMBUNHKWDRbdEOQecI,LCCHMFFFUEAHKACC.DDGDREGD..dACDEGGF..eHBECHCG.aDCFJDHFhAAA..ZBEBAEBHFBADBBAGhAAA..HAFGOAHFhABAQFDE.ICEF.XGABhABASHAG..hADA...,1,-22,-28,6
EGXfZYPBNgHFbUTRIMSWJCQLdcOKVeaAD,DEFAGBDBZCCFBCEDHGFAFFAF.UBAARGBA.SHAACFFHLDABdDDGhAAA.KAHBeAAE.AAHG.hADAXDGE.fEEBhABAPAFD.NACF.......hAHA......hBDA...,2,-44,-11,33
DZFgBMSEGWcdCLNafPRJYOXTQIeUVbKAH,ZBCFBFEDEDGDGACG.dHADCHBGLAFC.aGFCPHFA.hAAARCADOAFGXDAGTCFHhAAAeGBG....hABA............hACA......hAEA...,2,-34,-32,2
TWABXdeFCSNZOcVGUgLQYbfMIKPEDJaRH,BFCFXGGDeDEHFAABCHHG..ZDAD..VFBEGBBHLDEG.hAAAQBFFfHADhABAMIBGIAEFKDBGDFFBhACAJGEG...aDGE.......hADA......hAEA...,2,-26,-26,0
bPCeGYVASfgOFDXMELaQNBKTcUdIRZWJH,SHBGOGEADCAG.EEBALECC.QBDHBACFKFFATAGAhAAAdGBHRCGD.ZAEHJABGPHDGhABAeFHH....hAGA............hAIA......hBAA...,2,-36,-27,9
FWZbcgLTeDVSYQAHaRfdPOJCEXIBMGUNK,aDAFRDAGdGDH...JAFGXAFE.BDGHMFAFGAAFKGGAZEEE.hAAA.gGDDhABALBBEDIEASGFGhADA.ACFFPCDBCCHGECDB.NFEBFGAG....hAEA......hAFA...,1,-17,-37,20
NEYVWeLQPaISABgGMRbUcHCOXFfKZJdTD,BECDMEAEUFGHCBFE..FGDAKHAAdACB..DDFFEHBA....VACGhAAAeDEALBGDhABAQBAGaFCD.ADDA...hAAA.gGGG......hABA......hAFA...,2,-42,-41,1
SbHLNVMZXWfFGUgBCKQaJIREYcPATdDOe,DDFFSAABHAAFLECFMDGB.ZEGBXGAGFBHFUAEG.BCDDhAAAQAFD.JACGhACAEHDAPEEFAIAA.dDHAhAHAeDABNCDC..WHEA......hAIA......hBAA...,2,-24,-21,3
TWXGANHFKOIMgUaecbQVRSDLfJPCZBdYE,HDAGFEEDKACDMEEC.aGDAeFAH..QBCFSAGELAADhACAJAAF.CHBFBHDDhADAdAEETGGGXGGEAIDGOCEEhABAIBFH.cAGA....hAEA......hAFA...,1,-18,-35,17
aQYTALOBFWbSKPRZEXeHVgMfcNDUdIJCG,LEGHFDAB.SDBBKFECRFAEEBBAHGDAMEAF....fHBBhAAADDCAUGGCJDFACEDCaABHhACA...QGDFhADAAAACBAHC.PBFC.ZADB....hAGA......hAHA...,1,-16,-38,22
bASaPGOWYdHXQLBcVJTKMNFEeUDZCgfIR,SAFBGEAHOGFCdCBAHECCQDGEBHBCJAEFKBGAFBBB.EHAGhAAADGDBZADGCHGE...IGDEhABAAHAD.PCDChACAXGEH.cABAMIEE...NAAE..hADA..eBGH.fEHEhADA,2,-26,-12,14
fMBYFOJWHDeNVLTZRIKEGSUPAQbdXaCcg,dGFCXGAFaDED..CGAH.....cAAFMDAGBCHH.OAFDhAAAHDFEDFIF.NADCLBEEhACAZEAEIACBhABAECEFSEAAAEAGQEGEgFFGhAEA.FHDAJHBE.eBCAhAEA...,2,-27,-4,23
QFeUdHTBPACIEONYGJcVKMZgRaDXSLfbW,EEGDOGEAGDBE..VAAHKAHBMBBEZAFDRADF.DDIDLHFG.hAAA.bBAGFDHFdGDGHFAHhAAABDECAEEHCDBH..IGAHhABANDDE.JFFFaHCEfAFE..hACA......hADA...,2,-22,-9,13
PJWVcXOdENIMAGDTCbeKQZUYgfLSaRBFH,TCCBCAFBKBCH..UDFG..fHADLAAFREBHBGGF.FDFDhAAAJAHHVGCG.OAFAhABAEGHH.MIFGAEIFDIAAbDAHhACAZEDF..SCFCaBEC....hADA......hAEA.WBCC.,1,-3,-35,32
eGRTPSXUVIAYcbJNOfHdKMgCBZQFaWDEL,...bAADJCAF.OFHBHDDHdFCA.MHEGBGCFFCGFDGBB.LEEHhAAAeAEC.GAGGhABAREABSFGEUBCCACEE.NICBKACBhAAACAFC...........hACA......hADA...,2,-40,-4,36
EWNdJKHUQLTBVfRbIagXGCDMecPZAYFOS,OCCHSAFB.EEBGdAGB.JFEAKEGAHCGDLCAFBEACRADDaGGAGGCFhAAADGDD..MDCChAAAeFAHZAGB.AEEDFBBA.hABA..NIEF..........hACA......hADA...,2,-24,-19,5
NQWZHATJdKEaSfGDVXMeYUcFLbOBgIRCP,TGGDJEGH..KCABaEBDGCDD.DIEEVGCE..MAECeABChAAAUECHLDEC.hAAABFEERABBCHCH.NCDFWAFAhABAAFFBdBGF....SGHHfHAD..hAFA......hAGA...,1,-24,-32,8
bVgUBKdZYRPQNaHIOTCWfEcXJeMALDSGF,SEGCFGAH..VFGDUCCEBEFDKAGCZFEFRAEA..QGDAhAAAaBFDHFAG.ODDHhABACHGBEHCC.JBBHAAEG..LAAChBBADGCB..gACD.PCFEhAEA.....hBCA...,2,-25,-19,6
BCGaNLXHeRQAUESZdMWVTDFKIYJgfcbOP,EFHBSEHBdEEG.MHCCVDAG..FEBCKFAD..JACG..fHEBhAAAOAHFBDDDhAAAaCGALCACeGFGACAE.hABA..WFCHDDGF...IABCcAEDCFDHhACA......hAHA...,1,-24,-36,12
KFQNDXIfSAeWVYEGbUgdJRLCZTPOcHBaM,eFBBVAAD.GCEG.UBADJDDGLADAZAGH.OEFFBHEFKECBhAAAQEAADBDDXGGAhABASHGA.hACAAIEAEAHFdBEBCEAC..cGCE.MCDE.hADAIFHEfEGFhAEA...,2,-24,-15,9
BdOFAPbNfgKYUaLCSQJMVHWReEZTXGcDI,...NDHE.gFCE.UFGGCFEAQFABJHAC.MEDDhAAAHBFBRACGZBFDXACAhAAADCAHBCDGdBACAGAA.fCDGhABAaBAF..SAHBWFEB.EGFHhABA......hACA...,1,-15,-32,17
FXHGLOAaQIYJZUKPEgCeVbWTBNcdfRMSD,QGBCJGEAZCAF.KABEEEHF..CFHDeBBD..bDDCBGFEdBGARADBhAAADDFG.FAED.HDDEhAAAOFABAIDA..IAHAhAEA..........hAGA......hBAA...,1,-34,-35,1
egKTDdJURcSHLVXAWGZPYOCEfbBQMaINF,GEDHZAADOBFFEBCDBCEF..MDEDIAAEeBHHKHFA.dEBAhAAAUGADRACA.SGEDhACALFADADFFPFHDhADAfHCF.aFHHFDBFDDDFHBGB...hADA......hAFA...,1,-9,-18,9
PXMDVGaeOUfdbTKCJHWZLRSQABEFgIYcN,BEFAEAFBFABD..ICBA..NFCD.MDDGDECEGCGG.hAAAeGDCUAGF.fGGAhABATBDHKHBACFAHJFCFhACAZDAB.LEAC.SADFAAHG.hAAAYFEF..hAFA...,2,-41,-21,20
fRYVZGTScbPOgNJLKIWUFMEAXaHQCdeDB,HBCFQGAFeFCADFIBBDGCRAFDZFGFGEDH.TCCDSEAHhAAA..PBFCNIAHKABH.hABAIHEDFGEEADHA.aGGHhAAACAHHdCEAfDAC.cABB..hABA......hAEA...,1,-8,-22,14
gUQEMcTfeIVPAZJDYNHFSORBKdCaGLWXb,JAGHDACBHADB.FGEGSDDGBAAF.CFBB.GDAFLEHDXDGEhADAUCAA..QFDAhAAAEBGCMFDBfHGHhAFAeHAAVADFAFGH...NIDF.KFBD.aHAE.hABA......hACA...,2,-23,-14,9
dCJQcHXfKAUaNBLOMWZPReDTIGYEFVbgS,aGFCBAFBLACBMBHFZEFFRFBD...DGIBTAAFGECA..EBEDFBBBhAAA..VDFESBFDhABAdEDCCAGF.JEABcEABhAAA..fADCKBHBAGID.NBIGWFFDhACA......hADA...,1,-7,-32,25
JXPOGFAWQVdCgLNHIaKRDBUZEfbYMTceS,VEFHCFEDLCAF.HGCAKCGABDCGZABHEGHD....fFAAhAAAMEEEeFAASGBAhABAPCEG.OAEHhACAADBF.dCBBNCIG.IAFCDFFC.....hAAA......hADA...,2,-29,-17,12
VWIHKbACJcDeaFRBUOTMXQfGPNgELZdSY,CAFBJFCHDBAE..eDDCFEEA.BDAA..OAGDMCIF...QDBBhAAAGADD..gFFFhAAAZFDFSCCChABA.VFGFICCEKACCACID..aFBH..hAIA......hBEA...,1,-30,-38,8
DEAYNZVfSFCLdUOQPgWeIXRGJBMaTKcbH,ZAADVDAGSDFC.LEDAOACEQCGE.hAAAPFCDeAHDRGCABCCBhAAAMFAHTEEAKHGCHACEhAEADAGAEHFENCCECFGA..........hABA......hACA...,1,-9,-28,19
cKSEOBfPXaNGeLTbgVMZHURFAJQCdIDWY,QGDEdEGDDEFD.......YDDCSAGGEAHDBBEGhAAAfDCB.hABAXGGDaEAE.NHCHGEAHhAAATGGEbEFAgBEBMCAEUGAAFACGCBAAhABAIDAC.KCHDhACA...,1,-19,-22,3
LDfBOTaZcgXRVeHdWCIJYFAGQEUKPNbSM,QECBUFCEKCAC.....bFFALAFCBBADaCCAZDEHXCGEhAAARCGDHGFCdADG.CABD.hAAAIDAA.FAFChABAAIDC.GGCFNEBA........hACA......hADA...,1,-18,-27,9
VKBLPUNYeRHaMWXbZCSTfJDEdIAGgQcFO,QAGHOCCHBHABUBDD..eEHHHFAFMAFAXFFAZBGBSFFChAAATAACDEDBEABHhABAIEEAGGCBFDABhADAKHCANACBaFBC..CCGA.fEDFAEBA..hAEAcGEH...hBAA...,1,-7,-13,6
UKQWYLMZOFgTGcJPNDBbIAHfVXeCSdRaE,HGFGXFDHCEFBRBCE.UBFCKHDA....QFBELCABOEEGhAAAFCAHGAGEJABEDGGEBABFhAAAAAHC....fFCAhABASFDAaCCDWFAFMIBG....hAFA......hAGA...,1,-20,-31,11
ReDNaAPcVbFfMgHIYBWUGJLTSCEZKQdOX,VAADFHBGMDEC.HGFEBAGG.GAEELBBACHEAZEBBKEAC.dAHCOEFDhAAAeFFEDADC.AGED.hAAAPDHH..bDFAhABAIHHE...WEAF.JEDBSFCChACA..hAGA...,2,-21,-19,2
DHYZRMTVUQBEGLdFJOebcSAKWfgXINaCP,KHBG..gGBCXDCB...aHGADBBCHAFERCFCMGFGUCDBQCAEhAAABGFCLEEAhAAAJFAD.OEAHeFCASHEAhABA.AAFFIEHFCCBEYABGhABA......hACA...,1,-17,-20,3
EdWGgUHLKYOReXTaPQVIBJCMbFNfZADcS,DGHHSAFBdECDGACFHECCKDABODEG.RBBH.XGAA.hAAA.aHAEVGDGIAHChABACBAG.FGFFZAGFEDHFUCDFhAAAYEAH.eACE.....hABA......hACA...,2,-24,0,24
YXfdVQEKNeFAOCUHRDPSacJILWTgbGZMB,CFFEHABHDDDB.aFCG...JDECLFBD.TCGDgFFGhAAAZAFABHGHXAGC.hAAAdHABEDAFeDAHFABEAGEBUADEhABASCEBIHDC.WHFAbBACMFIHhABA......hAEA...,2,-30,0,30
EbFaGcMVTUAHLNdPQKfCZSgOeJDRYXBIW,HFDFdDCDQEFGCHBHZDFD.OABADDFBRCBEBADAEFBA..FGDCaGABMEIBhAAA...TBEHhAFAAABGLAFAKHGASCBEhAGAJHFE.IHAE...bAGDhAIA......hBAA...,2,-36,-14,22
dJKIMEFQCBUNDaVHeTAPLOXcGYWSbZgRf,LEEGODACGGAHSBAAZBFCREFDdAACJAFG...MBBAEGHDFCEGhAAABCDCUEBADAGA.aGEHeFAChACA.AHFB...cADBhABA..........hACA......hADA.WDHBfDGD,2,-22,-21,1
ePKMOBYdLIEUgJZHRVScGfANWQTbXFCDa,QCBCTCGC.FACCaFEAKEFDBAFE.dBDALAFHUAACZFCAHDGDhAAARDAF.VFBH.SGGAhABAfHGBAEAHNDEEhAEA............hAHA......hAIA...,1,-15,-29,14
BOENKJYCTAaXVRZWPFdLfHUSQDebcMGIg,VBCFRGFGZBABFDDG..dGAGLBFGHEEBSAAEDIEA.eEHBhADAMAFEGAFCBDGBEADFhAAAJEAA....CHDBaHGChAEAPGBE...fEFC..hABA......hACA...,1,-7,-36,29
QFdYaDPOATfcgVbJIMCKLeBHGUSENRWXZ,TCBC..fEHA.VCCCIGFG.KBHHeACGhAAAGEAGEGBARBGFWDEEhAAAXGEC.FEAFYEEDhABAaEFFDAGBAIAAgAEH...hABA.MFCEBACE.SHGAhAEA,2,-23,-22,1
bgFXYeZKfVBUTcOAGDHWINdPJSCRLMaQE,DDGBHAAD...IADCPCDD..CAED.MEDG.aHAGQABEhAAAEBFEFCCB.eBFAfFADhAAAVFGFBHADUFDEhACAODBFAHIBGDGE.NIBF.SHDGhABA......hAFA...,2,-33,2,35
eVOgAGEQMTCHLJYFNKfdbISBRZPDWaXUc,EEABMGECHAAELBADFECBKCCEdHAH..SCHFBHHAREBGDBHFaHBCUBDEhAAA..eFFGOAFDhABAAAHGTGEE.CEEF.hAAA..JEEANACFfGCFICBF..WBHHhACA.....hBEA.cBED.,1,-5,-25,20
DSXEQICAeLYWGbOHdTaFPBJURfVKgMZNc,eEEGLGEAGEADHAFEdADEFEBCBGEFREFAKBAFZCAA.DGHBECDE.CAEF.AGBB.hAAA.....WCHBhABAOHAG.aBBF.hACA............hAFA......hAGA...,2,-39,-27,12
VBUYXIPJbFDHEQLRZSWAdgNCKcfOMTGae,dHBHCFDGKBFHOBEH.GBBEaCCC.BFGHUGGG....XAGAhAAAIGAH..JFCGhABAFEFADACEEADFLEHBhAFASDAHAGAC...NAIG.cBFC.fGFEhAGAeHDCPAAGhAFA...,1,-20,-42,22
ALRcQMJXPCNIHWaSKfDgUVEBeZbYGdOTF,LFBBQFDHMEGDJDBB...CABEHAEHaAED.KDEFDFIF.UGAHhAAABFHH.eBCH..hAAAYDFHOHFEAIDAXABBhAEANAIC.IHGHSEAD.fGDFhADA..hAEA...,2,-30,-30,0
WbfNgZARDCFXUdGOcSVEMJKQTHLIeBaYP,DAAFCFCFFEEDUBEA.GAGEOAGH....VFEAJBCC..KEAFHFAChABALHFABEEFaDAFhACA....PHBEhAAAfBCCZCAAAGGEdBHA......hABA.EEHDMFIH..hADA...,2,-29,-28,1
ZgdGIMHLCJfRKaFATbVEQUPDNBYSXcOeW,VEFHEEHBUFDC..DBHFBAAD..SCDAOCDAZCBCdEAGGEAEhABAMBAAHGAGLAHFhACACEHE.JACEKDCDAHGG.QGDChAAA........hABA......hACA.NADH..,2,-26,-24,2
RFTAMgHfLdVEGeUSYKcbQDONZaBJWIXCP,MECGHAADdGCFGBAGUGGEKBGGQDDD.OEAFZAEDBHFAhAAAJAEF.IEGA.hAAACGDBFACHACIFfAGHhACA.EDHBSGGB.cGBFhABADDCH.NEAA.aGED...hADA...,2,-33,-7,26
TCODadBYfNgSPQKVHFEIMZbReLGXcJWUA,CFEEaEGCdGGBBEBG......fCEAgGAGSCGChAAAQDDAKHAEFADHICCGhABAMIDARAFEeABDhAAALACEXGGAJECFABBBDDIDNGCB.....hACA......hAEA...,2,-30,-19,11
ZDfGKCISaEXQecTJALYbNFHgOBUPMVdWR,LGEA..NDHEFFFBOBDHBFAGUFAG.MIBGVBBAREFADIGEhAAAKGBB....CEDB.IBEAhABAEGDH.XCAHhACAeCECJADA.AIEA.HAGB.....hAAA......hABA...,1,-16,-42,26
GHPeQMNSVJDXgWbUCKEYcFRdTZBOfaALI,GECFHFDFQGFGSGHBVDEEDCGA..XGBG..hAAAbDCFUABCKAEBEBHDFCECdDBDhAEATEAGBDGHaBBAIAHEhAFAMIAA.NIDF.WAAFCEHA.....hAGA......hBAA...,2,-17,4,21
YGEPcAHMVLOCbgJKfXTadZeWSNDRQBFUI,VFBGLEGH.CCEA.JCBGKBGB....TBFFdGDDZDAD.SBAGhAAADEEEBHFDFFGBUECFhABA....IBADhAAAEADCAHIHMAIFOAEG.fDAEhABAaHAE.NDIE.....hACA...,2,-41,-25,16
EFYJZHSdcaWQKAIfeBUVTOgNGLDCPXRbM,eGEABFFCUAFCODEHGDBELAFG.DAAFXADCRGAE.EGDFhAAAFEBF.JCAGZDEGSDGBhABAdEAGaBHF..KHGGhABAABBG...ICAD.....hACA......hADA...,2,-32,-17,15
bGJHUXRICKBAdSDcQWNfePFgMYTVaLOZE,DGGDQCBC..NBEE.eHDAFBFF.MAHB..VFADODEEhAAAZFEBGAAEJBDEHFAC.hAAARFFEKABCADFBdDCESFDBhAEA..WEHD......hACA......hADA...,2,-36,-5,31
eIZcOLKJPBMYHbWDNXUTgRSaFVQECdfGA,eFBBZAADOGEELCCEKBGF.JCABBEEE.HFAGDGECUAGC.RDFC.hAAAaHACFHFAEFGE.CCDF.dABFhAEAAFAA....IDHAhAAAMDDB...bAEB......hADA......hAHA...,1,-26,-30,4
FNPAWKVJgEIXTfGaHRBDOCLZUQcSdMebY,KCFCVFDFEDBB....TFAGaCCAHFDEBDEBCHBELDHDZBAC.hAAA.QDAHhABASABFdHGDMFAHeAHDFAEEhAAAAIBG............hADA......hAEA...,2,-25,-22,3
bWBSTUJEIdDCGgVYXPKcZefRLAaHMOFNQ,HGCCFFAGQDFEBAHDTBDEUAEG..JBAFEGBH..DAEECDCAGAAFhAAA..gCGFhAAAVEDF.XGFFhABAKGGB.eEEGfAHE.AGIFMIDChABANDIASDBH.hADA...,2,-19,-19,0
VaAQTGCePgSXHBEDcJZIdFYLObKNMWRfU,TABHeCBB..SDDFBFDGDCEHZAEFdGABFDAHLDHDKHGEMCCGhAAARGAAUAGC..ABAECFHEXFFDhAAAHFDB...hABA.JBHFIDAC..YACEhAGANIEFfEBAaFFC...hAHA...,1,-18,-20,2
WMZLHeKIdXJGVYQNROSAgDCcBfETaUbPF,DAEDBBBDEBBAUAFC.FEHFMFCH.LAFEHACHKDEAdHGFGEAChAAAVDCE...QGFAhABANBGG.SECBhACAAHDDCDAE.fGDF....hAEA......hAIA...,2,-35,-21,14
IgdCDeQZENJALfFPYUTSMaBXHKRGcVbOW,FDCDUCBCMBEDBHGEHBFGKBFG.GEGC..VEFGOBAG.IGEAhAAACFAE.DFABZCFEhAAA.JHBGADAH.LABEhAFAfGBG.........hAGA......hAHA...,1,-22,-41,19
NLEBeSXgdQCMfRIcDFOaTVHAKJPUYGWbZ,JCCHUCBCGBECZGFELFAHBFHB..eHACSHCA.dCGBhAAACBGBRABEDFCEFHEC.OBAHhAAATADH..AHHBKEAHhABAPDGD......WEGF..hADA......hAEA...,2,-31,-29,2
PEeNGLZVUcSFQDBACfaHWdbORYKITMgJX,aEGDHDAG.dGDHOCBBRBACKHAE...MDDCXGFDEGHHGGCH.hAAAZAFGUCGESABAhAAADGAACEEH.fECAhABA.YFAFTADBPAFA..hABA......hACA...,1,-3,-25,22
EZcWDeCUSIJHLaXAgVRdNPMfObGTYQBKF,VGFGRDAGdGDH..MCIHOABCGACB..QEDEKDFDFGAEZBAADBFAhAAA.CDHC..UEADJHFE.hAAA......hABA............hACA......hADA...,2,-44,-30,14
ATMDGaEeHBSgFdOYPQWLIRfUbcJKCXVNZ,DIBGEDAFBGACFBFH.dCEFOEEA..QDGELEBHRFGBUFDDhAAA.JCCBKCCB.CAHG.XABFhAEA..ZABGhAAAAIBATGGFMDAHaHDASADA..hAGA......hAHA...,2,-35,-29,6
feMAKbWTNYaRSPgZGLBIcCOQVHFdEDXJU,KHBGTCBC..aDEHREGF...SGFEZBECLHAGBACGIABChAAACFAD..VDFAhAAAFAGEdGEADDCFUADEeFAEMADEhBAAAHIB..NABE.PEDC..cGCAhAGA...OBFAhAHA..,2,-30,-15,15
MFEIcDGaSNdLOVQKCJbBUAYHTfWXRegPZ,TFDHXCBC.RFDF.eBBDZEAG.FDFC.EFHBDDGD.GACH.SAHDhAAANIEHOACFKHBEhAAACHHABFHFACGGHEAA.fAEHhABA........hACA......hAEA...,1,-16,-34,18
RKGWSeJOHMDZfaTPLIXCNgdBEYFbUVAcQ,REFHGEAHeDEHHGBEDAHDZBCG..aAGELAACCFAE.dGGBBABDEGDDFEGAhAEA.....hAAA......hACA.VBCHAIAGKDDASCFEMAGF.fDADhADA.IAEGhAGA.,2,-37,-27,10
aYMLPNEDdHBbZRUJVegOGAWFCQKTcSXfI,CFEDQFCAKBFG.SAFB..IEBBMBCANEAA.EGHHhAAADCEHdBAE.HCDAZFFGJHFGhAAAeHDGOBADAEADFGABTDGDhABA.fACBYBHDBCFDhABA......hACA...,1,-22,-24,2
UZWDQCPXfgAaTSGNJKBeHYbMVLdRcFEOI,TFCEGEAHKCBD.BGFDeHECHACCMBEGLHBERCDDFCAA.ECCEIHAEhAAAUAGFZDGFDAFC.hAAACFFA....fEADhABA.aADBSEEENDIA..hABA......hACA...,1,-13,-20,7
VLJBTDNefKIEZCdcMSQAXFOUPWgbYaRGH,XGGDFGDDOAAFUCBB....PDFC..gAFDhAAAaAGHHECELHFGhAAABAHHNBABKGDBZADFdHABSFAFhACAQDFEACDF.bECG......hABA......hACA...,2,-23,-16,7
WRBMgYHPAUIKTNDJcVLeECZSFGdQOabfX,KGFCTAFBDCGD...JFDHLCCF.EAGASCBCGBDEdFAGhAAAOEFE.aEBGfCHAhABAXGGE.BCAGhACAMBAD.HCDDAIEAIHCFcBGDCFAD..hAAA.FHAEWFHB..hADA...,2,-37,-7,30
OERbKJLFgIUZdDNfAeBWVCHXaMYQTScGP,eAFBVDBH.HAAH.XDFCaBGB.MECHTBCDGACE.EGFEhAAAKGABLHFGIEEAhAAAdDHADIGEAIAACAHEQFGDhABAPEAF.OADGJEDB.FCHD....hACA......hAHA...,1,17,-23,40
fSgecDWUMAXGPYRHbCNTVIZLaJKEOBQFd,XFGHGAFERABGHEDG.CFBB.TAAFZDGBLEADaEEG.EHBABCDAhAAA.dFADSDAEhAAA....hABA............hADA......hAEA...,2,-49,-16,33
cEVTHGLaJQXSIBbgfeDAFOZRKYWNCUMPd,FDBDODACKGDB.....NFEF.MEEC.dBGGEAGEHAAFLCDEhAAAaFGA.XBBF.hAAAIHGHBFFGgADDhACADEGERGBECAFD.........hABA......hACA...,2,-37,-30,7
TUcQZReIVDOHFSPKLNGdagJXYfWEBMbCA,TCGCUCGCQACB.ZFACeEDCDIDGHBABSGBELCEFhAAAdHABaAAFJFGF.YFFGhACAEHAEBFHB.MBFEhABACAGARCBEODAB........hADA.KCEC.NIEF...hAEA...,2,-13,-8,5
FaJOfDMEeQdCVcUBgLHWIZbSATGPNRKYX,TFGHGAFERABG.KDHHFAHH..OFFBMFAFeCFBdFAE..CAEBUCCFhAAABAEGHFEB.ZBAEhAAAAHHA....PFDBhABANECG...........hABA.aDDDDAIFEDAA..hACA...,1,-19,-28,9
EOcCaZQPSHIVTbJMeYGBfNAUFKLDXWRdg,FFHBDFDCRCCCEGBH..CFAA.QABCHEGF..TBAEMCFGGEBBhAAABAFCAICE.LAEFhADA.dGFAgGEGhAAAaEGGPAFCIGCA.JABAfHDFhAIAKAHBWCFB.....hAEA...,1,2,-34,36
gBVEWPALFYfZJMCNXDcIOQUaTRKGeHdbS,FDCDZAADJCFECHAB..DAID..OCCHUEEG.RFED.GADD..dGGAhAAA.SFBAhADABBAEEHCEAEACLEEC.hAAAfAFDXGFEIEHA..hABA......hACA.aCGCeHAA,2,-46,-23,23
bCBedMTRfZPKUcGWFJIDOQNaVAgEXLSYH,XGBCSDCDHDEHCHDC.BEAHdEFCRAFGZACG.UDGAGBCF.JDAHhAAADCFG.QGGAhAAA.aECDAABFEEGALCAAhABAeACCfGHAKAGE.FHAENICF..hACA......hAHA...,1,-3,-21,18
CAGWTONYMfJFgLDaSEVdHeRPZIcKbBQXU,TAGHOGEA..MDAFFFACLDCC.DHECEBECHEFEeDCFRFCFZBBEhAAAKHDEQBAFhAAACCFB.GBGANIEF.hABA.JABESEDA.dHAF...hAFA......hAGA...,2,-12,-12,0
bJFDYWGQAcTLePaIVCfEZRNHOUXMgdSBK,TDACLEEG.eCCHaEED.CAFB.ZCDBHBEAUBGGMBBG..SEHFhAAAKHBCFFHDDDGAGABFhABAQCAFAGIH.IAHGhAAAfGAAEGEGNEAAgGCD.hABABCAC....hACA...,2,-23,-3,20
LEJbKcDCSdOPaTUBYgQHGAVNXeWfRIMZF,XFDHeGEARCADZFBGFFADLCFE..EFGBKABCDEBAdAGH.OEEAhAAATCGA.BFCE.hAEA..gAAFhAAAHCCDAHDHNEIA.fBDDMFAF.bAFASHFAhAFAaEEF....hAHA...,2,-18,-8,10
KbCaWLdNMYVSOEBcRAQXTJDUFGfPgeIHZ,TCCBJEGH..FEACGGAH...gEGHICDGHGDGhAAAKABGaAGHdGAH.MIBEhABASGHHBFECADGCDBCHhACAfCED.eFACCBGG.NBAA.OADGhAHARFEB......hAIA...,1,0,-35,35
KSeBOXRHcJNZWbLYdPDFVgMCaETfQIGUA,KEEDBDGFRFAGHACGJEAH.ZGFGLFGH.dCEGDCFA.VDFECADD..hAAA.ECACTAAC.hABAQFDGIDCEAACEhAFA............hAGA......hAHA.SHBGOAHF,1,-17,-41,24
LAOUJSeDBMHXKfZdGIFbVQRcEgaNPTWCY,OFCAUGGDeCDFDFGDBHHCHGBAKAFC.dEAFGEAG.FHDCQDGFhAAAEABF.aBAAPCDAhAAACFEG..AAIBSADGhABA.fCABIDGGbAFAhABA......hADA...,2,-40,-14,26
dcXLUfeWAVJSCGDHRgbMQYBEZTNPaKIOF,VDEDCDGFGBCD.DFIHRAAE..MIDEBFGCZEAG....TGAAhAAAPCHHKABF.FDAAdDABLFDBhACAeGBAABEBSGGBhAAA..bAFA.EHGG.aEAC..hADA......hAEA...,1,-20,-25,5
cUHWARLYaGZdCeMQTPVXSfNEIJBFDOKbg,RFDFaDCDGAGAZAEA.eDCBQGDA..TBDAXABCSGAAhAAAECEHBGAFDIAGKHFEhAAAbCABUCGD.ACAD.LHFGhABACCCCMFECfDAAJEEAFGGG.cGADhACAWDAD.....hACA...,1,-7,-8,1
ZeXDAJRcKSEWQaTGMULgOHNIfPdCFbBYV,JFBBRDAGKGHH..EAADQGBHGACF.UDFHODFE.HGFA.hAAA.IABBfCEHhABACFGGFAFDBAHCZADBeAHDhADAACCC...SGDEWFFETDAEMIEEhAIAgGDD.hBAA...,1,-11,-21,10
dNJECacHPLTDbSQUZRBfAVXGgWMeKOFYI,XBCFGAFEMBCHKEFG.FFAB..dGHEEDHHCAAFHCFGLFFA.TECGhAAAbECH..UGAEhACABBAHACCH...WBEFhABAYAFGJHAE.aEAGDADASFEG.hACA......hAHA...,1,-12,-19,7
SNFZCTbDaGVYWfEBUcXLIRgKPeJQOAMdH,dFEFHDAGSCEEZAGBTFFGDDDE..aFBCGCGG..VACBhAAAfEBFBEEBXGAChABAIBCEKAFFJAEGAFDAFEGAhACACHBH...........hAAA.WBAB...hAEA...,2,-32,-14,18
gDTVKZNBPcMXfEYeRALUFSICabdHJQWGO,UAADFAFBCEDA.dGBFHEAB..QCEFGFEHDDEAKAGBBHDA.MCHBhAAAXADG.EDDBhABARBBCAHIBLHFASACEhABAbEAC....WCHH.....hAHA......hAIA...,1,-18,-29,11
SFJcPUbLKCfdBMaOTNQAWZXegEIRDGVHY,XFDHEDCDDACB.GCDHHGACFAAD..PACGLEEH.fAGChAAABHAGOFGDhAAAQBDDAHBE.WDGFhADAeBBG.RAFASDGA.cBAChABAKHGAMEIBNICF.IEAFhAEA.,1,-10,-24,14
REWUPObJIAcXZYCgdNfFSMHQaGKBVLDTe,ZEFHCFDGdCABFCGFHFGHGACGBGBADAIH..eDDCEHBE.UAFD..OGBAhAAAJABC.AIHE..XBADhABA..NEAE.hAAAfFHGMCIFaEFBKHDELFAD.RAEA.hACA......hAEA...,1,-16,-25,9
AJTcNWOGKZSeXUaEQbIDLgVRfYHFMCdPB,JDACTCBC......NFEFGAAFSFBDUGBEEEDB.ICGGhAAADBHDLHEAhAAAVADBRGFA...YFFEhABAMBFBCEAGBGHBABBHWAFEKGEC.....hACA......hADA...,2,-32,-23,9
ZaYUSLAdMHPFCEBOcJGRVQNfTDWKebgXI,MFCFHDAGCEGEBEGH..JHDERCEG..QBACTACG.DFFFKBFFeACBhAAA..XGGBhAAAIAHD.ZECFaGAASAEFhABAAFFCdBHCEBAGcEDBNEIC..fBFBhADA...hABA...,1,-16,-28,12
bVYMaeGDgQHPWdZOBUKCFSARNJcXfETLI,RFDFJGEA..XAGFEAFELFCB..bCEGMABGGEBA.DBBAhAAAQBDDHCAAdFAGBGHGhABAKBBHCCGFAHAENBIEfGFChACAIEFE..YCHBgAEB.hAAA.ZDBE....hAHA...,1,9,-28,37
YCDGSdFOReUMZWaKgIbNcPLJAHQTBXEfV,QDCBXABH.EABD..VEDCCFGCDFEFSBFE.OFAHhAAAeHCGZBFDKEACIEHDhABANCACLFBDJHDC.hAAAAIBGBFCGfBDCdBDAFGGAMAIF...hADA......hAEA...,1,-16,-17,1
DABKgIHVTXCQdUPWJfNcGFZSMbRYeELaO,KEGDHAAD.VEEHTGCD..CBGFdHGBUCCA.JAEE..fFAChAAAGBAEFHGAMADCRBGF.hAAAEGDBaEDEABIFBCCH.hABAXBED.PCHB...cECBhACA....hAHA...,2,-25,-17,8
OHQLdDUAPCaeMWJbXcZfGSYNVITERgKFB,aEGDMDEB...JBFDXABEZFGH.SGBA..VAAChAAAECACKAGDFEAFOADGhAHAHCDGdGEEACDB.PEAHhAAAeECB...cECBfBHANBIC.IHEEhAIA....hBFA...,1,-5,-37,32
TDZJHXNRKWeYOdLbACcVSGFPIBUQgafEM,VDBHFDAFBEGE.UEDHaGDC....MCHFDGBHHABDRAAC.KHCGeGFGhAAA..OAHDhAAALAEGCCFC.SEEChABA.PFABgGGGECCE...hADA......hAFA...,1,-17,-45,28
NBIUDXLQFEebgGPdKaZTHcfYJCASWVORM,SCFCVFDF.RFFCBDAHUEABLBEC.QAAChACAeDEAGAADdDBBKGAHTFBHhAAA..fDFDhADACHHEAAHCMICADADGEHGG........hABA......hAGA...,2,-30,-15,15
BeWNGXPIDTfRULJSdAZCKVaMcbYOFEHQg,KBBDaHDC.MIFE....bEABFCEEHACGBDHCeHFEGECF..hAAAIAHGTGAGRACCLDFEhAAAdAGFADDF.CGCCcBBChABAEFHF.QEEBWBAD.XEGDhACADICA.....hABA...,2,-27,8,35
bQgJBZCcDXHFSYMVfAERTNPOdeLGKIUWa,TCCBOGEAdBBE.LGAGGAAFIFAHUBFH..aEBFQEGHhAAABHECZADBDIBChAAAFFEDYCEC.hABAMIECfEEBABHE.NAIE.....hACA......hADA...,1,-15,-29,14
EbXSJNdgCKUHIeGQTDRMWcaZYLBOfFVAP,EHBGSGFCdFBB.KCAAHCDCGBEDDCAGREFEMFED..aADDLABGhAAABABDFHEGAFBDbDEAXAGHhAAA..gDCFhACA.IAHAeDAG....hADA......hAFA.WGAA.,2,-20,-12,8
WeGUdFHMLJXEDPCYgKTZcNaAfQRBVISOb,REFHVDBHODEH..eHFAUGAHFGDELBBG..XDGGhAAADAFCCCFD.KBHDZBGFaBBEQDBChAAASAEE.hABAGBDEMFID.JHAA.......hACA......hADA...,2,-26,-14,12
GILWSKaAEefMXQDbJNVPUORBCcgFYTZdH,eCCHXFDBDIAC...JDAFVFCH.UBADBCDH.CHFD.FEFAZGAGHAEAhAAALACCKFHHAEAC.MCFAhAAA...NCCE.OFFBhABARFGB...gBGA..hACA......hADA...,1,-23,-31,8
gUCbeWAYNHdfGSQJVKPEaOFIcMTDRXBLZ,HAADGEAHSFCGJAHB.KBGCEGFBaFHBFCDA..MIEADACGBHHAhAAALADHUGBBeFABhAAAAHAB.dEEBQBAChABA.OFFAIDHA.....hAFA......hAGA...,1,-12,-27,15
HWgfBGFYXeODZIVbRLEJUdPCTQNMcASaK,KDABHAAD...fGGHFEFAeDEDDBIBVDFERAFB..LHAGhAAAUFBAdAEE.CHAD.QACFhABAMDEDAAGD.SGHHhADAaDBEBACBXBGAIFCE.....hAFA.ECCB....hAHA...,2,-24,-10,14
fSYQORPFbCTWNaHAZMEBVeIJgDdUGXKLc,EAABBEFA.eHDAJFHB.DCDEGDEELEAF..SCGFhABAOGCGFBAECDBH...NCHC.ADACZFCHhACA.IAFFhADAUDBAKADAfCCB...YEAFhAEA.....hAAA...,1,-17,-39,22
MNbIZEGKVaJWHUOcPgSADXFBCdfQRTLYe,FDABCBEAdBCGQBFALGFC...MIDE..IDEDGABGVEGBhAAAaCABHGBGUEDDOBGBhAAAPFADACIHDABEBBAChABATEBE.NIEF....EEGAWHCC.hAEA......hAFA.SGAF.,2,-8,-6,2
VTCIUScQEYFRXMLBAeOZPNbaGDKdHfWJg,ZFBG..bDEGDBEFdCDFHFGH.JCFETDAF.CBGG.UDBD.SABDhAAAQFFEFHEAhACAMIACBHADACCBeADChAAAOEEA...aADGKFHH.fFBChABA.gGDBhACAIAGA.YAHH.,2,-26,-5,21
ZFBaAQEHYebLKDTRJgMXVNGCUSPdOfWIc,HBCFeGEAKGBGTGGERDDH.MCIF..XCFEGGBFCAFH.SEABhAAAOBAC.IEFFhABAFEAAaHFEEADB.LAFEhAAADFAFJCEA.NCIE........hACA......hADA...,2,-16,-16,0
SORTQIBgVPNYEZXHDJeFCfdcKLGMWaUAb,OCCHTDCB.BFEG..VGDG..NHDDZBFBDEAHJBBB.CFBG.dDAAhAAALCFGMFFGaACFAACE.hAAA...SGGBhABAIHAE.PADCEAEH.eEFEfCHEhABA.....hAGA...,2,-31,-25,6
YeDBRQUOVMFNfJAKCIZgLGHPEWaTSbcXd,CFEDZAADGCCHEHAC..aAFASAFB..XFDGeHEADBBGhAAABCGFQDAHhABAOCEBFHFANHBH.ADCAIFBHhAAALAHF..WCACTACC.dEHE..hAEA......hAIA...,1,-17,-26,9
ZVcTJEOPBFDbHKYUWRfALQNXaICgGMeSd,LDACQCGCXEEFCHFDGCCB.eEFBSBAAZFCB.TFBChAAAOEHDBAHGFFBFbDAGhAAAKDHFUBEF.fHGBhABAaBBBIAHDMFAFcACDEHCA..hABA.DGAF....hACA...,2,-11,-5,6
VYGgHXJEQACLbBTRZKaNUFDeWdfOSIcMP,CAFBLAFBBAACZDACKGHD.UFEHFGGH...DAABdCGE..SCCEhABAMFFA..VBBGhACA..YEBBhACAHFBDXGDHEAEDADAHbDEAaBHF..eDAH.WHAGhADAIHAG..hADA...,2,-34,-18,16
MBeNPHAEVFTbYUDWRQLcdaIOGgCZJSfXK,EEHBTCCBUFDC..DEGHQADCdGAC.OCFDGGBHCGABZBBDhAAAJABDSFAEhAAA.KGHDeAFEHAEEFHGEhABA............hACA......hAIA...,2,-25,-24,1
BTQXKZOURNWEgbCVJLdaeHScIGFMYDfAP,TGGGQFCA.KFFHOABAUACGRAFAEAFE...CCEHLFFChAAAaDEEeFHHHBAB.IGAEhAAAMBIFDCBC.AGDDBEBHhAHANCHE..........hAIA......hBAA...,2,-36,-11,25
RCFDTXdNQbJZEeacgSOWIAUKfMPLYBVGH,KGFCMCCALBEEBAGCGCAECDDG..DDBHdDEG.QGFEhAAAJCFDZAAE.eHBE.gDGAhABAOGAAAAEC.fACBhAEA..PHDC....hAAA......hABA...,2,-51,-13,38
feIAVJTNPKFXWaGSULDMZOEQgRdBCHcbY,JBDGTCBC..KHGAFGCD..aCFEGBECLGCEDEIFMDAD.hAAAZCGDECAGQAAFhABAdEAHBABBCEDBHGEE.cECBhADAfAGBAAIFNEBE.....PEHDhADA.....hAEA...,2,-35,-5,30
dDSbVgRLIeCBPXacUZQWfHAOYGNFJKTEM,GECFJCCH.EDBHDGEA..VAABLFABCHHE.BCHB.aBEGZAGHhAAA.QAEHhACAHDGBAIGGOCFHFHECMDDASBADhAAA.........hADA......hAEA...,1,-18,-40,22
PeJfNSZBUTRHdQFbVGOKaLDWIYAEMCXcg,CBGEXCBC..PDGBeFEB..JBHFSAAEZFBBBHGGUADChAAARACHdECG..FGAFVDEEhABAKFHBLFED.hACADBFF...IEAGAAIF.MAIF.hAGA.fGGBhAHA...,1,-26,-30,4
MfUTGZCaXISKbROdFDHQLJEYgWcANVeBP,VFDFeAFBMEAC.UFFDZDDACECD...aBGFICBF.SAHHhAAAKBACOAEDDHBEhABAQGAFEFCE.hACA.YADD.WHDAcGGCAGADNEEB.fEAGhAAA..hABA...,2,-43,-16,27
KHbFDOGeEUXCcNVZLdaWRgfPTISQYABJM,MIAGKCFCFFGDGFCH.EEAECEAB...VAFHdEDGaACG..RCCA..hAAA..PCHDIAGAhABASACHABDABHDAJBBFhAFADIGEeEEE.XAAFNCIA..LFFDhAIA.fFBChBAA,1,-18,-37,19
KRHAJLNXZeGfVdcbIOBMYCUgDQFWSTPaE,JEEGLDACZCCD.eFGBGBACdCGC....bAACIGHH.hABABHAGMFEHUAGFQFAAhACAFGDF.SHBAhADAaACAECHB.KAFDABAD.NAIEfCEEhAEA..OHFC.hAGA...,2,-25,-16,9
VLJPAQEMSBWXFfabTeDcIUOZYNGRdgHKC,EBDHBBGEFDABaHGE...eACDDCIHUGEBZEBHGFEBRCFF.HADDKEDFLACEhAAAAABBMIAG..hABA.SGADhAGAfFAE.bDFAIGBDNAAACEED.....hADA......hAFA...,2,-31,-8,23
EbdZgHKQeWDBaUYRJLGFCTPXcfVIMONSA,EAFBdCFCHFFBKBCC.eCDHDEFABEDBUGAERACCGGAB..FAHFCDAG.TDAGhAAA..XGFEhAAA..cBBChABAfFCDMCHFSGDCbAGB..hACAgBAB.hADAaCEC.LFFE,2,-21,-14,7
EVLgQTBdRWfCYIAGXKMbDUOJNaFZSceHP,XECBKGFHMCFB.DHFGUABG..OAEH..JDBBaBBDSBHFhAAAeAGHEDADLGBAhAAAQGBEdFGFREDBCDDCAIDANAIEhABA..FAFG.........hACA......hADA...,1,-20,-32,12
PBRLYDKEQJfCFHdeMIGbSgVaZOcNWTAUX,UCGCBHHGRFCDLCBHDCEH.EDDGQBFA..fFHAhAAAHAAHMDADIADGhABASAHBaFCDZFDBOFFHhAAAWAFCAFEB..XGAH.KCCFCGFDdGBGhACA......hBAA...,1,-17,-21,4
YMKRTfZgPUedbXCSOVQaJEDILHBAGWNFc,GAFEFHBGMDECREEFZFAB.UACGdFFDCCAA..OHFCQECG.hAAAEBFEIDHH.hAAABEDDAIECNDIE.KBACTACEhABA..fGGBeFAFSGEGhACA......hAEA...,1,-25,-26,1
LgSFaCKHZcEbONDdBGMQfeXAJTUWRPIVY,JDCHTCGC..UAFERCCG....IAGFLEEEFGGECGHGZACHhAAAEFAC...OHBAhABAdACDMIFEeFFFXBAGhAAAAEAA...WGCG......hABA......hADA...,2,-41,-28,13
DSNFMgPfYKIdLEAJXVbTQcGRCWHBOeaUZ,XAEGTFDH.GDCGCAAFBDEG...OAEEaCAHZAAA.SBHFhABAFBBGMFCB.gFGFhACA.fFAEhADAYDHBIDAFLFFFAIHEJFABQCEEhAFAWFFH..eCEGhACADCCFNIAF.,1,-8,-30,22
eCNEgcAbLFTMIDXWUKQBRJPYfSOZGadHV,FDCDMFFFDBIFUBADBHGE..RCFG...JHBC..fBDChAAAZACGGBFGaHCG..dBACeEEEhABA.CAGE.EFEBgGGFhACAAIFE.TEAHXCDBKFCA.PEHDhAAA.....hADASAHF.,2,-33,-10,23
NcBJUCdZbXIMHLWOAKEDFfaVTRQgPYSGe,DGGDFAFB..aBBDVAFB..RBGD.QFAH..gGFChAAAPCBCGDEE.hABAeDHBBEDHCCACdEABZDEBIADDhACAMBAC.LHAAAHHA.KEHB.hAAA......hABA...,1,-17,-24,7
CLVHZUOdMREBFSaQJIWfNPeAcDYKgTbXG,DACBKHBG...TEBEXAAFGFEBLADBZAFAODEGdCFCMFBGhAFABHHEFDBCQGAGhAAA.IADAhABAWDHB.fDDEPFFHACCG..gAGEhAIACHEG.....hAGA...,1,-20,-21,1
VDfLgeNAZYQTbGPEIaBXSCMUKRcOHdJFW,QFDHTFGH.GEAAEGBABDACCDDFKAHBODCAHCFH..dADHJEAGhAAAVBAEDAHBLABEhAFA.eEFFAIDG..hAGA............hAIA......hBAA...,1,-22,-29,7
QaPRKIAEGdefFbTMDJUHScXCLWZONBgVY,dDAFFDCDMBEDJHDE.HBFG..XAGFLCAFZEDEBGBB.VGFGhAAAaBFDKDHHAIEA.eBCBhAAATABF..SFABhABACAHBOEFGgFDFQGGCPACAhBAA.....hABA...,1,-18,-19,1
CXbRQKLDOeMEWHdFIYVUcTfZASJPNBGag,JCCHBFDGGBECCCGA..RAEGKCAGLDAB.OEHBeEDGMIFAhAAAEGFDHAAA..FHAAIHBBhAAAUACE.fAHAhACAAHFG.SAEFaBAG.XGCFhADADAGAWEHD...hAGA...,1,-17,-41,24
fYNeSaEcTBbJHPGDMdWLXCAORIgUZFVKQ,OFBBRAADUGGEZEBEFCCF..KHEE..QDGB..YABEhAAASAGE.EGCDhAAATCFCBACCbBEBPEGDhAFA..MFFBLECAADDC.IAGChAIA.fBEAhBAA.NCIE,2,-39,-27,12
TKWOfSdcVYEQGXMZFUBLeCgHNAIRbJPDa,RAADJGEADAGC..KAFEOFBB..dCCF..VDFBEGCB..QDADhAAAMIFAZBECBAFDhAAALBFG.CDGG.HDAGhACAIADBaADB..WEDHfEED.hBCA.cFGE..hBHA...,1,-27,-38,11
HUBJWIaQZYGSfEDMbLXKARdPCecVNOFgT,RDAGCFED.eAHB..VDAGFGGAHDFGBGCF.JFAD..aBBEZFDD.GACHhAAAEDFE.DCACLHDAhAAA.ACAHdBGFNDCF..hABA.OFAB........hACA......hADA...,1,-17,-37,20
ZPaKcFdCWRUbLHNeVIMYSTEOBfXAgGJDQ,JFEFDEFAZGCG.KDCFdEDB.CAAF.UABGHCFA...eCAHMFDASACChAFA.EGBBfFABhAAA.AHBFQGGEhAEAaAHDFHGA.bAEANCCA.....hAGA......hAHA...,1,-27,-36,9
UgNdTaIWFMXPVZJRcLKGDbEOefYAHSBCQ,BCAHUABHdEFGaGEE.FGBG..MBEH..XBFFZBFFJCCDLFGHhAAADBIF..OEAEhAAAeFCFABHGCGHD..QCCBhACANAEH.IHDD....hAEA......hAFA...,1,-35,-42,7
dIYGObCeUQWSFgJDBPVRcfLNKXTEZaAHM,dAABGAFECBHD.UBBBQFGHFHGE.DCCABEAD.REFCLECDhAAAKGAAEAEB.AICAHFDD.hADAMABEIDFD.hAFAODBA.eHEGWAHB.....hAFA......hAGA...,2,-41,-17,24
PBRZGSFdcMEUbTYXADaeCgIHQWfLKVNOJ,eEACCFDGHAFAQCGHLAEDKHGEOEFHBHAHGBBFFEFC.MEEBhAAAEAAF.UGBF..TDAHhAAAAIHE.DEIHaACGIHEEhACAfAEFNADE.......hAHA......hAIA...,1,-9,-26,17
gZUAFHbaNEOVPQeYRXWCfLTDGcKMBdJIS,FCFCHDAG.aACDEFFBODGFQADB.eGBERFAGXFFD.hAAACBAHLAFFDBAGKAGEBEFEhABAIFEHSDDHhACA...........hAAA......hABA...,2,-33,-25,8
SbDagJXOTLfcQRVNMEIGZdHUBYeKWFCPA,SHFGDGHH..JCGFOAAHLEEDQFDFREAB.MEAGhABAIAGGdCGHUBDEhACAeACB.FBBHCAGCAHCDaAEFTFAEhADA..fFFEcGGA.NDICEHCEhAAA......hABA...,1,-13,-36,23
KObaEgACDBXVcMdfGZUIWJRLYFHPSQNTe,BAAHVEFH.dDGBGBAEUFDD...JDDFLEBBFACE.HAEG.hAAASBDDTAFEKDHHhABAaHGAAICECCEH..DIAAXFAEhACAMACC.IHHE....hAFA......hAHA...,2,-32,-25,7
SMTQXEONbgJRUYGCWdfLPVcaeAZHKBFDI,HDDFKEHBDFAGSAAF.QADEOBEH..bGBAgGFHhACARGFGGAAECAEBdGBELAGFhAAAcCBDADIDBEFBhACAIDGDMADFEFCAJAFGWFHH..PAHDhBAAaDAH.....hADA...,2,-11,-8,3
cbIAUeHaRWdJNGCLfDQgVPSEZBMTXKFYO,eADGaDAF.dECGGECECDDE.LAFEQGAC..PFFBhAAASEFBZCFGMCBAKAACFDHHhAFAOEHF.IACDhABAAHIHHGDEWAHBNEAEfGBEDCDC...hAGA......hBAA...,2,-24,-2,22
XOaYSRDBcWFZGVKfILEAPCeUgTHdQJMNb,CAFBeDACUCAAHFGF.JABAMDGF..XCEFODHF...aGDHhAAASBHFDGFBBBHHFGAChAEAZFCEKCDH.LHFEhAAA.AABB.gDCA.dAFFNIAB.hACA......hADA...,2,-36,-16,20
VZaMUXcIFECdgTBPLeNJSQfWRbDHGOAYK,KCFCZDDFMFAGUDBD.....IHFDFFFGCHAD.dABABHEBLADEhAAA.JDHFSAGAhAAAQGCC.RBEEDBIDhAHAHBAGAHBB.VFBF.....aGHF.cAEBhABA....hACA...,2,-42,-16,26
JQEdLNaVfKBUbFIGOCZSAWRcYXePHDTgM,RAADXCBCHEACDEEG..MFEFEGHBLAEB..NCFGaAECKGFBUGDAhAAAFGCF..IAAFhACACDHCSGAFAIHE.hADA.WBHH..cACFeFAHTGFDhAFA......hAGA...,1,-20,-30,10
UCWFZXSDdMcRQVPLeKGOIaYNJAEfBgTbH,BFEDTCBCUBFD.FABGZFBF.DIEGdHEBMABE..RFAH.QDEChAAALECEKDHBGAGGhAFA.IBEBaDGH.hAAAJFGFAHIHEBCC.........hAGA.fGDFhAIA...,2,-38,-23,15
cbSDXMWJLRQTafHYEZVCGAPNIFgedUKBO,..IFDGeCCHKCAEBAGCOHBE..SCEHDEABMIFALDGHhAAATABHHGFAEFDBCEFDhABAGDAE.AHDDFFGAhAAA.UCGAXBGA.JADERADF.fABFhAHA....hAIA...,1,-6,-27,21
DGcRMAQWOaJSZLNdKBVfbXFIEgUCeTHYP,QDACaDCDZAEA.dFFGKGFFBGCF..VGAGXBGF.EGAFhAAACCDBeBAFHEGFPCBAhABADDIHGEGA.MAFEhAAAAEDC.OFDFLFDB.NBBH.fCBAhABAFCFF.....hACA...,1,-8,-15,7
GaMZOHVAgPCFDWEecYQRKIUSdXBNTJLbf,CFDGFHFGDGHFeFFE..QDAFRFBHKAGD.UACBSDEF.hAAABABFTCFCLEAChAAAGGAFMCBAZAFEOFEAhABAAADC..WAHBEHEA.....cGDBhAFA....hBAA...,1,-19,-37,18
TYKgHfeDWVLMIACZdSBFQacJXNRObEUPG,dBBDSEHBFGEG.QAFEJGAE.REEA.OCEAUCBGTGDChAAAKAGGHDAE..DCFFLEEAhAAAMABCAHBGBGGAhAFAaADA....NEIG........hAIA......hBAA...,2,-32,-26,6
gHIGDKLeEBbZVPCFAdJRNTSXfUOQacWMY,dDBDJFBB.RAEA...SDGBXGDDUFGA..aADG.MBBFhAAAHCFADCDCKFAD.eACHhAAABEEG.ZGEGCBAFAIAAfAGChABA.OFDBQEDD..hABA......hACA...,1,-23,-37,14
YgQGNRHZIVDMaFSOTJEcKeLdWPbBAXUCf,CCAH..fHBHQDCBGBFERFBBHAFAZBAGDIEGaEDEFEGD.OAAEhAAAEHEGKFGH.dAEA.PAHDhAAABEAAAGEH...hABA............hACA......hADA...,2,-33,-17,16
VWOJdGIfUNZSTMeCHAYDPXFKLRgQcbEBa,DACBFGFCLDAFQDAFEBFCBCHA..VABAJFCCGDEB.hAAAUBDDNEICZFDF.MDHFhABAHGAE.AHGA..PAADhAAARGAC..gDEGaAGD....hAEA......hAFA...,2,-17,-15,2
TKeUMYJPDbcaZALXfHVRCEGSBNOdQIgWF,LDACHEFHCBADGEAESGGG.BEAHdBBAQADBhAAA.gCEFhABAFEEETABDeEHHUAGFJHCEDCHFhAAAaDCDXFCG..fAHEhACA......hAEA...,2,-35,-5,30
PaWcIBgCdKHOQeUVNGMXFbSALDEYTRfJZ,EEGCREFHZCFA..aGGF..IGBCBEEBdFADHADHQGCHUDAH.hAAAVBFFMEED.XGCHhABAFAAESADAhAAA.AIFADEAA.........hACA.fBBChADA...,1,-22,-31,9
VLfQbWeTdKXYJBCgSHMNPOIUREaAFGcZD,GEAHDHCELBEEQAABeDEH.KBDAJCABCHFGHAGF..MCDHhAAAODHFUDGEEGADAGGBFFAEhABAZDDAfGHEhABA..WACC........hAGA......hAHA...,1,-4,-37,33
EUaRNJLfIbdPBWHGOSFTQCZceVXMgYADK,EGCDRBCFLDHB..IAEFdFEDBDAEGCDEOEBFFAAGCBBC.eCFEhADA.MFHDAIHEUAFHhAAANCBE....JFFFbGDChABA....WEHB......hAGA.SDFBhAHA...,1,-26,-34,8
KWDJQgUYHCIMOEASNFVPfXaBZdGLcTebR,SAFBFCFC..PEDCaAHFZDFBLBAHeEAE.RFBGDCCGJHFEUBCHhAAAHAFC..MHFGhAAAAHCE..fDDEhABAdFAG...........hABA......hACA...,1,-27,-28,1
NLESVCgfDaAWdYOTZHBcQXPMebUKIGJFR,dHBHODACHCCEBCDDQBFE.XADFPAAC..eGEAhAAAKCACJEEBRCGHLHAGhADA.SFDChAEAgGFAaFAAAFBD..WCHB......hAAA......hABA...,2,-26,-23,3
BQZaCMUYSLJWANVfdFERTPeDIGXOHgcbK,VAADdAFBREFE..eABGDHAGGFBDHFCA....bCFEBDEDZBDECHEEUFFGhAAA.SBFChACAJDAAAAAFFGHD.EDBH.TCFChADAXEAC.........hAEA......hAFA...,2,-28,-8,20
UKcPbNLOJfMeXTBDaQHYdZRFEAgGVWCIS,GEDHCFDDUBDH.KGGH.....PAGHNICD.LDCDOEFG.hAAAMFBDeAHFBDHDDBBDHDAChABAdBEGFBADAEEF...hACA.....WHFE.SGBFhADAcGEC.fFGFhAEA..,2,-33,-28,5
CHDPXbaBRGgVLIcJdFNQOZAYWKfUMESeT,KHBGMFFFeBCHHCFCDAID..XEDBBBBAREED.VFBHLDHD.hAAA.JBBCFBEDQGGEhABAAADE.fEAHhACASAFEPAEGaBAB..IGDFhAAANDAF.OEBH..hABA...,2,-39,7,46
gdDHAWGaCTfXSMVecYIRNEZKPFLUJbBOQ,aGAHTGGG..SECAeFAF..IDEGEFFEZBAAKHDCLEAChAAAJBGD.OCHFhABAdDAGDDIFHADGAIHE.CHFDfGCDhACAMAAC..cGBC...hADA......hAEA...,2,-29,-19,10
OBWZegXDaKGRHCQdTVMJLEFAPSfcUYbNI,SHBGUCBC..NCIC.BEDGZFCE.XBEBDABG.GDGAhAAACAHG.TDAAJHEALAEFhAAAFABDAGDA..PFFBhABA..fBFBYAFCICDHhADAeEEEKGAF.....hAGA...,1,-12,-39,27
PMIVGKCAJUDQRNfETZdHgcFWeSLOYaBXb,JEGHDFEERCAE..EAFEZDECHBAEFGGA...SDFFOHBE.aGHDBGBFhAAA...XEBEhABAPFCFMFBF.hACAIDDGVAEHCAHGACHDNCEBdAAB....cACGhAGA....hAIA...,1,-14,-37,23
NXWBgcLHYPbfJGdSMKVUaFOCTeDIZAQER,RBCFXCBCBFDGLAGFHFDF....bAFDfGFGdADD.hAAAKAADaGGDFFBFCDED.DCIBAFCGEAHHhABA....NIAF.hABA.....cEEAYFFEJEHFMAFBhACAOHAC..IDAGhADA.,2,-36,-11,25
JVAfBZWKYbcaCDgFLdTRGeEPONISQXMHU,ZDBHKHBG.....bFFHCCFAFBCFLEHHdAEGGEFGeAAH..EDDBOAFChAAA..SHAGhAAAQEDGMAFAhACAUDABAIDEBBEG.WDFFYFHBDHBAgBGEhADA...hABA...,1,-9,-36,27
NMZaLAWEOFeTdBXJKHRfCYPGcgQVUbISD,OCCHFGDDdAEABGBFKCGDHFAH..RCBE.CCHBGFEBQCFD.UGFChAAAIBED.SBAFhAAADABCMAIFaHAChAGAAEAAEHEE...XDDF.fAFBhABAcEBF....hACA...,1,-26,-33,7
HWOgNbEeIdFLZAcTCaPYQfXMRSVJKUDBG,CHHGaHBG..QDCCMGFCRDBD...VAAEUBFABHAGGACCHFFHhAAAOEDD.NAAE.eADGhAFA.FEHFACIHPHFAhABAXCEF.KHDEDFABbAGF......hBIA......hCAA...,1,-14,-18,4
RcVAQCMWJEDHfaIFUKPdGXZBeNbLOYgTS,MEECEDCDDEFDHGCE.aBAHUABF.dBEGXAGGBDHE..eGAEhAAANCIELBBG.OEAFhAAA..TBFAhACASGGBREGFAHADCEAF........hABA......hACA...,1,-22,-36,14
EPXLGDKdHCYaIObMTZgVeRcJWfSQBFAUN,EGFCXDACLEAFDFCA.KAACHBFG.CCCC.aDCA..OBDDMAIDZBFDhADAVGDERFBC...JAAEhAAAfBDHQFADhAEABHDEFGGAADIH.........hAEA......hAFA...,2,-27,-11,16
WHUGYagLVdNeRDJFcTQbBZAICKPXfSOME,KEGDXCBCODBE..ECGDHAABGAAFaHGELAFFdHGFeFDEDHCAhAAAJFED.FAGC..TBGFhAAAbFBCAFHF...IGBGhACA.CADC.SAEH.MIAGhABAWHAG.....hADA...,2,-20,-14,6
NAdBLeYTOXcZWRIFMEKHgVaUbDCGSQJfP,LCAFeDACOEFAZCEDRCCBFAFDKGEC..HFDE.aEBDUGBE.CAGDGAAFhAAAJABC..fAHAhAAAAAHEdHGBBHDBYFAFhAEA.cGFD.....hABA......hADA...,2,-28,-13,15
GTIBOANSfZgLaePMKUXVRHCYdJcDFEWbQ,SHBGZAADaFDG.MDFGUAGF.REGDHGDAdBCEDADE.FEHFEFAAQECBhAAAGACEBCEHAGCF.hABA...fFFDhACAeHAG.KBGGCAEC........hAGA.cGEF..hAHA...,2,-33,-12,21
dNPUSeQRVfTcZYLbHWJMBXAFIagGKDEOC,FAFBaHBGGAFAEEBH.dDCDUFDE..QGGGVACB.fFBFhAAATFGH.ZBBELBAFhAAAHFEBMFAHAEIFKCGFhABADICCOHEECDADNABF.SBHB..hACA......hAEA...,2,-23,4,27
OHaQbYLZXCfJGWVdKNTUgESDBIAceRFPM,eFBBRDAGFHFA.OBBHHCDCQBGALAFAZEDBCBAC.GCED.dACAhAAATGBEUFGDSHFAhABAIFADAFIBMAAGhAEAaGAH...XEEA.fBCAhAFA.....hAEA...,2,-11,-7,4
RLZKWEHQMTXSGfAIUgdDYCNecVbJaBPFO,UCBCdHFHCGDA.eFAA..VCAFJFFH..BDGCFGBHLAGFZBDF.hAAAKBBCEHCG.HAFEMDDHhAAA.....SGGEhABAAHABIABCDFEAYEHFNAFE..hADA......hAEA...,1,-31,-32,1
FSaMZYRGTKbeDABJQLcVOUWEgCfXHIdNP,JEBEQDACLHBEODFD..UEFCEHACCAHEHABH.dAFANCDE.hAAAFAHF.MDADRFDFTABDhABA...KAGD.hAAADFHHABAFcBDB...WHFAfAEEhADA....hAFA...,1,-23,-25,2
DaOWURPMHZASIBQFdVJXNYEeTfbKGLcCg,BFEDFFHBdGEAJDHH....XCFAEHGA.eAFCTAFA.KBAChAAALCEF.CABDDFADhAAAOFAAREBBHCAAAAEBIHCEhABA.QCCA.NDGE..hACAfDAB.hADA...,2,-34,-24,10
MaUIJHWbOFdYZVcXKSfTRCAEPQBeNDLgG,QGBCBAFBDGDGLBEFMAGD..IDCAJEHB..HDAChAAAOABAFBAFdHAFZGFEVEEEhAAA.KBHB.TBDEhAFACHEHABIH.eFBENCGE........hAHA......hAIA...,1,-12,-41,29
VWfCcOZEHAeGPDRYTMUFBbKLINaSJXQdg,GECFRFDGMBAA.BFHCLAEGaBGC..SACBJCHB.dHBDVCCFhAAACHHA.ZCAFAECEDABF.hABA.TGAFFHEAIBEAhAAA...NEAA.......hAEA......hAFA...,2,-36,-26,10
aDKcXYgPJNfEdSeHIQGOULBWZCVbATRFM,FDAFDCHHKGAB..XFGH..PEBAJGAC..EACGdGEDHAFDhAAAGAABODECBBFFhAAACBCGACIF...TECChABAaDABgFGB.fGCGhABASHDAeCDG...hAEA...,2,-30,-28,2
MOGIXRWVCcLYZadfgPNbFHJQAeBSTKDEU,SDABDDFFEHEC.OAFBGDBG.XAACVDGD..CHAHLGCAhAAAZBDEdEGG.PDDBhABANADFFAHD...JAHHAGIH.hABA............hACA.BGDAKGHBMEADhACA.WCBE.,1,-19,-23,4
KaHWJSPVIBGcMFfERZgNTeYAUOCDXbQLd,OGFACEFADCBA...XCBELCEEdFEGKGBFHEBD..SACAhAAAIDHDBBBFhAAAMFIB.fGAEhABAEFGHZAFA.NAFA.eFDHAIHE.QDAEaGCD..hABA......hACA...,1,-16,-33,17
UJBLPcaeVDWbCOAZKMTXYGHFfRNIQESdg,KHDCTGABGBBG.FBFBRECDQADA.dAGAUEDFBFEBPEGBhAAAeHFADBCH.bBADhAAAABAGMAIH.XGAChABAfDDB.IEHDEADD.SGGChABALCAF...hACA...,2,-27,-6,21
SaOUPYdZeBKEFLIcVGTgWRXHbCDAQNfJM,QCBCJGEA.aGBFOCAF.UCDGdAHAeDEFKCGH.LABGhAAA.IHFDhACAVGBG.gGGBhADAXAACCGACADIHNEDC.MAGDSAFE..hABA......hACA...,1,-2,-48,46
DSRIAaFgHebGNBYZQLEdfKPUCOXTWcVJM,aAFBFCFCeGAAGGCFBEBCZCDFLBAB.dDGFfGGFhAAAKAHHCACE.XACG.hAAATFEEcGGAMBIFhABA.DAGGSGBFAFAD.bEAANDAFYEEChADA.EHCA..hAEA...,1,-11,-28,17
CVcXDBFSaWPZJEUegKTYLQMHfbNdIRAGO,CDHBXFDHBEAH.FABD..SGDA..aAEGZBDAJCDCUEEHhAAAeBADKGAELFGFhAAAMFIF.fFBEhABAdBBAAGHB...........hABA.OACAVAGFWDDGhADAEAHF..,2,-42,-17,25
fQbSGLXJFMgUDAPWBVKTEaOINZeCYdHcR,BFDGTCCBEEAG..OGEAZAAFCHGG.HFCFRADH.QAACGCECLAGFhACAJCFFMDBBDAIFAAHG.hACA.PADAKHCAIFHEhADA..NCIGdHFD..fFAEhAFA.....hBAA...,2,-21,-9,12
MJXaZENdVCUTeHOGRDAWQfYFSbgILPBcK,QCBCFHBG.SACCICBFBFHBKEFH.MEACJAFHaGHHhAAAZCFAdAAF..CEHBTECDhABAOHEADFBA.AFFE.hADAWHBE..bDDDgAGBLAFE..hAIA......hBAA...,2,-31,-27,4
CbdLJBWHTRQAMYeEPIONXgcUDFKGafZSV,eCHDEHBG.OGBG..gBCFDDDCKHFEGABFaBFBZEAGSCAHhAAACDAEdHEDBHAGTEFEhABAADHDMEFH..IECChACANCGE.UAGFfAAELHAAWDHHhABA......hACA...,1,-6,-31,25
DPUWRLbYKfQBVAaEeNJMISdgXTHcOGFCZ,aEEDeCCH.MBEDdECD....TDGEHDFAOHCACFBDZACG.DABEUAGFhAAALFBAKFHBBDDFhABAAHGBJAFC.IBBHhAAASGDGXFGAFCAD..WHAG...hAEA......hAIA...,2,-22,-20,2
gdaWAbeGTXQOfKSRPMYFCHJULEcIZNVDB,GECFQCCBKBDCRAAFMEEE..FGGGCGABUABDECCE.ZFFGDGCHdGDAAAGG.hAAA..eBFGOEABhACA..SFCFhAAAHBGF...........hADA......hAEA...,2,-28,-25,3
GKWagNIAZPBUHTCXLFROdeQSVJMDbfYcE,BFDDHCDBCAGAFCAHRDBD.dDCD..QAAB.SHCGhABAVBGFJGEE.MIFEDIEA.bBFA.hAAA....fFGChADAEAFAKBCGaFAFIFAAAIAE....hAEA......hAFA...,2,-46,-19,27
NZdVWbLHFQATcJXfGgYCDUOMeaRPSBEKI,TDACJDACGECD..CFDGDGHDMDHB.RAAE.BHDG.KHECZAECdCGCVFAFhAAALFFE.QBCAhAAAAIGG.XFAChABAfGEA.......hACA......hADA...,2,-35,-28,7
aZFMeBNESgKcbOPfVDLdHXCJGRYUQATWI,TCBCaHBGZDCF..FCGAMGFG.BHDFEEHBKBEEOEFC..VFFBhAAALAEF.HFBEhAAAXACBCHHFJAGB..YBHBhABAAFAAIBAF.SGAC.hACAcCEHfDAEhADA.DBBE.,1,-22,-25,3
YMHWODbSZUKVegCFEGcIfPBAdRLTXJaNQ,dDBDLBDGJFAC.aGFE..QGFGMGDCOBHHDHACZACA.UDFDhAAAVCAH..eHCAhABAFGADEDDD...IDFGhAAAPAGHACCD........hADA......hAEA...,2,-30,-24,6
UFCgAJOMDfQLENPXBKVRcHbYIWGTeSZad,MBEADAFBQGECLDDGEHEE..NDBA.BCBD.KAAGRCDGHABHhAAA..bFDGIAGChABATEAHZCGFdEHACCHEAICE.fGCEhADAXACF........hAEA......hAIA...,1,-17,-23,6
YXgWTLQUDNfabeVMIAKEHZRcOFBJSGPCd,KEHBHBCFZCDCODABFFBC.SGEHGACHdCAC..XEBHhAAA.TGGELFEHhAAADIBEaDFDeAHFMHBAABAEEGHBhABABBFHJHAE.CAHHWACC......hABA......hAGA...,2,-21,-17,4
NYWZETJAQSMcPbLRVDefgCOaUXKFdGBIH,SBDHMCCA..bBABRDFAeGAA.CGHH.aCGDKBFCFFFA.BGDFhAAAHGDG...WCABhAAATEBH.AAFEcAGGhABALCCD.DABEfADB.OFHDhACA.dDDB.NIBF..hAEA...,2,-30,-12,18
ONcJSDFadbGAZRUTCPYBXLMVQEKIfWegH,RBCDCCAHBGEGMFFC...QBEAEAAF.KHGEfGDC.hAAA.eABBOBFEJHAESFEEhACAFAEGbDABAHGE.hAAAUAGEPDFELDEA.IEAHhADA.gEBHhAEA...,1,-17,-30,13
ZWPXROLKeSTdMIaHCDgGEbVJFNcUAYQfB,QCBCZDBH..XACDOFBGLADGSDEDTGCDhAAAdGHEaFADHDEH.DBADhABAgAEDEGGDVBGFNEIAhACAAIBEfAACBFAD.RDFCKGGF.MHCEhAAAIHAC...hACA...,1,7,-23,30
YdcIGbZRJAFQBageVfLCWUTXSPOKENHDM,FFFBQGAFBGDG.aHGAeDAH.LAHHCACGUGEE...TCCDhAAASEDFKGHB.EADEhAAADCABMCID.dBAA.hABAICEHbABA.ZBGDADFDfFBFhACA.XEGB.hABA...,2,-24,-22,2
BKFdJZQSaYbRNMAGCOETIXPfHceUDgVWL,OCBBTGBC...XEGHHBABUAFGDBHH.VDFHBCEA.dAGFJACAhAAAZFBDQCCChABA.aHGEYEFDhAAA.NDAE.AIEECFDA..EBBE......hABA......hACA.fGDAeEHH,2,-25,-2,23
ZgPJMAacbHdUFYTSDVQWCBEKfXLeOGNIR,aHBGHAAD.FDFD.SEHDQBFBBCFFKDDALFFFGDAB.hAAANACG.IAHAZDGBJAAF.hABAMCIFAGAE.dFAG..hACA.TADGDAIHCHHHXADBeHCAgGGGhADA.....hAGA...,2,-27,5,32
ZeBNfYUPSXCLJQbOdgTRaAGHMcDIWKEFV,MIDADACBKGHBFEEBZEAABAHD......fGFCPDAFCCHC.hAAAQDED.hABAdHCBgCFDhACAaCEAAAAFHBABIADCEBHB.NCCG..SGADhAFA.XFGChAGA...,2,-41,-23,18
WTgNCILDOVPHdXSKBeAbRaUZJfMQGYEcF,RDAGZBCFMAHFGEDB.EGCFFFFC...TAACCGAADAIF..ODABhAAAVFAH.dGHG.KHEAAFDGaHEEhAAA..JBBFQADDhACA...cGCDgBFHIHHChADA.....hABA...,1,-14,-31,17
VPOCTKbDXAdeHNMEgaQcISJGYBZfRLWUF,dDBDeFBBMBCEEGGB..QCAGSAAHJAACBFDG.RCFGUGAFhAAAFHDCOECC.TAGAhADADGGDAHFD.HADBaBGA.cEGHhAFAIEFE........hACA......hADA...,2,-38,-1,37
UQSVgDdEXRaFeGIPYONAMfJHTZKBcWLbC,JCHDTBBHZCDG..BABCLFDB.CEBDQGACSAGADHAEhAAAXCEC.RADGaFFDhAAAFEAGGECF.IADChAFAYAHF.AGCAMFIBKGHD..WHAAhAGA......hAHA...,2,-43,-7,36
WbReGTdHCBLgDMaZPYINUVSFJKXEAcQOf,QDACOGEA....bDEEeFEDGEBGHCDELCBEhAAAgDFAMBFCaCHFYABAhADAIBBG.UGBDhAAA.FAECKGADAIGAfFGA...hAEA......hAFA...,1,2,-22,24
aOMcgeWEQDBLHbAFJIGYUZNXTSdCfRVPK,JCCHGAFEZEEC...NADE...XBEHdFBBCEHE.RGEA.KGGF.OCEHhAAAMAIF..eFADEHDEDIBChABABGCC.LABGhAAAAHBAFCAC.ICAE......hACA......hADA...,1,-29,-33,4
RBQAUKHGgFWadLVCTMNOZXeYPfIJSDcEb,HBCFFGAHdCCCLFFH.CCEEMADEOAAAeFBD..fGCChAEAICAH.JCFASCGAhAAADIEGEFAE.BHHGhABAQDDGKEHDgAGFaEGGTFGHNEEE.YADGhAHA...hACA...,1,-16,-18,2
JgLFYAcNXOWeRTPHbGBfDCEdSIQMVZaUK,XCBCOEEGREAGHFGDBGGD..DIGEdBBC.QGCAZECEKBFALAFEhAAAAIAE..NABDeAHHhAAAPDHB..fAGAhAGAEHBAMAEBaGDDgCCHFABA...hBAA......hBBA...,2,-25,-6,19
bQcSYaMgLVFUfJNAGCKTReHZXPBDdOWEI,CBCCRBCFHEAEZDCCBDADDEEEdCGF..OGBAEHEA..QGGChAAA.SHBGhABAMBIDgGFGFAGA.JAFGhAAAABBCTAEC.XEGAICFEcFDBhACA.....hABA.aBDD.,2,-52,0,52
VKYHQMgcdABDJSNaXbfeWCITUZPLORFEG,JFEDSAFB..aHFEXGGE.eFBBCBHETDBAUBCELFDGhAAAOADCFFAHEHEGhABAKGCFHCFC.MEAHhACAdEEBABCBNECB...WDGB.....IBADhAAA...hADA...,2,-38,-8,30
PXBIRQWCbAaeOSgMETLHcKFYJdVfGUNDZ,eFFBSDCDMDFGLHAEHGFGKACB.FADDJCGBdEHCGAEH.DABDhAAAXCAHBEAERFCCCDEBAFEDaDDBhAAA..OFABhACAgAGG.EABA.......hAEA......hAFA...,1,-14,-20,6
VMLHPBXWZURKDQeNCAaJcOFgESbGYfdTI,JCCHFDCDEEEAGBEC..dEAE..VFGDMIFALCADBHAFZAFHKHAChAAADFHH...QACBhAAANEEEAAID..OBGFhABASHCG..YABGTBAD.hABA......hADA...,1,-22,-34,12
KBTNYGbgWDPSJRQHFXaVULOCEeIZfAdMc,dGFHMHFGBCEE..TAADGDEB...bEBFDEBA.JAEEHAAHhAAAXEGCVAFELADDhACAOBHH.eFADZBDCAICChAAAKHDANEAA....gFDC.SCAAhACA..hADA...,1,-3,-30,27
ZMRdbSOLAVQFJfGIPEDHaTeXNcBCWUYgK,FDAFGECFEDCB.DBABHDGBeHAC...XBFHNAFABHBB..CGDE.UCBGhAAAKAAC.MCIF.dAFFhABASGGGAEHBQGEAhACAIAGF.aACDWBBE....hADA......hAEA...,2,-34,-16,18
fWHRNgaTZcMBdOPYSVCIGALJbeQKEDFXU,LEEGJEEG.QFBDEGGEDCEH.XAGGUCBBHGDE.RAFF.hAAANDAB...aHAGTGGDhAAAMIFG.OBFH.hABAPHDE.YBBE.CCHFAEADKFBA.hABAfABH.hACA...,1,-20,-27,7
YgXQIHecfWDKTJUNBLVPbFaERSAZGdMCO,GBCHCBGE.ODABXAADHDFC.eFFG..fDDDhAAAKFBAJHCABABHLFAEhACA.VFFHPAHDaHAC.hADAEDDDAHDCZBDA.........hAAA......hABA...,1,-19,-23,4
LaYCJOfZDAFVGceWUbQMEPRNXdIKgBHTS,FGFHVEBHGDCF.eHBAUCDH.QFFDMAHHRDAB..dAAHKAGHhAAABADCSACChABA.aDHFCAFCfEGAhABAAAIF..WHEGEFCFNAIE.....hAFA......hAGA...,1,-15,-35,20
CfDYPdZQONKRFAMVHLbXWUBeIJScgEGaT,HFBGLDACXDEBBBBEJGEA..SGHFEBEA.aAGCCHDADFEGhAAAdBACZCBD.QGEEhAAAOEBFRDFEMACEhABAWBCEeHAE....IGAH.hABA......hACA...,1,-11,-37,26
ObaCSAedRVHYXfLIZFUgGBNDPTMJQKEWc,eDCHRBCFHAAF..XBGAIFDGZFFFUBFABAFE.DEEAMIDAQABGhAAAKGHH.EGDCOGAChAAA.CEHHAFFCdDAH.hACAfFHA.FHAC.....hADA.NAEB.....hBAA...,1,-16,-26,10
UOQHEVIRLFfgcJeYMPSbdNKZTAXGaCWDB,GCEBCFEDBHDF.UEAFHCFDEEEEREBF..LAFGFGGC....fCBBhAAAJHFEMEABSACGhAAAdBDDKADCAAHBaGADDBBHhABA............hADA......hAEA...,1,-27,-34,7
dVPfCFcNYAOEISUJZBGTXbWKeLQDaMHRg,EDCDUGBCBCHHGADA..TEEDXFEFKGGDLFAHDDBAHAGFdAAAhACA..fACHhAAACHHBFDHD.NCABAGCDIDFAhADASBEE.JHCE......hABA......hACA...,2,-28,-19,9
ATYbSLQFcRKaGDEWOgVXCNUHefBdMJIZP,TCBCSHBG.LEFFFABAKHCEDGHBOAHH...XEAAhAAANEEHHFDGBAGEdFDAMIEGhABAZAEFAFIDQCAFhACA...........hAAA.REBCEBHF...hADA...,1,-22,-27,5
UAEKHedNZPWOYSXaJGLVcCMIQDTFBRbfg,EEHBKDBDdBGFZCCD..OADGSFFB..aFDEJACALBFAhAAA.CHBF.MHCEDGHDBABFhAHAfBBBAEEE.eCDFhAAANCBA...WFCGYHDE...hABA......hAFA...,1,-27,-47,20
QTKDFSIdaUALbPGcgfVBJeMRHYONCEZWX,LGEAGAFE..fDCGVACBBDEFMEBFRBGFHEAF.OBAHhAAAEFGAXABD.hABATEEEKAFHDFCCIDHAhAAAdFGBAAHG.bADB........hABA......hAHA...,2,-19,-19,0
LFeNcGSVIDRUaPXgKOYHJMdEBbQAfWTCZ,TCBCCEFALDCF.FAABeEHD.GBFGSHGAVFAGDADCUBFEhACAaBBA....XGAGhADAgEDEOHCEhAEAJHCEMBIDBFHCABDGWBAD..NCBCcFEChAFA.....hAAA...,1,-13,-25,12
EabKUBRDGNFYXWMSPVHcQLZgJfOCdIAeT,TAADEAFBKBCC..UDFADDGBFEEF....XFCCMDBFSHEAhAAAHBABLHEAhAAAJGCACCCB.AEEGaGHFBCEHNAIE..hACA.PAFG..cGAC...hADA......hAEA...,2,-39,-17,22
DJWQPGgYUMcVdHfTXNIeCFbZRABKOEaLS,OCAFEEEDLAAEDFDG.QBDEGAEBUGFAMIDGdACGHBGB.hAAAfFCAXCECeEADhABACBFHFFAG.RCGFAFCDaFHDSHAGhAEAPBBF........hAFA......hAHA...,2,-17,3,20
HYeGfOdgUPWaSTbcEMADIQVFXZNLCBRKJ,DAFBVEFHZFGD.LECCCEDH.BHCDJGBEHAEGGAGG..OBCHhAAAdACD.UCFFaCCGSDAHhAAA.TGDEhABAEFAFADBF...FGADNABH......hADA......hAGA...,1,-22,-30,8
VBPOHFgZTfXCWNJYAUGDRaELdcIMbQKSe,DDGBRFEEEDCELCCA.dAABMECHKAGE.SAGABGBFHECHZADF.hADA.TFEACHFG.JCHBhAEAAHIBaGCD..IGHDhAFAeBAFVDFE.OFAD.fABDhAAAWBDE....hAFA...,2,-27,-19,8
DbdceRLYQgZEMFHPWVNfUSJAKBIOaGXTC,BFEDaDCDGEEDCECA.dBCFRGFELBFC..QAGDhAAAEBADHGAA....VDGFhAAAfGACSCCEhABAKDACIHDEODAH.DGIB.bCEE...hACA......hADA...,2,-24,-19,5
ZDTLMJaUVSNGBdQfFPbCIYXOREWKegAHc,HGFGDHCEMGEGJAEDUAAF..SBEHGDEDBCHFdFACQBAHhAAAFGCC.PBGHhABACEAEXDCD.EGAFhABAKECGAIFG.ZGFE..aAGGNAEFfEEBhACA......hADA...,1,-19,-26,7
AbedCLWNcHIfPEZKSOgMGRXDBYTUQFVJa,dDCDCAFBLFEC..NCFEHACF..IGCGEGBAZAFCKGGBOBGFhAAAMIDARCDGBCBB.hAAAUGGFFDHHaGAHAEBH.bEBGhABA....WBAEfCAASDAFhABA......hACA...,1,-7,-42,35
PHgTJfNeYDMaIdSBCZcbVRKWAUXGFELOQ,XABHEDAFLDDG.QGGGHCEATAGEJBBC.eFFE.DFADhAAAICHABDABCGGDbGCAhABAKHACAFCC.FAGE.PADAhAAANIABaECC.ZFDB.........hADA......hAEA...,2,-14,-12,2
ZPFLgdfIeGWSTJEUbRXDCQMOYNAVHKBca,HDDFBFEDaDDEZDAFFHFCLFAGdDGF..eBCHSBADEHCE.UAEChAAARAEFDACD..MHEGhABANEAE.ACBAKHCA..gFGBhAAAIBHD........hABA......hADA...,1,-16,-35,19
SLJVBPCecIaAfKXDRQdEHUZOWGgNFMYTb,XGBCDEFARBAH.dDCFEBFCHFEHZFGB.GABBFCHF.MDFA.TAGFhAAALFDEBCAAPACGhAAACHHAeEHH..aDCBAABEKEAFhAEA..OHAE......hABA......hAGA...,1,0,-32,32
PYELDOFGMAXcWIdCJfRSaKQZHNgBTbUVe,XCBC..WGFACFDG..RBFAKADEQDGBHDEBBHGGTECHhAAAUAAF..PHCChABAEGBHDHDAGAEF.hABAcFAA.IBCGfAFFaFEE..hAIA......hBDA...,2,-32,-16,16
ZRcPeIdHQgBNSAOXCYVfLJGbaDTFUEMWK,XGDEVDBH.LAHDJBBC.GFABDFGCFHCAUCBC.MIBAhAAAZDDBRAEEeFFG.dAFG.hAAAQDDCBCAFAGIBCHHG.hABAfABD.aDAHWAHH...hADA..KFFD.IGAFhACA.,1,9,-44,53
ZHAfFEaQYCRJLeWVBDXGSbcgdONMPITUK,FAFBaFAA.QBCERCBA.LEFBeFGBBGDHDECCGAGESABDhAAA..bEADcBEChACAOFDD.MBADTGAAhADA.UAGC.KDGG.AFFHEAEE.CFHB.WHFAhAAA.....hBAA...,1,-12,-18,6
gfOFRaQZCDPTMKLANJVcWeIEdXHbBSGYU,JFBBVAAD..eCBHdECEHGDABGGEGABF.UGDGfCFDhAAARAGF.QEEEhACADFDCMEAF.KAEFABAF.cAGAhADAEDDE.XFAF..SGHHhAAAOHFE.....hAFA...,2,-24,-12,12
JPOBTUCANYDZKbRGIHLaXfEcgdMWFSeQV,DACBZDAGKACBGEDHHCFELEBH.aAHHfGGF.EEEHhAAAgGGCMHBCSBGEhABAeBDFJAADBHEAhACACGDAAFAD....NIAF..bAEFIFBF.hAAA......hADA...,1,-19,-21,2
PfeWEUDVGCMLIgTSXRaOHAcJbZYKQdBFN,JGEAZAADQFFFBBAB.FDCF....NDAC.PBEB.eHAChAAAUDBBDEGCVDGFCAHC.hADALACE..hAAAICGGSCCEaEAHAICE....cGDChABA.KBGDWFEDhAEAEHBE...,2,-33,-33,0
EgJVYLfBHMCWaPGSQXNIFUcOAKDRTbZed,DEFETFDHeHCG.dEBHEBDD....JEEFLCADBAFBHACGCEBEaCGFhAAAGCAFQGFAhABAXCGAIHBE.hAAAUDDBAIBAKGGG.........hACA......hADA...,2,-25,-22,3
MKaFNGZYARBLTSWQCeUIdEcJDOgXbVfHP,RFEELEBE.TAGGSFHB.QCGHeEHBdAEAJAAAhADADFCCXEAD.hAGAVBBAPGEA.MIAEhAIAFAFBNBAGZCCAAEEE.CHDBUCGFEHEGOHBC..hAAA......hABA...,2,-19,-4,15
FgdIAUfbKQCMTVHRPOEGJWaLXDZNBSYec,UCBCKHBGMFECHBFH.RFDH.OCCCEADD.GGEHaFAH.LAAChAEADHFABHBHeAFD.FBHBIABChAAAABBFQEBAhAGACEEE............hAHA......hAIA...,2,-33,-18,15
bEVXFfBYPDJZRAdGICHKLOSTcMgeUQNaW,GEAHHDBHKFGHSCAGMCAG.eFFGUAFAaBAAEFEB..XGDHhAAABDHHDBACZBGFADGGCHBETGAEhABA.QBEChACANAAF.WHFE.......hAIA......hBDA.FEEA.,1,8,-35,43
YBVHNJgGRFLfOQaDPZcASTWMKEbeXCUdI,TGBCMHFGKEGG..ECFCeAFC..CCBGdACBBABEHDGFJBHHRCDEfGGEhAAA.aECADDAEhAAAZAFEAEAC...WBADhABAUFCE...IFACYFEB..NIBH.hADAFFAG.....hAEA...,1,1,-40,41
EeSXDYVNRTKZdPALfIJFObagQWGUCcHMB,LGEAJGEA.FGCBaBFGQCFGGDCEUCAFCCBF...MDIDhAAAEEEDeFAF.DIEENBAH.hABAKADFdFACABAD..IAFFhAAA..bCGBWEAC...BBHAhABASHGA..hACA...,1,-21,-32,11
OcBICZPVGJTLYRWDUMQKSFbAaENfegdXH,aAFBEHBG..eDBCdCBAOCABBCBFZGDA.GBFGJFFD.LFFAhAAARGBGDDGC.MABGKEEDFABGNAIA.hAFA....XAGEhAAAcECB..CHHE........hAEA......hAHA...,2,-39,-9,30
QWCdUAYcOMPbgLeNZBHSIFJRKXafDGVTE,OGEAMCCA....bBABLBDH.ZAFGSEHFhAAAFCADKCCDaHCCfCFFhABA.DEDDVCGBQEEDhACACHACABAH.cGABPFAAeHDCBEFDJAFG.hAAA......hABA...,2,-29,-6,23
QRCLUFBTaYbdEJPZMAHSOVfeIgDWNKcGX,HDEDSDBDVBFA.eEFHDEBF..KEGBXACDRCBA.LAGDhAAAUGGHBAFCaEHDbFACdABDEHAAhAAAZFDB..AEDEfHBFhABA.IHHH....hACA......hAEA...,2,-26,-14,12
NeRIXYKcSaEDZOHVALPgWfCMdQTbJUGBF,LGEA..PFCAfCABMEAHQBEEJAEG.hAAABCCBeCEGXFGAhAAAcGCC.EHBEOEAAhABAHGEAAEDGCABAdEFFTBGC.bBABFBHFNADD....hADA......hAEA...,2,-21,1,22
AeQSFUgXZdcOBWEYLbRGaPTCDNKJIMVHf,QAADFFAAUBEHZFEFdBEA.BECE.EFGF.LHEARDGBaBAB.CHCG.hAAAKBCH..JFAFMBIDhAAA..fFEEhACASFDDXCGDODAE.YAEC.hABA......hACA...,1,-15,-36,21
dYCXfMGFORUDgABKEaSZecVTQINWbLJHP,BEFAaDABZCFBeHDA...TAGFQBCC.IBAAhAAANDAGLBAEJFHBHEBDdFBAXFDChAAAMEEBFGADUGGAhABAACIBEHECSCCD.cBEAbBEFCDHD..hACA......hADA...,2,-18,1,19
CeZRWYAXbJVTGQEHDcPNgUBSaIdMLfKFO,XDACJFBBGADAHFBF.DGEG..PFDFUBBDBGAF.aDFDhAAAMCBFLHFAFGGEeAAAhAAAZBFA.RAGFADDF.VDFFhABAEDEF............hAFA......hAGA...,2,-18,-18,0
MGdRaZXFPOegBQbVTLfWKNcSCUDAYEJIH,JCCHHFACGBECdFFEaDDGZBGB..FAEG.OBHHBADEQGCGhAAA..bBBCLFAFhABAfGDHKGFESFHBhACADBADAEFGEHAEMAAG......hAHA......hAIA...,2,-25,-20,5
YDMdACRbGeaVXHWfLBJcKNEOQgUSZPTIF,RDBHeFEF..XADEHBGFLACGBDGBKGFAODAEUABG.SGBFhAAA.TGGEhABAFAHHMFFCCFCB.aGCE.hADA..fDDBJCCA.NIDB....hAEA......hAGA...,2,-31,-19,12
FWEHGZXIQgORTLfAScedNYbDaMJVCBPKU,eCCHdHBH....NCHA.bAFEDDEC..JHAECFAD.KABG..UBABFEHDEFEDhAAAGECH.ZBDEICGAhABA.OBEBhADATGEGAAFC.SDBGaEABMIDEBFFB.hAAA.WAHB...hAEA...,1,-21,-32,11
EeCKSAfaNRMHQLJWgFZDIVTbUPXGBYcOd,aHBGRFACHCBELABC..gGFGDCEF..TAGCUADEXEGHhAAAGCBEYEHBhAAA..dCAGCGECKDGChAFAABBAfAHAMFDC.QDEEhABAFHFC......hACA...,1,-12,-16,4
fDXRSHEgbecaUGdFWTLONYBVIKJMQAZPC,CFDDDAFBRAFA.HDCA.EGAAeBDD.UAACdHFHTAGH..OEBHhADABACGKFFHMHECQDGEhAAAAIFCZCFA.fFDChABASAEFgDADaFEA...hAGA......hAIA...,2,-34,-14,20
MaIWCUcHOAREFYBKZPNgTJXdeLGfVQbSD,RFEEEAFBFAAAKBAGZADD......NDAF.JFBFdDGBGDEB..fFDEhAAAQAFESFGGhABADIGG.IHBFhACAUDAB.OEAGAHDF.PHFG.hADAXAGF..hADA...,1,-29,-35,6
dbVaHUGEMSWKZecTPfFLIgNJOQDYCXBRA,dCFCVDAGaACG..GDDGMCDD.KHGEZGFE..eBHD..PAADhAAAfBCF..hAAAIFAANADB.ODBFhAFADGFACFHBXGBFBAHEAHDDbEEGEBAASCHHhAGA....hBDA...,2,-28,-14,14
dcNfQGZSIVDLCMeJXPFRUEBAOaHWgYTbK,ODCHaCFCHFBB......gAEHbFGHKBADdEAC..fFFHhAAAGDCDICCFhAAAVDDGCADEMAHDeBFEPFFBhABARBAF.........hABA.BGHAWEHB..hACA...,2,-20,-12,8
ZTYMVLIRDBFENGKCXSgPfOUabAQJcHWde,QDACJFBBHDEHdCAHeFCGZGFG...TAADMAGFLAAEhAEADCGCBGHGEAEEKDHF..CAHD.SHFGhAAA.fGAGhACAOEDBaFABAFEEYCDA.IEHEhADA...hAFA...,1,-13,-26,13
HdaAbVfRCLTUDINJPgeWFOSZYKEQXMGcB,VAADCFDDLAEG.UAAFDEIF..JEEDeGFE..OFBFZDCEEHCEhABAQAEG.hADAMDAFBGAGHCECaBGEAEHHhAFARGFA..IAHF......hAAA......hACA...,1,-24,-33,9
BaeUROPTIEZNcMXbQKHJgCYLVfSdGDFAW,aEGDUAEG.RCBA.OFCD..IHACZEADMACG..QGGAhAAAJAAHCCGF.LDFBhABASFEHDCIH.AEEEeCCAhABAEHCCXEBA.KAGBYAFGfABFhAIA.....hAGA...,2,-37,-13,24
RMWZBSaUTDHGQEFCNOALeVYJcIbPgXKdf,VFBGJGEA......bAADPCEE.KGFHRGBEMIECBEAHUEFHhAAAHECAEFAF.CBEGAAADeACDhABA...IAEAhADAdAFBfDDBSAHBaACFDAIF..hAEA......hBCA...,2,-28,-19,9
bPDdFGBKaJgNRALSCIMZVOEHUfXQecYTW,CDGFMECGZCEF...OBDGEGGEHCBBUGEHQABH.eHBEhAAATAAA..WGAChABAbFCBDFAD.FBGDKAFGaDAGhAAANAIA.ACCE...IHFE....hADA......hAEA...,1,-20,-30,10
MBFGLacYRUNeWJKHgXdCZVEDASPQTfbIO,QGBCTCBC...ICACMABGFGEAaGFGRBGDUGBD.eEDGhAAAJAFGHDCBdBBBCHHDZBEFhAFADIGAPCDA.OEEAhAAABAHB...LABE.NDIEKHDGhAFA......hBAA...,1,-9,-16,7
XaCbZdHPFSNecJYMBVEDgWLfGOAQITURK,QCGCTCGC.UGBEXDDC.CCEBZFBHdCCFFACA.NABA.JHFEhAAABFDBEBBF..DAIHLAFDhAAA.fFGHhAHAAHBBKAGFaADEbEFA.SABCcGFC.hAIAMGEE....hAEA...,2,-22,-21,1
WQbPXSHfgIREMTGUeJODBcVCaNLFdZKYA,QCBCXCBCHFDF..IAGHMGFGUCECJEDBBFHCCHHGLFBFhAAAFHEEZFABKBBCAIHA..hABA.PADG.fAHEhACAEACGGBDBDDIFaCGE.....hAIA......hBAA...,2,-21,-13,8
JfGOHCMgUcAKNdaWIZPDVeLEBFQRbYXST,KAFBdAFBaFFEZDBFDCIB..LCABBEAH.QCCCRFFF.XCGChAAATBCA.fFDAhABAHDEECHCB.gGBDhACAAAHC..NAAF.WHEA....hADA......hAEA...,2,-43,-25,18
APBHIDQEOFKWaTcCNdVfLYbeZgRMSGXUJ,HDBHDAFBEECHFAGC.aBDECEEC...dHGFLFFCeBACZGCGRBGFGBABhAAA.UGBFJEDEADDGBGHDhABAQEGA.KFABhAAATDAD..NABF.......hAIA......hBAA...,1,-14,-25,11
KaBJfVZeTgFEGDYNMPQcIdALbCWSROXUH,LAFBCFDGRAFA.XDBEKACBBEFB..JFFGZCEC..eAHBFCACDEBGhAAAMBCG...PFCHhAAAQGGGdBAAAEADSEFChABAOFCH.......hABA......hACA...,1,-18,-48,30
gYNDEWOIdfALQbXUMKSaBJGPHeFZRTVCc,LDACQCGCUGAGKEDFBBHEGBCDeCAHRGFA..CDHD...gGFAhAAADFFAEHCGOAHDhAAAIADD.dBFCAABCMFAEhADASFFC.PHAG.FCCB.hAEA......hAFA...,2,-24,-14,10
PJaQBOGFRKXVYITEecWdCSUbANDgMfHLZ,DACBMCCALCHDZGDE..aADGODBHGBAAKEEA..VAGHICDAhAAAeFBAdDEF.CHHG.hAAASGDEABAB.hABANIAHHAEA.........hACA......hAGA...,2,-34,-19,15
XUHZNYBMbcVdTQWCgOfRGeADSFIJPKLaE,FGCDJGEALEDFEGFF.HEABZCEHBBHH.MCAGbEFA..VADAhAAAdABDQEAGhAAA.CHGH.fCADhABAeAFA.ADDCDIDGSEHDIAHCKEDB.XCGGhACA...hACA...,1,-14,-24,10
HPOVfISaDMKWRYUEQTFgLcdbCeJZGABNX,XGGGHFDFOGAG..VFAAIDEBDEEB.KHGERAEH.UAEHQCBFhAAAFBBHLAHHhAAAbDFA.JFFAAIAA.BACGPAHHhABASDCH.MBABEACGcGDEhAEACHCD......hAGA...,2,-16,-7,9
SWKcMCgHXNaRUAZIJYOPfEebFLdTQBVDG,ZFDFJGEA.OAGD..EAFEFDGHLECDdAACBAEGDBAGGCBEKCAH.hAAA.MDDACGHBHGAAaEHD.hABAAICE.....PEEEhACAfDDB.eFFD....hACA......hADA...,1,-23,-37,14
IHcSOLGZKNRdMeaXWBTgPfQEJVCUDbAFY,FHBGHAADOFFFLGCEZDFC.KEFG.dAGDeAAHaAFHBHHG..PFCAhAAAQEAG.hACAECCFJDAECADA.DFHBADIFIEDDhAAASAGDNICF.MAIF...WFAFhADA......hAEA...,2,-34,-11,23
KBbRXEeJWMTAOFaHVdLPGIQZSNcgDfCUY,OEGHFEHBHFCEdBBELABEGBECZGCG..SDDG.hAAAgAFADEEFCHHGKAHFBGAFhABAXGGAJEAAMDIBhACAaGAHIBCF.NAAE.fADEhAEA......hAFA...,2,-30,-12,18
YKaUcgQTOWdRCXPVEDGFfSBMNbZHALJeI,eAABKHBGUCBBQADD.OECGdBHGREECCAEG..VCFCDGAE.FAHFhABABFHHMACF.bFABZGDChAAA..LHFAhADA.JFFAaABG.....gCEFhAFA.....hAFA...,1,-3,-43,40
eLZPKVTBXOUfQbMDaJSEcANHYWgdGRIFC,HAAD..gCBCRAEBCGEALDCFZCFFKFAABBHCOEEFQEGChAAADGGG..JFDHEHAAAABG.hAAANCAE.dAFH.FCHFPDEBhACA...........hADA......hAEA...,1,-14,-33,19
AYUeCSZIKJdMFgRfPBVNDcXEOQbWHTaLG,UDACSDABKEDC.dEGCMFFBRECE..BHBHDAHB.EHDA..QGGEhAAAHAFDaCDCAEEGeDGFhABACBCC...JACFfAAEhABAVFCD.NAIAOFABbAEF....hACA......hADA...,2,-23,-21,2
YATgGVaEfSIOBLNbeFUMDPZCJQXdcKRWH,TFGHGEDHEAAC..SGBCBAGELFADeDCGFADGMDIHZCABhAAAJBCGQAGChABAdGCCRGECHDACgCFGhACA.aFFHOBGHNICD.......hAIA......hBAA...,2,-7,-7,0
ELMPGfXJAUYRFSWgbNIaHBQZeDcCTKVdO,REFHFAFB..SACG..WEAFbAGH...aHGABFAFZABDDHDChAAACAABKFDH..ODGDhABAMICG.GDCFJCCBADACUAEEhADANCIG...IGBFeHBG..cBGBhAEA....hAHA...,1,-26,-30,4
NSgKbeLOHVXDcYJUTFECQARWBGIPZMfda,BFDDGAFEZAFAMHBGdCAA...aAAFSEFFKACBLFHBOCGFhAAAXDEDDGCB.JFBAFGGFhABA.CDDA.AIDA.RABC.IAEChACA..fGAENAIE...hAHA......hBAA...,2,-35,-23,12
RYCMFHeDbdPQTNXUaWKgJAGZcBSIfLOEV,GEDHBFDDSAGELHAEOCAHREAH.MCIBeACHDBGDdCEEQBBChAAAXGFEaGCChAAAKCEDJHEEAIEA.ZFBAICAHhABA..EAGECEFA.......hACA......hAEA...,1,-7,-32,25
HRLcNEaGJFMZBPSdUfYVgWTIbAQKCODeX,QGAFOCAFDFDGHFGDLCBB.EBDEaAGFFDFBZEBBBAFE.dGFEhAAAfAEA.hABAVGDEWDHD.IDAChACAABIBCABB.eDDBRCDANEAA.JHCE.....hAAA......hADA...,1,-11,-17,6
WYeDHZfPMJGgSTAVRNbKadXOUFBILEcQC,VGFGRAADKHGE..dAEAOCBEBFEH..LAGBEBFC..QDGDhAAACDEH.eECFZDCBMDADhAAAJFAHSGDDhABAAEBH.aFEB.FACEIACC...hACA......hAFA...,1,-14,-44,30
JRDgbVcCSIKaNZTQUMYEGAWBeXPHOfFdL,BAFBeDACHFGFFEFELEBADHAG..VECASBHFKBBGZCEAQAFChAAAUBCA.EHCChABAAGDDXAAF.hACAOFHDdGFC.gGDHCADA...hADA......hAHA...,2,-36,-7,29
CAFaIRZOgSGHXQfYLMeVbPKdDNcBUJETW,FAFBaCFCZEEBOECD.GBAGQAAD.LBDCMFIHVEEBhAAAbFAA...KHFADBIFBAHEhABAEEAACHHGADDG..ICHDhACASHAG.XEGEfACAPCDDhAAANEAE.....hAEA...,2,-29,-6,23
YAGeNUbgVEJPZOcMBRFLTXfCWDQIKdHaS,eFEFUCBC...VDAGEAFGZEFF..MDHBBABDLAFH.hAAAXABDfCGGhACADCIHKADHaFBBAIDG..bGFAhAAAgADEJHAA.PEHF.OEDDhAHA.....hABA...,1,-22,-24,2
fBRFDVaSOQXPHIZAgeMWcCTdUGYbKEJLN,MDEBCFDGdDDBGEFAKCAFLAHFBAFB..FFBHDFAF...aAAFOBCBhAAAQEBD.XFFHhACAICAHAICCeCDEhADA..WEAF.......hAEA......hAFA...,1,-30,-46,16
dMTFJKVPRCHUNgeBGfDIaSYQLOWXbEZAc,dGFHTAGDJEBF...KFGFRDEGHABHUEDB..eBAEBBHEGCAEDCEG.hAAASDHBLDDDOAEAhABAXFBHEHDEAADF.hAAA..MDAF........hADA......hAIA...,2,-26,-21,5
SHaXNPbWEfCBIORVGKQFATJeUZMcDgYdL,TFCAJFCAZDEC...DAGHdGGFLDADHCAF.aAHBXCGA.hAAA.NCAH...WAFAhAAACHGEIABA.OFEAhADARABCKGABAHCCMEIF.gCFG.hABA......hACA...,1,-19,-30,11
ILVHEcUDdSWZMXNOGQYKCRTgJAPBebafF,BAFBaDCD.FHGELEHDHAABUCFCDDBHdAEHZECH.MIAG..XFFGhAAAOAACGEEAhAAA.KCEDCAHHTEAGhACAAGCFeBGF...IHAE.EADBSCAChACANCIA....hADA...,1,-17,-21,4
MGPRWebZQaKgFSXTYIVOdEfcUHBJDANLC,LAFBCGADGBFGREAAeCAE.QEEAKADAFEEB.SHCEhAAA.XADCTBAGIFHGhAAAdGHAfAHChABA.cEAABHHEAIEAMCIF....hACA......hAEA...,1,-11,-40,29
LFIUZTWAOYCDbMfaSdXQJcEeVKRNHGPgB,OAFBCAEDDDDH...MCBDaHDC.dEDC.QGACEBGE.eFFBhAAAKGFBRBBFHABD.PHCEhABALCAF.IHHGhAAAUCGCWFHBAGEHfDGC.XGAChABA....hACA...,1,-3,-47,44
RdUTgZfBDaNJLCIePbEQHMGVcSOFXAWYK,KHBGUCCBZAFBDFCG..JHEACBGC....eFAFEFCBHBBDGDGG..hAAASEADFHCAADGHRACA.hABATEEFBFEA.aEGA.hACALAAC........hAEA......hAFA...,1,-27,-39,12
VFMaCfBDRcbTeOQUKJHIYgZdANGSLEPXW,SGAHEDCD..XBGGVDDHMBAFaGEEBGAD.DFACbBDAhAAAeAAF..UGGAhABAJCCAHDGBIAHFZFCEADIHhAAANCCC....PCHBCAEF.fGEAhACA.....hACA...,1,-9,-23,14
dgQXNYOaSDBIAZJTKMCHbGfLUEPRWFceV,JBDGKBDHMCFHHCAAGEFGLEAG..UAGCEBBC.REDH.FGCE.eHFAhAAAVFAF..QBGAhABAXAAE.ODAGhACADIDABHHBAGGHCHAG...fDHE..hAAA......hABA...,2,-18,-16,2
QdCAIZaWXbREUDOBTFgfMcGHKNeJLVSPY,ZDAGXGBCRACCDGIH.BEGB..FGFEMIFAGAGEKEBB...eAADhABALBDA.SAFEhAAA.QCAGhABACGAFAEGBaEEBEFCBTEEA.fGDBhACANIAF.....hACA...,2,-32,-22,10
SMdLgVXQJBFPCDaRUIcAOeTEbYGZNKWHf,OFCATAAD..EBFFGACG.KGCFfHBHMEBHLAEChAAAVDAC...QCAHhABABGFFCBHAaHGAUDGGAAFCeDDHhAAA...YADDNIEHSGGEgEGBhACA....hAHA...,1,-12,-20,8
TNIHcSAPXQJECgRDMLbYWaUfdOeGVBFKZ,XCGCQGGD.CCHA.RDCCDIBALCCH....bAEEaEABdFAEhAAAOHAEeABCBGGDhABAKACETEFFHFDBAFFDJBFBMCCChAFAUBAE.GEDE......hAAA......hABA...,1,-11,-12,1
QRALWMcBbEdXGSgVIZeTYKJUCOHDNfPFa,MDEBBFDGdBGAGBED..SEFGVAAC.eAABKFGFUDAEhAAACCEGDIAC...NIDHFGADQEADhABAADDF.LACChAGAbDFE.EDCG.IGHE.TGEHhAHA.....hADA...,2,-23,-21,2
FLbDYdGIZJRfceaCgNPQTWMVUKEAHBXOS,BADCXGGDSCECLEDCDDGFGAACZDCH.JBFARFEF..eEBHhAAACCDE....gFDFhAAANCIG.QFAFhACATAGFMCBF.......hADA......hAEA...,2,-31,-25,6
QDMZRgXFJafdNeEbIYVCBGOAcUWKPTLHS,UCBCKHBGLDAGQDGGDFFHZCFHRAED..FHAA..JABCaEEGdAHAEACAhAAA.....IGGFhABACHDEBHHHAGBE..hAAA.....WFAC.....hACA......hAGA...,1,-33,-51,18
HRWJgdSGEXCQYFIPTABVbDMOLNKUfceZa,VDBHMCHFLCEB.UBACeBDDHGDARFDAJFAFdHAF...EFAEhAAACDHAFCAG..IAEFhABAAABGBHCFDHFGKAGFfDCHhACAZAEE.aFGE..SHGAhAAA.....hADA...,2,-31,-17,14
LXHFgUQJeaRcMNEIGbWYOSVfKTdDZCBAP,LDACFDAFUFFG.JFDDRFCG...MAGFECFHGABH..bDFAOCCBhAAA..fBBDhAAAdCHACGABBHBHAAHAXGGChABA.gFAF.eBEFhACAaHGE......hADA...,2,-31,-27,4
BFZeAfDCRGaYIPTcQHEWUSNgbKOdMLJXV,DAEDCBGFRFEE.GBCA..aCCC..IBBG..TFAGhAAAQEEAEDHD.WHDGhAAANBBBKHCE..MHEAXDEAhABAFGBDAHAH..YAFBcCAC.HDAF.hACAgDGHdAHA.hADA...,1,-11,-31,20
ScLZECbeMBdGIVYaWXFgDUOHPANTQfKJR,TCGCKGFCRDBGLBCE.ZCFDbAEG.MHAEdHAB.GBCC.VFFChAAAaHDGFAAF..DCAAhABA......hACA............hADA.HCEBAEIFNAEH.fFAFhAFA,1,-6,-49,43
FfDIOSGNUARHcYZVgaCeQWEbJBMPLXTdK,RGFGHAADZBAB.aCCBCDEA.QAEA.EHCEbACFBFFG..MFFEhAAAPBHDLBFE.hAAATEBCdDDFFDGHIGDAhABA...SFADNCACAAHCYFHBhACA......hADA...,2,-23,-12,11
PCYIfbWedABSQGVaOcKDMURgFHTJZELNX,BFCFQBCBGAGAODEGDCAHRFDE.HGACZCBCLAFDXGEFCAFG.hAAA...IGHDhABAfEHGeEAFADABaBFEhAAAKABGMIDAFDBBEHGA.NAIE.......hABA......hACA...,2,-18,-11,7
KLOdGMXJFacfUICTHWARENgZeBQVSDYbP,RDAGEHBGZBAABHFD..SGBDDBIF..PDAGKGEHdEFBGAAFhAAAMAHF.FFEA.aEDBUGGHhAAA.CADC.HAFBAGCEeAFFhABA..YEHD.....hACA......hAFA...,2,-29,-20,9
PRDdJKYQaIAgXLHCFEGeWSOUBfcMVbZTN,XDACLFCAFABFGGEFeDEE..ODBABDCCMBIF.ZADEhAAANBIEDABAKEAD..aGGEIDFAhAAA.ABGEgGAEhAEACHCF.WFCE...SGCBhAFA...hADA...,1,-20,-38,18
KWTMgVOPaBRJXNScCYbUeALDdZQFfGEHI,dEGCFDAFGCDBHAFHKDDGMIDGOBBF.BDACXBCG.SGFGhAAACAACUFCEAHAFZFAFEGCC.hABA...TAGAhACAPHFAJFFA..........hADA......hAEA...,2,-32,-21,11
URLOVHEeFNGXJfWTQdcZKPMgbADSaCBIY,aGCDBBBD.UEBERFAFLDFBHBDEFGFD..XBAH.JHFGTAGFhAAA.dEFBZACEMDAEhABAACHGDAGGCHHE.ODEBhAAAEGDH....NACB.WEAC.KEHF...hAIA......hBAA...,1,-21,-28,7
JBKObQXRUeEPWZDLVNIGacfSFgdCMAYHT,TFDHKDABQEGB.UABGEDDGPAGDDDDE..LHCAhAAANCAD..aFHHfAFBhAEAFFAG.CFEGACGC.hAAA.HGAC.........hAHA.BECF.XGGAhAIAeFFH,1,-27,-39,12
RTXKDNULOJdYfQBFecHPWMZbCEIAGgVaS,GEDHVDAG.SFACRGFE.KAHBDACBLACFJGCE.fBDFhAAABBHCeAFDPHEGhABAZADHEEFA..gGBAhAEAaGAF.........hAAA......hABA...,1,-13,-35,22
gDOSUMZVKcYeWdLHQRTJaNCXbEIFAfBPG,BFDGGAFEOHAGMDDFZGFAKACB...eBBFLBFDQEEHhAAATEAFaHBE..XFFFhAAAIFAA.AFIBgADAhABAUCCF..cCGCdBHA.JFHBCHAC.hACAEBAB.fAGDhABADEHB..,2,-20,-6,14
FcCPTOIEVWKZXeQNDGYBfUgbJMRAaHSLd,aEHBHDEDLGBCdAFBCBBH..ODAGECBEKAAGZCGF..eFFBQGBBhAAAGBDFBEBDUEAFJGFEhABAAICEFAGE....hAAA............hACA......hADA...,2,-27,-21,6
dDKRZfBGPYWIUVQcbCHOJXMFTegALSaEN,LEGHEDABDCDA.KDBDZFDABCDDGCGE....PFDEIACGhAAAUBAFQDDFhABA.bAFEOAHFhAAAMIFAFGAATGBHAIDESHAGdAECfDEHhABA......hACA...,2,-35,-4,31
VOaLbfYXACEWKgBedRUMZJINGQPDcFHTS,EEGDKHBGeBCDUECCZAED..JFBAGAGG.DCAFFDHF.HFFFSDBChAAAVBDALAAHhACA..YGDGhABAAFEGgAGGBBCDMFIHNEAE.....hADA......hAEA...,2,-22,-19,3
GEHDMQdgTKARIZVfFPJLbWUBNaecYSOXC,RGFGZGFGFAHHLBCD.UFADBDHA.aAABeDDE..SFABhACAOBAHCBEAHEFCQCEHhADAdBHAKGDBVBBH.hAAAJECB...WFFE.....NIAFXAEEhAEADIAE..hAFA...,2,-25,-18,7
CMERBZHGaKUbOgAFINPTXVfdDLYJeQcWS,FHBG..NEBF.XEAAdABEDGFH.LFFG.eHDAQGBHhAAASCAHMDADRAAGHAGHhAAAKCFCUGGBOCDHAHAFICDAhADAPEFA.TDGCYACC...hAEA......hAFA...,1,4,-34,38
OZCFRgSDPHaMBYdQbLXJEIWfeVNTUAcGK,KGAHOFCAFGEA.RAEF.DDBFHABD.BHACdHCFLDDCEHEC..fEHChAAAeAEC.TDAChABAAGIDGDGG.CABESECAhAAAMGAG..bDDAXAGAhADA......hAEA...,2,-34,-11,23
JaZfdAcMYIUTNXVPbDSKHWROFBQgeLGEC,MCCAUCBC...XDFGVEFB..DCFCSGFEHFDBRADAFGADBFHBhAAA.eFAHLDFChAAACBADJDAGZAGFABBG.IEDDhABA...NIBFKADAWEAG..OGDChACA.....hABA...,1,-10,-32,22
QbUXVCdTNJaWRcOLZKEePGHBDYSgMIFAf,QCBCUCGCCHBA.dCGB..TGFDaEDCRACALGBGKBBA.eAFEhAAAGFBFDABESHGGhAIAIAGAABAEXCDDhAAAVDGB...NCAE......cDBGhABA....hACA...,1,-7,-40,33
BANIVeLgKaMHUFGdTOcSRXJDEZCQWfYbP,VAADeEEGLDCF.KGAFMGFEHBFGFBFDdGECOGACSABDhAAAJDBG.DDBBZCGBQACAhACA.YAFEhBAABGEGIHHG.aAFAUGGF..hBEATADA...hBIA...,2,-29,-3,26
gRJQKZUCXLbIeASVPBcTOdaYNMHGDFEWf,SCFCBFDDOBADdGBG..aFHFMAFEHGECDGGHFCEE..fCABhAAAJAHBZDDA.CABFLFHFhADAeHAEAAGD.PEAGhAEA..YACGEGDERDFAKEDA....hBAA......hBCA...,1,-16,-23,7
GceZLVCHAfEOgBIbJXYNFdPaMQUWDTRKS,OCCHBFDGJCBC..XGEDFGGE.dGCGMEABUBFH..DIDETAAChAAA..SGDAhAAAeEFELFABhACACACAACHB.fHGB.IBDGYEFEhABANAEDaEECQBEEhACA.KEBF.,1,-4,-54,50
cWXPdgIaTebDQABVZKfNYRJECMSUOFGLH,VCDHZDAGKBCA......fAEGNHBDRFEE.CEHG.SBFFhAAAOCADFGAGLAGHhABA..cFFFhAAAPEFAIGDA.aACF.eAFGDAIBAHHH.hABABCAHECHDMCCF.hACA...,1,-9,-35,26
gSVbWLQRDGNXcYeTOIPCKAZdMUaHBfJFE,dHDDUAGDBEBEFEBF.EDFB..SGEA..bACHQBBFhAAADBFE..NCHG.XDFChABA.eHFAhACAOBABCAEDAGDCaHAGJFCEgGADLDHB.cGGChAAAIDDF..hADA...,2,-34,-24,10
RTNUeHXDBdYcEQLJPKbfFgIWAaCVOMGSZ,CHCHMAGDZABB.REBC.UEGGHFFB.DEEEdEBG..EHBAQADELBBAKFADhAAAFEED...IDAGhABAAIHGOAGF...hACASAAF.......hADA.eBHFBCFA.cDCEhAGA.,2,-45,-16,29
dfFeIMBaUQZGAJYCXWgcTROKNbLSHDPEV,JAFBXGGG......gGDATBGFOAAHKBBCLDEAhAAAHEEEECDFfAHChABAFFCFMDBBaHAEQDAFhACAAHACCEHB..cAFBbDCDDGGG...hABA......hACA...,2,-22,-19,3
cLJPSaRfdObKFDMCUZVXWAGBgNQIeYHTE,GGDHBFDGQAACeEFCHACGEBFHLBAH.SDDHhAAAfAHEdAHCKADCMFAFhABAUFFFXBFDAHEHNCCETGAEhACAPCCB.........hAGA......hAIA...,1,8,-28,36
efFbTHCSINaJdgVUKOBAZYRWDPEMcQGLX,ZGFGRAADDAGCEDDD..MDIBGADD.eEAGFFBFHDCESDGF.hAAAaCCBgBEGhACA.KFFDACHAPAAGhAEALEADbGAACGHG..IHDE....hADA......hAEA...,1,-8,-26,18
GOCVEBYeXJTRZaPWfUcAFISHbNMLKgDdQ,FAFBSCFCHDCBMIDELFFF.KGAFdACAGDCFCGEFBGCGeABDhAAAJAAF.ZFBC..aGHHWDHFhACA..UCEFIBDHhADA..NEACDBHFQGGB.OAFGhAEA....hBAA...,2,-30,-11,19
VRbPWAXNeMHYELDcTJfdGaSQOKZBUCFIg,XDACMDEBHDFELDCBDFFD..JAAGdHCDGBDHaAAF.SEAHhAAAKEEEBGGCFACFIHDBhAEA..RCFGPFADhAEAADBEeAHBEHGA........hAFA......hAGA.fGBA.,2,-24,-8,16
ANFMXBQGEdOKaUVLDTCYSPfIbgeJZWHcR,FGFHBFECEHCEKCGG.UABGLCAA.DBCECAAG...SECBhAAA..IGAGhAEAgAEHJDBEZFBBHCFFhABAAHHF.XGGFGADFdFGDaBHFTEAB.hAGA.fHEBhAHA...,1,-8,-42,34
DTWLIcYBMeRdANaUGFfXHgCEJZOVPKbQS,UGBCFGAHHABCCCAE.EFGCZDBE..OEEBKEHB.QFBEDEAFLCFChAAA..IBFAhAAABHAFMFGHRCABNICBfDGFhABA..XABE...hACA......hAEA...,2,-48,-13,35
gBLGZXIJQYDaARcOdSKEHfMUPeVFbTCNW,RFDFdDCDECCCHAFC.MEFHeDFAFFCC..CAAC.....gACBhAAABBHEZFBFXFFFhACAJEAHDBABAEID.SCBFhADAUGGG.bAEFNIAF.........hABA......hAEA...,2,-22,-21,1
EcYAGTaZCJDdfPOFXKQBWNbUgHMVSRLeI,TECBCCAHdCFF..OECEFHBEKEGB..QGACBBFD..bCAGhAAAHEGH.MIDGSAHDhABARDACeGDAEACAAGIB.hACA.ZGECDCIFfFAD.PBBEhADAWAFE......hAEA...,2,-28,-15,13
WUadcEeDILVZPgGTYHbMCNBfKSQRJFOXA,aGFCdAFBEEAF..DGCELDFCZDAEGEEHHFCHCCFF.BDDH.SBAHhAAAJABHFHAC.AHCHUFFFhABAeADD...ICCEhACAgAGE........hAAA......hACA...,2,-34,-22,12
bDIfRXCTOQZFMNcgdHEBAKWeVJGaPLSYU,eCCHVFBH.GBECLDBESEGHUACGDAHBRBAD..CBHE..OGCChAAAZFFEFAAD.MIEGNIEFdAGChABAEDFEBFAG.KADBaAEEhAAA............hAFA......hAIA...,1,-14,-24,10
XNMQUgeRLPTSGAHWFBDaKJEdIZOVYcfbC,HDAGBFEDKBACEEEGZBAG.OHDCVADF.....fAHAhAAACCGEMDDF.QFAChABAeHFARGAG.LEGBhACASEHBAGDGDCIFdDAA...IAGC.hADAcFFDNDDB...hAEA...,1,-6,-32,26
ZTOEASaVCHFNMJDRcXbQeLBPfdYIGgKUW,SEHBCCAHFEGE.MHCCRCDH...XAACQEAD.BCCDhAAAdFFHIECBhABAKGGAUGEEZAEAOAFH.aAHHhACAHGAANDBGDCCA.........hABA.eDFCfDDBhADA..,1,-19,-27,8
bFKAfZgMcVNYEBCTQGdeSLPDOHaJIUWRX,ZAADMCCA..VDBDEEEGBAED..TEGFdHADLFDHDIACOEEBhAAAaCGEUBAE.RFGBFFAChAAAKACGAGIH....hAEA.cAGDCBHC.eGAG.SAFFhAHA.....hABA...,1,-21,-27,6
MEcLYFCNTOUaXBSbIPHAKgRfQdJVZGWeD,KCFCRAADdGCFZDBEGAEFDBDH...MCDBEABCLFFDCFFF.OEGDhAAAUCFFaFAG.BACFhAAASGBB.PAEEhABAAEAEQGGE..JFDFeHAG.hAEA......hAHA...,2,-33,-17,16
YOXMVTBAaQWUIEHZNGKFfdcCbLJDgePSR,QGBCUCBCEHEAHFBAGDCH.KBAFdEFACHGGLDGBDFADeHBARADCOBFChAAA..MAAFhABABEAEABHD.aBDG..WBHHhACAIAHF........hABA......hACA...,2,-27,-19,8
NVbBTfZFSIAcCEUdePDgGaLMXYOQWKJHR,EEGDUGGDdAADeBHF.DDFFGGCB.MCDGOCDBKEEHHDBGRFBE.hAAA.VAECTAGHFHAE.hABAAAEECHHG..aACBXGAHhABA..WBBDNDAAbCFABEAD...hADA......hAGA...,1,-7,-24,17
MHFCYGVfZXNREaPbLQBIegJAKdOWTcUSD,KEEDOCCH..TAFCSAAAHEBDFCAFGBFAZDGD.RBDHEGGFaCDCLAAEhAEABHAF.eFHHhAFAAEHCdHCBUGDFCEADfFEBhAAA.XAGB....hABA......hADA...,1,-8,-24,16
HZWKNOaPAEQeMbGCSUBYdgXILTDJFVRcf,EGDDeAEHGEECCCAD.UAGGdGHA...XGBDICGA.LBCFhAAAJCAFFGHB.REFHHEAHhABAZCFCKDCAaFEBAAAC..MBCAhACA...SCCEBAHD....hADA......hAEA...,1,-15,-22,7
aQfPcHTBdWXGVIRLECFDgKZNJYSOebUMA,QGBC..fGDDHBFGdCAGXEGCVDEELADAhAAACHHFDAAEZCDHNCBC.SDBBhADAeCCBMCIHAEHCaGDDhAEAPHAABGAD.WAFCRFGH......hBAA......hBBA...,2,-15,-12,3
ZRVXQSTaGeAfEKMJOBbFYdPcgHNIUWCLD,EAFBJECCBBABFABD..dDCD.....PFGB..HGEAhAAAUFCFCBEBDGCBZAGF.XAFFhABASDAF.aDFChAAAAHIFfDGGMIAC...OACFhACA.YEABNEIE.hABALDHB.,1,-18,-36,18
IaWHCNFSKbQYdZGTOLfDegUcAJEVBRMXP,JDCHBCAH.RAEG.MFEF..IHGHHBFGFFHDKDCEQABAhAAA.ZEEHTFEAOEADhABAfACH.hAEAeDFCcAEBEHAGXFCBaHAE.NEIESAGEhAAA..hABA...,1,-10,-36,26
NcGUPVHEgJCFBDKZdeITALfMXOWSYbRaQ,MDEBXDAC..SGHBRFBF.aAGGQBDAGAEEVDAFhAAAHDFB.JABBBADBhABAKAGAdHDHTCGGAGHE.fABChBAA.OFFD.WDCH.hAAA......hABA...,1,-5,-29,24
UKbDEdcPZfWgMeRSAJYaTNVOGBIHQXFCL,aDCDVEFHBEGB.HBBEFACBUAFF..DGACECDGdDAC.ZFDG..hAAA.fGHEhABAMGACSEAEJBHF.NIEH.hAAAIHAECDDG.KACCcGCD.gBADhABAAEBA.OCHDhAEA..,2,-31,-19,12
GbICRBDLOSPcWAQdaZMFYfTJHVXKUEeNg,dFHAZGCCFHGA..TCFGHDCEKADAUECAeCDGGBAC..IGAChAAABACADAFB.LFEBhAAASFGA.PBAFhABAAHBAaAHF..MAEF.fHCFhABAJBFEEDGANIAF.CBGB.....hACA...,2,-26,-11,15
TDYHLFgIGOWZCBcSXVeJEUbPAfaRQNMKd,aCFCQFDH.KAGHDACFLABCFFBFGCDAOCDHCAFG.BDBDhAAASDHHeFBDUCGHhAFAAFGDRGEE.MCFF..dAAEhADA............hAEA......hAGA...,2,-39,-22,17
eEQNCRJUIdKMPOcFVWXAZGDaYgHSLfBTb,GDFCDGHH.aHDEHGDALEHBBFGCeDFAEEAB.CBGE.RCCD.UDBHICEEhAAAdACD..KFBHMGCChABA.OBEAFGAH.hAAAWAHBAAFFZCDF.SBAGfBBH..hACA......hADA...,1,-15,-27,12
YDCEKUQGdcZPOIeATXHagfbNLSMVFRJBW,XCCBHDAGaACD......fDGALADASHBChAAAVFGDJFDBBGAFDIEEKEAEhABAQAFAdBBGcBGEhACAPDDAIHHGACIBgAAHNFDHMGCA...hAEA......hAFA...,2,-25,-3,22
ITVXcCKLAJfZBRYaQgOUHESeNbFGPDMdW,JFBBBFDD.aAEEOEEFHCEF...EGHDSFHH.eABDhAAAFEGEDCBGMAHBIDBHhAAAXDAHCAFFLAHFhABAAHEDfGFARADB.YADF....hACA......hAEA...,2,-32,-28,4
TJDBSdGMCbIOFLgPHKVfUQYNZAaceERWX,eCCHECFCRBBC...XAAFDEECdEBCGDGE..CADEIGGBhAFAFAECLFCHHBEDKAADfAGFhAGA.YEEGhBAANAIEAFFHaGAH.WDBDBDDCSDGEhBCA.MICA...hABA...,1,-8,-24,16
bALUNgRFSTaMOcKIHBQCfZXGJYDdPEVeW,LDACUCBCRBFH.SEHBMFFE.KACABHEG.CHGG.ZAGF.XCEDhAAAJFCH.DFBAdBHEhAAAEFFFeFABAHGE.FABETGCHhABA..aDDD.....cAEBhABA.....hACA...,2,-33,-32,1
VLeJMcBRDQCNGYgdOPaXUKHFTSIfEbZAW,VFDFJAABBDHH..DBBF..CBGBGBDCdGAFaDFB...UGAAKAFFFACGhAAA..SDBDhAAAECCBAHHE.LDGDhACAMBED.RFCF...NBIA.OHFA...hABA......hAGA...,2,-39,-28,11
VMHDNKGCEXZgWFcbIQePdTfaBJSUAYOLR,OEEGLDACREAGHFGDDAACKBFEGBAH.EGDAZFAD.FDFC..IAAFhACAQGGFeBDEhADATFCHBHBG.JBBGACHHMAIFhAEA.CAGC.WAHH......hADA......hAEA...,1,-3,-37,34
BCXNPOSFDWGRUYdJLfKVHEMAeTZgQabIc,TAEGQFDH.aFBB..IHEFBAGFCHGG.XBCC.hAAAOCADDEEARADDUCBChABAYFEEJEHFKCAD.EABAhAFAAHGFgCGD.bGAANIABSCGChAIAFAABdDDBfGGBhACA.MAIF.,1,2,-15,17
TABLIYNeQKCSXDJMbFfgUHVOPRWGEacZd,BAFBLGEA..NFDB.KFBA.SAEHDAAD.MACHFGDFUBDBhABAHBFFOBABRDAAGAGEhACAEHBA.aDDHdGGFAEIFIFFBhAAA.........hADA......hAEA...,2,-39,-15,24
XATaBIGePUZMDRdOEgFSKLYQCNWcHbJVf,TGAFBFEDeBFH.UFAFMCCD.DBAAOBDBFBEELEFF.hAAACEAB.NIBBHBAF.JEHDhABAfGDE.hACAAAGEIDDAZFFFdBHEEAECKCGG.QEGEhAAA.....hADA...,2,-21,-16,5
VcWIPGdXQDORMgYSbAEKeZFaLTUfNCBJH,EEEDKDBDFCGGLAAE.UCGFCEHABEDGHBCG...VFAB..hAEAIABGPAFEdBBGhAFADFGHRFBBMFDH.SFHHhAIAAAECeCCEZEEBfHEF..NDAC.hAAA......hADA...,1,7,-48,55
NfIEQbWYcKdPCFSTXAMVURLgGaDZJHeOB,MEIBUBBHRAEFLDFBGEEDZEAFHBAG.BBHH..IHHGhAAAEBEHQGBB.WFEDhAAAKGDACEDC.SHAGhABAXDBEAAGHaAGADFAH.eABE.fHGBhAEAcCGF....hAFA...,1,-13,-22,9
cMdPDXRALQJTbYIHeFKGBfONSEgCVZWaU,LFCAQDCHTAFG..bAFGHBCBFDFHKBCABHFG.fDFDhAAASGGEEHAGCCGGVGAEhAAAaEHD..MABEhAFAPHECDAIFAHHE..ICAAOCBH...hAHA......hBAA...,2,-15,-15,0
QIeXCURVGaKSfJDTOZWcPALNFEbdYHMgB,FDCDEAFBdBBEHAAFBHACQBGA.eFAHUGEGGFEBSDCAhAAAJADEDEEGZCFE...hAAAPDAB.AEHGLFCFhABANICBMDAFIEHF.CGDD.REFEKGHB.hACA......hADA...,1,-10,-14,4
PTfXCZKOFdDHALaWgBeNVQRSGMIEUJbcY,aDCDBFDG.eBADQBAAGBGC.EEAAUBCAJDHF....bFECPFADhAAA..XGCDhAAACEFEOFHFFAGHDGCBAAEG.hABA.gADGNAEF.SHAChACAMFFF......hAHA...,1,-15,-24,9
VePaEgGOSUZHDKJfTbdWAILFYcNBCQXRM,FDCD..NDDGBBHCCCAFRBFC...MBGHeEEB.EEHHOBAA.SGHDhAAAZGBCDBBEJAEETBDChABA..dGGDAAFALFEFhACA.QEAH.PHAChADAaCCG....hAEA...,2,-36,-28,8
EGTJPDNZKfFQIaOHBYUSMXAeRcgVCWLbd,eFBBRAAD..VDEGCDGCLEHFdAHCGGCHJFDH.DADBZBCB..KGAEQAAGhACA.OAHFhADABECBSBEFhAAAAEAH..cEECbFGD.EBEFNDIE...hACA......hAEA...,1,-20,-26,6
GODZedUAVRWTfSKEINaPYMgJHQcCXbFBL,VGFGTFDH..KAGAECCF....aEGEPEEA..gGAGhAAAJAHBQEAChAAACCFBFFDG.BHFGLCABhABADAFEeABCAEEGRABA.fGBCICDD.MEIB.hACA......hAEA...,2,-27,-11,16
WAIKBbYDXHELMaZNQSeCJgdOVPUGfFTcR,BFEDDACBEFDFaCFF.ZBBAQADC.CGFB.JACA.dBHAOFHBhAAAUFFCGGAF..hAAAfAGD.hABATCGC.cDBHADDDIFACKFAAXDDAhABAMFID....hAFA...,1,-33,-36,3
OMCNAISJKGFgVQfcZTRdEYWbDLPeXHaBU,JCCHFDAFQDEBZEEC.dBHGEGAC....bFDADIGE.eABEhAAAaAADBHEAOHCGCHGAAAHESDGAhAEAGGAF.VBEAhAFAfCCC.......hAGA......hAHA...,2,-33,-19,14
YDegOKZXGVFHQAIbESNBPTdfRLcCJWUaM,EHBGBFEDdFBBLCEA.CHGB.UCCD.MFIBeFBBKHDCGAEDhAAAHAGBAACCSEHBhABA.TCAFcEFBaACHhADADBECZDDAFGGD.bAACNEAE.......hAEA......hAFA...,2,-19,-16,3
bKHVedSPcJQAYBNEROIaCZGgXfTMDLWUF,BFDGECFCRBBC.aEECGFAD..XDACMIFADGFELBDAFABGKDED.hAAAHGAAdAEF.SBCDhAAA.PEHDhABAJDHF.AGGDNIDBIAHEZAGF......hBAA......hBFA...,1,-6,-25,19
OKAGBQWIbcVHZdaXgYJePRfTEMCFULDNS,BFFHQCBC..IBDEVAFEdACBaAAC..XGEHhAAA.JFAAPHAE.hABAfBGDEEGCCEEHFGGADDEEhAFAOFACADHG.WDEG.HCAA.YCFAhABA.eEHFMIAEhAIALAFC.,2,-15,-10,5
beODXcZFAKSIUdCPWMGNJQRVBYEaLgfHT,KAFBUGBCdFFCCECC...MFEBGFEB.QBDARDACBHGH.EDFAaADBhAAA.LAHFHABD.hAAAeFCBDAEEXAGEhABA.FDAF.AIFG.SBAHIEHF.PFABhABA.JDDA..hACA...,2,-30,-9,21
JNBQdEAMHFOLbPKgTfDIZRcUGVWXCYSae,FAABOEEGLADDKACG...TCFADBGEZCAERAECGECD..hACAVEAFCHGE.aAAHNCBABHCHhAFAQGDG.AHAFMFIFhABA..........hACA......hAEA...,1,-26,-36,10
eOSTPgHDWQKJBfbRNACXUEdaFMZLYGcVI,UABHaDABZCFBGDGE..VCCDeFAC..SHEEPAEDDEEBhAAAKAGCBGDGRFGB.ABIFEHAEhACAMBBA.LFBDhAAA..cGEEOCHD......hABA......hACA...,2,-24,-20,4
ZcgFXPERMdUSbYGIQAVfTLBHNDJWOCeaK,TFDHLFCA.BAFEDBBC.OBAGeBGFKECDZDFAFHGA..PHAEhAAAMHAC..dDACbGFA.hAAAGADEACCG.fCAHhABANIAFCECB.aAFGgBGAEDHF.SDDBhABA..hACA...,1,-4,-32,28
bagOAfZQUJFBdRSYGEPKNMTDVeIHCWcLX,QFDHUGGDFDADBBBBdCCHRDFG.GCAAKDEE...MAIHDHBC.IAFAhAAAHDGHCAGDLACBhAAAXGGF...aFAEhABAAFCEfHAB.SACAhABA......hACA...,1,-18,-43,25
dBPMSeOHTJFbIfRYQEGLXgKZWUACDaNcV,CFEADGHH..aHGEVEEGBDDG..MAIH..eEAFHFACFHDCfBFAhAAARADC.EDBHLCHHhAAAKACHZBDBAABC.dHBDhAEAODCH.bEFB.QBAG.hAFA......hAGA...,2,-24,-17,7
DWVNcLgdSHYJRMaTPOZEbCFUGBIXAfQeK,QDACDFDC..NIAFLCFESFHBHEBFRGCAaAGH.TABGhAAAPHFC..ODFDhABAEBABCAGGGDEFXCDHhADAAHAGKCCA...cAAAYFAG.MAIFhAEAFADABFHGIHGDhAFA...,2,-16,-7,9
dAPOCFMHcTIfaQKDXVZEgUSNYGbeJRLWB,OAFBMAEEHDGH..TEAHIHBHQABAKBDEDIDEZBADEHAAUGDAhAAA..SAAFhACANCGA.GCCEhADAJFHFLAHBBCFDAEFDCGHHfEDBXAGA.hCCA......hCGA...,1,-11,-17,6
YRXbIPEUKOHZTGCcDANagQeFJBVLMfWdS,aHBGQDAC.JAGHLADB.MABDfDDGSBGEhAAAXEGGIDGAhACAPFCFUFFC.KFBAHACAhAAA...........hAFA......hAGA...,2,-36,-23,13
gPXbQKAIDJGENYCBaScRHMUVdWFZOLfeT,DEFHGAEGEHAC.CCCHBABC..aBEBRGBAUFGBdAABFGGD.LCGBhADA.eDDBPAHHXEAFhAEAKHEGAEGA..JDBHSAGEhAFA.MICE.....hAAA......hADA...,1,-16,-40,24
XKMcaSCTNVUAFRZbQOeWBJYIELfgGPdDH,RBCFQFDHOEEABHDDJDBB....EADALCBDGBDHDIACKFGBaACGhAAACGHD...TAEChABAUAAHADAC.ZDDAeAHFhAGAIAHE.fEHEgFDE.dHAFhAHAXCGAMFIB.SGGDhABA,2,-24,-12,12
gOKRZCEdPIMAfWcTXDJSUNVFBbaeGYQHL,...fHBHTCBCJAFFUDAC.FDDFaHCEGACBHEAFOAAEhAAARDFACBBD.EGGCdAHAIAHFhABAAHHF..WFFDhAAAcFDFDABE..SGCEBCHDYEDChADA......hAEA...,2,-20,-19,1
FdPULSCIXDVOAbBeTNWaRcfgGQMZHYJKE,BAFBeDAC...TAADNECH..RGCC...fFEFQGGAhAAAHCACKAFCFADCdCGCLHBChAAACBBADDFGAABC.aEBC.hAIAcGGFMCIF.JACAEFCASHFG.hBAAIAHF..hCAA...,2,-23,-21,2
VIacPEHWUJDFXLQdfNZRKgOCbTYBSAMeG,MGEAeEGHGECB.aBFHPCHH.HAACJCAGFHCAQDAChAAAdABDZEABKAFEOHBECDDC.hAAAYAEFAAID.cDDChABA..WFHHXGAC...hACA......hAEA...,1,-4,-24,20
RXQMHgWSZeATOcIDaNEUKFbfCVBPdLGJY,TDACOGEADAGC..EFHFKEAAFFBD.CDDF.BGBGLBBGGCAHRAGF.hAAAMIDEHEEF..SEEChAAAADIBaACG.NBIC.hABAbFCD....fAED.dBBBhACA......hADA...,1,-8,-37,29
CQRIFcDgZKSbMGVYEJLeHfdWaNUPBTAXO,OGFACFFCRCAF.FEEEDEEAZACG..KAAD..MHDCGEBC..ECDBhAAAeEGHdGAG...NAIG.hABABBFA.TDAGhABAQAFG.IHADSCGA..hACAYADH.LFDBhACA,2,-40,-25,15
THRNPWfaELAGgbZSOFBJIMVKUCYDQXdec,GAFEZAADSCEBOHDGFDCHBHAC.MFBGKFBDCEFD..DCDBQBDEhAAAeHDEHDGFREGF..hAAA.NGCF...fBAChABAEAGG.AHAF.JACE......hAIA......hBAA...,2,-26,-22,4
LIaBZcDQNVHYGOPUREfAgKCbWFTeXJMSd,CFEDFHBG.eFFFJDAD.dAFCLCFHBEAC.ZDCBQACF.HCDHhAAAOBBCRAGD.AHEGKGHFhAAAbEGB....TBAChABAMIBGSAHDaGHD.DBAB...hADA......hAIA...,2,-43,-8,35
aPVdfLAFYRQGgKMDIbUNeXBEOJSZTHWcC,FCFCQFDHKFFA.DHAGUEBD..XCGGOACEZAAFHAEH.hACACACGaCDBdAGFABHF..GBAAhAAAMFID.bFFDBDHAhADAJEHFSEAD......hABA......hADA...,2,-45,-8,37
bUXLIZFTdSfMQOPEKAGcgeDCRaWNBHJYV,GAFEeGEARBCG.aDCDBEBAHDAH..JAHFbFFFLGAA.FEGETADAhAAA.SHDEhABAMDFBOCAHKHBGAAHHDIGAhAAANEIG............hABA......hACA...,1,-3,-36,33
MANZCFcKLdQGUfHbDXgTREeBSOJWPYaIV,CFDDFAFBKBEBdADG.UFFCHDAD.DAAB....XCCGTAGFEHFChABABFDA...JCABPDHHhACA..IHAAhAAAAICGNADE.ZBGBQFEC.fGAEhAEA...hABA...,1,-21,-47,26
DMFIJcdKSWECRXOGePAaNQbfHVUYTBZLg,QGBCHAADUDGGBAEHZGFGDEEDFCDG..JAEFdGCC.KGAFEDBHRGEA.OACFhAAAGDAF.AFEA.aFFChABA....fBGFhAAA.........hACA.TDGH.MAGFhAFA.IBHD,1,-22,-30,8
IHfAJadZOXSTWLGBbCVYgNUPDMEKcFeQR,JEGHaEHBZFCE..SBFGLAACBHHE.CBGC.VCCC..hAAA..gEAFhAEAPGAGDBADMAIDKGDAeCBDhABARCDCIBBCACIHOBBGXGFD..WHAGhACA.....hAFA...,1,-26,-30,4
PJUaXNHTeKQVgCBZORdfcSWbLMEYIDFAG,JFEFUFCA...XBGGHCBFKGBG.QAAFCAFFBFGC.OBGHhABAdGEA..SBBEhAAA.LEABhABAYAEDFHGEAICGaAGFeDAE......hACA......hADA...,2,-34,-32,2
WZRgBbQdIEANVOKfFLeGJYPHMTCUcDSaX,VFDFKDCDLBGB.eFEBGCFE.JABEHBEBCHAH.UGGEDCCD.hAAAaACBZAEEBAECdFAFAIFCOBADhAAA...fGCDhABA.FGAD......hAGA......hAHA...,2,-41,-17,24
BEWYFUIQPfbNGdcKRZDaJSXLAMgHTeCVO,MECGTFDH..CEBGBFDHECCF..FGGEUACBQBED..hAAAPHCCNEEH.dGGEcAGAhABARCGHZAAF..DAFFSCAHhACAAAGC.gGBD.eACChAIA.....hADA...,2,-41,-4,37
fMXgGaKAYRCVSHFDOTIePJNbdUQZEWLBc,CFDDSDAFHGEEDAGA.OCEF..eBEEJAHF.dCAAUECEZFAFLCEFhAAABFHC.MEIHhABAGGDB.KBBBADCH.RFABFACAhAAA...........hACA......hADA...,2,-31,-25,6
eaARMZLcbEDfHUSXQBgVdFICTGOWPNJYK,ZFBGLGEAEAHHHADASDABQCEABACBdHEBCECG.OCAE.hAAA.NEIC.KAAFABACMIBGhABADFAD...UDEHXFGAhABAFAGF..ICCE...WEADhAEAYHAG..hACA...,1,-19,-30,11
VPWEXMbZULRJTNSGFfAYgKHaCIDOQdBec,KHBGCCAHDDGHQBEE.BGABeFHB.VAFEEGGF..MFFHUEDFhAAARBAG...JABESDGHhAAA..fCCFhABAAADHHDDAOAHFdEBEPCHD..hAFA......hAIA...,1,-19,-36,17
INPECDgZWAVaeXKTOUSHQLbJcFRfdMBGY,VDEDaGDD..eAFEKBEA.OACCHCACQGBGLCCB.JAAEFCEGhAAA.dGHEMEIBGCAAhABA..NBHA.PCHHhACAEEAGCGGEDAIH..........hAAA......hAEA...,2,-21,-10,11
LEdFQKfGXTJIBeVHDagMWARbCNUOYSPZc,CFDDUDAC.OGDGSAGEZDFA.EFEGQGAAKDCFGBBH.JFAHhAAABGHH.HAAEDABEMEEAhAEAAIDGRAEA..YEDAhAAAPFHBdHDB.FCGCfHFB.hAFA......hBAA...,2,-18,-15,3
JTGIEFYLWZRDbdcHBAXgUVPMeNfOaKQCS,XCGCVEFH..MDDDeEAG..OBFGQEFB.SABEhAAATCGHICADhAAAECBBFHGELHCEhAEAZBBBDFEHdFADcAFABAECAHHEPCCGNIEHKHAE.CFDA..hABA......hACA...,1,0,-20,20
JIYdcMVXTBfUQZFDRPKLGbHeANSCagWEO,CFEDaHBG..EBFGODAE..IEBGdFBDVCFCBEHB.UACGhAAAZFFBDADEKFFELDDAhABAHAAD.AAFA.SEEDhAAAJHAA.MEIBfGHAFAHF...hACA......hAGA...,2,-35,-15,20
JKaQVYbAeTZILfSHDGEUBgOWCcXNdPRMF,TAEGZFDFLFFG.SBFHGCBBUGFABDHBOCGH.hAAACHDA.NECCRABDMAIH.KGAGhAAAaAEB....QABFhACA.bEACABAFIHHADEEB.hAEAEGAH.....hAGA...,1,-15,-29,14
GAKgafWOHNQYDEPCUILdZFceXBSTbVRJM,KAFBaHBG.OCDFHCCCQGEB.EACEPFECUAGAdEFFFFAFeDFChAAASFAA.hABA.bFCHJBACAACG..fBBFhAEA...NHEDCEBBIHHAhAAA......hABA...,2,-22,-17,5
WXaHcNPMKYVZOIRgLCbdGSTDEQAUfBeFJ,BHHGFGDB.JBGFaCFE.HDCA....NBBA.MEIF.KDAEVEEChAAAIFBA.LAEChAAAdGAGTCCFDBIBAFHF.hABAeBBEXADB..YFFFOFDBCACDhAGA.SFBHhAHA...,2,-39,-17,22
DGSBMXZcQKaRIeFbWYVTHJCdELOfPgUNA,DEFASBCGBCECZAAFQGBB.aEGHeFDA.FGACbFED.hACA.VAFEHCAECEAA.EAGHhAAALFHDPACANDEAADHG.hADA.....MIAEXCGEKDCG..hABA......hAGA...,2,-32,-8,24
dbASaHgOYQIWBJRGLUTMEeVcXCDFKNPfZ,SEHBaCFCHFBBOAACQAFE.BAHHRFEBGDCDLAAChAEATCAHEEDFeGEE.hAAAVCBECHADFAEBKFABfAGGhACA.dEHEACFBIHDG..hAFA......hBBA...,2,-18,0,18
bIEZPJNTFHBLWAaUCgSQKVMYOdDGfXRce,aFFBCHHG..QBGEKBEA.MBEHOHAEdEGDGGBBRBAEeHDGEADAhAAAJAAH..FFDAHEGBBBFFhABAAEECSDABhABADIAE.fAGEXDAA.bCFA....hACA......hADA...,1,-13,-22,9
UCcGJYBRQdHXaLeOPIWAMNEZFVDbSgKfT,MHFGECFCZFFHDABA..SBHHKCFD.UGAHCEDEGCGCBEBHRAABdBCHhAAAHADGLFAB.hAAA.PFHDACIDFAGG.bDDHhACAfDBG.TGCA...hADA......hAEA...,2,-27,-13,14
KNTOLgReXWcBHGFCbfYASIQVMUZaEDJPd,QGBCVFEE.MEFGUAEHZABAEBAGDCCFdAHE..KDDEOFAFhAAARAFG.eCEHXFGBhAAABEHCFDBECCAC..bEAEADABIACHhABA.aHDCJHDE.....hAFA......hBHA...,1,-16,-20,4
ZNcEUKJGgeWLPXCYQADBVbRafTOFdIMSH,DFCFVDBHRBAE....aEHDTFFH.dGAESGDHHAFCZBBEEABEhAAAJHFE..GADFeEEC.hADALCEAXGCD.hAAACDDBAIHGfFED.IDAD.hAEANDDE.KEHB..WEEEhABA...,2,-36,5,41
OKeLfHTRaWQFANPZXEICgYBUJGMdcDbVS,ZAADEGFC.CAHEBDFCUDFEGCAF..dEBBDICESGBAKFEDLGAGhAAAHACFRACG..aBFEFHGEhAAA.AICG...NAEF.XEGGhAEA.IAFF....hBAA......hBCA...,2,-39,-23,16
EgRBJFcPHLINVbCDdKXWaYfSUMeAZQTOG,QDCBTDAC.EFEARDGFBADH.FHCAPHCEHAFALCAChAAA.VECEDGGFdCFHhAAAKGGF.aBAHSFAGhABAMCBCeFABAHAG..........hABA......hACA...,2,-28,-8,20
FaPMDJEgbQfNedULYGVTcICSXKBWAHORZ,HDBGODACFBCE.MGFEJCHH...EDHBQFCCeHAALHFAhAAAGCCHTAFFCGGE.KBADhABAAFFFaAGGDFEC..fCFEhACANICFdBAH.........hAAA......hABA...,1,-2,-34,32
ELZYHaVeJTPNfCcAQUOGWSDdKbIMBRgFX,QDCHUDACGGCBSACGDDFD.dGFDKBCBMIACRDGFFGAFLCGDhAAA.ZGBA.aDAGhABAJAEC..PAFEhADACBACACIH...WCCEIHHFBFAC....hAAA.EFCA....hABA...,1,-1,-40,39
DOCGMTHFgeJXRfUVSPBNQaYKdcLAbZEIW,ZDAGEHBGDAFEGEDE.MCIFHABH.FFGEJBCEREDBUEBG..SAGChAAABHHEQBDAhAAAKGGGdCGGLFCDhABAAIEA..IDHBCFFBeFAFfABFhAEANBACaBFE......hAFA...,2,-17,-14,3
cdAbCIaKHWgUGFeXPQZMTVJRfLNEBSDOY,CFDGaAFBHABF.UFAHeDFA.QEDCZADCMIBG.JBBBLEHDhAAA.BEFBSBFHhAAADECC.YHFEhABAAFIFIBHDWHAE.FFGAPFFBTEBA.fADAhACANDDH...hABA...,2,-28,-8,20
KVeOcFLJDdZUagEIABPWRMXSYHfGNQCTb,BFDGRAADMBGDSAGE.HEAHNEBG.TBDCKEGG..OFDBhAAAFCGBDGFCUADBEHFEICAAhAAAAAGC.PHBEhABAWEEH....fGGCCABAeAEGcCCChADAdECB.....hACA...,1,-3,-40,37
NBVYULdEfKMCHcIJRFQAGXTWZSODbPgae,XCBHZEFHDIEA......bDAEgGABeABDBGDHVEEHhAAALBDGdAFD.EAGEKEHFhABACFAH.HBDH.ICAEhACARCGDAACG..WFHHSGCB..hADA.OAHD.NIEB.hAEAfEEG.,1,-1,-25,24
OPceTXWIKRbaMEgUNdJHBLVfFQDZSAGYC,GGDHCAFB.OEFCeEAC..XFEGKDABRBGHMBAEEAAB..UDGEhABAdDDAHFAGBFCBLCCGhACA.VACEfAFHhAAADAHBABIB.........hAIA......hCAA...,1,-21,-24,3
cDZBLWFOPeIHNCXETdJMAUafVgQRGbKYS,aGFCVAAD..RDABGAGGKDCA..SEFDDABCBCDDFEFFOBGDhAAA.eEHHHFCBCGBHEAEAhACATADC.MEIHfFDAhADA.........hAAA......hAFA...,2,-27,-25,2
cQADXENVfHIKGYdRTMSgObCFPeWLZBUaJ,EDABVAADHCGD.KHBEdEFGRFFG.MCDA..SAACOHEAFGBHeACFhAEAZCGBBEAFaDCEQBDDhAFAAHIH.DBBFfFBBhAAAIAGF...YADEbFBE.hAIACDDB......hBFA...,1,-6,-25,19
OKCBRJbXIDLUQNePaAdSHfWgEcMGZVFYT,dEHASCFCHCCG..fHCFEAADGEDEFBFEOAEGKGAFCADEBBCChAAAbCAG..DAIFLCAFhABAQGBCeFFHAECBgDFFhABA.MDIH....hACA......hADA...,2,-21,-12,9
bJdLfWOFBDUgIMcGQAKeXaCPNRTEZVSYH,KGDDXAADCCBA.RECH.EHFAZEEB...SADFHEEBdEBALAHDhAAAOAGFBEBFDEABIBAFhABAMAFFGEGEADFC.hACAaGAC..NEIATADF.....hAAA......hACA...,2,-23,-23,0
BOCDbNILKWHdaXZEPAcRVUFSYTGeJfMQg,RGFGFDAF..SBEAGEECJCFGQDBDBGBC.DEHH.IHBBhAAALABC.HBCDhAAAdBDGaFACEHGAAAHGUGDEeHBAhAFAfBAE.MAIBgDGAhAGACEFENADF......hBAA...,1,-6,-22,16
TNKMDXZYedRcAPbWQLaEFHJUfOBCVISgG,...PFBBQFDHLFFAaDFAHBDEJHEC.OEAFBDBBCADAIGGHhAAAGBEBKABBMDAChABA.DACC..XDDGhAAAeEEEdAHCAEGAEFDFfBBHSAGENDIE.hAFA......hAGA...,1,-11,-21,10
bHNFVcgRdJeUSAGWDEKZPfCTYaMLOXQIB,GDCCDGHHKACAZFDECDBF..aGGALFBF..OBAAQAFHhAAABCHG.HBADFAFAgCEGhAAAdCGHeCDDAIFAEEHBhABA..fHFF.MIAA..hABA......hACA...,2,-36,-14,22
WVXAGQPgITNBaJHfLUCMESeYcOKbFZdDR,QAGH..gGDETFBHBHFBJBCCLDEChAAACEAG.EFGHYABEhAAAKEFDFEACDBADRCDCXEGEhAFAAHBD.IHHENDIG.fHCFUAGF.hABA......hACA...,1,-15,-27,12
cJCYeGadgSQHDURZFWTXELbVAIMOBfPNK,OCHDBFDG....NCBG.KGEG.CFBAeBDGaFHH..dHEBQBADhAAADDABUAGC.FDDG.TAGChABAEDEELAAEhAEA.AEEHMDIBfFFD.cGAC.hAFA.YFBBSGDDhACA..,1,-20,-41,21
JOZPNATEKdDgcSIaGHVeLFYXQBCfWbRMU,EFHBDGGD..SCACaBFHHEBELAACFAEC.QEEGhAEABAAFCBHD.fCBHhAFAREDAJFHFZGCE.AAGHKBHHdDCF.IHDGhAHAGDAA..........hAIA......hBBA...,1,-12,-32,20
GAZSFgYfELWHaeNcCVUIDKbXQRMTBdPJO,ZFEESAFBFCFE....fECHLCABaECBeGACNDFE.VBCEhAAADAAA..KGDHXBADhABAMBIHBDGG.dDDAhADAPAFGJHAAAHGAEAEBcEABCCCC...IHHAhACA....hADA...,2,-26,-18,8
JFSBLYXADMZNdGRTEefcVWIQCgaOUPbHK,DIBGMECGZCCEdDHGRFFF...EAAFeAHH..VAFBQEAD.hAAACBAE.OFADUACC.bGEChACAKAEAFCCCBGDD.LEFChAAAAADE.........hAFA......hAHA...,1,-25,-30,5
ZQCRMEDSWIAJgNafKHTFBcXYOVUeGdPbL,JGEAaHBGHCCCBBAB...XADEOFAG.eBADdCCALAEGhAAAZFEBQAGFRCGF.DGCCSGCGhABAAGHD..hACANDICfDFHFEEC......hAAA.YEAG.hADA...,2,-39,-2,37
NLCbXDVFQIRSTKHWGJeOgfAdPZMUEaYBc,dCFCZFACUCADaBAF.BDFBLAGB.CGGB.XFEGDADA.FABERCCDKDHBhAAA.HFBA..hABAJBFGeHFG..fDDAhAAA.AEBFEHGENIBB.....hACA......hAIA...,1,-23,-42,19
WIJZCYQOUSbeDcAfPRdMNEXKGgTBHaFLV,RAADdGFHEECEKBDD.GEBEBFBCFFFFLACE..VADEJAGDCEFG..hAAA...OBAHhABAbAGBDGEBAEBF..MDIDXDGAhAAA..........hACA......hADA...,2,-38,-32,6
edBURaGcHSAYNWTZfFIQOLVKJXbPMEDgC,...NDDG.ZEFH.FGBBOAHBKDBH..XAEHMCAHDAAE.CHED.eAAFhAAABGHAUDDE..hACAGCEESDGBhADAADBBTEGDIAHDLBBA.VFAFPHCChAEA......hAGA...,2,-31,-22,9
DBcJTCdZaKHNfVMegOGUIREFXYWbAQSPL,SGFCLFCHBADD.JDEBTAEH.dEFBKABBHBAB.fDDGhAAAMEAHOBFAhAAAUGAGECDCXACBhABA.WCFAAHEEDGFG.CHHGaGAD.eCGBIAHFhAGA.FHCA...hABA...,1,4,-37,41
gLbHaNUJSMdPfKIRWFAXGZETQVcDCBOYe,GACFTCCB.QFAGDAGGBGDA.eGEALEFA.HEBFUCFChAAASBCCMCAEfDDGhABARBFEAGHEEBAHCEADOCHFhACA.gDAENIDB.PHBC.hAAA......hABA...,1,5,-21,26
INYGMCbWQFOSLRJHTEZAePdBgXUDfacKV,dDCDXGGGDGAB..aGEEKAHH...IFABGBEDCACE.QFBGhAAASACGJEFATGCBhAAA.ACGCBEDGhABAfFDBNDAF.MIBEbBCAFEGC.OFEFhADALBAD.EHGA..hABA...,2,-28,-14,14
cMZYILEbCWUaPFKGAXDOJBNdRVTfgHQeS,XEGDDIBGBAEEdGGFRAAE.....VBCETAEA.HDAHQAAGhACASECHZGBA.hADAIFECECFC.WHBAhAAAaEED.FBHFAHFH.ODDGNAIE.....hAGA......hAHA...,1,-10,-33,23
aVCTZPRMAOBUHLJNedcFgWGEQfKDYbXIS,BFFEHADGJEFEeAADFECEGGBB..QEAEKEACDIEG.XABBhAAASADB.CDDEZAGHhABAPHBCAIAA.LAGBhAEAdCFE..gFGHfHGB..hAIA......hBAA...,2,-27,-24,3
cNHJQGSTMeVaXLbZOgYAPCfIEdKRDUBFW,CFDGEHBGKBBEUBCC.BBGEFCDC.......NDHC.QEADhAAAGCECMBAHaGBHLHEAhABAOFAC.AGHGfCHAhACAIECADAAGHAEETGDE....hADA......hAEA...,1,-30,-32,2
eHJgEfQcUYSLPAVKRbDOXdWIGBZaTNCMF,KDAFDHCEODEGdEFHGEDAZDBF...aCCBCCAC.FGAGHEFB..EGGCQAEHhAAAUBDE.SBHBhABAAHCE..hACARAAH.WEABBCFBNIEH.MAIFeDDD....hADA......hAEA...,2,-24,-23,1
dgAMEDXSOUJGZeCNbKBYFaWTPRfHVQILc,DCHHXGGDUFEDZAEG..eDFH.CAGDKEABBDCF.FBAB..aABHhAAA..TEADRGCGfECBhACAQDEBLCFEhADAdFHEAAAE.MIAGEGCH.......hACA......hADA...,2,-38,-18,20
DbRAHSgUWMfZVTCFLeXYGEcaPJNdKOBQI,HDAGUGBCMFCEZFCGCBFAFHACLAEA..XADCGGDBaBAA.hAAA.JGFEKDAABBABDEGAAGGChAAASDFG.hABA.gCDHfHDB.....hACA......hADA...,2,-30,-29,1
BUXedMgAIFCVbENQGODYPHfcRLZTaWSKJ,CFEDVDAG..EBFGQFFHDDGGHEAHRABHLBAC.ZAFBTDCDhAAAaEHF.KAHHBCHCeFFGhABAdHBBAHEE.IEEChAAA............hABA......hACA...,2,-30,-24,6
XaMVdfTNOIeZUHRPJBcAgGSDYCELWbFQK,SGAHDAEDEDDB.LACG.FFEEXBAGMEAH.dAFETCEHhAAAIDFEZCGFHCCFhABAJFGBBAAEAHHA.GDAEhACACDAB...WDHB.KAHBfBBGhADA.NICF.OHAEhADA...,1,-6,-33,27
WTZfLFcOIaXJPSHgGAVeMRbDEKdCNUYQB,MAGDDHCEKCDBdAEG.UGGGBCBH.ZCFFFBAA..OAFC..ICHGhAAA.aEEAPFDChAAA.HEAAAIAEeFDDhABAEFHFCABFQDAC.fHBBhACA.....hADA...,1,-24,-45,21
XBbWNaeRdPLfMYHCGFZAcODgVIUSTKJEQ,OFCHVFDG.UAACKCFH...QDDABABE..bACHaDAGeCHDhAAAREGHLAFA.hAEAMEBDCHGAFGAFAIHEDGEFSEBEhAFAEGFB.WBFCNCEF..fDFFhADA.....hAGA...,1,-7,-37,30
gUZbWQRMXcVKadPCOIeFSBELNHDJAGfYT,GAFETCBC.ZBBAQDGARFBD.MIBEXGFB.KACGaAFAhAAACAHB.OFBAFDEDEEACNDAGDBEBhABA..AHED.fGHChACA.YFFDbCAG..cDGDhAAAdBGD.IHHHhABASBBC.,1,-17,-20,3
eEFfgIGBJPZbTaLYMDOXQSWRNUCAKdcHV,KAFBdCFCHGFEEADF.FECH....ICAFGBGAJAAHZECCaCHBMADBhABADHFA...QFAGhAAASFAFNIEFAGEBeDEDhACA..BCCG.......hAEA.bGBAYHAGhABA...,2,-38,-13,25
fZNIJGKdELcDgBMbFAQCSPHVXaWOTeYRU,QGAFSEGDHDCFaEBA.OFFH.eFBDRBBAUFEBZBABICEDhAAAKADEEAAFDIECMDIBhABAAHHDCFHB....VCFAhAAAXAGH..WBFEfADF.hACA......hAGA...,2,-24,-7,17
fGRTKIFUJMXZWVQPcDAadENLOBgCeSYbH,EDABLEEGBCFG.CACG.eBBD..SHCEHFFARACDKDGHFDAHMIFEhAAAXCFCZGBA.QGGEhAAADIBEdAGD.gBGEhABAfEDAICCA.UGAE.hABA......hACA...,2,-17,-16,1
dRbWaMQJUDILSNVTFXGAOHgCEcfBKPeZY,OFBBCFDD..EBFHBEHFKEEBZACDdEDBRCBH...aBDGQGGBhAAA.JHBAIHCFhAAASCGATGGHXCABhABAAFABHFDE.fAHE.YABEhAFAWFADDECB...hAGA...,2,-32,-32,0
PKDeEXIFaJUOZVgHNBQWfRdcLbMSGYCTA,KHFGEEGCFFCHUCBB.ZCEAHABA.BFABQAGBRCEHdBHALCDDhAAA.MBAHSFADhAAACHGH.PGCAXGEBhABAIACH.aEEG.OFHFNIAF.cAEChABA....hAFA...,2,-32,-9,23
VQYATeMECGIPUOBdJDcfXNRWbHZaLgSFK,eAEHCBGEGECFUFGBBCDHDBDH.....XDAGRBGDHGBG.LEHBhAAAFBAEQEBFhAAAAAIBTACGIFEE.hABAOEAHcGACNIEF.ZGDA.aBBH.KCGDMABEhAGA......hAHA...,2,-14,-14,0
QBfGXSEZMHdaWPVeALYcITDbRCFNOgJUK,LGEA..cGDEIHCA.DDBGCHBBFEAB..NCAD.JAAAhADAKCEBQBDHhAEA.GEGEECGFHAFEhAAAdDEHaAHFPFAGABGE........hABA......hACA...,2,-35,-23,12
FbeXCMEQcdOfgIZPWTAJaKGYLSVRHNUBD,JEGHGACBLFCERFCCHCFEBHBDDIFC..FDCBeADA..CHAAMDAHhAAAECBEdAHC..OFHDhABA..IHEGhAAA.PCABAFFAaHCEKAHF..SDGEhABANBBE.....hACA...,2,-29,-18,11
VFdMPCEIXeRZYKHOATJSaNUcQDGWgfbLB,TGGDJEGH..aEABUAAD.DGAFGGAB....fHEBhABABFBFVBDAMDGBhADAPABACBHA..IFCGhAEAeDDB.ZADG.HDDHSFFD.hAFANDIGWAAD...hAHA...,2,-26,-26,0
JdbZXSCPaBEQReVDcYULWIFTAHMNGfOgK,HFACGBGAODDGKDDCdFBAZAFC.CDBG.BGACRABA.eABDDGGH.UGGHLEHDhAAA.FFEHAICCMAFChAAA..NBAE.gADBhACA.JFEF.......hABA......hACA...,2,-26,-24,2
WGfOdLTEeKVUQAcYaCSMZRJBbIFXHPgDN,aHBGMAEEZDCFRCGF..BDEEFCGAHADG.DACGGACC.OBAHhAAALHFCEGFHKFCHUEFBAICA.hABACAHFSAAFhAGA...bBBCIBFC.PEEBhACA.NEBA.....hAIA...,1,-15,-30,15
DOEeVYMFAbdWJacfRUQHSTgBNCGIZXLKP,dHBHaDCD.RBAHUCGBHAACSFFB.BDGFCGFGGACFZGCGKAFBOFCAhAAAeEAD..MCEDhAAAAIFA..JDCE...hABA..fAHA...gFAEhABAIHHGPAHDhADADEHF..,2,-37,-18,19
IaeWRgKGYODEcSPZXCQfFbHNMJALBTUdV,BFFETFCAdHCF..aBFHeBAD.RAECGEAFDCAHEGFH...SFHBhAAAZBBGCHHD.FHGCHAGHhAAAMCBGJFAB.LEEGhABAIDEDKDBAOBHF.....hACA......hADA...,2,-21,-17,4
LTaPRFEXHZVMfOUYDgeSNdCQJAbBcWIKG,BFDG..IFDGLBAFTAAFaDEAFBDBHCGFZBGF.MDDGOEFBhAAADAEASGFAhAAA.NHABdBGFQGAFhABAJDBBACCE.cGGD.KFAC....hACA......hADA...,2,-30,-12,18
GXBQeJMSEOFHdTPDYbAKgcCUWfNLZRaVI,KHBGCFDGUBDH....fDFDZBFDRGFG.aEDHGCAG.BFGEhAAAJAEEMDBD.OHFAhAAAFHCAdAHADAIFADEB..hABA...gABFWACC.LCEChAEA.....hABA...,1,-23,-40,17
CWUIgTEQJMRXZcVSYDKfbdFLGNPOABHae,aBBDeAFB.CDED.UBFC..TBAAQEGDMAAE.ZFCB.SGADhAAADEBBKHCGdFDDLECEhABA..PHFEhAEAAHHGBAEFIFHHgGEEECHD....hACA......hADA...,1,-24,-27,3
JRXQYNIeLZdCgbMTFfHSDaBEKUPOVAcGW,GAFEJFBB.RBAEQFFF..NABGeHEALEBGZDEFCEHGMHAAhAAA..FAFHSADEhABABHCAUCCGOFHDhACAAGEB.XBDDdACB..bAGFfHEBhAHA.DIAA..hAIA...,1,-12,-32,20
UecbMEQZWSHgVPGYIXTfJNKLAaBORCFDd,OCAFFBBDdFGCUAFG..eDCD.bBGHMDDH.ZFDBHAEB.hAAAPGACGEAEIGHEhAAAXADC..fGFAhABA.KACBACAB......hACA......hAEA...,1,-20,-36,16
PaVLXIAcTRZUGBegfDbQFYNHdEWSJMOKC,REFHUBCFGDCCBAFBeFAHDABE...FAAEHFFBEHGA...JFBAOAEFhAAAKHCE.CHEG..aADHLBHHhAAA.ABBDZDBAhAEAgAGC........hAEA......hAGA...,1,-23,-40,17
ZVAIXSbEOFaJTeUcWKgLGNMHPdRBYQDfC,SGFCOCCHFGFA...aGAAJGBG..TCFFeAAC..UBFBhAAAKADALDAG.hAEAMAIFPEFCdBBCYHEGhAAADBIDCAGCAIEA.IEECEBCE....hABA......hACA...,1,-28,-33,5
PGXBEfVOgLAKcCYaDNUJdITRQHFSeWZbM,CFEDaHFGDAFE..UEBBdBDH.RCDG.FCGC..SEGCZEAE.MAHHhAAAXGFA.BCAEhAAAEABFOADE.AIBCKFGAhABANEEF....JHBA......hABA......hACA...,2,-50,-30,20
BEKQFdTeXYMGROIJCSVgcLPZbWNADfaUH,DGHHUGBCBEAGKBHD.dGBE..eADHMCAGGBEG.RCAH.OCEBhAAACACG.SDGChABA..cGFELFFFhACA.PADE.WDAEAEGGaFAH..EAHBhADA......hAGA...,2,-36,-34,2
dMJeDQOSUNCcFWRVbLfIgaPTZXEBKAGYH,GEDHHDAGdGHGMAAAJHDG.eADFDBFD...SGCEUABD.CBGAFHGAhAFARDFBLAHF.hAGA.IHACaFACTEDChAAAZCEABBBB.AIFG.......hAHA......hAIA...,2,-23,-23,0
aTAROYHGJUBXgMLdKDVFQZSWfCPEbINec,RFDFOFBBGBEABDCAMCHHKFEH..FGHHZBED..SAAFhACACDHG.EFADIAHGhAAA.eADCcEAATGGGhABAABIBHCCF.XBBBdHCBQCAGhACAfGFA.NADF...hAIA...,1,-13,-25,12
eBIUVfJPDFGCNagZSdbXAKQWMLRTOHYEc,QGBCLCHDOFFHEBEHBABDUBCG..JDBAFEAAGDFC.hAAAaAGDSHBGhABA.XDEAKADEMIDEhAAATAFF.YECBIFDG.PFHDhACACHGH.NAIE....hACA...,1,-14,-32,18
WbNXJDBPgfHOLGSeUVaCZQIcKMTFdREAY,...bAADNHBF..DADGBFDG...fCHAODBHSGGBhAAAeACDUBEBaDGBZEEHQCDDhABAKHAEFFAGdGGAACACXAFHhACA........hAHA......hAIA...,2,-39,-19,20
TdIbEGLgFSXOaJYHUMRDcQeCBfWVZAPKN,KHBGdGFCEGCDLEAD.FABEXEGA.OBEEJFBAUBGCDDBCQACChAAABEHF.hAAA.VDEFAEDB..NAEHIDGDhABAGBCFaGGCMFEB.....hABA......hAEA...,2,-30,-21,9
gGCBSUYPMQAcJOLIKVNdbDFRWaeZfETHX,JEEGOEEGLAFAKACG..dGBGFCAARGFE...aGCBZBFE.EECBHEAEhAAA..XCAChAAACHGFBABF.SCCBhABA..PCEEADIH.......hACA......hAEA...,2,-38,-31,7
gISRAXKYDBPMQJLGbaeEWcfZNHFCTUdVO,KGFCDAEDBFCHQCEAGDAE..eBHBEABG...fDCBhAAAZEECFGHDCHDE.dBAB..OAHHhAAAgGAE.hADAIGDDADCEXGEBMFFGbAEDcAEG.hAGAHEAC....hABA...,1,-17,-24,7
FDOGVUPgZbWKeJBQXTfYEINARSaCMLHdc,RFEESEHBMCDC.dAHCDICEGEBGUDGHZDAGKCAEBEFF.QGGHhAAAXAAC.TAEFhABAEHAC..AGIBLADEhABAcFDF.FAHFODAB..gFBEhACA....hBEA...,2,-23,-14,9
JIQgcMEUFLZbXKfPDSOWNaYAGBCHTeVdR,CFDGTBDGdCAB..RBFG.QEFC.MIDEFABEZGFEKDBDDFABODEFhAAA..aEHDAECBBEADhABAHFBBJDDH.gAABhACAEBDAUGAF.bBGB....fEHAhAEAWADC....hAFA...,2,-37,-1,36
MDgcBESUNAIKbZPeCYGTWRfdFVLQXJHOa,KHBGZAADCFGDGBBA.RDEG.FFACLABCQGDBHAFC.OECDhAAADAIFBCCBUGGEAIHE.IFAFhAFAeECE..TBEEhAAA.dHAB.JACE...MDIB.EHFAhAGA......hAHA...,1,-13,-23,10
DWOcHIbTeMQZfCYgFSaKVLBRXNPJEUGdA,DEFHOGEAHAFE..TDFBeDACQFCD.ZEFBYACBhAAAFABGKBCABHHHRAGFPFAGhABAEEBF.....hAAA............hAEA......hAFA...,1,-23,-36,13
PgHKFDOJUfMQbZXWNEYIaAVRBSTcedCGL,RFGHBFCF.SAGE..TAAFdFFFLCBGPFBHHCCEhAAAKDHHDBFDOAFCUGBDQABAhAAA.hACAZGEAXGDHEEAA.IEFFAGIF.cCFAhADACEEC....hAEA...,2,-32,-17,15
PbadSOBIfZELVCFeMgGXYUNDRKHJcAWQT,QCGCTCBC.aFDBSFDH.BDFEIHBBZAACEGAFhABACCDCFBBFeCHDMFFEgGFHhACAXDADUAGHhADADGGARAEAKAEF..........hAFA......hAHA...,2,-25,-14,11
DLgOGXYHSFBCWZMTfJUIVbNcdaPKQEeAR,DAGDLEEGGBBFHFCHFFDEBFHACGGEZAGDMEID..JFBDUAAC.hAAA.VDFE..cDABhADA..dDADKGAAhAEAEAHHAECAOADESGGDTGEAfABFhABA.....hAGA...,2,-28,-17,11
RUVXJgIDTGcCYSNZKPfLEaWeOHbMQBFAd,UCCBXBDG..IBGADDAGGFBB.CGGG.SEHFhAAAKABBLBHFaEFH..eCABhABAOEFCHFACMEABBHAHhACAAFBG.dBBB.JHDA........hADA......hAEA...,1,-21,-33,12
CVcDUOLJBKRSgIfFZAWHYTPQbXdGNMeaE,HAADTCBCQAEC.dDGAMFGHEEEBCGHAVEDB.DFAAOCDBhAAABBHFSAEFhAAA.IHHGhABAfEBCFGACABBFWGCG.......hACA......hADA...,1,-20,-33,13
TeIABHLPaMfQYDSEVNbGgdWZKFOUCRXJc,BEFAHFDFaCCDQFAGDIGA.EBEH..NBICGEAGdFDGKHGEFCAECBAG.hAAARABE...JCFFeAGFhAAAABDGMADE..SCHDhABA..gFFGOEAA..hABA......hACA...,1,-18,-28,10
bRVgAFZLfTOYHGXIBeQEKUaMdWNPSCcJD,FDBDZFDFLFFGOHDAGCGEBAFEQABG.KCDEaDEHMEBGhAAAdAEA..PABBhAAASCHFCHHADBGG.bFBD.hACA............hADA......hAGA...,2,-35,-26,9
FRYAQEBGKVWeUNSfPXgHaLZcdDMCITJOb,QGAFEGACBBCEKDGCeBFE.UCAE..SFFFXFEEaFDBhAAAZECFDAGC.MABEhAAAIDDE.JEHHbAFGhBAA.FGHDAAFA.GBDENBAFfCFC..hABA......hACA...,2,-23,-22,1
DadSFBIQOMVHCKcXTEfNgbRGJWAeZLPYU,LFFCUCBCdBFFBFHDOCFGHFDFKEBH....TCDFEFFB..hAAANDDB.RBACGGBF.hAAAADADeDFAPHACDHGGFACAhABAIAHBMAFE.CAFA.......hABA......hACA...,1,-18,-24,6
QBCUTVFcLGgDYOWZJdfIAEHNSaPeXRbKM,ECFCHDAG.SGACaGGF.eEDFRACGKCCHQFGFBEECUEAGTBAEhAAA...VAFHhABAFHEELAHHhAAADADGOHDCZGBE.dBAGAEGANAIE.......hABA......hACA...,2,-22,5,27
CgVbQONTDBPYGJMLUAaZcReIFSWfXdKEH,aCFCZGFGRCCH.FCFF..SDCF.XAGCEFAACDHH.VFABhAAAOABH.DAEFPEFGhABAGGAFLBDBhACA.AIGG.IFFEdGGB.HAFG...hADA......hAEA...,1,-21,-26,5
cWICFHgVOaYbfRMGBNXSUEDeKQAJdZTPL,JDCHTCCBLHDE..IAGCCEGB.FEBDVFAB..OEHFhAAAaBBE...bGCAhABAfAAHRDFHBBECNDAG.hACASADEDICG.KGGC.AHIBdEEAcACBhAFAWAFH.....hAIA...,2,-29,-22,7
AKXRLZGbcUHBFOTNeCEaIfPdJgWSYMVDQ,RBCFLEGHZFDHGAAEUFDAFHAGOBEH..TFGHCAGA.EAGGICAAhAAA.dEADgCGEhAAA.SEEBhACAMBAADIFAKGAAXEAE.HAEDhADANIABaCGC.....hAEA...,1,-7,-29,22
XdDAEgWcKIGOfTaFVCPZNMBLReYbUSHQJ,EHBG..gCBCKECEGAADOAAG.aDFFFFGF.CHDBZFEHBAFFhAEA.LHEGeDABUCGHhAAAQGBE.hABAdEDBAAHD.IAHDfCDBPDHFMFAF.hBAA......hBCA...,1,-17,-20,3
AEOPcdCHZWaUNLGJeBIFfgbYVMXQTKRDS,OCCHdHBHHABHZAEAUFCFGFCD.BCAEfEAF..bGAChAAAMEDG.QFGGhAAATDFFDGIBEAGDCDDEaHFAhABALADB.........hACA......hADA...,2,-28,-11,17
SeGNYfFVUdcbXDPTgELIaJQBMCKAOWHRZ,OFBBHGFGSBCEGGCF...fCGCFCDAdADBXAGHhAAADGAETFDAEEFFIABBhAGAaCAGBHAGMAAC.hAIACEAEAIDEZDGFeDCGNEBF.YAFD...hBAA......hBEA...,2,-15,-5,10
YANLdScPUgWZVaXDbMIQGCOKHRFJTeEBf,dDCDSHBGUDGFZFAB..aHCADGID..IFDHQAFEGCFChAAAKACB.FHGE.eAEDhABABHDHADEBLBCDhACA.cFAG.WAFEXFFA.CFCAOAAFhAAA...hADA...,2,-39,-19,20
PZHVfOCgWRAYdFTNIaeJUDMcQGSbBKXEL,dAFBTGBCaFFE..UGBGMFEA.GCBBBCEFKBCDLAFC.PDFChAAAHCFEOAAFhAAA.CADA.REACAGHEFHEEIABGhADAeDDDDAIFSGGDEEEE....hAEA......hBAA...,2,-20,-15,5
JcbVLeBZQPfFOGCYIRTDWUgASNMdXHKEa,SGFHMHFGdEEDKFCAEAHH....JAFDVBEHBDBBZAAC.QEGBhABAFACBGBGEIHHGhACA.RGBE.DAIF.hADAUFAEACCDXEABaEHD......hAEA......hAFA...,1,-14,-36,22
MOXHQfTUCdRPASFBeacNWJYIEGLZKbVDg,SEHBeCAF..aGGA..NFCF.JGAGEAFCLBFBZCAB.KHDAhAAADGCFODEHQGEAhAAATACDCABEdAEG.AHGCFBGEhADABDHB..WDECIECG...hAIA......hBAA...,1,-24,-30,6
OXKWGYNMTeCUARHfVDdgbBacFJQLSPEIZ,RGFGHGFGDCBA.dAGABHAHFDAEQDFELAEE.EBBCODEH.KECBhAAAGEDE.YACChAAAMDADCBFB.ACFFfGBAhABA.........hABA......hACA...,2,-52,-5,47
XLWREaFgDGPSZTKBYcOMIfANCVeQJUHbd,VDBHeFCAUAGF.dBDGXAGALAAFEGEAFEAE..DGIDGDEFhACASEECKGGFBHDHhADAOCCG.MADEIBBChAEAAHHDCHACQAAF.....hAFA......hAHA...,1,-20,-24,4
CHQJgdWKFfTUZcYPIbBNSaOVADLRGeMXE,DGADLEGHGABBMIBAEGBG.HCDB.QEACJFFBdDGF.KDBEFDEBhAAAUFDF.ZADEPBABhABABBHBaHAG.AIHA.XAFBhACACACF.fFCB...hAAA......hABA...,2,-25,-14,11
fTObHXMZCWVJDcBFPEALQRdSGKUYIagNe,QAEGRFEEdEBDKHDE.UDFF..aACGeABF.OHCEXGBBhAAAZGFCCGCB..VCEGJEBCDAAFhABAFAFAAABF..SBGAhADAICCE.fGAE...hAIA......hBAA...,1,-19,-35,16
YUTNMOcFDVaZQbeRHPEdJBKLGCISWgAXf,XCBCUCBCMIFAFGCD..DAADZAED.eFEHHGCE.EBFFBCGDKEECGBGEhABACABG.SDAFhACAAHHBTAGGNEEHOFBBhADA.aAGAQACC.REAA.PGFAhAEA.....hAAA...,2,-24,-3,21
HPMIURGQBEfACVdZYFgDLOaKTJbcXeWNS,dBBDZDAGFBGFLDDAKEGC.JHFE....XFEAeDGH..NEAA.hAAAHADB.MGACRGCEBBFChABAABCGCDFF....gBABhAAAaFDAbDAB.SHAG.PFHDhABA....hACA...,1,-24,-32,8
cdCHUTYVReAPDbEGNMFgBZaSKOJfQILXW,DACBGEAHMBDEBHEFZAGB.SAAH.ODHDfDDEhAAALBEDXFAHdHGBCBGE.hAAAUGEB...YBAFhABARGAEAFFAbCAA.EFCD.NBIE..FCEG.aFFG.hACA......hADA...,1,-11,-20,9
dRGbTDaUMSeVfcZIWLAPNFXEOJgKCQHBY,FHBGXGGDOAAHKADEHDEG.BBDGdDBEGEEBDIGE.MHBCSDDFhABAeAGD.VAEEhACAfBCG.IAAAhACAAFHFEHDCCGHAQEABRBEBaEDH...hAHA......hAIA...,2,-19,-16,3
KSTZONQWFJfeGIPURaACdYHBMLEDcgXVb,dEGDBFDDLCEADAGD..XFAFKAABTACCZACG...QGAAhAAAFGFHJDEC.fFCDhACAeHBA.IHEDhAEARBABACEACEED..MAAEgGGE.SAFHhAFANAIE..hAHA...,1,-30,-32,2
OQEKNGbaIUFMcTfZBdYPeJgHDCSVRXAWL,LEEGQAADKBCDGDFC..IHCAFEAGMGCE.fHGFhAAABHHFdBEAeAFGhAAA.HEAEDBDECGBDSGGChABARCDDADAEEDHB.aGEBcAGE....hACA......hADA...,2,-26,-18,8
cEaJHCFRLUWKbgeMdSXTDVOQPIfBGAZNY,ZAAD..NDDG.EEFGHCAFFCGGLEDBUCGFKHAC.eFAHdAAF..SFEEhADADCCGOAEA.QDBAhAAAIAFCBHEHhAEA.AIHE.aGGDCGHA........hADA......hAIA...,1,-23,-30,7
aEgUATdVYGXWeOHRLMBFSDJZKfNQCbcIP,VBCFXAGH..eAAHHGAELFHBFEHBJABAZFDCKBGE..QGAAhAAACDDH.IFDEhACAaFAAEBBDAGIDdHEF..hADA.WBEHRAEHBEFDSEAFNIDB...hAAA......hAEA...,1,-12,-17,5
HBGUcVXAgQRPMbCNKfaLFedDZEWISJTOY,REFHMCCACDHG.KEEGLCAA.dEBGEBGC.SGDAOHAABHGAhAAAGBAEUAFE...hAAA..VECEAIGAgFBChABAQABFNIABaHGADEAB.IAED.hACA......hAEA...,2,-24,-23,1
KfAOSFZBeVbEGXJaQIgNUWcLTRHMdYPCD,OEGHSEHBZABHBBFCeFEH...EHDEJDAC.QFAEhAAA..IEDHhAAANEGGUACDLAFFRCFGdDAECAHCDGAGhADAAHHBFAHF..........hABA......hADA...,2,-38,-19,19
FKCNJPYcRVMbXLUEWHdOaTgQGZSeIDBAf,FAFBCFED..JDHH..PDCDRAEA..MIBGLCGF.EBCAdFFAhAAAOFHFaCAA.TFEGhAAAQEAD.SDEAhABAeAHBBHDGAHHAKABANBBA.....hABA......hACA...,1,-27,-35,8
QIbaDcFBCXUfHRZeATdgSGEMONWJPLYKV,dGFCGEAHEABH.OAED..NADB.JCAALCCDKFGB..IHBFhAAADEDABDHG.CHCCUBEBhAAAHAGBRDEAABAD.SGFDhABAMDBD...PABE....hAEA......hAGA...,2,-38,-19,19
OPGJVcKfLbZWDHINeXCgQMFdYTBSRAaEU,EFAAUDACGFDD..JCEHVBBBKHEELAEEZADFDAHH..HDEChAAAeBCBCHHE..MIEGdEGBBBHAhAAAAABA.OGBGhABAcGAD...fAFE...hACA......hADA...,1,-7,-40,33
fPQAVMNLdObKDRBFIUaWcGYeEXJZSgHTC,VFACLCHD.OFAAKDFDBEHEFCCGUGDF..aEAGGADFhAAAEBAEZACCSGGChABA.TDEFCCDGQGFEhAAAAACCMEAC.NADFDEEHIHAE..YAHBhABA....hBGA...,2,-32,-12,20
bQLSAHUETVCeYcMFWJdKZaNBIODgGRPfX,EDAFTGDC..VABBCGHD..eCFHMAAFJBCAdGBH.ZGFABAGEDDFHRBFAhABA..XCAAhAAA.LFBFAEGGUECB.hADAFDDFWHAGKHFGaDGD.NEAG......hAEA......hAFA...,2,-22,-17,5
fLIJTMZUQKgOYVHdeFPREXGcWABNCDaSb,CBBDSGCDLFFC...TDGCZBGBKFDBOEAEHEBDFBDD.ECADhAAAXAAB.WFGDhADAAIHCDICC.aAFHIAEChAGA.MFID.UCDH.gGDEhAHA.dBGFPABGhAGA..,2,-26,-18,8
agPOUFKcZILWTBESfXRHNJQMDdAYCbeVG,CFDGeFBBGGEF..aCADOEBHUAABKCECZAGDLBAGBEGH.SAEGhAAAXAFAHDCHhABAJEDC.DIGEABID.bFFG.hABA............hACA......hADA...,2,-32,-24,8
JaLGACWcZSeXRNYfQMITbgODBVEPHFUdK,CFDGZAAD.SDGFeEDGRCBH.....fDECIBGGTGGGhAAAOEAFDGCF.EGGDhAAAFGAGKAEBaBABAIFEXAGDhADANAEF..MBCAbDCBBEHAPDHD.dHDFhABA......hACA...,2,-22,-16,6
MZaDFIKRUOPgCeBGAXWNLcVETQHfYJdSb,XCBCLGEAVCGB..EFGBHEBHJDHFdAAFSACDZAFDFFCH.hADAIAHAKEDG..hAAAOAHDCBECBFFAAFAF.cCDEhABATGEE.QADEfDAFMFBFhBBADICA......hBFA...,2,-16,-13,3
dgRTGJMXSNZHWEOfcBYKUFCQDaePVLbAI,dHBHTFDHMCCB..SFFEZAFFEDED.ODECBHEFKADD.CHGG.hAAAaBEB.eFACLBAFhABAbAAFAHAE.REGF..XECDhACAWHDA..cAFAFAHFDBFFIDCEhADA......hAEA...,1,-15,-28,13
NMDLBfgHebVXSPIRZQJFKOcTaEUdYGAWC,CFDGDDGGLCDABDAAHFFF..VGAESCDBRFGB.QGCGhAAAKAGEOAACaDBDEEEBUAGGhABA.dACBAEABMCCDhAAAfFAEeADG.XDFCICAG.FHEE.hAFA......hBAA...,1,-14,-19,5
KcaNTYFgVGRMBILdUJXCbZWHOefEQSAPD,DGHHKAFB..aEBBTDCB.FEGEGDGE.RCDEMIDGICAAUAAAhADAJBFE..CHAAZFCEHABAhAAAeAHBQFEDhABA.SGADAAEF.NICBgFBEhADA.BAEB..hAGA...,1,-19,-21,2
TRWZIUSdgXDKCJMPFOaGAEcVeQBfHNYbL,ECFCVFDFBEEG.HAAF..NAHE.LHDCRCCEZFFB.IBEEhAAAUAEHdFAEXEGG.hAAAKAHHMBAF.OBBBhABAADAFeFAD.fDBH....hACA......hADA...,1,-21,-25,4
gZAaYVXCSFTBDdQEeLNHWcfMGbROJKIPU,aCFCXFDH.FABDTAFH.BGGCDDFGdCDAEFED.eFAGLECBhAAAHAEG...cBCBhABAMIDCbFFA.JDAEKCABhACA.IFAF.......hAAA......hABA...,2,-25,-22,3
YfEXLBTgNWdKVFCGebODPQaZcIMURJSAH,HAADEHBGBGGDTAEE....NBDHdCFEKCCGFBHBGAAEOEACDFFD.hAAAQGDEZDCB.hACAcDEG.IGGBhAAAMAFAJDHFAHIBfHAFgEAA.WFFEhACA.CGAC.....hADA...,1,-19,-23,4
LCgQfKTHeBcOIbERAJWaUVNdGFPSMDZYX,aDCDVEFHGEED.FGDDMIFA.DCDAXBEFLACE.CAAC.QCADhAAAKDDB.HEAFhABABBHEICHAhACAEGDFAIAGJBGF...NBBC.SGHB..hADA......hAEA...,1,-17,-34,17
ZLKUYRWXHIGQSPcDfeAdFOCBEaMVNJgbT,dEEDCDGFBFAGEBED..MBAE..JDED..TCCGKBCBUFBG..hAAARFBBHAGHGAEFSGADhAAADBAG.AHGEFDAFhABAaCAB.NIEH....ZFEGLGFA..hABA......hACA...,1,-2,-47,45
QMgYPeNHcdKUSFVaECJbDXLWAZORTGIBf,ZDBGRAEGGBBCBCBCMCID..PHAGHFGDKACGFEFG...EAAFCFDADGIDhAAALHDEAHGH.IGAAhAAA.QDFBhACAgEADeAEENAIEdADCSGCFhAHAaDEG......hAIA...,1,-15,-20,5
MXIJCOaLgFDYcUeGfQbHBdWATKESRVPNZ,KFHBEEHBRDED..VGEAZAAF..MIEA..JCBBCCGE.OECD.LAHDhAAADDABUGBEGAEEhABAQACCBGBGABBHSGEAhAEA.NAIE.IADB..hACAgECEYEEG.hAGAfBEF.,2,-24,-21,3
NWZVXYDHEcUPgaOGLQfRCAFbIBJeKMdST,FHBGBFDGKBBASBAD..NAGEZADFXBEH.HGAEEFHHUDBFhAAAaCGDLAEChAAA.QGFHhABAfHEFCBCGAECC.bEFEeFECMAIFdAHE....hABA......hACA...,2,-33,0,33
LUPJfBNbMHACFOZYXKWcSdRGgDQaVTEIe,OCAFXFDHKEEE..SEADdCCHGGBFQBCG.hAAAVDFHIAFBUBFFfBAGhAAAbCGBAIHE.hABACHHBFEBEWABA.gGFHDIEGEHAA...hABA......hACA...,2,-25,-12,13
WAGKDbfOLYMaHVSQIPRJUcETFZBdNCeXg,KACADACBODEDLDEE.MFIFHBFG.SECFQEAGRGAEUGEBhAAATFECZADB.BDAFhABACCADXGCHAIHG.fHFHhAAA.aBHF.IAFCcDGCdAGBhADA.....hABA.eCCD.,1,-8,-13,5
cRXCPGAfdMFYUgVaNQLIEeDZKOJSTHWbB,dGFHMHFGFCEGUDAC..aABBQFCHLEAH.EEEAeADA.DHCChAAAOBBG.TBGEhAAAbEFERDCE.CDDE..AHAAfAEBhABAgCGFNIAFIFGC...hADA......hAEA...,2,-20,-18,2
aEdOecJLHXDKYCPTSfRVWGAgFIBQMUZbN,FHBGQGGGUCFFZFGFaDEF..dFBH..OFBDeAAF.JCAEHDBEhAAADEEFKAHDCBDE...SAFBhAAA.fDGHhABAWAHBACBCIAFCBACANEAA..cGDChACA..XGEHhACA..,1,-27,-35,8
ecZKRQIFbMVNHCPXLWOYJgafGdDAEBSUT,EEHBBFCFUFDCeBADZFBFKEAD..RAED.FCEE..MBAHHBBD.XDGHhAAAOAHF..JBCHaHAGhABAdGAEDEEC..SGFHhAAATGGF.........hACA......hADA...,1,-26,-32,6
RBXKSLaNUOcZgJeMDfHWVICYQbPGEdATF,RBCFBFCFKGDCLAGBaHAC..OHEAZGFG.eACFMCIHDDEAHEAGhAAA..VEFECBBAQEFAhABA..bAEAhAAAEAEBAFEDFEABNIAF.........hACA......hADA...,1,-15,-32,17
DQRKYbPUaMFXCVABcdWGEZLNOSefHJTgI,dEGDEGAHLCBBSCGGeBDHHAAB.JDCDTGDH..DADDREFDKAAGhAAA..bAECPCAHhACAMFEBCHCFAGIDBHCD.hAAAGAGEZEEFfFAC.IHHAhACA.....hADA...,1,-9,-12,3
MKIYcXJQdGECgBAVWZPFTRDHUbLSafONe,VGFGZAADFDCD.REGB.DECDHFDCLEFC..aBEEOBDB..hAAAMIFEKBGE..ICADhABAXFACdFAGCHAAAEIDTFDFhACA..........hADA......hAEA.SHAAfHCD,1,-21,-31,10
fLFdYWQXSOAVcEBePDCUINMGbZJTaKgHR,VDAGBFEDDBAA.UGAGMCHH.GBBFZAFC...JEFFKBDHHAFEhAAALCFDFFDFdHABQDBGhAAASACEOFHHhABAEHGA...CHDE........hABA......hAFA...,1,-13,-40,27
YbUXMCILTeNFOKRWJgQGSDVEfdHBPcZaA,UCBCCFECLDCFeFAAFAEGRAFB....JBBCGDGG.DABEEFHHHGDEhAAABDHDZBFEAAEC...hAAA.XGEEIEEHhAHA....NIBHKCAB......hABA......hACA...,1,-22,-41,19
gfdMCAbESXGYQLTIFUZaJORPDWceKVBNH,EAFBXBCBGGAFLECCFDFGZECC..OADHDFGBeBEC.KHEGBBAEhAAA..NDAGHAABhAAAfHGDCCHAAFDH.SEGAhABA.QCAFIHCEJEHB.hACA......hAEA...,2,-25,-18,7
UWEZaJHOBTfMFSAKDIVdgPNCQGcbYeRXL,KHFGVFDGdBAF......NACF.QGDFGBBG.bADFeAFAhAAARDEEUDBHZBFGJDFE.BEDFhABAfBGBMIFCABEB.hBAADGGG...IHAD....hAAA......hABA...,2,-30,-19,11
FOQUVCbSGcHXfdAILZWEaKgDPYRNBMJeT,LFBBZDAGEACG.KFDADFCGRACDBAAB..MFGHeAGBFGCA.QGAGhAAACHHGGBEE.XCDBhABAAEAG..IEHGhACAaBBH..YFHB.JAHF..hAEA......hAFA...,2,-37,-26,11
TNgQcYeMVGPBaSJWHDdLZIfXOAKECURbF,KEHBEFFBUDEDFCFE....TBCAQAEG.eEHBGEFChAAABBAAJDACDDAGdAEHIHAFhAAAXFCDADIHCHDE.REBB.hABANIAD.....cAGA....hACA......hADA...,2,-30,-26,4
QJTFfDPANWCUdeSIZBLaVGYcHKEgObRXM,CFDGUGGDdCAB.eCDFZCEGBFADLCFE.GGBBHFBFEHEE..gBABhAAARAEE.XEEGhABAMFFA.TEAHhACAFAAEDHGAAADC...NAIASDBGIAHEaGAHhAFA......hAGA...,2,-25,-12,13
KRFHcJePTZLQCEdbUXBVaSDGYMOgANfWI,...fFAFKEGDRECBHAFGeFFFZCABQACAdAHAUDDHBGDB.hAAAaCABDIGA.MDIDABECIAAChACAFGAEJHDE.PDHFhADA...TGBC.CGHD.ECEFXBEAhAEA....hAFA...,1,-18,-19,1
NTWYRfEUHFASPXabKceBLgODJGMCQZIVd,XGBCaAFB.KDECBEHG.LFDGDAADMEHDQABBhAAA.IHGDNCDD.hABATGBGRDBEfADFhACAUDCFHBFFAIDGSGEB.bAFAeEAFhACA......hAEA...,2,-24,-16,8
TZdEXeMNcHbOgAVBCJPURLIGfYaWQKFDS,CDCFJDACRBFB.LEFAGGAF....aEABQBCADGGE.TGDEhAAAEEDGMBCAHAGHOAAFhAAAAGCEBHGA..IHHEhACAfFACKGFDSEGAdAEA..hADA......hAEA...,2,-27,-19,8
ebQHNRfOgCVZKYPUBAIWcaSJLdTDXFGME,..IFDGaHBGLABCDGCH.GDDG.eCBBbCECHABDRGFAOBFDhAAACFBFKHFA...UFFBhAAAAIDCWAGBJBEC.XCCBhAFAMAFAEDAE.NDIC........hAIA......hBAA...,1,-13,-17,4
cXWIGHdOgPefQVYFRaAZKEbBJLSCUMDNT,ZFEEKAFBBCDCSCBGUEGH.DGAC....TFAAXAAEGAAChAAAOFCG.eBHDhAAAfFECVBEBFADBaFCDhACA.AHGE.EHAG.JHEEMIBA...cDEGhADA...WAHFhAEA...,1,-10,-42,32
OeQWRIgTVXDYCHGKSZdMAbEBfNPFJLcaU,BFED..PHFCFBDDJBFCaHCG..UCAGQCBB.IFAFhAAAVFAA.XCGHhABACHFD.KFCGSDFFhAAAMBEBAFFFEACALDHB.eABA.hACA....WHAGhABA...,2,-47,-15,32
QIKBYNWAOebdScPHGVRCgTZMaDLEUJfXF,OEEGdDCDSAADHEAGRFDF..CCDG.ZEFBMBBHDGBDECFA..JFHBXFBBhABAFADE.KBDDBBGAhAAA...YHAAhABAAAFGeEHF..cADA.....hACA......hADA...,2,-30,-27,3
SeAcUNOLXQgRTPKFDGbEWZYHVaJMdBfIC,UCBCOEEGLCHB.QGEHTABEKGAHDHBAEFGCZAEHHBDAhAAA.aFDHMBAEBAFAIHHFhAAA...hABA.CFAF.SEEAADIFcGFCgDAEhADA.....hABA...,2,-34,-15,19
LgRfCUBZEFOJNVWTdcYXSQeAMaHGbPDKI,aFEFHEBHGEGGDIGEKGEFLFABRCAA.UADGEFEGFBHB...JABChAAANEDC....WCBBhAAAdAFGXDGA.hABASGBDAEIDPDDAfCAECGHD.hAEABCHC....hACA...,2,-27,-20,7
UXeJcANKIaGfMPCYFDQLBdZOTSEWbgHVR,KHBGGEAHMAGBCBHDFHDALBCE..BACBdFAHZEEBSDGChAAA.EGHDgGGEhAAA.HDAERDEDXAEBhABAeDHDAADCaBABfBBCYAHHDBEF..hAHA......hAIA...,1,-5,-31,26
fMAHIKYCWVULgXJQcadPOEGZNeBSbDFTR,HDAGKHBGCCDA.VFDCLDAB..JCGDaFHHOHFC.ZBBEBAEChAAADAIF.RABHMIFAAIDA..hABAIHAAUDGDQFEChADAdADBEAAH.eAFF.SAHBhBAA......hBBA...,1,-20,-22,2
EAgHKGeQVdMZUPbRDBXWaIScNCTYFJfOL,HDAGKHAEQCEGMIDCZBGBUFDHRCAD.DBGHBFAG.aGHH...hAAASBACCGGBTBCHFFAFhABAOFFHACIB.gCGHhAAAeACE.dDCE.PAEE.XGCBhABA....hACA...,1,-20,-21,1
ZXRGFMNEBgQVYaJbCPAfOWKeSIDdULcHT,OGEAeCCHDCACdDECLCHBHBAAZEAEGGEFMBIB.EGBDBGBB.QADEhAAAaAECCAAC.AEHHKGDDhABASGCB.hACAIEEH........hACA......hADA...,1,-22,-30,8
IMHcRJGgDdaTALBPNXUfCFeQObVEYKWSZ,LAFBBFDG.XEEHCCBHFEBG..QFFDOCHB.EAFCKACGhAAA.ZFBFHACHJDDBDEIBhABAdAAEADHC...NIAF.fCABhACAeEAD.YEAFSEFCMCCEhAEA...RGFA.aGCC.hAHA...,1,-18,-23,5
DbAgYZcPLNeJdfaFGIUVTSWXCOKHBEMRQ,ZAADLGEAeDDBdEAAFCCGUFAF..TGCBSBHF.CEFH.hAAAHCFABDHHRAFGbGFEAIHE.hABA....cACEhAAAPCAF..JFFEfDECIHAG.XGCDhACA.EACAMIEEhADADFIF..,1,2,-40,42
ORSbdKZcJUXICPaeGTFNHWEYQMDLAVBgf,BFDDOGEASAEEdDCGZBAE.UCEGCEFC..eAFGFGFAHABG.hAAAECHBQBEGhABADCCHAHAC.fHDFhACAKBAD.XDGFIHEHaEAF.....hAAA......hABA...,2,-37,-18,19
eHLWPbAEXOSDMYGRTBUCdfgQNaIZJFcKV,EGDDXGGDDGBF.GBBARFEBBAFC..dFEHQCFCaACAZBFEFFAHKBCGhAAA.HDAALDEAhAAA.bECD...AIAGMEIBhABAUGGACACC.fAHA...hAFA......hAGA...,2,-26,-7,19
SFHeQbOXVJGKTDWBMCRZfgNIULdPcEYaA,SEHBFDBDeDGH.OECDJADC..KHGETCBHBAAB..RDEH.fEFDhAAA.gAFAhABAICACdGAGhACAcDAHaGDC..AICA.QABD.XFFChADADCCECCHB.NEEE..hAGA...,1,-6,-39,33
STKcZYAWBIVJDPNdbGgEaQXOCFRMLeUfH,BFDGVFDF.JAAC..DBFDdDAFGDBE.EGHBXFFC.FBGChADALBGD..hAAAfBEASACHhABATFAGKCABcEEFAIFA.IGAD.hAEANAIC.bDEA.aHAC.CGHAMAFEhBAA.,2,-39,-15,24
DfXOFegYGMREaZQATIBLcJHCSKUPNVdbW,BHHGLEEGHCGFKADHUCBG..VAAFdFACDFCGOGBAeAEBGCDDhAAAEGFA.ZDAAAFIB.TAGDhACAJAAA...PGEChADANIAD...fGAEFGCC.MEIHhAFAQEEC.CDACSBGFhADA,1,-13,-15,2
KJXDTNPYECgIFdWRUBVHQALSaGZcfebMO,LEGHGACBZCAGeHBAOEECKAHH..JBBETFAE....hAAANAAC.ECEC.CHGEIGEBhABAFDEFdECERBEEBFAB.hACA............hADA......hAFA...,2,-34,-31,3
IXcUOCAYbZQTRNPSGfdWEVKLMDgHFJeBa,ZAADTCCBRDCC..SGGEdCGHEEAD.KCCEDECF.HEFFFGEHBDHAhAAAICAF..UAGEhADAAHIDQAGBGEAE.hAEAfHAB.LAAE..hAEA......hAFA...,2,-31,-19,12
HKISfMLEWRbeGJYFPUcVQgDaCBdZOATNX,TCGCHEFHSAAA.MDAHLCBBEGBCRCCH.bBDCGBEFhAAAFAGGUFGA.QFDAhAAADIFAaEHDdEECAFAFNIEBKHDCIAEDhABA.fDED...hABA......hADA...,1,-4,-7,3
WBGXHZMTKYLcNSDFVEAdeIaRPJgbOQUfC,eCCHaCFC.RGFE...JDAEOHAEUGAD.CEEDGAACHECDZGFG.KEHDLCGBhAAA...hAAASAFEVAFEEBAAACCEhABAIDFG.PAEBQEEC.hACABADG....hACA...,1,-16,-18,2
XWVHZRBUMOSgdAJNaPCFGbEKDfYeTIQcL,aDCDFEGDEDBE..KEHHDGCGeAHH..QAEGLBBAXBFBhAAAHGEABBCEUGFESGAFhAAAAACA.NBICCEDHGEAEhABA..fBACIEEG...hAEA......hAFA...,1,-26,-28,2
PYeTJCQMdNEbHOZaKFUIVGRLASWXBDgfc,XGBCBAEDDDDH......fBAHcDBH.eEHDJADFMIDGhAAAEEEHHAGH.ZGAGhAAAKFGHIGFEVDECLAFEhABAAHHHSDBBWACD.YCCCCCGB.hAEANICF.aGHD....hBAA...,2,-23,-10,13
DSdRafFLEMWYZOJIgVABUQcNHGXCTPKbe,QABHHAADGBEECFHB.TDGDKDAA.DIDAdFCCRDBC.FAGC.LDDBhAAAMAFEZGCEOGEE.hAAAJFABIGHH.hABAACGABBHENICD.XACF....hBEA......hBGA...,2,-26,-11,15
ZgUfCYWIaTdEQGDSHcONVFBbReMXJKPAL,LFBBUFDHCCHB...ICACaAAF.dAFBEAEGQDDChAAAGDEBDFIFHFDC.NIEBBDBAhABAeEBHMACFKBHBAGHG.fDAAhADA...WHDATABCSGADhAGA...hADA...,1,-20,-22,2
HBNPGIKYJcXWULaTRAEdfSMDOeZbCVFQg,EAFBdAFBMEDADEDG.ZEFECEGG...FABDQBCEBBDAGEAEKDAGJFHDhAAA.....XFCFhABAUGGHaFDHAGAGOHBChACAeAHH..........hADA......hAEA...,2,-38,-28,10
dMDbTJGXNAHcFIPBLYKRgZCWfeaVQESUO,HDAGFHBGBEDCLAGFRCGD.CHGEeFDEQEADEHBC.UAEDMCCCDIGAhAAAJFAD..GCADhABAXAAFAGGA..IEFBhACAKADC..........hADA......hAFA...,1,-17,-32,15
ZLPSgFHRJATbWfGDOQBMVEcYaXIeNKUCd,TCBC..bDEDGEFGDFADBCCBMFEH.EAFCaHGA..IFCFhAAAKGBDdAADZBFHLCHFhABASDBHFACCRFABABBBOAEHhABA..........hADA......hAFA...,1,-7,-38,31
SeXaVGcIZHWFTfKLUPMgJObBEAdRNQDYC,dCFCQFDHDFGC.CCHH.eCBH..VAEGGABDZAACHDAB.hAAAFHGAKAGBLDDEhABAMIAGgGGBOHAE.hACAEECHAEIH.RGDA.SHEGaCAB..IGAAhABAfFFB..hADA...,2,-15,-13,2
fUNZMXCHTAdgBWJQFbKGeILYESPaRODVc,BFEDJDAC.FAGBKBFGGEAALABC..ECCD..aHEADGGE..hAAAVGAAUADH.MBAFhABACFECAFDB.dDGB..QFGEhAAAIHFESHCEODDG.fECEhACANAIE...hAFA...,1,-28,-37,9
dgIRMLFVUafKQNBCcGTJOXPEbYeHWDZSA,dHBHRAADLGFCUBDEKGEHBEAG.GBEGOBFCECGG..eCAHDEBCAEEDhAAAMAAC..FADBaEGAhAEAQGAF.hAFACHHD.cGGD........hAGA......hAHA...,2,-38,-25,13
TbZXBWHMYLCAdDfRgQGIPFUJeKcONaSEV,dHFHRFDGQCBCGCBFFEEEUCGDKADC...OHFCaCAH..EBHBTACChAAAZFCF.BGBFMAGDhAAACAEEAFFCDBBG..fAGHhABAIEHFeFBB.SGHBhABA......hACA...,1,-20,-26,6
efRWgJFUZQPAMBLcIHXNEOYdbDKTVCSaG,LHAGHAADXAFCODADdEDGKAED..TFGECBCFGEDHRCFG..hAAA.JCFEFEAFZGEEAADCMIBGhAAABFCD.IEFBhACAEAGEDCDD....SABCaAHFWEBH...hAGA......hBDA...,2,-23,-12,11
BQIOVcZgaCTGWFRNLKeEDXMYfJAUdbSPH,dGFCSHBGBDBEQGADOEFH.ZAGBCCGGGBAH.FEHHRECFKHGChAAAEBGE.DBEG.MABEhAFAfEBF.AABFbFAChAAAIEHE..gADE.hAGA......hBAA...,2,-38,-13,25
SdCMDZcaAOURFLbVYPNgWTIBGfQXHEeKJ,UAEGRDEDFAEGLAHH..bFGB..VCBE..PGBGhAAA..NCAG.TDCFhABAIHBEBHAE..fGDAhAAAXCFEEAGCKGGFSCGFhABAMFFFDCADcABDABBH...hACA...,1,-19,-33,14
IgLGfRZbVDPUQASOcFEYCXTaNMWJHBdeK,OCCHFAFBECGG...XFEDaFEF.MBHFJEADHDCH.BBDDhAAAeGBCKGGGIAAChACALABBfGGBhADA.ZBDHDIGAPAEAUEGFAICC.....hAIA......hBCA...,2,-24,-22,2
TRBONLMKZbQeVdGSHcXfDJPWAIEYUCgFa,EHBGCHHGFBFHRAFB..BCDHLECHZFDE..QABHdFFHHBAG...hAAAXDFCfFAEhABADEAG.JAHFAHFA..IFAEhAAA..YFEFaEHD.OBDDhACA.MADAKAHB...hABA...,2,-31,-18,13
fdLVXPDcZHEYgbKWUOIMFNSBJReQaTACG,CECDdGAHLAAC..XAEDDIACHCGDEAAC....YBDBhAEAKFDAODFA.IHFDhAAAMFGHSAGGhAFABCBAeDABTBBGAGGAfDCHPFEDcGCChAHA....hAIA...,1,-28,-33,5
XMQIYPVaOTcRSZNGFbCeLDUdHgJKAfWEB,EHBGMEEC..QGDB..YAAEPAGH..OCCBhAAATBEDSEGAhABAGEAFbFFHCBDHDGIBUCBHdDEChACAJHBEAADDBEAE.IGGGaAEG...hAHA.cBGE.NEIE.hAIALAHH.,2,-6,-5,1
ABRJMDWUZcHXSgEdGPVCLFbYOeTfQaNKI,BEFAMAGDUECEHEDBXAAF.EGCDdBDB.PAAGLEADhADAFGHB.ODEG.fGHGhAEANEFAKEAG.IBFGhAFAADIFDHBE.ZCBB.SHFG.hAEA......hAFA...,1,-2,-43,41
DIgSVGNWAYUHCLPEMaTcJKOZBXFefdbQR,HEFHCAFBLFECMBEBaFCC..JBBCZCAGBHDDFAFGdBAD..RCDADGCBhAAAIHDE.SCHHhAAAVDAH...hABA.NAIA.ADFEPEAD.EFHFKGHB.XGEEhACAfAHC..hABA...,1,-19,-35,16
aBQCLeUHDWdIFYRZAKEOMNGcbgfPXSJTV,KEEDMEGFGCEH..bDCH..fADGSHFGJCBDTDABhAAAaAFB.BADGLHBEhAAAUBGCDCFHIBAFhABAFGAC.RGFCAFGHEEHD.cBAA.....hACA......hAEA...,2,-21,-16,5
XPNGaWVFLOCeAfEBgUSQdbMKDIZTYJRcH,BFEDSGFCdHADKGFADDCCZAEA....JBECRCBAHDEE..XBAFhAAA.PDABhABAaECDFAAHLEEChACAODAHAIEEfGAAEEHF......hADA......hAEA...,1,-28,-40,12
GZgDVaWRPdAETIeMfbKSBYQXJFLNUCcOH,TGBCMDEBKCAF.BEHFQABE.JAGDLGAC.CFFGHAFGhAAAGCEEDGIDaGGFRCBFAHGChABAIHFF.fEAChAAASDFCFADENIAFOBBA..hACA......hADA...,1,-16,-28,12
YEFDSPRTOUWgKXcdNVaZJCBMGLHfbIAQe,QDACEDCDDGEA.SBCBREAHUAFE.KFFBdBDA..aBHBCDGFBHEAhAAALFCHHEFCfDEGhAAAACCC.FFHB.hABA............hACA......hADA...,1,-26,-40,14
JWVDANRGSYcaPbKMTEFZUgBdILfOXCHQe,REBHSGAH..aDGHKEDETAFEEFFFUAFCBBBHLDHFhAAA.OBBACCDG.eDAChABAWFDHAIEA..NECE..hAAA.cGGAMFDF........hABA......hACA.ZEEF.,2,-43,-15,28
OGAKNYbBSLJCfRIZQaTVdPecUWgFDXEMH,KHBG..bCAALACCCACG.RGDEQDBBaDFCdAAE.eDFFUAGGhADA.FGDEXAAHhAAAEFBCOHFCNAHGBGAB.fBFAhAGAIAEC........hAIA......hBAA...,1,-20,-25,5
HZAYEOBVCNDaXKgFGIbQePSRMcWdfLUTJ,OCCHCDCFDDEH.KCGDFGHDGEGC..QADASAEDMAIDhAAAdFECLAAC.hABAJFBFZBFHABBHBAGDNGAHaDAF.hACA.....gFFF.IHAHhADA...hAFA...,2,-35,-31,4
BCRePJGDOUfHLSKFWVAIYNcXdgQbaTZEM,..IFDGNDDG.dCFEQBGC.TEEAEAACCEHEeADBhAAAJHFEGADCUFFDLHAChAEAKABBFHAAAFBE.XAGAhAFAaDAEBGEDDIGA.fDCASAAD..hABA......hADA...,1,-17,-21,4
bBaMgLHPNUWDTCEFReJVOZGdIAXYKQcfS,KGFCQCBC.SACCbBAFBGED.MEDGHCDB.UEAHTAEHhAAACCCF.FGFHeADCJDHDOHBAhABAdHBHAAAE.XAGFhBAA..cDGF...aAHB.hBBA......hBDA...,2,-24,-20,4
RZVYBGJXITfANgbMWEaFSOHQCdPecLDUK,...bCAAMHFG.aEGHFFFAHAFECHEH.eEBEDAACKEAERCCGZABC.BCHBhAAAJDFG...XGDBhACATAFC.AFID..WDADhADAEFDGSGHH.dAHA...cABEhAEALHAEUFAF.hAEA...,1,-10,-19,9
HYJDdGXTIAZfNMLbgPcVROeWFQBaEUSCK,ZAADMCCALFDB..PHAGVFFHeEABQEBEBCFAEDHFhAAASFEA.CCBGKHGGhAAAJDCADECFdEFBTBGHhABAAIAG..fAHENBBB.gACAhADAOCAH....hAFA...,2,-23,-13,10
CVgYINQEZcGPUHBROJdLTFWfeDKSaMXbA,VDBH..IHHGEFFG.ZCGBGGDFUGCGBCBAJAAELAGDhAAAFCEAeAAESHBGhAEA.MEFAABGEYEBGhADAcBDG..........hAEA......hAFA.HFEBOFAB,1,-5,-26,21
AeTLdWcUDCRXbYEaIBJHQgKPNOMfGSFVZ,eFCATGGDdBGH.UCDECHAB..RAAC...XCABEEACBHEAQFGFhAAAKDGCOGBAMIEEhABAGBDDFHBA.AAIHLDAChAAADHEGaAFG.JEEAPEAB...fDFBhACA...hABA...,1,-10,-21,11
gcXOIFGDWVaNAUPMRdbKfTBQZCLJSYEHe,MFFFRDAGdFHEKCGGBCGD.ZACGLEEH..JAHFSBAFhAAAEAABHGBG.eHAE.XAFFhABAFCEFDCADaHGA.AGAF.hABAbBCAQDCG.CEAA....gEGFhACA..hADA...,2,-22,-22,0
PfVRgUdeYDMTSZWALFbCOQBJGIHNKacEX,FDCDCAFBBAACGADGHEAHKEFG..EEFA..XBGBVBCC.UGDAhAAAeFDHDGGAMDFC.SHAAhACAAHAFLDBFQFGAhADAIABD.cAGD....hAEA......hAHA...,2,-32,-18,14
BTCcAUKPZVDLISOWXEHfdaYMJebgQRGFN,KGFCZGFGDDBHLBEE.OFEHEEFEHAEHdDFE.MCAA..bFAARDDBFAAGhADA.BBHFCBCGADIH.UGAChAEA...IDHGhAGASHAG.WCAD.aABA.eHFAhAAA......hAEA...,2,-35,-19,16
ZdYRTfMKAQeXcOVFGJLNWEHIUgCaBbSDP,QDCHeDACOEFAFAGCLCEF.EAGCICAF.UCGDhAAAaACABFBDDAFFZFDEdGHChAAARABGMFHHAIDCXABChAFAGEAEJGCE..........hAGA......hBAA...,1,-15,-20,5
ZVdHaOKgNbMLQIAJUXeDfTcESGPCYWRFB,JDCHUDCH.eHBCDIGE.....TGFHEAEGGAGACDFC.REFFZABChAAAdBHAaEGF.KAEH..hAAAbGAGMFIHLCABhACAAADFXBAB.fGAHcDDASGDHhADA....hAGA...,2,-22,-21,1
SAWadVLOJPeQBfXKEcNbFDUIRZMTCHGgY,aAFBdDBDOFFH..eDGHQGBGXBGEKEGAEEAA..NAAF.hAFAFACD.UFDGZBFDCCCF.hAAA.gGBDhABASGGBAIHALDDEBEDH......hACA.cFGDDBBGMAIFhAGA...,1,-7,-32,25
NBJPYFEDZKOgRCQdGfeaHSLXUVcTIWAMb,MCCABFDGJCBCFGDCZEDC..KAHBRBGF..dDADeFHFHAAALDAFhAAA.UCFBVFAF.IGHDhAAAAHFE..NBAD.hABAEAFCDECHCDDB.....fEEEhACA......hADA...,1,-14,-44,30
PMOVLHIbYKXSFeTGdCNWUaAQDZgBfRcEJ,QFCAZFDGBBHCRFAB.JGFG..OACCLBGFHBAE..IACBhAAAKEHBFECCGCDFhAAACHAAUCCFABEADGHH..fEAChABAEHEE.MCIH......hAEA......hAFA...,2,-32,-21,11
LAeCKDgJaXBdENHQVYFZfGRTOIbUPMWSc,KDABDEFH..JCBGBFGC.EFBFQCGB.FHGEfFDDhAAA.GCCBODABhAAAIADGUEGHPHCGhABASHDGAHBF.gAGB.aAFHhABAXEBEdGHA.NACF.hAHA...,1,-21,-39,18
ICbBHOVWdLATaQeYMKRGZDFUJPNXESfcg,TFCAaGDD..eEAAMBEBRBGDZGFA.DADEFFFA.JAFB..XBBAhAAASACH.fBAAhAAAIGBABDFFhABAOEAGdEEDAIHEKHEA.PAHFEBEA.CGHA..hACA......hAGA...,1,-20,-26,6
DRCUJYZXNgeOcPfMHBLEATGKVQFaISbWd,GCEBQCCBFFGF.aHCGSAED.dCAGRFFDJADEZABH.XBABhAAAeHEGOFAA.hABA.fBHGhACABBHBLHAAEDFEAHFH.KEEFIFCE...hAAA......hADA...,1,-17,-19,2
FOBbGSQVRCaTJXEAfKPgUHLMWNIeYZdDc,KHBGUCBCLBHDMIFA.....ICDHeHBCdBFFDGFGOCFFhAAABHHEGDACSFEGhABARFDBCABH.JFAG.AACC.fDFAhAAA.PADAWABA..NDIG..hABA......hAHA...,2,-34,-28,6
XFIEaeOgZTfYKDQcbJdMGALNSWHBCURVP,SDCDBFDDRAAB..VACGXAEA.EEGFaFFH..eCAHhAAAZCGB.TDDAKGABDIEGbACBhABAMFCBLHBE.hAAANAIECHGCFAGC...IDDHfCGA.hACA.cGGF..hAFA...,1,2,-38,40
fEFUMSCcBLAWPVbDXeKgOTZIdQYJGaNHR,VAADDAFBKAGH..OFCAZDDCdDBG..JHFAGGAB.HEGBECEFMFBBhAAACAAEBBCG.AACE..hACA.PHCEeHDA.ICHAhADA...aFGCNAIE.RAFC..fADAhAFA...hAEA.FFDAcDGH,1,-13,-27,14
AbGKaWdJLZFUOVYefMgXSBEQDPNCIcRHT,KGAHaAFB.dFECZCDHFDBBUDBG..OACC..eHFEMDFCSABBhAAABGGG.EBGCDAGGhAAACADC...IHCGhABARGBCAEGC...WCCB......hACA......hAEA...,2,-52,-31,21
GAVTKSLOYCUNfFDXEPRbdZceJgQBWMHIa,KDAFLFFBOHFGCAFEUBAA..FGBCEEBARAAFdEGA.ZBFCeCHH.hAAAQBEDBFDCMCCFhACAaHAC.AAAE..TFDHhACASEEB.NIAD.fHCB.hADADBHF.....hAEA...,2,-35,-16,19
BJPOeUSgQbFaWEdDCHXMTAIKcVZNYRfLG,KHBGVGFGZAFB.RAAB.GBDCBDAG...OHAAUFGA.QBAHhAAAFDDB.aAGAdFAGDDIBCFEH.hAAAHBFD.MDBDAEHC.hACA............hADA......hAEA...,2,-48,-10,38
AWdNYSEZVDHXIaPUBgOceCLRGfKJFQTbM,dHBHSHBGEFGDZCFCHCBD..aDCBUABDOFHFCGEB.RBEHKGEDQFBBhAAAMAAC.ABEC.NAIG.hAEADIGE...IAGBhACAPCGFBFAG..eEHBfBCBhAFAFEEG.....hAEA...,1,-13,-21,8
VAQgcFHULRKJMPaWXfGTCYENeDdZISBOb,QCBCFHBGLBDFRCFEKHCEMDFB..aHGA..XBGFGECFCAFEhAAAEHEADDABdFCB.SCBBhAAABHBD.ODADhABAAHAD...gGGBcACA...hABA......hAEA...,2,-35,-17,18
MgANEHRDXJIFQVZBKCePLdSYUcTWGbfOa,ECFCDDGB..JEHHFEGC.ZECAKEAC..eHDELGBCdACDUGAB..hAAATAACGBAEOCAEhAAAaGGCMAFE.ADDB.HAFAhACA.IDEF.BHHD...hABA......hADA...,1,-18,-34,16
aRPdIFJXNUBZVAYCQTSKLODEgGHbfWecM,QGGGSFHBLDBFEBEGGDCHHGEE..fCAGhAAAeAFHMCBGaHCGdDGH.FAAEhAAAXDGHBAEHAIAETDDAhADADABGWFAA.RBBEIAHHJHBA...hAEA......hAHA...,1,0,-8,8
PBAQfGELbeHMdgXKRCaFNDWVTOYIZSJUc,QFGHEGAHLEEFeCBHMDGFdEGF.KACAaDBGFCGG..DIEEVGAGhAAAOCHH.ZADCSAFChABAUAAABCEDfFDDhACAbEAE.XDDE...NIDB.hAEA......hAIA...,2,-17,-16,1
DHgKSUWObFTIPAeJQaNRdVCBMfXZLYcEG,eFCAQAADRCAD.CDGCBHHGMBIBZDDC.LCCEEADBDDCEKHBESHGAhAAA.OAGFhABAFAFCTEGGAAFB.aEAEhAAANIADdACF..XFEHYGAA.cFGEhAGA.....hACA...,1,-3,-39,36
OfaBXTJbgLWVHDYKGMUIAQNRdcSPFEZCe,REFHdAFB.SFFEFECEEGBA.ZCFE..eBFCOCDHBADA.JHCELCBFhAAA.WEHBhABADAFCGBAA.MIFAhAAAAHHHQGCA.NEAACACHfCEEhABAaGBHXGEA...hACA...,2,-34,-11,23
TWBbMYJHDPEIdLcgaUCfGOQFeAVZKSXRN,ZDDFSFAARAAF..TGCBBEBFMIFAHAGFEADBdAACLEEGhACA...cGDDhADAUEAGfFHEhAAAGAEHFHAGAHGAKGFG.WAFFYCCEDIAE.PDEAhAEA.....hACA...,2,-21,-8,13
HOFZASDMPefcCXWLUNBGaTKYbIdRJQEgV,MBHHeGEACDDGLBCB.BEFATAAEKBAD...IBDChAAARGDGJGAE.QCFFhACAEBED.gFBEhADAOEACAEECDDIBfAGB.XEGENAAFaGGF.hAFA......hAGA...,2,-30,-13,17
YUQHWfOAFbIcLNRBXGZCJMEgaTPSVDdeK,FHBG..IFDDLABCRCBABAHDGEDFZFFACBCGEGDE..TAEEhAAASDBHDCGCeHDAhABAKAHD...UGACWHDAhAAAAADH....NEEBMCAFaGABPAFF..hAFA......hAIA...,2,-28,-20,8
ZTcaSNeFbWYGERIfgMDLdOBXACJKHVUPQ,KDABVBCDQEGB.ZEDDaFFG.eGBCFHBC....bBGBYDADhAAAGABHEGHFIHHAhABA..fCDHhAAADHDELBFFBCACAEEDHBGF...hABA......hACA...,2,-21,-14,7
dLPHgJSQCceDUbIBTZfGaOMFXWVNYKERA,LCCHHAADJADB.SGEACBGB.DEAGUEFCBEFAZFAFGADDhAAAMDEG.FHAE..VGCAhAAANIEF..KDHFAHIB.dBAA.hACA............hADA......hAFA...,1,-29,-34,5
IEMZCUSdQLNbecgJHWKfBOTaDFGVAPXYR,XCBCRAADMEAE.UDGCQGEG.LFCHeAFFJHAAKAHFBAEChAAAaACG.GEDE.hAAAAGHE.IEHECGGGdABB.hAHANAFE....cGAG...WAGDhAIAfECA..hAIA.DCCEFHGE,2,-31,-11,20
NLDfeYgAJbMOREXBGPaCTKZHWSVQFUcId,MDEBODCHRDFE.BAHDGACG..aHEECHAEKAFGHADA...SDGEhAAAFHGEUBAEdEBGDABGeEDGhAFAAGGA.EGGEXGCDhAAATGCC.......WFFFQBBDhAGA...hABA...,2,-30,-12,18
UPXCMIedDZTWRAcHLFaVfKGNOSYBbEJQg,HFDFLEGHVBBEKAGGGAEFOAEDBCGH.EDEDQCCDhAAA.UGAHCDACeFAHDFEATGDEhABA.AEAA.aABGhAAASBCCYFGB.......hAEA......hAFA...,1,-16,-24,8
dTMAKgHfaEXDOLZVIRcCUWJFNSPeBbGQY,KCFCHAADEDBBXGAH.LFGDZFDFIDHGRCCEUFCG.FAGBSCDGhAAABFEH.QGBChABATADEAFABfCGHhAAADGGGOADECACCNEIE.bEEB.....hACA......hADA...,2,-21,-9,12
KOLAIEPNcYGeCgUHRJDSVZdfWTXQbFaMB,EHBG..PDEH..NEIEGCDBCABGUDGERADEDGFH.ZACGdGGC..hAAATEFE..bCAAhACAaDADKGAF.ACGA.IHGHhAAA..eFAGgECBSGEHhADAfAHG..hABA...,2,-32,-22,10
efbHWMPJVcSNgOZBAdaCQFRIGYDLUTEKX,dEHAaFFB.CFEH.RCCB.GBEDDAAF.LEBCUGAA.KHBEeCBDHABD.MBADhAAAJAFD...SGAChABAOEFAADGCFGHDIHHEhADA.EGFFfADE...hAEAPAHF...hAFA...,1,-15,-31,16
FOZJPATHDUYIMLcESVbCgNRBfedWaKQXG,TFCAHFEEUCDB.MHBCECDG...SDBHCAHHREEGBABEdDACKDGEQAAFhABA.hAAAFAHFJHEADGABIHAChADALADE..cBBC.....hBEA......hBFA...,2,-32,-20,12
HRAINfBTMEWVFdJXPUcDKGebLSYaZgCOQ,..IFDGBADGEDCHFFABdBFH...JCADXGFE.UACGhAAAKEHFeGBGLCFFSFFFhAAAaHDCCHBG.QGGBhABAABAC.fHABTCGF.MACFhAEA......hAFA...,1,-29,-39,10
fTNIHgcObZDLXeQdCYAGVKBJaWUFESMRP,VCCHJCAF..UDECFGAG...MGEARFEA..TDGAHGACOABFhAAADCAELAAE.QBEBhAEACDGHACFEKEHB.BHHEhAFAEBGE.SHCE..fDCAhABA.NIDF...hADA...,1,-18,-35,17
XBKNgPbAVUfHQeSCWGEMFLcJaROYITZdD,UFDHQFDHeDCC.SDBDCAHB.EBCDLCHB.aBAEhAAAYAEG.TCGAhAAADADCKBFB.gGGGhABAbFFFAABFfCEA..WDBDMFAHhACAcGAC...hADA...,2,-33,-21,12
UTPeaJBQWXELMRdAGFHDSZNKbgOcCIVYf,FCAHDGDEZDCGKCGD...OHFECEDH....IABEVCGBUBAAhAAA..eGBCBHAFXFGFhAAAEBEF.MCCEhADAAGHCSAGG.......hAEA.NAIEgAFEhAHAfACBaGCC.,2,-38,-35,3
TCEcKFeYGHMQaNJBIgPDVUOfXZWRLSdbA,TGAFEEGDKFBB..FDCEGBDC.QDGDaEHFBDAF...IGDBhAAADCBEOACGfFFEhABAZBFCRFDC.SEAAhACAAHBBCAHF.cAGH.eACF.MBBBhAEA.NIDF....hAAA...,1,5,-41,46
MEGReXLbdFfJWBOaZcHSICTVDYNAKQPgU,QGBCUCBCEHCGGCFGeEBELAAF.dGEFfFAHhAAABFAFaDGBZBCGSHGAhABA.IADGhACACHHEDBCCAIEAKAHBPBHD.RAEFXDDD..hAGA......hAHA...,2,-21,-13,8
INVFfLcCEZYOARJHgPGWDdSXebaUBMTKQ,RDBGJFBBHGACGADADAIBdAAB..SHDEeAED.UDGHMDIFKFGGhAAAQFFC.hABANAGG.fCAChACALHEACFAE...........hADA.YAHDABBB.hADAWBBH.,1,-8,-45,37
DBbQKNgFLOUJRYAPEeSXMcZVCHGTWafId,eCCHXAEDMAAFZGAEHGFEGCAH..TBGEaFGH.dDGHDABCQFBBhABAKEHFFAGG.LEAFhACAJEEBABCE.SFGEhADACDFE.fBBABEBDNICD...hAAA......hAEA...,1,2,-25,27
cDGTRIbXYfQHaLdEgNKPWVFUMZACeSJOB,SDABJEGHBBAB.DGBERECG.....bAFBXGCC..hAAAQEDFHBDFaBGDdFAAhABAEAAFNAEEKCAD..PHEChAAA.FBCDMDIHAHDGeBHF...cGGAhACA....hADA...,1,-22,-31,9
BKNZRPMcgaLSGDAFeVTQYfUdIWHJEXCOb,FDBDVAEGQGFG.UGAHdAHAIBBCHADH..XAAGhABAOCEBBEGCKBGAZDGHhACAMEAAaDDCLFDFhADADGHBAHFDeGDC..........hAAA......hABA...,1,-3,-42,39
PCYFMdcIJKZOBELHeXRTgfDAbWNaVSQGU,...NCCA.aEHB.SAGBQEGAUCBCCFEB.FGFCMBAB.dAHChAAAJFBEKBCEBACFHGEGRAEB.hAAATBEFDBIB.AGAB..hABAbFAD..WHDG.......hABA......hACA...,2,-36,-18,18
IaEcQJPBFLSOWZHTGYKdXRbfgUeAMCDVN,CFGAVFDG..aADDEAEC..JCEDBCDF.FDHBLBGH.SCAEhAAAZBABTBFBGGDFhABAKAHBdHADRFACbDAEfDFEhAAA.eEAADEIDNIAF..IHGEhABA.....hACA...,2,-24,-13,11
PSKIgNDCLcfZOMJBXYQTFWVdeHaREbAGU,UAGHSAFBKCED.....NCFALBCFfGFEZGEEMDAFhAAAJEDBBAAC.QADChACATBBHFGDFVCGFhAHAdEFHeEBE.aFBB.......hAIA......hBBA...,2,-27,-23,4
MZOSFLYDeNQPURXHEfVcdKTBGaCbIgJAW,MECGZDEDFAFGDGDG..eHDAQAEFRDGD.EEHDVACD.KCABBACDhAAA.aDAHCHBA.IHCFhABAAAID..SEAGhAAAYBHHNDDB...XFFDfBHEhABA.....hADA...,2,-33,-31,2
fdJOgKBLFeVIUQbRAHXESPcCMYTDaGZWN,EDAFSHBG.CEFD.TEGBGBEDZADG...fFDGhAAAOCDBgDAFhAAAKBBHBHHDeHCGUGGEbACCAIBAXBFAhABAMEEDDAGGNECBJFFFFDHB......hACA......hADA...,2,-17,-7,10
JeWMHfQTYSBgIKVGNDdAECFcRLaOXZUbP,EEHBFEGDRBACLABE.OBFFZEDDUEAD..JFFDMAAEHFBAQBEAhAEASEDABHCGhAFAKHGAVCBCDIGGADDD.CBHCaFABhAAA...........hAGA......hAHA.PAHD.,1,-7,-30,23
dGPHXSEDYLKNQABIfVZceWTMROaJCFbgU,BFDGVAAD.ZFGB.eEFFMDEB..OADACHHGFEBE.UBBGGAFCHDCChAAAEGFFDIBA..LEADhAAAKBGAACAC..IDHFhABAcADD..WDHDaGBC......hACA......hADA...,1,-24,-27,3
SKYcRbTUVOJLGdMIFEDPfZXHNWCageABQ,BFCFSFHBKBFHREFH.UCBB..JDAEdEFA.MBAEFADD...DFBGhAAAZEDBHAFF.CEEDeHEGhABAAHBG...YHAGhACAbAGB..TAAFOAEB.LBHBhADAEFHF.XFAChAFA..NICH,2,-48,-9,39
AYLDfXJZGQICSVUgTbNaOHKWMRdcFEeBP,LFCHDAFB.XAECJBGBZCAAGGBH..CGHBSDABhAAAUECD.TCEDhABAaGHBKBCGMEEHdAAFFEAFBCHFhACA.AAHAfGAA.IBBEhADA......hAFA...,1,-30,-37,7
KDNeFHSPXVIULYQJfgGdOZcBARECMbTWa,CCAHTFDBKGEE..DCDHFCCD.HAAC.SHFGXDGC.IBEDhAAAUEABLBEGhAAA.QGADhABAJEAHgCGE.OFFGBHFAAACCMIBAaFDG.NADF.hABA......hAIA...,2,-36,-18,18
EcObaKTSCZIHDNGQBPWMVfJRgALeFdXUY,FAABdEHAUDBEEEFG..OBDAKAGG..SCAFCCCDHFABGAGEhACABABA.MADE.JGDARBEEADEEhAAA.eFAD..XGGDhAIA.bECCTGECDEIB.PEEChABA......hADA...,1,-4,-38,34
UPSLIdCXKeTBGZEaVYJMcDWHNgAbOFRQf,FDCDQFDHUGEGLAHBCAFC..eCDFBACBGAACZBCG.EBGDhAAAaEECJEHB..DABFNIDF.hACAAHGG...OCFBhADARFAG.SHAAIEHFdHBDXEAA.hAAA......hAEA...,2,-33,-5,28
QADZcUVMgKIOTLNedPRYHWCaEfSbGXFBJ,ZFDGVEFHMBEB.KCHDOCEE.LFCHeAACdDCGRFAFHABA.hAAACHEF.EGAH.SAGChAEAXAFABHHCAIHADFHH.hAFA...gDEHIDCDNAAE...hBCA......hBDA...,2,-28,-15,13
AEBLKCNUHaGRQZgPcYeWfOJITSdVbXDFM,LCAFCFEDHBCBRCFEZAFE..gCDG..PCAFeGAAOFGBhAAATGFHSEEEhAAAdBEB.XGAGhABADCCBAEHG.BACFKGEDNABFaEHDcBGDfHCFhAEA.....hAGA...,2,-29,-5,24
dbMCXgHDRKUaYLcAFPTWeNZQBIGJfSOVE,TGBCeGEAQCDA.GDBCJAEDOEFDdEGFMBBBCFDAHAAChAAAKFDAaAGELEAE.hAAAFEHFNACHBHAC.IHHAhABASCFA.EAGA.....hAHA......hBAA...,2,-20,-12,8
THPbCgKEXUGFLISDOfaWJZNeAYBRdMVcQ,RDBHMFCFQGDGHBAECGFD.KGBFUAEC.LAHFDEFEOAHH..hAAAaDEAZAEFAHIFBEEDdGFATABFhABA..PEHHhAAAEBDF.FDAHSEEGJABA..NDDE.YDADhADA...hBAA...,1,-9,-19,10
cHDFLAUKWIPBOfdMVSNZGTaebYRXCJgEQ,KGFC..IAFBOHBAdEGBSFGDGBECeCAERBAA.JFAEQFCAhAAA.DAEFhABALAAEACHEPDBCMAIHhAEANCFE.aECA.XAFFCHFG....hBBA......hBCA...,1,-20,-25,5
NWaMUEDOQAfGSXKJYebCdcVRFHBZILTPg,SGAHXGGDKADEeCFB..dCGCVAABFFDABBBHZDBE.LHBAhAAATAFA..NICD.MCABhABADDAF.QCDAhACAGEGE.JDBF.CAHD........hAAA......hACA...,1,-20,-21,1
FRUHTXMBLeAEOISbNGKWPcVDZQYaCgdJf,OCCHSHBGGAEGKACG.....PEAHDGAHZCEG.aFAACGEEdDGEhAAAFFEBHBAEMFIBLBAEhABAEDHF.IHCHhACANAEH..VGFA......hAAA......hABA...,1,-20,-23,3
FdURSAKBIGYLeTXOgcPaZCEbVDQMHJfWN,BFEDGAFELEAFeEFAOBBA..PADAaHDAZDDD.CCAG.bCFBhAAADIBA.HDAC..hAAAfDBDFHGAdFAA.hABASBAF.IEHD.TGGGhABA.cGBAhACA...,2,-43,-7,36
YAIKeNHSbfZJBgROdTQEVPWFGUXCLMcaD,eCCHHDAGSACDZGFEBGBGRAAC.OGAA.dEEHQEEFhAAAEGDHVADE.FBFA..UGGChAAACHDEMEAHDBAHADFDKADCNBHG..hABA.fDGB......hAGA......hAHA...,2,-27,-8,19
cZLeEIHXJKbQTCVDGMNWFBPaSUdfOAYRg,RAADZAADEGAAHDCC.XGACKCEB..TGFGDAEHGDGE.MAFChAAAFHCGaAFAUGDC.dCGBhADAOFBAAFCE.gEGDhAAA.LDAA.IACAhAEA.....hBAA...,1,-16,-18,2
CDBLQUTKNgAOYfPIZEWFXHVdaMRSebcJG,OGEA..fGDBZFADEEFC.XDEAVAGD..MBAChAAASCDG.eEBGhAAAcFCBJACGDGBFBCAChABAQGGGTCEEKCCEAGCBPAFEIHHAFBBHhABA.aDHH....hACA...,1,-16,-22,6
CJZScNGLUfVITgDMFPQWOeREHBbXadAKY,CFEDJDCHZBFA.....SFFBGEFCfAFB..hAAAVCBGIEAFDFHFMCABhAAAFCCA.QFAEhABAOABCeEHBEABFBHEEaHDGAIACKBHBNIAB....hABA......hADA...,1,-25,-27,2
QINJeMFgRHSKZcWbGTPaCdVXfOYULEDBA,QCBCJGEA.eAHBMGACRAEH.HADGSEFCZDAG..bCFAhAAAPHCAdBBG.XEGEhAAAOHCELEEEhABADIACIHHE.gABE...hACA......hADA...,1,-10,-20,10
SHBZJXgLFWcCEGbAVaQTMNPYUKRdDIeOf,QCCBMFFF..PCAGUFDCdEBEeBFBSGFEBDDHZGBC.hAAAXAGBFGGE.CAACEACChACAAEBHaADG..TDGAhAFAKAHBDECH.IABFfBFA...hAGA......hAHA...,1,-16,-30,14
EZNYVACHBMgbTSJRdcIKGXFQaWUDLOfeP,BDCFMCCA...TGACSGDH.RAFBdAAFKHCAXCFBhAAAFEAAQDDCaBBC.DGFEfGFBhABAeHFA.ZEDFhACANCIA.AIFACDAD.HDGBJHAEIADFGACF..hAFA......hAHA...,1,-6,-21,15
DZJBAgREXOLbFdaQMTPfNCWSGcHIVeYKU,RDAGEGDDLEEDdDCA.MAFCTABG....fCHGhAAACBGESCGAHADBeGFEKGBFDIGGhABAJDAFBEGGXBFFhACA.FFFCPHAC.......hADA......hBAA...,1,-16,-26,10
OUQBTKVbEAZCDPXRGSIdWaeLJYgcNMfFH,CAAFDAFBRADE.GGAF.dDGHeHEALFHF..JDEA..gFEEhAAAMHBEFFACHCBDhACAOCCBBGFCKEAHEBDBAIAA.hADA.XEECICAHaAHF..YABEhAGANDIE.....hAFA...,2,-28,-13,15
RaWfMVbPHZIUETDdSgCKFGLeYOcXNABJQ,JEBEaDAF...MAIHVBBAHBCE.ZFGFUGBEDAEA.dFFG..CCGHFFFHhAAAGAGG.eAFFOGBAhABANEAE.AEHE.BHHE.hACA....WEEFfDAA.IHAGhADASACE.hAHA...,2,-36,-21,15
OSNECeYVafXUMIFdWGRJPAKbTZLgcDHBQ,TGBCZFDFLFFG.DDHDQCAD.SGHHhAAANDAE.CFGDVBFAfEBAhAAAMFAFdFEAGBBDJABGAEEGhABAgGBABECAeCCGaCGA.....hAFA......hAGA...,1,-9,-25,16
RIeMGcfXFNOPKdEJbQYgSZAVDCUBWHLTa,DAAFCFFGUCBEBGHF.LCFBRADA..eEHBMFAG.GCBH.hAAA.fAHChABAFHCCOBHHdGABEBBAQGDChACASFEGAGHB.........hADA......hAEA.WCFAaAEA,2,-30,-29,1
OQUAScHRdZIGeJLNXCYBPMVEWTFbDgKfa,SCFCHGFGZCBAGABBeBBDLBEDCHBFBHED.MIFEEEFCFFAEDHFEKCHHhAAA..aGCDOGAAhABAADFGdAHA.IAHGhACA.NFAD....XFGE...hAAA......hABA...,1,-13,-25,12
OFEKVZaeGYWHQBPLNbRSCcJDTfMgdUAIX,XDACOEGHFDDEKBCHZCAD..GFBBHGAGBBGELHBA.bCFBhAAA.....CHHGDGAHhABAfAEGdACBAIFAIDEChAFAEHEEaAGAWAAC......hAFA......hBBA...,1,-14,-38,24
BGfHQZFaYUSNVAJXOCMeTDgWbPRcEdILK,JFCAOGFA..MFIHeDDB.DCGG....bAACRBAFdFAFLHCChABAKDFCBACHGBFCHGAEhAAAFBEBaHECSGGBhACA.ABHGXDABTAEA.....hABA......hACA...,1,-16,-26,10
KQJYXWAUfbPBZaeINFVMSREdgGCHOTLDc,UCBC..fDBDBHGEaEGA.eEHHFHDE.VBFB.REEFEAEAdAGGCHBEhAAAHAAELDAFDCAHKCCChAAA.JEAB..XEDEhABA.AFBC.PHBAZACA.MAIF..hACA......hADA...,2,-34,-2,32
aZHNGeCOJIEbgRKUcBWAPYFMfVXdDTSQL,FHBGMECG..XGDDDIDGQBFGZEFEHABCeDHDCFAB..OAGDhAAAEEADRFFHKADBBGGFAIAG..hABA....fBAGhAAATDDA.SBBB.aFCDNCCEICAFhACA.gAEHhAEA,1,-18,-35,17
BcQabPMdYFCEVORDAZHgTSUKJNILeWXfG,ZGFGTFDHUAGE.KDGBJBHF..LAAC..eFBF.XACChAAAfAECcGFEhABAaDDA...PDDAhADAMBBFFGBBEAFHOEAGDEEDADCBSFFGhAEA..WFHHBGDD.hAEA...,1,-25,-28,3
EMIcRUPKDNegbfHTBVaQGCWJOAXLFZSdY,XGGDLDCHSBHFdEBE.MBFFIAAF.RBFHUFEChACAKGGFDAEH.eHAGbBCB.hADAfEGEBAGEaBHDCEADhAEAJBAB..AFIB.YEEF.EFAANIAF..hAAA......hABA...,1,-16,-30,14
OKGdMHRbFfPgBQJWVCXeaNDTZAEIUcYSL,UGBCSHBGOBBBdCDAHACHFGGE.....PEEBBFDHQEAHhAAAJDFE.VBGDhABACGHHXEACaAEATABAhADAAHFAEAHF..IFFC....hAHA......hAIA...,1,-25,-27,2
dNFRAZMLXSBgHQKIGcCDaJOfbeUYPWTEV,LAABXGAFBADGQDGGGGEBCGABDCCEODCG..eAHBhACAUAFB...PBAEhAAATDBEEDFAdGCFNCIG.FGGGhADA.AAEAMEFH.SBFFHECCKGCBIEAHhABA...hAGA...,2,-24,-2,22
AVCJaUBPFRfYQTgWDIcdHNLOebGZKMESX,VFEEaDABBFBC..FCEFRACC...QAAFTCEG.DBEAdHADLGAGhABAOFHBGECAhAAAKCCFMIBCSHEEhABAAEAAUCGE...fEFCWADC.HAGFhACA......hADA...,2,-22,-18,4
fGdJYeDSZQFAaKWNLHVMCbcTIOXRgUBPE,aAFBKHBGLDAGHCAECEHG...TBDGOAHDRFEFBGDFEGGFGGBBhAAAdAGC.eDEHSFAChAAAQABBAIHA.WEAAhACANEEBMACD...IBAF...hAEA......hAHA...,1,-10,-22,12
dPDbcGgNMCeZFTRQLaUVIJEBAKfWYSXOH,KHBG..fHBHSDEHOGAGdAAFDCCHGACG.NGEB.eEAHhADAFCFH.TFCALAEEhAAAVGFEIABChAIABBDE.WHDAXAFA......hAEA......hAFA...,2,-31,-13,18
SMZcBLKGdCgfYUADJPIFaXWEVROHeNQbT,DEFHJGEA.FDDB..aCFHEAHH..RBCF.HDGD.eFBDQFADhAAA.TBAFMACGZBDAhAAABBHHKCBBdDHCCAGFfBAAhABAAAFGXGCDOEDCSGGA...hABA......hACA...,1,-18,-28,10
ZOcYXBMaHPCQVbdNeKERFGJfSWDATgILU,TCBCLGEA.ZCGHOEHD..XEBHBHEDMGDGHBAEQBEFhAAAdDECeAEAKHBEhAAARDEAJFAE..WDFHAAHAIHBChABA.YACECEAGNAICFABA...SHFEhAGADDDF..hBAA...,2,-25,-4,21
IGNaPVMACEgSXUOBcWbYHLZfQRKTdeJFD,EEGDXGBCUAFEBAAC....cEAB..bBDFHCBGhAAAZFDAQBBGhACAREFAKADAdABGFCFEDGIFIHHEhADAaEAFMIBEAHAHCFCAOCHD..LEED.hADA......hAEA...,2,-21,-5,16
cWZQHIYBgKNUdTCeDRAObJMSGVLPfaEFX,OEEGMDEBGBEDLEBD..aBAGEAGGFFAG..XGGAhAAAZCAEQFGAHFCDBCFBhABANIEFdFFCeCBE.DCAFAHDCSDFAhAAA.......hACA.fFGFhADAIHAE...,2,-26,-11,15
ZKdfSOIbPTJMLgQAeDWNGXRHYaCEUFcVB,eFCHDACBGDFCHAGBaACGUEBF..FBEDBAGGZFGDdDBCOCDA..hAAAbBAAJBHBLEEFhAAA.AGAE.NBAE....hABA............hAFA......hAGA...,1,-11,-48,37
ONAGHWVgdPRKITMCEecQDXFbUaJLSfBYZ,GEDHHGFGVAACdAHGKCCE..MDCGEADCQGCEDIDGFAGF.aBFDhAAAJFCB.LEBEhAAABGGBOCADAFAH..gEGEhADAIABF........hAEA......hAFA.CFFG..,2,-22,-20,2
CPKfXMJBHWELDdRUNcTASIeZQbYFVgaOG,eCCHQFDHFBFH.aFBBGEAE.KEGAMIBEBAABHCCHLHDEhACADAADdAEBUEEETCGEhABASAHHIHHE.hADAbFFF...gCAFCBDE.XCEBhACAEAFG....hADA...,2,-20,-8,12
LeJYGXVMKZUHBAOadDPNFQSWcIRfEgTbC,OEGHDGGDFAHH...QACGSAAD..IBFCEDEG.hABATGAALFCFJEAG.hAAAXCBAKDDEZAGFBHEAhABAaFFGPEAF.NBBF.cGDB..fFHChACACCBD..hADA...,1,-17,-37,20
HQReCgcOGWLEZSKPFAYMVdXNITDUBfJab,MECGXCCB..IEACDCFABHAG..JEGDHGFE.eAAHhAAACBGH.OEEHLCBEhAAAZDBHKDFHACABdGDE.UGAEhABAbAFA............hACA......hADA...,2,-40,-20,20
ESKCOWMZbadXBGcfANHIFYgPTULVeRDJQ,HAADFHBG...gFCHTDEGLFACRFGFDAIB.JBAC.QCGAhAAAECGHKGABCDCD.OBEAhABAMAEDZFEBdHGBBADFhACAfAFFIFGAPDAH.....hAFA......hAGA...,1,-8,-23,15
DXCGFcAYOEPQdWfIMZUNbBLRHJgTSaVeK,EDCDdGFC....fCFBMFIFUGEEBAADRFAEHACD..TCAChABAVAFHDAAHCCEG..FAEEhACAAHAAOEFA..hABAWEEC.ZEAE.NAIELHBC..hADA.SGHDhAEA...,1,-21,-29,8
ESFCbAReBXGfaMLQTgJHNIKcDdZWYVPUO,RFEEBFFEGBGEMAGBQDBF..gDBCHADAKBBGdGAEhAAAZFCH..VAACOFHDhABASDAFCEDHAAHC.eFHDhAAAfGCBaEHFLAHFNICF....hADA......hAEA...,1,-3,-22,19
MKWEQFBIRegHPbYNCdDZSJTfGcVaALXOU,LFCAXDCHUGEGKAGDECED..FHAEBACBRBBH.HBAD..bBGBhAAACHFGDIAE..SFAGhABAfGGEGAEEhACAaFAFMDHBIGHE......hADA......hAEA...,2,-30,-21,9
UHKeZLAgfSWXOJQBTVCGENdaIMPDbRcYF,SHBGXDAC.QAFCBBBCCFEHGACEEDDD..dFBFMDGFhAAAbCGD.RFAD..FFCFKBCDeFHHhABAAFFB..gGGGhAAA.ODABJAHF.TGDCaHEA.DABDhACA......hADA...,1,-11,-18,7
CVESDTKgNQUaeMHLYObXWRAIBfdPGJFcZ,BFDGdHBHJABHZBBE.EFEEDBEB..KDEE..QGEBeHFELAAGhABAOAGH..bAFERDFAAHHDhAAA....IHCChACAPDDB.GEACCFBGSADE.NCAE.hACAaEHD.MAEE..hCAA...,1,-19,-30,11
GRKJFDePVTWcAZHLBbQSdgCUaXYMOEIfN,ZDBGHFEEBBDAQBGDdAAEUFDGaEBC.MCCC..EBGE..IGAEhAAA.NDBDKADGhABADEAFeDGH.PHAChACAWHDGABBG.LEHBSCFB.CAHB..hACA......hADA...,2,-38,-14,24
WOcESNPJDQKHRfZLIFbAUGXdeagCYTMVB,GABHXGGDaGFC..CEED.MDHFBDHGOFABECAB...NAAA.DCEGhAAAHGBAZFABLABEhAFA.bDCBAFEBeCFDhABATGDEcCCC..SFGE.hACAPAHD...hAEA...,2,-19,-14,5
bVMYaHOXAdSGNRTCFEQfZBWDPIJgeUcKL,GACBTFDH.ECGBQDACZEEHBHADDAAFJHBA...UDACKDFELBAEhAAAMIFG.aCGAOCCDhABAAFCGdHGB..NAEC.FHCGhACA.....fGGDIFHE.cAGAhADA....hAFA...,2,-27,-18,9
CKfZAaQWBYdFJegVUIPXOcDNMHESTRGLb,QGBCBFDGFEAC.JDFDeFFE.UCDAXDCF..DBHHHAADhAAASHEARAEHGAGEhACACABE.fGHAhADAZGAAAHIB.aEAAdADF.........hAEA......hAGA...,1,-9,-43,34
IVJMHdSZCRXBeWgFcbETLDaUfNPOAYKQG,QGBCGEDHJCBFHBFCdCBBZACC.REEFBECDeACCFHGG..EHGGDIBAhAAA.aGAB..UAGChAAA.fDGBhABANBAAAFIBKDDC.MEABCHEG.........hABA......hACA...,1,-18,-21,3
PdOVEHgQSbUaJMCANWcFeIZYKBTLfRDXG,...NDDG.FHBGZFGHBCGDLHBARDBDGEEBdACG.OAEEHADDSAFEhAAAUABE.MBBBhABAADEG.eCFHKGHHDEAH.hAIA............hBAA......hBGA...,2,-44,-18,26
USKZAQIJBCaEHNMdOGeVXDgLcPWTbfFYR,QDACJAFBBHEA.aHEEHFGF.dDGFOEDAGAACeCDA.DDGChAAALHAA.PDCHhAAAbFBAFACD.YFHBhABASEEBAAIFCHBCEAEEMADF.....hACA......hAGA...,1,-16,-20,4
AVOIWdgBZeTNbFECJKfSGXLMRDcPUYaQH,VFDFOGEA.dAEDBHBDZDBF...eCEGTABAFADA..CAACKCBBSAHFhAAA.LEEEhABADAIH..cDDAhACAYFAF.........hAGA.aHGAAEIHIHHAhADA.NDDB,2,-49,-33,16
LbcMVYQTZaOBFKIJUAdWfNGRHgDePSECX,dHBH..NDHCHEDGeFCASCBDCECF.LEAGMFBBQAGAhAAAaACGFHEE.KACEICHBhAAAAGIDGBCDDDDEEGDDhABAXAGC.bFGB......hABA......hAFA...,2,-22,-19,3
DdSfKFRgIcZUQWCVGNTbYLAJOBHeaPMEX,JEGHOFCAHFEB..eGBGaDCB.MICG.EFGBXBGD.DGBBhAAAfCADKFCA.hABAgAEHIBFBZADFhACAQCCGCBCC.NAICYAAAAIGEBEECSFAFhAFAcDGC..hAGA...,2,-26,-9,17
dPSaKNBDIYbCMWXReTJfLFAOQgUEVZHcG,ODACQCGCUBCEZEDBGFEHdCAG..aHGABFAGDFAD...IAABhACACHBAMDCARABAJCFC.hAAALEFCAECE.EFBEhADAcFFBKAHB..NHAF......WHFGhAEAeBDA....hABA...,1,-15,-26,11
eFJdWMPHECNaOXTBKfcUZAbGYQVRSLIDg,GAFEVEFH.REDALHDEDBHF.FBDDJCDD.dGCGMBBHHACECACB.OFABhAAABHAG..KFGG.hABAUEAFAEHC..YBBFhACASBHH..ICFC.WFEDhAEA.....hAAA...,2,-29,-25,4
ISABdgcHCUXQJTfaPEGbOLNeZMRVWDYFK,dEGDHAADCAAC.QDDH.TGDFfCDHEGBAGAFGLCABhACAeGFGZGAEMCCFWAGDhADADIBG.KFAFAGGBBAEGhAFA.....cDCCXACBaHEC..hAAA......hAFA...,2,-28,1,29
YZASaLFHJOdDQVCNWbKGeXRUPMgcITBEf,SEEDaEEDHAGFdBDAQDGH.CBCA.WGAAKFHD..XEAChAAARGFGMFAG..IAAChACABHADEBGE..fCBAhADAYCEHAGCC.FBADDIAENABB....hAEA......hAFA...,1,-18,-27,9
GNAHSTCYZBFLPJWVaRXgeEdQOUIfKcMDb,TCCBZDBHLGEA.JBAEaAEC.RCFAeGACEBGG..dFAEOEGFhAAAUDDD.KHBGDFIBGEEEhABAAAGG.CFAC.FAEH...hACA............hADA......hAFA...,1,-20,-39,19
GOeHAINgTJfXPRFEDKcBdVMbaQCYZWLSU,..IFDGTABDJFGF..XCFFFGEBDGCH.KAAFBBGGdFAHMIDEhABA..QCDGhAAACDHGZBDDSFGGhACAOFCGAHABfHBHEFADcBACaCBC..LAEChABAeHFE....hADA...,1,-12,-30,18
fEIKGVBbQHNDZAXYaWFJOMCcUeSdLTgRP,aGFCJCCH...CHAH.eBDBdDDALBCGRFGD..EGBGKCABGAEDhAAABHCBHCFEDDABAEGG.XEAChAAAFBAFMIAA.SFEBhABAgEGA.fBGBbCFE..hABA.NACF.....hAHA...,2,-28,-15,13
CQbKVdYfZBIeAWGPFDSXRNgLOHETcMJaU,GAFEFHFGDAFE.RBBBLEFGHCEG..TGBGMDADUEBF.CHAH.hAAAbECAdHDHZAFEBAHEeEAFhAAAABDC...SCCHhABAXGGC.gABHECHH.aEHD..hAEA......hBAA...,2,-17,-12,5
UMLKGDASERbHFIQBXdgPZaYTJWfcVNeOC,SEHBECFCRFAF.HCBGQEGABCFGXGCBdEECZFCFTAEChAAAJHFE....WAAGhABAfACA.hACANCAACGGDMAIH.KBGBACIHICDGgEAAaBBHhABA......hACA...,2,-21,-16,5
CbHIfcFGDZABQONTJUePSVgEWXMRYLKda,QEBEODAC.JFAFeEDF.SAGEEFEF.MIDGLFHFhAAAaGGCHBFDIABEhADAfAAFFAEADAIDBFGBhAAATBCDVFAHWEEC......hAHA......hBAA...,2,-29,-7,22
AEMIfPbeaHCVNXGLWBOgcTZUFYQdJSRKD,EGFHMCCA....fFBBeDAGCBFB..XEGHGDDBWBBBhAAABFDBOEAB.hABATAAFFBHDdAFGSHBChAAADAEFAADDbGBG.HFEBNCAAgFGB.hACA......hADA...,1,-5,-29,24
RQcBEaTCZDNAJVdWGeKbMYOIgFUSfPLXH,JDCHVDAGGEEA..KGHBMCHBOHCC.FAFGSFAHhAAA.LADAXAABhADARBACBDDBEFDGaHEACGHFNIAHAAIFdDGFhAEA.eEEG........hBAA......hBCA...,2,-25,-22,3
fCcgIMGDebTVKaFJdLXHSRONBZUAWEPQY,EHBGQCBC.CFGC.IBEDDAGH.TFDHVFBA..KBHFJCAChAAAdDEHLFAFHACAOEHDhAAANDHABADC.AGGD.PHEEhABA..fCFHMEAD...hACA......hAEA...,2,-30,-17,13
cOJKBgTYdLaEPfFebWDQCMSZGNIAHUVRX,UBBHRBCDOHDEKGGDBGDE..TEEBLDHBEGHF.FCFB..bAGFhAAAQEBC.hABACHBH.ZFBC.NDAAABEHXADBhAAAJDHB..dBBCaEEE.eBFEMACE.ICFGhBAA...hABA...,2,-35,1,36
NOUdgbLWVTPcBaIGZAeFfJEDXKSQMRCHY,FDCDEDCDKHECQAFE.REGD.CHCAHEAH.OBBCUABAbEEBLAHFhAAA..VFAFhAAAcEDDBDHE.aGDHZFGBhABA.eADEDAEF.SCGDMIFE...hAFA......hAIA...,2,-18,-10,8
CFIDGVRJfgcZSEdAXKaPeTQBNUMYbWLOH,KFHBeCCHBEGDMEEC......bGBEWAAFLFAA.CEEA.hAAAFGCGGDAFVBFARFFGJCCChABA....cGAHhACASBDEAIHA.aAHDPDAD.NBBF..hACA......hADA...,2,-34,-17,17
dSGBeLYAgfTWcUKVDaENMPZbJQFIXHORC,TCBCUCBCDGDG..EFHFMDADZDFG..JGAEQDFD.FGGGhAAAIHFAHBFGCBDBdGBEhABAGADFBACC..eAAFhAAAAAHE.WFDH........hACA......hADA...,1,-26,-29,3
eLSJZFAdIXUYbHGQCMBDcWPNVEKTRafgO,XGBCUCBCHBFHGBBGQFFEBAACDACC..PFACEEHHKGFBhAFATEDHREDG.aBDFOBEGhAGAeDHBLACChAAASCGF..........hAHA......hAIA...,2,-26,0,26
VQOcKJBMHagSZeDFYTWENRALIbGdPXfUC,LGEAGAFEdBCFXBADCEED..OFACJCECBEFFMAAFHGAGhAAA..aDCBZAFADGGF.hABAFFGATACD.EEADhACAAIHAIDHA.PHAEfDDEhAEA......hAGA...,1,-20,-29,9
EBHYaPJLTVFNXUKGSOAIRfdbCWZgcMDQe,RAADdHBHCFEH.ZDCF.MBBCDCGG....EDEHBAHCHAEAaGABLEHDhAAA.FGAAXCABhAAAKEAA.SEFGhABAADHC.fHEH.gGGBhACAcGDC.YCEC.hACA...,2,-38,-23,15
OeZfEHGCKFAgaRbNLJcBdXUMYVIWPDQTS,aCFCRAADLFGFBFHG.UAFCMFAB....VEDBIBAC.hAAADEFCSADFhACAZECF.fHBBhAIAEBGACCBHKEBFAICENDDF.dADG.XEECPFHF....hAAA......hABA...,2,-35,-17,18
eEFWDPBHVgfCUcAKLMGNJQSZIaRObXTdY,MEGFJFEFZCFHREAF....OACG..TDCHdFECEBACDBFEBCDChAAAHGAG...fGGHhAAACAHAAEDCKDGE.LCBDhABANEIE.IACCXGBD....hABA......hAGA...,2,-36,-28,8
fHZEcXOMbedaPYJgAUVFCTNDKGILRWBQS,FDAFTGGGKDHHGEBA.LBBGBDABfEFHHDDFZAFCEFGDhAAAOCFE.eBCGaHDC.hABAJGCAAAGACACCDFBE.IAFGhAAA..........hABA.WHBG.SCAEhACA,1,-24,-27,3
GWdTVYCSUDJBHcAFPLORNaIfXZeKbQMEg,LCCHOFBBRDFE.aAGD....XACDKAAHMEIDEDDCGGDBhAAAdAAF.TFABCHGGDFIBBHCHhAEAAACCFDGF...PAFAhBBAfBECeEBGgFFE..hBEA......hBFA...,1,-21,-22,1
VTDaWPYGfRKNLIJedgOFUSZXBQMCcEHAb,TFDHDGHH..aFCB....PBHFfGEDKGHDLFBHhAAAJAEH.dBCGOCAFhAAASDAFBDHHCCCHcCEBhABAAEEH....WBACYACCRAGF.IGAHhAGAFGAH.XDFDhAHAMFIB,1,-29,-43,14
UBQRAJKXPESTdLfVCZaYNDcgWOeMFIGbH,KAADEGFCdDDFLADD.CFDG.aBAH.DHAA....gGEFhABAeAFGICGGHEFGQCAHhACAABFFJBBA.SAFDhAGAVEAAZEFENAAFcGBH.MAHF.hAHA......hAIA...,1,-14,-23,9
FbRGSVXcdLfZBTUIKOJgYQAeDEMNPWHCa,EEGCMCCA....NBEH.PFBDHGEECEEBFDFE.GAEF.SDDHhAAAcDAE.LBBDhABAfCAATFFFhACAIHAHKEADOFHDgFCAADDDDADE.WCCHhAAA......hABA...,2,-39,-2,37
gASdBeaJPGDWQUICHVXEcbTMRfFKOLZYN,SEHBeCAF..PEFHDHBGQCBHCHDHHCCB.EHDATGAGhAAAMDFDFACGKDGH.ZEBENAIG.hABAAAGEBCGFGACFIBAFhAAA...XGGG.bAFAfFCEhACA..hADA...,1,-11,-20,9
edLUQZRHJESXYNPCOBcaTAFKDgIWMbGfV,DGGD..IHHGMGBAGDCHeBGFdFFALBCAZAAERCCGHFAAEAFGSDHDhAAAXAEF..hABAPDHFBFFCaEACAAAEFECChACAKDAC...WHCE...fHABhACA....hADA...,2,-27,-3,24
BFQUXWTcLfadZJPNCEOKIGgHRbYeMDSAV,FBBDXCCB..TFEBLEBGdDHGZFAGJBGF..CADA.KAEAGFEDhAAAHDDA.RGAA.eHBEDDAAAAFGhABABEAD....hAAA............hABA.WBEA.fGHAhACA,1,-28,-42,14
ZJRLKFADETHIBfUcWMaVCXdbNSPOQYgeG,TCBFBFDDUBDH..MGCECDAC.dAAC.SAGDODHHQFADhAAAeEBAZGFELEFGhACAAEEFHFEB.IAEDhADAfABHaHBA.bAFB.....NIAH..hAHA......hAIA...,1,-15,-29,14
HUTCaAEPMDXWGdeRQFKVLOSYZbBcJgIfN,EGFHDDGGGECGdFBE.RFAB.FEDGKGHBOBAH.ZFGBBEFD.JAACIBCDhAAAHCDD.CAFG.AEBEMADEhAHA..XGCHhABAQGEE........hAIA......hBAA...,2,-36,-29,7
RPNGeEZbUFASCMIdHfgaBLDWYOcKQJVTX,MAEEdCFCHGFE.aBAGDBFA.ODBGKEAFQFBA.JADCTGFChAAA.RCFHPHCEhABANDEG.GEBFEAHHZDGFhAAAFACFCCCE....IDBCfBEEBFFChABAWBHH....hAIA...,2,-29,-7,22
JICNDSWLeQZAKgcYfbaHGUEPBdVFXRTOM,KHBG..gCBC..fECDaECAHDGHEFAHdBBGXEGGhAAA.TBEBhABAMFFBIAEDhAAACHGC.NIADSAFHWADDeFAFACADcABB.hACA......hAEA.YEEBUGGF,2,-25,-1,24
GLfbdIPSDCTNEcZMOJKBWHAUaQYXgFVeR,UFCAQGBC..XAFAFFFEeBBBRGFCGBACLBFDdCEDSHEAhAAACACD.NAEEEBHDhABAMICG.KEGF.BFADhAAAADAAaDCD..........hACA......hADA...,2,-30,-21,9
YBeLCIdFOaAMgGVUPTbWZKcEJDfRQSHXN,GBGAUFDH..TBAGZBBGKEAF.JDDDDBEA.RFAH.HFBB.XFEAhAAABDCFCHGGdEEF.FCFAhAAAAIFAMABE..PEHBhABA..........hACA......hADA.cAGA.,1,-29,-33,4
HEbDYFVCQJfMRecWTUIAKNLdZBGgaOSXP,LCCHBCAHGDDDaCAC.OBHD..XEABEAFEDIGEFAACVFFAhAAA..QFCFhACAJAHHMIFARFDBeCCA..hADA.cFGD.WEABUGAH.KABD.NAFE.hACAdHCD.....hADA...,2,-14,-8,6
ZEgPKBaDJOAdFUCeMVWGRLQIHcNfbXSTY,FFAACFEE.eDACMBFHGAAFRGAC.LFGDHEGB..fBBBhAAASDGAZEAEEAHHKDACDHAAhAAAADGEdBGBUFDD..WAEFhABA...........hABA......hADA...,2,-22,-19,3
HWVCYLabIKAJTFcXGRBUDSdeQOZPNgfME,TAADXGBC.BAFEDEDCdGEC..QCEDZAFG.NBBA.fEBAhAAAHGFG.CHGHaDHBhACAKADBAAHE.FCCDREFBSAEFhADA.eHAGOFFGMDBE..hAGA......hAHA...,1,-18,-27,9
gDeQFXcLbTaVRBCMUEZfANPWIOJSGHdKY,...NDEH.PAFB.ODFEGDBDdCABKAFADAGEeEHH.FCBGXDBChAAALAAEaGHFBHAFhAEAUFFEEEFF.AHCEIHEDhAFASEED.YABA...hAHA......hAIA...,1,-23,-26,3
WOLZTIXBeVHfFUJScMKENDYbGagQCdAPR,RAADOEEGZDCC...TBECXFBF.BHDDeCAHHAEAFCCHSFAHhAAAKGGBDGFB.bAGFhABAaEGE.CHAE.AIBCLHFGhACA.fGDCcBGDMCADEFGB..hAAA......hACA...,2,-32,-4,28
bTDdZLBFONEWcXQKIHaRfPgCeVGSYMJUA,TAFBdEAEZACGFEED..EHCE..XGCGQCGAHCFHRDBAPGEEhAAACEDF..eAADhABAVABCSCDChACAMFDCAIFADFABOHFA..cBAH...hADA......hAEA...,1,-5,-23,18
OYQGaKRWbAPXdVgNEDCJeTIHcLSUfMZBF,dGFCVAADEGCD..CEAH.eDECHFBALACG.SGBDhAAAMAEBZGDEFDEDOFCGQAGChAAAKCDC.bFGFAAIBPDAHhABANADE.DBBD.IEGF...hACA......hAFA...,2,-14,-13,1
PERfcdJDQXMABKeYgbSaGLIHWVZFCOUNT,eCAF..bEFHGEFAHFCAZBAGFFCGUAGATBFHECCH..RDAHdHABhAAADIDGMFBBKDEF.SACChAAAaAEGIABFCHHEODHDhABA...PBEFfEHE.hAFA......hBAA...,2,-16,-2,14
JPISRTgLCaGHFMbceYfNABVUEWKDZXQdO,BFFCEDAFDBGDZAEG.QCFBODEH..JHEASEDD.hAAARGAGLCABCBCHaFCBFAHD.hABAMEIBeDGF..fHEFhAAAAACB.WCCFKHAAPADA.hABA......hACA...,1,-30,-31,1
gLNYSGeQWOXDTdJAPVCMcFBKIUEafRHbZ,CFDDMHFGBAHFKGAE..EDAGRCFHHBCC.ZBAHLGFG.SFBFhAAAeADEOFDDDBBGJCHDhABAAAAE...VAEFhACAIAHE.fFGFNIBB..QDEBhADA..hAEA...,2,-33,-24,9
EABNUDObCJYVHQRFfdPLSXcgaTGZWeMIK,UGGGDEFHCBBF...JDEAHADG.FHGEdGCDLCCH..SBCBhAAAXGAEaCEETAGGhABA.GEBDeDGFMBIFhAAAKCACEAEDAGACBDAFOFAH.....hABA......hACA...,1,-26,-28,2
APNBQWOJcabMIDSRGEeTVZCHLdYfUFXgK,BFDGQDACOCFEaEDB..MECBDIGARABEEDDG..eEHFZAACCHEDdBGDhAAA.UFEFFEAHKDAC.hABAABIF...NIAD.JFGFcFADhADA..SFHBGCDF...hAEA......hAFA...,2,-38,-7,31
ATFSVWDJQCXRPbHKecUZLIYNBafGdMgEO,FFHBSCFCDAFE.CBBB.RCEGHBBE.KDADeHEEZFBF.LDAChAAA.NCICBFFCaEEFdABBEEDChABAABGB......hACA.TGADWDDDXGFDPAFEcEBChADA..IBHHhAAA...,2,-36,-14,22
XaVIbNREAULgDHcZFCGSfTOQYJPMWdBeK,UDACLFCHDAGGZFCBFGHBGCBF.SGFBOAEB.JAHHMFGHhAAA.dABBBABDKCGG.hAFAaEFG...IADDhAAANEEF.ABFHgFAECGBE..fFHAhBAA..hBCA...,2,-45,-24,21
VdQNSFBHYMgUAfPKXTEDLaJGCceRbOZWI,KHBGXFCAECBF.DACGLEDG.aACEJCCD.CDHC.RGDA.ZBEG..hAAAIFAEQFGBhABASCEFBAFFMIEAhAHAAIFE..fAAH.GEGAbEEBWBBChAIAdBHC.....hAAA...,1,-22,-26,4
SRPcZMWOaXUfVADFQHJCGKBgNeTLIbEdY,QCBFHFEEJFBBKDHDBADE.eDECLAFEEAGE.dDEDRGFEZFAFMDAHhAAAaEDCUBBG.AIDA.CEHD.hAAA...gGCBhABANCEF..........hACA......hAFA...,1,-18,-29,11
eAPFMYLHNODbfIgEWKTZJCaSBUQRGdcXV,FGFHLCHDHCEHDFBH..IBADEAFAKDGBZCCFCFFCBGDE.QDAFhAAARBADdGCA.XGGChABAAHHEMAIH..OABGhAAAfAFA.WFAD...aEDG.hAFASGCD.hBAA...,1,-22,-27,5
MfYBLSZNVeFHGDXRCTbPIWaAKEgOcUJQd,KAFBOCCHUBBGdAGB..MAABBACG.LFHHZEAG.eFEGHGFGhABADHCCCFEA...PDFChAAA..IDGGhACAADDAEBDC.JCED.fHCHNICFFEAH...hABA......hADA...,2,-34,-28,6
QYUgMIWEVeKcANGPdLCSBaXZHDJFfTRbO,GAFELCCHBDEHaAEAZGCAJFHD...FFECREAC..OBBEQAAFhABA.UBFFIAEGhAAAEDGBKHGAAIEEdFFC.CAHB.hABASCEDDCAF.TDAG...hACA......hADA...,2,-35,-11,24
IcDeHAVbLGBEWKdgNSYZCQRFfUTPMXJaO,VFDFGECF.EGABdCGF..SDHDCAFF.FCCCTBBDMCABaBGBhAAAODAC.DIBGAIHALHCChABAKAGG.NBBF.hACA............hADA......hAEA...,2,-48,-18,30
ESeWRCUbKTQAJBcYZXdINOgGFaDHPVfLM,JAFBBFDGZFEFdCAB.OGFCFAAH..DGHDHCFB...VBDFMAEFhABAeAEERFAH..UDGBhACATDAH.AHDE.XDAEhADAIAAC.NCIG.aHCA....PFBDhACA.....hAFA...,2,-39,-13,26
GFXLKBWEOTPeafNVACbDRMZUgIHdcQSYJ,CAEDRFDGUAEGHDGDdECE..SACDJBAA.FBHBKAGH.BDAFODEChAAAeFEH..aDBCVCDEhAAAAIEG..DIGA.MFFAhABAIHHG.QGACYDAFLHAAhADA...hABA...,2,-31,-21,10
gfdXHCRZDNPWLITAVcFEMbeKBSOaUJYGQ,VDAGFAFBMEFE..KGHBOBAEUGFAGGBH..QBGEhAAAdAACCEEH.DEED.NHADLEAChABAAGAGEADCBDDBSHGEhACA..YDFC.fAHAhACAXFFC..hADA...,2,-37,-23,14
bUHfNEWYZQVLRIMBFPgcdeJSaGOACDTXK,CEFATECEKHGE..HEAHEBFHZFFFLBCC.RDDFBCGGFEHF..PACDhAAAdHCFeBAH.aFGEhAAAAEBCDIAA.XBADhABAfAGBNAEF.........hACA......hBAA...,1,-22,-28,6
RTGZUYPEQKDJCdFALgXBWfHeMINbacSOV,LDACBHHGHBBAeFCAMIDA...IFEBNHED..aCEBSAGAhAAARFABGAAFZAFChAAAPHAAKHCGCFGH.FDFCAFDDXEAGhABA.bBED.OADG..hACA......hAHA...,1,-12,-24,12
XFVHNcfBSRIgWLQCAUGDKPaTJeZObEMdY,DDGBKAFB..aEBBeEHFZGDG.OFEF.MBDHdCDFXCAC.hAAAFAHFVFAAHEGDfAEBhABABFEBRABA.ICEHhACA.LAHBAHIB.PBBF.hAAA......hABA...,1,-16,-27,11
bTMWSIfXaZEDOgFdRAKLcJeCQBVYGPUHN,LCCHJEEG.CGHGBHCFGCBCHAAE..NABF.TEFE.SGBFhAAAIFHBaHDAhAAAEHDADDGCFAGG..ACBHKBHBhBAAcCEG...eDAH.YAEAhACA......hADA...,1,-20,-41,21
BUcAVCKLSTEdbeaIGPgMYFRODNfJXQHZW,KBBDSAADEABE.dDBGeDCHGAGE.MFAFFCDADGHB.JBHHQGBAhABAZEEH.UGGGhACAAADCCEGCLFADhAAAaDECPADB.RGDA..fAEBXGBA...hAFA......hAGA...,2,-32,2,34
KgbZSeaCEdJXGVLTUWNQfAMYDIBRcPFOH,DDGGRDBHFFFEKFGAZADB..eDEH..CGDGdBGAJHCG.GAAELCBE.hAAAUDADQGAGhACA.MFIHBGBBOHEEhADAbAAC..EAHB........hABA......hACA...,2,-39,-20,19
PObcgLZEfJSeKANHMYBRVCQWXDdFIUaTG,HFACMBFHBEAEVDEE..QAFBDCCDFCGD.aBBHGFAF.OEDChAAAbDACLFHDhAAAZABAEGHB.SHDAhABA.ADDA.NBICCCAH.dHBDUACE.....hACA......hADA...,1,8,-26,34
CVFYgXaEbfOdcPWKRSAHILGQUJNBTZDeM,HFDFGECFQCGCJAAEBBDF.TFAGZFGB.eABDCGBD.FHGA.XAFGhAAAaAFC.fDCHhACAdHDB.WFFChADASCCAAEAE.ICGC...hAEA......hAGA...,1,-6,-43,37
YgPIMeXJaWZUETQHbADfCFNLBSGdRVcKO,DAEDFEGDLEDBBBHFGABCRFBF..KAEFOFGB....gBBHhAAAMFBCeCHFXDAGhABAaHAAZAFBEDAFTBFAhACA....bFCAABIFNIEHSDDGhAAA......hABA...,2,-25,-23,2
NMbcfWPeaSCOQTXJDUKBdVRAHIEGYFgLZ,HDAGGEAHFGAALBGBMBIH...bBBGfHCF.eFEAhAAASACAQACAhABAXFGADIFCBGHEhACAdGAAACABIBFFEHFGYDDEgDFCcGCBhAAAaDDDCFFC.....hABA...,1,-2,-18,16
aSHCbZABYEOIXKTRgLfQJGWDUFedVMcNP,EEGDODACKBCE.RFDGLAHF..QDDDGABBDCAEFBBHdFAAhAAAVFDBMCGB..PBHDhAAAaHEC.HAFD.hABACEAEAHADBGHD..IHHCXGBDfFAGhABA...hACA...,1,-15,-23,8
LJcICZPARTMXWKHYSEfdObeagDFQUVNGB,RFEEMGECKCGCHECH..SBEAdBFGeFADDIGAFBHDUCBBGABGBHAAhAAALAADJABECEHB..hADAZEDE...ABAF.WEHBhAEAEFAG....fGHA..hABA......hAFA...,1,-14,-35,21
ZDIVRMGeJgHWXcQAdLENaBObTKUSYCFPf,dEEDEDCDBEHCOHEAKCACUFBB..CGHC.FAAFZABA..DCIH.RACC.MGAGhAAA.GAFEJCDEHDAChACAXFEA.AEFDLAHBhACANIAH..aAGC.SGGEhADAPHBCfEABhADA...,1,-20,-29,9
COHXYTegfGDcNFQZUSKdJbVWLARIMEBPa,RFACMHFGBDAB..CACAHDEB..TDCGeCACGBGCDFFCFBFHQAAChACASGADKAEEhAAAJAHF.VEBBLGEAhADA.AHIB.IDDC.aEHD....hABA......hACA...,2,-31,-14,17
UYEaLPQRAdOVXMSKTeCgcGNZbHfJBIFDW,dDBDVAEGSGCG.KAFATDGF.CCEDGDBFZCFF.HGFEhAAABFEADIDEUABFEHAAaACGhABAQGGG.hAHAAEAHOBHF.MAAFcBBEfEDFhACAIGDH..WFAHhAEA...,2,-36,-8,28
eYMWSUZQBTdfCgFGKAJEbXcIVLNDRHPaO,EDCDXCBC..IEEFLECCDICERGDAaDGF..eDADMAFHhAAAUCGABACCdACCCHABFAGEhABAKGGBAAGH.JGDE...hAEA.cGGENABE........hAGA......hBAA...,2,-32,-27,5
PWFYgSJHNXGEAcTdVLebRUOZMBKaICfDQ,dGFCeFFCRCCHZBFFMCDBBHBHKCFA....aAHBCAHB..DBCGQBAAhAAA.FGHBSGHHhAAANEBC.EFAAAADBTAEEhABALABDOEDDPFDD.....hACA......hAEA...,2,-36,-21,15
GWLCTAYeJVDgHPIbMXfUKdOBQNEZRcFSa,eEEGVAAD.DGDHHDGF....bCEEMEAGUCAF...KECAdGBHhAAAQAFCEEECZADCFCDFhACAaAHFWAFELAAEhAEA.AIHAJGEA.........hAEA......hBHA...,1,-14,-21,7
fDRJgSWZEMFLOedPXCQTKaGBIcNAVYbHU,VAADHAADUFEE.RFAB.SBEBEDGC.MICCFHGELDCDhAAA.eAFGXAFFhAAACADATBEAaHGABBHBhACA.IDDBAFIF.fFEHDDAD.hACAWEFE.dEAA.KCGAhADA.NDCE..,2,-29,-7,22
AGUIWcSMbBgDfQRCNKLYTePOHdXJaVZFE,UAGH..IFDGSHDABAEDDCHDQDAH.CHECLFFGhAAAeBAH.PBAAhABAOEDAHAGFJFBCaAAGhADAFHFEAEEA..cGGEgGAE.fCDChACANDCBKFGCdHAFZACEhAEA...,2,-25,-10,15
NaHDdfbLWQXeAZIPRUMTOJSKCgBYVGFEc,ZAADRAADMEAGODDB.KFGHBDHC.GGBBEBEA.aBFGdGAF.LHDAhAAAQACEAGEE.UGGEhAAASCCFCEFF.hACA.YFAE.......hADA.cCFBDEEB..hAEA.WEHB.,2,-34,-15,19
bOITYGRKFAXDBWLUPgfaZeMHJNCSQcVEd,XFCADAEDLDAGUBAG....gFFBaAECZDFCHGFECDHF.hAAASBGAQFAGhABAEFABdGEC..OHBEhAAAIBCDTDCCYFCB.KAGCACCC..hACA.BFHE.fCFGhADA,2,-21,-21,0
GDeIRUWVaKYbMLgTSBZCEQOJcXfNFAdHP,dCFCHEBHDFACeADGUCAAVDGD..KFFFMBDHLHEA..TGDFhAAABAHF.CFFGQBAGhABAOBHD.JFAFXFBEhAAAFGHDAEEA.GABF...IDDHhABA.aGHF..hACA...,2,-37,-2,35
NTHbGdcgBfZIUKeQaMAWODCSEPJFYRLXV,OFCHDFEAECDF.FDEFLFCB..NBDD.TAGEHAAFGEFChAAA.dDADgCAFhAAABGAHIHEEeFGHaGAAhABA.AHEHSACA.JBFFXDGFhACA.....hACA...,1,-19,-22,3
GcfBAaJXDEKZVRFSNWLbTMYUCIQgOdePH,aGDDJEGH..DAGCEABH.KAHFRFCF...FDDD..SCFGLADATCFFhAAAMAAC.CGFDQFAAhABAOAEBdHEHeCBFhAFAPFFA..cDDCBDHHAGID....hAEA......hAFA...,1,-20,-36,16
RWUJPbYaCAFIgXSGcVQZfdHKMDBeNLOET,FHBGXCBCGAFA.QABGZCFBdGAFMFDBeEAFLACA.hAAAEFGAWFDE.JFHFPCEBhAAA..bBDHCBAFACCChABASHEE..fHEBhADA.KHAADIDEBGHANAIE.hADA...,2,-20,-9,11
aDCBSXMQcVGUWHNYdKgJEFZfRIeALObPT,LEEGOGEA.TBDHCCCCBBHG..XDBEQEAG.GCEHhAAAHGEENAEFKAFCgCGEhAAAEEEGZFCB.fGBChABAIEHFAADGaDAGDABFcABB...hACA......hAIA...,1,-1,-29,28
UHgcCVPeTNDQRGFWLafIOdBXYJESbAZKM,KHDCMEIBHAEH.CHHE.VBFD..eDDBDHFEQBCAFGABLABBhAAAaECFODFE.BGCChADAJCAHEHBCSGFHhAEAAHAFZEEA....cAGA...NIDB.hAAA......hABA...,1,-23,-24,1
VCbTDELJGXAeKINfZOMdaRSPcYWFUHBQg,KDCD..NHBFZCADdAEEaFDC..SFGC..PBHHhAAA..YDDFhAAAUABFHGFGgCEDhABAVGAECEHADDDAECGBLAEG..XEEAhACAAGHCIACCMAGF..hAHA...,2,-21,-19,2
BfKDEaGReUYVAIOcdSWLgMFNbPQCHXZTJ,OGEAdAFBSEFGLCBCFCGH..NAGE.QAAFHEADZAAEBHEHhAAADGGAEBDG..aAHDeFDDhABAUDDFAEEB..IDADhADA...WDCC.MAIFCDHD..hAEA......hBGA...,1,-21,-27,6
SZNWGYBKIDXcfVgbdFAOCULMaTeRQHEJP,CFFELAEH.aEHFeFEBHCACJDBDZFFDGAEHKGCD..DAACXFCHhAAA..cBGDhADAVCGF.dEECAACGMEABhABA.RBCB.EAGA.NEBABBCBIHGD...hAGA......hBAA...,2,-19,-18,1
EWNBeXadPcKROCSgLTYUHGMDZAFVIQfbJ,FCFCQFDH.JDBBNEAHBABC..eCCGdCCDKFFBOCGF.hAAACHBHLABGUFBDMICAhADAAAGG....ICAChAAAEHGA.aHGAPAFAcEEA...SEHHhACAYEFCDBCEhAEAZAFE...,2,-43,-9,34
SOdUMJWgXRCIHbBKYeFTDZLPVfEaGAQcN,QCBCSHBGOFAEMFDA..JBHBXBEHRFBF.CDBEHFEDhAAABBDHKFHDFDHBDADEPAFHhAAAEABE..AEEDdAHE.hABA.gGDA.IACH.hAGA......hBAA...,2,-24,-24,0
dUWXcMJNSYCbKGOTLBAFZHIRfgPeEDaVQ,ZBCFHGFGREFH...fEGBeCAFDHDA.VAFEUAGC....XADBhAAAMAAE.JBAFSGBDhAEACFDFGCDBODCBhABATEBDBBECACIHIFFGEFDA....hACA......hAIA...,2,-27,-11,16
BQKDAONPHJWEfcMTGFYCSUILRaeVdgbZX,OGEAHAADEAGF.MCFHFBCDCGDD..UEAGLFCDaAHD.dFACZGFABAAFhACAKADAACCG..JBEHfGDEhAAAGBGE.SEGAhACAIDAH.eDDB.....hADA......hAEA...,2,-37,-4,33
UCGMcELSPQDVOJHNAdIgaReTXfKWZbFYB,dHBHaHBG.RBDH..eHFEXEAAKDGE..ZABBFEEHUFAFGGEB.MBAHhAAAEFEF.LDFGhABA.SCBChACAPBFGDEIFOBEE.NBBFAEDH......hADA......hAEA...,2,-30,-15,15
afeFNZgdUAIKCbROPcHJVLYQTEMBXGWDS,CFEDRFDFODADHBFALHFE.QACDECFBXAGBDGAFSEAAhAAAaABH.FBAHZDCBhAAAdEDFAGHGIADHhACAKDHFPHBEJHFA..........hAFA......hBAA...,1,-10,-27,17
MHBTISfGJFYEDKbReXNPdVCUcLZWQaOgA,MEEDBADCSEFAGDBGFBEH.DECGKGGERFBG...eBAA.XAFEhAAAdAHGUBEG.LAAFhACAZFEBaDHBAFAHTGEBhAFA.ICCE.fGGB.hABA......hACA...,2,-25,-24,1
RLWeTJEVaMQYONAcCgdXGSfPIbFZKHDUB,CFDGXGBCGGEF...SHGE..fCBFhAAAIDCBFAADKEDCUFAELAGFhAAATCGEJEEGEBDDVAEHhABAMDIF.QEAD....hACA......hADA...,2,-28,-19,9
EWBYHMKCORDQgAPLIFZGaVdTSXNfeUbJc,LGEAFCFCZBCBGEGCVCBE.dGAF..SCGC.XFAChAAAfABF.eEDFhAAAJADCEHBABHBGMIFEhABAKGEDCAFDREEADBBEAEAG.........hABA......hAEA...,1,-14,-32,18
NPQEgUSOCVbcXMZGTaHdeKBARWYFJIfDL,RAADFHBG..JBEFDCCALDHBQEED..UGCDCCAG..VEAAhAAAXAFF..MDEGhABATDCFaFHFHAEEhACAeFFBBEAEAHAB.IBHEfHEB..hADAEACCSDGAhAEA...,1,-24,-29,5
GBDQKfYLFHZAUTNgOMXCWbVadEJSIPRce,UCGCTCBCOAAC..MGFGCDAD.VECEdFFH..ECCG..SGBGhAAARGDG.cAGGhABABFBEDACE.fAGDhAAAYEADFADCAGIB.NIBHXCGEhACAaECAPFABeHFG...hAFA...,2,-38,0,38
MBIRceUJDXWNFGCOVYZPHQLbfdEKgASTa,TFCEBBGEREFFUABG..DAGD...XDBG.FBCFCFDHOFAFhAAA.VBEFhAEAZCFEQGFFhAAA.fADDdHDFgDBEAIAGaEEEIEHGhABA.eHAENEIA.hAFA...,1,-16,-44,28
fcFKIdYJUVaNTWbGDeEBgHCRZQAMOPSLX,OCHDLCCH.XFGCFBACdGAHUAFG..aBHF..TGGEhAAAbEADDAACBCDC.CEDB.hABARCEDAADA.SGDEhAFAKEGFJDBB.NBCD..WCGBEGDC......hAGA......hAHA...,2,-33,-26,7
IPYNUbOgCGXJHeWZRLKAQMDEfdSBTcFaV,DIBGEAFBdBBEBGFD.FCABaEAH.....VDEGIFCC..hAAANIDB.UAGH.ODEHhABAgEBDGABFJADDhAAAeEAC..WHACLDHBABAD.MHAEhACAfFGH..hABA...,1,-24,-37,13
VgLOBCYfTRcQWJZAFdbUSKaEXDePNGHIM,FAFBUGBCKHACEFGE..DGGAeBFGGBACHCBH.MHEALDDFBFEGCAAChACA..TGEERADB.hADAQCFAJDEEAIEESAFEhAIAXACC.IEEE...hBBA......hBCA...,2,-25,-15,10
TSKVbJWFYERfOaUecIdgPHNZXMAGQBLCD,QGDHBEFACGDE.DDBHKGGF..JAEEFDABRDGH...OACCeFCCdABHhAAAHGAGZCCAAABGLCCChAAASBHB...hAEA.VAGFYEAFfFHG.aDDDcGGDhACA....hAEA...,1,-25,-29,4
UAbVeLONfQcIFPKGgHREWTDCaBMZdYSXJ,VFDFOAAB..QFADFFHFGBFERDFE.EHBGDBBCBBDE.dDCHXGFHhAAAAFEA.eCCHhABAfAHE.IFAFhABAKBEDgAFEHFCACHEGaCBAMIAC.SCAAhACA..hADA...,2,-19,-13,6
KIZPENRAHWBSMDacYTUJdQObeCVGXgfFL,BFDDDCHH.aAGETFCB.UBAAQBBB.OBEHCDDGGBEAhAAAXFAFFGFBIAGFhABAEGGFAHIFHCGF..hAAASACHcCAHdHADbFAH.....hABA......hACA...,1,-18,-25,7
CAQLNRWHDGZaTSMfgXFEBVOYbJKPceUId,QDACLFBBRAFADADEZBGF..aAACMCEF..XDCBEBBFBGEEhAAAOFEH.JGAGPDFEhABAeGFEdACAAIHE.NAEF.hABA............hBEA......hBFA...,1,-15,-40,25
IDWXGeLJdUbfZCYgFSONaTQKARHVEMBPc,HBDBEHDCBHBH..PHBADBGHGEEHLEGBUCBCZBFC.gCAEhAAASFAAaGAHTADChAAAAFGH..MABGhAFAIAHA.XFDC.dDACfFEGhAGAFHGA...hABA...,1,-9,-24,15
TNSgJDRGBUYfQdWCaPKOHbZELAeIFVXMc,FDCDVFEEMBED....TAACSFECJBFE.DIECGDADhAAABCAHUBGD..QFAHhACACEHBaGAF.OADBhAEAZAAAAHHFeGECIHHENACB.YDHHhAFA.WFDF...hABA...,2,-32,-8,24
WSKeUACDVRIbQGdONgPXHEfaLJYTMZcFB,CFCFRBCFQFBCdADE..ODEE..PFHFEAFALFGDhAAATEFFZAEAFHCEBBAHhABASDAGeCBFAHHGDHEC.hACAbAAF...NAIE.XFDAfFDBaDDGMFABhAFAWHAG.KBGA..hAIA...,2,-23,-6,17
RdXLEMcfeOQNbTYBZASJWCGVaPDIFUKgH,JCCHCECDGGCH..aGCDDBDE.FCACKEEGHEFGRAAC.LFAB.hAAAEAGHMBFE.eFGHhABA.OFABNDEB.TCFEhADABAAAAAEE..SCHH.WFHHhAEA.....hAAA...,1,-27,-32,5
UFeZWaRGBSVMgEKDcIOdPQNCbLXfTHJYA,UGGDFDBDZEDARCBFGAGABAHD..MIFEKEFGDAAF..OFAHdAEG.hABAQACGCDEELFBAhACA..XEGBhAAA.fBAA.TGCC.YAEBhABAAIAA.aCGGSGDAhADA,1,-33,-37,4
BIXgJQVCFMbfWcOKEGNAaPdYSUZLDHReT,aAFBdHBHSGFELDCHHCFHRCDE.BCBC..XEAFQFEGhAAACHEDMACCfEAFhABAOAADKCGEEACAAGHH.PHAGhACAZAFEDFFG.........hAHA......hAIA...,1,-13,-25,12
GeEQKgfIMbPRaZScUBHdAYVXTLNWJCDFO,XFDHTDAC.LCEEJDDA..CFAGDDHHOFFF.EDBCKGFD.hAAA.IABFMACFRGBAZADEhAAASGAGBBAFAHID.hABANEIGFAFE.QDFD.fFABhADAaAHB.cADBhAIAdGGA...,1,-19,-27,8
AfDJTMEFVNOBbcgHYeSQIKGLaCWdRPUXZ,DEFHTAFHFAGA...OEBBBBCB.....bEEFgFCDhAAAHABGSGFHKHEGGBAEhABAaCACCFCHdDEF.REGF.PCHFhAAAXAEGAHCHMDDCEFAB.NEAE.....hABA......hACA...,2,-23,-10,13
gNLaUXKFebRTZYMcJBWSAfPGDVIdCOHQE,GAFEVFDG.CDCBHFDFQAEC.EHGEgEAH.aGGFhAAAKHCA.eBAARABE.TBGFhAAAMDIFBBAGSDAEhABAADAHDFFEOHACNEBELDDE....hACA......hADA...,1,-10,-13,3
APUbefIRXdgMTWYOcBJHGQDCEKLNFZSVa,UCBCeGEARCADdGBB..MBIF..TAFGOBGDBACBGEDBDGIHKHFEhAAAFCDGZAAE.SGBBhAAAAEGG.fAEBhABAIFFDXECE...WHCGhABA.....hACA...,2,-46,-19,27
RDGAYTCbedZcfSaOKFIXgMBEQVPJHULNW,CHHGdDCDZCADSAAD.KBGBXDCA.MAAFBGHFQGBDhABAJBBAHFCELFAHhABARAEFDFGHAEID.TAEFhACA.bFFHfHEB..OCHDhADAFAHD......hAEA...,2,-26,-17,9
dPacUZIADbKOBSMXFHNECYWeRfLJQVGgT,DGHHOCCHMFCGFAEFHAAF..CFDA..eDFFLCGF.JGBGVAGFhAAATADDdHEHaBBBUCDFhAAA.AHABBDAG.SAGChACANCAGEFHB..RGAE.fHEBhADA......hAFA...,2,-23,-20,3
aZbgSVYJfPOBXFHKQCRMGIUWNTcADeLdE,DIBGdAABZDCA..SGGBVFBD.JAFBOBFA.BEHGFADBHEEAhAAAKBDD.CGDGMCAHhABAUGED....NADF.AHADeCBGhACA.ECHD.aFAE......hAFA......hAHA...,1,-28,-41,13
ZMLHJDKbPTUSXcWCBGEgANIQORVefFaYd,QCBCODACRFDG.eHDAFFAB.dAHAZCFEMDEAHABF.KHBG..TACFhAAA.SFGBhABAWADG.BFCFEEHHABAGhAAAIFAF.fEEAaHEE.JAEChACADCFE.....hBAA...,1,-20,-24,4
PGSVUKZWgNQfXCRFLHdJAbaOMYTEIeDBc,OCCHTFDB..EEAFeCGD.BCAGGAAFSFDHKCFHZCGBNDICQGGHhAAA.fEEDhABACECBRGAA.FAFChACAdGGAAHAEMICGICDADBCC......hAAA......hABA...,2,-19,-17,2
YSBPUAObIFXDZEHNCQaMKeVcLTWfdRgJG,OGEAFHBGZCFBHDAA.CGHB.aFHD.eCAHLCCA..TGAHhAAAfHFDdCECJACESECAhAAABHEHACGFICCFhABADAFEEACG..NGBDMAIFcFBA...gAGEhACA..hAIA...,2,-32,-14,18
PNWFDJZaLMXedYCQBTARKfbIHVSgGEOUc,RDAGKHBG....IGCESGAFGDDGEAAFUCEH..cACBhAAA..WFEFhAAAJHFELBGF.hACAMAIBXDBDdFAACCAFBFHGAIGCbADC..gFGGhAEA.NBHA.DCDEhABA...,1,-20,-29,9
PCUBJeKcZQSTGHFNbYXOgLfAVIRdWDEaM,VGFGRDAGdDGCDCBE..EHBA..aAFBMCFA.UAAGJFFH..KHCEQDGEhADA.SEDBhAEATCDAFAHBYFADhAFAOABE.fBDCAIHE.IDBAhAGACAAC.BFFC.hACA...,1,-10,-42,32
BeAVUKDIMJTbgWOXLCcPFNGdERfQaHYSZ,KDAFMCHF..TCCD..bAEBOCFCLGCACFHH.FDDFdHCHRBBF.hAAAaHFASABFhADABBHEAAAADFCAIHHE.hACA.gACCWDGDXEBCNEED.EAHDfFFFhAFA..hAGA...,2,-38,-9,29
KMTFRbQIdJfcaLBPESVOAGZeYDHCXWgNU,GGDHZFDFDBIBHCCGCEGF..XBGF..WFGHUCCGKDADMEIFhAAAFBCG.QFAChABA..dGBBJACGaAAGhADABCFDECFGSAHFAAGG....hAEA......hAFA...,1,-23,-30,7
JdeLTVKbHcDOGMXPRWUQCfIEYZBFSgaNA,dGDBeFCALBHFKBFHHBBFDBECGGEF.MIAAXCBA.REABQGGHhAAACGADICHHZDEAhAAABACDSADDhABAaCFB.AIEE..........hABA......hADA...,2,-34,-10,24
RUDAdTbCJfXFcZKeLYIOVWaEMHPSQBGgN,TGBCCAFB..XCCFFCBAKDAA.LAAB.OEHFVBFGaHGAhAAAHFED.SBHHhACAGECH.RFBFAHGEdADHJBFFhADAfEHGeEAH.......hAEA......hAHA...,2,-22,-13,9
ZWEeSTXYaMgRKOQUIAJcCGdNFHDfPBbLV,JAFBCECDdEEGHFEF.DAACBBCA.LGAGZDAGEEDC.eAEA..XGGBhADAMHFCKHDAOBHHhAEAQCAGUBCFABBB.hAAAGFAFfCGD......hABA......hACA...,1,-12,-38,26
bIAGKHXUWeVJfYENBaMcZDRTOSQCdFLgP,KCAHXDCBeEGH...JDAHEAAG.BHHEMCBCZACF.DBIBRGFGSEHFhAAAdGAHLFEF..hAEAbCFBAGDBGAFC.hABA.HGBC.WAHBfAEAaEEDOACAhAGA......hBAA...,2,-22,-17,5
QNHKdLSaWOTfYeIUJFAVRMgDcXPZGBEbC,MGCEDACB..XFGCGBEFBHBH.CAFFHCBELCHF.WAADhABA...OGCAhADAYHDEUCDEAHAARAACgDBFhAEA.PHAAZEBE...EAGAhAFA......hAGA...,1,-25,-26,1
WTBbcEJQVGYRNDKLOPgXAFfCeHSUZMadI,CFEDeDCHUBFDMFEA.dDAF..TGGEBGDHEBFB..QBCEhAAAVAAE.GDAHhABANAIA.LHAEOFADXFGEhAAA.fAGESAGCaHDEhADAICAH.WDFAhACA..,1,-23,-24,1
VFfQJaRNCgMWTSbDAUEcYLPOeXKGHdBZI,EGFCLGEA.OAEAKFDGdDCHZABHFCGHQDADRFAH.CFGF.MBDChAAA.SBAChABAACIFUBFF..PEDAhAAAeAFE............hADA......hAIA...,2,-35,-30,5
gaAVZWfFDGTJcYCXUeKNHdBLPREQMSIbO,VGFGZAADFDCD.DHFCGCDB..JGCECAGFUCAH..KAFCHABChAAALEEAREAEEEGCMIAChABA..SBHBhAAAOEEBAHCA.TACF.XBFC.NIAB.hAEABBGA....hACA...,1,-9,-34,25
PMWDONKXdbIBEQLCGgcfAYFTUZJeHRSaV,TGBCZADGeGEE.HDAAREGD..SGADaAAFMFEA.OBAGKGCAdCFBhACABGDBEDDE.QCCAhAAACBHE.GBEAhABAfHABFDAC.........hACA......hADA...,2,-16,-14,2
JWEaABGHfZTcbXUMIPCVKgRQYOFSdNeLD,BBGFGEDHZDBC..bBAEMFDH..IGHCCEGDKGAF..RACF.OBFFhAAAdAAGLEHBhACADHDAJFBHaECGAAEE..HFEDhAGAfAGB.XADB...hAHA......hAIA...,2,-31,-17,14
bgXLCQWEVYTPSDBdZAfGMIaROHKeUNFJc,MEAEaCFCHFBBKGGE.UABHFFBA....JBDHbFGB..LHFAhAAA.CGAH.WBEE.EGEGhAAATAGCDGIBBHADAFEF.hABAIEEEeACENIAF.cCAE....hACA......hAEA...,2,-32,-25,7
aNULMEFfDGZgbKAeSJIRPdQVOYBXCcTWH,SGDBJFBB.RCCA.QAEB.OEDCBEBEXFADhAAATFGF.aGHHUGDEhAAALABEEDBGDADFZAGBKAHDhABAIEFF.dAFACCAC......hBAA......hBCA...,2,-28,-27,1
dJFgOEHDKCaIcBLTXNVQZbYRGWUeSAMfP,MCCAdHBHFGFA..OAAFDFEEKAAB..IEDFBBDCLDDAhAAA..NGBFZAEARBECUDADhACAeEHF.SHAEhAAAAIEA.PHDAEAGECFAH.cDAE.TCFChACA.....hADA...,1,-13,-39,26
WbAQKBdGZSJDLNgEeOCFTRIfXUaHVMYcP,QGAFKEHBGCABZFBGDAEELCDG.EBACCCFGTAAG.hAAARFFB.IHHDUAEFaAHDhAAAMFFF.PDHFhABAAHAHBDHCSECC......hACA.NBDHeDAD.fHCFhADA,1,-6,-34,28
bEcVHdNCWMUXPaJegBTfLOADKQGYRSFZI,QCBFGEDHSCCFZADFEHEE.HAAECDHH.MACCUGCEaHDAeBFAhAAABGAGLBADDGHDKCGF.hAAAFFGHbFBDdFAA...hAGA............hAHA......hAIA.WBDH.,2,-14,-7,7
XBacQDCGbUYVFSMPWEIAgHdJTLeKOZfRN,HDAGdGDDLBECeDHFODDAZEGBRDDDBCAG..aHDGDCBECGCFUGGFhAAAFEAB.MFBF.EEFFAIHAJAAAhADAKAHD....XABDhABAQGAAYADGSDFB.hADA......hAEA...,1,-11,-30,19
DCcOFPIZESUHAXMKgTWQfYNBJLebaVGdR,MBDHTGBC..QFDB..fCBDBABDJGFEeAFBhAAAVFDAGABFDAIFCGAFFCABhACAPCEE.IHHBhAAAEHBASEEEACAHKAHDWFACNCCC.aHEE..hABA......hACA...,2,-23,-20,3
SYbOTPgINWLFGQeZDHEJaXRCUdKVMcBfA,SHBGOGEA..TDFB..IAEALFBHGCDAhAAAQAGDDGBEJBCDaDAAhAAAXGDACEHAKFADcACDhABABAHEfABF.bAFHNDDEFHDEZFFF.hABAEABF.....hBAA...,2,-24,-6,18
HYecUWgMbGETaICFSAfDBLPZRQKNXdVOJ,DAEDBAFBLGDCZCCDKEFE.dDBC..OACCJDDAHAGB..eFFBhAAAUABE.MIFGEBGHICAAhABACGBF.FEHDAIAG.hAAARFDB.NDIE...XEAF...YHAEhACA...hAFA...,2,-33,-21,12
gMNdJUceLRYOHfZKSIEDGWBaVQFbXATPC,CHHGMCCAdFDG.UDBALCBB..ODHDZFFCSAEFEDGFGEEGhAAABHFGaGAH.FCHFAHGC..hAAATGBE.PADAhABAJHAA..cAFB.eBDD.YDADhABAfBGD.DCAFhACA...,2,-22,-22,0
WBAMLQUfeHgXPGKFNYEOCcVRaIdSTDZbJ,MIFGLDCHUDDGHFEE.XFAFKHDCFDBF.EGHF..CGAARABCIDHChAAA.dAEDDAGFJHBEhABAACID.eCACGCGENCEB.hACAOHAEaEEG.SAAC...hADA......hAFA...,2,-35,-3,32
WDHMgKXbVGIRCZBcUSPJLOdfAQYNEFaeT,QCBCEHBGFDDB.eDEHDDGFHAEDKGBG..XDGCVAACRFGFBHADhAAAUAFD...JGCAdGGBhAAAAADE.NICD...TBGEhAGAMEABbABA.CEDC........hAHA......hAIA...,1,-8,-23,15
BAbHZKJfIFTeMGcgDOPLXaVCEURYWSQNd,HGFGZDEDKAHDJBAEFDBB..MDFHGGEB.DIDAOCGB.XDCEhAAACBBHUGAC..RADC.SEAHhABA.dFCAhACABEDGAAEEIAHATDGF....cAABhAAA.....hADA...,1,-29,-31,2
NaIALYREKZDTbQBJSfOXHVGWCdFUPegMc,LFBBRDAGEGFD.KABDDDGFQEDBBCCC..SEDHhAAAOFGDXAFCGGAHdADDhABAFCCGUGDHeBFFMFIBhACANAAEAHAE....ZCEG.......hAEA......hAGA...,1,-13,-26,13
LJTMgKEXZYRfPWGbBcSAVCUOQeNaHFdID,CADCUDCH.eFEFHCCAdABEIHBHLBHBMFFAKGCB...EABH.hAAAZGEAfHFBhADAGAFCBFBBADFEOBDE.hAAA.NAIEDFABJFAH.........hAEA......hAFA...,1,-17,-27,10
gXNZSFGWedYULcbMaEVHBQKJAfPOTCRID,OGEATGDC.RDCB.DECF....XGCCSDGFFBEBeAGBhAAAdABELBFGMCADEBAGBAEChAAA.KCDDAGIHfEEBhABACDACIGGD.NIDFZFABYHAA...hACA......hADA...,1,-15,-31,16
IEMCdbALZOBVDNPFRfYSTGHJcUQWXgeKa,OFFCBFCFDGHFFDAFRCEA.....SFCCTBBA.JACBQGBFhAAA.XADEhABAKAGEaGDHMIFE.hACACCHHAHCHLEEA.......hAAA......hABA...,2,-47,-35,12
WPBKLNdQFbIHGSfTMDYcOaZgEXeCVRUJA,BFDGLCCHdGHAFAEDHGFAGDAHSHBC.TCGDMICCDHDGhAAAOAEA.ZDABXACFhABACAAHRCEBADAH.KBGANEEE.QEFBhAGA.fHAFcACFEFGG.hAHA......hAIA...,2,-32,3,35
TJFcWQVERCDBZeabLYdGNfHMKSgIXAOUP,ODACUCGC..JECCFGHB.QGCGECDC.RFEDBACGeDAHaGGChAAALAFAGABF..hABAfCFEKGBG.hACAICCH.AEECPCHB.TGAAhAAA.....hAEA.WHBACBAG,1,-26,-32,6
VYdXRDabJCSgAIKPZWMNTcLEfQUGHeOBF,KHBGZAADMAED..TCBFEEFD.UEGAeHDABACGFGCC..dBFHXEBGhAAADDDH.aBABJFABhAAA.CHGH.AIHA....hADAPFDD.NAECLAGB.fGFEhABA...hAFA...,1,-24,-36,12
QHDRGedTNUPCSBKXbMLYJAZEcIaFWgVOf,ZDAGEHBG.aABEFDDB....VEEGQDGCHBDERFBD.dFCD.UADChAAASBHFBHGBbBAHMFIDhAAA...LHEEhABAABIHIAGF.WABBfCAF.hAIA.DGGA....hBAA...,1,-8,-29,21
FRePIgZBcOXNADdSMEHJbCQUYLWTKVGaf,SGCDEFEFHBGFJHFGCBFD...UGBGLEDFKGAD.aBAFFCDHeHFEhAAA....IDBFhAAABCCAcEGGOAEGhABAAEACdGACMBBA..YAFC.WCEGhABA......hACA...,2,-32,-24,8
DCWPLHMSIeETUGfZgbdXFJaNRQKcBYOVA,DAEDCFDGLAFCHAAFMEGH..SHBGEDBAUBFGZEDDdEADXAAFhADA..JHACREFDKBEFhAEABFACOCGFAEIFIFCGhAAA...eHFAfCBF.hACA......hADA...,1,-24,-25,1
dFPZBOJDGRCUYEeKAHbaWVfSNLMQXTcIg,HDAGaHBG.VEEC..fDBFLBCCQGAF.hAAATBGCIGFBFGHBPAAFhAAAOADCJEDFDADE.hACACGACUCFHEHEGAIDA.SFAEMDDE...hAGA......hAHA...,1,3,-34,37
DagRXBHGdfSTbAEJPcFVUZQKLYeNCOMWI,JCCHFHBGUCBEZEEC.LAEE..NHCB.CCFG...OADAMEEGDFGFhAAARCFE..BBCEdABF.hAIA....TAGGhAAAAIFAEFBG...PBAFQBGB..hBAA......hBCA...,2,-41,-36,5
HeIDGWLOFCgKURPNATbQcSYEBXVJMZdfa,TCGCQCBC.SACCEFECBBCAJFBBdEFGHGAA.IAGChAAADDAGLHFGFEGEKCGGhABAPAAGAICA.bBEBcFCFhAFA..XGCDVBDE.fEHAhAEA.aAFA..hAIA...,2,-27,-1,26
cOKAgbTGfBULYRQdFZeWNCXaIPDVEJSMH,TCBCGGDHBCBH.UCGELFAAREAE.FHEGZBCHeBECCHAA.IEFHhAAADBGC.EHACMAEGhAAAODHFACAH.fCFFhABA.QGGCWCEB.NAEHaEDFhACA......hADA...,1,-12,-40,28
VXCQMYLIDPJRcgAGZeBUdNOKFSbfTaWHE,GGDHZFEEeDBDUDFAdAAFKDFCFAFA....SHCGTGAGHAEGhADAEECB.CEDA...MBAHhAAAICDDJBBD...hABA............hACA......hADA...,2,-35,-29,6
bAeVdPTEWHUYBLOCIQDXNFfMgSRGZacJK,eDCHVDAG.dAHG.EEGFHEFA.BBGCOBBFQGAGDADG..hAAAFHGEMHDESBEEhAAAZACGaDDFKCGAADHE..PEEBhABA..........hACA.TGAA..hAGA...,2,-30,-21,9
RAIgZLfSBMdWXbKOcCJVPUFTQEDNeaHYG,ZAADSDCDBFHCdDCD..XCGDOACD.JAAFUFEE.FBHDEGGHhABA.eAEDHEABRGCAAEEDLAEEhAAAMBFC.KCFBCFAH.hACA............hADA......hAFA...,2,-28,-27,1
LUJBWDHGMZCKSIeAVFNdOgcYPQRXfTbaE,VDAGFAFBOGFC......cGEBPBDF..QACBhAAARCAF.XAGEhABATBGCEFDHLHAChADABBBBDIEEMEEAKEHDIGHFAADC.NGAHYAFFhAGAaAABJHAA...hACA...,1,-10,-30,20
CSgLbadMUVcEDWBRIAKGOQFTPYXefJHNZ,KHAEGDDCQECDFCAD..TBFG..XADGeFAHHGFAhAAACCEESDGBhAAALACAdECCUCAHECCCDGFGBDHEhABAABGBOHCC.fABANIBF.bGFEhABA.MAIB...hADA...,2,-15,-5,10
EDFNAJTgCcQVfeXIBGUabYKOdHWZMRSPL,JDACCHHG..QDCCeBCCBHBEUGAA..aGDFKFFFHEFGMCAGSEAGhAAAEAEF.DIGAhABAFDGHABGC.TDAF.hACA.gCGEfHCB.....hADA......hAEA...,2,-33,-26,7
JLNBZERVbDHGdIFUKgaSQfeCcOTPXWAMY,JCHDLAFBBBGC.RBCEDEBGHGEAGEGE.FFBDKCBF.SDEGhAAA.QFCGhABACBAGOHDETEECXADBhACAAAAEMBIHNIAF..EFFE......hAGA......hAHA...,1,-26,-27,1
QFWXPMCOdZGEIUYVJbLSacfKeARTBNHDg,TADCHDBHQACH.FEGAXBFECHCFdDFCZAFGIDFGhAAA.UCBCJAAFLDDBhABASAGEaHGAcGFChABAeFAF.ABBARFAGDIDAPDHDMAEE.EFFE...hACA......hCDA...,2,-6,-3,3
UGQBJNCXSTEdAZfROcLbgIFHMYKVWePaD,ZGFGRFDFLAGB..IHCEFGHBHCBCKACGVAAEeBEA.aDDHDAEDhAAA..GEAGBFAHCCFChADASAACEEEE.hAFAAEHG.fGBFOAEGcEEAMBID.WAHHhBBA......hCAA...,2,-31,-10,21
acYPAFEZeMHSVUfgbWDGNJXCILKdTRQBO,FEHBEDBDZFDFHFED.SAGGUBAF....gGBGhAAAbCAGGEACJFFECHHALAAEhAEA.TECFBAEDaCGDhABAcCECADDDMAFGfHCBDBIF...hACA......hADA...,1,5,-31,36
fCbTLXREDIaJSWOGQVedAHgFBcUZPMKYN,HDAGBFEDZBCBKGEC....NBGA.CFBHLDGD.EBAFaAHF.JBAChAAAOHAEQADFhABA.dHBBABFEFDHDUDDEMAAEhAEAfEHEXAGFIHGCSFDDhAFA......hBAA...,1,-12,-36,24
LQbAUNVIYFSCMPgdKEHOTBRaeJWXDGcZf,VEFHFHBGCEDF...MFBGdEHCHBBF.BEAHRBACJCHFDIFA..GAEEhAAAZGFALAEDAABC.hADAUAGFNEAC..SGBFhAEAKAAD.ODBCaEFFXFCEQGDGhAGA.....hABA...,1,-10,-27,17
HPOWNTeEdFDLaAcBJVCRfIKXbgUMQSZYG,BAFBJFCA.CDGB.RADA.KBDA....XCABUFFD.MBIFSCADhAAAGGEHHCEA.hABAPHBENEIC.EABADDDDhACAAAAE.VFBF..IDCE..gAGHhADA..hAEA...,2,-48,-12,36
MORVcZGbQDUBSLNfWKEdPAHXJYTFeaCIg,XBDGJDAC.FDFFeAFA.CHHE.MDHFRGAC.ZGAAGBCBDIGEBEDDhAAALFFB..fBAGhABAKGDCdDFBAAFCHAAAhAAAaAFCOFFH...cDAC..hACA......hADA...,2,-33,-19,14
DWCZIUANgJeadSRfKBXHbFcYMTPELOVQG,JGEAeEGH.dCABRCAFBEDBHGCAFGAF..MCIFTDAA..LCEGhAAAQCGHDAFCCGCEIEDHhAAA.AABCNCFGaFFAhABAKAFC...bABAYACH...hADA......hAIA...,2,-46,-9,37
BUfQCROYJKeXNSAbgHcLEPdZDMVGTWIFa,HAADEDCDZAFCVBEDGEFG..TEAGFBDCBEEBUGGBQAAChACARDGF.JHCEXGBAhAAAAHHC.gDCGhACA.cADBLDAFDIAGIAHEhADA.fGEChAGACCGD...,1,-5,-19,14
SXATCDYgQaeWNGKOFZMPLUVRbEIfBJHdc,TFCACAEDDDDH...QGFGaAHF.eCEDGCEDFEHHMFBFhAAAUBAGRFEAECBA..BHCDhAAAHADGSGHHhABAABAH..gAGHKFAC.ZDAE...hACA......hADA...,1,5,-39,44
aOMJTULEbCBXfFYQReVKDAdgIZHGScNWP,dHBHZAADHEGHSBCD..NICH.aAGHMCEHUGEHLFAA.hAAAEAEEBEDGFAHDQCFChAAAeBEFKEACAFID.IEBGhADA...WHACOACA.TDGBhABACCCC.YAHHhBAADFFF...,2,-36,-1,35
eJBTIXVaCYWGSPAHgOFdQNfUbEDZRcMKL,HFDFFDCDdAGGQAGFUEFF.EFBADEEDZFFC.MADFLCADBDEETAAFhAAA.IDGGhACAVABGCGGD...YFAFhAEA.SEBCAAAFNDIA.fHFFhAFA...hABA...,1,8,-48,56
XRPfOZSNgbAHGUICJMFacLTWQdYBeEVKD,GBDFCHHGFBFH.aEHBLECH..QBADdAACeEHDKAGEDIAARDABhAAA.OEEDZDADSGFFhACANHAD.ABBC.IEDChABAMBIH.WDGFBADF.EDDE..PAFAhACA....hADA...,1,-23,-25,2
egFZCfATLQbPDMNKJSdXaRWUEOBcIVGYH,TDCHLDAC.QEAHDBHHKFDH.SFDGdCFGREAH.ECEDBHHAhAAA.VBAAHGFGFAEGhABAfACB.hACAABIFMCHDXFGCaHBCOBAC...hADA......hAHA...,2,-29,-6,23
EDcSWgfCVXULPGJdBZOAbKHTYMFaNReIQ,KCFCTFDHFECC..RAAC.eBGH..QGBGDEDGSGFH.hAAA.gFEAhABACEAEXAAGLAEAPADCdHAHhABABDGHACDG.YDCCMEIHaCCCIHHEhADA......hAFA...,2,-29,-13,16
gIDNcOFdUCHTKRaLfQJSBPZbGEAeXMYVW,XAFHMECG..VACG..IDBCDCADOGAGdADCHDEEhAAAKCHBLFFGfFBAhABAJBFG.BGDD.PGFGhACAZFDHbCADAHFB..WFAF.NBIE.....hAFA......hAHA...,1,-22,-23,1
BScdQeOIEHCDKYGMFXTNAZafLUgRbVPWJ,ZDAGLCCHUBCFRCFGVFDE....JFBFBCHC.SDADhAAAdGFHQEEHOEEA.hAAAIABBCCAF.KAGAhADAMABETBEHABIH.aHGGfAGG.hAEA.gGAChAFA...,2,-34,-27,7
bUGAWEPSDBTIVeCXNQFRJZKgfOcHdLaYM,EHBGSHFGDEIH.BEED..IFABVEGH.eCDFCAHBQFCDhAAARCEFZAAHKHEAOGCGhACAHBAGdDDFLADEhAHAMEBBbAECAGGH....PAHDNDAAJCFC....hBAA......hBCA...,2,-17,-2,15
gMAWZQfPCNeFXVYHdJOTSbDRBLIGaKEcU,QFDHCFDGFCAB...XAFEVCEFHEABdBDGODEC.hAAASACCDAFELFGDhABAIECGaCHBKABGEGAFhAAA.gGGEACDDfFHANBAC.JHBE..hADA......hAEA...,1,-9,-25,16
VaRGSKfeXAcJWdBMbUTDZPYCELNOHgIFQ,JGEABFED.UFFCDCBHZGAE..CHAHLDBEHCFA.FCHDQAAHhAAA.aCEHSGCDhAAAeFBCAEADdADFMAFGhABA..TAGAEEADOACCIDCF..hACA......hAGA...,1,-19,-40,21
SaMOBNPCfZRVHFWUKTXgYLDGeQIJcbAdE,SDABOECCBBGHCEGH.RGDE.HFEE.FGAEKDAH...XAAEhAAALBBADHAGeEDFJDGH.hABAACIHaAGE.MAFDNADF.hAIA.....fCDEWEHH..hBDA......hBEA...,1,-22,-43,21
bAYFMXPDJCZBNfSGaEWLdUIOgTKRQHeVc,FGFHXFDBDADGZEBDBBGH....SCDGaFABEBCB.dEFDOBEBhAAAKAGC.HDGBeAAHhAAAVFBBADBC.MIEACHHHGBEFhACA..WABFLDHB...hADA......hAEA...,2,-25,-23,2
KXWaDSPLFEAZOCbMeJBGVdYRQHcfUNgIT,ZFEEOAFBMCGFBCGDGEBDdEFD..RCCHHABHUCAE....gCDGhAAAKGGBaEBH.SAGBhABAFGAHCHCA.JFAF.hAAAQADEfGEANICD....IDHFhACA....hADA...,1,-16,-29,13
AXKEBWafcLSdJZMbFOVPQRCgYTIHNGUDe,KFHBBFED.aDFDLAAD.dDEAMCBEOGDCQAGF.hACARBEFCABAgFBAhADA.IBEDNDICGDAFhAAAeBCFADHFEFAF.fGGEJAHBFEAB.YHAGhABA....hADA...,1,-20,-25,5
PFIbWgcJBTYeCKLADaNHQVSMUEfOdRZXG,DGHHaCFCHFBBQBDAMBEH.UGCB..EFHDOFAGRABBZDAAXBGEhAAAFBAD..bAGDgGFBhABABGFH..hADAeAAELFEDAFGG.......hADA.NEEDfGAEhAEA..,2,-22,-7,15
JAeXIMTRBGHgDcPKUCOLQdVSYENZaWbFf,eDACMFFFBHBHGCFGHCADDBIHKHGAUBGDLGBAdEGF..SGGFhAAA.EECCaFHFhAAAFAEFABFDIECAhABA.TABC........hADA......hAEA...,1,-30,-32,2
MAXHfGSDRQNLOdgVUeaIPYTBEJWbKZCFc,HEFHSGAHDFCHQBGDLDEHdDBCUAACaHFA...IDGDhAAAPEABBHHA.hABAEEDHWBBGKCDACHECFADC.hADAAHCH..XAFFfADANDDEOEHD.hAFA......hAGA...,2,-24,-12,12
bIREUALCTWXcgdYHDfQMFBGeZSNKPOVaJ,CFFETCGC..XGECdAFEDBDB..QFGHFDFCeECBSABGhAAAKBAEOEADaEDAJBHH.hACA.RBCA.ABIBLFDFhAAA..cDAG.gGBDhADAfGEEBAHEZADFNCCE..hABA...,2,-20,-19,1
DHXKbGPNWRBaUOJgeLYEcTSCZFVMdfAQI,QAFBHFDGXCBHGBAB..NAECBGHGOEGH.eABELFABhAAAEEDGSFCHhAAACDFFZCGHMICAfEAChAEAABDFDABEKAGE.WCEAaFCG........hAGA......hAIA...,2,-16,-12,4
MbJRLdBeYfWcOEVGAgHUSQIKXDPTZNFCa,UFDHQGBCKCHD.DCADZACGFEHD...CBCG.aCDC..MAFAJBAD.hAAARCFBLCEDBHFH.hABAeABE..fAGChACAOEACEAABAIAAHEAFIHHA..XGGBhADA.NECF..hAEA...,2,-30,-24,6
DKaIFJgWTOGQSLXUdCbVZcANMBfHEYRPe,MBFHHDBHEFADREAH.DFGCKGCDFEDD...JABDTGEH.GBADhAAALHCAdAHGCDACVADFAGGABHHEhABA...PEFChACAIDHE.gGGAODDF.SBFHhAAA...hADA...,2,-22,-18,4
aBgfFeHNSPUDOQRYLWAZEVJMCTIbKGcXd,EDAFMAGD..CCGE.TBBCKFABGADC.dCABaGEFBHGHFFAFHECEhAAA.SDHBhABAUEGCOFDAQGGChACA.YBEFACIHJAAEIAHC.bFBD.hADA......hAEA...,2,-26,-17,9
TRcWUadgADBOCNefVIEKMGPXZHYFSbLQJ,OFEDCAFB..eEACVBGFKFCH.GCDBZDBGHACG.FGGDbAAAJAABhAAA..REFA.UGAEaHGCAIDAhAAABFDH..IHBGhABAEDFB...MEED...XCAGhACA.SAHHhAEA.,1,-19,-25,6
BZWXbeJTcdYODQaPFUCHgAEGIfKMNVLSR,GEAHKHBGMAGBLDHFBHEA.ZBAC.XBEAeDAB..JDCEdGAEhAAADAIFaHCE.FFFHCFCFABDHEADEhABA....ICBGhAAAfAHE..VFFCWEDE...hABA......hACA...,1,-5,-48,43
CHYRKIdVNeUgLfAaFOBSXJEQWPMGcbZDT,aEEDBDGF.SGGEEHAC..QCCEMFAFGAAFZAAEDAGBhAAACBGGRFCG.IEBBdDAHeEDGhAAAgDGAAICA.hABAFGGBOHECXFACWCHHPHCC.bAEDhABA......hACA...,1,-11,-18,7
BdXafCRUZVJOHMPDcegYWGKbSFLAETQIN,EEHBTCGC..ICAAdBBA..fHABRFEFUAECZEBEODEHhAAAMBBG.DAFA.eBEAhABA..YAHFhAAAKGFCFEBBAAEDBHGHCHHE.HCCA......hABA......hACA...,1,-21,-24,3
SOKMCfYcQVXIRbLZDaHPFeTdJAWNUGgEB,UCBCEGAHBGDAKHEG...MDIFCGCD.....fEFAhAAAQEFEVADGIAFDhAAARCECZCAGDICGaFDF..HBDBhABAFABDdGGEAAIF..NCAGSABA..hACA......hAEA...,2,-35,-15,20
JQIHcFCdSNeGUEWgTRMKYPVaLBbAZXDOf,ZFEEXEGDOEBG..JAAFQBFE.HACBCAFCSCCBhABANIBD.UGCEEBAHTFAEhAAAKEAHVAGFBHHGhABADAEH.IEFE..FEEE....hACA......hADA...,1,-10,-32,22
YRBLVeKgDIObWcCTHPXaGENUSdfMZQAJF,FDCDBFDDeADDDAGD..OBBD..bCABCAAB.HAED..XFADhACAEEEBSHGEhAAA.fCHGhABAZCFEAIGAJAEDRFFCKGAH.gGCE.cEGAhACA......hAEA...,1,-12,-48,36
adcRCNSQFDMfEOGXYZHLbABIgWTJKeVPU,BFDG..gGGGTAEA.KDGDeHDEUGADdHAFCBEB..QEDGhAAAFFFADCCHEBAAXBGAhABA.ZBBCLADFhAAAIACDJDEEaEAANBICSGHH.hAEA.fAFDhAHA.YHDAAAGC,2,-30,-9,21
EKFMdfIRJHDVLXGNScWOBCTUQYaegPAZb,ZDAGEAFBFCBCMICA.dFCARFGHHCEHLEGBGEAC..SEEHhAAAOAHHBHEATAGH.hAAAUACHaEGAgACBhABAAABFKGAF..........hAEA......hAGA...,2,-22,-12,10
KERfLXWAHgQIMZJCdaTOSBDNGFeYVPUcb,QFDHMECGZABGdGDBOCDHBHBF.GBFA.eAECVBECPBABhAAAUDAE..KAHBfHGFhABA.WFCDhACAAGACgGGA.CHDA.aBHFDAAFFEHD.bBBBhADAECCE.REFE....hAEA...,1,-3,-18,15
aORNSHJUMCXGQbPBLeETcKIAVfgdFDZWY,VAADdHBHFDBD.DCGBZCEA...aEABRAAFHFCCUFEH...CHEA..QAGAhAAAbADE.BAEDhACA...eCCGhADATDCGKFFCAGIHWHCA.OBHFSHGGhAFAMHAE......hAGA...,1,-20,-24,4
LZGNEJcUHMaDgFWbOdYTfIAePKXQBSRVC,KDCDBCAHRFDGLEHHGEDHJEAEHADH.DACFFHBG..OAFDdCGF.hAAA.TACFAHGHeBAHQGEBhABASAHDCAHD.hACAEFAG...cDFC...MIAAhAAAWAEH.....hABA...,1,-19,-30,11
OTRgIJXZWUNVDQKFPcYLbeHASCBdGaMfE,CCEABFFCGABCaHGC...EHCEODEB.RAAF.JECGZAFB..NBAG.DIAChAAA.FAEH..PFFFhAAALFAEHAGFAADFdDHAhACAMEBB...fDGEICCD...hAFA......hAIA...,1,-22,-30,8
NFWORBDIJCfVGaSMAYQcbdKLgPZXeHTUE,QCBCdHBHLCFEZAACHDFAEEFG.FEBFOFAARAACDHGE...CHGEGAEFhABAaCCE.ADID...hACA..cEEC.hADAKAEGXFFC.eEDH....hAEA......hAFA...,1,-18,-25,7
YHKbBLgFXWJZNcUDQadEfPITOGRSCAVeM,MAGDHDAGBGACFCCH.XADEZEBAUFFFDHDC..dCHEEGGF...hAAAIBAGOBABSGHHhABAADFCeEECKCCE.LHAAhACAJBHH.cBDAaGBD.....hAAA......hABA...,1,-24,-26,2
edJRCSPZKcFaAOXfMGIBUQVWDgEbLYHTN,ODACMFFFBDAHUBCE..QEGCDIAC.EGCFLGDChAAAHBFGTFAEeFHHdBFCCAHEZBBAhAAAFBGEAADH.XDFAhABA..IAFE.WFDHgFAHhACA.NADF.SGHHhABA.,1,-17,-21,4
LCIHXKPBaUJFcQgMAeVSYGTZfNRDWOEbd,eDCHVDAG.GADCZFDH.RGAGDBIFEDDE..dDHECCBEHFDDKGFE.BFFEUAFHhAAAFHGA..QACEhABAACABSBFB..hAAAfGAA.......hABA......hACA...,2,-26,-21,5
KQFcgfBaAENdbHeRSWZYLTDGJUXPOVICM,EAFBdHBHHBDHRDBG.ZFGBLDGFDGAFGDEGJEAH.UCAD..OHCGhAAAVAFE.CAHA..QBBDhABAFABA.fACBhAEABEAHAAAB.NCFE....SHEAhAGA.....hAEA...,1,-15,-21,6
NPCAFeTISZVcKDBOaLGMHXYJUgbWfQERd,FGDDeDAC..SEAEVADG.DBGFaDGCGDGAHFED..XABBhAAAJBBEUDDC..gGCBhAGA.fHABhAHAQGABEHGENACBAAAETBGC.IDEChAIA...hAHA...,2,-37,5,42
OgVNaBTCPYbLeIKRQMDGSAJfXdFEUWHcZ,JDACdGFCFAFE.UFAGHAEG.OGDA..VBCDBABB.CEDH..hAAA...PBAFhABALHEAKEGCRFCBMDHFDEEH.hACAAHCCEHAG...WBBG...gEAGhAAA.NDIG..hADA...,1,-28,-35,7
HEfFgDWOYPdTbJLMSKUQXCNAeZcGaRIVB,eFBBZEBHaEHHRCCGBHHE.HADGFAHDDDGB..OCABdBAG.JDFEMCBAhAAAKHFG.QAEBhABA.CDEH.cFFBhAAAIHAEEABC..fAHA..YFFFhACA...hABA...,1,-27,-30,3
ROagcXHJIeLEMUDSVPYAZBKCGbFQfdNWT,KBBDCECDFACBQECC.dACBTFAB.OAFCaHDA..XGGGhAAAHEEGJBEHeFAHhABAMIDESFGEhAFA..YGCGAEGEGBEANAAE.gAGEhAIA..IGHGhABA.EDGE,1,-18,-20,2
SNWQUXKHGYAMBIOgbaPLEfVcRdCJTZeFD,MBFHBAFBOEAC..gEGEaEGGLHDAEBBE..VGBEhAAARFGBJCEDZCAH..DCAHSAHDhABAQABHKDDDhACA.YFFFAAAF.IHHAfHAFhABAdGACCADC.....hADA...,1,1,-37,38
fYbKDOFJZVAGeEHaNTXCMQUIPdBSgRLcW,eCDGEEHBHDED.aEAHXAAD.MIFGQGCDUEEGdFBABEBHhAAARAFELDHFfCCHhABAKDAA.DBEGFADGJABEAAAB.hACANAIECHAGSHAG..gGGDhAFA.....hAHA...,2,-15,-3,12
QCTgRVEPcAHGNIBbSLYFXdUWaMfODeKZJ,HEBHGAFEBHEFLDDFFCBBdEGFaCAF.MFHBOAFB.KGHFZFED.hAAACHABRAAEEACBAADE...IBHAhABASFAGXEDFhADAfCHA.DDCFeHAG...hAAA......hACA...,1,-19,-20,1
LaGEBKFZHWXIcMeCVNJdOUTYRAPSfQgDb,SHBGQCBCDBADLFDEGDECEDBCKHGCFGEBZFAA.HAEEIFBDhAAA..eAAGhACANBAH.OBHDUAEETAGAhABAAIFEfHAD.......hACA.aDHHBECA.cEGAhADACHHE,2,-25,-17,8
TQISGWdNXgBUeKaJOHPDEMYRLfVZbFCcA,TCGCSGFC.dDBEXBEGBBBAKEGEOHFAHBED..EGBHRGBAVBAHhAAAZAGB..FEDBAFAB.hABA..IADEhAAAWFECNAEF............hABA......hACA...,1,-18,-29,11
aeGCdLMfTSFKNYOABEHgQXWIbZcJRPVDU,EGFHQFDH..IGBEZCDEJFAHRDBBDABB.eDAGCEEB.MFFAhAAASAEHKHGA.OCAGhAAAABFGBCCC.XGDBhACA..cGGEUCFG.dABBLAHHhADA.....hAEA...,1,-18,-32,14
GEJARZcCPfOMNdBLDXeQgbIYaHKVWUTSF,RGFGCFDD.OBAEMAFEBDBGLFAD..DEFDeEEA..QADHhAAAIDBFHADDKDDHUBADhABASDFCGBGEAFIHhACAPFCBdGBE.gBGEaGFE...hADA......hBBA...,1,-9,-26,17
JHKTDXFRGOQgIfceSMZVbAWYBUNPLdaCE,BFDGUCBCLCFCdBHCCHFG.EFABKCBG..DHFCRACEGDCH..hAAAgEDF.hABA.cGBFMAECZABAhAAAAHHD.NIAF.aAFF.JFFG.......hACA......hADA...,2,-36,-31,5
UDEfTCFSJbVWcAeHYBQgPaZLINOGdMXKR,eFBBBFDDQAAC..aAAHICEBNDHAdAFG..XEEBhABARGAEEEHF..CDBBJAEAhACAbFDD....cEBAhACAACCGgEEB.PHDC...hADA.OBBGMAIFKDAFhADADBIB...,1,-18,-26,8
YaGQBVUcZdSLJEWMKXgbFPRTONCIHeADf,DACBaHBGGDDCQECCUCGGdEGD.LAAFJDBF.EGDFMBAEKGHH.hADA..XGFChAAAFAECRCDCTGAD.CHEAeFFBhAGAAAFHBAGF..........hABA......hACA...,1,-5,-36,31
SBIDWgKACQVeHRNGXPfJEbYLOUcMaZTdF,CFFCVADGRDAE..GCCB..fDDCEGGALHAEOFFGMBIBhAAAaGDDZACAdGHGBAGGIBHChAAADBAH...KCBGhABAAGCCeHEGNDAC.........hACA......hADA...,1,-18,-28,10
AEgWDPHYNJdfVBKRTQSMIeZXUGFbcLCOa,EHBGDACBHADB.JAADVAFE.BCDARCFD.QCAGMFEBZFBBUFFFhAAAGEED.FGDA.LAAEhAEAaAGGAFBB.WCFAhAFA..PBHD.dDBFfEBAhAIA......hBBA...,2,-20,-16,4
LWQXOaJMcCRbfUIEGYdZPHDgNAFBTSKeV,FFFBBFCFKAHDeDAELFADQAFG.OEGFMEDCCCFB.RBBF.UACBhAAA.EGDHdCAGZFEFDIDAhAAAACIH..SHAEhABAVFBC..aEHB........hABA......hACA...,2,-30,-19,11
HYTDEUKANMLOSPQVZIRagJCFXBGdfbWce,LCHDSDCDQDADZEFCRFAE.aEDGJABE..FGFFBHECdGBB.hAAA...fABChABAcGGA.HADADAFDECCGhAAAADIFNIBHMDCA..PAHBIAHFCDHA.hABA......hAGA...,1,-1,-36,35
RHeaSLJAFYXbNCQZBGdKDUfIMVcOPEgTW,XGBCCFDGZDBCBBABKBFC..DDCGUDCF..MAGBOBCC.EHFAhAAA..TACCRDGDeCABhABAaFHHLFDA.hAAAAIHE.FHBCNAEF..........hABA......hACA...,1,-13,-53,40
fFWeXETgObVINPAaZKGdHYBJRcQCMSUDL,aEHBKBBDHBEDBECA.JGDARGDC....CABC.MABEDBGF.FCHD..eCCEhAAAEFAG....OHFEhAAAIHBGADCDdAGD..hAFA..QEAA.SADChAGALHAAfDDEhAHA.XDFH,2,-50,-15,35
KODJAWGVbcISNMPXCYEFZLQTdUaegfBHR,GEDHVAAD...IGACSBGFMCACCAED..FGHDQGCBhAAAUDDF.aADGeHAEhAAAfBFEBGEFHDGBhACAKDDEJHEEAGGF..WDBHNAIE......hADA......hAFA...,1,-12,-27,15
GFKdCaANBRTHVOJeUWILZbfgSDMXcQYEP,RDBHHABHOAEHeGDA.UDGHLFFCZEAB....fDDChAAAgGCASADHhABADFADXBAGQAFFhADAEAAEFHGAdBGAAGIBNIAFBFCD......hAGA......hAIA...,2,-18,-7,11
VeHRWNZQKTLPMDOGaAIUFdCYXJcSbfBgE,FGFCCFED..JDHHSDAG.BAGDEGAFeBDGHAABRCFHZDCBTFCEhAAALCAB.MAAEhAEADDCGaFAD.ACHCIEHChACAdGGEXAGE........hAFA......hAGA...,1,-23,-32,9
IcFSOUPQfKGEYTWVdbBDReANCJgXZHaML,CAFBJDACZDACHAEGLEFGFGHD..UDGDQBCDGEDG.EHDC..hAAATABDdGGCDCGFAIAE.NAHE.hABA..aFAAMAIF.hAAAIFBCSDDEfABF..hAEA......hBAA...,2,-21,-20,1
CLQEGgKXeAYafZcRIDVMNFPOHbBUWdTSJ,aHBGZAADRDCC.DBHHMGFC.FAFBOBFF.BFFGdFECSDCAhAAA.JABECBECEGABGBGChABAKEHD.ACDC..fEBEhAHAIEAE....NAIE....PACDhAAA...bFDDhAEA...,1,-23,-43,20
dZgDfBYOAPbHRMXWEecTSJGQFNVUaCLKI,HAADRFEEMCHFXAFC.EFFHTGAD.SBADGEABFHGAhAAAUAEFLCHDKDCHIBCDhAAAgCCBDAIFBEEChABAADIHPHAEeFCBcGDC....hACA......hADA...,1,-4,-18,14
WDAKHcCMVNGLgTQZIRSdXaUbFYOPBeEJf,KCFCCFDD.MHFCGGEFLFDBQDEH.ZFAHIDDAdBAHUBEFhAAAFHAGODACBCACeABBhAAAEDHD...WAFChACADGAFACDH....cDGDNADF...TEAAhADA....hAEA...,2,-36,-13,23
WJDdVUXFCgOBcNPHTKZIGQeRafASEYLMb,SAFBLCCHMGEE..JGEGDBAAUDDCCFAGBEEB..PDAChAAAHAECKGDD.ZCGBQFBGhABA..hACA.aDHHADBDEHAG.WFHHXADG..hAEAOACGNICBIBBEhAHA...,2,-33,-29,4
CbAFaegLTSRcJfGOHPXNWQBdIZVUEDMKY,FEEDeCCHLCAGRGFE..JBGHGGEHHABA.XFAHQEDEhAAABFCDdAFBZAEHEDAADBEDMDIDhABA....KAGDhAAA.CBCCAFIH.aDHB........hABA......hACA...,2,-26,-14,12
UbPHOJYTBfdCVAKGNRQaDIWSLeFMcgEZX,GEAHQFDHDBDH.SFBBFDGB.MCIFEGGFUAGCHBBHOAEBhAAAJADC.BHGFdBAFAAAEhACAKGAFRFEF.aDFF...hBIA............hCBA......hCEA...,2,-31,-20,11
WVRYIAKUXSNFOeCTcDdfPEZLHbMaBJgQG,KEHBUFCA..XGBBFAGBCACH.DAADdCDE..EDEFLCABHADCaBADhABABGEE..QCCBhACA.VGFEhADAIHGESAHBNEIC..eCGFcEABhAEAfAEE..hAAA...,1,-2,-53,51
WYZXEHAJRSMIFaKcQPVDdfCebTUBGOLNg,JDCHSHDC.FDDDaFHB.KAFAQAAB.DBDCCBCGTGDEhAAABEAELFGBhABA.NAHG...YDABhABAXCEFAGFEMAIDPFABdCGA.eHAE.hADAbADF.....hAEA...,1,-28,-30,2
FfaMQRGcDIPUeHVZBNdTOAXSKYgJWECbL,SFHBKHBG..gCACEHCGLAACFGAG.MCGHREFHGBEGhAAADFAGUGAGHACDZBBGNFAF.hABATEDD.AGGCXCDAhAEAWEHH.CHEB.fHEBaAHF..hACA......hAEA...,1,-5,-21,16
IfZDUOaHPTgNVJeYMBLdbQWGCSXRcEAKF,KAFBFHBGZDCFOHDAHBDA...TCGDVBAC..eFCGMADELDDChAAAdFGAQFEChAAACHBBSAHBXBACEHGAAEEHhABADFIF.PDBB.NIEFBAGA...hACA......hADA.WFAF.,2,-23,7,30
HMdabOcYVXIWFeBZKDfCPLQTURESJNGgA,dAABOCCH..VBDGXGEDFHAC.eADEBCCGZEEADGGA..CHDFLBAFhAAAQDGEUGAAhABAEEAG.SDGEhACAGGDFABBFMAFCaBDC........hADA......hAEA...,2,-30,-12,18
UNbcYMJADSXPBZOIadVGTCRKWfQeELHFg,XCBFZDBHaDFH.dBFAGBCD..REAEKHBCQFGDeFFCEDDD.hAAALHEAFAFANIEB..hAAA....YCAFhABAMACCABDGSAHH.BGHEICHAhACACAGBfDGHhABA...,2,-23,-20,3
aKJVMUAONRBLYGbHQEWZSFCcIdfDXTegP,OFBBBFDDLDBHGGCFHADEQFFEEEDEZFGBFAFE..ICFFhAAAdBBDDHCGeDDC.hABAaAEHJCBF.MCABAIBENDIE.hAAAbAGB.CCCB...fDAE..hABA......hACA...,1,1,-28,29
efUDaWgAMRPKXGIZTQSVCdNYOFLEBbHcJ,MECGRDAGKGHHGBBHZABG..TFDDQEEACDFB.dAAFOFAGhAAAEBGHBHEAHAGF.eHFAhABADDIB.aCACADHH..PGAChADASGAD........hACA......hADA...,1,-19,-22,3
MAfSNKOeURcGTIJFDEBQHZVYXgWdbPCaL,SHBGOCCHRAFCGEFA..JFHHDDGEBFBE.HDFHZFAFXACBhAAAdDCDCGCAMAEEADFFKEDGhABA...eHCETBEEhAAA.IBAG.EDAF....hABA......hACA...,2,-31,-24,7
JWBaFbCKZEDSUMGegcLdOXAPYRQTVHINf,RAADTCCBHDBD....fDGAJAEABCBCFFCAKHGEDBFF.SGABhAAAMIDCeFFGLDDHhACAdCGBAFHA..PAAAhAHAYHCE.IADG.aAHHCGEA..hAFA......hAGA...,1,-20,-31,11
bVICMYKXgePFdZfTGOJUWREaNDSAHQBLc,QADCBAFBLFEC..bCFHCDBCMBHBKBBC..eBHDdHABZGDGhAAAGGBFOBABJCABUGGAhAAAECFB.DFCEAEDD...hABA.....cCCAIDDFXEBDhACA.....hABA...,1,-18,-25,7
STUdAQbFDOgYLMKHRGeCWNZIaXJBcfEPV,FGFCDEFHODBBLEDGHEGHeABH..CHBDZAAEaAEBBDHC.EAHHPAFHhAAA..VGBGhAAASCDBdBFCAIEA.bGDAhABAMADF..KAGC.......hABA......hAGA...,2,-24,-22,2
TeMDgVJYAbZfcIRaLCBWEXOHPUQdKSFNG,ZAAD..IFEDaGBEBDCCEBCEHGEA.UAFGQDAAdEFH.hAAAFCHFTACFDIGEJAFFADEF.hAEA..fFHChAAA.LGAA.CDEH.WAHH..hBAA......hBFA...,2,-31,-23,8
XDMUbeGACKLPQdYgJTVSHNOWaFREZBfIc,LCAFdGFCJACB.TFBHHFBD..ODDAFGHDEEFEZEGB.BHAFIHAHhAAADEBA..MAEAhAAAUDDC.eBBGCEEGKBABPGDEhABA...gAGE..hACA......hADA...,1,-17,-35,18
KLdWBHcSeFORAZEVgbCDPQYTJNIGaXfUM,EDAFVAAD..CCGEDCFHQAFB..TFFBJCEBGEAC.hAAAaGFEfCDEhABA.MBIFKGDEdCHGBHEDhACASADBeFAHOACEAIHG.bECC...hAAA......hACA...,1,-21,-24,3
bKROFVWGQZDIEaNXHSUcdgPBAYeJTLMfC,eEEGJFCALCHHMAAA..CCDB.RCAG.FBHHGAEBDIGA...EFFEXEBGhAEAHFAD..SACFhAAAdHAFBCBAAFIF.hABATAECfHEDOHEGWDEE...hAGA......hAHA...,2,-34,-12,22
DcWeKYRVdbfFGTEJSIQgALHCaOZMBUNXP,LFCAaBBDZGAG.UAAD..XGEGDGADeBFDRCFEdADFFDHD.GEEHhAAAEGBD....IHDGhABAADDBCBAFBEBE..hABANADC.cAGFKGGE........hACA......hAIA...,2,-32,-24,8
WOURNFPEZDGTIHJcXBQdSAaKbCVgMfeYL,aAFBCFED..MBFHeEAFLAHBOEFGUFDERAAF..FECDEGHBDADCGCAFhAAAHFFB..XCCAhAAAdACDAFIBKHFA.gBGAhABAfGAENIAB.PHCC....hACA......hAGA...,1,-3,-26,23
HEVDNMOdRLBbFJPTQZGafgAcKISeYUXCW,KHBGeCCHUCBBCFDG.HEFGDFGD...MBBAdBECLABHBFDD.JHCEhAAAQEABZAGB.hADAfCGCAGBESEEBhAEA..XAGGEHGANBIE.....hAFA......hAGA...,2,-29,-28,1
YcUbTOWRCVgAHXPfBeQMLGIENFaJZSKdD,XFDHBFDGMBCGLADGGCCH..ECAAFDGAZCGFKCAA.dGCCDGGHUFGGhAAAOFEDRCEB.CAAC.AABCHEAAhAEA..PHAGhACAfBBDQEAEIHABaAGA...hADA......hAEA...,1,-8,-21,13
gWLeaNKEAHSZcXYIdJOPTDUBMRQGfFCbV,SDAFXFDHdBFHOCEF..PHACDEBDBFHG.RABEGGBBhAAAFBCGCAAB...gAGDhABAWDEA.aEGGhADANAEBKCABAIHE..cECAIHGB.JFFE.hAEA......hAFA...,1,-26,-30,4
CQTJcNRYALOfZGeVHgEXPFadbSKWUDMBI,LEEGOFBBGAEFVBCA.ECCB..FAGDdFFBKDAFUGEFBHGECCAE..hAAA.JHDCRCFAABBG..eFBGhABAXFCB.aAAGhADASBBFDCEF.QGACNEAE.hAEAfDFH.hAFA...,2,-25,-14,11
dUDgceZICOfNGSEBQAYXRJKLPaMbTVHWF,REFHKGDBLAAEMFHD...TBGBVDDGHABHdHABUDDCDEAHeGAAhAAACDHH..OCCHGBEFhABABBBCAIFE...XGDChAEAaEBC.WAFC......hBEA......hBGA...,2,-26,-18,8
TMcXEIASfUBCeQHagYObWNDPZFKLGJdVR,UGBCBEFACFADQBCCHADA..aDCEOHDG..bABDNGEDZCFChAAAFGHHGGCF.dBHAhAAATDAE.cDEChABAIBAF.ACFHfDAGYAFCDIFA.hABA......hADA...,1,-16,-22,6
JVKAafFbBTMQLIUDXRgSPZNYOCWdeEGcH,aAFBFHBGBEDC..MIEELCBBDBDBRDEC.SFGFZGFC.OACGhAAACHDFeEAA.EGBCHBEHhABAKDAE.ABBE..TAGHhAGAUAAGXAGA..NEIEYHEAhAIA.....hADA...,2,-26,-18,8
DUMNTeaScgLHRdXVPGIJbZBFAOCQfWYKE,CFFEQCBC..fHEBKACBDFCFMHEAeAAB..aBGBSEBFhABALEDAdAEEhAAAXCCE.PCFChACAJDHFBGABABHCOFCB.YADENBAE.hABAcFGD...hACA...,1,-22,-29,7
KdbDJIEGeBWRYFHCPgaLVAfcXTSZNMUOQ,XCBCZBCFMDGFUCADKEFG..DIEG..EGCABCHH.RFCEHGAAhAAACFEBaHEA.AGHC...TFAEhAAANBAF..OAFHhABAdAFFJBEF...IHHHWECC....hABA......hACA...,2,-31,-30,1
CHRXdGAafQSZOeWKDTVNJLcbgEUPIYFMB,QGBCSDBDODHFeCEBKCAA.DGDETGFC..JHFEbADBhAAAUAAD..YDEBhABAMAFECBEE..HDBChABAXFCDAEHHaBHF.WAGFNEAE.LBCF.hADAEBHF.....hAEA...,2,-17,-6,11
UKWCfeAOJDQYVGLEXcIFNPRaTZdgHMbSB,JBFDDAFBQGDDGBACLFFD..XCDGFAGARECF.TBGChAAAZACGdHCDHEAH.SABFhADABEGEKGGCCDDBAHGEVEFGhAEA..........hAGA......hAHA...,2,-27,-19,8
MGcUHKBaIOCTdDZbeEQFPALSWVfRJNXgY,SDCDVAAD.RAAC.JHDE....gGDAGEBAHDFBhAAAKBHDBBFGaADCODCAhACATEGHDGAFZADF..EDHBhAEAPGAGAIHG.fGGEYBEGMAFEhBIAcDED.CAFB....hCDA...,2,-17,-14,3
KIcHDeMXVafPbGAOJQETLCNUdSFRZYgWB,OFCAQAADLDGHCGGE.UBDAFAEHRFAGZCAD....gDFChAAABAGEKGCGIABEhAAADDDBMIBE...aBGChADAfDAB.PAHD.AHFG.EGHFhAEA......hAFA...,2,-34,-24,10
bPKAZNOFIVCRDeBXWJGQSUTLMHfcYEagd,ZFDFFDCDCADEDCHD.BAHB..JBFEGEAA.QCECTFGALAAFhACAMDAC..HAEGhAAA..fGEEhAFAEABEaGHBdFFEKDHHACCG.OGAE.IBBChAGA.....hADA...,1,-18,-34,16
XdYfReKMNZcESCPgOVDITUAWQLBHbaFGJ,QDACLFCABAFEHCCGaBAAFEHF.XBGFdHEFRBDG...MFCEhAAANDAH.EACD.CGEC.ODFFhAAADCGF..TGGAhABAAICGbEAF....YAHBeHAEKAEE..hADA......hAHA...,1,-7,-25,18
SbcWFIeJBPVfRAZEDgXCdHKOLaMNGUTYQ,EGGEDAFBCBDAdCGC.HEAGKBHH.OBCCLBCDMIDA..UGDF..hAAATGAESBABhABAbBAFFEEHeCGDBAGBVEAFhACAADDB.....gGGF..hADA......hAEA...,1,-12,-33,21
PFVWGCHXNMEZKYSgQeAbIBDaRTOJLUfcd,BFDGaEAE.RFGB.OEFFUCBG.dEHAFHEEGACF.CCAA.HCFC.MHAEhAAAKDDHSBHFhAAA.QGCBhABAAAFCIACGDAGETEEC.LBFC.hACAcEAC...hADA...,2,-26,-26,0
gfceDIWQOXVbCKGSTMRdAPFHJZBYLUENa,FCFCHDBGZECDBAAFLBHHEGEC..aACB..fHABeBFFDDHHQFAChAEAOBACVFEBhAAAKHGE.SAGEhAFARDAH.AICE.JADE........hABA......hACA...,2,-22,-17,5
CPXTbceURJNgMDaALSYEIFdfVBWZQOGHK,SDCDEHBGFAEH.dABEBBACZDGDGADCCGEF..XAGAhAAATGEGeGAERCBE.NEIEDICAhAAAAIGALCGF.IGGHhABAWAFB.........hADA......hAHA...,1,-19,-38,19
RQdfCPUKZGONDTbYMVgLcJFAeHIWXBEaS,eFBBHAADXCCABHDDEFEG.RAED..dHBDCHAFKDEAZEFDOEAC..hAAADAFA.TAACMIFAgAGEhACALADBFHGGhAAAAGDAaEHDSDGH.fDBDhACA......hAIA...,2,-34,-1,33
VHgaQdGTAEUNCJMSXIcYfFBbWKPeRLZOD,UGBCCAFB.MFCEXEAE...IEFGfBFH.BDCGhAAAbBCG.KCAD.eHEGhABALCHFDGAFHABEaHBAQGGFhAAAdFGFAHHA.JEDH.SBAFhABAFBHDPDDA....hADA...,2,-20,-16,4
NDcSTYBHAZeMPbXIfRFWgdGQKJaEULVOC,MAGDXCBCREBC.FGCDdGFB.GBBBKDFA.EEHBLFFB.CCGEDAAFhABA..SBAFhAAABBHEAGBDeAFFIHAGhABA.fHCBQECD.aAEB.OFHFhACA.NDAE...hADA...,1,-22,-25,3
dSCNcUXTLQPgDHaMbZVeBYORIJAFfGEWK,GEAHEAFBdDAE.SACGCEHG.UBGFXCDFQFEH.hAAADCDHaGDHMFIDZCFGBCBBhABAOAEGIGFHhACAAIECfBACKAGC.NEED........hADA......hAEA...,1,-13,-36,23
HaGLYPCXMFNWDOZQAbgJdBfSUcITEeVRK,JGEABFED.SGGEUEBE...ICBHEEEEeACB.KBHBaHDEhAAALAEH.CGAG.hAAAFECD.DHBAQBAChABAAEECgBFAdEHEfHDBcACA..hADA......hAGA...,1,-26,-41,15
eWNROcVZUSFADYBaCdEHJPIXLfQTgGKMb,DAEDaEGD.EABDHAAE.JEAF..XFFGLDCBQDAAhAAAGBEDMACCeHDG.NDEBODDHhACAcEEE...UAFDhADAAHIBCHBHIAHEgGAAWHDE...hAGA......hAIA...,2,-14,-9,5
XbTCGFWaRHcgJYQAfLPUIBOdVSNEMeKDZ,LGEAUCBCBHGBOFCHdFCF...VADGEADGKGBFZEFE....hAAAXBADCAHGFHEC.aBGEhAAAHDGB..JDFE.hABAACCG..IEDDNAGGDBBG......hABA......hACA...,1,-26,-38,12
fFVKQAZBdcOLCYWPRXMHEIbaSDgJNUGeT,dBBDOEEGLDHB.CEFC.PHCEREDD.MGFEEEAC...aCFCSDDChAAADBID.JFCHhABANDAEUBCDGAEFeFBHhAAATGFFFHFA...KHAAABBFBBFB...hACA......hADA...,1,-18,-20,2
LMAETCHJQedNUIVaDPgKfXObZSYFBcRWG,EFFBTGDCHGAE.QAFHdEBGUCDC.VACDDAFAKCHH..OHEChAAASACCFEGGBHHBhABAREFGLAAFMEAAAFDFCCAF.hAIA............hBBA......hBDA...,1,-9,-33,24
YgTFJVXOGCAdIREeNUcPDMZQKLSfaBbHW,dCFCRDAGEAGEeBDH.UDACDCGDZEGDLGBG..aBBFHFFH..hAAA.gABChABAFGBAVEEDOADFAAGC..hAAAIHHCNIAF.MBIHSFADBAEB.hAIA......hBAA...,1,-17,-24,7
PBbJLfdZAVTeGUaWNgRIHDEYCMQcFKSOX,TBDGeDACUFGC..aAAF....gECCHFABEGHDCGFAMBGFhAAAQCGEFAGASACFhABAOEAABAGFhACAJHCELFAFfGCDACED......hADA......hAEA...,2,-21,-19,2
dQZASVaEWTIBXPJODMLHCKcReYNbGFgfU,SEHBVFEE.EBHHTAAC.BDEGXGEC.PAADhAAADGBGMCEG.CHEDKCADhAAAREEANADAGAEEFAGG.UGBEhACA...........hACA......hADA...,1,-7,-45,38
ODQVNUHeJZEKLfBWXadSbPGIgMCYRFTcA,OEGHDEFAQFFHUFDAHCAEZDAGLBDABAAC..aAGHSHAChAAAGEBEMEADCCBG.hABARACE.FFDFAIEA.eCFAKDEC.hACA............hAEA......hAFA...,1,-18,-26,8
IPZeXQGFAWCMDJURYdEbLBOSVTaKcHNgf,CBFDDGCGUGFDRDAA..dFFCLFADBEHE..OAACSBAH.hAAA.aHAGHCFG.fEEAhAAAIBGGeADHhACAXCBH.QACEADAEMIBAECFBVGBEhABAKHGA.NEIE.....hACA...,1,-19,-30,11
LMfcSUIRNXgVOJFBZdeHYaDPEKCGAWQTb,QCGCTDAC.LFCBMCCG.SFECICHHREEGNAAC..hAAA.XGDEOBCCFGAGhABAdGHEeAGFaHGGEDDAKABDhACAAAIH.WDDF.cGAG.....hACA......hADA...,2,-23,-8,15
aceXGTbdfAVLgNFMCRIJYESQPKWZUOBDH,VFDFLGEA.FFAARBAE...JCAASDAGKBEC.UGGGBFFChAAADFAFaCECeCGD.XBGFhAAAGAGE.dDDBABBCMEIDhABACFBB..EHAA...WABEZGAA..hAFA......hAGA...,1,-18,-29,11
HQEIDUGFcLeBZdfVgOAWbSRaXJTPNYKCM,SHBGXCCB..JDGHTDDG....NEFE.CHDEMFHDhAAAEGBFDFCEUBBD.FEBBLCADhAAABGFAdFDDfBGGhABAgAECAGACWEHHaCHB.....hABA......hACA...,1,-26,-34,8
UOcNJXDYPFBfWKIVaETCHSRGMLdgAbeZQ,eFBBQDCBUBDH.OHAG..JEFHDBFD.FAGCBDGEKACG.IHHDhAAAEEGBHAABRBAFLEDBhABAdEACAEIH..cFFChAAAXAFB.fAHAaGDFCCGD.MDIBhACA.....hACA...,2,-22,-19,3
cOLIVZSdNfQTDaCWBEMUKgReXbHYGPFJA,OEEGLFBBZAACdBDH.QEEGaAGA.CAGGBEDDMDAEKBEFeCBGhAAAHEAFGGEF.FDHDhABAJEHBAAHE.IGFHhABA..NCAADGDF.EBHFgGCC.hACA......hADA...,2,-23,-12,11
ZXfTRNPKbWBJVIQHGaMeDULAdOYEFgScC,OCCHEAFBFABD...SABGCEAAZGFA...TBFEREDF.KEAHhAAAbBGDBFFH.IEHGhACAHGAAaCDGDADEAAID.dGAHhAGA...gBDFfDBBWHDA.hAAA......hABA...,1,-22,-30,8
XfLdVWAJBDHNIPGZEFKTQSabRgeCcYUMO,DGGDHAAD...NCDEGEEDEAFEKABC..QEEGaADF.RDGD.gAFFhAAACEBG..hACAUBBFOAHFLECBhAAAdHEFAHDFIHHEFAEHSHAGbFAB...hAFA......hBDA...,2,-27,-9,18
bAHePKVSaDBUZTQEOFLfJXdGMIgRNcCYW,HFDFKDCD.aEBGDBCABBCHUFGBZFGF..EHDEFBAH.LFCF.hAAAXAEGMBHDIHADhABA...NACB.hAHA...CBEA.WDDEAGCHeBFHPFAH..hAAATEDE.fCCDhAIA,1,-35,-36,1
FIfYKTDgdSeGJMANbXVWQZaBLHcPOEURC,XCBCQFDHBCHBHAFH.OAAFEAGACGAG.FEHF...IDDAhAAAKEGGTGCDDGGFdAHEhACAGAEEAIHE.VABE.hADAaHGELEBB.cADBPGEA.fEAEhAAA..hABA...,2,-23,-9,14
eKbFCNBGZYdMORVUXPgISQJHEALWcaTDf,LGEAaHBG.DDEEKAGDCAEG.BEDEGACAdBEGRCACUCGC..XGFAhAAA..IAGAhAAAJABEHCGFAEEGTCAFhABAeFCG.FFAC.ZFCFMIDC.....hACA......hAFA...,2,-26,-23,3
JWFUPLXDIGBNCgcKEbAHQYeaRMVOSTZdf,QFDHaDCD.MEIFOBFAZACGdEAHJABAUGFGLBGH.DIDEhAAABEECCAHB.KGDDACGFHCAAhABAeFAB.SEDChACA.fGACFEGEICEE.NAAE.cFFAhADA..YBBFhAEA.,1,0,-46,46
LGFaUfSXdeOgNVAcZJCETKIYRBMQbPDWH,ZFDFEDABKECCRFAGBDDB..QAGDDCAGHFGDFDHFaBDG...UAEDhAAASAAH.dFAHhAAA.gEGAhACAABBGCAHE.IHEAMCFFPDAC....hABA......hACA...,2,-33,-21,12
abfCHFAXYMZBOcQJDLKRGEgSTIPdeUNVW,MFFFZFEEBGCH.OCFAQGAC.DAFARCCAEACASDAHhAAA.TEGHIAGGhAAAdCGBeDCFUCAENIAFaBAB.hABAfEDFFEFG.ACCGXGGA.hACAJAEFKFAC....hAFA...,1,-2,-27,25
QcbWHCJFPKRgANDUBYELeVIMOXaTGfSZd,DAFBBHHGLFEFeDDGMAGFOAGB..aGGGGBAGZACG.dACAQEABhAAA.bECDhABAWAHH.CHCCFGFGKAHH.hACAAHHB............hADA......hAEA...,2,-37,-26,11
gZSEMYdOeRILNaWXFATcUGCPfbVBHDJKQ,TCGCUFGHCFEA.......PFBGbAGD.HADCKCDC.QCCEhAAA.SFFChABAYGCAOABHhAAAeGAGIHGCLFBDaCBB.FAHFAAGHGDBBhACAfGEEBAEHDACE.hADA...,1,3,-32,35
RFHbJWXLaAGUNPgSKedTMOIBcQVfEYDZC,UAGH..NHBF.SHDAKABDdFDB.MBACBCAD.QBFDhAAA.ECCHDCCFCFBBHEGBhACAWDFBLDABhAAA.AHGE....PHAGeAFE.IEHFhABA.cEDE.hADAfAEE.,2,-35,-24,11
RCdVBaJMWGUIPKZNAOeDcQgTLHYXEbSFf,eBFDDAFBQGDDLBBEHEFG.EDCHFCDHCHDHBBGCMDBFGAAFhAAAUGACKDACACIFODFHhABA.TDGEXGGAhAAAfGHAdEECaCHF.IHACNABF.gAGHhADA.SGGFhAEA,2,-14,-8,6
aFPYSJCeQEAIBWRVMcHZDKgUOLTfdXGbN,BFDGRGFGMDCCHDAA.DGFCKHAAOCDALDHBdDHG.GBEH.aDAFhAAAPADC.SHAAhAAACFFFEABEAAHC.IHHGhABAVFBE...cAGA...gDDBhACA..hADA...,2,-36,-17,19
RCJPfYOVXagbZcdFDBTMeGULESWHAKNIQ,KHBGQCBCRFCE.JHBE..PCAF..fAEGhAAAOFHDaBAAZEFF.FCGEBCEDhAAAMEIHUAGEEAFGSFDChABAAEEGCHFG.XABE....hACA......hAHA...,2,-40,-23,17
QBVcGLXANCHdJgRYTKSOPFUWMIEaDZbef,HDBHJCCH.RABAKFFGOHAGFHDE...MBFCaGAH.DGCEZAFH..eADDhAAABFDGGEEDAHIB.CHHAdBAEhABA.....hAAAgCFCSCAF..WAECIEEEhABA.....hACA...,2,-33,-30,3
YXBWCZKSfVEMFHDcANgQTeOIaUdbRLGJP,QCBCTFCA.eFFGOBDHUGCEdABELBACGDACPFHHhAAABGAHCAEDKHFE.SCHFhAAAVAEFMEFFDDEGNIAB.hADAaDAH..JAHF........hAEA......hAGA...,2,-22,-8,14
YOgETLSbBHacGQWFKVNMPIfeJAdCXUZDR,dFFBUABHZDDGRAFD.OBAH..EHBALBBESDEFHBGHGEGChAAAFFAFKCCF.MFCDfGEChACAAHHADEIH.TFAEhAEAaFDD...........hAAA......hABA...,1,-21,-23,2
HdYXCaKecBQJEUDWPTZVROSLfIFANbMgG,MCCAGEDHHCFCdAHGCABDeFAGBECF..JAEAUBEDDBAE....TGEBhAAARGECSBCHhAAALDAEFFADAFEB..NEIA..hACA....YHAEaDHFKDAD...cFFAhABA.EEBE..hACA...,1,-18,-28,10
IJQCcFMKBaEOWXAGUYPVZHeLRbdfgDNTS,UAGHVAAD.HBEFLFFHdCACDFGH..SFBDJFHH.CGEDFFCFhAAABGEA.OFAEADIHGAGEhACAZABA.RCDD..fAFAhADANIDF..ICCFMIBA.aHAEEADFhAFA......hAIA...,2,-29,-12,17
YQFSEZJPReMgKcUGXWVNCABdfLDHTIbaO,dEGDLFCHDGCAHADATAAC..aCFAQAEEFDCGZGAA.RDEGMAHBhAAAKGGCUAAFGACE.hABA.XFED.hACA.NIEBBGHEfDAEIGBE...hADA......hAFA...,2,-24,-8,16
XHdgFcZLVTWCaSfGeOMUKIAbYEBQNRJDP,EHBGQGGGRAFB.DAFEXEFBHCAFFDHDZEAELDDB.VABEhAAACAHBaBCE.GEDEhAAAMFCBKBHFIGHAADFBBGEAhABANDAH..dABF.........hAEA......hAIA...,1,-11,-16,5
YRgXZKGCQAPNbMOJLUISeBTEdVcFHfDWa,...bDEGJAFE.LDCFUAAB.eGDABGDCEBBEdEAE.FADFDIGEaHGAhABARDFEZADF..KAFFCGHG.hAAAAIBC.MFABOCHFSEEGhABA..cGDDfCAA.hAGA......hAHA...,1,-18,-35,17
fBGQMPaRHTcIENFWKJeAUgDSbdCZVXLYO,UAFBDGHHdADECEEA.ZBGBLBBF..OGAGBHEFGACEMCCDREEG.hAAAHCFE..IABAhAFAFGGFKGAEAAAC.SFGEhACAVGDE..fAFA..hAHA.aDEG....hAIA...,1,-27,-33,6
TNAVSMFgKcDeOIJafRCXYUPbHZGdELQBW,SHDCMHFGFAHH.KGHFeCEE..JEBCREFACGAAUACG..HDAGhAAAdAGBQBFFhAAATBAEADIH...VFAFDGEH.hABAaEEF...YBAD....hABA......hAFA...,1,-26,-28,2
cRHITgPFGUVbBZDKSAOMWJNXQaYEdCLfe,MDEBJGEA..QCAFEGGHLDFF.eCAHHCGH.IAHChAAATFBBFACBUGBEBDCHhAAADCECSAEGhABAOAHHNIAB.XDDF.aBBGCGADfEHEhABA.gADHhAGA..,1,-5,-25,20
gLWDAFPcfTVBHbeXMaKJEQOISCRYUZdGN,FHBG..fDCDBCCDeBFAMCBGKEAG.EEGF..OEHFSEBGhAAACGEB.RGACZAFDdACHGDCFhAAANIDBLABEAAGG.hABA.....cGFD....hADA......hAFA...,2,-39,-12,27
EQBAUWDMFYSTgHbKadZCLXPVIJRNOGfce,UAFBMCHFFBDC..SGFEHEEDKGAHdGCBCGAFLAAF..hACAPAAFVDCFRGCA..hADAOAGB.cGGHhAAAEBBBABIDDFFC.........hACA......hADA...,1,-29,-33,4
EdCTAPVOUYbQeXHKFcJIGBDLNSgRaZWfM,VFDFODAC.UBCEQFADHDGB.FDCBJEEHBBDELHBG.hAAA.SGGGhABARAFCZFAEMAACdDFHAIHG.PAFEhACA.....eBBFKCFD.....hAEA......hAFA...,2,-18,-18,0
YMLONefcBSTEDXKAbdHZQWUFaCGgPRJVI,dCFCZBCDQFGDFAGCGEBEREFA..JFBF..VACBMFEH.OADAhAAAeAAFBEAE..hAAAECAEKEDBADHCHCFBaGHBCDHB.hACAIABF........hAHA......hAIA...,1,-19,-25,6
UMgcRfbEKBNQOTaGDXdPZALVJCWIeHSYF,JFFCCFDG..eBADHCAFFHEEMFDF..RFBDEAGEKGADQACEhAAA.aBGDDGFE.XAAFhADAdGBEAAFGLCCAhABA.IHEESEFA.gAEDhAIA.cCDABFEDNEEFhACA...,1,-16,-32,16
JCdXUeZcYGRDAFMbEaIOSPfWTNBLKHVQg,FGFHMHFGEAGD..aEGBODAD..SCCA.fGCBhAAANFEFBGCBKABFHEAEhABAQCDGCCAEdAHCeCEHhACA.ZADEcAEC...YHAAhAAADEIHABBG.IHHA.hADAWCCD.,2,-48,-6,42
NMfHgFdULRVGEaOcBYeXPJSIQCDWTbZKA,MCCAHAADdGAHUDBELECGGEGA..EEFHaGCD.BEHD.eAFAhAAAPHDESCDBhACA.IADFDHAATAAChAAAKGEAACCBNBEDFCGE.ODABcGGA..XEDFhACA...hAFA...,1,-7,-22,15
GWRcODPdZQEaHSXIUfbLMeFgABVJCYKTN,BEFAVFEE.CGBC..KFDHGGAB.RBEGDEBCZFGBQAGDHABE.hAAA.IFAEUCCALBABhAAAMIFGeDCEAIACJACEhABANADH.....ODFAEBABXDGAhABA..FHCC...hAIA...,2,-27,-5,22
dFKbEWYDgPIeMcSUZRQTJHfVXaOCNBAGL,LCDGKDABECEF.DIGE....IADAeFFHSAGGhAAARFGD.QEABhABATAAEJFBBfBDBhACAaGEHNCDAGAGGFCHF..WEEE.PHAAMDIF..hADA......hAEA...,2,-26,-16,10
CgYQKeOUTRLEXNJSDPVIfcbZWaMABFdGH,BEFAGACBCHDH.QFAGKACG.eCHBUAACRFDCEDEH..XAEFhAHASCCD.DAAChADAVDCEfHGHhAFA.ZCFFaGHDAAIF.FCHH.dGBA.....hAGA......hAHA...,2,-41,-4,37
fbXTOHWLQANIFeURZdVEPDaCYMBcKJSGg,FHBGUAEGRCADZDDHECGC..DGGG..CFCDBGGFKAACGGBF....hADA..fAEDhAAATEDHOCBDHABDLEHHhABAADDH.IAHHeHFC.dDFE..hADA......hAGA.aHDE.,1,-27,-29,2
TbXIQNMeWFRcYUaHACJPOfGgSKLBEZdDV,CAFBJEEG..OEACGDAAKGDHLAGF.ZFGBDDEH..TBCEhAAAIAHG.QGGGhAAANIBH.MCEEhABAWEDDFCHD..cABBaFFHADAF....PBBGhACASAHH.hADABAEC.,1,-31,-34,3
CUDNIASPTcXeJVBHGFOKWZaEfdMbYQRgL,TGBCXDAC..eAAFJFFC.HDFBGBDDKECGZAEGEGBG.dEACMACFhAAAQCCD.LHEAhAAADBBDIAHDhABAAAIF............hADA......hAEA...,1,-6,-36,30
PdNcQUMgLHWBZSebRfaYKACTDVEJGIXOF,CEFATFCADCBA...EAEAJFEFGBEH.OCCCFDAHdGBE..NIBD.hAAAUGGHLEECBDGE.hAAASGGE.hABAeEABfAHCKCAEIAHG.cGFChABAgCDH..hACA.WBDE.,2,-54,3,57
FMNGKWfbdQVJCETYBcPaALReXOUDHgZSI,eFFCXDCHDHBEHBBFZAEA.FBFHMEEE.KFGE..fEADhAAAdCAB.....hAAA.VGDECGHCTEDAhABABAHBcGADPAHFAHIFODAFSADFICEEhABAWGAC.JHEA..hACA...,2,-23,-20,3
KYNPDIBACMgTbEZOfaFeGUWJLVHXdRcQS,CBFDTFDBZCAC..OFDEFBDGUCFE.LBAFHGFGdEAC.RDFGQAAEhAAAKHGA..hADANDIA.DIAGAGACMHAEEAHF.hAEAeAFE...JCCF...cFFDhAAA......hABA...,1,-19,-24,5
ZIcNGOTVbAfdKSWaBDCPFYHUgMeLJXQRE,dAFBKAFB.SAAAaDGGBECF.DDDH..FFFHUCGG..eHAGXGFGhAAAEFCAZAAF..IGBBhABAGADE.TCEEhADAAHCGCHHH..PEHBgBCCMCAB...hACA......hADA...,2,-29,-24,5
gHJOYcVSMbXZDTUGQfFKCLIRWBdAPaNEe,aHBGeCCHHCCCOEFG..VAACMIAEZCGDUBGFQGDCKDAFCBBB.hAAAREAEBGGBdGGE.NADD.JGAAhABA...SBDEhACADEFH.TEDC......hADA......hAEA...,1,-13,-21,8
CXAGKIcOdRPaSFJUMWTYZHBLfgQNeVDbE,KGAHOGEAdDEGRBAA..aAFEFHEG..UAAF.MFAGTADC.HDFDhAAABHCBLDAAhABAQGAEeAGBVBDDDGCCCFAChACAAEHFIDBD...SDGFhABAWFGH.....hADA...,1,-19,-22,3
JDNBILfXGbYcFQEaHgCRMVWeUPZTSAOKd,OEGHKEEDDGIBBFCELCCC.GAEF..bEAHFHAC.EAAHaAAChABAHDAB.CEDDMCHBhAAAeBDHUGFD.TCGEhACAAHIFdGDDNIDF..fAED.cAGFhADA.....hACA...,1,-11,-31,20
QNHFTAbRPCdZgEDIGcSYKBeJLMUXVaWOf,RAADdEGDZDGFEBFHGDEE..SDBEBHHGeEBAMEEDUAEAXAAEhAAA..aAHBfHGFhABAQGBCHEBFhADAAACFCADDDGGBYFAF.KAED....hAFA......hAGA...,2,-20,-18,2
BOTKbIUaRDfgYMFGEeWCNAHQXSLcPdJZV,QDCBXGGDLACGdHGBZBGHBCFE.ODADTEFEKBAEIAGBhAAA.RGDADABFhADAfGECMCIHFDDAEEFDhAAACFCAAECESAEC..cCFA.hABA......hACA...,2,-32,-12,20
EUbSMYDWABPHJgGXFfZTICKeVadQNcROL,HDBHGECFFBDHZCCGCHBE.KCHH..aDFAdAGE.QGBEREFELAEGUACGhAAAMBAH...DIGGhAAAAEHBBHGA.gGEAhABAXBGAIFAENCBE.EFEB.SGGGhABA..hACA...,2,-23,-18,5
FVIXRYNfBHLWdAEMOcPJKUaGgbSTDQeZC,OECCJGEA.KGDBUDFHGAFG..SAGBDACGZGFA.FFCDXCCAhAAA.RBAF.NBEGHDABhAAAdBHAAIGG..MFABhABAaCAG............hAFA......hAHA...,1,-23,-42,19
EdAYRLgeJKDSaMbONUXHVIfFCPcQZTGBW,RFDFLEEGeDAD.DDBHSCGDMBAA.OFHDUGBGHAFH.hAAAICECCDEEQBBHhABATGGABAHH.dFFEhACAAGEEJCCFaGACXECB.FBEG...hAAA......hABA...,1,-5,-29,24
cLUQFPJZTORgDAIMKSCfHWVYdeGaNbEXB,MHFGKEHBCCDA.HCCC...VCGHdEEBaHBEEGBBBBEBLDBH.FAGGhAAAPDAH.ZAACOBBAhABADFEBAGCC..IFFEhABAfCHA.....YCAFhACANACF.XFFChADA...,1,-11,-42,31
BRMVbHKNUGdaAFZDSYfOJLgEeQCXIcTWP,ZFFADGHH.SHCAOEFDLBFE.ECDDCFDGXAEC.hAAATBGGPBBDMDDChAAAHFACUFAAaHDCAFHGfBBGhABA.JEFA.......hABA.eDEHIDAAhACA.BHHD.,1,-12,-20,8
THESBCNRIcdKUAfeJWPDZXaQMVFYgGObL,eEEGJGEA.DEBCZCAF..aBDDMBBC.FGBBGFBD.LADChAAAHAFFSDHBhAAABHEDCGHCICFFKCCAADFH.fBAGhABAXEFA...YAHB.hABA......hACA...,1,-21,-36,15
FVNIOKTHJUeBbDdSXZEcGAYfRQPCLgWaM,RAADCHHGLAHB..aGEEMCDFFDFE...VBEHIHAG.hAAAOGBGKCBHJHCEUADEhAAAeEAFBDDGdFFBSBAChABAXAGAZFGBEGBAADID.....fADHhACA...hACA...,2,-33,-16,17
ROecAgWLIMTCDBUHPSXQGJdfbFKaZVNEY,LGEATFDB.BAGEHCCASDFDQAEEGDBGdHDHfGGBhAAAFBABKDHH.ZDAHNCCF.hAAAEABC..OFAHhABAACIDIHACDGDF.........hACA......hADA...,2,-29,-4,25
PCcVQNeBUSARJXaMWgIbZfDTFHGKLdOEY,JBDGaBDH...MIFA..gEAEZGDEDBBAHCAFLEEG.hAAAdHAFOCHFEGDH.CEGCQEDBhABAeBBDSAGGhAAAXFAAIHHHfHAB..hACA......hADA...,2,-27,-17,10
fCTaSZJIKVXLbPRdABcOUDHWgYFEQMeNG,BAFBODACDIGGHFDG.....gDFBEFDHeADDGBAAhAAAfBAFCAHB.SFBHhAAAZCFBIEHBKHGGVAGHhABALFCDPADGAGHC......hACA......hAIA...,2,-32,-15,17
gMYGVFTEJfCDULOWRXAQZedBbPHcKaINS,ZADGBDGFHFCGaFFH.SBAE.MFAHVDBG.EHGACBHGLFHBhAAARAAEAFAB.QDFChABAdHBB.bDAF..hACA............hADA......hAEA...,1,-12,-49,37
DHWGTBLFdCENPaMJOcgVIUYQRKXbfSZAe,DAADHEBHGCFELAAEFFCC.CEHFEAGG..aGAFJDEB..OEHFhABA..cFGHIHCGhACAQBBGXBDHhADAfHDHSCBDeBEGWAHBBDDC.hAEA......hAFA...,2,-33,-8,25
gPOAGUXHBcIbFVDeZCTdKfLMNWJERaSQY,UCBHXGDCBFAF....IBGHFFECeFHFCBDF.dABBKBAGLAHBhAAAMECG..JFFCaAEFhAGASGAD.hBAA..gCFGADFAHGBC.cEACDECD.hBCA......hBEA...,1,-29,-30,1
fHLKdNASIeaTWCbVEQJFcZgXMUDOGYRBP,eCCHTGBCCFDG...EDECFBEAZDAC..XGFEDGEDGDGA.BHADhAAAHAACdBCFSDAHhAAA.aFEAWCFEhABAVCGHJAFEMFIH.YHBA.fAHEhABAKFFDACAA...hACA...,1,-7,-23,16
IXYZbMRLPOBKJGNVeHfDgQTFdcUEaSACW,CFDGXCBCZAFA.RFDF.LHAGBHAC.JEFCGEBE.eBBGDAAAQDAAhADATGFDFBFBdEDBhAAAEBBA.ADAB...ICGAhAEAMFIFPACA......hABA......hAGA...,2,-39,-9,30
TSPaMLFbJGIWBUROcCVgEXdYANQHDZefK,HEFHDGADZAADeACDKFFB.SBGG.aHBCMDDBLFAAFBGB.hAAAJBAH.GCDEIHEEhADABDHCOFCHCAEAEHGA.hAAAXEGFAAIH...fEEChAEA.PBEB.WFABhAFA..,1,-10,-33,23
KOcLbBSfFNIYCWEXMJVdGTHQPZDaRegAU,UGGDOCCHLBGHBFEGFDGH....NACB.CGAA..EGCHJAADdBACHCDDhAAAZBFA.DGCB..aBEHhAAA....eBDEhAHAAFIFKHGAcGDHSEAF..fCBAhAIA....hBCA...,1,-30,-36,6
JSYEdfUFLINXKcOCGVMeDZHAbgQBaRWTP,QCBCaGFH.RABG.PEDC..JGFGSCEGEFAAUGDEFAHFhAAAICAC.XAFFhAAAKCGHCEEDMADCDEACABHGhABA.bEGB...WFBH...TABHhADAfDFE.NBAE.hABA...,2,-31,-17,14
LCdDKXWVOEcUAINBHRfePYZQMJbSaTFgG,BFDGHGFGeAAGZAFAMFFCJEFG....aBFFFCFFLCCEdCCCDCHF.KGADhACA...XEBDhADAOEABEABAAFIBREDBfHCBhAEA..YAAF.SHGAhABA...hAFA...,2,-42,-13,29
PSRBOcZUdCQWYEGMfVFDJKXbgeTANLaIH,aDCDHAAD.SCGHOBGDZGCEdCEH.CEBCQGAGEGABGEEBMCAGhAAAFAFGKFFB..XBDBhABAbFCD.eBFFAHFBNADE.hAAAIHHGBFEC........hACA......hADA.WAFE.,1,-6,-10,4
UOdDeIMFgEfGWVCKHTcLbaYZJQBRSPANX,XCGCUGGDDEBC...eFDBMFCCFEBD.EGGB...GDEAhAAACBHCKACGHAEBLHAA.hAAAaBBAZCAEBAEDPHAAhABAAHBGdAGB.IDAHfEGG....hACA......hAEA...,1,-5,-35,30
egAEGKXCINBPYHTcSLaMbWfZJDFQVOdUR,KDAFCHHGBGFDHAAB.SBFHLCFGMDEF..fFGHhAAAZCBBDBCG.QGEChACAdAGA.RECFAAGEXGBEhAAAPAHF....YFABaFAC...hABA.JFFA.FCAF..hACA...,1,-8,-32,24
eTDFECJBZRMaYLUAVWXGNIfgdOPQSHKcb,XFDHGAFE..fEEEdCEAOAFEQBBBKACE.eHEAhAAATAABEECBBFHFhABAMEBFaDCB.LFGBhAAAADIFWFAFIAEHSDGA.....hACA......hADA...,1,-18,-22,4
fBLNJEWTAYKQcVZRPSDHMaCdgUGeFOXbI,QGBCVGFG.RAAFDCCAaBFB..dGCFUAFBeCBAFDDB..XEBChAAA..bEFDBAEChABALFEDNEEH.EDABhAAAAFFEKBBCZDGF.SBHBMAIF.CHAB...hACA......hADA...,1,-10,-25,15
HbSdLgQOVePDMYWRNABIcKCJTZfGUaXEF,BFDGKHBGCCDA.ZBEGGAEFUGFE...EDGEFBBCHDAFdFAELDDAhAAA..QGEAhAAAeAECDDIH.MBAD.WDCAhABAAADF.IBBC.JFCE....hACA......hADA...,2,-42,-18,24
XdBYFGHPRMbQCDcKTENVgJASeIWOULfaZ,eCCHOGEALBABZFADBCCHFFDBHBEARFFC.MAAFCHBB..DAGATDFEhABAEHDA...NEIE.VADEhAAA.ABIB.SHDEhACA.IAHDfCGEaBBB...hADA......hAEA.YEBC.,2,-27,-7,20
TdNDaUFMfCHcQASGPVKRebLWYOgZEXJBI,GEAHVDAG.eHBELAHBOABAZGDAEHGGBHHG.dAACaAEEMGFAhACACFEAHCCE.ACBHKEHFRAFB.hADA....WAHBhAAAYEFG.XFAC...JCCChAEA......hAFA...,1,-13,-18,5
AKUIDGZRSVfBLMXeQCdFWHaEbTJNcYPOg,UGBCDCECREGF...SFGGBFAFLEEBeDEC.CHBD.dAFEHCBGEGEG.hAAA..TFBGJADD.hABA...NBBG.PBAAhAAAAIHA.KAEAIBHE.....hABA......hACA...,1,-30,-34,4
UZdWcGXLDATNMQSOFIEfaJgYPRKbCVeHB,MFFFQGGDFDCC.EEBE..JCAB..gGAB.RACGCBFAhAAAeBGBBGEAdFBCGDDFhABAXACADAIFADCGNAIC.ICAEhACA..fFDC.aGGHhAAA......hABA...,2,-45,-12,33
WLOeJaYfHXbAQMRgBEGKdVFISPNDcCTZU,QFCAMECGBHEFKCGEFBFB....IDCFSAFG.DGABhAAACAGEUAABLADHOFFEhABAaACHHFGFADBF.RDFFEBAFhABAdADENBIC.ZFAFJFCCfHEF..hAFA......hAIA...,2,-24,-14,10
KfYPbLeZdUCcMGORSTBFIWJADaNXHEVgQ,DGHHXGBCHEBHEBGH..VDGDQBBAKAHB...fHADhAAAPAEFLACHhAAAeADGUGEAMEEDOEDGhABASEAGBEHB.IBAEAFAF.NIDF..hACA......hAFA...,1,-14,-19,5
BTfJICDPVcUHKMdLGAFNeSQgYOZbXaWER,eCCHQGBCOEFGZDEA..aBAFEFCEBHAETAAB..JHDAIBFBhAAADAFD.PDABhACAUACHKHGELAHFhADAAFDFSGCDbGFG.RAGB.CDCG......hAAA......hABA...,2,-31,2,33
YGOfLEFAVWDTaZUKdRcbBHXNSMJePgQIC,DHCEZBCFKFHFdCFHRABABGDC.HCFD..SGHHMAAC.JDEHeFBDhAEA...PAFGhBAAICAA.CEGFGEAEhAAAfBECLAFEEEBEAIEA...WDDDhABAaGGH......hACA...,2,-38,-19,19
COIGFgdHcaXTPeDYVJbKLERSfMAQUWZBN,QCGCZEFHBCECCBHH.OCDDGBBE..dBBCHGCEXEACeACGDFIHhAAAJADELFHDhAAARFAF.SFFDhABAMAFCADFC.UGBCNIED.IAHH....hACA......hADA...,1,-16,-19,3
OMgaUTeXfHJARBcYVQDNIEKWPdbFCSLGZ,BFDDVAAD.DDAA..EDCAKAGC.dHEFCGHGLCGFZAEF..OCBAhAAAaDAHUFDD.eHAGhAAAHFFCABGE.....hACAYBHBNIED.IACAPCHDSBEBhADAMEBC..TGBBhABA.,2,-45,-12,33
UbYXaOSZcJCILDAgTNRPQWFGVHeKfBdME,TCBCRAADQGDD.FEDGVCFF.HFCDeEBDBAFEMACAUFFDhAAA.XABESHGAhAAA.JCDEIHBFhABAAGAFPGFGKBEDdBHEEEAHaDGH......hAGA......hAHA...,1,-9,-13,4
fFgKbMCIdHDZLUcPGSBTQAaERJYeWVXNO,aEHBEDBDREFF..eABH..VBCBODCCFCHF.KFFF.CHDE.HAFHDAEA.hAAALABEUBFD.cFDHhAAASEBG.hAFABHAEAIHEJHAE..XGBB...hAHA......hAIA...,2,-33,-15,18
bIBYMDHdaTQGXfcAZJKePgWOSLNRFCEUV,ZDEDKGDBeACB..PBDAOEFBLHDCFCHB.EGACUGGG.hAAA.VDAABAEADCAA.hAAAaGGFTGAHGAGE.hABAfEDAcBEEAECE....gDADhADAWABCNEIE.CBBD...hAEA...,1,-3,-32,29
RcFWMLVIYdDaOgHUAEZTGSPQbeNKfXBCJ,TCCBSGAH.QAFEeEHDKAHDBAACRCDGFGFE.MDABLEBAhAAA.VABCIGCChACADGEF.gGFEhADAAFIBEBAB.ZBEH.........hABA......hAEA...,2,-22,-19,3
VLaKFUXcCNIMJHQBTWefYgPSZOERdGADb,VFDGLEGH.aGBEKCCH.FABHUADA.CABA.MAFCHDEBBEAB.hAAA.TAGDeCEC.fDBEhABA.PHDEhAGAODHF.dHGHAEDHDCIBXGBG.NBDB.hAAA......hACA...,2,-35,-11,24
dEbJPKCXSfgYAcRVDNZBaUTMeQIWGLFOH,RGFGDHCEBEBGUCGE..eAECQDCBGDEBFHBCdBCF...ECDFJAAFhABAKFCG..CAFC.XACFhAAA..fFFBhACAACBF.NEAG.aBGCMIBA...LHFAhADA...hABA...,2,-31,-28,3
FSGROMNAXYCJEIBUdagfKZHTPbLQWVecD,CHHGEDCDUDDHdBAA....aEEAKAFCZAGBHABD..TFAHLFBBhAAAQGGEeBADDIDGSAEAhAAARDGHMGDEABHD..hABA............hACA.XFDA.hABAJCCABCECfDHA,2,-23,-10,13
OEMFCHfSLBaWUbKTJZQdGVgRPNYDXceIA,MEGFCHCHHACBLBADBCGCUFFEKDCGZBCG.dBHEGEAE.RAEA.NGBB.hAAADEGG..eHAAAFEBFCAChAAASFHH.hABAaHEC...WAGF......hABA......hACA...,1,-26,-35,9
FKdWSPfIUHBXJeMbOgZYTLAcaQVCREGND,QGBCCEGHGDAEDEIHKEHF.dAAC..SGED..fECGhACAUAECBEDAXDEAhADAJACD.bADEgAAFhAAAZFDBLAHBAHHHaDEAECCB.NEAA...hAEA......hAFA...,1,-13,-35,22
TUEIYcLPdCVXWZSHFKfMgJDOeBNGQabAR,TDCBEGFC..ICBALAGB.CEAB.VCEHZFED..FCAAKADGMCIHhAAAJGBA.DFAHBECGQADFhABAAIDERAGF.UFCFhACAPDABdHGB...XEGA...hAEA......hAIA...,1,-12,-27,15
bDcPUEONMQICaHGYRfdATFXeVZWLSKJBg,TFCAFGDDeHFA.ZCAFSAAHBCDF.DEAEUDFE..EGFBMDABhAAACAHBHCFD.RADEACIFXBBBhABALEHBKAHF.hAAA............hACA.gGAEhADAcFBDNCIE.ICDD.,1,-11,-33,22
JYHZbcATVOUaDBMdESFCQIfXWNLRGKgeP,VADGUAADDEGB.BBEAECGA..FCBD..CBGA.QGCA.hABAXFFGNFAFGGABKABFhAAA.eDDEJDDEZEGBAACEaGAHhAGA..MDACSHFA..WFHHhADA......hAEA...,1,-10,-44,34
cQDPKUMFdOBYTCGaIJbReAWENSgXLVZHf,EHBGSHBGLFADHADBQDEDDAHBUGGGdCAABDFGCHHG.aBAAICCGhAAA.JGCAeDAFhAAAABAC.NAIE..XGDAhABAfBGCKEEDMDDBOADE....hABA......hACA...,2,-25,-12,13
RVdBeAECQTXIJaZgOSGNHYcbUfDLWFMPK,EFFBTABH..IEBCZGFEOEEH.GAECHAGF..bCCAfAHChAAADEGEFGBGKBBEdGBBhABAAAIB.CEBH.QGDDhAAA.XAECaCHDNEAA......hABA......hACA...,2,-19,-12,7
TFCdODGBJgSKcRQVEXHfLMWAPbIeZNaUY,..IFDGNDHE.UAFAFADDCFBB..dHEHDFADBHHE..SGFHhAAAKFFEQACDhAAAECBGHEDBMABH.AEAFeDCChACAZDAAaCHFOAHF...JFBHcGBHhABA......hACA...,1,-18,-35,17
IGXNaYRHJDMCFZdKQOecfVALgBbPEUTSW,LAFBBFDGEBFHUAAFSGGA.GEDHaGHBHFBFMEACFDCEKACBhAAA......hABA.eHAGcADEABFFPCHDhACAIHEA..YHCCREFA.DBBFhAEACEAAZAGB....hABA...,1,-10,-21,11
ADGCMJZQeOaNdRVKFcgYLBIWHTbSEUXPf,CCAHJGACZAAC..eDEEOEFGdFFC..RBFE.FBEE......gBCChAAABFDBIHAChABAHDAASAFEhABAEFFDXEACAHHE...DACEMFEH..aFHD.hACANICHKCGA....hAFA...,2,-40,-18,22
ZAeHDMfKRCEJLQcVbYGBNXTgUIWaOSdPF,HAADMCHFKEEBRFABCGHALCCA..VCBFGDEDBAAC...hAAATGGGUGCAIECDhACAaAFD.SAHHhADAPBCGADIF.fAEDQGDHcFGBhAGA......hAHA...,1,-13,-33,20
XELcDBdJHZCGRaIFSVQNYKWPMUTbefOAg,EGFCLFCHDCHF.dBAEHBAAGBEHRFCG.FGFE.QGAFKCFHMEAFTDBEhAAA.eADAhABAAGEE......hACA............hADA......hAEA...,1,-25,-41,16
gQBVLWOecNaMEAZfbUCISJHdDGPFYXRTK,ZAADUCBCSBFGdEEFDDFC.FDGARGAG...KHBEQADBLEAGeFEChAAA..NHEH.aGGHhADAAFIB.CAGFHCDD..hAEA............hAFA......hAIA...,1,-19,-52,33
bUeWcNRCaKdQgHYOLGFXfSEVBDPTMZIAJ,JDACUDAC.eCGB....NFEF.CAADKEEAdHDFHBGFLHCAFEAH..hABA.SACDhADABFDDTACHZFAEAHGA...hAAAbAEC...........hABA......hACA...,2,-45,-27,18
dMZHDNAJESLaBRITOCXWQgcKFPfVbUeYG,JEGHEEEDLAAEBBAB.RECD.OGAA..CHBFXBCEQBFBhAAAKCBFFDCH..PEHFhAEAVACF...eAFFhAFAdFECMEIHDAIDACGAaHEAIEAF...WHAAhABA.....hAHA...,2,-28,-23,5
MKXVGWSTgILOJUZEYRBfFQbPCDNdeHcAa,KHBGVACFGBBA..SBHHTAEGLHEAOGDEUEGBhAAAZDFEEGFCBFEFFBGD.QGBEhABACAACDFDD.NBBGdAGAhACAeADD.AGAHMCAF.......hAEA.WFAD.IDEFhAFA.,1,-8,-28,20
EJYeTMUaVCAcgbSPRdZOKWHDNLXQfIGBF,...bAADSDBD.dECAKEFGHEECLDFCfGHChAAAIAHCBHAFFGCEEHDCJEADhAAATAFAMACEaGGFVABBhABAAEDE.PDDA........hADA......hAEA...,1,-12,-29,17
bIYGCDKXPdeHAZgWSQMcEFOJNLfaBRVTU,ZAADSHBGMGBEFBFGOEFH..JEBELDCHBHFB.TAGBhAAA.UADGIDHDhAAACBCFDEIHKEGB.XCEAhABAdHCDAFEE..WAEC...QFGEhADAECABfHDDRCDE.hAIA...,2,-34,-16,18
deKEMZAVHfLCcNFQYDgBPaXUGTRIWSJbO,VGFGHFDFCCCH.FGAEDIBCBECF..aECHGAAERACD...IBFHhAAASBFD.JEEEhAAAOFGBeCAH.EDGGABGCLCHBhABA.NHAF.YAFC..hACA......hADA...,1,-20,-34,14
KLIVJDNaFXeOMYAZGbWHEdUBfSPTcgQRC,ZEBHGAFEHAACdCCCBHFDSHDA..TAEEQFBHhAAARDECLHBAJDADDGFAFGHDXDDFhABAMEAHAGGGEBGAfADFhACA.........hAAA......hABA...,2,-21,-17,4
TWGOAdHcfUNIYegVBXFKDRCLEQSMPZaJb,dCFCHAADUABG..NACF.eHFEBCCGKFBEDIFGLDDH..QBFBhAAASEADZDFGhAHA.JFHF.TECDhAIAOFFCAGBH.IHAF.YHCA.hBDA......hBEA...,2,-30,-27,3
KPfFLcYBQGgCVOedZUSXNbEaTJIADMRHW,DIBGHFBGKDGFFCBCLEBBBHBEGCFC.CECC.VACGdBFBZAAA..hABASHFG.hACAXEDGNAIGEHDCaAEGIGGEhAAAAFIF.MABFPHFC..fBGGhACA...hADA...,2,-33,-16,17
bBLDAOfPTeXMQKEcWFIUGJVdgaYHRCSNZ,OGEATCBC..MCGDEDBBFDDH..IAFEGACFdBHG.aHAGhAAAREDBCHGB.ZAAEBHEBACFDeHBGhAAAXGCHKEBD..hABA..WAHB........hABA......hACA...,2,-28,-27,1
XRKPHCOIcEWfaGTbdVZFAMJLBSQYDgUNe,LAFEBFCFQAGFDEDCUEGHeEGH.KEAFCHDA..ODBGEBAGaEEFhAAAGAAF.dHGBZBDChABAABGG.SHDEhACA.NDAF.PFCCIHAFfCFF.hADATEAA...hAEA...,2,-25,-19,6
MaBDWJFXfZCVKdbROGUceAHYSEINPTQLg,HDAGSAFBEGHH..IGABTCDEQEBALADGMGEEhAAABADADCBAFCACZDFEVGEEhAAAbGCC.GBGA.eHAEhABAADFC.NEIE.aBAH.XBFAfBBB.hABACEFA......hACA...,2,-9,6,15
GKFBDZaRLVCSbdTEJIXPMNQWAUfYcOgeH,UCBC..fHBHODGDHEEFKFFCFAFEBAHADCGBZADHLBDBhAAACABG.dFABTGCEhAAAICAEMIFG...hABANFAB.AIHEcFEC.......hACA......hAFA...,1,-29,-30,1
OGIeFZbJWBPNSCAKYaTVUQcLfgDEMdRXH,KAFBTGBCQDCG.LDHBDGFDECCBMACCdAACRFDEHCEDGBGGhAAAeFAHFHGE..bEBABDAChACA.NICHAIHGaBEC..hABA............hAGA......hAHA...,1,-10,-23,13
SefVZbKIOTDdRaQPgcLYEWGAJUFNHBMCX,UAADFCFCHAAFBGGCMCEB..SFBCeEHFZGBGKHEAOHECDAGGdEAHhAAAQCEG.hACA.gADChADALHAGEAGBAIHACFFA.fEHG.IDCEhABA.....hBAA...,2,-24,-18,6
QRaDAELSIYTKdGBZFWVMcbJCHPgONUfeX,EEEDSDCD..TBFEKGEDBDEAFBAHMEDDJGAE.HFABOAFGhAAAUEGC.eDAAQBEHhABADAFAABBA.IDAFhACA.GEFA...WABA.hAAA......hABA...,1,-24,-27,3
eBHKXJGNLdAbVTWZPIMRUacCgFOSQYDEf,TFDHZAADMAED.UAFACBDC..OCEC.QFADEDDBBFFHXDAEhAAAJAFELHFAhAAAAGDG.VBAF.IGGEhABAaDFGFHFASHBEDDIDeEEE....hADA.KEHB....hAIA...,1,-5,-30,25
IeLPZdbMEgHJaTKXCVfSQcRYUWANOFDBG,FDCDBGDHeAFELCBHZCGD.dAHAMAEFEBDEHFFH..aGHFTAFFhAAAKBBHCAAC...SFDChABARGCA.WDDEhACAAIEGODADDDIH..IHHA.gFAGhADA...hACA...,2,-36,-10,26
aLDOSHYFcIQdUATZbCGKRPfeWNJVgMBEX,ZEFHCECDRFAB.eCAD..JDEDMHCC.BFDCEABG.LBDE.SBGHhAAAHBCGFCGGIGHBhAAAUGAEACBG..TCDAhABA..........hACA......hADA...,1,-27,-47,20
BPKIOQCgENYcRFZTbeHAaUSdWVGXMJfDL,UFCESAFBdAABGAEFMCDH...DGHBBCBBKFEB.QGFGhAAA.CCEBEDGDNEAARCDAZDAFhADAeCHB.AHIH..aDAC.hAEAVFBBfBCALABE.IEEAhAHA......hAIA...,2,-28,-13,15
IVdWXfUEMAgeBZFOCNLPYQSGHTKaDbJRc,eAFBFBBDCHEA.LEDB.QDABSDFBTGGEaABADEBBRBAA.hAAA...IAHChABAVECAdGGGXGAHhACAUAFDMEAFAFFBBFCE..NBIA.YCHFKGCD.hAAA......hAEA...,1,2,-30,32
EdbTHgQMSPYNZFfKaAWVCJcUGIXRLBDOe,CFDDJDACUDCHGECD..RAFDBBHBOGAG.dGGHHGFG..MIAChAAASCAH..hAAAPAEBZFAFKABHAHFH..hABA..WAHDIDHFDEHBEACF....hABA......hACA...,2,-34,-32,2
YUeRAIWOKEMJZHNTQaCDXbVFcLfgPGdBS,OGEAMIAGHBFD.QFACDCCC.XABDFFBCfAGFhAAAGDABSFDAhAAAeDEEACACKHDAZDBANEIGCGGCbADF.hABA.cADA.PBHDBHEB....hACA......hAFA...,2,-31,7,38
OAFcHMEKXPBLRTQaIdefGJVWYZgCSDbUN,FCFCHFACMEIDKBFDBACGLBDFQGDD.dDAHeFEGGDEFhAAAVEAFZBBACAAC.SGHDhABADIBAUCAF.AAHFEFFB.hACA.XGEC.......hADA......hAEA...,2,-24,-11,13
QGbUEMZcagBKJLOXWfSTFReACVYHNDdIP,VDBHHAADDFDH.dACEQACGGAECEHAEMDDGZGFG...aHDAKEGGhAAALFECOAGFXEAAhAEAfAGGSDDBhAGAFBAHAGGDCFAG.NAIE.IHAC...hBEA......hCAA...,2,-17,-7,10
AfVUQcOEaIWNeRMZFbgPKSXDGLCYTJBHd,UFDHQDACEBCC.aEEH....IDDCNHED.RAEFMIEGhAAAFCFC..PHAEKBACSEABhABADDCACBBB.JAHHhACABAEEAIAE.fAHGOEHF.WDFAbEFB.hADA......hAEA...,1,-23,-29,6
ZOAMCJYIXKcUNeaTEgLWQVHbRSdFfGPDB,JHAGXCBC.KFCAUDAC.eGEEEBFELEFE.QACChAAAHDEASBCEhAAAdGGBfHDFDDDDBGAChABAOAHFACCGMDIBCEAGICEHNACH.TGAAhABA.....hAHA...,2,-36,-5,31
eObENSRHBIaWYGFVTKXQJLgUcAdZMPDCf,ZGCCDDGGCEGCeFEE.EBDCRDDBBCBA..aDBAGEAEFGAF..KCFBQGGEhAAALAAA.UADHhABAAAEEMEIB.OCAHhABA...........hACA.NICHIAHEhAEA...,1,-22,-43,21
GeNFUgKHCVQfOTBLcbYZdESRDWPaAJIMX,MDEBXDACGBEDFCHF.UFFGHFDG.CDFH.QBAH.ODAChAAALFCD.YEHFhAAAdGAE.EBCDDFDDhABAaBDA.ACAG.IAHHNABHKAGA....fGAEhAGABAFC..hAIA...,1,-20,-21,1
TgCHNWUYDJAEXOIfBRLGSMQFacKbPZedV,EGDDXDAC..IBBCRDFHGBDBMECHFABGKHDAZBFC..VCDHhAAACAHEHFAE..UGFAhABADFHHAEEBBAFESDBEhAAAcEGA...........hACA.PEAD..hADA...,2,-26,-20,6
DUJAaZeWBMGgLRNcdTFSQIbHYXOCfKVEP,aDBDZFDFBAAEGDDBRCCA.dGDGFAGG..QAEDHGFG..XDAHhACAfBHA.ECAChAAADGDDAGIF.MBCCLBAChABA.cGAHSCGFIHGFOCHFhADACFGE......hAEA...,1,1,-31,32
eDcLOAFbJfVQGBHIXCaKNTYWZEdMRgPSU,JCCHQFDHBHGA.HAAB.CHAA.KCHBTEAHZBDHdGDD..MEEChAAARFAF.SGGBhACADAGELAAFACGGFAGC.fCDChADA..VEFEIAEC.NDIA.hAIA......hBAA...,2,-43,-15,28
XBJNVQKILDdHAbGZcRFOUfEaeCYSTWMPg,GEDHZGFGFFCAUBECaAAC..eCEE.CDCD.TBAEMAIF..XFBChABABFFG..NAIC.KHCAhACALHBADDDEHGECAECA.hAAAbADCOEAB...EABE.SDHDhADAWFAD....hAEA...,1,-3,-30,27
HYEMQdZTSPbWLRBfNFUaJgcVDGAOeCIKX,OEGHeAFBCAAA.KGCHHACF..ECAHdDFHZCDFSFGG..hAAAWHFABHBF.FEBGaABEhAAAJHFC....VAGFhABADDIFAAHGIEHA.MAFDTEDH.hACALGACfGAAhAEA.NCCE..,2,-32,-18,14
ASdUXZJLRgPOcECfQYHeVbGWBNKMDITFa,dFAAXCCBLCHFRAFC.ODDC.CAGE.QEDEHFCB.VFAGhAAAbAAC.BABB.NIDD.hADAKFFDDCIBIHGBhABA.aCCBSGEAJADA.....hACA......hAIA...,1,-18,-25,7
dYOaIFNCEXARMGbDgHSeJfKcWLVBPZUQT,GGCBDACBHADBJEAAKFFDLCGHBDBDZAFC..UABAdGCD..aDEEFAGChAAA.EDEGAEIF..MDDBhAAA......hABA............hADA.SGHBhAGAfHGFWHEAQADA,1,-30,-37,7
dDaVEHPNYBRSbgOLCfMcXUZJKATIGWeQF,TFGHGAFEQBCF.DAACaFBDEFEEPCAGBHACSEADhADAOBECLFEBhAAACHDCMFIFUDGB.KFADAEDGIDBFhAEAWAEE..dEBB.NBAF....hAFA......hAHA...,1,-8,-28,20
QBORMXCTbAaJfPgYHSUVKWZFedDLIENcG,JCCH..fGDD..PGCGHBDBUFGCKCFFZFADFAHDdGGEhAAALCCD.IHAGhAAAEBAA.NIED.QAGHhABABBBCMBGFCAEAABDDYDABSHCGhACA......hADA.eEFADADG,2,-21,-8,13
JLSNeQKcMHfGXOZRFUEPCbVYBWgdTDIAa,JFFBSDCD.QGFEMDECHECCGAFGOBBBFACGEHGACHAB.hAAA....VGAGhAAAWBAHdAFCDEIBADDHNAIAeEDEhABA.KCCC..fACG...hAFA.RFDF.....hAHA...,2,-19,-15,4
dcTOaICHNWEBRbeJUZgLFGXMSYPDfQAKV,KEHBVDAGdFDA..ODGDCGBCHAAF..EABABDGB.RGFC.JAFGUADChAAALDDB.GGDHhAAASAGADDIH.AFFE.hACA...TDBH......hAGA.aHAEIDFFhABA...,1,-26,-35,9
YLUEfDOSgRVCaFJeQNdbWMTHGcXIPBKAZ,ZFDFLDACUAEADBDBSEAH.RGBG.aHAGFCFD..QDGChAAAdAFHMGFAGECBhAAA.IHFEKCAFAGIBfABAhABAOABECCECNBIETAGG...XFFChADABBAD...hABA...,2,-29,-13,16
dBTYNSMGaKILJHbDgWZFcRAfUQCXVOPEe,UCGCXABHOAAC..eEFBBFGCTAGA..SDAEhAAAaDGCKFBCLADBhAAAJECGHFAADIGA..WACEhAGAZGAARFDB.fDBDCHHEVGDE..ECCENBAA.MIAEhAHA.....hABA...,2,-15,-11,4
ODfSNdJMZTEFaPQVABHXgRIGUWLCbeYKc,BFFCXFDHRCAFUCGGLCEE..eDDHKGFCDFBA...SBBAhAAANAFE.MIFEhABAEGHHaABFQGAEhACAAHAE.IDAECAGD..YADDhAAAfEEB.dAGDZGDE.hADA...,2,-29,-26,3
VRISFZMdLCcBYAgKDQXfGPaTOUEJebNWH,KHFGQECEGBBA.aAHHOBHB.EEDHJDHH.eACG..NDAAHBEFhAAAIGBHZFFAMABEhAFACGGFBCCEAAIF..XGCEhAGATAAH..WCEBSGBF..hAHA......hBAA...,1,-10,-30,20
YTAEIbCKaFceWHSDGXUMJdBgfLOVPQZRN,EHBGCFDGFDAE..eDBCHGEASAAADBGD.UCFFJBAABEEBLGEGhAAA.OADEQADEhAAANDAEAGFA.KCHH.aHBEhABA............hACA......hADA...,1,-23,-41,18
ADQFINVBfHSOgLCWTZdGUXRYMEKJPabec,FDABVAADHEEG.OHEECHABZCEG..GADFXDCBRGCG..MDIFhAAAEBFAKACG..aDDHbFADhAAAAICA..DAGE.QEAAhACABCHD.SHGE...hABA.WEHB.dGDFJFEGhADA...,2,-15,-14,1
adSUTcIfbJBVXQGCFHZEMWOgLReDPYNAK,dDABSEHBUDFC...TDDBIAHAJGDG.BHGG.QGBAhAAACBHHFBABEGACOAEDhAAALEHHDCCB..NBCBKECAhABAaBDB.....cCCAbCFDXEAChABA.....hACA...,2,-36,-13,23
YNdgeIVAGcOZQPHaXLfTEFSWCKMBJDURb,OFEFQFDHHAFELADEECHH.SBEBKECAJAAE.DFIDUGGFhAAARBAG...NIAHdFAEhAEAeCGH.IDDGhAAA.AABE.GCCFPHACfEHA.hAHA.FGGFCBDC.BECD.hAFA...,2,-14,-7,7
QDeJTZaWUFYAbfLEBVOGdcMNRPKHIgXSC,LGEABHCHOCHHdACEMDDGRFAH.HBAB..IEEEXGBGhAAASAEAQDGAhABADGGATAGAZBCC..hAEA.WECCFDBAAIFAfAEFEAAC...hAAA......hADA...,1,0,-39,39
NdRAgCVObXUDBcfTeWMaFKQIHYGSJPZLE,VDBHODAC.UBCEBGEG....TAGGeAADaEFH.FDGCKFHFhAAAHAFESHEAhABAZADFEHAA.RFCBCFECDGHD..fGAChACAMFIF.QCFG..hADA......hAEA...,1,-18,-28,10
CWfGKHLYgRAPFXZadbOSQMETDceUJIVBN,XGBCZFEEdECAOHCC..MECEECCEDAEAUACA.JEHDBCHGCBBC.hAAA.GAEFKCFDHAAEhAAALDFBRDABABIF.aFABSEEGhACA........hADA......hAHA...,2,-25,-25,0
aPYAJHEMbCXKVUBDcWSTRGdfFONgZeQLI,JDCHEHDC..MFGDCAGA.KCGCBGAC..DBDH..SGEBhAAARECDdGAEOBEBZACGLCGHhABA.aEHDAHHGbCAB.hACA.XGGC...cGADWAACfAFBhAEA.hADA.NBBGeDDG.,1,-23,-32,9
KZgaYcAOeDJCNQHVTbFGUPWXERMdfSLBI,eBFDCGHDHGDA..VCAGFFAGUCAF..PHAGECGF..MDIHhAAAdFAHSGFGhAAABFCAZABC.aEDHAAHCODEFhACADFFAJACG....NAIE........hADA......hAEA...,1,-20,-28,8
IQZKEeaSLYPCWRVTNHJbcGAgDXOfBFdMU,DAFBXDACOEFDFGDE..dGAEUDDHZECGKHGA..eBDGLAAChAEACABARFAG...TCCHhAGAJAHD....cGFDhAAAABCHBAHB.MBBFIHACaGCE...hBEA......hBGA.SFHB.,1,-22,-29,7
CWUFDLANIJKGeYHcaRXMEdZBPQOfgSbVT,JGEAKHAEeECDHCAFRCFD..MEIFZACDBBGB..QBGEhAAAOHAG.fGFFhABA.SEFAhACA.VCCECFCGWAFEDAECAHHDNEIA.YDABaBAGEDEB.hAAAgABA.hABA...,2,-32,-7,25
NbQcRaJHFefYgSdWUAEPKCXDBZTGOILVM,EAFBCFEDBHDFZDBFGGEFLFAB..MAAFQCCDaFFG.HCFBhAAAfCHASAEFhABAdEAEAFDAKGGHDBCA.IHCGhABANCIA..bAGB...cABBJDDG.hACAYFCD..hBAA...,1,-8,-26,18
BKdfQSNPITECGJbUVOXeaHMYDgcRZALWF,FDCDBEFAKBBEdACG.QGDH..SDGG.PFDFhAAAEGAHCDGEJAEG.VCDFhAAAXGFG.aBFBhABAMFCBDBEHRAGFAEAH.LDADNEIAGBAE...hACA......hADA...,2,-34,-20,14
FSgCQRafLMbHOeTAJXPGDVEWUKZNYBdIc,JDACXFGHGECDDBBA..EABGKCDH.ZFBCBBFE.dEHAFHBCSBBGhAAACGFF.aBHBMAEEhAAA.OAHFADDGVFAFhADAUCAC..NICD.IDFD..gGGGhAEA..hAFA...,1,-24,-34,10
ABCFZWQIVXRfcLGaESDbJMUOeTHKYNdPg,CBEAFCFCZEGDQEEC..XGADREBFLADDEACE.DIGAMCGHhAAAOAADHFDB.KAFCNIBH.hAAAdEAF.AFDBBDDC.hACAICBGcAGASEHD..hAFA......hAIA...,1,-23,-28,5
RbOWZATdDIHQKcfMegXSPYNaUFJVCLGBE,DDFFQFDHKHGE.MBEAeHAE..SAHB.PACHhAAAYABH.UAEFhAAAVDAFCFHEBDACEGGEbCGHZAGBhADAADEH.dFAF.HDCDcGAEfGEE.hABA......hADA...,2,-20,-19,1
UZBbXYVRNMECPeFQdTIgcaWOGKHLJfADS,UCBFBFDD..XCBCRADEMCHB...CEEEeFHBQGAG.dAAFhADAIACH.aGBHhAAAGGEFKCEELAEChABAAICGSEEE.YAHHEHEG.FFDBgCGAhAIA..hBAA...,1,-17,-33,16
TIGAFcgBZUeNEWQLdaDHKfMVObRPSXCJY,FHBGBFDGeCDBEBFHLAABdCABHDFB..KFBAMECD..OAHDhAAAbACC.SHGEhABA.CAFH.YEAHhADA.IEEGAAEC.cGEG...hACA......hADA...,2,-31,-28,3
FgbafJSVQRUYWcAZPXCdOeTEMBIDGHLNK,XFDHOCAF..eFBFMDDFBDEEGAACHAFEKGGDFDHB.aHGAfAHGhAAA.SCFBhACAQCCAYFBDhADAAIGECFFFEAAFLHCA.NEAE.gADFhAGA...hAAA...,1,-13,-18,5
dXTcfUOeYEIaGRNbgSKDVBWJHAFZQCLPM,QCCBCAFBLFECdCCC..XEFD.TGBHfFBHhAAAOBEGEBDEaFABNICD.gAAChAAADCBB.WFEFhADAAAHDPDDA.MBIDcDBH.eFHHhAEAIABG...hAFA...,1,-15,-28,13
cgMRedBCFVTaNIWGPKbLHZQEUfODSYXJA,MCCARDEDBECEFGDC..aAAB....IFBAGEACKGGFLEFAhAAAQBBFUBACOACAhABASAEGJAGBAEDH.hACA.eDHDCGGA.TGDANIBD.....hAGA......hAIA...,2,-31,-22,9
FMceVSgCBKTWUbPQLaJINGEZfdAYRHDOX,RGFGDAGDFDBHeCCF..SCGDBDEEKGFCUDGA..QCCFhAAALABA.aAEAJHCEIHCChABA.EFDAfFAAhAAAAFIDOBBAMAHF.....hACA......hADA...,1,-19,-48,29
RAYdIDWUgfMSBQLOCVaJKNXPZbEceHGTF,dHBHDACBUEBEMDDGBBCALFEC..VAEEKGEB....XBFAhAAA..ZFEBEBADhABAeBBDHADEFGGEAIDA.IEAEhAAA.fCHASGAG.ODFChADACEHHJECE....hAFA...,1,-25,-32,7
NKVFbMeWQcfUHaRSgPBJAdDTCGYXZOIEL,TCBFCECDGGCH.ZBBAOAAHLAAE.KGACbBFA...MHBGhABAeAHFQDGDhACAUEFBaAFH.SEDHhADABEAAAAEFDGIBIAGF.EFAE.VFGD..hAEA......hAFA...,1,-9,-25,16
HQYAeLFUXREOgSDVBKJCGcfPINbMadTZW,FAABXCCBOCFHDCFHBBDE..KEAEGGBB..fHCBhAAAIFBD.MGEGaCDHZAFFhACAQBAE.hADAAGACLBHFEFGBSEAFCHFHPADENEIAdAHEWFHBhABA.....hAEA...,2,-22,-18,4
cIPFCEbXRJMagZNfGSKdHDeQTBWYVLOAU,UCBC..IAFBCBDB.XGCHJFGF.aDACZAEF.GAGEhAAASBBBdGEEDGBAeECAhAAABABCVEGH.ADEAPAHDhABA.bACBMDAFfGEE.hADAKHAC.....hAGA...,2,-44,0,44
HAQYLbXKNSETgcJDfPeFCZWaOUIMdBRGV,QDACLGEAKBFDSEFCEEAB..TGBEJHCEDBCGeDEBhAAAFHGAZCFAOBBD.IBAHhABABAACRDCF.HDCBhACAAHAHXAGANIDH..fAHACBBDaFGE.hACA.MAEEdADE...hAFA...,2,-13,-8,5
VRcKTBAHWUDEagQJdeSLXMFCGZfNOYIbP,UFDHaGCD.QCDHdACGLBGHFAEFZDAFOEAA...IFEGhAAAPEHF...VGFGhABAKAABTAGBABID.hAEADDCHEGAB.JBDAXGACMDDCCFAB.fACEhAAA.NIDH...hADA...,2,-24,-13,11
TJDaNdQXFbZRBYLAeUEVMSIfcGWgKOHCP,UAADVGCC.MEDG..SBAA..fGBGhABAGDCBKFGEHEGDTAEDDHDCNEAChADAdDBCQBEFhAEAFGAB.ZDBFBGGDAGGD........hAAA.ICGE.hAFA...,2,-22,-22,0
RUXKHCSDVNJbGWYQIEafdZPALeBOgFMTc,LEGHeEGHOGCEMEBCRCDE.KBBG..HAAFSAGFDAFC.JFCDhAAAbAFA.GEAB.hABA.YFADIHHAhAAAaCAC.dFEBAIFGBDAGFBHH......hACA......hADA...,2,-22,-14,8
fQVBcWaJGNSTOAMFeXDRdLgYUCZIPbHEK,eECCXFCADEIFdGFBLCEE..UBACIBBGHFAHEDGAQDEEhAAABCEF.aGGCJAEAhAAASEAFAAIB.hABAMHAGFHCA.gDBH.YADAhABA.CFHA....hACA...,2,-30,-3,27
GKXdYeZMaIHPBJLNETScCQFUVDfARObWg,RFDFOGEA..bEAAGACG.KEAGXBAEeGBG.ZBDE.aGGHhAAAPEDE.BAAFhACALABCEDGG.SGAChAFACHHEFAECDIFAAIBGdBHAMAIFIFHC.NEEF.hAGA......hAHA...,2,-18,-18,0
IbUFBRdEKMgfHXGVNCcaYLDePOTZQAWSJ,JCCHUCBCBFGCEGDE..KADA..MEBFHFABGGDBCCGE..aFDADBAChAAA.eCHBOEEAQBDAhABAAAIH.IEEGhACAFGGFdBAG..........hADA......hAEA...,2,-37,-29,8
GZPVUENAYHDSbITgeKMLJOfXBcRWCaQdF,DHCESHBG..IFECTDCBKDABLDFC.JFADXDGChAAARADF.CADDdFFDhABAFCAH.PGCCECCBAFCCHGFAhAAAeAHHOCCABABCaAFF......hADA......hAHA...,2,-27,-15,12
fSEYFNZXGJIKgADPedCLcBaMHQWUOTVbR,DEFHdDCDCFFFBCBGHBFFUAEC..TBAHRAGB.EEBDFAAC.ZEBBJHFE.hACAKADDAIFG..LFDFhADAMHCAOFAH..hAAAVEGFSEGH.NAEF.....hABA......hACA...,2,-38,-18,20
MbZVCBHQJWTEPYegKUaGNLSfXAOFdRIcD,OEGHFEHBdGAAREAGDAGC.ZDCFBBBA.HAEDJDAD...EAAFeADDUGEEhAAAGBGELADDXGCGhAAAACID..MECAhACACHHE....WEEBTGCH....hAGA......hAHA...,2,-31,-17,14
aUWdMXSAgbOJRFZYNcBGPTIHEfCeKDVQL,OGEAJDCHZGFA.....NAFE.BAGDGBGG..IBBChAAAEEBGCDCBeAACDIFALCHFhABA.UBDEdGBHSACAhAAAAGCB........hAGA......hAHA...,1,-31,-48,17
gZBUHJEQdRTLKPAfDNXIbVGaFOYMCeWSc,DACBXCBC..IGDBGDGCaBFBOADD..CFAFeECFhAAASAGCZEDBUACAJCHHdDBHhAAA.LHFAhABAABHDNIEFFHACMBAF.........hADA.cFAG.HFFAhAFA.EEEA,2,-21,-16,5
eVPMYXRLDBOTNFKJdgHEUfWbZQcSGCIAa,aDBDeFBB.MAADRFGDBDHA..TECCKFEFdDDDECBB..UAFEfAFGhABAZABE.QEGDhACASDAFIBHAhADAABAF.PBBGLHDADEECNDDB.FHGA.hAAA......hABA...,2,-36,7,43
JRYEgGHQcOPeCBFITXAfMUZaLNWSDdVKb,UFDBZDEDLBBG.SFABDGGFdBGGKCAFRDBD.EEBAGGEH.hAAAHAGFQGADhABA.ODCACAEB.BBCDhACAIACEABEGMDIHNIADWDHH....hAAA......hABA...,2,-34,-18,16
NUHXdfBSVLWgGQAMFDECTYORaIJbePKcZ,DCHHEFFB.CCCE.OACD.RCGH.aGFA..JECFeEAC.KGBHZAFBUAEFhAAAHFAB.dAEABCABSAAHhAAALEFA..hABAWEEFQGDG.AAIH.MIFE..hACA......hAIA...,2,-36,-19,17
ecRDOHEPAbINSMYXTQdWVUFaCgZBfGKJL,..IFDGSAAC.XCCBdBBDUBFCaHDACGAFBGHE.KGFGhAAALAGH.eADEhAIADEEAHDAEEFECAIHCbDFAhBBANBIC.MEBH..YHCAWFCFFGGCfCDFhABA...hBCA...,2,-32,-14,18
fCAXIabUSEeTGJHBdVMWgcDQOKZFLRPNY,aGFCSGFC.EDBDGACE.JHBEBHHGdBFBMAAF..hABAcDDHDGADKDGCLDFChAAAREAD.NCADCBHDAFFC.IHAAhABAeEDC.TGCG.....hACA......hAEA...,2,-28,-25,3
cHRYDNfOgBSZPUFXLKVMEbJdIGQCeWTaA,HGFGDHCEOBGHSBGCZGFE.UDFDLCBGVAAF.MCAB.EAHHhAAAbFCD..dGAAIHAEhAAACEEA..WABChAFAAFCHcDAE.YDDHfFCBBAEA.hAGA......hAHA...,1,-5,-33,28
RBEFgPUIDYZMCSHJQbKGLcAadOXVWefNT,aEEDdGDDOAAB..XCGEeAFH.TAFABDDDEEAF.FGGFhABAUEBHDFFAZCBFCBACJCBAKBDChACALHCA.AHGA.hAAAfHAFNEAG.......hABA......hACA...,2,-29,-28,1
RSWYDJMILdbBZAHeKTOPFcVUEQCXNfagG,HDEDKAADOCHDFGCHUDCG..EEAGQBACCEDD..NDAD.gGFFhAAAGFDD.SAGAhABADAFCMIBGIBGAhABAbACAAGDA.eBCEPEAF....hACA......hADA...,1,-14,-28,14
GgNaYRHAJcBWdbVQMPIFDXZOSUfLKCTeE,JAFBBFDG.dCABQGEDMEEC.FBCCDDBFZEFAUFGALAAF.hAAACHHG.EGCBGDAF.hABAaBHBRAFHABID..bFADPFABhACA...IAECSDGGfDCFhADA.eBBEhAHA.NIEF..,1,-10,-35,25
cVOPSQJgIfNFaeYRdBWUHATZXMGbECKDL,ZCDBGEDCCEBCLAAFOCCDQFAH.JABDgGDGhACA..IHHGhAAAfGHGNBEFeFFHdGAEBHCDhADAUCFCAAEATCFBMCIDKHAADCDHcEGBhAEA.SAFEhAIA.aBCG.,2,-27,-2,25
YHAQfOeRNVaJZKMcFGDIgXBLbdSEUPCWT,QDACOEEGREAG.aEEHZABC.KCDDFCDGGGBFDDGF....gGBGhAAABGGALAGFhAAAdGGBSAHFhABAECAA.CHED.WHFATABCACID......hADA......hAEA.NBIA.MACE,2,-24,-20,4
ZdEBDegNKQPSJMTaCFRVbAOYXGfWIcUHL,ODACXFGHGGAH..ICBAHEFHdCFFBFFGeFBENAIA.KAAFhABA.QBCHhACA.SAFEhADAJEBCaCGDFACG.bGCCAIFGfFHC...hAAA.cAEB..hABA...,1,0,-40,40
GKIOSCMagDRWNJXQVBdHcUeALFPZbYEfT,FDCDZAADEEFGGADG.OGFECCHC..aECADBFARAEG...JDHHXGDBhAAABFFF..HAAHhAAAUGACAIBCLGAEhACA..PCCAfDAEIGHGMAIF.hADA......hAEA...,1,-17,-33,16
BTgWYGPeFLUSNCIKAfDJbQZdcXRMaOHEV,DEFHJDACZAFAdBFHRGBE....aAAAHBCH.BAAC..TGGEhADA..YBBFhACAGGABPCFC.FEFDhAEASDADCBCAADDA.fGFH.hAGAcDGG...hAHA...,2,-38,-28,10
ZFgYKbTHSQEDdRWVOLeXaPBAcJfMINGCU,JGEAMCCAGACGUDBEZFGD..FAHFKEECHCEE.EHCEDBBC.dGCDRFAFOBAHhAAALAGFaDGEAICG.hAAA....fEBBhABACDAD..YFAF...hACA......hAEA...,1,-17,-39,22
JIDQdecHfGaBPbFMRTSZUKLXOWVCYNEgA,JFCHDAFBeEGBHBGFGDCBBDCG..FGCEMFBDRAGD.ZFFHLDFFhAAA..OCAGCADHEBAH.hABAAAECdFHG.fAFHhAAAaGAG..........hABA......hACA...,1,-20,-38,18
WEGceNTRVLIFBSYMZfaJPdbKUCDOXgHAQ,EGFCeFEFRAAB.LAAEBBEE.MCFAZECC.aEAFdHCF.KGADDFHF.OHAEhAEAHBGBADCEGCBH.hAAA.NACF.IAFAhAHA.SDGCfDED.....hAIA......hBBA...,2,-29,-20,9
ZJFCROeNAEWaLUbHGMfVKdSPDBYTgIXQc,EAFBLCCHHCEEMCBAVCAB...KFGGdGBESFFFDGIHBGFE.TDBFhAAA..IHEChAAAXDGAZEEGCHBHOEAHhABAeBHBADGH..aAFB.......hACA......hADA...,1,-19,-29,10
ODBEVYUJcFWdSRTGNIMfLXCQZHPgKaAbe,eEEGBGHDEEEBUDAGFAAFdHDH..RDFA.GACF.MDDDXAGDhACACAAFZAGF.HADD.KGAHAGECDIGAhACAVCBF...JFDFhADA.....SHFGIGGF..hAFA......hAGA...,2,-29,-19,10
TLQGYdJPBSKXaFbHMZCDINAWVUROEfegc,UFDHRDEDEBCG.eBAD..TGGELCDCQAEAdBHEJEAHBGHAhAAAKEHBFGBF.HAGDMBBECAAEDIDGhACA.AADE.OCCHhABAfEDE..cEFF....hACA......hADA...,2,-31,-10,21
WDNPXKEdafcOZYVCIHARJgMTGQFSUBeLb,RFDFMDEBQBFEFAEABHBELFAF.DDCBXGDCdFFA.aABAhAAAfBCB.hAHAOBADVCGHIHGEhAIAAIFGgDDC.SCHHbCEBNCBG.EAEAhAAAYCCHCHCD..hBAA...,1,-6,-34,28
PAYbKTgHROCBZLXScEUFfaQMVdGINJWeD,KHBGHEFHCCGD.LCCB.SEAHEECFUGFHFAAFaCEA..VGBEhAAAdEGFGACF..hACAIABFJCEB.DFIDhADAABHC....bDABRAFGBEEC....hAEA......hAFA...,2,-32,-15,17
XYBbDPACWcNZTEeJSFRHdaILgOKUQVGMf,CFDG..NDDG.ECCB..eEFGSBEHHABCaFAELFEB.KAAEhADAUCAHQCGGhAEA.MIAAXGGFhAAABFAHDGGEAEHAWAFC.TBFE.FHBCIBDEhAFAOFFH....hAGA...,2,-34,-9,25
daBWeQKXIGUJVcYNOCFgPDRLMfZATSHbE,HBCFEAFBBFGBeHFCKBBAGECH.JAEEVEAD....NCHCODAHhAAAFCHBDFIHLABEhAAAZGCEACBH.SEFFhAGA.dEDC.aGGHXABB..IAHFhBAA...hAEA...,1,-20,-24,4
feTCNBUYgabPOMLcRQXSIJAWVdKDHZEGF,VDAGDGGDZEAB.FFCDeDGD..CCBG.BABD.UGABaEGF....hAAAOFHDMEIDRADGQAEAhAAAXDDHIHEChACAACIDdDDH..KAGBEBGA..fBBBhABA.NCAE....hADA...,1,-28,-30,2
DRSAVdZETGKCOFIUMXNeHfYLJacWbPgQB,dDAFTCCBGFDB.CACF.OFFAFBFB.UCEGMBHDeHCC.HFAGhAAALBBAJAEC.aGAE.hABA.cGGD.bCABhACAQDDCBAHBDDAHAIEA......hADA......hBAA...,2,-32,-6,26
KGeJTbaULZHRXOMAcVFIEgBSYQNCWDPfd,VDAGFAFBEHAC..BBABQAAC.CHED.PFFH.dBGGeCDBhACA.TDGE.hAAAaEBCUACCLFFAhADARGAGOEFAACCFIHHASFDB.WAFFKBGA.hAEA......hAHA...,2,-27,-16,11
EVPUBFQZeCSdYGHOIKAJDXfRgaMTbNLcW,JEGHDAFBRDBG..MDCB..TACGLAAFEHAE.UAGGBCFAFBBGeGFAhAAAdGDEGBEAHCGBIFFEhABAADDD.fAGDhACAaFAD.........hACA......hADA...,2,-30,-18,12
gMHYbcVPeASTGNLXRCWEDBZFOQafdIJUK,TBCBLFEF.RACGEFGHBHGD.FCHH.QGDEaDDCdBHG.JAAHKFAEhAAA.HBAF.bGAEPCFHhABA.AAGCGEBEhACACCEADAGH...fFHE.IEAHhADA....hAEA...,2,-29,-15,14
QYAEDHTWgaSeLIOXPBdNMVKcRFUGfJbZC,DEFETFDH..aEBAeFBFLAEF.OHCCPDBG.dBFHVGFAhAAAKHEAFGHD.fACBhAAAJBFGCCHA.AAGCEBAAhABAHABB..SDFHBGAANBAE.MAIF.hABA......hADA...,2,-27,-7,20
WOTABUGLFfZEHXcaVJISMYgQDdPeRKbNC,UCCHLCDGFHDEZFEAHFFD.XBAD..aFAFJFCDMAACQAEGhAAADBDA.dGAGeCHDhAEA.KFCFCBHDOEFAhABAACBH.BHHCEAGE.IACFSDFF.hAGA......hAHA...,2,-32,-16,16
NfPESIUJMFWXGeLBbaQHdAKCYRVTDOcZg,CFEDRGFGDCBAZBFA.......NCEC.EGGDUCFGJFAFFDFB..GDAEhAAABEBE..QCCFhAAAABIF.KADDYFFChABAOBAB...fAEBPHDEMDHBhABAWFDD.....hACA...,1,-33,-40,7
CTPFZMLNJBYIRbaeSDXEQHKgcAOGfVdWU,GECFVDAG.dHEFCBAF.FCAHLHFABDDCRABE....eBHHSGBAhAAADAFF.QEEFhABAKHBAACCH.OFABhACAfAGHTCGH.MIBA.YCCChADAaGABXFGAEEHF...hAEA...,2,-27,-16,11
QEYZJGNMIaXHVdRTDKPegCcLfbAFWBOSU,BFEDSAADUEBC.EEFGZAAC.GCCF..IGCBHFFBVAGHhABAdAFGDGGA.PDDFhABA.eAHH.CEHELDABhACAABFHWDFA.YFFFMIAGaFAH..hACA......hADA...,2,-23,-14,9
FgLPMAYHEOWRSGKdbVJNDcUXZeTCaBfIQ,HDAGOCCHSGHBdAFD.JADCDCHHUAACeDAD.CGCE.BFFF.hAAAQGEFFEDELFGHhABAMCHHACIFEGEGRGAE.KACAhACAbBDC...NAIE.XGAC...hAGA......hAHA...,1,-12,-26,14
OQcCbJdHFGaWIDMVBTRYeNUgEKAPSZXfL,SCFCXFDHLCEEOAAB..CEHG.dFAAFBCAaCDH..DIBEBDFEhAAARGFE.eADEUFACKCAChABAAEDBZEDBfGHGhACA.bFFFJDAE.........hAGA......hAHA...,2,-33,-19,14
bcdGHJLSCQgaIKWZTYNPOMBVFRefADUXE,UECEEGFCdDDFHBCCLAEACGHA..aDHFIBCEZGDE..TGAEhAAA..YCAHhAAA.OFCBMABFBFFFhACAFEHFfFAEAEFCDDAHXAGCcGDB.hADASCEE.hAEA...,2,-25,-14,11
LaQSTbJcORHCgDdeYUfWFBINZEKGVAPMX,XFDBaAAD..SGFAJDAF.OBGBCHFGDAGG.dHBFeBCDhAAAUDAHFFGEBBDH.IFEDhAAAECGCKHBEACAGMAIFhACALBDA.........hADA......hAEA...,1,-34,-38,4
BYdIFfScDUNKVaQAbXLHEMReCPOWJZGgT,XDACLDCHEFGBRFBF...CAAE.OBAEJBHB.ZFGBGAECBAAFdDEGhACAFEAA.SGEChADADCAEKGED.VAGFABDDMHAEhACA............hADA......hAEA...,1,-21,-34,13
VDJXRGYWKPbLcaOMNCBZdTUgIAeHfFQSE,eFBBHDAGFEGGEFEFDDAERGBEGADF..KHGELCBCaAAC.MEFBhAAABCFHdGACTDGB.hABAUACEAGGHfHGFhACA...........hABA......hAFA.SFCB.,2,-32,-9,23
bXRWAGeSdgacZYDFNQfPBJUVELOCTHMKI,eCDGSAFBdGAB..aGFHZCGB.DDAFFCACQACGBEHAUAFCLECDhAAA.TFDGhABAMEAGIABChAAARCDAAIFA.....cEEFNCBAfGGBhAEA......hAHA...,2,-35,-22,13
DQSOIcBRNfKgeWPMVYATaEGbLUZHJdCXF,aFHBGEAHLDAEUEECHGFCdDGB.CGAHDCHHQAAC.OCEDhACAIBAFBGCE.NIBD.hADAfCBA.hAEA.gAFDeADGMIDAAAHA.EGCFZEBA..hBAA......hBDA...,1,-16,-17,1
DBNZgTIOeFdKcHSGVEPaLXMAUWYbQRCfJ,UCBC..bAADRCFACAAEDGAE.ZCCB...TBFGOFGD.dFBEKHFEhAAAHFEDSEEChACAEAEALHAAAEBGQEGEhADA.BHDG.IHACcEDB...hACA......hADA...,2,-31,-18,13
HgTBIALDOaKbYUMXcFdQeESJfRGCPZNVW,DBEDOEGHKCFD.UFDA..MEHBFBEDdDBBEAHH.....SDGEhAAAREAECCBDZFFH.VABEhABAHAAC.TGACBGBEAIFGhAEAaAGB..XAFB.....hAAA......hABA...,2,-30,-30,0
KDcGMaXFCNeLBfTZEURHJQPSgIdAVYWOb,VAADOGEA.KAHBDHAGGCAB..XGCDCBFALFHBBBFBZEAChAAARDCAHEFF.JDAFQACAhABA.gDEHhACAABIHbAGF.aHDCeEHBECHBUGAC.hAAA......hACA...,2,-23,2,25
FfPZANKDQBMgHGUdbReCTXVJWEcILOYaS,KHFGDEFAMBDGGADD.UCGCRDDD..eCAHCGAE...XGAEhAAAJEDH.EHDALBBHhAAA.OFFEaACBFBGD.hABAfGGDAHAFBDAC.dDCC.....hACA......hADA...,2,-38,-17,21
dUWLAGfXBRMNPQFDeHVgbSJYKEICaTZcO,XAGHBECDMDDE..QDEDeEFEHFAFVCBBSGHHhAAA.KBBACGDHTFGChAAAOFGHUAFCACAHfFAGhABANAIEDEEB.JAEBEADG.IHDFaBBG...hACA......hADA...,2,-19,-8,11
TLMEIdNgeaAUfCZDRQOKXcbFJYSGVBHWP,CHHGRBCFOFFEKDGF....XDCH.FAACSHCGhAAA.VAGBBAECHDADhABAPHBEMEEGdAGG.eDABhACAAACCfGDBZFFEDCDA......hAEA......hAFA...,2,-34,-30,4
UMcHBTdaeYOVQFCIbWRZPNDKELAXgJGSf,XDACGECFUCBEHFBFBHHAdDEF..eAABOABGFGFH..CAHD.IAHGhAAARBFEZACB.DFBDEFAFhABAAHDC.JEHF..MDDEhAFAaFEG.QDGA.PBDA.NICB.hAGA......hBAA...,1,-2,-28,26
AfbFPOBaEXeHIVZdcDQTMUJSLgWRCGYKN,FHBGOAFBECAF.HFFGZFEB.dBAADCDDMAED.UCGHJABC.LDCHhAAA..RBFCCAFAKACFAFDB.PHEEhABABGGD..eEFEhAAAIHCE..QEAE..hAEA......hAFA...,2,-36,-11,25
fFZLNYHIgAOEcPCGUSadWVRBDJebKMXTQ,EDCDCFDGGGEHUAFA.dAACREAH.BCGB..DAIFeGAEKHFC...MAFGhACAQEGA.FAAChACAZCDA.NIBHHCBBAGDAOADDhADASBHB..aHDCWFFC..hADA......hAEA...,2,-30,-20,10
MJVIcBDSWgFaTQPbZOUXNEeGAYRCHdLfK,CFDDHDEDLGFCMHFCJFBD..VGAEBBEGDAIB..SAHBhAAAFAAB.aEGETADEhACAQABFZDEAUDAEEDCAAAFAhACAdAGEKDGC..........hAEA......hBAA...,2,-23,-23,0
CNTFEDgGPABfHVMQebdJWUZKSLYIaORXc,HDBHVFEE.QAAD.dHEFJDECUADCZECDLBCAaFGA.hAAAXDBBCCAHTGAHEAAChAAA.GEAEADFEBFEDeAHHhADA.KEHBIHHE.RAFGNEEHDIDA.fAFBhAEA..hAHA...,1,-1,-12,11
eATPYMDdcOGgIJLVKbCRfZNXUBHaFESWQ,TCBCMCCAdGAH.GAEFJFCA.LFEDKAAB.CGFC.ZGFE.XFAHhAAAHCAHEDGC.SHGAhAAAQBEDADFFDABAhAEA............hAFA......hAHA...,2,-39,-18,21
XbVgCMAeDPfNLKdHcGQaTJURZIOSYBWEF,eFCHDACB....fCEFKGEHHACHGBGAQEGGTDEAhAAAJDBHZADEIBFB.hAAASEAGBGDBWFADhABAECADFBHFXGAB..bFEBCHHEAABC..hAEA......hAFA...,1,-10,-25,15
ZBCaVWSQPceOUKYDNGAIHFMXbJLdRTfEg,HDAGMAED.XFDALDACdCGARBFD..TAAEfGBA.EGHBhAAAZGFEBAHAaGAHSHCEhAAAQADGcBADhABAUEFHKFACDIFAACCC.IFAA....hACA......hAFA...,2,-15,-13,2
TKJDIFBgACHVNLMdQSXOcbeZRaEPYGWUf,HCDHVFDF.MAFA.SDAFOEADeCEARBFG..aACBEBCBGFBFhAAA.UFFETADHhAAADIEGIEBDBCABAABGNAIAQGGGhADA.......hABA......hAEA...,1,-13,-17,4
WXdKYNcPOVTMLGDSCUAHFaEeIfQJBbZgR,HFEEEDAB.eDBDQACBBBGAZACFREEAdDDHKAEH.....YGBEhAAAPDHFOHAChAAA.MBCDDIGACAGGAABFIHHAhAEAfFHC.JCFAgDECNIBB.hABA......hADA...,1,-11,-23,12
WFIdTQNXHKDSEafVORUMGYJPLBgcZACbe,CAFBeGEAFHGE.dCAB.QAECHAABKDEBDEBCEDEE.....aCGBVEBBhAAA.UAGAMDAFJDHFhABABHEA.ZFBAAIDC..hAAAWBDDIFGH...NAIE.fDAAhACAOHAE....hADA...,2,-29,-18,11
IdLUeRHgfDCWXbOZAEFPGaVMKcBQTYJNS,EAFBGEAH.MBGHBCDCQBAGJCEB.SGADIACGdGHChAAAeHFARBAF.HEEBDIAG.hABACHCDXACEOHDCAAHDFFFBhAEAaCDHKBHF.YDHBNGAF..LCHFhAGA....hAIA...,2,-24,10,34
SGeLBdZTbKYADXWRafJPcHVgCIUOMQNFE,DAFBREFH..aDDCJFGFHBAC..CHFD.OABA.MIAAQDABhAAAEBHBGFAFBGBATBEHhAAAKBGAAFEB...WHEGhAFAfCCD...PABE..hABA.gDGBhAEA.NIAF.eDHB,2,-55,4,59
eDIZYKGaMgCJPVREFLTfBdONHSWcbQUAX,XEGDeFCHDIFGZCCGGADB..MAHFCBAC..VCCFEGGGLBDChAAABFFFOCFESEFFhABA..WCBFhAAAcFADQGCDAHFAICAGaGAD....hACA......hADA...,1,-18,-29,11
SJKTYWZPQEIVLGNHCegcfdDMOBXRbFaUA,SEEDKAAD..TEABZGCAEGADLDDFGBBFHDFGeHFE.hABAfGGEdAGGDICAMFEGhACAXBGEFBCE.aDAAhAAA.AFAGJAEEWAEB.PCHD....hADA......hAIA...,1,2,-26,28
TEBDcLMRHKJNXObYeCSQAFaVZUWgfdGPI,FEHBVBCFUBDD......gBGEdEEEIGABBEEADIGAhAAALFAF.MAEAhAAAKHCAXBAHhABAOEGHbEBHCEBA.ADAB.ZGFEfFDE...hACA......hADA...,2,-41,-18,23
ZTPgJLIEAGUebCYNcVBRMDdFHQOXSKaWf,GDDCUDACCDFD...NABG.BHBC.RAGF.dDHAHGFEXADA.KCCEhAAAaABDZBFB..TDCFhAAAJGAAEGFF..AEHHeFCAhABA...........hACA......hADA...,1,-28,-33,5
APEZUHLcIXNYgfQDJSbMGBdKRWCTFaVOe,ECFCUBBHLFFC..IEBHXAAB....YDGDhAAAQADA.DGADhADAbGBAGGBDBGHHdDEChABAKCCH.CHGDFAEEOAFEAHFF.......hACA......hADA...,1,-17,-36,19
MfCaLJAcSGOVWUFYZIHNRgPBQEdXbKeTD,GEAHOFBBUEFFZBDGHFGB.RABHBHEEdABBKCCADAGE..CDHELAFHhAAAAADA..SHBAhAAAFECC.IDGAhABANEAE..gGGAQEECEHCA.hAFA......hBAA...,1,-25,-32,7
HZFMReXbDJYKWgdSEIGANLcTQBOCfVaUP,LGEATCGC.BADHOCAGCFCD..aFABUFGB.ZEBCRDFGeCCDhAAAXCEB..bBEADGBBhAAA.JAFCKABEdABFSGAHhAFAEGEFADDH..NEAE.fEEE.hAEA......hAIA...,2,-25,-18,7
JeTNBHWIFVXZSdaDKfAYGcLQCUMRPEOgb,GAFELDACQFAGMHFCRBGF.OGFCJFAF.eFDDBGCGICAHhAAAFFDEZAAE.dCCHKBEEAAIFCFGBhABA.EABA....hAEA............hAFA......hAHA...,1,-14,-43,29
HJKOUfbBGcQCFNDRSVIAWgeEZTaYMLdXP,eGEATCCBMDCC.LEEEXAFDJBFEOACG..fEAEhAAABFGGGAAECADGDEIBhABASGDG.hACAADIFEGHHaGDH.YFBF.dDFFKBBFUECFhAAAcGAE....hAEA...,2,-33,1,34
FYWRAMSBJENgLTOZUIaPbDVGKHXcfdQeC,BBGEEDCDLEEGZBADUDEG..aFBBDCDGKGEBHFAF..XAAChABAdEGAeCCDFBEE...hAAAWADCMIDG.NHDB.ODDAhACA.ICHAPADA.....hABA......hACA...,2,-29,-20,9
cNTEGUeJZLSAWYfdDPFQMgRBbOCIKVaXH,...fHBHPEACMCCEBHGF.CCFCKAACaGADHEFC.TAGAhAAAEEHHeECELDEDhABAABHBdFAADAEAFADEQGCChACARACEOGDA.IHHC.....hAHA......hAIA...,1,5,-31,36
TNSAdYIfbHJUVCMeEBDGacFXZQKLROgPW,dHBH..fEGDJFFHUDAF.CCFC..eFBADABBGBDBFCBEZFFALABEhAAA.gAGDhAFATEGHABGE...hAAAYHDEIDDF.......hAIA......hBAA...,2,-45,-23,22
PefODZIHQAFLGgCEdMBcUYNRbaKJXVWTS,FHAEGECFCCBF.MADDUGEGRAAF..KHGE..JCEF..VGBA..hAAATDBDSEABhACA.fAHEhAEADDGHIAHGAAFBLCEE..EAEBBFHANEHGaBABhAAA.....WGAChABA..,2,-44,-18,26
LEdGTCYMKgfNJcAXRFPVDbZSQHWUeIBaO,FDAFDHCEZCGBHDEGUEDBBCHA.OFDHdDACGABH..TBBBhAAACFHA.KGBD...fACDhABA..hAEANIDDAGGDXAGB.PFHB...hAAA.SBGChABAeFFDICECEGAA,1,-11,-48,37
dSefOITHWXaKFAPVcQYMULDgbZBRGJNEC,VAADQCBC.MGECUFEGLEFADGCCZAEDBDFAGADA.NIBF.hAAACHAC.dGBF..SEBEhAAAOAHHIACDhABAHAGF.aGHDACDH....YDHB.hAFA......hAGA...,2,-33,-10,23
WPdJRbFXBNGgKUOACHYZaIQfeDMcVLSTE,HDBHZDAGQCFGeBBCMAEGLFDF.EABBWAAFdADCJEGBFGGEBHEBhACA.GBDFhADAgAGEKCHBAGDFaFFGIFBGhAAADEEH..........hACA......hAFA...,1,-11,-23,12
NWLDZYgJdBKbMTEXPefFaGOAcUIQVSRHC,UCBCVEFH.RDFBHAEH..CBHCLFBEDAHFZDDF.JDCCdAAD.KGADMCABhAAA..XGCChABAeABEFBEE.GGAFhAEAAGHE.IBBF.NEIA......hADA......hAEA.YHDGBHEA,2,-25,-10,15
YNDdfOVeAZHTMJLEKCUQgWIFcPbGRSaBX,HBCDMAEHLDACEBGCKHAEUEAGQFCB..IFGBhAAAFGFCPBFDRFDBBDHC.XBAFhABADCHDdABDOEHFhAAAAADC.TGADCHHGWAFF......hACA......hAHA...,2,-24,-13,11
TbHGLRIFNaCQEXYMVBDOZPWAgKSfJceUd,KAFBJCCH.eEEBdAGDHEFFLHAA..FAEDCCDG.EHAEMECB.BBABhAAADGIHOBAGZDFF.AACC.hAAAfDAA.hABAUACFTEAF.bFDHIEHEaCHF..hABA......hADA...,2,-31,-19,12
dNMEITRBWZbcLSQfFCPVKHJOUAXGagYDe,GCEBaHBG.DHGCdCDHMIFGECBH..RAGHBGEHZGBELBBF.SFGChAAAFADECHGFKFFEOAAAhAGAAFEE..YFAChABA.eAEEIECCWCCC....hAIA......hBAA...,1,-16,-41,25
aUYIBPZFbDQeRNcMLXHAgfWCGKOdTESJV,...fHBHCECDOBBBEDGH..SEFDaFAB.IDGChAAAZFCGFEHDDIAAeDBARCDGMABGhAAALABB.AAEDWCFChADAKBGATAEAJFBAYAFEBGGD.PFHBhBAANIDF.....hAGA...,2,-22,-10,12
DBIHFLgGbaVYEZCXJdfPNQeMUKORcATWS,SGFCDAEDHAGBLFDDGABG..aBDDVEGHZAFA...XABFhAAAJCFCdEEH..NBAG.MDCAhAFAKFDF.OEED.hAAA.AEHFTGACIGBG.bDBGCGHA....hAGA......hAIA...,1,-15,-18,3
cFeHZbgaIOfRWGAKDPLQVCXdJNYBTSEUM,KHFGDEFHQCACCCDA.dFBEJDAHBEHF..EGCEUAGGFCFHHAAChAAAZDDD..aHGAOGFAhABARAAEAFIH.LAHFhADA.XEECNIDH.SGAG.hAAAMIBEeADG...hAEA...,2,-28,-21,7
bYfXJScRLUdGVBAaDMHTCIOKgEQWPZNFe,MBHHTADC..CAACKACDEDDD....QCEEZEDGFHGC.eGAEhAAA.fFFEhABASEAGLHEAUGAHdCEEhADABFHCDDCCOEHFPCBFYAFCXGDE.hAEA......hAFA...,2,-32,-1,31
XEUNWbgAeOafPFZRYIcDSJLdTGCHVQKMB,aAABFHBGRBFF....IEEFDCEHLCACdBCAGGBBHFFGKAGEBBFHhACAUEBG..NBIE..hAAA..bAGBAEFDfABBhADAPDAF..YFGD...hAEA.SFAFhAFACECE.MIDE.,1,-16,-23,7
fEDZecBIGdWQbUTVHCYaJPLgSOKNRXAFM,FGFHMHFGEECFDDFE.ZAACeDHH.BHHEGEBGdAAC.QAEChABA.TEDACAGEaGCEJCEFhACA.LDAFSCAHhACA.KGADNBBFAICGfFGH..IDGAhADA...hADA...,2,-25,-25,0
PCNDWFadgUbEOIVcBReSQHKGALXTMJYfZ,LDCHTGFB.JADGZBAB.CADH.DAAB.FCEAdEDC.UCGB.EGBDIFEAhABABHED.eCHBhACAHEFG.KCEBAGHCMEEGhADAfAFF.NCCE.aAGE...OCBHhAHA.RGFE.SFAFhAAA..,2,-29,-13,16
DUbWaBcSReZgNECdLVPfFXYITOKAJHQMG,HAEGGEDCDCDFUFFEaFHB.BCEE.RACCZAAFEBBFCFDF..dHAHLFFFhAAA..fCGChACAXEADICHAhABAKFAGADIFMAFA..WHAASHGA..hADA......hBAA...,2,-25,-24,1
BMgORTAUVcbaDXNYFZPKQWCfdHGeJSILE,VEFHaHBG..DAFE..XDABFBBFKADB.CECG.HDFHGAEB.SBAEhAAALFDBMCIDhAAARFDBAEEC.UBFF.NBAE.hABAZACF.QCGAdGHEIDDGBHAH..hABA......hAEA...,1,-14,-17,3
IMUYFEeQgcPOZHGDbadXKCWNBfRTJALSV,LDCHSCFCVGFAUBBB..FBEFeFED.QEAGhAAA..PBHBOHAEhABAGAAAaHGEKDFGNEEGfFAGhAAAJFFEACEHMACEEAFA......hAIA......hBAA...,2,-25,-13,12
BIdTcQJGUfgZOEDbaeXPKCYWFHRALNSVM,SDCDVFBH.BGDCTBFG.QDDAJGEGUBGFZDECDDAGeAAEhADAKBCE..CDAB..hAEA.WFHBFAAFAFFCMFGFhAFAdAFB...fAGBEEAB....hAIA......hBAA...,2,-36,-23,13
dcbIOTUXBfJLeAHZDQMFEgVRNCYaWPGSK,DDGBMBDHECAERGDE...CHEF.aEFBGFBF.dBEBIAHA.OCAFhAAAXDCABFCGfBBDhAAALCHHAAFCZAGFhABA.FGGANACC..WAED...KGGC..hABA......hADA...,1,-23,-31,8
RKJHLABGUXDPOMQTCSbaEgYIVNFdWZcfe,GCEHXGCEOBAB.QFCCSDBCEHFAIBFEhAAA.FEBEdCCEZGFGfHABhAAAKABDLDGBAFEEDEIHhABATEEGCBEFaBGA.YEAFWDBF.eADD.hACA......hADA...,2,-18,-6,12
VDGaSfbNUOXcQJRMBWCPIKTEAFdgYZeLH,FAFBdHBHZDCFeDFBLBGDDDCH.GAAC.aCHFfBDAhAAA.UGCFXADHhAAAJHFGBFHHPEFHKACCABCD.hACAHBGBSGAF..NBAC..QEDDhABAMIFGIGHEhADA...,1,-15,-20,5
GSVeDNXTLPMdCcbABUZfQFWgaOEKYHRJI,BFFCZEFHFFDEaHEAKCEAHBBC..RBADGAEFeCEADFAE...XGBFhAAALHCEdBHACECDAFAH.hABA.QEGChACA.WDAG.........hAAA.EABEIHAFhADA...,1,-25,-37,12
eEBAfPXICMcTWSZKbdNGHRaYULJOFQDVg,XCBCCBFD..TEDBSGBDKHEAdDHEHEFC.aABCLCBBhAAAJHDCFCGC.DDEGeAEGhAAAAGHG..IAHDhABAMCEHZFDAGGAF.RACB.......hACA......hAEA...,1,-7,-29,22
STXALaKHfBZFMWcPQVDCdegNJEYUbGOIR,LEGHaEHBHFCEZCBAMEBC.....PABADAFGCEFHeBAE.hAAAJBFBUAGA.OFCChAFAIADCSBDAhBAAAHIBBHCDFBHDcGBC.......hAAA......hABA...,1,-25,-30,5
XMFJPBETAeQLYUWObfaVdKHDGRCZSgIcN,eFCAQDACUFGD.ODFD..fBEDaGCGKBCD.DDEECHEGZAEChAAA..IBBHhAAANCIG.MBDH.FCHHhABABAHEAHBBLDAF......hACA......hADA...,1,-31,-37,6
GYZVDTBSHIUELRMNcfKdaXWQCPeJFAgbO,OGEAGEDHZABADAGCBGCASHEE.HAFFEDFCRAAAMEAH..hAAA.NDCE.fCCGhAAA.aFCGWBHBPFAFhABAFDDGAHIH.bFADTBDE...IEHFhADA.cAFChAEAKCAB...,2,-38,1,39
aeQbYNHJTIDLVPMGAgREXdfCBOcWFSKZU,RDAGXFCEdHDDBBFD..ODFAFACGZFAEaAFH....eFGDbEEFHGAAhAAA..IBADhAAADBDHPABHABIFEHAACEABSGGHhACA.KAGAYEFCNEIE.hADAJCCA.....hAEA...,2,-30,-11,19
edUYPLZHFWbJQRcVBACGaISXENfKOgMTD,CFFCaGAH..SHEAEDHFKBAE...OCBHMBDCDIGGeAAEUGDEhAAALEEFHEAHFDECJGAAQCFEhADA.hABARAEABECAAADCXCCB.fGGDhACA......hAFA...,1,-20,-25,5
HLOPDBSCXIMGEZeQfbVFYJaRdUWKcTANg,HAADLEEGDGDASFACCCEH.MHFCGEAA.EABDeBEAhAAAQAEHVDFC.YAHHhAAAJHAGdAHAUDDEhACAKGEAAEADODAABAEB.IHHE.fHCBhACA...hADA...,1,-13,-14,1
NIEYKVGPfbLUWQOXZJcCAgTedFaSDMBHR,TDACeEGHFABF.DIGEBGGA.RABF.EDBFKFDBGECB..fCGChAAAUGBEODDAJAFAAGFDhABA...dADAaBHHSFCFhAIAMEIHIAFC.....hBAA......hBBA...,2,-35,-20,15
KTNMDZCfEGQXBaeWHJSPYOcVgAIdLbUFR,LCCHFGFCRBCE.KGAAMDDFCAFB.GBFCBFHF..eGFG.HAAEhAAASEAGOBEH..hAAA.cBAHAIGAdCGATDAFhACAZGAAfEHCEGDB.aFEB....hABA......hACA...,1,-17,-26,9
SRCFTVGLMIJaQgfUHbPNKXdZcDAYOBeWE,OAFBBAFBEECGRFFG.FFFCGDCE.LDABMBCA...JBBEgGCBhAAAUCGC.HBGDhABANIAF.KHFE.dHAFDABGhAAAeCADCEEB.VCDGIHFAfBBE.hAEA......hAGA...,2,-24,-5,19
TYgcOUaCBQfWXDZIdLAHEebNVSKJRMPGF,HDEDeCCH.VFBFSGAFRGFA.MGCEGBCDFDFB.TAGD.hAAA.YHEAOAACaDDHhAAABHBEQCAChACAXACADBBF.IBFAAGAFEEGF.NDHG...hABA......hACA...,1,11,-28,39
YQXESUHgMVDaNLZbCGBWeIOFcdfAPRTKJ,TFDHJCCH..QFGCSGGAHADEMEDEDIDELBDChAAAZAGBCGCF.BABE.WCCDhADAIBAG.OFADhAAAcFAAAEEDKDHBEAHB........hABA......hACA...,1,-21,-32,11
RTJcDQPBYLbIFNVCUfZOSXHaWGMegAEdK,KDABTBDGDAHFBDCD..LGDGFBAG.CCAFUAGFZGDG.SDFDhAAAaGAH.GDAFhABA.eABCAEGGdADDJFAFhAFAQEDA.bAFDNCHG...OFFAhAAA.....hAHA...,2,-38,-16,22
KJXcTbQMeVEBNCRPOGUaAZfFLgDSHWIYd,ZDAGLCCHDFCCHGDA..IGGFdCCBKBGF.JBFC..XEEFhAAA..TDGHhAAAMABC.EGDDNBIC.CFEDPBAHhABA.GEAEAHBFfFBEFCEB...hACA......hADA...,2,-29,-21,8
WUMJQdCTEcZPLFAfIDBXgVGYHbaRNeSKO,DACBXGGGGDFCHCBFRAGF..eDAAKBDGUFDHMADA.QBGEhAAA.dADFTFBBhAAAEBAA.ZEDBFHAEAEIFIBAChABABDDB..........hAIA......hBDA...,2,-25,-14,11
KPCdHSNWLaBDRfUXTMeFIAVYgEbQGZOJc,VAADEHBGGCGE.ZADGOEEAKAAF.CAHCHADCSECFLCDFhAAADDAFRCDCUGGE.MHDChACAIFEAADIH...hADAbGFAcGAE.PEABWCBF..BHADhABA......hACA...,1,-7,-22,15
EMBRbYCHPfTJQKdeFISWNLAGVgcDaZUOX,GEDHVAAD.DCGEUFCGEBEC.BDDC..RBAECADE.HFAFTFFAKGGGFDGEhAAA..SCGGhAAA.LBFChACAcGDFODBEMFIFPDABfAGBdHFD.hADA......hAEA...,1,-15,-22,7
HcBfKFVDgIZNALbMSXYCOGReQEPaWdUTJ,MDEBXGBC..CDFGRFBFeCBF..EAHBPFCEdHGF..UAABhABAJAEAHDDCBADFKDHDDGGAZACFhAAAAIDE..LFADhAFAYHFEOFFBaCFAcBABFBEC....hABA......hAHA...,2,-21,-14,7
acCIUHeSMZDYXPRFWEVBdJTgKGOAQbNfL,QCBC..bBGFLHDEaEFCCGHDHBAHSEAGZFAGDAEG.hAAAPAAC.RDEEEEDDhAAABDDCdAGAJBFFKBDAADIBNICB.hADA.IHHG.MCIBFADH....hAEA......hAFA...,1,-10,-23,13
fbTWMHLERUcBZeSOVCdaIKYgGAXNJQPDF,XDACJDAC.DCFHFGHH...TGDGMGDAHCGHRBFH.BDDEhAAASAABCGHEdGACaABFKHBAhACA.GEDFABBF.NAEC.hADAPHBA.WBDE......hADA......hAEA...,2,-32,-28,4
RdWQeMDUVOXSIFgcCKEPbBGAHYfaZTJNL,HAADaHBGZDCFTFCH.LFGDdBBHeAHBMBFGUCFGOCDG.hAAAXGADFFAACGFBEHDABFAFhAAAABEH.fDBHhACA.JDEENACD.........hABA.WFFEDDIHIADGhAFA.,1,-11,-27,16
cMZbBOaULgVeEIPGRHAQFKfSDJYTdXWCN,FFHBKAFBDEDG..JCFGdCDD..CDAB.MIBEBGFAUBAFLFBC.hAAA.eHFEEACBGGAFhAAAAAHDQFAH.SDHBhABAXCDDNAEFZFFA....aDGE.hACA..IBAGhABA...,2,-40,-26,14
WgEcFOTULNBVARGbDYMXHJdKPeaQISfCZ,REBHGDCCDIGE.MBEDHGEAdGGBKBFH..eBFEaBAH.SHDAhAAA.CFAAZABBEEGGOAEGhAAA.TCCGLBADhABABHDGAGCB..........hABA......hACA...,2,-34,-17,17
BZaOfMHXAWJcSTYQVDgPKeIdbCRGNEFLU,JGEATGBC..QCAFDDGGKFEG.dBFCCDBAGBDEFGAH.BACAhAAAZEECaBBA..fFHAhABAMDDHADHE.SHFGhACA.VAFAeHCE..IFAChAEANAAFEEBF.....hAFA...,2,-30,-21,9
MIKRUWSAfbNFeBaTZQHOGCVDPcYgLdXJE,...fBFCbBGFFGFFBGCDZEBGHACB.OFFCCCCADEID.PHFAhAAA...YCHDhABALDAB.dAFCEHBAhACAIHAF.UAABAFADaCBHTEDB.hAEA......hAFA...,2,-32,-11,21
FAYcdeRHWbBMLIVXUaTKQgfZNPSJGOCDE,dHBHeDACRDFBHAAFBFAGMHCELEAE..XCFFaBFAKCHH.QABHhAAAZADF.NDIE.JHEAhAAAGEBFDGCAACFA...hACAWHAG...IHGG...hAFA......hAGA...,2,-21,-18,3
eATXMUBRESWOGKDIQPLgFNaYcfHbJZCdV,XGFBBFECSFCHGEBB.DCAF..IHEEQFGFLACGhAAAFAGB.aCGFfEAHhAAAHBAHJDDCCGACeHEGhABAADIHTGBCMCBERCGH.EDEC...OABEhACA......hAEA...,1,-4,-19,15
SDEMIGTfKdVHXPgCOLARYFabNUeWJZQcB,RDAGFAFB..aACBUAAB.eCGFJBFAZFGDBHBH..DAADEDCHGDDGhABAKGCC.dDGB.HFAAXGGEhABACGFC.LDADhADAABBD...NDFA.cADBIAHG..hAEA......hBDA...,1,-19,-32,13
DRJfadGeSLITcHEbAXZWUBYMNOCgFQKPV,ZEFHBHHGMDAGCEEE.FEBEQFDD.KBGCDCAE.RGCE..aAEFdADEhAAA.SDBChABALAGD.TCFDEAAGAHBB.XFAChACA...YCHBNBEGPAHDfHAFhAFA..hAGA...,1,-26,-39,13
GQYDcFOELASXUTZeWNPRHKBJbfagIVMdC,SEHBTCCB.ZCBGeEHD..NAAD.PAAFHGEABHAA.hAAAJEBEbGDC..aAFAIAFAhACAdBBF.CEFCYEBHhADADGCBFBGHEFFEAIAGXBGA...hAIA......hBAA...,2,-20,-11,9
cgLNKefbDTXdSaWFMRGZQIOEVBCYPUHAJ,JGEALGEA.KGBHeCBHDAHD.dAFA..SGAFFDDDMEADZABGhAAAOADBBFBA..CFGCUBABhAAAAEHF..NDIC.TDEGhABA..aDGBWAFB.....hABA......hACA...,2,-39,-35,4
NgDTcSWLRVPZfAJOdGCUbIXeaYFQEKBMH,dAABCFFHUAFC..IGAF..XCCCaAEC.FDGFKDDHBFDBhAAAMCIDHACGDHDCSGGBhADALDABPHBAhABAADFGOCCB.eFCFEFHF...NBBE...hAFA......hAGA...,2,-36,-26,10
HGIJQTCFDaORNVbAESLXceUKYWPfgZBMd,EEEDSGDDLAAEeABEKHBG.....PFFEfCDDhAEABCEEdDCBHGFAJAHFQEBDhAFATGAD.DBCF.hAAAOBEANHEBAEFD.XEGBYBBD.ZBFF.hAGA......hAHA...,2,-18,-10,8
WEgfILPFeRBaAcSObVJCMXdTNGDZQYUKH,OCCHVFDF..CBDF.dDHCGBGGDFGBZBEB.UGADKAECHAAF.EGHHhAAA..fAAFhAAALDAAFHAABACAABGBSEEEhACAMAEC..NIEB......hADA......hAHA...,2,-37,-14,23
HcEdFTBeSDXYfUNaMGKVIAJWPQZCgbORL,JGEAQCBCZCAF.CFGC.OGBELFACHADDdAHEBEEDDADG..XGEChAAAUAGH.MIFAhABAGCGEKDEF.ADAH.PBDEhACARABB...EHBE.......hAAA......hABA...,2,-27,-14,13
fCGHdWOKLXRZPMeJgaVIDBAEFYQTcNUbS,EAFBQGBC..TDGAUBADSFADGCCEHFDBOFDChAAALDAHZDFAMAEFhABAeBACaGGDDFFGAIHG.FDCDNCFAfBHGhAAA.CHAD.WBFG.KHDA.hABA......hACA...,1,-6,-17,11
cYMfOVSEPeRWHNJDdLQbGgFIBXTUAKZCa,CCAHaHBG..MEDGODAE..EFGCeEDCHAEEDIGEQCGAhAAAGAGCIBCHBCCCXFDHhABAAGABKGDE.ZEACfGGHhAAASGAE........hACA......hADA...,1,-22,-27,5
ELbFGdfHKDWeSRPOagcNVYCMTQJBXZUIA,LCCHGEAHdGGEKACCDCDEeGAARBGB..OBAGaAFE....gEEFhAAAVGDE.MEIDhABATDECBHDC.XBGAhAFAIAEAECEHFHAC.fCCEhAAASHFC.PCBB.hABA...,1,-9,-25,16
XOfdFDSHACUNebWTLGBgRIQcKPZEYVMJa,UGGGeGEA...TAADGABE.BGCARDEE.IFACKBFHZFAC.EECHhAAA..MAEGaEFEOAEAhABAFEBGDAIDADCCCHHHbBEGLHCAhAAA...QACG..hBFA......hBHA...,2,-21,-18,3
MgJbKDdULGcOXZfIVNQESBCHaYWReAFTP,TGBCMCCA..JDEGDGFDLHCEGEGE..OCBHZEFE.IEDBhAAANAAA..SAHBhABABCFDaGABYABEhAFAREACADBCFGGG..........hAGA.bAFAKGADdCCF..hAHA...,1,-20,-26,6
cJXZWPFeCVHTAdRaISODGELYUMfgBNQbK,dEHARDAG.aAHBSBBA.OAGFEEEHLBBEMIFA.BAFGhAAAQEEDKGCB.JEHBhAAAWEAD..eCDAhABACDDFVGEEAIBCDHEG.........hABA......hACA...,2,-36,-22,14
RNYGgUXCJZAMODLWVEfaeBFSbTKIcHPdQ,DACGLFBBEEGG.eADBFDBB...SHFAKFDGHGFGdDDFQBGEhAAARAFD.GCCAhABAXAACCFHCAEFCOFAHhACA.WFDHfBCF.BHDGIBBAhAEAcFAC.NAIE...hABA...,2,-33,-3,30
SHFVfAINEQKgdGaeXPCZbJLRDYWMOUBcT,EHBGKGFCGCDD.eFBBCHHEZCGBLHFADACAMGDEOECF.BABChAAATCEEFAHDADBCQBBGhAAAdBCB.XECChABAPAEA.RAEE.WEEASGAD..hAGA......hAHA...,2,-26,-15,11
faFgTNPDBAOebJKYdXSZcWLIUMRVHGQEC,OEEGeEEGKGDAdDAEZFBFLHCE.MCEERACBGAFA.CCACFGGEhAAANBCE.BEDDAFGF..JAEAhAAASEAF.hABA..IAHF......hABA......hACA...,2,-43,-30,13
QXfYTKFWODRNIgZBcGCSAPVHUMaLedbJE,VGFGHFEEUCDA.MAIBLEAC.dCFAbDBFJACG..XGCDhAAATBAA..FFBHDBGBhABAREDF.IEHEBHCACAHBAIEGhAAAaFAD.EGHF..fCDBKACC..hABA......hACA...,2,-25,-8,17
eHMNfCJTUSYgQFOVRXBKLdGPEWDIaZcAb,eFBBHFACMABECEHF.JBHDSCDD.QGGAOFDGXADEhAAALBAFPBBBhAGAEGDHDAGC..IHFBhAHAcCFEACCH.NBDD.UCEF.gGGBhAIA.....hAAA...,2,-31,-7,24
EQSCaVOXNRfIDUFHJgLbGMTeYBWZdcKAP,QGBCSEHBCEGGaDAH....VBABOFFC.RDCBIBAChAAAUGBFJBFALFEFhAAA.MDDCYCFEhABABAHEdEAHAAHAEHDAfHGBDEGEFHFE...hACA......hADA...,1,-20,-22,2
fNXOHPaAEQWcdBDYZJgVCSUGRTFMKbeLI,QGBCdHBHBDGBDAAFJCCG..CCEH.UGFHGGEFFDGD...KAGHeBADhAAALCBB..hABAIFDC.NEAA.hABAXADFOBFG.aGAGEEBC.....hACA......hAGA...,1,-21,-46,25
gDGLJBbKUXZOaICScPWTVHQFAEdefNYRM,EEEDeCCH....fBBENAEG.MBGFGFDDBGGFbAADKGADhAAAUBFG.ZGAAaACFCHEG.hAAASHCG.hACAPFBCWEFE.........hADA......hAFA...,2,-32,-24,8
FIHKOaJgfLARcZBPENDGWdQbUXSMeTVYC,RGFGBFDDEFDG.GDEA.QADDUDAHSHEGeBAH..TGBEhAAAVAAC.CFAGIHHGhABAKAHHJCGF...fAHAhACAAFFGZGAADDDC.WCBH.dEHE.MIDEhADA......hAFA...,2,-26,-15,11
PRCIVHcbgYZBaFWELGMQOXeDNUTfSAKJd,KEEDdDCDCHEFHFCB.....bCBGgGBEBAHAFAEFLCGHhAAAGAFEQACDhAAAOBAADGGANABEUGFA.SDFDhACAADAF........hAEA......hAFA...,2,-28,-22,6
JVWANEfIDXZBLTaORFPHYeCGSUdbgcQKM,EHBGDACBBGFHLFAD.OFEBFDGCHDBCCBDD.SAHFdCFD.hAAA.gDEGhABAKFAHJBDCAIFA.IHGA.hAAAXCABTFDFaBAD......hABA......hADA...,1,-22,-41,19
NYURIPGXcCFgbTZdaWMKfELHDQASeJVOB,eFFBOFFCBEACUAFCRCFDGADC..CCHAFDFB..bGAGdADC.hAAAMBAFKBAH.LEBFhAAADFIF.AHFE.SFBGhABA.NIBBPCCH.....hABA......hACA...,1,-14,-45,31
WKYcJNGHQFVfOTSRCeLBbIdEMAZgXDUaP,XFDHaDAB.KEABJHFA.HABEFCGC.OFBGRACB.LBHFhAAABAGBdHGHEGCCAFGDDFCB..hAAAPCED..cBAAhABANAGE...GCEEfFGF.hACACHAE......hAEA...,2,-34,-13,21
IcVFQCDdfNaUHWgPJEGRABZbXeKYOMLTS,ZDBHXDACKDHB..OAABMDIBLEEF.SAGAhAAAIEDDFBGADBBCdFGAaBEHHFGFhABA..gBDChABAEFAFABCGBFFFeHAG.TCFGcGECCFAANACBhAHAPHAC...hBAA...,2,-20,-16,4
cDAHOFfTURVMGNYaJebCKLSPIdQZBWEgX,HDEDFDCDUGEGMDHFGCGAaFAD...eBADCDCFSBEE.hAAAdABABHBGEGDG...hAAA......hADA............hAEA......hAFA...,1,-34,-56,22
WXSEGLIBbFVYTOUJQfcRMedAgDNPKHaZC,DACBKHBGHEAHCGFH.SEFCEAAB.LBCDBBEDFFDH..VGDGhAAAOEAFQBDEhABARDDE.MAGHACIF.gGGBhACAaHFEZAGBXGBD....hABA......hADA...,2,-43,-3,40
AXGdZYWCVJgHLBUIPeTRbONcFMEQSaDfK,GCEBdCFCZDGDCCBGJFAF.LEFABHAD.UACBeABA..RDCF.OFBGhAAAFHCE..EDADSBEFhABADBBD.AGDG..hAAA..XAGA.....YHCGhACA...hABA...,1,-31,-37,6
PRaCAWMdXLfbIYUBcFGOQENSKgVDTHZJe,MHFGdGDDLBHF..fCBEIABEUFAHBFADFACCOCDBhAAAQFCH.hADAEDEHSBFDhAEAKBHDDGGAZCFFPFFACDDCAIBAWBAF......hAAA......hABA...,2,-28,-28,0
ZRbILFfMAVcYgQOHSNCUTXDBGKEedaPWJ,VAAD..gCBCHDCECBGE.UFBCDGACKGDEeEDE.dCEH.aBGFhAAAJADGZGEEREFB.LABAhACAMHAC.AEGG....hAAA............hACA......hADA.YCDC.,2,-32,-17,15
OLDGQcAFKHNYCPBafMTRdXJebUZVSEIgW,FEHBKCFCHDBGCECA.BGAHMBFCdADE..eAAFZFEBECHF..ICCAhAAA..OEHFhAAADDGHQFADhACAABFENCACaGHH.TFEG.XBEC...hABA.JFDB....hACA...,2,-31,-26,5
EBJROCGbSWIDPMQXKaUTgdZYeALVcNfFH,LFBBVAAD...NDAA.FAFBBHGHJDEF.RFEF.GDGC..SAAFhACADECD.QCBGhADAXBGAaGDHhAAAgEGBdEAC.eEDHAHBDfADEhACAOBHFCDEEIBDEMCDF.hAEA...,1,-14,-29,15
YAbJXfFUdGgQCRTEKSLBOIMaHDVcWPZNe,JDACFGFCGBBA.CEEG.TEEH.EAACKAAD.SEHBhABALEHHOFAAMGAAHBFGhACADHDAVAEE..cADEhADAPHACeHAAAHGBfACA..hAAA......hAEA...,2,-28,-17,11
XVBTbQPODCNdeMgfHFSYWGRLKEZUaAcIJ,JGEAXGDCBBAB...QEFADDBE.CFAAdBHAMCGBHCBGFDED.hAAA...SBEFhABAYAFFGAABhAAARGBAKAGCZEAEAHHAcGAD.......hACA......hADA...,2,-43,-5,38
OfGJBKRdIgWeEZYCVUcabHMFDAXTSLQPN,XFCATGGD.LCEEQCBB.OEABGDEFKCFARAACIGADhAAAeDEBEEGHCFCAUDADhABAaACE.HFGH.MFFHhADADEIBAGEHNIAF.BHAA.WHCA.....hAEA......hAFA...,1,-3,-15,12
cKaFLYgPOZAIHMQEVUdeWfbSTGDNCRBJX,HFACQAGDEGDFUAACdDGAeFCD..fGFETABCDDDGCDEFBBFEhADAJDAA.KBHHaGEELEFEhAEA.gDBChAFAPFABAEFHIHHD....hAAA......hABA...,1,-14,-27,13
caWgQbDAdECXPROLZIUSTNFKfYGJVBMeH,dEHAEFFB.CAFE.RGAELCCGUCCG...TDFEFGDDKGFGGACDBAHE.hAAAMDAHHDAB..cCGAhAAA..aBHH.hABA.WHFA.........hABA.gDFDhACADBBDABIH...,2,-49,-6,43
RfCZIJadFEGVAXTKPeDBLMcgbOWYUSNQH,XFCAKGFCDBGALDFA..MBAA.bDDAODBE.UGAAhAAASBGGHABGRGCACCADhABAIHBAdAFC.FCCBhAAA.VFGFAIHG.PCAH.BAHH.WFFDhABA.....hACA...,1,-10,-28,18
fEBHAMPTODbScRdaFGILJKWCQeVUgZNXY,TFDBOFCHDBGH..SFFEdEGCFBCHLAFCKBECCBCH..eCAHhAAA.UCGDNEIC.fGAGhABABFEGMCAH.hACA.PHECbBDDaHFAIDDC..WDAHhAAA.....hADA...,2,-28,-28,0
HPEfRcaKLDeYMOQBTFXVgAbZdSJNGWUIC,ZDAGdEEDSCAHJGDE.GGDFUAGDCEEBEFCH..RFBH.KCEELBAEhAAADADEeBHD.OBBGhAAABHGCFDFA...hABA....gADBADCDWFBF...hACA......hAGA...,2,-40,-26,14
NZEaYTJQGRAKOgUXVdIHBCcPSDMbWFfeL,OCCHUCGCdBBEBGCD..CEEA.SDGBDBEC.MGFCFHBALEAEhAAAZAACEDDG..aEAHhABAJHFA.....hACA............hADA......hAEA...,1,-41,-58,17
RdOcKSCGUQaBYNJXHbeLTZDWMFfEIPVgA,RDEDOCCHKDAGGAFEUGEGBAHD..JFAH.HACFeGBEZFBFDCHBMAIDhAAAFAEG...EFHHIGHAhAAA..PHDAhABAAFFASEECCEDG.aDAF...XABAhABA...hACA...,1,-16,-34,18
AMJRIEcTPgeGQbVFSYWUfHCZaLDKdBNXO,JGACRDAGEGHH....TFDCeACFQBGC..bCEG.hAAAFACBSGCChABAUAFCCFHDLEAEKFEEBFAD.hAAANIAHABBDMBIBIEHFcBAC...gGGGhABA...hACA...,1,-19,-27,8
MdLBKRYGfDTePUHgSCZEVNFWJbAaXOQcI,aGDDXDCH..QEACMGEEBGHHRDCEGAFCDIFA.TFGDhAAAPCDAHBAE.CBHBEADEhABAFAHDJCBDAFFH.OAEGhAAAIDHCKDHB.eHAASBAC.ZGBAhABA.NDAE.....hACA...,1,7,-23,30
WeEgDHOQIMFPBYNAfTcVCbJKURLXGaSdZ,TCBCCFDDKBFH..UACBRFCELAGB.aEAFdHBB.eEFBDIGAHDEEhAAA.OABEIHEChAAAPGFEBBADADIH..hABA.VDAE.JAHF...SGAFhADAEAFDMIAE.....hABA...,1,-12,-31,19
WRVEQTGcXIJNSCDeaMgYABOUdFLPHZKbf,OEBEdFHALFBBHEEFKGCH..bAAFRAACEFABGAEA..IAHAhAAAJDBGSGDAhADA.DAHHeCEEMIEAADCAFDAChABAfDGAWHEG.......hADA......hAEA...,2,-21,-13,8
SdcaeWUOYLBKRNZFPJfbQTXACDgGMHEIV,CAEDDCECGDCFECCE...SDBFaDGF.eHBEUFEFLFFGhAAABBABRGAAZAFAFABCfBGBhADAQDAFAGIHMCCGhAFA.IHFFdACF.......hAAA......hABA...,1,-12,-31,19
XAPEWUVbRQIOBNCDceKFGfTHgJaSMdZLY,EHBGVEFHRAFB...OBFHCEAA..DGEGeCAAFDHFGACAHAGHJFAB.hAAA.SHGAhABAdACH..LEHHhAAAAAHCPEDCUGCA.IBAAcFCC.KECCfCBGhACA...hABA...,2,-25,-12,13
MSEgQBYIXFNbPTUCJfDcZWHdKGVALaOeR,aGDBRFBGMAAF..SFEEEBBC.BCBFIEDCFGAH...hAAA.bAFBPCHD.hABACGFEJBDGfADChACA.DDAFcGAHZGEEdCHAKDAAACFDODDCeFFE.hABA......hACA...,1,-15,-28,13
IOTCbUaEQHSNDZfYXRJdGALeWBcMVgKPF,LEEGeAFBBCEDMAAFKFEE.FCFE..TEBACGAG..aEBCEHFEQGGChABAHAACDDADZBGBhAAAXBBHJHAC.AGEB..hABA...cEGDPAEA.....hADA......hAEA...,2,-27,-21,6
RPWFMXSJATbLCIBOVQDdgUHEfZaKYNcGe,TDACLAFB.CFEGBDEDOBCG..QDABDDHHdGEDUGBHEHGE.hAAAaAADKAHD....hABANAIG...eBBCPEDGhAAAWFCH..MFAFSFFEAIFAICFFhACA......hADA...,1,-28,-32,4
IATcUbXaQHKSZgJDWVGPLNeOYERCFfMdB,TCGCUCBC..aHEGHFFHZFEA.DBFHGAEDLEAE.OHBEhAAAEFCBFAABdBAEAIHA.XACChABAKHAC.SAHBhADA..JEECWFHHNCIE......hAEA......hAFA...,1,-15,-28,13
VcPSQUaIOLbTKHWYJFGMZBNXRdfAEeCgD,CDGFVFDG..SHGEUADG.ODEDLAHFKBDDHGAAJCACFGAAhAAAMBFC.BHEAXCFDhABAdCBEAEHE..EABCDBBGhACA.....PHFCaBAHIFCChAAA......hABA...,2,-28,-28,0
GAKSIWdCZHbeDPcTNgEVRMQLUJXOYaFfB,KAFBSHBGdHADHDDGDEGG..TGGEEAFEMFECUAAF..XCCChAAAaGDHBEBEGABFhABAAFGACHEE.eHDE.NGDB..hABA............hADA.RBGF.....hAEA...,2,-26,-19,7
MQDTGNYCcKLgVOBfAReFIZSJWEUdPaHbX,RDEDFDCDZAFG..JBEAUEAE.dACGaABDHECD..MIDGDIEAGEGEhAAACHBA.KBABLEGFhAAA.OEEDACIBIHAChABAEDAH..XCGA...TFAChABA.NADF...hAIA...,1,-22,-34,12
WVQBUKMYCZJIcSTbAFRfedPGOLEaXHNgD,FCFCRFDFdCDGOGEELFAH..EDAD.HACBDAGCQDFDhAAAKEDH.MDIFCAHGJFAHIADGhABATAAG..AIHE.PABFhAFAaCHD..........hBAA......hBFA.XGGDWHCG,2,-29,-16,13
AJHQCYBgVZaXTSeIPfcOREWNMGDFdLKUb,HAEGCHHGBGFDVFACZDAF...aEHF..TBCBeDDC....PGEAhAAAOCFGEACHMAAEhAEADIACLAHBKEDB.hAFAACDD.JHAAYBADSDGHIHHA.hAGA.fDEBhAHA...,1,3,-45,48
dSBXWEYMARKTPFHQODVNgcCeZILafUJbG,TCCBFCFCOHBA..DAAF..VCBGNCBE...CFHCZDFGaDGEJFFDhABAdEAEBBBC..EHCEhACAAGFAKAHFQAGDhADA.eEEFIAFFfAEG...hAAA......hABA...,1,-19,-41,22
EWYBFDSCbNGRLAXIPUOMQVTefacgJdHZK,XCBCUCBCMGCE..QAAHeHFE.aECAJAGHHADBZDFFEACGhAAABAFC.DFFA.CHCBGGEFhAAAAIFAOFABTAGFhACA.fDGH......hADA......hAIA...,1,-9,-36,27
edBXaMOCEfLbSgGKAYFVHTRPcDJNUIWQZ,FCFCHBCDRFFB.DHGAUEBDQFDA.eAGDBCAG.MIAECEAA.LAAEhAEAbEBH..SACEhAAAKGEFAAHG.TDFEhABAJDHB.NIADIAHAZCDH....hAFA......hBAA...,2,-35,-16,19
MbWZScHeFDgQBaEILGVUNJRXCTAOdYKfP,dDCDKHBGMAGBZAFAHGDA.FBBEQFGFBDFG.EFCALDGHhAAAGCAB.VEAFJACCXAAChABAAIFA...fFAGhAFAWBAF.SGEG.DAIHhAHAaHACIDHCNDIECHHD.hABATDEA.,2,-15,-5,10
MDJLZOcYETPNUFbQfIHgAXBWRVeSCGadK,BHHGRGFGeBAESCEDGBDEdBHCKFBH.DBEAJEAE.LGBGZAGDOFDEhAAAECAE...TDAEhABA...NACD.FDGHhAAA..QBBE.IEHFhBAAAFIB......hBBA...,2,-34,-19,15
dTAYBVZOMeHLQgNaSGFcJDXKbRWPfUECI,VDBHMAGDHBBC.LFHDQACGaEEEFAHHJBAB..KCHHRFCE..hAAA..PCABEAFCIHGGhABAAABBZFAB.eEEChAEASHDGDIBG..bGCA.....hAAA......hACA...,2,-16,-13,3
daHVEFIQUYLXTWPOfJCGMZcAKBDgNRebS,KFGEBAEDDEDHRDGD..eHAEdCFFHAAC.EEEHIFDE.UAGEhAAAXADB.TGBEhAAAOBCH.CBAHZGFAAAHDNHED.hABAaFAE...........hAGA......hAIA...,2,-34,-33,1
GBeVJNOPQXRdcEbMTHLWKaADIZfYCFgSU,ZFDGCFDGFCABSAGF.BAAAJAAA.OBHDQGBD.dDCDhADAECCD.MFBEHBFBLACEhAAAaGFAAGAG.IFHFhAIA..fHEF.YEFGhAEA....hAFA...,1,-30,-41,11
aMZcJGSgBTKPICHDXOVRYNAFUeQEdbLWf,FGDDUDCHQDGBEAEALDFC..fECDaGCE.ZBADJFFGhAAASDCEBBCFKBADCAHAhABADIGG.OFBB.hACAYGFAACGC.dCFB.MFABGEAGgADAhAAAPHEC...hADA...,1,-5,-27,22
MFXDeBYULEQATfdcgHGaKCZNPbSJOIWVR,dGFCHAADKBAECCHAZFBG....NAEG.SACH.JDFDOFFAhAAA.VGBAMFIDDEFChABAeEAGBAFDLHEAhAAAEAHB.TAFH.fCECgCAGhACA.aGAH.bCCD..hADA...,2,-34,-11,23
eNIPTdOKgEUGCFQSAMfcbXRYVWJLHaDBZ,MCCA..fCFCXDEH.REAHVBBDLDBBHDGFDAAFBADDhAAAeGCA..PFCEhABATDGGdAHEOAFFEAEECHHESGGDhACAAAIB..YEADJHBG.hAGANIDF......hBAA...,2,-21,1,22
GENKVHdTDLeCZSfBcYFUQXIRMWAbOJaPg,OEEGaDCDGEEDKACGHCADDCEC.LFDAZEAFBADAFCGAUABG..hAAAIHHGMAFAAGDD.JHBAhAAAEGHHdAFH....hABA.CCEEfDCFYHCGXCGA.hACA......hAEA...,2,-21,-19,2
BRKHOUbSJdTDcFGMQVYPXWEeILNCZAafg,aHBGBFDGHCCCUCGG..SFFAJHAC.DAAGFABEMFEF.QDAChADAVCDD.XAGDhAEAeFHFLAEAhAAACGHAADGGfAEFKFFBdFAB.......hABA......hAFA...,1,-11,-33,22
NURZXGWKSVCTMcHFaYgAEbeIQdPJfBDOL,eCCHdGFCJACBDDAA.LGFCUGBE.ZABAGECHKFCA...CCAE.TAFFhAAAHAFFFEAG..hAAAaEAFAABC.EHFA.ICHChACA...fEEBBDHBNEHA..hADA......hAEA...,1,-28,-33,5
RbgGLXdYOVIBDeaJTCUHScKWEZQPMANFf,FHBGRAADGAECLACGdFGC.OFGFBAHADEAH..aEDCCHDG.HAGDKGBD.hAAAZBAF.MCDAAEDB..hAAA.fHEBhABAXACB....IEBG...TCGEhAGASDGGEGEB.hAHANDAA...,1,-11,-39,28
WbYCDKRNTHEMIBcFeafLVAdGQPJZSgXOU,GBDBQDACJDBA.ZBCA..SABGXCGAUGFG..hAAAYGDGCGBCRGCAHDDAEFAAhAAABAHE..FEGG.hABAfHBBACAEPAEE.WAFEDFFE.KHGA.MCAFhACA.....hACA...,2,-15,-11,4
LPUKOVTDAcQNaSIFdgHRbeGWXfZMBYEJC,QCBCaAFB.SAEAICDFFAABdGFEHGCGRDEC.GAGEhAAAXGFAfFCFhABAMBCBBADBEACALFABhACAUGCB.KDEATBGAADIH.....hAFA......hAIA...,1,3,-28,31
AXfRWKeOIHSUZDFQMCaJVLPNGYgBETdbc,REFHeCCHOEABHGFEZACDQFCE.MIACJCFELECFhAAAGBGGgAACEBAD.hABA.TEDCcADAAEIH.hACAfFAAKBEESHEGDEIDaAFF...hAFA......hAGA...,2,-22,13,35
dbCMHBXNZFOLeVfGTJUEKRaDAPYgQcSWI,...PGEAgCGC.QDAFSBFHdAABMAFGXFFGhADAFBAELDAEhAAAeFCBVBDHfEEDhABATGAE.JECHKGHBDIGAAHEBYAFAWEHBCCHEBBEC.hAEAOEAF...hAHA...,1,-4,-10,6
gUSOcefQPWdGACYFJRDVHLXMTIbNEBZaK,FEGDRAADHEBELBEFMIBE...TGCB..bDGDEDACaDECUAGHhAAAOAFDeFAA.fABFhABAWACG.AIHECGHADHBGhAAA.XGFCBDCHgGEBSEAD.hAEA......hAFA...,2,-18,-8,10
KDaTULfEbMWCOBYNZIdcSVJgHAPRGQeXF,REBHGDDCeFGB.FBDEDDCEUGFELAHH..EAGCMBAGCGCC.BHFEhAAAZCAFdDHA..SAGDhABA.gGDDhACAABAGXGADaHBC...fDEAhADAOAAA.IEAGhAEA...,2,-31,-28,3
ROLUTXGSgVbMPafcJIFEKeBYWQdHCADNZ,ZFDGLFFCUBFG.XDCA..gFAGMAAF..fBBBhABAJEAC.IHCHhACAFBAGECCDBHHGhAAAWBFBHFAHCADCDIEEOEEGSHEA.PAHFhADAKEHB.....hABA...,2,-33,-11,22
cVNWaGJCSPEObMQAYHITLZDFBKfdUReXg,HAADTDACDIGA.KEEFUGACRBFA...XCDDVEAF..aFDHCDFEEBBEhAAA..MEIFACADLHFEhABABADBeDDENFCBJCHBhACA.....SAFC..hADA......hAEA...,2,-28,-23,5
HFcZVNQELJYaSfgDRBAWGUOeIPTbdCKMX,UAGHOEEGeGDG..TFCFdEFDCCBF.KEBFHDAGFAAE.ZABC..QBDEhAAAJHAA.SDAFhADAfFABDGGGhAEABHHFAICGIAHAMACC.XGFCNDDF.hAAAECCB.....hAHA...,2,-22,-17,5
SIMgZOCeNBHaLfEJQYGbXWFDRAPVdKTcU,VDAGKFAAUAFC..MBGBZGEG..CBCC.BEDALEDCEBCG..JFGBhAAAQADCGGAFXBAChABADDGA.AFIB.dCAEhAAASFFFIHBAeFDFNAFE..fAGBhACA...hABA...,1,-15,-33,18
PNBUJQHfCKWMFGcZEVAXYgbLRdeDOTaIS,XCBC..gAEGRFAHdEGE.eFHFDAFDaGDDSAAEhADABEDEUAAFQECGhAFACADE.KHDGMDFFcBBChAGA.EHAEAHIBLAGBIFFENAIAfGCAhABAWEEE....hAIA...,2,-30,-9,21
RSOHZCGgMFPbJfELVUTNAcQeIKWaBdDXY,QDACKDCDBEHCDHDARGBEHGFE.ZBCFCHGCGBCDFCFF..JAHFEBAHhAAALFEE.UAAEhADAAAFDeFEGaGABdAEF.hABA.SGAB......hACA......hADA...,1,1,-50,51
KCQaFHMGROUNcSAgZdBLDWEVJeXfPIYTb,ZDAGLCAFDAIB.VEDGJFDH....eCACXBGB..IAGAhAAAbCCG.KFABCHHDFEHFhAAAHFFDRFBD..NABBAGGBBCGGhABA...fEEFYBBC.aFHDMIDEhAGAOACA...hAHA...,2,-29,-16,13
GJYFeDTZKLcVfQMREbgaAUNBHPISdOCWX,BHHGHAADSEFGCBDGGDDB.FCGGDBHFZGECKGDCLAEB.fEBHhAAAMAGDEGFA.aDGEhACAACAHUEAC...hADA.IHAEOHAEXABF..hAAA......hAEA...,2,-39,-11,28
WCMgJcHUBfISbAETLaeOXZFYKDdNPRVQG,EGDDTGGDLEEC.ODADFCGDDEEDdAHERGAAGCBF.MAIDhAAAgGAAHACCBFFHhABAIDCBABBDeDADXABHhAAAKEHB.VADECAGA.JGFA.....hACA......hADA...,1,-8,-9,1
fBHaNbOeWEZgcVAUTXQCPSGMdIYFRDKJL,XCCBCHHGGDBFdEGC...FGAARAGFDIDCLAFCHEAGaDGC.OACChAAAEAACZBCA.VGDEhAAAAABBUFEF.TGAEhACA.PFHBMDIF........hAEA......hAFA...,1,-13,-19,6
XDcWAIHTegKQMBCPLNZdFVaESfROGUbYJ,TFDHKDCDQGEH.BBCDCDHCLAABdBGDFEAH.VEAA.ECCBhACAREFAOAAFUAEBJFFADIAGhAAA.AGDE.eHBG.MIFEhADANACD....SDDHfAHE.hAHA......hAIA...,1,-6,-34,28
EeNIaPHXdGUScTBfAJbYLZFgWDRQKMOVC,JGEALGEAZCAF.FFAADDDCRDDG..KDHD..MDIHOAAC..CDFH.hAAAEAGFeBBG...hAAAaAGFHCAC..XEFAhABAdAEESGADBGBGAGCA....gAEEhACAWHCG.NIAD.hADA...,2,-42,-21,21
fCVLFWSMTUcdaBIQbEDgKJeAYXNPGOZHR,XCBCGAFEHFEGRFDF.CADELHFGFHGA..MAEHUFAGdFBAaBBGhAAABAHEQCDDhABAEAFFDCIFKFADeCAA.ACIH.NAAE.hABA.ZDGFfEHE.SHBAhACATDEA.....hACA...,2,-20,8,28
CTIcdeJOHEBaSDFGLWMXRVQYAgbNUZKfP,...NCCA.KDAF.CBAE...IDAHeBHBHCFBBDEDaGBCFGGELCCHhAAAMIBG.RFDBQFGEhABAABGHUDGEZAAE.fACFhACA..TFDH.dAFF..hAAA......hABA...,1,-13,-34,21
SaZYCKPAdQBLbMWXecVNOGfgHRUTFIDJE,dFFBBFEELBCAMBFH.eHCE..VEGHOCFEGFABHDBBUAAChADAIAHCDCIBSDDFhAEAaGGHCADB.AHBD.WBAFhAAA...XGAHfAFB..hAHA......hAIA...,1,-12,-37,25
OMcGBQRWVPZadJSIebgFTDUNAfXELHYKC,EGFCLFBBKFBG.MIDABDHEREFE...VDDDZAFEJCDH..SAABhACAeABF.FAEBDHEEhAAAAEHFHBFACHHFODFAQDAFhADA.PHAEIGAA...hAGA......hAHA...,1,-24,-27,3
TFDJZbcVGfXWegRHEUMCQINAPOBdKYaLS,OAFBBEFAKDAALDGFFAHD.DIFCZCDD..VEDBGEGG..hAAAXAACeABCHFABhABAMHFEIGDAAAGE.hABA.dDAFaCCFSHBAbAFB.WCHB.hBAAREABECCE....hACA...,2,-18,-14,4
bQLJcHOVWGYPNUdSeMDgCEKfaAIZRBXFT,ZGFGBADCFCHBQFFDLCCDHFADOBFHGAED..PFAEhAAAdDEAeAAAMEBGDGFGEEGEhABAaGDBAIGG..RBBE...hACA.XGCA.......hAAA......hABA...,1,-16,-17,1
MFEaNDPAebWXYRfIUSdgVKTJGCBHZcQLO,eGEAXCBCRCAD.UFAFdABBKEEE.GBGGHDCCQAEChAAALAEFMGBCFHFAaEHF.DIDAhABAAIGA..bGACfBHEhACASCCBTACG.BHAA.ZDFFEAFAhAAA......hAIA...,2,-13,8,21
FHBafYKIOcCAbNgPJSWUVTdXQMGRDeELZ,...NCCA.gFCA..PEHBSAEBUAFCVACChAAATBAA.QFGChAAAGEDADDFBEBGCFBAHBDCChABAfHBBKDADODECAIHA......hACA......hADA...,2,-22,-20,2
fXGBJDALRKOSTgVHaEFNWPQbUCdZcIeMY,LDCHRDEDOAAD.SACB..TCCCHCFHaBFAECGHFAGBhAAANABC.QGGEhACAUFFDdGAA.IEAFMEEH.hAAAXFCHBAHBACEB.gADD..hAFA......hAIA...,1,-14,-21,7
MbUTNYZVXBgRAQFLCPeJSIOHaGcDdfKEW,QGGDCDGF.eCFGIFAGHAACaDCBDECCKBAG..WFEBhAAAUFFA...TADChAAANEAEZDFABHCH.AEDCPADAhABAJFDHSCHBcGBG....EBGEhAHA......hAIA...,1,-4,-49,45
OEgMfIVFaNJdPKSWYcTAZGHBQbeLDUCXR,GCBDBADCQDDHLBHBDGBHCCBA.OFHBMBEA...VFEBhAAAaGDEdCGGKAEC..SEEEhABA..WAHBhAAATBFEAFAC.........hABA......hACA...,1,-20,-50,30
EScVaZOLWHbGKeUAgTRFICdQfBYMJPXDN,REFHCFEDdHADBBAD..MBAHJFHB...DGBEEADA....SBBBhAAAVGAA.aDFBZEDFOEBAhABAHCBAKAGD.ABBA.hAAATGFA.QAFC.fDHGhACA...hABA...,2,-35,-30,5
GQWZcXVNHCdITEJLURKaOFAMbDeYSgfPB,DDGGSDCD..PADDBCGDQEFAZCAA.XAAFhADAVEFFCGCB.dBDCEAFAJHBChAEAUFAEKHFA..aAHBABBCeFEDhAAA..........hABA......hACA...,2,-33,-30,3
gSOEZDRMCQbGKWBXJYAVPfUHNcadITFLe,VAADUCBCHBFH.aBABdHBF.FDEGLAEEeEGH.OHFADAFEMGBEhAAACFBBGDDE.BHDDhAAAJEAEAIEA..fCHAhABAIADF.SFGEEEFF...hACA......hAIA...,2,-35,-9,26
KgUPBSNLAaIXeZHQcDWRTVCFEYGJfObdM,XGBCeDACQEFCDADG.RADF.CEDFFFGGGGAH.ODFAMCFGUGDAhAAASAFHLABFhAGAAHIBaBBGZCEA..WFAChAAAEEBB..fGHA....hAHA......hAIA...,2,-24,-9,15
eWTQRKNUHODEFbJLYSZIBCMGfXgVcAdaP,dAFBeCCHQCGBKABDUDFB.HDDD.DCBFFGBGJFFHLAFG.hAAASHGGZACDCGBHMBAFhABA..XCAChAAA.....cGDBPHCC...hACA......hADA...,1,-22,-37,15
SbaQBXeNPRdUIEADLGTFKcWZMgfVYCOHJ,DCIHLDACFBCG.KGDCZFBAMFBG....fDFFCDHBOBCCHAFHhAAA..SECGhAAAaAHFXGFDPBEChABAdFHAIHCGAFGH..TCACWABC.hAFAYAFC.JFHFhACA.BDDC.,2,-29,-12,17
ACDMWLBJKSeHObVFfUaGTRgPdNEZXIQYc,DEEALCHDBCEBKBAHSGCA.OAACFGCHUAGCGDAA.hAAATCDDRCCFdGGGZFABIAHAhAAA...cDCChACAABEACADC..MFFBWFEH.eADE..hAGA......hBEA...,2,-46,-18,28
TEaMBKfSXcNJgVFWOZYIPeRCGQAdbHLDU,dCFCHFDFDICCEDAGBEAGSFAB..XDCCJDFBFECD.ZGFE.hAAA.IAHFRBGHGAAChAAAbABELADF.hABAaEGE.MHAGfGHE.NCIG.WGBEhACA......hAFA...,2,-25,-10,15
EafWKMJSAUPedZVHDbCBcNTQYOILFGgXR,UDACdDCDHFFECFDG.BAAD..TGGEOBHHLABAFHAA.GCEFhAAAXADAEHEEaHCChACAKCCCJCAB..AFGB.PFDFhABA...eCFHDBGCcGAB.hACA......hADA...,1,-20,-23,3
ReDHIfLUVbNadXWFTCJPKcGSMQYAZEBOg,BCAHOFBBeFGFDCIBHGDELBGF.UFAEVBDF..aCCCXBAFhAAAFHDG..JACEKDGFhABA.SAFChACAMCIHACEGEEEEIHHE.fFGH.hAAANDAATDBGCBAC..hADA...,2,-25,-24,1
GZKAceLgHSTIBDYdEQXCaRMWVUOFbPJfN,eEEGLFBBHFCHTGDFBBHHdBDF.QDACCGHFRBBF.MDDGhAAAVAGFOFHFFAEGJEFG.hABA.fGADhACA.NAEFKGEAAFDFSABFIBBFDIEEEDEF..hADA......hBAA...,1,-7,-22,15
CYBZSbDfXgRTNMAcWEQLFaUdVKOIPJHeG,EHBGQGGDLBGHFCAHUBCEdFBB..KGEBOFEG..IDEChAAAJBAD.GAFGhABABCFBSFDDhAAA.DFADXABD.REFCMAIHAGIH.aHBAhADA......hAEA...,2,-37,-18,19
IXbYcaFMgdNLSHVUEfPCRGZKJBDAOTWQe,ODACTCGC..QCDBXFDA.....bGCAaHCEFCAEdCGEhAAASEFBUFADPABAhAFACAACRAEEKHGGDIFAAEEDIECGhACAMBFH.LEAFECCAfGGF.hADA......hAEA...,2,-17,-9,8
PZdUQSLeGTMVIENYbBWRAOJDcCFfHXKga,JBFDDAEDCBAFHBBE.KFFD..aDGEZEBA.dGHGSDEFGGAB.MIFAhAAAEADE....NBIA.hAAAbGBABFAD.ABAF.cCBChABA..fDGCXAGD...hACA......hADA.UFGE.,1,-19,-26,7
TRPDOQMgUAaVEBFcGZdWKNeIfXYLbCJSH,aEHBBCAHGBCCdHCFKACF..eFHH.XDAHLEDA.CBGB.SEFDhAAAHFGBRFAAOCEEhAAAQAEB.MCGDhABAAHADEAECFHAC.WHDENBIE.IBBC.hABA......hADA...,1,-3,-31,28
ZeBYMHWTXLfGIDEFSgJAPVdUbKaONQCRc,VDAGUGBCKAED..OEHHCAAE.ZBBCeEGHBHBGHDDG..TEEAhAAALCCDGADFhABAEAGHSAHHhACAAADCdGCFNAIE............hADA......hAFA...,1,-19,-34,15
FGTJSENagVKXQRBUWPLHOMdYDAZfeIbCc,ZFDFeGEACBGHGAAC..JCDDEHGEaAGCKFFAQABA.BFBAhAAAUADCLEFEhABAMFBBdDHAAIAE..IHHEhAEA.FBFHSDEANICF....hAAA......hACA...,2,-32,-18,14
DgZCXBIQRAJeLTcYOVMadHUFWPEfGNSbK,LAABTCBC.OAFBMDHHHAEGFHEE.EFDGGACE.SDHFhACADIEEgFAEhAAAXEECBBACREAFAIAGeADDhABA.YFHBaGCH.dAHA.....hAEA......hAGA...,2,-23,1,24
AWQPJENeVXdDHFcUGaKCROIBYZTMbSfgL,QCBCEDCD.eHDAVBDEdAHAFAHHUDECKAAA.RGBC.BGHBZADAMCAHhAAA..fFFGhAAAAGGC.JHDADGAE.hACA...cFADCEGBIABF...hADA.YEEC.hAEASEAF.,1,-16,-26,10
BLeMYPUSJaZROfDHTKVNcXgFIAdbCQEWG,CFEDEGFCGCFABGBBLCAB..MFHFUCDHJCBGRABA.DIAEKDGH.hAAA...VEAFNCIE.hAAA...XAGFhABAIABHAGDC.dAHA.QAEB.eFDDhADASEEG.hAFA...,1,-28,-30,2
VDXZIJdRUEcWgLTfQMbFAYSPKBaGCNOHe,SHBGBFEDaADHGBACOCHD..eDEGVABDDGAB..ICFFhAAAJFHB..dHDHREBEEAGBhABA..gFBChAAATGEGMFAHACHD.YDDAPAFCKFFCCAEAXGGFhADA...hABA...,1,-3,-27,24
EMbZIgBSQcGaTLJCYOdUHXfFAeRWPVNDK,eFBBRAAD..VDEGDDGDMABGZACCBAHE..SAHDQGGHhAAAaDHDLHCG.hAAACBGFOEABUBBBXAEHhAGAFDCDACDC.WEBE.KHDG.IGGAhAIA......hBAA...,2,-33,-19,14
WUVgfPKRGOBXdTbFNaYDMEeCIQSAHZcJL,HGFGZFDFJBAALACG.UDAEVFAA..fAGGKBECGCEFhAAAXECFdHGH..hAAATFGFNICBDEGFMDDGhABACDAA.SFEFAEEA.WDHB...hABA......hACA...,1,-6,-31,25
PKgUfTCQbLdGMXcZFJWVOERISYAaNBHeD,BFEDeAGHKBCGUCFF..CDEDLEAGMBECZBAB.FFHB..JFABOBADhAAA..EGHFSGBChABA..aCCDhAAADHDC.PEFDfGFA.TGCChABA......hACA...,2,-42,-32,10
MTKNVDSAIHPZYeBEdWcRFfUXbOQLCgaGJ,HAADZAADBFGDdBGERGCGUGAAOFGFLFED..CFEGGAEGMFAAKDCEhAAADEAE.AGAE...IAHAhADA..YACBhAAAeHFEEDHF.FAEC.XCEF.hACA......hAEA...,2,-30,-18,12
SODZVgRJAHWIcXaYEBCGeFbdPULfKMTNQ,HAAD..IFDGaCCDEEEEGFBDeAAFFFGDdAFFLBEBKCHDMHFGhAAANEIC....QAGChAAAOADFDGGCgGBDhACAABIBcDAH.BHEA.CDBDPCBA.hACA......hADA...,2,-14,-11,3
fGWDZVAXRQLOMSbHaUCFdPYIBEgJTcNKe,RCDBQFCAMIDA.SFGCaGFG.FBBHdFCE...PABChAAABBHDgGADhAAA.JDCGNBIEeAEGhABAfGHGDCGHAAGE.OACE.bBFDCEGHIHHAhAIAcDAC..WHDAhABA...,1,-26,-31,5
ZQJSALHVCPcBIXOdUaEFDKNWgMYeRGTfb,LDACVFGH.CBCBBBEHOABC..dAHCaEAADDHB..KGBA..hAAA..gGBChAAAMCDAeDEGGGEHfAGHhABAbEBE.JDDFAEIH.cBGDIBAA..hABA......hACA...,2,-35,-20,15
WgRTUQFeKfEJdOYVHZcbLGBNDACaPISMX,aEGDSHBG.MFEBXABE.RAEFQEBFKFHFJEAEdAHCOADDhAAAHGEA.ZDFBLHAGhAAABGCGAIHECCBHICHAhABA.gEDHFBAB.fGABhACA....hAEA...,1,-14,-30,16
JKFbHQgRDEeLVZMIfcPSaXWOdYCBNGATU,TDCHUGGDFEBF.HBBERADGDHAELBGH.ZEDDMFFD.fCABhAAASEADaGHBOAABhABAdEGBBAGBADIH.JDAFhABAKHAAQGCC.eBBG...hACA......hADA...,1,-7,-26,19
XWDKIAZOJefbHcMaRFYVQgTdGUCNSBPEL,JFFCeGEAHCAFMDCCFGDE..QADAdCDDUBGD.SHDGhAAABACG.ECAA.LBHHhABADGAGAHBE.OFBG.hAAAfGABaADA.......hABA......hAGA...,2,-44,-8,36
DQRBVZYCLNeGSXfgbHdMJKPcEOaUATWFI,FGFCDAFBQFEARFADZEDB.LCHBGBABSAFC.hAAA.gDAHhABAdABFKCEGEAHFOGBE.AGAAIEDEhACABEACVDGFCBCENIAH.fGGBhADAMDDF......hAEA...,1,-13,-30,17
OHbFBRINSEYfCLdUgJKVGTZPeMDaAcQXW,QCGCXDACHFBFFAACBCECRABA..SGADEGGB.fDGFhAAACEBFLDACdFFHhABAgFDDJDCCGBDBhACATGACeFHH.aEEFABGE.OAFA...hAEA......hAFA...,2,-18,1,19
BcIXWYaEVHUPFJgMRSeZNDACOKdbLTfGQ,KDABLCCHGECEBDBF..IADGXAAF.aAHDHCEAUDGChADAFAAG.MAFGeFBBDHEChBCACAGBOEEBdGGE.TADGhAFA...fGGAWBHBECCA..hBAA......hBCA...,1,-19,-23,4
SDBaVcFfQCeNKOIgZRXYJHTdAEMLWUbGP,LECCUCBCGGCBSGFEDAAFBADBaBGC..FCFH..fBBGhAAAQFGACGEGKGABhABAOBFGZACF..XDGEhAEAJFAC..........hAFA......hAGA...,1,-30,-38,8
MSfeAaRYbIgWGFdHBLUEDJPcKXTQCVOZN,aCFCRAAD....bGAGICAH.GGBBHAEGBDCEUGGEEDCBhAAADCIFJEEC.KFCEXAGFhABACHGA..ZCEASCCEhACAADAB.WEEEdGGB.PEAB.hAAA......hACA...,1,-14,-27,13
dUMafROIBgLbDNVQCTZJXKGFWYAcEHSeP,ECFCHDED.eDHDdEBAaHGAOHCE.BBCDLEFGDDBF.QBCAhAAACAGGZFBGKAAD.FAFGAECB.SGEHhABAMDAB.fABFhAEAIGGHNAIE.......hAIA......hBAA...,2,-25,-24,1
YBOMbSPdGRfgVTJUEaQLZFDKACHXeNWcI,CFFCXBDG..eAAF..NBEB.IHEABHGDMHCA.SAAFhACAPHAGGCBGhAAAREFE.VAFFUEAAQGGEhACA.ZDFADDGAAEEHcBCFYHAAhADA.dBBA.fEDAhAEA.,1,-8,-28,20
fPDbWFXCBSRVEYLOTeMgKZGQJIaHcdNAU,UCBCDACBFGHBBCHB.REEG.EDAFLAAD..OFEAeFBGMFIBhACAKFAGQGDEhAAA.aBCDdAFF.AHHHbGBChADACCEBSDFA...YBHHhABA......hADA...,1,-27,-40,13
THFPXNeSWGcZUKDJbYMARBLEgCQVdafIO,RFEEEDABCGAH.dBBE...aFEHOAFE.FCCAXGGA.eAFBhAAASDAEGCGCZBCBhABAKACADCIDJFCF..YAHHhACAAABABHHHQGCC.ICFHhAAA.....hADA...,2,-41,-13,28
RAfXbHZaMQFYgDcCJWGSVLBIPKTOeENdU,XCBCHGFGaDABFAHDDFGB...CCFA.GEAHLFBFBHDCKEFDTADBhAAAOFCD..EAHBUBCBhAAAAHID...fEGBhABAMBGHQGAC.....hACA......hADA...,1,-24,-25,1
KZeSCQdBIHfGENFgDcOXJUVWLRYPMbATa,aFHBKDBDeADC..QCDEBDHBHDFFEGBEFDDBDCBCOFBC.hAAAUAAF.LHBChABARDFFYAHHMDADADBCSEAEhABACGHFdAHE.IAFG.fACHhACA...hADA...,2,-24,-16,8
IMWNTHAQYbSLXaFGcOfedDKgVREPCUZBJ,QCBCSHBGLFDEaAEA.GCBEfHBHdACBDIFEKACAhAAAVBGFREEF..CAHCBFCAhABAIGEDMDIDNAFC.AHGFbBFChACAFAAB...........hAGA......hAHA...,1,-15,-21,6
CSYVKFDZfgaLQeTAEOXdNWBGRbHcJPMUI,EGDDXAADdBFGBGGGREBC.HEDE..PHFAMAACUBBE.CCHD.hAEAVAFA.KDGDDGCFZADFhAAA.aDHDeFAD.ACEH.hAFAOFAB..WHFA.....hACA......hAFA...,2,-26,-23,3
DPIFcMCgBWETVbHfdKOXLeZQSARGNYaUJ,REBHGAFE.aDCDDBFBFEEDMFHD.BDHDEHDE....TBAGhAAAVEEFHCAEKGFBODAHhABALAEEeCHFSAAChADAABEB...NIAF.JHAC.....hAIA......hBBA...,2,-30,-10,20
CBbWGadDPSNUHYVcQZKMefJXLgTIFROAE,CCEABFDGGDEFDBEE...SFAEHAABVFGBZGAC.KFGBMFFBeBBChAAA..XCGDhAAALBADTCEAIDCEhABAFFACAIBAEBGC...aFFHNHAF......hACA......hADA...,1,-17,-22,5
PZeFfMTdNKCUDbRIHAVXWOYEGJBLcSagQ,XFDHOGEAGACGLAAH..SAGAQAEGZFAGfHGFhACAMAAFdHFHCBEBDFGBhADARCEAABBBVCFG.YDBGhAGABDHA...aHACeHAA.FEAE..hABA......hACA...,1,-7,-13,6
aAUgYCEDGQIcbRJFXedHLSKBfZMOWTNVP,UCBCCFDGGDEAQFGC..ICDARFDDFCFBdADHSCHFhAAABBHD.MHACTGBEhAAANIDB.aGABAEBG..gBAAhABADBAC.cEAH...XAGChACA....hADA...,1,-26,-32,6
GEFZNQMaBIXKDRWbSeVdJPYTCUgOcfHLA,FDAFQFDHBHGFKCEADBCH.RDAE...SGCFeDFAdAGAJFFA.hAAA.TBBHCGBG.OEEAhABA..cACAhAAAHAGBLFHBABFD.EECEMDDCIGAAhACA.....hABA...,1,-21,-35,14
OPZDHAIKgRWEUYSBTbQNdaeVLCXfGMcFJ,KHBGRAADUFFFBCDA..QDDCaBBD.LAGFXGFHMCIHhAAAFGDG...OEAGhACADADBAFCC...IHBEhADAgAGG.EDECSADA..hAEAbEFEeFCB...hAAA.CBAEcEAB.,2,-37,-11,26
OEYeACGHZSQbRfdLDIJFgNPXcaUMWVKTB,CBGFHDAHZFDE.SDEGRBCA.dFCHLACCDHCAFFFE...NIEB.PBBGhAAA..aCHDUAFChABAMDEEKGHBBGHA.hACAEAADAIBE.GDBE.......hADA......hAEA...,2,-26,-24,2
JcARLZMWFdEXaOIQfVBPSCNGHbDYUgeTK,RDBGMAGDFFGD.dAEG..EGCDOCBF.QFGFVAFFBHAGSDDGhAAAGAAF.DDHD.hAAAUFBDeFEH.KEADAFFBLBAEhABA..XDGAIAHE.hABAfGEE.hADACCHBNDAE..,2,-27,-13,14
AbCLPFVEcfeWUZJNXBRdOSIQgTYDMHKaG,CAFBFDCD.EEEAeEAC.ZABFJAFCBFBA.dEGHOACC..IBDHhAAATBAF..MEIDhAAAHAGF.aGGEAHGBLEAHhABAVEDF...WDGHNIAF.SGCDhACA.gGDGhAEADBBF..,2,-27,-20,7
MTUYOWJNVDSBfcRgHeQACZbGEaKIPdLXF,ZDBHEGAHKCCCdEFHFAFC..UFEHOBCC..JDFGDIGABHGH.RDAA.hAAAHGDC.eEABCABHGADFhABAaBAGLDDChAAA.MCIH..WFDD.....hABA......hACA...,1,-20,-39,19
BYCSUVMRDbTQINOFZJXgdHAfWGPLEceaK,GAFEEDCD.eFGFKGAGCDAGUAAG.RDCBDDADQABG.OEHBhAAA.ZEEHXFAAhADAHCFEABFC.fEEDhAEA.LHAAaHBE.SBHHhAFA......hAHA...,1,-19,-28,9
UZYKebBcSRLEfPgHJXITFGAdCDNOQMWaV,dFGECAEDDDDHQAAC.MCEEVFFEZDCBKAABBEEC..SCBHhAAALAHBfGADhACAHBGH.IAFChADATGBGADGBOHEC.aEGAYDAFhACA.cEDDEDBB..hADA...,1,-7,-45,38
OIBJTRKYUGDfdWSEPXAegbHcFVCNLMZQa,eGEAHAADVFGDLBEEZBEA.ODBEBHBGRCCEKHAAGEAFDCGH.dGEAEACChAAAAAGG.....cFCEhABANAIA..aADGIFADhACA.........hAAA......hACA...,2,-27,-14,13
SMJaDZXEFbecQLRYfCANHGUKVPOgTIdBW,HEBHUECBKAGFOAFG...IDEGBGHHMFBBDCDCZEFBFBBA.eACFhAAALADB.RDGB.hAAAfHDDADIH.hABANBIG.PCABdBAA.JHCAEHGA.....hACA......hAFA...,1,-8,-34,26
WLSYNdcAGRJMKbXgHUZEIeQVPaTBOfCFD,GGDHMAGDKHAC..bBACHEEC.UBBEIEDEeHDA..QEBChAAAaFBHOCEFCHGADDAHhABASCGE.dEGGhAAAAHDG.JAFC.XDBB.....hACA......hADA...,1,-8,-29,21
AQZFbPIVYfTBaGdRNeHJDEOXCMKgcLWUS,FDAF..bFEEVCDG..TAFCBEGFdBADeABFDHBEOEBE.hAAAMBEBKAHBLFFAhABAUDGFAHDA.ZFAEPHAChAAA.fCCA.aFAC....hABA......hADA...,2,-41,-11,30
GNbCTQEaDJWSLeKRAVcYZgHIOXMfBUPdF,VAADZAADHDCC.OHFAMDEBBFACdAFCGEAA..CGFBTADDhAAAaDGEDFFG...JHACSGDBhAAAKCFH.AFIHgACFhAHAfEHAPDCF...hAIA......hBAA...,2,-34,-16,18
SaKbHLVZTRfEYCDNAFgPGWBIXQMcOeUdJ,FHBGGAFEBEDCQFAC.OADHeGCEUDACSFFGhAAAKBBE.LBBDZBGFTFGHhAAAfEDH.hABACDHFABAFgAEDWHFCXEGAMDDC...hACA......hADA...,2,-36,-4,32
YRAeaTUcdZODNLJPFgVESKBWHCGMIbXfQ,aAADTCGC..dECEZAEBDCFHLAAFFHEG.EFEAKBDFBGHHHAFACEACGCCEhACAMIAG.IHAHhADAXFAB.QEFAhAAAAHGB.cCAE.....hAEA......hAHA...,1,-22,-25,3
PcdMVbDQeWTJLfZSUgXENHYGFaORABKIC,KEGDCFDGdCABMBFH..DEDEeEDB..TAFCJFAFZABG..UGFAhAAAEHGA.HCFCFCGARCAAAAEGBABFhADA...IBDChAHA..........hAIA......hBAA...,1,-37,-42,5
NZYIFHEOUfGScLMJKDaVWQCPbXRdTBeAg,ZAADFHBGHBFDEBEA.OFHFGDCFLCBHMAHFKACGDDFF..VFGHhAAACHEG..XABAhAAAdFAFTGCDAAHG..NBAE..hAEA..IEDE......hABA......hACA...,1,-16,-30,14
fIJTDHCBPOKAaQWUdMSNgZLFeVbYEcGRX,QGBCdGFCMFAD.SAHDZECHLCAGFEDG.eBFB.VAAEhAAAYFFA.GBBChAAAfBHGIADFhABADGHHCEEC.BEGHKAFFAEIDaAEANCAAEHFA....hACA......hAGA...,2,-16,-14,2
GZcFeNHJMUTARbDQdEOXIBVCPLfYSKgWa,DHCEdFHAEAAAOBGHBAGC..CCAH.LEBC.SFEHhAAAKFGDaHFCZDCCFDGEHACGUBCDAFDH.hAAAQFCC.hABAXGFDPFAH.fBGA.WEADhADA.....hACA...,2,-42,-12,30
TOafCEHMBDXLGFIcANdUbYZSKQVWRgPJe,UGBCZAADQCGBRGDE..JCEDeECC.OBEGCAGEHABGDAFELEADhAAAFFGEADDG.dCAF.hAAA..SFFGhABAKHCG...........hADA.gGEDhAEA.aCCGEBFE,1,-27,-34,7
FEQZAeLBDfHbXSURNCgTIMJYdcWaPOKGV,eEGHDGGDHCCC.SCHHNCFE.CEFH.ICGG.MIBChAAAJBAFdFHG.aGCFKCCGFAFBhAAAZDAHAHBH.LACChABABBBB.fECH.XAGA.hABA......hACA...,1,-20,-37,17
FJcCTILHDMAKRVgEOaPbQZedWUfSYNGBX,RBCFVDAGODAD..aFGEQAEA.ZAGDdACAUGFAfBGHhAAA.SGBHhABANDIABBAAFEEGJFDECABB.IHHAhAEADFDD.KGAF.PDFA...hAAA......hADA...,2,-28,-16,12
fGWHFBAEUMXbCReZJDPIQONcVdaSKYgLT,UAEDXFDBRCACZFEFDBGH....QABHODAE..NABD.dBHGhAAAKGFELEHH.hAAATCECfDHEhAGAGFAFFBBGAICE.MFBHCGGC.PBDD.IHCEhAHA.aHFC..hAIA...,1,-10,-34,24
ZYNHJFdADEWVegOPfCcbUMKLGXTRBSaQI,DGHHECFC.eEFDOFFE..CADEUGBHMFADGCCE.RAACaGBCQBEAhAAAZGEA.NFAH.FAEBhAAA.AFEC...gCAFhABA.fHEB.KAHF.hABA......hADA...,2,-33,-21,12
NLFVbRZPcTICaEWdKUDAMfeGHBgSQYOXJ,eCHDGCCFBECESGHHQADGOBHH.JGCALFEHhAAA.FBAHbEFGPHBAhABAIGGGEGGAKFAGAEBCMAABhABAfDDD..YFAFXBBBNBBD.hACAZAFB.CEGD....hADA...,1,3,-22,25
DBeMHWAFKNYbSZTVXdfREaPUgQGIJcCOL,FAFBKHBG.....NIBF.SBDFZDEB.XCFGRCBDEEAHUCGChAAAGGEF.JECACHGALABEhAHADFBDBEAFeABDhAAAMHBE.AAHC....YADC...hAIA......hBAA...,2,-29,-29,0
BPGLJYNFWSKDROCfAHdMZTeIQVaEbcXUg,dHDDMEIBZDFB.eBADVBCB..EAGA..XAFGBDEHGEBChAAAJGEC.FBBEKDGHOEHHhABAAFDGHEAB.QAAFhABAaAFB...cCFB.....hACA......hADA...,2,-21,-18,3
PdRAGfOUSYZXMFcQegKHLCNBTJWIEDbaV,OFEFSGFCZEBDFADDQACD.eDDDKBAECHGGBHBD.TGCChAAAJBFG..EDGBbCFDhABA...aAFEdDAAADCHfEAEhACA..XDDBMFIB.hAEA......hAFA...,2,-44,-14,30
LRUbNCagWDVOeXFZTAYISMHEfKPJQcGdB,SHBGEAABKBFF.QAGEdEFBRCCD.UEFFCGFE..aAHDDACE.hABAeBCCFHAEAECHMGAA.hACAPBABJDABBFHHNIEH.hAAA......gACC.hABAOHDEXCEE.hAFA...,1,-14,-35,21
MaKcYHONbZJFWeQXCGTRVPDSgABEIULfd,EEGDUDACLCBAdGBBKGGC.HEAB.OHEA.ZAAEFAAFeAFGXEEChACACFDCRCFE..DAAEAEHBBDFChADAMFIB..YHAGhAEAJAEC..QGED...hAHA......hAIA...,1,-3,-44,41
FOKHgBSGQdNeLCVWIAYfEXcDaPMTUbJRZ,EHBGXAFBDAFE..MEFFUDDG.READFGGHKCCEBGHB.GBGGhAAAdEHCeBAALEDHCGDH.hAAAIBADAAID..hABAfADBaBEF..TEAC..hACA......hADA...,1,-28,-32,4
KIAVDYSBXEdMbCaNfgLJeFZcOWTHURQGP,DHCEBFEDEDDHMADD..aGFA....gCAFJDAGFCFCZAFAOHFEhAAA.HAFCQABAhAAAKGCBIABBhAEAAEIHSEFEdDFBCGFHfECH.cGABhAFAUGAE.....hABA...,2,-33,-16,17
WFLaJfYRMbQVHeXEZUcgASOBCPNTdGIKD,BDGFCFDG..TEEBIGCAKCEF..DEIFLAAB.aEAFfEADhAAARCCD.QABDhABAVFEDeBHBECGEhADA.ZAFEcGAHAGGDSGADPAFBdACFFHEC.hAEA......hAFA...,1,-14,-25,11
dJMbVNLURSIXGDcTKFEBYaeHCWgAPOZfQ,OFBBQFDHdCCF.JCCCMDFG..VAEELACE.SEFBhAAAGDAGDAAFKHGEBHFAhABAaEHD.eEHH.CAHEAIHEhACAPBAF.fAGH.UFCAhABAXDFA...hAGA...,2,-25,-22,3
AeXNbdgPEWYBaZfOJcRVGLTMFCIDQSUHK,eDACXCBCdEFGECHBBCHD.ZACE..OFACRDEHGGBFMHECCGGE.DECEhAAA.UACEAGAC..NAAC.hABA..PAFC.hACAaFCAfECC......hADA......hAEA...,1,-23,-33,10
YIWDaNSeCOXRAPFUcQdJVBZbKTLHMEgGf,UGBCdGFCBHDHKFGGLADGHBFAMEDG.GAAC..IEDEhAAAaGAC.SCAHhABACAEGXDGDAHEFFCCE..hACA...JCFEbDBD.EGHFfGFGhAEADAFG......hAFA...,2,-38,-15,23
OaDHScFWGKQYCZdAUTIefRBXLMEVNgbJP,UCGCTDACeBBA.REAA.XABALFGHMBIF..EGADgEDEhAAA.bCGDJAEAhAAA.OFFHHFBHcGGGhABA.FAFCKGDH.......hACA.CGEDAHAGfCDHhABABCDA..,2,-25,-7,18
PLaNJBZdgCDWFQKEHRIYVfeScbGXOTAUM,MFFFaDCDBGFAZEGHdFBG..DACHFCEHKDHHRAFF.....VBFBSCAGhAAAGEACOEEHhAAAAFAHLABA..gADChABACCCB.EHGAIHDH..hACAeBBD....hADA...,2,-31,-28,3
cFJOWaLVDfKXGEBZSeAHNbTURMdPgICYQ,HAADTCBCRDCEdGAA....IBECQBFEJEHF.aEGADHDGfFBBhAAAGFAFBGGGhAAAZGFCAHCDNAEF.MADG.CAHB.hACAFABG.OEDC.WHBG....hBAA......hBDA...,1,-6,-28,22
RTYdOgLBNCcUXabMAJeDKEVGQWPHfZSIF,eBFDEGCDGDDGQGAHHFGBZAFHFBACREEFdCDFLHEGCADB.XDCEhAAAMBIDABCAKCAA..hAAAPADHSGFDhABAIEAH.ODHBBFBC.cAGF..hABA......hACA...,1,-10,-12,2
QFeVAGYBfELMPdZIKJXUWNbcHTRgODCSa,GGDHBFDGEBEBLCCAdHEFZCBD.KFBA.JAFAUCGB....NCIGHDFFhAAAREEEDADECHAF..aABAhAEAFAAHABEC...MFIFhABA.....IDDB.XAGBhACAcECA....hBCA...,1,-24,-34,10
aFGRQKSAYcTZHeWEdLIbfOPVJMUXBCDNg,TCBCZDBGeAGD.EADGLDEA.IAFCOFEGJHEA.MCBGhAAAUGFD.BHBBDICAaEGAhABA...GFAFhACAKDADYAAE.cFDG.WAHBhAEAfGGB..hAFA...,2,-28,-25,3
UIeQKgJAWFETBaDVdRPfOZXGHMbSCLNYc,FAFBEFFBBECADCGH.dGCARBCF...OFAHZFDHHCAF.MIAESBCDhAAALAHB..NCHCUAEDhABAIFHHKCEBACAFaFFDhAAA.....fABGGCAA.CEEB.hACAcGEH...hADA...,2,-26,-21,5
aIPbcZKUYVRdSCAWQTLDEFHBfJGOeXMNg,QCGCTEGD.DGDEFBBBHAAFBGCGJHAAeCDG..MBFGaGEG.hAAA..PDAHZBFCKAGEhABAUDCARDACCACBAGIHEHGGOHDEhAEA...........hAAA......hACA...,2,-23,-19,4
GJLOSeXCADRTKNbWMUYgBPHIZcEVQdafF,DEFAKDAF.....bBDCMDGH.UGCEBHACHCCGZFFEEFBBdAAAaGABhACAFEBALAEA.hADAOBAHeBDEXFGDhAEACBBDAAAE..NIEB.WBHF.....hACA......hADA...,2,-31,-23,8
QWPCgKVYAZRdJUOGBNLTIaScDMFXeHbfE,RDDFdGDDOBAAGDCBBAEDLBAB.aBHFDIBG.FDGAeFBDHCADECCAhAAAQGGE.hABACGCA.KGGEAGFH.ZCGHUAFAhAAAIADCMFFE.fAFF...hABA......hACA...,2,-24,-9,15
VgYUfcTEFRDAXNPOSGbWQHIJLCdaMKZBe,XCBCOGEAGACG.QFBDJFCGLFBFCAGD.MEEGBCAChAAAeADCVCECUFGH.hABA..fAGHhAAAcEABEHEEFCEAAICANEIASACF.WHDGhABAIAEAKCHH...hBAA...,2,-20,-8,12
JVXWTdCgSGfEDLcOFPZYKaQIAReUHbNBM,eBDGHEFHBBABMABE.JDDD..XDCBdACFCGAC.SFGBhAAAGAEEDIEELHBA.hAAAOBGDFHBG.YFBAhAFAaEHFADBA.bEEB.WBBD.....hABA......hAGA...,1,-4,-36,32
geSODHRKIUZGXNFEJLTPVbMWYafAdQCcB,dFFBCHHGBGFDSAEFHDAFRBCD.UCFAGAEG.FDHFLCAB.hAAAVFBEMDGD.aAGCAFID.hAAA...QABEhABAcBAB..OHAEKDDCIHAGNEEE.hABAEAGA.PHDC.hACA...,1,-10,-20,10
LPHfBUeAdaFKXIgDJVYMTWNGQbcCZSORE,FDABXGBCDFGB...JHFAVFCE..MCFE..TBBDhAAAGEEBQGAChABACDEDOCBFEAAFLFHD.hAAAPCEEfAFD.eADHaDDCKAHH.hACA......hADA...,1,-17,-27,10
DcSCWVfaUZdHORgGNbTYQLMAXePIJBEFK,XDACeGEA..IAHFEABG.DDEA...CCHD.fHDBhAAAZEACdGAFHBAERDFFNCCDTFBHhADALADEAFEFBAHDhAEAFEGCSEEBaHGA.......hAFA......hAGA...,2,-24,-19,5
LHXJcSfZaNMIOKgdDeUBRVWYFbPQGAETC,EFFBCFEELEBFHGAEJDGF..SCGFZBAGMIDA.KBDG..dECADDIHhAAABBFGRABF..VGFEhABAFDADbAGB....hAAA............hABA......hACA...,1,-22,-41,19
bFDaBZLeJEINfGTUVdQHYgORcPSWXKACM,CBFDMHFGDAIH.ZDFHLBBC..JFAGEHBG..ICAFGDEDUFFBhAAAQABAHCCAODAFhABARAFC.SGADhACAKDBAAIEGFCHH.BHDEfEEE..hAAA......hABA...,1,-13,-33,20
MgEFSTPGLbaKQDVXANJeIWCRZdfBUYOcH,JEEGeGEA.CDDG.RACGZBAHdFCFBAAE..UAGBOCHF..MDEGhAAAFHAC...SFHBhABATACCLAFEhACAKDDDDIEGAHHFICED.fDGE.hACA.YHCEgEAFhAEAEFAG..,2,-41,-24,17
cYTVSLXMIPFeGAWJKUbfNQCdDgBERHOaZ,KDCDUCBC....fHGFCGHEDEFABFFGEDHBHFCF.ZFABTABGhAAALADE..XFDGhABAMBAH.FBEEACGA.hAAAWHBA..bDDBdGABOHFEcEFH.SDAHhADAIAHH..hAEA...,2,-31,-26,5
JKZTHEBLMGSURFXcfYdQINAVOWbgeaPDC,VFDFOGEA.....bFADaHAC.DBEFKACCZDFGHAGFBCBHLDCAhAAA..SCAFhAAAFFCGfBADhABAdFBEIAFDAHEBgAEFCABCEHGA.MFFC..hAIA......hBCA...,2,-34,-14,20
VGQCRJHYEaSAMFfUPDKdOZIegLBbWXTcN,MHFGUGBCDGHFKCGCZDDG..eBAABCAC..XGEE..hAAAcGBFGEDFCFFFHAEAhAAAEAFEABEGFCDG.dDAAIABChADA..bCFANDBB......hABA......hACA...,2,-34,-22,12
EgPMOVNRXFBJSacfdCbZeAUGHLIDTQKYW,GACFHFDFLACGDFABKDEH.EAHF.MDAGOGEARDEEBEAG.SHAGhAAAaDAEdAAEZCCFAHHA.UCGFhACAIBAC..hABA.YECDPHCE.NCCF......hADA......hAFA...,2,-28,-3,25
eBGOSafPKRHWXbYcADCLVgUMTQNdEZJFI,LFEDUFDHMIFCQDBC.EHGEJDAEFHBABHCD.SDEAhAAAPBEB.KEHDRAAEXCGEhAAA..hACAcAFECFHEgAGHdBABZFAB.IAFHhADAeADAaGGC.....hAEA...,1,-13,-24,11
RCTcdNGSEHIDMYVBJZXgObKFQPaUfLWeA,CADCdGFCGBGEHBCAMCBFBGHDZEEB..XEBDOEDH.FHAGQBAChAAA.aGBDUAGFhAAA.WFEFRAEF.NBAC.hABAECDDDDHH..........hACA......hADA...,1,-23,-25,2
OQZIWYdGCXJcMeDEBgafKHLUSFPRVbANT,TDACQAEG.ZFFF..ICGCdFHEGCAGCAAC.JDFGMIEGhACAEABDBAHFaFDGHGBELEDHhAAASAGE.hACARACEADEAWHCAXEGCDDCEKADD.....hAEA......hAFA...,2,-19,-8,11
LFJDRfTXENdUVaAecOIQGMYKZWbSHPBCg,eEEGOGEAGAGEKGBHZADASCDF.HADCBECHCGDGFEACDFIHTBAFhAAAEGEE.dHDFaABDhAAAACDG....IEAGhABAMIFA...bAGB...LEEEhACAfGAA.NDIE..hAEA...,1,-6,-32,26
DgMVTQJOeHfGYLRICKXdWUABacENPSZFb,aEGDEHBG....SFFDFGDEDCGA.VDGFJACGHBEB.GBAChAAALCDFRDCF.CABBXDAEhAAAdGAH.AIHABFAHhADANIBB...........hABA......hACA...,1,-25,-32,7
KSYEQOURIWFNXDBLCaGfgbMcJZTHAdeVP,dDBDeFBBKGDCEGGBUACGRAAB..FAFDDGCD..CHEBGDDF..fAGGhAAAMFABZACF.AFEE.hABASFGE.hAFA.OFHDIBHHWDFABDHB.aGDH.hAHA......hAIA...,2,-55,-9,46
YRLFGEHfBPQUCIXageSJVdWDbOTAcMZKN,MECGZDAGKBCARFAA.LFDBFACD.GAGEEBFCBGEBUGAF..XGGEhAAAeFHD..JAAEdBEGhABADFGFOCABAIGA.NCHG.hACA....fCFG.CFBC.aHAChAEA......hAFA...,2,-26,-24,2
AROKDaTcZfMFgQEPIGYCVNLHWeBdJUbXS,RDEDDFDC..aCADZADCFHCEEHAC.GCDB..CABELCHFeEGBBAABhACAdADFJFACUDCE.SGGHhAAAAIDG.KAGGhAGAcCBB.MCIH......hAEA......hAFA...,1,-31,-33,2
PfaTNbVQRMgEBOWZIKGSACUcJXLYeDdFH,UGGGJDACLGDGeBHFdGDDHECC..aAGGTAFH..VDCGhAAAQAAFRABC.MICGhABAEBFBBEAF..hABAZFGBIHBEKCHHACCGCFAF.......hADA......hAEA...,2,-23,-15,8
dZbaPUFVYSOQHKGCANeEMcJRBIXLDTfWg,EDCDJCHDBGFCLEEG.DDAB..TDBF..fACGhAAAdHGBaBFD.PBFDFBDCSBAGhAAAHGAACGHAAHGD.eFBBhABAMCIBREDA.IBAA.WAGB..hABA......hADA...,1,-23,-28,5
GWdeBKFfYEPQgcOLXJbUDZVHNATaCMRSI,TGAFMAEERDGH..GCCBeDFEFDAF.EFEAQGBA.OBFChAAALDCBJBAHDFFHhABAZACAHGECAIHE.SCEDhAAA.........hACA......hADA...,1,-13,-30,17
HCZRMGSKTIgeVXPQWFaBOdUDfJNAYLbcE,LGEAEHBGZBBBGCFESAAFKBDH...IBHHeAHBPFBEhAAAQEFB.aADChACAOFFHDCDD.NEIAAABCYHAChAEA.HCECCEAGMADE....hAIA......hBAA...,1,-15,-17,2
KMLRgOYPFaIVZGQbUcSTAHNfXDdJWBeCE,HAADXCBCDHBAJCEBBCHD...EAEBKADDMFAHLFFH.OEHFhAAAFGDEaDGHZAFFQGBEhAAA..cEAGhACAAFECdABDCHHG.........hAEA......hAHA...,2,-34,-25,9
OMcYGfaZANbKBURILeSQgJVPEdWXFCTDH,KHBGBFFCUCGHRCDCLAEA..SCBFJCAG.EGFFdGAEFFDGhAAACHHDHECB.MAAAhAFAGACD.aCDHNCIA.eEHBhABA.QFAF..PHDEhAGA......hAIA...,1,-16,-29,13
KDVXZeQCFSGgTRMLHfUaYAPBIObcJENWd,BFDGOGEAJCBC..EGBHdBGEKBGE..DFECZACD.eAAHCBFG.SDHDhAAAGEAC.RECCMIDEhACALAAD.HGEChACAaEBBAIHG...bAEDNEEF......WAHBhADA.....hAGA...,2,-36,-18,18
XAIDfeGFWQSEONBaCJgTPcUVZRbMLdYKH,DACBGECFFCEE.QBGF.OBBAaEBGCHHF.JHAG..TEFHhAAAUCACRGEA.MAFFdHDBKGAEhABAAADC...IAFBhADAfDGE.SGACEAHBBBDG..hAAA......hABA...,2,-42,-17,25
DdEBZUabceRSJIQKCXYFVWgNOMHfPLAGT,DDGBdEHAZCDFUBDH..aHCEeCHF..JAHFKDAD..CAFE.FGAB..hAAA.VEDD..gAAGhABAMACH.HDAAhACAfEBFAHFBECFHBGFB.RFBE.SGHHhABAIADF.YHCAhADA..,2,-29,-29,0
KNGIPLJegYDfBCMaRWSXEdUHTAFZVOcQb,ZBCFVFDFOBGH..QFADKBAGGGABLAAFeHFEDAFCCEBBMBHHhACARDAF..SFDEhAAAdGGGUAECAFIHFEGEbDDChADA.....IBCG...hABA......hACA...,2,-25,-10,15
IVWQGbFcDMZUCKTXgaYBPLSOeNdERHfAJ,JFBBVAADGADA..FHDADHGCZDBB.KBFC..XCAB.hAAAaDFABFFB.SBEDhACA.NAIA.dGEGhAAARFGF.HEFE.AAHGIABH.WFAFhADA......hAFA...,1,-35,-39,4
aVcHBbLYXfDgZTIRMQSGECOFWNKPdeJUA,aCFCVGFGHEAG.BAAFLHBA.XCFAgEGE.TGGGhACAIBDF.RFBCSAFFhAAACCCBFDAGKFEF.hADAdCAHeHCGJEAEAFFAcGAHfABADBCGMAIFhAEAQAGD.ODHDhABA.,1,-3,-15,12
QMaAWCYJBGDEReVPKHNIOdfTFcSZbgXLU,CFDGJAFBDAFG..RBBG...eDEDKHAEHFFF.OEEGdHFFTCBHhAAAFGDG.SHCAhABAZAGB.XCGHUEADaADGhAAAABGGBADE.EACBNCIE.IFBE..hAIA......hBAA...,2,-36,-21,15
QGMWDbeOdYBfCKPVEgAUFHXSNIZcaRJTL,HBCFSGFCZEFHaFAHRCAGLEEEGBEHDABCOHACBFDD..CHEG.KCFGhAAA.EAEBAFHAFAAH..hAEAIAGA..hABAJEBFMFAE..eEEBdACE.....hAFA......hAIA...,1,-21,-23,2
YdaNefHCDUbFEXPGWTIZQARSBMcOgJLKV,BCAHOCHDJDDGKEAA..dFGCeGCAHAFEUACEFDHF...ECEHGEAEhAAA..IGGDhAAAAIHEMACHLHCAhABAaBADCDGCDIBA...PFCATAGG.....hADA......hAEA...,1,-22,-27,5
fXOIZNJQcWVEFdePRbKUHLGAgBMaTSCYD,BBFDaAGD.CBBC.DCIB..OFEEZEBHQACG..VEAAhAAAdFGERCDCKDEHLAABhAEAAHHE..MDIDYFEDhAFAICCF.JHAA...EDGBFGAFeHDEhABA.....bADBhACA...,2,-38,-13,25
cDOSfFJZWeRXIKAgadHENVYUPMTLCBbQG,aAFBdEHAEGAB..VDCFUAAC...TAEFCHHEBBAG.GBGGhAAADGEGOCFDSGBHhABAFEAAZDCBeBBE.IGFGhACAACHH...NEAE.MHFA....hADA......hAEA...,1,-21,-31,10
DXOaBYJLNZVKPSdUfQATMeRgbICFWcGEH,MAEHeFBBRCCG....IDGDCFFFFGDDGACHDEIF..aBBFBAAFhACALFBGZAGBKDAAdGFFUGGFhADAAAHCTAFF..hAAA...WCAF.EDCHOEFANIBB..hAFA......hAGA...,1,-20,-23,3
MTfDUAVSWYZGQPaOgLFIBCXKJHNRedbcE,VDAGSHBG.ZACBQADB.aAABOFBGLEEChACAFEGBCGHFKBGCJAFHRFCD.dEEAEGAHhAEAMBADDIGEAGFD...hAAA...WHCE...PAHFBGGH.hAGA......hAHA...,1,-19,-27,8
LQgSfURZCNBFAcJeDGbXEVHIYKWOdPMaT,JEEGeDCHGDAAEABEHBCC.KHACOAHF.MAGHLEEE.hAAAQBGBSCAEhABAfDAAUADFCHFFBHCBhACAFFFBDIGEXECB...IHHHhAEAdGDEaAAH.....hADA...,2,-18,-9,9
WHNfTGMgaFUOdDPKQSYIXbJEecCBZVLAR,RGFGHAAD.TAEEMEBHaDDAODCC.dCGGKCADQGGH.hAAASHDAYBBAICHGhABAJGAEeEAGBFGFhAAALHAGACIDfCDBFFCCDEHDPAFG.hACAEEFFCAGB.....hADA...,2,-14,-1,13
ZQUbJIPFOeXcLRYKTgBNMEDAVWSdaHfGC,VDAGSAFB.HFEFCAFEZAACUACD.JDFGFFEE.OFHH.hAAA.XFBARFCBKCHBBAHAhABAMBBH.AAHGdGGE.hACAaDEBfADB......hAHA......hCAA...,2,-36,-21,15
IKFZdRDScQgWOGTVCBAMEaPJYbfXLNUHe,aHBGJGEA.......bDAAXDEALAAFUAEDHFGFKHAEdAGEhACADDHDSEGEhADA..QDAAhAAAWBBATEEHBBBEAAFFEHDAfHCF.NEIA.hABA......hACA...,1,0,-47,47
HdeRNKCafZbIQMcDGTBgJXLVYEFUWPOAS,SEHBHDEDRAFGCBACZCBHQAFE.DCAHTGCABCCDXEDDhAAALEAHEHGA.FBDBhAAAPDFFADAE.NEBAKBCEhABA.....aHDAfEGAMFCB.hACA......hADA...,2,-26,-17,9
NeTVRYAIMQKfHCgcBZEJLUSaGbFdXDOPW,QFDBKCFCCFGC.BGBFEGHDLGAEUDEHGABAFABD.DAAHOEEDhAAA..NIDB...hABA......hADA.eAGDTADCYCHBIHBFMAFF.hABAfGHGgDADhADA.cDCF.,1,-21,-36,15
UBgXYKTAROVDaQHLdcJbSPIFZfCGNMEWe,RDBGVAADQGDA.dAEHJEEB..SCGCFBEDCFAF.MDIHhAAAEBGA.UFAABHAAXABChACAKADE..AGHFDIGEhAAA.HDBDcEFA.PCCAIDGC.hADA......hAFA...,1,-18,-37,19
LKaBNYObTRDeCVJMGIcEAUSZFQfgdXWHP,ZBCFQGBCdGHGHFAHLBEFKGEGBFDDOFFEREFC.DHEGeABDCFDE.hAAAMAHHGBAA.ICFHhABAAACESCFHhAAAfACEXAEFPAFANICF.....hAIA......hBAA...,2,-16,-15,1
gDBbRZFGaYQJUcXPONLfIAdTKMVEHWSCe,TFCEMFCFHBAE.CGHC.eDAHBBFHRABAFGFDGEEE..QCEEhAAAJADE.XBGDhABANAHA.LEHBhACAIDDGAFGGKDCFEGDBSDFBDGBH...hAEA......hAFA...,1,-9,-24,15
HUZMfTFPBDNROLGgCaIKSQcYEVWJbeAdX,HBCFUFCAMEGHTFEBBBGFDIFA..RCGHGAEGCBAA.KBACSDCGhAAAQEAHEFAE.JFHBhABAAHGEdHAB..fBDChACANEIE.LAEBaGDH.IDAFhADA.....hAAA...,1,-9,-26,17
SZQdJAYaLXTMDGVcCfbIKHeFNEUWPBORg,LCCHTGFB.MIAGGCAF.CHAF.fHEFKFEFFEAD.UBFDhAAABCFFOFEARDFCZABC.dDAGhABAABIB.aGBEDFIB..cACAhAEAbFBD...IHHHeAEE...hAAA......hACA...,1,-14,-17,3
feWIRdXPTKVaSLUMOGYFgcZHbDCEANBQJ,QGGGJEEG.eFABICDARECH.dFACXCFG.KAEChAAAaDHDLACHMHCCOADEhAAAFEGCZBAFDIBACAHCADIHBCGHhABA...fCAD.WFCGhACA......hADA...,1,-11,-48,37
TZFdXLcgePbMQIHJUCVOEDNYAKfWGRSBa,KHBGGAFERFCEBGACZDAEdAAA.LEEBeBEH.MHACHABG.JBHDCHGE.hACA..EHGADFIBAFHA.SFBAhADAFCAD..hAEAgEFD...PCCBQBDAhAFA....hAHA...,1,-21,-24,3
XbUPDdSAONIKWFHTCaQMBEgLGcZeYJRVf,OGEAKHBGHFEA.CEBH.QEBGBAACLBGDZAFAJBACRBCB...VCDFhAAAXADB..hACA...PHFChAGASHDGAAHE.WFHBaFDBMBBBEDGG..cGAHhABA....hACA...,2,-34,-17,17
VFQOMZCRcdaDNAGeUHbIWELJBTPfYKgXS,GDDCUAEGHEDE..ICHAEABCBGBFTGFH..YEHFhAAAKCBCSEBHhAAA......hABA.FDGHMIBECADAcGBEdGDDDCCBAAIFeBEAWCFAPBABhABA.fAHAhAHA,2,-34,-22,12
XHcFIETSBAYDUdQaMKbRfOWNCLgZGVPJe,DAFBUFCAdGHCMAEGKFEH...RBCG.OAAC..CCAALCGDhAAAZEBHGBGAJFHBHCCA..hAAA.ICADEFFBBHEHhABAAGBHaAGAfABF..NICF....hAIA......hBAA...,1,-20,-36,16
DfLcOZJgVPGXaNbYARTFCdMeSBHKUEWQI,FDAFMAEEeBCBBCEAKCHDUGEG..QFFDDCDFLABHZFDBJECHhAAA..VDFG.GEBEhAAANAGEABBH..CBHEdHAFhABAEBFE..IGHFOHFC......hADA......hAIA...,1,-18,-29,11
TWKebHQMGRFLPCaSBJgAZUfXYEdDOcINV,UFDHXCBCEDEE.DCCE..OAAF..IHFHTADGeAFEhAAAHDFAQFCBhAAAGDADFEHDCBFHBGGEAHHB.fAGEhABAdHCD.NBBHWCADKCGG...MAIFhACA.....hACA...,1,-14,-16,2
HQgOWceUIdbBNaTZfAPDVKJGELCSMXYFR,VFDGKHAEEBAA..CAFE.MBFE..FCGGQGDAOECB.eCCHhAAAdHGFBAAF.aEEAfBDBhABA.DEFAhACAJCCCSEABXDAB.RFFF.....hADA......hAEA...,2,-39,-24,15
WJSDEHbfLNCceXFdAZBIQPTMUaVYGRgOK,BFDDQCBCMDBBUFGFaACE..GFCBRCFG.ODFEJHAE.DBGEhAAAEADAHAEB.LHFAhABACDCE..XAGAhAAAAGHEPHAE....YBBA.hACAKEEESDADhADA..NCAC,2,-42,-10,32
NUSZKCbQGRMOIDeBHXAVLdgaTWYPEFfJc,VDEDdDCDaAAD....TAFA..WFDEEHEEFCCC.JECFUBFDhAAA.KGDCCBHAQAAFhABAMIDCDADC.HEGBhADAAHHB...LFAH.....hACA......hAGA.YDHBfBDB,1,-4,-44,40
CLTEOQXSVPMFKWfHdceaBYRJZNDGUgAbI,CFDGTAAD..OEHFSAEHMEBFFAEHKGDHHDAG.eDGFhAAABAGCRFGFZAFBDFEEUAAHhABAACHE.LHEEEEDHXACBhAIAVCFE...fHBDaDAG..hBEA......hBHA...,2,-32,-6,26
IYPdBgHbOMEGDRKQVXcTZFUSWeACNafJL,aEGDJEEGLAFA..IBDEdHAFHCBCMCAFEEBH.DBCHKGHFQDDEhAAA.XAGFhABATFCEUAAAhADASFCBAHFDCBED.NIEDfFBGBEHA..hACA......hADA...,2,-36,-19,17
VLWGQbDRfHJXPZYNAFBaMSgETdUOICKec,FEHBMAEEEHBAdAAC.UGCACDEC..KGFD..eBBGLCBFGDAEDEADhAAARDFAHFGB.JCEEXACAhABA.PAHFhACA...NBGC..ADCH.BDDG.SADGhACA...hADA...,2,-40,-13,27
SEYOLXAVWCcBbFPDKJaZUeTGMdRIHNgQf,CFDDBFDGFCAB.DICG.KAADZCEE.UAGFGAGE.dAEERABAHFAD..hAAAQFFFSGHFhABAEEBHLFFFAEEE.hABA...WDDC.....cCABhACA.....hACA...,1,-31,-37,6
XKTdgeOCbJPQfNWRBAZULMDFHaVGEScYI,UBDGDACGHFFDGEGAEHAC...SAGE..cCFFhAAAIBABTDBEdHCDeFCChAAAbFDB.QEAGhABA.fGFGWBAEAIHALGAEFBHHaDEE.hACAYAEG..hABA...,1,-1,-24,23
GaCFfLSKbceVOQERgDdPZYXBHTJNAMIUW,UFDBaGAH.CHAH.FGFELACGKAAD..eCFHQGGERECD.dCHAhAAAZADEBEDEHCACJCCGMIDGhABA..GBFEhABAfEHGSDAHcFAA...EBHB.hADA......hAEA...,2,-26,-12,14
YJTdXNKFDGILaZPCEQBVgeMOAfcSRbUHW,SHBGUFDHHAEFJBCDdBAFKAHH..DGAFGEDDLCHFZAFFCFBHEGGChAAABBEE..eBAHhABAAHABRCAB....bGEEWHBAhACA...XDEAIDDA..PEBHhADA....hAEA...,2,-24,-22,2
XASOgQfNCKVYIJGeEHbdLaTDBcFUWPMRZ,OCCHQCBC.CFGC.VACG..JBFCEEHDdHDHLFAGDHGGFFCC.hAAAUFED.MAHBZBDHSFAHhABA.hAAA.NIEHIBAG.eDDEaDABBACChAEA......hAFA...,1,-15,-34,19
ZQWENVDSOBXYFGHRIKTcdgJLaeMAPCbUf,CFDGUCBCZAFA.EFDCDFGBBHAH..FAABGACDHBCA.RBGD.KDEBdHGHLDAFhACAMICE..AGFA..hADA....fDFEhAAANIEF.........hAEA......hAGA.SEBC.,2,-36,-30,6
VSYfOQPRNKAbcZMdHaTgUDLFIEJXCeGWB,ZAADdFEFaEBAUGAC.LFDEFAHB..JCBACEHFGGDBBHEF...hAAASBEFOADGQCFGhABARBFGKEAC.AHGDMCAFhACA...HFBF.DBBE...hAAA......hADA.EDCE.,2,-29,-23,6
JgKCHZQcBGXNWbVfYFMPdDEOSTaAIReLU,RFDFeFCAUAADKBFHZDAFBHEF.GBBG..XAGG..hABAWFBDVDEG.FGGGPADGhAAADIFE..SHAGhADAABACLDHHCAEB.QGFC.cDFChABANCDE.fAHEhACA.,1,-25,-34,9
OeGUFZHRTgKWNcBEJaQPADISMXdVbfYCL,DGHHSGFHdBHG..VDEC..YGAGCECD..LAAFhACAOABDeBGHFHAERBBA.hADAKADA.NIAF.EAFCaDED.hAEAAAFCMAAFXFCA.......hABA......hADA.fFHA.,2,-28,-21,7
SJbECacQZeIOAPTWDgVNKBfXUMHdGRFLY,TCBCDACB..VECFBDFF.UGEHMABDHFAEdBEFGCDDLABEhAAA.SAFHhAFAEHEEaHAGZFGFIHCE.hAAA.AAFEgDAAfEFF.....hAHA......hAIA...,2,-25,-15,10
dOPbeZCETWFDRAYgJQBUNKHaGIMcSXVfL,JGEAUABHHCAFGGEF.MFAFXGAE.LBGDdAEDODFChAAAeABAEFCB..FDDCDBHFhACAAAGE.QDDAhAFANDIC..IHDE......hAAA.SCCChABA...,2,-26,-20,6
CQHZaIRdbPETgVYJcfUeMXFSBKLWAGNDO,GDCCDEFHOABHCAFEZABB..RAEF.dHEB.EFFEVEBB...JHFAfAAEhABA.MAEDhAHAXGDHBBGAKEGChAIALAGHAIHA.NCIEaCDH.....IACFhAAA...hBDA...,2,-30,-27,3
YTDQcbZJAEMHWXfVFGLCUdKgPBNeSOIaR,MFCFXFDHFDDHLFFAUBDH..dFFDKAACBEAE.eAGFICBChADAaBBF..REBFDDIHhAAAbAGH.ADAG.HADD.fHFBhAFACBHA..NACDSGHHhABA......hAIA...,1,-22,-27,5
eBTEbcQMYfaSPgCDJGRXdAUVWZKONILHF,VEFHZDAGOABH.LBFGFAHHeAABEGBGQDBE.MAGDhABAaHEE...SAEDhACACEFCJEHBRFDEAADCKGADIHHAhADABCDB...bEDH...YFAHhAFA.....hAAA...,1,-7,-30,23
GZRDJbAScEeCaMNWdPVUYXKTFIHQfBLgO,SAFBeCCHMCHBdGFFUDDG..KABAFBAAQAECBDABLDGHhAAA..ODAFhAAARGEEDDIHAIBECHBGaEDE.NAIE.PEBDhABA..........hACA......hADA...,2,-35,-25,10
NPJcYWBSgdCMUAfZRVQHDOGaeELTKIbFX,ZGFGVBCDHBDD.DDAGOHFEeFEALFBB.KBBCFFBB.XAAGhABA.PCHDhACAYAFCBEEESDFGhAAACHCGADGD.fGDEGAEBaGGG.EDAGhADA.TFDFNEAA..hAEA...,1,-16,-19,3
KMPBOXRYATIfDgGLEHNeVWdSaJcZCUQbF,TCBCDACBGBDG.LGEEEGBBHFFBeAGFdCGGSAABhACA.aEDCcGAFCBEBQEADhADAFDAHKDHFMDCBhAAABHDB............hABA......hADA...,1,-9,-30,21
QXUHOgIdADTMGaSbBfcVNRLZJYEKeCPWF,MIAGSDAFBEHF...VCFHLCCCZEBB.JFEFKABF.CFHGFBGAhAAAXEBC.UGGHhAAAOEEBdDEDABHHDBEBaBAH.hACA.fFAA.NIAF.EAFC.WEADhABA......hACA...,2,-32,-25,7
ZJAGQYKgHEFaPVWXOMBeLIfNdcbTUSCRD,QAGHKHBGEFGD.aEFD..VDAG..XBBCMAACBHEAhAEAIFDAdAGH.TCDChAAASCGDDFBHAIFE.GFBHhAFAHDBDFFHHOCBAfADBNBBF..hABA......hACA...,2,-21,-17,4
WBXUbeQKHVJGNfFCMSYAIaDPZEgdLRTOc,aHFGZFDGEDFFLCHB.REAF.TBBB.OEBGBCBCXABAhAAA.UGCCQADFhAAAVDEGGAEFFAHBCFHHSGAAhABAAEDBDBAF.PHFE...hABA......hACA...,1,-15,-16,1
cOfPGCgKXTVIaYHWSFUQeELBJdZbDAMRN,MECGRAADOAEGGBAG.CGFG.KECC..XDGCTDGA...aFCHhAAAHGFAFAEC.eHBEBGAFhABAdCDBDIBEACGH..fACBhAAAgGGB.IFDHSAHHEACB.hADA......hAGA...,2,-27,-17,10
YfePJWBIAMUDSNLcREOKbXdHFQVGaCZTg,DIBGLCCHEDHB.KDHDdBCEFAGHGAAE.CCEH.ZCEF.TCAA.hAAA.fECGhACA.JFFCBGGFAFBFUAGDhADANBBHRFAE...OFEB......hAEA......hAFA...,1,-25,-38,13
HPJOdLQDWVXIAaUCZBMfYbcgFSKTeNREG,aFFBUGDCBGBCMBEA......bCCBgGGB.SDBAhAAAKDHBeCFCNADFEDFDhABAGBAEHBBEOHAAhACAdGHCDAAA...WFAC.XCGAAHDFCAHA.hBAA......hBCA...,2,-29,-11,18
aKNIETdUFMYcAGSDHWCQRZPXgVfOJebBL,SACAHFDGCBGAZGAA...XBFHVCDE.JAHHBAFC.KACAEDAAhAAAdABGFHFA..MDCDhAAAAHEFDGFG.QGAChABA.PEFC.OFBGLEHFIDDEhACA....hADA...,1,-24,-28,4
RFDfQcIMHEBSVKJaOZdUTNbWePgLXCYGA,FGGEDAFBQGDDMCIBHAFEBABDKBAC..aCGGODFB.dFCDUACGhAAA..TDCEhAAAbDGHeDDGLFAB.hABACBCHABEFfAGBEHCCSDACVEBF...hAIA......hBEA...,1,-11,-21,10
DLcJSCZNGWefAXgdYRQOPKbEFIaTMVUHB,dGFCQFDHKDDCFDBF.aFBB..MCGFHCEBBAHDDBCELAAFhACA.JCHDCABEZFBC..hAAANAEF.eBCAXGFDhADA.RCCF.ODHH.......hBBA......hBFA...,2,-45,-10,35
LERDBTaXcYNQPefOZFdVHIWGJbgAKMUCS,MAEDUGAFCHDFLDAC.DFCGTDAD..aBGD..XEDGhAAANDIE.QAFAhABAfHAFFABDdEGEIHGEhADAJAAEAGCAKAFDSEGDRFED.cCDHhAEA.....hAAA...,2,-28,-24,4
WMCELQOeZafbPAGUgFNIcSTYJVHXDdKBR,UAGHFHBG....IEAESECA.TGGCVFEHDIGEBHDAhAAARBAE.MBCELADEhAAAQCABeAHFaFCG.hABA....fDDHAEGCNDDDJFEEXFAGhACAKDGD.CHCC....hABA...,1,-17,-29,12
VFYNUEAdDIZBGQSLbfPOHJCaKTeMRXWgc,dHFHZFDGQBCALFFC....fBEFPFABHDEACDGEKDBAhAAAMCEA.RBABXFBBhAAAgGCEFGHDNCAG.AAECDCIBhABABGGC...SBBFJHDE..hABA.aGAD.WDDB.hACA...,2,-26,-4,22
RHCBKMfJPbUcaOdNeWSVTXYZEGQALIFgD,FDCDRFDGCEHH.KFEC..MAAC..JBGBUCFD..aFHDOEAC.hAAAdBBHeBBF.SAEFhABAXGBGEHGEAHGDLGAEhACADAGF.fAFF...hAEA......hAFA...,1,-39,-40,1
MSAHKFYWOdgcfeVNEJaCUGDPLIQXZRTbB,HFEEKAFBFABDODBD.dEEF..fEBDVADE.EADBCABGDGDHhAAALEFDQAGChACAZCGD......hADA............hAIA......hBAA...,1,-29,-44,15
bBAfCgUYVOHEFIXdReNKcTLZPSJDMGQaW,CFDGUCBC.ODGDHACGFEEE.dCCAeFEDKCAGLAGBZBFE..hAAAJADEDEHFQGGFhAAA.aGBFBGHHAABC.hADAgGBDEDDE.......hAHA......hAIA...,2,-38,-24,14
RCZKaFIBfMDJSPgLUYHNWVEAXbcOGeQTd,XCBCOGEAGACG.eFCHdGAGCGHHZBABKAAAFBFCBFFD.DAEESAAChAEALCEEHDFEhAAANDIG.EFBGAAFE...hAHAbADC...........hAIA......hBEA...,1,-22,-27,5
ZEWLNadSUcBeCOGIPVHTMRgDJAbXfFYQK,XCBCFHBGQCCEZAFDLEFCdCGE.UGGGBGGB.CEBHOABEhAAAGABDVECFHBEBMFFFhABADGFFAAID...fAGDhACAKEADEHBEaCEB........hAAA......hABA...,1,-9,-22,13
IVKCGZHNAeEJLgDXFSOfbTUBMPdaRWcYQ,EGDBJEEGLAFADGBF..FAAFOHFE..fCEChACAUGAEMEAAdFGD.aADDRGDC..hADA....WABDhAAAYAFH.IAHEKADFCCHE.HCBBAGGA.hACA......hAEA...,1,-25,-34,9
BFLDaPENceZWQOGJTdRgCMbYIVUHKAfXS,SGFCLCAFDDEAEHFAeHFE.ZECHQAFBGAAF.TGABhAAAdEEBCGAB.MDFA.ICBBhABA.VEBGhACAKBEGACIHfADA.BDDEaGGANAHEWEHBhADA......hAGA...,1,-17,-26,9
KFeWJDcQVbSdPUNaYgGEXTRAZCfOIMBLH,CFDDOGEABEFEHBECKDCG.FDBDeBHH.DGCBQGGH.SBBFhAAAdBEHNBBG.aADBhABA.GGAFEDFHXACBhAAAAFAH..fEEEMFIB...hABA......hAFA.WFDD.,1,-19,-32,13
GdPEMFZRDAWYXBgOTJCVUSKINfabHQcLe,XCBCBAFBOEAC..CEHAUGEGSEDBKGDD...ICBFhAAAaGAFHCFCLABEhAHAdACGEADAFEDADCGFAICG.gFFAhAIATAFANAAE.fBHE..hBAA......hBCA...,1,-13,-41,28
JWTQcYAXgNdPSVKLOCfMeEbDGBRZHUaIF,XCBCdHBHSAEHKFBF.LGCC.CDFA.fECDhAAA.EFHFbBACGCFChABABBGGHEFGUADHICHEhACAWDBEQEAFAHFB.NAAH.....hAGA......hAHA...,2,-21,-21,0
FIcCOKERBadNQZHPDSMfeTUJbYWGgVAXL,XGGDFDCDCADE.KADERGAGBFDA..aAFEdBBCZGACHAFG.DGHBSDGHhAAA.eCAHhABAJFFF...WDCAhACA.GFCFAFAC.ICCAECGBNAAE.MAIFhAGA......hBAA...,1,-22,-42,20
GACcaUNXgTERFJSHdbIKMZYefOQPWDBLV,aEGDUCGC...XEBAEACHRBFE..JDCGSCDAHCAD.dAAFhADAIAEDKGFHZEFAeHAAhAEAOHAG..QBBBhAFADEIFBGFD.........hAAA......hABA...,2,-33,-20,13
KaBbAHeXdUcSNLIWCVgORTGMPDEfQZJFY,eBDGXFCAdBBAUFBG..SABELEEHCAGFOHFAGBGEhAAAMDFAEGGF.ZBCE.YEDChAAAaEABBCACAAFENCBG.hABA............hACA......hADA...,1,-22,-24,2
RCKEHcIdYQfAVMPBaSLJgTbXDWeFONGUZ,VFACMBFHBFHB.LAABJCEB..TACGDEADFHDE.ODCFhACA..NIDDUFGFhAAAZCDHCBHEHGAAdCAEQAFEhABAAIHE.aGDESGFB.XCGGhADAeCCDKEGC...hAEA...,1,-8,-29,21
PbSNAHaFQTYZJdeROVLUBIfgEcXKMGDWC,HFEEFFAAQDGBZBABdFBFRADBLHEGBDAC..IDCFEAHBKGCF.hAAADHDCCAFC...SEDAhAAA.AICCaACDhABAJEFA.eFGD.UAGEfCCEXBEF.hABAMFIF....hACA...,1,-17,-25,8
KdSgbTHVWcCAaOfLFGXZYDNUMBJePIERQ,OCCHFDCDGFCHZAEADGEBUBAE.BBEE..eACB.EHFAKHCGSFGAhAAATBGEHGFChAAAVDFECEEE...ABAHaDAFhABAfGADLFAAXACFMAIFJHAE..hADA......hAFA...,1,-10,-21,11
cJLAXeGbFIKgUNMHPTSZCQDdERVBfYOaW,XDACGECFFDCGKBCHUAEH.HFAD..TAGHZFGBCHDADBAGREFHBGAEhAAA.OHECaAHB.hAAAJECBADBH...IABAhADA.MBFFSDGEEDHB...hAEA......hAFA...,2,-26,-26,0
FSEUWIfTKPDZGaYeVNbXQLOHBCRcdMgJA,EDABUCBC....IFDFKEGDDHDAZBGHaCFC...eBDG..hAAANEHAQABDhAAAOFACCDFC.dHCFMADAAIFEWAFChABA....fHGF.TEDAhABAYBDB...hACA...,1,-27,-44,17
RbCEgJfNQBOIHGeWUPXDFdZMVAKYSaLTc,KAFBSAFBLEBFREAB.CFCE...EAHFJEGFQDEA.BHGHhAAAOAAFHBBDeFEBhAAA.UACCDBAHdEHCMIBGhAFAAGEF...aCGETECF.cGEDgCDAhAHAfBDB.hAIA...,2,-31,-9,22
ZJOaVAEBfceSRGDYICFHXQbMNWgTUPdLK,BFEDeGEARCADDBIB..CDCEHCGFQBBA.MFBFNIDF...TCEHhAAAUACELCFDhAAA.ZFAAJECHOAHFhABAADAGcFFDSHAAIAFD....hABA......hACA...,2,-46,-6,40
UadbGLTcNKYWVfREAZPBMeQOHDSFXJgIC,BFDDMIFG.OCEEDEGCFEBD..JAHF..CABCUCBHdFHCLFBDhAAA..TEDHKGFBVACFhABAEFGEZADA.eAHDhAAASCAF..XGDCIEEDaGAHhAEA......hAFA...,2,-34,-28,6
FKWCNZObSBEIRYVaHQdPGXegfTDMLUJAc,FAFBCFEDZBFAOECDBDCH...EGFERGAE...aCFEdGGD.GAAF.hAAAeEEE....hAAA.fDAGhABADCIHLBBFAAIBKHDANDAAICDH.YEEChABA.....hADA...,2,-35,-33,2
gYKRFEAISQNMXbPBGfDadJVTCOcLUHWeZ,QGBCXFDBBBGHDCEDdCFB..VCBGCDBALADCHGFAeAAEhADAZGFAKABBREAH..AIEASCHHhAEAMIEGGEBF.hAFAfEGB.......hAGA.aHACOBAB.hAHA...,1,-13,-19,6
VIDJgLEHNdfaACSBbXFTcYeMOUPZRQKGW,SBEEXGGGFGCE..TCAC.eGFCUBBGRAAE.QCEHhAAAGDCBVFAFIAGGhABADIDE.LFEBhACAEFDDNACBaDHDCEADBBEC.bCGB...cFADhADA......hAEA...,1,1,-19,20
GLaUcRTdIbNOQVMWEPYBFZJfAHSCXeKDg,CCAHXGGDDFDD.LCGFUGFG..RCFC.TEAHdDCD...IAAFhACAOABCQGAChAAAVFCGEHEABDEBFBFG.hABAfAEDAFEA.SDCGeEHB.hADAKADFaEACcGAC.hAEANDIC...,2,-32,-3,29
GbOCVTeDXKRfWaIMLHZgUNYAQJPEBScdF,QDACEDCDBEHCdFEGGEDH.CBGA.TGBCDBAEKGAC..RBEGaBBChAAAMDCE.LHAGhAAA.ZGEAUFGBAIFGPBCEhABAFAGCODBH.eACA.....hACA.XDGA.hABA...,1,-9,-24,15
ECaUXcPGWINYBRJTFgOfLSAeQKZHdVMDb,QAADZBCFdBGAMAFGEDBB..CFBA.UFGC..XEGBGGBFIAEGhAAABFECRBAH.JCDGhACAFGFF.OBFBfCGFhADAABIB.KEEFDABG.......hAGA......hAHA...,1,-18,-33,15
cAbBHLJYTNdZERWfKFXVDISegCOUPQGaM,HDBHLEEGJAGB.TBDHZGFARBCG...KGDBFAEGDCGB..SEHHhAAACHACOCAH.UDFFQAAEhAAAMAIB.ADIBBAGChADAdBAE.EFHH.fFBG...hABA......hACA...,1,-20,-24,4
KAdLIXDGTHYgCfcSZWJeaURFVONPEMQBb,LCCHXAFBDCDEGAFC.HGFECDEH.SAABJDAB.aFGAhACAFBAAODBBEFGFBHCGhAAAADHGTADA.YFAFhADAcDGF..ZFBG.....eACEhABARFDF......hAIA...,1,8,-37,45
LXVJTRbNMcZBeQEaFHfWPdUDKSYGIgOCA,XAEGJBDG.REDC.MIFABDDA..eHAGEHGCHGDC..fBAGhAAAdCGEDDBEKGABSAFEhABAIBCEODAHhAAALDFD.VEAG.TEGA..hACA......hADA...,1,-20,-31,11
RaZNXPgTHQCYFcWIULeVDOKdSMAGfBJbE,GGDHBAFBEEFDaADFZGEE....XEDBTABGHBFGQBFAhAAACGDFFFBB.ICAHhABALCDDDBIBKDAFSFBAhACAMIFGADIF..........hAFA......hAGA.fHAB.,1,-12,-19,7
gNJPYTQRDdIOabGECZLeVKXSAMWHcfUBF,MECGHAADUAEABAHAFGEEJDDE.....TGAHDGGDOHBA.hAAA.aADBEFHHCHCAZEGHeEFChAAAKCDAACCH...fBBEhABANDAE.PCABREBE...dCGB.hACA......hADA...,1,-22,-24,2
FWVXJaROeIdEgcZCASYfNTLGPHbBUQKMD,SHBG..NIEDTABDLCCEGCEHPFGFHECBBABDhAAAKFGHFFEGXAGBhAAARAFA.OFAFeDADIDGGhACA.EDBBcBCDAGAFfDDAhADA......hAEA...,2,-21,-14,7
ALFCEWcPITYRUHabMSJfOGVgBKeQXNDdZ,CDGFEHBG.....PACGTFBH.RBAAHCDFMCEB...JFFCOBAChAAA.VDFAgAGEhAAAeFDBXGGEhABADDABAABFFHEEIAHF.aAGHSBEBhACABFBA.....hBAA...,2,-24,-18,6
KYcePBUEJfAWTCLHVQDSabMZGdIXNRFOg,CHHGLDACHBBADBABSHCG.MBAAdBGHXDDD.hAAAFEACOBEBKGEEeGAGhAAAUCGE.EAGAADGC.TFGGhABAaHEC.ZEAD.IGDG.NACF...hBFA......hBIA...,2,-32,-18,14
LObBUYMADSfNFQgIGeJdcCRKXTVZHaPWE,DGHHSHBGFDEH.QAGEGEAAJHDECEDF..KDAD..XEGAhAAAVEGFHBBC.aCFHhAAAECCCOFAEBGDCMBAAhABAfABF.NIEF.IAEB..hACA......hADA...,2,-42,-5,37
PWXUDFcKSCAbNeHLdTJaOMRgBZEfVQYGI,eGEAHDEDTFCHODEHRAAFZAGB...fCBAQBGAIGGDhAAAPEAA..XGBAhAAAUAEDDBADFADFSFABhABAAGAH.NBIELHFAaDFCMIFCBAFChACAEDCF......hAHA...,2,-15,7,22
fdGTQPFMNLRYZCKEBISOHbAWgUVceaDXJ,UCBCVFDF.eFAA.DAACJCEE.GAAC..TAFGFGAHMFIBhAAALCHFZAEE.CGDBBHAGhADASGGFHFFA.ADID.hACAcBDA.fDDBdEAHNADA..KEEEhAEA......hAFA...,2,-20,-15,5
FLHEPXefdQGOKYbJVSTagINRUAWCDBcMZ,CAEDDAEDBGEGMAAFLCDDHFFD..EGDFeCFDdBGBGBEAKFAG.JFAGhABATCAB.aGGBIHAEhACA.UBBEhADAAGDHZAFFPCHBfAHE.OAAG.hAFA......hAGA...,2,-26,-8,18
RcfILQFOaWVXNgCKdHBDYTMAbSeZGEUPJ,eCCHGBCHUBAHJDBF.RGFE.....fFEHLCGFFGBHOFHFhAAAaFDH...XGEAhABACDAHdEEEDBFGMHAAAHAF.hAAASEAD.ZDEE.....hABA......hACA...,2,-31,-19,12
LOSVPFZCJfGaWBXAMRHbcNgYIQTdKeDEU,HFBG..NCCA.IGHCQADHKAAHEBDGLFDE.SAFEhAAAFDABZAGFJEFEaGCEBCCEhAAAMIFA..cDEBhACAYDAB.eAHHDIBA.ODEC.CBADfFHEhABA.hADA...,2,-28,-7,21
ZPcWdBaEgMbVLfFRHIGUTDXOSNAQJeCYK,QFCAJEGH.eACBCDHAZAAH..PAGBdGABBCEC..aADAhAAAMIFELHFA.hACAFBACHDCAIEBGhABATACFDGGGOAFFAFFGKCHHWBDHEEAE....hAHA......hAIA...,1,-16,-32,16
LdYcXRJNCSWeVBZgFabEADPTKQOIfHGUM,DAFBKGFCOFDDHDBGMGDELAFE.dDFCXCAG.JHDACEBBSBGBhAAA.hAAAVBAAgCGAhABA.FGAHaGCBAGHFTABCfEAE.YFHBhABANFEFBBGC.EDDF..hACA...,1,-17,-32,15
QbBREZNaLMgIGUeOSXWTcKAfdHJCPFYVD,dCFCHFEEJDBCFCHH.DDAGBHBCRAAE.ZEGDLBFD.MFAHGABDhAAAOEBHXGDG.hAAA.TECEAIHECGAF.PHFChACA..YCAF....hABA......hACA...,2,-44,-13,31
bISXPWKORFAGMfNDHZVcdaBQUELJgTCYe,MEAEDACBHDFCZEEBdGDCBEAA.EGBCLAFH.JBCGCCDAeGFG.hAAASAHBXBAFKAHFhABARADEAFDA...fGHEhACANAAE.aGFD.......hABA......hADA...,1,-23,-34,11
TXFUfAPaGOJZQcYIdDRHNMKSLeWECVBgb,GEAHZFBGQCDE..IHCADFBGHFGFMBAHLBCDhAAAEGFACBHBBHEDTAGEFBDCfAEFhABAAAAC.PCHDhACAOAGH.JEEC.cBBCdGFCNDAE...hADA......hAEA...,2,-26,-2,24
BaQMVPdbFETOIHfGRJALWZeDKCNXSgYcU,LFBBZFDFKFAA.CDFC.SDCF..cBBEBACDQDGEhAAAMIDG.dGGFEBEFhAAATBAGIFFEGBEHhABAAHHGeEADDDAD.NAIC.YHAAaACA...hABA......hAFA...,2,-33,-17,16
XAVbQMDBEPeCSOHJgLcIUdGfWKaNRTFZY,QFDHDFGABHED.eCEDCBCAHBGFLACDUEAD.dAFAGBDEKGGAaEBEhAAARAAF.FBHHZGAE..AABFMEAFhAEAEGHD....hAHA.SHEGJFFH......hAIA......hBAA...,1,-16,-24,8
ZGUPRaEFTfCeQXgBbHKDMYOScWVNLJAdI,dCFCZEBHUEEBaGBH.FACHCFFD....QECCBEHCKAED.MAHD.hAAASDHH.hABAVACGJBFBAHID..ICAGhAAAPAHB..EFABeHEA....hABA......hACA...,1,-25,-48,23
JaYPGRFZBWKfILNETXDHdAeVbCMQgOcSU,eFBBCFDD.QBBHOBADUCFF..aBEFGAEHRECAFGFBBDHFhAAAKCDDLFABEAHF.DHFChAAAABAHMEAC.SFADhABAYFFA.........hABA......hACA.WHFAIHHE,1,-14,-33,19
KZaOBRcGVHAdfbTXCIYMSeQDgUJLPEFWN,dHBHTCBCCAFE..MCCEQECA.DAGGJEHFLACEFFDA.hAAAKEFAaDDCOHCE.hABABGHAREBB.GBEFhAAAABBDXBGAIDHH.YBADSDAFhACA......hADA...,2,-42,-9,33
EXRDOfZACYcPeaLVBJQKUdHGgFIWMNTbS,CFDG..PGEALAHHBACGKGBFHBAAFDDG.MFCB..TACGhAAAbCED.EEACDAGD.ODAEhAAAAEHGeFEE..aDGAJHFEhABA.UAEA.dCAFIBHF...hACA......hBAA...,1,-18,-21,3
RCGIPbeQDdaJUcVXYAgLNSZBMOWTFHfEK,LGEASCFCZFBHBFGHOCAEFDAGHBBGEAGG.KDFARDFG..CACB.GEBHhAAA..PBEBhAAAQGAADIGEdEACaHDAhABA.JAFE..........hACA......hADA...,2,-26,-20,6
GJbTPBXAIFUZKaWYRdCcONDVeMSHQgfLE,UGBCZFEEKCAC..aDDHRCDAdFBG..OGFEDICG.eABEMADGSAGChAAAHAGB.QCEFhAEA.LBBFhAFAEABGbGFABECBAFFCIDHF..WEFEhAAACBHC......hAIA...,1,-17,-32,15
MLZgfCKGaVOJbSUBDcWQFAYdNeERPITHX,dHBHEDCDRAAB..ICGCHEEBMACCLCDHZBFC.CFAFGEGEaGAFOHFChAAAJADE...SEHDhAGADCACQGEChAAAAHHENDDH.eAHB.PDAE.....hAHA......hAIA...,1,-11,-15,4
LKaVUfOTJWYPMZGRNQedBSbFIgEDXCAHc,HFDFKDCDUFGBOCCC.JBEE....PBGBGDAG.QAAChACABACESCBEhAAA.FHAAgGGEhADADFDDAHEGLAEDVCGHfEEB.hABA......hAGA...,1,-4,-45,41
BKIVMXdHRQeYDFgJcOAGfNWLEbCPSZTaU,GAFE..WHFCbABA....CHGAZCCCTBDABFHA.KHBCMFBBhAAAHDAFQCFDhABADABAFFFG.JAEAAIAG.NDAELBBBhACAEAHBSHECaFFA......hAAA......hAFA...,1,-17,-20,3
gOHQWVcZTSRNdeYJDUfMEaBbLXFPIKGAC,CAFBOFBBHFBD..QDFAVCCG.ZBADTDGDREDB..NIDH.dGHGhAAA.eBEGDCCEMAAChAEAaBAHBFFELBHBFAHFIBBHhABAABFB..cGGFSGDC.hAHA......hAIA...,2,-17,-15,2
LVNBfKTRYGaEXPFCeHcAgbIWDQMJOdZUS,..IFDGDAFBMBGHdCFEUFDELCHBBCDE.KFFARCAE.GCAF.hAAAaEACXAGB.hAAAFGGFHGBAACIH.WACChABAJEAD.SGAF..fABBhADAEGHF.....hAGA...,1,-15,-38,23
SebcfPGUQCDHgKMYJANZXVTLadWIFREBO,XFDHTBDG.LEAGaGGE..IFGHFBGGBFGC.OBBFhAAAbFDB...PBEBhABAUBAEQFBDhAAADIDAKGADMADBAFAENAHC..dDGF.ECAB...SGHBhACAfDEF.hAEACAEB...,2,-20,-15,5
NZcIGTREbQKOSfAHgBdPYeXFaDLCWMUVJ,BFDDdHBHeAAFaADBLEBEMDDG..UECDJHDC.ZGFGGAFGRDGB.hAAAEGGBQAFDhACA.SEADhADAfAACABCF.PFBD.FCBCCBDH.....hAEA......hAFA...,2,-21,-17,4
gIBPFGOcNUJMZaYQLHKWRVXSdTDEfCAbe,eGEABFDGFBDGOCHHUGAHZABG...aAFHLDDCHDCH.RGFE.SDABhAAADDHF.fGBEhABAAABF.IEFGhACAPDAF.NIDBMAIF.....hAAA......hACA...,1,-3,-53,50
fHYACRLeJZcbXPNEFIWBgKQdSaUDOTMGV,CEFAeFFCZFEC...XBADEBEA..FCABBHEGKBHF.SHGAhAAADIAC.TBEDMEDFGAAFhAAAHEACABGALHAEhABAJHEA.PEDANDIG.gACAhACA......hADA...,2,-35,-13,22
BGUMgXNKOFLDRVYaJZEHCfPTIdAcWebSQ,eGEAQGBCBCBAUDDBMAAD....NBCF.KCFELHFADEAF.hAAAVCFFaEBH..EBAFfEAHhABA.TEDDhACAAIBC..........hADA......hAEA.cCDGSDHB,2,-50,-10,40
NTJRZcbDMfQeHLKYGBXUPSdWEVaAOCFgI,FDAB..NDHE.RDDGZDGBDCBE...QGCGeFCCHADCKBCCBBHAUAAEhADAdHAB.EGDCAFBBCECGTEAGhAAA...JDDEMFIBhAEA..fGFA....hABA......hACA...,2,-35,-24,11
KVOCBebgFYUMPJfZLWcDXHaTdNIRSAGQE,QECBEEHBKFDE.OAAFBBGFeCCH.FHCCUGAH.JDHFLABAhAAADEBBHAFHaGGDdGEEhAAARCAFAAIFCDDC.....hACAgCGCMCCEfADF.cGGFhADA.....hACA...,1,-13,-32,19
aVPTWLUAENMFcICBgdDGOSXfZHeKJbYQR,EGFHMHFGFAHH..CBBABECDdFDHDBBDGEDA..XBEAHBGHKGBGhAAA.JADAQDDFhAAA.aFAA.PACAhABAWDBFAAGC..NDHE.gDEB..hABASCCF.hACAZGAC..,1,-12,-36,24
JCQHcKGbOZEVdNegISYDTaLFMXUPBWRAf,JAFBCFFCHCAFGDCBZGBGdHFB..eHBE.SFGHDBAHaFBEFDEEUDAAhAAABDCBACAC..QABEhABAKAGC.EAHFNCIA.hAAA....IFFH....hAEA......hAFA...,1,-24,-37,13
UGKJXOPZfNbTDCEFRVaIeYWAHLQgcMBdS,LBDGQCBCMGEESAFDKBAG.OFGBZFAC..NFEH.DIDEhAAAFHEAaDEE..eBHBhAAAWHCCAIBAHDAE..hABABGBCdDFF.GEBF.PAHF..hABA.fBDEhACACDDE...,1,-14,-28,14
bVLSUYZEOQdDCgKJXABFaWGceNfPMRHTI,BEFAFAFBGACEeHDA.....PEEGMCBAHGBE.bAAGSFDDhAAAZCEE.EBGHhABAQAEFCHGGKFGAAAHEaEBDhACANBIATFGE.VDAGYEAD.DBIHhAEA......hBAA...,1,0,-25,25
IPTKHJUZQBgYSXdfAbLRGOeEcMFWVDaCN,LFBBRFBHeECE.ECBCMAACFAFB...DGECCDEG.....IDFGhAEAKGDAHAGBUAFCBGHDhAAASBCGfBAAhABAAHFAODHB........hAIA......hBAA...,1,-35,-37,2
CPDXITKbJgAdNMUQYLWfHReBaEZFVSGOc,dGFHUFDBQGACLFAFHACGBDBCaBACZCFCSEFB.hAAAOHCEPEDFIGHGhAAATCEFKADC.JAHBhABAgCAAAFIH..NIED.....hACA......hAGA...,2,-26,-14,12
IZBOfbSgQUFVKJLEacRGCYNWTHXAdPeMD,eCCHDDGGBFBGOEFG..SABHQAABFDCCVFDDLEFDhAAAaGADGADFCFDC.NDAE.hABATAED.AADAMIAEhABAfGGA..gEGHKCGE.hADAEAHB.....hAEA...,1,-9,-31,22
WPdJKFRNTLYgOcCSXfbAIMEaDHGVeQBZU,MHFGDGGDGBFE.QDACUBCCdBGAFFEBRACDLCHHOECG.CABC.hAAA..SGAHhAAA.XBAGhABAAHEFIFCFEGCD..aFABeHAA.BHHB.PEEDhAEANAEFTBEH.cDGEhACAfAGB,2,-30,-16,14
POFeHBTbNUKAMYWVfcELGRZIXJCQSgaDd,MCCAVAAD...EEEGRCFAZFFB..XGADCGAB..QDDHhAAAaCHBDEAFdBBCFAFGeACEhAAABFCDTGGE.UGEEhABAAHEHfDBA..LDDChAFAIADCSGCGhAGAOFHD...,1,-12,-24,12
EDKYfPRcOdVJQgAUGFCbZILaWHMeNBTXS,GCEBCFEDZBFALHDGaECCHBCA..eFAATAAGEBBE.DHAC.KFFA.hAAA.fDDDhABA.PAFAOHFAJFHHhACAAFAA.FDABWGAEBDGCSACE..hAAA......hAFA...,2,-26,-11,15
GPNTHLMCSEIWFeUgdJRfXaYcDVQbABOZK,BEFAODCHKACHGADC..TAFGMIAGCFAGEEDFFGEF..eFHFhAAAdEFDJAACRGDE..aAEHDIGGhADAQFAEAHBA.hAFAPCAC.NDED.SGGA.WAHBhAGA.UBFE..hBAA...,1,-15,-26,11
KXJFYOBeQHVEScUGRPMNWZAgdCLIDfTab,CFEDLFCHDECH.TAFBKAGF..FDGBBEECHBCBSCADhAAAGAAE.RBCG.MHAG..hAAAWHFGAFHFdAEE.aGGEbEGBhABA.JFAFeDAD..EABA.....hACA......hADA...,2,-27,-15,12
YPSJaKTLDCXgdBGWeIOVEUHMZRQfcFNbA,SHBGJEGH.KACGDACE.CCDF.dBGBGEBFeFEC..OFBGhAAAUBECZAGFRBAE..fGGEhABAFBBGAIEA.aCEDLGCAhAAABHEH..IDHE...hABA......hAFA...,1,-21,-40,19
XYdSgJUQcFeVKBbEPLCHNWRMZfaOTDGAI,XCBCdAFBJDDC.UFAFFCAF...KEHDBDHE..EBFGCGFBHEBDhAAARCEBMBBG...aHDADIFAhABAAECC.SFHBhACA............hADA......hAEA...,1,-38,-50,12
XEZKTUaSgIcBeMGHJFOVLdfAWDCRPQbYN,DAEDRDBHQGDG..NDDCZBFEUADF.SBAE..hAAAIFBEeAHDHDFHhABAOABBdHGBAFFFCEFD.YEAFhACAXEGH.KAFA.aHACBEDA..JHDEhAAA......hACA...,2,-45,-3,42
YAEGNHcLUPDMBTVZOaWFQCgSbedJXRKIf,GEAHHAADUADEMACHBEEBZAGD.OBFAFHFAQEGH.SAEFhAAAeGDAXCCGhAAAIDEEfHABhACAAGEEEBAF.NIEF..cDGFDAGB.....hABA......hADA...,2,-20,-16,4
SEKcVRZWLBFIGbeNaMDHgCPUYdJXfTAQO,QGGDOEGHKGCH.RBAHLFBCBDDH.FHAE.GAFCNCCC.DAAGhADACCACUAGBdHDB..fEEBhAEAAEHD.ECDGhAFAZABA.bFEH.MFBB......hAAA......hACA...,1,-6,-42,36
TQHXeUOcbLGRfMNdPgBYAFWCZSIJDKaVE,CFEDZDAG.SGEBDIBGKCGC...EGAEQAEGeFEEUBCDODAGhAAALAAD.fCGEhACAMFIBdABFBHFAhAGAAIAAIAHDJDGH..VEBF.....hADA......hAEA...,2,-33,-24,9
PWYRAZCBKJTLXDESUfOaVGgNIMdHbcFeQ,BDCFKGDDLEECDCFDUFABODAF.GACB..IBBAhAAAdAGEHCCEFEDFQFGBhAAA..YHDEhABA.RADFADAACBAG...XGGH.hABAEDGHSBHHhACA.aFFHNAIE,2,-47,-18,29
KPILeCTESHbAgYRXQFMWUJNBGfZcdDaVO,RAADXFCAFFFE.UBAGJBEC..BEEAZFGDdBFG.DFAAOFAA.hAAA.IHAHLGAGhAAACFFC.SDCChACAADHB..gAGBMIBENAED.fACBhABA.aDDB...hADA.KHEC.,2,-37,-25,12
cgaNERFfeBIYHUTZDQCVGAPXJLKWOSdMb,XDACKAABOECAdGEE..MACB..bAAGaDGB..EAHFFDAFeECAhABABHGHHDGDZFBBCHFCAIHAPGAAhACA.WBCAhADASAGD.NAIE.......hAAA......hADA...,1,-3,-42,39
QRFaZfGgBdSKcANXLOHJIWEDUbCVTMPYe,XDACHFBGJDDG..EFFEUFCG..CBFD.TBCAMCAB..eHFEhAAAQAAFFHAC.ZDEChABAfBABgBFDhADABHEGKBHBAGIDOCHFIFFCDAGE.PFADhAEA......hAFA...,1,-16,-18,2
RgSadZNXQWIAcGPUBDYTeHfMEKOFLbCVJ,GAFEBHHGDGFCeEFAHBFGMFDHKDAF.LDAG.CGGD.VDCDRFAFaAAEhAAAdGBG.ZABC..NEEE.hABA.QBDAhADAAFIH..PCAA.......hAEA......hAFA...,1,-8,-38,30
bJUGKQWBMeaTAOgEXYSDcNPFfVLICRHZd,EDCDSGFCDFAG.....NCCAFGABLGFC.CAHEZCGDdBDCJAABhAAAKAEGQAAFhABABEAAMEEA.aDDF.AIFA.OHFChACAXGAG..PAEAIGDEHFCBhADA......hAIA...,2,-26,-26,0
afOUeFIHNWGbKLAVXZQPdTDCcSYRgMBJE,XBBHQFDHdAAGDDBH..CFGC.SGBBRGCABFBB.aECGOBGHhACAFBCEHDFEGADEKAFAAGHGhAAA....PAHDhADA...cGACMIFGEABF..fHGHhAFA..hAGA...,2,-32,-19,13
PEQVfUFWZgLeMBGKATXINcOdDSCYHJRba,TCGCXCBC....ICAHOEHDSFDDCAGCHFFBJFACRFDHhAAAaEEF.QAEFhAAAUCDEFABA.gBGFhABA.MCABBBHEKABGACCD.cFAEDEAE.PHFChADA.fEGAhAFA.,1,-17,-19,2
INGdJYPDMcTWbEUfaAXgHLZRSFQKCeBVO,HEFHLDACRAFEFDCBCFEBBAGD..IGCAdCFA..JHCADICEMHFEhAAATABF.EEAHaACDhABAADAH.ZDGBKBDG.OEEHhAAAGEAE..PFHD.....hACA......hAEA...,1,-14,-32,18
YPIfSZQcdaVWEebRAONJXUCTFgDBMKGHL,OEEGJDAC.UDBGCCGA..FFAGBBHEGBBFLEAF..IAHAhAAASADAQGEBhABAaBBC.EAEARGFAAGCGhAAA.XGCADFECMEEGKBGD.....hACA......hADA...,1,-27,-37,10
GQOacVMWHeCBRZKJfYAFdDLUEgPbNXTIS,DGGDUAADECAC....bDBEXGDE..IGDHSEBChAAAQDFHOCFCaFAHhABAMFAHeAEACCHFRGFGJADChABAAIHELACB.PEDENIBF....hAEA......hAFA...,2,-22,-19,3
SOgUGTcdCeAfJPMYBaXZHEFINKRWQVDLb,JGEAMCCABBABZGDEFBGA..KBEHRDEA...QGBADEDFLBBDhAAA.OEAHUDEBTCBDhAAACADD...AEAD.hABAfHAFaAGA..XEBCEHGA.hABAWDHH....hACA.SADF.,2,-32,-26,6
GZTcUaVEXKPSMfeWCDgdBFLQARIJOHNYb,RFDFJEEGOBGHHADA......NIDBGGAHZDBETGFF.UBAGhAAAVBAEEBHDKBGA.SFGHhAAAMFFCeEADCDEFDAGGhABAdHADBFCFLFACACCE.......hABA......hACA...,2,-15,-10,5
PWXegUaDSMIRKAZFEHCBTYfVJbcOQLNGd,ZFEEFEHBCEFGBBHC...TBAAVGCE...JDDGOCAF.LCDBhAAAGDBEPFABhAAAXACC..UADEhABASCGFIHHEACIFEAGGfDGAQGGBhABA.....hACA...,2,-31,-22,9
fNRBASPHUFZMcIDdgCLYaQGEWVTJebOXK,SCFCUFDHFAGDZDBBMAAD..DICEdEDALAACQFFA.hAEAGEAGEHGA.WBBAhABAJDEE...ODFChACAKBDA.NAEBAIFA..........hADA......hBBA...,1,-20,-44,24
YCFHdBOPZGMgfaKLAQRUbDWNJEIVXScTe,RCDBUAFBDCAG...JEEAEBGD....VECHXADG.SFAEhAAAeACHFEABBHGEhAAAZFGDMBIB...aGDHhABAAABCbADD..IHAH...TGEAhACACHDAOCHF..hAGA...,1,-22,-38,16
SOEFDAcHNVgBLbefWJYCIPaURTXGMKdZQ,HAADVAAD.BDBALFFHeDGD..JFABIFABUGGF..RADGGDDChAAAMCDEKDEF.dDHC.hACASDAGOCHFEGCFhADAFHCAACCA...........hAFA......hAGA...,1,-12,-28,16
YNPXFHgWdKZVLQBEUbcfSIRaTCJMAGOeD,eHDADACB....NDAA.PBDHHFFGdHCFKDFGZEBALDBBBCHFEFGBhAAAUDDG...fAAGhABAIGBAaAFBCBEA.hADAAIHA.OBHFFBAG........hAEA......hAFA...,2,-27,-27,0
eBdXKJEWTVLbSfYDUONaPQMCRZgFGHcIA,dDABXGGDKACG..EEFD..VCAGLDDBSDGHDFBFUCGHhAAAaGCE...QAGBhABAMBGBCAHBZAACFHEEcAEGhABAAFCBBHHA...WCCE.....hACA......hADA...,1,-26,-29,3
JRfPbAXQIDgFMaSNLYKdTOVHBUeEWZCcG,XCGCQAFBDCBCMCBE...aDEBNDAC.KGAH..dHFBOHCChAAABFDGEDBECDGA.JACCfFGAhABA.AEBCIFCHhACASGAHYABGTEEC...hAAA......hABA...,2,-43,-21,22
AUSHJWgCMVXdEDQNbZOBLPKGFfaRYcIeT,HBCFJGEA.CGBG.MDAFdDHGQFDAZBCE.LBABKBAEGBGChAAAFGGAaAFFREBG..IDEDhABAAAIHSEAA.hACA.VGAADACDNICB.BDFA.....hADA......hAEA...,1,-13,-26,13
TQXWBRbNZgCSELOAYVGUecMJfHPDaFKdI,VEBHGDDC.eBGFMGFAHFGF.aABHdBCCQFABBAGE.NICF.hAAACDAESABChAAALADEABEB.....YEEChAEAcCBDfDHEDHDCKAFD...hAIA......hBAA...,2,-41,7,48
ICUELaKVBRQcbXJTOdNPSefZFGAWDYMHg,DACBMECGHADB.CAADLFAGKCDGBHFFQFBG..bFFChABAJBGFOHFCdGGA.SDDGhADAeCAC.FHCAhAFAAAFG..YHBGUBFGaAHF.....hAAA......hABA...,1,-10,-41,31
KYMVgHFPfCBRXIATeESWdDLNbOcZGUaQJ,TGGDeEGHEAGE.dFBHLFBH.OEEDZCEGaCAEQCCBhAAAKAAFMBCE.HBGBFEFBCEACBAFGhABA.XACFhAGAAICADIGE............hAHA......hAIA...,1,-17,-30,13
aFGEASPMZLJcWNfDHUdegOCXQYTRBVKIb,SGFHMECGZFFGLAEG..JEBF..NAAE.DAFBHBBEUEDDhAAAdFAFeAGHCDGH.QABBhACATGACBGDDKCDAaDHDhAEAEHFCAIHA..........hABA......hACA...,2,-31,-19,12
aAJEbUFPgMWVIfZNHQRGXYecdLSTOBDCK,EDCDFGFCMHBC..IABFZCCBHCGBRBEFGGEHeAECdBAGLHAAhAAASEDHTBCH.hAAABBHGDBIDaEAFJEAFbEEAhADA............hAEA......hAFA...,1,-11,-21,10
bDIXFaQKLANZHegEMVJBRScTUfPYGWdCO,ZGFGHFDFeDGHMBAHBGDHSGCFUFAC.....fGHAhAAAPCCDGACHCCCAOBHHhABA.IDFHhACAaBAHQAGCAEDBEBDEJFAB.cFGB.WAFChADADDIHXEEB.hAEA...,2,-18,-15,3
INRHCfBdEGKSXYQWeVaJUPgbLAOZFTDcM,ODCHTCCB.DGFFMFEF..RDECHBCDBBCCEFHFKGHB...XBGBhAAAQGCA.eCADhAAAJFBFUAEE.PBAFhABALABCAIACcDFFCHAEdGGGYAFDhAHA..WFGD..hACA...,1,-6,-28,22
TJcgCYXaBGHOWFfdILKMQVENSZDRbPAeU,eDCHUDCH..JGFECFAE..aEGEBAAF.HFAHOBEH.FBAFdBDBKGHDhAAAMCIH..EGDESGEDhACADCCFRAGF.ACBC.hADA.....gDFE..hAEA.XAFB.hABA...,2,-40,-30,10
JWTMHaNZXgCORcEGVYSDBFUPAefbIKQdL,eGEA..ICAHdDAEJEFG.MGBCHACFaHFAZGAE.CAAC.RAEBEFFGGAEFhACA...SCFGhAEADBAEFHCAAEAEKDFA.hAFAQCCH.LAHFNIDFgEDDhAHA.....hAAA...,1,-6,-26,20
KLbSdeBCgIEFQXfTOHUWYaRcDMVAPGNZJ,GAFEZFDFLBDBdBCBCAAC.EGCHFFBB..XBABOCAB..UFFFhACAaGHDDFHF..MIAAhADAPAFAKCDD...SBHHhAAABAHCIDHFTEAE..WFEDhAEA......hAFA...,2,-33,-19,14
JWGefPHLdOAVNgTYCEDKIbXcFSMBZQRUa,VAADTCBC..EBFADFCA.KCHB..XDEGFAHBBGBHZGFEUGFGhAAAJADB.GABF.eEEEhABAfHCDLCADhACAODGDAGAB.YFABCGDC....hAAA......hACA...,2,-32,-17,15
bWGcKfFLAJUSeTVDCZROEMQYNaBgPHXdI,UAADSGDDeADFDFCBZBDARFGB...EGACQGDA.aCEGhABABEFBHDEGdDAAIAFChADAbCCG....hAHA............hAIA.WHFEKEEDFAGEABHF.hBIAJCHF.CABB,2,-30,-26,4
PDKWRYUHTMXBFVbGfaegSOZLAcQNJdECI,QCBCdDCDEAHB.CFGC.DCCGKGBARFGDHCFB.MADEBDFB.FAGAVFCDhAAAGABF.aEDEeBAFhABA..SFHHhAAAOEBBAFFH.NEAGIHEB....hABA......hACA...,2,-34,-12,22
KSJYDWBNGFIXaZgCTUeHLQPVROEMfAdbc,dHBHKHBG.JACEDBBA.BDACGDDD..FDGHaHFAZAFE...CFEE.eABDhAAALFAEQFCDhACA.RAFGMEIFAEDESGGHhAAA.....NACD..XCCChABA....hAHA...,1,-19,-52,33
bgZLAYfeRXBTPIKJCVMDSdWENaUFGHQOc,eGEAXADCBDDG...TCFBIHCGCFEA.MBABdABDECAFaGGGGDEBhAAAHEBB.QBFHhABAODHF.gCBDhACAAHIHfAHEKGADDIFASFADNFAB.hAEAcBEB...hAFA...,2,-16,-11,5
gHSVNKEfGdZOebXLRQTaIMFBYAJUcPWCD,JDACUCBC.....PGDGCBAADAFBHGDC..SAGGhAAAKEGAEFDA.dFAHZAFBeHAGhABA..XABBhAAARACGTDFBaBHDFGHB.ADDA.gGGH.NIAB.hAEAOCHF...hAIA...,2,-33,-15,18
SefMJZTdbQBIKVEWAHYLOPXCUaDGNFgRc,HFDFLEEGOCCCXEABaAFC..DFGFGGCDFCGF.RCFAeAAAhAAAMIFAZEBBdAGHQGGGhABAKAAEEADD.ACDCCFCENCIA.SFADhAEA..fEAE.hAFA......hAHA...,2,-17,-6,11
XTHaSQFcIRDGBNYOAEgeCbdLWJMUfKZPV,eCCHdEGDJCBEUBGG.KFCBZFCE....XBBBTCEBHAGBhAAA.QEAFhABAFAEHIHEHDACEBGHF.hAAA.OEEAAIBACBBF.WDAFMIDA..fHAFhABA...hAFA...,2,-35,-26,9
aALFeGUKNJXTWfcCgRVHZSbdPOMQEIBDY,FGDBeDACKFEC..JBAE..TBAF..fFCFCEAA.hAAARGFEHCFFSDEAhABAPBHDOEBD.QAGChACABGADDAFC.YHFEABFB.LAEDhADA.NCIE...hAIA...,2,-31,-28,3
fZFMWHKBIEeOQCGdcLARUgDNJVPTabXYS,UFDHDACB..JEEFVBAH..aCGH..XCGB..fAAEhABAMFCD.KFAFhADABDEEeECBCAEE.dAEEcGGEhAAAAICC..NDBB....PEHD.hABA......hACA...,2,-47,-35,12
WPbUNIMAXefdQaKcOJBDCESRVTGLgFZHY,XDACdDCDKCAE..OBEEDFDH..CFHBRGFEGGEHLAAEFADEHGAEhAAA...PDFEhABANDEFACBGeBFE..fFGDhACA.aAGABEGF.SGCDhAEA....hAFA...,2,-40,-16,24
cCXbZESPLAGWRIadgVUHFDfTYOKJQBeMN,GEDHRAADdDCAUEGHFGACDIGA....TAGGKHECJBFG..BHEFhAAAeEAAMACE.CDGB.XBAHhAAAZCEB.SBEFhABAACED.IACHVGAEfHGBhAGA.....hAEA...,2,-41,-23,18
DGRSYXUETOHLKFaJBAVMNWcIgebQZdfPC,VFACMCCA......NAAC.IAAD.eFECZDGHPGBChABADEBE.GDECRAEHSBCHhACAUDBH.TGGDhADALAFAFAHDaHDAAHAHcGGH....hACA......hADA...,1,-19,-25,6
ZMgcLBHQNSECOUFKJfbeTVaGYDIRPdWAX,XFCAZFACMBBELCCABCAAHDFF.SAEHCECBUEEC.FCCDKHAGhAAA..JAAEeFHDaAGD.hAAADCAHRGAE.dAHEAAEF...hAGA............hAIA......hBDA...,1,-25,-33,8
BPUXRKGMgNfQWLCEZaIHAeJSTVOcdFbYD,SAABVADG.dHGFFEGCDEEGBBHD.UDADKAFHMAIH..hACA..fHDBhAAALCCHCADCEABCZFCGIFDChABAABHHeDHDOFAH..YDEHhAGA.PHAC..hAHA...,1,-24,-38,14
EIHVTFReMdKNLYaUcWJDPbGSAfXgCOQZB,XCBCCAFBZDACBEHCHFDF.FCFEMAHH..KABALGCAaFGHUFADhAAAJCDCDBFE..GAAFhAAAAIBE..fDEEhABAQEED.IGHD....hABA......hADA...,1,-24,-36,12
bMKLZaSOEJdQcFVRgDYPHUTXAfBWIeGCN,BFDGeGEAGCDECEFE.MAFEZAFGaFHH..SBAEOABDdHCBhAAAFDAA.VBFFDCEBHDAAhABATFBDAGAB...IHHEhAAANADF.KACCECGA......hBAA......hBBA...,2,-33,-8,25
dABOaXJcPQUZVeSIWgTCEfbKMNRDYFLHG,aDABXDAC..JHFAQDEDZDDG.SAGCIBAA.hAAATACGCBGD.EBFBfDHAhABAMDIBDEHHFHDEhAAA.HFACACCGBHBB.cFDE.PFAChACAeCAG.....hABA...,2,-36,-8,28
EAgHPWVCXFOMfZLeJcGKdUDINSQaBYTbR,HAADVAAD.FCDG.OGBAZBEBLHCE.eFABJAHDGDADhAAAdEGFDAIH.IFHDQEBFhAAABACBTFGFRGEEABFG.hAEAPADFCHAA.MAHFfDFC..hAFA......hAGA...,2,-21,-1,20
ebMaDfLONTVBXSPEdcRWHFQCJGYZIAUKg,KGFCeGEAMHCCDCBALFBB..ODDDTEEDBCBD.SBAEhAAAdAEBRBEEFDHHCAACGADBhABAZDAAAIHE.UDGD.hACAgEAGfAHENIAF......hADA......hAIA...,2,-25,-20,5
ePfbCQJVWHTMIOXFDGgYEZNaSdRUcAKLB,BDGFeGEA....PDHDfCCF.QGFHVBAHHFAHhAAATAEGIHHBFFDHDDIFhAAAGAFG.EEEENABEaHCChACASECBdAHAcDECAAEEKAHB.CHDD.WDADhADA......hAEA...,2,-27,2,29
XUTbRgHFJDGPILacANWSQVYBOZCdMEKfe,SHBGVEFH.OCHDZDAECCBA..EBFHeDDF.UGEHRBGHFBABDCGDhAAA.GBAGLFBGhAAAAFFAQACFBHHAKHAE.hABAXBGB........hABA......hADA...,1,-21,-29,8
eMOcHFTPEaZSDbRANGWXKBCLYfJQdIUVg,GAFEKGFCCDBH.LBBA.JHEAIBBFUEAH.eHAAMEDFHCGFhAAAFEGD.EBDF.aBFFDBIHhAAAAFAD...NIAFBAHFhABAfDEAdEEA.OBAH...cFCAhABA.....hACA...,2,-22,-22,0
CUcfYQMdPVFLDEaOWgNIHReBJXbKTAZSG,SBBDCFFHUAFC.....fBEGQEBGMIEEdACGFDEAhAAADEABODGB.hABAWEDFNICF..IEHFhAEAeCHBBGHB.bFBDAHBD.ZACF....hAAA......hABA...,1,-22,-44,22
gWIKHTXbLNGYcJFPMUfQZdOSVARaCDeBE,CCAHBGHD.EEEB..IAGEHGBC..bAFGGBEE.JDGDMBCBhAAAQEBAOCABAABChADADIEGeDCHKAADLEADhABANCIEFHEE...fCCF.SEEDhACAaEGB..hADA...,2,-36,-8,28
XeYESIUZaVdFONRLWHDTKCJMAbQfBcPGg,QCBCBFDGGGEFeHDAECHD.UADFZGAAdAEAOBHHLEEE.hAAAHBAGTECGCEBFAABB.fGDHhABA.cGAFhACA..........hAEA......hAGA...,1,-23,-26,3
AFbeQJKGMIfPWYUOERDCTScaXgBLHNZdV,eCCHQGGDGFEHMAGB..PFADUFCGEABCDBAB..CCBDSDFGhAAAXCDALFFChAAAZAFAAEIDFGCFKDBF.fHABhABAOBEB.cACDBEAF...NAIE.hAFA......hAHA...,1,-14,-18,4
CZQaWXIbGJHYfFdLOcNRPKEDMASTgBUeV,TGBCUGGGeFAD.ZBAEQFFF.XBCAGBDAJHCAhAAAfCBEFCFAdEGFOABGhAFANEACKCFD..MAAAhAEASFBCBHHEaFBG.WEED....hAFA......hAGA...,2,-21,-19,2
MJBcXKGAdgCFITLHESaPbOeZNQfYVDWRU,CFEDTGBCHBFA..aCEHOACB.ZAEEQCBF.fEHAhAAADDEAUGEDMDABhAAAJFAEBHDFXDDGAIHEFHACEGFFhABAPDGD..eAFENBBG.WABA.KDADhACA......hADA...,1,-11,-21,10
XaTFKZfJVMUPdgYLRCIbHBWENDASOGQec,SHAEODACGGAHQEBBeCFBaGGEKCCF.ZBDC..fFAFhAAAJHFAMGEAdAACgADChABALEEA.CAFB.hACAIBBCBDAFNDIAABBGTEDC....hACA......hADA...,1,-12,-21,9
EaPUHMbTOCLcgYdJZBQeVARGWfISKXNDF,REBHGAFE..IDDGKEAAXAAC.FGGEaCAFHEEAMAGBTBCDhABACBHCLEFB.hACA.YEDFJAACBHADhADA.eDHBADIBfAHENIDBDBFH....hADA......hAEA...,2,-24,-16,8
DHZMWaKVfTCPLbSEgGeQXROABcIYdUFNJ,BFDG..IFDGdDDBFBBCDBDGMFHB.KDAB..TGGGCCEG.hAAALDAHbGBG.EFFHhAAAeACH.XCFFhABAAHBEUAFE.NDIGZEEFaHDC.fAFH..hACAgCGA.hAEA...,2,-30,-24,6
gaCbLBEZSWdXMIDGcRfHAONTVKYePJQFU,ODACVEFH.KGCDeCEF..QGFEUEBACHEG.LFADhAAABBDEEAACZADD.dDGAMAEEhAAADIDERABFABIF...TFDHhABA...........hADA......hAIA...,1,-16,-43,27
LQOgMKcWDHbVIZaCfdTGXBSREYAeFJUNP,FGDBJDAC.UAFCLGDG..QDBHMDDCKGAD.DADBHBGD.hAAAVAAEIHFD.hAAACHHEdABETEEFBFFGEAEEhADA.AIHG...........hAGA......hAHA...,2,-46,-20,26
BCDMZEObKgaHRePSUfFcIYAWTLGdJXVNQ,TDACGAEGJFFC..XAAFQAGEDIEAZGEAODDB.KBBBhAAAgFBHREAB.hABAPAGDfHEBhACAICDEADAC.LFFG.dADFBHDDCDHAMIAAhAGA.aEEA...hADA...,1,3,-25,28
MAgTXNfDcIFEbYHWLVBZOUSPCadKJRGeQ,TCGCXCBC.DFGBFCDB...EEBHHCEALFDHZAEAUGCBCGFCKABAhAAAJAAERAEC...eFHHhAAAAIHA..NEAG.fECHhAFAIGCF...WFFDBGHBSGAFhAGAaEEA.....hABA...,2,-25,-11,14
QELdaXBVHPODgUIfWYNJcKMSRFTCZGbAe,QAADEEEDdACGBHEFHADC.DFGGUCFG..IDFA.hAAAfGHCYBABJFBFhABAMDCD..SAFEhAEATBGAZECBAECDaDHFPCAFOHFC..hAIA.WDDDKHEACHAE..hAAA...,1,-14,-26,12
XaNTbWJORGdBSKHICQFEeUVDfAMLcZgPY,LCHDZAAD..gFCFPHBE..XEFHTAECJFFBhAAARCBGdEABBEHG.SCDBhADAIGAHCEED.EBFAhAAAUAGADIGAAADBMEABaBAB.......hABA......hACA...,1,-22,-23,1
fNQZOFIKWaSJTUPALEGXgRDcMVBebCHdY,EAEGXAGHREGB.DBAGMDFF.BEBCeBDCHABGdFDB...fBGAhAAAQFAFOHAEhABAIDAEKDDHaBHDSGGEhAAAUGEBAAHCgCACbCCACEGH..ZGEAhABAWGAC....hACA...,2,-14,-12,2
JcQEAYPDaVHWTOfbNCGUdRegZLFBKMXIS,DACBVBCFHADB.OGAE..NAIACCAAdFBF.eFHBLGEGKEFBMEEBhAAASFBD.hABAQEFFAHHDaDABTAGChADAbAFH...........hAAA......hABA...,1,-19,-34,15
NJcRFUMeSAIXWBDHYObaQKLZEfPTVCdgG,XCBCBAEDDGGHHFCG..OEHDaCAGKCDEEFAA...TADChAAACAFEdDBCGBGCJEDHRGAAFGFFhABAeHAGAAFA...IABEhAAAYCEG........hACA......hADA...,1,-23,-28,5
JBDGRaSKbAUgPEWfCOMXeIHcVZTFLYQNd,UCBCEHBG.CHGE.MAEH.eCACHCGBZGEALAEEQAGDdEEEDBAFhAAA.RFBD.SDDGhAAAABFA.gEFChABA.fFCE.....hABA......hACA...,2,-41,-8,33
FdJEVXeaOTbKSCGBIQWDZgMLRAPcNUHfY,...PDEHUABDHCCCFBGF.dHEH.EFBAeGAEOFGFKBAAGGEFhAAABAHA.QDABhABADEBGMCABAHAHNCIC..fBDHhACA.JDGHXDGE.aBFC.hADASGDEIHAG.hAEA...,2,-27,-15,12
DQVTSZHbECWBgYUPNReGKXaMfOdFLIAJc,JFCHDAFBQGDD..SBFFHBBBCBHHBGAAUAAFRDECKGGEhAAAMEDAdABBFAGA.AFFB..hAEA..TDAF.hAGAEFHB...WADF......hABA......hAFA...,2,-44,-34,10
DTGXUAPaMeQcIgENYRHJFZOKLbVdCfBSW,aGFHMIFG..QECB..IEABEGBFRBAHHAEFJGAEFFFEhAAAKEHHLACBdDEHBBCCDDAAhABATGGEUAGBAHABeAGBhAAA..NDIEOFDD...CDCA.SEGFhABA..hAEA...,1,-4,-32,28
SOXHCJDbaYUAZRNfePVQcKEdGTLWIBMFg,ZGFGRAADeAEGQEBB.KCAEdFEFLABEBEDFMHEGFGCEOAFDhAAAXCGGHCDD.CHAFDDIHhAFAbEBH...aFFEAHABNCAEhAAA.....fCDB..hACA......hADA...,1,-12,-32,20
BQfLSVaIJYGMHDXTdFRZgKAcEUCPbOWeN,UGBCCFDG..OBADeHDEBCEAQCGALEBC..aAFAIAAEhACAJEEC.MAEGhADADFIFdACBZDFB.ADCHEGBF.hAIA.PCBA.bEGDNIDFSCCEhAAA......hABA...,1,-18,-36,18
VZbIJSeEUYcNdOPHBGWMLXTfFgRaDKACQ,CFFCVABHZBAE....JAHBEBEG.UFAG....NDEG.OHFAhAAABHGGGDACLFDA.hAAATCGBFGCDRAEFKGGEAFIHIEEHhABA.SAGC.YDAAhADA....hAEA...,2,-40,-27,13
ZVJRUDBfKPIHMCNWdXAaLSFeEYgOGcTQb,aEEDLEGH.eCDAEHACOAFAGEBDQACAZACDRGFA.UGABhAAADCGEBEDEKBAH.IEBAhAAAMAFACHDFdBGASFDDhABA.FCAB.......hABA......hACA...,2,-26,-14,12
NgbLUQWXFVcCfTIeDPHJMZdGEARaBSOYK,BCAHOCCHKGEE....bAFBQFAG.FDFGVFCECAAF.hACAfGFHeHFADEAEHACChADAMBCAZBGBECCGAAIHaABBhAAA.NIEH.LCHB.UFCEWDAD..hADA......hAEA...,1,-12,-21,9
AMgCUPBSYQbRGIfKXLcOJFDWVZaeEdHTN,MBFHUGGGBFEE..QEBFGBDBKAFCLGEG.OADDhAAADACAZDDCeHCGHBABhAAANBHGAABCCGDF...PFABhADA.SBBDYEBBIEHFhABA......hAIA...,1,-14,-35,21
OTHKPSGcCWYIMLebgaNJEVBAQdRFXDZUf,RBCFDDFFUEGGOCCGHEDF.KHCAGEFG.CFBD...IAFAhAAAeADAaBBHEDAFBHCF.AAAC.hACAQBGE.hADAdDFGXAGAfEBA.SBAFhABAWEDBMEIF....hAEA...,1,-9,-37,28
OdBLCHIGcESaKZVXMYJNgTAfeWbPRQFUD,eGEA..bFDFQBCFFBFHUBCEdCAGCHCHHAGB.GFABSGGChAAAKDEAXDBChAAAMIAGJAHBNABF.AAGF...WHEAhAGADIFGBHHB.cFAE...aABGhAEAYEFG..hAIAfDHC.,1,0,-17,17
aYXVFAePHEJKUNbWILdcDQMSRfBGCTZgO,eFBBHDAGJEFHKACGUAFG....NCCF...IFGAdFDAQAGBhAAAMDDE.SBAHhABABCAFCEEBZGEAaFAD.hAAAXDGAAFIB.PACEEECGWAHHDIGA..hABA......hACA...,2,-37,-14,23
gZVQaLEAKSXUcHbDJTBeWdCfOIMYGFNRP,SFAAXCGCUAAFHGDE.DIGABADDeAEHdECA..OACDhAAAIHEEMFEA.FBHHREFCZDDFhABAaDGCAABGKHAG..JHAAhAEACAGB...fGGB.NEBF...hAGA......hAHA...,1,-11,-33,22
TgEFdBAOKWeYCMZfRSNcJXbUIVGDaHLQP,KDCDeGEAMCIFRBBC..SBFA..NEGA.XEDEUGCEGBEGhAAADACALHAGhAAAQGACPEBHEBABBEAChABAAEDG.OFHBCHHHfDGF...hACA......hADA...,2,-24,-19,5
JPdZBUFYNLcMQKTHgSAbReEOaWfIVGXCD,RFDFEGDBODAD..fHAHGAGGDCFFJAAFZGFE.BCDEFEDALFGBhABA.MAFGhACAQABGKBFG.gFBHhAAASDFEADAF.aADF.ICCGhBCACFFB......hBDA...,1,-25,-28,3
RCEdKJBgPVSYUMOWIXNZDaeGTQfbAHFLc,HDEDLCCHCGAFKHCEBHEA...VAFFUADFOBADXECGDIGEGDGEhAAAQGGEAGEA.hABAFBBF.EBHF..JHAChACA............hADA......hAEA...,1,-28,-32,4
PBLKQebfRWGXSaAZgMcdIFYTVUNOJEHDC,ZFACMCCAdGGBFGDC..TBBAUGFA..OBEAEDAGHBFA.DAABBAAEhACAQEDAeDFARDBD.hADA....WAEChABASDDBAFBE..IHBENIABCFAD..hACA......hADA...,1,-24,-29,5
FeENbTdOYZQKHADcUXWgPBCILJRMfaSVG,DAFBUCGC..XABE..PCAECDDFLAGHJABC.MEFChAAASCEFFCAF.EGFDhAAANFDH.dGAB...OFFAhAEAQGGHAHID.gGBEBGDEIAFChAHA....hAIA...,1,-28,-37,9
VDPXFSNZYEeTUMICBOdagAKbQGJfcLHRW,QGBCJFEFLBAAHAEC.RBBADEFFFFCH.ZEFBEDFA..eDDHTBEAhAAAMEAD.CCADBAAFhACAOFADaHFEAAGG..KDAAfBHAhADA..cGGA...hAEA......hAFA...,1,-10,-34,24
KYdacIfMgBQCUAbSJGVLPEOXRDZFeWHNT,JCCHGGDHLBEGEEFDOGBG..RFFEDGAHFDBFHAGFKBAH.dBAD.hAAAIEDGMIFEQFDAhABAAAAESAEEXCGAhACAeBFD...TEAEaDAH...fGBAhADA.CAEB.hAGA...,2,-31,-2,29
OeDBJLdbYTMPAaNVEZcHIUSXWFRCKfGQg,aCFCVDAGZEEB..HGFEUGCG..SCCEFAEAKCBD.QGBGhAAAeBAEBDDDJAGF.dABDhACA.TFDEAIHAEEBF.IDFBhAEAXGGCCHAC...fADEhAAA......hABA...,2,-36,-2,34
VLTZaHCfcAdKgQBOJFPDWXMUSGRbYEeIN,dAFBQGBCJDDC.DADFMFHFUEDF.GGEDRAAC..EBHFeCBBhAAA..IEBGhAAALEADaGCHCBFCAIEE.BBAChABAFGFF.XEGESEHBNDDB.....hACA......hAEA...,2,-32,-16,16
DRNBZLUcHFeVSOAXTgfPIQKCdbYJMGEWa,XCGCTCBC......PDFAQFEFKAAAdGHGbAEFMEEBhAAAEAGA.DIBGBDBDUAGBhACAFGHDeECFSABHhAAAABEHIFAFCEHFJADFaGFBNDDC.......hABA......hBAA...,2,-21,-13,8
KYCJBSUVAbZFePEaWDLGNQdXIgOHMTfRc,ZDAGeCCHEACGDCACLDFHGBGG.dFCD..IADDOCDGTGAGhAAARFECKFCH...CEHGBCBBhABASAAEAGHD.bFADhAFAPHCE..aEEGWAGB...NAIE.hAEA......hAFA...,1,-20,-21,1
SKOPYZJacdIMTNLAbBEQXRfVDUeWCHGgF,EEGDXCCBRBAE.DCFHeECA.HDAHFGHBKAFBOGCAZEFB...JCHHhAAAaHAC..IAHGhABAMCAFLCHBAADC.hACAbABCBHHG.fAFE...hAAA......hACA...,1,-15,-32,17
KHZMfASNQETFRIbCaYdGOPWeLVUgcDJXB,QGBCTFCE.FDGHRFFCCABDdAFA.GBACOADBeDDFLAHDhAAAVFEH.UCAH..DAIBhAAABEEGKCCCMABEAFBAEHEEIAFChACA........hAEA......hBAA...,1,-12,-27,15
SdDIcHMFACUaYVPRTZfGXKBWbgNQEJLeO,CFCFaGFC....VCDBTAACGDGCBEBF.....gCGChAAANBCHEAAF.eGBAhACASGAHdDDHDGAEHADChADAFGCDADADUAGEREFA.fGEE..hAAA......hACA...,2,-30,-11,19
MdYKcBfOVNbTQEPAGgUHCRFZLSXDIJaeW,UAGHCEGHRFEG.LAEBDHDA...aCGDMDIBKHGEBBAG..ODDBhAAA..bEBHECAAhABAAEEFHFEEZFADSAEChACAIBDH..JDAFeCEC....dBBEhAAA......hABA...,1,-22,-34,12
FCVadYXcgTbAQGUSHNZPfeRKIBWEODJLM,GABHHBCFZEFHeGEAKFCGBCBFOAEADGBHMAIF..CFHC.dEFH.XCEChAAATAFFAFAASFCHhABA.NCAE.fCHEhAAA.IABFECCD...hACA......hBAA...,1,-16,-41,25
LVUOIdEBMXJHcfgReSTYZbGQFANDWCaKP,DACBaEGDLBADUGFA.dFBBMDBDHDDD.....fAGDhAAAeCDASCHBhAAAZGFAQBCBAHHECDFAKBADOHAAhABAIHDDBHEFXCGEJAEE..RECA..hABA......hACA...,2,-27,-12,15
MOCVDbYHXaKcPBeUGTgNFSAIJdWZfREQL,dDCDZAADEHACQFFFLFCBOFAGDCGHHAGDKHDEBACGGDEA.TCCEhAAAFAAFAGCE..JHAAREGHMIEChADA.CBED.VAGHhADAXEAF..aAED......hAEA......hAGA...,2,-29,9,38
CXdLcaMbUgIZQTGEOeWSDJNFYKBHPRVfA,CFCFXGGDdBGELADB..MBHFUCABZDBHGFDFOBFFeCHHhAAASAGE.DACGhAAANHADKDEABEDC.PBBGhABA..fABC.AAIDaAFH.hAFA.IGFE.hABA...,1,-26,-27,1
CfSUQGBJYMcbPEDROgNAHaLKTeWFVIZXd,HDEDaEEDLAAETCAHFAAEZGCA..dDDESAHBQAGBBGCChAAAMBCH..PEHDhADADFBD.OGDCgCFEhAEAAFBDKAGFeCCHIGHDCAEC.fBDFhAFA......hAHA...,1,-6,-21,15
RTXZAFJHfNCdYWeIBUEGbMgDKaPOcSQLV,FDBDJFBBHDEHCFGC.dCAHeDFCBEHFGGCF..MBBGDBCG.aGGDOCCGhAAA...SGABhABALGDATAGHhAAAAHIH.NEAA.........hABA......hACA...,2,-42,-30,12
PUGCHYeQJdbSOFIBVAXWaDMZfRLcEgNTK,aGFCDIBGMDFHZDAF.LCAGECFC..TBBDUECAHBFA.eHFChAAAQEFEdFBCODHBhABABCEC.AAEEfHDBhAAAcABB.NAIAKGAFCAHA.....JDDFhABAFAEB.....hACA...,2,-23,-6,17
JPfNWEMaTDeRgUbOIdcVXCGYFLAQBSKHZ,QGAFBEFAKEBEHAACZBEH..JGFC..PAEA..WBAGhAAAaHGE..DGDARDAHUDGEhABAOCGF...IHBGhAAAdEDC...cCDACCDAFHCEAAEC...hABA......hADA.SEHH.,1,-21,-29,8
BOgRKfSdPIQXNAUGCTJbFDEcYHWaeVZML,GFDHTEBE.JAEGFFEA..EABGHBEA.aGECZCFFBAGFOAHDKCHHdBCChAAAQDABAGDB.hABACDEADEID..YHFGhACAeAABMHBELEADfECA.SCCEhADA..hAEA...,2,-19,-14,5
TOBZMDHQbYSeWVdRUALGPNKcCIfEFaXJg,GECFKHBGCCDA.EGBDFCFB..XBFC.JACDOEAG.BCBHhAAAMBIHDFFEQGGGhAAA..SGHDhABA.eAFCdBAAAHFCNEEA.IEAAhABA......hACA...,1,-22,-55,33
gfbSIcYGdHOAJVaNXeCMLRTWDEUQZBPKF,JDCHVDAG....XGFEMDDELGFERBDB.DIBEEACCZGAEBEHFhAAAKACHFAFG..fBHEhABASAADIHAAhACA..YEFCdEFEAIFAeAFDCEEG.hABA......hACA...,1,-24,-31,7
DgKfXQJZEVMCIHGLdSWUePaTANBFOcYRb,FEGDOGEARCBC.DAGCKGCH..QCBHECGH.MHBECAHGGEAGhAAALEEAdFEAUACFeABETCEFhAAABAFD.cFAGhAEA...........hABA......hADA...,2,-35,-16,19
PUbXGgFHNOfQIVYKMeCTSDZJWcREALBda,dDABUGBCGDFCFGDEHACGOGCC..QCFGVACD.KCCDCBFEDGIBhAAAZCAF...JBHD.hAAA.WBHBREAEAHBHBABChAEAaGGG............hAFA......hAGA...,2,-27,-27,0
AQfSMDdBWZgKNCVEcJGIUYbTHFReLOXPa,SGFCdCBDZEBCKHEE.CCBA...EADBGBEHUAAF.TDEHHGAGFDGGhABAREAGeHFALAFA.hAAAOFGFXEGEAFFE.hAEAMBCCBDEENACF.........hABA......hAHA.JHBE.,1,-11,-15,4
dSEcTICJGAXbaUMeQHgWKYLRBOfZNFDVP,aGFCMAEHHDAFKHACLFEBOEEE..ZACFDCADdHAB.EAEA..IBFBhAAACBAFAIDG.XDDChABAUECCQAGEhAAA..YDHFBDHA.....hABA......hAEA...,1,-12,-41,29
FHAJBCLQdRfOegWNcaDMbPYVZSUGEKIXT,JFCABEFALCHHQFAB.RFGB.eBFH..NIAH.DCAF.MAAEhAEA..bBACVBCDZDDFSEBEhAAA.hAFAUBFAEHGGIHBG.FHDCAIFACAHBfFFDhAGAWBBEaEHF...hABA...,2,-21,-21,0
GTadWBUbLAKMJgPEfSZcRVXeHNYQCODIF,JECCEHBGZDBD..RGAC.eDFFHGEA.QDGBCGHDDBAFGAGCdACGBBEFhAAALEDFAAFAKEADMAFBhAAA....fBGEhABASEAF.cBCANDBB...YHFAhABA...hAEA...,2,-29,-13,16
IZUORASKWGQVNPECdTgcYLabFXHBfeMJD,SAFBGEAHQAAB..VDEFPCCACDBFdBBF..gGDGhABALHBEbDGFhAAAXAGCBGHHMIFEhABAIGHGUEADAHADNEGAEAHBYCHFaDDB.fDAFhADA...hACA...,2,-15,-2,13
TRUfdBESFgZYcQbXWAKOPHeJGLMICVaND,OCCHHFDFeCACGBFGMFFCCBAE...NEAF.DFHD.REAB.dGAHBAHBSDFChAAAFADGZDDF.QAFFhABA.XACAhACAAICEKDHB..........hADA......hAGA...,2,-39,-16,23
YIfJZHLcGVMKBeDCUPdOXbFSEagARWNQT,RAADQCBC..IFAGZGAGLHFAVFFF.MFDABCEAeDEChAAACGCD.UADCdGDEOBHHhAAAXBGE.FFGEaEAAhACA.ACDC.WCAD..YADEfAGFhABA..cDEDDEGE.hACA...,2,-29,-11,18
cMJKVQDABdGRfgEaWeUXPZSFbLOYICNHT,BFFCdGFHRBCG.EAGAeFAEUCECZGBG..FBACLDFC.ODAChAAACHEAHDAEMADGJDHHKADDDIGG.hABA.AACFGEEF.hAAAaAGDPGAE.SGGB..hABA......hACA...,2,-36,-7,29
aIYfUWFBAVHSOMJZbdXNGTKLgeQCDEcRP,HDDFMEGFZDCHdBEFXAACGGAFLBCG.eAGDDCFDRFAAaBADIGGChABA..fEBAhAAAFHDCAEACOAHHhACANAICKEEBCDBB...EFHB.YABCWFHBSADFhAFA...hAFA...,2,-15,-11,4
CQAWTJIeRaKOZbdMgNPSLBXEYUFGVfDcH,TDACJEEG..eAFEaCAG.KADGZEEG.MDFC....gCDFhAAASFAABCAEhABAYAACFGGEGGBFhACADIEGCCDBABHG...IHCBOCBDdCGFPGEChAEA.XAFF.hADA...,1,-14,-29,15
NBUOFAdePLCbaVZMKfgJEYRSXGcTWDQIH,eCCHLAFBCFDG.VCAGKABH....JCGFEGHF.RFCG.GADF.hAAA.TACFQGABhAAAICHGBGGH.FDABhABAABACbEFBMIDG.fEFGYHAA...hABA......hACA...,2,-25,-23,2
EDIZMaBRAcKLNFSHCPWYgVObXTGdUQefJ,LCCHFAFBHDDGCHED..PFDD..gEAGOFABTFFFhAAAdABAeHAE.EFHFDIFChABAMDAEBEBC.ACHAcACAhAEASGDC..WFHBbAGH...XGBDhAFA...hAAA...,2,-21,-21,0
gRGeUMQFOCLHbTVPdWKNZXcIDfYESBAJa,aDCDREBHGACH.MFGFQGDH.OAFCCAHAHCDG.bAAFTABChAAA.dDADKDGAZEFChABA...ICGHhADAfFHASHGAACIH.eFADLHAAhADA.WEED..hAFA...,1,-8,-20,12
LAJBQcGFbNMdIHCDOfYTKSWEXUVZgRPae,BFFEQFGHFGCF.MDCGdDBDHACA.OEFATEEG.KBFBEFDGhAAAUFABZAFF.RBAFaECFABHC.hABA.JFHB..cABAhAAA...NBIGCHHD.DGEBSCAFhACA..WHAA..hADA...,2,-27,-20,7
ASWTcbRMLVEeOFIZCYGUdaHKDfBJXNgQP,TGBCRAADMEBD..LCGBECFC..eDAFFGHDCACDUBCG.aECCDCDGhAAABEHA..JFDHNGED.hAAAQDDAABAH.hABASAFEWHEE.......hACA......hADA...,1,-31,-33,2
fMLGDUQbBWHPgJOTKceaSAFERYZCNIXVd,FEHBECFCRFAFZFAD..CGGE...XBCEdACGMBEEGGDH.QAAChACABECGHDDDJAHFKGFDhAAA.aCHDSDFChADA.ADBG.NAEHIBACfAFADFFC..hABA......hBDA...,1,-19,-28,9
IbaNAgfSJYUGORMKETdPcVZHWQDFeBCXL,SHBGJDACGECD.MEECKABG...TBCCdHCH..VAFFZDAFQGFFhAAAFFAH.hAAACAHDXGCEIHHAaDHHhABAAHIDfCFB......hABA.OFFG..hACA.EAEE.,1,-19,-31,12
RKFaCGWcHYNTObQZESDPfABMJUeIVgdXL,JHAGUDAC.eCGB..IBDEdAHCRFEDFABDGBEE.HAAFTDCFhAAAQDGA.hABASGFGDDIHAAECVGBGhADAXAGAKHGA.aEAHCGAC......hAAA......hACA...,2,-25,-19,6
NITLgQSXAedDRfPFMVOBbUJYEcCWZGHaK,DFDCRAADFEFGMBEBBGHC..UABG..EGCCCGCDZEGDGBED.HACEhAAAaBFA.KFAG..TDBEhAAALHBA.SEAChACAAIGGdGAA..fGEA..hAEA......hAFA...,2,-42,-21,21
GAEKbDTCgfVIJBUYQFPeLNRcOHZWMdSaX,EAFBKHFGDCFC..TGGBCGFC...VDFABEHH.UDDGQDAAhAAAFACD.eHAERBADHFBDhAAAMCCA.SBBChABAaAEC.ADDHfEDAIHAE...hABA......hACA...,1,-8,-46,38
LfSVTbYecDFZBQRGCOEPAUMJNgdWKIHXa,MAEHJGEA.dAGHKAFEHBBFLEFA..VDEG..TADAhAAAeHAAFGGFZBBFBDGA.hAAARBFACCABPFAA.AIEANDIEhABA....WFDFaCAH.....SDADhABA..hACA...,1,-10,-40,30
EIcfNMZQWJbdCKXYPOSVUFLRTBgHDGeAa,aAFBEHBG....IAFE..NCDGZBDFQEFBJHDA.CFDCKBAGhAAAXCAH.OAGDhAAAUDAGLGEAhABABGBEHEFCDGIH.eCEGAIBGMAIB.dBAB.SGGGhABAFAHF..hACA...,2,-23,-16,7
BZGfIXcFRWMTdDEaLeHbNQSgAUOJVYCKP,UFCAVFBG.CACG.BAADGAGC....fDBFXCDBFFGFhAAAMBIF..dEAGaHEAeDAEhABAHADE.QEFAhABAAIEE.OCAB.KGAD.IDEFhACAWFHHDFFF....hADA...,2,-36,-9,27
SQYBaIVNMAEOfDPLGXebZJRWgHTUCcKdF,OCCHDACBLBAFGAEGeCGB.ZGBAJAHFRGFE.HGAE.CCABdEGGFECH.hAAAQGDCaCDD.hABA.IAFCMABCfHFFhAAA........hAGA......hAIA...,1,-18,-31,13
EVXUYLPabGgASJZWcQTMKeIRfdFNBDOCH,SDBDJFBBZDCF.QAACMEAB.KGAGeBDBRAGB.FBABBADFhACADCIF.OFHDHFGBEEFBhAAAUEDC.LCCAhAFA..bBFBAHEEWFFHIHDF..NIAB..hABA......hACA...,1,-13,-25,12
LSJVBKbUCeRHPcgFMQNGfWZTAYDIEdXOa,DACBEAFBdBBEODEDLBHF..JBGFKEGDUDBG...CAAB.HEAChAAA.PHACFGHFMFABhADAQEDG.hAEAfHGB.WADBAICAXGEEhAFAaGDE.SDHHhAGABCAC...,2,-50,-6,44
aGHYECZgSKcXNfePJMRULVTQOBIbDFAdW,dAFBGEAHEFGHZDDEKFFG....XGCAeBAFJEBFUAEBLCCEhAAAQCDBBDHGDIGGAFHAHAAChAAA.CHHH.SFFFhABAfBHAMIAE.......hABA......hADA...,2,-22,-22,0
JeIUXdCTfMLHWcaVPAbGQOZFSRgKBYNDE,QAGHODCHFBCA.SFDCKDGF.BDHCDDEFeFFBUCBFdCEChAAACBAB.MFHHLHBChAAAHFAHaGECACAFZAFA..YACEhABAEFHF..JEAB......hABA......hACA...,1,-9,-30,21
VCTgeJSbOaHULFIDfBKYERQZWXAGNMcPd,MEAEdHBHCAFE...eFBGSGFFOCDCHAAFUDDD.FGFA.DICGKDAEhAAA.RCGDZABAAFHC..NADH.hAAA....cEAEhACAPBHH..........hACA......hAIA...,1,-30,-38,8
KRJSaQDLMfcGYHIgBZbXUCTNEedFPVWAO,ODCHKDBDRDEA...SFDAaCCGLAHDMBEDGGABHGFGIBCBhAAABAAFZAEDXFGDhACACCAAEBFA..FHCC.hADAPFAHAAEFDEIH.........hBBA......hBCA...,1,-17,-25,8
YfaZEQSPCXOGDVcJUNeIMWdTbKFARBgLH,BFDDLFBBHAFAaGDAZEFH.SACACABC.GCABDBCEJBEBUFAChAAAeAGDMFFD.dEHChABATDFCKHCAAHIB...hACAgDACECGA.QGGC.hADAODHD...hAFA...,1,-6,-23,17
BEJdfCceGNOLaTgIPDWAUXbFHQMSKZYVR,UCGCFGFCMCGBKFADZAAC..RAGBBCAFdAEF..CDAA.GBBCLCEBhABA..aEDH..IHBAhACADGAEABEE.HFGFhADASHGAEDDF.JDHBfGDH.hAAANCCE......hABA...,1,-19,-39,20
EJQZMbfGBdSRDaOFYKHPXCVeWTNUIgAcL,EDCDQAEGZEGB.MIFAGBBHBCGGSGDBRFEA.OHAEhAAAFACFHBAHCBHC.eDDHhAAANAEB.IHCGAGIH.hABAcEBBJDABdEEBDGAFKFFD......hACA......hADA...,2,-17,-12,5
FWcfECXHeRILgdBZOaKSTMQGDVUPYJbAN,FHBG..fHBHXDEHRACFLDAA.BGADZBAHKGEFTBAEhAAAQFGDDCGDVFEEhABAPAFE.JFAAAFDCcCDFhACA.CEHFeAFG.IFBFhADA......hAEA...,2,-26,-20,6
ZAFMQPfUTHCcLVORKXbgSEIeBadGYWNJD,MAEDQCBCUAABHDAALFEG.OAHBKGGD..XDGBhABAgFACEGBGIAFBhADABCADaAEHdDEH.YHEChAAAWFEF.DCIHAAHF.FABE.fGCAhABACBHA.....hAIA...,2,-29,-2,27
JXIecLfdVPCOQEZASbYHBaRNUFGWMKTgD,SHBGHAADaFEERAFE.FHEAGACE.KFADDECA.JBADeDFCLAFAhAAAdEHECEBA.EEGEAIHEBGCBhAAA..NFCF.MHFEXBEChABA...ICCC.cGGAhACAPHAC....hACA...,2,-26,-13,13
NAEDRfCSgBTJaYbMeZPOHQVdIFLGXKWUc,DEFECFDDBEFE..aGHDMIFAZFCBHAGF.dDBCFDAFGABFKAGGUBCHhAAAAFFG..EFGCRCGB...hABASCACJFBB.hACAeFAB..........hAAA......hABA...,1,-20,-50,30
BfaLCAFRcWOTeEIQJKUMPDXgbZdHSVYNG,FCFCRAADOAEGeGEA..QDBAKGHF.MCBCDAID..XCEEhAAAZEFESAGB.hACANCAG.fHEBhADALAAAAHHETEBEJFBF........hBCA......hBDA...,1,-12,-43,31
PMdbcEFQWDgBTAKfUCHROGLNeVXaIZYJS,UGBCHCDHOFBELBECeFHH..aFGAIBCDZAAC.SHEAhAAAPCAD.bAFCFHGEhABADDADBGED.KEDACEBD.hABARCEE............hACA......hADA...,2,-26,-25,1
ASLJCXZUaRfMHBGQYbEPKWceTVdIDFNOg,LFFBCFFEUBGH.aDDDRDAG.HCGHGEDE..QFACEAAC.hAAAKAEDeBCCTCAFIHGFhADADGEDFABA..gGAEhAEAAHIHSCCB.XAGEfCDFhAFABGCHPDHB.hAAA...,2,-15,-12,3
McREePbYfBTdDWNLQUJOFaKgZIAGCVHXS,GCCFVCDH.SEFBMIAE.EABBeAFC..bGAEBBDFdAEBDAAFhACALDHBQDAChADAOABBFHEGaGCGKBGG.hAAAZFGBADAFCHFF.HEAA.......hAHA......hAIA...,1,0,-18,18
NXSTUgcCbYJEefPRLDFAIHOGZBKdQaWMV,HFDFOEGHBDECKDDC.dFFH.aAGBMCAG..XEACSGDGhAAAUADHCHCD...JAAH.hABAEDFCPAGF.DDAGhACAIBHGGEACWHEANDIE...cAEBhADAeECH.....hABA...,1,-21,-25,4
OKJeLPgUGIMRaNSDAWEcFTXHCVYZfdBQb,EHBGTGBCHAFB.CCDBZFEBBACA.OBEGKCBALABCUDGCGGEBhAAAMAID.aEDEDIGE.AEFGFGGAhAAAVCCG.dEAG..bFAEhAFA............hAHA......hBAA...,2,-17,-17,0
OIfPDgEGBTZdKaAWcCSYUXRJMVLQbFHNe,CFDGUGBCRAFA.MFCELDEC.FDBDHBDE.OEHF.IAHEhAAADACCGEFABEAE.hAAAdGFFACBASGAChABAJABH...........hACA......hADA...,2,-42,-33,9
HgRZADKVUOeQGXdcFMEBaYTPLfNJWbISC,KEAEUBDGQEGCdGHAFBBC.BBDD..TGCALFAG.NHCH.hAAAJEAG....IBHDhABACAGEHDFE.ZCAAAHFGDGBDhAAAeCFG...cABB.EFECaEEHfHADhAEASBAD.hAFA...,1,-26,-34,8
APTaDIgBJGCZcMRXELOKSYVUfdHNeWbQF,aGFCDACBBHAGGECCZCFHRACD.LECE..SEEGUFBDHBABhAAAeBBD.QBFAhAAAAHIB.IGAEhABAgAGBCAEAMCAHEHDC.YCHBfAEChABA.dGGE....hADA...,1,-3,-29,26
abTDVIBfgEHRZOPFScJWNXYLeQdGKMCAU,aGFCTAFB..DBDEBEGGEEAF.HBCAZCEDFDCDSHEE.JEBGhAAANEIE.LHAA.hAAAeBHHQBAAhABAKABFMCADCGBFAICE..........hACA......hADA...,2,-39,-14,25
YCFMVIBbANEDdKZReQTOHWJLPGUXgaSfc,EHFGKGCDeCEG..OBDFHAADLEAHUDABaAGE.SEFAhAAA.fAGBhACAcDGDFFECMCCDBHCHAGGGdDDGhADARFADQAAC......hACA......hADA...,2,-26,-9,17
gOZYfKBLDNUeaJEcPIAHXMSQVRTWGCbFd,HFEEMBDH.QEBHRGDEGEAE.CAHDdBBEZFGFKAFDBHDH.DBEGUAACaCHF.hAAAEDGE....IDEChABAAHCDSEFDhADA..WACBFAHF........hAEA......hAFA.YCGF.,2,-22,-19,3
gCEABKJOTaWcPQUHfLYMXbSNGZFDdVReI,JCAFTAAD..aDGC....PFFCUDDFHFGBLDFAMBBAhAAAXAEF.NBEAFGCChAAADHACdFADRAGF.eHCChABACDBFBHHGOCCA..cDBD...hACA......hADA...,2,-28,-10,18
WBLDUIAMYKVbCcHfQGEPegaOFJNRXSTZd,MHFGKCFCCEEG.HCCCGBCG..EAFFeEBDaACDODGFFABG.JHBEXGGGhAAAZEAA.BHDGhAEADIEAAHAG..VDGFfAABhACA.gAGHSAFCdFEF.hAIA......hBAA...,1,-4,-30,26
OURTHPBNaeEFIMYDZbKcWLXJQSdfVACgG,CECDOFEFRDGB.HAFEBAHEeBBBFCDH...IDFEDFFDZAAH.KDHHLACEhAGAQACA.hBAAfFAGAIEAUGBB.hBDANIAF.EBEBMBAD......cGGEhBGAXGGA.SFCFhAAA,2,-45,-3,42
XUAMWZFKCDRLNcITJOQefBVHbSdPagEGY,MECGZDAGFAGDKAHBRFFH.LGEE..IACGJBCG..OBBHhAAAeCCEBHDHHCFHdFAAhABAaGAA.EFCA..XDFAhAAAADIHCHCCDAEG...NCIA.......hABA......hAEA...,1,-21,-38,17
BKYLUcgFEPQSfAXZMRaIJGdCHOVDWTbeN,XFCARFBG..aDBEGAAGCAAGHBDEDCFA..TGGGeAFEKGFDhAAALFEBUDFBgDCChACAFAGGECAHQDFEhABAACIBMDAF.IACCOFBH.WFADBGGE..hADA......hAEA...,2,-15,-2,13
KabZgECHDRfVAQNJFXdSBOMTeWYULPGIc,QDACFDCDdACBBDHFMABC..eFDCUGEGLBFHGCCHIFCHhAAAKAGEZAAF.CHBBDBGGhAFARFGDAIFG...JDHBSHCChAFAOBCG.........hAGA......hAHA...,1,-22,-32,10
PIHgabEeCNRVOUQDZWASfMGTKdBcFXYLJ,SGFHGBGAdFBGFBCFLCHB.JDDBHBED.aGHHeEBBCFFBREDB.hAAAUCABDDAA.AABCTGDHhAAABBAA...XAFBhADA...PBCA....hAEA......hAIA...,1,-23,-31,8
AgbLBKOcdReXJNPaVZSTWUEGQHYFCIMDf,LGEAOCAFdGCFXDBC..PDHBVACA.ZDCE..SDDEhAAAUACHGAFEhAAAHAFBCGFDMAIFAHACBABFKHAAhABAeFFC.NIEHWFAG.EHBA....hAFA......hAHA...,1,-14,-20,6
NDKUVCQTegIfRHLaXBYOdcJEGFZMAbWSP,SHBGDACBKCEE.CDCD.eFHF..IHEFHFBDaEEE.BAAFhADAdFGFJEDDEDBF.ZBFFADHB..hAAA...PEABhABANBDEVGDEQACE.fCAGhACALAEGOBHFFHGA..hAFA...,1,-15,-21,6
KLfECBMDaOHWUFbYSITXRgNcGQAPdeJVZ,eCCHJDACZAFALBFE.CEHGBGCAMFGBDDIBHABA.FFEB..SCFBhAAATFAFXGGChAAA..gFDEhABANAED.cGAHADIF...dACDKDAChABAaDDA...WDHDhADA...,1,-11,-49,38
QCKeXVEHfRGDLcNTJMaAUdSPYBgIFObWZ,dFHASHBGBHCFFDBHOEFHZBAG..KDFDXFCA.HAAGhAAARAGDDDEHLDDC.hAAAcAFHJGDA.AFIFPDABhABA..IGAE....hABA......hACA...,2,-53,-11,42
gUeKZNdEDXYQICMOWHRaSfLPbcTGVBJFA,UDACeDCHKAAFZGAAdGGGDADD...QDFHMIDGHAGDRFCE...aGFGhABASBCGLEEEPEAHhACATAEFBDDAhAAAAFFAEBEE...XBGACHHHfCBE..hAEA......hAFA...,2,-18,-17,1
QVfbSEePZLCKROXdgHaJNYAMDTUFBWGcI,TGEDUGAFFCAG.BEFFGECC.QABA.VBGDbAEF.hAAAEAFC.ZEABCECHOEDDhABAXDDFHBGBaAEBNAAGMIFEhACADGIB...IGHE.eDBCKFFC.hABA......hAIA...,1,5,-25,30
ZNQSMJPcHaCfdGYBAVTeKXWUObEIFDLgR,TBDGKAADUGDF..ECBGFADFLBADZAFA.QCGEMEEG.hABAJEFBHCACCHAH.dCFFBGHHhAAAAAGE.eAFCXFFBhACAOFDDDGIDRFAE.........hABA......hACA...,1,-10,-28,18
QJEGgZFYMWPVBSXRANDCbafdIOcULKHeT,DAEDaEGD.dEDE..OFCDUAADHCFA.eFGHTBEF.EAFEZFABhABAFFEBMDAF..WBBFhAAABHEH.SAHFhADAAIACNCIC.CEHBIDBGcCCH..KACC.hAFA......hAGA...,1,-25,-27,2
OVMdHBfCQIXEYNDWZgASTbcKGRPFUeJLa,TGBCKHBGRBDH..UEGGLFBC.VBBDHFBCBAGCCDBH.QDEAhAAAEBADDFFB.ZBEAAHIH.hAAASFHH.hABAcGEEPAHD.eAFBaADAMBAF..hABA......hACA...,1,-12,-31,19
BUXCWIHSMbfdARQJNEPFVLOYTDGZegKca,QBDGEDCD.FEGEOBFADGCB.GDAAeAGBKGHB.BHGDhAAACFEAIACGHFEHSBBDhABAfEHEAIAEREAFNIDFLAEDhAAA........hABA.ZEFFaEEG.WAHBhACAdCGD...,2,-25,-8,17
QBWHKFJOZVRGPcfDISaAeMbCgUETLXNdY,MDEBCFDGUBDHLCCD.dHAFBHFDKDABFABEJHAC..ZBGFRGFAGAFEhAAA....fGHEhAAADFGGIDHChABAADAG..eDED.EFAE.....NABH.hAGA......hAHA...,1,-24,-47,23
FbGJRIaHXWPMOSBVNcAYDKZETLUgefCdQ,DGHHKEHBECHHUDGG..eAFBdDEGFFCCGAAF.RCDFHGFA.XGAGhAAAMAFEBACA..hAAAVDAFAHBFZBAA.LBEEhABAfHCHCEAC..QGEE.hABA......hADA...,2,-35,-6,29
dcMZOVEPXQGUaFTfKJNeBWDYIgRASbCLH,CFEDLDCHdCHAZCDG.OEEH..EGBEXAACGABGFGHF.KHFGhAAAeBED.BHGADAGE.hABAIHADABFD.HAFBhABAMFAEPDAH.aDHFfADEhAEA.WHBA...hACA...,2,-29,-25,4
IWOKTMYGJQPaSNFAdcBgUeCHbEVfXZRDL,BFEDUDACHFDDEBFG...VAEGXBDCDACCLHFGOEAAKBAChAAAMDIDGDGC.QFADhABAPHAAaDFENIEFADFEhACAdAAE...cDDGCADB.....hAFA......hAGA...,2,-22,-9,13
XeUFWYKAPIMJOVEQDdfgRaCLSNcBGZbHT,MCCAVFBG.DFGB..dBHERGAALEEE..cFGAZAFDTDAGhAAAUAEEFCBH.KABCAHHH.hABA.JACAEFEE...hAFA............hAIA......hBAA...,1,-34,-36,2
IJEVfgZdKYbDUScBHLXGTaNCFMeORAPQW,QCBCJGEA.EBFCVAFAZFFB..dHAHKCAADEAFUDGEBAAFLEAEhAAAGECC..TACChACACCCE.FEEGOABChABAAFBF..PFHD..IEEGYBHBhAEASFAA.hAFA...,1,-10,-38,28
BPIQfLEMVDTgAdOWFJKCNUaGSZeYXcbRH,OCCHJCCH.KCGDCBGH..UFEFGEGC.SFBDeAAH..hAAAXEACRACDBEEEIAEDhABALHAEEBDCMICGhACADIGAAIAGFFDC.aAHF..cDGF..hAAA......hACA...,1,-17,-43,26
CIJTBgZSEebXHKWYaNcAVfQRLDMPFdGUO,QFDHLAGHMDCGFCCHGAFGUFAG.CFAE.JBCGBAAF.SGHFhACAEGGF.eCHHhADA.HADDYAAFhABAaHAGAFFE.fEEBDCBD.PFCC.IEHEhACA...hAFA...,1,-16,-24,8
gSLWAdVHBeENGcYODUTbRFaJXMZCQPIfK,VBCFHFEEBCHH.eDCFGEAGOHBCUGEDRBAA.JAEEZDFA.CBFA.QCFHhAAA..hABAIFAHfFGBhACAKAEF............hADA.LFCBABHGdABBEGHFhAAANAIEDBBF.,2,-19,-15,4
EGXRNgJBMbdPIWTKDOcCfVaUYFQZLSAeH,eDCHEBBDRECD...JAFEBHEBdEGF...IAHAKBEFDBID..ODBBhAAACGGH..aBDFFABHZEAHhAAAAADH..GGDHXCEDhABAMCAFbCGF...WADEfFDFhACA......hAEA...,2,-33,-23,10
PdFOWcDfHJETAaYBKLRSgVbGIQeXNCZMU,BFEDKDBDRFCD.SDFD..gBBDVAFG.GCFGhAAAeCAHCCCGMAHH.dAEDFEHHhAAAOHFADBAGHFAH.hABA............hACA......hADA...,2,-34,-29,5
NQTbRISOVdDaEHZgYBAXcLWKMGFfCJUPe,XDACLGEAKAFEGBCGFEFE...CBFGUGBEeFBFQCBGhAAA.RADF.SEEBhAAA.OGDChABADFDHEDEFgAGEAIHEWBFAMCAHfABFhAEA..NDIE....hAFA...,2,-31,-15,16
JTUDIfcHANeGQLgBVFZPaOWXYKbSRdECM,GECFQDACLEABBCHAFCDGaADF.OHAGXBCD.KGGCSGGDhAAARGDA.dABDhACAEBAEMEHHUAGEIEFAhAEAfDGB.AHIFNAFEgAGA.hAAAPFBC...hABA...,1,-11,-18,7
YfRVCdIebGKcHaMOPXJSTAWLgUDBEFNQZ,LGEAUAFBDGHFBGACFCGEZBAC.RAEF.dDEA..eEBAKBCG.HGAA.hAAA.MHDCPEFA.hABASDAFAEGEEEBE.hACANAAF............hADA......hAEA...,1,-10,-56,46
BVEOgADFPQJZeMdWXcaCTfRGYHNLbKUSI,DGHHQGBCZCEFdHCF...XBEEaEDF.CFACRDCAHCAH.LAEChAAAKAHBSGFAhAAABCGFECCEOABEAACD.FEFDhABA.eCAC.MEIHTDGE.fFBFhABANIDF....hADA...,2,-30,-6,24
AUOLdFQaZRKgJGSNBfYXDVCeHbcPWEMTI,UFCAdAABaGAARCEC..KGGGGDBF.BEHA..fAHChAAADCFCCHHFHGDA....cBCEhABAEDGHIBDAhADA.AAEE.LEABFBBH......hACA......hADA.gEGC.,2,-33,-24,9
KLRgITSFdeNcZCYVDUGJHOAMfWXQaEbBP,MCCAXCBC..QBAEaEDG.BGBCKAFBRGFETGGEFHBGdADChAAAeFEDZBGB.CFGFDDDF.hABAJCHHAACDfFDHhAFA.EEHFLHAG.SAGFhAAA.cEAG.hAHA...,1,-18,-23,5
dXYBRHDebGQPUWVfLMCONJZAgTKIFEacS,KGFCFAFBEHAC..SHCAdCCHBEAHDHGGeDAH.GBAHUEGA.VFBAhAAALABG.MDFAhAAANFEFAIGA....TAEEhABAIEEH.aGCDYBHH.HCEChACA.....hACA...,1,-4,-40,36
JHDeBfSgcXaFZEMVGYbQWLRdTKNAOCPIU,OAFBCFDGUBDH.DBEFBHED..SFFE..gAAChAAAXGGGZEAEEEAHGDEBhADAQBBB.LAHFhAAAdGHEKHBE.AIBGIDAAeAHFaEBD...hAEA......hAFA...,2,-26,-25,1
FfAebIdYJUVSgNPcLZOEWRCXMKaGBQDHT,eGEAdHBHUABC..SGAD..NFCFLBEBZBAFOADChAAAEFGCCEDCKCDEBHEFDBHHFDGGhAAAAEIF.....IFAHhAEA.....JDBGPCFDhABA......hACA...,2,-42,-34,8
fDcHgOPWGQJIZKATLeBFCNUVaYSREbdXM,TFCALEGH.BBBGCDCA.UGAF..aEAHSADCRBDBdCHCMBFGhAAADIEEHFFG.OACGhABAGDEE.IDDFhAAAAAHC...........hAGA......hBAA...,1,-25,-41,16
SGJYXfLKCOZVbaIQURcTHWENDedPBgMFA,SHAEJFEF..XDCGKGGHCBGDZAAC..aAFBUGDC.RDFAHEBAhABAEAABDDIH.eFFEhABA.BHCAFCDEACAFfHAFhACALAFC.OADB.IDFDhAEAcDAB.NAHA.....hAIA...,1,-16,-35,19
LZKgCNPfGXecRaSTWJFVBbHEYUAdDQIOM,QCBFMDEBZABBKBGECADE......NEEAGBEFeHDARFAETFGEhAAAFHBABFGB..EHAGUGGDhAAAABAE.DDFBLCFGhABAfFBBaADDWAFC......hBDA......hCAA...,2,-28,-19,9
PYCADFRdaTGBLNcVIZUSHWeEfQgMKObXJ,FEAERFEEdCFEGDDGLEBC..VGFEUBCFHABGEHEE.QAGDhAAA.KGABOAAFhAAAJDHFCHCE.DAIDBBADIAFDhACA..SAEBeHBEMEAB.XDGDhADAACCF....hAEA...,1,-8,-21,13
gdaWGfFJceQRYXNCIZKPMHDESULTAbVOB,VFDFOAFB.dHBHGEAAFAAC...eBBDQCCCRAEG.XGFFhACACGHFIACCKCGCMEABhADAECCE..LCFAhAAAbDFABBDBaGFD.JEEANEEA......hABA......hAEA...,1,-11,-17,6
gZURbeWKFTCScDfBOPGMQaIJAYdNHLEXV,dHBHHFDFEAHDXFBGZCBB.UCDBeDEAFAFECFDB.DGIDBACG.OEHFhAAAGAAC.aFFGJHEEAAAF.hACALAEB..hABA............hADA......hAGA...,2,-30,-25,5
QNTgDEbZOAFULaWIcSeCYfKVdGXHRMJBP,FGDDUGGDLDGD..IBGASAAFeEFECFHB.KBAGVCAGhACAGCBF.RFBEMIBChAAABFBCQAFDhADA..TADDDFFBEDEFODAHWBBE...hAEA......hAFA.fHAF.,2,-18,-18,0
PeOfSHMbBWQXADUFKdTaYGVCNZEJIRgLc,FDABdFAAaFGHGECE.CFHF.EBBH..RABHLCEHeHDGOCFAHBGDMAAEhAEABGHA.QFAAhAAADECEKEGC..YCDAhAFANIEF...IAGG...hABA......hADA...,1,-18,-23,5
EHMDRgZAbWKfTdQYaFLPBeCJVSUNGcXIO,KHBGdGFCQDCHFEGDBBHH.eHAE.CFCH.JCEBUBADGABA..hAAAIFABEAEG.DGHBhAAARGDCADAH....fAEFhABA.YEHHaGAB...hABA......hADA...,2,-44,-24,20
cGdbHTQWCBOMeSZNfXDgYaPEAJKLFRVIU,KGDBLDCHFGAC.VGFAUCBG.GAEAHBDDQAFABHHA.hAAAMAABSGFBhABAZCABfFEFDBBA.aHBChABAAEEBRDGHIDHC.......hACA......hADA...,2,-40,1,41
EXFIVfBdOTbMcRNaWULAJQHSKDZCgeYGP,QAEGHFEEDCDHCACG.eDDBGBFG.EDHHXBAA.VEBFhAAAfAAGdGHC.bFAChABAMBIH.RGDA.WBEFhADAAFFESHAG..KGHBYAGBhABAIHCEBDAF...hAEA...,1,0,-24,24
acIOSeYTJHAbPZCgVUBXWNfELKMdFGDRQ,ZAADVDBHBHFD...XCBH..WDHBEEABLCFFhAAAKACGMBGF.dHCHGEDEhAAADAGEaCGEOHFA.SAHFhABA.YCCCTFGFAIHGCCAD..hADA......hAEA...,2,-32,-23,9
JYBLUaGFWHdIKCgDNAMeZVXQfSPRObEcT,eGACVBCD.QCBF..SAECPABC.bEFHEBFAJHAChAAABFFHLBAFaHDAFEDEhAAA.dCHACFBGDDGEAIGA.XAGDhABAODEA.cFDB.....hABA......hAEA...,2,-17,-17,0
dLNBQAOSfTFKXDGbEZCPJWHaUcVgMeYRI,SDCDFGFCKCFBGBAGEFEA.ZFAE..JAEGHAEAUABF....hAAAgABBMIACeGEAhACAIHCHLDECBECChAAAAGCEOBFETEGCbEADWDDB....hADA......hAEA...,1,-12,-20,8
dERWQgJUGNBIeaHcCSKLTfDbXPMOVZYAF,EDABQFDHUBDDBAHHaACA..HCBB.CAAFKBHBLEFA.DHCChAAAXDFBMGEGZAFFAGBGFEHDhAFAdACF....gBAEhABAJAFE.IEDDSBBCfHABhAHA.OHEChCHA..,1,-16,-28,12
CdNUDEJPgMcZbLOfaXKAHeGVWFBTRQSYI,HFBHeEGHGECBFHEGRACH.SAAFCFGD.UGDBDBFFEEDB.JAHDhAAAgAGD.hABAZFAFODHFfBEEhACAaGAHKEAEAGIHBCDD.......hACA......hAEA...,2,-30,-9,21
WbBRYPMDEQIZNGFTCcLUKAHfOdVSeaJXg,HFDFdDCDSFCDJEAA..XBDF..gFDBhAAABDGFPABHEAGHIGGDhABAZFFAFAGBCDEA.LACEhAGAAFAF..OHFCeBEBaDGBWCHH...hAIA......hBAA...,1,-21,-24,3
ELNgWRPdZaDMbeAfBUSIOVJQGKHXFYcTC,UGGGOCCHQEBBHEFDFADE...TGDHEHAALGAC.hAAANIEB.WAED.dCHGDDIDhAAAMDAHAHECBDFF.IABAhADAVABFKEFD........hABA......hADA...,2,-23,-23,0
XaMCKLDPIZdTAHUeJgOfNRFQYWcSEGbBV,UBDGeEEGOEAARGFE.FBHFQEFD....WCAChAAAECGAbGBABGBB.XGEChABAaCACCAHH..LEAChAAADGIDIBFFdABEAFCH.......hADA......hAEA...,1,-18,-40,22
KcCaHLQGTOXUVBFWAgYNEfbeJMIdRDSZP,...NDDG.EEHB..eBFGIAGFRABH.SFFBKGFHCFEF.LCBHhAAATCEHOEBHhAAAUGCHBABH.ADIDfBEChABAMFIHDFAF.PDDBaFGF....hADA......hAEA...,2,-33,-29,4
KOFcPWEQUVXeaNBSdGAfbZCJRDMgHITLY,ZAADCEFADAEFMEIB.HBGBLGDCKCDE.OBCBFGAF....PHFChAAAEAHFQFAFhAAA..XFEFhADAeDDABHGAdAEFAAIHJEHFIGCA.TDBFhAHAYBAF...hBAA...,1,-21,-30,9
RegBSCGPaKHQNbDTEFYcIMWfXZOVUJALd,LDCHdDBDRBAEBHEFCHCCGAGG..KGGFQGEGDDGFFGAC.IFABhAAA..fFDFhAAAOACAJBADAFBG.hABAeCEF.SGGBaAFG.NDIE.bCGB.hABA....YADHhACA.,1,-6,-55,49
ZDFQLBXGVCTPYbUJaEWNAIfHKceRSgMOd,HAADeCCHRGFESEGA.OAHBdEHAZFDDFECBBBBHGEDCCADA.hAAAPAFFUBFBJDABEDABAHGDhAAA.KCCA...MACAhAIAQGBB.......hBDA......hBEA...,1,-7,-33,26
aAWfNOFgRcLHJGYSECZKBXPUVDeMITQbd,...NDHC.FAAD.RDBHLFDFJBAB.GFEHEDCDKAHFBHBD.UAEAhAAAeBEF.MAAEQBGGhACAaGGH.ADDGOHFEhADAHFDFSGAB.CCCB....hAHA......hAIA...,1,-23,-26,3
IaQSeFGAELOgKXZMdRHCYBPbVUTDJNfcW,LFFBKDCDZGEGdFBHRACBHBFEBEEG...PEAE..UBDCJHBE.hAAA..NCIE...fBBGhABA.IDEFhACASCBCeGACAHCB.EEGGOAFAMAEE.hAIACEGD....YABEhAAA.,1,0,-56,56
aWDNZdOKIHMBYVJTfQFLeUEASRbCgcPXG,SCFCCFDD..gEFCXFABGDCBDBFDZBBDKAGBMEHHhAAABGGEVBBG.JAEATFAFhAAAFGDELBADhABA............hACA......hADA...,1,-12,-50,38
KbAEZRUMHaXFdTeSJNGQLcDgOWfCPVYIB,ZBCFRFEEHBCBaDAB.FDGHdEGF..SHBEGGDBLCFCDABG.OFADhAAACFCE..VAGFhAAABABFAIHAMFAHeEBG..hAEA............hAFA......hAGA...,1,-24,-30,6
BFIKCTGAZEMbQHgNaOdYSPfRVWDUXLceJ,EHDCQFDBHDCFaDHBOBEC..dAEHSHGARFFBDADFUBAAXEAEhAAA.LDBEhABAeCEC.BHEHKFAACEEEhAAATACGAAIB.MCID.gGAGhACAPHAG.WDHD...hABA...,2,-16,-7,9
DZLGfWFEdKMNRVYTUbeaOXQCHJSPIABgc,BFDGDACBGCFCFCABdGFDKGAD..MFCBRADC.....TEFEhAAAbFCB.OBEACGHHHDAAJBBAhABASAAF.hACAACHH.cCDE..fEHANIEB.hADA......hAEA.YFAF.,1,-24,-26,2
dWPNeSBcKbHGIMJfVTDXZaUFgCLQYEAOR,ODCHRDAGdGDH.....NBEH.SBCEBACBKCHF.HCGDGEEFhAAAIGHDMCCGJHAAfCDGhAAA.DFEGXGDAhABAaFBHUAGFCDEA........hABA......hACA...,2,-32,-26,6
MXYUVGWHgPTBIeLJAabNCfDOEFZRcKSQd,aHBGCFDGDGHF..FCBAZADGRADA...KBAEdFEB.MCIHUDEB.GAGEhAAAHDAF..TCEFBFHELDAAhABAAGHG..hACAfHFB.EAAG.....hADA......hAEA...,1,-20,-42,22
BcaMeZUAHfdWCbRXSIPJVgTNEGYOKQLDF,HDAGdHBHCAFE.XBAG..IFCFVFAF..TEDGECHFOABFhAAAKAFADIEEFCEABGFEhAAAaFFE.MDIFZDBCAAHFfBDChABA.WFHDbGFAPEAB..hABA......hADA...,1,-8,-28,20
HSCdUDJGBgaMVfERYIFAbXQPWcLKNTeZO,XCGCQCBC.....PFACLBBEKCHDeDFFHEAECHABhAAADAIFBFFBMAAEfFDAhABAEGGB.IGHGhACAbFDDNAEE..OAFHSAEEdHAF.UCDBhADA.....hAGA...,2,-17,-12,5
eAYKNZMECBdXQgbVGUaFPfWcTORJLDHSI,KHBGZFACMAEDBBDEdBAH..XCAEQGEG...VDCHhAAAaABGFGGH..fFFBhABAcDDE.TAGDhACAOHACLAFDSGEBIDHDACFE.hAAA......hAFA...,1,-20,-36,16
YbXZHAPOWVKRgNcJELGBfMSFedaUDQCTI,OGEAVDAG.RCCH.....NAHA.JBAHLEFDBCGH..MCFHhAAAFGBBaADBDDID..CHHG.IHHGhAAA.bFDHZGAChABA.ABGDKAEE.........hABA.EAFBSBBBhACA..,2,-41,-33,8
LabTIXNDHPeWSJBGRcQdKYCEfOMAVFZgU,FDAFUFDHLEFB..TAGAXGDBDIAGeBCA.SGAAhAAABDDAGAAFQCFChABAYBHFEDDAOAFGhAAAAGHBZDAB.aFCHNDIE.WHFA....cABBhAEAdCDB.CHED...hAFA...,1,-13,-20,7
GaQWdFEDUATHSOIbgBPcNJXLVRfeZKMCY,SDAFOGEA..IECBBFBC..NBEGLDFHRGAAZCBECACEGAEFhAAAaABA..dEHCDIGEhABAADCFHGAC.gAGChAAAcDGE.........hAEA......hAFA...,1,-22,-34,12
NELHfBUCDSRGgFXAcaJeIQMbTKPYZWVdO,JCCHeDAC.QFFBMIFA.KAGAZAEBdFACOBAGEFDH.HCFBBAABhACADCABSCGEhADAGDAAXFFAAHEHaCEFIHHAhAEA..TAGFWBCC.NAAF....hAFA......hAGA...,1,-13,-22,9
MOJLIYWgUNbHTfXQKaeDVAEdBCPZSFcGR,EEHBBCEAZCCDFACBGGBBREBG..MCHHJABALFFB..IAFGhAAA..gAGBhAAAUGFCHGCCXEAFhAEAaEAHDBIBAHAACHHG...SCDFhABAYAFF......hAEA...,1,-13,-34,21
KSWPTcVGLJCAgaMDIHdfRNZQYXEUFObBe,aGFHDDGGdBAG.RFAE.QBFD.ECBCUDDAFFBH.OGFABHGESDHHhAAA.hAAATDDFcAECLAEChABAAFHCMCBG.IGDD.NCAE.XGEChABAKABG.....hADA...,1,-18,-39,21
GeHgQRAadEXSObJcBLVMfWTCZPFKDINUY,EDABXGGD..SACBJBGF.BHFFMGAGTGBGCEGDZBBDKFEGhAAADEDFUGGE.eEFEhAAAHBDHRCDCABBEaHBGdAGBOBAHhABA..........hACA......hADA...,1,-21,-27,6
XbaAQTMEPKVURgFIfZcWHeBLSYDNCGOdJ,TGFBMHFGKEGG..UFBAFCFHZCAAHCCGBAAELAAC.DFGACAFGdEBEhACAXBGD.ACCAQAEEhAEAEEDH.hADA.PHAE........hAEA......hAGA.gAGHIFEA,1,-14,-34,20
CAaEDbQgHIfVOTFKRMYecGLSBUJZPXNdW,DGGDQCBCHCCC..IDAAVCGHOFFCFGDG..MBGDeABAhAAALEFASAGAhABAUGAAPGAAdAHGCAACAHHFaDEFhACAEACF...........hAFA.fBDFhAGA...,1,-18,-22,4
RZWdHfYbXKcLDQMUCeEVBGgOITaFNPJSA,RGFGZDAGdFBEHEFH...bBCEKEDE.DIEEMBHDeBBHBGBGGAGAOFHDhAAA..TADChAAA.FFDHNABFSGDHhAGAAGAA.fEDF....hAHA......hAIA...,2,-32,-20,12
gYQMAUSHJLIRGabcKZWPfTBEeFdOVXNCD,HBCFJEEGLAFARGAAGBEF.aAAFKBBE.ZBEA..fEGAhACAEDAFFEHD.OFEF.VDAFhADACHHADCDF.QGAFhAAAAGIHSGHD..bGDE.....hAEA......hAFA...,1,-7,-26,19
RLgaTUdHfVEDZecAWFJBMNPXbGQSYIOKC,JCCHBBFD.MCCH..XBABQACA.SFEEhAAAIBFGKFEGCEHGRGBG.LGAChAAATAGG.dEHG.fHBBhABADIAAeBABAHHHWAECNDEB......hACA......hADA...,2,-41,-19,22
YUZaBEAHdbLXSIKJRegWDQNFfVPOcCGMT,HDAGLCCHXBBCSHDEKEGB.eFGHDEEFFHDE..VAFAhAAA.OFDEGACFTDAEhABAYCHHZADFBEEChACAdGAEIAHCgCGAQGGBNEIE.hAFAfFCA.hAIA...,2,-7,-6,1
XZIMYLEVWeOCKRBSTPQbfNdgUcDJFHaGA,ZEFHMCCAEABC..VGCEeEAF.KCCARDEBBDBD..SHBChAAAQGGH..NEIGUBGChABADBBAFFAGHAEBAHBBXCGAhAAA.LAEEWHEGCEED.....hAEA......hAGA...,2,-20,-20,0
EXeGCBbDfgKILRFQcAaWVPHdJZTSMNOUY,aCFCVAADHFBB.ZAAGSBGF.OCDDEHGEXEEBhAAA.CFHGDBEFgEABhAAAIAFDLFHHhACA.RFFDFHDAAHEFPAHFJBHBMAFDYDCH.hADA......hAEA.BDCCfCAF,2,-11,0,11
FDBIZdULObfCGaRMEAcTXWKgPSVHeJQNY,TCGCKGFC..SDDDeBDB.QFBCFFEGIGCBUAAFhABAOBBDCEGC..RAFEMBEBhADAAFHEXAEA.hAEAPFAH.JAABNIDHDCIFBHGC....hAAA......hACA...,1,-25,-29,4
UXJRbNHDTWKCOPZMeBSQgLYVdIcFGAafE,aAFBUGBC.RGDEHAACDBBCKCGH..CDFFZFGHBAGA..QDCEhAAALFFFdEADFBFG.AICEEBDFXDABhABA..NBIE.OBHFhADA.MAFCSEDB.gGGGhAAA.ICAFhABA.,2,-51,-5,46
MVDfKUTJRbOLSAEdFCagWBPQcYZHGXINe,FDABaEGDBFEGQBGHZABG.HAAGGCCDXFBGeBFG..DHDCKFFGhAAAUFAFJCEB...OHAChAAAAGIBCDHG....hABA............hACA......hADA...,2,-31,-31,0
XLgWHPOMfUKEYQBbZTeDIFCGdaVARNJcS,RFDFJGEA..SDDFLEDFHEABMBHDKHGAEBBCBCFBZFBF.eCHFhAAADCCBCAFAdAEH..AAEC..hABA.NIEF.XAAFhADA..WDCEOBDC.fFFBhAHA......hAIA...,2,-34,-20,14
UKJcaFVHAYZNPCXIdLEMOeQDfWSGTRgBb,ZAADCFDGdCABEFCG..OCEGQGEE.DCHFSAEARCCG.hAAABHBCKAEBJHBCFGFEAHID.hADA....PEFEhAAAIHHBLDBAfAGF.WFEEhAEAgFAC..hABA...,1,-27,-46,19
XHYgLcGJTbDMZVWSdafRONEABPIUeCQFK,BFDGUCBCQBFEKDBGHBBCLFEBGEFGJABCDIAEZCGF..VFBHhAAASGHH.hAEAaAAG...fGADhADANDIAAHEB.IAFGCFAFXDDF..hAFA......hAGA...,2,-27,-22,5
DVLJASPEONFfRIXYUCKBbZMgGaQcHeWdT,SAFBOCCHFGFA.REAB.....IAACXDDF.CHEFBBABhAAAMAHHGDDEQGFGhABAHFAD.eAEBdCCCDACGhAHALHFAADGANAIEfBDB.KHBAgDGGhACA..hADA.aGCDTEGE,1,-11,-20,9
AUdEPaWNHMgGOBTJcIKXbfRDLZQCeSVYF,dFHAEAFB.aECDHDBG.MAABGBBFBEFDTBGGJGDA..KDHDXEAFhAAA..RGAEDAIHhABAQEFASGGBhACAFHAAAAFHUBCB.........hABA.NEEE.....hACA...,2,-22,-20,2
IecANEOUFTPSDJRBbGWCfKgLZXYQadVMH,OCCHUFCAFAGF..SBGDRFEBBAAC.GEGC.CHBGKFCBZCCGQFAChACAdDAAHABCIEFHhAAAAHHA.NEEA.EADBhAEA.DBIB..WAHBfBBC..hAFAXAEB..hABAaDEE.MIAE,1,-23,-27,4
UeNIPdDEaHJGKgCTZfAWLOVRbYFBQXcMS,LEEGODACRFDG.FGGDBAACQBFG.MABGUCGD.IGAChACADDDDaDBH..HBBEhAAAKCCACGHGTGAC.AFIB.hAFAVADE.....YHCAcGEG.hAGA.NAIE.EEHB...hAHA...,1,-15,-32,17
KDMXSGcfBLVTZAeJPCYNQOIWURabHdgEF,eEEGJAFB.CFHA.QGED..IBBEUDBDaEEEdGEBFADGMEBDhAAAGBAFBHEHLHAAhAAAVADF.AHHE.NDDA.OBHDhABA..WAGF......hABA......hACA...,2,-41,-15,26
afIgHcCBEDKWOeGQMFPTdJLUXNSRVAZYb,ZAADaHBG...IBGCHCCCCACGBBFADHGAKDCAeDAD.GDFGMFFFFDHBhAAAdAAA.LHAGhADA.UFCFSHGAhADAAEAD.fFHAgACA.EDFBWAHDhAEA.PFEB..hAFA...,1,-17,-24,7
DBeFSHUMgPZNXERICfGaVTdQAJbWYcLOK,JGEA..bAAD.......cGBCKBCGBAFH.SEDChAAAUECCPACDZFABXGCDhABAIFFFfAHChAAAGCGA.aFHBTCACAIHELAGDhACADGIBFAHFMEABECEACACC..hAEA...,2,-31,-7,24
KaFWDQEVOHBCYfXRPJGALIeTgNbcZSMdU,LEEGeDAC.TBDHbGAG..ZABCSDGCMDEB.UBAHhAAAKDGDaGGHDDDB..VGAEhABABBFGCGGF.fFHAhAAA.XBGBJBFAAHIHNAEB......hACA......hADA...,1,-18,-26,8
edPZYQCBJOfaHIgUTDVSNLbWXRFcKEAGM,MBEEdDCDZAFA.CCAH.OHFAHEAH.UCAEDFDG...SCGGhAAALHFEXGDFRECCFHACKABEADEGhAEAGCGC.PACDhAAAQEGF.fFAB..hAFA......hAGA.aHCA.,2,-26,-17,9
TLYQbPgfHNUWGABdRKIaXSeZMEVOCDJcF,dGFHRDAGKGHHaEEE..eDGHEACF...CFDH.JFCHFBCFLCDA.QAEFhAAA..hABAgAFENBIE.hACA............hAFA.WHEGBHAB.IDFGhAAA,1,-37,-54,17
cXeOBGbQLSYZMHNWTUaEAVKRgICPJfDFd,KDAFRAADCFEH...JCDGFHAC..dGFBeDFABFBFGDAFLHACZGFE.HBAEhAAA..TGCEhAAAEEEAAGIB.VACE..IEHAhABADAFGXBGC..QAGEhACA.....hACA...,2,-28,-17,11
IDaOgTQSZcJbFBWUEKGefPHRANCdMYXLV,dEGDXFDBLAFCDBGH.aEDH..ODAEQGBDZBCC.JAACBGFHhAAA.UGADKDAAeHEGhADAfADBRCDEACCACGHA.VDGBhABA..IBGF.....hACA......hAFA...,1,-16,-31,15
NgDCZLUVeKJSPWMYcEABbHFOQXGRdTIfa,HDBHFGDDQADDGDGCRAEAdGEA..fAAAaGCDDEABZBAGUDGFhAAA.eAGBKDFFSAHBhAAAMECFEHGEBDAGXFADhABA..........hACA......hADA...,1,-12,-22,10
TLeJOcbAPGSZVaCHUNKYfRXMWFDEdQgIB,SGAHVDDF.HAEBUBAAKBCCRBFB.MEGH...FAAFEGAAQDADhACABFGBeHEEODEHhADAAEAF..PHBChAAAaAHFYEHH..fAGBhABAWHCCDDDF.gACBhAEA...,1,-5,-35,30
WHgIPGTDaANBXQYLcKOZFUCSJMVbedERf,XGGGQDACLCHBKEDAFAGH..UABDSEAH.JEDGhAAAMDEEeBCHdGFCfHAHhABAHEGDIHAEhAAATGDEADDBBAECOADGCFCD.EBBF.WAFA..hACA......hAHA...,1,-16,-21,5
PWJbVMZHegRaGCFBTYIfOcXAUELSdKQDN,UGGDEEEDdACGDEFH......NEAE.JCBAMBFCeDAH...aBHHhAAAFHEE.BEHE.IGDBhAAAOFCFAADEKBAF.hABA.QAEAPCEA......hACA......hAHA...,2,-45,-36,9
gRHDLUKEIcWSBPJaebXGVYAOFfNdCTQMZ,FDCDdHBHQADAMBAAZGDE.RDFFLCBHKDGD.EDEF..IHHEhAAASAGEBGBDPCABhAAAJAEG..eDAFhABAbFGD...XCDB.....hABA......hACA...,2,-36,-16,20
CYRbXLJaQeSMBZNcOTfUVPHFgEGDIAKWd,KAFBCFEDRBFA.LEBF.QGDGMACEBEBBZAACOFDHUDDE.HCCAhAAAEDHB.DEEGAGHEdAHA.hABA.XGFAaGFDSADBhABA.NCAE.fHAB..hAGA......hAHA...,1,-11,-41,30
KDLgSNbFaGTMWRUeIXcJdQPVHfAZCEYBO,EBBDBAFBDDDFSCAC.FGHBTEECRDEG.eFAH.IADChAAAXDAE.dGCAVGCEhABAAHFD.CGHH.KAAA.NBDA.hAAAaCGC.MAFF.cAGFQBGA.hACAfHAF.hAIA...,1,-25,-29,4
LeWfGFbYZIdKAHacROVgMJUQDSPEBTCXN,HDAGaCFC.RDGDOGCGMFBFUAEBDCAG..EBHDCDBHLEFG..hAAAeAAEGDCEbGFEIGAHhADAKGEAABDF..cCAGhABAgDDH.SAFHBHHGNICF.hACAfBDF.hADA...,1,-3,-25,22
FRLdQbJOaeIWAVGCXTMPUDKfSBYEgHNZc,VCBFCFFH..TGBEMEIB.UCBH.KHGESEFC.EADHhAAAgAGHHFCHNBAEFGGDhABAdEAH.JDFE.eADGhAAAABHCXBFGDEIFBHFD.....ZFDDcGAFhACA....hADA...,2,-22,-17,5
VJUSgKOfHeWFIMEYTPQAXNBRdcaDLGbZC,BHHGRDAGdGDHDAABLCBE.GDEHCHHE.UBFDKHBAHEFGeEBGFACEhAAAEFAD....TBBFhABAQGAG.AFAG.hABANDDF....aBFE.......hACA......hAFA...,1,-27,-31,4
fDecMJAFEGBgKIYZNHTLaOPCUdVQXSRbW,GACBKEGDZCBFHBDDaEDG.CHAE.UCAE.dHEFQCGFRGAA..hAAAbCFHDBBE.MBFCAAFCBHHGhAAAIDAC..hABANAIE.TFDF.PFHDSFGA.hACA......hADA...,1,-20,-24,4
BTEXgdQIMfDNHcZKbJWUPCaYSOFLReVGA,BFCFTFCAEBFH.dEGHMABB..DCCGHFFDKGAG.JEABUGDE..hAAACDECaCHBODABLHBAhAAA.eACHAIHA.gAEEhACAfABB.....cDDFhADA.....hAGA...,2,-45,-16,29
DcWPKCZRAfIFOGUXQMLbNaJeVYESHgBdT,FHBGODACUEDH..MFFFLHFA..NIAB.JEGF..VACDhAAASADBBCFEDBGC.hAAA...PAGBhABAZDGBAFDAfFBEXFAGaDCAEGHFdBBB...hABA......hACA...,1,-24,-35,11
BIdRaOYCGMJZTHNbcLAgSXKFfWQPDVeUE,XGBCKAFBFABD..QEFBDADGUCECBEGHREBH..OBEHhAAACGGCGBCEMCIHZAGBHGDEhABA....cEBChAAAAHBDfEAA..WABF...hADA......hAEA...,2,-34,-27,7
ZGVEMCcPFDUSbeKLAfdOBJNQaXRWTIHYg,OCCHBAFBJDBF..QBDCRGFA.TGFHHEDBZDFA.GBBHhAAAMAAACDFAFAHDDEIH.hABASCGBKHAAAIDG.hACANIBF............hADA......hAEA...,2,-32,-29,3
PBZIJAFgWNdEMQeGTcXbVDRCSOULfaYKH,FHBG..gGEDdHEBMEAEGCCH..TCGH.XEDGhAAAbAABDFBCCEFFUEADhABALADEaGHDHBDGBEGHhAHAIAHFAIHG.EABF.cGBCSCGEhAIAfDDD..hADA...,2,-23,-18,5
NZfcTdgRXKOCMBUYFSAPHEJQeDbLWVaGI,HDAGEGDD.eBCCDCAELFBHaDFBGEFCZFFG..TAACdBDAXCEDhAAACEHCUAFGFHDE.AHBG.hAAAQAFE.hACAWABC...IHHCcECD.KFADBHHEhADASBHH.hAEA...,1,-7,-19,12
MDQSdBEcWAbYIfOLXZJaRKPCFTeUNVgGH,..IFDGOFFBXFCDZFGF.RAEF.PAEH..CCGFFAAFhACATDAA..NEAA.gABHhAAAMEDC.SDDGhABAEGHBABHC.fCHEJACDKEGA.eGAEhAFA.....hAEA...,1,-16,-30,14
dTacFOIUMJQYfGDCRXBKZVeHWPLNEAbgS,SHBGTFCE.FDEHOAAF.MCCGJFDHQBGAhAAAGGEHDAIBCACCRACEKGFBZFABHEFChAAALBABEDDCAEAEdCCAIAGEhAEAUFAF..XFGBBHCD....hABA......hACA...,2,-15,-2,13
VIfMQacWXgSdHEDBLReAbYUPJKGFTCOZN,UCBCKDCDGEEHCBDB.OHDGZFCG....IAFGQBBHhAAA.aAEDXGGEhAAAdGBCDAGGBDADeDFGbBFA.hABA....YEAFFDGA...NIAFMABEhAHA....hAIA...,2,-33,-25,8
VWOAYKfCQXUcDEdSGRaBPHMZeFbNJIgLT,KHBGQGGGUCBB.DCGHEACHdGAG.GBAGRAECBFFHMFEF.FDDGJEDBhAAALAFC.TACFhAAAOFAB.AECFCHFGSFFFhABA.PFCFHCGF....hACA......hAEA...,2,-38,-10,28
BTcKHgFdLAYMCDNZIRbXQWJfaOVGESeUP,MBFHCAEDZCCA.REAH...QABHJEHB.OBGHECDHUABA.BHDFhAAAKGAGFHECLAHBhAEADDAD....IECHhAAAWEFH.aDHD.SGGB..hABA......hADA...,1,-36,-40,4
OABIMFUgEbJXfPYDcWQCKSRHTZaVedNLG,BBFDMHFGFEFHUDCB..ECCFJHFE....XECE..hAAAPDAFDBAEQGAEhABAKDGHHGBAZAAEaBEFdEHEhACALDFDADBHIAGHfAGBcGDHCFHA..hADA......hAEA...,2,-31,-23,8
LZSRWKgQNVDGbEIOPBaMeYAUCTJcdHXFf,TABHdDCDFHFALAGH.ZABESGGHKGBG.QEDGhAAADIDAGAEEbAFFOFFAhAAA.BCCBMBAFADAE.hABACFGCJEBF.cBDG.fGEAhABA......hADA...,1,-22,-31,9
gIPJfXRGOLZTDBbEVWQcFMeCNAYUSKdaH,SGFCaDABHECF....IHBBfDDDXBFDOAFDhAAATGFGbABE.EFAFWFDHhABAFBCACEEA..AFIFUCAChACAdAACJEHFRFAALAHFDCCD.BHFA..hADA......hAFA...,2,-8,-4,4
JgYAfGUIQKTeWSLMRBODENPVdbaHFcZXC,UAGHKGFCeHEGLBBBRDBD.ODGDDAFE..EDGB..VGEEdBBHaEEChAAAHDDB.FBDBXGCDhABAJHAEAAAC..IFAEhACAQBGA.SAEDBDAC..hACA.NDAE.....hADA...,1,-17,-24,7
SPXZeCYfcFQLEDUBNKWJGOMTIVHRdAgab,aHBGSHBGZDCF.CEDG.....fEEFFCBGEHEGDCFHBCAGhAAAKGGCGACFMBEHTFGDhABAHBGBABAD...PFAChAAAeAFBcGFC.LAHB.hABANEACOHCE.IBBFhACA,1,-7,-32,25
fbdTaSRDMOUVPYZHcgJBNIEGKFAXQLeWC,XDCHQFCALGACeACB..fAFAdBADaAFA.DIAEOCEDhAAAUCEF..VFEChAAAPBHDHDAGJFGHIFAEhABAKDAAAHFBCBFB.SCHDMIAE..cEGFhABA.BADANIDFFAHF.hACA...,2,-20,9,29
XURePAQbZVGBdcHFDWLNJfgMICOKSaYET,ZEFHVCBFBGAB.dGDDHGAAFBFD.DDIHLBDDJBFH..MADCOCADhAAAKEEB...aHACTGFAhAAA.RAGBAABGbECC.hAIA....WACC.....NIDB.hABA...fCHEhAGA.,2,-37,-24,13
BKbCaQGMVFZfXcNSHELAOeDWdYUJITRPg,eBFDDGHHdADEUGCG..JDEHRDCABEHD.KHGAaGCF.GAGGFBAF.hAAA...XBGEhABASAADHFABAIFE..hACA....WAFDICCATDBEPFFBhADA.CAFE.QGAGhABA.,1,-16,-47,31
PLbaDTMEWOZKVXfgSCFAUIHGedYQRcJBN,HEFHeCDGdACDQGAHRGCCBFFE.LCBD.DAEEMCCFOGCGhAAAKAFH.fAGChABASDDGAECCICDFhACAGCGEJBADNDIGaDFAEGHFZFAG.......hADA......hAIA...,1,-9,-13,4
FHQXITgJDWeNKcRMVGABLaOSEbPUCdfZY,aDABOEGH..EAABUFDAdFGFZGEEFFAFHAED..XCBDhABA.TCFHgBAEhAAADAHH.NIBF.KFBERDAEMAHDhABAADIHSACCCDDB.fGAGIHHG.hACAeEDH....hAFA...,2,-24,-12,12
MDJRLIgTVUEeSaHdWKACGOQZbPXcYFBNf,OCBBZEFH..XBDHFABABCEA.MIDEJBADRAFF..LFHDhAAA..TDBFhAAAEGEAaEEGdCHGKAECCFAFGFBFhABAQAGE.bDCDYFHHDCCE...hBAA......hBBA...,2,-25,-19,6
XVZCPDfHgSLKdUTJQNFEWBAObGeMcaIYR,GECFMDEB.aCADRDFEZBCADAAB.HGAELDDEKDBEdAAEUGGE.QADDhABAFAFFBHGFAGFDOBHFhACA.eHBEIADFhACAXFACCHDA.........hAHA......hAIA...,1,-5,-28,23
NaTVgXPCIdEMOWKfBDLJZUYcQRAHeSGbF,HDEDSAEGGBADFBBEaHDC...VGFEPDEDdGAH..OCFAhAAAKAGEBGDCDDBHJEDFZDAAUFAEhAAA.QCGChABAABGCNABD.TGGD......hACA......hADA...,1,-10,-22,12
LMfGUREWQVFXacBJHZSKdIODYPgCAeNTb,eDACTCBCMECG.UFDBEAGF..QCGEFFAB.XAAGhABABHGEZABCSFGChACAdCFDIEHFYECGhADACGBHACCG.bFAH.LAEF.fGEGhAGAWHBAaGGA.....hAAA...,2,-35,14,49
dbKLAXCcJISGVfETPWaeNZRgBHQYOFDMU,CHHGJGEAGDBF..VBEDEAAB....TGDHaCGDZAACBGCFHGBAhABAOGFGDFFA.dDACLEAAhACAAAHD.IAGGhADAPEFCeCFA.RACG......hAEA......hAFA...,1,-12,-28,16
gbfCBGDTXQdSUIHaJKPRFYNcZAEWLeVMO,LCCHMAGD.ODAD..gFBFCAGBGCECDFHFTGGAhAAA.dCCASCHHhAAAHBABKAHBFFFGNBBH.AEFCeAEBhABAfGBCBDHF.XGDC...hACA......hADA...,2,-26,-13,13
OeMCZUFEILfDAYRgNdBHXGcaJPVKTbQSW,RAADdHBHBAEGHBACGAGCaFAA...JGBGKBGD.TGEGQGFAhAAA.OFABCHGAFDFHIDDEhAAADEDAADAH.NABF.XDFDhACA..cEGD....hAGA......hAHA...,1,-28,-29,1
agHXBfDQTEMKGPdYJcUZSNIWAROVLCbFe,RDBGLFFCFDGD.aCBAHAACBAHBDFBH.QAEDMDFGGEAHdGDD.hAAAJAAE...ZBEENEAAAEIFhABACGGG....bGBGgGGFhADA..fAEBKHBA.hAEA......hAGA...,2,-22,-20,2
SRPXbgUBVWeOZTCAFaNYGdJIfDQcHKELM,FAFBaHBGGAFAdGEE..JAACDCAHHCDBKECDLBEDRBGB..XEABhADAUGGHBAHBeHAEhAEA.ZFFFCHDAAFAA.ICCEhAAA...fABA.EFDAhABAPEHD...hADA...,1,-19,-32,13
LEJVeIWfORXNSBgGQbTPDKdFCHMAZYUca,UFDHLCCHEBHD.eFGF....IHAHOEADXAABhADABGBBQBDFTGDGKCGFhAEACHGEHCAFAIBCZAEEaAGAWCEHhAFA..fAAH.SGGEhAAA.bDEADAIF.hADA...,2,-26,-12,14
ZWKeHEMPAJGSDbBYRfdOgFTIVcUQCLaNX,GAEGSHFGDBAEBDDARAFB.dDBEFEBG...IEHDVFFCQGDHhAAALFDFNEAGZAGBhABA..KABHEGACPBDFhAAAAEIB...YEGF...fFEAhABA..hADA...,1,-23,-32,9
HBNFGaQgTdYEfLVZKXCSDPJOMbeWIRAcU,HEFHFEGDQAFCTBGDdAAF..EBBGfDBCLAADZEAFXGDAhADACEEFDECH..OCDChACAeBDCIGABhAEAAHDDBHHEaGEHYDDF..SFFDhADAMFCB......hAEA...,1,3,-22,25
DaFYLVTINZXKMPdWEbcGHCQSORUfeBAgJ,JFCHFGCDLEGF..VCEBTCBBZABHKHEAMCFE..dEAEEEADhAAAGEGECAGG.OAFChAAAfFHE.AIEADBEFhABAIHAGXACB.PEEB..hAFAcECA...hAHA...,2,-30,-23,7
TKVOGQWbMLcHDdAZaECNIeRUXPBJYSgfF,ZFEEaEHB.EFCB..CECA.eEABRAGB.UAGGBCEE..JBDDSACHhAAA.FGAHKCBB.ODFChAAAQGCEMBAG.hABALEFHDIBEAFIH.ICAE...hACA......hADA...,1,-30,-34,4
FIZYGUOTPDbgfAeQMWLXcBECNaSKJdVRH,QAFHLCHDBHBDECGB.aABDKEDD.dBBBHADEZFFDGCAFODCADIDEhAAA..bEEBAABB..hAAA.MEABcDAASACEhABARFCEFFAB.IHHA....hAFA......hAHA...,1,-9,-20,11
IUYDGFHMKXdVbREgQLJSNOPAfBTaeCZWc,TGGGCDGFZCEF.....IHCDDCIFGFAHFFBCKAGGdHFBRBAFQEFBhAAALACA.JCDG.hAAAOACEABHBBDCEaCAFeHAGhABA....cDCC....hABA......hACA...,1,-28,-31,3
UZJNHeARaTGYCBDVLWcbMSPdKEgOIQfXF,TCCBGGDHCHBF.BDDCDGEHLAFA..bEEAMCHH.SGFFhAAAdAEAEBGFIAAAhACAQABF.fCAGhACAFEBC.ZEBE.NDIA.AGID....hAEA.YHAAcBCB.hADA...,1,-7,-39,32
AFdfQHaEWKcONSMCgTbPIDYVZReBXUGJL,FAFBQGBCHFDBEBGCKBCE..OABHMDEGCGED..TDEH.hAAA.IDAADGHHVEAGhAAA.RACD.BHHCUDGELECEhABAAGID.fBFH.aAHD.hACANACBSHEAhAHA...,1,-5,-40,35
CUGgTbNVFIHKEYOMefdXLSAcDJaZQRBPW,DEFHJDCHZGFARFBFBGED..CBGF.UBDHGBBD....TAGAhAAAVEFCHEABKGGA.EAAEMBBDhABA..eHCE.hACAfAEF.LAHBAFIBaGAH..hACA......hADA...,2,-44,-13,31
RZQBHfSXUYCGFDVdJMgAeIacOEPLbKTNW,aDCDEDCDLEEG.KFBBTGAE.RFFBBBDESABDUAACCGDDhADAGAED.FGEEdEFBhAEAMIDEACIHeAGBIACFhAAA.OFAHNEIA.WDHH....hAEA......hAFA...,2,-26,-22,4
EGbNWgXQVdfTCMUKRcIZADPeJBSOLYFHa,DEFHeEEGBHFDLHCAHBACGDGA..NAAD.XAGCQBCAhAFAdEBDCGDGKCGD.IGADhAGAAHAFSADG.hAHA.FECBaGHDEHGCgCEEfFDA.MAIFhBAA.....hAAA...,2,-30,-9,21
HScbWNKDRTYdQgGFUBJfCIXOMZEePaLVA,HDAGSHBG..bBGBKACGDADERDGDdGGDGFEFUEDDBHHA.CGAFOABChAAAZAFBEBAHaFAGAGDD.hABA...NCCD...hAGAQCCD.......hAHA.gDDBhAIAfAHCMCIF.,1,-11,-22,11
ZKVbUNMOWTAcEdDgaYXHCFIefGQJPRSLB,EAFBdHFHaBADHDBG.FCGDeBFGGFDB.QBADJCCCRFCE.BAHEhAAA.KEHH...VGAEhABANEIAMFABTBDGDEEC.hAAA.....YEBDCEAD.fACFhABA.SFFEhACA,1,-11,-29,18
gEGTSMLWXCDAUZPFHKfYIROdcNBbeVJaQ,ZEFHFCFCHDCCKEDB...IBDERCBHOHCEdABABAAB..VFFBhAAAQCGEEFAG.SADGhACAMICALCHBhADACGCCABGB.fAEB..NEAA.eHAChAGA......hAHA...,2,-36,-9,27
OXBageQdRLEAUcGVMFTNHZDKSPbWJIfCY,UFGHGEDHMDBFFEAGHACBZGCE.DGCBKADA..SCFG.hAAA.WCCCIHHEhAAACDDH.XBAFBAGF.hABAgAGDQCGC......hACA......hADA...,2,-45,-18,27
YKEQgWLITPGdRbNHXDAfUMaBSeZCOcVFJ,MFFFaEHBBECAZCFG..CCBA.OCDC.FCABJGBG.KGGE..EBHBQEAGhAAALGFGIAFGhAAAGACDdDDE..hABARABC.NIAF.XGCE.AEED.SAFEhACAeHAG.....hABA...,1,-20,-26,6
VQegXISGHACEJKaDbcUMWTZfBFNOLPRdY,JCAFDGGDUFAC..TBCHBBCAFDFG..OCGBLBEAdHEHQGBHhAAA.hAAAeCEFIBAESFHHhABAAIDGKEHF.aAFEMFFH.....fEDEhABANAIE.PDAAhACA.,1,-17,-55,38
LUYIJQNXgbaHdfeVZGKEAFOTcDRCSMBPW,FGDDODACDAGC.RFDG...MDBCBAACLEFDUAFB..JGAAXEBDhAAA...aBHFhABAdCCFeAFDVCFFKABAAHGECCAChACA..SHFA.YCHFhADANDIC......hAEA...,1,-31,-36,5
QKVWDXBeHZMdTPYRNOCaJFbSIGUfAgEcL,EHBGLDACKECE.VFEEDDDCBAED.HAACMIFE.dACG.TBGGhAAAPEFD..NBEA.CAGA.hAAA.JDAHFGBB.IAFAhABA..fFHEADFHQDGBXFCEhABAZFCH.OAHDhADA...,2,-39,-3,36
PCWXBRIFbGMJZSfOeLAadcKTDUNQgVYEH,aAFBdAFBKHGE.DDDDQDDA.VBBHEFFCCBDF..BHGGFHCAGBEHhAAAJEGHZEACSCGChAAA.eHBAhABALEABAIEE.cCAF...NEEF..hACA......hADA...,1,-24,-37,13
gOEDHRILMGTBUAeNXdYCVbZSaQPWJFfcK,eDACdGFCCCGDZECGQAAB..JBCDFHDE.KECBOCAHDAGDHFFChABA.LBHFMDIHBEGHhAAAAHAANCEG...XBAFhABA...bFADSHAA.hACAaACDfAGHhADA.EHCE.,1,-12,-41,29
PEeFRUHBNdZATLGcMbWgYOQJIXKVSfDCa,TDACGECFMHCA....gDDFOHACICGHhAAAVGDGDAIBCHHB.EGADRBBCBAFHhABAZDGFAAFA.LDAD.hAAAWACCJABAKFCF.SCCCaAHFeFGF..hAEA......hAHA...,2,-17,-8,9
HTFIUDYdacNQPAegfSLXCBGEKMZROJWVb,eGEASHBGCDDG.EACDZBGH.OCAD..JEGB.VBFHTFBHhAAAFFAADADEdABFaFAHQDDGhAAAAFEF.fBABhABABHHEMIDA.WFFCIAHF..hAGAYCCC..hAEA...,2,-34,-19,15
YZaSCfTXMDeBNFALIbHQOPKRVUdgGJWcE,LGEAHAADQGGDKAEARAAD.UEBGdFGBGEAEJBFF..EAGBaCFBhAAASCCA.hACACADD.XDCCMEAFDEEHhAAANIEFFAHFABIDOHAC.gFEHYADFfDGBhAEAeDHB.hACABHCF.,2,-21,6,27
MVFOADPGbBcXSafERegKNCWZQYLJITUdH,DCECGAFEBDAASDCD.EFEEgFEGCBAC.QCCGhAAAYEHDLEAFhAAAJFAE.IHDBhABAdHCFMFIB.FADEACBFPADFcABB.fFBEhACAeDGDKBHD....hADA...,2,-23,-20,3
MZSJfKWDINeCGEcOBFXTAbQPdYaRHVLUg,QCBCdHBHRBBAHDAALDGHMAEFZFDH.SBGAKAFGDFAC.eAAFhAAAGCGC.OHAGhAAABHHEFEEBAABG.PAFAhACAaFFBUGGF..........hADA......hAFA...,2,-19,-10,9
gBaCEKFZSMLAYQfcGWDVdOINHeTXUJRbP,QCBCGAFEDIACODHHHABGeCFE.XGACRADF.bAFEBEFDhAAA.aABEEGDGKFDFFEFBhAAASCAFAIHE.hABA.cECBdFAAIHHC...NCCE.hABA......hACA...,1,4,-31,35
XdUHOgYWKQEbJICNLADGFRBcVaTSfZePM,DEFAFCAHBGEG..VDBESDCBZGAC..eAEHMDIHXFFChAAAdEEHUCFB.HFADhAAAOABC..WHFAhABAKBGDEBAB..IBCHCEHAAGIH....hACA......hADA...,1,-29,-36,7
VMLJFWbcERTAaCSUXBZQfGKdPeHgIDNOY,aEHBCFCFUBDHBDDD.ZGDCGEFC..KEBBeCABHBDEDIDAOHBChAAA..MAFELAFGhABAJCHDFBBF..WEADhACAEBGFAFEASFEA.fBBEhADAgGBA.IHHFhAAA.NEAE..,1,-17,-32,15
aOCEcbVYDZdSBKTNRUFQLXIJfWHAeGMPg,eHEAMEAE...aCACCGGAEBAH..VDGHDHCAdFCHBAEB.KHACRBFH.FFEChAAALAFE.JCBEhAAAfBGBAHBH.hABAgABEOHDE.bECB...SBEGhADANCIE...hACA...,1,-17,-32,15
OHPLYNcfZDCSgTRWFbMJQeBaKdEXGAUVI,VEFHOFBB.HGFGLCCA..cBCGDADASCBDhAAA.RGCAFHACMFFCQAGGhABAaEEHEAAEXAEDhACA.ADFCIHCENCAECFBC..WHEAJAHD.hADA.BHEDKDGC...hACA...,2,-20,-6,14
BTPdLCAWYbaZcEOfFGRQeVJgNIUKMDSXH,...bAADaCFC.EECCODCDFHAC.GGABeHCE.JFGD..gAAFhAAAUBFBKEAFDFIHSADEhAGABGEBdACCCBGHAIHE.hAAAZEFAfEEF......hAEA......hAFA...,2,-24,-20,4
cPHCaMbNegdFTBREDVUYQGALIKSJOWfXZ,KDCDJFFB.OEDC..XBADZGCAHAACCGCD.MAFB..eCEFhAAAFEADBDGADDIDUAGAQFGEhAAAABECLEADIAHChABASCCH..fBDAhADAaEHHNABF......hAEA...,1,-26,-29,3
MRJTUZDQYWaLbXeFHEScdNPAGVBgCfOKI,GCCFBFDDCEFE.KAEHRGBE.UEAGZBBF...DGHB...QAAFhABAaBGALAAEeCHHECFA.hADAdGGGNEFE..AHDA...hAEAfFAFIHAFMEGFJAEB....hAGA......hAHA...,1,-24,-33,9
XTILdSYWePMCFaDBZORgQVbKJNcfUEHGA,XCGCTDAC.LFCAdDDG..SGDAeADACBBA.FCGABABChAAAZACGOGAGRDACQGFDhADAKEECJEGBfHCBhAEA.EDDEAHHAWABCaAGE.DEIH...hAHA......hBAA...,1,-12,-26,14
bIUVZLOHQRdWgFTcYKGMJNSCBPXAafDEe,aHFGDGHHeFDD.UBAGVDBD.LAHDHAFHdFGFFBDD..TDEDhAAAKEFHMACC.JEHHCEAEXFAGhABA.AACEECCEhAEAIGDH.QAAG..hAGA......hBAA...,2,-30,-16,14
EaZVGFXgTPIdNecHUOfWbLYSDBAJCRQMK,JFCACFFCRCAF...MBABEGCC.ZBDFGGEH.FCGETAGH.dHEBeAFAhAAAHBBFUADA.ODDEhABAfFAB.hACALDHBDGAC.AFFAaGAC.....hAGA......hBAA...,1,-15,-24,9
VIcNTADHagUQPCeSEObJZYBLMRWdGXKfF,HEEEUGBCCEHASFAD.OABBZDCEBGGBMADFdBABKDHBFAEHVEBFhAAA...IGGGhACATCAD.ABIFDGEFaAGD.hAAAQAEF..PHDA.EEFAhABA......hACA...,1,-7,-41,34
OcCZJIfWBLTRKYQbFMGVHaSedADUPEXNg,DAFBEGFC...XABEOAAFCEDGZCEE..JGAG..IEFAhAAABGDHRAFH.KECA.QGGEhABAMAEH.HGAG.hAAAaBGA.SCAF.AIFE.UDAF.hACANIEBfACEhADA...,1,-12,-45,33
YTFaUOAIPdLXbEeZJMNcGSBQDVgCKRHfW,dHBHLDACEFAGZBCCMAFBGEDFBFEE.DGEDCADHHAGF..fHGFhAAATCAF.aGAFAGGCIHEGhAAA..hABAXABB.JCGHSEGEgEBEhAEA.WCHB...hACA...,1,-20,-29,9
THSQUEBPfWAdFeGILcXZRDaVgNbMCYOKJ,dEEDFHAEeDEFGBCDLAEAZFAGDAIF...aECHVDAC..NBBG.CHFD.hAAA.KEHBHFFF.SBGAhAAAEABEBHBF..hABA.PCCGfAFFIACF..cGGAhADA....hAEA...,2,-32,-14,18
gONCYWcSLfIDFBHGPeEbMZAQXJVRTUdaK,QDCHJADG.RGACdHEBKECGODGF..CCAF....cAEEhAAASGBD.hABAfBAFDEBHFDGBBFDGhACAGCADeABAMFIDACIBXFGATGCFaEEFhAAA.NAIG.....hABA...,1,-19,-39,20
MKHXfbZJYTSDdNWagCVLBAORFUIcEePGQ,ODCHUCCBECGAGADC.MDBDHFBH.XAAGZGDAJAHH.TGEBhABADFGCdBAF..aAFBCFEBBHHEhAAAAAIFREGD..IADAhACA..eAFBKFDC......hABA......hACA...,2,-27,-9,18
dZOTUFJHQKfPDXIAEVbcgNCSeRYLWGBMa,ECFCVAAD....bBBC..NADB..CGFA.eFBGLBEFBGAEaDFEhAAAdFDAZCGBUGFA.FDDFHDBDhAAAKABCDAFEADIHSHBGhACA..RADEWEHHMBGF.....hAIA......hBDA...,1,-16,-18,2
JRDEQTILKcHXFeVbGdUNWZMPCfYaOSBgA,RAADQCBFLFGFHFCDFCGD.eBHFGDEEdADBUCEAZGBACAAG.aGABBAFAhABA.AAEGEACEKCDD..hAHA.XECDNEIE.hAAAPHFC.........hACA......hAGA...,2,-15,-14,1
OSPQGHWMEFfTACgLcdIbDXNeVBUYKZaRJ,CAFBLGEAdGEE.DAGCeAHFBFACKCBCRADH...OFCFQABFhAAAHCEH.ECGFFABG.AEHF.IEEAhACA.NIEB..hAAA....YFCBZEAHaGHFSGGDhAEA....hAHA...,2,-29,-27,2
aNVfZJKYGMBPDWQeFgLHbETUXcAIdCORS,CFEDODCHRBFA...SFGAaBBD..VEBDZBDCJHDC.KDDBhAAAMACEBAEFDIEAeHAGhABALEHDHAGDEEGATDEAhAAA....cABBAIBGIBAC.hAGAfAFF.hAIA...,2,-31,-23,8
QRVPbDIcXWHETJNGLKafdOBUCYgMFZeSA,RABHVAADDDDH.....XDBAEGDG..JFFGLGCAKEBDdAFEBAHFhAAACAEGMCFD.FGAHeCEDhABAABGAQEGEhAAA..ICHA..WCDBNEACfADBhBAA...hACA...,2,-36,-31,5
HNYVFDUJRZOPcEBQKagAdMILWbSXeCTfG,dGFHLCHDSEEFeBBACGFCGCBA.HADCVECEUDFE.JEAHhAAAOCAB.PBEDhAAAEHCABBAE..aHAAhABAADAGMAIFIGHD.XEAD.fABFhAEA..hAFA...,1,-14,-28,14
gXSMQCebKJcROYVEDdaFIZfUGABTPNHWL,TGGGHAADLHFA.XEFDQAGHeFDFKBBDRCECVDBEhAAAdDFDaGDEZAEAUECD.BADFhAAANCAA..SAHBhACAMFBFCBEF...cGAB....hADA......hAFA...,2,-26,4,30
HZFQERNfXBAGCIYdOLKPSWMeUbDTJagcV,GGDHCFDGdCABLBDASEGF.eABBUEAETDDC.aFAFgFGEhAAAHBEAFCAD.EHCAhABANEIEBAHC.ACID.YEEHhACAKACCMIBEDAHF.......hAAA......hAFA...,1,0,-30,30
PLOeJfQdaICUbMEKcXRTZFYVNSWgABGHD,BBGFHEEBLAADeDBBQBADIHCACDHB.UCBG..MIFAhAAAEDFEXAFAZFDGFHAAVDDEhABASHGE.hACAAGABDIFEJEHFaAFB..KEHB.cECD.hADA......hAEA...,2,-16,-8,8
IQYXSgMfCdFcLKPaRATODJVbNHUGWeZBE,TEGDDBED..JGDG..VBEDHCFBGBAAeAABZCCHBHDFQAGEhABA..SACAhAAAfFAFFHAAhABAKGHBaGGCAAFH.NGBBEAFGIACC...gGAAhAEACCCB..hAGA...,1,-13,-28,15
dHYBcXIKENbMfSQTODUgARWLCePZJFVaG,RFDFLAFBCCBF.ZABGFAAEaHGEGCEB.dAHABDHF.XDDHhAAAEBEA.MGEASDCFhAAAQFBDDFHBUGAChADAWCAD...........hABA......hACA...,1,-29,-32,3
JcBTXIPFdNAEOgZLWQSMGYKVDbeaCUHfR,OCCHZFDFQGBCGAEGKACADFFC..aACFCHEEUBGE..HCBHhAAAJFGF.TGGG.XBFGhABAIAACdAGFEEAHhACALDEG.MDIBYHAA..hAEA......hAGA...,2,-36,1,37
EXSZWFKVbCHOcDBIYdTRLMQAPGUJNfage,UAGHJGEA...aHDAeABH.EDBHZCBCKDGCCFDBHFGH..OADAhAAABAEFdHAFLHBAhABAAIDA.GDCE.fBGBhAHA.SHGAFABCcCEFDFFGhAIAIFBH..hAAA...,2,-42,-14,28
BKNSTbHaLRZJMcdeADGOCYgUIQPVFEfXW,DCIHCDHBUCDBQEAC..FDGHEAHH..XGGABFGFKGDF.hAAATADCaADE.RFEBJBCHhAAAMCCB.dGBBAABCOCEEhADA..IBAA.fAHAhABASHAG....hAFA...,1,-27,-38,11
EbUPJOdKNaWeFTMHDXgGBIVRZQCAcLYfS,LGEASHBGEDFDUBAB..OACDdDFBaAGFFCGE.MFBEHFFDhAAADAAFXDAHBAFF.hABARGCGCHHHAGIH...fDDAhABAPHAEKAGANAIE...eBBD..TAEChACA....hADA...,2,-24,-13,11
FgHZDWQfXSAOTLBeUEIcJYPGVMbdaNCRK,OFCALGFABDEHUGAF.EEDGJAAB.GGEBMACG..dEGCCDCC.RBEC.hAAAKBHFFCCC.ZBAFDGDB.hABA..QFAChAAASDGEACCGeAEF.......hAGA......hAHA...,2,-35,-19,16
EXcdFRADONZafQMgJeYVTPGCBISUHWKLb,DEFHOFBBZBGB..QFACMBEB..eDGF.TAAGCAEDBHGBhAAASAGEHACFKFHHEGCChABAXGCDFCAF.ACCEaDEDhAAAfCEFJDAGYFHB....hACA......hADA...,2,-26,-24,2
TgKJBIMUOYWCQNcLVdeRbFHDZAXSPEfaG,SGFCEHBGGCGEKFCGBCBA.UDFHODCC.CFFF.QGBEhAAALABHdAFHRAECFEAGDAABAHAH.hABAXADDaBCF..hADA............hAGA......hAIA...,2,-33,-26,7
DUXdERbPcfMFZBOQAeNgKVaJLCGSTHIYW,eGEAKHBG..aECDCCCBGBEHHCFA..IGFCDEAGdABFRDEG...hAAA.bAFAPFAA.hABAMFIDBFAA.ABBENBEGJHBAhAAATEGG.UCAE......hACA......hADA...,2,-25,-21,4
cBRZTFMAJIHNQbLgDEfVeYCdKUOGWPXaS,JFBBHAAD.QAECLAACEDDAeGFCdAEFKCHHGDGGXDCH.hAHASGAFBBCGTGEHhAIAAEBCNIBH.DCIH..fFEHhAAACBFD........hACA......hADA...,2,-28,-16,12
DQCNKUaSHWgEILAJfMFXPcORVebBGTZYd,MDEBXGBC..ODFBRCDD.eHBEBHFEZACEDEAACGHD.KBBESDCDhAAAHBFFEFCEAEHGJHECFFFAhAAA....PBGDhABA..cAGA......hABA......hACA...,1,-29,-32,3
dLGQSAXJZFUMaYTDBcKCWgPNIebVOHERf,JADGUCCB.MABE..aCHBDDHDKDCG..CHGG.....gEFEhAAAIGACeFDFhAAAOHBERFEF..LCFChAFASFDBAHHA.FDAHBBDCPABBNBBE...hAGA......hAHA...,2,-39,-32,7
AWKTaRDZVBGPfJQLUNYFEgMdOHSXIcCbe,TGBCRFFAZABFBBEA.GGBHJAFBLADF.UEBHFEDAEEBEMFFHhAAAHBGH..SCAEhABA.IHGBhACACHHEABDAaGAHDAAF.fFABNAHGdEGD..hADA......hAEA...,1,-17,-26,9
CJHUVTXEebNWFQdYIcRGZKDgOfABSaMPL,BEFAMIAGLDCBHDBETABGEEFF..eAHB..NHDD.FBADdHAFIHFHhAAARAEGZDGFDAABOCEEhABAADDE..SDAFhABACEHE..........hADA......hAEA...,1,-23,-26,3
TKNBQOcJLYCDIRFPWVaESdAXbHfMUZGge,HEFHUFDBZABDeFDHKHGEBECF..QCEHODAHJBHFLBHDhAAADBAGFBEE...PEBDhABAaDCAdHABABEH...XCABhAAAfAFE.MIAC....hAEA......hAGA...,1,-22,-28,6
YPGMOJXZVFgWBfCAcQTdDUNaSIbeELKHR,QCGCDDFFUGCA.aDBH..SDCC.eBFCKFFDYAEHhAAAMIFA.OCCDhABAJAAFZEAEFABDBGHAABIDdHGHhADAIAEAEAGALGAEREFF.XGDDhAGA......hBAA...,1,-11,-28,17
FRBfWYVALHUePgaJZTDcSIMEbCKNOGQdX,HAEGUDACeCGBaECAZFEDDDDD..SACF.MBIFCHCDOFHDhAAAdCDDFFACRCEBBBCB.hAAA.fBAEhABA.WHAAAAHGgAGGcDGCEGGFNEEAXGFBhABA....hACA...,1,0,-40,40
IDeJdbOLCVUTYRWgQEfHGKXFSPMaZANBc,BFDGDACBeFABJCAA.dHGBLHFE..UCGCREEC.QFCBhAAAEGAEHAEEKHCASDBGhABAMAIH.aCDEADAH.IADAhAFA..CDEE.YFFCWAAE...hAEA.fCGGhAGA...,2,-36,-21,15
ALCEXJZPFMGBfYDaOdQcSVKNHbRWIgTUe,EDABJADGZECCFGCA..BDDADAAB...OFGFQBFH..SACBhAAAKBBAHEGB.bAFChABAIAHD..hABATGAEAIHALDAHPDFGMICGGBBEaDEE.hACA......hADA...,1,-18,-27,9
aAXRbEYGdeDHNCPZQgOfTcWUKJSLIMVFB,REFHEHBGGDABdDBDHABBCBGC.ZAFF..OHCGTADCUGAA.KBDALFCAhAAA.IHHBhABAMDFGBAABAHEE..hACA............hADA......hAEA...,2,-40,-19,21
IXCNgYbdHVEFGfZDQSKAUWLTeJaBcPROM,UDACLDACeCGBBAFCRFED.OGDE.MCIDXGBH.CACD.hAAANIBF....bEEAdAGBhABA.ECCEFACG.ZAGDDGGEhADASAAHAAEH.TEBCaFDB.cGGDhAAA...gBEAhBAA,2,-37,-11,26
SGfFEZOUJYaBVDHbXMdcPQIRLeCTgNKAW,GEAHFAFBEEEB.ZFGFUDGEaAEH..BCBEDGCAHDAC..XGBAhAAAMHCAdCBBQBGDhABA.IDEHhACALABGTGEEKGGGAIBASAHD..hAAA......hACA...,1,-14,-27,13
dbDVaUIASGRJMZTgQXHKOLcFCfYEePNBW,SGFHGGDHJBCHZDGBQEEC.KCBFOBFGLADFFEBFCDFChAAAEAAH.eAFDBCAHdCHGhAAADABEUGAC.IECDhACAAIHAMAFG..TEDA.....hAGA......hAHA...,1,-13,-33,20
KEceaDSfPTbGdMINUVWBLgHCYJARFQZOX,QCCBOBDGKEEE.EGFB..eGFEDGACSHCC.TEFAhAAAbAGHGCAB.hABAIGAFNAHCUADFBCAChACAHGCACABHAEAB.FEAC........hAAA......hABA...,1,-20,-22,2
BUbMRgGOAdfPEIWDYFeKZCVcTSJXNLHQa,dHBHEHBGDAFEFDFDKGHF..CFDA....VBACSAHB.JBEDhAAALDFC.aEAChAAABCCDMFFDRBGBOBAGhABAAGHA..fADEIEAD....hABAWGAC....hACA...,2,-49,-35,14
gAOWLfDdFeVQTbYPIMNSaUHZKCJBcXERG,OEEGLGEAdCGFFEEE..eBCEVAAFQEAB.TBAChAAAYEAF.MDDFhAAANABDUGAHKBED..JDHHXGFEhAGAECFA.........hACA......hADA...,1,-14,-30,16
CEZQVMPdgfYaBHTFINGDRSKUOLXWecJbA,EGFHQBBH.MAADPFBB.dAHAfEDDBCACHDEAIBEAhABADIGAKCBHLFCHhAAAXGCF.eBEAJCHBCGAGhACA.ZBFBYABGTGGHFDBD.NAEF.SFGBhABA...hADA...,1,-8,-9,1
HVGfBSNWFgLcOKbZECDeITdUYRQXPMAaJ,aDBDJDACHACDGDDBBEDH..SGABFFGFLFBF.KAFAZACHhAAA.EGDEDIDCeBEGdCGDUAAEhAEAYFGF.QBABhABAXFEDAFADNCIA.......hAEA......hAFA...,1,-9,-26,17
MLfNcIgaEVFZBCGdJOTKXRHAeDYWPUbQS,eFCHDACB....PEAEbEGB..SDEBMIDCLGDEhAAANBCH...IHBHhABAgFAAECDA.FDADCADBdAHGhAFAJHDEKBAFXDEA.AGAF.YCCEhAAA......hABA...,2,-25,-22,3
PafLVTEDUYcNSJQAXdKHCeGIBbZOFRWgM,dFHACCAHGDFCBHCFZBACFFCH.RFEA...MIDG..aBEBLAEGhAAA.EACHDAFE.UCFFhAAANCDH.SDAHhABAADDEKFAFeEED...IHHA....hABA......hACA...,2,-45,-25,20
aCcJNfRHLTeSMDGdKAFgEZOUVXYIbWQBP,FAFBECFCUDAD..XDFC..bDDCBDCC.aGCACABDJHAEhAAARGFELCAF.eABGhAAAMFHFDBHHKAGGADEF.OCAGhACA..IHAEWFFD....hADA......hAEA...,2,-36,-33,3
VaYEdbMHSBceCPKNfgLUFJIDXRQTAWOGZ,GECFVDDF.aDBEdGCAHAACBABD..CGEAKAGE..NCCH.LCHDhAAAFGFB.DDAEQFAAhAAAAFAFOFBB.EEHFSGGGhABAPCAB.fAECJAHF...hACA......hADA...,1,-14,-27,13
ZaLDYTQVRGgfbAEOCeFJHBMIPdWXUcKNS,CDGFFGDBHACGBFCF..MDACdAABUDEAKFEG.ZBBGDFDF...QGAHhAAARDAAGAGE.fAGDhABAEGAH.JFHBIFHAhADA...XGGC..hAEA......hAFA...,2,-33,-29,4
VBKXeOSMDRabPWFAZECLQgdYGHNcITUfJ,CCAHLDACdBEFGDCFHAAC...NBIE.IHAEUFCG..VCEHhAAAKCHBeFAG.OEGFhAAADBHDaGGG..bACBWFAFhABAAABH....EGDF......hAFA......hAGA...,2,-28,-21,7
QERUGdVJbOgBfPSWDLYZFKTaXAMcIHeCN,MCCAHAADCAHA..QFBEUGCFGBEBJDDA.OADGBAFESEGHhAAADCAFLFFFFDBBTCCHhAAAAADG..IAHGhABAEGGAdFBB...gGDHWEFE.KGHBhACA......hBAA...,2,-36,-4,32
ISBTZcGUMfXOLYDdQCJgWaAERFeHNVPKb,EEHBRDEDFGGHHDED...VGFAKDBBSABGBHCGZAFGUEBE.MACGhAAAfEAE.hABAXAGBOCBCDGABhAGAdDDGCCHA...JGBG.aEHDADHG...NIBFbBDAhAAA......hACA...,1,-13,-25,12
YFVIOdKcQUMNWAGaSJPTEXHCDLRZBbegf,SDAFJDAC.EBCCHFBE.LBFFBCHAeCFDfGGFhAAAFHAAOEHFKBCGUAGAhABANDEA.AIBGaFFB..XFFChAAADIDA.........hACA......hADA...,2,-31,-27,4
cVZWTCebSOIBNAgfUKREPHGLYaDMQJXFd,UCBCKEHBRBFAHFEBGECDLCBHDBHH.MAAFQDGB.JAFBhAAA...FGHFdGBE.hABAcDEFVFAB.WAEChABACCAG....SAEFIHHCADHGEABA.hACA......hADA...,1,-18,-28,10
QNSGXAfTDOaPRCcZMLYdEBFHUKWeIVJbg,TAFBaEGC..CHCHZFBAMDAALBCF.dCFFEHCABBAGFEEBHABAhAAAKDAF.IECAhABA.JFHBQGGGhAAASBHHAHBAOBDF......hABA......hACA...,1,-17,-34,17
CPegRIaMYdOZATNKBbUFXWLSVfEJGDQcH,KGFCUGGGFDDFLBGH..SDHBVDBD.EAHHDIDAHBBDhAAAeABGRGCG.MHAEOBFBhABAACCABEEDXDAD.hAAAfADEGAEA.CHHEIGAE.hADA.aEGE....hAEA...,1,-11,-24,13
ODeIBgGRAEUZPNCMFWVKbTQJSXYfLHcad,ZBCFCFDGFCABKAED...QAAEJBFB..SFADXFDHLFAChAAAHGFGdHCHDCCBhAAAIHAABEEG.RCGFAIGAEABAhABAUFGF.MICEbCGD.TCEC.fDAFhADA...hAEA...,1,-2,-37,35
TAMeCbScWaKgDVRYFGZBLIXUdJNQPfOEH,CHFDSHBG..aGBBDEFGRCBBFEEFZBEEBHFE.LCBDhAAAUAECdBBFQFGEhABAODAH..EAHFTDCChACAMDGH.bFACKEHF..YADGIHDFNAIEfHDBhADAAIHG..hAEA...,2,-30,-21,9
FRILKEMSAceCZYDQXVJUgNTbHOaPfdWGB,eAFBZDBHQAEA..JCDHUGFETGGEOFEH.aBGAPEAChAAA..fDEEhAAAdACHBHEAIHCGhABAKBAEMEAFADFACGAAXEGG....hADA......hAGA.NAIE.bCCB,2,-34,-19,15
FZWbPRKDLEgUXeQCdOIJSHAaNfTMGBcYV,aHBGTCBCGDDC.BHHEVAECZDAF....PAAGDAEHLAHFhAAAUGGEQGEChAEACBBAdFGDOAFBIEFDhAHASHEANDEBMIAE.FECD......hAIA......hBAA...,2,-25,-9,16
ONBQYIRCcLSFTPUEaeAHZXGfJMgDWbKVd,ZBCDXFGHGFEF.JGBCDDEB.KACBdCFGBGDB...QBFBhAAAIBBBRAGBCBBGSHAEhABAFEAC.TEAChACA...........hAAA......hABA...,2,-40,-36,4
GEZABgUQOIaJRYLCdNXDbfPTcSVMHWKFe,UGGGQDAC.OAHFJADALFDD.dHAFDFIF.fFCAhAAATBCG.VGDAhABAMAAFHABFFEGGEDECZAEFAGAHhADABAGBIEEE.aGGD.CDDC.XBGAhABA.PCBB.hAGA...,2,-20,-12,8
SRUIJbZCgNaBOEMePKHQAXGVfdYWTDLFc,GACFVDAG.dFGF..TFCBDGDHFAAFREFE.UDCF..JBGFCHGG.aHAGhAAABCHH..OBAEhABAEFAG.MICEKHAAAGAFfADEhACA...WAFE.cGGChAEAIHEG...hBAA...,2,-44,-25,19
PKEQFgGaXJLTICWVAORcDUYBbZfeMSNHd,OFBBDHCEBAGDZCCF..eEGFSFHBdDAEKAAF.FGFHGCCB.hAAA.aEAALAHBhABACHDCAHAHRAFF..UBAEfFHAhACA.MFCG.NIEFEBCA....hADA......hAEA...,2,-32,-23,9
CYKfWJZUeNcRgbATaSPDMQIVLXHFGEBdO,aFHBSHFG.MCFEQBDA.IHCHVDCELBBChAAAFCACBGEFdGBGCBGAKFAChAAAJDHDeAFGRDFA.AHDADGEGhABAXDBAEDAA.fABG...hACA......hADA...,2,-26,-18,8
PFbgBfOZQALGHCTKVXRSYWcIJUaedNMDE,LEGHGCCFCFFCKAFEREED..SFBH....WFBAhAAAIFAFUABCeHEEhAEAMAEDDBBB..FCHDBDBAhAAAOHCCAIDG.........hABA......hACA...,2,-46,-35,11
IFUdROZKaXLMJDgBcEfCHTeWGbYPAVSNQ,VDAGQGBC.UEDHRDFHZBCAKBACLHAEDCFE.BBADECCCCAFGHAGHhAAA.eFEB..hABAGEGEPEHDAADHSEAAhAAAIADC........hABA......hACA.FAGA.,1,-7,-30,23
HKSXFVILcTBgPGfQMJEUDYbZRAWOdNaCe,dDCDCFEDKCAFSFAD.FFCFLCCE.BGBEPHFAQGGGhAAAEEFH.DDDDbADChAAAAGAD..OBFAaBABXBFAhABA.IEHAgDGHMCBH.hABA.YABG.hACA...,1,-23,-42,19
AKaDcLfPBXObTRWeZNQSYIgUHVCJFEGMd,DGGDLGEABCFH.XCBHOCAD..RDCD.ZBGF.SAFFhAAA..YADHhAAAIABCUGADCDFEEADFdDHEAIAGaEDEhADA..PFEDWHFA......hABA.eAFE...hAHA...,2,-29,-29,0
EgeFabWVBPCAMTKGYZLJIcDHQUNfRXdSO,TAGDGEAHZCAA.LGAGJBDC.DFGHQEAGUAED.fGFBhAAAdAAHSFHDhABAEDGAeEDDaEHF.VBBHhABACEEBACIFKGEFIEEF.NIAB......hADA......hAFA...,1,-5,-21,16
eKWHGLTdNVgaMIAUYCJBREfcPbXQFZODS,CHHGJFCABCEB..EGAC....PEABXCCBFDGA.ZFFDOCAGhAAADEAH..eBFCKADCHFEDhABALABGdGCEVDBEhACAaEHFACIH....YHAGfHAFcCAFhAAA.....hAGA...,2,-28,-23,5
PbXKMRCNEOYFUeSWHcBTdQVGaAZfgIJLD,ZAAD..fFFBJDDELHFADEDDXGAGREGB..EFBCOADDhAAAFAFB.SDAChABAHACFBHBGQCGHhACAaAHDAIDE.IHEEKEAE.CBGCNAFE...hAAA......hAEA...,2,-25,-16,9
ZfPOebARBNYWLFVQKJcIMEaGDTHCXUgdS,BFDD..NDDGLBBGQCCCKFHFJHDG..MIACECHFDBDECDBD.hAAA..UDAGSABEhAEAZEFA.OAGHhAFAACAARGAEFAAE..IEFFaGGF.....hAAA......hADA...,1,-27,-35,8
LPIMJFZeNYdERgDXbSAfcHBWOVCQGTUKa,HAADBAFBOEACQEAGUGDFLAFA.IHEBFCGBeCEBhAAAdDDHRBAG.DCHB.XGFFhAAAADAF..WBHBhABACHHEKADD.MHAG........hACA......hAEA...,1,-13,-45,32
HTMFBEYCVbRUKPJOZefdgacLIANQDWXSG,QAFBDAFB.SEDAGEECTCAEMCABBAACCHGE.RGDEKEBEhACAJBGHZGAE..dCHAhADAaACHIGAAACEH.hAAAXGGHEEBF........hAEA......hAGA...,1,-25,-36,11
fKNQGTHLWDIaOEXFBScCbUJYVdgePZAMR,MECGRDAGKGHHGBBHLHAG.DAADOHCA.FEECSFBDhABA.CBDEUEGBJAFCdCGBeCAAhACAAFDF.QFDAhADA.TAFCIAAGECGABHGEcFGB.hAEA......hAFA...,1,-14,-32,18
cLegOFXKIbZVJURBWYPGaDQSNfCEMTdAH,HFDFLEEGeAECFFAFKCBCZBBBUGBABGGF....PDEGDAHBSCFGhAAACGGH.MEIBhABAAABAODAB.bBFAhAAARGCA....WADEaECGfFFFhADA......hAEA...,1,-19,-37,18
gXFQKPbGNaJeYMAEdISHORDBZCVfcTWUL,EAFBdAFBSFEAHACDRFEGBDFAZCCH..CAAC.VCGF..TEADhACALCAF.FAAEKAHH.hAAAPHCCbDBD..aBEHhADAeCEFAFIHDIAA.fHGB...hAEA......hAGA.WCGH.,2,-17,-9,8
WDeLSJBTNUZGIVXQPRbHKOafdEFMcACgY,CFDG....gCBCDGHFeDCFLHDEBHFGUEGGZABAGGAHhAAA.VAEBXAFGhAAAPABA...REDEbAGFhBAAKHAGaEFB.fDAE....hACA.dCHA.MFIFAGDG.hBBA...,2,-20,-10,10
OFZXcMEPAgeDTaWIQRYJLbKHSCdVGBNfU,eFCHaDAB.QCFARECFLEEBHBCF.CGACdGGFBBCGUAACFBGBZEGBhAAAMADEEGAGAEBC..DFGCIBEDhABA..JEEFhAHASDBHNAIE.......hBAA......hBCA...,1,-12,-27,15
cEBNJRLMabKFfSCedUAWPQZHXOVgGTYID,QCBCHBCDXBFDODHHGGEF.IDAFDGAAEGCABEADhAAAJFAHLFECMADGaBAHKABDhAAAFDEF..SDGAhACA.CHCF.........hADA......hAEA...,2,-35,-10,25
AVXIcMGafRLKSYPHUZNbJTgQBCdODeWFE,XFDHMCCAGEEHRBBC.LAGHKHAE.SGCCHDDGZCGBNABHJADChAAA...QCAChABABCFBCHHHDEIBFGHFAGGF.IDEDhACAaAGE.PHEC.....hAAA......hAGA...,2,-29,-4,25
ILdHEPQJRFNgVOMTDBSfXUKGZCYcbAWae,eCCHdDCDEHEGQEDA.RAAF.NBIGOABATBFE..BFHDXGBGhAAAKCHBCHAF...bFDAhAFAAEBFaAFG.LHEAhAAAPBFD....gBBEDDAB..hAGA.fEBEhAHA...,1,-14,-31,17
TJSMcdUQCDbZLgXFGKNAaERYPBeIHfVOW,aEHBECFCRBBCBECA.HGDCODGF..TCEFMAIBdAAF.UFCEhADADAGBLEADFAFC.hAEAKBABAHAAeFHHfCCFhAAAJFFF..SEBDCCHB....hAHA......hBBA...,2,-27,-17,10
TfGaAJQDLFSHORWCcEeIbNgYVMUXdZPBK,JEGHQEGDLFCESADGHAGF.RFCA.CDBF.eABH.IHBBhAAANCAD..gGABhAAAMEAAUAFEdADDBDDBhABAKCEG.fDFFAIHADDIDFHEE.....hABA......hACA...,2,-24,-10,14
IWdcUZTCGVXebRYSQaJOBPDEfNMgFAKLH,KDBDLFBBHDEAdGDGZAFCCAAFGACF.eFABRDEBSBBC.hAAAQDGFOAHHDDCChABAEDCAMGFA.ACAGIHHDhACAUGGAXCAC.aHDEBEHANCCB..hADA......hAFA...,2,-18,-7,11
QaWFGXeScEfOUYZgHRdBNICVDMPATLbJK,TDACLEEG.KFBAQGABFGGGGACGSEDC.EHDEhAAAOAEEZDGDHADGRCADBGEBhAAAICCGDHAAMIAGhABAAFFBbGFA.aACG..eDFCcBGB...hACA......hAEA...,1,11,-24,35
LbGfCWJcKFQHTBgXDSYVOeMIdZRaUNAPE,LCCHGAFECCCH.JEFDFAAHHBFEBDHE..DBBC..VFFEMCEHdEBAhABAaFAF..AEDF.EHDG.hACA...bBDBcCAAhAAAKHAE....gFDFSHGC.hADAOADG...hAEA...,1,-20,-29,9
BbMKaJfSWRCQADgHGeNYcZdFLIPOEUTVX,HFDGeFEF...NBDHZCCGFBCGLGAE.IHHBEHCAUAAC.hAAATCGCXAEHMFIDhADAJBHF..SFABhAEA.CECADEEAYDDA.PEAChABABHADaAGAfCAAhACA...,1,-6,-36,30
NPeAdEJFHafKGTDIVQXWCUBcYbLORgZSM,dEEDEEEDFHCAaCHD..KHACDGAC...QAEGCCFEBHHG...bDFEhAAALAEE.RAACSHDEhAAAPDCDAFHFfBHChABATCCF.ICADVDAB.UGGBhACA.OBBGZFDC..hADA...,1,-18,-20,2
GIUKXbgAMQSZJOEFcRNCfVPBaYWHTeDLd,QAGDSDBDZDCDJAAF.FAEH..RFCGCHGG..VFEFBAEAaHBEHGAEhABA.DIDALAAEhAFAGDCBKEADbBGFABCDOFHDhACA..EGAEfFFB...hAGA......hAHA...,1,-14,-20,6
DYEOCSXZVPNBRWJLFcHAIaUKGgQTbfMed,UGBCGEAHQAFC..fDHAdCAGDIGEEEGDSCAHhAAAZFDH.PFEFhABARCDELABGFAHFAGBBaGHB.hAAATACAMAIF.YCCG.CHCCXDEAhACABDCD....hAEA...,1,-16,-17,1
JPGcAUTESDgYXWLNCeHbaIdZRMBfQOKVF,UFCAEFHBDIAG..XAFALBEE.eFDHaBCH.ZEAGBBDC.QGFHhAAAVABDFFFB.GEAGhABAAEIH.SEGGhACAWAHH.NAIECDEB........hADA......hAEA...,1,-23,-29,6
TNabZcJWKMUIACVegEPXGLOdRFBQSfHDY,CEFAVFDF..ECHBGEAALEBGRDFE.FGAEBDDC.QBAEhAAASEGHDABCTAEDhAAAaHGAZADEJBCF.KAGCMCEGhAEAAADGeCAF...XGCD.fGHAhABA...hAFA...,1,-14,-19,5
OULQDaNSGZWXEeHCdgJFIVbYKBMfPcRTA,OFCAUDCHQFGGDBHF..SCCHGAAFZAFDEEAFCDHGdHBFhAAAFABF....bGFEBEAGhABAMIEEfFEAhADA..RADAAIBAaFBENAAEeDHH...JGAGhADA......hAEA...,2,-17,-17,0
eWGVdZAYCgTDOXHaEISfLUMQFPRbJKBNc,CFDGTAFBDGHF..HFEBEEFG...SCGHLEADUDDAFAADRDACKAFGhAAANEIA..eHCAGADEhACAdBBBAGGAOHAE.hAAAaFAEICHC.MACE.PEBDhABA......hAHA...,2,-18,-14,4
GIDSgXPYNFVQdeMKCcOTfHUABJaLEWZbR,aDABEDCDZEGBGDEF.DHCASDAB..gCCHhAAAXGBB..PAEFNACDFBFBdHGHhABAeDDGKAHHCBCDcGDDhAAA...........hAHA......hBAA...,2,-28,-20,8
UadGReNFOVXQbJBEIASDWTZgfPYLcHCKM,SHFGDAFBZDBG....PHAGLDACHDGDMCIHdFDDRAAFFEFEhAAA.OHAEQAGChAAABBBCAFBA.TFDEhABAfADGCCGHKBEG.........hACA.aGGE....hADA...,2,-27,-20,7
eTHPMFBOEDWNUdXfIZbQaLJAKCgVYRGSc,CFEDVAADGCAE..eEFBHCCEFDDHBFCDDCGD.UAGG.dFHGIAGGhAAAZGDEQAADhAAA.JADAAFABKADC..hACA.YEHB.SHCETDFBMIEEhACAEFBG.....hAIA...,1,-4,-39,35
SaTfBDJERdbKGAPIWZFXNLVHgUeQcCYOM,..IFDGZDAGFDGDLBCGHGDCUEABQFDECCHA.MAGFhAAAaCBGBFFB.JACGEGGChABAdDDB..KBHHAHHAXGADhAAANIED..gFAC.YHAGhACA...hABA.SAHFDADA,2,-22,-14,8
KTUXFdBQOZaDSMAbINGCgHREJPcfeWVLY,..IFDGCCABHBECJADE....PAAFeFHBLDDFhAAAKCHHUFGAdDCHBHADZFABaEFHMAFEhAAAAABC...NBEB..hADA............hAHA......hAIA...,1,-30,-40,10
cNYLFJIUCKObMDEPBTeAfaXSgQdZGVWRH,XGBCQGBCGEEARBFGHACG...NDCH.FCBB.JACECAHGKGGHMBAFhAAADDIFBFDF.eBFEhABAaDAFdFEAZCFA....hAAAcDCGIBAG.......hACA......hAGA...,2,-21,-19,2
MSHdegWbIZXVPFBADQcTRYUNOLCKEGaJf,DAFBQCGCRDBG.UECFOABEKAFAGACG..aDHDMICEhAAASCGFdFHG.eFFGhAAA..WFADIHEHhABAZFFHXBAFFGBGBCAGAEAA.....hABA......hACA...,2,-36,-17,19
UBdRXZgACQceGbJLIOHMSNYETDafWVFPK,QGGGGECFLBFAOEEHSBAA.EFAHTDAHhAAAaADH.VDFAKDEEdGHCXGAChABAAABGCGBHeHDAIBGFhACAMAFCDDHFWADB.FFBEBEACgBBEhAFA......hAGA...,2,-14,-5,9
dFVBCZfAMUXbNQDWaRTIPJSEKYLGOgecH,UGABXCBCQABEDFGB.RBFG...IHHCSFGGKAAFLEEDhABAGDBHeGEGhAAAdGBCFDGCCAEEAEIH.MDAD.hABANCCD....WAHBaHEC......hACA......hADA...,1,-16,-32,16
cObJWMdNURfPICSZXVDFGLQgYABeETHaK,EDABaDAF.KECC...OGAEbAGB..MDDGdCCBUBGGRAAE..PGCEhAAACEFCZACC..DBBDFAEDhACALFGHQEEEhADAAAACBFADeHFAHFDE.......hAEA......hBGA...,2,-21,-15,6
RELBgGKYeCPVTIbNQAafWMHXFOSDdUJcZ,aHBGMCCAHCCCFGDC.DIEAdAEF..UFFEZEFGLDBCBBFAKACC.CDFE..hAAA.TBAH..hABANIDFAAACXBGD.hACA.SBHDJFAA.cGGA..hADA......hAHA.EFBH.,1,-25,-37,12
BZLVUNGQMgWbdDcHSKRfTFOaXJPEAYCeI,CAFBeAFBZGDCLEADUEDCGCAD..QBGHMCIF..bGFAhAAADFBAHEAASEFChAAA.RABEFFGEXGAEhABAECCDABABBCEF........hABA......hADA...,2,-25,-11,14
BLKFJWadUTgGeYQZXMbSVPcIANRDEOCfH,DHCECDGFHACGBHGGKFDEFDBH....JHFCaDFDUFAB..GACAhAAAQDABMCAHSGABhABA..cAABhAAAAHAH.ECCELFEAdEHA....hACA......hAEA...,2,-42,-26,16
RVMOPcNLHbDEZBWCGeTagYSdUJFIKQXfA,MGCEOGEA....NEAG.LBHFHABADCIDECCBZBEBCACBGBEGhAAA.aHFCSGGEhAAA.dHFBFGBGIHDEhABAKEADXBABACHFPEFC.BCDCeEBG.hADA......hAEA...,2,-25,-14,11
UgSbENXWVYdDQZHTCRIMaeFKLGAOBfcJP,OAFBBFDGJCBCUCAE....SGACEFFF..XGCBhAAA..VFFChAAADGHBQDDChABATDEGCEBBMAFCaCHHFGADGACFcAGFPHBE.NBAAdBHEhABARABE.....hADA...,2,-25,-15,10
VGJPNgFaWXZBDdSCAHIEbTYOfKQcLRUeM,HDAGEHBG.TBCAODBCQFCELBCCUAGHeFECMIFAGEDDhAAAPAFCFHGAaFACXAAFhADADDGCCHEE.AIDEICHHhAEAfBAEKFAF........hAFA......hAIA...,1,0,-14,14
XFfHVOMCJTLWISREBePUNgdbZaYAQDGcK,GACBXGBCHEFH.MFIBCAFELDBA.SACBhAAABFAEPCAEUDGHdGCAZFEFYFEFhAAADBCDFGHDOBFBhABATCEE...WAHFEHACeAHB..NEAE.hAEA......hBAA...,1,1,-20,21
fVYcQPgJZUSEARDGHFOXeCWLMKINaBbTd,DCHDHCCHFACGeBAHLFFGMGFGKAGG..aHFATFAA..fHBFhAAAVCFC.QBEEhABAJHFASACEhAAAAEBBRFACGDCFCEHAIEEFBCCE.....hAFA......hAGA...,2,-22,-6,16
DFCSRUBHEMOWTPeAJfXVIgLcYbdGaZNKQ,JDACVEFHLGDG....bFBGGEDDaDDD.ZAEAKHDEDCGFCECC.hAAASABHBBCFEADE.hABAMIACOAFG..hACATFAAAIHA.IHHE....hAAA......hABA...,2,-33,-28,5
TXCWVSdQLJObUIaAfYcePZMKDFHGBgRNE,...fHBHeGEAMIFEFABGBFBE.RADAEBGFCEFGSCFChAAA.dEGELAHBhAAAOCDHIFAFaDDCADABYBBDhABAPAEAZEDEDBEBgGABXGDFWDBBhAIA.....hACA...,2,-20,-17,3
GgHMBNfVPDIKJdSWEaCbFeRAOQcZYLXUT,ODACZEFHLDECUBCEGFBHMCBGBHBA..VCFCDEIBKAGAdHGH.hAAA.EAFECFBB..FACEAHAB.hABA.....YFEChACAgCAGNIBF.IAAE.SHFGhACA.aAFHhAGA...,1,-14,-43,29
FIOVZBASDXGJRYQeKTPdaUMCfgEHcLNbW,XCBFGGDHJFBFRGBE...eABCKAGEdHGFMECA..CEAH..EDEDHDGFhAAA.LAFChABA.NDCDFFCAOGDABBDAhBAAADFASACE.YAAD.hBDA......hBGA...,2,-34,-13,21
KZFXeMcbVETDfdQWGRLJAgHINCSBaOUYP,HAADCFDGBEFEUGGE.KGDFFCAF..eCEHMAEG..VBGHDHBAdCCDhAAAGACG.RFADAEAD..hAAANHED....SBGChABAaGEF.OBBA.....hACAZCFA.....hAEA...,1,-14,-44,30
WFZVXbdLOPBGYDINEQgMUJCfTScaRHKeA,FCFCVBCDdGGH.LHAEBBHEGEBADFEE.EABAQACB.hAAAMDADJEFACGHF.SHDEhABAaDECRBAB.eFADhAEAADDH....ZFBAXBFH...hAAA......hABA...,2,-25,-21,4
dMNHLVUOKTYScCXPbIfaFZQBgDJWeAGER,ECAHdHDDMBHBLDFGUDCGOBBA.KBGESGAA.CABG.hAAAXCCC.PECChAAAbAEB..IFFDhACAFHDEBFABDBIFeHAAAGED.RFGFNABFHDAD..hADA......hAHA...,1,-7,-31,24
NcDGUaAFJREZPHQgfSbYeLdKVIXOTWCMB,FDBDJDCHZGFAHAGB.QADA.SDEAeAHDLBFHhAAAKFFB.VABCXFDBhAAAOGACCCAFMIFGBEAHDIFAhABAaGBEADEGEEGA..........hAEA......hAFA...,1,-15,-29,14
YHTSLIOKAFRNQPgMdDJWceZfBCXGUbVEa,FCFCQFDHMFIF.DAAG..JBACeECCZGBGBFACXAFD.UBBFhADAEEDHHADE.LFGHhAAAOFBHAEHGNDAF.gGGFhAEA..cGEDCFFB...hAFA......hAHA...,1,-22,-26,4
DYNVOKRPQUfSWgFEJdBcbLMCHZGAaXeIT,aGDDXDAC..TDCCDCFH..VBCFKADFQAADhAAA.SDHDhACAFABBEGCBdEGABBGEbGFGMEEHhAAACEAGGEFAACIH.eHACYFAB...OAGFhADARBEF....hAEA...,1,-6,-23,17
ERUIMHYFdfSeaGLWZQKAcPNTVbJDBOgCX,...PDEHVDDDDHAEBGAC..ODABCGBHRFGH.MCBCFGDHdDBFeBFChAAA.GCGELBCGhAAAZDBFAHHE..NBAEJDFAEABEIGFAhADA........hAEA......hAFA...,1,-18,-32,14
eaXYUNGAgWJOBKCFfTbERLDPVcSZHQMdI,JGEAKDABFAFG....TDFBEACBRCFALEEDDAHD..PEBHhAAASAAF.ZFFBhADAHBBDdHBH.aEDBXEBDhAEANIEBAEAB..gADEBDDCCBBD...hAIA......hBEA...,2,-29,-22,7
MECRGadQIgLfHVBUKPWbNSYJDZeFXcTAO,EFAGCBGFRFEE.dDFA..QAACLADAVCBBBBEE..KHCA..bEGDhAAASFHH.hABADAFEZFCBFECHcAGDhACAAADF.MIFEaCDCICHF....hACA.fEAAhAEA.PEFA.,1,-9,-31,22
NCTKGPbWSfORXHQFZEIBMcYaedgLUJDAV,CFDDKCBBGGEF..PDGHSHAA.RAACHBEFZAECBDHEMADEhAAAaFEFdAHEUFAG.AHGE.hAAANCCE....WEEGhABAXGCH.........hBEA.EDHDIACAhABA...,1,-7,-49,42
bTVZdEWRXIDGCKfgBYHLUMOcPSJFANaeQ,eCCHQCGC..TFFDdAACEADCXADEDGDFGBEC.CGHCKDDFhACABBABHDAFUDFFMIFChADAPCAB.FGBBAHBF.hAGANIDH....aAGH.......hAHA......hAIA...,2,-20,-15,5
MLQINTEKOJWBgVYedPZbDRaHfUGAFScXC,FAFBXGBCLCAB.QCFATDAEOAHFBHDF..VGFGhAAAeDEBZCDHDGCE.RACCaAGHhAAAHABEUGGCSHAAhABAMFAHIEHFKAHB.gBAE.hADA......hAEA...,2,-13,-1,12
HJREAQUMCOcfagVSLDNZWKFIGebdBTPXY,UGFBOHAG..aDCCVBFDLCAD.DHCCZCBC.KEGHFBGDeEBGhAAABEGA..TADGhABAXABA..YFAAhACA...HFEFEBEDAEFA.MAIBCHHA.hADAfGAA.hAFA...,2,-38,-16,22
gPcAMSEeRFVLfBCHGYONTQaJUXDIKdbWZ,EHBGeDCHFDFBLGDG.BHBFGDABOAHFNHDH...TEEDhAAAJAHHDBBGKBAG.dBDB.hAAAZAFFgEGChABAAHAB.MGCGSDAHfCCB.CAFF..hABA......hACA...,1,-23,-25,2
TQgDYEdRISWCGOUZaefXFPKbJVcHANLMB,MDEBQABHDDHF.EFAGdGDD.RCBH...SEFCGACH.ZGBEhAAAeHAGFDDBKAGF.JGFEhABAcFFAACFH.NIEF..hADABCAB.....YBFGCAEEaAHF.hBAAfFAB.hBEA...,1,-22,-24,2
QTAEPIWOVbJLcYMSFdKNfUBHGeCgRXDZa,EHBG..PAFBODBC..JCBALAEAMEID.FDHHKAGCNAAEBCBFhABAHECFCGGG..XFDBhACADGFDZABA..aEAHAFAFVGFGhADA..YEEA...fCHAhAAA..hACA...,1,-21,-33,12
TeUWDGdKBPaHYcEFgOIfCMRAXQZLJNSbV,QCCBJFFC.SHGATCCDeFEBDDBHGCGABGBEHBFFhAAAEFFBFABAOACC.CBADAAIFhABAZAFD.LFCDhAAA............hAEA.NEEE.bFCD...hAFA...,1,-15,-29,14
TCNQXWDbVgALEROUdefYISJZaGKBFcMPH,LDCHEDBDUCGC.eHBE....fGDHIAABZBDAKABEFFAFhAAAMCAFHGFACGEG..hAEAQAGFDDDD.hAFAgFGEACCHdHADSEFGaEFGBEBG..hACA......hADA...,2,-24,-22,2
FVdTLaWUSecKBJMYRCXHDgAPGIbfNQEZO,GAFE..fBBDEFBHFAADdFGFLFEHUDBD.SCAFhAAAKFEFBHHB.MEEACHGGDIBGhAAAPGBE.IAFChABAQADFZBFGTGGAeAHB.cEADhACA......hADA...,1,-22,-24,2
cdMBbZDHRAVQEXPgWaGOCSJLINYKTUefF,EDAFXCBC..PEDFaGEE..OCEECFGBLCFG..hAAAIFBHNBAF.TAEFhAAA.eBBEcFAEhABABFEBDGGFAICCQEGA.WEADhABASGEH.KDCChACA.FAGG.,2,-35,-19,16
BNUafFGbQMgTXDYdHLWIPVRAJEecCZSOK,EGDBeAFBZBFGKHGABCDFUFGF..FGFGGCDC.MBHFXABGhAAADIDCHDBBLFBD.hAAAIAGBPABCABABCAEEOEDChACAaHAA.fDAA...hABA......hAEA...,2,-25,-18,7
GOPWKVRfYbDdJBQIUcFTANaXgSEMeCZHL,XGBCSAFB.EABHeEFE.ZCFCLEHHOACG.KCEARCCF.fHDHhAAADBBHBGGFUAGEhAAAFFFFABDG..aECFCHHG.HEABhABA.PAHF.......hABA.WFFF...hADA...,2,-25,-17,8
PGfFURdVaESBNcgHCZeMDLTXQIYbJKWAO,GECFUGBCRBED.dEAC.EACGBAGG....gCCCCFFGeHEELEBEhAAATCGAQBABhAAA.IGCHhABAJDHBKABBAHAAfGHA.FBFGaBDH.hAEAcBACMIAEDGGF.hABA...,1,7,-44,51
fDdcLHVgZKREYQGWUTXPFCabOMIeAJSBN,BDGFDACBdCEEHBCHZFGD.RFBAEBAFGAEF.UDCCXGFG.CAGH.OBAHhAAA..IEEBhAAAeCGHSHAAhABA..fEHAcGDG.LCFEhABAKFAG.YEADhACA...,2,-30,-20,10
XeKJFgUCAGaWMdZBDLfbSIHEONTcYVRQP,aGAHMHFGBCFCLABA..SABDEFCFTBEF..VEGBhAAAPHCC..eFAGhACAFFFACBHFACDAdEEEDDCDIDDAhAAA.OCAD......hACA......hADA...,2,-41,-22,19
LgICbTSMRXUQeOJWaEVYdNFDPfHZGcKBA,LGEACFDG.TABDMFFEUCAE.OFAHaEBDEDGH.VCDGhAAAdCFEDIGA..fDAEhABA.HAFAhADAZBGHKGGABFFDAADDbFBH.RCDF.eHAC...hAAA......hABA...,1,0,-33,33
gQUERcNLTGKfZHeDJOBdSbMPFAIYCWXaV,CFDGaGFC..QAACUBGDRACG.LDECKEHBHCEBDGAEBAACdHFBMFEEhACAFEDH.AECG...ICAChACAXAEDECCGNCIG.hADA....TFAGfHAFeHBC.SEAGhAEA..hAGA...,2,-32,-16,16
RMQOANaHIBgESfZTCULWXFDdPbYGKVJce,aCFCBFDD.SGADZEEBCGBB.LADFFCBADECE.dDHE...PABDhAAAGACF.KAAEJFFHhABAeDHHMAFEAHBB.IFBFhBAAEAHBUGGF..XBEE...hADA......hAFA...,2,-29,-22,7
MLJOaPfgSDbYTFECeRQKHNBXGZVdUIcWA,JAFEaDCD......PFHDfFGFDDBD...TCAAhAAAEACEeEGFKACGHFDHBAABXGEDhAEAZFAHUCFBIDDHhABAACCGMHBGOFABbGFECGCD.QCEBhAFA......hAGA...,1,-7,-25,18
PeaZDgRBEcVWSULTJKXNGFCQOfMHdYIbA,aDCDDHCERAACBGFA..EECB..VAEHUEGALAACKAGE.GEAAhAEAFFAB.CHHC.OCCChAAAHEFCdHCB..IFEEhABAAAHCeBBB.....gAEEhADASEDH.....hBIA...,1,-8,-42,34
bBFKJDXNYdQEgTfaSMVPZRHCWcOeLIGUA,FEGDDFDC...XGECdBFGEBGC...TBDHSGHH.VABBhAAAPAAC.RBFFCHHAOEGHhABALEACUGAEAADEbFBDhAAABHDB.JCHB.NEAB.......hADA......hAEA...,1,-16,-27,11
GUYHITROaVcQKSfEJAZMNbgedWDFLXBPC,ZFACMCCA....gBEHdDEBDEFHFHBGBDCHCFAE.UFEDHBAFRDFE.hAAA..aACEQABChADAKGGFECGE.AAHGNICDeEHDhAAA.....XAGEYFHB.IBHFhAEA...hABA...,1,-18,-29,11
HbVfYKdgGCJeaIcFRBDSLOWNMXTZAPQEU,EGFCHEFH.VCCFKAGAGDCH..eFDHIBAGFFBHBABDDCGALGAEhAAANAED.MADChABA.ZCFAACFCPFHDhAAA...........hACA......hAIA...,2,-29,-29,0
JYPMdXGQLbBSOCfDaKZRVcNIFAeTWgUHE,eDACTCBCUFAF.HDCCECHD...JGEGMFIFdBFAGAAFQFCEhAAABHHHCHBFDADFKBHF.RAEDNBAGhABAAIFE.....YEGHhACAXDGASEEH.aBGA.hAAA......hABA...,2,-22,-5,17
bMFcWACSVEOXUKQBRdIPgfNHJDZTYGeLa,SGFHVDED.ODCFKCAABGHB.dCEFICHE..hAAAgFAANBEE.hABAJHBETFAD.YCAEhACALEACbAFFFABAAAIFEEGE....hADA......hAEA...,1,-27,-36,9
VXITeZPAOdQURMGbCBcSJEDNgFLfHYaKW,dAADUCCBRBFFGDCGBDAA..JACAEHAG.DEIFFEHFHADD..KFECXGGChABA.IFADhADAZFABOAFG.QGCBhAAACCHHSFFE....gGGEhABA...hAFAYDFE.,1,-8,-40,32
IXYDMFSRGWgEHPBVdTQcACaeZUNJOLKbf,eCAFUFDHOAEDKDEF....IHFDXAGCDFBC.FBGDRCAHGCGChAAA.EDCFBGBBhAAAdABF.QACDhABAAHHECHAD.NEIALGEC.....hAEA......hAHA...,2,-30,-27,3
WKPUeRFGDTNCEcZfaBdXVbQMYILSgHOAJ,KDCDUDACFBAFGAEB.DAABTFCH..CEGDEDEHZFFCBADF.hABAdBHAXCCBQAEEhAAAMHCG..YHEAhABAIGHD.SDGEOHACJEFA..hACA......hAHA...,1,-24,-33,9
RGdOJMSBINQKTEYWHXADCUbLePZaFfVcg,DEFAUGGGeCADZCGBFACD..VECBRFCD.dBGG..MAEBBFFA.QGAHhAAAEFAHHAFECFECLABChAFA.aHFGfCABhAAA..cBCF...hABA......hACA...,1,-22,-30,8
beFZfBGXIODNHALaSUMWTdJRPQgVEcYKC,LEGHSFAAUACGMBABdAHE.RFBF.QEGB.EBBHKAADhABACAHF.FEFHBFDBXAFChAGAIAFCDDEAAIHE..hBCAWBFAJHDA...PHDC...cDADhAAAeDDD.fDDHhABANDIE,1,-27,-41,14
TMdgAPDQBJfIHEKeRGSZYVFLXONcabWUC,DAFBBFEE.JFADHDBG.EHBCKAEDRBAAGFDHZAAC.FAHDLDHBhABA.OCCHNBGG..hACAaABGUGCBMEIFAHHE.PHFChAAA..IHFESGAF..hAEAXAFF.WDFBhADA..,1,-13,-39,26
LFdEfaRCHVXOeAgNDBPQYKSGWJMTIbUcZ,DACBQGGGKGHBGEAEJCAC...MEGFTECBUFDA..ZAFEdCDChAAAECGGRAEA.HFEB.XADFhAAAAADG.BHAHhABAPCHDYEEC.SGAE.hABA......hAFA...,2,-34,0,34
OSHKDJaCGXUAgWPcRNBEfYMITQedZVFLb,...PGEANCCABCAG..ECABMAAC..QABAdBHAZAEHFEHBhAGAOAFCKEEF.aEDBCHHHGGBFhAHAAEHF..WAEFhAAA.fCFH.IEFAhABA.eHAGbBCBDIAA.hAHA...,1,-26,-28,2
PESAXOIBgKcGNDJZFfYaHbedWRQMVULCT,XDACOAFBBCGDKBCH.GEBE.DAACJEFFZFECFAAF..aBCGeDHHhACA.dAGFQDDDhADAMFDHUBFFCHEEEAHFAHIH.hADA..IEAF..cGECNDIE.hAEAHFAF....hAEA...,2,-22,-16,6
WCPMBURbeHEFagYNTXLVQGcdJAZODIKSf,OAGHDGHHKACG...SDDCCEAABDDD.RGFAHAACFGBC...aEBDhAAA....gAGHhAAATEFELEADhABAQFDBcADAAIFEZBBCfCHC.hABAMIBAbCFAEAEE.XEFBhACA,1,-22,-34,12
GJMeKZVXEFIOSQaCTWfYHNRbLAdcUgBDP,UGBCBAEDGCGCeBCBZGFEEBFF..OAABaAFA..CACG...fCEHhABAHDAAREDDABIFdAAEhADADBHFJEEBMIDG.KCCEFDBHhACA..IHHF......hAIA......hBAA...,2,-30,-16,14
gUASHbVDMZefGXWEORKcFCINaJdTBLPYQ,SCFCHGFGVAACZFDHeAEF.GAAEEDGGKFFEFEFE..CGCF.IGDChAAAaAEF.dGAFBHBGhAAAPFHDQAGChADA.ADEADCDBXDDG.WHDA...hAIA......hBEA...,1,-12,-16,4
QITDbOMNZSFgPKRafcVGeECLXUWdBHYAJ,JDACQCGC.DBADMCGBZAEB.FBGAKEHBRFCG...aGGB..VAAEhAAAGECB.CBBCXEABhAAAdGACBHEAAHDBIBDAhABA..OAEDSHBAfHGBhADA...EDDE.hACA...,2,-31,-28,3
eJcROYEZBVIMgfWPUQGaLXFbNHTKDdCSA,eEEGJFBB.RDAF.OCDAEGGB.BABG..MCDE...fBHAhAAAUGFGQDFAhAAALACGFHCEHGBGTCAGhACADAGACFDEAFAE..........hABA......hADA...,1,-22,-40,18
XfYDVOLdbNQWBFAEGUZgTMIHaJcCSKPeR,GBDBZEFHMDAGaEBD..CGCE.KBAEREAC...XGFFDIBCLBAGhAAAdEEFQGDCFAGB.hABAAIAGEEAF....hAAA............hABA......hACA...,1,-28,-48,20
WYLTbPfMHVGFecZDABKNSEIXOJgCRQUad,KEGDSAFBEDBB.OABCCBBA..UEDAaFGD.dGAELHAEhAAA.TEDAbADEMBAFhAAAHCFG.VDAHFHGAeCDGhABADIEGAADEICDE..JAHF...hABA......hAHA...,2,-23,-13,10
ECSHFBfDLPIYdGbcKRZNXAWTgaUJMeVOQ,TCBCUGBCeBCB..QDGASFFCBGAGDABDLBHBhAAA..PGBGhAAAdBEAGGEFbACAKGGCNACBAHAEgDEDhABAaEEB.MCAFEDBF.....hAHA......hAIA...,2,-15,-15,0
DJLZEXFIWgBVGObdeRfNHSCYTcMPQUaAK,JEACLDCHZDEA.FBEF....IBDHBHFDVFFGGGBBdACAeAHHhAAARAAFHAFF.SGGAhAAACBAF..YEEEhABAMFAB.UFAEAFFFDIFEEGDF....hAEA......hAFA...,1,-17,-22,5
KfGNJeAIPXOZdFEbVgMTSWcLUDHRQCaYB,XCBCODCHZEDFFACE..EGGB..VGDGMFAB...SCBFhAAALBFBDAAERADBaFGAhABABHAGKBHD..fABFhAFANECEAFAE.dDGDbDGD..WFBD..hAGA......hAHA...,2,-33,-18,15
UgcCWGJZTAEPHbKdVLSRYNMXFIaOfDeBQ,ECFCHAADdGABLBEB.SGAFNBEC.FGDCaBBEDFGCBABGhAAAQCGEUEGACEAH..hAAA.JEAGAHHEKCAD..hACAYAECIHDHfHGH..hACAcGFCWFFG...hADA...,2,-37,-23,14
KDBTWZdIONQafYEVFgSLUCXeJRGAMPcHb,MCCAHAADDEAEBAGCZFGDdDAHOAGH..aFEAEGEHFDDBLEDChAAA.CFCG.JFBDAFAA...hACAPAADbADB.KHEGICCFhAHA.NAIA.fEGD..hAAA......hACA...,2,-48,-9,39
OXcYVTEAeZaRPgFSdUDGfJHWMCbNIKBLQ,eDCHaDAF.RAFC.FAFFdGGBDAAGGBAG.HEEAMFCACCHF...IEGFhADAKFAFBHED.QACHhAAAOBCC..YHAEhAEA.TGGCAIAA.ZCEESEGEhABA....hACA...,1,-17,-30,13
WbCRGQacUSJIKLMAYeXFfOdPVEgZDNBTH,eDACFGFCOCFGdEFGECHBZBAH..BBBG.HFDBCGBHQDDBhAAAUAGHJHAA.LACA.hAAAMEAFACEBfHGBhABA..PDHBDACATEBC.bACAaGEHhABA.SHBAhADA...,1,-8,-29,21
XFJIHNUEPRdbZQABcWDCgeaLVfOMTSGYK,BFDGDACBeADELECD.ODAFSCHBGCCBKEDFFFFFHGFEhAAAEBAE.RCDGdFFFZADAAIHACHEDaEBDhABA..MEFG..hAAAYHAEJAHB.NBBE.......hAGA......hAHA...,2,-20,-18,2
VMfXBLZYeaFgJKEUPbTCdSROQAIHcGWND,HAADGAFEDFDHMBCHBCCGLGFAeEFBFBEHJBDB..KAFAEEADUEAEhAAA..PHACCHFDdCHG.hACARDGFACAE...WEEFhAAANEEE....fHAF...hABA......hACA...,2,-27,-20,7
NJICMBbXTReUVPALGdHDfgaYKScWZFQEO,GAEGHFFADECFaAACKBDD..SGHBZDABEABA.OGEC.IDBFhABAMFDDBEGETEFHhACA.UGACAEAHfHAHhAAAgDCHWAHDFCHF.....NDEECBADhABA......hAEA...,1,-2,-38,36
YfRIEZeNLDHSOGKgJXUaMTAWbQVFdBcPC,QCBCVFEE.FCFBBDBA.CBGDRACCIAEA.ZFGFLFCFhAAASHCEKDDCJDHFhABAXECH.aHBCADAB.hACAdAAF..PFAFfAGGeAFEDBBFOFFHhADA.....hADA...,1,-13,-30,17
EAaQdeSFOLGfBXDRYHVbITKJPgZcMNCWU,QFCEdEEDFHGELGAEBEACDAACHBAH..VBCHTCEE..hAAAJFFDPADAZBGBMDIFhADA..CCDF..WBHFhABAABFDaGAD..OHACfHGF...hACA......hAHA...,2,-29,-19,10
FDdLNPEARBSQeHXCGbZaWfVKUTMOcYIgJ,SBBDeADGCGAC.GGBHZEEB..aDBAfGGBKBBA.MDABhAAAOHFE.ICGHhAAAFBGCDABENIEF.AFEHBFFFhAEAXECAbCCFWBEH......hAFA......hAGA...,1,-20,-40,20
QZJTWKXaPeFDHRNIYfAEgcGOBLCbUVSdM,EHBGGAFELFDCUECHdHADMCBDZFEB..TBGCKBBH...PAAEhAAAFAAGDGIB.RADF.IDCHhADAADDF.OFABhAEABDAACEHHSEGE.JAEBaGGFHGDAhAGA.fHGHhAHA...,1,-8,-30,22
UJMPWBAfEeFKNCYLOgQcTHIXSDdVRbaGZ,eCCHFAFBKCGGCFDG.LEHF..OEFEQACGHGAEXADAhAAAdDDGRBAB.aCGGUGEHhAAAMACHBEEEAADC.fHBDhABAEGEANABE.....cEACSHGAhAGADAIF....hAHA...,2,-22,-17,5
OBUMaZXWeKHPSTFCDGNRAJgVfIdLYQEbc,JFBBVAAD..dFFDQCEF.EHAEOAFH.MEDGZEGDeADChAAAHCADSABAhAAACGEDDFCHRDAAAAIF..fEEGhACAIDHBbGFABBGBaGDD.KAGC...hADA......hAHA...,2,-22,-16,6
fOgDFBaLIcCTMeZYWXHSNVQKUbAEJdGPR,EEEDdAEGRDGF..ODHHFDAABBCCLAAC.CAEE.TAGDMBGDeGAAhAGAZDDF...XCDAhAHASGEA.QFBChAAAKBBHUGGFAIDC.......hABA......hACA...,1,-16,-38,22
CHeILYQMGTWJEDZFKdOcXfASPaVbNRUgB,SAFBaCFC..NDEE.UEFGBEAACABDHECHLAAC.QFBEhAEAMICGTBDFEBHDFGFDhAFAdCAFOEAD.hAGAfAHAAIHGPBCB.......hAHA......hAIA...,1,-18,-28,10
VCRGUQXMBIFLfgbSOATdYHDJaZePKcWNE,dGFCDHCEZCGBKDDC......NDAA.EGEGRBGD.GAAF.QAFBhAAABHHGFBCBLECHhAAA..fCEDhABASEGGTDAF.HDDAaCAF.cGGEhADA.CGAG.MIBA.hAEA...,2,-37,-20,17
UHEZPRaAbfNVQSCMdLBTGIegKXFYODWcJ,...bBGFfBFC.QEGACEAAdBABLFFBTDAHGBDGhAAAgGDHKHACFGDBhABADHBEJFHFUACG.EDDBhAAA.ZAGBaDAGAGAESGGDMCIFBFCF...hACA......hADA...,1,2,-16,18
NDVMKLbfZXaHcgBPdIYQCJFeSRUAEGTWO,GBDBTDAC.OHDEDCGC.KBABLFGFZDFEHGAEBAAEdEAHQFGChAAAFGDGeCDBUFABAADHEAGEhABAVADE..MEEHhACAbDFE.aCCC..........hAEA......hAFA...,1,-1,-17,16
YBWLSMIgAEbUJcQVKNXTROPZCDfFGedaH,UGBCJDAC.QAFCKABE..TGEDOCCCZCFFDAAFGFAFhAAAdGHCHEEGBAFDLBBChABASAHFIHEHhACAAEEFEBCA.bEAC..cGGENAIE.....hADA......hAEA...,1,-8,-27,19
gRIWfYNJBFcSGULKbAHeECZXaMOTDPQVd,HDEDCDGFZCEF.aFAF.OABGDDEB..QCBCVAGD.dBAGRBCG..hAAAIHHG..hAAAfGCGNDDEBHFEFEHHhAFAcGGFSGADUAGHKHEAAEBG....hABA......hACA...,1,-5,-37,32
WZKCRXSAQEPIabVTBGFOUYcNLedMgDfJH,EGFCaHBG....VEDDBEBD.GABHFADEUDAANEEE..LAGDhAAAdABEMCIBDDFH.fBAEhABAJAGFHGFE.ZFAE.hAAACCEC............hADA......hAHA...,1,-24,-26,2
KegZAUDcXWFLOVNMPYdfICHQESbGRTBJa,UAFBDAFB..XABELFFA.OHFEVFGB.MHDEdBHACCFAHAAFhAAA.EDBAGEAE.hACABHEGKCFA.ZEDGAEGFFGAEhADANBAA.fADAQCCBSEDHhAGA......hAIA...,1,-16,-17,1
ICYRULdeWEgNXcfOaPBASJbKHDVQTGZFM,JCCHKCFCDBCC..QFGCZFADFEFE.MBAC..CBABRFDHUGEG.hAAALEABdCCD.EHBAhAAAXDAC..hABAfBDH.PAFASHGEhACAbCFE......hADA...,1,-18,-48,30
DMYFdGWRTCNZfUeVKbgOaIPLEcXABSQHJ,BFCFHBCFJEFDDCHFFCCHdEAGGGAF.RAAF.CEAAZGBE..UBFFeADAhAAAKEBA..OEFHhABAIHGC..ECAFAIAGMDIFhAAA..........hACA......hADA...,2,-52,-20,32
SOKbQACaIJHcWEVPBUNdDFZMLRGTfXgYe,aEGDJFBBHDEH..EDCGBCBCUACGdAECDCGGMDAFLFFF.GGAHhAAAXDCF.eHFAhAAAOBADKDHHAAIDIAGGhABA...WAEH.....hABA......hACA...,1,-23,-35,12
ICSNFMAPebdgXJUQGYVRDZcBLWKOEHTfa,eGEAdHBHJCEBQCCC.GBEHRFGFDBGGZACDLEAF.KFBAhAAAEEBEHEEA..aCGHhAAACABDNADBABBE.....hABA...gFAE....hACA......hAFA...,1,-9,-42,33
KfMRZWPYCTHGNUQLSJeEBbgFXaDVAcIOd,OGEAdAFBMIAGZBDA......PFDECHDEHEBHUAAFSHAGhAAAECFH.BHFDFECGaCDGhABADCAAAABB.KEFGfEHEhADARAGB..WDAEYHCC.NDBE.hAEA......hAIA...,2,-30,-28,2
bTYSaBHUIMPWfCdFVNLeAKREJQZDOGgXc,KEHBRDEDQABDDAFAGDAF....XGGETGEB..aDFHUDADhAAA.IGBEhABA.MICAfBBDhAAACEHD.FCHBVAGFeHBEADDB.EBFB....hABA......hACA...,2,-31,-16,15
EJUdFGCfWYVXKNPeTQbOSaZDAMHgRcIBL,MECGHGFGRCGBBHACLFDGUFDG.FCDBGDGECGAH....fAAChAAAVBEEKDAFeCBEhAAATAFA..OABAhAFAZEBFDBCDAGIH.IADF.EEEA....hACA......hAFA...,2,-24,-13,11
NQFJUcGMTEgeWbfYDBLRXIVOPHAdZaCSK,dEHACCAHKGEEFAFF.UGDGGEBA..ECFBeEFG....fAAChAAABHAHLAAEhAEARDCE.XAEEOCAFADHChACASCCGJHFA.MDFC....hAFA......hAHA...,1,-30,-37,7
BDaIOfQWHTecMCGJFLgUNPEKbXdVZRSAY,BAEDDGHHOEFDQCGBHCAC.eFDC.MHBAJBFAFBCALABHhAAAUFCD.EDABKHEAdFAH.VFGFhADASAABACEG.hAFAaEDGWDDG.CAHA........hACA.NEAA.....hADA...,1,-3,-33,30
VfEbTeSYBDAaUXNLOIRQGCPKFHcgJZMdW,aEHBUCGCLGBCOGFE.RBEG.GGAB.KCBCFBBEHEEEJEBEdGFE.hAAA.fEAGhABAEAAFeFHHBHBAABDE..XECFhACAIEFHCAGD...gAGEhAAAMDDE.WEAF...hADA...,1,-14,-19,5
cBAXdQGFOTPgWKZNbJRMEDYLICVeUHaSf,XFCAQBCBFDCFOEAA..TEAD..PHBChAAAKAAFZGFGNEGA.JAGDRAGHDGAGLAEBhABACFHE.eBHH.hABAaFFGcEDDBBCAADAHdBFC......hACA......hADA...,1,-14,-23,9
fDWUbQTMdEXHaAOgcFVJReKSGYILPZNCB,OGEAFHBGRCCC.KGBHGAFELBAGZFEGBBBCDDFB..UAFAQEAChAAAdDAFHEBCABDC...hABA......hACA............hADA......hAEA...,2,-41,-37,4
KSTCPegJARWBXdObUDYGIaNFZLQMcVHEf,BFDDXGGDOAHHDDCE.GACG..aAFHZFAFQFDDhAAAMBBDHGFGEABESEFChAAA.TAECCDACPCHDhADA...........hABA......hACA...,1,-22,-34,12
gGLSQcRPYIFECfWOXUZBTVHKNJdMaAbDe,DEFHGECFQCACRCAE..IAHEEGEBCFAB.OHFAZADBTAGBhAAAKEADdACG.AGCHeBEEhAAASDHH.cGGFhABAFEHBfDEB.XGAHBABHHCFDhADAMIDE....hABA...,1,-11,-17,6
PGVJbTDUQdOfeFaZgKWAHMBIXNRLEcCSY,HFBHMBFHBFHBXDDBREBG.EHGE..SHBEGBEBVCAHJFFB.hAAADAGE.dFFFOAGBhABAeBAEFGEH.aDHFZCBE.hAAAKACE.ABCDIHHA.....hABA......hACA...,1,3,-32,35
bTEfIgeMLOCHKJUdDaAcNYZPWRSVQFBXG,...NDDG.ZFDF.PBGHRBBA..QGEGFEAFBGGDGACChAAATEFHEHAA..IHBBhABAeAHDODAHKCAGdFFBhACADBGBAGIH.YBEBSCEH....hAEA......hAFA...,2,-27,-12,15
KJADaWNdXIOYQPHLFZUGbVgRecTBfMESC,DGHHaHBG.dADE..OBDFQGAHLAFEZGDEGEDF..hAAAVFFEeBCDBAACMBAHhABASCADJCEE.hACAAFEHWHCANEIG.IDFF.HBFC.hAFAbDBF.....hAGA...,2,-18,-16,2
IPMUAXbOCHDfEgKVRFSdQGYcZLWJaTBNe,XDACOAFBDBEF..EBCHKAAC..VEEASDCHGGABZAGFhAAALEECJHEE.BBHEhADA...NIAHeGAGhAEAICFHMFFBADDH.CGGF.fABA..hABAgCBF.hADA...,1,-24,-28,4
PYEKSBWTHRGMFVAdNZbOfagcCDXUIJQLe,dCFCZAADOBFFaCAD..CCHE.DBEFUFAD..QFBGeABGEEGH.hAAABGHGHDCHMIDEAHHC.hADA..fEEDhAAAXGDE.JDHH.YAFCSHGG..hAEAWEAE....hADA...,1,-18,-40,22
KbDWLSEZPNeCGQYdHJOBXfVagUFRIAMTc,TFDBKHBGDBBALCFD.ZCACNDADeEBCGEAHdHGF.HDFDJGEC.hAAAOAEGBDHA.XAAChABA.aGCH.FAHDhACAIAEDMCCA.cAGFSDHB.hABA.EGDB....hACA...,1,6,-38,44
cELGVTOXZeUdbSNFDQfKMJIPRgWBHCYAa,aAFBLCCHGGCFTGGDZCDF..dDGASEBFDCCBKBAH.MCHFhAAAJABA.RGCABEEGHEADACGGEBABhABA.OAEH.eAFChACAUGGE.NAIA.........hAAA......hAEA...,2,-17,-10,7
PScaTHDgLdBfRCeIVMKUOAXJNEGQZFbWY,XDACEDCDZFGD.FCHF....bFDH..PEGHaAFAHAABDGDFdEEGhAAABGBDRBAC.eBEFMFBFhABAKDAFADDD.....hACA............hADA......hAEA...,2,-35,-22,13
YIEOSPGNJWbZFRKLHTCcXfaABQUeVDgdM,UABHVAAD.dGAH..MDEBEHEE...OBGHSEGDGEAC.hAAAJHFAZDDB.KBGELFFEhAAATEAH.XADAhACAAAEHBHHFDICAIDCD..WCAG.FDHFhACACHCGaAHH....hADA...,2,-23,-18,5
dZHFWIPCAJVbNQaGgUXeKOBRTSMfYcLDE,JFBBVAAD..QCBFGECEUGFEKEDABACBRCFA..MFFE.hAAA.fGDGhABALAEGDCDGdGGDZBFFFDAH.IAHChAEAAGAB.........hAAA......hACA...,2,-31,-23,8
dFIaNSXVBDKRPYEeOAfZQbgMHGTJcULWC,QFDHMCCAHGCCJCBFLDBC.dABEFAABaGBBSFGGhACABEHEKBFA.RAFA.EDFBAEFGZFAG.hAAA.gADAhADA..cEDAUGGCCAHFIADCNEAE.DCIFhAFA......hAGA...,1,-5,-23,18
RdLBOeQZYfPSXcMNUgJWDGCAaHIKEFbTV,aCFCHDAG.EAACFFFB..VFFERAFEBDDG..QADHZEAF.hAAAfGCESCAAhABAMFEFNICF.JAFCDHGACDFHKDDEhAAAdACB...........hAFA......hAHA...,2,-38,-7,31
ABXMRVYWIQcdOFCgbaJGSfHKEUTPLeZDN,MEECRGFG..VAAB..IFFBQAFBOBBHCGAE.aAAGJCDHhAAAGGCB.fADEhAEAKCGGTFCGLBFGhAFADIBGAECFBADCXGAB.YCCBhAGA......hAHA...,1,-21,-29,8
IJBGdUSYbgTRXAQDFCeWNZcfPMLKEVaHO,FDABCAFB..eEACZGAG....fAACLCHBVBDDOHFAJHBChAAABEFEUEFC...hAAASABFbCECREBAAAGGDDIHhACA.....NIBFPBCBKGHB.aEGD.hADA......hAEA...,1,-13,-32,19
MBTWfGVbSLYeCDZQOUKRcFdHIJaEAgPXN,XCBCMBFHBFHB....TABCGCACSHEAeACHDGEFZDFDhAAAOFFCKHAAFEDBdCEHIBHHhAAAaAFF.AAEFNEEDhABAfAHALFBDQFCA.hABA......hACA...,1,-4,-29,25
fVFCBTZYMESGIPJdQAeXcWRObLUDKagNH,eDACXCBCRFGFLHAGDHAC.KDFD..NCIE.HEBA..FGEHTAAChAAAZDEGEFGBSDGEhACAGAAFJFAAdAGDAAECOCEAhAAAaADBfHEB.BFADMIAE..hABA......hADA...,1,3,-20,23
YSFQTUeRLOfZMBPcVGIHENbdgXAWJKaCD,KDCDaFGE.DDGFFHFE..UAEFeDCELEEBZGAEBCGA...VAEChAAAGAAC.EBHBdBADAIFECHGEhAAASEAE.hACA.TFAHfEFA..cFCDhADA......hAFA...,2,-35,-25,10
HLJgXORBeESADMWQKNITfPbCYGZVdcUaF,MCHFKGFC..TABE..PECACECBZFABdDGBaBFFLGFGhAAA.XGAEBHEAeEHBhAAASBCHAICEQAFBhABAIABGbDDB.YDAB...hADA......hAEA...,1,-21,-26,5
DFRBZdTMCVIaUeNEKLOQJfGWbHAYcXPgS,XCBCSHBGRFAB.ZDDE.dBEAMAHF.CFGC.aFAE.UFFAeCFFKABFhAAAQECF.hACAJADHfAHGhADA..WFHHAGIBcDBBDIEEBBBB.IAFFhAAANIEFEDHB.OGEChABA...,2,-25,-19,6
BDLabcNEfgOHPXIGFeQVMUCYZdARTSJWK,SDAFKDCDLBFG..aBCG..bDFHEAGE.ODDFHGBGPCAFhAAAGGEFQBFGhAAA.VFAECFEFYHFGhABAACAGJDHB.BAGADICANABFgACGhADA.FDDA.MFAF.hAIA...,2,-8,-3,5
aZGHMXKFcRICTNEeYVDJBfdWbAUPgSQOL,UCBCSHBGOADALBEFGCFCHGBEMGFGFDHB...IBAChAAACAGHNBAG.eGDGhABADDIFBBDBdDBBACGCQEABhACAaHGAZDDF.XAGA....hADA......hAEA...,2,-21,-17,4
RZcgPDFVOIMbEQeUGBHAXSYfTdKNLWCaJ,SGFCTCBC.KDFDLCHH.CGGARGAEZDBF.PEADDABDFBFBhAAAOCHDMGDEEADCUACGhAAABHEGAHDA..fAEFhABAdEEFaDAH.JHFE.......hACA......hADA...,2,-24,-22,2
VKAGPWJMSbQTNECILceOaFHRYZfdBgXDU,GAFEJGEA.MCBHSGCGQECD.EDDGCAEGLAGDhAAA.eCAEaFHH.FFADYFFBhAAAdEFBBABFDEIDKDAGhADAWABC..NIEB......IEDAhAFAOHBA....hAIA...,1,-12,-33,21
eJBIMYHgPVEFDGdQTOKCcaXZfNUALSRbW,LDCHSCFCRGFAeEFCBFHG..MBBDHBEA.VAAFDEGBQGDEhAAAKEAG.aADHfHDDhAAAAAHG.JHAAhACAgGBDEADFFAGA.......hADA......hAFA...,1,-4,-39,35
IJgWdVbOGUeZTQMXcaSRLCEYPNAHKFDBf,HFEEDGGDBCFHJCGDdEBD..OCCFUABBZGAEQABG.MIAGhAAAaGHDRBDH.LAFEhAAACBGBEDAH....PEBFhADAAICAfHFF..IFEBhAEA.WEHB...hACA...,1,-21,-35,14
BHbTDJeEQIFgUPNMWGOYLfVXCcAaSdRZK,dDABZDDFHBBEDFDG.JACCEEGG..FHEAUGCA..MBIHOBFALHAGhAAA..fBCHhAAACGBDaGGA.SHGEhABARBFBKAGCBFAC........hABA......hAFA...,2,-45,-19,26
VFcSDQgMeJGHBOAbIEfUZdaWYLPKCNXTR,EHBGZEFHaDABLFAD.CABE.TBFC.FEBCSDGA.hAAAQDDAgFDAhABA.MDIDeHDEJACABHGEhAAAAAHBICCFdBDDWDACKGAANGBF.....hADA......hAEA...,2,-26,-18,8
TAfEHVSOMWaFgLPZRXIKYJNdcbGQDBeCU,ECFCVDDF..SGEBMBFA.FCCHLCDCZFACREFE.KBAAJACCdGABhAAA.....cGFHhABAQAACBDAFCHDDhACAAEEDfGHCHDGB.WHBG...hADA......hAEA...,1,-22,-23,1
aMXIGgTVAUDHcBRSEQdObePJCYLNZKfWF,UFCAHFDGBHCHRFGH.SDEFdDEDODACeEAF..CAAALFAFhAAAKBBBFCGCMBAB.IHGHhAAATACFAGFBDBGEEBGGhACA............hAEA......hAFA...,2,-33,-29,4
eLUbFHMZRVJBPcdKaWDAXQfNSCgTEOIGY,XCGCQCBC.SACCCFDB.EGBBIBEGGDEDeFDEhAAALDBAFHDAMBDAhABARABHVFABBHHEdFFEaAABDFAAAAGEhAFA.fCGB..NEIA....hAIA......hBAA...,2,-21,-9,12
YGHXPCdNOJfIbAFVEgUBaQSZRcMeLDWKT,FEHBVDAGEBGG..BBAFQBCDZADB.MDFHeFEF.DCGCTGAFhAAAHGFACAGA..NHDH.ODFChAAA..fDAChABAAADFUGAH.aADA.REBA......hABA......hACA...,1,-13,-26,13
QYIbNVcdPAOGDBEFJUTMHXfSWLagCKZRe,ODCHBCAHFDEGUEGAHEAC...SGAHLAHBaGAHKHGEeAAChAAAQAAC.IBEGhACAVDGBdAGDAIFCEDAFhADAJHCAMCCE..fGDF.CHHG.hAEA......hAFA...,2,-29,-16,13
FGXQIbRVDLPaWeHUTcCSNdZYBJgMKEfAO,FAEGXCBHQCAHRAEE.DFGDLHDE.aEDEeDEGHAAETECEhAAACHAHdDGBBFGG.hABAMFCBEHAAfBBBhACAAGABIHHG.bBEA........hADA......hAHA.PFHH.,1,-7,-14,7
NCJaOfRFWVTYIdQBUEAgZcXbKDHSPeMGL,ZAADXCBCDHBGHFGF.eEECMFBDLCFGJAHD.OAEBFAFDTACChAAAdDCABHAG.ABGH.hAAAgECAKAGC.hADAGGEFCFACaHCE.WDEH......hABA......hACA...,1,-12,-28,16
SNUTFYbcKXeHPgDWMOIfLJCdGQVZBEaRA,UGBCFGFC....bBFGKCAA.eHFEHCCFDECEMFEH..OCFEhAAAfHBBCFGH.dBCBhAAAQACGBAHBaAEAAFFChABATAFEXCAC.PDHFIEFG.hACA......hADA...,2,-38,-14,24
GQNTERgWYSPULKOHDIBcMCXdAfJFeaZbV,FDCDeDCHZAFGGADC.QDGETBAGEABGRAFE....YFAHhAAASDGD.LHCAhAAAKGHFOEFBDAFABEEChADACDABABBB.fGGAaFDDbABBNICF.WEAB.hAFA......hAHA...,2,-23,-2,21
FITLcBOgUXHaMGECdWZASeQJVKNfDbPYR,SGDDeFCAQCCEKCHB.DHAE..PACDFADALBGBhAAA.OHFEgEFAhAAA.UAEBXCAFhABAaFAGEHGECFGH.dBAEAIAE.NDEAfHAB.hACA......hAGA...,1,-13,-26,13
dCQeJgAKMGTOVZNYHXcURLfWDFSPBbaIE,KEHBTFGCZBCDHCFA..XBEFUAAFRFCELEADDBBAFHEABECAhAAA.aEGGEGGG.CHEAeHAAhABAACEHMEAD...ODAAhABANADF.fHCBSBFCIBHAhACA.dEEE...hAIA...,2,-15,-13,2
XgQCOaDLAPeYcIBZGHdVTJbWRNKEMFfSU,eGEA..IFDGZBCBHCFDdCGCVAAFJHFERDADKDAD..FCEFUGBEhAAA.QAGEhACAaBAADAFCADCC......hADA..PFFEBEDA.TGBCWHEA.NBIGEADEhAAASDHH.CGAD.hAEA...,1,-13,-23,10
MgdQIUYEWTGJSVeAFHKLZDfBXOPNcbCRa,FEHBHDEDKABDDBAEBBEBOBCD.....NBED.CEACMDAG.dHDFhAAAICHE.UEABhAAAEFAFGCEFSGHBhABAAAIFLECAfGGG.cGDFaACDQGGFhACAWHAC..hAEA...,2,-31,-21,10
AZVNXEYgMedLTcWROGSQHKabBUPCIfDFJ,ZGFGXFDHEGBC..MDHDdBGCLDBE.TGAARDDBOCEGhAAASHEAKCAEBAGCUAAChADAIEBFDAGCADFB..hABANDICeFGBGABFaAEFCDFA.......hACA......hAEA...,2,-25,-6,19
SONMPHCFJAZYLXeQBdKgabIRVDEUGTcWf,ZFDFLDACQCBBdHEFaGGARCFH..DFFBEBGAUGBDGFBB..TADFhAAA..fHABhAAASDADMCCEhABACAGCADEA.YEFABHHEKABEIACH.WAFChAEANAIA.....hAFA...,2,-24,-11,13
KERVeHfTZDUNBSOJbAadLXIPQgcFWMYCG,aEEDdGDDLBHF..ICFHQDEEFECBMBBCCAADECDARBAAeHAAhAAAHFABZCAEDGIHBFHBhABASEAFJHEA.AADD.hABAPBHD.........hACA......hAEA...,2,-24,-18,6
OaMbLPSTCeEVNHXUfYDAGgIFJZBcQWKRd,GAFEFHBGBHFDQFACKDFD.ODEDMFAALBBHSEHBhAAA.TGFHeEHFEAEFhAAAVBAGHAGFXDBAhABAfCAAYHAGAGBA.IADFZDDF..hACA......hAFA...,1,-3,-18,15
SeEGUACZDOPFNfRQXMaHbgJdWLYVIKBTc,CFCFDAGDFCABRAAC....MEEGaGGA.HCCA..JHBCLFCF.hAAAIFFBBFAGSBFFhABAeEABEFHDAHHBODCEhACA..NBICfDABXDGAdAHAWGDGhAAAKCCC....cGFChADA..,2,-39,-26,13
dHRPCQZDKJAbcFOYSGUIgBLafXeWNVETM,FHBGSDCDUEDHBBCDLHDE.XADCeBEF..VCAHhAAATFGH.dAAFHCFAhABACAHDDIAEAAHG.ODDAGEGEhACAaGAEfAGEEDGHMBBF......hADA......hAEA...,2,-23,-10,13
aVOXfTZNFbAUKLDMPJSECHgYIWBdQeGcR,UGGDDFDCMDCB..SGCEHGDC..gDGGIDHBdBBGhAAAGBBBRGAE.OCABhAAATDCDFAGEKBEDPFADhABACACBBFGBeABC.aHCCfEAD.hAFANAGCAIAEEHGA....hAGA...,2,-24,-3,21
ZQFAXICEabefgSBdHKUMDOWTGPVNJcLYR,CHHGEAFB..eDDGSEBBBFACKBEAUCDF.DFHHOCBFGAAF.hAAAVGDEJFFHLBHDhABA.RGAAZFDFAIHA..hACA.XABAaGAH.......hAAA......hABA...,1,-22,-31,9
GQCORXcIaWNfFDSAUTePgEHBJVLZMbYKd,UDCHTDACeDHF..EAADBGCBLGDGMBGH.KAGAdFFACCDF.OACChAAARDEF..ICHGhABAaEAF...WFCDhACAFBAHAHBC...gAGB...hADA.JADE....hAIA...,2,-31,-26,5
CZfKNHPMIaYeGVAOJQgcFRBLbSEXDTWdU,OFCAJDAC..QFDHFBCHRGDCLBADEAFG.DGIDdCFG.UGGAhAAACFACZBDFKFBE..HBGFhAAAMABE..IGBFhABAaCCAeHAEAGGCBHAD.......hAHA......hAIA...,1,-22,-28,6
JHLSFBEOMKWVbZcCRIfNAedgQTPXaDYUG,dDCDQCGC..PFGFDEEFUFACHAGBLAAFBAAHMFEBhAAAVFFGZGAA.RDAB.IBBGhACAAAFBeDFG..TBCDhACAaCECJAEE...SDAA..hADA......hAEA...,1,-12,-26,14
OVdKUGfLZCNbBJMWaIXHQDYcPeARSgETF,RDAGSAFBEGHH.OFDBdGABKACG.UDDEGABELBFBZFGHCHAABEEChAAA.MFFBIHDGhAAAXCGHDBAB..hABA..PBHFAEBFTADB.fAHGhADA.....hABA...,2,-35,-12,23
AHSVYaTEUfXeRWLDZCdFKOgcPbQGJNIBM,SDAFVDAG..aDDFEAHD.UAABXGDBeCGHLFBBhABA.CHGEKDCCcABGhAAAQFDGNAGA.MEIBhADAAHFATADARCEFDBEC.dBHE.FGGA.PHAAhABA......hAFA...,1,-3,-19,16
agQGMTEHUSDbAZdIOfYPNKJRLWFCcXVBe,ZDAGOCCH..PFBGJBGFLBEF.FHBACHBF..VFEGeAAGhACAQABGGFCDMADEhAHAEBGEHBDADIGGAAIFdFHEhBAAIEHF.........hBHA......hCAA...,2,-19,-19,0
JcRgXFYOPDbZefaUGTHdIVBCKSMENLAWQ,QDACJFBB.RGBEFAGHOCBH.DCDDZAAC.aHACGEGE.hABATFDGIFHECAHF.hAAAKEEBMEAHECCDLAEDhACAACAH..WABCcGED...XDGGhADA...hAFA...,1,-4,-47,43
WUCOHZLaYFEBSGbJTVegPKRIdAcXDNQMf,XAFBDAFBQDCA..MBDDUGBDHFBELAAFaACGEGHDGGEFhACAJDFH.eAGBKDHBIHFEhAAAABCC.fBAAhABAWEAFCEGD.ZCDBBBBD....hADA......hAEA...,1,-5,-25,20
KeOacTQHJLGWBZISbAEfDgXUVYFNMPRCd,EHFGDACBUEBEFDCB..MAABCFGC..dBFBKEFF..OHACaAGHQBDEhABAHCDALEFFhAAABDGFSHBGhACAAFIB.fBBA......hADA......hAEA.gFCAXGCA,1,-19,-39,20
DQSXdFcgaIZUEYOVKMWATLHPRfebCBNJG,LADGHGFGRCGBeADHCEAGBBHEGGAH.QAGHXFDDFGHDaFAGUBAFhAAA..ECDG.hABA.ODFBKAAGAIDGPEEGhAAAfEDE..NCCADDDF....hACA.SHAAhAEA...,2,-38,7,45
WbNaLRJOKdCfQMDPFZTSVAGcEgYIXeUHB,EGAH..IHHGUDCCBEAB..NEGERBFEJAAF..KEDGdEGFCFBC.MGCAhABA..DABDZAFATGDHhAAAAFHH...GACEhACAgGGAXGAAeHCA..WAFChAEAaCEDfADEhACA...,2,-34,-24,10
TZRfUMVcbFaQWGKLCgDOIdAYBSHJEXePN,SEGDHDEDEEHDeBEC..TECBRCACMHAAVBFAFACG..QEBEhAAAGEAACCEDDIGGdHGBABAGhABABCCEXGDDZAABfAEFhAAA........hADA......hAEA...,2,-23,0,23
YGgWDEZaULRTAQcfHOPMJBIbdFSXCNVKe,QCBCHAADMEAABGFHdCGBFGGECBGA..KDGGeFDHGEDGDEAFaEDBUADHhAAA.LHAEAFFE.hAAA.OACE.IGBDhABASAGCNIEB.......hACA......hADA...,2,-30,-22,8
MgRXdaZeEBOUPQJCbKDGLIAfFWcYVNSHT,FHBG....WFCAVAFC.HDEB.MDACRAGFdCDDZGEEBGHE.hAAAOEAFQEAGhABAJBAB..CECH.bBBADAAEIACFhAEAAHEH.fDGHNEEF..TGFEhADA....hAEA...,1,-4,-46,42
EHKfFLOYIMZXaBUdADJTebVPQNCSGgcWR,DECDJFCA.eBAD..VCADQFGE.CDGBGBCF..hAAAgCGDRGAEKEEDFAGA.hABAOHFAMDDF.aCCABAFDhACAAHBB....TDEC.NICB...hAAA.WAFE.EABEfGFEhADA,1,-16,-48,32
AUBCGEPQSDfOaHTbNKcLZXeWFdIYVJgRM,UGDGGCCGQADHDACGOBCAHEFC.TAACKAADZFFF.eEHHhABAdGACIHHA.hAFAJBHHMICEADEABDAFCBGG.hAGASECFfHAHbAFB.....hAHA.cCGD..hAIA...,1,-2,-32,30
WTgKZVdNAYIGBMXeLHOJbDSURaFPEcCQf,GAFEXEBCHBBE.OABADCHHUBAHFHEAEEBHCEFA...QEEDhAAATGDAZBDGdDHGAGAFBHHGhAAAMFDD.LAFChABASHAEaGGGfDEF...hAFAKHBG.....hAHA...,1,-10,-19,9
DbEBaKFMZcHOVTRfAGUQeXgPYdLWSJCIN,UCBHQDCHeHAG...XAFE..gBFAhAAAPBBHdFGCSABEhAEAJFDHIACDNEEFDFACBFABFHGA.hAFAMBIDHFBCOFHF......hAAA......hABA...,1,-18,-24,6
ZecMfBASJbXCKOQRVdDEWYaFPHTLgUIGN,JCCHCHHGKDGF..REFD.dACGDCBF..EEEF..aHDGFGAH.HFCBLBAEhAAAUAFEGBAEeAFBMDAHhABABFBH.AAAC.SAHFhACA.XFCGQFGH..hAEA......hAIA...,2,-29,-24,5
ALCQKdOFIaJMREBeZHUDgTYbNVWXfGcPS,CFFEKFHBFHGE..JBDBRGBE.BCBEZBAA..HDAGDCGB.....TDGEhAAA..NFDD.XAFBhABAGDAE..SHEAhAAAAADCdEECaAHDMBBEEHBC....gAGBhABA...hACA...,1,-21,-48,27
ObQJXHFLDdWaUAeGTICMZVYNPKfRcBSEg,eDACTAGHMFGH.ZAFEVDBG....PEDFRGDGSDGBhAAAOBBA.QFGFhABAHCGFDAADaGABAIACCGABKBDABHHGhABAEABF...........hACA......hADA...,2,-22,-15,7
KVfIOeNGRbAWTgdEPXUcCQaDZFHLBYSMJ,TCBCdAFBEECH..UGEBCGGD..DABEFCBHBHDA..MFFGKBHH..hAAAVECAIDHF.hAAAeDDERBEBAAEF..PDHBhAFAXABE.aGBCHGAE.....hABA......hACA...,1,-26,-32,6
cbLReSDNCHMWgfKdPYUaBVGQXJZIEOATF,FGFCLGEAeEBFDEGCCBDFHDEH..MDAB..fHBFhAAAKBCAdBBCUDEABCBC.QAEChABAJAHB.ECGCAACATFCFhAAAcDAE.SHAGNEIG...hACA......hADA...,2,-30,-24,6
eDIBgCcbFMQGJSREKaTOZXAWNYPdLVHfU,...NDDG.dDCDHACEeFCABGEHCHACFHGAGAGA.SGGAhAAAKACDaBEF.TGADZAGHABAC.PBAFhABALDAF..hAAAVCEFDGGE...cEGEbGCAMIBE..hABA......hADA...,2,-28,1,29
XLZbIDRCFPfAMGUYdVHNBSWKTcEaQOeJg,UFGCdCFCHGFEBADGSEHBKDGG.EAGCQGAF.eBFAhAAAJAAFXCBHhABAZEDBDCAD.CHCD.FCCHAAFBYDDBhACA..NCBG.cGABOFFB...hADA......hAEA...,2,-31,-25,6
VgbKedGfPLMNIcXAUZBQERFSCYOWDJHaT,UGDCBADCEAGDFDHF...CFFE.OCEBDCDHHFBA..TCBC.hAAA.VCAHKBECdEAEfHGBhABAMHFG.IDHAhACAXABC.AFFC........hAFA......hAHA...,1,-36,-40,4
LIHbaBEPOVGRDYMTcKWgNFXQfJASCeZUd,eCAFdDAFLABCHEDCaHFEEFDF..OHAGRBCGDCID.MBEHKGBB...hAAAgBFBFAGAQGGHhAFAAGGFCBBBZDBBUDDFBAAFhACA............hADA......hAEA...,1,-15,-22,7
bEVBUPOgJMRfTZecCAaKQDIYLHXdWSNGF,KFAAQAFBDEBELFFFHEAGdDGE.SAAFFCDEEHBE.BBBBhACAOAFCJDEHRGAEZEGBCFHAACDH.hAAA.aCAB..XGGChADANABF..........hAEA......hAGA...,2,-34,-19,15
GIUfHMYcFVPNbWKBgEDSaXQOJdATLReZC,LADGRDBGCBDE.UFECMIFEFDDE....VCGH..NCHGKFCGhAAABAAD.EFBBDFAEaGCDQBBChABA..hACA.JHBAAFFHeGFA.IHAHYAHHbAFEhABA.SACChAFA...,1,-29,-36,7
XSZFNdPGYMQfADeCLcOabKEIBWTRVHgJU,CGHDLEEG.OGBAKBDABGDFRBBF.HDFHJBFB.SAAHhAAA.FAFFNADHdAAEGDADhACAMIBGAFFDDAHF.eHFGhADAaFGE....IBHD....hACA......hAIA...,1,-29,-36,7
dUMVeNCbAWQLZEXKfJPcYgOTFDIaBGRSH,QDACLDCHZGDEKDGCJADG....PEHD..gCEFhAAAOFAEFFEHDIGEBBBGhAAASBHHUCDAeHAGhABACBBAAHAA.EACE.XGFDYDAH.IEGDhABA....hACA...,1,-12,-44,32
VMIHJOPEUDBRcWZAYgTFbKaLNdGfeSQXC,TCBCFAFBKHACLEGD.GCADSAEG.QAAFhABAXEAGCBAAIGABhADAJDEB.EGEABDHEcEDEhAFAAGDB...YDFCgBGCaHFEdFCGhAGA......hAHA...,1,-18,-32,14
BHaTQLIRFcAEgKeWCDOMfSPGVYdUJbXNZ,EAFBeCCHDEDGMBEH..SAACGBGEdGHEUDGGJBBB..XGAHhAAABHAATGEG.hABAQBCFIFEDcGCFhACAAHIHKGGCOFCGfBFAYDAFNADF.hAIAaAHF.....hBAA...,1,-17,-19,2
NOBfXERZHbLcSMaCDAQVGgTPdWeUJKYIF,VACFTAGH..dCFHUEFCKAAC.FBAHBGGB..XAEFZFBDLFHBhAEAMEDD.DEEHADCE..hAFA.QGEDhAGAPBBAJHFA..IAHCOEEB.....hAAA......hABA...,1,-27,-29,2
SLPEWHVBYcbeFJQDTZXUNKgfdICMGRAaO,aEEDSGDBLAAEEDCCHGBE.BHFD..bBBCJEBEDGHBZBEGXFFBhAAAUDGFKAEEdGBECGGD.hAHAGADH.AEABWEEChABA..cCBB......hAIA......hBBA...,2,-22,-15,7
RHSaMOcLfDBIJWGYAEPbUgTZNCQdFKXeV,EHBGUCBCZDBDCCGF...FBACKFDG..eEFAHGFESBFCOAFBLHBEhAAABADE.JABEGEDEhAAA.ADFGPFHDhABA..gDFA.NAIE...hABA......hAGA...,1,-22,-32,10
XLAJNGfRaPgdFbBMKIWTcVYCOeHSQUEDZ,GECFRDAG.aCADdEGABHBCICGC..TAGD.VACHhAAACADEHAAA.QCDEhAAADHFCXCGGAFAGfFDEhACAFFACMICGKFGGWFFD.OHBC..hAFA......hAGA.SAHB.,1,-14,-15,1
XcWPGKMQbTaFJCADeHVOUSLfNEYgRIdBZ,DGADeDACODAGLECC.EGAHRAAEBDGFZGCA..XAGE.hAAA.WGFGKAAHbDGFFFCG.hACAAADG.HAFGUGGF..hAAAfEGFNCCF.ICEG..hADA......hAEA...,2,-42,-6,36
SZXUOHJTQGNEaLMAeYVdBDIWgbcFfPRKC,eFBBVDAG.BDHH.DBHH..IAAD..bABGFFFGRFEFCDDGSCGEhACA.UGAFhADAOAEDJHDATADChAFANCAAEEGB...aEEGAHAG.dGHE...cDGAhAGAKGHB.....hAAA...,2,-37,-12,25
gWZPKUTbVCILXGSNHJOeMBQaFYdDfEcAR,RAADZAADUFFF..bCDGCADC..LEDBGGABSEEAHCFG.hAAAJHEGMEIHBAGEQEBDhACAFEAA.dAGHDDIDhAAAEAEFAHIDPACEKHAE.......hAHA......hBCA...,1,-14,-19,5
cXCHaJdIZgbRTWeKSGVNOfDYQPEBALFMU,MEGFUCGCCHBAHEAF.JCAAdFGH.ZEDHRAFE..eHEGKCBGGACD.hAAA.NEICDCFHQFAFhAAA.BHHEFECAcGCGhABA..IAHE....hABA......hACA...,1,-20,-37,17
DUbHQSdJVeTLPOBaWFgRNAMIKXcfCZEGY,MHFGXGBC..CBBAZGBGEDEBGACBDFADHDFBQEGH.hAAASAACVDAGeFBAhABAPCFEOADDaHGA.hACAFDADNAIEAADFIFCH.KGEH.cBBChADA.fAHEhAFA...,2,-19,-9,10
eKbGZPQdYSUOcNCWDTBFVfRLIAMgHEaXJ,MECGHDAGXBGEKHACZFBA.QACGdHDHUBDA.ODHB.CGAGTGEGhAAABGHFFCAGfEEAhABARAGBAFCG.EAFFJAAGhAAA...eFFB.......hAEA......hAFA...,2,-29,-12,17
QdOIENXcYJRFPbTMVSfGBKaHLZUAeWDgC,eFCHDACBCDEC.dCCH.EHEE..XBFE..JBFDRFAAFADH..hAAAPBAFMEAESGGHhABABFGFKBHDaGAFZFEBADIH.hAAA....WHAAOAEG.IGHChABAYAFE....hAEA...,1,-26,-43,17
dKASYHNFELfecBMURaGgCbJWDTQOVIPXZ,SCFCHAADEBHBeFEABGAHRDBD.GEFG.CEAC.JFAFDFIDOEHDhAAA.VADFXACChAAAZGDAAHHHFEEGfCDChABA.MDCD.aFEH.WBFE....hADA......hAEA...,2,-34,-4,30
MNSdRHLbXBacKZVQUFCYTfPeWJOEAGDgI,GDCCDACBMFIDSDAFHGCELDAHBFEAKFHBZACDUGFE.FDFFhAAACBHHfHFFhAAA.eACHOBHBAABAIHAEhAEAdAFC.XCEGcECA....hAFA......hAGA...,2,-31,-14,17
AREaJSgXZcFKLHeICbDMUWfPNYQBTdVGO,RFEEEEED..JBDBSAEFZBGD.KBHFeFAACAAC.DBCFMACF.UGAHhADA..fBAAhAAANDGGBDBD.dBFC.OABAhAFAAHEDaDHD..cAFGLHFA.IHAAhAGA....hAHA...,2,-30,-29,1
ZCSWRTIFEgaQKDAGVPNYOfecLUMBbdXJH,GEDHVAAD...PAFEOFCA.eADFUBCFBFGCdCFHXGCHhAAAJBFE..CHDFSFBGhAAATGGHFFAGEGEDhABAaGHD.DACGAGAH..NEDH........hAFA......hAIA...,1,-16,-32,16
TBSDQdOCfYPaZVEJgbeRFMWGNcXIULHAK,KFFBTGAFDEEG..dAHGCAGF......PBBHZFCBEFHH.JAFFbGEChAAA..RAAC.FECG.MCGHhABA..NDCE.IAEHhACALDABAFIB.BHEFSDDE.fDHAhADAaDDG..hAIA...,2,-34,-34,0
FVHNGQCEKJLXWBYbZOSfPUaAIDReTdcMg,RFDGTAADMAEB..FHCAHFEE.QBFCCHAF.JCAFXCAFhAAABHDDZCCFODECSGAGhAAAUAGEABBEDECDdFAF.hACA............hADA......hAEA...,2,-34,-20,14
MWXRcHTEJgeSDULFZCIabONVQBdfAPKYG,KHBGMEAERBFAHFEC..EACHJCAASDFH.UAFELEDDhAAACDHH..IGGDhAAAbADFOHECQFDGhABAfGAHPFBD..WEFCcCDF.hABA......hACA...,2,-28,-17,11
ZGXDYKVOUfBNCFEcHTMIgbQAaPSedRLWJ,aAFBeCCHLDDCZGFEDDBF.KDHFUAGH.BAACFACFEGFG..HCGDhACAMBBD..IHAGhADAgGBCACBAdEEHJAHFGFBFhAEA..YEEDfAEACAACbEAC.hAHA......hBBA...,1,-16,-18,2
BMKLFEDOaSgZeNJUTYXfAVCIbQRHcPGWd,CFDDQCBCRDAA.HABGGBGABHEFMBCAKGGFEFAHDFFF..OHAAhAAAaFFG..SGDFhAAA.gCGEhABANIEBJDDA.YAEBAGGBIBAC...hACA......hAEA...,2,-38,-16,22
YBOfFWAZJKSgIHUPECGNdDLQMTVbecXRa,ZDEDJEGH.KGBH..SCGCHAFEUDCA.EABCCGAGGECA.dBBFhAAADAEDLAFCQDGEhAAATDAEeGFAXCCAhABAaFAB.BFEE.OHECFBAHACCE...hABA......hAFA...,2,-16,-16,0
EABOUbgcdIPKTeaLCWFYJfGVQRMXHSDZN,OEBEUCBC....bGFEdAFB.IDBCKDDC.eEGDaBGECFGDFHCChAAA...JHEAfABFhAAAGBBD.RGAAHDFChABASEADDEAHNIDBAFBABCGH....PBDAhAEA....hAFA...,2,-24,-19,5
OEYQSdTLKHWNZaUAcPFIGVfRBMbCDJgeX,FHBGGEDHRCCCBDGBCAGDDDCA....eBCCXADGEGEE...QCGGhAAATAGALDAHhAAAKEACHGDAZEFAaBAAAAECIBADhABAMIFEJHAA........hACA......hADA...,2,-25,-15,10
VgSbDZYEaeHJTRfMBdIUOCGKPNAXcWQFL,XCBCQCBCLDECSACCZFBHEAGAeGAE.HCFGRFEBBADEhAAAIHAFCABA.PBDGhAAAACCG.FGGEgGGHhABADEDDaEFH.fECBMEEHOAFAKFADNBIE.hABA......hBAA...,2,-7,-4,3
cGfULFBAWSNQEgRTDdbMOICHaXVZYeJKP,SHBGEGFCRAAB.dGFAMHBG..ICAHHAEFaEBBZFBAJEFEKBEEhAAA.GCEHLAGBhAAAFABGAGADNEAC...TDCAhAEAbDCBCADD...YFHF....hAFA......hAGA...,2,-23,-8,15
fDOHdSZLFaWIEePgYXVCJAKbQUGcBNRMT,QGBCUFGHBFEARCFGMAAD..DAFCHFEAZDBG.aBED..EAACeBHHhABA.PHFE.hAAAXDCGJFBDADBCKAEFbBBChACA...NAEFOEHFdHFDSACH.hADA....WFCHhAIA...,1,15,-45,60
gPdcXKRNQUYFIDCBTEZMOfWJSeHGabLVA,dHBHKGFCQEAFFCBFDEEC.BBBEEBEHZEAAMEIH....OACGhAAAfADA.SCGDhAAAeFFFHAGFbEDDhABAABABPEHF..cFBE.NDAHIAGGhACACGBB...hABA...,2,-27,-20,7
EDBPLAVfYeOFcNUSCIgMQTZGWbdXHRJKa,VAADeGEAFDGD.UAFASBGH.CAED.IEAA.MIFChAAAQEEE.hABAZFACbECAXGFAhAAAHACDKCAAaCDFBDECLDAAAHBB.....hACA......hAEA...,1,-19,-22,3
BJCHFGPTgcQOdNEYIWafeSbRKMLDZVXAU,BFEEJFCAHADAFDAHGEBA..TBBCQACBdDEFEAAF..hAAAIHHEfHGBhACASAGHbBFA.MDHDhAAADDADVFABADFBCDDEgBAE...hADA......hAFA...,2,-27,-9,18
aJebGHWXcOASgZNYPVRLUIKdEMTQBDFfC,SCFCZAAD..NGBD.VGAERGFGLAHFUFFE.KCDEEBBA.MABAhAAABDFA.DAAFFDCACAFA.hADA...eEBGbDFA.hAFA...WBEC.......hAEA.OFAHADGG..hAFA...,1,-18,-36,18
PQXVSDCIOTHWegLMdbYNEKaRfGFBUAZcJ,ZFDFJGEA.QDAC...VAEBCDEGTEBHeGAELBHDhAAAdHCB..NAEHKDGAaABBfGFBhADABBHB.hAAAAICG.PCBA.SDAFIDDB.OACChABAWFHH.MFFE.hAEA...,1,-19,-34,15
KdJEeFXUYVZLCPOBNgMcRQfSHAbWDIGTa,DACBTAGHKFDC..dAACEHDC..FCFFUAABZADE.LAED.CGAFBGFBhABAMFADQDABhADAHDFAbDBB.GDGEhAEAaHFE............hAFA......hAHA...,2,-36,-12,24
TCfKJQeVRENDXYPaALMIScWFgdZBGUHOb,MDEBSHBGFDBGZBGHBFCC.HAEGOADGCEEGKAAC..JFCDeGFChADA.ECBDDBAC.XFFAhAAAaEGAAHDG..ICHAhAEA..WBCA......hABA......hACA...,2,-47,-26,21
SILYODPNJcCQdgBMFVUeRGEXAHWKbZafT,HDAGKHBGZAFBaFEC..SDHHLGACOACEDFAF.JHFGQDCAhAAABAAEMCAC.FDFDhACAeABH.EGHHAIACfCHAhADATADC..YFFH.cFCChABACFHHgAFHhAFA...,2,-21,-21,0
WZNeLIUGOHYdRSPVKJXbDTFCaAcfMBQgE,MCCAQGGG.EFAENEGA.LCHBGEAEHCFCRBAF..PFEHhAAAKAAHXEDADEEA.hABACAHGAICEfAGHhACABADG.WAEHIAFFODCFdFHASGAGhADA.....hAAA...,2,-24,-1,23
USNIVAdTMCfKQbRWgBPcHaJYDGOELXFZe,TAEDMBFHKFGF..RCCHBABDHGAE..JEAEDIACGAAFEGAE.FDGGUFGAhAAA..SGCEhAAAIHEDdDGDCDAFQAGGhABA.WHFAcDAG.aEEHLCDBhADA....hAEA...,2,-27,-13,14
ZLcCaHTJGNUWQXEPVYdIFSKbMBefDAgRO,RFDFLFFCCAHD.HGCAGCEBUEAGQGAFXAAE.EADAVBDGhAAAdGGEFCCG..KGGGbBABhAAABBHH.eDFCDFIFAICGhABA............hACA......hADA...,2,-17,-17,0
bfcLEFRDYCdIKXeVZGJaOBgUQPTHNWASM,SGFHMCCA..bEFCLCHB.EBAFDHEAdCCBIBHHhAAAXAFGeDBFGEBAhAAA.aDDCBGCC.gBAFhABAUFDE.PDDFNEAE.AGGCcAEAhACA.YHAAhADACHHA...,1,-5,-35,30
aYVTDMbOSLgcPWXCNFQAIfURedEJZHKBG,UCBCRDEDEADA.ZCFGBBGDGACF..aECF..VEFBMHFC.SHBEhAAALDADPFCBhAAACAHE..FDABAFIF.eCBEhABA...........hABA......hACA...,1,-30,-31,1
XFRCAMEgGDLecQOJUWdKISaTNYBVPbZHf,MHFGGEAHLABAQAEEOCFBJFEGUABAdGCHKCCG..IHCHhAAASDGA.TDAEhAAANDEFBHAF..bAFAhACAfAGF.FHGAAHAADIGE...hAEA......hBAA...,1,-17,-23,6
MGTLIfOgPYASKWNcdZUXJQRVEaCFeHBbD,SAFBKHBG..NIEBZDDHUFFG.JBHDRAAB...EFDECFADFAHFeCBDhAAA.BDEDDCEEGCGEhAAALABE.OFBBhAHA..gEBBACCC.dADD...hAIA......hBAA...,2,-29,-29,0
gXBPcWJHbUdYRQITFEfLGCAeNOaSKMVDZ,eEEGaDCD.MAAEDAAFZAECBCDB.....PHCEJEECUGCGdGADQDBBhAEAFDBBLEHBhABAAAFBSBGGhAGAKBCG.XFGA.cGEA...hACA......hADA.WAHH.,1,-14,-40,26
RUFfIBYONTgZJbeVWadSMKDCAEHPQXGLc,ECFCQFDHGGAFLCBAUBCFFAGFBHFHOGEG...NAAFZAFChAGAJEACeDEA..aDGDhAHAMABHDFIFCEEBADDHXGGBhAAA..cEBFfFAE.IEHHhACA...hAIA...,1,-21,-24,3
MVTILaXEQDWfNABdZSKgePJRGFObUYcHC,dGFHZFEESCACKEEE..eEAEJFCBFGAFOCCC.UAACHBDEhAAAMAIDTDAD.aHDEhABAXADE.EGCChADADIGG.fEFFBHDA.RAFE....hAEA......hAGA...,2,-35,-10,25
HUOVRJLeSfINFCYcATgbMQWdaPKXDZGEB,TCBCMCCAdEFE.KDDDDGFD.GEGEBAGDUDAGRBEALFAB.SGDBhAAA.IACAhABAFHAEYDHFhAAA.AAEB..QGDCaEDA.XBGAhABAEAGE.....hAEA...,1,-22,-31,9
QJGETfLNXcKOgBdZWYAbUSeHPaFVCMRDI,SGFCeFBBHCCGaGFCFECF...MAAHIBFGQDGH.hAAAEAGGLCAE.hABAXEEGcDBHKGDHhACAOCGDgAEEdABFYHBGABCA...hADA......hAIA...,2,-27,-6,21
QZOTbEYXVRNFUHcaBDWGJLKfAPIeMdgSC,eGEAMHFGdEHACDDG.ZFDGOFDB..EAHD..VBFERAABFDEDUDAFhAAAHADHBBBBDFCBGAFAhAAAKHAAAEFH....IBDGhABASDAA.......hACA......hADA...,2,-39,-13,26
bUJNXRVCFgHELdWAaQMYTeKfISZcBODGP,QAEDTFDB.KAADSFFEBDCGDGGGGDDGUCBB..NCIERGAGhAAACHAFFCGE..gAGChABALHFAdDAAaGGCMBFHhACAeFCD..fBCEIADAOHEChAFA.....hABA...,2,-27,-4,23
WKMdYLUBNDIJeCTAEaRXQfZgGPSFObcVH,EEHBXCCBZCCDGGBB.FHGEOHEA.VCEDKCGEdEFALCABhAAABAAGDDBBJHBACBGCaGABQEGAhABA.fADHhACASCAC.bAEFWFBA...hABA......hACA...,2,-26,-10,16
eLNKVCXcHJdUaDgSBEfYIGFTbOZRMAPQW,QCBCeEEGLDCFKACB.CAFCHGEGUBGADFFGBBGE..EFBFfACGhAAAGEDCFGGEODAFhABAMAFE.ADHH..WHAAhADANBAC............hAEA......hAHA...,1,-24,-27,3
JCbacXNHfTZPIBMDQeOGEKRWVgdYUSFLA,JAFBaEGD....XABEHFEFTBCB.ZBAFPGACBHBBQDGAhAAAGAFEECDFKCAGhAAA....WFADhABAdFEEYEAA.......hACA.SGDFhADAAIHA.CEDHcGGENCIG,1,-20,-24,4
MaDCbSPVKXeLBgNRJZGcAYUEdWfHIOTQF,EGFCdHBHHBAH.TFEAQBDA.MCIHCHHESAFFhAAAKBAAeGBELEAEBDGEREBEJADHhABAZAGB.AGAB..WAAEhAEAfAGFOEEEDGIF......hAFA......hAGA...,1,-17,-20,3
GOUeXPMgIcRafYZKdWQDSLJBbANTFEVHC,FGFCVBCFHDDG.CGCBGDAEOHFE..eEEEMADC....IHDGhAAA.aGBHfCCBhAAAKFCFdDAEDAID.hABAJAGFBHBA.ABBCEAHDXFGA.cFDAhABA...ZAEFQEGEhACA,1,-21,-23,2
DSdJNfPAMbeCTYgQcOBXZUHEGWFRVLIaK,eCHDTGGGQABD.BCECZCCAHBGHEGDGFFFERFBAIFFHhAAA.DACESFAEhAAANBCHADIH.CAGBcDDEhABAOBAF...........hABA......hAFA...,2,-27,-25,2
PHJbeKMVXANdGgLROfDBScFCIEUYZQTaW,GEAHLFBBOBAFBCCGFBDEEAEC.UGFAZFEDQCCB.hAAAaCHHPBHF.JBADhABAeGBA.MIAAAEGDdFDAhACAgGGEDAGH.CAHC......hADA......hAEA...,1,0,-37,37
MLCFAEBIcTVgGUYZQdSKWaORHfDPNJebX,BFEDTCBCGACG.UFBEQFFDKDGF.aDFBRAEEDEID..hAAAPHCE.NAAEeAHDhABAbBAFLHFAFAFFAHIHEEAFhACA...IEDF.cEGA.hABA......hACA...,2,-35,1,36
GKXbVQAUJDEOeSLMcZCBgIPNWdHTfYaFR,UEGDEEGC.OHCCLCDFZCEE.CACGBCHC..IBCH.hAAA.NIBHHEAH.TCEBhABAYBADFGCEKAGChADAVEAFAHHADCCHMDDF..gAEE.hAAAdGGCaAHF....hABA...,2,-35,-6,29
FDEWPIBXbMONAJYUKRafcLCgSZGTHdeQV,JDACKGFCRDBG....aDGBLBCE.SDAFGGABTEDAhAAAHGAGdAGBeBCGFEFGEHEChABA..IAAHhACABAFDXGGDMEIDOFDFABBHUAGAfFAHhADA.CHHD....hACA...,2,-23,-8,15
bMAGgafKeXEWYIZVJLOQSHdFcPUDRBNCT,aGAHeCCH.EEFA..ICFAJACA.LAACOAAHHFCCFCBAUEBChAEADFHHBBBE.CCHBMFADhABAAHCDgFEEhAFA.fDHEXBEAWHDAZAEE...hAGA......hAIA...,2,-25,-20,5
NUQEXBWOHARbTVeSJfKFCdYGDcPMZgILa,TFDHVDED..eBFCJBEC...FBCAdGHCDEIFMDBDZGDG.LEDEhAAAUDAF.QBAHhABABBACOFBHAHAGSCEGhACACDGB...YHAG...hAAA......hABA...,1,-14,-36,22
BeAGTNbJUcSfFHgOYWXKECMQPVIZadRDL,TAGHJGEA..SADHFGEGHBACOFCD..XAGChAAACBDBMCFF.VDECZDAEaGAHhAAARFABDGIBBFBHADAB.NCIC.UBBAhABA...fHCH...hABA.WHEAKFCC...hACA...,1,-13,-30,17
BSJNfXGdFZRHWeOVCPDKQMYEIUcLTgbaA,JCAFXCBCGGCHFECGZEDE..RFFE.HCDGOCHBCGAF..DABBKABGMIFGhAAAEAFB....UGAEhAAATAFEaDAHAAHCBGGEhACA.SECCdGDA...eBHH.hABA......hADA...,1,-11,-24,13
FgeIDCMJWABGSZXEQfTHaYdNPUROVKLbc,BFFCSCAHEHAC.QFGHHDFGdECAUAEDOCDHKCAGLBFHhAAAFACH.IHDAhABADAHDCFHA.MBBGAIHE.GFAFhACAZGDE.fAHAaFAB.NADF....hAAA......hABA...,2,-27,1,28
SNgBWLMFVIDERAHPaXdYUQKcfOZGbCeTJ,HDAGXGBCdHGHUBBHKDEC.OGCGZEFGCBDE...JAGF..NBCA..hAAABHHAMEHH.IFAEhABAEBFAAAAD..aFAB.hACA...cEEA......hADA.fHAFhAEAbGECeBAFgCGH.,1,-19,-29,10
dAgQBFCXbNaWOVMLTGIeEHDSJPUZKYRcf,BHHGFFFBCGDG...XAGD..NICB.OBDHLDBD.GACAhAAAIAADHAFFSEFFhACA.JADChAGA.UDGE.ZFDHKGHHYCBFfBAFhABAAAIB......hACA...,1,-24,-38,14
WZCfUKgbFGVORNXDTeAYdBcPISQLMHEJa,BFED..PAFBIHADQGFA.MEIHEAFHaCDFCDBFKCGBhAAAFABAGGAH.OBCFhABARAGHDGIHAFHGdEADSEAAhAAAHEDA.ZDFGfABF..hAEA......hAGA...,2,-36,-8,28
PbJeBSNDcKEHFIROUQGLfaVgZYAdXWCMT,XGBCCBFD..PGFCJACB..SFHDDDHFKHAE.HFEDhAAAFFEBRCCBUAFF.LEDChABAaDAH.ZCEAAACGdCBChAAAMEAF..TAGH...BBACNAIEICAEhACA...hABA...,1,-7,-40,33
AXSUMYdIKRLeENQBHFgcZPGTbDaOCJWfV,XFCAUAEDMFCFdAFB..KGGBeCFG.EACGBEHAHEAEFFDDZDCCGCABhAAADGGDCCBC..JFHFVDEEhABAAIEE...SBHHhACAIAAF.LFAF....hADA......hAFA...,1,-15,-26,11
JgDbNKfQZPGdAUSIMROHYFBacECTLXVeW,SGFCMECGREFG.HDBAFCAHBCHEEDFGCACGLHAC.XAGFhAAAeGBEJHAA.DAAEKAEDhABAQAFFPHFCAGBAOEHFhADAaCFC..TBBC...gGGGhADA..hAEA...,1,-4,-34,30
DEISeFVCfRLNbAOUQZTMXdBJHaPYKgcGW,ODCHQCCBZGFE.MEEEdAGGBBCCHFDEaABEKFGC.GAEF.DAAFhABAICABFHAC.CHDA.hAAAfHFHLAEBAFEEhABAXFAA........hACA.YFHH.hACA...,2,-46,2,48
agWZXJODQSLHecdKMAEbIPBUYTVCRFNfG,EHBG..bFEEBHFDUCFF..VCFHRADAFGACGACB..aGCDZAAFhACAOBCHSEDFhADAeBAFKEAAAGAF..IGHDhAFA..........hAGA......hAHA...,2,-31,-28,3
HJIfAQKFWbBYgEMcZVLSXdRGCeODTPNaU,KFHBFHBGBEDCEEED.ZACGLBFE.dAAGCCAEOEHBDHEE..TDAHhACA..aGABUGCGhADAJFEB.ADFHQGAChAEA..YCGDMCDF...SCDAhAAA.XDAEhABA,1,-29,-48,19
fEcgDHOVaNALbKJMWdFQeIURCYTPBZXGS,KDCDMDEBFEEE..eCEEUGBDCEBB....TBADBFHFGBCDhAAA.SAGGhABAEAHHDHEGOGAA.NICBABFEJHEAhACAdFFBIDAG..YADD.hADA......hAEA...,2,-42,-24,18
AeWDRfJMgHEbVaZTOQBdICXScPYLFUKGN,eFCHRFDGMBAAHDAA.EAFDaGADZBCC..QBDEIHFGSGAFhAAA.PFFEhABAFDAHKCGB.AEIFDAGDfEEHhACAJCAA.........hAAA......hABA...,1,-7,-39,32
fWXFJVGDCLIZBRgMecdNaUPSOHbQETKYA,XCBCFDBDGEEHLAEBBCBFRACA...MIEGdHADUAGHOEBCHECBhAAAEACFKGFGAABC.JAHDCHGE.hADAZGAE...gEGDhAAANDDF.........hAFA......hAHA...,1,-13,-25,12
KgNefVCDBLIUXFbdPRMEJaQYAZSOHWTGc,ZDEDSDBDOACGHDGHGADCKGCF...eCBBVGFABAGFUAAFhABAFBGEdHAD.MFEFaGGCABEBhAAATDGE.gAGEhADAfDDGDDDD.......hABA......hAIA...,2,-29,-5,24
IgDYeNHdJEALbPVZWCKMUcQfGBaFTRXOS,LGEAVAAD.CFBDKDCCUFFG...QAFGGBEDBAEFFDECREBGhAAASHAA.hACADADFeHACdDHEAGAD.ZBABhAAA.MEECaGDDTCGH.OADBIFFHhABA.....hAEA...,2,-23,-20,3
LZdHUNfeKQTbGAcWXgJPVCROYBSMFaDIE,XCBCJGEA..CEHCRDCHBGHF.FDGADBEGEAHBZBAB..UADG.hAAAeHCGTBGFGDEEhAAAAGAA.....WCADhABAPHAEOGAGMADE.LCEB.hACA......hAGA...,1,-22,-37,15
PNEDMbBFZYVWOdHSIfaKUXGcQALTeCgJR,LFCAeGFACEAA.JCBCRFBB...EAGCDIDCBHFGZCCG....VABGhAAAdHCFIEAB.hABAKAAGGAGAADFH.TEEChAEANDIA..FADE.....OCEAhAAAfGAGaGAF..hAFA...,1,-26,-31,5
CfDeOLcEGRNaHFTbdZWYUPVJXAQMISgKB,MFFFSHBGKCFBBAHBCCCA..DCECLHBEGEEH.RDBFHEGBFBAHdEDGhAAAZAACUEAB..PAEHhABAJHDC.AEEE.IAHAhABAeCAHEBGE..aGHD......hACA......hADA...,1,-9,-29,20
JOPEbQgAHKGeVUFcIBaMRSTCfWYLZDdNX,KBBDGGDHUGDAFBEDBBFAMEFE..RFAB.SAAB.CDBA.fEFHhAAALAHHDACDhADAdFHE.JFABEDCD..bEEChAEAAEAAeAHD.VACE......hABA......hACA...,2,-32,-21,11
defLYaSNFGCJDBgKQURAOXZcPIHWEbMTV,XAEGZAAD..IFAEEDAH.MCDCVDCH.dHGFeEBELHCAhAAAaEGF.FBGDCGHADBHBhAAABBAGKGDCUEGA.AADBPFADhABA..WCCGfFEANICB.hADA.gGAAhAEA...,1,-6,-39,33
QEWdFCfVeNUPJObGcZKADaHRLIBgMSTYX,aEAEHDBGLEDHBAHDSABH..TBGHQADAhAAAEBCBFACAVFBF.UGFAhABAODGBbAFD...ZFGBhAAAAFHCDFEGIBABMDAF.YHAA..hABA......hAFA.dAGFCHEC,2,-19,-12,7
WbFPUVTKEcONMGBLagYAfZXeJQHIRCdSD,XFDHeFCAHBCGRBBC.dFAG.DGIBFBEAUBAEKDDF...EHCGOHFChAAAGDEFaEAFAGHH...ZAGFhABAIHFECFGH.SAEEhAAA.bDAE......hABA......hACA...,2,-34,-11,23
DQFVHGCaKXZSOeUbgIfdJPLcMWTYBNARE,EGGEFDABGFEHKCAC.ZBFCeDCDUDCE..IBHHdGBELAAEhAEAMABC......hAFAYAFEADGCDCCG.HGDEhAAACAHDaHFE..........hAGA......hAIA...,2,-29,-27,2
CgSKXVfbMBdLREYNaUHAZTPGIcDJWQeOF,TFDHGAFEDIAC.QFACeDBHOACGFHEA.CHDG.KCDG..fAHChAAABAEAdAAFRDGFNDEFHBAAhABAAEAA...PFFGhAGAIHHG.JDCFSBECXEED.hADAMEEA.EHAA..hAHA...,1,-11,-17,6
HWLPdXKUSFcgeOEGTQaYZCNJfDMAVBIRb,BFDDRAADHDBDLAFCdCHEKGCG.FEEE..eDFDEDCGGCAEQADHhAAAaHDA.CHFF...fCHChAAAAFAGIAHFbFGD.hACA............hADA......hAFA...,1,-24,-26,2
RBICUbLYfZGPFTgAdOSKWXMVDEeNJQaHc,dEEDOEGHSFAHKGCH..MCAGECGBJAEEHDDF.BCFHUCAFLEABhAAAZDCBFHGAABCGXAGAhABA.DAFHNCIE.aDAAhACA....IAAF.CHBA...hACA......hADA...,2,-31,-24,7
ORbQPUEJLVZGDaWecNHgSFAYdCXfMTIKB,CFEDMFFFKBFG.RECH...QBBCECBALBFDZFFDGDBFDCIF.eEABhAAANEAA..HEGBSEHHhABAAHBHdABH.XGDChACAfBGFBAHB.PADA...hAAA......hACA...,1,-12,-24,12
EOGMNUYPSTAHCeBFfgcJRQDKVLWdbXIZa,HFEECEFAFBGC...fAAF.JDHFDIECLCDFdBBGIHHEhAAAaEBHGADFUFAA.SHCEhAAAAGDHBCCERBEB.KBHBhADA.WHAGZEDFMABCPCFD.....hAFA......hAGA...,1,3,-39,42
MWDATVeFIXaZUQYNgbBOdCJfESPGKHRLc,VADGFDCD..aABDUCGB..QFDH..NDDEBHAEhAAACGBGECGCSHGChAAAKGGHRDABLEEH..WAEEhABAACAA.TBDCIABA......hADA......hAGA...,2,-37,-29,8
cSGBETKHIAObCPZNgRMeVLfWadJFYDUQX,OAFBCFDGZAFA.RFFG.MFIDLDAE..aGFAJAAG..DGCBXGCEhAAAGDAEBAAF.hAEAEBCETDGBHCEGIHFGhACAABHCbECC.........hAGA.NEBE.eEEG.fCCEhADA,2,-31,-18,13
IJbMYgTcOZaBKdQDPWeUNfCARSFHLEVGX,RFEESEHBFAGFLADBGEBC..JDHHbBCE..MBFH..hAAATAGAOBBDBEGDhAAAKGDFdFADQGGGhABA.DADC.PFEFeBAF......hACA.NBBEAEDG....hAGA...,2,-29,-15,14
DAbeZFCQJVRSgNBfEcTYWHaIGXLKMPOUd,eFBBCCAH.QFDHVFBF.RDFG.SDBABAHAEABA...TAEGhAAAHDBAIAFAhAAALFFAMIECUGGEABDEbAGHhABAFBAHJACBNCCB..........hACA......hAEA...,1,0,-24,24
WMATaLBJbZOUfIgeGEScYXVCQHPNKFdDR,TGGDBDGFZEBA.UCDC..IEAAeDHFGAEDSEGChAAA.XECGCABDQGFChAAANABB.KCAEdCDGDEAHhACAMAIDAAHG.aHCA.LAGFOHCA.EBBC.hADA......hAEA...,1,-6,-23,17
gdUVAKXfaPLBZYTRbcJMWEFNOHeGISQDC,XGBCaHBGLEFABEBBZAEF..RDGB.JDBFEFCA..OCAAHBBCIAAAhACADDAD.dAGHhADAUGEGAFFCKBFD.fGHAhAEATBGEMBACNICB.SGHDCFAC.hAFA......hAHA...,1,-15,-23,8
BAaNKZPUISRDOdCLXeVHFEYfWcbGJTgQM,aAFBKCFCZDFC.UGFHSDAF.RCDHDFIBCEBHLBDH..hAAAVEBHEAHB...fGEGhAAA.bABFhAEATGBG.gCAHBFGGAHBHIDHGhAHA.....hABA.dGAC.,1,-21,-39,18
gORHaVTcNCADGPKFYEBIJfdbQeWULMXZS,DCECKGAHFBADEDGG.BCDA..JDDCdFGB..eDBDUCFALGFEhAAAZEBA.SBAChABAOAEE.aHCG....hACA.cBGANAIAADCD.PADA..fHGBhAAA...hAHA...,1,-31,-48,17
CKZTNHDfQAPgJXERcFOUWMIBLdbVaSYGe,JGEARBCFOEEC..UACGMHECBHCE.dDEDaEAFGAGC..hAAACDGAKFCGZBAB.HAAFDFFAAIFAhABAPAHF.EAFFFGADhAFALHAE.SGGETEBGNEIE..hAAA......hACA...,2,-29,-18,11
HLfDKYQIaAUVcdCRXebJgOGNWFTEBMPZS,VEFHCFEDRBFA...eCEFJACG.GACG.FFBGBEEEZAGF.LCCBhAAAKGDA.QGBGhABAaCBHAHHEdAAF...gGFAhACANIBF.TDGFEAFBMEAF..SBBDhAGA..hAHA...,1,-5,-39,34
EMZKQfabeGFcJCTXVWHDdRSPNLOUAIYgB,..IFDGBFDGZAEHKAADaDBA.GCGGFCFD..JADFCAAF....hABATGAGVEADHFFDhACADCCA.dDHASFEBhACALHCAADDBEAGE.MBBE......hADA.fGGEhAIA...,1,-22,-34,12
ZNBbASVLMUOfCdQXDJEHgaYKFTReIcGPW,SDBDMAGDUAAB.ODDFdFBD..DFHBHCGF..aDBFKGGFFFEGhABATGCH.IACGhAAAPHEE.ZAFEBADChAFAAGABfBAACBHG..JBEBECCF...hAHA......hAIA...,1,-12,-36,24
VPTZKdOXgbCWaREGLcFMJAUfIYSeBHNDQ,UCBC..IFEDSFAHHAEEQEGATGCDKBCDOFDChAAAXEAG.gGGAhAAACHHE.aGADGAEAhABAFDFGAHFB.eHDGBCAGDBBC.ZAGFWAHB.hACA......hADA...,2,-20,-8,12
DCfAPNSKTGLVIaUWYHMbOBEQRJgXFdecZ,SHBGTBCB.GCEAVFCC.UACGHAFHMAGHOEAF.EGFChAAAJEDF.FFAGeBAHDCHFADDEhAAAKCEBLBAFIHHDhABAaGGDYCHBBAHF.......hABA......hAFA...,2,-20,1,21
LXeaKOcAfQHMJRdFSBTVDECPgWGbINZUY,HEFHJGAC.FCBGBHEADBBA..EGDDCCCB.......PBFHhAAAGAEA.IAAHhACANAHEUGAHLDAAaGGH.hADAKFACAICEQDBGMDIBSHGAgEGDhAEA.WAHF..hAGA...,1,-8,-47,39
MUQeacOLVPXRFBDATgKfJHISWCdGEbZNY,KGFCJFBBHDEH..IBGHCAEDGEGAZCCC..MBACUABFaDDHOHAGhAAA.LEEGhACAXGDGBFBDAHAHTDAHhAAAfAEEdAGANCAF.eFHH.....hABA......hACA...,2,-27,-16,11
IUYOCacfNdLABMSGbFgDPXRHWJEVeZTKQ,SAGEFGAHDAFE.RABDHFDBEBCFZBGF..QDGGUDEG.CEBCaFAChAAA..fAAFhAAALAEDAADDMIDCbFFA.hABAXFBA.JFHB.TDAEKEEC..hADA......hAEA...,1,-4,-30,26
UCJYRVIPLcDQFKZXbTBEeSNdagGAMHfWO,MECGHAADOGEAUBAA.CAHE.RFCE...IDGHLEAF.DBGEQFADhAAAKHEGZACF.bDCBhACAECFD..SAEHhADAdDHEaGGCAHCC.WHFA.YEEA..hAEA......hAGA...,2,-25,-20,5
WJMUcaHYZPdAVRKSNFLgIQBfTeDGCOXEb,RDDFKAFBFBGFLEBF.QGDGTCBGeACCDBAAGEFG.hAAAOCCEXGEEEDHB.hAAAJDHDMCADaFCH...hABA............hACA......hAGA...,2,-34,-22,12
SHXEIKDYOegTNbCZLfABPJFWdaMGRcQVU,BAFBFDCDdACBaDGCRGAG...QFCBUFGAHBDCEGGC..KGEBOHDChAAA.eACFTBAEhAAANABC.CAGA.ZCEHAFAA.PAHFhACAMBID......cEEB..hABA......hAFA...,1,-13,-28,15
MIACLXTgFNRDOeWKJYGEZHUBbScfQPaVd,LEBEXCGCFFDBRFFCDEGA...eCBCJABE.EHDEZAFC.BFGCSAAChADA.QAGBhAEAPCCHdHGFACGFCCHHTBDFhAAA..OFABKGAA....YHCGhABA...hAFA...,2,-26,-25,1
SGfgaNWYKBTAHbFUOcdQPDRIJLeVCXEMZ,HDAGUGBCdGFADAHFRFFBLBAG..eAABCEAD.ECGDMBEEZFDH.GCEHhAAAaGBE..NAIG..hABAKFHBBEFD.AADEFFHFhACAOACD..........hABA......hACA...,1,-21,-33,12
TMBfRdKPZGHQEIgNeUDLFAXaVWOcYSbCJ,VBCFOGEA...SCABJGFCBABE.dAGAKAFAGGBF.EADChAAA..IEFHhAAAeECADCCHADFE.XCGAhABA..aEAEWHEAYHAA...CHEGMBBHhADA...PCHFhAEA.,2,-49,-14,35
eBWFdVJbQGaIMZHNXRgPYEAKLUcSfDOCT,KGDDLDACUBEE.SHGADGEE.OGCGeBAHBGHG.FECEhAAAVBEC.QAAAhAAAaGAF.IEEGhADAMACEZCGFNBIG..gGEAEAHBACDB.fFAEhAEA.CHAG..hABA...,2,-41,-7,34
HYFgSBUOaECRIbQKfMXZJGdeWNAPDVTLc,VFDGTDAC..LAGFHFBGFAACBAAEOFGBCCCC.RBCA..QAFEhACAMECBZADBdHGFNIBF.hADADIBG....gDEAhAEA.SCHHECABbDFAfAHAhACA...hAFA...,2,-25,-12,13
gMNSGbdWVZUaRQATEYICOFfDeJPKcLHXB,EGFCCFDGFCABDBBA...eCFDKGBDLAACBDCF..MIFESCDHhAEAdGCBZAGHRDABAEIH..TGFAhAFAIEDC.OADDhAAAPCFG.XEFENIAF...WBBHhAGAaFAH...fAGHhBBA,1,-29,-32,3
SgKbMOaUCPBIFNHdGWLQJXfeVTZRDcAEY,EAFBSHBGKBCC.ODCDUGGBBAAB.FHBGdGFF.LAFFhAAAQEDDfEGBhABAeCABZCCEDIGE.AHADYDADhACAMAHFCHEG.NEEGHBBA.....hACA......hADA...,2,-31,-9,22
AMeICOPVTNUDWcJfHSEBdQRFYZKabLgXG,eCHDCAFB.OGBGTGDFDDDC..JDFHHEECBEAHQADHhAAA..FACEZDACaAADgBADhABAAFIDMCFC.IAGFhACA.NIBD.WECFfGHESCDBhAAA.EHAG.dHGF.hADA...,1,-14,-33,19
WXVfFdGZTagYJePSRIKCbLHEBQUNMDAOc,OGEAXCBCFAEDZAEC....TCGDaGHH..JEDBSAAEhADAKCFALBAEEDEEBAGBhAEAUFACDBIDACCCVDBCdFFE.hAAAgGBB.eFHH....hAIA......hBAA...,1,-18,-26,8
KOFTEafQAZBSLUIWVMYDHgJbeRNcPGXCd,SBBDLDACUFBC..VBGFMIAGDAACJFHDRFBG.....hADA.PDEDXDGGhAAACFHG.OBCCFAFGTGFChAEAaBGAAFEFBAFF.IBAE...hAIA......hBAA...,2,-31,-30,1
BeaAUMCOQZXgRcDWYLNFEGJdPbKIfVHTS,CFECQAEGZAFA.RFFGDDBCLAAB.FHFAJAHDdCFGKFDF..VDBDhACASDED.hADABBBFAIEEMDHHODAHhAAAXGAC..gGAF..hABAcCCANIEBECFF...hACA...,1,-30,-31,1
FJDUSQMWNCcHBVbZKTIPfLOgGdEeYaAXR,FDAFJEGH.UGCH..SAAFMFFA.CDHA.BBGGZAGB.KACG..hAAATAEG..PCDBhABAOFEHdGAGeGAEhACAADGGDIGAQCCC..NAFE.cDAGhADA......hAEA...,2,-43,-33,10
RJAgUECfbdKcDBQIXZHVWeFTGNSYLPMaO,EGFCCFDGdCABDDEBBHEF..QFBHZEBHHDDE.eCCCFGHHGABFhAAA..SAEEhAAALFFBMAEERABAAEIHfFEAhABAKBHB.IHHH.WAHF.hABANIBBPCAB..hACA...,2,-28,-18,10
UQTZJNLaIEFfOAKHBdRWgCSDMcXYPGbeV,BCAHdCFCRGFE.CGEG.DAEA..MBEH..XDCGGBFAeFAG.hAAAUAAFTABAZFGBJHAAhABALHBC.EFGEfDCChADAAHAF.KAGC......hAEA......hAFA...,1,-26,-38,12
UOKFPgLAIcJQeCHWbadMSNDBEGYTXfZRV,JGEAeGFAHCAF..aBAGdADBMCCHDDFCBAGGGBDG...XAGBhAAAZCCH.RFAEODFEhABA.FCAD...hAAA.gGCBAAFFIFFC.CGDA.SHAChABANIBF.YEEChACA..,2,-37,-14,23
eYVEMaNZDJOcAILgUBRdKFCGHWbfPTQSX,LGEABHHGKCCDGECCHCEG..bDBG..TADGSGAAhAAAeFAH.EBCDMEEGaAECDIBChABAOAGDAGFA.UFGFFAGACFCEhACA.PDHDQAAB.....hADA......hAFA...,1,-5,-19,14
agYbEJPQDOVTcHSIMUGWCXFZRKLBANfed,eGEAdAFBaFFE....bEBGEAAF..JBADDDFG.OEDH..hAAATGBHSGBBhACAMDCEUDGGCBCGFDAEKHEAAIHAgAFEhAAA.PABGcDDA.IADFhAIAXEEF...hBGA...,1,-12,-38,26
bNZYXTDHFcUQVBJGLaMEWfOCAdIRPgSeK,dCFCRAAD.SCADKEFGZFEC....XAEAHFBEUFGGBDHEJBHBhAAALECHECCC..hAAAfAFHAIFA.hACAIABCPFADgCDENIEBDFAD..hADA......hAEA...,1,-17,-38,21
bRBOZEfKFcWgCNJTGVdAQULIDMXPSYeaH,QDCHUDACDEGG.MBAD..SAHHaGAAHGEGRDGFBBBGECBAFDFBhAAA..gFDDhAAACAFCJBFE.TFGHhABA.dGACIHAGXACE.YDEHhACA......hADA...,1,-9,-34,25
bRMSPTLNWGEdXAKCHeaJgQBZDYcfUOIFV,CHCHHDED.aDCBJDFCBDABZCDF.DBIH......fABGhAAAUGAGIAAGFCAHRAFE.SHEGhACA.PAEAhADALFHBGBCFXGFFAHCCKGGBQEGDhAIAcFAE...hACA...,2,-44,-5,39
GIYKNeaXRCdSZOUcTEDWPFLfVJBAHgQMb,QFDHGBGAKDFDeBACRBCAdFADZBFD.UBAEEFHFDIBE..FHACVEAAhAAABAEBHADB.MDAEhABAIHHH.aGGBhAAAXGCA.CHAFSAGCOCHF.hABAWFGD....hACA...,2,-18,-13,5
adRELgWSbcfVJMHDBIQZGYANXKPUFOeCT,KGFCFGFCeHBGCAFE.dAFBRCEBLCAA..SEBA.hAAAfABEMEABBGDAhABAZDGFABCEXDGHhACAOCEHaCGAEBGF..WCAGbFBD......hAAA......hACA...,1,-32,-33,1
cfUINCPaVFegBRdXSbHOYZDKQAEJGWMLT,EHAEGECFLAAD..fDAAUAEBCDDB.aBCFeDFEBHEFXGEGhACAHBGFOFBHhAAADBCDAIFE.JHFG.MABETEFChADAcCEC..IFAC...hAFA......hAGA...,2,-23,-17,6
KUENDYXCSefaHRWQILBgFZTbJMPGVcOAd,KFAAEGFCDBBACHAC...eCFDaCFA.HDCD.QFAFLEEAFBBEhAAAZAEEJDHFMGDA...hAAA..PAEAcBAChABAAACAdDDB...NDIC.XGCE.fDAGhACAWGEA.IHHFhADA,2,-46,-3,43
RKBWTLbYZFcdeGOaVEJCPMUIgSfHNQADX,DEFAKDAFBBAELAFCZEEC.FBCAdBGCGEAD..OECHEGDACHHG.UGEAhAAA...SBDGhABAfCAF.QFFChAAAADDD.XBGGWFAH...hACA......hADA...,1,-23,-49,26
GJKWYOQLRdeVEDFCIMTNXPAZbSgfcaHUB,ZDAGSHBG..gGCFaGDCBGGHKBFGOFEDLFFChAAARABHeAGBECAD..FHGAMDEAhABATBDCXCBFhACAPEFAAEEG...fFAHcEAH...hADA......hAEA...,1,-13,-29,16
OBEUTQeKCSfRZFDbYcaJXNgMLGIdWPAVH,VDBGHFEEODDE.BDHHEGBAUGFCeADBKBGBCADA.RFCD.DBID..hAAA..bBAHaBGFJFAFXBAFhABA.MIAGhACAICCFdEFB.AFIBSAAF.FHFEhACANCCD......hAEA...,2,-22,-15,7
OXeHJDaEfYULMTbAPNgCVKWFdIcQRSGZB,...PDEHCFGCKCEDFAFAdBCH...QDABSAFGBBDC.hAAAeFBFDFIBaDGG.fCAAhABALHEAMABEhAAAAHFDNHAH...WAHHIGGG.cEAEhACAZFCB.....hBAA...,2,-35,-28,7
BaPNUGYbVXMZKeLcSHITCOFgDQAdRfEWJ,dCFCRDAGEGHHJDBC..BHCF..aHCEUDFEGEAE..VACBMFIHhAAAKBGALAFC.hAAASBAEHFAAIBAGhABATGFDFHEADCAHAEID.fCHE.hACA.WFEG...hABA...,2,-30,-20,10
LgWTHBXJYDREZdPQeAaINMKVScbOGCFfU,aHBGMCCA.KEEG..VDAC..SHEE.OFBHhAAAFAFEUEGALAHHgAAChAAATAFDBFDBXDAChABADFFF.RFGBEDDCPCCAAGDE.ICGDhADA.NICB.....hAEA...,2,-33,-14,19
LOBXEbGTYJPcaCWQMUZfdDSIRKVFHgeAN,LEEGBFFEEHEAGGAFTAAF...JAACaFBB..CEBB.MCIHUBGChADAdGEH.SAFChAAAKDDAHAEBAGIDNCDD....hAEA.bEGBPHBC.WDAE.fDFFhACADAGE....hADA...,2,-24,-20,4
bJMLXQTgUVZdHRfcPIYCEWDeSONaFGAKB,BFEDMDEBLCCDQFBCUBGHZAGHRAEB....fGGBhAAAIHGHCAAEEFBB.DACAeDCGhACAOBAFFDABACBCJHDE.hADAXDGD........hABA......hAFA...,2,-29,-24,5
LGVDbSYKaBEdZRXWMCUeNITOPHgcJFAfQ,QDACLEGHDDFASEEHKAFCBEBEZDDFRFBH..MDHBUACGIAEAhAAA.OAHFhABA.HGFAcBAHhAAAABGFGACA..YBHHdGAC.CGCGNIAF.hACA......hAGA...,1,-2,-38,36
DNcCUEdOHRSZFPbMBQfXeJYGTgaWVKAIL,LFCHDACBCHAG.UGGGOCEFRDCGZADG..FGEBMACGBHCF...hAAAQDGFXCGHeBBHhABAGAEF.TDBDhAAAWFFC...AGGEIFADEHAA.dBAA.hAHA......hAIA...,1,-21,-30,9
LMFRcdTebKHOUEfDABCVgWXZGQYPJaNIS,VAEFXCBC.GGCBQFGC.JBAAIBFA.LFFAhAAAFHBEdDAHTEDBhAAAKABGOEAHECGCDACEADEGBHBGhABACAHA.WCGH.PEBCaGAGMIFA..hABA......hAGA...,2,-19,-15,4
JTCEVFBPbgSaDfUeXIAWNGdYKcRMLQOHZ,GAFEdAFBKHGEREBBMFBH.ODDHHBDDZFFGCGFB.FABGBCBC...hAAA.PEFA..hAEA.SBGDhAIADAAGUDAHIFHAADBB.WAHBNICH...LHEAhADA...hBAA...,2,-31,-24,7
LPAONVaQJKdXMFYeCTBIfbDUGWRHScZEg,OFBBVDAG..QGDFdGEGFADF.CAFE.BFHC...IBBChAAAfBGC.DCCChAAAUDDD.RAGFSGGAhABAcEFFEHAELABCADCB.aGGC.KEDBhAHAMCAB....hACA...,2,-40,-14,26
RBdTODAUKHVLSceWXPbMIfFaQCNGgJYEZ,HBCFVDED.SEGA.eHCGPHAGIAAHFFHB.aBHHCECHGAGGhAAA.JDAGYFBChACAEACH.BBEDhADAOADDAEECKGAB.cGGE.XFFChAEAMIEAfBAANAGE.hAFA...,1,-13,-18,5
fOBTRWGSKIeNMPQdJYbZDFXcAagCVUEHL,CFEDEDAFLCEABCGERGAE..GBCEKDAG..eACDMAIFdHGB.JHBGZFCAhAAA.XADFAEIF.hAAAaEFGUAGF.HFAAhABATGGESADE..IAGDhABA......hACA...,2,-25,-20,5
eJBWYHMCPQXDbIKUcNRGOZLadSEfTVgAF,eFFBJAFBBHEAHGAE.CCFG..QDAADDHBKEAG.UACBRABH.ZDCBdECAhAAAEAFE...fAAEhABATFFE.AEHDFHDEhADAMBID.....PHAA.IEEGhABA....hADA...,1,-3,-51,48
aTWcIXGCHRdLVAQfPSeJYNUgbFEMOBDKZ,QCBCSHBGeEFHJFAC..UFFE.FDEBOCHH.KEDEhAAATADGIBAACAHDdCHEhAAAAIHE..fADBhABA.PCBFNAGCEHDEDIGGaBGBXFCDhACA......hAFA...,1,-24,-28,4
QRdAVHDGCZIEYbgeULOfFSJMWaPKTXNcB,DDGBGCCFZDEF.EEAG....bACEUEFALAAFfADB.hACASFHBMEED.hADAPAAFKCCBNIAHBDHAhAEAdHBBAAIFCHHDIFHHeAHDJFCEaAHH.....hAAA......hACA...,2,-24,-10,14
IEFgAbUDNLcSQRTPdZGKeaWVBXHYOJMfC,UAFBDEFHLCCCQEGBRDAD.dGGDKEGBeBAA..aAGFBEBBHGBAhAAAODDHMABECBBCIHDHhAAA...ECGBhABAAHHENIDBSGAG..PDDFWADB.hACA......hAGA...,2,-25,-24,1
dPgTNXAHbJEaKFcOYMDCeGfBWUIQVRLSZ,HFDFEDCDKFFHOBEE.DHGEGBGCBDABUDFHQADBLFBHhAAAdHAFTBAEAHAH.aAGAhAAAFDCEMEIHCACD.fFCEhABAIAEFSFGAgDDB...hACA......hAEA...,2,-28,-13,15
NQSPCRcFEAZVDXLbaHOeBUIGTYdfKWMgJ,DDGBXDACLCDFHFBFBACAGCDGdAGGKEABMBBE...gFFEhAAAQCAD.SGHBhAAARBFEEBADAFHC.ZEEFhABAaAGA.eDFGIEHD...fHBFhACANIDFCCCA...hABA...,2,-30,3,33
PVaHRYCKFODXgLINEfSUbMBJWeAGQTZcd,QCBHZEFHdBFH.aCHHRABECAAF..KFHHDIEALEFH.EFABUFDBhADAMICABGAH.eEHBhAEAAGCFTADF.cCEGhAAAHCDAOHAE..IAHDhABASFAC....hAFA...,1,-12,-30,18
NPRYKIESMcaAFVbZOfGdTeBgLJWHCDQUX,FCFCVGFGZFBF.GEFAdGBHBEHFLAEGHACGDDFBQCAC.hAAAUCCEXBFE.hAAARBAHKDCE...SAHBhABA.MEEFaFEBODHF.hACAfABF.hADA...,1,-17,-23,6
LOPgNJUMHZbBCXTYSKGDIEeacRAdfWVQF,dHBHVAADLDBA.OEAB..NEIEMEADZACBBGFA.TCFChAAASFBE.hABADFECEFCGeCHFaEHDAHHAWADDhAAA...QGEG.gGBBhACA.JBEE.hACA...,2,-32,-19,13
UZIgDbBKPdACfJOHEFYNRQWSTcVLeXGMa,CAFBJEEGHFBD.FDHDRADA..QDCC..WDFDSGHDhAAA..VCCFeGAEhABAXAGHaDAFUGDEZGEChAAADAHBBBBG.KACAACIBOCECNBAA...hABA......hACA...,2,-25,-19,6
KZOcNbSAdgMGYQPUXRLBHJfWFaDCIVTEe,dGFHGBGAQFCDUAACRFCBBBDFHAEFJBHF.FCADaAFD..CDDC..hADA.TFFGEAAHKGAFZEABhAEA.OCDD..hAFAcEEANEIA.ADCBMFIF.....hAHA......hAIA...,2,-18,-18,0
HcTQPCGNIEFXYebOAJUKgMdRWLBaZfVDS,UAADKGFHdDACLDGBZBGF.DECAHDCC.QABEGAEAIDAFhABAEGCBFGAH..XFGBhAAAeHCAAAHB...gBEEhABAMBIDBCDDaGEBfGBB.hAEA......hAFA...,2,-28,-13,15
ESGeaCbgRHcLMVYKPAQBOTfINdDWJUXZF,BFEEODAC..TDGH..IGGAdBEBDAIHUBABXACDhAAAFFCD.GAFA.CAHGRFABhABALDBA.MEAHhAAAKEEAADIHQGFE...WHBGhABAEABHaHDE....hAEA...,2,-28,-28,0
ScJGTAMHYfZPLeVQaRBdUWbXOKICNFgDE,MECGHAADZDCCLCDAeFBFQGDFRFCABBEDUGGG..XGGGhAAAKHAC.IBEEhACACADCFHEGDAGEEAHD.JCHFABAD..hADA.fEGEaBBD.WEAFbBGF...hAAA......hABA...,2,-30,8,38
ZWDOSbXefVKcNLCUgTREPAFBMYdQHJIGa,MAEEQGBCHDGHGDDAaCBH.DBABOAACSFBGeHDCKDEAhAAALBBCCGGB.UGGFhAAATAGCEAHFACIH..BEAGhACAYCCDdDGEICCH.bADB..hAGA......hAIA...,1,-3,-17,14
YFSVcDbBgTaefIZMARQdWPCULEHNXGJOK,dDAFCFDGUAEGEGEHHBFA.GFAHKAAFFDAAVABE..DCBABDHD.hABATEFGeFHBZDEFAEDF.hAAARBGF....QGBGhACA.........hABA......hAEA...,1,-20,-37,17
ABCHPWVDOGfTcIQUEKbSJXeLaNRdgZFMY,HAEFVAAD.OABDGECE..TGFHQBGCKEBH.SEFFhAAAXEECaHCGREAFdEHEFDFEhAAAADAFBHHGCAGGDIDGIADHhABAECDC..........hAHA......hAIA...,2,-20,-10,10
VPbJMFgICHKUXZeBDdAQcOLENWYGTfSRa,QDACOEEGLEBDEGDC...NCDB.GAEG.fABDhAAAaHGA.bAGDFBACIFHGhADACDHBUGDHeADGhAAABHHAAAIF....WAFEYDCBSDDDhABA.....hAEA...,1,-18,-23,5
RPIWSDLBFQHOAdaCZJTVNGKYUEMXgfceb,dEHACHCHZEFCJABD....TCDAGDBGKAEHEDED...MAFBXAAChABA..cGEChAAARCAD..IBHGhACASGAHLGEEQAGGACCFaBGHNEAA..hADA......hAEA...,2,-27,-26,1
KONTWcSGYagMfQUbLXFCVPHAJIDZRBEde,JFCHZFDGEAFG..dCCAeDACOBEG..TEBG..SGFBhAAAaEFGMCBGfBHChAAAQDFBUBAEhABALABECFHG.PFHBIHAGDHACBEDBKEABNEEC.hACA......hADA...,2,-36,-4,32
PTcIJNdOWVFDXbLSfKeGECURZQMABYHga,HDBHaHBG.TBAG..IEAEJDGDdAFGOHAAFCDFDAIFLGFAhAAASABEKACEEFDGCBBGZBGFhABAAIFEBHHG..gEBHhAFANAIE.XGDDfEAGeFEEhAGA......hAHA...,1,-13,-23,10
USedOHYIcaNXVQgFfWbRKTMCGBEDAPLJZ,LEEGZAEGSCCBOBDAHEDC..IDCFaAAC.VEADhAAAgEGH.fGCAhABARBAAKGGGCCHGBDFEhABADFACACGD.JHDEdHAD.NADF.FCAH.....hACA......hAIA...,2,-23,-10,13
EbGgaSUTVOdMBcZXIWefHRNYDAFCKPQJL,FEHBKEGDQCAFEGEB.GEDCSEFBUGAG.VDCHdDDBMBBAhAAAZACE..XGBHhAAAeAHBRAFBDFIHAEAECAHBPBFChABA...........hABA......hACA...,2,-20,-17,3
UaROGbYEQBCAHNKFDXJfIVZPMLSeTcgWd,HDAGKAFBDBCAXFDA..JFAE..fAFCZEEFMABGLHBEhAAASABC.cCGGhAAAdAHEUEGDODHDhAEA.YFAHBCEAADCH.IGGG.eCCEhAFA.....hAFA...,1,2,-42,44
QEHSUXNdKJDMgcLFBIRYTCAGZPaWbfOVe,GEDHZDAGaABE...fGBGeFBAHFGBUAACdCFGKGDADFIDMCEChADALAGBBDBG.RGEACDDGAABG.hAAA....PAEAhAIAOBDF..EDGENIAF.......hAEA......hAFA...,1,-16,-19,3
PEDXCceUbOVJWLAfFSKMRdYNIQBGagZHT,FAFBMIAGRCFH.dAGC....IAACQFDGBBDDaECBHEBBTGGChAAADIBG..CEAAeFHHhACAUACHODCA..hABAWDACABFHKHEA.NDAA........hADA......hAEA...,2,-40,-14,26
XJeMZCcGWVYQPOKRdAFNTIBSfaUbLDgHE,TGBCSEGD.UFDALBEEHCAEEBGEJDEEZCAAGABD..hAAAVFFEQFAFhABA.KGHBAIHEIBCFhAAABCEDaHAEDIDGgEAFMAEAcDGAPFCA.hACA......hAIA...,2,-15,-2,13
PEYJbadMOUWSNAHVTRZCfgLDXFcIBQGeK,VBCDRABHCCHC..LFABFGGHBEECGDCH.KHGEEGAF..JGDEdGEEhAAA.MBFAUADASCBDhABAAGCE.TGCEhACAfAGH.DDIHXCGB..hADA......hAEA...,1,-31,-32,1
YNaZCdgLbHFMXPfKUQIBVcDGREAOSWTJe,SDCDTDAC.eBCCaEEDZCDB.CGBH.dBAALDGBHGEGMFABhAAA.fEGDhABAKAHBQACFBCGFcDDFhACADFAHEBAF.ADHGOGBA.YAECNIDB.hAAA......hABA...,1,-1,-25,24
FWSREcLDBIAJQTdZVfMgOHKGYNaCPUXeb,JDCHQFCAZGFA.MIFAHACAGCAE.aFHHCAHCUGCH.eEADhAAAFCDHSAHHhAAARBFD.EABCDIFABGFChABAABAH.TADFfCAF...gEFGhABAOFAHYCFBhAFANBIE..,2,-30,2,32
dCGaEeWQIHbXARNMgJFYBUTcVLDOZPSKf,RFACMCCAFCAHBEHBUDBA......TAABLCCEDAGGZEEFSHCChAAAdHCFGCGCEFFH.hABAeFABQAFEhACA.IEEG.......hAAA......hACA...,2,-32,-28,4
EWbAIPZUfMDCGHLXFadJeORKSTcgYBNQV,ZAADMFFFCHFHGEAGLCAH.FDDAdCCC.eEEEKEHH..SGCChAAA..gFDGhAAABGAAVABAEAEGAHHFIHDBhABAfAHCXAGBOCHF...cCFAhAEA....hAFA...,1,-17,-32,15
FKebPTMfWVOZNLUGSYXdRQgCIcBHDaAEJ,EEEDJEGH.FAHDKAFE..eCBA..TBBAMIFE....fFBAhAAAVFBHOBFBZGEGLADAhABASEDBXDGEhACAdBDE.........hAAA......hABA...,1,-17,-42,25
gSbdHcUWTVQLJMKeEBaFGDANXYCRPOIZf,XCBCRDBHOAEHZEEB..SGEEHBGFUABDVDEALAFChAAAKFAEeACEEGBDBGGH.hAAA.FGCFDGIFNCIGCAGGIFDAhACA..........hBAA......hBGA...,2,-25,-16,9
MCGaPdDWZASLJQXHgFYIKVEbOUfBTcNeR,LFFBJDCHHEFEFADDKDAFEBBA..UAAEBGDB...TCDDhAAANAIG.MABAGGDBaBGHDFCEhAFAZAFHAHBH..SAHHhAGA.........hADA......hAHA...,1,-28,-32,4
GWFfSOHQEXIMRBaKJUdNcDYTZbPLAeVCg,eFCACFDDGGEFFBFH..ODABEEAF..MDIBaBBA.KDCE..JGFAdACFhAAADDIDZCEF.LBAAhABAAECG.VGAEfHBBhAAA..........hABA.SBDHhACA.XDFA.,2,-33,-15,18
bIZWTaPecVfHDMgJAYNdSBFKOQLCEURGX,dHBHSEHBKGFALCBECDDB.RBGB.GEBE.XAFEIFAChAAATACBeFDCVDBEhABAHEFHDCAD.MBBHABBABAHBhACAOFEBEADA.........hADA......hAGA...,2,-21,-12,9
NbTgZVXMLFIEDSKHOACGRBWQcadfUPJeY,CBGFGCCFRAAC.BGADQDCAdFCEUADD..JEGHeFEH...hAAA.bCFETAAF.hABAZEFFMIBAIBGGhAAADDABKGAAAHIBaEAG..fFBDNAIE..hADA......hAEA...,2,-37,-13,24
VHcADQPFKEeZMYRfSgdUGObCWNTXLJaIB,DAFBFGFCeFCFZAAFRECG...SCFHUGFGGBGGOADG.CBBC..hACA.TGADJBHDBDCEhAAAHACFAIGE.KEAC.MEIBhAEAfCAEdGCA.NCEE.aAGG.....hABA......hACA...,1,-6,-40,34
BAdSRLgcMWbeOQGfYEJCNTZUaFXDIKPHV,dEHASDBDRECCLBFCMDHF..eHCCQGBAGBABEEABCGFEZACBhAAAFHAGDGEH..PHFEhAAABBADAIHA...WAFDhABA...fECBNCGEaDDAIADAhABAKAHB......hACA...,1,-10,-28,18
AUQFbeHaWgNMfOTVRXJBcICPZGYKDESLd,UFCAFGFCHDDB.aBAH..NDAC...OCHFVDEA.RDBHBGAE.hAAACHBA.PBEEGBBFDAIFhABALAFCADDG.eEHDhAAA..MACE.fHFF.hABAJCBB.cEGD.hACA...,2,-32,-13,19
YVKARLENQTcbZFgGIfSaHJdMPDWXCeBUO,RDEDEDCDQAFA..TFBHZFCDFGHDIADC.SBFDhAAAaHEGHACDdBAGMFIDhABAPFABXGEGBECChAAAOFEAKEGCAEAA.LAHF.bCAB.fGAEhACADBIF.CHGH.hAFA...,1,-7,-19,12
JQKLYEUSHWIRCTMcdFebBAPagVDZOXfNG,aHBGDHCEOBDB..XAEDGBACQDGDKGGFEBCC.UAGAhAAASFDEHFEA.hABARDGFMEACcFADdAHEeHFAhACAAGBCgAAH.fGDBhAAA.NDAF.....hADA...,2,-22,-6,16
SFMabVOKNPGCfTRAUJXHdYQEDgZcBIeWL,UDCHXAEGHGBEdEEEQBAC.DAGGZDGBBACFIHBHhAAALFAFFBBHMBAH.hAAAaAGDOBGBKDCB.PFHHhABACGAF.TFEAAHHBEFCB.eBEB...hABA......hACA...,1,-4,-27,23
SVJbPXaeNFLYRgWdKQGIUHOfZCBDAMcTE,TFDBEEHB..VBFEJBHF....XGFEaECFFBBBLADDhAAA.REEFdFBGKCAAGEAEhAAA.IDEChABA.OACGCHHHAIEAMCAHSCCB.hABAPAFD...hACA...,1,-20,-24,4
edBAIUEGPKHgbFfCcDZTSXaYRMVLNWOJQ,EGFCKGAHHEGFFDAG.CCCBZEED..SHAA.aAHDMBDEVACGhAAALFCF.WAAChAEAJFDDdDFG.ABBFIDDFhABAUAGA.gFAFfCBEDIGE.hAFA......hBBA...,1,-17,-33,16
dGfAPHUceQBDVKgEabNTWRFSOXJZMYILC,UFDHeDACDBIBKCHD...EDGGaBFD..TADAFCCF..OACChAAAJFAFZGFE..MIFELFEEhAAACEHA.dFCAAEFCHCABhABAcCEBQGAA.BGGG..hACA......hAEA...,2,-27,-19,8
WVOLXFeNaAYdRDCIGKUPEfQZJSTcBMHgb,dCFCDAAFCADAKHBG.UDAB..EEFBZEEA..SDDDBACDHECB.hABA...gAGGhACAbAGB.OHDAhADALHECXFAFFBAFaCCA.AFBH.IDGEhAFA.fBBGhAHA.JBEBMFIF,1,-18,-40,22
dZVJFATBbGQRKCYNefMEgLOHaPDSIcXWU,BHHGQAGHKGDB.CBBA.eDFF..EGEAODBCaAFB.DBGEIEBGhAAA..XACGhAAAdEDDJDHFAHGAGBDFhABANIDB.MCIHLADDPFAFSCAGhABA..WDGH..hADA...,2,-40,-15,25
BCGFdAcVIPXYUbeRaWOZKHTgSMfJQNDEL,VAADXCBC.UFAFeHBA.REAG..OCEAHDEATGFD.hAAAMICAfHFBhACAQABADADEBFEH.hAAAFCDHcBFFPEFAaEGEKAGEgECBhABA......hAEA...,2,-15,-13,2
AfceRdQCJDZIPLbgHKSaVUWYOFEBXGTMN,eGEAQCCBDHBAZDACLHDEHAAC.SAAFVAFC.UEEEhACAOEEEBFAGGCDFhAAANEIEAEBA.fFAChABAdBDFIHAF...bDGF.aGCB...YAEChADA...hADA...,2,-16,-5,11
NLBXQJbIWTRVdgfOCYcAGSPeHFDZMaUKE,SGAHeFBBDCCDZFFBUGED..KDGCLABBBFHH.QDEDhAAAJBEH.IAFGhADATAAC.RBFCdEAD.ODHDhAEA.CDDCADHDHAFE.aGEB.EDAF.NADE.hAAA......hACA...,1,-8,-33,25
YAaDeCbgQKEULcTSGWJFVfRNdBPHIOMXZ,eEACCFDG.QCGHEBGALBCA.SHEGGABBFGACREEGBEAGhAAAHFDFOBAHZCAAaHAG.hABAbFFB.KCDG..cFGDhACA..........hADA......hAEA...,1,-6,-28,22
JgTGeCWVNHALEXdBKbSDOYMIRQFaPUcZf,EAADXGAFKBHH.DEIDOHBA..ICHAQFFF.aBDBhABAUBDHZAEF.JAAETECDhACACEBG..VGFGAIGABHEAhADASEDBMEEEFCBDfAFB.hAGA......hAHA...,1,-16,-33,17
XYcVfLMJdPWNAQSZeTgCGFRDKOIEHBUba,ZBCFeDACCCHEGDFGDFCGKGAA...OAAFEACBBHFBUFCF..XAGGhAAA..cAEGhAAALGEE.MECEhABA.JDHFWHDGAFAHSBFDgEAF..hACA......hADA...,2,-37,-27,10
WCbTIgaJGEQRUeDNKPfHLcBSAMZYFXVOd,MECGZDAGFBGF..XDAFdBBECHFG...TABGaGAE..EDGBUAEBhAAA.eCHFDGGGKADAhAAAHGDGBHHHAHBEOFAEhABA..IFDE......hABA......hACA...,1,-15,-48,33
WbLOVfFdYIgNaDMRXGKAeHEJSQUcPZTBC,eDCHHDEDEDBDQFEEUFBBZABCCBGC.LFHBODAD..FACBdAFC.hAAAICCFaDGCDAEHXGGBhABAAAHGSGFAPHAEhAFABCHG..........hAAA......hACA...,1,-16,-19,3
JVeYPHFIcdTfWUgMbXCDAZRSGBLKQaNOE,RDDFSGACLHDCKGBCQGDD.OADEJBBCeAFCHCFDFCADhAAAdDCC.TBAD.hABAfFGH.hACAWBHH..........hAAA.MABECGGBAIHABBHDhADAEGHF.YFAFIHBA,2,-37,4,41
bTGXcfKWSLaQOHPCBEedgYDNUMJZVRFIA,TFGHXAGH.KGGBSCAB.LDCEOBEDCGACBAHFhAAAEBBGdDAHDGAEMABGZDFB.hAAAVECERECF.AIEA...hAFA.GAFCfHEDWBBE.....hBAA......hBFA...,1,-19,-27,8
UQdeBIKFfHNMOPcbZWaRgALDGJVESXTYC,LDCHDCIHGCADJFFDEEEH....XGAGCEBDUGBG..QAEFhAAABAFBFCEG.HFGFhABANEED.MFAH..PBAEhAAAcABB.ZDFB.......hABA.aEAEAHEA.SGDHhACA.,2,-43,-4,39
QYMVIBZNGcOdHUfLEbWFSeDCAJPXRgTaK,JDACREFH..aAFHQCGE..MBBEBGEFGDCCdFBDUAEEhAAAfCAEEBCA.FHGEhAAADABBAAHB.XEEAhACAKCHHIGBE.NEAE.OFHF.LHAEhADASGDHCDDB...hAHA...,2,-21,-21,0
AgedIORVWGHSEYcXMUDfKaQBNTZPCbLJF,dDCDOFBBRAEAGEFGHDFEEEDE..XFAGDBBDaADC.QAABhABABHDFZAGFCABBLFEFhADA.AHIFeEAGIGHEhAAAWCHDSCCCMAIFfHAFNEAA..hAEA......hAFA...,1,-5,-19,14
GOZWVXcQBfJTMeHYIgSCPKRdNFUaDbEAL,OHDAZGFG..XADEBHAHJAAC..MDECeBGH.HAEBIBHBhAAASGGBKGBDRBADdGCEhABAUEBEDGABAICALEEAhADAGEED..........hAEA......hAGA...,2,-27,-22,5
GZMIeNdTFCDLJSYKXHaVfEgQWcPBUbOAR,GCBDZFACMEBCeGEAdEHG.FFCFDAEDLCAD.SGAFhAAAXFDFaCAGEBHH..QEEBhABA.WBEChACABCFE.bGFC.ABAANIABCBBB.JAHF.....hADA......hAEA...,1,-12,-28,16
KSHRFOLAUeVPQBaXECcMYWJZIDNgbGfdT,eADGQFDHBFGBEAABCHAH..MAAC..JGDGZBBCDCCE..NEEBGADFhAEATGAEKDDFSAHHhAGAHCEGFDBHAIDAUGGChAHA...........hABA......hACA...,2,-34,-15,19
RHDNgdcLQSPAKOaWZfVeFBTEGMIUbJYCX,KEEDaDCDZAEAeDAE.FHEABGDG.GFEBMCGBUFAD..bCECCBEFHAAEhAAADBIF..dCBALBHBhACAQGABACCEfGGBhADAEAAE..IHHA..hACA......hADA...,1,-19,-24,5
efXbUaPOHNCMTSJLIFAdKcWDRgZVQEBYG,dAFBKHBGDBBARBCGZEEB..EBFHGDAB.eAAHXCCE.UEGDhAAAaBHDHEGB.CFDCMIAEhAAATFAG.LEAChABAABGF...WFFD......hACA......hADA...,1,-15,-40,25
TBWfgQEVHUKFRaDGLXNYISdPJZceOAbCM,CBFDBFEC....fECGgACGQAACEGEC.UFGAhACAFGHDDCHFLAGHhADAXCEAICCBdFBEJAAFhABA.ZAFEcFDEAIFAMDDFVFAFKFAD.aBEHNADF..hAEA......hAFA...,2,-20,-14,6
CaFQJPENfMKAXbYcRGIOgdLUSDTeHBVWZ,XCBC..YBDGGEEEIADEdEECLFAC.DDEAhAAAeFADBCHDZBFHCCAFQGGGhABAJECFEGHDMCCAAAEBRGAEhACAgAACUBBE.SHCA.hADA......hAFA...,1,-3,-22,19
IXcBKdGbUOagAMSPeHQLCYDfJZTRWENVF,MHFGeCCHLHBEDGDGZDAC.RFGB..EBGCFEFC..XFEBKABAGBDEhAAAOADAACCCHAGHQBAHhAAACFAB.fDGBhABA.........hABA......hADA...,2,-37,-8,29
UeCLGVEZJPSYWBRdANMQaOKgFXDTHcfbI,QFDBaEED.KACBFDHHDFIDHDAG.fBAEUCGACAFGLHAGhAAAEHBGZGFE..SDDHhAAABEADAECAMABFOCCGhABA.XAFATCDCIHFEeFAG.hACA......hADA...,2,-30,-10,20
JAHSbGZXIUgfYVQOMPRTCNcKBWadDeLEF,HDAGGEAHXBABUGGG....fHEFQFDAOCAAhAAAMIAEPAFERAGH.hABANEEHBHHAaEEFDGBDEGGFAGDESBEBhACAIADF.......hAAA......hABA...,1,-18,-21,3
GFMNeHXZcVYdJbIfAEWDBKOTCaRULSQPg,EHFGDAEDOFAG..CABHUFAGLHDEQCEEGAAEMDGFhAAAeBABZFFC..cGBGhACAdADCIHDH.hADAAIBGBCGHaAGDPCEDNAIA......hAFA......hAGA...,1,-22,-27,5
dJBZXIUFHaLYGNfgcDQSMRWPTKeVAbECO,CFEDdGDBZCGBUBAAHCBCLCEAGAEB......gGGGhAAADFFASAEAREAC.TEADhAAAKABCAGDDEHAEBHHG.hAEAFHAC...........hAFA......hAHA...,1,-16,-41,25
gDUXcdVKaARHOPEZQJIMBCSNLGTYfWbeF,RDBGHFDFOFEEZCBEQAAB.MGFEBHFB.NBIELCADhAAAGAFGTFAG..hABA......hADA.fEEBWAGDeCCEDAIB.cADBhAHAdHCHaBDAAHHD.....hBFA...,2,-33,-11,22
ZLODaFBKfWQETbMSIJGANcUXYCdgeHPVR,UCBCCHHGdFDGHCADRBFHLGACDEEE.BHHGKCEC...QADEhAAAEBBGMFAH...SFGFhABAIGFD.AIBGNEFAXBGBhAAA...YFBBPCHFOEDFhACAaAEG..fEGHhABA.,1,-17,-38,21
HSAdZRYgBfGNCUOIJFQKWVaMEeXTPLcbD,ZBCFRAADBFEHGDGCUDAFJAEC..FDHFKCFE....aECDMAIH.hAAAEBAHeDDG..TDAHhAAALHBADEFBAGIBdHFDhACA.fFAA..NHAFCFDFQACAhAFA....hAGA...,2,-26,-25,1
gVEYGKTNDeUbPdLZHWQBFRAcIaMJOCXfS,aHBGOAFE..CFGA.XGGD..gECDEEGAKCEEDBDFUAEFhAAAdGAFHAAFBHHGAIFAMHDAhAAASEEG.hACAVABF...YAHFTEDD...hADA.NIAFPEAALDAFhABA...,2,-34,-9,25
ZXgdcIEDKFHYOQUfWBNCeSLAMaPRJTVbG,MHFGaCFC.RCCC...VACCGAABZEFDdCABEAFADFCDHFAE..OBHBhAAA.UEEFWCHHBEAAhABACHCB..eDDBSGCHhADAAABH..JAFA......hAAA......hACA...,2,-23,-20,3
VTXKcYOHQALbIPBdRJUSMfZNGCWaFEgeD,LGEA..bFEEICHBdCFERCAFUCCCSEBHZAFA.GAEHhAAAaFDG.ECBCDIEATDFDhABAKACC.ODABhACAABADJHAA.NEIA...CDHH.FDDF.eHAE...hAAA......hABA...,1,5,-28,33
cWZDSBKeHYOMRUfECALPXQFVGgNIabTdJ,LDACXCGCFFDBVAAG..GBBE..IGAB.hAAAaBFGTADAdFEFJHFAWFFFhABADGCD.BFADHCECMEIBhACAfEAFEHAEAEEG.PEHD...hADA......hAFA...,1,-11,-27,16
EFCVYbBdSRJIgLXeNUHPAKaTZWcGMOQfD,aFAAZEFHGBGC.MAEDQEDC.fBAEDFBHFFCECBCG.hAAAVGFGBAFE.dCAEJCCAhAAA.IDHC.hABAgAGGeHAA.NBBF..PHAEAIGC.hACA......hADA...,1,-7,-34,27
eTfbBWKRFNGHcDgPCXVLMYJQUdAaEIZOS,aAFBECFCZBBC..ODBHSEAE.eHAETFEEBABBKDFAFEHHhAAAHGBEDBIH.CBACXAGEhAAALADCMHDG.hABAJFCEQCCHAIHA.IHGB.hAHA......hAIA...,1,-18,-23,5
CJAcRUFLdSHOfgQZPNWeBaVGEbYXTMIDK,UFDHFEEDdCBDOCAB..QGBHZCEG..NABF.BGAC.hAAAaBFEEEBD..XGGGhAAAMCDEDBIBKABCAEHDLBCDhAGASEAA.fAEDgGGEeDFEhAGA.....hAHA...,2,-32,-27,5
eWdXIgMaJSbFLAZUKNYDOHBGREPTVfCQc,KDAFDACBBDDFEEHB....TAAFCGCDeGFAdHCF....IBEGhAAAMCFASGFGhAAALAFBAEGFNGAB.HBABRCCCfDFFhACA.WBDCaHCE.....hABA......hADA...,1,-16,-45,29
PeWGAOVgJMDHTFKZSBYdbXREacNfLQUIC,OFBBVFDF..MAFCTDBF..FHBCKCCEBCDDdAFAREDG.EDGDaABHhAAA....NDIELAAChAEAQDFHIGGDhAHACGGFeBDEACAF.gEAGDAIHSHDEhBBA......hBCA...,1,-20,-27,7
MCNLaedAEWIfXgObZHTGDURYcPJQSKVFB,EHBG..fEGDODBCZACEHGCCDDHBUAGCRBFA..PACDhAAASAACVEBCBFFAhABAMCFDLGDA.hACA.eAEFADAF.IHHG.gGADhAEA....hAGA...,2,-31,-10,21
ZCLWVdNePfMJgFcGQaBUOAXHDYbTKSEIR,XFCADHCE..bCCHKBGE...IBEARBFFLABB.dGGBhAAAeHAAMICAFDADGEAEhADABFGGAIFAHADDTDCBhAAASEGACBAD.WAHHNADF.....hABA......hACA...,2,-36,-5,31
dHKUOEWRYbJQFPGZcDXeISfVCNBaAgLMT,MDEBHBCFODHHRDFE.JAFDFDCH.ZBFEDABGeACD..SHAAhAAACAAEBADF.aAHDAIAGLGAEhAFAKGEAEFAH...hAEAbFFAQECB......hAFA......hAHA...,2,-28,-24,4
MJUPOQKXbTVZfENReWFLScdHAGYgCDIBa,GAFECFDGBEBA.JDAHUACG..QECFKGAA...bBCBTGGGhAAAZFFE..fAAEhABAEDHFRCDA.FCHDSAFChABA.dEFAAHBFDFFEIHDFMACE.hAHAXAGE..hBAA...,1,-9,-41,32
AWBJKRIdGUNQEeTLHaMbCXZDfOSFPcgVY,BAFBJDCH.KEDFdBGAUCGB..QFAG.EABEeBCAHFFFhAAAbFFECBBGZADF.DFIHOEAFhAAAFEEF...gABChABAAEHH.IHCDNAIEaHAE...hAFA......hAGA...,2,-37,-18,19
JFdMEWVAQebXIGcBLaDfSgYPZCTRNUOHK,QDACeDAC..IHCABAHBLFGHDDGA.SFCAhAAAgFEFZAEHCAGERAAENEDDOFFHhABAKFBA.FBBCECEAhAAAAGBH.XADBaHCEfAGETGGE...hACA......hAIA...,1,-11,-28,17
TaSFNRKXHPELJQMYZGUOIfcbdBCDVgAWe,eDACaFHB.FFAEKAGDHAFCLHAE.MDECGEFC.IAAChACA..bACACEEFDADChAGAgDADTGDENCIAXCCFhAAA.EGFFYCCC...hABA......hACA...,1,-9,-30,21
RaFMYECgGbANfJPQTVeOIBKXdLHcUDWZS,JGEAQCGC.eAACIGCGBFDCdHGFHBCEDEDCZDFA.aEBEMIAAhAAA.CGDA.GAEFhAAAAEBG.PFABVADFKCBAhAFAXCADLFFEWEEGSGAC.hABA......hACA...,2,-21,-13,8
ROBFTMJAcHKDfeLZUaWYNdVbCEgGPISXQ,HDAGKHFGeBAHZFFHaBDB....NEECdACACBBEEBFAGEBG..IHDBhAAAXBFEOAHDhABAFDFDMAFEAGEGDHAG.LFAAhACA.WEFE......hADA......hAEA...,1,-22,-28,6
CJLPHacBKNQVMIFbUTAgRdXWOSefYZEGD,RDAGXGBCOAHB...SCGAeFAHZDFCEBBCCAFALFDA.hAAAHAACBCDCQDAHhAAAIHHGFFCETDEHhABAdFFA.fGHGDADGaAFD.KCDDNICF.MIEEAABC.hAIA......hBAA...,2,-18,4,22
UVAZJWfEgbDSGaFIQOcYMePBKdLNCXRHT,ZFDFJGEA.EEBBDAGCGACF.FGFFOCDD..MAACeFAHKDGFLCFDhAAACHAFHCCATBGChAFAVCGB..AIFG...hABA.fACB.SCBChAEAaAGA......hAFA...,1,-11,-38,27
OCXPUbMeDHJBWIdFTVcgNfLAKGYRSQEaZ,GEAHRDAGQEGCaHFAZCCA..CFCA.UBGDeAAHHDGFBHHEdABBFAFC.hAAA....TEEDhAAAcAEB..NHCBAAHCSHBAhAEA..XCDB.MIEAhACADGIB.....hAHA...,1,-18,-20,2
JAgcKGOITSWDCbYFeXNMZPLQdVBURfaHE,KHBGOFEF..IFFHTBGD..SCAECBCE.FGAFNAEHZCEEhAAAQDCH.hABAdAADBBEGRDFEaGHHJFHHAEAB.hABA..GDAAbADFXFCDMFEB...hACA......hADA...,2,-40,1,41
JUTaKQYADcPCHIXSLWGFBEZfbRdVgeMON,DACBCFDGHAFA..IBDDSDEF.LBBEFGFABEADfEABhAAARFBAdDHA.VFFHhABAeDEE.MABDOCHFhACAJHCE.aHCAKAGFADCHXFACEEEE....hADA......hAEA...,2,-32,-13,19
cYTJFXGCZNESOdaeDWRQAKfPgHIUMLBbV,KHBG..fGDDHBFAMDDBLDFGBCAG.bEAHVAAE..hAAATACGXFABCFCCEGHBhAAAdEGBDAFCRFFCAAEC.IEEEhADAcCCDFCAE.NIAFaFGG.....hAGA......hAHA...,2,-21,0,21
TSFMDGYUHdbaPCgWVJIREQXNeAKcfLOBZ,KHBGLGEAZEEEFCEFGAED.HFAEaAFA.PEFG..CEAA.VABBhAAAJDBA..RABC.EHCE.hAAAXDDHAHGE.fCEBhABABGEA........hADA.MIFADGBC...hABA...,2,-51,9,60
APJGZaSCfYQDTKNUHWcLVIFdOBXMbEReg,GECFZFEESBCFCHGE..QACGDEFEKAHBHECHLGAEhAAAFFAHdAEFBHED.XBEHhABAMDDG.EHAAeBADhAAAAGIBPCBBfCHENAEB......hABA......hACA...,1,-13,-24,11
gBbYTQHIaGSUdZMLRPCAcXKeFVWEfONJD,KGFCeDCHFDDFEABE..OBGDDICEBGBG...TFEDHABCaFAEhAAASCEGdAFGMCIFRDGHCDAGhAAAACAB....XGBAhABAWBFE..fGHA...hACA......hAEA...,2,-34,-27,7
CecVQEFBGTNSHKdAPZORLIWbfaUXDMgJY,ZFDFLFFC..IDBAfGBCUGBEMFBA..JCFGCHHDVBBEhAAAFACDBHGG..hAAANAIAHCEGABFGRFFE.WAEChABAaAGA...DDAD.eHCC..cDDAhABA......hACA...,2,-39,-5,34
MWPLHeOVBRcDJNECKUSabdfAgZQXYIFTG,QFDHXCBCFGCDGDFA.MBDHLGFGOADGBECGDFIFEAAEhACAKBHBSDEFhAAA.aGAFfAHChAHAZBFBTEGGWFCDPABE.....hBAA......hBFA...,2,-24,-17,7
fLWBNZQOcdGPKgFMJCTHAXEeSRYaIUbDV,XGGDEEEDRDAF..aGHBUCBB.DEEGVAAELHAA.BGBEhAAAZCGHQFCHhAAAdFDBKCEAMACA...CAGBAIEESHAGhADA.bAEGNBBFOEHFcGED..hABA......hAIA...,2,-29,-10,19
dFXHLgKIeQJSWNbMOUVBcEDAZPTYCfaGR,TFDHCFDGGGEF.dBGBHACCLHAAKBAGeDDC.QGFHhAAAJBBC.SFCDhABAbCFGODAFBGAC.DDIFAFGGPADAhAAAYBHD.fDAHFDDF..hACA......hADA...,1,-15,-16,1
VYfEdMAJQePIULOaNBGDFbTCgRZXcKSWH,JFCAQDAC.eDFDIFHBUGCAOCBABGABGAEH.hAAADCHBTBGG.CGEH.hABAZBCFKGBDHCAB.YFFBhAAAdACBAHHHaGHF........hAFA......hAGA...,2,-31,-18,13
CZGIXBEKFNcMHYSDQRWPOgVdUbfLaeTAJ,JFCACBGFGFDFBAGA.FDHF..MCADHDCC.DFAEQAABRACB.hAAAOCCCdBAC.UFFGhABAfGADLDHBaAHDhABAABIBZGAA.EBEE...NECB.YAEEhACA.SHFAhCBA...,1,-16,-23,7
SPWGUZJELQDXcHRYCNMeOVdATBKgbafIF,TGAFKEGD..aDBDFAGD..SCAFGADEUDFEZAFAJGACEBAGDFIBhAAAHDDB..CHEAeDDDhABAOABCAGGBBACC.hAAA.fHDFIDBA......hABA......hADA...,1,-18,-34,16
YVUTWJaQSBCXINOgFLZcHDPGbeERfMdAK,KCFCUFDH..TFDCaCCHBAAB..IDAGOBFG.LBAAhAAAZADHDFAF.GDDF.hACAEFACMIACAIBEVGFE.hAFAJAFESGHF.NEEH.....hAGA......hAHA...,1,-12,-43,31
NTObECaFHQfMUVKPAIeLcgDdGWRZBYSJX,eEEGLGEADEBCdFCCGEBDZBFG.SBCB.JAFBNBACOGEGhAAAECAC..FHBGHBBEhABA.MIAEKAHBIAAAhACA..WHEABAEF.XCGDhADACGAGfDGF...hAHA...,1,-23,-24,1
gJBZfAKOTXFEeRaPDNdGCbVIMUHWcQSLY,KGDDODCHFEGF.RAFC.DDABGBBH..CFEA.VGFEUBFB..HEDBhAAA.QGAGhABALBBCJCCFBDHC.fCAEhACAABIF.EDEEaAAG.dGBA.MFID.hADA......hAEA...,2,-45,-7,38
POeVGXRgQHBYFSZDdIMNcKUAETbJLCafW,TGBCJEEGLAFA..CGEA..aDFD..PABCVAFARACBQGGBhAAABGGH.FCDFDIEGhAAAMHCCKFCEEEAA..hABAfEAE.OCFG.eCCDhABAgCACSHAGhAEA...,1,-25,-26,1
LAHbgVdUZYMGTJScIPRQOBKaWFEeCNXfD,HAADVAAD.ZACFGECESEBA..IHGCQGCAKEECaBFDhAAAEFGACHAE..fCHChACAAFAFdCGEMBEATGABhADA...cDBBOFEDFFGCNAIEDAEEgADHhAGA...hAAA...,2,-15,-4,11
PITGRfUgWaLbXCYdSQBVcFeZDMNOJKEHA,TCBCGEDHRBAH.UAGBaEFG.LECD..CHDASADHhAAABHGEFAED.DHACMABCJAFFEABFhABAAHEE...fEDGhADAWDDE.........hAAA......hAHA...,1,-32,-34,2
LBVdIJFYNUZcCDAeQMESPObXWGfHRagKT,QAFHSHBGOEFH..XADFGDBGHDGDaDFFKFGHhAAATAADLDBDdAEFJCCAhAAANEIEZBAGDAIBAIBAMDEHhABAECAB.....WHDCfGHC.hACA.BCHAIGDHhACA...,1,-10,-15,5
gfWHNOJEMQbZIYXTKdeAPGacBUFDLCVSR,aGAHUGGGLGDCCFEE.RCDE.....gAAFfCBGHAGBhAAAJAFA.EGDE.MEEEhADAbCGBZAAE..IEBHhAEAYEBFKGADACCA.cAEEDEIHSHGAhAAA.NFCF.OCBEhAFA...,1,-3,-29,26
aZJNFDPKGScBUMOVTHgfbCXLeEYIWQRAd,dEHAaDBDZFGDJAFE...DBIDGADEBABE.OHFEHGBC....bADEhAAACGFCeCCD.EFDF.hADA.IEDA.hAAA.WCBDQGECAABCFCGG.KBBDSFAGhADAMDDC....hAFA...,2,-30,-19,11
ZAeDBMIGNCXSacUJdOETLRFfQgPVKWHbY,BGHDGBGACEDC.SEAAUBAG.dBCHECCERBEHQGAG.hAAAVFFFKFEDHGAE.hAAAbCFHADBA...MIFAhABANAEFaABAOAEE........hACA......hADA...,2,-35,-8,27
EdSDKRfWcCBAONaYGLFVHgZbXJePITUQM,aDCDLFEFHAACZDAFXBAB..eHBATAEGUAGG.EDGFSCDGhAAADAFDKFEA.fDHEhABACHHHACED.NCACFHBAhACA...VDBF......hADA......hAEA...,2,-27,-18,9
cVXWPYTRefCMHLIKQbNgDZEaFSOJUdBGA,XFDH..YAABRBAE.CFAELCGBQDGB.NEAEZEBBhAAAFDDDSAEFhAAA.UGGEBBFDAFCDVGDEhACAWADCTFFHeHAEfCCCIHHGKDDChABADBIBaAGG...hACA...,2,-26,-7,19
dUaVbgJcGQITfDXeZNAMKEYWOFBLSRPCH,EHBGOGEABBCCLAECREEE.CDFH.dAHGUCADaFCF....VBDBhAAAbBFA....JAAEQGEChABA.IFAHhACADHDGXDDB......hAAA......hAIA.ZFBBAHHF,2,-34,-29,5
KfHCPQMgdOAcLFNXGITZJeSDbVaBEUYRW,FDCDXFGHGADGZDEHeFFC..DCFAaGHDBCDC.EGDGRBGDKGBECAHG.hAAAQAACdCAH.hABAAEFB.NEAF...IAFChACASFBC.UGABfDAE.hACAMIAC....hADA...,1,-24,-26,2
CQMgaPcGJbIedHfLEVTXZBRDYAKUOFWSN,KGDDUGGDFDCF..SBEDCEFF.MBCFaFHFGEAG..hAAAIHCGHBDGLADEhABAECAH.XGFAhACABAGFDDGCOAHFWBFAgEEA.hAHAcAAG.bEAE.hBAA...,1,-22,-32,10
VDIMeBUGYgRAHKNEWdCfbSaOFPJZcQXLT,HDAGKAFBEBCCdHDD.CBDD...SAAEaDFFFBFCZDDFQEFGhADA.XCECTFAFDACChAAAMFCFeCHFBHAH.hABAYEADgGGCAGHGNHDH.fBBChAFA......hAGA...,1,-17,-19,2
TUCaMAWHcYfJbXBQLENdSVOgKRGZFDIeP,HAAD..fHBHbDCHBHAH.QCCFEAHB.NGEDSAEBhAAAgADBGGEFhAAADDIHeBGBPEECTEBDhABACFADMDIDAGAAWHFC........hACA.JEECXCFAhACA...,2,-12,-3,9
SIfdTHGUNVKEOJcaZBFDXLeCgPbWRYMQA,SHBGdHBHHBACUGGGKACG.OCHB..aCDDBBGCFDGFDFCCLFEHhAAAeFFD.CDEF...hABAgAGGPDABRFBA.hACAMBAFABDG...fGGD..hAAA......hABA...,2,-41,-16,25
BIXCOaDEQTcFNWZfGVAMULdJPSHgbRKYe,MIFGUGGDLAFEdAGC..JEGDHBFFRACG.eAAEBCCFCECBDFFGEAAH.hAAAQCDA.hACAFDAFNDFGZEAC..fBHEhADAAIAA..PHBA.SEDBhAEA...hAEA...,2,-28,-24,4
ETRgcQKaVCZOJFNIUDMPHLAWSYfXBdGeb,SHBGXCBCBGDHGBFC..eCFBTECCRFAH..QABFhAAAaFHBCAEAZDAFJCBAIFHBhACADAACHFEBACIFfAGFhAEAdAHE.bFED.EECB.....hADA......hAEA...,2,-12,-12,0
gUJICGYZbQNVHdaXeMPLOBSKfcDEFARTW,TFDHUCBCCHGE..ZFEDQCBA.HAEAdGCHXBGAhAAAeDFCMHAELADHBAADfEAEhABAEFAA.AGHC.hACARDFE.JHFAIAFE......hABA......hACA...,1,-7,-30,23
cFSVWLOgXJUNdEfKeaHGRTMAPCBbYZIDQ,BBBDZAADQGEDSGEHLDEG.XFBAUBEFdFDAKDBHhAAAHDAHGACCMADHAHBDCAHHhAEAIBHCDAGH.FHAAhAAAOFFAJEEAEGGFaFAB.......hABA......hACA...,2,-23,-6,17
bHWBaeEMJNATVCSIRPQDLYGZFKgXUdcOf,TGDCSBBD.REDC.DGABGCGCFEDGKCABUAEG.dEBGOECHhAAAHGBC.BHHBaACBMDDEhAAAAFFBCCDE..QBGGhABA.LACDgGGAXGFDfAHEhABAWAEB....hAIA...,2,-24,-9,15
HYREDMgAVLXbeFCJaTWZUOINfPSdQKBGc,LBDGXDACFCHFJEFD....aABGZBBAUEBFOHFE...hAAAIGFCNDIC.SFCEhAAAdHBFBHHD.HDEChABAEAHDDAEEMBFAADDC........hACA......hADA.eFAFCCGA,2,-38,-11,27
GVXELOBRQIADWNKUCYTbdJHMgeFcaZfSP,DACBKHBGUGEBCHAG....TAEEJBBFHBEF..MDIHFBHDZEBGhAAASFGH.VCDDhAAAEACBBAEC..hABAQEABAHHA.YHDA..hABA.dAGAcAGG.hADA.aBBH.,1,-31,-37,6
GUHeXOYETDcJMBAQFbIZfWLNCRVgPdSaK,FGFCZAADLFDBCDFB.RFAF.VFAFdGHEKFFFHDBG..eDCAOADGhAAAEAEE.DFEE..MAIHhAAAAAIFQABG.hADAIEHEfDGBNCDF....SHGAhAHA...hAGA.aCCG.,1,-22,-25,3
CgJSYGLHKIWQBAbTDfMOFVRceXaZdPUEN,TAFBMCHFFBDC..RDBF.eBAFZDFBUBBF..EGDACHGF.SGBHhAAALFEDKADCQFFChABAAFDBDBID.fDDChACAOHAA.XAFBdAAB.NIDDgEAChADA....hAEA...,2,-23,-14,9
TGPZAXfFOJagDbMRLHIeCSNBdEcKWUVQY,FGFCaAAB.DCGDRCCE.LBACHGFA..eHAASBFEBFCDEBEEKGACUBGEhACA..QCAEhAAATDAFZEFEADIFODDBhABA...bFDDCHEGNADFdHAD...WDHDhACA......hADA...,2,-28,-4,24
QXdGeIMgOBLVFTEZbSDNHRAYJWCKafcUP,JGEAKEGD..aDBDUEBE..QGDGdBFAGADCMBBABACDLAFBhAAA.FHGAZGAADHBAhABAHDFCAEEECDAC....hAAAfAHEcBAF.XCCB..hACA......hADA...,2,-31,-28,3
EeabZfWYXJSIdCTGBQURVNHDAFLPOKgcM,LCCHKDCDMGCE.aGABZBGF....fDGEXADDSEEGhAAACHHGBDAB.UGGChABANICFAAEB....FGBEgGAGhACAEGFCeBFAWCEDIDAE..dAAChACA......hADA...,1,-26,-28,2
SOZEHCIJgQcLeUVAXfGWFaDMYdRBTPKbN,XFGHGAFEFDEDDBBAdBBE.BFBCKCDD...SHEAZCFACAFH.hAAA.IAHCJADB.hAAAQEEBeFGBAIAAaHBAhABAREBB....TCAFNCAAEAHB.....hACA......hADA...,2,-29,-25,4
TKVQfbdaeCNDIYXSRAcEPBGOLUWFHJZgM,EHBGBECDLCFGUGBHHEGBZDBG..MEFGKCCAQDEEdBCB.hAAAeACADDABXGFGhABA.ACAA.PAAHhABAOFBE.FAGCJBFC.gGEE..hACA......hADA...,1,-19,-24,5
NJPRTXGYbgUefQMSFZILOKWaVHEBDcAdC,CFEDJGEARBFA.GACG....bFBDeBFH.MFAAZADHODHBhAAAKAGE.aFABECAH.BBEEhAAAAAIFdGGH..PDHBhABATABC...........hACA......hAEA...,1,-28,-31,3
dDLZAWIGBFTfXQbYJSPMcEONeaUKgVCRH,GAFEBFCFFCAB..TFFHQBEC..JACCMEIBOEDBhAAAeFGBKFABCAHG.dHFDDCCGLBAHhABAAGEG.fCCBhAFAXGBGYAAAPCHD...NICF.hACA.....aDDChADA...,1,-11,-39,28
VWadcXBgZJIQfMOGeDbEYLNUKCSPFTRHA,VDAGaAFB..dCBABBABZGBG..QDGFMDHHOACAeDDFEGBC.hAAA.NICB.KBGC.SGFBhAAATAGAAHGGXACAhABAJDDA..IHHADFEELDAFCGDA.hABA......hAGA...,2,-36,-3,33
BHZaVCXRcedfSQGPWANLIgEKOFJUMbDTY,LGEAEHBGKDCD.FAGGMBECDGIDBBCE.ZBFECCAHREDF..dEFFSCCEhAAAGDAG.AHHF..hAAA.IEDHOCGHJEABhABA...........hABA......hACA...,2,-40,-38,2
ecfgaKDXEFAJZdMONHCBQLUVISTbWRGPY,JDCHdHDDMGDAHEFEBAFCUDBH....SAAFTBAH.RADFGAGChACAeEAF..fDDDhAAAKGACECFBZEFACBHG..hADA............hAFA......hAGA...,2,-38,-18,20
JAOIDVZbLdaTBNUQWfPFHYKMSGEXCceRg,OFCHVFDG.LDBAdCEABDHBQBFH..fBBAhAAAFEFHKABEMFAFEAFCCAECeEHFhAAAJDBB.AAEFDFBH.aHEAhAFANCAG....WCGD......hABA......hACA...,1,-17,-39,22
SYfGdLFNbMVXJDCEAgIcUBRaQTPeKZWHO,..IFDGBHHGQFDA.TFABPGAE.eABDKAADZADChABAOFHB.SFEHhAAA.GAFAhACALDECFBDGMEAEJCCHDGFEABID.....hADA......hAEA...,1,-23,-35,12
ceaZHYDCWMUASQfGREPKXTJFBdIgbLVNO,QGBCGEDHECCFKGGDJBAD.BCAB.dFBGIBHCLHAGOBEHhAAAeAFCZADFHFGHDEGGCFFFMIDAhABAACGH...SDBAhACAfAAFPAFD.FDGE..hADA......hAEA...,1,-16,-18,2
IDQUZGSKXJBCbRdcOFVTgWAENHeLYfPMa,ECFCHFDFLAAC..fDFAaECCDCBFZFFBSADHhAAA.JAHHBAEDCFBBRFGHODBGhABAFGEBTGBFABCHNCAE.eDCGhAFAMIAEIAHE......hAGA......hBBA...,2,-26,-13,13
eYXOTEcCZaSJQKfVNgULAHDGbMRFIdWBP,DCHDMEAEFFCCdAFDBAAD..eAAB.OCDGEBDBZGBA..SDFDhABAJAEE.fGHGhACAVFFC.UGEEhADAHCAEbGAC...IDGH...hABA......hACA...,2,-43,-14,29
QXaYMFLKGcBbHSZEDReWPVATgUCJIdNfO,TCGCCHHGdFDG..OBEEQDAG.XFDBMACGFEGFKACHGBBAhAAABBAEHFAGZDEFDCIFhABA...eHBGVAEChAAAAFBH.UGFC.IDDAaAGA.LHAGhABA.....hBAA...,1,6,-27,33
RZQWGMPBYAaTUcKbdSNegfLEVJXHOIDFC,aEHBTCGC..UCACKCAHdFFHeHDELCCBEAFG...XAFBhAAAOHACDCDHCHBEZABCQEEEhAAAMEEHBGHAAABASFBBhADA.fGHA.hACA......hADA...,1,-22,-29,7
FNGROQVWPKfLHgDeUAbZJMEIacdYXTCSB,ZFDFEFAG.aAAFdAGE...XFFCSGCFFDEEGDCAOEBGVGFAhACAKCBHLAAE.hADADICEADCCMCCC.YAHFhAEABBBFNAIEQAECfGAEeBFHhAFA......hAGA...,2,-22,-12,10
gWcNREbfDTISXVBMQdUHaJFOeZKLPCAYG,GAFE..gDCHNBIE.EGAADDBB.SFDChAAABGFFMCBHdHFDaDGHFBBCZAFEKFADhABACADFAFEH....WADBhACA...bFBDTGCD.IGHBhAAA.....hAFA...,2,-32,-30,2
PODdEYBVJHbRSAFLKNGXgcWZQeTUMCaIf,FEEDKDCDGEEH..XBGD..WAHBQGGHhAAA.TAEDUAECMCABhAAAaEAH.IABBhADAPABGDHAAdHEDBHCEJDCG.......hAGA......hAHA...,1,-30,-35,5
OJCXIcQgbLBPEYDNTFUSRfAeMHZaVKGWd,MHACZDDFaACDKCBH.GBEGdHBD..OEHFCBAB...XCEFhAAAIHFBQAGEhABALFAEBEGDEFAENDGEFEBAhACASACGAGAF.eDDB.....hAEA......hAFA...,2,-33,-15,18
gJHOYXCbcaKEPfLSTQMZARFGNDIdWUBVe,FBBDGDCCDAEG.dBEDUFBABEAG.eCHHHFFBOHDCCEFC..aEEHEGHBhAAA.LACE.hAAASEEBMDABADDBICEAhABA.VBGFYAHD.cGAGhABA.....hACA.PEHDfBCA,2,-26,-11,15
JaKZVMLIUOdTQcBXFPHDNASCEGgYRebfW,SEHBCFFCGADARAAC.eFEH....fCGGJFAAaEDGZBCCMIBGhAAAUAGE..dGAFTGGEhAAABFHBFHGGDBDGAACGEDADhABA...bAFAWBADKFDB......hABA......hAEA...,2,-28,-10,18
gMZNCWQaebUPKSXTAfJEHBcdOIVDRFLYG,EDCDBFDDdBAAOBAD.DGABFFEC.GBGCMDEE.ZBEB.CGHGQEAHhAAAaFGD.eHAChABAUACBKACAXGCGhAAA.AFFFJAFE.....cDCA.hACA......hAEA...,1,-20,-38,18
TdYGNKcLaRHgbFOJeCXDMUSIAZVQPfWEB,VBCDQCBC....PBFEECFBBEDCdAABGFADNBIA.hAAAKEFHaHEA.HGAEFHGA.hADAOAEBCHEGDAEESDHDhAHAIFFAADADfAGA...hAIA......hBBA...,2,-26,-18,8
AIgTWHeRNUFKPGEfaXLSBYVDMJQZcdbOC,TCBCHFDFRDBHUAFB.KCHHGACD.fFACaGFFLBAGhAAABCFDDIBGQGFEhAAA.dEEC.OCGDhABACEEBAFDHIGADWHBC.......hACA......hADA...,1,-20,-30,10
cXOCSGFbULAReDKIWdYBTPJZNHfQaMEgV,eAGHDGHHKACGdGBABEAA..JBEHHECF.QBAGEGEE..hAAAVAAEOCHHCDCBFHDCUAGDhABAAFAF.RCDC..IFFDhACATDGE..NFBF.aHAC....MADEhAAA.XGGB.hAEA...,1,-20,-25,5
QCXVaIbKBTWUNESPADYZFGgROHeJcMdLf,ZFDGGEAHRDCEHCFCJAEE.MABCdGHELGDA..CAHEaFBHKCADBDEFhAAAUBCF.EABFAHHAFHFCeBGHhABA....fAFAhAAA.........hADA......hAEA...,1,-22,-31,9
SPZVUBWeGNREIYbdJFafHKTLOXCAMQgcD,QFDBDACBZACBBGGDGEAE.RCBGECFB..IHACdHGFFADDaDHDhAAAHCFE.KBAFOAHBhABAABFDMFFD..SAFBhACAVECH..eEHB.....hADA......hAIA...,1,-11,-33,22
QNBUPRWFOVaTfCXdMEKDZAYbSHcLeGgIJ,SHBGHFDFLACBGGEBIGGC.JEBEBDFB.UAEChAAAPAAFRDBDOEEC.hAAATBAECAHDXCGEhAEAMAHDDABGAGAHbBEF.gGAH.WHFAhAFA......hAGA...,2,-21,-15,6
KMLNPAUBIEaXOedbFZcSYRTgfWDJVHQGC,BHHGEAFB.ODDGdGAGZDFC..SECHRABE..TGGDhAAAfHEFJCCHHFCCCABAKBFGhAAANICB.ABEH...aDADeEFAhABAFBHF...gDAA.DGGG.hABAQGAG.hADAMADE.,2,-38,-6,32
BNTXJfePcIOAZMVGgYdSUEaWRCLFHQDKb,VFBGGAFE.dBCFEBDCaEAB..RBAD.FEHFQFFHDGFC.BDEFhAAAXDCGeBFAIEHFhABAOFDHABHE...MFAFhACASBAFCEFCKHDA.NAAB......hADA......hAEA...,1,-17,-29,12
aXMONVPJZWdLecUBERKTFSHCbQGIfgDAY,XGBCOCHD..VEFDZBDHdGFG.eCAGBGCCKAFAFDCE.CGAGGACDhAAA..fDGEhAAAAIBEMBAH.NAICJEAEhABA....WFDB.....cBGBhABAEFCCSGHFhACA..,1,-19,-44,25
HFgDONWYbaELeAKRUXcPJIQMGdfVZCBST,UCCBXCBC..JEABQFFEdGFEZAAG.SAFHHDFCDAEA.hAAAOCHD.NEDA.bFBDhABAEHAE.LACAhAAAADFEKFHB.cCFDMAIF........hABA......hADA...,2,-27,-20,7
XLTRZJAIDGOBKWdgNSUEfQHbPaFVYCecM,DCECBDHBKAHBdBAF...SFAAEEBEHDDGaABDFBFD...CHDH.MAFAhAAALFADZFEFAGGBOHBAhABA..WADDhAAAUDBFQFGF.PCHBeEEEXADChACATGBCJAEE..hABA...,2,-22,-22,0
YfXOHRBQGWaDEAMbZTJdICPgKScFNUeLV,MECGTFDHdDGG..CBHC.KFBDFCBBUAEH.LAAFVGFG..XFBBhAAAOEHDBAHHhACAQDEF.aABAAHCBZFDBhADAJAEE.IBCE.SGGDhAFANIAHfDHE....hAEA...,1,-24,-25,1
EXbAUCHTDRNaKZPgFfSJeBIYVcMQWLGdO,UGDCCFFCHFBAREAE.KCDGZCCA..FDBB..SADGBADF..IHHBhAAAVBGD.MDIBhABAQGFEGAGE.EAAChAAAXGEAAIBEDFFA..NAEF......hACA.aFAH.fBBBhAFA.,1,-21,-33,12
FEBdLCWNeAUDHOfPMcaYVKXGQRgSZbTJI,UFCADGADODAGMEDC....aGGDKBFCGEAEQFCD.SBHHhAAAZAFETACCJEFFhABAEGFFBAEFdCCDCBAGeBCGhACAAIDG.....fFHA..hADA......hAGA...,1,-18,-38,20
cZbfPUOXMQHKgVWABGFCSYRIeJDNdaLET,BFFCFBCGCFHB.RFBD..eEDCDCGD..dBFBEAEHZDAF......fAABhACA.OAGHhADAMHECHDEFKHEGgGGBhAEAAAACSECCIHAD.aCDCLAHBhACA.bGAA.hAHA...,1,-32,-35,3
IcRCHLNAGbZPaVWFTDOKQJgBMYEXSdefU,GEDHZAADaDCA.FEAGDBHDQGEB.BCGGEDGBSGFChAAAdGBFeABDUADFRFCHHEADAIDA.hAAAVAEBOCHDKGHBMBIDhADA..fAGBCHAD....hACA......hAEA...,2,-19,-7,12
TGfUZLWEVBDdCIFQHAKeRNabOcJPSMgYX,KDBDeFBBRDEA...aDCFOFDC..PHFEMHDA...XBAFhAAATACG.UACELAEHhAAAVEFGBGADdHADCGBFQAGGhABAAHDA.NIEF.bAFESCAFhACAYCEG.....hABA...,1,-12,-22,10
fHRCXEAQYBWVJdNOTILMFUGPZbSceDKag,BHHGVFDF.JDAC..OCEGLFBG.UAGCZABDSGGDhAAA.DGBBKGEBaEABfCCBhAAAHDECCHHBAAHC.QAEChABA.dDFCNCIETEBCFDHB..hABA......hAEA...,2,-31,-21,10
OHGcYNWKIFXSCRbPVBTegDUdZQJAMafLE,MHFGLCCHHCCCGFCB..NICHKAFEIBGHFEHF..CCHERFCGPEABhAAA.BHHATEAEhAAAeACAUABGdHDDZCEAhABAAIAAEEFB...........hACA.YBBF.hAEA...,2,-19,-11,8
CFRSHfGdNVWabJPDBKLUgIQXZecEMOTYA,FGFHSDAFHCBFdCGD..VCFHaBDD..JFBHDGBF.KDCDUEEHQGGHhAAA..XAEFhAAAeHCEEBCGMBABhABATEDBADFHCBBF...fAGE.NAICWACEhABABAHFLEHFhACA..,1,-13,-27,14
QYXUgILKVHcdeFaNCZASTWOPJBEDbGRfM,TGBCOGEABAGC.DDFCGBBA.fDFAMBBG.QAFDhAAAUCDGLHFGhAAAKFGBcACFdCAFaFACNAIEABBDhABASEFA.PHBAEEAH...hAEA......hAFA...,1,-15,-30,15
EZOJaQRNAdIYPDfXcWFCKVUBMGegTLSbH,dHBH..IAFBDCCA..fAHAXABEFEHBCGFG.VFCHhAAAMBAGGCAH.eEAHhABAgCEFLFEHhACAHDAG.ZEGFOCFGaFABNACFAFFCcGGEKGBC.hAAABHAA....hAEA...,2,-14,-9,5
dbHVZGXMIWYELaJgeQADCUPSNROcTFBKf,DEFAUGGG..SEBARACBOEAF.FGBABAGEKCCD..dAHCHFCEZFGFGABFhAAAMABH..IAEChAAAECAB...hABA............hACA......hAEA.aFAHJCFH,1,-32,-34,2
RSBGOTMaPNUAECFQfDdeVIcWZLgbJYKXH,EEHBCFCFFCABDCGD..dFAAeBCB...VFCHIDEH.ZEFEbAGFhAAA..KAGFRADBSBAHhABABABAGGEFTFFEhACA.MFAD.NIEFAIBAfDBF.hADAWHAA....hAAA...,1,-1,-51,50
KJAFTBLIWSReDNUcVbfgZQCEdPMGXaYOH,FFFBBFEELFAESFAEeBGDUAAG..VBCA..fFDEhADAQGAAdDCBMDIHhAAAaHEEHGAAKBADAGHB..hAEA.TBEH.IFHDDFEF.NAIE..hABA......hACA...,2,-27,-16,11
QFbCEGIdAMcKZJUVaWfNeXYPDTgORHBLS,MHFGKCFCZDFCUDAC..VACG..aGDB....NHAD.XDEChAAADDEF.OCHBhABAHCABBHGBSAEFhACAFFFGCAAC.IBBHAAGF.cGAH.fFFBhADAYFAG...hACA...,1,-27,-41,14
EIcCgaPDRJeXUHTMAONBWSYdfLVGbFKQZ,OAFBBFDGSAGEdBDELABDGBGCFEEFZEABECDD...CHFH.gEAEhAAADGCE.JBDChABAeEHFUGGB...hAAA.MIBAAEIDYABB.fEFAhADA.KGBDICHAhADA..,2,-31,-18,13
NdDaXeEASCQcbJYWBLMPgZTHFGIUKVOfR,SFFBQGGGJCDFBECA.LABG.MEEHZAABFAGEGCEHhAAAUFAGOGAC.hAAAfCABdAECDFDHaCGHhADAeAFCAICECEHA...YFHHgFEF.hACA......hADA...,1,-22,-24,2
RUQFTaWLYMdbCeDfVBgZEJONIKcXASGHP,SGFHGEDHRABBFEAE..aABGLHCA.dGGGCAGCeFAGDAGBBGDChAAAEECEJBEH.IHCHhAAAXCGA.ABHD.PBHDhAEAQBDC..WFHDMBAFfBCEhAFA...hABA...,2,-23,-23,0
GMUXFVcZNHabCBPADTgWfRJOYLSQKdEeI,DAFBTCBC....fGGHREFEOHEESAFGdDFFeCBCMIAChAAAUEDEFBHFZAAEaEABCCHBBCFBhAAA..AADHgGEFhABA.YDDBQGABEGAA.hACAIEAA..hABA...,1,-15,-27,12
IGeAbLUNKfBXEFaQODJdMgcSRTYHVZPWC,LDACKGFCBAFEFEGGOFCB.DGHFMIAE..SHEEhAAAREBDHAACZEDFCEECGBEFAFIB.hAAAUABCXBECEGABaDHBhAEAJAHF.......cDAB.hAFA......hAGA...,2,-24,-24,0
XKLPBGSNgIFeHMVODcAUJRWdCbTQfaEYZ,JADGRDAGdHDD..CCGH.QGAH.EADAZDAF.KEEABDGFSFHFhAAA..ICDAhAAA.eFDEMIBChABADACDACDGbFDCTEGB..fHEDhACAaAGF......hADA...,2,-50,-22,28
IZHAaUJTFKNeSPCODVMfcYXWLbgERGBdQ,aGDDUDCH.FCHFKAFE..eFDBSCFE.OCCDMEAF..hAAAfBCGXBADbEFAhABAEHBEBFHC.IGFFhAAAAGGETEAFNBGGDIGA.....cADAhABAWAED....hACA...,1,-25,-37,12
FGSNZWYVebQLTUdaKEAOfHMBPDJcCXIgR,OFBBHFACMAFEDDEB.JFFD..CHEF...IEEAFABFGFEBSBCAhAAAZDFG.VBFChABAQAECLCAHTDBChAAAaEHDAGEBBADC..PAHB..hADA......hAGA...,2,-31,-11,20
FXLKGSYJETcWCUbBaMPDfNQORIgeAdVHZ,VBCFZDDFLBFG.SACAJBFE.ECAETGGE.CGEDBFFChAAAPFHB.NHAF..hABA.QGAFhACARDFA..IAGFAIFEdDGHFDAFKAAC.cDAChADAWFDF.aFAC.DGGB..hAFA...,2,-28,-17,11
NCKEXURJdWZOgTVbaAcHIYfBeFQGLMSPD,HAAD..fEGDFEFGGGBBLFBESDCFDGDHKCCAEBGCUACEhAAARGFAJADCdCACZFGBOAFGhBEA..gEEBhAAA.TABCaEDFAFBB.IHBEhABA.YCEC.hBFA...,1,-12,-13,1
HJFLWAgCKNTREUDIdBcSeYPbZVQOMXGaf,KEGDREFHDCADdFBGBDEH..eABF....PBEGbFDHZADG.QCGBhAAAMGAAGABEhAAAaCED.JFHDLDAAhABA.AHGECAHCNHAB..........hADA......hAEA...,1,-18,-39,21
CbXTZSKBaWfMPFgLVRYcHdJQIeDEUAOGN,GECFCFDG..XAEASADHBFHDaHAE..MBIFFDACLBHDhAAARFEHHCDDdABDJAFHQEAHhAAAIABCDGGFhADAABHHOHAA.........hAGA......hAHA...,2,-30,-21,9
TZUEgWBMFJNAQPLbaYGRICfXOHeVDScdK,QDACLGEAaCHHRABE..CGHD.ODFFHGCAeAGDDABE.dEEBTGBDhAAAEAHBBDDC..JBBChAEAAIGE...bAFE.IEDChAFAfFBFSGAD...hAAA......hABA...,2,-22,-19,3
PAJGIfWOgMHZcXEabDCFeNdRTLUKVQSYB,GECF..WCAFMIDE.ZADF.EFAEDAGEFEHBeABB.dCGELCAAhAAAUDBBKFGGSAGChABABCFDAEFH.fGCChACAOHBC.cGGHaEEHCFBA.....hAAA......hACA...,1,-13,-42,29
NBGVJARQgHCUSWDIMEFZKLXeTdfPYabOc,QFDHCFDDUBDH.DCCAEEFBFDAH..KFAGeAAD.dGGF..fCAChAAAaCFA.OHDAhABAcDDGBACCJHAAAEIHhABA............hACA......hADA...,1,-32,-51,19
UKWRAYJGDfLVTbIcgZBHXNadEPCQSFOMe,GECFDEFHLCCC..bABC..IFBBZBFCHFAE..aBBGhAAAdCCGEHECCHEDFHGE.eHAAhAAAKEGCAHIHfAFBhACA..TAFABFHGNDDFSHAChABA.ODDB.MDADhACA..,1,-6,-27,21
GSEDaKbAWUcPRCVTeXLIfHgdJYFQBMZON,UCBCRAADCFEH.eFAALAEAHEGDdBFEFGGABACBMAEC..ZBDHGDCEhAAADAIB.KHFGABHF....hAFA.PCECXAAChABA.IGEC..fGAFhAGA......hAIA...,1,-19,-35,16
YVUSZEgXLQOIDfbRWNGHaKTMecAdPFBJC,dAFBBFEDCFDD.UCFFZBBH...EFBFLCFD.OBHDfBABhAAARFGF.GACFaGEDMDBBhAAAADIFFGHH.JCAF.SAHBhABAQGBDDDCGNCAA.KFFC...TGCAhACA....hADA...,1,-20,-23,3
TDLRbQPECXgKWdIcBSfJANOYeaMZFGUHV,OGEAaDCDZAEA.GGADUAAB.HAEA.DEDCLDGFQDGEEFAGCEHEhABAXAAF.KDBHhADAIHFASBGAhAEAAICGeFEFMDDEFCED........hADA......hAFA...,1,-4,-29,25
bVgeIDLMQTAZBcHaJFPYEdNWOXCGUSRKf,BFDDHDAGJBGDFCAB..EEFHdADA.ODHDGBEDUGFBKFHH....hAAAVEADeHAELHEAhAAAMEEFAGBA...aDCEPBAAhABA..WABGCFAF.SHAGhACA......hADA...,2,-29,-19,10
dOcHWZGVFgRBLfaDJbNIPUQMTSeCKAEXY,XGBCOCCHHAECZFEAGBCBFAACBEFDLAHFDBIF..JGDCIBAEhAAAUGGE.MIFAhABAeDADKEHHAFDA.EDBEdHAF.hACA....WACBREAGaEEA.....hAEA......hAFA...,1,1,-30,31
RSIYKTDOBQWMdCAXeJEbFgPLcfZVUaNHG,XFCAEAABFDCA.LCEEZGDGUDGAHCCBGAEFRFFA..SGAGhAAAKHGGDCCE.BBAGQDAGhABAMBIFdADDAFFHeFCFhACA...........hABA......hACA...,2,-20,-19,1
WIMCgceOVPALRKTaNQZXJdUDHfGEbBYSF,LDCHTCCB.QFAEJFFG.dEHEHACGGBDBBCGGSCADhAAAIHAECBAFgGDAhABAeGBE.OHFChACAAAGGaFCAZCABDAFAbEECFHEE...cABD.hAAA......hABA...,1,5,-22,27
PXJbUeNfHKIMSOFCDAQTYBLWadVgGEZRc,QCGCBHHGLDACaEAA.dDGCGAAFEBBGREDF...XGGAhAAAUFAGeABEHEED.IFABhABASAGACHAFADACTCDChADA.VFCF.......hAAA......hAEA...,1,10,-34,44
VBeLdQZDfNRbPWXFEcHCIgJYSGTOUAKaM,MIAGVFEE.LDFCZFAE.DDEDRDAA.....bABEPACG.hAAAFBAHHFFE.IBFHhABAJHBESCFFhAAAOHECADDBaCCAeCAA.QFABNEIGEBHB.CAHC.hACA......hADA...,1,-12,-15,3
eETOdUfLKAXGJbHaNPIQFcMSBWCDVgRZY,XDACJFEFHCFD...aHAC..IFAEFDDDMEHHBFCE.CAHEDCDDhAAARBFHeHDA.TBAFhAAAOAECdFBAUBACfAGBhABAAIDA..NCIEQGGGSCDC.hACA......hADA...,1,-17,-27,10
KRUDcdJLOHeIaNTPbEgVYFSWCGBfMXZAQ,RBCFUAFBdCFFLGFGeFDE..aGDD..NABC.TBBG.ECEDVFBChAAA.FEHBSDADhAAACHBD.fGHEhABAMADCAEEDDBFAcGAF.JCGF....hACA......hADA...,2,-31,-19,12
CWUDMZQGITfaKbASNOBVRFgcLPJHdEXeY,OCCHVCDH.RAFD.FFACLFEEHFCB.dBAEXACC.eEGFhAAACACCDEAH.MIEA..hAAA......hABA............hAEA......hAFA...,2,-46,-37,9
LMbARNOSdVPCYKeGZaQTcFHWXIJgfUBED,RFDFSDCDdABC.CGBG.KBHBGAGCQFAAFACGHDEB..XGGGhAAAIHHAfEEBhADAEAFHMBBDAIFGNDBD..hAAA..OADE.......hABA......hAFA...,2,-26,-25,1
IDdHJbYSPKBNQOGAaTUEcXVfLCMReFgWZ,aEHBTFCA..UCACECFE...XFAHfGADMDFERDDGFBCFhAAAZEDDdGFEHCAD.bGFASAGHhAAAKEHD.BADDhABANIAD.OFHDAAHDLABCCAFAWCDF.DIAC.hAFA......hAGA...,2,-15,-1,14
bdWfMZCQTFXAIEJBaOPRYKNeVDSGLUHgc,JCCHOCAF.RFBG.KABD..eHFADBGEGEEELACEHAEF..hAAAgDFGdHGHMIAGCGDGhACAFAGA.ACCGBEED.hADAaAABNCHA.SHCA..cEAFhAEAfCHE...hAGA...,2,-30,-19,11
MGLDgbICSXHBcFeYPKAfWTEQJNdOVUaRZ,TCBCEGDD..JAGDdGECUDDBRFAGGAFC.LBEDDCDE.IBAHhAAACEBFSGFGhAAAXFFBBBAB.FEGGYFHBhABAKGAB.AIAGWAHBNCAC.....hABA......hACA...,1,-3,-45,42
fNVSYRIHEBbPLMCeKFdOWgQUcJZXGTAaD,aHFGDACB....VECFRCCCEHCEBAHCLBDE.CFAC.eDDG.FGGHhAAAOEFEQADChABAUCAGJAAEZBFE.GFCFhAAAADBCSEHFIBHE.......hAFA......hAGA...,1,-12,-34,22
ILcPYZJbgHFEBRDMUQefCaTOXKWGdVANS,SHBGLGEA..PCAFZDBDJFHDHDFAFBFF.BCHC.MFIDhAAAUFEE...fADAhAAAaCCDTGAHXABBhAFAWAFA..dABFAAGENEEDIFCC..hAEA......hAFA...,2,-30,-20,10
WKAfIFPNHRDaZJQdGEecYCXVOTSMgLUBb,FHBGHAADDHFGZAGB.JEGBdEAFGFAB..eFFECCDA.OBFF.hAAAMAHHLEEB.hAAABHHEKCACABAEfAFChACAIFDE.NIDF.QADBEEAC..cADBhADAXCDG.SHEGhABA,2,-31,-23,8
WJXMKHgFGaLYNReOBdSEfZDbQcVTCPUAI,JGEAMBDHHCAFFFGALAFCRCFD..BAFDEABDZFCEDACCQDDGhAAA..VCEChAAACHDHACCG.IHHBKCHHaGAE.hABANEBC....eHCCSHGAfCAChACA......hADA...,2,-29,-22,7
BQeScULDMJfNaPFWIKbdGXgTOVRZCHYAE,EFFBQEBE.SEEELEAFDDECMAIHfBCChAAA.aEFAFHAE.IAFChAAAKBGEbECB.XEGDhABAOFHF.VACHCHDHACFGcABBNIEBWCAF....hABA......hAEA...,2,-27,-13,14
bJeTVGWOcHaEfRKCAZdLNgSXFQPIDMUBY,ZDEDLCCHSACDQAFADHAE.BFFDJAFG.eHFAGDGAOHBGhAAAHDBBEEFEKBABABIHdABFhAEAXADBFFAB.MBIHhAAA..bCEC.........hABA......hBAA...,2,-22,-9,13
ZUIPGEAdJfKOCYQbWgBVaNecDMFTLHRSX,JCCHOCCH..QGDF..WHEEBFFE.aFAHeBGHhAAAMBFCFADA.HEFG.hAAARFCHXBDCZADHIGHHhABAEBABAIBAfCHGCGBC.....hABA......hACA...,2,-33,-23,10
SJPUBXAbWKEcDNFMgOedCVaYGTfIQRHZL,KHBGEHFGDHBGMDEE..eDDECFBH...aEBDTACG..ICAAhAAAHAFCSEFDhAAAUAFDAFFB.bEGB.NBBG.gEGFhABA.OABF...YEADhADAfDDE.hAEA...,1,-25,-35,10
bPMCGBYNafReADVOEcUFLXJIQdHKTWSgZ,DGADVDEDEFFG..FCBHLDDC.JBBCIHBB.dAFBTAEBhAAA..SADFhAAAgEAEZFCFMHCAhABABABCaGHDeBGDOBHB.....hAIA......hBAA...,1,-22,-36,14
MLSYKGgQfIaJFUXWbHAETeVRDPcCONdZB,EGDDeADGREBF.DCGH..CABC.dCEGZBFFBDCHLBDFKFAFGAAE..hAAAgFEDQFFFhACAaDAHFHBC..UGGAhAAA.bAGBAEHC..........hADA......hAEA...,1,-18,-33,15
RDLVSIFeQgdaPKTWCGYNEXAHUZBcfMbOJ,UBBHBFDDMDBBOEHHDICELHDE..VFFGFAHB..QGAEhAAAdABEaCFD.KAEETADFhAAACFDEGCEB.EEBAhABAADEEZAGF..fEEB...hADA......hAFA...,1,-13,-38,25
MSbJINCBYXeZKdQHaUgVFGcEWLADTRfPO,DEFAREFHODEHMDDF....SEBFJADA.CAAB.XBBBhAAAZGBEKGGFHBDDaAHF.UAGFhACAFHBEEHEEAFIB..fACFhAFAIECANCACBFFC....eGAChABA......hACA...,1,-24,-28,4
QYFUWfDaXTRBMcGeIgNdZbEALHVKJSOPC,LDACVDDF.JFHDOBAD..CHEBFEBCUGAE.DAEC..XABEhAAABDGFMCDEeEDHhABA..IFHHhAAAdBHGbAFB.AAHCKGFD.SDBH...hACA......hAEA...,1,-34,-37,3
OKPBRFSTfdCAJHLQcZIWeUNaMYDbgXVEG,LFFCZEFHeCADUAGGMCCADBGD..XCCHGBACKAEE.RFDBFAHBhAAASFDA.hABAdABHCDEGAIHEHFBB.IFHEhAAAaEBD.........hACA......hADA...,2,-30,-20,10
gLCKZHAfQdTBPYVNWbcOUGeSEDJRXIMaF,dGFCBHHG..VCAG..bDFAUAGDGCCCEABA.RFAH..MAEHaFCBLEGBhAAAKGFFAHDC.QEDChABATAFGPAAChAAANDIC..OAEF.eEABSGGEhADA.DAIF...hAEA...,1,-11,-13,2
bNBMSdKaARHLITDUYFfXVZJGceEWgCOQP,RDBGHFDFLHBEDFIDUBGDFABH....XEGAZDEAGEBE.eCAHhAAAEAHDCAFE..QADChABA.bFFDNCFEMADDhAAAKABAADDD.ICGC.fGGAhACA.....hAFA...,2,-24,-12,12
JSRIFMNbHKdDfEPUXTWQeALaZGOCVYcgB,LDCHaGFHZFAC.OFEHCABD...VAFH..gBCChAAABACGSHACFDDGbDFE.hACAdDAC.EAAB.PDHFhABATDAC.QGGEeFGBAEBC.YHAAhADA.....hADA...,2,-24,-12,12
gMBfHOLcNQCaKEWZSRYAGDPTIJbVedUXF,GDCCDAFB..IBBDJCBDeAFD.dAACUEAGFAHF.BFHFHFFGLGFGhAAA.QGCAhABAaGAAKHEC.ZCDCSADBhACAAAHF..PECC...hAGA......hBBA...,1,-22,-32,10
PcAIFDgVEdYGBbfHJeKOXUMaCSZRNTQWL,FHFGVFDGdFEH.BHCHHADA.KCGHUDDB..MICCCAAE.ZAAFREAF.TFAFhACALBCE..hACAAIAADDAHECGF...bDDChADA..fEHGOAHFaHGCSDAEhADA.....hAFA...,2,-34,-13,21
JVSBQWYTHeIgCOPDNLXZFdKfEUbARaMGc,aHDCGBGA.JCBDSBEABAFA.QFFD.TFABhAAAIHGE.gDEBhAAAOADANACGLDDBhABAZFCDKABEEADFAHIDRDFEMEIFWAHF....eFADhAFACBDC.....hBAA...,1,-16,-20,4
gKMaWGALZfdFRSJYeBXPHNTCOQDIVbcEU,LFBBZDAGFADBRBGH.JFGBBBFEHDEB...CGAEDGEF..IGEBhAAA..VABAEEDAKGAEhABA..MAHHaFFFACBHhACAfCDH.SEACYHFG.hAFAXDGENIAF..hAAA...,2,-36,-30,6
ZdOXFIWRSBKPbegcVHGfMLDaANCJTQEYU,CAFBJDCH..QDAGUACGZAFA.dFGF.OACCFGEE..RCGBBGABhAAAKHACeHEA...gEDDhAAA.VBGFhABAfEEADCCG.AIGC....NIABEBAChABA......hAGA...,1,-18,-46,28
LVJIGCKDdBXAPOgNfZURTFeMYEHbaQcWS,OGEA..fBGARBABeAED.MAACHDFAQFBHhAEASAFBJFFCIAHBhAAAKCEFBCCFAFBB...NICHUDBBhAFAYDDDEAFFaCHDWFBH.LHFACGEG.hAHADABE.....hAIA...,1,-7,-20,13
EPMVYdOSLZNFgWXIcCBfGTUJRQHDKabeA,EGFHMECGdDAGLCDAZABG.FEGC..XCEBCBEDBDADGFBDhAAAUGACQEDHKCHH.hABAeEHHAAGG...PAHFhAAAYACEOCCBSBFE.NIBDIGHDhAIA..hBAA...,1,-10,-33,23
BPbFfJDOCMQUIWeTHcREAKdLZSGYXgaNV,KEEDdDBDSDHFGCEH..XAFCaEACBGCAFBBCDGBF.MFFBhAAAQGAC.IHFBhAAATADAcAGDhABARDACAEHF...YEGFNEIA....hACA......hADA...,1,-21,-39,18
XMcbdUDFfaBRCTYLHJIPENeWKgOQSGAVZ,ZBCDMFFFdBAHFBGABHEF.RFFC.CBBCLEBGHBEB..JCHHEGHD.eCCChAAAKAFC...gGCDhABAOEADGECFhAAAAGEBXGAD.........hABA......hACA...,2,-26,-24,2
bFBEeXgdVQHPZcLKDTNRaGMUWCOYSJfIA,BFEDEGDD.eDHBdBFGQGGGHBBDZFFFKAEADFFAREAG...MAAECADF.hAAASBHDJHAE.hABAAEFEFDDFXAGF.hAEA.VFAB.LCCDaDEG.WBBE.hACA......hBAA...,2,-24,-12,12
QfPBUNKAXECecYZGWdLFSORgVIaJHDbMT,XGAFeCAFZDEHGAADdGHELDDGFAGFRFAB...VBAB.JBFEDFCAhAAA.MIDG.QEGEhABABAEDKGFAAHEBCDCF..hAAA.cFDGSDGC.....hABA......hACA...,2,-31,-14,17
bAUDHdENJSgaFIYPXQCLeBORKGVWTZcMf,UFCAHEEEEGAC.SBABFAGB..IGGGXDCFLACBhAAABDADOBFGRBEBKEGEGEAEhABATGGHMDIFhAAAAFIHDGFB.JHCE.aCFE........hABA......hACA.QACECBBH,2,-35,8,43
SNOWTdcfBDMUXFbYCLPAeQGRaJKHZEIgV,eDACGACFRFGF.aEFHKGCDHCGBZADH...EDDH..IFFASGAGhAAAODEEdDAGBGDFhABADACFUAFFFCCBYFHBhACA..PHDCAIDG......hAAA......hABA...,2,-31,-2,29
dUSQYbKCaWRTZJIEgBecFOLfDHAMXVGPN,MEIBVACF.GCBG.dHBFQGAEKADE.aHEARDFBZAFG.EFDDhAAAeEFA.FDEAfBAGhABADGGGAEAHXAGDhAAA.PBADSHEA.....hABA......hACA...,1,-17,-24,7
UcQbWTeJNEgAXdMVIHCGfDPaFYBOLRSKZ,dBDHMECGHEDHGBAGDDAGFHGABHFFLEBBRACBKHCG.ZAGDUAFC..hAAA.QGGChABA.TFBENABDAEIDIFGEhAAACEGB.aGAB.SGCHWDFE.EDEEhAGA......hBAA...,2,-24,-16,8
bcXAJeNCZWgGYVaMdPTUQRDEHFfOKSLIB,JEEGeAFBZCCDGBAC..aHDEdFEE.PDCDQGGG.RDAFHAEDhAAAOHFCLAGBhABAbGACAAEF.CCAC....hAAAgGCCMDIFDCCGFEGFfABF.hABA......hACA...,1,-6,-16,10
VfDbSXQEMHTWKZRJeBcGdaYONFPAIgLUC,LGEAUGDCCDHC.DEFF..SEADXDAGMIDGHBDCKAAGRCFABCDFhAAA...dGBDODBGhAAAFBAGAAID.IGGBhACAfBFFEDFHWEBG......hADA......hAEA.eHAAaHAC,2,-25,-20,5
QLDNGbPOCJdefaSYBARFEVUTMXgcWHIKZ,RFEEFEHBUAEFMDCF....XCAC..cAGBHDBGKHDGhAAAZDDDDEBHGBGE.OFAEhABAdBAAaFFBSBBEhACABCHAEACA..gGGAIHAG.NIBFCAEA.hADA......hAFA...,1,-16,-23,7
NCFMBbWfKYVDJHZaUgQAPRdXcTGELeIOS,RDAGXGBCGDFCLBFE..IHEEOADHCFDDBGGA.hAAAfCBFKHGGDBAGJHAGhABAaAGD.QEGDhAAAAHEE.dECBEFAESADANDIE.MBADhABA.YDFD.hACA...,2,-26,-18,8
DLWcHCIZXfJaUFdReQYBVgGMbAOTPNEKS,ODACTCBC..EAADDEHB.LACAHFGDIBEAZAGB.XDFFhABAaGEHdGAEQGGBhAAABAGHVFAFMADAAGCEPEDChABAKDHHSEED.CACDJHCE..hAIA......hBIA...,2,-23,-1,22
BXFKeTZJRSLfcdUAbIMaOGEWVQDNCHYgP,MCCAaHAEGCBG..VDBGDBDBHFEF..gGBFhAAAPAEDBGAFKEFCeHDEZBFBJDHDhAAASAHD.hABAcAEAABBBIHHHOFFE.EABH.WDADhABACBHA......hADA...,2,-24,-12,12
UJVPLgKeYIFBEARMSHZaTNWDcfOdGbCQX,SAABZDDFaACD...TGDFDCEAOHBEGEAH.QADHhACAJBHDLHFGKAGFIDGChADAFFBBAAAG.MFIDhAFA.NAIG.fGGFCCCGXFFEPAEAeHAEBDEChAHAECBBHDFB..hACA...,1,11,-26,37
MaDSZIHLXOKUbNEGQecJRgFAPfWCdBTYV,...fDCDdEGDTEDHMAADDAADZEAHHCEDLCCAKBGG.UAGChABANEGCEEBDGGDF.hABA.eBDCRADAAIHGCCAAYEHFhACA.aBBG.XGAC...hACA......hADA...,2,-19,0,19
LXPCGgVfFMeTaZWJIBESRUHcQAKYdObDN,KAFBOCCHDEDGLAED..CFGHGAEG.VGACMHFCaGEChAAAJCAG.BHCGRAGBUABFhACAHCGHAIEA.dABD.NIEB.XDGAhAEA.fEEEeFCG...hAAA......hACA...,2,-33,-14,19
EVSHXMgWLJATFOdCecNYQZIKfPDGBRUab,TGGDFEEDdBFE..eBBF..NBEE.QDCBKDGCDGEA.BHBFaABF.hAAAEADHHGBE.MFAAhADAgDGH..hAAAJAEACGGH....YFADIDBCfHCFhABA...hAHA...,2,-33,-22,11
AMILabgNUZWPTGCReBcDJFXfYVESdKOQH,LCHDaHBG...NIBH.UCBEZDCA.PAGHCGBF..eBCEBAAChACAJGDGFFGB..XAAFhADAfDDB.EHEGhADAdAFBQADEAEACMDDEIHGE..hAEAWFBA....hAHA...,1,-19,-38,19
UQZOaEXdTbCVfMWHKYLcBRNAGgPIeSFDJ,GAFE..PGFASEAADFCEUACGQFGDZAGF.EFEChAAAXBEFTDDGVABChABAMEEGHBABKCHBLHEAhAEARGCAAFFA.IHBAeFAF.....hAAA......hABA...,1,5,-20,25
IKTOACVUWPMEgQdYfBbcDSeJLXaGNFRHZ,CFFCUFDH.MAIHQAGF.dDEFBABCDAACeDBFXFAHaAEB.hADAGCBD.FBEGHDCFhAHAKGGGACGA....hAAA...PEFAYFHB.fGCGhBAAcABDSEAEhAEA..,2,-34,-25,9
VKUMfFeATPdBLEIOgHNSZRcJYCXabGQWD,dGFCEDAB.OFBHHCGDZABCRAAC.JFFB..CHHC.aFBEQADC.hAAADDHD...UDEAhAAAMCFFFFCFAAFCBHBC.hABAIHHDSAGBcDCG....hACA......hADA...,1,-30,-34,4
PVCWSdGFfeZEaXMJRYbKOLIQcABgDUHTN,BAEDDAFBHBAH..TDCAVBGD..SCDFFABDeAFEaCGAMAAEhAEA..RDGB.KGFAIGFFhAAAAAGD..NIEHCGEFdGBEhABAGEBCfCDBZEFA.EGDF.XDAFhADA.....hAHA...,1,-11,-17,6
gOYTKcNWSBJCMZEIVULdARHfePDXbaQGF,RGFGHFDFeBAEXEAB.QCGEFHAGODBAKAAC..NEEH.SBDGhADABHDG.JAFChAEAMBFEIGHHLCFEhAAAfDEBDAEEaEBB.......hABA......hACA...,2,-31,-11,20
bGCYdDVIJBMEWFKTReZXgAULfcPaONQSH,UDACLGEA...fBBEaEFFOGBEQACEHDDBCBBCdCGBhAAADFFA.JCFEMFIFFGBEKAFFhAAAeFGH..XEBGhABAAIACPAEASGADGACE.IDDGhACABHEA.....hABA...,2,-12,-12,0
PVWHJbOGFEDKMYXSfLNBRcQZAIeTUaCgd,eDACTFCACGBE..dDGC..VABGHACAJFHHOHEE.FFCAKGEGMBIDhAAASGAF.hABALEFEBDEFcAFEhACAACHDICEB.aAFEWFAD.EGGEDAEG.hAEAfBAE.hAFANIBF...,2,-22,-21,1
VNLZKSIcFTODREYeAWdaXUMHQJbGgCBPf,dAFBaEHB.MFHDHFCE.JBFEGBAC.BHCD..VBAELDDEhAAASEEAIHEDhABAFDDEDIAEEFEEACFE.XEBDhACAbEABCAFF..fHDFNAIEKACG...hAEA......hBAA...,2,-19,-19,0
SLRUAGCHBQYKZTMefOPINgacWVXdFDbEJ,GCCFBDCFKECGMCAA.OAFE..IBAHaHEG.VBEDhAAAdFEFDDIH.JEBDLGAAhABAADBDCAAF.QGFEhACA..YHFGZCGDeAFENCHC.cEAHhADA.....hACA...,2,-33,-22,11
AJRgMdGYQCZXPfVNSDceFBaHKIbLUTOWE,JFBBRFACMCCAGADA..CABAZEEF..fBFB.SCAEhAAADDBHFAHDaGCEIDFGhABALADE..OFFFhACAAEIFdDDCXGGBNEIGBHEEKDAD....hADA......hAFA...,1,-29,-30,1
JBASXYbWDaTLgZNfUFVQEeIHGCdMPRcOK,XGBC..WFFCaEGD.LDEGZECCUBEAQBCFhAAA.ECFCeAABHCAB.hABACAFEdGGFMCIHRFBCOABAhAHABCDFAEADYACEDCIH......hAGA......hAHA...,2,-31,-5,26
daIDGSLTZACNXeWgHKUBFbRVQEJPfMOcY,XGGGeGEAHCADBEAERAFFEHCE...JEFCMCGF.OCEDdFDHIACChAAADBDALAAHhACAACCECAEF.NIBF.KBHB.FHACbECHhADA...QAGEfDDGaCCA..hAEA......hAFA...,2,-21,-11,10
UXBTgKfbFcOQGVDaERMLHINZJYdeASCWP,CFEDUCBCBECAKGEC..FDHFOAABGAFG..DDIFEBAELAFHhABA.HFBFIDBGhAAAJAHB.dADHAGHA.SHBEhABAXDDD.TGFF......hACA......hAEA.fDDB.,1,-25,-33,8
AdfGLBQbFKZcSNTRWECJODYaPXMgHeIUV,GEAHBFFEQFAHFCHBKGEHZCBE..SCCBRAAE.CBEDODFEhAAADADCaHGG..MDGHhAAAgGDHHGAA.IHHEhABAAAIH.dDAF.bAFE...NACBEEDFhAHA......hBAA...,2,-24,-22,2
KGUVHdeSMgfbaRcPOBILETAZNXQWFCJYD,XFDHFGFCCADG.DBGHGAEE.HGBEdFAFeBCCMIDE...fCDFhAAAbDCF.RDEDOBHBhABABAGGEBAHTGAAhACAABIFNEAC.QGGC..YEFGhAAAKDAA.....hADA...,2,-15,-13,2
SedcbOVFUfaLHRgIJTEAXYCMPQGBNWZDK,CHHGQFDBBDDFZFED.KDEA.dEAHOCEG..FBEBUBAGaGBDRAAC.hAAA.JFABADAE...MBIDhABANDHE..DGAD..hAAA....SDFA.eAEAhACAcBGFfHBFhADA...,2,-47,-34,13
fOXeZSHVCPbUKETQRWFJIacgGDdNMBLYA,ODACeADGHBAF.VDGBCCDDUFCB.KHGETGDF..QDFFhAAAFHACaGGHGCCEhAAAdBADBBGEAAGCXFAAhABAZFFESAFF.EHAEWBFA....hACA......hAFA...,2,-30,-2,28
dDAWRQeBaZNCIVbKXHEGSgUfTcYFJMOLP,QFDHaDABZCFB.CHBF...IDHCKAACEGGGGBCHUFCA..hADA.TEAEFFHHJACFOCGFhAEAdGBCAAIF.eDBGBEBFhAAANAIE............hABA......hADA...,1,-10,-38,28
gWdEPFaUZbXfNVOJLSBMYGARCcIKTeQDH,CFDDKHBG.eAFEDCBEHADEdBAH.FHGAZDDA...XCGBVDAHLFFDhAAABFHDGDAE.hABAAIFGRADEIDDD.hAAATCGCgFDFEGCD......hABA......hACA...,2,-24,-21,3
VDdMRbXgCWZITPFHaSOUEJYANfQGeKLcB,QCBCeCDGLBHDBFGCDIGCdABDRDAG...XAEDCGCEZABE.TGEGhAAAFFGAHEEB.aAGGhAAAODFC.EGBHACIBfFAEhABAcFDGMAHF......hACA.WEAA.IHHAhAEA.,2,-30,-13,17
MTENYJRZUQfcPHBOeAXIgWSDLFKaCVdGb,XCBC..gEBEDAFBLFDFaCCAdHADGCGA.MEADhAAANACH.JEBDZGDEUACChABAQEGF..hAAAPFFBBBGDABCGIHHASCGACDEG..hABA......hAHA...,1,-13,-33,20
SEFDOcZWGJYaXfPIMNHbgRCUQdLKBTAeV,eDCHVFEE.EHGA.DBEDOBGH.ZFBFJGDE...aACGXCCDhAAA..fDBChAAAIBEGMACDNAFEHDGDhABA...gAGCCBADdAHELEADKGAAAIDASEEGhAGA.hABA...,1,-5,-26,21
ITRPSfYGDAMLOVZcNXCgBWaHJeKQdbEUF,OAFEVGFG.ZAAC..XCGECFAFBFEDHEBBeDAC..KHBAdDFBUADHhAAAFFHBRCAA..PCEHhABASACE..hABAfGCDDICAADEF.MFFE.cAGEhACA......hAEA...,2,-28,-24,4
DUYHTCPWRFVAacNbZGEQOeISMKBXgfdJL,aHBG..bCAAZEBEQFDHOAGH.SAGBBDCF.XFBBhAAAfHFFLHEAhABADABGHADFCEEBRABAAGHAcDGEhAAANAIE...eBBFMFAFKFEAgBEChACA.....hAFA...,2,-29,8,37
AYWHLeDadCQbVOTcNJMZKISGPURBgFXEf,HAADeBFDDHCGCCDA..VDBDOAEA..TGEHJADHZEEH.KBHDIHBChAAA.GAEDhACAPCBBUDGC.BEFFhADAXGGBAGID........hAAA.WDDD.aBAB.hAEA...,1,-18,-33,15
YNfgMKXGAJBRPZbHQEDdWaUFVcCLeOTIS,JFCARDBHZAEAHADADEEG.dAAF..UGGGFEHD..CGCD.OFFH..IHABhADA..NCAF.hAAAMDDCKDHH.AGGHBBBDhAFA.QBGAaGCE..LDADhABASEEE.fHEDhAGA.,2,-36,-35,1
eCYHTFQUELZAcXBDNKRIJObGfagSWPVdM,BHHGDGHHKDEHJDDEGACG..aGBE..SEGE.VFBAhAAAeAGB.CFAATACBhAAAQAEBLGFEhABAAIBE.XCAA.NIAD.IAHG.hACAfBAE.hAEA...,2,-39,-34,5
DTNEZLKOgMAFfRJWXYPeCcdbGVaIUBQSH,FCFCRFDF..JDECXCDH..eFAHdFBGVCAGaDABBBAF..hAAASFFAHGFEDBIFEBEGhABAKAHBMAAAAHCF.fGEEhAEAPCBG.CHHG.......hAFA......hAGA...,2,-32,-26,6
eGHgZRACLBEOSQWfXVYUIFMJDcTabNKdP,CEFAEDAB..QBDH..XGDAVAGFUCAGICGHhAAAMBAA.DGAE.aHGAbGDGKCDGhABA.eACHGEGEHEFAhACARFAFBFEDOHAC.fAFA..hAEA......hAFA...,1,-11,-20,9
WUFSMcLYZPVgKDCefBaOGdRHNATbJQIEX,TDACJDAC..EEFGUDDC.FGHBSAEGLHAAZCGF..hAAAgFDGDABFCGEBBACAhACAaAGFdAFBHFAF.AGHFbAAEhAAAIGBA.XADDMIEAcCGChABA......hACA...,1,-20,-23,3
HcEgSNYZDbXRLfPGWABFJKCOIaTQUVeMd,JCAFOCAF..aDGCQBGH.VGAGeFCC.dHBHEFEBSHFAhAAAZFFBDDDAXAAEhAAALCCE.fDDDhABA.........hABA......hADA...,2,-37,-30,7
AQFdfBMKDIJLaUPRHObVNXYcGWCgSeZTE,FFHBBFEDDBEELBEH.UCACHCDBOHDAbAGH....XAABhADAGBGC.CFCESGEFhAEA.ZFFHhAFAEGAC.AADDfAABIGAH.aAGB..hACA......hAEA...,1,-20,-38,18
dEJICKaHMfYSUcebBLVOFXGZAgQDWRPTN,QAFBRFDG..TBADEFHDCEGFKBAAMEBH...SDEGhAAAeADBLFDDFAFBXCFAhABAAIBADFFF.PHFChACANEAFICHEaDCD........hAAA......hABA...,2,-34,-20,14
CYQfeFNgUPMGSJXTVHbLWBZEDadRAIOcK,OGEACFED..QFBCeACGFBGAUCEHMEAAGAAF.SDFChAAAJEAF.XAGHhABAVBBBLFCFhAAABHHEZFFFDGIHaEHBAEHD........hADA......hAEA...,2,-29,-23,6
BdWQIHgcTMVRXASONDLUGfYeJbPCFaEZK,OCCHDEFHUGGCGAEG.eDABJBDH.CHGG.FBAAZGAE.BFHFdEBC.QAGAhAAAHCFG.TACFhABAMAEG..RGCGAFCC.hACA..SEGGfEFF....hAEA......hAGA...,1,-16,-36,20
ENcbQdUReAfJOIgTDVHSZGYFWCaBXLMPK,JEEGOGEA...TDFBDFACSBEH.GABAFCDFCBBCBAEGhAAAMIDG.KBFAEADANIBH.hABAQGAC.hACAdDHEUFAAeGCEAFDDIDADgGGE..hAAA......hABA...,1,-22,-35,13
KTFYgaEHdQCfNORXDPSeUGAZJVLBIcbMW,ZDBGLFFCBCBC...IGCCMAABKHBGFBFH..aFFDdFAC.CADGODDFhAAADEGC.SEAEhABAUBGEGFBDJHEE.hACA....cAEGWBGB....TBBChAEAEHGC....hAFA...,2,-35,-31,4
BQKUEgfASTVcOYbdNCZHLRaFGWXMIDeJP,VBCFOGEA.dAEDZAFARCFH.GEBA.MEECIEHA.DADFPDABhAAABAAF..UCABhACAEFGCAIEA..SFABhAFAcFDA...NIDHCHCFLABCFAHF..hAGAeDDH....hBBA...,1,-9,-26,17
KAEDadPYVfUIXeFOTRQWGMNCHZbcgLSJB,aGCDdHBH..VCCCUBDD..eEGFOHFEQCAEMAHD.CFAHHAFHhAAAZCAF...gFCEhABALEECBABEhAAAEABADGIF...fCHEIGFHFGAFWFEHhAEANAIESAFBhADAAAHE...,2,-33,1,34
EMUHfcYdJPDAGSCLQeKBgXTbRFWIZVaON,SBCGLEBEeBHHKHGEBEAA..gAAB.XACFhAFATCGEFGBAZGAGaGFBhAGANIAFUEEA..cEGHhAHAJAEEAFDC.CBGC.QCAD.WABChAAAIHHC...hAIA...,2,-36,-12,24
cfOKMHWaSTVGZgNJXbeIECQLRBUAYFPdD,FHBGdHFHDBBAOFFFHDEC...SCAHGCGAZAAFJAFAXAEBhACAeFDB.CAHDLFDBhADABDDFAFBE....cFGBhAAAfCEE.MEBAaCDA....hAIA......hBAA...,1,-22,-28,6
PHfUYZBaXLbAcMNSdeJVQKWTDIOCFGgER,MCCASAFBdEFE.eABCJFBG...QFDFKBFCDIEE.IDDHhAAAOABC.FDBDECHDPHBChABA..fBAEhAAAYFHHaAHFLFADACCE...NADF.hABAWEFBCFHB....hBAA...,2,-31,-26,5
fEKRdSPZcbJGWaYNeOTXVIgQFMBHCDUAL,EDCDKEHBRCBCdBAAZGDA..JAFAGECB..aCGBeACG..TFEChAAAXAGG.VFAFhAAAIHGB.FDHHMBAFhABABACC.CFBFDIAEAIHA.SCCE.hAEA......hAFA...,2,-32,-20,12
OVeEdaZfbLPSTAIYWGUNKMFgDRBcHJCQX,..IFDGGAFEKHAGFFAB.DFGGBGGFHACD.QEDFOHBGeABChAAAEHDGdBAEZBDALDEAhABATEAGAGIB...WFHBhAFA...MAIDcGGH.CAHA.aFFB.hAAAbAEA.SCCDhAGA..,1,-9,-20,11
FgNMUSJTRCWZbaeAEXdDGIcVQYfLKBOPH,XFCEdEHADCBHGECH..VCAHQGAHLDECOAAEhAAAPAACFCDC.MDAFSFGHhAAATBFBCHDDWFEHhADA...aHBGEHFAIAHH.fAFAhAEA.KCCC.hABA...,1,-11,-20,9
AaLDFIPfWQOMRBYUHgCdEZKJcVTbNSGeX,DFDCFHBG....IGECfADC.QCAHOBGHMCDBhAAABFAAUCACCDHAZGFGKGGDJGCGhAAA....cFABhABAVBEA...NADD.SBACeFFE.AGGGaHAChABA.WEDE..hACA...,2,-31,-29,2
SfZQOcgGITBedKaWXDUNHFAMRYCPbJVEL,MECGCFDD..JCBCEFCDLHDGZEGH..QBDHOFFAGAGEhAAAIBACBFBHKHDA.hABAaEADXDBG.hAAADIAG...NBBHAEFCRAFCPFFD..SGAGhACA..hADA...,1,-18,-36,18
QUCZdTXRfIbMHBAgNEFYGaWLODVSJePcK,EHBGGEAHLFADDDBC..SAEDeFGDKAAEQBDEhADACBGCZGDGdAACRDEC.IDGD.hACAMFIBACHFNCIG.aCBD.VFCAhAEA..cGAF......hADA......hAFA...,1,-4,-29,25
BPEGdDbWQeUXcIOCSNRMaTgJHVKZAYLFf,FDCDBFDGGDGEdBFHDAADQAFE.eACHUGGF.XGADhABAOABBSGEChAAARCAA.aCAHTEEHhACAJFADKHBAADHALBBC.EEHF....hADA......hAEA...,1,-11,-32,21
KRMGTeaIdZWBUfcYgFOHPDNXAbVJEQSCL,VFDFEAAD..QGABCCDA.KEAERBFCMEBDGEDD.aBGFZABDUGGEhABA..fAFHhAAAYCAG.OHFChABADDEGAACGSACA......hAFA......hAGA...,2,-33,-17,16
OXURbMgVKNBIEDGPcaFLdSZWHeQAJfTCY,JDACCHHG..ODDGUGGF.RAAF...MBGFKDBABGAEDDDE.GCGGhAAA..aFEBFAEHdHDHZGCAhACAeBBCAEFH...TFBEhAAA..XAFBgAGBNIAF..hABA......hACA...,2,-39,-28,11
aZdCRSbFcKEJefHGIMXQNTAYLDWVOUPBg,LFCHVFDG.UBFGBDCBZBCBCDFH.RAAF.FACGKGFC....EHCGJEFChAAAHAEAGEAE..hACAMAAD.XBGAhABANADFAGID.DCCA.OHFC.aGAF...hAIA......hBAA...,2,-26,-21,5
bCAOdLIFeDaTfVXZWNEgPBJRKQGcYSUMH,dGDBFDCDeBGFDFAB..aDEA..TBDA..VBBGXCABhAAAZBFAEDAEBGAH.KGGCQEFBhAAA..hABAcFDBSGBFMCIHCHFHAEIHIHHGhACANAEB......hADA...,2,-31,-25,6
YHcXfePGWIVNZSKCDAEFMTOBbJQgRLadU,MIAGOGFABEHF..QACHLCCCaDDHUDFBHAAE.XFAAhAAAeCABPDCDhAAAIEAFNIAB..KBGDAHGFEFHHhACAbEDD.JAHB.dEEA.fGDEWAFE.hABA......hACA...,1,-4,-21,17
aJbQTODGZSgdNYeXcLVWRfABKEICFHMUP,BEFAKAFBCCDC.HBEF.MIEEaFGH...JDCBQFAFDCID.ZEEBhAAASGABdDAB.hABAeABDLFDDRGCAfFGAhAAAIAHB.FACAPAFAOCHFgACEhAEA...hAFA...,1,-15,-29,14
cOLgPaJCNXKUTdYfISZWGeDHVFbABERQM,EGFHRFEEQAAF..MDIDLAEGaCFAJDEFCBHHKGCG.UDCEhABATDBDdFAE...fBBDhAAAIDAFSCEEhADA..WGBEDEIB.FACABHHEhAFAOHBE.PAFAhABANIDH...,2,-35,-12,23
ECOJNcBfHGgUZXIdDeARPMLbTFVQKWYSa,RFACLCHDFCAH.VACBKDEF....SABAaCAC.CHCD.JFFBhAAABHFBHGAC.gBFFhABAUEGCZAFCdCCEAEAAMEDGhACA...........hAAA......hABA...,2,-43,-17,26
TRVMYPQXIecKUNZFAgSbWLHfOCGadEBDJ,SHBGLGEAOBDHGCCDdEADDFGERBEG.MGCC..QGBEhAAAIDAF.KFECZBFAFABDhABAAAFA...bDFEfABGhAAACAGA.EGHFBDAB.....hACA......hADA...,2,-33,-14,19
YBOGTDPMgIFbdVCALXKReEWcaHSNQfZUJ,XAADKDBDEGHB...aCHFSAGC.QADAhAAAUEADBFFAOCGDTDDHDEDAhABAgEGBbGCA.hACACHAFABEC.eFDDWFFBNADFZBDEJFBE.....hADA......hBAA...,1,-13,-23,10
GbMFdcILPTCVOgYaRDNXeHBEfSWAQUKZJ,QFCAZBCFJGAA.MIAGdHGFLCAB..CDBBOGFEhAAAaAHHRDFG.NCADHEAHBFFHECEAhAAAfAGB.SADChABAAADAKHDA.FDEFcECCICHC.hABA......hACA...,1,-9,-31,22
TbYAZQLRWHGIfPaeCNgcFXDOVSJKdEMBU,QBDGLFBBRDFAHCDEGGCB..IACGaADAeAAF.NBCE.FGGChAAA.DIDGOFFA.hABASBGBJBBHdAGHMFADhAEAUGAG..........hAAA......hACA...,1,-17,-19,2
XeJTPcVWGFYSUQONRMHKbDfEBLAaICgdZ,CFEDdCFCZBFAJECC....TACG..PEBB..WHEAhAAAFDHHUGGG.QBCChAAAOECHRBAFKFAHDABCBHBHhAEAAAFEaDDB...XGDHeEEE...hABAcAGA...hACA...,2,-33,-32,1
VADFOSfHXUQMdcKBGLWgPTNCEbIJYRaZe,OEACSCFCHFDGQECGdAAGKCCFLAEH..PEGBhAAACEFEEBHB.IHDBhABARGAEaHGC.eBDCAADF.DGIFFEHBhACAfEAEMAGFBHDA......hAHA......hAIA...,1,-9,-24,15
JWecYbTFHNORLUAGZDIXESKgMVBdafCQP,ZEEBDAFBEBBAKBCD..MFABdDHE..CFED...JBFEeDDC....hAAAbFBHTDAG.FGHFhABANIEF.OGBCLDDBhAAAABGDXGFD.SADHBAEAaDHFPBAFhABAcAGF....hACA...,2,-33,-23,10
FSKGIXTaYMEcNVdZLHDOUBfWQeACPbgRJ,CFDG..PFBBRAFAFDAE.KFDHGGEH..IBDE.aCFHEBAHhAAA.VDEEdHDDZFGFDFAF.hABABBBA.QAFEhAAAACHH.JDAAXGADMCIB....hACA......hADA...,2,-36,-18,18
FTQdZgPDJcAXVMWISeGOfYKLbHBUaCNRE,XFCAVFAC..MFGFSABEGCDAOFHHKGHHLAEBhAAABDAHCCBEEEBH..TACAhAAAdAGHZFFB.DCDBAABGeAHDhAEAfCBC.YCHH...hAFA......hAGA...,1,-13,-25,12
cUGgWXLAMeEPfJIFTRbSHZCaKOdDBYNQV,EFAGJGEA.FABDRCAF..HCCFZEGBKEEA..dBHABBDAQABBUAGC.hAAA....WHEGhAAAADGHMDBG.eHDEfGAAhACA.IAFFSAEBCHCHaDGH.hABADCFC.....hADA...,2,-40,-19,21
gafMQEPHbBKUWYNGeTZRIdDOCVSJFXLAc,aHBGQFDBHCCCBFCFKAECUCBF..NGEHGAFEZABAdFHECAHBJACALBGFhAAA.ACIF.fAAChAAA.PHFEhAFA...YAHHeDAD...hACA......hADA...,1,-13,-30,17
XYCJNOaIRQecFgZPbTUDGHKWEMdBASVfL,SCFCVFDF.LEDHCHAE.OFFARCFCeECFFADAZBDE..hAAATAACDCACKABGMECDhAAABEAEAIHA...fAGBhABA.XGGBNIAFIAGC..hACA......hAIA...,2,-34,-30,4
KTCQPZIBRGdaJVHAMeYfNSgFLbWOUcXDE,eCHD..NDHCFABDLDFD.OCBAUFAEDDEGEAFEKEAH.QGCAhAAAIAGGBADDhAAA.dEEGJHFGAIAA.YABGhABA.SAHBWCDF..XGEAhABACEDA...hACA...,1,-21,-46,25
WAbUQFgSKMHINdVOCGYPRcDXLTaEeZJfB,UCGCFGFCKHDAHECA.dAACCDEEGDBARGBG..DEAHLBDFaCAEZBEBBGHChACAABAC..QDGDhAAA.MAFChABAIGFEOCAB...cBGF..hACA......hADA...,2,-32,-32,0
YQgWdRMTfAFOJGHXBECDPSZIeKbLUVaNc,OFFBJEGHHEBEBECDDAFC.ZGBE..KBGGUBBB..VABGaAAG..hAAA....NEIE.QGDGhABAdDEFRAFC.fDHEhAEAAGAH..XADBPCDCSGBGhAIA..hBAA...,2,-33,-32,1
WXYGZaJLQNdSAbRMTKOVHgPCEBIcUfFDe,RFACTAGDOFEA.HBACCGFCBCCG..ICEGUFAEDCEA..eHDEhAAA..XDFDhAAAYAHDaBBGLADAhABANICB.ADIDKGHF..PEDFfEAFhACAFGHBWBAD....hABA...,1,-6,-38,32
WMcFIYgDeRQSCHKdbaUOTfLANZPGJXBEV,ZAADJFEFBBHCEEFG..MDIDFDCH.....IBFCDDGCQAAAhAAA.HADHbECFUGAEhAAATFAAACCG...hADANEIC.XGGC.cGDDeEEGCDABaACEOAFGhADAfAHE.hBCA...,1,-17,-27,10
aTZWMJHfYGQUFLPRDOSIbgEXdNeBVcKAC,CFCFZBCF.MAHBHBEGGEAHUGEDFBCDLAAFRGAE.OAED.SHGAhACAbFGF.EGEFhADANCACBFEE.KAAHTGAGhAEA.fBBG.PEGFhAGADEBG......hAIA...,2,-30,-7,23
cDUGFIHBfWdYQaeEAZJXbRVCMPKgNOLTS,JBDGREFHMCDG..KHGAOADELBAF..TDAASFDHhAAADCHFFEDFBDFG.dFAHaBCHhAAAAFFAZDGB..XGDChABACHBB..gCBGNAIE..cGAFhACA....hADA...,2,-38,-32,6
IGBQAZbHEaKeSYcfPRLVTgFCOXdJNMWDU,ZGFGHDAGKEBDSHEG..fAFCPAAFRGAE.LCDAhAAAVAFG.FACCCGFHdDGDJFEAMABFhAEAUDDGBADCABIFaHAA.hAFA.....YDFGgFGB.hAHA......hAIA...,2,-27,-5,22
OJIbYEcRPSgfNXTGeAMHaZUKLdVFDQBWC,aAABKDAFLDCG.FGECBCEF.CEADOHFEJACH...IBGChACAbBFB.EBBCRFABSGGHhAAA.hADA.NGEBGDEDAFFAMCIHZFCFdDCCQGAHhAEA.....hABA...,1,-21,-28,7
bKMGIEfVQJPCYaANcSOdXeBWZHURLDTFg,SHBGdAADeBDCBBHDHADBRCEH.DGEH.FEFAKFHDGBBG.EGGEQGCHhABA.CHAAAIHAhADAcCGF.WFAGhAAALEAE.........hABA......hACA...,1,-27,-36,9
RIFBDZGQbUKMCcYaVLfPWHSAdXETNegJO,XFCETGBC..eACBOCBFFFHBDCEBZBEAGDDF.UFGGhAAAKAFFCEFDaBBALBAFhAAA.fGEDhABAWADEACIFdHBFEAHB..NBAE.JDFAIAHF..hABA......hACA...,1,-15,-19,4
OMWaAcZKLdTGDBQEICPfVXHFbegURSJYN,ZDAGKEEDdACGGADFDHAG.BFFG.ECHHCFGB.....VBACHGEGFHCGhAAAbADH..eEGBUAFChAAASAGE.hABA.NIBBODBDMIEGADFEcEDB...hAIA......hBAA...,1,-10,-34,24
LCfHQFeTAVgOdIGbNXZJUDEaWYBSMcPRK,VFDFdDCDGBBF..XBAAUAGCDHEGEHAE..aFAEBGGBMBADhAAARDBCKCGA.LDADhAAACHDDQEFEFDFHABFE..hABA............hACA......hADA...,1,-25,-34,9
ZcUQgWSRNDaFXbYEMLfGKdAeHOCPBJTIV,OFFCBBBDJEAE..TFBBZDFG..UADCQBEC.SBBHhAAADGBCaAGC.FEAGhABA.XGDHEGGDLHCGhAAAfAGEKDDCAIAA.CHFEIDHA.hABAcDED...hACA...,1,-14,-43,29
fYNJFEReWPKDVQTHOILMZgCASBdbXaGUc,SEHBdEGDaHCA.GAEAUBAG...fBAEJBFBFFAA.eGBEhAAAKGHD.DBIB.QEEBhABAOCCDLAHBhAAAgCBHBAECbEAC.cGGCEFFB.PHAChACA.....hABA...,1,6,-35,41
cbDaPSVQgZABOCMFeENdTJHGRWfYKILXU,BEFAMIAGFFDGECHBdGBCHGDGGCCE.RABA.fCCG.KABAhAAAICAAUAFCDEBHaAFEhAAASCEDQGDDhABAAADECHGH...........hACA......hAEA.TFGGJCHB,1,-16,-20,4
ULHGedJQOaNREFZVMWIgTXKABfcYDCSPb,BFDG..fHBHDGHFCDDD.SFACUCFHHADDdHEDQGADhAAAOCAGRCECFDBEMBCHhABAgEGE.hACAKAEEcGEBPAAE.......hADA......hAFA...,2,-41,-11,30
MKYPZBQIUeWGNbDAXcLOfaCgEHFVRJSdT,XDACLEEGOGBA..fGDCaAEC.CCFFHDFGhAAARCAEJAHDdBAFMGAEKCFFZACGBHHChAAAUGGE.eAHB.hABAWEDG..........hABA......hACA...,1,-14,-37,23
CdSecREKabUAZBVfMYHDQJTNFOLWGgIPX,BEGHVFAC.MIFEHFEGDEDFQAFE.JBBBNCEH..LEEHhAAAGADE..IDFAhAAACDAGdDBESGABhABAeHEGEDHFaDDHABCD..........hABA......hACA...,2,-45,-2,43
KZSUMaFcbJEdfOPVeGYLRINADBCXQTgHW,CAAHTCCBHCCEZDFG.UGFEMGEG.FGBD..JDADEAEH.dEAFOFBChAAAeBGDLEFAhAAA.IBAHDACCBHDDhAFAgAGBSAHFaGHD.....hAGA......hBCA...,2,-38,-5,33
WGARaXBdNZDKCEFVPMQUgHTcOLJfYSbIe,XCCBdEGDZCDGCAEG...EFFHFFEH..VAEGQFAFHDFCOHAEhAAALABH.JAHFSHGEhABA.IDBGhACA.eEABAHIBaDACDIFGKGGB.MIAEhAAATEDG.fGDEhADA.,1,-15,-29,14
KdZeVQWBIcUSMCPfRgOaNLXHDYbTAJEGF,EAEGKDAFeDEG..VFDCBGHHUDBECCFE..RECB.aGAGLACFhAAA.DBGEbBEG.ADAFFGHFhAAAQGFE.IBDFhABAMIBAfACC.OCHFhABAXGACYEEC.hAEA...,1,-10,-39,29
LBRKHPSQDcETZXCJbIgYafMAedOVFNGWU,dGDBODCHFBFH.GADCUGAFLBGBBBGEKHACHFEF..SBCGhAAADDBFEABDZDGFJEBE.hAAA....IBAGhABA...gGGEfFDAAIFANFEBhACAWCAF....hACA...,1,-29,-33,4
KEbYUZdGLHfVeWaBSJQRXAPITCMONcFDg,TCBCOHAGFBAD..DFCAEDEEUGGE.dAEFLEHFHDEDeAAAhAAABFAE.SAGDhAAARBGB.PFCEMFBF.hABANEAD.cGDF..bABB...ZFFF.hAHA......hAIA...,2,-17,-13,4
FeGCWRQDcZLOPgHdKTbVYaMAUNEIfJBXS,EGFCJGEABBABFDAG..GDCERACC.DICELCEB..gAAChAAAKCAD.TAFChADAVDGFMAAE.UFAGhAFAIHAF.XCGD.CHHHWFFChAEAcAGC....hAHA...,1,-20,-42,22
VdZWfTNbARPDCOQXeYIcKEgaGJLHFUSBM,DHCEOEBEeFHF....IGGFEEBEaBCBLFAFHAFESCHHhAAABAACMDEGdHDBfCCFhABATEED.AAHAPACGhBAACBGD.XEEFcGEEKBDA..hACA......hADA...,2,-30,-12,18
YPReJaMOTbBKWZFDgCIXdNLUSAcHGQfEV,HEBHQAGHVEEGRACBeAED..MFIBbEGF.BFADZDBF.DICACAACdFAAhACALAAFAIHA.GAEFhACAEEEGJGDEOHEA.hADA.KBBAFDGA.........hAFA......hAGA...,1,-4,-15,11
OWACRLJbTfHYFENPdQMDUSegZGVXcaKIB,CEFAJFFC....TFDCHCAFECFB.dGBEMDDGUEDAeABHZACHGAGEhAAAXADC.KECEBAFFhABAAEIBLHFA.hAEAfFAD.NBHEDICG...SAGChAAA..hABA...,2,-30,-22,8
HIVTPSZEeMJRXUNGdFBQObDLacfAWgKCY,KHBGHDBH.TACESGHHEHAC.MCEEJBABUGFGdEDCBCBC.QEAHhAAAOEEEDAGGaGFEhABAfFAAAFFD.hACACHHE.IAEA.ZCDAeDFENAIE.bAFC.hADA......hAGA...,2,-23,-3,20
NaPWBHOVdegILZCYSAJEKfXcDQGTbUMRF,JEGHEAFBKBCC....XECDQGFHGAGGTDEAUBDDMAAChAEARAAF.FCHF.aFCDBFAChAAA.HGAA.OADGhACAdGAAeCCAIEECCAHF.AIFADCCFNBBE..hAIA......hBAA...,2,-17,-8,9
QKZeAXWPTUbCVNaGBHDfRcJgdLMSEYFIO,XCBCTCBC.UFAFCFAG....aHGABDGHDDHF.RAEE..JDEHLBBEhAAA.EHAEIHHAhAAAQEEAKABHAGDEhABAbBFA...NABFfFBB..hAGA......hAHA...,2,-44,-27,17
WQBOVcHDFTNXCRdePELAbSJUKMIagYfZG,JCCHKBDHMGCE..aGHH....fHGFZEFCQGBGhAAABCBFOEAFHBDCDEAHTCFFhAAAXGDF.CADGeABFhABAEEHFLHAGABHB......hABA.SAGChACA.IHEA.,1,-19,-25,6
HgPfSBOVITEWDKGUNcQFLMCJXbAYZaRde,ZDAGaEHB.RAAAdDGBHFCE.....fGAEBADBIGBAEACGDCEDhAAAUFDCQAFAhABA.MFIBXAGHhAAAbFFHADCBgBBEOHFE.TEAAWCCEKFGDhABA...NIAF...hAFA...,2,-32,11,43
CeKHWRZIJLPBXOGTMaFUVcYbgDENSdQAf,CAFBeDCHKEDF.HEDFZBGB.LBHFBFBG.OBAGGAACMCDG.aHAChAAAFGDDUFFC..VFFEhAAAbEAB.DDAH...hABAEDDGNIDH...SCDEAFABWACE...hAGA......hAHA...,2,-37,-3,34
HaAbYSUgIefQGKXLPFZMNJDBWEORVTdcC,SHBGUCBCeFAAGEFAKEAALCHDZAEF.MGACDHDGBBHB.hAAAEAAEVCCG.TGFChABAdHADCHHGAEFD..YADAhACA..fADEXGCAFEFBWDDBhACA......hAGA...,1,-9,-32,23
bWKJeLZAVUYNSEgIPFMRBdfaCDQHXOcTG,UFDHSHBGEBHD.....PBADFACBBEFBdFEFCCHGQEADhAAAHCDEOHFGGBDAhABAKDCDLFAAAHHE.hAEA.NIEBIEHCfAEBaHAEDEHB.cABAhAAA.....hAFA...,2,-27,-10,17
OVGCBZegFbLPADUMYHJNITKRQSdafcWXE,MIAGHFDFJBGH..TDEDQABG.SDDCaBFA.hAAA.fGDHhABAXGGGOFBFCCAFBGFHgFAGhACAFDACLFADABDCDEDB.....hAAA......hADA...,2,-31,-19,12
SZAKfeICGBUTJVYMXRLQdNEbFODPcWgaH,eCCHCECDBAEBUGFG..JEFCMBAG.RAECLHAGQCDGEDFCFHAEhAAA..DADA...hABA.PABE..hAGAcDGEaFFHHAGBSFDCACCFfGDGhAIAICAF....hAAA...,2,-35,-28,7
NXWIMAQOFaeSdVULBbZfcJEDPGTYKRCgH,QGGDOEGHFAED.SFAAdBCGLDFEBEFDZEAB..fHAFhAAAECAHDGCH.PBCFhABAGEDEKAFHCAGB.gGDBhACA..NAAF.ICEDAHHF.eAHFhADA.....hAIA...,1,-11,-27,16
EHgbeCIQcBZaSTVWJNLDFXPOUMGYfdKRA,ECFCHAAD.eGEACEFF.QDGHZAAB.aADCVGAE...NCDA.hAAADEAH.FAHFOEGFhADAMIDCfEEEhAAAKAEC.AECAIGCC.BHHGWCEFLCCEhACAPHDC....hAEA...,2,-33,-10,23
GNRCWYIHPKcEVSBUbAdDQOZgJaXfeLTMF,QCBFOFBBZCCF.aAFHeAAF.LEGDFEAHGECARAEF.CACG.ICHAhAAAKEFHEHGABCHDhAAAACBFdEEADFID...XGCDhACAfEHG.......hADA......hAEA...,2,-25,-20,5
dFHNYBPJQRVLTZbMXCIaUOGAgefEKcDSW,eGEAEAFBDFFBdCAB.FEEFHCDBBEBDQBBH.RCFALGAAhAAATBGGMBBGCHFAUDAFAEGFKFAFhAAA...SECBhABANEIC..PEGFZAEBXGBDaACA.hABAOHFE...hAGA...,2,-15,-7,8
LNHPJcBTdgbaZXQVeSDKYUfARICWOFMEG,CFDDFDCDGGEFHAGDJAAFBAFE..dCCF..aBAAQEGH.hAAASGAHDBFFKADHfBGHhABAAGCDRFDB.ICAChACAMBFFEEAHNFEH......PHAAhADA.....hABA...,2,-34,-23,11
VfceKMCHSJTXBFADNIGRaLPbWUgZYEQOd,DACBGAFELCHD..bADFUDBGZFEFEBAEdGFF....fHABhAAAKDBHCCAGJHBEBHHEhAAAAFABRBEF....aADFgEGAhABAOGBA........hACA......hAHA...,2,-33,-24,9
fGHgLWZNQXAFaEVYUbJMCROcDKPeTISBd,EDABUFDH.MAIHCBHHRDCC...OFBHDEGFKHGA..eABH.TAEGhAAABHEBdBCF.HFBAhAAALHEAZAFF.NDDHAADF.hABAaECA...........hACA......hADA...,2,-38,-22,16
ZKIEYeAHMbQTXSfOBUaWFRPVgDNcJLCGd,HFACQFDBSBFAOGAEUDFH.FEAGPDAGDDDH..JAAFhABALBCCdCCFZGFAKGDHhACAEDEG..ABBFTAGFhAAABAHBaADEWHFA.........hADA......hAEA...,1,-16,-18,2
bDcTXCRUHLKgMYPGNFVBWEJdIfQAaOeSZ,OFFBeDCHZGDGDDEC..TBAECHBG.HCECLDHFKAGA.MCDDhAAAPADAFAGB..BEAAhABAEEEGdCHAQACDhACAAHIDaHFE...SFCG....hAEA......hAFA...,2,-38,-9,29
edNfKSPMIJaOCHTGZVRFYXLbgWQcEBADU,DECDUGGDdBFDKFAC..SHGAMAAB..aAEDCEACHDEG.ZBBAhAAAFFDALAHB.hABA.WHCAEADABFHEhABAAAEFeDEEPFFB.OFDFTBBD.VAGBhACAXGBCQGABhADA...,1,-9,-30,21
KRYSPDfgTcQdUAGZXaONEVMCbIeWLBHFJ,ZCDFXGGDaBAH..EDHBCHBC....IDECeGBEBBHB.FHFEhAAARBCCSFFDhAAADBFH.fABChABAcDAD.QBGCABCD.NDAEMEIB.bFBAhADALGFCKDBD.PHAEhABA.,2,-34,-6,28
aKMGHNbLDTOSVEZPFIWBQdYgXCcRfJAeU,UAADMIAGGBEHHECHLHCAOCBEEAACFGGEBADC.dAGDXEBChAAACDCC.REEEAGEBKEEEDIGEhADA..SEBDhABA.VBDEIAEA.WGAA..hAGA......hAHA...,1,-20,-25,5
BVIDUfFASHCZPgNRMbcKaGdQWLXeTYJOE,CCAHZAAD.....PFCBgEDG.RDGB.bDDGKAGB.dABHQAEEhAAALCDGXFADhAAAeEADJFFEBHDAhADADAIHUGGFAAIB...NCCA..aAFBWCEG..hAEA......hAHA...,1,-15,-26,11
fVZGUaDHXETRCNcLYWOdPSegFJKABQIMb,QGGGMCCA..VCFGUBCDHGFEXDGHEAADREDF..CAEGLDAChABAOEEDdHBB.eFAFhAAAJFABAFIDIBAEhABA.bAFEfHBFZDAEDCFENADF.....hACA......hBDA...,1,-4,-11,7
faBOSCgFNcMbEDeIAdKTWQYZVGPRUXHJL,KFAATCGCQEFH.ZACDPADB.UEEHJCABLHCGhAAABHBFSAFDFCFAMCEHhABADBGEAIHA.dCAH.WFDDhAAA.....YEHB...hACA......hAFA...,2,-34,-25,9
UIRZgGCbSTQBMAfPKaYHWNdeXDLJOVFEc,KHBGaCFCHFBBdECADDBGLBBD..OEEFEEECUAGFRAEC..ZBAGhAAACFABTCCGBEHBAHAE..hAAA.fADBhABA.YHECWEGDeCFCXEGE..hACAFEAH.....hAFA...,2,-39,-9,30
SJgbZPDfUacCTGOHVeMIFKNRdYWQXBLAE,EEEDJCCHZEECDADG..UBAG..CCGAGGEBHGACMDGBFAAB..KADF.hAAA.dHEB..QGBGhACABFCE...hABA............hACA......hAGA.SBFEgBEH,1,-35,-40,5
DNHbCJVYIXdfOTgBQRPSEGaKAcUMFeZLW,MFFFFDBDeDGDLCAHDCGE.HEBB.CHHB.JADE..VAGF.XEGHhAAAdFDFfHEHhAAAOAEFBEDHQGBChABASCCGaACBAGID.cGAC....hABA......hACA...,1,-18,-32,14
SHTFCWeMQLARbYVKPJgNOUZEfdXIGDcaB,RAADVAADKHGE....JCGHOFCA.EBEGdHCFGGAFDEAFBBHCSGFChAAA.FDGDCFBH.hAAAeDCALCEHAIFAPDABhACA...NBIC.fCDE.IADEhACA...hADA...,2,-52,-14,38
dQPARTceMaGXZgDWOYbBJCUKHEVLISNfF,TFDHMDEBGBED.ZDFGDAHH.OBCBBDAFUFGFEHGELBABhAAASAACFGAAPDDGhABAABBARFAE..aDCBWADEhACA....YHBGJDHFCECA....hADA......hAEA...,1,-13,-27,14
YHdTOCaDZSLbXWBEMeQgRAVFKJUIcfNGP,VFEEFEEDUDAD....IHBA..NBDCGBGGHACGdABGhAAACGCFZGFESGAChADA.bAFDBBFEMAIHgABFhAAAAEFE.KFABcDCF.YEHHhAFA....hAHA...,1,-20,-35,15
GADJCdYaRVSMFPLcEXWfUZBNOIKQgTbeH,CGHDdAFBRGDA.MEDALBFC..XEACUGAGZCBDBFGD.IADAhAAAQDGB.TDDEhAAAeFDBACCF.DIFAJABEhABAaCGG.FCAF.EDHB...fGBChABA.....hAFA...,2,-28,-20,8
eaEUYGVHdILANZSOPBMWRXKDJQfcgTCbF,ZDAGOCCHMFCARAEC.DDIF..QCGD..fABDhAAATFAHFHEEeBGHaABEEFGChAAAGGCFdHADAABASBBDhADABHHHXFDGKGAC.gDDBCBFAYGFChAEA......hAFA...,2,-25,0,25
OeCAIHZgGMJSKYDQFRLTXcWUNVEPabBfd,HGFGZEBHMIAGKCBADBFDREEA.LFAB..TBGCXDGC.hAAAUEDCEACAaDDBBAHCfGGDhABAdHCDeABGCCGBABFAIFADhACA.JHECSDAG.hAFA......hAGA...,1,-18,-22,4
NdOZIDMAVfSCQBacgFEKUGLYXWJebPRTH,VDAGCFEDBECA....aFGEFDHF.EBEBUFDCLACC..XAAChABAJFFC.eCHHhACARGAA.HADEOBGBDAHDAHIHhADAQCCD.KAAF.....hAFA......hAGA.WHDA.,1,-20,-32,12
ZTFKJCSQgaGMcHLXPWIDOEefABUbNVdRY,UGGGVAAD.RAFHZBBD..KDCC.CFBE.QDEC.GECEhAAAMAHFLEAF.hABAPFGHDCHBEADGeFEFhAAABGFDdADCFHAA..SGCH.aCEDhACA......hAFA...,1,-20,-30,10
KgSPTXbdAJBaNWDROCMLVfUFIEZYeGHcQ,aDABDACBCDDFLBGD.UECBFCHHECFD.ZFEDeCCC.HFAFKHAE.hAAASGGE.hABAPACAbDBDdADBABACNICH.hAGA............hAHA......hAIA...,1,-13,-44,31
CMcILDYZBFUNXSWKEdTGHAPRQJefOVgba,QFDHJEEG.ODDAVACG...aGBBMAAFLBADDGIDBFCAhABAUAGA.SBCGhAAAEAGCGGDBAGGFPEHFhABAeFAB...........hACA.fDDHhAFA.CCHA..,1,-17,-38,21
DabSdJNQBHVMUYAGEgPZROKXTILcCfWeF,EGAHZAADOHAGKCCC....XCFBIEHFCFEC.eDFHFFGDDIEGhAAASFBA.NBEC.hAAABACFHAFEUEAFAEADPCCBhADALEDD.fADFaGGA.dBAEhABA......hAGA...,2,-32,-8,24
UELWVCfPaFDRbcSTMQAXgBeJHIYdGZKON,BHHGHFBGdAFCZABDODCEEGGFLEFE.CDEC.aGCEDDCD..RAFD.SBCBhAAAMFAD.ABABeAHFhABAIFGGKCAB..hAAANEAE............hABA.WHBG.fADFhAHA,2,-44,-27,17
gfNQKUaBYAPEXIRMWVcTCOHLDGdFbZeSJ,XGBCRFACMBAE....VAEFCFGDOHCEDEAC.FACHZFGF..JDFEhAAA..NEFG.KDDCBCCAhAAAAAFGEDAH...IHHEhABAWAHF...HECA.LBFEhADA......hAEA...,1,-23,-40,17
VAgdYKHZBSCEITNaQPWMXbFJcLRefDGUO,dHBHKCFCZEGHCDAA..EBBC..IACB..TEDCQEDGhAAAMGFGFCDAJEAB.LHEGhAAARBAEDAEB.UAGFAIACHGBAhABASDGEaGGH.......hAFA......hAGA...,2,-27,-23,4
DTVASEIeWKaCYQgLUFZXBPdJfcbNORMGH,SAFBeCCHKEFA.CEGE.QBEALCACZFDBBBAAdFCC.JAAEbGAAhAAA..RGFA.HBGDDBFFAFGBhAAAEADA...IGHHhABA.aDABYAHF.FEAG..hAEA......hAIA...,2,-27,-12,15
TRegbXdBKaWFLcNSOIPVJGEHZfUDQMACY,TGGGRFDFeDAD....XGFHdGDEaCABLCDE.SBHDhAAAODDCIHBHhAAAPFEAGDACEACGfBCEhABADIAEMABAYAGHBAGCWEDCFFHBNAIE.hAFA......hAIA...,2,-14,-12,2
BKWcbJaTLdYVFANfMXGODRZePEHUIgCQS,MCCAXDACDBBBZEDG..eDDFHDBAICBFCFHGBAGC..KBGGbEFBhAAA....TFAEhAAAYFBBAHHE.NBBDOEHDhABAEADCQGDE......hABA......hACA...,2,-29,-18,11
GWbfPKBaSXTcVMdDRHOgLZFQUAYeCEJIN,eAFBJCAFGGCH..fEAGKAACBFGH.XCCF.VEDEhAAAMDCG.DBIBOABChABALCFHQGGEhADAAAHCEAGB.WHCG.aDHDcEBDdAHE...hAEA......hAGA...,1,-9,-40,31
AZUCGdBSYDFeOMHEbLQRcKIPTgVNJafWX,UADCCFFCBBHBDFBG..FAEHOHEGHDFCLDAH..QAAChACARCCHKHAA.PCHHhAGAVGCA...aFGEXABBhAAAABHEdDEH..SFDAMAFEEGGG.IHAGhAHA...hBAA...,2,-31,-23,8
SdXFGNUfEPZgKWJbHYacLOCARVMDIQTeB,MGCEDAFBQGDDBEEBdBDDGBFCUGAG..ECACZBBH.KBHHJDDGHDABhAAA..aEFE.LAAEhAEAAFHGIGHASECGhAGA.........hABA.FHEAPAHF.hACAgGGGYHAC,1,-17,-19,2
IRKAdLbXMcVaeUEPJBOHfWgNTCFGSDQZY,LCCHMFFF.aDABEFBBBHACHCDE...gEGGTCEEFFHFhAAAGAEFDGCAZAGHIHHChAAAKABAAEHG.XCAChABAVGEE.eFAD........hACA......hADA...,2,-26,-10,16
LVNedEgHfaKFCRZcGSPYUDXABMbJQWITO,BBFDJCHD.QEED..IDEHLDACeEFFEBCCfHBDhAAAaDADKABE.CEHG.hABARFAAGADBSDGChACAPCCDDAHDAFDH.MFAB......hADA......hAEA...,1,-28,-29,1
JFQBfDWcGRPEaVSUYOeLCgZXdAHbITNMK,HAADTCBCKEFG.JGCCBFDG.DGABGAEFRBED.aADGSCAFhAAA.UGGHeCCGCHDGZBGFhABAdHGHAECH.IHADhAAAMFFHFFAAfCHE..PABEhAEA......hAFA...,1,-15,-21,6
WLeBFbNHJfaYGgZVcEDOCATMKQdXRPSUI,MBDHQFCEREEG.SGFBUBGC.LCCABHEFFGHDbFAFHFBAhAAA.JBED..YBAFhAAAGBAE.VAGBhABADAECCHAGAHFDKEGA.PBCA.....hABA......hACA...,2,-26,-1,25
TYSIEbUCWMcPLKdZJNDQGBFXfHegORAVa,TCCBSHBG.EACGCGEG..MEADLEFBKEBBZACADECG.QBAAhAAABHGFFDFCHAABhAAAOFAEABHG.aDFA.IEAGhABAWFFG.dAHEJHAENCCFfHGF.hADA......hAEA...,2,-27,-6,21
GQSNRMVYfTAIPJaKBFXgWUdLeZObcHECD,JGEAaEHBBECA..FHAC..XAFAUCDGLAECeDABZCCAOCGHhAAA..cGEGhAAAHBABDIEA.QFBEhABA.NDIA.MIFA.YBBChABAAACC.IGCC.hAIAKGAD..,2,-29,-23,6
SKXadDBILONceFRbCQZHPfMTYUVgWEAGJ,JCDGKFAAdHADBEBELBAF..OFAHeBDAFDHBREFB..CHCHZAAFhACAHCBE.MFFDUBGE.hAAA.gCFFhABAAIFA.SHGEDFEBIAEENEEE....hADA......hAGA...,2,-48,-9,39
fKePaUbNHMgXIFSCQdLOWBZYDJTEcGARV,RGFGVDAGeBEB..UFFEHGAA.MIDA..IGACCEHCLEDAhAAABCACDBBCEFDEACDDKEAFaABG.hAAA....NADHXCAFhABAFAFCdDGB..WHCG...JCCC.hACA......hAIA...,1,-18,-25,7
dLDVJfMPKBZgGUaNYIbXCOAHQFeWRETcS,FDAFeFBBEEDG..SGFEDDFE.JDDAMAIFBBEGZGFC.UEGAhAAAaBAH....IEHDhAAAbABC..CGADOFCDhACAAAHEHDACQGDC.RAFDdBBFfAFFhADA...hABA...,2,-28,-18,10
NTXLFJOgSUaCQZDBYRfVPGIAceKMWdbEH,KDCDMHFGdABDHCCC..TFEAXEGHFCGC.OBFA.UFCBhAAACAHEQAECZBAEDGADBABChADARGAE....fEFDhAAA.PCAFACIFWEAEEEDFNIEF.LHEAhACA...hAEA...,1,-12,-22,10
DUSIGdTEWPgebNRcHBFXVLfCYZKaOQJAM,UGEDGEAHdCEGEGGA.....PAHBeABARDGHHBDEBEBHXCBChAAALDCBCEHEKFEH.hAAAaGBHJAFCAADG..MDGHhABADFIH............hACA......hAFA...,2,-43,-11,32
gQGIAYOCdDbJfULPaNXTEceZBMVWHFRSK,OAFBCFEADAHH...JDCBLDAH.aCGETFFH.eEFEhAAAMEDGHBABFGHBRGAAgGDEhABAGABH.IAHGhACAdAFA..bCCCfCHG.PEABhADAEHEABBAD..hAAA...,1,-10,-23,13
LZCGQOKJXfadUMeDcFTgWVRHEbINSAPYB,BFDGLFCAGDEAOHBEJFAD...XDEEaCCF..UBEFhAAAeDACDABBFEHH.gADHhAAA.VAGBhABAEDHFIGGB.NIBHAHDA.....hACA......hADA...,2,-38,-24,14
aAVZOcHdGeDbRPFCWfgTMSJQKXLEYINBU,VDBGZFDFOCBH.dBGHDGAB.RGEA.FADECEGA.......fGFFhAAAgAFBSDGChABAQABGXDDAhACAEBDA.IHBCBGDCAADC....hADA......hAGA...,1,-35,-39,4
gcWPHSEUeKfGITaCJXVQLYFDMAdRbNBZO,dCFCRAADBFEHOCAF......gECHPDDBHGFGEDBF.hAAAUGAEKCHH.GAAFhAAAaAGC.CCHHJAFA..QADEhACAFGDDDDCFAFGG.NHEB....WHAG.hABAfCFF.hADA...,1,-13,-30,17
AbKHUVfCcYSeMIRJXEaPGdZONLBgQTDFW,KCFCUBBHCEEG...SEFGeFBH.MDEGRBCBEFHB..GGEHhAAAOGECBBED.QGBEhABADEAFABFAHBABcAGChACAIAHF.aEGAZDAA....NAAF..hADA......hAEA...,2,-26,-24,2
HeWJFNCXcdSYBKDIMbTQPfOARaZUgGEVL,aDAFUFDHGECEEBHDLAFHHEEA..eAFGFEAD.XCEAdGHGSAABhACAKCHHMFIH.TAAFhAAA..fACHhAHAAGGBZACB.WECCCHEABHAADDCG....hACA......hAHA...,1,1,-30,31
ZVUDEMTYbXFgRHJIfKeNAQadCOWBcPGSL,aFHBOCAFBHCDGGCHLEAEUCDF.MIFE..TAAB.hAAAXFDDgCGChABARBFCHFADJFFCKAFBAGGDCCDE.PACAhAHASACE.DDBE.EDGF...hAIA......hBAA...,1,-10,-20,10
ZYWRQPbfLHGTDaNOXgCKAeVcdFMEUSIBJ,eFBBVDAG.FAAB.UFDBBEFE.ZAFFRBEA.QBCF..fGHAhACALBHBHFFChAAADIEEODABCFDHAHIB.dBCEhADAMABEEEHH.IHAD.JHCEWEEC.hAHA......hAIA...,2,-22,-16,6
LQKFdAVCUTBMPfOIRSaWcJGZgNHbeDYEX,CADCBCAH.MEDGOGEARGCE...aEDBJAAEGAGEZAFG.HBCCDDFE.hAAAXFAGKEGA.ACAA.hAAAUEAC....hAEA.fCCHIABCSFHBhAFA..cGGHNIBD.hAGA...,1,-28,-39,11
gLOXNUVaMBJfdPZTIWeYSGcRFECHDAbQK,KGFCLEEGOHECXAAF..NDAF.UGAH.MIFAJBEAdEAHhAAA.ZEEETADE.hABAICFGeACCSCGAhACAcDAF.FGAC.......hADA......hAFA.CGHGAHDB.,1,-29,-32,3
WcNRbfKFSeTgBDJVaLdOCGEIYUZHMAQPX,QCGCXCBC.....NBBERDEBKFBDFAGC.....eDDDhAAABAEGDGGCJCEBaHFALDGDhAAAdAEC.CEHCEAGBhABAIACAZGCEAIFAcACCSFBH...hADA......hAFA...,1,-20,-39,19
fdYLOJNcBXQKVMeHIDFERPAWaZGbCTUgS,aCFCZEBHCEEE..UEAC..SFAFdHEFOEDGJHEABAFG.KFFGhAAAVAAD..MCBEhABAeEGBDAIBEADD.ACDH..hACA....WDEE......hAAA......hACA...,2,-46,-41,5
dZDUBYSGVNOWMbPXRFJIHQKCLgeTfAaEc,aAFBEAFBZACDBEGEGCGC..ODEFMIAG..XFEGRBBDJAHHHECDhAAACCABLEBF.hABAeEDEAHHFDAED.SCADhACA.NIAH........hAAA......hABA...,2,-30,-21,9
EeFUAZDGaCYXdWfVRLBNSKbgTPHJQOMcI,DCHDaBCG.CCCE.dBGG....VGFABHFG.SGAAKFBD.TDDGhAAAHACGJAFC.QEDEhAAAMADEEFFBeDHFhABAAICCZCFF.GCAA..XCADWFCB.hACA......hAHA...,2,-28,-23,5
edEGcBWNQHKTZPgARDJOLYMIXbCSafVFU,DAGDLAABMBAE.XAEE..SEACVCDH.FHBGdGEEhACAEDDFBACA.QCGHhAEATFFAZBCEAFCG.RCFA.hAAAOHAAICAFCHGF.aFAE.....hAFA......hAHA...,1,-23,-26,3
ACWSYHZVfbXGEDOIcaJBdgMTPLKRNeUQF,SEGDHGFGVDBG...XFBBDCBEOBFCaBEA.BFAF.dDGBhAAAMCAELFEDRFDF.hAAAeACG.QGAEhABACDEGYABE.fBHG.EHFA.hAEAJFAF.....hAFA...,2,-18,-13,5
gDCbQBHcdWeGJEXYRIFfTKPLOVUNAMaSZ,SHBGDHCEQEFABFEAdBDCGDCB.EBBBXDAF.hAAAIHHETAEALGDGhABAOAGDUAACAIFEaEADhACACFCF.bCGB..WAFD.eFEB...hADA......hAEA...,1,-18,-21,3
SAQeLaWUFIRcfHOEGTXZJCMYbPNKVdBDg,QFCAaAAB.FAEGIDCCRCFG.HADCECDFGBAGZEGDJGAECHCAhACAMAAE..PFEHhADAVFFEBBHH.SHAGhAHAAFFCeBBG........hAIA......hBAA...,1,-16,-22,6
KPWFXVMbaZLdJBHECIQeDcROGNTfYAUSg,SGFCKHBGFEGD.MIFEZCDCLBEG.BDABEHCEQDAChAAADEEB.cBGFhABAOHDGGECH.hAAAfCGGAAIFgFAAPBBC.WAEChACAXABFaDDG...hADA...,1,-20,-42,22
KFWQNAOeGSDfYRZUagEXbBJMPCTLdHIcV,GGCBSHFGDFBBRCFAUEEH..EAECBCHEMADFCBFDLBBAhAAA.dAGFHFGD.IAHGhAAAKEACFEHF.NACAAABFfFAEhABAaEDG........hACA......hADA...,1,-18,-37,19
FVIYKJWAPUBXDGMRTdNcSgOLHQaeCZbfE,BHHGGACBMEGDdDHCSGDFLAFCQDBGCCFG.ZBEEEEFBhAAAFACGVCAH.KAHBAFHAUGDGhAAADIEC...TGBChABAcGAD.OGEC.aDDF...hBAA......hBBA...,2,-25,-13,12
EagRLdDBAXOfJNMFCGKVcHQZbYTIPeUSW,XDACOEEG..JHCEMDFHGACB.KCFGHFAH.ZACATBAChAAAeDDBSDHFhAAA.EGHHRFAADGGBAHCBNDGCCBAChABAcDCC...YAFC..hABA......hACA...,1,-9,-32,23
NQWaFDXAVSbHOgYGPdKLfeCUIBcJEMTZR,VDAGSCFC.OCBFGFBB.KAHFLBBECEEHBHGG.EGAHZADGhAAAREDCQGGEhAAAFEHB.DABEAADE...gAGEhAEAdBAFeFAD.IHEA.cDGFhAFA.....hABA...,2,-30,-8,22
IDBQedELSZJXURKCfAGbNFYagTPcVOWHM,GAFEFHBG.aDCDTAAD..VFDAOEBCHAABDFADBAEHeCDGhAAALBHBZBGD.UEAAhAAACBEEAIFG.NIAF..PHFEhACAMHFAdFGB.ECCBSCDB..hADA......hAEA...,1,-3,-25,22
aHGcPXLgNIARJQDWCSeBMVUZFYOTbfKEd,JBDGQAFB.DDFCCGDHBHBAUFCCFCBE..OEAG..hAAAfEGAEGFDdDGFHEFChABAGEAE.cFGEhAAALACD..IABEAHHDWAFE.MIEGhADA......hAEA...,2,-36,-31,5
aQLbeScDWPAJCHXUFBZGONTRYgfdVEIMK,JFCACFFCHAEC.FHEABHDDGBCGOFHH..TAACRBAG...hAAA.fBFEhABAEGGEMEEGKEABLEAFeFCBDAIDhAAAAIACZADB...NCIE.dHAFaGFD...SBGBhACA..hADA...,2,-32,-5,27
ZeTSGKNfDaVPFdRAEBLbCOcWXJIHUQYMg,LCAFCAFB.OCCEXACGHGDCUDFEQDFE.MEBAhAAAZEAFSCDFhAAAKFCEDAIHaGAAFHACAFIFEHEGBGGBhABAbFCF....cBAC...IHHEhABA...eAHBhADAGABH.,1,-1,-20,19
XYAHdGLWQJKEUbfZORScVeBPCDNTgMIFa,dBBDLFEFJFDD.EGBAUCFCZABA..RDAC...SDDFeCCGCFGBDDIHhAAA....TFGDhAAAMAFGaBGFAHBFHDAF.hACA....WACE.KAGAfGHAhADA..cGFChABABDFA...,2,-42,-18,24
IgDAfBZHJEYcadXPNUKCQOeTWLFbGRMSV,ZDBHHDEDEADEaHGE.dDBH..XAAFUGBEQAFDOFEAeFHHhAFALDHFFGAC.bEAGMDFAhAGA.SEDChAHAVAAE.IHEAAAIDBADB.YBEG.hAAA......hAFA...,2,-8,-6,2
QNfSMabGFKdEOPcJCRDHeBLWAZYUIVXTg,UFDHXFDHQCDH..SDFFMCGHGBAEdHGFOAGDhAAAJACADIFA.BEAFLAHFhAAAABAGIGAH.hABATBDDNEICaGBB.........hAFA......hAGA...,1,-18,-35,17
WgZGEaBUQdfHcRLYeNMCPDJVFSKIXTAbO,OGEAZAADaDFD.BAFEdCDGHFCELDCA.eBGFMAFH.CCHHDEBHVFBHhAAA..FFHHKDAB.TABDhABAAAAF..gAGChADA.EHEAQADC.fHDFhAHA..hAIA...,2,-29,-22,7
JdQabGeRLgSBXCVMcNOTIUWEfZDFPAYHK,HDAGKEEDdAAFQGEFGACELBHBSBGBCEAD.MCAG.OFDAhAAATCECIHABhABAEFGBDAGG.PADGAHCHaHDC.hAEAeDHFBFBAcGCC..WFHHFDDA..hAFA......hBBA...,1,14,-27,41
RcNZPXTUEHgVQGeFAOWYaJfMDCSBbKLId,OGEAaHBG..JACGMEFE.DDCGBHHGKGCG.LCEF.dEHChAAANFBDZAAG..PAGHhABAUBGAHBDC.QGAAhAAAFDCHAGEE.WFHBCCAC...SEAChABA...hACA...,1,-16,-44,28
WMbCYOXdPFHILKJgfQBNSVRATaGUZDceE,aCBBUCCFZGAGeBAC..MCFGCHEF..OHFCdAEFHFGBLCHDhAAAKAAGJDCCQAFChABABECG.VFBGAFBHDDABEGGE.hAAA....YEAD...FEFBhACAIHEB..hACA...,2,-37,-3,34
YWDLBaeNJOAgbETXHVPdRfIUFGZMKCSQc,EHBGXCCBHAFBdGEARAFC.UACGFGDD.ZEFCCCAD...SFDFhAAAQDFH...cGFAhAAADABBBFBE...hABA.aEAH.eCEFNAIEADDAgGGE.hACA......hADA...,1,-18,-28,10
dGJYMROEHXTDIWKegcUBLCSNFaZPAfVQb,QFDHGEAHJAAC.RCGBHACGDDEG.KGAHeFFDUCAFLGBA.hAAACHHG.FHGAZAGHAGCHbDDCMCDChADA..EAGC...hAEA............hAFA......hAIA...,1,-14,-32,18
TAKUcZJaPLQIDYeXMRSCFbVfGWdENOgBH,UGBCZFDFJDCCLFEA.DBFFXCGE.RAEC.CBAAFDBG..hAAAVEAD..fBHAhABAdFGCECAH.OHEAhACABABGAHAHKDFAaGCDIADFMACE....hAFA.SCCEhAGA...,2,-44,-21,23
CSZeOQcXWIVAPGHFYgDfNdTLJUMKbERaB,GEDHHDAGFGAADCGEdEGFLADAMDDC.EBACBBDFZEAD.eHCA.QAADhAAAXFCGIDDGhAAAAAHC.PHEChABAfGGB.TAFCKGGC.aEEFCDHFSCDEhACA..hAEA...,2,-19,-12,7
UAWebRVBcCEXgPGSILHONJKdYDfMTFZaQ,eGEARGFGBCBACEAG...EAFF..XDBEGEAESFFChAAALGAENBIC.dDGB.DABCMABGhAAATDCCZADGaEED.AHIB.hAFAbFDD..gCFEPADD.IHBHhAHA.....hAFA...,1,-8,-22,14
UXfCJRaEGLDWIdVPZQOHbgTYNSFBecMKA,UCGCCHHGRBBA.EFGGDEHF..dAAEZDDGHFAD...TEDA.SDBChACAeAEEMHDCKADFhAEAAFCBXBFC.hAFAaAABWGDA..PHAC...ODABhACA....hADA...,1,-19,-39,20
TYIVdZHKeRMAQXJfWBbGUDCLgEPFcNaOS,QDCHXDAC.JEABBBBC.UBGADAAALDFDEACG.FEHBhADAaFEAOHDG.SBBAhAEAIFBGdDDFhAAAKBHFeAEAAHIDbGEGCHAF........hABA......hAEA...,1,-22,-32,10
McOKfWCZJNGFYBeaUXAHDbgTdIREPVLSQ,DHCETCBCdCFHRABA..EAADLFFF...SECBhAAAcACCOCGHKAHB.fDEAhABAZCAFGEGABFHAhADAaGAHAEEAgFBC.ICHH.hABAPFFBMAEECCDAFAGE.hACA...,2,-21,-8,13
BebPDGgYOKWMSLATfQRZEIHaVNFJCdXUc,TCGCREFHZCEBHGAA..VFFAJAAH..CAGA.UGADBECEeCAE.DIFAhAAA.GADHOADHKCEDhABASHGAABBAEDAEaFEH.hACAFDGA...XEAC....hABA......hACA...,1,-6,-32,26
fgcDJYQZGRUOePBFXaHCVNIMSdEbAKLTW,KGDDLDAC.TFAFfAGD.DBBAJFEDZCAAUGGE.eFCHhAAAFFAFHEEG.NAEC.hAAAMAIFdHGB.ACFFcCFDhABAQCGA..OABEBFCC.CAFA...hACA......hAEA...,1,-20,-24,4
TPQKadMVCZeJObSHFGEfRcXgNDULBWYAI,TCBCKGFCdCAE..CHCC.JFCH..OABCHBFFEGFC.RADB..XAAFhADANCEH..UDGBhAAABEHFAFEA.IHHGhAFAQCCG.aAFCMEEDeHFA.....hAGA.SAHFhBAAfGAG..,1,-19,-32,13
FJIdVaCbHWKYLMOTPXQefDANRUBcZgGES,UFDHZDBHGGEHFCDF.JACCdCGH...aGADCBHAHDDA.KAFCLAEAhAAA.MDAHPDHFhAAAeHFCACBG.BHCDEHBE.hABASABH.IDBF..hABA......hADA...,2,-35,-26,9
UcGWSNEOFIZQCYVXBePLJMHfKDdRagbAT,TCGCUFGHGEBF..SEBCEAGAOHCAFHFGZCBEQGAChAAACBCB.VADGBAEGhAAALFDEJCGFMBAFKCAAhABADFAH...........hACA.aEHDACIH.cCCAhADA...,1,-18,-25,7
THBWLSbQICfeYXPcDUdFJMgOZAGVaRKEN,VCCHaEHB..KGADEACCHCDA.LHDEQFBCCFEE..eFBBhAAAPFGBUBABdBGH.JFEBhAAAMEAGOBBBAAFENBDBBFCBhABASGAD.IDHF.fAEFhABA...hACA...,1,-9,-21,12
CYIZTGMaHPJUDfAVEFgQcbeSBLKdXNRWO,VFEEEAFBFABD..QDACeGDABGHFdCDERBDB...CAEAZGBAMIDAHAAEhAAAUDBFAAHF....hAAAgDGBSAHDhABAKFCCXDGC.NEAG......hACA......hADA...,2,-19,-19,0
TDdUgAYIFWRBMOPGaVXEHeQSJbcCfKNLZ,FHBGBFDDOBDHGBBB.aFGDEAAB..eHCGJCFH...CAECKCAFLAHDhABADAHF.UDAFAIHA.hAAA..IEHChACARDEGMAGF.XFFCSFBFfFAANAIE.hABA......hACA...,1,-25,-29,4
CgLHdOVGfYAZKBXTbNaeSFERcWQJDIMUP,BCAHXCGC..TDEFaGBA.FDCHRAADQEEDDAAB.MAFChAAACCGEHFGDdCDAOHFEhACAfEACAIBE.KGDE.hADAeHAESEAG.EDBAcAEEIFHEhAEA.....hABA...,2,-41,-3,38
FfUeMOgGPRScNJYCXbDEBIdAaZKVHQLTW,aEHBKDAFQGACLGBCFEBGUCCA..OAECGGEHRACD.SACEhAAAJAAF.CBFCDDFDhABABCHAABBC.HFFB.WHAGhABAMDIB..........hAFA......hAGA...,1,-24,-32,8
ecQXPACNMZOHaGDBFTdKWYLgIEVUfSRJb,CBFDMECGZDDFHAACDCABBBBGdFHG..KGBALFBG.EGFAUDAA.hAAASDFAJCDA.hABA.eCHFQAGAhAAAAEIDaAFFFHCA..YFFBIHAE...hABA......hADA...,2,-29,-29,0
PEDBTZQgeUWJSHIVXLGaOfYCdRFMNbKAc,EHBGDEFABGBHZDBD..eCCEUAFE..SFFFHCAC.IDHFhAAAXGDA.aAAHOADEhABA.CHGAdAHGFEACMFDGhABANDAG.ADIH.cGDCTGGF....hACA......hADA...,1,-17,-38,21
HBaADOGZXPNcdMQSeRLKgIECFWbVfYUJT,DCIHOEGHZEFD...XECB..PCDEdCABQCGFhAAAeHBALFBAKBGCEHAEFADBhAAA..bABAfAGEhABAJFEBBHHGAFAENACEMFIH.SHAChAFA......hAHA...,2,-27,-16,11
ZDPObeNKgfQTJRSIaFULdWcVCGYMBXAEH,HBCFDHCEOBGHeHDEKBEC.QGABRGFE.aDAHUBAF.LEAGhAAAdFGAVAAFCBHBMFFEhABAAGDCZECA...NIAF.fBGChAAA..TBDH...hACA......hADA...,1,-6,-34,28
NJXDGSKPFOCTfAVHabEMZLQdgWBRYeIUc,HDDFaAFB.MHEAQFEEdBHCBEBFRECHeBAF.UBGCNICB.DGIDKCAAhAAAFDBFCCFE..AHIBEGBGLHEAhAAA..gACFhABAIHAEcCCA.....hACA......hAFA...,2,-32,-11,21
JHAOgGeLWPXYSFBbEUcMfTRNZaVCdQIDK,GECFeEEGLEAB..XCAEFBAHBEHEEEABUFCCMAIFRCCAZAFAhAAA...CGGEQGEChABAKHBGHGEGAEIHOACFhAAA..........hABA......hACA...,2,-27,-21,6
IXaLbeNWPASQKJFMCdVgfUROcYDBEGHTZ,QFCEKEEDFAED.CBBF.dDAG...VAGBgGAE.UADAhAAAODGBDGFAGDDBhABATCCF.XBFFhACALFHDeHFA.NBIGADDAMIDE.fAAChAAA.cGABBDBC.hAGA...,1,-13,-28,15
AEJaTSZQdWgMfcKVPGDHIRNCXUYOLbFBe,EEEDaAADZBEEdAAD..MADCKGHHGEBH.DAIFHBGB.IHHHhABACAGCUGEC.LFCDhAHABDBFAHDG.SBDDhAIA.gEGG..fADChAAA.PFAB.hBEANEEF...,1,-22,-33,11
OLaDJRYdEUVTXbZMBCGHgfPNQSAIFWKce,FHBGKHBGeACGOBGHLHEA..DFCEJCDBREGHdACB.UCCETFFFhAAA.ZAFFCAAD.HBAEhABA....PAHDhABAQEAF..AAFA......hAEA......hAHA...,2,-45,-19,26
NJACXURegEOMfVIaTGFDPKZLQSYBWHbcd,UABHRFDFeFAGEDEH..OBCBMBHB...VGFATFBA.DAGGKCFChAAALFAFSHAGhABABGHFHADEdCCHAIEECDEB.XEGChAAAICAEaBEAPCHD....hACA......hADA...,2,-19,-16,3
aDHNYPdeVZUMBQRKgWIGCJAXbESLfcTFO,EGFCLCCH.TBGGFEDDaCDG..DEAH.HEFHNAIE.dGBC.ZACAhAAAMEAHBHEHRAABKHBCIGDGhABACEBA.AADESBBDhAFAOACGeDEE........hAAA......hAGA...,2,-31,-16,15
EfOTgXVPJBQYZDbHeCLRNSUWGMFcIKaAd,dAFBOCCH..XFEGJDFDBACBZCAEHADBLCGB.REAFUAAChADAMIACFAFA.KGHBaCEDhAEAABBC.EFHF..fBHAhAAA.........hAIA......hBAA...,1,-24,-40,16
NdASPHWQcRgEVKMeIYfZDTJCXBbUOGLFa,SCFCHAADQAECRECC.EDEDMFAHIHEA..YACGhAAADBIFCFDFBHBF.OACDhAAAFCCDNHBB.dFGGACAGPEGFhABAcEBB..KCGF.......hACA......hADA...,2,-33,-8,25
CNdgOIUYMXKaRHEVDFfQbLeWGZPJSBAcT,CHHGdHBH.OBEHUGEG..MEEEaAAF..ECFEDDCF..FGFAQGAGhAAAeDCBZDAF..SACChAFAAEAETABCIAHDhABAXAGAKEFE..RECHVBDCLHFAPEHDhADABEHA....hAGA...,2,-16,-14,2
VSQBTDaGEXYgHbNeFZUfJOCKcIRLWdMPA,QCCBBEFAaDEGGEBAEEBD....gFFEHBABeFGFFBAGhAAAfACFOHDCCHBCKAHHhABAIBFDLFHBhACAMFIFABGF...........hADA.SDFGhAEADAACYAHF.,1,-8,-32,24
dBeUYKQVTWJPOHSCagLfEcXRZbINAFDGM,FEHBGGBDdADEBHADeBABKDFC..QDEEVADF..TEEHhAAAPHBG..HEGBhABASBAGCAHB.gAFHhAAAEFAGcCCCXGGA.RDBF..hACA......hADA...,2,-22,-12,10
SWBgLPCKRHGEaeIUdXVfTQcDObAYMNZFJ,MCCAZDAGSFFABAGCLFDGKCFC.GCGGaBAG.UDAHdGBG..hAAAXDGAVFAFQDDEhABADFDDAADG.NIDB.FBDGhAAA...gAGECACE.ECAA.IEEHhABA.fHDFhACA,2,-25,-17,8
CVGSIZQAUHMEJTFcPfdLgXKNbYRDWBeaO,UFCAEAABFDCA....fADHLDFEXEAEKDAD..hABAbDEHRGCEBAHD.OFFEhACACGAESCEEhAAA.IBAGABDEMCCCcGACPCBEdHFF.hADA......hAEA...,1,-26,-29,3
AeRdCZWPKQEJXGSfgBLHDaVIbTYNOcUFM,eDCHCCAHZAAC.KABE..QFCEJAHH.GCEESBEDBHGHDGBDhABAaFEA...IAFGhACATGCG..NIEH.OCCBhADAFGAB.AAHAdCHEPBBHEGFC.....hAEA......hBEA...,2,-30,-24,6
WBfLXCAIdHbGOMDYZEcFVNeKJTSQUPRag,dCFCHEBHOHFEDFEFEBAGFCCH..eBHDKEAG...SFGChAAAUGAARADC...gCDAhABABGDFXAAFAIHEIAEGhACAMEIB...cGACNAHE..TFFChADA.....hADA...,2,-27,-27,0
bFXBWTJVPYRLKHQUgNIdGADMeCaZfOcSE,MFECaDABZCFB..ODFEEFCB.FCADBEEC..TGDAJFHH..hAAAVABHRBFALDCFhABA..QGAChAAANBBHIGADAIDCDDDCCGGA.SEBC..hABA......hADA...,1,-22,-33,11
QGPIOASMYLEbKNcRaVdJXWHDCFZgUTBfe,SGFHLCHDEBEGKAHHRGFE...dAADXABADDIHFCDG..ZGBGTGAHhAAABGAC..QEEBhABAGECEOCABhABAAADFMAEEbCCC.aAGA....WCCDCEEC.fFHEhBEA.ICGGhBFA,2,-29,-12,17
CNRZcdTPBQOGEbUMfgHeJDWKLSFaIXYAV,CFDDRGFGdGDABEFEGBFE.UACGMIFA.HGBADBAF.LFFA.hAAAFDBGIHACAHHEZCFC.hAAATDDFOBBAEFBA.hABA.gAGH.eFAFWCHHKAECXAGBhABA...hACA...,1,-18,-21,3
JdPSRMNFGaYcZbeTKAUfLQCOHIVgXDWBE,UDACLDACOEHFVEEA..DGBFBCGCdAGA.REBB.FFDFGAAF.hAAAaBGAZCEA.eBAEKHEEAHAHhAAACGGA....IAEFhABAWDHB...EFFFSGABMAIF.hACA......hADA...,2,-29,-22,7
fgRaFNAPTcEIXGKHJSUZYQObdVWLMCeDB,TCBCEHBGGCGE.HAEESGAFZBAFOEEFdEFGLFDDhAAA.eCADBGDAfCGFhABAaCCAAGAEIACFhAAAJEHFQAFB.......hABA......hAEA...,1,-9,-23,14
BFcEMLbeAWXNSTIHUVPgQaOfDJdGCKYRZ,XCBCTGBC.UEGC..VFGH.QBEEfGCCJEABhAAACEADKFEFZABDBEDF.hAAAFGEFMIFE.eCCEhABANBIASEFCIBHEPACCOBAB.DBGH.hABAdGAE.....hAEA...,1,-14,-15,1
KXVSbeQLYRgPfNGcFIZDdECHAOMTBUJaW,MAFHUABH..aDHBKCGE...SGBBQFAGLAADhACAREDF.PCCFfFGEhAAAGEEHIAGChACADIECEGHHAAIDOHCCBAGFWBBCXBDD...hADA......hAEA.eGDE.,1,-8,-19,11
eQZXcUMYPJTCbFRLVfAdaWDGENBHSOIKg,dAFBaHFGGAFABCDGHDEH.OFHFKCDDeFFAZEAD.UAAC.MFBEhADAJFCFCADD..FHBALAADhACAAAECDGIB.EGGBIAHGhBAA..........hBCA......hBDA...,2,-29,-27,2
gKadcTYJSMNIXbRCWfAOHeQFPBDLUZEGV,eFFCFGFCDEEALCDHZACG.EACCGCAC.KCHHaGHD.dBGG.TCAFhAAASFFE.hABAMIFEIGAHRECHCAGE.hAAAAIEEOAEF..PCDEBGEG...hACA......hAGA...,1,-20,-29,9
CUXPRTJLWYgfQdBDMHVSeGZENaOFAKcbI,KHBG..IFDDXBBFRGDALDAA..YBGDhAAAQAACDFAEMECESBGFhACAZDGB.aGGDAIHACFDFTFAHhADAgBDABAHE.eFFDNEEFFBDA...hABA......hACA...,2,-29,-6,23
DFMfVXQEgRaKPbBOIZCdAJNYTeLWHcUSG,JGEATCBCLEDF.HEABSFEHGAAFFCFCMDEF.VEAFhAAAEAFE.RAEB.KEFABHCBODAAhAAAIABFCCHB.AADHNEIGhAEA.....eDGF.....hABA......hADA...,2,-20,-11,9
OUBIQLHWKNVCcJbXTfAEDGYgFMZSeRdPa,EEHBDCECGGBHFBED.ZCAESDEAdEGC.OGFEIBABLBCFhAAAKEEB.CGACJGBETEBHhAAA..AICAMIEGhABAPAFABCAC.........hABA......hACA...,1,-29,-35,6
dRJGYWbNPHVITaALMCUfBEQcFKXeZgOSD,CHFDBHHG.QBGEKCDFeADCZEGBOFDE.DCCFRBABGBFE.hAAA.bFAHHFBG.IBHFhAAAaADBAABEMEIHfHADhABAECFDFHEESBDH...hACA......hADA...,2,-23,-19,4
VIPYJERHBZWQFMOabKfLdGecNSXDgUATC,TGDCVDBH.....IBGHJEGDEGDDBBHCQEBG.hAAAFAAFaADAKFGHdBACGCCDhACAeBCG.SBDEhADADIGEAEFD.CEFFYFAFZDDFMDIBOHAE.hAEALAGD..hABA...,1,-6,-17,11
BWRIXMaTOJUDNLVKefdAPZEYCcGHbgQSF,ZDAGCFEDHCFGQFDHFEAFBHFDRBGF...MDDBaAAB..OBBCDDCFLHBGhAAAeHAEAIHE.EGGA.hACAGABFgFFBhADASAGAIFBAJEEA.......hABA......hACA...,1,-12,-21,9
ZXWJadTfeOMAHDLcKgICBNVEGYFbSPRUQ,DAGDKDCDCEHCBBDA..EAFCFHCE...SBAGUGDGZBBG..JGFEhAAAdFAB.eDEBAIHELBADhABA..gGGChAAA.NAHA.VFAF...YEDGhACAPDAA....hADA...,2,-42,-36,6
NWXEYBTFGeALORfJIaDUgSQVMHbZKdCPc,RFBGJGEADIGE..UEBEQFFGHADDZAAFdABE..CHCH...NAAC.EAGDhACABAGA..FEHHACHELFADhADAODFGaEECSCDEhAEA.MDBE.KEHB.WEEChAFA......hAGA...,2,-31,-30,1
VBWSRIEYbGaFDKgfXMNQCPZecTLUAOJHd,HFBGBCAHREBCEFGEGDGGaBHF.KACA..XBFCMAFB..QGDAhAAACGEAZBACTDAGLEAFhABAAEFBOHAEdBGBSCCEhACAYADHDIFE.......hAEA......hAGA...,1,-6,-21,15
NJRMIOHESTgLfUbDGYeFVCdZXaQAPWBKc,BFDGKHBG.JCBCMEEE.OGFEEFGF...SAHBTFAGLHEAhAAAUEADDBDGeADAhABACBBEZDCFQEEBhACA.PAHBNIEFHBEC.fBAEYDAA.hADA......hAEA...,2,-23,-21,2
IVWaLETXSeHZJYdNBRgDcGAQKPCUfOMbF,KGFCUGGGOAEDMDDD..FBEB..VDFALCHH..EDCBXFAGhAAAHAADJHCGdGEABADAhAAADIAAAHDEQAGChACA.CCCB.fACAIHHAaGBBeBABNDAE.hADARCFF......hAIA...,1,-16,-17,1
PHNXFLGSVYAIQUbMBcJKRDfgaCEOZWedT,QCGCMFFFBCGDKEGFRDBEDAAC...aFHFEFBB.ZBCDdGBAHAABFGGDLBBAhADASHGGAEFD.hAEAUAFF..cAGFhAFA...gGDECFDFODAB...hAAA......hACA...,1,-16,-28,12
GFCdVNcIERagAWDHbQLeKJZYOMTfUSBPX,HFDGQDACKCEDJAHBZFFG.MIEEUCADBFBHGABFdAGG..VBCHhAAA..NEIC..EEFEaHBChABA.ADFGDEEBeFAD..hAAA...OFCHSACE...hABA......hACA...,1,-19,-23,4
RGIUNQMgSBTOWLDKfHJPXVbeYCZcdAEaF,FDABREBHUGGGMHFCBACB..OBCFLBFAKFFEHBGF.JHAGPCCChAAA..XECEhAAAeFECCDHC.dAGBABAGEAGAhABAaCEF....IBAE...NIEF.hABA......hACA...,1,-24,-33,9
LXPRbOYcDAIBTaKFSJdVUfEeMHGZWNQCg,TGGGFDABdHADUECG..ECAEHFFGGEDFZCFG.QBFFhAAACBCC.gFAChABA.LADDXAABhADAPCHD.........hAEA......hAFA...,1,0,-42,42
GbTVZASHgUDCFKLdeRPEfQWIJaBYNXOcM,SCFCUFDHFEAALDEGRDFG..EAGCQGAAJFBF.BAGEhAAAXBCF.MHDAhAAATBAFAAFHDEEBCGHH..hABA.KHGAeADH..WCAF.aGAHNIDBcAFChABA....hACA...,1,-25,-33,8
OTWDJLABHdQUVMYebIPFSaRKfZgGCXcNE,dBBDUCCBMBEFeFEE....IGEBSBGAKDFBZDAGCDAAXFCGhAAAEAGC..TFAAhAAADFBDJACAAFCC.BDFD.hABA............hACA......hADA...,1,-38,-41,3
BbHfaVRgXATFNPUCGYSdMLQKeJDcIEZWO,FGFCUCBCCBGA.GGCB.dBACLFCBKEFA.JBABDIGA..EAFAOFABhAAABDDC.HAEC.hAAAaCFEVFAF.REFEAEHANBIE.hABA........YABChAFAQDDCeCEH...hACA...,2,-25,-20,5
SOaPgNDBIfMWLKHbRTCXdVJZUFAceEQGY,EDCDQFGHGBECOHBGaAGD....NBIEBACGMFAFLBAGhAAAKGDAHBDBRBABXFGBhABAJFAH.FBGCAAECeFCChAAASEAB.DEGC.......hABA......hADA...,1,-12,-19,7
BfPJHGDIAUaeXdFMZQOYVTELbgKcCRSWN,UGGDaGDD.dAGBZGFA.ODCH..VBAGEAFELDHBKEDH.hAAACEFH.REABSFEHhABABDAAJBBA.DDDGAIAGXBFGhAAAMCHF..QADE...hABA......hACA...,1,-29,-32,3
gYNCMGAcSDbPJOXRBTUfdZKaEHILeWQFV,SHFGDACB..JEGHRAFGBCEHUGAFZCDHKGCAHEGDLHDG.hAAA.eEBAFDBC.YBBChABAMDFA..AEHA.bCAChACAOADA..XCGE.fFAEhADAaAAHEBGG.IFEHhAEA.,1,-24,-35,11
NcJfTABPdWbeLCOSMgQHaUGXDYFZKVRIE,dEGDeGEACAGF.OECB..SECAMIEEHBDFUBACDBFEFDHHKHGERAEBhAAAECAE...NAED.JHCEhABAAADD.BCHB..bBFEhAAA............hABA......hACA...,2,-47,-19,28
HCPKRGfFTBIWQYLdSEMDAeXVNZOUbgacJ,XAEGVGFG.ZFACOCBE..bDFCaBFA.HFCCKACHRBABFDHDBEDChAAAQABGLGFAhABA.EHAEDAEHACHD.eCFFhAAANIDF.cDAC.JHAA......hADA......hAFA...,2,-14,-10,4
LEKISAQfNbBaDWgeCMJGcPUOVYdRXHZTF,QCBC..fBFCBFGCaFEHDAABgDCH.hABAeFAHCGHFMBFCJBBGPGDGhAAAODFAdADE.XFADhACATCGEEHGASEEBNFEB...hABA......hACA.WAFE.,2,-29,-13,16
CEfRbYWSBeQAXFaNGJLUTHKZDgOMdcVIP,FFHBGEAHUCDGHGAAZBFH.OFFF.MBBDdFDG..VBAHCEHGEACA.hAAARCDE....bAGBSAHBhABABCCF.AFAGaGAChACANAAE.LFFFDGEF......hADA......hAEA...,2,-29,-5,24
IBZDAHVPRcSYGNEMaCOKbfXgWQTeJFULd,HGFGVGFG.RCGB..SBAFGCDBMAFEaEAF.OHBG.KBAGXDCBhAAA.WFADhABAQEEB.eDCDhAAAFBCAUFCBdBGBBEAADIDAcEEA..hACA......hADA...,2,-17,-13,4
DeKfSJPZONEMcFWBHITYUVbRAgCXGdQaL,XGGGdEABaAAD.LBAADGBF..KDEGJAHFZAGB..ODABhAAAMCCCFHGEBCEB.IHDDhABA.UEDBbGCAAAABhACACGBEQEGE..SDDDhADA.NCICEEGF..hAEA...,1,-21,-35,14
BQJeWSCZMAYdfHIVPbGELROXUNFKaDTgc,dHBHHAAD.VDBDGCBFLHAEOHEEUGFEFAFFDFFD..gBGBhAAABEGBQABGhAAA.JEBHWFHBZAGBAHHGhADAfADA.IEFE.bDDBhACA......hADA...,2,-23,-16,7
GEDWJFMgPNSTeQBXKdYLZOfaHcVIbACUR,CFFCRACFEBGHDIBG...FDHFMECF....PAADSDHD.hAAAeEAFQDEHhACABHGGKAACdGBDZDCHfFFGhAEAaAEB...cAFBIBGEAHHAWFAFhAFANAIE......hAIA...,2,-39,-27,12
AabcNJgHPMWUDTQXFLeOVGdKCRZEfSIYB,aHBG..NCCAHGDGMGFCDAIBQEGG.LDFCeHCAOAEAhAAAVAFGKEDGCDBBZDFESBCBhAAABCFHAEDA.JBAHPFBEhABA..WFABTACF....hACA......hBAA...,2,-30,-6,24
gaJZVUOcLCdRAeNFSbTWYQfHMPBDXKEGI,FDCDTGBCQAFE.HEGDBDAHXEADEBGBGEDA.aBCGhAAAZEEB.UBAD..hAAAcDEAdHBHAAEASDGEhABAYFHB.fBDEMFAHDBIFKDCB.hACAIBAF..hABA...,1,-4,-28,24
IeVUHbJQKXgWLBdCNFDScZOMfaPATRYEG,REFHGEAHeDEHHGBEQAGEKABG...gAAFBDAHCBGHFCDHSEEEhAAA.cBEHhADAMEIBfAFAhAAA.AFAHEECBIHGA.bDGHWAHHhABAdDBBNIBF.....hADA...,2,-28,2,30
FEQZMRBUeaKGDfXPHSOYAWcTLbVJdCIgN,TCBCLFBB.JCABCGDC.....IGGCFHGAEEFCQGADhAAA.RACEUAFAhABAaDFBDDDDXEACHEDFYAHDhAAAAFDG.cACA.....hACA......hAEA...,1,-21,-33,12
KIecbJMXfEaFdRHGOBWSLUZPQgNVADYCT,DAEDTGGGKGGD...eFCAJEFC...fBDDEDBB.aHACFFABhAAAdAFHRFCHHABBBDDFSABFhAAA.UDAGhADAPBHD.gDDDAHDACBHAcCEDMBAFhABAOHDE....hAEA...,2,-28,-17,11
ZIBcYXCQWPeKdSTNRADFOLfUVHMabJGgE,OEACLDACUBBAVEGFHFFE..aBEDJCHHGEAHZEDD.BAAFhACA..XGBFhAAAQBGHeAEGdGAC.SGEFhADA........hAEA......hAFA...,2,-27,-19,8
fCUZPbRESgcYMVeJBaGdWXFIQDKLTHNOA,UGGGZAADRDCC.EGDA..SGGE..cCCEMHACeCFChAAABDFBdGBCFDGE.DBEEKBECLAHFhAAA.TABChABA.OEFECEAHPHFCgDADJACDWFFChAEA......hAFA...,1,-17,-29,12
QPJTAaYDVERZbcdLIKSUHWfOBCFeGNMXg,aHFGVFDGZCCC..dCEALAGBKCHD.SAAFUBBE.HFBChACAOHFECEAHGEEFMADCQEBBhAAATADEDAIB.hADAEHAA...bAFA.......hAFA......hBBA...,1,-14,-19,5
XEIDYFHORNLaPZMQWdTcbUeVBAKgCJSfG,CFEDSDCDGACG.EFGFDBFD.HFAFRBDFLCABaEAG.ZDEDMFFEhAAAQGBHdHGH.TAGDhAAAUBAA.BGAC.hABAAIEGKAEEfDGFIHHEFAGD....hACA......hAEA...,2,-19,-6,13
QDGJWMZaPCLEeKYTFHdNbcfUBXRVIgOAS,DDFFJFEFZCFHCBBA..LEBFKGGF..FBABdFGD.....NAHE.hAAAfDCHBAEARECB.hABA..VEAFOADHhACAAICC.QGEDMAHHaCCG......hAEA......hAGA...,1,-37,-41,4
gOCLWHMcdBXbKUFPeZEADYNRaJIVQfSGT,DACBRAAD..aHEEJEEF..QCGDGBAEOCFECHHHHDAG.MACEhAAAdGBABAFHKFEH.FEHBeAFHhAHAAGIB...YFBFhAIAIAHF.....fGGGhAAASEHD....hBCA...,2,-42,-16,26
HMAKFDVaRUTOfJZEYLBSPgIGWcCeXNbdQ,DGGDaDAF.UBCD..TDFHOAHBZFBBLFDDBDDC..PABDhAAAGDDB.CFHAeAADhABAXFGH.dAFFHFAHhACAAAEFKFFF.FHDCfAFAEBHF.SEAChADA....hAEA...,2,-21,-16,5
SVZWEPFeJNADbXTaCMYLOfgcKHdUQIBRG,DAFBXCGCCBDA.LAACODFG.....fFGFhAEAKFGFdABBUAGCBHBFRCBH.SFDGhAFAZEDB.PHEAhAGAeFHHAIEAaBDE.MCBH.gDDDhAHA......hAIA...,2,-41,-25,16
EIRMUPgfbLNQZJXSOYFdeWaKCGDcTHVBA,ECFCRFACMCCGUEAC......fHGFLEHHZAFGJACGSGEDhAAAOCCFFBAAeEEEhAAAKHBACAHAGDEGDHAE.hABATCAFBBDEIHDC....hACA......hADA...,2,-28,-18,10
bBeXDWUJAVCdHIGcQNLaMEOgFRZTPSYfK,dBBDHEBHGGEFQBGGaGBF.EFFD.OFABRCFAZCBG..SEGAhAAAfCDCBEEDXAAEhAAADCAB.UADFAFADCAHG.hABAIFHG.NEEHMIDG....hABA......hAEA...,2,-28,-6,22
GWLJZfPBdgCXNYEISaKTcMOHRQFbUDeVA,LFEFJFBBZDCF.BDECdADA.CHBH....XADAEAFF..aAAHhABAKECFMDIDRAGF.QEFBhACAFGABDCAGADIF.GGDFhAFA..fGHCgAGHIAAAhACA.SFGFhADA..,2,-33,-27,6
LOBVgQIDdSKCJUZEHRNAMPcXGeYTfabFW,MCCAXCBCGEEH.eADETABC.aGHBFCBH.LAHHhAAABEDFVCGBIDDA.hAAADBBAdAGDSHCGhABACFFGZGCARAEBACEF.PGDCfHABOGAG...hABA......hADA...,1,-5,-13,8
RQUBECNAPZYLdfIXTaVbKWGOMcSDFHegJ,ZAADdDCD..XCFGVBEDKCCBGEFG.MABCDAHBeFAE.RFGBBGAHhAAACFBFAFADLCHHhAAA.fGBFhAFATGEHaEGAOBBA.SHAG..hAGA......hAHA...,2,-30,-21,9
RXMNdPHcgDQfBYATSJFOVeWaCILbGKZUE,TGGDSEED.OHFAVBCE..aFACCCAALHBA.KCFEhAAAZAADRFAE.XEGAhAAAdEAFHABDDHDE.BHCDAEDBJDHFhABAFDFBeAHBWBFE.IHAC.GDAFhADA.....hADA...,1,-6,-13,7
agUGNLXEQASDWKFPVHJZOIecdBfRbYCTM,SHFGDGHHFEABHEFDOBDD..ICCDdBAFBGDB.RDFFCAHETFBChAAA..MFAFhAAAaBBBGADFXGBHAHEFKEDBhABAVCAFJBHB..eBHBfHAB.hABA......hACA...,2,-23,-14,9
EIgFRSBdCAbYeDGUWOJZXKVQNHfTcMLPa,eGEAUCCBOHAGZCAGKEEB...QGGGHBEETAACMBBHLGAChAAAaCFC.EAFEFADEBHHEhACAAAAHDAGCJEAE.NIDF.fBGFhABA.PFEBIEGH..hADASDGACHAA.hAEA...,1,-7,-20,13
TUfCYZeHFVAdRJSWcQBLIgDNKabOEPXGM,dDBDRDED.SEEGQAFALHBEDDBCKFAA.aDGGOHDE.EABDhAAAXAGG.TBBBhAAACDGCeEBEFFAGAHHAJDHBhACABADE.gGGG..PADDhADAMBAF.YHBE.hABA...,2,-22,-14,8
UXCVSKHbNBGAIQFZRdPWcJEMTfaYLDgeO,FGFCRDDFdAFB....PACBJHFE..MECDaADA.LCAH.hAAADGBBOGAC.UCGHhABACBBBKFFDHECCBADDADEGIAGAhAIA.WHFAEEHF....fDGAhAAA..hABA...,1,-25,-46,21
DPZRSJGTBCUbNOQWLgdcVXYAFIKEaMefH,FAFBKAFBEEFBMDBE.HFFBDCEDZCAF..SBHHGBGCBADBCGCCUABEhAAA...ODEFhAEAWBBB.LHBAhAHA.dEBFXGECAFID.aFDBfBGChAIA.....hAAA...,1,-8,-45,37
ESUOPKYGIaVebDdBMfcXTAHFNZgWRLQJC,HDAGFCFCZFGFREDGQBAG.CCGDEBGESCCH.UGBHhAAAKGHFIGADeFFBdAHCMBABhABAfEHG.hACAXGECNFABLBEDPACAaBBBDEGE..hADA......hAEA...,1,-6,-18,12
JgPIfBaKXFCGNEYLZSTdWDbcAHeMUQRVO,MAGDQCCBREBC.JHDE..IBHEBDAFKFDECACC.GBFC.hAAAEFAEZBCE.dBAE.bFGHhABAAIAC.HFDCUGGAOHAEhAEA...........hAAA.fAHAhABA...,1,-13,-39,26
ENbVLgCYcFdeOISZWGfQJAPKBRMDaHUXT,BFEDMCDDHFFEUCFF.ECFA..VEAACHEG...FBDBeBBH.IEEAhAAASAACGFAFhABAJHFA.AACCKADG.DBIHhAFATGCE.NADF........hAGA......hAHA...,2,-41,-18,23
eWGBAEOXSYMcRTLPaIKNHdZQJVUCDFbgf,EGDDXAAD..MCEERECHLBFAaEDCKFAEHGFGQGFG.hAAAUFAACAEEFDAA.fEGFhABA...hAAAeDDGBDCCSBBAcEGFIADAhACAdAGF......hAFA...,1,-8,-32,24
TgUPJfDRNYCFbeadVASIWXOcKMGZQEBLH,SHBGXCBCKEFGMACG..QGBFEFGBBCEGLAAFhAGAHEBEgADHJEBEDHCGRAGHhAIACFHHFAGE.aACBADCAOFFHhBBA..cGGC.....hBCA......hBDA...,2,-25,-11,14
ISgWOGXYTcZPAaUdQBfbHMEKRDLeFVNCJ,UFCEdFFBBEDEHGFEKECDRBCEDCGGLAAF..eDEAFAFD.CAHF...hAAASBHDOEAF.hABAGGEFXEGATBBFhACAPADAAEAH.fCACbFAD.MIBEhACA......hBAA...,1,-20,-26,6
QUTSfVXcLFHAaICODdZgPKBeNMWGYJREb,CFEDdEGCZBFAKAEDBDCH..eEEB.MACFGDACRAGB.EBAFUFAH.hAAA.SGFHhABA.XDFEcGDCFAAFhADAACCHaHAEDIGA..NAEA.......hACA......hADA...,2,-34,-31,3
PATfZGbRKNUSYdVMaHJLQOWegEcDFXBIC,ZEFHGEDHKECCUGDESHAE.dDBFaCDAHBFC.QGDGhAAAeDADECGA.DAGGBAACCBCHTGGEhABA..RGACNACFMAEBhACA..JBBBWDAD......hADA......hAFA...,2,-29,-8,21
EaKbYWQLDIVOFSCNGcRJXHUBTdAMPfgeZ,MCCA..fAADZFBGEHDG.KADA..bDEEQAGChACA.LFDCDGHBOBBHhAAACEHCcGBAXEAGhABAUCCGBGFFAGEFeFHFaADGIAHE.SDDChACANDAE..hAGA...,2,-29,-11,18
caRdKFMZHeTbgQUXCfEWYNSIOJAVLDBGP,LAGHBGDHGEDFaAAD.dAGGKEHDZBBH.eACG..TCDDQEAGhAAAUGEECDBHEHGE..hABANFAB.SCGAhAEA.IHBHACCAPADC.FGCDMEIF..hAFA......hAIA...,2,-26,-13,13
ITUSHVRaAdFCcMNbEXgeKYfGPZQWLDOBJ,dEHACFED.MDECEBFG..eFAAKCCDGFADZBBHLEHHOABEBEAB.hAAA.TGFGSHDAhAAAHEEERAFGaHGCAIDEFBAH.hABA.NDDB..XADB.fEEBhACA.WAHBDIAE..hAGA...,1,-8,-24,16
STRKePIBagEMNbYVWOQZDfHGXFCJLdUAc,TGBCRDEDeAADBEAB..EDGHMIDG..NEEA...VAGDOCABhAAAQFCEDEBBfABFhABAXCCFCDEBdGGEhAEAAGHDSGAGICCGaFHF...gAGAhAFAWFHB...hABA...,1,-13,-31,18
DFYVcbNfgJEZIaUXGOPRAKQdCWLBeSMTH,QFCECFEDBHFD.SCHFMCBCHFBFDGBBFCAH...VDGBhAAANEGE..JBACZAFCaBEEUDDFhABAGDAF.OFHBhAAAAGGBdGAC.eADC........hABA......hACA...,1,-20,-23,3
dISEUAeWfgDKcNFMbQOXGBJTLVRPYZaHC,eGEA..gGBCKABF.FFGBbCAG...OEDEXCFEhAAABCGDLACGhABA.RDDDPEAHaGBGCCEDIAHFhAAAEBBBAHHHDDIDMEID......hACA......hADA...,2,-41,-13,28
YLCPQIRagdSJKWEMXHVFDbeUGAfOTZBcN,ODACTGDC.ZABCBDEC....NAIELHFAPABG.RFDA.dAGEhAAAKGBDMFCD.HDGDhAFADACE.UGGBAFAD.fBDHhAIACCGFaCFH.JCCFECDB......hAAA......hAFA...,2,-33,-11,22
VeERbHZaSJWLQIdMOcXfCDgBAKUFYPNTG,UFCEFHBG....NGAB.TAEGGGEBeDAGRAEG.ZAAC..JBCBLAHBhABAdDAE.OEGHhACAXDEDCGAEDIGGAABH..hADA.KCDA..........hAEA......hAGA...,1,-25,-38,13
WVNBeDFRJHSKTIAZdLQOabUEYcCGgPXMf,ZDEDdGDDQABBOAABUCBGECGC..CBGC.GEGG..XFBChABAWDCC.BHGFDGAHFCABhAAA.JAFC.KFBDAGGCaAGAhACA...YHCE....hADA......hAEA.gBDHMFCA,2,-33,-16,17
QGPMVceOfCUAWDaBHJYEgXFTIKSLNbZdR,DGHHBHCHHGDAJFFD.EEDE..FBEAKBFHLEHFZABDdGAH.GDAD.hAAA.MIAAeABHCBAHAEADaFABhAAA....gADAhABAIDFCNADBbDFA.......hABA......hAIA...,1,-19,-34,15
KYRXPaVUeETIQBJCASZfbdgHFNcLWDMOG,SCFCZAADdEFBHDAGFFFBLHBA.MGBEKGAARCBA.aACBUBFHhAAAEAGG.QGGHhADABGHEAABH...gACAhAFAcEBH.DAID..ODFE.XGDDhAAA....hAEA...,2,-37,-2,35
UNZHLIQXbEFTcgdeYCVWDOMPBJGaSRfKA,ZEFHHFDFLAECXCAGEDHDFGBF..TGCHdFFHCGHADIFA.OEAChAAAMCAGBCFE.JDDFhAAASAGCKDACAGBD.hABANBIEQCEE...gABFhABA....hAEA...,2,-29,-17,12
dBLIaZVgYGHcCTEQDKWSXbfUAMOFPRNeJ,FFAGRAADeAEGBCHHLGECZDDH...VDCFGABA.CHBBEGGHDAGESDADhAAA.hAAAXBGAfGDGhABAAIEGMFFEPAEG.NCGE.JCDA.IACAhBEA......hCAA...,2,-32,-18,14
UABPdNKJSZCefQVDbHaRTMEgOFWcYXGIL,dEGDJCCHZEECeGDG.QDAGDGGF.HGAEaBHB.RAEE...EFACgCDGhAAA.FBBGhABA..WHAEXGGFhACALABEAAGEBCGAPAFFKECG.....hADA......hAEA...,1,0,-45,45
ASbLFcKHUOdYJBINEGVZWaXQPTRDCMefg,LCCHFAFBKECFHFGHUBGAdCCDBAAC.EFDFZEEF.aAHF..XCEDhACAQAAF.TGCAhABACHGEeFAH.gFFChADAAEGH..SEAF..hADA......hAEA...,2,-30,-23,7
OSJBCgYHAbeQdILWFXTcVRaGfPUNKEZMD,eDACdGFCLHBAFFAE..TABGRDCCaAABGFABUFFA..EAFADBDFhACAOFDBBBEACGHG..hADA....gCEFhAAAACCHIEAGWAHH......hABA......hADA...,2,-32,-31,1
ZXSLENHMaeRgKcJVbdABTOPfDGYUQIFCW,TEBEOGEADAGC.GDEDUCBHFGHB.CABD.ZABCLHAAHGBEMBFEhAAAeCHHKDAD...hAAA..cFABVAEHbFEFhACAAFDCBDDC.fCAB.YFHBhACAWDAD....hADA...,1,-15,-23,8
TfCGWYVdBLNHgDPFORAebXcMQUJSKIaEZ,eDACXCBCMFBFUFAFKFEF....aAGETCEGGBCD..VEFFhAAABEEBLAEChABAHCGDDIFEOHDEABAD.bECBhACAJAAASADD.IHHCEGFACHHB.hADA......hAEA...,2,-19,-2,17
RMBNVdSGbQKFDIJETCgPfHcaWYZOLXeUA,RFBHMBFHBAHDdEACGEEFKFGA.DAGB..JCCBEDBC..CAAB....hAAA.gABFhABAHGDEaDGG.ZBDBLADChACAeDFEAHHESHGG......hAEA......hAFA...,1,-22,-39,17
BbcDQHCRAZGaUfWVdNFOEeJTYSIXMKgPL,GBCHUGBC..VCBBNGDH..FHDA..EABFJAAH..SAFHhAAAMAID.KFHFLAGBhABABGEBDEEAHFADAIHEaHEChABAfEFD.WEACeBHD...hACA......hADA...,1,-26,-30,4
bHERCLXegVZJUPDWcdSNaABQKGTYfFOMI,BFCFKCBBGDFC..TDDHFDEBMDDBHBACRGCC.CGFDLFAFhAAA.eAEAVEAFJEHDDABChAAAdBHASAHFhAEAAFFG.QAEEOCEAIDAAEHGA..hABA......hACA...,2,-22,-12,10
NeCEbVOZTgAPSaRDFcBHWLMfIGXJKYUQd,SAFBRFFADAHBBCBD.LFBH.MAACIDGDGEEAKGABUCCHhAEA.dHGHCDEA.EAHFOECBhAAAZDGFADBH..aFDBHABEhABA.XAEF......hADA......hAIA...,1,-7,-44,37
aKNTPVdIXQbcFCRfSLWZJYMGHEeUAgODB,OFCHDFEAKCDF...TEEBdBABQAGE.FHGECEAHSBGHhAAAZEAF.MABChAFAEGDGUCECAIHEaGEHVBBAhAGAIADF..........hAAA......hABA...,1,-30,-37,7
bYFEXTQReIWCZGLgJcPdBMfDKaSVNOAHU,UFDHFHBGEDAEQCDH.RBBF.IFEACEHC.ZACCLBFEhAAAJCCAdFABBGFHDIGEKFAC.hAAAaAEGSBGGhABA.VDFEAHCF.........hABA......hACA...,2,-35,-25,10
gKBRZPeHOQCEbcNUVdfaXMTLWIASGYJDF,GEAHJFCH.DAAFFCCFKGHFZBFBHBCB.CHEA.EADE....bBEBUFGDhAAA.dBAA.aAHFTGCAhABA.LAHBhACAICECAGGHSEGA.BBGHeFADhABAcGAHNEEE...hACA...,1,-9,-35,26
RcZgWOXQSCaJKTDVAYINdFUBfPGHeLEbM,..IFDGdGDFUBAHBAGCGDFAHBDFEHBEMFAFZEAE...OHDAhAAAXBECCHHE.KAHFDCGChABAAEEC...NCBCPFFAhACA...eABALHEA...hAFA......hAIA...,1,-24,-26,2
ZdeIQbAWCcLKaSMRODUHFBNXYPVfgTGEJ,CFDGKDCD.MGCEDGFFFCEHBABD.....XDFEVCAH...hAAATGFAJAHDdGAF..hABA.QACBhADAAGBFLHAGaGGARAEGODAB.UACE.NEIE.PEFEhAFA....hAGA...,2,-39,-19,20
HWUMDCFfeSgYJAbTcKdGRBQaPVZNLEXIO,TCBCKAFBRDCBBFAF..aCGCZFFELFAC.EHGEOHFCHACCMFFEhAAADBHBFCAGeHBC.hAAA.SCFDhABAYDEDAGIBdHAF..........hACA......hADA...,1,-1,-43,42
cNKTVBJYaGMeZHUPEIDCWFdLbRAQOXgfS,QDCHODAC..XFAFSBEGKBCABFHDaFFEGAAEhAAAeFEHHCDGPAFEIGCBhAAACHEGdDFGLFADhACA.ACIFfGHAcAGDNACD.....hABA......hAHA...,1,1,-30,31
IZTXgRGYSeWfKUQDcFEHAOBPNJVLCbMad,OAFBBFDGJCBCLDGF.MABDaFFGdFBAZEBF....TDDBhAAAXCEBRACF.SHGAhAAAfHFBKHCADAIBhACAEADEADIH...NAHG.CHHB.....IABFhAFAYHAA..WDBGhAGA..,1,-26,-37,11
MXfdZFaYWASbNeOcGgQLJEVRTBUICKPDH,SHBGeGEAGBDCQDFCJBHH.RBDAUDAEIBAC.CDBG.hAAAPABGDADF.XDDChAAAZCFFFFBC...YFHHhAFAACCD.NAIGOHDALHAE.EAFABAGFhBAA.....hABA...,1,0,-24,24
cAaCUbEJXHLKZQRVOfDSWdPIgeBFMYTGN,aFFBUGGG.EGDAHAFEZADG.REBEOBBG.DIGASECF.hAAAdEEBPDDCeCAGFAHDhAAAMCIF...TCAEhABANDACCABG.JHACKDGCfGGF...hACA......hADA...,1,-10,-26,16
ASYPDBLfXWCTbVHNJIgMOaUKEcGdFReZQ,SHBGDACBBDECLFCF..fFEHCAEB.TACGhAAAHFEFIHAGhAAAMECHaDGGEHEEGDGE.FBDChABAZCCAQDACAABCYBEGXAGDWEAFNEIE.hAEA......hAFA...,2,-21,-19,2
fbZNcKSTgJeAIRPaGUdFDVMQXYCHBWELO,RAADGEAHdEAFFEGCMACH.QEGDCHDD.BBDDLCDFOAGBhAAAZADAKHGASAHHhAAA..JDDAAIGEIHBHhACAPHACaAHDDGADYBAFEGGE...hAEA......hAFA...,2,-33,-11,22
dLWUXTQcaGPNORbBfHKgISDeVYFJEZCAM,LECCUCGCQBCBaBFHGAGA.OABHbFDB..BEABKGHBSACChAAADEDEeHFAFFGBhAAAZFAEAGABdGBAXGFBhAFA..cAFB.NABF......hAGA......hAIA...,2,-20,-13,7
VRXgFLJcOGPYNUTDeMHbaZdCKQfSIABEW,EEGDVGFGRBAE...FDAGLBHF.OBFHGEDA..PEBEhAAAUABETAGD.hABADFFGMHAAaFBHdCFCCFFGKGHBhACA.SAFBAIAGBDHG......hADA......hAEA...,2,-26,-24,2
cdOaDSZYUeTMLfgWVHFbQNIEBXCJAPRGK,REBHKGAHOAFHDAFEZECD..UABH..TCFCMAADLAHBhACA..fABChAAAVGFGFHCE.QADGhABAEDGDXEEGAFHFPFED.cGGCaBDDYEADhAEAeDBD....hAGA...,1,-14,-22,8
TdeNXHgcaQFbMACSVPWOKULIfZEGJRDYB,SGFHVAAD.OACGLFDF.IGFBZAFDJHCEDDCHBCFEhAAAdBAEeDDEHDGFaBFAQEDDhAAA.MCCEhABAAADECECFKEGBEBHB.YFAFNEBE....hACA......hAFA...,1,-3,-33,30
cMEWAZGVOTJgXNPIDBdRQfKYbLaHFUeSC,GCBDOBDG.JGFE..XAAE..IBGFBGGEdGAGQEAEhAAAKCEHLHFGhAAAFABDSEFFhABAMAEAADIBTGCHNICHDHAARDAEbCGF.....aEEEeADChADA.EFCG...hABA...,1,-14,-19,5
MSDIKXbRETCBgcUPeWVHNAQJFYLfGOZad,QGGDFDCDLCGFGAEAOBACZEEGdFAESAGC.DBHBhAAAIDHAKCCFRABEEDAHCAEEBDAEhAAAUGDF...eEEFhABA...........hABA......hADA...,1,-14,-39,25
SeMEXIUAJDcKBRWbGgFLafVHOdNTCQZYP,JFCHDGHHBFBD.RBBC.GGEFLGDGaFAHHADA.dEDHCCHBQDDHhAAAZBAD..SEGChAAAECFE.XBGHhABAAAGBKADC.WDCC......hACA......hADA...,1,-22,-45,23
UbQTcORgVCNSJKWaXfLdEBeHZPIYFMDGA,UCGCQCGCOAACRFAF..CABC...JEEBaBDELECHBFEHeDAChAAAZBCE....IHGGhAAAFGGEMIEE.DDECAEAB.hACA...bFAD........hADA......hAEA...,2,-35,-33,2
fNDRLQWSUeHEdPKYIGMcFBJACgOXZVTba,CAFBODACZDAC...TFGGaGCE..DDBCRABBLGBA.SADAhAAAeFFGHCFAPHEChABAIHFHGAFEhADAFABDAFBHgDDB......hAEA......hAHA...,2,-41,-11,30
HAOYegGPQbUWKLCBFIcDSaTVfdJEXZNMR,OEEGeGEAGEBB.QACDUBAGKFAECHBFFAFA.DCGG.aDCGTFDHhAAA..fDHGhAAAEGHHZAEG.MABHhACAAIDC..PCEC.bDAABEGD.IHHAhAEA....hAIA...,2,-26,-22,4
PcWDXCEZJagfQUBSNTVRYdbFHKOeAMGIL,GBGALGEA..PCBDDAGCCCFAZDCC..aGBE...fBFChAAABFAASAAChADAVEDCdHGBFBBCKFAGAAEEICHEhBDAXABEEAEFJFCB.......hBEA......hBFA...,1,-7,-44,37
WFTYEIBCbUDZgeJPSXARLacHQMfdOKVGN,RDEDaDCDQAFA.dAABVFFEGGEHFGBHEHEEBDBD.UDCCDACBZBEFhAAAeDHD..SAHDhABAAGDGLBBAMBBHhADAKAHBNEAC...........hAEA......hAFA.WCED.,1,-6,-27,21
WTYBMQdgLVcFCEGbDKOaUfRSZXHNAPIeJ,eGEAJDAC...TBEEMFCAdBCFLACHFBFG.GFAFDCIB.KAFChAAAOHAA.UGFChAAA......hABA............hACA......hADA...,1,-37,-50,13
WNTFcgaPBEKYGLfDeOXVRdJQbSIUCAZHM,MGCETCBCFBAA..aEFGBEDE.KHACLCFC.DAADeBGHhAAAVFAEdGGD.QBDAhABAIHDFAGHC.ZAEE.hACA.WDADgGFDEDBC..fEHAhADA....hAEA...,2,-34,-19,15
dXDbSJTCVABgZIHFKWaeMOfPERULQNcYG,ZDBHHDAGKDDGeHDG.MGEEOAEC.EHGERACFQGAA.hAAANAIG.GBBFdEFFXBFBhAAASDFB.CFHCAIAEhABABEDHIHDEWABFfGHAPDAB.hACA......hADA...,2,-34,2,36
aScfWeDNULEVAOMKGQBIZPRJdHCYbXTFg,KFAGQGDHBECFZAEGRAEGHDEC..CGEB.bAABFEHF....SEADhADA.fHAHhAEADDAALBAEhAAAAGGCGCBEPDDA.dGGA...XGCDhABA.....hAGA...,2,-42,-12,30
DNLPcRHTXdSGYaJWgEVebOAIZUKCQMBFf,UFDHKFFBMEADBHAH.FCEEDIAC.LCFCRBBG.HECFdBAC.GBAEhAAAJAEA.EHGA.VACChABAOHFE.ZDEECEEDfEHEhACA..NCIE....PEBDhAAA.....hAFA...,2,-36,-13,23
bgeJZYfQIGdHMAPULBaTNOEVWDCXFRScK,UDACaDAB.OGDGEBCCDFCG..CDFE..RACG.KHBG.eFHHZBAAQGAAhAAAdHEBAGGALBFEBAGChABATCDA.VCGFhAAA..FEEC.SHDGcGAB.JCHBIABGhADA...hACA...,2,-30,-10,20
CbKTaNcOeRHWBSPgdVFGEMJYDXQAfIZLU,ZAADUGDECHGD.KCGC..aHDAOFBH.HBBGBAHG.SEBBhAAAdGGEFDFHGDAFMDDBDDIFhADAAAGDLABC..hAAANBGCeFAB.PAEB...EGGE.hAFA......hAHA...,2,-28,-23,5
OGUQEDeYXVWFKBTRNHZMdgaCJAbIcLfPS,..IFDGfDCD.OFBAQDEEEGFF.DAFEeAFGVCADhAAAKDADBBGCTACBNIDB.hABAMCIBdCHG.CCGAAFFDbACBLHAAhAAA.SEHDYGEGWFBHhAIAFCEF......hBAA...,2,-26,0,26
gDTcIeAQGaKEbNJWZSCMfOPHYBUXLVRdF,GCEBEDAB.JFAFZDCB.CGGE.MBADOABFHBBCBEFGLHCC.hAAAdGGAFDHDDFGGTAGAhABAIEEDeHDA.QGAHhADAKBEC.WBDG.....fGDFhAEA..hAFA...,1,-21,-27,6
RLIcFbUWJPDMgOTKNaQdXAeBGSCVEYfHZ,GACBCHCH.EGABHACBZDCCLHFAFGFGUBGH.JFCDDGIB..OCAGhAAATAABKBGG.QFGBhABAdEGFADEHBAGESGDHhACA.fDAEIFDGWFADhAAAMDDG...aEAF..hACA...,1,1,-42,43
adVePGAFXBEOcLDKRJNSYMQWICbHZTfUg,FFFBXGAFBCFC..OCCHDDIBRAEB....SBCHMCBFQBGGhAAACGGBHECEfCAGhAAAaGHH.dGEGPDHDhABAEABDKAHFJEDB.NDAE......IACEhAEA...hACA...,2,-27,-24,3
RZNYKFLWMbAfJgBeIHOUQDEdcXSCaTGVP,JGEABAFBHCAFOAHFDCFG.dBDF...SHEACGBFGACDRDEEZEDCKCCHhAAAFCGH..LDHBhABAMHCEAHHE.eHBA..hACAUDAEEAHB.aAAB........hACA......hADA...,1,-12,-35,23
cPeUCEdKYASaFLJGRQbBXIOZWNgMHDfVT,FDABGGCBRBFEBABCOCGD.ZCDE....NDCG.MBACHDDHDBFC.hAAAVCAFTBCA.eHFGhADACGACEFGDKAGCAEEH.LDFHhAEA...JDHB......hAFA......hBAA...,1,-16,-29,13
OVBLEfCUZbeRTJNSYDKGPHdXaFcIgMQAW,OFBBVFEE.LBADECBE.CFDF.ZBDFeGEAJAFF....SGAFhAAAKBDBHDEHaEGEFBHD.hABAIAGAMHBEAIEABDAFhACAfCBE..REAE.NICDDCFA...hADA......hAEA...,1,-16,-22,6
SBDfKIAYcJaCPWFZVgGUTHENMXOQLdRbe,JGEACFEDFAEFZCAF..GDBEHADE..MFDC..OACFdGABeHDGhAAADAGHKDGFAIBA..aDCG.hAAA.PCAH..hABAgDGBEFHH.QABALAHFSGGDhACABBHC.hABAfDEE.,1,-11,-28,17
LHRVEcTDgJIPYFQedNSBafGZKUOWACbMX,CBFDXFDBLECCRDGF...EFAEDECF..JBBA..IDEAhAAAFBHDdGGFBEGBGBEBKFDAOFADhABA.ACCGMADEhACA..cBACgGGG....hAHA......hAIA...,2,-43,-25,18
EVfQCYTgWcJBLePXHFINKaRZdDOUbMAGS,EDAFQFDH.CHBF.TFCH..gAEDJCFABADHLCBHhAAAeEDEHCGDFDECIDBDhAAAKGHHaGACdFFBUGGGhABAMIAESBGE..fHEHhABA.....hACA.WBBG.,2,-17,-9,8
BNcQWXGgSHVAZDaPefEdOTRIFCLJbKUYM,DGDEeCCHEAFEdGFF.OHBERACG..CCFALHCAJEDG..UBADhAAABEEFQCGBhABAGCAEHCCDZEAFaBDA..hACATGGH.FDHHKEHHMAIFWAFESBAFhAAA.AFFC...hABA...,2,-16,-13,3
QRCZFVNfSTYDPIKcBWAUbgMOaXEeLJdHG,UCBCMCCA.ODGDEEEGLABAHEEFGAFACCABZGCA.FHBG..VAFEhAAASFBC.TADChAAADEDFIFAHhACABHHHADIHaDABXGGF.dDAH.....hABA......hACA...,2,-16,-14,2
QBYOHIeJKGLDFbUMdETgVRNASCWPZXfac,CFEDZAAD.aDCABHAB.OCADHACCJFHB.KAGBDBBG.FAFAUGAA.hAAAdDGDEHGE..TFEFhAAAVDEG...ADFDSHDGhADAXBGA..QFBE.hAFAICCA..hABA...,2,-47,-17,30
LVNFRPKUfIEOBXaCZQTDGdSbAMeWJYHgc,eCHDJGEAHCAFLDFDFDDC.KBAGUGAA..EGBGBHEDCEDA.QCFEhAAADBECSGHFhAAAACCC.MIDE.gDABhABANABD.fAHEOAFC...hAHA......hAIA...,1,-22,-35,13
WVfBIRTHOcFbeDGSgdJAXQaLZUMCYKPNE,XFCAQGGDZFAHCHBD..KDCGECHF...VAEGBDAD.IDFChAAAHGFAFBAF.eDDAhAAADHDESACGhABAdCCBaFFG.MFAA.NGCH....fAHGhADA.....hABA...,1,-10,-35,25
ecfRLIgHPYaEbSVdJGBAWDOKTCQZXUMFN,DEFHKAADQEBDUBDA.FCHBeHDA..RFEGLFHBHBFGaEAESEHFhAAAJBCHGADFADAHhABATBBEZGCA.MGBAhABA..NIAB.IHAE.....hACA......hADA...,2,-20,-14,6
KDSNRJZgeYAcOCPbMLTIVEadUfXQHWFGB,OAFBCFDG..MDBBTEAGECEF..UABBXEEFHAGBFGGHBGHGhAAADCAHSHEGhABA.NDDA.JEHFZAGDeFBHhAAAACCB..PADDLFEBICAF..hACA......hADA...,2,-25,-21,4
CFfKBTbROJScIMPLEQaVDeYUGHNgdZWXA,FEGDBFEDRCBC.SCFE..IACBLDDGEEADQBBGhAAAaAHF.DIECeGEGhAAAGEBAHGBANABFgGGEhAGAdBEFXCFCCHAFfDHAKBAF.OAFEhAIAMIDA....hBAA...,1,-9,-19,10
YQfgbKWHGIARcedTOCFNaZUMJDPVSLXEB,RFDFdDCDOCDHCGAH..FDFGZBFHUAEHDFFE....SCBFhAAALAACBHEGQFAHhABA..fGGDhAFAKADHWFHH.HFCE.ABCFeHFG.aEFEMCABhACA.PBHD..hADA...,2,-30,-26,4
XPEAaBKRMGVZJDfICLQYeNOFgbHdWSUcT,aEHBKGFHGBECZFCE.DCCGCABELCCH..QEBFhAAA.eBAHNAACOFAHhADAFFGA.HBFEdBHE.WHDGhAEAcGAA..XGGAAABC.MBBFfACFhAFA...hAFA...,2,-26,-25,1
VFJDgNebOLWKGTHQBcPZARdaUMSIYEXfC,RFEEaFAAMBHD..SABDECCB.CEHC.VADGDDGC...eEEEhAAAODBALBAFKAHFHFEDhAAABHHHZBEFUGAAXGCHhACAFGDH..........hADA......hAEA...,1,-16,-31,15
VadCHOQUNIgEMAZcTLfSbFYeWPGBJRKXD,TFDHSDCD.FABDeBBDGGCBBFCCKAGEXAFC.DBEFhAAAdDGACDHH.OBED.hABANEBA.EGGDMDIBAIFAcGAFhACALBDD.fHGFbDDA.WDAFhAAA......hABA...,1,-20,-25,5
NWXGEdbaHJOKIPcUBLVCFYSTfMgZeQADR,RFDGXCBCGCCFEHGGdGDCHAEE..KBAGIACGUGAHLADChAAACGHDFEHF.SFBChABA.MEIBZCFBAFDADEHBhACANECAaAHF...PEABBBEB....hAAA......hABA...,1,-13,-20,7
YPIUNSeZMQGBdRJCbTEXaDWFcVfOgHLKA,..IFDGSBGAZFGFGBCDRCEECGFD.EFAEXECE.aDAEhAAAFGEE.fCBEhAAAHABEAIAGUGGENAEH..MIBGhABABAGGdBHEbFAC.DADE......hABA......hAHA...,1,-10,-18,8
FAPZHGWSIgeBMCURNbXaDdLcEVKTOYQfJ,ZGFGHEBHSGCAeAFACEFCRFGH....XADHDCGDdBBFEDDF.KDAChAAATCADQAGEhABAfDDF.AGDEPAAEhAAAIFBFBHEENFEBaACAcGAC..YFAFhAFA...hADA...,1,-17,-18,1
TWGUPHVaOMINdAYQRZgKBCDEJSfFecbXL,REFHZDAGBHEHEAAE...SCDCFADEeCHB....XFCChACATCGBUFBHVGFEMFDChADAIAHDACDC..gAGChAGAKCBHDGIFJAAC.fDEA..hADA......hAEA...,2,-38,-12,26
JYXeUIAVgaPQcEdTNbWDBFZfLGKROSMHC,VDAGaHBG..QFDEEEFC.dBFHTAFG..NDADDACGFABBZFCDhAAALDFCKHACOCCGhADAMFAHJBBGeFGFAIHE..hAEA..gFGC.....hAFA......hAHA...,2,-21,-18,3
fgYUeGKLcQOSBNFWMDXIPEAHCbTJRdaVZ,CFDDTDACRAEA..dEEBaGBFZCEA....fAABUBAGKGHDLEABhAAAOFHDBEGE.hABAFFEFMICGICFAhACAEFFB.AEDEbADC.JBHH.......hACA......hADA...,2,-34,-15,19
gSXGTFLOeAZWMJbIRCBVQKUDfcNdaHPEY,ZFACJCHD.RCBGBHBEKAGD..DCFD....fABFdEAF.HCEFhAAAECCASFGDhAAA..XGFChABAGEDEFFADOAHDAHCFMBCECBFEQEGEhAEA..NABF.aGDD..hAFA...,1,-24,-35,11
NbOgYZIdTfCLSJEcGeaXAUMPFHRBKQDVW,MFFFFCFCBCCDDCEG.....VEDD..NEBEOAHHZAFCdGAGCACDLEDFhAAA.SGHBhABA.EBBH.hAAA.cGFGeADAAEAHPBABKEFC..WDCFhACA......hADA...,1,-33,-45,12
dLIgEZRMcQYaJGSePXKAFNBTWHUbVfDCO,BFEDHEFHUGDF..bBABVAAF.DADFOCGBLAFHEHACMAEGhAAAQEAE.JDDFhAAA...eAHBKCCHNDAAhABAfHGFCHGEIFCG......hACA......hADA...,2,-39,-6,33
EXIGNUCgKFdeOMLYcVBJHPfRAWaZQTSbD,aCFCQDCB.SAAFDFBHEGGBGDAHCDHB.FAFCOBFEhACAMAAFLEFGVFFABDAEhADAJHCA..PFADhAEAABCD.TBCG.IAFD...hABA......hACA...,2,-33,-12,21
HXdaSJTMBKFfDcYLGCZNUbPQIVOeWEgAR,HBCDdFHAJAAGMFHD.BHEBFFEB.DGBCLEABCBFH.ZCEAUBAE.hAAAQDFFOBCFEHBAhAEAAIDA..aEBCKAGA..hAFAfHAF..cGFBYAFChAAA.NCIE.....hABA...,1,-29,-30,1
bJfTABeWOHVSaEGFCgcUXdLNYQZRKIPMD,BAFBeEEGOCCHSDGEGABFFAAF.CCHG.UBDGLHEE.QGAEhAAAKHGAMEEHDFFChACAfAFDABHGHDAGaHAEhADAEDFG..XFGE......hABA.dCAE....hACA...,2,-32,-6,26
WbRBOCaQLJIETYHXSdAfeNVcUMKgPFGZD,eGEAVAAD.MEBB.KCCDFHDA.GEEFDDEDRACE.BCFF.CEBFLAEGhAAAICGG..TFCHhAAAXFAA..AHABNCFGhABA..gCDD.WAHHOHBChACA.JAFA....hAEA...,2,-26,-23,3
PbcDVLRZJXNFeKIQBWSTUYMdgEHaCGAOf,OGEA..fDBD..cCEBLGDCZBAHJHCChAAAXBGH.FBEHIACGhABABGBDSAAChADATAGCMEFGdEFDEFHFHEBCCBBHAAIHDIGGNFAF.eFABhAEAWHAG.....hAFA...,2,-21,-20,1
TDOaWLNZYVGfJXFcKBUEgHSIQdbRCMAeP,eDACTAFBDEED..OCFBaDFH.LDBGZFAGGACHJBBGFFHFBGHEhAAAUFAFEGGB..SDHFhABA.IHBDhACAdGFECDHBAEGANAAG..fGEAKHCA..hADA......hAFA...,2,-27,-19,8
XEFKUgZDePHQGdMVTBfaNCIROJcbAWLSY,SDCDEGFCUACBZGAAeAAH.HGFEQDGGMDEEBFAG.aAHHhAAAIDDDREFE.JAAHhABAcGCEAFBFLAFEhADAFAEFDBDFdCFG..fGBFCHHH...hBGA......hBHA...,1,-5,-18,13
RAUObSNHMLIKeYXVfQZWGCEaPTcBgdFDJ,UDACSDCDHGDEMBIDLBFH.KBBAeCCE..XFFHhAAAQGBAGGABCFFFEABFhAAAaDAB.PBEBBAEAdGAChABA.DGGEAIEANAIAIHHA.fDFFhADA....hAEA...,2,-16,-15,1
XBIUdLabfOgJNTPRZDECeFGcKHMWQAYSV,SCFCXADCBDFHUEFELHFA..aDCDOGAEJACB.hAAATCADREDHDFIBeAFEhABAGDDAHEABMIBCAHFB.IBGEhAAA.dFGH.fFAHNIAF.hACA......hAEA...,2,-22,-8,14
cCfFLKXUDWgGaBMETZObeHYQNJPIdVSAR,CFDDLCCHKGFA.DAADGAAFMHFC.ZCDHOBEHHCFH..QGBChAAAJFAD.dAHGADGHRAFAFAFBhABAUEFFaDAHBEHA.hABA............hACA.EDAC.eHCGNIDF.hADA...,1,-15,-26,11
JVIMYeXbDCRZQFBWTLfEdSagNAKPUGOHc,UGBCGGDHODAHJACD..MBGFeFFEDECBCEBB..ZCDEFEAB.BHAHhAAALHEA.dACGSFEEhABA.aCHFhACAAEFCPBHF..cBDD...hAAA......hABA...,1,-32,-35,3
ZSWVDPIUfYcFAGOQabTgKBNLdEJRHXCeM,GDDCQAADaAHH...TFCBKDBGBHHBdCFFEDCHHDGF.eADChAAAZFFFSEEChAAADCADUABE.cDABABGBOFCBhAIA.NIDF.LADE......hACA......hAHA.JEHF.,2,-12,-9,3
PgKYSRDdeTNUCBZGJFOfWMHVEQaLAIXbc,XCBC..cBDGKEFGRFCD..eAFCTFEH..CBHCBACDhAAAZFAFGDGGOCFCfGCBhAAAMIFCHDCCEBAHhABAaFGEAAIBICFA..bFAFPDAChACA.SAHDhADADADE...,1,-8,-22,14
VXbLcSKdfYFBAJZHUOeWGTgPIRCNDQaME,JDACHBCD.UFCEeEFCGCAG..PFBFIFHA.CHHADCGFhAAAMBBE.EAGB.XEDHhAAALACE.SAHBhABAdFHGfCCBBHBDAGFD.WHDA..hAGA......hBAA...,2,-26,-24,2
NPBYeVOKQDgHZEUcLIbfFadARSXCWMJTG,XCCBCBFD..JECGGGAHBBDE.eBFFKHAC.QEGBhAAAHBACEAGE.LFBE.hAAAIBAGFDAFAGFASHEAhABAWDAFMAIFTDGEYHDG..DGDBhACA......hADA...,1,-2,-42,40
OGSVPHdaDQNRfZKIBFcgCETAMeWYbJUXL,eCHD..bAADJACGLDHFGFBB.VACGHAFH.dCCEDCFDQGGDhAAARFAFKGDCBHHHFEEECDDH.hAAAABAGMAIF..YFFBhACA.OAFAPCAH..fHCDhBAA...hABA...,2,-13,-13,0
ZELbWOIKSQHCPfAVBMdaFReJXUcYGgNTD,VFBHdAGEaFAF..eEGHUDDCGAEG..TAEGDBBALAAFhACAOBBE.IAGFhADAKAADHGFECEDFADIFMDID.FGDFhABAXGDD.YEAD...hACA......hADA...,1,-12,-23,11
AOdFTDPgXBcSbUCRJQMLWNGZeHKEaYfVI,OEGHFFAADEGC...XECBSBEBCGBE.RBCD...MAFFLBADhAAAGAACHGFAaFEFVAGFhAAAAEFBTGCE.BHAGhABA...cAGCJADFNIEFKGADEFGE.IEHEhACA....hAEA...,2,-19,-17,2
WEVBeCdKGfQRbNJDFcOIHXSLYAZMPaTgU,ZFACMHFGaABHUDAC..EDDEeAHD.CGCB.dGFBGACARBFE..JHAAhAAAFEGFOACE.HDAEhACASCEHAGEB.hADATGAHWFFE.BABA.KAEA....hAAA......hABA...,1,-16,-28,12
RBHIQOaCNPfUAdEYLWgVKSDZMbGTeJFcX,dAFBLCCH.VFDEDADBMGCE.GCEDeBFDFHBCREAAHGFAOBAFhAAACEEB...PEAHhABAfAAC.AFIDECAFhAAAYDHBKHCE.bADB......hACA......hAGA...,1,-18,-21,3
RGdFSMZEWPHNTVLaOgfKbDBQYUCAeIcXJ,eGEAXCBCRCAD.FEGDSHAE.ECCGPCED.HEAChAAATAGFaGDE.ODFHhAAAfCHEKDGEBFCGUAGFhABACHHHAABCIACF.JHAAdAEA.MBBE.hAEA......hAFA...,1,-12,-16,4
UCZTdQSWIeBNJPaVYAfHFOXDGcLKMEbgR,HDAGFGDDDHAGGBFALBFGEBAERFABZAAF..QFGH.SAHBhAAAIHHENECDJEEHhABA.aADAAFDC.OHCEhACAKEBDMGFG...UACC.CHFG.TBDChAGA......hBCA...,1,5,-34,39
QXFNeOSVBLCERYJKcaGMbZDAUPfdWITgH,UCBCdHBH..ICGCTDFB.HDDD.XBABeFCBSCHBhAAALADECGHBRBDFKGGF.hAAAaAFFbFFHDCABAHABfEBBhABA.WCCE......hACA......hAHA...,2,-30,-19,11
dPHKLBWJaYNUDFeESZTgGMbAOIXQVfcCR,ODACXCGC..VGAGCFDB..dCBAKFGEBAAE..JGDAaFHF.hAAAUGFHDCFHEBCCZACFGGAFhAEAAHHF..QAGFhABAfAGD.PAEDWACC..NFBF..hAIA......hBAA...,2,-32,-25,7
VfMYQeBJbdUADCgPWKEcZFGILSOHTNaXR,DAEDCFDG.....PFGFECGAZGFG.GDABSDCHOBBGHAAChAAAaFFC.RAFC..MFIDhABAQGAHBEFCJHCCdAFBhAAAAEEHKDAFICAE..TCGC..hADA......hAFA...,2,-23,-21,2
DJTcIHKbUfXGedLOVYESCZWFANRPMgBQa,RAADMCCAQFBCDFGB..JAHB..IGFGKEHD.UDEAXAAChABAdAHCLHEAhAAA.OCAHEDAGCHHEFDEEhACAAECAPDHHBGCHaDDB...TFAA.hACA......hADA...,1,-20,-35,15
QEeMOFbXIYRDSKUZAfNBCLcHTdaGPJgWV,BFDGCAFBHFFBaCAHGCCG..JGFCVBAH.eHBEOEFE.FHDEhAAAICFHRAFE.KAHFhAAAADHGLABFdEHA.hABA.gEAGEDDBMFCDXCEEDEFF.hACASFAF.hADA...,2,-26,-8,18
YeVNRZSTKWLJCDgUfOEXMdGcBHIaQFPbA,eFBBVGFG.REDHZAEG..KDDELAACCBGC.UCFFOCBF.EDGAhAAAdHGFBBACIBBDhAEAQFCDFDCBAGAB.SEAFhABA.TADCDAIBfFGFhAFAMFEE......hAGA...,1,-22,-25,3
dAXRGQHPLaDOUcIWNBCZYFbSfgJKMTeEV,RACFQCCFHAEBLBGHOFCAUGAA..IHBCBAAFCEEGFGDAhACASEAB.fHEHhAAAKGGA.TAFAhABAEEAAAAHG.PEHHDIFA.cCGG..hACA.ZABE....hADA...,2,-27,-19,8
LRDgZXESAHQcPVTKOUJMCGaIdWbFBYefN,QFDHVAAD.KCEHUFEC.CCFCGDBBaCGFdABAFDBD.BAEFhAAAeFBFLFFBDAHF.hAAAXGAAAFIFHADE..hADAcGGAOEHDIDHE....hACA......hADA...,1,-22,-25,3
JZIQXgCWLOHbUFVBTPAdDYGeRcSMafEKN,dHFHDCECeDBCSEDE..aHEGECAHKABDJFBCZCFG...QGBDhAAACAHEOAAGHBGDhAEAFGGABAEFAGAA.REEAMCADhACAfBEA.XFGE....hAFA......hAGA...,2,-30,-23,7
VbdSROCcQUGBTNMEgXeIFZLKaWfAJYPDH,JGEADACBHADB.dDHGSDGFCCGC.UCDETGFE.EFECXFBDhAAA.eAEEhABAFDAALGACKEHH.hACAaAAFfBBGADDH......hADA......hAHA...,2,-41,-27,14
cTSMVWRZLCbXGaUKPdJYNOBgFeDHQAfEI,EHBGTCBC..SGFDMGCE.RDBFZAAGLDEG.CAGAXABEhAAAaFEGKAFBdDGDJEABOCCAhAAABGHB.FAHFDDIFAGHA.hABAIHFH.WCFC.....hACA......hAEA...,1,-24,-28,4
XebJLFABQDYgaPGSCdZfNKRIHUMcOWVTE,BEFAQAFBDCBA.aEDASGAE.ZAEFfFCAhAAA.KEAGIBHGhAAAMBABcGEBOFEHWCCAhABATFGH.EECBeBBEbCAC.FGAH.ACIF.PABChABACEGD.....hACA...,2,-26,-20,6
FJHCSMEfKDZNTcYGbBIgXVOLadPQeAUWR,REFHFDBDCFDC.EBDD..KFABDGIFZCFG....TAFGGAACBFHF.hAAA.XADHVFCBaFFFhAAAdAFF.QGCBhACAAAEC..WEECSFHHfBAHNIEF.hADAYAHB..hABA...,1,-18,-43,25
cGSPQXVIRJeLANZgdUEMWYFfDKOBCHaTb,ZAADUGBCMDCEFBCB.DIAABCEH.HFEG..aAGB..TAGEhAAAbFGF.SDEAhABA.QDAGhACAIBHCeHDEAEHD.gEBAWEHHfHDDhADA.CAEC.cACEhAAA.XEEF.,2,-27,-14,13
QMOLeUKXTDcVdPNgZIASWJbGFYERCHafB,JCCHFGAHREFHHGDGBHCH..QABHLCBHUBEFKHBADIGE.dDGE.hAAA...PCHFhABANEAGZBEF.AFEA...SBGAhAAAbDCD..EACAaGBG.fGGBhABAMAFE.....hACA...,1,-13,-30,17
UJTPLaNRWgXQEGVebfOdZIYCSAFKMcBHD,MIAGHDBHJFFFLDCBRAFD...XFEGQACGEEAHGADFhAAAeHBGOEAHdDHA.ZDFAhAAA.CDDBABADKEEC.DBAD.hABA............hAEA......hAFA...,2,-22,-20,2
KGTbNJIAMVLFcDgHQOeSYCWdRXBUfEPaZ,LAABFHFGDAFEHCEGeEGH.CFDD.dABCBEBBEFEFZDBDKAHB..GCCFhACA..NBIC.AIFEMEIDhADAVACE.QGBChAEA..SHBG..WEFF.hAAAXAEA..hAFA...,2,-27,-23,4
ANRfDbJZeLdKWGEHcPUTSQXCYBOMgFVaI,RAADDACBZDEBeAEDKBHF.GFABHECD..UGACTFFE..QACEhAAAXDDCBHCHMEIBFHFChACAaAFFAAAF..fAEFhAHAJBHHdDACEHEE........hABA......hADA...,1,-12,-19,7
gXTBNGEJDVAIfWdSOcFLZabYHQRMKeCPU,..IFDGfAFBdCFE.ODFAFAFEZACDaGEEHFAH..QECEhAAAKGHHeHEGCCAHgACHhABABGGC.EABFDDHDhAAAAIECSFFC.cBDD..hAHA......hAIA...,2,-28,-24,4
RZgBUWSVEHbLXTYNGfKdcIeCMQPAFJODa,JFFBaEGCZCDBBAGC..UAGG..VEBEEDBFLACE..hAAAXACGTFEF.GAEEhAAAKBCBdHGBeHBEMIBGhABAAIBCDDAA...gBGHSGBAYEHBhABA.NEAE..hBAA...,2,-24,-21,3
TeXgRdDCAJUFEcBVZHGQfMOaLbWPSNIKY,UAADFAFBECGGBBDE.HDGFQCAG.MIEALDDE.hAAAbFAESECChABAKDACeBFGRFEBCFFHABBE.JADF.ZEGBhACAfHABaHBA.NAEB.IDFE.hABA......hADA...,2,-19,-15,4
eDBNYRALISCEOgfKbJVPXTQcHUFZaMGWd,SDCDOCAFKEEE...VADF..TFGCHDEDUAAEFGDBMDEAhAAAGGAH.eFHDhADADECFBGADNAIEAFAD.LCDDhABAEHEA.fAEBPBGD.XBBBhACA.....hAFA...,1,-7,-26,19
ODUSCMLVTaFYAJfeRPHEXdKINBGWbgQZc,JEEGeFBBHADAEEFBKDCEBFDG.GGDB..bAEGQCDFhAAAZBAHOHEESBHHhABALCFAaEGAFFAHAEIH.fBBChACA.XDAAIACH.WFADhAAADGCF......hABA...,1,-6,-24,18
fdCZBOXSIFWbDKecRMAGaPVTQJNUHEYgL,aGAHTFDH..JDAGHCCA.EDFCLGDCCBGAZABABFBASBGBhAAAFHACDDAH.eDEG.MDIHhABAABFGVGFEUACC.fFBGhAFA.OFHH....hAGA......hAHA...,2,-22,-22,0
PZYULJCAFDRSWOQBcEbagVMKHXdIfNTeG,DEFERDAGOAHBBAHE..ECCB..aGEE.MGCCXEBD.dADGIAFDhAAA.TDFEhABAPCABZACHUFDGCHHE.hAEAAHBDSBFG.QFGAhAAA......hABA...,2,-38,-27,11
EDdfKJCYUPeNSWORGFHLXZIQTcgMbAaBV,BHCHEGGEdEAAKFBB..CGEE.UBFC..eAFASCDHRCGBGDCHHAAChAAAZAAD...IHFChABATACEMICA.hADAAGCHDBIFfEHE......hAEA.PFEC..hAFA.OAHD.,2,-28,-16,12
RgTacBPKZUDAbCWHVMSeQOdJFXEINYLGf,CFDGHGFG.VAEDeCCEdDCEFAAD..EGDD..IEHALBBDREAF.hAAATEFFBCHEKFFBZAGFDAIFhAAAAEEB.MABEOAFChACA...XGCC.....hBAA......hBDA...,2,-35,-9,26
HeFRNTZWLEOBYKVJDcaSgfQAbGPXUMIdC,GAFEXCGCUFGHdFHEHFDAeFAH..RABEZFEFEHEABDEE.KAFDJCCFhAAAaHBE..SEAFhABAQAACAHDBMBIFhADAIEADCHHD.FECG........hACA......hADA...,1,-15,-20,5
APXQcTbeIZGJUCdaYHFgEMDLBOSWKNVfR,XCGCQCGC...TBACeFFDIHHEZEDAUGABaGHFHADGhAAAFGDDEABC.MBAFDCFFBAEFhAAASDDHKAFAfCDEhABAABHAPEADcEGBJDBBCHFC.dCCE.LHAAhABA...hACA...,1,12,-14,26
DLOHeNPUTRZfAaVCYQEMKFGJcdbBIXSgW,CCAHEGFCFGFAGCDB.dAEBBDHE..SDAADBEAHCCGeHAChAAANEEE.UCFC.REAA.fBAFhAAA.AABCaFFGhADAQABE.MICAKGCFcAGDhAHA.IHHAWFHB.hABA...,2,-34,-14,20
YHMSXZTFNWUObRVGLEaQBfcAKgPCJDdeI,KHBGCFDGDBFDeCFE.HECFMFADZCBD..FDDCUGGE..OGFEhAAAbAAF.GBAHLADChAHAaGCCBEBEAFFHJEFA.dBGESDDBhAIA..NAED....WFFChABA......hACA...,1,-7,-39,32
VOMRaCZDbWQTSEYcKJHfXBLIGeUPAdgFN,dAFBFHBGOFFFRDCDZCFG..DEAFQCGB.ECBCKFHF.HBAGhAAABECDLGCAeAFEAFIHVDDEhAAAMEBHCADD..bABEhABASGGD.......hACA.JDAF....hADA...,2,-29,-14,15
UEVbXJAKGcPFSIWRgeYTQNCDaBLZMfdOH,GEAHFHBG.SAACIAAC.RGEAeDDGQAEBDHAC.aDFHBBCDhADA.LAEEhAIAMFABOCADUDGC.EGED.hBBAVBGF...XCCAABID.KACF.hBDAcGGH...hBFA...,2,-19,-13,6
FWGCAYKTBEdHMcVDJQeUXIOaRLNPSfgZb,TGBCBEFAdABF.MIAGDDGG..eAEBUCBGOFFGLBFG..hAAAPEDFSGBEhAEAfAGCZEGBFDDACAAGACCE.hAFAKDAH...EGHB.......hAGA......hAHA...,1,-24,-33,9
HMSNWBEfYCPLUDeROTcVQgGKIadbXFJAZ,MGCESHBGBEEB.EACGCHHG..LCAHDBGAREDF..OCGB.hAAA.TABFVBAHQFGEhAAAgAEDIHABhABAbAEBFHEE.AICCNHCBfECC..hABAPDFA.cDCBhADA.aAGF,2,-25,-17,8
TAfPdbCIJQSZYDcRaFUXNgGHKEWOLMeVB,dHBHCFDG.QBFHSFFAZACDDIGERFFEFAACUEAG....XECGhACAGBDBKADC.EHAGhAAAOEEGMHEABCAEhABAAGAD.....bDECIHFA.cAEGhAHA....hAIA...,2,-31,-26,5
eVgNdWfMcKLZHPXSEDYIFbTUOAGQJaRBC,GDDCQGGDaCDBBAECCHDH..eACBVCFEdEFF.MCFCLBFChAAAZADF.XGFAhABASGAADBCDFHAAbBADOFBAhAAAJCAB..NEIE.fAGB..hABA......hAFA...,1,-10,-16,6
LKQMRAVYUdDbcFOGBCESNJHaWgTZeXfIP,UFDHdHFHDBBAFCHHBDED..EFBD..SGEEHABCaAGE...hAAATECDXAEB.hAAAICACLCCEKGGDhABARFABACGCVCDF..YDHF.cCAChABACHAG...JAFG.hACA...,1,-19,-29,10
GdFWEIDUZXScgNHPLJfVaYBQRKAMeCbTO,CHFDTDACdEFA..FBFHEAAD..DADGZACB.XEFD.SDHFhABAgDBBPAFEhACALHBG.VAAEhAAAaFHDQEDC.AFCAMIAGeAHDOGBAhAGA.IGHFhAIAcFACNIEF.,2,-28,-19,9
MLSeZDbXOUNYAJIHgGaWTfKREcVBdPQCF,JFBBHAADGADAaDCE..TCFGKCBA.EAGGBGFD.dDFGCGFHMCIFhAAALAHHZGBADBEE.OFCEhACANDAE.AHIBICCFhADA...fEACREGFcAAE..hAEA......hAFA...,2,-34,-12,22
dNUBaJCVWgTAebSXDGfRKEMcOFZHLIPQY,SDCDGACBKGECMCCFOFHF..ZFCBLAFE.IHFBhAAAPFAFdGHCUACEBCABhAAAaDEE.CDDG..VCGFhABATGCEAFFA.bBABDAFEfEGC.cBGFhABA....hBEA...,2,-25,-20,5
EWMTaYOHGCfDZSNPQVbRLAXKIedgBJFcU,KGFCdDCDJEFEFCEG..UGAE..EAAC.MFACaABA...HGBGGBBChAAADIAE.ZAFA.SGDFhAEAQBGFRDFAAGIHIGHHhAAA.gAEFBHFD...hAGA......hAHA...,2,-29,-26,3
NdOXIDHKGPeLRgZYWQMfbFBVcJESTUaCA,OCCHXAFBDAEEGCCCLBDEZCABQGFE.MAIDhAAAfDGEBGDAJCFFTFEDhAAACHCD.AABBNDIAIACGhABAKHAE..eCAF.gDDHhACA.WHDG...hAEA...,1,-21,-23,2
VCONLbSJBYWTXAgKIPfUdGacRDMHZeQFE,KHBG..fDABGEDGaAFEDEIFZDAFQGEHFFFA.ECGACCEDOACGhAAALFBF.SEGFhAAA.BCDEhABA.TAFCAIHAIDHEdBCCMEABeCCB.hACA......hADA...,2,-32,-16,16
GXHUeFBSPEcaVZgbJNMKCdRLDAWTOYQIf,TDACODAC..QCFFGDEGUGCGFFGABHAFEAGG..aBCHVGCGhAAA.ZACH..gADDhAAA.NEHACGBGhABAdBGBDFIDABCHIHHE.fEEEhABA.....hACA...,2,-22,-21,1
KUHYCEPLNaGIedMTgZJcVROSQbWDAXfFB,FGFCBFCFUDAFHDGB.EBECLBDGGGEHeBGFMFIB.ZCBC.JDAHRDDCOHBChAAA.QCGAhABADIBAfACChAAACGAB.NAIA...IAHG...gABFhAEASDEH.hAFAAGAF...,2,-29,-6,23
FGHBdAESOJZXPLIeRNYDQbcafMTgKVWCU,EEEDOFFBZFBCLHFARCAF.DBCHQGAH.aHGEMBADhAAATCFFKBHFCAGFGADGhAAABCFBAGGCSAGBhABA.JDHB..........hACA......hADA...,2,-47,-15,32
NAJbGBMORaTdZKSfgPXWFYUECeDHVQcLI,GECFOHAGRCCCaDGGZFGBKCEE....SHDA..PABAhAAAFFCEEDADeHCAHABAhAAAQFACLAFEAGGFhABA.BBGCdHGFfAGF.XBBGhAFA....hAGA...,2,-26,-15,11
cFVfQGTeRKXZAgJDPHYSdUIaMWNObELCB,JFCHHFDG.dAGBUBGGMCGF..OFHFLFBFBFFDVACB.QCAGhAAAeCDCRBABKEGEAABFDIGEhACA...YEHHhAEASABB.aGAHNAFECHDGFADC....hAAA......hAFA...,2,-37,0,37
LWfZTaSQPeUVcERKYXNCdBHJIDObFgGMA,LGEAZAADSHBGQGAFUDEG.EDBEKHEE....XCFAhAAANEAA.CFBFBBCGhABAHEBFICCDOADCgEEBhACAMDHDABEEfBFFaGCD...hADA......hAFA...,1,-23,-26,3
bLAdZYgMVPcefTNEKGOFQCJSHXWBUIDaR,dCFCZAADMAED..PCBAeFBB..TFFDKEGGFHCA..CFDDHAGHhAAABHGGDEAERCEF.AHAD..hADA.YHFG.hAAA..cCBENACFEEEDOBFASFADXEBAhABA....hAHA...,2,-45,-2,43
aXAWBQbCfUKDHZYVFENLcMgITdOPGRSeJ,QGGGCFDGKAGE.DDECZBEDFEEFEDBA.LCBCMEAF..TFBAhAAAOABEGACD.hAAAeHCAaEFEAAECBBAAUCGFhABAYCAG.NAIE.IHGE..hACA......hBAA...,1,-10,-35,25
IbFZUNJBOTLWgPGVadYMEHfeSXKCcRAQD,QAFBDACBFGHBZDAA.UDFDBGCBLDDB....PEEBhAAAVABAaGGB.MHCAhAAAHCFC.eFBDKGADCEAAABAC.hABANCIE.JBDC.....WAFE...hABA......hAEA...,1,-21,-34,13
dZfTQaOMUeKcSFRWEABGVgHNPILCXbJDY,BBGFGEDHHEEB..ICDFLBAGCAAF.JFBDdEAEZCBG.TDGFhAAAaHDEMADE.KGGESHGGhABAFBHF.EADEhACAACCB............hAFA......hAGA...,1,-25,-37,12
LFUZEHQCWXAMNBebaOTYGDRPKJScgIfdV,MBFHBAFBaEFD..TCAADDHF..KCACJGDE..SEDFhAAA..IHAAhAAAfCEFdACBFDGFUEAHhABAZCCFQGDH.CHGAABEHNECGOAFAhABA......hBAA...,1,-30,-36,6
CJXDTNaZcMHWRbgIFGUELSdYOQKAfVBeP,BFDDeAFBCCEDJAAC..DGHF..aADFZGAGHFFBREEA....IBAGhAAAFGABEAFFdHCF..hAFAQCBEACCA.hAHAPDAB.NEIA.MBID.gCFFhAIA.....hABA...,1,-29,-37,8
MRFcbgIWALZdEUBOTSHDNaeYKJPCfVQGX,LDCHZFEEdGBEBAFBODAHHACDDBBG..aEEGeHCA.KGHBCFCEQBFBhAAAMFEG.FEABhABAbBEE....ICABhACAAEBAEGAFSAACYHDG....hADA......hAEA...,2,-31,-20,11
TQfcJMdLSaOHgRUDFEWCGbBVZPANYeIKX,eGEAXGBCQAFB..JBBBdCCDLFGFSDEAOFHDhAAAgDADDCAFFFDCEBFEhABACBADBFDH.VGAEhAAAACFBNEED....IAHF.KHDA.fDCFhACAMEIDaHFE..hADA...,1,-8,-31,23
XcJgBVASGHUKeLQYDFWOPRCTIZMEaNbdf,SGFHHCDFKGBEeCAHQDFAFHGE.OFCACAAEZCFA..MACChAGAECCAaHAE..dGEGfDAEhAAAXAGE.cCEGhABABCCAAFHFLACEDFBE.PAHD.hAHAIGAF.NEIE.hAGA...,1,-17,-18,1
BfXCFLMJbQUDadgeVTRcGSYNKPIZAOHWE,OFBBHDAGBGAC.CHGHLHCEMBEBQGGGUCGA.DABHdACGeCHDhAAARADC.SFCHhACAKGFEZEFA.AEFFEGEHFAABaEDDhAEATDBE...YADC...hAGA......hAHA...,1,-12,-16,4
SHgJEedFVOQLfWRYXIKZGcaTbNBAPUMDC,MFFFDFEACDFB.HCFC.JDAFdEAA.FHAG..VBCFOAFGLGAAhAAA....fECFhAAAYABEXEGEhAFAKGHFZABF.aFCATADCBHHGAHGFUGCE.EEHBhADA......hBAA...,1,-8,-35,27
IOQBMDRWVKdcEHNYCaTGFbZJXSAPgUfeL,UCBCeEEGOHCAQGGFDDAC.RFBA..KAFHEABEHBDB..NDED.aHDChAAAFFBGZEFE..SAFChAAAAAIF.fAHChADAIACEBHBGWEAF.cCFD.CEAD.hABA......hAEA...,1,-17,-30,13
YGHVLIFQDPJONKSUCEXBWATdRMfacbZeg,RBCFMHFG..aGHBZCCCeEDAGFABHCABLABGFAGGDADE.OBHDhAAASGCAEFGABHAFAGFAdBAFhAAA..fCAChACA.bBFBYCFE.....hADA......hAFA...,2,-17,-15,2
JbFXRVWCdSDMeNBaAKgcfPEYQIOLHGUTZ,KHBG..fGFCEACGQCGEOACGLCBGUBCDZAFEJFADXGDBhAAARFDH.CGCGDGABhABANEABBAFB..gDEChAGAPFHB.IHHG....hAHA......hBAA...,1,-23,-26,3
QUILNcAfWXPCdGHbaOTEVSRMJgBYeKFZD,XCBCdEGDHDADaGDD..EFAGRCCC..MFADBFGC.KHGEZADAQAGHhAAAUGGA.LDEFhABAACACPFCBCFCEOACGhAGASBHH..JHCA......hAIA......hBAA...,2,-26,-15,11
XfCJBOAQeLUVPDHbaMNEIYGWSZKcgdFTR,QFCAeFCAUFGDDAIBaAGB....MCIDECEGGDBBZCADKGFAdAEEhAAARBAE.CDEC.BHFDLBAChABAHFABIHDEhAAA.SAEEFEGFfHBBAHHB...hABA......hACA...,1,-16,-17,1
GCIaUZfHbWDTgRSKAeMENLYXQJFcBVdOP,EFAGLGEA.QCAGFDGCBHHHVFEHOHBE.GCFA.hAAACBHFUDDAHADCDABERFAA.hAAAABBGeDCDMAFGNBBDXAGFhAEA.dDDB........hBAA......hBIA...,2,-25,-9,16
LdTDWQONZFeEHACbJYVKgaGIfcMXUPBSR,CAFBJGEAKBCHGACG....IFBGMHBC.UEGF.BHGGhAAALEEE.TAGHhAAAQCAHNABCZAEBEEABhACAADGAVEDF..aDGAfBEG.XAGDhABA...hAEA...,2,-36,-22,14
AefTKWcLGNaRMJICXQYFdDOgBZHSbVEUP,eDACKGFCLBEEGGEBRGAEMDBC..IFCHCABC..XCFHhAAAFADBdDEBDACHBGABZEFAhAAASHFGEBFEAABF.hAFAfFCB...WEEGNAIG.aACDhAEA......hAFA...,1,-10,-44,34
XTLCUAVJKHSONREZabBMPeIdgWGQfFDYc,VDEDJDCHHEFE..SDAFOEADEBBAZBFC.BEBE.MHEGhAAAPADG..dAGHgGDFhAAAQCCBDBAHhABAXFADCGHBKAHBNDDF.bABC......hACA......hADA...,2,-22,-16,6
OAfXbeMJZRTWYEDIdaFKgHUQGBLNPcVCS,XCBCMDEBRBAG....TAGAEEFGIAAB..FDFGHEAGhACAUEBGBADHNDAC.PHEEhADACHEFOFGBAHDB.eABGhAAAJCHHZFFADDID.KAGG.......hADA......hAEA...,1,-12,-24,12
VWaYMbKONILRQTJBfXAEPHcSDFUGgCdZe,ECFCHAADDFCFFEBD.GGEBCACG.dEDEZADBeBHB..aGGEMFFAOHDEhAAALCCA.QADGhAAABGACfBAAhABAXGACAEGFcEEHSDFA...hADA......hAGA...,2,-45,4,49
XJZSMbeGCfgORaKUTEDFBNHYAQWVdPcIL,VEFHdHBH..ICCALCCAZAGF.MEAFeAEC.CHCG...fEEFhAAAOBABKBHFEEGHhABABGBFHADAAEHGQECAhAAAPFHF..cCACSFHH.hACA......hADA...,2,-26,-21,5
eQBFRWDPdAMJLVOXTUKGCfHcIYESZbaNg,LAFEOBDGUEGCCHEFHBCG...ICAASAHB.ZCADhAAAaDDEeFEDBGCFFDCADFGEhAAAAABGMDFDJEAD..XGGFhABAKGAE.fBHEEHCE...hADA......hAEA...,1,-25,-28,3
CFSONagVALUTXPRGEDfbWHQZeJcKIYBMd,LDCHXCCBGFDDECEEDGHF.....bBEDHEEGZBAHeAFEhAAAJACGIGACMIAGCCHDODAHhABAaCHH..AIFATAFFhAAAfACBQCAAKGBABHHG.FEHF.hABA......hACA...,2,-22,9,31
GMDXNaAcKJTOLbFEdHSfIgeVPCYWZRUBQ,JCCHTFCALBEG..EBFBdGBAHGEA.IACEVGDGCEEE.ZBGHhAAABEAHMDCA.DCCCaADGhAAAABAEOFAB.SFEEhABAgDGAPEAG..WABFhAGA.UGGE...hAEA...,2,-26,-12,14
cGKZLgIdAeOHTQMbXRUSfPDJNWaYEFBCV,HFBGQGFBMAEGRABAUCFE..SGFEDEEDJBAE..aEBFEBFDhAAA.CCAGVDDCKAFA.LCHDhABAdDACOCHF.hACAXDCBNIBF.FHAEBCDC....hAIA......hBAA...,1,-7,-25,18
DTeIUScdCJgaBGQbWXZRFMEYPAVHOKLfN,VDBGHDEDLADG.DCFGIHBHUFAD.SAAChADACBAB.JFFFaDGAGAGEhAEAQCBAXBDEFHGAMICAhAAAEBBFAFAHODHDKEGG.fGDEhAFA......hAGA...,1,-18,-19,1
aTAcFSNgKZUfBCJLEWbMQRYGDOdPIeXHV,FAFBSHBGKHACZDFE.BDCDLFHH..bAFCRBAEGBDE.hAAADAAEdHEB.eBAAHDAEhADATEDHAICE.gDGBhABACGFCEBGF.........hAEA......hAHA...,1,-19,-26,7
CGJLUDgQHZAIOSXYfFVEePBcdbKWaRTMN,SDCDXCBCFGCDEEGD..BABDdGDEKCGGREEC..MHEACCABLEABhAAADCECHAGDADDFOAFHhABA..fGAEhAAAeFFB.cADBWABA.aEDG....hACA......hADA...,2,-27,-26,1
KeWBLJCaFIfZEVAHQcPOdgNSUTDXbYRMG,QFDHOGEAdAED.SFBBDCIF..XCEDRDEEKADHeCCBhAAABDAFJAFACAAC..aBCHIHGChABA.fDADhACAEHDEAHAEHFAC........hACA......hADA...,1,-19,-40,21
ZgTISFaBPXUfAMDQdNOeEKCJHcVbYWRGL,QGEDOCCHKCGDHFAH..bAACRACGZGFETDAF..FEEHaEFGhABABEHCUGBHMAIHDGABeCDEhACACCAB.JAFA..hADA.cGGFYFDF......hAAA......hABA...,1,0,-29,29
ZAafTOLKDMXJIdRWSPBGYENUebHCFQcVg,TGBCKAABMDAD..JAFBREFB....SDHHBBDGGDGEEGCH.hAAAUBAGHEBAQDEBhAAAVBDDAACC.OAHFhABADBGDIHABdEBH........hAEA......hAFA...,1,-18,-26,8
XNCgbWVQHMYBGIUAdEfODKLeZRcPaSJFT,dAFBOCCHLCHBRFGD.aHGAFFAD...TGEACDDE..gDABhAAAVAEF.MGDEhABABEEH.IHCAhAAAUACCfDFHeACBcCGE...JBABNIAF.hAIA......hBAA...,2,-30,-17,13
SMZdNbPLFKXcHUERDVAQJICTfWGBYagOe,QDACJAFB.CCHA.TCBAGDDCBBHFaGBE...OGEAhAAASHEAZFABdACDNCDFLACFhAAA.FGGAKEDEhABA.XDGH.......hABA......hAEA...,1,-24,-37,13
IFCVRQbLNDdeHEGaBWOgfKZMcUYXTJPSA,CFEDRBCDQCFALCAFDGAAdHBH.HFEGGCFABACCOHFAKEBBZAEEMDCChAAA....YAABhAAAJHBEAAHGFBDENEAC.aBHDhABA....WFHB..cDBC.hAEA......hAFA...,2,-22,-18,4
TUcKOIeFdCBNGHQXERgAVZWfYaJPSMbLD,VGFGZAAD....fEFGaDGF.JEBBMFAG.LACGhAAADHGCUAFFKAGC.IBAGhABAdCCFBHEBHGBAEACCAEIHhAAAWDDH..SDHFcCCB...hADA......hAEA...,1,-25,-36,11
HNJTCcgUQRePXWLKaVEAFZGbYMdBSfIDO,FGFHZEBHGBDCMBFHBDCGSAFG.DGFC.HAACJFAATEDFhAAACEGE...UACDhABAeAHH.WEHHaBHBAEID.hAAAdHAFOEAH.cGDF....hABA......hADA...,2,-38,-20,18
KEDGgSZQVUTBIeWNXbfOFMJdPCHLaAcYR,RAADDGGDGAECZDCFUACGBFHC...eHAC..XCFFOFFBFDAHhAAAJHAG.CDDGHBGBLAAFhAFAAAGC.KEBHEACGSEFGhAGA.........hAEA......hAIA...,1,-20,-38,18
WDeRQdZTMgLBCafFPHUIKANEXcYVGJOSb,XGBCVAAD.GBBGJDFD...SBFEDCHBRECBZEAF.TFGDhAAALADCBBAG.fDGFhABA.HFDDhACAKCECNIAHcBEH.ODAHeHFA.MIFAhADACDCF.aEDG....hAEA...,1,-5,-29,24
dGDXHEgALNZbWMYBPfKVQOSeCJcTRFIaU,LFBBZAADMAEDBHEFKGDAOAHH..CGGG.JAAFRAFCFGAE..aDCAhABAdDHGGAEEDEEHHDAChAAAEGFE..AAID....hADANEAG...YDFD.....hACA......hADA...,2,-31,-29,2
LWICVcRDgKdYGXPHBTZaQObMFSAeNfJUE,eGEAJGEALEDFCDDG..VAFFDCCFdBDFGFAHHCGFBAACZBAD.OBBFhACAMFAH..AICG.UDFFhADAEGBF...WHAAhAEA.....IBDF...hAAA......hABA...,1,-22,-33,11
eHWUgKCPSEZdRJfFQXBYTcOIDVNMAGLab,LCDGeCCHHBFHUGFHCEAG.EGACRGFAFCAG.BGAHTAGH.OBAAhAAAVEDG..ABEH.aECG.hAAA......hABA.WHAAKDABSADBJCHB.XFCHhABA.IEFEhACA.NCIG,2,-30,-29,1
BCDfgedYKUJFISaMcEPHOTXNRAVGbZWLQ,VEBHGEDH.ZABALACGBFADDAHH..eEFAdGCAKBFBFBHHSAFHhAAA.aDDCMIFEhAAA.PCHFTBAEhABARCACAACEQGDH.CHHBfHABhADA.....hAEA...,1,-4,-35,31
EHGaXZBfMDgUNOIRQAVCWKPTLcJYbdFeS,CFDDKHBGLAFC..JCBBdECBSDGHEBDHHGFGGAAEZAECBACBhAAAMHBEUEEC..NBGE.hAAA.OEAHIBAChABAAEID.....WDCH...PFHDhAFA.....hACA...,1,-17,-39,22
DJIaXRHNKEPgfGVBQWbMedTCYLUSOFAZc,DHCEaDCDHAACKHFG.EFFB....PCAAGEAEBECFQGDChAAAMAFC.TBDF.hAAACDAFLAFCSBEEhABAACHF.JEFB.RDDF.NCIEfHGFWEAH.dEEFhABA......hADA...,2,-41,4,45
UfTHbCgGBFEdPWaVQSXYNeADJROKLcZMI,DGADOFFCKEEEZCCEUAFC.HDDF..CHBCBGGEdBCAaEAG..QABGhAAAXAAB...hADAeCGBABHCJFBBLFBEhADAIHFA..bAEEgDGEEGFD..hAEA......hAIA...,2,-30,-24,6
XUPCgYDOeZVEcLJFdHBIMGRWabfTKQNAS,SEHBXCGCUCCDCEGG..DAHHZFFF.EFCALAAF.dCCChACABGBDMBEBRAEAaDABTGDAhADAKEHFAACG..gGAChAEA.eAFB......hAGA......hAIA...,1,-28,-35,7
VQXPTdEaKZBICNfGYWUeLcDgJFAMHbORS,MECGHFDFRDBH.QBCFXDAB.dBGHKCGEBEAC.CDFEGDGEhAAAUGDALACEDIGGFBAFAGAHOGFEhAAA.SDFHhABA.TGBEEHAAaEEFIAGGNADF.hABAWBBG....hAIA...,2,-31,0,31
UeWEIQHJKOXRNaMZDPVcAYfBFbSgdCGTL,BFDGFAFB.SAGECDCBLBACUCFB..eCHFEFABHACBKEEGOEBFhAAAXGED.aFBFhAAADGED.....hABAcFGD.AFDD.fGGGdHBD.TCAFhACAIAHGREFE.ZADFhABA...,1,-8,-34,26
DeZHUPNSWIEAcgBMRfFaXQOLbYVKGJTdC,BFDGMECGRBACaADB..OFAGLEBE...VAAFJHFECDHCeAFBhAAAUAGF..SGEHhACAEGEH.AICGfHGBhAGAXEGAQADEYCHDKHACdHAFDABChAAA......hAHA...,1,-17,-24,7
EUICHOVZMJXYcATGbaQKfReBNPdSLDWgF,TFGHaGAH..KGEBREBFBEEDdBBELBGF.DAEAgACDhAAA.EBAGUGGDCBFGOAFAhABAMBAFJDED.XEBGhAAAcGDGAEBD........hAEA......hBEA...,1,-30,-34,4
ZeIOWAPaTMVDKLBCfbdUXQHJNRYGSFgEc,TGBCVAGH..DFEDLAFHBABC.CEBEdBAAUFAE.HDEDJEEGRACC.hAAA.GBCCFAHFEFGHeFHDhADA.OHEE.hAAAAIAG.aCCCMDIFfHDF....hABA......hACA...,2,-23,-14,9
IRDfKWBeFcMCVUJQLGAYHNTdEabPOgXSZ,HAADdGFCaEDHOGEA.SFCBRCAAKBHFBABAFCCH..CGHF.JBEHLAFChAAAACHG..NIDBEAFDhAAA..bCEHXACBhAGADAEB.eEFCcGBA.....hAHA......hAIA...,1,-17,-35,18
dWcXUZNIAMEHfTOBeLJKSVQDPGRYCFagb,EFEFTFDHBADG.LAHBKBFD..QGFEDFBFRCBD.FECGaGAHhAAAdBAA.XACChAAAUGGHZAEFAAHCMBHFOEEAJFAHhABASABF.......hADA......hAEA...,1,-23,-25,2
LdbDAaJOIPNHQYKCGfXMTVRUBScegZWEF,JFFBOGEA....IECBNFAD.HGAAKAHFCHEHGADG.hAAAXCBCTCCCVADEhABABAAGSAGFhABA.gDGDWEHHFGAHdCGDAIDAaFEBQCAAhACAMAID...hACA...,2,-21,-19,2
SIJAfXPKHCROGDWZbYMQBNTUdcaegVLEF,XCBCKCFCCDEF.GEEEZACE..MFEHBCECUDACdFAGeBGF.hAAALABGFHAC.IHDGhAAAAHDDHGFADACAYCHBhACAQDGE.......hADA......hAFA...,1,-23,-34,11
IDMgJcaNSZObfWCTPRQLHFdKVBUYeGAEX,XGBCMCHF..JEFHaHGEZAFA..OCBF..fBBEhAAACBBCRAFBHDEAFADDdGDGVDAFhABABFHBeHDAAADH.IAHEhAAADIAG.NBAA.SGAA.WEHHhACA.....hABA...,1,-18,-28,10
AWMcQbPZBKLNXSadFfJgVDGRYOeIETCUH,MCCAQCBCZGDEKGBFLHDE.SCFBaDFDFADA.fGBEhAAAJAHH.DFEERDDFeHFAhAAAIHHF.CDEBHACGhABAAGCE.bDGDPBAFXAGF.dFAB.hABA......hACA...,2,-32,8,40
DOABLUKNVdIECbWSRZGgXaJTPfFMeQHcY,LEBEKGFCdDDF.EGCFCHCH...SBGAZCGDGBADaAAC.TAEHhABAFAFFQDAGhAAA..HGEGDIGABHAChABAUDFEICCF.WDAFXFCEhACAfGAFMEIF...hADA...,1,-8,-30,22
NDWLeEMGVHKdCSBYbgfROQPcXZaTFIAUJ,UDACJFCH.DCHHeGFGGFBBKBFD...CGGC.BECB....bACGhAAAfDAA.hABAOABGQCEAhADAXGAHaAGCFHAEAFFANEEH.WEHH..MIFA.hAEAdAHASHFGhAFARBBA...,2,-30,-22,8
GPUbJFeCWOfNYScXZAVLTgRHdDaBQKMIE,LBDGREFHHCAHdCGBBAGEKCEH.MFFBGCCCUEBHFHBC..CHCF.OACGhAAA..fEHEhAAASAGEXBAAhABAADHF...gGGBDEID.IAEEhACAEHGA....hADA...,2,-40,-16,24
OCTeXcRSfAKFdPEUgDYVBQJaWHZNILMbG,dDABUGBCDFDGBECC..aGHBHEEBZBFCLHDGMCBCGADF.CBAF.hAAAXGAB.SAAFhACAKDAHFGHDEBHH.hADA.gDGE.QBCEhAEAWCDA......hAFA...,2,-28,-27,1
TBOEZDHdXeQLgVGYScIUJAFfPNaMCRKWb,FHBG..NIED.aAHHMDBDKCCH.....TBBABBBAEEACZFCDdAGEhAAAeFGDLEHB.hAAAVCEDSDFFhABA.cAEFIFGGAGEEfFCHCAEGWECFDCABhABA......hACA...,2,-35,-20,15
GHFMbRTDVBIKWAeUSEYJgLfaOQCdZXPNc,UAADSAFBEGBF...JGEGLGDG.aFDAQDGBhAAAZAED.PEAG.hABANCAB.cCFEFEECMIFChABATDAABFDGIADCKHACeABCfEGFhAHACHDD.dCDC...hAHA...,1,-11,-21,10
cYETGPdMabQJBIXCReKANWZLSFOfVDUgH,ZAADLEGHSCEBFHAGOCBDDDCH.UAGEHEFC.EHCAGDDChAAAdGACMBFCQBDDhABABAECCDDHKCGEADAG..NDIE..hAAA..fABFgGGA..YFAAhAEAaACD....hAFA...,1,-12,-20,8
EKLCTRNbMDJOYZUWaAgHcQBVSdIeXGPfF,HAADBHHGdGCEXDEAGADAFGHBLFFG.CFBF.NCCCDEAH.OACGhAAAUCAGAAAG.QAGBhACAIHEGfGCAhAGATDFE.MFBB.JAHF....hAIA......hBEA...,1,-21,-28,7
KBDdXAUVHTYgRNeEFLaZcfICOMbQJWSPG,VABHTFDH..RDAB.eFCDFGEC.LCBCZDGF...fEAChAAAOEDGMAAFJFHDWEEEhABASAHD.KGADhABAdADHAHHA.UBGC..gGBH.hACANIEHEAFFIHAE.hADACGFA...,2,-24,-4,20
SdYCaBAUQeDZgbVPFTMXNGRKWIEfHcJOL,UDCHQEGDeEADZFEB..bGCEFCGHMAABGACB..KFACEHGGhAAAHAEH..OCAFhABASECECFDDAACCDGGEPAHBhABA.TBBC.NIAFIHGFhACAfAHE.....hADA...,2,-20,-12,8
LHZGMYcKQaUfCPFDOdXWJIENgVeBAbTSR,SGFCRDBGHGAGMADCKHFAUFGE..CADGDGEDOCBA..XDFGhAAAIBFC.EDGGVGAEhABAAAID.LFAEhACAZFEF.GBEF.QCCCaAAC..hAEA......hAFA...,2,-22,-15,7
HCcBYJZXPLDdfOGgFINKaMSWEAeQbRVTU,eDACREFHUBDHHDEEBDAGZACC.LHFEDACG.OGACFHAC.KECHMFEBhAAAEBAGACGH..QBAFhABAbAGB.CCGE..hAAA....JAFAdFGB....fEBAhAIA...hABA...,1,-9,-40,31
JAVbgKFHZCIMULTDOeWdQfEYXRGBcNaSP,VAADKHBGFDBH.ZFEDCBGA...UAACLFCE.DHAGeADBdFHEEAEFhAAARAGHBGAB..aDCA.hAEA.SDDGhAFAAIAG............hAGA......hAIA...,2,-43,-41,2
EDbXMLSIRPUYCNKZFBQgGdJOVeaAcTWfH,TCBCHAADDEAE.MCDDSDED.RAFCUGFANEHGZGBA..FCFGBBAGhAAAGEEEOGAEeADEhAAAaDGGAAGE...fFDGhABA.EEAE.XADF..hACA......hAGA...,1,-21,-22,1
DgBEOQHXTaRYMKWJIdLbZCUcGSFAPNfVe,...fHGDeAGHBFBBQFBATDDCaGGHRAACKHEA.JAFAdEHEhAAAZEFAUBADGADEAGBB.hABA.NEAE.DDAF..EGEDhACAHFDAMBDE.........hAAA......hABA...,2,-19,-9,10
fWFZcMHEXbRAUCeTJVNGaDPSOIQBdgKLY,CFEEeFCA..JFCBVABEGBCD..aGGCDIEE..OHBCBAHEKBAChAAALDFA.fGAAhAAAFGGAZCAA.MCFChABAXEAFAFHF........hABA......hACA...,2,-46,-22,24
HdMeKRSJBQOXEGVIbYTCDcafLFAPNZUgW,ZAADUCBCHDCCMIFGKEGE.RFCDBAHGODHB.GECH..bFFCCAEFDCGBhAAA..aGBHFHCEAHIB.hAAA....NDAC.WEAFhADASABE..JCFEEBGE..ICCAhAEAcGAD...hAGA...,1,-20,-34,14
bMePRAYTJdBKXSZNVgEFGHQfCcIUDOaWL,TDACBDGFSFFH.ZABGgDGFEEED.FFFHQGCEhAAACBHFUFAHDBADOAFGhABAaBBALDDBMEHD.hACA.eCCAAAAE.dDAAKHGAXBGANIAF..hADA......hBAA...,2,-16,-16,0
XTDJWbaCQYZLMcEANgdHeOBKFPSVIRfGU,dHBHOFFCFGFA...SAFBRBBAUFCB.DEEF..JDAF..aBHDhAAACDDG.ZABFLACChAAAEADGAFCBHFCBBAGCKDBF.IHHGhAHAGCEF.........hABA......hAIA...,2,-35,-22,13
dHJANgVfMIUDPXKTFYcSeOWEZaGbBQCRL,VAADMCCADGGG..KDCAFEEB..SEFDOEAEZBADGAFAhAAABGAE.CGHBLHDChACAdCGGADDG.fHAFhADA.IFAHPADAXGFCTADFcDGEhAFAEAHB.....hAAA.aGBD.,1,-7,-40,33
eGOEAcJYgBCQRZSLHUTIVPXKDNMbadFfW,JGEABFDG.QEEEZCGBHBAAUGAA..TBEE.VCBBhAAAXDBHDHGG.MDIDhAAAbFAH.dAEHFADG.fAHGhABAeDDEEGDBAAHD........hABA......hACA...,2,-21,-20,1
FUPeLOTMQVYGXHEdbSNBWCIRgKZAJcfDa,JGEADACBFCEE..UCAFLEFG.MFBCVAGD.GDCGHAFCEGGAhAAAdGAG...bDAGBEAAhAAA..CBDAIGEBhABAgABCZGAEAGIHaFFA......hABA......hAEA...,2,-34,-15,19
DTbeIUMLYJgEOSBPKRNXCcWfGaAVQHZdF,QBBHZDDFDABA.eABEMHEALECC.JFADOAFCBDGARFCDhAAANCIA...CHBA...hAEAfCFHAIHAdAFDFGFF.hAGAIFAB.UCBE.EDGH.SFCDhAAA.KHAA.hAIA...,1,-20,-27,7
LYRMIQaPASGEVDFbCTOHdWZKXcJeUBgfN,EDAFDGDEFCGC..CEDBOCGHHBBGdDAC.KGACJGACBGGE....hAAANICF.LEEC.hAAAMEIDaABDAAHD.SHFEhABA.bACDWHAGZFFA.eABC..hABAfFCB.hAFA...,1,-28,-37,9
AITMFSOQWYDEdNgcGaHbCJeZBRPVLKfXU,MFFFFEEDOBDH..QAFBDGHF.dGDC..NAICGBFChAAAHCCECADAeBABBEAGRFBBVDFAhAAALABHXGGHhABAAGIH.SGAG......hACA......hADA...,1,-13,-35,22
UKVEJAWafPBTCDOLFRHIZQecSXbGMYNdg,aHBGBFDG.DEACLAGDHFFBZBDBQGEB.SBAHhAAAXFADMDAANAFE.dCFBhAAAgACHKEHBEBAEAHEF.hABA...fACGTECECFGEFAHDIAGAhADA.....hABA...,2,-20,-16,4
HaFXZVeGYfNEdcLMWAUObQDKBSIRPgCTJ,UDACODACDAGGKAAABAAD..SHDERGFA.CADA.JDFHaFCGZECBhABA..GCDF.hACA..NBIA.EBCEdHAFMICEhADAbFGD.QBGC.....hAAA......hACA...,2,-36,-29,7
bDJSCGfaENABIQdcZUeLPRgKOYHXFWMVT,QGGGdCFCZBGHLACARCBFKHCA.ODAEHAFBFEEE..MAAFbABG.hAAAJHFC.GECDECHFAFDDBEAGhACA..IGAChABA...eHAA.....hADA......hAEA...,2,-19,-17,2
ZMFBKONeYdSCQUVagERXPDAJWIbHcLTfG,JGEA..bDBHLCCGGAFEFBDGOEAAeEHFdCGH..QBAGhAAAaABC.REDADHDEIHCEhAAA...TAGEhACAMIDGBAHAKEHD.YFAFCFAG..hABA......hACA...,2,-31,-11,20
ENDCSBFILReTOVgWAGQbfdPUHJYZMcXKa,QAGHdHBHUACGHAEEZDAEMHFEKHEG.EEFBDDEA.BEEAFCACLFBDhAAA.eFDHOGCAhAAA...gGGEhABAAFIFGABFPCHBJCHB....cCBChAGA....hAHA...,1,-2,-38,36
HcBPEgbOaCZSDGRFYQMJWTdeUVIXfNAKL,KDBDLFBBBGHG.EGDAODCAZABAGBEA..FABBQDGEhAAAMIDG.JCCFTADEhAAAeGFCIHHG.hADANADF.cDGA.PFEG.aAHBDIEGRGAG.hAFAYCAD.dBGFhACA...,2,-24,-3,21
DSaNTWRAPLHXgfEQFKOGVbJUYCIedZMBc,LFBBXFDH.EGDAKAHFGACG.JAFHCCFHdFBC.MFGHBHFCDEIDhAAAaBHB...NAAE.TCBFhABA.AACF.PFFGhABAHADCfDGFOBBH.....hACA......hAEA...,1,-25,-26,1
aJFIdeHDUPfcYMLXKESAgTBNbOZCGQVRW,BHHGOGEAGCAERDCB.JAFFdEAE.eHBADDDD.UBAB....hAAAPEFAfBDHhABAMIDELAHBXCFHEAFGhACAAABG..TACFNAIECHAC.QFDAhAAAaHFC.IHBA.hADA...,2,-23,-15,8
NIFfdYTaLDWGQCVZbeSUKgEBAXJcHMOPR,XDACJFBBHDEH..MIECRCDCFBAF..dGGBaEBEDCIH.GABA.hAAACBFA.VFEEZAGBeDDDhAAASGAB.gGCBhABAEADGBFAFAEHDOEFA.IAHHhACA......hADA...,2,-26,-12,14
NcJUfEOASKHeTPaQIMWDXgZBYLbVGCdFR,SEHBKDBDeFHF..aDEFMFGD.DACGZGBELEBDGADDCBBEdCGHhAAAFDGCREDF..JAEBEDDBABAG.hABA.....TAGAhAGAIGFF..XCBEBAAC..hAIA......hBCA...,1,-24,-28,4
JLeSQFUWBRgXOaTMIYDECfdKNGcZbVPAH,LFFCSAADFADBUDGGRBFA..ODFEaDEC..MEAGDFDHCAAEKBBEhABAGCACZGCG..PADGhACAAIHEHCCC.QGABhACABBGDXGGF.IAHFfGGAhAFAdFCB.....hCDA...,1,-10,-22,12
RHXBENPcdOZCTfbSeYGQDIJLMKVFgAWUa,aGFCHBCDBDFBEEBH....NBHA.dEBFZGDATAFA..SAADhABA.eAFBQFABhAAADBIBIHHEhACAMIAGKABBgEEHAIEGWDBEUADEXGAEODHBhABACDAG.....hADA...,2,-24,-13,11
IdFEaOGfWcJZeTDSQKRBAMgNbUVCYPXLH,MCCA..bDDDCDGH...XCFBLDDBdFFAaGBBGABG.hAAAfGBCJGFAeBAFDFAGhABAKADBAHEB..UAGEhACAPDHFIDBHFFAGEAHB.WAAD...hADA......hAEA...,2,-32,-2,30
fBVUDaGQEAIRJSWKTXLZgYCPeNdbFOMHc,RFDFSDCDKFAGLFFHZEFC..CABD.eABAdBDAFDADMCAG..HGBEhAAABHCDUAGCDCEDQDGEhAAAACAH.ICFHhABAWGEE...gAFE..hACA......hAHA...,1,-28,-32,4
gbUQdJNGBDLPHZEaRMXCeOIAVKTWSYfFc,TCCBSHBG.FDEH..bAEAUCAAdEEHGFAFDCDHLCFEhAAA.ZFAEEABGRGFACAFE..hABA...OABChADAAHGCWDFE..fEGAQDACBGEC.hAAA.aHFC.MIAE.hAEAeEHB.,2,-17,-13,4
HDFMaOYVJfWcdTUEBAGgQCeSRNLKZbXIP,QAGHSDABLEDAKCCDZAAG.XACDHFGHFGAA.aGEBOAHFhAAA.JAFBWFCBhAAAdGDFEBAA.BGGGAFFGCEEFeAEBhABANEAE..IEHADIAA....hABA......hACA...,1,-15,-24,9
GKaHIOUfeFZVQNJBALRMDbgYcXWSEPTdC,MAGDDACB....bACD..gFFA.XDDEhAAASAHFEBDDdBAHCGDBaBEEHFCDhABAIHHHfDAChACAFBADQGAGBAHBACHFLEHBcEFCWEAEhAAA.....hADA...,1,-10,-30,20
ScBXJYCLFVTgUZDPdQGMOfbREIAHNWKae,HAADKHBGeAFESGAGBADE.JEDACDGALEEFFEBF..TGDEhAAAZCDGdFBHQAFBhACAGAAEOGFAbADDIHGEhADAAECD..NIEF.cDGA....hAGA......hAIA...,1,-12,-24,12
SgEHWPYcZfTJLaDCRMdNBKAQGXbUOFeIV,GABHXCGCUEDFFFDB...VCAEEAAEHAFG...PDBEhACA.ZFFETBGGhAAAJHFEDICEMEAFBGAEAFHFOGBChABAeADDSFAEYFHBfGFAhACA.....hAEA...,2,-14,-12,2
MRUADIdQKVJYcZBbPaNOgfSCGeWXFTHEL,DGHHQGBCKACG.JBADZFDE.BEED..aBFDOCAH..hAAASCEDCBHD.hABAGEFAeDCFFDFGEHDC.hAAAMEIDAHIBIAHCdGAC.cEABNCCB.fABDhADA.XDCDhAEA,2,-45,-17,28
WgaDPJBfRMEZAbOSVKFQGHYICUTcdXLeN,SDCDVFEE.KGACFFCFHDDHCDAB.UAEHdGAALAFD.hAAAeHFANDGGaHAE.DAHHBCCGhAAAMEHBEABH.ADEHOCHHhABAQABC....IAHGhADA......hAEA...,1,-20,-27,7
fKbQBRGOXVgTUWaDNAFZHJIYEcCMPdLSe,ZBCFHFDFJDFGEEAB.CAGG.dAACLCAA.SBAEeFCAKDAABHGGhACAOHAC..XAFAhADAVCFFTGGE.hAEAaBEBACFGFFHB.IFAFMAAE....hAFA......hAGA...,2,-40,-2,38
VHPNcQMIKaFfGYSCZUeJbdDOgWLXERBAT,VABHHAAD....NCCB.MHEAKFEB.FBGEGDBF.CAGG.eDGHdDGFOFBFhAAALEAB.RECCAAFGhAAA..TGGC.hABA............hADA.cCEA.aHGEhAEASADA.,2,-24,-23,1
RMfBdbOQWJcTZVDSYaLePKXIEGNAgCHUF,HDBHRBCFMCFEdGBD.OAADQBAB..JFFHTDFCDBIFSAFGhAAAaEAFLAFEKHDG.hACAEEEBGADEAHHA.CHHG.hADAfHBFBFDB.cEGD...hAGA......hAHA...,2,-24,-9,15
aJYgLKHReDTUQFcSVXWNBGPZAMfdObICE,MHFGOCCH..CBBA.EFFD..aEBFJBGDLCHHRFAD.DDDFTBDDhAAAFHBG...SBABhABAXBDABAGGhAAAPFDBAAEEdEEF..IAFFKHDA...hABA......hACA...,2,-36,-29,7
DQREcGMfTOHeZCSUBaLPgJNAKbWdXVFYI,KHBGdHBHFDFHDBBA.RFGF.GDDD..TAAGeDAHZFCAUDCEBHGHLADEhAAA..gAEChAAAAFBB...hACAbBACWCEE..XBGA...hAHA......hAIA...,1,-26,-36,10
VWbFHcEXMgSKORCLQUZDNJPaATfYBGdeI,TCBCBFDGGBAF.dABFVEFGFCGBHGFGEHBE..MAAFKAGGODEDhAAACFABUAEB.ZEBDDEEB.hAEAJAHFAIDA....fFAChAFAIFCE........hAGA......hAIA...,2,-26,-22,4
RJZIeYCNMXDWFSQadHBAOfbVgKULcGTEP,OGEAVAAD.UFBBLCDAGCAB..TAGGRAFDZAAE..eEEEhAAACFCHMIAGDIAC..SEHBhABAQEEBdAECBEBDhAAAAHHD.gGGG.EADDPHDChACAIEHH.XAEBhACAFAHF.fHDD,2,-8,-6,2
fOcFdIVDNHePQBTGSLKgXREJMZbUWAaYC,CFEDOGEAFCAB.dAEDDEBGHCBG..QBFGGBGA.KHACRFCBEAAChAAAZGEE...bFADAAGEaBBFhAAA..fEEBhADA..IFACNIEH.eDFA.BFCAhABA.....hAFA...,2,-35,-9,26
fOTLgYABcZVPeFDWaREJSGMNHUKCXdbQI,ZDBHVFDFFHEE.DAFCRAAB....SAFCMBECHEFGCADB.dFDEQDFEhAAAOABG.TCDChACALDDE.AIHEBCHAhAAAeBFCaGHD.EDCBNCCF.......hAIA......hBAA...,2,-26,-11,15
EbaeFNMBdZXVDGIPYKfHLURCJTOWcSgAQ,EGFCeCCHFDAGBEHA.ZAAEDCHD.GBCF..IAHGKFAHLDDAhAAACGBG..TCAHhAAAOFDASAFHhABAACIDaACGMAFEVGDE.PEDEfHBFUGGEWFADhACA....hAEA...,2,-24,-23,1
BLgEaAKOZFVPJNfRQbDcdTHeYSWMGXUIC,KDBDODCHFEEB...JBGBRFBHDDFE..dGBHHAAEeABG..SHEAhAAAGFEBXBBChAAAUAGCBGFCLAFChADAaEHB.AEDG...PAEBNEAE.....hAEA......hBAA...,2,-31,-23,8
SaNTGALZfgVdCWRHDIBJXQeMPcFbEOYKU,LFBBZAAD.VCBECHBHREFHDBGE.BDBAQGED.MBCChAAAFDDDOGAGUEGASBGHhABA.aFDGGAEGhAAAAACEdAGB.IDHA.XGDDhADAPFAH.EHGA....hAEA...,1,-6,-38,32
YINALWeBRXdGFMTOQVCcgEUJKHSfbZPDa,LEEGeAFBRAAHGFEBMDCF...OEABVBED.CCEE.EGGFKCCGSADChAAAZBGBDEBG.IAHGhABAAEECBHHE..FHAEcGEBhACA..........hAGA.UGBF.fBBChBAA,1,-12,-34,22
SNVUIZdcXbLJeDGOCRHPAgBTEWYMKfFaQ,TGGGEHBG..MGECFAGB.QEBE.SDFGhAAANFDFUCDEZAAHXBCDJCHHDGDEGEAEhACACEAC...hABA.PAGFAAIHBADG.......hACA.YFHB.hAEAKBBD.aGAB,2,-28,-12,16
NCWLFPYaSHbJQVADZfXUOeKcGBIEMgTRd,ZFDGXCGCOABAKAADBCEE..MDCGRCBCdEHACFGD.LAHH.hABAFEBHPHCA.SBDAhACA.JAFAhADAABBBDGAD..eHFAIHHHgEAAhAEA......hAIA...,2,-40,-30,10
GEOTHLeDXZdIWAcfCRaSVKBbgNUMJYQFP,CFDGRFEE..aCEGKGAF.BGEH....NDIEUCADMCHB..QBEBhAAAFGAD.GBAChABAEFBGTDFAeACBDFEGXABGhAAAIHHH.ADEF.SHFG.hADAgAGEPHBELAFChAEA,1,-17,-39,22
eALDSMEZKYBOcRFbdTCgfINXUVHPQGWaJ,SEGCEFEFZBEDBCAGOHAA..FGHDTBDDCHBC...fBBGhAAAICCCUEAChAAAVFEFQAGFhABA.WCFAeDHHDEABMBAE.KGFBcDBEhACAdAHENEDE.....hABA...,1,-8,-29,21
IOLXUdBYEfPSGRcgbNTCVAKJHQFZWeDMa,KDBDHAEGFGHHZFDD.DHAGMFCFOCCC.LFAGUBAHBHFG..hAAAfHGFSAGGhABARCAB....cCFEhAAAgDDE.TFDGCBBEAAEGWDHHeAEB.hABAIDHG..hACA...,2,-43,-11,32
XLaHGODBVQcefFJAZRCKgNSYdTUPWMbIE,RFGHKEGD..SADDTAGDUEDCMDEC.EEFDLFBD.aHDAhAAAOHAEDADG.QFCAhAAA.cCAAhABAeCAG.FAFGAHGACABHYEAB...WCFEhACAXBEG..hABA...,1,-10,-37,27
PDQWIXSefcONbYFKLURMGaBCdJZHTgAVE,VDAGEHFGDHBG..QGDF..XBGCSAABeCCDhAAAODFG.bACBYACAhABAKGGE.UEFGhAEAMIFEBAGBdHAFZAFC.HEDAACFFWFAD..hAFA......hAIA...,1,4,-38,42
NcVYXZJHCDUMfgeAEWGIPLTKabBQOFRdS,GEAHLGEAaFFEBDFBFDDG.dBFH..SABHVBBHZGAEHEDChAAADBHFMAEG..eDABhABAAIEG..IGDEhAAAKACC.OBDENDIG.YBAFCAGC.fGHAhABA.WBHHhADA...,2,-37,-15,22
DYBOQLTdgAZeUWPCVFacHERSKJGfXNbMI,eBDGUCBCCHGEFAFG.HFFBRCGB.KABBGEDG..XEEBMAIHDGCHhAAABHBCLADEdDCGAHDEZDGFhAAA...WEAFhABA............hADA......hAEA...,1,-24,-42,18
UWKXTCQbHaSfGNdPgJeDVLZFRYABEMcIO,MAEEOGEAUDAEKGBH...CACG.QAGCHGDE.aDGHSCGEhAAAGACGdEACJCEHeAAFhAAADIFALDGFFCEDAEIDBDHChACAEFCA...IBAF....hABA......hADA...,2,-27,-15,12
QRZaDMgXOJdBFKGPVUSEWAbHcYTCNefIL,HAADTCBCCGEH..eCFDLCHHZFBD.DFAEXEGHJBEF.BCCHhAAAKGHBGEFEUAEFSDGEhACAABHG.bDBAYGBAhAAA.fAEDIBHD...hADA.aFAFMBAF..hABA...,1,-5,-34,29
ebZYfLXcdgPVJBWRCOEGFHTAKMIUaQSDN,KGFHUFDBQCGEDIGE..eCEFZECGLBAFdCCC.VCCEhAAAJADCRBGB..EAGGFBAGABGHMFBHhABA..SHAEhAAA.........hACA......hADA...,1,-25,-44,19
cgWROCTBaQGePNbXLAKSEJMFVYZfUIdDH,EDABFFAGZEFBUBDDdGDGHEDF......gCABOACACHGBTBABhAAABAAFGADFhACAeBGH...PDDAhADAXGBHAIBGSHFAJFFAMAIF.fBBBhAEAIGACDIEEWAHB..hAGA...,1,-5,-29,24
JHLWNdSIbcBRDAKPTEMYCFQaZeUfGVOXg,TGBCEGFH..MCFBCBFD.QCBGeCBDGEFEOEHF.XGCGhAAAHCCANADBSAAFhACAbFABBADG.AIHEKBBChAIAPAGBaBGF..fEHE...hABA......hACA...,1,-4,-23,19
AHVOYPWMDgCFSdILEQUKaZeGfJbcNRXBT,HDBGVFDF.OGDG....PAFAMBGBCBBEFCDASCAGhAAAdBACEFFG.KEAFeHFAfGAAhABAJDBD.NIEHBEFGhACAACHFDCID...LDHBaCGH....hADA......hAEA...,1,-21,-23,2
UTLCdgKfFNRAQEbHMXYcGDIWaOZJBSeVP,EGFCHFAC.XBEGGCDBDAIH..IDBDaAEEOEFEZEEFBHAFhAAAeEAGUBACTABF.hAAACEAGdEGBfHCHhABA.NIEB.AHIBMIDA..cFAHSDDDhABA.....hACA...,2,-19,-9,10
CYBPTNgWaHcbIQfSEFXDeOZUdKAMGVJLR,VGDARFBGBDBG....TAFC..gGEAaDEBHACDIHAAhAAASFGBFFFAXAAChABAOABHdEACABIHJCDDhACACHHE..PDFC.WFCDQBFGhADA.EBCF.DEFD.eHAGhAEA..,1,-12,-17,5
KBDcYAJCPXHdNILTOSZgWEFaMfbUGRVeQ,JAFBXGGGHFEFdDGCLCHB..SEADZAFEEGEFFDCCaEDDMBAHhAAA..UBCBGFABhABAeHAE.BGGBcBCFhACAABAGCCAE...IDFH....hADA......hAEA...,2,-29,-16,13
fAdeMEWUaBPSJRgXOQTbLZYVHKIFDGcNC,MEGFUGBCBECC..JAECRAEF.OFDDQDFHLEBFZAACHAGBhABAFCDHDAIF..NDAH.CACBAFFFhAAA..EFGB.aEEHSHAGhABA.XDGB...hACA......hADA...,2,-36,-21,15
EaHDUReGbdTXQPLgcWCIFZMOBVYKJAfNS,SHBGEEHBDBAA.UDCHGBCC.TGFEQABE.LBGDhAAAgFBBCEAAFFFFhABAZCEBBAEDKHAAAAFC.aAHHhAAAeFDBXAECWAHHIFHF..hAFA......hAGA...,2,-26,-12,14
gCTBOGLMbEWXZdPHfYDeQUKJaRScINFVA,TGGGGACBMBHF.EFDFZAGH.dBCCHFFCDEIDQFABhAAAKDEERFAFSABF.IDCBhAAAFGDGADACCBFABEFF.hADAOBEH.WEAE......hABA......hACA...,2,-31,-14,17
ZAKDGVWJHSLOgeENYbPBCXIMTQcfUFRad,KEHBGACB.JGDGLBGD.eBDBNAAC...PFBHBDCBCHBGhABAMACG..QCFBhACAfHGB.FFFBhAAAdFAFDBCF..WHEAODDH.EBAFXBBChADA.IAHFhAFA.cEDB,1,-29,-30,1
PTgMAVSHOXaQRFNIEJeGUcbfYLZCKDWBd,SDAFOBDG.QABCRGFEFFEG.ECFEJFAFGECDUABA..hAAA.fDCHhADAZFCHDDDCBCHHPGAE.MIDAhAEAAIFG.XGGA.IAGG.hAAA......hAEA...,1,4,-46,50
LVFEIeKOPaYgMSCfTQDRdbJHAWNZUBcXG,ZAADBHHGGGCFFFDF.eBGDOAEF..aEBHMAGBCEFA..TDCDhAAADEIBRBAA..dHBFHACEhAEAAFFE.NAIE.UDAF..hAAAcGGA.........hABA......hACA...,1,-7,-45,38
TVMKaXcFJYQbOSCeWfUgIDZLGHNRdEBPA,TFCAKAAB..aBDHFGGB..QGEGSBAGeACEUBDDDGGAhAAALEFEHBFEdFAHPDABhAAAMFDFXDEDhAFA..JAHH........hABA......hACA...,2,-29,-14,15
GWeZfIaAFBEUVgHbdTMNYcJXDPQSCLROK,FEHBBFCFEBGGUBDH.HDGDdFEEMCDB..NBBG.JDAH..DIDEQABGhAAALGFAOAGBhAAAKCECeHAA..fDEEhABAAIHA........hACA......hADA...,1,-31,-38,7
CBWNPGDdVSFZHaLgEUQbJIXKYefTMAORc,OFBBCFDDBEFE.....PCDGDHGEdFAAFBBDHBAELHDCEHDGUAGEhAAAQEGH.hABAIAHEKCEAeDAAMCAFhAAAAIGE...cCFDWFFA.NABF..SEBEhAGAaADE...hACA...,1,-12,-35,23
VYQbIDFOKLaMTfBPCRWGeHNdJESAUgZcX,ZEFHVEFHQAAE.DFDBFEAELDBCTBADBHEGCHBE.GADAhAAAHAGBdAEF.SECFhAAAAHAEUAGC..hADAcDGAbFDD.KFDD.aGBF.....hAIA......hBCA...,1,-16,-20,4
IJVXNGMSgBZfPRYDOFaTWdbcCQHKeULEA,JFBBXFDHGADA..SDEABFGAZDFERAGDOBHD.aCABdGDAhAAA.CBAEHDAAKHGCeBDAhAAALACDIEBCMFAFhABAfFGBDFIF.FFAH.WABE..hAFA......hAGA...,1,-13,-26,13
RGZgCVbaWcTXHDENJUMBYIdSLQefKAPFO,OCCHGCBDCGDC..aGAA..TGEBDFEHEGGBJAFA..BAHEdEBESDADhAAALBEAeDFChAAAAIHE...PBAHhABAFACEZEEC..........hABA......hACA...,2,-33,-28,5
EVSXaDeQdIWFZCgfBKbYNHMGTOUARPcJL,RAADJGEAEDEB.....SFHFDIFAQABCdGEFFGAGZEADCHCCBBEDhAAAKDGG....bAFGhAAANCDE.GDCA.OFFAhADAAIAGPAFA.VCFEaHCE...IACHhAEAfCDBMIEE.hAEA...,1,-15,-29,14
HOfWSdTRYVbUJINPQBZgDcaMXLeCKAEGF,FDAFHFDFOEDBSFAB.dADETAABRAAF..VDFDUCFAIHGEhAAAQGGHBFCGhACADFFAaCDEMACELAHFhAFACCHAKGACACDC...fAFF.bCCChAAA......hAIA.NIBF..,2,-24,-4,20
AXJHFafdBUMTWDZEPYCOcGSVLbINgQReK,JADGHFEE.aDDEBBAAMEIFDIAC..ZAFG.EAAFCEGAGCEHLCBE.hAAA..NIDF.QFEHhABAeEBFAHCDFCGBdCCC..hACAWEAFPFCF.ODAF.SFHHhADA.IAHFhBAA..,2,-24,-13,11
KcfTVPXRZQYgDFdLUBWECMbOAIaGJHeNS,GEAHeFFCKBFH..fGGH..PHCGXBCBRACGZAAFhACAQBAGDFDAdDDDBFABhAEAEEGFCCHEMBIBOHBAhAAAaHGA.HBED..SGAD..hAFA......hAGA...,1,-5,-25,20
DGcECYJOdSUQAPgNHIfeBMLWaTFbVZKXR,...PDEHHDDDeBDCLECFaCACFAAEZBAARBFBDFAD.GDGACAFFODAFhAAASGEA.hABAAIEE.gGGGhACAIHCEBHAAMIAEWBHB......hADA......hAEA...,1,-19,-21,2
TcIfQFGaLXbdRMOJNgDKZYSVHBEPAeWUC,eDACCHHG..TGBFIFHB..FACDGCEFaEDGLBGFhAAAdHBFRFEDOBAC.NAAF.DAGAhABA.KFGA.ZCAFSFBEhAFABHDAAAEA.........hACA......hBAA...,1,-21,-34,13
dZgHSefNTcRIQVFaKYbPDGXWCJBLAOUEM,UAADdHBHHCCEeADFTABGRFBA..QDEHaDGA.KBFHPGFGhAAADBIF.GEADCHABJHCG.hABAAEEEEAGEZFGB..SAGBhADAfBED........hABA......hADA.IEGG.,2,-20,-2,18
DCAQRFYTHWXKNaVOBgMZdIceUbGLPSJEf,FDAFHEFHKDCBVAEBBHBEZEAA..dHEFeBAAGEGGLHCC.PDCEhAAAEAAGDGCA.ABGG.RBGF.hABA....TCFFhACAXGAB.NEIG.aEEF.MBIF...hACAcBCB.SGADhADA,2,-32,-7,25
TReEVBFbZcNKQgUSaCOWXGAHYIdLPfDMJ,HAADdHBHLBGHDFDHJEAB.eBABBHGGZCBB.KGFBUEEB..CDEFOEHFhAAAGACEAHBA...hABA.IAEDfCFDhAAA.MDIDRFCE........hACA......hAEA.FAEENDAE,2,-30,-29,1
ITdOgXQCYJPESLKAbFHNWeMZcVUfDRBaG,FCFCHAADeHEAMEIHZBAGUACE.DFAEBFBEGGABdEAGOABG.hAAA.QDFAhAFACAHA.PDDBEEDDSHAChAAAABEGNIDF..cAGC...fFFEhAHAIEHAXEEBhAFA,2,-33,-22,11
cZJCMeHQKDXTFfRUPAOLGWNEVaYBbISdg,GGCBEHBG.aBAABHFD.SCGDdCFAZEACMDAAHBBGDECETEADhAAAFBHF.RFDF.AIFAOEFEhAAALACC..NACF..hABA............hAGA......hAHA...,1,-25,-27,2
PMBGEDCIUdfgaVFcXSLKTZOAWeHYbNRJQ,eFBBHAAD....bGFCJACD.MDEHEEABCHCHUFGGdCHG...aAFDVBEBhAAA..FBAHSGAGhACALDFA.KADEZECFhAAAAFFANCCE...........hABA......hACA...,2,-30,-10,20
LcAEYPSZCMGfFKUVNdJQBeRgIWXHaTDOb,EHBGSHBGZDBDGEDEKDFG.UBEDdAFCQCCGRBAH..IACAhAAAHEAEDACCLFADhABAAGFDCCHFMEIHFGHFNEEA.eDFDhAEA....WABG...aFFA.hAFA......hAGA...,1,-9,-20,11
QJOIaYFXDHWgAGSEdTfbKBMeZLRVCcNPU,EDAFTGBCKEDA..BEGFZDAGRGFA..CEHH...PEFEQFBGhAAAOFEBaGAB..XBFEhAAADBCCHCCAAIAASBBChABAfBAAMIDA.eGDCcCDA.hABANACB.IGHF.hAHA...,1,-18,-25,7
BSIWNQVYbLEZKaUDfMeCFdcgOPHGTJAXR,XGDCSBBD....IBGHNCEDQDEE.VGEAhAAAbFFFEDBF.ZBDDKEDDaDFAhAAADADEMADFCHBCdEBAcGADhABAPDHB..........hABA......hACA...,1,-14,-26,12
JAUBSfGPXaHFKceDINbZWTgLMREOVYCdQ,UGAFSEGDGDEC..aHFAHBBB.KCFCeAEDDFBG..IBAHhAAAbCAHZGBA..WAGBhAAATADF.LDHFhABAEEDBOACDCDAD.........hACA......hADA...,2,-21,-19,2
cNRSGFdHMJCaWUbYVOTQZEDIXefgBPKLA,RAADFDAFHDGHCHGF.UAFG..VAFCQFBGZFDG.DIAGeBACBGGDhAAALECAAGID.SCDFhAAAMIFEaCDDbFDBhACAOFAH.ECHFIADCfFHE..hABA......hACA...,1,-12,-26,14
gIPFUYNXfeEDQBGdVKTHAJbZaRSOcMLWC,JFBBZDAGaBBB..RDFF.OFGFMIFE..LBBCCFCG..IGAGhAAAFDAFUAGE..NEEF.hABAXDCA.eHDChAAADADCQBFCBCCD.....hABA......hACA...,1,-30,-38,8
afIeUJWQBGMVgTPbNZdYDFRcOELKCHSXA,aHBGeGEA.UBADQFDEGBDE.MCID..TBGG..hAAAbBCEZFBHdCGE.DCABRDFE.hABAcDAELEACKDDDCFGDhAAASGABABBH..fAGBhABA......hACA...,2,-23,-10,13
ASGeQOHLbJNRWYdDZVgaFMITBCEfcXUPK,SHAEGDDCQGAFOAEA.LBAGJEED.NEIC.RBDDdDAHZBFEaEAGhAAAMCGBBHFH.CDGAEFGBhABAXABB.KFBGhAAAAIDE.eHFA.WDHFDDAA......hAIA......hBAA...,2,-25,-6,19
RZCSUGPHWVINEYADKafgLOMbTedJXQFBc,aGCDLGEA.MGAATGEAdFGB..QCBBFCCHBAGDZEEASDEChAAAUADE.HBFChABAIBACEADEAFAEKECGfCHGhAAAOHAE.........hACA......hAFA...,2,-34,-13,21
WJdMDENPBICKXcZOYFLfASbgTRaUVGQeH,SHBGTCBC.RCEH.UCGHGAACQGGEeAEAHEAGdAGHMEBBhAAAEGECBHHGCEDG.KBGAXABEhABAODHFLADDhAAAAFCDaHCGJAEF..DFFD.NCAE......hACA......hAFA...,1,-4,-6,2
APSBdTELNXRgfHKMQabCeWYJVOZIDFUGc,BFEDTFCELECB.RCFBHBADKDBGQCFFCAGA.eBAChAAAJEAHOFHHDFFEFAGCUFAEhABAAADB.SHEAhACAdAABNIAF.fBDF.MDIHWADH.hADA......hAEA...,2,-27,-18,9
VUeDNJKaWTfFCQScEXHRgBZdGPOYMIAbL,LFBBUBDGeFAADGFAKHEE..TADFFDAG.QDGGEAAC.hAAAXAACRAFHZEFE.PDAChABAMHAEAHHD..bGEChACANIAF.aBHF......WDEACAFBcDDEhADA.BHAC..hAHA...,1,-15,-24,9
OYKGdeBLfUWbCMgSJPEFZDaHVcIRNXQTA,KDCDdCCGLCGFUFGB.CAAE.MEEB..JFBCFACDDIACHFAB..hAAA.IAEDXADEhACAAHFHGAFEBDAG..hABAfGGA...gEEDhADASCAFZGAA...hACA...,2,-33,-31,2
ZEaDeLKYFABWRNOUbVSQIcTPHGXgfCdMJ,RDBHODACUFDA...SGAAQBGG..IACBTGAAHACDhAAAXDFHCHHGMEEEhABAEHGEaAAF...LBFChAEAYAEBADHEWFED.....hACA.NDIE.cCDA.hAEA...,1,-18,-22,4
FDCBOHRaJLPbXSGZEgTYdcINMfQKWVeAU,DDFFCEFAHFCBRDBBLAAF..PCCE..SHAChACAEBBH.TAECdGBCIEABhAAAMFGDKDHFeADEUGDBhADAOAHDaBCF.JHFGXAGF...hABA......hACA...,1,-17,-23,6
cEMOGHdSaKUZXTVAFIYQLWbgPfNeDJCBR,FHBGQCBCLABC....gFCGPCBG.eFHBDGIDCGEDhAAABDEH.RAFGMBAChAAAGBEGHBDASAGEhAFAKGFHXFADTBGCAIEE.YFGF.bDBChBAA......hBCA...,2,-26,-2,24
SGVLfDPHaUNWRMYBIQJCKTFEAOZXgdbce,ZAEGdGFCeFBHGGCFLEHBDAABHCGDUDED.RBBE.BADF.JCDHTAGDhAAAFFAEADFH..OFFChABAXEAB.bFCDSBBBhACA..fACB.hAFAaBAB.MFAF..hABA...,2,-23,-15,8
FPTOILRSgXaCAZNKYGDbJUBdceHEQfVMW,ZDAGKHBGGAGADICGUEEHdFAE.HABG.QGGEMHEE.FFEBTABHhAAAOECFLAGFhABARCAG...XFAHhADA..........hAEA.AFDBNBIGYAEBhAAABCDB...,2,-27,-21,6
OgMRTCKDHBZELPfaeWXNIAUbdQFGJSYcV,dGFCFCBBGEAFSFDC..VFEEMECCCGBG.DBEGBDDGZBGDEBCBLADChAAA..PBADhAAAaHDC..eAHDNDIEAFAD.hABA.UGCF.........hABA......hACA...,1,-20,-31,11
IPTZDOXCLBKFSMdaEANRHJUVgcYfQGeWb,RGFGJBDGUABE....VGDG..gFAH..cAAChABAQCDHGDBDhACAeHBC..bBGDPAFGhAAATFACDGDAXGGFBEED.SDAChADA.MFFGEBEEAEABhAEA...,2,-30,-13,17
RHgYbBUEaFZfSdMKVIWQGNcJATeLPDXOC,TFCAeEEGDFCG..CFAFHAEG..gBABBBDGEGFBFDAASCGEhAAAKFFC.IGABhABAQAACGADDhACANDDFAHAD.XDAGOEHD.YHDEaHCE..hADA......hAEA...,1,-12,-29,17
eOgWHSFUYdDKNETXAMBRVcZaGQfICPbLJ,MEEDRCDHZAAF.GDBGQGFHCBEC.LCFHOBHBHBAHSHCEhACAUGFADDDGEFAFABIHBABBhAAAaAFA....PACChAIA...........hADA......hAEA.eFAD.,2,-22,-9,13
DPLcEbBCAMfQeFdJWGZXIgTSaHRNKUYVO,QFDBeEGHdABCGDEAZBFA..XCAGTAEBHEAARABCKHGAUDEFhAAAOCBEDDHHLAHHhAAAEHBABAGDMIFE.FHBAhADAJEAE...........hAEA......hAGA...,2,-16,-2,14
FQbWYKCNeAVEaRSdLIBMPXGZDUgJOfcTH,VFEEEEHBRDED..LADAMIAG.GCBGDBAGUFBDOBAH.TGCDhAAAHADDFCAC.QDCDhAAAbBFAKGGG.CHHFAAGEaFAFhABAdCHEBBBC.........hABA......hACA...,2,-22,1,23
HbUPCQIOaRBKTWeSdMYXEJLFGNcVfAZgD,DHCEUFDHQEFAOAEDBAABKAGF..eCDDdAHC..MIDAEFBGFHFAhAAAGCBC..VBAFhABAAHHHHACDCBHH.aEAH..hACATCEH.WEADSEHD..hAEA......hAGA...,1,-18,-26,8
CMfOJbIEXQNFSUGTYceRDLKZHgWdAVaBP,BCAHCBFD.ODHFJFFD..EAAEQDDA.SGBChAAAGECETBCAeAEARGEEKEHHhACAZBBDHBGB.dDAAAGGCaCFFhABAMAEEfHCDIEEF.NEAG....hADA......hAIA...,1,-7,-23,16
BJWAXKVcITURGdLfbHYDNeaPEZSCFOgMQ,VBCFTCBC..RFDDLFADHGDEDAIHeBED.EDGHCHHGOCGDhAAA.MDFDBCFBJBAFXGAEhAAA.IBAAhABAGAEFdGGBfGGD.NADFaFBG.hABA......hACA...,2,-18,-7,11
GVbDJWTYREXOKfeNZSHQUFLcMaIAdgBCP,BFEDCECDGGCHDECH...JAEGTADA.RBAD.EAAB.KDEBeBGFZCACHCGFhABAFFABLFFHhAAA..aGGDAIHEPDHFhABA..WEAFXDDG.OHAEhACASCCE...hADA...,2,-24,-24,0
DQZYIAWVCMKgOSaXefTUJbFHPNEGcdRBL,CFDDMHFGKBFH...OFCH..SGGCaBFH.XGADhAAAeDEBfACGhAAAUACGJCHHFDDFNADD..cBGAhABABCBGDBAB.ZFEBIEHEAFAF.WEBFhAIA......hBAA...,1,-33,-38,5
IgHXQbKZCLcRTDSdBEJYUFOafWeNGMAVP,VAAD..IFFEHDGFQAEGKHFGZBFACGBBLADDRFEFDGAAdEBBBBHHhAAAEEBG..JDEGFGCDhACA.ODDAaGAHeABHhAAA.MBADAHAH.........hADA......hAGA...,1,-14,-22,8
RKaVfeQXgZFJcOBELUGHYWICPNMdSAbTD,TAFBREEEKFDF...aBBDeAAF.QCBBZCEHFHDAOFAEBBHDEBEFhAAALCHDUFAC..hAAA.YABCIHEHhACACHAF.NDIG.SHGG.AHHADGEAfHGBhADA....hAEA...,1,-13,-25,12
EVFIOPcKCLQGWZgebXSTARJBMaYdDfHUN,RFEEMIAGdCFEDAACUDDG...EGECFFAB..OCGDKECFLAEAhADAGFAHZCAD...bAAEhAAASCCEAHGD.hABAaBHDfAEC.NEIE.IHEGhAFACAHA......hAGA...,2,-47,-6,41
MQXWYDdbTLJNaIOUSRefEKVGPCAcZHBFg,ZGFGFBBDQBFH..WBEHdGAHTGFALDBF.JADHIEHGhAAA.SDEAhABAfEHAKADEPHBEhAAAADDGBECB.MAIFXBAGDCAB.aBHB.hACARDFF......hAGA...,1,-23,-26,3
NeHgGDZOECATBIWfPXSYMLJFacRUKVbQd,BHHG..fEGDXEGD.MCFEFCFFRAAFUEAC.KAFAQCCEhAAAdFFCeADBgAAFhAAADFACEGAH.AHIDIFDFhAEAPFEH.SHDG...hACA......hADA...,2,-39,-14,25
AfeCOYHXaRNPJKFMWQBgULGbEIZdSDTcV,eAFBCAFBHFBDRFDH...JFFFFGAG.MIFGQBDHUABF.GDEFhAAAEDGCZCAADABA...cAGDhAEAAAEDOGFE.aCEFhAAA.KHBABHDB.bBBB.IHAF.hACA......hAGA...,2,-19,-12,7
IVWTKGFOcXPdLZUaCeSYJDBNbAQHfgMRE,HEFHMCCARAGFVCDC.KABGODHD..XAGFdFBFZEEDCADCeGBChAAA..SABFhAAADIFANCIE.AAFCQGGChAIAEAEEIEBD.WDAF......hABA......hADA...,1,-21,-27,6
fUIEKYNSWXMOcJgGVTCQaLdeRHPFbAZDB,DAAFUGGGKGAB..SBEDMDGF.OEEDJEAE..GGCBhABATDBFCADF..LBCAhACAeAEERCGDFCAGAFEGBAGF.hAAAEDDE.....NAIE.XFBC.hAFAgABEaHFE.hBBA...,2,-32,-21,11
GWMeIECaASdZbYRBfVcKHXFJDNOPLgQTU,SEHBdCFCZDGDRACDBAHD..VEEBHCABJCBCDFIF...OGBEhAAALBEA.QEAAhAAA...hABA............hACA......hAEA...,1,-39,-44,5
SYNDgJVecIdHBXFLMUfOQCGEbWZTaRKPA,SHBGDACB..JFAEeFCEdDEABBEBLBCFUEGAQCGFhAAA.CEHHbBEHTGCChAAAaGGG...KDADAABGYAFChADA.NEAG.cBAC.IAHChABA...FGFHhADAMBBF.,1,-16,-45,29
KYaAPTUMLDFfBNJIEOWZbGcVHXeRCdgSQ,TCGCMAEHDDBB.BBAAJFBB....OGEEZCCHGFDDHDEFRAEAdGAFhAAASDCCKAFEABIFUCFFhABALBAD.NEIA.hAAAIHHC..WCBC....hABA......hACA...,1,-19,-34,15
eNYCcZVEKMIHWfFaOGbBQLTJdUAgDXSPR,DAFBSGFCeCBF.CCBA.ZGFA.KBCCMEBGHGBEFCGCGCEHBAEALEFEhAAAdAACAFIB.XABEhABAPECA...NCAC.hACA..cAGFVGACIFDEaEGD..hAEA......hAGA...,1,-11,-26,15
VXHNFTBPOJMfWLEDQAScCIedGUZaRYgKb,CFEDdDCDUACCaBGB..RFEA.KGGH....XFABFDFCBAGE..OFCDhAAAMAAF.LABEhAFADFAF.AEHCSAHHhAGAeEBCGGBB..YBCA..bCBGhABA.NBIC.JHFE..EBGBhAFA...,2,-37,-15,22
TXBDPecKAHOgQdNbUaRLGZfFWJYEICVSM,HFDFODACQDFDdBCAUGDF.LAAAGEGGFAGAJCCAECGG.IHHFhABACCFD.MIAAhACABEFHDHAAPFBHKGFEAEBB.hAEA.bAFEaABB.fAFEYFAG.SEEFhAAA...hAFA...,1,-1,-24,23
gdPYNFeCcbKaJMIfLZXUVSQERTHOBWADG,DCECdGAH....PFGBFDAHeEFD.CEGF.KDAA.MACCLGBEhAAAZAFEUGDHSCCDhABA.RAGDOFHDAFEGGBAFhAAA.NEIE.aACG..IDEC...hAFA......hAGA...,2,-34,-23,11
gTcOFULCGBJEAISfHWPDKYMbXeVdaRNQZ,SHBGHAADDFDHKDDHMFEB..eFAFdBGHaCDGRAECZFFB..TDAGhAAA..cGDEhAAAUFFACDFFBHHHEACEAIGGfCHEhACA.WCCFbFAEXBAE.hADA......hAEA...,1,-12,-26,14
JTEDFMaBZcKdOHfVbQNgILCUSGRPeYXAW,JDACDDFFMCIBBHHH.ZABG..KCCEdGGHHFCH..VAFCQFGBhAAA..NCEELDADhAAACACEUBFDSEADhABA..PDCFXFEDAGFH.EHAEaHEC.hAEA......hAFA...,2,-28,-25,3
bZaeACTFgNdEJSRGMPIXYHQDWLKUBfVcO,CFCFFGFCdCABEHDE..RFDDGAEEMABE....IFDHXFFAHCEFhAAADBHHLHAAhAAABDBDVBCBODBEZAFFAHBC..hABANBIC.SEAD.YABG.hAHA......hAIA...,1,-17,-21,4
VKLbSGFQURYAEHPfgaDBcIOTCdWNZeJXM,ECFCHAAD...fEHEaGGDDIBEBAFEOHBEdEFDZECD..JEBBhAAAMDAAKEDBSADChACA.QFFChAGARACCAGEFcGEDCHHAeBEBXAAFVAGF...hADA......hAHA...,2,-35,3,38
EfbRdKUMcSHAWTaQYPONXGDgeBZLFVJIC,aGFCQCBC.ODHHXFBHGGBBeDDFBEAGLFEFhAAAJADGEEDGfACEhABA.RAFGdDAAMBGF.SGHHhAAAAAHG........hABA......hACA...,1,-18,-28,10
BfPTdKJOIaQGZSCYLUgMNcWVHDREeAXbF,FGFCBFDG..TABEKEFCOCDF..IBGFQDBCZDDASADHhAAACCAFLHAEMAAGhAEANAIE..WHAGhABADHFGeAFB.AHIBbAGBfFCD.PDAFhADAaFFE....hAFA...,2,-35,-22,13
KWHCUXNQZIgSOfRMbAYcdTDVeaGLBFPEJ,dHBHTFCAeFCA.GDBDLCBBFHEE.EAAFKFAECHEF...UADHXAEChAAAQAACZDEFIGHHhACA.OAHFhADAMCHHAAGCDCHHBHHE.......hAFA.JHAANAIESFGGhACA.,2,-24,-8,16
WcZJIAHFTMbaRCeOKQELdBVPXNGUSgDfY,TCCBMHFGRCCC...CABD.eFAAKAEE.LBDCdFFEBGDH..PDHFhAAAXAGEUEEBDCHF.hABA.fHCFhACA..WHAG.cEBAIAHD..hADA.ACBC.....hAEA...,2,-46,-22,24
KOGYBFHLNfREJaSTQdgZCUWeIDVMXcbAP,OCCHGGDHFFBBLFAARBDB.EHEEaAFEQAAFdCBCZAAE.CHCEUFGGhABAeDFCDFFG.MFABhAAAXAED.AAHCKDABhADA.BBHANEIE.SDDE...hABA......hACA...,1,-13,-19,6
cCGNMaFeJdOIbDLXSPUVTAfZYBREQHWgK,ZAADRDBHEHDCHEGH.KEDFCBHHGFEFMFBH.FCAHeCEC.dAGHOAFFhAAADDCFLHDA.XEEDhAAASBCC.hADAPHAA.UDFDAIHGBAEE....hAHA......hBAA...,1,-16,-20,4
VOabFMERAZKBPQUNdeWYgfILGcXSTCJHD,BCAHQCGCUFEFdBGAeAAC.....gDBEfCEAhAAALGFEGDBASACGhABACGDBJFABDAFB..hADA............hAEA.aGADMICAADIHKFHBNFEBIBCEhAAA,2,-41,-20,21
DZTVFLKNeHIGQgYOEJUBRfWMAXCbcSadP,CHHGSHBGdFDGZCAD.FDEHLAAC.KGBHeDHH.IFAHhAAAQEGGOBCBEDCABHAGhAEAfGHA.hAFAAAEAbFCGaGFHDBGD..VBEG.NABE...hACA......hADA...,2,-31,-20,11
gATWJaUfXEVNZFLKQcMDPBGdYHeSCIbRO,TDACaDCD..XABCEAADZCCA..LHEGKFEAQAFChAAAMGCABAGGGCGEHEFHSHAAhACACHCHIACCbDAFhADAOBHFAIHE.JFAHfGDE..hAEA......hAHA...,1,-4,-21,17
YOgSaedGMHCWPADVFKTLbUNcEBQIXRZJf,VEEEKFAALDEH.UAEHEABCBHHE.QEBEXDGHRAAFhAAAJADG..OHAAhACAaHDAdBHAHDBC..CBADAAAChAHATGGG.NAIE.ICCG...hADA......hAFA...,2,-29,-17,12
ATfbaRNZIgSHJWcEKVOGFeMYUDLCXdPQB,TCBCaHBGZDCF...SEFGHCEFJAHH.EFDFOBBBGADFeGFAhAAAMDAH.DICGCEHGdFABBAHBhAAAACED.fCGGhABA..NABF.IGGF.....hAGA......hAIA...,1,-14,-24,10
fQVOYGWNMacSAdLHIFKRTZBJgEDCXUbeP,dDBDLFBBFCGHKACGTBCB..BBBDEDECDEACCFEA..UGGEeFGFhAAA.QAGEhABA.OFAH.YEDFhACAWFAC..aHCAAFIB......hAAA......hABA...,2,-64,-10,54
gWTaQGPVJMBRFHdZKCDINXAbeUYEOcLSf,eDACEGFCLBEE..gDGDaDABGDDFVGAEMIEABGHDhAAAHFADKEDACBBEDABA.IGDFhAAANABFACBG...hAGA.bBFG..........hAHA......hAIA...,2,-29,-14,15
SgUVGRJYAHMNKefdcDLIBCTQaFbPOEWXZ,HFACMHFGKEGGeHDG.dCCADCDGBABB.CDAF.QEEEFDFG..hAAAOAFGEFBFZDBGSHGEhAAAUBADRAEEADHG.NBEE..hABA.fGDA..IFHHhADAaAHF.WBFA...hACA...,2,-24,-24,0
NHLIdVcGUDWBSOXfAEeRbJYFQgPMCTKZa,EDBDeFBBREFF...JDFDQAAB.MIFETGGH.aAGFHEDHhABAdBDC.VGACUBAGBAFAhADASFDFfDGBhAEAADIHFHDE.CAFD.KCDGNAAF.......hAIA......hBIA...,1,-4,-27,23
faSedZXURJLQYbWMVBgEOGIKNCPAFDHcT,DEFETFDH..SDHHZGFERAGHLACDQEDD..YCHBhAAAMAHDBEAAEAEBOBAFhABAKCEACADAFCBGHGAChAFAaHGAdGAEXCEC.......hAAA.UGCF...hAGA...,2,-25,-5,20
PJGXZSdfCQUgAFKLEVeRHObaWBINcTDMY,FEEDKEEDEAFGRBBAHBGD..aGGEBAEE...IHAANDBD.DBAGhAAAPBBE.XGCGhAAASFDD.dEBAhABACDGDQEABAHFDeDDCWCAD...TGGEhACAMIDG.....hABA...,1,-17,-36,19
fDYVCXEReSUdWMHagAbcOFTPBNZQKIGLJ,OGEATGBC.BAGCQCEAKFBC.LFFCDCEF.CAFERBACeCAFhAAAdHGBHDACABEEFHBCZACBIAHGhAAAGBGE...hABA.fADB..XDEHhABAEDGE.WFHHMEEF..hACA...,2,-32,-4,28
KRfBWLPaIGENTJMFdeCObZgHVADUQXSYc,UECEQFCA.SAFBKAACBHACLAFGaEGC.EGHDJABEhAAA.dFBGOHEC.hABAZEFEHEEBACDE.XCCDhAHARCFE.fGHCICBA.NIAD.TEAChADAeAHFCBEH....hBAA...,2,-29,-10,19
GReaSKCAWPBTcNIXgMdFLDYfHJbZEVQOU,BFDGTCBC..IHACMGCELEDA.DBFDfAFEhAAAHBGBbABE.EGFG.OCEFhABAUGGBeDABaHCAKDAGABIDPHAEhAAAXCGH.gBBD.dADEhACA.YFHH.hABA...,2,-14,-6,8
SPOBXgDFaTecCRHAdYVNWKLIUGEfbZMQJ,dCFCVAADKGHH.UECAEEFG..ZFAC..QBBCSEBEBFAChAAADGHBFAED..aAHH.hAAA..TADF.hACACHFGAGGANAHCWCDA..IEHEfFFEhADAMBAB.....hAEA...,2,-35,-35,0
HXFNfOABLdEGYQDcJbaMRWTgeZCIVUSPK,dDABGEAHDGGF.JAABMEFB..RGAG...TGABeHFGCHED.UBEHhAAAKBEGFDGD..OEGDhACAAICABABGECBHQAGAhAAA..cEEDWFAE...ZAGHSDEFhACA..hADA...,2,-43,-14,29
egHLVDaBWUJAIYPEGSQMfcbNKZXCTFdOR,..IFDGEDCDQFBG.MCCCbCDAKAEDCHFDdAHC..eFHHhAAALEGFDHAGBHFEJEEBAAEAhAAAGABE..SACGhABANBAGZBGF........hADA......hAGA...,1,-22,-27,5
cTgUaDWdJOCXbRYLIVZSGfeMBQFEKHPAN,TCBCaGFC..dBEDJAECCBBB..RDAD.LEFFZDFCGBCEMEDFBHDFhAAAFCFCKEHD.HABCAHIH.hABA..NCAC.UGAFDBIHOHCEhAAAbEEC.IHAFSAFE..hACA......hADA...,1,-10,-22,12
bBFPDHSMCZdJVXefgLAaKQNUGOcYITREW,KFAAQCGCUAAFGEDDOEFH...IBDEEDGEBBDGDBFEMAIHhABAdEAE...XGGGhADAfCAH.AAFEaGHBhAAANEAF...YDDEWHAE.FHAASAFHhAEA.CGED..hABA...,1,-25,-32,7
VfcXYgUTGIPdDWCbBSMReQJLOKFaAENHZ,ECFCHGFGZBBCVAAC..XAFGUDDCGBGCdHGFDEGHCGAC..SDAEhAAAMFEHRDBD..JABAhAAAKHAGAGAE...cAEEhADA..YBHBIEAEPHAEBGCA.hAEA......hAFA...,1,-16,-18,2
TbPBKMLgECaeWRZHfOXQdGDFAJVYSUINc,JFBBVDAG..UFGA..IAAD..NADG.TADGBGDHKEEHhAAAMIDE.LDFFhACACEAE.aGABRAGF.ZGEC.hABAODHFQCEHDBHHACBCSDDBhADA.cGBE..hAFA...,2,-48,-16,32
JXUODfIaGHEBecALMbQKPZSVdRWgCYTFN,MDEBKGFCZBFGdFBHRDFE...CABD.FABG..XGDEDEAE..aFBFECFFhAAA.BAHEAEEF.QDBFhACA.SCCChADAWADA.TAEGJHDA.fHGBhAEA.ICHFhAGA.eHBGbCCB,1,-12,-49,37
PDJMdaFbLYBeSVATQNKCcOfZUWGgEIXRH,TCGCKGFCOHBA.ZEAAUFAD.GCADEAGG.RFEFDIBCMBGBdHGHFBDDhAAA.LABFBDFGSACEhAAAAIEA..hABANCIECEEFcAED........hAFA......hAHA...,1,-24,-31,7
CZSHNdaWFJIERPXcMQYbVBLGUOgAefKDT,KDCDDEFACGBHZEEH.HAEHdAFC.FDHH..EEBERGAA....XGGBhAAAMFFBQABG.hABA.YBBABGDBUGGGhAAAODABeAHHSGED...hADA.aDEB....hAEA...,1,-17,-35,18
USZaNdEBbCTPHDMgRFeQIGWcJAXOLYfVK,XFCAOEEGLEBD..fDCDUBBCaCGC.dEAGBAHHhAAACGHAHADDMBAFFDFCeFDGhABAIFGA.cBABhAAAAHGEKFHBSGAD.NIED.EHAA..hABA......hACA...,2,-23,-19,4
cTFAeNKMCSDfOEVLIBZYaGUQdRHPgXJbW,KDCDSAGEDDHH.EHGELGDC.BEACZDAHaDEDQGAGhAAARBCDHDGBXCFFhAAA..WACCFHBEACAGMIEAhABAfAEBOBFAIBDF.UDDEhAGA.....hABA...,2,-27,-16,11
SeaMRCTPDANGfYWQUXELbgFIOHZVdcKJB,GAFE..YFFBUCADEGGA.LBHHFBCEHGBAZFDEdGACKABGhAAAJDDEeFBFRBFE.CDDDDBEFhABAACBD....NBAG.fHDFhADAXEGB........hAEA......hAFA...,1,-16,-24,8
YFDGUcHNLefXdPJWIZREVabgOKAQCSTMB,QGAFCFCF.MBCGBHEF.DBGEGEGCHBDHLBCDhAAAeCDCXFDAJCHFZGAAEAAD.hABAVDAFaFEG..OCABhACAAEEDYDFE..FGGBNACFPHCC.hADA......hAEA...,1,10,-29,39
gLYJZefENDAQcGOWPBVSaKbUXRdMCTHIF,QFGHOFEFBAGCSEACKEHD.UABGXDABRDDB.CFBA.hAAATAGDHABEFHCAgFAHhAAALCEAJBDA.hABAZDFAEGGBAIDE...WEADaGFH.MAIB..hADA......hAEA...,1,-2,-25,23
YdZgJbBPcFILNeMUOfHaKSCQTDVRAEWXG,XGBCdGAHZBEH..JGFCBEGB.FDEBLCDBMIFE.OABFhAAAaADE.KHEGQAADhAAA.DDCFAIAEEDAHWEAFhACAGBGE..bBDAcGCD.NADF.UFGHhADA.SHCAhAEA..,1,-11,-32,21
ZWLOQRcMdbSFgeBUHDJAaXVfIYGTPKENC,VBCF..IFEDGFBBKBAFCAHBZEBFLEFGQBCG.RGFAdAEFhAAASHGC.hABAFAHBBCACDFAGACIHfDFGhACATAEA.NCIAOHCEMAAA....hADA......hBAA...,1,-20,-25,5
OZCKWGfVEJINDbQgXLaSPABRdTMFecUHY,dBBDMBDHeDDAHFCGZFCACCEBGCAE.EGFHNDAE..DDHF..QAGAhAAALBFEaAAGAIDABACChABA..FHCAYDHHhAEAKGHB..........hAFA.WCFH.fHGFhAGA,2,-43,-10,33
RGaNdMTDOgFZKIUCPXBfeQEYWLAbcJSHV,JGEAHBCFGACGdHGBDCIB.FHBEZFAB.KAGAUDFD..CAEDBBAGeEAHQAFGhAAA.hAAA.EFCA..YBADhABAAHCASFFE.aCEENEEEMGFE..hACA......hADA...,2,-41,-18,23
ZOIgAaCQRUVKedYBENTPHJWfSDbMcXFLG,aFFBCFFCRAEC...KBHHdHEFBHBE..EDDB..TCEBJCBH.SBBHhAAADCGG.MABEhAFAFABGLDFEZFBA.hAGAIHACAEEFQGGF.....hAAA......hAEA...,1,-28,-46,18
fAeaCKTHEDcgYSBJXMVLQdbGPUNFRWIZO,CDGFHBCFDCCA...gBGGBFBH.MIBAQFDAGGEFUEAFhAAAFAAFRFGB.ZDFA.ACACaGDGhABAEDBC....SGADhACA.VAFG......hADA......hAEA...,2,-42,-9,33
NOVIKSYQTWUdHFDPfbBARCeaJgEcGMXLZ,RFEEaDABECGCGDEF.LGBCOABCKAFD...SCCAhAAATAABdAGBDGADbCCBCEAEeHBEhABAJHFCMACEZDFA.IEBEhAAA..WHFGFHCCBFFDADAG...hADA......hAEA...,2,-29,4,33
PYOcbFaRIQdWCTVSfMUKNeEXAZJDLBGgH,JAGHBGHDGEGGHGDAOAAC.FBGARFBAdBBD.CGEH.SADEhAAAUDAF.eDCAEEEGABIHDCAAhACALDDC..hAAAPGAG.cDFD.aEBCWACC.hAGA......hAHA...,2,-27,-27,0
AaQEBdGeRHKCbDOTfZUWNMcPIJFXSgYVL,QFCEEEHBBCHBdEDAGDAHHCEG.KBDADGACOAFFZCBD...NEGA.hAAAPCAH.JGFASABBhADA..hAEAYABGAHAGaCHFeFHF.CFAC.....hAFA......hAHA...,1,-19,-27,8
cPYaAVgTWJLeRBMXSEKZGOHDfbCFQINUd,TFDHJEEGLAFA.BACBXDFF.KAGCGCBHDGHBCDDHFBBEhAAAIFHB.dBAHPDHFhABAAFCB...gGBGhACAWGCA.MFAE.EBEAZBEAfDABhADANICF...hAAA...,1,-14,-36,22
PMcaRYIeVFSdfLOZbJTHABEUWNgCGXKDQ,BFCFUGBC.....gEGCXCFFQCBGMBDD.hAAAREGH.IHAGFAGGdDEALACGhAAAbBEEHFDBAEBBWHDEhABACCBGKABE.DGHFaDAH.......hAEA.eAECfECHhADA..,2,-26,-12,14
BJEIMGQcKSFUeXZHTabPDgfNLWCYVRdOA,EDABGBGAKECC.FFBHUABGeCEH.ZAAFHEFF.aHCADIAC...fGEDhACALHFA.CAEERACFhAGAAAGEJAFH.MBIHSGGHhAHA.........hAAA......hAEA...,2,-29,-20,9
ZOERUbPLVCAMfDgQJcWNYHFXIKBadeGST,DDGGQDAC.JCBANEGCHFBF.FEHBKGEHBCEFeFCC.GDEBhAAASDAHOABCRABEUAGChAAALAHB.AIHEfGBGhABA.gAEBcDDH.hABA......hADA...,2,-36,-7,29
PLGagFTUfHcXQbRdDAWeIMKBVCSNYEOJZ,eGEAMHFGBEFGCDDG..SFCDEEBHZCDALBAHGADFaCAEFHACUACFhAAA..fGAChAAAXAFBQFCEhABAdFDBABAHIEGDNCHE.......hADA......hAIA...,2,-25,-18,7
KcAEUMaQdJSNVHGPBWXZIbLTYgFOfCeRD,UAEDaAGD.dBBB..JFBFSDGCHEFFBABGZDAFLDDD.hAAATAEEgCDAhABAFCACCHEA.DGGC.AHBAMHFAhACANBIC............hADA......hAFA...,2,-37,-28,9
LdHWJUECXOcfbVBTAgZRIFPNDKaSMGYeQ,ZGFGRDAGFGAADCBA.KCDHMDFG..eGBGdAAGHFFCUAFC...XCDFhACAODFC...bAFAhADABFFC.AIDA.PHCChAEASDAH.....YAAAhACAWEFCCCCD.....hAFA...,2,-41,-22,19
WJODRVICZSNXKHfYUPbLdBgQaAEecFTGM,eCCHTGBCMAHH..JAAFDBDE.REFB.CEDCZFEB..XGDGhAAAKADCHEGFUBAFLAGFhABA.BCCFaGABAHIBFBEDOAFDhABA.SDAHNAIA....hACA......hADA...,2,-25,-22,3
SKLAUHaFXgfeWMGIcPdOBNTEYVCbDZRQJ,aDAFXGBC...eCADMBCCGDGGIFDAdDDGBBBE.hAAAEGEAVAGHDIGARAFDSFAAhABAAABCFAHF.WEHFhACA..OCED..NIDHYEDChADACBDC.ZBBA....hAEA...,2,-29,-11,18
QBGTLKfFNMIEaRcHgDCVYedUAWZJPXbSO,ZFDFJDAC...XCGBOCGBBBAEGAAELBFEKGGAFDCAMECBhAAA..IGHFhAAAEADFaAFB.HECCDIGACAHAeACBhABAAGFH.PHAC.SHEC..hADA......hAEA.fFAANDAE,2,-24,-18,6
KFRcgIPWTDAUSLZJGMEYCXHeOdNabfQVB,UGGDSDBDZAFFGCBCEAAD...CACGHEDDODFH.aHGEQBDAhAAAKADBFGBE..gBGHhABAIHAH.TCCEhACAAADEMBABeEHF.dAFEfHCBhABABHAD......hAHA...,2,-23,-4,19
YUQVIdNZbfFRKDJMaPTeOcBXEGSAgHWLC,HAADLAFBCHAFUDECVBBC..dHGBZCGBFEBEDABA..MGEA..hAAATFCAeBGBBBEDhACAXGGE...SEBChAAAAAEG........hAEA.YEEHICCChADANIDBfHAF.,2,-32,-22,10
UQCXGKMEgVNdTeAYRIDfZLPWOJSbBHFca,RAADDACBLDHFODED...JFEDSAEDBFBAHBEBFBAH.aAFCQDBDhAAA.CHAHKGGDhACAgGAF.hADAdGHCAAFAIHCDfGCC.ZDBE.WEGFhAAAcAGE....hAEA...,2,-29,-23,6
JIBVdRaEGcgeMAHbWLSOKPUZYCDTXQNFf,HAADLGEAOBEDKDFDUGBBZDFBCHCH..DEEHQAFE.FEBEhAAAfADCBBDHdBAFEDAAhABA..cFAGhAAAMEIHACIDSDAG.YFHF.hACAXAFB.IBHEhACA,1,-18,-32,14
efAKgTbUXIDWYaHOZGFPMJEdVNLcQRCBS,TGBCUCGCDGBB..aBFGHABH.OAFAFGFGJCDDdFGA.LADBhAAAQDGFBGDAeACChAAAAFBG.KFDB..bDCAIEBBhABA.YCAD....hACA......hAGA...,1,-27,-29,2
dEVLbeYNJXBTORCGaUZQHFSPDfMAgKIWc,KHBG..IFDGdECAEAHBLCFBeAACJGFCBCGARCAF..CGGEUAABhABAZEAB...HADDhADAFAFHSDHHhAAADIGGAHEE.cCCF...YHEA.hAFA......hAGA...,1,-27,-29,2
VMHLUSXeNWFgDQAOIaGdZcKCEYPbTJBfR,aDCDdCAHKGEC..EAGG....PGAAbFAHBBCCREFEHDCA.SHEAhAAANCEE..hABAWGFEFAFCDIBE..hACAAGCGOHFCIDHFcDABCBBC...JCHBhAAAfCFFMABE.hAFA...,2,-34,-19,15
aUKPReBSTfXQHgWCYMZIcbODAdEGFLNJV,GACBLCCHJGDGVEFA..aEEAKBEERFAE.BAHE...SABFhAAAXBADQDCAhAAAHFAHCGDC.MIAAhABAIDADOBHDDCEFAACEFHGENICF.....hADA......hAEA...,1,-12,-32,20
bPGaLgZeEJAMVXdRQWNYfScUIDFHBKOCT,MEIBdDAFRCFA..QFGD..NCABSAFCUFACDABHFACFKBFHhAAA.CDAG...PEEBhAAAaDDDLFGB.hAEAeBHFAGCEXAGE.fBEChAFAIABFBGEB.bDBF.hAGA...,1,-27,-28,1
IfUgcdEYBOTJDaNQMFZbKWCXSVPALHGeR,LEGHHFBHeDDBRDBCUAEGdGGBECBDBCHA..JAHBDHCCQDFChAAAZAAF.KABHCHAG.SBEGhABAADFC.IAFChADAfAGH.......cEDEhACAOHFETACChBAAaDHDMEAH.,2,-37,-10,27
MgOdZDCLFVaQBbPXARUGEKYJfcNSHWTeI,UBCFKDAF..JCDG..fFFH..SBGEhAAATCFBMDBDdGAGZEGBLEEFhAAAFEECQABChADAPAEGAICCEFCF..NDCAeHCAOHEEDGDG...hABA.CBHHBHHB..hACA...,1,-18,-28,10
MIDQJAUcVKELfGHgCTbYdXFPWBROSaNeZ,VEFHKEEDEGFG..GBACCCHF...TBGGdCAGXDBF.hAAAFFHF.BAHGSABBhADAeGBEZABADGIBAEDFLAFBhAAAfECF.HGBA.YAEFhAFA......hAGA...,1,-24,-25,1
DdSaHIcVLMQUFGeZYRNCWOXKBfTbgAEPJ,JCCHSGCDHGDG...VAACLAAFUBEAGGEBeFABZBFBRBGB.hAAACAEDOCHDBCDCTEAEhADAAGIBDFFA..dFCDaFFA.hACAMAEE..........hAIA......hBIA...,2,-22,-14,8
QSdTOfMGZEPLIaFHWecXbgAUVRYJNBDKC,VABHRFDF..JBHFBGFBDEAE.KEEC..QFAEdAGG..fHDBhAAAGDDHEBCELFHHhABA.IFDHhADAFAAHWAFB.XGGEAEACNDDB..SHBGhAEAMIAEaHFC.cFAFhAFA..,1,-28,-33,5
bSgUXEQNJFaMBYZVKeIfRAdPCTDGLWcOH,CFEDGACBLCAFODEGHGCA..SFHBXABA.QDAGhAAAJBEDFCGG.aGGFBHBGhAAAZFCAKHAC.fAGBhABAAFFAdAGFPHFCDIDG...cEBDgDCBhACA.....hABA...,2,-26,3,29
WRcdGAQJfEeIYaTMbNZVODFCgLPBXUKHS,QDACEDCD.eDFDIGAD.TCFCNBIGZFBE..OHCEhAAADGFDFABECHFB.LBEDhAAAXABFKFFEHAEESEHBhABA.cFCEACDF...fAFBhAEAaCDD.MAIFhAHA...,1,-10,-33,23
KdRYGJZfDAcWPbTNVLBEMCQaXgHSUeFOI,...PGEANDEHBEFG..MACGCEHD.aBGHHACD.UGGDFAGAOFCGhAAAKAAF.RBBD.GCAEhABAJFBHDEEGAFCB..bECHTBDChABA.LHEAEAGA.....hACA......hAEA...,2,-29,-11,18
DNeAUKYBcgPJHCbXTadWSGELQVIMZROfF,KGFCBFDG....PACBHBFBCHCE.TEAEdBHEGEBBLAAChAEAVBEDMFID.RDCEFFFGhAFANIAH.AIBA....UBCFhAGA...YHEAJAAB....hAHA......hAIA...,2,-33,-15,18
KPIEcaHTfdOBgbALeNSXFWVMRJUYQDGZC,LEEGSDCDXGGHFABD..MGCERACGUGCAQBFEhAAAZBFBCAAF.KFAD.EADCaCCBTEFGhABAOCAD.BCHHhACAAEHENHCH.....JFAFDIGG.IDDEhADA......hAGA...,1,-19,-24,5
BLCZAKXMUDORVGHSIdegYbcPNQfFaJWTE,XAEDDIBGOAADRCBE.HDAG..dGDCeGDA..gABEhAAA..bAFEcEFEhADANADHFDFH..aHEEWDFChAEAEFCFCCCBABHG....UGAH.SEHHhAGA.....hAAA...,1,-13,-24,11
bTFSJUYgDOBceaQGfAZEHCPWLMdVRNIXK,EDAFCFDDLAFCdBCA.RBAA.XCFA.KEDCFGED.SEEEhAAAUFFCDIGABHAFaCFE.QGCGhAAAAECCHEABMAEFhABAIBAETGGA....gAGChABAODHF.....hACA...,2,-23,-20,3
IQbVYfKcONLRCeUXFEBASJdWGZgMHaDTP,SEEDdDCDZBAAHADADDFC..IHACQACG..bDFCfCDChAAAKFCF.NIDBCBAFhABAXGGE.BGDAhAAAJCBHgAGEaDAB.PEAHYAGBhABAODHF...hACA...,1,-13,-20,7
SXDLfBgCFRGYWTeANZKVOEbIdQPHJMaUc,ZDAGKDBDODEGEBCA..dEGFQFGHJHFE.MAABaBFEUGAChAAASEADLEEBBHCGhABACCAB.GECF.TBCEhACAABAE..NADF.IBHD...hABA......hACA...,2,-31,-18,13
SdGfOgQbPCaWNDFTEUMXABYIVKcRLHZeJ,BFDGVAAD.RABFLAEBZDBG..JEFGdHABGFADODHD.QGGHhAAACFHA.aEBBNIDHDDADhAAA..EHDEMAHFhACAADADKFFD...cCGGSCDC..hADA......hAEA...,1,-19,-34,15
ZXBCaNLWPORcKIHVgbADQMTGdFeESUfJY,MIAGGCEBFEEESAAB.UFFDJAGHZBCDBAFGCHGH.LDAAhACA.OGAGKFGAVGDAhAAAAIGADAHF.QACEhAGAeAEHEBAH....fDAAaFCANIBD.hAIA....WBHHhABA...,2,-40,-5,35
ZPFGRObMHAXaDSUICBcEdJQTeNKWfVLgY,DDFFUGBCCFGD.BCAE.dDEGJBAE..QGGD..NAIE.KEAAhAAA...VABELHDAhAAAZAGFFEGCGEBAhABA............hACA.RBEGODAG.hABAMAEEACEG,2,-44,-34,10
RPGYWdZKbMUQAIgCXacJENSVeOfFTDBHL,CFDGaGFC..EGAC..VACHeAAF.FFFBBGAGRBEC.GEEBdCBAKHGAUBGHhAAA.ADHD..IFCBhABAXEAC.NIBB.SCEHhACA.fEAGHDDEPDHFhAAAYHBG...hACA...,1,-21,-23,2
cTFSbBLDUaPXMGKdZfOWgHJVEeAINRYCQ,RAADQGGGFEFGBGHC.UDBG..aGCCXAGDGAEB.ZEEDOGDAhAAAHACGJFAH.EEGCAEAC.hACA...IDCBhADACHDGSABFLFAHDDEHMAAFdCFD...hAEA......hAFA...,2,-24,-7,17
NCBZUFMPVEYKAdWRaDQTgOIfeScGLHbJX,dCFCRDAGDGFAQFGB.OCAEfBFDeEDDGACDLABChAAAHCGDJFDB.CFAGBHBHhAAAZGFGMCCAEEEBAAHA..TFAEhAFAIBAASDDE.XDFDhAGANIEF.PCHD.hABA...,2,-7,-7,0
dYcFBagbTZEXOVCNHWUAQRILPeJKfGMSD,REFHLGEAeDEH.KGADMBBAdFBBFADDBCGD...aBAHTEEA.hAAAECGDXFAC.hAAACCCEHFCBAIHEIHCChABAfBEASBCDDCIH.YCAD.hABA......hACA...,2,-27,-24,3
JOdaHBSeZTAGCQPMNbVfLEcFDXUIRWYKg,CFFHMFFF..VCAFECHFFAAD..DHBEUGCHRDDE.KDBDOAFA.hAAAdGHEBHHGZAAEADFEPAFHhACA....NBIE.hAAAfGAA.LDDGIFCH.hADAWHEC....hABA...,2,-41,-28,13
UKNdHEeLRDVXZfbGgQMCcBWOaFAJSPYIT,SDCD..PEGHTBEHNEIA.dGHCHBFALDAH.hAAADEGBXACAZBCHfHCFhAAAgCCDCDGBBHAAhABAaHBAAGACIAHHKDAAEFED.RFEB.....hACA......hADA...,1,-15,-18,3
eTNUSMWBQaPcKIVgfHDFdbCXAGLJYZERO,JHDAZDAGEGBA..RCDF.eECAUFGD..SHDEBGCF.QBAHhAAAaAAF.KFFHICCFhACAfBFEFDFE.hADAdAGF.XEGBAAEBLAFEOABG..hAFANDBEMCFE...hBAA...,2,-35,-15,20
TMXSWRQEDAbJdOfCaUILZVPgHNBYeKcFG,dDCDOAFBCBFG.UCAEZGFA....VABAHFEEBHDBeCHB.KECGFCGEhAAAMICE...XGABhAAASFAA.hABAQEFBAAIDfDGEIHBE.PBABhABAYADH..hACA...,2,-31,-29,2
dQeHCfSAaFRLGZEDIOKVNTgbWYXcJPBMU,aEHBFDBDGEDGZFCE.EBBGDDEE.KAAB..VAGF..TAGHhAAA..gGGAhAAA.bADFXBDChACAJDHBBDFDdDAAHGAACGADAHHAIHDEOCAB.WEFHhADA.....hABA...,2,-33,-5,28
dQfHBgSOZNGMeYaWRcULbPIADXEKVFCJT,EDABKEHBCBAEdBBE.HGFEBEDEOHCCZFEB.GCEC..eBFC.hAAAaFBBRAGB.LDCChAAAPFBEAEHHDEAHXGAChABA.JACCfADD.SHGAhABA.....hAFA...,1,-4,-38,34
fgLTMKWaCYGZAXIFPUJbBONRHeDdEcQVS,FGFCUDACBADGOAGBRBFE.HEDHDCAG...EGHFQEGE.hAAA.fDGAhABALFACMECEWCAECHFGGGAFhAAAACIH.IABFJABENIAB....cFGBhAFA.....hAEA...,2,-35,-14,21
IRdHQbeEYDPOFTAcaGfKMLNBZJgSUXVWC,GEAHKGFHMDIDBCCHZCBE.SAGG..UGBGVGDGCAHBdAAChACAQGGCEAFE.PEEAhAAA...FACEhABAAFDCaADCfHAFJEEAXEAC...hACA.RBEG.....hAFA...,1,-11,-32,21
cHTfUABFNeMGXRVSYaZIdLCQOEDKJgPWb,FEGDMDEBGECERDFE..SEAGaBCEZCFELAFGCFFD.QGAChAAAOHDAKBBEJBAB.hAAA.gAGDhABA.PDAAcDBBfHGFBHHGXGEDhABA.....hACA...,1,-7,-36,29
MNDJaIQKSYBGbLPZVFOeWdXTgcfHRUEAC,CBFDDDGG..aBAGQFAB.SCAGBCCHLCHHZFDGOHBChAAAeDABdEEE..hAAAXDDEgGGAhABAcABCRGBGADGDMAFAJBFCKEHH...bGEE..hACA......hADA...,2,-25,-19,6
WGEMHZNOVTPJBICDbFARcUgeXQfYSLKad,UFDHeDACQAAB..SCAFKAFAdDEGGCFEMABEZBEDhAAAOHAAPCGHBEBAhABACBDFFFAGAFHD....hAFA.gCCAXADBfHDFhAHAaGHFEBHD......hAIA.NBIE..,1,-17,-21,4
NOfIGUERHeTdWbCcAPMJDYgXLKaBQSZFV,JCHDDACB....XFGCLBEHBHHGZEAEFACG..OGAAhAAAGGAHEADHeGFEdDDFCHADABABMBBFhAAAKGEH..QDAChABA.SDHDNBGEICDE..hABA......hAFA...,1,-29,-33,4
fCVTHRaYSWIXFKdGeMDLUANZJcOgBbPQE,ZFDFJEEG.OAGDBEBG...QAEBEGGG.CGGHHBBAaBBDSAGHhAAA..IDDHhAAAFHDEKGBFdADDMCIBhABADCAHADAHgFAE.PDGB.hABA......hACA...,1,-11,-46,35
IWCKUDQabcHdRgLefPXJEOGZBMNYSVTAF,FHBGCFDGDBDCQFDE..aGHBHBFAdCDELHDEPBACXDAGhAAAEDAC..ZAGBBHHGhABAMFFG..YFGDhACASFAATCDCABCDIBAEKFBC..hAAA......hABA...,1,-3,-40,37
SOTYPCeXKIEABGZbNUVFfdcRDgaQJLMWH,BBGFGEDHZFDEUGCCFBBC.dCBEDGHB..QGACLDBCHEAChAAASGHF.OAFBhAAATGADCAHH..XACBhABAIADAAEHE.NAIE......fEHEhABA.gDEHhACA,1,-28,-33,5
JKUIZdVcAaEYFWXHCODSMRNLTPBbefGQg,aAFBEAFBFABDHCAE.OHDADDDB..MECHRAGFLFGHBFEB.eEEChAAAQDGCJBBC.KDAFhAAAZEAEdGGBAIDG...XCDBhABANGBB.PHCC...fAHAhADA...hABA...,1,-12,-24,12
GTCWecEZARbSDXaILQHKdYOJfPFgUNMVB,RDAGSHFGDIGE..aEDELEBBHFAHdHDBODGD.PBFAhAAAFFGGUBCH.MADChAAABCBACAHA.eBBE.EDDFhABAAHHE.IGDGKBAD.YDAF.fFFEhACA.NDIC.hADA...,2,-28,-27,1
eKgWECbdVHBDOPJSFQGTaNAZILRUfYXcM,ZFDFLFBBRAACUGABXCBF..MDGHKBDEEGDGdDADBBFH.hAAA.OFFG.SACChABA.FBHFhAFA.QDDFaGHDAFACIDEDfGHAhAGA......hAHA...,2,-49,-24,25
DMOJHEbGaKeNWgFPITVUYdXQBLfcSRACZ,CFCFDCCD.MDAHHBEFGEEEKGAHeHDE....NBCF.FFGB.ICHBhAAATECH..VBGFhAAAUBAGdGHEXCCBhABABBAHLHAESAEEADDC......hACA......hADA...,2,-28,-17,11
XdGbHIQSDVWAfKTNFBEZLMOYPgRUeCJca,TGBCBFEDLCFB.MCBFOAAF.PCCCRADCCCDD.JADCaHGChAAAGGEBHGAESFHHhABADACFAIAAKAHH.NCCA.FDFEhAAAZDGB...........hAGA......hAHA...,2,-26,-16,10
AgWHBCGDETbROcSUdQIMXNfeaLKFJZVYP,HAADGCCGDFFCECGERFDF.OFFAUBGG..QGAGMFEB..fHBBhAAALEAAFADEhAAAJABC.ZCCE..PBEDhAEAAGIDBGGGCAHH..cGGC.dFAFNEEF.KBBF.hACA......hADA...,2,-14,-4,10
ZCOQAFPYXTaEdUgRGVDbNWMBeJILcHSKf,FHBGXCBCEDAE.UBFBRDGHGCCB.DGEF..NECFBAHB.eBBEhAAALEAAHGFAKEHHhABAfAAFCAFE.AGIBTAGEhAAAaGDD.gACHWCAD.MGAAhAFA......hAGA...,2,-22,-21,1
eUEYKaARVGDZSgBWQOFbHTNCfdPLMXIJc,VCADDDGBZECH.BBFDOGEAHCCG..CDDE.dGAALAHHMEIB.JHCGhAAAeEGH.UAAFEFBFKBBChABAACHD.GAFE.hABASFDC...WHFAFAFANEFA.hACAfDAA.hADA...,1,-22,-24,2
WeFQBHGZTCEVPXfUKNDYAbRMagdcOISJL,RFACMHFGdACB..OBBEJBCCLHBA.FBGHHEEC.ZAFAEFEAVGDEhAAA..XBADhAAAfDDHUFABDDIFADFHaDHDhABA...IDDFWHAGBHHECEABNACF..hABA......hAGA...,2,-23,-17,6
eSACOGTUVLJDNFYgdKXIaPHfRcEZMBbWQ,GACBUCCBLBAFDFAAFHEA.dFCCKEDB..aEGBHCAG.RGAAEAAHZAFCMIAEhAAA.BFEGbAGF.hAAAeEHF.ABCA.TFGHhACA...........hABA......hACA...,1,-14,-33,19
FXedcKZYETbWCgPUDMaVQJOSAHBfLRGNI,BFDDLFBBRGEEGAAFFBCBeEDGdBFAZEAB..EGDB..TDDFhAAACGHBUAFFDIACMABA.aHFEhAAAJCHB.AGGE.HDFC.hABAfGAANADB.......hAIA......hBHA...,2,-26,-11,15
SWRTCQBbKdJaIZeVFYUOfcEPALGDgNHMX,LDCHGDCCDAHDHGFAMBCCSCFC.TEAAQFEDhAAABBDDdAEBJCDAaHFEeHBAhAAAFGADOEFEECAD.AAIH.hABANABF....WFHBCBBHKCHB.....hAGA......hAIA...,1,-5,-25,20
QGNFYPHBfVaOecDARbMILXUCdZKSWJEgT,RFACMCCALDHFUDBAZFGDKDDB....JCACEBHH..QGFHhAAAFGEGHAECBEEA.aAAFhACAcFDDAEAE.IDFDhABACDGG...SAEEWHAG..hACA......hADA...,2,-36,-27,9
PGgYcdTKNJWVUfSbZLRAQFOCIHDeEaXMB,QGGDCDGFHFCEDAAD.aBBABAEC.GCAG..cEEAKAHFJFHBhABAUBFF.SCABhAAAZFFDAIAA.IGEBhABAeCDCEDEFPHAE.dEAD.NDDC..WAHBhACA......hADA...,1,-16,-25,9
HLYDZEIbTdVRWJKSgeNBPQCFaMOUGAXfc,XCBCHAADDGEHZGAG.EBEGTABC.RBGHKFHBSDFC.hAAAeFFHBAFGCHHAFEAEOEEDhABAAEDALADCbECBdGAA.hADA............hAEA......hAGA...,2,-24,-21,3
ZASPBWVceYMLIaJFUHRNGXfgKDCEOQdbT,BFEDVAAD.eDHBLFFH..aCCDFGDGRADDGDAG.XGGHhAAAKGBFCFACECFF.QDCFhAAAbGDC.AICC.SBBBhABAPAEE.WCGDMAIDIAHAhACAJFHF......hADA...,2,-22,-15,7
QgIJbSMBeWaDOPELVCRKYAcfNFdUGZTXH,...NDHC.dFAAGCCHZFFGTACGHFAHQAAC.IFEBhACAbFDHBCGA.aEDAPHCEhADAEAACLCCAhAAARAFGAEAEfADFFAGG........hAHA......hAIA...,2,-20,-9,11
KNCZXMJPEIQFaUWOYTGRSVfeHDgbALBcd,LAFBdEGDCEDAZAAF.JDCD..EGCGQACG.UEFCOBFBhACAGBAEVACBeHFEDGHBAFABhAEABHDD.KCHBMAIDhAFAIHBBFHBC.aEAH....YFFFhAGA.....hAAA.SAHF.,1,-8,-22,14
GdJBAgCFUeNKMIOSZWfEPTRQbXDHcVaYL,FEGDUDACeDBEMCID..OCFBZFDD.EGEDTABA..RADFQAAChACADHAGHGFEaDFELAHFhADAdAEFAAIH.CGAGNEIEKCEGhAAA.SECH......hABA......hADA...,1,-16,-20,4
NYgRaLPFDKCOZHIcWBUTJGMSeVQEfbXdA,...NDDG.REFHLADF.FEBGDIDACAFGZGAGHBBD.IAHChAAABCBAUAGETFAD.GAFEhABASFEFQFFBhACAEABF.fADE....hAEA......hAFA...,2,-37,-20,17
BTOASJgUeLVPHYFdIfREKNQZacWCGbMDX,JCCHUDACLBEGHGFEdGCA.RAEG.KDGCZEFE..aAAFCBBEGDCF.hACADAGCBAGF.TFFDhADAABIB..SAAFhACAgFAG.PFDD...YFHBhAEA....hAFA...,2,-42,-21,21
dMQHCcUIaAVNbRWSJZeYLBFTDPEfOGKXg,VAADRAAD..SHEEeFBABAEGFDBEDFGGEGBA.GADEKHEAdDEBHCFChAAA.CGGE.UAGBACAF.hACA.bEFE...JAFEhADAYHAE.TDBAfFAF.hAAA.OFEC..hACA...,2,-34,0,34
BUYMTegVGfPbdDQWCKcAaEXZJNIOSFHLR,EFAAZADGJEFC..OCCDFFAH.LHACUGGG.TFGF.VAAGhAAAGCBC..bFEFhADAQGCHKBEG.hAEAABACXDDBIDGH.RBFAMAAAfAFBhAHADFFF......hAIA...,1,-16,-21,5
WgZAIEOdKNSbfLDBeCHYPTJaMFXVGcURQ,OCCHdAFBSFFELCHBDDCACAHB..HEAF..PHCCaDFFMBCGhAAAFECBGAACREDD.hABAQBGBgGGAhACAAAAFEADDKHBA...fEAEBHEH.YFHBhACA...hADA...,2,-15,-13,2
HeTUNAZaYCFcOMVLfBRJIgXSEWQdGDPbK,ZDAGCFEDFAEFOAHF.LADERDAC..JHFAXABD.EFEAhAAAdGBG.GCFCDCHFKHAGhABATBCEAHHF.aAGCMFIHhAHA.BGCE..IHDEWBFD.QAAFhABA..hADA...,1,-22,-37,15
cCHeBWYITDVGAJNbOgSQFUKPMaLfdZERX,JGEAOGEA..SGCGQAFBKDGEMICG.LABAhAAAdFAGZBBEEBGAXDFH.hAAAHCDDBBACICHAhACADIGAAIAA.NDAC.bDDGFFCFaEAA......hABA......hACA...,2,-35,-2,33
KefEAZSGbYMaXTDcQUgICBJWRNdFOLHVP,SBBDGAFEMBCH..aACGDABG.QDDAUDGBCAAFBFEFJHDCREGHhAAAdHBD.FHFEHEAFKBGB.hAFAEBDAAFCD..ZBEB..hAGA.XDBA.......hAEA......hAFA...,2,-26,-19,7
FGgbdQZMSKYWfNTCADEJcHPVRLIBaUeOX,JEACHAAD.RDEGLHFEBHEAUACGeADB.FGBBGBGAdAHCZCCFMFGFhAAAKGDH....fCFBhAAATDDF.DFAEEGCBhABA............hAFA.cGAC..hAGA...,2,-44,-9,35
ZTRHYMGNUVgCFaSfcEWOXdLDJbQIPAeKB,BDGFTBBHRFBBHABA.MFEBUFGG.CGDCFCHHaGGA....SEDChAAAEACEOEAFXDAGhABADDEEQAEChAAAAGFBKAGH.ZFEF..NBIEfHFFcAGA..hADAdBAC.....hAEA...,2,-26,-12,14
XEQDefFUYOMHSZgWNVcJAKPTCGIbaLBRd,TGBCCECDGGCH..aBFGBAGD.RBCAdCAAEACAeHFA..FABCOFAGhAAAMCGBZDEF..hAAAgEEF.hADANCAD.JFABADECIFHE.....hAEA......hAFA...,1,-17,-32,15
HYIbFDQVfMXKSJLNGZRCWeTPOAdUacgEB,UFCEaHBG.EAFCBCBEHEGD....IEGCFABBDEBBQCEAhAAA.MBDBKDDHLBDAhAAA.NDFGZAGFhABAWBHBTEBFAAEE.dEAC...gGGAhACA...hADA...,2,-31,-24,7
UGYgQIVLZDHaPSfcAMRCEbKWeJXOFNTBd,MEEDEBBDKEDE..eBEEODADFDFHBHGG.UCADGDGG.QGEAhAAAVFAB.LFCBhABAZDGBaABASFHHhAAAACHECHBFJAEGXCEA......hACA......hADA...,2,-25,-19,6
RObQgBHTWPIUfESKJNZCVMLYXeGAcdFaD,dAFBDGGDRCCEQABGBHBF.HEFA.TCGGIAAC.UDGHhACAfCDF.EGBChAAAKAHBNIAH.CGACLECAhADA.eBCEcDCCOHCCWDAD...hAEA......hAFA.SFHD.,1,-3,-28,25
NKXASfVBcGEgPLWTUOFRHCeaZdbIJDQYM,SCFCBFDDGAEGEAADLCAG.TAAFFGGERDAECGDB.eCDBhABAaCGEZFFGdADD..IAHHhACADIAEQEAAhAAA.MIEAXDFAABHCfEFFcGAH..hACA......hADA...,2,-18,-18,0
GTUaQeLWJYAScIKOHfBRVMbEPNZdXFDgC,SHBGKHBGHDDGRBGH.MFEBEGFB..ZCBEdGFDDFCECFBHGCBB.aDGAhAAAeADE.LBAEhAAAJADGABAH.IGAChABABBBEPDAB.FAHH.......hACA......hAGA...,1,-19,-20,1
NZEXYDaTbPKgBIMeSROQdLHUCWJfcGAVF,VDAGFCFCZBDF..EFCFDGEF...aEACTGEH..KGHHIBGDhAAASAGG.OBAFhAAAQABF.hABALEFEHEFCCDCBfHABACACXDDFPFABhACABHCB.MIBE.hACA...,1,-9,-37,28
cNeFVKdaPQDSGCfUbLOZYWBAREgXIJMTH,RDAGXGBCMAHF.HDEHeFAHKDAC..aBCGQACBGEDACCDH.UAFHhAAALDFGOFHHZFFFhAAABHEEAABCEAFBIBAFhABA...cCCDFFHF.....hADA......hAEA...,1,-9,-12,3
IaUNdMCTeSOEXVFPfLGQZYAgHWJcDRbKB,HAADJGEA.DEDGKFAGBCEF.UAGFMADB..CDHG.eCEF.EAEFVFAGhAAA..FAHDLGEAhACAQDFHAGID..hAAA.gCAA..WDFBRGBAIABHhAEANIDB....hAGA...,2,-34,-29,5
NEecAFLIHTgQdZGDCPXKBWOSUYVaMbRJf,LCCHTFDH.dGDHDDBFCEGD.KGHHBBHH..SAHDUBEF.hAAAaAEEMEAD.RBAB.NEAG.hAAAeHBGAABFHDFH.QDCFhACA.PACDXGGC.OABGhAFA....hAGA...,2,-32,-15,17
FNcGEYWaPeKfMRgdASJTQbHZIDVCOBLUX,SGDDJDCH.QABDHABGDBFFCGFBBCGAUGABFEGC.GCDChAAAEEHF.aHGAKCACRAFCACID.hAAAZDAFOAFG.LFEDhABAXFFC.cGAH..PBGDhACAMCCF.....hABA...,1,-11,-26,15
LKGOEFXDaCUPZVQHdNSeAYBIbWRfcMJTg,BFDG..bDBHRAFAMEBFJDHF.LGFGKCACGBEHFACG..DIAGaGEEhAAA..CAAF.UDDCZCGBHCDBhAFASFAFADIH.hAGAIADF.WHAA.....hAIA......hBBA.fCFE.,2,-26,-22,4
TGMeVWBLKfIaXSJdFOgNcAHURYDEZbCQP,UBBHDHCEECACCEAH...QDDGGDECMCFEeGFA.BAACKDHD.aBEGhACA.....SHAGhADAFECGgGBEhAAAAHIFRDBFZAGF..PAEE.....hAEA......hAFA...,2,-35,-22,13
JdWHGAgfCIMScZQbFKDLeOEBRXVYaPNUT,CFDGMHFGZAFA.FAEHDDEALBAG..EEFCBEFDRABH...VGAAhAAAaGGG.UDAEdHFH...hAAA....WDDBhABAAAGAgDAE.IHDHQDGFhACA.KAGA....hADA...,2,-41,-30,11
WBcfMCZUJLeHVGQAFbTYgdPNSIEDaROKX,TGBCdHBHSAEH.DDAFOBFG.XCEGBEBEMBDFhAAAUGEGeBGHHEAAQGGAhABAFGHHgABDhAAAIFDFaEFEKDBC.fADFCFFFJABB..hADA......hAGA...,1,-11,-28,17
aSEBPIYeQTMGLVNcZXURHJdDCAgWfObKF,...fHBHODCHKFEAFFAEaCCABAHE....PBFChAAAYFDGQDDBhABA.MFHBLCEEhAAANBBDZEAFUDGFJFHFDBAAAHDA.gDCDSHAGEADAhABAICAH..hACA...,1,-18,-24,6
HSgJCPEQDAWUNdTcaILZbMXVBRfYFeOKG,UCBCTGBC..aAGHLECEZECE.MCCGBGDBRGFG.FBDAKBGHHFABhAAAJAAC...EHEAADAC.dDHAhABAIAFA.XDGEhADAfHGHeFDB.SEAFhAEACACCDAIF......hAHA...,2,-22,-21,1
UFgRTdLWNEIMQaXDHbZCfGVYAPcJBKSeO,JGEABEFA.SEAHUCAC.FFCCRFADdAAFLBBE..EDHFIDEBhAAA.aCCHDADGhAGA.ZFCBCFHC..GGDHhABAVCDEAIHAKHBA.OADA.....hAHA......hAIA...,2,-37,-22,15
XWOFPaGALSUNbTMRKEgeIJCQYVfHBdDZc,SAADUCBC..bGCGMAFB.KCBBEEEFeFFC..CABAVCFAhAAAfBGG.BGAAhABADIECXADFhABAFHGAaEDGAGEBLADFTFGCIAGA...hACA......hAGA...,2,-28,-22,6
aIZFBJgKVLdXNRWOPMeAEbQfUHDSYcCTG,QGBCHEFHDGIFSCCFCECCGBEBZACFBAGFKFHBLHBC.hAAAdADHXEFFRBFA.hAAA.WDEDPBABACBB.hABAEHDC.fEAA..cEAFhACA......hAEA...,1,-12,-28,16
NObdPYEKLRgcXWMHfTUGIVDCFaBAZSJeQ,ZDEDJFFB.QGBD.OABAbEDFdGCEEBFALCBC.REAF.hAAAXDCA.MEIBhAAAfHGFTBBFIGGFhAFACCHCBABFAEABeACA.....hAGA......hAHA...,1,-22,-25,3
ZNSKDUObCgATfLYHVXdIeJMQEBcGPaFRW,TDACLGEA.VCFEdDGBeBBA.JEEBEAHB.BCCB.GDAFhAAAaHGARGAAZAFESADChABADBAA.UGAHCDDHAFID.fFFHhACA........hAGA......hAIA...,2,-28,-20,8
FgKOYEeZcVUWLQSHBRDCINGJabXTAPfdM,dHBHMHFGKGFA..OFCFEAHHZDAGUEGC.LECESFECBAEEhAAACEHH.GBAC.JAHHhABAXBAHACCC.fFCChAAAFGAC.gCFDcACA..hABA.WACC...hAGA...,2,-30,-27,3
MTJRDZSLIaOVWPQFeXUKcGdCgYbHEANfB,BFDGMIFGRCADSACF.LGFCaEHFOAEA...PCFDhAAAFFADUDCF.GBDBhAAACABH.YAFChABAHFCFABHCfFFEDBBBIEHE....hAEA......hBAA...,2,-28,-26,2
bTfCZRJGPVNBKOXgMWUAeYacdSIFLDEQH,aDCDdAFBSFHFLEHDDFFDHEAG.TGCHCAHDRAAE..GBDDhAAAVDDCBABG.KCCEgGBFhACAMFGBABIHeBGDhAAAIEADEACE.fHDB...hAEA......hAIA...,2,-23,-9,14
MAFRPOZaWJcGHVfSTLIXBbeCDdNgQYEKU,FCFCRFDFZDFA..aCADJHFEHACE...SEHDTBDA.IECDhAAABGBBCAHD..DAABdAGFhABA.NEEE....QGFHhACAECBDKBBEAFAAODDBWCHBVFAF..hAEAfFFB.hAFA...,1,-13,-40,27
fdAgDTQKGeIVRYPCaXOEBScMbNZHJFUWL,DAFBTFCAQFGA.GDCGICFDRBAC.CBCA.OBGBBGFHSCHFhAAAMEAHZEEF.hAAAHDDEFHAE.LEABhABAAEBBKHDA..YABCaFFG.....hACA.EAFC.NIBB...hADA...,1,-6,-23,17
WfTMRbeNPXgZYISaDEACJOBLKdQVcHGUF,CECDJEGHBDHHLFCE..QDECHAGFGAAFUGCGFCEB.TGAEhAAAMDABeGFA.hABAXBFAgDAFhADAZAAESBECEHEEADDH.KHAC....hAAA......hABA...,2,-29,-4,25
dMaQJUTgIABVFROLWDGZScefHYCXNPKbE,FBBDLFFCDAAFZBFGeBAE.HCDECDGH.XGAAKHGE..dAFHaEBEhAAAUGDE..ICAEhABAAADC.VAECOFFAhABASHGA.fGEGPGACMBEFhACA.....hACA...,2,-42,-16,26
VUPIbNCfJMgYdAQWTGLFSRcaHODeXBKZE,QCGCTFGH.LBFCSHCCRBBHHECHDEBEBGADEFEFUGAEhAAAIFDGCADH.MAIDhAAAgGFFABBGGBDFFBABhABAaCAE.eAEE.XGED...hACA......hADA...,1,-5,-13,8
aQXdPJLTBOUMZDHbYRSGWVfecgFAECNIK,CFEDKHBG.QBDAdHADLBFABEFEUACGMACBHDFE..RAGHSHEAhAAAGBAE.VEABhABAfHGH.hADA.cGGAAFAFNEDC.IGDHaGGG...hAAA......hABA...,2,-24,-19,5
MKEYHIXGPcJTFfeNROLVBZdCDgaSQWbUA,EHBGHAADGCGEJCGFFFDAeCBD..OECHBHHGZEEHDCDH.SACDhAAA.QADEhABA...WGAEhADAbAECAGIFMAIFIHAE.XGGHhAAA.PHCCTAFCNCAA.hACA...,1,-1,-38,37
LJPOTQKFcCRANEIMXfbUGZeYBWaDgHVSd,EHBGXFDBUAADGEAHZAEABDHF..DAHBHCDGdHEFLBEFhABAJAAFOFAEKDGA..CGHGAHFFMGFEhADA....eHAAhABAaDBASGAF.....hACA......hADA...,1,-17,-32,15
DIAgcPCSfTVeHEBRUXLMbaQZFWJNOGYKd,...PGEACEFASECB..VBDEEACBUFAHMDIDQFADhAAAFBFA.NAEHGBBEhABAdHEHDAAFAEEE.fDHAhABATDFHBBHCXDAFaHDC...JFHBhADAKDAF.....hAEA...,2,-35,-1,34
dHWQETGLZcbefaYSFXKURVCNADMOIgJPB,MFECOGEA..JAABdAHAHEBHQBACGBDDZGEGeEDE.aBEDSEADhAAAKECF..hACAUGBFCAHGAHIHDIFAIHHGhAAABDGEECCBTACA.......hADA......hAEA...,2,-19,-15,4
IFGbUKDgAcCaOVJWeTZQfPEMSXHNLRBYd,aEGDJFFC...eFCDZFBGQAEFEAAE..MFIHHBCFLEDGhACABBBGdAHAGADHhADAbGCA.DBIFAHHE.CCDD...hAEA..WAAD.fCFA..hABA......hACA...,1,-22,-29,7
UZRPGeHOSFYLWTAEXaJfCMINKgBdQDVcb,XFCEJCCH..MBDCKABEBBCAdCGADCBF..VFFAUGAFRDEAGAEFhAAAHFEB..SGDDhAAAFEAALHAEAABCEGGEhADAaDDB....fEAENIEB..hAEA......hAFA...,1,-11,-36,25
IaBMUfgHVZJNCcFYQKEeWTSDOAPRLbGXd,RFDFGECFdABCBAEBUGAHHDFDZDGB..CAAB.FAHFKAEG..EGHH.eCFEhAAASBCD.AECALCAFhACAIDCCMGAAhADA..fBGH.gGDGhADA....hAEA...,1,-25,-31,6
OVJSdUbGDeZNBTRIEPAXaLHCfKQWMFYgc,XGGDaDBDLAACHGDAKAEC..MBEBFDDA.....cFBBhAAA.OCABVFGBdGCEhAHAGBFEDAIFNCBBBABChADA.IBCDEBGFAEGHCGBD.fAHA.hBBAYCHB.SHAAhAEA,1,-1,-34,33
MPFRaJdGfYAOXNDeCSQVgLKHBEcbITUZW,ODACXAFBDBAD..SBAAQFCGLEBCKAFDBDDBEDFChAAA...IHGHhABAUEFGMIFE.RAGFaFHDhAAAdFDDYAEFAGAB.CFHA.HBBE...hACA......hADA...,1,-19,-27,8
TPbZEIMGYVgJWQLCeBAHfXcDaFRUSKdON,XFDHDGHHRFCE.KBGBdDAB.OBGB..NDBD...TABAhAAAPBAEEBEB..IFGEhAAAMAFE..YBHBhABAgEAC..JHBCQAEFhABACHFDAEEG......hACA...,2,-41,-22,19
NDbJMUXOCadWZQEgSVRFBYGHTePIKAcfL,LGEADACBMFID.UGBD.CCDE.dBDGZADCEGCG...SHFEhAAAFEAGGDDDeDAGKAACAEIHfBFChABA.NCHC.hADAbAGB..OFBHaFCG.gEEEhAEABCBC......hAFA...,2,-25,-25,0
OdeabSPTAGLcVQHYNFZBUfJMKIERgDWCX,LFEFQFDHHCCBFDBDZAACBDGE.JBABKAGDRFBF.DGGH..CAFEdFGFhAAAeHAE...SDEGhABAABIF...hABAcBGD.NCAE.fGHEMEHF.IBEFhACA...hACA...,2,-34,-32,2
PWBNDaCeGgJfcEVXLMRZUKYHSFdIOTbAQ,QCBCBFDGaAFAGCGGJFAC...EEAEVEGDLADFZAGBKABCSFEBhAAA.ICAFhABATGEEAICCNIBD.DDFHhAAA.CGAGeBDE..fGBB.hAEAcGGC.XCEBhACA.,1,-20,-32,12
QYHXPbRALWZSKJDgCfUTNcMeVaBdOFGEI,LFBBZDAGKEFADGCFCBHHUBCA....TAACMFDE..aAFEdADDhAAAGEGCEBGG.QBAChAAAXGGHREDBAGDDJDEEhABA..fGAE.eCDGBGAHODHFhACA....hAEA...,1,-20,-24,4
QAdNaMOHfEGWRUJebFPcYVKLBDTZCXSgI,dAFBaGFHHAACEDACGDDGRBDG.UACGJDGDFDAB....PHFGhAAAVFAHLDDFDGGEZCFASEBHhABA..hAIAIGHEADDDMICC........hAAA......hABA...,1,-11,-26,15
bKDCPWATgeEfcIRaQHBSLdNYMJUGXOZVF,TDACEDCD..IBGHQFFE.BHCDdEGAMHDCGBCDOABHhAAAFAFAKCGACADBAIHEfFBFhAAARFAA.aHECSEEHhACA.NAIC.JDEBXDDB.hABA......hACA...,1,-20,-21,1
dRPKIUHgDaYMBVbefQcAEFCXGTNZLJOWS,EEHBFFFBCAAFGAFA.ZABAOCHDdEAH.RACF.KCAAHFCBDEDC..aHBGBBFGhACA.eEAAQFDEhAAAAHBH.XGGDhACATAGC.NAIE...WBBF...SGHHhAEA...hADA...,1,-16,-28,12
FPUbCgITaDZSKJGBREdOXANfYcLQeHWVM,...fFAFLGEAHCFEMHFCUDGGgFBH.aEFHDBDDhAAAZBAESFDGhABAKAGCBDDEdEAAABHANCEH..QCAChACAWABE.PHAACAFD.IAFChADA......hAEA...,1,-16,-26,10
VfEAbgWFcdBJGCZeUXSPQLMHTONDYIRKa,...bAADFGFC.dCGCGEAGeCAAUGBG..SEDFhAAA.LAFDMAFETDDDhAAADHEAIHCFhACAaBEFEABEABBF...........hADA.WAHHBHDBCGGBZEFEhAEAXEGA.,2,-29,-13,16
baBPeRJNOMDWYLIZTUKgcXdFECfSHGVQA,BFEDeFBBRCCGJCEC..MBEADBDH.LEFHZFBB.UAACKHEA...hAAAXDACFAFG.EHGChADACDAF.HECEQGGEhABA...aCAANBIC...OEEG.hAEA....IBHEhACAcGDG,2,-51,-18,33
aJCKHDebTQSNMOPZXVgIdRfWAFUYEcBGL,UGBCEHBGBAFELBEC.CHHE.KFEBHDFADCEBeABDQBAG.hAAASDBHMADFOFBGhACAXFDF.IACEhAAAdEAGfDGDAGHG.FGGB...hABA......hAEA...,1,-23,-32,9
AXWVCIDgPTEdGUeBFRfLONQabHMZKSYJc,VEFHCAEDDDDH.....TAACdCBGGGEHeAFCBDEGFFAERDGHLAAEhAFAODAH..QGCFhAAAaEEF.bBDCZGAEhAGASDFE.cEBAABID.IBHGhACAECDE....hADA...,1,-22,-23,1
bSEaQHFYXNeBLGJKUOZRCDTdMVgfWPIcA,SAFBaFAAHCBAFEFC..XGGEBHDAJAEHUDCH.RCGBCACGDGHF.hAAAdCAG..MCCE.hAAAfEAGIBGCAHADhABAQFDB.NICHeBADLGDCKHAC.hABAOCHF...hADA...,1,-13,-26,13
CBWTQGaNPHEJLZXUcSVeDIRFYbMgfAdKO,dEEDCDGFBFAGQGCDGFCD...aCAAHAEDEBDELBHDUCAGSHEAhAAAeBFHDEACFFHBMIFAhAAAAHIH.KGACOADHhABATFGFJHAA..........hACA......hAEA...,1,-8,-24,16
ZKCHJVGTcUOWEfADBFXdbRYeMNIagQSLP,DFEABFCFdHBHRAFA..eDBAMCBC...aHEEQGDF.SABDhAAAZBFAKACEJDDGGEEBhACA.TACChAEAUFADODGFEGHHAGAF.XAAC...hAFA......hAGA...,2,-35,-20,15
aUIgAQFdCNZeHSfOcKbGVDRXYMWBPJELT,FFHBCFEDZBFAeGDEHGBA..OCBGKEBDGDGGDBAE.RCCF.MAFGBADDECHBhAAA..aBACUDEGAIAAdAGFhAAASHEG.hABA..fGBC.cDBD.hACA......hAEA...,1,-22,-23,1
HbAcSCPFTUgdYaKLBOXeGEJfZWQIMRNDV,CFEDTGBCdBED..KBBCBBBF.OHFCeDCFEBABZBDG..QEEHhAAAMCID.DAHFVGFChAAAAEHGSGAFFEAB.hABAgDBDaHAG.......hACA......hADA...,2,-33,-23,10
gaIQbGeKLTJBVMDRfAUWFNdOPESYHcXZC,FGFCOCCHEHDE.HAECZAFA.CEFD...aCGCIHECGBBHLEADhAAA.BEGEMCAHDDFHhABAfHABAACC.hAEANDIASBBFXEBE.gGGDhAAA.bDDB....hABA...,1,-19,-30,11
NdeJaRFSfIYPKBbcTUAEZVQDGCMgHWXOL,ZBCFVFEEDCAC.GFCBMIAG.HGFC.OHAGdBABJECG..FBEASFADhAAA..hABAfDAFIBFAPADFhACABDFDbAGBTDAE.AEIH.CABCWFFEhAAAXDGB....hADA...,1,-14,-31,17
DIBHeKdLVOSZWFagMcGbPAUTXCENfRJYQ,XCCBEEGDRBAE..QADABDBEHADCKEDALHFG.VBGHhAAASGAAFEEBMEAFhABAbAFE.AIGG.CBBFfFGGhACADEIFeGDCOCFE.WDADaHAE...hADA......hAEA...,1,-14,-15,1
AKaeOcHBPYLSVXfTdWDUCMFgNJEbIZRQG,KEEDeFFBHFAGBEACLBFG..XBACfHFHdGCBDDDChAAACECBFBBBJBGD..IEHEhAAAZFAB....hABA............hACA......hADA...,1,-37,-48,11
BOPACQNIHZMVGXfUTKeWLgJbRYadEcFSD,QGGGHAADZFGDMECDGCAGUFEEKAFALADAJFCH..RDDDaBAGhAAAEBGHFFAH.BDDEAFHACADF.hABA....NAIE.ICCChACA.fDFDWCCE...hAAA......hACA...,1,-21,-23,2
XELdKbQGNDBgRMAeIWCPHSFZOcaTVYJfU,eGEACFDGHAFAZGAA.OBFETEAD..JCCBUBBG.LDEAhAAAdAEBQDGEDEIFBGHDMCBFhAAAIHFE.SAEDhABAaFDCfABBEHAAKHCANIEFAEEF...hACA......hADA...,1,-14,-20,6
AXFcEBNgdDRWfCTIVPbMLHeYQaUKZGSOJ,FGFCBFEDdBFHDCDGRAAF...CAGE...TGBB..VFBHMEFGHBADhAAAeADDaGGGKAFEZBFFOFDFhAAAADDG...EEBEhACANBIG...fEAEIADCLHFAhABA.....hAEA...,1,-23,-28,5
RbeYfAaXLOVJNUFEDCPZIMTGSWcBKQHdg,aGDDXFCALHFA..VBBCJEFFFGBECDHH..ZFFA..TCAGhAAASAGFBECDKAFChABAdFBC.RACE.eEEE.AHHH.hAAAODDGNEACDICAMABE......hAFA......hAIA...,2,-27,-21,6
bBOeGdgCaYMXVUPEIDTcAWQSHZFRKLJfN,SGFCZDDFFBHDLABC..JAEA..NBGC.bDCHBHHE.GCBEhAAAdABEaHAE.MFEGhAAAXBDAUCFEEDADIHAGhAFADEIDAHDB....WBDB....hADA......hAHA...,1,-25,-29,4
WTPMFJDEdbXQGKaRNfgCZAYVcLHIOUSeB,VAADLFBB.OADCSDGGBGEF...TFABMFIHJEFGhAAADDDHdBEH..XCDHhABAKFGFRFDB..NADFCDBHAGAEHABBhADA.IAHC.....hAAA......hACA...,2,-31,-26,5
JEAUKDRVfFBSPCeMGQZIHgNWYacbOdLXT,DDFFRGFGFAHHBBBA..SEAGCHADGADCZGDAHADA...NEDF..hAAA.aDAAOHDCdBHALFBChABAXBBGTFGChACAACGDUGAC.KABCfAFGMAAF..IFDAhAFA.WFFChAGA...,2,-27,-22,5
PaMGJCUgIRHFbEcfXTWZAYNSdeLKBVDQO,SHBGeFFBBCFADAFEOAEB..MABDCDFGUCBFRFBA..FACBECGEhAAA....XCDBhAAATABFAFAG.dFFHKBHBhAEAQFCCaEHF.......hAIA......hBAA...,1,-25,-40,15
MVOcDZJSFgIXHbYfEGALWeCRUBKdQNTPa,LEEGeAFBRDABBGEBdCEBQAGE..PCHBMDDBVFAHhAAAODCCDACA.JABHFHAAhAAA.XBCGHGEEfDBEhAFAAIFECHGEKACCaFDBSHGA..hAGA......hBAA...,1,-11,-25,14
fPZcJDWAdHXINGEKYSLeMbRTVaUFgQCOB,XCCBGAFEKDBGLEBGMHEA..RFAH.aGFAFADB..CAHDBGBGhAAAZDDBDIECAACCHADC.NDIE.hABASAAB.hAEAeDHBbCGB..........hACA......hAFA...,1,-19,-31,12
HMWfDZASJYBKaCXNGOLQIdTgeVURbFPEc,JCCHKEGDCGHCGBEC.LGEAQFAFdBBF.eADDRDAB..FCGAEFDChAAA.MBAHDAFEAIEG.BGBAhAAAaDDEOBBD.hABAIAHC.gBFD..hABA......hACA...,2,-35,-30,5
DKTUAfEQgcNYOdWJVLMGPbIBHaSRCXFeZ,QGBC..gBFG.NBCA.OAAC.WEDChAAALGAAMFIBPAEHhACAIHEE.aFGACGAGFDAGhADADEGAKAADTFDFAEDHECAHdHFB.JCFE...hABA......hACA...,1,-9,-41,32
KYMXLWgZANUPdBOIQTGfRCESDJcVbHFea,UCBCBFEDOHBAQFGCGAAFRFDD.CBFA.SAED.JAFGhAAAVDGH.FDCHaFAEMDAFhAAALDFD..hABAgGGGABID.......hACA......hADA...,1,-27,-32,5
DFSebOICKWLHYNXPBTMgGJaZQUVAdRcfE,dCFCRAADEHGEFDCE..eEACOHFA..IFFCKFACHACG..XBGHhAAATAGCMGDChAAAJDDAQFCGAIDA.hABADIBCCDHA...LACCPBBB.BHEGgGAAhACAaGAB...hAGA...,2,-20,-18,2
OGKIYSVRPXHUfBdJNLFDbZgWcQaAMCeTE,eHAGTGGDGBBD.KEHFIFAD.SCCDRDEFHGFAUAGBhAAAdAEDLFFEhAAADADEZEBF.gBDGhABA.QGCAMCAFCABC.OBHH..hACA......hADA...,1,-13,-17,4
fcFQITAVbaNRUZPHDWYSKegEJLBCXGOdM,VDAGaHBG..REDDUCBBHFFHDEEC..SGGEKAAEEGCE.BCEGhAAAGAGGdAEH.MIBGFAHDQCFChABAAIHAZACE.hADA..PHEC.eFAF....hACA......hADA...,2,-19,-19,0
SbZGJVNdaWcFUgDHERfIQPKeTCYAXLBOM,LGFAMIAGZABEGFCDJEFC..dFBDaAGEFAEG.UDABHDEA.EGHFhAAARAGF.QDAAhABAKAAF..CEEDABCCBCCE.hABASDHB.NCEFcFAHDICEPCCAhACA......hADA...,2,-34,4,38
cSfKHOAJEdIPMWRUVFCZgNQeGbDXTLaBY,JEGHEAFBdBBE..MDCBRDCEFEGGZEAF..QEAGeAAFGBDEDBIFLHBAhAAABEHB.SADFhABAfAFCHFCEhACA.AHHH.WAGH.CBCC....NIBF..hAGA......hAHA...,2,-28,-15,13
VWLePJUHfKgEAFMaGIXNBTQRYSbcDdOCZ,aHBGXAGHBEDC.RDGF...SBEADDEEOGBGCDBF..ZGFEVADAhAAALEFG.JFAAUBABhABAHAAE.KADCAEFAMIDAhACA..IAHFQDCD.cGGChADA.....hAAA...,2,-31,-16,15
LCfVTGQedPgaUDNSKHRWMAcIXBZJYFObE,XCBCBEFAJHDG.FGCD..OCCDLGFG.CCFC...VAGFhAAAGABBdEEC..aBCGDAHBhAAA.KEFARGAG.AIFEcECBhABAZAEFEBAF...fEAEQGGC.gDAFhABANAIA..hACA...,1,-22,-23,1
OQZTXEVWYGHCgFRMUNLPBDASeIKaJdcfb,eCCHKAFBdHAD....fFBGOEEFQAACTEFGEAEF.hACA.VEGBGAGCCFAHRCDC.hADANEECBDFC.SAAChADAaAEBJDCF.cFGD.....hAHA......hAIA...,1,-10,-26,16
EFcXONYHDVfZUTbCGAPIJSBKMeRQWgLad,JGEASEHBBBAB.KEBHRACC...QDECLEDFdAGAECABXGAChAAA.NCCBHFGBhABAfGBAZAEAUGDFhACATDAACDDDABBH..MAFE..WDDE.aFFAhAAA......hABA...,2,-47,10,57
dGDVMgYJIEHUBXLCTWNKacPeSZOfbRFQA,dEHADDGBMDEFJABD.HGAABEDGLFHB.CDAH.TGFE.KCGFhAAAaCGA.eBBGZGBGOBEBhABARDBFABAFGADF..hAAA....YFAA...IAHFhADAEGGF...hABA...,2,-40,-14,26
FIfGKEJAMeUXLCZabRBNdQWcVYSPgTODH,MIFGeDCHLBEDZABERGBA.dBBBQEGF..WAGFVCCDhAAASFAD.hABAPHDETAGB.ODAFhACADGHDIFFGKFEGECGDAGAFCCHEaEGA.BDAFhAAANAFE......hABA...,1,-3,-28,25
FVcELWZgIPOUAYKeQNTDGfMSaXCRBJdHb,eCCHQCGCDCACGBGGSDBG.CEECBBCHdFDGFABC.EGBFLADHhAAAZFEB.IAFGhABAUAEEAHGF.KGFENDAE.fFDGhACA.MIAEXGGB..hAAA......hADA...,1,-21,-24,3
EHWNRPZMFcTXBSVQOaGbAgJILfCYKdDUe,JGEALGEA.CBHCKDBEdABHeDHB.EBEDHAAE.REFAMCAFFGAH.hAAA.XDCCSFAAhAAAOHCCaBECADIHIBGFhACADIGG..WHAENAEF....cEFAhBAABFDC.....hACA...,1,-24,-29,5
RFeBWgGTaKDNbAZLIJdOPXHfCVMQYESUc,ZFDFLEEGdAAHOADBHFCHCGGE..QAGBECABUABC.RDEGeHAAhABABCEFGAEFKEAD.NEAA.hAAAAHHG..IFHAhAEA.XCGAMFIBcDBD....hAEA......hAFA...,1,-13,-20,7
VGOgKaHbBAPdJRDLNeMcYCWIUQSTZFfEX,JCCHDAGDeHBE..MIFACGFA.UGABQECBZBAD.EAEDGBGChAAAOCAAKFEF..aAHHhAAAHADCBABCABAFdGGBNDAE.hADA............hAFA......hAIA...,1,-27,-33,6
QeOBJLRgXZIMdfaNGUYbcACVWPDHETFSK,VDBHDACBEFDF..FHEAKADB..QGBBOAFCBCHFLFEChAAARDFFZBAF.IAGB.hAAAMBIBaFAEUCDF.hABA.bADDCHHG..PHACSACF..hAFA......hAIA...,1,-22,-28,6
UJbMNGIAgTefFOKLYcaBPCEHSQdRZXDVW,TDACFDCDKADHLAFA..aEEDBHGBPAACCAAC..EDACHGAChAAA.dBGEZFEEDIDCUCGChACAJFHDMAID.IEDHhADAAFEG.eCDAYHAE...hAEA.SGEAhAFA...,1,-13,-39,26
DWfARCcOHMTgadbeLVJFGNPSKBIQZYUXE,CFDDOFBBHAFA..MECBaEEG..dFFFeACBLEHHFDEDGBAC.hAAASFGBKABFBDCGZBEAhACAXGEADDDGAHABRGDE.hAAA....gAGE...hABA......hADA...,1,-22,-24,2
dXbFLBQGVDCgAOEUTaMZPRKIfHNSecJWY,EAADUFCA.MEDCRDBEKFFDHAGD..SADDJCAA.dCGGFCEGQGAGhABAVFFG.DCABhACACAABAEIHaDHDZFAF..IAHBhAEA.fFCG...hACA......hADA...,1,-19,-29,10
RHMKYdUFCBGWeEODfSQbcPJAZXIaVgTNL,XFDHaCFC..TFGCRAEGHEAF.KFGBdEEDFABEBEBAGCEAEBBADIAGhAAASDCF.hABA.cAFFAIFC.VGCGhACANDIEMBAFCCDB.OHAEfDAA..hADA......hAEA...,1,-5,-29,24
IDaSMPQbdWgcFJLAZKeRGBXHVCfETNOUY,ZDEDKDBDeFEARDCBBHHGHDDC..CGBH.ECBE.OHEAUDAEDIAG..hAAASGAC.hABAMAAFPAEHdAEB..hACA.....cAGEFBHFACFA...XGEAhADAfDHE.hAFA...,2,-49,-16,33
HIDaNXOCcEGKVQMUTReYJLWAdgSFbPfBZ,dAFBSAFBFEEE....PABCfDBBBBAGHEAHDCCGaGGGhAAAOHDAEDGGGDDEhABAKCDDMAIBTFBE.eEAFhACALDGBAGFDZABGIHHDCGCC...hAAA......hABA...,2,-27,4,31
AICBfbQDePaMSGULOKZEYJNdWXFRHgVcT,BBBDQCBCDHBG.aEGASGHD.LDDFKHAAZAFAJEDHhAAAdGACFDAAHGFA.gACDhABATCFE.CCFH.eFFDhAAAMEAFOAECEFGE.YEHH..hABA......hACA...,2,-32,-7,25
ELYHZUJeQVIDScGXCTOWABFPfdbgNMRKa,FEGDdHBH....bCGBNDCD...KGFGLHDEZBDD.UCACQCAEhAAADFBH.SDFBhABAXEEB.CAGDWFEDhACAAEIHBCHG...gAGEaBBAEFAA.JAAA.hADAeFCF...IHHChADA,2,-29,-26,3
CMgfLFATVIbKBHPDSXONEaJRUZdQceWYG,VEFHKHBGBEBG.DGIBOEDD..EACBaEBE..UEDHZADEdDADhAAA..eCGDGAGEhABACAHE.MFIFLAAFhADA.AGBA..TCDE...IAEChAGA.....hACA...,1,-29,-36,7
ZSaLRIEfbTWcgGYVDOFUNeQdKXJBHCMPA,ZFEESEEDaHAG.LDAAECAC.TGCB..gCGDhAAAGBGEVABGFAEGNIBBQFAFhAAAKEDFBCDCMCFHhABAAIGGIGHB.fBAEcDADDBGG.hABA......hAEA...,2,-18,-16,2
OFTCQZdcUHBLSYPGRANIKWbJEaVeDfgXM,KHBGJGEA.EACG..eAHBDEFC....XGFHMBBBOCCB.hAAACACDZGAEdAFCHAGH.hAAABBAASFFEhABAPCDDAFFEICGHaEHDVEACfAFC.hABA.TGDE..hAEA...,1,-19,-34,15
FHbLJaKEMgfATXePYdGQBZNcRSWDOICUV,TDCHXDAC..eBAEdGEEBHBHZGDERAGBDIGACGGE..FDGHHEADLCCAhAAAaEGCKCAF.EFDAfFBBhABAAHHE..hACA.PAGD.GABFNAAF....hAEA......hAFA...,1,-10,-26,16
aTNLUFAYgeOWDKRGVZPbfJSHcEIdQCBXM,eGEAOFCHKABFGABGZDDE.....PBFGbEAB..SFCDhAAAEEEHQDGEhAAACAGGMIDEaGFHLADHhACAADBBWDAD.DBIH..fGGD...hAFA......hAHA...,2,-28,-16,12
XVKdFNcIUJEBgSReGbHALPZaCfWOYDQMT,LFBBZDAGaCAE.CBHH.OAHDDACG..QFDAMFDH..VEFEhAAAFCEB...IHBEhABAUCBGEDHDBCGGgGGFhAAAeACC.........hACA......hAGA...,2,-33,-32,1
SdTfZABeIGaXcgDFPYRNKMbCOEWHQUVJL,BAFBGECFaECA..XGEEDEAD.FAFERFGHKBDBCCHG...EABBHBAChAAA.QFAChABAJFCDdGEEZBFEICEBhACA.gDGGNDBE......hADA.MIAC...hAAA...,2,-41,-3,38
bKWCUQZEegYHLcXaTVAIMGdNBRDfFSPOJ,GBGABFEDRDAGDIFCSFEA.OEBHJBFB.KEDCCHAA.ZADH.EAAChAAAeHCCHFCBLCHFhAAAXCBB..TBBChABAAIEAIHGG.MAFEfGHG.hBCA......hBDA...,1,-7,-43,36
cGLPACRagENJVOWDBIQFfTYKeHXMUbSZd,aBBDEHBG....VBDBDIDABGFA.QGAHfGHEKFBEeAADhABAHEGDMBFAUEDGbEFAhACASBEB.hADA.dEAALADCPGDCCCGCNAAC.WCCD..hAEA......hAFA...,2,-21,-11,10
cdNSUKBAfPaGLOeDVCXQWFIHZYJRgbEMT,aHBGOHDA.DAGCVCDF..CGBA..QDACIDAGZGFERDFE.hAAAEDGG..TEDEhABANBAB.KACCBGEFAHHAGBCFhAFAXFAG.FBFC.......hBAA......hBBA...,1,-25,-28,3
ZOFNVMXgDSKGUYJbdQeIAEHBTRaCcfWPL,BCAHaDAF.CGEG.....fBABLEADFCGDMBIHDBGAGFBHhAAAUDDF.JEEEdABDeAEChABAABFD.EGHFHFGBRCDA..hAAAcACC..WECDOHBC.NEAE..hACA......hAEA...,2,-43,5,48
BQGfOKXTIRFeSLAMbcEdaZUgVJDWHPNYC,MCCAEHBGZFDFUDBA..JBAGDFEDHCEF....NBGG.BGGE.hAAAfCGHKHAE.hABAIEBHFADE.SEADhAAAAHDBcGGHdCAC.aDEFgADHhABA.....hACA...,2,-43,-21,22
aTEJedVMNDOICPHbfcUgFAGRZXBWKSQYL,RDAHXADCBAGEKFCD..SDDFLADH.aCACEAAF..JGDGdHEFhAAAMCFCOEFA.CCCF.hACAHFAG.fABGhAAA..cFFAFGHBAAIDWEEC..hACA......hAEA...,2,-38,-22,16
SBNWDRICObLKPEcUAYaZJVeMQFdfgHGXT,aCFCZDBGeDFC.FEHFdGBGHBBAXECFBGABDFCBRCAF..CFHDOADAhAAALAFG.KAAEEGFHAGHB.hADA..JAHFMFGF.hABA.fFEC.TABGSFDHhAEAIHHG...hAGA...,1,-17,-27,10
FgJILEGVRBOKfXbTdAUHSNcMPaQYCDWZe,SDAFMCCA.QABCDGEBeCEA.JFCHLABF.EGFChAAAGCDCBEACOEBEhADAfFFETGBEAGIB.hAAANBIC.PBEG.CBHAWEHFFDGDIAGFhAEAKDFC......hAFA...,1,-17,-23,6
WUSNKVIEDdHfBZRCPbYQXTFOgacAeGMJL,eHEAMBEELDDGUEBBKDDE.EHEEHBBA.BCADREACCHHG....PABFhAAAbFFA..XAGGhAAATFFHFGCB.OBHDhABAaABGAHEAJCGB.SAEBIDAEDAGAhADA......hAEA...,1,-14,-17,3
CAfIdHFJbKBLTGEYPDSMNeWZVRgcXQUaO,dHBHHDEDJFFCBHFD.GBBDEDEC.DGACMFBCeAFA.ZDGBRBBE...hAAAXDAEUCGGOCAHhABAAHHB.FAGELABChAAA...........hACA......hADA...,2,-35,-18,17
CWABSHGTIZdDRFbcPfJYLMEgVNeOaQXUK,SGFHGBDFZAAHDACDRDAA.FEBC..PAHH..fAFBhADAJFDGLBAGEDGAVFEHhAEAOFAB..aHAGXADBhAAAKDDGAGIBBHHDIHHH.dEHC.YFBBhABAMIBE...hAHA...,1,-13,-17,4
BYMUSTPeJFdECKZfIHabcgVAGNQODLRXW,QAGHDBEDRGBEBBFH.UEEB..SEGCTBAD..eDBHhAAAFEADdDDHEHDGKHGAZAACHFGBhABAaADB....cFBEhABAAAECOAHF.XCAEWDEEMDIFCHAD.hACAfAEF.hADA...,1,-7,-26,19
ZTgBcXaJeCYLPWRdMVDEKFHbSGINQOAfU,ZEFHBHHGaBEDJCAH..eDHBLCEC.REEE.MBAE.EECAFGDESAGBhAAAGAAFQFABhAAAAICETCAFXGDAhABACDCD..WHAGDGCGKEAD....hACA......hADA...,1,-19,-32,13
QHVafZBAUPWLXOgKcbNSRIMEdFCGYJDTe,UCBCLGEAODGDKCAB......bECENBAE.RCDA...MGCEhAAAFHBCCFAH.GABDJHAADDDGhABAeDGFHBFE.aAGAfAHAhAAAAFBB.XAFF...hACA......hADA...,2,-35,-11,24
FeGbCgHdIRSWXZAJQEODKLBUMcPaVTfNY,QAADDFDCBFGCUBFGMEDG...aFCC..TFAG..hAAAYFGFFDCEeBACGBEDhAAA.CHAHdHDHSHCAhABA.XADFAAEHOEHFKFHBLDABhACAcGEA....hADA...,1,-16,-37,21
LFCWAeYNfPDaRKUbSHTEBOIJXVZQGgdcM,eGEA..fFAFaBEGKCHH.UACGSGCBEDFE.OBCHhAAAIEDD.JEHBVDEChABAQGCGdHAFMCAFhACAFGFH.CAHCACBBNBBEDFCG.......hAAA......hABA...,1,-15,-31,16
cQZgHLPNYMSEUKdOWRTeDJFIGfabACBXV,CFFGBFFC..XAEGQCBGZFAGLEHH..NAGCMFIHhAAAEBBCdDEDOFBARDAE.hAAADHDA.FCHHfHFBhABAABDC.gGCAPFABSADEhABAKBHF.....hACA...,1,-18,-34,16
SgFBdcNYLPMJfRIQXbKOGeUaTEHCWVDAZ,ZDAGSAFBBBBHdDHG....NEFCLDBDMGCERBDD..QGGGhAAAXDGHbECHKAHH.hABAGABDeFAHaAGBTGGChAAA.ECEGCEFEDACEABHH.FHCE.....hABA......hACA...,2,-19,-16,3
QJKWGbYUVMPFTEfSLRCcAHOZBINDadgXe,HDBGOFCABGEGDBHF.dAGD.eFADJDGFGGBFUBAH..MFEGFCEG.hAAAECFCLBBD.hAAACHHGACIDIAEA.hABANEIG............hACA.aHAC....hADA...,1,-22,-40,18
BeYHGMUSdZaIOVgXLWAbJcPQNfKCEDFRT,JGEAQCBC.KACBDCAFFEGCRBDCBHDA..HAEEMAAAUGCHhAAAZEBE.OAHD.gGGFhABAXDGGAIFGbEAAhACA....PAHBCEEBEGAF...TGBEhAEA.eBBD..hAFA...,2,-42,-1,41
bWUOKTNgFPYGfVRHMCaJBILZDSXQdAceE,EDCDUCBCKGEE..TCGGFGBAGBBD.RBFF.HADE.CGGDBGCFhAAAIGHBLCFF.hAAADFADSEFAhABAXGEDABABeAEC.........hABA......hACA...,1,-26,-34,8
KZegQOJfAEWCRdaDXGIPLTbYMHFUBNcSV,CFEDRFEEdGAHDECH.GACGLGAG..TDGAMBIFHDFDBCFESHCAhAAAKCAGZBEA.eEAGhABAOABGAFIH.aGHBPAFEhACAFAFE...........hAAA......hAFA...,2,-28,-15,13
TaUQOFDKBNcEAGCdVefXHLbPYJgZRISWM,CBCCdDBD.eBBGHEFALGFC..PBFEJFBEZGBGREBD..SACEhAAAMDAD.TDDFhABAUBFCOACGDIEAKHGEBGAGhAFANIDB.EGDFACIF........hAGA......hAHA...,2,-23,-22,1
bZSTEfWJNPVQIULXaMDcKBRCeHFGYgAOd,dDCDZDAGSACGEAED..JHAG..PGAAIBCGLDFHhAAAMEHD.KBFABGFAeFEDhABAHFDHFDHB.GBFEhAAAAADEbBBG.fCAE.NDIE.....hABA......hACA...,2,-23,-15,8
YgJWXEGdaDHLNQFZCUcAMPRBSOeIbTVKf,MECGBFDDOHEA..eBAD.TFFFfAFA.JADFhAAAEGDHGEEBDFAHNIEFZFBBhAAACBBAAIHE.RBBG...IAHEhABAbAEDKBGC..........hACA.gCFChAEAdFHA...,1,-5,-44,39
TEFWCdQZHMAeLNPfISBVcRDJGYgOUKabX,eEEGLGEA..PECHIDGH.BADERBFEDGGFGEDF.hAAAOCBBKCBCaBDFTAGFhAAAFGEHdBAGQFABhABAMIAE.AEIFNICHSAFEcCEB..JBBAYEAFhABA...hACA...,2,-17,-15,2
fAXVIgKaFQUSTJWPeCRBdNZDbOEGYHLMc,VEFHKHBGQGFE.UBFCJBFAeBBCBFCCZDABDIEE..ECEBGADAhAAA.LEFAhABAMAAFAHHH.IACFhAFAFHAASDHB.TDAFCHED.RFCB...hABA......hACA...,2,-27,-17,10
QGADUBCaXKJYIgTHMEdNSLWfecObFPVRZ,DEFAUGDGCGDG.KCGC....JDCE..IEFBHABDdCGBLBBEhAAAeFFA.OCAHFGAA.hAAARFABZCCGAHHFBBEB.aAEAhABAXGGF........hABA......hACA...,2,-41,-33,8
dPYTEZKRSADCUgWMOHBGFcLQJfNeXVIab,DEFAUGGGMDDFOFBABBCGGCBB..LCEAQAAFJGFA.hAAAeGAE..IADChABAdAFAPFEF.EBHFhABAZAFE.SCABAADC.gFAHhACAWHBG.cGCDNEEF.hAHA...,2,-33,-13,20
KSOZdYfPcQIUaATJDbMEXWHBVgeCLRNFG,TEGDJFCH..DIAGECFGHBGFBCEG.eDCHLAAH.RACEGGEBhACASBHBdDDE.fHABhAAA.PCAGhABAIGAGaGGEAFBFMAEEWFFDCFFC.KDAD.YABGhACA...hAIA...,1,-8,-26,18
RYJMOKXQAFgDTEUaGBHZbVdLNfCWSIPec,FHFGDAFBEGGDUDFB.BEDAHCBF.ZEDEdCCBLBHH.CCGB.IHBAhAAAeBDB....hABAYHAGMADCXDBChACAACABaAAF...bAFAfFHE.hAHASEAD.hBAA...,2,-45,-13,32
FZLdgcTRDVaIJBGAYXMEQeSObCHfWNUKP,MFFFEGDD..eFFASCCHCAFEHCCA....NDBC.KAFEZABAdGCC.hAAATBECDEAHaEFGJDHFBCHEhACAAHHC..QABGhAAAfGHAUDAE.FAHD.....hADA......hAEA...,1,-18,-23,5
VPdaKeLHACYbWgEZfMXcBNORJFQTUIDGS,CFDG..bAADEBFH.ZBCBMEEEBBHF..RAGBQGGG.IGDEhAAASGGGdEAG.hACAaDAF.KEFGeDCCAACC.hAAAWFCEfBABXACENCIC..FGAFDIAA.hABA......hAEA...,2,-42,-2,40
DSMTKgHVUCLcEJWONQZRdaXeIfBAPbYGF,...PFBBbEBHFABDDCBH..MCIHKAACHCCCCEAB.LEGDhADAEHGEOAFDZFEHRAGD..aDDGhAAAIGDEAEGEGEEEgADChAGA..cADE.NIAF..hAIA......hBAA...,1,-13,-17,4
cROFgJXBHNSMKaPTIVdEDbCAZYfLWQeUG,ZAADLGEAQFCHUACAGCEGOEAFFFFBJEBD.BECCHAFCMEFGhAAAKDHH.....aHBEhADATAADdCCFDAIBAGID..hAEA.fAGGWHDG.RAEB.....hAHA......hBAA...,1,-14,-20,6
dECYXGTBUcQSbMHWfLOADJRVZFPeNIagK,DGADJDACZAFAeDDH...aCDAdFDD.EGCDCABCGCGCBDDB..UACGhAAAQGFH.SAFBhAAAMIFA.fCBDhADAABBAVCFDFFHDPFBB....hAEA......hAHA...,1,-28,-32,4
JVOcRBWNeGADZFEabHgPITMKYXfLQSCUd,ZEEEaDABHECF..PGBCMEFFKCFC..XCCAQAAAhAAACCAEdEAD...JADGOCEBhADABAHA.NEBA.AAAEFGHFhACAEGGBIAHG.fEHESHAGhADA.cGEDWACADICAhAEA...,2,-30,-20,10
QYENPCWSXBUDRdJOGFAbLaMHVKTcfgZeI,aDCDVFBG..KAAD..TBAG..gCEDZGFGQEFEhAAAEHAC.CHAC.SFHBhABABEEFUADBDICGdAGEJGDGhACAFEABLAEGMBIF.fFAC.hABAIBCENDDF.XCGEhADA,2,-20,-15,5
XBCKGPNReJHbUATOVaSMYDEZLgIfQWcdF,OADGVFEE..MFACDFDGLGEA..IHHGQBGAhAAAdCCBXBGAhAAAKABGGCCFRAEA.eHAGJBAB..hABA............hAHA......hAIA...,2,-30,-30,0
XTOLMUWfHRbYZFecACGPBgJDNaKQVIEdS,CECDGGDHBFDA.DAABKFGBQCEC.EAEEdBBE.SFAGhAAA..XEBDhABALADAWDAC.fEFFhACAbFEDFDEAAHAEJHBENDIGIBCA.MAHFhADA.....hABA...,2,-44,-11,33
cQNCfIKadeSTJRBEPFMgLUObXVYAGWDZH,GDCCZFDGQBAGCDBFKFAD.eCEF.SBGDTABDBCGAEHGAFEHHhAAAMCIF..UGAEhABAXGFEAAHHHDAGNAAE.IACFhAEA.........hABA......hADA...,2,-43,1,44
VfGLcJgTREZXaWOKHFSQdCMePBUAYIDbN,DACBVAADGBDG.LHFAJEEB.RFCDZBAHXCDG.OFCDhAAAKFACSCHHhAAA.CBHF.PAEEAFGE.hABAIFHGNAGG.fDAGcFGDEHAEWCEEhACA.....hADA...,1,-23,-33,10
aLZPdQFOefXSJANITgHRKEcWbVYBUCGDM,TCBCHGFGEAAC.....bBDEBCACCBCFGDABMIBGaDFAZFAGQEFFhAAAOFBCeEEGSHCChADAAGGF.NBIC.hAEAgAGH.cAEE...hAFA......hAGA...,2,-29,0,29
GYfJBXaZRNcOMDEQPTKAeCLFgVIHWUbdS,eEGHFDAB..VDFBICDGHBCD..UGCHdCFDGEBD.fAAFhAAABBGHaAAHNAIEMBIFhADA.DCCD.QGBChAEAKGABAHGFCFDC.WBDE.SGEHhAFAJFHD......hAGA...,1,-19,-25,6
TfOMBXgaFcLSGIAJDVYKWERZdPNUHeCQb,DAADVDAGKECG..EEGAZBEF.dBCAUGCAHFFD..CHHE.QGCDhABA..fEDHhAAABAHHXBGCaABFcBGEhADAGEAA.AFHA.JFFH.....WAFFhAEANADF.....hACA...,1,-22,-24,2
QBZCcFWVSLeHDGAgKXaPdOEUJRfIbTNYM,XGBCaAFB.dDCFEHDA.RBGH...IFEGTABG..MEBFhAAAQGFHBECFCHHGFEEDhABASAGGHBDBDDACGAADhAAAAHGB.KCGG.OAFH.fEAAhABA....hADA...,2,-26,-19,7
WBcXCUDOSYKJPILMVRAfbZgdaNeEQTFHG,ZAADdAFBeEFCQFFFFFCGGGDBBAFBCDEADAIF..OCDGKBCG..hAAAJBFDLEBD.hAAAMEIHAEAA..fBAGhABA.aHGENIAHECGC.....hACA......hADA...,1,-28,-34,6
EKfTSWaMgJYZBDALRVFQHPeObXGdICNUc,LDACVDDF.QAFCHBBDOFAFXGGHdHGFCDGA..UAEChAAAEFDFKCHB..SHCAhABAWDFH..gACEhAAAYAHHBDACDHAEFEAD.eHCAIFGFhACA....hADA...,1,-8,-24,16
EGHFLaOKIRYZCBMfDgQcTJbAVdWNUSXPe,VDAGdHBHUAAD..SFGEeDBGHFFCLEEFOBGFKADCIDHAhAAARFBC..CAGCMCFFhABAfACD.QGBChABA.TGGCAEIH.WBCG.hAIAPAFE...hBDA...,1,-11,-24,13
XbGRVMTIdQBLFDeCaPHYWgSKJcfUAOZEN,ODCHZDAGEBCA...XGCHREDCMCHFdHABBEFBLAAFFHAG.DGGDhACAeCAC.aAFAPFAChADAHBEG.....hAAA..WDHHKGGEJABE.fDDFhABAABIH......hAIA...,2,-25,-21,4
AELgPHeaNCbQVJcXIGOUDYKfTdSMFRBZW,LCCHHAADaFEACCGBVFGD....XCCFGGAFDAGHKHEEdGAAhAAAFDAABFEAZAEDAGEAEEBEeAAEhADA....NEEB.bAGDhAEA............hAFA......hAIA...,2,-25,-22,3
KIRDEdYcfZBgaLOHCUGPQWbeSMXNJTAVF,VFEEFAFBKECF..DCBHdACH......fGCBBHACLHFAhAAACCDGUBFHQEEGhABA.eDEEXACEhAAATBGCAIAAIHHGECCD...cGAAhABAaEHDODAF.hACA...,2,-50,-20,30
aPIGNJHDUdVgKEORFcZeLfSCYbQXBAWTM,MFFFaHBGGAFAHCFCDDBGdFDF.KEDCRDAE..ZBBAeHAELFHB.CAAC.hACAbADGBADDAAEE..PEHDhAAAIGGG..hAEANEGA............hAFA......hAHA...,1,-22,-24,2
PQXCEaVOIZRTFdUDWMHcGYJfebKAgBNLS,BFDGSDCDQAACEHEC.OCFCZADBFCGFDFEGHAACGCAHJFBH.hAAAeFHBAEFHLGEChABA.CHAD.aGBH.IBEFhACAdAGF.MEAHfDACKGGFNEEF...hADA......hAEA...,2,-19,-10,9
YNfOGWVeHTdBMQRUDXSgLIAKbFJPaCEcZ,KAFBJCCH.CHAC.ZEEC......fEHCGDAAeAEBHAACdHAHhAAABEFEMEIDQFDChAAADHDA.gBGHhABAACACPAGF.cEBB.NDAF.WGDE..hABA......hACA...,1,-16,-33,17
GARLdKfcUbeNOIgMQDFBYXWZHaSECVJPT,RDEDLEGHdCAAKFHD.UFDA.eADDOCCDMEIHDABC..BAFG.hAAA.XFCGZAAFSEAChACACHAF.PAHBhAEATAGGACGB...bABAIGAEFHEE..hAGA......hAIA...,2,-31,-28,3
KEZMNbVGfHgUeSCcYBJTWDFOQIaPLAXdR,RBCFKEHBMAHD..VFBGHCFB.eDADCHHEBCEAJFCB...DAFAFBAG.hAAAQGGA.hABAaEEHLEBCABEE.hAAAEGFD.NEAG....fCAB.hABASBHF.hACATADE.,1,-13,-41,28
KaTYBJfdUgXLCVEQSAHIMDZbPORNWcGFe,HFACDDGGZAACODDGRGFE.....WAAHFEEDeDDF.aFBDTAEChAAA.BGEDdCAHUAGGhABAXFGDCHEG.EACChACASEAFAHDDMIFE.......hAGA......hAHA.PAHD.,1,-12,-32,20
GgPLJDTOWNBbeQUFHaMKESZfdRcCVIYAX,XFGHGAFELBBADBBA.OHEABEACQCEGFFECMICEKDBGhAAASGAEZFAA.hABAfEDGdBHA.hACACBFEIHEGADFH.JCAA.NADH....hADA......hAEA...,2,-27,-19,8
APDOXCJZgQGfIWabBVRNeTHULFSKMdYEc,DEFHXGDECDBC.ZFAGGGEB..IADBaFBCBABG.RCFG.NBHG.hAAAHBCGLBBB.hAAAKHGAdHBFEHACAFIHJAFEfCAAhABA.WCFD...eDDB.hACA......hADA...,2,-32,-12,20
FaQRAcISJMWNXdeKTUDCGPVYHBOEbgfZL,SHBGMDEB..XCACdBDDeFEEKDGBUBGACGDD.GCBEhAAAVAFF.HGEABEBHOBAHhABAEBAE....gGGAhAAAfDDBFHAEaGABAFFD.....hABA......hACA...,1,-4,-33,29
MRGWOHgQeSBCXLAZcPYfaJENbTVFDKIUd,ZAAD..PGEAaDCAEGDH..TDFBDFBCKCGEUFBC.dCCARACA.OAADhAAAQFGA.hACABAGCXAFAACEE.hAAAYADEfEFFNDIC.FFAHMIAE..hAIA......hBAA...,2,-25,-19,6
VaNOQBUcECRWDKGPFgSYMHAJTZILdXebf,TAEGZFDFdBEBeFAB..VEEGOBDHBHACEHGECBAH...DBCDGCCBhAAAFCAF.SGHHhABAHDGFAICA.IEAHhACAXEEBaHEE.NBIEQGCF..hADA......hAEA...,1,-16,-22,6
VSAXTIWYfJNegQBDOZCPKbUdHLGEcaMFR,XCGCTCBC....ICGH..WFGFJDAFeFCAhAAABDCCDBEDCGGB.KGBDUABHhACALFEBEHAAMEECFAACSAFEhACAAIDG.NDAAOFDB..hADA......hAEA...,2,-37,-24,13
XBJKHTWCYfAVSLROGPDNFEcQebUgIadZM,VDEDSDBD.OHDADICEEDHF..eEFAUAAF..aEDDMDBFhABAJAEAHCEACHHE.AIDELAAEhAHARAFFGBCENEAGQGGChAIA.gBBG..hBCA......hBEA...,2,-24,-11,13
VIQbcgWMNSdCFLTYJDURBaKHEXeOPGfZA,QFDH..cDCBMBEAdAAGCADHLFEDTFAGJDDGDFHHBHCGhAAAHCAC..EFFEXBGBhABAOCFA.fGFEhACAABBCIEHFWDAHNAEF...FDFC..hADA......hAFA...,1,-3,-41,38
fRVPdIEZGFOgeUDMaAQLTBWbYXHKJCcNS,QDCHTGDE.BGEA..bBAEXACBJAEC..CHADSGGAhAAAVBABdDGFEEGFZEDChABAFGBFOCFAUAFFaHGEhAAAADACLEBF........hACA......hADA...,1,-15,-21,6
LHDBGcTdNfQZUbJCSEAYXIegWRKFOMPaV,XCBCeGEARCAD.FAAAMBHB...aGCFLEDCBEDE.TGGGhADAdEGH.QAFFhAEAZAEDJAAAEHAAAEHGIHDEhAGA.KCEA.PEBDDEAB.....hADA......hAEA...,1,-14,-29,15
JZULKdBVFYXHPCDANOcIfGWTeaQbESgMR,OGEA..cGAFGACG.eHBAQDFCSCHHMAIBhAAAJCABZCABKEBABDDAFEEG.hAAAHADACAHG.AHHEfHFBhABAaGAG.EFGC.......hABA......hACA...,2,-27,-16,11
HSDPgFRaWXQOANeEVcMICdGYfTUBbKJZL,EDCDVFAC..MDHBdBAHGBEH..fGAFBGFEKEDCLHFGhAAADADGFGDBRABEaAFDXDAChABAAHHE..NEFEeBADhAAAIDHD.CAHF........hABA......hAHA...,2,-28,-24,4
VDNBfAEUMHSOgYRIZdPTKaGCWQcbJXFLe,UAEDSAABOCCBRFCDZCEG..dHADKAEGGDGA.CFDD.QFGEhACA.bDABFABEhAAA..LEFDhADADIDABFFDAHBA.MEDA........hABA......hAFA...,2,-40,-22,18
FdSQHURVWTDKZPaJXfIAeNYcLOGEbCgBM,eGEA..NDDGLBBGOFCBEBEG.CEAA.MBFG.FGHBSCAAhAAAQCGCRDDH.TEEAhAAAKBHHaBBA..JDABIAGFhABAAAHE..cGAE....hABA......hACA...,1,-25,-31,6
XHYgZVOGUeWEJNFAdMTLbfISPCRcKBaDQ,MAEDTDACLDAC..IEFHSHAARFDHBBGCaEHHDAAChADAHABDZFDEOCFEUAGBEFAAhAFAJGAGAADGdBBF.fCGAhAHACAFFKHFE.........hAAA......hABA...,1,-7,-27,20
EZGQSRXaUeJfNbIOKAcMVgWLBTdPHFDCY,MECGVAAD.LCDABAGG.dFHCFHCEDBHF..CCEGZEAFQGBBhAAA.SABFhADAaEEFeCFE.fFFEhAEA.IHEEAHHCcEGHTAEE..PDCFhAAA.EADE..hACA...,1,-14,-37,23
dRQVIbeaSTXgfcYJKEPUWDCANGLFBHMZO,LFEFBHCHMFABdBABRAAC.QADB..IGHDaAGBSDGHhAAATCFBXFCAhAAAfGGE..JAEAhABAKEAEUCDECHCEAHBBFCDHODAG.bFFF...hABA......hACA...,2,-25,-14,11
KGBZJWeEdADfNVCPbcQaUHTYOXSgRFLIM,DACBVAADCHAG.......bCFBQEAEHFDCOCHFSGGBhAAAFEBDLADCKDEBBHFHhABAJDCCEHGEfEGHhADANHAF.PHBG.UDCE.TAGBhAEA.gADAhAGA...,2,-29,-4,25
ALQJPYSHgKNBGaTFEMXODZUWRfebdCIcV,LFCAQDACJFADSEEHHBAC.KECGBHCHGBCHTAEChAAAMBIFDDEBZGEGUGGCfCGChAAAdCHACDAH.IACDhABAAHFE..........hAEA.YGAG.hABA.aDFGEAGC,2,-27,-4,23
QYbAgNdBcWKOPFSfCRJZHMUXGaDTIeLVE,dHBHBFDGKAHHFHCE..CGFHZFBAMFHD.GCCHDAAC...eEBBEBDB.hADAQAAFAIHE.hAEANBIE.OEFG.SBBHhAFAfAFDJAFBXEFB.IADEhABA...hAHA...,2,-47,-19,28
FWEBdcPbfXAOJHaDgINCMTZYULVSKRGeQ,HFBGaHFG.DIGE..IAFECBBAMEIDZBDDLCCG.KHAGeEFBhAAAFEBFBHCEdAGB..PCFChABAfFGBABDDJDAB.hACANEED....TAAF.....hADA......hAEA...,1,-23,-32,9
DAFKBgJXScWaRGYLdUfHEVCMbNOePIZQT,FEHBBFED.JDHHXBEE..SFCDaGEBGDBFLCBEhAAAdACGUGAFEAEE.MEBBhABAOAAHeGEAZGFEDDFBAFBEKEFBhABA...WAFC......hAEA......hBBA...,1,-16,-37,21
MVYJBPGQcKXefgTNIbDHEUSdRWOFaLZCA,MECGVFDF.BHACGEAAKABC...eCDH..TEFGICCFhAAADAEGECDGUAFF.dGHERFCHOAFEhAAALABECGHCAEIBYCFBhAGA.PCHD.....hAIA......hBAA...,2,-41,2,43
ZSaWRVeEOUNMKJTQdFcGHfXLDbgIPBCAY,ZDAGSAFBaFDD.REAB.EGGBUFDC.KAAFJBDG.dABDGADCHBGBLFFEhAAADGIB..hACAgCFABHAEACCD.hAEA............hAFA......hAGA...,1,-24,-35,11
BAMFWEfPIGgXOJUbeDQSKCZaNdTYRcLHV,MHFGFAFBEHAC....ICDFGGDHXBCGOBHB.UDEHhAAADAAAKFCGCADH.ZBEHdDAARFABLFFAhADABAHFABBF.fBBEhAEA........hAFA......hAGA...,1,-29,-32,3
XVgABNcIbfPLeUJFTMHGDCZORQSEYKdaW,BFDG..NEBB.IHAC..PAGFUBABFGGFMBAADAGAOFDChAAA..RBDGEHDEhAAAdGAHaGHF..XDEChABAAAEEfCFELCHFeHEATDAFCCCD.hABA......hACA.SDHHWAFG,2,-26,-19,7
VYCEaRQUGOFbPgIXdDTZJLABMWKfcHSNe,BBFDMHFGKEGGHEDD.SHACeAFC.CCDF.aEFBUEBCFEBH...hAAA..PAFGIBAGhABADGFCZAAEJCBEADIDfDHChAAA..cFCDNIBBECAF....hACA......hADA...,1,-15,-41,26
UOVGYJceIFCRBDQAEHgSbNPaTMLXKdWZf,ECFCHDAG.SACD..bFAANAIC.TAAALFFCKCDEdHFBhAAAZFAEOBDA..hAAAVEFGJHCAIBAAhABACAEGDDAAAEEFaHACXGGC......hADA......hAEA...,2,-21,-12,9
PIgVdXLSWROBQDTMAaNEecbfJCYZKUFHG,aAFBeCCH.....fABDJHFGZBBAFHACHAEEGDBH..hAAAPFFFVEFEdGDAXGCEhAAA.SDGChADAOCABBAGADAGGAEAHEABECHHG.....KCHBhADAIEEH..hAEA...,1,-12,-26,14
OHCbBLRWcNdXfeIUgEKDSAQTJYGFZVaMP,QDCHTDAC.JAGBFEDG.ZFFA.MCIBOHFAHGDABAFCRADC.hAAA..NBAG.fCFDhABAUDFHKCBD.SHBGhACAAIFE..VFCFCCCC......hAAA......hABA...,2,-34,-7,27
LbZPTNKMYOBGfEIgacQUVdAHCFWDSJeXR,FBBDDGHHeEFDLEEGZFBG...TGGEKDBGOADBBADAGFAFhAAA.EBFG..gDFBhAAAaDDA.UAGEhABAAAFE.CBBH.WCADSDHBXGDA...hACA......hAEA...,1,-18,-35,17
BQJWYbDKUIRVAdaGgNZCcFHeTPMXSOfLE,GACBZAADCEAGHGBEeDEG.MAIFSCEELAAFQDCGhAAAJGDE..bDAADEGGIHGFhACAAFHFaGFH..NBED.FFAFhADA............hAFA......hAGA...,1,-15,-26,11
XSRFPgJGMQcZfIHBeVKDTaAUdYCWNOLEb,dGFCCFDG.OFBHLBEF.EEFFSBBD.FCFBJCFAGCGEhAAAMFAFQGBHhAAAZCCBfAGFICAEhABA.BGGBKADADBAHAFHAYCCD.WAEEhACANEEE......hADA...,1,-19,-35,16
RVSUPAYLZEeKfbBaIFdNJOWcCHXTgGDQM,LFBBZDEDKCDHBHBEFCDBdGFD..OBAGCAFAHCEB...TBGAhAAADAIFRDABUAFF.AACC.hAAAEBAB..eEHH.hABA..aGGHNIEBWBBB...gEGChACA.MDAFSCCDhABA,1,-27,-37,10
FBWTAXRfOGYcNeCJbDdKZMSQIUEaPVHgL,REFHGECF..NBIE.CBAGJADA..DBEBdFHEKGDHZGDA..MDCDSBDDhAAAUABF.ECEGaGAFhAAA..HBGDFBFCBEABhACAAGGCXGAH.OBBD....hABA......hACA...,2,-42,-18,24
WTIeSZDOFNXKBaCfGAEPdRgYVHLMJUbcQ,EAFBdCFCRGFE....VEACMGAAUAAFQAAC..IGGFhABAZEBAOCHBFDDGKAGEhADABHBHCGEH.fBDGhACA.ADAE.PEFG......hAEA......hBDA...,2,-36,-26,10
BKYfaACdQXDTLJbSZgVRPMUWHcIOeGNEF,CFCFdEHADGHFJEDG..ZEABRGFE...MFEAHAGD.OBAEGABBFEAABCCDhAAA.KGEEaADGAEEE.QGCAhAAA.XGABhABATGCDSDEE.gAGAhABA...hACA...,2,-37,-22,15
FbQYRLOZVUWJSGAceINMEDTaBHCKfdPgX,eGEAMCCADFGBBDDGHGAACBDF..dBFH..XDGBFAAB.QAGGhAAAREADZDFA.UEDGhABASECGAACF.ICBFhACATDAE.aHACKADE.fHGFhAIA......hBAA...,2,-35,-22,13
MfSdeNgTGcbURBLWPYXIJVZQAFEKCODHa,KDABDGGDMFACdBBD..eGEA..TBBGGDDHUCEDLCEChAAA..PHAGXGBFhABAJADCZCGBAIAGCAHCaEGENEFA.hAAA............hABA......hACA...,1,-26,-32,6
NMYRUSFIdcAfPeHZCGLWKgaDOXQTJBEbV,eGEAZFGHLAFEKAGEDFDB.QBDCBDCD.EABA..VBEAMIDEhAAAUBBHFGBG..dEFCAIFGHEABhAAACGDA..gBAGhABAaEGC.ODFA.JEAA...hABA......hACA...,2,-36,-2,34
bPKJfCgAeSIGYaDWNQHMVLTFEcZRBOXUd,SDCDGAFEDDBBQACDMBBF.LFDCFCGBEFEDRACHBHEBhAAAOHEEdHGBKBAD.JDCAhABACBHEAFAC.eGAAaFAH.NAAE.hABA............hACA......hAEA...,2,-27,-22,5
cKRBEOVJUXdWgSFaNMLDGPfAeTHZCQbYI,TAEGZFGHQCCA..IHEFRFAAODFCJDAEUAAC.dHDBhADAgABD.hAEAaFGCLBFADAGCfBHGhAAAAGIHCDBD.cECBEFDE.....hAFA......hAGA...,2,-27,-17,10
RZSFBXGIVJMgaLTEUbKPcOYdAWNCDefHQ,CFDGDEFHHAFARFBFZACDBBAG.GCBG..JBEEMHDGLBAFUEFBKBDFhAAAODHH.ADFE.eHAGhABA.SDAFhACAFGEH.ICHFaGGC......hADA......hAEA...,1,-19,-43,24
efHcACPGFVSLdUNgODXYJWaRQKbMZTIBE,CECDFGAHLAACUCGG..OFEGDIAC..XAGE..JAAFhABAaCGBKFBAZBCGBCEAeHFAhAEAHADAAHEH..VFEGhAFASDCGdDDF.NIDF.YGAA..hAGA......hAHA...,1,-20,-39,19
eBVaDXIHLQGdMZAcKgRNFTJfSYbUPECOW,KHBGRAADFEFG..JABD..SBFHUCDA.CDCE.eFBABHBCDIEGHEAGhAAAGEGEdADEAIFE..hACA....cDBGhAAATFGE..bCFEEHCC.WAHF..aAFChABA.IADF.hAFA...,1,-30,-33,3
dEJDVIPFSACMNLYXfGHcbgZTWKReBOQUa,CBFDLCHD.XABEGEEDHBCB.gEBDTGGGKDFBhAAABBAEUFAEdGAADEEHIHCDhAAASBAGNAHG.hABAfGCB.ZAEE.eCDAaAEA..hABA......hACA...,2,-18,-17,1
TRCFOdNIeSZUGaMgBPVcJXDYWHEKLQAbf,TCBCFBBDdECA..eHDGZEEDUFBBGAEAMBBEBABC...VEFChAAAXEGE.DIBAHEADhADAKGGAQAEChAAAACHH.fAHECHADIAGFSCFAhABAaGHD.....hAEA...,1,-12,-22,10
TcNAYHMgGKaPDSJUQIbEeVOFBRLWZdXfC,HFACGBGAaGGFSDDHQAEFECCCOBCDFHGEBFADLEEDhAAAdCAACBBE.TBAFAGEE.MICChABAKHAEDAIDIHAEhACAeFFH.WDFEXADA.NAAB.....hAGA......hAHA...,1,5,-18,23
aQCKYMbJSNdHOegLZATDRXVIFWEUcBGPf,TFCADEFARFAB....XBADVFFGFDABUAFBBBBF.GCCHhAAAaGDG.QAGGhABAKGGEMIFE....SDEChAAAdFBC.........hACA.OHECgACChABAACCA.IECH,1,-19,-33,14
gDNRdLWEJHbVUPQeCBXSYKOcMfFTGaIZA,DACBRDAGdGHALCFE.EFBFbEEC..UEGHeADEBAAC..XAAChABAKDEFMFFFfDFDhACAFEAB.aAHFAHGF.hADA.NBDC.JHBG.HBCE......hAGA......hBEA...,2,-38,-14,24
RXeDGCdaKLYcQPWZNISHfMTVgJObBUEAF,XCCBeDCHCBHG.KAEALEAB.QGGGPHAE.ZBDHSBADhAAAMABH.TEAChABAVGDGJEFGBAHEAFABDACHhAAAaFDB....YFFG.cCGBhACA.NIEH..fCEFhADA,1,-20,-27,7
ZAUOWSaPJIYVeBKNDMEQfCbHdFcTLgGXR,UDACSDCD..JBBAVGDGeDFBBAHAKDGC.DEDC..MFHBhAAAQAAB.bFAChABAFGBC.TAGDLAEHhADAGEDCXEFAADDH.aCHFIAEHhABAEHAACBDA......hACA...,2,-32,-4,28
REUcTVJCfKNGaOMAIbZdFWXLBHDeYgPSQ,ZAADdAFBFEEELFDBDBEF.eAGH....PGBCRCBFUGFG.TGABhAAACCFG..KGHFNEDH.hADAaAAA..ABFH...hAEAIDCH..WFHBHDAB.SHDAhADA...hAFA...,1,-25,-40,15
PNBWOSVXIYQMJaDbgTKFCEZGedRHUAcLf,LGEA..NIEDOACFXCCCQEGDJCFF.DEACbFAEhAAAKEDC..FABCEGAAGAEDhADAdAFCHAGDACIDfEABhAEABGEBSBADIHAAMFDB..hAAA......hABA...,1,-15,-24,9
KcITDVQbSWZLRGBNOAUdgHaCYPMefEXJF,dGFCHDAGaDEDCEFA..MEHDECCE...FFABKAGE..TBAHDBIDQEBFhAAA.SGCHhABAWGCCLHBAhAAABBGDAHHH...YABGfABB.XADFhAGAIEGC..hACA...,2,-42,-23,19
KQYgOXGIdFVCUBLRJZcAebEWNPSaTDMHf,EDCD..NDEH.SDHBDCBGHECE.KCCEQGAFOHBAGBEChAAAdAFHFHFGUAGBBCAGJCADAHIBeAAEhADA..WACChABA...aHFAfHCHXEGD.CFGH..hAHA......hBAA...,1,-17,-23,6
EdBYZOIJCSDVbeQaURKPcMHNGALfXFWTg,LDACFGFC.TFAFEEHDBDBC.OFBGCAFHDHEA...VABChAAAbAAC....aCCAKCEAhABAMGEAHAFE.NIDF.ADFEXFCBhABAdHAF.YAHF.IHHAhACASEEE..hAEA...,1,-19,-30,11
UNMLdTCIFPKAZDSaOXJEWQgVfBHYcRbeG,DGDESEEDOEHB.EAED..QAFA..gGFFhAAAfDEBBBBGHABDhAAAcAGEbEBH.eECBhABANDACMIAGLCAA.TFAHCBEG...hABA......hADA...,2,-23,-15,8
VRPGSgUHOAfYFBcZeXLbdEQWaKMTCDINJ,FHBGZDBHeAFHLABCEBCC.QBGG.KHEECEEADCAF.IHEBhAAANCEE..JCBDVEGFhABARFGB...SBHFhACA.HFAFACFDBBCB....hAAA......hAFA.bDFA.,2,-32,-20,12
QTGVaAbHecULSYdXJKIDOPFECBNWZMRfg,HFDFeDACLECCdEDBKADHDGACOCGF.FBFBEBBBBHHGZBFCMAFAhAAARFAB..QABDhAAAGDGEAGIF.UFGBXDAChABAIAHFCACC.fGEE...hBAA......hBGA...,2,-17,-12,5
LAWRDJYNPUacESIGQeVgHfXTCbKOdZMFB,DHCEJGEA.....PAAEaADH..SFAFGCEBeCCDHCAAhAAATFGBCAEE.OAFEhAAAMFEABCFEAEAE.RGBANDIGhABAUGAC.EFED........hADA......hAEA...,1,-22,-31,9
ZNXYCcHGPQUObKWdBAVSEJIRTFgLDMaef,VFEESEED.EAEDJHBG..RGCEFAGDDIEG..eBCHZCCCXGGEhAAACFBF..HAAFhAAAQFAFbCGB.dCAGhABAAAEAIAHA.LBEFMCIH.NDAA.hACA......hADA...,2,-23,-12,11
TEaPBcSHQFeJVgCIMXKGORUNbdLfAZWYD,ZAADDACBEGHBBCHA.HFFDFAEG.eAEH..JCHDCHAH..MEFAKDAHRGCAUEBDhAAA..dCEDAEAH..hAAATAGEaFFF.SACAhADA.QGDDIHAEODCFhABA.....hAGA...,1,-20,-39,19
KHOMUQXPJGEdeSFLDCacfNZRWTYgBIbVA,KDBDMAGDQFAB..JEACGADGdBDESDHDDCAECHHBaFEB.hAAA....fBAEhAAANAHERDFB.YHCAhABAIABE.AHGB.HDEF.....hADA......hAFA...,1,-30,-33,3
EJKSUILcFdPZCaeQMTYHWARBOVGbgNfXD,RFEEBEFAGDCA..NICH.DCAB.EBBFKEBHUAFCLBDF.dDHGCHHGeEAFhAAA..TGAGhAAA.HBAFACEDOHDChABAgAGFXCGA.SEEEhACAFFDDZAEFaGGF.....hADA...,2,-23,-12,11
cOeFUYIDMJNWQGKVfbXgHZPALaTBCSdRE,aAADTGDGBGCD..dGBCEHEGeCFH.UCCADBFEMGFE..NDIE.hAAAGECFKAEB.bABDHCADhABAZBEA.ABBGCAGH...hAAA.SFAHOFGF.IHHG.hACA......hADA...,2,-21,-19,2
SPFZaKcAUfDeEVbGTOgBWYCXIHJMLdQNR,UAFBDEFHeDAAEABDGFEH..TBADBGCECCAGXGGE.hAAAHADBMIBALGAGhAAANEAH.RAFCFFAAaDFEAHHCfEHAhABA.bDFBWCDAYHCG.hACA......hADA...,2,-38,11,49
PgAWTMSLNUEcbBVIYaQDRJfCHGXdeFOZK,MFFFLCCHUBADEHGABECC..VFAB..aAFAQBEEhAAADFBBRBEF.JFFAHCGBXBAFhABAFHGAKGDFADAFSHDGhACA.NAIA......cFEChADA.....hAAA...,2,-39,-7,32
HIbQDWSZUdATRMCJcXNgfaKBeLPVFYEOG,TFCARFBHMBEA...CCEH.JEEE....NIEF.aDDGKBABBGHC.LHDEhAAAFFGAOHACGABEhABAHAGF.QDCDhAAADDBH.SDADdGACAAFC.XFEHhABA.....hADA...,1,-12,-30,18
AJGBQCWXgNaKITOPSeUEdDLMHcFbfYVZR,BDHBCHHG..XAGDaGEGKBAA...TDFHOEEA..SFCHhAAAUDADDDECMIBGhAAAHBCHFDAC.fGAGhABAZFAEJFHB.WFFAIBFD...EBDFhABALACC.YHDGhAGA,2,-43,-10,33
RBYKcdJCgINfTeFGaAZQEOSHXPLUDVWMb,EDAFODCHHDDBLAGBDABA.MBAEBDCAKCABJBFH..CDDC.IBBGhAAA..NBFATGEDhAAAeEHHFBHB.AHEAQGBFhAEAPDHF..WFAF....hABA......hACA...,1,-23,-36,13
NcAbGUOHSBaTYMIfeQZRXCLdEFVgWPDJK,UAGHODCHHACGBAHDaEFC..MEEF.eBAEZCCECGGCLBFDhAAAEHACFHDC...VFFFPAAFhAAADADCJCAF.KCHFAIHESFAFhACA.TCGF...hABA......hACA...,1,-11,-29,18
fUgDYSCLbQAIWeFaOPcVJdZHBXRNGEKTM,eGEAFEEDOFAD..PCCC.JBAGdBEC.BHHGRAFH.EAFGTEBGhAAAUCBBDFCB..hAAACHCGLEFEAAIH.hABAIDAHaGGG..cDGA...hABA......hACA...,1,-30,-41,11
QRAIXWFPJTfGHbCKYSNOeaLdcDgUEMVZB,XCBCFHBG..JCFAGDGCCEDA.SGCGOEGD...hAAA.LCAEDAHFEFADZFEFhAAARDACABAE.WABC.fAEAhAGAbAFA.KDEENGAD..dFFC...hAIA......hBAA...,1,-24,-33,9
HKTQIGNCYcgDFMRXfeWLbOAZPEUSJBadV,ZDAGUGBCBCGCdEEFHCCEQFBAGAGE.CHGH.....gEGEhAAAMBBE.fGHEhABAWFHB.OABFhADAAEAF.SEDHJGDE.VADAKCAHNAAFDAGEhBAA.RFEF.....hBHA...,1,-16,-22,6
edaFGBcNMXYEUWIKAQLgPfVJHSbTZODCR,QDACLGEA..PBCAVFFCSDFCZDAHDCFC.CAEDdGBFhAAAaDDCBAHH.MCIFhAAAYBAEUDFEKAFCfCDGhABA.........hABA......hACA...,1,-23,-31,8
ZaQJAYCcLUSIBdbHRGeEMKPFWOTfVXgDN,CFDGLDACUBDH.SGGGdDHAHFFFGCBEeHCCKGAE..FHAATDGFhAAA..XAAFhADANACBZBFA.aAFAQEDHhABAAIHG.YBBE.IAHChBAABEADEEECMIFE..hBGA...,2,-20,-14,6
DOUWcPXQIKLAMafFHBJZeSRNbTGCVgEdY,MHFGaAFBHCAEZDFHRACG..TACGGGAHCHHE.EEDADFEH..UAGE.hAAA.PEEAXCAHhAAAIAHAACADBFAEeCHBhABASCCBNEAE..gGBH.hABAdGGC.....hACA...,2,-20,-1,19
EPDIKfRNOVbGUgCHWTXcJMdQSBLAeFZYa,eDCHFCFCZFGFEABEDEIDKHEE..RGBA...OAGHGCAECEGE.HABA.hAAA.TDAAXDCBhAAAMCIHSEFFhABAAEEG.PAFENIAF..bBBA.gGGBhADA.....hADA...,1,-15,-20,5
fLadQDGVHZKScWMeNFCXIBYPORJEAUgTb,UCGCTCBCLCCE.dFBGDGGF.VAEDKGHF..SAAChADAMFEHeDHHCAHG.BHHAODDHhAEAJEAHEAAB.AGDB.bFEHhAFAaHAC...HDECWBBDXACB.hAGA......hAIA...,2,-32,-7,25
KEFSIdGPRZJLAYfQVcUWMCNaHTeOXBDgb,QCBCUFDHMCHH.aEAHHBCF..eFHFBHGEDDFCKFADFGFFSEHHhAAAGACD.RBEDLEBBhABAfHCB.cDGEhAAANICH..OAEAgEDH.IHAGhABA...hACA...,1,-8,-21,13
TbHdVIPaJcRYGBZEfNMCSKegDOQWAUXLF,UDCHXGGDLDGHFAAB.HFAFdCGB.VADEaADE...RAAFBCCBhAAAZCBGEFCB..MDABSFFDhACAKGEFDDFD.ODFEhADAACIB.TGAF.bFDD.....hACA......hADA...,2,-21,-9,12
fdKgJEVaWFeQLPZRBXHbIcGODSTUMANYC,CFDGdAFBKBFHEGBF...aDGCeEAC.LBAERAAEHFDD...IEEChAAAODACDGGA.SHFAhAAATGFAAADGNCHCfCDFhACA........hADA......hAEA...,2,-42,-26,16
XJRCLbPFgBZYOEIDecUGKHWNTdaVSAQfM,MFFFJADGLEHBFDCCZCFF...EECEDGIDUGFEKADA..HDAF..hAAATGBBdGGGaFDBSGDHhAAAACBC.QBGAhABAXGBDbAGFBBBH.OCDE.IDAChACA...hABA...,2,-27,-16,11
KDFRSTEVcHXagCGLONeAUIWbMQZYfBJPd,UCBC..bDBHQDFHZAFFBACBJAADdAAHDBHH..FEEFSFBDhABA.EGHDHGFGhAAA.XEGEhAEAaGGHCAEGLFDHeHCGIAHBMAIH.fBDFhBCAKDDC....hCCA...,1,-19,-24,5
WVQTYUBPMXIfFRZaOKbLAgSCcJDedNGHE,CFEDJFCHdGBDHBFB..ECGFQGGG.UCADPBDD.MIAChAAAfEECZGFEaDAB.hABAKBHBLBBBSABAhAAADBFF...........hACA......hADA...,2,-31,-25,6
bSWRMNZaUFJfYABeQDTPKVLdIcECHXGOg,eEBEDFEEKHACdCFG.EAFECBDH..HBABGDGA.OGDA.SADGhAAARCFENEIGZGEA.aHAGJFAAhAAAAGIBBABC.PCBEhAEA...........hABA......hACA.IAGF.,1,-12,-40,28
IBEDbUTGNLaYKfWeOdSZXcFQAHRJgMCVP,HDBGRFDFMIFAVCFC.BFHAECEG..DCBGTBAEGEBE.LEDChAAAKGBBeADEOACCdHFBSFEEhAAAXAFBFGGAhABAAAIDCABB.IBHF.bCAC.....hAGA......hAHA...,2,-21,1,22
cIWQLgEXGHCOTFDbPaNRJYMfZdeAKBVUS,BHCHSDAF..ICDAQFCBLBCEXCCAGCAChAAAOABEDAHBbDFHNDFARBFB.hAAA.MFBHdGCBAIAAKHFA.hABA....cGGAWBHH.EEHBCDEAPHFEhACAaHCEfAHE.hADA...,2,-31,-1,30
HJdMXeAVbBgFTIZcPKYfUaNESRQLOCWGD,BFDDTGBCZAFA.KBDBUBEE..EEECREEGLACB.CGHEDBADhAAAJCBBMCAD.AFCB..hABA.gAGHhAEA.FGEDIHGB......hAAA.YHCANBBAQECEhAFA.,2,-53,-22,31
EZAVDLWfCNOPJSXQFKUcMHdbBTeGYagIR,DAGDLGEACBDA..OEFGJDFBQEAG.FCCGKHBCMAFGhAAAHAABBBHBTFGHeABEhAEA...aDHHIFDChAAAEHCEABBC.fDBC.NIDDSDDChACA.XFAChADA.,2,-45,-19,26
cGMeUYBFDgTJaKLOQWIXdfbZACNHVESRP,HDBHVFEE.RAAGGDDG.MCIBUAFAFFGFTAAHKHAA.LDCEhAAAQAGB.XBDAhAAAdHBDfEBGhACA.AADCNEIESEAD.eHDABBDADADChACAaHEC.OAHF.hAHA...,1,-3,-11,8
IYMGbHXQSDFBPALcJaWURVfTKNCedZgOE,LEEGaDCD.RDAG.VAGBKABG..CGAFZGEAOADA..EGCHMGEAhAAAGAFEHCEF.QCAHhABADADEBCCGAGGCJHEG.hAAA............hABA......hAHA...,2,-33,-21,12
OLaeZgSTQJCKUdRHXYEbNIBPWDGFcfMAV,LFFCaDBDZFGD.SFAHQAEACHGB.dDFEHCBE..XAAFhADAEAAC..IHCDhAAABAHADHCCGADDhADAfHABAFDAeCFCTDDCKGED.....hAEA......hAGA...,1,-15,-26,11
fTXZBMRCcUFgGVJAQdWSeKYbEaODLNIHP,dGFCeCCHKGCDEEFADFEFLHAG.HFAATCBBZADFBHHD.CABDFCABhAAAGBEGAEEC.SABFhAAAaFHF.OAGFhADAPAFDMBID.REAF....gADFhAGA....hAIA...,2,-27,-9,18
dGVSJIDYUgTbKWROZEPFLABCQMXHefacN,BFFGMEECHGCEeACG.aBAHdECE.GBAF.SBFHICDEDAAChADAUFAETBGHKHGGOHCChAAAPHFCLEEEhABAAAFEQEAA.fBBHNAEB.JFFAhAEA......hAHA...,1,-11,-15,4
dRVSAgBNUCEKYfZcHaOLTQXFMDJbWIGPe,BFDGCHHGKDGF.ZAFAHDCCOFFHLGCG.QADDXBBEFEABhAAAMCAF..DFCBbFAD.hABA.ICECeAHFdABChAAASEFEAAGC.NEIE....EHCC.hADAfGAA.hAFAaCAC..,2,-29,-13,16
MEWFcKdSPReZOYHNBVTCJLGIQDbfgAXUa,XFCAaBDH..EGGHFACBKAGAdFHA.RBEHZBGHHFBF.BEHG.CCBBJDEGhAAAIFFF.DECAhAAAfABFAICA.hABAMCEGSHGGOEAG.YHAE.hABANBBC......hAEA...,1,-23,-32,9
aEMcAbNHISgJFfQGKBVYDWZPdTXCReLOU,HAADSHBGFFHFQAGEBBBDDCFHZBDBdFBFCADGLGDC.OFHHhAAAECGDMFEB.AIBG.hAAANABF.IGFA.hAGAJCCGKBGC..WEAFPDBD....hAHA......hAIA...,1,-16,-35,19
YXGAUOSKFERPJcBfQdCNaZgbeMLHVIDWT,UGGDOEGHFEBFREAF....JADABEHF.dGDBCBAEZDCHeDEC.LACGhAAAHCEEDGIH..TBADhABA...XAGGhADASHFAKCDEEHAEfACG.hAEAaCHD.MIBA.IAHAhAAA,2,-30,-30,0
QgcYLZTHWMOGJaEPURAbCeKFdXNfBDSIV,CAFBeEGHKHFA.dABC...XGBFBACGSFECQCDH..hAAA...gGDChADALCCCZDGDTAFAhAEAHFBDOBHDJBAHEDDG.......hAFA......hAHA...,2,-39,-18,21
eCcTRIYdWXJOAgaUMNLQVPGHDSFZfbBKE,UGBCLCHDQAFCVEAE.GACCDAGAFBAEZEGF.BEBDKDEA.CFFGRGDEhAAAdGDH...XBDChAAAOBAHABBA.aBHDMIDGhABA...........hABA......hACA...,1,-20,-34,14
gRIdVLGUSQHKOcEbYJZFBCAWTMfXNeDPa,MFFFXCBCDGCC...aGEERBFAdACG.GDBFUDGHHGAE.KEDHhAAAEADCJAFAFHGAAECG..TACEhABAeAAB....hACA............hAEA......hAIA...,2,-34,-26,8
aIOLSHAZCRgGFUVKeXNWfJbTQBdPYMDEc,CEGHREBHGFEBUEDC.eBCB..XADA..NAAF.JBAFQBFAhAFABCGA.dAHA.hAAAMEEGDAGBaFHDLHFAhAGAAICA....gEAG.FCCBhABA.KHAC....hACA...,2,-43,-11,32
TdGcWCAaLVDZMbOReISHEJFUQfYXgPBNK,aDBDVAADZFGD..MFHHOGDG..eCDCHDEAFFDEQABChAAA.XAEEhADAgEACBHBBNAEDKHCCdAHA.hAEAGDEF.CBHAAGIHDDDF......hAFA......hBAA...,1,-15,-16,1
GHUaMJDdfBAQbPXEYNCZVTeWFIOLgScRK,QCBCXCBC.EBFCCCHDZACE..TGFDeFGBFHAALDHFhAAA.SFDGhABAKAACHECHaAGCDGABBACEAGED.hADAYFBDVCEBIHFGcADD....hAEA......hAHA...,1,-12,-19,7
MREKgWYTVIOZdaeGLUAJfXNQbSDBcPFHC,JDACXCBC..QFDHDAFBBEAGFGAAMEIF..RDCCKACC.hAAA.gACHhABA.TGAGOFGHaAGDhACAeAHDUDFEABAGNIBFSGGD..cEGFhAAACFCCEDDE....hABA...,1,-11,-43,32
eBGVDHPaYUXLFZKdIANTEWSRQfcgOCMbJ,EGFCSCFCRAAB.QAAE..fDBFODDBMEHHhAAAbBGHBBFBDDBFaBGAUGAHhAAAXGDHFACFKFACADCFNEAChADATEEE.WAECCGFHeFBF.HADDLEDDhAIA....hBIA...,2,-17,1,18
dAKCEgFJRDeOUIcGbLWNfYQZXTPaHSMBV,KEHBEEGDFDAFRFAE..OCBDUDCBGAGC.LGDA..hAAAfADFQABChADAXFFG.aDDAhAAAMEIHBCABAGAA.gAFADIAGIAFG.hABA......hACA...,2,-47,-16,31
IHWQbLCAYDUOZSPTRXeGgfBMcKJdEVFaN,DAFBOADGZDBG...SEDEREFCeHBA.GBAFBHGGKCBGEHACVFDDhAAAFABE...NDDD.HAGFhAAA..QAGEhABACFDDAIEA.UGGA.......hABA......hAEA...,2,-39,-5,34
ICUfZcgJKMXYbNLHdQPGaERAOFeTWVBSD,FGDBeDAC..TAGGBACDDHBAUBDCZFFD..JEAAMIBA..XABHhAAA..YDEAhAAALEEEQBGFhABAaHGEAGGBOFAHSAFFCCGD.fECBhADA.KGDCNCIE.hABA...,1,-27,-30,3
UgZBOVHeRCXEPaATcSdDfGINFQJKYLbWM,SGFCdHFHDACGGBAAFBFG.KDFGLBAE.MBEBUGACZCADBFFDhAAAHDFCCEDC.EGAFAHCA.fFDHhAAA.NAEF.hABAQAFH..YHCAWFDH.hABA......hAFA...,1,0,-45,45
FEaCgXYZDSPRbeOUILcTVBHNdGQMJAWfK,KHBGaDAB.CCDA...XBFGDBAF..SHFARBCBOGDAUGAFhAAALAHH..TDFChABABCBEdEAFMDIHJFFGAIHGFHDChACAEGDG..ZBFFeEBG..IEEFhAAA......hABA...,2,-41,-10,31
eNIDMTJdHUOFXWQEfASRgaKcGCYZBLPVb,SCFCRDAGKGHHGBBHZEDHBHFBLACG..VBGBeEAHDDFFMCIBhAAA.dDGEUGBHFHBCXGGDhABAEAAA.ADCEaDABhADACAGF...........hAAA......hADA...,1,-9,-35,26
BAGgJUaVSLHcdNQYZXIDEOfFPKWebTRCM,JFEFVBCFHCGD.dHAFQDFCZEAE.DCGEOADHFFBE.KAACeHBAhAAARAEA.CBAE.ABCB...hAEA..UGGEaGCFSGGGhAFALAEGcFEC.XGAChABAfEEBWCAD...hAHA...,2,-26,-12,14
RJEQHLIKFYecUNGVBfZSTgWDCdAaXOMPb,aGDDOAEH..MAIDRAABQEGDLABFKEAFeHBAUDDDGDBBhAAABHHGZFBG.SAFGhACATGBEDGGGACHF.XDGChAAA...bBEEEHGAFADE....hADA......hAGA...,2,-22,-6,16
GdcgFWOAKSHUfQRMTebDXBZLPEaVYNCJI,KEHBUCCBRDDG.MEBH..TFDDeEHHDDAFBFBAZCGDLAAC.hAAAEBDHaGCF..VAFChAEACGEEJABE..dBBEFAGAAFAASGFHhAFA.......hABA.fCFEhAFA...,1,-19,-38,19
WCKPTeDFZcARNSLfUOVgJGIMbXdEYQHaB,RDAGLCCHUGAG.VFGDGAAF..MCGDXCDBdBEG.EGFAHGBEhAAA.BCACCAFBKDFGeAHDhABADFDD.FEAGZFDBAFFDfABFhAEAOAHB........hAFA......hAGA...,2,-22,-15,7
KNaJQgXRCHAcEZIMUbTOfSPWDLdFeGVBY,ECFCZFACUDFD..bEDBOCBE..fCAHSCEEDEIDhAAALEBAdAGFFFAGeFGBhABABGGFKAAFaACCJHBA.hABA............hACA......hADA...,1,-15,-44,29
cKOJCLfAgYUWMaTeVEHGXPBDFINSQZdbR,UCBCMHFG.eFAAHCCCGEFABBGHFFBH.SABDQAEEdEFFhAAAbEDHKGDF..OBAHhAAAJEBCLACGAHHA.hABA.WHBG.........hADA.aGAHEAHBDGFGNDDF..hAEA...,1,-6,-22,16
CQMYPHXWULSaJeIfEbBcNOTFAZGdgVDRK,GBCHdCFCDDDBKCGBMABF.HDDCUFGELBHH.aHCGJAFGfEAEhAAABFAC.NADD.FBBGhAAAAHHA.ZEBF....hABA............hACA......hADA...,1,-12,-52,40
bSDZBHQRgPEGNOaYWUMILfKJVACFXecdT,CFCFFGDD.eHFAdCAB..SABAZAEFBFEEHABDRDDA.EBHBOHDAhAAA..aEBDUAGBMDAFhAAAIHHAKDDFAGGDXDGDhABATBDF..QEGE.PEABhABA.....hADA...,1,-19,-21,2
bTWFCAKZRMPJBdNXgSUfDVcYGIHEQaOeL,ZBCFRFACMBAEBEBH.dFFG..XBDESEHDUGEADIBE..VCAChAAAGAAE.HAFEhAAAEDHD.aFDFeEEE.LHAAhABAbFAC.WAECAADA.KGHFNIEF....hACA......hADA...,2,-15,-12,3
NBgTXUIPQRWfSGdOJaLbVDEAHeKMCZcFY,HDEDMEGFZDCHFGCHBAHE..TAFBUAEBQABDRADD.hAAASGGHdHCDaFAELCAHhABADEDDAEID.KFHBCFAG.hAAA.....cDAF...NBHE.hABAIEEE.WAHBhACA.OHFE,2,-34,-16,18
FYOHgcfDaERBZTbCMLdNSUAQWVIGKJXeP,VEFHKGAHeDCC.FEFBHADA...gGCADAABEFHFBGDHZAGBCGABhAAAdBDH..UDCEAEACQAGChABAIHHEJCAHhABA..XDGB......hACA......hADA...,1,-14,-38,24
NQLgCHeUafdbFGWOSZMKRIEDBVcXYAPTJ,TDACJDACLGDG.HECCaEGBdEDDGCGAOHACMICE.RBCADACChAAABGDG.XACBhAAAAGCHQAGDCAHGeAFHfBAFhABAFHGASBACIFADECHB....hAFA......hAGA...,2,-12,-9,3
FfDMgcUIHLEAeQYXTNGCSZWPdaBVbJRKO,eDACQCGC..TFCGGBAASABHZGBCdGGCaEDDVBFAhAAAJACAKCEAFADF..fGADhABAMFFA.gGFGhAFA.IEHEEAFEAHHEXCCFhAAACDEDBHAD......hABA...,1,-8,-16,8
NWBaLIcHYebPfgAGURZTKEMQCXFdSOJVD,UCCFZBCDKAFGMIFA..XEGGdDAC..SACGJHEE.hAAADDHFBCAHLCFDhAAAICGDHFBA.eAHDhABAbFAH....gFCAAGGC...hADA......hAEA...,1,-26,-40,14
XeOVFKLRIANQHZUMJBfDWCbSacYETdgGP,HEFHZFEEJBFEDADA.CCCF...aDECEGDC.dCEHGDAC..eBFEhAAAOCCDKABALFCDhABARAAEADAF.NEBF.MEIDBGAHhAGAfHEF..SFHHhAHA......hAIA...,1,-22,-30,8
APYbNRfJWMdCFLSZDOEGXHQTKecgaIUBV,...PFBBNCCA.RCCG.JDED..dAFCLHBEDEGGGAAFQGGGhAAAeGDA.aBDBBAHHhAAAAGAB.fDAAhABAMDIFSBGFOECCEGHBXBAB.KAEC.hADA......hAEA...,2,-23,-17,6
MdXKQgWEUYIRVObTHJfDPNBFLZCcAGSea,SCCGMEGFKCAA.QFAFECGE.UBFCIAGERFGH.OEBChAAAHAAEfDABhAAA.DAEBPFHBhABAFEEFCHCCAHADaGDFXDGAgBED...hACA......hADA...,1,-9,-32,23
gadeXPVTAZWFLRNEYDcbUGJfQSMIOKBCH,ZDAGLCCHRACC.EHGADABEUGBHGFAH.QGEEMFADKHECCEGEHBFChAAA.dEEDeACC.hAFAVCAH..ADFH.FEFHhAAANDIE............hABA......hACA...,1,-17,-24,7
MHbDNTBYCREAFPXVZQSLGKfUOcegWdIJa,XGBCZBCDLGEAGEEFUBGH..OAGBeCAFdHBH.aFBEHBBFhAAA.DABCBABACEACEADFhAFAABAFFEEG....hAAA............hABA......hADA...,1,-28,-33,5
LgGXeEWOMVUbKfcPBIZDaCHYdNJQRASTF,TFCELCCH.XAACEEAD..OFFCUAFCKFDB..cDCGhAAAIDAHZABCCCHGdGFChABAJHECAAIF...SCAGhACAFFBHgCEGeEFEMIBAfDHAhACADHAGaAGC.....hADA...,1,-4,-29,25
MYfCBEPLZRJDGAFISOTdVQWebUaXHgcKN,FAFBOCCHdGEE..QACGeBCEUFDBHEACKGBH...MCIHCHGGEEFGhAAAZDEG.DBAHAIAG.IGGDhAAA..SAHBhABA.WCADaAGD...XDDBhACA.NEIEBBGG.hABA...,2,-28,-27,1
SQDANBeZcfXJHCMgdOFTbUGPLYWKVaREI,BAFBeFBBZBAE..XEADJEGBHECDMCCBOAEE..bDEGUCEChAAA.LEADhABAKGHDaHDGRAAFIHHH.hAAADIEEABHA..cADHCABA......hACA......hAEA...,2,-37,-12,25
HZUbPdMKBYeDaTNGREXgOQFVJISfAcLWC,LGEAHDBHUAFDdCGCMEHFKCHHBAFB.DCBHaBCF.GEDERACG.hAAAXGFHQDCChABAJAAB.SHBAhACAAAEF.CEAG.bGAC..YFFENDIAEDFH...hAAA......hACA...,2,-28,-8,20
VNXAFgfZaMERTWSYGBIDCKPeLJHObdQcU,FHBGZAADEDDHRCCC...SFFBGAFEDHFGKFBHeDAFLBHHHACAdFGBhAAAUGDH..NIDB.ACDFaAEBhAAA...MBFDhADA.....YAGFIAHBCHAA.JEEBhABA......hACA...,2,-20,-17,3
ZRVDIOWYTcSHMUCFJAGXBeQEdagNKbfLP,XGDHeEBEEFEHdBGC..aAGAKFAGLCAHZAACDIEE...WCEDhAAATCDF..SGBEhABAMBIBCAED.AHFAQCFGhACAbGFA.RABA.IHCBOGFA.cCAGhABAFDCFBBHD..hAEA...,1,-14,-16,2
YBVMdUZORJAQIDNHgfeXWabPKFScGLECT,QAFBDACBHADBeGAEaEDA.KDBB..SCCFLEGFEAFECGGBBFDAhAAAMIEAdBAG.OCGFhABAAAAF..IHAHhABAgGAEfDEA.....hACA......hADA...,2,-34,-20,14
FZPIaWeLKGMQcOYVNgdBSCXUbJHAfETDR,TGBCREEEZBAH..aADGeBGH.KCEEQGECODEH..VABAhAAAgCGFBHGFCEHD.XGBHhAAA.JAFDAGFGDBIHhABAFCCE.IAFD.LEAEMCAF.hABA......hACA...,2,-19,-18,1
UYCLSFaPJTXEgBDHbNKOWQIfdeGRVAMcZ,MECGUFDHCDCBFBHD....aGHFTBCH.EGCCBAFE.DCGGNDAC.hAAAKEFE..OEFChABAQAAFIGHHeAEDhABA.....GDAEAGBAcBEA..hACA.LHBG.hADASGGD.,1,-14,-37,23
HMBJRbTaEUWYDceICGQKSdXVAZNPLOFfg,ZAADLGEAODFAFFAAHFBCBBHHRFFC...aCEEUAFF.DDCHICCBhAAACHHH..KGADSACGhABAdEEFAEAD.NIAH.hADA..fACAMFFGbECB..EAGA..hAEA......hAFA...,1,-25,-30,5
cYPXJWDgERQMZSILTCeHAbfBKaVNdGFOU,BFDGKEHB.aAGEdEFAGBEEOABB..UFGA..PADGJACDDGCBhAAARBFAZGBE..SCADhABATECH.CFAAAHAEfDBAhAAA.FHGAYHDA..hACA......hAEA...,2,-40,-23,17
BTYAFIEMGRHDQgeWOfLdXJUPKZbNcaSVC,FAFBEGFHGEBDHECHQCGGeAAF.OBBDLDHF.dAEBUGFEhAAAKHAGbCCCaHAGSDDEhABABHHGAAHCMCGFgEADhACAfDAA........hAAA......hACA...,1,-10,-12,2
AKfJgBDRPUGYaFHeWdOEZQITbMVCNcLXS,JCCHBAED.DGGHUFEFGECF..aCFHFFABHAGBdCCFZBAD..TGAGhAAAMICE..CBHH.NACH.hABALDHH.AHHE.hAAAKBDB.fDHA..PGBEhABAWCBDEFHF....hAIA...,2,-32,-28,4
GFXNOEKfdLYVTSUJcMCePIgAaDbHBWZQR,aHFGHFDGBAAAQBCCGADG.FHCG.OEBEKCAGLAHF.hAAAVDFFSACEhABA.JAFHCAFH.IGHAhAGAAIHADDDDbFADWBHF..XGCANIEF.fACAhAAA..hACA...,2,-28,-10,18
dSgEPcMZHYIRKJTLBFQVXfOCbUaWDNeGA,dAFBSAFBEECH.MCDHHFFB.RCADJABABDAB.FFFBQDGEhAAA..fAHAhAAACCDFUGDG.aBACDGBFNIDHAGHFhABA.....gCEE..hACA......hADA...,1,-21,-40,19
EeJKHIOaBWCSNYdRbADLTPFGVZMgXQfcU,DECDLDACFHACGDFEVAGF.ZBCH..MGFAQAEDUFBBeEEAhAAAHBAB.OFDH.hABABEADSABHhADAdCHEAAAC............hAEA......hAFA...,1,-18,-33,15
dYIEPaWFOLDQSeKNGXAHZRcCVgfJMbBUT,ZBDBCFDD...VEABJCBCBCHBdFHA..EBCF..aADEFABBLHBAhAAADAAF..QDFChADASFEBeHBAKHFAGBFEhABAAIEA.HDADgFEGfAGBhACAMAEE.....hADA...,1,-14,-33,19
eTPDMOIVBcFHSWJfKXZaENGLgCQURdAYb,eGEATAFBDECD..OFADBFEGFDGFHEDB.JCBCKACGZCGD.EABCLCCAhAAA.QAFBhABAdHGFAFCD.bGAAMEAAhAAA.IDFA......hABA......hAEA...,2,-36,-17,19
KXIAdTQSBfLZPgHEMGcOURbYDWNFeJVaC,dEHATFCAQBAD.BAHHfCHELAEDZAEHHFCEMBEFhAAA.OFFBbFFBDAGBWABFhADAFHAEeDAH.aEEGhAAACGACIGHASABEEDBF.....hAHA......hBAA...,1,-5,-16,11
GXVaQBNfAICWgEJHeMSODbRdcZTKFPYLU,CFDGEHBGHAFA..SEHHOBEHDBBERCADdACDZFGH.FEEBLDAHhAAA..UAFCXCGEhABAaHEGBDCEADDH.IHHHhAAAJHCEMCAE.........hABA......hADA...,1,-20,-34,14
dGYfJaPIQVRAgUcNDLbXZTWMKHOFCBSEe,UCBCDACBLEAEZGFE.MEEFKCHFFACE.BFEGeCHF.dHGD..hAAA.fCFHhABAaGCHQAFFAFCD..gADChADA.NIAFXFFCWAADCEEBECFB.hAGA......hAHA...,2,-43,-26,17
QgMWAPNOUXYcHGIdJVeLDfEBaRbSTFKCZ,OGEAUCGC..XEBAHDCBGBDH.dAABJACGeHBADFGHBCAEhAAARDAFSAEE.hABA.TGBACHHE.ZDDHhACA.MIFAPCHD.......hAGA......hAHA...,1,-9,-39,30
XeESNdGMaBJRbLWZFKAUfIQVTPCHDcOgY,UCBCQCBC..PGFCHGEADEED.OACEXGDBeBHDhAAAEAAHdGBFGAEHaAGGRDFB.hABALHAE.WEAGhAAA.KCGGAIHE.........hACA......hADA...,2,-18,-17,1
SHBRfZLKaGFVbeCPYTJQNcIOAdEXgDUMW,EFAAXAFBDDHF.UDDGMCEC..HEADBHGDZAABKABDaHDCGDDChAAAFFGH.eHBECHBH..TDGGhAAANADD..IDCHhACAAIGCgACA..SGFChAIAfGDB.....hBAA...,2,-33,-6,27
JRgBLAQGdfCeYENScUObDTHXIMFPaKVWZ,GCEBCFED.EEFBSDFDUECD.DIACXCAGFGCC.aAHDVBBEhAAAZABG...JEACgGABhAAABFHA.AHIHdEHChABAeAGF...NIEFOADG...hACA......hADA...,1,-14,-36,22
FLHKQUeaGgVINcbCAYBMZOXfPRJSWDTEd,BBFDOAAB..XFGCRDBH..JEEFSBGEDIEEdBHGLGAAhABAHEBEKCAB.eABBhAAAaAEC.GDDF.IHHGhACANCBF.CHCAAGDCZDFAfGAE.hACA......hADA...,1,-15,-33,18
YIKcEDZSAVNRTGeHCJgUaQfLOMFdbXPBW,VGFGTFDH..eDEGJBEC...UADAaFACLECEFGBH.dCAAhAAAPFBABHBEIHGAhABAEAGEZABH..AFFE.RABBCAHAhADA.....fFHEMDIB.WDFBhAEAcGDB.DAAFSHDGhAFA,2,-32,-14,18
KVMLXFeDcbYSATCOgdERQaHNIZGfBPWUJ,CFEEdDCDRFCH.aFDCHABA.ZDEABCFG.UGGGVDAGLADC.eHBEhAAADIAG....YAFGhAAAAHFFTBGD.EABFhABAIGGF..fBDF.hABAPEFEKGACMADE.hAHA...,1,-20,-29,9
ZFdfEPYCQSRGaXAOcBKWJHNIDMVbegUTL,OAFBKEGDHCBBDBBHMEAD..eEBEUFDALHCAZADDdCHAEHGACEGGQBGHhAAA.SADDhABAaHBCABAEBCACNCAA.hACA.....IHHG...hAAA......hABA...,1,-24,-29,5
WGJeDCMTOPYUFIQafRNKVSdBEbcXLZHgA,JFEFCGHD..OAEDUBFC.FAAC..aECBRDCD..KGAGdFAC.BHHEEDHD.hACA....XBBFhAAAZFFFAEBBeAGH.DICChADAMAED...YEECIGEFNBIA..hAEA....SHAAhABA,1,-40,-41,1
KUQeTDJBaOXICMNLgVdPHWGSfAYbZFREc,ZAADFEHBEBACKDGDUGGE..eFDEDAAD.BHBD.ODCECAEBLDDHhADAdBFAHFACGCBEfHDFhAAAADHE...hAGA.bGCAcADB.JAHFaAHHMDAA..hABANIAF......hACA...,2,-25,-16,9
DCKNGQcbVYdPfLaWAUOFRZEXeTSIgBJMH,UGGDODCHZBEB..eEEHSDCCBGHDJAECDACD..KACBQGAFhAAA..cDGBhAAAbEBC..dHDHPCAFhABAfDGB.aAEGAIEGEDDA.IHAFhACAMAIDCEGDNBAE...hAHA...,1,-11,-42,31
aZPbLHWUQYNTOVCIJfMEcDFKRXBeSdAGg,aGAHZAADLFDBHABDUEDBQAEE..NECE.TGGGCBEE.hAAAIFFCMIDAEDHFDCCAhAAARGFEBFABSDDAhADAAHDA.gEAE.PBHHWBAD.OHAGhAEA....hAHA...,2,-22,-13,9
HbcOVGQIdNBTXKLAZUgERCMYSWJDaPeFf,UFDHECFCRBBC.CCEH...MFEA..SCAGJCAF.aGBBPGBGhAAAeCHDHAEC.OAAEhAAAVGEE.QDCDhABAIAHDBGADTGGCKABCAIDA.....hADA......hAEA...,1,-16,-28,12
WXJLNZYCTSeOfRDBFQIAEPVaMdHbUGcgK,ECFCVDAGdGAG.HABGUABEGEEF.KFCBJGFCLCADZGAC.CHEGeBHHhAAARADCBEEG.FDGHAHIB.hABA.aCEHMCIB..hAAA............hAEA......hAGA...,1,-8,-36,28
HYXOfDgRWNAaISQZJLUdCMVGcFETbKBeP,aAFBQGBCLDCHCBAGGCEFFHAE.EECCTCFE..KAFGeFEEhAAAHCACOABHDGGE.hAAA.WFFCAEHCSHFAhACAJHEEMBBE..........hADA.cEABBEAB.XACAhAHA,1,-16,-22,6
PHDMRFQgfIdUESALYbOJBeWCXcTZNKVaG,LGEAOGEABAGCeAED.CDHB...TCFCZCAHKFFCGBBHHGAARCCDhAAAFEDEQAFAhABA..IHBGhAAA.UDAHAIFA.YEHH...WACChABA.NIDF..PAHDhBAADEFAMDAF.,1,-11,-17,6
WEQTdRXaVcGCgZLPbDeOUYBNKASHFIMfJ,SEHBHDAGFHCAMGBC..JACGECAAdGCDREED...XCAAhAAAaBHFGACDCEFBLBFAhABADAACOHFCBFGAAAFAIHAChADA..fDDF.WHBGhACA......hAGA...,2,-43,-8,35
POTHBFXRZdWYQMgKLJbEUcIAGSVCeNaDf,SCAHVFEE.CCEH.aFAG..DDGFOCAABHHGFFBHRCGH.dHDBQAEBhAAA.MHAGhABAgAGCKDDF.hACALACGEDAE.IEEEAIHENIAF.fECEhAAA...hADA...,2,-40,-20,20
TGCQNZSVPfHDUebaAgYLEcWJKXBOMIRdF,LGEAEHBG.JAFCKEBCBHCGMEEG.dHGBFCDDCAAF.ZCFF..SBCFhACA.VAFFhADAHEAA.DACH.eAABhABA............hADA.ADHE.gFDBhAEA.YFAD,2,-40,-33,7
DZKfdBPOWMcATIFYHNGXRCQEJbgSUVLea,FGFCHAADGEAFRCCDEADA...JHAASGHBLAEDDDHHKDADfGCChAAAdBBCBDAD.PEFBhACAMFIF..AAGG.YBFChADA..CGDEgBGCeCFG..hAAA.ZDDCWHEA..hAGA.IEHF.,2,-21,4,25
GQXaEMDHTVPLOICSURfKWgZYJAbcBdNeF,BFDGeCCHQFFFEGAFDCFE.HAGH.TABGPAFALDFGhAAAOFHD.IGDBhABA.CAFF.SHDGhAAAfDAAWDBBYFHBAGGDbABE....NCAEFDEFhABA.aEHB...hADA...,2,-23,-4,19
fQYVAPSGCTcBObRFUHJKLDdWZeEgaXINM,GEAHTGGG.BGDDRBCFHAGDKGFFDIGEZFBBEEFG..aHAE..XDAChAAAMBBC.QFDAhABAAGABSAEECBBH.OBHFhAAAFGAB.LDEE.dCAC.eFFGhABANACF......hACA...,2,-24,3,27
FXVOWHRKNTIYaLUSJQBZDeGPcEMCfgbdA,VBCFOFBB.RCDE.KCGD....IDBBaDABLACCUFFHJAAChADAZGAADEHB..GAGEhAEAEGHHMFEFCAFA...hAFAfGFA.gEBEAIDE.hAIA......hBAA...,1,-21,-33,12
VHGABMbFaRDTXdNYUIeOSWcJKgLCZfQEP,BBFDMHFGFAEHDAAGdDCD..UEDAOGEA..SAGChAAA.JDAGLEAFhADAZCFDEEHB.PCGFHFAFAADDaBCAhAEA..XBAC.NICF.IHHDhAFA.cGBA.KBBDhAGA.CFDC..,2,-45,-13,32
AGacWJbRHdeZgBCPQVTKFSfDOYENUXILM,aGAHJGEAHCAFZABC.BEDBQEEH.KAFGSGAH.hAAAOCFGNCCAUGDFXABBhAAAMCADAHHE...cCDFhAEA..WDEERDGFeAFA....hAFA......hAGA...,2,-31,-25,6
adIORegFVSCcHEJLbQBKZAXYNPUWTDGfM,XCBC..YCAFUFAFDGDFGBBB.MFEFIFFHhAAARCGBFGFA.CABHHAEDLEDChAAABBHAKHBAADAHNEIGWAHBhABA..aGECeEBHSCED...hACA......hADA...,2,-26,-15,11
NHAbREWIMgZJDTXYaSeOPVcBGKQfFLUCd,RDAGEHBGMAHFZDBD..DEAB..XCDE..aFGCSGBHhAAAeBFG.OEFEPDEHhAAABBAGKDGHQACDhABAFGEECBFBNIEBAHHE.ICAE.....hABA......hACA...,2,-32,-21,11
bgaKdAeLVMIHZUNYJSRQfEXWPGBOCTDFc,VFBGMECGZAFG.UGGEJCBG...RABH.EBFH....XFDChAAAPEDG.BHAD.CCGEFFAFhABAgGGH.hADAdAHEAHFAeEFALAAE.IEHB.hAEANEAESHDAhAEAWDDE...,2,-31,-23,8
aYJWGgPFfATCLVeRZUEcNBdKSODXIMHQb,CFEEeFFCRFBB.ZCDFUGEHEBAE..BAHCKAGC.DGBG..MFIFHCFA.aEAGhAAA..JBBG.GCDBhAAAPHCC.AHHC.TDAFhABA..LACA..cDGDhACASHGG...hADA...,2,-37,-16,21
ERabIKOfYQZeXLNcUgJVGHMFBATDWCSPd,TAFBDAEDCBFA..dEHCaDEH..KGDH..fGGEQCBAZBBEhAAALFFBUDGFgFADhABAJDAH...hAAA............hABA......hACA...,1,-24,-52,28
EgOPDWcIdTLSeQNXaBYMHVFJURGbfZCKA,OCCHDACB..IHAGLFHH.eAADQBGDaFFB.BAGChAAAMICGFEFFRBGBfBEChABAKFHHAHDC.EFAGWDAEhABA...TEAGSAGE..hACAYCED.JHFAhADA...,1,-15,-44,29
NTEeHQcdSMVFgCfUGZDbLOWJIBXAPKaRY,KAFBaCFC.RCEF...TAACHBACdGFB.MAIFFFAGCADAGEBAZFEDDCCG.hAAALDDHODABIEGAhABAABHG..PEHHhAAANEIE.EHAEeEDBSCAD..hACA......hADA...,1,-8,-28,20
IWFfGMRXHQOTVJBaEcZALYUgKDSCbPeNd,LDACUCBCDGDG.SGGG.CCGB.PGAEdHBB..IAAFhACAFGFDGAGE.XBDFhAAAHBCGOFDFhADAJEEABAFEEAHBZDFE.gEACKABC..hAEANIAB.MIFE...hAEA...,1,-2,-34,32
JQPUWRTbABVFOaXMISKCHgGdLZENDcefY,FBBDaAAD.MBEBKBFHHGFEGDGGLFAB.ZDDADIDG.eFBEJCHBQADBhAAAUAGD.hAAARFDFACCFOFAH.SADFhABACAHA.dEFC.NHCF.....hACA......hAFA...,2,-21,-14,7
KQEDbCVfaLSOABZcRIUFMXJdYgGeTNWHP,ZDBHRAADFDEBJFFA..dEHEGAEH..TBFD.HEBFKHCADCAHhAAACHAH.aBAAOFGHBDEG.hABA..IADAhAAAMHEA....XFADYCAFeDFGWCDFhACA.EAHB....hAFA...,2,-31,-28,3
HYZVTCJXBfQRAGcaODUENeLPISdWFMbKg,aGAHOEGH.DAFEUCAD.EDGBeDDF.LBFCSAFBFCAAKFEHhAAA.HABCVFCFTCGChABAJFHBBAAC.REEDADDEhACAGEAE.........hADA......hAEA...,2,-29,-11,18
AWHJCcLEdMVKQZDGeBUFSOTabPNXYfIRg,HFDFJAFBLECGECABdFGDKCGCZAGB.GBCCBBAG.FFAA..OGEAhAAAaHFE....NEEF.fHEBhABARAEFACBG.CCCAMIBGhACADAGGSABC..bDAH..hADA......hAEA...,1,-7,-34,27
DEbMaZQXKgAHUdNBWJTVfGecRSLIOYPCF,dDAFBFDGJDEG..TACBGEGC..eCGFSFBHLECFOHCEhAAACAGCFHFC..EEAHaBBGhABAQAAAKEDD.hACAAEHEHCDDUAGD.........hADA......hAEA...,2,-29,-17,12
CUAcYSOGQVEagZBXTMdNWJFKPLefDbRHI,SHBGODACGGAHQBAAEDGH.ZADAXBAAMEABdHGFJHFAhAAAFFGGKAGBLDEEhAAA.eFCEfFAFhABADAIF.HADFCDCAACCC.YFEA...hABA......hACA...,2,-13,-6,7
TEJWPUHIQZNXVCYaegKBDfORFAbMLdcSG,LCHDdAFBSECEGDEC.EGHDJHFEUGABHAACZADD..XGBChAAACFCBeDAEBBCCDDGFRBFEADCAhABAMAAE....hAGATFEBWBFC.IEABNIDF.aEHB..hADA......hAEA...,1,-9,-21,12
FNVWZgRMTQDbSGOJfBXKCEHYacPeALUId,LDACdGFCFHCG.VBEAZDFGMACE..QGFGDBEGGBBBfDHEhAAAKGAF.CFHDEEBHhABAaDEG...eHBEhACAIGHAgABA.REDF.TBGCOAFAhAEABAAC....hAGA...,1,9,-35,44
SWKARMDVZcOYGPHITgEQeUBdNLfFbXJCa,MCDDZBCFOEAEGGAHHAEA..IGHFEGGHQFECBAGGdBAHhAAALBAHFAEBJFFBSDGAhABAAGAEDIACVCGF..hACA.PCEE.eDAF.....hAAA.fGCGhABACEEA...,1,-8,-17,9
NaXLARFUfHcVSCMTBeJPGgOWEYIbdKDQZ,UCCBHAADSCCBCFCB.MIBGBADHJGBAGGEH.OHAGhAAAEGHHIFGBdDAEDBGHZAGFhABAaAFFLEFEhAAA.FBEDfABF..cDAEhACAeEFE.WAHF...hAFA...,2,-35,-2,33
NZVgEaITQMYWLSDfPUCbJBdcKeOGXHFRA,ZGFGVDAGaEBH..QGDFMFDE.LACGDGDEUCEE.CCHE.BGHEhAAA.KGGFOAFEhAAAGBGGFCBAAFFA..gGBDhABAEADA..IEHEWCCESEEFhADAfGAE...hAEA...,2,-33,-22,11
VNOSeDXTFafKULEIdABYHGcbCPWQMRgZJ,HDBHGAFECHEF.QFACMBABZEFC.JBBCOBGDDHGA...TBDBhAAAaFGEKDEH..EFDHADABBHFGhAAA...cEBAhABA..........hACA.WHAA...hABA...,2,-37,-27,10
aUdXRBZEFIfLWDOGQJVNSAPHCcYTbegMK,CFDDTCBC..eBADKCGDdFHEBEFBZECDEFFDFACELCEG.DEIHhAAAQFAB.hABANIAF.SFAFhACAAGFH.HAEEYBADgBBGaBED.XGCChADAIAHFOHEChAEA...,2,-28,-21,7
KPJZgTaLFdbWOIHRSXGeAEYVCNQMDUcBf,ECFCCFDD..QCAAMFHHUECDBABD.KFECZFAH.TBCDFFBBdAHGhAAAOAADHAEFSHFGhACAeHDEAGFA.NEDB.fAGHhAAA........hACA......hADA.gDGCaEHD,1,-11,-26,15
aZCVPcKFXfgYMRBESJNOdGHeIDLWAUQbT,UCGCQCGC.aFDBCBDB..VFGHKEBDFCCA....XDADhAAAfAGH.MBBGhAAABCEHJFEENCDGdHABeEHHhABADADCAIBA.ZFEF..gCAEEBAA.SFADhACA..hADA...,2,-30,-24,6
cGVKeFBPRQaZNMSfJHYdbDAIEXTOULCWg,XGBCTDCH.LFFACEHC....gGBCGBBEKADHhAAAFEAFBFCAQACChAAAaAGFMHEGJEFFdBFEAAHGOCFAhABAWBAF...eFHFZDEA.fGEEhAEA.....hABA...,2,-20,-11,9
gTDBbHEVFPaRKZdNWMUSfeGcXCYIOJQLA,TAFBDAEDHAGB.FCBCaEDGZEEC..dDGAMAACSCBAGGBBCBFCOFDEhAAA.LCAFhABAADFGBHHEEFAEPFHD.hAFANIDH....WECD......hACA......hADA.fHAB.,1,-6,-29,23
OQRSVAcBFDHJgdPCYaXTMbeIUKZEGfNWL,FEGDDGADHABDdAED.CBHA.aCEH..MECG.eEFFIACBZGBG.EHDChAAA..NAEB.LCCHhABARDADAEIHBHHHJAHF.PFAFhAFA.....YGCEbDGBKGGDWAAFhADASGHH..hAIA...,2,-31,-15,16
JAdIRFDWGUPQcCTLeOSKaXHMfbVZBNEYg,dCFCRDAGDCDAGAAD.UGDEQAGG.CGBALFHDSBHDhAAAKFFBXGBCHAAEMIDAhAAAfDDG.hACAbFFB.BHHENEEDEGDGgDACAFBF..hABAWFAD....hADA...,1,-12,-23,11
YJecLdGOgKBTQNbFXEUPZCSaDMAfHVIRW,HGFGVGFG.RCGB..JFDFLACBGACBKDCATDFA..QDAEhAAAFGBGUAGBZBDDaAHFAACE.hAAA.fBAGhABA.IEAFeFAB.......hABA.dEFE....hAFA...,1,-9,-15,6
XOgLPTcWKVDQaJefBENAYFGUdISbZCHRM,GEAHdGFCSEDHCCCHRFFF..MAIBOEAHLGAA..cCBEhAAAKBGDDFIH.JAEHBHDChABA.AEIHFBFC..hACAbDEAZADFHAAAgDFF....hAFA......hAGA...,1,-16,-28,12
JIUfdeSgBTWHDbQFRCaYGMVEPZNXcLAKO,OFFBJDAC.UFBAdBADeGFEBBEC.HFADDCCD.QCFD.hAAACHFE.aDDC.MAEGEAHHZFCBhAAA..NIABLBGFhABAKAEESGED..WDAF...hABA......hACA...,2,-39,-17,22
PWJgNUaRQdDMVIOGTZfCAeFKBXcYSbELH,eEGHFEHBKGBBBDDG...XEBDSFGDLAFDHAEAJBBDhAAAUACGRDCH.dHBBDFEBIEFAhAAA.GBAEhABAfEAECHHFAFIF.YAHBEAGF...WFFDhABA...aCEEMAIFhBAA..,1,-4,-39,35
DAYLcBFCeGEKJINfURMVWHPdbOTQXSgZa,LGEAFEGDCFBC.eFFCKCHB...JCBA..IAFCUBGHMFCChAAAHBCAdHBH....hABA.ODABTFDFSBDEhACA........hADA......hAEA...,1,-29,-55,26
cHNLeDEGIMRUAbKXVBTPZfOgaWCQJdSYF,XGBCBADCZBFDOCDH..aHGEQEGASAECFBBDNCFA.hAAALAHB.DGAEhAAAIBAG.UDCGhABAKFFDPFDDWDGFdEHE..cAEBEDAEMAIFhACAAIHA.....hABA...,1,-12,-32,20
bWNCaYcMXfeLHQRUEAZPVOFTgSBKIGDJd,ZGFGVFDFFDEG...SDAGBBHCGDAADBAE.dCCE...bADFhAAACHDEaBFC..MIFAhABA.eFFE...hAAA............hABA......hACA.QDGAUCGF,2,-49,-15,34
SPHJacIXKgNMQLYTZFfAeRUWGCbBDOEVd,RAEGUFGHCGFD.DBCB..EDFBdAAEHCAD..aBEFXECF.KAADhABAMFAGLCHBZFEFFBHDhACAAHAD.eHAA..WHEAhACABGAFOFCHSDBA....hADA......hAEA...,1,-18,-36,18
TfWBCHPEFgNObYLMaAGKQVcIZJRdXUSDe,KEABVEFHZDCE.RCGH.UBDC..SGAGeAGD..TGDGhAAABABACHHDEDCDFGFH..OCAHhABALBDEMCIBAICA.hAAAQFAA.IBBB..hACA......hADA...,2,-44,-16,28
KOUBVGNXFSAPTfdZcHQbeRLgDaMCJIEYW,TCBCdCFCHFFB.eCDHRFCELBGHDCAG.MDAFIEBA.EGADhAAAKBCCBAFDNIEF.SABAhABAAHFGZEFAQGADhAAAaCHH.JBEB.........hACA......hAEA...,1,-10,-29,19
cPBdWQFNZEAXLUeGgaYJVIOfDTKbSMRCH,XDCHLFCAeDCAGADC..aHAEJGBCOCAFDFAD..KGGGbAAChABAMBCH..CGHF.HFEDhAAAPBGDdBFEFBADNAEF.hACAADIH.....YHFAIBHA..hABA......hACA...,2,-20,-12,8
DYHaTWdBRebLfIgQUKSXcOPCZMAGENFJV,EGAHJCCH.DBCAHGDG..aABBdEEB.eBBELFHH..ICAHhAAAUEAHXDGChAAAOCHDCAHAZGCEAGBG..FCFGTEDGhADABHHH.fGGAKEAASAEEPBEDhAEA......hAFA...,1,-19,-21,2
QBRefHGCSYXdIJUAbNPFZOaMDWVLcgTEK,...PECCFDBDaHGEDAHHLGBC..TABGQBDChAAAREGHHADBSAGChABAdGBDIGEGAGFHZDFA.WDAFhACAcBAC..KBBAfAFE..hAAA......hABA...,1,-22,-28,6
YVeNAJQgLWCRBcDGTbOMUEHKfPdXFSIaZ,JDACQDACLGDGRFFEDBGBGACB..TDDAOAFA.EEFEKGEFhAAA.dGAE.FACDaAAH.hABAZCFAeFCBAHHA.WAHHhACABBHA.MIFE.fCCBSAEF.hABA......hACA...,2,-24,-15,9
WRafQbCYKBgAMUDGLNTISVPJeFZXcdOHE,DIBGLFEF.TAFCIBHH..SFACJCBHZFGHdDDHEABEhAAA.aGFAQGEHhAAA.CGABBADGACIHUCCEhADA.VDFEFDHFOAFFWHAA.....hAEA......hAFA...,2,-34,-21,13
QNSBIcOEHLeAGFgWCPfXKRZVDMYTJUbda,FGAHCFDG...XBAERACAZCCAMFGF..TGFHUBGF.dDGFQDAGhAAABFEF.OGAChABAHDAHeADA.ABAEgECFhAAAfGEADAGA.....hABA......hACA...,1,-25,-29,4
eYISQdUCMfVgWTNbRZBLHOPXKEaAGJFDc,JCDGFHFGDEAG..eDHF..ICBBQBGGUADGMIFE.hAAA.VCGFTFAARFBGBBHEhABAOABG.PEFDhAAAXEDEEBCHAFEH.YHAGCACG.WAFEhBAANIAF......hBBA...,1,-22,-31,9
QGJOLIFDTKfVaCgNUEHdSARbMBYeXPWZc,RFACMBFHeBDG..XCGGZFEDQGGD.OCHFIHCGhAAADCDBKAACaFGDCBAA.UDAAhABAEEAAdHADAGBC.BGDAWDDHhACA....JAEAFAHHfEDF.hADA......hAEA...,1,-10,-34,24
FWZVEbKSRLOGdBPYUcJINTXHaMADCgefQ,DAEDCAFB.eHFAQAACFDAG.ZDACEBAEKEGBLFACdBDGBFBAUEEHhAAA..JFEH..IAHGhABAXBFAaCEEAIDA.hACA....gGBDfGGE..hADA......hAEA...,1,-25,-40,15
IZHeNKWFLYGQcbTMEDJOaVPgdRXABfCSU,CBBDUGBCHEEGKCECLHAEGEGA.QEAG..TABChAAAEDGEJAFBVDDHdACBAGHASEAGhABAeDCE.FGFH.hAAA..bAGFDBADaADA.......hABA......hAFA...,2,-16,-11,5
gaWecRFQOHMfSGJPNLBdTYXEDUZCAIKbV,KHBGVAAD..aDEHeFCARAAF..FEBGOHDEHDGH.MFABGADFJBHH.hAAALFDABHHGdAEH.hAAA..XCDEhACADAGACCGC.IFGGWFHH.QDBDSCCChACA......hADA.NEAE..,2,-18,-11,7
RWCXMfDBHbFZIULKVTNEGQPcgOeJdYASa,SEHBaCFC.RCBC.CACGMEAGDGAF.HEEBFGEDZDFFLFBF.hAAAKEHFVAECEHCGQAGChAAA.gBBGhABAeECAdBADACHCfGHAIEAC...hABA......hACA...,2,-29,-8,21
fUHaGeWKQIEJLcSAMXOTDPYNbZVRBFCgd,MIFGXDCHDEDC.......NBBEZGBCBCDHFDGFdDGC.UCAGhAAAGACBeABEQGFEhAAAIFBE.EAHHJAFGSGADhABA.ACCCPCEDbFCH...hAEA......hAFA...,2,-41,-6,35
dMYTSKPBfAONFCRXeHVcaEDGbIWJLZUgQ,FDCDCFFCRCAF.HEGF.aAFEDHGE.GCGA..IADGLHBAUBAHhAAAQFBAdFFCMIEAhABATACDSFABhACABDED.ACHDXGCF..cAAB.hAFAEAFC.....hAGA...,1,-19,-23,4
XQSKNUgeGFPEBWVRfabJTCLZOIcdDAYHM,HFACXGABQGEFKDFG.UDDFeDDHGABAFDBBBACGRBFGfHGHhAAAJAEE.CADHLBADhABAIHGADBAHABHGMDIDhADASCFE.PFFA...hAFA.WHAAaCCF...hAAA...,1,11,-38,49
KBALXcdTQEeHMCZYRGVNaWfFbJgIDOPSU,LDACdGFCEADHHGBAMGDECCAE.ZAACGAEE..aBEFFHGA.JDAFIFAGhABADDGE.OHCGhACASAGBBHABAIFGXABBhAAATDFD.eEEA......hAIA......hBAA...,2,-28,-13,15
RNVTDWKdZQHbPCOcEXFGYLeUMJIgAafBS,BFEDSCFCRBFA..VCCADHFGKDCG.QEAGHAACCGAAOGFEhAAAEHAAGAAF.LAFEhAAAMIAEJAEEAFFB.aDGEhABANIEFdEGA..........hABA......hADA...,2,-27,-19,8
OLfZcBWMFVIJAaYgPdGCUbeRTEHSDQXKN,aHBG..gDACdCBDUFGD.eAAERAFHHABADGBCKEHDLEAGZGBEBGGGhADAMEECFEEG...hAAAJBFCAIDC.....hABAPCCACCED.........hADA......hAEA...,1,-25,-26,1
NbYWfJXKMeFPZIaSECLRHBcDUOgTQdVGA,...bCAAfHBH.KECDMGBCFCDCZDEESHBGLABHhAAABEBGUGDEgAFChAAATAGDdGGCGGDBhABAAFAH.NEEDJACEXADAeFFE.aFHFCCED....hADA......hAEA...,2,-13,-3,10
KeURdISEGYBgVTMabQNPOZcHfJDFCLXWA,KGDDUAEGRCBA.dFGF..SHGEECAEGAADBAFC..TAGDhAAAaCHD.QEDBhABAOEAFHDFBDIAAFHGACADDXAAChABAADAFIDGA..gAGCMIDE.hADA......hAIA...,2,-25,-13,12
UVXLJcKgWeYCBZbTOIaSMNEfDRQPFGdAH,UBBHXBDGLFCAKEFE.eDEEBHHEZBECOGDG..IHGChAAAaAAF..NCCA.DIBEhABARAFD...FFAHAFHBJHAEhACAWACC..CFAE.SFHBMDIFEEDE...hADA......hAEA...,2,-28,-28,0
fOeFMAGZJNXVLIBRagSTHDQbEWcdKYPUC,GGDHZFDFJBAA...XCFGLDHHBFAARDDG.aBAG..SGAHhAAADAIBQAFEhAAAEBEBdGCAPCDH.CDBF.hABAeBFGAGGA.IDBF.TGFGWEBHKEGChACAfAGD.hADAMCAB.,1,-13,-28,15
USCfDHELIRFQWZJAegbKaOMXdBVTYcPGN,eGEAKHBGOCCEMDEHBACG..VGFCTFBH....PFAGhAAANCIG.UADHSAAHhAAACFEB.DEABEAHFhABALBEEICAF.......hADA.QDFEhAEAJDHF.AHAF.aDEE,2,-31,-23,8
AMBbYSOcZUTFPWeIVLgXCHNJdfDKGRQEa,MBFHBFDGSAGEZAGBUAAC.FGGH..eDAHLEEHCECC.HBCFhAAAJDHD.DCABKGCHRFADaDHFhABAAGGB...OCFFhACA..PADFIBBFXGAD.dGEEhADA......hAFA...,2,-31,-15,16
GVQLbPINTWFgKReHcYAJBEdCXZSOMafUD,EDABdFFBCCEHZBDG..MBABUFGA.DBCEGEBCLFEF..IAHGhAAA..WAGBhAAAKCCHeBFGHFBBACAGBBBBhABAODECfHEH......hACA......hADA...,1,-28,-37,9
HJVDaNAeUCPGITXcYZEWQKOFbfRBSgLdM,UGDECECDGGCH..XABGZBBAEFGDKBFBOFAD..FBHFRBEFBDAAhAAALDAEdGHA.HEABhAAADADCACCB..IEEGhABATCGF......WEEGfACFhACA.MFIF..hAFA...,2,-34,-16,18
XTRPgVFNQBJDZOCAaGLISMdKeHYEUcbfW,aHAELFEF.SCFHKFFGeAAFECDEUCCG....bEAAfFADhAAA.TAGHhABARBGHPHFAFCABQGGHhACADCBBCGAGAFEB.MBBG.....hAAA......hACA...,2,-30,-14,16
CgIFBeLODNGKRVSMTcUPJWEdHbQZYAafX,XGBCCFDGFCAB.BGHFLCEH.DEBAKDDD.SFEHhAAAMCIFUGADJBFG..dGGBQDAGhABAABGD.fEGDhACAIHEG..NBBB.RABC.....hAEA......hAFA...,1,-33,-44,11
LXfgAYeZdWNUECDTPbJGHMBVSROIKFcQa,eFBBZDAGdACBUCDCCHGA.DGHB....TBFGJAEGHFDDBAABRDFF.KEGAhAFAFABA...aEAAXFDAhAGA.ABIF.NAIE.hAAAEFBF...........hAEA......hBAA...,1,-28,-43,15
SCMFPaeEVQOfZHGJKXcDgRTAbIBdWULNY,BFDGUGBCLFEASAGECEBE.FGGH..eHEAEDCF...VBBChAAAOABBHAGBJAEFKDEBDHDAhAAA.RCGD.AAFDdDAC..hABA..YFAD.MFIF.aCAH.hACAfEEB.hADA...,2,-23,-22,1
IJbRDYLASPWaNKGTUBfcMCgFOZXEHeVdQ,SHBGaHBGGAFABDBGMFEB...FAACXABBEEAB.VBEChAAAIGFE.RCCBDAIHhACALDCB.AGIHNAIETADChADAfGFACHHGOEFEZFGBeEAH..hAEA......hAFA...,1,-15,-16,1
TZJVHKgFSBXNDILEeaCPWbMOYGAdfcQRU,dHBHQCBCRACGUDFE.JHAGHCAF..KAAGSGGCBFGHDBDALFEBhAAAEEDH.aDFCCFAD.hAAA....bAGBOCHDhABA.ADDE.........hACA......hAEA...,1,-29,-37,8
YbOXLRfWcgJGTFHQEZAVNadBDCKeUSPMI,VDAGaAFBBEGE..KGAEUBGH..SFFBMHBE..IDBFhAAAbADB.OECChABALHFG..fDDBhACAcGDB........hADA.JFGFFABFEBBAAIAADCHDhAAA.eAFC.,1,-20,-30,10
fQIBZSdDMFeabEHXVCcLWGJOYTKUgARPN,RAAD..fHGDBGDCZDFDDFBGFCFF..aFEFHADH.CHAF.LCBGhAAA.JDHHOCAHhAAATEBGKAGFACHG..NIAH.IGHFhACASACGeHFGEAFA....cDCAhADAWDAD....hAFA...,2,-37,-15,22
cRLCeUfaXbWVHYGdPFTZEAKDOBJQNSIMg,OEACJEBE..SCGGMIFARGDA.LHFEUCEC..aABHXGAEhAAA.VADBhABAYCHD.dGACTEFGhACAADDBDBDEBCADICBC.CAFEfFDAhADA....hAHA...,2,-32,-30,2
XbRCMYdDOHgNLITKZWcAUFJEQBefSVPaG,UGGDFEEDQEBCBEAG..eFAASCAFaFFG.GBDDhAAARCDDMADCDGAD.ODGBhABAHGCELBHFIHHDKABHhADAZAAHACADJHBAEHAEfEHA...hACA......hAHA...,2,-15,-9,6
HEMYGKaQcIABVXRdgPeNCUFJWSZbTOfLD,BFFCXBBHdGHAeCBDUADC...FFDDSEFBZFAF.OAGFhAAADEDEMCCCKFBDQGDEhABAADIH..gAEEhAAANCACCEDE.JHEEWFHD..fAHAhABA.EDFE.hACA...,1,-31,-33,2
eYTAXIWBFcaLQgJPSMKZRfbEOdDNCHGUV,XCBCBFDGaADBLEBE..gEDGJFHD.PAFGhAAASCGG.MAFChAAAZCECfAEGhABAOHCAdABEDBGENEIECHFC.........hACA......hADA...,1,-31,-35,4
EKTZdNbRfgMFOBLVJSAcIeHGUYPDXCaQW,eGEAGBDFUBADDDGBCDEG..aCFA..ECACZAEGdGABRDEH...MHDAhAAAOFAFBFGALDDDhAAASAEEAHIH.HEBChABAPDHF..WHBGNICB....fDBEhABA...hACA...,1,-12,-34,22
bEJMgWAVRHfLaYTPcOBXCQDNGSIZKFeUd,RBDBHFDFLHBEaCAH..TGAGOAAFCBCG.DGGFGDGAZCFF.KCDG.hAAAeBFBUDAFdABBEAGDMAFChAAAAFFB.....hACA............hADA.YFBGBEEBXEBAhAEA,2,-41,-3,38
GcFPdXMWRCTUfOZQNSEYDHaLIJbVeBgAK,GEAHFHBGdHEB.MBEHRDFE.CGHD.UEABZGBC..QDGDECDH.DAAFhABALBAE.JFDGhAAAeAHDAAHG.KCAH.cBBAhACA..PBEA.XGGBhABATFECOHFC.SGADhADA,1,-4,-37,33
YBNdbQKAZSDcMXVGfJTgLPRaFOeUICWEH,SGGEMCHFGGAF..TFAFLDEFRAAFFHFAODFF.IACGhAAACHDFHADBBEGAhAAAbBBC.ADFDDAFA.cDDChACAfFAF.PFHDUDAB....hABA.WAEEECHB...hADA...,2,-16,-10,6
SFLJUVXBZMdcAHGTDIQegKOEYfWPRbNCa,GBDFTAFB.DAGEeFECKDAD...ECCF..fGGFRBAHCEHE.hAAASEFAFGGGLFAFhABAVFAABHCFZEDBMBBGhAAAAFCBIDED........hACA......hADA...,2,-24,-24,0
CgZRbTUVXWKLFEIQHMOPScGfBdNAeJDaY,JBFDDGHHCEDCZBBE..RACG.UGFA....XGCDKBHFFAAB.EFAHHEAFhACA..OFEAhAAASFHBGCADdHAHAFIBaBHBhABA....YDDFTGEELAFBhACAMADE....hAEA...,2,-28,-25,3
JSDRGAaBUfOdTYFPIWLMQeEHCVcZKbgNX,aFFBUGGG.dBGAFBCE....ICBEMDACEAFCHFAC.VDDGhAAAZBFGKHGA..bACFNABH.hAAA.SDGGhAIADAFCAHEABBACOHBE.PEDF....hBAA......hBBA...,2,-27,-25,2
JPaMdLQWRXZFObNIBUYcDCGKgeEAVTfSH,TFDHSCFC.HECCaCEDLBHDQFGCRAACFGGHOFBH.hAAAbAADNCCC.BHDA..hAAAUAEFDAFECCCBKDAFEDGEAHAF.hABAfACFMFFE.XAGA..hACA......hBAA...,2,-14,-10,4
TBDeNdaXgFSCAPMLRKUJHYEObQWVcfIGZ,LCHDUCCBHEFBEGDAQGCE..WCEBVAFH..IAHAhAAATAADeDBDhAAAaEAEFADBAFIFMBIH.KADChACAJGAG.bEFDfHEBBABGDCAEdDDE..hACA......hAFA...,2,-21,3,24
aABKcDCdLVJPSHbINfgQMeZEUXTRWFGYO,KEGDDAEDCEFHdACG.LEBA..PBCBHADA..IHEHhAAA..fFBDhAAAMDEEEHGEXAGDhABARAFDFHDEOFGDBDHAJBABbFACNCIG......eHAAhABA.....hAFA...,1,-19,-26,7
KGJBXIacVZSdDNMOFEACYPLeTfQgWHRUb,CFDGLGEA.eECBQAACHAFERDEFUBBBKBEGGGEBBACFaEAHhAAAZCAEDFAC.MFFGEHAAAIHEhABA..TCGD.hAEAfGABbCGH.IAHG.SEEChACA..hADA...,2,-31,-5,26
bFHKAfZeNCIMESQLJPgVUBTYOdDaWXGcR,ZFDFeAFBCBGH.EABGLHAE..PDAEVAAC.UFCDBAEAOHFAhAAADEEC...aBHDXDAEhAAAGADEcGAChADAFHGEAGFB....fFFBIFGD..hADA......hAEA...,2,-40,-7,33
QNIXAHYgfBESMCOVUcLWedGJKRDPFaZbT,HAAD..fGFCBDEBMCFACABHUCGHLDCBdGABKCEHREEADGBBFDBEhAAAaHDAZEAA..QGGGhAAAXADBACCEEAEGOHAChABA.....WFGB...hACA......hADA...,2,-24,-20,4
BfHWAYbGaITDJSULRgPMcNVZKFXCdQOEe,GAFETGBC.JEAAUDFALHDA..RAACMFIH..NEHEZADBhAAAXEDFdABF.EDACBAHEhBAAHAFAAHBG.aCCADFEESGGFhAAA........hABA......hADA...,2,-33,-16,17
QGcfWCbMaTBgADZKHSXFPVYILOEJdNeUR,ZEEEKEHBHGFASBBEFEEE....VACGIHCCLAAFEAEDdDGFhAAAeFABRDAD..QAGChABAfDDHCGGHMECChACABHEDAFCCDGIBXCGBOFAH.....hADA......hAFA...,1,-14,-16,2
BGJUKTeMdRVcWFfHYCPZENDIXQabgSLOA,JCBBUFCA.eDEEdEFDRFCB....VACGFBGAHACGCBBG.ZDDFDAAC.hAAAQFFCaCFF.hABASGBFAIFAKGGGMCADhACA..fAGDEGAB.NEIG....hADA......hAFA...,1,-20,-26,6
AgfeLZYFVEUGJQBIDHKPCSbMWadNcOXTR,eGEALFBBFHBCUBDHQDGC.DDEHKEEBCGHF.MCAD.dDHANBDG.hAAA..OEDHRBABAAHGZAFAhABAEFAABGAE.HFEBhACASAABaCEF........hACA......hADA...,2,-35,-12,23
EKDAaXOgCecBRMSQNdGZPVFJHYbTWUfIL,aGDDXDAC..OBHFCBAEBHEFRBACMGFE..QGAFhAAAGDBCZADHVEEG.FCDDhABA.JBGHYHFAhAAA.WAGFIHHHKFAD.AICAcACB.hABAdFBB.....hACA...,2,-22,-17,5
DgNcKPCIadeTfFBJUXLQMOSbAGZYEVWRH,GEDHZDAGEBCA.RGBGDCBF....NGDBKCFGIHGE..eBHBhAAATABBFEDEBCBG.hAAAXGBHMCDESEAAhABAAHHH.WDECcFAGCAGB.dHEFfAEBhADA...hABA...,1,-26,-32,6
NVGUTeBHFIKPDfQcgZYCMbLOAXJaSdERW,XGGDJEGH.dEBERECE....VBFATBBCBDBAFFEC.KHBGDIAChAAA..QAEBhAAA.ZAGBMBAAODHFhABASFBGNDDA.......hACA......hADA...,1,-18,-54,36
VDUcgTaEQJSfXeAHbOFYLPGCBRKNZIdMW,HFDFFDCDLCGFCFGDRDBD.ZCDFdBDH.MDEADBBHUGBE..TAADhAAAaEHF.EAGG.SDGAhACAeCADAHGE..bAFGhAAAYFAD..PABAKHFA...hADA......hAEA...,1,-18,-24,6
AEaHIUTedPOgcLQRXfVbZDNWSBKJGMCYF,EEHBaCFCHFBBUFDC.eBABdBDD...OGFCLAFBRAFC..fCCAhAAAZCADDGGDSBHHhAAABEDD.KHACMADGhABACABC.AFFA.IDDF......hADA......hAEA...,2,-32,-16,16
OPFBeTXKbHcdAEZfVDCWgaGLJYIRMUQSN,ECFCZGFGDCBA..CEEG.aGBGJBAA..RDEC.UGBD..QAEHhAAAOGEEBBECXDAAhABAKDBC....bEACdHCBhACA.AHAH...fAHEgEGA..hADA......hAEA...,2,-44,-29,15
fgTdRKDUAaMNGcWEJOLZHCXbQBFIeVPYS,aGFHGBGA.EDFBLAGFZEBCHGCACABDQEDCBGHEeADGVABHhAAASFAG.TGGEhAAAKFAFAAIHMBAF.NIEF.hABAcCAH.JAEF.OBHF...hAFA......hAGA...,2,-17,-2,15
TdIbaPOUSKLZWREMVDeJNfCFXAGgYcQBH,GAFE..gDCHQFACHFGDIBCAaGDC.ODAChAAAKEFCLEAFREGB.hABAEBFEDADENCAF.CFDFFFFHAABFBADChAAA...........hACA......hAHA...,2,-27,-21,6
AHMRJLeCdcagZNTGBQbDFfKVYWSPOIUEX,RFBGeAABdBEC...aGFAZDAAGECHQBAEFAEDKGCF..VEFB.hABA..SCHDhAAAPDEAICCFEAGHAEEBMIBEhABACGAF..NEIABHFGDFIH...YEAEhACA.....hACA...,2,-20,-13,7
gefMQBCYPbUSLXHKaVAWGTJNFEDRIdZcO,TAGHFDCDRFDEZBAB..OABD..eDHFQDDABBHHCGAB.PGFEhAAAUADB.LDABhABAKCGD.AEGGGGAFhADAEGHFDBAB.IAEC.......hAAA......hABA...,1,-6,-40,34
TcgXPdefQSOYMAICRZEBbJVLUFDGKaWHN,RDBHBCAH.JACCLDFD.DBAEKFDGaACFHFAF...TGFAhAAA..cAGHhAAAXCFEdEAGQGCHhABA..SBEAMIFAAHAGCGHFEEGAbBBDFEHDhABA.....hAEA...,1,-26,-32,6
OTMbecZRWFNYKaUPdGEfHSIADQCXVJgBL,DEFAXABH..JCCGBGGALHBGMDGFeHDGRFFG..FCABKAEBhAAAUBFGdCHAEEDGHEBAIHAHhABACFAD.ODBDhADA..TABA......hAAA......hABA...,2,-33,-22,11
KXCGMSTVbOEPHedfLJBRZFAgNaQUcYWDI,aHBGQCGC.UECF..cADHDCBGKAECGEEH.TAGFhAAAVFFCEGBBeBABLDAChAAABGHFFCCCAAIH.gEAGhABA.NIDHWDFEXGDG..hABA.MIEG...hACA...,1,-16,-19,3
OUSYKGcRBNEeHPCAZLQadTFgbWXDJMIfV,LBDGaFHB.dEBDFABG....gEDHXEAGDFDDMAEEhAAAVCDEUGFC.KEHH.hAAAGCABBGFEEGEDPAHDhABAACHEQGAA......hAEA......hAFA...,1,-15,-38,23
bSLRYBKTZMaQCAWFdVPDEHGfcJOIgUeNX,FAFBdCFCDDDBEDFG.HADEGEBE..JGAAOFECUFFE...NHDD.XDADhAAALABGBEHEhABATCAA..aHCEAIACPAHFhAAA..IBBGbCCF...hACA......hADA...,1,-15,-35,20
aXBNbgPLOCQWMJYdHKcUEZAfSTDGeIRFV,TGBCDCIHeAHF.FBAEaBFG..BFAB..gCFALDCBCGGChAAAQEDC.hABAJAAGHADAUDBCAHHGfEEHhACAIHEAXFGBNHAF.OADDhAAA.MAIB.KFADcCEBhADA.,1,1,-42,43
UFXGePLIEHCbdWTcVgNOABMKSRaZfQJDY,KAGESEHBZFFF.QAFEJFBD.UEDDXABCGABALCDAhAAAIFAFEDHFCHFCdBAChAAA...cBEChABANEAGBDAB...aHDAYHBGeCCD..hADA......hAEA...,2,-28,-18,10
UCMYRWIaQKTbNdBeOVZLcFAPEHfSJGXDg,ECFCHDAG.SGGGJAACGDGGDABE.UDGBCCDD.MBCERGBE.aDDFKDAAhADA...TECFhAEANGAFBAADOAFALHAChAEAACCB.fAFD......hAHA......hAIA...,2,-28,-20,8
aGDJBIceQAOCLHVdWFNKERfgMYZSPXbUT,OEGHCEFALBECHBEDdABGFAAC.KHDEEDHFRDCH...MHDGZDABSGAAhACA..PEADhAAA.UGGEaAFADIGAhADAIFDE........hADA.eDBEAICG.NAEBfCFAhBAA,2,-33,-20,13
BWKFgLUMHYIbfaZDOeGQPXCSTNEdRcJAV,BFDDKAFBLDFAHEEG..IGHBaECBOBBBeDEC.GBBEhAAAQGFHCEHB.SHBAhAAAEADGRFADACGEFBABMAHHhABAfAHEDFADXACENIDF.dFFB...hABA......hACA...,1,-10,-15,5
PbLFQeUfRNKTDZgJcMOVaGCIYEdSWBXAH,HAADLGEAFCFGeEECUAECREBEKECHZDEH..JGFEMAHF..OHAChAAAaBCH...CFAGEADAhACAdCACBAAB.ABDDQGBGhACAfCDEDFGA......hADA......hAGA...,2,-29,-22,7
NCcRGYOAfdFXWMLHEbUBIZgSPeKQaTVDJ,dAFBXGBCLEBGHDEHEGDABCBCZCEA.SHGEKFHF.aEGDVABGhAAA.DGGDJEDFCBGD.GADHhAAA.ACDEfCGHhABAMBAB.UEAD......hACA......hADA...,2,-32,-13,19
bKgGPWEQfDdRaVNSTMUeYZBCHLIcXAOJF,FAABKHBGGBBAEEFG.DHFERECD....aCGESEFFUADC.eAFChAAABCBCLBHHhABA.XFCAABHHJFHBPFFBhACAfFAA.dADENIAF.MDEC..hACACGBG......hAFA...,2,-32,-20,12
LBbAUfCIYgXPaGSeQdZDEHKNWVTFJMORc,CHHG..IFDG..gGBHXAAFaDACGFEH.eBGFhAAAQBFCdADBECCDHCABhABANICD..VFGDhADAFHDEMAIFcAGABEEGAFFEYBDH.SFAAhAEADCFB.KDHBhAFA...,1,-4,-21,17
BORPWegdFQaYEJGVLfcNASITMXUKHbDZC,TGBCXGAB.HBCGDEABZCDFBGGH.OAABRBADeBFE..FEGAaHGEhAAAJGCEGFEHLAFChABA..fADFhABAACBDIEAE.MICGbCFCCEHAgDEF.hACA......hADA...,2,-12,-12,0
WcDYXJCKFMdBQIUeTPNaZOHfELGgbRASV,SCFCVAAD.DFEFXGEE.KAHHdBCABDGDUFACeAEDhAAANAIC.ZGAAHDGF.ECAChAAALEFG.GDAFhACAgGGAAFAG.YAECCCGB..hABA......hACA...,2,-29,-14,15
bdJRANeELDgGTKXVZaSBWfIUMFCcOQHPY,EDCDLFCHDGFH.GAGAKAGFZFAABFGB...IBCGMEIHCFFB.hAAAQDDEHABE.hABAPADGbBED.RGEAeAAHhAAA...........hADA......hAEA...,2,-36,-13,23
OMYPdSVKfHEWNaXGAJcCLRbeQBFgUTIDZ,JAFBCAFBRFFB...eHCEQDCBBEGC.FBAFUDCE.DIAGOCGFhAAA.MCFFdBAHSFHBhAAAKHBAHEAF.EGGFNEIC.hABA...XADCAADC..cBGDhABA......hACA...,2,-45,-14,31
KORUAeQfBMWIEcFZLgDYTaSHVGPCNdXbJ,eDACBHHGMEACEAFDFAGALFCE.DDGFaHEEHBBAGFDF.CECDdACGhAAAJHBARAFAADED..QCGEhABAIHFE...hAAA.gEGH.SABChAEA......hAFA...,1,-20,-28,8
YRUJBHPaNbdAfIGEQDFeCVOWLZXKScgTM,GAFEDDFFCFBH.OEFBLBAEZFAHKABA..SBEC.hAAA.cEGDMBIFUGDGhAAABDAG.aEAGbCCFAFHCECCBhABAFAHF.....VGFAWHDAXBFAhACA......hADA...,1,-21,-27,6
IFKEedVBYNGXaAQCHfTMLSbWDZgORJUPc,QGDCHDBHMAEGLDGHSBFHDIACOACDRABAUFDB..PBABhAAAFBHF...KFFEhABAEBFFVEAENIEB.aDECCEEC.hAAAfHAB.WAGB....hACA......hAEA...,2,-20,-16,4
dMQJNHgFYOTIXPcSfRbLEDeVACaWKUGBZ,aEGDUGBCZFAEMHDA..QBADHDFDFAEAOCBA..IDEChAAAXAGDPAEGhABASDBBRDAELHBChACADIEGAEDECABAKGHBBDAGNAIA.......hADA......hBAA...,1,-16,-24,8
QSMJLUCEXNfcTOGdRFYWaVDHAPKeIZbBg,eCCHZAADBAHEQEDAMIFA.UAFE.EDGEXEEF..hAAAfFBETBGBOECHhADAdFHCRBABFADF..hAAAaAEBDGGHPGFC.bCDGSHBAhABACEHE......hACA...,1,-13,-18,5
AWZFTPUcgKXLGMYNIObQfHDRJdBaSCeVE,ZDAGTGBCUEEC.KGBCLFEG.GBBDMIFA...IAABhACAQBDAHBGBJAGDhAAAdEBFBCAD.CGHG.eAEAhADAAHDE.WFHHFABC........hAEA......hAFA...,2,-39,-13,26
VdDATUaPJGgcXbKIHMWOYCFSRQEZLBefN,TFCAaGFCGECC..XBGGKBFCHCFCOFFDFHAERCAAZAAEBCDAeFFEhAAAVBAG..AFAF.JHAChAAA.....cEAEhABAMAECCEECSADE.EEHFNIEB.DEEEhACA......hAGA...,2,-20,-4,16
QZYTbfNcADOJCRWKFMagUEIXVdeGHPBSL,DIBGOEGHRADH.KDDCFCHB..MCAGUFAF..EAEA..VFEFeCHDhAAAHAABSGCAhABALDDAQEADhACA............hADA......hAEA...,2,-36,-33,3
RXBSOYEZTHNcDAVCJQFdgMfGbeULWPKIa,VFEEJEBE..dBBHMFAC...GACBeHEALADBKHAERAGFBBAHhAAASFEF.hABAEAFETCCH.NEEHAGIHhACAFCGF.fHAB.WGFC.aCAHhAAA......hABA...,1,-21,-36,15
KFLVMNBbIfSDATYGOacPREWXdJUHgZQeC,TFGHOFEF..aCHHRDED..EDCDdBAB.UFBDZAFACADALAEA.hAAAMAAEBGAD.fBAEhABASDDGACCGGGCFhACA..cGGE.XCEAhAFAJCFA......hAGA...,1,-16,-34,18
fCLOgTePMVEIKWRNGDbUYHZBdAcQSJFaX,SGFCJEGH.FBFGaABH..CCHBLBBETBFG..eECBhAAAMIEEEDCEKEHB.RDDHDEAEhAAAbDAD.HFAC.dCADAAEGXFEDhACA.fAHE..hADA......hAGA...,1,-21,-32,11
NZBJOfLKSgIYQCMeabXDPTEHRdAVWcFGU,VAADFHBGUEDH.ZAFEBAFB.OCHHKBDB...SEFBhAAA..gABHhAAAQGDGCEADaGGHDAIFEEAAhACAdFHG.AIHAGADE.JHAEIHEGhABA.YCFG.hADA...,1,-23,-35,12
CXDcgQHGbOYEMeWZKTJRSPANBfadVLIFU,BFDGaAFBLDDCFDHDUGFGDHAE...QCAFGGABOAEFhAAAEFEE..MEHHZBAAKAGChABATEBHRCFF.ABCEdHDFCEED.hACAXAAB.cAGEHDAA....hADA......hAEA...,1,-19,-20,1
FPbKDJSGUfEMdaVHWRXIcCAQeLNgYBTOZ,QFCAeEEGLEAB..NDIC.BECDOEAGFGCDKCCG.DHEGGCCBhAAAUCGH.fHFHhABAdBCB.VABARAFEIAAFhACACAHAAAGD..YFEG.PHAChAEA.....hADA...,1,-2,-32,30
RaVYgSUNbQCdOfKPZAcEJWDTLMeFIHXBG,JCCHDAFBMGBE..eAABHABBBFBDRDFA..aHBCVFEA..SDABhAAAUCFE.QGGHhABACADDdHBDKCHBACAH.hADA..EAEE.........hAEA.WECG.FAGDIAHFhABA,2,-37,-31,6
DeZCBPAQKGLEFVITJSfNYWaORdbgMXHcU,KCBBLCDGEFEF.FEAE..VACEJABH...SBFH.hAAA.NHBDaAGFdGAGMBABhAAAHADEDIBCeEEEBEFBACHHIHHEhABATFGF..fFCF..hACA......hADA...,1,-26,-34,8
fcdSLTXFgNQWKbaREDZHGCUPABIOVYMJe,BAFBOFBBMFGD..eBCFdFCGLHBAFEDBQAFFKCBERDDCDBAHhAAAZGFGCCHD..AFIB.IFGGhAAA..JAHBfCAGhABASFHD.TDACNEAE..aDDAhACA.EGDF....hADA...,2,-33,-22,11
aeEVHONXSIYfQUDMcdJZFBLbWGRgKTACP,aEGDeDCHHAAEOGEA..SFBA.IDEBfGAChAAADAHFdAEBFDHBBCEFhABALFFFbBFFRABETDAHhAAAAAFACEAG.ECCA..........hACA......hADA...,1,-17,-25,8
HJYeDfSZMVCUAKFLNTQgIGcORbWdXBaPE,KEEDLCCHQDADGFCBRBCB.dBEEBGFAEBGFHCAF..eDHDhAAADDIB.SBFHhABAMHAECHHGACADFAAATGAH.gADBhACAIHFCOEEG....hADA......hAEA...,2,-20,-14,6
IUJCeSfNTMXbdPcOEADBZHGaQYWgVLKRF,DFCFZCDHGBFCQFDH....YDADgDFG.KCDDhAAAIHGEUGGBCBGEeHAGhABANACB...MDABhACAbFBBdBABOACEBFHBWBBD.....hAAA......hABA...,1,-15,-29,14
ETMQZHSCcfPeLVdXYNgFDROWBKaGIJbUA,TAEDMEIBHAAC.SFDDCEHG..fAAFLEFBVDABhAAAXCCE.NEFADBIFhAAAWHCG.BAHFaEAFIHDEhADAbADDAEED.EGGH.ZAGBeBHH..hABAgGAA.hADA...,2,-12,-11,1
WGMAdbfTKJcHIQOLNXgRPSDUYVCeZEaFB,dHBHTCBCJEGH..HCDEQGBALBBBXGGGRAGD.DAAEUADFhAAACGECZEFAFHEA.BFEAhABAMFAAAEID.KADB.IDHEhADAOEAH...gAGB.SDEEhAFA..hAIA...,1,-22,-23,1
VcKdYELaHWJXFfBbPINRgAZMeQDGSUOCT,eAABGACBUDAHOEFC.CDCG.TFAD.KFFBdAAELDDChABAaBHBHFDDJCHHFFAF.fGGDhACABHHH.ICFGhADA..........hAFA......hAGA...,2,-37,-22,15
GbWfUTMJYQgeAFHVIPLNCaBXcdSRKZEDO,HBCFVAAD.LEBH.aACGXEAGdFDAKFFCDEIFOEGF.GECAhAAA..WBFDhAAATGEEMAIDQADGhACAeAGFAHGEFBADIAHCCFACSHDAZCEDEGAH.hABAfDBF.hAFA...,2,-16,2,18
bXfaVeFUZTdCAKGROBNcEPMQJgIDYSWLH,KGFHGGDHBBFCEEGC.QCBAJDAC.DCFBSGDHLBEEXGAEhAAA.fABHhABAeABAUDGCTEDChAEACGAGACGGOFAA...NCAF....hAFA.MAIF...hAAA...,2,-50,3,53
UVXHTJYIdDCLRFAOBfNcSWZaPQeKEgMbG,OAFBBFDG....NECG.SAAFZAAF.QBCGhACAKBEDEEED.MFGBUAGBVDABhADAHGFATEDBJDHDdACEDDHFhAEA.CHCDFGAHAHDE.cGDHaFAD...eFHFhAGA......hAHA...,1,-11,-28,17
egNHKJOPBfQCbIMGYDcdVWFTZSRALUXaE,LDCHUFCAEAFC.eBCCHEGDKEEF..OEAHBDHGCHBAMDCAGDAAhAAADECGdACGFGGD..SGFFhABAABIFaBFE.JAHFfADFhAAA.bFEDICEC..hACA......hADA...,2,-29,-12,17
TfJMVASIEGgbaHOXeNCDBdcKLQRUZYPFW,SAFBGEAHaAACHFFAeGFC.DEDAdFCHLGBARBDBZBGB.FBDGTDAEhAAAMIDA..ABIHEDGCOABFhABA.CHHEBHACKAGDQCAFhABA........hACA......hADA...,2,-21,-8,13
NMDTVadEAUeRWLcZBOFGQXHPJgYSbKCfI,eADGRFDFLBHDBCAGOFEHQDAB.HGFGJFAF...gABDhAAASHGAKCFBIHCGhAAADAFH.TABFhABAdHAHAIFEWDDFZDGHFCDC.......hADA......hAEA...,2,-26,-14,12
DeSHfNYEGALVQgUaIFdOWJBZMCXcRTbPK,VAEGQCGC.aCAEFBBD.OCHFBHBDMFGF..CEACREDATDDBhAAAKDCA.DAFCeGEChAAAHFCD....YHAGhABAAEAEgABEIHHAdFHA....hACA......hADA...,2,-34,-13,21
PDcUSeIGKNaAHfXdCWYTOEQJbZVRgFMBL,XFDHCFED..TDGBEDCG..QCGFJCDAZBAF.gABChAAAFHBEBAFADAHDSFAHhABA.IGGFhAEANCAGAAAE.dBEGOFHD...RFFF.LFFChAFA..cEBDhACA.,1,-6,-45,39
OTSMAgcePKJZFfRaGDUWIVBYQdECLHNbX,eGEAJCCHZEECFACD.REBB.DIGE..UAEC..VCFGBEEG.dEGFEBAAhAAACCAB...LFABhABA.HADANIAH.XFCChACAOAHDSDDEAAGA...hADA......hAFA...,2,-37,-25,12
ZCOPIBQJLKcRaSbWeVHTEAXdfNgUMFYGD,dGFC..gAGEUBCEMEEHFGCAGEAACDFC..OFADBHHALAHDhAAARBDA.aBABhABAWGFAeAFFHAACTDFChACAAGGGXDAE.NIDDDFGE....hAAA......hABA...,1,-15,-22,7
DeFKERIHVbUOBLJAMfTYZdcCXgGPaQSWN,TFDBZDAGCDHBGDFG..QBEC.SCCChAAADCDAKGBAICBGHDFCVDAFhABAUAGCBACEABAG.fGGDhAEAdACF.XGAAaFEHNIBF..EHGA.hAFA......hAGA...,1,-15,-28,13
AfKFbIPYGgaDBMXNVLHQceZTOWERJSUCd,KAFBFHBG....IGECPFGF..GDDDDAGEBDBC.MDEGhAAAXACG.LHCEhAAAQEBDeBADOBAGhABA.REFGSGGDCAHHACEGfFAHgAEDhACA.NDAA..hABA...,2,-34,-27,7
MKIfgcVZCQWAeGYORdbEaSFTPJNLXUDBH,GECFOFBBdADCEDBCFABH..TCFB..JFADLDDFhAAADHDABHHEHAFCMIDCfEEEhABA.gGGFhACAVAEFCCHFAGGH.YBBF....hAFA......hAGA...,2,-35,-19,16
ZGRcIKbdMBNUeLYHJEgCXSfQFWTVOaDPA,GCBDRAADKHGE.MDHFUFACLFBCHFDE.JABECDFF....XAEDhAAAfAFC..hAAAFDCETGEDaDHBAEIB.cEEAhABA.dGCEBADFNAIEEHAAQAGAhACA......hAGA...,1,-1,-27,26
gVSaMPbNFfBLKRDcTUYAIHeJWCEXGQOdZ,HFDFeEEGCFHAECFC.GAACQCAHZEBD...SFADhAAAMAIBNADFFFGGBCGC.KGGDDEEAhAAAUGBEAHHE.IHEEhABA.JCCC.........hACA......hBAA...,1,-22,-25,3
gGRebWJaEfNBKIMLXHZOVdPTCSDUAcYQF,QCBCGEAHeBAFJFACEBDC.BGFHKHACLFGDHDEDOCHDdADDCGEBhAAASAGH.hABAAAGFFHDCbBDA..aEDGNABBIHHChAAA.MDBEZAGF.....hACA......hAEA...,2,-22,2,24
AcBOaJDeGbgUNXRQSELTWKHIdFfPMVYZC,BAFBaGDB.eEGBGCFAUABGRAGB..QCCALHBEKCFAdAACPHFAhACAMCIF..ZECCAFBBJADEhADADIGG....NAAA.hAEASFCF..EDDG...WFBGhAHA.IBEHhAIAfEHC.,2,-23,-21,2
DUBOXQFgAVcEIZHYGJTLWfNCbedSPKRMa,VDAGEHBGHBBF.GFDHJFDA.LAED..fDHGhAAANAAECCGDdAHAKDHBMFAH.aFHHhABADFCEBGBH.XADAhACA.FBBCAAGF.IBGA.YDDChADA....hAEA...,2,-32,-18,14
GMdVJHaUcYALSPEeOCRTBXWQbKIDFZgNf,SDCDeCCHCHDE.BHEAQDFGKFDBDGGD.FGABZBCH..fGHEhAAAMAIB.JAEGHBFBhAAA.aFAD..YBADhABAAFGAPCAHOBFE.....hABA......hACA...,2,-34,-25,9
AQUTSFBDgEKGIJXOdRVZcPYfNHLMCbaeW,TCCBSEHB.DAIHEFBGGBAA..JHBAOAEEVEGBZABChAAA..PGCG.hACAfCFENAGGLEEBhADACGGAaACGAEAEFAHFBHFG.KDED.IHAEhAAA.dCCA....hABA...,1,-13,-21,8
SEOXFeHaDfZWTLJcdgGUNAIQbCRMVKYPB,QCBCRDBHMBEH.KACBBGEB.EAABXGDFHAGBDIBGZFABLEAFhABAJAFA.dEFD..hACA......hADA.gGGFUDFHACGGCABFVGFESFDFhAEAFAEH......hAFA...,2,-21,-20,1
VTMKAOcJWXBHUfgQbdILECNRYFSGZaeDP,OEEGJGEABBABHAFE.UFADQBDAdAAFEDAA.REAC...SHDAhADAaCGB.DEDBTGBGhAAAMCIDAIAA.XBBAhAEAfEHA.IEEECHGHFFGC.eAHBhABA.KACE....hAFA...,1,-8,-34,26
VSJETKOCfNAZaGIQWHeFdPBXRDUMbYLgc,aBBDQAGHHDEGFHDAdHEFBEAADDEG..MBBCLAEB..VEEAhAAASBGBECCHKAEE.hABACGGHAGAEZDAH...IHHBhACAWCHHeAAHRFCF.bECC.....hADA......hAIA...,2,-18,-13,5
JaeCBQMLXVZNIRTfODKdFYSPWgUGbAHcE,HDAGJCCH.aDHHeACECHAE.BDHALFEDZFFD.RBDA.OGCEKBBEFGGE.hAAA.SCFAhABA..WAFE..hAAA............hABA......hACA...,1,-33,-49,16
egGYFNMEIXSdcTULABWRCJVZOQKfPDabH,RDBHCEFAZFECOHCA..KHDCDAFCHFABGBGAFDCF...EBCDSBDGhAAAdAAEUGFABEFC.hABA.VAGHQBEFhACAfABFaEAH.........hADA......hAEA...,1,-18,-30,12
eECbGMADJXFNVdIRgaZcYWHSPTQBfKOUL,DECDXAADFHAC.dGBFRDEEZAAC......WEEASHGAhABAQBDDBHDGfDADhAAAKAGFODADUGEHhACAeGDECAHAMEDE.AAEE.JEHBICHEaCCE.hACA......hADA...,2,-32,-18,14
ZUBCLHMdFgPefDQEJKcXYaGRbSTVNAOIW,OGEAZAADBAHELAECHEBBFEFHeBDD.QAABKBFD.XFBAhABAaHDEGACASHDAhADA.TBEChAIAAEACIGHGCCHAMCCF.......hAAA......hAEA...,1,-4,-39,35
gBQALSZCJUeIGOFPDWfMNXREKTHcdVbYa,LDCHCCAHUCEH.eDABGEGCOBHF.DACEMIDA.RFBAKBECHEFBhAAA.dBDF...bGAGhABAaGAHBEEGSBBEhAAAIHHGFEAE..fHDFEBHF..hAFA......hAGA...,1,-21,-25,4
QWXFeIMPJCLARHYOSGTVdacZBDKbNfEgU,RGFGHFDFOBAETCAG.dAFAaHAEBBHD.DGFEKBGC...fCDFhAAAgABEQFBDhABAXDDAIDGAhAAAMEFCCEAEAAGE..SADCVEBD.ZFDBNDIEEHFAhADA.FHAC...hACA...,2,-26,5,31
GORSJYAMDdTVEeHgKUXaIFNBCfbLZQWcP,dCBDEDAFHDDBUGDF.aDHDFBED.BHGG..fGHAZEEC.QBFHhAAA.WCBHhABAcEAC.GAAFhAAAOHBERAGF.YACAMEIDDADETGEC.hABAgGACKGAD.hAGA...,2,-27,5,32
RgSDCMeIcUYdOAWKbPQZFLBETGHNVJfXa,KHBGQCBCLDFGEGDBGACBHDEBVCGFJAAF....aFGBRFAFDADGhAAA.CHGF.eDDDIAGDhABA..cGDHhABAdBDFACAD...PAHB.....hACA.BEDCTFAC.hAIA...,2,-21,-10,11
AFNMJLDGSQOXVHRCYTIeWUdcfaZbEBgKP,FGFHJCHDLHCGGDBGOBBBHEDC..CAAG...TEGHeFAEdDCBhABA.aAGDEEDG.BHAChAAAKGAFAAEGDAFE..SGGChACAVADHIGDD.UBGAfADGhAGA.....hABA...,2,-20,-16,4
RAaXUWTZOYEVCbcfJILFgBeNDKPdGHSQM,aEHBXCGC.UCCDZFDEOACB.EAGAVEGD..bECCfFCEhAAA.IHAHhABAFEAFBAAENBBE.KBDBhADAGADF.SFEHMFIF.AHIB..hAEA......hAFA...,2,-32,-14,18
DILRBEOdFQCMUVXgNAScZJTeafGbHPWYK,SCFCZFDFeCBDGDGEHECC....PFADKGCFLACGhAAABFHHEDBCdCCDCHFE.MBGDUABDhAAAgAGBAHDE.hACAJFFF...........hAEA.fAEAhAGA...,2,-34,-11,23
CEPFBfdNMRWOcTQALDbIeGXSYgVJZKHaU,LFCHDACBeDEDGBGGXEGF..SAFHVBBF.JFACKAAEhADA.aBGGUGEF.CBDE.hAAAFGFHdBAGMBED.OEAFhAEA..........hAFA......hAGA...,1,-26,-33,7
POEdbLNQACFfKTUSYRIZVaMJgHcBGeXDW,FEGDTGBCUCBC..SACGRCFCZFBD.MDADHAEABCEFeEEBXDFBhAAADEAB.PFFHhABAOABA.EGHFbCCD.hAAALEHFAHAC.KBGG......hADA......hAEA...,2,-22,-17,5
ZJQeHFLRMDTCWNfSPEcUgBKVIaOGAYbXd,XCBCdDBDQEFCHEFERABCDCGE..CHGE...fGAGhAAASGAAEFDHUGDHKFBEIHEDhABAaCFGAIBEZEAE.FBCCMAAFhABA..NADB.........hACA......hAIA...,1,-12,-28,16
ePVXQRZfIcaSANYMUbdWGTDFHECKBgOLJ,MCCAdGFCGECGFADCHCAHEBGCBEAFLFAA.eGEAXGAGZEFA.hAAA..IEHHhAAAaAHFNIEF.UBAH.TBDGhABADDEBKHBA.OCFE......hABA......hACA...,1,-9,-21,12
FedMRGLgbEXPfQWaYIKBUSZTONDJCVHcA,FEEDMEGFRCEGLGAG..gBADEHGE.XEBHhAAAQBBCaBEDKGADBADESADDhABAOBABDAIFCDHA.hACAHDBCAAEBdHDF.bFGD.PAFA.fEEAhBCA...hAAA...,2,-26,-2,24
fYaDPVXIHBQMOWbecFGNLSEgTdCZJKARU,UFDHaHBG.DIGE..XGDDBBCE.ODACeBFCGCAALADGhAAAEHAGdDDE.JCFFAGGHRCFA.hABA.fAHAhACA.PFGD.IFAAMADEcCCChAAAFBBCNCIE......hABA.SEHF.,2,-27,-3,24
cVBWSIUYJfKNQEMaCDdOGgRbFTXLPeHAZ,ZGFGBFDDSHCEUBDH..JCGBKEAB.EDDECAGG...OBDAhAAARCBD.FDGCLBADhAAAHBAAAIAA....cECChABA..IHAAfFFFMEIH.DGGBhABA.gFAEhACAXAGF...,1,-13,-50,37
ERAOMNGFVJfCBZLbWQSYPIHgeKdXTDUac,MDEBFGAH..JCHFBEHHLAACQBAG.SBFAhAAA..IDDAhAEAeHAAdFADDFHHUGGDaDFHREBDADFH.hABA..OAFGNACFfDBFbGDE.WFFFhAHAYBBA...hAIA...,1,-26,-30,4
UdNSGgFPJTAOEIecQbRXZKDHfaLWVBCYM,EDCDeGEA.QAFBRAABKDGCHFFFLADFBAEG.CBHHMCABdGAGSGCHhAAAFFDC..JEBBhAAAADDEOBEEICBB.hACAXDEADDABfEEE....hADA......hAFA...,2,-26,-15,11
OTWJcCDgEZeLQMKAYPfFXVSIdUBGaRHNb,...fDCDVBCFSAAFdBHGBEAGREGDHAED...bCAHhACATAAG.WFBAhAAACGEHEAGE.....hACA.LFFAKGCFADIF.PHAAFEEB.IHEEhADA.aCEC..hAEA...,1,-10,-37,27
UDcSReEfbTJIOCHMBGQLZFgYNVKPAadWX,aAFBXGBC.DCACSDAF.RCFAEGGATCEB.JEEHCFFEMHAEhAAAQEBELCCHhABAZAFCFGGD.NDIEKAAEhADAACAAWBED..eCBA......hAEA......hAGA...,2,-28,-18,10
gOHQIXFAJdLaZYcfMGBCRWeKUVNPbTSDE,dGDBLDCHaEFA.ZAEE....fAACGCEEBGGCCFBAeFFGhAAAUABB.NIDB.TBCDhACASFABEAHBOCEEhADA.IAEAFCHFAIBA.cGACMAAF...hACA......hAEA...,1,-9,-28,19
YXcBQgLCSDdbRZaUVPGJKNAeFTEMOfIWH,FAADEBDH.MDAFOBFH....IHEAHFFFXDBDBGBFQBEDhAAACHACDABCRAGHaAACUEFAhACAGEDEJAHFABDC.eCCBhADAfGBB..cGBD..hAEA......hAFA...,2,-27,-9,18
BCRAaDVEIGfeHPOLZXYQUbMKJgNdcFTWS,DEFEVDAGEAEG..GFBBeBBGHDABLAAEZFDHQFGBhAAAMCBEKFFC.JAHFdHGB.TAGHhAEABGCGAGAD.aDEGIHEChAFA.ODDA......hAGA......hAIA...,2,-16,-15,1
bSJXWLCEHgPMVaUTYNfQcBOKdGIZADFRe,FEAERFDFeDAD..JADBLACHHEEF.MHFAaABH.UCFH..NDEB.hAAAQAAGBHGEdHBB.hACAZFBDAAGF.DFFG.SAGEhAEA..CAHH.......hADA......hAFA...,2,-42,-15,27
gWeZPSCMXTfcDHRaKGFdQbYLAJEUIBONV,EAADBHHG.ODDG..gBDCeBBDZFBCCAGBTGCH.DFAChABAaEFEGEEGdAAFQADChAFALAHFABGBICHFhAIA...NIBF.PDAC.SGAChACA.fHGBhADA,1,-13,-37,24
SVbWZOUXKFTcEaQdAMLeRPfHgCIYGJNBD,eAFERAADHDBDCDDH.GDDGBDHG.SDHD..VEADZADAXAGFhAAAFCABEHCC.QGGAhACAdGFAAIHAMBAAPEAHhAEA..fCCF...gEGGhAAA..hABA...,2,-37,4,41
JWXbFKMfRENUdAVSTHCgcZLDIYaQPOGeB,TCCBCFDDZAFALEBF..IDGHQBDGOAABGDEHhAAABHCGXABHFFBCKAGGfGHAhABAEHGC.hABANDFG.AFHCSFFD..cEGDhACADAGEaHCE.....hADA.JBDAMEAF,2,-30,-2,28
aEGAIPdfJcHbVXRNFBOWKYDLgUTeSMCZQ,dHBHJGEAHCAF..XBCCFDEABAFAKAFGLBHHUCFF.eACBhAAAMABEZEEA..QGGChAAAEGCG.IGEGhAFAPHAC...fEDD.cDBChAHA....hAIA...,2,-42,-20,22
aVTFZOKQMRNLbDXAJdEIWeBHPUGcgSfCY,JEGHdAFBEECH..eCCDHCDAUGCHGGEB.SCBDCAEA.hAAAaEFBTEADOBBAMBHBhABANCHG..DIDEIHAGhACABBFA..........hADA......hAEA...,2,-46,-11,35
IaJLPeKRgBQXcDdObASFUEMZYVfGHCWNT,FFAAEBDHZGBE..VEECGDEGHAEDCGGH...TGCAJCBFLFAAhAAAeBBBRACB.QBFFhABA.DFIDOAHHhAAAAADHMIEAfHGH..WAHBaGAH..hACA......hAEA...,1,-8,-19,11
CgUBSNKYPFHIbXZDeJcEadOfRQLVAGMWT,MEAECHHGBEHHKHAC..FHEEHDGD...XBCAZAAFJACA.aGFBdBHEhAFARAFE.LDDE.hAAAGECFWFCBUBAEhABA.SFAG..PHAAIHHFhACADCCG.....hAGA...,1,-10,-38,28
JLSYRVPZbUHNFadOBDeKTCWMGQIAgcXfE,XCBCJCCHLBEGRFDF.ZFACHACA.aAFDBHGG.DAIHKDFC.CECAMEAHhAAAQFGA.hABAAIEE.fHGHhACAEABA.SHBGPBABNEEB....FHAAdFFAhAEA......hAFA...,1,-15,-26,11
IVSHcUdFCOGaRDBZXKMQPJNELAfTgYWeb,TCBC..gFCAeEHD.VADASHAA.HDEBhAAAdDCFFAABCCGDaEBHDAIHXADHhABAMEIDQFFChACAJAHH.LHEGAACF.fDFHhADAWEDFIAFDOHAC.hADABAGBKGED,1,-18,-20,2
RQfHOGgXJZacNLSdDPYbAFCBWVTUEMKIe,CCEAVDBHUCGH..MEFBKAAB....REEFHCBDOEHHGACF.hAAA.XBCEaHGALGAEhAAAdAFADAIH.YHBAhABAACAFBHBC..EEHBIGDB.fACFhACA...hACA...,1,-22,-27,5
aHcDINdMECVZFAQYgLTROSUPKJGfbXBeW,QCBCLGEATDBDSAFA.UEDGJFABGACB.hAAAXEFFBGABaCHFDIEAhAAAdGGBEBABCABC.FGCDAAFG..hABA............hACA......hADA...,2,-39,-22,17
JLSKeaGURdWBcAfEMHZIYgTXDVbFQNCPO,EGFHZFBG....IDCBTEBBDBCD.FDEHCFGGODFELDADKCADhAAAaGDBGBCD.dAFHhABABHBCAFHG.fBEEhAAAHGDC...XACB.bFGFNIAF.hACAPAHF...hADA.eEAF.,2,-14,-12,2
eVFKUgRSOcBQCdIHbfGLNXETYPJZAMDaW,aCBDeFBB.FDHBUAEHRABG...OHDEBDEECGFDdFCGHBECGDEHLAFChAAAEGGG..TAAChAAAPCCBAAHF..DAIHKDADhABASACB..cGGFIFAAhAFANEEE......hCAA...,2,-23,-15,8
BCDeJgAdFEaSQYORXTHKPZbLfUcINWVGM,EDABSFAA.OABBTECH.KBACZAFCLHDCUCCB.IFGFhAAAVEGHBFDECHADJBDHhABAAFFDFHCA..aEGA.hAAAQBGG..XACF.hACA......hADA...,1,-26,-28,2
DRbaHYeFSCJdAUPIgTGVXEKLMNQZWfBcO,UCBC..IFFETCGB.XBAALFFAQAEDhAAAZABABFAADAFCbFCD.HFCHFDAHSFHDhABACHBGAEEH.hAAAPBHH.........hACA......hADA...,2,-32,-14,18
KMeIDBOVZfJSEGPgWQFRCdHcAUYaNXTbL,aGFCXCGCLACBKAAD...MDEDDEEBBFHHOFACZDAE..JFFChAAAEHAAGAEF.PDFAhABA....hAEA.WHAGRADGCFGFdAHEABBCNIEF.......hAFA......hAHA...,1,-16,-42,26
FMGDVTHIdbSAOXRNEfYeJgPCQaLBKUZWc,XAEGRDAGEGHH..eACFJAAE...CGCDQBFGaGEELDDCKEDHhAAAUFAGZADB.FDHHMIDEhABADFEGHFCEdFFAAEHE.fBCAhAAA.........hACA......hAGA...,1,-18,-21,3
VfWNHPTEJBLbgGUQRFDXaICYeAcMOZSdK,OCHDZFEEdCCCKGAH..VEFD....fAGCHACCTFAGhAAAJACC.BCACLDFChAAAbEDFUAFEFFCHaGHDCHHHAGDF.hABA.MCCF.NIBB.EEFC......hABA......hAFA...,1,-5,-33,28
PGQZTOEULSHCaIAMgJfRVBWDKcFdXNebY,JCHDRGFGBCBA.DDECFDDH.dGBF..eFCA....PFHDhAAAGDBFQDAEhABAOFADEACGLAFBSAGGhAAAaHCCMCBG.VFEBKABFNCHA..ZACA.hAEA......hAFA...,1,-8,-31,23
USObAMGQTfWXFZJYgRNHIVPKeaLcBdCDE,QFGCTCBC..XFAFJADGRBBDHEEF..VAEAeAGFaGEBhAAABAABCHCE.EDAHUGGGhABAbFCB.AHABMEDC.fABFhAEAFCHF.YDFC...hACA......hADA...,2,-14,-8,6
FRTcBHSXZEfVLPJCKWaDbOgeNIdYUQAMG,MEIBFCAHRGDEBBAEHFEDZFCF.EBEALDFE.CBFA.KABE.aDBBDFGGhAAAOAFA.eDDEhAAAdGAEQGGGhABAACGG.TECESGHDXCCEfBCFhAEA.....hACA...,1,-9,-36,27
TdSICOQaBgLVcUFNZRJADHYbMXGKfEWPe,HFDGMCCAKGDHEABEeCHB.dEBESDDD.OFFCBAEE.hAAALDADcDDENHAFJHFEhAAADIBGXCFH.hADAfABCTBDEQAGDaFBD..hAGA......hAIA...,1,-15,-23,8
VfCaBNbKPMEXGZYgRTAJcWeLdIUDSFQHO,JGEAeGEALEDFUGACDEDF..QABGHCFCOAACCADB.BEAFhAAAKCFDEHAE..ZEFARAFEAIEAhAAAdCABFFAAfBDHhACA.aEEHNDIA.MIEE......hADA......hAEA...,2,-25,-14,11
PSZTDLMOXBUVHKfFNJdgEReWQbIGAYacC,aHBGCFDGZAFALABC..XBBAUCECKDBCFCEHdGFG..EGFERCGDeEDBhAAA..QGAChAAAIAFCAHABcDADhABA...TCGHDGHD.BEHA..hACA......hADA...,1,-26,-35,9
FIAeaWPXNRDgSTYCUHZcLQBKVEdObJfGM,aDCDXCBC.RDEA.SACH.CAHHZBABLGFABGEAKEFGhAAAdHABJAGH.MAFHACGCeGAChABANAAE.DGHB...hABA.YECH..cAFBEEHFfBBBhACA...hACA...,2,-46,-16,30
WdSCZXbLOFKaEGJHMeNTfQPVABcDYIgRU,BAEDDACB...IBAEUDAFSFDC.CAGD.ZEEALHDAhAAAFBHDaHAGGGDBhAAAHDECMCIDTDBEQBDAhABAAHID..cAGBRFGBXFAD..hADA......hAEA...,2,-32,-17,15
FBTUNVIGEYOgbMQXJAPdKafSCcReLDZWH,dAFBKAFB.aAAASDGG.RAAC.LCDCZEBB...HDGDhADABFACNCCAVFDBIAHChAAAEEAB.OHFEMAIF.JEDDhABAAIGACEEBDDCA.FFGE.UADE.....hAEA......hBAA...,1,-19,-20,1
baVDNZdSQAGCPecULBOYgEFHRXWTfIJMK,GGDHCAFB.eEFCLFDGOCDFEBCEHAFARDAC...TAAGhAAAJCFAMICCKHAGVDAG.hAAADACENHED.SGGEhAFAABBH...........hABA......hACA...,1,2,-45,47
APCZILBSFJYKRcTNWXQEHOUbfaVeGDgdM,ZDBHLAFBBBEEFBABKAABREBB....TDDGXFGF.EDDDUEGBhAAA..aGEEeHDEhABADAHDMICAAGBFCAGG.JACC.hACA.....YAHBcCBBWBHHhAAA......hAIA...,2,-38,-32,6
CcRMZKWOeHALUYgPEfITBJSXbFNaGVdQD,LDACUCBC...PHDEIGGFBGADJCFH..SABHhAAAFGBBGACFQCFEhABACHFD.REAEKFFCODDDhAAAACEB.EAHB.fDHA...hADA......hAEA...,1,-29,-33,4
TNZKLOJfMQedRagXDPGBEHUWCVAIYcFbS,..IFDGFHBGTBDEKFBF.LFGD.OBAFfDCBhAAAMFAEdBGGaFHHDCFFGDDFhAAABGEHEFHFUABDCADCACCD.bAEEhACA..NGAB..........hAEA......hAFA...,2,-38,-6,32
LPWJBGNKMEDQZHadTYUcOVgCFReISAbfX,XCBCLGEAJAFCGEBD..KBAGDFGEHCEGdHGB.UDBFOBGDhAAACHCH.FACGREFA.eCCEAEEE.hAAA..fGAChABABADGMEABEGEC.aAGB.......hABA......hACA...,1,-7,-32,25
bHCDZLfYKJWESdRXBQAaOFecgMUGVIPNT,aEEDFGDBeDBB..MCAFUCDDGBDH.VGFAIAHD.hAAA.PDBCTGGGCHDADABChAEALAAEKAHHEHAG.hAEAdDGCBBFBAGBA.cFAH.gEFAhAFA.NCIE....hAFA...,1,-17,-18,1
GcXSNOQRUJIYHbZeBADWfVgPaLMEFKdCT,DACBVAAD..aFHFEHGAFECG..dFFCGEAA..XCFAhAAAOAEBUGEEIBFC.hAAAHDBEeAFEBADBAHHHfHCFhABALHBGKAGE.CFACSDHHhACA.....hADA...,2,-33,-6,27
eKdEGAPDfBHTOXUVcFSgIZLbNaYMCWQRJ,DACBHDBHODEDXAEA.UEGFFBGF.SGDG.ZDDFLDAEhAAAaGHH.CAFCREABeAHHhAAAEGGBAIBGPHAEBBAA.hABATABF..cGEH....hADA......hAEA...,2,-44,2,46
bgJdeQcIYWEVXMPROUaZFCSTLKGNAfDHB,HFDGBFDGJCBCdGBGQCBG..IEFEEGHHMBFBOHDEhAAAaADDFAGF..SAFChABAKHDAADEHDFAEgAAChAAAeBFC..YEAEWDHF.VFGFhACA......hADA...,1,-5,-46,41
BKdJPIXOEgYTURcVaLbNGHQDWZCfeMFSA,BEFAKEEDdAADJBAD....ICCHECFE..TDCGREBF..hAAAVADELGAEGDGChABADGHBCAGE.MDIBAIHA.OABGhAFAUGDFaDAD..NICF....WAFAhAGA......hAHA.fFEESDEE,2,-27,-18,9
VSTQKPLcCDFGBJWIUMbNfRZHdAeOEgaXY,EAABXGBC..SCDGKEDELCAECHHBDFCFBGHG.JABAIDHDhABAUDGB.MGEGhACA..bAFARAFBdHBHAEAC.hAAAeCCDaFAA..........hADA.YEFA.hAEA...,1,-24,-34,10
SHfKPgcZYCNFALDIEbVOeaWBUXdQGTRJM,LFCHDGHHEACG.OBBFeCFHBHBAdGFFGAEHRDCF..MCCGfDAGhAAAKEAD..PAAFhAAAgCGC.hAEAZEEECGFAAGIB...bFDH.aAHFWABC.XFAChAFA...hAFA...,1,-9,-28,19
XTRKQBEJYcVbPHWeCAdDMOIUSgfFNLGZa,MBHHODACUBCE..SAAFFFBCGGCBZADC.aGFB.RDFEBAHEhACAEAACJECA..VFAFhAEAHBED.CHHHAIAADFDC.ICDGhAFANAEB..XFGBKGHB...hAGA......hBBA...,1,-17,-23,6
fNWLJIaHBPSYQZeFDcKMXgEAObTGdRUVC,ODACTFGH.dABGRGCE.UGEG..VBACCHBH.....NECHLCFAhAAAaDHDBBHESFBGhAAAZADADFACMAEAECFAAIHG.hABA....fADA.IGHEhADA....hAFA.YEDG.,2,-36,-17,19
MBaScbUeTVQIfWgLZHCAXFGRDYOJNKPEd,FCBBREEBDGDFOFBA..KBGDdACFBCCH..SAFBUCAC.hAAATGFBQEGFhABA..IHDDhAAA.fAHELFADCHHEGDDBNBBBEECA.aEGEhABA......hAIA...,1,-31,-36,5
eSWEKONXCHPgdaJFfTBVZQcGYIAMLUbRD,MIFGLDACRCGB.eBGHEABD.OEED.CHAB.HEDE.PEBFhAAAaGGBFEBCTBEFBBAF.ZACFhAEA....QGCGhAAAcFGDIAHEAGAADAFA.....hABA......hACA...,1,-3,-34,31
IVNcPUJEKBYDdaCgXeRLMZfOAGbHFQTSW,GEDHHDAGFBAHQAGGSGAH..IBBAVFEA.NCAA.UAGDhAAAKFBB.DBFF.aHCACDCHXGDHhAAA.eBEHhABAMBBGfHGH.ADHA....hABA......hACA...,1,-9,-28,19
YPGREDAFcaZSMNCITUXBfdKbgJVWHQeOL,FAFBaCFCZEEBMDIF..CAHE.UDDCBFBD..KBAF..JBDDHDBH.hAAAQGDBLBAFGEGEhABAEHFCABDB.SHBGhACAIEGFfHBBgAFE..WCCDhADAeAHH....hAAA.PEAB.,1,-12,-26,14
gCZBfMHYaNbGQTAWEISFXedRUOKVDLcPJ,EHBGSAFBFDDB.dDABRFEDKCFBDHGC..LFFC..JFAACDHEBEAHhAAAMEHBHABF.hABAaDHFNHAHQACGhAEA.ADDC.IBECeFBAOHECcAGF.hAHA......hAIA...,2,-27,-26,1
gCFWOBPbLXDKYZQTcHRGUMfadENSIVJeA,FEGDOAFBBEDFLDGFKAGH.QAGCHBCGUGCGMBDHdABB.SBAChAAA.IHHBhABAeFAFAEFHCGEAPDADhACADAAB.ZFEF.........hAEA......hAFA...,2,-43,-8,35
MYTGJFdcHAaNECXWZegKQSBIDbPVLUROf,aAFBCFEDZBFA..eDCAKBBGBHGGDGDB..VBGHLECF.RDGB.MCAAhAAA.GDAEFGAHdDAAhAAAAGGBXFGB.hABA..WABESDFDPFEB....hACA......hADA...,1,-14,-42,28
JcBMKObXZeNADSfUTEPHVYGFaLQdgRWIC,DGHHUGBCEACGHGDE.GBBCFBHBLBFFQBEAdAACRCBACFFFBAAHhAAAKGCB.OEDGZEEE.AHHG.hACA.SAHBhADAPFAH...aFAB........hAEA......hAFA...,2,-30,-12,18
TaOQAdEIVJfDRCGeLBgNFXYSbcUWKZHPM,dAFBECFC.JACDRFGFGEAH.BFEAFFFC..SGDDUBBBKHEGZGAAhAAAHEBA..MEEGOHFAhAAAABGA.....hABA............hACA......hADA.IBEEDAEH,2,-46,-23,23
DNbXMRTcBQSHGCPaeWOfKgJZLAdVIEFUY,dCFCVDAGEHCA..UAAEDFBF....XCBHMDDERFEHBGCEHGFGCAEGhAAA..aFAHOBAHhABAKEGCZADEAEIDFCHB.bEECTBGAhADA...SEEF..hAEA......hAFA...,1,-20,-26,6
YBXMQATNIWGaRbdFZPLSOefDUJHgcCVEK,TCBC..IGAFaGDH.dFECFAECZFGBSHACOBFHDABEhAAAUGFEHBBCCFECECFCBEAHhAEA.XCGFMBAAAAAE.hACA.NCIC....WDEG.....hAFA......hAGA...,1,-19,-35,16
SeGaXRJZYUQEIKMgfdPFcTLVbWCDBAOHN,OFBBHDAGeHDGGGCFRBCEZGFAUAGC.EEDGKEGH.MADEdCDHFAECTAAChAAA..VDGHCGBBAHAD.hACASDAC.hAHAaABFXBFB.......hAAA......hADA...,2,-18,-11,7
KLEDGBCbZeXNTOFgSVacHPAdQIJUfMYWR,QGBCJDAC.UACGMBFHRFGF.LHEGEBAC.DAAFGCEGhAAABFFHCGCAZAFF..eBHHhABANAIAODDHFAGH..SCCEhACA.aEAH......hADA......hAEA...,1,-13,-40,27
aXdVESRYPAMcONJFKCbeWGZBLQTfgDHIU,OCHDFDCDCADG...eBDAZGDEBBBALDBB.TDECDAFCUDGAhAAAaGDA..dFAGEGBFSABGhAAA..RBEAAEEHhABAMADCJEAB.KGHH........hACA......hAHA.WHDA.,1,-12,-45,33
BIQFMGZLcNPKYAVgJeXWaTEHfSdODURbC,VFDFJEEG..eBAA..aDCDEBDHHAEHdHGBDDGAUGAH.RABBCGHAQGBGhAAAGBGE.ZEACLFFBhAAA..cCEBhABAKEABABAH...XAGF.fEHAhACA...hABA...,1,-11,-19,8
MKAeYcXIEfCObLdgRBTDQaGSHFZJPWUNV,eGEAXCBCEAGE..CGCB.LECC.REGFDIAGaEBAHBDCFBFEZFAEJCAAhAAAUAAF..MCHDhABAAHDB.IHHEOAEGdGEEhABAgEEFBCHA.......hADA......hAIA...,1,-17,-18,1
bFVGdCTJAYRQZUINKDfgMcXeaWSEBOPLH,QFDHUFDHKCHD.DFFCMEAF..eDFG.SCBDhAAABCADODBFLCCHHBCHFABBhAAAdGAHCABFAHGA.ZBFAIBFFhADAfADE.cGGE..WFAHhAEAEEAB......hAFA...,1,-8,-42,34
STDYJcFbPQNdEgHBfGMURWCZOXeAKVaIL,KEHBVDAGLFCC.DABEJGAE.FEGAQBFF.EEABHEEBhAAABBDAfAGFhABA.UACAWBCF.hAFACGAGOGFEAIDAIGHHSDDC.cGBDhAAANDDF....hAEA...,2,-42,-22,20
WCbXLdOZKcHNRaMPJYgAFUfSIVEQGDBTe,UGBCSHBGEFGEGBBCDCCABFGG..eBFGCFDFLFHHOEEFKDADhAAAHDDC.RGDGaAGGJDFAABBHhABA.FGGH..fDAEhAAA.IBAG.QCGFhABA.bDBB..hACA...,2,-23,-21,2
MLKQEdgAbBYFPTCJOeNfcGUDWZXIVRHSa,BFDGFHBGCEDC.eCFC.....fEBGUBBCDBEDZAFA..hAAAIBAAVEFGHFDDhABAaEFEMIBE.KGGAdEAEhACAACEBPAFEOCFC.NEAA......WDAEhAAA.SHDEhABA..,1,-20,-32,12
RbPgMcVaLWJIHOGQKDFUNCfXSYZAdETBe,EFAABFEERBBA.....gCCFMCAHVGFCLHAC.IBFBhAAAHDECOCHFhAAAQABFDBEEFFDGCHEFSHGAhACAABHGdHCD.TDFD.eFAA.hABA......hACA...,2,-18,-18,0
SBYGUIgMfVNaFHRTPbADXeJEOWQcCdKLZ,DECDXFCAeDFF..OHAGQDBF.CBBAKFGGSAFFhAAA.BEAAUAFAICDHhABAMICENAIA.FHFERADF.TBGBhACAADAFEDFCdFFCZABE........hAAA......hABA...,2,-26,-18,8
CGaUVDXcTKRAMQEbgISeOdPBZFNWfLJYH,QAGDEHBG..IEHCeDGBPCDFZEEDFGGE..fADFhAAAJAAGCECC.GCAAhABAVADC.DFGH.cFDEhACAKCGEAAGA.MFCHSEDHBCCF.NDCF...hAAA......hAIA...,1,-4,-31,27
ZISLCKDPBaOegMRbXAWdTJNQFcUfVGYEH,TGBCJDAC..FFHFUBEEGGABHCACZACFSEEDLAEEDGGFhAAAaAGA..eEHBRBFEAEGB.dEAGhAAA.QGFAhABA.cACCfBAB.EEEBKHDABDFChABA......hAIA...,1,8,-27,35
VBKfbaUEQOHLJPMeRDYZScAgNCWGTXFId,CFDGTAGHFCAB..dFHCBDDB.KACBaDCAEEGAHAGB.LAAEhAEAMFEBDAEAZFADAIAE...NEFC.hAFAGEBE.XGGBhAAAfAFA..bCAB.OFFH.hAIA......hBBA...,2,-27,-18,9
HfbSVUgMdcKONPAJGTQCDBXYZeIWFaLER,JDACTCBH..QGFACGDHBGHA.ZFAHeDABFGCA.LAFFhAAAHABCSAGFVEFFMBIHhABAKDFG.OEDCABBBDAHDIEDEhACAaAAH.EGBAfCHE.hADA......hAEA...,1,-16,-21,5
GVXNPSgBYQKLTFZeMbEadDRfHUJcIWACO,GACBXFDHSGABBAHD.QBACLBEBTCBChAAAeHDGMCGBEFADDHGCRDCGUFFBhAAAIABCAACECHCGOAHDhABAPFFG..KFCG........hAFA......hAGA...,1,1,-27,28
WSFfMJIBUNXadEQZcDTgPVHOARGKbYCeL,GBCHKHBGCCDA.eGDELDABSEFC.FHCAMBHBBEACXGDBhAAAdGBCQBAAhAAA.ZAGFDACG.PAFBhABA.OBBFAGGA.RGFE....WEFAhAGAfDDE..hABA...,1,-23,-29,6
HKVADcIMdRWZQEBbCaOJLfTPGgYeNXFSU,DACBMCCAREBBZGDEBAGC...CEDF.OAFELBAD..TBDChAAAGGCH...YEFGhAAAXDDA.FFAHUGGAhABAHEGDKEBB.AFABIBHC.WDDEhACAEBAF......hADA...,1,-22,-33,11
cNOQeZJRCWFMPDUKILYXBSGdbTgafVHEA,OGEAeADGRBAF.FAEDMAHD..DDGDKEECLEDFBFGGGECGdDBA.hAAA.TAGDaGAH..hABAfEHEEBBCAHHE.hACA.NIDF.JCDECEAF..PCHD...UGAFhADAIHHA.SDBHhAAA,2,-22,-21,1
DZRJfBdbYEHaGgPWUeAFOcIKVTSLNMCQX,OCCHKHBG..TDGFLEFC.CBHCDBDFJFCCdCEB..EHGEaGHBhAAAGFCB..PAEEhABAUBEGAADE.ICAAhAAASCBB.MEABQGAG.hACA.XDDA.hABAfACF.,1,-22,-30,8
GQTVYXbNWeBODPAHfEJcCLUKdRIMgZSFa,HDAGJCCHLBEGdBDDMAADZFACFGBF..QGEF..TGFDhABAXAAFNBIABHDAhACADHACAEFFEDGF..CDAFKFGChADAgFDC........hADA......hAEA...,1,-24,-34,10
cXZNGAfaPDJLbRQeWFVBdCgKSUMITOYHE,aHBGDEFHLCCC.QDGAFCDEdGEHKACGMBFEOCGH.EAAChAAAZEBD.AIEEJABG.eGDGhAAABFAE.CFEE..SAHDhAEAUGGE..IFAAYHFG.hABA......hAFA...,2,-37,-23,14
TJBDSQPCAXMIELYWKOGaHcbNgURZVFdef,MFFFLCCHKHGEGCBHaCGEHGCC.....NADF.RAFHFABG.eEBHhAAATEEEBAHBDCBFQEGEhAEAAABFIBFFEHCAhAFA............hBAA......hBDA...,1,-21,-30,9
BQGeUbaITJLPgCSWHNAcFDdVfXERMOYKZ,FHFGdEAE..VFGBXAAA.REDF.MIDCKDBGBAFBeBDDUCFH.hAAA.ICGETECDJAAEhAAALADF.PFBBhABACAHFSAFB.NBIEAGEGDAID.EDFB.hAEAYDHB..hAHA...,2,-32,-12,20
KPMAGSICUdgNEfaZJXeVQcBHFOYLWRTbD,SGAHUGGGdGAA.EEDEZCFA.eHCA..VAGBBEGBOEBFhAAALBBBTBBHKGCCAEEFCGEC.hABA...fAEAhACA.JDGFcAFF.FBDFWFDDDCAF.hAAAMEAD.IHHAhADA..,1,-5,-38,33
DRGcVJBEWTfFPQCbMUXIgSeZOHNaALYKd,KDCDDEFERGCEGEEH..VDAFBAAE.TBGCFFDA..CCGD.MAFChACAUGGH....XFCDhADASABFOBEDhAEAaCDE.ABCCdGBC.EBDFfBHE.hBAAPADGIHGE.hAAA...,1,-17,-45,28
WXQGCMLIYFBDZNcaEVdebJPSAHTgfUOKR,TFDHUCBCODGD..KAGGREED.QFAFCAFB.MFHFIHHGhAAABBBCDIDC.NEAH.hAAAaBDAECCEdAHE.eHBEhABAbDFA...SDAFAADFfBFG..hABA......hACA...,1,-25,-30,5
XQBAIMHWLPNTYOeUFbJEVScfDgaGCZRKd,MECGHFDFLCEE.TGGEOFHFUEBHJGBCSGFFhAAADAAFaHAGZAFA.dBECBDACACFC.hABA.ICCBPBBAeEEGhABA..........hACA......hADA...,2,-45,-7,38
NfEMRLTBGYWXeDQCKUFbAcSagIJdZPHVO,SAFBaHBG..IEAEdHEFHDCEOHDCfBAA.hAAAMCIBRDEHBADCGDAEhAAAYABFXFFAQGGAhACACFDHKCGBFCDAAEDCgAGHPABA.EDGGhAFAWHAADGAB....hAHA...,1,-6,-15,9
NFSdYIVKAeDCaWXJGUfHLgOBZMbTQRPcE,CGHDXGBCGECAUABELECG.BAHDMFEGQAAF.hAAARADAEGGHFAFCSBEDhAEA.IHEHhAHAKEGDAHEHaCGAfDBE.OBHDbCDCcDABhABA....hADA...,2,-24,-22,2
ESRDUcgONVbePYdZLGCHAJfMFXITBKaQW,MDEBXGBCBHACKDEC..aAGG..QBCBEBCB.SHFEhAAARBABDDAHUGGGOFBGhABAVCGB.eAHF.dEHEhACALECFCGEFAAEGFDAG.WABENICF.....hADA......hAGA...,2,-25,-16,9
QcZIPRfBCSGWVNaMdAUDTHbOKJXeEYLFg,DFEEHEFHODACXCCC.EECAFABF.QCFGZACCRFADBAHECAFG.SGCBhAAA..hABAWHCGNIEHMADE..hBAAdFHEAFEB.TCDC.KBHB...YGAEhAAA....hADA...,2,-42,-6,36
VFDREALgZPNcKYUfJaCTeHIBQSXbMWdGO,LFBBZAAD..PFCBNDAA..KBCEUGEB..JFEBCEBCHAFEhAAABHGCQDGHhAAASAEDMDCEdCEDOBBBhABADEEAADIB...........hADA......hAFA.cFGF.,2,-34,-26,8
PeHSKFAGdaZTBXNWEIcQJbDUVORLCgYMf,aDAFTADCBEGH....XGCAEECAQGGADFHHODCFCAGG.hAAAMFIBeCEBKHAAFGCAAABEdGFEhAAAZABG...ICFAhADA.JAFA........hAIA......hBAA...,2,-33,-27,6
RHOGUJASdafegKDZCEYNVLBcbTQFWMXPI,aDABeGEA.DBDDCBFC...EEDD..VEFABCFC..TGAHQFAEhAAAMICA.XBAAhABAPCEH.IDHBhACA.OAECJCCBAGCGfAAB.KACChAFANICB.LAGBFEEA.hADA...,1,-16,-25,9
QWaKJbNZRdTMCeDGIBXSUfOEcVHPYLgFA,aGFCJCCHZEEC..TECF..CHHBDBFABEAG.UBDCEGAAHGDAhAAALABD.FBGFAACGKEAAhABARGAEMAAF..eBCGhAEA...IDGAfFFD.cEGFhADA.....hAFA...,1,-23,-39,16
NdHaLSebVMWKfPEgYcCFORIBAGXZTDQJU,XCCFZFEEDCDEUEAAHCFG.LADC.eFBAMFDHKBAHEACC.hAAA.gGFEhABACCAF.OHBABEFDTAFHhAAA.JCHFNEIE.SHAE..hABA...WDDE.hACA...,1,-15,-38,23
FSbORLDZWBQeJGcPYfCKMVdENXgATIaHU,aGFCFDAFOEDBLACBZACHBDGB..eAFHJFBEGAAE..hAAAPFGDCAECKAGEMIEAhBAAdAAEECGA...NIAHAHAAIHCGhBCA.SEGGDFFF...hAEA......hAFA...,1,-26,-31,5
FMILaZdXCWUVYPANTBHgOcbDeQKfSRJEG,BHHGHFDFOBFCDGFCKAGD.SCDG.EACHGEBE.FEEGhAAAICAFaAEBZBACdDHEhABAXGAB.CDGGVFGHhAAAABBC.NAEF.TGDHcEBF.....hACA......hADA...,2,-37,-4,33
bWaHESZNBOITcgKfDeJVFUGRMdCALXYQP,LDACXCGC.QEAH..WACGHDFHZFEFBFHBOEHDhAAATBGC.KFDHfGBDhABADCCAeAAEFHGAhADARDCACEABAHAA...PAFA.aCCGSHAEhAEA....hAFA...,1,-17,-19,2
ZOTgFaHAIbUdQMWBLPJfVKRNYcCGSXDeE,UCBCQAEDBFDGLAAGJCCB.KAEBRFCB....NDBGCHGHXBGEhABA..DCAHeHDEhACAZFFGTAACFGHDAIAAdEEFhAEAMBIH..fFGCYEEE.SGBBhAGA...hAAA...,1,-25,-31,6
gZSINEUFeQbKVdcPaMRATLfGOBWYXJHDC,TDACGECFOHDE.BEAFXGCADAIF.ZEFHSCCAhAAAEBBAeFCCQCDChAAAKBFHdBBBaHAG.ABHCfHABhABA..JDHBCAFBIFHCNABF..hACA......hADA...,1,-14,-27,13
ZOXMIUeSYTHNQPVBGaACFKfJbcdREgLDW,CEFAFAFBKHGE..JDCDdCGB..RCAHLGFCZCCG..XGAChAAAMIDAUAAFeADC.SCAFhABAHBGB.QECAhACABHHGAADFfHAFEEHDDHDA.IEFEhABA.....hADA...,2,-31,-22,9
UDfQFTKGLYIBcMVPCJZRAdEWSeaNHObgX,dAFBEAFB.eEFCHDBGOACDXGGG.DABDFGGHKEGHGEDG.LCADhAAAIHDGMFCBhABACHAE.JCEAAHCBaBDC.bAGHhAAA.....fFEE..hACA......hADA...,1,-21,-25,4
RSVUPfGHgJMYAOFEXWNdIcBbeCaZKDQTL,OEGHEFAA..XDFHdAEDBBHA.CACCZECFDHEALACA.hAAARDCCSHBChAAAPFAFHCDGMDIBABAH.FDABNIEB.hABAIBAD..bBBCKFDA....hABA......hADA...,2,-25,-24,1
gBCeEPbMWAfcIaLTHNDVGQXYRJdUSOFZK,..IFDGaGDDLAEAHGDCDEAFGEDDQGGCRCAFUGAGFHGEZDBDBHBAhAAAECEH.MAHDABAD.hAAATACAXDGA.hABAdCCASBFH.OEDACGCA.bCAFhACA......hAEA...,2,-10,-6,4
fRMcdXPGeSEaHDVUZLYWFABCgJKbTNIOQ,CBBDKDCD...TEGFOFHHRFAB.dDCEGADGEGBE.HFEBDBDAUAGHhAAAZAAELAFC.WDFChAAAAHACBEFE.JDAB.hABA....bCEE.......hACA......hBGA...,2,-43,-11,32
AgdCMabIeOYJSBUFGZTPWRfDVNEXcQLHK,CFEDMHFG..aDFDeBCF.OBGDJAFEBDBGUDDEGADGZGBE..hAAATAEERFAADGIB.EDAB.hABA.QBBAhACAKFGAAGCA.dGGG..YABDFDHF..PHCEhADA.....hAAA...,1,-17,-27,10
SdBEYHbfcMRJUCNgAeIOTWFQVPZGKLDaX,eEEGODACFAAF..VGAGZACEKGDC.LAGFDDGB..XDDFhAAABEAEEHGGHAFC.hACAfACHMDIH.hADAUGGHCCDHAHCE.IEHE.WBAG..hABA......hACA...,2,-33,-27,6
dfAYWcNZKIMLagGCSHbEJDXTReQFOBVPU,......YFCAWFFGZDBF.KADAMAEG.LHDGhAAAGBEHSAAFhACAHBDDbCABJBGBDFAF...XFDHhADAeFHBFABEBHBB.PHFCfGBEhABAAEEGcBCCNAIA...hBAA...,1,-12,-26,14
ZEYRDVbBeQTgXKdcaJNCHWUOAfSFLPIGM,SAFBLCCHGFCBEECB.RAFCDIEGBBAC.QCGE.hAAAXCDFcDAGaCEBhABACFHBHEFB.OEABhAAAfCHCIHBEMFHDYFDBbGAC.eBCDhABAKADC.....hACA...,1,0,-22,22
bHfdBCXUIFWDRSGTYVgcOLMZJPAaQENKe,QFCEEAFBKBCC..HFEEBAHACCAEUDGBFBDCDFBDGEAB..hAAATFEC.VAAFhAAAgGADLDEAMABAhAGAZAFBAHHAaGHD.eHCGdDADWFADRCCA.SHGGhACA...hAHA...,2,-10,-6,4
OSUcCgRMQaIGKeFNPJBfALYTEbXDZdVHW,LDACEGFCDBBA.VAAAOEAH..SAHDCEHE.RFDHQGFHhAAAIGCGeFEFhAAAFGBDJEEAACAG..bCAEZAFHhADAdBEC.HBFD..cEAEMAIDKHAANDIEBBEChAEA.....hABA...,1,1,-23,24
MTJQGYAKeCHgPacLfIVZbRXOBSdEFNUDW,CDGFHAAD.aEFGLBBH.VGBAbGBGXEBABFHA.dFHAFADAhAAADCGAMFCCQCDBhAAAAGFAKAGC.eAFC.gGFDhACAfHFF.IDDD.OBABhABAEADANDAE...WBFAhACA..,2,-30,0,30
VaBNXFQJGAZKOcHWSfIegECPbRDTLMUdY,ZDEDOCCHHABA.SBHDeBCEEEFFCGAHRECFDAAD..LHEEhAAAdDAHaGHF.BDAE.NABFFAGEhAGAJFABAGGH..KDDE..hBAA.fGCE......hBBA......hBFA...,2,-30,-26,4
LXJUMDEdSIPBFAKabZONWcGQCHVRTegfY,KAFBaCFCZEEBOCDF......NADAGEAGQDGEHAAFRBAHTEBDhAAA.eHAEhABAfGGELFFFXEGEhAAAMACADAIFSAFCIGGGBGDHhAHAAIDG......hBAA...,2,-18,-18,0
ADHTFXcadIfCZJRMPBLNeSbKQGOYVEgWU,DEFAFDAF..aDCBdDCF.CAGEZCADRBGFBBBA.LABCeEHF..SFCEhAAAKGAFGGEHOHDEhABAEFGG..UEDFAAIBHACGhACAXGBD..ICHAfAFHhAAAPGBC....hADA...,2,-34,-13,21
UdCNWZbLfJFDMPYgHVBXOIcEAKGaQeTRS,aDAFQDCH.RABGdCGGNBBD.ZFDALECEFHAC.MGEE..hAAAgEADVGAEBBAGhABAOEHDIHHBAHDC.hAAAKAGA.eCCESADECHFFfDGADBAD.hABA......hAGA...,1,-14,-22,8
fQNBVGPdFLgEDIMbcZaOCKeWHYSTXARJU,JBDGUCGC.QBCBBBBEGGCBFCAHLFEDDGIF..MCIFhAAA.ZEAACGFEKFCDHCECTCEEhAAAAHBHREEE...fFAGhABANACD..dDBBIHHG.hABA......hAHA...,1,-21,-24,3
eadCIKEWgRXVQOJATHNGPUSBfZcDLbFYM,HEFHGAFESFDGBHEHZFEGDDAGFCBHeEABdEAD.KABHEDDA.RACA.XAGGhAAA.QADDhABAAIHE.TCGChADA.NICB.fAAC.LAHBhAAA.....hAFA...,1,-12,-28,16
CXgOdPcaFHBUDVEIbSNGJKRQYWAMTeZfL,MIFGeADGZBAFLDCBCEHD.OBGDdCFA..aGGFBBFE.VABChAAAECCC..SBHHhAAAJFEEQGACAHAA.fCEAhABA........hAEA......hAFA...,1,-27,-41,14
YeMJRLZCbONfWKIPASBXDFQdGaEUHTcgV,SFFBBEFAFABFdGGGEFACHADF..TABG..gBGBhAAAVFCFMEECLFBHhADACAECOAFDfDDGhAFA.IEHAAIGGDDAFaBHDUGDHeFHB..hAAA......hABA...,2,-21,-11,10
XLWNGBFdSHEeMAPKIVYRDQZOCUabgfJTc,KHBGVAADDDAB.ZDABCAEA...UGGG..aDFA.....fGEAhAAATEEAXCEChAAANFCF..BGBFhACA.SAHFeAHHAACBIHEBQCDAhADA.OEAGJDCBLBAAhABAFGGH,2,-36,-36,0
UdafJCRSgcHIEMPLFYbTVWXZKOQNDGBeA,dFHAJCCH.READ...SGHHHCFDMAAGLEFHFECC..bBDFTGABhAAA..XAGBhAEAKGDEOAEHDCIBeFFBhAFAABDFaAFCCCGB..IHEEPDAB....hBAA......hBBA...,1,-18,-28,10
IRVAJZNCdeMFaTXgYHDWbOGLcUSPBKfQE,JFBBCFDDdCAB..eCADFCFG...aFDC..XGAFHAFDDEFGOECAhAAALHFE.SABChAAAKAEFEGFA.RCBGAICEMDIBhABA...YHFGbEFA....hACA......hADA...,1,-15,-43,28
FVGLKTWaSDJRPUEBbcdOQXHCgeNZMAIYf,..IFDGfAFBFAAF.LAHH.KGFCaDECDCEGJDHHUBAChAAABHCDdDDH.OHCAhABAXBGECFBH..NEAAAIFAVACChACA.GGDF.SGBFEACEcDGChAEA......hBFA...,2,-25,-20,5
fYHECRKbTLIQSeGcPXUJWBNMAVdgZOaFD,VDAGdCFCOCAF.DHFAHGFE.CFECRBGFKHCELHAG.QAAFhABAeCCDGABFXADAhADAUGAGBFGH.hAEAMAFEAFID.aEECFGAA.fDDB.hAAA......hABA...,1,-4,-32,28
GMaOdCNPFgSbTQYIeVcDKLHZXBWEJUfAR,MIDAaEED.dEACCEDH.FACB..SBFH.QBCChAAAICFAeDCGDFACKHEAHGBAhAAAXCAFBAHFEFHBfGGFhABA.ACHEOGAANFBDgGFE.hACA......hADA...,1,-21,-34,13
AFceDBOaMfZVgPbXNEWGCIdYQHLJRKUTS,eCCHOFEDMBEDZBFA....VBAC..gCAH.hAAAXAFBEECGCGGFIGAChABAQFEE.LCHFhAAAKAFESEGGAAIBFHBEDBFHaEACfABFhABAPHBCNDDB....hAEA...,1,-20,-21,1
UaHJCgZAIBFPceENKQOfWRGTDMXLVYdSb,FEGDeGEAKACFQDEH.OBFCfFADRACGDIEG.LBAHhAAAVFAH.dDDDUAAEJGDACAHBhABAADDBBHHE..PAGBhADAEDGE..NAEF.WHDG.....hBAA......hBHA...,2,-29,-13,16
OQVaARJPdDcWTFeXIBLZEUNYGHCKSbgMf,RFDFdDCDDCGA..TFAFeABHBFCEEBBC..UDGCGBEGKADESGCHhAAAMIFE.QGGEhABAAAHCJDAF.PAFChACAFFHBIHBG..LFEF.hAAA......hABA...,2,-38,-7,31
NgZbFHJUSBKDEPLdIfOCXYeGQAMTaWcRV,TAGDaHBG..RCCC...VDBGZCFDFABDUFGEKHEADADALADAhAAA.dGHEfCHChAAA.CBDC.eEAFACBCMIEAhABA...WGACNAIGHFCGBABH.EGDH.hABA......hAEA...,2,-22,-18,4
LgaBXKZQSRETFVIHUYeDGfPAdNCbJcWMO,CFEDJGEA..MBFHOCAFLAHBBECFZCDCQAAB.SGBAhABATBGG.FCCGIAEHhAAAHFFFeCGDDFFGGGAFhABAABDCdFAD.NEIC.WEAE..XBBBhACA.....hADA...,1,-16,-23,7
JPXDRELaIAeBWSbFgNUdZMGQCKcYTOHfV,eAFBSEGDFGHBUEBEZAEBGAGC.CEBH.KBAE...TCDAhAAAfBBG.PGBChAAADIAGLBHDhABA.aGEAABABBDAH.WFFD.NDICMADDhABA......hACA...,2,-35,-28,7
HbUZLaVIPFcOEgBeTKGdYDQACSXJfWNRM,CFCFSGDD..fDEGRAACMDADHBEDUACBLFFBhAAA.aAHFIHBChAAAFDDDEGBBBHHATEGGKEHFYBAHhABAAGEH.WDADNCCE.ZBFA...PGDGhADA....hAFA...,2,-35,-4,31
ACUMbPHGINgeSYJTcROdZKWXBDVQLaFfE,MEECHAADGGCF.IEAFNEAE.eAHFSGBE.hAAAJFFFcCDBRBADZADCKBHFhAAAWGAC...XFFAhACA.DADG........hAGA......hAHA...,2,-41,-17,24
dOALPNbVIBQgfESMKGaDRCFXJZcTYUWHe,LGEA..bDEGVBDAQABF.EFFGMIAEKBGADCDChAAACEECXDGGZEBD..hAAAYHFGUFAAeBAHhABAAFHAIAFABAGFSACF...hACA.aGDA.FEAF..hAEA...,2,-22,-19,3
BNYAabUGTeVLXWgIcZfPdJCSFMQKHEDOR,UGBCGDDCeHDELADA.XFAEICFEZCAEdEEECDHASGHFhAAAMBCCKCCB.DABDBHHGhAAAAHAE.aFAH.TBAFhABAWCEE...fEABFGFF...hACA......hAEA...,2,-23,-23,0
FfZRYEKJcVHBXWgPaDSMAGUCQdbeONLIT,UGDHCFCFdCAB.eDDDLFGFFFFA.ZAGFRAEH.KBFH..JCHFHDDC.BFAChAAA..XABGhAAAPABE.aCAH.DIAGAFIB.hABA............hAEA......hAFA...,2,-37,-34,3
OCFGfDNSPVIaZWLXTdegRKJcHABUEQYMb,BFCFUFCAEDEBQCAA.MEADCCGGFAGEDEDC..SGEBhAAA..IDHChAAAaDBBZBCB....LACEhABATGFHdABFgGADKHCE...hAEA......hAFA...,2,-42,-26,16
YVMZIaAcSPRNUbgTeWJGFKDBLOfEQHCdX,SHBGRAADUGGE...TDDGeEFEJFBEKGFCBDCFLHCEEABHHADEhAAA.dFABXAEFhAAAMIFAaDGHADCF.PCHFhABA...........hACA.gAGChADAFGCE.DDDCfBGF,1,1,-39,40
bKSecGXafADFWYTOPHCLERZIJUMgdNVBQ,DGHHFHBG...TDCBOACDHEFHCBAF.EBGAZEDGUGBAdEHABCBD.hAAA.KCDEeEAAGBAEhABA..aAHFAAFDPFEBhACALBEH...ICGFMFIH...hADA.NEAE.....hAEA...,1,-9,-36,27
gEROLBSeHDAXfQCYNJKGdVZFIaTcMPUbW,XCGCCHHG..NCAC.JECEGBCE.ZCEDIAEG.aHCAhAAAMIBE.UEGA.hABA.bFFEEBHFRABFLDAHhADABABDSGDADIAAfAHCKGAA..hAGA......hAHA...,1,-25,-29,4
HERPWZOBgLFdQcfNGITaMSCbKVeUADYXJ,DAFBXDACHDCAEBBARFBF.ZFFEBACB.FBGAQAGG..hAAAfHDHIEGEaACAhABASDHFKGBFeFDHhAIAAFEH....PBAC.OFGB.hBAA......hBBA...,1,-17,-34,17
fXLBEMDPNZFKdUCcVeSTHJOWQbGAaYgIR,aHBG..IHHGRCCCLEHFBAHG.EDEHMBAADDHD.ZFEF.FBFGUDBDhAAA.CABF.eDAFTGEEhADAOAHD..bGAGhAEAAADAfEBA.NDGE.cBCA.hAAASAFD.hABA...,1,-20,-29,9
TcGObYfPHaLSQRDUEKVAXFeBZdNJCIMgW,XGGDBDGFdGGECAGD..MGDA..TDCB..OBEDhAAA.fAFBhABAaABDSBEFQCGChACARDADEHCEAIBEeEBHZEFE.JBCH.IEAH..hADA......hAEA...,1,-25,-36,11
LeSXMBdNZDYUVGCFbaWRfQAKJEIHOgPcT,KEEDEDCDHAABODAE....PEBBTDFC.LGCGXGDAhAAAMCBANAHGZEFFUAFBCFDHaAFFhACA..fGGEhAAAAGIBIADC..eABE......hAEA......hAGA...,2,-27,-7,20
GdbTOFAHgXfIJSCPVLReZUDNEBWcYQaKM,XFDHJGEA..SAGDCAHDLFAGZACADCFBBCCE...hAAA...YABAhADAaHGEKFADMCEBdGHE.OEAGhAAA.HDGF.fGDEICDA.hAEA.PCHF.eFFBhAFANAIEEHBG.,1,-24,-34,10
eNKCMJYGWcILVgTASOHaUDZRPbFEQdXBf,SDBDODCHUGFERBCE..FEFDQDGB.dEDABHFDeBCAhAAANCAAKDDFMDAH.JBFG.hAAA.....YCHBhABAWHAE.IGDB...gGAChACAAABCDDBB..hADA...,2,-47,-22,25
EgVDdaOUATfPYLKcFXHJeBRSQCNMGIZbW,TCBC..PFFBKCGFFHBEHCAF.BEGBQGGGCHHGGGAHhAAAIFEBZACBEFCGDBGAhABAaBEFAHAB...fACFhAAALAFD.........hACA......hAHA...,2,-32,-19,13
NeadbWCBUVTXDHYJFRcQMISfGLOZAPEgK,EHBGKHBGeAFEdFBB..CAEDBHHEUBED....XFBGHBBCFHECQAAHhAAASAGGLGFChACAABAC..gFEEhAAANDAGaDFE.WDHDDDBG...JCEEMEEFhADAIDAFOHFC.hABA...,2,-36,-8,28
GKYCgEJdbPfaAQSMWIVNUcOTDLBFXZReH,SBDHMCCA..IHBHUGEDTFAFBDEDZEAA.eFFBhAAAHCFGKABGCFFFEBBH.JAFAhAAAdEHG.fAHChABAAADH..WFCBNADFDHDA......hBAA......hBEA...,1,-24,-31,7
fVNBWdXFRZEgbYTAecCaJOKISMPQDHLGU,eAFBaEGD.KHGAMIFEDEAF.LCBDGCCEUFGB..NDCHBACBhAAAdABHFFEFRFCEZAEE.EFAB.hAAA...YAHBhACAACIHCEEH.OGACIHCC.SFHHhABA.....hAEA...,2,-27,-15,12
XGKDZSVCLQdHWEegJYOcBTMURPbAfNIaF,..IFDGFFAAKBEGDGDDZFGF...CDCH.LCACHFFE.ECGBJAAEOAHFhAAA.BAFGMDFAhAAAPCEDAFED.fHCHhABA.aDAE.......hAEA.SAHDhAFAQGAFeHEGcGED,1,-11,-46,35
WYIQBPgNHVADZdREOMbcfFaUGJSLeCTXK,ZEEEdEHAOHFAMBCH......bDADfCABFADF.UDDHhAAAGGBDSAGEhABACDEHKAFA.IBEGhACAPCFA.gGBANBAC.AGEADBGH.cFABhADAaGGH.....hAAA...,2,-26,-20,6
WTaMVDCgYSeKPGOEBIAFNLbXdfJHUcRQZ,LCCHdGFCJEFG.UGDFRFAB.ZAAF..aEDFDBEC.CACF...SCBEhAAAKGHBGCGABBAChABAAAFC.FCGE...XGCDhACAHEABQCEFTBEH.MAIFYAFChADA...ODBFhAEA.,1,-18,-35,17
HVfMDagYecBLNdJRKIASFXUTPGCbWQZEO,FFAATCCBGCEH.CBAD.QDADZFFE.EFFA.HAAEfAGBhAAAaGACeHEABCCCLDHHhAAANIEH.RFCDIEEChACAABDGXFCDPBFA......hADA......hAEA...,2,-33,7,40
GDTVEfIQBLCZJbAWUcHSOXYRNgMeKadPF,UCBCHDAGOAHHRBFH.MFADKHBGdGFFGEGGDGAH.EFCF..QADEhAAABCCECBAHZADFABAG.SEFFhAAA.XGDDhABANFBH..aBHF.FEHF...fHDBhABA..hACA...,2,-41,-4,37
cHeSTfEWBgAVRaJOPbQCYMLDKZdNIFXUG,RDDFJFFBOBGD..QDBBCBEG.MABGDFABZCAE.dFBEFGBBhAAAUFGBGADFHAAEeEEChAGA.SEHHhAHA.EBBBWACEADHAaAHD...YFDFhBAA.....hAAA...,2,-37,-4,33
NeaOPDVGgbCcdAfEYJZIQRSWKBFUXMHLT,EHBGJFBBZDCFRAFB..KBBBBACB..FEFHUAEBMABALFFF.hAAA.NDHC.eEHB.OAHDhAAAPECF.DFIB.hABAGBDECBBCAGGD.IFAE..SCEHhAFAXGEG...hAFA...,1,-30,-35,5
cSYeIfLGJDOdQUWNPVFbTZaXAKMHRBEgC,MFCFRFGHEBGC...CEGH.SGBDeBDHLFDHDFDC.dGHAQAAEhAAAUAAC..NBFE.PBEFhADA.FHDCTAGHhADAaEBFKCHBBDBC........hAEA.YFAFfADFhAGA..,2,-33,-16,17
egWFVJSYDCcdAbKTXGUPENOMaRfZBILHQ,TGBCGABHEECB.MIFEaACGZAAH.BFDALGFCHFFBQCFEhAFAgGBEVAGFhAAAJEBEDDIFCEGD.AAHB...XCABhABA.PCDE.NEAA.OCCAhAGAfEEA...hAIA...,2,-20,5,25
KYNDOMegTGSRVLBCEUdfbJQFaPHAIZXcW,XFDHKHBGDBBA..eEFEGDGG.SDDGLDDFECFCdGABJADHhAAAQGFGFEAG.hABAaAAHAIACIBHFhACAZAFA..cEAD.......hAEA......hAFA...,2,-28,-24,4
eOMLWREZfKIFTAGDUbgBCdQNSHVcXYPJa,UCCBBFDGdHCDQGEGHDDC..XBAFJBEA.OHFELEFAhAAARADGZAGBKFAD.IABChADAAFGADCABCGGC..SCCEhAAA..cEAA..aFADMDFEhAEA.fHBFhAFA..,2,-26,-25,1
LgMXPTGBNESHCFaJOQYebVIDZRdcfAKUW,UGBCLGEAMFCETBCFGAGA..BAFGSFGDHBAFFAHFOFAHhAAAeFCH..ICFFhAAADABDZBEBRCACdGAAAGED.KEFBhABAXACENIDB..CEBA......hACA......hADA...,2,-19,-7,12
WDfeZaELMSFJgOdNTBCcKPGXUYRQAIHbV,HAADVAAD.DFDHZCEAEDDCLGCC.FDCCgGEF.OBGHhAAAdADFNIBF.BGAFCGAC.hAAAPACG.XEGAhAGAUGGC..YEFAAFBCIHBH..hAHAbBFAfCCChAIA...,2,-27,-17,10
eTASXHPKDRJUgdYFZNELCGMIBcaQfOVbW,HBCFKHFGREEE.UDFCdFAHZCBGEFHFLBAH.MCFCIAAD.hAAABHCDaECCOHEEhABA.bFACeAHD.SGDChACADBFE.YBFH.FADBNADD.hACA......hAIA...,1,-9,-32,23
OZCKfWgLVeUEXYQDMcPFSaIJRTbdNGABH,BEFAHDBGCBBEKHGE....fADCLDBB.eBFEXBEChAAAQFECDHDEMBADFDGASCAFhAAAJHAA.hABARFACdGHAAGGAOAFEWHAG.gDGB.hABAEBBE.....hACA...,2,-30,-9,21
PXMfBITLgVDCQAJENZecFHUWbYdRSKOaG,EDCDZFDFeDCCHAFAUACG..bBGHREEHSAADOHAE.aDGEXABGhAAA.BADBhACAIFACTGFHLHAEhABADFBHAAFH.NDDB.cFGAFGGH...dAGB.hAFA......hAHA...,2,-11,-8,3
GDJYPARHLBbEWfVZcgKdMTIUNSeQCOXFa,RDBGHFEEBCGHECGC...VGBAZFEEKBAC.MDIFTBAG.IEAChAAASFBG.CAHA.hAAAXDCDGAEEJHAEhABAAAHAbADE....fACBcCDA..hAEA......hAGA...,2,-35,-5,30
NfMbPJdSOQeBTgAFDcVXCKWERUGaLZYIH,FHFGVFDGCDFE...EBBHUGBC.LADEZBEHHEAC.MAAC.JHFEhAEAdFEF.SDHBhAAAOCHDeHAGBDCEADEF.DABFhACAXAGFKBDB........hAFA......hBAA...,2,-44,-11,33
ZfKETJIedAgOYWUaCLDXGBFQcMbSVRNPH,OGEAUCBCCGEG.DBCHBDGE..FBGC.MECFSGCD.RFGH.hAAANBAA.ZBFG..KBDDJABAhAEAdDGF.AIHA....hAFA.gEEBaHACLEDD....hAAA......hABA...,2,-42,-39,3
HSXPZfWgBJVQIEbTCKaeMAOFcDdUYNLGR,FDCDDGHHUCGFLCGFGBCGHFCG...XACCZFBC..gAEHhAAABGHBQGAChAAAEHAG.CHHDaBAHAFIH.hABAOAEGdCAA..REEB.SDHBfHCBhACA......hADA...,1,-14,-23,9
IWJGaFKPeAEdDbVfRLXTBOYMQUHgcZNSC,DGGDVAADLADA.BAADOGEA.MEFEQCABHAEAZCDGhAAASCGHCHDG.hACAJFCBaEAEKEHHAADEEHACdDDH.hABA...fAHE.XFABhACAYHFGcGDE.hAGA.WEEG.,2,-22,-17,5
ZEfbVXSdRYTDNBgeCGFQMcaJLKWPOAUHI,HEFHZDAGEBCAVCCF.dAFFRFEDDFDFBBAA..CEFB.FGDA..QBGAhAAAaGBCKCGC.OFBFhABAAIFA.UGGEIDADhAAA...XABBSACCNDIE...hAEA......hAIA...,1,-24,-27,3
EVWaMOLcTCYgBFDIPJAXQZNbRGfSKHUde,QCCBZAADRDCC.SFHFKGHFHEFDUAFEeFDA.EHEG..VGAAhAAAMEAHOEBC.hAAATAEGCFBBBHBGIACEhABAADHAXACENIEBbAGB..dGDC....hADA......hAIA...,1,1,-18,19
RPVCOWXGUJSgIAZKEQMNafcDdTFLbeBHY,ZFEEEFAA.MACC..NGDD.aCBF..DABEFHCCLAFCBAHEHDECRBCFCEFF.hAAAOEBH.GBDBhAAASCHDAIHE.fHFBhAEAdDDC.TGBC...YBBDhBAAWBAF...hABA...,1,-22,-25,3
cKWNTBVCEJUHGaRSfIYbODXePgAQLdMZF,QGGDMEGFFCAH.KEBE..TABGBAACEGEBUGBEHADAGCDBhAAASCHD.fAHEhACAIAHBYEHFhABADIAEPGAE.ABBBZEDENIEFCAFC.RCCE...XDCChADA...hADA...,1,-9,-12,3
eUWHPOgcTaKMLACGYXNBfdIbZEDSVJFRQ,CECDXAGHBFDA.dEEDZBEB.DIGA..JADAFBCGQGDH.hAAAeCBFHEAB.OEHDhABATCEFKCAAAHHFNAAE..hABAICHASDCH......hACA......hAGA...,2,-47,-26,21
DJUOaHBAefbdFKLVMcgSIZNXRGTYCEPQW,eGEAdHBHKDEGLCHH.MCCCSDAEZCBCRGAGGBFCCEAB.EADGhAAAPBBA.DAIDOFAAhABAHAFDAGFFFAGAVEGFhAAAIFEF..XEDG...hACA......hAFA...,1,-4,-27,23
LcYJEfaSQPNgbKdGAUDWTOMFCZReHXBIV,UAFBDAFBOHFACHFG.ZEBARDFEHFDE.BBAALBAG.JAGFaGHHhAAA..SDGGhAAAQDBA..NAEGKFFEhABAAIBCMABE.FGABIHAE....hACA......hADA...,1,-27,-39,12
eIPLXFWSGBRJaYfNOAcgQDEVZMCdTKHUb,QCBCEEAEZAGB.CFGA.TEEBKEDA.UACFeCFDLEHDFAHDGFAHhAAARGCC....YAAFhABAfHDBADEADIGGhADAdDAC.IABFXGAB.BDCANDIE..hAFA......hAGA...,2,-15,-12,3
DLSIdbYfGWaHKXZBREAUFVPeQJcOgTNCM,VBCFeDACQAAB.OEDGTGGECADFLDGBIHAHdAAChACA..fAGEhABAaEGEXGEFBFCDACGGUEAFhADAJHAA...NBEFSFDFYFFF.hAFA......hAHA...,1,-12,-22,10
UYMgJNeTaQARCFKGBLdSOcXZDPbWEVIHf,FBBDKGACGCFCdADC.OCDBZCEGDEGH......bACCVFBFhAAA.HAEAfHDFhAAAMFHD.NABA..eCHBhADAaEHFAHAFCHHCBAHDLFEB.SCADhABAcFDB......hACA...,2,-25,-12,13
GUVSNcfeYDWHZJXAaCgROKdbQMTFBLEPI,CFEDRFDFKBEGdHAD...MHFABDBA.EHGEGBCE.UGBGSBBFhAAA..NCACeBHBhAAADGACZDFE.ADEDaEBEOFFAhABA..TADGLBBDIBHH.cGDChABA....hACA...,2,-43,-15,28
WDaBOIgcYTQMbUHLVFCKEfZdGXAJNSReP,SDCDRFDFeDAD.DBHHBHHE.OAAGIABE..gCCGhAEATGFH.QCGChAFAUBDCVFABFBCAKFEChAAAfGFAdDGDADAH.PHACaAFF...hADA......hAEA...,2,-26,-15,11
MdWVEgcPNCZSYfUOIBFeKQAbXGLRJHDTa,XFGHGGDHLCGFRCCH.DCBGMEEAdAADEAFH..PAGBhAAAZFAGSBEDUBAHOFBFhABABFECFBEFQDBBhABAAEAH..........hADA......hAEA...,2,-24,-20,4
TUORNPAgWQLcXdVbGCefEZaHIFMSJKYBD,QCBCLDACXAGAdCGBGEGG.CEDB.eGCAEAEA.aBFHFHAAMFEChAAAKHDABFDGDABFTEBGhACA...UGGFhADANCAAAABA...gACA....hAFA.cGACfBDEhAAA..,2,-25,-17,8
SfCGeATJBMVcORNgdYHIEDFWZaXKLQUbP,JGFABECD.MHFCOFDFRBFC..dBAAHABGDAGA.FCADZDGBKGCD.LAFBhAAAUACC..SEEDhAAACECAACCB...hABATGBENEEB..IAHH.aHFC.hABA......hAFA...,1,-27,-38,11
COGbTaVPLZcENeXJfWBKUFQRAIDYMSdHg,DACBMHFGHEBB.OAAFTCGG..VCDGLAAC.ZCEBNCIE.hAAAeFBB.JAEGBADAhADAKCBBQECAhAEAIEGBdAFBCBHE...........hAIA......hBBA...,2,-30,-20,10
RHOLVDcdXZbgAWBeaJGfUNPCKSIMYQFET,BAFBaGDBGCFAUCAA..CGEB.SECF.MACGQDEFhAAAFBDCEAAEHAGDOHDCDGHBhAGAXADD..hABA.gFBEeFBDNEIAKEDATGGG.LAHBhACA...hAIA...,2,-24,-8,16
eLFbQTINKOMYgcfVUDGWPBSECHAZaRXJd,aDAFXBDG.dACBeDFCLBGBQAGB.TFDDIGHAhAAAOFFDMBIFcFBBhAAAfHFB.DGAFhABAWDCCPFBGEACGAFABZDEB.FBBHNCBF....hAFA......hAGA...,1,-6,-14,8
OASUHcLgRBaGeFXMbQYICPZTdKfVJDNEW,HBCFLGEABBHEeABHXDFGMEAEQFAACAAB.TAFHhAAAKFGFfGCHhACA.DIEGWDFEAHHDSCEEhADAgDDBaHACbFCDPAEG...hABA......hADA.dFGBJEBB,2,-18,-12,6
GINJLKETPgVCdcbQMSZfXOWFBHaRYDAUe,UDACGECF.JHDEEAEF....TABGVFDAdCGFQBFGhAAAZBCF.OEAH.BDHChABAaGBCDIEAAIBG..IHHGhADAKAGECHHE.cCDBMABGXDFAhAAA......hBAA...,2,-30,-18,12
fPLNAUEISOKHbBTXFVDcGCZdRYgWQaeMJ,EGFCOCCHHEACBFEGFGABDCDG..GAGACBBDZFDB.dGBC.RAAF...hAAA.gGGAhACAaDGGeAEAMDAEJDFF.fACFhAAAPDAH..AEIDSGDG.hABA......hACA...,2,-26,-17,9
TdJcWODYFBCfXUMbSNeKEZAPILagVGQHR,LGEAaCFCGFBDHDCEdBDG.JACD..OADAFEABCHCG.UCAG.MIAEhAAASCGA.hABAeEFCEAHHAHAE.IEFChACAQFBD..TGGFDIGAfBAGhAAA....hABA...,2,-28,-14,14
ACHbZPLBcQFVWgONUKYXRdaTGfJIMSEeD,HDBHZAADLAECQAFCFBED.VACFOCCHUDFCKBHH..XGGAhAAAaGDA.GEDEhABAIGGHMCIH..EEHBhAAAAEAHPHAEBEEH..gGBD.hACANIEF......hAEA...,1,1,-22,23
DPXRacGFgCfKJIEZdOQUYMHWSbBALeNVT,LEEGeFBB.VGEGPFEG..aBGBFDAC.CFHA.KAEB.EDCBdDEBhAAA.OACFUAAFMIAAhABASHEAAADH..hABATEAFDAGH..cFCAfCHEIHHEhACA.YBHHhAEA...,1,-19,-35,16
QcIgOaKYBZDPfREdbULJXCNTVAHGeFSMW,HFBHeCDGFFGESACG.QAGAIGECOEBGKEFEZDAEfGDChAAAdFBHUAFDXGAChAAACHGB.NICD.TBAChABA.AFIDMDFG......hADA......hAEA...,1,-12,-27,15
HgAdJObPSfNcDMKXEFTZGYCILUaQWRVBe,JFFBOGEA..SABD..cDBDDDAEKDEHFEFAGAFAhAAACHDGLADE.QBAGhAAAREBGBEHBeHBGhACAAFIBdCGD..PACC.fHGFhAFANBEA.MAIF...hABA...,1,-20,-34,14
CPaDIHSRFKXNdZbLOQcUAYfgVGBTEeMWJ,...fHBHVACFBFAAeDADMFCGCBACDCFDHGDG.RCEG.KCCGdHAFLEHBhAAAOAEGQCAGhAAAAHAGGDFETECFhABA.EAGC...PHDESGGB.hACANEIA......hADA...,1,-11,-13,2
cSWeVCZNOEGaLPIdTXFBHAQbMgKfRJYUD,MFFFKHBGRBFA.UBADDCCD.....SEHBeAABCGGH.OCFFhAAAEFDB.aECCLFHBhABA.dADBTFADFEFBACAD.hACAQGGH.fBDE.hAGAJAEE.WAHHNBEE.PHBChABABDHC,1,-29,-33,4
ZKTSNUMPJOQcFLaAXgEVBRDfWICHbGYde,EGFCBEGHDEAA..IGGCHACGGGAH.dBGCeCEDKAACTCCFhADAUGAAMDDD.OHCAhAAAFEFGAEIH...XBBChABA.RCFCCDBA.bAFC.....SACEhAGANFAB..hAHA...,1,-19,-26,7
OGeJIASUYRBPMZVXfKTFgabdEDCWLcHNQ,UGBCBFDDMDCFZCFC....VBAHKBCGFAEE..aGGGEFHFCEAG.LHFAhAAAHEEA.QDEDhABA.eAGHhACAIECEAHEBSCHH...YEADhADAPABAfAGDhAAA.,2,-42,-19,23
LYQZbEcHdeBaTPgNJVOIARKWUMfSXGFCD,RDAGUGBCMAHF..SGHHFBBALGBCZCEE..EGEGdFHA.aGFBTAEDhAAA..PCDEhAAAJCAHOCCD.IBBGhABAAEFBKADC.fAHECBADDBIH.YEFAhACA....hADA...,1,-27,-30,3
cgROeJSMFBDEGaVZbIPCTHdALXfYUKWQN,LDACXCBCUFAFQCGG...NBBF.RGFAOABA.hAAAJDECMHFGDFGE.EFAG.hAAAaFFAVAEEZFCBIAHDhABACHAA.TCECAIEGfECB..hAHA......hAIA...,1,-11,-32,21
PYXRBKDMCTSWIcHaELUONFVQgJefGAdZb,dCFCZAAD....PFBGRCBEBHFF.MDHHCBHG...SAADhABA..cGEDhAAAEEAEOADENAGE.FGDFQCDHhADAeHAEAIHE........hAEA.YEHFKAGCDBIF.hACAWHAAIFFH,1,-21,-50,29
LRJCEZMUIFXgTPASaNGBKfOVedbQHWDYc,SAFBGEAHKAEHOHFAdDABHECF.DFECLBABCFHD.MACHhAAAFBEHTAADAEGFBDEAeBHFhABAQGEE..hAAAYFFGJEABEBHFIHBFXGBCaAGBNEEF.hACA......hADA...,2,-14,-14,0
MCAUBGHDQVdRgFeZYJLfIOPbXScKaTNWE,BDHHHEEBQFBGdGHCRBFB.FHDCeADDZBGDLBCBOFAA.XAFBhAAASBAFaCAC.hABATEEFEBEBAHHFDEAD.hAAA.gAGB.fCCEhABA.IAEF.hACA...,2,-23,-10,13
XLYdaNPbMHTASKICEFDWeRgJOGVBcfQZU,SAFBCFEDFAHH.DAAARFAA..OCBCBFHDQFEBZAFH.hAAAXDGALABEaHAChADA.....NDBEMFDFhAEAAFIFKHGCEDFD..WBBG.eDDC.hAIA......hBAA...,1,-21,-41,20
cKQCYBZOgIaSdLXbWUeGDPJVfNFMRAEHT,TCCBQGBC.BEEFZFDEOHFE.aADFSGDHhAAA.LEAEbAGHeAFHhAAADABEPCABVBDAFBBHhAEAAFBDEBBAcGFACEED.YAHDIEHC..hABA......hACA...,1,-14,-18,4
cJBGKDZRLYVFNOHAbCWeSTQMdaEIXPgfU,CFDGSDCD.MFHHdCBFEBGB.XEAF..PDEEhAAAUEFABAHDDGCCLEADhABAFACG.HABAABACbGAChAAA.......WEHHeBFAaDEBIHDGhADA...hABA...,2,-39,-23,16
CcIRFSJXHZOLPbdefaAKNGBMYVTDWgUQE,GEAHBBFDMCCH..VFEDDEHFUGADCBDCRBED..FAHD..XFEHhAAAOAAHLDHBhABA.dGAAfCAEhABAABBE.KDDH.YDFE.WBBEhACAEGCFIHHG.hADA...,1,-16,-51,35
RGUHVdEJQYXAOTIZfFBPNKaDbLcWSeCgM,ODACZEFHBDBEKGCDDGCCLHFE..SBGDCEHG.RABGUFAChAAAdGAEEEED.QBFChAAAAHED.fABAhABANAIE..cDDGeADB...MFFBhABA.....hAEA...,1,-32,-41,9
ZLXAKUSebBDEQCJfOMRFcHNdVaWTgIPGY,UFCEeCCHDDAACCDA...OGFEMBABFGGEHAAE.dBFB..aHDETGCGhAAA..IAHGhAAAPEECGEAEhACALBEBAAFA.KCBEBAHBEGADQCGF.hADA......hAEA...,2,-30,-14,16
PXUbeZMCGJRQcOEFYdWKNLADHTIgaBfVS,DEFATFDH..aACFBBHC..SDHHPBDG.UGGEeBAEhAAAMFDGCGADGCFGRAEHQGAHhAAA.OCBFhABAECAEFDDGdGDANAEBAFHDIDDB....hAEA.fAGBhAIA...,2,-26,-18,8
TNDHdQRXOEaMFLYSCZKGIeUBPJfAVbWgc,VAAD..gFDH..cDGFDBHFdFHC.RCBFOBFFhAAAaFDBLDAASADBhABACGFDKGAG..eBFC.hACABHHGfHEHAFFC.WAFE...hAAA......hACA...,2,-35,-26,9
LaKQJHcBEdeZbfWGMVXNSPIFUCDOgRATY,TDACaDCD..QGGHHEECEAGFZABF..fCDDhAAAMIDAVADFXBAG.hAAASEACPCHDFGHBhADACCGBDEFB.gGACAGADKGDE.cDGChABABDFC......hACA...,1,3,-30,33
REYZVNHPISDTGAbCXKLaUFfWOJMBdgecQ,XGGGKEEDUADD.FGCE..OHBEBFACdDEB....eFHBhAAARDBBEAEGZCBFHABGSCHBhABADCIHACADLFEBhAAA.fGAAMFGBcGAB....hACA.YDDC.hABA...,1,-22,-30,8
EKZfFITRDALNQcHVXWSBbaeGOJMdgPUYC,LDACQCBCVEEASACC.BFABaGAEGAGCMEEBdHFBhAAAUABDCFGGZGAEFEBCRADCDBADhABAAGAG.HCFAXGDGhAAA.....eAFF.....hAGA......hAHA...,1,-12,-14,2
FSZMgTeBYEHNDXUACRVdPaJcfWbKOLIQG,RCDHVDAGdAGB....aFGDJGAE......fAABhACAbADDKBAC.OEBDQGFHhAAAFHDAMGDAeEEGEBFBHAFChABADGIDABDBCEHE..cGDBLFAF...hACA......hADA...,2,-19,-18,1
aITLSXCeMRPGBDKFJcAdgQWfVbOUHYZEN,QGBCVAAD.UBCBZDBGEHGA..IHHETEGHSFDHhAAAeFEGMAAFGBFGhABABGCCKGAH.FAEDJEAC.hACAAIFEdAHGfCFF......hADA......hAEA...,1,-14,-25,11
FaTWIRfPAdHOGgZQNDKCMEBVeUJYSXbcL,dDBDHFBHGBFEQEGFDADGKBAAMECG.VABHJHBA...SAGDhAAA.XBEHhABAcGGFLEEBhAAAaHEA...IFCGfAHEAAHG.OEABhADANBIEEABEBGAC.hAEA...,2,-28,-11,17
EIgadXFcOZeHDWQCJVRMUGNPYbSLKTBAf,EHBGaHBG.dAEHFFDAZDEGHDAB..DFIDQACGCCAC.JDDARCBC.MEHHhAAAUFFH..PAHFhABASFAE.LAAEhAFABAGCfHDF.XGFDhAEAeAHB.....hAIA...,2,-31,-5,26
CSIVAKeYcPaXJdUOZfLBRgMGHbWQDFENT,eCCH..PGEAaGFHdDGGOHBAZBFABCBHRCBFGDEBHEAB.QBGFhAAADGGGEEDA.NACD.CHHH.hAAA..SFBGhABAAADCKABF.XBDE......hAHA......hAIA...,2,-26,-15,11
GQRfMeYbDAXdSNcZPOBFJKaWITgEVULHC,dFHASHBGZDDDBCBCKDFG..aEAD..TABHEAFD.UGGACGFFGGAFhAAAQAFE.hABAfEBFMBIDeABAhACADAIHAIAA.XEEC.PHDAFDFDIDCGhAGALAAD...hAHA...,2,-23,-10,13
bQNDJOFIKVZTdALGPgSEfcRCHaMXBYWUe,GECFSHBGEGBDRCBGCFEA.HBFG..aCGDBHHEUCAGeACC.QGEHhAAADBGEJFBGFHGAIBAChABAZAAA.AIAEgDGGhACAMBFB........hAGA......hAHA...,1,-3,-39,36
KHYBJZgdCRbONIAVSEXDFUfWeGPQLaTcM,VFEEEFAADIFG..UCAGeDGFGBGELBDF..TGBHMIBAKAFGhAAABCDBJABFdABDCBHA.OEBEhAAAAFDF..SFDHhACAfAFEQCEBaGAB.YFHHhADA....hAEA...,1,-15,-27,12
KUeCdfHJIVZQPbEXBgFWDOLARSGcaYTNM,SBBDaGAH..NGDH.UEAG.CGEEHCFAIDFEZEEAQACChAAAEFAGBDBE..FHFAhAAADHAAAEDDGAEH.hABATABFMICGdAFFfHCF...hAEA......hAIA...,1,-21,-25,4
UTMbKEadGPZcALRBgDONWeFYVIJfSCQXH,LFCABFDDOHAGeDDAFDDE..VBAA..ICGAJDHDCFAAHAEEhAAAMCID..EHDGdBBGhAAA.GADF.ZGFGhABAAGGHDHAENCAE..........hABA......hACA...,2,-26,-25,1
GJcNMCYTKBXeQHaPDZOVFgdbIRfWLAEUS,UFCESHAEGCBB..JEDHMAEE.CACG.TEAHKAAD.XEEFhAAAeBGBHFFE.aDAHhABADAED.OBBD.hADAFGHD.gCGGIBEGWHFAABBHEAGA.NAIEBHBDhBHAZAEB....hCBA...,2,-17,-11,6
gZPABHIRMJTFSQfEbdeNcYVDXaGLCUOKW,HDBHRFACMBAEFADB.SHBEEDCG.eFAF..NDHC..VBEChAAAaEFHCDDB.KFHH.ZAFABAEFhABAJABD.fFFEhACA.dDAEDHEA.XDGB...hADA......hAGA...,1,-17,-29,12
PVgSLFWIdCXZGRBYaAfMHbcKEeODQTJUN,MECGHAADKHAC.OEFDTFDF..UADCVAEDLEDD.hAAAFFHHdCAGCCGH.GBGAhABABAGHAFEB.....hACAfDBFEGAADBBCQGFANAIE.SHAAhADAIFBG..hAEA...,1,-20,-25,5
HBMVAUYDXaPQSJIZWcGOedCgETRfbFKNL,UAFBDAFB..XACGQFGC.SCDDJHDCZEACGCGChAAAOAAFdEEE.CBAGEAGETEAGhAAA.RFDG.FGBHNIBFHCEGhACAMDDGADCD...aGHDIADA..hAGA......hAIA...,2,-17,-16,1
RfaWACQDPSKOUIEFeXBZJVHgYGNTdMbLc,CEFAQAFBDCBA.SAADOGDAUAGBFEAGBFEC.ZDFAVCDChAAAHFGF..GDBChABANADEMIBGLHDAhACA..cFCCaEABAIHCIHAEXGAC.JEHBhADA......hAEA...,2,-23,-9,14
YVDObFNHSReGXJAZUcTPCEfWBaLMgIdKQ,UFDHTCBCEDDD.BBCDMFCH..dAHGQGEDDABG.FBFDSGGBhAAAeDGHGABFhAAAAAGFZBEFCBHD....aAGAhABAIFAGKEAH.OEHF....hAEA......hAFA...,2,-42,-10,32
QcEbCTWgMNXGdBfaHJFRIUOSLVPYAKZDe,ZFFADECDeEGHEACC..CHCH...TABGMHEEGCEBdBGCBBEEHBAFhAAARCDFOHCESFADhABALDAHPFBEAHHDKFEB.hACA.cAEE........hAFA......hAHA...,1,-13,-28,15
cDGUgEBaAdHeRKLCZJNYfFQMWXVbSPTIO,dDBDHDBGeDGFKAFCZAAF..JFCC..NBHG.FFAB.MIDG..XGEFhACASACHIFBEhADADHBCGAEF.hAEA.EGDBAABELFHFCGHF.....hAIA......hBAA...,1,-25,-34,9
QLTWbGfOdMcXDYBAJEgSeNKHFUZCaVPIR,EDCDeCCHKAGGFHBA.UACFCAED....VAAFRDFHQAFC.hAAA.LHEE.hAAATDGHWEEDfHGFhABAdFADMADFDIAAAHABJDAFSEEH..hACANBIE......hAFA...,2,-32,-20,12
cDfWAgSaebQOHPKNBTIVRCFUXZMJdGELY,SAFBeCCHOADGHDBAKFGE.BCCB.VFEFFHAEUFDF.MACHhAAAJDHBEDFDLBGFhABADBAHAIAG.aGGH..QFBFhAAANBBA.IBHE.CHHA...hABA......hACA...,2,-24,-22,2
XcVCBZRbQNdSYgKJUaFTOLeIAGEfWDMPH,EGAHDACBMDFDHEGF..VBFCCEBG..BHHDRDDEQBCBdAHC.SEAFhAAAKAFFJAAD.aABGhAEAFGAALFDB.hAAAAGFH.fHEFWFBH...XEGEhADA...cGCDhAEA..,1,-6,-46,40
YMdNJDcGOPIbeTRFWUgEBKfXLHQAZCaSV,aBBDSCFC.MAADdGFADFCC..OHFEIGABeCBBRBEAFGDFhAAAUFBB.BGEHKCHHLADDhABAHDDDAICACAGCNBBDJFHBhACA....PFFAWEBC...fCHAhABA...hAFA...,2,-33,-12,21
bCeHFPAIBUTNYMVLRWKJaOSEQdfXGcgDZ,UGGGTCBCMICE.LDBBKAGFOAED.EEFDQDDHhAAA.dADGfHAFhAAAGAFGDFGECGHDHEAEABAAIDHHhABAYHDE.WABCaHBG...SDGBhAHA...hACA...,2,-21,-13,8
QLPUDWXRgZNJMOBEKaGITfbYSCVdcAHeF,HDEDFAADLEFBUGGBDECDREBAZBDG..JAGBBBHHKACG...aDGF.hAAA.IFAF.hAAA.fDABhACASHDACAECdGAEADDB.........hABA.QCAFhACA.XDGDMEIF,2,-30,-28,2
NcSOAJDZCRXFGLBUdfVTeHYPEMgbIKaQW,DAADCEGHRACG.FDCABAGD..dFDC...TAFFHDDCEFCF.MFAHhAAA..IGGAhABAKCABQGGH.NBIE.hABASFAF.AEGGZCEHXGDALCHBhACAfCCCYBBEhADA...,2,-42,-23,19
HdeTcMZaSIKUPGWBfQNRbgAJOYEVDFXLC,JEEGEDCDFGAALAFA.HCBFTGDAZACH...aBECKABDGDGChAAABHGE.QABFhACARFCEAEIHOHCCDAEE.XDDBhAHACHAC...........hAAA......hAEA...,2,-31,-11,20
IBdJGFgQNaePLWbKESHCcDURMOVZTYfXA,dEGDGAEGFGCG.QAABeAGHLBBAKGFBEDCBHDBADAGC.UGGARCGDMICChABAOFAB..VEAFhADA...YEDBhAEAAIBAJHDG..........hBDA......hBEA...,2,-23,-10,13
FVIcBWXDOSPedAbHMNTEGKaQgRCULYfZJ,HFACTFDBKBCA.QGGGCAAFLDAHZBEBFACF....VGDChAAABFHHDDAASGCDhAEAdAHAABAHMDIFECEF.gGGGhAFA.YAHDfEFF..hABAIECAWEAE.OAFFhBBA.,1,-14,-32,18
TUMIFRbKJVHaAYQcOgLePZNSCWdfGBEXD,QCBCOGEALCBCZFFECHBH.dAGEBFBGEDEC.DEDEUGBE.MFAHhAAAFDGARACA..KAEB.JDHFhABAaAGF.ACFD....hACA.gDBANDAA.fACHhAIA......hBAA...,2,-39,-20,19
QfMOVRKGJSIaCeAZgFDUbXcLYBHPENWdT,ZDAGFHFGDEAGUEEC....XEDCLFHBHBCEEAGGdFBC.QBDFhAAAOAFCKAABSGDDhABACDHHAHCA..hACAbFADBHGC..NCGG.TCGGMACE...hAAA......hAHA...,1,-17,-32,15
fBEMHaTVZINJgAcGdOXSUDLCbYWFRPKeQ,dGAHXAADUBDEDAEALAEE..CGDB...bEGBFFGH.KAAFfDDBhAAA.MHCChACA.aDADZCBFNIDHACFC.hABA....OCFESDHBYDCFhADAWHAA.RDEA..eDABhACABFFC..,2,-47,-1,46
JAfgZKCYDEHSbaBeLQNMcdUWXFOGIVRPT,ZAADCFEDDECHHEDB.aDHHeAHDLEAG.MDCAdABEXGAHhAAA.FFHFIHHGhAAA.VACETGFGfHABhAFAKDFHSDABBCGFNAIA.WACHRFFHAAGC.EAFFhAEA......hAFA...,1,6,-36,42
WKIVdZCRFMeSEGTaQUAOPgDLNBXHJfbcY,OGEADACBLEBCBAGCHAAB..fCHC..YDCEhAAAIBGEZEBGCFHHRCDEhAAAeHEGGFBDTCGHhACAUFFAABIHNEAEXAEF.JHAAcADCKBAB.hABAdHBD.....hADA.MIEE.,2,-5,-1,4
XHWTEGISdAOKFMgaNPDcRefBCQUYbZJLV,OEGHMIAG..aBFHDAGC.RCCHBHBCCEGC..UDAHZBFCLAAFhACAHBBCEEHFGEDEdEAAKEEDFBBFhADAPAHF.fGABhAAA.YABEJHDA...XGGEhAFA...hAEA...,2,-31,0,31
WRaQEFHdPOXVgDTSYfBcUAZINMKJeLCGb,ZAADMCCAKBEALDEGGDDCRGFAEAHB..dFAHXFABDBHD.SABFhAAABHAEUDGFIDAGhADA..NAEF.CFFAWHFChAEAFCCD..........hAFA......hAGA.PFDB.,2,-32,-15,17
MfOGadZHJLIbXTBUVAcWSYeRPQECgNKFD,SHBGeFBBQCBDCFBA.KGFDDFEAMFEAGADBZDFA.HBACLADAhAAAICHG.TFGGhAAABBAGABBE.WCFEhABA............hACA......hAEA...,2,-30,-27,3
CUeZPgSRJKYFcOGHaVMBTEfbXLWQAdNID,dHBHDACBeEBBZDCF..SCHHRDEAKFGE.FABHOEDHHCEAaHFABAAFhADA...ECDEfFABhAAALAEEACIFNADD.UGGBhAIA..JFFE...cAGDMIBE..hACA......hBAA...,1,-23,-24,1
cDEOPALGTfJeQZNbXBRdUCMaFWVYgIHSK,LDACTAGH.JDFHeACGZBBA...NDIC.BGAC.UGCHCCDHMFEDhAAAFAFG.....WEAEhABA..gFGHhAAAIFAHKGFGDACCOBHDACCHfEEB.hABAXGAAaBFE..hAEA...,1,-28,-37,9
EPNCZQdSKRTJYVcbHBXOFLIeUDagWAMGf,GBGAEHBG.CHHGdDAGSGEH.TCDEVBBGHGCE.BAGFhAAAXCGDFFEAeFAAhABADBGHaFAAAIFE.MBBAfCEAhACAZEFAKAHHJBAF.cGGA...hADA......hAEA...,2,-18,-11,7
TZPfQgbdXSGDRaKeCFOcBILWMHVAEJYUN,JCCHUCBCZEECQFGC.dAAFGFAHDDGG.aBDEKEEEFBABBFAHhADA.LGCEMBHFADIBEGEAhAAA..TAFEhAEA..fGHAXBDHSHAGhAFA.CEHB.OBFDhABA.IEAC.,2,-23,-16,7
VeYFRBIEMDQKHUGTPbALcZWNaJCfXOdSg,LFBBZAADaDCA.CAAF.OGEAdAEB..SGFCeBHBFDFHBGBGhAAAEACH.DDHHHDEE.TBGFhACAAEBF...NIEBXDCBhAHAYAFHMIFGKGDD.....hAIA......hBBA...,1,-18,-34,16
eVCYSOLbHZEdIFfgDKXRAaUBWNJcTPGQM,aFFBBHHG.JBGF..TEABGFDH..QDGBMCDH.CHGESABChAAAOBBDLAEFhAAAbBDDHGBEEHBCFDAHhABADGIBKBCHAFIH.UAGCWAHB......hACA......hADA...,1,-3,-32,29
QILDNATcafRFXSWPZbYdHCVeKJOUBEGMg,aGFCRDAGFGAA....XAFESDHBZBAAdDADCHGE.KFDEUEEDGGABhAAA..MAAFIDGHhABADEHDADFE..TBBEhABAcBDA..fAHG.bFCD.hACA......hADA...,1,-29,-31,2
OeDFYbTPRUgZNSBQafVWELJMKCHIGcAdX,dGDDXFCADBFAFDAA....TBAARDDFZCFCBGHEQBGD.hAAAaHDE..VABEWABEhAAALFAFMBFBHDBAhAFA.IHHDAIFA.OHAG.eFFChAGA......hAHA...,2,-41,-7,34
DcTBaUdSNHKWOQMVeELIZfAgXGYPFJRCb,XFGHGAFEFFBBRDAA.DIACBHBD..aDHHSAGDHEDG.KEEGhAAAQCBD.hABAMACCEAHBZFCFAAACgGGChAHAJCCACADH..cGEC....hACA......hADA...,2,-30,-18,12
RfIGNTSWEbLUdXHPYeAgcDMZaFJQCBKOV,DACBaAAB.FCEE..CDGCKEBGRFAAGEED..SBBD.EAFGhACAUDBFHADFPAHBhAAAeHAGAIFGMIAA.JADAODHDhADA.IGCANBAE.WEFDdGHC..hAHA......hAIA...,1,-21,-29,8
WGQSdEJAMFIHBNKVDYeTPCXZgfabcLOUR,MHFGFCFCHAAFKEBA.DIGA..eFEGCBGBZEBBaBGCLEGH.RCDB.GGABhAAA.dCDAAHADBGFFhAAA...NCIA.VBAFhABA....PDABXDGF..hACA......hADA...,2,-27,-27,0
RYNAFWCXQHEMaBUcPTJODGVgKbZefLSId,CFEDQCCBHBFA.MGFCaHBCBADG.UGGGPAGH.TFAFhAAADFAEGBAH.KDDGhAAAZDFCLGACdBAGNEECAIAA.hABA...FHFCEHECOBCG....hACA......hADA...,2,-23,-12,11
bOcSNJDQURIgYTeLXVGCBAFEfHaKZdPMW,FAFBECFCHBBCZDEHdHADMFID..OAGD..NEAEQFBChAAAUAABRDBH.IEFGhABA..gEGGhABAYFGBeADELDAD.XGDGCHDCAACBKEDB.hAGA......hAHA...,2,-22,-6,16
TeEUHfBMdCRDbScgOWNQFPKJIZAGXYaLV,XAGHLCCHVGDA..EGDCUAGGHBAABCEDCDEGDDID.SEBGhAAAOAAC.QGFHhABAKDAH.JADEAAFFYEEGhAAAeCEGMIACdGBE.....cGGEhACA....hADA...,1,-7,-34,27
SVLGPWATQEeUIOKgNJHCZYbacDFBMXRfd,TFCAQGGD.EDAFeAAF.ODBCKEGDJADCCGGGZEFG.aGAHFBABhAAA.MCDBRAFF.SGCAhABALCBC...hAAAWCFCAAECICHF..NEFE....hACA......hADA...,1,-19,-26,7
SLPXRHbNIOEQUGgdWVFKZBTecMCJaDYfA,LCCHREFHHFAB..IAACEFFGQAFBGBDBdFEGFGAEKABDBCBAhACAeCEGCHHA.DHFAAEDDSEAFhADAXCACNCIG..hAEA............hAFA......hAGA...,1,-20,-25,5
AJFRbfSLBINHKgQUeZWEGaCDTMYOXdVcP,JDCHFCFCRFFB.....SGBAIDHHKGGAQBBAZBBAGAFGhAAAaEAD...DACEMEEAhAAAOFAFdAEFPAHDhABAAAFFLEEF..NEIE.......hACA......hADA...,2,-34,-24,10
YPSAGKMdbROITcEBUWFCLVHZQDJgNfaeX,KACAMHFGRAFH...TDAGBEFDFDDF.LFBBZDFDJGAA....hAAAfEDCaBHD.hABAeAFFPCAHAAIBGAAFhAAAdHGDOEHHEEHBCCDD........hACA......hAEA...,2,-35,-13,22
FePcXgBYDVEQfOMdSaZTAbUWKIRCJLGNH,UCBCKHBGRFCELFFBGCGCFFBC..eFHB..XAAGBCEBDAABhABAEHAEQBBHhACA.MEEAaADFZAEDTDBAhADAAGFH...IAFCCEEANIDF...PAHHhAEAgAGC.hAIA...,1,-20,-22,2
RfNgAcFCaLQGUJBOSdeVDITbYMXEHKWZP,CFEDaGDDGCCHBGAA.dHADDFEC....IGHGTCCB..MCIHhAAAEAADKDGAZACC..RBAF..hABA.fBFBhACAAHHFFCGB.QEACOEAEeAEE....hABA......hADA...,2,-28,-27,1
fIcGadFJbWVYULeBOKZTNCQEgHDRAPMSX,MHFGXGBC..IAFEGBBDaHGAFHCC...JEFG..bEDAhAAAVAGDLDABBDAFKEBChAAAZCGHCBBCEEDFHCCADGADABAHhABA............hACA......hADA...,1,-20,-22,2
RaDfYdKILMXGVHeTUBFOQAWCSgJPNZbEc,SEGDJGEAZCAF.EDBBRABA..DCEAdBAF.LEDFGDDBHAGDhAAATBFABGADFGABAADHCAFC..hAAA...NBIAbFEDfGDEhABA..ICDGMCIF...hACA......hAEA...,1,-14,-30,16
cPeJQdDSGabVRUNETAIWKFMOCfgHXYZBL,KHBGOECCCCDA.HBFCZAGBLAABeHFEdEGBDADEGEEH..bGBEUFBHhACA..ECBAAHHEFAEFhADAfAAE..hABAXDCC.BHEA.....hACA......hAGA...,2,-29,-22,7
ACfBZbaWeTNgVQSGLFIUYMKHcJXPDdEOR,BBBDZDAGaABEeFFC...TBDAVEEGQGBDLHEAIBHGhAAAMFIBHBDG.XAGAhAAAdHABODFEAHEHCHGG.hABAbDBF...NADFSGDF..hABA......hACA...,2,-21,-11,10
QUJMaDXOKEgGdeTYHFRPLCVcSbWBfIZAN,QCGCJAEH.DAIFOACHKFHF.EBGAGBBE.eFDETEGAhAAAFAFELFAFhAAA.CBADSADDhABABBACIGAAAHIFMIEEgEDH.HGEAhABA......hADA...,1,-10,-44,34
UgBOQfVZCLWcaYGSRIedEDFMPXJAKTHbN,HBCFUCBCBHGBOHFC.QGABZBGFCACB.LEFA.aBFBhAAASFAGeABFEGDEDBAHhABAMIDAXBGEhADAAAAC.KGGCNGDB.fEAB..WAEHhAEA......hAGA...,1,14,-60,74
OQRgZYadNTcUPAbIFeVHMKXSLWCEBfGJD,FHBGeDACHDBDMDFCSEGDLBBACACBBAHBGFAHDABG..QBCEhAAAREEGZAFEdGHA.TBFDhAEAPHEA..AFBFbFDBhAFAIHAC..KHFA......hAGA......hBAA...,2,-20,-6,14
IQXgAZbMTPOVECeSYBUKLHaDfJFdNWcRG,ZFACTFDBOAAB..VBFACAEF..SCCCBACGKDDGaFAHDCIB.hABA.FEDAdHGH...hACANAED.RFGBGBFE.hAAAIHADgBADMCBHEEBD.eFFELHCGhADA....hAGA...,2,-21,-15,6
XDRHCIKAFWGaNVULOeQBSEMbcgdfZJPTY,GEAHaCFC.UGGGOACBBGDG..MDDB..gBGDhAAAdEBGfFFHZDDATGAGhABADEGGCHCH.AEID.FAGCNBBD.LAAFhADA.eFADSCAGEEEF..hACA......hADA...,2,-27,-17,10
OICTgAWXdYLeQfFRcDJKGNVPZMEaSBHUb,dGFCLEEGQACFRADDDAACGFAD..NABCZEGFaDFG.BDEAUGGGhADAOGAE.CCFEAFBAXBBDhAFA.fHABhAGAFAFE..cECA....hAAA......hADA...,2,-37,-20,17
SAdLICPGegfOUJKWXVcRZNTbaEHFDMBYQ,LCCHCFDGGGEF.eGDGOEBHUCEH.KFAA..VCCAZFGB..TAEEhAAAEHCEDEFA.MAABhABABDAD.SHAAhABAdAGEIAEFfFEB.JABEWFFC.hAGA......hAHA...,1,-20,-23,3
YLVXRKWTCZUPfEcNDIJGaFObQeMSgAHdB,BCAHLFBBRAAGKHACCHDHZAAC..UECGEFFFDAEGGGEH..FGHDOEFGhAAAeDHH..SAGAhABAHAEFdAGBXEAChACATCAA..fECD.NDDB..hADA......hAEA...,2,-24,-21,3
CJXcagGMSTRfWdeALNODZQUEKIFBHbYVP,LEEGOFCHZDGBUADHKBGD.FBAEBGAEHEAD...VGCCJFEF..hAAA.aCGBGABG.hABASADCTGGCfAGFhACA.eCDFAAHCDEEA.IAADhAGA.....hAEA...,1,-11,-40,29
GLMWPKBeCbYRQNDIJUZfSTdVcHaFXEAOg,GECFMDEBKCAFBHAH.eEHDCEHF.RGCEDBFCJGEE...ZBAD..SABHhAAATCCFdCGBHFAFhABAFADG.EBEBAIFG.LAFAhADA..........hAEA......hAGA...,1,-24,-36,12
HAPLabTEKdNQUZeVYCcSFDMgfOIJXGBWR,aDCDEGFCdECE..UEGAZCAFeABBCBDE.FBHBMAAC..OHFEhAAAJBFABGDCRADCAHEB..LEEEhACAKEAF.QGAGhADA..YBBF.DEFB.IHHGhAEA.XGAEhAFA.,2,-56,-7,49
VNXAIYJbEeaUHOTdKBDZcLMQSPRWfCgGF,JGEAeCCHHCAFdABFBHGEDDDC.ZFEGLADG.QGCChAAAPCGHRFAB.CFADGDEFFAFG.hAAA...NBEGAIFEYCFChABAECBF..OAHFKECA.....hACA.MFIF.fHAFhAEA,1,-7,-30,23
JHgXDAFYBIdKGaQWbTZfMcNSECLVOPeRU,BFEDdAFBaCEEQFBC..TGFEMEDESAABhACACFEELCCHODHBRAFAHGFEDFFGhADAABAHFHCEKBDBGBAE.hAEA.WDHHfGBFNIAFEDBA.....hAFA......hAGA...,1,-15,-17,2
MBLIbDVfOcTdSWRYZgJKPQCEXFaGUNAeH,MAGDBAFBLFECDFCB.OHCEdFHASEEHREACZBCH.KDACQCGFhAAA.XBADhABAFECAaGGB.UGGFhACAABHDIFAA.VABGfAEE.hAAA.WHAA.gDGChABA,2,-32,-28,4
SCfHYIdXaDVZOWGFNKMQJEcPLABUeTgbR,UEBEeDAC...TABGREFASAFG.CGCH.fAFAhAAA..ICEAhAAAaDDDDICEOFFBFCGCMCACQEGEhABAcFEHABAGgEBF..hABA......hACA...,1,-29,-34,5
IZVePYJHdBXNafUTQLKODFcbgESWMRGAC,ZDBHVFDFeGEA..JAFABEAC.aHBGUAAFLAGFDCEB.FABD.hABA...bFFHSDEFhAAAMDAD.AEGHPADBhABAHEBDdDBB..NDIG......fFAAhAEA..hAFA...,2,-30,-26,4
GVBZYFDeATbMUPHCdaEfSXIcLNKJRWQOg,MFFFHEFHdFDA.EBEEXEACLBHFJBGHRBBA..QDAGhAAAGGAFZEFFDDEEAFDA.UGACCACBSBEHhAAAIABFNAEFOBADhABA.BCCC.......hADA......hBAA...,2,-22,-7,15
gbaFZDPKTXSeGCJBIOWEfNYUAdLMVcHRQ,MEGFVGFG.RACB...QBGDaCAB.DAAEKGDC.SBGHhAAAGDBACAFEJADFOFBFEHAE.hAEA..NIEF.AFFE.dDEGHFDDhAHAFAFF...........hABA......hACA...,2,-30,-16,14
KTgCdUWBSVPHeYLQGONMZafAbIDXEcJFR,DACBEGFCFDAGKFDF...CCGH.UCGGBAAE..SFEBHACCLFDBhACAGDAAOEEGZADFAHAB.hAAAIGCE.XAGGhADAcGGA.JFAF.......hABA......hAFA...,2,-45,-19,26
WXCcKfYRLABUVEDZPIFeSJNTgGMadOHQb,BFFCEDAFZEECFDAG..SHDAJHFE...TEBDMECFOBGFhAAAQGAC.bAAEhAAACHAGKGEDRCDE.LDDEhABAACIFDCAGIAHHeACG.......hAEA......hAFA...,2,-43,-7,36
UPWGBNFSEcOKIDdQeMgJTACYfbRaHVZLX,CFDG..fCFCaAEEZDAH.UEGAGGEFBHAHFCDHECDD..ODHFhAAADCCF.dABCMACAJCFD.hADAAAHCRECFLHAE.hAAA.XBAB.NBEF..KGFD.ICHFhABA....hAGA...,1,-22,-28,6
PWZGJCeOFfVKTBAYLEQdMcHDRgUSXabNI,EDCDdBDHHGBEDEFD.RFFGUAAC..SGBBaDDD.IDHFhAAAZAFFCEBE.eBCCOHEChADAfGDE.TAGFhABAAEGC.LFHHMAIF.cGFG.hAEA......hAHA...,1,-16,-25,9
XYEfIbZgSKRQdcVHWJUMLaOCBAFTNeGDP,TGBCGECFDBFD..XBAEECDH..IFADZGFESBEDhAAAKCADdBBHHGBAUCFAMEEFhABAOFGFBAGCAIDCNAAH.hAFAPDAF.fFGF...hAGA......hAHA...,1,-13,-23,10
UJOAEQVIGSfaDgWHNPdZRMbcLTCKFeXBY,VBCFSGAH.DBBEHCFB.dFAAMDHFLHFGKAFD.FBADXFEEhAAABCHFJHBEAGDFQCCBhABA.fDABhACAWFCG..NAAF....RAEA.bEAChADACGGA.YFHB.hAFAEEEA.aAHB,2,-20,-15,5
QEFXBcHAeaIbNRLDYgMKOVZTWSPJUGdfC,aDCD..IGFHRAACDCDC.MAGBKCGCZFFGSEHD.UDDEhAAAdAFHCEGEQCBAhABAFEAGBFDH.AEGF....eBHBhACA.LBBCgGAAOEAB.TFBBhADA....hAEA...,2,-42,-15,27
GFQIcMSCKgaeXfANEJUVZLOdBRWHPTYbD,JCCHVABHLBFG.BFGBHGAG.TECADGBGGEEEFFFEQCEBhAAA.IEAGhABAcGAC..CDHCKAAFhABA...eCAFAEHCEAGC.OHDC..hADA......hAEA...,2,-35,-17,18
EDgBGYZcAQdRHaIFTLNbCXKeVPUMJOfSW,RBCFHDAGFABHLGACCEFAKCCC..eEHBUEEDJAGH..OBFA.hAAA.fHAHhABASHFCDICABCFAZGDAADACaDADhAAAIACF.NAFE.......hAEA......hAHA...,2,-35,-27,8
LEdNTBJgbWaYIHSFZPKUVMcRXODAfGQeC,QAGHeEGHCBCA.LBABdCFFBEAEJGDE....bFEHaGAHHECDhAAASCCDZAFAKABEUGAFhAEAMFCERADFDCEDfGHChAAA..NDIE.gDGH.hAGAIACG..hABA...,2,-26,-12,14
ZGceBUSKVbPJNECdIWHaMTQYDRgFOXLAf,ZEBHeFEFBFDEKGFA...VFGBJDAG..EAGECDGE...dFAFHABHMBAChAAAQAFC.hABADIDARDEEOCHFABAH.hAAAfADB.UGBFSDEBhABA.NBIEWDADaHGE..hADA...,2,-36,-14,22
YXeMZQcRbNICELWdGSHDJfOKAgUTaBPVF,UCGCTGAFBHBA.FFFBXCCC.eADEZEBGQADAhAAARFEA..IEHGhAAAEGHDdBBE.SHCAhABAJAFGKBAF.ACGGaBBG.YDFE.MFCChACANIDBCDEE......hAGA...,2,-28,-21,7
gPNMTKbLBWEfOXZeIJQRDAaSHcFYUGCVd,aEHBSCFCHFCEFEFFGACH.dAACNCDF.KHGEBBAG..EFAC.hAAAXCCGeADEIDBDhABARDFDDEEBAHEA...cGAAhACACHDG..PCHFMDDG.....hAGA......hAHA...,2,-28,-18,10
TYNfVCBEPWSKMDGHUXaJZbdQcRAIgFLeO,FHBGOAAB..TAAD..NAIECFAGBCGG.EDDCSFFFhABA.DEAEGADDhAAAXGBDZEGB...QCDHhACAcEAAAGACIFEGgGGEeCAAhACAfHDB.WEBAhADAMFIDaBDA,2,-31,-29,2
MFCSHIAgNDLGXPTcaOfEJYQKBZUeRdVbW,DACBLDACGDFCXFFH..PEBBaCFE..EGCEJAEHKABEhAAABAAFeHAGdEDAbAFEMIAGhADA..CEGEIEBDhAEAAIGG..NEIEOAFA....hBBA......hBDA...,2,-36,-15,21
VGXZRIaSgfAUdCDLBcPKMHbYFQEJWOTeN,UGAFdFGELDADBACGKFEBMBFC.HEDHFDAF.QCGA.hAAAECCEJCDEOHAAeBAGGBGEhABAXGED.ZABGhAAAaEHD.....SEEEAIHGDCEA.hABA......hACA...,2,-38,-2,36
EaOGDdbQTNFICgXZVcUMJHSKRBWefAPLY,LGEAEAFBGGAFdBBBQFFBFFAE.CBDEZDDCUCCB.MIBCJCAEKAAGhAAABEAF.eAHFAEAH.hACAaACADGIH..TDFFhAAA...........hADA......hAEA.IFDG.,2,-27,-22,5
QGYKRACfHWDPBLdENZcVgFabJeSOTXUIM,HDBHDACBBDECEGEHZBDH..VAECFGHFaAAC..eHEAOAGBUEGEhAAAMFABGDBG..hABAKDGHAGFBCHCA..fCAFhABALDAD.........hADA......hAEA...,1,-19,-32,13
ePWUNXVZYJOHKFDQLMdRTGfCScbgaEABI,BAFBeGEAUBAD..VBDBZBEHOBDHKDAHDHGA.LHAA.hAAAMCHFdHAHTABChABAGEADCBHESFFAhADA.....gCGCAAGE.IHEChAEANAAF.JFBE.hAFA...,2,-30,-23,7
LbDYKZBgHCUSTRAJGafVQWOeFPIXENdcM,GAEGaCFC.QAABOBBGFEEG..IHGAEAGA.dDHGLDCHhAAADDBCZEDGBEADhABACGHBSEGATAGFAADEVDAFhABAPGAC..cGGCMEBE.KBHB.HGCChACA.....hAGA...,2,-15,-6,9
IKeGabDJRESQHgBPLCNMZWUATYFcVfOdX,FGFCVAADOCFG..dHBFKCBDaFAB.DGGAEEHB.HEDEBEEGCDDC.MADFhAAAZFAC..AAHG.TGEGhACA..fAAChAAAIFCBGAECbAEC.SEGEhAEA.gBGBhAGANIBF...,1,-17,-27,10
GTeWFXANCbRPLZcfJOMYaDHIdgSUKEBQV,CFDGRAADZDCC..JCBCMBFE..DAGEdHAHUEADKCFEBACF.GEFChAAAeAAEFFHH..AIDE.hAEA....PDEDhADAfFDE.aDHFIBGDEFAC..hAEA......hAFA...,2,-56,-25,31
KJGcaPTSgLVOWMbDNXQURZCBYdHEIFeAf,JCCHaGAH....TBBDLHDG.VBEGMBHF.DCIH.XGEEhAAAQABH.ZFAHhAAABCFDdEFHEAGEFGCBfDAEhABAKADC.PEDESGGEOAFGhACA......hADA...,1,-20,-30,10
OdRXZQbTaIBcHfMJWPEFCGgeUDSAKVLYN,KDBDVFDFLCFD.OACHXCGHZAGB.QCAG.hAAAaDDAIEDEBFFBfADDhAAAMHECJDHDEADChABACGAEeAFEUGBAACCANECA........hABA......hACA...,2,-23,-23,0
gfdIWHaUMPXbeFSGQADcVLCOZTYJREKNB,VFDGLEGH.CCFHZBAAJAFA...EBHBKBDABBEGdDADHCFD.MFBDhAAAPEDB.eDBHhAAAFABC...SGBHhABAAEIHDICE.OADA.RFEFNEIEIHHHhADA.aEDG....hAEA...,2,-31,-9,22
BFDGUNVOfTZSLEWYPCbcgXaMQdeIAKJHR,KDBDJDACBFAFDHCGGCDB..UFCHOCBGZBGHLGFC.hAAA.EHEA.PABEhABACABD...bEGBXACFhAAAMAFAdBGBAHAARAEBNEAA....fFBAhAEASHFA...cDDFhAGAaEEH,1,-18,-47,29
SfeQHUYZMgKXBWFOPLIcTaEDbGRdCJVNA,eCCHHCDBZFFEMACGXAFBFBDA..OFGDLFBB.IEGBhAAAaEEDEBHFGBAChAAAdACDCCCCJAHBAEHESGAFhABA..fBAEQGBE...hABA......hADA...,1,-9,-21,12
YagKIJHZVUDNOfCMLPQBWeATFdEcbSXGR,FFHBdAFBEECH..SDCBGAACREDH.aCBHKCDG.HBFEZEEBDIEA.hAAA.NIEH.CHBGLAEGhAAABGGHAEAB...bCFA.hACA..XABE.IFAE.hADA......hAEA...,2,-26,-25,1
YIeAMFfZCbRSVGcaLNHWQJOgTEUDXdBPK,MHFGFCFCZECDRCCC.GAACLHBAHGFA.JFAHTFBE..DCIDXEEBhAAABADCKFEEIBFHhABAAECB...fAHChACACEHDSGEDaEAGQEGAhADAEAEF.dBBF....hAEA...,1,-13,-25,12
NUAgBcKWQGXITfbaDCZRVYMJSFOPLHEde,BFDGKHBGQFBDGGEF..XCDH..ICDAhAAATCGDaFAGCHHFRAFDMFGBFBAEOFFAhAAALABCdADFeHAEhABAAEFBgEGB.fDBCDAIB.hACAYAHH..hAFA...,1,-7,-32,25
IeRHNVKafLXEJMFWAdcOCSPQUgZDTbBGY,OCCHSEGDUGEGZDCC.DDBBBAHD.GADAeFCDRAFDHAAEKFADLAAEhAEAXDGEJFADhAAAFGHDADDG..CCGA...hACAgFDE.......hADA......hAFA...,2,-27,-21,6
faSUcRAZBPOHCgNKXeQEVIJLTYMDFGdWb,BFDDOFBBHDAE.CABEKADAQFFE.IBEALAGHMDCChAAAFCDEdGHA..fABHhABAaGBHSHEChAAAUAGFAIHE.gGDBeEFGEEEB.JDFE.DFABhAEA......hAFA...,2,-21,-21,0
QNFRaAeIMWVZgGOKLTdPCbESHBcUDJYfX,MDEBVGFG.ZADAGCDBKHCC.dABB..CBBG.EEBBBDGGDFFG..JGCEXFFEhAAA.FBHHaCCBhAAA.ACBH.eEAH..hABA.IECEOHACLAEE..hAIA......hBAA...,2,-39,-21,18
ZTeOYKPANIMJLRSEbcHDBgVCXaUdGWFQf,MCCARFBGEFGE.HAGFBEEGCABE..UGGGdAACGAEHFEBC.ZDAEOEEBhAAAKDFG.AGAA...JHDGLADEhAIA.SDGDhBAADBBC.........hACA......hADA...,1,-24,-36,12
fSdXKeUWYTgIROPDLFCcHBVJNMEGAZabQ,ZDAGQGBCdHADKAAF.eDFDUGGE..TDGBREDG.DBECCDHH.HAABhAAABBHBVDBE.NDAA.EFBFhABA..AHHB..aGDASHDAhACA...XADC.hACA......hADA...,2,-38,-14,24
dcbJVKGMBUCfWEeXATPNaFRLDQZYSHgOI,TCBCaHBGLABC.DBGAZFAH.HFCGOFEAdAEDJDFAGCBBUFFGhAAACBCC.EECAAGHA..FFBE.hABA...YAHHhACASHCA.IHHA...cGEAhAAA....hAFA...,1,-10,-38,28
IbEJSQTZVfGBLFeWORYPdMCgAUHXcKaND,HCDBKGFCDCGDEDAF.SBAAQADEZFAEGCBHLGFA.FBHHhAAAeFED.RGAGdCACMIEGhABACAGEAIAAcADA.IEHAhACAJAAE.fGDABFBB.OCFFhAFA.....hAAA...,1,8,-28,36
NDFWYOAdZcaTJQUHbEGPCMBKRXfLSIgeV,dCFCZDAGaABEQDCF.UBBBEDFECGHHBAGDREEH.LFHB.hAAASFFGICAE.hABAeFBHDFCAFGCCOEABhAAAAHBH.TGDFJAHB........hABA......hACA...,1,-19,-34,15
ZJDRFNaMGYXHUWOVcKTLSbQEPACfgBdIe,CFDGBFDGdCABZCEGRAEHFBBG....MAEEGCFAHGFAUEAF.OAHFhAAAKFBFLBDC.hABASEFGQGAHhACAADDHIAAFeHFCDCDB.NIAB....aEHF.hADA......hAEA...,1,-21,-24,3
gAHTFJIOVWPCUbSZNcadXEeBMLfQRYDKG,FDAFJEEG.OEDB..VACGCGHD..UAGDZFAA..aFHDEFFFBBHFhAAALBBE.QFAFhAAADDFEKBADAHAD.TCEDhABA..IHFA...PCCHhABASHCA..hACA...,1,-33,-41,8
QPXNBHfbYDZAESMGOgJdRWIUKaLVTCecF,MIAGOFEFdAGCRAFE.UFABKBAA..LEDD..CDHGeEFGQGGAhAAAXBCCHEAB.hAAAfADADCAHEGDESDDDhABAJEFAaDAB...cFFCPCECNBBEBCEAhACA....hADA...,2,-28,-2,26
ZdIELUJFfVaCYcBeAQNXWHTOPDGMSKRbg,QCGCXCBCHFDFOEFHGEBE.SBBEKDDDREAFZBCAdAEDhAAALAHFFHGE.aHGACHBHBGDEhABAAFAANABB..PFFAhAAADCAH.MAGF........hBAA......hBEA...,2,-27,-5,22
XECQUVaBTMWegbOLYDfSNIZdJFGKcHRPA,XGAFEFFBUFBABDBB..MCBB.eAFBODEEDDDCSHGAhAAAZBEGFAAEKHGARFDBPEFEhABA..AAFDCBCAaBBF.hAAA............hADA.WEAFgECGhACA..,1,-25,-40,15
fIONWbJRXDGSZgTMBHCLPeQEKFdaUYcVA,OGEA..bDEGXACFDDCHZGFE.MEDCCFAC..LCAChAAA.eHBAEBECFFACdCGHaEGEhABAYBAD.AAIFfCFHhAAAIAECJGAESHAGBDAA.hACAHCBE.PDHDhABA.KHDE.,2,-21,-15,6
agfdeAVXTQUKBNSLDcGPMFJEWHZRIbYCO,XDCBUCCBBBABLFFBGDGE..FAFAJAEAHGDARBAC....hAAAIDHECAEGaAHDdCFEAHHEQGCChAAA.hABA.NDBCDIGAcDAHMCABEFEB.....hACA......hADA...,1,-18,-22,4
ARFgWYMQIPZVbBELUCacSXJKfOGTeNdDH,RDAGFHBG......gFFEMDECQDCCZACHBBAGUEFGhAAACCGF.aFCESBGEhAAA.JFDDKADDODFEhABAeHFENBAEDGAAAAGCIBFE....hABA......hACA...,1,-31,-34,3
FIPSGCEJYfeRXcAgdQbBLHNVMWKZTODaU,QGBCBAFBHFFBMEFGZABBOADFDDECFHAC..SCFAhAAAGCCACEAF.EAFC..fBAGhAAAeEFGXDCHhABAAHDE.gGGEbBFANBBF.KHEA.aFAH..hAFA......hAIA...,1,-9,-19,10
ZDSGJXaFYbEUAgPNfRCOQeHBKWLIcMTdV,...PDEHNBGE.RAFB.OCAEHFADBHFGKHECLFBDMDDBdCBCDIGEhAAA..SADChAAAJAHF.FFGFbABEADHBCABAeDEHhABA...WEDF......hACA......hADA...,2,-33,-20,13
RcAZPBaTdGMNKSWIDLHgeYFfEOQbCXVUJ,BFDDTFCEdEEH.MCCGSFAC.DBBELHBGHDCGeBEGhAAAfAAGEHGC.QDAChABACCAE.UBGEhACAJHACAHFCaHGAKFGEIAEG....hADA......hAGA...,2,-31,-18,13
bVWUfCAPaXBIFHYgeKLOJdRQMDZSETNGc,XGBCFEGDHCBCeHDALDDBdAFF..RAACDFDASDBG.EAFEhAAA.GCGAbFCCVBFFhAAAfBFE.AFFBaABGhAEABEAHIBCF......hAHA......hAIA...,2,-20,-17,3
ePZVKAUQfFYGMDXRdTILgHBJaWNbcCSOE,UCGCFGFCGAEAMFAC.RBAE.dBAALGBAHBEBBHHG..JDDDaGAA.hAAA...NIEDCADGEDDDZAGFhABAAFGD....YAEChAAADEAH...IFHC.gACEhABA...hACA...,1,-21,-28,7
SHXPdOIYTNKAaRbVGDMFQcWgBZUCLEefJ,aCFCRGFGGDCC.FEGAQAAE..gABDUGBHCEHAEFFDhAAAJBEEHCBG.dAHAIHAEhAAATAFFNEACKHDAAECF.hADADDAB.MDBFBHEB.......hADA......hAEA...,1,-8,-29,21
fFRUMSGQWVNPbKIaCTHAdZXJEODBYceLg,XCCBEGDBBEFE..eECGLEBG.FBGGUAEESHGAhAAAGEGEVAAG..PBABhABAIGBFTEGChACAABID.dGAA.OFEDDAHF......hADA......hAEA...,1,-19,-28,9
OYZfaMdIVSKTPNWbADERJgBceLCQFUHXG,EEAERFDFBAHDLBBCFGAD.UEEEHBCGGDGA.OBHFZCGBMFAEhAAAdHBB.SCBDhABAKFAD..TCCC.hACANACHAIHADIGE..........hADA......hAEA...,1,-12,-36,24
FHbdWNeLZDcOGgEUIaQBRVCJfSMTXPYKA,FCFCHDAGdGGHeCHDLEBEDBIFOBDDGACHUFDBQFABBADCRAFH.hAAACCCC...SEFBhABA.MFBHXDGEhAAAKABBAFAB.NICBgFEFIGHB.aBAH.hAFAfAHE.hAHA...,1,-12,-15,3
XabgGNOFBeVUJICZSYPKWcMRDfLQAdTEH,TFCEXCCB..aBFHGGAH.FEABVEFBJEFE.ZABH..SBBDhAAAKGBDMCEHDIDEhAAAfBGBAIHEEDAGHAGFhADANABFBGHG..........hAGA......hAHA...,1,-11,-33,22
XLAbITKBHNVMPcFeCZEYUgSDGOWfQRdJa,TCBCBHCHHACB.MCHFFGCDCBEHZEAF.UFGDDBIBGCGA.OAAChAAAQAAB.hACAJDEDaAGGABIFKAFCVEDC.hABA....eDAD.gGGAhADAfGEA.....hAEA...,1,-18,-24,6
IEHbdFQgaXKZeJUVTPSRAWDMcNYBGfLOC,MCHF..NDDGBAECLGDE.CHHAHAFEdAAFFFFDQACDhAAA.XDCGeFBBVBEBhADAPFAHADCBDFIB..hAGAYDDCOBHH........hABA.ICAC.hAHA...,1,-7,-43,36
YXRdbIVUeaLHWZDBcKgJSTPOANCEfGMFQ,EEGDMEAEFDAF..XDDBdHCB..ICCEeFHFLFFFhAAA.ZFAHBBAEKAHHJCFAhABAPDEDACCECACA.QAFFhAAA...YFHB...hACA......hAEA...,2,-34,-28,6
ITVMJBKPDbREFdOgXSeZAHQUaYfLWcCNG,QDCBaGFCLACBCADEGFAH..IDGHMFEEBAACDFBDEHCAhAAAdBHCOAFD.hABASGGEeAFGAEEHYCEHhAEA.fEBBcACHNIEB...hAFA......hAHA...,2,-27,-26,1
WZEGeJIgAMKfFBDcOVYHdXCaLQTSUNRbP,MHFGKAFBBEHADGDG...OCAFHCDECAGHLHEEQBAD.UCGAhAAARCDA...PFAHhABAWAHB..GAAFhAAA...IHBEAEBFFAEG.VECF..hABA......hADA...,1,-24,-31,7
WQSXINTJdABCFcGUPZMgRDVfKbELaOYHe,CBEAGEAHZCFE.MHEEDEAB.KDGGLHCE..OAEHHFFEeEBChAAAQABDSCAGhABAIHAATABCdFFBAAGAhAAABBHFFBGC..........hADA......hAEA...,2,-27,-23,4
JMCTABUKLIDdPeOcYfRQgXbNaSFGWHZEV,BFCFUGGDKHACLAAC.DDEHdCCA.eADCOFGH....hAEAfHDBgCBDhAFAXDFDaAGC.FFCEhAAAWBFD...EHDAMBFBAGDA.cDAGhABAYDHHRBGD...NEBE.hAHA...,2,-42,-20,22
cHUXAgfaITYJdVFSLWQPRDEKObBZNMCGe,aHBGTCBC..JCAGFECDLFDA..QBGCRBGHKACCBAFHhAAAZFFH.CHHBeBBEHCEBAHFDhABAIGAFdFAD.WGCAhAAADEIHEHGA..NABBMEFA....hAGA......hAHA...,1,-22,-24,2
LQXAUTPFMEGacOfSZbDVIRdBHgWCNeYJK,UCGCFGFCEFCCGACG.OFHBSCFHDFBF.RAACdCCDBAFAHAEEhAAACFEE.eCHFKGFBLBAFhAAAAIFAMIBG..aHAG.hABA.fCEAVDAB.IAHF.hABA......hADA...,2,-31,-7,24
MZHSYOBREIbfLAcVPgaWKQUeDCdNGFTXJ,VAADaHBG..KCCAUDGBDEEG...CCGBGDBGFABH..XFGChAAAMEABZADEHBFG.SFDGhACAOHFEEEEDIAFGhADA.LHEAAADE.PEAHhAEAWHBGdGGB....hAAA...,2,-25,-15,10
AYXLPbISCZKRFHOgJEeTGVMfDcaBWUNQd,XDACLGEA..IGCACDGGZFCH.KCAEFBBAHDCA..OFEDhAAAEHAEeBGB.TEADhAAAMAHHDHGEBADFNABHAGAA.hABA....bBDD...SGAAhAGA.....hACA...,2,-27,-26,1
abBLZfOHKNJTdSRYEMDPXFWUVGcQACIeg,CAFBeGEA..aECALBEEZACDHBGDJDCFdGEEREAB...MFCHDDHFFEEGhAAAUAAF.....hABA.cABEIHHGhABABCADKBEB.NEBC.SGADEDFF...hAHA......hAIA...,1,-19,-32,13
gPWeadOSHTBLFbXMcAfUNQDZYVJKGIREC,UCBCQAFBDHDGZFEAJBCC..KAECRBAH..EEDC..CHAD...PHDAhAAAaBFD..OEEGhAAATDGA.BGAE.hABAbFFAMIFA.ADID....fBHAhACA.....hABA...,2,-45,-27,18
dLDWPXHAfCIZMegQYFJSUbNGTBKaEVORc,CFDGZFAC.MEBCQEABFFFE.UAAFGAEBKBDC.aBAA..EGHDOHEAhAAAdCGHDFGH..PHAEhABAAHBC..IEHBhABAeDDE..........hADA......hAEA...,2,-44,-19,25
ONcSaTVMYgIeJbKCPBDGZLHEWXfAFUQdR,FEHBUFCAQECFRAAH..OFHDSBDDaAFH.MFAH.hAAAIHDHeHAGKADHBHHGhAAAZDCCLFGFhACAECGCXBACdGEATAGE..YAEGhABAJDAH.PFFFDDDE..hACA...,2,-26,-3,23
FVCDbOPXdMHRfATcgJLUaWeEZGKQNBIYS,TCBCJGEALEDF..aFEHECDEKBGFBBGA..IHGChAAAFEBBDDAF.OFCFdHABMAAEhAEAfDEB.AFGFUADChABAeBBC.QGAGNBIESFFECAHB..hAFA......hAGA...,1,-14,-32,18
eVaXSZRQETgKIOPfdUWABJcFMHGbLYNDC,BAFBFDCDMCAEGGCHLEHDDABE..CDGG.eABC..aEDBXEEAhAAAZBFAEEAF.KGCFOFFAhAAAdFACAIAAHAEG.NIDF.hABARBBB............hAFA......hAHA...,2,-34,-17,17
XeIVFENHYTBZDfUWQPAMSCROdcLbKagJG,CBGERDEDdAECLBCGKBBA...aDBGJEHF..eGCA.FEEGEGBBHEAChAAABCGDDIFAUDAC..hAAA.QAGEhABAAHHCMIBAcDGA..gGEAIBAENAEH.hACA......hADA...,1,-17,-36,19
fKCTYdXNgbPIAEBRQOSVDHcUGZJWFaMeL,BHCHQBDGOFFCDGAEHDCHUFFCZBGDFBHFMAED..LBAFhAAACCBAdAAF.XGDBhABA..NBFC.bAFFIHADhADAAEEHEDHD..SEAA...hAFA......hAGA...,2,-35,-12,23
HaDSROCNPMgEGTQZLWIdXFcbfYBJUKeVA,aGGESEAE.OBACPECC.MBEEECHHGGBB.QAFBhAAAZCBEIGAChAAAdEFCFEDFfDGHhABAJHFGeABGAIEGDAID.CGDBgABH..hAEA......hAFA...,2,-32,-6,26
JIMKOYeVEHDWCfFLNGUSZcdPXaAgTBRQb,BHHGQFDHJBGF.KAGH..eFFGHABECFCE.fCDGLBACGCDChAAASEACZDAHdAFBhABAXFBBAHFF.gGGEhAAA........hABA......hADA...,2,-32,-24,8
OAYKNeHLVRTfJGXcIDQMWPZSBUCdgbFEa,KHBGeFBBHBFBLAHFRFFH.JFHHXBCF.DAAFQFDHhAAA.MBAGWFCESCDBhABACHHG.gCAHhACAFAHF.aAFHAGABYCAB.hADA......hAEA...,2,-31,-23,8
gceFdIPBVWZRLKabAUEGCSXTDHQOJYNMf,ECBBCBCC..SGFADEIFQACE.OEDHJBGFMDFD..hAAAfAEHeDDHIHAGhABABHCGVCFGZDAHKAEFhACAABHEXGGC.......hADA......hAFA...,1,-24,-37,13
NWZYIBgeVOXAfUTFKHQPaSDLCEJcRGMdb,UCGCFFHBHEEDQBCBaBFH.DADELDBD.CDGH.EHAEJAACGFEBhAAAdAGH...WABDhACAIDDFBGDD..hADAgAFCOHAEfECGKDEB..hAEA.SGGDhAFA...,1,-20,-27,7
cSPRZfUHWOJeETYGFXDNaMQbgVBCIALdK,LEGHdAFBSFFERBAEZEBHUDDFHGEEOECD..JAFFTDAEhAAAFBHD.DDIBMDADbDDB.hABABHAG..CADEKBBBhACA.PCFA..eABE....hAAA......hAEA...,2,-32,-5,27
HYBaWdAETVfRSQXMCcGLgFZebINPUJOKD,VBCFRDAGQDFA..CFDGLFHDFFDHZACBeFFD..bAEAIAHGhAAAUEAH.KGAFDIAGhAAABABCdGFAAHEH.EABFSGGEhAFA.XBFCMADE...hABA......hAIA...,2,-26,-16,10
FCYWPUTegMfZOSGdbHQBJARILVDXaEKcN,RFDFLFBBDCGA.aBEDEGHH..KDFAFFABCCAH......PAFAhAAAUADGTDGD.hABAMDBAOEEBdDFCQAABhABABHFBACCHIFGF.XABAhACAcGBG......hAEA.NDDE..,1,-22,-38,16
eVZWNdBfgOICaKDUSEQJXYRLTPHMFcGbA,eDACVGFG.ZGDE.dFCBBEAC.OCCECAAFKBGH.DCGDUACC..SABDhAAAQGACJGAChACARCEBLFGB.hADA............hAEA.PEBC.FAHFhAFA.cFEBABBF,1,-28,-35,7
BTScNUdEMgDJGbLZaeOCIXARYFKQWPfVH,RDAGFAFBKDGEQEAC..fCCFBGDCSAHDUGCAdBFBhAAAEGGCMFIFDADBJAAFLFGFhABAZDEC..aHDEOADGhACACCGD.IBBCAIHG.....hABA......hACA...,1,-19,-31,12
WKgfILFQETeNDcVSOXPZMUAbGdaBYJHCR,dGAHBFEDJDAGCAHG..RBAA.KECH......IAEHFGHBQEEGhAAAeCFA.DBACSGCBhAAAOBFF..XACFhABAZGFEAEEAaDAH......YHDEhAFAgGAE.fCDFhABA,2,-49,-38,11
EOKbQcRGBJHFaVCeYXMASLDdPTWgZUNIf,DFDCTGBCZDAFUGEH..IBGH.OABFKAFDQAAChACAGADEJFFHHCCGaDBEeDGDhAAAXFGB.AHIHdCHEhADAWDAF..fGAEbFDDBFBFCBAD.MBIHhABA.....hAEA...,2,-29,2,31
gLWHFUAbOdCTJINPGYKefSQMZDREcVBXa,dDCDTEBEJCHH.....IGGFGGBBKGHDeAFEQABGhAAADFEFEACABDHF.aBABLAFHhADAFBEH.AEAGCAHCNIAH.hAAAfEFESEEBMFBE....hAEA......hBAA...,2,-28,-20,8
EQKNWVSXPGYIeJZfHgDLCcaBbMdTAUORF,OADGRFEEQAEFKEDG....VGDAXGCC..PAHBhAAAGAAE.eDCBfCBBhABAgBGFCFCGBCADhACAMDAFABBC.EDDE.SFHB.IHAGhAAAJBFFDGIB...hAIA...,2,-36,-1,35
WgMEcJRXTGAdLZCPBSDYbeOIHVUFKfQaN,dDBDLFCACEEFBBHCDDEA.eABDHFBB.UAAEKHGEQGAHhAAA.aAFC..NEHGMAGFhADAEEAHJDHHRADF....hACAXGEG.AFAA.PADB.SEFBhAEA...hAFA...,2,-37,-16,21
MHeAfQPXKcIRbUgVBECDGSONWZYLdaFJT,QCBCKGFCRDBG.UBGABCACDGIBSHBC..OFGBhAAAZCGDLAAEFDEBJFAGMIAAhABAACFGXAEC.hACA.IBDGbFDDEBBECFABNADFdGEE..aFHD.hAIA......hBAA...,2,-25,-20,5
ZLeDURPgACOMXcSEWTNQGYafdbIHVJKFB,MIAGSGFC.EHFANGCH..GDAH..fDEGhAAAdAGEHBCEJHDCFADABCACeEFCDGHDhAAARECDgAGFhABAABFC.XBDCcBABWDFCTGAC.aCGE.hABA......hACA...,2,-18,-8,10
PBDXVIMfYEgFJeRdOQUTbWCaNHLGAZSKc,ZFEESAFBKDGGBAHBDBBC....XCEBIGDD.MFCFhAAAEGBH.FFGFRDBA..OABDhAAATCCC..CFAEaBDGhABANIDDGCEA.cCACfGHA..hADAYAHF.eEABhABA..,2,-40,-13,27
KBHTEcOMeCaNbfADRVIXWLFUgZPQYGSdJ,VBCFXCBC.FEFAZFFE.QDFFGFABdHDFBHCGEADHMEIBhAAAeFAFCCAD....aGGHhABAfFCBDACBRAFAICEChADALAFE.PHFC.SAAChADA....hAEA...,2,-22,-9,13
AfRKEIDVZSFHNQPWdLUOTebaMYcCXgBJG,RDAGKAFBEGHDDEDG.ZFADHAGB.QGAFdGGFUAAB.eBAG.aFFBMDAChABACADH.BHEAAHEHIDFDhAAA..SFDBhADA.FDGAWCDHOAEH...hABA......hACA...,1,-19,-41,22
OHKQdTDCLfAYXbaeEBFWgUMZNVJRSIcPG,XCBCeCCHBGBEFGCDUEEB.ZBFG..JADH.REEB.SABDhAAA..cAAAhACAPADCOAGDKEHFdDAACFBCAHHFhAEAaHDAEEGB..MIAENAIE......hACA......hADA...,1,-24,-27,3
PeLYNOaTUGbHgdKFSWfMQRCZJVcBIXEDA,eEEGLGEAOEAAUDGCHADAdAEGFACD..SABFMFBERAFE.hAAACDHBJFDDBDDE.ECAGAFAFPFHDhAAA.aGAE.hABA............hACA......hAHA...,1,-21,-35,14
LITDYafXANOSUGeHKbCFMRgQWJVdEcBZP,SDCDUDACeGBGHAAGCHGF.RFGB.QEEA.JGBCdDFAEBAAhAAABAGFLBECTDCGhAAAaDAHAICA..NBIC.KEGAMBHBhABA..WDECcFEC...PAEBhADA.....hABA.DIBC.,2,-28,-3,25
aePWMbBQIXUEScYKOJgVRAHDLZdFNTGCf,DAGDLDCHdDCBFBBBTFGC..GFDBaBCG..eBHDMFBABAFChAAAXFACSBEAhABAKHFG.gGEBhACAAEHGZBEFCHHE.WHAG.IEFEEBHF.cEAGhADAOHAC....hAAA...,2,-29,-8,21
BJLHcIXCPQbNRMOTFGWeEAYafgZSVdDKU,aHBGZAADdGDB.DCIFUDBBBDEBLAAC.HAEAXGABCAHEQEGDhAEAREFC.OHDEhAGAGAFAeEEFADDH.fBBEhBCASACAKCGCIGHD.NFAF.hAAA......hADA...,1,-2,-38,36
HBLfgDRPQMOUFYcbAeKVCGZNaIJWXESTd,eDCHCCAHZFCD...aCAHJGFG..EHEEdACALBFD.DCIDQAFEhAAAOFFGFBCB..hAAAbCFAAAHG...KEBE.hABA.NCEEIGAA..WFAF.SFFChABABGCAfGHEhACA.,1,-30,-39,9
XcgHEZJPSTWCUVfIdDMaKAGNRBeQbOYLF,GEDHBFDDQEABOFHFFFBB..XGGGHAEDEDAFZBDHSGEGhAAACHCDUAGB.VABFhABAIHEEDCEH.KBBGAIEGNAIChADAeBADLHAA.......hAAA......hABA...,1,6,-31,37
AVNZFUYOHLGIbSfQgDaKWdXRBJcEMePTC,VGFGZDAGFAGG.UFBHHBGB.LFAAGGEH.SCDBQBBChAAAaBAA.dDBABCFFJADAMFEBhAAAeEEACADB.AEID.OHAEhABA..........hACA......hAGA...,1,-10,-29,19
HbYcgMdUZNGPTXDVKeRBEQFCOAWJfLaIS,JGEAaDCDHAAC....bCAF..YFFCMFCBZCEAGADEhAAA.TBGGXAEEhAAADEGEKGBFeEEGBAFFFABCAHBBhADAWGDEIDCE.SEHHgDAChABAdAHENIDF.....hADA...,1,-12,-13,1
bEBSAPVeWKGDFTJCHfcZgLQMRdXUYONaI,VFDFKDCDFGHB..CBFD.HADEZBBC.LDFC.QFAGhAAAMIFEXDFHUEEHOBAHhABAaHAC.EBBEBCHEAAGEeHCEhACADADGJEBG.fAGB...hADA......hAFA...,2,-34,-9,25
NaeTIBAKGJCEMLPDgXfVUZWdQcHRSOYbF,KHAECDHBLFAFDBBE....XECFUABGdDBHQAEChAAAHGDAOBGBFEFF.eFCCIFHHhABAAGIBEAEA...MICGhACAfFGGVBGFZDAF......hADA......hAGA...,2,-24,-19,5
PKLgZBVaADCRNWXeEJdbGOHMQYcFfSTUI,DFCFRDBH..XFEGeHEEEDABdGBHGBCD.HDGFQAADhAAA.FAEFSHBAhAAATAGCIHHAKACCgDEAhABABBDGADDGCDFEWAHB......hAFA......hAGA...,2,-21,-20,1
RaSOLTJbEIFCYGWcAfQXDUBgPHdeNKMZV,QCGCDFEEBACBHCEAeBBAKAFAZFAB.RFDA.OABHLAFG.TDDBhAAAJEHB..EDCECHHG.hABAGEBCABBCXDAChACA..gGEANICF.....hADA......hAEA...,1,-7,-31,24
cAFaVeDWEJKLISMHZNCOBdUTXQfYPbRGg,FEHBaDBD.DICC..EGDAKBBELADD.SGABHBDGCEAAOCAChAAABAADdDFG..XGGEhABAfHFB.hACAYAHB.PAECbGBCREDA...cFCBhABAAHADWAECMFIB.hADA...,2,-36,-13,23
FeEUMcfbaSdKXILBJRVTWNZYPHGOAQgCD,CHHGeEACUGEGMIFA......fBDDSEEHKGBFXFCHhAAALACFRCGFTBDEhABAZEEAHAFDAAGGgABAhACADBBDEDHB.aFAEBDFD.WAHBPGFChAEA......hAFA...,2,-24,-17,7
LETIFcAWSZJCgDKHBaVXUYRGONePQfdMb,SCFCZFEEJCBC.DCIFBAFD..XDCARBGDGDAE..NEAG.hAAAQDEE.hABAMEIDbCABTDFBhACA.FADBABBGCAHBKHDGaAABVFBFOFCF...hAFA......hAGA...,1,-20,-26,6
EKDZSRWJCfbdFPGTQVacgNBMUYAXLIOHe,XDACLEEGHADGKBCH.DFDDRFAH.CHGGdEAHFAABGEEE.QDGGhACAaCGG..cABHhAAABGHFMEDH.hACAUAGCAIDGOGEG.EGAA.SDDEhADA.fAGDhAEA..,2,-23,-15,8
RgTPDIeAdXUFfNVWSBbOYaZCMJEKHcLGQ,dEHAXFCAFCDD....VGCABAHD.OAFHaGAG.MAAFKFECLAAHhACARDAC..hADATGGGDEAEABFC.fFFHhABASCFAYGAACHHG.JBBE.EDFAhACA......hADA...,2,-35,-29,6
UEeMOIAWXHPBZgYQLFaVSJfbGdKRcNCTD,HEFHZDBHQAACaHEC..JFHDGBGGKEBDRCCC.CEEDUGEG.EBEChACAeBBC.IHAGhAAAADDAXGACBDHA.gAGChABA...FFCEfGHEhADA.....hACA...,2,-21,-18,3
caDZHObTCMLQAXFeEPBSGUJKNRfVIYdWg,XGGDFEEDeACDBEBEUCBB...KBABRGDE....IFBChAAAdGBH..gGFAhAAADFEAZAEBHDFGTADACHBDMBBChABAACIDSHCAJAHFNCAE...fAGAhABA....hADA...,1,-9,-39,30
ePfAZOEbJUGWKQXcLBTNCYMgRSFVHdaID,ZDEDEDCDUAFAKCHB..QAABLHDEBAEDCGCD.MCADRCCBFHGAdEEDhAAA..DEHBeBAEAIFE.hABAOAHFGADFXFGAhABATDAF...NDDH...SHAGhADA.....hACA...,1,-21,-22,1
QMcABbSFUZPRafDTJHIXeOEgCLKdWNGVY,SEGDZBCFaDGE.DGDCJFBBHACG.eFADEFGGLCADdCAFGBGEhAAAQAGCAHIDFDCE.hABAUBEE.RFEFIAAFhACAODAFKGCD.........hADA......hAEA...,1,-12,-19,7
TYgMCObWUBVdJQAHcPeEfILXKSNGaZDRF,HAADeGEAEAGELHFAKFCD.GCFEDAEHRBFF.FAFA.TDCHMBDFCDHAOEBBhAAA.UACEBBAGhAAAdDHAAIGA...cFDGhAIAfDAC........hABA......hACA...,1,4,-43,47
FRaZEKHgVNGBYQfCbXIPJcLWTMOUDedSA,FEHBaDAFZGAGKDEHHGFA..VCGFGBBABFDBQGAA.hAAACDGC.bACF..IAAChACAPAFBLEEBhABAMBEEDEDBeHCEACBAEGGG........hADA.NAEF.....hBDA...,1,-15,-17,2
VCUeAYacfNMDBQEdgIbRJFZKLXSTHGPOW,aHBG..NDHCBEBGdDGB....IFBHRBAGJGBC.FHEALAEBhAAATABG.HEEBGAEHhAAAOAHDCCDAAHIB..fEEBhABADIGEEADB.........hABA......hACA...,1,-25,-31,6
CSZMbBGOTcLJNHKgfaVDeFYWXIQPRAEdU,dFAAUGAFZECCBAEDOBECLCCGHGFGKDDA..aCBHeBBC.FAGGhAAAXEED.QBGFhAAAAIFESDHFhABAMCAF...bGEA.....TECChABA.....hACA...,2,-28,-21,7
AUeHdTDKXNMBQGgYIfWaZCSbEFcRVLPJO,eADGTCCBDHGG.KHDEMFEF.BGAEQABHGACB..IBAGhAAAfFEDZDFDCGHCSAFEhAAAEGCD.FCEBhABAcDAFRCGB.PAHDAFIH.....hAIA......hBAA...,2,-29,-12,17
KPQHgAefLZJdNOFIDEXCVaRWbBTGUcSYM,eEEGLFBBdBAFOCAFDCCECDBD..RGDABADAUAGB....SEHHhAAAMCABKDFFHAGFhAAAfFDA.ZCDA.hABAFFAHEEGAaFCB..WDDF.....hABA......hACA...,1,-25,-34,9
QXGKUMHFacOCWEYSBITDALRJedPNgZVbf,JFFCdDCD....NBCB.ZAAF...VAEGQFGCGDCHMIBGhACAFHAEaBFE...ODFBhAAACEAHEDGEBFDDDCADAEHCLFAAhABA.PHDC.....hADA......hAEA...,2,-36,-24,12
cTeBQNFAYGDHLIOdgfWbRaMCESUKZVPXJ,GDCCDGADHFDFOFABdCFE....gEBBbACGRFGH.CFFA.SCHHhAAAUBCE.VBFBhABAXAAB.JAFGhADATFEDBCHEFHGEAADELHBA..WFABhAEAMBBF....hAFA...,1,-8,-18,10
gZRUJBfNIdVLScWYHXGeOCQFEAKTPDMba,TGBCMCHF..aCADZAEG.UFEABABD...ICCCLBABhAAASAGC.hABA.YFAEHFCCeCEDhAAACEGBQCCGAICGDIFAbGFA......hACA......hADA...,2,-30,-23,7
YBIGHJQMbcZFNTEfCLPDOSAWUeKXadVgR,UDACKAADdCFHRGFEBFEBGEEE.HADE.MDDFZECFFBBG..NHAB.EGAAhAAA.LAEFDAFEACCE.hABA.XCADaAGC.hABA...gEGEIHGE....hACA......hADA...,2,-30,-23,7
eOZAgXdcUBPJEMSQTWVGHfLDYIaRKNFbC,dGFCBHHGJFBHMBEB..QDCG..WCGBGAECLFDAhAAAIDHCRCAGFACHeDAFhAAAAIDE...XABDhABAUGAFPAFAEGHDSAHB..hADA......hAEA...,1,-22,-32,10
EFCeAKafZbXVgdSIYOcDULQBRPWTNJMGH,KAFBaCFCZEEB..VCCBdAGA....SADGIHHAOCFEhAAADCACLEAF.BGGAhAAARFEHTBAFMDDF.GEAEhABAEDHFCABCAHIDXEGA..cGBFhAEA......hAFA...,1,-19,-31,12
RKMBENGfJgZbeSDIOHUFVaXQCcPTWALYd,dDCDKHDCMFCEBAHAEADGGAEG...JACDZGEA.SDHDhAAADEGGHAGDUGFEaBAD.QGAAhAAACEFB..cGBAhABA..PBAFTBFCAEAF.LFAEhACA.....hABA...,2,-23,-23,0
QACdJSfgFEeNbTcLDHaKOMYXRIBGZUVWP,JCAFSHBG.FDEHeHFA..TCAFDFECaEHF..KFHHOGAGhAAAXAFGBDFFUAABhABA..PHCAhABACGCCgBGAECBG.NEAE......LHEEhADAYAHFIECFhAEAGABF,2,-39,-26,13
LKVRdZJEaNSGHFbXTOQgPYAMDeUIfCWcB,DGCGeDACUBDHCFAG.BBABKGEG..dEFBZDFB..ECEH..SEHDhAAAHECFFBBG...XCBHhABAOBFAgGGBhAAAAGBBMFAE.IHACfAHA.LHAAhACA...hABA...,2,-35,-31,4
QbeZUOSGgRfJFdHDVYMBLTIcaKNECWXAP,QCBCeFBBOEFHSHACRDCF.FDFADAHF.VADCBBFALHEAhAAAIADFKABHEHCAhAAACGHB.AAFCZEDAGCEFJHFA.hABAdDAFMBIF.........hABA......hADA...,2,-18,-13,5
bVeGQgMKIEOTWCULdXNDRHYcASfaPZJFB,SAFBaHBGZDCF.FDFEBBCD.eGFGQEBHKEAF.IBBGhAAAEAHBOADA.CAACLCGBhACAdGFEDDBCHADDhABAAEIH.PFHHJBEF........hACA......hADA...,2,-27,-25,2
ZFaUKdEMRIXDHPOYVBQbLgNcWfSeGCJAT,FDAFUFCEdGBEMECCRBAE..DEDCOCDA.BFAELCFG..hAAANBAH...fFFDhABASCAECAGDAGEFaBHFEECBhACAHGFA..PHFA.....hAAA......hABA...,1,-31,-40,9
FOEXTWKgQfURbLJAaSVeCIHcGYBDNPZMd,aEHBSDBD.eDDFHECF.GAEHBEHFDAABNAACZGFGFGHHECFB.hABA.XBBAKCDHfCBChABAUGAELCEBhACAJFAFCEFD.IAFA......hADA......hAEA...,1,-8,-29,21
BLGYgDVCAUXRPTOWIdQcSHMbaKFNfZeEJ,XCCBTFDH..OBBDdBGAQGGEHBFDMFADKGABFAEBZEEGeHFAhAAAEDBFBCAH.LFCFhAAAYCHBDABGAIBAUDDFhABA..RAEB........hACA......hADA...,2,-12,-11,1
FTJcDeKRABZfdgbEQMCXPHOaVNGWSLYIU,ZDBHdHBHEFAGCHEAHEFB..aGEFGAEHLCBAUABDFACF..TEDFhAAADCFGeDFBKDEEAIACBHGEhAAA...fEHEhABAbEAHMCAF.PAEG.NAIE.WDHB..hACA......hAEA...,2,-15,-12,3
OPNgDLHaRKSAJIUEbcfdGCMZWFYQXBeTV,JDACEGFC......fGDECCGAZGCAFFAD.XABBBAEA.VCEEhAAAOGFA..PAHFhAEADEFA.HDBBKBBGACFDhAAAIGAB.bEFA.cAEBMCIF..hAHA......hBAA...,2,-56,-11,45
bcBHRALgNaTCMPOeQJdDKSXWfZUVIFEYG,LGEAaHBG.MCAHeEHFdCCDSBFF..fEFDhAAAUDCDIDAFFFADGABFhABABFADACIDNAIACHCHOBAAhAAADFCB.XGEB......hABA......hACA...,1,-21,-34,13
LRfCMaAQXIJUPHcOFSgEDKZYWNBbGdTeV,QCGCXDACUAABHFAF.FBCE.SAAFDGFDKEEEZBFA..hABANEFABHHBGGAHdDDGTECChADA...VEGFhAEALAFD.fCAAaBDDIAGEhAFA......hAIA...,2,-17,-16,1
LHJIBUZRgOcGdaNCPeEKMDSfWbTVYQAFX,FGDDLADGHDABBGAGRDDGOCBDGABG.aEEACFDC..EHACDIGE..hAAASFGD.hABA.fFHGhADATAAFYDHBACIHXAEAIHEH.ZAGBcDGAhAEANCAE.PFFBhAFA...,2,-28,-11,17
IGOFSWUTHdJgNeXARYcBbQDCKZPafMLVE,RAADBFDGQACACDDHZAAF...aGECMHDELBFE..EBGGICGChAAAFFAEUADDdGAF.hACAJEFAeGFEAAFE...hACA.YEBCDFFAKHAA.fHGF.hAEA......hAGA...,1,-11,-39,28
XfLAFNVPQSEKJadRIeZGCUbWMTgDYcOBH,FCFCVAADQEEC.KFBBdGEG.eAGHZBCBCGHBUDAD..MAIHhAAADGHDOEDBBBBC.hABAXGAAACCFSHEAhACAEEEE...........hAAA......hACA...,2,-37,-34,3
BbdUHfPTGRWOXKFLVDNcgYAeEMSJCQaIZ,MEGFCDGF..aAEGZDCCdBFDHAFD..TBBA..WBAEKGFEFFDHhAAADACE.....hAAANDBG.cFAAAEEG.EFDEhABASHAAIHEEBBED.fBHAhAFA....hAHA...,1,-31,-43,12
XOfALGRYEdHNKFQTDPcWCVBgUaMZSJeIb,LEGHGEDHECCFdCEAKAGBFBBB.DBFA..PEAFCCGC..BEADhAAAaAAEZAEBeHAE..IGDGhAAAOFAEAIFA..hABAYHEG.NCIA.......hABA......hADA...,2,-46,-23,23
fJaRYOFIcKDbVPMNgeSdHXCBLTGWAQEUZ,QFCAZBCFaCGD.RCCCFFGFKGFDDCIF..VAECMIBA..eBAEhAAAHCABBDAEGFAFAGIDECHHhABAUGGE.JADAIHAEhACA..........hADA......hAEA.bEEB.,1,-21,-24,3
JcfYEbWeRLBOXFVPDSMQZTUGgdKHICaNA,JGEA..fHBHEAFE.eBCFBCGCXFEGFBBGDCIF.SFBGhAAAZFCBUEAB.dAEAKDAEhAAAIAHC.NDDBADIFhABA....YEECWFHBOHEC.hABAPEEA.MBBFhACA...,2,-44,-19,25
DTHSaLRCAZNJYebMQOfVUcWgPBFEIdGKX,ZFDFJGEA.eAGD.MBCDQGBF.OAEHVFFFUBDE.hAAA.gDCBhABAFEAHEHBGdAAAXAGCDAIDSDGGhACAaBBCCHDAACAFbCGD.....fDBEhACA...hADA...,2,-21,-18,3
TdKbOCYFcQJfUgMBLSHeGEXIADPZWVaNR,ZFDGVDAGaBFH..RGFE.dBGFKHBA..CADCFECEQAFH.UEFHhAAABDCCLABEeFAHXAAGhABAAGDBDDDC...hAFA..NIEB..OEHF...JCABMAIBhAHA.....hACA...,2,-31,-23,8
DQSACYWcNKXfIGJPgBVHZREadMFOLTUeb,CFDG......YFCANCBG.KCACXEEBGGEFJBFBBAHAhAAAZDAERGBG...EADHaCCAhABAMDHHOADG.TGGChACAeAHBDFBF.AEIBWAACfCFB.hAFA......hAGA...,2,-33,-24,9
FRfaTIPJQVXHKSODUebYLWCgZdAcMNEGB,MCCAGEAHRAFB.aAAC....IGHGJDHDQBEBHDAFOFFHhAAADDCGeHDELEEChABACDGC......hACA.dBHAAAHENACHBACHfFFEPHAA...hAEA......hAFA...,1,-17,-26,9
GSVLYCINbMXAWfFKHJeQETZPDgacRdUOB,FHBGKDBDeFHFQCCEZGBG.DGDE..aAABdCAAUDDHBADF.SFHFhAAALBBECCGG..hACAIABCMDADAAID.HBFFhAFA.TEBGgGEHOHEC...hADA......hAEA...,1,-17,-29,12
RZNAbDJOgEUfICFScWHMaBQeLYVXdGPTK,DEFHJEEG.ODAAUBFG...CBAB.FADG..SBEDHFCHBCCEeGAChAAA.LEAAhABAXFGEdAGH.GEGEhACA.PHCERCAFAABGEGAGfCHG..hADAIHFA.MBIBhAAA.aHAC,1,-23,-28,5
OQZbPUSGcfIEBWdHVKYeTLaNJgCFXDRMA,QAEGZAADUGACGECH..IDFFBDHFdGGFKBHH.eACDhAAAaEAG.JEBGFBFFDFFBAEIF.OHBAhABA..SGEHhAAAfHGH.EDAFHACB..TEGGhADA.NGAFCHAD...hAEA...,1,-9,-29,20
GSVJHbcDgCZEKIFAPUXWNLTeQRadOfBYM,UCGCXCBCLCCE.eAACaDEGdEFBBGGEMIECGGBB..hAAAJBHFHEAEDDADCABAKADGAECF.hAAANFEB.RFCB...fAGFhAFASHAG...bGFA...gACHhABAEDDE..hAFA...,1,-7,-27,20
agEWFPbDGeYMQOBXLNAdRKZVTICfScHUJ,dEHAKDAFZCED..IDBHSGADHFFFUGFEJECD...EHCEFABDhAAA.DBIDeBHH.QCCDhAAABEEENBACAHDHRBFFCCBC.hABA.aEBE..PFAF.....hACA......hADA.GACH.,2,-25,-8,17
VIEKeCXcPDZSdBNGfagJbFLRUWHOAQTMY,TGFBMECG..VACGKFCG..CEED...XGEBDIDAZBAFSCCAhAAAdFACBABCGBGEhAAAaFAF.JFCBFAGF.RAEB.WEHHhAFAAHIB....IDHEcBEE...hAGA......hAHA...,2,-30,-26,4
BXRLCZVGWYdADISbOJePHEUfcMFKgaTNQ,DGHHSHBGOEFD.eEFHHCAC.UBEHMCBGKFAA..aBGD.TDBGhAAABHFDLHBAhAAAZADAGDDEdABFIGHBhABAPCHF.EEAB.FDHDNAEF.......hBAA......hBCA...,2,-26,3,29
OXQIKadHEfYcWbMgRVNDSJTGAeCFUPZBL,FDABZEFHBBCHOBFGQEAF.KHACHCCG.EHDE.fEFAhAAA..YDHDhAAAbABCREGF.NACBDABFhAHA.....TCDGAHCDCCGAPFAEXGDEhAIAIHAH..hACA...,1,-23,-31,8
VLfeWdIEAHMFZRTCNabXUKQDPcSJOGBgY,FAABRBCDCFDG...aAGEUFAEKGEH...QAEGDCCE..PDAHhACAJHFABHDC..VCEChADAeFFE.dBACAIDEMDDHhAEAZAGF...TGAFNEEF...cGGEhAFAOAAA....hAIA...,2,-31,-25,6
RFDedLPIUBfHZcaYgTJCSVNOGQbMXKEWA,FGGEdEGCLDAGUDACHCEEaABH.....TGAACBBCSGAGhAAAVAFH.GFBH.hAAAMIBEXFDHKDCGAEHBDIFChABAeBDBBAEAfHFF....hACA......hADA...,2,-23,-23,0
gVGYdUQMLZbFecRBIPXJDOSWANTEaHKfC,EGFCaEHBHFCEKAGA.CAHE.GADE.dFBEMCECZDAEFABFeEAB.BCBEhAAA.XDDFODFCADAEhAAATACF.fHDHhABAgFDFUGGF......hACA......hAEA...,2,-27,-15,12
TKOZYWSbNgXfeIPABdaCFMJRcLUQDHEGV,BEFAdEHAaDFHMBCB.RBEC.UGCDHGDGGCAEKFABZACF..SHFAhAAA..bFBHXAFDhABA.fADBhACAIHHECAHFJCDFcEGDDFAB...EAABhABA......hAEA...,2,-29,-17,12
dFGDNLXZEPfVaWHBKQReYIMgJTcCbUOSA,GACBDEFHLCCCEEDG..VCFCaAAFBGDCKFHB.RAFD.eGAE.MAAChAFAJCAF..CHEFUFAFhACAAIBEdFGC..NBBC...XGFDhADA...fDDE.hAGA......hAHA...,1,-20,-33,13
NgEAOKPQYbRCecLFXIVSdTGafBJZUHMDW,KDCDQCBCRFDG.eHFAFGBC...IHAESADCGBDHhAAAaBEC.BEFFZAGHUAAChAIAMGFEDACC..NIBB.AIDEYGDAhABA.CFACXCGAdHGB..hAFA......hAGA...,2,-32,-19,13
eHDcZBKATEXLMOfdaFGIUWJVbSNgCPYQR,TFCAEGDDLEEC.MCCBOEFF.dAAFaAGGFCHHGEAAUFAEJAEGhADA..SGFGhAAACCCF.QADChABAeCEFDFID.BCAFAEAA.fFFBWHBA.hAEANDDD......hAIA...,2,-30,-5,25
KBAbgTFCYUMLPSQEfJZXOWIReaVcDNHGd,TCBCCFEDUCFF..LDCFQAFB.JBCAOHFE.RABG..hAAA.aGAEDBGGNAICdDFGADACFEAFhAAAMABE..EHAEXGEAhAGA..IFHCcEGAKEDF.hABABHDD....hBAA...,1,-18,-37,19
NSCDbXcFMWVKPHAZQGEedfRLYBTOgaJIU,QBCFECCGdAADLECFBFGCOEEH..gGADhABAaFBCUAGECAACXFEA.hACAMIDEKDAGAAFFZAEAfDHEhADATDGE.IGHFDDBF.FDFBPFHDhADA.....hAEA...,2,-33,-3,30
IPHYfMcQSCZJVeETRbNdXKFgaWUALDOBG,DBEDGACBHCEBMDHFQGGBZGCE.eBCBEAABRFAHdHBFKDEA.FDAGaAHHhAAA.AGDCBFAA..hABAPFCGfDAAhACACHHA............hADA......hAEA...,2,-24,-24,0
CZgLKaBTAJQPWfbMVDOUNedGERcHXYISF,JDACQCBC....fFHEVAGFDFHHUEDFdBFEECHDHGAEhAAA.XGFDhABASFCHCFACZAEDgGEEhAAAaADDBCAGAEGFbFABMEIDeBAE.....hACA......hADA...,2,-19,-5,14
aBfJKPSFLERTYWAZcOXQMICGdDgeUbVHN,ZFDFODACMCBCGGAHdAED.DFBGUGGEHCDEBHABKACGFAFALDEAhAAARFGB.....TDAFhABAAFFEXDGACACBeFCBhAFA.....NAIEaFFGfBAC.hAHASHDA.hBAA...,2,-19,-19,0
SgKFJRTLAeVUHfaBINDWOdCEXZMGQPYcb,VAEGHEFHBDHA.DIGEdHEHEDEAMADB.GEACQADA.hAAA.PDEBbDAFSHAEhAAAFABDTFGEAIAGfAGAhABAaDGB.NEDGCBBE......hACA......hADA...,1,-16,-21,5
VTJGKfDZENCIBPWFbdaHMUcYeOQXgRLAS,TCCBGAEGDAHB.EEHFCFEHBBGG.FADFdDBGHGFAMGDE.UABEhAAAeEFGQGAChAEA..XFCDhAAALEDASBHBKGHBfHEDNBACWFAH.aCBHhABA......hACA...,2,-27,-10,17
DCWTNGFadLUJOMRKSePcBAQYZVHIfEXbg,ZEFHVGFGHDBH.EACG..XCGEDICECBAB...TDDFFBFHLFADhAAAOFDHMADGhAAASDDBeCABBHAGhABAAAEEICHFgBBBNHBF......hACA......hAHA.aFGA.,2,-23,-20,3
aDJdTOAMXGgIUbSVRNPYCBcKWLQZEeFHf,GEDCUCBC.SDFHVBGH.RACG....PGACBAGCKFGDhAAAQAGAZFBAFEEFaABChACAdGGCOAAB.AHHAMCDHhABAXBDDIEAA..NIEHCDAC..hADA......hAEA...,1,-2,-34,32
FRQDcAEVHgIWNbSaUYTKMOBdXPfGeJZLC,VBCFHAAD..IHAC..bAGBSDDEUFEAKCFH.BBGFhAAAdAAC.fADEhACAeFAFLFCBFDHFDFCAAIEAEDAFhACAWFFGaGGFMEAG.XGEC...hADA......hAEA...,1,-14,-15,1
YZPfHMDedWaRIBVcFJGNOQUXgAETLKbCS,EGDDTGGDKCBH...CCAFZDAEHEEB.MFIDdGDDRCFBBAFE.FHAEJFBBOBABhAAA..QBDFhAAAXEADLAHBhABASAGBfDDC.DCFCaBAAIHGAhACA...hABA...,1,-8,-33,25
OGDICgJfFaKcQBdEMbLVXRPTSHNUZeAYW,OGEAGDCCCACH..JCAFFEGE.KCADQGBEBAAC.MFDGLAGBhACARCDG..TAGAhAAANGEF.UABFAEBADFAHfHDBhACAdGBA..EBBB.....hAEA......hAFA...,1,-24,-35,11
baOLJDCHGZMXYUdEKcFQAfTeBNISWgVPR,TDACeAFBBCED..SEEDVEFERBBD.aHDCLABE.hAAADDBBCAFGHBCAZAGHMFCHhAAAUDFA.dGGC.EBGCKGHBhAIAcBABAEEG.fHAH...hBAA......hBDA...,1,-8,-24,16
IXFVgBDNdQKRYJSWcHeZTUfEbLAaCPMGO,CFEDGBGA.OAAEXBFBFGBEBCCA.DGFGNDAH...dEACKECFhAAARECE.SCHFhABA.HFAF.eFHHhACA.TDEEfCEFLBBAaGHDMIAEhAAAIHFH....hADA...,1,-26,-30,4
WdgFXJURETYbGZecVAHOMKDSLBafQCINP,MAGDSGCDBEEE.QABDCEAG..IABE..hAAAWEGFdHDDFDBCXAGEhAAAJFCC.RAEBTEDFhABAGCGEeBCAcDADAIAAKGHBDFIFaHFC.fGAEhADA....hAEA...,2,-29,-19,10
MFULCfORBcSQAXEKPVYIDeaHTJdgZWNbG,EFHBKCFC....VCCCIEFH.DAEAHFEEdDBCZFCB..bDADhAAAMADBFABC.UAACfHFFhADABBGG.SAEEhAHAABIDPHEA.YHBC...TDGEhAIAWDEE....hBAA...,2,-31,-25,6
gHSdBXaGRDZVIQMTPNEfOUcAYeJbFLWCK,eEEGFDCDCGEE.KCBCHCGBdAGABDHAGABB.DGAEZGEE..QCAGhAAAMBDE..TEAFhAAAEHGEfBFHOCECAABC.hADAJHAE...........hAEA......hAFA...,2,-35,-16,19
CSTRVMQOBaWHgdYIGEJDebNUKALPcfXZF,LGEA..cAADZCABSDCB.VCFDMAIHBGBFhAAAWCEHHACG.gAGEhABAYHAAIAFBhAAAEHCEDIAA.NCHAKEAFfEEGXGEF.hACAFCCH.CADC....hADA...,1,-13,-24,11
WZLRPYIGOJCebESFKMHUAcgBfVDNdaXQT,BFDGDHCEdGFBQAGFZDACLBFHRCDG....IBCEOABAJFABhAAAeACE.EFGESCCGhAFAKBAFMICGADHF..hAAA.fGGENICH.TFAEWEEG..hABA......hAFA...,1,-22,-35,13
KMGgcXeYfERFPJOZIWDSHUTdQNaCLbVAB,MAEEGAFE..XAADeDACEADA.FFFCODDGZFBGDCAEUFBFdHDB.hAAAaEFDCDEC...bDACAECCBAHFhABA.KGHBYCHFhAAA..fCHA...hACA......hADA...,2,-33,-21,12
bFLGTJfZEPSDYBdNAaCKcIHgWRUQMeXOV,aEHBKEGDHCBB.RADFUGADMABDeACF.OAGBFAABLEHHhACAGGEFTEBFJFDH.ZDDHhAAA..EBGBDAEBBEEGhADAADHGCHAH............hAFA......hAGA...,1,-15,-25,10
THLcdYbOIBWgCXKSJaPFMAVUeZERDNQfG,UBDGeDCHZGAEEHGC.DCEB..QGDDGAACLHFAdCAGOAHFhAAAIFFEBGFBCGAHKAFFSFAEhABA.aDGChACAMIBGACHF.VBGBNFEB.fEAE.hADA......hAEA...,2,-22,-14,8
bNfCOHcPEaJVSWeMTKgLRFAZIBUGXdDQY,BFDDGABHdBFHDGIBQGGG..bGACCCDCHAACEBGG.JEABSCCDhAAA.MFHBhABA.KEEERGBEZDEAICFGhACA...YHDG...hAAA......hABA...,2,-34,-19,15
FJZcYKTfEHDPeWRBMNaXGLSOVQgdCUAbI,FHBGJFBBZDCFKDAE....EEFDDCCE..eHEABGFE.MBFBaCGALBBChAAA.SFBEhABA.OEAHhACAVAGF.QCEDCCAEAEHFIABF...hADA..YADEhAAAfEHE.,1,-28,-53,25
bCDJVRIHBYLMTUgcGXESQPFfZNdeOAWaK,aAFBCFEDDECH..RCAEBHAGLGAG..UEGDGAFGEGDB.QACGhAAAFCGFZAAE.dEHGAHGFKEAHhAAAbCBG....JHDEIHHGhABA.MFFB......hACA......hAEA...,2,-31,-25,6
YaRUcWKZFCTIPGDfbBQHSJEAONeLdXgMV,OEEGeEEGdABF.MGACaBBH..RGDG.UAECKGABZACEFCHB...CFGF.TCCFhAAA..IAGChAAADHAABHGHHEACJGEEAEBAhAHANDEB............hAIA......hBAA...,1,-29,-31,2
QOAXREJdHcVFSNGCbBZagUPTfLeYDMIWK,EDAFJDCHHEFEFGCA.GGDFCACG.BACBZEEFUBGC..TBAHhAAALCCHDAIBMAFBKCEEAIFA.hAAAdHAH.SAGDhABAaHAA...fEAEIBAF.WDDBhAEAXGGB...hAHA...,2,-33,-21,12
WIOdRSLQPCUgBTcZADEMXKeVJbGHfNaFY,MBHHXGGDKECE...JBGFHAAE.aFEEFEBA....IHHEhAAAOABDdFEARGAGQADGhACACAHABAEAZGAEACCFDEIHhAFAEDDG.eBFH.........hAAA......hABA...,1,-14,-39,25
CBORbQHSKFTNUGDAMZLEcYXJagWVIefdP,LAABEHBG.XAEEaADF..gAACVFFB.eFHFhAAAPCGDBGED.OAFFhAFAQFAGKDDFTDGAhAHANEAFDCIHAEFB.ZACBJDBFIFDEdGFE...hAIA.CCCC.....hBDA...,1,-11,-14,3
QHPKfXIAScYTBEdOZNRgJbLCeWaUVMGFD,SHBGTCBC.BFFHOAFFRCBD.JBHFCEHG...eGEEaFEHUAFChAAAMIBGFEADHABCKECBXEADhABAAAAF.EDFAdACFhABA.NHAD...........hAFA......hAHA...,1,-21,-25,4
VQAYTXfHUBIWSOPERcGgebaLMFZCDdKJN,TCGCHEFHUCBC.BCFESEBCOFAHRFBAGBCH.eCAGhAAAaBDF.MGACCAAG.KGGB.hABANAEFAHFHfFHChACA.IHDEWFFEPHBE.EABE..hADA......hBAA...,1,-14,-26,12
gZdROHNaGDFebLCWVMKQPASIJfUXBETYc,JCCHUCGCBFGCEFHF......TBCA..cFDEZAEBdFFChAAAOBHHHEABNIDDaBCADACGhABA..FDABeHAACBFF.hAAAMEEFKGAFAIFA.SCFHIAHA...hBAAfHGD.hBBA...,2,-43,-9,34
gfQbSeZaGBMcDRNJLCOVKAdEHTIUYWXFP,dEHATCCBUDBE....XFAFFGCE..fBCDhAAAQDFDeFFBaCADBACGhAAADADERAFDLBADCCGBOFHFAFGHhABAEAHBYHBG.WADE...gFCChAHA..hAIA...,2,-24,-24,0
DRACFaTbNPHXcGBZUJEKfWMOYdeLSgQIV,CEFAaFAA....TFDC..PACEXBDAGGBH.ZDFDhAAAJAHHKDDAMACGdCADSGHDhABAQBABDDHHhAAAAFIHFBGANEBH.BCEB..EGAE.fGGAhABA.....hACA...,1,-22,-24,2
WZGfcHBRMXFIPeKAQbDYdSNLCTUaEVOgJ,QAFBDACBdGHALEEDUEFG..EGABODAD..JBCF.ZEBChAAAfAGABGHHMHCChABA.FCABeCHFAIFGSCGAhACACECBVADH..gFFD.cGAEhAAA....hABA...,1,-20,-34,14
RVTQPAZgJYLFDOKUWfMcNdSCEGIHbBaXe,ZFDFJGEALEDFOEABKGGH..UEAB..MADAdBGECCDEGCBAhAAAHAAC.BBDA.aHBCXGADhAAA..VBGBhABAPEFAAGIFFFFBDFIHfDDBSBEBEABFhAHA......hAIA...,1,-19,-23,4
VNKIJcbZLEXSTAfCDMYgBeFWPdGHQaORU,CAEDMCHFBGEGFBDC..dCGDGDAEHDDEOFCFRFEBUBAB...KHAAJAEAhAAAZBAFLDDE.hAAAEGCBSAGBhABA.fFGB.gGGGhACAWEHH.PACD..hAFA...,2,-31,-21,10
TKfENgaDBZdLIHJFQObAXCcMVUPGReWYS,CHHGMECGUGEGRFAG....eHFASAADKACG..EFFFaDDGBDFEhAAALFCBJAFG.OBEChABAXBAC..PEABhACA..WCFEfADHDDCEdEHE.IEHHhADA.QBBChAGA,1,-23,-37,14
gKBFdAYcOZXGQbPVTLUWDHCaJSIEfNeMR,OGEAXBCFGACG.QFBDVGDEUBFFDIDEHFAH.JEFEhAAASAEB.hABAEBADfDABhACAeEFGMAHDKECG.FGGAAIAA........hADA......hAEA...,2,-18,-17,1
