aBfVIeDHLdZMYGQATSNEXCWgRKbOPJUcF,TAAAEAAA..CACARADFOACA..UAFAaAFDBAHA.VCCAhAAAeBHH.HDDCZCGBGFBBhAHAACCBXEGAKDBDbGEAhBDAPGDA...FGHHDDIBdHBB....hAAA......hAIA...,1,-3,-17,14
LKCXEUQcRPAYTFSOVgWBMHJafIGedDNbZ,TAAAOAAA....VADABACBHAGBaADDGAFAeBBBdDDADAIBZDEBhAGALDDBCDHA.EDHBhAAAQGFARFABAAFB.hAHA.SCCDMFIB.fFFAhBHANIAB.KGHB....hCAA...,2,-16,-3,13
RVXYfNOaDSPgHTWebAIKFBJELdcGMQZCU,FAAAEAAAdADAGACAZAEB.RAEA.....XAGAfBHA.aCEEhAEASBCD.hAFAHCFBeDHFACHBBDBDhAAALEEBMDIBQGGBCEEDYFGBDHAAPHAAhAHAWHAA.....hAHA...,2,-19,-12,7
BFRPbMZKXdLEOfIaNWUVTAGCSJYHcDegQ,GAAASAAAHADAeACHQAGCBAEARAFF.bCDCZCGB..dDHAECEBhAAAfEEA.hABAaDAHUEAAAAABCFCAcFGChACAFDDHMDIB.LGEAOHEC.IHAAhAEA......hAHA...,1,14,-13,27
QGKcPTAWLaRfMNbHDUOeSCYVXFJdEIZBg,aAAARAAAMADAHACB.OAEAeAFA...CAHA.XBDDdBEAZCFBQFGAhBAAGCFAKBHBTFCAhAAAABBBLEED.fCHAhCAAbFGDSCCD.FHDE.EEEB..hABA......hCAA...,2,-8,-5,3
ZDcGHRJAWYKBVeQOCLSTbUMEXgdfINFaP,KAAAeAAAQACCLAEASAHHUAEA.EBCFdAHA.fDDAhAAAFCEAZDDAGEGAhAAAHDGBABGABDHBCEFC.bFAAMGDAhCAA...IHHAaFFHDFAA....hCBA......hDAA...,2,-26,1,27
DQEabPYWHAGfFKcMgVXIOUZLJBNedTCSR,GAAAKAAAMACA..XADAOAEEZBDALAGBBAHB.eCDBdCHA.hAAATEGARDDA.EEABaCCChCAA..bDED.PECBhAAAHFFAAFHAFGHD.........hCBA......hDAA...,1,6,-27,33
eMYJaAfOHFBCTRVZQLPNdSEKUIDgWGXcb,HAAACAAARACA.ZADBLAFBdAGAECAB.KAHBDAIBGCAA..XCEDhAAAeCCA.MCCBaCGDAACAFDGAhACABEEATFFA.QFBBhADASDHHIHHAgFGG.hBFAWHAA....hAAA...,1,4,-32,36
feODJCaAILKVURGYXMSgcZQNWTbBHPdEF,LAAAKAAARACFGAEAMAEA...SAGAZAGBQCAC.hABATEDAHBCCECABeCHHhAAADCGACFGD.ADDBIDFAhACA.UFBAXEAAgDGHcGAAbFFAhBFABGEA.FGHDOEEBhCBA..,1,3,-11,14
aWfdGFVCUZgKJQcEMBXObeLDYHTRINPSA,aAAAdAAAGADA.CAFAZABBKADAQAFC.EBBBMAHBOAHDhADAeCFFLDDAhAHAHEFBRFAAIEHASDGHhBAAAAIB.FECH.gFDHBHHADDDBNICBfFHAhCAA....hCDA...,2,-16,-7,9
HSCZWdQfFXDTeacEJRbNVLPYKUAgGMIBO,GAAAMAAABADAHADAZAEBdAGA.QCDBFAGDDAIB.eBHH.EDFFhAAARBBB.VFAALDGBhBAAKEHBADABOFGBCECA..hACAXEEB.aFHD......hBBA......hCAA...,1,10,-38,48
aCHPMJgbNVOKDITYdGcARUeFZBXLfEWSQ,RAAAeAAAZADBLAGBEADA..QAFAHCEBMAIBbCCAOCCHhAAADAIB..TDGAGEGAhABAAAAABECAfDAAhADAaEECCFHAPGDAgFBAKHBAIHHAcGCDFGFHhBFA......hBGA...,1,6,0,6
XYAcGCPVOEgHeRDWKbUTJSfQFNIZaBMdL,GAAACAAA.OADAHACARAFFKAGAUCAA..TCDASAHBhAAAQCFCFCDDZDFAaCHDdFAAhACALFFAACHB.PDCBhAAAEFFADGHBJHCA.fHFB.BHHBhACAMIDA....hAEA...,1,3,-19,22
SYcfRTBOIgXUMdaFGCPAVNEWHLbDeJQKZ,EAAAHAAALADAeACEQAFCZAGB.SAHBfBCERCCATCGAhAAAOCDDXDFChAAAdEEAGGEBAAEAVFCBhBIA...bFGBDEIB.......hCAA......hCBA...,2,-13,6,19
VHDQZWKfAYCLXTagGPUEcFbIOSBNdReJM,LAAAaAAAGACAEAEAFAEA..OAGDBAHARCEAeCAA..MBBBhAHAHCEBZEBEfDHAhABAACHACDHA.TEAAUFFA.hBAAbECDSGEDdFGDDAIB......hBEA......hCAA...,1,6,-21,27
LPdQNXVcTOgUbKBMfHWFSZACaeDRJEYGI,eAAARAAAEADE.GADALAFBdAFBQBGB..XCCAhAAATDBAODFBbBGDMAIBhABAHEGBSEFDhAHAAAAAaGDBDIAAIFCANIEB.gGFA.hAIA......hBDA...,1,-2,-6,4
MOCBNZYUHbSLXWReaAEQfFPJDcgTIdGKV,EAAAQAAAFACD.DADA..TAEAGAEBMAHBBBDDZCDEHCDChAAALEABRCGFAAHAJEEFgDGAhAAAdGGA.OECBhAEANEIA.UGGA.bEED......hAGA......hAIA...,1,-5,-16,11
BcLEHWUDCGTFgOVSMeZKJQNYdfaIRAXbP,XAAABAAAEACAHAEADADA.GCAAFAFD.OAHDMAHBZBCB.QDFChAAAdCCBaCFDAAGA..hABAbDGDLEED.hAAACFGA.TFDASGHHKDDDNIEB.....hACA......hCAA...,2,-22,-4,18
MZLBgHcRUXDWaJbVNeOKCfYPdEGFTIQSA,ZAAALAAAHAEARCAADAEA..aAGAVAGB..eCEACBDA...fCHAhABAdCAAECCBGCEAhABATECAQEGAhACAAACAMEABBEEBgFBAXEGAbGDAKGEA.FHGEhAEAIHHA..hAIA...,1,7,-14,21
FbCXaIAeUNYBdSLMTHRgVQOPcEKGfJWZD,eAAAUAAABADAdAEAMAGBHAEB.RAGB...QBCAOCBEEDABGCGAhAAA.JDEBZDFEbGFAhABAaEEH.AAIB..SFHBhADALHAA.TGAA...gGDGhAGA.cGGChBAA..,2,-17,-9,8
ICWPNUEZXTHSJYdLAMGgFbeDVOKfcBaQR,GAAAFAAAeACHOADAKAEA.BAGARAGF.CBHA.....PCEBhAEAECDAZDCAHDFBSCGDhAAAdEHAACIBMDDBDDIBfFDAhACAaFCH.QFGCIGAANIAB..hAGA......hAIA...,2,-20,-17,3
ABZHQUcTOJeWbdDFYNGKVgLCRIMaPXSfE,HAAAQAAATAEAeACAdAGAFCAHGAFAKCCALDFARCDBMAIBaDAASEAAhAAA.AAIBZECBhACAODGD.bFBBDFFAhADAYFFFgFGACHAAIHHAfHDFhAEA......hCCA...,2,-4,6,10
CRbVLaJNgMDGeTIOdWQAPYBZSXFHUKEcf,BAAAZAAAFADAHACAKAGA.EAFE..CCAA.RCAALAHB..aCCCgCEAhAAAGCEAeCGBhABATECAdECA..ACHA.SEADhACAUGGA.bEGBNIAB.MFFB.DGGBOGAChACA....hAGA...,1,2,-23,25
fUbBQRCFSATPWeLDHVGgcYaNMXZEOIdKJ,TAAAeAAAHADA.GAGA..gACBaCCBMCFBEDDBdAFAfAHAhAAABEGDRFAASEHHhAAAACCBLDDADGGB.hABAcDGDXGDAZEAAKFFD.bFDDCHHA.FGHB.hAFAPHAA...hAGA...,1,9,0,9
ZeSTEgQObJDLNdVfKPcHYAIFaXBWCGRMU,aAAABAAAGACARACAZAFB...eAEAEAHF.QBGAOCAB.bCEDLCEDhAAA.dDHAKEAAhAEAHFAAABBBXEGBhAFAMCCBTGEADFIBfGDA.cGGChAIAFGGACEGC......hBAA...,2,-9,-4,5
HOQZdEPgVRACaUTDMNXLcSGKYFIJfBbeW,aAAATAAA..MADALACBGAGAFAEAJBBFBAHA.eBEBHBEBhAIAZCFBEDDB..gEDDhAAAABEBDDIBXFFAhBAAKCHBfEHEbGBA.QGGC.hBDAdHAB.....hBGA...,2,-14,0,14
UEZdgIacXbMJQfHKYRFPNLDTWCVABOGeS,GAAAeAAAEADAdADA.aAFA..XAFA.MAIBQBFChAAAHCCARCFFFECHLDDBhACATFGACCHAAAIBSEEDhAAAZFEBgGGAbGACKHEAYDBB.DEHBBEHBhABA.....hBAA...,2,-16,17,33
VNXHFZCcRGLJOKQeWUMBSYTIfPdEbgDaA,XAAAHAAAZADBRAFAGADALCCD.KCADeAFAUDGAMBIB.SCFAhAAATDEA.fDAAhABAEGAADGGAACHA.FEFAhADACHHA.ODBD.QGAC.BFFDhAFA.IGHAhAGA...,1,-9,-15,6
BVeWMRYDSPdOcNfbIQFJZGCALaKHUTXEg,aAAAHAAA.TAEAEADABAFAeAGH..RAGFDBBBdCADOBHD.fCEEhAAAbCCA.QDCDhACAZDAAACCALEEAhADAXEADgFGAMEGBSEHDhADAcGDANIAB.IHHA.hAIA...,2,-22,13,35
YNcELaVAPMFSZfdHJQbRDOeWXCKIUBgGT,MAAAZAAAHAEA.QCAARACAeAFE.CAHBKCDABBBD.GBEB.hABATDDANCGALCHBhACAADHASEGAdEEADEABXGAAhADAgFDAEGHBaGGAFHDAJHEE....hAIA......hBAA...,2,-18,3,21
VgaMYeDbLEXBKANJPTIdWZROUFGHcfCQS,JAAATAAA..dADARACFFAEAHAFA.CCCD.QBGA.SCADhAAAaCEDeCGFLEHBhAFAECEBKDGDAAHA..IFCAhACAOEDB.UFFBfFFEMEEBDEIBBHAAhAHANICB.WHFG...hCFA...,2,-24,-11,13
HcAVJOSTZeDYGgNFadRWCMbXUEBQLIPfK,OAAAZAAAeACEGADAFAFA.RAFA.MAIBUDBABCCDLCHB..hAFAfCEAHDEBABBBSGAAhAGATDFADECBgGDBhAIAdFFDCGCA.EGGAIHHA.KHDAhABA......hCAA...,1,3,-27,30
bNcGFWKMSOQRHEaBUdCIJXVPLfYDAegTZ,eAAAZAAA....bADBGADA.KAFAMAGBQCFAHCAAEAHBhABAaAHFdDFDCCCD.JEEFXDBChAAALFBBDDIBADIBTGGAhACAFEFHOFAB.BFHD.IHDAhABA......hAFA...,2,-17,-4,13
EFBCaDAGPVRHbfgOeWcSLNMIQdZXKYTJU,GAAARAAAHADB...bADAOAFA.eBFGSAHBMCCBdDAAZCDAhAAAKDDDTECAUDGAEFDAhAAACCHDAADA..VEGB.fFAAhACAgGEALEEBIHHAYHBAhAFA....hBAA...,2,-6,-2,4
fKTHFAcDGBCSgRNEUbJOIePaMZVWXdLQY,GAAASAAARADAEAGEUADA..OCDBeAFAMBIBZCEB..XCGAhAAAdCGALDBAhAAAQEABKEFDHFDBAADABEGAhACACCCDgGAAbGEAIHCAaGGA....hAIA......hBAA...,2,-8,-2,6
VcJZHXGFNOWYLUeafETdBDICSbKAQMgRP,MAAARAAA..VAEAZABEHAEBGCCAOAGFLAHBeCCB.EDGBdDAAhAAADAIBSEFAhABA.ACCBQGDAhADAgEDHcFGCFFHD.YGAAaGGHBHCD.hAGA......hBAA...,2,-17,2,19
IMFYJXTGUQOaSNVKPCEHfZLecDWAgRdBb,RAAAdAAABADBMADAFAFA..JAGBGBDB.UDEBaBDA....SBHHhACAKCCDECHFHFFChAAAZCBBeDDBDIAA.ADFBIEHAhAIA.TFFANIEB...CHHA..hABA......hAIA...,2,-26,-23,3
CTWRVMfQOSAGFEPKdaJgXYbUNeBHIDZLc,EAAAdAAAaADA..XACAUAGABBDAHAFAZCCALCCA.TCGAhAAARDFFMDBBQDAChADAADHAGGBB.KEEAJHFEbFAAhAFA.eEHFDEEBCFCCfGEA.FHAA.hACA......hBAA...,1,22,-24,46
CFKNcHPVdJBTLEMQIAGSRZUWYfOgXaeDb,RAAAZAAAUADA..fADBOAFC...aAFAeCCB.CCFAKCHBhAAAHBEC.dCAABEEAECCBMAIBhABAAAHAGEGASDFAhACA.gEEGDGEBFGFH.PEHDhDAA.JFDF....hDEA...,2,-30,-6,24
OBMHLSZeWFUJRcCDAQKGaNVPfbTYdXIgE,GAAAaAAA..VADAbADA...dAGAXBGDEBBB.BAHBHDAAhADAZCDBeBHHFDCBREGBDDDAAAABQFAChACAKDFB.hAIAfFEATFGAYEEF...hADA......hAEA...,2,-11,-9,2
EgGdHAVWXTcfJSMPCFNQYODZeLIKbaUBR,XAAATAAA..JACAMADA..FAFAQAGADAIBZCCALCFBhAAAbBCDBBEA.ECFFdDHAhCAAHDGBAECA...cEBChAAASECACFFDNIBB.eHCAaGEC.gGGAhCDA....hCEA...,1,2,-23,25
RZLeDMUEKWAdcYFBIgSTfVHOaPNJXbQCG,dAAAFAAABADASADA..TAFAHAFBaAHF..JBHBbABDGCCAhADARDCA.eCFBMDABhADAEEHFADHA...IFAAhAFAfEFAOEFHXEGDCGHALHAAhAHAKFDBYHBA..hAEA...,2,-15,-10,5
MXIKfcaHVFNEYZPQdWGLDOTeAbRUSJBCg,RAAASAAACADB.MADAKAFA..aAHDHAFC.FBCDECCAZCEAdCFAGEBAhAAALDEDTEEAhABAAAAAUFAABEHA.XGEAhAIA.IHHAfDHA.cFFAhAFA...YHDAhAHA.,2,-43,2,45
XgVLCKEfHQGBZWDNFIPcJaUMARSbOeYTd,RAAAOAAAeADE.dAEA..XAGBLAGBEBDFHBCB.GEBAhAIAZCEBDBIBFDFH.IEHAhBAAcDGA.aEEH.ABBBSGGAhBEAbFGD..TGEA.CEDC..hBGA......hBIA...,2,-13,-10,3
VMFaKeNgJDXOWfbRdLYZTAcUPEQGIHCSB,UAAAEAAAGACAHADABAGBMAEA.KBHB..eAHFJCDF.OBED.hADA..bCFDRCFBdFAAZEBAACBBhAAAQFCCSCHHhBCAaEHDDFIB.fGBALHFA.cGGChBEACFFDNIAB......hBGA...,2,-13,-3,10
QcLPXAZfEJUFBCMdRWVeOTDbgSGaHYNIK,EAAAFAAAMADARACA..eAFEDAHB...SBEAHBCA.ICHAhAAAQCFD.LEBAhAIAACCBZDAAUEEAdEGDOFFBhBAAbGDC.aGBAKHGA......hADA......hAIA...,1,-18,-20,2
LcKNDIgedGFYMECBPTUOWAbRaQZVfXHSJ,RAAAZAAA..XADBHAEALAHBKAFA.DACAeAHHGCCBMCCBEEFAhABABDDATFGAOCGHhAAAACGAaFEHQFCAhABA.SFFAcGAANIEB.dHAB.CGHA...hAHA......hCAA...,2,-15,0,15
NdWLCDMSGaBOfRPVJXeFQZAYIEcTKUHbg,EAAATAAAHACA.....bAFBdACALBHBMAEAaAGEOCCBhAAARBDFJCFB.eDEBZCGBADIBIEAAhAEAKFBA.UGEB.hAAAgFCFCFHASGGDBHHA....hAIA......hCAA...,1,2,-21,23
AKaTYBJMCUfQVHcIdLFbDEOWgSXeRPGZN,aAAATAAABADA..MACACAFA..UCCAQAFAHAGB.dBDALDABhADAbCED.ECFBOAHFhAAASDHHRDGBZGDAACCAhCAAKEFD.JHEA...fGGBIHHA.hDAADIAA.....hDBA...,2,-18,-9,9
DGgHUPLQCFafTXRZBKWbOdAeJSMEcIYNV,eAAAMAAA.EADA..IAEA..VAFAGAFAHCCALAHBhBAAQDFAaBBATCDAhBHARECAKDHB.OCCHhCAAAAAASGGAcEFCDEIB.PHEA..hCBA......hDAA...,1,-12,-13,1
gHGOAYVZaCceNdLJQRWfbMXTFSUDEKIBP,ZAAAaAAA.eACEdADALAFARAFF..bCCCMBBB.FCCHDAIBECFABCHDhABA.HECAAAGACCHA.JEGBhAFAQEDA.hAHAXFFBSFHHKFCDIHEAgGEDhCAA......hCBA...,2,-17,-17,0
CTKUBYaXIEQcFdLDNPZfJSVOAgeMGbWHR,eAAAGAAAHADARADAKAGCBAGB.aAHDEBHFQCCCdCDDLEAADCFBZDFBhAAASCGDADIB.hABAMDIBbEGD..TFAAhAFAXEECFGCDNEEAfFGA...hCAA......hCBA...,1,1,-13,14
MeAfRdBGKSUQNECTXFPWHIaZgLOJbDVYc,RAAAGAAAKADC.QADAEAFA.CAFAFAHBHBFCZCDALCCB.hAAAbEDDDCIB.VEEBMDGBhAAAADABdGCASFGHhABA.NDIA.PEHB.......hAIA......hBIA...,2,-17,-13,4
OAIdQYgabNDGPJLTUVHSfMFCWcZKEeXRB,dAAAQAAAaADA.DADAGAFALAGBTCBAHBDA.MAIBCAHAZDEFhACAEDBARDGF.ABFA..gDFGhAAAbEBA.PEEBhBCAJHAASFHHFFHD......hAHA......hBAA...,2,-12,0,12
fEJZSUCcHKRXFeGQNPWDBgOYLMTAbVaId,aAAAdAAAEADAZACB..UAFAHAFA.RCAAFCEBGDEA.QDGAhAIA..PCGDBBBDOEBAhBAAMCIBAAHAbFEBfFBAhBEACGGA.XGDD....hBFA......hBHA...,2,-19,-19,0
bEHSUDMVNFWTfRZeCQJOaIAcLdKBgXYPG,dAAABAAA..XADAGACAHAEADAGAMBGBFBHDTCAA.RCFBZEAAhAAAeBHB.QCBAhACAaEEBAACBLFFAKDADgDDBhADA.bDGDEGAASFDDhAEANIABCHFAIHHAcGFC..hBAA...,2,-22,6,28
JXeTPQNGABfaZUIHWFVLRSMEOKgdDYCcb,aAAAZAAAHAEA.FBHDRACFEAEEKCAA..dCEDCAGB...JDDFeAHH.TCEAhBAAQEAAGECAhBBAAACABEHAIEHALFFBhABAMFFBDGGA..bGAA.....hCAA......hCBA...,2,-18,-15,3
JCEWGZdKfYHIBUbVLaMTSXeNRDcAFgQPO,QAAAOAAA.EACAZADB.dAGAKAEAHCEBBAGBVDBBMAIB.SCDAhAAAeBHHRFGBABBBFGBHhAIAJCGBGECA.fEEEhCAAIGDA.LFHBaGFH...hBAA......hBDA...,1,-7,-10,3
GICQHaeOVYXfLWNAbgMZEKRdTBPFDJcUS,MAAAEAAARACA.dAEABAFBDAGA...UCCBGBBA.QBGAhBAAHAGBeCFBODEBXDADhAAALDFBAAIBZEGBTFEAhADAFEHBSEBD.aGBE.fGHAhBBANIDB.....hCAA...,1,-5,-12,7
WGcLbDIfBTPSYJdZMAOEXFNgRUHVaeKCQ,EAAAFAAARACFHACA.eAEEQAECGCCBLAHBDAGABBGA.TEFAhAAA.SEHBhCAAdDEAABIBXDGAgFCAhCBAaFGB.CGHDWHCA..IGDA.hCCAfHGF.hCFA...,1,7,-38,45
HaNIEdPFgfARWGTYLcJCbXKeSDMVOUZQB,RAAAGAAALADBCADAKAFAeAFA..MAIBOBHDZCDAHDGB.aDAHhAAAECFA.dCCCFECAAAAATEEAhAFAJFCF..bFEDDEHBhAGA.QFCCBGGDIHAAfGGEhCAA......hCFA...,2,-16,-7,9
ZIQUETFdWONMJfagGHXbBPLSCAceVDRYK,eAAARAAAZADBUAGAEADAdAGA...OBEDMBFB...aBHDHDAABCCAhAAALDGBADGBDECAKEGATGBAhAAAFFFH.JEEF..hABAfGBA.......hADA......hBGA...,2,-27,-20,7
ZSQdKXDMVLNCRgBYWFcHOaJbPfTeIUAEG,EAAAZAAAdAEADADA.MAGBLAGB..RCAABAHAFBCAHCEBOCGDaCCC.hAAA..JDEB..bEGDhAIA..TEBAeFBAABFAhBIAQFGBXGCACGFC..YHAAhABA......hACA...,1,-6,-28,22
LDMeFRPWSGCOdNaHXQIKYTgVfcUBbZJEA,MAAARAAA..SADBGACBdAGAHAFAQCCCKCCATCGAVDFAhAFAUEEAZFCA.AAAAeEHFhAFAFGGACEED.aFCB...IHAAhAHA.........hAIA......hBAA...,2,-21,-7,14
NRECLIVcQbMZJgeXdDaSFGOWHBYfTAUKP,KAAARAAAEADELACB..IAGAQAEAZBFE.eAHBdCCAaDFDhAAAGCGAHEDBBCEDTFAAhABAAEAAPEEB.CGBA.hAAAcGGAMFIBXGFDFDHB.OEAEhAEA......hAIA...,2,-11,-2,9
RgNdJXYOAcWeTSKUFGZVMbBIHPDQfELCa,eAAATAAAKADA.GAFAZACBMAFABAHAHBEADCCA.ECABLDDBhAAA.RFAB.dBHA.XDEAhAAAACIBSDFDFEBDbEGDhACAQFGAaEDC.JHDAOGBE..hBEA......hBGA...,2,-15,2,17
fJdZDbcOBAaPQENYHURMgSGTeFLCIKXVW,aAAAEAAAHACA.RAFF.MADAGCDAeAFALAHBKBBD..XBEChBAAfEAAZCFEbDBDhBDABCCD.AAEAQFFAhAAAUEEBSEHBCEHBIHCAJHCAdHGBDGIB..hCAA......hCBA...,1,0,-5,5
VDITdPXZHEKFLSJcaGWBYQNeMgAOCRbUf,RAAAUAAADADA.dADAZAEEHAFA.FCEDLCCA.SAHHhAAAaCGDGDBABCGDQFFAhAFAeDHFAEEA.CFHA..fGDAhAHATGAAEEFF.KGGD.....WFHHhABAMIEA....hAIA...,2,-20,-17,3
NAeKOQUWMRVacYCHEDSdFgLTfJbBZIPGX,eAAAQAAAMAEARBCAaACE....CAHAHBFBEAFAdBHALCHBhAAA.TDBAbCDAZDAAGEDAhABAACDAOEEBVGFADEIBhAAAFFBHfFAA.BFCD.XFGDhADA.KHCA..hAFA...,1,11,-11,22
XdbceSIWTAZfHCDKNFVMBUGRJgOPEQYaL,HAAAKAAAFACAMACAGAEARAEA..OAHDEAGA.aCCAdCCA.eBHFSCFHhAAA.TEGAhAHAADGBZEEADDIBBDDDgGAAhAAAQFDAXGGAIHHA.CHDD..hAGA......hCAA...,1,-3,-21,18
DJMgQdRHNFAIbPSVBUfOYeCEWLcXGKaTZ,..IAAAbAAA..SAEABACAOADDeAGH.ECAALAFAhACAGCDAaBHDZCEBMCCBhAGAdEAAHFCBACHAUDGACFFAWFHBhAAAKDDDTGEADGHB.QGGCFHEE.hABAfHAB.hACA...,2,-12,6,18
RAaNJXDCYVHFIUZLTdPfgGQBEWMKSbeOc,aAAAXAAA.DADACADAHAEB.FAGAZADEdCCA..fAHAhAAAGCGAEDAAMCEBKEDAeFGDhADARCFBACIBJEHB..IGBAhBAATFCA.QGDASFEH.OHAChABA.....hBBA...,1,-10,-13,3
IBXPdFGRAYcUaKWTgbONDQLeZCVfHMJSE,UAAAaAAA.KADA..TADAOAFA..QAFCeBFFZCBE.fBBEhADAHCGBMDABEBHFhAHABEEDdDDAREGBABIB.cFDDhAIA..bGDADDIBCHHA.SGGD.hADA......hBAA...,2,-23,-2,21
ZfTPdFWgJQIbBVeMDSNYKaHCGXURLcAEO,EAAAZAAA..TAEAdADAFAFA..JAHBQCBCBCAA.eAHHMCCBhABASBFDKDDAHDFBGEAAhACAREDAADEBODHDfFDAhADAgGCBIGHADGGB.aHEACHHA..hAEA......hAGA...,1,-6,-14,8
CERYbWNafSGeDdOZMTAcJUKQFXgLIPVHB,UAAAQAAAFADALAGB..IADAHCBCEBFFRAEFbAGB.hAIA.aCHDGCFAdECDZFEBhBAAABIBKCDD..XGGAhBCAgFGH.BEED.....hBDA......hBIA...,1,-14,-16,2
DabeXOBYZJKGURLAFfPdNMVSWEIQHTCgc,FAAAdAAAMADA..SACHEAGAHBDACBHADAEA.eAFABCBAZBEAGDBBhACARDDALEHBADGA.hBAA.fDHAhBCAVGDA.QFBC.TFFAaFFA.bFDDhBDA.OFHD..hBFA...,2,-22,-3,19
AXPaIRgeCDMNOVfTUEZcSWGdBQHKFJbLY,aAAARAAAeADE..MADAOAGD..TAGAEBDFZDEA..SBBAhAIAdFCAHFFAFGABbBDDABFBhBAAXGDD.IHHAhAAADCGBfCHA.cEGD.hABABFDA.KGFD..hBBA...,2,-33,-4,29
LTebdPZHCfOJSGFXYacDBNRQAUMEWIVKg,EAAAVAAALADA.eAGHdADAHAFA.OCDEGCBAXCGDhAAAaBHDBDDBREEBAAHAMDFBhAAAKFAA.bEFD.ZFAFfGHAhAFAFEHBDGIB.NICB........hAEA......hAFA...,1,-4,-11,7
NOJILSbPQdfAVRCMDWHgFBXZcYUTKeEaG,RAAAMAAAHADBBADAZAFAUDAAKAFA...ECGBGBBA.OAHDhAFALEEBSCGDhAHAQEGBABBBDDEBFFDBXECDhBAATGAAaGGC.NIDB.bFED.dGGB.CEHA..hAAA......hABA...,1,-2,-16,14
NObQGPDgBedSJFYfIATUaVKZXHcLRECMW,aAAAZAAAHAEALADAEBHF..MCABOAGDGCCBDAIBBBBDdEFAFDHD.hAEA.ICDAAAGAUGCAKGHBhABARCEFCDHA...bEADQFAAhAFA.eEFH.SGHBhBAA.fHFFhCAA..,2,-11,-7,4
UYVPHXZfbdLMRGEWONQBIeTgDaJFAcKCS,CAAASAAAUACA...VADAHAEAZAGBdAHARCCB.ECBB..OCHDhAAAQCFDeDABTEFAhABAaDDBADIB..KEEDXFDDhADALFGBMIBAGGABBGADDFIBFGHBcGEDhAAA....hAGA...,2,-13,4,17
SOPGbZAFdMDQaNTUgHYVKXWEeBILRJcfC,dAAAMAAAaADAUAEA.HAGDKAGA..EBDBeBBALCFARDDA.JCBBCDHAOFFAhAIA.GGDBhBAAACGAQEEA.hBBATEGA.gGAA...hBCA......hCAA...,2,-22,-17,5
ZVgAfQYKERLdUGTWPMHaSIeONCXcBJbDF,QAAAEAAARACA.dADAGAFA.TCDAMAFAHBEB.aBGAhAAAeAHBCCGBBDBAbDABZEFAhAAAADDBKDHBLHDAUEEBSFGHhBCAOFAHcGGADGIB.....hBDA......hCAA...,2,-17,9,26
gDZeLHKVUPFaAGdWNRIESYcXJCfTbQOMB,dAAARAAAEADESADA..XAFBCAGA.TCCAbABDMAIBhADADAIBeBGHHCEAKEAAPDHDhAAAACGAGECA.IEHAhAEAcECCQFECBEEDZGEE...hAGA......hBAA...,1,-6,-9,3
eRVJdbLXgNQFUMSOTHWZcCGIEABPKYfaD,KAAAaAAA.RACF.dADALAEB..XAFAQAGAMAIBTCAAhAAAHCDCZDBA.GDGAhAFAACGBBDGAfBBEhAGAeDHHbECAFGAAOFFBCGFA.EGCADECA....hACA......hAGA...,2,-15,4,19
FbLUdNTQVcWMCSKeIYJBEaGZgRPODXAHf,HAAAFAAALADAdADATAFAQBGA..VCEBMCCAKBHBeDDAhAEAJCAFBCCDEEFAZFAARDGFDFABhAAAAAHAUGGA..NIAB.hACACEHA.....SFHH.aGGHhAFA......hAHA...,1,-11,-12,1
JAFcSMCIfOgYPbNHeRVLdZBEaUGWDTXQK,SAAAMAAA.CADA.OACE..PAFAHAFBRCCA.dBHAEBEFhAAAGEEADBIB.TFAAhAFAQCFAAAHAFEHBfGHAhBAAbCCDeDABZEEFaBBCXEGA.KHDAhABA.IHHA.hCAA...,1,-3,-10,7
WHJNXSOKQeGALdTRVCUaEFPYMgcIZBbDf,dAAARAAACADB.EADA..FAFAMAGB....ICCAbABD.DAIBHCEBhADA.XDGDhAHAKBEAeCGFAAIBTECA.hAAAaCHFgEDABFBDfGGANDIA.OHBAhBAALHEA..hABA...,1,4,-42,46
PRQXJFKSOHdWCDEBebTILUafNGVMAcYgZ,....gAAARAAAQADCFADAOAFDHAFBdBHA.DCCBEAHBeDDBhAAA..bCCBTFAAhABALDBBaDFCfEHAhAFAGDGAAAAAZEDBXFFDSFFDBHADNIAB.hAIA......hBDA...,2,-6,-1,5
UYeRMCQSTgcKWJAaDbfBNEFXLZVOHdGPI,aAAADAAABACA.FAEAZACB.HAEAGAGAICGAUCCA..RDFB.MAIBhAGA.QDEChAHASBBDTEGAKEBDAAIB.hBAAbECBEFCAXGGA.OBBBdGHAeFFDhBEA......hCAA...,1,7,-23,30
LEBYNZXgIWPbMKDQVCAHcFdSGeUTaRJOf,HAAAdAAAeADAaACARAEFOAGDLAGB.ECCBBCBA.ZCEF.XDAChACAgDGA.IEEAhAAAbDCD.MFIBhAIAQFGAABIBSGCATGEAfGGAhCAANAIAKGBDDIGA.....hADA...,1,4,-15,19
EaIMgWXVOGJeADYCBdFNcTbRKfUQPHSZL,CAAAdAAAFACA..TADARAEF.KAFCQAGCHBFCZABBEDCA.aDFBMBCBhAAA...XCGAhAIAGEFAAAIBBDDANDIA.hBAAbEFB...fFHA.SHFGhCAAIHEA...hCDA...,2,-25,-14,11
IdbLJMADaGgQVBXcCFYZEKfRSOPNeWUHT,GAAAQAAABADACACAZADBEAFA..RBFA.OAFCeCDBHDFC.dECAhAAAbCEDMDAB.AAIBaFADhACAXCGA.FDCHfFFAhADASEGBNIDB.TGCAIGHADFIBcGGChAAA.KHAA.hAFA...,1,-3,-8,5
fIQSEHWeTbLPYACVXBaGMNdZDFURcOgKJ,XAAAGAAAdADAZACBFAFA.RCDA.OAEC.KBHBICHA.hAAAEEFAHCEA.eECBhABAbDBD.LEEA.hAAAAAGABFHAaEHDMFEBDGCBgGEAfGGE.hACA......hAIA...,1,-10,-21,11
GDWYZOQLXBSFMdEAHUgcJNVRIeCPKaTbf,HAAAUAAA.JADARADA..eAGHKAGC...aBHDTCCA.GCEAhAAADCDBZDABLCGBBCEAMEEAhADAABIB..gECGhACAVFFA.CFHAbGDA..YGAG.hCAA......hCCA...,1,-11,-24,13
HYWeVDfQdCUKFZNBSaXbGcTIOAPMgRLJE,MAAARAAAEADE.HACC.eAFEDAFAdBGAKBBDZCDABCCA..aBGCGCEAhAAA.TECAADHALEEAhAIAJDHB.VFCB.QGGAhBAAFGCHXGFD......hABA......hAIA...,1,1,-24,25
PefWCDdIaTBFOEARLHMgJQKNVSXGYUcZb,HAAAMAAA.QADCKADA.SAFBGAFAUCBAZAGBeCABhAAACAHAdDDA.aCCCFCHDABIBRDEBLFABhAFANDIA..XFCAhACAbFDA.fGGADFHB.BHEA.hAHA......hBAA...,1,15,-24,39
HNLgKGXAMUJVBbaQEWYefcIZdPTDFRSOC,MAAAVAAA.BADA..aADAEAFA..eAFH..fAHAhAFAZAGBdCDATEBARBBBCCFAHDFChBAALEFAGECAABIBbGEAhAAAQFFC........hBBA......hCAA...,2,-16,-11,5
YeDPMNLBRJUHKbZdXGVaCIgFcOTSfQAWE,EAAAeAAADADAMAEA.LBDARAEAHBCBZCFBGBGACAHB.FCCH.TEDAhAAAQECB.ABCB.hAAAPEBBBCHAKEHBdFGDaGEDhABAIGGA.OHEC....hCAA......hCBA...,2,-22,-2,20
GREPfCKJIOYTHZMgBQSFUdVcaNeLWADbX,XAAAEAAA..CACAKAEAOADAHAGBZAGBMCCAQBDC.hAAAFDCHdDDA.aDGCeCHHhAAAAAIBGEAAREEBJGBAIGHAhABATFEASGHB.....hBGA......hBIA...,2,-14,-13,1
YRPXFfaKAcZDOISCHgBbWMQTJUeVdLEGN,ZAAAOAAACADBHAEBBADA..MAHBQAFAUCAA.eBBBdDDAEDGBhABAGDCA.REEFFCHDaEHDAAGBhACADFAB.SGGAhAFA..bFEDWHBA......hAIA......hBAA...,1,-17,-20,3
ROWTfSeUZIAdMDYcFXgGaCbLHPKJBQENV,dAAAMAAADADAFADDGAEB..aAFALCCAHBBBKBFAQCGAhACA.EDBBRDEATFBAhAIAeECHZEEAABBB.XGEAhAHAbFDDBDHBNIAB...OFGB.SFHBhBAAIHHA....hBFA...,1,3,-18,21
JLWTDNAVIdfEFMbeSZYRBQKXcUPgCOaHG,dAAAEAAAFACDeADA.ZABBRAEABAHBKAGA..UCEACCDA.HCGDGCFALDDDhAEADCIB.AEIB.VEAAhAAAMFFB...SGGAhAIAQFDA.XFGD...hBAA......hCDA...,1,-18,-23,5
fdHXUSEgLceCWFDKGMBaOJZTbIQNRYVPA,HAAASAAAEADELAFBeACH.FAHBGAEAaCAC.ZAGB.bDDDQCCChAAA.RDFAPEEBhACAAAAAdEAAXFFBhAEAgGGACDHAKFHBMFCBOGAE....hAGA......hBEA...,1,9,-9,18
EKXBNUYTdbWcaMAIHLOSJCZfgDVFPQReG,HAAALAAASACEZADBDAGAFBFARAEFGAGA.ECCBBCAAUEEAdCCChABA..bGAAaBHDAAIBOEHDhAAACCFD..fEEAhACAPHFC.eEHB.KFGD...XGEDhCAA...hAGA...,1,1,-24,25
IZEASYfgRaXKFcNWGbQHVJMLOdTUeDCPB,SAAA..fAAARACFKAECFAGD.NADAGAEAHCDBMAIBhAAAdAGBeBGHDDFA.BCAAhAAAEEGAAFCAaCBD..XFFChABAbEACQEGA.JEEF....hACA......hAEA...,2,-22,-11,11
NeZafCcbXAFLPMgRIYBWSDGdEVJTOQHKU,LAAAMAAARACA.BAEADAFAGBEBEAGA..TCAAHDDAKBBDeBHFhABAaDGDCCCB...bFDCACEAFCFDhACA...gEAAhAEAIGHASHBGdEDAODHDQFFChAGANIEB...hAIA...,1,-3,-21,18
adVbPAINLDFYKCEBgWTRXJUMeQOHfGcSZ,LAAAFAAACADA.EAEABAFA..TAGARAGFUCCAeCAA.HCEAhABAGDAAZEAAdEED.bEGDhACAACIBDDFBKGCD...XDGChADAMDIB.QFCA.OFGDhAFA.....hAEA...,1,1,-32,33
HBOKSYeJdcIUMgWAPNQEGLfbFCVaZDXRT,QAAAEAAAGACALAEAFACE.aAHDZAEB.RAGBHCFBKCBDeCEFhAAAdCDCIFHAMCGBAAFA.hBCA..fFFEhAAAbDGDDDIBBFEA.........hAIA......hBIA...,2,-20,-6,14
aEOKLNTcXZQDSFYCIGARPBJfeUHWVMdbg,RAAABAAAeADEHACA.MAEAdAGAaBDDKAHBLCAB..TDEAhAAAZCCAQCGChAAAFCHDCCCCAAIB.fECAhACAUFCAVFGBEEEB.OEHD.XGBASGFDhABAIHFA..hBGA...,2,-13,-11,2
NAIgPYEMVXSeBFWOdGfHUTQCJRaKZbLDc,..IAAAPAAA..EADAMACA.SAEAeAFAFBHDdCCAHAGBhAIATDFAQBCChBIARECAZFGBLGCADCFBADEBgDGAhCAAXGADOFFB.fGDAhCBA.CGHAaHGC..hCCA...,2,-15,1,16
MZPBNbdKefJXgEHLGAYISTDFVWCORcQUa,SAAATAAA.FADACACBRADF..QAGAaAFA.ZBAEBBFAhAAAdCEAeCGBXCFAHEFBhAAAAAIBDCCBODDHUEEAMDIBhABA.bGACfEHA.EGHF..hCAA......hCIA...,1,7,-30,37
KbYBAXaQgSHWUcdRFJMVIEDOeCGfZTPNL,aAAAQAAAHACBUAFARACAFAFA..MAIBEBHF.eBBDGCDAZDEA.TDAAhAAALEAA.bFBAhAEAACFASDFBhADAdFFA.IEHACHBAfHGFKFFDBGHA..hAIA......hCAA...,1,8,-12,20
gBOCQARdaVDLbSIcFWKPJUeTYGXNfHEMZ,RAAAaAAALADB..bACDSAFA.FBHDKAEAUEEAeAGHhAEAGGABfCHAhAGAHGFCEDCBZCEFOBBBhAIAAAAADEIB.IFHA.PGEC...hAFA......hAGA...,2,-14,-11,3
MFQDbWXNfVHdEcCIReLOABJaPSUgZGTYK,aAAASAAAZACB.GACAKAEAFAGADAEA...XAFAVCEAHECAhBAAECEA..CCHARDFBeCHHhBBAAAAABEBAUFGB...hAIA.YEEFMHCA.WHEA....hBEA......hBIA...,1,-15,-26,11
aMTdISFCXVWbUNZPDLGRAQeKBJHgEcOfY,eAAABAAAHACAEADA.OAEAaAFD.dBHAFAHBCCAA...XCCAhAAA.VDFAbCCAZCFBLFBAhABAAECAQFGAhAAAKFFD.JHEAfGHAMIAASECANICB.hBFA......hCAA...,2,-11,-8,3
CONeXQHLDgTadVYSWARKIcUJEMPfZBbGF,RAAAKAAAUADAEACE...MAGBZAEBGAGA.OCCBeAHBHCGBhAAALEABTDDAdEEASDGDhAAAACCBJFBA.BFHAhAEAbFFA.CGGD..XGBDDIAA....hAIA......hBGA...,1,-14,-16,2
XITLRONHGdUYbfZgPJaSDeCEMBQWVAFcK,KAAATAAARACFHAEB.dAGBUACA...bAEAZCAF.JBHFDAIBEDEBMCFBhAAA.BCGDQEGChAAAAAFAFDDB..XDGAhCAALGFAOFGBYEAF...fGDAhACA..hAEA...,1,-16,-21,5
KafPbTXBINVAYOEeMQDWgFRdZCUGcLJHS,EAAAeAAADADAFADD.RAFA.ZADEGCDBLAHBHEECKCBA..aCCH..hAAAbCEBTFAA.BCHBhABAIEDAAAFAMEIBQEGAhAAAdHEBCHHD.cGDA...fGGEhBCA.PHBChBHA.,2,-32,3,35
JUCcXbAFVEILZHBDRGQNKSfgPOYaTeMdW,EAAAZAAAHAEARACA.GCAAQAFCSAGE..fBHAhAAAOCCEaCFDeCCBdCHAUFFAhABAXCECAACAFHDCLDABhADADEEB.KDHB.gEFB.hAEAPHAA.MFFBhAHA.CGHA..,2,-7,0,7
CQWJNFLUVGHdXEcTDKIZMSPaBYfOgReAb,QAAAJAAALADBGACBHAFA.EAGEDCCBZCDA.MCFAaCFCBCHBhAFAODABREEA.ADHA..bEEACEHBFGGAhAHA..dGGD.XFADhAAA.........hAIA......hBAA...,1,3,-32,35
fZTDNBSIdPHaKeXWbGYcOFUgLQAREJCVM,EAAACAAA..MACAZACBDAFABAFAdBEAHAGB.eBCBXAGAGCEAOCBHhAAAFDBBLEHBhAAA.RGDE.fCGAhBCA.TECANIAB.SDHH.hAIAaEED.bGCC.cGFDhCAA..,1,-12,-14,2
EYgQLRfbedDZKMPFXcBGWTCOHINVUaAJS,EAAAQAAARACA.eACAZAFBMAIBFAFDBAHAGCDA..TCDAhAAAHCGBIDAAhAAAUDAAACHASDFALFAAdFFAhADAKEHBXFFCCCCDOHBAaHGEgGDDhADA.DHAA....hAHA...,1,12,-17,29
BHIRLUPZMWSJDeQdVbFGgKfTOcNCEaAYX,BAAAHAAARADFLACAZAFBMAIBSAFH.eAHBdCADbBGDGCCAhAAAKDDD.OCGD.hAAACDAAAADAXEFCUFEA.hAIAPFABDEIBQGGCFFCHTGGA...hCAA......hCBA...,2,-13,2,15
PVHFAMZYUQEgIBfXNdRGLTOWbSDKcJCae,ZAAAQAAAEADEBAFB..XACARAGFGCAATAFA.OAHDhAAAbCCA.KCDDCDGDeDHHhABAHCEBADAAUGGBIEHAhADA.dFAASECADFGBaGDAFHDCMFFBfHGFhAFANIAB....hAHA...,2,-2,0,2
EHSgcWLVDYBebJKNIQCdAOZXaTFGPfMUR,ZAAAaAAAGACAMACARAEA.HAEA..SAHB..gBGAhAEALCEADCCBeBBDhAGAbDDCKDFD.QEGAhAHAADIBTEGAFFFHfEDAEGCA.cGGChAIA......hBAA...,2,-12,-9,3
TWUfVLRFMHXeYNCISOEQaBAGcJgbKPDZd,GAAAJAAA.KADAZADBdAFAUAGALAHB.RCDBHDFBeBFDCCCCODAHhAAA..EDABaDCHADHA.hADA....cFGDhACAbEEADEIB..fHBBMGBA.YHEAhADASGGD.BHHBhBAA..,1,-14,-30,16
LGUTWYQCZdgIJDePNfHcABFMXESOKRabV,MAAAEAAAKACARACA....aAFALAEB.GAGATBFAQCCAhAAAdCCDJCHB.eDFFhAGAfDEAHGBAAAIBXEGAhBGAbFFA..WBBDCGGA.ZGEADIDANIAB..hCAA......hCBA...,2,-9,-6,3
HXYRTCKMNgZJIOUGeLbBQPDVAadWFSfcE,dAAASAAAEADAHAFARACF.KCBA..MAEAZCEAODABeAHFLBFBhAAAQEEADCEBACFBaCHFfDHAhABA.XFFChCAATFCACFHANICBIHHA...hACA......hADA...,2,-16,-9,7
VZCFQgLXdTGUHBaRSYMAJWbOcENKIePDf,JAAAOAAA..EADEKADA.eAFEDAFAZBDEQBFDLBHBdCCAGDEAhAIAHDFARECA.MBBBhAIAACCB....cGDChBAAIFHA.fGGEFGGA...hCAA......hCBA...,2,-32,-9,23
DWIQJXAcfeKURVFPSgOYdEHCBZaLGTbNM,eAAARAAAFADA...SADAOAFD.EAGAHCCAZBFEGCCA.hAAATEAAbBGDMAIBDDHBQFEAhAAAAECBKEEAUGGA.hABAgGAAdHABBHFC.aEHD.NIDB....hAHA......hCAA...,1,9,-14,23
XOeHbfALEcJTZCdFgWNVDYQPBRIaSKMGU,EAAATAAAdADA..FAFA....gACBVCBB.QAFAhAAARCGBaDFH.MAIBGEDAhAAAOCCBeFBBHDEAhAEAAAIBJFHBZFAA.CEDDDEIB.BFGA.KGFD..hAFA......hBHA...,2,-14,-1,13
VYCHJQPGEWXOLIgDNfRFbABTdUcKaSZeM,dAAAKAAAZACBeADA.MAHBCAEAHAFB..QCBAEAHB.OBFDhACALCABDAIBRDDFACEBTDEAhAAAaDAH..SDHHhADAVEGBJHDA.PFCB.XFFChAEA.IHHA.hACA...,1,-3,-23,20
faQCeUMNJFIdYSALBPHTVGXRWEObDKgcZ,LAAAHAAAGADARADFEAFEDAFA.KAHBZBFEaBFDeCAB..MCABFCCHdDGAhABAACCBBCHD.TEFAhAAAXEEB.OEHDhACAbDAD...fGGECEHBJFEFSGHBhACAPHAA.....hAHA...,2,-15,-3,12
bIaAfHFQUPZOCcXEBDNJGWKLTdSYVeMgR,HAAAQAAAZADBCAFA.EACADAHBGAEALCCDdAGB..SBGHhAAAeBHHRDEB.aCDHAACAFEHDOCHDhBEABGCAJEFBKGEDYHFGhCAAMIAA..IHHA....hAAA......hAIA...,2,-19,1,20
OKWLgNPMEAJbaQVfCUeBYFScZGTIDdRXH,aAAAQAAA.CACABAEASACH.GAEATAGAdAGBHCDAhAAAKBHDLDDBhAEA.gEBAhBAAMCIBACFAbDGDfDHAeDCBFEABZFEBRFFBOBBHPGAChAEA......hAGA...,1,-1,-5,4
TEgCJXZdHWbfIOVKPDeALMQFGNYBScaUR,MAAAGAAABADAaADARAFF..EAFA..CAHBZCDFHBBA...bBFAOCGDhAAAKDDA.eDBHADFALEGBhAFAQFGBFFFBSHBAhAIAcFDC.......hACA......hBAA...,1,-17,-18,1
ASEJCURaKFLNHQcDTgBbOXZVGfMYWdIPe,EAAACAAARACA.FACDHAFB.DAIBBAEA.OAFDZCAAGDGA.MCEBhAAAdAHAeCDF.ADHASEAAhAAAaFAALHAAQEEAhAEATFEA.bEGD.....fHBBhBHA..hCAA...,2,-30,-11,19
OZRMUYeagLBVNcIFCbGEdfAQTJKWXDSHP,TAAAKAAADACAHADC.ZAGBRACFMAEA.eAHFaCCALDFAhAAABBEAVDEA..IFFAhAGAbFGD.EDDBABGBJCAFSFHBhBIAOEDB.gGCANCIA.CHGA..hAAA......hACA...,2,-12,-11,1
SLVXJNFfZgWYbaGOeUTcBMPDRKQECAHId,HAAAdAAALADAXADBFAHBZAFB.....gCAAhAAAbABDGCEAeAHFUDGATDCAhACAMEAARFAAEDHF.ABFBSEFBhCAANICB.fFHAaGCEBGGA.DFFBhCDA......hCIA...,1,-3,-6,3
WKfHMgJDPBYROZNGVEcAXbLCQUeFSTadI,LAAAQAAAeADHSACAdAFAKAHBHCABMAFA.DCHBBBEARDEBZFBBhABAGBFA.EBHBACABCEHAhACATDAA.aCDHfGDAhAHAgEDA.PEHB.NIBB.XGGAhBFA...hAAA...,1,-7,-12,5
MBZFGDRNHEcLIWXQKdeOAVgPJYSbCfaUT,VAAAJAAA....SADBCADBUAFABAHAGAFA.RCCBHDGBhAFAECDBLDFA..hAAAXFBCdECAAFBA.gFDHhAHAbFFA.aGGCMHDADAIBNIDB...hBFA......hCAA...,2,-30,-8,22
aULAfKFHGRISWZEXbdTgNQVCMOPBceYDJ,FAAAHAAARACF.SACEZAEB.EAFAdAHATBGAQDFA.MDIBhAEABCCA.eCEBDECAUGBAhBAAAAIBGEFA.XFAAhAAANHEB.ODHD.cGDAaFFC.hBGA......hBHA...,2,-24,5,29
UMfBTRKQGOJENCdbVXPWcAZIYgSeHLaFD,ZAAA..gAAAHAEAaAGADACAMADABCCDRAFAGBDA.ECGAdCEDhABA.bCGDXDBChAAA.PDHDACIBSEEBhCAAeEGDLFCAfGEE.TGGAhCBA......hDAA...,2,-22,9,31
cgUROCIGbAXZHEQMTKPFeWVDJdBSaNLYf,HAAAEAAA.MACAKACAeAEEDAGAdBEABAHB..aBGALCCA.hAAA.fCCAhCAAgCFHRCFFCDHAGECAAEEBZFFAPECDhCCAFEHBJFFBSFBD..YHCGhCEA...hAAA...,1,-3,-22,19
OdRYgNQVefCMJBFWHTbZcPKaLDAGUEISX,EAAAXAAARACA......gAFBQADAeBHHMAGBhAAAFCCHHCGBZDAFKCFDaAHFACDBhABAGECBSDAAhADAdFHAYHAAfDEABGEAbFBB.LFFAhBFADGGB.IHHAhBHA...,1,4,-12,16
FaPRVEcGUZWbCNdSgYIOQAefMTHLDBKXJ,eAAAMAAAHACCLAEAKAFCFAHDRBCB..EBHFGCCAZCEB.CBBDdCFASDGAhAAA.gFAAhABAODHBAFFADFIBXFGAhAFAaFDD..cGGCbGDC.....hAGA......hAIA...,1,-10,-18,8
VXLcHJdPKUQIZeONSfYWMTDCRFAagEGbB,EAAAGAAABACALADAHADBdAFBKAHB.QCDAeAHHOBFDSCFAhAAA.fDCEhACAMCCBTEEAREFAAAEAaGCAhAHAbEGD...XGED....hBAA......hBCA...,2,-15,-11,4
JCPeTFIXMLQRWOcVYUHKGDfZdNBbEgASa,aAAACAAA..eACAFADA.MAGBRAFF..OAHD..VCAAHBBCGCGAhAAAZDEAdFDABAHAEFFBAEIBhAHASDEB.hBAATECAIHHALGFA.cFBChACA.KHAA.DIDA..hADA...,2,-17,-16,1
dIVQOfUDaFKBSAgXRTGCbMWJLeYHcNZEP,RAAAGAAAMADA.LADAHAFCZCCAEAHB.dCDAQCGBOCFBDCHBaEBAhAAABEADAEEB..TFFAhABAbEFD..eDHHcFCChAIAIGCA........hAAA......hACA...,1,-7,-17,10
PBbVNIJCOdELDZAcMKWSfaeYXTgFQUGHR,MAAASAAA.eACHTADA.QAFCHAEARCEABAHBbBBD.hAHAIEAA.OCHDhAAAEBHFZDDBADDBKECDaDFDXFGAhAIAFEEHGGEBPHEA....hBAA......hBBA...,2,-12,-5,7
FVATdeNIGQaYXWLCMKDbZPScgRJEHOBUf,eAAAGAAAQADAaADA..XAFDLAGBMAIBbCCCZDFEhAAASCDBRFBAHFGBBBFBhABAFDFAAAABdFEANIAB.IGGAhACACGFC.DDDB.PEBD....hAHA......hBCA...,1,9,-18,27
TQPdegOGCIKNRZEHMDabcJFBVSWUfYLAX,TAAAdAAAeADA.GAGAKACCRAEA.HCAC.aCFHJBHBBEAA.SDEDhACAfCCAAAIBQFGAhADAOCFD.CECAZGBAhAEAEECAbFACFGFH.UFFB...YFDBhAAA.....hBAA...,2,-10,2,12
AJHgMTGRXFVCfNEIDKcYZbOBSUWPdQLea,HAAAMAAARACAFADA.CAGA.EAFEKBHB..ZBFEBCADUCCBdCCALDGBhAHA.ABBB.TCFA.hAIAGECBfEFAhBAADEHB..bGAASFEDQGGBaGHD..hCAA......hDAA...,1,-16,-20,4
QASEBfYdgVaeGWFLUZXTcbCRONPDJKHIM,EAAABAAAdADAaACAGAFALAFAZCBA....TEGACBCARCDA.OAHFhAAADCBBHCGB.MECBhAAAAAFBfFDA.hAGAgGGAeEFBFFHDXGCDNDFAKHAA.IHAAhAHA...hAHA...,1,-13,-14,1
XCBPKIFJDTWLMYgSdcfRZAUeQOVGNHEab,eAAAQAAAGADAHACAEAFA.aAEA.CAHABCDAKAHBFCCH.DCGBTCFAhAAAMCHB...SCHBhAHAdFAARFDAAAAAOFHDhAFAbEEAXFCC.IHHA...hBDA......hCAA...,2,-16,-5,11
SUHKTQGJVeXFRNBIYcDAZadPgfELOWbMC,dAAA..fAAAEADALAGBOADAMAIBSAGAHBDCTCBAhACAGBCA.eBEBhAAAREDABDADICGADEHBADEBaFHDhADAgCAFCGBAKGEA.QEEB.hBAAXEGDNIEB.YHAAhACA,2,-9,0,9
bTfeSRKYPFVJIDBaZECWgUdALcHXONQMG,HAAAOAAAMACAGADA..bAEAeAFARCCAKCGDFBBH.JBHBBDHAECFF.hAFACEEAUFGALFFA.hAAAXDBATFCASGABhAGAPGAA.DAIBZGEA.....hCAA......hCCA...,2,-12,2,14
YCMRHNFgXTIUaELJWAObdVfDcZPKeSQGB,dAAADAAAZABEeADAGAEACAGA.HAGDFBHD...TCCAaCAELCEBhACAACIBODAB..bDAAfDGEhADA.KEEDhAGAQEGAMEIBgGFAXGCA.EGGBhADA......hAEA...,2,-23,-2,21
aNfcWFbURAMQOZdCXVLSDeKTEIGJYBPHg,MAAAZAAAdAEA.CAGA.LAEA.eAHHEBHFGCAABBBAHCDAaCCC.hABAfDBA.hACAFDHDRCFBADIBQFABhAFAXEEDDFHBTFEA.IGHAYGAG.hAGANIAB.bFCD....hBAA...,1,-7,-16,9
AQYCFZOUWPNEBcbIXSeVHGLDfdKaRgTJM,QAAAFAAAZACBUAFA....PACCECEBBAHA..bAFB.hBAASAHHHDFBGEBAhBEALCDBdEHAaEEHRDGBTFEAhAAAADHA.OFCB.NIDB.IHHAhBFA.....hBHA...,1,-11,-16,5
YHDCScQVFZELTdBKUMGaRbfIPNWeAJgXO,XAAAHAAASACE.QAFAZACBEAEAdAHAKAHBGBFAhAAARCCAbDFA.fDEEhABA.IECAPEEBeFAAhAAAADIBOEGDCFHDFGFDLHBABHDD.aFCE.hAFAWFHH....hBHA...,2,-11,11,22
aMJdAOgBSLDHIPGWTEVKNCFUZbXRYefcQ,BAAALAAAHACAGADAEAFEKBHBFAFA.ZCAARCAA.eAHHQCEAhAAA.aDGDdDFA.ADIBSEGHhABADEAB.IFBAhACATECACFFDbGCAfFHA.MHAAhACA.....hBFA...,1,-10,-19,9
ZPUFfTVNHcRLMgbCXWSEYBAedOQGJaKID,eAAAdAAAGADAKADAZAFBFAFA....TCCAHCACRCFALBHBhAAAMEFBCEGA.SECAhABAEFBAAAIB.QFAChAFAaEHDDGGB.fEGE.cFFCXGCAhACABHCAIHHA.hAIA...,2,-19,-9,10
HCNbaATWIZUFGDERPJQceKVOMYXfSgLdB,TAAAZAAAGAEA.RAGB.QACCeCABOCCBMAEA..XDFDhABASAGA.dCEAhAAAHEDBbCFDACHAIGAAhACADDDBEDHBPFBBKDHBfGGABGGANIDB...hBFA......hCAA...,2,-9,0,9
DgaVZICORTfULAQHWMXYSKBFNPGeJcbdE,HAAAMAAA.SACEFADDGAFAeAEH.JAGBdBBADAIBaAHF.ZDDBOCCBhAAARFAB.UDFBAAFBQFFAhBAAXFGABGAAhAGAPHDCEGFB..IDHACHHD...hCAA......hCDA...,2,-11,-8,3
GHJYKZBMbCSPAQLFUIaTDefRgEOVdcXNW,LAAAFAAAUADA.aADDDAGA..RAFA..ECAAdBFA...XCCChBAAGCDBHEECKBHBZDEEbFAAhABA.SCHBhACAADBB.IGHAeEHFOFFBNIABJHEA.MHBA.hAFA......hAGA...,1,2,-30,32
IOPEGHSMXAKRYeZBLbgQcVCNdTFUfJaDW,RAAAeAAAZADBLAGBQADA.CAFA.dCCCFAHBUEEA..aCCBDAIBOCFChAAAEBFF.HDDAMDABhAAAAEHABFFA..bFBBhABA.....gGFANICBfFHAhABAIEHA...hCAA...,1,-14,-21,7
VUIZeTRYQcbMBdPaLCGfKOSJDNFAXWgHE,XAAAHAAAEADEUAFAZACB.RCAA.QAEA.MAHBdBHAaCEChAAAGDEAOEEADAIBAAAAVFGBhACAeDGB.TGBAhBGA...cECC.BGGD...hAIA......hCAA...,1,2,-17,19
bNaGQCPSVZJAMHgRdYcETIBKUfFXLDeWO,HAAARAAAdADA.EADEBAFAKAFCFAHDLAHB.DCCBeCAA.OCEBhAAAaBFE.GCFA.QFCChACASDDAZFGBhCAAAAAAMDGB.gFAA...hCFAcFGD.IHEAhAFAfHDF,1,2,-51,53
GTLSQJYVbfdZHURXBKMNWAgaOcCDFePIE,aAAACAAAFACA..eACH.EAEAGAEA.TAGALAHB.QCEAhAEAVCBA.dECAhBAAHDFBREFAKGBDMCIBABBBOEEHhBGADEEBSGAA.YHDAhAAAfGHA....hBHA...,1,-11,-13,2
WUHaYCSRcBPEJMdfONKZTbgXDLQFIAGeV,eAAAUAAAHADACADA.RAGFBCDDEAFA..dBHAOCEDZCCA..bCFBDCIBhADA.LEGBFECAAAAAGEGAhAFAaFAA..SGABhAFA.PGDAMFFBNIAB....hAIA......hCAA...,1,-17,-18,1
SIEUDNRZKLMdaYOJCAcTHBbPFefGgQWVX,HAAABAAAFACAeACEGAEAQAFC.XCCAEAGADBCBRCGBZCFELDDBhAAAaEFD.OFFBhAGAAAHAbEGD....fHCBhAAA........hBIA......hCAA...,1,-8,-34,26
OWNFZbHgcAQPTYeRKGJUILCEXDBaMSdVf,TAAARAAAGADA.UAGALACB.EAEABAFDMAHBdDAA.OCCBhAAAFBFDHEAAADFA.QEDChAAAeDFAKEHBCFFAaCHD.hABAfFGA.NIAB......hADA......hBIA...,1,2,-29,31
RfWFMYSONLcCQTXPGUeZAJDdIKbgBVHEa,dAAAKAAABACBHADARAGFFAEAMCCB..OAGDLDAB.QDDAhACATBDA.GEGAhADAeCCBAAIBDCIB.bFCDEDGBaGAEhAFA...fGEBSEEB.CFDAXGFAhAAA...hAGA...,1,8,-38,46
UWaJYQGCLOKIgDMXNbcEAeZfTHBSdPVRF,eAAAZAAAHAEAdAEARAGBFBHD.UCAA..aBCDQCDDGCFALDEDhAAAKDGDDAGA.MDIB.hABAXEBAbFFA.AAIBTGAAhABASGCAPHFAJHFACEED....hACA......hADA...,1,2,-14,16
UIVfAcbaETSKgHDLPOCYGNXMBRedQJZWF,aAAAEAAAKACAHACB.LAEACAEB.GCEAMAGBRCCAeAHH.dEHAZBGBhAAAFEDHUFCAVFABAAHA.TGFAhAFADCIB..OEEDhCAAYBBFBGGA.......WHFAhCBA.....hAGA...,1,7,-31,38
LbOPdUSAfJDMeXaTRZWIYQGVcCHBFNEgK,DAAAeAAA..aABERADAZAGB....IAEAGCCACCFCHAFBFDHDEEABhAAALAHB.bCCBhBAAdEFAAEEA.MIBA.XGAChABATEFAQFDDBGHA.KGHB.hAEAOHBCSHGGhAGA...,1,-9,-14,5
EaQRNMDdSLZCWUFfOKbeTVYBGcAIXgJHP,XAAAHAAAEADERAFFDADAdAHA.ZCAAUAGA.FBDAKCED.eDFA..hAAATDCABEHAACCAIDGAhAAAJFAA..aFFBMDIBhABACGGA.OEFB.bFDD.....hACA......hAFA...,2,-23,-15,8
BVGPIYFOdafMUKZTCbScAWRHQgNJLXDEe,HAAAQAAAJADALAGBEACABAEAGCAB..IAGAhAAAOCFHaCHDMAIBZECBbCDAAAIBRFGBhAAA....XDCChCAADGFB.eCHD.PEFB.dGHA.hACAKFCA.CHFA....hCAA...,2,-10,3,13
KTYOeQCZAMPFVRcEbaUgHLXNdfJISWDGB,MAAAFAAARACF...EADAaAEAHAFA.LBBBdAHA.JCFFSBEHhBAAGDCAKCHBTDFAhBHAeEGHCHAAADHA....cECAhCAA...bFFA...XGCChCBAIHHABHFAOHCEhAHA...,2,-16,-13,3
POgKQBSAaXMFeIJRbGdUcNZVLfHCYEWDT,aAAAMAAA.FADDeACH.RAEAGCEBdAFAUDDAZEAALAHBHEEAEFHFDBBBhBAAOHAA.KHEAQEGAhBCAAAIB.XFBChBFA.bGDA.......hAEA......hAFA...,1,-8,-20,12
UdKBWbcCQLJgHDOTYZSIRXeaEGAMVNPFf,MAAAVAAA.FADD..dADABAFA..bAEDQBGA.LBBBhAFAHAGBTEEAhAAAZDDAREGFeFCAEDHFAAGBfFHAhAIAKHAACCFDDGIB.SGEA...hAHA......hAIA...,2,-20,-11,9
dFYeNKOTHSLcIgBDJZQfUGEXCaPAMWbVR,MAAAVAAA.RACA..dAFAeADE.KAGCHBGBLCDAIDDABBEDZECAhAHAQDGAGGEBEBBBhAIAaEEBABIB...bFFC.hBAAFHCA...........hCAA......hCEA...,1,-13,-16,3
QVGHOfcXFYELPKUdeANSDIMRaTbJZCWgB,DAAARAAA..aADATACAZAFB..CAHA.BAEBGCCAHAFB.OAHFhAHAXCGDEBBBLDDBhBAA.KDFDeEBBADHBSECFhCAAbEFC.gFGAQGGA.hCEA......hDAA...,2,-18,-15,3
ZDgUGaPWFdcbfYONXRMAJKILTSHeQCEVB,KAAATAAAHACB.eAEAEACEZAEBDAIB..GBGAaAGD.FCABdCCA..hAAA.bDFAOCED.hAEAREAAAEGBLFFBQGCAhAAABFHDPFHDfGBA.XECAhAIA.IHDAhBGASGGDCHHA,1,-11,-13,2
JULgFDGPNIdBKbReZXSVCYcaMQOTWfEAH,HAAALAAADACAGAEA..IAEAdAGBKBHDRCCBeAFHZEBF.SAHBhABACDGD.aBGDhACAMDIBTCCAEFFAAGHBgDGAhCAA.FECH.BEEA.XFGAhCBA....hCCA...,2,-20,-19,1
ZNXTadbQWCIYKGUefgHABcDOESFRLJVMP,DAAAEAAARACALADA.MAHBZAFBTDAA.dBHAbBBC.QCEAhAEACCCDKDEDGECAeCHHhAFAHFFAAAIBODDBFFAH.hAAAPFFBaHECIHHAfGDA.BHGAhBAA......hBCA...,2,-17,4,21
cUYZKJIDbFGfgVCHaWSRTALNEdOMXQBeP,EAAAdAAAMADABACA..eADHUBDAZAEBKAGADAHBGCBA..VDFAhAAAHDFA.aEEHRGBAAAIBLFHBhACA.OFCDhAIAQGGA.cEECIGGA...hBGA......hCAA...,2,-29,-8,21
SCVGEfgFZYcRDWHMIOULJPQdKATNeBabX,eAAAaAAA...SADAGACAEAEAFAGAZAGBRBEAHCCBMBBBOCEDhAEALDGB.QEAChAAAABGBTEGABGEAbFEBCGHA.hABAfGGE.......hAEA......hCAA...,1,-5,-15,10
SJVKCEFZgDIPQLBXYUfWTAGNbaROedcHM,GAAAaAAA.RADAeAGHHACBMAEA.SAGAKCDDECHFZEAADBBBQEEAhAAALBEBXCGAhBAAUGAA.TEFAhCAAAADAbGFA.dGCA.cEDCCEHA.FFHD.IHEAhCGA....hCHA...,1,-1,-10,9
TaQDdXMWBFPLNgeOVGRUHIEJfAZCbKcYS,ZAAAKAAA.SACEaACA.dAFAMAFABAHALBDA.eBGHhAAAGCCBHDDBECHBABIBbFBDhBFATEFA.QFBAhABAXFGAFCCHPFEBOHEA....hCAA......hCBA...,2,-11,-9,2
FebOBAYCfgSVDZLUHdJKRMGWPcITNXaQE,CAAASAAAZACAHAGBdCCARACFGAEA....PDABTAGAaDFBhAAAECHF.eDEDBDHAAAAAfEAAhAEADEEBLFGBhADAKEGDMFIBIGDAQGAAOFHDgGEAhAEA...hAGA...,1,-5,-11,6
gWMXeRJYcbNCSZUQIOdLEBDVHTGKAfFPa,FAAAaAAA.MADARACF....JAEA..bAEASAHBZBDA.QCEAhBAAdDDAECHFDCCBHCGDhBBAGFDBAECA.fGHAhAIAgECA.eEHHNIBBCEHA.OFFB.hBAA......hBIA...,2,-19,-8,11
gPdNOHCDRcMKUbBJSTZaXQeGFIfLAEWVY,EAAAVAAA....PACCdADAHAFA.RCDAMCHBKAFCBAHA.TCCAhAAAaEFBeEHHGCEAhCAAFFAALHAAACGA.hCBA.gDGBCGFA.DECB.bGFA..hCCA......hCEA...,2,-21,-7,14
fWRTbCLPFANVJMHOXUQEBYISgKceGadZD,VAAAHAAAXADB.EAFABADB.SAEHKAHBeCAAdCFAhAAAZAFBDAIBRDDBTFGALDCBhAAAACHBMFDBQEEAhBHAIHEAgGFA.aCHH...hACA......hCAA...,2,-18,-4,14
aNMGgLBeTKAWDORHdbEfcQISZYVFXPUJC,OAAAHAAAEADE.QAFCZADBFAFDUDFAaAHDGCABLBHBeDEAhAAAAAHA.RECBdEHA.bFFBfBBEhBAA.SDBDhBDAYHAA.XFECCHHA.MFIBhCAA.BHCA...hACA...,2,-20,12,32
AMgFZbKfLPcWYOBJCaDSHQIdNUTVReXEG,MAAAZAAAKADCLAEA..PAFC..cBBAOCABCBHADCEAhAFAHCCC.dCFATDBAhAGARDGFEFFBACHAFDFA.bEDD.hABA...YFHBaFFAQGGBNIAB.hACA......hAIA...,1,-11,-14,3
BLAZMRUgTDeXJHcQfNYOFCSEdKWabIGVP,RAAATAAAeADEHAGB.QBDD..fACBhAAAOCCHSDFHEAEEdAGAaBHDhAIAGEDABCCAACEAZGAAMDEBhCAADFHB.XDFC.cFGA.FGDHhCCAWFHH....hAAA...,1,-7,-10,3
MSdbYgXKOPWDJGVfUacCQBeERATNHZFIL,HAAAZAAALADBdADA..bAEDXAFA.OBHDDAGAGCGAhAAAUCAACCFAeCAB.ABGATEEAhACAFEEAMEHBSCCDhBIAKFAAJFCA.aFHD.QGCA.hABA......hACA...,1,6,-22,28
QegBDCbKYFfdEJNPMHSTAZWORcaXGLIUV,ZAAARAAA.aACAGADA.LAFAVAFA.eCCBDCCBKCFDFCFDECHB.hABA.JCHBMDABHDDBAAAAOEFEhADA.XGAAhAGAQFAABGGAbGEA......hAFA......hAIA...,2,-23,-5,18
YGLbMcPBWTCDHagRUNVeEIOJQFZKfXSdA,GAAAMAAABADACADAHAEBRAEF.UBGA..eAGHECDB.OBBBFEFAZFFAhAAAKCDD..SDADhACAAAIBLDHB.bEEBPGAAhADA.DIAAaGAANIEB.IHHA.fEGAhAGA..hBAA...,1,-1,-33,32
RIPJcFKAZCbOSgWLXDeYUNGfaTQdHMEBV,ZAAAOAAASACELAEADAFAeAHH.UBBBGBEA.aAGEdCEAhAFAHCGBEDGBRFFB.IGAAhAGAcCCC..ACIBbGCAhABAXEDC.fGCETGGABECD.hBAA......hCAA...,1,-4,-15,11
cOEgDRBNHVJWbaXGZeQUTdSAPKMLFCIYf,MAAALAAAFADD.CAEA.....IAFAfAGAEAHBRBBBHCAAhABA.VCEBJCFAaDEBZCGBeEAAhACA.QGAAhAEAdEGAAEIBKFEB.OEHDBGHANIAB.....hAGA......hAIA...,2,-23,-4,19
aUNLXPCQRDIKZGdbFfWAHEVgYJBSOeMTc,HAAAEAAA.VAEAJACBBAEA..eAHHMAGBaCAC.LCCBhAAA.CCEDREABKAHBdDGDbCEDFEEBhACAACEB.SFGAhADA.OHAETDGAcGFCXEAA.QGGAhAAA.DDDBhAEA.IHAA.,1,16,-28,44
eIQHSAYJTafWMRdFKbCBgXULPOGNEcDZV,TAAAaAAA..MADARACFdAEAKAGABAGA.UCGALBBA.GBEAhAIAECABZDEBeCGHHGAAhAAAACIBfDBAhBAAFEDBCFHA.XFGAOGFCDIDAQGCA.hACASDDD.hAGAYHFA.,1,-3,-5,2
TYaKZGScPARXdFJOMHBIbDNfEQVeUgLWC,RAAAdAAAOADAHADABAGB.DAIBEAGA.eBDFLCCA.TCGAhACAaBGEGCEA.SDGBhAAAADAAFEEAMEIBbGFAhABAQFAA.gGCBWCCD.hCAAKFGB.....hDAA...,2,-19,-11,8
bOSAGTHfLURgQdEYMJeDWIaBNXZPCFcKV,HAAALAAARADFdAFAEAEAMAHBDAHB...aCACXBEA.ZCAAFDDHhAAAKCHBOCHDGEAATFEAhACAUEEA..gGFAhABAYHFGeDGDBEHDCFDC.....hADA......hAIA...,2,-11,-9,2
SAEdKYOfDTMbNUJPWaXcHCGgRBIQFZLVe,EAAAdAAAOADADADA..MAGBUBEB..JAHBaAHBHBCAGCBARDEBBCBDhAAAQDFBZEBAeDHFhAHAABDBKEED..fGGEhBCAbFGD..NBIA.......hACA......hBAA...,1,-15,-20,5
DGaEQJcSYBMZeOXVTgbLdWfRNCFIPUHAK,GAAAEAAA.QADASACAMAGBeAEHXCDC.TDGAhAAAbAFDdAHA.RCCBFDABhAAAIAHAHEFAADIBaDAHcFEChADAZEEFOFBCLHBAfGGBCHGA.hBHAKHCA.DIFA.BCHBhACA...,2,1,12,11
QUdXCALNHITOgKaMbPReYJFWBEDZcGVfS,HAAATAAAKADC.aAFDMACA..RBGFeCAAFAFDEAHBZDDAGBDA.hAAASCCDdFBAAAHALFDBhACAOCGD.bFEDPFFBhBFA..YDBFBCEDDGIBfGDAhAAA.QGGAhAIACHGA,2,-13,-12,1
ETYdNKRZcSbCgGXfJOHMWaBILeDPAVFQU,QAAAEAAAdADA.RACAZAFBSAFA.CBCCGCDBfAHAhAAAHEECaCDDLEHBhAAADCIBADAAFDGDTFAAKFAA.bGCAhAFAXDAAMAIBBHGDeEFD.PFHD.hAGAYFCB..hADA...,2,-13,10,23
DXVdBMANSYECFKZLePUTgbcGfQWJRaOIH,SAAAEAAAKACA.eACHUAEA..TAEA..bAGDGAGAhAAAQCCCRDDAaDHDHEAAhABAXDFCdFFAAAIBCEHAZGBAhAAALGAA..gFGGfHGF.hAIA......hBGA...,1,12,-24,36
bNZgHFcQVdIAfSOXBRTLUaDEWYePKJMGC,OAAARAAALADBDAEA.EAFA..eAFAKAHBGCEACBBDZBDA.HCGDQDDAhBAAdCCCAAAA.XCGDhBEATFAAUGGA.hBIAaGCDPFGB.MFIB.....hAFA......hCAA...,2,-21,-3,18
AIZPaDVfUXYFLeTOSbJECQKGRMHdWcgBN,ZAAAaAAA.DACAUADAFAED.LAGB..eAGBSBBDECCBQDFChABARDBAHEDCdEGA.hAHA..gFBGhAIAAAIBIFHAfGHATGCA.....hCAA......hCBA...,2,-36,-5,31
QeLDCEJcYPdbRMVGBWZaISHfXKNFOUTAg,eAAALAAAEADA.JAEA....PAFCRBCAGCAAZCCA..aCEAHCFAhABAKCHBFEEHTEDAAAAAQGFAhAIACAHBdEHAMFGBBEHDhCAASHCA..fHCBhCBA......hCDA...,2,-17,-6,11
VgfdGIaZMRNUCHbeEKDTSJQXFWBYLcOPA,VAAAdAAAaADA..RADF.CAGA.HAFB..EBDBTDAA..QCBDhACAFAHFBDDDLDFAhAAAOAHDACFAGDFAhAGAZFAAMFFAbEBAeHDADEIBSHDAXGGB..hBAA......hBCA...,1,5,-22,27
AYKIPcNSXQaFeZJMBOdCbTfVHEUGWDRgL,KAAA..IAAA..cACAXACAQAFAeAFAZBFEhACAMAIBdCCATDFAhADAHCCAEDFAGEDAREAAAAEAPEEBhAAAaDHDBFAACFHA.fGGAWHBGLHFAhBHASGAA...hCAA...,2,-7,0,7
LNMVQUYSBCabKTJDERZOeWgfGFPXHdcAI,LAAAMAAAUAEABAEA.aAFDKAGA.DBBARBGFZCAA..eCCB.hABA.fCEEhACAGCGAXEBDHEAAAAHAIFFAhAEAQEECCEHAbGEAEGGB......hBIA......hCBA...,1,-16,-24,8
UfFHMcNJYOdISPVQbWTZeGaKCERDgLXAB,BAAAFAAAHACBMACAJAEAdAGA....SAHBQBCA.TDEAhAAAeCEAaDFE.EEBAhBAARDGFLECBADIB.hBEAfBEFcEECOFCDIHHAbGFA.WCBDhAIA.....hCAA...,2,-19,-18,1
FVOWXBbScTRQGeAEgZYCPDUMfaLHNIKJd,EAAAZAAACADBDADA..MAFALAGB.HBCAKBEAdBGAOCBBBCAASCHHhAAARDDA.eDEBhAIAABIB...gEBHhBCAPDHDUGFAaEGCIGGA.FFDDhBEAXCCC..hABA...,1,2,-42,44
IFQCBMSZfdPgcTDeEJOAGXHRbYaVUNLWK,HAAARAAA.aACAUADALAFAKAFAFBHDBCCA.ZCEAdDDA..gEEAhAAADCCB.EEHFAAAAGCFAhAHA..bFCDhAGA..NEIA.QGGBMFFB.fHAFhAHA....hCAA...,1,-7,-39,32
OPJDNcbefKWCVTAgYISEXFaUBdLZRHQGM,..IAAAEAAAaACDdAEARACA.HAGBGAFAMCBBOAHF.DCAAbDDAhAAAeCDFKDHB..CFDAAAGBSDAAhACAFFFH.LEEAhADA.ZFAA.QGGANIABfHGFhAIAWHAG....hAFA...,2,-10,-7,3
aPdTQRbeDXUAVKLgBfZWcCMIJGEYNSOFH,LAAABAAAZACACAFBMAEA.GBCBEAHB.SAGAHCCAdCGARDABeCABhABADDIB.ACHA..KDDD.hAAA.fEEAhADAIDGAYDHBFFGB.aEFHQGDBhAEAbFBA......hAIA...,1,-2,-21,19
LYQNUVRbfFEcIMXePBTgWZKAOGJSdCaDH,GAAAdAAAaADA.HADALAGBQAGC.VCEBRBDBFCBD.EDHFMCDBhAAA.eCHFTFCAhACAZFAAADABSEFBhAIADEIBUGFA.fFHA.cGBC..hBAA......hBCA...,1,8,-21,29
UNPOXRfgQMTKAdVZSWIEGDLFcCYHebBaJ,ZAAASAAAEADEGAFALADAFAHF.CAHAHCCAeCABBCCDUCFAOCHFhAAARDEB..QECChABAMEABAECBdFFAIDHAhACADEEB..bFADaFAH.PFHBfHGFhABA.....hAFA...,2,-11,-4,7
baEVJOcUgdKFCPYWTNMGRQfDBSXHZILAe,eAAAEAAA.OADCUADAdAGAFAGA...CBCC...PCCATDDAGCFAhAAARDFF.QFAAhABABCHAHFBAZFDBAAIBaEHDhAAAcFGDKHFA...WHFA.....hBFA......hBGA...,1,-3,-23,20
ADSHNFRPWOVMaYfXBLEKZIGQcgUdeTbCJ,HAAARAAAOADAaACA....XAEDEAGAZBEAGCCAQAGAUEFAhAAAeCCBCEHA.ADGASDGAhAAAFGDD.PEEBhAGA.MFHBBGHAKGFB......hBIA......hCAA...,1,-8,-26,18
VCPKLfRINHOgaGBdJSEecAYbMDZFTXUWQ,MAAAZAAAFADAUAEA..QAGACAGA.LCABRBBBHCFCaDBHhAIAdCCDECFBABIB.DDHBTEDAhBAA..XEEChABAPEHD.fFHA.OGAABGEASGFHhBBA.hACA...,1,-18,-23,5
MQPGOZJVdUBScEATKeNgLXHYDIaFCfWbR,eAAALAAAHADADAEAaAFACAGA.....bBFARBCAMAIBGCCAZCAFdEFAhAAABCGAEDHBACCB.TGDAhABAKDEA..XEDChABAFGHB.QEGA.OGCE.hAIA......hCAA...,1,3,-23,26
FVRaNCAKdgBYSJDUOcXEGHPIbWTZeQfLM,dAAABAAASADADACAUAFA...OAFDEBCA.HCAC.bBGDZCBAhAAA.eBHHLDEBhACAMDFBRECBaAHF.AEAAKECAJEHB.hAIAXGFA..IHBA..hBCA.WEFH...hADA...,1,-14,-29,15
KNWBDePbfcaXTJSGOFYUdLHRAQZCVgIME,ZAAACAAA...IAEAEACAKAEABAGBDAGA..eBEA..bBFAaBHDhABA...TCAAhACAGCAAFDDAdCCBHDFBACABQDDBhAAAMEIBPHCAXDFDSGHDhADAOEHD.LHDAhACA...,1,0,-25,25
HcMFdIfKeaYDgEJTRBLOSZUWPANVbQCXG,VAAAQAAA.GACBHADBMAFAdAGAKCDDeBFEDAIB.ECFFRCEFLDABhAAAZDAAUEEBADHACDGAFEHDhADAaEHB....YFHBhAAATGFA..........hADA......hBIA...,1,-7,-11,4
VFGYcMeBbZWQdHDaPfEgITJRCSNUOLKAX,FAAAGAAAMADAeADAZAEE.dAHAHBCBDBGB..aCDAEBHF...TDFAhAIARDDBSDADUFCALFFAhBAAAAAB.YHFAhCAAbDFAQFGC.fHBBhACA.JHDA....hADA...,1,-3,-11,8
GJOgQXZKDUTYcHdfCSRLBaAMIePWEVFNb,eAAAEAAAFACDGADA.OAFAQAEAZBFFDBIBTAGAHDBBdFEAhAAASCDHLHDAACIBMDFBhAAAIHHA..hABAPDGB.VEAA.JFHBXEGAhBDAKHDA......hCAA...,2,-4,-2,2
cWCVIPNFKRHUQXBAOfYGLgMZSJeEDTdab,OAAAGAAAMADAZADB.eAFAEAFA..dBBDaBGE....bBFACCDAIDFAhAAAFDED.HDBBhACAQDGCADHALEEAhBAASFGATGGA.cGEA.PHBAhAIA.....hBCA...,2,-13,-10,3
NDHCTfaGJBcLReWOdYEIFVAPQbKSUZMXg,QAAASAAAZACBMADA...XAFADAFAHBEA.TDFAhAAAGBDABAHARCFFeCHHhAAAdDHAEEBAFDBBAAIBKEDAgFCBhBCAfGBAaFFCcGGAOFHD...hABA......hBEA...,1,7,-22,29
ebDMQYWRCSNHcIUdGBFXLPZVJKAaEOfTg,EAAATAAA..eACAMACAQAFA.RCCACAHAHAEC.ICCAhAAAGDAAXCGAhAAAZCEAKBHBAAHAaDBCOEEAhADAbEEBDEIBSFCAUFCAdGGALFFA.hBDAPHFA...hCAA...,1,8,-4,12
RUTaFVGONKIJeBbPYSQAZcEfCdLDgMHXW,EAAAdAAALADADADA.HAGBRAEAUCBAaCAEGCEAKBHB..eCFFhAAAbDCD...SDDBhAHAAAEAZGDECHGAMEIB..hACATDGA.OFGB.IHHAhAIA......hBCA...,2,-31,-3,28
LXFWYJNIGVfcDUSBAdHaMKQZeRTOEgPCb,HAAAaAAA.MACAZACBRAEAEAFA..CAHB.LBEAFCEH.JCCBGCGAhAFAVDFA.DBBBBEDAACGBdFFAeFFBhAAA.OFHD.hBAA............hCAA......hCCA...,1,-8,-36,28
gTBUKbGaEWXAQZYeRHcMCNOIFLSPVfDJd,ZAAARAAAHADBMACAOAFALAGB..SBFBVCDB.DBIBdEBAhABATDAAKDHBGGBBhAIAECCBAAAA.eEGB.CBFA.FDFHhADAfFFEBDHDaEEHQGGA.hBEAYHCA..hCAA...,1,-4,-14,10
SBFTCLJOVUQaWcMGIegKHbYXdREDPAfNZ,ZAAAFAAALADAOACAUAGAQBGA..aBEDMCCAGDEBhABAeDDAHECA.bFGDdEAAhAEA.EEFAACCB.SEHHhAFATGBACHDA.WHAA.gGGG.hBGA......hBIA...,2,-12,-5,7
CcGRfXBPDaUFMgNIOTZVHLdeEKWAbJSQY,SAAAQAAACACARACFBAEB..aADDMAGB..IAFAhAAAZBGBHCDBeAGHEEHFAAAAbCEDhAIAJFCBGEGA.XGEChBIADFFBFGGH.OCHF.....hAHA......hAIA...,2,-22,-3,19
KVOUAQPYcgXaGCSMJfdBTRNWZFbLeEHDI,QAAA..cAAAaACEGAEAMACAdAGARAGBZDAALBDBhAIAHEDBKDHBOBFHAAIBPFHBhAAAXDGA.SDCDhBAABCDDTGAAFFFAEGBADGGB.IHDAhBGA.....hADA...,1,0,-9,9
LeTBcAfUdMJQRWIZVXgSYbCGOFEPaDHNK,dAAAMAAARADAZABB..XACA.SAFAbAGBGCEAEBBBDBIBhAEAHCEALDDDBBHAAAFAhAIAUGGAQDCDhBAA.IEGAgGCGOEHD.aFFH.hBAAKGCA.....hCDA...,2,-15,-2,13
eXCREOIKYcNQGHPMLUBAdTSDbZaFfVgWJ,dAAATAAADADAZADE..aACAFAHB..VAFA..JCBBeBDBRCFB.hACAECCBKCHB..cCFChAAAGDDAHFAALFHBhBAAACIBbEFA....fFEE.XGGChAFAOFCBIGGAhBCANIAB,2,-32,-10,22
RYbFXADCaGWELecNHgMdJfIVPUSBTOQKZ,aAAAEAAALADA.eAGHHACB.dAEBICBAPAHBBBFDhAIATDCAQDEAhBAA.REGFFEDHAAEAGDGAhAAANBBAMIDAfFCE.SEFDhAIAKGEA.bFDD.DBIB..hBCA...,1,-2,-15,13
bEfKHVeFPWOJIcMaZRQGDCgTBSNYULXAd,EAAAHAAAFACDOACA.JAFBMAEA.RBDFGBFACAHABCCA..SCEDhAAAUFBAAAIBdEHAKCGAeEFDhAAA...IHHAhBFAZEFBDEIBNHAB..YHCGbFGD...hAHA......hCAA...,1,-9,-26,17
dRfYgZWObLEMIPaCXeJFATQDHNGSUVBKc,TAAAHAAAGADA.SAFABACBdAEARAGB..fBHAhAAAZCCAbCFD.ECAB.MCCBhACAaEBAeEEDAAFAQDFChADADDIBVGAAKEHB.gFEGLHEACGGCFGCB.hAAANIDB......hAGA...,2,-6,19,25
THMNGQcRgabAOWXBFPJYeEKCfDZVSIdUL,XAAAFAAA..PADAeADAKAGA.DCDAZAGB.SBCHhBAAdCGATDAAHCEB.GECAhBGARDDBaDHDAAAABEHAEFGBCDFChADAfFGE.IHEAMIAA..hBIA......hCAA...,1,-14,-23,9
LbYJCPVMdQUKTHNXZDSIRfFEWeacOGBgA,LAAAJAAA.CAEA.MADAdAGAKCAAHAFCZCCBSBCA.RCDAFCHDhAIAECEFeBHH.aDGHhABAGEFABEAAAEFBbGCC.hACA...VGBA.TGGADFIB...hBAA......hCAA...,1,-14,-19,5
GWROMLaXgTBYdQVUCSeIAPKFcEJfNbZDH,FAAAEAAA...JADA..bACAHAGBGAGARBCBLCEBaCCA..TDAAhAAAdDGDQFGAhAGACDDDeDFBAADAKEHB.fGAAhAGADGFBMIAA.BGDA.YFFF.hAIASGBH.hBAAIHHA.,2,-17,4,21
SVJUfNMGBOCRaTbXAcPZWgeFYDQKdEHIL,ZAAAeAAADACAdAEAHAEALAGB..SAGEUDBAMAIBGCCBhABACBCA.RCGFaEFH.TGCAhCAAAAAAPDEB.FEHBhBEAKFHBEGBA...IGFA...hCBA......hCCA...,1,-16,-19,3
IdaCNJeHBVfYPGULgEWOADFQZTXRKSbcM,QAAAZAAARAEAKBHB.SACA.MAFAaCAACCED..eBDAhAAAHCFBBBGA.fCHAhADAGDAALFFAhABAEDDAADGBTFEA.cGFDdHADJDDF.PHDAhACA.....hBIA...,2,-25,-9,16
WAEcPTVXDdGHCZIbaFegMJUYNLSBRKfOQ,EAAATAAADADA..HAECZACB..aAEDeAHHMAGBUCBA.LDDBhAAARCGFOCABACFB..PDFDhAHAdDEAGEBA.bGFAhAAAFDHD...........hACA......hAHA...,2,-16,-10,6
DVfCKOUePQGdJXHETcNRZYLWaIFAgSbBM,SAAAMAAADAEA.CADA.OAFE.UBBAeAEH.GAGAdCEAHCGBhAIAECCBTDAAREBAZFFA.hBAALDFBaGCD.AAAAbGAAhADABHHDKEED.PEHD.....hBEA......hCAA...,1,0,-19,19
YKbeSHMfJVIaCPAXZcULgRNQFODWdGBET,ZAAALAAARAEAFBHD.DAEAGCAAEAGA..KBDAeCCBHCAA..MACAhABAfBHA.IDEAhABAaCFDAAHAUFFAQDGBhACAdEHATFDAbFBASFFB.hCAACFHA......hCEA...,2,-11,-6,5
fWCdHSFTPQDYIOAJKBgVGNaeELcUZbXRM,BAAAGAAAeACAEADALAGBZAFBRCAA.MAIBCAHAHCGBFBFB..TDCAhAAAQECA.DEFBhAAAODAHAACAKFBD.gEFAhACAaFHD.bGEAfGFA..hBFA......hCAA...,2,-23,-1,22
IYOaFWTVDbRNXZBHGSPgLcEUMAKJfQeCd,KAAAQAAAeACEdAFAOACC..aAHBTAGADBDB..RCDFZDFBhAAAHCDA.GDGA.hBIASDCDLEHBEHFEhCAAAAEACEFCFGAA..WCCDNIAB.....hAAA......hAGA...,2,-23,-12,11
VYHGKEUSLNCRgIJXQcZedfMOFWDBPaATb,TAAAVAAA..HADBEACELAEBRAFA.JAGBQCGAhAAA.eDAAdCCAMAIBhAAAFDEDBEGDADHBGECBSFAAhADACEHAXGAAZGAEOFHDDGGAaGED...hAFA......hAGA...,2,-6,-3,3
gCVfOePJKdALNbQGEMaSWFcBUZTRIDHXY,LAAAQAAAEAEAaACEFAGD..BAFAZCAARCEBHAGB..XCGAhABACCDAOCED.eDABhAAAKEAAAAIBGEFAMEEBSFGAhACAcDCC.IHFADDIBgGDBhADA.....hAEA...,2,-25,1,26
PAIFNbBKaGgCUJcYTRZdDMefSVXWELQHO,FAAABAAAGACACACA.UAFAJAEA.....TDFARBCAdAHADCABeDHHhAEA...SEBBhAIA.XEDDhBAAECFFHDGBABHAIHDAbCADaDEH.gGGAhBEAZGEAMIDA.WFBD..hBFA...,1,-17,-27,10
EWUeTPgHCBXAfYNMZDKLRIFaOQcSdGbJV,...fAAAMAAAZABELAFARADA.aCCAQAGChAAAdCFAGDGAbCAAEDDBeCEFTGAAhAGAHDFA.XEAAhACAACIBDFDBFFFHSFFA.WFHH.PHDAhADA.BCHANIEB.hAHA...,2,-12,16,28
DcFaVIYfECJOdMHgQBKALWXSRebPUTNZG,LAAASAAARADFeAFEUADAZAFBGBFAFAHD...aCAA.VFCAhABAfCCE.EDBBhAAAOCHDHDFCQEDDhABAADDBXGGA.bGFANIAB.DFBB.....hACA......hAIA...,2,-9,-3,6
VSJKYMFfPBTHDgcbZGLaWOXCEdUAeNIRQ,eAAARAAAQADC..SADAKAFCMAIB.fAGAhAAABBGAHCDCDAIB..bDGDGCCAhABALFFDaCFCXEAChAEACHHA.EDHFAAAANCCAIEFA.VGAAhAGA.FFHD...hCAA...,1,4,-19,23
RcbWEaNAXJHYPICBZUdDMQgOKGVTSLefF,HAAA..IAAAZADBdAGAMAIBQACAKCADGCEATAEAeCCDhAAARAGF..bCABEDGEACIBXDDAhACAJFBB.CDGDDEIBhAGAOFHBLFGBFGFD......hAIA......hDAA...,1,0,-10,10
AQFHLBZWbfIaTENSMXdGJDcPVUCYgKOeR,HAAAZAAA...bADBaACA.EAFAMAGBGBGADAHB...VCDBCCADKCCBhAAARFAAAAIBLDFA.hABAfEEETFFAXGCAhAFAdFBAPFHBYFHBeHDA....hCAA......hCBA...,1,-1,-11,10
QKEFcIbaJeGSYfHDBVWCZNRdTXUMPOALg,LAAAQAAAEAEAFACE....bAGDeAEHGCAASAGAhAAAHCCABEEACCFARCGFdDCATEGAhABAMEEBAAIBKFCA.aGEDhACAfFFADGGB.ZGAA.NEIA....hAEA......hBGA...,2,-6,-5,1
PAODSIeFaNdVgJMGKUbcWXBHQETfZYCLR,SAAAeAAAFADDdAFA..VADAMAHBGAGAKCCD.UDAA..hAAAbDEBXCCD.hAAAHDFBEDHFZFBALFDBhABAAAIBDFIBaGFDgGAA.cFGDBHHD.hABA......hBFA...,1,9,-21,30
RXgaQODETSBLcWYbfVMUPHeFNACdJIGZK,dAAAGAAARADA.aADAQAGCDAGA.ECBATBFA.LBHBhAAA..cCFChACAbCDDMDCBHDDBFEGHAADACCHAIHDAhACAZFGBKGFD.OFHD.....hAIA......hBAA...,2,-17,-4,13
EbLdPDVgZQAITfHMeGWUKONYXRSBcCaJF,TAAAHAAAeACE.GAFAKACCOAEC..XCCARCCABAHBaCFAhAAAEAHBdDHA.DDFBZDFEhAGAACCAMFAAUFGASEEDhCAACFGDFGHD.........hAAA......hAFA...,2,-21,-11,10
eOMLZgGTaVFJXcbIQHKYUCSfPdANEWBDR,EAAADAAARABA..eACAMAEAZAFB.GCCA.aAHDFAHD.XBDAhBAAbDAB.HCFBKDHBCEFAfDDAhBGAAFCBBFEDLHBAhAAATFGA.JFHFIHDA...YFFFhCAASGGD.hCBA...,1,1,-30,31
MfCDQSGTOXacFBbWUEKYZVdPNLJIgAReH,HAAAMAAADAEAGADA.TAFAaAFE.BAHBUBBAECABZBEA.dDEALCHBhAAA.gDEHhACAREGBeGDA.QFAAhADA.XFGC.FCCH.KHDAhAFA......hDHA...,1,9,-37,46
OeYMUaWHDgbLfNEcFXCBRTPGSJdQIAKVZ,ZAAAeAAAMACAUAEAHAECDAHB.LAHB.ECCBXBCDBCEARDFB.hABAGDEAdECDAEHAOFFHhCAAaBHD..bEBBfHCBhCBAFEGATGGASHGAIGDA...hAAA......hABA...,1,1,-20,21
QGWKbeINBELYfAdDXSTUFgcOCJHMVRaPZ,dAAASAAAFADA.OACDHAFBRCAA.ZDCEGAEAKAHB.eAGBBDGAhACAEDGBLFFAAAAADAIBTEAAhAEA...gEDBhAHACHAAMHFA.aEHD.QGFDhBEA......hCAA...,2,-28,-9,19
UdfZTDVGXFQMeIEbLKYOBcCaJPRAWSgNH,SAAAHAAAdADAZAEBDADAGAGA.QCABeAEAEAHFLCCAhAAAODDBCEFA.aCFDRFGBAAIBNCIA.hABA...UECATGBAhAAAFFFAMDBBKFED.BHDA.....hACA......hBGA...,2,-10,-4,6
VQBCbKaLMZOHYJdGDASPeTfcgEUNRFWIX,eAAATAAA....fADAEACERAEFFAGA.XAEDQCCChAAACAGAKBHBaCFDZCCAHDGBdDGAAAAAhAGASCHB.hAIAgEABUGEAIGHABEED....hCAA......hCBA...,2,-23,3,26
PNKTHQYJIcgVZEGRCbaAfBWXdUMFLSeDO,BAAAdAAAMADALACADAHB.OAFDKBDAHBFBQCCA.JAHBhAAAgCAA.hADAEDDBREAAaDGEAAIB.XEFChAEASCHHeFDFTFBAIGGAZFEBCGGAfHABhAHA.WFHHhCAA..,1,-7,-26,19
EPQSOYWfKgZAGHaFRXMIDBCLecdNbUTJV,HAAARAAAMADABADB.eAEHdAHAUBEA..TAGAECCA.QCABhAAAODFE.fCFAhACAZEEAAAAAaFHDFGCADCIBLEEAhAGA.bDCD.PFHDSGGDhBHAKGEA.....hAIA...,1,-6,-20,14
JaTGZDEIUQdOBVRSfAcKeLFCNPYMgXHbW,eAAALAAACADA...PAEAMAFAHBDC.JBHBGBCB.hAAAEAHFQDDChABAdCAABCHARDDAABGAFEGHgEGAhABAbGDC.aFFHDCCBIGDA....hACA......hDAA...,2,-17,-13,4
YUHIPQaDETONKRZGCVJbgdXMcFSLWABef,eAAAUAAAHADAQADAEAGE.OAFCRCBAGCFACCCA...bFAAdCGAhAAA.MCIBFCHFLFHBhADAAAHAfDEA.IFFAhABAaEEHDFAANIABZGDA.......hAFA......hAIA...,2,-12,1,13
gbGVdNKFHOXQSUecLIJAfWTYPMRaECZBD,TAAAMAAARACA...EACEZAFBBAEBDAIBGCDAdAGAFCCA.HCGB.QFAAhAFAeBHHLDFBhAAAABBB.fEEAhAIAPFFBaHBEbFCDKCCDSEHHIHHA.YHFAhBGACFCA....hCAA...,2,-16,3,19
JbIfFDAdERBHWGgUMNeTLCVKYOZaSPXcQ,RAAAHAAAGADAMACAeAFALAGB.KBDAZCFBaCCCXDAA.hAAAQFACbDEDFDHDAAIBEFBAhBFABCHA.UGGATGCAhBGACEHAODDHSGFA.....hAAA......hABA...,2,-10,3,13
OHbWTNIJcSYUdGeARZMDLPaVBEXCfFQKg,RAAAZAAAMADALADB.aAFAEAGA..CBFA.QBDAKBHB.HCFBhAAATCAAICHAhABASDEAdFCAACCBDEEBBDHDhABAFEHDOFBANIBB.cFDD...UGGAhACAeFFB....hBIA...,1,-7,-16,9
GJNYZALQTdBCDRgVOMbEPeFfKHcXWUSIa,TAAAdAAADADARAEA..OACA..EBDBeAFAKBHBHCAC..hACAXBDCSCFHhAHAGCEBJDHFZFDAABIBLEEAhAAACEED.MCCBFHGE.fFHA.hAIAcGAA...hBAA...,1,-11,-20,9
LQPATXcSKBCWIMZFdbfJHYDgNeUaGVREO,TAAASAAA.CADA.MACAZAEB.dAGA.JBDBHAGB.DCCAeBFDhAAAGDAAECHFLDBBhAIAAAAAKDDDBDGDFEEB.bFGBfEFEhADA.gFGHaGBE..hAIA......hBGA...,1,-4,-28,24
ROXDPJGHeCYdIAEFUBTcaSZMVKLfQgbNW,EAAABAAA.aACAZACB.MAFALAFA.QBCCbBDD.RCEADCIBhAAAGBFAHEECeBHBhAAAdFCAAAGATFBA.SCBDhBCAfFHAgFFAOHCE..hBFA......hBIA...,2,-13,-11,2
RaWNLgQISOBPEDTKJdGfZYCHXbFAMcUVe,MAAAVAAA.RACA...aADALAFB.QCCBOAFDEAHBTDGAhAHAdCDAZDFAHEEBFEBBACHBhAAAeFCB..gFFAhAIABAHAKGHB.........hBAA......hBBA...,1,-12,-21,9
ReabATcVOKGPJMXBDQZUWHCFESNgLIfYd,TAAAOAAAGADA.MAFADACAZADEHBFBEAHB..SBBDhBAALCCAfCGAhAAAREFAeBHBADDBKFBAXECAhAFABFED.QFFACGHANIBB.gGCBhAIA.....hBDA...,1,-5,-8,3
GVJdSgMODPQcAUWIFCBaHEfLbNKRXYTZe,UAAAFAAABADAHADALAFAKAGCRCBA....TCFAeCCAGCFAhADAdCHA.MCIBDDABQEEChADAAAGACEED.EFAAhAFAbFGDXFCD..YFDFJFHB.hBAA......hBCA...,1,-7,-25,18
JDadfTWeONBEFVZQRMKUcCSXGLPAgIYbH,..IAAAHAAAaACAdACA..TAFAeAEABAHAEBHFZCCARCDAMCBBhAEAKDGDCECAGFCBLCGBAAHA.hAAA..bECAfFAAhAFAOEHDFFAH.QGEBSDHH..hCAA......hCDA...,1,-1,-8,7
dFOCMAcegRNbBQHKaGTfIEDWJUZPXSVLY,eAAARAAABADBHADAGAEATBGA..EAGADAFAUDCAZCCA..SDFHhAAALCHBdEGCCDHAAAIB.hABA..gGAAhAAAbFCBaFGD.IGDA..WFHH..hCAA......hCBA...,1,-13,-17,4
FVdEaNLePTgcGZAWHQXbURBOYIMDKSJCf,HAAAQAAAXADBRACABAFBOAFC.MCABSAGH.hAAACCDAFCFHECCBaCEDLDABhAAAeCGBTFFAGDGAAAIBhADAWCHB..YEEFKGEDfHABhACANICB......hAHA...,1,-7,-10,3
YARKgaOIWHcDPJTeZfGbQSFMLEdNCUVXB,RAAAaAAAOADAHACBDAEA..JAGBeAFA.GCEAQBDDMBBBEBHFhBAAdDHACDEDUGCA.BEBAhBEAAAAAKEFB..gGFAhCAAIGHA.WEHBPHEC....hAIA......hBIA...,2,-38,4,42
bJQTgIVRZEPCGUDecaHLFMBXKNfdWOSYA,QAAATAAA..VADAEACAGAEA.eAGBHAGBMAIBhAAAKCADdCCASCDDhAHAAAIBbDFAJEDBRDFFZEBA.CEHADGHBhBEAaFFABGAA.fGGE...hCAA......hDAA...,1,-2,-10,8
MQCdJcOPgBNbUSTDAREeZKXIfFVaHLWYG,EAAAeAAAZACBKADA....XAEAFAFAHCCALAHBGCFAMAIBhAAAdCBCOCFBBECDbFCAhABATECA.REGBfFAAhAAAaEHD.QGEACHCAPHFC...hCAA......hCBA...,1,0,-12,12
cgTKWBaFVCDALIJPbGfQEUZNHMOdYReSX,LAAAJAAAGADAEAEAZAFAHAGB.dCAARCFA.eCCA..XDAAhADATDEABDHAaDDHCEGA.AAIBIFGAhABA.bEAAhACAQFED.MEIBSFHHhAEAKGAAWHAADGBB.fGDAhBGA.,1,-9,-15,6
bKTaPfCFBEJSRZWIDGOcLgMQXUYeHNdAV,KAAAaAAA.CACB.BADA..EAEARAEFZAGB.DBBBGAGA.LCCAhAAAMBIBUDABHDFBACCA.bEAAhAEA...TGBAhAIAFDDBSEFAOEEH.QGAAeFHF.hBGAdGEA.fGGAhADA..,1,-7,-22,15
aDAbIZRVUgfCEOWXKYcLdGHSJTeBNQFMP,ZAAARAAAUADACADB..EAFAOAFC..KAHBLCGBHCAA.SCCDhAAAeCEAQDGAhABAMCIB.aECAAAHAIDFAhABAfFAA.XFCCdDDATGGAFFFBDGHBhACA......hAFA...,1,-14,-21,7
YUSAGdJgBCFKRNIQMTPOebLDHcaEZXWVf,dAAABAAAKADARACA..QAFCMAFA..TBFAeAHHLCABhAAA.HCCCECBAZDAAhACAXDFDfCHAhADASEHBABHAGEDACFEDFGGBIFHAOHAADIDAhACAaDDAYFFB.hADA...,2,-12,-7,5
gUTSOVDIHbLGdcfNACQYaRFWJEePXZBMK,QAAARAAAFADA.EACAeAFHZAEB.MAHBKAGAUCGA..TCCAhAAAOCDHDAIBHEBBGDFAhABAdFEA..fGGAhAAAADIBaECCJFHBBHEA.......hAIA......hBEA...,1,-12,-18,6
OeJdbASHURXFYMQZTBKgPCGNDcaLIWEfV,HAAARAAAFADA.MACAZAFBBAHAKAFA..CAHBGBDADCCA.LCCDhAAAECHB.OCGBeDDBdFCAhAAAACHAXEGDQFFAhABAPFEDaHEC...IHHA..WFHHhCAA.....hCAA...,1,-16,-22,6
dDFVJWEeIUKARfOPCQaGbYTLZHXNBcgSM,RAAAOAAAQADCGADA...TAFAHAFBBAHASAHBhAFAdDDAFCHDVCGBEEGBeFABhAAAKBBDADDBCDBAaCCHLFDAhBAA..XFDA.gGGAhABAMFIBDGHB......hAFA...,2,-8,-2,6
CKcZOeFbAHISdVRLGBUEgQNXYPaTWDJMf,HAAAdAAARADAGAGAEADEQAFC.XCAAaCAEDCFB..MDDBhACAKBHBZDCBFEAA.AAHASDHDhAAALFFABEGDgEEAhACA.NIEB.TGAAfGGBOGDChADA.IHHA.hCAA...,1,-10,-14,4
UaEKRGgPDSXOfQAVFbTNBJYceCZILWHdM,FAAATAAABADA..JACAeAEH.ZAFBLAFBHCCBdBHAaAHBRDABGEFAhADADBIB..OCCAhAAAACCB.VDGB.bEEDhCAAYEHH.CFECMHCAEDDB....hAIA......hBAA...,1,-12,-13,1
PeJCQBTRaXfISNZMgcbKEDLFUAGOHWYVd,HAAAVAAA.eACE.QAFCRADF.aAHDfAFB.hAAASAHBZCCAMDGBbECBhAHAECFALDAAhAAAADIBOEHBYFFFdDHACEEATFCA.XFGChADA.IHEA.hCAA...,1,-3,-6,3
EcCWaXFBbMgILNZdVUfJRTKHYASODGeQP,DAAAeAAAEACACADA....aAEDBAEA.MAGBLAGBdAHA.fCCAhAAARCCAHDFCABBBGFCBhBAAQDEC.cDGDhABAFFHDIHBAZGBAUGGA......hAIA......hBGA...,2,-20,-17,3
TVgdYNZLeBGDHXRfCaSIbPcEAJUFQMOKW,FAAAMAAAKADA..TADAdAFAZAGB.LCCBeAFEGBBAHDADREDFaBFDhAIA...SCGHhBAAbFGB.EDEBABIB.QFCAhBBA.OFGBgGEHBFHBDCIBhCAACDHA.IHHAhCBA...,2,-16,-5,11
AXIeSHTEYBaQgObdDGfKRLZJcCVPWFUMN,eAAAHAAAEADEBADAaAFAQAFA.OAHFdBGDGCAB.hAAARDEAZFCACCCAVCEBFEHDMIAAhAAAADHB.SGFHhACATECAbFAD...KEHB.cFGC..hABA......hAFA...,2,-18,2,20
GSNfXgDVdMFPeLAUIBcHYbJRWaOTZECQK,BAAAHAAAJADARACA..aAFAZAGB.ECABKBFAGCCA..SBHHhAAAXEFA.DCAAdCFCMCEBhACAeFHHADAA.UGAA.hADA.IDFA.bEGD...OFFBhAIA.....hAAA...,2,-30,-11,19
HcMgDdGREBXKUfVeNLWYZJQTOIaAPSbFC,SAAACAAAHACA.MADAdAFAEAHB.KCAAVAGBLCEAZBAEQCDAhAAAODDB.ABEAFDGHhABADDIBREABBFDAUEFAeEHHhAIA..NIAB.JFFFaGHD.......hDBA......hDCA...,2,-13,-9,4
ebBGHUNSDJMYRLXfOTVcAQWPEKCFgaZId,QAAAEAAAFACD.ZACBeAEAGAEAHBFCSAGAMCEBRDFBLEAAhAAAOCGD..TEBAhAAAAAIBKDHBaFDEdEDAbFFABGHAhAEADCIB...XGAC....hAGA......hAHA...,1,-6,-8,2
OGZbXEHJTfAFUWdSBNcQIDYMVaeCLRgKP,FAAAdAAABADAQADADAFA..MAIBeAFALBFBRCCBKBHBGCFAhADAZABB.EEHFHDCB.TEGAhBAAAFFBSFDHhAGA.IHHAaCEBCFFDOHBA....hBHA......hCDA...,1,-8,-23,15
JMdUfGEPCFLTagSAKNeQYZIXHBDcVbWOR,eAAAZAAAHAEADAEA.VCAAOAFE..RCFAdEDAGBCA.EBEBFEAHaCFDhAAAAACAQFFAhABA..XDGDhABABAHBbGCCMEEB.fFFE.LHCAhAIASHGAKHGA..hAEA...,1,-5,-13,8
VCMYGeAHPJFfbDcZXLKNBTRdIgSEQWUOa,HAAAFAAADADAZADBLAGBBAFARAGFdCAD..SBCAECFB.QCEAhAIAOCHDaEEBMBIBhBAAeFFBABFA..fDBAhBDA.bEEAKFHD.NIAB...gGGAhCAA.WDDDhCBA...,1,-14,-34,20
dRSFLTOUeaHWYGIAZCXbfQcgBJMVEDPKN,ZAAAXAAAQAEABADA.MAHBDAFAKAHBRCAALDEB.OCHDhABAeBDAHCECGEABAAAAbDAAhADA..fFHEhACAgEEBEGBBdEHATGFAaHCA..IHFAhCAACGDD....hCBA...,1,12,-22,34
BReTXEZVaPbFOKdUGYMgCcIQAJfDSLNHW,DAAALAAAHABCRAEFeADH.EAFAaAGA.FBGDdBHAGDDAMCABCCEAQEAAhAEAACCB.SCHHhBAABCGCZEEAbFAAKFGA.hCAAUGEA..gGFGIHHA.fCCEhCBA...hABA...,1,0,-19,19
XRJZcgMESePaFKQUIWVACGfHTYONbDLdB,GAAAHAAATAEAOADADACAdAHABAGBRBFBZCDFMAIB..EDHFeCCBhAAAaDBD.QCEBhCAA.IEGAAAABfFDEhACAbFFALHCAXFGA.gGFGhBCA.FHBAKEED..hCDA...,1,5,-3,8
EDCJLKAHGedPYgWOQVIaUFRZfTbXNcBMS,HAAAeAAAdAEA..gADBQAGAaAFARBCBZDFA..bBFDXEBChAAABBHA.EEEBCCADLCCBhAAAACGBGGABPFHBhABAODHDIFFA.fFDAhACA.NIABSGHDhAIAKGFB,2,-15,-8,7
REdbJHDaXgITPBOfceLWSQKYGZCVMAUFN,FAAAEAAAdADAHACB.aAEA..XAFA..TBGAOBCHeBEHhAHALCFAQDFDhAIAGEDAZEBAMDBBADIBRGFADIBAhBAAgFFB.BFHB.fGAEhAAA.SGCDhAFA.,1,-2,-20,18
eLWYJIVGMZaUDRcNTXbQBPEAfgSOHKdCF,SAAAHAAAdADAeAFALADA.JAHBGCABZCCA.aBGERDFF.TDEAhAAAQEAAEDGEAAFAOFCBhACAFECE.IFGAhCAAMDIBDFHB.XGCABGHA.fHABhAAA....hABA...,2,-19,3,22
WBLNUKXHZAReSFQbgOaEIJTGDCfMPdcYV,RAAAeAAAQADCOADC..EAGEJAFA.GCDBCCCA..MCEAdCHAVEFBhAAALDEA.KEHBhAAAHGCAACIBFFAAaCCHTFDAhABADEEB...fFFB...hABA......hAIA...,1,-9,-16,7
edUSYGDXATICNRbQZKHfcMaVWOLBEgPFJ,TAAACAAARACA..ZAFBHACB.MAEAaAHD.OAHDECAA.FBEAeCDFhAAAdDEASCADhAAAGDGAAACA.bDFDQEEAhAFA.fFCEWEHBLHBABHBA.PHFChACA....hBHA...,1,-2,-11,9
CZcSNYFRVJgaQAOfXWdDIGEMBKUHLePbT,XAAAdAAAGADABADAHAFALAFAeCBFTCGAZCDA..SCFEhAAAFDFHRFAA.gDAAhABAAADBfEHADCIBEECAhADAMIAAKEFDUGGBbEGDCGAA.....YHAGhAGAaDDH...hACA...,2,-3,2,5
cUAYFEOgGJITZBCRQSWLdVMfHbKeNPaXD,EAAAGAAA.JADAZACBBAGBRAEAQCEB.LAHBdCDAMAIBhAAAHEECeCFBaCBBDCHBAEHAOFAAhAAA.IGHAhAFATFEASDBH.fEHAhACAKHCA.XGCChBAA..,1,-7,-21,14
LBURWZbMSGITNAJFCOEXYPfeQVaDKdgcH,CAAAEAAA....XACAfACA.eADHaAFAdBFAHAFALCAAhAAARCEBZCGBMDIBGCGAhACATFAAAAIBODEBQGDAhAAAKFCBBFFAWHAGSFHHIGGA.NICB.hADA......hCBA...,2,-22,15,37
OLWBPSdeNRGbJAXagcQDYFETfVMKZUIHC,aAAAQAAA.FACEEADA...TAFAMAFAZBDEHCCALBHBhAAABAHBdCHARDEBbFBAABBBXDAChADA.DDGBfFHAhBFAKEEBCFCAOFHBSGGDeHDA..hCAA......hCHA...,1,-6,-18,12
SUEOHYNZXGaCPBIdeRbTQfLMWKDAcJFgV,FAAASAAAEADA.HACBZAFBGCCACAEA.BAHAeAFHRCGFQDAAhADAMAHBDAIBAAAAJDEFUFEAhBAAODGB.XEAAhAEAaGGA...dFHA......hCAA......hCBA...,1,-15,-20,5
JcdCQMDaULbGNZVYOIHSKXeAgEBFPRWTf,EAAAFAAARACF....TACAJAEA.dAEAMAIBaAGA..LBGBhAAAGCDAZCFBOCCBHFCBXDEBhCAAACFBBFGA.fEHAhCBACGHADIEA.bGCA.......hAHA......hBAA...,1,-5,-27,22
IQZCPTHWEbJUDASXdNFYVBceGKMfORagL,dAAAFAAABADAeADAGAGAKAFA..MAIBRCAAaCEBLCCA.ZCFBhADATEFAHECBEEHBbEAA.hACA.DDIBAECB..XFADhAFAVGDA..fGBAOHDCIGGAhAHACHGA.....hADA...,1,-10,-13,3
KEQZcTWOLeIGMYPASaUHJDNbBRXFdCVfg,aAAAHAAA.DACABADARAEAdAHACAFA.....VCCAKAHBEBBBZDFB...hAAATCEALEHBeCGHhADAGFAB.MIDAhAFAADDBSDHH.UECB.bFAD.fFFEhAFA..hAHA...,2,-33,-8,25
IZGYJEaKXBRbQVLTCNDPdWMUFeAgcSOHf,SAAAHAAAZADBGAFAEADA.aAHFBAFARDAA.QBGALDHBTEEAhAAADCCAdDAAMCFBhAAAeFBFAACAODDB.fEGAhABAIHEAKFDDbGEACHAA...NEIA..hBFA......hBHA...,2,-8,1,9
bXEgMVZPdRSfHBKIaQcCWTGYeFDALNJUO,LAAAUAAAOADAEAEA..MAHBZAGBRBDBHCAABBFAKBFB..QDBAhBAACCEDGEABeCHHhABAABIB.JFEB..bEFAXGFDhACA..gFEG..hBCA......hBDA...,1,-3,-32,29
CZbHPIGUgNAeOQDfMTRVBcWJYaFLXESdK,eAAAQAAAMAEARBCABACA...JAEAaAGELAHBECFA.dCDAhAAAZDBAHCFBGDGAgEBBhBEAAAAAfFBAhBDATFGAVFEB..cFDD...WHCAhCAA.....hBFA...,2,-10,-6,4
IYeJADWVTGUbQNCSBXHEOPRdLMgcaZfFK,DAAATAAAGABB.QAFCSACBHCCCEAEARAGBdAHA.MDGBhAEAaCCCZCEBKDHB..eFEBhBAAAAIBUDGBCGHABHDAOEAAhAAA.LHFA.fFGA.hCAA......hCBA...,2,-15,-1,14
WJXYMKHPUSZBGRLOQeAfdabcNgTEFVICD,aAAA..bAAA....gACHEAEAFAGDCCAADAAAJAFA..MBBBhAIAHCCCUCEAZDFBREAALCHBhBAAeCHHAAIBdFEC..hAEATFBAIGHAXFFC.KGDB.BDDChBFA.....hCAA...,2,-10,-10,0
cJUIVDbPNGMXBTALZSEOFfWQgCdeHaKRY,ZAAAEAAAFACDQAEA.dAHAHAEARCAA.JBHBUDEADAGA....hABAbCDAGECA.MEABhACATEAAABGALEHBhADAfECBCFGAaGEDKEHB.IFFA..hAAA......hAEA...,1,-1,-29,28
MTWaFDfSAJOLNdCYPKBeXUHcGEIgbVRZQ,LAAAdAAACADA.KAEAeAEHHAGBGAGAECAA....bCDBRCAAZDCEhACAMDDBaDFDDDIBAAGBODHDhADA..PEABhABAXGGCIEGA.QFED.hAIAFHGE.....hBAA...,1,3,-21,24
PRQHCgAWZSIGVYNTcdLJeOMXEDKfBFaUb,ZAAAGAAA..VAEATADAdAHALCAB..eAFEMCCBhABAEBFFKDDAFCDH.bCGDRDFFHFDBhACAAAABSDADhACA.IFEAcFGD.XGDC.BDFAhADA.aGGA...hADA...,2,-17,1,18
PCWdfbUeYDVFJaGEMHATgQBSIZcKOXLNR,TAAAQAAA.SACAZACBOAECLAFARCEA.CCDAdCFAhAAAbECBUEGAeCHBDDAAFCAH.hAAAGEGAEGAA.HFDBhADAAAGABCHBKGAA.XGFC.NIAB....hAGA......hAHA...,1,0,-4,4
aLQRfOMJbAVDgPSZEGBcIFYCXNeKdWUHT,DAAASAAAEACA.GACABAEAFAGA..XAEAeBBBdCFAHBGBhAAALCHBRCEBMEABADDA.hBAAgEGAZECB.hBGAIHHACFFAKGHB.WEEDaHDE.OHAC.hCAA......hCDA...,2,-27,4,31
DGLOBPSUEVKHMXAWNgIYJaRCbfZQFTced,...NAAA.gAAA..IAFAaADARAFF.CAHAZBBAQCCAhAAAFCFA.eAHHGDAAhABALDFABDDDSCHHhACAEDBBHFFAAFHAYHAAbEFCTGGA.dFDAhADA.OHAE..hAEA...,1,7,-17,24
UOWFZfaNXPgeIdYVLSMEHDbQACGKTJcBR,GAAATAAA.BADARACF.OAEDZAEB..aAGDXAGA.eCDBhAAAdDGALEAAhAAA.ECABHCFBbEEBAAIBKEHBhACAUGBAfFFE.gGAAhADAIGGA.SHCAhAGAMEIB.CHGA..,2,-19,1,20
LUIDTZWbBVCeOGAgSXNQEHFcRMfJKaPYd,XAAAEAAAHACARAFF..MADAKBHB..aCCCdAHALEAADBDAZBDEBDEAhAAAeDGFAAHASDFHhABA.QFGAhBHAfEEAPEDBIFHAWHDACHHA....hCAA......hCBA...,2,-23,-10,13
NRPIDLBYGaOeJXUQWdSgZAKEbTMHcFCfV,EAAAMAAAHACAFADD.CAFB.....VAFARAGFDCCBLBBBGDDAeCFBhAAAXCFCQEAChAEAdDDAZEGBACIBbFGD.fHEFhAIAIFAAaFFBOCHD.....hAFA......hAIA...,1,13,-24,37
gVULDaNPRMYHJcWEfGFBICbAdQeSXOZKT,eAAAOAAAZADBKADA..TAFAUAFALBHBDAIB..aCCBRCCAHDFBhAIAJCFF.EFEBGEGAhAAABBBDCGHAACHBdHAB.SDBDhABA........hAHA......hBDA...,1,-20,-27,7
PdWYLfTEMcKJOQABbeaICDRZHgXNSVFGU,eAAAaAAA.DAEAHACB.XAEASAFAGBGAdBDALCCDhAAAECEFMBBBKEADQCGAhABAAAHABEFACFEDRDEBZGCA.gGGAhAIAFFHD........hBIA......hCAA...,2,-11,-10,1
XcbUNKQRPWHLgEeOBadCGDZTYMFfJIVSA,XAAAUAAAQADARADA.HAFAEAGEeCDAaCBEGCGAZCGBMDABhAAAFDAH..JDEBSDCDhABAAAHA.bEADKGDDLEEBhADABGFADFIBTGGA.....hADA......hBAA...,1,9,-13,22
IGFXSCbMQBNLdUTHOPRcWeaDfYgZJKEVA,GAAASAAAMADAQADALAHBdBFAHAFARCDB.eCCBDDCB.fCGAhAAAZEGBEFCFAAABFFFBhACAbDADBDHA.TEEAhABAOHBEPFHB.aHAA.....hBCA......hBDA...,2,-11,14,25
DVGCFdegTNWEQAMaUOScZJBPKbfRXYHIL,aAAASAAAZACB.BADAKAEARAGFHAEB.LAGBGCEAdECAeCCBhAAA.TDAAEDHFABBBMFIBhAGAOCHD.JEEAbGDAXGBAhABA.DGGA.CHHA.NIAB.....hAIA......hBAA...,2,-17,-2,15
NBDdcGIUAbLEfOKHMaSJWFZePVYgTCQXR,EAAAKAAAHACB.aAEASACA.FAFAeAGH.VCABTBEAhAAAQDECRCCBDAIBGCGAhADAAAIBLDHBMEFB.hCAAZFBBgGDDXGFCBEGAdGGD...hCBA......hCCA...,2,-11,1,12
SeKGJTMNVcOXaEPCIBAgdUQbfFWYHDRZL,dAAAQAAAFADAHAFBRACAZAFBeAHBGCDA.MAIBVCBA.XDFAhACAEDAACDGA..ABHBUFAAhAAAbFDA...fEHAhADADEIBKHGANIABaECEBFCA.gFFDhAFA......hCAA...,1,-1,-6,5
aFfQHNERJUKgGcDSVPWLXTdIMAbeBOCZY,eAAACAAAZACA.FADDHAGBRAFA.KCCAGCDB.DCCBSAEE.hAAAVDABLCHB.hAAAdEEDAAIBODECaFAAQGAChABAEEHFUGDAgGGA..cGGChADA....hCAA...,1,-8,-22,14
IVeDaZHRJYLXABbdQSgCPOUMTGWNcfKFE,dAAAQAAACADA.OACCMAFAGBDB..NAEBKBFAECBFeBHHhACAZCDAHDGBRDDBLFGBhADAABHASECAUGBATGEAhBAAfFEA.FGGHDEIB.....hAAA......hCAA...,1,0,-20,20
SFCaUgYBIAGLWKPDJeXNdZRHVfbMOEcQT,GAAALAAAKADADAEAeAFEdAHAHBCC..bBFDECAB.QCFDhABATCDA.CDDDaDHDgEGAhAAABEFAABFAJHBAZFCAfDCEhACA.MDABSGGAhACAFGHDICHA...hBHA...,1,6,-17,23
QgcXMIPDJKLaVHfESNZAWYeUTbRBCGdFO,eAAATAAARADAGAGA.dCCAQACC.XAEBhAAAMCFBDDGBLAHBHEAAEEHFhAAAZBFBAAIBUGABbCDDFEGDOEDDhABAIHCAKGGD.aFHD......hCAA......hCHA...,1,3,-9,12
RaJWUKGBQISZAHEVCOgNYdbePMXDTFcfL,HAAAEAAA.OACA..gACAdAGAeBDAMAIBTAFAFCCHLAHBhAAARDFA.aCDDUFDAhAAAGDAAQFGAhCAAZDFAADABCFCAbFFBDIGA.fGDA...hDAA......hDBA...,2,-6,7,13
OPfGRLcFCKSBJETMDIVNWUQYdeXbgaAZH,HAAAOAAAGADARADALAGBCAFABAHA.ECABMAIB..DCCBICCAhAEAVCFA..UFAAhAAAdCFCeDED.bEGDADDBZEFAhACA.fGGA.....hBAA......hBBA...,1,-8,-26,18
YUIEeJWOPKcCbVZSgGBFHQdfNaXALMRTD,RAAATAAADADA..UAGAEACE...eBDAOAEAKCCD.CAHAZBFAGDEAhAAAHCCAdDGBaDFDLEDDhABAMDHB..JECFPEBBhBEA..cFECbEGD......hAAA......hCAA...,1,-8,-16,8
gSPLcCHAFbMJXBOfVUaKIDeGNWYTdREQZ,MAAABAAAOACAUAEA.KAFAeAHB.GBBA..NAIA.TDEAhAIAEBCBZCDB..SCHDhBAALCGBHDBDhAAAABBBbFGB.fFEAaEBHDEDB.dGGARGDA.PHAAhAHA......hBDA...,1,-1,-19,18
eBdLCgAfORMTVQPJDFXSZEcWNKYUIbHGa,RAAAMAAAQADCDAEA.FAFAZAEE.EBBA....NAIA.KBHBUCFAhAAAHCDCeCCBdEEDLEHBhAIAAEEBOFDE.TGCAhBAAJFHB.SDCD.YHFAIHDAhABA......hCAA...,2,-23,-7,16
VReHBXdNEKAPZWbMDCOYIcgUSQafTLJGF,ZAAAMAAAOACA..IAEAUAGAQBEAaAFD.LDDBhABAGBBARBGFHDFCdDEAEEGBhAHAACCB..bFFACGGDYECBhAIA.........hBIA......hCAA...,2,-18,-17,1
XAGFdEZMgLVOKcRUTefaHbBIDQWJSPYNC,dAAAEAAAZACBMADALAFAKAGA.RCEA.eBDBHEBABBEBQEGAhAAA.SCBFhAGAPCBDCCGAACIBGGEB.FHAAhAHAODDH.TEGA.aFEDDIDA..hBCA......hBEA...,2,-32,7,39
dSQbXZgacEPKADYJNVBfMWTGFIReCHULO,DAAAJAAABADBMADAGAGA..RAEFHAGBLBBAdCCA.QCEDhAIAZDFE.aDBAEEDFABFAVFEAhBAATFGA.eGAEhAGAODHD..XGDD...cGFChAIA....hBAA...,1,-11,-24,13
cUfLGDVFSaQWMgJIAYRdNECBZTKbHXPeO,RAAAEAAAZADBKACAHAFA.eCCDOAEA.UBFBGCGA.FDABaCCAMCFBhAAA..JDDFAAHAdGDAhABABDGDTGFA..hADAbFED...XGGA...fEHAhAAADFIB..hAIA...,1,2,-41,43
eCPWGXSAZMLFHVOfYDJdRKcIUQabTEgNB,ZAAAMAAAHAEA.OAHDDAEARAFAKBBAUCAA..QBDCaCDD.hABAECGABCFA.eDGFhACACDEAGEFAAADALFEBhAGAfDHAdGHAIHAA.....hAIA......hBAA...,1,-6,-34,28
SdCGYMgDfZXUPcHAIabOeFTKNBQRJEVWL,aAAAeAAA.KADAQADARAFF.EAFALAHBdBHAGCCAMCCBfBBEhADAZDCBUEEAHFABhAAAACGAOEFAFEHBBGHAhABAVFFBCGDA.DFIBPHCC......hAFA......hCAA...,1,2,-5,7
cGMTbXSYdVPgafIBCODKHWEAeQLRZFJUN,eAAARAAAZADBFAFDUAEA.GBCA..MAHBTAGA..bDABSCGAhAAA.dEBAhABAgDEAaEEABEHADFFBhAIAHEGBAGGALHEANAIAXFDC....hAAA......hABA...,1,-4,-25,21
bZLJFOaHUdEVXGCIYDMPgfTNQcSWeRAKB,BAAAZAAALADBOACAHAFAEAFAGBGA.CCAA.DBCB.MBDB.hABA.fDEAhACATCEAQDGASCCDhAFARECAAAHAbFCAaFGCdGGAIHCA....hAAA......hCAA...,2,-24,-5,19
OVKJHfBbeQXAUFENZTcCgRISLdWPGaYDM,EAAAZAAACADBRACA.LAFA..dAFAGCAAaAHBMBIBKCDAHCFB.hAAABCHAeCCBAAGAFEEHTDAAhADA..IFCAhABASDGB.PEEBOEHDfFHAhCAA.XGFDhCBAcGGCYHCA.,1,-7,-13,6
UdVZCcNRPXObaMBEfTSeLWDJGFAYIgQKH,..IAAAQAAAHACAdADAZAFBCAFARAGFOAHD..aCDEECAATDBAhAAAeCDFLEABhACA.DDHBGDFAhAFAAEEAKEFBUFCBNCIAPFEBMEIBSHGAFHGC.hAEA......hAFA...,1,3,-6,9
YDSfLUCVKgeJORIBZMPTadAFXbWcNGEQH,XAAA..bAAA....cADAEAEAHAGB.SCAAhAAALAFBCAHAKCEAeBCHhAAAREAAZDDAMCHBaDHDAAIBFDEHhABAGGBBQFGBfFFEgGEBhAHAIHHABECA...hABA...,1,-6,-11,5
XANYWeIQFMgbVKSPOUEaDTBHRZCLfcJGd,...NAAA.eAAA.QADAMAFA.bAFASBBA.hAAAOBDDECCBaCEETBFAhABAHCGBREEBZDABLGAAhABAfCHAcGFDdEFAABBA.IFDA.hAGAFEHD.KHBA...hAHA...,1,0,-12,12
CVJKAXeYdOISgPMQRcZEabGLTBDHfUFWN,eAAAdAAASADAMAEARBCA.ZABB..EAHFGAFALBFBDAIBHDCAhAEAFCHDCDBA.KDHBAAAAODEHhBDAIFFA..QFGAhCAAbFDDBFHDfHABWFDD...hCBA......hDAA...,2,-18,-9,9
YHGIabCJPMdWfSEeXBRgNDLTFQUcZOKVA,HAAAaAAA.CADB.MADAdAFA..SAHBEAGAeBBARBEBDBHB.LCAAhAAATDGA.QDEAhACAZDDFKBHBAFFA.GECAJFHB.hBAAfEHABGCA.FGED.OFBH.hBBAIHHA..hBFA...,1,-7,-11,4
RYWSMGCBgeOTbfNJEcAQHdILZXDVaPKUF,HAAAdAAAZABBDACA.aAEDKADA.RAFF...SAGAGCGABAHBeCCBhAAAOCEB..bCEAhAGAJDCBACIBLEBBhAHA.XEEAPFABFFEDMEIBCGGD.fHFBhBEA.cGCDhCAA...,1,-15,-25,10
GTBUWcINZVDeMbRKAJOFdXLfSYEgPCaHQ,FAAAdAAALADA.SAGHEADACAFAHAGBGCABBCCAUDEAhADAIDFAZECBDDIB..hAIAeBHHRFGBACEA.XEAChACA.fEEEgGEBaECD.TGFAhAEA.NEIAMIAA.hBAA...,2,-27,6,33
ZWBDegVQOTKdAEUHcXbIYJGfPaMRNFLCS,HAAAXAAA..bADBJADAGAFA.aAHFRAGFLCDBZCAA.hAAADCFBeDFDQDBBhAAATFBAACCAEDGBIDHAhACAfFFAMEEBCGAABGHAOFGD.dHBD..hBFA......hBHA...,1,12,-20,32
KFVIBWLaJGDXQgHYTRONcPCbEdUZMeSAf,FAAABAAALADAGACAQAEAHAGBRCCAODFC..PAHBhAAAEEAAZEEAeCAB.ADFAKDHBhACAIFCAaEAH.XGGAhAEATEDACFGA.bGFAMIAASGBA.hAFA......hAIA...,2,-13,1,14
MZYXWUJKBbSdcVQACeGgTfRLDEFPIaHNO,eAAAGAAA..TADARADAEAGEFCDH..aAFAHCFAMAIBZEAAXBFDhAAAUEFBBGGD.dHCBhAAAQCCCAADA.hACAfEEADFIB.IEHA.OFCBhABA.YFGFhCAA.KGEB,1,-2,-14,12
fRTebFNJWUBGIdcaLgSVQCYHAXPOZDMKE,OAAAZAAAMACAKADARAEA...eAFEFBHD...JBBFBCCDGBEBdCEDaEEAhABALDDB.SDFAhAIAQFFBHFFAhBAAAAHADEIB.EHEE........hCAA......hCBA...,1,-16,-29,13
VKRfWNMZIYGBadQXEUCgeJDSHPAFTbLcO,TAAALAAA.OADDRACF....fAEBMAFAZBEBGBGAhABAdAGAECABCCEAeCABSBHHhAAAHEFBABIBbGCCKDFAIECAhACAaCCH.QFFA..hAIA......hCEA...,2,-21,0,21
OAfDUEWYMLeRJZTdCHGKFIaQcVNgBbSPX,DAAAEAAA.MADARACAZAFB..dAHAHCDBGBBAFAHDQDAA.hBAA.cBEAVDGBBFADhAAAbDEA.XFCDhADAABBBfEDEUGGB.LFFA.eGBE.hAFACHBAIHHA.hCAA...,2,-10,1,11
eACBLJSWVdTcUaNRQFZMfIHODPgXKEbGY,LAAASAAAdAEAUADARAGBZCAA..MAGBHCFBDAHB..XEBChABAECCBGDGAAAIBBEEDhACAVEDBaDHD..FDBHOGAEhAGA.KGGA........hBEA......hCBA...,1,-12,-25,13
SLHIXbdKEfBYOPMVcJNQDGTAWeUCRFZga,eAAARAAAZADB...aADDHAFA.XCEDdAFAEAHBBCCDOCCHMCHBhAAAJCHB.DDBBGGDB.hABAAAAACDAASDEAhAIA.bEDCfFFB.PHACcFGDhBDA.NIDBWFBH..hBFA...,2,-27,-5,22
HbTPZWVFgBQIJRfeGSYXOLCKDNcdaMAUE,HAAATAAAZADB.FAFDQACCRBGFGDAA.XAEBLDCADAHBdEGDhAAAAAIBUCEBEFFB...hACAbDGD..WHAABEFDhAAAfHGFeDDDOGBCCAHB.NICB....hADA......hCAA...,1,-2,-3,1
ROMfHDNIcWGSABUZCPdaVJbegXKFTLEYQ,ZAAAdAAAaADAJADA...eAFHKAGCLCAB..EAHBRCCA.MBDBhACAHCFBDBEB..ICHAhABAGCGAACCBBEEDCEEAbGDAhAIAFEHD...TFCA.....hBAA......hBCA...,1,-23,-25,2
UFMQRKHeEPJOGBfdSCaALNDcgZVXYIbWT,LAAADAAAZABE.XADD..bAEDTAFAFAGA..RCCBHCGBhADAEBHFOCABGFEBdDDAhABAaECHAAHA...gGBGhBAAIEGAMCCB.eEHHBHHACFAAcFDDhACA....hAFA...,2,-19,-8,11
ONAHDMTbXYSKWeREZLQBdfVGcPgFJaCUI,HAAAMAAA.TAEA..bABASAGB.eBHHEAFAZBFEhAFALCAAdCCAGDFAhAIAgCEAaDHFCEDAOHBAhBAAAEAAXEAAKHEA.REFBBEHA.....hBHA......hCAA...,1,4,-11,15
MbCfZRUXQegODGcJLBAYKIdTFWaPSHEVN,KAAAdAAAFADA..aACAHAFB.EAHBMAFACBDD.RBCBUBFA..eCBFhACADBIBGECBLDDBhAIAACEA.TFFA.SDFAhBAAbFGD..fGEA.hBCA......hDAA...,2,-29,-20,9
VMFLBgcHZXSTbQJEKDARIYNCfeOaGdPWU,RAAA..IAAACADB.eACAGAEA.dAGBPAFCVCCBLCHBhAAABCAAHCCAZEFBTCGAhACAQGDAEECBAEEAfEFAhADAaHBC.MEIBFHGE.XGCAhAIA.SGGBhCAA...,1,-6,-14,8
aCBSfJTDXFGWNKcYMUORPLHgeEbZAVQId,QAAAaAAABADA.SACA.JAFATAFA.FBBHGBDBhAAAKBHBMCEBRDAAHDDBhADAECFBAAHAdDGA.DCIBXDAChADAcFGD.UFFA.ODCDgGEFhAIAeDHBbFAD....hAFA...,1,5,-20,25
aGNgMFULdDTSKEQcYZPfWRbBOVAXeJICH,eAAACAAAHACAGADA.MAFALAFB.dAHATBGAECAAQCDAhAAAZDBBfDFAhAAARDGBbEAA.ODHD.ABFAXFDChABAaFFBFGGHSHBAKGFA...hBDA......hBIA...,2,-8,2,10
OLIAFNJVBHZCRgUGfKXQDEebSWTadMYcP,FAAAVAAAHACB.RAEAGCEBKADCDAGA...EEAAeBDA..bEEATBGAhAAA..dAHAMDDAhBIA..cFADhAEALEEAAEEABGGDZGEA........hAFA......hBAA...,1,-11,-26,15
OQFRZXaGYJBTUVfCLbAIPWdgceNHKESDM,..IAAAdAAAeADAHACAEAGADBIB..MAEAQCBARBEAZCAAGDFAhACABCFAUEEACAHAACIB.hCBA.PEDDgEABhACAKFHBOHDEaCHHYFCB...JFHBhADA......hAEA...,1,-1,-17,16
SGEQTcPVKNFWaCBJfgIMUHeZRAYbdXODL,dAAADAAAGABBEADA.QAFCTAFA..VCBAFBHDCCCD.BCEDhAEAJBHB....fCFEhACAMDGBHFEBRECAAAHAYHAAhAHAODABLFGBSEEF.KHGANEIA.hADA......hBAA...,1,-12,-13,1
ZBKfVYLWUdNMOITFAaGDSbgCEPJHQReXc,GAAASAAACADA.EADAHAEB.RAGBeCDBZAFBKAHB...fBEAhAAALEGBdGAAMCCBhABATFEAACHBDDABbDAD.hAAA....gDDG.QEGAhADABGDD.VGEAhCAA...,1,-12,-15,3
PfSKRWGcZFJadVbTCEHeAIQLNUDBMYOgX,LAAADAAAMADA.OADD..XAFASAFARBBAGCEAhAIAZBFEaCAAdCGD..bDDAEEBAhBAAHEGBABBAQEGAhBEABDHBgFAAKGGD.WFFD....hABA......hACA...,2,-17,-11,6
TXZFJVLSfGcQeNIHKYROUagEBDACPdbWM,dAAAMAAAZABBFADDLAEAGAFA.eAHHHBBBRCEB.aAHFBDCA.AAFA.bDEDhAFA....TEGAhBAAXDGD.SEDFhBAAQGCAKFBBUGGBEGHBCHBD....hBBA......hBFA...,2,-15,-5,10
NaUPXLEgYORQKBCeFGWHAcDJZfdVIbSMT,DAAAZAAAdAEA..IADAMAGB..aAHBUAFALCAB.ECCBhABAOAHF.RBBBQDEAhBAACCHAeDFBGEBAhACAHDGDADABJEEFbECDSFBFPEHB.XGGAhBBA....hBFA...,2,-24,-3,21
fOXIJMbBcEgeZDHLGUTFVSQNdaCRKPWAY,OAAAXAAA..MAEABADA.EAFAeAHFHBFCGBBBFCDBQDAAhAAAaBEARDEA.KDFAACIBfEDEhBAAIFDAbFFAhABAZFGB.DFGB.........hADA......hAFA...,1,-13,-17,4
VNbGcFKMIJfSgBOXLPaZQReYTADCdEUWH,dAAAEAAAHACA..bABDGAFA.KAHBMADAIDDASAFAhAIAODFHLCEAhBAAZDGBREAAeFHHABIBCDHAVEBAFHAA.hAAAfEEB.XFGA.aGCEhBDA.YHFADIEA.hAEA...,2,-3,-1,2
bQIUNefJCKAVYEgMPZGBSTaXdWODLRHFc,EAAAMAAAGACABADA...aAEAdAFA.DAHBHAGBFBBB.QCEDhAAAUDCA.eCBBCCHAAAIB.gEFAhAIAZEEB.XFBAhBCAOEGD........cFBChBAAIGHA.NIBB.hBEA...,1,-3,-44,41
XaPHQegSWKEIDZLCNbGOMfYcBRdAFVUTJ,FAAATAAA..aACDHACB.eAEASAEAEAHFZCEBLDGBhAAACAHAGCDAMCFAfCAEhACABDFBAAEAUEAB.XGEChAEAQFFAWEDFDDIBNCIA.OHAA.hAFAYHEA..hAHA...,2,-34,23,57
NZCFSKALBWHGgcfDMVabXYQIRTedOEPJU,LAAAHAAAGADA..fAEAMAFAbBFB.QAGAhABARCAA.eCAAEBHFPDHDhAAAUDDAZCFFSDEHhACAACAABDHAgEAADFGBaHGE.XFGA.hADAIHDA..hACA...,2,-15,9,24
RJgeBQUFIPdSWcYTKAGaZOCMbDNEXHVLf,ZAAAMAAADACA..EADAHAEALAGBRCCA.eBBBQCGAFBEDdEEA.hAIASAGE.hBAA.cDGDTEEAABGBaDCDhBCAbGCC.XGEAJHFE.BHHA...hABA......hCAA...,2,-18,-9,9
LGdTURIBSaNKHPeOcXJEDACFQZWYMVgbf,QAAAZAAAMACA...VACA..bAEAGAFAdCCDRCEFBCHAhABAaAHFHDDB.eDGHXEFDhAGAEFAAADDBFFHD.YHBAhAAALEHB.TGCA.SHFGhAIA....hBIA...,1,9,-21,30
IbMERdKfcWUCSAXaLYBVOPQTJgHFZGeND,aAAALAAABADA.OADD..TAFAHAFAGCAAeAHHDBBBbCFAhABARCCAdDGDKDDD..fEFAhACAUFAAACCA.XEGDhAFAPEEB.QFCBFFHB.IHAAhAHAEGFFCDAD.SHCAhAIA..,2,-20,17,37
daUCIRNJTQFVZYEcDAWbPBKXegLfMGSOH,...bAAAKAAA.eACELAEAGAFAHCAAaAHF.CBHARCEA..TBCAhAAAQECAZDEFEDHBAAAABDHAhACA.fEFAhAFAMEEBdFAAIGHAFFHBcGAADIDA...hAGA......hAIA...,2,-9,-8,1
FZMSTeBGKfUJPYbQCANVRHEDgdaWXOILc,RAAAHAAAEADE.dADA.aAFAOAFALBFAZBDE.MCABeBHF.GDEAhAAAKCCDUDEAJEHB...bDGDhAAAACCBDEDB..XGBAhACAFGDDSGGDTGEABHHA...hABA......hCAA...,2,-15,3,18
fROGHLgDAXMZdSNECBQYPKbVTIceJaUFW,ZAAAdAAAEADAQAEA.KAGAbABD..TCAAeAFAUCEA.hABAFBHDRCFAHDDBLEHBhADAAACAMEABCEDDBFFAVFGBIGAAhAGAaECB.OGDCDGFBNIAB.....hAEA......hAIA...,1,-1,-8,7
RJLebIQOgHWSBAYXZDMfENTKCVGdcUaPF,ZAAAMAAAEADEKADAGAFA.dBHAaAFA.RBBBLCFAeCABQCCBhABAHECABBGDAAHADDFBTEGAhAIACEGAUFAB..FGEAIGGAhACA.OEEH...WFHHhAFA......hCBA...,1,-6,-21,15
NbXZFPCIBMSQfLVeWdDEJRHKOYAGTUcag,GAAATAAA.aADA....bACBZAFBCAEABAGAMAIBQCDAhAAA.LEGBhACAeAHHdCEAEDCBHDFBOFFBhBAAACCBgGAAFHBA.SEDD.hBCAfFHADEIB.hBDAKHEA..,1,-3,-10,7
VKdPCbeLgNEWXDSMYQcTUIaJZFBfROAGH,HAAAdAAACADALAFAEADEDAFA..MAIBQCBAUCAB..aBEEZCFAhACABCGARDDFAAGAGGEBhADAKDDAeEFA..gGCDhBAAXFDCSFHH..YFFChBCAIHBA...hCEA...,2,-14,-12,2
SXUMWbZgGTOENFfDeacJYPKARQLIdHBCV,RAAALAAAHADBCAFA.XADDUCGA..MCCBZAFAGCAA.ECCBhABAfDAAeCFFaCGDJEDBhACAKDDDAAAA..dFGASEFDhADAgGAATFAANDIADAGA...PFDDhAFA.BAHA.hCAAbGFA.OHAE,2,-4,3,7
BfGSNeEgQLUFHMJPCVKXWcbadDORTIZYA,GAAAeAAAEADALADAHAFA.MAHBCCCAKCEAXCDA..bCGDhAAAdDGDRECAZGEAAAABSDCDhACA.QFAChAEAFHAA.PEEB.cGFBaGGADIDAIHHAhAFA.fGCAhAIA,1,5,-18,23
fgAYMZUPTHOecaEJbVDCNKXdGWRQSLBFI,ZAAATAAAHAEA.eAHHEACE...VCAACAEBKAGAGCFARCCA.LDEDhABAFCFA..fDHAhAAAAACAMDIBOEABhAEAaEEADFFBdHFBQGAABECAgGAHUGGA.hAGA......hAIA...,1,16,-19,35
CWgLNJMeIUKBVXSbAEdQTPZFcaDfGOYRH,EAAAdAAAQADAZACB.FAFEaAEDGCABRAGBHCFBCBHA.LCBDhAAA.MDEBeCFFKEHBXDGAhACAAAIB.TFGAhADADFDBOFFB.gGAAIHDABGFDhAIASGHD..hAGA...,2,-12,-10,2
QFOPEJcKgNVWMfHBCTUALYRaGebDSXIdZ,RAAAeAAADADA...XADAZAEEQCCC.FBHDEAGA.KBHB.hAAAgCCAVDFBMEEBhABAHCFBBCFCTEAAhAAAAEIBLGAAGFDBSGHBdGADOEHF..hABA......hAEA...,2,-17,0,17
cMSQYbgPfDaWdBNOALTFXeHUVKCGIEZRJ,TAAAeAAAHADA.KAGCGACAEBHF.RAEAMAIBQCCC.bCFDhAAAfCAE.hABAaCEEdEECOCGDACFBLEHBhAFAXEAACGGC.ZEEF.SEHHhAAA.PHAADIDA.BHHAhACA..,1,10,-6,16
LCTZIGSQXabVgNFMEKdeDAUfWBJPOcYRH,UAAABAAAOACARADAHAGBLDAAZAFBGBCAQDFC.aDHDhADAbBGD...gEEBhAAAMEEBEFCBdGAAAAIBJFBBhBCA..cGGACBEASFHB.NICB..hAEA......hAGA...,1,-4,-15,11
YRAVJQIBcgGeOUEZLSCPXNWbKDTMaFdHf,QAAABAAAGACAeACAEAEAZAGBLAGB.CBEA.XCAChAAA..bDAATEAAhACAaCHDHEDBRCEBABIBJDHBIFHAhAAAOEEHSFFB.NIABDDAAdGCAfGFAhAEA..hBCA...,1,4,-9,13
FPWJBDMcYNCGUaHXgSEVZKdQRfLbAIOeT,eAAATAAAFADD..JACAMAFA....NAGA.GBEAHCCASAHBhAAAEBGAZDGBdGBARGEEbCGDhAFAAAAAOCCB..hBGABECDDEEB.CEEAaGGA.......hCAA......hCBA...,1,-13,-18,5
VOPKfRIZBcSDYTWaQbCFgeEHULJGNdXMA,OAAAKAAARACFZAEBBADA.DAFA..TAGAQBEAFCAB.EAHFHCFBhAAA.LDHBhACAGCCAdDHAAECAVEABIEFAhBAASEEDaBBHbGCAeHFAUGGA..NIAB..hCAA......hCCA...,2,-14,4,18
YQAXLUIgSbZfCHVEWJdKNFDeMcBOGTRaP,LAAAUAAA.SADHZADAHBGBECDAdAFAFAHBeDCBBCAAGEAAhAEARDDA.aAHFQDGChABA.ACCB.XEEAhAFAbFBB.CEHA.JFFFDGHBMFIB.....hAGA......hBAA...,2,-11,-9,2
COVBQAZGTebgcIPYSfaKHdXFNEDJRULMW,GAAAeAAA...bADAgADA..IAHASAFHhAAAaCDAHCGBdAHAFCCHEDDBhAAARDFAMEABODAHQEDDhABAACIBZFEBTGGAPFHBKGDD.DGGB.LHBAhAEA....hBHA...,1,8,-4,12
FCOKJYXfZIEURNAQdBcPLTSHVaDgbGeMW,dAAABAAALADAHACAaAEADAHBGAGA.eCABMAIB.CCBAKCEAXCCAhAAAZDDA.UEGBAAEA.hACAQFCA.hBAA.TFGASFFDbECCOGCCfHGFhACA.....hBCA...,2,-33,3,36
fbSWMLCQeFRZPaNVGTIcKHgOABXJYDEdU,XAAADAAAEACA.dADAUAFA..SAFAMAIBLBBAeAHHRCDAhAAAZDDAaDBBGEGA.hABATFBAKDHBHEFBADFABHBDhBAAfFAECHDA.QGCA.hBFA......hBHA...,1,2,-20,22
gOZUcDBAPRdINQGHEWbFaefSXMJVTCKYL,RAAAdAAAQADCHADAEAGEFCBD..eAFESCFAMBGB.JDDBTDDAhAAA.KCCDLEGBhACAZCGBDDIBACFBIFAAhADANIAB.bFEDaFFCXGCCCGHA....hAFA......hAIA...,1,-7,-13,6
UZeGfQIRFVLEDbAOTCJWBScgHYNXKPdaM,TAAACAAABACA...SACBHADB..XAFAdAEAaAGAZBFBhAAAeBHHGDDAQCAAhAAARDGFLEBBECFFAAFAODDBhACAcGGC..NICB.MEGBfCCEFEHDDFFB.hAIA......hCAA...,1,8,-16,24
XREJMCGUcYNOIDWbZBTPFVSfAdQgHLKae,dAAAHAAAaADARADFEAFE..MAGBGCEA.UCAB..NAHADAIBZCGBTGCAhAAAFBDB.fFHAhACAACCBLDEBeDDDhADACEHAOFCBIHAAbEFD.......hACA......hBAA...,2,-33,13,46
KUVCMTXBFSIDHgfcRZAGOdNJWbEYQaLPe,dAAAJAAA.EADA..aADAeAFA.KBHBCAGA...MCCABBDA.SAHHhAGAHCEC..fDAAhACARCDAACCBGDGAODDBhADA.bEFALEFDPFEBTGAAhAGAFGCADGIB.gGGBhBAANIDB...,1,-8,-27,19
acfDTJZGMKReESXNVBAQYLbWgIUdCHOPF,LAAA..bAAAIAEAdAEAHAGBFAGAaCAADBGBZDDA.GEBAhAAARCAAECEB.SDHHhABA.XFDBhACABCHAACAAQEEBgGGACGADOEGD.fFCAhABA.MEIBhACA.eHCA,2,-15,-3,12
RKfIGXQNBMdODJYeTEPgCLSVcWHFaZUbA,RAAAKAAAGADAQACCMAFA.dAEA..DBFAeAGBEBHF.CAHB.LDAAhAAASCEA.VEEAhAAAHCFB.ZFDAACIBIGHAhCAABEHA...ODDB.JHEA..hCBA......hDAA...,1,-15,-19,4
aUdJQgBcKSNZDWOYeMLRTEPFICVAXfbHG,XAAAHAAAaACAdAFA..QADABAHASCCAZAFBOAHDhAAAeCFARDAAEDDEFDHDCEEAADAAGDGAhABAUFBA.JFBBKFGDDFFBhADA.MIEA.........hAAA......hAHA...,1,5,-24,29
ZKGRAJIQBDWMdgaSYEHefTOFVLbUcNPXC,QAAADAAAdADA.aACEEAFA.HBBB.eAHFTAFAFCFBLEDAhAFAbCDB.UGGAPBHDhAAACDHA.GDAAABBBBHFChBAAMDDB.SEGB.OFEDhADA.cGGC.NIAB.hAFA...,1,-8,-19,11
bTWYceIHEAdLUGXZVKNaBOQMJDCgRSPFf,dAAAGAAAZABBKADAaADABAGA..MAFACBHARCDA.FBFD....bDBDhAAATDCA...hACA.cDFDHCGBABHALFEAhAGAXFEAOFHDDFIB.....hBAA......hCDA...,2,-33,-14,19
TGcMQUSYBKNFRADZafVXCbeHdLgJOPWIE,aAAAXAAA..eACHHADAdAEALAGBOAGB.IDAAhAAAEBHFGDDAMAIBQEBAhAHASCDAKDHBREEAADCBZFGFhAIACEHBbFAAgGEH......hBAA......hBBA...,2,-3,-3,0
NMXFbVUdLIQJYEeBGfDPgOHACaKRSTZcW,aAAARAAAZADB......NADA.MAGBFAEAUCEAdAHALCCD.hAHAQDEDEAHFeBBBGDGAhBAADDABODHBHGDAhBEAAAAASFBD...cFFChADA.WFHH...hCAA...,2,-20,-16,4
GMfYIeEJTQNWObKARLScUaVFgBDZXCHPd,RAAALAAAUADA.aADDFAFEBAFAZCCA..HCGBGAGA.MCAB.hAAA.fEEEhABAeCCBECEFTEFAQGCAhAIAOEHDABIBSFHHVFAAXGDAdGGC..hABA......hACA...,2,-9,-6,3
VbMcZJXEaQKLUIBRTHSePNdAgfCOFYGDW,CAAAFAAAGACADADA....VAFAMAEAZBCBEAHF.KBECLCFAhAIA.BEDAHCABeEGBhBAAdCGDAACB.ODFB.hCAAbEDDXFEDaGFDIHHA....hAAA......hCAA...,1,-16,-32,16
GFAaJdPBUDHgOLKWYESQcbTVICMfeXZRN,dAAABAAAHADALACAKAGCEBHFQAGA..bABDTCCAhAAACCEA.eCEERDEAGFABhADAAADAaDFCUFFAODHDSEEDhAGAIGFAfHGFNDIA...hBIA......hCAA...,1,-2,-17,15
cefMdBTgWOYIVbPGFUJEZHNLXSCaQKRAD,eAAAdAAABADA..TADAOAED..IAGAVAGB.GCCAhAAAFCBDUDEBEBHFHCFBhABALEHBCEHAaFAA.RFDFACCBDDABhACAMIAA..gFFA.bDCD.hAFAZGAASGGAhAIA...,1,-2,-16,14
FBKXDWZLHOQcVGNMARdEgPSbUYeCaIfTJ,EAAASAAAUADA.eACHCAFA...aAEATBGABAHA..DBEBZCBAhAAAHCEBQDFChAHAGDGAAAAARFGB.dCGB.bFBAfFEEhAIAKHAA........hBCA......hBDA...,2,-25,-9,16
QdEALeGOcTRJDMCIYfaBUPFKSXZNWgbVH,eAAAGAAAOADCRADAMAHB..CAGB...ICFAaAHDBCCAFCDHSCEAhAAAZDFE..hABAgEAAHDFCEECAACEAhAFATFGADFFBUGGAXGAA....hAAA......hACA...,1,-16,-21,5
SaeDKgUFIARTCBJGfYNXQdWLPZOMbHVEc,RAAATAAABADBGAEA..fACB.XAEBhAAAdAGBLCCBZAGBMBIBHBGBhAAAECCAaEDDeDEBKEHBFFFBhABAABGBCEGAYFDBNICB.QGGA.hCAA......hCIA...,2,-17,6,23
WXYRAZceLPTGaUDEMNgSJQOBbCFIdHfVK,eAAATAAAGADA.aAFAEACE.MAEASAHHQBEABBFBhAAAbBGDFCCH.HDFAKCCAXEEChAAAADBBZFDALFHBhABADAIBgFGACHDA.dGCA.WHFA.hBDA......hCAA...,2,-4,6,10
gUEOAJRQGfVBYXbTWKDSLNHdacFZeCMIP,RAAAGAAABADB...bADATAFA.DAIBLAHB.HCDAhAAAaCCAZCFAeDAD.MDCBhACAIEEAgEFAhADAEEGBAAAA.fFHA.XFCDSFAAhAFANIEB.dGGDCHBD.OHAAhAHA..,2,-23,0,23
afEUQYdISBMJPNTXVDHRFZObWgGeCcLAK,aAAAEAAAUADA..dADABAFAMAFA.JBBFTBGA..DBFAHCBAhAAARCFAZDDFODEC.hBAAbEFA..gFCDhBDAeGDACAHBABCAKGHDQFFC.SHFAhBIA.NEIA...hCAA...,2,-21,-11,10
RebNMVLJZCQcAHfOgUYXaWIGTFdEKDPSB,HAAAOAAAUADA.aAFEGADA.dAFBEBHFDAIBBCADRBFF.eCCBhAAAMBBBLEEAZDBBQEFBhBAAACGB.fFHAhBDAXFGATGAAKHDA.bGEC...hCAA......hCCA...,1,-5,-17,12
INeOJUTHdAMfQWgECDGPVYacZbXLKRBFS,MAAAQAAA.EACAGACB.PAHBaAEDZAFBLCCAhAFARCGFSCDDeCFHODHDhAGATEBAHFEAABBB.fGHAhAAACFGDDEEB.YHBA...hAIA......hBAA...,2,-24,5,29
NQDbfGZTPMcFUBXCIgSHVROAeKYJadLEW,eAAAKAAA..aACAEADA.QAFADAFAGBCAZCCAMAIBFCHDXDFDhAAACBEA..SBFHhAAAHECBOFHDABHBdEEAhCAALHBA..bDGD.....hABA......hAIA...,1,-5,-30,25
bTBcICJQDZfUXeEMRWKOHSLGPaFVgdAYN,...bAAATAAA.BACBCAEAQAGAZADBXAFAECAARCDAOBHDhAAAHDFCGEAA.hAGAaECCFCFBdFFAACCAcEEChAIADAAAeGCAKEGASHGALGEA....hAEA......hAGA...,2,-17,10,27
VCRUYSOZfTAKebEQXcNBMJLIDaWgPGdFH,eAAAEAAA.QADA..XACABAFAMAHBLAFAhAAAaCCB.gCCBhADAdDDAHCFBRFDASCFAhAGAfFHAACFAbDFANAIA.DFFAWHFAFGGACHAA....hAHA......hCAA...,1,-1,-19,18
BOgVTFAMQKHWLdEZRJbUYeNXPIDGfcCSa,MAAAHAAAdADARACA.UAFAeAFE..XCAADBBBGBEBCAHA.aCCCOCHDhAAA..TDEAhAIAADDAQDEALDHBhBAAEFBAbGFC..PFGDfEGABGEA..hCAA......hDAA...,2,-13,-11,2
STAKDcFMeIQZVbWNJfBXGdUgaHRYOEPCL,DAAAMAAAeABAZABE....VAFA..bAEAJCCABCCA.dCEAaCGEhAFAHDFB.RFAAECHFLEEAhAIAAAFA.FFCBIGHAhAIAQGEA.fGHAGGCB..hBAA......hCAA...,1,-10,-24,14
bOZAFLVRUNQSTJXBPIKGeDdMCYEcfaWgH,LAAARAAAQADCTAEABAFB..KAGCeAGHdCAA.MAIBEBHFaCCAhABAHCEB.ZEGBACGBFDDHNCCA.hAAA..XDGAhACA.GFDBCDDCfHDBgEAA.OHFChAEA....hDAA...,1,-6,-9,3
eNRbAIPDELdZgUfGJWTFSKaYOVMQCcBHX,DAAAEAAAZACBUADAGAEA..TAFAKAGAaCBB..OAHD.hAAAMBBBQCGAhAGABCCDHDEAeDEDRFGBADGALFHBhAIAdHABJEDF.SEBACGFD.XGEAhBCA.....hAHA...,2,-21,3,24
CSONVYbeFJQKBacULEfHgAPTdGWMRZDIX,dAAAGAAARADAZABBDADA.CAFA.OAGD..VBGBeCEF..QCDAhAAAaCHDLEAAHDBBhACAAAIB.TEFAMDGBSFEHhAEAbFDD.KGAABAHBEGHB.fFHAhBAA....hBCA...,1,-10,-15,5
gaHZPYCbEAQDVXeBNRTLWIMfGScFJUdOK,QAAAXAAABADARACALAFB.MAHBGAEA.FAGAdCEChAAAKCDDHDAAZCGBCDAAAAIBeCHHhADATGBAfEFAhCAA.SFHHcEECOEHDaGGB.bGEChAAA......hABA...,1,9,-23,32
ZAMGHRafXDQIWCBPdTFUVcgYNKOELSeJb,HAAARAAA.aACADADAQAFACAFABAHA.dBHAFBDDUCCA...VDFBhAAA..gCEHhAAAKFAAEFCEeEHHZCGBACCBMIAAhAFAGGEB.IHAA....hABA.WDHH...hAIA...,1,-1,-36,35
fXNMWOJITZBSdEcaLRDUCAVegFGYQbHPK,eAAAGAAAQADAHADAKAGC..XBGAMAGBOAHBJCDFZDFAdCCAhAAAEFAAaCHD.REDACFBAAAABFFCDhACA....bFGDfFFAhADANIAB.IGHATGEA.SGDHhAFA...hABA...,2,-8,1,9
MEfSNAOBPIYRCLUcDZFJHgTeQaWbXdVKG,BAAA..IAAARACALAFBDACAZACEHCAAeAFHaAHB...bAGDhAIAdCEC.GDGA.hBIAEFFBSCDBhCAAAACA.ODDHCGED.FEGA.TFEA..hCBA......hCIA...,1,-21,-24,3
OWFbPHLdIMeGQYSAKfTaDJEUZVNRXcBgC,TAAAaAAA..EADAZACBRAFA.BAEA.OAFDFBBHHCEALAHBhAAAdCHAeDABGDEAQDCDhADAABHBDCABUECAXEGChAGACEHA.WFFDIGGAMIAAKGHB...hACA......hCCA...,2,-19,10,29
VdMGScWKDJITEZBNCRFYbQUgOXAfeLaPH,eAAAaAAAHACBdAEAGAGA..SAEAKBCBDDEA.TBGAhAEAEEBAZEEACAHBRCEBFGAAQEGAhAFAOFHD.ABBBLGDAhBAAMIAA..cGEAIHHA...hAAA......hABA...,2,-22,0,22
GJNbQBULCWXFSPfRaVTIcZHOKdAEeYMgD,EAAAeAAA.MAEAGACA.JAEAQBCALAHBCCBDFAHD.fBEFhAAARCEB.aCFDTEBAhAAAZDGBHFDBdEHAAEEBDFIBhABAbGCABFFC..XGGC...hCAA......hCBA...,1,-5,-9,4
AfKQENbHVaDYZFBWGICdTcRXgSMLPJUeO,QAAAEAAAHACAaAEAZACB.BAEAGAGAdAGARCEBSCCALDGBUECAhAAAAAIBKCFD..bEECDAIBhBCAFFHDCGBD...TGEAhAAAXGFC.MDIB......hBGA......hCAA...,2,-16,0,16
KOWLPFYECXUZVIdMRGQgcHDTbNSfJAeaB,eAAAaAAABADAOADCLAFAFAGA..ECCACBBDZCDA..dCFARDAAGDGAhADAQEDCHECCbCGDhAAASCGE.hABAAAGA.KFAA..........hAFA......hCAA...,2,-23,-16,7
HCFEWJNOZSdbGYQTaXcIPfeVDKBLAgRUM,RAAAHAAAEADE.JADAZAFBdAGAGCCA..TCCAaAHD...XCEDhAAAIDHA.eEFBhAAAKCADAAIBMFABFCHDOECBhACAbFGD.QFFA.fGDAhCCABGEA.....hABA...,2,-15,-7,8
gXTbYEVNOSAQGWCZaMRIKLfeUcHJdBPFD,GAAAZAAARAEALAHBeADAHAGBdCAABCCDDCDATDDA..ECEBODAHhAAAAADA.QDFChACAaCGBKEED.fEHAhADAUFAA.PGBAXFGA...YHEAhABASGGA.hACAMIAA.,1,-1,-19,18
UVRCGYHdbJFXQPMZWcOISKABfTLNgaDeE,TAAALAAA.aADDEACE..RAFAGCAAHAEBbAGBFCFH..QCCChAAAZCGBODDBKDFAAAFABFFDhABAfEAADDIB.hACAeDHHCGHA.dFFA.XGBAMIAA.IHHAhAEASHGGNEEA..hAIA...,1,20,-17,37
cJVGRTQBNPALOZfXKEHUaDIdCWSegMYFb,ZAAAKAAAHACBaACA.dAEBCAFA.eAGH..MAHBFCAB..JCEBRCCAQDFDhABABCHA.AAIBLFAAhAFAXEGAEFBADCIBSEEDhCAA.bGFAGGEB.NIAB.hAAA......hACA...,1,-14,-19,5
LJNfcRKQOVUETIPMWGaFZegDCbAXSYBHd,SAAAHAAAdADALAFA.JCAFfADARCDA.QAFAhAAAOCCHECGETCDAhABAMEFAGGABZDAAeBHHhADACFFAAAGABEFAKFHBIHFAaEHDDFAAbGDA.YHBAhAFA....hAIA...,2,-14,-1,13
cVfTeaSWILMBHXGZbUJEPNdYAKgOQDCFR,OAAAQAAAFADD.RACA....VAGBeAFA.aBBHSCDAhAAALCFAHDDAZDAAbEEAEEGAhAFAdFAAACGADFFB.fGAAhAGATGDAMDIBXGGA....hBAA......hBIA...,2,-17,0,17
EVdbeGOKYDTIaSALZFXPUNRcWgQfCHJMB,ZAAAXAAAUAEARAGB......gADAQCAAHAFBhAAAMDDAEAHBdEEAeDAAGGEBhABAKDEATEGA.hACAaEDCAAIBFDHDPHDAcEBDCHHA.....hABA......hADA...,2,-15,-8,7
JGMCONKdfZFULDAHBbeWTSVRYPaEIXQgc,HAAAeAAA.TAEARADA..aAGAEAGE.QCABJBGBGCCAMCEBhAAAOCHDdCGAZDEBLEABhAAAACIBbEAA.SEFDhABA.PFHBXGFA.CEHANIAB...hAEA......hCAA...,1,16,-13,29
PaYbUORfLIKWeSVcXNdgBMZACTGDJFEHQ,GAAAFAAAHACBaADAUAFARAFF.LBHBKBHB.eDEASCDBhAAA.XDBDdEAAMEDBhAEAAAHADDHBEFFA..PFHDhAIAbDEDOEHD..WEBH....hBAA......hBEA...,2,-15,-13,2
CGaOfVAEYNKUMXLeZHdPQTBJIDFcRSbWg,EAAAKAAAMACALADAHAECdAHA..QBCDTCBABCFADAIBRCEFSDEDhAAA..hAEAbCGDCDGAaDHDfGEAhAAAAFAAUGFAeECFPHAA.FGGAWHBAODDH.hAFA......hBCA...,2,-15,4,19
HgXGWUdRMLVAfBIcSTNbaDFOPJZYKQeCE,BAAASAAA..bACAaACD..OAGBZADBQAFAhAAA.ECFBHCAAGDGAhABAdAHARDCAMAIBAACAfDGAhAAATFEAFHBAPEAB.KEHBCEEC.XFDAhAEA.....hBHA...,1,-8,-9,1
fASPaUJHIKgFEOWVQXcbBeDLCMRNGZdYT,aAAAHAAA.KADCEADAOAFC..QAFAXCAA.bBBCeCFAhAAALBHBRDCFZEFAdGCDTCEAhADAAAHA.SDDDhAIAJHEE.FEGH.WFFD.BGHA.CHDA..hACA......hCAA...,1,3,-14,17
VIUdZeSCBEgPWNbOLKFRQJfcaAGHXTDMY,HAAATAAAMACA..VADAdAGAeBDA.BCCDEAGE..gCAAhAAAPCHD.bCEALDEBhAAA.REBAQGFAhAIAfDCAAACADDGBIEEA.ZFGBhAIACHHBNIBBFGCA.aGED..hCAA...,1,3,-10,13
bLKcBIHDAQONCeREJdVXSGUMTZgYafWFP,QAAACAAARACA.EACAdAFA.SAHBGAEAMAHBZCAA.aCDHFCEHhAAALEBBBCGAHEFAhACAAAGBeDFH.XEGDhAAA...........hADA......hBHA...,1,-3,-37,34
PEGaXMUQBFIfKebcTLVODYZJHAgRSdWNC,RAAAdAAACADB.EADAGAEA..aAFDMAHBBAHAFCCBKCBA...eCEBhACATEDALCHB.hAAADDABZFGBHEFBAAGBSCHHhABAPFBA.QGDBfGDA..hADA......hAHA...,1,-17,-22,5
aPbNgXCTWSMUYKIFeVfQADLHEGcJZOdRB,HAAAEAAAGACAZADBRAFABCAD..bAEAXCEDCCBD..TCEAhAAAMCCBKCGAeBHHQEGAhAAAAAEALFFAOFFBhACAaGAAgGCHSGAAIHFA.hADA......hAGA...,2,-16,4,20
gFJfXBRQAGWKCLIEHceaZOTMVYDPdNbSU,GAAACAAALACAHADA.eAFEZAFBMAIBDCDBdCFA.SCHBhAAAFCCAJDAA.BEDAABHB.KEGAEDGFhAAAaDAH.OFDE.hADA.TFCAPHDAbEEDfHGFQGGChAEA......hCAA...,1,2,-22,24
OJWfcPFENRAMYdZabVHDUQXKTIGCgLSeB,dAAAaAAAHACBQADAKAEAGAGALAGBeBBDOCAE.JDEBfCFEhAEAFDHD.REDAAAIBhAGAZFBBDDIBTGEACFGABGHAhBAA..cGGA.......hCAA......hDAA...,2,-12,-11,1
gdcWPBEOVZHXbKeGNTYCUIfAaDFMRJLQS,aAAAMAAALADA..QADAdAHA.PAFCEBBBZCEAHBBBhAIAbDCDGEEBTCFACCHBhBAAIEAAABBBREDA.SGHBhAEAgFGABHBAOHEC...hAFA......hBAA...,2,-12,1,13
NTfVUHWMbBLFGJRPDQcOedYZXaSCKAIgE,EAAATAAAUADA.HAFAMACALBCDGAEBRCCAQCGA.hAAAeDDEZCGBaDBHKEEDAAHAgEEDhAHAVFGB.bFCDhAIA.FFHDDGFB..cGEC....hBDA......hCAA...,2,-4,-1,3
MRFJWSHOeDLVPGgNbKacAETIZCdUBQXfY,EAAAZAAAdAEABACAQAGA..fAEARCAAFCFD.SAFHhAAAHDGBeDEDLAHBhAEAGEBAgGGAhABAbCCCaDEEABHBCEGA..XFFC.MEIB.hACA......hADA...,2,-16,-2,14
GQLebKEgWXRUTfYPAFHdBDIVJaOCMScNZ,HAAAdAAADADAVAEA..aAEEMAIB.SCAAZAGBGCABeCEBhAAAEDEF...XCGDhACARECBTFFAfDCAhADA.AEAABFGAOCHDCGDAcGFCLHFAKHAAhAEA......hAHA...,1,-5,-15,10
OQGgKYNeZVWURFAHBDMafdTEbICXSPLcJ,HAAAMAAAdAEAEADECAFB..SAGALAHBOCABGBBAKCGAeBGFhAAAZDEAUCCAAAGABFDAaDFH.hACA..TFFAXEGDhCFA..cGCC......hBAA......hBBA...,1,-5,-27,22
EXIaUORVgTCBAYbJPMKcNdGDSWFfHZLQe,JAAAMAAA.KADAdADAGAFADAFA..FAHDHBBA.ZDDBeBEHEAHBaDHBhAFARCFF....TFGAhBAAADDBbFED....cGGAhAIASCCD.LGBA..hBGA......hCAA...,2,-37,-3,34
ZEQSCaTWRObAPGJIVDcHNYXgeKdUfLFBM,GAAAVAAA.HADA.XAGBeADEdAGALCDAMAIBZCDAECHFQEBAhAAAaDAHREEA.ABEBJDHFhCAADEIBNIBB..KEEAFFCBhAAACGGA.TGGA........hACA......hADA...,1,6,-17,23
XLgRBcMVYGbPUNaQZEKHCeWAJTdIODSFf,dAAADAAAFACDLADABAEA.MAHBGAFA..UCCAQCDDhAEAECFBHEAAeAHBAAEA.TEGAhAIASCHH.XEFChACAgGGARGCAcGGAYBBF.PEEBhBAA.aHDC..hCAA...,1,-5,-21,16
KSQPFUBfRCYcXdZIOJDHWETgeGaVMNLAb,SAAAQAAAFACEBADARAEF...CAFA.XAGBZAGBOCCAHCFBhAAAEDAAeCDB.aBHDMBIBhAAAAEIBKFFDUDDB.fEGAhABAdGHA.DFAA.TGCA.gGEBhADA..hAFA...,2,-26,-7,19
fOESJDRUgBWHXdNFTGPIQLcAYabZeKVCM,aAAAeAAA.CADA.MADA..EAFADAHBRBFABCCAHBBCdBEA.FCGHGDEAhAAAQEECAAIBZDGBKECBhABAODHD.UGBAXFAChAFATGGA..IHHA...hAIA......hBAA...,1,-15,-20,5
WeHXOMdfVDIJgQNGYBLKCcFRZEUAabSPT,aAAASAAA..TADAHACBMAEAdAFADAHBJAHB..QCCChADAGBEALEBAhAAACCHARDFBEEEB.ABGBbEGB.WFGDhABAeEHH.fFDE....hAIA......hBAA...,2,-22,-6,16
bJCAUHIMNEQBGFXWKRfDeLOdZagVYPTSc,HAAAMAAA.EADEGACBFAFAKBHBRAGFDBBB.LCCAZCAAaCCA...VDFBhAFATCFA.SEEBhAAAbGAA.AEHAIFCAhACABFHAWEEDeFHB......hAIA......hCFA...,1,-14,-15,1
BLTUdWaecEVSGRIfbKHJYMXNCFgAQDPOZ,QAAAOAAAZADBLAGBdADAeAFAEBHFGCEA.RDBB...bCDAhAAAHEGBMDBBCBBDAAIBBDHAhAFATGCAaEEB..SFCBhAGA.KFFA.YFHBNIEBDCIBWFBDhBAAIHFA...hBDA...,1,2,-13,15
MHFOeZARGdSaVcWJXCIEDbfBPUYNKLQTg,RAAAdAAA.aADAVAEA..JAGBCAHB...EBDBDCCA.BCGAUDDBKDAALDHBhACA.QFCBhAGAMCIBHDDAeCBFhAIAAAAAGEGASFGDXFDAfGEAhBAA......hBCA...,2,-27,-19,8
BPGXMZJWNVHLEgFTSaCOAIKUeYdDfQbcR,KAAAeAAAdACAQADARAEA.GAGAZCDEJBHBVCCB.HEFAEEAA.hAAATFBA.aFDDAAEAUEEAhAHADGAB..fGHAhAAABEHAMIAANIBB.FGHBCAFA......hAIA......hCAA...,2,-31,17,48
eGRfOTaDWbFBQNMVYHLCUcEgPIAdSKZJX,dAAAZAAAeACERADA.OAFAaAGA..DBHBFBFDBCBA..MBIBHCEBhACALDDBCDAD.EECFhABAIEHAACCBKEHDGGEBhCAATGCA..WHCGbGFA....QDCAhADA...hCBA...,2,-21,-17,4
NJYXFOUBLCgKaEHcPeAdDTGWIbZSfQVRM,dAAAGAAA..bABDZADA.QCDARADA.MAEAJAHBFCEDBAHAhAAALEAAKCGAHEFAeCGDhADAADCBTFDA.SGHBhACAfFFAYHEGOEHDCGAA.aHAEhAEA......hAGA...,2,-20,0,20
ePJWOaIcVULfDHGgERSFQdXABTKYZbMCN,TAAAZAAAMACA..eACEJAFB...aAFA..IAHAUBGBLCCAhAAAHCDBECGARDFAQECAhAIAACCBKDHB.bFFAhBDACEBAPEGBOHFC........hABA......hBEA...,1,4,-31,35
JTbUIfEQDBLeKGZVMPAFWYNHCORSadXcg,FAAA..NAAAHAFARACFdAEA...XBBAJAGB.UCFBECHFBDEAhAGAeCDHZDAB.MCIBAAIBCEDD.hBAAaEFD....TFFAhCAAbEBDIGHA.DIAALFHBhCBAKHFA......hDAA...,2,-38,7,45
HGCRfbeZIJYNUBdAMKLFgQcaVXWEDOTSP,MAAALAAAFADD.QAEA.aAGEXAFA.EBBBTCAAhABAHCEAREEAeCCEZFAAIGGAhAFAYCGBBDDDhACAAAIBKDDD.gEAA.cFEADCIBSHEGhAGACFHAfGDAhAEA.NIEBdHABWFHH,2,-11,11,22
WIVSMAcfJTGgECeKbYPRBLHaDdUZNXFQO,JAAAGAAA.EADAeADEKAFA.....bAGBRCDAHCGB.dECAZCCAhBAAFEFHQDGBhBEAODAHIGHAMECBABIBTFFAhCAACAHB.BEEDaGCEDICAXGCD.SFHHhCBA..hCDA...,2,-20,-7,13
NGITbWPfYVXMOQaKHRcCFJSegdZLUAEBD,EAAADAAAGABB..bACA..fAFBXAGA.MAIBaCCAHCFAhAAARCCAFCFA.eDAAZEAAAEEAhAEABEEATEFAPEGDhADAOEHDQGAACHAASHEA...hAEA......hAGA...,2,-6,-5,1
EIQfLNYJRaeOTZMdgcVPSUbKFBAWCGHXD,GAAAHAAAEADEQADALAFB.JAFERCAAeAHBZCDAdCHA..gDCAhAAAVEEB.SCGHhACAKGCAAAABCGHA.DEFBNDAA.hACAaEGE.MIAA.cFCD.UGGABHFAhADA......hBCA...,2,-14,17,31
BXREdTIWbgHLAPCMcfDVJQYFUOaGKZSNe,MAAADAAAQACAFADD.UAFAGAFAZCCA.eAHBRDFF.EBBBdBHATDDAhAFA..bEBAHDGBhAIAABBB.CFBA..fFDEhBAAJEHB.aFFHNIAB.BHHA....hBCA......hBFA...,1,-7,-22,15
gcFDaSULVPKCOQfATIGBReEZHWYNXMbdJ,GAAARAAAEADE.HADA...NAHA.bAFBdCDDJAHBFDFD.DAIBUCCALFAAhAAAKDFD..QEGAhAAAADABTFGAeEEDhACAZFCAXGGCMIDA........hABA......hCAA...,1,0,-17,17
MEYHBUPRgCOJeZQFKTLDWGSXNAbIcdVaf,..IAAAdAAAaADAEAGAHACA.BAFBRBDB.OAGDeBHFZCFF.QCBDhACATCAALCEBhACAGGABXFFChAGAAAIBbDFD.fGHAMCIBPEAB.CDDAKGHBhAEADDIB.SHEAhCAA...,2,-12,7,19
dHMVXRYBgWIOLGbDfJcZSFeAUTPaCENQK,TAAAaAAA..EADAQACCHAFA.MAEARCCABBBD.gCGAhADAOAHDbBEDDEEBfCDAhAAAZFCFeEHFAAHACBGCdDGAhCAAXFEDIGGA......hDAA......hDBA...,2,-15,-6,9
SAPEMcNKJVCLIHeUYdWQgGXafbZBFORTD,EAAAMAAAKACA..CADAHAEBeAEE.dAGB.QBBCGBDBaAHFZCGBOCCBhAAARDDB.DDEBADGB..hCAAPFHDJDFBLDHBhCBAIHBA..YHEA....hDAA......hDBA...,2,-16,-15,1
SRZUeJcIMgNKVWPCbHTYGfdFXLQEBODaA,RAAAeAAA..IAEAMAEAKAHB..VAGBCBCAHBDBGCCAdCFALDHBhAAAECFBBDAAaDHDABFAZFFBhABA.JHCE..gFEAhAAA.PGAC...YHEGhABA....hADA...,2,-20,-19,1
JcPBLfCMITXYNbEUSDaRAWdKeGFgVQHZO,dAAAeAAAGADAFADD.QAFAHAFAZCCAOCGDJCBB.BEEDLBHBhACAMCIB.TEFAhADAXFAA..bFAAEFGBhAAADFEBAAHAKGDA..cFGD....hAFA......hAIA...,2,-15,-14,1
ZHKOWCfPJTVaDQbBELMdYgUXcRNAGFeSI,eAAAZAAAHAEAOADCCAHB..JCAAaAFA.QCCAECEB.dCFAUCGAhABARDGFAAAA.GEAA.hAIASEEDKBHBfFDAhCAATGFADFFBBGDDMFIB..YFFChACA.....hCBA...,2,-17,-6,11
CQFEHNdRePaYWJSAKcbgVBMOTLIXfZUDG,KAAA..bAAABACBMAEALAEA..fAHAZBFEGCCAhAAAQBEAHEFARFABeFEBhAFAaCAAJCHBACCB.gDDBhAAA.TEBAIDHADEGBEFHFdGHA.hAGAPGCC...hAIA...,2,-13,2,15
XIgVbSfJHCTDNcdWQALaFMEROKBZUYGeP,aAAAEAAARACABADA.ZAEBGAFA.eAHBXAGA..gCCAhAAASBBDHDABhADATCGADDFBdEHA.AEEBMFGBhAFAKCCCPDABIHDAbEEBCEHA...cGCAhADA.QGGAhAHA.,2,-27,4,31
DfdEXUWMgabVLJIReGScCNTYQPKHOABZF,ZAAADAAAEACAUAEA..MAFAaAGE..LCABRBCAGBFA..CCCD.TEDAhBAAQCGAHFBBABBBhBFAFDEBdEHA..XEBDhABAgGGGJEGFeFFD.SHAAhACA.....hBHA...,1,-9,-13,4
ZDTVJFXKMWRbgCfILOUYHEQNBdcAGPeaS,eAAAZAAADACA..TADAFAEDKAGA..RAFFCAHBLCGB.UDDAhABAHCCA.ECHBBFHAAAAAaEEAhAFA.SEGHhCAAJGAA.MFFB..bGECfGHA.hAGA.OCCH..hAIA...,1,-8,-38,30
fAIceEGSXCLgZVbdYJWQBTHORKFUDaNMP,eAAAEAAAGACACADA.ZAEAdAFA..JCBFQCCAHDFAREDB.FAHBaAGAhAAAMCIB..ACIBSFABhAFALDFBbEGDBFHAhBCAKFBADFEBfGCA.XGGChCAA......hCFA...,2,-22,-4,18
XTUOMCFBRdGbDVLPZQceJgYHENKfWIAaS,aAAATAAA..MADABACBRAFA.GADA.DAFALBBAZBFBeAHHhAAAgCDAHEFCECCBKFBAhBFAfCGAADIB.hCAAXDBDCFDBdGGD.bEFA.QGGChAIA.cFEC..hBAA...,2,-22,-1,21
aSYZNKCbdBULEJfgMPOeRDTAFWcIXVGQH,FAAA..IAAAGACAHAEAaACA.ZCEECAFAdAHALEAB.EDHFhAEAfBCAMEFBeEGDhAGARCEAACBBXGCAQECAhAFASGHHKDHBbEFDBHBA....hBCA......hBHA...,1,6,-24,30
DOcWEgLVRfJFHSeGTKaXZQYUBNdICbPAM,MAAAOAAA..EADALAEARAFA.FBBHHBBAeAHHGCEAKCEAZDDAhAFAQCGABDHAdFFDCECDhAGAADDADFHB.gGAAhAGAVGCA.SGFHaGHD....hAIA......hBAA...,1,-10,-15,5
CVcDLOGYSPgTNdaAEXUefbBIQFKMRWZHJ,EAAAeAAABACAQADAKAEA.RAFAHCCACAGB.DCHBGCCA.SAHHhAAATEEAaDHDACCBUEFAhAEAbGAA..FGEHZCFAhCAAcGGALFHB.OGCE...hAAA......hABA...,2,-17,-3,14
QLYKATaEVGOBCbcIFXPMJgRNdUeHfZDSW,EAAAGAAABACACADA.....IAEAXAEDMAGBRAGBdDCAHCCAhAAAZEDBSDADhAAALAHBABHBaECCODGBFEEAgEGHhCAAeFFDDDIBQGAAKGHB...hCBA......hCCA...,2,-16,-3,13
PgNZHUeKRWOLIfQXFdJEaDTcbMSYBCVGA,...PAAAZAAAHAEAKADA.RCAALAHB.QCEBhABAdAFAEAHBaCCATEFAMCHBBDDDhAIAGEABADFAUFEAeEHHOGAChACAXGGBDHEA.......hBAA......hCAA...,1,12,-31,43
XUcOLKEZbIGMSPCBfDNWTdaVJYFQAReHg,HAAAXAAAOACALADAEAFAZBEEGAGAMAIB.CCDABCFD.DDCBhAAATDCAdEAA.aDGBVEEAhABAFEHBRFDA..eEHHhAEA............hAFA......hAIA...,1,-10,-17,7
RTBJYUPFdKgNcSXDAGILaEMbVZefWHOCQ,GAAAaAAA.EADAMADAZAFB..eAHFHAFCQCDARBBATCEABCHAhAIAUEGAdFBAKDDDNEBAXGFChAAA.ACIB.bEFAfDCEhACACGCA..PGEA...hADA......hBAA...,1,-4,-7,3
SGdDVIFgWePRQLTfUHYMaXBbCAOJKcZEN,KAAAEAAAGACAdACADAEA.FAEA..eAFARAGFLDFAUCEA.HEBAMBIBhAAAaFFA.BCBDACHB.OFHDhAAAZEBA..SEHDhBEAgGDAQGDB.fGGEhCAA...hAIA...,2,-29,-8,21
LEUgaCbWGHXVZRJNTfdcSPIeOKAFDMBYQ,MAAAQAAALAEAEACA.UBBA.CBHA.GAEAHCEAZECARAGBTDCAhAAAdEGA.SDGAhAGAeFABADIBBGCAaEBHbFFA.hAFAXGDC........hAIA......hBEA...,2,-19,-4,15
FBOfVJXCLaHWAeYbEDGKUPcdRIZNMTSgQ,eAAAEAAAGACAKADAUAFAdAEBRAGF..ZCCAMBFB..TDGAQDGBhAAAOAHFVEDBCECAHFFAhAAAACBBDFIB..IGDAhABASGFABEED.......hAIA......hBCA...,2,-17,-12,5
KVfMbISRWgTJXLdGBePFECNOacAQZHUYD,HAAADAAAKACAMACA.SAEARAEF..TBGALAHBGCCAhAEAeBGFEBBBOCCAhAAAAAGAZEFA.VEEB.fEHAhCAAbGDA.IHHA.WFDD.hAIA......hBAA...,1,2,-30,32
ZPNCEHIQdJAbUKFDGMWXcLBgfaSTOYRVe,KAAAGAAAMACA..XADALAGBBAGAaBCD.OAHD.RCDBeCGBhAAAZBDBCBFAHEFA.hACAdFDAAADAbFDADAIB.gGAAhAGASGHBYEHBPHEC...EDCBhBAA......hBCA...,2,-18,-8,10
TUgXLMaRKWGcdABIObVJHFQePNYZfECSD,OAAAVAAA.HADAeADE....PAHBZAGBEBDFDBBBUEDALCCAhAFARFFFGGABACGBbDFA.hAAA..FEEHNBIACCEATGAAhAGA...MFHB.aGFD....hAIA......hBAA...,1,-10,-11,1
EfePWHQFdJGKTIYLACXaZUcRMbNVBOSDg,aAAAZAAARAEA..MADA..bCABBAGA.DAIBEBHFeBBAHCDAdCEAGEFAhABAKCGA.TGCAhACALDDDAADAXFAChAFAUFFANEIA.SFHB..fFBAhBAA.WHEG..hBBA...,2,-31,10,41
bIQECROPJFMWGVYDXBLTAeafdSNZgcUHK,eAAAdAAAZABBUAEAHADAKAGAQAGC.RCEB.OBCDFCHDGDCAhAFADCHBLDFBAFGA.hAIAaDHDSFGAhBAA.gGDHbEBAEGHB.CHHA.MIAA..hAAA......hABA...,2,-29,6,35
ObCPYdSZMEJFeWKAgLHRBNUfaIDVcXGQT,HAAARAAABADBUADA.aAFEDAFA...XAGAGCABTCFAhAAA.CBHAdEEAZCCAEBFBeDHFhACAAAAALDHB.hAGAIECAQGFDOEEB...bGFChCAA.SHCGhCDAMIAA...,1,4,-36,40
GPUVdbcfKJIREYXMAeCaZNBgWDQSFTOLH,eAAAZAAABADBDAEAFAGDLAFA.HCAAGBCAUCEAdCEA...hABAbDGBKCGA.REFAEEDBMEBBhAAAAAGA.CEFA...aGHBgGGAhABA...WFBH...hACA......hCAA...,1,-18,-24,6
PFYbXeOKSBGHEdZDWMILCURQgAVaTNJfc,aAAATAAA..JADA....fACBFAGA.XAEBhAAAeBBBSBDDhBAAHAGBECCAZDEAMCFALFDAhAIARDEAADHAVECBPFHD.bGBCBEHADIDA.CFGD..hBGA......hBIA...,2,-25,4,29
ZQOHcRfTMPEDANICBYWXJKUFgabLdeGVS,CAAABAAA..XACAKACAFAEA...aAFAdAHAGBEAZCAAHCEARCAAMAIBhAAAEDHF..ACCA.IEGAhACA..YECFhAAAUGBAgFGA.eEEDQEEBhACAfHDBTGGAhBHA...,1,-3,-31,28
cWYfgRbeGJCXPNIQKASTaFZVLdMDBEOHU,aAAAZAAAdAEABADAHAGB.UCAA....cAEDfDDAhABARAGFGCCACDGD..XEFChACAIDAAAAGBTGGAhADALEFA.EBBBOFDDgFAA.eFDHhADA.PHEC.hAIAKGGC..,1,-1,-19,18
KeTBQYLSbZIWDUEFGMNaCdfVPOcHJARgX,RAAAKAAAeADEQACCLAGBZAEBDAIB.FBDDGAGA.aDDCdCFC.hAAAVEGBODFD.HEAAhAEAAAAA.TGBASCCDhCAAbFGD...WEEDMDIB..NIDB..hAIA......hBGA...,2,-19,1,20
WSJCHOGIaVPdLXbUfBRAKQZcFTEgNDeYM,ZAAATAAAEADE..DAFAeACE..MAIBSAFBHBECGCAAhABAaAHBdCCALDDBUDFAREDBABIBhAAAQDFBFFCH.hBDAgFFAYFHBCGGCOHBA.IHHAhACA....hBHA...,2,-5,-5,0
GRWCbLOBYPENXDJISKAaQgTdcZHFMeVfU,aAAATAAAZACB..HAEAeACEUCEBRAFF..CAHBLCCBBAHBECHBDBBBhAGASCED.ACHAdDHAhAAAMEFBGEFAOEGDhBAAPFABNICB.XFDD.KDBD..hAFA......hBDA...,2,-19,-3,16
aMAKHfCLUYRbDJWESPTVgFXQGOcZNdIeB,HAAALAAARADFDAFAEAEA..SAGA..TAGAFCAHGCEAhAAAZCAAdCEAeCCBaCGCACCAhABACCGAUGCAbEAB.PEHBhACAXEFA.QGEA.NEIAMIAAhACAfGFA..hADA...,2,-13,3,16
fTEKbODAVIMdZePHUNcgRXaWGCLJBSFQY,MAAAeAAAHADAUAEA...NAHA.RAGB..aBBAGCCA.LCFBhAAASCCDQFAAhABATDFA.EEHFKDDCbFDDAAIBdFFDhBAAcGGC..XEBC.CGHA..hAFA......hAGA...,2,-23,3,26
MgVTUdYQXNaObBLKFPJcCWAEDeHSRGfIZ,EAAAHAAARACA.GADAZAFB.MAFA..TDAAdBFAQCABhAAA.aBHBbBGDLEFAhACAFCDDPEFBCGEAACIBeDDDhADAfFAEgGGAUFCANIAB.BGHA.KHFAhAAA......hADA...,2,-8,14,22
FHJNDOQdALESRMBcIWgVbUTGaZXeKfCPY,EAAARAAAMADABACA.....IAEAVAGBUCCAGAFAZBEFeDHFhAAACAHAFCCAHDEB.DCIBhAAAdFFAADHBLFHBhAHASGDB...........hCAA......hCBA...,2,-23,-22,1
LfGHPbAaVYBREZDUQNgcdOKTFMWISXJeC,aAAABAAAZACBQACA..NAFAdAGATAEA.FAGAMAIBSCAAhAAAeDEDLDGBhBAAHCECACAAREEBEEBADCIBgGBAhBBAKDDD.XGECfEHE.PHCChACA....hCHA...,1,-7,-18,11
TgSAVMHPIecWfUZNJBOKEdYQaLXCRDFbG,HAAAeAAA...fADBZADBBAFAEAHBdAFAaAHBLCCD.RCGBFDEDhAAAGCAB.TDEAhAAAADBBMEGBIDHAhACAUGCAOFHDQECD.DFGA.bGDA..hBIA......hCAA...,1,-3,-15,12
IKBeMdRCcgYPfAWUGEVXaTbOQLHDFSZNJ,GAAAEAAA.aADATACA..QAGAHAEBSAGAhAAAZCDAIDHAeCCBRCGBCEBA.gEAAhAEAfEEAACIBVEEBhAGAbECDLFGBFGHBKHAA.dGAA....hAAA......hACA...,2,-7,15,22
PHSWZDOcLgbQAJGdTKYBURVEIeFaMfXNC,dAAATAAABADA.RAEF.EACEFAGA..MAEA..XCAACAHAHBDCZCGBhAAADCGA.LDDAhBGA.bFFAADDAGDEBhACA.KFFD...YHDA.IGHAhADA....hBAA...,2,-41,-8,33
EOVKDZLRYbUAPXaeCHJNgSTIfcQMBFdWG,aAAAHAAA.JADA..SACH.TAEAfAGB.hAEAMCABdAGAECDFKCCAZCEBhAAARDFAbFDBACHAeDGB.CDHBIECAhACAQFGAFGFBOBBHDGIB...hAIA......hCCA...,1,-7,-18,11
MPXFKHTeUVAOJRfELaSBGgZCQNYdIbcWD,RAAAEAAALADBBACAZADBQAFA.dBHAbAFADCCB..MCCBhAAAFCFHHEFCeCGBAAGAfFAAhAAAGDEACFCAIGGAhCAA..cGGCPHCC....hCBA......hCDA...,1,-14,-19,5
cdJTURVDSbKFHEMQgfWZYAaNIXOLeGCPB,aAAAXAAALADAGADABAHA..dAFBTCCARBFFDAIB..KDAAHCEBhAEAEDHB.MBBB.QCGAhAFAfEFEZFGBhAHAAAAAODDHeECBCGFA.PFHB....hADA......hBDA...,1,1,-20,21
VGbADOYZBFRLQXIgCPKNWTdcSHfUMEaJe,OAAAZAAARAEALAHB..QADA.XAFAhAGACCAAKCCDTDEAdCCAHCFAMACAhABAEEDA.eEGFGECAhCAAAAIBBFHAFEHBIGFANBBAWFFD.....hBAA......hCAA...,1,-13,-16,3
CGEIWVKDcPLBXaJegUNOQHfMSFTAdYZbR,ZAAARAAAEADE..IAEAKAFC.DAGALBHBBBFA.aCCAeBGHUDDBhAAAQCAAHEFBMFCBhABATCDAADGA.bEFACFHB.hAIA....WFED.....cGGAhABA....hACA...,2,-33,-16,17
bHfYNWceRDSOZaIGLCJKPQTdFEAXUBMgV,BAAAMAAA...VACAHACC...fAFB.NAIA.eAFEhAAARCCB.OBFCZCEBGDGAhAHALCABKBBDTGDAhBAAECCBADFAXDFA.bEDD...cFFAhACAaGGHCHCD....hAIA...,2,-35,3,38
WQIMcNHUVPJTgXZYCKdBOEaGDRfFbeLSA,QAAAMAAAHACCUAFAJACE...TCCAZAFBKAHBBAHAEBEFGCGAhAAARDFAFEEH.LDCBhCAAABBB.IEEAhCDANICB..gGGBCGFA.aFDHDFIB..hDAA......hDBA...,2,-14,-11,3
AfQadJNEKUZTHRGDXVceMYbSgCIWOBPFL,aAAAdAAAEADAZACB.HAFARAEA.GCABDAIB.XCFAeCEA..MBBBhAFAbECA...CDGAODHDhAHAFEGHAAHA..fGHAhACAQECANICB.TFFA.....hADA......hBAA...,2,-21,-4,17
PEJCGLOegXcTVFIZQBfSWHNbadYMAUKDR,DAAAEAAAGACAeABA...XAEATAEAFAGAZAGBQEAAhAAABCCASCEAHEDAaCFHhAEAdCHAAECARFGBCCBDLEEBhBAAOCHD...gEGG.IHHAhCAANIBB.....hAFA...,2,-17,8,25
EJHcDROCPAaFgGdMQfSLeZYUKIXVbWNBT,aAAAGAAA.dADAMADAQAFALAHBeBHHZBBAKBEC..XCDAhAAAVDBA.bDBDBBGAhBAAEEEB.HEFA.RFDBCGHAhBDAAEGBfEHASHGG.IHBA.hCAATGDA.DFAB.hDAAFGGH..,2,-9,11,20
YGKSADRHgecNWQOTZEdPFaVMXCUbBIfJL,HAAAeAAA...NACB.QADAZAEE.EAFAdCCAaAHDMAIB.CCFABDGAhAAAfCCALEEBhCAAGCFAAEIBRFCF.gEDBhAAAOHFCFGGA........hCFA......hCHA...,1,-10,-13,3
ScCMVWGedZONEYBPfRagDbFLJAXQKTIHU,QAAATAAA.HACASACBMAEAGBEBeAEAZBEEEDDABAHAhAAARDDAaBHD.DDHBLEABhAAAADIBKEFBIGHACCCDdEHAOFFBhAEAPFEBfGDA....hAFA......hAIA...,2,-3,-2,1
TbMWaECcSIfKQgHeDNdVXOZUJLYPBFRGA,MAAAEAAA..SACAKADAHAFBeAHBdAFAOAHBZBBALEEAhAFABCCARDABACEBTGEA.aGGAhAIACDEAIEGA.hBAAQGDADDDB.XGGA..hAAA......hADA...,1,-9,-28,19
NFdAMIgUfHXPWGaDERecJOYBQbTKSVCLZ,MAAAUAAAHADA..XACAGAGAECDBRAFAeBBBOCFBBCFDTDAAhADASCGH.hAFALDDBZFGBdGAAADIBfEHAhAFAaEFD.DFFB.cGAA.QGGBhAGA..hAIA...,2,-22,0,22
BKGOCPRMNAHgdYULQbcTeWIaSDfFXEZJV,HAAAdAAALADAQADC.TAGAeAGHaBHDDCABFCCHECBAZCEFBCFAhAAAGEAACCHAREDA.AAEAUEGAhACAbFAB...IDDAhAIAXFGA.KGEAMIFANIEB.....hACA......hAFA...,2,-2,-2,0
LbJVOFQMgTBDEAWSfZRGYeUaCNXKPIHcd,SAAARAAAeADE.CADA.KAGCHAEBdCCALCFAJAHB.FEBHMCCBhAAABEDAAAGAZDAFGEGAaDDB.hABA..XFEDhAAA..IEEA.bEGBQGCAhABATGDADFGB....hADA...,2,-21,-11,10
IDBZTRONSLKGQWJdECFUaXPebMAfYVgHc,VAAAHAAADACA.ZAEBRADF.OAGDLAFBGCCAQDAA.hAAAdAHAEDHFFDDHaEBHeDGFhAAAAAIB..fEFAhBEA.gGGABEHASFEHKGDA.hBGACGHAPHBCMICA..hADA...,2,-17,4,21
IAaSgTKFENeZGLYWOUBfcVJXPdHRbMQCD,aAAATAAA..EADAeACEGAFALAFBOAHFBAHA.fBDEhAAAVCCA.XCGDhAHAHDABRDGFbFEDMCCBQGGBhADADDDBACIBKEEAZFGBYHAA...hCAA......hCFA...,1,14,-13,27
VZXABUYadCfKbcLWREPMJgTNDeIOQFSGH,BAAAaAAA.dACAKADALAEARAFF..EBBBMAIB..TDAAhADAeCBBQDDAhAAAGCGAHDCBZCGFAAHACEEB.bGFAPFABhAFA.JFCBDBIBFFGHXFAC..hAFAfGEA.hBAA...,2,-11,-9,2
RNDXbLGeSgcWaKOQBJYCMFAIPZEHTVfdU,ZAAAHAAA.TAEAdAEARAGBDCAALAGBGCFAeCAA.SCEDhAAA..gDAAhABAaCHDQEAABDDACEHAhACAAACAEEFFfFDAXFDD.cGGAOFFHhADAMDDBFGAAIHHAhAGA..,2,-12,0,12
eOJNcGCULBgMZSbWIDFEQVdRYPHXATafK,aAAAeAAA.OADC..NADAGAEALAGBMAHBZCCASCHHhAAA.IECAhABAEBBBdDGDREAAHEECAAEBTFFAhAGAKFAACFHABGCAbEDDFGBD.....YHFGhAIA....hBAA...,2,-10,-8,2
TZAJdLNMWgRUfaKESOHGFeBVCPXbDQIcY,dAAAMAAARADAUAGAKADA..EAFEHCAC.eCFBCAHB....bBBCQEAChACA.IDHAhADATCEAACGALEDBhAEAgDGAaFFCOFHDBDDDXFFChBAADIBA.YHDA.hBAA...,1,-6,-26,20
PHBLFYSGUZXJdeNROaVQDICKfWTAcbgME,...bAAAEAAA.HACALAEASAEEZBFEdCAARAGFaCCCQCCBhAAACCEBKDFA.TDFAACIBMEEBhAAAFEEHUFFAeDHH.OFAAhABADEIB.fGAA.gGGAhACA.BHDA.hAIA...,2,-21,22,43
XWUEfaTRPMYAebcGDHVFgNIOSCJZLdQBK,eAAAGAAAHADAFADA...IAHACAGAZBFEdCDAQCCCKDFA.hAAAXCFAEEHF.aDHDhAAARFFBMGAAAAFADEEAgFCAhABASDBHBHDAfFFA...hACA......hAGA...,1,-2,-25,23
JEXGFTSNCZcgMORbQdIHVAKLPYafWeUBD,LAAAaAAA.eADHDADAEAFAGAFA.TCAACAHAZBBA..MCFAhBAARDEBdBHAHDBAAAFBKEDD..hABAfDFABEHAFGGASHAAhACAgDGHbFDCIHEA..hAHAPFHD...hAIA...,1,-8,-10,2
EeZaKJIfgULVSHTcGBAWRbOYdFQDMXPNC,RAAAOAAAdADADAFA..MAEA..XAGACAHAEBBB.ZCCAKBDA..hBAAJCFA..fBFBhBDALEEAHFBAGDDAhCAAAAAA.bCFAQGEAeFGBaFHF.IGHAhBFA......hCAA...,2,-20,-8,12
gLIDPGFMeKRbHYEcBAdSTJOVZUXfCQaNW,dAAATAAAOADA.ZAGBXACB.QAEAaBDB.NAHA.hAAALCEB.DBIBhACAGCCBeCBFREGBHEFAhAIAEGBAABGBSFEDUGEACEDC.gGBAhBGA.FGHB.MIDA.hBAA...,2,-17,12,29
bGWVZRIKJDALgCNeTfaPBdOFcHMUYXQSE,LAAACAAA.eADHaACAdAFAFAFAHBEBUCBA.QCAA.hAAAEBHFGBGAZEEARGCAKGGDhABAAAHATEDA.BFBAhBCAMEIBSDDE.bGEA....hBDA......hBFA...,1,3,-33,36
GLgBaOcVDXSEMJbRPWTQNIeFZAdUCHfKY,dAAAHAAAKADAGADALAFBaAFA..OAHDDAHBECBAMBGB.RCAA.TDDAhACAQEFB.hADAeEHHAAIBCCHA.fFBAhAAABECDXEGAbFDD.PFFB.IHHAhBAA....hBCA...,2,-35,19,54
DfaXLRbIPYUHOEdJGcSAgCWZTNFMQeBKV,CAAAZAAAFACAeACE.KAFCDAFA....aAHDRBDA....IBHAhAAAPCCBHDFAdCBAGDDBhAIAADHA..TEDAhABAMDIBQGBAfFGAbGCAOFGB.EGDAhBCASHBG.hBGA...,2,-26,-8,18
RHEGTDBdYJbUAfcOZaPKCNWLFMSIQgVeX,OAAAaAAA.KADACADALAFA.MBBBQAFC.eAHHhAHAHCCAEBBBGCFAhADATDCAdDHA.bECCADGBZEFAhBAAPHAAFFDDSGGB..IGHAhAGA....hAHA...,2,-14,-14,0
SPJRIfLTbcNeagBHFWOCMYdEGXVQDAUKZ,ZAAASAAARAEALAHB..TADA..bCABeAFEBCDAHBFAhAAAOCFDMCCBEEEBGDDAhABA.QDGAhADAAADAKEHBIGGAfFGEaFACFFDH.CHCD..hAIA......hCAA...,2,-12,-6,6
cUTdgCNVOPXFKQABZSEMLJIDGbYaReWfH,ZAAAEAAALADADACAGAEA..aAGDRAGBeCCBHCBAUDFA.dEAACDGDODHDhABAFECDAAIBBDHAMEBBhAGAJFEF...IGGAhAAAbEDD..fFFB...hAEA......hAFA...,2,-17,-16,1
YdOEKIRSaGZNbQVfMUcFALHDWTBgJXCeP,HAAATAAABADB.XAEDeACEdAFAEAGARBGFGCCA.ZEFAbCAAhAAAQGEA.hACAMDBBFBHDADFALHAAhAAADEEAgEFACGHD.OEHD.SGAAhAGA...hAHA...,2,-10,-1,9
SQCWVYMANGcTKeUHdBFOPaDZLXREJbfIg,GAAATAAA.eADAHACBdAHAOAEADBGBZCDBRBEF..EAHFJDGB..bDFDhAAA..IDCAhAAA.SDADhACAQEBACFEA.YCHBADIBKFHBFHBAaCAC.LHDAhACA.....hADA...,2,-19,17,36
fVeTgdbNHLJBPEQUOMCYKFRXDZaIGWcSA,eAAAdAAAHADALAEABAGBEBHFQBCD.MAIBKCBARCEBZCEBGEGAhACASCGHACGBTFAAhADAbFAA...NEEA.PEHDhAAA.CDDDXGDDaGFH.IGFAhABA.....hAFA...,1,9,-17,26
JONTHLZAgVYSUBMQeGDPcKIbWEdXaRfFC,VAAASAAA.MADAeADE.GAGADAHBKBCA..bBDDEBEEaDCBhAAARDDA..FCHDODFDhAGAHFFAAAAA.UGBAQFCAhAIA.IFHAdHFDCGDA.NIBB....hAIA......hBGA...,1,6,-17,23
ETNLOPebSQJIWGaBFCHRVKXZdMgDAfUcY,UAAAEAAALADAeADA.QBGAJAGB.GCBAaBHDBCDAHDDBhAAARDAA.XDGCZDFAdFCA.hADAMEABAEEB.fFGAhAEA.YFHBTFFAOHFEbFAD.hAFA......hAHA...,2,-23,10,33
gPCXNHaQYMfeGOZScFWKIELATDUbdJRBV,TAAADAAAdADARAFA..BACB..VCBBCAEAHAFB.aAHFMCHBeCCBhAAAZDFFFCEHKEDA.LFABhAFAADHAUEAA..bEFA.hAGA..JGEA.PHBANCIA.....hAIA......hBAA...,1,-3,-29,26
HRSWMVCGUKAgNXTYBEfZaILcbDPOdeQFJ,XAAATAAA.BADAEACEZAEBLAFA.DCDAdAHA.eBGDQCFAhAAAHCCBREABMDIBhAAAGDAAACCB.NCIA.aEFBbDDDFGFDhAEA.SHBACFFB..KGHD.fHDBhABAIHHA.OHAEhADA..,2,-4,-2,2
TEFJDPQfNOHgbXGYALeUSMRWCVKIacBZd,eAAAMAAARACACADA..KAFA..aAFAZBFE.dCCAEBBB.DAIBQDFAhAAA.ODHFHBECbDDBhBAAGEDAADHALEHBhCAASFAAIFFATGGAFHFCJHAA...hDAA......hDBA...,1,-7,-13,6
LYEJUNcTHMdAbVQXOZRBKDPafgWFISCGe,QAAAZAAARAEADACA.aACE.....fAFAFBHDCCCDeCEBEAHBhAAAUEGA..TCDAhADAHFAAAAHAbCFD.ODCBhAFAKGDA.gFEG.SCHDhAIA.....hABA...,1,5,-37,42
NZbSePEaIgdWDCRHFXUQAJOYLGVcTMfBK,OAAAGAAA..TADAMAEAKAHBZAFBeAHF..EBBB.aBDAdDCAhAAADBGBHEDB.XFAChACAACEBLDFAfDHAhADAbDCD.SFFBgEEGCFHA.FFHB.hAFAJHCA.....hBAA...,2,-16,-1,15
afCWVUdGLObSRPKTHJBDYgFXMNAeZcQEI,eAAAZAAAEADE..aADDCAFB.UAFAGAGA.LCABSBHBRCCAKDFBhABAHDBABEEDDDDAFEHDMDGBhAAA.ADHBQFBBhABA.fEHAdFCA.bFED..hAIA......hBDA...,1,-11,-21,10
CPfaKGEAODXRTZHINSJLcgQMYUdWebVFB,XAAARAAAHADB..SAFALADAQBGAMAIBdCGAeCCBhAAAbCDBBDFACDAA.aEAAEEEBhABAAAAA.TFAAZEGBIFAAhAEAJEHB..gGDBUFDBFHAA...hAFA......hAHA...,2,-6,2,8
COVZUWYLSdXKaeEARMFcTbgfBGDPNJHIQ,RAAAMAAAFADA...TADA..bAFDBAFBGCCADAHB..JBBBHEFAhAAA.CAHAOFCHhABAZCEBUDGALHEAdEDCaGEDAAIBhBAAfFEE.IHAAQGGAhBBA......hCAA...,1,-3,-26,23
SePfHNKcJCLbBWUTMRVFXIAgYZOQDaGEd,ZAAAQAAAGAEAEAGAeACAHCAAKAFACAHBLCHB.BDGATCDAhAAAREAAFEEHACFA..OCGDhADAdGADfGDEhABAJDCFUFEAMCIBXGFAgGGBaACA...hAGA......hBIA...,1,6,-10,16
DSTbKdJILRcYeCfgQFHUPMBXOVAZNaEGW,aAAAEAAAGACA.DAEAbACD..dAHALAEARBEF.eAHHfCBEhAAAQCECHDFBhBCAMBBBODHFAAFAZEFBSEBDhBEATGCAKHGAIHBA.CGHDFHDAhBGA......hBHA...,1,-4,-6,2
BZAdSWEJKIUFgXORQLfYeHaVcTPCDbGMN,dAAAEAAAKACAFADA..OAFDRAEFLAGB..eAHBHCCB.aCHDTCBAhACADEABGEFABDEAACHBhAIASFED.hBAAIGCAXECD.QEFA.hAAAfGHA.hAEA...,2,-28,-17,11
GAKFEgLdITPBObQSfMNHYWRaJUcXDZeCV,EAAAdAAA..TADAOACC.QAFCMAFAHBFARCCAUDGADCCBeDABhACAGEAAABHAFDDALEEBhAAABDGASDHHhADAfGGA.YHCAaFFBXGGACAHB...hAEA......hCAA...,1,-2,-6,4
JGNZBQLKSYgPUWXCDfbdHRcIOaFVEeATM,MAAAGAAAZABELADAKAFA.SAGH..gBGAhAFAPCDBUDGACCCAbCEDHFAAhAAA.RFDFOCFHhACAFDHDEECAAAHATGGABGEAQGGA..hBAA......hCAA...,2,-25,9,34
NJIPEFDBRWLMOcTfdSbHGVXeKgQaYCAUZ,ZAAAJAAA.EADEBADBLAFB..MAFATCAAdBFAHCCBGCGAeBHBhBAAQDDC.hBIAaAHFACCBIEFAhCAADECBRFFBOHBASDHD.bFCC.KGGA..hCBA......hCEA...,1,3,-25,28
GCVFODKaUZBXfTQdHRbLcAIMgPJeWSYEN,MAAAJAAA..eADESACA.EAFAGAGA.FBDDKAHBZDEBhAGAfBBEdFCAHGEC.hAIARCEALECBACCB.hBAAgEEA.PEHBNDIA.OFABhAFADIBA.aGGH...hBIA...,1,-4,-20,16
HABaMeTIPYOSCQNWVDZXURbdFGLJcfgEK,aAAAeAAA...TADAIADA.OAEDQAFC.VCCBhAAAZAGBRCCBdAHAGEFAhAGALDGBfDHAhBAAEEFFHFDBABBBMFEBSGHHCGBADFIB.....hBGA......hBIA...,2,-18,5,23
LabZECIPWQJAUFYfdgBeOVGDcHNTSKRMX,FAAAdAAAeADAGACAHAGB..TAEARCAAMCEBaAGAZDEB..EBGFCDHA.hACA...IFCAhADAQDFBAAIBUGGAfEAAhAEAOEABDGBBSDHH.XEDDhBAA....hCAA...,2,-26,-5,21
DFMfIPWNJgKYURHVGCcXEQbLTaAdOZSeB,ZAAAeAAAFADAMAEA....fAGAIBDA...PBHDhABAJAHBKBFB.RDDAHEGBhAAAGCAAXCCCECCBbDFDaECEhACAADIBdFBA.BFFCDFIBgGAA.hABAYHEA..hAGA...,2,-17,-9,8
JgOKCDHdYXFaVTNfRWPcbMZAUIeEBSLGQ,eAAAEAAALADAGADAQAFAOAGDDAIBHCBAdBHAFCCH.aDBHTDEAhAAARDFB..PFABhAAAbEAAAAEABDHA.SFGAhBCAKFDACEHB.XGDAfGHA.hCAA......hCBA...,1,0,-12,12
SFQcNPRZaLGVgXECMIfHYAKbOdBTUJDWe,OAAAdAAABADAUAEADAFA...eAHBQBEA..PBBBhAIARBGBaCAEGDCA.hBAA.XCFAEEEEMEIBhACAHDCAAAIBKFGBbEFATGEASGBA.FGEAhBDA......hBEA...,2,-17,-14,3
YIfESUJMcPFHdATNQbRZLaCgOGeKWVDBX,TAAAQAAA.RACAZAFBaACA...OAHDeAEHKAGADCEBBDAAhAAAXCCD..fDGAhADAECFASCHHhAAAMDDBFEHDHEFAAEFBbFABLDBD.CFEDgGAGhAGA.WHDAhAIAIHHA.,1,2,-16,18
DYeWXfcGdTNZCALQMJPERHFUOVISbKBga,MAAAEAAAHACAFADD.OAEA..SAFABAHAaCCC.eAHHXCEBhAAAGBBA.dDEAZCGBhCAAAAFALEGBQGDAhCBARFCB.IGGA.......hBAA......hBBA...,2,-21,-7,14
XEQOTYZHNVgcdRWUPKeCIFGBaADLSMJfb,LAAAMAAA.JAEAXACA.EAFATBDAHBFC..VCCBhAFAdAHARCAAUDGBeCFFFFDDaDGDhABAAAIBDBBB..bGEAQFFBhBAA........hCAA......hCCA...,2,-21,-9,12
RgITHGePZAcDEVKWbfMOJYUNQaXCLdFSB,EAAAKAAA.....bACAMACA.OAEEUAGAaCCALAHB.hAAAdCCABDAARCFB.TDEAhADAHECCeEHFADDBDDGAfEGAhAEAYHCANDBA.QGBA.FFHDhBGASGGD.hBIA...,2,-19,-10,9
HgMUXLZRQNDKAGeWaIfEJSBVOFdbcYPTC,eAAAaAAA.EADABADAFAFD.dAFA....bAGDPAHB.HCCAhADAMCCBLECARDDAQEGAhAAAKBBDADGBGEGAhAIAfFFESFBD......hBAA......hBFA...,1,-11,-18,7
DGeKROEHWCUFQNITdMcLAaYbSVBPJgfXZ,aAAASAAABADA...JADAXAEDGAGARBCBHAGD.CBBDQDAAhADATEEAdFCAMDIBhAAAACIBVDCA..fCEBhABAeDGBEFFBFGAAIGAAYFHBbGEA..hAGA......hAIA...,2,-7,-6,1
KcaXZBLJgVYbUDOPNRHTAFeGEIMWQdfCS,eAAAEAAA.MAEAdADASAFAKAHB..aBCDZBFELBEBhAAAJCBB.VCGBUDEBOECBhABAREGFHFACABGB.FHDAIFFAhCAA...fFHA..hCBA......hCCA...,2,-23,-18,5
ZeJXAKERHPQCNgDYfIVGOFcUdTSbLMWaB,RAAAHAAAQADCCADBDAFA.....fAFBGBDBFCAHdAHAbDDAhAAAMCCB.BCGDeBHHhACAAAAAEDDA..gFFAhAIAIEFAODHDTGBASCCGhBGAaFCDXGGCNEIA....hCAA...,2,-24,-2,22
CXSNaeZJLUdYKcfHDRbgEGITMVWBPAOFQ,QAAASAAAeACHZACBLAFA.dCEAKAEAHCGBRAGFECEBGEBAhAAAMCIBBDDDAAGACEDDaFFBhBCAUEAA..fGDAhBEAbDFD.TGGAPFCA.FGHD.NIAB.hAAA......hABA...,1,8,-13,21
KQROBeWAUFHXGfZgCEVJdPcTSbLaYINMD,HAAAGAAAZADBEADAdAGA..TAFALBFDaAHD.IDAA.hAAAMAIBQCDAhACARDGFeCCDAACAXDFB.hAAACDCDPDHDbGDADEEBBHHAFFFHfHABhADA......hAHA...,1,0,-9,9
fZGPKJUEbaLgVcYdSHNCXTIAOBRFeQDWM,RAAAeAAAQADCMAEAGBCAKAFC..EAHFaAGELCCA..hAAAgBEBVDFAdGCASEEDhABAHCGBXEEChAAAAFIBFGGBfFHA.....hCAA......hCGA...,2,-11,-4,7
HLJaXGDIgUWBEFAQedVRZTSPNYcMCKObf,eAAARAAAZADB...TADASAFA..PAFA..cBGDhAAAMBIBOCCBhAAAHCEBaCCBGDEADDABgEGAhABABCGAADEBdEGAVGAACFCAfGHALHEA.hADAXGCA..hABA...,2,-17,2,19
YNRTKXdULSDgCFbZGQOfBHaPVAcWeJIEM,eAAAEAAA.MAEARACAKAFCdBDALBHB.DCCBFAHD.GBFA.hAAAQFBABCFAHDABhADAaCCBACHBJDDBIEEAhAAATFEASEGH.CGHA.OHFC.hABA......hBFA...,1,-18,-21,3
JRabNIAHUTfWYXMKSVLDcgdeOGCFBZQEP,HAAATAAA..fADB.XAFBMACASAEAhAAA.LAHBhBDADAIBdCADeBGHGCCABCEAhAAAEBGFREFAbDCDACCBYFCFKDHBgEEBFFEH.PFHBhACAaGHB....hCDA...,2,-14,2,16
dPISENeOMZDALcHgCJGaQRfWVTBKXYUbF,HAAACAAAGACARADF..VAGBKAEAUAGA..dCAD.SCEHhAAAECABeCEFZDFBAAFALEGBhACAJDHB.aDDHQEABhAAATGDABFFA........hADA......hAIA...,1,-12,-20,8
CeBfQEaHRSJUOcFDKYVGWTXALgNZdMIPb,LAAAZAAAdAEAMAGB..bADDeAHBBAFAECAAHAGB.RCABSDEAhABAOCGDDDDAKEBAGEGAhACA.TFCAAACAgEEBhABAPFABfGFEaEHD...hAIA......hBEA...,1,9,-26,35
PXSFWTagDbARcUCEfdZYBJNKMOGLeVHQI,RAAACAAAdACAZADBBAFA..KAEAGAGAeAGHHCDBQDAA..hAAAXCBCFDED.aBHDhAAAbDFDACFB..UEABEFCFJHFAhABAMEGB.LEHB.....hADA......hAIA...,2,-17,-15,2
PgeKIEUGFHfTQSLYOdCZWbVaNAJRcXDBM,RAAADAAAMADAeABA.KAEAEAGA..GAGAHBDATCGALCCAdDDDZECAhAGA..VEFBAAIBXDEAhBAABFBAIHHAhAAAFEHDSGGD.CHHB.......hCAA......hCBA...,1,-9,-20,11
DVZdOAYGcSFQMHgECRXWUfJBbNaIeTKLP,GAAAFAAAHACBEADARAEAUCGABAFA....aAGDeDEBLCDBDEAAdFAAhAEAAAABSBHHhACA.MCFBXFDDhAFAfDGENIABKGGA.ZGFA.ODAH...hAHA......hAIA...,1,-8,-19,11
JHMbXdgGCAWNUeYKQPROIcfaFTBEZSVDL,UAAAeAAAQADARADA.OAFCfAGBaCCB.BCDDECFAZDDAhAAADCFAHDAAMCIBdFFDhABAGDFAAAHA..YHDAhCAAKCHBIFDAFGHD.SFHH.hCBA......hDAA...,2,-21,-1,20
KJZRdgAPETCfOUeVFIMbNXQDLcYSaGWHB,EAAATAAA..OACCeACEFAFAMAEA..XBDCLBGBSAHHhAAAGCCAHFDBhAAAKCFAREDAAAIBfCFAhCAAUGGAIEHAbFFADCIBaCCHBGEA....hCAA......hDAA...,1,-1,-13,12
ARgMFNGQEZHeVfbaDCLUcXdBTPSJWYOIK,RAAAMAAAGADAZABEHAEBeAFA....VCFAaAGALBGB.hAAAXCCCdDAATFEAhABASDHHJCCFOEHDhADAAEEAFFFBEGAADGDBCHFABHHD......hAFA......hAGA...,1,-2,-16,14
WaXACHZcPYGdDfJMQTRVgBIEUObLKeFNS,HAAAZAAA...PADAdAEAfAGA.MAIBRAGBBCADECAA.hABAbCCALDDAeCGDSECAhAAAaCHHAACA.CFFA.hACAGEBADCCAJFHBTFFA.IHHAhAGA.KFDCNIAB....hBEA...,1,-6,-11,5
ULJPKMdcaXCHIFDEbQfSgORYGNVZTBeAW,LAAAKAAAdACA.aADDHAEA.DAGAEAFAQCDDSAHHRCGBGEAAhAAAZCAAeCEF.ACGBUEGAhABAMEEBCFFAFFAA.bFEDOFHDhAEA..YHBENICBBGCA....hACA......hAFA...,2,-9,-6,3
ZfRMDEYSJeAKNHLgIVFOCBdUGbQTaXWcP,HAAALAAAVAEACAEAdAGAGCAB..TCAAaAHD...XCCBhABAPDECREAB.EEHFSBHHhACAAACAKECA.gDFBhAEAOFFBBGHAbEDDQGBAhAIAWHAA.ZFFA.MIEA.hAAA...,2,-5,4,9
HLGSUCWcaXDQEFVZTfKYbMJeONBIAgRPd,RAAAHAAAGADACADB..aAEDQAFA.ECCBZAFBKAHBbBGDeDABhAAABCADADFA.dCCALDHBhABASEDAUFEAXFGAhAAADFAB.FGFH........hACA......hAIA...,1,-5,-20,15
PceTGNVQECJKgRUOWYdBHZfXIADaMFSbL,aAAAMAAA.FADDLADA.eAGHGAFAQCCAEAHBKBBBRDDBOBBBhAEAdDHAHFAAZDFAXFAAhAFAAAFBSFGDbFCDTFFAhAIACHEA.........hAIA......hBAA...,1,6,-17,23
PBceAXTLgRZOFHGDdCKSfWbYMJUNVEQaI,TAAARAAAZADBHAFA.dCCCSACB..bCFAMAEAUEEAEAHFhAAAQFCAaBDDBBFAACCBhBFALDABFCHDGDEAhCAAKFHBfHABYHFG.JHEEIGDAhDAA......hDBA...,2,-14,8,22
KbSDcHFWUGOCLMNIYeQgaRfXJPdEZBAVT,TAAASAAA.HACBFACAGAEALAEAMAHBICFA.hAAAeAHHaCCBRDDBJDEFEDGBAAAAKDHBhAFADAIBUFGBCEGD.QGAAhAGAXGAAdGGABHHD.....hAGA......hCAA...,1,0,-11,11
OKVRIHFZQcBdCXaWDgUTbYEeANGSPfLJM,GAAASAAALADAMADA.KAHB.RCDAHCGBZAEEQCCChAAAdEADaECD.DAIBUFEATCFAhABAEGGEAAABfDHAhBDA.OEEBFHAA.CFCAXFGA.gGFGhCAA.eHCGhCBANIDB..,2,-7,8,15
fLKaHPEIGcYTMXUZFDgBWVSORJAbCNedQ,CAAAeAAAdACALAEAHADAEAGEGCCA.TCFAMAIBZCBA.DCEAhAAABCHB.SEFAhAAARCGBAAFAQFDAaEHDIFAAhABAXFGAFFEH.gGGG.hBCAOFCH...hCAA...,2,-30,17,47
cCXABZdVUEWGMgKHSRJQNbOLYeafITPFD,dAAAEAAAGACAMADAHAFCRAEA..QCFAOBDBeCBFaAHFTEAAhAAADCFBCCGDBDHA.ZEDEUFEAhAEAKFGA.SDHBhAFA..bEBDfCBEIHHA.FGGAAIAA.hACA......hAIA...,2,-17,9,26
BDeQWINXGUHLSdgAaCKZMPYVJcRTEbFOf,aAAAZAAAMACA..VADARAEA..EBHFOAGDDCCB..eCFFQCCChADA.IDFAhAGAGECAHEFBdEHAAAIBKEEDhBAAYEHHTGFAfHABNBBA..hABA......hAHA...,1,-13,-17,4
QZFXacENeIfDgJVdLBCOWHPSYMGRUATbK,TAAAQAAA.ZACBaACAEAEA..eAEHDAHB.JAGBdCEA.LDGBhAAAOBHDHCCBSEDDhAIAGEFAABGBbGFAXFDDhAAA.IGAAfEFABDBC.CHHA.hAGA......hAIA...,1,-8,-12,4
CQJNGWYVcPBTedIXbgZFSafLROKDUMAEH,HAAAQAAAGADA.VAFABACA.eADHdCADXCGAZAEBaAGDRDEADAIBhAAAADDBEDFB..CDHB.NEHA.hAAA....cFGAhBGATFAA..........hACA......hADA...,1,-9,-26,17
eUYIaOcJDTKMBdHPANVXWELgSCFfbRQGZ,XAAAEAAALADA.CAHA.FADA.RAFFZCDFeBCBUDBA..aCEAOAHDhAAADCHBMCIBHDGBAAEA.hAAAVGEASDFDhAHA.bEDDYHAA..IGGAhCAA......hCBA...,1,-5,-26,21
MTbcKgZYURaFGNLAHVWfPIeCJSQODBXdE,HAAAVAAA...fADBeADE.SAFBQAGCBAHAhAAAEBDFMCFBTCCAbDFDKCADhACAZEDFRCEFGCGA.hAAAACIBIGFAOCHDDGIBdHAB.gECGhAHAaHDC.....hAIA...,1,13,-11,24
AHLDfKZWSbTBUCPMEcIgOGXFJeYNQRaVd,HAAALAAAKADCZAFBSADHBAHAUCABMAFA..EBEF..gBEHhABAGCGAFDDHeBGHhACAQFEAREEBdEHAABIBfCCEhCAA.WHFACHHA....hCBA......hDAA...,1,-16,-17,1
VBZFEfIYQMHJeKCURWgTXGObSALNDdaPc,LAAAdAAAaADA.VAEAZAFBFAHD..EBHF....fBDAhACAQCAAHCBBeCDBhABACDGAREDATDFAODHDAAHADDIBhACABGGAMEAB.KECB.gFFAhAEA......hCAA...,1,-12,-17,5
PLUWaJHEgONSDBIXYVZMCGQbeRFcdATfK,TAAAKAAALACB.UAEAaACAHAEB.EAGAOAGFDBDBXCGAhAAAZDEAGEBA.eEHHhAAAREDAdFHAAAIB.fGAAhAGAPFDA.gGEASGGDBHCA.hBEA......hCAA...,1,8,-21,29
OgDFNEVXBJHUKfZWbMRPAaLTdeIcQCYSG,aAAAdAAAeADA.QAGASACHGCABDAEAEAGABCFA.HDFChACAfBEAZEAAbFFA.hADARCFAABBB.LEBAhBAA.TEGACEED.OFEDNIBB.XGCBhBEA.KGGD...hAEA...,1,-4,-5,1
bSDQWIZJPfedVNOcBTGFAXUYKMREHCLga,XAAAKAAAEACE.HADALAEB.aAGAbAGB.DBIB..QBGChAAAZCDAJDAA.eCCBhCAAdEEAOEHBTEEAADIBMFAAhAAAREGFSECDIGCAfGFAhABAcGCD......hADA...,2,-12,-4,8
aPcQEBFYJAWeXDUIdNGfHMLKCbRSgTOVZ,eAAADAAAdADAGADAHAFAMBBBLAFA.CCCDRCFATCEAZEFA.aCCHQGAAhAAA.EDBBhABAFCHBAAGA.XEEAhAFA.IFHAKGCASGGBOHAA...hAHA......hAIA...,1,-2,-22,20
caEMfZFYWGgQIRVPXDJKBNbAUOSHeLdCT,SAAAHAAAeACEdAFACADA.aAHB..EAFAZCCAFAHDGDFA.QECAhAAARCCAXCFDKCHBhBIABDAAAFIBLHEAhCAAMDIBfEEE.gFAA.hCDAIGGA.DHDAhAAA...,2,-36,9,45
GdSTbVWefgHaOIRFYAZJMQKEUNBcCLPDX,ZAAAMAAAEADEBADALAFBDAFA.dAHA..TBBAVCAA..eDEBhABAHBEA.aAGERDGBADIBQDDChBAAKECAUGGBCHBAGDGAhBBA.bGDA.........hACA......hBHA...,1,-9,-10,1
TJDMIUgOdNbWQPSeYGcCKHZVXEAfBaRLF,aAAARAAALADB.FAFATADA.MAFAICFAUBGAdCCA.hAAA...bCGDQDAAhADAeCCDGEEAKDFDHEDBhBAAZFBFEGHBABBBBFHADAIB.OGFC.NICB.hCAA......hCFA...,2,-10,-4,6
NXEFeabUfMWYZAgLIdHBGDKTPCRSQJcVO,LAAAHAAAGADATAEARAFAQCAB.VCGBXAGBhABAEEFBFFAAeBHH.bCAAMDDBhAAAZDFFACAAdGHAKEAASFDHhACAOCEHaFFHfGAEgGCADICACHHA.hACA......hAEA...,2,-6,20,26
NTEVAReSbKHBUQaOPcGZWIgdCFXLDYMJf,RAAAeAAAKADCHAFAQADA.OAFCGCCAZCCAICHAdCGAXEEChAAALEFA.MFCBhAAAfEHAEGDAAAHABGGAhABAaGDCPHAC.gGGADGIB.hCAA......hCCA...,2,-13,4,17
bPNaUXTgHODfMALRBSKIVdWGFCYceQEZJ,RAAAKAAAdADAGACAFAFA.CAEA...eAHHEAGAZBFE..JBFF..bCADhAAAaCCC..UDGATEEAhAAAHEDB.DCABADIBLFHBhABASGAAIGGA....hCAA......hDAA...,2,-30,-12,18
gOeWVAHIKZcQUdNRbfPaBJSTGFMDCXLEY,HAAAZAAAQAEAdADARAFA....bCACaAGEBCEATCAAGCGAhAAAMCEBCEEALFAAhACA.EGDAOCFE.hAFAeEAAACIBKGFAcEGANIAB.fFEAhABA.SGFAhACADFIB.YHAA.,1,5,-5,10
SeDaZGOFfgQJCIYKEVARHTNPUdcWLbXBM,HAAATAAAUADA.dAGALACBBCADeBHHZAEAGCEA.fCGEhAAAQDDACAHBKECAhAFAABFARDFB...cEGDhAGAWCCD.MICADEIBaGHHFGHD......hAAA......hACA...,2,-23,-1,22
LNfIATbQJBCEcKWaVFHGYXegdUDSMZPRO,TAAAQAAA.CACA.EACEKAEA..aAEAHAGBGAGAeCDBdCCASCEBhAAAZCDBRFBBLFFAhAAAfDGEAAIBBEGDcEAAhAEA...FFFBXGDDDDIBMIAA.hBFAOGACIHHA.hAGA...,1,2,-12,14
HFgDUORJCQadcNAKbPEYWMXfSGITBLeVZ,KAAAEAAA.MACA..SACAGAEBBBCAeAEHHCDADAGARBFFQDGAhAAAdBHAACCA.bFCAPDAAhAAA..XGFDhAHATEEAZEGBFHCA........hADA......hCAA...,1,-8,-21,13
LfQcCWFNBKTREAHUgPVYDeIadJGbMZSXO,HAAAUAAA.VAEAeADAdAHAGAGAZCAA.OCBELDFA.QEAAhAAACCEBFDAHKDFBEEEBACCA.hACA.gEEGhADADDIBaFHH.bGDC..MGBAfHGF..hAEANIAB......hCEA...,1,0,-17,17
eLHRTDBIdJEAgcQGZXMSCUFbVaWfYNKPO,QAAAZAAAMACAUAGAFACE....aAED..fBEAhABAKAGAeCDBHCFARDDABCCDdEHAADGAGEBAhBEACFEAVGAA.NDIA.LHFAhAAA..TFFA.IHEAhBGA.....hAGA...,1,-10,-11,1
eEafRIACHZgYdWDKbSNXGJFQVUBcTLPMO,HAAAZAAAdAEAKADC.SAFAGAGAQCAABBHALCAAMDDAEEEAhABARCEAACEA...CEHA.gDGAhAAADFGBXEBAhACAFEEHUGAATGAAeFHFaHGE......hACA......hAGA...,2,-10,-2,8
CIeFKdVgScOELRGNHDbfWJXUZPaMAQBTY,TAAACAAAFACA..dAFASACB.EAEARBGFHCBA.DDFBbAGDhAAAJECBZCCA..MDIBhAAAAAIBQEAA.hAHABECAeEEDKEEDgGFHLEHBGGBBhAEANIAB.XGFBhBGA...,1,-1,-25,24
aXbBGATZEIWgcNOMKHVUePDSFYQfLRCdJ,EAAA..gAAAOACCHAFBeADASAHBQAGARCCAdDHAhAAAaCCABCFAAAEAZEEBIGGAhBHAcDAA..MDDBhAAA.KDHB.PEABDEEB.fEEAhABA.LFGB.hCAACGEA...,2,-18,9,27
HMeRNLADKTacSQgZJdGVUIOCWPEBfYFXb,TAAAaAAA..QADAZACBGAEAUAGACAGA.EBBBBBHA.FCAHhAAAHDAARDFFADEB.KDDCSDHBhACAdDGAOEFH.fFBAhADAbEBD.eEHHLHFADGEBcGBDhBAA.....hAGA...,2,-14,2,16
UbHLFKPaMeAOZXRdBDGEcWSTQCIgfYJNV,ZAAARAAAdADAGAEA.EAGASAFA.QCEACADBICAAhABA..fBHAhAAAJBHBUEEBHFGBLEEAhABAKCCDaGAAAAFABCCDDEDB.TGDAgGDANDIAFGGBMIAAhAIA....hCAA...,1,-3,-13,10
OdKYMBZWQfcHCaIPegJENGDSUbFXVLATR,RAAAdAAAMADAZABBQADA.HAFAaAFEeAHHECGAGDCADBEBSCCBhAAAFEEALEHBhAHAACFAKDFABFGA..fEEEhABA.CEHAIGGA.PFDBhCAANIAB....hDAA...,2,-34,2,36
FVQAaEXOSKCTUGIRHJNDdYeWfBPZgMLbc,EAAASAAAKACA.CADA.GAEAHAEBDAGAeAGBBBGBZCCFLEABhAAA.FDGHAAAAaBHDTGGAhAEARCCBdDAA..YHAGhAHAfDGE.MEFB...cGFDhADA.....hAIA...,1,-13,-25,12
RCZSHATFKdEIeJBPbQaUOgVDLWcGfXYMN,TAAAdAAAEADA..eAFABACB.QAEAOBHDDCCALAHBhAAAGCEA.XCCAMDAAREGBZGAAhACAHDEBACGAKEDDIEAAhAEA.bEGBaGGHgGBA.WFHHhBGA......hBHA...,2,-9,-4,5
YcbEGNZLIOeMRVUaTACXDQJgHWFSfPdKB,DAAAQAAAHABCSAEBdADABAFA....bAGDEAGA.ZCCALCFDhAAAeBHFRECAaDHDAAIBXDBAhAFAJFGF.FEGAKGAAhAGAGEDAIGEA.......hBCA......hBDA...,1,-7,-16,9
daMDEBYWQFRfHcbXNIAZUeKTSLgVGOPCJ,eAAATAAALAEA.GBCACACBaADDEAFABBHA.QCEChAAARBFAHDDA.bDGDXDGDhAAAAAFAZGCA.SFAAhAFA.OFDB.dGGAMIAADCCB...hAIA......hBIA...,2,-7,-6,1
IVTHKPAdeUEfQaZcXYSNLJDFWBbMCROgG,eAAAEAAA.QADAZACB..XAEASAFALAHBhAAAFBHDbCCCRCEBGECA.hAAATFGAHCFBAEEBdCBCaEHDhABAcFABYFFFDGFBBEHBMGAACHHAIHBAhAFA.....hAGA...,2,-7,7,14
KVbOXWIMeBUPfDNTERFcAYJCZSLQadgGH,CAAAZAAALACAdAEAHAGBKAGAOCAB..XCCAMCCBBDDAUCFAhAAADDFB..EDABREFFAAGBSDHBhADAQGDCGFDBhAEA.VGAAIHHAeHFA.NEBA...hABA......hACA...,1,-4,-20,16
bdaKWQcGZUAeHNOMgCEJRVFYLDSXfPBTI,HAAAMAAA.EADERACAFAFALAFB.DAHBXBGABCAD..bCCBaBBHhAIA..QDGAhAAAZCEAADDBeEEBOEDD.hBAACFFA.VFCBfGHATGGA.....hCAA......hCCA...,1,-7,-18,11
VLaABRXfMQgeCNcYDFdJWUSIGOPZTHEKb,RAAAMAAAeADE..CADA.....NAHADAIBdAFAUCBAGBDAZAGBHDFBhAAAEDDEKDHBLCCD.hBAAADIBXGAAQEFDhBBA...gFBAFFHD.SFDHhBCA.IHHAhBFA..,1,-15,-17,2
cSFCRKeTPgVLEJOGWQfDNbXZdUIHYaBAM,MAAAFAAARACF.KADA..eAEE..TAGAVBEB.EBBBGCGA.hAFAQGFCDCEAbCFAdDDAhAGA.HEGBaAHFAEEBCFEA..hBAA............hCAA......hCBA...,1,-18,-23,5
WAcSdBULeHDbXQfTgGRJEMOVKaICNZYPF,dAAALAAAHADAXAGBTAEA..RAGFECAAMBIB.KCBA.aCEDCCDAZDCAhABA.FDGHACGBBDADhACAeEABQFDChACAGDGAOEDBIGGAPFABSGADDFFB.hADA......hAFA...,2,-11,0,11
NaHFAWMJTYELfKBDGgcRdCOIbXeQZSUVP,MAAATAAALAEA.BBBAGACARCDAdCGAOAEA.bBEDeDBBhAFAZCGBUGCAVFEAaDHDhAGAAAIBJCAF...EFFBDAIBhBAACFHA.IHHA.......hAAA......hACA...,2,-15,-13,2
ULXSCFPRWDTMIZQgYAVcfBKOJebHGdNEa,VAAABAAAOACA..eADEHAFAdAGAEBCBaBDDLCEA.hAAACDBAREEATDEAZFCFQGGAhAAAAAIBKCHBGEGA.hAHAXFCASCHHFDCHDGFB....hCAA......hCDA...,2,-13,-7,6
bXCBDcFKTadIOGWZRNJEPgVQSYHALefMU,eAAAMAAAUAEACADA.BAGAFAFAKBEA..dBBAGCCARCFA.EBHFVDCAhAIA..QEFAhAAAHEGBABIBLFFDhBAAXFDDDEBBaGHD.........hBDA......hBEA...,1,-20,-21,1
cGVbXEafPWSYODQIgHCTdFBMLJReAZNUK,ZAAAKAAAGACA..bADBEAEA..aAFD..fAGAhAAASAHBDAIBQCAAhABAHCABdCFDMDIBRCFAADDBcEEAhACAXEDA.PEGBOEHBCHEABHHAeFBANHBBhBFA......hBHA...,2,-10,-3,7
EWDRAdUfNTbOCcVBgHKPIJYGFZeXQLSMa,dAAAUAAA..TADACADABAFAHAFB.KAHBJAHBGCAB.eDEFhACALCDAaDGD.EDAARFAAADIBhADA...bFFAODHDhADA...gECAYHAG.ZFAF.hAFAQFEA.hAHASGGB.,1,15,-31,46
XfVUAQbaOBIWdCgYNeMERcDFPJHKTGLZS,aAAABAAA.dACACADA.....NAEA.EAFARAFA.FAHDHCFCGCCAZEFA.XCFChADAUFAA.ABBBQEFAhAFAODDH.IHFAhBAAgGEAeGCAMIAADDIB.KCBD.SHGAhAAA..hAFA...,1,-11,-19,8
eEXZJCMaHFLdPbTIVcOgNDWGKABfSQURY,SAAARAAAEADE.ZACBMAFAHAEAdBGATCFA..ICCAhAAAOAHDDCEBGCEAAAAAQEFBhAGAeCHHCECAaFHDLHAAhAHAVGCA.cFGD.NIEB.BGGC.hCAA......hCBA...,2,-8,-6,2
JMCFcDSUYfgEBGRLKHPVWbdZNaOTIeAXQ,QAAAMAAAFADD.SACAUAFA....fBBAhAIAEAFARBFAHCDB.PDAAhAAAbCFAZDDAaDGD.TFAAhADAABHACEHDDFBABFDDKFFDdGHAOEHD.eFFB..hAFA......hAIA...,1,6,-22,28
ZgaTSDJMIEGKAFRePUNWVBQXdHYOfLbCc,RAAAeAAAUADA..VADAQAFAHAGBOCCBLBHB.CCCDZDEBhAAAaDEADDIB..MEDBhABAEEEBAAAAFFHB..PEGDhAGABGFA...........hAIA......hCAA...,2,-25,-17,8
NGefdbLQMSYRBgaEUJOcZDFVXCHWPATIK,TAAAKAAAeACE.dAFALACB.MAEARBCBaAHBEAHF..OBHDhAAAZBDBFBFD.CCHAHEFAhAAAADFAGECB.QFGAhCAABFEDJHEA.DHEA........hCBA......hCEA...,1,-11,-21,10
bREQCBfKXHWeJIDMNUdLcgAVZFSYPaGTO,ZAAASAAAaACA.GACAOAEDRAEAEBHFQAGA.BCCDhABAXCEAHCFBeDEDhAGADDIBMEABdDHA.LEEAhAAAAGGAFGHD.TGGA.bFAD.....hBIA......hCAA...,2,-14,0,14
GdQIJMXeOfVTcPECSHgURABKLYZWFaNbD,LAAAZAAAaACA.DAEAdAFAQAGA.MBEBeAHB.fCCEhABATCAA.ECEBHCFAhABARCGBAEEB.KDCB.FEFHGFBBhAIAXFBCOFFDPEHBCHHA....hACA......hBFA...,2,-13,-8,5
FCAQWLBgEJcIUZfRYVKMdXeDHGSONbPTa,LAAAEAAA.JAEAIADAZBEA.RAEFKAGCdCAAeCCB.HEDBhABAGCBAOCHD..hACAbDDDaFFAABIBQDFAhAAABAHBUGGB.fFHA.MHCA.hCDASGGD.hDAA...,2,-11,-8,3
MTIRJLUQBdPgHDSAOVGfCNcZKaXWFbeYE,GAAACAAAZACA.aADAFAFA..eAFHEBHF.MAHBRCCA.LCDBBDAAdDGDhAAAHEBB.AAABfDHAhACAKEEA.bFEDTFGAhADA.UGCAQGGADIFAOEAE.hAIA......hBCA...,1,-2,-24,22
FYZSeWUcKHBbAVPIDGdMLXCJRgTfNOQaE,VAAADAAAdADA.LAFACADB.RBBB...TAFAOCFA.EDEAZCDAhAAA.eAHHUEGAHECAhAFAAAGA.GEGAMDBBJEDFhBAAfGFE.aHAASFFD.hAHA......hCAA...,1,-13,-23,10
PQNOedUVCBbLHDGfgaTcYRAFJXMWZKIES,XAAAZAAAEADE..QAFCeADAdAHACBFALAHBHCDAGDAAhAAAaCAA.TDGARDDAACEBMEHBhABAKEFDSFHHhABAOFFBBGDAfDCE.YHBG.hACA......hCHA...,1,10,-18,28
DNMSYaeUWKLIGPJQXbBOdcCVTEAZFHfRg,HAAARAAADADA.MACA.aAEEeAEA.KAHBGAGA.QCCAhAAABCCAdCEACCGAECFBAAAAZEDAfEFEhAIA.SDHHhBIAUGCALEHBIGHA....hCAA......hCCA...,1,-9,-36,27
beBNgYUSTEOcfMCLGWAXKFRdZPQHDaJIV,FAAARAAAZADBHACBDAGA.aAEA....VBFAeAGHBCCC..gDEBhAIAUEEA.ECHFODABhAAAMEBAGFBBhBAAADIBdFBA.QGGA..bGFANIBB.SFDDhABA...hBEA...,1,-4,-26,22
RCNdZaTXWEGgJFUDMBfPHeAOIKSYVbLcQ,KAAASAAA..bACBLADA.RAGFdCCAaAED..TAGAhAAAECFBGEAAFCFDMCCBhAGAfDHAHDGBACIBODEHhAIAIEEA.cFGCQGGB.NEBA.hBEA......hCAA...,1,-13,-14,1
FEVXdNIJeGCbYZgaMKHWAUROTSfLQBcDP,RAAATAAALADB.QAFADACAEAEAdAHA..JCFFeBDBGEGAhAAACBFAZDEBaBHDHDGB.ACCBSDDDhAAABCCCFEEHXFAAhABAIHBAYHBGMIDAKGHB...hAFA......hAIA...,2,-12,-2,10
UaDTPGEJIdgAbMKQHLWFZeNVSYRfcXOBC,MAAAHAAALADBZABE.eAFASAEHRCEFXBGACAGADAIBGDGAhAAAECCB.dCADACGAQDFAhAGAFFAANIEB.fEDAhBAABGADaGEA.TGGA...IHEAhCAA.KDHB..hCDA...,2,-30,10,40
GODdRaECIgUQbSYFcAJHXBeZLVWfMPTKN,HAAAeAAAZADBLADB.VAFAMAGBKCADGCEAdCCC.EAHBCCFDUEEAhAAAQDBC.bCGDhAAAFCHDACCA.BFAA.fFHAhACATGGADIAAaHFCSFBA.hAFA......hAIA...,2,-13,1,14
dXYBFLZNHbTGaUgRCcSADeIOMJWEPVfQK,eAAAMAAA.EADA..VADAQAFA.dBHABAGBZCCAHDFBhAAAGBBAaECARCGBSDEBhAIAAEHAOFCBJFHBfFGEhBAA.XGCA.....hABA......hAIA...,1,-7,-19,12
ZTWSgKEMAaXVNLQfUPeHOcIJRGBYdbFDC,aAAAXAAALADAUADAHAGB..OAFCICCARCEA.GCEAhAEAdCHADDBAZECF.TEGAhAFASEEAEGGBAAIBNBBAQFGAhAAA.eHAA.....hBAA......hCAA...,1,-3,-20,17
SRTVDCZXLQUHEINJgcWaGYdKFPAeBMObf,eAAAMAAA.OADC..bABARAGFDCCAZAEBLAHBHCDC.EBGFIEGAhAAA.JEEFgCCDhBAA.aEFAhBGAdFAAFFFBACIBSEHHCGHA.XGGChABANIEB.....hCAA...,1,-12,-17,5
YgbOaHKXJQdEWCDeZFVfUGLNAIBSRcMPT,SAAARAAAMADA...TADA..bAEAHAFBKCCAQCEChAAAEAHBDCCBeDABZDGBfDDAhAAAGGCBAAIBBEFAhABAPDGD.OEFH.aFAH.JFDBCHHA.FGHDhABA......hADA...,1,1,-16,17
DTMFAbYUQPJSBEefRLWGVOIZKCHNdXgac,UAAAQAAA.SACAEADARAFAGCBBOAEDZCGBHECC.hAAAdGAAaAGADDABMBGBACEA.hADAbCGDJFHBeCDBLGDAhAGAIDAA.CFEAXGGA...hAIA......hBAA...,1,-3,-5,2
JVPHWdTEACGUeQZgcYROBMNLXDabSfKIF,GAAAeAAAZADB....gADARAFAMCCBLCHBaAFD.SDEAhAAAKAHBFCGDPDDBhAAAHFCAdFFAAADA.QGAChABAODHDXFEAfHGFIHAAhACA......hAHA...,2,-22,1,23
NLYFfKeHRBPUMgWTdGaAJSDQICZEXVbcO,DAAAQAAAZABE.EACAXAED..bAEAOAGFLCDAhAAAFCCBKDABHDFC.RECABFAAhAFAMAIB.TGFAGDEAhADAAAIBSGAACDGD..cEGD.hAGAfGAA.hCAAeEDD.,2,-33,10,43
RKPdOTaVLgHAQCUEJZBDMSfYGcNbFWeXI,QAAAEAAAZACBBAEAMADA..SAFHGAGA..bBDBeAHBhAAARDCBdEGDaCBBLGBAhAAAHCGBACEBCDEADCFB.fFFEhAIAcFFA.FHGEXGDA...hBCA......hBGA...,1,-2,-15,13
GRVSfCBbJcOWQUZFEPTHLDKMgNXeYIdAa,RAAASAAABADB..JAFAOACD.QAEAZBFAECCAHDEAhAAALAHBKEDD.MCEBhAAA.XDFCeEHFdGFAhABAABGAGEAACGDA.bFGB.cGDA.FHCChABADIAA.....hAEA...,2,-24,-7,17
SQgPTMWBYOVDRcZNKUbJLdCfIGHeAFEaX,EAAAaAAA...QACATADA.MAFABAFBOBEARAGFZCCAKDAAbCCA.hAAAdDGD..CBHAGDFAhCAAHFCAABBBSEEGhADA..PFHDYFHBDEEBNIDB...hAIA......hBAA...,1,0,-20,20
GeRKDOFMLPXWAYBUTbNEdVQaZJCIcgSfH,BAAATAAAEACA.dAFAaACAZAGB...CBDA.IAFA.SAGHhAAAHCAARDEBOCHDhAAAMAIBLCCAXFBAAFBAhACAbDBCQGEBJDFBfDHEKHGADIBAFFHH.hBFA......hBIA...,2,-11,-7,4
QfUTNJcCZLDKYbGdeRVBMSAFEWgOPHXIa,EAAAOAAAHACA.aAEAQADA.TAFAJAHBZCCA.LCFBhAAAKBBDGCGARECBMDIBhAHAAAHAFCDH..PFGDhCAAfEFE.cFDACHEA.DBIB...hCBA......hCEA...,1,-6,-18,12
fJKOYdMRbZWAeIXgaCFScQDBGUVTHLENP,eAAAXAAACADA.FADAQAFA.GCCATAGAHEFAEBDB.hAAAfCHAOCEDdCGDhABARFAB.ZEFBAAAAaFDDDDDBBEHAhAGA...........hAFA......hAIA...,1,-13,-21,8
dMSKFTgPaQNXfHROcBDGZeCJYVIEUbWAL,dAAAMAAAFADA..TADAaAFD...QAFCXBGDHCAChACARBBBBAHBZDEAeCFA.CDEDVEFAhBAAEECFUFGB.AAHAKFDAhBAANIDB...........hBBA......hCAA...,1,-17,-19,2
ETJXOSDFCNZKBdYPUWVgHRGaeLcfIQMAb,EAAATAAA..OACCFACAZAEBdAFA.UCCAVAGBHBGB.REABeDFBhAAALCCB.fDGEhAAAMEIBAAHA.bEEDSFFDhAEADDIB.KHGABGGB....hAIA......hCAA...,1,-7,-22,15
aeOTQDXRMFSYfWUNbZLJHEIdAKGcBgCVP,GAAABAAACACA.aADA..eADHQAGARAFA.MCDASCAAhAAAfDDAUCFBZDBBHEDAhACAEDGAAAABKEHB.VFAAhAFATFDAFGED.NEIAbFFBIGGA..gGAGhACADIAA...hAGA...,1,14,-16,30
eJOHQSNWCIRVFgTBaEDGZdcPfbYAUMKLX,MAAALAAA.eADHHACCQAFASAFBCAHA.RBGFFBBHBCAAECEFhAHAZCFAdEFA..fDEEhABAAAIBXDCDOCCHhACAIFHATEGADIDA.GGEB.bFAA.hBAA......hCAA...,2,-17,5,22
eBWTGQKCEPHSgDbOZfRIYFVaUXNAcJLMd,LAAAeAAABADAGADAQAFAEAFAHBGBDAIBZCCARCAAFDFH.aEHDXDFDhAAA.ACEAMDIBhABAdFAATGCA.CGGDSHFGhABAbFAAOEEHfGGA.hACAIHBA..hAFA...,1,8,-24,32
WLKYNCQVXPfBDbOZHGAFJegIEdMURcTaS,eAAAEAAAdADARADA...aAFALAGB.KCCACBCCQBFChAAA.XDDCBCFCbDFAhAAAHDGBAAIBFEAAIGEAhAIAMEEBUFFASFCDNICB.fGGEhBIA.DCIB...hABA...,2,-24,-5,19
TCNPZIAKFWMaVdEgXOLHeBDbGYcUQRJfS,FAAAaAAA.EADA..OACDHAFAeCCADAEAGAGAUDFARDAB..SBBDhAIATGGA.CBEAZDEBhBAAAAHAMCIBdEBALEDDhBEABEEC.bEFDYHCA.....hBGA......hBIA...,1,-6,-13,7
OdcCUHPEITVQJSaYLZFgbMWDGBANfKXRe,KAAARAAAeADEdACAUAEAHAGBEBDF...TCEAQAGA.aDDAhAAAZEEA.bGAADDGAAAAAXGEAhAGACEBA.IHHAhAIASEEA.LEHBMCCB.BFGAhBEA.NIBB.....hBIA...,2,-36,12,48
aSFIQOeYLJWBPfVHbKgcGZDMECRNTXdUA,aAAAFAAAQADA..eACHLAGBBAEAfAGAhAEAHCCAbDADKDHBGCEAZEEAEGCAhADARCGBTECAdGGDAAIBSGEHhBAAOFHDJGAA.WBBD...gGFFhAGA.MAIBhBAA...,2,-14,7,21
aATKCRHGUOfPYJecQLEVINdbgBWMXSDFZ,TAAARAAAHADBGAGA.OCCBfACBJDAB.eAEELDFBhAAAEBEFICCAdFECbGAABGHAhABAMAIBDCGB.aCHHhAAAAAIBCHFAPDED.QGFA.NHAB.hAHA......hCAA...,2,-10,0,10
LPXRcdINYBKQCSUFEfZgbaOVTWHMDAeJG,eAAAGAAALAEARADAdAGA...ICCABCDDQDEAhAAASAHHECHFZCEA.aDBCTFCAhACAHEEAAAAAJEAFXFAAhAFA.NDIACGEDfEHAbFCD.OGEChADA.MIAADGGB..hAEA...,1,10,-16,26
APfEMLWVCbaTZOSBYQIXGeKRUNgcdJFDH,EAAAMAAALADA.CAHA.aACEZBCABAFA.QBGAGCFARDDBUEAAhAAA..gBBGhAFAdDHADGHBACHA.fCEAhAHA.bDFDSHAAXECCeEHBhAIA.NICB....hAEA...,2,-20,-12,8
TdeUgbKGJfBOCaRVSMLQDYHEFcAWZPINX,ZAAA..IAAATAEAeAGHUACAKAEAGCAABAGBCCCD..RDEBMAIBhABALCFA.QDDChAIAHDGDEECFAACAPCBBhBCAdGGDbGAA..OEGB.aEHDDIFAFGCA.hAEANIBB......hAGA...,1,11,-15,26
XZVUTYKGICJPFaDQRNMHLegWbBAfSdEOc,dAAAEAAA.OADAZACBUAFAKAGA.GDEA..CBDAFCBDaBEB..RDGB.HCFAhACAeCBD..bDDDAAIBSGDBhAAA.hAIAXGGATGFAIEHADCIB.MFCBhBAA......hBCA...,2,-31,-7,24
RFbQZMeGXLWAcSBNgPafTVKOHCEdDYJIU,BAAA..gAAAaACA..TAFAOADAHBCAEAGAdBDAhAAADAIBJCBFRCEFQCGChABA.eCCDGCGAhAAALFGBADEASEEBNEIA.fFAAhAFA.CGDAIHHAhAHA.FGFD,2,-13,-10,3
gVCYdXIBNUSfKWHeaEGbOZJPTDcQARFML,RAAAMAAALADB.CAFA.dAEABAHASAGA.KBBAHCEBECFAGDBAhAGAZCGBTFAAQDGAhAHAAAAAFDCH.gDDBhBAAXFGAIGDAfFGE.aGHDOHAEhAFADICA....hAHA...,2,-21,-5,16
cDdPOTUbWJagXGAfCeHBYKZRQEFSINLVM,eAAAHAAAKADCRADA.EAFASAGBLBHBMCABdCCA..OBHDhAAATCCAUEEA.bEACaCEAhAAA.GEEAACGB.BFDChACAZGFE.FGHBNIABDEHB.......hAIA......hCCA...,2,-8,-7,1
KFCEdBfDHAaGcNZPRULMITSbVgYXeOWQJ,GAAAZAAARAEALAHBMADA..TAGASCAA..bCDAgCEAhABAeCHFQEBAhAAAFEAAEEFABEHAHEEBACDAhACAaDDHcGFDUGGAIHCA.XFAChACA....hADA...,1,10,-10,20
gXFObQGTfWLNaeHZRCdcIPJVMEKBUDAYS,SAAAFAAAQADAGACA..TAFALAEA.eAHHhAAAHCCARCEBdEHAICHAhADAPFAAMDGBEGABBFGChABAAAHAXFEDbGCA.fHGF.aEEBCHHA.hAFA......hAGA...,1,0,-12,12
RJgPaLHbMWOIFKZGDdBXTQVcYCeUANfSE,SAAARAAA..gADBaACDHAEAMAIBOAFAKCDAGBFAhAAAdCGABEAAQCCChABAVEEBCEHA.ABIBEDHFLGAAhAAAbEEDFGGADGHB.........hCAA......hCHA...,1,-9,-10,1
LYHROMEfcXGDgAWUeKZTQaNVBCbJIFdPS,eAAAZAAAaACABADA.CAFA.JAFA..dAHALCCAHCCARCFF..EDHFXCFDhABAGFABAAAAKCHB.hAFAQECA.hBHAVFFAbFFA...FFBH.SHCAhAIA.MIFA...hCAA...,2,-19,-6,13
IOUAYTefQXBcVGdFMZaWLSJCNPEDbHKgR,eAAAQAAABADAGAEAdADAZAEBLAHB.CBGA.EAGAHDBAhAAARCCBOBHDADGB.TEFAhAAAXEFAFFHDaGAASFEDhBCAJGDA.DEIBKHCAgGBA.hABAIHHA..hBDA...,1,-6,-17,11
PaHSAKTGeMVbdWZIcEFLNXQOYJgCBRUfD,GAAAeAAAMAEAdADAZAEB.EAGALBDA.QCGAhAAAOBHDJDDFBAHARFEF.DCCBHCFBhAAAABEATDDA.bFDAhABAIGHAFFHB.YDBB.CHCA..hCAA......hCBA...,1,-5,-17,12
DXBWAZdCMfGUVHbcIOEReQKJYFLaTgSPN,dAAAMAAAGADAHACC...IAFARAFFeAHHQCCCKAHB.hACAFDFHaCBDTFAASCFAhADADBBBBDHAADDBZDFEfFGAhAFAbFGBEGCA.LHAA.NEEACHHA.hAHA......hBAA...,2,-18,11,29
JMPaQgLOdETFcRSWAGBKUVNeDXYCfHZbI,GAAAKAAAUACAeADA.DAHBCAEAHAFBZCDA..JCHBaAHFLEAAhAAA.EEEBTDDA.hACARDGBADIBBFHA.XGBAhADAbFDA.IHHAMHBA.....hAAA......hBHA...,1,-12,-28,16
BEIfZSUGDTHWVJFAYKcCOgQeMNbadPLXR,KAAAOAAAeACE..MAEAaAFA.dBBDLBDARBDFBAHA.EBHFZBFFGDDAhAAAHDEB...VFGBhAIAACHACDHBQGGAhBAA..PCCB.XDGA.SGDDhCAA.DGFBhCBA...,1,-10,-22,12
ZAbPSaKeJUFdOQDfRMgLWYTCNEGBIVHXc,SAAAeAAAFADDdAFAQADA.RAFALCCBTCGAEAHBGCGAhAAABCCDHDEBZDABACIBaEDDhABAKEHBOEDHMFFBgGAAhADACFBA.IHHAXGEA..hAAA......hABA...,1,11,-21,32
WCTRNMKbUfOaGXJHdQcIeBPZFYLASgDEV,DAAAEAAA.CACA.RACA..MAFAKAEA..UAGA..aBEEGCCAHBGBdDAAhAAA.QDDAhADAeCFBZEAFLDHBABIBSEGAhCAAVFEBTGEA.fGGB.hAEAOCCB...hBAA...,2,-29,7,36
gZGTHAdVPKEXNDcfCWOaMYBLbQJeUFSRI,dAAAKAAAEACEDADA..CAFA.OAEA..aAGDMAIBLBDB..hACAbBCAeBHH.SCBAhAIARCFFZDDFTGGAHDFBhBAAABHB.XFCAfEHEBFHA....hBCA......hCCA...,2,-28,-16,12
XHPRWVSJTgKOcaZYdQFbfEAMCDULIGeBN,MAAADAAALADAGACBeAFEBAHAHBBA.RCEA.SBBDhAIA.TCEAOCHDZCCFhBAAdEAAbCGBADDBCEEDUFGBXFCChAEAWFFD...gFGB.aGEDhAFA.FHAC....hAHA...,1,3,-19,22
FQJGTIeAKPEdfgWUBcbRVZNSOLYaCXDMH,EAAAdAAA....fADAUADABAFARAEFZABBOAGD.LBCDhAAAaAGADBHB.HDDB.QDGBhAIAGCFAeDDBhBAAABIBKFGDgFGH.WFFD...hCAA......hCBA...,2,-24,-12,12
AHKNEJIVMTCgdGQPeBLbFOcYaDZWXfUSR,HAAAEAAA.VAEAMADA.CAGA.GCAB.eAHHbBCA.ODEC.hAAAaDHDZCBA.fBHAhAIAREABAACAKECAJFFBTDFAhBCAdGDABHADLEBBFHGE.DDIB.XFFAhBDA.SGCHhBEA...,1,13,-14,27
TfagHIXEYbJKBPOAcNReQLWFdSUGCVDZM,RAAAeAAALADBdAEAGAGADAFAZAFE..MBDB..aCCBHDFBECFA.hAAAbEBABCHAAAAA.QEEAhABASEHHCEGA.TGAAhAGA.IHHAYEHB....hCAA......hDAA...,2,-29,-1,28
TNIcaFgWAbVYUBPGRdKCEeHXMOJQfSDLZ,VAAABAAARACA.dAFAEADEHBGB..MAFAQCAADBGAZCDA...hAAATCDAICHAaAHFFEFBhAAAACEAUEFB.GGCBhCAAeEHF...........hACA......hADA...,2,-19,-19,0
CWVRGTeIOSLdaNZBDQcbAJPYHMFKUXgfE,JAAAHAAA.MACAKADC.UAGA..XAFAEBDACCCD.RCCA.GCEAhAAAeBHH.SDGBhBGAdCFAZEEAQGAAADIBFEDHfFHAhBIA..WEHH.....hCAA......hDAA...,2,-26,-14,12
DgYUGbMadCVZefKNBJQEWSXATHFLcPOIR,HAAALAAAOACARADFDAFAUAGAGBFA..aBDEdCAAZCCAeBHBKDGABEEDhAAAECCB..XEEDhABAAFGATGBAFEHH.IFCAhACA..gFGAMIAACHHA.fGDBhBGA.NIDB.hBIA...,2,-25,-1,24
IHYACgbVSJeRGNFTdEDOUZBLKPMQXacWf,CAAAVAAA..eACARADFGAFAFAFDdAHA.DCAAZDAA.LAHBKCDA.hAAAMEEBaDAA...fFAAhAAAHDECADHASEHHhACATFFAEHBABFFD...PHBAhADA......hBHA...,2,-31,-3,28
bcFIKAHGVZdWDREfPSCMOLTBXNeJYgUaQ,HAAAZAAAdAEARADFEAFE..SAGAMAIBLCFBBCAAeCCB.hAAAJCFBgCAAhACA.aCHHbCGDFDDHAACAGEBAhABADFHBCHAA.OEEH.TGGA..hAGA......hAHA...,1,-5,-17,12
SEfeLaIDXdJGTURVPbKQFHBOMNWcACZgY,ZAAASAAAEADELAFBDADA.dAHAGAEBRCAA.VBCBKDEDHDGBhABAMCFB....NCHAAAAACECAfFFEhACA.hAHAeHBAaEEHXGDC.UGGB..hAIA......hCAA...,1,-8,-19,11
YgUNHGCRPFKZEdLfTabXMJDeQcVBWSOAI,..IAAAUAAAHADARACA.KAGCdAFALCDA.aBHDbAGDMDABhADAeCAB.QCCBhACABEEAOEGBAAIB.NEIA.GEEAhADA.FEHBEFCBfGHAXFAD.DFDBhCBAWHCA....hAFA...,1,2,-22,24
ELIYVCBKQSZJTFcbNMdDfaWGHeXOgPURA,EAAALAAA.VAEAKACAZAEB.FAGD..bCAAdCCA.aBHDHCFChABA.eCEDODFCgEAAhACAREABAEEB.CAHBQEGBhAEATFFA.MICADFIB.fGGEhCAA..WHFG.hCBA...,2,-26,-1,25
ZAbWPMUeSJOYcKXEIHGaFQdVfLTDCNgRB,...bAAAMAAA.eACAOAEAKAFAEBBBHBDBGCEAaAHD.dAHALCABhAAACCGD.RCFFACCBPDCDhBAASDHH.hCAAcFBBFDHDQGFATGGADFFBBHHBWHBAhABA......hACA...,1,-7,-9,2
CFLNfMSeHdcAGOZTWKDPIUQbBJVREXgYa,ZAAATAAADACAUAFA..QACCBAHA.RAEFEAGE.XCFDhAAAaBDDLDFA.hAEAMCCBHDDB.ACHAODHDhAIAKEED.bGFCgFBACHDA.fFGAhABA.eFHHhBFA.dHDB.,2,-37,6,43
TJQBNHGAOUgZbLfEWeCcKYMXDSaIRFPdV,OAAAZAAALADB.EAFAeADA.KAGAMAIBSBBDRCAB.hABAdCCATCFAQCFAhAEAHEEAABHBbECACEHBXFAAhACAaDHDFGFD..........hAFA......hCAA...,2,-14,-14,0
HYPSUEKQVZNbDAaRJOBfdTCLMGWXcegFI,RAAABAAAdADALAFAGACA..XAEAeCCBFCEDHBGB.SAHBhAAAECGAQEFAhAAAZCAFbCEDAAGAaDHD.OGCAhABATFGACGHA.MEAB.gGEB.hCAA......hCGA...,2,-13,4,17
NLDRIYKJVeEMGFWQSfaACXUZBcHPgdObT,XAAAZAAAHAEAdAHA.OCABTADALDDARAFFKBHB..eCDBhAAAEDHBGEAAQDAAhABAaECCACCBBDFD.gEGAhADAbFDADFHB.IHAA.YFFFhAFAMIDA.....hABA...,1,-1,-5,4
MOVeBYEUWGTXfRFAaQLHCbKgNDdcSJPZI,aAAAHAAA.KADCDADAdAGA..SAEAZBEBMAIB.eAGHECABGDCAhAAATBCA.REGB..ACCAQGEAhACAbCED..hCEAgEGB.cGGC.IHDAhAIA.BCHA.hDCAYBBF.,2,-18,-1,17
agHTPNdKMBJXIFeLCfOAZGUWQEDVbRcYS,GAAAQAAAEADADAGARACA..SAFBHBFATCDAdAHAMCEBhAAAXDFAeCFBLFBAhAAAODAAADHAZFFAUFFBWHBAhACA............hADA......hBAA...,1,-5,-14,9
NAVZPQdBEMUKcOJGFCbXHgfYDWSTeLRaI,ZAAAdAAAEADAMACA.KAFAOAFC.GCABCAHBHBDB....fCFAhACADCCBTCGARCGFaECDhADAACFAQEFChABABEEDUFGBFFHD..........hCAA......hCBA...,2,-28,-13,15
JcOaBLPZgVDQNREUFGAYCTSfWHIMdebXK,TAAASAAA.HACBdACAeAEAKAEAOAGDaAHDLCEBZDEADAIBREAAhAAAECGB.GEAAADIBCFDA.hABAfDDAMFFBXGAAhAEABEGDgFGA.NIDB.FGGA.hAAA......hAEA...,1,-3,-7,4
IaWKYZceGCHMBXOVJSLPNATdgbDRfUQFE,dAAADAAARABAQADA.EAFAaAEA.KAHBZABBGBDBHBGBMDDBhAIAODDBSEEAhBAA.LFHBADHAbEFAFFEHhAHAIGGA.cGCCeHEA....hBIA......hCDA...,1,-7,-24,17
QJMTRWbNdPAGEBSKYXHfLgZcaCFUDOeVI,EAAAKAAAHACBLADAZAEACAHBDAHB...eBCBQCACMAIBRCEA..hAAA.bCEDdEAA.ACEAGEEBhAAASCGA.fEGBhACAaGHBFHEA.OEDH.IFAAhAFA.TGGA.hAEA...,2,-14,-4,10
VbJMANDOcUWKgBXHIZGQPFYfCSEdaTeRL,OAAAUAAAKADABADAHAFBGAEA.QAGAFAHFCCDA.EBBBaDAAhADA..RDCBLDHBhAGA.VGDAbDEAADIBDFFAhBAA..gFAAIHHA.ZFDA.fFHAhAFA...hBIA...,1,-10,-20,10
EZDVJAaSPKIbcdfNBFGMCXRUegYWHTLOQ,aAAAKAAA....IADAdADABAFA.GAGAMAFA.RCDAUEGB.hAAA.eBDA.gBGAhACAHDBBLFEBhAFAECCBZDFADBBBAEEBSFFA.bGFAfGHEhAIACHBA...hBHA...,1,-18,-27,9
eZFSVOaDdRTKfCXPYINLbQUJgBWGAEHMc,HAAAeAAAZADBSACEOAFC.dAFA.RBGFKCCAXCED..IECAhAAALCCDbEEBQCGAhAAA.gFFAhABABAHBADIBEFBBMDBBFFDDaGFDTGCACHHA.hBFA......hCAA...,2,-10,-5,5
WYZOfAPLIMVHNdEeQaJKCDUBcFgXRbSTG,LAAAMAAAHACCEAEAeAFE..aAGDCBBDBBFAFCAARCEB...bCDCGDCAhABAZCGB.AAIBIEAAhACAdEEAQGGA.hAEADDIBgEGA.SCGAhBGA.YHEA.hAIA...,1,-5,-18,13
LTDVcMBJUZPfWOeQEAgNHbYRKCFdXIaGS,HAAARAAAFADA.dADA.aAFAGAFALBFADAIB.MCABBCCA.ZDEF..hAAAfCCEeDHBAAHB.hABAbDFACECA...SEDHhAAA.TFFAcGFDPHDC.hCAAQGBCNEEA.hCCA...,1,9,-35,44
DcfWOgBaRTFCAUNKdXbLeQVSJMPYZEGHI,KAAAdAAALADAeACE.QBGASAFBMCCAZAGBHBCA.hACADBIBfDDAhAEAODEBaEHBREFATFAAAFDB.hAAAXFDDbFFD........hAFA......hAHA...,1,-15,-17,2
WUdJCcbfHeXYDTQNLgVGKZaSAEFRBMIPO,RAAAMAAAOADAdAEA..CAGA.....bAGDHBBB.eAHHDAIBTBDAhAAALDEB.GGABhAGAaCCHEDFBBDGD.IFHAhBAAPEEBUGBAfGFAQGGAhABA......hBGA...,2,-15,-15,0
aFdDbcfTYGZPeOBVNJXEHIUSRWKAMgLQC,MAAALAAA.aADDdAEA.DAGA..bAEDTBBA.ZBFBeAGBhABABBHAVCAA.XDGAhACAHDBCSDGHhBAAREEBAAHAQGCAFFDDfFFEPHFC.OFHDhBBA.NIDB....hBIA...,2,-13,-6,7
KTAfYQLIbORXPJcVgMWCBGEaHeUFNDdSZ,QAAALAAAOADDRACA..XAFBJAFA..VCAAMAIBhAAABBFDECDAHCGBFCGDdEEAhABAZDAAACIB.fEEAhADA.bGDAgGFACHBA.eFDDDFIB.hBHA......hCAA...,1,3,-21,24
dcfDFXLGYMOgaBKJSATWbECHVRZPNIQUe,TAAAEAAAHACA.RAFFZCCA..IADAeAHHdEAADAFALECBhAAAGBDBMAIBaEECKEGCABGAbCAChAAACFHA....NIDB.QDEBhACA.fDHEFHAC.OFGBhCCABGGD....hEBA...,2,-19,7,26
AIBYXMfEFWSZQeCGPKgadNTRbLcJVUODH,BAAAMAAAFADDZACAeAEEGAFA..KBHBdBBARCCA.LAHB.VDDBhAFADCGBHDAB.AAHAXDGDhAAAEEHBQFBChBAACEEA.aFGH.NIEB.TGGA....hADA......hCAA...,2,-31,0,31
QCGEKIJfbNVDASdgTPUaBcMHRWXLZFYOe,dAAATAAAaADA..BAGAHACB.RAEALAHBZBDAOAHDeCAB.GCFAhAAAECBFKDDAfEDAhACA.bFGDDDHBAAEASFFDhCHAgFDAPEBDMEIB.FFHD.hDCACGAD....NIEB..hDEA...,2,-22,15,37
BSQMCZKIXNGJEeUbHAFYLgWaORDcPVfdT,LAAAaAAA.RADFDAFAVADA..dBGATBGAQCAA.ZDDAhABAXBBCGEGAEFCAhACAeDAAHGCCAAGAFDEA.gEEGhADA.ODHD.fGHEhAIAMAIBCCFC.KHEA..hBAA...,1,2,-18,20
cHMOWQPdYSgANLEIBZaXVCbGReTJfUKFD,EAAAZAAAaACA..CACARADFeAEH..JAFAKAGA.DCCBHCEB.MCCBhAAAQCFAdCGB.SDDDhABAADDBLEHBXEEDhAGA.bGFAfFGAFHDCOCHFPHDChAIA....hCAA...,2,-27,-9,18
VZNXFKPWGfJQIDYaLUcEHgObABCMeRSTd,MAAARAAAdADAZAEBFADD..KAFAGAGA.QEEADAIBLBBBECCB.hAAAHCFA.ODDBhAFAAAIBeDHHTEGA.XFEChAHAfGBAIHCAaGDB....hBAA......hCAA...,2,-25,-11,14
PCFKQOEcVfLRDSZdagUBWeNIYHGAMTXJb,MAAATAAA..XACAJACA..CAFBKAHBEAFA....fAHAhAFARCCAZCFBdDHAaEEBBBBDhBAA.eCDA.IDGAhCAAHFCBACCAFGGAQEECOHEC.LFHBhCDASHAG...hCIA...,2,-21,-13,8
YWVSfGDJcOCQNUAIeBKLgdREZbFXPTHaM,eAAALAAARADAZAGBXADDHCCA..aCHDMAFA...VBGBhABAGEAADCAA.OEEBhAAAQDDAACFAKFGAEGFBbFBBFEGHhACA...YFHB....hBFA......hBGA...,1,-8,-17,9
ZLJGOXRbBFUNQWcMPCdeYSTKagfAIEDVH,EAAAHAAAZACBGADA.RAFAFCAHQAEA.MAHBdCHAeCCBhAAATDEAaDGBAAIB.DEFBLCBDhAAAXFAABDHAUGGAhACAcECACFDA.KFGA.fGBA.hADAIHHA.OGDEhBCANIAB,2,-20,-5,15
DBPAYJMTHCSUOFVgfXcGeWRKdQZNabIEL,MAAAHAAASACEFADD..VAFAXAEDeBBB.RAGBdCCAZCFAaDDBhAFAEDFBLEHBhAAA.BEDAAEEATEFAhAIAOFFBfFHAGGAB.KHEA....hBAA......hBCA...,2,-21,5,26
TAYJQIcRbCeLBdMfEVNSHXPZWKOgDUaGF,QAAARAAAeADELAGBdADAEAFA..SBDHHBFCZDBAODDAhAAADAIBGCEAAAIB.IEHAhAAAbEGBMFAA.fFFAhAFAXGCAKDCDaGHD.TGFA...hBCA......hBDA...,1,-3,-9,6
UJAWdQMKYRSGCPIDOeXaTVfBHgLbZFNcE,dAAAMAAARADAGAGA..CADADAFAeCAAaAGE..TCEABBBAHBDChBAALEAAZCGBFDDBEEEBAAIBhACAQFECSDHHhADA.OEGHfGHAbGAA.....hAEA......hAGA...,1,-1,-26,25
TWLXOPASEFZUgDadHCfBVeQKRINJMYcGb,EAAAZAAADACAHACABAEAeAEE.RCCA...JAGBMAIBGCDA..bCFBhAAALDHBODHBAEEAFFCBhABAaFFHdFFA..fHABhAHAKCCD.IHHANIAB....hCAAYHFG..hAGA...,1,5,-35,40
UEFfXedCPWDAVITYQagBLcbRJKHSMZNGO,TAAAaAAALADA.RAGF.HACBZBBAGCEAEAEAXAGA.eCABhAAAdEAACDHADCFAADDBVGFAhAEAQDEA.BDGAhACA.bFGDSGDBMDIBOEAH.fEDEhAEA.PHAChAHA..,1,19,-20,39
XdDNcaJfUETKAVBeCYFIMLOWPGSZHgQRb,eAAAFAAAMADALAEA.OAHDGAGAHBCARBCAdDBADCGB.aDEBfDEAhAIAUFAA.EEGBhBAAAAAACDHD...IFFAhAFASEDD.ZGBA.QGGBhBDA......hBFA...,2,-19,-12,7
OaPGLRHEcebUZBMJWAFIdgDTCKSYVXQNf,dAAATAAASADA..XACBQAGAOAECGCABhACAHCCCECFBeAHHZDGBMEABhADAAAGAFDFDDDIBKECAVGCAhAEAaEGDRFCA............hAGA......hBAA...,1,-4,-9,5
YLQSBUEXKZTbNFPVHMDJfcaAReOIgdGCW,RAAAeAAAOADAdAEAGAGA..CAGALCCAQBCABBDAEDEAZEFEhAAA..bCFDFGAA.hAAAHGECMAIBDIAAfDHEhABAAHIB.gFEG.SHCAhCAA.KHGA.hABA...,2,-18,-11,7
EYWDULGZObfJaecQBMNTVIRSPCKHAFXgd,XAAAEAAADADA.GADAZADE..OAGDJAFA.eBCDQCFAhAAAMAIB.TDAARCEBCECDHEGBhAAAAADBdDHAUGDALFEBhABA.aFBD.BGGA.NDDA.....hAIA......hBFA...,1,-4,-14,10
ScVbLHTdMJIFNACOEgDUGQWeYKBXPaRZf,EAAADAAAGABB.eAEEBACA.aADDRCCAZCFBSAFA.VCEAhAAAHEGB.dEECMAIBhAFAFFCBAAHAOCCB.QEGAhAGAKHDA.fEEE.LHCAhCAA.IHHAhCBACDHB,1,-23,-25,2
SYXdLCgeMFZUVbAEDKJNGWaQPRHcOBTIf,EAAAKAAAGACA.QAEAHACABAFB.TBGASAGAhAAAdCCDLDFAeCABZCEEbEAAhAAAACIBDEABJEEF.aEFAPHAAhAEARFFBOEHD.fHABCGGAMFIB...hAHA......hAIA...,2,-7,1,8
JOfZXMAaILSgVWePFETDbNKcGQYUCHdBR,aAAALAAA.SADHVADA.eAFAEAGEDBBBKBHB.GCCAhADAQCAACCFAHCGBRCDAODFEhABAZFEAACCB..WFHHhAIATFAA.bFFANICB.cGCB...dHFBhACA......hAFA...,2,-8,-4,4
YFKaLbfZdAIMcJgXSCHGPUeENBOQRTWDV,MAAAJAAA...SACAHADBGAGAeAEHECCBBAGARDAB.TCFAhAGADDFBFEGH.LGAAhADAZCCFAAIB..IEHAhBAAXGDDCCHBUGFAOFHDWBBD....hCAA......hDAA...,2,-24,-8,16
UAgQbOPHLfcZMBDdeNJaVIGRXYFEKTWCS,QAAAOAAAHADALADAZAGBMBBBdAHAeCCBaCBEGCEA.hAFARDGFFEAAECEATEEAhAGA.SCHHhBAAACGBbECDfFAEDFHBNIBB.IHHAXGEA..hBIA......hCAA...,1,2,-2,4
eLcDJNOMHTQfIAdYZRXBGPWKCEgbaVFSU,ZAAARAAAGADAKADC.EAFAaAFD..FAHDUCAALDAA..DAHBOCFChAAAHCDAQDGAhABAACCBdEFABEHACFAAVFBAeHEAhABAJEFF...MIAA...fHGFhACA....hAIA...,2,-16,-13,3
aUDICQOVSNfHXRMdTEgPeJcZBFbYKAWLG,GAAAaAAA.DADAQADAOAEE.SAFAHCDARCGFdFCAEBBBeEFBhAAAZCEEFDABKFHBAAHALEFAhADA.CDCAfGAAhAGAMIBA.TGCA.PGEABDCD.hACAWHEA....hAIA...,1,-13,-14,1
dWQCgNcIRFXLGSMJAKUfYEOBTVeDHZaPb,KAAAUAAAEACEBADA..eAEEHAEBZBCEaAGAdAHA..QBGChADACCFA..gDDBhAAAIDCAREDALDHBhCAAGGEBMDIBAEGAOFGH......hCBA......hDAA...,2,-22,-13,9
gFIHcbDVCEeOBGKJPYUMTLdAXZRNfaQSW,RAAAaAAAQADC..SACHFAFAHCDCDAIBEAEAeAGFGCGAhAAAKBHBJEEFUDDA.MBBBhAEAdGCAACCBZEGB.fFCEhAIAgGGAIGEA....hBAA......hCAA...,1,-8,-22,14
DUPBVbETXcdaHCSFAQZeIgNfWMGKOYJRL,eAAA..gAAA..fADAGADAOAFAhAAARAEFLAGBDBGBBBHAECCBTEDAhAAAdDAAHDEBFDHDACCBZDGBhABAIGCAMDDBKFBBUGFAbGEC....hADA......hBDA...,2,-12,-1,11
MNTOgeGDLICQXaZEdHKUBYAFJWRcbPSVf,FAAARAAA....bADBSACH.MAEATAFA.eAHHhAAAGBDALCCBQBFAhAIAZEEAHGDABBHAADGBcGGDhABAfDHAOHACDEGBXFBAhBAA.EFEF.dGHA..hBFA...,2,-23,4,27
OQYDLCBaRXVUcHgWAeMKEfNIFTZSGJbdP,eAAAEAAA...IAEAZACBGAEA.dAGBQAGALCBDaBGDhAAARBCBXCEBUEEBHFGBhBCAAAAAMDGBKDHBNEDATGAAhAGA.SDHB.bEGD.OEEBhBIA.DIGA...hBEA...,1,4,-6,10
eVYOScCBDJAGFPaITEKRfXUgNLWMHQdbZ,GAAAaAAA.EADARACFUAEALAGBHAGDdCDAeBBDOBFB.CDHADAIBhAAAACIBFDEA...TEGAhAIAXEFD.gGBAhACAMEEBQGGB.....hADA......hBAA...,2,-21,-9,12
caSZYdfUGPHgDNFXMKBOTCWVJIeERLbAQ,aAAAZAAAdAEAGACAHAGBDAEAFCAA.KDADBAGA.CBEB.JDDA..EBHFREBALEHBhABAABBB..hACAQDFCSFFAhADAfEDAUGBB.gFGA.hAGAMIAA.OGCEhAIA.WHFA.,2,-22,-8,14
BbLIMQaYAJHZSgGCVFOWEfdeRTDPKUXNc,HAAAZAAAGAEAFADAEAGAeAGB.RCAA.DBIBKDGDUCAB...XCFAhAAABAHBbEAALDDBhACAMCIB.aEHDAACASEEDhABACECAOFED.dGGATGAA...cGGChAGA....hCDA...,2,-14,-11,3
eJEQAfRPONTIMcbGVLXCaUDKBdSZFgHYW,RAAAOAAA..TAEAMAEAGBBBLAGBaAGEKCCA.dDAAZCEEHDEAhAAAeCHHEECBABEA..fEFAhBAAIFGAbGCAhABACFHABGCAFGHD...gGGG.YFEFhBBA...hADA...,2,-9,-7,2
ZSHWcNCRKDeYTJGFgfadIMPBLQbAVXUOE,XAAAEAAAHACA....NAEB.RADAeAGH.TDAAGBEBFCDHaCCChAAAdDFDMDFBLFCAhAAAABHAODGDZGAASEHHhABACGEDDDIB.gGGGfGGEBHFD.hCAA......hCBA...,1,9,-20,29
dgULYbEDKXTCQBOAJFaHSGePVcNIZWfMR,aAAAHAAAGACAeACEVAGB..IAEAZCCAMDGBRAFFdAHALECBhAAAEDFBKDHBTFAA.hBAABEEDABBBSEDHhCAA.cFFCfEHAYHDADGIBCHEA.hDAA......hDBA...,2,-16,3,19
dcIRUCHDOLZFbYTfQVEPSNKJaBAXGgMeW,GAAAeAAAdAEARADAHAGBLAGBZCDAFDHD..bBAA..TEEAhAAAQDECEEAB.SCHHhAAAKFCAaGACAADAMIAAhACAIEBADGGA.fFGA.PGBAhABABHHA.WFHH...hAGA...,1,-1,-5,4
GSfcVCAIUPJKLEeRQOMFdYDaWNTBHbgZX,UAAAKAAAEACERADA...MAEAdAGADAIB..aAGE..TCEAHBDCZCGBhAAAGDAASCCDhCAA.fDDBhCBACDCAAADAIDHALFFAeEEBQGGAhBAAFGDBNIEB.BEGD...hDAA...,2,-18,-7,11
KcJGADEfIZeMTRbVUdNOFQCLYHXWBPSga,EAAAZAAAeACERACA.UAFAdAFAFAHBLBHBHCCCBCHA..SCCAhABAaDABKDFA.GDEAhAIAAEIBDFFA.MFIB..hCAATGGA.........hCBA......hCCA...,2,-27,-24,3
WKCHAVcQGUBTFXNLDPYafdeJMRIbOSZEg,QAAAGAAABADAFACELAFADAFA.aCDAeAHF.RBDAOCHDhAAAECGAKDDAHEFA.AAABUGAAhACATDEA.XFGChBGAPGCCdGHAMDDBSDADgGDA.hADACHHA......hAGA...,2,-7,-7,0
XdgYVBfKEebPLFWNZaDcROISAJMTUHCGQ,MAAAHAAAGADAdAEA.VAFAKAGAEBBA..eCABLCDAFCCHZCFEhAAAaCGDREFASFAAhACAACIB.TGEAQEBAhAGA.XEECBHGA.bFGDNIAB.DEIB.hADA......hAFA...,2,-15,10,25
SgQHdYINBGLcWAJKaEeTUZOMDFXRPbCfV,aAAAEAAAUADAZACB..MAFAFAFE..RCBB.CBBD...SAHHhAAAHBEAdBHAIEBAGDDALDGBhBCAADEBeDFFTEGAhBAAXGCD..bGBAfGFEQGGBBHHAhBDA.....hBEA...,2,-11,-10,1
dLJFbCIBSNTeYfWOAKGQMXaUPcDVHgERZ,GAAAMAAAUAEADADAHAEC.RCDAZCGBdAHALBBBFDCH.CBDCBDDAhBAATFEA..eDFAhBGAfGHAADFAKEHBQFFChBHAaHAA.........hAAA......hACA...,1,-19,-28,9
IALMaTUbCdegSNQYKFfDPOVcJXZHGBRWE,aAAATAAA..CADAdAFAeACE...SAFBQCCAFAHBDAHBhADAOBDBJCHB.HCEAhAAAREDAEFBBACCBMCIB.bEEAhCAAgFGAKGEA.fGDEcGGD.hDAA......hDBA...,2,-26,-9,17
BXeCLNdUGbFDEIKVZMAQWSJYOTagPfcHR,QAAASAAAOACDaACE....fAFAHAEARCDFeAHHhAAALAHBdDGDbEABEBGFhAAAKFEAZCDFAAGA.JDAATGCAhABAgDFGBFHACHFAGFABIHHAMEIB.hAEA......hCAA...,1,7,-4,11
cebgDHaVKRGYEWMAIfQPUJBOdTNCZFLXS,QAAAUAAAOADAdADA.CAFA.ZAGBLAHB..SBDBhBAAeBGFDCFBHDBAaCBERDEBEDHFhBCAADDAfEGAhAAABBFATGGAXFAC.cFGD...hBIA......hCIA...,1,-6,-26,20
geBDSTNXJKAWZfHUIROFcLYaEbQMVPCGd,ZAAAHAAARAEAFBHDLADB.EAFAMACACAHAdCADBCCDDCFA...SCEAhABATDEA..XCGAhAAAAAHAUECAOEFAhCAAaEGDQFAA..PFFBeFHHKGFDhACAfHGF..hCBA...,2,-37,7,44
BCbXVePILcUaJdHWERGZSYFNgODQAKMTf,MAAATAAABADA..XACBeAEHLAGBaAED.HBBBRAGBZCCAhAAAFDEDOCGHAAIBCDHA.bEBAhAGAIFGA.UGBAhBAAdFFDEGHFSFHHNIABDEBA.QGEChBBA.....hAIA...,2,-5,-4,1
AGeRdcYfFOCJTUNMbLHKVZWBaEIPQSDgX,RAAAdAAA....fADBCADATAFAUCCAMAFA..HBECZCFABAHBhACAECCBQDFBhAAADDAAACHA.eDHHFEFAOFAAhADAbEDDKGGDaHBC..SFFD.XGGBhAFA...hABA...,1,-5,-28,23
CLHQEbWNFKTVeDGIBfYPAaRJdOZXMSUcg,RAAAdAAAZADBMADAUAGA..CAGAHBDA.EBHF..bBEDFCBD.KDDDeCCDhAAAGEFABDAA..hABA.fDGBhADAADIBaFBBXFDDSFFA.LGBANIABDFIB.hACAIHHA..hBGA...,2,-25,-7,18
AcfNWMGBRHgXKeVTDIPdZLFaEUbSCOYJQ,...fAAAMAAARACAHAFBKADA.eAHBTAGADBBBdCCD.ZDEEaBCChAAAEEHFSCAHhACA.OCDEQFAAhAFAAAFAcCGDWFDAGEEABGHA.XGCChADA.IGHA.hAIA...,2,-12,-3,9
ZCbVQfOFPWIHMeBcLAJKYXETUNgDSGdRa,KAAAEAAAUADADACAGADB..RAFAZCBACAHB.QCGAFCCA..hAAAICGAHDEBeFHBhAGALDFAAGEB.XEEChAAANIABSGGD..bFGD.OGAAhAGA.MICA...hAIA...,2,-21,-13,8
ACUNcHeMKGEXDdQSgFLZITWabBfPVOYJR,CAAAUAAAHACAeADAGAFADAHB.dBHA..QCDAFCAAZDDB..TEAAhAAAaBFDBCHA.VDAAhADAOEHB.RFEFAAEAMEGBhAEAEHAASGHHLEHBWFFD...hACA......hAHA...,1,-3,-16,13
GBAJLPQTaSWVNcCOMZfRdYbUXeHKIFDEg,LAAATAAA.aADDSACB..VAFACAEAZAFBRCAAdDEAUCCBhAAAHDGBFAHDDDHBEFAAGGDBhABAADIB..QEAChAEANIAB.MEFBfFCAbFCDeEGD.hACA......hAFA...,2,-5,-5,0
GTQJHNefKIPaXbDAOFUgWMcZdVLCESYRB,FAAAUAAAMADAdADALAFA..EAGARCDAGCGATBCAHBEBhBAAeDBB.KBHB..aEFHbDGDhBEAAAGA...OEEBhCAAgGCAZGFASGCBBGHA....hCBA......hCGA...,1,-8,-18,10
dOQHcPTDEXZVNaAbIFfgLCeKYSWMBGUJR,FAAALAAAeACHKAEASADH.MAFAGAGA.RCEBdEAAHBEBhABA.TBGAEDDBZFGBaCAAhACAAAIB.IEGACECDBGDA.hAEAODDB.QGBCDFGBXGAAbFFA.hBGA......hBIA...,2,-15,-9,6
NHdEOPBXRKSYCUaFDbfQGJMAWTecgZILV,eAAAZAAALADBHADAEAGEBAFARCCB.KAHBCCEAFCGADCAA....QCFAhABAGEFAAAAATFAAhAFA..gEEBhACAIEHAdFECXFAASGDDaDHDbFCD.hAIAfGHA.hCAA...,1,-6,-19,13
eaBXOVKNUAYDJcETfGPLHFWQCZbSIRgdM,DAAAEAAAGACAHABCQAECZAEA.SAGBRCEAdEEDeCBBaBHDOCHDhAAA.KFAAACCBJCFBhAIATFGALDDB.hAFACEHAbGFAMHAABFGDNIAB.......hAGA......hAHA...,2,-10,-3,7
cKaLGbHePNgSMVBOAWXJFQUZdICERTYDf,XAAAQAAAdADAEACA..RAFA.DAFAKCEAGBDAHCGB.eAHF.hAAA.gDBAhABAMBGBOCHDAAFAFEEBZFBATGFAhAIAfDCE.aFFA......hAAA......hBFA...,1,-12,-13,1
gRHGMCaUYVKXFNWOEcLSfPAdBTDeJQZbI,dAAATAAAeADA.ZABB..IADAHAGBGCEAaAED.VEAAFAGAOBFDhAAAEDHFLGDAhAEAfCAEAAIBDFIB.bCCD.hBAARDGF.CDDCKHGA..XEED.WFHHhACA.SHCAhCCA.BCHB.,1,8,-1,9
QKdVIGEUPWYSAeOaTgCDMRbJcZNHfXLFB,eAAAaAAA.CADA.RACF...JAFAZAEB.HAGBLCCAQDFDdCGAGECAhAAAEEAAUFGB.PECDhAEASEEB.hAIAACIBTGFAMEEBcGBCfEHABHHD..hABA......hAIA...,2,-30,5,35
CUZIgWecORHBAXMFdJGTSVNQKYaDLEfPb,MAAAdAAAGADA.SAFAQADAKBHBaAFELDAAEBBB.hAGA.bCEAZABB.gDFAhAFAeDCFREEAHGCAACGBFEHDhAGATGGA.NAIA.fFDA.CGGD.hAIA......hBAA...,1,9,-16,25
XCZOUAJRDLMSdFQgNaEYKcPGTBbefWVIH,RAAAMAAAdADAFAFA..QADA.aAFEEBFBKBBAGCGA.hAGATDDAeAHHfCFAhBAA.IDDAhBBAHFDCCCCD.ZEFBAAAADAIBSDHHNIDB..hCAA......hDAA...,1,-20,-25,5
cJObCGBPNMZTFHfXAeUIDKaYEQLSgdWRV,eAAADAAAKACAEADALAEBdAGA..RBEBJCCBCAGAGCCA..BCHAhAAAMAIBZEDEHCFBAAIBaEGDQFFBhAGA.SBBDhBAAgGBBWEHHOFHD..PHCAhCAA....hCCA...,1,-19,-20,1
VMcbYaOCJQUARPgHBXEIGFSfeLTZWdDKN,RAAAHAAAEADE.GADA.SAFAeAFEZBDEdCHAKBHBMCAB..hAAAbDEBaCCHCEGD.QCFDhACAAAAABFHAFGGHTEFAhADADCCB.cFAB.OEHD....hAFA......hAGA...,2,-26,2,28
XARIeTaKHYOVBMNDcJdPFSUWQgLZfCEbG,RAAAeAAAKADCHAFAOADCBCCADAFA...dCEASAHHQCGAZCCAhAAAEEDBGDFA.ACEAaDHFhABAMFFA.JGEEFGCA.hAAA..WHBGLHAACHGA.IHHAhABA......hAHA...,2,-15,-15,0
TEQVNXUHDPbGAdMSefFWJKOcIgYLRZaCB,dAAAeAAAFADAKADA..OAFD..gAFBRCAAZBGBBCEDECCA.hACA.QEEChAHA..XCEDhAAADCIB.GDGAAFHAMIAAfEDE.cGDChABAIGGAaAHFCFFD.hAIA...,2,-36,-19,17
JaGOXWVbYdcgAZIDBLTRNfMHQUPEFSKCe,ZAAABAAARAEA.MACAHCAAUAGAEBHF..KCEDeBCAGCFA..XCBChAAAVFAA..dFHAACFBLDEAhBCA.TFFAhBDANIAB.QGBASFFDaDHD..hBGA......hBIA...,1,-6,-22,16
gBKTEDGSWNVYPLQZFRdXMAUHJafOecbIC,HAAAaAAA.eACE..bACDCAFBKAHB.ECCAGAEA.SAGAhAEAVCEALEEAZCGBREBAdGAAhAGAADIBUGGAOBBBIHAAhAAATGDADHCANDIA........hAHA......hCAA...,2,-15,5,20
URDOIbQSJdVKFYHEAgfaeCBNWXZPcTLGM,aAAAeAAABADA..XADAZAEB.TAGAGAGA.RCCBOBBBhADAbCCB..QCFDhAAAdEFAFEHDHGBAACIBCEAAPEEBhABAMIDA.DEIBIHHASFHD.KGAAhAEA.EGFF.NIAB...hAGA...,2,-10,-6,4
aNKHXLcUBCRQeOPEJSIdAbfWVTFgZDYMG,...bAAAfAAA..TAEAZADAMAEAaAGAHBGBLBHBhAAABCAARCAAeCEBECCBSCEDhAAAACHBFEGHDEEBGGDBhACAXEAACFCA.QEFD.OFDBhABA.IHHAhACA...,1,-3,-10,7
bLVeXdFRgKZTBfYAUWDNIGQEcCaOPSHJM,DAAAGAAAEACA.aADA..SAEAHAFBbCDD.eAGH..dBHARCCAZDFEhAFATEGABBBDAAABUGEAhACAIFCAQEBAhAHAOEEHMFHB.LHDAFGHD...hAIA......hBCA...,2,-13,6,19
VfLecKSXAIdPGEUgHWRCNBbMJTOYaDQFZ,dAAAEAAAHACARADABAGBMAEA..OAHDDAIBZBEELCCAeCCBSDGAhAAAAADAGCFA.UFEAhBGACEED....bFGDYHFGhCAA.aGDBFHDA......hACA......hBAA...,2,-29,-2,27
UbdYCJGBNMIFVWcaOQTfEASXLPRZKeHDg,LAAARAAAeADEHAGBDAEAUBEAdCCA..CBEDGDFAMAHB.FEDDVCAAhABA..aEHD.TGAAhAAAAAIBXDGA.ZECBhACAKHEA....bFEABHHA..NICB..hABA......hAGA...,2,-18,-8,10
XTYQfgVCKZEISOBAPNdHRcGaDbeWJMULF,dAAAHAAARADAGAGAaACAeAEH..MCCBLAGBFDAB.TDCAQDDAhACAfDHACDFAEEHF.hADAOEFBAAIB.cGBAhAAAbFCDUGGBXGGA..gGAAhAEAKFDB.....hAIA...,1,7,-4,11
IADgJFUcMERYCOXSNbHGVPLZTdWKQaBfe,DAAAFAAAMADARABA..OAEA..SAFAHBDCGBGALBDBhAIAdDDAQFEAhAIAaBGEeCCFADFAUGGAEDGAXEFChBAANIBB.bFCD.....PFHDhCAA.....hBAA...,2,-16,-8,8
LFgGYCaUHKNWAZdScJbXDeMQfTOBPRVIE,dAAASAAAJADA.DADAeAGH..MAGBQCBAOAHBRBCAECHFhACALDBAGDDAaCFHhAGAHEFA.KFBAAAIBbFGBfFDBhAAA.BDHA.IGHA.hBAA......hBCA...,2,-19,-14,5
ZRODCUGSKWeNQBHcFdgVMTbJYXAILaPfE,aAAAEAAARACA..CADAGAEAKAFC..eAHFQAGAHCCCdCFAMBBBhADATDAA..bCCDXEFAhAAAACCBLDGBfGGEhADAZGAADEIBSFFDNCIA.BHHAhAGA......hBAA...,2,-12,-4,8
aLRCYFKEUVgQAXefZDcWHPMSNTJBGdObI,eAAAZAAADACAHADA.MAFATAEAGBGAdAGA.OCCB.aDEBRCCAFCHDhABAEFCF.UEEA..hAIAQFEAAFHA.hBIAfGGBcGDCSGFANIBB..hCAA......hCBA...,1,7,-30,37
RBVYMWXGbSEQCdFPeafJHUNKgTZOLADcI,DAAARAAABADBMADAGAEA..EAGAdAGBeBBAaBGD.HBEA.KCHBZCCFhAAAABBA.VEGB..XDDChBAAQGECFDGHfFFEhBIA.JFHB.....hABA......hCAA...,1,-14,-23,9
WVCEXbFADTdYcSIBGZHQPLgeNRKaOMUfJ,dAAASAAAGADAHAFALADAeCBFRAGFOCCAMCHBUFAB.JDFBhACACDDDEDFB..bFDDAAAATEAAhAEA.IEHAhAFAQGGA.NDDAKHAAaFFCfGDAhAIA.....hADA...,1,2,-12,14
DgCYGEARbQIMSdBJZWXUeOHFKNaLcfTPV,RAAAQAAAMADA.dADAZAEEUAFAHCCAKAHBaAHDLDBA..hAAATDFADDFACDHAEEFBAAAAbFCAhCAA..BFBA.XFGDhBCAeDHHFGGH.fHDBgGED.hCCA......hCFA...,1,-9,-17,8
AOfFaSDEWRKJIVYLZdMCbTcXUGNBHPQge,FAAAaAAA.EADARACF..KAEC..VAFAZAGBdCEA..MCCACDHA.TDAAhADAUFFABEDD.HGBAhBAAQDDA.hBBAACIBSDFADFIB.IFGA.hBGAbGDC.....hBIA...,1,-16,-30,14
CEcSHGafNQDPVWbeZgLKYJBUIATRXFdMO,RAAAdAAAMADAEADAHAFA.GCABaAFE.QCFBDAIB.PDHDhACAbBDDZCFA.LCCDhAAAKECABEEBACGAFEFDCFGDfHABhADA..WEGH.....hAHA......hAIA...,2,-24,-8,16
cOURDAgKJSZNWGePFMLIQdbEVaBHTCfYX,KAAAZAAAGAEAeACEFAFAMAHB.LCABdCCAEBHF.BADBHCFBTEDAhABACDBC...XCCChACAODHDRECAAAGBSCHHhAIANIAB.IFGAQGGCaFHDfGDEhBIA..hDAA...,1,-13,-18,5
cYOTQDIgaNKVAfLUPSdGHCJERXBFMWebZ,LAAASAAAHADBEADA.RAFAFCAA.eCFAZAFBOAHD.TCCAhAAAQEEADDABaDFEhABAKDDDABFB.fDHAhABA.dFAAGECBXGFAMEIB.bDAD.hACAIGGANIAB.PHBAhADA.,1,5,-16,21
SHIFCWTOQefMANZPDRcYdabVJEKXLBGgU,ZAAARAAAdADAaACA..JAFAEAFA..LCCAGBGASCCAhABAHCFBCCHA.TDEAeEEBAAAADAIBhAFA...bFCBXFBAhAIABFGDIHHAOEHDfGGEhBFA......hCAA...,1,-5,-23,18
gOMGLSYdTURKCFEJVHZDeAcXWBbPINfaQ,XAAABAAA..bACA..IADA.aAEDQAGAhAAA.MCAAGAGAhAAALDAAdDCAREDFFFGAECFFHDGBhACAeGAEAAIBPEDDfGGESFFDhADA.TGAA.CHHA.hAEA...,1,-11,-14,3
FQUMVCbEDYOHWANdTKBfeXLRIPZcaSGgJ,dAAATAAABADA.eAEHRACFZAEB...aAGDGAGA.FCBDMAIBhAAACDDDDDABHDEC.ACABfEAAhACALDFBIFHAhACASECB.QFFBbGAA.EGBBhAEAOFEHKHDA...hBGA...,2,-24,-6,18
fCLAQNaFGgZUOXDMPcdBYKWIHbSVJTeRE,aAAAGAAAZACB.OADADAFA.MAHBdBEAKAHBHCDA...SCHHhAAATCGA.EDCBLECAhBAAAAIBQEFCFEGHXGBAhBBABBFAIGHA.....hBGA......hCAA...,2,-32,-4,28
BRfVYdXTcIGHFbOAWKSUgNeJaMLQEZCPD,SAAAUAAAeADA.MADAEAGA..ZBFEDAHBRCBA...VBCAdDGA..hAAATEAAGBFAHECBhADAbEEDAAIBKEEB..gEGHhABAaEHDCGGD.fFBA...hAEA......hBAA...,2,-14,-7,7
WbgeYGFKOTJAdMEfZIaSXcBULRVPQHDCN,EAAAZAAAaACA..XACABAFARAGF...QAFAHCCCCDFA.bCCAhAAAeCHHGDAAOFAAhABAAAIBdDGAMFFBSEEDhADAUGGA.PFHDDIAA.gGEA.hAFAKHBA.....hAIA...,1,11,-17,28
NObIGcLTKUPZDMegAYdEXaVRSWJQfCBFH,EAAAaAAA.RACA...SACHQAFCBAEAHCCCOAFDGCGALAHBhAEATDAAKEFDZDDAeBBDhBAAAAHAdGDAXGGAhAAAVFDAfGHA.FHBA.....hADA......hBIA...,1,-1,-6,5
SaNCJUZcARHTdFOQVBDeEWGXMbIPfYKgL,HAAAdAAAQADADACAEAEAGAGAMAGB....IAHAfCCAhAAAKCBALCHBhACAaCFHCECAZEEARGBATDEAOFHDeDABhADA.bFBD.gFGGSGGDJEDFAAIB.hBGABHEA....hBAA...,1,5,-2,7
fOZAPMJbDQTYWCFLgVXRBSdHcIEGKaUNe,MAAADAAAQACA..TADACAEALAGBXAFBRCEBdEHAHBBBhAIA.EBHBaBBHeCFBhBAAZGBAAAIBbDGDFDDHBDEDSFGDhBAAIHHA........hBBA......hBIA...,1,-13,-18,5
XNbYMdDaUQVAfEOHILgcSFeBRPJKCWGZT,EAAAHAAALADASACEeAGHRAEFKAGCGCBAZCCF...TDGAhAAAbCFD.dDDADBIBaEAHQGGAhAAAAAIBOFDEgGFAhAEABDHDCHCA.........hCAA......hCHA...,1,6,-16,22
bYQBTCMgfDeUWaKFISZdOANXJHGRPcLVE,XAAAHAAARADFLAFB.EAHBbACDQCABCAEA.MCHBhAAADAGAeBEAUEEAaDDHFBHDZDEBhAAAADIB.GEAA.hACAcGEDBFCDfFHAKEHBSHGANIAB.hADA......hAIA...,2,-5,-3,2
RceJBaKEgPVNHdTXIUQCZOYfFbGLMWDSA,RAAAeAAABADBEADA....VAFAHAFAdCCATCCA.UCFBZCDBOCHDhAAAFECHGEEBMDGBhABASGHB.hAFAAAAAaHAAKFEBPHFCNIDB.IHDA.hAHA......hAIA...,2,-23,-2,21
SEfgOaKPMQNDVFYLUIXGBHWZJbAcReTCd,RAAAeAAAdADA.EADAOAFAKAFA...MBFBQCCADBGB.FBHDLCHBhAAAXCEAHDDBhABAZEFAAAAATGEACFCA.fCCEhBIAaGGB..PHAA...hCAA......hDAA...,2,-20,-14,6
JQBWKeZLaXHVFCbYIUcRPdNTGgOEfSMAD,QAAAKAAAeACEZAFBaACEHBCA..CAFA...bBGDIAHAhAAA.RCDAdCGAGEDAEDAAMCIBhADAAAIBBFAALECAhAFAFFFAYFHBPFGB.......hAAA......hAFA...,1,-3,-15,12
FGPZdBbDTaSYMJKQcCeUEWROgNHfIVLAX,GAAAdAAADADA.aADAMAGBKAGA....QCDAeAHBEBDARCAAOCFChAAAHCEB...fDCEhACALEHBACHBFEFDBEDDhACAbEGD.SFGF..cGAAhAGA......hAIA...,2,-19,-17,2
QaOUYLcVABfREPMGFWZKISDgJTdCHXNeb,RAAAEAAAGADAZACB.KAFADAFA...JAHBdAHAHBEBeCCB.QCFDhAAAaCBB.ODABhABALECBADIBBEFAMDIBFFGDhADASEEA.TGGAXFAD.hAAA......hBCA...,1,-7,-26,19
ZYSMEOCRgKWBFLaQbUVJTeNdPGHIcXfAD,ZAAAMAAAEADERACA..KAFCFAFA.LCAB.QCCBbBEA.hAIAUCFATDDAdDHAHFDAhABAXDFDAAIBDGHBOBBBhBAA.CDHABFDD.aFGE.....hACA......hCIA...,1,-13,-20,7
QcVabWfOdXKYCGBUZJLPFHeATRNIMEgSD,RAAAMAAAEADE.DAEA..QAFC.aAHDbAEA.OBBBdCCAKDFAhAAAGCDAZEEALHAAhABAHCFAAAIBTFFAIHHAhAHASDBH.WEHBfFDEhCAACFCABHFD......hCEA...,2,-13,-10,3
LWIYJfbUMVOBEKFaNCdQSHXPeAcRZGDTg,RAAAGAAADADALAGB..IADA.fAFAhAAAbBDDMAIBBBFAEAHBFCDBaCCBdCGAhACAHEFAeDFDZFBATFAAhAFA.gFGHYHEG.UGDA..hAIA......hBAA...,2,-12,-1,11
DZHCAKNSbTOJUBXLQWfEFVgaIRdYGPeMc,SAAATAAA.OACDBACBLAEA.QCCAhAAAEAEAFAGDaBHDRCEAGEFAhAFAeCDHMCFBZFCBAAIBKDGDNEIA.bEABhAAAXGAB..fEHAIHEA.hAGAdGGD.....hCAA...,2,-7,-5,2
KdYcOGfSLADTPUaWgFQMRBIHZJCVeNEbX,TAAAaAAA..FADARACFHAEBZAFB..CAHA.eAGBEBBB.KCAD.dDEDOBDBhBAAGEAALCHBhCAAAAHADCIBUFFAQEDAhCFAMFIBBHEDIGGA.JHDA....hDAA......hDBA...,1,-1,-20,19
WBSZGHdeNJfROcXaAPQKITDYUCMLgFVEb,QAAATAAA.DADACACBLAEAFAFD.EBHFBAHAGCCAHBDBhAAAeCFBfCGAhAHAREGFXFAAABDBKDHB.IFEAhBCAMEFB...bGFASGHH.hCAANIAB......hCIA...,2,-27,1,28
AJbLMTBcEHYRSZNPXeIdgCVWfGDOQUaFK,LAAAMAAABADAHADBRAEF.ZAFA..XAGBeCABdCGA.CCCDVEEBhABAGBBA.QCGBhBAAaDHDAAGA.bEDAEGDBSEHHhBBA.IHFAfGHADEDA.hBIA......hCAA...,1,-7,-19,12
JWUBFcRgSMDVKeTQaYEdGCHLNAPObfZIX,OAAAZAAAJADA.BADA.RAEF.MAHB.KCAAeAGH.QCCChAGAECEAGDEBHDFCLECBhABAAAIBbFFA...XFFAhACAWEED.FGABSBBDDBIBaGHD.CHHDNICB.hAGA......hAIA...,1,-6,-17,11
gXTOPMdQCESVKLDcAFWbaIJfGZRNUHeYB,FAAAaAAA...JADAZACB.RAEAHCECeAGHBBCA..TECAMAIBdCEAhAGAEDHFKBBDLDDDhBAAAAHA..bEEDGEFAhCAAUGGAXFACOEHFCHDA.DIBA.....hCBA......hDAA...,2,-22,3,25
NefAEGSVQKTUCZLIXBbFJWHaPYOcMgRDd,EAAAGAAA.QADATACAZAEBLAGBBAGAFBHDHDCA.aCHDhAAAOCCBMDABREFBdEAAeFBBhACAACGBKEEACFDA..IHHAhADAbECD..PFGD.....hAIA......hBAA...,2,-19,6,25
MEOZNHGYKRIUPdBbgACcQfVFDSWXLaTeJ,QAAAFAAADADA.SACALAGBeBCAEAFAZBEEHCEB.GDBAhAIARDAAIDFAdEHAbGFChBAAAAIBCCHA...fEEEhAAAXGCD.aEGD.MEIB.OFABhADA......hAFA...,2,-14,-7,7
VQKHXFSgBWJTfEYLAZPODIMUeaCcNbdGR,ZAAADAAAMADAeACECAFB......bAEARAGFQCCBHBBA.hAIASCEHBCEATDFAhBAAEDGBACIBOBHD.hABAaDBCdFFAGGCBKHGA.FFGE.....hAIA......hCAA...,2,-24,-8,16
TAWJUZOgDGXcPeEKFaYSRQMNIVHbLdCfB,UAAAZAAADACAGADA..XAEAeAFAEBHFFAHB..aCFDRCCAMCIBhABA..IDAAhADAHDFBdEECBDHAADHBOFAAhAFAgDBHKGHB.QFDA.bFGBhAFACHGD.TGAA..hAGA...,1,-13,-15,2
RgYKDHUZBVcfPQMCdIeGOXFSWJLENAbaT,aAAARAAAKADCHACBZAFB.BAEA....VCCBfAGA.MAIBhAEAdBHAeEFAGCEAFFBBhAAASBBDLGEAAEFAhABAbCGD.TGAADFIB.PEDBCBEAOHCCXGGAhAGA....hBAA...,1,-7,-17,10
ATdeJgCUHWFEOIZBMSXRKfDGPabNLYcVQ,eAAACAAAHACAEADAZAFBBAFA..MAIBRAGFDCCAaCAALDDA..hAAAVDDBACFBdEHAUEAAOFFBhABAXDGD.GGEBhAAANIAB...YHBA...hAIA......hCAA...,2,-28,-2,26
LeRbcdEXYWUIGgHPFMDQOAaZSBKTNCVJf,ZAAAKAAACACBJADA..LAEARAGF..dCAAEBHF..XCCAhABAUCCAGCFAHDEBMCIBhACAQFAAADGB.aDHDTFCAhAGA..fFCFeEHD.cFDDhAAA...IGHAhAFAFGGH,1,-17,-37,20
CYMfJNUBWVHSIeEXOQPdKcTLFADGRabZg,RAAAZAAACADB.MACA..JAFABAFA.HAGBeBEFEBEB..QCFAhAAAdDDATEGAACCAaDDH.hABA.bFED..fEHAhABANCCA.VFEBXGGA.KGDD.hAIA......hCAA...,2,-33,-4,29
MOJDaYBSNKIGeFQUHgTEPdCfRVLXcAZWb,ZAAAMAAADACABADAKAEA.GAEA..eAGHQAGAHCCCECHFdBBAhAGAREFB.LDDB.hABAADHAbDFDaFCASFHBhAGA.NIAB.FEHF.......hAIA......hBIA...,2,-22,-16,6
ZATHIVJeCfacUPDgMSQFBRGKdWYONbLEX,HAAAVAAA.eACE.aAFAUADA.DAGAMAIBFBFA.RBEAdCCA.ODFChAAALDDAZEEAAFIBTEGAhAAACGGD...fFDAhBIAPHDC.QGGB.KCHB.hCAAWFFD....hCAA...,1,-3,-32,29
RUMIfceOHJZFQNVXGbTWBCYSAEdLPgDKa,EAAAdAAALADADADA.RAGFUCCAMAGB....fAHAhAAAeCFBHEAAZBCAQFEChACA.NCIA.GDBAhAHAbEGD.TDDA.CDGAABDA.KEHB.aFFB.IGGAhBFA...hAEA...,2,-13,-9,4
LPdEgcSCaGJWfeQRFDYBbXUZIKMTAONVH,OAAAHAAAdADA.EAFASADAGBGAJCAFeAFH.RBGF.DAIBBAHBhAEAUDDAZBBAKFADADDBLEEBhBAA..gFCGhAAAaDHDQGGAbGFAMIEA....hACA......hAFA...,2,-13,-10,3
DPEGFSUNTMWVLJdIRZHOcCYfebAXgaQBK,aAAAQAAABADA.DADAEAFAGAEB.SBDDTBGAMBBBhADALCEBdCCAZCDBHCGBhAAACDGD.eFGBAAIBKEHBFGDAUFAAhAFAWHAA..IFFA....hBAA......hCAA...,2,-22,-3,19
dDGUfVSeHgYOMBWNQFAcCIZETXKRbLPJa,CAAAEAAAKACARACA..LAFB..aAEAGCDAUBFB.SAHBhAAAHCAAOCEHMBHBBAHBhAAAQDAAACCAZEGB.bFCDhADAdGDAfEHAeDFH.gFFDhCAAWFHH......hCBA...,2,-21,-3,18
HDGFTdIAaEZUCPSYVcbXJfOMBLgQWReKN,EAAAZAAACADB..SACA..VAFAbAED.JCAA..MAHBhAAALCEBQCCAhADARDGBKFAA.HEFAGGDBdGAAACIBhAGA.aFEH.YHEG.fGCAhAIABEDC.....hABA...,1,13,-33,46
LMYRTFEPHeXDcQdSgBUfNZWVCKbIAJOaG,aAAAGAAALADARADAEAGE.HAGB.DBBBdCDDBCCAUCGAZCEFCEADKEEAAAEA.hAIA.MDEBFFGD.eDGBhBAAQGDA..hAAAfGGE.NDIA.WFHH...hBIA......hCAA...,1,-19,-20,1
AeKXCUEHIbGRaPgcOVJZMBFYSfWdTNLDQ,eAAACAAAHACAGADARAFF.aAFA....gCAAOAHDZBFFMAIBhAAAFCCHSDBDhAAAdDDATDGALECDhACAADFBXEGAEFABIGGA.PHDCcFEB.hABABFHA.fGGEhAEA.,1,0,-14,14
ZEHIGcXgbPaFKJOeNVCYDWMSRfLUAdQBT,dAAATAAAHADA.GAGA..XACBbABD.aAEDKCEAeAGBhAAACDADDDIBMAIB.RCFBLDDBhAHAAAFAZEEAEGEAIHHAhADAgEBA.FEHDNIAB.YFEB.fGGEhBEA..hCAA...,1,-7,-8,1
aUOfKBMLHVNRPDgCSXZFTGWIedQcAbEYJ,EAAAaAAA.UADAKADALAFBHAFA..RCBBDCHBSAHBZDDBGDFAhAAAeBBBdHABABHB..JDABBFHAhAHA.MIDAVDDB.hAIA..gDGACHHA.TGGA.hBCAIHDA..hADA...,1,-4,-26,22
JTDdGRXBWbLENaVQcMUFHIPOeACgKfSYZ,KAAASAAAZACBDAFA.RACFBAEBLBEA..EAGA..aBHDQCEAhAAAMCAB.HCGDhABAODEBABIBfECAhAGA.TFFAGDFAWEEDbFBBNEIA...hCAA......hCBA...,2,-23,-19,4
RCHNIKQfBWDXFdZLScOYbEUeaAVMPJGTg,MAAAGAAARACA.HADAKAFC.QAGCBAHA.XCDAZCCALCFBhBAAOCHDECHBeDADABBB.hCAAPDCBJECB.TEFAhAAACEHD.fGDAFGGASEED..hCEA......hCIA...,2,-26,14,40
XBMEKFLdZScITNeJYGORPVHgQaAWbCUfD,CAAADAAABACAEACA.LAEAZAEB..SAGA..TCAAhAAAeBBBGCFARCCFHCFAaAHDhACAABEBbDCDUEFB.MEEBhAFAdDHAIGHAJFCFOFHDPHAA..hAHAgGADfEEEhBAA...,1,-4,-18,14
LXEfIMZbJecOdRQWSCKHAFGBUDYTgVaNP,GAAADAAA..TACAaADALAGB.EBFFMAEAZCDFeCHHhAAAdBFARCDBQDGAhAIACEBA.HFCAAAIBBFGDgFFBhBAANDDAXGECfBBEIHHA..hACA......hBAA...,2,-15,-13,2
HaFCVYKWAEBPeJcDXTNLMGOSQRZfbUdgI,EAAAeAAADADA..TADAMAGB.GAFA.QCCCRBCAZBGBUEDAhAAAdBHAHDBBaDFHCEHAKEHBAAAABFAAhAFAJHAA..XFFDhAHALHAA.fGGA.IHEAhAHA....hAIA...,2,-16,-12,4
YSHbTAKcGXdOJMWVEDLIFBgaRCQNPUfZe,GAAAdAAAMADAEADALAHBBAFARAGF..QCDAUBDAeBGFHDFBhAAAACCAKEEAOCHD.VFDBhACAFEHBaFCB.CGGD.fDCEhADA.SGHB..hAIA......hBAA...,1,-1,-31,30
DcVgdYJQbFRWeLUSMEOBHaNKPfCGZAIXT,TAAADAAA..VACAdACAQAEA.RAGBLDDAhAAAMAFAEBBBHBFAaDHDKEAACDDAABHAXFDAhAEA.gGFHhAIAbDFAeFDAOFHBBCED.fHDBhBAA.....hBIA...,1,-7,-18,11
WfJgcNFLGOUZHPTVaSdREebDKQYCXMBAI,..IAAAfAAA..JACA..gADAFAFAGCBAZAFBhAAAHDDBTCAAaAHDRDGBEAHFhACAeFGDbDDC.KGCAQEABhADA.XDGDACBB.cFCDhAEA.OFFB..hBCA...,2,-14,-3,11
MLAGaUFXHgeBTQPWcZIRNCDbVJSdYOKEf,aAAAXAAAHACBeAEABADA...QBGA..cAEDhAAARCEBDBBBbEAASAGHhABAdEHAKGDAEGFEMAIBAAEA.GDAAhADA.FCDH.TDFAWHFANIABCEHAVFDAhAFA......hCAA...,1,11,-18,29
KJPRZfCFgVeWbILacAGOHYTNUdEXDSMBQ,HAAATAAAdADA.EAFASACBBAHA.QAEAKCADRCDAZCGBFFAAhAAAeAHB...bCCCaCCHhACAACHBGDEBOEFH.UFFBhAAAMDIBfEAA.CECAgGBAhAEAIHGAcGCB.hAIA...,2,-8,-1,7
RHIGYbWfEACNMQJdcZKPBaLSVFeTXUgDO,MAAAdAAAZABBBADALAEAFAFA.eAHHUCBAOCEBHCFAGDDAhAIA..bCFDEFBBAAFAQFCChBAAKFGAaGFC.TGGAhBDADIBA...IHEA...hBAA......hBBA...,2,-22,-5,17
ZdLAGcUBTFHSINOECaefJDKQWPgYMbRVX,GAAABAAAHACASADAOAEA.EAGAeAHFDBIBKCDAQCAAhAAA..gCFBhAAAbCDARECAZEGBACIBTEEA.hACAFDCHCGFC.aDAH.fEHA.PGAAhACAMFIB.dGGD...hCAA...,1,6,-7,13
AKUWgBcZILFbRfJPQCSGVEdOTYeNXaHDM,KAAAUAAABACBZADALAGBRADF..JAFAQCDAGCEA.EDCBhAEAdCGB..OCHDhAFAeCCB.aEFDHDGB.AGGB.hAAAgFDFIHHA.fFHE.hAIACHHD......hCAA...,2,-30,-10,20
XUaEACMZHFgQBYLKefdcbTGDJONPRWVSI,ZAAAHAAAQAEALADBeAFAdAHA.bBFAGCAA.OCCEhABARDEASCAAXDEAEEHFhAAAAACAMDHBBFAAfFDAhACATGBADDIBPFFBIGFACHHA.gGAAhAFA.KHDA..hAGA...,1,1,0,1
QXCERONfgadJTKLZWDPbHGeFcVYAIBMSU,MAAAQAAA.EACARACAOAFA..fAEAdBGDTCDAhBAAZAFBDBBBHCGBGDFAhCAAeCDBFDHFcFCAACCBSFCAhCFACAHAaFFBKGGA........hAAA......hCAA...,2,-15,-8,7
McHIABCYaZTUXNKLdSPDJOgWEbRFVfeQG,CAAAZAAAUACAKADCdAGA..DAFAOBED..EAHFRCAA.FBEA..eBHHhABAGDDAHDFBACBBBCHAhAAAaECA...TFGAhBCALGBA.SFHHPHEC...hCAA......hDAA...,2,-40,-15,25
LBJOEaPIdWYTeMcNZDVAFSCKHbgGQfRXU,CAAAHAAAGACARADFLAFBBAEA.EAHB.aCACdAGA.TCAA.eBHHhAAAMCHBZDFFADDBKEEAQEABhACAXFCCOEDDhAEAIGGA.WFHHYFFFDIAA.SGBHhAIAfGEA..hAAA...,1,-4,-21,17
XcPgMDTFULBafHIWZVCdRNOEKSbJYAeQG,eAAAGAAA..XADAPADA..MAHBTAGALCDABCCAHCEChAAAZDFEdECAREAAEDHFbFGB.hAAAAEAAQEEChABADAIB.aFHDfGBE.WEEDCGADNIABSGGDhAEA..hAGA...,1,-3,-4,1
cTVUFMXaQWLgDbZBSEeOIKYfdAJNCPGHR,CAAAHAAARACA.TAEAFAFA.MAHB..aAHDLCAA.bCFDZCAAhAAAECEBeCEB.KCGDdEAAhAAAADIB.PFHDGEGAcGADhACAXFCA..WEEDBGFDOHEEhADA......hAEA...,2,-27,6,33
PYNWCDgcQIFAMLaGZEKRXUOBfVdHJSebT,aAAAEAAARACA..OACDBAFBdAHAHAEA.eAHH..bCCATDEAhAEA..PCGBNBBADDIBQECChAGAADAAGECAZFFAhAAAXEGDfHFBSGCACEHAIHBAhADAFGFHKHAA....hAHA...,1,0,-4,4
VBGHbJXQZDKfLNUWTARdFgESacOeMYCPI,RAAAdAAAEADEaADA..eAFEMAGB..CBFA...IAHAGCCAHCFChAAAJBDB.ZEFAKCBBLGEAhABAUDFBACHA..SEEDhACA.OEHD...PFCBhBAA.BGFA..hBCA...,1,-13,-30,17
GEDSOMWagXFQfNTJZRUVHIAdeYBbLKCcP,eAAABAAALACACADA.GAFAEAFAOAHDaAHF.FCCAQCCAhAAA.TDAAhADARCEFHDGBADFBdDHAbFAAKGEADFFBMHBAhAEA.XGFDfHBB.NIEB..hBHA......hCAA...,2,-13,-8,5
CIYVfcSGXbZReUABWHaKTQFJDMgLOdENP,HAAAaAAA.TAEAQADADACALAGBEAFACAHA...ICCAhAAAfBBEGDEAZCEERDABhADAAAIBKDHBMCIBdECAPEFBhBAAcGCDSDDDeHFABGGCFGCA.OHEEhCAA.....hCAA...,2,-2,11,13
CLDUZWHMVBfIaSRbFJEGcdKXNAeOQYPTg,eAAAQAAA..TADALADAZAFBHCCBMAHBBCDAaAHDRDGBFEFHhAAAECFBdEAAKFAAACCBOCHDhAAA..PHBAhABADDCBVEEBSGHHJHFEXGCC...hAFA......hBHA...,1,-4,-6,2
YgMVRCLOZeEWdXUPNTHKIJGSBFfcbQAaD,aAAADAAAMADA..RACFLAEBeAFA.EAGAdBBAUCGATCEAHECAhAGAKBHBGFEBFDCD..hBAA..bDGDABBBYHFGhBIACEEDZGCA..........hCAA......hCEA...,1,-10,-22,12
aXTENHeARSgdMKWbPFCVDGJZQfYBLcIOU,RAAAdAAAMADAKADA......bABDCAGAGBDAZAFB.QCFChAAABAHALCEDOAHDaCGDhADAEDCBHFAAACCA.SDHHhAFAgEGAFFGHDFBB.fGHAhABA.IHEA.hBAA...,1,-10,-20,10
WfeUXRHKIMCaFZDNScdTYgVAPbQGLBJEO,QAAAGAAALADAEACA.OAGDeAEARBFAHCDAMCDBaCHDZDGBSDCDhAAAdEEA.TEFAhACAgFAAAAEABFEDhAIAfGHAKFHBCHHDDIBA.NIAB......hBAA......hBCA...,1,0,-3,3
ELRgDbYAUGICJSKXeTcafVFQPMBWNHOdZ,GAAACAAAKACA.eADA.aAGDFAEA.MAHBBCDAHCAAZCFAREAA.DAIBAAIBUCEAhAAA..SEEAhAAATEGA.fEHEhACAQGDAPGBC.....hACA......hCAA...,1,-14,-35,21
AVbBOgJXINaHdSTQLcZfUEGWeDMKFYCRP,BAAAOAAAJACA..XADA..aAFAHAGBdBGD.TCCAhAEALCBAZDFAEECBeCEHMBBBhAGAFDGARFFAAAIB..bEEC.hAAAIGBASGEDQGGA.cGDDhBAA....hBGA...,2,-34,-2,32
KVbaJNIZOeARTSXQEYdCBDULHFGWgPfcM,RAAATAAAQADC.dAFADACAHBGBGADB..PCCBMAIBbCCBhAAAaAHF...ICGAhAGAeDFBAAAAEEDFBEEALFHBhCAAFEGAfFGE.KHAA...hDAA......hDBA...,1,-2,-12,10
OGeFNXdEJVbDIafMSYPLgQUHTCZRWKcBA,eAAAXAAAEADA...JADADAGA..aAGAMBFA.SCCAhAAALCDAQDBChAAAHCEBZCGBRGCAKGGAABHBGDGAhABANIEB.bEEB...fFCA..hBDA......hCAA...,1,-10,-18,8
VDGLgHJMfaZcWICOUeKRBTNPAYbXSEQdF,XAAAEAAAdADA.DADAGAFA.HCBAMAGBZDGB...IAHAhAAAOAHBeBCHRDEBTFAAhAFAAAAAbBDDFGHDLEGBhAIA.fFBA.aFCD.CFFA..hBCA......hBDA...,2,-14,-7,7
VRFCeKMIcNEaZAQOdPJTYfbXWBHgSLDGU,dAAATAAA..bABDBACB.HADBLADAGAGARAGFeCEBMCCBIAFAhAAAEDGBAAEA.QDDBhAIAOEEHPFCBhAIAfEGE.XGDASFHHDDIBFGGHhBIAKGFB.....hBAA...,2,-15,8,23
WXMAVKgbNQdUEIGDHPSYCFTZaeJBRcfOL,KAAA..bAAAdACAEAEAGAEA.HAGDSAGAFDDBZEABeCHHhAAARCAAOCEALFFAMCIBAAAAhACA.VDEBQGDChAEADDHBCEAD..aEDHBHHAfGGA.WHAAhAEA.....hAGA...,2,-7,-1,6
TaMQVZIEBWGRPSFfXCDdYUHNAOJbKgLce,OAAAKAAALACB.eAEAaADDMAFAZBEEBCHARBEF..FBBHCDEAdEAAhAAAHBGB.ABIB..bEECTEFAhAEA..QGBAhBAAEFHF.GGEBfGDADDDB.NIEB.hAFA......hAIA...,1,-1,-28,27
dSRMeaFIXObHEZNUGLKVTPQWfYJABCgcD,CAAADAAARACA.eABA.FAEDOAFA.HBECEAGAZCCAGCAALCGBhAGATDDAQGDAhBAA..fCHAhAAAABIBBEEDdGGAaEGC.bFDCNDIA.KGHB.....hCAA......hCBA...,1,-5,-19,14
fVDOdUgBcRALYEXMSaHTPeWZINGFQKCJb,EAAAMAAAHACA.eAEEZABEGAEAKBHB.CAGA.JCCF..VCCBdCFABDHDhAAAAAIBLCHBSEDHhAHAaDGB.TFFAhAIAIGAA.FFFH.fHGFOFHD..hAGA......hBAA...,1,-9,-22,13
fUWbBXAOVaDFTNKJEeLHGIQMZYScRPdgC,aAAATAAA..KADAEACEHAFBGAEAMAIBZAGB..SBBDhADARCCBdEAACDHAUFFABCCBABIBDFIBhAAAFCEHeDGF.LFAAhAFAQGBAPEHD.fHABhAHA.WFFD...hAEA...,1,-2,-10,8
OgULGcDIBPZNYVRbSJATCXKQWHMFdeEaf,TAAAKAAAHACB.dAEBEACEOAGDLAEBGBEADAGABBGAZCAF.VDCBhAAAREFF..SCHHhAAAABIBQEGAMEEBeFEFhBGAaFHD.fGGE.....hACA......hAIA...,1,-8,-9,1
UCeYWQaLgMJPHKFRNDGdbfXAIOBSTcEZV,BAAATAAAEACA.ZAEBCACB...eAGFQAEALCAAMAHBHCGBhAAARCCAGDFAdEBA.bEABhAAAAAIBSEEBhACA.cGFBYEEFWECHaCHD.gGBHhAEA.KHGADGIB.hAIA...,2,-7,-3,4
gfXHOBcESJeQWRALKdCVDYFaTZMPNUGIb,dAAADAAAFACDZABBMAEA..UAEAGBEA..IAHA.hAIA.bBGB.XDBAhBAAHCFCBDDAEEGBeEEDhBDAREBBABBBLEFACGCAaGGCNCIA.OGEA.SGBDhBAA....hBEA...,1,3,-34,37
MBTYKNUIXdEVcFeaORfHZDCbPWAQSLgGJ,LAAAGAAAMADATAEAKAGA..UCDAdAGAECAAFCFE...eBHHhABAREBBHEFAZCDACEAA..PHEAhAAAAECAQEEChACA.SEHHBDHANIAB.XGGC.hACA......hAIA...,1,-3,-15,12
aBgNCGcYeZHMKAdRIFbVUfDPWTQSELJOX,RAAAFAAAUADADADA.....TAFAEAFALBDB.OAHDhBAAaAHDBCCDCCCA.GDEAhAAAeCFBHEGBADEBdDGBbEGDfFEAhBHA..PHAASGCB.hABA......hAHA...,2,-21,-21,0
PaZfOKcRTWDVGdACbSNHJgeXYBLUMQIFE,SAAAHAAAeACEBAFBMADA.QBGA.ECCAZAEEKCEARBCBTCFAhAAADEEAdEHAAAHAbEEAJFFBhAAA..XFCChABA.UGGBIHHAaAHD......hCAA......hCCA...,1,-6,-18,12
FTCHbgeLUDfEVdYcAWRaOZMGKXJIPNQSB,RAAAZAAAGADAKADC..JAFB..IAFA.QBGAhAAAFAHBHCAAeCEDLDAADCIBEDGBhABAdDFAAAHA.aEGDMFGBhACAPFEBBFHACGHA.........hABA......hADA...,1,-13,-31,18
PHLMFgdCBcJbTZOfXUVDGNeRYAWIaSQEK,aAAAEAAAHACALADAMAEAdAHABAHA..JBBFZCCA.OBEEUDDAGCFAhAEARDFFACIB.SDHBhAFAKEHBFGHHCHDA.bFCC.hAAA....fFHEDEEB.eHBAhBAA......hBHA...,1,-15,-17,2
HbVPSUOAFIZcXNTKEQYMRgWDeaGBfCdJL,ZAAAXAAAKADC..EAFAMADA..RBFADCAAeAFAGCDACBDALCFAhAAAHDGB.VDBAUGGBACGAFEFAhABA..NIAB.TGGAhBDA...........hABA......hACA...,2,-23,-13,10
DNRYAZgTbCVWBeJIFQGXLdUKOPMfaHScE,ZAAATAAACADBBAFA..eACEFAHB.GAFALCABdBHAOBDBhAAA.MCCBHCCCEEDARCFFACIBhABAbEGDJEHB..QFAChAFAKFCA.aFDEDFFBYHAG..hAHAWHEG....hACA...,2,-35,19,54
IdMNeUJfWFGcPVLRYSDgTEAaHCQZBObXK,HAAAZAAAOACAKADCdAGA.eBDAUAGA..JCAFFBEDGDDA..hAAAPCCBRDGBDAIBECCBADGA.hABA.aDGEQGFChACA..bEEC.MFIB...fGBAhBGA...hDFA...,1,-9,-26,17
WOZBYKQJEeCSaNbTLDVXcfUAMIgFHdGRP,MAAAFAAAHACBRACA.OAEAZAFBKAHB..EAHFeBBB..aBEDTDDAhAFALDGB.XEBAhBAAfCHEACIBdEEAGEGAhBAABGCD.QFCCSFHHDFFB..hCAA......hCEA...,2,-13,-12,1
DMHRFNScJCZLWIbeTEUAaBXOfYKQGVdPg,aAAAOAAA.KADAGACA.dAEBDAFAHAGBRBEAFBBHSBBDhAIA.CCEAZDFELBHBhAIAbFBA.EDCAAFBA.XDFDhBAAQFGA..gFEGMIBAcGFChBAAIHDA...hBFA...,1,-3,-29,26
MfYeFLcARTaSUODZWBECXINPKVJHGbQgd,RAAAaAAAOADAZACB.BAGAEAEA....XAGA..ICCAhAAAKBBDHCEAGCEAhABAbECBdEGAMAIB.eCGBhBEALFFDACEBTGFADDIBCGHAPHCCJHAA...hAHA......hBAA...,2,-18,-5,13
TJDEBUYbdeGfOcXPRSaAQFWILZNgHVKCM,QAAAFAAALADAZACBHAGBCAEA.MCCADAGABBFAUDDA..dDGDeBGHhAAAGEAAOCEBXFEAhAEAREGBABIB...IFHAhAFAVFEB.........hBCA......hCAA...,2,-26,-6,20
OVQDBCKHAJRIWdZFPEfGLeMSXTNUcabYg,RAAAdAAAZADBEADAGAFALAGB..eAHBMAIBTDAAUCCAaBED.hAAA.bDED..ODABhACAQFBACEFAHEGBACCAIEHAhABAFFEHSGBAXGFANIEB...hADA......hBAA...,1,4,-7,11
PTaGUgfRXZWFDLVbAHcJINSYKdCBeEOQM,HAAAJAAA.SACEdADABAFA.EAFA.MAIBaAGD.GCCA.fBGAhAAARCDAZDFEDAIBLFAAhAFAACCBIEFAKFGAeDHBhAFA.QGGC..PHDAhBAA......hCAA...,1,11,-37,48
gGAOXBNPUHTScLKZdYabQMDIfWCVEJFRe,BAAAUAAAHADASACALAGBdAFA.aCBEMAHB..DAIBICAAhAAACCEA..EDABRCCAeCHHhACAADIBOEEA.XFAAhADATEEAZFBAbFFA.QGGA.hAFA.fHFBhBAA...,1,-11,-22,11
aNeQDVLfYWbFUcIJZgAXOCRSKdEGPBTHM,CAAARAAAdADAGACABAFAHAEA..aAGDeAHH.QCACLCCA.hAAAfCFA.hABAbEDAFCHD.IEEAhAFAZEGBAAGASEAAEEGBMFIBDGDAWFHH...hAIA......hBIA...,1,8,-33,41
NCRLTHKVUAeXIWbdZSQDEFOaBcJGYPgfM,eAAAXAAA..bADAZACB.QAEAFAHBBCCAGCEA.hAAA.gBGBhABAMCIBREAAHEGBKCEDAAHAdGDAEDFF.hAAAaEGD...cGFC.....hABA......hAEA...,1,-10,-15,5
WCBeJATMSEPNKZfGXcRQbYFHagOILdDVU,MAAAEAAAKACAGACB.RAGF.QAECFBBHHCEB.aAGAOCHDLCCBhAAAdDDCDFAAUCGABFGAhAFAAEEATFDASGAAhAGAZFFBfFHAXGDA.YHBAIHHA.hBHA......hCAA...,1,0,-12,12
cefTVNSUPHKabJCgROGDILBWEQAFdMZXY,dAAAZAAA..XADBeADATAGA..SAFAHCACaCFBCCHARCAAGCEAhABALEAAEBHFADGBMEEBhACAfDHAUFFA.hADAbGAA...OFHDDEIB.BEDD.QGFAhACA..hAGA...,1,-4,-6,2
TVPMQCSdbOFecADLEaUHKIJgYZBfRWXNG,EAAAHAAAKACAJADA.ZAGBRAEF.....XCAAGAGATCCAhAAA.MDGBQDDAhAAAdEAAFEEBAAIBaCHD.gEGGhACAfEHAVFCBSGAA..hAEA......hAGA...,2,-20,-10,10
TgOSeMfWJIHLFVEAXKNcYCGRDBPUQZdab,KAAA..NAAA.CACBRADFBAFA.UBBAdAFA....aAHBTBGA.hAAAOBEBeBHHMCCBhCAAJDFB.HDDCLEHBhABAEEHFAFGB.XEAAGGDBDGIBZFDFSGGDhACA.fHABhADA..,2,-21,-13,8
AKcZJeHLDFPdbEYCOVIWGaRQSNBTfgMUX,ZAAAHAAALADBFADAdAGAECABOAFA..VCCAGBFA.RCABQFBAhABABCHATDFAMBIBhACAAAIBKEHBeEEB.bEGDhBFACFCAaFFC..SHCAfGBE..hAAA......hACA...,1,9,-21,30
BdSANUJQYRPbWHFXEIZVCMDegaOfLTcGK,UAAAQAAARADA.....bACAHAGBEAGAZCDAMCDB.eCEFhADAaBGELDABGEAAdDGDhAEAADHAJECAPFECFEGDXGAAhAAACFHB.OFHD.....hAGA......hAIA...,2,-14,4,18
cgSfRVdOAKCLQYaXNEZeIWbUMJFTHBGDP,LAAAaAAA.EAEAeACH...bADDMAHB.TCAAHAFAGCGAhAFADAIB.gEEBhAHARCCFdCFAADIBQEGDhABAXFCAIHHAUGBABEAD.SEEDhACA.fGHEhAEA.,2,-13,-2,11
RLegAGSOdBJWTFDMYbVXHcIKNZQfPUCEa,GAAAdAAABADAJADAFAFA..MAHB..VBEBHCDA.KDCDZABBQEFAhAAAUEEB.EFCAhACARFGFeAHHAAIB.ODCDhBAATGAA.DCIB.YFHB.cGCDhAGAfHEBCHFA..hCDA...,1,1,-32,33
YFMSUGBEcQLgRTKdWAXPNZHOVCDIefJba,XAAAZAAAHAEACAHBDADA..eCAB.JCCFaAEE.MAHBGCFAEBDBLCFBhAAAREDFdDHA.AAIBOCHDhABAfGAAbFDC.hCAASGHBBDDD.......hCBA......hDAA...,2,-23,-8,15
MZYcEeJBWUVCPGKHRDfdgNQFIALSTbOXa,TAAAXAAA.ZACBEACEBAEA..VAFAGAFAHCCARDEBdBHAQDFAhAAAAAAALECBbEABaCHDhAEAMEHB..eEEBhAFA.UGGAKHAADEIBfFCA.NIAB.SGGDhAHA..hAIA...,1,24,-19,43
bFIBRDgEGVAHNTWUOQCScYZXdfKMPaeJL,HAAATAAAOACA.QAFASACBZCCAdAEAMAIBeAGBLDGBhAAAbCCCBAHBRECAEGEBhBHAACGBUEBBCGHA...XEEAhAAA.KDHB.aFGD.....hCAA......hCDA...,2,-6,-6,0
egfYRIELPadJZQMUGDBXAFSVcCbTNWOHK,SAAACAAA..bACATADA.OAFAHAGBeCAA.hAAAfCEERBFBECCBaCHDZDAFhABAMDDBGEDAXEAAhAAAADFBFFFAcEECKGHBIHCAdEGBQGAChACADIFA.BFHD.NIDB.hADA...,1,7,-7,14
UBEJYMcZWPDVLSCTROeFbgQdHXKAfNGIa,GAAAaAAABADAEADA.MAGBZAEBDAHB.LCCBTCDA..RCGFeDADhAAAFCGH.QFCAhACAHDADAAIB.fAHEhADAIEEAUFGAcFFAPGBCCDCD....hADA......hBAA...,1,12,-26,38
dgbLCefWBSFcJRGEXUNQYIMDaTOVZKAHP,HAAAdAAALADAeACEBAFBFAHBRCAAEAHB.UCCAQCEA.MCIBhACAaCFATDFA.hAEAZFDAADGAbECBCEHA.SEFAhAFA.cGGA.....hAAA......hAIA...,2,-21,-11,10
KEGcUfTWYFQbXNSIVdRAPOJBDCHeMLZag,OAAADAAAHABCLAEAaAEA.EBBBGAGAUCEA.TCDAFBHDQDBBhAFAXDFDSCCDhAIAdEHAAFFABGAAeGDAhAGAZFBAKFHB.fGGE..YHFGhAIANIBB.....hBAA...,1,-5,-8,3
ATEZIgHDeKdQFXOJWNUSbBVLCfcRYPMaG,EAAAZAAAHAEAKACA.dAHAQAECOCAB..JCCFUAGABCFALCCBhAAA.CDGAREDFMDHBhABAADIB.TEEADFGAXGGAhBIASEAH.bGAA.....fGEEhACA.cGGChADA.,1,-22,-28,6
dPcFVDfWYEaRBNSZLJUObgACeIKTQGXHM,eAAATAAAGADA.HAFAdACAFAEADCCB...fAHAhAAAECGARDEFSDBDZCDBLDGBhAHAODHDACIBKEBBMDDBcFDDhBEAVGFAaFACBGHAJHAA......hAAA......hABA...,1,8,-14,22
JGIRVHOQULbAYDSceXTMNFCWgKBfEdaZP,SAAAeAAAMAEAFAHDCADA..KAFABBCAdAHAZCCAGBDA.RBFBHEGBhAAAQDACLFBBhABAAAAADCGBXFED.hADANIDB.fDHA.EECA.aFCE.IFFAhAFA.OFHDhCAA.YHDA,2,-16,-8,8
EXQgHbJVKUFecfLNOTYDWIdSaRAPCBZGM,BAAAGAAAEACAQADAHAEA.JAFEKBHBeBHFLCAA.TCFAhAAADCDBdDFARECAAAGAZEDBMEHBhACAbFGD...FGFBNDAA.hAAA............hACA......hADA...,2,-16,-12,4
VFDSdAYGfaReMCTQUPXObLIHJcBZgWENK,GAAARAAAeADE.MADAQAGCUBFA.OBDDLCDB.HEBBhAAABCCCZEGBECFBKBHBDCIBAAHAaFEDhACATEGA.bFED.hBAA....IHHA....hAAA......hABA...,1,-11,-22,11
agdUETefIZYXHLFWJSbRcQBAVOPGMDCNK,OAAAGAAAMADADAEA.KAGAdAHA.UBBBEBFB..eCDBZBEBHDFBhBAALCHBFDHF.SDBHhAAAREBABGCA.ADFBCDGAaGHBTFFAhACA...IHHAWHBA.bECD.hBEA......hBHA...,2,-24,-1,23
RfSCHJUbgFcQVWdOXPLaZKNDYAIGEBMeT,EAAAeAAARACA.CADA.HAFBUAFAFAHF...QCCBdBHAOCCBLDABhAAAZDEADEIB.ADFBGDGAhADAMFBB.TGEA.hAAA.SECH.bFDD...gFFBhABA..hAIA...,1,0,-30,30
ASGeLPbHJCaQZWBNfMTUKVgdYcOEXDIFR,eAAALAAAHADAaADDZAGBBAFAMBIB.KCCAdAHA.OCABEDEFDEGBRCDAGDGAhABA.JFABQFAAhAAA.fEHEhABATFEAgGCBXGCBAAFASCCDhACACGHDWFFD...hCAA...,2,-15,-8,7
SOGNcWILFTbVReBUPaJEZfYQADHCKdMXg,HAAAdAAAMADASACEGAGA...NAFA.IBDALAGBFCBDbCCBhAAARDDA..BBFCUEEBaDHDhACAEDHF.ZGBA.fFHAhAIAAAIBKFFAOGDC.......hBGA......hBIA...,1,-4,-20,16
ZQKIJWNdAfGMDUTaeCYRBXEVHbFcLOSPg,GAAAMAAADAEAaADA..eAFARAFFBAHB.ECDBHBBA.FBHDLCHBhAAASCEAZEBBQDFBhACAKDBDIEEAWFFDhBAAADDBTEGA.XFCCcGGA.OGEChBAA.....hBCA...,2,-14,-12,2
UZIOfHTXGBeYWRgcaJdSVKQbNMAPCFLDE,FAAAEAAAZACBOACDHAEAGAEAeAHH..RCFB.aAGAdCBC.KDED.QFFBhAAAbBGD.AAGACECALEAAhAEA.DEEBIHHAhBCATFFABFHB.gGBAhBAA......hBEA...,2,-20,-5,15
XfCIKPRQMYWOHAJSNgBTcLFbdeUZGaDEV,SAAABAAALACAdADAZAEBaAFD..EAHBXAGA.CCCD.KCCAhAAARCFF.MCHB.ODABhADAHEGBAAAAJDEB.TGEAhAEAbDBCeFFD.DDIBfECAIHAAPHCChAHAQGGC.NIAB.hAIA...,1,0,-24,24
NSJCLBHIUdecZFTbPMEDXgKYQaAWVOfRG,OAAARAAAGADA..SADALAFAHCFAdAGAeBBBZDAAbEFAECFBDAIBhAEA..KFEDaDCDAAAAVGAAhADA..fDHAhBAACCCDBGGA.IEEA.FFGH.MFIBhBGA.YHDAhCAA...,2,-26,1,27
XdTLMEACUFRJDaSbVePZWYBHIcNOGfgQK,FAAARAAADADA..aACD..SAEAeAEAZBEEBCHAHAGB..ICCAhAAAODDBGEAAhAEA.QEFAhAFAdCEAMDGBAAIBCEHAJFEFbEGDPEDB...WFFDhABA......hCAA...,1,-14,-28,14
EQdIFgCLTVcNBMSaRKDJAPfGZWbOHeXYU,GAAAZAAAOACAHADA.eAFEUAGAECDBdBFCFCFALDDB..hABATEFAVFFABDHAhBIAaCHDRFDBDDABACCB...fGHAhAAA..WECD....hCAA......hCBA...,1,2,-32,34
LPUEJeYZbdGaVSRDCXBKcgNQWAFMOHITf,MAAAHAAATAEALAEAEAGEeAHH.ZBBAGCAB.aCFDRCEFXDBAhAFAKCHB.gDGAhAGAQEACADBAOFHDhBAAfEEEUGCAbECDdGGCDACA.BEGA.hBCAcGGA.WHCAhAAA...,1,10,-10,20
TPLeYVWcNOREIfAHJQbFMXGZBSUdaKCgD,HAAAQAAAMACAZAEESACAdCCAKBHBDCFBLAFA.eCDAhAAAVDGB..NCHAEDAAACGBFEDDhAAAGECABFFDaGAATEEAhADA...YFHB.cGAAhAGAIHHA....hAGA...,2,-26,11,37
cXfLIKDJRWbVAGUadYCONQMFgBSHTEePZ,aAAAdAAAOADA..MADABAGAHAFCEBDBZBFEfBBE.hACALBDBDCCBRDEAVFGBhAIAACFAGDFA.CCHAQFDChAIASDDDeEBBPFHDIHDAhBAAKHEA......hBCA...,1,3,-24,27
UNHSFGCVRJgILKBXaEcWTQeZMPYAODdbf,dAAAUAAAHADAGADARAGF..JCBBLAFABCFD.ECFA..TDDAhACAeCHFZDAA.MEFBhADAAAFADCIB..bGAASEGBhADACGGA.gFFD...hAGA......hAHA...,2,-29,-13,16
OYcBLZNUPEJCXgGFAbRWdHeMQfDSKVITa,RAAAHAAAeADEMACA.QAFASAGBKAHB..TBDAaBDDOCCHhAAABCCDZCFEUDFAEEEBhAAAXFCAGEGAAAIBdGGAhCAADGCA...........hCDA......hCFA...,2,-14,-9,5
bQKWOHaeTAgRXGDUJIFVYCZESLNPBcfdM,RAAAGAAADADA.UADAFAFD.CAFA.ZAGBLAHBBBDA.dCGC..MBIBhAAAQDDA.ODBDhAAAHDDAeEGFAEIBXFEAhACAIHHA.EFDBSFHD.hABAPHBA...hCAA...,2,-34,-9,25
FIdXJcGZOHNETCAfeWVagSRKDbYULPQMB,eAAAaAAA.RADA.DADAUAGALAGB.MAIBFCCBdDEA..XBBAhBAAGDGAHEAA.hBBAEGDAABEAfBFAhCAA.gDEGSGGDbECD.QFGAhCEA.BHEAhDAA...,1,-15,-23,8
NXQJCegMbOHGfEISBFTPcAUKLWRVDYaZd,LAAARAAADADAZAEE.dAEA.QAGAeAHH.MCAAHCCAGCEBhABAEDFFBDHATEBAAAAAKFCAVEEBhACA..aFGAXGAChAGACGAA.OEHBSGGB...hBEA......hBIA...,1,1,-26,27
DeSaVTIBXQCgGKOLUENWZcRfPHYMbAFdJ,dAAAeAAAaADA..TADABAGA..QBDCGAFALAHBhAAAEBHFZCBBRDEAHCCA.bEEAADIBDFDBhACASFAA.hAGAXGGAKFGANIABfGFEMHBA...hABA......hAFA...,2,-16,-3,13
FHgPGUEaARBYOTLZNfCSbWDKXQdMJeIcV,RAAAOAAAZADB..CAFA.SADADAHB.QAGAdCCCeBHH.ICCAhAEAFCFBHDABGCEAhAGAEEEB.ABBBBCGDLFHBhAAAbECDKEGAMEGBcGGA.....hABA......hADA...,2,-17,-11,6
DGPcXNAHCTeBLUFKWJIYQVbdOfaRMZSEg,HAAAeAAALAEAKADCJAFB.QBCDdAHA.aAHDRCAAZDEA.EECBhAAAGCEA.XDGBhAAAADHATFFAFFAA.IGGAhABA.bGAAMEIBDDDBNEIABGDA.YHBAhACA...hAFA...,2,-16,-3,13
XGgaeJdZTSHbBNYFEIfPQLACcKWVMDOUR,KAAAMAAAOACARACA.GAFAeAFEZCCA.HBECBAHAFCHDEBCF..hAAAIFFAQDDAhAHAABBBCFHA.VEGB.XFBAhBFAaGEC.JHDESHFA.NIAB..hCAA......hCBA...,2,-16,-14,2
aUeFEXfWSCVJMbdNBgcYDAPRLZHTQGKOI,RAAAHAAAGADAOACAUAGAEAFA...XBFASCCD.CAFD.hAAAMAIBdDAABDFA.hAAA.gCCAhCAADDHBADIBZFDAKFHBeDFB.fEEE.JEHBNIBB.hABAPHEC...hADA...,2,-24,0,24
WXUIfETPdgRcJQSVDAYGHOLCKBMbaNeZF,HAAALAAABADBaADDeAEHZAEB.FAGA.UCABEAGAdCAA..RBFFQEEChAAADBIBACCBGCFAKCHBhACAMDDB..WDCHhCDAfEEE.PEHDgGGA.hABA.SHCAhACA...,1,-10,-21,11
QdIUVOKTFGDcYXbNBJgaSHLfARMZEeWPC,RAAAEAAAeADE..CACAdAEAUAGAKAGAGBDA.DCCBXCCCBDFA.hAAA.aDGDHCFA.ACHAZEBAhAAAQFCCOEHBTGAAhAGAFFFH.bEEDNDIA.......hABA......hBIA...,2,-20,-10,10
gfUJLGFaVIZTYeNWQKOSXPDEHBRdAcCbM,CAAAMAAAUACAGACB.FAGAaAEEZCCA..eAGHQCGA.hAAASEEADAIBHCEBRDGFhAFAABBB.bCBCJFAA.LFHBhAFAIHHA..YGCG.KGGD.hBCA......hCAA...,2,-27,-4,23
MLeKaTZSbIDYPQBVWGXEJHgFAOdRUNfCc,RAAAUAAACADB.MADALAFA.KCCAZAEE.SAHHDCEA.QCDBhBAABCGAGDEAhAAAECGBHDBBAAGAdEGA.fEFAhBCAaGHD.TGGA...YFEFhBDA....hDAA...,2,-39,-17,22
AVJZHOQBFRYcIUNdXgLafCGPbWKMESDTe,ZAAAHAAAQAEARADF..IAGAdAHALCABaAHDGCEAhAAAbCCC.MCABEDFATECAhABAACCBODDHBDHAFDHBUGCBhACAXFFACFAAKFHBeGBG......hACA......hADA...,2,-7,3,10
PaHDfceXYAgWdILNGQBJEOFbMSZURTCVK,dAAALAAAGADAQAEAEAFA.FAGEbABDZCAA.RCFA..CEAA.KAHBhADAHECCDCGBeCHBACCA.hABAIFAABEHAMFGBhACATFDA...aDFH.XGGA.hAEA......hCBA...,1,-5,-18,13
PbSGdTOcKaRAZDgCeJVfBUNEHYQLFMWIX,ZAAACAAA.eACEJACA.BAFB.UCCBHAFBLAHBMAIB..XBCChAAASBFAGDDAhAFAdDFAOEGDaDGD.AEIBDFEBhABAfFHA.EHAA.....hCAA......hCBA...,2,-29,-19,10
WZREFPQKcXDYTUaAVSefIdOJGLBgNMCbH,eAAAdAAAGADALAEABAFAMAIBHAGBRBCBFCEAQCBD.XDFChACATDGAAAAAfEHAhADAOEEB.gFAAhAFAbFAAEFGB.KGDADFAAaFGHSGHHhAFANIAB.CHCD.....hAGA...,2,-10,9,19
gdVUFKfbJLPQOeCBNIXDTZHRGaYMEWScA,dAAAFAAAKADAJADA.LAFB..QAGCeAHBBCCAXBDChACAZDAAHCGBRCBBGDFAhAIA.aCHDEEEB.SFCDhADAADFB.gGFAfEDA.OFHDhBAANIAB.DHDA..hBCA...,2,-18,-14,4
AQabegJMEPNWKfGVHDOYFZXTLRcCIdSBU,aAAAeAAA.MAEAEADA......PAFCKAHBGBCAHCCAOBBBhADAZBEATEEARCFFCCHBdECDhAIABDGDAEHA.bFBC.gGGAhAAAWFCA.DDIBXGGA...hABA......hBFA...,1,-7,-15,8
aVZIfTWKBGEbUPYNSAdDCXQFRcgOLJeMH,dAAAXAAARADA..OAGDeADAHAGBZABB.TCDABCEAEDCFbDAB.hAAA..UDGB..hAEAPDFDSEEBhAGAAAIBQFCAFFHH.LFHBaGGH.fHEFhABA.WEADhADA...,2,-25,-7,18
ESWbdTNPJCZIDHMfeAFaXcGRKVLOUYQgB,aAAAGAAA.RADALAGBOACDUAEA..QCDBEAGA.hBAAbDFAdCHA.TDEAhBBAPEABZEBAHFFAeFGBAAABXGCAhACAKGDD.YHFGSFHB.hADA......hAEA...,2,-12,0,12
TCXHdDBIgNKLRePQFaAEWbOJcGVSYMZUf,EAAAOAAAGACA..SADAZAEAUCGBCAHBHAFBBCBD..gBBGhAEALEEARFAAeAHBhAIAQGGAACEBJDEBcFGAhBAA...MHDA.....hAAA......hAFA...,2,-20,-10,10
KHFfWJgBTeDCYULERIGdaVOPMSbcQXZNA,HAAAFAAA.JADATADADAGA.UAFARBFA.dBHAOCAB..MCCBhADASCCAQDDAhAIAZDCEACCAKDFA..fDGAhAAABEHAeFGBLFFA.EHFA..hACA......hBIA...,2,-21,-21,0
BadYNEQefPTIRKCOFcgWJZHbVAGLXSMUD,GAAALAAAMADABAEAdAHAEAGA..eBFBTCAARCDBKDCD.FDHB.hABA.gBGAhACAZFDAHGBAAAABSCCBhAEADFIB.aCEB.QEFA.fFDAhAGACHGA.OEHFhCAA...,1,-9,-18,9
VTDOaIbUNGcgBQKfPFZdAEYLSWMXRCeHJ,EAAALAAA.MAEARACAHAFB.TCDAaAGEUCAAGDAABBFDQDGAhAAAKCDA.FAHFhADAACHASDEAhABACEFDeCCDDGGAIHHAbDGD..gEBAhACA.ZGFA....hBEA...,1,11,-24,35
DgdJBQRIVcbPCHFeENSLWTXUGfAaYZKMO,ZAAAMAAADACAdAEABAEARAGB.....VAGBbBBB..HCFBFCCH.EDDAhAGALDFA..hABATFGAGECBAAIBaEBChBAAOFGD.QGAA...cGDChAGAeFFD....hAIA...,2,-28,-6,22
PdFQGbgUHAYCMEKaOecWJSBLNZXTDIRfV,MAAAEAAAKACA..eACA..JAEALAGBZBFEDCCA.RBDAVDEB.hAAAdEHAGDDAUGBAAAIBaDGAhAHAOBBB.SGGDhBAAXFGAfGFE...hBGA......hCAA...,1,-13,-33,20
aQEAbVcIdfeZXBUONWLHRDgGSCYKPFMJT,VAAAdAAAeADA.ZABBBADBUBGAOAED.LAGBHCEBRDCBGEAAhAEACCDD.KEGAMAIBhAAAaGCE.ABGB...IGGAhAHAXEEADGIBSEHB.FGHH.hAIA......hBAA...,2,-31,-6,25
VOSeBPRWaHfIULdQCKZFYXTEAgcbGNJMD,...bAAAGAAA.MADAOAEAeAFARBDFHBGBICDAdCAAQEFChAAAZBFEFDFD.TFBAhABAAAABgEBAhACAJFHBSCCDBDHAaEEHLFDBKFHBEGGBDHDA.hACA......hAIA...,2,-2,3,5
CDAYOLUFGceHNIPdBWXRSgTZafKQJbEVM,LAAAGAAAHADA.IAHAdAEAXAGARCDA.TCAAaCGAQDGDhAAAECCE.MDABhACAAAGAOCFCFDCHeEFDhADABEBASFAHZEEAKGEA.JFHFCHCADEGA.cGGDhABA....hACA...,2,-19,18,37
HSYCJgLMIZUadEKRQfADNTXVPeGFBcObW,TAAAXAAA..eACEGADABAFBOAFAHAGBCBDDLBFBhAAAZCCAdDGDRFCAAADBDBIB.PDHBhABAbFFB...SDDDhCAAYFHBMIAAaFDEEGFF.fHCBhCBA.....hAAA...,2,-9,-3,6
dAMDgQVHJGXSecTbUCaFZBLPKIOYfERWN,MAAAQAAAHACCGAFAeACA..bAFAaAHF.ZCCALCDAhAAAKDHBOEEBECHBRDAAdFAAAAGADEEAhADAVFGBSEFAhCAA.TFCAFHBE.BFHA.IHHAhCEAWBBD......hCFA...,1,2,-1,3
dMHITWgNBPJCRYXFZGULQVbEfaeKOAcSD,DAAAHAAA.TAEA..gABABAGBCBHARCAAFCEHGADA.LAFAhAGAQDGAECFAeCHFhAHAAACAdEADMFFBIEFAhBAANIAB.PFHD.YDDFXGGA.hCAA......hDAA...,2,-17,-6,11
bMIYOGWTRJgVLBSEUQePdHZFXcDACNaKf,aAAAKAAAMACA..OACDGAEBRAEA.JBCBLAHB.ECEBeCFAhAAAHDFBZDEAFEAADDIBABBBCEHBhAEA..bECD..IGCAhAFATFFABHAASEED...hAHA......hAIA...,1,-14,-22,8
LgbCUaXNZRFJDMWKQVEPfeIBGATYcdOSH,TAAAdAAAHADA.LAGBCACB.aCAEZADBRCEB.DAGAKDCAEBFA.eBHFhAAAGEGAACCA.OFAAhACASDEA.bEFAXGCAhADA.FGFHMFBA.QGGChBFA.....hAFA...,2,-13,-6,7
abZAXUfQHPFeLSRTIOgEJVDGdcWKMYNCB,XAAAQAAAHADAeACARAGF...TAFAOCDB.ECFBDAIBdDAAhAAAKCDAMCIBCCGABDAAZEEAAGAAhABAUEEAFGGH.LEHBhAAASGAAgFCD.JHAA...hADA......hAFA...,1,-4,-7,3
bdgTFLPHNJCeWEORXYaDIZMKGBfUcQVSA,dAAATAAALADA.HAGBCACBEAEARCAAaCEBZAGBGCCA.BBFAhAAAfDFAQEAChAEAAAEAFDHDPDHDeFDBXFGChACADEFBMEGBKHGA.......hAIA......hBAA...,2,-13,-3,10
JAaLCgIdOfHYTeRcWNFUPEVGKQBSXbDZM,aAAALAAA.CAEAdAGAHACB.eAEARCAA.NAIA.FCEB.UDGAEBGFGCEAhAEABEAD.SBBDhAFADAIBZFEA.ADHBOEDBhBAA.TGFAPGBC......hABA......hACA...,1,4,-34,38
PWcaAdSVZTOeNRIfCGKXgUMQDFLBEJHbY,dAAAZAAAeACERADA.CAFB.GAGA.KCBAXAGDMCFB..QEAAhACALCCAEDFAHEDBhADA..bECBPFHBhAEAaEFEAAIB.SGADOEHDfGGEDDIBBGFA.hAGA......hAIA...,1,-8,-14,6
KMLSbJPUGdaABZcVXIYRDEfFNWQeHTCOg,ZAAAXAAARAEADACA.FADA..QCCBHAFBTCDA..OAHDhABAMAIBLDBBhAAASCFHbDGDUFAAdFEAAAHBBDHDhAFAIHHAEEEBfFDE.eFHBhAHA.KGFA....hCAA...,2,-16,0,16
YKCLIeTRGBVANZMgHQcWdDXFfaPbSEUJO,ZAAAHAAAQAEAdADAFAFA..aAHDSAGAEBFB.OCABhABACCADeCCBRCCAGCGAADHA.hAAAMEEBgEDHhACADFFBfGGEbFGB.YEABKGEA...hDEA......hDFA...,1,-2,-13,11
KgCfeNOIFYVMTUcJQDaLGHSdEXbBAPRZW,RAAAZAAAKADCCADB...eAFAOAED..FBHDMAGBUCCA..QCAAhABAaCFB.HCGBhACAEDGBBFFAAAHA..gDDBhBHAfFHAIGFATGAADIEASHGAhBIA...hAAA...,2,-36,-20,16
dVWJgPFeHbCGEMDSLZRKQYOTBfaUNIAXc,dAAAVAAAJADA..FADAHAGBGAFADBDBZCDBRCDB..KAHB..QDGBhACAODCBBDHAaCBD.hAGAUFDBAAIB..XFDAhBAA..gGFH.eHAEhAAAEGGAMIFA...hAHA...,1,-17,-21,4
INfdQaROTEYZGWbBMPUCcVXgLHASJFKDe,FAAAeAAA...IAEAdADARAFAECCB.GCEABAGAMAIB.CBCA.hAAAXCGAHCDAACFAKDGAhABADDBBQEGDhAFAaEFC.TGAAZGAAPFHD.....hAGA......hAIA...,2,-22,-17,5
BQFVCLDMPgbGdeJfOKXHSEIcaAZRWTUNY,RAAATAAAUADABAFA..QACCFAHB.LAEBMCCB.hAAAbAGBeCGBOCFDHDDAhABAEDDBaEHDABIBZEGB.YECFhAAADFDB..gFFD..hCAA......hCIA...,2,-28,0,28
fUecVRSYWXNQDFABKZHELCOIGagbMPdJT,ZAAAHAAAEADELADB.OAFAaAFAMAIBdBFATDGAUCAAeBFFhABAREEB..SCAAhAAA.XFCChACAQDGCABIBCGHA.GDDAPHCCfFHAhACA.cGED..hCEA...,2,-20,5,25
gVWRYbfFaGMCEBZLPKIUXHNOcdAJQeDST,eAAATAAA..VADARACF....bAEBaAGAGAGAEBGF.ZECALCCBhAAAKCADUEGBHDGBhABAOGBAACIBQEEAhCAADEDASGHD........hAAA......hACA...,1,-9,-10,1
LfXRNFDTEKVBYSdIAcOGCbMUJgaQWHPeZ,GAAAMAAAUAEAaADAHAFBZAGB.LAHBRBBB.DCDBEDEBBCEDdEBDABDAhBAACEBA..JEEAQEGAhBBAeEHH..fHBBhAAAFFDDKGBBSGEHOHEC.gGGGhBGA....hBIA...,1,-7,-12,5
gfaFZAUBMOPYTDVERKeCQIHWSGbNLdXcJ,MAAAOAAA..TADAEADARAFA...eAFEQCCAHBBBGBFAhAIALCFAdCHAXEDAhBAAgEDAaFCCABBBBEHAhAGADFHB.CFGDSGEH....hAIA......hBAA...,1,-3,-24,21
HEJgDfGBNXIZdVMcSKWbPARCLQTOYUaeF,RAAALAAAQADCTAEAUAFA..eAGHHDDAECAADAIB.GDGAhAAAXCDCdFDDMCCBhABAKCHBbEABADIB..OHBAhBHAaECEFEGB.JFEB.BGHA......hABA......hACA...,1,-3,-8,5
JbfXWRTeYCEGHaDQKVMBOdUIPASLcNgFZ,LAAA..gAAAZADBJAFB.XADARBGFeCAAEEEAHAGBhAAA.aCCAKEHBBDAAdGFA.hABAIDFAAAHA.SDDDhABA.FDHD.bFFC.TGAAhADACHHADIBA......hAEA...,2,-26,-16,10
MEKTHJRCZULPeBYcOWgfVIdaFbQNXASGD,GAAAEAAAHACARADAZAGBLAFBBCDD.OAHB..fDEAhAAAdCCDbDFA.QEABhACAAEAAMEEBTFFACDHAeEGB.hAAA.cEADgGAAaFCDNIABDGIBKFFD...hADA......hAEA...,2,-12,14,26
XDYGRbPMaQWIKTCAOLVFZSJUBcNEHefdg,LAAAZAAASACEBAEAEAGAHAEB.eAGBdCAADBIBRDDB..bDFAaCCAhABA...QCFAhACAKCCDAAHAFFGBUGDB.hAEA.fDDE.XEGA.hABAGGAB.MFFBhAGAIHHATGGA,2,-5,-5,0
aZXVQAHcNOSBJGCdIWYKPMbReEUfLDFgT,HAAAOAAABADBGADAdAFA....IAHAKAFAbCFA.RCAAECEBLDBBhAFA.FEFAaCGDZFFAhAHAQFBAAAIBSDDDhBAACEED.PGCCeEHFDFGB.XGDBhAAA......hACA...,2,-16,-2,14
DFZAGPOUXYKfQJaMgdSTEBINWceRCVHLb,GAAAOAAAUAEAKADAQAFC.MAIBdAHAEBBB.BBDChBAAICDA.NCHA.eDDAhBGA.RDGBHFFBLDFBhAAAFHBAADDAPHAA.fEEA.hBHAaDAH.SFHHhACA..,1,-4,-23,19
GDQPBbWUNYaCeKgJSMTfFREXcZVHdOAIL,GAAAQAAABADAUADAaAED.KAFA..SAGAMAIB.TCFAhAAARCEAEDBAZEEA.HGEAhAAAAAGALCHBDEGAPHAAhAHAbDCB..NDAAeEEB.fGGAhACA......hADA...,2,-17,-5,12
HZCDdKbESOaLXIUAMJGcFPTfYgeRBWQNV,GAAAFAAA..TADAfADA.eAEHRAFFQCCChADAHAGBZDDAdEHAEBHFODFBhAFAaDAHLFDBXEGAAAABMFFBhACAPHAABGAANEEADGGBSGBH.IHHAhADA...hAHA...,1,14,-17,31
fDNYWMLPBScIZQRabATFHOKXJVUCgEGed,HAAAXAAAUADA.EAFAeADA.dAHADAIB....NBGAMCDBhAAALCGBBCEASCAAhAAAZDABREEBAADA.TDDAhACAKDHBCGHA.GFDB.fGHAPHBA.IHBAhBHAaECHOHFC.hCAA...,2,-19,-4,15
PeBYbQDRLIfAaZFCWOKcNMTVEHGgdJUSX,ZAAACAAAKACAMACA..EAEEHAEC.dAHASAGBeCCABDEAQCAAhAAARDFFLDHBAAIBFCDAhACAOHFA..TDFAhCAA.GGCB.gGGB.hABA......hCAA...,2,-19,-18,1
bIEFHdJRfDMcQNCSGYZPXTaVOWeUAgLKB,LAAABAAAEACAHAEARADFMAFA..QCAASBFAZCDA.TECAhAAAaBHD.OAHDhACAeCABACCBbEEDdDDD.DDGBCDHDPGAChAGAXEGDUGGAKGBAIHHA.hAHA......hCAA...,2,-15,8,23
NVBUgLdafFYXWTCPRGZSOeKIHQJEDcbAM,MAAABAAALACAdAEAFAGA...XAFDTBBA.RCCAZDAF.eAHBhAAAHBFB.EDBBbDFDACHAUEDAhBAA.aDHDfDHEhADACFFBSGHBKEEDIHFADHEA.NEAA.hAEA......hAIA...,1,-12,-16,4
BgMdSXCRTIEDQHYZKAceaNOWJFGPbfULV,eAAAaAAA.OADCFADAGAFA..bAGBLAHBBCCA.dBBDCCEARDEAhAAAECDFHECBZEEAADFB..hBAANBIA.JHBAUFAA.MFGBhABAXGGADFHB........hBHA......hCAA...,1,-5,-18,13
ZXBeLYIcCEJbMRDHUTNVAfPadSQgWFKOG,aAAAdAAAQADA.FAFEGACAZABBBBHAeAEALDDAhAIAIBHAEDHBbCED.RDGBHEAAhAEATFDAABBB..SGCAhAFAKFFC.XGGACGCDMIDADGHBNIAB..hBAA......hCDA...,1,7,-15,22
EaPYDeBVfCJdQWRUGgcHXTAOMFZNbISLK,MAAAZAAA..IAEALAEAKAGAEBBA.aAHDDCAA.BCDA.CCFA.hABAdCDA.RCFBGFABhAFAHCGBACIBFDAAbFED..SDHBhAGAeEEBVFCBQGGAUGGA..XGADhACA...hBAA...,1,-6,-10,4
IMOGPQXVBcCYHRZDEKUSJFdaNLTebAfWg,...fAAAgAAAMADAGADAQAGABAFACAHAHCFAhAAARBCAECAFKCFASCCDhABA.dDAAaDBDTEGAhADAADEBODHDXFAAcEFBZFEFDFEBFGHDNIBB.eHAGhAFAIGGA...hAHA...,1,12,-2,14
PLKZHGNYBWfXCUMeRJFgADadTVIScbOQE,dAAATAAASADA..bACBEAGALAFAHCACGCFABBEDXCEAhAAAMBIBREABFECEAAGAaCCHhCAAIFHAQEEChCHAKHCA.ZDGB.YFHBCHHAeFFDDGAB..hACA......hADA...,2,2,3,1
DKEAMNLcagYXdSQOHeJGIVbCWTRFUPBfZ,MAAALAAA.aADDXACA.dAFAQAFAHBGBeBBBGCAAhABAIDDAbCCATDGAhACAREFBFFBABAHBZFFAEGDBhAFAAEIBNICB............hAIA......hBHA...,2,-9,-6,3
fJLWEAZRFMNHTPIXYbCKeVQcgDOGSBUad,RAAAMAAAHADB..TADAXAFA.CCCD.eAFE.QBBChAIADAIBGCFABBFAdDAALDHBhAAAACHAZDDAFDGAIFDAhBAAbFAAKEED.VFGBOHFA.....hCAA......hCBA...,1,-1,-14,13
RdabCDIGfVBNAUMYPEQgHZLFTKWJceXOS,MAAAEAAAHACAZABELAFAKAFC..JAHBeCCASCCARCFA.hAGAaCEDbEEA..DCGBGGCBhAHABDHAAEAA.PFFAhAAA...FGHDcGGDOEAE...hBAA......hCAA...,2,-17,-16,1
ENKMXRWQHPODcYBFfbgILSGeaTUCAZdJV,dAAAEAAAKACARADAHAGB.DCCBBAEB.FAGA..bDADLCCA.hACAeBGBaCFHCDDAACIBZECAVEGBhADAMDGB..QGDAhAEAOEHD..fHFB..hAAA......hCAA...,1,-11,-33,22
AKBTWMaSJLdVICNPHEZbYXFUfOQRcDegG,TAAAaAAALADA.dAHACACBHADBZBBA.XAFAFCFBUEAAQCFDhAAARDGB.eCCBhAFAADDBBEEDMAIBSFGDhAEAIFFAEEHF.bGAAOHBADEEBKGHB..hAGA......hCAA...,1,0,-19,19
RDKHOfFUMaXIBCebLSZdPYgTNcJWVAQGE,EAAARAAAHADBFACD.MAFA..aAEABBFB.eBGHLAHBdDAA.gBDHhAAATEEAJCCFABHBGCFAhCAAOCHDXGGAhAAAbFDBZFGB...NIBB.......hABA......hADA...,1,-8,-9,1
BLdTGbQcMRfJVEKCPgUWXHIeFOSYANDZa,ZAAAaAAALADAGAEAQAGARAGF.JCAAEBBB.CCEA.UDGAHDCAhAEAeDABSCHHhAFA.ADGBBFFAbEBDMDEBhABAKFHBPHFCXFFC.FGHDNIAB.DGAB...hAIA......hBAA...,1,5,-13,18
dGIHZYSKCQFAEXNDaeOVBbMWLJPfcgRUT,EAAADAAAeABABACA..MAEALAFA.JBDB..fAHAhAAARCEFdCGAHFGBZBCEKGAAQCFDhBEAAAGA.aDDB.hBAAbEECWCCD..gFGA.GGBBhBGASGFD.hCAA...,1,-14,-23,9
YXSedEJFRVfTcHAOCGagDUBbMQNWPIKZL,GAAAaAAA.DADABADAMAGBQAFA..PAHBZBBALBHBhADASCDAECFBREEBhAFATEBAADDBCGHA.bEEAIHDAhAIAKGEA.........hAAA......hACA...,2,-30,-20,10
bBAHYZWTPaJUCQXcRDfMSgOEVGLdKFIeN,HAAAZAAA.TAEAaACACAFA.QAGC.RCAAMCEBOAGDECHFGCCBhABAdDFAFEAHeCHHbFEA.hAAAAAIB..PEFB.hACAXFAADEIB.SGED..hAFA......hCAA...,1,11,-27,38
EPDdRQTYgIbLVfAWBKSJNUHXZCOGacMeF,KAAASAAAUACAHAEAZACBGAEA.aAGAeAHH.ECFFdBGARDDBQFGAhAAATEBAIEGAhAAALGAA.ADIBBGEAhAGAXEDDOHEEMCIB.DGGA...hAHA......hCAA...,1,-7,-9,2
ZADYRVcKLWaPUEQTbIgJfCMdHNOSBGXeF,RAAAKAAALADB..aACAEAFAQAFA..bBFAgBDGhAAACCCCHDEASEGAhAAAGDEBeCCBADGADFAAcFAAhAFAPHBAUFFBTGGAfHDB.hABAdBHA.....hAFA...,2,-12,1,13
ZOVWGTSMCfcQedFbYPgUHRXKDIABLEaNJ,EAAAaAAAZACB..OACCGAEAMAEA.CAHA.QAGA.hAAAeDEDbBDA..gCCGhCAAHDGBREBBDBBBACHALDFAhCBANIBB.VFFASGAFdHDB.FGGHhAGA......hBAA...,2,-6,-4,2
FPfAYGgBEKXVCMQcTJORDeZSLdbIaUWNH,GAAAEAAAKACA.CADA..MAFAQAEC.JAHBRBFAeCDB.ZDFAhAAAdCCAaDAHUDGBHECBfEDAhAAAAECBBFFA.XFEDhAGAcGBCDFHBLHAA.IHHAhAHA.....hACA...,2,-13,-11,2
dDWFJLNMBUGIgReATCXcfZVQObEKHPYSa,TAAAXAAA.ZACBQACC.EAEEHAEA.SAGEhAAAdAGAFCDDLCFAhAAAMCEBGCFAREFAAAIBfFEEhCAAbFGDKCHBaFDCDGHBNHCB........hDAA......hDBA...,2,-11,1,12
RIJDPMecZLEgWCUGbOBYHQdfXTVFAKNSa,SAAARAAADADA.eACHZAEEEBHF..CAEAGAFABCCAHCEBdBHATDDAhAAAAAAAKDHB.aEAAJEDFhAGAMEHBLFGB.hABA.gFDA.WFHH.OHAChAEAfGCEFGFD..hAIA...,1,7,-35,42
NMJBRgFXeHTDOVAZGdcPWfabQLYSKIUEC,dAAA..PAAAaADALAGBKADA.EBDBMAFABBFARBEA..XCCChBAAHCACTDEA.hBHAOCHDABIBGDEBfEBEhACAbFFASHDACFGAgGFG.DIAAhAIA......hBAA...,1,-14,-15,1
bBeHXQAYWLGNdRSPFVCZUJcgITaOEKfMD,LAAAdAAARADAFAGA.ZADB.UAGA..JCBB..ICAAaCFA.hACAECFBMCIBBCCCHDCBhADAABFAGDGA.SEEBhABACEEBTFGAfGDADGGB.eEADhAEA.XGED.hACA...,2,-30,-13,17
gINBbTYKCcaGLZQUFRVJAHPMfDWXdSEeO,HAAAMAAADAEAdADAEAFA..eAFAOAHD..IBBABCADbCCAhAAATBDA.CBHAGCFAhBAAZDFBQFAAhACARDBAADBA.fEHASDHBgGCBhAFAKFDAaFHH.FGHD....hBHA...,1,-4,-12,8
FVYUMODQXHgBfGbEZLKJNSAdTaReCWIcP,aAAARAAAeADE..CADA...IAHAFAFAUCCAMBEBDAIB..HBEBhADABCCAGCGAECFAZDFELFFBhBAAKFCASFGAhAAAABBBdGCA.TGAA.PHDAOFHD..hCAA......hCGA...,2,-17,-9,8
MQNFDJVdIeaRfXGTLOASYECbcKUBWHPZg,EAAACAAAKACABACA.HADBZAEB..MAHBQAFA.DAIBdCAAeCCBhAAARCCBGCFATDGAAAIB.hAAAbEEDUGBA..gFAAhAFAFEHD.IHHAaEAE.fFDAhBHAOFFH...hACA...,1,5,-23,28
TDCGUVBcKXMPZJaRSYgLWOdHeFENbAIQf,QAAATAAA.GACBBACBKAEAMAFAZAGBRBFA...SCCAhAAALDAAdDFDHCEBEEDFhAAAABIBDDIBCEHAVFFBXEAAhAEA.aEGD.gGAB.WGFAhAGA......hCAA...,1,-3,-22,19
DXJbeWdZaNAPCYcEMFTIGBVHOLKURQgSf,CAAAEAAAFACAGACA.HAEALAFARCEA.QCBAfCBEDCFAhAAAXDGA.eEABhAAAZCFEAAGAPEEBMEEBTFFAhBCABAHBKFHDSFHBWHCAaGAH.NIEB..hAEA......hAGA...,2,-25,6,31
HEcdUeLWfNbQYTXIRPFMOVKDGZgCJAaBS,aAAAHAAA.EADEdADAeAFELAFA..fBFAQCEATCCAhAAARCGBMBBBKCADZDBBCCGAACIBhACASEEDUECBbFED.hAIAXFFDFEHB.DFIBgGGGBGADNICB.hAGA......hAHA...,2,-12,14,26
MFQbPTeGYcERDVZaJXAdLKCSHfIWgOBNU,dAAALAAASADAHADB..IAFAOAFDBAHAMAHBQCAAhABATCBAGCGAECFFREEAhACAZDEFaCHDAADACECA..fFHAhAIANEEA..bGFA.eHAADDDB..hACA......hAHA...,2,-12,4,16
PIVHAedXWLScNMCUKEJaZDTYOQBFRGbgf,eAAAdAAALADA.SAGHMAEAKAHBEBCAZCAEDAIBOBECQCEChACARDDAGDGA..hAAAbDGDfFFEhABA.IGBAHEAAADIBXGECcGDA.CEFA.hAEA......hAFA...,1,-8,-12,4
bJTXVaOScKEdBLAHGQUMeIDCFWfNRZYgP,HAAAGAAAMACAeADACAFA.FAGD....fAHARCDAZDFE..hAAAgEAAbBDD.hAHATFGAaCCBSCFBhCAAEGFBBHDAAAABQEGADAIB.YFDAhCIAXECDOHDA.hACA...,1,3,-14,17
XdfaLQJcEYUgVFSZBbOCAMNWTGHRPIDeK,MAAATAAAHACC.RAFFDAIBeACE.dAFAaBBCLAHB.QCCAhAAAECHBUDDAFEGBZDFAbFFBhBDAAFAAGFABKGDAfHBBhBHAJFHB..YHAA...hCAA......hCCA...,1,-4,-6,2
aKLdBHAcGPCFfeEZTWJMRSbQVYUgXDION,GAAAFAAAEADA.ZADA.JAHBRAFA..QCCAUCDA.DCFBODFDhAAAaCGD.dEADHDABAAGA.CEHAeFFBhADAMDIB..SFDBhACAbGAA.....YFGBhAEAIHHA.....hAFA...,2,-26,-5,21
ZGeXAREFaJPNIgTKDfVYbUSCOWHcLBdQM,EAAAaAAA...JACB..IADAKAEA.DAFAVBGBUBFA.OAHDhBAAHCEBLDDDhAAA.dEAAZBBAeEHFREEAFFCBhCAAgGAATGGAfHEBSGFBCDDD.hCFA......hDAA...,1,-7,-23,16
KbMFSaNYfPAWgEdJLeHTDCORZQBcVIXUG,EAAAdAAAeADAHACACAFBRAGBZABBBAHA....VCEBXCCA.GCFAhAAAMDDBFDHDaCHF..hAEAfEAAAAIBJFGFLGCAhBAATFCADGIBOFFH.IHAAhAEA.KHGA....hAHA...,1,-10,-13,3
KgHZLXWecFMIBUAQDNadRGOCVESfbJTYP,QAAAaAAAGACA.CACA.EAEA..SADHJAGB..TDGAhAEAKAFAHCDCZEDBLFCDhAIAeAHHMDIBBCEAAEEBdEGAhAAARFFBOBBHbFAA..gGFGWFHH.hBAAFHAADBIB....hCAA...,1,3,-4,7
XdVLcRMbBHQWCZGDgfATNISPJUeFKOYEa,TAAASAAA.UADAeACE.OAFAEAFAdBHALBDA.hAAARCFAMCCBHCFBQDBAhABAZDDFDEHBABIB.IFHAhAIAFGFD.aDEB.XGGC...hAAA......hCAA...,2,-16,-11,5
RQfdTgJMZEHabPVcNLXKWOYCeBFGDUISA,RAAAdAAA.JADAEADE.HAFB..aAGAVCCALCCAKAHB..ODFEhAAAeBGFGDGADFAASFFAhABAABDBQECAhACAfGHAMEFB.bFAANICB.....YHAAhAFA....hAHA...,2,-15,-15,0
JbcaYIfEUGLPHTNRSOFeWMQKXgVZCdDAB,BAAAJAAA.aACA....fADBEAFAGBCAHAFBRBFA.FAHFeCBDhAAAMCCBQDGAhAFAKDDAXDGAZEEFdGGAAFAA.hAFAbFDDIFDA.LFFB.PFHBhBAA.SHDChCAA.,1,2,-22,24
NLROZaIWbgUQXBFeAJHVCPGEMfcDSKTYd,HAAACAAAGACAEADEMAFADAEA..KAGAdBGALBEBRCAAZCEB..aCHD.hAAA.ICAA.hAAA.bECBQCGAhACAFEGHAFIB.PEFD.SFHBNIBB.hACAOGCC...hBIA...,1,-8,-21,13
eBJIfgSQAFMEXCHaRPZVOYWcUdKGLbTDN,EAAAHAAARACA.ZADB.OAFC....cAFAdCADGCEALAHBhAAAbCGBDDIBeCCABGDAhAAAfCFAQGFAhACAADAAMEEBaHAA.VFFA.......hADA......hAHA...,2,-11,-6,5
GSLZPYdIacRBTfbMDKeWEHJXVNUQACgOF,OAAAGAAAZADAdAEA.aAFARAGBBBBD..TCDAMBDB..eCFFhAGAHCGB.XEAAhAAAUEGAAAIBFEBBLFEB.hBAAIGDAbEDD.KGGA......hACA......hAEA...,2,-23,-10,13
YeIZFDgcJWBUXAdaNTMLPRGQVCfKHOESb,aAAAMAAALADARACA.GAGAQAFCCBBDHCDAEBBB..bEAAeAHHhAHA.ZDDADDIBgECGhBAAJEFBBGHAAAEAdEHA.hAIAPFFBKHFA.........hBAA......hBIA...,2,-14,-2,12
eOSWcPdLgNGKZBRbJQUIFAHVMCaYfDTEX,HAAAMAAA.aACADAEAEAFA..eAFA.SBBAPAHDLCCAhAAAGBDAZCFBRCFFQECAhAFAFCHDABBACFCA.TFGAhCAAOFGDdHEB..NIBB........hCDA......hCEA...,1,5,-21,26
YADZbEIJGVLeCXHWBQgKdPTUMaNFSROfc,ZAAAEAAAGACAeACEHAFBQAEAdBHAUCCBaAGEFDFH..RCFAOCBBhAAA..fEHAhABAAEABbEDD.IFAAhAFALFFAXGGABHAAKHFAMHAA.SHEGhAHADICACHHB...hAEA...,2,-1,0,1
VYfJPBGOLXcIFKWCMbAdRDUTSNHgQZaeE,RAAATAAAHADBZAFA.ECCBVADA..JCFBGAGALDAB..hAAAXCAAFCHHCFGAAAHA.dDDAhAAADEEBSDGDhACA.QFEDeFHHfGFEOFHDKGAAhADAbGAA.NIAB.....hAGA...,1,-5,-6,1
YcFSfAMgHCNeBEbGJdPaZUIDWXLVKORTQ,HAAAeAAAEADAGADAdAGAZBCEDAFALBFB.OAHDRDDATEGAhAAAQCABFFFHAAIBMGBAhABACDHDbFDA..aHDCIFHAhAAA...WHBAKCHB.SDDDhACA.....hBGA...,1,4,-14,18
REQXUPgOVNFGMeZHJCDbSfILdTacBYWAK,EAAAQAAAUADA.OACCFAFEGCBAZAFBHCDBDAIB...bBGDSCHDhAAALDCDaEABhAAABDDBAAIBRFFA..XDFDhBCA.VFDBeFAHfGGAIHHA.hAEA......hAFA...,2,-18,2,20
HEcZTeMDVPgOJRSaNBYbAWQXCFIUGLKdf,QAAAFAAAGACAdAEBHACAZAGBeAEE.MAIBDBFB...gCDAhAAAREDAaCHDBFGAACGACDFALGCAhBAAEDHB..TFFAhAHA.OECBSGHHYHFG.hBIA......hCAA...,1,9,-28,37
daTQLCYIcFKVeBfPbEHDXRMGZONgWUSJA,aAAATAAALADA..CACB...IAHAKAEAeAGHBBBDbCCA.hAAAHCDA.RCGFZEAAOBHDhAEANEFA.UECAADCBdGCDQEFAhAGAFGGA.fGHADICA.MIAAhAIA.....hAEA...,2,-14,-8,6
RdQWfPUGCKBSMXIYcebLaOVNFJTDAgHZE,HAAARAAAdADA.QADC..fAFAGAFABAHAMAHBXCAAhAAAIDDAeCHFhACAaCFD.ODDBFDHDTFAAhAAAAEFBEFAAPFGBKFDASFFBbFDD.NIABDCCBhABAWFHHCHGA.YHAEhAFA...,1,0,-9,9
bHMfaGdIUPSEATNeOWLXBKFCgQDRJcYZV,eAAALAAAKADAFAFAQAEA.RAGB.JBHBZCAAHCCAMCEBGDFAhAAAdDFAUEAAEECBAEEATFGAhABA..OEHDhABABDHADIAA..cGCC.....hACA......hAEA...,2,-16,-13,3
PYFSMBDbfLdKWTOIUGCHEZcaJNRQgAXeV,eAAAVAAA.FADDBADBDAFA.LAFA.dCDATBFA.OAHFhAAAGCFAHDDAECHBaFCAhAAARDGFACCB...XFGDhAGASFBAMFFBKFFDIHAACGHA...hABA......hBFA...,2,-23,-10,13
LPZYMDRQWVeKBISbEcAgdUGXaFONTCHJf,dAAAGAAAaADA.OADA.CAGA.HAFBLCDAZBDFMAIBRCGF.QCBAhACAeDBHBEEAbDGDAAABXECDhACAFFDA.TGFAhAIAfHAB.DIEA.....hBCA......hBDA...,1,-6,-17,11
SHEcVPWBeQDgFXZRUCaITfNKbGMLdJAYO,SAAAHAAAEADE..VAGBBADA.eAEHQCABFAGARBFFCCCA.aCEBhAAA...TDFAhACAKCHBGDAAdFAAADDBODHDhAFAPEEBDFHBZFDAfHGFMFIB...hAAA......hABA...,2,-27,14,41
CDeIKUAMSZFbGPfaRLQNXTEHYdcJBWVOg,ZAAAGAAAaACA.RADALAGB..QAFATDCAHEFAdBHABCCDhABAODAHDCEBeFCBhAAAKCFDAEGAMAIBFEHD.fFEEhACAEFAA.YHEGcFFC....hADA......hAEA...,2,-31,0,31
CeZNDORVMLWaEdbIFAGPUYcTHXgKBSQJf,GAAAUAAA..TADAHADAKAGC.QCDBCAFBZAGB.OBHDhAAARCBAMBIBaCFD.EEGFdCFChADAFFAAAEEB...cFGDhACABEGAfFFE.eFHFDFFBWHCGhADA.....hBAA...,1,0,-29,29
NRbOPQWHTGBIXVZEYSLafKAJegdCDUcFM,eAAAdAAADADAFADDRAEA...OAFAQCBAHBEBGCGABAHB.XEEChAAAECFALDDBhACAaCCHABGB.CCHAUFFA.MEIBhBAANIBB....WFHH.....hBCA......hBDA...,1,-10,-25,15
aQDfZBLCAeFGUWEcTdVgNIKMbOJPXHSRY,eAAAGAAAEADAdADA...VAFAIAGAMCFB.OAHD.XBDAhAAAHDBBRDGBaDDFQDDChABAZGDACFADAAAB.FCGH.hACAcEGDNIAB.bGFA.SCCD.hAFA......hAIA...,1,1,-6,7
JdGfBFATZOEcMQPCUReXNVHKLgWDIYaSb,ZAAAEAAA.MACAQACAUAGA.RAEA..eAHHXBDDHCFBLDDBhAAADCCB.aCCHbDEAdFAAhAFAGFBBFEHDAFFBOHAEhAHACBFCKFHB.gGGG..YFFBhABA.....hCAA...,2,-18,13,31
XeQTUGZSgWICDLaHbKOVEBAPMFdJYfcRN,MAAAdAAAJADA....fADARAGF.eAEHTCBAZAFBSAHHhBAA.gBBDhBHACCFDaCHDHECAbDEAhCAAOEGBEFFBBFHAAEEAFFHDNIDB.QGAAhACA......hAGA...,1,1,-25,26
cDCMLPXbSNBQYHdAgEURfJeGWVZTaFOIK,EAAARAAAeADEGACAZAGB.FAEAKBDA..CAHALCFA..bCCCBCBDhAAAHEEAACGAUEEA.hAAAJEBBTGAA.aDGEhABAOEHBDFIBMICASGHH.YHAGhAHAdGGAfGCBhAGA...,2,-17,-11,6
cTJaRMWEfQHgeUCFGAOKdLSPXBINbZYDV,dAAALAAASADABAEA....bAFDZABB.DAGA.TBFAhAEARCAAEAHBHDCCeBHHFCEHACAAKDHBhABAXDCD.IFFAhBAAVFCBaEACMEIBQFFACGEDOHBC.hACAPHFC...hAEA...,1,-1,-9,8
UgYefJGNVIERBXObaSFLcZQdCPTADWHKM,HAAAMAAAUAEAeACEGAFA..IAHARCCAOAHF.aDGDLBBBhBAAZEEFdFAACGGBABDAKCGAhBGA...fDDAhCAANEIA.EEFA.bFDDSHAAQFGAhCBA.DIGA....hCDA...,1,0,-22,22
dAEeLDRSIfTKWOZVGagUcNYBCQHbJXMFP,EAAAeAAARACA...SADA.TAGAOAFA.GBEBhAAAaCCAUCGBcCCCBDDDHDABhADAXEAAMDFBdDHAhBIAAAAALFDAfGEEZGAANEHAQGGAhCAA......hCBA...,1,-3,-7,4
UaQOMYPeZIdETGBXLKWRcAVDCHNSfFgJb,CAAAHAAA.SACEFACA.JAFAaAEDMBFBeAGB.dCBAGCCAhAAALDDARCGBACCBDEGB..hAIAfDHAbGCA.hCAAQFDA.OFGB.PHAAhAAAEGHB.BHHA..hAHA...,2,-29,-3,26
BCJfFKUAaZYRDNVObdHeXLISEQcGWgMTP,ZAAARAAADADAOACAHAECLAHB.ECCAGAFA.MAIBTCEAhAAACCCDFCEHAEEB..aEGAVEGBhABAdFFA.eFBA.SFFDhAHAWFGHBHCAKHBA.NIEB.....hBFA......hBHA...,1,-13,-14,1
aZOVbSYXHTFCJEKRUDAMGNdIfWgPceQBL,GAAAdAAA..fADAPADA.eAEHLAHBZABB.bBFDXAGAhAGAHCDD.TCFAhAHACDCDEEHFRFCBADDB..MDIBhBAAIFFA..gEEBBGHA.aFHHhCHA.SHEAhDAA...,1,0,-20,20
HNWIgTDdOXcBPMfZAVKUSFQeaGCYRLJbE,KAAAFAAAeACHGACARAEA.LAEA.EBHFHCEC.IEAAhAEADCABdCFAODHDBAHBMCIBhAFAAAFAUFDAaDDC..CECDJEGBhBAAbCAD....gGFB...hCAA......hCBA...,1,-12,-21,9
QLGaVFHSdeCXTBOWNfEDZRgIcYMAJbUPK,UAAAQAAAGADAaACEHAFA.eCFATAFAODAA..fBHAhAAAEDHFREFB.gCDAhADAIFAAMFEBhADAAAHAbDFALFAASFHHdFFABHAADDCBcGDBhAFA.YHFGhCAA..,2,-7,12,19
UaCGVJPIDTdHXQgNBRZbAOYLWKFSEfcMe,LAAAFAAAEADA.MAEAeAFAUBEAGCCA..VCAAJBHBDCFBHBGDhABA.QECAhACABDAAREFBACCB.ODHDKEHBSGAAhADAaEFBCGFA.TGDA.....hAIA......hBIA...,1,-10,-17,7
ZHEADJPcbdRYgfBLMKFVQCeaUSWNTXIOG,DAAAJAAA.....bABARADF....fAFBMAFAFBFAQCCChADAeAHH.aBHDSCCDhADA.TDFAhAHAOCFBHFCAAEEBdEGABCFCLGFACEEDUGGAhBAANIEB......hCAA...,1,-16,-21,5
FMHZPNAaTIVEfKGgSDcWeUQROXBdCbLYJ,aAAATAAA..EADAGACADAGA.eAEARBDABBBDdBHALCFBhAAA.FCAHHBGBZEDBAEIBfDAAhADASEAAcDDChBAAQFGD.CHCD.bFDA.MEIB.hACAIGBAKHEAWFAAOHFEhBGA.,2,-27,11,38
FIAOCeZcMKVGBRQPLgNbaXTSUEHJWdYfD,eAAAZAAAMACAGADARAEA.LAFA..bCCCaCCH.SCFAhAAAHCFBdAHADDIBAAGACDHAKEFAhABAQECA.gFFAhABATGCAEFEBYHDAFGGAODBHBHHAhCAA......hCBA...,1,1,-10,11
bBZIecVLfaXDEdAKCJNSWGgPOQYRMUHFT,CAAASAAAGACA.OACDRAEAHCAB.FBHDTAEAZDFA..eEDFhAAALAGB.aCDDEFABhACAAAAAKDFDNIAB..PFFBhAEAMAIBbEAB.BEGAIHHAfFHAhAEA.dGCA....hCAA...,1,1,-18,19
HeDZIcUENdXbBYVaQWLgSFJPOCTfKAMGR,RAAAHAAAeADEZADB.UAGAEAGE.dBFCBBDA..aCACLCCAFDGD.hAAAOCFDTFEAAAAAGEGAhAIADDIB..IGHAhACANEEA..YCHH...WFFDhCAA.....hADA...,1,-14,-27,13
MPLDfJcUOXdGHSFRgeWNKaETCQbAIVBYZ,BAAAZAAAMACALACADAGA.JAGBUBEA..dCCAHBGDRDAB.eCCBhABAKCHB.EEEAQEDAhAAA.AADA.IFGAhBIAVGFA.fGHA.OECHGGABhAGA......hAIA...,2,-21,-13,8
KeaZUcRCNWDAbVFBGQfdgYHLPSTOIXJME,FAAAGAAAdADAHAFALADA.TBGAXCCCECDA.eCFAZDCAREFFCDHADDBBhAFAAAABBAHB.QFAAhACAfEEAgFDDhAEASFCBODHFMFGBaFHB.NIAB..hAFA......hBCA...,2,-9,2,11
VEMGdQUHWDAOZKFBIRfgYNTaPLCJXcebS,ZAAABAAARAEA.....fACANAIA.aADDLCAB.hAAAXCCAeAFAbBFAECFAhABAdCAAHDGBAAFAFDDAgFAAhACATDGA.CEFCSGGAGGDB.WHAAhADADGGA.....hACA...,1,-6,-20,14
MYNTgHWdcSeDEfVXCIQUZLaFbAPKJRGBO,KAAARAAAGADAMACA...TAFAHAECdAHAeAHHEBCF...XCEChAAAQDAAZDFEaDDHhCAAAAAABDFA.ODDHhADAgFCGSDHHfFGACFADLFFBhAFA.FHAA....hAHA...,2,-9,-4,5
bDIPQNaEGYeMHBLCXZcfAKSgdJFRWUTVO,SAAAdAAARADAUAGA.OACD..DCCBQAEAECFB.eAHBhAAAHDABLCEAhABAZDCBAADAKDHBFEAA.TEEAhAEAIEEAaEGAGGBB.BGGAXFGChACA.fHDBhBAAWHFA...,1,8,-32,40
ZeRdgKUaONfLMXYDScbHVAICJWQPBFTGE,CAAAQAAAFACA.EACARAEFdAGA..KAEAOBCBLAGB.MAIBhAAADAIB.SCDAhCAAHDDAADGA.IECAhCDAJDHBBFFAZEEA.eFHHaGHD.XGCA..hCEA......hCGA...,2,-39,-9,30
gdfVYGPeMUCNKcZWbAQTRJaDBLXHEFSOI,RAAAaAAALADBHACBEAEAOAFA..dAHA.VCEAGBFA.eCCDhAAAMBBBCBHAKDHBZEAAABGATFBAhABABDHASEEDhAEA.fFFBPEEBcGGAWFHB.hBAA......hCAA...,1,-9,-11,2
XRAHDBZUQcCgMdWJaILGTVfOYEPFNSebK,HAAAZAAAQAEACADBdAFA..aAHBGBGA.TCAAOBHDECEBhABAFCAHeDDBXCCAhAAAAACABAHBUEFAMEABIFBAhACALFFA.fGBAPFDBSFHBhBFA....hCCA...,2,-18,4,22
cJUdgHbTWfLNQYGCMXZFPDKIBEaSVOeAR,RAAAUAAAHADB..TADALAFA.QCFAGAFAMAIBZDAADCIBhAAABCDDEEEBaDAAOFHBhABAAAHBdEEA...bGAAfDHEhADACCCDFGFD.KFAA.SFDDhAFA.eFHB...hADA...,1,-2,-9,7
JTOdSMUEfYeKLGbcZNCIAFaRWVXHPDgQB,RAAAXAAAHADBDAFABADA..TBGAdAFAMAHBECCB...eCDBhAAAGDAAZDAACDGDAAAAaDFB.hABAVEGBQFBChADA.SDHHfGEALFFBcGBD.hADAIHHA..hAIA...,1,2,-21,23
ZWGfHbYKEUFMVXIRQAgJdOecBPLTaDCSN,dAAAeAAABADALAEADAFA.SAHHZABBGBEAHBCA.bCFDEAHFhBAAFDEB..MCIBXFAAhAAARDCBABGB.ODHFhABATFGAaGGB.CHDA.fGEA...hAFA......hAGA...,2,-26,-2,24
CZHMJLDPYQRGgSAcTaEIUfNdeVFKXWBOb,aAAAEAAAUADA..dADAeAFAKAFABAHB.CBBD.HCBALCFAhAFADBIBQCFARDBA.hBAAGEEAACGATEFAfEHAhAAAFFEH.OGAAMEIB....YHEGhBDASGHH.hCAAIHDA.,2,-22,-6,16
GbYHSOBUJcTKXMQaeRALfNgFVIWdPCDZE,LAAA..fAAAFAEAVBDBdAHADADAEAFAGCAAHBCABCGDhABAUCGA.TCAAhAAAMDIBeEFBAAIB.IGEAhACACDEAbEBDOFFA.KEDDaHBAgGDHhACA..WHEA.hBCA...,1,-10,-11,1
gLYAaTDKPGUQCZJEMWRVOHIfXFNcbBSde,aAAATAAA..KADAGACAQAFCZAEAECABRCCAHCGB.XBBChADAFCEDbCFDBAHB.hAHAeDHBLEEBAAFADGGBCHHAhAAAMAIB..........hBAA......hCAA...,2,-17,-9,8
EdFBgDOaXTWfbRPUIQZGVHAcYSeCLJNMK,SAAAeAAALAEAMADAEBCF.BBHAOAFE..aCEATBCAhAAA..bDDBRCEAIEBAhABAGDGAHFAAACHACDHAKEEDhAIAFFFHDGIB..fFCA.QFGAhBEA.cGFChCAANIAB,2,-29,-11,18
ULEOIJMBdbCgARXSYFNZfHeaKPcTWDQGV,RAAASAAAFADAZAFB.HACBKAHB...TAEAQCCAGAGALDHBhAAAEDEAODHDMEFBhABAbEAA.AAAA..XEFDhAEAfEGAeGAEaFCA...PHCChCAADIAAIHHABHHA..hAGA...,2,-13,0,13
VOgDbHIKFPGRUecAJQZXMYSBdEaNTWfLC,ZAAAMAAABADBdAEA.EAFA..aAGA..TBGALBBB.OBDHhBAADCAAHCDAFBGBRDFAeDHFhABAACIB.QFAAhACASEEDfEFACFHA.bFCDKGGDUGGB.hBEA......hCAA...,1,2,-25,27
NOEWcQCJHTLYGSUdXZfAKPMgRebIVaFDB,MAAARAAAeADE..VADAaAGA..BBDA..EAGEQBGDhAAAHBBBTCFAGCEAdCHAZEDAhAIAACCBKDHDbFGDDDDB.OFHDhABA.CGFA..........hBAA......hBBA...,1,-12,-17,5
HeCVLPdTJOaBGFMANDWRcQEfXZKSYIUbg,DAAARAAAEADEZABE.KAFA..SAFBUCCA.HBGBeAHHLCCAhAAAdCFA.TECAaDABGEGAhADAAAHANEGA..WEEBhABAQFAA.XFDAIHHACHAD..hBIA......hCAA...,2,-18,-16,2
KeWObLAgGPMfSUIJTCNBdYaEXcHRZFDVQ,GAAAMAAAUAEAJADA...CAGA.dAGA.ECDAHBBBZCFE.DAIB.QCGDhBAAeDBHOEEBABBB.hBDA...fDEAhBEATFGABGFDaEDHRFFA.KHEA.....hAAA......hACA...,2,-26,-13,13
LYEUBJbgZMCeAWfOTHVPcIdFKQDXNSaGR,OAAAHAAAVAEA..IAEAdAHAQCABDAGA.SCEDhAAARBBAEBFABBHAJDCBZDDAeDGBhACAADFA.TFDAFDHBXFFChBAAaDHFLFFB.YEAF.hBBA......hCAA...,2,-34,22,56
UceOEFLGIfXgYbdAWHPVQZRTSJaMCBNDK,HAAAQAAARADF.SACAaAFAMAIBBBFAKAFAUCDA.eAHHhAAAECABGCGA.XDDAhAAAbCFDADAA.PGDAhACAZFAATGGACCCD.DDIBFGHDLFDB.hADAfHAB.hDGA...,2,-6,1,7
HRBPNQgWKVeJbTCAFDcfIMLdYXOESUGZa,DAAA..fAAAMADAdAHA.OADAEBBAGBDAHAGBRBCABBFAQCADhAAAKDCD.eDEBhACAbDFA.AAIBFDGHLFFBhBAASEHHaFBC.gFDDJFHFTGDACGBAIHHAhBCA...hBBA...,2,-14,8,22
SdWHfGPMcVbYEFQLKXRNeZAUTJaDIBOgC,TAAAaAAABADA..CACB.dAFAHADBGBGAMAFA..VCCAEBFELBHBhAAARDABZEFF.ACCBDDDBhCAAOEHDSDGDhDAA.fEEAcFBD.FFHD.KHDANIAB..hDBA......hDFA...,1,-9,-14,5
egXNSUICfJZEcKWPAFGaYQbLTHOBdMDVR,aAAAQAAALADAHACAdAHA.MAEARCCA.eAHF..XBBChAEASBEACCFBZDFEEDDAKFAAhAFAACIBGDFA.YEHBhAAAbFGBBHBADFEBNEEA.......hBAA......hBHA...,2,-15,2,17
HfcdKUMVWILXOaeCBZbFADJSNYgGEPTQR,SAAA..gAAAEADA.TADAHAFAdCCAMAFAhAAAICHALBGBaCFHhAAAeCCBZDABAAHADBIBYEDBhABAGDAARCEFKFFAVFGBOFHDbGCA.FHEE..hADA......hCAA...,2,-7,9,16
LUCNdQeSHDaBMOWFEPVRcZJIXKAgTfbGY,TAAAGAAALADA.CAHAdCDAeACEHCFAaAFAMAIBFEAHEEFBRBEAZCCFhAAA.JDBBKEHBADGA..hAAA.bFCBUEEA.SEHBhBDAOHEA.PHFAIHAA..hACA......hAEA...,1,-3,-8,5
ZJSDTAaGVegUFKdEXBRQHIPLWbYCOcMNf,GAAAeAAAFADDEADARAFA.HAFALCCA..bCDBOCGDMCHBZDEBhAAADCIBAAAAaDAH..UFAAhAFAdGGABHAAQEEChAGA...IGGA...WFHHhAIA.CGDD.NCIA....hCAA...,1,1,-20,21
CPXOeIcMfLGFVYTSdZQEJgANDaBKUWbHR,aAAAKAAAUACAHACBRAEA..CAEA.OAHD.eBBDMAGBGCFAFAHB.hAAATEAAZDDA.EEDBACFBBCHAhCAA..bFGDXEGDhCBAfHAB.YHDESFFDhDAA......hDBA...,1,18,-46,64
RCfNXQHBAeGZaLTDcYVbgdEIPJMSUFKOW,eAAAaAAALADADAEA..VAGBdAHAEBBB..JBCBMCEB.FCFBhAEAOBEBRDGB.CDFA.XFAAhAFAHEFCAAAAZFBATGFAhBAA...YHBGgGGA..hAIA......hBFA...,2,-28,-6,22
dDNSCFOEZLTXUJPfKgIRGBbVQWeAaMYcH,aAAAMAAAHACBdAEADAGACAEA..FAGAZBBB.LBGBUCFA..JEAAKDDAhBAAREDF.GFDBBCHA..hBBAQFGAABIB.hBEA.cGCCSBBDEGHF.TGBA.hCAAfGFE.hCBA...,1,-14,-26,12
MfVaOFZSJEeITRWXcHCKYAgGbBNLDUQPd,GAAABAAALACAQADAdAGAMAIBaAFEZCDA.EBHFeCCA.RDAB.hAAAXEECHDEAKEHBAAABbFGDhACADFGBUGDA..hADAfGAAFGBDSHGATGCA.CHEA..hAEA......hBGA...,1,8,-6,14
eDVLgQGfOaNMJSTBRAEIWYZKdbUCXcFHP,EAAA..IAAAZACBdAFACAHAFACA.HAEBeBEDLAGBGCGAOCBHhAAAaBCHMAIB.TEDAhBGAACIBKEEDUGDB..hAHAXFGADGGB.QGEDfFBA.hCAA......hCBA...,1,-13,-16,3
CPWOcaHeGLEDZINgUKQfYdXTBVFRAMbJS,MAAASAAA.CADA.OACEHAEBeAGBEAFEZBBA...ICFAhAHAgCCB.QDAAhAAAdCHATEEAFDFDhABAAAIBbGEAPDHD.aAHFDDDBKGGA....hADA......hCAA...,2,-20,-9,11
fIPOQZVcdCBXMAKURHSEGgNYaeDbJFLWT,RAAAHAAAEADE.GADA...gAFBaAFAeAHHDBGBFCAHTDFAhAAA..fCCAhAAAOBHDZFBAdDEAXFFAhACAADIBSECHYCCFbEGD.LHAAhADAIGEA.....hAHA...,2,-18,9,27
ZQUIAPTfgCFENMSaHbOeBRLXdVWKcJGDY,TAAACAAAFACA...EACEMAFAHAEB.eAGBRBDAdBGAKCCAGCBAZDFEQEAAhAAAABIB.fFGAhAEASDFDaAHFhCAAbEGBBGDA.........hAAA......hBCA...,1,7,-37,44
gLQEAXURcVHIFYSafbTBJDGdOZWCNeKMP,RAAAHAAAFADA.aACA...TAFADAGAdBGAZCCACCCA.eAHH..MBIBhAAALECB.ADIBXEEAhAAAVDEB.SEHDhAFABCECGEGAOHACKGCA.....hABA......hCAA...,2,-36,2,38
VaSEZKeBHdQgYCPRMDJcFWAOTNUIfXbLG,TAAAUAAA..XADAGACA..aAEAEAGAeAGHHCBC.dCGAQDFBhAAACDAD.REBBMAIBhACADBIBFECHABEAOEDFhCAAfEEAbFFASHFAZFGBBGAAgGDAhADA....hAEA...,1,13,-18,31
TKfVQSRCIHbMZUOYAXeNPJaBDGdcWgFEL,eAAAJAAABADBdAEA......gAGAEAFALBHBKBCBQDEAhAAARCCAHDFBZFAAOEEHhAFAAAGAXDGA.aEBAhABADCFA...WFHHTFGA.SHDAhBEACHGCMIAA....hCAA...,2,-20,-19,1
aYgMQSCBFPdcJGRWLZKVUEOHbTfNIDeAX,aAAAMAAA..QADABADAdAFAGBBARAFAZCCAKCGAEAHBHDAA.TEFAhADAfCGA.hAGADDEBABBB...XECDhAIASEEDFDHDcFEDLEHBOFBHhBAANIAB.IGHA.hAIA...,1,-6,-12,6
NOLfcIFKYeDbgVdQBWUZJCGPXAETaRSHM,EAAARAAAHADB.MAFALADA..fBFBFAHBeBCBbCDDdBHAQDAAhAAABCFA.hAAAZDDAGDGAADFAaEGDOFFHhABAKEAADCIBgGEA..WEHHhADA......hCAA...,2,-11,-7,4
UMPBDGfAaQKebXcJYgNVSCEWZRTOLdFHI,aAAAeAAA...XADAJADA....gAGBSAGAhAAAEBBBRCCATCGALCEBhAIAHEAAMBDBDEEAACGBbDGDhBAAcEGD.VGCAZGEA.FGAH.IHHAhABA.BFFC...hCAA...,2,-23,11,34
dNPAVHCOSXbFgWeMKcQfIGREZYBTDLaUJ,HAAASAAAFADAeAFHMADAKAHB..QAGAGCABECGFZBAEBDHAhAAATBEALEEBhACAaDDBdDGAAFIBOECD.hAAAXGFDbEBDgEEDfHABIGHAhABA.DDIB.NIBBCGED.hAHA...,2,-8,10,18
BebOLZcCIADTaXSQGHMPfdJFgRKUVEYWN,aAAAQAAAHACBMAEAdADAFAFA..RBEFKAHBEBFB....NAIABDBAhAAAeBBDbCGD.ZEBACDDAACHBhBCATGBAGEFAfFFEhBAAUFDA.........hBDA......hCAA...,1,3,-22,25
ZUcWXBACVbQfFRgYDGSaLTOKPJNIdHMeE,CAAAQAAARACA.DADAaAFALAGB.KBDAPBFD..hAAAIDBAHCAAEBHFZDDAhAAAUECAXEGDAACAbEFA.hAIAFFBA.GGCBOHEANAIAMIFA...hCAA......hCCA...,2,-18,-4,14
QeFLVKOXPgJWRYHSfNZUbIGBECdDTacMA,eAAALAAAOADCXADD..gAGBRAFAHCAA.SCCAhAAAZCEEbDFAGFABhABAECFBdDHAaFFAACCAFEEBKGGD.PFAAhABA...YFGFNIAB.BGCAhAFA.DIAA....hAIA...,2,-14,9,23
MceTAPEYGXgVUZDaCJfSdQKONBbHIFWRL,EAAAGAAA..XACAUADAaAFE.CBHA.SAFA.dCCAhAAAQCFDOAHDbCFDhADAHDBBFEDD.RDDBMDIBhAAAeDHBAAFAgFGDDCFBKGGA.BGAA...hCAA......hCBA...,2,-15,-7,8
EKGTeOgbMcNUCdLBaRYPHSXfWIZFQDVAJ,EAAAGAAA.eADAOACCMAHBUAFALCDARCCAHDFASCHHhAAA.XEAAhACAfEAAZECBQEFChADAAAIBTFGA..........hAEA......hAIA...,2,-24,-3,21
bMXKPNIgJTCSaYfAEReUFQGdHOWVcDLBZ,RAAAeAAAQADCHADAOAFA..VAGBLCCAZCCA.bCFDMDGBhAAAKBHB...IEHAhABATGGAaEEBAAFAEEEBFHDAhAAAdFCA.DGHB.........hABA......hCAA...,2,-14,-9,5
gbLfKJWPOVXUCdRTNaHMGQIFAcZDeEBYS,ZAAAEAAABACASACELAEAKAFA...JBHBOAHD.XCCAhABAdCCARDFBaECE.HFAAhAAAGCFAFFHD.ACFBeEHFhAFA..bGCAfHAB.PHDAhAHA......hCAA...,2,-20,-13,7
ZMGcCENXQgbKBAIHTRYeWFDUfVJdSOaLP,HAAARAAAeADEDACA.UAFAJAHB.dBEC..aBDDZCCF.GDGA.EFEFhAAAQDEA.hAIAbEGBABHA...TFCAhAAA.FGABSGDDOCCHMFIB.NIDB.hABA......hAGA...,2,-23,-14,9
XWNLAEaSMGKdHYUBZRQPDIVObgfCceJFT,EAAAaAAAGACAHACABAFBRAEA.QBGADAIB.OCCB..hAAAbCEACDEAeDFHTEAAXEADhAEALEEBAAHAMEDBhCAAdEGDUGCAZEGB.IGGA.fHAFhAEA....hAFA...,1,2,-11,13
YSdRLMaZEDHUBVfcGPbQIWegJKTOCXAFN,FAAASAAARACFLAEBZACBHAEABAGA.VCFAGCFA..bECAQECAhAGA.eAHHhBAAKEHBTGAACEHA.hCAAAAAAdGGAEGHBDFFB........hCBA......hCEA...,2,-17,-9,8
PTLgMeGUCSbdQcARFZaWHNXDJfKBOVYIE,RAAAaAAAHADB.DAFAKADABAHAOAFA..VCFAEBBBLCEAhADA.eCHHGDAASDCHhBAAdEEAAAAAZGFEXEEAhBGAfCCE..IGCAgGBHhADAMFIBCEHA.....hBFA...,2,-16,-15,1
UGReZVWQNdbYEIDJHaKLTfBCXPSOAgcFM,FAAAGAAARACFZAEBQADA.dAGAEAGADAIBHCFBaCDC.LCHBhAEATDFA.CECA..SEEDhBAAAAABMDABeDHHNHDB.hBIAbFBA...IHHA.fFFEhACA.BHDD.hCAA...,2,-24,6,30
WfSARKdDVGFNXcYeTIUEaQZOLgPJMbCBH,RAAAdAAAGADAFADA...XAFAeAFHTCBAECCB..ZCFELAHBhACAJDAB.MDEBbEFAHGAAhAAASDFH.hABAABHBDEHBcGEAUGGBaGGFOECDCHED...hADA......hAFA...,1,2,-15,17
IMGUFDaWZOfcARBgTHLJEbVdKNXCPQYSe,RAAATAAAHADBEAFA.dBHAXACB.QAEAeCCBGCFAhAAADAHBZCCAfDAAhABAAAIBLDGBbFADKEEDCECASEEAhAAAMEIBaFGDOHCABGBA.....hBGA......hCAA...,1,22,-23,45
gbOGEReTZJMfWQUBVIXAKdLaNDYcFPSHC,dAAAaAAA.DADAFADAHAEC.CAHB.OAFDGCABRBBAZBGB..MCFBQDDAhAHABCGA.XEGAhAIAACIBLEGB.cECBhACASGGB.......hBAA......hBCA...,2,-29,-23,6
SJAIYXgFaLWTNZCeVMEOBUfdDcRKQGbHP,XAAAaAAALADA..TADAZAGBeBBBEAFEBAHBdCFCRDCFGEAAhAEAHCDCSCGBhAAAACIB.gDAAhABAFEGDCGHAMFFBfEEE.KEGD.PFHDhADA......hCAA...,2,-10,-9,1
JVLFHIdaACecbXWPZRDgEYUfBTNOGQSKM,eAAAXAAAZADBRAFADADA..EBCFUAGA.BBDATCGAGBEAQDEDhAAAMDBB.LFCAhABAHDGBaDDHAEIBbGACgGBAhAAA.fGEASFHDKGGD.hAGA......hAIA...,2,-8,-8,0
YfKgSPUNbcACReXOHWBVTJZDLFdEGaMIQ,RAAAeAAAHADBBADA..TAFAZAEBLAHBEBHFGDAAaBGBMCCBhAAAQDDB.KDGDSDDDhABAPEHDNIABAAAAOEEAhCAA.VFGBFFFH.dHCB.....hADA......hAFA...,1,2,-8,10
RcZSCKAQVBbPdLDIHOeJTWEfMUGgYNFaX,QAAABAAAdACALAEAHACAeAEE.TCDAEBHFMCBBGCFAhAAA.NAIA.aCDD.RCFBZFAAhAAAKFCAACHB.bFGDDDIBOFFHhAHAfFEA.UGGA.....hCAA......hCFA...,1,7,-16,23
PYLHgDFbOVNRAfCGWJSQMKTdZXaUceIBE,GAAASAAAMADAdADAZAEEUAFA..eAHHECCBLBHBhAAAHCDCFDCHbEEAODBB.RDFBAEEBhABACGCAQGEAhAAAKFDD.aGHDBFHA.PHDCDDIB....hAIA......hBDA...,1,8,-17,25
BZQeNfaXCMSKIHVcRdLYGOEDWPgJFTUbA,ZAAAeAAAaACAMAEA.KAHBHAEB.RAGBdDDAGBCAEDGB.DBEA...hABAPCEAFFEDTGAAhAGAAAAAQDGAXGFDSEEBhCAA.IGGA...hAIA......hBIA...,1,-12,-19,7
dgUCHKbDIWaZPLMXNRAYSTfeQJGVBFcOE,TAAAeAAAGADA.FAFAEACEdCGACAEBHAFBDAIB...aAHFZDBBMCCBhAAARFDAAAAA...fDDAhBHAJFHBBDFC.ODGDhCAA.KFDAIHFAWEHHXGEA.hBDA......hBFA...,1,-3,-26,23
TAQSFYCWJeUfHNMPDaIGcgRLVbdBZOKEX,QAAAFAAACADA.eACAHAEB.MAHBaAFDGBGARCCBLDABdCDAZDABhAAAEDGB.AAHA..SDFDhADAJEFF.fFHAhBFADAIBgGAABGEA.KFHB....hADA......hAGA...,1,-5,-20,15
OQPJTEZVDfdBgYRNMLSKWHAeXcFUCIaGb,eAAAFAAACADA.GADA.QAFATAFAZCCADAIBBAHBRDBBLDGBhAAAKCGA.HDEBACEAUEEBhADAbFADOFHD.EGEBhABAdEHA.NICB..MFAA.....SHFEhAFA..hBAA...,1,18,-35,53
JCRYMLTaBeQHbSVcPEXDZOGKdUFgNIAWf,JAAARAAAMADALADB.BAFAHAFC.bBDD..SAGHhAFA..PCGBECFBZDCAhAIAGFCBdDHAFFGHICCAhAAAABIBCHEA.aDHD........hABA......hAIA...,2,-31,-17,14
YMHIgdSFUCABZPGKeRaEQDXVJcWObNfTL,ZAAAGAAARAEA.EADAQCAADAGA..XBFAVCDB.JCDBOAHDhABA..bEFATDGAhACAMDAB.HFAAdFBAFFDDhAAAAAEAKFFAeHEAaFHDcGCD....hADA......hAHA...,1,-6,-8,2
HbXTRSVLeOFUNKQBdaCAIZPGEfJDgWMYc,ZAAAEAAADADAMACA.HAEC..TAFARCCALAHBeAHHFBCAKDFAdFCAhABAACCBGCEA.JDHBgEEGhCAA..hCBAcGDASEHHOHAA.QGGBhAAAaHCECHFAIHHA..hCCA...,2,-11,-8,3
WYRESfgeHKVXFLcJPGaIMObZBATdUDNQC,dAAADAAAQACACADA.RAEA.EAFA.SAHHeAHHHCFBKCBAFBBHhAFALCEBJDDB.aCGChACAMDIBZDAA.AFFBTGGAhAHAUEGA....YFAA.fGFEhADA...hBAA...,2,-20,-17,3
IGEVLJZNbQaBfCMcXHgTFAWDOUePYSdKR,OAAAeAAA..SADARADAEAGE.LAGBZCCAQCGAhAEAaBEECCCA.MBBBHDEATEFAhAIAAAAADAIBUEAAdFCAKFHBIFGAhAEA.JEDFBHHDfGHA.hBAA......hCAA...,2,-14,-8,6
LbcSePGNYTaCMDOKRIgEUfZQBXFHAVdWJ,dAAALAAASADAeADHGAFA.TCAAaAFDMAHB.KCBAhACARDEBEAHBZDAAQDGBhADAFDHBHFAAAAFBJFHB..hABAbEDDNIABDGGBOFFC.IHHAfEDEhACA......hAIA...,2,-10,7,17
dUbSDeRXHYGfKJLCVaWFEgANOMIBTPcQZ,MAAATAAA..QADAdACAUAEADAHBRAFAHBBBGDDAKCGALDEBhAGACCHA.aEHBEDGBABBBOFHDhAIABEBAZGFASGEAhBAAXGBA.........hAAA......hAIA...,1,-4,-25,21
HUfVcXTQILMYWPJEeFDOdBKGbNZaCASgR,RAAAHAAAUADAVAEA....TAFALAHBMAIBPCAB.hAAAECCAeCCBODEBdDGAGEDAhABAZDFFAEHASFFDhAAAfFHA..cEADIHAAYHCAhACA.....hAHA...,2,-23,11,34
UDVeLBWHgZfPbMCQdRKYaXGSTEAJNFOIc,FAAAOAAAUADADAEALAGBHAFCZBBA......bCCCMCFBhAIAdEEARFBBaCGC.GDBAhBAAEEHBAAIB.IEGA.hBAAeDDBBBFB.fGFAQGGAKHGA.hBDA......hBEA...,2,-21,-11,10
fEWcBaDAFQJNKHTUOCRebSdLYZMPVGIXg,QAAAKAAAHACBOAEARACA..eAFEdBEAZBGBMBGBGCAA.hAAAXEECECDABCHAACABFEHDhAAATDAA.bDEDLGCAhACAPEHBIHCAfGGE...hADA......hAIA...,2,-15,-2,13
QNGcWHJTOLUbIPZFMeXfDaKdBCVYERAgS,QAAAGAAAHADAOACCLAGB.bCEDZAFB.eAHFDAIBdDCAhAAACCDAEDCBADAB..SDGAhACANCIA.JFABTEAAhAAAIFHAMEEAaGCABFFA.YFHFhAEAgGGGcFCD..hAFA...,2,-18,10,28
GdBRHFTUbSICVeMcNDQXEZJgPKWOfaALY,GAAARAAAHADBFAFAUADA..SAHHCAFA.eCCBMAHBDCGBECFFhAAAZDAFJDDBKDHB.OEEBhAAAAAIBdEGABFFC..hACAbFGDIHHA...NCIA....hABA......hADA...,2,-27,-13,14
TIWLGHEbVYQKcSAPDfRdUCBegOZXNaFJM,DAAARAAAdADABACA..eAFAZADB..aAFDMBIB...TCEAhAAALAHBHDGBEBBBbFAAQDEAhBAAKCCD.ABHBUEGAhBFAOEEB.FGGHIHHAWHCA...hABA......hAFA...,2,-30,-8,22
TAQWaYXFcfgUdLbPNJIOVDCeEZSRBMKHG,aAAAFAAA......fADAdADAbAED.JAFAOAGD.CBBDEDBAhAGARBEBMCCB.HCGBhADAAAIBQEEAXDDDgFGAhAIALEHBIGBAeGCA.BHFAhBAA......hBDA...,2,-22,-10,12
dJeQULFIEBDbRKfOYgcPaXZMVTNGCAWHS,HAAAdAAAeADALADBEAGA.DAFARCAA.OAHD....gBGAhACAaBFBZDCAMCABTDEAhADAGDGAACEA.SGCAhAAAQEAB.FDHDBHBDbGFAfEDEhAEAcGED....hBAA...,1,-4,-12,8
XBJfAEQMZPbSLeGKDHTgYIRacFCOUWVNd,EAAAZAAASACEGACAHAEA...TCFAgAEHREAA.aAGDhABACAHBOCHD.VEEBhAAAdDDABCHAACBB.MCCBhAIAbGAAeHFADDGBIEHA.FFED.UGGAhBIA.....hAEA...,1,5,-11,16
GbPTCYBIRVANDgEaJKMeHdSZUfWLcOFQX,DAAAEAAAKACAHABC.ZAEBUAEALAHB.FBGBGBGA.bCCCTEAAhAEA.BCCDREEBAAHAaEHDhAAAeECE.dEGAfGBAhBGAOFHD.........hBAA......hCAA...,1,-17,-20,3
QBcRVSdbCOGPXDYZFHEILfMTgKNUWAJea,eAAAaAAABADARADA..dAGAOAEDGCCADAGAZCFA.HEABLBGBhADAMEFBKEGAUDCA.ABBBQEEChBAASGEDCGGAXGCChBIA.EFHB.....fGGEhCAA...hAAA...,1,-15,-19,4
SDHRBfVdOFWcGQYCgAaIEKLXPJNbTUMeZ,EAAALAAA.XADDPACC..JAFATAFA..eCCAhAAAZCAAHCFCRCFABEEAdEEAFEGDhAIAGGEBQGCAhCAACAHBAEIBaFAAKGHB..........hCBA......hCCA...,2,-21,-4,17
NWODATQEVcZCedaKSBLHRYJGgPIfUXMbF,EAAAZAAAeACEdADA.KAFCLAFAHBFC.RCBBGCGA..gCCAhABAfDDBMDFBhAIAFFCDOFFBADGBQEGAhBIACGAAaGDDBGHA........hAAA......hAGA...,1,-14,-17,3
gJGKBCLPYVbASXFaHUZRTeQcfdIONMEDW,FAAAHAAARACF.eACE.QAFCdAEAOAGBEBHFDAIB..JCCAGCGAhAHACDFALEEA.PFHDhAAAbDED..ADEBaFHDhBAA............hCAA......hCBA...,2,-32,-10,22
AZOHcMPDfXSIabCGWEFBQgJVLUeRdTYNK,HAAAMAAADAEASACE.aAEDGAGAEAGABBHAQBBAhAIA.gBEDhBAALCCBRCEAdEDATEFAKEHBAFFAZGBAhBBAODHFfGGAbGAAFGHH.....hAAA......hAGA...,1,-2,-7,5
PLHgOEKAJfZYVbaSIcGDURFedMWBXNTCQ,ZAAAVAAAaACA....SADBGAEARAGBeCCBdAFAMAHBBDGD.hAAA.TDCAQFFAhABAHEFAEFBBAAIBJGAAbFDDDDIBhAGAFGHB..NEEA.CDHA........hCAA......hCBA...,2,-13,-1,12
BHPETDegLKRdFOGVCNIZWaXUSbMJQcAfY,BAAAHAAAEADEeACALAFBRAFA.dAHAGCAACCADZCCB.aCCAUEEAMCFBhAAA..JDHBAACA...hAGA.fCGAhAIAPHBADCCBFDDH.OCHDIHHASFGBhCAA......hDAA...,2,-19,-11,8
COHLceAGWJQNYBSFgdMURaITEVPfbDXKZ,GAAAQAAABADAFACEdAFARAEF...aAHBEAGE....fCDAhAAAbCFDKCDD.ZCFEOCHDhAAAHEECeDADACHBNEEA.hAIASDCDUGGA.IGHA.PHEChACA.CEHB...hADA...,2,-14,-11,3
FUcBIXLSbgYTNZaPedQJWVRMKOHEGfADC,FAAABAAALADASACA....bAGDTAFAZCCA.eAHHhAAAdEAAQECAhAEAVCAARDEAMDIBHEFAGECAAAIBCGCDIGHAhAFAXFABgFGDaHEA..hACA......hADA...,1,-4,-9,5
gXMCSeDBLQKbYNPfGTUdOFAZVaRHcEWIJ,aAAAHAAA.EADE.JAFAMADA.eAFALCAAQBBBKCEA..hBAAbCGBPBEBGECAdCGAhBIAAECBREEBIFEA.hAAACEHABGDDfGHATGFA.....hACA......hAIA...,2,-11,-7,4
HAMECIDONfWgJeGdTYQRLBbXKZaVcFUSP,EAAADAAAOABE..fACA.JAEAeAEEGBDAdAHATBEAhBAARCFFLCHBbCCDZDGBhCAAaDCHFFFH.SHAAhAAAHFEBACCBMEIBCAHBIHHA...hCBA......hDAA...,1,-4,-17,13
bPFEYTOgUJdBSGfNDIHZcAaCXKeLQVRWM,aAAAKAAAeACELADARAFF...MAHBFBCDEBHFOBBB..UECAhAAAdCDAGCFADDIBHEFBAAEAQFCAhAIA.hAFAbFGDPHAA.YHEA...hBAA......hBIA...,1,-15,-16,1
BIXMALfCcNOQWVGePKaEgZYTdbRFDSJHU,LAAACAAA.OADDQACAGAFAeAEAaAHF.EAHFZCAAdCAARDGFDDFBhABAHCDC.BCHAMEEBhACAACCB..fEEEhAAA.NEGA.PFAAKEHBTFAASFHHhAFAIHEAWHBGgGCFhACA.,1,-5,-17,12
AMJZIDgUGNdBPKXfbWEOaSQVYFTLRCHec,ZAAADAAAGABBdAEAKAGA...XAFB..bCABEAHF.aCCCQCFAhABAFCFH.RDDBHEBBhACAACIBMDHBJEHBgEAAhAEABGAD.fEEESGFBTGFAhBAACHDA.eECH..hCAA...,1,-11,-20,9
gMXVEGIfRAZCKLaPUFbWDTJcSYONBQHed,ZAAALAAAaACA.FAEADAFA..TBDA..SAGAhABAOAGDQCAAHBEAeCCBhCAAdDDDMCIBEDGBfFFAhABAADGAKEEAbEGD.WDHHcGEBBHHA...hCBA......hDAA...,2,-21,-12,9
dPILTaUfJXQRcOZMGgWVCHDYKEBAeSbFN,eAAAFAAAdADALAEAUAFA.JBCBRDBA..ZDFAGCFA...gECAhAAACAHAHFBCKFFAAAFASAHHhABA.hBAAbFGDIHFA..aDHF....hCAA......hCBA...,1,-16,-36,20
SOIdZJaPbEHTDgKLYVQAMcBNFCXGeRWUf,MAAABAAACACAGACB.RAGF.UAEA.OAGFZCCAaCHD..ECAAHDFBhAFA.TFCAKCDDLDFAhAAAQGACAAIBFEBBhACAeFHF.WBBDSEED.dFFA.hAGA......hAIA...,1,1,-35,36
GEKJBTZLadeWODbRXHfFQSgPMVAYICNUc,CAAAUAAAGACAEADABAFAZAEALAHB.dCAAeAGH.DAIBRCEBHEGBhAAAQCDASEEDhACAMDABADCB..IFAAhAFAKDGAaFDA.OGAEbGFA......hAGA......hBCA...,1,-7,-25,18
aFHBDJOKYIGgWQRTdXSVefbcZCEUPMLAN,aAAAHAAABADAOACA.KAFAGAEA.QAGARCCAdAHASCFBhAAAeBBB..bDADZDGBhCAAEDDBMEEBLDGBhADAACCADEIBIHHATGEA.fGFECHHA.hAGA......hBAA...,1,-9,-10,1
UJDbVXZcgFPHOQNGfWRACYBMaTSdKELIe,BAAAaAAA.dACAEADAeAEADAGA....XBBCZBEEFCBHHDDC.hADAQDGCGBEARBGBABIBhBAAMAIBTECALFAAhAAAIFGAUGGAbGBA.......hAEA......hAFA...,1,-10,-11,1
RPfaXCBGcNQSeHdEIgLMFYTAOVbUZJKWD,OAAAUAAAZADAKADARBGF.....aAFABAHBGBEBQCDAhAEAHCCAEDGALFAAMBBBTEEAhAIAADCB..bEFADEIBhBAA.XGGCCGEA.NIBB.dGGA....hAFA......hAGA...,1,1,-25,26
HfWUDeYZSdabJFENTVILQKOPAMgXGBcCR,MAAAGAAABADARADAHAGBUAFAeCDB.ZDEBaBBBFDHD...EEABTCCAhAIALFCB.QGABhAAAOBHDADFAXECAhBAAfGFADEHBSHGAbFED..hACAJFBF.IHHAhBFA...,2,-31,17,48
FVSXDWgGKaBTJQbMENOecfCAYZdIPULHR,dAAAUAAAHADARADA.SAFEDAGAGBGAaAHDBCDD..QCBAhACAEDAA.eCFBCCFCAADAZEEBhBAALDDB.XFEDhADAKGGA.JDHBMIBAcGCC.IHHAhBAA....hBCA...,1,-5,-33,28
bDKVdIeLMCOSRJYTNXEZWPfFcQgBHUAaG,GAAAKAAAdACALAEAMADAOAFERCDA...TCDAEBHFZDFE..hAAAfCFBQECChAFAHDBBAFGAaFGEbEFADGABeFEBhAAACHHA.SGGB.NIAB.XGCAhAGA.....hACA...,1,-1,-11,10
JZTKcAGUFOaHLIMSRWCbdDgePfEBNXQYV,GAAAOAAAHADAMADARAFACAGB..dCCAeCDBEBHF.BCEB.QCGAhAAAVDFBZFAA.TEBAhACAABBBaEEH.LFFA.hAFASGEDDDIBfGHAYHFC..hAIA......hBAA...,1,-4,-13,9
ZXFdBKHaDVObLcCJPfIGNgSAEWMYTeUQR,EAAAMAAA..eACARACAZAFBdAGAHCDBDAIBOBEDLBHB.CBBD.JCCB.hAFA.IFCAGDFASDABhAAAACHB.hAIATGBAQFFABEHBaEEHcGEC..hBAAfHDF.hCAA...,1,-11,-20,9
cAHVaTOeIYGSMbgBLPfEJXNFKDWCRdQZU,HAAAaAAA.eACEGACAMAFABAEALBGBEAGA.XCCAKBHBCCEARCFF.hAEAZCEB.ABIBODHDhAAA.SFGDhCAAbEGDfEEEFGDA.dGAA.......hCCA......hCDA...,1,-3,-19,16
LJRVTYBUbNFfSegMdCWKcZHQDGIEAOXaP,aAAALAAA.RADF.TADABAFBUCAA.FAHBeAFE.dCCAKCFAhABAHBFAGEEAABBBXDABhADA.PDFBhAIAYCHBbDGD..SEDHMDDBCGHA...hACA.WFCD...hBAA...,1,-13,-23,10
PLVIYbaUdHfGFDSNgRKCBJceTAWQMXEOZ,MAAAEAAAZACBLAEA..IAFAaAHDHBBAGAGASCEAhAFARCEBBCBCeDBBAAIBQEBAhAAAODDBPDHBhAGAbFGB.dEFADEEBKGHBcGDD.....hBAA......hBBA...,1,-2,-9,7
fcPTbZWDVJBQIUORYCdNXSFegELKAMGHa,HAAAaAAA...fADBTADAZAFBDAFABAHAQBFAUDAARCCF.hADAdCAD.SAHHhAAAeCGHEEEBABBBGDCA.hAFAbEEBJEHBOEGD.CCEDNDIA.....hBAA......hCAA...,1,10,-19,29
DFICcRPgKbSfdYGMQUWLBeEaVHNZOXJTA,FAAACAAARACA.KADA....SAFBdAFAGBGAMAHBQCCAhADA.LEFBECAAHCDAhAAAZFDBXDAAAAHADFDBIHHAhBAAgDGA.bFCA.UGGA..hACA......hADA...,2,-20,-16,4
KMRAGcEZFCXfNJadUIbSPgTYHeOVLWDBQ,EAAAZAAACADB....fACAaAED.dAEAIAGA..hABAbAFDSAHHhACATDCAHEFAeCCBLBHBhAAABCFAMDHBAAHAFEBHXEDDJFEF.gGEAhCAA....hCBA...,1,2,-36,38
ZKCbcJHPREeSOgYTWUaMfQALFBNGVIXDd,LAAABAAAGACAXADDZAEACAHB...JAFAHCAB.ECFBeCABhABAOCHDTCFA.aCCChACAMEEBACHA.FFAHIEEAhAIAdFFAbFGD.REGBSFBAgGCD...hAAA......hACA...,2,-11,-7,4
GfSNBcKLIgXFZPdDJCVTMRaUeOHQEAWbY,...bAAAGAAA.SADABAEALAGBXAFDZCAAdCEAhAAACAHAMCDBREAAeCHHHDGBAAIB.hABAfCEEKEFBFFHDDGCAhACATGDA.aDAH.QGGBWGCA.hAEAYHAA..hAAA...,2,-14,-8,6
MdAbZFcLHJfaOXIBWgPCVRDGQeSYKTEUN,ZAAALAAAHAEAaAGAXADDBCAA.....PAFARCCAGCFAhABAeBHFKCHBECAAMEABACGBFDDAhABAJEEFODHD.gFBAhACADACASGHBTFFAdHCB.fHFFhCAACGED...hBFA...,1,-2,-12,10
UZIdKHDQBCFSGaeLNWbEVJTXAOfMRPgcY,MAAARAAA....gADBUAEAdAHAHBBBQAGAFDEAaDGDeCCBhAAALEBA..hBAAbCFDEFFBTFAAABBBOEHDhBDAfDHE.cFECZGBA.DGGACHHD.hBEANIBB......hBGA...,2,-7,-1,6
MFLcJZAHUWPKadDVCIbNGYEQBSRgfeOXT,HAAAUAAAKADAdADACAFA.....IAHAGAFAEAHBQCABhAAARCBAeDAB.TCEALDHBhADAZCGBADDBaDEDDDIB.bFAAhACABECA.fEGAMEEBFFFH...WFADhAFA.....hAFA...,1,-5,-12,7
NXCaOecGKEFBYbQRIgHSdTWJUMAVLPfDZ,LAAADAAAZABE.CAEA.eAEHGAFAFAGABBGDQCAA.RCDBHDGBhABAdCCAJCHBAAHA..fEAEhACA.aBHFKDABhADAEFDBbDFD..SFFDUFDAMFIBNIEB..hBAA......hCAA...,1,7,-29,36
cFePCAYMbJHWZGIBNOLSXQUaRgTVEKfDd,MAAAHAAAGADABADALAFAQAFARBBB.TDAAECFA.DAIBdDHAhAGAeCCBADEB.JDGBZECEOEHDhAAAXFGCaFACKFDAhACAFGEBCHAA....YHBAIHHA..hAHA......hBAA...,2,-22,14,36
XePMRfdFKJQVBaZGHDETCgLbISYWNAOcU,OAAAXAAA..eADARADAdAGAKAGA.QCCAaBHDHCDCEDAACBBDLCFAhAEA.SEDAhAIAYEAGAAAAPEGBhBAAMEEBFFFABEHBDEIBbGCAIHHA.NIAB.hADA......hAEA...,1,-10,-11,1
AYcfHEPWVMXaCUDNeSIKOBQLZTRgJdGbF,...fAAAHAAAEADEVAGBMADAaAFEDCAB..eCCAKBCAQCADhAAAZDCERDFFdFAA.bBFAACCA.hAAA...PEHDhACACDDASDFABHHD.TFDA.gFFBhACA.FEBH.WFHBhAIANIAB..,2,-7,2,9
DTVHZEPYFgUfNIRdKOJLWbXcCGSQBaeAM,MAAATAAAHACC.EAFEFACA.UAFA..fBBERCCAdBHAODFChAAALAHB.bCEDhBAACEEDGFBBQEGChCAAeFHBACGAZDCB.gGDAKGFA...hAIA......hBFA...,1,11,-16,27
MgYJFORXTQAHbSWacGUZICLPKBdfEeDVN,HAAASAAAaACAGAEAZACBLAFABAGAEBHFeBEB.DCGAMCCBhAAAJDGB.RDDBQDGBhAGA.AFGB.bEDDcFGDhAIACGAAdGHA...........hAAA......hABA...,1,1,-26,27
gGIMcFeOWLDbRaUYBJHfZQAdVEPNXCTSK,EAAAXAAA..TACAKADAGAFA.MAIBeAEELCDBhAAARBEBaAHDBCCDHDAAZDGBAAHBdEHAhABAPEDBSFAAhADAgGFGFFEDDGGBYHAA....hAAA......hAHA...,2,-18,2,20
NXTYWfQgUHZeEDKRSMAbOCVBFIcGPdaLJ,CAAAFAAAGACAdADALAFA..XAEATCEA...fAHAhAAAQCGCHCABhACAECCBRFFAACFBbDFABDBDIFFAhAEAaEECJGAA..NICB.gFAA.eEDFhAFA.SFHDhAHA.MICA,1,8,-19,27
UaZgSWKVDFJLYNCHQMEcITAPRGfXdbOeB,RAAAGAAAdADA.eADAaAFA.ZAGB...SCDAKBFAFCCHLDFAhAAACDCDHECCEDHF.TGBAhAAAAAIBXEDDBEADgFGAhACADFBA..YFFB..hABA......hBFA...,2,-38,2,40
QfNBdOVTPKFMGURDYCJIbHgXSZLWeaEAc,QAAABAAAdACAOAEA..TACAFAHDGBDARAEFCAGB..bCFDhAAAHCFB.SCBDhAAAZDDFeAHHADIB.fEAAhAEAPEHDMFBBDFIBIGGALFCAEGGBhBCA......hBFA...,1,-4,-13,9
AVSeZDBTfKOJaWEGdLcCQgMFHXIYRUNbP,eAAAZAAABADBKADA.OAED..aAFAEAGAdBGD.LCCA.hABAQDFAMBIBHCAAhACAXECARCFFbEDDAEDBDFIBhAGATGGA..fFFEWFFDCDHA...hAAA......hABA...,2,-25,-15,10
HLCaOBXIdbFDfURVGeAQWSPMgTcJZENKY,QAAASAAAMADA..TACAZAEEEBCFKAECHCEAaAGDXCDAhAAAdCHADDDBREEAeFHFhAAAAAIB..gCGAhBGAJGCANIAB.LECB.BEED.bFGB.hABA......hAIA...,1,-4,-5,1
dDeZEHINWBLTgGPbCaUfVYSKQAcJXRMFO,XAAARAAAMADA.dADAeAFAHAFA...ICHABBDATCEAhAAAGCEACBHAUEEB..hABAfDBASCCDhCAAAAAAFEDHZFGBEGCBLEHB.bGDAaHEGKFAD.hCGA......hDAA...,1,4,-13,17
IRbEAfCHaOLDXSeQYBTPUWdgGFJcNVMKZ,HAAAaAAALADASACE.eAEHQBGATAGA.UCCAdCCAGCFAhAAAFCFHJEABVEGBhAEAZFDBRFGFACIB.OGAADBBBBHAAhAFA...WFFD......hAHA......hAIA...,1,9,-18,27
JIXaUAMcWTQVNKOSELFfgZHDeYdBGbRPC,MAAATAAA..QADAKACC.EAFALAFAFAHD.ZBEAHBBBhBAAeCCBdDEAbEDDRDGBCGCAXDGAhAAAABBB.VFFAhAGASFGDDHAA........hCAA......hCDA...,2,-20,-5,15
JRbXTeMUPdDZQgIHWBSNAKGcafVCYFLOE,GAAAaAAA.CADALAFAEADARAFA..TCCAeCDAMCHB.dECAhAAAZCEFQEEAhACAHCGBSDABAAGAKFHBfGDAhADAFFHDbGAA.........hADA......hAGA...,1,-9,-15,6
BJPUHFgAYIedcORaTCbXVGMDNKLZfQWSE,eAAAdAAARADA.CADA...XAGBGAEAMAHBKCBA.ZCCF..QCEAhACAEDGBBFFAUGAAhAAAHDGBAADA..IGHAhABAaEEHbGDA.DDIB..NIBB.......hBAA......hBCA...,2,-20,-20,0
LZXIDaYNGfKgcJBATEVCOFHWeMQUdRSbP,EAAAOAAAHACA.eAEEMAEAdAHARBBA...SCCALBEBZBGBhAIADCFBaCGCGGBB.KFFAhBAAgEEABDDCABGBCGHA.hBBAQGGA.......hCAA......hCIA...,1,-8,-22,14
UHJfGFReWLEVSABbaITDPQMNdKOCgYcZX,aAAATAAA..QADAdACACAEA.....gAGAhADAZAFBHCDBGCGARCCBeCHFEEFBhAGAAAIBbEABDBBBMFCBOEHDhAHAXFFDfFBA.FFDD...hAAA......hAEA...,1,1,-14,15
UbZFOWGRaMBXJfTLEeNPAVYScIHKQDdgC,SAAAHAAAQADCdADAUAFAZAFBOAHDRDBA.aCACMAIBXDDChAAAJDFA..TFEAhAAAEDGFeEHF.AFAAcFADhACADFBBCGHAFHBEBFFD.fHBF.hABA......hBDA...,2,-27,12,39
LFTPIMCdVNBZHOWGUceDKSYAJgaQbfXER,aAAAQAAA..bACDEACA.RAEALAHBTAEA.MCDBdAGABBBDhAEAHCFBGEDAhAAAeBHHSDEAACEBfFAAhAFAFECBCEHA.ZFDBOFHBcFGCDGGB...hAIA......hBAA...,2,-15,12,27
VJDfOKTXPFWGLIRedMgcHNUbYESaZCQBA,DAAAKAAA...TACAFACAGAEARAEF.eAGBdAGAMAIBHCCBUDGBhAAAEBBBZDDAQFFBhAHA.AAIB.fDGBhAEA.XFFA.WFHHIHHAhCAA.NICB.....hCBA...,1,-17,-18,1
gALCXTDdBbEZSQPecVMUNIFKWaYHJGORf,LAAATAAA.dAEAEACEZAFB.QCAAeAEEMAIBUDCAFBEDaCCBhAAAHCGBGCFAREEFAAIBDFIBbFGDhAHA..SGGBhABA..cDDCIHBAKHCA....hACA......hBEA...,2,-10,6,16
MESTPAXKWGRFNLJZaBHfIdODQecCgbVUY,KAAARAAALADBZACBHAEAdAFAQCAA.eAHHCAHAVCGB.MCCBhAAAECFFTECA.hABAAAGAGEGAFDEDaFBCBFGDhAHAOFFHDFIB.........hAAA......hACA...,1,-4,-25,21
YgHWXUANIeSMKLVROJTGEbQCFBcadZPDf,eAAAMAAALAEARADA.OAHDGAGAEBBAbCCA..FCDAaDFDZDDAhAFADDIB...fEAAhAAAHEGBXGAAhAGAAAIBSEEDKGDA.TGAA.QGGAhABA.BHFD.hBAA...,1,2,-16,18
caLgDHfRAXNEKUIBbVJQPMYSGOCTdFZeW,EAAAKAAABACB..bACAQAEA.MAHBGAGA.TCCAhAAAZCCAeCHHaDABLDFBhADAHEAAAAIBXEEAhAAAIEEAPFHDODHDdGDAFECH.gGABhAEAfGBA...hAGA...,2,-7,-6,1
IJObfQUBHRCYNdVFASGDPcWTeaKXMZgLE,GAAADAAA...PADATACA.eAEEaAGD.MAIBZCDAECHFOBBBhAHA..QECAhAAAHCDARDFACBFDdFFDAAIBSEFDhACAKGHBLHCAbGBCBFHA.YHFAhBAA.....hBAA...,1,3,-13,16
eTLQXcJBACOaZNWbFHYKIfgSERUGMdPVD,aAAAZAAA....bADBHACB.KAEA.IAHASAFA.RCAAGCEAhABAdCFADBBBeCHBhAEATCGALDEDQGAAhACAXFFBBEHAAAIBOGAAFGCEfGFAhAGAEHEE.....hAGA...,2,-18,3,21
bLgFGUWMCVIPaHXDfeSJYdRTKZENBOcQA,LAAAGAAAMADACAEA...VAGBaAFDHBGBDBFB.eCAA.SAHBhABAdCDARDFBZDBBEFHFhAAAOCEBADIBFHEAUEAA.hACAIFFA.fEHA..hACA......hAEA...,2,-20,-13,7
KZHgPJOFNfdGIYbRWcMCDEaLeABQTVSUX,TAAASAAA.KADAHACB.JAEAFAFAdAHAGCCA.ICFAhAAARCEAMCABEDHF.eEBAhAAAAAIBQDAAhABAXEFDgFCAOCGDfEFEYFHBcFGDhADA.DCIB..hCAA...,1,9,-31,40
gTQGMcBXeLWHNAZCFbIdEUYaOSPVfRDKJ,ZAAAFAAAdADAEADE.UAFAOAFA...SBEAVDBA.RCAAKBHBhABAJCHB....QFDAhAIAGDEAMDHBBFBDhBAAeEDD....WFGDACAACGGD...IHBAhBDA...hACA...,1,-18,-36,18
MFCHTKVRcegIENSAYGfaXBZOdbUDJQPWL,GAAAaAAAZACB.dADADAFAQAFA.LBHBMAIBHBEATCEAhAAARDEAeEBB.EEDBADDBXDBDhACAOEHDJHDAFEEHhAFAKBBDgGEA.SHGAhAIABFGC......hBAA...,1,-7,-9,2
ZNVKcaFJGAgfLIQdBREeTbYMCUPHXDSOW,LAAAdAAAEADA.eADH..bABDMAFACAFA.HBEBDAHB.OBGFhABAZCEAKDADaCAAGEEAABIBfEEEhACAQFCARGBATGFAhBGA..........hDAA......hDBA...,1,-5,-21,16
AKZTdbWaODEBXNgUSQfcFYJPMeLHGRVCI,ZAAAdAAAaADAEADEBAFB..XAFDUCAA.QCBAFAHB.hABAJCHBeCDAHDDBRDEACCHAAAHATGEAhACA.OEBBhBAADEIBSECH.fFGAhACAPHBCMDGB....hBCA...,2,-28,-9,19
DLTbUEKJaFGSfHQZCINXBAWcYRPOVegMd,......cAAARAAAOADA.eAGFdADATAFAEBDFKBHBFCEDhAAAGCAAHDGBZCFACFFD.XDDChACAACCB.PEFChAFAMIAADGEBLHAA.UGGAaGHD...hABA......hAIA...,1,4,-22,26
BFSPDgNXUbOfRKQdcHEJGYZaACMIVWTLe,MAAAVAAA.LAEABADB.FBBADAFA..XBGAOAHDRBDAdCEAHDDChAAAEDGB.GDGAZEDAAAFACFHAhAIA..TGBA.hBAAeGDESHDA..NIEB....hCAA......hCBA...,2,-24,-7,17
GLdBcYVPOfHXWMeaKSNRDJQUFTgAIEbZC,EAAAZAAAGAEAdADABAFA..VCAAOAGDHAGD.MCIBeBCDaACASCEHhAAA.RDFFQFAAhAFATEDAADGBbFGDhABALFHB..PGAA.fGFAhAGA...hAIA...,2,-21,7,28
MUONJFaDEQLgRBfSGYIcHPXCTAbVZeKWd,ZAAAeAAAdAEAMAEAOAGBFAHD...EBHFLBDARCAA.SCCDhAAAGDEA..IEHAhABAHDDBCDGAABEAKEBAUFGAhABAaGEHQGGAfGDE.PHAA..hACA......hADA...,2,-11,-11,0
feEIULSOBAMKDXcHNYGdZFRbJgVTCaWPQ,MAAAXAAAHACCGADAZAFBRCCB...JAFATDGA..aCFDQFAAhAFAECHBLDAAhAAABAHAADBADEHBNEFAdGGAbFBACBBD.hBAA...fHCFeFFBSFHHhABA......hADA...,1,2,-14,16
MWYbgZdJeLVPaXFGAENKOHQTCIDRSfUBc,EAAAOAAAHACA.QAFCTADA.DAIBRAFFUDCAMCCB....hAFAbCGDdAHALDDAhAAAaBBCGDGAADIBCEAA.SEEBhBAABFDAcFFCgGEAeHAA....hCAA......hDAA...,1,6,-13,19
GPCbRKfXFQHWTMSZDJeOYBIdEULAVgNac,VAAAaAAAGACA..CADBRAEFKAEA.FAGAHAGB.MCDBZCEBeBBDhAEABDGDdEEAECGALEGBhBAA.ADIB.gGAAhAAA.PEHD.XGFDWFHHDGFBhCAA......hDAA...,1,-12,-18,6
LdGaPTUVcYHCJIDXWOSFgEZBQRKeMNbAf,dAAAaAAA.UADA..VADAHAFA.CCBADCHBOAGD.FBBHEDDAZDAARDFB.hACAKDDC..eEHHMAIBhADAAAHA.GEFA.TGAAhAGAYFFF..XGDC..hBAA......hCAA...,2,-25,-14,11
GSJEYdNKgaWXITPAMeUZBFQbfRCOVDHLc,eAAAZAAAQAEARADA.OAGFHAGBGCCAECAA.dEAAKCDAaCFHhAAAXDAATEGAAAIBMAIBhABAFFFHCGDALEEAhACA.SEHHNIDB.gGDAhADA.IHHABHHB.hABA...,2,-7,1,8
UIENTKWMBALVdGeQbfFgYPOcRSDZaXJCH,dAAAeAAAQADAFADD....gAFAOAFCRCAAZCEEaAHD.hAAACDHAHEFAUDDAEDGATGCAhACAKEHB.BFEDLFABhABA.bGDAfGHA....hADA......hAHA...,2,-15,-10,5
MagXKLRHfNTBIcWZSeCUJAYbEVGPdQFOD,EAAAGAAAdADA.QADADAFA.aAFEKAHBHCEC..TBFAhAAABBHAIDCAZCBAeDEHCDGAhBCAAAABbEEAFEHD..MFBBhBDALGAARGFE.fGGE.NDIASDADhACA..hADA...,2,-15,-7,8
FBCOLTAcNUMEHJeXfaVQZKRPGDIYbWSgd,UAAAHAAAeACE.aAFAZADA.RBGFGCBBDAIB..bBDASAGEhAEAdDDACCHDLEGBACEAMDIBhAFAEFEA..XEEAhBAA...fGHE.KHFA.hAAA......hCAA...,1,-16,-18,2
PVJgdAWZYNKGTCaREBLScFDfMbHXOUIQe,ZAAAKAAAGACAaACA.EAEALAFA.FCCHMAHBHCFAOBFDhAAAQEDAeCABPDHDhACAgFFB.AAGA.YEAFhAEACEHASFCDfEDA.bFEDIHEAhABA...hAIA...,1,-8,-18,10
EgdDAFUQHGOWeMYSaZPTVJKBNCXIRfLbc,QAAAHAAAGADAeACAMAFA..aAFDZBFB.TDAAKAHBCCDARCFAbCGDhAAA..EDAAdFDAAEEAOEFEhAAASFBH.PFFBhACABFBAXGGAIHHAfCCEhADALHAADIEA....hADA...,2,-13,20,33
HSdcMCTQXVRDWAKZPOEebfIgaLJBGUYNF,ZAAAEAAA.eACE..bACA..fAFB.aAHDLAGBhAAAGCCBUEFAFCCAHDAAhADAdDHAMFCATEEAQGCAhABAREGFAAIBOFDBIHAABGBASGHHhAEACGHA.DCIB...hAHA...,2,-7,2,9
eLENdcDUBIAPSYbTQfOXaRCVGKFMHWJZg,SAAATAAA.QADAXACBRAEAGAGAFBHD.HCCAZCCAeCGDhAAAEDABdEEADECABAFAhAAAAAHA.bEFDaEHDKEHBMFAAhAFA.JFFBNIAB...IHHA...hABA......hADA...,1,-1,-5,4
eSdUCOPWHGJDKMVaTBZXgLYRfcNEQAIFb,FAAAeAAAdADAOADCHAFAGCDBKAGC.aCCHZBFE.LCCBREEA.hAFA.fFHAhAHAEDGAAAAAbEDD.CCHB..JHEAMEIBhAFA.TFFA.BHHDYDBF.NIAB.hAIA......hBAA...,2,-10,-10,0
CBZEbgYdGNFJXeTMHRKOPLQDaSUIAcWfV,...fAAABAAAEACA....bAEAdADAGCAAFAFAeAHHHCCAhAAARBEFOBCHLCFBaCADhAAASBHHADGB.hACAcECDCDHAZEEAgGGAYEGB..XGAChACA.MEIBhAFA...,2,-14,-9,5
bHUBfVPKGYecADIdLMRaWCJOSFgTNQXEZ,dAAARAAACADB.SADA.FAGATAFA.QCCAEBFFHCACfCGAhACAKBHBeCFBAAAALEHBhAFAaCHDODEBXEDAhAHAbEAABFFAPHDAYFHBDIAA.IHFAhADA....hAEA...,2,-12,-11,1
KbHAVODSIQdLPBWEZFeXNCTMgRJGcUfaY,DAAAQAAAdADALAFABACAEAEAZBBBFCFAeAGF...CBHAMCDBhAAARDDAGEGA.UGAAaCEBKDGAhAEAABBB.OEFB.hAGASFDH.IGGAWFFD.NIAB.hAIA......hCAA...,2,-26,-21,5
MNZARgPVCSJFDGOKeaXcEdIBQUTbHYfWL,RAAAVAAACADB..FAFAGADA.KAFAeAHH..aAHDEBEFBCFAQDCChAAAUDAAHDFC.hABA.fDGEhCAAMDDBAFFASFGAOEFBdGCAIHAATGGA..hAAA......hADA...,1,-12,-20,8
DKWbagBfZOJHLFXMcSEdITNAPeRCYUQVG,RAAACAAAUACAGADA.KAFA..aAEEBAHB.ZCFBHAGBLDAAMCBBECEFhAAAdDHA...TDFAhAFAAAAAeFAA.QFDDhADADDDBbFFA.OHEEFHFA.SGGEhAFANIAB......hCAA...,2,-10,-10,0
bJdeUVfNaAGRMKDSIXFOBcQETCHPgWLYZ,RAAAMAAADADA...XACABAFAEAHB.HBDA..gAFAhAFALDDAZDGBdCCAeAHHhAGAfFDAABBBGDFASFFDhAAAODHFTFDACHCD..WCCD.hBAA......hCAA...,2,-19,-16,3
YUdcNaDTOXWSHCPLQEeAfRVIbJBFMgZGK,RAAAVAAA..IAEABADBFAFAZAFB.GCCAKBEA.dBHA.aDABTCGAhAAA..XEFAhAAAHDCALFFAhAIAEFEBACCBJHCAMHFA.YFDBcGGC..DIAA.hBIA......hCAA...,1,-6,-27,21
WRITQHUFCDdJfbgSYcPNVEeGMaKXALOZB,ZAAARAAAQADCHAEACAHBdCAA..JAFA....bCCCSCCDhAAA..PCGBhABAECFAeCHFaCHFAADALDDBhABABECATFEADEIBfFFAgGAAYFCFhAIA....hCAA...,1,-10,-24,14
IHdDSFNacXWTMRGZEPeYBAQVKJbOgULfC,QAAAKAAAOACALAGBCACAHADB.dBDDFAFA.aAHD..XCCChAAAMCGBREEBZEGB.EFBAhAAAeCHHADDB.bDEDfHDBhBFASFHH.cGBA....hAIA......hBGA...,1,-3,-28,25
PgcWXOQBdKCTDHfJVYMEGUIFeaSZRALNb,LAAA..bAAAPAEA..gAEAXBCAQBGAhABAdAHATCAAHCEChAAAfCAAVEEBEDHFhABAGCEAFEAHeHBAZEGBADDBcGDABDDDDFIBMIAAhACAaGHH......hAIA...,2,-11,15,26
VYgUfHCGZcEWdKTQPBeMDJFLRNaOASbXI,XAAAVAAA.UADAHADB.ZAFA.ECFAdAGAKDAATDBA.QDDChAAAeDDBMDHBFCHDhABARFEFaGAAAAIB..bFBCIHAAhAAA.fGHAGGDBPFFAhBDADDIB......hBFA...,2,-7,1,8
GJdFDYgHbRAUaIcPNLECTXZMKSOWeVfBQ,aAAA..IAAA..PADAEACATAEAZAGBMBBB.OCCAhBAAeAGHBCAAGDBAhBDAdCCADBIBHDFCABGBUEEAhCAALFDAKEHBSGFAfFHA.QGAAhACA...hDAA...,2,-13,-6,7
XWaDbGJCTBdeYZFANOKfRHQLEVUIgcSMP,KAAAHAAAEACEUADA...IAGASAEBMAIBXAGAhAAA.aCCAGCAB.hAGATCFAeCFFZDGBAEEAfEGAhAAARGEELHAAgFBAPDDBDEIBCFHABHCAhACA.YFFFhBFA..,2,-12,-1,11
XQdSGENVIKcUHDTZefWaMBOPgFAbCYLRJ,CAAARAAAQADCGACA..EAEA..IAGAKAGAHCABZBFEeCFAhAAAaCCCBDFAODHDFDHBAACBLEEBhAEAdFAA.SEGDhAIAcEECDFIBTFCAMIAA..gGFAhAAAYHEG...hCAA...,2,-11,-10,1
QGOPKeWMfcSHBaVXNAdJTZLgbDUCYFRIE,dAAAZAAALADBDADAUAGA.FAFA.RCAB.EBDAGCFA..KCBAeAHHhABAMCFB..SDHHhACAHDGBaEDB.XFBAhBFAADIBJGDE.bFDD.CGHA.IGBA...hCAA......hCCA...,2,-32,-5,27
MKLFQgJbOZYVaCBHWDSdfRIEGTePUAcXN,XAAAMAAALAEAFADA.QBBA.JBHBZAFB.aAHDHCEBhAFASBCHRECBEEHFeFGDhAGAAAAAKDED.ODGDhBHA.CECADDIB.dGEA.fGGE.hAIA......hBAA...,2,-23,-10,13
GYCZIMQaSXWUEfDNALdFRKHgPVcbBTOeJ,dAAARAAAHADB..PADAVAFABCCD..eAGFGDAAZCAEMAIBhACAaCGE..SDEHhAAAXCEDEDHBDEGAADABLECBhBAAKFGA.bFFB.OHCECGFDIHHAhABA......hADA...,1,-4,-16,12
CTFEeRQPDfUNGXIacAJMBOLVdHWgZbSKY,MAAALAAAHACCZADBKAFCCAFA.FAHDRAGF..DCAAUCDB.GDFA.hABAaBBHACFBOCHD.hBAAdEEAbGCASDCDhACA.EFHB.QGFDfHGFNIAB..hCAA......hCCA...,2,-19,-18,1
NKJDERYWGMbLVdgOTQSBaZHPeUfFAcXIC,XAAACAAAKACA.DADARAEFGAGA.LCAAdAGATBDA.QDBAhAAAaDECHEAAeDHHhAAAFCHDAAIB...IFFAhACAEDEAMEGB.bFBAOGAEZFGB.fGDBhAEA.NIAB...hAGA...,1,-7,-12,5
HIRGACYDOZJNgEVMKdWQLPUabeXFSBcTf,DAAAZAAAJADAEACA..KAEAdAGA.LCABUAGA..eBBBFCCHBCFDhABA..TDDAHDFCRECAhACAACFBODFD..hBAAgFGAMDHBWEHHaGFH.....hBIA......hCAA...,2,-37,-17,20
COdJZLFeDgEbTWIAUBSQGKNXfRPaVYHcM,SAAAGAAAKADA...XACDRAFFaAHDHCDBMAEAdDCCZAFEeDADhAAAECFA....bDDCTDGAhACAAAAABCHAQFFChADAfEBAPHAAcEFDCHHA.OEHD.hAFA......hAHA...,2,-11,5,16
GQKcdNIUORXZCfaYTDAeVEbJHMPWBLFgS,EAAAHAAA.MACABACALAGBSADHGBDAQAFAdCCCIBFAhAAARCDAZDFE..aCCHTEGAhAIAAAIB.eFEFbFAAJFGBhAAAFGGH...KHBA.......hBIA......hCAA...,2,-10,-4,6
MRcNJgdIPQYCVKbSAOeaTWLEXUBHFDfZG,eAAAaAAALADAEADABAFAHAGB.DBBBGAGARCCA.JCCAdDGDQEEAhAAACEAAKEEA.AAIBODHDhABATFCAUGGAZFCF.hCAAMIAAgGFA......hCBA......hCFA...,2,-11,-11,0
BZPDIAceYTNadSOFCUbHRVQLMfKWXGJEg,eAAATAAAdAEA.FAGACACBHADB..RBCBLCGBMAFAKBFCGCGAhAAAEDFFZEBA.DBIBAAAA.NCCA.aEHDhBEA..ODDBUGBA.hBGAbFDD..fGGEXFFD....hCAA......hCBA...,2,-13,-2,11
cEZCUQVOfgXIYHBSNRDTFbWPAadGeJKML,GAAAeAAAMAEAEADAZAFBUBDA..QCDAOAHD.XCGDhAAAHCFBSCCDhAAARFBAFFFA.bFCAAAIBdHBDLHBAhABACDCDfGHAgGGA.....hACA......hADA...,2,-4,3,7
LbHBeGYTCFASZIcKdNVgJEOMfRQDWXaUP,ZAAAKAAAdACA..VAEAEAEA...MAIBRAGBQCDADACA..hAAAaCCCLDFBHCGBeDEFhABAGEAATFFAAAIBSDHHhAEAIECAgGDGfGCAWHEAhCAAPHACBGHBCHHA..hCBA...,1,-2,-21,19
NAWTbUODMQEVHcLRXFKIfYePdJZaCBSgG,TAAAOAAADAEA..EACEHAFCRAEF.KBBD..fAGBhAAAeBEBdCGDaCDHSCCBhAEAGDBAAEGAbCFDMEIBQEDAhAIALFFBFCHB.IGGA...hAIA......hBAA...,1,2,-13,15
cWNbMPJHCfDXLAEaFOYSTdIeRUZQVgGBK,EAAAaAAA.FACD..SACHdAEARAGB.ZADBQDDAGAFAKAHB.hAAA...NCGAMDIBhAGAHDEBDBBBAAIB.TFBAhAHAeEBB.gEGHBGHDWHEGPHDA.CHHA.hBAA......hBFA...,2,-19,-11,8
FdPVBOYDSgTHcRAXZUJfeILMCQGbKWNaE,ZAAAUAAAeACEMADAGAFA.KAHBaAFEdCCDBBDA.DAIBSDEHhABAHCDCACGA.JDHBLDBBhBAAQFAA.bGFAhAFAEDGA.FEEH.OEHDYHDATGFA.hAHA......hCAA...,1,-9,-15,6
TNcHeBCdPSWOVbFQLAJUMDGRXKfaZgEIY,MAAARAAAKADCZAFB..EADA...TAFAHCCBeAHFdAHA.SCHHhAAAOBBBFCDAABFBDEFBhABAGDEB.aDDHgEGGhCAAIFHAcFFCCGGD...PHDChBAA.....hCCA...,1,-5,-29,24
VITbWKAGaFdcLXOMJBQPDegNCYHZEfSRU,aAAAdAAALADA.MAHBQADA.eAFACCBAHCEBEBBBRCEAhADAIEAATDCAbEFAhAGAAAIBGDCA.XEGAhACABBHADGEA.YHEASGCD.WHEAhAEA.....hBAA...,2,-15,-13,2
INbZdJYXRTQHeaLVfCDOPFgBcUWKAGMSE,GAAAEAAA..IADAZADAdAHAXCDA.RDFFHEACeAEHaAGAhAAALDHBCBCDOBFDhBHAFGABBHBAUEFBACHAMEEBhAAASDDDJHFA.QGGBDAEA.PHDChCAA....hCBA...,1,7,-23,30
IZBdWTNPFEcJYLXGKUabRgOfVHeCQAMDS,MAAASAAAZABEdAFA..TADAFAHB.EAFEJCCALAHB.hBAAGCCAaCGEREEA.fCFAhAAAHFBAeEHHACCBBDAAhABA.PEFC.XGGAKHEA..hADA......hCAA...,2,-18,-12,6
NDcTLPQSBaEMGCVJHWYAgKfIZRdeFXUbO,KAAAZAAARAEAeACEFBHD.UAFA..OCABDAIBLCCB..QCCBhABAaCEC.ECFFhACAGDGACEEDHEABADBAfEEAhAAAdEGAXGFCNHBB.......hBDA......hBHA...,2,-30,-11,19
eUbGDVPJNfWIELAMdKYTcaRFQSHgZCXOB,dAAATAAARADAFAGA..HACBZABB.OAEABCEA.eAHFGCFADBFBVDFBhAAA..JDCBfCAEhACAECHB.ACIBMDEBhBEAKEABaEEHQGCC.CFHA....hAEA......hBAA...,2,-31,7,38
dRSYLVbfAWTDcUJPIKXOENeZQaCMBFgHG,TAAADAAAUADA..JACAKAFA...EBBAeAFE.aBEEMAIBFCCBHCFChAAARCEA.LEDAhAIAVEFA.AEEA..PEHDhCAAODDB..NICBCGGDBGHA.dHAB...hCIA......hDAA...,1,-8,-32,24
YNaWORUSCcLEIZQBFKXgJHMbdTGfDPeVA,aAAARAAACADB.LADAZAEB.FAHBKAGA..JBBFHCCB.dCGAGCFAhAEADCIB.eDCHAAAA.NCIA.OEFBhAIA..SEDHhAFAEGDBBGGAMFIBbFGD..fHDBhBAA.....hCAA...,1,-7,-33,26
gWGYZXBFPHaJeMIQbfCDVRKTOEUSdLcNA,GAAAZAAAFADAHAFBeADAMAHBQCAA.CAHA.RCDATECA.hABAEDHFdDDALFFAhAAAACIBgEGAXGBCaFDE.hACAbGECDGIBODAH..SHAAhAHA.WHDA...hACA...,1,2,-10,12
dVcATeWHXJfFQENIbDYSMBKLRCOUaPgZG,eAAAHAAAXADBFADD.EAFAIAFA.DAHBMAIBLCCAhAAARCAAOBGDaBHDZEEAdCFCADEBhAAAJGCAQFFAhACA.NEIA.SCFH.CGGD....hCAA......hCDA...,2,-23,-5,18
KGdJMRFTfAYUZBgVQcDXLEHaSOebWPCNI,ZAAABAAAQAEADACALAFAHAGD.aCAAeBCB....bDAAhABACBDBKCEAdDGDREDFFCGAAADAUFGAhACA..VEEA.hAIAEFHF...OGAANICB.JHEA...hCEAfHAB.hCIA...,1,0,-29,29
EABQMXfKaVODWHYNTSJecLIFCPGZdRUbg,MAAAKAAAOACAHACC..TAGAeAFALCCACBBDZCDA.RCFFUECAhAAAECHFAAFABEEA.QFCChAIAaCHDDDBB.YEHBhBAASFFA.IGAAFGFB.dHCB.hCAA......hCFA...,1,-10,-17,7
DYPcUQeSgJWfbVFLARHTMXaZEIBOCGdNK,HAAAMAAAZABEEADEOAFAdAFA..DAHB..PBFDQCCAhAIAeBHFSCAAhAAAJCHB.bDCDLDFBhBAA.RFBAaFHDCEEAKEHB.cFGC....hACA......hCAA...,1,-11,-22,11
OJgZfAGDLCXQMIYUaeFVNBcWbPHEKdRTS,GAAALAAAQADAMAEAUBEAeAFAFAHD.BBHA...bCDAhAAAHCAAEDCB.RDFATECAhABAODAHZDGBACCADFFBXEEChACAaGCC.VGAAcGGAKGHB.....hADA......hAGA...,1,11,-13,24
beNLfDTWHBUSFdPAaZEJQIRVMOGKXgcCY,EAAAQAAARACA.MADAGAFA.XCCACAGAeAHHLBDBhAAA.TDFAHDAASAHBhAAAdDCCABFBZFDBIFHAhBCAKDHBgEFGcGGC.bFAADGCBBGHAhADA.FHBC....hAFA...,2,-5,0,5
CTMJBdbLAaKNVQFSUXWcgREeGfPIHOZYD,aAAAKAAAQACC.FAEAXACD...gAEBhAGAEAHBeCDAGCGAhAAAfAHAHECAZCFECGDAMFGBhAIAdDDAABBBSEBBWFHH.REGBOFFBhAHADIDA......hBAA...,2,-14,-5,9
eGOEHSKAIRNCQUYZTfWMVFBLgXPcJadDb,RAAAQAAAZADB..TAFAMADABAGALAHBXBDA.hAAAJBHBdCCC.eCFBEDBAHDFBhAAAADAACEEAUGGA.fHCBhABAFEDBgGCA.aFHDDHEA..hADA......hCAA...,2,-17,-6,11
OEbgNUGBKICdLafDZcWSVPAFeJQMHXYRT,eAAAMAAAHACCRADA.EAFE..bAGBUCDBGCCAKBBDdAHALCFBhAAAaCGC.ZEAF.SDHHhABAAEEBQEGATGGAhAEAOFFBBFEDCHHADGEB.......hBIA......hCAA...,1,-1,-11,10
SBLfFQgXYNKDAGWPMdEeTIVcOJZHUabRC,GAAAMAAAdAEAEADA.eAFA..TAGAICDAOBBA.HCEChAGAbBFA.REEBBCCDLDFBhAAAQEGAXGAAhACANIABAHHAPDHB........hADA......hAGA...,1,-9,-11,2
RWbGZCNaESQfdKeALMOPcIDHgTFYJBVUX,MAAAOAAA....IAEAHADATBGAFAGABBBAUCDBRBEAGDBAhBAAZEEAaAGA..EBBBQDEBhBBAdDGDAFAA.LDHBhBDADFIBgFAAYFGF....hCAA......hCDA...,2,-20,-6,14
BdcCKOFHaJWUgbTYDSeMLPXEGZfRIVQAN,dAAAKAAAHACBaADA.UAFA..TAGASBHBeBDBLCFAhACAECABZDEAREAA.QCBDhAGAAAEBBFDAOEHDFEBDgEFAhAIADFFBMIAAXGFDGGCBfHGFhBAA.....hAAA...,1,11,-13,24
LeIJQUARGWgfbYZBTcONDEVKSPMHaXFCd,RAAAGAAA..fADBZADATCDAOAFAEAGE..KCGAMBGBhAAAHEACFBHDdEFALCCAhABAeEHBIHGAQECAhCAAAAAB.bEFA.BGGADIAA.SHEGhCDA......hCEA...,2,-13,-4,9
eCWRZOQcAXJBbSKdVGHYfIMNPagDUFTLE,BAAAKAAAGACAHACA..IAGAMAEAaAGEDAIB..FBFHECAAeCABhAAARCDAZCGF..QDGAhACAAAEAXECCSEBHhBEAdFFA.fEDANIDB.gFEAhCBA....hCHA...,2,-18,-14,4
ETdfXPIWYUKNbFcSLQODRCHBMVaZGeAgJ,EAAAdAAA..XADA..IADAUAGAKCBAbAEDFCEH.LDGBhACAQAGA.RCBBHDFChAAAMDABZEABAEEBTFFAhAGAfEFAPGCCNDIA......SGBHhADACHHA.BHHDhAEA..,2,-12,-10,2
AEKbFSQCXfGMODPgWNHLURaeBJcVZdYTI,EAAAFAAAQADA..fACAGAGAMCCBDAEAgAFAhAAAHDDARFBAeDAFBBDAhAIAVFFAdCHA.TDDAhBIAAAIB.bDFB.CFHAOFFHNIDB.....hADA......hAGA...,2,-10,-2,8
bICXcSOLFaRHKBgPdUYQeTWfANMJGZVED,MAAAZAAAEADEDAEA..CAFB...SAFALAHBRCAAHBBABBGAdCFAhAIAQCECeBHFTEBAhBAAACAAGEFAVFDAIDDAhBBAOEDBaEHFKGHB.......hABA......hACA...,1,-4,-17,13
YAKSCPcFGJdERXWDIbLaHMUgVeZTBNOQf,CAAAFAAAdACARACF..DAEALAEA.HCDAMAHBUCGA..eBEFhAIAZEFATFAAOBFDQEFBhBAAAAFAKCBD.SEHHhBIA..cFCA.EGGBIHHAhCAA...hAAA...,1,-25,-30,5
RBQCVEOJUKXdGSDMcLeAYHfFIZWbNagTP,HAAAFAAAZACB..bADBaAED....TAFARAGBQDEAEBHFOCABhAAAKDHBGEBAMCCBeDDAhACAAAIB.IEGAhAHA.gFCACEDDUGEAdGHADDIB.cFFChAIAfGAE...hCDA...,1,1,-14,15
gBOSeZILXcMEUKJPGVHbAFQNfRCdaYTWD,QAAARAAAdADA.aACETAFA.DAIBOAEDZCCA.LAGBhAAAMCHB.ECDBKEEDGDAAhADAHFAAAAAAfDHAhAIA.CEFAgFEGeEHHXGDAcGBDhBGA......hBIA...,1,-7,-18,11
LVTbRUQSfWMDgYdeKNcEGaOXFBHJCAIPZ,ZAAATAAARAEAUCAA..QACC.SAEBMAIBDADAdCGAhABAeAGBKCDAECDFGEEAhACAaAHFFCFDBEHAHEFCAEEB.hAHAIHHA........hAAA......hCAA...,2,-32,-11,21
GAdbOWUCLIJYXcRSZKaMPNeBDfVEHQFgT,dAAAOAAACADALAFA..IAEA.XAFDRCAAZCEAaCGAhACAMAIBeEEBDBBBEEGBHCCAhAHA.QDFAhBAAFFCB.TGGAAAGAUGGBcECC.KFFD.hADABEHB.fHBBhBDA.,1,-15,-19,4
FSHQVTNPLgCEcKbeZBWDfUdJIGYaRXOAM,MAAAHAAATAEALAEAEAGEKBBA.ZBFEDACAdDBAGCCA.RCFAACCBQDDChAFA.PDGBhAGACEFDeEGHBDHBfGCEhAAAIGHAaFHDOFFH....hAIA......hBAA...,2,-21,-2,19
HEMDdSKfIeZORYPbTXcUaQBCGALJWgFVN,LAAAJAAA.FAEAHADBEAHB.dAFB.KBGDeBDFRDAA...bCABTDGAhADA..XCEAhABAaDFHBFHAACHBgEEBhACAMAIBDEEB.fDHAIHHA.ZFCB.hBAAOFHD...hCAA...,1,-2,-30,28
OHENFcaZGXSQJeUfgTIAYLVBCRDbdWPMK,LAAACAAARACA.dAEAMAFAHAGB.ECAAFBFDZCDAGCAAQEBAhABAeBHB.UEFB.TGAAhACAAACABCCDDDIB..bDEAhAAAKGGDOECCNEEA.aFGC......hBIA......hCAA...,1,8,-26,34
ESgLHVcQDKTeYAbPFCRdOUMWNfGaJXZIB,FAAARAAAdADAMADA....fAFAaAFEZBCBBBHAEAHB.LCFBhAIAHCECQEEChAAAKDHBeECAACCBbFAA..OFGDhBAAUGGANIAB..JHDASCCD..hABA......hAFA...,2,-21,-4,17
fCgLUXKTWAFbVIMPEROHGcNQZBDSJeadY,FAAAVAAAMADA..RADFHAFBGAGA.QBCAZDAASAHBhAAAeBFDdECACDGALEEBhADAKEEAAAIB.IFAAEEHFNIDBBGBDhBAAaDHD....fFDAXGGA.TGGAhAFA.WHBG.hBGA...,2,-14,3,17
VGdLDNEQKYJMgIAbOeaPUfBTcRCXFZHWS,eAAAaAAA.UAEABADARAGB.FAFAHBCB..SAHHdDFALEBAhAAAEBBB.QFGAhABAKBEAMDAB.AAIBOHEC.hADA.TDCACDHA.ZDGB.GGDB.DDGBhBAA.NEIA.....hCAA...,1,-5,-21,16
KNaeLJMPbVCDIXdFOWYRBUESTgZfcHGAQ,QAAAaAAALADAMADA..VBGBDAHBdBDAOBBBRBFBBDCDECDA.hAEA..TEEAZDCAHEFBhAFAAAIBeCHHbFDDCAHBFFBA.hBAAUGGASFHB......hCAA......hCDA...,2,-14,0,14
gZEeVKdBPaAUbYNQDcSTIfHXWFCOGJRLM,UAAA..bAAAQADASAEA..TAFAHAGBFCAAGCBBhADARCEBMDDBEBHFeDFFhAHAdEAAaDHDADIBDEEB.fEHEhAIACFGDLHEAgGFA...hAAA......hABA...,1,-4,-9,5
aFRTQbYMdVNfIHeLCAUJXGZWKDBSOcgPE,XAAAZAAADACABAEA..OADA..PAGBEAGARBCFTCEAhAAA..bCCAdCGA.hABAfEBAHDGBeECBhAHAABIBUFFAGGEBSEEDaEEH...hAIA......hBIA...,1,-10,-21,11
IAWGMPTVNKbBRJcZQSdgaHFODfLEXeUYC,GAAAMAAA..TADAKADARAFFZCDF.dAHAHAFBDDAB.EAHB.eBBBhAFACDFD.ADDA..VDEBBDHAhAAAQGGAaFAD.hACAfDHALFGB.YHDAIHDA.hAIA..WDDD..hADA...,2,-32,6,38
CAbDPaMZGJTfRYQUHIdgcLVBXKSEeOFNW,DAAAaAAAGACA..TACARAEAUCGAHAEBdDFCLEABXAGAEBBBhAEAeBBDFCGD.CDDAAAGAbEDDhAEAZEFA...fGGAhBAAQFGA........hAFA......hAHA...,2,-17,-5,12
UCgTcaBIDPOeLAMYFdGXVNSZQWHJfKREb,MAAAdAAAGADA..XACASAFAZAEBHAGBKBHBECBFbCCDCCFA.hACA....TEGAhAIAaDAHDDDBeBBBADHBFEFBQFEDhBAAJEHB.fGBARFAA..hBGA......hBIA...,1,-8,-16,8
VYTgZeUObfQAMaEHcXBGDSJPdCLWNIRKF,EAAAHAAABACAGADADAEA.SAFA.dCADLAHB.hAAAIBEARCFAFEFHTFAAhACAeBFHOCCBbDAAAAFAaEHBhADAXEDCCGCA.KEGAYFHBZGEAfHBBhAAAMIAA....hBHA...,2,-31,17,48
EYCbZWAJegQHPIKUDSGOTFLdXaMRBNfcV,eAAAHAAAKADCDAEAGAGAFAFDdAHA...aBCDRCAABCED..fBEAhAAAEDFA.bDEDADIBQEGDhAAA.hABAIHBAODHDTEBAMEEB.cGBChAIACGHDWFFDgGDGhBEA.SGHD.,1,-2,-20,18
KAGMdSVENeTcRBPWFbaUQXgIYCZfJDLHO,dAAAEAAA.eADARACABAFBFAGD..UCCAQBGA..XCFChACAgCCACDAAZEDEDCFBHEGBhADAAAHAGDAAMAIB.SDFHhAAA.TFGA.PHEChADA.aEEH....hCAA...,2,-18,-14,4
YXEWGCBMONaAcVHfQTSUFIRdgKZLJPebD,HAAATAAAFADA.RAFFdAHAZACBLAFA.eBEBbCAA.DCABECEBGCGAhAAABDGA.MDEBaDHDAEEBhAAAfFFA.hACAQGAASFFBIHHAKHGA..hACA......hAGA...,2,-14,-9,5
HOJYSLNfcUgQXRITbVDGWCFaZAdBEMKPe,EAAAMAAAKACAHACC.OAFASAEBLCCA...fBGEhBAAgAGARDEAbFGBhBBAGCCA.FCHDABIB.dEFAhAAA.eFDH.YFHB.UGAA.hCAAIHFADGGB..hAGA...,2,-16,-6,10
YAPVBNILJURQeCZDaKSgWXTGcOEMdHFfb,BAAALAAARACA.eADHZAFBKAHB..SAFA.XBGAhABAGCAAECCBHCABbCGDhAAAAAFAPCFB.IEDAhACAQEDAaDGDTGGAMFABdGGA.fFCEhACANIAB..hADA...,2,-24,0,24
fNLGXSaIEFcTgCRPHDWZYJBeAUObQdKVM,OAAAdAAAMADALAEAGAGA...aAHDEBDAFBBH..TCBAhACARCEAHDBCZDEBBDHAAAIBbEFDQEFDhAFA.fFCEhAGASDHHgGGADDEBYFCBhBAA......hBCA...,1,-5,-14,9
DFVEBIKaUHSMgdeCOAcWYfJXTRGPZbQLN,......cAAAfAAA.TADARADAZAGBLCAAhACAFAFAEBCBKBHBHCEB.MBIBhADAeCAFAEAAJEDFGCEAhAAAbFGBDGAABCGD.aEDHSEAAdEHAOGFC.hAEA......hAGA...,2,-10,-5,5
PVZKSdIENHRcgeaDJTFBXUOGWMfbYLCQA,ZAAAdAAAEADAHAEA.RCAAeAHHaAFD..DAHBTDEABCBA..UDDAGEABhABA.MDIB.bEGDhACALDGB.AAIBKDADhACASGABIFBAgGCAXGEC.hADA......hBAA...,1,13,-37,50
VNePDSgMKJRUTICWGZQOdbXEBLaFfcYHA,eAAASAAAMAEARBCAUADA..CAHAZBFFdAGAECCBLCHB.FDBBhAAAfCHAHDEBADEB.hABAPDBBKGGA.TEDAhAAAIHDAGGBB.bFGB.....hBDA......hCAA...,2,-14,-5,9
NYdZMcHTOfbPDXeJQLESRUVFCIGAWKaBg,aAAABAAA.....gACAdADAZAEBHAGBOAEDbDBBDDGBeAGBhAAALEEBRCAB.FDHDhAIAGCFAABBBKGBD.MAIBhACATGGAXDDD.EEHF.SGHHhADA.CHAA....hBAA...,2,-14,-4,10
QUJTYaKeDRXIgLFbWfdZBCEcVOPNAMHGS,HAAAGAAAQADCUADA.TAGAaAFEeAHHRCAA..XCEAhAAALDDAbDGDdEHAZEEFEFDAhAAAOFAAAFGAMIDASGABhACAKGAA.DCIBgGGG..hACA......hAGA...,1,19,-13,32
bNVOTKDaEICeHBFfXAPcMgLZRJUGWdYSQ,MAAAZAAARAEAGCAAdAEA..QAGA.VBBBTCDAaCFD.hAGAEBHF.eCFHHDGBfDHAhABAADEAPEBBgGGAhBAALGFAWFADSEED.NIBB.hBBADACA.....hBDA...,2,-6,-6,0
ZOfPJSYXGAQcDeBNgLaWCKdMFVTRIHbUE,QAAAeAAABADALAFAaACE.KCCAdAFAFCEARBGFHCDB.EDAAhAAAZCGBODHDJEEB.XFBAhADAAAAADDIB.gFFBhAHAMGAA.IGEAfGGA.SHAAhAGA..hAHA...,1,6,-39,45
OEXRCLKHVdfYQDIgWBecTGNAMUaPJSFZb,aAAASAAAZACB.EADARAEALAHB.HCFBdAGAQBEAhAAADBBB.gCCBhABAeDEDGECAAAIBMCIBhADAPEHDbDGDCEFAfFAAIHHABFEDcGGChAFA......hBAA...,2,-8,-6,2
EgXLUDOJIFYNHPMVABafWTeKdbQGSZCRc,aAAATAAA..eACHdACAGAEAZADBRAFA.EAGALCFADBIB.OEEAhAGAFCGDHDDBMBBBAAEBfEHAhAAAKEHBQGGChAIACGAAXGFCIHCA......hBAA......hCAA...,2,-12,-5,7
QUYTPbZWSRcILeFdJCHAXOfMVGDKgEBNa,OAAAMAAAGACBKADABAFBQAGC.UCDBTBGAZDFBRFAALCCAhAHAeBBB.dDGDCDHAAEEBhAFAXECADFHB.EFFAhAIAaGHD....PFHD...WBBDhBAA.....hAIA...,2,-21,-10,11
cTdbDYLKMQCgZaSeRfNHIEOFUGPXABJVW,BAAAVAAA...TACAdADADAFALAEB.MAGBQBFAhAAAZBGBeCABRDDAHEGB.hAAAEFBAFCCH.GECBhACAAAIBcGFCbFGDCHAA..aCHFNCIA......hBFA......hCAA...,1,0,-19,19
WQASYgXONHIVaFdECeGfRZDLMKBPcTbJU,SAAAXAAAHADA..aACDEAGEeAEARCDAZCGBMAIBBDAATCDAhAAAUFAAAAAA..OBGDhABAIFEAdEAAGEFAhAEADDIBKGGA.bFCBQGCCYFHB....hADA......hAFA...,1,7,-9,16
CIGBfWYdOSVPeDbANRKaZMFJHUgXQcLET,RAAAZAAAMADAHAEA.XBGALAHB.EBDATCAAGCEA.BBGAhAAAfCEEdDDC.SDDDhABAeEGFACCBaEHDFDGBhACAUGBAQEABCGDAIHHAOEHD.DAGAhADA.KFFD....hAEA...,2,-2,-2,0
QBGWCNDPgLIKXFHREYMcZVbfAJeTSdUOa,eAAAdAAAaADAGADA.CAFA.DAGALAHBKBDAHBFBEBGF..MBIBhACAZDBBVEFAABHB.TFDAhAAAOCBCBFAC.NIEB.hABAgEEB.FEHH.....hAFA......hBDA...,1,-5,-29,24
VebGgdNUOJYIXDKZPFaLcWATMEBQfSHRC,EAAAQAAAHACARAFF.eACAGCDAdAGAOBEDJBHB...XCGAhAAAZEAAaEHDLFFBhAAAAAIBMCDBBDAACCCD.bEEANHAB.hAEAUGBADIAA...FGEA......hADA......hBGA...,1,1,-9,10
HPRabAXILNcYdfZGQUgKJMBECWTDeFVSO,LAAA..cAAAdAEAGAGA.QCAAKACCMAFAEBDAhBAATDDAeBFASDFBhABAHDDARDGFACIBXFDAhBGAIFHAfFFEUGGB.BGAA.hCAADIAA.....hCBA...,1,-9,-12,3
GAFISMBfUcJEeCdXTgRDHWLOaYNPbKQVZ,SAAAMAAABADAUAFAEADA..dAGA..TBBARBEBHCCBLBHBhAIAaBHD..PDABhAAAbCEC.QEFAhABAGEFAADDBfFBAeFHHXGBADFEBOFHDhBAA.....hADA...,1,-5,-9,4
gJDFaEfBATIPLOWdHXUeMbRYQcGCVSZNK,TAAALAAA.dAEAHACBeAGBRAEA..QCFAGCAASAHBhABAZEAAKCHBDDEBECCBAAHAOFEChAAAXCFDMFIBbEDDCFFAhACANIBB.FGHBBCAD........hACA......hAEA...,2,-6,1,7
aRVMZgOXcLQHdTKGWfBCUbPENeFJAIDSY,SAAARAAAZADB.OACDLAGB.HCEBdAEAGAGABBFBbDABhAAAEDEA.eDHHAAIBDCIBaEBAhAAA.MEGB.XGAAhABATEGAKGGDCHHA........hABA......hADA...,1,-6,-24,18
FNTEURBHWOMSJDVeCAXPGcbIKYQgfaZdL,GAAA..bAAAKADAQAEAaAFAZBFEdCDALAHB.TCAAhAAARDFAHFFCMCEBDDABeGBAhAAAABGAXDFC.hACAIFGA.fEAENIAB.EGDAhABA.BGHA.SHCGhACA,2,-21,1,22
ZOUgAPcJfGCYFVLBIaTMQdXWbDHKeRNES,JAAAGAAA.FADALADBBAGA..aAHDMAFA.dBFA..bCDAhAAAHCGB.REEBEDCBZDCAODGDhACAABHA.fFCAhAGACFCDIGHAQGGBDICA...hBAA......hCAA...,2,-29,-15,14
QbPEgBUfcZeMICTGXHDaYVJdOFAKRSWNL,RAAASAAALADBQAFAEADA.BAHAfAFAZCFAeCCDhAAAMAHB.CCCAGCFAhAAAHEEAaFAAVDABdGEDAFIBKEDAhABANICB.bFGD..........hADA......hAIA...,1,-2,-13,11
VKFGbZIRdPXTCEgHWBfaSQDUYJMecANOL,LAAAFAAAZACBRAEA.dAEA...TAGAEBHFHCFBBCAA..aDEBQCCChABADDIB.UCGBhACAMECBADFBOEBBhAGAKFABbFFC.XEEC.CEHDfGGAhAIASHAGeHFA...hBEA...,2,-18,-10,8
MNLYQdUHGCOFgKfWSeJZPETbBVAcIaXRD,aAAARAAAMADALADA.dAHAHAFCGCCAFBDDKCFA..SBBDhAEAeCCDZEEAEFCBbCFCAEGAXGEAhAAADEIBQFAAhAFAOCHD.fFFA.PHFCBHHA.hABAcGCDNIAB...hAIA...,1,9,-8,17
abgCIEZRVLfHUTOYDQKeAJMSGNWBdXFPc,MAAAGAAABADAdADAFAFA..aAEDCBFDZCEERAGBLBBBHDBB.OCFDhAGAQEFA.AAABSDHHhACAXDCDbEGDhAIAEFEB...fGHA...hBAA......hBIA...,2,-30,-9,21
cXHKBLIMJRTgWSePFEDbdQVNCYGfZAOaU,aAAAXAAAHACBLAEA..MADARCEATEFASAFAhAAAeBBDEFAAdBDAQCFAhABA.CCHAGEEAhAIAAAFAOAHDKDCDBEHBgFCFFFCDDEEB.NEIA.fGHAhBAA..hCAA...,1,-6,-7,1
dcgPSMTHGVWUZfQFeIYbXDaAJBKNRCOLE,KAAARAAALADBEACE.dAFA....gAEBMAHBHDEAGBGAhAAAUFBAZFGBQCCAhAGAeGDE.bEDAaCCBAAHABFHAhBIANAIA.CHHA..........hAAA......hABA...,2,-15,-10,5
ZOGIPYTXMfFCDEedVaWUBSbgQHRNcKLJA,GAAA..IAAATADA.MACACAFBEAHBeAEA.dBCAaCDCBAHAhCAA.SCEAhCBAQCFCHCGBREFAKGHBACEAZEEFhCCAODAHXGGBDEEBWHCA....hAAA......hACA...,2,-16,-12,4
LEPFdDSQZTKOVcaJMUBNfbgeWXCGYARHI,HAAAEAAAdADAQADCZAEB.TAGAOAGDaCACMAIBBCEA..hAAA.bCFDeBCD.CDBDADGBhAAARFAALDHBDEEBKEHBVFFBhBDAcFEC.NIAB.fGBAXDDCIHHAhACA...hBGA...,1,22,-23,45
HeabfIQVEgMGKPOBXUNcLZWTRCdDFJYAS,HAAAeAAA.aACA..bADAQAFA.ECCAGBGAOAHFXCCAhAAAUDEALEGBhAAAZEAARDEFdGGAFFAAAAHA.fHDBhAFA.........hABA......hAEA...,1,2,-18,20
MQWXGPNgRSfbCZDABLFeUHYIaTOdJKEVc,LAAAeAAAHADAaADDdAGA.ECCBMAFA.QBFAGCEAgDGBhAAARCAA.bFAAZDEAhABAAAIB.FFBA.IFFAhACATGFA.KBHB.WEHH.XFDD.hABASHGGDFAA.hAFA...,1,-2,-3,1
TXAWdMFNfKLICOcVgUGBSeJPbEYQDRHaZ,dAAAMAAAFADAKADALAGB..OAFAVCBA.GBBABBFA.eBFFhBAA.JBHBEDFBQEDChBBAHECCZFGBAAIBfEHAhCAACDHA.gGDA.SGFHhCBA...hACA...,2,-27,-8,19
PbJFZfXgASEHYdGKLUTRNIQaMBVeDOWCc,HAAAGAAALADBRADAQAGCaAFABBFAeCDBOAHD.CCAD.bCFAhAAAZDCA...XDFBhAAAAADAEEGBdFCAKEHBTFEAhACAMFBADGGB..WHEA.....hACA......hBFA...,2,-18,1,19
JcMNdUgTDCbQEBFVGKHZaARPWXYLfSIOe,RAAAXAAALADB..SADAeAFAMBIBdAGAUCFADAIBQCDAhAAAEDCB.FDAAGFABhAAAHDFBADHAPFFAhABAfEAEOHDAcFDA...TGBAhABABHHA.KGHB.aHEC.hAFA...,2,-9,1,10
RCFOcQXgGTHEdBWYUZDfSKVIaMLeAPNbJ,...bAAARAAAOADA.QAGAGAEAHAGDEBDFBCEAUCAAZDDFhAAASCCDKDGDaDHDeGAAhABAAAAAJCGF.FGGAXEEChBIA.dGGADIAA.......hCAA......hDAA...,2,-23,1,24
gCGcHfRFeDKQWJIbPVLUSaZNXTMABOdYE,dAAAEAAAGACAHADARAGFeCAAQAEA.JAHBbCED..LDFAhAAAaCHDZDAE.TEAAADGBOFAChACACCBDFEDDKFGA.IHHAhADAPFFASGBH.XGDAhAEAMIAA.BGHA..hAHA...,1,3,0,3
FBDACUKZIbGTMNgYafLVXEeRJScHdQWOP,KAAAZAAAGAEAMACA.....gAGBaAEELAHBECAARDAASBCHhAAAHDDBdDGAQGBAhABAOCEABDEAAACACFHAhAEAbEDATGEA..fEHA.hAIAeHBA.WHEA.hBEA...,2,-22,8,30
LgGTUINBQJfYEVZcOaFbXWDSPARMdeHCK,RAAAeAAAHADBLAEAGAGAUDAABBCAQCDAJDDF.EBHFZFEBhAAAOCFFaDHDFGAAXEGDhAAADGDB..AAIBdGGAhABAKFAAIHHA.YFFF.bGAAhABA......hAFA...,1,-7,-16,9
UXLGSEfOdJANRYagHePKTZBMFbWcICVDQ,RAAAaAAAHADB.eAFATADAZCFBFCCH....bAFBIDAAhAAA.DBIBQCCChADALEEDEDHBdBHAABBBgFAAhABABDFDMEEBCFGA.XFFAfGHAOFCBhAIA.NEIAKHEAWFDD.hBAA...,1,6,-16,22
UbGZVSCFeRTMEHcBAJXPKfDgdWQOIaNLY,XAAAKAAADACA.dADAQAEA..aAFALAHBUBGBZDBAhAAACBCARCDBEDFBHDFBABFBJDHF.hAAA.fFDEhBGA.OFHDIGGAYHBA...hABA......hAIA...,2,-32,-13,19
IPAcfYedDKOMLVBNJFCWaZTHSRgbXUQEG,...fAAAeAAAdAEAOAGBMADALAHBBAHBFBCDCBCAZBDBHCGBhAAARBFF...XDEDhABAECAFGEGAACIBDEBAKEFDJFHBhBEAaFCA.SHBA.....hCAA......hCBA...,2,-24,-1,23
XTLBSGVFNeEKHdZIUaCbcDWPYRgJQAfMO,MAAATAAALAEA.GBBAFACAEAFAHCGBZBEEUDDBaDEBCFAADAIBhAFA..PCHDRFCBQFEAhAGAAAIBODGHSGGBhBAAeFABdGHA.........hAAA......hAFA...,1,2,-17,19
fagVKAeBdNWbcEJMHRSGYXUPQILFOTZCD,eAAAdAAA....bABDEADAHADARAFAGCCAUAGA.QCFBhAAALDEATFAAZEFADCIBaGAAhABAKDADACFBBGGA.WHEGhAGAMDIB.XFFA.FGDB....hADA......hAFA...,1,-5,-7,2
TSKLRMcWGUQDaCNZOPAEVBfJgXHeYbFId,EAAABAAA.JACAHACA.eAEEFAFA.dAHAKBCDRCCAMCGB.GEEAhAAAQCEAaDHBZFCBAAIB..hCAA.fGHAhCBA..XCGA.bECB.SEFAhAAA.LHCAhCAA.cFGD,1,3,-36,39
TIdZJAeRFNKVPUXGbBLcaMfYHWDSOCgEQ,RAAAKAAAUADAGACALAGBMAEA.HDDA.DAIBCAHAEBEE..TEGAhAAAZCAFACHAFDFA..PFBBhABABEDAaDHD..hAAAfFDESFEAQGGBdGBA.hACA......hBGA...,1,-8,-23,15
HPdUSGDcZgeLYITFMEJOKBNVfWCbRQXaA,HAAAdAAAGADAZADBeAFALAFA.TCBAEBHFKCAD.BCCCVCFAhACACCFAREEA..QFEAhADAADIBSFCBDEIBgGAAhAGAFFHDOHEC.fGGBXGAA..hAHA......hBAA...,2,-9,-9,0
bSMBGQLDfZERJUcFOedXYACIKaWPgNHTV,KAAAaAAA.....PACAHACBbAEA.MAIBGAFALCFBhAEAZCCARDGFUECAOBBHeAHBhAAAdEDAAAFACFBC.IEHAhBAA.gGGANIAB.SHDAhCAAQGGB.DFFB...hDAA...,2,-9,-4,5
YISVNAWfZHFcbTMCeGREaPgdQUOLBKJDX,ZAAAHAAAFADATAEA.eAGHEAGA..aBGEdCAD.QDCAhAAALCABKCCDXDGA.hABASEABACFBfDEEhACAbEEDMIAARDGBUGAABGADDFGBIGDAhAGAWHFACGGB......hCEA...,2,-19,16,35
JaFENOKWZPbMYgVICSdTReXQDBfAGLcUH,GAAALAAAHADAaADD.EAGEKAFAZCDA.MCFA..VCAASDADhAAARCFAeDEB.QEEChACABAHBACFAUFAAFDHBOFAEhADA.PFHDbEGD......hAFA......hAIA...,1,8,-19,27
DMcaZUbFgJKRdCVQYHWeNSPXLfIATOEGB,EAAAGAAADADA.aADAZADEFAGA..KAHBRBFBdCDA..QCBChAAAHDBBeCHHSCFAhAHALFEBAAABTECABGGA.MDIBhBCA.UEEA.bGCCCHCA.....YHEGhCAA...hACA...,1,-4,-13,9
WHfJGbFNKUgMEODIaVQLCSRYcAeBZXdTP,eAAAZAAAdAEA..TADAHAGBGCAA.FDDAKAFCMDGBEAHFDCCBhAAAaDHD.LCFA.hABARDCFAEFAXGAA.hABAfGHAbEFAgGCAOFFHQGGChCAA.CHEA...hCBA...,2,-8,-6,2
AdCZaOQDPXcHBYeRLgVSFMEWfKNITGbUJ,ZAAAaAAA.QAEADADA..XAEAHAGDeCABRBBALAHBhBAASCCAECEF.KDEATDFAhBBAbEFAACIBdGDA.OEAHhABABEHAgFFGFGGB.MDDB.fHBBhBHA..hCAA...,1,7,-22,29
GXVOTHKaZcWMdDUgNBYEAeLIbCfRQPFJS,eAAALAAACADA.RADFQAFCFAFAGBDB.OAHDHDDAZDGB.MCCBhAAAdCAADCCBUGDABDDDhABAAAIB.bDFB..fGHAhABASEHB.XFED.KHAA.hCAAaHFE.....hCBA...,2,-15,-5,10
OcEJYBCIVLTGZWaSgHbXPeRdNMKFQAfDU,DAAAOAAAEACA.BADA..CAEALAGBZAEBaAGD.HCCA.XDGAhAIARCCBdDGAMAIB.QFEChBAAABBBfECEhBAAUGBAJEEB..IGHATGBASBEAhBIA.bGFANBBA..hCAA...,2,-18,-18,0
OVcZHeYIAFKUgLTBNJSPEbRMDdWXQGafC,KAAALAAABACB.SADHEAEA.RAFAdCAAQAGAGCDBaCCHhABAOCCA.ZDDAHEEChACAeCGBAAFAFFHDUEAANHCB.JFDAhAAAMIAADDIB....fGHA.hAIA......hCHA...,2,-19,-3,16
KDaEgTQONJcLRBHYCdfXGSUeZFVMAIWPb,..IAAAbAAA.DACAEAEA...TAGAQAEA.OAGFhAIAcCAARBCBHDFAhBCAdCFAGDDAeECBZFDBMCIBhAAAABIBKFGAaDGDgEAB.NIABBGGAhABACHHA......hACA...,2,-8,-3,5
YNCfEMaAXTdcJPKgHZFGWOSBVUQeRIDLb,dAAAJAAA.KADAHADBGAFAOAFABAHA.UCCARBFFLDAA..hADA..bDABCCHAEEEBACIB.hACATEGA..gEDAhADAZFBASGGAeDHBDFABNIBB.aFGB.hBAAPHAC.FHGE.hBFA...,1,-9,-10,1
HfACcdEgTNMLDUSOZBaPVRKYIeFbWXJGQ,dAAAEAAA...TADAMADALAHBDAFA.OBCAaAGERCAAKCEAeBFFhAAAFCGA..XCCChBHAGEEA.HDFBAEEBCEHA.cFGDhCAA...NEEA.SGHBBHCA.hCBA......hCDA...,2,-27,-9,18
JbdCNILGEBHMXKDgZfATaSecQFRUWOPVY,aAAAeAAA.QADARACFUAEA.OAFC..PAHBVCCBJCFBhAAAdDEA..CDGD.LCHBhABAEEHFHGBAMFGB.DHAAhAHAZGFAADHB.SBBD.....hAIA......hCAA...,2,-14,-13,1
cAKgBOWebMFYfNIdHSRaEQTCDLZPVJUXG,BAAAeAAAMAEAFACA......fAFAdBDAHBFARDEBEAHBTDGAhAAALCBAZFBAPFHDhABAUDFAGFABAAIBOCCHhBFA..YEHBSGGDaGGHDIAAJHBA.hBHA......hCAA...,2,-20,3,23
NLJcgMfBQHSEeIVZKTFWAdbPCRaGUDYXO,dAAACAAARACA.GADA.DAFAOAFALBFB..JBFBMAIBBBHAHCAChACA.EDHBeCABZFDAFFHHhADAACCB.aHBAXDDDhAAA...gDGA.QGGAhACA.SECDhADA,1,-15,-32,17
UVAWTdEHLagDKcSJZbOICRfYNXFQePGBM,dAAAHAAAaADAKADC.SAFAZAFB.OAHDRBDF..fAHAhACAXCAA.eCBFGCFAhAAAMCIBACFBEDDBLEFBhBAADEIBbFGDCHDAFHGEBGAAWDHD.....hACA......hAGA...,1,-8,-13,5
XdROZPaUKJMEFABVHDebTLWYNQGScIgfC,HAAAeAAALAEA..YACCGBCASAHHhAAAIAGACBHARCCAZCEB.aDGAKCGDEEGBhABAACCADDIBbFAB..NHEB.QEEChAAA.fFCA.dGGAhAIA......hCAA...,2,-20,2,22
TKZXOIFdLSagMVHWBcDCJfNbUAEGReQYP,RAAAeAAAQADC..TADAZAFBOAHDdAFAaAHB..MCCBhAAAHCCABDDACCHAJDFBbDGDEEHBhAAA....PFABhABAXGGCLEFD.SFCAhAFAWEEDDIBA.fHBFhBHAAIEA...,2,-15,-10,5
ACPdSWXZcJOITDYKGUNFaELfHMRVQBegb,dAAAXAAAZABBOADCDADA.GAGAFAFDLAHBHCEBRDCB.BBDAeDHHhAFAAAAA...SFGDhAGAJDBA.TGDAhAIAKDFAaEGE.EFDA.MHBA.QGGAhBDA......hBHA...,1,4,-30,34
OPMdGbJaReZIcLBCDHKUgYQNSTAVFfXEW,FAAAEAAA.OACDdADAGAFA..aAEARCBBeAHBZAGBLBEBDDDAHDGBhAAAKDHBUFBB.QFEChAFATECAABIBXFFAhBAAMIAA..IHHACGCD..gGEGhCAA...hAIA...,2,-20,-3,17
aWbEXMcIFBAPJeZYSGdUQLCRHTNOfgVKD,eAAAZAAAGAEAdAEALAGBHAGDOCAB..fBCAhAAAKCCDaCHDEEBBMAIB.FDDAADEBJEFBhABASEBA.hACAQEFARGAE.TGBA.NEIADHFAhABAXGDD.BGHAhADA...,1,-3,-8,5
BNJSKfdUgIFaQAHWMPVLecYbGZCXEDROT,HAAAMAAALAEAeACE..bAFBZBBAEAHFRCEFBBHA..SCCAhAAAdDBAIDHAaCEDACCAhCAA.PCHDVFGBGGABhAFADEGBOFFH........hDAA......hDBA...,1,-9,-14,5
SedFHWGXQPYLEgVARCbTNZBKUcafOIMJD,RAAATAAAZADBKAFA..aACA..OAHD..MAFASCCDhAAAeBDAHBGBGCFAQDBAhAAALDABEDEBACFBbFGDhABABEGD.fFDADEEBdHABFHDAXFGAhBDA.....hADA...,2,-8,-1,7
HRQgbfLcaJWMAGDCZVSEYKIUTFeNXBPdO,GAAAZAAAEADE.KADAUAFAeAFEBAHA..dCDAHCAARBFBQEFBhAAA..bCECLFDBhACAaCHDMEFBACHACFHASEGDhABAIHHANDAAOHFC.....hADA......hAIA...,2,-13,-13,0
gfKARbYGFWSDCaPeMVOZNXUHLTBIdcJQE,RAAAGAAAFADA.DADACAGA.eAEA..MAIBZBFEUDCAHCCALCFBhAAABDGAdEEA.QECBhABAEEHFKGDD.ACHB..bEGDSGFHhAAA..aGAA.....hACA......hAIA...,1,-12,-25,13
acBYXTGdICWAJfVbNLFERKSUeQPODHMZg,VAAALAAA.RADFKAFCeADE..QBGADAGAHBDAZBGB.aDDChAAABCAA.TDEAhABAdFDACFFAACIBbEGDEFHB..SCCDhACA.OFCBMIEA.gGDAhAIA....hCAA...,1,-14,-16,2
fCeGWVBLUacHTNYZdSRXJgQbDIOFMKEAP,CAAAeAAAGACABADALAEAUAFAHCCA..TCAAZDFBRECAJDHBQCEAhAAA.bCGDOFBBhAAA.MICAAACBfEEEhAFAaGHD.cGAA.dGDA.XGGAhAGADAIB...hABA...,1,3,-17,20
UfJQIOKcXaAeTHFWVbSPgERZMDdLGYNCB,HAAAFAAA.VAEASACH.EAEARCAAZCEAdAHAGBFACAHBBCHBUEABhAAAQCDAKEEA.aDHDhAEAAACA.eFFB.WHBAhBAAbFGD....MEIBDHBA......hAEA......hCAA...,2,-17,-5,12
fCBEGVLaYUbDdJFOMTXcgNQHRPWIKeZSA,BAAAEAAAGACAaACA.UAFAdAFAFAHB..MAIB..TBCAhAAAXDFA..gCGAhBCAHEAAREDFIGFAhAAAeDEBAEIBCFBAYHBA.DFIBOFDB.hAEAQGFAKHGAfCBEhBCA.,2,-21,-7,14
FfQVaNKXBOgTJLRbDUHEdWYSZPICcMeAG,GAAAQAAAaADAKAGAOACC..TCDARAFFDAIBHCDB.ECHBhAAAdCFA.SCHBhAAAZEAACDCCeEGBADCBfEGAhACA.XEBABFFDLHAAbGACYFFFhAGAIHEA..hAEA...,1,-2,-9,7
AWCMBGDPSgeJLQUITROHcYaFNbXEfdVZK,MAAAGAAADAEASADA.eAFHLAHBQCGATBBAhBAAHCDBaBDAFBGBbEACEEGBhAAAdDDAZEGBAADABAHA.gGGAhACAIFFAOECHYHAAfGEEhBBAKFFDCDCC....hCAA...,2,-24,27,51
ceRWYGSOdAPZMBDKVLfCUgHJbTNIXaFEQ,ZAAAMAAAKADCLAEAUAGA.HBBA.TCEAXBED.FCAAEBHFhAFA.eDBBRDFA.GEEBhAGAdECAAEEBBFFDfGCAhAIA.CDDDJHEAIFHA.aGBC...hBAA......hBBA...,2,-33,4,37
ENdgBAVbSMCYOcJLKUTfaZWDXQGHPFeIR,SAAAMAAA.OACDLAEA.TBBAZAEAXCDDhAAAHCEAeCHHECFBdDHAAAFAbDBCCAHBJFAAhABAKEFB..UGCAaFFBQGGAhAFAFFHD.NICBBGAD...hAIA......hBAA...,1,0,-9,9
dNSaXYAOPCEZJLQHMDeFKGRbfBIgVTWUc,CAAAEAAAZACALADAHAGBDADAeAGH.GCBARCCABDFA..IDHAhAAA.TEDAUFFAdEHAhAAAaDDAAAEAOEEHQFGAhAIAMGAA.KGEA........hBCA......hBIA...,2,-30,-2,28
afdJZBDLYCVIQMPEUeTcNWbGSOHgKFRXA,dAAAZAAALADBCADA.QAFAEAFAeAHF...TCAA.hACA.cCBBbCEDGEGAhABAHCEBFDHDAAIBaCGEBDDChADADFAAIGEAMECBPFABWFAAOFGBKHBA.hACAfGDA.hAFA...,2,-11,-3,8
OBWNFEYLMXbKPaTARIVfUQCeZJHGdgDcS,RAAAVAAAQADC.ZAFBHADBGCGAdAFBDAIBOAHFBBGDFCCHEDAAhAAALEEBMDDBKDHBaFAAhAAAAEEA.UGGB.eFCHhABAgFDH.SFHD.YHDGhADA...hAFA...,1,3,-16,19
bYHQBWSRKfAPdCVNgEXcUaFGTeDMZJLOI,dAAACAAA...VADAEACAUAFAGAGA.eCAAZBDBLBHB.hACAOCAAbDAAHEDBQDFAhAAASDHHRFDAAFDA.hACAgFFB.aGAADFIBMIAAIHGAhAIA.....hADA...,1,-3,-17,14
NMKbcSaQLPWTCHUFIdDBEgGRXOZeVAfJY,JAAAMAAA.KADA..SADBLAFB..TBBAHAFAFCCBdAHAEDDBhBAARCFAZEDA.AAHA.fDGAhBBA.bFCAaEHBhAFA.PFCBCCEC.DFIBBEHA.XGGAhBHA.....hBAA...,2,-29,-7,22
EPSOgebLDCZKXQUJfcRaWYdTNBFGHIMVA,EAAAOAAA..eACALAEAZAFBQCCAUBBBJBHB.RCGFaDABdCEABEDDhAFAHEDC..MEIBhAAAACGB.SFBBhADADEGBXFGDfGGA.YHBGTGAANIEBhAGA......hAIA...,1,13,-34,47
JXUKbaEZFYQfcVgWNRPTCeSIHGABDdMLO,dAAAMAAALADA.OAGDXACAKCBA.EAFAZCEFQBGAhAFA.VCCBgDCAhACAREFATFDAeCHHSCFDhAIAHEABAAEADFIB.bGDAaGHB....hBAA......hBBA...,1,-5,-10,5
IgMdYOKVeJFfDEAZBCaHGNXQUTRSPcWLb,ZAAAaAAAHACBGAEAQAEARAGB.SAGAPCABLDDBhABAICHAdEHA.KEBAeBBDhAEAFFFBEGAAADEACDFAXEEChAHA.TFGAWHFAMIAAOHEC..hBAA......hCAA...,1,-5,-6,1
YCfFWULHTOMDAZBReSbNKEQaJGdVPgIcX,RAAAeAAA..SADBKADAEAFE.aAFAdAHA..VBFBICCAhAAA..XCCChAAACCEAFCGHLECAHEEAMAIBhABAADIBbFGBQFBA.PFHD.YHEAhBFA...hABA...,1,5,-30,35
cSDbYgGZJITQCBXVMFWLdNEPaKfUOeHAR,RAAADAAA....bADBGABB.ZAFBTAFAQCCBBAHBMCCBhAAALBHB.EEAAaCGDhABAKEEAODDBHFACAAEASDHHhCAAgFGACEFDFGDDdGEAfHCFhAIAUGGA.....hCDA...,2,-15,3,18
SFgfVeTbaXYQDZGdKLHEUWNMCBROAcPJI,JAAAFAAA....VADAeADE...aAGAQAGCGBCBdCHAHCCAhADAEDDB.UDGA.MEEBhAIARDFBAFDB...IGGAhBAAfFHAXGEDDFFBLHBA.hCAA......hCBA...,1,-16,-21,5
gfHAaEOMQYRTLFDKcSXbUeVJdPCZBIGNW,EAAAMAAARACA.LAEA.KBBAXAFB.eAHFdCEAZCFBGCCBhAAAgDBAHDAAACIBaEFAhADAQFGATFCADEIBhCAAbFAA.VFFBCCHABHEA......hAFA......hAGA...,1,14,-20,34
RPKYegGcLMCBNWZQJUSbTDFAfHVXIdaEO,HAAAXAAAaACARAEFKADA..eAGHGAFAMAIBBAHAZCCF.QCDChAAASDGHTDAAhABAAEEAVGAAECHF.OEFBhADAgFFGLFAACGEDNEIA.UGGA.FHAA..hAFA......hAHA...,2,6,7,1
KgHYPTGeLXadAWMcDBfbZNVQIERSJCUFO,MAAABAAAZACA.QAGARACACAFB.FCCAKAHB.HCCC.TCGAhAHAeCFFaDAA.AAEADDHBhAAAbEFA....IFCAhBAAEFGBSEEDOBBBgFEGhCAAGGAB......hCFA...,2,-22,-19,3
ePabEHCGJfBZONMVDXdKcTFRLUIAQWgSY,QAAASAAAeACHaACE.HAEAGAEABAHBZAGBMCEBDBIBdDAAhAAATCFARDCBLEGBhADA.AAGB.gEAAhAAA.bEGDEFFFfFEANEIA.KHCA.hCAAcGAD...hCDA...,2,-4,2,6
PJAFSCdgYWZKLDabUBEHRNTGfXVMIeOQc,CAAAdAAA.....gADAZACALAFBDAGA.bBGDBBFA.HBGBhACARCCBGDAA.XEFChAAAMCCBeDABQGGAhADAPDDBABIBSAHBKEGDEFEFfFHAhADA....hAEA...,1,-9,-22,13
bEOBJKZXIfFMdAcDUaRWGVHTYPeSgQCLN,DAAARAAAGADAHABC..TAFAeAFAQCFA.LDAAhAAAEBHFBCCDZEFAfCEAhAEAdFAAABIBaGGB.VDFBSHDAhABACECAbFACKFHBIHHAMIAA....hADA......hAFA...,2,-6,-2,4
WFOLCfTUPHaRBSeZAbYJgcXMEGNIKVdDQ,JAAAXAAAGADAKADA..dAFBDAFAFBGHLBGB..TDAAhADAHCDARDAABCCDeDHHAAIB.hBAAbFCA...gGGAhAAAEDFBIEHA.QGGA.hABACFFD......hADA...,2,-24,-14,10
GdVXcSQPNaORTCfJHeBWYEgAMDIZULFbK,MAAAZAAALADBKADAGAFAdAFA....XBGDQBBCaAHF.hABARDDBTFAA.CAHAHDGBhAFAeCABBDEAEECBACIBDGGBhAHAFEFDbEGD.SCCD.OFBChACA.....hBAA...,2,-9,-9,0
QCHIUDSeVAdRcafOLFGTBWJZgPbEMKYNX,RAAAaAAALADBGACABAEAZAFA....bCEDEAGA.MBBBKCGA.XBGAhAEAHEGBDAGAeCEFhAGAAAAAdCCCODFCFGCA.TFFAhBAA.JHDA........hCAA......hDAA...,2,-19,-10,9
HdSIQJYFWPEgReMNCGcfTVKXaUBOZLbDA,HAAAdAAAQADAFADAEAGA.RAFA.eBHF.MCABGCAB.TCGAhACAXCCAaDEDOEGBhADAbCEDACCA...SEHHhAGAIFHAYGAA...gGDBhAAACHHA.fGGEhACA,1,-3,-21,18
UBdEgbZFaPWJHRGScKeNVOYCQIMADLTXf,TAAAXAAA.BADAEACEZAEB..aAEDJAGBHAGBGCCAKCDDeDABhAAAOBHD..QDFChABAACCBLEABdEECbEFBhAAAFEHD.RGAASGGD..NIABCFHADIDAhADA......hAGA...,2,-3,-3,0
DNEdIPFOgbTGWKVJBeCRLaUQZcMYSAfHX,HAAADAAAEACAdADA.FAFAOAEC..bBEDGCCA.KBBDBBHAhAAARCFALEFAaCACZDGBMDDBhACAAAGA..XGCAhAIAIHHATGGA..VGDA...hBAA......hBIA...,1,-10,-21,11
CULSAaQcXIeJfDWZHbYBTdMPEVNRKFgGO,aAAAQAAA..XACDeACADAGAHAEABBEAdAHAEBGARCEAFDDHhAEAGDAACDHALFFAhAGAACDBIDEAJHFA.ZDFB.bEGDhAAAMBBB..NCIA....gGBHhADASGED....hBAA...,2,-12,3,15
AOEDgbJXfcHMaVUeQFSZCNdPKRGBWYILT,EAAADAAA..JACB..fACAHAEA.aADDeAHH.QCEBhAEAZAEBdAHARCFFGEGAhAAABDDDIEGAABGAODDBbFFAhAGAMFFB..FHAA.CHHDNBBA.....hCAA......hCBA...,1,-12,-13,1
OYTLGFcJEHbWgaKCXfeUZdNSDBVMPAIRQ,RAAAQAAAOADALAHBGACBFAGA.ECDBHBDA..bCEDaCCHhAAA.XDFCeCGBdDAAhAAADEEBMCIBABGA.TGEAhADAcFGA..gFAAfGDEUGGAhAFASGGDBHCA..hABA...,2,-27,23,50
ARZKPgJYaebUQMHSIEXNfDcWOCVTFGBLd,RAAAZAAAKADCJADA..eAFAUAGAHCCA.EBHF..XCAADCEAODFChAAA..TDDAhABAGGABdDFAAEEB..gFFAhABAbDGD.MFIBSFCB.IHHAhACANIDB...hAGA...,1,-11,-26,15
WfPRVZIFCHGSKDLgdYaOJbcATUBENQXeM,TAAAEAAA..QACAeACE.MAFAfAFBRBEFZBGBCCCDHEBAhAAAGCCA.DAIBdFFAaCFAhAAAbFGDACCBBDHA.XEFChAHAWGBA.IGGA.KGDA.YDBFhBDA...hBEA...,1,-5,-10,5
PbdFUYDCQXScEGJHWfNTIKVBZMOReaALg,LAAA..bAAAdAEAFAEADAGA.QBGASAGHECAAHBDBhAAA...fCAAhABATDCAKDGDZDFBRFDAAEBBhABAgFCA.PEHBCFHAXGBChACA.JHFANAIA....hBEA...,2,-18,-8,10
DVYMGWcELPTSdKOZABIebQRHgJUafXCNF,eAAARAAAHADBUAEA..aAFACAGA.DAIB.MBGBGBCA.EBHFTDAAhAAAdDGDZEBFBCCD.QEEChABAfEEAFCHHhADAVFGB..cFBBSGFDAFHA..hAAAgGGANIAB.hABA...,2,-14,-6,8
ZQgBNbRVKJcGaMLYWFfSOHUTePDXCEIdA,ZAAAQAAABADBRAEF.KACAGAGALAEBFCAA.OAGBHDDAeDHHhABAXCGD..EFFBAAHA.hAAA.bDCCVGAA.aGDDhACAMFFA.fGGA....hBIA......hCAA...,1,-3,-23,20
fEITeXUBSJMLYHWNGcCPVKDQZORFdbgAa,EAAAeAAABACAMAEAHADBGBCA..CAFAKAHBZAFERCFAdCGAAAAA..aEBBTEEAhAAA..SEEBhBEALFAAYDHBhAFAcEGB..DFIBQGDDbGCC.fCCEhAHAIHGA.XGGChCAA,1,-7,-22,15
CgTIafecUQZPKWJYRFLGbEOBXMdHNVDAS,CAAATAAA..aACAeACEUAFAZAFB.KAHB..JBCBRCCBGCGAhAAA.EDBBXCGAhAAAHFAADEFBAAIB.SFHHhAFA.fGFAQDEC.PECDhBCA.FEGD.LHBAhBFA.BGHA,2,-23,-1,22
PfUGRMaYSVNJdZTAOFBQEcHKCWbLIeXDg,BAAAEAAAHACACACALAEAeAEEDAIB.....fCCEhAAARCAAaAHDSCEAVCEAdECDAAFAFDGDhAAAQEGA.hACAKFFDbECAIHAA.PHCCMDIB..hAHA......hCAA...,2,-30,-1,29
gLURCAMdcIBYVfWSHbNQKGXJPeaOEFZTD,dAAABAAA..VADASACAHAGB.QAFAGCABXDEAhACAeBHHECAAZEGB.TFDAhADALCDBRGAAAAIBMFIBhAGAIFAA.fCFENIDB.KEHB.aDAEhAAA.DFFB.CGGAYHBAhACA.,1,14,-29,43
aTAGXLQWSdRfZEIDNCUBeKgMYHbOVFPJc,GAAALAAAQADAdAEARAGBZCAA.EAFADCGBCAHABCDD..eDFDhABAMCGBHEBAOCHBFDHD.hACAPDEDaGABACCASGHBhAGAfFHANDAA........hAAA......hACA...,2,-19,-10,9
gWOBbAGfRYXcLNPIFHVSMadeCKDTQUEZJ,RAAAXAAALADB....IADAHAFAMCCBeAEHDCHBTAGAhAAAEDEAZEFE..gCGAhABABFAAAAAAGGEBhAFAfDCAcFCBFEEBaHACdFGA.QGAAhAGA.WFDD..hAIA...,1,-2,-15,13
YAZcKBWGHdgXPVRaSCOeEfILbMDNFTJUQ,ZAAABAAAHAEAdACA.XBGARAEA..aAHDOCAB..ECBBLDDAhABAMCGB.FDHHTDDAhAAAQFDA.hAEAAAGAKECDGEGAgFGGSDHBeEAHbFAAhAFADIAAJHAA...YFFFhAHA,1,-8,-11,3
bYZBCPJIadgNAOfXUGKVLMDcSQEWeTFHR,XAAAGAAALADADADA.QBGAEAFAeAHFHBCBRCDAZEAACDCDICFAhAAAdEFAAAAB.fDHAhABAKEHBMHAASGHDhACATEBAFEEABFHAaHEA.gGGGhBEANIAB......hCAA...,2,-10,5,15
gObDRCQEKSLGTaZBUXIMeHAfWPdJNcVFY,...fAAAdAAANADA.FADAOAEA.RBEB.EAGALBHBhACAaBCBZBFEXCADeCBFHEBBhAIAADDAJDFBVEFB..bDGDhAAACEDASFHHGECATGAABHCAMIEA.hBAA......hBCA...,2,-7,9,16
DMaCGTNUOZFgKcBbYQfLAeIWHVdPREJXS,eAAAHAAAdADAEADA.SAFAMAGB.GCABTCCAOAHDZBGBKBEBhAAABCFAQEEChABAAAFAIEEAPEHD.JHAAhAHAaDGDCGGD.FFCB.bGEA.......hAIA......hCAA...,1,-6,-8,2
QZFgbTGVRAEcKNOUfCIdWDPYMSJXBLeHa,EAAAKAAAOACAUADA..CAFA.dAGA.DAIBMAHB..SBCHhAAABBCCHCFBZBEBFDDBTDGAhCAARFDAAAIB...fECAhCBAIFHA.PFFB.....hAAA......hCAA...,2,-36,-27,9
eNKVBgIOQDGPRCHScATYfMWEaXdULbJFZ,TAAAMAAA..EADAdACALAGBFAEAZAGBKBEDBBBA.OBDEGDDBhAAARDDAHEGBABIB.fGBAhAIAaDHDUGCAeFGBhCAANICB............hCGA......hDAA...,2,-15,-14,1
KXfJVcZDeUCBMLQbIPdOESAFHTYNGRWag,HAAATAAAGADA.RAFAaCACXACB.VAEAZCFEeDDD.hAAABEHAMAIBbFABdCCDEFFBhAAAACHBFDED.NDGAKEHBfHCBhACADHAALHEAIHHA....hADA......hAFA...,1,2,-7,9
VNXaCdfTGBSLKYOAgIPEbFDMceWHRJQUZ,..IAAAEAAADADAeAEAHACARAFF..QBCCZCAA.XBFAhAAAdAHAGDGALDEBhAIAOCEBABIB.bEABMDGBhCAAcGEAJDHB..........hACA......hAEA...,1,-10,-17,7
FJfDUbcIgGReAWOCdEHMaSTXZYKVNBLQP,CAAAHAAA.aACATACAZAEBKAGABAEB.LAGBQCCAFCAADAIBhAAAUCGA...bEFCgBEAhACARGDE.ADDBdEEAhDAAEGGEMIAA..XDGA.VGFAhEAA.....hAAA...,2,-15,-8,7
fLVDEQgCKJGPNBWYHTAcOMZaRdebFXUSI,MAAARAAAeADEFADD..SAGBLAFAEBBBQBDD.KCGDhAAAGCEABDEDHEFChABAAAGAZCGBbGCCXGGAUGGA.hBAA.fEDEDAIB......hBCA......hCAA...,1,-13,-14,1
LRedMgFXDEVKBYaPSCbUAcQNfTIWHGOZJ,QAAATAAA.HACAZACBRAEAeAEEdAHAMCABXBGA.ECDABCEDhAAAaDED.CCGDADIB..fDGAhAAAGEEAOEHBhACALFHBDGIBKFAASGDA...hAFA......hCCA...,1,4,-17,21
VFITLDaHZAOcRPeXNJgWUMGfKBEbYdQSC,RAAAeAAA..XADBJADBUAFAGAFA.BAHAECHFdDEAQCCChAAACAHA.FCHDTFBAhAAAaDFHHFBAZFGBACCBOFGDhABA....PGDCWHAAMFIB.hABA......hBFA...,1,5,-29,34
UHfDTedSGARLJZYMbQaVgOFNICKPWEBcX,RAAAZAAAMADAaACA...OAFEFAFA..CBEAKBHBEBDFBCEA.UCGAhAAAHCEC.TEEAeCCDGEEAhABAACCBLEHB.hAIA....YHFA....hABA......hAIA...,1,-21,-31,10
FTXYMSDbVQHUGZIfCEgcBJdPKeNOWaALR,RAAATAAAMADA..DAHBQACC.HAEBZBDBCBFAEAGABCCAdCHAeDDBhAAAOBHDADGALEABhAEAFDFB.SFEHhAGAUFGA.fGGA....hBIA......hCAA...,2,-45,1,46
BNdTDFPaLKRMbecYUVAQEGOgSCIJHWXfZ,EAAAGAAA.SADACACAHADB..fAFBZAFBdBHATDCAhAAAFBHDLDDAREFAeDADUFCBhACAAAHAQEGAOHCCIGHAhADAXFBADCCBKCDC.bFDD...cFFChAAA....hBFA...,2,-16,13,29
PKIVEXebWgJRUSATcOfCQHNaBLGFdZDMY,TAAAOAAA..QADAHACBaAEAGAGAZAFBMAIBKCAD.ECEFeBBBhBAA...bBGDgEBAhAAARDCFAEFB.CEFALFEAhACAdFGADFBB.IHHAWFHH.SGDDhAIA...hBFA...,1,7,-15,22
HAUPNXKJRcdTZCgEFfQSaGWBbeVDOMILY,UAAAXAAARADA.dADAZAGB..EAFAQCDBGBGABCEAeCHHODBBhAAAMDABLEFBhADAHEEBAAIBKDDDTGAAFGCBaEHDhABA.....WFADDFIBPGCA.hAFA......hBDA...,1,-4,-8,4
OXGdgPeaIJQMScfFbBZYENRKLVWUTHADC,OAAAdAAAeADA..aADDQAGA.MCCAfAFAhAFABCFAEDAARAGFLDBAhAIAUEDAHEACABBBXDFChBAAGGEBIDHASDHH.bGDAYFFChACA.NIBB.....hADA...,2,-13,-2,11
UIdQESbgeKAfTaBXVPFORcHJLDMYZWNCG,aAAAXAAA.FADARACFHAEB.LAGBMAGBZBGBCDEDGEAAhAEAdCDAEDBA.SBBDhAIA.eCHHAAAATFCAhAHABEFAOFHDDCFBNCIAQFFA...hBAA......hBGA...,1,-7,-15,8
RGeJUfaCPVYcZTLMbdKDOAQIXgHWSBENF,QAAAXAAAHADABACAFAGARADFGAFA.eAHBfCDEhAAAaDDC.CCFA..PCHBhABAcEFDZDAALFAAhAAAdEFAOFABAEIBIGHASFCAEHDA.JFHB.hAFA......hAIA...,2,-8,3,11
WXRNgDUOfYcELCGbaVIHKZAeJPSBFTdMQ,eAAASAAAFADDdAFAMADA..QCGARAFADBDB.OCCBhAAAfBEEEDEBGEFAhABAaCCHHCGBAAHABFBD.XFDDhBFAgEDAYHBALGFACHHA..hAAA......hABA...,1,1,-23,24
DAYTGdCWNSeLIVPgJFEQORXZHBaMcKUbf,GAAAdAAACADA.SADAeAEHLAGB..IAGA.hACAgBGAECBARDDAHEGBhADAaCDAMAIBKDDAbEACABGB.hBAATEFANIEB.PFHD.FHEA...hBCA......hDAA...,1,1,-19,20
QOTNLfAYGKDdFMgCaSJEcBeVZUWRIbHPX,GAAAdAAAMADAaADA..EAGAeAFHZBDARCAAHBGB.QDCAhAAAOBHDLDEBAAHADEEACEHASFFBhACABEBAUGGAIHCAhACA.........hBAA......hBCA...,2,-17,-17,0
fAXYBJHabUCgDZEWMcdSGORNPQTIFKeLV,BAAAHAAAaACACACAZADBEAFA....MAGBdBHAGCCARCAB.QCFAhAAATDEA.KEFDeAHBhAAALFABACCA.XGGAhAFAbCGD.DFCBSFBA.NIABFGGAhACAfEHA.hAIA...,2,-27,4,31
fgMAHUPLRQcJeTbKECSFDVGYBaOXINZdW,HAAALAAARADFQAFCeADHKAFA.EBHFFBHDGDAABCAA.ODDBhAAA.XEFAZCEBdEDCfEHAhABAAACAPFEBcGGChAHATFAA.bGDADCCB....aHACNDIAMIAAhAIACHHA....hCAA...,1,15,-12,27
gdWFAOZceTDNXIRCKPSJHGBMYEaLfQUbV,ZAAAeAAADACA..XADARAEAKBHB...SAGAHCCCGCFAhABAMCCBEEHFaCGALFAAhAFAQDDA.bDFDdHABhAHAAAAAOEABNHDB.CDHDBFHB.fHAFhAEA....hAGA...,1,-8,-18,10
THZKIQUAWFCgMbeDcRJVSPXBYaELdfGNO,CAAAMAAADACA.RACA....SAFBBAEAEAGALBCBGBGATCDAhAHAHCFAZCDB.QEGAhAAAAAIBFBBHeEFBVFEBhAGAXFCA.aFHDfHCBNICB.IHHAhBIA...hBAA...,2,-15,-14,1
SIFTNOaCgJQZYEeVDcBRLXAHdPbUGWKfM,HAAAdAAAUADAGADAKAFA.MAFA.FBFAOAHDaBHD...CCBA.QCABhAAAZDBE.EDFBhACAeCFFDDDBREGFADHB.bGDCSEFHhACA..NIEB.JEHB....hAHA......hBAA...,1,11,-39,50
ROAFKGJYaHLUWBXMeTISVbPcfdQgCDZNE,GAAAaAAAHACBLADABAEA.eAGHSAFHVCDB..bDGDfAHAhAEA.dDEAhAHAQEABDBBBECHFADGBKEHBhBAAYFCBXGFAMAIB.TGEA.hCAAIHHA..hAAA...,2,-8,-8,0
fKNdMgEHYXCcJTebZIUVaDQLGAOWSFBRP,SAAARAAAKADC.dADAEAFAHAFA.CCCD.TBGAeCEFZCGB.UFAAhAAAaCCALDDAhAAAADBB.FDHDfDFAhABAMFCAXFGCJFHB.IHHADGGB...hAFA......hAHA...,1,-13,-19,6
BMWJefbEcGCLAaKRgOdTNFYHXDUIZPVSQ,RAAAdAAAFADAHADA.DAFAZAFB..SAHHMAIBeCCAECBAGCGAhAAAACFAKDAD.OEEB..hABATDDAXGFCIDGAhACAPHBCQFDB.BFHA.hBHAfGFA.hCAACHBA...,2,-15,-14,1
fGaUABKSCQRTMHcJXFVWZDeOPdLNYbEIg,SAAARAAAHADB..XAFAFADAZAFBeAHFdCGDLDAA.hAAAbDFCEBCF.fDDAhABAaEEHAAAAKFAA.TEFAhCAAMFHB.cFCC.WFHHDFIBNIAB....hADA......hAFA...,2,-11,-7,4
IVRXNTDacPWdCUHMAQefSLKBZFOYgGbEJ,eAAALAAAZADBOAFCGADAEAFA.JAHBRCEF....TDBAhAAAaCAA...PCHBhABAdDFAHEGBAAHAQFGBhBDAKFAAFFEH.bGCAXGCDDGCA.....hCAA......hCBA...,1,-7,-8,1
ZJMCaVYLgEGKDSHOUAIXPNBWFdTcfRebQ,XAAABAAAdACA....TAEARADAeAGHZAGBMAIB..aCBCLDAAhAAAECEB.GDGAhABASCHHHEDBACFBIEAAhAAAPGACNIEBFEEH.bGAA...QGFAhAEA.CHHB..hADA...,1,-5,-11,6
DFcfORYHIZGXKVQMNgBPCTWELaeJUdASb,DAAAFAAAOACDHABCGAEA.KAGAMAEABCCDCAHA...ECGAeBEBhBAAdEAAADEBSBFBhCAA..bEFARCGFZEDAQGEAhAEAPFHD.WGAA...aGHH..hAGA......hAIA...,1,-16,-22,6
WDJSVTeNUOcCdIbAHYRKBFMfGXaZPgQEL,HAAARAAAFADAGAFAZADBQAFALAHBDAIB..SCCAhAAAeCAAOCEDdEEAACCABDGAMEHBhABAaDHD.EFGBJHBATGDAhAAA...........hBHA......hCAA...,1,-7,-22,15
DSCIaYRNgQPVTcWJMdUZKbABEeHfGFLXO,EAAAHAAAGACALADBDAEA.CAFA..aAGDRAFAQCED.TEBAhAAAcCAC.MAIBhAAAZDGBACBBeCFBXFEBhAIASDHDIHCAgEEDWEHH.dFAA.hBCAKGHB.BCCC..hACA...,1,1,-12,13
bIcOWXPQCdVLaeTgRNUSJBZYAMGHKEDFf,HAAAEAAAFACD..bADBOAEA..XAFAQBECdCADaBHDhAAAeAHFRCEF.UDGBBDCAADDBGEEAhAAAfEGAIGHAhCAAPFHDCECD.TGAA.SGCBhACA.....hCBA...,1,7,-19,26
AYFgPBbKMXNZeCDdHVaRGQUJOSIWcTLEf,FAAABAAAMADAZACAeAEE..dAHAHCCARBCAGBFAQCGAUEDA.hBAASDAB.hBDAIEEATGGAEDHFhBFAAAHAgEGGKHBA.CECDaGCA....hAAA......hADA...,1,-18,-20,2
MdULaHEgBSeAINTFOVJbCWQDKfcYXGZPR,TAAAOAAA..JADBCACB..DAEAKAFA......fAGAhAAAXBGAZDEARBDBdCHAaBBHhAFAHDFBBCFDAAIBFCCH.hAHAbFBAQFFC.YHDAMFIBLHDAhBFA...hAIA...,1,0,-39,39
RWZCJPDQKFLMEYbXOBgHUdIcVAaTfGNeS,aAAAGAAA.eADARACFZAEBCAGA.DAHBFBHD.LCDAECGB..XEAAhAEABEADHECA.dEGAhAAAIEEAAADA.TFGAhAIASFHH..WECH.QGEChBAAMIAA.OBBHhBGAcGFCNBIA,1,-25,-26,1
feNAVEFcXHKUQSMWdPDaCZLYBGOTgRIbJ,EAAAXAAAHACAQAFC.MAIBdADAaAFAZCCALDGBhAAAGBEATDBAREAAJEEFeHAAhAEAAAAAFBHDKEGASGHHhAHADEEBBGBA.OGEC......hAIA......hBDA...,1,15,-23,38
AfSEPVMZXYJWBFUKCNgITHdReaGLODcQb,EAAAMAAAZACB..XACAJAEB..FAGACAFA.....ICGAhAAAHAGBRCCBeCFBGDEAhBCALEHBDCIB.bFABhAFAAEGASGBAPFEBWBBDKGGA....hBGA......hCAA...,2,-33,-4,29
VMOHTaSfUPgRAWXZLCFNBQdEIDKebGYJc,ZAAALAAAFADABAGAEAEAKAGAGCAA..JCAAMAIBHCEA.aCGASCCAhABA.UCFAhACAREAAAEAACEEDdFDAeEGB.hAGA.bFFA..YHEAOHDE....hABA......hACA...,1,-12,-21,9
WaAVfdCQJDGETeMbSLNHKYXZPIUFgOBcR,dAAAQAAAGADAEAFAeACA..MAIBbAFA.LCGBHCDAXCGDhAAAZABBUFAAFDAABDFAhAFARFCAAAGACFFBTFDA.KFHBhBAAIFHAOHBEaDBE...fGGEhBDADIDA....hBHA...,2,2,2,0
bdaOePXIDSJFYBHTfWVMZGEUKgLcQNARC,RAAAdAAAeADE..XADASAGBFAGAHBFB..TBDAhAAAfCBAMAIBECCBKDCALCHBhACAQCFDAADAaEDEhBAAOEEBDFGBBHEAZFGBgGEHCHGA.hBCA......hCDA...,1,2,-19,21
ERaTYdLBfOHMDgUGISXZKWJecNFQVbACP,EAAARAAA..aADAdADALAGBOAFAHBEB.MBCBDAIBGBDAhAAA.XDGAZCGBKDDDeDBDhAAAFDCHQFEAhABAABGBTGEAfGGBgGBASGGBhBGA.....hBDA...,2,-15,-1,14
GWRJcdQfNACBOSDYbKLHITUEeMPVFXaZg,OAAADAAAKACAHAEBUAEA...EAGAeAHBMBBBFBBH.ZCEEGCCAhAEARDCB.dCHAQEGAhAIAACCBSEFBLGBAhBAATGAAXGED.aGGCgFGHhAGA.cGDBCEBD..hBAA...,1,-1,-19,18
HFaTJbXRNZcEgVGfWMIQPLCSBUdADOeKY,eAAAHAAAaACA..bADARAEFZAGB..EAHBGCCAMCCA.QEFAhAAALDDABCHDABIBKEHBTGAAhAGAXEAAcFEChCAAfEGA.IFDACHHA.dGHADIDAhCCAOFFH...hCGA...,2,-6,3,9
YMfCIWZONaVXBeTALPKgHUbERcGJDdSFQ,LAAAKAAAHACBEAEARADFGAFA.dBHAQAGAMCAB.CCAAZCEBhAAAaCCHBEEAADEBUDGAJEGBFEAAhACA....fFAAhABAOGEANIBB.eFDB.PHAC..hACA......hAFA...,2,-14,-10,4
OBEFXQaKTWGMCeLcJdSgAHRZIDPbYUNVf,HAAARAAAZADBDAGA..bADBUBFA..fAFABBHA.EAHBQDAAhAAAaCAC.KDHBhABAGCCA.eCFFhAAALEEBdDHAAEGAIGFAPEGB.YHCAhACAOFCD.FHGE...hADA...,1,16,-33,49
THSKaMGBRJXQbfUFCegYEDcWOPAVZNdLI,ZAAAdAAALADAHAEAaAGAGCAARAGF.QCCBbABD.FCFDeCEBhAEAECHB.DCIB.ODGBhAFAAACAIFFAKFCAMFHBhAIABEHD.fGHA.....hBAA......hCDA...,1,-1,-22,21
aSCHRQIUTDKOcAbVZXPfFeJYWBgdNEGLM,ZAAAXAAAFADA..eAFHJADA.BAHA.dCAAEAGEGCDAMBDBaCEAhAAAHCGB.RFFB.UDFBKCCDACIBhABAVGFA...fEDAhABAgGDGSCHBCHAA..hAIA......hCAA...,1,-8,-24,16
PNAJdSKXVFIaBTegGQZCERDWOcYUMHLbf,dAAAXAAAFADABAGA..eADAGCABZAGBRCDBOAHDUDAAHEGBhAAALCFB..bFCA.hACA.fDEAhAGAABGB.KDHD.aECD.TGGA....hBAA......hBCA...,2,-25,-15,10
aUEBbZDQOLGdIVPSWTRNKgeCXJYfHAMFc,MAAAaAAABADAZABEDAFALAFA..dBFA..ICCASAHHhBAARCEAKDAAeCCA.XDFAhBHAfDHAHFFAhCAAAAGAFECD.EEEBOEEBGGEB...WHCGhADANIDBCHHB.....hCCA...,2,-19,-14,5
GMCZUeVHTOdBQXEANgcYIKPSfWFaDJbLR,...NAAA.gAAA..IAFASADAFAHBaBBAbAFDRCCBhAAAGBDA.ZCABeAHBhABAHCFBdDAAQFCChABAACEAKEFAfFEEDCIBMFFBCEHBTGGAXGGAhACAEHCA.....hADA...,1,4,-8,12
cAbEdJOYRNWfgPBZCHXSQTDaKUFGMeVLI,EAAAdAAAOADARACA....fAFBBAGAHBDAQCCBhAAAaAHDFCBDeDDALAHBhADAADHA.bCEDJEFB..YEGBhCAANEHA.gGCA.CCGCSGEHhCBADEIB..hDAA...,1,-10,-26,16
ZdTAOHKbgIeQFPBfWcCGUNaVXLSDYREMJ,HAAAKAAA...bADBeACE.QAFCBAFA..fAHAhAAACAHBGBCAaCFELCAAhACADCIBEEEAZCEBAECBOEGDhAAAFCHDcEGC.VGDASGFDYHAA.hCAA......hCBA...,1,7,-25,32
RgLGaDQTKUBXCfEZMVNOdSbAYJPWFHIce,JAAAFAAAHACB.eAEARADFGAFADAIB.QDAAKBGBBCEACDFAEAHB.hAEA.ZEEA..MDDBhADAODHFdDHAAEEA.PFABhAFAIFAA..LFFBaGGC.XFDDhAIA....hBAA...,1,-12,-28,16
TZNBDbPLQdCeOcEHXIKFUVafgGSMYJWAR,RAAAZAAADADALADB.dAFAeAEAEAHBHCABKAHBFCCAUDFA..aCEDhAAAGFBB.MDIBhABAJCGBADIBTGGABFFD..hACAQGCAOHCE...IFHAhABA......hCAA...,2,-40,7,47
BJUdDeRaYfPbMHWFCOXSEQcVTLNKIZGAg,BAAAdAAARADA.aACA....fAGBMAFAHBCACCBA.SBFBhAAA.EBHBQCEAhACATDEALEHBhBCAKCGAGDCAAEDBgGFDDDABeEAHbEGDFHDC.OFFBhADA.....hBIA...,2,-12,-7,5
OfNDdTYUGXRbHKZSQaVPBIJgcWLCEAeFM,eAAAMAAA.OADCDAEAdAHAUAGAGBBA.RBEB.HCCAZDGB.aDFDBBGChBAAJDHB....gECAhAAALEDAABBBfFAAhABANEBA.XGGASFHH..hBDAPHDC...hBEA...,1,-3,-26,23
NfKFbAcOReDGPdBaSZCEgWHVUJYTMQXIL,RAAAeAAAGADAdAEABAGAZAFA..ECCBHBCBUDFATCFA.MAIBhAAAQDACLEBAKDHBhAAAAEHADFFAaFEC.CFHAVGAAhABAXGAA..fGGEFGHB...hABA......hADA...,2,-10,-4,6
FdCgAVESYPbRLGBHcIMeNWZDOKfXJUTaQ,EAAASAAA..bACARACFGAEAHAGBMCCBeAGBZDAFKDGDXDDAhAAATEAA..aAHFdDGDhADAAAAA.PFGBLEDBhAEABFHBIFHADEABOGBEfFFE.hAEA......hAGA...,1,-1,-3,2
QIMUGgPeaFZDdNBKJbAcTfXOCVSEHYWLR,TAAAOAAA..SADAHACBLAEARAFF.MAIBGCCAeCABhAAAZCGBdCFAKBBDAAFAXDGDhACAEEABQFECUFDAaGGAhCHADDIBBAHB........hAEA......hBAA...,1,5,-19,24
CJgALORNWIXBVcPGdDKTQEUSfHZYFeabM,RAAA..IAAABADB..VAFAGACAdCCA.TAEAUDFAHEDBhAAAZAGBeCAB.aCHDMCIBhABACDFDAEABLFFAOFAA.hAFAXGAADGGAEHEA.fEDA.FHFAhACA......hAEA...,2,-16,-7,9
HdKBgUMICfGOWFENQJPcDZYSLaeXVRbTA,HAAAdAAABADAMACACAFA.GAEB.FCCAEAHBQCFB.JDHBhAAADCCAZEEFLCFBhACA.eCHB.RDAAADAAKHAAhAHAUFABIHHAODDD.....PFGDhADA.SHEGhAFA.,1,-7,-29,22
MWSELONIUCKfYBFecQdADRaVgHPJbXTGZ,RAAAaAAAHADB..JADATAFAZAGB..MBBBEBHFLDAA.hAGAODFBICCAKDHBBFAAhAAAeCEBdEGAAAHADEEBgFCAhBAAbGDA.XGFC...hABA......hADA...,1,-11,-23,12
UZRDfYNQAIaEFgVeSGXBHJbCdTLMOWPcK,EAAAFAAAeACHGACAHAEACAEA.dAHALAGB.MAIBOCEB.hAAAPCGBKCBDRCEBfEAEhAEAQEAAADDBaEEHSDHHhAEABEHA.bFEDTGBA.cGFBhBCAZGAADGGAIHHAhBGA...,2,-16,5,21
eFYbgBfSVZOREXMNGQULKWCPJcdIADaHT,HAAAeAAAFADD..bADBBAFA..SAFAZAGBECCB.MAIBhAAAGCEALCAACDHAJFAA.hAAAdCFAABIB.aCHH.TFDAhACA.fFFBRGCAQGGAKGAAPHFAhAGA.....hABA...,1,10,-23,33
JdfRVIeEWUYNQacKFPCAXDTLMSbGOBHgZ,TAAAMAAAGACB.HAGBZACBdAFARCCBeCFBEAHBUDEA.QDGAhAAAaDHDFFAAAAIBLFEBhAFAOCABBBEC.fGGAhACAIGGAWBBDYHCAKGAD...hAGA......hBAA...,2,-8,-4,4
bZeTJcFaYEXVGWKCPHNRdUQBLAfSOgDMI,OAAAMAAAZABE..eADAJAFA.FAGD.EBBBGBDB.CCCDHDEChAIARCEBdDGAQDCDhAEAACIB.SEHHhAIADEDBbFFA.aGGC..YHDA....hBAA......hCAA...,1,-14,-28,14
ZASFgKVRaPDcGEdUbWMLJNQfYBHICTeOX,FAAAKAAARACFDADAGAEA..EAFAdAGBUCCAMBHBLBHB..hAIAQCACBCFAHEDChBAATEDAeDBDZGEAACIBSDGDhAAAaGGA.cEADWHCG...fFHAhACA..hAEA...,1,-15,-27,12
QTYZfFPKdEAIJNeLSUbgCGHOaVcBMXWRD,JAAAeAAALADBUAEA..CAGAHBCBOAFA..aAHDBBFA.MBIBhBAARDFATEBAZDCAFCGDdFFDhAAAACCA.SFDHhABAGFBB..XGFADFIB......hBFA......hCAA...,2,-25,-10,15
fWJNgHBDQIUSZGXAOeFMRCKYdTVLbaEPc,eAAARAAAKADC.dAEALAGBEAGA....fBCANAIA.HCEChAAAQCCASCHBhABAGEDBADDBMEBBTFBAhAAAaEEBPEHBJFHBDBFBIHEAZFFF..hABA......hBGA...,1,5,-22,27
YHPGObSJWQXAefcEUZTaLgKMNVDFIRCBd,eAAAEAAAZACBLAEA.MAIBDAFARBEAdCCAHDECGCFASBHBhAAAQEDDABCBUEBAaDBBKEHBhAAAFEHDBFFDOFABJHDAhAIAfGHE.......hBEA......hBFA...,1,1,-17,18
JaVLGQDgWcFMXOdbUKePYHERCZTAINSBf,SAAABAAAaACAGAEAQADA.DAGA..gAGBhAAAFBFAMBIBdCCAKBCBeCBBhAIAHDABRDFBZDFBAAAA..fEDAhADALEDBXGBBOFFH.PFHBhBCAEHGACHDA......hBGA...,1,0,-13,13
MfNOgTJaCdLeDHEUZKRGIAYSXFbWcVBQP,XAAAFAAA..bACD..VADABAEAMAHBOAFD..TDAAhAAAaAHBLDFAhAEAHCFBECDBZECARFDAAAIBSFHBhBAAQGAAfGFAJFHBCHFA.DIBA.KHGAhBIA......hCAA...,1,6,-20,26
FVeNTJXIdaSZUPKAQDYHERbcfLOGgWMBC,QAAAHAAARADF..bAFBLADA.GAGAMAIBFCAHeCBAhAAATDEAXCEDaCCHZEGBhAAAKEAAAAEAEFCAODHDhAIABGFCCHBAVFFB.IGDASHDGDIBA..hACA......hADA...,1,4,-3,7
NRZGfEJQIFaYDOXAeSbLTBgKcCHdVPUWM,eAAALAAABADAKAEAHAEBdAGAUCAAMAHBRCCBGCDA..EDGBQDFChABAaEFH.OBHDhACAAAAAbGAA..gGFAhAGACFCAVFGB.NAIA........hAEA......hAIA...,1,-4,-15,11
aMLISBFgOHJGceXCDEbUdYKfNQRATVWZP,TAAAZAAAaACA..LAFABACBOADDHCCCGCFAeAFA.DCIBEBHFhAAAdFCAKCCDQGAAhABAAAFAVDEA.MFFBFEHDJFCAhCAACGHA.....bGCC...fGGEhCFA....hCGA...,2,-12,-2,10
AdJPNbeRKFXVOBfETDaLSIMZcUYHCgGWQ,dAAAJAAA.....bABDRADFFAFA..OADAEBHF.DAHBLCFBhADAMAIBZCEAUGGA.HFDBhAIAGEBAACCB.eEEBhBAAXDDCfEGE.aGGC....hBDA......hBEA...,1,-19,-24,5
eYcObGLNDVHKafCUgMWXJdEAIZBPRSTQF,ZAAARAAAQADCeACEOAFAGAFA.LAHBDBGBHCCCKCCDaBHDCDEAUFAAhAAA..MEFAhABAXEDCEFCAAFFABFGAhCAATEGAFGHD..cGGCNHCB.....hCBA......hCCA...,2,-15,-3,12
ebRKVHZEcCDASOUfgdFTILMQJaYWXPBGN,OAAAUAAAdADAFADDLAFA..MAFAaCDE...XBEDhBAAGCFAeCHBRBGBHEEAEDBBhAGADBBBAEEB.SCCDhBGA.TGGAIGHA.YFFFhAHABGEDNIBB......hBAA...,1,-10,-24,14
MWObfRYSKQLXAGcegUVEFTPIaHCBNdJZD,eAAAVAAA.EADA.FAFD..TAEA.aAGAHBGB.BAHBdCDAZCFBhAAAMCCBOCHDRDDAKEHBLFFBhAAAAADA..hABAgFDBIHHA.CGGADGIB.fHBBhBHA....hCAA...,1,-13,-23,10
LEUXcRGQgCFVYDOJZaIPdNKbeTMHSBfWA,EAAAXAAARACA.GADAQAFC.FBHDDAFAZCCAaAGE.dCGAKDAAhAAAeDAAHDFBBDFCAAHALEHBhADAUFBACEHAOFFBhAAAPECD....NEEA.......hCAA......hCBA...,1,-5,-18,13
PZGXdSFVREaLKMQUWDbfJecIYHgOACTNB,TAAABAAAGACA.dAEBFACAEAHBaAEDLCABMAGB..QCCChAAADCFAJDFA.eAHBhAIA.IEEAHEDAAFHACFBAhAAAZEGBSGGAKFDDWFHH..fGEAhCAA.....hACA...,1,-2,-25,23
NPHEdgZWbIeQJMBSYfUXDVRcOFACTKLGa,TAAAGAAAaADA.HAFBEACEZAEB..bCDDeAGF.MAIBSAHBhAAAUCCADCHBRDBFFDGDhACAAEAALEFAdGGAIHBAhBAAQGEA.BGHA.....hBCA......hBDA...,2,-8,-2,6
ecQFXfHYATMCRLSEODINJVKGgZPaBdWbU,MAAARAAAEADE.DAEA..JAFAGAGA.ZBBAaCCAdBFC.UDBAeCEHFEEAhAIAHCGB.AAAATFFAhAIALFHB.SGGFhBAAOFHDIGCA.NICB.....hCAA......hCGA...,2,-20,-17,3
RNGMceTKfXCEDSBAZgWQPbFaLOVdUHIJY,ZAAAQAAAFADALAGBdADAHAFA.ICHARCAAGCEA.eCHHhABATCEAKECA..CFHADGBAhACAAAHAgDBA.hAIAbEEAaGCEOFAB.UGEANIBB.fGHAhAAAEGGB....hAFA...,2,-8,-3,5
MceRDZASbGTfPHaWELdICgVNQYFKUOJXB,GAAATAAA.HADAEACE.dAGA.CCDD..VDEAQAEC.KAGChAAAOBHDBBHAeCCBhCAARFAAAAABSDADbCFD.hCDAaFGDLDHB.gFEGNIAB.hACA......hADA...,2,-11,-5,6
WQCESfIMYXPJABOUVFZTNgdDabeGHcRKL,OAAAFAAAZACB...TADAdAFAaAHB.GDEAHAFBRCCB.LAHBhAFAQDGAEEFAfEHAhBAAMBEB.XFDDhBBAABIBBFBAUGGA.gGDDeHBGKGGD.hBHA......hCAA...,1,-1,-15,14
ADFKWNQUceIBgRfPJaOHSdXGEYMLTVbCZ,KAAAQAAAeACEBAFBRACA..JAFAHAGBdCEAGCGAEBCFLCEBhAAA.TEGAbDAAACGBFFFBhAAAUGDA...gGGAhAIAaGHD.SDDFMIAA...hADA......hAIA...,1,-4,-14,10
WUMJaFPRNBXVcLGYdbQTZSfeIKOEAgDHC,HAAACAAAUACAaACA.RAEFBAGB..XAEALCCBdAHAQCGAhAAAZCBAeCFB.OEDDhAIAADHADEFB.MFFAFEHB.NIBB.GFABhAAATGGA..fGGE..hAFA......hBCA...,1,1,-26,27
HVcDAfBREbMNQYGadCTZgKFIUeSLWOPJX,RAAAEAAAMADA..QACAGAGAdBEAZAEBFCCBeAGFLEEBOAHDhAAA.XDDCHECBDDIBhAAAACCBBDGANIAB.aEBBTGGAhABAKEHBSFFB.....hAIA......hBGA...,1,-8,-9,1
UHXABObQcNeDFCVgaIfPdWLERYMSGTKJZ,OAAAQAAA.eACACADA..aAEDfAFAdAGALCCBRAGFMCDBhAAAGDGA.TFDAhAIAZDABHEDBABBB.bFFBDBIBhBAAFFHDIGBAECEBSCHHKEEC...hBGA......hCAA...,2,-23,16,39
YKTdEPUVbIGfQSaJcWLBRgHZeOAMNXCDF,MAAACAAAFACA.KADA..EAFAUAFA....IBHAGBBAQDEAhAIA.aBHDhBAAcBCCLEGBRCEFHDGBhAAAeECHADIBDECBdHBD.bECD...SFABhAFAWFHH.BGEB.hBBAgGGA.,1,-8,-16,8
dFELZaRJUgQCcHGXDVNOWISbeTfMPYBKA,EAAAaAAA.RACA.UADA..QAFCHAFAGCGADAIBOCCBSBBDhAHAeCGFMDDABDAAACIBdEEAhAIAZDEFCDHAXGFDhBAA..WECH.IFHA.fHABhAAA...hBDA...,2,-17,-14,3
bPdgTJAEZSXfCFLNHIRcBUWDMQGeVOKYa,EAAAZAAASACE..CACALAEAHAEBRAGBBCCDDAIBGCCAhAAAeDEBKDGDbCFBdFHATFAAhAFAAAIBFGAA...IDHAhAGA.UFFBMIDAOFDD.aGHD.hABA......hAGA...,1,-3,-19,16
YXAeBIWEdHUVSgLaGOCFJTZPfDNbRQcKM,eAAABAAAEACAHADAUAFASAFE.aAHDGBDA.FCAAZCCAhAAADAIBRDFFQFCAhABAMDGBADHA.dFHALEHBhAAACHGD.TFBA.fFEA.hCAA......hCBA...,1,-7,-22,15
WbHQLMeDBTaKdPEfJIXCNFOGVYZRgcAUS,SAAAHAAAMACAeAEABADAKAFAdBHAECCA..JBHBCCEA..OCFDhAAAGCCAZEGBRDABAAAA.UEGBhADA..WEEDLFEBhAFAaHCC...fGCE.IHAAhAHA.FGHH.hAIA...,1,-15,-17,2
ZBeANKRgDUXVEWLcIJSaYHGCbFdPfOMQT,RAAADAAAUADAEACA.LAGB..IAFAaCCC.HAGBGDEAhAAAbBBA.dEGA.OFBBhABAMCFBZEFBAAIBKGCAXGDBhAIA.WDHHSGHHFDDH....hBFA......hBGA...,2,-18,-7,11
VYORFHfeUQbgAZBNSIaGJWLMDPTCEcKXd,ZAAASAAAGAEALAGBMADA.TCAAEAGAKBCA..dDDAOBEDhAAAHEBBeDHFQCGAhABAAACABEADaDDHDAIBCEBAXEGChBEARFFBfGEEbGCAIGHA.hABA......hAEA...,1,0,-5,5
gZIVeLNCHRObQDJBScKGUWEYaPdFXfMTA,ZAAAeAAALADBHADARAGFQCCCBAFAKAHBGCAAECFB..aCHDdCFAhABAFEEBMCHBAAAA..gFAAhAFAIFDACFFAbFGBhAGADDIB...SFAD.WHAAhACA......hAFA...,2,-31,9,40
YCORBJgSKbWPMdDFVTLAHcZNEfeGXIaUQ,HAAAZAAAEADEeACEGAFAaAFA.UCAA..QBFDOAHFRCDBBDHDhABASCCA.bDFAhAAAMFAAdFFAFGDBTFFAhACAAAIBfHGFIHAACFHB......hAFA......hAHA...,1,1,-11,12
VLJBdbNMcXQOKSIRPTCUDWYEFAegaHGZf,eAAAHAAAZADBLAEAdAGAMAIBQBCD.SAHHhAAARCEFTDAADDHBECFBAAFAGEFAhAAAfDDEBCCCbFBAXDGDhABAOFHDKFEA.CGCA.......hCAA......hCBA...,2,-15,3,18
EGNXUVWHbYIDTMLcSeaOZFCQgPKdAJBfR,BAAAEAAAGACAUACAHAEA..bAEADAGAMAIBLCGB.eCBBhAAAZCEBQDGChAAAKDDAABIB.REAAXFGAhAEAVFDA.IGEASGHBaGACCCBD...hBCA......hCAA...,2,-27,13,40
KMWBSCOPZNEIagAfQXVJRdeGTbDcHYLUF,QAAAXAAARADA.eACAGAGADAGAHBDCLDAAKBGCBCHA.hAAAODAAZDFFEEDAaDECAAIBfFCEhABAdEHA.hAAATGAAbFFBUGDAMDIBCHHA.IHFA.hADA......hCAA...,2,-4,3,7
HQOLNGaeTSPZYcXKWJAgFEBfbIVdUCDMR,EAAABAAA...IACAdADADAFAHBEB.LBCDaADD.eAHFhAAATAFAZEEAXDGAhBGAKBHBAAHAFCCH..bDFBCGCAMICAhCAA.QGGBGEDASFAAhAAA.PFHB.hCBA...,1,-6,-22,16
CfdNPcIUeRAQBLOHZSabMJDgKFYEWTVXG,LAAAHAAAaACAMAFADAEAFAGD...EBDATBEAGCAAdBGA..hAAA.PCCBIDDAhABAREDAABIBQFGAhCAAZCFASEFAJHEA.KFED.YFHB...hCDA......hDAA...,2,-17,-3,14
dPZbXUgLQNRDWEAIGSFVHfOJceCaTMBYK,GAAAFAAAHACBOADAeAEA.CAGA.MAIBBBHAdCFAZCDAUEAALDHBhAAARDGF.EEBAABHB..SDEDhAEAVEEB.fFDEhAFAaFCDKHFA.XGGANIAB.DIFA..hBAA......hCAA...,1,-9,-11,2
TbaBUFMHNCWZOeRDGAgcPKJLSdQIfEYXV,...PAAALAAAdAEA.QAEA.EAGAXAGAhAGATCAAaBHDFBCDHCEC.hABACDHAZEBARCCFADGBKEADSEEBhAHAfEEAbGFABHCAMEHBOHCADIFA.hBAA......hBEA...,1,-3,-11,8
TSbGJUBAPXORcNeMWFagHKDEdZCYVQLIf,OAAARAAAeADE.FADDHAGB.EBDFZAEB.CAGA.QCEDLCGB.TEGAhAAAGEEABFEAAAIB.hBAAXGAAMBBBaCCHDCCBhABAdGHAIHHA..SGDDhCAA......hCIA...,2,-24,0,24
CQJYNBgbIOcdATSKfUaPHFXMDeWVZRLGE,TAAAKAAAUACA.HAEAMACA..eAHHZADERAGFECFFQCCBhAAA.JCFFBDDA.bEFAhAAAOCHDAAGA.aEEHXGEAhCAADFHB.........hAIA......hCAA...,1,-20,-23,3
cIgbUNAGPFTJOeLSKfVDCBdMaXWYREQHZ,GAAATAAA.eADALACBKAGADCDAdAEA.aAGA..XCEAhAAARBFFHDGBZEBA..gDDGhACAbEEDACIB.FCHBSHBAhAAACEADMEIBEFGBIHHANIAB..OHFChADA....hAEA...,2,-13,3,16
OdIBQVHLfAZTgDUeNPSJYCaRMKXcbEWFG,ZAAATAAADACAUAFA..eACE.SAFBCAHARCCA.MAHBhAAAKCHB.XBDCEDFFGEBAhABAdDEAQDGBhAIA.HGFAABEAgFGANCCA...hBIA..YEEFhCAA...,2,-40,4,44
FYVaBTWKPSMHOQeEcLCAJNUGgdRXZIfbD,UAAAdAAARADAZABB..IADADAGA.FAFAaBFE..BBEAKCHB.MAIBhBAAHDCA..eCDBhBCAEDGBLEABACGAGDFAXFDChDAA.fFHAbFDA.YHEAhDBAWFHH...hAEA...,1,-18,-27,9
VBSbMENKJLOZAPGDHWQTfdYXCaIUcReFg,GAAAHAAATAEAdADACAFA.UAGARAGF..eCEFFCAHBCCA.MCEBhAAAEDFFKDHBLDFAAAABDDDB.hACAQFFA.hAFAXEAAaDBDIFGAgGDBSGHHhAIA.NICB....hACA...,2,-15,-11,4
JLZUPQEabKgSfBYDOHeMTVXIcGNCWFdRA,ZAAAQAAAEADE.aACEKAFC...SAHHBAFAOAGDHCAAhABAeCDBMCEBTDAAhAAAXCFCGDFA.CDHAdFADhADAADIBLEGBbECDfFHADFFBIGCAhACANIAB.WHBA...hAFA...,2,-13,-4,9
XDHYIMNbLeRfFgOKCdVAPQSZcBWUETJaG,QAAAZAAABADBEAFAaACE..GBGAHAEBMAHBLCABRDAAFDFDKCCDhABAdDDAAAIB...SCHHhAAAUEDATGFADFHBIGAAhADAeFAAOEHD......hACA......hAFA...,1,-6,-13,7
BKTWLGRbACaMgZVXOdDFEQeYIHSfJcUPN,aAAAZAAAOACA.dAGAEADA.eAFAHBEBSBBDJCCF.UCCAhADABCHAKBHBTEFAhABAGCFAAAIBMEEBXFCAhAGAQGBAfFHAPFHDLHDA.hBGA.CHEA.DFFB...hCAA...,1,2,-14,16
cWafQVUXTPKIFAbNMSZgLJYdEROHGDeCB,MAAAZAAALADBdAEARAGB.HAFAGBBAeCABBDEAaCCH...QDGBhAGAXCFATEEAhABAKEDDAAIB.SDHHhACAJFFBEGCBDEBBCFADfFCA.UGEBFHGE.hBAA......hBBA...,2,-17,12,29
bWVBcZgeDIPRXMSJdFfLGNUCYEKHQATOa,aAAAVAAAZACB..eADEDAFA..RBEA.MAHBdBHALEBAGBDACCFBEDCBhAAAHEGB.ABBB..OFEDhAIAbEGBBFEA.gGAAhAGA.XGFDSGDD..hBAA......hBEA...,2,-26,-2,24
QUAgEBGRTbaIfOCDcPNVZLKFdHMeXSJYW,EAAARAAA..aADAOACCDAGA.....PAFAZBDELBHBhAAAdCCAHCFAeCCDSEABhAAAJEBFQEEAABIBGECBhAEATGDAbFGDCEHBNHCBFGHB.......hCAA......hCBA...,1,-4,-13,9
HaUKgIJVRWDCSQLPAOBcMNEbefGTdYZFX,BAAAMAAA.EACAeACAGAEAdAGAZBBAHAGDKCFDJCAA..RDGB.DCIBQFBAhAIAADEB.OEEBhBAAbDFD...TGFAhBFAXEBA.aFHD.gGAA.hBGAIHEA..hAAA...,2,-25,-10,15
VILZBUORNAceSHFEYTJbaKgXMDdCGfQPW,eAAAHAAAEADE.JAFAaADD.KAFA..MCABdAHAGCDBQCCAhAAAVDBBZCEBBDHARCGBACIBFFGHhACA..bEECDFIBCFAD.fGEAhAIA..IGGA.OGCChAAA....hABA...,2,-20,-2,18
BNMVaPeADHQcYCXKTOSJgWFRUfZLEdIGb,HAAAQAAACADBKAFA.SACA.JAFAFBHD.RCAAZCEBdCDAGCFAhAAABDGDMECBaCHFABFBDEDBhAAA..XDAAhADAOEHD.gFDA.fFHAhAIAEFABIGFA.NIAB.eHDAhCAA...,2,-23,-10,13
DefdFANYGJUPSLRIHKTMXWBZCaQgcVObE,GAAAUAAALADAHADAMAFABAHAZBFEQCDAVDCA.ECFAeDADhAAA.dDGAAAEAJCHBRGEAKHBAhACA....TFFAhAHAWDHH.aDCH.OFHD.DGEB...hADA......hBAA...,1,2,-20,22
QWKdROSDJBITNHULfbaGCePFXAYEZMgcV,EAAAZAAAMACA..VACAQAFAdAFARBGF.DAIBBAHB..TCDAhABAHDDALFDAhAAA.aDHDeCCDFGHBACCBhCAAgDGA.KEBD.SEFDhBEA.IGDAhBHA.fFHA.,1,-13,-14,1
GAPcfFVYOUgeDMQNXRbZdTHCILJaBSEKW,...fAAAFAAAOACDeADAMAEAQAGARBEA.dCBAHDEChAIALCFBaBHDEEBAGDCAhAAAABEA.cEAChACAUFFBDEIBbEGDCHDABHBA.......hADA......hAEA...,2,-21,-1,20
ESTZNMOeKdWFLIHgGaXQURfDYPAVJBcCb,BAAACAAA.EACAZACA.MADAeAEA.dBHALAHBHCAAGCEAQCCAhAAARECBDCCAACGAJCFBSEHBhAAAOEGD.FFABaGBAhBGA..XGFA..fGFEhBHA.....hACA...,1,-9,-23,14
BFAdWfIYOTZJNHSCRGbVUcMLXaPgQEeDK,dAAA..fAAAOADAZAGBHADARBDBGCBAbAGB..UCBAMBIBhACAaCFB.QDGBhAAAEEFAeFCHBBFAABIBIFAAhACATFGASDDB.CDACLFFAhADAPFEBDIFA....hBAA...,2,-10,15,25
BgPafVYTJFULMRAGSCDcKNWXbEIHdZeQO,GAAADAAAKACA...XADAEAEEHAGBeAGBQCCABAHBaCDB.hAGA.VDFBJCFBLEHBhAAAAAIBCBBD..cFCAhBAAbEACdGFA.OEDDfFHA...hACA......hADA...,1,-10,-20,10
KbMXfTUEFJdgaAHCWYDQZPNIOcReSBVGL,HAAACAAADACA.ZADB...IAGARADAeAGHBBCDGCEALDDBhAAAMAIBTDAAFCHD.dDGAAAIB.hAGAQFBAOCFH.hCAASEHHKFGA.fGGEEGFB.hCBAaHCE.....hDAA...,1,8,-33,41
CPfFZISBNKQeAgMbOLRXDdGHUYVaJWTEc,MAAALAAARACA.dAEAHAFBUAGA..aAHFTCAAEBBB..CCEDFDDHhAFAZCCFBDGA.QEEChABAADHAbEGB.DDIBVFEBhBAAJEBB...PHBCSFHD.KGDDhACA......hBEA...,1,-3,-20,17
bNDPZCgGcEXYWVQfFeJITOdBASKLUMHaR,LAAAHAAARADFDAFAZADBGBFAEAFA..XBFAVDAA..QFCAhAAAeCAAJDEBTFGAhABAdCHAAACAKFEA..aCHDPFHBhAIACGDD..cGFCfHBB..hBHA......hBIA...,2,-12,-6,6
fcPURDBbXEHLgJSKdAaVZQGCMYTeNWOIF,ZAAAGAAAMACAeADA.OAGDFAFD....fAHAhABAPCDBREFABCEBECCBHDFALGBAhAAASBEDAADAaGEDCGHAhACATFGA.IHAADAIB....hAHA......hCAA...,2,-25,-9,16
ZKGECfVQBLceWAIXSMPRTbNDYHOJFdUga,SAAARAAA..bADBDADAHAFAFAFDdAHAaCCBGCGA.EDDBhAAAfBCABCFDeFEFhABAAAAAMBEBTGFAODDHhBHAJHAA.ZEGB.CFEA........hAHA......hAIA...,2,-32,2,34
HLKZbOVFABWXMTSUJRgeYaPGDQNEIfCdc,XAAAMAAAUAEARADA...eAHB..aAGAGBBAQBGDhAAAECGFCDEAHEFCZDAAOCFHhABAABBBBEDDTEGA.SDCEhADAgGBADGGBfGGEdHDB.hAEA......hCAA...,1,-8,-12,4
NDKfScXRWAJabGYOdFEMZHTgQIeVUPBLC,aAAAGAAA.dADAEADAHAFA.QCEDeAFAUCCALCHBhAAADBBBSBGARDBFAAHAJEFFOFABhACAZCFATEFA.IGAAhADABHDAKHGAfFEE.WHEAhAGA......hBAA...,2,-27,4,31
WHLXaMCFVeBKgNfPEdYcUGJTQOSDRbIZA,HAAAaAAA.MACAFADABAGAKAFA....fBDAEBBBdCEAUCGAhAGAGCEA.TCGAhAAAQDBBDAIBRGCAIGGAhAHAAAIBLFFACEDD.eGDGNCCA...YHFGhBAA.....hCAA...,1,-10,-17,7
BZFcaYbQeHEUDSgWILJXKCRPONATGVMdf,GAAAdAAAZABBFADDaADA..QAGAHAFAECEF.SCDA.hAFAIDGALCHBKDCDhAAARDFFODDHADIBMEEBBFFAhACAYHAAeFHBDGHBgGAAJHDA.XGCDhAGA...hAHA...,1,5,-13,18
aSLbdWUTZBHJVRfGOAXgcECNPeMKQFDYI,XAAAEAAA..CACAeADHMADA.FAFADAHB..aAHDLBDAhAAA.dDDATCEAHDGBREBBhABAGDGAAAIBgGDAhBEAPEEBQFBASGGA.....hBFA......hCAA...,1,-11,-15,4
MLIbGCNUWaYeTcHQESBOfgKZJXVRdAPDF,FAAAMAAALADAGACBCAGBUCCA..aAHDeAGHHCCA..ECHFOBBBhAFAKDFDZEAAJCGFRFGB.ADIBDEEBhBAA...bFCDNIAB.hAEA....TFFASGFDBHHA..hAFA......hAIA...,2,-22,-6,16
GacdKfHBWYLACUFeQJZSEgTRPVDNbMXIO,FAAAeAAAZACBEADARAEA.DAGA..MAIB..OBDEGCFAdBGAHECAhAFABCCDLFHBAAAAQDEChBIASHAATEGAhCAAPHDANICB..XGGA...hAHA......hBAA...,1,-13,-14,1
WRQgKUSMNZLEBHAIaPJeFdcObfYGCDVXT,aAAAeAAA.dAEAOACD..bAFDGAEADAHB.TAGARBCB.QDGAhAEAKDHBMEBBZEEAhAAAEEBAHEDAAAIB.IGAAhAGAFGEA.fGDECHHA.XGGAhAIA.....hABA...,1,12,-24,36
cLAfHKURICBVYFSaWZJPbQdNeDXGEOMTg,HAAARAAABADBFADA.aAFDZAEB...JAGBQCAB.eAHBhAAAGCCAECEB.MAIBTDCAhACALEFAACHBKDGDCEHASGEAhAAA..bFFCDGIB....hABA......hCAA...,1,-2,-36,34
AKGQXTVeIBHUCOaYLfRSMFPJEZNbDcdWg,GAAATAAA.eADAHACBOAGDLAEARCDAFDCHEBHF.ZCEBDAIBdDGDAAAB.hACAQFAA.hADAXCACBDHAaEAHSEDDhAAAMEFBJEGFbGBAgFGA..hACA......hAFA...,2,-10,1,11
cTgIUYQJKaAHLNGebERFdMDOfXPBCSVWZ,HAAAGAAAEADERADAdAGAMAFADAIB..OBEE..XCDAhAAACBHBSCAAZDFB.TDCAhAAAgDCGUDGAQFDAhACAaDAHADIBLFHBNIEBFGGABHEA...hCAA......hCDA...,1,-3,-11,8
WfQDUZSHaEgdBCANJFMPLecTVIROXKYGb,FAAAMAAAeACH..TADARAEAKBHB.GAFA....bCECQBBChAFAZEAAHEFAEFEBhAEAdBHAAAHA.PDDBLHAAhAFAIEHAOHEEXFEA.fHGFhBAA...hAHA...,1,-8,-9,1
BMJaGdeORVIbQSFDUPTCcLXAWYfKNgEZH,...fAAAKAAAEACEHAEBMADAGBGAeAFARBCAVCCB.QEAChAAADBIBTCAALEFBhAEAACGA..YDEAhAAAZGAEaEHDIHHAbEFAFGDACGGA....WHDGhACANIBB.....hAGA...,1,4,-2,6
dVaFMgNLQJEBKXARHbPOGWYZfTeCIcUDS,HAAAOAAAGADAZADB.eAFACAFA.UCABdAHAFBBHMBIBLCFBhBAA..ECFAKDHBRDGBbFAAhAAA..PFDB.hACA.fEFETFGAIHBASGHHhADA......hAFA...,1,0,-26,26
fEaKJAbDRPCYMSBcZOHTdXLeFIgWUNVQG,RAAACAAA.MADABACA.ZADBHAFC.dCCAeAFAFBEH.....gBGAhAAAUCGBQEEChAAAECAA.aEHHACFBbDCCDGGB.hABA....SDGA.TFFAhACAIHHAVGAA..hAGA...,1,-16,-30,14
aSTCDYfHdBMURcOKgIbWVNeXLGEFPAJZQ,ZAAAaAAA.CADB.DADAHAEBBAFARAGB..KCAA....bAGDVDDB..hABAeBBAGGABECDAAAIBQDGBhACASDEHTGFAhAGAdEGAMEIB.OGCA....hBAA......hBBA...,1,-4,-30,26
DNPARaEdTFVcgKYfIGSZOQMWJCbLXHBeU,EAAAdAAAFADA..VACAKAGA.....fAFBGCABZCFAMAIBhAAACECALEEAHCDCeCCDhAHADCGAAFIBRDGBaEEC.TGCAhCAA..gGAASGGAQGEAhACA...hCBA...,1,-4,-29,25
TYKZbCIFcdUPMADBgRGeOVXJNfWHEaLSQ,BAAARAAAeADEOACA..XAGBJAFB.....fBDAhAAAHBCBEAHBaCBBLCFAhABATCGAZDEACECDFEEAhAAAdFFAMCCB.AEIBDGCAgFGANIBBSHGAhBIA.....hAIA...,2,-33,-1,32
HBgSPYDNUWAeLfdcZJCGXITVRbEMOaKQF,eAAAdAAAZABBGADA..TADARAFAECCBaCFEQAFC.HCFChAHASCHHDAIBUEDAhBAAAAAALEFBJEHB.hCDAXFAAbFFD.MFIB.KDBD.BHGAhAFA......hAGA...,2,-9,-5,4
AcFUDBEGTaPSbIMKCJOHNQWXgZYVRedfL,FAAABAAAEADAaACA....SAFAMAFACBCAHBEAQCCAhADA.XBGAZCBARDFAeFFAhAAAdDFAADHBDBGAGFCBhAGAbGDC.KFHB.OHFC.NIAB.....hAIA......hBAA...,1,-8,-20,12
LQXPJdUDGceYIKFRVATCOMNWBgfHaEZbS,TAAAMAAABADA.HAEBEACEZAEBLAGBQAGAJBBB.dCCAGDCAhAIAeCFHKDHBREEFABIBOEHBhBAANEAA..fFGAhAAAaGBBSGGDXECADIDA.IHDAhAEA.CHHA....hBBA...,1,3,-10,13
JNAdVgbOWLBKHZFXecSCEfMDYPQTUIGaR,dAAAVAAAOADA.LAHBHADBZAFAeBDBCCFAECHB..MBGBDAGAQDAAhAAAUEBAGEGAhACAREEAADDB..bFDBKFHBFGFHhBAASGGD..fHBBhBCA......hBEA...,1,-6,-10,4
cRUXedIaSYbfDNBTVMgGKCQHZJWAELOPF,EAAALAAAFACD.RADFeAFEdAEA..aAGASBFH..bBFDhAAADCAABBHDMCHBGDDAhBEAQEEAHFGBWDHBhCAAACIBODDB.cGFD.....hCBA......hDAA...,1,-18,-19,1
GeSUbNCRJdZTVAYBEafgWKHIOPcMXLQFD,EAAAaAAA.....fACAKADAHAFBOAHFMAEALBEAhAAAQCCAGDCAeDABbEEBhAIARDFAZFDAABFABCHAIFHAhADAXEGASFADCGGA.....hBIA......hCAA...,2,-14,-1,13
agXHVNGQJKYUWdOEBRFScALZfDeMTPCIb,ZAAAeAAAMACACADA...aAEEHAEB.GBGAQBGAKCCAUEEAhAAAdCCDECFBRGAAFFHDAAHALEEAhABADAGA...TGGAhCAA..........hCBA......hCIA...,1,-21,-23,2
SRGLPMadfKWeZNTUAEgBQXCFYOcIHJDbV,EAAAQAAAFACD.OACCHAEADAGA.SBGARAFFGCDAMAIBhAAAdDDAKDGAeCGHZDEBUEAAhAAAAAEAXFFA.CDCCIHAAhAHAbGFA........hCAA......hCDA...,2,-13,-13,0
BRFLQXJAYCMGTKEVdPHINgUSfWeOaZbDc,MAAAGAAAKADAEADA.dAGAHAFB..ICDAUCBASAHBhAFA.eDDEZCFAbEEAhAAABDHARFBAQGEAhACAABBATFFAPHBAfGHAaECEDFIB....hBAA......hBHA...,2,-15,-1,14
RTPHVKfBbedDGCEaSZQYWXOcNMIUJgALF,RAAAHAAAKADCBAFAeACEGAFA.EAHBZAGBQCCA.XDGDhAAAOCCAMBIBhAAAIFAAUDDBADFBTGGAhAFAVEGB..dGCACFFD.aGEB......hABA......hCAA...,2,-30,8,38
JaYcWSFgHfIeONPbDGERdZXTLCUKMBAVQ,QAAAaAAA......cACDFACEHAEB.eAGBhAAAOAEDbDCBEDHFRAGBZDAATEEAhAHALDDBKFHBAAIBVFFAhADA.JGAASGDHfHEB.NIABDBBBhAGA.XCFDCGGD.hCAA...,2,-8,-2,6
eBUFGLaWAJdHQcKfYNETSIDbCRgVMXOZP,HAAAQAAAKADC....fAFAEACATAEADAHBRAGFMCDBhAAAZCAAeBHHFCEHGEFAhAGAaCCAACGBdEEANCIA...bEFDCGDA.hAIA............hCAA......hDAA...,2,-14,-9,5
ZVFIagOdLGCKJTRDWEXPUbeQYcBfHSNAM,ZAAAFAAA.aACAdADA.GAFAKAFA.RDBA.EBHFUEFB..eCCA.QDEAhABABAHAHFAAAAHAMDIBhAFAIHDALEGBhCAACCHADFIB.XGCA......hCBA......hCCA...,1,-15,-28,13
eEGbCMWaKHJILYFRDXPfOBTSdQcZgANVU,UAAAEAAAGACAMADA.KAEAHAFCLAGBRBDBDCGB...XCEDhAAAOCHDBDBAdEAAZEFEADDBeEFBhAIAbGCC..CCBDaGGAIFCAhBAA..YHEGfFHE.SHDAhBCA..hBDA...,2,-26,3,29
TOAcPQBbRUgILaSeJEZMNYXVGDdfHCKWF,QAAARAAAUADALAGBeACAZAFB.MAIBXCCCGCDAdEEAHCGBhAAAKDHB.TDAA.hAAAACDBBFBAbEFD.aFCDEFBAhABAVFFBCBFB..WHFA......hAIA......hBIA...,1,15,-22,37
TJaCHVODAGSWINbdMPEYfFQXegZRLUKBc,GAAASAAA..IADAdADAEAFAFAHDeAEHRCDA.LAGBhAAABDBA.TDCAaDFEHFAAhAAADAIBABGB..bEFAMDIBhACAfGGAQEFAZGCE.KFDA.CHFA...hBAA......hBCA...,2,-12,0,12
HeLOZVTMDRJAPcFEbWICQSNGYaXBdKUgf,FAAAEAAA....IADAQADA.GAGAaAEDdAGAKCCAUCBAhAAAHDAAeBHHZDFFMDIBhADARDDFADGB...bEEDSEHHhAIAXFBAfGAELFFBTGBAhBCADEEB......hBGA...,1,1,-14,15
gNaLJKEbVRWZIHMPGeSfYTUFAcBXOdCQD,XAAAdAAAQADADADA...aAFELAGBEBHF.RBCFZBEBHCAChACAGEBAeCFFfDHAhADATEFAAAAABDHACEDAgFGAhAGAKFHB........hAIA......hBAA...,2,-20,-11,9
HfcRVDbENWOdgLSIPGAXQUMeBFaCTYZKJ,QAAAeAAAFADD.aACECAFAZAGB..HAEBRCEB.DAGAECCBOBGDhAAAdEHALFAASCDDhADAGGCBABIBMDIBBFGCTEFAhBGA.KFED.fGHE..hCAA......hDAA...,1,-14,-19,5
LQgIBXEFfRbNMcPUeHWCdZTGaYKASVOJD,OAAALAAA.QAEABADAEAFARBFAMAHB.UCAAHCCAdCDAGDGAhAFAKDFA.AAIBSECAhBAADAIBXEGAbFED.hABA.PFDBCBBD.aFFC......hACA......hAEA...,1,-13,-19,6
PUgRaHbWMTcCABGNISXDVdfZYEFQeLOJK,GAAASAAADADAdAGAZACBFAEDLBFD.KCDBUAGA.RDEAHFDAhAAAMAIBCDCDADEABDHB.hAAA.XDGD.hABAfFFEEFHBQGBC....hBGA......hBIA...,2,-30,-18,12
YPGbLDQBZgTdXaFeJKWHRScCEMIUOVAfN,...fAAAPAAAGADALADAQAFAZAGBdCBAaCFBeBHHhAFAKDDBHDBBREGB.CEFAEEHFhAIAMBIBOFDCAAEA.YHBAhBAABFFDXGECFGHD.....hBDA......hBHA...,1,5,-13,18
QFJSRIaYTBUCKNPbGAecXWfLVMOHDdgEZ,eAAAXAAALAEA.MAIBHADAdCCAEAGEZCDBQCDBhAAAFCFDRDGF.aCFDBDBCKCHBbDABhABAAAAA....fFAAhAFADEHBSFADIHCATGFACFFD.PHCChADAWFHH....hAFA...,2,-16,-5,11
HJTVgMFKULfcOBPQeDSWYZGEARXIabdNC,RAAAaAAAdADAHACB..TAFAMAEAKAHB.LBEBOAHDQCEDhAAAeBBDSBGDhBAAZEFAACCB.bEDACDHD..gFAAhABAfDHABGGADFIBYHCA.hAFAEHGENDDA.....hAHA...,2,-20,8,28
OSZcgXHFRMBDIKCWTPNAGUeLVfQdEaJbY,eAAALAAAQADAEAEA..aAGDbAFASBHHZCCA.XCAAhABAHCGBRFFBMEEBhAAADCFBCDDA.TGAAACAAGDFAhACA.fEAAdGCAOFHFFFHD.KGBA.NIAB.hAEA......hAIA...,1,14,-9,23
JYeGdNQaHSMAVDLXfTEFObgZPUCIWcRBK,LAAATAAA.EAEAOACAZAGB..CBFA.IAGARCAABCEDKDHBeAHHhAAA.dBDD..aEACHCFBhCAAABIB.XCCChDAAFEEA.bFDBUGGAJFGBNDIA.......hABA......hACA...,2,-29,7,36
LCcPMWbJGNgFHARQTVIXZeEUDfYKSBadO,RAAATAAA..XADBEACE.DAGAKAECBBFAdAHALBGDhAAA.CCCAMCEBbBGDGCCAhAAAFEHDHFCAABIBQFEAhABAZFFFfHDFaFBBOHFE....hBFA......hCAA...,2,-22,-2,20
RSOTZgIGWFQBCVXDEPAdeUHafYbKcJMNL,eAAAHAAAaACA..bADAKAFA.MAIBRBGFOCCAZCCAGCGA.QECAhAAACAHBDDDBAAAAdEAAfFAAhAFAJEEA.LFFBhAHATFDAgGGAFGCHBHHA...hCAA......hCDA...,2,-18,6,24
CeLDQadJWNKSgPRVGTcUIZMEFYBOXHAbf,CAAAeAAALACAQADAdAGA...NAGA.SBHHRCCB.GCCAhAAATEGAUDAAZFBAEAHBhAAABEFAXGGAhABAHEGBAEIBbFDDaEFHKHCA........hAIA......hBFA...,2,-14,-4,10
DOXJAKGUQCfgSVNLFRMaZdBPceTHEWIYb,GAAAQAAACADA.SACALAFARCDAZAEBdCGABAGA.eAHHhAAAHECAEDAAIFGAhAAA.DCIBXCFDhADAAAGAfGHAgECANDAA.aDHD.TFFAhCAA......hCDA...,2,-13,-13,0
EXBIYaZAbDQPONHVCegfWRSJKdUGLTMFc,QAAAOAAAHADAeACA..fAGBRAFAKCDAGCGAMBBBEDAAhAAABCCA.aCEDACIBbEEDhADADCGAPDGB.CDHBSEDDhAFAdFCAUGAA.FFHDIHHAYFFFhAIA......hBAA...,1,5,-12,17
RbGTDSELFgOBUaAKVPQCZJeWHfcYXMdNI,KAAAQAAAZACB.eACAHAEA..fAFAXBGAdCAARAGFGCDAhAAATDEAEDAALDGBhAAAOCHDaDFDAAGACECA.cGGAhADAMEIB..NIABDGFBFHFC.BHHD...hAIA......hCAA...,2,-9,2,11
FJYgBGcfTDUASKbPQVIXeHLWdCZENMROa,KAAAQAAA..XACBHACAdAFAEAEARBGFaCDDFAGD..JCCFBAHBhAAA.GEAA.hAAATEFAAAIBbCFAIEEAhCAAeEHHLFDB..ZEGF.MFCB.hAEAgGFD.hCAA...,2,-21,2,23
IKCebNXHWZcEGFRdgLJaAUYDVPfMSBOQT,DAAAVAAAMADA.BAGAQADC.KAFCeAHH..bBFAHBBAhBAAZDDA.EBEEGEGAhAAARDBAdDFALEHBADFA.hAIAPFEBOFFHCGGC.WHBA.....hBBA......hBDA...,2,-17,-10,7
EKMIeNUWSTgaGFDJfYdbBRXAVLOcZQCPH,LAAAZAAAQAEAHADBEAFAMAHB.eCABUCAA.TBGAGCCBhABADDDBfDHAhACAdDGDREEBAAIBOFABCEFAKFEDIGBAhADASGHBaFHDFHFE.......hAEA......hAIA...,1,2,-8,10
PQKLeMAEaDJVUdOFZWBgXNHIYGCbSTcfR,EAAAaAAA.DADAUADA..dAGAZAFBBBCA..XCCCHBDBGDFAhAAASAHHTFBARDFAQFBAhBAAeBHHABFAOCBBhAIAFEEH...NEIACFEDfFHA.LHBAhBBA...hBCA...,2,-15,-7,8
ZOXAVGeFHICSgYLUEKRacNMDQJfbBPdTW,eAAAHAAASACELAEAEBCFRAEF..aAGAMAIBDBHB.QCEAhAAA.JDDFbCCDdDGAZEEBhAAAAAFAFFFHCDHAUGCAKHCAfHGFhABATGGA.OECH....hCAA......hCBA...,2,-4,-4,0
ObBVZNMYPEDICfQALcTWegUKFdGHaSJRX,TAAAeAAAKADA.GAFAHACBaAEA.RAGF.OAHFBBEBZDEAMCCBECABhAAACDDA.ACIB.LEFAhAAA..gFDAhACAdFAAXFDCbGFANIABDGGA.fHDF.hAIA......hDCA...,1,-3,-13,10
CWEMSNXGRYIeFPbdOTBLgJfAaZDcQHUVK,ZAAAQAAAHAEAKBHBEACAMCAB..XAEARCCA..eCFHhABAbAGDdCDATEGALEFAhAAAJGAAAAHA.aFAA.DAIBUGGBhACACFDASGEA..YEEFhADAFHGE......hAEA...,2,-9,1,10
SQTaceZGHVYIMUPgXdRJONFLfCWBAKbDE,DAAAEAAA.QACA..aACDeAEAHAEAVBGBMAIB.gCBGhAAARCEBOBBBLFAAhAFACCFAAAGAKDGA.TFGAhAIAGEAA.IEEA.XFGANEEAfGFEhBAABGFDSHCAhAEA.,1,2,-17,19
GbVcDdIZMJOYEWLAaPTgBXFSQCNKfRHUe,aAAATAAABADA..SACBQAFAKAEAHCCAGAGA.VCDAhAAAdBHAZDAF.MDGBhADAOCCHEECBABBBXEADhAEACEEARFGFeFADbEFADIEAIGEA...WGAAhAGA.gGGBhAIA.NIBB,1,-8,-9,1
LXdWHPUVAEcIOZDYKFJMfSBCQGabgRTeN,EAAAOAAAZACB.KADAMAFABAFB..GBEA.aBGARAGFeBBB.hAAALDDAdCBCHCGBPDHDhAIAAEEBDFGBFECD.SFHHhBCAbFCA.gGCATGGANICB..hBEA......hCAA...,1,-6,-18,12
OEcITbQLZfeNRdCBADSGWJUgMYHFPVaXK,GAAAUAAAMADAHADA.FAGA.aCDCOAFEECFE...TBDAhAIAbDFAZEEAeCFA.RDBAdEFAhBAAAAABSDADJDHB.hBCAgFAAPGCCKGHBQGGB.hBDALHCA..hACA...,1,5,-4,9
dRgbXFQGJKCUEDfVTANYBaHceOZLMWIPS,BAAAHAAAeACEZACAMADA..IAGAdAHARCCA.XBGAGCFACDHBhAAAECCA.DCFB.TDGAhAAAABGAaEEH.LEDBhAFA.SFFBFFHB.KFHB....hAIA......hCAA...,2,-33,-7,26
feaBbULTWMEYKICXDGSFAJNOVRgdZPQHc,OAAARAAAZADBHAFA.eCCDaADDBAFALCFAMAHBEDAB..KBBDXEEAhAAAGCEAAAIBNEHA.dDDChAFA.QEGAhBAA..fHABbDBDTGDAYHCChABADGGB......hADA...,2,-7,-7,0
MCUWQLYgGKHPFcOAdbZXESeBTVRaNfJID,ZAAAEAAABACARAEA..aAHDJAEA..MACACAHB.UCCBLCCA.hABAGCFAHCFAFEFHABEBdDHAhAAAbEGD..eEEBNHAB.hAHADGHB...YHCA....hCAA......hCBA...,1,-13,-30,17
dBFVQXLASYcGPgeCWHJMNbUfREOZIaKTD,SAAAGAAAeADAHACBMAHBUAFA.ECHFZCDA.aCHDDDEAdEADFEAAhAAAQEECAAIB.hABAPFCDCEEANEGA.fFHAhAAARFBAKEHBBHBDLHFA....hACA......hADA...,2,-15,-2,13
QDSVTePbOMaCJKcALRBUEFNGHdYXfWIgZ,RAAAEAAAGADAHACAdAFA..XAFA..fAHAhAAAIDAAZCFEQCCBhAEASCCDeCHFbEFAaDFBKFAAhAAAAEEBLGEAFGCD.YHAADGEAPHEAhABAMEIB.....hADA...,2,-5,5,10
FXMcYHSBNUbdfTJgZeKDVGWRQIaOAPLCE,LAAAEAAAFACD.MAEAHAEABAHAUCEBdBEA..TEAAZCAAeBGBhABADAGAGDGARDFB.aCHFhAAAACCAXECA.hAEASEHHbFED.......hBIA......hCAA...,2,-22,-11,11
KBMDQRVSCGNaFEOIWJAHULbTcXdeZYgfP,HAAALAAATAEAdAEAeAGBZAGB..fCAEBAHBMCAARCCACDHAaCEEhABA..EEABOCHDhACAIEEAADDBUEEA.XEBChBEAgEGGDFHBSGHHGGABFGGH.hAAA......hACA...,1,3,-11,14
YCPQLFOeWHKZXJEVGRbDgNBISacdUTMAf,CAAALAAAFACA.eADHHAEBZAEBEAGARAGBDCAABBCD....aCFDdCHAhAAAUFFAADDA..fDFAhAGA.QFGAhBIAKDHB.JHDA.......hABA......hACA...,1,-25,-35,10
DURBcPVeMdQWJXfYHLACKONTSgZFIabEG,OAAATAAA.ZADBFACA..aAFDEAFA.GBGARBGFBAHB..PCCAhAAAeBBBdEEA.QFBAhBAAXDEDHFAAhAFAABDBKEHB.SEHH.bGCADGGBcGGChAIA.MIBA...hBFA...,2,-26,14,40
gUTHYLMdbVAQZOXPGCSKfFIWENeDRJBca,ZAAAXAAAGAEAKADAFAGA...ECAAeAFERCGBBDDAaBEE..TCGAhAAAHEAAMEGB.VGBAhABAACDBQDAAhABA.CDEAfEDEIHHADACAgFFAhADA.....hBEA...,1,-10,-12,2
dBHUYTIDRfZJQLVPSMKbNFegXcGACaWOE,aAAAEAAAHACA.UAFATADARCCA.ZAFBLBHB..SAHHhADAbDFD.eBBBhAFAXEAAADDAODFEdFECBGHAhAAADEEBQFFAMIAAKHFA.FFCB...hAEA......hAIA...,2,-15,-2,13
aLTUJbPAIONZRXeQVEdBDFGSYgfWMcKHC,OAAARAAAeADE..EAGEdAEA.FAGAGBDA.SCCDfBBEhBAAMCFAHBFBLDGBhAAATDCAUEFBbFEDADIBIHHAhABAXGGABBDCDIAA.YHCA.hAIA......hCAA...,2,-10,-4,6
eUWQCSHfdEBVKYNRJPALacOgbGFZIDTMX,aAAAOAAAGACAZADBDAGA..MAEAUBFAQBECHDBA.EAHFhBAAKBBDRDFAABBBLCHBhBAA..bFFATFCAhBDAeGBASHFAdEFABGHAYHEA..hBIA......hCAA...,1,1,-15,16
IFXfPSHYJAcMEKaVDUQWOBdLRGeNgbTZC,EAAAaAAA.DADAUADA..QAFABAFARAGFGDBAeBCB..bCDDZDDAhAIA.FDHD..fCFEhAAAHFDAABBBMICAKAHBODBBhBDAdGHA.LDHB.TGFAhBEA.CEGA.....hCAA...,2,-11,-11,0
FODEeVAKcLaXTWdIQZPBMGRJHfUbYCgSN,LAAAaAAA.TAEAdADAZAEB.MAHBRAGFHCAAUDBACCED..SCHHhABAOCGHDAIBEDFFABBB.hBAAKEAD...XFGAhACAQFECGGABfGBAgGFGhAEAeDHH.....hAGA...,1,-1,-22,21
gNBbFJKQOZecIdHPYSCXGLRDaTAVEUMfW,EAAAMAAA....fACANAEA.FAEAQAFAZAGB.hAAAeBBBdCDAHEBASBHBhAFAGEGARDEFaDBHABIBVGCAhBEAgDGBBFFC.bDCD.OGFC.hCAA......hCBA...,2,-7,-3,4
RMSOHUdgKeWEINfZbABDJaVGFCTYPQLcX,DAAAaAAAGACACACA....TAEAQAEALAGBRAGBMBBBhAEAHCCAdDFAeCHHEDHFfEDAhAIAAAIBBBBDFEAAPEEBhAEASFGA..OFHD.KGCBIHHAhBAA.NIBB..hBAA...,2,-21,3,24
XHMdVAaZfcOYLTeKPFCNRBESQUWgbDGJI,ZAAAOAAALADBKADA.CAFABAHAEAFE..QCCAUCAA..hAHA.bBFAGCFA.hAIAXFAAHDFAdFDAACIBaEEHhABAfFFE.YFHBeEHFFHACSHDAhBAADFDBJHDE.MBBBhCAA..,2,-18,2,20
YVKUTGJCOcebBHgFQPESZIfXDNRMLdWaA,KAAAGAAAOACAeADAHAFAQAGA.ECDAZCCA.XCGAhAAARCFBdDHAAAABUEABTECACEEABGGAhACAFEGBSBDGhAHADGIBMIBA.aFFH.YHCA....hAIA......hCAA...,2,-14,-3,11
GaDQWJdXRPKbeSBENHMLVCOfZYcUFTIAg,aAAAQAAA.dADARACFKAECeAFAEAGAHCDCLCEAOBHDZDFEUEEBhAAAFFCA.AAFAGDBAhBCADBBB.XFGDSFGAhBAAMIFAfGCE...cGFChBIA.....hBDA...,2,-18,0,18
QgEJRLCZfTUSBeOKYNaDFWcGVMHPAdIbX,dAAAXAAAEADALAGBZACB.UCCAeAEAKBFDaAHD..FDABGCEAhAAAHEDCAAIBQDGChABA.RECBTFAAhAFAOCHDDFHBcGGAMGBA.......hBHA......hCAA...,2,-19,0,19
SZFJKMRHCbLcaYIPENDVOGTBeWgQdXfUA,ZAAAKAAAHACBLADBaAEA...IAFAEAHBDBFBGCAAeAGHQCAAhABAdCGAUEDAACABFCHDRFFF.hAAACDEA....bEFD.hACA..PFCAODHDWHFA....hACA......hAIA...,2,-16,-6,10
bHdQIJBDfWESeYLOKcCPGZgVNaXMAFTRU,RAAAHAAAdADA.QADCBAFADAHB.EAFE.eAHHLCCAKCAD.CCGD.ZCCAhAAA.gDGAhACA.aEEHAAAATEEAhAFAUGGAbFCDIEHA..fHAFhAHASGEA.....hCFA...,2,-46,11,57
PGTagOVDSCUBJcfbLXQNRHWMdEFIYZKAe,eAAAGAAA.aADAOADCDAGA.CAGB.BBFA..JBHB..bBGDLCCAhAAA.QECAhABAHCDAdFEAEDCBFEFBZFAFhAFAAAABTGGASEHH.fGCEhAIANIBB.MHFA..hCAA...,2,-19,-13,6
LfQSRKXGgFMUabVTBPNYAEZeHCOJcIWdD,EAAAHAAA.OACAJACB...IAGAdAEALAGBQBEDhAAARDDAGEBAMAIBUFFAbCCDBDGAhCAA..NAIAADDAeEEGhCCA.CFHADGGBSHEGKHCA....hAAA......hBEA...,2,-23,2,25
CEHZQLaTXIgVfFJRUcbWMKOSYDdAGePNB,eAAABAAAHACAZADBLAGBaAEA..TBGAXCED.VDBBhAAAFCAARCEB.UECA..hAAAbEFAMDIBOGBEDEHBAAHAhACAPHECEGFB..IHHAfGGB.hBIAWBAA....hABA...,2,-16,-9,7
bLgEeSTIKaDVOJRYBNGHPCfZXcWAUdFMQ,dAAAMAAALADA.EAHBeACA.TAFAaCAEDCEAOAHD.hACARCCABBBDHCFCfDCAhAEAZDFBXFCAAEEAQEFDhAFASFHBKHAAYFHBPHEC.CEEB.hAHA......hBAA...,1,-11,-14,3
AQLSMWXRZBVgdbDUOKaYTPfCGIJHecEFN,LAAAMAAARACA.ZADBBAFBdAGADAIBKAHB...aBFB..TCDAhAHACCAAGDEBHCFB.EBBBACCAQFFBhABAXFCAbFFAhBAAOFHD.fHDBeHCGFHFA...hCAA......hCFA...,2,-18,-8,10
YcKEVQLgTMUOIAWZDeCRBPXNdGJFfHSab,ZAAAeAAARAEABAHB..XADAGCAAFCDDHAGB.aCCA.bDDAKCFAhABA.EDHFLEABhAAA.MDIBOEFBAAGBCFDAdFFDhABASFAD..YHEAQGGAhACA.....hAEA...,2,-21,-6,15
BQKMaVGXWLJTDNRECAeYPHZSIcfdbOFUg,eAAAHAAAZADB.SAFAfADAdCADFAFABBHAKBEA..aAHDGCEAhAAALDDATEGAhACARDGFAAAA.IGAAOFDBQGGBhCAAMHDA.WFFDDDGACGCC.cGGDhADA.....hCBA...,2,-17,-1,16
ZFCOVIeaQJWHXdMEDBRNPKbSLgGYAUfcT,UAAATAAAZADA.FAGAOACA..eCBAaAFD..QCCAhAAAHCEAdCHAEEAARBGFKDBDLFFAhAEAGEDBAAHACEGD.IGGAhBDAXFAAMDIBBHHAbFBD.SGEDhBFA.....hAFA...,2,-16,10,26
KNbVPJcRFZaUfQIABHWXELdeDMSCgYGOT,HAAAEAAAdADAeACE.MAFACAFAGAGAKBFA..VCCAJCBB..RDDAZFAAhAAAaBHDUEFA.QGDChAAAAAIBXEGASGHHhBHAOFFB.........hAFA......hBCA...,1,-3,-24,21
cgdXJNZeGRBISLKUWOHbQCYEaFMVDPTfA,dAAAXAAAZABBRADABAGBLADA..KBHBOAGDHCEA.QCDAhAAAEDCF.aCHDMEABhAEADDCBTEFAAEEB.gEADhABAeEGBGGCBSFDB.WFHHhAEACFFD.....hAIA...,2,-18,-3,15
GPUJHgFBNYAfVRILWCeZaKMQcbDOdTXSE,RAAALAAAeADEZAGBaADD..MBEBQAFADBIB.dBHA.TCAAhABAECCBGEFAUDDAHEGBhACABCFCAAAAIFAAhAFAKEHBOFEHSFCD.gGDBhAIAFGAA......hCAA...,2,-16,-2,14
KARINQVfLJPDEaSYMBdTbUHcFXOGeZWCg,RAAAQAAALADBDAFAEACA....aAEDMAIBdAGAUDCAHBFBXDCChAAAeBHHZEEBCEBCABFB..hAAAVEGBJGBE..SGFHhAIABFEA.........hABA......hBHA...,2,-26,-9,17
PLcICaFDNbBURfXQdMeAYJVGZgKHEOSWT,VAAAZAAAHAEA.EBHFSADB..TCAALAFACCEDaCFDhABADCDBBDDDRCEAQEEBhAAAeDHFAACAGEABOCHDhAGAPFFBFFCBUGGAdGAA.YHAA..hAHA......hCAA...,2,-8,4,12
dSMKBAeEfYCUbDgIWROPcaZQJVFXHNLGT,EAAACAAADACA....IADARADA.OAEDaAGAZCBA..QAGAhAAAFBGDHDEBGEGAhAAAdCBAMCGBACCA.eDCH.hBCAfDHAbFCD.gEDHcGEC.hCAAXFGA.TGAAhAGA.,2,-24,-15,9
SQRJULdYAMEFXTGZVPOcgCDNBKIeHWbaf,EAAATAAAZACB..OAECCACBBAEA..eAHHHAFB.aAHFQCEAhAAARCCALDHBAAGAMCBBhBCAGEAAVECA.gFGAhCAAKEEAbGEC.SGDA...hAAA......hAEA...,1,-2,-11,9
ZUSHdAaOWMQGTLeBRVEcJgPXCFYKNfbDI,aAAAMAAAGACALAEARAEA.EBBA..JBHBXBGAFCFD.KCDA.hAEA.bEDDZDCA.HDGBhAFAAAHAQFAAeFCBBGAAhAGAVFFAgGEA.CHHA.YBBFhAFADIAA......hBAA...,2,-12,4,16
XYbeQgGDNRAaITKCLdVEJWPMSfcFZOBHU,aAAATAAALADA.dAHAEACE..JBBFMAEA.SAGAhAAAFCFBZDCBHEADXBDAhCAAeDHBGEFARCFFACCBCCHBPDDBhDAAOEEBBEHA.bFFCDIDAIHHA.hAEA......hAFA...,2,-5,0,5
KLWZGEfSNXORcTFHPgQdDaYMBICUeJAVb,KAAAZAAAEADE..SACBOAFA.RAEAFBHDHBEC.QCAAhABAdCCDDCGB.aBHDMDFBCDDAeDFBhACAAAEALEHB.hCAA.fEHAXGFDPHAABGHAIHEAhDCA....hDDA...,2,-27,-12,15
XRDTBcMOVfAGQaJbIUFYNHCKZPEgeWLdS,aAAAJAAA..UADAFADAHAFB.ZBBAEAFAeAHBdBHA..RCFB.BDBA.hAIAMDDBOCCBADHBGEEAhAIAQEDA..hBAAIGHACEHAKGGA..PHCA...hBAA......hBDA...,1,-21,-23,2
SHUEBZfOVFXKCbDGNcMQaIgLAWYJeTPRd,JAAAeAAA.RADAHAGBEADEZAFBOCCB.FDEACAHAGCCA.MCHBhAFAaDHDLEAB.hBAAAAAATFCAdEFABFHAXFFChAEADCIB.NIABIHHAYFCF...hCAA......hCBA...,2,-33,4,37
NDGeYbdHJWZSRFVcICPgTXQfLMOKaUBEA,GAAAeAAAdAEAHADAZAFBRBCBFAGA...ICFACAHA..TDGAhAAAQDCALEBAhABAMCHBaFEDEEEE.AAABDCIBhACA.bFABSGFH..PFHDhADAfHCBKGEA.BHHAhBEA...,1,8,-27,35
FcKHaBRWDeXGTZONCIfPbEMJgLVdYSUQA,KAAAHAAARACF.eACEGAEAZAFBCAHA....fAGBECCAMCHBLEDAhAAAdCAAUDGAACHAaEHDDDEBhAAATFAA.IHHAhAFAbEAA..gFFG.SGBBhACA.FGEH.hCAA...,1,-8,-12,4
CIVefPcWgAYGZdJFHRQSNXMTUaBKDLbOE,ZAAAdAAAHADARAEA.QAGCXBGAUCAAaCAEBCEA..LDDAhABAECHFCDCA.eDGHfDFAhACA.PEHDhADAgFAAGFABSEHHMFGBDIAA.bFDBhACA.OHAE.IHHAhADA,1,-7,-11,4
HGDaEVZFCTLWRPKIfONXbBMUJdgQcSYeA,HAAAaAAAZACBTAEA.RAGF.KAEA.OAGDbCAA.BBBDUDGBdCEAQEAAhAAA.SECAhACAAAIBEDGBCEDDLFFAhAGAIGGA.XFDAMICA.gGAGhADA....hAEA...,1,0,-32,32
KCQcESZDXNFMGWfIHVeJLPgOTYRdUbaBA,QAAAEAAAZACB.DADAFAEDGAEB..fAGAHCBCeCEGhAAALCBDOCHDREEAbCEAhAAAAAHACGGA.SHCAhBCAMAIBIEEA.PEGB.TGAAhAGA.YFHB.hBDA...,2,-11,-3,8
HbOJLYDSVPWRaTeGfMFAZdUNEKBCcIXQg,dAAAEAAABACACADA....XAEDHADBbAFALAGB.SCAAhACAPCCBRCGBeDFBhAAAGDCAMEEBAAIBZEEBKFAAhAFAQEGAOFFHDGIBaGBBFGCDNICB.IHAAhAGAgGGG...hAHA...,2,-5,1,6
cYgBITJQMRfLASCaVNeXZGOPDFdWKbHEU,aAAAeAAAGACADAEAdAHAKAEAHBCA..EAGEUBFA....gCEAhAEATEBAMDEBhAAARCGFABBBCFCAXDGAZFFA.hAIAFFFA...........hBAA......hCAA...,2,-23,-17,6
bKVTOZMWfBACLDgIeJHFYRSPdUNQEcGaX,LAAADAAAeABAHAEARADFdAFAUCAA..EBHFGBGAaCCA.KDDDTDEAhAGAZEFF..MEIBhABABDHAAAHA.CFGAIGCAhAHA.FGFHSFDANIAB....hACA......hBIA...,2,-21,-13,8
WAFOVKRaLXMQfYbcDSJCNeHEBZGTgdUIP,OAAARAAALADB.MAFAQADA..bBEDSAFAhAGA.CBBDHCECEBGAGDGAhAAAdCHAIDCAhAIAACCAKFFDaGBAfEEADCIB.eFGB.BFHBhBAA......hBIA...,2,-18,-15,3
UbKPTRXJEIfQWCLYFaZBMADdgeGVSHcNO,dAAAeAAAGADAHADAOAFAKAFARCAA..EBHFQCCC.LCFAhAAAaCFDZEFEAAHADEEASFAAhACAcEFDbGCCTGGAhADA..IGHACFDABHEA.MIEA.hAFA......hBAA...,2,-17,2,19
bIFEZTDYUGMAOCgeBaJdWcfVKSHNPRXQL,CAAAeAAABACAdAEA.....fAGASADHHBCBRAFALCABhAAAbCFAFEBB.ECCBZEEATCEAhACADFIBGGAB.hAFAAAAAaGEAcCGDKHEA.XEEC.QFGAhAGA.IHCAhAIA.,2,-31,9,40
YGefbNRWIHXAcCDOPZQMBUaTgSJdVKEFL,DAAAZAAAMACABACAUAEA..aAEE.SAGHdAHAEBBB.LCCAhABAeDCA...bDEAhAIARDFAHFFCABIB.OEBBhBAATECAJHBEFFFB.fGDA.IGHAhCAA...hBEA...,2,-28,-10,18
VSBNGbLYFWcIMKPUaZTCfAHQODgXJdReE,HAAAQAAADACAJAEBRACA..EAFEBAGA.GCCALAHB.FCDDhAAAICGAMCFBKDAAaCHDhAAAZEFB.TGCAAAIBXEFChAGAeHFA...SFDH.YFHBhCAA.cGEDhCCACCGC..,2,-21,-8,13
CNcbDgdETIfWHGQMLJPSXUZaVOeFBKYAR,RAAACAAA.....bADBdACA.EAEA..TAFAIAHAHCCBGBEBhAAAMAIBLDGBhAAA.SCFDhABAZCBAaDEDeDGFKGFDACCBDDIBfHABQEAA.XFGDhAEA...hAHA...,2,-15,-15,0
aMLIKRcZEYeVTfBbgGAQSPCOHDFXJdUWN,QAAACAAAHACAFAFA.dADAUCAA..aAFAMAIBLBFA.RDBAEDFAhAAAeCDA..TEGAhAIAbCGDADGB.OFDB.hAAAXGGANEEAKECBZFFAfGBABHHD..hBCA......hBDA...,1,-11,-12,1
aSXNBZHVJCDKgOQEYATRFGMbIWLdUfePc,RAAAGAAAMADA...bADALAHB.dBEAeAHBaBGB.XCDAhAAAZCCBHEEACCGAKDCDQGEBhAAAAADATEFAFHCCIFAAhACAfHGF..SEED.hABABEHBDCCB.EGHB..hAFA...,1,4,-15,19
MZTaLAFWGXIJOUgYedBEVNKHCDfRQSPcb,GAAAXAAAOADAUADA.eAGFBAFAEBHFKAHBHCDB..DCGBREBBQEGAhAAA.hAAASFFDbCGDZDBAaDDAhABAACDBIHHAJFFF..dHABNIAB.CHHA...hAHA......hBDA...,1,10,-24,34
FMYUSVTfbBHdWIRZPGXgKJLOacENDeQCA,MAAASAAA..TADABADAHAEBdAFARBBBGBGAKAGALCCBhAAAaAHF.ECGAeDEBADAAFDHDhABAVGFA..bEDDZFDFhBAAXFGC.OGAA.DIAA.CHHA.hADA......hAGA...,1,-1,-11,10
UJZWQOMGPINYHKTEFabLBVdDASRceCXgf,RAAAeAAACADB...XADAUAFAZCCA..QAGAGDFA.ICCAhAAAHECBECHFbCECLFBDhAAAdEAA.AAIBSEHHhABAfDHAOEFB.MFIB.hBFAYGAG.FGGBhABABHHADGEB,2,-16,-13,3
ZKNDcOVMWJdYBHLIXeTFgfGREbSQaCPUA,ZAAADAAAOABEMACAdAGAHAEBLBEB..eAGBFCCHGDFAhABAECCBQDFDaBHD.CAHBACIBhAEAKFHB.VGBAJEDBBFGDhBAA.IHHA......hCAA......hCBA...,1,-14,-21,7
MZFgOPNUfcVGKIJAbEYRTSBXdHDCaQWeL,EAAARAAABADBHACADAFAaAEA....eAHFZAGBOCCBUCCA.fDEAhAAAGBEAKDHBABIBTEGAhCAAdFGA..QGBAhAAAMEDBFFFHNIDBIGEA....hABA......hBGA...,1,1,-30,31
UDMeBFaQCgcRZIAVJLfXNYdSGbOEKPWHT,LAAAXAAAdADAGADA.EAFAKAFAHBGBDAIBBCEAaCAA.QCGChAAACDFDRFAAAAIB.JDBAfEHAhABA.SDDDhACAbEFAOFAATGFAeFEBFGDHgGCAhAFAIGGA...hCGA...,1,-2,-15,13
MXWNHOGTIZbJVKaSDdRCAYFUfPLQgEBce,FAAAUAAALADAEADABAFAeAGH..MAHBXCCAHCBCGCEAhADAZDFA..VEAAaCHDdFHAhAIAAAEA...fECEhBAAQFFAgGCAcFCDOHDChAIA......hBAA...,2,-18,-7,11
QFNPRcTIMAgSCOZUKaXHVWDELGJbdBefY,CAAAZAAAKACAHAEA.DACAEAEEGCCB.dAHAeAGHQDGAFCAARCEB.hAAA..TFEAAAIBOCHDhACAaGAA...XDCDhAGA.LFGBBGHANIEB.IHDAhCDASGCH....hABA...,2,-22,-12,10
OBJYcZbLNDUgKHfaeCIPTMFdVWRQXGESA,BAAAJAAAZADBLACA.DAGAKAFAHBECeAHHCBHB....TCCAhAAAdCCCRCFBGDAA.hADAADAB.ODFB.bDGDhAEAgEED.aDHDMEEBFFCD...hADA...WHAG.hCAAEGHB..,2,-30,-13,17
McCbGagDUYSAENTLRXWPQHVBKfJFZdIeO,EAAATAAARACA....XAFBQACCHBGBKAECFCCHdAHAeCFDhAAAMBGBCDAA.aCDD.DCFBSECAhADAADHALEHBPEHDhAIAfFFAJFFF.OHBA...hBIA......hCAA...,1,-9,-12,3
INMJbHZPESWXUVQKdYATaGRFgeLODcCBf,GAAARAAAeADELAGBDADABAFA...ICCAMAHBHCDA.EDCBhAAAXBECQEFAhACAdEEAAAAAaDHDOCHD.hAIAfFHEbFCCSGHHWEFH....hBAA......hBCA...,1,-11,-17,6
dZfNXJWQaEcVBTYADUICKLgeSbFPHOGMR,DAAACAAALACAeABAFAEDHAFB.GCCARAGBZCCA...XDABhAAAQDGBEAHBBDHAAAIBKEED.hAGAbEFCMFGB.dGCAfGEEhADAJFHB.aEAH.TGGA..hAEA......hAIA...,2,-20,-3,17
WBAIHOFYKXJVdUZSQePMLCbgfRaGNTDEc,HAAAFAAAKADAXADB.dAGAZAFB.eAHFMAIBLCCBCBFC.hAAA.bCAARDAFGEDAhADADDFAEEDABEGAACIBOFFAVGEAhACAQGGB.......hCAA......hCCA...,1,-12,-14,2
KFdDNfQJXHITgLAGeMEZUbYVPcRaSBOWC,eAAAEAAAZACBUAEA..VAEARAGBBBCA..CAHBdCBCDDDA..QDFDhAAAHCFCTECAAAIBGEBAhABAMEGB..bFEDPFGBhBEA..aEHDOEEH...WFHHhCAA.....hAAA...,1,-14,-15,1
PYeBDSXadMHUOVbgcTEJKANRfZIGWCQLF,RAAAZAAAGADAQAEALAFAFAGE..eCABSCCDdCCDHCFCOCFChAAAVEEA...bDADhABA...TEFAhADAEFHFAEABNICBfFEE.CEHBBGHA.aHAAhAGA......hAHA...,2,-7,-5,2
YVBbaOLeUPIfdAEMgKFZHJGXTNRSCWQcD,EAAAMAAAFACDHACC.GAFA..TAEARCCBCAHAQEFBhAFADAGABBGAaBHDeEHH.IHAAhAHAACEBZDDA..XEAAhAAASFDH.YHDGbEGDLFDBhAEA......hCAA...,2,-27,4,31
gQDTHaSUGLZdAcWIJOeMEVfRCYXBFbPNK,..IAAAeAAAEADARACA.CAFA.BAFB.FAHB..bAGDKCAA.DCEAHCCAhAAA.aECCGDDAhACAdEEAAAIBJEHBMCIB.VFGBhADAXGCC.PHEC.....hCAA......hCCA...,2,-30,-6,24
BRaGKNcbdEOeHSLfgWMXQUTCJFVZYIAPD,BAAARAAAGADAKACA.....bAFAEAEEHCFALAGB..fCCEhAAAMAIBQCAAhAAATDAAFEFHZCDBACDBaEHBhABAdEGAeFAASFDAWFHHCHAAJHCAIHHAhACADAFA.cGCC..hCAA...,2,-30,20,50
CWKDQVbaULdPGEOcfHBAZSTMgNYRXeJFI,ZAAAMAAA....gADBRACAeAFEFBBHCAFB.DBGB..QBGAhABAaCEBLCHBGCAAhACAEDFB.fCCEhAHAADDB.TDFAXFFCIFDAKGHB.bFFAdHEDhAIAOHFC...hBAA...,1,1,-19,20
CFNBAEHUSMdPLKDVgbQWXYTJZaGfIceRO,HAAAMAAAdAEALADBDAGA.VAFA.QCABXBBAJBGBGCEAhAAA...fCHAhACAeCHHRDEBFEBAAEIBEFAAhAFASFHHKFHDbGDA.TGBA...aGGBhBAA......hBBA...,1,16,-28,44
LebMIgUFZTNGSKVQDCHaEPWXAYRfJcdBO,RAAAJAAAdADALADB..eAFAMAFAICFAFBFA..ZCFAGCGAhAAAKDCDDEEAHDDB.hBAAECCBXEFAAAFA.hABA.fGFAOFHD......hBIA......hCAA...,1,-20,-33,13
UdfMZFPHCcVQTXDBeELaNKAbYWGJSgOIR,...bAAAGAAA.SADAOAEARBDFdBHAZAFBHCDBCCAA.QDGAhAAATDFABEHAhAAAEAHFaDAHACCB.JFCBgFBAhABAfFFAMFFBFGHB.....cGCDhACADDCB....hAIA...,1,6,-26,32
SMcXZNPFCOWVdKgDHIaQbBJAGETeLUYfR,EAAAeAAALADAUAEARAGB.MAHBZBAE..FDDAOBCB.dCFADDGBHDDBhAAAQEBABDHAAAEATFGAhAIA.SGFDhBIAXEGDCHHA...WFFD...hCAA......hCBA...,1,-15,-27,12
MeCAIQdNHSXFEcBGROKVUDZYbTLPfWJga,dAAAHAAAFADAEADEGAFARAFFKBHB.DAIBZCAA....TCBALECAhAAA.fDGAhACAJDEBaDGD.eCCEAAHB.QFAChAFAXFGAOECDUGGAYHAG.hACA......hBAA...,2,-32,16,48
MJNfFSKAYaTXUIZHdWeELCRPDcBGQObVg,aAAATAAA..XACDZACBHAEA.eAHHEAEARAGBDCAB.GCFAhAAAQCEAOCEBbEAAMDIBhACA.JGAAFDHDAFFBIHFAhAGAdFFACGDABHGA.NIABSBBD.hAHA......hCCA...,2,-4,-1,3
cTLdAVHRfbFQSKeZXCGgDaOPNWUJYIEMB,HAAARAAAFADA.QADCKAGA.eAFEZCCAGCGAaBFDOCAB..hAAA.PCCBUECAIFFAhAAAECHBMEEATFCAhACAACFA.bFFACGAADFIBJHFA.BHHD....hABA......hAGA...,1,25,-35,60
WPeBNCZQDbdOISLcERUJfGXKVaMTHgFAY,...PAAAeAAACADAZADBQAFA.dBHASAFAhAGAECCARCEBUFAAGCEA.KBHBhAIAaEEHHDBBAAAABEHAbDGDOGCChBAALGDA.fHGFMIEA..hAFA......hAIA...,2,-16,-2,14
APODVcGIaMfUBKgFECHLdNTXebYSZWQRJ,DAAAGAAAMADABADA.FAFAHAFCdCDA.TBBAeAHH...bBDDZCEBhAAA.REGBADAB..OCFChAIAVFBA.aDBH.KEFAEGEAhACALEHB.XFCA.SGGDhBAA...hADA...,1,-3,-19,16
TYZXUMaWfbcIAFNQgPeKVBDOdCELSJHGR,QAAAeAAABADAdAFAEACALAFAHBGBRCCAZEEAMBEB..aAHFbCEDhAAAAAAA...FCGA.gDGGhAGAKFBAOFHDSDCBhAHATGEA.XGGA...hBFA......hCAA...,1,3,-19,22
KFQMOUTWXaNGLIbHDfVgSAedRZCYcBJEP,RAAAZAAACADB.BADB.EAFAFAFA...MAIBTBGA..aBDEGCAAhABALCGBHCCCDCCBfDFAhACA.SDHHhAFAAAAAeDDAdGEAcFCAKGGA.QGFAhAIA....hBIA...,2,-33,-13,20
RELSHIMfYdQTUCGPAXNcFVZaOWbJKeDgB,XAAAFAAAZACB..aAEDOADA.JAGBeAGB.BAHBEBDBHCEBhAAAMCGB.dDHAUEBAGEBAhABAACIB.VGFAKEDAREGFSDDDhAIA........hBEA......hBIA...,1,-4,-34,30
DUYECHefNAaQLJbSGRKIXOFVdgTZBcWMP,aAAALAAA.SADHRACFKAEC.OAFAdAHAZBFBBBFAMBBBDBIBhABAECEFHCAA.eCGFhACAADHAQECCGEDAFFBBhBFATEGAPFHBCFFD....fGHAhBAA.....hCAA...,2,-15,-9,6
gBaXFdGKEQWCNRPZOHVJTcADbSUIMLeYf,SAAAMAAALAEAeACH....fBBAaAEAdAHAEBEBQCDAhAFACCGD.RCFAZEFEhAGAHDDATDBAAAAAbEGDIFBAhBFABGCAFGGAKHEAPHBA.OFFBhBHA......hCAA...,2,-12,-2,10
aBGLDREPSWcMVfAbKOeQNHFCgIdZTYXJU,OAAAeAAAHADAFADD.CAGBdCCAZAEB...TCFAXAGA.UDGAhAHAGEDALEEBEDHFSAHHhAAAMBBB.AFAAbFFDhABAQGCA.gGGAYFCFaFHDhAFADCCB.....hBAA...,2,-22,12,34
cgQTWAJMZVXFKNUDEPbILBGdfRCOaYHeS,ZAAAFAAAKADADACA..EAEA....bAFBLAHBdBHA.RBEAaCCCHCCAhADA.eECA.SEGAhAIAQDFDACEAMFFBhBAAXFGAUGGABGFDCHCA.OHBA..hABA......hBHA...,2,-28,-10,18
fXDNdMaGSZObIRLJKQWecECYFTPgVBAHU,HAAAXAAAdADAGAFAZACB.OAHFRAEALAHBQCABeCEAEECAhAAAFDDA..TEGAhAAAgEFAAAFBDFFBaGGCbFACKFHBhABACHAA...YFEFBHDA....hAFA......hCAA...,1,0,-6,6
aLfGVAZQHEOTMIdCcSWPFJRbgKYNUeDXB,HAAAEAAA.MACAdADASAFAFAFDRBDB.KBHBUDGA.eCCBBBCChAAAaAHBGCDBZFEA.TEFAhAFA.CEHBPGAAhAGA...........hAAA......hBIA...,2,-23,-22,1
SVgQOdeXRGNZHLDfFKcMabEPTBIAJWCYU,CAAASAAA.QADAeACARAFAZCAAHAFALCEAFCCBMCHBhAAAEDHFBEEAAAHA.JFCBUDEAhABA.ODABGGEBhAAAfFHAaGAB.TGEA...hACA......hADA...,2,-21,-3,18
HQgEOYPVCceSITMBKJLFRdZGNAXfWDUab,XAAADAAAUADAHAFA..EADAOBBBVAFA...eCFATCDAhAAAMDDBKCHBLEEAhAHARDAAGDFAADIBaDBDQFCAhABA.PFHDSFGABHEA.dGEA.hADA......hAIA...,1,0,-12,12
KLNZSRJGdYCTBPFWcQeIHAMXOfVEUaDbg,MAAAOAAA..EADAaADDDAGA..KAFAZBBARCDAGCGAdBFA.CAHB.TDGAhBAABBBD.FBHFQDBChAFAHEEBADDB.XFEAhBAAfFCA..bGCC...NIDB.SGHBhBCA..hCAA...,2,-26,-11,15
KDdgYAaVBELCReNZUGcbMTPFHfIQOSJWX,aAAAEAAARACAZACB..GAFAMAFA.FAHFHBEA.QDEBSCCAhAAAXDGDdDAAADFBLDHBhADAeEBBUGGATGFAhAFA.fEEEOHBEKBBD.DBGA...hCAA......hCBA...,1,4,-12,16
fecgMRZKQGUISANWXHLYFbVEDCJOBdPaT,XAAAHAAALADBFADA.EAFADAGAOAHDdBGA.aCACeBCH.MBIBhAAARCEFZEFBGDEASEHHhAAAACFA.NFAB.bECDCGCABHBDhACA..TGGA.fEGBhABAKHDAIHHA...hCAA...,2,-20,8,28
bGMcYZgWSTXNPKaBULOAFdVfIeQECHRJD,dAAAVAAAeADA.EAGAHADB.RAFADCHBGCAB.MBIBZDAASDGDhAAATCFA.XEEDhADAKEAAaECDLEEAhACA.AFIBfGGAQFAACFHAJHCA..hADA......hAEA...,1,-3,-13,10
VdUQIBSKfZaCcGWLTgFXbYPEJNReDHMAO,dAAAQAAASADAZACBCAEAGAFA.LAHBTAGAXCEAhAAAbABD..ECEBRDGFHECAhAGAAADAOEEBIHHAhAIAfFGA.aFHD.WHBG...hBCA......hCAA...,1,-4,-15,11
YbWSAGMgIdLORFVcXeEHCKZBTQfNaJUPD,GAAAMAAAdAEARADAFAGA..XAGAHCDCZCGBQBBAaDAH.hAAAUDEADDCB..bFFAAAGALDHBhBAA.OEBAhBBAeGCECEEDTGCANIDB.PHEC..hBEA......hCAA...,1,-3,-13,10
DAgUfLIbPaZOXReJGFTMBWVdYNHCKEcSQ,UAAALAAA..IADAaADDZAEBRAGBGAEAFCAA.BAGAdDGDHEEAhABAEBHF.QGCAhACAACDB..bDFDXGGAhAIAeEDBMDIB.VGAACDDD.SHEAhAGADIFA.....hBIA...,2,-9,-6,3
eWXZbIDQFVRGHPLcYEOUABgSJMNKTaCfd,SAAAMAAAKADA.CADA.eAFEZAEB..DAHBQBBC.RBEAHDDAhAIALCCBECHFAEIBBCGDhAAAJFFA.aCHDdGDAbDABIHHAhBAAGEEAPGBC.....hCAA......hCBA...,2,-21,-8,13
DWFeNVbLJAROZQdIKYacEBHTgGPSUXCMf,RAAAZAAAdADAKADC..aAFAEAFA.HBFCGBEAUCAAMAIB..DDDAeBGBhAAA..bDFAACCBQEGBhABA.IHHAhCAABECATFFASDDDfGDAhABA.WHFA...hDAA...,2,-21,-19,2
FQebHMEJaXWGYZTRKLNgAIDSfBcVPCOdU,SAAABAAA..PACAdADAQAFAHAFAEBCB.aBHDGCDAhAAAZCCARDFFLFAAhAAAAAHADCHBVFFAOEEH.eFHBhABAbFCDMIFAXDBC.YHBA.hCAA......hCBA...,1,12,-15,27
ODYWafQXMAPIJKLRdBNUTVeZbgcSEHFCG,JAAARAAAdADABADBUAFA....eAEHZCCA.....bAFDSBHBhAAAHCCBGEFADDGBaDHHhABAfAHA.hAIAMCIBAEEBKFBALFEDTGGA.....hBFA......hCAA...,1,-10,-35,25
UKAGXJcMVCPDIdgHWLOTNREFYZbeBfQSa,GAAAXAAAMADA.CAGA.DADA.dAGAHCDALBDBTDGAECFBZBFAhAAAeBHHQEBAhACA.aEFHAAAAVFBA.hAIAgEFGOFHDNIBB.FGHDBHGD...hAIA......hBFA...,1,9,-20,29
SCKRBbDVeULQPgHNIdfMaZXJYTAGFEOWc,EAAAOAAA..SACARADADAGA.eAEHLBHBQAGAhAAAHCCAdCFAaCCBZDAFXEAAhAEATCFAABBBFEEHCDDDbEFAUGGAhBAA...PHCAgFEG.fGAEhADA.MIDAhAGA..,1,9,-15,24
fSANIKYOXLBRgPaMUJeDFcTEVQdGWZCbH,KAAAXAAARACF..aAEAMADA..eAGHFAGDEBDAdCAAZCDBHCDCAAIB.hAAAIDBALDHBBCHAhAAAUFFADEEB.TFFAhABAQFBCCEHA.SGEDOHEC..hACA......hBFA...,2,-18,-10,8
BVCKNeDPfHZWEgTAYbQIFcMGXdLURaSOJ,QAAAFAAAGACAdAEBRACA..aAFAOAGDBBFAKBHBeBEH.DAIBHCDAhAAAZDFE.EDAAAFGA.bDGDMFIBhBAA.LGDAhCAAUFEA............hCBA......hDAA...,1,-10,-18,8
UNYaRdDVEOSAfBMJbFZWegcITKXCLGPHQ,MAAAFAAAeACH..IAEAKAEALAGBHAFBQBBAhAHAUCEA.aBHDREAAdEHADCEBEDFBhAIAAAIBBDDCZEGB..WFFDhBAATGFA..CHBA........hAEA......hBAA...,1,-7,-30,23
BDYeMUfNSIWRbXPQLaHGFZVdcOEKgATCJ,TAAABAAAeACA.MAGBUACA..SAHBRAEAXBGALCAAhAAAHDDAZDGFdCEAEFAAABHBDDHBhACA..fFDEhAAAIFBA.bFFDaEDCFHAAOEGHCHHB.YFHBhADA....hBFA...,1,10,-30,40
ZdfHRAPMKeYFLcQJSOBITbNXGDUEVCgWa,MAAAeAAALAEA.QBCDOACETAGAXBGAGCCAhAFAECFBCDDDaBBH.dCFAHDGBhAAAACIBKDHDFFAA.SEFDhABAbFDDDFFBUGAAgGAGfGGA.hAFA......hAGA...,2,-4,-4,0
ZWcDQFUdMHTEISaOCXBgeJYPfVLKRbNAG,ZAAADAAAQACAdAEAHAGBECAA..aAEEXDAAeAGH..PBBBhAFALDDA.REFAAACAGCEAhAIAFFDBMIAATEGAhBAASGAABCHAgGGAfGHAKEDD.hABANIBB......hAGA...,2,-8,2,10
ELXHAWRVGeQUcCdagTBOZJMFDKfPNYISb,RAAAeAAAQADCCADA.dAFAaAEDBAHAZAFBFAHDKCCD......hAAAfCGAPCCB.hABA.IDHAEDEBHEGBhAAAAEEAGEFAgFDBOFHDMCIB.DHAA.hCAA......hCBA...,1,-8,-24,16
aTfXeVAPSgKHcNbZUYGBJWdEFLCODIQMR,SAAAHAAA..bADBZACBGAFABAEAdAGAEAHBLCAAhAAADAIBMCEB.RDEBaDHB.TFBAhACAeCFBAAAAKFHBUFFB.hAIAJGBACGGD...OHEE.....hBFA......hCCA...,2,-28,7,35
VLPQRWGCKTOFceXIDJEfMHYaBUdANSbZg,SAAAZAAALADBRACFGAEAKAFAFBHD.eAGBDCAA...EDGBHCEBhABAaAHFBEAAAAHA..bEGDhACAgEDB.hAFAQGFATGCA.......hCGA......hDAA...,1,-6,-27,21
FbXZfIgVUGARPeQDYOcWKNETHCJdSLaBM,RAAAeAAAQADCOADCKAGC..EAFEHCCAdAHAaCCCMBIB.XCFBhAAAZCEB..fDGAhAAAgECAGGDBhABAADHBDFAB.cEGDTFEA.SGHBhABA.FHFE.bFAD..hAFA...,1,-3,-5,2
PFHCDALEeNdYZWXSIaOKgcVBGJbQRTUMf,EAAAeAAAdADAZADB..SAFAaAFD.KBHBVCGBGCBA.QDDChAAARDBBMEEBFAHFHDGBhAFAAAAALFFANIAB.hAGA.XFDAOFBHBBCA....hBFA......hCAA...,1,-1,-15,14
EOPcGNWZHeRJDLVgaFTfbAQMSUXYKCdIB,MAAAXAAAKADA.dADABAFB..EAFAOAGDGBGAZBBAHCEBRCEF.hAIALDBB.aDDBhAAATEGAAAIBQFGBhABASDDDCFACcGCBeGEEDBIB....hBAA......hBCA...,2,-34,11,45
aAYVIZOdDefXGFUgNLbQJRHCWKBPEcMTS,VAAAZAAAdAEA.eAGBGADAFCAA.UAGALDAA..QDAAhAAAHCFBKEDAEEHFMDDBaAHFhABAAAFBODHB.XFDDhADAgGGAbFFDCGBA.BHHB...hACA......hADA...,1,-2,-12,10
ZKYGadfJcNEbHPIMLSXQVgTOUDAeRBWFC,RAAAFAAAZADBGACAdAGA...JAEAECFBHCEAMAIBLCHB.QEBChAHATDAADDHBAAIBeEEAhBAACCCC.KGCAaEEBfGGAhBEA..bFBD.SEHHhAAA.XFFDhABA...,2,-27,-1,26
DVTPaNXgEbJMfSOZGKWCQLRHcdUAYFIBe,FAAAeAAADADA..TADA..aAEEXAFBEAHB..MBDBhAIAOAHDGCEACCCARCEBHDGBhAAAdDGAACCBBECDVGDA..hBAA.gGCAfHBBKFHB....hCAA......hCBA...,2,-29,-3,26
TbFScPUaXIAgDReBdCOfQLMENYWJGZHVK,RAAAeAAAdADA.OADCLAFA.ECCB..NAHA.JCEBHCCA.TEEAhAAASCGAUFAAaCEAhABAAAAABEGA..QGEBhAFAMEIBGGABKHGA.FFFH.....hAGA......hAIA...,2,-18,-9,9
EVGQPaFgWOcKAYRSLHNeXZTdDBCfUbMJI,RAAAHAAAeADEZADB.dAGACAGB.UCAB..MAIBECFBGDGAQBDDhAAAaEEB.FCGB..OFBBhAAAACCBLEDB.TFFAhABAfFFE..IHHA.hACA......hADA...,2,-19,-15,4
PcbaKBDTXSdIHLJWUFGYOEAeNZgfRCMVQ,eAAAZAAARAEA.MAEAQCAA..bAFAaAHDDBDB..SCDHhABAHCDBLCFBUDFAGFABhACAECHBAAAA.fFHAhADACEBAcFDCTFGAdHEBIHAA..hAEA......hAFA...,2,-7,-6,1
gMSXBNLZDTRbAIeYFdGfCOUcKQVEWHPJa,eAAAdAAAGADAOADCKAFA..EAGEHCACaCCA.MAIBBCFAZCFBRCGFAAAAFDHHhACA.CFAA.UFAA.QEEChAFAPFDBSGGAhADAXGGADDDBIHAA....hAFA......hAHA...,1,-12,-14,2
QOgSWCAZIUcLXVEaMdTJBeKfHbYGRDPNF,ZAAAUAAALADBEADA.dAFABAFAeAHBHAGBGCAARCBADCFBFCGD.QEEChABASDADACAB.hACA..XDFDhADAaEHDMFDBTECAKGGDYFBBODHFCGGA...hAIA......hBFA...,1,-2,-15,13
RQWIBPfYTKDANaScVGgCbLUMJFXHZdEOe,aAAASAAAGACA.CADA.LAEA.MAIBXAEDHCEAEEEBhAFARAGBQCCCBEGAfFHAhAGATDFAAAAAcGCAhBAAbDABFEEH..OBBHeDHHIHHAhADA.KGADDGGBNIBB...hAGA...,1,7,-11,18
YaVbELXGeDIHFcUZAOfBJSMCPTgRKNQdW,BAAAMAAA.CACA...TADARADFKAFC...dAFA.aAHBEAHFGBBAhBAAeCABHCEBFCHDZDEBACCB.fEDAhBBA.SFHBhBIAgCGGQGFAVFGB..hCAA......hCBA...,2,-29,-7,22
ecPKJWQIMCFHASBVGTDgZaEfbNXORdLUY,BAAAGAAADACAaADA..EAEA....bAFDOAGDRCDBLBHBhAAAeBCBKCEAQEBAhACA.MEGBHDBBAAHASFHBhBAATEEAZEGBXGBAdHCB.cGEChAAAWFFDCHHD....hBCA...,2,-22,-2,20
VOHYRQKABFaPCTSEgWLIfeZNGUMDXJcdb,aAAATAAA..EADALACB.eAEAGAFAMAIBXBBChADAdCEAOBGDHCDBREAAAAEAFAHFhBAASEFHgDGHhBFAfEHAZFDADFIB.bGCC.....hCAA......hDAA...,2,-7,0,7
BLgUGQFRZeWdfXVHMCcNSAEDbYIOJTaPK,EAAADAAA....IADATACAKAEC.LAHBGAEARAGBeBEAhAAAdBBA..XDCAhAGAHDDAMCCBCDGD.SEGAhCAAAAIBbFFA.OFDBaHFA.BFFD...hBAA......hCAA...,1,-4,-29,25
JTfXCLSGeMKODAbgPBaUFNERHcWIQZYVd,...bAAABAAA.aACAFAEARAEFHAGB..IAHAZBCFdDGDTFEAhAAACBEDGCAA.eCCBhAAAMCCBDCGAAAIB.UDGAEGAA.hAGAQEEAJHFE.fGHA.hCAA......hCBA...,2,-15,-11,4
OHWTaBAPeIdCLFcZYgRbfNVGEXJDMKQUS,eAAAdAAALADAZADBRAFA.....bABDfBCAGAGAECEBDCFBhAAAKEAAQCGAhABA.OEEBHDFBaEEHhAEAAFGACFHAFGAAYEHB.NIABXFCDMIAASGEHhAGA.BGGDhAIA...,2,-16,6,22
HYGKPZeJgWdLUREbQTFIVBaXSAOcfNCDM,OAAA..fAAADAEAHAFCGBBBZADAeAFEJCFBdCBARDGF.ECFBhAAA.QDDChACAFEBABGGDaEDDACHACDHAKEAD.PFFAhAEA..WFHHLHDA...hAIA......hBAA...,2,-27,-2,25
OYHJTeGEIMBFcPUVNfAZKgQRdbLDSWXaC,ZAAAQAAARAEAdAHALCABSACA.aAEDOCCB.HDEAhABAeAGBEEDBMAIB.FCDHhAAAPEHDVDABACGBKGCAbDFChADADADACFGA...TGFABGFDNHAB....hAHA......hCAA...,2,-5,-5,0
ePfdMVEIZURSNcJQXFbTGBgKWaCALDOHY,LAAAHAAAeACEdAEAEAFEZAFBRCCA...SAHHJBHBFDFD.GCAAhABAKEHBCFCA.ACABDCDB.ODFEhACAfGGA.hBEAMEEBIFFA.NEEA......hAAA......hAHA...,1,-19,-22,3
UcPYfIGLSFDWTQEZdJNbMHKXVCOeBRgAa,aAAAUAAA.....PADAfADAGAGALAFA.hAIADBBBTCDAECCBdCEAbDBDhBAAHCGBKDFB.CDADeFFBhADARFFAABDB.IGAA.FFHDZGBEMICA.OGCChAGABHHA....hAHA...,1,-4,-7,3
AdISHfQReGgUcWXNbDMPZVEJFYLaKCTBO,dAAAHAAARADAGAGAUADA..XAFADCCBZDAF.ECABFCFHLDDAhAAA.aBHDTEDABEGAACCBhACASDHHeEHHgFDAhAGA.NIAB.bGAA.MFGB...hAIA......hCGA...,2,-18,-4,14
UXOJRaVHbCPQTeWgBfIAdYMNZcSLEDFKG,dAAAMAAAZABBLAEAEADA.KBBAGAFA.OAHFRCDAHCGBCCED.TDBAhAFAeDCFBDHDAAIB.hAGA.NEFADGCAXEEChAHAaGGA.bFGD...WFBD.....hBAA......hBBA...,1,-8,-20,12
RVdbLJgZECMBIGWKNUDFOSaYAfHTcPQeX,HAAATAAAQADC.RAFFdAHAbACBLAFAZCAAEDFBBDHAGCDAhAAAKEDADFAASCFAhAGAAFHA.fDHAhAHAeHDAXGGBgEBB.MFFB.IGGAhBEA...hAAA...,2,-9,6,15
EGHVRUNBZMLOIdQgfXAaYbcDPWJKFSeTC,aAAA..bAAADADA..JAEASAEA.eAGHEBEBHCAAhAAARBBABCEAZCFBLDHBhAIAdDHAQEDAXDDCAAHAPHEAhABAFEFDCHEA.........hBAA......hBBA...,2,-26,-9,17
CfXYUeIEdPAbGQWDgMaKFJOSVRLcTHZBN,GAAAQAAADADAMAGBaACE..FAFASAHBRBDALCHBHCDBhAAAZDAACDGA..XCGDhACAeEEBEGDBABFB..bDBDKGGAhAAAOFFA.cGGC.BHBA..hBAA......hBCA...,2,-15,-10,5
JCWaKNFLVSXfTPYgbOBQZcGHdRMDIUAEe,EAAAeAAA.CADA.aACDFAFALAEA.SAHHTBEA...hAAAPCBBbCCDBBHAZCFAHDDAhAAARDGBMFFBDEHBACCBKGDBhABAXFAA.fFFAgGGAcGCDhAFA.IHHAhAGA...,1,-15,-18,3
SPBGYJeAHNcgIbQZdOFaLMDXUTfEKRWCV,HAAA..gAAAbADBZAFB.dADAaAHDMAFA.DBFAUCABEBHFRCDAhAAACDDD..SDFAhAAAGDBAeDHFABFB.IEFAhABAQFFAFGGHXGCDKFHBPHBA..hACA......hBHA...,2,-10,3,13
WaXISOKGVYUPZNERTDJbQHBLcMfgeFAdC,dAAAaAAA.SADAGACAUAFAZABB..RAFFDAIBQDFA.HEAAhAEALDDBMAIBeBBDhBAAACHBXDFCKEEDPFHDhBEAEEAAJEHBBHBA.fHEBCECAOHAANIDB.hBFA......hBHA...,2,-13,0,13
BISMUWfdHgcYbRLAGZaCDXEKJNTeFVQOP,aAAAXAAA.KADATADA..eAFEQAFCBBFAMCDBhAAAfBBEHCFCgDAAhABAbCEAAAHA.ZEDBEDABhADAFFFAODCCSFHHdEGDcFFC..hBAA......hBIA...,2,-16,-7,9
FSUgNXRZBGYePJTEdLAQbKOICDaVMfHcW,QAAAOAAADAEA.aACE..MAHBHAEBFBBHSAGA.hAIAgCGARBEBGDCAeCHHhBAATDAAEFFBAAGAbDCBhAAACEBC.VEEBfFHAWEHH.XGBDhBDABHCA......hBEA...,1,14,-20,34
dRATSEPOGUXDFJLBeHWMVagZNbQIcYfCK,EAAAGAAADADA.LADAHAEC.MAHBaAHDZBCAQCDA.IEGAhAAAfDBAdEADAAIBhACATDDAOEHDFDGAeFDBhAEAgEGG.cFFCKFFDSGCDhAFAPHAA....hBAA...,2,-4,-4,0
JXZNeYMAFSgPLbUCQVdfRTHcaKWGBEDOI,SAAALAAACAEAdAGARACFHAEB..aBHDGBGABCAA.EDEBOCCAhABAXEAA.eEFHhAAAADDBFDFBbGAAUEAA.QEGAhACAfGHAKGGDDAGAZGBE....hAEA......hAIA...,1,10,-18,28
VCQARPMbBZLeTFXfYONDSKJdcaIUgHWGE,RAAAMAAAZADBLAGBFADD..XAFAOBFBDAIBKBBB..dCFAaCCBhAAAUDDAHDABGDGAhAFAEDHF.QGAAhAGAADABBEEDeEGD...TGBANAIASGGDhBAA......hBBA...,1,-6,-16,10
gXPWOReTBVGFcAaQJCDfEUKIHYdZMLNSb,aAAAQAAA.DADAEADAKAFAHAFA.ZBBAMAIBLCFA.hAAAbDAAXBDC.hADAOCEEREEAeEHHTEBAhAHABHAAFHCAAEEACEFAfEHA.IHCAhBCA.dGGDSGGDhAHA,1,3,-36,39
CcBaSTJEUKFWfYZbRAPOgLVXGIMHDdeQN,OAAALAAAGADAHADBeAFAQAFACBHABCAAaBBH..TCFAhABAECHFFDFB..fCCEhACAbFAAAAIB.gEEBhAFAXEGADFAAdEHASGAAKGGAYHBAhAFAPHFA...hBAA...,2,-7,0,7
YdKHTOWXJCVaMSINERbLFGcDfQZBUgAeP,eAAAdAAAHADAOADCXAGB..CAGBaAHDMBIB...SCAAhACAECCARCEALEEAhAAAGCEAfFAAhABAZDAEBCGDAEHBKFCATFAAVGEANDIAbGFA.DIFA...hAFA......hCAA...,2,-9,4,13
QfJRXTHPBCdZDabcWeKgGENOIFVUAYSML,MAAALAAA.QAEARACAHAFBCAHAZCCAaAGE.....bDGDeCAAhABAGECAECEBOCGDhACAFFABABBB.fDDEhAEA.TFFAdEEDDCIBKGDAIHHAYHAAhAHASHAA.hCAA...,1,-5,-10,5
LgNCEJYTdBePDfFZQSVUcAXOMKbIHWGaR,MAAAKAAAHACBGACBRAEALAHBCAGB.ECABTCCA.BBBDeCEAhAAADAIBZEAA.QEEAhACASCEH.cCGAhAFAAEHAbGFA...aDFD.JEHF.....hAEA......hAFA...,2,-25,-3,22
cXVfgKAGCTEFSQdRWaNBZbOUJIHeYPMLD,GAAAEAAAFACD.dADARAEA.aAFAZCDE..UBGBHCGB.eEABMBFBLECAhAAADDDB..XDGDhAAAfFGEAEEBTGEAhACASAHB.NIDB.bDBD...IHHAhAIA....hBAA...,2,-23,-5,18
SXWPcVZOIECAbJFRgBQMUKYdGNLTHafDe,FAAARAAAQADCMADA.KAFCGAGA.TBCAHBFCaCCC.eDEFhAAAXBEB.PDEBhAIAZFFAEDGB.AAIB.bDFDhBAABHHDdFHA..NIBB.DDIB......hABA......hCAA...,1,-5,-13,8
IfQMSXBVFdHJcOZACgKDGTNPUEebaWRYL,KAAAGAAA..TADAPADA..EAFEeAGF..aAHDRCDBLCHBhAAAQCAAMDCBhACABCDDdEGCHCFAOFCDhAIAAACADEEB.bFCDIHHAXFED.FGGA..hAAA......hAHA...,2,-15,-3,12
RSFWBcKfaAZbUDOHgIdXGVPETNYLJCQMe,ZAAADAAAHABCdAEAGAGAEAEE...TCAALAGBQDDAhABARCCAFDHDBEEAKDFBAACAOEGHhAIAXEBDVFCB..PEHDhAGA...NIABCGGD......hAIA......hBEA...,1,-8,-19,11
YTZMDUbFVXBKLIWeREQaPOdNfcgSHAJCG,GAAAZAAAMACADADAFAFDBAFA.LAHBeAHBECCBQCDAhAAA.aCGBdDFA.fDHEhABASDBHHEBAhAIAAEHACFDATFFAbFEAKHCAWBEDOFHD...NHBB.hACA......hBAA...,2,-19,-3,16
PZRFUKVJQIWLTXCSGeBMfgEcNdDbYOHaA,RAAAKAAAQADCLACBCAEAGAFA.eAHBMAGB..ECCBdAHADDFBhAAAOCEBHDGBAEEBZDFEFFAAhABAUEAAIHHA.hAAA.TFGA.BFCB.fGFEhAEANIAB.aHBA...hAFA...,1,-3,-17,14
PAIBMOdDaSHgKNfRFEQVUCGWeLbJTXcYZ,MAAAdAAAaADAHACC.KAFCRAFFFBDB..EAHFQDECCBBDGCDBeCHHhBAALAHB.TEGAhACAXDCC.ZFFAACCBOHCAhBAASGCAfGGE...hCAA......hCDA...,1,-11,-15,4
VPJTFOeHSZcMEXDUKbgYBaIfRNLGQdAWC,CAAAVAAA..TACAeADEHAGBZAEB.EBDFDAHB.KCAA..bCEDBCGDhAAA.aCHDREGFGGABhAAAAAIB..JDDFSEDDhAGAMEAB.XGEDgFEH.fGBAhACA..hAEA...,2,-42,7,49
dBMaONScRbJHIgeFCXGTAfYULZQWKDEVP,UAAAZAAAQAEADADA.EAGAdAGA.aBDASBHH.RCAAHDEAhABAeBHHXCBAhAIAAACALEAAKCEDBEHAMDGBhBAAOFGB.cGDAbFEDJEHBFHCC.CHHA.TGBAhBCA....hBGA...,2,-26,9,35
JKHefZMgELbFIVUDRPXcdCWSGNTaYOQAB,KAAAHAAAeACEZADBEAFALAFBFAHD..UCABRBCB..XCGDhAAAdCFASDGHGECBaAHFhBHAQFDAACEABFGAMFIBhCAAgFGA........hAAA......hACA...,1,-12,-17,5
HUaORBLcKQeZSbXTJAVMNFdfPgEGDWIYC,MAAAdAAA....fADAEADAGAFADAFAIAHAHBEAaAGERBBBLDEBhBAAKCBA.eCHFhBBAbDAC.TECAACIBFDFD.hACAgGFACDHDBEDAZFGBSFBD.hADA......hBAA...,1,6,-17,23
BVEYFbRCLNIGgaDdTcMePWXOQZAHJfKSU,HAAAKAAABACBEADEFAFARADF.LCAAGAFADAIBdCEAMAIB.eCGBhAAAXDDAZEDA.AAHB.SEHHhACAUFAA.bGEChCCACCCD...IHCAaDGDTGGA...hCHA......hDEA...,1,4,-34,38
JFgYAKBaMITWdbORXQCceDESPGfLUNHVZ,aAAAMAAA...TADAdADARAFAQCED.eBBBEAFEGBBAhAHALCHBHCGBZFAAFEFHhAFAAAIBBDEAIGHAhAGAbEDCCFHASGCAfHDF.NICBgGGGhBAA.....hAIA...,2,-10,2,12
FRgYeWNTJLKOcDZfQVdbHCEAaIPSMGBUX,aAAASAAAGACABAEAFADA..RAFFeAHHTAGALCCB.hAEAOCEBZCEBQDGAhAGAdEGAHFEBAAAAMBBB.hAHAXFGCYDBDNIABKGDADDIB.....hBDA......hCAA...,1,-6,-10,4
YHTVbUIcaGgZRCOEDfAXNQBSLJWePKFdM,QAAALAAAeADHFACEdAFAHAFA.TCAAUDCA..aAHBZCEERDGB.hAAAEDHFABIB.BEFA.SFAAhABAPFBBMFFBhBFAbFCDIGGA..gGGAhCAADFEBfHAF...hCDA...,2,-20,5,25
dHUMRgBZWXPGKfAJaYQVNSDLIOTFEecCb,aAAAQAAA.SACALADATBGAEAFA.eBBBbBEAHDAAhAAARDCFZEAF..XEFAhAEAGDDAAAIBJFEFVFGBhADADDIBFGGHdDGDMFABBAHB..WFAD...hAFA......hCAA...,2,-3,7,10
WQDcdBeTgNJKUbCXfYZGOLHFMIaAEVRPS,RAAASAAAQADCdADABAFB..eAFATBGAJBHB..KCCDCAHB.hAAA..XDEAhAAAZCCAGDFAHFAAMDIBAAFAEEDBhABAPFCBDEIB.NEEA.bFGD.OFFBFHGE..hBDA......hCAA...,1,-3,-11,8
URNEFfabMLOCTXBcYeZQDVdWGKHPISJgA,RAAAEAAAFADA..aACDMAGBLAEA.CBHABCBDeAHBZCCA.QDGDhAAAdCEAGDFAHECAhABASDDDACEAUGGA.bFABhAAAOHCA..TGCA.YFHBhAFADIAA.KHEA...hAIA...,2,-11,-1,10
CfaecbHYdLJgXRWVPQNFSGUTAEMKIZDOB,EAAAMAAAZACBBADA..aAEDeAEHHAGBdAGALCBD.XDEAhAAARBBBPCHDFDHDGDEAhAIAAAGBDEDB.CGBA..fGDAhBAAbFDDJFFF.gGGA...hAIA......hBCA...,1,-8,-15,7
WHJLVFMRABYNSUIDadTZGeXCKfOcPgEbQ,BAAASAAADACAdAFAGACA..eAHBKAEAOAGD..hAAAgBCAECEFQDFDhABAHCGBLDBAhAAAMAIBAEAAUFGBaDFBZFBAfGAAbGFA...hAIA......hBCA...,2,-20,-8,12
EQIZKRefDAWOaJXNVCHTYFSBUbgLcGPdM,aAAAXAAA..CADAHAEBFADABAGAUBGALCDAGCCAdDAAEBHFZDBAhAAAREFADAGA..ADIBOEGBhABAJFEF...TFCAhAGASGHB..bFED....hAIA......hBDA...,1,-19,-20,1
EGBWQAgJKfePFcHYOILXRDUMbTSaVNdCZ,KAAAeAAAFACAHADA.OAFALAFARCCBMBIBSCCA..hAAAaCEEdCFAEDGFGDGAhAGAQFCBACCAJEEF.fFFEhAAA.PFHBIHAA.DCIB.hABA......hCAA...,2,-30,-7,23
RaDLGcUBMHYFgVTSCKedXQIOEZfJWNAbP,RAAAaAAAGADABADAHAEBFAFA....TCFAKAGAeBBB.dCHAQDAAhAAAEDABZDCBJEEAAAIBbEFAhABALHDA..hADAMDDB.gFEGCFHAXGACfHCBhADA....hBFA...,2,-14,-6,8
BHbWAfEISFcPKULgRYXTNVGDMZOdQCeJa,EAAAFAAAKADALADA.RAGF.TAGAGCBAZCCAdDDA.eCHHBCFBHFABhAAAAAFA.SEGDhAEAUECA.XFDAhAFADCIBMDABCGHA.aDHH.....bEFD...hAIA......hBCA...,1,5,-33,38
ZGHBPQAbaEVYUcFXedgWLRTfIMJSOKNDC,EAAAUAAAFACDeADA.dAHALAEA.RCDA.TCDAMAIBOCGDhAAADBGBGDAAHECAQDGAhADAAAFAaEHD.VFCAhAEAXFEA.fGCESFFBCHHA.BDCDhBAA.....hCAA...,2,-16,-5,11
YSXeaQTDOEFcVdAPLWMBJHNfIKGURbCgZ,LAAAMAAAHACC..fAEAGAFARCCBCAHAZAFB..XDGDhAFAeAHFaCAATFDAEDCAFDHDhABAdGGAAEAABEEAIHAAhAHAbFCC....SGEAOBBB...hBAA......hCAA...,2,-7,-3,4
TENYcRICgUHaGWQbMDFedBLfVZJXPSOKA,EAAA..NAAA.RACACAFBHAFA.GBBAQBGAMBEBFCGDeCCAdFAALDABhAAAZEFA.XDEAhADAOFCCABBB.TGGAhABAIEHAaHAEDIDAfFDA.PFFBhAHA.KHGA...hACA...,1,-4,-7,3
TDgeWUKINdGSbMHFLZOVBcQYaCXEfPARJ,RAAATAAAeADE..KAGCdACAGBDAMAEAHBDBZCFBBCCCQBFAhAAA.aAHDECHFADIBDEFAUGGAhAAASFBALFCB.hABAOFFA.cGGCCEHA.....hBIA......hCAA...,2,-15,-2,13
TfHRUDKVASbJFIWBaCcPMOeZdNQYGELXg,SAAAFAAABADA.CADA.MAFAZAEB..dAHAQBEAGCCAECGBLBHBhADA.TCCAhBAAHDABREFBKEEAAAAAbGBAIFHAhCAAaFHD...OGCA.eHCG.hADAXGGC..hCBA...,1,-2,-24,22
ZYbNVUCTSDXEdcagHBOGKfAQMFLIWePRJ,MAAALAAA.eADHRACAZAFB....bAEDUCCB.TDGAhAFAXAGAEAHF.aCAAHFCAhBAAGCGAABBBQFFChCAAFEEBIGAA.WFGD.....YGCAhABACHHADICA...hCFA...,2,-10,-6,4
FYZWHRBaTfJEMcLCUOePNSGbIVKDXdQAg,FAAAZAAAHAEARACFBAEBaAGA....JAGBECAA.MCEBLCEB.hABAUEGAeCFA.SDAAhACAGGAB.bDFAKGFDhAGAdFFAAAIB...gGCA.YHFGhADA.WEAA.hBAA...,2,-39,6,45
EJPXCFaDKWUgLSRITeHdVbNAGfBOMZYQc,GAAAOAAAZADBQADA.EAFAXAFAaAHD.KBBDgCDGhAAARCEF.eCGBhACAHDBBbEFDAAIBMCIB.hADAcEFDCHBADDIB.LGAASHGAdGHAfGEEhAGA..hBAA...,1,8,-18,26
bUTQLNGXYVCfEcDIgMOaWSRKdAeFHPJZB,HAAAZAAABADBTAEALAFAGAGA.XCAACCAA..ECCBDACAhAAAMCEAaDCDREDF.AAIBeDHHhAGAFCHDJDFBQGFChCAA..VGAA.fEDA.hCDAgGGA.hCEA...,1,6,-28,34
WUOAQNTPEGSHLXgeFJdcMbBRKVaCIfYZD,TAAAEAAAHACA.LAFBeACEdAFAMAHBRBGFKBDDaCCC...fDHAhAAAZDEFDCCBODHDhAAAAAIBQEAA.GECBhAEAXGECFFHDcGEBBAHBCHGA....hCAA......hCBA...,2,-18,3,21
GcQEVRTHYadADbLOeWCXKFfZISJgUPBNM,LAAAeAAACADA.FAEAZAEB..SAGHUBGABCCAGBDA.hAAAECAARECAHEGBdDGAAAIBODCBhABAKGCD..fGEAhABAgFFGMIFAcGEC....hACA......hCAA...,1,-20,-24,4
KaNQMGEYCPFeBAVcDOgXHULISbJRTdfWZ,DAAAXAAAHABCLAEB..bACDRAGBdDGDZAEAKCECaCCHMEEBhAGAECHF..CAHB.FFFAAAAAODFDhAFA..gGCDhAIASEEDfGHAQGAA.PEHDhAGA.BHHD.hBAA...,2,-22,-10,12
JKLYgASeZFEPacHbfGBWDXCOVUdRQNMIT,eAAAEAAA..aACDHADAGAEADAFAOAHD.dCCARAGBMCBB.hAAATEDALCFBAAEBZFGBhAAAFDHH.bEDDBDDCCGGA.hABAQGAAIHBA.KDGD.....hBHA......hCAA...,2,-16,-4,12
PdGcHSVBAWXYgIOKeURTNabFEJQCfLDZM,XAAA..gAAAKADARAFF.aADAEBHF..QAGAhAAALCDBZDABdBDAHCEBhABABDHAAAAAIDHAhAGAeEGBTFEAbFGBCCCCMGCAPHAA.SGHHhADAWGDA.....hBIA...,1,-7,-14,7
SVUIedaNTMEKbcDWGQCgYPHLXZfBRFAOJ,SAAAUAAAeADAdAHA..aACDMBGBEAEAKAGADCDA..GDAAhADAQCDACDDA.gCGAhAAAHDGBZFDABHBAhAEAACGAOEAAIHHATFDA.bFFB...YFHBhABA...hBAA...,1,-3,-15,12
cSXTKMIBdLZNeQgPWDRGfOCFAVHabEJYU,HAAAEAAAUADAXADB.MAGBdAGAZCBAeAHBQDFA.hAAA.gCAAhACADAIBRFBAODHFABFBbCGD.cDCBhAIATGGABDFD.PEEBWFFD.CGGA...hCAA......hCDA...,1,-3,-19,16
AbVaLQTMJNDHCSXcBZIReYKOEfWdPgGFU,aAAATAAA..MADADACAHADC.XAGBZAEERBCBeAHH.OBBHhBAAECCAdCGDGCEAhCAAADEAbEEA.LEHB.hAAAQGCACGEABGGD.KGFB.....hBIA......hCAA...,1,1,-21,22
ZaMPABcNJQGLFHRegKTbSYEfUdXVIDCWO,BAAAJAAAGADAHACARAFF.eAHHKAFA...TCAASAHB.hAAAECCBdDDA.XDGAhACADCGBOCHBaEACAECAQDAChADALFFBFFHHbFAAUFEACHAA...MEIBhAFA.....hAEA...,1,-5,-8,3
MeSFJZGWgABDLRYPXHVaEfCNKOUcdQbIT,LAAARAAA.XADDHADBEAFA.CAHAOCCBdAFBQBGBhABA.TCAAeCGBFDABhAAAGDDAACHADDFBPDGBhACAaEEHKFAAcFGDMDIBZGEE......hABA......hADA...,1,1,-11,12
BdOHEcJaVDfNUXTSbIgFCRZQYLPeKMAGW,GAAAdAAAHADAEADAaAFADAGA..UCDB..TBFASAHHhACAbCDD.FCBDRDGB.ZDFBLDCDhAAAeDADADIBBEEDODAHhACAVGCAXFEA.CBHB.PHFCMIDA..hADA......hBAA...,1,5,-4,9
LCZbPFJfIeVEaKSMBRgDNWTcdHAUYOQGX,OAAAGAAALADAZADBFAFD.JAHB.eCDAEAHBKBBDBDCD.RDFB.DCHBhAIA....TFAAhAAAHDBAADFA.QEFChBAACDHAfEEEaEHDMIDA..WFHH.hBDAdHAD.....hCAA...,2,-22,-10,12
FZMKBcOHIYbgWCJaESPXdfReUTLQAVNGD,GAAAZAAAMACABADAHAEC..IAFA..bCCACAHAECDAXCGAhABARCFA.eECBTEEAhAAAAAHADEEBKDCDOEHBhBIA.gGEAaDAHdEHALHAA..hACA......hADA...,2,-17,-2,15
bHcNMIYACaLfSdTJQgZPGUDVEBeFKXWRO,aAAALAAA.dAEATADAQAGAZAFBGCCADCAABCDDKAHBRCGFHCFAhABA.MEBAABBBSDABhADAJEFFUGAAEEHBeEFBhAFAFHGEOEHD........hBAA......hCAA...,2,-14,-6,8
afGFDEdeUWZRVLXgKMTHPSICQYNcJOBAb,aAAAGAAA.EADAeACHZAFBRCDBLAEA.KBHBHCGB.SBHBhAAAQCEAcFBAhACABDDDAAFA.bDGDDDABdFFChAIAVFFBMBBB.IGDACDCDNIAB.OECBhBAA......hCAA...,2,-15,6,21
PQUVfGZMBDeRFXSAaKJTWYEHdNLICgOcb,aAAATAAA..EADAHACBdAGALBFDCAEA.OBBBbAFDQEAAhAAAUDCAGDGAZDEAMAIBhACAeDADRGDASEHHhAEAAAIB.KFCC.YFFB.IHAAhAHA....hBHA...,2,-7,-5,2
HXISCYdGbQLgWNVePMRTAODJEUcFZBfKa,DAAAEAAAFACDZABEKAFA..HAEA.SAGEdAHAGCCALCEAhAAA.gDDGhAEAVCFBeDABREGBACIBODHDhADAcGCAaFAH..CGEB.QGGC.WFCDhAFAMIFA....hCAA...,2,-14,-9,5
NgQDbGSBAeWEIXUPZdHTVCYFfaROKcLMJ,EAAAXAAAZACBHAEA.CAHB.FADA.RAFFKBDDMCBB...JCEFQDEChAAAGCGAACGBeFGDhAAAICHAdGAA...TEGAhABA...fGGE.aHAAhAHA......hAIA...,1,-13,-33,20
CIYRWSbFUZNEfOJLePQDgKBaHVdATcMXG,MAAAGAAA.CADARAEFSACA.FAFAZAGB.ECDBOAHDeCHHQFEAhAAAKBBDHBEBACDATDGAhBAAXGAAIFFAhCAA..YDAFbGCC.fGGBhACAPDDBBGHA.aHGChCGA...,2,-17,-5,12
HSBJFaZfWVeCDMQPLAGUYENXdOTRKgbIc,GAAAEAAAdADA.RADAKAGC..IAFAHCDCBBHAFAHBZCBA..fDCEhAAAeCFBMCIBLDHBhACAADHBUFFBXGCAhAAATEFAbGCA.SDADaGHD.CHHADEEBhADA......hAEA...,1,-7,-13,6
GdBKcDTNJCLFWOPaeEHfbXRgMQSAZIVUY,ZAAAUAAAdAEAKADADAGA....TAGACBGALCABFCDA..OCFDhADAeBHHHDDA.XEBDhABAREGFMDDBAAFAVFFAhACABCHA.JEEF.aGHDEGDF......hADA......hBEA...,1,-17,-27,10
FWGQZBDSdbfeKJacLMgPRTAHVIUNOXCYE,HAAAUAAAOADACADBFAFAGBDBZAGB..DBDBdCAD.eBHHKBED.aDDBMBIBhBAA..REEAAEEA..hAAAIEEAXGDCEEGBhBCAQGGABFDDSFHH.bGBC.hACA....fHEFhBGA,1,-12,-29,17
KVObRFWJHLBDcYAPXTgdZINMeSGEafQCU,TAAAZAAAMACA.GAEBEACE..QAECKCCDOCFBRAGFFCCBHCGBhABALDEBDDEB.ACIBXDGChAAAdFGDeECFaHAChAHACFHAbGAABHHA..PHFA....hAGA......hAIA...,1,-4,-7,3
UCbJaOMSDWYLIXEVHBPFNKQcAZTGRgfde,GAAARAAAdADAUAFACADA..aAED..MAIBDAGALBGB.ECDBhAAAHDDABCFAFDHHQFEAhACAAAAAZFBATFFAeDADhADAOCCBSDHHIHBAXGGB.hBFANIBB......hBHA...,1,-4,-21,17
RSMfCaXWDOHeKVGPFZIbNUQgcTEYdJLBA,RAAAMAAACADB...aACEDAFAHAEBKAHB.GBGAZBDE...ICCAhAGAUDEA.QEDAhAHA.TGBAECHBdEGAhAAALFFBACCBXFBAeEHHFGHDNBBA....hABA......hBFA...,2,-37,15,52
DNYeWIOfZQUKJTGMFXAcSagdERCVBHLbP,aAAAEAAARACABADA.HAEBLAFB.DAHBeAGBOBHDZCCFQDAAhADAKCCDGDAAMDEBhAAAAAHASCHH.dEEAhBAAbECDPFHB.WGDAfFFA.hBBAJHFE.....hBIA...,2,-14,-8,6
FMRPZLcBKbSNWfCQUJGOgdDeHaTXEIYVA,RAAAZAAALADBKADC..SAFA..fAFAhAAAQCAAGAGAdCFAHCDDhABAaCCBEDEAICHAAAIBMDIBhABABEGAbEFD.CFFDOEHDeFAA.TGAA.hAFA......hCAA...,1,-12,-13,1
ROPBFECSIKTJaVfdNQXDAcGWgYZbeHMLU,GAAA..gAAAbADA.HADAMAHBRAGFBCCAECDASCHHhAAATCEA.aDAHdDAAhAAAQDEAACIB.hABAcDCCZEEAeFAALFHBOFHDCGEAKGGDfGEAhADADIAA.WGAAhAFA...,1,9,-16,25
aGIXZFHVdNgAKTMCeELBQSWOYbPRDUfJc,MAAAEAAALADABADA.QBGAOAED....bAGBRCBAfCFEhAAAaBBB.GEAAhAEAZCCFHCFBdEEAAAHATFGAhBAAeEHBSGFAPGBADBIB....hAFA......hBCA...,2,-10,-3,7
CIUOKHEZLNScRfXbWPFeVQATDGMdagBYJ,GAAAaAAABADACADAUAFAHAEBZAGB..LBHBSBBDRCDB..hADAXDFB..hAAAbCCDFDCHeCHHADABMFBBhACAdEEAgGAA.IGGAEFFBfFHAhADAWFHH...hAGA...,1,-15,-20,5
ENLVUQaRCXYKdgZcGOIMABDTPWHfbJeSF,TAAAHAAAJADA.FAGAEACE.LAEBUCAB.RAGB.CCFA.KCCBZCGBGCFAhAAA.MDIBADDADDIBfECEhAGA.eEEBhAIASECANIBB.aFEDdHGB..gGGAhAAA...hBIA...,1,4,-34,38
KbDQgRMITeSEBdfAHWVOYNJXCUcPGaLFZ,HAAAOAAAJADAUAEAGAGALAHBZCAADCCARBCB....MBBBeCEFhAAAEDFBdEGD.AAIB.VEBBhBAAXFED.CGAA.aEEHhBEAKGGCQGGA.IEHABGDC.hACAfHCFNIDB.hAGA...,2,-12,-4,8
ZHfdYCPQILNeVGXMbUgRaWJSAFEDTKBOc,EAAATAAABACA.ZADBHACB.dAEBCAFA.QBFBLAHBeBGFhAAAGDEA.bDGDRDEBaCCBSAHBhAAA.ACABDDIBhACAOEGDYEDFIFCA.NEIA....hDBA......hDCA...,2,-20,0,20
DJBZLFHTbAKWUaePfCgGYIRQSVEcONdMX,KAAAaAAA.eACE..CADAGAEARAFF.QAGAEBCFOAHDdCCAMCEBhAAADBBBZDFBHDFCADABUGAAhADA..fFAAhAFAIEHA.SFDANEEABGHA.TGFAhAHA......hCAA...,2,-16,-15,1
YHCMQFDRSPcONAJBfIXdKTVbGZeaEULWg,BAAAXAAAdACAKAEA..TADAGAGAeAFEECBB.LCDAhAAA..gDDAhAAAHCGBMDABQEAChAEAREEBSFCBODGHACIBfGBAbFCAaEHD..hABA......hADA...,2,-10,-10,0
PYeRUAcJSgCKLHQFZfaVTdEMNBXbGIWOD,SAAAKAAAHACBZAEA..aACDdCAA.ECEAMAEABAHBGBDA.hAAAOAHDDCIBeDEAAAAAgBFDhBHALFAAQEGDhACAfEGATGEA.NEIA.IHGAhAFA....hAGA...,1,-9,-19,10
RZPUIBaYXcDSNKbfQFVMEOLJeTgCAdWGH,GAAAHAAARADFZAFBUADABAHA..aAFEXCAASAHH.KCFAhAAAQDGAFDDB.hACAEDDBLEFAeFAATFEAhAAAAEGAdGAAIGGADGHBfHCBMIDAODBDhAGA....hBAA...,2,-13,-2,11
gAJNTWKHSRXEcMZBfCdaOeLPDFGbVUIQY,TAAAHAAARADFEAFE.ZBFECACBdAEA..eCABLAGBFCCHGDFAhAAAbCCC..UEBBIDHAhACAQEEAAAHAJFEFKHGAhADAXEGA.MAIB.aGBD.DGHB..hAAA......hBEA...,2,-14,4,18
fKUdTOZGIJacWgHVCNeABFYERQXLbDMSP,FAAARAAALADBMADA...SAFAKAGAdBDAZBFAGCEA.aAHDhAAA..gDCGhAIAHDGBCCCCAAFAEGCAQDGChBAADGGB.fFEA.TGGAIHHAhABA.....hCAA...,2,-30,-7,23
UXTVROQWYPECMHFaJLNdKIbZfgAeSGcDB,eAAAGAAABADAUADA..TAFARAFAQCGA..PBHDhAAAEDDAHDBBaCCALDDAhABAdEFAbGAA.ZFAAAAABDFHBhACAOEFE.CFDBMIAA.FGGA....hAFA......hAHA...,2,-12,0,12
AFPDCaMBdQKEfOTSZNIgcGRVJWXbYeULH,DAAAaAAABADAdADAKAFA..EAFA..OAHDZBBA....gBFAhADARBBBVCFB.XDDChAFAeDBDHEDB.AEDBCFADhAFAMAIB.TDGASFHBIFFAcGGChAHAWFHH....hBAA...,1,-20,-35,15
OeHLZYWfIVDQRTcFNgPdSMKJUEBACXabG,aAAAGAAAHACBZADA....fAEBDAEARBGFTCDAFAGAgCEAhBAAdEFAKDCD.ECHBAAABCAHBhACAOBBHLFHBIEGAhBEAQFCA..PFCAMIDA.BFHAhCAA.XGGChCFA...,2,-9,-8,1
TWABdcYRCbZFeJNXQUDKHMfOLPaSGIVEg,dAAARAAAZADBeADA..XAFAQAGAKCFA.HCAC.MCFBLCCDhAAAaCGCGEAAEDABTEEAhABAADEBBECA.CEGAbGEAhACAFDHDUGAADEIB.OGEE.SHGAhADA.....hADA...,2,-4,-3,1
PSVCNXFQRdWIOfEMYGTDHLZbBcUaeKgJA,SAAACAAAFACA.RACF.dAFA.OAHBEAEEGAGAHCBAZDEBBCEAUFBAhAAAeDFF.KECAACIB.PEHDhAAA..XGEAhAIAQGAA.fGFAMEIB..hABA......hAGA...,1,-16,-26,10
SKEPeGQFCBdOcYaWgDRNLMZVfTIHbAXUJ,XAAASAAAKADAEADA..GAFAFAFDdAHAOAHF.aCDBDCCAhAAALDABZDAATDGAhABAHDGBADDAUFEAeEDFQFEDhAAABGDC.YHAAgGGBMIEAhABAfHBB.hADA...,1,1,-16,17
XgdafSBIOQCFLVDNRJHWKUZTAceGbYEPM,eAAAGAAAEADAMADAdAGA...aAFEBBEAQCDALCCBDAIBRDGBHEDBhAAAKCFAZEBBAAIBbFFDXDGAhAAA..SGBBhABACFFAFFHHJHCE.........hACA......hBAA...,1,-8,-11,3
COeSJGIAgYHDUKcQZLbRPdfEFaXTNVMBW,HAAAKAAAZACBRADFdAFAFAED...aAHB..TAGAMBIBBCAD.OCCBhAAAeCABGCEBhAAA.AEEADEHBQDEAhACAbFFD.EEGE.XGGAVGAASFHHhACAIHDA.....hADA...,2,-17,-11,6
aeKYHANGCVIZFEUSgMRPdLfTDcQXJBObW,GAAACAAAZACA.EADAUAGAMAGB..RCCALDABTCDA..QDGAhAAABDFA.bFBAeDGHhAAAHFFAAAEA..VGBAhADASAHB.dHBBDEEB.JFHBaDAH.KDCDhACA.IHHA.hBGA...,1,20,-27,47
cdEPMKgNLfGJFReUTVOQbAZWCXBIDHYSa,ZAAAXAAADACAHAEA..aADAEBHF.MCCBKAGALBDBGDDARFGBUDGBhABATCFA.QEFBhAAAAAGABGCA.SCHBhABA.dDCCNIAB.FFHD.eGAA..hAGA......hAIA...,2,-11,-10,1
QHSRXfaPcABdCNUZFTMWEJILYKegOVGDb,dAAACAAAZACAMADA..EAFELAHB.eBDAOAHDGCABQCCAhAAAHCFBREBAaEHDAADABCFAhAHAFFFH.JDGBKHBADEFBSHFAhACA..fFHA.hBAANIEB......hBCA...,1,0,-34,34
ZYWCBaAfPKMUgbEGTSQecdVJIFXOLNRHD,KAAAMAAAUACA..EADAGAEBQAFAeCEF.dBBA..ICHAhAAAOAHFRCEB.HDCBhBAAZEGBCDFAADHBfEHAhCAA.bGDATFAA.SFFFhAFA......hAHA...,2,-32,2,34
QDARaKPZVdYNeHXBLbSOJFTcMfWUgGICE,RAAAaAAAZADB.dAGAeACHHCEBLAEA.OAHDTDAA.MAIBhAAAfCEAUFGAGFBBhABAECGBAAFAKECA.PEGBhBAAYHEABFEA.SFHH..hBBA......hCAA...,1,-3,-21,18
SXZgaLNJAPMUIcWHGVTBKeQFbdDEfYCRO,MAAAUAAA....IADAHACCGAFABAFA.eAHBFAHBdCDAEBBBCDCAhAFA.RDGFOEDDZCEBaCGE.hAFAJFFF.ADFB...PEGBhBAA.....WEHB...hAIA......hBAA...,1,-12,-35,23
LQXBYGgEcMIRJfUAaTFNKCZSOdePWbVHD,aAAATAAA..KADAZACBdAFAeAEA....bAGDHBFCLCCBhADAQDEABCEDGEEAhAIAECABMDIBIEHAhBAARECBfFAAABBBCGHASHGGOFGD...hAAA......hACA...,2,-16,-4,12
NAGcObHBfSVeDRJFTKZQPYaLgIXWdMUEC,GAAAOAAAHADASADAeAFERCCBFAGAZCEBQBFD.aCDBhAAALCHB.XFGChAIAdDGDEEABAADABBBDhBAADEEBTFFAKGDA.YFHBIDGAMICAhACACHHA......hBAA...,2,-10,-6,4
UQXPKfcMLEBVFCWDbgYRTZGHSIANeaOJd,eAAAaAAA.dAEAQADAKAGA.MAGBEBCAFCFDDAHB....bCCChADARDDBGDGAHDFCAAIBOEEBhBAAXGAA..fFBAhBBA.LGFA...hAAA......hABA...,2,-31,1,32
JWINASUdgcQRfHCFMbGBTVeXaDKPZEOLY,dAAAQAAAHADAMAFAGACBBBGAeAFEDBIBZABBECDBLCFAhAAA.JDAAIDDAhBAAACGASEFAUDFARFCAFFEHTGGAhCDAaGGA...KHEA......hCFA......hDAA...,2,-15,-1,14
PWgfHVDSaCUARMFJTOKLceEGZBIQbXNYd,RAAAMAAAFADA...TADALAGB.EBFFZAFBBCCAQBBChAFA.bBGDXDEChAAA.dECAgDDBhAIAHEGBSFFDaFCBABIBKFGA.cGFC..hBAA......hCAA...,2,-22,-13,9
CeMgafIBGdAFXLVOYKJQcbREHUZTSPNDW,LAAAOAAAKADAQAEA.RAGBHCAAZAFBTCCA.SAHHhAFADCCAeDEBaDFFhABABBBDAAIBXEAAhACAVDGBJECF.EDHFUGGB.PEEBCFHAfGGEhAEA..IHBAhBAA...,1,5,-23,28
FGDCObSVKeLaBPgdQNMcRETYJUZfAHIWX,HAAAXAAAGADADADA.OAFA.SBFBeAEAaAHDBBDDhAAAdCADMBIBECEA..TDFAhABAUDFBADDBFDDHbGFALDHBhBHAPHCC...gGGG..hCAA......hCBA...,1,2,-20,22
WBZIVPXUSeHDFbgcYJCMEfOGaQdLKTNRA,ZAAAVAAAUAEA.HAGDFADA.....bCABgAFH.hABAJBHBEDDA.GDFAhACAdCDATEFAACIBBEHBXFDChAAAeEBHDDAB.CFEDMIAAaEHD.KHGANIABIHHAhAIA....hCAA...,1,1,-26,27
RPYLAGHZMQUDTFcCIgBKEedfWaXNObSVJ,HAAAZAAAMACAQADCDAGA.TAGACBEABBGAECAB.dCFA.aCCCOBHDhABA..bDGDSCCDhBEARFAALFDBADDAGDFAhBGAFGFHIHHAeEED..fHGFhCAA...WFDDhCBA...,1,21,-38,59
dVNHRSJMfaDFWZYEGeLBbOgcCPTQUKXAI,dAAAHAAARADA.MACADAGAZABBEAFAGBDA.eAHFLBHBBCCCOCFDhAAACCEA.QFCChCAAXDCDACGAIEHAhCFA.SFFDaDGBFEAB..bEEDgGGBhCIA..cGGAhAEA.,2,-39,16,55
AQbCFWgSDXVfeMadTIRUOYJLGcBZHNKPE,QAAAFAAA.SACAXACDeAEAdAFARBGF.OAHDLCDBhAAAGCDBZDABHFBBhADAKEAAAAEACEEDDDIB.MEGBaEGAUGCAhBAAYFEBBFGAEHGAbGFA.....hAHA......hAIA...,1,3,-10,13
JDLQKVHOcGeTAfBbWCRZINaXUFESYMgPd,BAAACAAARACA.ZACA..aAFAFAFA.EBHF..MAIBdCCALDABhAAAKBFAHCAAGDEAACGB..hAAAbCDDIDGA.hADAXECBSDGAgGGADFGAQGGAhAEAcEGD....hAIA...,2,-26,-14,12
fKIPgOFSTRGZbeCdAMUWYHBXaNVcEDQLJ,MAAAUAAAHADABADA.aAFA..VAFADAIBLCDAKBBA..ICEAhAFAOCGDTDAAhADARDEAZFGB..eDDDADIBXEEChBAAEGFF.QGGA.fFCAhBCA...hAIA...,2,-30,-7,23
QGCcgPIEHadNDAXJRfSBZOMWLUTKVbeFY,RAAABAAAZADB.MACALAGBKAFA.eBFFFBCAGCDBCCCC....hAAAgDABEDHFHEFBdAHAhCAAAAAA.XGCAhCBASCHHOCCHTEFAYFHBPFHD.aEEHhADA.DIAA....hAIA...,2,-18,-5,13
OcdQFUMCLAfXPHDBeaGNZEVYWIgSJTKRb,XAAAHAAAeACEGADAEAFE...VAFAICCA.SAHBhAAATDAARDEFbDGBdCEAQCGChCAA.hAAAMEDBAADBDDDBaEGEZFAAgFFGOFHDFGFD.hDAA......hDBA...,1,7,-8,15
IHObZQTEgfKaXBJPDWYReSMcCAUGVdNFL,GAAAdAAALADAHADAZAGBEAHB.KCDDBCBADBIBREEAeCEA..MDABhAAAAAEAUECAFFCB..OEHDhACAbEFA....TGEAhACAaCEDXGAD.PHEASGGBhAIA.CDHC....hADA...,1,-5,-15,10
SOLNFAUKQYCEJfITMWdeHPGRacVBZbXgD,QAAAEAAA.JACETACA.dAEAHAFARAGB.aCDABCCDZCGBXDDChAAASCEALFFAhAHAAAIBKDHBCEEAMEGBhAAAeGDG.GGAB.bFGDDIAA.NIDB....hAGA......hCAA...,1,0,-16,16
GIeDUSTECQHNLPWKZBOXcYfagRdFJVbMA,eAAASAAAEADAHAFALADAKCCA.ZAGBXCED..fCCAhAAARCGBdECAFFFBJHAAhAAAbDECAAEADFIBUFDB.TGGAhABACHGA...NBIABCFC....hCAA......hCBA...,1,-9,-17,8
AHNOdDLXIEFPZaUfCYgbeBJcGKMTWVQSR,HAAAdAAALADAEADEZAFBUCABCAHA....bABDeAHF.BDDAhAAAGCEAMCIBTCGAhAEAQEFAACEBDEIBFFAAaFAAfFEEhACAJHAAKGFASHGAOFCDIHHAhAFA....hCDA...,1,-7,-10,3
IXTSNdJaRKMCHZEYUPbVQcGDABOLfegWF,LAAAeAAAFADD.TAEAdAFARBGF...MAHBHDDAZCAAEEHF.UFBAhAAAbCFD...QGFChABAGEAAAAIBOCEBhABA.fFHAWHAG.SCHHhACA.aGGHCCCD....hAEA...,2,-10,-7,3
QDYfCLGRKbcVUITEOXgNWHPdFBSeaAMJZ,ZAAAQAAADACA.CACAGADARAEAKBHB...VAFATCDA..hABAECHFOCCH..hAFAXDED.gFAAhAAAHDFAdFFDSFHHADDBMEIBfFGAhAFAbGCCIHAANIABFGDABHHDhAIA.,2,-20,-8,12
PVCcLdSJZgAeEGYWfbHUQBaKNXTROIDFM,EAAAGAAA...fADAHACAQAFCaAED.XCCAhAAARAGBDCGBMDABCAHBdCHAZDDBADFAeEAAhAEA.bEFCKDHBTGGAhCAAFFFAcGABSGED....hCBA......hCCA...,1,2,-12,14
WVAfbYJKFLZQMBgITDSRNECUeXacOPdGH,...bAAAKAAA.ZACBMAEABAEA..TBEARAFFEBHF..UCAAeAHFhAAA.aCAAODEBGDDAhABAHFFAACIBfDGEhACAFDHDLHAAQEBAIHHASFGAhBEA.XGBChBGA.cGFC.,2,-19,16,35
fETXSGYHDRPAFWbOegNZVKaUBJcLICdQM,FAAAOAAAeACHZADBKAEABAFA.LAHBdAGAMAIB..EBBBSCEBhAEAHCEBREGBABDB...hBAA.bGCAgDDDhBAA.aDGB.cEGDCBGA...fGHAhCAA...hCAA...,2,-23,-20,3
RSGJQZgfEeWVMbUcPNAOKXIdYTCFHBDaL,XAAAdAAACADAHAEBDADARAGB..GCABZADEEAHB..eDFF.MDIBhACAbCDA.UGAA..PCHBhAAAAEEBKEGB..IHHAhADATECAaEED.SFHH.QGFAhABA..hAIA...,2,-22,-8,14
ZcFJQTegfbVEHPWOXaGMYLDKNCARdBUSI,RAAAdAAABADBSADAZAEB.FAGAQAGA.eCCBbABDHBEChADAOCFDGDCBLDHBhAAAKCHBAEAA.IFFAhAEAcEEC.JEHF.fFDEEHEAWECD...hABA......hBIA...,2,-21,-2,19
SIVKFaJfGBDHgOdRUcWeTCXZEPQbAMNLY,MAAALAAA.SADHKADAaAFA.GAFAHBBAdBGDRCAA.UDDAhAIAeAHBCDGAZFCAEDEBbDGDADIB.hBAA....IFAAhABAFGGABHFAOFBD.TFDA..hACA......hAFA...,2,-23,-6,17
fPXMANRCKVgDJWUOIBcYTEbaeSFZdLQHG,RAAAKAAADADAUACABAFA....TAEAEAHB..eBDFZAGBdDDAHCEAhAAAGEGA.XFDAhAAAACCBCDHAVEFB.JGCAOGAChAGA..IHHA....hABA......hAIA...,2,-29,-22,7
KEXCADMdNSWcYBHeQROVabITFLGPUZgJf,dAAASAAA....cADAHACBRAEAaAFAbCEA..TCBAhACAGEAAZCFBfEEAhAAAECHFAAIB.MAIBYDEDhBAAeEHFQGCD.IGFAhABALFHB.gGBAhBCA.,2,-25,17,42
QYJGEORBDAfXgdCaFKUbVcIMPSWTLHZNe,XAAAdAAAaADA.KADAUAGA....bAFBIBDA.MCCBhACASAHH.hBAATCDAHDDAeDFEhBCAQDAAGGBBRDFAAAAACFFAFGHBPFCC.LFHBhADA.YHBAhBHA.EGGF,1,3,-16,19
gcFMGBECZVSHTNIbODQXLdRWYafeKJPUA,FAAAGAAAEADA.ZADAHAFA..TCDA..bCCAQCGAhAAAdCHARDABaDFD.eAFE.KDCDhACAPFGDAEABMEFBCECBSEEDhADAOEGBXFCALHAAfHGFhAEA.....hAHA...,2,-7,5,12
BGNLbWYgcaMSPVDEQIFCKdJXeTRAUOfHZ,OAAAHAAAGADALAEA..bAFA..gBBAaCACMCGBSCHDhAAADAIBECEAQCGDhAFACFAAdFDAeFFAADDBZECAhAGABGHANEHA.cGAD......hACA......hADA...,2,-14,1,15
dZfEWBDOeCXMNJQPbSYcHgaURGILKVFAT,ZAAAEAAADADAeACE.MAFAQAFA..bBEASBCAhAAA.HCDCaCCCRDEAGDBAhAIALFDAFDGDABCAdFHABBHBhCAAXGBCPEEB.gGGA.hABA......hBGA...,2,-16,1,17
AUFeYCgOITPEMWDNbHaXJQVLZdRSGcBKf,eAAACAAA.OADCTACA..EAGEMAEADCCAHCDCaAGE..QBEDhAAAZCGBRFAAGGCBKCAAACHAhACAFGGA..IDHAhCAA.PDDB.bFEA.....hAAA......hABA...,1,-12,-13,1
aYeQDBTHKWZbUPVMXGcFgIJENdLSRfOAC,aAAAeAAABADAHADAZAEBUAGA.MCCBGAGAFDDA.JBBFdDGA.RFABAAAAQECAhADA.TEFAhAIAbFCA..XGGAhAFAgGBB.EFHFNIDB......hBAA......hBGA...,2,-20,-2,18
MBgbYPOdLaFKEZRcfAQGISDNVCJTXeHWU,GAAADAAACACA.JADA..eADHHAGBUAFAMCDBBAHA..bCEDOBBBhBAALEGB.aDBDhAAAECHFRGAA.ADEA..QEEAhBFASGDBTGDAWFHH...PHFChCAA.....hACA...,1,-10,-29,19
bMXNGVfZEWBCOYKcHDQULRSIPAJdFaTge,dAAAaAAA.eADA.MAHBGACA.ZAEAEBFFCAHBKCEAHCAC.DAIBLDHBhAFARDEA.SBBDhAGAADIBTEAA.XEEAhBAAfEDEOGCAQFGAIHFAFGFH.hCAA......hCGA...,1,-2,-20,18
HRAMeNKLPaOQfgEYSbVFCDdXcJBTUWZGI,eAAALAAAOADCQAEA.EAGAbAGBFBHDdCCA..XCAAhABABCFATEDAZDCBHEADhACAAAAAMBIBKEEAaEGAfEHEhAFASFGHDFCBcFEDJGDE...hAEA......hCAA...,2,-15,0,15
EabYQTHAeRCgGFWXNJMKLDOUBcPISZVfd,RAAAGAAAFADA...XADAMAGBLAHBOAGBBAHB..hAAAICCAZCDFdCHAEDFBhACAbCED.TFGAHECBAAAAeDADhADACEHA...NDDADIFAPGECfHDFhAEAaHBC......hBAA...,2,-14,-6,8
QGegOTIcSPJKfbDRBMEFZYVWHNXUCdaAL,GAAAeAAAOADC..TADASAFEKAFCDAIBRCCABBHAEBGFZDCAhAAAVDFAHDGB.XFCAhACAdFCAAAAALFFAhAIAQGGBIHHA.......hADA......hBAA...,1,-8,-13,5
JIHfcbREPWOSdTFGCgAKVMLDXUQaZNeBY,MAAALAAADAEA.QAEAZAEEBBBA.JAHBHCDC....bCAAhABAEBHF.ODBBdDFAGEAAhACAADIBKEEDUFGAeDHFfECEhAEARGCE.SEED.hAIACGGD......hBAA...,2,-24,1,25
QFOVUECdPYTeNbIgcGfLJZWaHSRDKXMBA,QAAAOAAAUAEAEACA..dAHA..TAEAeBBA..IDDAhBAAGAGALCDBhAAA.ZDEBHDFARGAAXGEAhAGAABGACFDAPFFBNDIA.......hAIA......hBIA...,1,-2,-27,25
KaQNJfgLXZRGTWObBPdUHSMEeDYAIcFCV,FAAAKAAAQACC..fADALAEBRAGBGAEAOCFDhAAAbAGBdECAHDAAEDHFeEEBhAGAABIBCCCDaDFD..gGGAhAIAZEGBTGBA.BEDA.....hBIA......hCAA...,1,-3,-10,7
QFXILMPgeTbYKdSWNZDfJcHaBEGUCAVRO,RAAAQAAAFADALAGBMADA..eBFFTAGAKCCA..dECASBDAhAAAZEEADAIB.fCFAhAIAHGEAaEGA.ECHF.hAAAGDBAAGIB.XEDD.gFFBhBCA.WFHB.hABA...,2,-18,2,20
PYRHgLaSFbTJADEMNQCZKVIeBXfOWdGcU,EAAAMAAA..QACAZABEKAFA.eAEAXBGAOAHD.GCDBhAAAUCCARDFAHEECLFAAhAFAaCCHbFAAAAHADFFBCEHBBGHAhAFAdGGA...YHBAFGDD.....hBAA......hCAA...,1,19,-19,38
fVCaFTLNgPMOGRJYZIKWSbecEBdXAUHQD,HAAAQAAADACACAEA.aACELAGB..gAEHMAIBRCCAZEEAhAAAKAHB.SCDDhAAAeFCBEGBBdGEAACGAVDABFGGH.hBGATDFA.ODHD.GFDB.hCAAIHAAWEHB.BHDAhADA..,2,-10,8,18
YAPEZaRbULWJCVgedDcMHKIfQSBTFGNOX,EAAARAAALADB.CAFA.eACA.dAGAMAHBHBEBKCFBQCCAhAAA.TDAAGEEAhAAAXDGAAAIBaCCBbFAAUFFAhADA.VGBADCIBfEHESHGA.FGHHhABA......hAFA...,1,13,-23,36
KEXRVfOgbeUWYQFJITDdLaNHcGCMPAZSB,ZAAAKAAARACFOACA..eAEEUAGAQBEDFBED..TDFAhABAdAHAaCABHFFCGDEAhAAAMCCBADHAEEGE.fGGAhACAbGBA.........hBGA......hBIA...,2,-24,-9,15
UJCLFETWVPODAGdYMZfRKaNBSXbgIeHcQ,dAAAZAAARAEAaADABAHB..SAFH..bCABeAHBHCDAQCBAhACACCGBLEFAECGFhAIATGEAPEBBAADAGFABhABAMDFBKEDB.XGFAgGGBIEHAhBAA.....hACA...,1,-1,-12,11
