eTLcRBMDGHJaOYAbdSfFNPUIVCWZEXKQg,dAAAFAAAUADACADAZABB...EAFAQAFA..eAHFLBHBhAFARCFBMCCBHCEA.aDCDhAIAACIBSDDBhBAA.fEHAIFFAXGECTFEADDBBhBDAOHFE...hCAA...,1,-12,-29,17
OgMRQJTdWcUPEAfZBXeHbFKYDSVGIaNCL,ZAAAeAAAHAEAKADADAFAGCAA.aAGALBGBMCGB.RCCA..TEEAhAAAdCCDUFDA.AACAXFGAhABAbFCD.SCHBhAEAIFHACCFBOHEEgGGG..hABA......hAIA...,1,2,-27,29
DfQHATIOcECJGZPNUMdKeXRLYWVFBbaSg,TAAAOAAA..EADAGACAZAFB.UAFAdBHAeBBBRDFALEAB.hAIAVEDBbDCD..aBDEDAIBhAAAHEEAACABCFHA..JHFAMEIBhBAAKHBA.XGEA.FHCC.BHHD.hACA......hAEA...,2,-8,9,17
KIQgNLTefRPAVDSbWXFUEcOadHJMYBGCZ,SAAAXAAAFADAEADA....aAFDHAFA.MCCAGBCAhAAAZCEEQDAAhAAALAHBeDGBREFAAAHAbGEAcEEAhABAODDHdHBBBFDA.KGHBNICB.....hABA......hADA...,1,1,-5,6
TSaRCFIgNXbcYOKVEJMWeAZDfQLdGBHPU,ZAAAQAAAGAEAHAGDUADA.aACARAFAFCGD..IDDA.hAAAXDFDbDBAODFHhAGAEFHFMCCBACIBLFHBhAIAdGAABDHASGGFNICB......hBCA......hBDA...,1,3,-16,19
XFKdVZOGSfCcJLHbBDUQeRIAYTNEPaMgW,TAAAEAAA..aACDMACA..XAEAdAGAZBDBGDBACAHALCBAhAAAHDGBDCFBeEFDAAEA.hAHAPFDDFCGDODHDhBCASGBDfEEE.cGFBBCCB..hCAA......hCIA...,1,2,-25,27
eVaYbXFcLQTGUdKfDIMBCZWERAHgSPOJN,HAAASAAAOACAeACHaAFD...XAEALAHBGBGAhAAAdCCADDFBMCEBZEFBREDBAAEAgFCBhABAPFBB.VFFBhAHAFHGE...........hAAA......hBFA...,2,-10,-5,5
gdAZIOJaCDPVKQHRTLeMFYGbSfEBUXWcN,ZAAAOAAAaACA.DAEAKAFAHAFC.LBBAeAHHMCCBGCDB.SCHHhAIAEDDABDFAXEFAhABANDBA.ADIBCFAAQEEBhBAARFCA.TGCAFGGHfHABhAFAcGGAIHFA.hAHA...,2,-19,2,21
EFHWMSdVPLgGfAUJZKNeBbQOXDRcITYCa,ZAAAeAAAQAEADAEARAFA...TAGAaBCDHCEAMCABdCHALDDAhABAGEBAAAAAKCHBBEEDhAIAbDAD.OEGB.IHHAhBEAEECBSEFA.gFGAhACA.....hCAA...,1,5,-18,23
BGaPZMUSAIebLNVdEYWFKTOHQfJgDCcRX,eAAALAAAdAEAEAGAFAEAOAGD.HBCCQBCA.fBHAhAAADAIBRCABGDDBhABAZDEBMDIBADIBbFGBVGDAhACAKGAATGFA.CGCBBHED.....hCAA......hDCA...,2,-7,-4,3
dIfFLADcTPZUaSWKXEgOeBYNCGJMbHQVR,TAAAZAAAaACA..KAFAEACE...eAEEBAHBCAHBGBDBMCCBHCGBhABARDDBdDGAFDDAACCB..DCIBUFGBhAFAXFGAOECD.hAAA..NICB.QGED....hCAA......hDAA...,1,-7,-21,14
ELScaQgdHCBIbOeZDPURVYTfWAGFMNJXK,GAAAMAAA.JADAEADALAGB..aAFDdCDAHBBABCFCbAGDeCHHhAAAZDDA.DEFBREGFTFBAhAIAAAIB..XDBDhACASFDBQGEB.CHGA.OFFHhBAA......hBBA...,2,-16,-7,9
gLXCVHdQWeOaRFJBANUSGbYEcKDIfZMTP,SAAAGAAAEADADAGAZACB..MAFA..TBFALBEACBHBHCDBhAAAdDEAeBHHRDGBBDCCAAAAbDFDhBFAKFBA...fGBAhBGAXFFD.WEHHaDAHNIDB...cFDDhACAIHFA...hADA...,1,-9,-12,3
adfJXeTRBLZPHbYAVcIMCOKEGDWgFQSNU,VAAAMAAAKADA.GAFADADAFAFD..QBBCUDCA.dBHAXBGDhAAARDDBZFAAHFGBAAHA.hBEACECDEHAA..SEEBhBIAaEHF.eEGBBGFCPHEC..hCAA......hCDA...,2,-35,3,38
eJURKbCVTGgcLZBQDWdENFYXSMfHaIPAO,eAAARAAACADB.GADALAFAZAFAQCFAdCCAFCFA.SCCDhAAAHECCaCHD.AAGAODBHhABAKFGA.bEFATGAABFEDEGGBhAIAXGEDMIDA.IHHA...hBDA......hCAA...,1,4,-15,19
ZOWHMKLIFJAVfDbSYdRTBNXGEagcPCQUe,DAAASAAARABABAEB.GACA..EAGAaAEA....PBHDhAGAQBEC.eAHBhAAAZCDAHECAMCHBLEEBhABAFEGDACEA.fGGAdGCD.NEIA..hBAA......hCAA...,2,-30,-8,22
MAWXebDCcPURFaYLZSgdONEHfVTKIBGJQ,eAAACAAAUACARADA..FAGALAFAZCCA.dCFAECFEHDDB..TEAAhAAABCBDGDGA.hABAMEBBACHAbEEADCIBaFHDSGADhAAA.OHCAfGEA.hAGA......hAHA...,1,-15,-20,5
FcXAfZYQgSBJVPNMEOTUHKdeLIWCbaDGR,ZAAAQAAABADB.JACEVAFA..MAGBECAA.UCDAHCDAeAHBhAAALDHB.CEFAaFAAhABARDGBXFBA.AFBA.hAIAfFEESFFBOFCDdHCDIHHAhBFADGGB.....hACA...,2,-21,-6,15
QVgEDPbKfMaLNeUYCGXJTdRSOHcZABWIF,BAAAFAAAQADAEACADAFA.KAFA..aAGEeAHH.UDAAGBCBhAAA.TCAARCCFHEEAACHA.hACAIGCAVDEA.bGEAhADAMDDB.LDHBCHAA.dFBASEGEhAHAOHFA....hBAA...,1,-4,-9,5
FHONdWKMRaVfALQZSYEbDPUTJegXBGICc,ZAAAEAAADADAUAEA..eAEABAGAGBCACBHA.HBFCdCAAKCCDREEAaCBB.hABA.ADEA.LEHBhAAA.QGDChAIASDEA...bDGD.......hBCA......hBIA...,2,-51,-3,48
gLcRPXCMbUIWABEGTKVDefYdSOZNJHQaF,EAAAGAAAKACA.eADAdAEAZAFBHAGB.aCDALBHBRDDB..CDFAbEAChAAAICCA.ACHBBDEDhAAATFGA.DDIBSEFHhAIAOGBCNIABFGFHPFHB.....hACA......hADA...,2,-30,8,38
SIfaYNPAGJUHZBbQFOcdCWKLgRVEeDTXM,GAAAHAAAZADBQADAOAFCdCADKAFARCEF.EBHFDCGA..MCDBSDGAhAAAaCEE..PDHDhAAAAAHABFGAFEEACGFD.LHAAhACAeHDG.TGGAIHHAYDAFhADA......hAHA...,1,-1,-19,18
RLDHWECeSKaUBJAMGVTbOPfNQFXcYIgdZ,GAAATAAA.OADA..fACBQAGAXAEBhAAAICDAZAGBRCEFHDBBECCAeCHHhBGAaDGDBFHAADEAbEEBFGCAhBIAgGCAdGGADFIB.SGEH.KGGDhAAA......hACA...,2,-3,11,14
aELAKJWRIDHTVNYXPgQbFCefUGSBcOMZd,KAAARAAAHADB..TADAVAFA...XAFBQDAA.bDDAhAAAeAHF.GCAAhAAABCHAMEHBaCCCAACAIDFAhCAADEIBPFABCDHASEEDZFDA.EFCB.hABALFFB.WFHBhCDA..,2,-6,-6,0
CMVUcJafIYATGXDZKSePREHONQbLFgWBd,GAAAZAAAeACEEADAHAFBQAFALAHBFCDABCCDdBHA.MCEBUEEAhAAAaDFC..IEHAhACAAEIBTFAAKGDD.RGFAODAHhADAbFFBCHBA..........hAIA......hBAA...,1,-2,-6,4
TcFNUdEWLXeSJYHbBACRagGQZVfODIPMK,RAAAGAAAZADB.OADADAGA.MAHBKBFAFCHDdCDALCFB.eCHHhAAASCCDHDBBAAIBaFDDhACAQEEA.hBAAVFBAfFHA..IDAAhAAAcGBC.EFHB...WHBAhABA..,2,-28,-6,22
SOQeRTKbZLBMVaCXgYGEDWPfHJANcdUFI,dAAAFAAAOACDRADAKAGC.ZAEALCCA.BBHAaAGA..CCEA...hAFAXCFDGCFAEECAhBAADDAB....fEEEhACAHFGBACIB.UGGASHDAeEAHMHDAhADA......hAEA...,2,-29,-21,8
YRNQbDOgGSXBMfVHFeKUIPcAaJZCELTdW,ZAAAEAAAdADARAEA..QCAAOAFAGBEABAHB.MBCBHCDAeBGBhAAAKCGCUEFA..IFGAhBDAAACAaDHDLEAAhABATGEANBIADGIB..SDDD..hCAA......hCBA...,1,-13,-16,3
GDSTcYMgeBfbZRCdXQJPFUNKaLHEVOWIA,GAAATAAA.MADAeACEBAGAZAFB.RCDAdCGAQCCA.FAHDKDCDhAAAHDFCEEFBODHDhACAADBBSFAA.gFCHhAAAbFBACGHD.XFFC....hAFA......hBDA...,2,-18,-8,10
aCHQTcSFYbJOBRLEZDGIVWePAXdfKgUNM,dAAAKAAAUACAaADA.HAEAQAGA..TCFAFBDB.JDDBRCBBECGBhACAGEGA..IEEAhAGAeFEFAAGA.fEGEhBAAMAIBCHCA.SFCH.OFHDhBCA.....hAAA...,1,-12,-24,12
dGRMZPgCUbJSEIaAYBcHFTOVLfQKXeDNW,BAAAHAAATAEALACAQAGCeAFHDAHBdCCARCAAZCEA..CCHAUDAAhAAAbEAA..EEEAAAIBFDFDhADAfEHA.XGFChAAAGEDAMFHB......hAEA......hCAA...,2,-26,14,40
YFAbIHPRZgCJDWQeLKdVfaNTUMBSOcXEG,HAAARAAAZADB.CADBDAFAeAFALBFAdCCC..aBGEUCABBCFD..ODCDhAAAEDABGDGAABGA.hACA.bEDDIEEAhAAA.JGAAQFFAKGEA.NDIAMIAA.hABA......hADA...,1,-11,-14,3
JPcKWbTDVMYBSQXaINdZCRGLUOAeHgFEf,HAAAEAAA.JADAKACA...TAFAMAHBSCAAQCCAaAHDhAAAdCEARDCBGDFALEGBhAAAAAEAeDHBFFFB..fGAAhACAcFCADHAABGCDIHHANBIA.CCEA..hAGA......hAIA...,2,-12,-3,9
dRaWYBMCgLSXFcAINQfHOeZVPKJEbDTGU,QAAAHAAAeACEZAFBKACA.EAHFDAEAGCCARAFA.aCHDBCDA.MCFBhAAALEFBFCGDACIB.fFAAhAAA.OFCHhAFAPDCBbFGDdFGACHDA.SEED.hCAA......hCCA...,2,-29,11,40
ZfQIHJKGREABUVFdMPcXOCgDSeWYbTNLa,BAAAFAAAdADAMACA..XAFACAFA.DAIBeAGH...bBCBhAAATCEALCEBZDBAQDGAhAFAHDGBGGEBhAIAACCBVFFB.OGAAWCCDNIBB....hBIA......hCAA...,2,-17,-17,0
OCQeaGMDcXHIVJNKAbFPBZRETWdSgLYUf,FAAAZAAAEADEdADALAFA.UCFACAFBeAGHGDBAMAIB.DCAAHEDBhAGA.JFFAACEABDDAhABA.RDFA.SDDChAHA..fFDAaDHFIHHAKFFDPHFChACA....hDAA...,1,-10,-33,23
ITKGDHcWFXUbZLYVNeCSMgOJAfdRPaBQE,RAAAaAAAEADE..KADAHAFBFAFA.UCCAZBBALCFA..VDGBhAAAeDAAMAIB.OEFHhABAAAIBdEEAQGCChADAGFABDGIB.XGFA.NEIA.SHAGhAFA.....hBAA...,1,-1,-21,20
GHcXLYaUCWJgRFDQTSOINePKfZdABMbEV,MAAAEAAAHACALAEAaAEA.CBBA...JAHBRCDAQCGCOCCBeCGDhAAAKDBAdDEAAAFA.BFCAGFEBhAIAXFGA..hAHAYHFGgGFGDIBA......hCAA......hCBA...,2,-18,-11,7
WSGPdfgUXJcKMLAbQVBNZHIDYOeTaRECF,QAAABAAAHACADAEAeACARAGB.FAFDGCAAdAHAUDAA..XCCAhAAAKCEDADDB..VDFAhAAAZCFFODED.EFHFhACASFFDfHEBgGGBMIAA.hAIALHBA..hADA...,2,-16,-2,14
ZUOPNVICWEKaTQJSbADgXdLfeHcYRFBMG,XAAAdAAAeADAHAGBRADA.MCCAZAGBOCDB..PDAAhACAIDAAEDEAKDHB.aEAChADATEEAQEFDhAEAbEGBAAAALGAAfEDE.FGBABCFCUGGBNIBBWFHHhADADIAA....hAEA...,2,-19,22,41
CLUJBMQPdDVecITWYHSOXfAGgbRaFKENZ,GAAARAAAKADCZAFBLADA.BAHAMAIBdCDAeBEFTCFAHCGBOCHDhAAAAAAA..aCCBEEABhACACEFD.QFCAhAEADDDB.IFFASFGAfFHEFHBA.hBHAJHAA.....hCAA...,1,4,-23,27
XWNPCabfOVFRJHBMQIKgYZSLEDAGedcTU,eAAAdAAAUADA..XADA..PAFCbAFD..OAHDhAAARCAAHCECMCCBQEEChACAKDDAZEAFEEFAACHATGGAhAIACEHAaGGA.FDHDBHAD.......hBAA......hBCA...,1,-7,-18,11
JXSPQMCfWIYTZUGRLDbBAONKaFcgHedEV,KAAAaAAA.FACAHACB.EAEAJAFA....SAGAMBFB.fCEAhAEA.ICGAhAHAZCCBRCGBbEDDABBBOCHDhBAA.gEFBeFFBdGCC....hCAA......hDAA...,2,-33,-19,14
BATRCJeWSMZIGQUYFVOdbfKHcagLEXDPN,RAAAeAAAMADAGADA.QAFAFAGDdBEAKCCBHDBB.aBHDECHFDDGBhAAABDFAADBBCEHA..SDEHhABAZECAUGGA.OFABhAFA.fGGA.LHBAhAIANIAB......hBDA...,2,-33,4,37
bDcfeNKSZFXJVWEPGgHRCaBLQOTUYdIAM,MAAADAAAeABAKADAZAFBFAED.....XBBCVAGB..ECCBGCDAhAFAHDFAREDBaAHDLFHBhAGATDGA..dFCAAGGA.hAIAbFFA...NIDB........hBAA......hCAA...,1,-7,-20,13
KCFOVdLfWcgEJQDPZeSRHMBYIGUbANXTa,TAAAaAAA..FADAdACALAGB..fAEA.hAIAgAFHEBBBQCEAhBAAZCEEREAAHEFAMBDBBDHAhBGAIGHAbECCABIBKFEDOFGBWBHHDIAAeFHHhCAA......hCEA...,1,0,-16,16
HDENOgAdYWUKPeRSLXJCMFZbIQfGacTVB,dAAAUAAAeADARADALAGBCAGA.ZCEBQCBAGDAA.aAHD..hACATDCAHCFAEDABOCHDhADAADDAKEEA.SEGHhADAMEGBFFHH.bFCC.fGHA..hAEA......hBAA...,1,-8,-11,3
SCWNdTKOFMLYRXfZbHGVQBeAcUJgEIPDa,UAAAEAAADADACADA...dAGAOAEDLBCA.RDBAZDFAHAGB.GDAAhADAQFFAAAGB.JGBAhAAAgDCB.hAIAaDGCSBHH..TFEA.hBDAMFIB.fHFFhAIA.,2,-29,-18,11
LeVYIAQZBUCcdXOPgaEHFbRWKTJfMNGDS,ZAAACAAAdACAOACA..aAEAHAFA.RCCAKCGATBEA..MEEAhABAGBGALFCAeCBBIDDAhAAAAAHAQGFAhCAABAHB.XEFD.EGHFWEHHNEBASFEDhBCA...hCBA...,2,-19,-10,9
VFZMKLQIJfTYaCXBdbHcNOPGARgDSEWeU,RAAASAAAEADE.eACHFAFAZBFELAEAQCCAJBHB..TCEAhAAAaDFDBDHAHECAOFEBhAAAAAFADEGBUGCB.hABAMFHBfFHA.CHFA.....hAIA......hCAA...,2,-25,-7,18
TVLDcdMgabPYEJKUOBCXAfISFGRWHeNQZ,SAAARAAAHADBeAFAZACBLCGBdAFA.aCCH..bAGDEDABKCEDBDFAhAAAAAAA.FEEHGEBAhAIAQFABTEFADBIBMEIBhBEAgGGAJFEFCHGA.......hBFA......hBIA...,2,-11,5,16
POCAFMDGJNWYafUcEgZTSdHKXbQVeRIBL,MAAAGAAA.JADA..NAEA...aAGAUAFAEBGF.ZBBB.dBHAHCDBhAAAKDFA.QDGAhACARFBA.LDCDCEHAABBBDFFB.hAIAfFFA..TGGASGHBhBAA.....hBAA...,2,-34,-2,32
aMQgSbLKdPTWRUVIXJNYGfeABZCcDEOHF,ZAAADAAAHABCaACA.MAEAQAFA..bAFAdBHA..TCDAhBAARCCAIEEA.XDGChABAYCCFeFAAhAFAACGACDGAEEFBFFGD.LFHBWFHH.VGDA..hCAANIAB......hCBA...,1,-4,-8,4
YGABTcUdRMQVPFCSbENDWHJIXaKZeLgfO,TAAAdAAARADA..MAHBQACC.FAEAbABDEAHB..DAIBHCDAhAAA.XCGDhAIAZCEBeDABLFCAODGBADEBhADABFHAUGABCGFASHFAJEHB...hAEA......hAGA...,1,0,-16,16
BcHgfFNaXbQOMGTJVRESdPLWDeIKYUZAC,BAAAHAAAFADAaACA.QAGAGAEA.JCAFEAGA.dBCALCCAhAAA.eCFHKBHBZDFBADHACECA.hACAfEDA.hAGAbEGDMEEB.RFGBSGFDDEIBIGAA.hBIA......hCDA...,2,-18,-8,10
AgMHOWGQeYVXNfCFKLdBJbPRcTaISEDZU,HAAAGAAAeACE.XAFBCADALAFAdBHABCCAJCDARCGF...aCEBhAAAEDDBZDEBAAAB.MEHBQFEAhACA.VGAAhADAFGFDKHCA..cGGA.....hAIA......hCAA...,2,-13,-11,2
dJgcAbYDSFTWNMVaUECPBeIOHXfLQRZGK,DAAATAAAMADA..aACAEAGA..BAFAeBBAHAGBLBFARCCAGDFAhAAAdDDAJDGBAAIB.SECDhBAAFDBHVFCACFADOEHDhBBA.QGDAKFHB.....hAFA......hBDA...,2,-12,-8,4
YONJbIKXdQTFegCVHfURaABWLcGESMPDZ,LAAAEAAA.MAEAZACBOAEC.JBHBbAFA.KBDAdCBCQCAAhABAeCFB.CCFAHCGBhACARECAAAGABEHAGDDADGCB.hAAAIGFATGGA.FHGE......hCAA......hDCA...,1,-5,-23,18
VQRcOFBGaXgUWJPfNbEHADSYTLZdeIMKC,SAAATAAA.dADAeACEKAFA.QAFCRCDA.FBDHaAHDXCFAhAAAUEFA.PEEBhAHAbDBD.HGFAAAAALFADhAFAMAIB.CDHBOFHD.GGCBWCCD.hCAA......hDAA...,1,-5,-7,2
dOKbVHBFcLJNeRUWEGZCSDgQPfAYXaMTI,aAAAMAAA.dAEAKADAHAGBFAFA.LBBB.eBDDRCCAEBHFZDEBDBBBQGAAhAGAACCA.TGFAhAIAbCFD.BDHAJDAFUFCAhADA...CFHA.SEBA.hAIA.fGGEhBAA...,2,-32,2,34
ZLUGIDQOHPKYJRBACXSWTbVfNFaEMgedc,SAAATAAA..VADAFADAEAGA.eBCFZAGBGCAB.hAAAQDEDHCFAKDDAREFAhABAAACAXEGDbFCBaGAAdGHAhAGALGAADIEA.OFFH....hAAA......hAGA...,1,4,-9,13
CUBWAOITPEgdZfeGMbNFLDJcYSRXHQKaV,TAAAEAAAZACBGAEA..bACBLAGBDAFA.JDHBSAGAhAAAHEBAaCBB.CBEABCFAhBEAAAIBOFFBgCGHhCAAdGBDfGHAeCCDMEEB.FFFA.YFHBhDAA.....hAAA...,1,-1,-7,6
XdJCVfQebaSPcFTKZNDGEUYIBHOLMRWAg,dAAACAAA.QADAeACA..aAFDSAFAFAHBZCAAGDFAEBHFICCAhACAHEDBMCIBACGBXDAChADAJFBB.bDEC.hAAA..TFFADCCABHDDRGAAWEHHfHGFhACAcFDC..NIDB...hAGA...,2,-8,-6,2
PNdHKWERQJTUIVabfgBGDFcLMeOYSCXZA,dAAAHAAAEADARADFQAFC.UCABaAFD..bABDBAHB.GCGAhAAAFAHBMCEBeDDASCGAhADAZFFFACIB.KDFDhBAA.TEGA.fFBADFIB.cGGChBFA....hCDA...,2,-26,-5,21
XFARZabCYKdePfgMGLVJHQTcEONDSUIWB,RAAAaAAACADB...dADAeAEH....fAFAGAGALCCBhAAAHAGBTDBAEEEADDIBSDDBhAFAIFGAXGAAhABAAAIBbDFAKBBDMFDBQGDAOFFB..hBAA......hBDA...,1,-12,-15,3
cIREDaQSUgbFMNATOeBCGZKLWYHfJXVPd,eAAAGAAAZADBLADAHAFA.XAGDdCCCRCFAEEEBaCDA..QEGAhAAASDDBbFCDMDGBhAAA.AAEABDHAKGGDfHAFhABAPFEDDGHB.......hAHA......hAIA...,1,-2,-13,11
eOFQCKTdcANVWEfRgSaJMBIXZHLPbGYDU,VAAAEAAARACA....aAFAMADA.BAGAZBFEHCDBLBEBGDAAhAAADAIBeCDFQDGAhADATCGAACCBfFFAhAIA.SGBHXEFDbGCC.OHFChAAAKGDBdGHA....hBGA...,2,-14,7,21
VcBFSUaKYDgCAPZOHXGdTMbLeEQJRfWIN,ZAAAHAAAdAEAMACAeAGBEAFARCAA.....fAHAIDEA.VBDBhAAAFDGHUGCAKCGDDCCBAACA.hABAXEFA..hCAAbFFAQGGB.NICBSFEDhCIAaAHFCEBA.....hBEA...,2,-23,8,31
EKCgbNDIVfTZScJdGFYMRHBWaUXOQPAeL,EAAACAAA.....bACADACA.IAFA..TAGAZAGBSBCAhAAAdCCAGCFAMBIBhBCAHDABBCEAaDHDOEDDhAAAADBAeDDBLFFAKGADNICBfGHAFGCBYHEAhBDA....hCAA...,1,7,-33,40
MSQRDWHYZdVBObLFAfcgCJUPTEKIGNXea,...fAAACAAAUACAEAEAGADA.eAFAaAGD.MBCBRCDAHDFChAAAdCGAOCADLFFAAADBgEFGhAAATGBAKCBD.hAIAXFAADBIB.ZFDFBHHAFGHD....hBCA......hBGA...,2,-17,11,28
fOJWBUbAXTHPIeZaRSdDcFYNCLgQVGEMK,HAAAeAAARADAdADA.FAFACAGBLCCAQCABGCFAEBFB..MAIBhAAAOAHDBDDAAAAATEAAhAEAZDFAaFFADGGB..NEEAKFHBhCAAfHCB..WFFD...hACA......hCHA...,2,-13,-11,2
UQSTbLEXPNAfMBYeWKRGVgZcDFOHCIJda,MAAAeAAARADAGACBZAGB.FAGAHCCA.CDHAdEAAaBBCUCFA.QDDAhAFAbEEB.EEHFXFCAhAAAACIB.BGGAhABAKGFA............hAEA......hAGA...,2,-21,-18,3
XHQSaEFRIfgTKGWedOUZLVbBDNMJPYACc,XAAAHAAAaACARAEF....IADATBGAGCCAeAEHdAGAZEFAhAAALDCAbGAC.DAIBhAAAMGEAPDGBACCBCHEA.QGBAhABA.EFHF.fHDBhBGA......hCAA...,2,-15,3,18
eYSEJKfLRPZIDBHFWCbQXgAOVTUdcNMGa,TAAAdAAAMADA.GAGAeACE..EAFEKBDARCCAZCFBBCBAHEGBFDDA.CAHBQFCAhAAAAAIB.hACAOCHFUEGBaFBASDBDhBDALGBA.DFFB......hBAA......hBCA...,1,8,-28,36
ZdXaYfSKODCFPBHMLGVgWbJRAEQINUecT,EAAAQAAAUADA.eACAZAFBdBCC..aAFDSAHHDAHBFCDBHDABhAAAGDGA.VEDBhAAAbDFAAAIB...IFDAhADAcFBC.TFFA.fHDBhBFACHBDMIDA......hCAA...,1,-10,-13,3
NfYdRISEbgODHTMJGCULFaXVWBPQZKAce,eAAA..fAAARADAEAGE.OADAHCCAMCFAGAGALDGBhAAAaBCAXCAABEAAZEEBhABAAAIBNCFA.IHHAhAEA..bDCDDDIBTGFA.CEHAFGBH..hAAA......hACA...,1,-7,-11,4
XWIEcRfFSJOCZgaTAPGQUMLNHbdVeKYBD,GAAAMAAAHACCdADAeAFABAFBDAHB..XBGAEBBBRCEA.SCDAhAAACDCAZEEA.aDBDAAIBQFCChBAALDGBbEEBhACAKGEA..IGAAcGGD.FGHD...hCAA......hCDA...,1,2,-21,23
IYRHgLVQfZEGUBWdNbDcSOaXPFMeCJTKA,RAAAHAAALADBQADCEAFA.GAFABAHAdCCCbCAC.DCFA..OAHFhAAAaCGE.FDEBeDFBhAAATEGAAEEB.IFAAhACAVFAAZEGBUGGB.NHABSHDAMFFB.hABA......hAFA...,2,-14,24,38
dDGOZRfLPbACYUWQgTXJHKcFIBMNeSaEV,CAAAUAAA.QADATACAHAEBFAFEBBHAeAGBECAA..dDAAGDDAhAAARCEALDCBAAHAgDGAhACAKDHBMEEBaEAAOFFBhADAfFHA.......hAIA......hBAA...,1,2,-20,22
TgUdPLMDXeREfHACNIVQcGYbBOaKFJSZW,CAAAVAAAGACA.BAEAaADA...FAGAZAFB...TBDAdCAAMBGBhAAAeAHFECEFHEEAACHA.hACAQGEB.hAEA.bDGDKDDDSFEBWDHH....hBCA......hDAA...,2,-32,-7,25
DQFYTUgAfMNOLEdIBKebJRSVZHXaCPWcG,MAAALAAAdAEAKAGAeADH.RAFAZCABHBBB.aCFDCCEA.....PCHBhAGAGCGA.QEEChABATEDAABBBOEBBhAIAEGAAbGDA.SFGA.XGFChBAADCAB......hBDA...,2,-17,-6,11
JFIOfbGQBPKCDTZRMAdWYSNEcLUgXVHae,dAAASAAAEADALAGBUADA...XBDAHAFAeCCB.FCGDhAAAfCBAGEDAQFFChABAKDDATEFAMCIBhAHAAAIBNCIA....gGBAaDBHOHFEBGHDhACADIAA.WDAD.YHEAhADA,2,-7,-6,1
NBdMZPDbTFLYGKJAgXfVUQWEIaeCcHROS,XAAAUAAAEADA...eADAHAFARAGBOCDABCDAZCFA.DDAATDAAhAAALEEAGDDAAAHA.hADAfDGEQGEAhBAAaFGCSGHBMIAA.FHCC....hBCA......hCDA...,1,-2,-15,13
TcNEeUQSWfFZOGYKCPbgAHXLIaRdMVDJB,HAAALAAARADFdAFAMAEADAHBBCAD..TBDAECCB.eAHFQDFAhAAASBFBFEEHOCHDhACAGCAACCCD.bDEDhABAAAIBaFDHJDHB..NICB.fGGAKGHB..hADA......hDFA...,2,-18,2,20
bdLIAOFSUgRNTKPQCMBJGVeYHXfZDEacW,SAAARAAAKADC.QADAMAGBGCCAeAFAHCGBZCCAEBHFaAHF.hAAA....bCFDdFBAhABAAAAAFDABgFDHhBFA.TGFABDHAVGAA.fFHAhADADFIB.WEED..hAGA...,2,-12,-3,9
MHcgDTIYXNGCBeUFEJbaLWVSZQKfAdRPO,RAAAMAAAHADBDAEA..TAFA..XAFAGCGAeCCBEBBAaBDDhAIALDAB.SAHBhAAAZCEBQDGAhBAAAEEAdFFAOFDDgFGGIHHACDCDFGDA..hABA......hADA...,1,0,-15,15
DBTJCMIeAbOdPcQUWZVFYfRgHLGaKSNXE,dAAAQAAAZABBFADD.RACAHAFBGAFAKAHB..SAHBECDFBDAATDGAhAAAMDDB.ADFBOEEBhADAUEFB..VFABhAFAfFAAaDHF.DFGBCGGDeFDHPFHD.YHAGhAFA...hBAA...,2,-12,6,18
MJYFKdXLWTaPSbgAEOefQUGZDNBVIHCcR,EAAAeAAAUADAZADBBAFAHAFA.RAGF...MBCBFCFHdCCCLCHB.hAAAaDBHSCHHhABAAAHA.QFFAhAIAGDDADDGBNDBA.CGGA..........hBDA......hCAA...,1,-17,-25,8
IJBUOKRTgeQXVcAPCMGYadbHSDEZNFfLW,MAAAaAAAHACBDAEAZAEEFAEALAHB..IBBABBGAKCEARCDA.hAIAeBBDQCGChBAA.XDBCAEBBGEEAhBAAbEFAEEHB.fGHEJFEFTGGAcEBDhBEA......hCAA...,1,-9,-11,2
CfgHFcVJdOLTQbaZeUGKIBYSEWAXRMDNP,RAAAMAAADADA...CADAHAEBFAFD..JAHBdAGB.TBBA.aBGDeBDFhAAA.GDFABDDAEDHFhBAAACCB..XEDDhABAfEFA.gGGAODHFLHAAhAHA.....hBBA...,1,-23,-29,6
cDMZCYNLEbGBOHefPVRSFWdUIQAXgJTKa,XAAATAAA.KADAaACA..DAFAZAEB.CAGALCCBEAHFGBFAHCGBhAAAeCDB..fDBAhAIARDAAFDHDdFCAQFEDhAAAABIBgEEBMICAbGCCBGHA...hABA......hADA...,2,-8,0,8
BPUWVSeLOXNDTEJKIAfbcRHMFZCGagYdQ,...bAAAHAAA.ZADBaAEAdAGABAHAPCABUCAA..SBFDhAAAeBFBLCHBXDCChACATCDAECHFKEFAAAAAREBAMFFBhACAGGBBQGGAWFEGNEIADIAAfHABhAHA.CHDA...hBEA...,1,10,-3,13
bVFQfdNKOSJWEeUgADYRaCXLPMBTGZIHc,RAAAaAAALADBBADAZAEBHAFA...bCEDQAGA.dCCAhADAOCCHSBBDhBAAECGAeDHFACGBCDGA.MFABGECBhBIAIGEAFEHDKGGDUGGBDIDA.....hCAA......hCEA...,1,2,-17,19
aHXYOfGIAREDTBZVMUcSKeFPNCLgbJdQW,EAAATAAAZACB..MAFASACB.eAEAFBEACBHALBHBhAAA.bCCAdCBC.aDEAHDFBhAEAODGDGECARECABGGDhAAAcFABKHBA.PFHDNEIA.....hBCA......hBHA...,2,-23,16,39
VZHGAbSEeaDJUXOLYMWdPBcFCgQKRfTIN,EAAAeAAADADAUAEA.LAHBMAGB.dBDCBAHAFDED.QBCAhAAA.RCGF.TEGAhAAAIECAZGBAACCB.aGDAOBEFhAHA.PEEBCGGD.fFHAhBCA.NICB.....hCAA...,2,-27,-21,6
aWDdTKBgALMbfVeOFCIJHYcPXNGESZQRU,MAAAVAAA.FADD..CADBHAEB..PAFAGBGAZBBFRDCAaAGAdCFABBHAhBAALFFA.eGBAhAAAODDD.IDHAhBFA...cFFANICB...EHFEhCAA......hCBA...,2,-34,-6,28
aVKQZDJYGHFCcXURMSLeWOdTBgPEIfANb,aAAAQAAAZACB.DADAGAEAHAECCAHBXAGARCBA..MCFBhAAAeCGFdCHABBBDEECAADGAbEBAhAGAKEGD..FDHDSFHHhBCALHAATGGA.....hBDA......hCAA...,1,-2,-18,16
EVSbMPAfZXNFDTCgedWBOIcJGHLYKURQa,ZAAAFAAACADAeACE.dAFAOAED..IAHAGAGAHCCBLCEAhABAKDABREFBECCB.SCHHhCAAMDIBAAGB.XEEAhCBATGDABHHAJFHB.......hDAA......hDBA...,1,-19,-21,2
FLHZdAEYRIBeUGbOMCNVTQKfDcSPaJWXg,RAAAeAAAGADAMAEACAFA.....TBCAQBGADAIB.SCCDhAAAaBEAXBGDLDABhABAHCEBAAAAEDFBBEDDhCAAbEGDOFFBKEGAfGGAPHAA....hCBA......hDAA...,1,0,-18,18
PEXMSOfWKAUbYGFLRZcaTJNCVQHIeBdDg,UAAAGAAARADAZAGBaADA....TAGACCDDHCEBeCDABDAAdDGA.DCIBhAAAEDHFMDCB.fEEAhACAAADAFFGHLGAAhAGANIAB..QGEA.IGAAhAGA......hAIA...,2,-28,-6,22
MbdOFTVXcCBPZNGJeEWgfIHYQKSALUaRD,aAAARAAAMADA..dADAFAGD..TAFA..XBDABAHBZCCAhAFAGDDAECGA.fCCEhAAAHEECQFCChBAAAAIBLDGBbDBCOEHDCEBANCIA.eHEAIHHAhABA.SGEHhBEA..,1,-5,-10,5
KeMORYTPSFJBUVbQIAGcNfEHgWZLCadDX,GAAA..fAAAHADAZAGBaCDCdADAKAFAeCHHRCAA..TCEAhAAAFEEABFAA.bFCBAAHAEBHFhACA.LEEAhAFAXFGAMDIB.OGCASGAA..hAAA......hACA...,1,-11,-14,3
CVOZcNEQSHfagWULRbIGXJMPBKdATYeFD,eAAACAAAZACA.EADAHAGB..aAFDUCCALAHBRDABGDFAMCCBKDHBAAAAFDDAhBFA.DDGBOFAHhAAAQFFBSFDBhADAfHBB.WEHBXGBDBHHD...hBHA......hCAA...,2,-18,-10,8
WSJAeKbNgBCfTVRLXPZQODHdUacGYIEMF,eAAAKAAA....bACBBADA.TAFARAEALAHBZCCAQCGAhAAAHCDBaCGBGEGAhAAAEECAMEGBSFAAhAFAAAHACFAAXFCADCCBdFDD..YFHB.WFFDhABA.....hCAA...,2,-7,-7,0
RHEOGXCcDWNIPBbdFeKfYMZUaAJVTLgQS,TAAALAAA.QAEAHACBEAEAGAGACAGADAIB...IDEAhAAAbCAA.eCABfCEEhABAZEFEAAIBgFCAhACARCGBXEAAcGEDPEEBFHGEMFIBaEAH.SGFAhACA.NIDB.hAEA...,1,25,-18,43
XPcKJZVafETeODAYbUdgMNWGFLRCSIQBH,UAAAdAAAMADAGADARAFA.CAFA...QBDCHAGB..XDAAhADAKCBBZCFEaEECEDFBeDDDhAFAAEGA..bFGDgFFAhAIAFHCA.LEHB.BGDD.hACA......hAIA...,1,-1,-20,19
aITSARVGPMKDZUXbNfHceEgJLFWQBCOdY,RAAAGAAAMADA.ZADAUBEA..bAGBHAGBECDA.LCCB.QEEAhAAAOCHDaDCCTEGAhABAAAABKDFBDEAB.fFDAhACA.eFAHFGHD.CFFDdGHA.SHFChAEA..hAFA...,2,-9,-6,3
RFCYSafXBLVeIdJZUEcDAMTOWgbGKPNQH,MAAATAAA..OACE..bACBGAFAKAEAQAGChAAAHCCARDGFCAHAaECCBCEA.eCCDhAIAdEEAZFAAECHFADGB.gEEBhCAAFGGHfHABLFHB....hCEA......hDAA...,1,-2,-8,6
AFGaIYQTLdDfUCbeMNBHSgKVcEJWOXRPZ,aAAAQAAALADAdADADAHBCAFA...eBBBMAHBHCFAKCEAEDBAODCDhAEA.REEBZEGBAAIBGEEAhAAATFAAUFAA.BDHAhAFA.SGCB.....hAFA......hAIA...,1,-12,-16,4
ZeLBFbSCMYdcNAJDWKgXUEIfHRGQaTPOV,DAAAKAAAUACAEACA.HAEARAEAGCCA..aAGAOAHDZCDELCHBhAAAFBBH.CDGA.dEFAAEEA.JDHFhAFA..XFFChCAAQGCB..........hAHA......hBAA...,1,-22,-26,4
VDUCWFHBXcAKQbGTENdLfaZeMOPRYISgJ,QAAAGAAAEADAdAGAaACE.ZCDA..eAEHMAIBRAGB...SDADhAAAgDAADDHBCCFAHDCBhAAAXECAAAIBbEEBTFFAhACALEHBOFHDIGAAUGBA.BGGChADA.NIDB.....hAGA...,2,2,2,0
ANdcMXRKYGHBOJgEDSZCTWeaQbPLVUFIf,dAAAMAAARADAGAGAHACCOAFA..ECBAZBFECCEA.eBBB.bDCDLDAAhACA.FDFDADHAXEEAhBAABEHADEEBTGAAhADAaEHB...QGGA..hAEA......hAGA...,2,-18,-9,9
CXNWAPJTHGfeBDLbVaYdQIOEFKUcRSMZg,TAAAHAAAeACE.LAFBaACA.dAHAQAFAECCAKDEDRDGBZFCAhAAAXBDCADIB.GDEAhAAADGGB.bDGBIHBAhBHAFFAASCCDCHHA.PHBA.BAHAhAFA......hCAA...,2,-7,-3,4
eVYUbdMDFXIKRWALOfZEgcHaPJGCNSTQB,LAAAZAAAEADEHAFBaADDGAFACAHA..TCAAeAHBUCAA.hABAdDDAMCEBFDHHKFAAACIBfDFEhACA.gEGHhAFAPFECSGHHBGHAYFFFhAHADIAA.IHDA.hABAWDDD.,1,-7,-22,15
AVEFYMGJZaUWdCRHcBOgSbKTINfDLeQPX,EAAAMAAAZACBUAEA..dAFAHAGDOAHBSBBAKCED.TDDAhAIAIEBA.DCIBeCHHhBAA.QEBChBBAABCBFDFDGEGAaEGHRGDAgFBA.NIAB..hBCA......hBEA...,2,-19,-5,14
TBNKFJcYAPQaZHEegIXUCbWSdRfOLVMDG,aAAAHAAA.EADEeACH..XAFBCAEA.SAHHRAFFLAHBhAEAMCABGDDATCCAhAAAKFGAFGFHJCFFADHA.ZECAIHCAhBAAbEGDdHBB.........hACA......hBHA...,2,-21,3,24
VKWbABeIEHFdLTOYfCGRNJMZgcQSXDaUP,eAAAHAAAdADALAEATAFAOAHD.CBCAGCDARCAAMAIBZCEEQDFChAAADEFAUFAAKEHBAEIBEFCAhAAAFFAA...fFFAhACAgGAGSGHBaGGB.WHAAhAFABHDA.IHHAhABA...,2,-12,3,15
AYTLCEXfcPZgDUIGRQVSONHFBbWaMJKed,TAAAEAAA..XACA..fACBZAEBDAHBGCCAhAAARAEFQAGCOBGHHDABhADAbCCDaCGEMAIB.eEFAhCAAACCBLEABCFEDPFHDgEEB.hCBAIEHASGGDhCCABGED.KGHB,2,0,0,0
DQIPNEXHTgGVfSAKFWbMJdCLUYBeaOcRZ,FAAAMAAAdADALAEABAFA.eAHHOAGDRBBAZCEB..QCEDhAFA..IDDAhAFAECCBHEFCGEGASDBDhAIAABBAbGAACGEAaFECDGAANIBB.......hBAA......hBDA...,2,-22,-6,16
DZRAFcEBbLJKVMaSQCeYNOTGPWdIfXHgU,EAAALAAAKACA.aADDQAEC.eAGHOAFAGCCAdBFAXCAAhABAHEFADAIBACCBBBHAhACAbFDD.MDDB.CDHATEEAhCAAIDHAfFHAgGAAUGEBhCBAFGHB......hCFA...,1,8,-19,27
FVIMYeEOTaZdfBHKbRQJgNAXWcLPSCGDU,XAAALAAACAEAGADAFAGA...MAFAEBFF.OBFAZCAAdCHAHCFAhAAARDFB.QDAAhABA.gEFAhADAACCAPEABDCEBIGHAeFFDaHDC...BHHAhABA.....hBDA...,1,-8,-17,9
SdXMfAFPQRKEaBcGWUYgOVZHLTeNICJbD,QAAAEAAABACAGADAUADA..OAFCHAFAeCCBCCFA.bCFAdCHAhAAA.MDBAAAHA.REEAaFHDhAHA..cEFA.hAIAgFAALHDA.IHCA.SFFDhAAA..hAFA...,1,-14,-16,2
HAZMReQbGPODUBaNXIFcVJSdTfCLEgKWY,RAAAeAAAGADADAEABAGA..aAFA.XBFDFBCDJBEB..dCGATDAAhAAALEBB.KEFDhAAAHEFA.AAIBZFBBMAIBhABAPFEBUGGA.IGHASGDBECCB..hBEA......hCAA...,1,4,-30,34
EbafKcBeUILTACgGSZPRNHDOWXFJQdVYM,GAAAZAAARAEAHCAAOADAFBHD.dAHA..MACAEBFA..aCDBKCEDeDBHhAAALEFAADFA.SCGDhABADDHBXEDAQGGAhAHAbGEA.........hACA......hBAA...,2,-17,-14,3
SgaXBLYDNTHQGMUdEPbZJIcFOWefAKRVC,RAAASAAA..aADALADADAGAHBDAGAGAdBGAECCBZCCA.hAAAIEAAOCHDeDFBhABAAAAACECABEED.TFGAhAEAMEEBbFGDFGDA.........hAFA......hAIA...,1,-10,-23,13
VUJcKdgeDOIZAGaXHEYLbRCQSTFWPBMfN,aAAAHAAALADARADFQAFCFAHB.BAHBMBBBVCGB..UCCAhAEAKCADeCCBOCFBAEEAEFDAhAAACCHA..TEGA.hACA.fFGEJFAAdGEADGGB.IHHAhAFA......hBAA...,2,-17,-4,13
ROcGZQKAgXfVWTbYMPULIaBDNHeSCFJdE,XAAAVAAA....TAEAMADALAHBaAGA.DBDAHBGBhAAAeBEAFCDBECDBRDABGEEAhADAZDEBAAAA.fEHAhAEAbEFD.YFDFIEHASGHHhCAAdHCB.....hCAA...,2,-19,14,33
bEIPLHfBTKcSaVCMJgUYZdXAWGFeDQRNO,GAAAeAAARADA.OADAEAGE.LAHBHCCATCGASBFA.hAAAaCDBMEABUEEAdEEAAAABDEHBhACAbEFD...fEBAhBCAKEHBCFCA.gGBA.ZGFE.hABA......hAEA...,1,-1,-7,6
ECaIAYFNVfeJMGWKPXHBDRQUOTcdbSgLZ,FAAAVAAAeACH.GAEAKADCHAFABAGARCDAUEFA..TCGAhAEAdDHA.SDDBhAGAZECFEGHFCHAA.AAIB....fEBAhBAAMICA.XEGA.QGEAhBEA...hAAA...,1,-11,-19,8
cFGJUHDANLeMTdOEfCYPQXKbIVSBRWgaZ,eAAAdAAAEADACADA...QAFAKAFA..bBFASBHBhACA.RCBAaCFCZCCAGDFAhAAAHECAADABMEEATECAfEHAhADAXFACBDHDgGFBFFHDDIAANIAB.hAIA......hBAA...,2,-13,-5,8
ZPQMBfedcUFGSNATgDYXWIRVaLbHECJOK,TAAADAAA..XABARACFLAEBHAEAEAGAOAHDZCFB.MCCBhAEAeBHHdDDAFCAHGDGAhAGAAECA..gECAhAAAIGCAbDEDKEHBQGACfHABSGHHhAHA...hACA...,2,-6,1,7
TaWDXAEObLBdQVRHFGNYMZKCUegfcPISJ,EAAALAAAdADA.RADFHAFBGAFAMAIBZCBACAHAeCAB...fCCEhABAIDHATFAAhAAAaDFCDEEB..AAHBbFAAQFDAhAFA.FFGAKEHBgGGGSFFBhACAWHAABHDA...hAHA...,2,-20,7,27
YKUEIJAMWabXeOgcfCGBLDQHSNZRFTVdP,aAAAeAAA.OADC..fADAGAGALCCAHAEBZAGBRDFBTECAhAAAdDAAKCCDEDEBAAFAMDIBhABAbEFD....XGAAhADACGHDDFFBNIAB.FDHD.......hAIA......hBIA...,1,-1,-9,8
GDJFceCfEPdVQNWgITMASKZYRHBbUOLXa,ZAAAHAAABADBOACALAFAGAFAFCAAeAHB.ECCAdCEA.QCGAhABAgDEDMDDBhACAADHBKEHB.RFBA.UFFAaGGBDIAAhAAACGAA....fGCE..hAGA......hAHA...,2,-29,5,34
ACXKgaOcBGPIMRQWebESUDLVTFfYdZHJN,KAAAaAAABADAGACA.MAEARAEF..eAGHEAHF.DAIBLBEB.hADATCAAfBBEhAGAZDFBHGBAADDACDGA.OFHBhAAAIEEA...bFGBSHEA.hBAA......hCAA...,1,1,-39,40
YFIQTgLWSZNEcDeAKHOaCJUfdPbMBGRXV,HAAAaAAA.CADBUAFAdADAMAFAGCAB.RDEA.XBED.FBBHTECAhAAALBGBZFGBEFBBhACAeDDBAAIB.ODHD.hBFAfFFABDHBIGFAQGCCSHBAhBHADGHB....hCAA...,2,-9,-8,1
VSFNDGeTaLEBPgROJUQKdXWAHfZMYCIbc,HAAAZAAAMACACADB....bAEDSAEA.DAHBeAGBaBHDLCCAhABAECABBAHBRCCBOCFDhAIAQEFAdECAAEEBIEHAhCAAFFEHNCIA.TGGAgGCDKFFD.hCBAfHFF.hCEA...,1,0,-17,17
AXFRGWcMPgeZCSLNYHfKdJTVUbEOIDQBa,RAAAGAAAMADA.eADAZAEELCCAHAGBdCDATDFAUCGA..EEEBDDABhAAABFHAAAIBFEHD.PFCAhACASGDB..hAAAfGBAKGFA.......hABA......hAIA...,2,-29,-2,27
ebYDgIGaFKfLcBACEXRWTQPMJSNUHdOZV,EAAARAAAQADC..MADASAFBHAFCZBCAeAHBbCFDDCIBhAAAGCDBKDBALDDBhAIAAAAAXEEATGGAJEHBdHCBhAIAOHDC..YCCF...hBDA......hBEA...,2,-6,-1,5
PQAMNdTaWUBHRObYZDgJVFXIESeLCKGfc,dAAAaAAABADAHADARAGF.OCAEZAEBDAHB..JCEBFBBH...ECGBeCHHhACALDAAGFAB.hADAfFFAQEEAhAIAAAFAMFIBTGBA.bGFA......hBAA......hBGA...,1,-8,-24,16
gdcPaDVCeJQHEBFbLXARUSGMZTYKfIWON,RAAAGAAAZADBKAFA..fADA.OAEDdAHAaCCB.CCFA.eAGBhAAAHDABEDDBFDGDbCFDAAAA.hADAMAIB..TFCAhCAAIGGA.NDAAPHACDDIBQFEChCFABEHB......hDAA...,2,-21,4,25
DRMCEKNUVaQBIOPXbGHefAcFSgdWZYLTJ,SAAAdAAAZABBLAEADADA.RCEA.EAFAKBHBUCCA..aDBEQBGAhAAABEED.OCFBhABAXEGAHEFBAAFAFFCBhAIAgEBG.YEHHMGEACHEAIHHAhBAA....hBDA...,1,-9,-26,17
IdNXBOWcFYfUQSeGaREMKLDAVHJCgbZPT,HAAACAAAZACA.TAEAdAGABCCAOAGD.FCAHUDEA..eCCBRDAB.hAAAECEBMAIBLEEAhAAA.AAIBgEAAhACA.bGAAIEHAXFGAcGBBQGEChADAaGEADADA.PHDChBGA..,1,12,-35,47
WRTcaFBMbOZSfLEegQCAdXUPVYJDGNKHI,dAAAXAAAUADA....VAFADADAGAEBHCAC.RBCF..aCEDMCIBhACAZCGBLFFAhAAAEDEAeDGFCEDDAAHA...PFHBhAIAYGDA.NIDB.WFFD.....hABA......hCAA...,1,-11,-19,8
gTIMVePYKLDRXcaCbFAHNfSQJUEdZBOWG,HAAASAAAQADCEADA.ZAFBBAFAGCAB.TDGAMAHBeCCAhAAAKAHBREEB.aCFDbFAAAAIBJDABhABAdGHA..OHCEhAAAgEEG.IEHA...PFDBhADADFAA.CGHA...hCAA...,1,20,-26,46
gGRfHMPDYaWJVSUbOABcKIeNCXZLTdFQE,KAAAeAAACACB.ZADBLAEAdAGAFCFH...EBHFRDBBHDGB.DAIBaCCA.hAAA.JEEFSCEHhAAA.OCGHABDBBGBDhABAIFAAXGGATFGA.GGABhAFAMIDA.YDDF.hBFAWFFD.,2,-34,-14,20
ZQUVAeKONFPXEBDgHRLfcbdIWCTGaMJYS,eAAAOAAAFADD..EADADAFAHAFARBEF.LCCA..bBGBdCHAhAHA.CDFAaECAMCCBSFFAhAIAZEEAQGDAhAAAABBBKGHB.XGGAfHDB.....hABA......hAIA...,2,-23,-10,13
LRcCTaYZFfQKEGPMNXAOdBHSUbVWgDJeI,dAAAHAAASADAVAEADACA...eAFHRCCACAHB.aAHBZCGB..QCBAhACAEDFF.GDDAhADAMDIBACCABCHA.bEADhAEAgGGBLFGBcGED..YEEFhAAA...hBAA...,1,-8,-15,7
cVMJPWABEYZgRSQITOeNfdaXGFLUHKDCb,EAAAZAAARAEA..QACAOAHD.eAEAdCAAGCCBLBHBHDFChABACCCDbCEDMFAA.JFFBACGABDGChAAA.SEDDhAFATGCAaHACFFGDDADA.......hAIA......hCAA...,2,-13,-4,9
IZESebWJYRQKTOUaBAXgCLNfdGFVMcDHP,CAAALAAAdACAGAEAMAEAHAGDZAFE..EBDFeCBB..JCABRDDBTFGAhAAAOCCH.BDGDACGA.hABAXEAD.fGFEhAEAFCHDDDFBSDGDbGAA.QGGAhACA.aEDD.hAGA...,1,-5,-18,13
DgMLfTZGIbKHRSFUOPJAWCaeXdEQYcVBN,aAAAeAAA.EADAQADA..cAEDBAFADAHB.MAIBhADATBGAGCCAKCCAHDEAhAAARCFBFBBHOEFHAAHAXEGAhABAdGHA.VGDALHDAfGGB..hBIA......hCAA...,1,-3,-10,7
SZgEfIYUaPLCbceFHAGVDMQWdXNORJKBT,GAAAMAAAdAEAOADARAGB.BAGAZBBBECFF..fBHAhAAAUEEBLEHBCCDA.eDCHhAGAHCEBAAIB.QEBAhACA.XEGAKHFA.TGDA.SGGBhAIA..hBAA...,1,-17,-20,3
gGAfMVBOZPFJeRbEYHQIcCTKSLDXNaWdU,MAAAOAAAZABEFADDRAEF...EAFAHAGB.QCCCCAHAKBBD.LEEAhAGAXCDAaEHDdCGAhAFAGGDBACIBBEED.eEHFhBAA...bGDA.......hAIA......hBAA...,1,-10,-25,15
CKENcLdJBAFHYIZUPfgDOVeaMTXQRbGWS,HAAAZAAAUAEA..fADBOAGF.eAFEaCAA.MBGB.TCCAhAAARDABGDDA.CDGDEFGAhABALCEB.dCHAhACAAAIBFGFHIFGADCIB.......hACA......hADA...,1,-6,-22,16
aZUEcISFHLXPVWADTBCJdKbgMOYGefQRN,TAAACAAAdACA..KAEAMACAGAGA..eAEARCDAZEAAEAHF.SBDDhAAAHEFA.LCEBhCAAXGAAPCGBhCCAAAIBBCBDbFGDOFEB...fGHAhAAANCIA.....hDAA...,1,-11,-15,4
RJLaebDdBfgEPGQZTOCIKYAMNWUXFcVSH,MAAAUAAAFADA..SACAHAFBRCBALAHBeAEHdAGABDEAEBBBGDCAhAIAZEFB.TEGAhBAACECAKEHB.ABIB..XEEBhBGAJHBA.aGDDfHGFQGGB..hCAA......hCDA...,1,-5,-23,18
PADFQLIUTEZfOdRcHWKJbCMSeGgNXBYaV,QAAALAAATAEAEACAZAEB..dAGAHAGBKCAA.CBDA.eBHHGDEBhAAAXCCBaDDHAAIBFFFHhBGAIDFAOHFEREAAJEEFhABA...MEIB.SGFH.hCAABHHD....hACA...,1,-1,-11,10
EYLKGAVWJHZgQBbcTXMIeNDFSRadOUCPf,VAAAHAAAZADB.QAFABADB.TDAAMAFAeBDA.FBGDhAAARDEAdBHACDDA.EEHFLDFAhBIAAACAJFCA..bGFAXFFAhCAADIAA.aGHD.......hAAA......hAIA...,2,-26,-3,23
IYTPAVgERBQSDaXJWdHfKNZebFcLGUCOM,EAAARAAAQADCDADA..aAEEJAFAHAGBKCCD.eBCB.FCEBGCFAhAAAODBBMCIB.TEDAhABAAAIBBDFA.XEFAhAAAdGHAfFCE.NIAB.cGGCCHFA.hAIA......hCAA...,2,-18,-12,6
YdcSeUWFEAOINMCLTgZJbRHXGKaDQBPfV,OAAAMAAALAEAZADBRAFA.HBBAGCEAaAHDBCEA..fBBEhAGAdDBDeCFHFDHBABDBCCGA.hAIATFAA.bGFADCIBhBAA.QEGD......hCAA......hDAA...,2,-26,-4,22
YGDMFIOAKBgPJVcSTfHdXWEbeaNQRLUZC,BAAAJAAA.SACAHADBdAFBEBGB..eAEHaCCH.RAGBZCAAGDAAhADAMCGBOCHDAAIB.KDFBhAIAPDHD.TFDAhAAAXFDA.NIBBQGGACEEBFGAAIGGAhACA......hADA...,2,-21,2,23
UGcgKJQTDWSVebYINaMHLPCFBRdZXOfAE,EAAAGAAAKACA.QADADAEA.SAFAeAFA..bBFAICGAhAAA.aCDCHCCAhAAALEEAFDFDREGFdECDhCAAZGAAfFHAAGIB.gGEAhACAWHDA.NAIA.....hADA...,2,-15,-8,7
QdURNBKgTaDAEYPeIOMLVSJGfHcbCFXZW,EAAAeAAA.MAEALADA.SAGHGBCAHBEACBCDZCDBdBHARDGBKEAAhAAAaDGCAAAA..IFFAhAEAOEBBfEEAhAIA.bFGBXGDC....hAFA......hAIA...,2,-27,1,28
KGXQBZegFVaAIfMUbYLCdTDNJPOESWRcH,MAAAUAAALADAdAEADAGA...JAHBEBBARCBA.HBFBGCFABBHAZEAAhAEAeCDB.FDHDADIB..hBAA.IEBAbFDDCFHA.hAFATFEAOHAASGHBKHFC...hAHA......hBAA...,2,-17,-11,6
VBSGDdKNcWEJXRHLUFIbaMOgPAZeTQfYC,eAAATAAAQADA.CAFA.SACBdAHAKCCA.NAEAEAFARCFBHEEBhAAALBHBFEHDaHBAMCCBhAAA.OCGBAEEB.hABAZFAA.fFDBBHHA.DFHB.WFHHhAFA......hAIA...,1,-12,-16,4
GZaDgXLESNORCWeMTAUbFHQYdPcVIJfKB,FAAAHAAAdADAVAEA..JAFABAHBZBFA.aCAC..DCCBLCCBhAAA.ECEBODBHRCGBeEABhACAADDAUDFAQEEBhADA.PFHD..fFEE.hAEAKGGA.....hCIA...,2,-47,4,51
CSDNUBgIeXYKLGbOVEZQdMRfPJHFATcaW,aAAASAAA.DADABADA.eAEHKAFAGBCAOAGBEBBBdAHARCEFhAAA..JBHBHDGBAAHA.hADATGCACDCAUEEAXGEBhABALFDD.ZGFEMEBBfEHAFGHD.hBEA......hCAA...,2,-16,-7,9
gJHeXbdMIaEPcULAQfNBSDFWTCRGKZOYV,QAAABAAAFACA.CACAGADAZAEBOAGD..VAFAHCBBeCHFhAAAdDGDaEEBEDFB..PFAAhAFALFFA.AAIBSGBAhAAATGDAKGGA.JHFAMIAA....hAIA......hCAA...,1,-4,-19,15
bOUTMZDHdQYgXJIRGBEaNPLcWeFCAfSVK,SAAAKAAAOACA.MADAHAFA.dCCAQAGA.XBCAhAAARCFAEEDAaDBBLCFBhABAeEGFAAHA.bDBBZFCADDHB.hAAAgFDBIHHANICBcGGA.CDEA..hBDA......hCAA...,1,-1,-11,10
QWXcETIGJgfRUdFKOSMLAYPZHeDabCVBN,ZAAAHAAAeACEaACACAFABAFB..QBGA..XAGDhABAECCAGCEAfCCEhAIAREGBdFAAOEDBMCEBACFBDGGBhAAAbDFANIAB...TFFA.gGDBhBIA.....hAFA...,2,-13,-3,10
WKTVIgPeSbOAYDQEfcBMUZGdJNXCHaFRL,QAAAEAAABACAZADBdADA...XAFAHAFARCEFLCCDhAAAKCEATDBAICHA.hAAAeEFHbDFAAAFADEHBMEEBhAIAJHAACGHAaFFA.FGCB.gGGA.SHDAhBCA..hBDA...,1,-10,-12,2
CDTBZLAQIgfPESUdeGVcROabHWXJKFYMN,QAAA..fAAAEACAdAFAeAHBGADARBDB.bAFAHCGBhAAAJCAB.FEFH.MDDBhAIADCCBZCFBAFBA.IDHAhAAASFHHVFAAaGDDKFEDCHGD.TGGA.LHAAhACA...hBFA...,2,-6,5,11
BIYKJgTZGFCWRVHPXNafbcQALEUdDSMeO,EAAAdAAAMADABACAKAEA..TAGAGAGACBDA.RCCAHDFB..XBEDhACAaEAA.bCBDAAIBLEEDhAAA.SFCHhAEAeCHFOEEBIGAAgFGAhAIAFGHB......hBAA...,1,-5,-26,21
AITFLgaNYJPfRbOSeHVQDdUcCZXEBGKMW,TAAALAAA.aADDJACA..RAFA..SCAAHAFBQCCAhAAAdCFDCDDA.EAHBGEFAhABAMDFBADHAFDHD..gEGAhAFAPFAAOFEHeHEADIAAZGAABHHA.hAIA......hCAA...,2,-13,1,14
BEARVXSNGTHMFUdZICPeKYQfgLaOWDJcb,RAAASAAAGADAHAFAMADAdCHA.ZDAACAGAKBCAQEFC.LFABhAAAaAHDDBFBJCGFbFDDBCCDhABAAAAA..XDDChBEAFFHD.UFGB.......hADA......hAFA...,1,6,-36,42
IFLPHVTagbOAWZYBJGUCdKcENQfDXeSMR,ZAAABAAAGAEAdACAEAEAQAGA.DACAeAGFRDDB.LCBAhAAAHDGBaEBBbCED.AAIB..hABAJCHBKGAD.fGDEhAGAMEAAFFHD..TGEAgGGA..hBEA......hBIA...,1,-7,-16,9
KGCLdTAFcNbRDSeWfHYZEXQBJUOMVIPga,FAAA..bAAARACFeAEEHAEAEBHFBAHB..OCABMBFB...IDDAhAAAaCDDGCGAdDFAAAGAhABADFFBfDHAhACA.ZEABQGCAVGCAKGGA.CGGD....hAEA......hAIA...,2,-27,5,32
XOKfEVWIBNeATCdDGLZPJUaRMcYHgbFSQ,dAAAGAAAZABBUAEARADAMAHBHAGD..FCDHQDCAKCFB.EDGBhAIAIEHABEBDACIBDEIBhBAALFCA.aDAHgEEBhBDAXGACfGFA..hAAA......hACA...,1,-15,-27,12
KYFOEDASbGeHXaIJBLCZNMdWTUPQRcgVf,GAAAHAAAaACABADAZAEBdAHAUAFA.RCDB.VDCBKAHB...FCGHEDCBABGA.hAAA..eDADJEHBLFFBhCAAMDGB..PDHBhAAA...gFDA.OFBDhACASCCCIHHAhADA..,1,-7,-21,14
eSfZVUAEFKMRXBTbYJOLCgdQHWNaIcGDP,EAAAMAAARACA.BADA..TAGAJAFA.LCCAdBBAHBEA.aCGEGCFAhAAA.eDABZDCBAEEAhAIAXECAOEFCQGGAhBAAIFHADCIBfHEBFGAHKHDACHHA..hCAA......hCBA...,1,4,-23,27
aLfcEAWHSgVQXNYBGFPRbOMKeDJCdUTIZ,HAAASAAAQADC.XAFBBADAGAEARBGFMCABeAGBhAAACCCDdDEATCCAZFCAaDHDLDABhABAEGGA.AAHAgDGAhADANIAB.FEEH.bGDA.DFIB..hBIA......hCAA...,1,8,-10,18
GTXHPAfVdNKSLYcFZRCeJIWaQDbUEgBOM,dAAASAAALADAFADARAGF..eCAA..IAGAaCEB.QBCDhAAAbDED.EBHFhABAOCHDGCEAHEAAhACAACGBfDHAKFHDZGDA.CFHADDDB.BGFAMIAAhAEA......hAFA...,1,-1,-16,15
dDbEHOVZABKSaGTXWCYLNJPUQMIceFRfg,SAAAGAAA..TADACADALAFAJAFAUCDBMCCA.eCEAhAAARCGBdEEDECHFHGCA.ODAHhAAAAAGAaDAA..XDDChABA...YEFBQGGAFEHD.hADADIAA.....hCAA...,2,-20,-2,18
VCGcMWYBPTdaegZLKQfJRSHAUXIEOFNbD,XAAAEAAAFACD.DADAGAEA..MAGBBAGAdAHAeAHHZBCBLDFAhAAAQDGBRECAHFGBhABAAAEBODDB.bFFACBEAYHBAhBHA.aGFBfGAA.hCAA......hCBA...,1,-8,-16,8
aOWMEQYLcKSGTVgedbRUJDPXFNIBHCZfA,aAAAMAAA..EADALAEAKAFA.GBBATCCAeAHH.RDEADDIBhAFAFBHDBBBDHECBZFGFAAHAQCEChADASGABdEGAhBAA.bGCA..........hCAA......hCGA...,2,-23,-5,18
KcdZTNPILUBDSMFJReGXaAEVgbOHWQYfC,EAAAVAAA..OACCHADBQAFACAFB.dBHAZAGB.TCCAhAAAIDAALCEBhAEADDDBMDGBREGBeGCAaEEBAEHA.hBIA..bFAB.fFHAcGED...hCAA......hCBA...,2,-20,-3,17
gMGUADQPZaBJYLObIRSXNCefEKVdcTHFW,QAAAaAAABADALAFAOACC..RAFF.SBBDCAHB.ECCEhADAdCDAHCEBFCHBMDFBhAAAAAGAZCGBJECBIEAA.hBAAeEGBKFHBTGDAGFABDEIB....hAEA......hAFA...,2,-13,-8,5
IWSaBFPGJcLVCefYAKDRHEUOdgQNTZXbM,RAAAHAAAEADE.dADA.QAFAZAFBMAIB.SBHBFCCAGCGALCCAhAAAeEEB.ACABDDGBOFAAhAAATFAA.bDGDaGFDhABABEEAPHBA........hAFA......hBHA...,2,-9,-7,2
RHbXQUPeVgcINfKMCaSYJOFBdDWZLTEAG,HAAAQAAAeACEVAGB..gADA..ICCAhAAAKAGAaCDESCFHhAAAOCEBdDGDZFAAECHBRDAAbFEAhAFAXEEC.cFGBMFIB.CGAAFHECDIAA.hAGA......hAIA...,2,-6,1,7
YJXRSTaLgVGIPNWFOdCEQcfbABKMZDeUH,MAAAeAAAHADA.XAGBRACAaAFALCCAGCCA...ICGAhAIAPCFBFCHDdECAEDHFhBAAQFAA.bFGBhAAAABBBZEEBDGGB.UGGA.SGBD.hABA......hAFA...,2,-9,-1,8
JGFBDCcNYVLeUKTgMXfISaAEdWQOZPbRH,EAAAdAAAQADAZACB.RAFAHCACGAEADCHBCAGA....cBGDhAAAVDEBeDHH.TGAAhACAMCBBXDGAhAGA.SDEDAEDBOGDC.bEBDBHHALFGBhAIA....hBCA...,2,-16,-1,15
DRbUJETSdVFPAaHBXQKCLgYGcZfNWeMOI,HAAAQAAALADBGACBZAFA..fCAEeAFEMCDBDAGARCEAUDAAhAAAECFA.dCHAFDCHAEEBaEGChADAKDGACEEA..gFFGhAIAcFGA..NIDB.......hAAA......hACA...,2,-17,4,21
DcCFfAOgWJPZEaGTVLIRQNBMSKeXbHYUd,OAAAJAAAZADB.GADALAGBRAFABBBD.KCGAeBFF.HDAAdDBACDFDhAFAAAIB....gDGAhADAEEGAaDDH.TFBAhBAAQGAA.MFFBbFFADEEBFGGA...hAGA......hAIA...,2,-15,-9,6
GfFcEQXJCMHBWOAUgaNLYebIDTZVPKSRd,aAAALAAA.eADHDADAZADEKAFA.RAGFGCCBFBHD..ECAAQEFAhAIACCEAHCFBBEEDABBBUFCAhBAA..gFAAhABANCIA.bFGDIHFA....hCAA......hCCA...,2,-23,-11,12
MgVaQXBeOPJWZTNLcRUKfYHFdSAECbGID,EAAAGAAADADA.MADA..aAEEQAGABAHA.eBFBOBCBhAAAPCDBZCFALDDBhAHARDGFfEBAHFEBdFEAACGACECAhBDAgGGAXGGB.......hCAA......hCBA...,2,-20,5,25
TDCRFQLdMWbUYOVHKfPIJXAZgScEGBaeN,ZAAASAAAEADEGAFAeACHDAIB..RAEALAHBdCAAMCCBUDDAhABAOCEBHDGBKDFAfEAAhAAAJFAB.AAEABEHAhABAaGGCCHBA.QFFC.YGCEhCAA.IHHA.hACA...,2,-11,-3,8
PbEOCeTdGVWDXRYNcAZfILJSgQKHFBUMa,ZAAALAAASACEQAEAHAEBBAGAaAGE.EBHFeCAAGDDAhABADCEBRCFA..NCCAADDBfEAAhABAJDGF.FEFHMDIBhAGAbEGD.CGGD.dHAB.WDDD.....hAIA......hCAA...,2,-11,1,12
faYBVMGDJFCHNIeQRcdKZXAUPSOEWTgbL,SAAAEAAA..TACALADAaAEABAHAGAGA.FCCAHBEAhAAAeCEHRDDBdDGAZEAAAAAAOCCBhAHAbFFA.VGEAMIAAhAEADCIBCEGD....NIEB.......hAFA......hAIA...,2,-9,-6,3
KWOUDeNXfESPgFaVHQGJTYZbAdcIMLBRC,dAAAMAAARADAKAGCUAEA..DBIBeAHB...XBBAECBA.SCFAhAIAFCEDHCGBGEAAhACATEBAZDEAAADALFFAhBAACFFAOEHD.fGBEaDDHQGCAhBCA......hCGA...,2,-12,-12,0
KJacDGCTZXeNRSVMgYfLFbIQdPUWBHOAE,EAAAaAAAGACAZACB..eAEARAEA.MAIB..fBHAhAEALCBDbBGDdDFAUFAAHCEDAECAhAAAKDHBDEEBTFGASFADhAFAgEDFFFGAQGCCWBBD.BGGDhBCA.....hAFA...,1,17,-15,32
SCUKcXHGgLPZBeVWIJYFRDTQbdMaNAEfO,EAAASAAAKACA.HACBGAEALAEAZAGBeCCBICFAFDHDREAB.hAAATDGAdEED.aAHDAAGBCGGAhAEAXEDA.BFAAhAAA.VGFA.YGAGDGIBMIBA..hBIA......hCAA...,2,-15,6,21
WPJZFKQIBRfMcaHONCGVgSYEAdTUeXDLb,dAAAeAAALADA..bADAJAHBZAGBQCBARCCA.MCFBhACAHEAA.CDHAGEEAhAAA.SGHBhABAAAEATEGADCGB.FEDD.BGGD.aHAA.NIDB..hAEA......hAFA...,2,-18,-13,5
WgGQXYCTFARKbUJZMaefdHNcLBSODEIPV,RAAAKAAAUADAZACB..eAEAHAFALBHBOCCBDCHB..ECAA.VCEAhAAAGDEA.QGGAhAAACECAAEEB.MCIBhABAdFAABFFASEDDIFHAPHAA..hAHAWHCA....hACA...,1,-3,-29,26
HMBQANVSXIJacgFGEKDdPWZRebUCTOfLY,SAAAXAAA..aADAFADA.EAGAdAGAZBAERBCFUDFA.OCHDhAAALCEA.HEEAhAAAMEBBABIBIFCAhABAJEDB.GGCBDFCB........hAGA......hCFA...,1,-16,-25,9
UTAHdLKSEfeQCRcZOMYVGWJIDabBPNFgX,HAAAdAAALADAEADEeAFERAGFZCAE..MBGBGCEAJCAF.DCIBaCCABEAAhACAFCHB.UGGA.ACEB.hAEAfDDE.hAFAQFCCOGDC.VFFA....hAAA......hACA...,1,-8,-21,13
JUVCDERgOHIXLfQMeAbZcadWSPFTGYNBK,ZAAAdAAASADAFADAGAFABAHAKAGA.UCAADCCARCDA..HCDBLCGBhACAMCIB.AADAaEFBTFFAhABA...JFDFEFHFhAGAOHAC.IHHA....hACA......hAHA...,1,-12,-35,23
HFWGaBLbSTRPgDeZECYNMOcIJUfQVXKAd,HAAAGAAAaACALADA.TBGARAEFDAGAEBGACAHB.MCCBOCDBhAAAJCHB.QCEChACA.KDHBADDAdEEABEADbEFDhAAASEFH.eFHB....hAEA......hAFA...,2,-18,-10,8
eXcICEYRWbfJBTLMZUGHQdKgVSDPFaANO,eAAAXAAACADA.RADA.....bAEDBAGBMAHBGCDB.HDAAhAAAdCCAKDHBSAHHhABAFEEAAAAAOFGDEDHFfEEEhADATGAAUGCAQGCADAGB.aFHD.hAIAcGFB...hBIA...,2,-18,2,20
cEKAdQTeGOPfBCFSNUgaIXVRbJDZWYLMH,dAAAeAAAGADAOADCBAFAFAGA.UCGA..aCCA..XCAAhACARCEFDCGAZDGBLDFDhADAHFAAEGEBAAHATFAACGHA.hAAASDDD.gGFA.hABA......hAFA...,1,-13,-18,5
MdSFQeVDLZKCaEbYgXfAWHTRJUOGBNPIc,HAAARAAAOADAGADABAGAIAFA.dAHAQBDDeCABLDFAhAAAZCFBaBHDECCB.bFFAhACAXEDBACGB.TFGAhAAANHBB.MCCBFHFEDFFACEHB.....hABA......hAIA...,1,17,-24,41
GOYEBXAVdCMFUKaRWfJeTLDbPQgNHIZSc,dAAAMAAAKADARACA...JAFAeAFE.LCCADCCA.QCGAhAIAHCDCZCGBGDAAEECAABBBFEFBhBAAaEEHTGBA.gGGAhBGASEHH.OGCCBFHC.CGGD..hCAA......hCEA...,2,-24,-3,21
febKRXBNScLgQCVAHdFEJYPUMaWOIDZTG,HAAAEAAA.JADAUADA.MAGBaAGA..OBFEZBGBGCBA.eDDHhAAARCAABCED.SDEAhAAALFFACHAAADHAdEHAhACAFHFA...PFFBDCIB......hCAA......hCDA...,2,-24,-14,10
DOHNITGfcYKJXWLAFbEUPRZaeMBQdgVSC,EAAARAAAeADEBACA.dAEASAGB.OBDCHAGBTCCAhAAA.GDFAfCCEhAAAKDHBXEBCAAIBbCFAZEDBhABAaEEBMFFAQGABCGGADGIB.IHHAhAGA......hAIA...,2,-10,-7,3
LAMJgUVcOaZTRNEFSfKWYPDHXeGbBdQCI,MAAAUAAAOADAZABERAEF..FAGAKAGA......PCCBhBAAHBDAeCFAGCGAdDBAQEDAhCAALEEAADDBgGCBhCDAaEHDEGEA.fGFADIAABHHA.CHHA.hCGA......hCIA...,1,-13,-17,4
cgKNCQROaJWdXHBIATFZEVGUYbPDSfeML,ZAAAEAAAGACAUAEA.....bAEASAGAeBHHLCFBhAAAKCAAQCGAREAAaEDDdFHAHGAChAEAAACAFDDA..VEBAhABADCBBMIEA..gEGGCGGC.OFFBhAHA....hBEA...,2,-28,22,50
IeCJQNUPRKMWYTVOLgaAFBZHXEGcSDdbf,ZAAAHAAAEADEGADA.DAFAdAFA..bAFAeAHB.QCAAhABAUCABRCFAMDDBTCDALEFAhAAAACHBXDFDSGCAhACACEHBJFEFKGGA..YHEG..hADA......hCGA...,2,-9,-2,7
FfIGAdaMKCUSORQZLENWeJHgcDYPXbTBV,aAAAMAAA.KADACADA..UAFARAFFZBBA..EBBBeAHH.HDDCDAIB..hAFA.XEGATDAAFDDAhADAIGGAADGA.dHABhAHAQECD.LEHBWHEG.gFFAhBAA.PHBAhBFA.,2,-30,-10,20
LGIdORfVUXeFZWPJQBCDaTYScNHbgAMEK,EAAAGAAAdADA.RADAUAGAeAFAZBFE..JCDFQCBCBCFD.aDEChAAASDADHDGBAAFAMFFBhBCALDHB.OEGBhAAAXGGAFFEDCHHADGDB......hBDA......hCAA...,1,-7,-22,15
afcCVELUBNAWgGedISZbKFQJRMPDYTXOH,GAAAeAAAdAEAZADAFAGARBGFDAEA....TCCAHCDBaDCB.CAHBLFDAhAAABBGDAAAAgCGAhBDASDHHQEBChBEA.MEEB.XFFAfGHAhACA.....hCAA...,1,-11,-30,19
RgXfOLScNaHEDbPGYJFZeMWVICQAdBTKU,dAAATAAARADA....XAGBLACB.SAEAaBHDHCACECFBhACAbAGDGCEAFDEHeEABhADAMEAA.IEHAhAAAAEHAKFGAfGCAOFAADAIB.PGCCZGFA.hAEACGGA......hBAA...,2,-3,5,8
dNMRPHCfDQOVLaBbGTSJYAXWKFIZEecgU,KAAAZAAAEADEeACE.UAFAdAFARBGF.HCAADAIB.QDECLCCBBCEDhAAAGECA..TDGAhBDASEHH.AAHAFGFBhABAgEEB.MFIBCHHA.OGDChBHA......hCAA...,2,-30,1,31
AeOgTVGULcYfJbZXEFBaCdQDIMSHWPRKN,eAAATAAAGADA.LAFA..fACBZCFBECCBaCHDhAAAdAEAQFDChABAMAGBHCCAPDBBRCGFAAHAOEEBhAAAgGAAcFGCYFHBJHBA...hBHA......hBIA...,1,15,-15,30
KNPULZSFGWMIQCYEBOXDacVRfTJdeAgHb,HAAAKAAAUACAZADBGAFA.MAIBQAEAECABBCCCDAHBaDEDRDDA.hAAA.JCHBAAHB....hAIAbDGDLFFA.hAAAFGBACFBAXGFC......hACA......hADA...,1,-10,-34,24
YadXRLQPWVgFMbIEZTfAeGScBNHDUCOKJ,eAAAGAAABADAHADACAFA.KAGC.aBGERAGFLCCAQCDB.VDFAhAAAMCIB...EDFFZFAAhACAAAAA.SFFDhADADECAOEGDdGGA..XFAA....hAFA......hAIA...,2,-36,7,43
fCZVbGARcTQEBdSageHMDPOFUKLIJWYNX,RAAATAAAEADE..dAFAaACAHBGB.DAIBFAFALCCBJBDF...hAAA.NAIA.CCEDZEEAGCFAhBFAAAAAQGEASCCDhCAAeHAAMFCA.OFGDKGHB.IHCAhCFA......hCHA...,1,-6,-19,13
GEYKMgJSdNbOFQBcTCILaDXfPHRWZeVAU,EAAAMAAA..SACAdAEAOAGBQAFABAHB.TCCAhAAALBBBaBHDDCFBXCGDhBAAHDABRDFFeBDDADABYEEFhADAKEFDgEBAJHBAFGHBCHFAfFDAhBEA.PFHB..hCAA...,1,19,-25,44
bIKDBVgCNASMWJZUOLecRfXPTaHYEGQFd,MAAAZAAALADBRACA..XAFBaAFAHBFAEAHFGCAA.dDFDhABAbCCADDIBBBBDCEEDAAIB.SCGAhBAAUGFA.eECBhCAA.fEEEYFBB.QEGAhCEA.KGED.gGGGhDAA,1,5,-18,23
LPYGKdXRMEeDOJbagFfSZBUQNcHTWVCAI,LAAAGAAAdADARADFEAFEeAFA.DBIB..OAHDaCDE.FCAAZCFBQCFChABAHDBB.TEGAhACACDHDAAABIFHAhACA.KFADMDDBJFEF.bFDDSGGDBFFD.hAHA......hDAA...,2,-13,-5,8
NCeDSBRHXAZdJVgfLTMPUcIaYWOGbEFQK,dAAAVAAALADA.MAHBUADA.aAFEOCAEGCEBFCEAQEEChAAACDED.eEHBhAGABDHA.HEAAAAIBgGGDhCAATEFAIGHAYHCA....hCHA......hCIA...,2,-24,-14,10
KbGdOSUBNJIARHPTQCDMXfecYVEgaZLFW,HAAATAAAQADC.MAFAeACEVBFAEAFEZBDALDDBhAAAKBHBdDDASCAAhACABDGAIFFARFEFDDIBfDFEhBIA..YEHBaGHB.FHAA.hCAAWHFG.OCCHhAAA...,1,14,-26,40
ACZGHdVcRFNPLaSYBXebIUWQEKTgJMDOf,GAAAHAAAdADARADAFAGALAFA.aCACBCDDeCEAUCFA.EEABTDGAhAAA.MDDBfEEEhAAAAAGAZEEF.VGFAhACAcGGA..SDHBYFCF...hACA......hCCA...,2,-21,-6,15
JIPULYTKNZMABFWRDSOeCbQfHdVGEagXc,FAAARAAAOADAeACH..QAEAHAGBGBDAEAGA.aCCB..XCEChAEAIEGALCHBhBAATFCAZFFAADDBDEFACGBD.dFFAhBIA............hCAA......hCBA...,2,-19,-9,10
EfHCXNPGFVQDZTSOeKYabJBRMUAdIgcWL,dAAA..gAAALADAHAGBCADA.XCAAGAEAQAGAhAAAZDCBTEAAeDHFhACAaCCBbDADREEBAAEA..IDDAhABAEGDFfGHAFDGASEFH.KFHBhADA.BHFA.MIBAhAGA...,1,7,-9,16
YUfQKDgLFdJaVBOCHZRAIXEWcbMSGTPeN,EAAA..bAAAGACAeAEA.UAFAKAHBLCABdBHAaCBH.BCCDHDFAhAAAAAAA.XEACMCEATDEAhACA..PEDDhAEAfDGBQFFBFEDHOFGBCHHA.IHHAhAEA.SFAAhAFA,2,-11,-5,6
FQdfOKTcRbIWXeUSLZPDgJNAHaEMCBGYV,HAAAEAAABACAGADAFAEA.dAFB.KBGDRAGF...bCACXBCA.hAAAeCEHLDFAZEGBDDDBhAAAgFFAACIB.hAIAaHDCMDGBCHHA.........hACA......hADA...,1,-11,-28,17
cACSTeBXHKQEdVgZDIMYJOPNfFaUbRLGW,TAAAeAAAHADA.EAGEdACAZCCAMAEA.OAHDfCFB.hAAAaCHDRBDFGBFAAAAA.hAFABEHAQEEBhAIADEFBIFBAPFHBFGGALHCACHBAKHEA...hBFA......hBHA...,2,-15,8,23
XJMdETaHCUgVQGODbYWSPFZcLIRfAKNBe,BAAAeAAAMAEAEACAHAEAUBDA..QCAAGBGADAIB..bCDAhAAASCCDZCGBLEEBhACAREEBAAAAKFCAXECDhAGAdGHAaGBCCAHBgGGA.....hBGA......hCAA...,1,10,-18,28
fBWACTcbgXRUDaeLINMVdSGPZJFHYEOKQ,TAAA..bAAARACFDAEAeAEA.LBHBMAHB.dCAAGBEAhAAAZCCAHDFBECABQECAhACABCGBAAAACECAXFAChACAaCHDIFGASEEDFGBBKGEAfFHAhAEA......hAFA...,1,1,-9,10
fAdKLHbICUNFDZBYXeWGgPERVTSaOcMQJ,dAAAHAAACADA.FADAZABBBAGA.eAHHGAEAECAB.RAGB....TDCAhAGAaCCAMCFB.QDGBhAAAAAIBLEGBbGAAIFFAhBAADDDB.XGDCgFGA.SEEDhACA..hAGA...,2,-20,-13,7
cYILCRBAdNfTHVPEeMaFZKXSDWgOQbUJG,dAAATAAAHADA.EAGEeACEFCBD.ZAFB.SAHHDCFAOCHDQCCAhAAAUDDAGFABIDHAhAFARFGBADAB...fDBEhBDAMHDA.aEDE.XEGC.hACAWHBA....hBHA...,1,-8,-20,12
VcMXUWLSKHOCQfaNgFeGDYTJZBdEbRPIA,MAAAXAAALAEAHADA.QBBA.aAHDFAGA.eCDAhAAAGCEATCGAZDGBEECBhAFARDAAADAAUEEAKGAACGDAfGHAhAGADEIBBFADdHFB........hABA......hADA...,1,-1,-10,9
GQdRaLIcXADOTMSZBVCeWHJbKfEPYFgUN,TAAAZAAACADBHAEB.KAGAEACE.FAEAUCAAGAGA.RCCA.aCGDLEEBhAAA..XDDChABAAAIBMDGBBFCAeDHHbFFDhACAfGHA..gGAAhAGA.dGDADDIB...hAIA...,1,-10,-11,1
TGCHEYWAbOdQfXUMRBcZDeNVPJKFSagIL,dAAAQAAAUADARAFA.ZACB.eAEA..VCBBKAHBaCEALCHBhACAGCGAHDFDEDEBAFAAOEDDhAGAMFDBBGFADFFB..hAAA..NIAB..FGHBSFAA.IHHAhAFA...hAIA...,2,-14,-5,9
NPIZLCOdgDEReYMTFVfUGABbKSJHWXcQa,KAAAHAAA.XADBaACA....IAFAZAFBLBHBdAHAEBCFhAAARCAAeDEB.MEGBhAAATCEAfFBAhACAADDBbDGD.SFCH.WFHBQECBhBHACHDADIAA.FGCH...hAIA...,2,-20,-4,16
KbLOeYBUJcTgHfWaPdAZQVNRDGCFXMSIE,ZAAAQAAARAEAGCAAFACE..MACAEAFALBHBeAHHBCCDUCDAhAAA.TCFAHCFBaDEBhABAAFAADFFASDHHhAHAKFHBOFAEJECB..fGGEdGGA.CHCA..hCAA......hCEA...,1,-1,-9,8
PGNUAfLZJFRTWMIVCOHYKSBgacedXbDEQ,ZAAARAAAMADACADBHAEB.KAGABAGA..aCAAeAHH.dBEADCHBECCAGDDAhABAAAAA.LFGBhACATDFA.VGAA.SGEHhAGAXFFAbGCCNDIA......hCAA......hCCA...,1,-3,-31,28
FTSfCaLDRNZBHIXUWbAEVOdYGMQecKgJP,EAAAdAAAGADA.eAFAKACAJAEAFBHD...TCCACCBALDAAhACARCEFZCGB.HCFB.XFAAhADAbGCA.AAFAOEHDhBAAMDIBQGGC.gECGhAAAfFDAaHACBFFD.IHFAhBCA,2,-22,1,23
GaATPHUFbgDBXZdVIJWLcSKNMYECRQfeO,HAAAFAAADADAZADB.dAGA.JCAFLAGB.KBCAMAIBEBEERDDAeCCDhAAA.GDGAAAIB.TFBAhACAUFFABDHA.hADAXGBAIEEASHGACGDA..hBAA......hBGA...,1,-5,-38,33
FCJBRTWeIHgSQDbUcENPXVLdAMKYGOafZ,MAAAGAAA.aADAZABEFAGABAFA.RAGF.eBFFHCCAQCGAhAAADCIBUECB.ECDB..XFADhAFAdECAAEGBOFFB.hAIACGHA.TFFA.gGDGSHGG.hBAA......hCAA...,2,-22,-7,15
bdeCIgVQaOMJUWPSZDXLEFKNfYTGcRHBA,eAAACAAA..VACAaADD..MAFAUAFA..SBEHZCAALBHBhAAAEBGAKCCD.fCHAhAAAGDFAHEDBADBBdEEAhABAIHHAQGBAOHDEPEHDDIAA.FGFDhBDA......hBGA...,1,-9,-11,2
OfHINESDQUVTgFBCLMdYcaKJZWGARPXeb,RAAAeAAAOADAHADA.EAGEQAGAUCDB..TCGABBDAMCCBhAAAdEEDaEHDZDDAGFABhAAAACGBXEGDfGGEhABASDHBDCCB.FFCDCHFD...YFFFhABA......hBIA...,2,-22,11,33
YLNKZDXTcAbUPRgGHECFVfBQJSaOIMedW,UAAARAAAHADBEADAFAFABAFA..QCFA.aBHDMAHBeCCBhAAAdCDALDABZCEBTDAAhADAAEEA..bEFAGEGAhAIAfGGAOGDCYFBBDBIB...hBAA......hBCA...,2,-22,9,31
PHEeMRTOYIBCULcbdQJDNSWKZagFAGXVf,GAAAXAAA..fADAHADAEAGERCDAOAEDBCGBLDABhAAA.dEFAQAGAhAAADCIBSDCDZDDAaCGChACAAEHBeFHFMDABTFGA.CEHBbGAANIAB.WFFDhADA.....hABA...,1,4,-8,12
adRMPVKLeQIJGDANYbZBfTXSCcEOFWUHg,...bAAAZAAA.TAEACAEA..EAGAFAGAHCAAdCAARCCAMBIB.KCEAhAAAeCFHQEABhABAGDGAAADABCGBSCHBhABAOECDgEEAaEEH.LFHBhACADGGB.fGAEhAEA.WHEC.,2,-11,10,21
QWbGFecXPaTSARLfZVDEgBdCKHUNMOYIJ,RAAAZAAAEADEdAEA.HAGBMAFAOCAB..IBGAQDDAGCCAhAAAeDGB..XCFChABAaEBBAAGBLGFAhABADBIBCEFAKEHBNIAB.JHEA.........hACA......hADA...,2,-19,-9,10
FJbCKIPYDEgBWVfTUMZdaAORcHXeNLSQG,RAAAHAAAeADELADBGAGAFBDDCAFAKAHB....IDFADCABECFABCCChAAA..fEEEhAAAMDHBaEEAADIBXEGAhABAQFAAbFCDgGAATFCAdGGD.OCCHhAGASHAG.hAIA...,2,-13,-8,5
OXdTRNBIKaCUfZbAVcPDHgGEeQFYSLMWJ,VAAADAAAHABC.EAEEeADE.FAGALAGB.MAIBOBDChAAAdCCDRDEBBCGAaEGACFCAZDDAACFA.hBAAgEGH.hCAAQFDASFHD......hCBA......hDAA...,2,-21,-17,4
dGTCRQIZWHNbOMDUeaAfYKXcSLFgPBVJE,KAAASAAALACBFADABAEA..EAGAGAFARBCBZBFE.HDEBODFChAAAMAIB.eDHBADHAXECAhABAPEAAdGGATFFAhAGACHAA...IHHA....hCAA......hCBA...,1,-12,-23,11
eRWMVPUSNDZTCKEHFBbaLIQfJOgGdYXcA,RAAAMAAAUADADAEAZAFB..KAGAHCGBBBBALDDB..QBDAhAIAOAHFdFBAXCFBhBAAAAAAeCCD..VFFBhBFASCHH.TDBA.EEEB.aFHBhBBA.fGFAhBDA...,1,-6,-43,37
PJWEBGQKDTXMaYHFILfAdbCRgScNVUZeO,dAAARAAA.SADAVAEAZCCA...eAFHOAHDJAHBBCBAGDAAQDCAhACADDGB.MDABhADAHECBLEEBhAEAAAAAbFFACEED.gDGA.cGGAPHDCEHAAhAHA......hBAA...,2,-12,-6,6
CgJONcHfSMXYbWLATdFDaZUeGQRBVPIEK,dAAAaAAAZACBeADA.RAGBBCBA..IAFAECEA.CAHA.ODABhACAHCEAMBBB.bEBAAAIBTDCAhADA.DDGBGGEBhAHAQFECKDHBgGCDNDIA.SFFChBAAYHEG..hBEA...,2,-15,-15,0
dZKUecNVCbLMEDgFQHABYIOaPRSTXGWJf,BAAAOAAARACA...TADAGAFA.JCAAZAFB.eAHF.VCCBhAFAbDAC.LEFA.hAAAEFCBFAHFHGEAADFBaDGDSGGEhBAA..fEDAKBBD.hCAAcFAB.MDIBhACADICA.QGGC.,2,-21,12,33
VSTaYDAJWKNUZOgXCIfQeHRcGMLEPdBbF,KAAAZAAAOACACACB..QAEAHAFARCCAGCGAEAGA.dEEAFBHDTGFAhABADCCA..ADDAJDEBhAAAUFCA...IHAAhAHAeDGBMEAA.LGFA...hAIA......hCAA...,2,-28,-7,21
DbLHPEAXaGKVWCQTFYNZJfBeMgIROdcSU,GAAAKAAACACB.QADAFAEA.ZAFBBAHAeAHFMBEBRDCAdEGA.SDADhAAADCCBHCFAACHAaFBDhACA....TEGAhAAAYFFF.NCIA.fFCAIHHA.OEFHhAHA....hCAA...,1,10,-48,58
dITcZQRHMGJfaSCYgPOUKNAWBDebFEVLX,DAAAeAAAEACALAEA.dCCATAEAZBFEHDFAGAGAaDBBCEDAPBBBhAGA..KFADAAIBBCEDhBAAbFFA.XDCDhCAA.QEECMHDASHFAODHDWGDAhCDA.FHGEcGADhAAA...,1,1,-14,15
XMbJHCdRWAEBaefUYGNLDVOPZTFIcQSKg,EAAAeAAAUADAGADALAGBOAFA.ZBFFFCBBQDBAKDDA.hAAAMBIBHEFARFDAAAAAaCHD.hBDA..fFBAhAIADFHB.TFDASGHH....hCAA......hCBA...,2,-14,-12,2
aXLFQJbKPOcDUSYdRfCMVANEZTgHeBIGW,EAAAZAAAHAEABACAGADAaAGALCAB.QCCBbAFA.OCFChABADAFASCCDhAAAREEAMEIBAADA.TCFA.hACAeDHFXGGDKEFDcGGCdHCB.CHCA...hCAA......hCBA...,2,-20,9,29
fZXNCQdYGVEaISRPUeFbMKcWLBTHgDOAJ,ZAAACAAAdACAGAEA.EAGAaAEA..RCAAeBHFMAHB..KBEALEAAhABAHDDADAIBAACAJEEF..hAEAXCBCQGAAhAGAIEHASDGDFEBD.cGGATFFA.hBEAfFDENIDB.hCAA...,1,0,-26,26
MSARUcVXKaQZHObENFfIGDeCWgPdYTLBJ,RAAAVAAAKADCZAFB..HADB.EAFAFAHDGBGAeBEF.CDAA....hAAAPDDBdCCATDGAhABALFABMEFBAEGBXFEDhAAAaGFD.QGGC....hADA......hAFA...,2,-27,-3,24
MWJNReBXZLbfUQETaAVGSFgcIdHCPOKYD,GAAAFAAA..IADAHADAOAFA.DBIBMAFAJCDFRCFBeBDAhBAAZFCALHDAUCGAECCBABHAhCAASDAD.hCBA.dDFCKEHBYEDBBGGB.bFGD...hAAA......hACA...,1,-9,-16,7
CUZaXgNHYDVQdBcTOSEPMfJeRALWbIFKG,LAAA..bAAAKAEAGAEAZAGBaCAAXAGAHCEB.DAAAdDDChABABCCDTEAAECGFMDEBhAEAeCHHAFGBFDHD.CEBAUGAAhAGAgGAA.YFHBQFFCSGCHhACA...hAHA...,1,2,-12,14
HcJMTYCDKZINdfQGBWOEVbXeUgaRAPLSF,LAAAHAAAMACATAEADAGAZBDB..dAGAGBFAOBHDEBHBXCAAhABAeCCFUFFB.RFCBAEIBhAAAFDDA.JDGF.KEAA.hBIAfFFE.BHHA.bECDaGHD.hACASHEA.hAEA...,2,-15,2,17
dQGWDUTEFbPeLOSBKIRaNACXJHZYMfcVg,XAAAHAAAZADBMAGB..VADAdAHAGCEADAGAUCGAECABFCDHeCCDhAAALDABBDHARFBBAAAA.hADACFHA...JEFFfGFAhACAQGDC...WHFA...hADA......hBFA...,2,-18,-4,14
NbdBOZSVUGXQJWFIDKLTRPaAYgECfcHeM,EAAACAAAHACA..eACAMAEAdAGAZBEEUCCAGCAAQDAAFCHDKDDDLEFBhAAARDFAAAIB..hACAfFCA.hAIAbFDDSFDA.XGBDIFHAhAAADFIBaFFH....hADA...,2,-17,-7,10
RAfbcJGFdNCaPEBHTUDVLeSgZQWOKYXIM,...bAAAGAAA.dADAaAEAEAFAHAGBTBGADAAAeBDHZDBBQDEAhAAAKCFDXDGAREGFAAIB.hACAfEEEFEDH.hAFACFBABFHD.........hBAA......hBCA...,1,-10,-12,2
badgRZXfeAPUNWcVYMTDSCJFKQGBLHOIE,UAAA..NAAA.VADAMAFA..DAGACBBAKBDAGBGA..HBFBhABAECDB.dCHARDAA.ZDABeDFBhADAABHA....cDDAhACATGCA.FFHDLFGBOFFH.aFBD..hADA......hAEA...,1,-10,-24,14
APNKCDZIdJBQHXFbERSVaWMULOefGgcYT,KAAAZAAAdAEAQACCHAGBFCAARAEF...aDACMAHBLDDA.eDHFhABAGCFA.gDDDhAAATFDAAAGBCFFBDAIBBGHAhACAEEAASDHH.UGAA.fGHAhAEA..hAGA...,2,-16,-11,5
cSMALXWGCYFURfPbDZdJVNOeBEIgaQTHK,LAAAGAAAFADARADF.....bAFDdAFA.VCAAeAHBEAHBaCDBHCFChABAKEDA.MEEBAAABCEGAUGEAhACADEIBZFEB..ODBDhAIABGGA...IGHA....hBCA......hBDA...,1,-10,-16,6
fYKbGIDXTJOdcEHCMNBPSZgRAWaVQFeLU,aAAAQAAALADAUADAKAHB.GAGA.DDBATCCAdDEAHFBAhAAAMBBBBAFAZCEBAAEAFEHDeCGFhAHA..bGDAXEGDhBAA.OECBCHHANIAB......hCAA......hCCA...,2,-18,-3,15
HWaAXRFPCDEJOLKBTUNedYVfSZMIcbgQG,RAAACAAADACAEADE..LAFBBAEA.UCCAeAFHdAHA....fAHAhAAAZDFEMFCBIFGAhAAA..bBCD.hABAGDFAaFHDAHBBFHDAOCBB.KCHB.YFEFhAHA.SHGAhBCA.,1,-11,-41,30
MaefcKXUSLVDPEgRBFACWJGITdNHQbYZO,CAAAGAAAdACAHAEAQADAZCBA.aAFEeAHHKBHBUDCALDFADCGB.hAAAEEAARDGFBEEBAAGA.JGAAhACATECA.bFFAMFIBhADA...fGGESGCA.PHFChAAA....hAEA...,2,-11,-7,4
QbEZVcIWPgCBMKdAUFXTYeRONDSHLaJGf,XAAAeAAARADA.DADAHAGB.aCCBGAEBQDDAEBDBZCFAVEABhAAA..IEEAhAAA.gEGBhABAMDGBAAIBFDHDTGFAOFCDLHAAfGHAWDDDhAHA......hAIA...,2,-14,4,18
XeaHZPVCWfFULOIDRASBETMNKJgbGcdYQ,EAAAMAAAKACA..JADBGAEA.dAGBQAFAeBGHHCCBZBBFCDHAFEABhAAALBHB.DCFBhAFAACCBTFFA.NICB.hAEAbDFD...YEDBaFHD...PHFAhAIA....hBAA...,1,-1,-31,30
LTHIcGNQPOMdWSFBUCeAKaXRYJgEfDVZb,aAAARAAA..JADAEADA.DAGAZAGB.LCCAHBDCGBGA.QDAAhADAMBIBdECAFEEACBBDABIBXDDChBAA.fEFAhBGAbEGD.TGGAIGAA.cGCDhAAA....hABA...,1,2,-35,37
SAYFcTONRMLgXIQbBdCEPHZfWJUeGDVaK,FAAATAAARACFLAEB..XACBQAGAdAFAEAHBHCFBZBDBhAAAfECAUDFAeEHHhAIADDIBaFECAEEBOFFBhAGAMCCBIHCACGHA.PHEC....hCAA......hCHA...,2,-11,-3,8
AKNBaFHRWGZJIMOcbUSDVYdCgePLfTXQE,BAAAHAAARADFZACAMAFAOAEAUBGA..DAIBdCAD.eCEHLCCBhAAA..TEGAEBGFACEBaDAAhADAGGCB.IHHAhAAAbDGD..SEEACFFD...hACA......hADA...,2,-31,-7,24
DGVAHJBReYfICNSPcWKQLaZEUTbOFdMgX,HAAARAAAeADE..fADBCAGB.SAFBPBDD.KAHBaAHDhAAAECAB.UCCAOCCHhABAdCFDMDIBDCGBADFBBDHAhCAAIEFA..cFCBLHAAZFFAFHDAXFGDhAAA....hACA...,1,-11,-16,5
WCKfVDdGAHaZJUEQMbYLOTXFNPSRcgIeB,HAAAZAAAEADEMACALAFBOAEEFAHB..SAHBRCAA.ICCAhAAAeCEDCCHAfEGAhABAdCEAACGAaDFD.QFCAhACAbDGD.XGEDcEDCBHHAKGHB.hCAADDIB.....hCBA...,1,-6,-12,6
gYLRMXWOJaKbUZHVBSFTQfIPeEdNACGDc,GAAADAAA....gABARADAMAHBOCDBKAEAZAGBHCEBBCDAhAEATEGA.QEABhAAAfDCEeGAAhACAEDHFABIBCGDA.LCFDXGGAaEEH.VGAA.hADAFFHD.....hAEA...,1,0,-13,13
IZbTWUBaEdDSVfHJcAQXYRKPNegOCMFGL,QAAARAAAKADC.eACACAFAGAGAZAFB..TDAABCCAECEBdBHASCDBhAAAHDFB.hAAAADDBXEFAPFCBOEEHhABAMEIBLFCB.bGECaFHD.DIDAhAIA......hBIA...,1,9,-21,30
UCRZcEGFLBgXeDKOWbSaJAMQTPfIHNdYV,MAAATAAA....fADAHACBdAEBUBFBRAEFZAGBGBBAhAGALEDAXDECeCABOCHDhAAAbEGD.aFGDABBBQGCAhBAAIGDAYHAACFFA....hACA......hAHA...,1,3,-9,12
NHPZfcMKdLVXAJWIBbaQSgTOYDFeERGUC,JAAABAAA.aACAQADC..TAFADAFAEAHFRBCBGCEAhAAA.CAHBHCGDZCCAMBGBhBAAdFAAXECCACIBIEHAhCAAbGFAOEEB.eFCBNICB.fFGEhCBAKCBD.....hAFA...,2,-16,-4,12
OMLGXQIVKDBbcWJFNASZdURafegTHPCYE,dAAARAAAeADEHADA.CAGB.EAGEMAIBGBDA.QCFCKCBABCEA..hAAA.bEGDJCGB.ADABZEEFhACAaCCB....fFFAhABATFAAOEHDIHCA.DEIBFGCD.hAIASHFA.hCAA...,2,-19,-8,11
NVZbHdCETIBYcDaJeGfAKXOPFMLRQUWSg,OAAAMAAARACA.UAEA..SAFB..gBBAhAHAZAGBHCCCEDHFTCGABBBDhBAADAIBeEFBABGAKDDAFFCALEBBhBAANIBB.dEGDCFHAIHHAaFDAfGGAhBBA.....hBIA...,1,-12,-14,2
RIVdbKBOGXZafFcMWgNCUADPHSJYLQeTE,HAAASAAALADBeACHRAFAdCADBAEAGCEAZAFBFAHDMCHB..hAAA.NCIA.AAAADCEB.PDGDhAEAQFAA.hCAAEGDBbFCAXGFA..aDDH.fGGEhCBA...hACA...,1,-1,-21,20
SKYbGagDfCUQeHIFBAVWNXdJPTMLOZEcR,VAAAXAAA.dADAJADA..MAFAZAGBRCDBKBFA.GDBADBIB.CBHB.hAAAeDCBHDDABCFCADBB.hABA.PDHBLEGBhAAAEFFBSGDBaFFBUGAA.IHHA.hAGA.NEIA.....hCAA...,2,-18,0,18
PKLTRBCgWQfXdJZVENUeHbaOFSYMGIcDA,LAAARAAACADB.QAEAdAFAZAGB.EAGAeCCBHCAA..aCEHSBHHhABAGEFADBIBACCATDEAhACABEHA.fEAEhAEAXFBC.VECB.bFGBOFDDFHEA.hCAAIHHA..hAAA...,1,19,-30,49
gOdWRfcbTZeYLUNFHVPAJMBSEXaQGKDCI,MAAAEAAA..aACDGACBDAEA.CAGB..OAHDRAFA..bBDDeBBBhAFALCFAFCFBHDCBACBBSEFAhAAAQEGAKFHBhAIAdGEAfGEAcGGC......hBCA......hCAA...,1,-2,-24,22
EOegGQBUSXAZTJLVcdfKHDIbMPaRCWYNF,ZAAATAAALADB.dAFAHACBDAHB.bAEAMAIBRCEA...CCAA.NAIAFCAHhAAA..EDEAeEAAhACAGDGAQEEBhAEASCCDAEHBcGAAKFBAaFFHOFCF.BFHAhAFA.XGGC.hABA...,2,-26,24,50
MFgeVSDKLTdfJYXOQBbACZIWGacRNHEUP,ZAAAGAAARAEAHCAAEADAMAGBeAHH..DACATCDAdCED...fAHAhAAAXDGAQEEChABAABFBCCHA.aFAAcDCChACAUGGAFHAASDAD.LEGBhADA.OFEDBHFC.hAFAIHAA.,1,6,1,5
KVCGMLDXAfPSbdJTUcaHWRgEIQZBONeFY,SAAAdAAAUADAHAFARACF..EAEEZCCAOAGDeCGFKDBD.GEGAhACAMAIBLCEBhAAA.ADEBbDFDJEEFaHAAgGAAhABA.BEHA.FGHD.CHEA.DDIB.hAGA......hCAA...,1,-8,-15,7
ILObTUWcFKXdCNZSgHDeVGQfaRBEYPAMJ,MAAALAAA.TAEAUAEAFAGE.dBBAZAGBHCFCeCAAGDBBhBAAaCEHEDHFAEGB..OEHDhBDAbEAA.KFFDCEFA..SFDHhABADICA.QGAABHFA.PFHDhACA.....hBEA...,2,-20,5,25
LNcBJICWAZYTXdaESDVFfGKMUQOHRegbP,ZAAATAAAaACA..DAFAFACA.GAEAKAHB.MAHBQBEAHCCBREFAeGAAhAAA..bCGDLGEAhAGABCCD..CDEDADIBhABA.dGCA.EFFB.SGED.fHGFhCAA..hCBA...,2,-30,-2,28
dYfNXFgZSObEHKBUVGTCecRDMQPWILJaA,dAAA..fAAAFADAZAFBOAHDHADABAGBGCABeAHH.RCAAMCFBhAAAQDGD.hACAIEEAaCGHADEBXEGAhADASECHEFAAKGGATFGADIDA.LHBAhACA.....hAFA...,2,-9,-8,1
OYbPSVMKfDXaNLGHCFTgeUdcRBAZQWIJE,ZAAAQAAAJADA.EACAOAGD..bAEA..SCAAhABAMAIBDCDAaCEEGCEAHDFChAAATECAeDDBdFAAREGBAAIB.hACAIFFAVGAAXGDDCFHA....hAGA......hCAA...,2,-14,4,18
IAWaXRSUebPdgYONFcHKEBDLGJMVZfCQT,aAAARAAAeADE..dADAOAGDFAFAHBEBBBDAGCGA.MAIBZCCAQDGBhAAAABBB.hBAASEEDbDBB.hBDAgFCDcEECEGCALFFBfGHAhCAATGAA.IHHAhABA..,2,-14,-7,7
ZKSBfGWANPdaIULCXJEROcTeFHYDbVgQM,dAAAaAAALADACADA..EAFARAGF.OAHDeBBBHDCBDCCA.bEADQCEAhACA.ZDAAhADABDHAGDGAAAEAIFFAhAIAXFAATGDAFEEHgGDGMFIBfHFFhBAA...hAFA...,2,-17,1,18
ZOEBHSVPfKMReQYLCGdTcJWNgIUXDAFab,aAAAZAAAEADEHACB..SAFBVAEA.KAHBRCFAeBBDLCABdEAATEDAhAEAJCCF..NCFA.hABAgFGA.hACAIHAADCHBADGBbEDDBEHCMDIB.QGGChAHA....hCEA...,1,4,-16,20
JfDaHKGRZXYCFBWVgbIdeQUMLcPSTENAO,OAAADAAAHABCRADAZAGBCAEBBAGA....VCCB..bBFAeCFDhAEAMCCBLEHB.hAGASFFAEDDAADGAaEFAXFFChAIAFGAA.IHHA...hAGA......hBAA...,1,-23,-25,2
fDZORQIedBbPUTJXGcALSEKaWCVMFNgHY,EAAAaAAA...CACAFAEAHACB.DAEARAGF.eAFAdCCABBEDUCFA..TEBAhBAAGDFALDEDhBBAKDHB.MBIB.gFFBhBEAZEDBIHHAPHDC.....hAAA......hAIA...,2,-34,3,37
ScXfTbIBZWRVMYONdDFeQAKUgHGPCELJa,KAAAHAAAGACAEADEaAFA..XAEA..bBDAZAGBRCAAMAIBhAAAOCABdDEAeCEFACHBUEGAhACACDHALFFASGFDhCAATFAABHHA..YHFA.DGEB.hEAA......hECA...,2,-7,-2,5
WbUKZEcPBfJgYNLTDGdOFVHQMRAXIaCeS,aAAAeAAA...SADAUADAEAFABAHAJAGB....gCCAhAAALCGBGDBAhBAAdDFDFEABHFCARDDAABBBCFFDKFHBhBDAZEEAfGAA.YFHBTGDADCIBhCAA.....hABA...,1,-14,-15,1
MEXBCaRfPFGcNDHWOTILZQSgJdKUeAbYV,VAAAEAAABACA.RADF.FADAGAFADAGA.HDEBOBEELAHB.hAAAZEGBQDCAhBHASCCDdDGAeFAAABIBbEEBMFIBhAAA.aHBA..fGGA.NDIA.hCAA......hCDA...,2,-30,8,38
NFIXSKZUEGJeMORDCWBPcaTgQALHbVdYf,HAAAdAAA...fADBFADASAFHZAFBEAHFeAHB.RCAACCEDBCADhAAA.aCCAQDFAhACAACIBbDDC..VEGBhACAIGGAKFAAJHDAMEEB.DEIB...WFFDhAIA.....hAFA...,1,-6,-22,16
XAOZCQReKHTbUVSJDBcPLIgYMWfdNaFGE,ZAAARAAAHADBUAEA..SAFABAGALCAB..gBGAhAAAMAIBdDDAFCGDECCBAAFA.hABAQDACeEBHTFEAhACAbDFADEEB.IFFAfEHAaFDHOFHBhABAKGHB....hADA...,2,-18,-5,13
dQFDTWRSUOGJfcLXPKBMaIHVCZAYEebNg,EAAAeAAA....bACAdAEA.QAGADAGARBFF.OBCDGCCAhAAAfCFALBHBKDABhADAaDGDHEBAZEFAACCBgGGBhAEATGAASEHHJHDA.XGEAhAAA.BHHA..hABA...,1,2,-9,11
PFCcaWIfNTQdSZYKDeVAMUGXLJEHRBObg,GAAALAAAHADARADFOAFA..bAGBFBFDaCDC...fDFAhAAATCAAdCHAZEGBDDDBhABAABIBMDABUEEAEFHBBFCAhACACHDA.cGCD.WFAH.....hACA......hBIA...,1,5,-23,28
KEOcaAbPRXMCJYGWIdLSNFVQBeZHgfTDU,RAAAMAAACADB.GACBdAFALAHBFAGABBBDHCCA..TCEAKDFAEECBhAAAaCDH..ABHB.bCGBJEEFhABA....IFAAhAFASEHHQFFCeFBB..fGGEhBFADDIB...hBAA...,1,-15,-21,6
LGKDBJdROZPWEaAgQYSeCUfVIMTNHbXFc,QAAAeAAACADA.UADA..fAFAMAGBHCGBFAHBGDBAhAAABCCARCEAZDDBEDHFAAHASBHBhBCATECA.bFEDhBDALFABDGGA.dFFA......hAAA......hABA...,1,3,-20,23
NYdKMLfRIHUASDZTGagVOBCcFEWebQXJP,ZAAAaAAA.OACABADAFAFA..EAFA.eAHFQBED.XBBChADAPCCBdDFAMAIBhBAAREDBUGGAACHB.DCIBGDDBhCAACGCA.bFGB........hDAA......hDCA...,1,-18,-24,6
DISAEUeHKGfYaXRTNQBdWVCMbFcZLgJPO,EAAAHAAAGACAaACARAEF.QAEAdAGA.CAGA.bCCDZCEE.LEABhAAAJCHBDCCB.AAIBeCBB.hAAAfDHATFEABGDDhAIAMEFBFGHB..gGFH..hAEA......hBCA...,1,-4,-11,7
eVNHZWFPTRfaMUCJgILGXYSQDcKOBAdbE,EAAAeAAAHACAZADBFAFDRAFF..aAHDMAHB.UDGBCCCD..JCEFLCCDhAAAGDGA..SEAAhAAAQFDAKGEAAAIBbFGDhABANIDB...WDBDfHAB..hAEA......hAFA...,2,-15,-12,3
KfAWgRcBeaUCZXFPQMJHIbGSDYELNOdTV,RAAAeAAACADB.ZADBFAFAMAGB..HBDCGCEADAIBLDDAdAHAKDBAAAAA.hBDA....gDGHhAAAaDGDXFBAQGGAhABAIGGASHCAEHBE.OFFBhCAA.....hBFA...,1,-16,-20,4
EWSKQPGcXICBVUANJfdDFOLeYaHbRgZMT,JAAAdAAAOADALADB..eAGFHAFARBDBZCGBECFBKCHBGCBA..hACAXDCCBEFCAAIBDDIBhBAAaEFC..MFABTGGAhBCAQGGA.IHCA.CHEA..hBDA......hCFA...,1,-10,-18,8
IHacGKLFSOdBTeUgJPWMNYAQZfXDRbECV,ZAAADAAAEACACADBHAEB.GBGALAFA.OBBBdAGBeCABUCDAJCCFhABAMCGBAEEA..QFFChACAREBB.IHHAhCBAaDHBFFDATGGA.gGADhAGANICB......hAHA...,1,-3,-19,16
fJgQXEMDTHZUFdbPIVGANCRBYOceLSKaW,RAAAOAAAeADELAGBKADA..aAFAJBDBQBFD.EBBBhAIAMAIBHDCAZCEBdDGDbEGBhAAAIFFAACCB.BFHAhBAASGFBfHFBDFIB.....hABA......hCAA...,2,-23,-10,13
ZHdGWKMbCFLXRaIUEYcJNQDTAVOPfgBSe,OAAA..fAAASADAHADAGAFAMAFAFAHFRBFAaBCHhAAAEBBB...JCABQDCAhAEAADEA.gDGHhBAAeDFAdFFAbFGDLEEB.XGGAhCAA.....hACA...,1,-3,-17,14
OQgMEXcNAGIdWSDHULfJPTYbVFBaKZeCR,dAAADAAAHABCLADAJAEA...TBGA..bBFABAHBZCCARDFFQCBAhACA.ECFBhAEAXECAADDAGECBSEHHhAHAfDHAPHDAFFABeFHFCHHAMIAAhAIA......hBAA...,1,0,-19,19
VSWXDfYgHKAObJZPQGUMLRdIEeTcBCNaF,OAAAZAAAGAEALAEARAGBdCAA.EBBB.eAHHTEBABBDD.aCEDSCCGhABA.DDGBhACAfDGEHEGBAADAbGAAhAGAQFAA.MDDBCEEDNIEB.FFFB.WDHHhAFA.....hAIA...,2,-9,-3,6
VAFKcOGTDNfBJERLSMWZXUHIbeaYdQPgC,KAAAGAAADACABAEARADAMAHB..ZAFBHCDC.eCHHdBHAQBCDhAAACDCDAAABFEAH..TFFAhACAJDDFLEHB.hADASFCDXGAAIHHAaFED..hAEA......hAGA...,2,-33,-10,23
VWaYOXceGTAJDHRINLfPZBUSMCdFEKgQb,HAAARAAALADBZADBSAFAdAFAKAHB.QCAB.VCFAhAAAaCCBXCFAGEEAAAIBDEIBhACA..fEEAhAAABFCACGAAEGHBbFBB.ODHD.eFGB.hADATGEA.IHAAhABA.,1,3,-22,25
EDRQVBKOLWZgNYScbPXTGHUCMfAJIdaeF,dAAAeAAAEADARADABAGBLAGBZBFE.....gBDASCCBhAAA..bCBDTDFAhABAHDEAMAIBADHAaEAAQEDDhAEAODABYEHBXGGAGGBBfEHAhAIA....hCAA...,1,13,-20,33
bKSaNAJdFLMVYZUBHTGIDfECORQWcgePX,dAAAMAAAZABBHACCGADADAFA.EAFARBFA..QCCC..gBGAhAFAeDFAXEEChAIAbDEDKDHBaBBH.AEIBLHFAhBAA.UGBABFHDTFGACHBAODDHhAIA......hBAA...,2,-19,14,33
ZDUGgBAQTcYfbMXHVaRIJWLdPKEFCONeS,TAAA..fAAAMACAHAECRADAJAHBdAHAEBDB..OBCBhAAAeCCBZCFAGCFAAEEAQEFAhAAAbCAD.aFHDhCAALDDBFHFC.SDHH.DFFBhACA.BGAA.YHAGhADA.,1,9,-23,32
DILZTVgYGSUMEBbdeJHcPfAKFQWXCaONR,QAAACAAA.aACERACALAFB.ZBGBTAFAVCAAGECAhAAAMAIBECDABEEAeCGFhAAAHFGBfDAAhADAAACAFHAA.ODCBDEIB.gEEDSGFDdEHAhAFA.PFDB.KHAAhAHA.WHFA.,1,16,-9,25
APNJZDeBIcUagCdFHRSYOXfELKQGTWbMV,JAAAeAAABADBUAEA...aAGEdAFA.HBGBRBCB.OCCBECGALDFAhAAAGDEA..TGGAhAHAbEBAAEBA..ZFFADAIBIHAAhABACEDCFFBH.SHFA...hBAA......hBFA...,2,-27,-4,23
ZOgDAIXaePScEWUNYCMLfdKJHQGTbFVBR,aAAAeAAA...SADAEADAUAGACBBDMAGB.dAHAHBEBGCCAhAAATDAAFDHBREABZDCFDCFBADHA.hADA..XEFDhABA.PHBCcEECYFHBLEHB.KGBAhBAA......hBGA...,2,-15,2,17
cMLJabQTZDESGgCKFdYeUORfXBPINHWAV,MAAAaAAA..QADAZABEEAFAGBGAKAFAdAHAeCCARCCBBBBD..hADAIEEAHCECADIBLFEAhBAAbFAA.SFHHhCAAFFGH.OHECXGED...hDAA......hDBA...,2,-10,-10,0
RPEXDYVFcadAQGLfCbgTeBKINZSOMHUWJ,GAAALAAACADA.TAEAeAEHBAGA.KBHBZAGB.MBIBHCFBUCAAhABARDCBEEHFDCDB.FDFHdGAAhAAAAEEBQFGAhACA..fFFEbGAAIHEAOHDC.hAEA......hAGA...,1,-9,-12,3
gHUADFWKGaVfEPOcRCdeQMZbJTLBIXYNS,FAAAGAAA.aADAEADA.OAFCRAFFdAHAeCDBZCCA....bCFBTDGAhAAA.LECBhACAXDACSFEAhBAAHECAAAHAKCHBfFHACEHDQGGAMIDA..hBCA......hBDA...,2,-12,-5,7
ZWXcRSHGUIDdKBCbeLOQVPFYaTAfMENJg,EAAAJAAAZADB..XACARAFA.HAFAGCEADCCBdCFDCCCC.eCHHhAAALCHBQDDChADAFDAB.aEGHADGA.MFAB.hADAWFFDSGAA.KGFABGHA..hAFA......hAHA...,1,-7,-31,24
cIALBWMDbQOTgRVfXCGJPNaYeFUKZEHdS,LAAAMAAADAEA.QAEA.TAGARAFAXBBA.GCDAhAIAPCAAaCFCeCEBhABAKDHBHEBBdDGASDDDhACAABBAbFFB.OEABfGEACFHAYGEAhAEA......hAIA...,2,-9,-9,0
HXRYTJBVedPQAWEISLMaNKZDbfUgOCcFG,EAAALAAA.aADDZACB.DAFAUAFACAHAGBEAHCAARDEA..TDGAhAAABAHAeDHH.dFBAhABAABCBSBGGhBEAMEDBbFDD.OECBFGFC.XFGA.YEEFhCAA....hCBA...,2,-30,1,31
EIMCeBaVKcRPTfNFbJLODdQZgGUHXSWYA,EAAAMAAABACAKADA.RADF.....TAGAFAFALCFAdBBAZCEAGDCAhAFAHEEASCCDhAAAACIBeEEEaEHDVGCA.fGGAhAIAJFFFQGAA.....hBIA......hCAA...,2,-19,-4,15
MDVeWSLIHQafbCKZNdOBUEXRPJFTGYcgA,MAAAeAAALAEAHACCaAFA.CBCAZBFE.dDDABBBD.EBFFRDGBFFAAGCGAhAIA...gDCAhBAAAAAADFFBSGADhAFAQFEAKGDBUGGB......hAGA......hAIA...,1,-10,-17,7
UFPfWZIRKCbXTHaLcgOeVGDJQBEAMdSNY,dAAASAAAUADAFAFE....fADAZCCARCGB.CAFAbAGDHEFBhACA.aDBCLCCAhAAA.ODABeFHHDAIBhBAAQECAAEEBMIDA.PEFAKGCA.TGGAhABA.gGCGhADA...,1,-14,-16,2
EIFXJNdUcGgBWOYeTZMabVfHAPRKDCLQS,RAAACAAALACAEADE.FAGAXAFB.dBHAGBEBBCCAOCEBhAAAeCCBZDAF.aDGDbDFDHEDBhAAA.ADIBDEABQFCChABASFHHIEHA.NIAB.cGEDhADA......hAEA...,1,-9,-14,5
IXNPKQMfBVGCSRJTOHYaWgFALUdEDebZc,dAAAEAAADADAeADA.ZABB..XAEAKAGAMCEABAHA.GBCAhAAARDCAOCHDHCEB.aCBBFEABhAEAACHALDGBUFFA.hAIAbGFAIGDA..PHAA..hAHA......hBCA...,2,-19,-10,9
XcZfORJKMCUYaPeNgHFIQSdVBbWDTAGLE,EAAAZAAARAEAKACAUCAA..aAEA..eAHHHAGBQCDDdCCABBEADDFBhAAAAADAGDFALEGBhAIA.XEDDODHFMEEBhABA.CFAAPHAANDIA.FHGE...hBIA......hCAA...,2,-24,0,24
aCPBWYVHMLfcNTUJRSZDAKeXOQGIEdgbF,eAAAQAAAEADAdAGAFACE..CBEA.BAFA.VBGBHCCA.MAIBhAAALCDB.fEGEhAAATDFARFFAZGBAAAHAOFABhAFAIHHA..aFCC.PFFB.hABAWEHH....hBIA...,1,-7,-25,18
EIYBScPVLZQKROCAFDMUTaJXedWGbfHNg,MAAAaAAA..eACHGACBHAEAEAGEBAHBSBBDVCFA.ZCCFRDDBABBBhAEADCFAUFGA.JECFdDGAhAFA.bEEB..fGAAhAGAgGGA........hAIA......hBAA...,2,-17,-9,8
EWLcTQZHfYRaUKJdbGDXOMeCIANSPgBFV,SAAABAAAEACALAFAQADAHBCCRAFAKCCAdCAAGCFA.hAAAOCHFeCFAADAAgFDAhAAAFDHDVEEBTGAAhABAfDDEaGHB.UGAA.DFHB....hACA......hAGA...,2,-6,-2,4
HLOKPYAJFIVEdRDUNcTgQZCbeaXfSMGBW,FAAAEAAARACADADA..UAFA..TAFAZCCAeBHH..aAHDSDABhAAAGBCAHCEBLECBhADAKDGCABEBVFGBdEEDgFGAhAIACHAA.XGDD.BHBDhBHA......hCAA...,2,-20,-8,12
MeKJXQVOHTUDZACIFNGRfSgbEYWcBaLdP,FAAARAAA..SADBEADA....cAEDaAFAdBFA.eAHHhAAAXAGDQCCChABAHCCATDAAZDFEAEEBCFCAIFGAhCAAGDFAfDHEYFHB.LEEDhADA.MIAA.KHGAhAIA...,1,-7,-8,1
XBZgPMIFCNEdeDaSWOVAJHRGTQKcUfYLb,HAAARAAAGADATAEAQAFAKAGC.UDAALCAABAHAZDEBMBIBhAAAFCHDECEB.eCGBaDDH.hAAAOEAAAFHA.fEEEhACAbGEA.XGEA.IHCAhADA.CHHA.DGIB..hABA...,1,10,-14,24
PfeNCVAIOFUZKgTWaLDYEMXcRQSHJdGbB,FAAAZAAAKADC..TADAaAFD.LAFBDAHB.EAHBMAIB.RCAAHDEAhABAGCCABECAeCGHhADACEHA.ACCBODHD.hACAgFEBXFBCQGDASFCD.hAIAbGFAfHGFhBAA...,2,-18,-14,4
JXHWDKQfUAbTCVSRIMFGgcPaBNOLEdeZY,TAAASAAA.RACF.MACAGAEA..gAEAaAGABBGBLDGBhAAAEAHBeBDDZCFBhAAAXEAAHEGBKFDAQEDChABAACCBCDHB.FGEDNIAB.......hAIA......hCAA...,1,-6,-8,2
CgWVdTXUeBZOaFMPLDSbRKNJQGIcfYEAH,HAAACAAA.VAEAdACAUAEAZCAA.FAGEMAIB.LCEADCBB.REAAKEEAhAAAQCGAGEGAIGEAhACA.fHABhADAADDATDEAeEBF.aFGA.SGGBhAAA...hAEA...,1,2,-36,38
SeZWHMARFUIdPDObCQfgaKBVYTNJGcEXL,RAAAFAAAdADAOACD..QAFA.aBHDBAEA.TAGAhAEAGCEAECEALDDDhAAAeCHFHECAACCBIEHAhABAbGACCFGD.KFAA.VGFAYFHBJHBA.SGDHhAGA...hAFA...,1,-7,-13,6
ALWcbDYMZdFNaHSJKOeRXQgEITPCGVBfU,LAAA..bAAAMAEAdAEAFAGAHBCCKBGDRBFFQCAChABA.ECHFTCAAGEEAhACAfCHAAAIBDDDBZFBFaEHDhBFAODDB.eEBFIHHACEFABEHA.cFEChAAA.SGGBhABA.,1,15,-33,48
fUDYFeNWEQKHaRPcMJXACVZbLBISTgdGO,ZAAALAAASACEdAEAGAGAUAFAFCCHeCAA.EDDAHDFA.RECAMAIBhABAAAGBCDFABEBA.TFFAhABAfFBE.hACADFHBYFHB.NIAB.KHDA.aGGH..hBFA......hBHA...,2,-13,-9,4
YGBXdIEZMKfVWTUaJgHPReDCQcOALNSFb,LAAAFAAAGACAdAEAEAEAZAFB.MAIBKAGA....VCEATCAAhABAUEAAaCCDHEFC.eEEDhAEAQDGDACHA.hAIAbEBAXGGAIGGA.fHBBhACA.WFEH...hBAA...,1,-2,-9,7
PQERWYKUVHCLONBAIXdgFbaZcSJTfGDeM,dAAAFAAAZACBSADA..TAEAGAFAeAGHMAIB.ECBARDEBKCHBhAGAHDDBLECBhAIABDADAAHBXDGDaEGD.hBAAfGGADFIB.WECD....hACA......hADA...,1,-18,-20,2
NfcEUKTXWAbQIHgdJaRYVGDMCBPLFOSZe,QAAAHAAAdADARAFAGCABMADABAGALCFAOAHDeEEA..hAAAfBDAEEHFTFAAhACAABFB.IHCAaCEEDDBBFDGDhAAASGGAZEEFcGGA.....hAFA......hAGA...,2,-16,4,20
fBSbQYHTEDKIPAFRdeWLNaXUgVcZGOJMC,RAAAeAAALADB..aADDXAFAUAFA..VDBAGCEAMAIBhAAABCCC.bDGBHDGBhABAEFAAKGCAADGBdFEA.gFBGhBDAZGFE.CGGDSHBG..hBFA......hBHA...,1,-10,-11,1
QbASEBOYcgKRLPdWIJGUVXZHNDfeFTMaC,EAAAOAAA....gACARADAdAGAJBBFGDCAUAFAZCEAHEABhAEADAIBeDAAFCHD.aDHDQEEChAIAADAA.BFHAhBAAKEEALFBBIHFA.XGEA.hBIA......hCAA...,2,-11,-11,0
fcLZXVUFNdKQOJBGPYDagAEHeRWCTISbM,HAAARAAACADB.TAEA..SAEHMAHBLCAAZAFBUDCAdCEDQEAAhAAABAHAGCGAhAAADAIBACCA.EDHFeEEHbEEBXGAChACAFGFD.KGGA......hADA......hAEA...,1,6,-25,31
OWELIbZMVAGaQeDCTKNPUfHJScFBRXYgd,aAAAeAAA.CADA.KADAUAFAHAFB...SAHBBAHARCCA.XBBChADAdDGAEEEALFBBhAAAZDDAACEBGEGAQGGAhABATFAA....fFDA.FHDEhAFA......hBAA...,1,-12,-23,11
EJPQbRCZOfcKMYLdaDHFgXWAeVSNGBIUT,eAAASAAAGADABADAUAGA..EAFAQDBARBFAZCCA.fDGAhAAAMDABdDHAHECAhAAAXFACAAIB.IFEAhABATGEA.JEHBbFADOGBEKGGC.aGGH.DIBAhAFA......hBDA...,2,-5,-4,1
OABDGPHTbcLCKNaQfSEFVMUIWZgRedXYJ,GAAAHAAATAEALADAKAGC.aAGD.QCDAEBHFMCABICCAhAAAZDFBREAAeCHH.dGHAXCEAhACAOFDDAAABDDIB.hACAbDAD.CECA..SEEB.FEGD.hAEA......hAFA...,2,-1,4,5
AHMINTbDUQBLdCFaVfcgYeZRJOGWSKPEX,HAAAMAAA.TAEADAEABAGAdAGAFCAH..aAHDVCCA....hAAAfBBAgCGAhACAeBEBREAAGFEBKCDDECGBhBAAAAIBIHHAUEEBLFBBCEHA.ZFGB..hBBA......hBDA...,1,12,-22,34
QMEbcWCRfSZeNTGdKYLDPFgaIVBXUAHJO,HAAAQAAAEADE....bAFBCACARADFZBGBeAFEGCABdCFALCHBhAAAFDEDaDHDBECAADDBMEEBhAIAfFGE.SGHHhAAATFFADFDB.gGBD.hACAIHHA..hBGA...,1,6,-21,27
OLcSfDXMUJKZVQWgCERYTGbIBAePFHdNa,eAAAHAAAaACALAEA.SAHHXAEDMAHBKBCAZCDEQCCChAAACDGAREEB.GDFAhAGAbFAABEHAAAIBdEEC.OCHDhBGADFAA..........hCAA......hDAA...,2,-20,-6,14
FQADENWCHKUGdTMSRVJceOYXgLaPbBZfI,EAAACAAAHACAGACAdAFA.MAEARBGF...VBFAeCAB.OCCB.hAAA.XDFCaDEBBAHBhAAAZEBAFEGHAAIBDDIBKFEBSEADhACAcFGA.....YECBhAEA.....hBCA...,2,-23,-8,15
LNSWOPIMKcCGFDQJgHUdBAXVaEZTRYefb,aAAAEAAARACA..eACHLAFB..SAEAOAHBMCCBCAHAGCEAhAEAQDDCHCGDdDDChAFAACIBZDAFTGCA.hAAAbGFAPEGBKHAADBBB.......hADA......hAIA...,1,4,-19,23
WIQbgSMXBPJVLHNKUZYafOcFTDAeGCRdE,eAAARAAAEADE.QADA..bAFBMAGBBAHAVCCBHCCAKAHBZCGBhAAA.aECCOCGDFFEDADIBdGGAhABAgFBB.hCAAXFEA.PFHD.NIDBfHABhAAADEEA...hCCA...,1,4,-11,15
LREOZXVDFSPUHQWfAbgTCIYGaeMcKBdNJ,TAAACAAAGACA..eACEMAEABAFB.dAHALBEBEBDB.ZBGBhAAADCCBSCABhACAHCFAQEECABGBIFFAhAIAaDDHKEHBRGDE.XGGCFHGEWCHHfFCEhAAA.YHBAhBHA...,2,-11,-10,1
GeAfVIQWBaNHFbKUPCScZELDXRgTJYdMO,VAAAQAAA.aACEHADB.KAFACAFAZAGBEBHFLDAARCDB.hAAATDFAdDAAGEGAhADAAAHA.fDCEhAFABEEDbFAASEHHXFCCYFFFeHFA.NBIA.hCAA......hCDA...,1,-2,-7,5
ZWfdSeLOVAUGXaBDHTbEMPgJKQCYIFNcR,GAAAaAAAHACBEADAMAEA..JAFBKAHBQCGACBEB.FCDBRBFFZDGBhBAAdEEALFHBhAAAABBBBDEDDEIBTGFA.PHAAhACAgGFG..YDAF.hCAA......hDAA...,1,4,-27,31
fNPcUEKSGFQgHZbTWVAOMRdCJDYaLBXIe,RAAAdAAADADAaADALAGB.BBDAeAFH...fAHAhACA..cBEDEBDBGCBAhAHAQEEAHDFAbFFAhBAATEGAACIBMEEBCCCDXFBAIHFANAIAKGHBhAAA......hABA...,2,-32,7,39
caeWZICDPYURAbdfOSMgNFQGEVBHTXKLJ,dAAASAAAMADAFAGDEADA..HBDBKAFALAHBaBHD.eCCAhAAAZCBBDDGBUEEAADBBOEFHhACAQDACBEHATGCAhABAXFBAJFHBIHFACGHA....hADA......hCAA...,2,-20,-13,7
VZDWPHXbdETcaIYFNeQLKRGJOfCBUASMg,MAAAZAAADACAHACCdAFA.EAFE..aAHBFBBH.eAHHLBEDRCEB.GDFAhABAfDCABCCDABIBhCAASDHH.hCBAgFGGPFDB.bGCAIHHA.hAHA......hBAA...,1,-8,-27,19
OHdKZTCeLYAJGSURMEfPIVBWgQXbFcNaD,GAAARAAAEADE...fADAVAGB.BAFAQCCAFAHBaCDDHCFAhAAAZDFAeFAALEFAhACAAAAASFFAMDABIFCAhADAXGDCbFADDGIBdGGA.CHEA....hAFA......hAGA...,1,12,-17,29
TcWaZJKBXAGNeSfHDRFQMLEPgCdOUbVIY,eAAAHAAARADFMAEAEAFE..CAHB.dBDA.OAHDVCFA...TCFAhAAAaCACZDAEBBFCGEEAfDCEhABAQFCALEEAhBHA.gFGAIGHA....hCAA......hCBA...,2,-17,0,17
IbaLFYAdVESegKWGZRMHUJQNCBfDTXcOP,EAAAeAAAKACAZADB.HAFAQAECBBCADCFB..TBGAOCGD.hAAA.bCCCaEEC.LGDAhAAAAAGAdDGDSEEBhAIA.gGFAWHAGMEIB....hABA......hAHA...,1,-9,-24,15
IRdKLZbBCaXOgQTGHMUcWfJEPFDeSNYVA,RAAAdAAAZADBCADA...aAFDOAED..TCGAHAGBMCCB.UDEBhACAfAHE.hADAEDAADDDBeDEFSDHHhAGAVFBBAAAALFFAbFFCXGBA...hADA......hAIA...,1,-14,-17,3
CUTPDVHXLGJdMacABRWefIZNYgKQOEFbS,RAAAeAAAZADB.....gADAQAFAEAGASBHBhAAA.TDAADBIBHCDChAAAGDEAdCGAaCCHACCAfDGBhABAIEAAKEEDbFCDCGGAPEHD.LGAAhABAMFIB.BGFA.hADA...,2,-13,2,15
LAVYTaKJIDMSdWQCgEfFXONBZGHPRecbU,TAAAaAAA..KADADACAdAFA..QAEAEAHBFBBH.OAGFhAAAZCEAHDCARCCAeCHHUEGBAAIBVEEBhBDAJDAF..MFFBhADACGDDfGHABGHD.......hAIA......hBAA...,1,-7,-18,11
GSDgXZNWPcKLOQaBHEdIbVFfUYTMAJCRe,RAAAeAAAGADADAEAZAEE....PAFALCCAaBGE.HCFBECCBdDAAhAAAbDBC..FBHDfDFAhABATFGA.ADHASEGAhADANIAB.KFBAOFFHQFDChBFA.BGGA...hAAA...,1,5,-14,19
RLBZQVTbdYSNXDOgfWFeaJPKEIcHGUMCA,RAAAZAAAQADC..bADBdAFA.SAHBDAGAOBFA..hABAfCCEeCABaCCHKCFAhACAECGFHEDAGEEAMDIBhAAAACIBLEHBTGGAYHBAXFCB..hABA......hBHA...,2,-9,-7,2
YZHaPWRMfCGNbgTXeSUODVQcKILJBFdAE,EAAAHAAA.aACARACAMAFAGAEA...bAGBTBFA..eCCBhAAAOBHDQDGBhBGAKCCDLDABFEEHABIBZGFEfDEAhAAA.CECAXEGC.DFFB.hCAAIGHA.dHBBhADA.WHEG.,2,-6,7,13
RYbWHQUBZSeVTfOaMJEDKdXLPCIGAcNgF,...NAAA.RAAA..bADBHAFA.QBBAZAFBeAHF.TBDAOCCBhAAAaCFEEDHFdEEALEEBhABACDHAAAHAFEAD.UFBBBFHAfGGAhBFAMHFADICA........hCAA......hCDA...,2,-8,-8,0
FaYAQecOUCXVLNJdSPZDGTBWRfHKEgIMb,eAAAOAAACADA.LAEAdAFAZAGB.GBBBBCCA.RCEAHEECKCED.EFAAMBIBhAAAaAHD...AEFAUFBAhABAXGAA.JFHBDEHBhBFAfHEB..bFFD....hCAA......hCBA...,2,-32,5,37
aZSbRBOMKFPALdCYHQWeGcXDIEUgTfNJV,dAAAHAAAeADAGADADAHB.EAFAUCCA..TBGA.JCAFZCFARDEFMCCBhAAAFDABAAIBLEFBhACA.QGBAhADAXEGAfFAEaEHHBHHA.KGDA.CGGA..hAEA......hBAA...,2,-21,6,27
QNVTgGcOfYbLEdZKPMHWSFDJXBaACRIeU,RAAAeAAAQADC..TADAGAFAfAFBLAHBECCBhAAAZBFEMCCBHEDAFEHBXDDChAAAAFAACGGD.UDGAgFAAhABAOFFBdGHAKHBA.SHAADGIB.hAFA......hBHA...,1,3,-1,4
XLRBDJIOTNgYEaUFKPASZcGMCHdVWfebQ,ZAAAGAAAHAEAdADAVCAAeAFA...QCEARCFADACA.OBHDhAAATECA..gDBHhACAEEEEaAGA.KEEDAEHAMFHBhABAfEHELGCABFADNICB.FFGH.SGAAhAFA.CGDDWHCAhAGA.,1,2,-13,15
MZfGQUOHdFcNISaALXTVJRPWeCDEbgBYK,TAAARAAAeADE..EAGEBACB.MAEAGBDAQBDAHCFBdCCCFAHDhAAAICHAABGBLDDAhCAAXFCCVEGBPFCAhCCADEIBbFGDKFFD..fHDB..hCFA......hDAA...,2,-14,6,20
PKgVFZDGICNEcdAJXHOTReMLBfbaSYWQU,HAAARAAAeADEMACALAGBBAFA..aAGDSBDHQBDDKDCDFCHDhAAAGEEACDED.EDHFAAIBOCCHhCAATGCAfGHAhAAAbDFD..YFHB...hABA......hAIA...,1,-8,-15,7
CAEZePIGJMHSfNYFVcadRWLKBUTXDQgbO,EAAAeAAAGACAHADASAFE..fAEBFBHDaCCBRCFBLDDBhAAABAGBTCEAhAAAQFFBbCGBAAIBZEBAIHHAhABAMDIBVFFBdFCC.......hAIA......hCAA...,2,0,0,0
QbUFIPZLgBMfeTWOHEVCKNYDSJRaGcAXd,dAAAQAAAFADAZAFBLBHBMADA..eAFAOBDBHBDA.EBHFhAAAKCBBDDBAREDA.GDEAhBCAACHB.bEGBUGGA..hACAgGDDTGEACFCD.SGGD.hAIA......hBAA...,2,-23,12,35
ENKSPXLgJYFMUfbDOBaIGedQRWcVAHCTZ,HAAAZAAAEADESACELAFB.JAFAMAHBUCCADAIBBBFDGCAAeCFAhAAARCDB....VEGBhABAADIBTEFAKFCA.PFEBhAIAXGED..FGHB......hCAA......hDAA...,2,-16,-4,12
MTaEKfVbPHWLcCDBYFeNSAIUOZdgXRGJQ,OAAAdAAARADAGAGA..MAEAECBAKCEAVBCAHEAALBFB.hACADAIBFEEA.eDHHABBBZDGBhBAAXGAATFDAaFHDhBHAfGGE..WHCA....hCAA......hCHA...,2,-24,-3,21
DNGUVWbFQHMETBYLcCdRSOPAfJKZaegXI,KAAAeAAA..XACBDAEAGAGAUAFAVBCAFCCH..HDFA.EEBBhAAATDEALFDBdFBARFGBhAAAOAHFAAIBZGDA.aFFC.hABA..IHFA......hBEA......hBFA...,2,-15,-13,2
CGIWfRaYBDgSbcQVXKLdJZPUFAeEMNTHO,EAAAMAAAHACAGACB..fAFBRAGFBBBDSCDAQCCBhAAAKDCDdAHAZDFEFCFBAAFAeEEDhAIATDGA.CEAAaEECDFIB.hBAAgFGA..cGDC.XGGDhCAA...hAEA...,1,-6,-11,5
JgRZQLMWKSGPBcEVOIAFNaHdeDfXUYbCT,aAAAHAAA.eACEDADAUAGACAFB..TBGARBBAZBEB.MCCA.SDDAhAAAGDFABDDCEDGBOEHDhAHAADHAdEBA.XFFDhAIAJFHB..........hBIA......hCAA...,2,-33,-12,21
PZedNEWMHgJaQfIYUTVXGCLbcSRAKDOBF,OAAAFAAAeACHdAEA..EAEAHAGB.aBBCQAGA.fCEAhAEAIDBATDDAhAGAGCFALDHBhBAASDFBADDBBECDZEGBMFFBYFFFXGBAhAIACHHA......hBAA...,2,-18,-3,15
DIBSCfKEVeATOWbcPMaZRdJHUYFGLgNQX,TAAAOAAA......bADAMACARBGFHCCAFAFDGBDALEABhAEAQCGADBBBSDHHhAFAKDBAEEGBAAIBPECBhAHAdGGDYFEBXEEACAHAeHAAaGHB....hAAA......hAHA...,2,-8,6,14
HTaIWQSNCZRXgJUfDVeEBbAYKMdOLcGPF,MAAAdAAALADAGACBHAGBaAGD.QCCCCCBAZCEA.RDFBXFAAhAFAUEAADAIB.EEEBADDBKEEAhACAOBBH.FFDHTFGAhAEASFHH.NIAB.fFCBBHGD.hAGA......hAIA...,1,11,-28,39
SbVTeEAKdUORIJHZLfQBGYFNMWcDPCXga,dAAARAAAHADBZABBLAEAQAFAGCEAFCCHMAIBDAIB..CCGA.aDAB.hAFA.SDBAhAGATDFAAAAAOEEBJDHBBGCAYFABhADA.cFGBXGFD...hAFA......hBHA...,2,-24,-6,18
gJYEKTDBAMRbNeGCIcQSULVdZWfOHaFPX,RAAAeAAAGADACADA.QAFALAFAZCCAOAHFHCGB.FECAXDAAhAAAJFCF..EFFBTDFAhABAAAAA.MDDBIGAAhAGASEHH.dFAAaFHDgFDHhADA.DGGB.BHHAhAFA...,1,-1,-16,15
IFJdObDBHAgfUVELKWMZRTceNCaPGQSYX,UAAAEAAALADAMADAZAEERAGF....eBCBaAHDGCBBQCEChAAA.XDGAFCGHdEEADDIBhBAAHEAAAFCA.fFFAhAEAKFHD.WHFA.NIABCGHCSGFHhBCA......hBDA...,2,-26,13,39
geHVIaXcZUFTDOLdfYPGAbBMRWJCQSEKN,MAAARAAACADB...EADAKAFA..eAFAHCCAaBBBZCFB.FCHDOBHDhAGAdECD...fCCAhBAAPFAB.ACFAbDEBBFGAhAAAQECASFHHgGEA.hABAIHCA..hCAA...,1,-18,-27,9
TZCBGUAScKPOLFVWbaMNdegYXEQfRIHJD,KAAALAAAFACA.VAEA..aAEDdAHAeAGB..XCAAhABAECCBRCFBHEDBTDDABAHBACAASDFBhACAODHDMICAhAAAgEABQGGCfDHA.hCAADFFB.CGGA....hCBA...,2,-14,-8,6
USIRWTXPgJHbQafZBOKYACVENecDdGLFM,EAAAeAAAdADAGADALAFAMAFAUCFA.RCBB.TBGA.XDBAhAAAPEDD.HEFAaDHDZFFAhAAAKFBAABFA.CDHAcFEChABASGAA.WHAA......hAGA......hAHA...,2,-18,-1,17
RKYINcHeDLAPCSJUFgMEWVGXdTbOZQafB,SAAAFAAAEADA.GACAdAGAOBEDZAEAaAGARCCB...KCEA..hAAAIDAAHDFCeEEBhABAAAIBCCHA.gFAAhAFA.MFIBXDGCTGCAbFFABGGA..hCAAcGBA.DHFA.hCBA...,1,1,-26,27
IabXgUTYAfZWcSRHJNFCdQGMVBKeDOELP,ZAAASAAAHAEAFBHDdADAGCAABAFAeAGHECCBLDFB.aECEhABAbCCA.UEEBAACA..hAAAfEHARFAACCHA.hABAMHAADDBBOEHB..IHEAhAEA......hAGA...,1,-9,-19,10
YMICcEZPTNUGJbHfFgORAWXeQKdBSaLDV,eAAAdAAAaADALAEA.DAIBMAGB.CAHAZBDFTBCAGCBAHCEAhAAAFCHBREEAAAFA..QEFDhACASEHBIFDAhAHAEGCANIDB.UGGBfGGB...hBAA......hBCA...,1,-6,-16,10
dReEaZHIUOPfFScWMDNJQgTXALCVKYbBG,LAAAKAAABACBRADFEAEA.HAGBUAFA..fCAAFCCH.SCCAhABAMAIB.DCFBhACAQDFATEAAAAIBCDGDhAEAVFDAGGBB.eFFAaGHBOHBC.hBGA......hCAA...,1,-1,-30,29
WMcVCBdDTFReYJbPgLKOHaSfNGIZUQXAE,EAAAMAAA..CACAdAEATADA..RAGBeCCBJAFA....bBBDLEBBhAAAHCFA.aDGCfDDBhAIAGEDAZFFBQEGAhBAAAAIB.cFCADGABFFHDgGGGhBBA.SHCGhCAA.,1,-9,-17,8
WJNZXVcYULHbgaSKdCQEIMBfGTDeORFAP,JAAAZAAA..XADB..VAEAUAGAHCCAaBED.dAHA.EDABMCABhABAGDFAeCCBFDHFADGA.hACA...PDHDhBGAcECCbEEB..KHGAQGGCBEEC.DIBAhBIA......hCBA...,2,-15,-8,7
FTadfEbHOLGWNcSDIgBKMZPYXeUQVCJAR,RAAAaAAAEADEHACB.GAEB..NAGADAHBBCEAZCCAXCGA.hAAAeBBDQECAhABACEAAAAEAdEEAOEHBLDHBSGEAhAHAKFAAMFFB.YHCA...hAFA......hAIA...,2,-25,1,26
WUGRSOdaBIbZNEAgVFfcDKYeTLCPJQXHM,FAAADAAAeABALADA.CAHA.QAEAHCCAMCEAGBGA.RCCAdEEAhAHAaCGEBEAAZGBAAAIBVGFAhBAAKEEA..TFGAhAEA.XFAA.SEGE.hBGAOHAC...hCAA...,1,-11,-12,1
eafALdHCbTYPONURDEVBJKGXZQFIScgMW,HAAATAAAOACA.RAFADCCAEACEBAEB.GAFAZCEEQEFAhAAASAHBMCIBeCCBhAAAADDBdFCAbDGD..PCEBhBHAUGAAKFEDFGFHIHHAWHFA....hCAA......hCDA...,1,-3,-11,8
RSEHcgKPZITFCbLQJUVdYNeMXBfaWGODA,EAAAHAAAKACAZADB.TAFACAEB..LAGBQCABUCCAdAHAeBFFhAAAMCFBBDHA.aEFDhAIAGDGA.ADGBSEEDhAAAPFHB........hACA......hADA...,2,-30,-11,19
gYNVJHeKCTEbdGMOISZBUfLDPAaXWQFRc,aAAAQAAA.RACA...gACHVAGBHCDAeAEHCDAAEDHFGAGAhAGA.MBBBSEFBhAAAZDDAfEHAhAIALFAAADFAFFFHcFGDYGBANIAB...hADA......hAFA...,1,0,-7,7
OGBDCeEaXRIdVgULfQZHSMAJKFYbcNTWP,FAAA..bAAATADAOAEAGAFA.CAHA.EAHFRCCB.dBEA.UCAAhAAALDABZDDAHEGBACIBKDHDhADANICBBCGDeEFBaFDD.hABA..IHAA.fFHAhAFASFFD.....hAHA...,2,-15,-5,10
acABWGLJVUQSTYPeFbNgMHCKIRDZfdOXE,GAAALAAAUADATAEAeAFA..FAGA..bCDAMCAA.HCDAhABAKBHBRDBFZCGBdEEAEEAAAAABBDHDhACAVFEB.QGAChAGASGCB.NEIACHGAfFHA.aGFDhBCA......hBDA...,2,-6,3,9
GRULcMbWfEaDedAYKHQPFCZIXgSOJVBTN,HAAAQAAACADBZAEB...XACAOAGDBCADGAFARCCBLEFAhAAAbDAA..EAHBeECDhACAAAFBKDHBFGBHSEDHhAAATGEAUGGAMFFB.aGGADAIB....hBGA......hCCA...,2,-4,-2,2
YMPWJgVeDHbTAcaGXUZCKIEQRSNfdFBLO,GAAAZAAAKADC.EADARAFA...SAFAdCAALCCAMAIB.PCDAhAAAJCGB..eDHHHCGBhACAAECA.aDAHUGAAQEEChADAFEEB.ODDH.gGAAhAGADGGB.bGDA....hBAA...,1,9,-27,36
XeBKDbSFMdCPTZJaQWUHIGOfcYENLRVAg,eAAADAAAFACDdAEA.CAGA.ZADB..QBCAHAFAGCEAOAHD.hAHA.fCGFhAIAECFFRDGBAAAABEEDbEGD.MFGB.hBAATGAAaBBH.IHHANIDB....hAGA......hCAA...,2,-19,-11,8
ZBHYUfcMOTKNdDXPCRSeFgQaGVWbIELAJ,ZAAAHAAAUAEAMACAKAGAdAGA.DAIB..CCAA.RBDBeCCBFCCH...aDGAhAAAGCGA..bEFBhBFAEEBBAFCBBFHA..hBGAfEDAOHFE.TFEA.NIAB..hCAA..SGHHhABA..,2,-29,-14,15
ZOLJbTNCgIPWFBSfHYdMeKREQDGXaUVAc,ZAAALAAAJADA.TAEA..CAGB...IAHAFBHDSCAAhABAHCAAdCEDKCEAECHBGECAhACAaEACACCA..bEEA.hAIA.gEEBBGAAMFIBeEHBRGEADEEA..hABA......hACA...,2,-27,-2,25
GHUOKWbADNMeIQRYPVBXEZdcagLFfTCJS,MAAAeAAARADA..VADAEAGEZCCA..aAGALCFB.TEAAhAAASBBBHEGBKCHBhABAABHBDCGB.QDCAhBAABHCA.dDHA.FFED.CGGA......hAEA......hAIA...,2,-25,-13,12
LCHTQDUNSgcZBRKdJPXGaYbMOAfVEFIeW,EAAAeAAALADAHADATBGAQBGA.DBCBSAGEhAAAZCEFRDCBdEAA.XCCCGEGAaGDDhAAAbDEDADGBFHAACDHAgFAAhABA.KFHB.PHFC.OFCDhAFA.....hAEA...,2,-6,17,23
dOgDIWGaXHMRZcESbKNTfUPJQLeFBACYV,CAAAdAAADACAGADA.HAFARADAZAGBECBF.KCGA..TCBAUEFAQFAAhACALCFDeCHHhAAAAADBODDH.IHFAhAFAaEDBMFIB.bGACNEIA...JGEABHAD.hAGA......hBCA...,2,-21,2,23
KbXQBeIdAHLgVMEZcNRPSafDYTWGFUCOJ,HAAALAAAMACAEAEAZAEERAGB...aAHDDCAA..TCCAGCDACCFAKDGAhAAAbCFD.BEEA.eFCBhAGAAAIBVEAA.PFHDhABAfFGA.YFHBFHEA...hACA......hAEA...,1,-6,-10,4
bYKVHLTAcgJaZOGDFUefdQMEWBNCSPIRX,JAAAZAAAGAEA.FAGAeADEdCAA.EAGEBADBCBDA...SCCDhABARCDA..bCGBKCGAhACAHEFBADDAaEECDCCBQEGChBGAMDIB.NICB.IHHA.YFEFhAIA....hBAA...,2,-30,-16,14
YDIABOdFaTREUHMWSCebJfKQZXVgcLGNP,dAAAaAAA.EADAHACB.MAEACAFA..eAGHJAHBKBECZABB...XCEAhBAAgCED.GDCAhAIAPDHDDBIBABBBFEEBhCAAREGBSFFDQGFA......hDAA......hDBA...,1,-12,-16,4
LWHENTAIVcfBaOXRQeMGYgZKbDSUdCJPF,VAAABAAAaACA..RADF.eAEHGAFAZAFBDAIBdBHACDAA..FBCBHDEBhAAA.EEHBABHB..IDHAhAAAODDBMFAB.hCAAKGGAbDDC...SFFA..hCBA......hDAA...,1,-7,-39,32
ETYWMJKfXGcCBHSRgPNaeLVbAFIdZOUDQ,dAAAZAAADACAEADA....TAFAMAFAKBEAGCABBBGBHCFC.RECA.hACA..PCCBeEGBLHAAhADAABIB..hAHAODFA.QEDAWFHH.XFFBhABA.SEBDhBEA.,1,4,-48,52
cABOYTMGEaJegDWNRPdVUbCZXSfQLIKHF,OAAAMAAAGACB.EAGEeADA.DAHBRCCBdCFAUCCAZCGB.SEHHhAFALCFAHEAAhAEAABBBBFDAaBBH.JEFAgGGGhAIA.WFFDPFFB.bGBA.fHGFhAIA..hBAA...,2,-19,-9,10
eUMXPHDWQOZSgCEIKJLfacbYdRFBNAGTV,GAAAeAAAMAEAHADADAIBQAGC.ZCDACBCAEBEAKCHBLEEAhAAAaBGD.bFAARDDABDHAhAAAADABTGGAXEBChABA.OFFA.SGCA.gGGAhBEA..hCAA...,1,5,-26,31
HBbAgcPCWDdfeGYXJQKRFTaVNSULIMOEZ,...PAAADAAAeABAGADAJAEB..RAGB.aAFA...SAHHhBAALCCBMCGBECCBHBFBhBDAAAIBCDHA.dEFD.XFBAhBFAQFDATGGAUGAA.ZFGB...hCAA......hCBA...,2,-22,-3,19
HRVLgWQUPTXJCAZSYdcGKbNMDOFaIfEeB,ZAAAdAAAGADAKADC.MAFAFAFD..aAHBEBFEHCAARCAA.LDEAhABA.QECChACATDFACBHBADHASDHHhBIA.bFFCOEHD.eFDBBGDAWFFD.hCAA......hCCA...,1,-10,-16,6
AgKYDeQOZGcPWRHICaTUNfXMEBbFVJdLS,KAAAeAAAZACBGADA....PAECHAFAaCCHUCAAXCFAhAAAEBHF.bEFAFCFBdFAAAAHADDEBhAAAQGEA.hACAOHAERECBTFFAfGHEMDIBBHEA.hABA......hAFA...,2,-18,4,22
LWbZESXYPdBOIHaJUgCTDFNGeQKAcfVMR,VAAARAAALADB.ZAFAEADE..SCCDXAFB.dCFAOAHDhAAAHDGBaEEHUCDATGAAhAAAFDFAeEHF.AFFAMHBAhBHAYFDF.BGGD......hABA......hAGA...,2,-17,-10,7
TMdCNXUJOFgSAEPbQWfcBHDeVGLaYRZIK,EAAAQAAA..fACAHACAeAEEGADAaAHDRCDAZDFETAFAhAAAdECACFGAUDFA.FFAAhAFAAFIBbGCABAHB.LEHBhCAAKHAA.MDDB.XFEC.OHCChCBA.SHGGhCHA.,2,-3,0,3
MHRVAJUgcXbSEGfLNZKTeDIdCWPaFYOBQ,UAAAXAAAEADAGAFALADA.ZAGBeAHBdCDA..CCFC.aCBEOCHDhAAAMCEBHDGB.ADABJFBAhADAbEAB...fFFEhAIATEFADFABIHHAFFEHBGHA...hBAA......hBCA...,1,-9,-11,2
KYEVHcWQfSaPRGNDTAJgCObUXIBLMZeFd,CAAAOAAAUACA.BADAZAEB.dAFA..EAGAHBGB.QCCAhAHAaBGERDEA.GEDBDCBBADDB.bFBChAIALDHBFFHD.KEBAhAAAcGED.WBBDSFGD..hBCA......hBEA...,2,-33,-1,32
ePWFJQbcZOBMCgGUDREfSIVXKHANLYTad,LAAAaAAA.eADHFADAQAGAZAEBBAGAMAIBGBBB.RCEAEDHFhAGASCAA.hBAAXCFDHEFBAEEBYFHBhBBAdFFAPEHD.JHCA......hABA......hACA...,2,-20,-4,16
dAJROLFVgHaPMCBcISNEYTDGZUKXWQfeb,RAAALAAAFADAHAFBaADD..MAIBBAFA.SAGHECCADDEBZDFAKCAAhABA..QFFAhAAAeBHHACFBODDB.gEFBhACACHAAIHDATFAA.GGDBhAFA......hAIA...,1,-16,-17,1
WDGIHFNeBLgVSXOfdYAJTcURZQPbEKCMa,TAAARAAAZADB..QAFAEACE.MAIBaAEAGAGA.HBEBhAAAeCCDLCCBhAIASCFDfEEEhBIAAAAAcDACbGEAKDHDDDIBFEEHBEGDXGDC.dGGAhADA......hBHA...,1,9,-13,22
RSPbgaVQMKJZGNeODHWUIcETALXFBCYdf,LAAABAAAdACARAEASADH..bCBAaAFA...MAIBhABAZCFBeBHHHBEBICAAhACAEEAAAAEA.CBGDfCCEhDHAgFDBQGGAGEEBDGHB.WHAAhAAA......hAHA...,1,-7,-28,21
DBIFLRMVdKUaJOfQGgCZEXePWTNHbcSYA,BAAALAAARACAdAFAaADD..OAHBGAFAZCAAEAHB...eCABhABATDFAHDDB.bDGDSDHHhAAAAAFBFCCH.MCEBhACAKGFD.UFDB.QGGACHHA..hADA......hAIA...,2,-22,2,24
VQgHYERTefNJGcXDFbPIdUMaOLSBACWZK,ZAAAQAAAHAEARCAAeAHHJACE.GCFADAGAFBED....bEAAdBGAhAAAMCEBaCDHLEFAhBIA.ACIBKGCAgFGHhABAEGEE.TGAAfGGBcFDD..hACA......hADA...,1,3,-22,25
NaTYbKIPQZSMRGfcWCeFVEdLAOUgJBDHX,OAAAUAAABADAHADA.aAFA..TAFAKBBDQCDBZCBERCEFGCGAhADA..fBHAhAIACAHBeFAA.EDFFACIBDFGBhAFAXEGA.bGCASFHHcGGA..hBAA......hBCA...,1,2,-23,25
JFCWaKEPMbNHGeODTcRYXfQSUAVdBZILg,dAAAZAAALADBFADA.aAFAEAGA.MBDBHBFAGCEAeCABTDEAhABARCGB..XCAAhACAQEGAABIBBFHAgFBAhACACGAAKGCA.PHDAOGFCDCCB...hAGA......hBAA...,2,-19,7,26
EgUSCFKXMYIOGLacbWPNJBfVHTZRDQedA,EAAASAAAKACA.MADAOAEA.GBDBaAFE...bDDAPBCChAAA.BBHAHEGBhAAARCEAeDDBAAIBCCCDFHBAXDGAhABA.LFFBNIEB.fFHEhAIA.....hBHA...,2,-22,-7,15
RCGIFPgaDQMfOSZVTUdeEXcYAHKJWNBLb,HAAAKAAA.JADABACBRAGF.GADAFCAH.aAFAMCCA..OAHDhAAAZDDAUFDAECCB..XBFDhBFAACIB..NEIA.bEFAhCAACFGA....IGAADEFAQGGChCBA..SHEAhAAA..,1,-22,-24,2
OFbMWfTPAaHgBVeLdERGXQDYSUKCcZINJ,HAAABAAAeACAEADERAFFGCABQAFA.DAIBSAHB.hAAACCHDZDFAICAAOECChAAAbCCAMFAB.TFGAhACAACCAaDFDLDHB.dECA.XGGChACAKGFD.JHBA.WEEDhADA...,1,8,-18,26
IAGFgcUdWLOHTYeaBZSRMNfDKXPCEQVJb,GAAAFAAAUADAdADALAGBHAFAeCEF.ZCGBRDBA.MDDBDAIBKDFDCFAA.hAAA.EFEF..QEGAhBAAJFHBAAHA..cGEDhACATGBA.aGGC.BBFB...NIDB.hBDA......hCAA...,1,-1,-29,28
GEUCFeSgYfQBcTZIRdaPAXMWOKNJVDbLH,MAAAKAAA..VADALAEAHAGBGCAAEBBAFBHD.eCCB.SDGAhAAAfCDAQEEChACATDFARFAAaEEHAAIBOFHBhADADEIBCGGA.BGAD.ZGDA.....hAFA......hAGA...,2,-25,11,36
EWdfTDSVeABLOYMCNRHUPQacgGFIZXbKJ,LAAAMAAARACA.HADBQAFCaAFAGBFAZCCAKBHBECAA..dCHATDGAhAHASDDD.hAIAAAIBOEEDCECAUFGBgGDAhBAAXFBCWHFADBBBBEED...hABA......hACA...,1,-7,-8,1
XaEFLPUbQWINGYRZeTcKVAJSMOgdfHDBC,MAAAdAAAHADABADAaAFALAFA.UCBAbABD...QCFAhAGAICFAGCGAhADARDDFeDHHKFCDAAIBODCEDFFBEGGBhAHAFFFB.NICB...YHDA...hBAA......hCDA...,1,-9,-11,2
IAbNDUKTYEOLFZXJaCedPMWSfVBQgHcGR,DAAATAAAEACA..LAFAZACB..aAEDeBBBdAGAMAIB.SCADhAAABBDAHCFARDEAADEAhACAbDDDKEBAFEHB.CFCCfGAAhAGAQFGAGGBBIHCANIEB.OFFDhAHA.....hBEA...,2,-7,-4,3
eWZHcQAUVRgKdLaBGJCMbONTIFXYDSfEP,RAAAdAAALADBGADAMAFAOAFA..TBGAFBFBDBIB..ECBFeCCDhAAAHDEBACHB.UEGAKDGDBEEAhABAbFBB..XGDChACASEHH.fGGEWDAD..hCAA......hCDA...,2,-34,5,39
REVSfBJOCLXTcZGaeYUbAFWgIDQPdKHMN,FAAA..gAAAQADAdADAHAFARAFAECCBfCCA.hAAAOCFELCFATEDAhADAGEDAeEHBbFABAAHADFGBhBAAMFFASGEHCDBDXGGA....hABA......hAFA...,1,-1,-8,7
SabTBOVcHZLCENPAQeUGFWIMJRYDdKgXf,eAAAGAAAFADDMADARAFA.dAHAKCCD..XBFB..aCFCbCDBhAAATEDA.OCHDhAAAHDBBZDGBLFABhABAEFEAADDBWEHHIFGA.DGIB.SGEHhAFA.BHCA..hAGA...,2,-21,-1,20
aTQcFHVAfbePXISDEZJLMgOGKUBRWdCYN,eAAAXAAADAEAZAEELADA..MAIBGAGABBCARCDAdEAACCEA.hAAAaDCHQDFAhABAHEFAAAAA..fFEEhAEAIGCAEDDB.OEHDKGHB...YFFFhCAANIAB....hCBA...,2,-32,4,36
KHJacFdACQXONEGYDSZLMUPIeWRfbVBgT,QAAAOAAAGADASACAZAFALCGBMAFA.UDBA.eDEHhAGARBDAbBGBBBBD.TGEAhAHAHDAAaDFB.dEGDhAAAADGBXGGBEGGADEEB.......hADA......hCAA...,1,-4,-5,1
YgDFTfPRVcAUXMESeBQNbZICOJKdaWHLG,MAAAEAAABACA..QADAZADBOAFCdAGAHCEBGBBADCCBFCGAhAAATDEA.RDGFAAIBSEGAhAHAeEDB.bGDACFBDaFHDhBAA...........hAIA......hCAA...,1,-8,-27,19
BCJgAIeZcGDHYFObEaXNRTdKLUSQPMfWV,eAAAGAAAHADAOADAEAGE...aAGDRCCBdCFALCDBQEGAhAAAMAIB.fFAAhABABCFDCDGAAAABZDBBDFFBFFDD.XGGChAFATFEASEHHWHCG.gGBAhACA.IHHAhBCA.,1,10,-24,34
PTeJDVZCIAMXgKHQEUbBYaWOLFcdfNRSG,MAAAKAAAHACBUAEABAEA..aAGELAGBdBBA.RCABGDEAhAAAeCFADDDBZEGBADIB.QFCChACAEEBB..bEDDOEAHhAEAFFFA.NIAB.SGHH.PHAChAHA.....hAIA...,2,-16,-4,12
bZOICBYDGfQAFTdPRJHNMSeVagLcXKUWE,dAAARAAAHADBMADAeAFA..aAFELCGB.KCCDEBDBZDAFCBHADCCBhACAGEEAACFA.FGAHTDEAhAIANCIA..SFDDhAAAgDGB.XEBA.UGFA.hABA......hADA...,2,-21,-2,19
ZJPVRWFIagfCcEebYUHABXTLDMQGSOKNd,TAAAMAAAGACB.KAGCZACB.VAEARCCBFBHD..aAHDCBBD.ECABeCFBhAFAUDEAHEGB.AEFBLGCAhBAAQDGANIEB.hCAAdECA.PHAA.gGGA.hCGA......hDAA...,1,3,-7,10
UMNGdBISgCYEPWXKFQOVaTbZRfALeHDJc,HAAADAAAUADAGADABAFASAFA.CBHAECABXAGD.hAAAQBBAaCCHZDFAAAFAeFFBhACAMDEA.dGCAIEEAhAIAPFHB...FDHD.TGEA.fGGBhBAA..hBBA...,1,6,-43,49
CKeARHXMSgPYBFTEdbfNJUWOIQGDLacVZ,HAAAMAAA.SACE..gACABAFAEAHBdCCA.bCDDhAAAfAFA.hAFAUCEBOCFCGDGAhAFAaEGAZFCAeAHBAGGAPHCCTFEAWBBDDGIB..hAIA......hBAA...,1,1,-24,25
gXPRALOdJICYaWZKeFGESHDNTfcVQbMUB,dAAACAAA.aADAZACA.eAEEEAGA.HCCA.DAIBTBDA..fCGAhAAAQCBDMDABhADABBHA.XCFDhACAADIBLECAODHDIFGAKEEDGGABSFHHhAHAcFGCbGCA...hAGA...,2,-18,-8,10
RZYGXdVBFSUIcbeWgCKNAQJTPDEfMOHaL,TAAAEAAA..MADAHACBRAFAGBCAdAEBFAHBSBEHUCFB.hAAA.bEBDeCAB.CCGDACIBhAAAQEEBDEEAaEFE.hACALFHBXFGABCBC.IGGAhAIA......hBCA...,1,-8,-9,1
CPLNgVEceDWYUXaAIQSfTRdbMKZFJOBGH,QAAATAAA.RACAdAFAMACAZAGBFAFDBCDAHBDBLDAB.hAAA.gBGHhAHAEDEFeCHHDEGBUEFAAFFBSFHHhAAAbDBDODHDCHHANIBB........hAIA......hBDA...,1,-8,-11,3
CEMVNLHKcURZFYIGPebSgQDfdAWOJaXTB,OAAAaAAABADA..EADAMAFALAGB.HBDCKBBDRBEAZDDAFCDHGEGAhAIA.eBBBbDFA.hADAQGBAdFBA.hBAAABIBWFFDTFFA.CGDANIBB......hBFA......hBHA...,1,5,-26,31
LZYAVFaPegbNGKMTWcDJBRHEUdSCIfXOQ,aAAAeAAA.....bADAGACA.MAEATCCADAIBRBEFHBGBhAAAECGFdEBACAHBXCEDhABALEEAAAEAFECH.gEGAhCAAKFHBcGBDBGHASBBDOFFH..hBAA......hBEA...,2,-19,4,23
DRUdXObFfGAaNgcSMHQVYJECWPKIeBLTZ,aAAA..gAAAMADAHAFCQADA.VAFAEBBBCBDAKCCAhAAAeCEFLDABZDFBRGCAdDBDhAIAbCFAGEEAACIBSGHBhBAAYEHF..WHEA....hBDA......hCAA...,2,-7,9,16
UBcSfWDXeZNKYOHQAabCRPJdgMLIETGFV,aAAARAAAdADALADA..EAFAGAGAFAHDBCCDSBBDDCFBZDFB.hAAAKCCCHEDDAAEACCEAJDFBMDIBhABA....TGGAhAIAUFAA...WEEDeFHDODHDPHEC.hBAA......hBIA...,2,-23,-8,15
MLWGVPYCSXJcFDOeIaUZdNbRAKQgHBETf,QAAAHAAAEADEMAFAGACB..PBFCSAFE.XBGAhAAAFCAHeCCBaCDCdDGAhAAARDAAADAABCEDLDGBhADAVFEBCEECDEEAIHHAZFCAKGHB......hACA......hBIA...,1,5,-8,13
OYUeVERLMFHQWXSIDgNTfZaKJbcPAdGBC,GAAAOAAAUAEAEADARAFALCDBHAGD.QCFBSBBADCIBhAAATDDAZFEBKEHDbDFDADABdGAAhACA.BGGDeCHH.hADAMEBB.FFDH.IHHA.NIAB..hAGA......hAIA...,2,-5,1,6
ZBdLTFGXfOcCENRJAaDbPeSWgIVYUKQHM,aAAADAAAeABA..SACH..gAEAIAEAUAGAhBAAHAGBZCCAdCEATDGAhBBAGDFAODHFhAFAEEDBRFFBADDA.WEEDKFHBMIBAFHGE.fGBBhBGANIAB......hBIA...,2,-15,-5,10
JREPKQaMGOXBIZDCHSTNWfFAeUdbgVcYL,eAAAdAAA..VADALAEARAGF.EBCFQCBAGCEABBHAZDDBHDFAhACATECA.fCGEhAAAACIBbFFA.gEGAhABAJDAFaGAC.MFABOHFCDGIBNIDB...hADA......hAGA...,1,2,-1,3
BSECXdZPeLKfQJaYOVFUgIbARTWMDcGHN,RAAAMAAAGADAHACCBAFAEAFE.dAHAZBFELDAAQCCC.aBBHOCFChAAAFDFD.UEFAbDGD.hAHAACCBDEIB..SEEDhAIAXFAAeHBA.KHFA....hABA......hADA...,2,-14,-1,13
RUbSQKcAMaLfCYVIZgeWOEdNBPHTFXJGD,aAAALAAA.CAEA.IADAeAFH.EAFAdAHA.BCAAHBFCTCCAhABAXBBC.GCDAhAFARDFASEAAQDFChAIAAEAAMEEBfEHAZFFAOHBCFGGHDIBAKHFA.hACA......hAEA...,1,4,-12,16
gWfVUREIbYdcDeNTGXALHJZQPMOSFaBKC,HAAAZAAAMACAFADAaAFDKAFA....CAHB...fAHARBDF.hABAECABbCFAdCCA.eCHFhAAAGEFAADFALEEBhACAQGCASEGDBEHDWCCDIHAA.hCAADEIB.....hCBA...,1,-1,-25,24
UETGHbKAFgDPJBLcCSIXWZYVRdaQMOeNf,DAAABAAALADASACA..XAGDZAEBRAGBdCAAaBBB.MCCAhAEAeCCB.UDGBEDDAHDFAhAFAAAIBFEEB.JFFF.CHDAIHHAhAIAVFGB..QGCC..hAAA......hACA...,1,-12,-16,4
XCVRLWJBZgIadEQbNDfFceAHSOMUKTPGY,HAAAMAAAKADAGADA.CAFARAGFLAFBBCADZDAEaAHB..EDFBQBBChBAADCIB.FCHDACCBOEGDhAAATDDAXEGChBIAVFAA..gGDAbFCAfGHAhCAASGHH...hCBA...,1,-2,-20,18
SDBNdKZCPeREJTXVGfUIHaYgOLFbAQcMW,MAAADAAAdADAZABE..eAFAEAFA...TCBAGBGA.UCCAHCFAhAFAaCFBODEBLFAAhAFAABBAQFFASEFHhAIAKFCBCFHA...........hBAA......hBIA...,1,-18,-23,5
eMVNRTUZSJDGHKQLCXbBcOFaIAdPWYgfE,dAAA..PAAA..gADAEADAeAFAMBIBRAFFZABBDAIBHCCAhAGALDDBXCFBBCHDhAEAFECHADHB..fDFEhAHATEEASFHBKEHBQGGCCGGA.hBAAOFFH...hCAA...,2,-12,-9,3
ZSUPDTbeVcKWBNCfJFaAOLGYEHQMRIdgX,GAAAHAAARADFdAFAZADASAFEDAHB.eAHHKCADBCCD.CCHAFDEDhAAAAAABLCDB.hACAECFBMDGBXEAAhACA.TEGAbEGD.cFFCNIAB....hAEA......hBCA...,1,-14,-27,13
BAXZMgdaCNbOQTPIVHeWLRfJEYDcKUSGF,ZAAAdAAAaADACADB..OAEDQAGA..TAGAVBDBHCBBhACAeCABLDDARDFA.hAGAECHFDFFBKEHBSGCAhBAAGGABACCBMFFBgGGA.NIBB.IGGAhABA....hACA...,2,-18,3,21
ZIMSEBKfDLVdFGTANgQecJCaYUHbPRXWO,QAAAeAAACADA.aACEHAEB.RAGBOCCBZAEBMAHBBDEDDAIBdCDChAAAGDFAABGB..NDAA.gGAAhAAA.JFHBhABAbDFA.XFFASHEGEGDB....hAGA......hAIA...,1,-11,-12,1
CAeWPJXHgNRYaISfQTdLFBKMDEZbVGcOU,eAAAJAAAHADBRADA..aAGASAFA.QCFAdCCALCFAhAAAKCCDEDABbEACGEDAhABAOBHDAAFAXFFBhAEA..gEEBIHBAFFHDMFHB.DFIBhADA......hAIA...,1,5,-18,23
faAHUFJCTdOBLMKWeXQNIcbGgRYZESPVD,HAAAFAAACADA.dADALAFAMAFAKBFA..eCCAQCAB..hAAAICGAGDDARDGBEDABhADASBHBDCIBAAGATDEAhBAABFBA.XGFCbEGD.....hCAA......hCBA...,1,-4,-33,29
PfRdGSOKXQUDYEBcNWgaMCeTIJLFHZVbA,RAAAGAAAKADC.QADADAGABBEA...NAGA...aBFDeAHB.hAAATDCALBHBHDGBhAAAZCCFADABdFBAXEEBhABAEFDAgGGAMFHBCGFAFHCAPHCC...hCAA......hCHA...,2,-31,17,48
MgBQbXfJOKRaHLZdTWeYcGEUDVIPASNCF,CAAAMAAABACA..QADA.XAFAOADDRAFA.HCAAhAAAdBBAeBHHGCEAECFFDCHBhACAIDDAAAFAFEHD.bEFAhAGAKGDAZGEA..........hAIA......hBAA...,2,-34,-13,21
RPdcVHJNBODMgFWTbAZUXYSKCfLaQEeIG,ZAAAXAAAKADCLAGB..EADAeBEFRAFAdCDAHCAABCFDMAIBhABAFCHB..TDAAABGBSDEHhACAaEFBGGABPEGBhCAAVGFA..OFHDDEIB...WHEGhCCA......hEAA...,2,-17,-3,14
SIbHdMVUgPeQLXGRCEOcDFfWAZBTNJKaY,ZAAATAAAKADC...aACASAFA.HCAAdAFAMAHBUCEAeAHHhABALCCBREFAEEDBDAIBhAAA.fCEEhBDAADIBBGAA.YDGFbGDC.gFBG.hACAPEEB...hAGA...,2,-12,-10,2
SRHUbdCNIcaBDTAGgVZXQJPFWEMKOeLYf,GAAAZAAAQAEAFADAEAGA.MAHB.eCABLCDA.SBHHhAAAHCCCdDGDCEFDIECAhACAaEAHTFGAAEEAXEFAhAGAPGBC.OFCE.RGEANEIADAIB...hBAA......hBCA...,2,-11,1,12
ZNaDHAMXdYIfBWVKPECcJTOebQRUGSLFg,dAAA..fAAABADAKAFAEBHFCADA..TAFAeCAA..RCEBGECAhACALAHBZFABaBCCHFGBhADAACFBMDAA.XDEAhAAAIHEAPEDB.OEHB.bFABhACA.SFFDhADA.NIEB.DFAB,1,-10,-16,6
NbHgWBfEFOcdLMCRKQUAZSaGXTVeYJIDP,aAAAGAAA..TADAeADAJAGB.DAIB..bAFBHCDBBAHAEDGAhAAAOBBBdDCCLFFAhACARCEBQDCCAADASHFAhBAAXDGD.IGGA.PHCAhADA......hBAA...,2,-19,-6,13
gcbDIWARQEKdOVLBfaGHUMTJZeNYXFSPC,EAAAdAAALADABACAGADAHAGB.MCCAZAFAeCCB..XDDAhACASCFACDGDbEABDAGAhAAA.ADIBREFAQFGAhAEAKFED.fGFEaGCB.....hCAA......hCBA...,2,-21,-4,17
aIQNEPBHKASTGDMYLJUgbOXZRefcCVFdW,GAAAMAAALAEAUADAOAFCRBBA..eAHHCCFA.dCFA.aDDBQDDChAAA.ECHBhACAHEFCAAHADEGBgFAAhAFAZFGB.fFDAFHEGWDBH.IHHAhAGA.....hBAA...,2,-22,-1,21
bAIeEfRYWVgdNFQJBPGTaKcLOHZMUDXCS,EAAARAAA..VAEAdADAQAFABAHB.GCBAaCCALCHBhAAAHDDBZDGBMDAAXFADhAAASDEAAAIBeFHH.fGDEhAFAgEAAFGFHTFDA.OFFDhABA.CHDDIHHAhADA..,1,3,-7,10
YOKDbcSABQMeXfHETRNWJLPVFGCdagUIZ,MAAAeAAAHADARACA.JAHBLAFB.FAHBdCCAUCCBZCFFKDHBDBBB.hBAASEDAACIB.hCAAQFAAEDGF.hCFATGGAPEHDCHAD.aEFH......hDAA......hEAA...,2,-27,-12,15
YAfKeHbdPEWIaGQLOJgMcBDCSTZUFXVNR,eAAAHAAAdADAEADA.aAFAGAFALBFA.OCABMAIBDCCA.TDDAhAAAZCCAXDFDhAAARDGFAAHBKFBA.bGBA..IHHAhABAQGGAJFFF........hACA......hAIA...,2,-8,-5,3
YTRfWOLQAGVeKXDSCgdUMIJNaPHbFBZEc,eAAADAAACACA.dAEA.MAGB..IAEA..aAHBHAFBbBAAZDEAhAAAEAHB..TCCAhAIAREBAOBHDABBBGDGAKFFASFHHhABAgECA.UGEA....hBAA......hCAA...,1,-9,-20,11
UEPMdRDLfCHeZIXGAgKYJWaBFSQTcObVN,KAAAJAAABADBQACC..OAED..bAEBUAGAEAGAdCGAhAAARCCBLDGBHCDBeDHHhBIAZFEB.GGDBADIB..hCAA....gGBA.aGHD.hCBA......hCIA...,1,-5,-34,29
aWfbZUMXYIOENGLJCFdSgKDPVcTRHAeBQ,eAAAaAAA.....bADAZACB.MAFAXBGDOBBBGCCAhAAALBFAFEABdEFAKCEDDDGAhBAAPEHBTEBAHFDBABGAQEFAhBEAfHAB.IHFA.NEIACFEDhCAA......hDAA...,1,6,-18,24
AXPJaVDFSRfHLZUNgdQTcMOCEIKWGbeYB,XAAAaAAA.FADARACFHAEB.ZAGBUAGAdEAAQEDAhAEAMBDBECEB.KDHBGDFAeBBDABIBhAGAPFCBDFFA.LEHBhAAATGBACGGA..WEED.....hBAA......hBGA...,2,-12,-5,7
GIVeJfHaBcQgdUbLXSZEOTRWFNAYCDMKP,DAAAMAAAGABB.eAEEHACCBAHBQAFCdCCDLCFAZCCAEBHFhAHAREEA.FDGHACGA.KEED.IGGAhAIAJFHB..aHEAhBAA............hCAA......hCBA...,2,-26,-18,8
XcIJLafEGRMKHFgSbCTPYOVBedQWZNDAU,XAAAJAAALADB..EADARAFAHCEBFAFD..SAHBhAAATCGAOCCHeBGHdCDAZFAAAEIBhAFAIDAA.GEGAhABAMFGBKFHDbFDBCGFD.......hAGA......hAIA...,1,-2,-14,12
JLGAFgWZCIXMTOSbaEKBNVDQRcHfUdYeP,FAAAZAAACADBMADA..SAEHEAGA.BAGADBDARCCAHCAAdCFAeBHFhBAALCGB.AAIB.IFFAhCAATDEAaEDHKEHB.hCBAQGAA.fFHA.hCCAYGDG..hABA...,2,-28,-27,1
HcPZRNYMBebLQTOFDEfWKVICgUdXSGJAa,HAAAZAAARAEA.MACAeAHHLAGB.TBDADACAECCB.KCEDCBFBdDDDhAAAGCFAAAIB..aCHDPEHDhABABEFAQFGAhCAA..fFAAWCCD...hDAA......hDBA...,1,-14,-24,10
URLNMHFOeacTKfYJSZABIGEgDVdPWbCXQ,GAAAEAAADADA.dADA.....bAEDQAFARAGBLEEAHBCAhAAAeDBHaBHDKFHBJCBFAAABBGADhACAIDEA.PDGBhAIAXGCA.MDDBOEHDfGGEhAGASFFD....hBCA...,1,1,-25,26
DUFfeSQZNGAMTaJBPIKECcbVXWdHLYRgO,aAAABAAA.KACAEADA..CAEB...VAFAdAGAHCAARCCADBBB.FCEBeCHFhADAZDFBGGBBACCA..hAAAMDGBJHFE...IEEAhAIA.bFCC.....WEHHhBAA......hCAA...,1,-24,-35,11
LIFSUYPTOJfHEDcZKGaeAdbNgQXCWBVRM,dAAA..bAAAQADACAEA.BAFARAFFMAIBLAHBFCAAUDDAhAAATCBA.OCFDhACAHCGBEEAAZEDFaDAHAFGBNHAB.XFFAhADA.IHBASFHH..hABA......hACA...,1,-8,-18,10
LgEPNACJZeVcGdbOQaMfRIHUSYTWFBKXD,ZAAAeAAAGAEAdAEAQAGAaACA.RBCBHCFASAGA.TCGAhABABEBADEEBLDDBhAGAEEHBAAAACFFAVFFA.OCCHhAHAMGAAfGHE....hAGA......hBEA...,1,-4,-17,13
ObYAQMHFIeRXSNLKGVJZgacEdUTfPDBWC,HAAAeAAARADASACELAGBGCCAZAEBaAGDdCCAUEFA..TDFAhAAADAIBCCFC..ODHDhAAAAAIBMCIBFEABXECAhBGA.KFFD.JHFE........hCAA......hCEA...,1,-6,-19,13
JERTeSZgCYFdOWBIXMHaKLGVUQbDcNAPf,JAAARAAAeADEZADB...CAGB.dAGABBDA..MAIBHCDCLBFDhADAGCGAQGCAhAAADCCB.AAIBEEEBTEGASCCDhABAFEEHOHDAXGFD.aFHD..hCAA......hCGA...,2,-32,-8,24
aZTPbRdYUXCASMKFGcQgIDOHWBeNEfLVJ,MAAAGAAA.QADADAEAHAFCeBBAEAFALBHBaCDD.ZCDAbCEDhAIAREEBdGCA..XCGAhBAAAAABFGHB...gEGBhBBAODAHBHFAfGCA..hBCA......hCAA...,2,-18,0,18
ZdcAGYBRTQbFOLMEIDPJgaeCfVNWSHKUX,GAAARAAAQADCOADALAFBEAGA.DAHBJBHB..eBHHfCDAhAAAVDDB.SCEHhACAHFGBXGEDhAAAdEGDACGBTEBAMCCB.gFFG..hBAA......hBCA...,2,-18,0,18
EcKNXRLZIDBQOaYdGFeHfVUgSTbJCAPWM,MAAAEAAAKACARACA..ZAFBBAEB..aAHDGAFAHCDBUEGASAHBhAAA.JCCAABBBPFAAhAFA..NDHALEEBhBHADCCBOFFH.dHBB.......hCAA......hCBA...,1,-10,-34,24
SPXefEKUGYcIbBCaMWJRdOAHFNZLDgVQT,HAAAZAAALADBDACAQAEASAFAeAHBEBHFGCCA.IEFAhAAAbCABBCFAaCFEMDIBhABAREGF.AAFA.FGBBgEEAhACA.TGGA.XFCDhAIA.KHEA....hCFA...,1,-4,-11,7
OaCdRbTUWNYJgHLKGIDBcfAeZFSXPVEMQ,eAAAZAAASACE..XADAEAFAMAIBaAGA.RBFFTCCAhAAAUCCB..NBHAJCFBHDGBhABAGFABBEAAACIBFFGHQECBhAEA.dGGDWFHHLHBADIEA.hABA......hAFA...,1,7,-16,23
NHJSIFYGPfQCZARXEMDcUBVOKdTbgWaeL,EAAAMAAADADABADA.KAFAdAGA...TBCA..bBBCaBEDeAHHhAFAHDEC..SCDAhAHAFCBHGEBBQDFDhBAAAAIBRFGBXGBCcFGCOHDCLGCAhBCANCIA......hCAA...,1,3,-29,32
aXLUSWeJOYTKCfRgBIQFdZMAcNDPbGHVE,DAAAGAAAHABCEADAaAEALAGB.SBFFeAGHOBEDTDCAhAAACCCDRDGBBECA.QGFChAIAZEFAAAIBPGCAhACAXEECJHEE..YDAF...hBAA......hBIA...,2,-21,2,23
VYNWDEBcJfCPHTSGLFebKAgUQdMXZIOaR,QAAAdAAAZABBOADCRACA....VAGB..NAHADAIBECDABDAAhAAA.JDEBCCEAHDCAhAFAGGABeDGDAAFAUDGBMDIBhAGAaFGD....cFFC...TGCAhBAA....hCDA...,1,-9,-26,17
eVHAKCWEFRcZXOadPgTDBYJNISGfQLbUM,CAAAEAAARACA.ZACB..OAFAdAFA..TCGABBFA...JCEFSBHHhAAAGEBALFGBhAAAMCABHCCCAAHAFGEAaDFDDCBBhBCA...NEIA.QFGA.eFEBhACA.KHCA.WDAH.hBEA...,2,-18,-12,6
XDJMEVOBLcUNaZPgeSKYfGQdFRAWTHIbC,HAAACAAADACA.EADEBAEALAFB.UCABZAFBeAHFKAHBGCGA.hAAAdDDAABCA..TCCAhCAAbFCAMFIBOCHD.aECChCBASGFH.fHABREEFXGGAhCCA......hCEA...,1,6,-32,38
DVaEBKQXIdfHJUAMFcYeZLSTRbWNgPCOG,MAAAFAAAeACHZABELAFARAEA....bCEANCCA...CAHBGEAAhAEAaCHBKDDA..QEFDhAGAdECBHFEAACIBSFCHhAHATGCA.gGGADEIBEHFA.XGDDhBAA....hCAA...,2,-25,0,25
BLdbcIXeNSJYHUaKGgPOAVMREDTFCZfWQ,RAAAEAAAFADAZACB..QAGAdAFA..bAGD..XCCAhAAAeBEDSCBDHCFAaEFCGFCBhABAOEEBAAIBMEIBhAGATFBAfHEFLFGB.cGED.hBIA......hCAA...,2,-9,-4,5
VXYaFNKPgQEeSHOWCIZLGAbUJcBRTDMfd,UAAABAAARACAMADAdAFA.....XAFAaAHBKCAA.QBDChAIA.ECFFHDDACCHAZEEAhBAAAACAbCFAJDCF..TGEAhBCAfECE.FEGDNEIA.eFFD...hBIA......hCDA...,1,-11,-23,12
JQdVfFaAObcZPWDKCUXBIYSLNGHTeREMg,OAAAZAAADACAKAEAUAEA.BAGA..SAGBGBCAHCFCRCCA.hABAEEBBMAIB.QCFChCAAdEEAFEHDAAIBbEFD.hCBA.PEEBCBBD.XGFA...hBAA......hBEA...,1,-16,-26,10
JdAGUVLbacBSQRWPEIYOZDNCfXTegHKFM,GAAALAAAaADASADHRAFF.EAFAOAHDZBFE.CCDA.TCAAhABAHDBBMDHB.AAABVDEBhACAbDDAQFAAhACA.IDHADEIBXGGCeFFAFGHDdHAB.hAHA......hBCA...,2,-5,6,11
JZcSALBXeTCVYHgQDbPUfKaINRWEMOdGF,LAAAeAAACADA.HADBQAFADAFAUBFAKAHB..aAHDRCCAEDFAdCAAGEEAhABAZEEA.ACCBBDDDhACATFAA..gDGAhDAAbFCD.fGHAIHHA...hAAA......hABA...,1,-7,-20,13
ARTgLOFXeZDUSbcfCQIEVYMJdPaKGHBNW,RAAATAAALADB.FAFAeACEZBFA.DAFAUDFASAGA..hAAA.bBDCCCCCEFEB.MEIBhAAAdCHAaCCH.HDFBhCAABGGAADFBXEDD.fFHAhDAA.IHDA.hABA...,2,-36,4,40
QPTbJYeFABISCWfagVdGUXcDMONHZELRK,SAAACAAA..aACAdADAGAEAUAFADAIBMAHBHDBAZBCFRDFFQDFAhAAA.bFBAhABAeDHH.AAGBBGHAhAAAfFFE.........hAIA......hBIA...,1,-15,-34,19
QUaFCfINGEPJORbLgBKYAcHdSXTZVeWDM,HAAAdAAASADAZADBeAFAMBIBUAGAFCBDCCAD.....IDDAhACAECFAOCCH.RDGBLEEBhAAAKCFDAADA.TFCAhACADDHBaEFD.GGBB.....hADA......hAGA...,1,-6,-30,24
MfEGgBIJLDWSXZYAaKNHVFRPeCObTQUdc,aAAAHAAA.RADFeAFEOACDQBFDdAEA.MCABEAGAGCEBhAGABCCDLEEASBBDhBAAZGDAACIBKEBAFGGAbEEA.UGGBhBEA...fHCB...hAAA......hACA...,1,-2,-8,6
HEVaYPRIQOBAXdZgKLNSCJbGMDeTUFWcf,ZAAALAAACADBGAEAeADH.FAFA....fAGBHBEBEBHFaCAAhABARCAAQCGAhABAADIB.dEDAKEEDSFFAhACAbFGBMIAADGGBTGBAcGCAYFHB.hACA......hAIA...,1,-1,-14,13
CBTDARJdGgSIXVFOQNbKYWHMfaPeEcUZL,RAAAGAAA.SADAXADBFAFDQAGAKAHB.HCDAaCCB.hAAAEDCBZDDALDHBhAAABCGAADIB.dEFA.gEAGhACAOEGD.bGAAMFDBeHEACHAADFFB...hADA......hAEA...,2,-31,18,49
fWHQKcDaPbMBTYFSXNeIRZVOACJUdELGg,CAAAdAAAGACA..fADAHAEAQCACDAFA.aAGAbABDMCGBhAAABAHAFCHB.XEAAhACAeBEFRBFFZDAAADFBEEDFLDHBhADAKEHB.TFEASFFDIHHAhBAA......hCIA...,1,5,-17,22
aMGAFDbYdeZcBOCJWXLKIUSQVNPTRgfEH,DAAAdAAAeADAZABEBAFACAGA....JBHBLAHB.KCCASCAAhACAQCECVCEBhADA..TDAARDCBEEABHFGBhAEAGEFAAEIBFGCHbFAAOEHF.IHBAhADA....hAFA...,2,-27,-10,17
ZYKeRcWgDEVOHbMLQaNUSGdfFBAPCTIJX,TAAAXAAA.ZACBeACE.RAFF...gAEAEBDBHCGBbDEDhAAAMAHBLFAA.hAAAaAHFSCEAhABAdGHABCCDAEEBCDHAIEEA.KEGDDIDAQFAAhAFA.NIABfFHAhAIA,1,-4,-12,8
RJZABcDLgdHQPTMaeFbVGWIONYEfKCXSU,DAAAdAAAHADAQACAMAFAFBGDGAEB.OBBBECBAKCEB.CDAD.SCDAhAFA.RCGBAAHAhBAALEEATEEAeFHFhCAAbGEA....WDDDNICB.....hCIA......hDAA...,1,-10,-22,12
WadAKgXPQBFHUZOJELMIVTeSfbRNDGYcC,XAAAQAAAHADAZACBEAEALAGB.MAIBTAGA.eCEBhAAAbCEDRDAAGDGA.hAAACCFBdGEAADAAKEGC.BDDBhABA.OFAB.IGCASGGDDFIBcGGChADA...hAIA...,1,5,-15,20
bIGLVAacfFZWPORKXeEgMBHdNDTQSJCUY,aAAAFAAAZACB..OACDRAEAKBHB...EAEAMCEBHAGB.dCEADCGBTEAAhAEA..QEGAhAFACDGDUFFA.IHAAhAHAVGBAAAIB..fEDEXFDAeHDGhAIANEIASBBD..hBAA...,1,-12,-28,16
SIbRHOfcANWYadPULFQCXKeTZJVGEBMDg,...NAAA.aAAA.dADALAFAQAFAKBBAeBDGZCCAGDFABCGAMCIBhABASBHB.hACARFAAOEEHAAGA.PFHDhAFACDDATEAA.EDFBDBBBbEGD....hADA......hAEA...,1,-2,-28,26
XHOcIJBQeCfaYERTKGVWSZNPLMADbFgUd,FAAAdAAAHADAOACDJAHBBAEA..eCAACAGA.aCEDRCDF..GCFAhAEASCGDZFCALCHBhAGAAAFADDDBUFFA..IGHAhAIAfHABEHDE.......hBAA......hBIA...,2,-22,-22,0
DTKdILYBfQXgSORUCAJZFbNEPaMcHVGeW,ZAAAFAAAEADAaACA..HAEBeAFADAGA..dCCALBGBBBHAQCFChADASCCDRECAADIBbDDDMEHBhAGA....cFFAhABAWFGD.KEHB........hBIA......hCAA...,2,-22,-21,1
GHETDZbaPXMIfeNRYASWgJLFdOKVBcQCU,SAAAJAAALADBdADA.KAFABAFA.QBGAGCDBHDBAhAAAECFB.ZEFB.aAHDMCCBhAFAeDHHREEBAAHAFFAB.OGCAhABACEGADEIB...PHACfGHE.NICB.hBAA......hCAA...,1,5,-30,35
LaXcfVODYUNdebFGIWPCgATZRMQSEBKJH,RAAAMAAAEADE.KADAHAFBLAFB..aAHF.XCCAVBBBDAHBUDFBhAAAdDHA.eEHHGECAhAIAIFAACEEAABIB..ZGEEhBAABGFA.fHBB....hABA......hAFA...,1,-12,-20,8
SfTcbYIVEJeMDZCBXPRGUWdaHgAKFOQLN,OAAALAAA.SADHTADA....bAFBIAFAhABA.EAHBeAHFZCAAXCEAhACARCCBGEFAdFCDHDGBhAIAABBBFDHDQFCA.fFFEhCBA......hCCA...,1,-10,-13,3
ENJTIVGcgaeKPFRYBHdUMWZOQXSCLAfbD,DAAAEAAA...TACAGACA.aAEAeAEEFAHBRBEFHBEA.dDDAMCBBhAAAZDGBQFEAhAHACCHA.AAIBfBBEhBAAbDFDIEHAcGDCKEEDBGHA.OEBD.hCAA......hCIA...,2,-9,-8,1
fIOTBbFDPSYgGHKRQCeWALZdNcaMVEUJX,dAAAaAAA.EADAUADA..XAFAOAFCBBBDDAIB...SCEAhAHAGCABHCFARCGFeDBBhAIAAEEAZEFE.MFCBfDDEhBAATGGAFGABgFEACHEA.NEIA..hACA......hADA...,1,-8,-18,10
TAVbPDYcLXUQGeJECZgBMKaFINOWfRdSH,VAAADAAALADA.QBBCeADEEAGEZBEAMAHBFCDH.OCHDhAAARCEBHEAA.AAEAbEGD.hAIA.PDFB.XGDChCAAUGCACDDDBGFCaGGA.NAIA.fHFFhDAA.....hBAA...,1,-4,-10,6
BgLRETCJIQbYDOXZFAHGNVMWaScfKdPUe,HAAAGAAAMACAaADA.SAEAKAGA.dAHAeCDALCCAECGATEBAhAAACCGDQECAhAAA.bEFAODHDZGEEAEFA.hBHAVEEB.fGAA.BGHD.hCAA......hCDA...,1,-3,-5,2
VURFGXcEKeOWYCSTNJfQLPZIadBADgMbH,MAAAHAAARADFGACBEAFEKBHBeAFE..OCABCBBD..TCEAhAIAfCCELCGBZCEBdDGAhAAAACDBbFFAFFHD.XGEAhACAcGEC...SHAA..hADA......hAHA...,2,-9,-7,2
ZHFIdMOEbcRgLVNUeCBKfJWaDTYXPASGQ,GAAAHAAAdADAEADARAFALCCAUAGABBFCKCAD..JCDBaCGD.DCIB.hAAA.TDGA.XFDAhACAAAFAZEEAMFIBODAHhADAbGDA...gGFHNIAB...hAAA......hACA...,2,-14,-12,2
MNeaUcICTVSgAHYdXfWQDPKBJGEORbLFZ,HAAAdAAA.XADBQADAKAFAGCABRAFALCCBZBFEeDEAaCGDUFEAhACACDHA..TFFAhAAASDAAAAHA.fGAAhADADFIBBHFD.EGGE.ODHD.MICAhAGA......hAIA...,1,-4,-10,6
LDfPFdcKaTAIGeHWVMXQRYSbJCUBgEONZ,eAAAHAAAMACARADA.SAEACAGBBBHA.EAHBZCCALCCADCGBFDHB.hAAAdCGA.aDHDAEAAGEABhABAXECA.QFFChAAAJFFB..........hAIA......hCAA...,2,-35,-6,29
DbTMfWQRVLGBaCOHKAePdcYIEZgNFXJUS,eAAAdAAA..IADAEADAZAFBFAHDUAFADCCA..MAIB.QCBAhACARDDBGDGAaFBAHDDBhBAAAAAA...PDGBhBCAgGEAXFBC.SEHH.hBFAfHBF.hCAAWHDA.,1,-16,-24,8
ZFeBJQVISTgPCYNEDXLOcGRHAbWMfUKda,MAAAKAAAZACBBADA..QAEASAEH..TAGACAGAEBBBLCGBhAGAGCAAHDEAhAAAAAIB.bECDUDDAdFGAaCGEhACAeEHH.IGDA.gGEHhBAANEIADIAA......hBCA...,2,-29,9,38
LCFPTOHUGdKNXAVcYWMfSZJQEDBRgIbea,VAAA....cAAAMADAZAEE.EBHFRADA..IAHAhACA.eCDAaCDCLCFBhAAAFCGDTDAAHEGBdEEAXGAAhADAADIBfFEEQGFADIAA.BEHAhAEA.CHHB....hAIA...,2,-21,-2,19
cQeOANIUPKDFCdZaRGYfbTJXgHLEBWSMV,UAAADAAAdADARADAGAGA..bAED..TCEAJAGF.HDAAEBBABAHBhBAAMDIB..QEEBhADAACIB.IGAAhAEAFDDHaEGAXFEALHFA.SFHDhBBA.....hAGA...,1,-6,-30,24
UMNJaLEDeXTRCABbcPVHQSgOYFWfZdGIK,BAAA..bAAAVACAHAEA.QCAAOAFAFBFDZCDE.GCGAhAAAKBHBUCAAMAIB.aEAChABAEDDBeEEB.RGAAAAGASDFAhAAAgGGAfEHA.dFFAhACA.IHHA.hACA...,2,-26,15,41
ScDaEbHKJPOMWXYBVCNLfZQATFeGRgUdI,eAAARAAAdADA...SADAaAFAHBEBKBHBOAFD..MCCBXCCAhAAABDDDCDGALAHBhABAZEFEAAAA.GDEAUGBADGGAhAIAEEAAbEGB.PHBA.....hBGA......hCAA...,1,1,-21,22
GNLOcZbQeFdBEYVKTHDPfWJaAgXCIUMSR,CAAAMAAARACA.GACBLAFBZAGB..eBBBdAHAECAAKDDAHEFA.DBIBhAFAfCDAaFCA.hAGAAACA.XGCCSDFAhAAAOHECbEECQGGABGHA.YFCBhBHA....hCAA...,2,-25,0,25
XCFbGBTPNcHEagWdVYLeZfQMAUDOIRKJS,OAAARAAAKADC...XADAFAFDGBGABAGA..TCCA.hAEA.cBBCHECCEFGBhAAAaAHDdCEDLHAAZDEEMDIBhAGAAEIBDGIBSFFACGEA.....hABA......hAHA...,2,-21,-15,6
LOaQCYdXbATfJcWNDRMVgeSGBEZIHUFPK,TAAAJAAA......NADB.RACFMAEAeAHFGBCBEAHFHBEBFDDHhBAALDHB.aCAChAAAQDGBdECAABGBfEEEhACADFBBSFDAZGEA.IGGAhBFA......hBGA...,1,6,-34,40
FTLDRYeGgBAIfcQSKNHPWXCOJaUZMdVbE,..IAAAQAAAKACA.HACA.XAFBOAEAUBFBdBHAECDAhAAALCAARDEAeEAABEHAhAEAAAIBSCEDPFDBCFGDhAIAZEFB.MCIBFGHD.DGDA...YHFGhACA.....hCAA...,2,-20,3,23
gfFWcaRKbQJGHUVOdPMXADTILSZYEBCeN,TAAALAAA.ZADBEACEeAFA..fAEBFBHDaCAA.RAGFQCCAhAAAHCEBOEGDdDFAhAGAMEIBACIBSEGHhAIACGAA.gFCAKGCA.....hABA......hACA...,1,-2,-18,16
CIZGgFOecMKRXYQWUNaPLAdEBSbTDJfHV,EAAASAAADADA.HACBCAFAGAGAOAEA.eAHFMBCBRBEFQDGBhAAAUDDA.aEBAAAIBbFCChAAATFFA..fBDBhCAAIHHA.ZGDE.FHGEKEED...hCBA......hCDA...,2,-18,5,23
WFeVOEKRQISXCHDfPJYbgTLNaAMUZdGBc,ZAAAGAAABADBFADAeAEHEAGA...RAGB.QCDA.XBGAhAAAHCAAfCFAhABA.PDHDbDBDTEFAhACAaEECAAIBdGAAVGDAKGEACGADDDFA..gGGBhACA...hAGA...,1,-6,-8,2
BOHINQSRFPbMLDgaAGCVWedUZXJYfTEcK,GAAACAAA.eADAZACAXAFBJAGB..TCDAEAHFBCCAHDFChAAAQDACREAAFFFBMAIBhACALDEADFIB.ACIBdFDAhAAAfHGBOFFASGGAgFCA.hADA......hAEA...,1,-3,-18,15
MXaKYOANDPIVWBCQRUEZfdLHJgTSeGFcb,DAAAVAAACACA...RADFZAFBdAEAHAGB..TDAAeBBBGDCAhAGA.FEEAbBGDMDIBaDDCKFADhAAAAAIB...IFCAhADAQGGCUFFAEGBB.fHEFhBAA......hBEA...,2,-17,-10,7
OPDZTfVdUIaNBGQLERHAWegCMYXSbKFJc,eAAAMAAA...SADAFADDOAFAZAFB..TBFAdBHAaCCAGBBAhBAAEDDBHEAAABBBCCHA.bEGBhAAAKDEA...PEDBhBFAfFEAUFFABEHBLHCA...hBIA......hCAA...,1,3,-19,22
WADXBdCGTJYRELZFVbNeUfOgcQMHISaPK,BAAAGAAAJACAEADA.ZAFBFAFA....bBGDeAHH.UCBAOCDBhAAA.QEEChACAHCFBaDDDKEHBAAIBdFBACFCD.TGGAhADA....YFFF..hAAA......hBCA...,2,-38,-1,37
EAOUceaWKMYRZPHSXBFNQdgDIJCfVbLTG,OAAAeAAAKADARADAHAGBBAFB..FAHBdCCA.DBBBCCCA.....bDFAhAEAGCEA.AAAAaCGChCAAMEEBZECFXFFAhAGA.NIAB.QEGA.gGGGhCBAfFCA....hAIA...,1,-21,-22,1
REALWQPdGDHOSXFbMUaZJefgCNcTBYIVK,LAAAQAAAGADAHACASAEEFAFAMAIBZCAAeAGH.CCDATDEAhAAABCFAVDGBECHFAAIBhCAAdFBAOEHDUGGBaFEBhABAfFCA.gGFB..hCFA......hDAA...,2,-8,-3,5
AbfCcUFaVTgSXRINeGdYHBDWMQLOEJKPZ,CAAAFAAA..aACATADA..XAEDRAFFeAHHdCCAHAGDBDAAMBCBhAAALDFAEDDA.KEDAhADAABDBbDFAUFAA.SFGAhAFAGGABDFFAOHFA.....hAGA......hAIA...,2,-17,-8,9
HYGNXETPZMKaBSCWJOVRdfgeIDbUFcQAL,HAAAGAAAEADEZADAaAFACAGB....OAHDRBEAdCADeBHHDCDA.FDCDAAABLDDAhACA.XDGDhAEAMDGBSEDHhAAAVFAA.fEHAbFDBUGGA.YFEBhACA.....hAFA...,1,2,-12,14
LPUbGBEeNFTDZMQgIACfHaRcYKJOVSdXW,HAAARAAAKADC.OACAdAGALBFDUAGAGBEABCCA.ECCA..eBHHhAAATDGAZECA..MEIBhABAQFGB.AEEBaGBAhAAAJHFAXGDD......hAIA......hCAA...,1,-3,-25,22
XBUIHbRaYdOWEcGQCVZKDAFgJPeSMNfTL,FAAAJAAA.eACH..MADA..TAEALAHBBAGBHBCCRCEAdCHAhAEAEBFEGECAQDDBhBAAZEEAAAIBSFHHhBAAXDFDIGGAaGED.OHBA.CHEADGIBhBHA......hCAA...,1,-6,-16,10
IGbWFcTVgYJMOPREeBSfXKZdNQLACaHDU,HAAADAAAGABBFADA..TAGAVAGB.JCAFMCCB..RCCAECFEeDDAhAEABDHA..XDGAhAFAdEEALFHBADDAaFCDUFFAhAGAbEFD..gGAA...hAIA......hBAA...,1,-1,-20,19
HNZgVfKdDCLFAIRaMUQGcJETYWSBPeObX,RAAAaAAAMADAGACA..EAGA..TAEASBDAeAGHbDFAHCEChAAAZEAAVEBA.dCHALFFBhAEAACCBQEEChABAcGAAJFHBBFHD.XFDDNIBB...hBEA......hBIA...,2,-2,7,9
POLUFfEKYaXAeBVCRDbHQdGJMTgSZIWNc,eAAACAAARACA.HADAGAFAMAFA..SAHBZBFEICCA..hAAANCAA.ODEBLDDBhAAAfDGAEDHBaCCHADFBDDIBhABAdFFATFGA.gGDAPHBAKHGABHBAhBHA.....hACA...,1,3,-13,16
BEVReFSNbCAHQDPJgXIUdGMLaYcOfWZKT,HAAAQAAADACAJAEB..XACAdAGAGCCAaAFA...OBHDhAAAZBEBTCGABEFAREGFeDAAhAAAFFEH.bEDA.AAIBgFGHhADAMIAA.LGCAfGBB.hCAA......hCDA...,2,-17,0,17
NLfWOUVKXcTPYFMIZAeERSbdBQCHDGgaJ,RAAAdAAAQADCHADAGAGA.aCAELAFBOCED.KAHB.TDDAhAAAFDCDZFAAECHBBEGDDCCBJEGBhABAfFHA.hAHA.VFCBXGDDYFHBAAIBSGGDhACA.....hCAA...,2,-11,0,11
OLKHAFfTIbBQCPGdNSZRVaJDXMWUEgeYc,TAAABAAAQACA.GAEBdACAZADBRCAA.aAFDDCFBMAHBECGA.hAAAeCHHODEHHDEBAAHAFDHDhACAbFBB..CFHASGDBhAAAXFAAUGFAgGGG...hAFA......hCAA...,1,5,-11,16
JSBUgENeVWHYDcLAfCdXMFORIQaPKZTGb,dAAAMAAARADA..QAGCaACEZAEB.GCABSAGABCFDECHFeBBBhAHAHEAADCGA.AEEAXEFDhACAODCDKDHB.bEEBJHFAhADA..UGGANIAB........hBAA......hCAA...,1,3,-20,23
YZVHbCBGMTKDdgFIScNfQeJaPLXROWAUE,EAAAZAAAHAEABACAGADAMAIBDACA..dAFBFCCHSAHH.hABA.fCFAhAGAeBFHaCCHLDHBRDGBAEEBUGGB.hAHAbEFDKHCA..........hCAA......hCBA...,1,-14,-19,5
RbLDIOJXNFZcPKfUaHETGCgYMeASWQBdV,QAAAdAAARADALAGBOACC..XCAAZAFBKAHBUCDAHDCBEDHFhACAGCGA.CEAAMFFBhAAAAAIBBEAA.bEEBDGGBIGGAhADA.FGCHcFAD....hAEA......hAFA...,2,-22,-3,19
VLSAEQdYUGfWMBCeXbHDZOJRPTKNcFgaI,EAAAdAAAGADA.MAFAeACAHBFBZAFBRCCBKBHBFAHD..aCAELDABhAAAADDBUEFB.BCECXFBAhACAbDGD..OEFBhADA...........hADA......hBAA...,1,-17,-20,3
CZKVGdROYDeWafScbFPETLMgUAJHQNBIX,HAAAQAAABADBCAFAZACBGAGARAEA.DCABeAHH.aCECSCCAhAAAFDHD.ECFBMEEBhAAAAAIBJEEBXFAA.hACAdFFAODHDfHABbFAATGFA..hAFA......hCCA...,2,-15,-5,10
SfHKOZEARGIeYabMFBNdXTUcVPCDQgWLJ,RAAAeAAA..aADAMAEABAGAdBDAUCCA..PAHDQCFAhAAALBFB..fEBEhABAHDGBZFCAAAAAGEDBhAGAIHHAFFHDNAIAcDCCDGGB.....hBEA......hCAA...,2,-19,-12,7
XZKBUGEADRYgfdaJLPNbSeMOVQCHIFcTW,RAAA..fAAAaADALAGB..bADAeBDF.MAIBQCAAhAAAHCEBFEGDTCDAhACAZGBABGHAEAHBAAEADCCBdDGA.hAAAPFCA.OEHD.CGEAIHCAhADAWGCE.KGGD...hABA...,2,-16,11,27
MHcAZdgXCFfJSbBeOTLUYaQNIVWGEDRPK,dAAACAAAFACASADA.BAGAeAEHLCCAaAGA..QBGChAAAICGAGDAAhACARCBBMDFBHEGBAADAZDFEfECBhAGAbGCC.TFGANIDB.EGFBDEEB.hAIA......hBAA...,2,-18,-9,9
JXefESLRcOVQGTBYZUCWDFIPHaMdANgKb,KAAAXAAAEACE.RADA.OAEAGAGA.BCDDZBCECAHAFCFH..HCEChAAAdDAAAAAA...bEECeCHHhCAA.LEEBhCBAQGAATGGAUGGADDDB.aHCC....hCHA......hDAA...,2,-13,-9,4
OEbXHSALFWQPRCIZDgfaYKeJVUTcBGNMd,LAAAQAAARADFZAFBDADA...aAHDeAEAUCAATBGA.GCBBhAAAdDHAEDDBHDFAAEGAFFAAhABACECDfEEEhAIA.KFHBcFEBMIBAOHFCbFCD..SGGAhACA..hAFA...,2,-15,8,23
AdGaDfFgEOSRBYeWXZKMVHNbCTLQPUcJI,aAAAFAAAEADA..RACFeAEEZAFBKAHBHBEA.CAHBLDEAQCCAUFFAhBAAJCHF.ABBB.GDAAhADADCIB.OEDEBGDA.XFGDhBAAMFIB.........hCAA......hDAA...,2,-19,-15,4
INKVXFBUWbQRMTDLPfCgaGAOYSHdeEcJZ,SAAAHAAAEADEZAFBKADAFAHDBAFB.UCCAQCAB.RDCAMDHBhAAATBGALFABhACACAHBGDAAADIBdFCD.eFFBhAFAIDFA.XEFADFIB.fFCAhAAA.aFHD.hCDA...,2,-27,6,33
aEeWHbZUTYLJIgGFSdAMBNKcRPCXfQDVO,MAAAKAAARACF...XACAQAEC.OAGDEAFAHBFC.ZCCAhAFATCAALEEAIDEAhAAAGGDB.SGGEhAIAAAIBBDGD.NBBA.CEHADFFB.eGAA.UGGAhACA.....hBAA...,1,-10,-14,4
SEHKdYLabXQgJMPDGIfAOVeRCUWBNFTcZ,eAAARAAACADB.BADAFAFA.ZAEBHBDCdAHALBGD..bCGDQCCAhAAAMAIBGDDAADHAOEFBhABAUGGA..NCCA.TGGAhCAA..SGDDKEHB...hCBA......hCCA...,2,-19,-11,8
AYZOPHRgbSNaCVMUWLcIJTdEBfKeGFDQX,ZAAAHAAARAEA.SACECAHB.MAFALCABJBEB.ECCBKBGAeCEAhABAGDCADADA.ACCAOEGBhAAA..bDFAaEHDUECBhACAIGBAdFFAFHDCXGDD...hCEA......hCIA...,2,-10,-7,3
ZDcCVeYMaGKdFNWXQBPSbRUEgJfHITALO,ZAAACAAA.eACEaACAGAEAdAFAFAHB.....XAGAQCCBhABASBCBRDFAEEEBJFDFHCGBhAAA.AAGALEDBhCAADFHB.cFFAMFIB.WCCD....hCBA......hDAA...,1,-17,-19,2
YRbdENGQWCMFZTceaSVKUfHPLIgXBDJAO,RAAAEAAAGADA.QAFAMADAZAEEeAHH..aBHDKBCBHDAAhAAALCFBXDFCDCBBADEAhAAAbFAAdEEC.CDHATGGAhBCASEGA.fGGA.gGDHhABABFHB...hCAA...,1,9,-23,32
FfJdPLgRTEOGZUIbQaWCNKSeBHXYDAMcV,MAAAFAAAdADALAEARAFA.EBBAZCCA.UDGAQCDA.aAHDhAFACDBDKEEDeCGBHFAADDCBADIBhAGA...VFDAfGEAhAFA.....gGGAhAGA.....hBAA...,1,-18,-25,7
cBdDFRVOgSKeWXHbaGIZCPENJTMQALUYf,LAAAUAAA...fAEAdADARAFAOCDEKAGA..eCAAHCGBhAFAGCEAZDBAEFEATCGAhABAACIBBFHAFEAA.SDDDhACAXGAAaGGCCEHAPGAA.MIAA.hAGAQGFA.hAIA...,1,9,-21,30
GFYJdfbZIXVDaKWLgcNeESQAUORCMTHPB,RAAAMAAAHADBGACBFAFAdCGAZAGB...XBBCaCCHLDAB.hAFA.gCDAhAGAeDFDEEHFAAAACDHATEFABGDAfGHAhADAbGCADGCAKGHBNIAB....SFBHhAIA....hBFA...,2,-10,-2,8
VAgZDTCcaGWdXBebfQREHYNJUIMFSLPKO,ZAAATAAAaACA..dAFAeACE..QCCBHAFBJBDFMAIBLAHBhABAOCCHABHBCDFAGEGAhBFABDFDRDGFEFABUFDASFFDhAAA.KHBADIEAcGGD...hCAA......hCBA...,2,-15,4,19
MNWDVPXEfgKYABZGOFJIRCLHSdUabceQT,GAAAFAAARACFHAEBdADAaAFA..eAGB.MAIBDAIBXBFChAAA.EDDBKDEDBDFAZEAAOEGBhAEACDHALFFASEHBhAHAbDBD.TGDAWGBA.fHGFhBAAAHFAIHHA....hACA...,2,-22,-5,17
dKZYIaeWOPNVDGAMFgEBRTCHbQXUJLcSf,MAAAEAAARACA.HACC.QAFCXAFBLBHBSAHBdCCDZCCAhBAAaCEDeCGF.ODHDhBBAPDABDEEBACHBBEFAhAAATGGACFGAUGDAfHEBKGHB.....hADA......hAIA...,1,6,-12,18
IOSXacRfBbeMZKPAFTUQJNGgEHVLDdWCY,TAAAQAAA.GACBHACBLAEAdAGACCDD.OAHDaBHDRCEFBDAAhAAAeCABZCEBAEGAFEHDUEGAhAAA.gFAAhACAEFAADFGB.IGDA.XGFC.hADA......hAFA...,1,13,-20,33
HacONRZDPAVXUQbYSeLEWTdCfgGMBIJFK,XAAAQAAA.SACAEADA.dAFAfAFAGBGAMCDBhAAABAHAFCEHHCDAaAHFODABhADARCGFZDAAAAAAbFEBeEFFhBFATGCACGGA.gGGA.KHAADEIBhCAA......hDBA...,1,8,-4,12
VLUHaPMfFDKAYTQdXJRBWNeScIGECbgZO,TAAAdAAARADABAGB..eACE..SAHHGAFAEAHBCCBAZCEBhACALCCB.HDGBhAAAaDAC.MCEBDDDBADGAQFAChAFA.XFDANDIA.IDBAhAIAbFGD.gGGAhBDA..,1,19,-46,65
CdBVePOJGWZHgTYLAEDSXIUKMNbfFQcaR,EAAAXAAAKACA..MAEA..bACDQBEARAEAdAHABCFAeAHFhAAAODFEGCCAHEAATEFAhCAAAAAASECEhAEAUGCBFFHDaFFA.CGGD.........hAFA......hCAA...,1,-5,-12,7
QGbLXaSEKcgDHCWdJFTMZONAePfUVRIYB,eAAAUAAARADABADAGAGALAFA.aCCAECDB.KCFDDCFAHDAAdDDDFCHDhAAAZEFEAADA..VEFBhABAQGAA.bGEAhAGASFHH.CGAATGDAMIDA.OHAEhAGA....hAHA...,2,-19,3,22
TWdQHSABJGZIFaEVOMNUYfRXLePcKbgDC,GAAAZAAAaACA.EADA.MAGBUAFA.RCCALBHBeAHBKCDA..DCHBCDFA.hABAdEEAHFBAAAABBDCDFFFAOFHDhAIA..fEHAhACA.XFBAPHDA.bEFD.hBFA......hCAA...,2,-14,-14,0
IeYCgGQTNVUFDJdaLOXcEZWBKAHSRPMfb,HAAARAAAMADA..bADBeAFA..CAFAGAGATBDA.UCAB.DCFBhAAAaBGELFFAOCCBEDEAhAAAZGDAKDDDADHA..fEFAhABAIHHA.QGGANIAB.FHEChCAA......hDAA...,1,-1,-13,12
TOAeEHMbZLdIQPBFXVfSWYRUJaGCcgNKD,HAAAZAAAdAEAQADCFAGA.XAFBSBFHRBGFUCABGCAAhABACDDA...NCHADCIBAAIBEDFBhAAALDDBBEHAfFCAhACAJFFB.aFFC.KGHB.....hACA......hADA...,1,2,-25,27
fCOJFKbeVGARYXdaMSPEZIcNBUWDLQHgT,RAAAdAAAMADAEADAZABB....IAHABAFADAHBHBDA.TCGAhAAAOBHDKCCDeCEBABFAaDEDhABASCFB.hCAA.cEGCUFGAQDCDCGGD.FHEChAIA......hBAA...,1,-14,-24,10
GXSWOQVIKcZNBHAYJMgDdLfaETbPeCRUF,MAAAdAAAaADA..EADA..TAGAeAFARBBBGBDA..SBGAhAGAQCBAKCFDZCFFhACAHDGBACIBgFFGhAGALEDBfFFECDHD.....hAIA......hBAA...,1,-12,-15,3
WOVLNdDSGTJQaPBCMEFgcefUYIHAKRZbX,RAAAZAAA..XADBOACALAGBdAGAGBEATBEAQDCChAAAaCCC.CCHAFEGA.eFGBhABAfDHAUGBA.HEEBhABAAAIB.bGBC.NICBSGHB..hAIA......hBGA...,1,-4,-12,8
NEAKSXZVDafYbLdFQTJRBWHIUPcCgOGMe,XAAAZAAAaACA......bAEDdADAQAGARAFAHCDCICHAhAAAUECACCCD.GDBAhABAeDHBAEFASEEAhAFADFFA.LEHBTGAABGGAcGACMIDAEFGF.hAGA......hAIA...,1,-6,-8,2
QFGaZCTEeJfPDULcONXWMAgbKYRBdVISH,KAAARAAAdADA..SACBHAFAGCDBZADBEAFAeCCD...fDHAhAAADAIBLCFBOEEBhABAXEGDAAHA.bFDDhAAABFAA.QFGBaBHHCDEA....hAFA......hCAA...,2,-21,-9,12
FaGLUAObJNYfWEQTMHPICSegVdRKXZDBc,OAAAJAAA.....fADAEADEMAFAHBECCAFA.eBHHhBAAdAHARCCAZCCABBBDFEEHGGEBhBHAACFA..bDFA.hCAANEEA....QFAA.TFFAhAFA.SHBAhBAA..,1,-15,-22,7
NZJOYSUfbFRBTICQegVEHXcGWaMPLDKAd,ZAAAOAAASACEUAEA.FAFARAGBBBBD..TBEAQDBAhAIAeAHHECCBHDEAGDFAhABAaDHDMFGBLEEDhCAAABDAdGDA.NDIA...........hCBA......hDAA...,1,-9,-16,7
CEFTMcWJDKXVNRUOQPHYdfBIeabZgGLSA,EAAAMAAA..JACBXACA..RAEAQCEBHAFAdCCABCFDhAFAeAHHZCGBGEAAAAHATEDAhBAADDDBKDHBUGGAOEEBhAAAfGEAaFGB........hBBA......hCAA...,1,-13,-17,4
XYSeQVWHENbfMFJLOCAaRKUTcIZDGdPgB,RAAATAAAZADBdAGA.BBFCSACB.eAEAQDAAHBFCECCBhAAA...bDFAMAIBhAAALEABACCAaDEDKDGAIFDAhAEAGGDBXCEC.VFFA.NIAB.hAFA......hAIA...,2,-26,11,37
AeaDCLQdfcSORBMWPEbgHXNFVUJTIGKYZ,eAAAaAAALADAdAEA..SAGARAGFBBBDMCDBEBCAHCEC.hAEAFDDHUDGBTEGAGEDAhAFAZGAAAAAAQGGAhAIAOFED.WCEBgGGA....hAGA......hAHA...,1,-4,-11,7
aWdSRfeGXVQEOLMJUcNYKPIBTgbHZAFDC,CAAAdAAARACA.eADAGAFAQAGALAHBMCCAUCAA....NCGA.hACAKCDABDAA.TDDAhADAHEEAAEHA.aFAAfDHAhAEAEFHFOHBAcFDC...IGHAhBAA....hBCA...,1,-12,-27,15
gHMLRVBFUZKdCONfAcIDEbYQWJGXSPeaT,DAAAEAAA.QACAGACASAEA.eAGHaAEEHAGBRCEBFCBHZDGBhAAAdDDAOBBBAAEA.hAIAbDED.JDGFXGFChBCATFAA.MEEBBGHA.......hBIA......hCAA...,2,-10,-6,4
KPTFHDLRXGgCOQISMYfJWUBEaVecdbAZN,ZAAAKAAAFACAHAEALAFARCAAGCEB..OCCAQEAB.MEEBhABAfCFAUFFAEGABhACAeCGH.dFFDAAIBNEIATGAAhAAADICA.CDDDSFHHYECB...hADA......hAEA...,1,3,-22,25
OJFdGRWNLZcBPQXSKMVgeCabfITEAYHDU,HAAAOAAAdADARADALAGBZAEBBAGAQCAB.KBHBMAIBhAEAeCFHbCCA..TEGAhAAAABBBDEEBFEHB.GGEBhBAAcGGCSGCB.CFFC.aDDH.EHDAhACA......hAIA...,1,-11,-12,1
XBeCEbQZHKJgDGLMNFVPTOcaWSIYdfRAU,BAAAEAAAZACBHACA.KAFCDAFAGBGAMAIBFBEA..TCAA.hAAAaCEBSBGHhBCAdEADAAIBeDDDbDEC..QFFChAAALECBPEHDcGCA.IFFAhCAA......hCBA...,1,-4,-26,22
aYfZgTNdcBbHPUIVJFGCMKSQRDAOELXeW,EAAAeAAA..aACDZADB.TAFAdAEABAGAHCEBUCGA..ICHAhAAAFCBHGDDAMCCBQFGAhAAAAAHALEHBXGAAhAGAfFGAcGFC.....hABA......hBDA...,1,-12,-18,6
UIPVBJHRKLCNADbTgEaeXfZMQGWFScYdO,TAAAEAAA..eACAZACBGAEASAFAdAGBOBGDUCCAICFAhAAABCADHEBA.RFFACGEDhAAAAAIBbCGD...aDABhADAMCIBQFEC.FGAA....hAGA......hCAA...,1,-6,-14,8
GKUcPbHMANSfVWFdTgCLRIeEOaQJDZBXY,SAAAVAAA.dADATAEALAFARAGF.ECCBQCDChAAAZCEBBCGAGEGAKDAAUDGBbGAAhAAAHFEA.AADAfGAAhAGAFDBHCGEA.eHFA......hAIA......hCAA...,2,-8,-4,4
TBaYgSOIXNJHCLWAGQMbZDEPcdUKFVfRe,GAAAMAAAZABEEADAdAFAFAFD..RBGFBAHB..aAHB.SBHHhAAAXCCAHDEBLCDBhACAACCAQFBAhBAAbDEDDDABcDGCKEHBeGEAgGFAIHHA..hBFA......hCAA...,1,-1,-13,12
YICSLKdfQAeHTJORcUbGBFMPZgWDXaENV,HAAATAAARADFUAFA.GDAAMACAZADEDAIB.EAHB...VCDAhAAACCCDLDFAdCGAACCBeDHHhAIAOEEBBFFAFFGA..hAAA.gGGGaGHD......hACA......hADA...,2,-13,-12,1
RCNbePIOFdBMUDGHZAgWTJEaKSVQLfXYc,TAAAEAAAKACA...QACCLAEBXAGARAEFCAGB.eCCBhAAAOAHDdCGABEEAMCGBGDDAhAAAHFGBAAGAgGDAhCAAaDHHfEAANECA.IGGA.DGIBhAEA......hCAA...,2,-14,-6,8
CgGAHERPOFfJbdZWBKLYTVDMeaQUNSIXc,HAAARAAAFADA.JADAZAFBKAGCLBHB..TCCAMCCA..eDDBhAAAaBGEUDFA.SCADhAAAXFEDCGGBACEAEFEBhACAOHCC..dEHA.BGGDDGIB.NIDB...hCCA......hDBA...,1,-15,-23,8
FJPdBAfKebDXGOTNgESMWQHRZYcCaVUIL,eAAAXAAAGADA.OAFATADAEBFEMAFAHDBBZBFB.CBHAUDAAhAAALDGB.FEFBdDDAhABAAAAAbFDDDDHBSEHHhADA.RFDA.aFHDIHHA...hBDA......hBIA...,1,-4,-5,1
QEgLSVfICeGUJKZBOFDRdMcYHXbNAPWTa,TAAAEAAALADA..SACBVBGBCAHB.eAEAGCBAKAHBZCCAhAAAFDDAREFBdCGA.MDIBhAEAHFABbECBAAEAaFHD..hAAAQFAA.fFFA.hBCAIHGABHFD..hAFA...,2,-13,0,13
BCQHDaLMSVYGEIZKOPbgfTAXNWFJReUcd,XAAAFAAARACF.UADAdAEAQAGA.HCECaAFEMAIBhAAASDHHGCFAEEEBZDBAhABAOGAAbFGD.TGFAhAGAACHBJFDFBGAADIBA........hAGA......hBDA...,2,-14,-8,6
YWVKDOEbHcRdfTXFINQMAUaCJGZBSLegP,aAAAGAAAZACB.LADA.eAGHPAECVCDBOAHDHDGBREAAdCEAhAHA..TGEAFCGHQFFAhBAAAAABCHHA.SEDDhBBA.WFHHDAIB.....hACA......hAEA...,2,-16,-4,12
SZBEYVaWQeAMcIOXgbHfKUDGdNCLRTJFP,MAAAOAAA..XACAHADAKAGC.GCCAdAFALAHBRCFAFBBHZEFAhAFAEBBB.aDCDeFCDABHB.hBAAIGGA..hBAAbEDDDIEATFFA.SDGG.hBIABFBD.YHFGhBFA..,1,-6,-12,6
WdFeZcbLKODVXfAQEaJTYNRMHGBCUISgP,EAAAaAAA...JACBTADA..RAEAHCECGAFACAHB.SAHBhADA..gDDGhAAAdCCAeDFDbEDDLCHBhAEADBBBfFAAAECBQFACMDIBBFGDIHBAhAFAFGHDKHEAXFGDhBAA..,2,-13,7,20
GXCabBVLNUORPIMfTQKAZdEHFgWYeJDSc,EAAAHAAAFACD..gADBeAEA.SAFBGBGAaCDDBAHAhAAALCFDOCABREAAMEIBhAAATCCAAAEAdGEAJCGBXEEDhACACGGA.NCIAIHAA.KGHD.hAIAYFDFDIBA..hAHA...,1,-4,-13,9
TcLgEdSBJKIZWFbVNADQMePORYXUHCGaf,MAAAeAAARADAUAEAHAGBGBBA..aCCB.TDDALAHBECFBdEAAhAAABBGB.KDEAZEGBbEDChBAAAAIBDFFB.OGAEhABACEHA..fGDA.SEBDhBBA.IGGAhBDA...,2,-28,1,29
USdRIOVGeDKHMXQFgbafCEWLAZTJYNcPB,ZAAATAAAJADA.......NACBBAGAdAGARCAAOBHDeAHHHBDAhAAA.MCCBQCEChABAbDDA.aEDCEDHFACAA.PFBBhBDASEGBGFDBXGFCfGHAhBFA......hCAA...,2,-26,1,27
JSQNeMOTWPIELXdGFHgcUDYKVaBZbRCfA,QAAAeAAAMAEA.OACC..TBCAIAGAEAHFdBEAHCDAhAAAUCGBKBHBBDCDREEBAAAASEHDhBGAPDGDGEAAhAEA.FFCADIFAaFEDCHHB.fGGE.hCAANEIA......hCBA...,1,7,-18,25
PDOfAECITXcYKLgBZGSMQRNFdJbVWaUHe,EAAATAAA..XACAKACCLAFAZAEBGAGAMBEB.RCCBdDAAVCFAhAAAUEGBHDCB.eEHFhAGAOFEBACCACFEA..IHAAhAHAgGBABGFASGHDNICB..hAAA......hADA...,2,-11,2,13
IPGYHWSXaAJgTEVFQZNDBLdUcebCMfORK,TAAAEAAAFACD..ZADBBACBLAGBdAEAeAGB..MAIBRCCBKCFBGCEAhAAAHEBB.SEGAhBFAAAHAVEGB.QGBAhBGADBIB.cGGAbFED.OHEC..hCAA......hCBA...,2,-11,-5,6
UMGSJaXgHbCOIWPeRVBFdKYLNZfEADQcT,QAAATAAA.GACBaACAHAEBOAFA..IAGAhAAAeBHFRCDAFDAAdCCALCHBhAIAZEFAADIBDGCA.MDBBXGEAhAAAbDFDCEDAPHDABHHA.......hADA......hCAA...,2,-6,5,11
FRVOSUJXNCAgKQEfBWaMHGDYPLIcdZbTe,QAAAEAAABACA.aACEHADB.GAGADAFALBFAdDDDZEFEeFAAhAAARCDBSDAAXGBAhAFAABGAKDFC.MDIBIGGAhAGAbEGD.FGEHOFFB.NIAB....hAIA......hBFA...,2,-5,-5,0
HaKVEeBdYNcFRUGCbPIWSJQAXDgOfLZTM,DAAAOAAAZABEHAEBKADA.EAGAeAFE.dCCA..NBIA.RBEAGDFAhAIA.CCHA.bCCD.IDAAhADASBBD.AEEA.hBAAfCGAMEIBaHECBHHDFEGDPFED.hCAAQGAA.hDAA...,1,-4,-19,15
aIgDHSMbXcOfYRQdUNJZATCVEFeWGKLPB,TAAAEAAAFACD..GAEALACBBAGAaAEADAIBHAGB..MCHBhAAAbBDD..ODFDRDDBdEAAUFGBhAEAZEGBAAIBeFBAKGDD.hAGA............hBEA......hCAA...,1,-2,-22,20
fLDcJHPNeRdbaBZWXAVOTgQMIFUEGYKCS,TAAAMAAAFADD.GAFACACBLAEA.DAIBHBBB.eAHBRCCAaCFAhAAAZDEF.AAFBODGDhAIAQDFDEGHF.SEEDhAFA.fFHA.PGAAhAGANEEA.BGFA...hBAA...,1,-5,-15,10
XbWUMNPBcKQdAEGaOgHRLSDZJFCTYIfVe,EAAAaAAAHACBRACA.LAEAZAFBCAHA...TCEA..fCCEhAAAeAHHbEEAMBBBhAFABCECQDAChADAADIBGGABSFHHFCHBIEEAXGEBUEGBcFADhAFA.dHGB..hCAA...,2,-19,16,35
eHDfVObELUWaKRcSQMZITNJBPYCXAdFgG,dAAAGAAAHADADADAOAFAEAFA.LCCAUCDAKAHBRCFF..QDAChACAZCFB.TFGAhADABDHACEBAABIBeEEBVFDB.aHCAhBAAMFIB...IGGA...hBCA......hCDA...,1,2,-25,27
VANaOMEHGKLdFfWDUITRZgeSJBPCcYQXb,aAAAEAAAHACAGACAdAFAFAEADAHB..UCFARCCAeBHHBAHA..CDFAQEAAhAAAXEBCABBB.MEEBhAEALDHB.fEEEhAHATFFASFHBPHFA...hBAA......hBEA...,2,-25,-3,22
XRBaYIEbNMSgVUOWGLQfFJTPDeZAHdCcK,HAAAdAAAKADARADFBAFB..aAFAEAHB.MCABSAHH.UCCAhACAGCEALCFBhADAQDGCFDHB.TGCAhAAAeFDBAFIBXGGA.bDADgGBBhBAAOCCB.fGGAhBCADIAA..,1,-5,-18,13
aEgfBcHTWUCSePRVKYQNXIJbLdOFAGDMZ,GAAAZAAAEADEBAFBHADATBGA.CAHB.eAGHRCDA.KCAAQEFAhAAAXCED.IFAAhACALDDDdFHAAAIBaCHDfDCEhADAUFFA.SFED.YGAGhAFANECAOHDCMIDA.hABA...,1,19,-24,43
OcZTLSUWRQBeXPAMKCfDHEgJbVdNGYIaF,MAAACAAAHACA..EADAJAFAdAGAGCAA..aBBBOCCEZBEBTCCAhAIALCFB.SCHBhAAARDFFeDHHABIBDECBbDGD.hACA..NHDB.FFEH........hAEA......hAIA...,1,-14,-15,1
VdMJIeEWCALYUQgNDcBOPXRTGFfSHabZK,LAAAQAAADAEAOACCRAFAGBDA.FCAAHAFB.ZCDFdCHAMAIBhAAAeDFFEDFBAFCAUGGAhABAgEAABHDA.TFGAhAEA.aHAA.KHDA.......hACA......hAIA...,2,-23,6,29
MLHWBZTdQEcDSXbUKNfVAOPeGgJIRCFaY,eAAAGAAA.JADARADAaAGALAGB.HCDBZCCAdCGA.EEAASCHHhAAAUFCAKFFA.fEGEhACAAAAA.ODBDhAIAIHFAFFDHMFFBBHBD.QGGBhBAADDIB......hBCA...,2,-22,-6,16
XBLQEFOHUVcMNRTWdPZaIgJGbfDKYeCSA,LAAAEAAAHACAUAFAMAEARBCAdBHA.ZCCAaAGE..JDGFGCAA.hAAADCGAeEAAACABBDEAQGGBhAEAODFD.NEEA.PDHBhABA...bFBD.KEDD...SGHHhACA..hBFA...,2,-14,-9,5
DGHTLUJVcOXFINfKZaSbdgeWYEABPCQRM,CAAARAAAGADAHACALAFBUAGA...VCAAXDAAFAHB...hAAAIDFAKCHBaDECdFCAhACAeDDDEEABAAAABAFD.hAEAMDHBTEGAOFFBfFFESGHHhADA......hBIA...,1,-2,-22,20
ETceMHJBYfWVRSXdUZPGDKOCLIaAgbQFN,QAAAEAAA.eACAHACABAFAfAFBRAGFdCDAZDABGCCBhAAAOCFBLAHB.hAAAACFAbEAATEGAMEFAYGEAhADASFFA.PHCADCIB.CGHA..hAIA......hCAA...,2,-14,10,24
KGJMWcUYASVTbODBdRXgeQEFIHfPZNaLC,TAAADAAARABA..eAEEEACEHAEBZBFA.aAGALCDBGBGAMCCBhAAAUEGAAAHA..SDDBhAEAOFEDBGDCdFFAQGBAhBGA.fHGFCHHA..hCAA......hCDA...,1,3,-36,39
GAMJFZfbRKDdBQXYHOVPWIUgNECLcaeST,MAAAZAAARAEAdAHABADA..QCAAHAEBOAGF..VCDBIBBAhAGAUDGA..EEABLDCBhAIA.eCHHhBAAGGCBAEEAfEFADACAXGGBPFHD.hABANIBBaGGH....hBIA...,2,-19,-5,14
SAKIFPZWJcTaXfBUVeRHQdbOEgLGYCNMD,FAAAZAAAJADA..aACDBAGBUAEA..RCAAHCEAdAHA..EDDAGECAhABACDFA.MAIBABGAKDHB.hACA...IEHAhCAAPEBB.TFFA..fFFAhBAA.eHDG...hCBA...,2,-33,-23,10
XRSVQDeYTMCIPNEabcWUZLFJGfdHKOABg,XAAARAAAQADCDADA...eAFEMAGBCBFA.....IAHAhAAAECCBbCEA.UBDAZEEAFGEAhAAAGCGA.HEEBhABAACIBBHHASDCD......hCAA......hCBA...,2,-25,-15,10
OaAdMBNCPVTDLKXJgbfHWReQZIScFUGEY,dAAAMAAACADA...TADALAFA.KCBAXAFB.JAHBbCEAhACAHBBB.RDEAeDHHhBAAZDAASDHHFEDHUGGB.hBBAEEEAaFCHAAGABFCD.PFGBDGFB.gGCAhADA...hCAA...,2,-20,-2,18
SAeOWNQTBgMYDIZRCfdGELbHUFcKVaJPX,eAAAOAAAQADABADA.MAGBDAFARBDAdAHAGBGAECCB.HDDChAIAFDFHKDHB..aBBHXEDDhAAAABIB.TGGAhABAgFGAZFBBfHDBbGBA...hBAA......hBGA...,1,4,-25,29
JPLfXMODCUZdVWNHgeAQRTbEacGBIKYFS,RAAAEAAAGADAKACA.FAFA..SAEBLCGBMAIBCAGAZCCAdCGA.hAAA.VDAAHECAADFAQFEChABAaDHDBFGDIGAAhAAA...PGDCOFBEDAIBNEIA..hAGA......hCAA...,1,-6,-22,16
SXYGMIWcdaFUKTfJeVOQANbCPgELRBDZH,CAAAEAAARACA.ZACBHAFB..XAEAGCAAMAIB..IAHAhAAAdCCDaDEDKDGATCEAeFADhAAAQDGAAACA.hAFAbECBLFGBSCBF.cFAA.hAHAfFFA.hBHAOHCE.,2,-1,-1,0
KWeXdcHVNAZICLPJgDOEbGSTQYBMfFUaR,ZAAALAAAJADA.OADDGAGA..TAFAQCAABAHBMCABhABAFCDDRDFB...eCCBhACAdFCA.HCEBAAIBCFHADFFBECGAbEGDhAFA..SGAB....hABA......hACA...,2,-24,-5,19
eKJbSCUBGVMRYIDgPAQLaWOfNdHTcXFZE,aAAAOAAA.dAEAHACB.TAEAFAGAEBBBeAGH.KCHBSBDDhBAABDEAGEAARBFFDCIBAAIBLEDAhAEA.fEHEhAGAXDGDbEBACGGA.MFFB.gGGAhBEA...hBAA...,1,-10,-16,6
PXFZDNfEebKSUacVJTBGdHgAIMCWOLYRQ,MAAAOAAARACA...QADAFAFAZBFEDBBBEAFA.KAHBUCCB..hAIAaBBC..VDFATCFAhBAAdGGA.HDDBAFFB.CDHALFGBhCAA.PHCA....hCHA......hDAA...,2,-34,-11,23
FPEgRdOUZXQWeICHANacGLVbYKBJSfDMT,aAAAGAAALADA..bADABAHA.SBBDMAHBTCDAhAAAECCERCEFdDGD.ZEAAQCGChAEAeEFBCDCDAADANIABcECAhAFAKFHB...DEIB.FFGBOHFE..hACAWHAA.IHHAhAHA..,2,-9,-4,5
cJDMIEHSbRBgdGOCeNXTfZVWaKUPFYQLA,DAAAEAAAHACARABABAEBGAFA.eAHB.TCDAZAFBaAHD.KCDBFDHHhAAALDHBAAEAMCCBbFEBhAIAdEFA...CGGA.XFCAhBAA...fDCE..hBHA...WHEA.hCAA...,2,-33,-3,30
VQbFgUGCcSIDaOLWZKJdNYAHBXReTEfPM,HAAARAAAEADE.MACA.QAFAFAFAGCCASBDHaAHD.LBHBhAAAZCFAdEFAAAAAeCCDhAIA.TEEAfEHEhCAAbGDACCFDDFIBKGCD.........hCCA......hCEA...,1,8,-21,29
eXPBVMbDSGICdTJEAafKWFLHYUOcZNQRg,aAAAKAAALACBHACBOAEAZAEARCEA..eAHFBAHBMBBBDCIBGECAhAAAdCFAEDHF..ADEAFEBDUFAAhAFAQFFC.hAGA.XEEA.bFGDCHHA...fHEFhCAA...hBAA...,1,-12,-13,1
UBKCTdHcfDFGLaVbZgNPYAOSRMEWXQIeJ,RAAAEAAAQADC..eACABAFBTAFAHAGBDCCBGCCAaCFHZDDFhAAAgCFA.hABAPDABAAIBMDIBXEFAhAAAIGGAKGGDCGDD.dHAB......hADA......hAHA...,2,-18,-9,9
aRAGYfWNOUJECBVgbTcMSHXQLIFZKdeDP,GAAA..fAAAOADAEAGABADA.VAFAbBFAMCDBhAAAHCAALCEBZCEA.hACAeCHFaDBDAEEANDGACEDCTEFAhBAAXFAAFFHDDIEAPFHD.....hBCA......hBDA...,1,-5,-7,2
YaNTIAedWEJfCHGOQMgVDPBZFUcSXbLKR,eAAAEAAA.CADA.HACAGAEAMAEA.DAIBZAGBFBFDSCCBLDDBRCGFhAAAaCHD..TFFAhBHAAAAAdEEDJFGBOCCH..hCAAQGAA.......hCBA......hCEA...,2,-17,-11,6
efXUPDcWQAdEKZTHFVBbINMCSLgaORJYG,EAAAZAAAHAEABACA...bCABMAEA.LBEAaAGARCDB.GCCAhAAAeCFAUEGADAIBQEFAhBFAAADAdFFCFGCA.IGBAhBGACHHA.ODHD.fFEE.hABA......hACA...,2,-10,-6,4
RAEQLKDXagTFfHYeIMSOdCcUNVJbWZPGB,EAAALAAADADA.aADDFAFDHAFA..eAHBMCABdBCACCCD.UDEAVCEBhABA..JDHFZCGBGEBAhAAAAAHAQFAA.hAIAXFGATGEAfGGB..hBEA......hCAA...,2,-24,-4,20
aSCTNHVfZOJUYMXbDPIBKgREdLGWAeFcQ,eAAAQAAACADA.HACAZAEBOAGDUAFAMAIBDAIB.BCDA.RDEAEEAAhAAAGCCA.AAAAaDHDhBGATFDA..fEFAhCAAXGFAIHBAdGGAFGDD.SHDGhAEA....hBHA...,2,-19,-10,9
IDYXfWVLSagebHRBdOTPQMNUJKGZCFcEA,DAAAXAAA..fACALADAaAGDeADHHCDABAFAdDHAOAGDhAFATEAA.MEFBhAAAUDEAKFCAZEGBFGGAAAIBIFCAhBAA..WHEGSBBD.hABAgGED.hAEA...,2,-24,-12,12
YgESKRHXQADBMUTbPNGeJLcOCVWIFfdaZ,MAAATAAA....bABAGACA.eAEALAFACAHA.ICCAhAGAdCFAZCGBECABRCEAHEEChAHAAAEABEDAPFCBcFDDhAAAOEHD.FHEAaFHD.SGGDhACA......hDCA...,1,-1,-16,15
aIHOPXJeRULgMTcNQGfBSAbKCYDZVWFEd,CAAAZAAAFACAEADE..dAFAHAFB.OAHFJAHB.RCAALDEA.hAAAMECBTCBA.QDEAhAHAGFDBSFABhABAADIBKECADEHBaFBCIHHA..eFHHhBCA.UGEA...hACA...,2,-23,-9,14
SeHcbXFPJWDaZCfdKTIRNQEBOUgYLMGAV,eAAAHAAAXADBFADD..JAFAaAFDZBFAdAHAKCCDRCAA..EDEAODEAhAAAUEGALFBAhAAA.ADHASFFDhACAbEEADEIBCGGD.fHBB.IHHAhBFANIAB......hBHA...,2,-32,2,34
VcgOWULBbXGfPMCdEHATDFZIKaJRYSQeN,TAAAZAAAaACA..RAEF.QACC.eAEEVBGBOAHDLDDBhABAXBEDGGABMDDBhAAAEFFAAAGAFDHHKFHBSEEAhAHA.gGCABHHD.fGGAhCAA...hAIA...,1,1,-19,20
HWSDKOEZTMBbPRcFLQCgJeVXUYfGaNIAd,HAAADAAAEACAZADB.MAGBBAEARCGF.LAGB.QCCAhAIACAHAeCAAXDEDUEFAGGBBhBAAaEHDAACA.dFCB.KBBDbFBBhAAAFGHD....gGGG..hAHA......hBFA...,1,-12,-13,1
UOVXQAaBTHYgLSfKPZMIDNdGFeEWcRCbJ,aAAAHAAALADAKADCZAFBMAIBDAHB..GCCAEBEF.RCFB.CCADUEEAhAAAXEACBCCA..TFEAhAEASCHD.hAFAIFHAdDHAFBBH.eHBA.....hAIA......hBAA...,1,-15,-17,2
HFPWegITLMJYbcCOGDRSdEUBfNZKVXAQa,HAAAFAAAeACHTAEALAEAMAHB..JCAF..bBFAOCCB.hAFARDEAEEDBfCEEhAGA.ZDFBXFGAhAAAADDBaEHB.gGAAIHHACEEDSGCHhACA.dHFBNIAB....hADA...,1,0,-9,9
NdHAJMBZRYISWbUQFfEGKPgecaOCXVLDT,MAAARAAA..SADBUAEAQAGAEAFAGBGAKBBA.eCCBaDBA.hBAAXCEDLDFATFAAhAAAHEBAADGAZFFAIFFAhBBAFGCD...fFHA..hBDA......hBEA...,2,-21,0,21
JENGFKXIDCeOBUbTHPWZRAMdgfaSVQLYc,dAAAaAAA.QADALADA..JAHBEAFAGCCAXBGA.CCBABDADhACAbCFD.HDCAZEAFABBBMDGBhADASEHB.hAIA.cFDBKFEDDCFBeEHBTGGAPHDCWFADhAEAfHGB.hAFA...,1,5,-17,22
SRUJODfILCYWTAeBVgZdXEcHMbQFNGaPK,eAAABAAAZACAEADAHAFAMADA.FCCAGAGA.KCCARCEFOCGD.hAAADCIBLDFBCFGD.hAAATECAAAHA.dFHA.hABAbGBAaFHD..SHGG...hCAA......hCBA...,2,-23,-15,8
GNeMAbcgBFPZEfCTIKWRVHdYUXDQSOaLJ,...bAAABAAA.ZACAEAEATAGAKAGARCAAHCEAdCCAUCGB.DADAQEABhAAA.aCGAhABAGECBeECHACAAFEHHCEEDIEGAhACAVGAA.SEHH..hAEA......hAIA...,2,-26,-2,24
VMDJeNUfYHGCKbZXIgOLFSBPTRcQdAWaE,EAAAMAAADADA..eACAUAGAHAFAGBCAKBBDZCDA..XBEBhAAAOCHBLECAhAHABCBCRDGBdEEAAEIBaFGC.NIAB.CGDDbGFAhBCA..IHHA.....hBIA......hCAA...,2,-18,-8,10
KCAdOfSJZYRTDGUcQVIaegXBbHMELNWPF,dAAASAAAZABBRADAGAGAQADA.aAFEeCEF.BDCAHCCAhAAAEDFFLCGB.hAEAPDABCEHAAAIBOFGBhAGAfDFA.TGAADIDA.cFGDIHHAhBAA.....hABA...,2,-17,-17,0
MFRBacDdCSXgbNKWeYfHUPTOJEZLVQAIG,GAAARAAABADBDAFAdADASAFA..bAFAKBHB.eCDAHCCAhAAATDFAECFEZDFELFAAhAAAAECBFFGA.aDBDXGGChABAgFFA.YHDAfHCB.hACAOEEH...hAFA...,1,-11,-13,2
aTPQeVDKUgNRbGJESXdBAFLWMIYZHfcCO,LAAAMAAAZABEHAEBCAEA..aAFDQAGAeAHB.KCCAUCAAhABARDEAGGABECDBdDFAADIBFFGAhAGA..IEHAhACAfGGETECA.DGGA.NHCB.SHDAhBAABHHA.....hAEA...,2,-19,5,24
YFZLXPCEUSdBRgKbfcJAVaDITeOGNHQWM,aAAATAAAGACA.HAEAMACAZCEELAGBCAHB.EBDAdEAARCEBKCCDhAAAbDFA...JDHBABBBDFFAhAEAeDBDQGCAhAGAFGBHXGFCSGGA......hBAA......hCAA...,1,-5,-6,1
AcdMJKUXLgSfYZFHeRGQEbVNWODTaPCIB,dAAAMAAAKADALAEA..fAFBZBBAHCEBRCGBEBHF..bDBBhAFAVCBA..OFGBhAGAaCFBCDADBDGDAAIBJGCE.XECAhACASFHHeDHH.QGFChADADICA.IHAA.hBAA...,2,-9,-9,0
NHJDEAabeMSUdCWBRZPTVYGIQFXKOLfgc,eAAAMAAAdAEABADARAGB.ZAEB....TBBAGAGA.QCCAhAAAKCFBLDBAfDFAhABANDIA.HFGBEEFBAAIBhAGAbGBACHEA....WEGH.....hAIA......hBGA...,1,-11,-24,13
KXabIfQcMUPLGYTVDgZeWOHEJRASCFdNB,FAAAdAAAKADA..aACD..IAGAQAEAUCCAGBGA.hACATCDADAIBeCFBHEAAhAEARDABACGACAHBXEFDhBAA.bGBAMDHB.LFEBYFHBgGGAhADA.OFAHhAFA..,1,-8,-19,11
faEVRIZBXDMQbHYNCAPJOFcWKSLdGUgeT,OAAAFAAAKADALAFBGADAeAFA.aBBHRCCBZBGB.DCIBMBIBHDABhADACCFAAAFA...PDGDhBAAJEFF..SFCAhAHAdFEAgDBAEFHBBCECQGGB.hAIAYHCA..hBDA...,1,-12,-15,3
AacWBEbZHCdPRGMOeYFJfgQSTKXNVDULI,aAAABAAAZACBHACA.dAFARAEAGCEBeAHBFCAA..JECAQDDAhAAA.TDFAXEGAhAFADEAALFHBhACAAAHAEGGBCBBDMHCAfGGA.KHCANIBB....hAEA......hAIA...,2,-16,-7,9
YdQbfCBJEUSNKOLIAHaTVWgRDZGXFMcPe,HAAAaAAA.TAEA..gACHRAGFGCABMCIBeAEHdAGAbDEDBDGDhAAAECHFUDDB.KEGDhAIALEAAABBBDEIBZGBAFFHHhACA.PGAAfGHE.SGDEhBAANIAB.....hADA...,1,10,-3,13
AXeTKRbdIfcQGEOHWUgMBJFLYNaZVCSPD,eAAARAAAdADA...IAEAQAFA.ECCBHAFB.UCCAMAIBhAAAFAHFLDFBaDBBZDFASFFAhAAAADHBTEDAbFABhABAfGHA.OHDABEHA...hAFA......hBHA...,1,-6,-16,10
OSQVIAKgFBcGDUWPbfZNXJTHaeMYdLCER,FAAAGAAADADA.UADA....bADAZAFB.XCGDHBGBeCCAhAHAdDDAEFBBRDEBQGEBhAIA.ABIBBHGAPFEChAAANEIA.aBHF.MFIB.CHFA......hBAA......hCAA...,2,-17,-11,6
PFJVYbTCfgXHcQWBEdDMLAUGRIeNaOKSZ,RAAAeAAAOADAZADBFAFD..JAGB..VCGB..TBDACAHA.hAAA.XDBCHDDCQEGAhAAAEBCF.dHDBhABAMDFBAAIBIHHAaFHDSGFH.PHAAhABA....hAHA...,1,-17,-23,6
VKSLeObDgIQHcUPFTCMRXZfNadJEGBYAW,KAAAeAAADACAQADAHADCUAGAFAFE.MAIBRCCAZDFB....aCCBhAAAEDHFGCFAACCA.SDDBhABALEED.bFGDhCAAIGHAPFDB........hAAA......hBIA...,2,-29,3,32
TBPbCIOVeGDcRAgYdHQKZWSENULaJXMFf,dAAAHAAAZABBEADELAEAaAFA.MAIBFBFDBBHA.CCAD.OCEAhAFAeCCBGDGARDBAADFB.QEEAhAAASDGHNECA.hACAXFFC.TGAA.IHHAhAGADGIB.....hAIA...,2,-13,-10,3
HNcACgYGOQdDBKFJeTWXMUPbLfSRIaEVZ,CAAAGAAAdACABAEAFADAeAFH...TCGAMAGBUDDA.LAHBhAAARCDBEAHBHDBBABHB.hAEAOEGBQEGAhBCAKFHBWFFD..bFCC.SGEA.hAAAIHHA..hCAA...,2,-38,0,38
NIUGdBOXMVLfAEeagPHRCcYDJSZWTbFKQ,EAAAeAAA..aACDHADARAEA.CAGBDAIBZCBA...TCCAKBHBQCFDhAAAUCFAdDHABEEDMEAALFAAhAEAAAAA.gEGAhAFAcFAASFDDbGECFHAA.IGFAhAFA....hCAA...,1,8,-30,38
YCTEgBbFLDGJdHUQIXaRcZPOKWfSVMAeN,eAAACAAA.EADABACALAGBGADAHBDCQAFAaCCCZDFEKFGASBHBhAAAAAAA.TCAAhACAbGBADAIB..dDFAXGFChBGAREGFODDH.fFAA.MHDAhAFA.NIAB....hCAA...,2,-7,-4,3
WYCQeBZcDIRHLNVTSOAPJXfbMGEFaUgdK,XAAAMAAAGACBFADA.UAGA..dAGAKBBDCBDDBCEAZCDADDHBHDEChAAALEEB..TFGAhABAADIBJFAA.EGBAaGFD.hAIA.YFFF.eDDDIHHANBIA.hBGA......hCAA...,1,-15,-23,8
YdJCSVZUbfQWMGOFNPBcKTRHgEDaXALIe,eAAAdAAASADAZADBUAGA...QAGAGCEAFDBBBCBAKDGCHFBAhAAAECEAaDACACCALFHBhABAIDGA..CDDDbECAhACAMIBA....ODHDcGFBRGAAXGFAhADA....hAEA...,1,-4,-12,8
SLJBEcHIROaZDPGgUAeVNYdbXWTKMQFfC,eAAAVAAA.dAEA...XAGATAEAMAHBQBCA.CCFALDHBhAAAECDBHCFBRDAAZEEBhABAGFDBAAGA.bGACFGGHhCAASGHHBEGAOHCCDBIB.....hAAA......hADA...,2,-6,-3,3
WVMQEeLGgUXaOdTCKNYBSZJPAfcIFbDHR,..IAAAbAAA.HACARAEAMAIB.ECAAeAEE.GCAAUCEBaCHHhAAAdAHATCDA.hABAKCGDBEAAZEFAACABFEFHDFCAhACAWDDDLHEAOFHBCDHA.SFAAhACA.fHABhAEA...,1,6,-18,24
cBQWKLSAZVEMOaTUfGRFPHeIgDbdXCYNJ,EAAAaAAA.UADARACF.HAFAeAEE..DBCBdAHACCGA.JBEBBDBD.KDDAABBBZDFBhBAA..MCIBTGCAhCAAGEFA.FFDBIFHAhCGA.........hAAA......hAHA...,2,-29,-26,3
fFCbcOJdUXAMHDgZNTaKWQSRLIePYEGBV,HAAAZAAAaACAQADC.RAFFeAHHEAFAGBGABCADFCCHCCCDOCEBhABAdEEAADIBMEHBDAIB.TFAAhAAASEGD.hACALFAAYFDFbFED.....cGCDhAFAXGFDKGHB..hAFA...,1,-2,-7,5
DcJEFGPVYXKWLUQBZIaRgNCfHdSeATObM,TAAAMAAADAEA..EACEGAGA..PAEAXBBALBHBhAAAQBEAZCCARECACCGAHEBAhAIAeEGBABBAODHDhBAA.bEEBFGCHKGGAWFHH......hAIA......hCAA...,2,-11,-3,8
ZSBQMOHWcENPDXIUfVedaYAgFKRGbTLCJ,KAAARAAAGADALACBZAFABCCDMAEA.HCFAEAHF.DAGA..UBEAeDABhAAAaCHDAEFB..FEGDTECAhAAACGHA...QEEChCAAOHCA.cGCC...XGEAhCBA.IHHAhCCA..,1,-8,-23,15
FcKfBGSgAMRUZPbeaEdHCXNLVOYDQWTJI,RAAAZAAAeADEEADEHAFB.CAHA.LAGB.OBDCQCAAhABATDDAFCDDKCCDGDGAhACAAAAAMAIBbFAA.dEFCXEGAhCAAYHAADFDB.IGEA.BGGAhDAASGHH..hAFA...,2,-13,-1,12
HIEXSPdRfCJGLMOFaYgeUZVDABTcQKNWb,TAAAQAAA.KACA..bACBHAEBEAEA.SAGARAGB.hAAACCDDGCGAMCCBaCGHeEAAhAAAZDEFAAIBBEEA.cGAAhAEAIFHAdGDALGFAFFCD...hCAA......hCEA...,2,-15,7,22
KYHJTfNDBaAReCZLMObEGcSVIdUXgFWPQ,RAAAeAAAZADBLAGBMAEA..EAHFGCEASBCAdCCCUFBAFBFBQDBAhAAAHEGB.hAAATDGADAIBABGBODABhABAbEDBVFFB..........hABA......hBDA...,2,-9,-8,1
McbSdaINLgeFGRXOQWKEYfTDJVCUAPHBZ,HAAAZAAAMACASACEdAGA.aAEDLBEBeAGBRCCB.QCCBhABA.ECHFTEFAhAAADDGBCEHAAAIBBAHB.bFDDgFFGhBGAFFHD........hCAA......hCBA...,1,-5,-23,18
VGESeAdJQaPTHMILWOKfNgCZRUbYcBXDF,dAAAaAAAHACBMADALAHBKAEA..fAGBCBDARBEF.UCFAhAEA..bABDBCHAFDGHEEEBhBAAABBBQEDChAIA.TFGAOEHDNIEB.ZGBA.cGGC.hBAA......hCAA...,1,-9,-19,10
ONKdFfQVPWcaMJLEBSUHGRZbYXeAgIDTC,DAAATAAAOABE..dACAQAEC..PAEAaAGAMBHBhBAAEAHFSBDHhAAAHCCARDFBZGCA.bCED.eCGBhCAAACIBCEEDFGHBfFHA.cGEA..hCIA......hDAA...,1,-10,-19,9
VJBbCKXOeSTEFLIZHNMgRDWPYdcfGUaQA,BAAAKAAAeACEEACALAFAHAFB..MAIBRBCADCAB....PBCDhAAAdCGAGDEAaCEHAAHBJDGBhAFAbCAD...OEHDhCAATGAAZFDB..gGDD.cGGAhAAA....hACA...,2,-22,-10,12
ceRSBFfJbZUQCHMGLVgEYANIPdTXWDKOa,..IAAAdAAATADADACA.OAFA.eBFFRADAFAGA..bABDZCBAhBCA.QCFAhCAAHCGBGEDALDHBEDABABIBXFFDhADAaEFCBFCAfGGE..hCCA......hCDA...,2,-27,8,35
HRZKfGMPCJQELgaeFAcVbWBYDTINXOSUd,VAAABAAADACA....TAEAXADASAGBHAGBRCBAZDEBhAAAGCDAMDIBCCFAECHFaECD.hAGAAADA....bFFAIGGAhAIAODCHdHFBfGBE...hAAA......hAIA...,1,-14,-20,6
bHcCVOEXSWIaNfRJQAUeDZTYLgFPBdKMG,eAAAZAAALADBFADDdAFAGBGAHAFACCAAECFB..SAHBhAAA.aCCCRDGFAAHA.TFAAhABAgEEAKEEBMCCBhACAbFBB.OFHD.IHCAfFHA.hAFA......hCAA...,1,-10,-12,2
cBXRTMaHdWfZKAEYeDbGOJULQSFVCPgNI,EAAAeAAAGACAOADCLAEAFAGA.CBHA...PCCA..hAAAgCEAICGAXDEDhABARDGBaCBHHFAAdEGAhAFAZFFFACIBDEIB.........hAAA......hAFA...,1,-8,-22,14
DOHcaIPTRLCFJGfXYBKVANQWMZUgdSEbe,QAAAZAAAdAEAEAGA.eACAHCAA..aAFDTCFARBGFLCDB.hABAFDAAGEBA.XEDAhACAKEGDAAHAMDIBSDHHhADAbFBCOFEDIGGACGHD.fGAEhAGA.BHEA.hAAA...,2,-9,4,13
JcBTLeORNUafWKdEYXZQCFVSbAIGDHPgM,GAAAHAAAMACABADAeAEARAEFUAGA..aAHDKCDDECCAZDFB..QCEAhAAAFDHD.bDGBhBHAAAABDDABJEEF.LEEDhACAfGGEdGHA.........hADA......hBCA...,2,-23,2,25
cXbBJgLaKRUICfPWEYQMFeVHANOdGZSTD,dAAAZAAADACA..bABDBAEA.LAGBRADACAGB....fBHAhADAEBFFMAIBeCCBhABAHCEBACGBGEDA.TGFAhCAAXEAA.aDHD.KEDD.IGFAhAEAYFFCFHGENECA...hCBA...,1,-9,-26,17
NgAeYUGBKECQcLSDTXbJWfIZOMdaFVPRH,eAAAGAAAEADAQADALAGB.DAGATBEAXBFB.JBHBfCCAhAAAZDCA.dEDAhABAaDAHFDHDREFFHFDBAAIBBFFAhBGACHGA.bGEA..........hCAA......hCBA...,2,-10,-2,8
DOETCQcXdaHKLgJBFeZVRGNPMfISYUbWA,EAAATAAA..QACAdACAHAEALAHBBAEAeAFHRCDBGDFAhAAAMAHBSCCDhAAAUEAAAEHACFDDaFHDKDFAFEDD.ZFFAhAIAPHCAfHFB......hBIA......hCAA...,2,-18,6,24
dBAHQPKDUYEcfGbVTFWIXRaLNMeJgOZSC,HAAAQAAADACAEAEAGACB..bAGDTBGA.FCDHXCCAhAAARDABaAGA.MCFBeDFBhAAAOEFDZEGBdGDAAAIBKEHBhBGAYFAFfGCAWFFD.LHEA.hADA......hAFA...,2,-3,3,6
VCJWQdYLKBAIZGUaFENDOTeRSMbcPgHfX,GAAAaAAA.EADAOACDRAFA..MCDB..bAEA..gCEBhAAAHCDBXCGAhAEACCHAQEGAdEGALFAAhAFAADABZGAAFEEHDBBBeFFDSGGDcGCD..hAGA......hAIA...,1,-2,-10,8
cOfgQAdBCPVeWLHYNFaIZMXSKEbUGJDTR,dAAACAAA.eADAHACAFAGDZAFB.MAIBKCBAUDEAGCAA.DBHBRDGB.OCDDhAAA..QEAAhACAACABBCCD..PEGBhACALFCB.aGGCSEHB.EFCBhAEA.bFED....hAFA...,2,-23,-14,9
QEAFRdVSYBOCKgWafIeLXPUbcGMJZNHDT,RAAAdAAA.SADAOADAKAGA..aAFDeBDFLAHBUCFAGEDAhAAAZABBHDCA.TEAAhAEAACCBFFFABCHACDGD..fEHAhBAAIHHA.bFDAMIAADGIBEHBA..hBHA......hCDA...,2,-22,-1,21
gZIdbLXSBAGKQaUfRTHFYCDcEOVWMNPJe,GAAAaAAA.RADAHAGBCADADAFA.ECDB..OAHDMCFB...JBBFeDADhAAAZBEB.bDFDLDDDhADABDHAAAIBQGABhACAUFFAFCGH.YFHB..WHBA..hBAA......hBHA...,1,15,-34,49
GBcUYESLIQZPMeJDXVbHKRfAdCTWNgaOF,dAAATAAA..NADA.aACAGAEA.BAGAUAFA.EBDBLCHBhACAZCFEeCCBXEAAhAEAHEECRFBBAAIBCCBA.OEHDFDGBSEDHhAGAIHEA.MFFB.DGGA...hAAA......hBFA...,2,-16,-4,12
EUZgTScGPJQdFNCYXaHLOIbDAKRBWMeVf,RAAAMAAAeADE..EADAZAGB..SAFAGBDAQEGAhAAAdBBACBHAaCEA.HFCALDDBhAGAOCCHDDFBABIBBGAA.hAIAfGGETFGAPHDA....hBAA......hCAA...,1,-3,-24,21
URcPJDFeNMgQAfabLOKSGWZYdBHCTVEIX,aAAALAAA.SADHZACBdAFAHBGBCAFA.ECEBUCAAREBA.JAHBeEGBhAHA.MBBBACFAODDAhABAKFFD.GEEB.hAIABDHA...TFAA.IGHAhACA.....hBAA...,1,-18,-19,1
bXJAZSUNDRHgICTGOQdcLYBVPKMFeEaWf,ZAAASAAADACAHAEACADA.GCCB.dAHALAFABDGAKEFDeCCAhAAA.ECFAaDHD..bDAChABAAGAARGAA..TDGAhADAQGGAcEEA.PFHD.MGAA.hABAfHAB.hAGA...,2,-18,-2,16
dfTYLDBbQFaCWeKgOSJRHcENXAPMIUVGZ,MAAAVAAA.dAEA....TAEALAGBBAGBbBBBQCDChAAA.aAHDeCHHOCFDhADARDCFHEFBEDHBAEAAIGBAhAIAZFFADHFA.CFECWFHHSEAA.NIDB..hBAA......hBEA...,2,-16,-3,13
JNGBePOfDRKbIcgMXYAUWVaCHEdFZTLQS,VAAAHAAAEADE.ZAFBLADBQCABSAFAGCGAeCEDhAAAOAHDRDCBKAHB.bFABgCEHhAAA.MDCBhAFAAFGBaFHDdEGA.TGAANIDB.fGFEhAGA.DEIB.IHDAhCAA.,2,-23,21,44
NfCTEdGSZPOKeabDWIUHBYgLVXJFQMRcA,CAAAEAAAGACAZACB.KAEAeAEA.DAIBUAGAHBGBBCAALCBD.hAAAXCEBQCEDhACAREDBAEIB.TEAAdFFAOFABhAAAaDGD...IHHAgFEB.FHGEhAEA.MDIB.NIBB..hAFA...,2,-11,-6,5
QeETXPAWcHKBIbGaNORdUgCSZMLVFDfYJ,HAAABAAAGACAaACARAEF.dAEBCAGB.ZAGBLCCBDBFB..JCABEBHF.hAAATEEAAACB.KDHB.hBIA.bDFAOFHB.hCAASGCAMEEBfFFA.eHFAhCGA......hCIA...,1,-10,-28,18
FNILdPSeWMYEgcbaTVCRDJHZQXGBOAUfK,KAAAFAAALADAdACA.eAGHMAEA.EAHF..bCCA..aBDDTDGAhAEARBFBHDEBZECAGEGAhAAAAAIBUGGA..fFBAhBFAIFAA.........hAFA......hBAA...,1,-16,-19,3
LYBFZGAIegaCQdNHWTDVMSfKbUPEJXRcO,eAAAaAAA.dAEAHACBDAGA.MAEAKBCB.UBEA.EAHFRBFFLBHBhAAA.FDEHABBBCCHA.QEEAhBAATEBA.fEGFhCAAbFGB.XGCAOHDA.BFHA.hABAIHHA..hCGA...,1,-17,-22,5
TaHPRcGQDgeKLAUBJNWZSYIfOCbEFdXMV,BAAAJAAAZADBSACA..IAGACAFAEAHB.dCCC.MAIBhADAaCAAHCEA.RDABGECAhAAAQCFAeEEAABFBUFEAhBAAYEHBOHFEFHFC......hCAA......hCBA...,1,-1,-30,29
JBQdRDZTICaLfHYMNKgASEUcOGWbFeVXP,EAAAOAAAGACAFADD.eAEA..XAFABAHARCEAZEAACBBD.aCBHHCDChAFA.MAIBKDHBACHASDGHhAGAUEEB.bFFAhBAAPFHBdGCADEEB........hCAA......hCGA...,1,-10,-17,7
DCaZGOWPQTcIJKMAdeFLBfHYSVRUbNgEX,eAAALAAAHADASADHRAGFUCDB....bDFDEAFA.CAHAGCAAhABAOCHDQFAAhAAATCFAIDDAMEEBAAFAhABAdCHAfGHAVFCAXFFBDCCB.aFAH.hAIAPFHD...hCAA...,2,0,8,8
JNXAZcLWCYgSaUHBKDfeTMEPIbRVGOQdF,ZAAALAAACADB.SADHHAEBDAGAeBGHEAFA....bBFARCAAGEDAhABAdCAA.FDHDXCCChABAABIB.cDEBhACAgFFBBDGATFAAIGBAQFFAhAFA.WFHH.hACAaHBE..,2,-23,3,26
LcBKJeHVdOWaAfEMGPbZXQFCgTDUNISRY,EAAAGAAAZACB.QADACAEA.DAGAIAGARBFFLBHB.KCDDhAAAHCEAdEEAODAHhACAAAIBMCBBXDGATFBASFHBhADABECAeEEBaGFDfGCAFHDG.hBAAgGFH.hBCA...,2,-18,6,24
eSNUHbFCYWKVPDfTLRaEgGQdAMBZIJXOc,ZAAAXAAAeACEUAFAHADAFAGA..CAHAKCCDDCDBLCFA.hABAEDAAGDEAAAAABEDAOCHDhCAASEGA.hCBAbFABYECB.PHFCRFEBaGCBdGGA.hCEA......hDAA...,2,-26,4,30
VMOIDTdcQYKCeEUJAaRHWSXbfFgGBLZPN,HAAAXAAAFADAGAFAZACB...PCABMAFADBEA.dBHAQCCAhAAACCEAUECAAAAA.RDGFbFDBhACABEFALHAAhAHA.OFHDTFGA.KHCA.EHEEaBHF.SGGDhAIA..hCCA...,1,10,-26,36
aXWeDRdbKGAHSMCgTUIQLEcBZVONJfFPY,HAAAMAAA.TAEAQADAEAGE.ZAFBOCABJAHB.FCCA.aCFDeBBBhBAARDGF.dDDAGEAAhAAAADIBCEGAUGEALFDBBFBA.hBCAfFFE.YFHBDGHB..hACA......hADA...,1,7,-19,26
LIPgaWHKOTQeUVBCFYSJdXbDNcEMAZGRf,RAAALAAA..gADBHADBTAFAeAFEBAHB.FCAASBFHhAAAdCHADDDBEEEAACCAGCGAhABA.fDDAhAIAaFAAOFGBQFEACFHBXGDAcGGDhCAAIHHA...hCIA...,2,-24,-8,16
PDEgCABTVHGeNbUMZFOLXcWQIYRKSdJaf,TAAAHAAAeACE.UAFAZACBLAFA.XBECQCCAhAAARCFAdEEAaBHDDCABEDFBAAGABEHAhAAAGEGAMHEAOFFHhAIA.IGDASGGEfHBBhBHA......hCAA...,2,-12,-6,6
XMEPNLOdQaBWFZVAUTfKbecJIGRHDSYCg,TAAAKAAAeACE..JACARAFFHBCB.SAHBCAFBMAHB.ECHBLCCAhAAA.dDGDaDFChAAAFECAAECBUFFA.bFAAhAFAGFEBDEEB.XGCC.OHFEhAIA......hBIA...,2,-21,-5,16
bAFTXHUKGJceBLdMQRIgDOWEfYPSaCNZV,TAAAHAAAGADA.eAFAdACARAEADBIBEBHF..fCAEhAAASCDHaCCHZDFAAAFAXCFAhACAKEAABFFAMFHB.hADAQGCAOEFBPEHDCHAA....hCGA......hDDA...,2,-12,-7,5
DVfMAJTCGdYOgLREeXWZbNFUHBIQPKacS,TAAAdAAAOADA.RAGB.EACE..eBDBZAEBFAGDHCACQCCAhAAAKCFBaDHD.DAIB.MDGBhAEAAAIBGEBBLDHBbGFABFGDhACAIFEA.SHEA..hCAA......hCCA...,2,-17,-5,12
ZdJUcDELTHBKaNSRgAVOFIQXbPfCWGYeM,FAAAQAAA..bACDCACAGADA.eAFAdAEAUAGAEBHFHCFBhAAAaDEDRDGBAAFAODDHhCAA.XFFAfEBAhBAAMDIBZGBE.DFGB.BHHA....hBEA......hBGA...,2,-24,3,27
cZFMLDWXSNRPVfQaTeHEdKbOYIJBgCGAU,ZAAAMAAALADBDAEA.SAFARAFA..fBBAhAIAaAHDHCABECFBdCDAOCFBhBAA.ICHABDHAGEEAhABAAEBAFEGA.XFAAPFGB.....hBBA......hBDA...,1,-8,-31,23
BPcARQIJEVUbNSHFDegXMaOTGdKWfLZYC,RAAAQAAAEADE.UADASAFBHAFAeCFAMAHBODBAGCCAhAAAdEEAKCFDLEHBhAAAZEFBBEHAAAHAIHFAhBCA............hBDA......hCAA...,2,-27,-9,18
KCSUHATIOaRXdDQYGBgPMWZFNLbcEJfeV,TAAAaAAA..RACFdAEAQACCGAGABDEAMAEAZAFELEDAhAGAECDFeCFACEHAHGBA.AAIBOBBHhBAADDIBgEEAhAAAFGGA.bGCC.fGGASGDE..hBGA......hCAA...,1,4,-9,13
cVBLaNPKFYHQgMXAUDSZIdeWJCTbfGOER,SAAAdAAAeADACAGA...TADAGCABRAFFBAHBaAHD..KCFAHCCAhAAAMDIBACHAZDAF.IDHAhABAbEAA.EEEALEEAhACAFFGA.QGEAXGGCDFABfGHEhADA...hADA...,2,-12,-6,6
KHBZfbMOIJSPLGgXcEAUNaCdYWRQeFVTD,aAAAdAAARADA.FAGADADA.HAECZABB...MAIBOCEC..SBBAhAHAGDCA.XCDAhBAAACGACEAA.QDGChBBAeCHHTFEAfECA.bFFAIGHAhAEALHCA...hBAA...,1,-2,-30,28
GCOPNgRHJSLbETfVeMYQdZABacKFIUDWX,aAAAFAAADADAGACA..OAEE..gAEBHBCALAHBhBAAEAGE.TDEAeBBDMCHBhAIAdEHAACGAKEDDIDFAhBAAXGDACEBDREDBbFFDfGGE...hBEA......hCAA...,1,-7,-17,10
HSCYdJZgDAIXEOaLUGfeBTcPKVWbMQNRF,EAAAaAAAGACABACA....TAEAKAEAVBGBMAHB..RCEBHEAAhAEACCCAdCEDZDFEAAGA.OEAAhAAALFGBeEEDWEEDhAIAbGAA....QGGASBBD..hBAA......hBIA...,1,-6,-13,7
ZMIBGbfaKQLUeFWcdRDPTOgXHASJVCNYE,SAAACAAA.EADAZACA.MADAGAFAaAGDLCCBeAHBFCCAdDAAhAAARDGB.TEEAOCEBhAAAHEGBAAIB.VFBAIFFAhBGAfHDFKGDA.......hCAA......hCBA...,1,14,-32,46
ZWAdFJBVRYefNQgIOPEaCcUKDLGTMSbXH,dAAABAAARADA.eACAQAGCOAFC..ECAAaCAE.UDDALCDAhAAAGDGAMCHB.bECAHEABhACA.ACIBFGDA..hADAVGFANIAB.gDAA.CHAADCIBSGGDhAEA...hACA...,1,1,-15,16
IAdKSMRfDWCHLaXeTJcbBFVYOUZPGENQg,dAAAMAAARADADAGAHACC.aAFA..eBFA..TBFAJCBBBCHAFBBHOBHDhAIAZDCB.EDCAQEEAhACAADFBSEEAhBAACEGA.LFHB..XGDD.hCAA......hCDA...,2,-33,-11,22
TBNWRLVbCZXcSDaAgEJfKGIQOdHPMFYeU,EAAAKAAAGACA.QAEAHACAMAEAeAHBTBFABCAARCCALBHBhAAACCGAZDFA.SEEAhAIAAEAAJEDB.OFGDhCAAdFFAFGBBYHDA..WFGH..hAAA......hACA...,1,1,-18,19
MSHKRbYeQAFaZfICdgXJDLTBUEPOGVcWN,ZAAACAAAdACAJADALAEA.BBHAEAGEGCAA..VCDA.hABA.NCFAHCGBRDGBeCBBACABaCCChACA..fFAAhAAAXECADFIBTGCAOGCCMFFBKGGBQGGBhAFA...hAIA...,2,-14,-8,6
MAVEWZeagcOCPfKQUSNJFBYdRHXGITbDL,EAAAeAAA..aACDOADC.CAGB.KAEAQCCASAGBFBHDdCEAhAAAHCEDGDFA.bCBChAEAMEGBAAIB.ZFAAgGCAhBCAfEHAJFHBBHEA.....hCAA......hCGA...,2,-14,-14,0
VZdaMEPOQXfCATFYNeHBGUDIbSRcWKgJL,TAAAFAAAeACH.HAEAGACADAGA...bAEARCEAKBHBLCFAZEAAdEEDhAEAECAB.QEABhAAACEHAADDB.BEDASGGAhBAAgEGAaHEC.MFFB.XGAAhACA.fGHAhAEA...,1,-3,-15,12
ZRNHIJMVOEAWULKCFfPGYeTBDgbSQXcda,LAAAFAAAGACAeADHDAEA...SAFAQAGAdCAARBEFHDFBhBAAMAIBECEAADHA.KCGBfEBAhBEATEEAbFAAaEEHhBIAZGEA..JFHBOCCHCHEA.....hCAA......hCBA...,1,3,-11,14
fdAgXFQSDUbOGJMZWPaIcYETCeKLNVHRB,FAAAQAAADADA.OACCGAEBZAFBaBCD....IBHAhAAAECEBeCGFLCDBhAEAHEGBRFCAdHABADDBSDGAhAFA.bFCAMIDAcGFD.CHDA....hAHA......hAIA...,2,-16,-7,9
JTGKXOgHANeWdQBbYLCIfVUEFRDMPcSZa,eAAAdAAAQADABADALAFACAFA..VBGBECCARCEA..MCCBhACASCHBZDAF.aEEChAAAGDDAOEGDHFGBhADAAAGA.WHAAbFCC.........hABA......hCAA...,2,-22,-6,16
JVgTWUQGfAPbHDeRBdXcKELYCOaMZNIFS,HAAARAAAdADAKAFAEADELAFB.OAHBZBFEFCCHSCAAhAAA.VDCATDFAQEGAhACAAAAADDIBBEDAXFCChAIACFAA.aFFHMFFBIHHA..gGGAhAFA..hAHA...,1,13,-43,56
efcNgWIaYEPSHLRQBUZKCdOAGJMDVXFbT,GAAAMAAADAEAFADA.eAFH....fAGANAHA.IBBAhAIAECDBHDBBRBDBQCGAhBAAZEFAdGDAAAABXGGChACAbDBB..TEFA.gFCHhBDA.aFHD.SHGGhBFA,2,-19,-7,12
gYcCFSRaAXNWMZLJPIQEHbVDUTeOdBGfK,XAAAMAAAZABELAFA..IADAHCCADCEAeAEHdCHAGDFAhAGAKAGA..gCFAhAAACEECSFHHhAHAACDBJDHBEHDAbFFD.TGAA.BEED.fGCBhABA..hAGA...,2,-28,-9,19
KZfMCLYQcFbESTaWIBXNeGgVJRdOHDAPU,KAAAZAAAMACALACB.QAEAFAFDEAHB..aBDDBAGA.eAHHhAAAGCGAVDEARDEBHGDAhABAACEBUEAACHHA..YCCFhAIAbFGD..........hCAA......hCBA...,2,-16,-10,6
eDXQHCYLAfISWNbTGZEPgdJaMUVKROcFB,SAAA..bAAAZACBEAEAdAFAaAGDMAHB.KCEDRCAAFCEBeCHHhAAAQDFAHEBALFFAhABAAAAA..fEAEhACAIGDANIABGGBB.gFFGhAEA.....hAIA...,2,-16,-4,12
MKdRQLVANfYaIHWcJZgGTebDUCBSOXFPE,...fAAAaAAAHACBJAEAGADA.eAFADAIBBCEAOBCHFCGBhAHAEBHFdEBARCFBLDABhAAAABBB.IFEAhACAZEEAgGGAbGAASEHH.MHFAKDHB.hBAA......hBEA...,2,-29,20,49
RMfFcBSEGODQeIgZYHUbLaXCTdWNJKVAP,RAAAMAAAFADABAGAGACB.QAGC.eBBBZBFEHCCBLCFAhAFAaDGACEFAdDDA.JEGBAAAA.hAGAfFEAEEHB.hAIADEIBgFEG......hCAA......hCCA...,2,-32,-4,28
SWUJCTFGEOVbLHZdBQIaNgcXPefKMYDAR,RAAASAAAUADA.CADA.GAGA.ECCBbAEDHDFB.ZEDBdAGAQFBBhAAAaBHD..hABAgCCDPFHDKGADhAGAMDABADIB.TEFA.OECB.LEHBhAAANIBB.eFEBhABA.DGBB.,1,7,-15,22
PNCcWEMaSURTgVJXFdODHYIfAZbBGeKQL,ZAAAGAAAeACELADACAFB.EAHBaAGDRCDA....TDGAVCDAFCHDhABAdEADHECB.fEFEhAAAAAIBbEFD.KFHBhACANCCA.MIAA..SHGA..hCAA......hCBA...,2,-27,10,37
DgAReWXTbSFPdGVaIMKEHNcUQYfZCBLJO,RAAAeAAA..TAEAFADDGAFA.aAHFMAHBHDDBUCCA.QDAAhAAAZDGBLFABhAAADAIBAADAbGFAdDFAKCCDEDHF.hABA..NGAB..fFHA...hAFA......hBFA...,2,-14,-4,10
YBfgWaKSCJQAXFMEZeUVHINOLdcbGTPDR,MAAAEAAAZACBUAEAHAEA.OAHDdAHAGBBADCBBBCED..fDEAhBAAaCFD.CDGAABBBeDGHhAAA.IGAAhAGALFFA.bGBAPEEBYHFAKFHBSHAAhAHA....hBCA...,2,-14,-12,2
URBYEcVCdGIebNaQMHTJWKLXZOFgfPSAD,RAAAEAAACADB.GACA.eAEAaAEDHAGB..TBGAKCCAZDEBFCBH.hAAA..fCFEhAAAAAGBBDHAVGFAbEACMDIBhAEA.LEEA.XGGC..hAFA......hAIA...,2,-35,1,36
TbFfRMJCOGLIUKNdASQYgVWPBHDZceaXE,QAAAVAAA.BACAHADBZADBeAFAEAFA.TCFAFAHD.RDAAMBIBhAAAOCEDGEEALDGBhAAAKEHDAAFASDCDhCAA.gGCADGIBaHCA.bGFA...hADA......hCAA...,2,-4,-1,3
YHCXBKGAMRPZeOIgENfQUaScbLFdJDTWV,RAAAeAAAOADAEADA..QAFAUBEB.aBHDSAHB.hAAALCCBdCCATDFAhABAVDGBHECCBEEAAEIBMFHBhAIAIHBAfHBBFGGHDIDA.....hAAA......hABA...,2,-26,4,30
HXAMDgBcIdPKQRZeWaLbTfOFGYVCEJUSN,MAAABAAAdACAKADAZAFBeAEA.LBHB..bBBCOCBBGCGAhAFACCEA.EDDBUECAHFCAAAEA.hAAADAIB...gGGAhBAAIEFARFGBaHBCFHCA......hAIA......hBCA...,1,-2,-26,24
YVbUTQeKJGIgaRMfFNBLAdSHZcEXWDCOP,HAAAEAAADADAOACA..VAFATAFAKBCA.GCCA.aAHDRCDAMCBBhAAAFCFHLDHBhAAAACIBZEBB.XFFBCDGA.hAIAPHAAbEFA.eHEGgFEGBHHB.SHGAhBCA..hBEA...,1,16,-24,40
MJAPUKgaRDdTfEQGXNZLeSHIbBWFOYcVC,KAAARAAAdADAEACEGAFA.ZCCAeAEEHDGBBAHBOAHF..VBEBhAAAMEEBACCAUEEBDFAAQGGBhAAALCHBSGHBhCAAbFAA.FHDACHAA.......hABA......hAFA...,2,-22,-1,21
aFTSZALfIPMEgDcHJOWVBXdYeRCQbUKNG,LAAA..fAAAMAEAEAHFDBEAHADA.OAFABCAAdCCAhABARCAAbBFAKCFA.aCHDTDEAhAAAAEEA..IFCAhACAgDGB.cEDCVEFBeFHHQGFAhACA....hADA...,2,-17,-12,5
GIXLYEMCRKNPeBaDZSQgbJfHcOUAFVTWd,TAAAGAAALADA.EAHBRACFKAECeCDAaAGDZDCA..QCEChAAAbCGDHFAAOGDChAAAAAIBFCAHdDHAXGGBhACAMEDBCEFABGBADIAA.SGGA.fHEBhACA...hAEA...,2,-14,6,20
VeUPJECMbAXNOHaTWZIgYfSLDdcKRFGBQ,OAAAHAAAaACAZADB....IAFA..fAFAhAHALAHBdCCARBGBGDBAhAIAQCFAeDEFPEHDhBAAEEDAbFCAAEIBTGEA..gGFHhAAADBBB.FHBABFFB..hBDA...,2,-14,5,19
BdaEYeWfcOLQbRJGHMISTKVZACXNDgFPU,XAAADAAAFACDBAEAdADA....EAFAeAFH..fAHAhAAALAHBRCDBHCDCMBBBTDBAhABAZEAAABHB.CCHAgEEAhAFAaEGA.cGCAbFFB.IFHAhBDAKGDA......hCAA...,1,-14,-23,9
DVgNWROXfeGCIbHKUYEQcAdJZaFMPSTBL,ZAAAaAAA.MACA..TADALAGB.DAIBVAGB..gBDHhABARCCBXDACeCCDhBGAGEFACDHA.HFAAKEEAEFGAhCAAABBBdFECFGCABCFD.ODHDfGHAhCBAIHHA....hADA...,2,-11,-5,6
SVCAETIHYQDFLbZMcJXUNWBOPfgdaGeRK,EAAAHAAADADALADB.ZAFAMAGBXCAAUBCABAHAOCFB.hAAA..fCGBhAAAaCEDRCGFSECBAAGATEGAhACAQFFCbGEC.cFBC.WEHHhAHA......hBFA...,2,-34,4,38
ZVNaDeEbTXRGMAQdUHJCLKfSWIPFOYBgc,dAAAHAAALADASACE..IAHAOAEDBAGAZCAEaCEAEBHFhAAA.TCCARCGFADEAQEAAhACACDFAKDHB.fEEAhAEAFEEHgGAAVGFADEIBeFHB.XGCDhAGAMICA....hAIA...,1,-1,-10,9
KYWMfRVBPNdbcEFACUQJZXgITGHeOLDSa,QAAAZAAA..XADBTACAHAEBeAFALCABhABAaAGAKBHDMDDBRCDABBHAdEAAEDHFhAAAACCBCDGAUFEAJEEB..gGFAhAEAODHDSGAAfGBA..hBGA......hCAA...,1,-1,-18,17
HSLPNVYEfebgWRQKJDGIFTacUOdMBAZXC,ZAAAHAAALADBVAEA.EAFAeAHH...bCAARBFAQCAAhABA.DDFBGDFAhAAATDGAaCEHOEEHdEAAAACASEHBhAEAPFAAfFHAKFDAFHAAMIDAhAHACGFANIAB......hCAA...,2,-1,8,9
cEIUMVDgSTQGPHbAYZfXRKJBNLaWOFCed,ZAAARAAABADBaACA.FAFAdAFA...EAHBMAIBDCCB...SBDAhAAAGCGAHDDBACCB.XFBChABAKCFALDDBCGFAIHHAhAIAVFFA..........hBFA......hCAA...,1,-17,-35,18
gBVCFUaTWfPHJADGMRdObYISeXEKQZLcN,GAAARAAAdADA.OADA..bAEDSAGAEAGA.ZCDALCGBhAAAgCGBCCCDaEEBTEBAhAAA..fFFEhABAHEEAAFIBMHAAeEHHQGGCBGAA.hAGA......hBIA...,1,7,-23,30
APWFDaZRKCNeTcdIgSJYXQBGVMObfLHEU,FAAAZAAARAEACADA...eAHHdAFA...SCAAXBGD.GCFAhABAMCCB.OCEBLDABhADAHEAAAAHADDDAaDHDKGHB.hBAANHAB.TEEA.gEGBYFFF.BGGDhBFA.bECD...hACA...,2,-21,-5,16
FfSIGOWdMeUTNCQHZgAPcRBYbJEaKDVLX,RAAABAAA.JACAEADE.aAFADAFA..LCCAFAHD.SAHHhAAAGBFAdCBAeBGDUEDATECAhABA.QEEChCAA.HGECADDAcFFDYDHB..hCDAKDHB.....hCEA...,1,2,-46,48
adQRFCWIGTMESOPXYJLcUAVfgNBHZKDbe,VAAA..fAAABADBHAEBZADADAGAeAFEdBGA.RCAACCEAGDCAhAAAECGA.OCHD.XEEBhBIALEAAADCBKFHDhCAAaDGEQEECFGFD.TGGA.MIAAhAAA.....hCDA...,2,-12,0,12
SCbDPUMKfWVOXFcAHLQEeNdTIRagZGJBY,HAAAEAAAdADARADFZAFBGAFABAHA..CAHADBCBMCAB.KCCD..fCHAhAAAOCGD.FDBHACIBeEEBhAAA..TDDAhAFAaEHDJFABbFDA.PEHDVFCB.LHAAhAHA..IHHAhACA.SGFH.,2,-2,-2,0
YbBXcKIafWgCHZFODPGSLUETeQRJANdMV,dAAAMAAA..VADABADAKAGCaAED......fBHAhACACAGAHBBBZCFBDCCBGEDAhAGALDABECHFeFHBRCFBADDA.hADA.bEED...XGGB...hAIA......hBAA...,1,-16,-23,7
OHRSXUCGdMKDcEfIJaLVNWYAQgPFBTZeb,QAAAFAAAZACB.eACAHAEARAFA.XBGAGCDAdCFDMCEBDCIBEDFAhAGAJDABLEHB.hAAA.VFFANHAB.ACDBBGAAhADAbFDA.SHEGCHFD.....hAHA......hAIA...,1,-4,-10,6
FdMOTNEJeKgbAVBYHLCGWIRDZPUXcfQSa,BAAAHAAAGADARACAZAFB.XAFAQCAAaBHD.dBHA..MCABhAAATDDAECCBeCFF.hAAAbDADAACALEGBhAFA.CFCADEIBcEFDFFFBOHCCKFHBgGEGhACA.WGAA..hADA...,2,-13,5,18
ODbdTCQJgWfNaLMIeRGUZVKXYPAcBHFES,HAAAEAAADADAdADA.TAFAQAFA..JBHB..fBCAhAAAaCACMCFB.RBDFZCFEXEDDhAAAAAIBFEFDOCBHhBCA.bEGDCDDCgFAALHBA.eEHF.hBHA......hCAA...,2,-8,-4,4
dFSWKBGPcMXOEDegNJfZRTaQbYAHCUVLI,HAAACAAALACAdADASAFABAGAGCCAMAIB..EBHFeCABJCFB.hAAARCDAaCCH..bDABAAFAIEFAhAAA.KDHDhACAXEGADFIB.fGAEZGCA.TGGAhADA.YFCFhAEAFGGB..,1,-3,-13,10
HUPWcEBLNOFCZSMYDbdQTKVXAgIJeRafG,JAAARAAAGADAHADBUAGA..PAFA.EBHFLDAA.hAAAFDFAZDAAMDIBbCFDdEHAhABATEEAXFBC.hADAACCBeFDHaFAA.fGGEBGBDCGGADIBA..hAFA......hBAA...,2,-22,9,31
QMPeEgLSfJbYCKNXTaHUZAdRDOGFBcVWI,RAAAGAAABADB...VADAQAFA.eBHHEAGELCDAhAAA.fCHAhACAbCCAKECATFAAHEEAADABdEGDhAAAFFHDIGDAMHCASGGDCFFDaGHBDCCAOHBChABA....hAFA...,2,-12,1,13
ORafTPcEbYQSGVWKgXLeDIdUJBHAMCZFN,ZAAAOAAARAEA..aAHDTADA..ECAAQAFCGCDAKCFALAHBhBAADACA.dCCABDHAhABAHDFAAFAAMFFAFEDDfFFEhBBA.PFHBbFAASGEAhAFAWHCA.eHAE.IHHAhAHA,1,-9,-16,7
RJGQWCZMXcTEYBPSaNVLDfKeUdbAIgOHF,OAAAHAAARADFGAFA.QCABZADBMAGBTDBAEAHBBDDDaAHBhBAALDHB.KEFDhAAAeBHHbFAAAEHBFDFHCGGD.XBBChBDA.PEHDNIABDFAA.dFBD...hACA......hADA...,2,-9,7,16
cAHUGKZabXTJfEPNVRIdLMgFCeQSWOBYD,HAAAGAAAaACA..bADATAFA.EBHFPAHB..RCCAdDGDhAAAMCDBCEEAeFAAQCEChAAAOFGBDADAAAHA.ZEFB.hAFAfEHAIHHA.......hCAA......hCCA...,1,-7,-9,2
KVRaPONfgEDSeWXIbTYGCAUcQZHFdLMBJ,QAAAHAAAdADAMAFAKACARAEF..aBEDOAGD..fBGAhAAAECDBeCHH.XCAAhACAbDFD.GDGAAAIBZEAALFEDhAAABDDDPFEBDGAASFHHhAEATGBA......hAGA...,2,-6,5,11
YGKPScOBUVJEbgARDZICeXNMHTFLWQdfa,RAAAZAAAeADEMACAHAGBLAGBdCCA..aBEHGBDAKDFA.SCCDhABABEEDUFGAEDHFAAAACFCATFBAhAIA.QFEAhBFAfGAAcGGA......hBGA......hBIA...,2,-22,-5,17
adVQFBXHEALfTIZPSKeUgcDRWJbCNYMOG,TAAAZAAAKADCUAGA..DACARBEB.JAEB..CCAA.MAGBGDDAdAHAQDBAhAAABCCD.hABAHDEAADHALFGBhACA..fEHASGBAeFGD.WHBAhBDANEIAaGED....hBGA...,1,-12,-28,16
BgIVdbPETaCHORUfJYKZLFWeDSMAcXQNG,QAAAGAAABADA..IADAdAFAEAHBCCDAHAEB.RAGBfCDEhAAAKCGAZDCALEGBhAAAeDFFMDIBADAB.XGAAhAGAgFBAbEGD.aFDD......hACA......hADA...,1,8,-26,34
UAePaHJKGIMfEVBTcWOYZFLNXbdSDQCRg,eAAAHAAAGADAMAEA.EAFABAHA.TBCAOAHD.ZCAALBEBhAAAbCFDdEHA.QCGAhABARFAAADFBaGGC.KEDDfHBFhAAAcEGCFFFHSHDACGBA...hBGA......hCAA...,2,-18,14,32
PRYGANgJZHCKLdFIcaDEQfWMObUVTeBSX,JAAAHAAALADBdADAFAFA..aAHDEAFA..QCABMAIB.OBFBhAAAbBGD.UDGAeCCDhAFAXDDDREEBACFA.ZGEAhACAKGDBDGGAfGHA.....hDDA......hEAA...,2,-15,-7,8
BXZfOAETIJGagPWLdYSVeDUbHNQRcKCFM,EAAATAAAGACA..aACA..PAEAdAFASAHBeAHFbCED.hAAAHBGB.RCCACDBDMCBBhBCAZEEAACCAgDGGhBEALFBBDEIBQGCAFGEABHHAfGGAhCAA......hCGA...,2,-2,1,3
YSTDLFQdcaKbUBMPVGeOCNJRHEAfgXZWI,XAAAZAAA..IAEASADALAGBdAGAKCDABBFAMAIBhAAAGCAA.eCCBhABACDAARDEAHEACAACA.fEHAhABAgDGATGFAQFDAbGBA.UGGAhAIA.....hADA...,2,-13,-9,4
ZTFbIOQHfKMWdXeaSDPYAJRGcUBLgNECV,RAAAGAAABADBLAFAEADAZAFBFAHD..OCCAHCDBMDABdCGAeDDAhAAAaDCB..DDHBAAGAUFFAhABACFBD..TFFA.hCAAbFCD...fGEEWDHH...hCIA......hDAA...,2,-33,4,37
CWLHXBSDGIYfMJOKTZgQeREcdNbPVAaUF,aAAACAAAHACABADAGAFA....fAFAMAIBKCAAZDDBeAGHhADAEDHBdCCA..bEABAAIBFCHDhAFALFFBDBBBIEEAhBAAOFHB...TFGA.QGEChCAA....hCEA...,2,-29,-4,25
CbEBLPFcWRUAMKIZVJDeGNTQHSOXYfadg,MAAAZAAADACAGACB.QAGCHAEAXBGAaBBC.dCCDbCEDEDEAhABA.LEGBFCHDRFAAADDAKFGAhAFAVGAA..eGEGhAIASFFF.OHDC....hAGA......hAHA...,1,1,-13,14
HaKQRLDVcPGYebBZXJdEICFTAfOgMUSNW,OAAAMAAAUAEA..SADAHAGDaBBA.RAFFLAHBDCCB.hAIAVCCAGDDA.eCHHhBAAZEAAdEFAEEBBFFGHABBBfEHAhAEA.WHCA...KGHB.hBEA......hCAA...,1,-9,-16,7
BVMZeXdNcFHAKIaPOQEJWTUDbLYSCRGfg,aAAAQAAA.EACATADA.DAFAbAEALBGB.CBBDRCDAhADAGCDABDCDZEFAeBHHhAAAdGCAFCFFAAIB.KEHB.ODCHhAFA.UGFAfGGAMIAA...hAGA......hAIA...,2,-25,-1,24
KHWTgBZINMeYVGDJdScQRXUAbOPFCfELa,OAAACAAALACAHADA...TBGAZAFBMAIBeBBBGCCAdDDAQDGBhAFARDABAADA.bDEDhAGAfDHEEFCB.hAHAaEFBKFHBBFHDNIAB.DGGB.SHBAhAAA......hBHA...,1,14,-25,39
CeGDHPVWSZMIBKfETFcQAbYJaROUdXNgL,JAAARAAAdADA....XADBLAFAGAFAHCDCVDGBZCCAMAIBhAHAKEED..EGAAFDHHAAAA.aEEChBAAOCCH.UGGBhAGACFBAeHBADHCA.SGGA....hBFA......hBHA...,2,-20,-8,12
DUAHLaQSPIGBVgFEZMXcWJNCfRTbdYKOe,HAAAaAAA.QADC.SAFBGACABAEAFAHBECABZAFBMAIBhAEAXCCCJDGBfEDAhBAARDEAdDHAOFCBeBBDhBHAAFDALGFA..IGHA.hAAA......hACA...,1,4,-23,27
bNPSBVWJHMacfKUgdOCDXGAQZLYFETIRe,ZAAALAAAEADE.RADFeAFE..bAFBSBFHBAHA.VCAAhABAHCAA.aCEBKCHBdCHADEEAhACAADFBQEFDhABAFEGD.IHDAPFCAMFIBfGGEOHCAhAIA......hCAA...,1,-7,-11,4
fgQdPYaEFXUKbDLWTMeSJOCBcHGIVARZN,RAAAZAAA....fADBdAEAaAGAEBGBFAFAKCAALCCA.MAIBhAAAeCHH.ODDAhABABCGAHECAGEBAAEEAQEGAhABAXEEADFIBTGEACHGA.IHHAhCAA.....hACA...,1,-5,-21,16
OdITgRfJDQNEBASCeZXbPGMUKFaVcHYWL,eAAAZAAA..XADBGADAMAFAFAFD.aBFAHBGBLDBBdCAATDDAhABARDEFDBIB..EDGEAAHAbFDAhACAKFHB....cGCBhAAAOCCB.fEHAQGFDBHHAhBIA......hCIA...,1,1,-12,13
bCNJDdXQZHIULOYSTWaeAfKBgcFMREPGV,BAAAFAAAEADAGACA.CAEA.DAGAdAGAZBCEHCABLBGB.SCEAhADAaBHDAACBKCFDMEEBhAAAREEB....PEHDhBAAbFFA...NDDA.QGBA.OHEChAEA....hAIA...,1,-18,-25,7
WYFSUgaTbZAQDVOJCGNERcKdHMBeXILPf,QAAAOAAAGADARACAdAFAHAFABAHAeBBBLCEA..fCGAhAFAFDAASCHHhAAAaCHDZEFAADDBDEEACFDAEGGBMFFAhADAIHAA.YDBFTGGAJHAA.hAHA......hAIA...,2,-10,-5,5
AIBHTQGDVOgYXKLeFUWNJadSMZCRPEfcb,HAAAGAAAOACA..XADAeAFAFBHDUAGAJCCA.dCDAZCFFRDFAEEABhAAA..bEEDAADATFDAhACAQGAA.DEEBhAAAgGGAKGGC.NIBB.MIEACFHC...hBAA......hBCA...,1,1,-10,11
aVHRACfPJBEeKYdQXMbDNZOITULWcGSFg,CAAAJAAABACA..EADEeADH..dAFAMAFADAHBZCCA..TBFAhAAALDGBGCAAFECA.hAIAaBHDHGEA.ABIB.KDEAhACA.QEGANDIA.OEDB.IHBAhBFA.cFFChBHA..,1,-14,-33,19
dUHAEGbRVTIfgWFcYPKLQBeCXZMJaDONS,EAAARAAA..TAEA..fACAFAGA..PCCBLAEAhAAAeCGBZBFEMCIBaCDBODFChAFAdDAAHEDAADHAbEDDhAGAgGEA..cFFAKHGACHCA.DFIB.hAAANIAB......hABA...,2,-7,-6,1
RBMQICEcTKSONULVaZFedfWbDJYHPgXGA,RAAAMAAAQADC..EADAKAFCOAFCLBHBZBBAeCEHdCFA.hAAA.bCCCDCGA.HDFBhAHAXEECADDBCDHASFHHhAIAVFGBaHCA.fHDB....hBAA......hBCA...,1,-5,-19,14
PHLGYZfRUCbQgdOMITVSWeAKEXFDcaNBJ,EAAADAAA..aABEBACAHADBGADAZAFA.RAFACCCDQCFA.dDHAhAGAMCHB.TFAAhAAASCCDAAFAFDFBJFGFLEEBhAHA.fGGA....hAIA......hBAA...,2,-26,-19,7
IGPBcaWTLDEbRKSeVNdfMFQXYHAUCJZOg,CAAAZAAA.OACAGACABAFAaAEA.LAHB.DCCBRAGFeBEH.hABAdCAAMCFBQDFDhAAAHECBABHBUFGAgFGAhACAIHEAPEBD.......hCAA......hCBA...,1,-5,-29,24
ASKPCNgeGFZfIHEWDMYOUBRLTXcbJdaVQ,KAAACAAA.eACEZACAHAGBDAFA.MADAUBGARCCA.LCCA..TDFAhAAA..bDBCaDHDhAIAAEFA.SEEDhBGA.gGGAGEGAfGCA.hBIAEGFB.....hCAA...,2,-26,-20,6
FcJbBXLAedTKNMECQYUPVWfSgZHGDaROI,eAAAdAAAKADAEADA..QAFCUAGA..PBEDVCBA.SCCBhAAAHCFCaAHFRECAFDGA.hACAJEEFXEGA.hABAADABMGEACGBAfGGA.....hADA......hBAA...,2,-19,-13,6
cObYDfLAadeMgJBIZUFTKNXESRWPHVQGC,eAAAMAAABADAZADBFAFDKAFA..EAHBRBBBHCFAGCGA..ODEBhAFADCCBAAAAdDFC..gFCDhAHAIHHA.TFFAhAIASDBD..WFHB....hBAA......hBBA...,1,-25,-28,3
YRGUHAMQCXVIJdbZgTSKcfDLPeOaFBEWN,MAAAQAAA.CACA.XACA.VAFAdAEAZAFB.TDCAhAAAKBBDDCDBeAHFFCEDECHFhAFANCIA.REFB.HEFB.AEBBIHEAhBEAgGDAcEDD....hCAA......hCDA...,2,-21,-14,7
NDfdTFVgLMYAPeaWbOGXcUEJSHBZIQRKC,eAAAaAAA.OADCGACAUAGAEAEAHAGB.ZDFARCCACDFADBBB.dEAATEGAhAAAFEDDLFFBhAEA.AAIB.bFAAXGBDhBAASEEDBFHDQGGB.fHDFhABA...hBGA...,2,-12,0,12
gNLHCERbKTPYVfXSQUdAODWaIGFZeMcJB,DAAAaAAAGACAeABA..MAFABAEALBEAHAFBRDFAKAHB..TCCAhBAAVEAA.SBHHhBFAdFFDABBBOEDDFDFBZEGBhBGAJHAA.CGFC...EGHF.......hCAA......hCBA...,2,-22,-2,20
dUePTRLNEBgaVSYDMIAcbOXQJfZCGFHWK,OAAAQAAAZADBGAFAHACAdAFA.eAHBRDBBEAHBaCDD..SBBAhAIAMCHBADFA.XDEDhBAACEAAKEFB..PFEBhAAATFGABGHA..YFBFDIAA.IDHAhBBA...hAEA...,1,-5,-15,10
OSCABDKgfHTGNFMLIEUecPdbRZXQJaYVW,KAAAHAAAGACAMACAEAFAeAEA..dBHARBFAZCAFQBDD.aCCHhAAAVDGBOCFDAAEADDFBTEDAhAIAFEDD.LEHBhCAAIHHAPHCA.......hAAA......hACA...,2,-25,14,39
ZIMGgTXKYCRALcFNUEfHQbPSeaOBdVWDJ,LAAAFAAAEADA.HADBQAFASAFAeBHHaAHDBCCA.dCEAhADADCAAZEDAGCFA.hAIATFAAKEHBRGDAADGBcDDChABAfHBBODHD.JFDFIHHA.hACA......hAFA...,1,-7,-9,2
XYTQSLVGIJgNWbOFMaCRKBdcHfEAZPeDU,eAAAXAAAQADALADAGAGA.ICCAgAGHhAAA..bDEBMCDBRFBAdFHAhAAAHCEAAAGBDGGBTEAAhABA.SCHHNIAB.FEEH.aFHB.BGFAhAEA.....hABA...,2,-7,5,12
gVAZNQEeaFPTSDYLICJRKMHdcbBUGfWOX,ZAAAEAAAFACDSACE.LAFACAEARAFFHCDBdCCDBAHBGCEAOCGDhAAAXCGA.AAGAeEGFhABAaEAADCIB.JFDFMFIBhCAA.bGCCUFGB.....WFFDhAEA......hCAA...,1,2,-24,26
YdaTcVECePLUXSNIgGMAfODQJHKbRZBWF,DAAAHAAARABAZAEBFADAaAFD....TAGAEAHBeCAALCDD.hAAASCFHgCEGhACAACIBQEAAhAEAbCGDBDDDdGGACDHDUFFANIAB.MFIBOFFH...hAIA......hBAA...,2,-17,6,23
bCONQgdIZMDVRBSXFUTcGAJeLWYfaEHPK,eAAALAAA..fADAHADBbAFAOCABQAFA.dBHAhAAAZCFBMCCBREGFXDDChABATDDAADFAJFAB.aFDDEEGAhABA.CFAAgFFGDCCBSGHHFFCDcGEChAFAYHDGNIAB....hACA...,1,10,-2,12
TQMdPcRKVeYgfFJWNEDICXOALbZaUGSHB,ZAAAGAAAHAEAQADAdAHARCAAKCED.eAFA...fBHAhAAAFCGHJEAF.ECDBCEFDAACAaCFD.hABABDHA.MDABVFGBhAEAgFDA.DFHB.XGAAhACA......hADA...,2,-26,-3,23
dLaceZGXbFTEfPKWQgUSIRVONMDYCABJH,HAAAaAAAZACBGADA.FAFAEAEAKBHB.QCABSAGARCFBODDHhAAAMBBBCCEA..ACGAdDGAhAHAeEHF.TFEA.hBAAfFBAgECAIHDADCIBBFEA.hACAcGED...hADA...,1,0,-23,23
SfGZXDPebHaCTOIYBWdVcgJMFAKNUEQLR,KAAAEAAARACAGACA.ZAEADAFA.eAHFHCABCBFA.TCFA.OCHDhAAABCCDdDAA.VDEAhAAAgEDAFECB.AAFAQFGChACALFHBfGGAPHAA..hADA......hCAA...,1,4,-26,30
BOZMRNFbQXIVCDUfecSPAJHGTaKdLEWgY,HAAAaAAALADAEADE....gAFBOAGDRCCAFDFDQCABhAAA.XCEChACACBBDfDHAeBHHSDCHhAHAAAEAGFCBdGHABEFAMIAAbFEA.DEIB.hAIA......hBAA...,1,12,-20,32
JdNZUAXgecTLBMaYVOFGHEPIDWKQbRfSC,eAAATAAAMAEA..aACAOAHDHAEBEAGADBDAKBFBRCCB..CBHAdDGAhAAAZCCAAAAA..XFEChAGALECBBDBDFEEHGGEBhBHAIGHA.........hCAA......hCBA...,2,-22,-7,15
XgZOYBWDeLabKFPdCVHUJEQcNISTMGARf,RAAAXAAAZADBBAFADADALAHB..bADAFCFB..dAHAHDAAhAAAECDA.QEEBhABA..IDFAhAAAMEHBABHB.ODCB.eDGHaGGHCCCCJEEFNEIA.SEHHhABA.fHBBhBHA,2,-22,-17,5
fKFUYbLBMHRNQOcWeEGPJAXCTDSZdagVI,TAAAZAAAaACA.....IADAFAFAUCCBLAFAHCFAREFAQFBAhABAOCABeCCAEFEBhAIAGCFA.AAGADCIBhAAAdGHA.fEEE.KFDDBBHAMFHB.hBFAWHCA....hACA...,2,-16,-6,10
cANRKZUWCEXIGOLeFVSBYfbdMPgDJHTQa,RAAAZAAACADB.EADEGAEALAFB.FAHBBAGA....bCABdCCAMCEBhABADAIBHCGB.aEDDhAAAACIBKDGAUFGBXFCChACAeGAE.SFEH.fGGAhCFA.....hABA...,2,-25,-6,19
GPNTbZWDeSEHKYAMgaRLIcBQVdXFfJOCU,aAAARAAALADBBADA.dAFAFAFA..OAHBGBDB..TDEAhAAAZDAAeBHHHEGBABBBMDGBhADAgFBA.QGDAhABAfDDBCCCC.PEHD...WFFDhAIADCIB.....hAIA...,2,-22,-9,13
CDFbRLegKfcYTUJHSWXAQMaGPdINVOZEB,aAAAdAAA..VADAEADADAGA..RAGFLCCBKBBD...fDAAhACATBEAHBGBXDGAhADAABIBGDAB.IEFAhADAZEDBFFFAeGAAgFGA.cGBAhBAA.....hAGA...,2,-14,-14,0
AFDJSGYQNfdRcUCTKaBHIgebWPXLOVZME,DAAAGAAAQACAdADARAFAUCFBKAEA..HAGBeDBH....bCCAhAGAXDDDLEEAZFGBhAAAAAIBSEHHhBAA.fGDATGEAaFAHBBBD.gGEHhCAA...hACA...,1,-6,-18,12
WEJDUGPAbeKgHNMYLFVIfTQOBSRdCXcaZ,eAAAHAAAMACALAEAFAFD...ICCATCCABAHARCEAdCHAXDBChAAAZCFEEEBB.DEEBGEEBhAAAAAFAKFCB.NHABfGHAhAHAQFFACFHAaHEE.......hABA......hAIA...,2,-17,3,20
eGLXfgTDMIJKBYZNQPVUHbFAOdERSCcaW,EAAARAAACADB...aACDeAEHGAEALAGB..fAGBhAAADAIBMCCB.KCBDZDDAQCGAhAEAUFDAHFGBADDAdEEDSGBBhAAAXEBA.TFGA.BGBA.hABANIAB......hBGA...,1,4,-19,23
YLGaIBfdWDNHPJEUKeQAbXFSCcRVMOZgT,FAAACAAARACA.MADAZAFB.....TAGAGCAABBCAdBHADDDBHBDBEEEAhAAAeBFB.ACIBbDGDSEGAhACA.OFAHhADALFEB.IHHAfFCE.PHEAhAFA....hAIA...,1,-14,-26,12
SDbAJOdagUKRZTWeHQcIXPCMFNEVYBfLG,dAAAaAAA.KADARACF.ZABB..eAEEHAFB.QDCAXBEDMAIBhAHAEAHBBDGAGCGA.bECAhBAAADIBOEED.TFAAhAFAIGCAFGGANIABfGFA.DBBBhCAA......hCEA...,1,-8,-16,8
YeAIKfUWEQBLNgGJCTVHZSOMDcabRPXFd,KAAAUAAAEACELADA.GAGATAFAHCBCZCCAMAIBaCEDREAAFEFDhAEAeCGF.AAEA..IECAhAAAQGDC.BGHAhAFAgEGHCHFASDHHDEEBPHAA.hAIAYFFF..hAHA...,2,-24,6,30
BOeCNWSJAcfHaPEDXFdGKILUQgTZVbRMY,HAAAEAAAFACDGADA.LAFAQAEAZCAARCFAMAHBOEFBeCDFhAAACEHA.SCHHhAEAAAGA.aDGHXGCAhAAAdEEAKFHBgGBATGGA......hAIA......hBGA...,1,-2,-13,11
aYDKJZFNGAPRfLQgcHVbOUCBSXETeIWdM,RAAALAAAQADCHADB.OAFABAFBEAHBeBFGdCFAMCAB.aCCHhABAKCCDZDFAGDGA.hACAAAAA.fEEEhBIAVEDBCHCASGGDTGDAIGGA.DDGA.hAIA......hCAA...,2,-18,7,25
SZJbdgEeMBfYQKLcHUCTDRXOANaPGWFIV,aAAAGAAA.FADASACHZAFBdBHA.EAEAeCDBBAGA..QEGAhAAALCEAHEAAhAEATFCAREEAAAIB..PFFBhACAIGCA.JFHBMIAAKHEACDDD.DBBB..hBAA......hCAA...,2,-15,-8,7
dVafEcHCgBUNLDFGYORMTKWSPZAeXJbQI,eAAAXAAAQADAdADA..aAFAEAFAHBEBBAHALCGBhAAAGCCARCFAMAIBTEGASDBAhABAAAAAIFEAfEEEhBDACGCDUGGBDICAOEHD.KGBA.ZGEA.hCAA......hCBA...,2,-4,8,12
efSWHNbRAFcZGOTMBDJLXIaUQPVgYECKd,ZAAAGAAAMACADADALAGB..aAEEQBEBVBGB.ECCBhABAdCDAeCHHSCFDhAAAHEDARFBBAAIBODBDBFHAXGEAhBFAIFFAPEHDCHHA.KHAA..hACA......hAHA...,1,7,-24,31
THOKAeGNBfdScEJDVXCQMbIgWZaRPLUFY,eAAAGAAABADAdADAEAFADAFA...CAHA.MAIB..ICFAhAAAZBCERBFFLDDBFCHBHDBBAAAA.hBHASDDBJDHF.hCAAQEGBbFED.aFAH.PFEDTGGAhCBAKGGD.....hDAA...,2,-22,3,25
ZReASOBgGVJCaMTIbUNPKYXFHWdLcQEDf,BAAAGAAACACA.aADA..MAEA..bAFDUBEAKAHB.FAHDHCDBLCAAhAAAEDHFZDBB.AAABOEGHhACAJDGB..TECAhACAIHAA.PHCAXFED...hAHAcGCCDFIB.fHGFhCBA,2,-36,-9,27
OcabVKgQASdIeJXTMCZPGLDBRENYWHfFU,dAAAeAAAJADAMAEA.ZAFEGAGALBDBRCAA.ECCF....NCEAHDFBhACAFCFDOCHB.hAGAbFFAKFCB.AAIBSEHHhBAA.IHHACHHDDICA....hBCA......hBDA...,2,-26,-14,12
ZODbdRNLaVIBSGEcPgKWeFJCXUHYTfQMA,ZAAADAAARABAaACABAEB..EAFA.....PAHDKAGAeCDACCCDHCEAhABATCGA.MDCBhAGAAECAdEED.LEHBhAFA.SGCAGEEAWECHFHFC.JEHB..hAIA......hBAA...,1,-6,-35,29
AKYcFMDfVIbWRPgedHCUZNOQaXGLESBJT,KAAAFAAAMADADACA....VAEA..bAEARBCB...eBCFHCFChAAAZCFAQECBhAHAGDDAEFGABEGDAAIB.fFEAhAIAIGCAgGFGdGGANEIA...hBIA......hCAA...,2,-21,-13,8
GUdJQbXLFMVDKfITCeERZNAOaHSgPWYcB,HAAASAAA..gADB..PADA.cAFDhAAAGAGA.dCADbBAAhABALDDAFBHD.MDIBhAAAKCEDTDFAEFAARFDAAAFAaFHHBEHAQGBDhACADFFBCGGANIAB.....hAIA...,1,10,-24,34
LSQfdeOJFBZHMEURPKNVTCXDbYcgWIAGa,aAAALAAA.QAEAeACHFAEAHAGBEAGARCAA.KBED..TCGAhABADBBB..bDDAgDCAhACAAAIBGEGAdFDABEADhAEAMFFBPEFB.CEHAYFDB.IGHAhBIA...hBAA...,2,-15,3,18
MOGTKNYAEXJSgdbUHZBePcFDfLRCIWQVa,EAAASAAAdADAHAFAeACHFCBBLCFA.RDDB.CAEAQAGAhAAA.aCEAGGEBhAAATDDAKFAAADHAXEAAhABAJHAA.bEGBBFGBDFDBfFFAhAEA.IGAA.hAFAMFIB.,1,-8,-20,12
GYTcABdCQOaEfWLSUMIbFHPXDgRNeZJVK,dAAAQAAAEADALAGBMADA.FBEDHAFCDAIB.RBDBeCFGZABB.KDBAGDCAhBAATEFAABGBOEEAhCDAaEHD..SFEDhAAAbFFA..PHFCNIAB.....hAIA......hBCA...,2,-7,-4,3
FWISGdCgZbTQfLJEYXaAKBMcNVPODHURe,MAAAVAAA.DAEAHADB.RAFA.eAFAFCGD.SBBAdDAAZEEA.QCDAhBAALGAAEGGBaBGEABBAhBEA.BDFB.PDHBhCAA...OFFB.IHHAhDAA......hDBA...,2,-26,-18,8
VYHNTXBFKegScUOaCGEZbWIAMPRDdfLJQ,RAAAdAAALADBQADAHAFA..TAFAFCFHeCCDSAHBhACAOCHBGFABECBAZCEEbDAAhADAAAAAMEIBDDIB..fEFAhBAAVFFB.XEGDKHAA....hBCA......hDAA...,1,4,-6,10
VYOKIcDTbaFNMAdHREXJQUgLeWGBSPCZf,HAAAEAAA.QADCLADAeAGHGAFASBCDZCAAfAHEhAAAOBHDKDHBDCEBaDFHMCFBhAAAREDBXFAAUEAABEGAhAEACFHDIHHAbGEAAFIB.dHDD.....hAFA......hAIA...,1,23,-13,36
gDPFLASKJTGYXVEIbBZQOcRdMaUWHfNeC,KAAAGAAA..XACBEADABAFAZAEBQBGARAGB.aCDAHCFBhAAA.eCCBDDABLDDAhAAAAAIBTFGAIEBAhBEAbEFAdGGAMHAA.fHEFCEED..hACA......hADA...,2,-17,-14,3
bHQPGOABJKUDZdfcgCSEITLFeVaXMNRYW,KAAAZAAAdAEA....fACBCAGAEBHFLCABeAEE..aAHDMCCBhABARBDA...bDDAHDDChAAA.GDGAADABBDHAhACADCCBSFDATGDAFHAAXGAA.hAHAYFHB..hADA...,1,-3,-30,27
KNHDLMJQYCVeUGdPSIObEFfZcRgAWTaXB,aAAAKAAAHACBLADAMAEA..QBGACAHAUBEA.dCCA.SBBDhAEAOCABECGEZDFAREEAAEEAhAAATEDA.BFAAhAFADEIBJHEAeFCB.IFGAfGGB..hACA......hCBA...,1,-4,-23,19
CcIHfVPEgODLeGXQMNKWbZYJUARTdBSaF,RAAAdAAABADBaADA.FAFA..CAGAHBDA..VBEBEBHFDCCBGCCAMDBBhACAKBHB..ZDDAUEGAhAAAADFA..TFGASFFDhABAIHEA.fGAEOHDC..hAGA......hAIA...,2,-25,-23,2
cBWPYfTLdeAUXbQZVHMOGJNCIKFgESaDR,XAAAZAAAHAEAGCAA.CAHB.FADAECCBaAFD.RBCFBAHA..hAAAPCFCTCGAeECAhABAADFBQEDDMEGBOEHBhACAIFHASGAADEGB.WFFDLHAAhABA.....hADA...,2,-13,-9,4
QfKaPZAdcNJTGSIVMXDBUbWCRLEOeFYgH,dAAAJAAAGADASADA..MAFABAGAUBFACBHARCAA.LCHBhADA.ECCBeCEB.FCGHhACAHEFBQEABhADAaFEBAGIBNIBB.TFCA.XFGA.DGAB.hBAAOHFC...hBIA...,1,-12,-13,1
ADEJFCUdZSBgOPcbNWHfaGRLeVXYTIKQM,EAAACAAAZACABACA..OAEA..bADDHBGBGAFARCCALDABhAAAeAHB..XDCChAAATEEAQGCAhADAAAFBFDHHdFEASGFHgGGANIAB.fEHAhAIA.....hAIA...,2,-16,0,16
YagSTfXdAIRQNZeCPLHOKVGEFJUWMBcbD,RAAAZAAAeADELADBHAGBKBDAEAFA..FAHDUDDABCAADCCB..aCCHTEGAhAAA..dCFAAAIBQGAAhABACDHAOEEBVFAAhABAGGDB..MFGB...YFHBhACA...SHDAhAFA,2,-15,-9,6
YQREbPeHIKaFVAMDgZXJNWOBSUdGfCLcT,MAAAZAAAJADA..OACEBAGB.dAFAGCAALAHB..TCDAhABARCCAEDFF..eEEDHCFBhACAaBBCAAIBDCIB.XFCAhCAASEHB.CGGAYHBAbFFAKHCAFHFA.hBAA......hBHA...,2,-20,-7,13
cERbWZSXgNVfTaBJIGYCHMKOAFPDULQde,DAAALAAAeABARAEAZADB.SAFA..XBGAVCABaAHDhABABCCA.GDEAhAFAHCFAMEEBAAHAFDGCQECAhBAAEFCBbFED.gGGATGAAIGGAhACA.....hCAA...,2,-27,10,37
LJVRUIgdFBAeYWZGbECSfNaMHQTPcOXKD,eAAAZAAAEADECADA...SAFBaAED.HBGBTAGAOCABDCCBLDDAhAAARCCAUEEAdFCAACIBGDGAhABA.bFDBMEIBhABAQGAAXGFAKGCBIHAA.hAGA......hAIA...,2,-11,1,12
RICdeFXJHQabYScTKfNOBAWDGgEZVLMUP,GAAAEAAAZACBLAFAMADARAFA.dCBCeCDBFCFAHDEAaCEF..SCGAhAAATECA.fEBAhACABEHAAAGADFGBgEGAhAIA.PHCACHGA.....hAAA......hBCA...,1,-1,-21,20
QfBbZWYUGLTMgNHFDeAIESXPRKCOadcJV,EAAAXAAARACA.KADAaAFA..dAFA..VBFBQCDCBCCDZDAAhAAAUDAAGEDAMAHBHFFBhADAeCHHAAIB.SDFHhAAAOCHD.fFEE....hABA......hADA...,1,-6,-22,16
EIafGdWcDAbXPYRVMBQJegLSTZNHKFUCO,XAAARAAAMADA.BADAeAFALAFAZBEAHCCAFCDAUDGB.EEEBaCFDhAAA.dCHADFHBAAGA...hABA.bDAA...PEEBhADA...QGFASGGD.hCAANIBB.CHDD.....hCBA...,1,-16,-18,2
JEVPMSBTfAgHOacXYINWKQRLeGCZdbDUF,HAAAaAAA.XADB..IADAKAFARCAAeAHHZAEBdAHADCFBFDGHhAAAEBBBMBGBBEDAADIBODCChBAA..NGCBLHAAhACAbDGDJHBA.SFHHfGFE...hAHA......hCAA...,1,-10,-16,6
RKBTMCXWGFHPNgbIaQfUJZEYdeAVDLScO,LAAAOAAARADABAGBMAEA..CAHA.GCCAHBCC....gBFBhABAaAHDQCFChAEAfCAAZEFEEBBBeCHHhACAAGGASFDHTDEAFFGHPHECNDDA...hCAA......hDCA...,2,-12,-8,4
IeHTBKfPOEAXLVZcMNUWQJDSGaYCbFRgd,LAAAZAAAMACAUAGAQAEA.SAGAaBDD.CCAARCCAdBFChABAHCGBTDGABEAAKEEAhBIAOEEBACCB.XFGAhABANIDB.DGDB........hACA......hAEA...,1,-16,-31,15
VJWgSaXBFYOfCTHNUPRAeMEdDbQGZILKc,EAAAdAAAQADAZACBLAFAKAFA..VCEAJBHB....SCAAhACAaCBBFDHD.OCFDhADATEBAHDCBUGFAAAHAeEHFhBAAbGAA...cFDDXEEC.BHHBhAAA.....hBCA...,1,2,-22,24
YVCNFWcJKZQUagIHAbLDRTBSeXEMdOfPG,LAAARAAABADB.eADHEAFA.dAFA..OAHDGBGA.CAHBFCAAJCCAZCFFhAAAQDEC.hABAaEHDHEEB.ADHBbFAAhAFATFBA.MFGBfGHA.YHBAhBHA....hCAA...,1,-8,-26,18
YFGKETIZdWbLVXUABOCgeRSfHNQDPaJMc,CAAARAAAHADBDACA...aAFAMAFAFBGH.GBCAECCB.ZBEAdDAALBHBhAAAUEEAAAAA.OCBH.hADAeDGDfDHAhAIA.QFBAcEECTFBAbGFA.BGHAhBCANIBB......hBFA...,2,-20,4,24
EIaZTUOdHgMWVCLJSFYNcAXKBeRGDfbPQ,BAAARAAAGADADACA.....bAFAEAEAZCFBTAGAdDAAHEGB.MCCBhAAACBCALCBAFFDB.hABA.NIDB.ACFAeCHF.hADAQDEAaGAA.OEHD.gGEAhAAA...hAFA...,2,-26,1,27
PHAGRWBNCIFQaYbLKSXDdZceUTEfOMVgJ,RAAABAAACADB.QACA..bAEDLAFAKAGA.DCAAZCCBeCDAhAAAECGE.MCHB.VEBAhACAgEEAHEEBAAGANCIAhBEAaEHB...XGAAdHGB.UGGB.hDAA......hDBA...,2,-18,-5,13
NaZdCYQGRJPTLcIDVSHKAEgbBfeFWXOUM,EAAABAAAFACDOACA.UAGAaAEAZAGB.dBEAQBCCGECAREEA.hAAAJCEBLEHB.hAAADBIBHDFBAECB.bFBB.hCAAeDHB.MIDACGGC.......hCBA......hCEA...,1,-15,-16,1
MfSDYAZWKNEHbdICgQTRVXPBUFGcOLJea,ZAAAKAAAHACBdAEACAGA.QAEA.RAGB.XBGABCAAGDEAhAAALCABeDGBMCCBDDIBAAIBhACAEDDA..IEAAhAEATDFAUFFBOEDHaGAASGGA.hABA.YHDA.hCAA...,2,-16,-7,9
XBIbORTVPHWMLAFQEGeKgUcYdaJCfSDZN,EAAAeAAAKACAUAEA.dAHAaAEA..CBCA.DAHBZDDABBEA..ODFAhAAARCCB..TCFAhAAAHEBAMEIBAAIBGEGA.hABA.gFFAJFEB.SGBAhBEA......hBGA...,2,-29,-21,8
BDPSVRAYcbZCdfQXKEFGTNgIOULMWHJea,...bAAAdAAA.QADAEAEAGAGATAFA..gCAAhAAAOAHDMCCBHCEBeDABhACAaDDBDDIBSDDAhADAAAIBZFGFXEAAFDGBIFHALGBABFFD.hABAPHAA...hACA...,2,-8,8,16
MJfUAFXEYbDVPKRBSOLcQdTHeGNaCgWIZ,EAAADAAAKACARACA.BAEBLAFB.dAHAHAFBeCCAaAHF..CDAA..hBAA.ICCAZDEEMDIBhAAAUDFBAFFAFFGD..bECBhBBASHBA..QFGBhBHA.NIDB.....hCAA...,1,-17,-31,14
ZfFaRbGIUMWPYBdQSDHTNOLgCecEVXAKJ,ZAAAaAAAGACAMACA......PAFCdAEBQBFBhAHAHBDBTCGALDFA.hABAeBBDEEFBACCBfEDAhAIARFCAbGEA.IFFA.YFHBhBAADEIBNIAB.CHDA.....hBIA...,1,-3,-13,10
GLANJIWfSPcHKTgYZDUReFdMEQXBOCbVa,JAAA..fAAA.SADAHADBTAFAZAFBRCAAeAHHhADAdBHAEDEBQDDBhAFAOEABbECDGDFA.ACCBIHAAhAHAcEFDKFHBDDIBMIAACHEAaHGENIEB...hAAA......hACA...,2,-5,-1,4
NcKMARSGZLXCVTOIdbQPFfDWBgYEaUHeJ,RAAAZAAALADBCADB.OAFAdAFAQCAA.FAHBDBFBBCDAhABAEBGBHDEC.eCCDhAAANCIA.MBIBADFAGEEAhACATFGA..IFBA...fDGAhBFAYFFF.aGHH.hABA...,2,-22,-22,0
HOVRPUNJETAIBdMKWbGCFZDQcLSXefgYa,dAAAMAAAKADAGACBZABB.QAGCLAFBeAHB..fBBEhAFAaCEBHCGBRDCBPCEDhAIAUFGB.ECHFAFFBBHHDhAIAbDCDDEIB...XEFD.OHFAhBAA......hCAA...,2,-12,-7,5
SQFcEVTXYDBMLbRGaOZACdWgUIfeNJHKP,dAAAUAAAeADAHADAKAGAQAGC.ECDBTCBA.DCFAMCFBhADARDEAGEAAZDFBACIBCEHA.hACA.IFDAfFAAhAFAPEHDFGHB.XGFCBHEA....hADA......hAEA...,2,-21,-6,15
KBQHSGFfUAIPNJVaZEWdeYDMgRcObTXLC,..IAAAPAAA...JACAZADB.EAFAeAFEMAIBRBEA..OBCBhAIATCFALDDAhCAABBCAHEEAGDGAFFCBABHBaFFHhCBAdEHADCIBgGGG.....hDAA......hDBA...,2,-17,-4,13
UDScPaGACREYgHZQXdLWfBNeFOITVJKMb,EAAAHAAAZACBdADALAFABAFAeAGHFBEH.OBHD..TCGAhAAAKCADMCCBDCBBSEEAhAGA.aEHDADDARDEBQGCAhAHAfEGBIHFAbFAAUGGA..hAAA......hACA...,1,-8,-13,5
OJaBHRFIYTVMCKgNGQAPecfDWbEXdULZS,eAAADAAAEACAdAEA.ZAFBOAECBAHAHBCB.RCGF.FBBH..TEBAhAAAMAIBKCEAGEEAAAGA.hBAA..fGHAhABAbCGDLECA.aGCA.IGGA.CDDDNIEBhCAA......hCDA...,1,-4,-28,24
UDgYMLaXGIBbNFZEAHKOWRCTQPeVSfJcd,HAAAOAAARADFQAFC.eAHHfADAdCADDDDBMDGBhAAAaAEDGAGABDHAbEEDZCCAAAGBhAIA.CEED...PHAAhACASDGD.cFGDYHFG..hADA......hAHA...,1,-1,-28,27
QOTKbaMdPgNALXJFRUZDfGBSeEIWHcVYC,LAAAFAAARACFZAEB.GADABAGA.EAFAHCFB..VBGBQEAAhAEATCAA.aAHDdEFA.PEHDhABAADHAUFFB.SECAhBAAeDDDIFAA......hACA......hAFA...,1,-7,-16,9
SFIEGUXfPJRKeNZbYaHdWDCgATLcQVOBM,TAAALAAA.QAEABACBMAEAFAGEEAHFGCAA.XCCAhABAfBDA.RBEFeCCDhAAAbCFAHEFAdDGACEEDACABOFEBhACASEHHIGHAPGBA.KGEA.hAEANICB......hCCA...,1,1,-3,4
YdeJWCKAGIRUMBNHaEXTbDgLOSZfVPcFQ,RAAAMAAAHADB.EAFATADADAIB..LCGBZAFB..fAHAhAFAPCCBFDABdBBAeDFFhAAACCHAADDAGEEABFAAaEHDbFCBhBAASFDB...cGGCYEHBhCAAKHBA.....hABA...,2,-6,-4,2
EHOcBKTMdNSARUeWVDJIagCFGbfQYLZXP,RAAAeAAADADA...aADDFAFDGAFA.QDBAZAGBEBDFHDEABAHAhAAAMBIBdDEAAAFB.VEGBhABAIFGA.CEDD.fHABhAHA.LHDAOFHD.KCHBNCCA.hAAA......hABA...,2,-29,3,32
YQFKJHCZWbGIAaEXMNUcDfLgBVSRTdPeO,EAAAMAAAUADADAEALAHBBAFA..RAGFdBCCeBBA..QDEAhAAAKBEAHDDAZEGBGEGAhAIAABBAaFDCXGEC.hBAANEDA.fGBA.SHCAhBGA......hBHA...,1,-13,-23,10
MdYPHUeQbFCBSLJODTRNVgXGAEWKfcaIZ,EAAAKAAA..aACAZACB.dAFAHAEBeAHBQAGACBEC.LCCBhAAADCBBRCGB.gDGAhAGAADEA.fDBAhBDAMEEBPFFBbEDDSFFG...hAAA......hAIA...,2,-35,7,42
RFLYMQSVHZcgbPUdOIWBfAJEGCaDeXNKT,EAAAaAAA.DADA..eACHKAFA.RAEALAHB.MBBBQBCAhAAAHCFBZDDBbBFAdEADOCBBhAHABEHAADDBGDEACFFD.hAEATDGASGHBgECDIHCAfGGAhAIA...hAFA...,2,-9,-9,0
TSZgdVLCIBQJHNUfbDKYeAaPFMcXRGEOW,aAAAMAAA.RACA.EADA..OAFASAFAdBGDLCCABBBDHCDAhADAUDGAbBFAKECA.ABBB.FDCHhAGAGEEAZEFACDGAQGGChAIA..fGHA..hBAA......hCAA...,1,-1,-25,24
GCeNTWLKYBHXUcEPVDZAFgIQMfOadbSJR,FAAAQAAAMADA.aACEdAHA...SBCARAEFeAGH..TDAAhAAALBFBBCDDHDBAhBAAXDFAEDHBDDDAAAIBfEEEhADAbFCACGGA.KFHBYHBAPGAA.hAGA......hCAA...,1,-11,-14,3
fNCHZadWASTbLVYORcgPQBKFUeXDJIMGE,TAAALAAA.OADDRACF....gAEBQAFAFAGAhAAAeBHHDCAB.MCABECEBCCGAhACAHCEBdEED.ACCBbFAAVFGBhCIAPEHDKDHB.XGDD.IGFAhABA.....hDBA...,2,-16,4,20
dIZNfRBPFYACVbWXHEDLaJKgSOMcGeTUQ,CAAAVAAA..XACAHADBEAFALAFA.aCAAKAHB.OCFChAAAGCEAeDAATCGAhAAAdEEAZEFBRDABFEDHADAAbFAADEIBSFHDhACAMEIB.QGAB.hADAfGFABHCD.hAFA...,1,4,-2,6
YTeGFMIXJRaAZBEQfbVDSWHPKcdCOUNLg,EAAAQAAA..bACASACAHAGBKCCAdDAAOAEDLDFAhAAATAGAeECBGCFAhAAAMEEBXDAARFFAAAGBBHHAhADADCIB.cDDCNIAB.FFHB.aGAA.fHDBhADA...hAEA...,2,1,5,4
XQgUVALdBKJDCWIacPGbfRMNFTSeYZHEO,dAAAKAAACACBaADA..GADARAFF..MAIBFAFA.eBDBHCFA.ECCBQCBDhACAUEFB.ACHBLEFAhAHADAIB.IFDAhBAAbFBA.TGEASFHHOEBD.hAAAXGGBBHCA..hBCA...,1,-12,-20,8
XdCFfNMAYZEHeDQgWJcTIBSGOaVUPbLRK,EAAAHAAADADAQADC.JAFATAFASCAAaAHD.UCFAhAAAbBCB.RDDB..dDHAfCEAhAAAAFDBeFGB.gDFAhAHA.IFHA.GGDBhCAA.OECB..hCBA...,2,-18,-9,9
OgfINRHVUCZAPFYGLeBXcbQDWdSaEJMTK,FAAAGAAAeACHBADA..XAEAQAFAdAHA.ECDAMCEBTDEAhAAAOCFB.IDHAhAEAHDGBCAHAACIB.LFAAhACAbFAADEGB.aGDDKFHBfGGE..hADA......hAFA...,2,-17,-10,7
VFYMACJBTbLKNeUDEgfPORXdGQcHaISWZ,BAAATAAALACA.eAFHEACEfAEBRBGFGCCAHDABaAGA.hAAASDHHZBEEFCCBACIBCDEAhCAAbEFDKDGA..DEFBOFFAhDAAdHAB.QGDA.IHHAhDBA.....hAAA...,2,-8,1,9
QJNeAHWCbEPTfXaBcgOZGKVdDLFUMYSIR,HAAACAAA.EADETACAaAFA.BAEB.OAFDGBEB.dCADLAHBhAAAMDDBSDHBhAAARCAAQDECeEEAABHBbECBhACAXFGD..ZEGBDIAA.....hCAA......hCBA...,1,-1,-17,16
CaWBVZYXdTQSNfHFGPAbMJRcEIOKDeULg,MAAARAAAEADE.KADA..eAFELAFB.aAHBBBFA.ZCCAdBBATCGAhAAAQDCA.hABAfCHAHECAGGEBhAIAAEEAJEGFcEGCDEIBCFCD......YFFFhBAA...hCAA...,2,-18,-13,5
YAScaMZbQCTRHNBKEfJdIWXFUGVDeOPgL,aAAAZAAAQAEA.RAGBHCAAKADAEAFEdDEAXBBCGECAeEABhABAOAHDLEHBhACA.AAIBMFGBbCDATECAhADAfGEAIEHA.FFED.DGGA.PHAAhAHA....hBAA...,2,-24,17,41
DKgIadbQAXSTRUBCLZfEGWYVJPNecHOFM,TAAARAAACADB..ZAEBEACEGAGA..VAFAJCCB.eCCAHDFBMCIBhAAAKFED...aDEDdGBAhAAAAAEASDGBhAIABFHA.LGEA.......hABA......hAIA...,1,-9,-29,20
TgONJRDEVcHLedGPYIFQKfBMSCaUWAbXZ,ZAAATAAAOACA.RAFA.EACEHCCCdAEAGAGA..ICHAhABAQCCCBDFAMDFBhAAAaEFEAEIBbEFD..XFCAhAGAgGAADGGA.cGDC....hAGA......hAIA...,2,-22,-11,11
PCZOBdbcGHNMgYXWTfKSRFEAVUIaDeJQL,UAAAaAAA.eADALADAZAGBBBFAdAHAGCCAHCBC.MBBB.XCFChAEATEAASCHHhADAEDHFACCB.DDFBQFAAhAFAOEEHbGFAgFFB.fGEAhBAA..hBHA...,1,-13,-14,1
LSecYONAFVfXaDJbPdUWKCZREQTIgGHMB,FAAAXAAADADA...JADAdAGA.KBCARAGF..EBDBQCEDhAIA..TDEAGDGAhBAAHEGBMBIBLFCBhAAAeDDDOEBBADDBaGAA.bFED......hBEA......hBFA...,2,-22,-14,8
OcPZeWMEVgaUTbBFSdRNXAQKDHIfLJGCY,QAAAHAAALADBGACBOAFAZAGBeCDAEBFB..aBHDbDABSCAAhAAAREEA.ADFBDEEBhACAfFHACEHA.hBGAPHECMFFBgGGABDHAdGAD.KHCA.hAAA......hADA...,1,-1,-3,2
gBKRDQWcbGSLdIZfeMYVHTNOXJPUCFaEA,KAAARAAAQADC..bACBGAFAdAFAZAGBeAHB.MCCBHCDBhAAATDDAXDGAPDHBhAAAFEBBABIBBFAADFDBSFFAhBEALFDAfGHA.NIAB..hBFA......hCAA...,2,-23,10,33
XSVOebJRdMYCGgTfKBLHANFQcaPEUWIDZ,QAAAaAAA.EACAIADAZAEB.SAEHeAGFRCGFdCDCMAGBhAHAGEBA.TFEAhAAABAHAHCCAAAIBFGHB.PCHBhBAADIEA.OBBB.bEEB.CGGA...hCAA......hCIA...,1,2,-22,24
VAdXHIgaJTFMcSKEeBOLCPbDGWQfYURZN,HAAAaAAA.TAEAMADAKAGAEAGE..BCADLBBACCCA.DBFBGCEBhAAAQCGAfEAAhACARDBAZEDEADBAdECA.XEEChADAgFGAFEHBeHCAbGCA.UGGB..hAEANIAB......hAIA...,1,12,-6,18
FLOWCYQSbADNIZMHEVfdPGBaRgcTUKJeX,DAAAZAAAHAEAEACA.dAHAGAEARCAA..TCFAKAGAeBBBLEAAhABACCGA.QEEChACAACIBMDDB.fDHAhADAaEBHUEEBFEHBOFHD.SGAAbGAC..hAEAIHHABGGC..hAGA...,2,-22,13,35
deXSCQWUEYGKgJcRIMaZATNPLbVfFBOHD,TAAALAAA.VAEABACB.HADBdAHAeCAACAFAQBGA.hABAECCBGDDAKDFAJEEFRDGBaEAAhACAAAHA...bGFAOEHDhAAASGDDUFAAcGGC.MFDBhAFA......hCAA...,2,-8,-2,6
bQLKgNADVXYdUHReFOIfGEWJBcCMZaPST,XAAAdAAAHADARAGFFADAOCAE..GAFAECEFBDFAMAIBZEFEaBCDhAAA..SFAAhACAQECALHEAhADAKDHDAAHBDEFB.UGGA........hABA......hCAA...,2,-18,-13,5
YQXFfPSaVGEDUZARKcHNOBIWTgLJMedCb,RAAAHAAABADBTAEALAFAeAGHdCCA..bCAAQCFA.hAAAFEDDSBHHhACAGGABEFFAZDFAAAAA.KEAAOFHDhAGAgEEGMIDA.XGAA.aFHH.hAHADIGA.....hCAA...,2,-13,12,25
CagOTHUAXeBFYZLIQdcfbKGJSVRNDEMWP,eAAAFAAAZACBLAEAdAFA.....bBAAGBGA.SAHBhBAARCDFEBHFMCGBCBECaDEBhCAATFAA.HEGBAEGBBFEAhCBAQFCCKFHB.NIABDFFB....hAAA......hABA...,1,2,-34,36
DPFOIefYCBULZdKgHXTQAbaWcNSMVJERG,aAAA..NAAA.MADAEAFA.RAFA.GBBA.FAHDeBBA.CCDALCFAhAIAdDEAHDGBTFAAhABAAEEA.bECDSEFAhBAA.DEIBIHHABGEAKGGAQGEChACAWHCG.....hBBA...,2,-30,7,37
CZEdaIYBDFMSNfAcUOHWJgXQLTbeRVGPK,OAAAHAAAJADA..QADALAGBeCAARAFAGCCACCEA.EBBBaCHDhAAABCGA.FDHDMDDBhACASEFBAAIBUEEAXGCChCAAbFDD.KFHBdGAADHFAfGHAhAGA......hAIA...,2,-10,-7,3
YeFbKEMQIXcANCLgGSaRZHUBJfPdTDOVW,LAAAGAAARADAHAGBBAEAJAGBdCDDDDAB..OBHD..VDFBhAAAeCAAKFHBECEBMEEBhACAQEAA.XEEAhABAAAIBCGAA.aEHH.ZFCF...fGAEhACA...hADA...,1,-11,-22,11
PTUCYgOSNBcXJadVDAEHKMLWbIGfZQFRe,HAAAMAAALAEA..bADBGBBAZAFBRCAAeAHFTCGACDHAOEEBhAAABDEAXECDhAFA.dFFAABFBEFGAKEHBfGAAhAGAFGFH........hAIA......hBAA...,1,-9,-17,8
fAHBJgSQDceTGZMdbWRXILOYUVKPNCaFE,HAAABAAASACAQADCeAFEZAEBdAHARBFBLCHBUCAA.KCADhAAACBGCFDDHACCBDDDA.GEEAhACAMDGB....bEGDhAAAIGHA..OFED...hAIA......hEBA...,1,-5,-27,22
GDQdMVUcKCBAIZOgeaJSTRYWHNLbEFXPf,ZAAAeAAAaACA..TADARAEFHAGBLAFB.EAHBXCCChABAGCCAdDHAMDGBUEFACDHAAAIBOEEBhAGASFCD.hCAAYHCGbFGD.fGHADFIB..hAAA......hABA...,1,-6,-7,1
ZYfKRbFeaUOgAWTDMQPIESCVHLcJNBXGd,TAAAMAAA..QADAEACE.CAFAHAGBLAEB.cAGAhAAABBBAdDCAZCCBKBGDREDFeDHFhAIAaDGD.OFGHACCBDDIBSEEBhAIANIBB.GGEB...hBAA......hBBA...,1,-2,-16,14
KEUJBYaWRAVSFNdMHCOGQgPecZXbDTfIL,FAAAdAAAHADAGACAQAGCeAEAZBFEDDGATCBA..LEABhAEAECFBBCHAaEDDADABSDEDhACAMEHB.OEGDhADAgFEHXFAAfHBFKGFD..hAFA......hAIA...,2,-20,-2,18
MNJUdgVOLfFYAacSDeZQRHKWBGCPIXETb,aAAADAAAeABAZACB.HAEABAEAGCCA.CAHB.XAFD.EAHBhAIAbCFA.MEFBUDEAdEGAhAGAOBBBFGCHACCBSGHHhBAARDGBKECB..IHHA...hCAA......hCBA...,2,-24,-10,14
IKWUMfaOeNAGgZRECSHXBVTcJbQdPDLFY,ZAAAEAAAHACABADB...TAGAJAFAdCAALCCA.FCGHKBFDMCIBhAAAaCCC.eEAAGCGAhABAREEBXGAA.cGFDhAEAbECADECA...IGDA.UGGBhACA...NIAB.AGAA.hAFA...,2,-21,2,23
MULgORaYNWdbDTfBVcZePHECGIQSFKJXA,MAAALAAARACA.aADD....NAGAdAHAbAED...DBBBBAGAZCCAHDGBhAFAEBHFGCAA.hBAAQEEAKECAACEAOFFBhBHATEGA.fCCE.eGAAhABACGHA.FGHD....hACA...,2,-21,-8,13
DAMRLgPVaSdNUTHBGEXFbOcefYJQIKWZC,RAAALAAA.VAEAdADATAFA.HCDCEBHFFCAAOAHDeCEBhABAJDGBQDCDhACA.KDGDZFAAAAHAMDIBhAEAaCCHSEEDBFGA.......hCDA......hDAA...,2,-18,-16,2
SZbeQRUMHGJELWBXgYNIcPdfDTOCaKAVF,SAAAeAAARADAHAGBEADALCCA.XDEAgAFA.hAAAICCAdEAATFGAhABAaAHDAAAAZGAEUDEAMFFBGDAAhADABEHB.NDHAfGEADIBA.KECC.hAEA......hAGA...,2,-3,4,7
YWcSAMITNJBPfgKDOEQaLHCFXVUedbZGR,MAAATAAABADA....fACBDAFAEAHFLBBBHAEBXAGAhAAAeBDAZCFERCCBcCFDhAEAADDA..IEGAhBAAPDHDOFFBaEEHFFHDdGCAGGABSGGDhCAA....hCBA...,2,-21,14,35
DGMPHLCFNSJdfXagQWeTVURYZcOIBAEbK,EAAADAAAGABBHACALAFBFAFA..SAHHdAHAaCCCQDGAhAAAeCCAUDFAREAAZEEFODHFhAEAAEAAMHBA.CGGBNIEBXFEChBAA.gGCD...hAEA......hBHA...,1,4,-19,23
FGBOCMaKTdQRYUJIfcDNSPAXZbHVEgWeL,ZAAAHAAAEADEeACEGAFACAFBKAHBdBHA..RCCAUCFAJCAA....fCEEhABADDIBSEEDhAAAAAHA..XEEChACAbFFB.gFAALHAABHHAaEHBQGGBhAFA...hAHA...,1,0,-17,17
GQUBXRSADPZLKebTEVgNWHdCaOFYJcIMf,ZAAAeAAAEADE..VADA..NAGA.HAGBdAHA.aCCBFCAA..JDDAMCEBhABAGEGABDHARGAAAAAALFAAhACAKGDC.bDED.hAGA....gGFA.OHBAhAFA.....hAIA...,1,-10,-15,5
eNFSgEAZDLfKJYPMIVXWCGHTcbURBOQad,ZAAALAAAKADC.JAEAMAGB....XBCAGCAAHCCChABATCAAbCGD..RCEFQCGChABAeAHBSEFDhACAAAHAfEHAIFCACGFABHHAdGHAFGEHDDDB.hAIA......hBFA...,1,-2,-18,16
CSXBAbPFdRYGIENMLQHWgUOfeaZcJVTKD,FAAARAAAGADAEADA.MAFAHAFA.UCCA.eCFAZBFBVDAA.DBIBhAAAXDABACHB.dEFAhADAIEHALEHBQFDAhABAOFCAaHAATGGASHFG.hADA......hBFA...,1,0,-17,17
WYPEBJgTaOVbXFDIdQeLcCSRNUGMZKAHf,HAAA..fAAAPADABAGATADAOAHDXAFB.hAAADAIBdCADeBCBLCEBhACASBGHRDCFGEGAhCDAZDABACFBEGCBaDGEFGEBQEDA.CFFBMFHBhAAA.....hCGA...,2,-2,3,5
RSdHeQDCALBVIZEKagXFTYbOUJGPMcNfW,LAAABAAAZACAEAFEaADD..FAFA..TCCAOAHD.GBEAhABAMAIB....fCFAhAAARCAAHDGBeEEDQDAChADAACAAKGCAXGGAbCGDPEEB.cGEDhAEA.SHAAhAHADIEA.CHGA,1,-6,-27,21
NdYeXGZUIMJLDSaKBOgFEfbQACWVHTPRc,CAAAHAAARACA.dADA.eAFAZAFBMAIBLCCA.aBGEOCAB.ECCBhAAAbDEA.AAFA..TFFAhAAAPDGD..cCAChACAXECA.IHBASFHHBCECfGDAhDGAQGGBNIEB.hDIAYFEB.,2,-21,8,29
REDYSQLcBCNJAIFMUTdOVZGgHKfebaWXP,MAAAdAAAZABBHACCeADAaAFA....XAGAEBBBSAHHhBAALCEACBFAADDAFDCD.TEEAhAEAGDEAKDHBbDGBRGCAQGGAhAHABGGDNEIA........hBAA......hCDA...,1,-3,-7,4
SEaZeUOcAXBHFWdRQIgKfNVCYJMDGLTbP,HAAAdAAARADA.QADCKAGC.VAGBCBHA.MCABGCABLCCAhAAA.TDFAbCFCEEABeDHHhACA.OEEBAEEBFEGA.hACAgFAA.fGGEYFFADGCAhADA.....hAFA...,1,7,-24,31
RfTEPbCIUKBSVGYAaLZOHedWFXcgQMJND,ZAAAHAAAeACEdADAXAFAQAFC.MAIBDAIBRCAA...ECEAbCCChABACDFA...KCGBSDGHhAAAGECAAEEAaEFDLFAAhACAFEHD.gFFGfHAB.IHHAhAHA....hCAA...,2,-10,-9,1
IUALCMNOadTeRGWJSbcHfEZDYPgQBXVFK,MAAAaAAA.dAEARACFGAEA..SAGAHAGDEDGBZEAADBBAPCCBhAGAQFFC.XGAAhAEAKCGAADFBLEEAhAHAOBBH.eEBD.bGEA......hBAA......hBEA...,2,-25,2,27
aYHLZVMcefJWXAPIgFEUCRNObBQdDTSGK,..IAAAEAAARACAOAFABACA..dAEASBEAGAGAKCAAHCFChAAAZCCF.MCCBeDGDfDAAhADAXEBDAAGBFDDBCEEB.hACAbEFADDIB..aFEC.......hAIA......hBEA...,2,-26,-1,25
TdUZKLMaGcFPfeBJQDHSXYbAgVCWIREON,CAAARAAAEADE..TACAZAFBLBHBGAEAFAGAeCCABCAA.QCGAhAAAHEEAXFAAhAAAACCB.gGEAhABAIDDAdEAAMIAAaEFDfHGFSFHB.bGBAhACA......hAEA...,2,-18,6,24
NOegIbFZCEKAPaGRDdBHSQVfLWMTXYcJU,GAAARAAAdADAHAFAQADALCCAMAGB.TDCAXCGAJAHBUEFAhAAAeEEA..bFAAZFBAhACAEFGAADABaDHD.SGHHhADAfGHAYHAAOHAC....hAHA......hBAA...,2,1,3,2
SZHNQDegKCUTXAdVBPGacRfEJYWIbOLFM,dAAABAAAaADARACA..EAFE..JAGB....ICAALBDBMAIBhAAAHCAC.QDFBhACAeCCACCFAUEEAAAIBGFCBhAGA.fFHAbCGDSGHBDCIBKHFA.hACA......hADA...,1,-6,-31,25
gPcFYAWUKeCSDHdabMQOJXLVINGTZEBfR,KAAAeAAADACAHADA.aAFAMAFA..QCCCOBCCLBFBhAAAICFAGDDAEBHFREEA.hAAA.PFHDFBHBADDBCDHAdHEBhABAXEBD.TFGABDHA...fGFEhBEA..hCAA...,2,-31,6,37
LSVfUWCYHIeQbZXPJcdREDKaNABGMgTOF,GAAAMAAA.OADALAEA.SAHHfAGACBBAHCDAhAFAeAHHZCDAXDBC.hAAAPDGDdECAEDHFaEFHAEEATFFAhACAFFCAUGAAIHHA....hBAA......hBCA...,2,-14,-2,12
SBCLJKdcOYgRXWQPMHaeUIVDNGbFfTAEZ,EAAAZAAACADBLADA.dAHAOAEDRCBA.QAGAHCFAeEABUCAAhABADEEB.GCFAFECDABCBBEHAhAAAKDDB..gFGHhACAXFEDPHBCaGAA..IHDAhAGA.....hAEA...,1,-12,-13,1
MNFVYPIWcBJeOTUfZADbdHXKCGSgRaQEL,dAAAHAAACADAGAEARADFEAFELAHB.MCABFAGAVCBA..ICFAhAAABCGAeCHHTEEAhACAZFFAADABDCCB.bDADSGBAhACAQEGCNEEA.PHCA.WDDDhADA......hCHA...,2,-20,1,21
XDPYaJcLTAGIgOfVWSEQdHNBbZURFKMCe,GAAAOAAA...fADASADAEAFAHAFBBAHAZBBARCDAMCHBhAAAeAHBDDDB.aDGDLECAhACAAEAA.gFABhADAQEEAbGEAKFHBXGCD..hAFA......hBAA...,1,-7,-17,10
WbTgRYIVSUDOcJGCNFKaXAQZEMLedfHBP,EAAAeAAAHACABADA....bAFBRAEFIAHASAHH.OCCBhAAAGCCAFDEBaCFDADHAZEAFhAEAdCHA...fEGAhBHATFFAVGAADEIBCFCAKHDAMFFBLFHB.hCAA......hCBA...,1,-1,-4,3
CdJgLeZHbSNBPDKRWVMUcXaEAQGTOIfFY,GAAATAAA.OADAFACA.dAHALAFAHBFBSCDBBCCAKCEARCGFhAAAMDDBUECA.aEFHAAABQEFBhACA.hAGAfEBACFHAeHAANIEB.DDIB.WHBA..hBCA......hBDA...,1,-12,-14,2
QdAWHOZXVCKIGNPRMBYcgfETLUFeSDbJa,HAAAZAAACADBGAEARADFMAFABBFA....gAGBEBHBLDAAhAAAeCABbDFB.aEEBACCBXDDDhABAKEHB.IDGAhACAPHEA.fEHA.TGBAhAIA.SFGDhBGADIBA..,2,-12,-10,2
PUBAfbRIWaXTLeHYKONJMGSDdVQZEcgCF,RAAAaAAALADBHACBOAEAMAFA..GBFAdBEAZBGBEBHBCEEA..FEHDBCCChAAAABBB...bEEDXGCAhAIAeFBAKGGCSFGDhBAADIBA.........hABA......hBFA...,1,-14,-19,5
STbPHfIWaDLGUBJYeRFAgdNEZCOcKXQMV,dAAAEAAAZACBOADA.KAGAMAFA..SBDBTBEAHBGB.hACAIEBAaCBDGCFAhAIABCBCeCHBABIBCDEDQEFDhAAAbDCD.fGBALHFA.UGGBhBCA......hBEA...,2,-12,-11,1
eCZAHIFXDNdPgESMRTbGOUYKLVafWJBcQ,HAAAXAAAdADAEAFARADA.GBGAUAGALDAAaCAC..fCEAhAAABCFDeDFAAAIBDDDBhACAPEDDMEFB.bFABKFFAhAAA.JHFAQGCA.CGGA....hABA......hADA...,1,9,-22,31
AFLbPSXGgBNeMVcERUJQZTIKCdfWDaOYH,LAAASAAAGADABADA.eAFAMAFAEBHFRBDA.UCAAZBGBKCCDdDFADDDBhABA..aDABHEGBhACAAAAAFDEDbFAB..XEGAhADAgGCA.NIEB.cGBA.TGGAhBGA.CGDB....hAFA...,1,5,-15,20
bWTZCfMHGOVQBcaXIDPJNUeKgdFEYSALR,RAAATAAAZADB..MAGBHACBGCEAQAEABAHA.aAGEDCCBPCABhAAAUFBA...eCFAhACAdEHAEDAFADEBbDFA.fFFAhAEAOGFC.........hAAA......hABA...,2,-25,10,35
aJUVLXTfQeYHbSPBGKAWgcDdECOINFMRZ,....gAAAdAAAEADAOAFCFADARAFFZCCAaCAE...UECALCEAhACA.TDCAhADAeAHHHEFASCHHhAHABBDDAAAADEFBCDHAMHAAXEGCfGHAbGCCKGHB.hAIA......hBAA...,1,-7,-13,6
TRbPKOQcfUGaLYHSWdAeJMBINCEFgZVDX,eAAAMAAABADACADA.FAFAZAEB.DAHBRBBB.KCCB..QBEDhAIAUCGBGECBaBHD..HDEAhBAAdFHAAAAAJEHB..EGBAXGFDhBBA.PHCAfHEB..hAIA......hBGA...,2,-33,-10,23
ZIWMeUOBbDcaPSLNVTYGRQJXfKAEHCFgd,HAAAFAAAZACBMACAUAFABAFA.DAHB..aBEBLCCA.TDFAhAAARDEAQFDChAIA.XGFAAAIBEEBAdDHAhBEAeHBGbFFCSGCA.NICB...hCAA......hCDA...,1,-11,-26,15
gSDAVcGTZIBWRLHdaQMXKUePYJbCNFEOf,GAAAZAAABADBRADAHAGBdAFA.MCDBKAHBUCAAeCEF....PDGBhAAAJCDB...bFEDFCGDhABA..EEABODHDhACASEHHAEFB.cGAC.IHHAhACAaFBBQFDD.CGGA.hAHA...,1,14,-37,51
gVPeWLbdQTUZAfEDCXHFRKGcYSIaBNOMJ,EAAAXAAAHACARAFFGADA..SAHBaAFABBFB.MCCBVCGBhAAAeCGHLDAAdDDATFAAhAAAAAIBCEFD.KEHBIFDAhABAOFDE...gFGA..hADA......hBDA...,1,0,-21,21
UADWdTbMaBXVNOELQCeYSZIKPFRgcGHfJ,dAAAMAAAaADABADA....XAFDOAEDEAGALAHB.hAGAeBDBZBBFKBHBRCAAGDEAhACAHCFBfEDAhBAAADGBTEBAbEGDQFFB.SFHHhCAAFHBA.JHDADEIB..hBAA...,1,1,-6,7
GQbVBRNSaTPLXAgfEICKJWYeZcFHdMUDO,EAAAKAAA..JACAeACA.ZAFBHAFBdBHAMCCAOAHFGDAA.QDDChAAAbCCB.REGBaFFHhADATDGA.LEEBhAAAAEIBfHCBCFAAcGFDDIAA.BFDA.SHAAhAFA..hAHA...,1,8,-27,35
cbeFDKIgVXJOEYPZGfMCQSUNWHABTdaLR,dAAARAAAeADEKADA....VAGBOAGD.EBDFZABBGCEAMCEB.QEGAhAAAUDGBHFAAAAIBaCCHhABALHFAFGAADGDBXFFAhAFA.........hAGA......hCAA...,2,-14,-13,1
KTgWYLRNOfbPEBIUeZaVXFMCcQGJASdDH,dAAAHAAAKADATAEA....gAFBLAGBRCAAOBHDhACAbDCAEDHFBCBA.eCEBhADAaEACFFGHMDDBQGCAhAAAAAHADEEB.WFHHfEHE.IGFAhBAA....hBCA...,2,-38,12,50
BKNcaCbQRWgMLfTIHeSVXGOAYdZPEDUFJ,ZAAAEAAAFACDKADC....aAFDQAEA.RAGBMCEBTCAAHDFAhAAAeAHBSEAAhAEAGCGAACEBdDDDDDDBBFFDhAIACFBAbFFD.LFHB..fGDAhABA......hACA...,2,-22,-4,18
QNDKJORTBgLedCafMFbcEGUZVAWYXPHSI,XAAAHAAAQADCKADA.RAFFBAHBeAFEaBEEMCAB.FCCHECDBZCGBhAAAAAAA....PCGDhADASEDADCIBTFDAhAIAdGEAbFADUGGA..YEHB..hACA......hAFA...,2,-15,-4,11
MaKgVHZNELAfSWYRBGPdIbXTJQFeUcDCO,SAAARAAAGADAdAFB..XACDQBGBeAEADCCB.MDABhAAAaAHDKCEAHDEBEDDBADDB.fDGAhAAABDGD.bEABhABATGGAFEHD.CEHA.OFED.gGCDhAEANIAB.WFAD.hABAIHHA.,1,8,-4,12
NRTBaXOcHPbJCSIeFUdVAYWKZMfLDEgQG,KAAAZAAAMACALACBDAGA.EAEAGBDA.RBFA.aAGD..OCCHhABAHCEAbEAACDGA..eDHHhBFAdEEDAAIB...fDHAhAAAQFEATGBAXGBAPFHDIHHAhBGA....hBIA...,1,-4,-19,15
VAHBQYCEgLUFaGJMOcZdKbRSTPfIDWeNX,HAAAQAAAEADELAFBaACE.GCABMAFAZBDEdAHARDFA.TECAhAAAfBHADFFBeHBAhACAXDAAAFIBBGGACDEAFDGHhAAA.OEDB.bFFA.SFBDhADAWHFA.NIDB.....hBFA...,1,8,-10,18
dNSVXfBTCQEUIDgRKYHPLWGabAZecMFJO,eAAAMAAAFADDdAEA..SAGA..fAFATCCAECFAhAAADAHBRDFA.HBBBLEBAhABAaBHDABBBZDEAOFFBXFAAhAFAQGAAUFDAKFGD.....hAGA......hAHA...,1,-8,-14,6
NIWJEGYPUTOXRBHDMbCSLgdVKefacQAZF,ZAAAFAAA...IAEAEADAGAFAUAGAOAHFRCAA.HCCAMCEBSDABhADAdDFAKDHBeFCBhABAaDGDAECB...JEEBTFGAhACADEIBLHAA.fGGAhAHA.cFBD..hBAA...,2,-19,-11,8
EfHYKOGCcUNDbZSIaAedMTJFLBPWQVRgX,eAAAdAAAMADAFADDLAFABAGA..QBDARCDAECGE.HCAChACAOCCHGCFACEFAUGAAhAAAbFCA.ZEGB..aAHDAFEB.hABAPEHD.WHDA......hBAA......hBCA...,2,-17,-13,4
OPDTVMaJYdLeZEGRNbUHgSBIQXWFcfCAK,OAAATAAA..MACAaADD..dAFAZADERBGF.UCCBHDBABAHA.QCFAhAAAFDFHCAHBABBBDDIBVFCAhAHALFBA.EFGFhBAAbFFB.SFHH..IHHAhBDA.....hCAA...,1,-14,-15,1
WcSRQJDFEeUZBHVAbfTPGCIXaOgNMYLdK,TAAAGAAACADA..aACAOAED.MAGBdAFAKAHB.SBDDhAAARCGFQDCAFCGDEDEFhAHAeDADZECFHEEBACCBbFBDfAHEhAAA.IGHAXEGANIAB.YFFFhBFA.cGGAhCAADIFA..,1,-1,-12,11
OBKfZDJVPYdQLgAeFREaSXUGWHICcMNTb,RAAAEAAA..aADASACAGAFAHBDBCAFAMAHB..bDGDKCCAZFEBDAIBhAAAJDCF...PHAAhAAAdCEALDAB.hABAACGBeDHF.XFFDIHHA.NAIA.BGEChADA.....hAHA...,1,-5,-19,14
fUbIORENdFeTKPWJgBcLZGXCAaYQVSHDM,aAAAQAAAHACBMAEAUADA...OAFCEAHFdBEAeCEAKCGDJDHBhBAABCHAZEEFGDBA.hBBAAAHASDDGhAAAbGBA.REFATGEA.......hBGA......hCAA...,2,-15,-6,9
UPaVSQceCgXFZWfKOYdGLHTRNDbEAIMBJ,MAAABAAAUACA..aACEQAEAeAEHCAGA.FAGEZCCF.KBHBdCHAhAAAHCFBRDDADCBBABBBJEHB.hBCA.SFFAhCAA.XGDCOFDEGGAB...hDAA......hDCA...,1,-14,-31,17
RGfPUMQVZFYNXbISaEBDAWTKJLdeOHgCc,TAAALAAA.eADHHACBCAFA.RAEAGCEB.UEAAMAHBZEEAFCAAhABAXGGASCEAhACAEHAAAAHAKDHB.dEEAOHCChAAAfFAA.QFCA.VGFAhAFA.NIAB.aCAC.BEHBhACA..,1,14,-15,29
DYXVfNbcEMJdLFRZOAeaBUWHKSIPGCQTg,eAAAaAAABADAHADA.SAFEGAEAQAGATCCA.DBBBXBGAhAAA.fCFEhABAbCCDEDABdDGARDGFAEEAKFFDhADACFFD.VGAAMFIBFGHB.......hAIA......hCAA...,2,-8,-3,5
FXPKOQSeJUcHAWCgfbZMaGYBdRVLEDTNI,CAAA..bAAAaACA.GAEAdAEARAGBLCAB.ECCBTAGA.hAAAFBCBKCFBQDGAhAAAeDHFUFEAHDDBAAIBfGAAhABAZGAAMFGBBHHADFIB......hAGA......hAIA...,2,-10,-5,5
BFNYLISXfCEaOUPAKdWMVGHRcebgZJTQD,dAAAMAAAHADARACA.eAFEZAFB.QCBAFAHDLCEDSCFAhACA.CDADEDDEaBBHODFEhAFAACFAKDHBGEFA..hADAbFGB...........hAIA......hBAA...,1,-6,-27,21
JTNLfSAbIRaMDeXdgVKWZcEUOYQBCHFPG,RAAAaAAAeADE..dADAKAGCZAEBUCCAQAGAHCFAGEDB..hAAATDBALEHBABBBbDFAhBAAMEBB.XFCChABAgEEG.cGCAEHCABGGCFFHH...hBDA......hBIA...,1,5,-18,23
BOgFZLVWaQbEXcKUCdPNHADIJTeYRMfSG,DAAATAAARABA..MAEAGACA.OAEAZAFELCDAaAHD.ECHBhBAAKBFD.dDGAHECAACABeEBBhAAASEEEFEDDQGEAhACAbEGD.........hCAA......hCBA...,2,-21,-5,16
efDHVbSJXWRgCOTYNcMKPEIBAGFZdLUQa,ZAAAdAAALADAaACA.eAGHHAEB.bAGBXCAA.RDCFOBHDhACATDDA..cDGChABAMEABEEFABCCDAFEBFFGDhAEAQFFCDFIB.SGBAWFAH.CHHANIBBhBGA......hBIA...,2,-12,-6,6
bGSUaCdcJNXMWFEgPYAOTKfeRHIZQLBVD,TAAAeAAAHADA.ZAGBLACBDBIBGCCAaAEAdAHAJEFA..MFABhAAAEBEB....gCGGhAAAACCBfFFEREDAQFBChBFAbFDD.CFGAXGEDFHGEOFCHBGHAhBHA.....hABA...,1,3,-3,6
JgKXMdeSVZNITfUbWQFHEcBCLRDPAaYGO,GAAAOAAAKADAdADAeAFAZAFB...TCEAUCCAQDGAhAFAHCGBEDDBCFAA.REDA..AAIB.aFFBhAAAJFCFMFIB.SGAAhACAIGGA.fGGA...hBAA......hBBA...,1,4,-32,36
PLRHaQDBJdbIfMXYUZCFGTgVNOeKASWcE,SAAAEAAARACA.HACBaAFABBFAdAEB..bAGDMAIB.UCCBhAAAZCEBGEGA.TFBAhAAAgCFANIABKGEAADEBhABAPDAB.LEHB.QFFBhADA....hCAA...,1,4,-19,23
SLCUVQJDfEgPBeFcMOWXGNaHYdbKAITZR,ZAAARAAALADBCADB.QAFADAFAEAHFBBEAeBHH..FCAAMCCBhAAA.ODEDGBFAHFAAhABAdDDAACIBTGDAUFFB.hABAfGGA.......hACA......hDAA...,2,-37,4,41
SIXBZcTQPWCLRDdOaNYMHeAGFJgUfVbKE,GAAAFAAAUADA..bADAEAFA....XBGDZBGBQDBAhAIACAHBRCDBdEAD.aDEB.MCIBhBAAHEGB.AAABfFCAhACAKFEABFHDTGCALFFD.DADA...hBDA......hCAA...,1,4,-22,26
fBOAgVTcUCLdPYaeGSNDFXKbIJHRMZQEW,TAAACAAAdACA...aACAeAEA.GBGADAFAKAHBJCBFHBDC.RCGBZDBAhAAAEDDABEADACCB..hAAAgFEAUFEAPFCDhAEASGBA.FGHBXGGBMIDA.hBDA......hBGA...,1,-9,-20,11
XOVecUSRNQMPJgfCWTEbZIFDKAYaGLdHB,GAAAHAAAOACAeADASAGARAFA.MCDAgCCAhAAA.CCFDECHBZCEEDCIBACCAaEEAhAGAdEADBEHDXEFAhAAAUGGA.QGEA.fGHAhACA.WDDD.IHAAhADA.,2,-17,-12,5
FQBRJMSUYfLEeVKdZGICaAXbPgHTWONDc,XAAA..bAAAHADAOAEADAFAQBGARBDF.MCDBhAAASAHHUDAALEEAhABAECAAeCFFdGDAGDGAhAAAaFGEAHHATCEAcFBABGEA.fHBBhABA...hADA...,1,-4,-9,5
RSYMAgbIUfPHKLGeXZaTDOJFQcECVdWNB,..IAAAfAAAHACAGADAZAFBaAHDTAFA..OCABhACAQCAAECCBdCECBAHBhAAARDGBMFFBACHAbDEDKFAAeDGBhACADGGBFHBACDHBVFAA.SDDD.hAEAYFHB..hADA...,1,3,-1,4
OgSQZWUBGcFIEaTRVdAbMHXeDCKJLPfYN,HAAAeAAAKADALADB...fAFAOAFAQBFDhAAAZAGBBCADGDEAFCCAEDFFREGBhABAABIBbEGBMBIBCCCCPFAAhAAANEEA..SGGDcGCBaGGH...hCAA......hCBA...,1,11,-19,30
HXQPGWFOcVJdSZNfDIgbeUaRKMEATYLBC,TAAALAAA.HADBQACCGAGAOCABVAFA.dDDDZCDBDCCBhABAIDGAeDFHRFAAEEHFhACAAAEACEHA...XGGAhAFAFFEDSGFHNIAB.......hAGA......hAIA...,2,-18,8,26
TGFRJeIZHDgXCafSVbKdAcYWPULQNEMOB,......cAAAPAAA.LAEAEACEBAEBGBCA.hAGARCEFeAHHHAGBXCDAhAIAaDGESECDbDFDACDAUGBAhBAAMFABTFGAFDHDIHHAZGCEDIFACEED..hAFA......hAGA...,2,-7,-4,3
QVDJNCTKLIfaWGPcZUMBbeREOSYdFHgXA,QAAADAAACACA.LADAaADD.GAGAZAEBMAHBeCBARDEA.ECEFhAAA.SDFHhAEAdFGAHGBAAAIBVFAA.TFGAhAFAfBBEPFEB.......hBAA......hBGA...,1,15,-37,52
gCOKaLVGcPZQEDNYWeSdMHbfIBJRFTUAX,CAAAaAAAGACAZACB.DAEA....NAFA.eAFAdAGAHDFB..bBFAhAAABBBDRCAB.TEBAhAIAAACBODFBLDHB.hBEAPHEAEDGESEDHMBEBfGBEhBAAFFHBXGFD...hBGA...,1,-10,-14,4
gWTcRQGMSXJAEbNaeLdHZfUFCKBDIOYVP,EAAAaAAALADAHACAZAFBFAHDBAHA..OCCBVCCA...PDEBhAAATCGA..RDGBGEAAhAEAMBBBXEAAhAEAADIBeFCHdGFACEFADEIB.gFCH.QGGChAFA.SHAGhAHA,1,-4,-7,3
MVJIBgScWAPQXUeTGNEDfRaCOYbLHKFdZ,QAAAeAAAGADAEACARAFA..OCCBLAFAHCGBdCDAZDEBMCFAhAAAIFAASDFAhAGAAAAAUGGATEBADIAAaGAEbEFAhAHA.FFDD.BGGA.......hAFA......hAGA...,1,3,-4,7
SDOUEabBXdfYMQWATRZNGCeFgKcVHPLJI,RAAAGAAAeADE.KADAHAGBLAFB.SAHBOBDDECFBaBHHbEFAhAAA..dCDA.MDABhAAAAAIBZFEAFEFAVGAA.IHEAhABABFCAfFFEYCCF.WEHH.hAGA......hCAA...,1,0,-14,14
dFDJQfYZeGbOKgRWATVCIHEacMPSXNBUL,TAAACAAAHACA..EAFEaACA..MAIB..XAEDBCAAdCCDDAGAhAAAQCFAZBGBeBDDbDEDhBGAKEAAREEBACCB..IFHAhCAASEGA.LHAAfGDE.hAAA......hACA...,1,-10,-16,6
JdUCWbaMHRDXTcAGKIYVeNOESBQfFLgPZ,GAAAKAAA..IADAeADAEAGA.QCDALAFAZCAAdCGACDCDhAAAaCCAHFDA.RGFAXEAChACAAAGAVCFA.SDHHhADAFEEBJEHB..bFCDMIBADFCB....hAEAcGFC...hBAA...,1,7,-18,25
bJGcBMdIZQAfSLRHEgaUePOYVWXKTNCDF,LAAAHAAAEADEaAFAeADH.OAFA..VBFBKBFACCAAFCAHGDEAhABAMAIBZCCBABIB.REDFUFGAhAAA..PDHBhACA.XFBADCCB.cGGCBHEA...hACA......hDEA...,2,-15,-4,11
CKINRcLJXVBHUWFedSGEgZYQDMOPbATfa,aAAAKAAARACFLADA..XAEBHAGBFBBHeAGFGCEAZCAFQDEChAAAMDDBODHDAAIBCCHAhACAIEAA.cFADhAEABECBdEHA.EGFBDGGBPHCCTGDA.hCEA......hCHA...,1,4,-15,19
KRgfHJCZLcNbAVUSWFTBQDMeOYPdIGEXa,SAAATAAA.QADAeACEOAFAdAGAECCBaBDC..RBFFHDDBhAAAZCFELDAB.hBIAbEDAACCBUFGABEHAMHEAhAAAIDHAKGBA.........hABA......hADA...,2,-10,-9,1
BGJSYRWOPdgLXKAQcITDfNZHCbaEFVeUM,QAAATAAA.DADAZACBHAECaAEDEAGAeAHH.MBDBGCEBSCEBhAAAREBAOCABdDGDLEEBhAAAAEEB.fEGAhACAbFFAFHAABHFAYGAA....hAGA......hBEA...,2,-4,-4,0
WCQDdfZKMcGLXaJYbFHRIPBVTASOgeUEN,OAAAeAAAEADA..CADAdAFAZAFBMAIBGBGALCCB.aCEBbBBChAHAHCGBRDDA.BEFDAAIBSEHHhBAAUGGA.QFBAhBFAKFBDJHBE.FFFB.IHHA.hAAA......hABA...,2,-7,-5,2
BUHMCDbZdWYcTQJReNgAKEFIPVSXaGLfO,EAAAFAAA....IADASACA.GAEALAFABAGAHCCAhAGAMAIBbCFBdCCA..hAAA.cDABTFEARCGBeEDFhADAACIBKDHDXECCaEGHOFFHDFIB.YHAAhAHAQGAA..hAGA...,1,-5,-9,4
bUBTGNAdSgXKfDJWPFEaIQeYMZHLOVcCR,dAAAXAAADADA..JAFBFADA...EAGAaAHBeBCH.ZBFEHCAChACALDEAOBHDCECARFFABDEDhBAAGGABABEB..KDGDhBCA.....fFFEIHHAMIDAhAAA.....hBDA...,2,-44,-3,41
RNdYUCJQEPAfcSOKMHITGBVFWXgDaLZbe,SAAAMAAAHACCGAFAFADA..XAFDaAHFZCCARDGF.dFAACAHAEBCFhAAAABBB..OEEBhAFATDDABGGD.WFHHhBAALDFB.eCHF.YECF.hBHAJFHB.fHABhABA..,2,-11,-9,2
QUZNXdLEJbAYSgBKaeRfcODITVWMFHGPC,SAAAKAAARACF.OACDTAFA..MAEAHCABGBEAQCFBhAAAZBGBdEBAEDEBAAAABEHAhAIAeCHHDFABIGFAhBEAFECDCFGDNIABXGBA.......hACA......hAEA...,2,-14,-9,5
gSMfXCNOGPBYFUeTEAbDadVcKJIQRWZHL,aAAAdAAAKADA..QADARAFFHCACLAHBMAGB.CDEA.GCCAhADABECAFEFDeAHB.ABBBbCGDhAIADEHB...VFEBIFAAhACAZFBFfHGF..OFHDhADA.PHCA..hAFA...,1,9,-27,36
EMTWDBVNSKaAYJePLZXGbFIQCHOfUdcgR,eAAAZAAAGAEAFADD.QAGAHAFAOCCBdCAARDDBECGA..MCCBhABATDEABADB.SDGAhACAAAAAPDHDbFAAfFGAhAGAUGFA.gGDADHAANIAB...hAFA......hAHA...,1,-2,-4,2
cDYdQCPHGNZIJWVBXeSbMULgAaKOFRTfE,aAAAFAAARACF..EADADAEAdAGA..QAGAHBEBZCCBJBBFBBEAeBHHhADAMCGBLFFA.hBAAAEEBOGBATEDAfDHAhBIACHFA.PFHDIHHA..hAIAWHDA....hCAA...,1,-1,-39,38
CPLOYHSfXFNKeDcIAGZEWRMQJVBbUgTad,EAAARAAAMADA..QACABAGAUCCAaAEE.dAHALBFAHCDCXDGAhAAAKDFADDIBAAAAZEEA.hAIAVFAA..bEBCCGGDOHBEhAFA.SCCDFFFAeHDAIHHAhBEA....hCAA...,1,10,-29,39
ENXYBQPJIfcUaCKgFGWAeOdVZSRTMbDHL,eAAAdAAAZABBRADA.MAEAHAGBLBEAECCB..XCEDQDCAhAIAIEAAUDGAaEEDKDHBGGABhAAAABFA.SFFAhABAbGEADGIB.BGHA......hAEA......hAGA...,1,-7,-14,7
TYFBWEDGNaIXgCdcKOALRSVUfQZHPbJeM,RAAASAAAUADAZAFB.HACB..JAHBeAEA.MAIBFCCHBDHAhAAAEBGFGCEA.aDGD.hABAXEAAdEEAOFBAhBFAAAAAfEDEQGFATGGADFIB...hCAA......hDAA...,2,-29,6,35
fgYQcFKSDIWPHLRATEaVUbZNGMJXdeOBC,EAAAaAAA.UADAZACBGAEA..MAGBdAGBeBGHCAHA..fCBAhAAAQEBAKCHBDBBBhBAA.IEHAHDDAABCAbEGDhAHAXEECBFBAgFDAFGGA.SHCGhBFA..hCAA...,2,-23,-8,15
HbYdBMKIeTCQLEPDRcWXaOUGgAJZNFfSV,ZAAAFAAA.SACEHACBdAEBMAHBKAFA.eBEHQCCBLEFAEBHFhABARGCA....XGGAhAIAaCEDGDFAABIB.fFAAhAFA.bGCABDGDCHAADDIB...hBAA......hCAA...,1,-4,-17,13
ZFdaPGTDQJVbScCUOfeBLEIKRAWNMYXHg,MAAAHAAAZADBdAEAGAGATAFA...QBBAVCGB.SDCAhAGACAHBOCABeCCDhAAAEDFBRFFAAAIB..NCFAXGFAhACAaEBCDDIBJGBA.........hADA......hCDA...,1,-8,-11,3
ICOfgLSVDUYbecJMZadAETNQBGPRKFWHX,EAAATAAABACA.RADF.FACAHAFB..CAFAOAGDLAHB.DCCBUCCAhAAAeDDBMAIBdEHAADFBGDFAhAFAKFAA..XFFBhAAAfFCA.SEHBYHBA.bFDDhCAA......hCFA...,1,-10,-23,13
YPTBfAZDIKcOdSGQENMCWJFReXagLVUHb,ZAAAKAAAdACAGAEA.EAGAMAEA..CADBFBHDRBDFeAHF..aCAALBFBhAAAHDDB.bEFATFGAhABA.ADDBDDGBOFDBhCAAQGAAJHEA.......hCBA......hCIA...,1,-8,-23,15
UTWcfXeCVFOdDIGNHARBJSPMgKEYLbQZa,RAAASAAAMADA.EADALAHB.ZBDBaAFDUCFA..TCCAhAAA..fCCAhAAAeAHBFCGDdDAAGFDBhABAHECCABGABEHAgFGAKGHB....hABA......hADA...,2,-18,-15,3
QIPdSYZTfWceREMLDaAVXOgUNGKbCFBJH,OAAAUAAAGADAKADA.FAFAHAFB.QCCAdCGAZDAA.TDGAhAFA..fEFEhADAeAHBEEFBMBBBaDHDAAIBXFBChBAAbFDDBFHAIHHASFDH..hBCA......hBDA...,1,2,-24,26
XaSTUPVOJcBMHfDLZEbYRGQAKeINCgFdW,eAAACAAAdACA...aADDSAEAUAFA..OAHFBAHAHCDAhAAALDBAECBBRCGFAAAAKDFA.hAEA.IFAAFEHDTFBAhBDAPEFB.VFCBMFDADEIB..YHDAhBFA....hCAA...,2,-26,-13,13
dJCcWgDEZUeAXKFHRBOLfVQIMNbTYGSaP,FAAAHAAARACFLAEBQADC.MAFA.TBFAGAGA.aDEEdBHAhAAACECA.gCAAhACAZEFEAAGBBGGAfDDAhCAA.IEFANIAB.bEGD.SFDHhDDA.....hAIA...,2,-33,19,52
NMBdTbYZWfGOCJeHXIEKQFSgUcDPAaRVL,RAAALAAAMADA.dAEA..TAGAZAFBGCAACBDA.HCCDEBFBQDDAhAAASAHHgDGAhABADCCBACIB.aEEBhACABDGA.bFEAfFFE.eFHFhBEA.KHBA.FHDA..hBHA...,2,-22,3,25
egdQSaLURbKfOGNXMTWBFHEZYDVJcCAPI,eAAAdAAAaADARADA..KAGCGAFA..MBIBTCBAFCCBHCFBZDEFDAIBhACAJEABAAHB....IDHAhBAAQEDCLEBAhBCAbFGD.OFHBWFCDBHDB...hBDA......hBEA...,1,-11,-17,6
IVGWKXTQdYbCFAOZMPNaSJELcDHeRBfUg,ZAAAMAAAaACA..EADALAFAHAFARBBBBCFDUCCB....ICFAhABAGCGAXECAhAHA.dFFAbCGDACIBNIABSEFDhAGADFIB.eHAA.fGEEhAHA.....hAIA...,2,-15,-15,0
cJCXDbNdKHfZLReaOTUBPYWEIVQGgMAFS,SAAACAAADACA.dADAHADCZAEBLAHBRAGFeBCB.OBGBBCED.hAAA...PDFDhAGAECCBQEECMCIBAEEBFFHHhAIAXGGAKHEA.aDBH.YHBA.hCAAIEHA..hAAA...,2,-21,-21,0
XLfWSZQHeAVRFcTYgMBNPDGaEJKOdbIUC,RAAATAAAMADA..BAGADACAGADB.EBHFOAHD.dBEAbCCBhAAACCCALDGB.hAGASECAHCFBAAHAFEEHhCAA.gGGAaFEDKGCBIHHAfEHAhDAA......hDBA...,2,-30,-10,20
YQXZfRKGDEISAdgJMCTWOUPLVeacBbFNH,dAAAMAAACADA...TADAOAED.LAGBeAFEBBBAFCBDHDCBhACAQBFDZEEB.RDCAGEFAhAIAEDHFAAIB...gGDBhBAAUGGAaDAH.NCIA.fGBAIHHA.hBBA......hCAA...,1,-10,-12,2
HXRCaKOPdcgVMQYGBLWEJTeIfbZFSDUAN,HAAARAAAKADC.dADA.VAFAMAGB.GCCALCCA.ECABeAHB.hAAAIEFAZDEEDCIBAFAACBEA.hAAAaFAEOCHH..hABAgFFAQGGABGDAWFDH...hACA......hAFA...,1,-11,-15,4
LNHURKdYPMIgWDJXBGSOcZEaeCbVTFQAf,LAAAHAAARADFdAFAMAEA..IAHADAIBBBDAGCGAOBEDECABhAAAeBGBCCCD..bDEDTCAAhABA.ADDBUEEBhACAKGDD..YFHB..gFGHhBHA.XGDAhCAA...,2,-26,-2,24
EHKNMVLPIRWQZdbgYJTeGOfFABDSacXUC,SAAAaAAA.UADAHACB.MAEALAGBRBEFZBGBdEBA..hAIAbCCCgEEGhBAA.TGDAeCHHGEEAhAAAFGHBABBBDCIBCBFBEGHB.NDBA......hBEA......hBGA...,2,-13,-6,7
WGaZdYBeAQRbDMFCPcfJELIOKSHUgNXTV,RAAAMAAACADB.....fADAEAFALBHBKAFAHBBBUCCA.XBGAhAFATCFAGEDBhAAAdDEAeDGBAFAA.QECAhAHAFFCHJFHB.SFGDNIAB.aHDA..hAIA......hBAA...,2,-12,-7,5
BYZeDMHWcICdgKbfGQSJPLFUOaVTXANRE,EAAAZAAAeACEHACA....IAGAdAFAbAGD.GCCB.QCGChAAASCCALEAAhAEAODECaEGETFEAhAFAAAIBBFFDMEIBCGHA.fHFF...hABA......hCAA...,1,8,-31,39
WaVJHGNbgFTXZBRDUdefIQEcPCMYOAKSL,LAAAaAAAHACBGAEB..bADDTCEAZAFARCABdCFA.eCHBhABAQDGAEEEB.CEAAMEEBhAEAAAGASEGHhACAVFFBgFAABCCCfGHAIHCA..hAFA......hAHA...,2,-6,-2,4
RYTGbfFEUPNIOcdQZAMgCHVWeaJLSDBKX,MAAAHAAAeACELAEABAFBRBBAGCEAFAHBECCA.UDGA..ICFAhAAAdDDCAAFACBHA..aGCADCIBhCAA.XDEC.hAIAbDGDfGGA..OFFH.hBAA......hBBA...,2,-21,-12,9
XNSKPUGEObJaFIQWefTgcZdAMBYHDCVRL,MAAAHAAACADBRACA.LAFA..SAFBKCADGCCAEAHBbCFAaBBHhAIA.QCEChBAA.eCGHTEFAZFFAADDAhCAADCFANIDB.OFEB.FFHD.fGAAhAAA.....hCCA...,2,-13,-2,11
SFRNbKMVOPCHZTJXWfUDGaBIQeYdgEALc,LAAAFAAARACF.KAEAMAEAOAGDHBEAZCAA..TDFA.JEDBhAIAfCEA.hBAAGDFAaBGAQFFBhCAAeEABdEHAAAIBSFHHNECAPFEB.CHDA...hCBA......hDAA...,1,-9,-13,4
AQRZgFCYOBUWXKGEMPHbcdaeSfINTVJLD,RAAAZAAACADB.BADB.UAFAKAFAGCCA..ECAAHCFAdBHAeCDFhABASAHB.IEHAhAAATEEALEGBhACA.AEIBQFBCFEFHOFABMFCB.hAIA......hBFA...,1,-20,-22,2
JPgfaDWBeFQbLVNGUTCKXZSdHAMEcIOYR,EAAAOAAARACA...JADB..fAFBDAFABAHA.eAHHFBBHLBFBhBAAGCCBTDAAhAAAKCHB.ZDFEHEDAACFAMFGBhADA.IFHAgFGAaHAA...WFCDhCAA......hCFA...,1,6,-38,44
AMHPRCEdgBcLUaSZDOeVIKYWJGbXQNfFT,HAAARAAAEADE.dADABAFBLAFA.aCACZAGBeCEAKCCA..JDEBbDDC.hAAA.QFGAhABAFCHDAAGAMFCBCDHA...gFFAhAAASECBDFIBOFCH....hBIA......hCAA...,1,0,-32,32
cMJGgVNbdHPBQRUWLOYKTAXCZfDeSIFaE,ZAAAeAAAFADAEADA..MAGBGAFA.VCCAdAHAHCAABAHARDGFLCEBhABAKFBA.ADEBCDGASEFDhAAA.aFHDgEGAhACA.PHBAWHAA....hBHA......hCAA...,2,-25,-12,13
RSMYfGLPEOTdgcbJICQAHUeNZBaVKWXDF,HAAAeAAAZADBaACAKAFADAGA..RBFA.MAIBGDBAECCA.dDHA..bCEACBCAAAAAhBFA..BEEA.XEGAhAAASDEHLFAAhAFATGEAgGCAIHHA.QGGChAHA....hCAA...,1,-2,-21,19
ZaNRgbTOYSVcLDIfXPGAUHBECFWMdeQKJ,HAAAEAAAFACDdADA.eAFAQAEAZBFERCAA...TAGASDEAhAAALDDADDHBXEDChACAACEBCCHAMEABKEGA.aFDAhAAAbFAB.OEHD.cGFAfGGAhAEA......hAIA...,1,3,-22,25
PHgVOMLdUIQJZSNWeTaYcCRFEGfXKDbBA,HAAAOAAAdADAUAEAQAFAZAGB.SBHBeBBA.aCACCDDAEDFBhBAAGCEA.KDHDbEGDhBBAADDA..VFAALGBAhBGAIGGANBIA.TGDA.....hCAA......hDAA...,1,5,-19,24
EWRcVIZUOLDJgXBAFdHKNMeQCbTaSGfPY,HAAAMAAA.eACEQADATAGA.GAGA..fCCAhAAAEBBBRDCAIFBAZCFALEDAhAFADDGBXFDAAEEAdFHACGAAhAGAaDHDSGCA.PHECcGAC.hAIAUGGA....hAGA...,1,12,-7,19
NIOBcTFHeGPERWZgSKMbfQJXAYUaDVLCd,aAAALAAA.dAEAOACDBAGAFBHDHAEAGCAARCDFZCFBKCHB.MBBBhAEAQDCC.hAGAACABDCGBCAHBIFHAhBAAeEFAEFDFSGGD..fFHAhABA.XGAAhACA...,1,-14,-23,9
BTVCdPeGRAbaEOXJYQMUHZfNSKcDgFIWL,EAAAXAAA..QACAHADAZAGBSCDADAFAFAHDLBEBhAAATDAAdDDCGEEAhAAAABGBaDGAOEGBMBIBfEHEhABAKFHB.gFAABHEACHHD...hCAA......hCBA...,2,-22,5,27
MBdSIJPbVUQWfNEXCcHYRAFeZGOLDKTag,eAAAGAAALAEAKADA.aAHDMAFA.dBGASBCHJCDB.hAAAbCEBQEFAhACA.fFCEhADAEDGACEDAHFAAABIBOEHFTFGABGDAPFEB...hAAA......hABA...,1,-12,-13,1
HUFIOMYRaQSNZdfEALCDgBVTcKJGXbWeP,LAAADAAABACA.TAEAKAEAGAGA..bAGBeBBB.HDCBhAEAFCAAMBIBREEF.aCECQGAAhAGAZDDAEEAAAEHBCFFDgGGAhAIAJFHB..XGCA..hABA......hACA...,1,-9,-14,5
eZRQSfJNDWaTgEGIcYCKFUAPHOXbdBMLV,HAAAXAAAdADAMAFALADAZBEB..RBGB.QBGA.fCDAhAAADCABaCCCEEFFGCEAhABA.IEAAhAEACEHAFGDBABIB.bEGDBGGAeDCD.SGDHhAFA.WHAC...hAAA...,2,-25,11,36
KaOIZTgWGHYeNBJVcfdUbFDCLMQARXPES,RAAAEAAAKADC..aACDZAFB....TAEAGCCAHAGBeAHFBCBDhAAAVEFAdDDA.bDEDCBEA.MDIBhAEAAAAA.SDGDhAGAOFEB.IHEA.YECF.hCAA......hCCA...,2,-30,8,38
dKWRBcTgYHDCeJUPIFMEZVXfbQaLAOSGN,GAAAdAAARADABAGB..TADAHCACeAHHUAFAFCDHZCFF...fCHAhAAAaDEBADIB.SDADhACAKEAA.gDFDhADACFEAIGGAEFFB......hAIA......hBAA...,1,-20,-28,8
JdVAYgNSUHZfEKWLQDRBFCbMIPeOcaGTX,...NAAA.HAAAZAFA.EADELBBARAFFCAHB.MCFBeCAA.aCEHGCGAhABAJCHB.AAGA..SDAHhACAKEFBQFAAhAAAFDDBbDBDODDH.cFGDdGFAgGCAhADA.WFHHBHCA.hAEA...,1,-4,-11,7
ICRgXVLFMYcOTHfSNaBZPbUKQGJedEADW,DAAACAAARACA...XABALAFBFAEA..MAHBOAGDHCAASBDHhAIAaCEBZDFE.UDGBhBAAQFGAeCCDABIB..hAAAIEEA.gFCGcGFCNIAB.bFGDhCAA......hCBA...,2,-25,-13,12
TMHUASJPgOXbQcDdKGYBaFZeICWRVNfLE,SAAAJAAA.OACDQADC.dAFAGAEAaAHBeBHHhBAACAGARCGBVEAALDDAEEDEHGEAhAAAACCB..XEGAhCAAbGAADAIB.BFDA.FFFH.IHHAhCBA......hDAA...,1,1,-22,23
TACFeNKfaSDWIUdBRZHgQJXEcOPGYVbML,eAAAKAAA..aACADAEAUAFARAFAHBCA.QCGAEBCF.ODEBhAAAGDDA.VDGBbEBBLFFAhABAAAIBFFBB.SFDDhAIAdGGDBHBA.JHFA......hBEA......hCAA...,1,-1,-25,24
LOGRIKbBfEPDJYeQHTNaFXgWMVCUdAZSc,ZAAALAAARAEAKBHB.BAEA.EAGADACA..eBHFHCCC.aCFDXCAAhABA.MCFBCDHDAAHAOFAAhABAGDCAbEADJFFA.hAFATFGA.FGEB.......hCAA......hCBA...,2,-34,-2,32
ZdIeVNDWcLMKgSHQJYGTfRCOBEXFPbUaA,dAAAeAAADADALAEAKAFA.HBCAQBDCGCEBREEBBAHBEEGAFFAAhAAAUCGAAAIBZGAA.IGHAhABAVEEB....hAFANCCA.MIFA..SFDD.YHFGhACA...hAGA...,2,-33,5,38
KbZQACYOWdMRHVSIBgNUTJeLFDGEcPfaX,OAAAdAAAHADA.SAFEBADAUAFAeAHHLBHBGCABEBBB.hACA.fCFAhADAKCEDZDFBADDB.CDHAMEEBRFBA.gFFAhBAAJFHBDIAA.aFCB......hBCA......hCDA...,2,-28,-4,24
aQbAKOcdMLWGFRgfINCZXPBDeUHTEVJSY,OAAAdAAAMADAGADARAFA....IBDAZAFABBBD.eCFFhAGAHCACECHBSCFAhACAaDBAAAHALEGBFDEHfDHAhAIACGFCDFIB.TFCA.VGEA..hBAA......hBCA...,2,-17,-15,2
SCQDKHWENRPUZcOXfAGgFYLMBTVabJIed,GAAAFAAAMADABADA.aAEDJAGB..eAGBdBDA..QDEDhAIAHCFBECDBRFDAZDGBODAHhAAAABFBLCCD...hACA............hADA......hAHA...,1,-18,-34,16
fNYEcJIOTZGSBXMdHLVePDbQCWFAgUaRK,aAAARAAAKADC......fADAEAFAJAHB.TAFAGCCAXCCAhADAHCFBeDHHbCED.hAFAQGGBFBHD.hAHAAAAA.gDGG.UGGAcFDDOBBBhAIA.....hCAA...,1,4,-21,25
aXWdUbfZeBJYDAFKcORgHQSIGTCENMPLV,KAAARAAAHADBQACCGAGAECCB..MAEALDABaAGE.dDFAUCEAhAAAZFBBeDHHBCGADCIBhBFAAAAAOEEHSDDDhCAACAFA.PEGDXGGA..WFFD..hCBA......hDAA...,2,-29,11,40
HGPUWXVTCaBOAIZecgRDNQSJdKFfbMLYE,eAAARAAAQADCdAEAFAGA...MAFAEBCAHBFBGBFAUEDA..hAAAXCCCTGFAaCHDhABAAAAAZEEFDFFASBHBhCAA.fEHAYHCA.PFCB.hCAACHEDBHHA...hCBA...,2,-12,2,14
OLTSHRCgNXdWYIGKbMfZEFeAQcJVaBPUD,QAAAVAAA.aACEBADB.DAFATAFAHBDCRBGF..CAHBXCDAhAAAdDDA.ICHAhADAbFEAZGBA...EDCBhAFAAAIB.PDGB.OEEBSGHHWFHH.hCAA......hCDA...,1,-18,-24,6
ZOaUJgVQbILfdBeNWRCYGDEFHAcMKTSXP,MAAATAAA..XACAZACBOAEC.UCEAVAFA..QCGAhAAAbCCA.LFFAhACAdDGAeEEBRGAACEDDGFABhAFAEHFAAAGA.SBBG.aEHD.gGGGhAIA...hAIA...,1,2,-13,15
aBEWgCLHJdGSUDPZVIORfMcbeAFNQKYXT,QAAAXAAABADAEACA...CAFAHAGBGAEADCDAZAGB.OCDBhAAARDAAMDDAeCHH.AAGBKEBBhBEAaDGELEEBhAAAdEEDSFGAPFABIHHAfGGA..hABA......hADA...,1,-2,-22,20
YENHKCdcBZIUeAGQPROSaJWVgLTFDXfbM,GAAARAAAOADAaADA...JAGBVAGB.LCCATCDADAIB.hAAA.bDFAEDCB.HDGBhAAAdEBAZECBeEFDAFFAQFGDhABASFCAFGABMIAANIDBCHHBBBDA...hACA......hAGA...,2,-5,0,5
TfXGIgBPOMeHbJKadVSYRLCAZcENUWQFD,EAAAUAAAFACDDADA....TAEAGAEBBAGBMBDBHCDAKCEAdCHAhAHASAHHLECAADHAZEAAhAAA...cEFAhAEAQFGA.XGECgGCA.hAIAeFFB.aFHD..hCAA...,1,-14,-23,9
QVETGHXcbeKJPZDROWUFASIgLdCNaMYBf,SAAALAAAdAEACADA.aAGABAFA..QBGCEAHBHCCAXCFBhAAAeCAAKDDAZEBARDABODGDhABAFDHDACAA..gFFBhABAMDIBfEEATGCA.cGGC.hACA......hBEA...,1,-7,-12,5
PCAGfXNSJIQBFLadMYZHDeOWUcVRgKEbT,GAAAXAAASADA.QAGALADAdAHAZCDAHDGBhAAAeCDAODCBUEABREEBEGAFhACAbDFACEAAAADA..fGCAhAGAIFFAaFHHMIDADEEB...cGDChAAAKGHB.....hBAA...,1,12,-15,27
TYVSBNOcbdKHIAfFGeXgUQaZWDJLRMCEP,GAAAeAAAUAEAZADADAEARAGB...EAHBTCCA..SCDAhAAAODBBdDFAHCGBAAAAFDHDhAIAQECA.hBDAaEFHLEEDMFIBCHGA.......hACA......hAIA...,1,-14,-20,6
GbPeAadJDEXYMFUSKcNIBLTCVHQZfgROW,dAAAEAAA.MADAFACDKAEA....IAHATBGA.HBDAZCDBREABGCBAhACA.eCHBAAGAaDGChAAAXDFCUFFASHGAhAEABFGALGBA.CGFD.....hBAA......hBCA...,1,-11,-22,11
geIJPUfQBXZWHTAMSOLYFGRabVKNEcdDC,MAAALAAAGACBRADF..aAFAKAGC.EBBBdBGDDBIBeCAB.JCCFUCFAhAFABCFDZDCB.HFDBhBAAADHAOEEAFFFA...hCAAVFGBCGHA..........hABA......hACA...,1,-13,-24,11
cRIUgfDJaMKQTYFZXdCbeVEPALOBSHNGW,LAAASAAAHADBGACARAFAUCAADAEAMAHBQCGA.FDDHhABAdBEA.eCFHEEGBAAFABDHAhAAA.NEEA.IHHAhACAfFGAaFDE.TGBA...YFHBhABA....hAIA...,1,-4,-25,21
BSHOGEeCgZNfQXdVFTUYJbWLDcRMIaPAK,SAAAHAAAEADEeAFEZACB..QAEAdCADTBFAUBGA.JCEFhAAAbDCALEGBRDGB.hAAAaGFBACIBOFGH.hABA.CHAANEIA..........hAHA......hAIA...,2,-18,-4,14
NQbMgXECeWdfDRITGOLJYaKPZFcVSUABH,HAAAQAAAMACAEAFAeACA.dAGARBDBGBGALBFD..aCCHZCDFhAAAFEFBSBHHhADAAAIBBFCA.bEGDCFHADGGBOGDAhAIA............hCAA......hDAA...,2,-18,-10,8
MRGLXYDcAUWQSFBPgeCHIaOZTNfbdKVEJ,QAAABAAAeACAHAFAaACE.ZCAA..TAFA..bCEAdAHAhAAAEECBRCDAGDAALEEBhAAADDHBAAHASDHHhACAFEFBCDCDOEHDKGGAMIDA.cGGC...hADA......hCBA...,1,3,-14,17
BCPYKaDcNHORUdLWMZTeQVGbFEfIJSAgX,BAAACAAAKACA.aACA..DAEAHAEB.RAGBdBCAMAHBZDEA..eBDAGGABhAAAECAA.JFFB.AAIB.XCEAhAAA...hAGAPDDBNDIA.LEHB.TFEAhACA......hAIA...,1,-17,-36,19
RHgTKQZLFDVEYSOAGPIdCNfJMXBeUcbWa,GAAAdAAACADA.JADAMAFABAGB..UBFA....bBFARCAAHDCChACAKCDAZDCALCHBhADA.DEGBEDGBOFCBhBAAAAABIGFA.fHDBeFFD.aHGE.hBCA......hBIA...,2,-26,-18,8
fLbCEYBFUNMOAKSTQWRDHcgePdZXGJVIa,TAAARAAAHADBeAFA.ZCFBGACA.IAEAaBHDLDAAhAAAEAGAFBHDMEEBACAB.QFAAhABADCFB.gFGAhADAdEEDXEGD.fGAACHEA.hAFABGCA.NIEB...hAAA...,2,-25,9,34
NQHDVfBCabZKEMGTOYgAUXIdWLRFecPSJ,XAAAdAAARADAFAGA...eADA..SCAAQAGAHCEAhACAfCDAaCGA.ZCEBhAAAEDCFGDAAOEABAADAIDGAhABALEEAPFHDDDIBCFGAbGFAMIEA.hBIA......hCAA...,2,-7,-7,0
NEfCTGZWdHgJaKPFMXDUVQScILeAbYROB,RAAABAAAEADE.CACAZADBHAFB...aAHFFAFDMCCBDAHB...QDDAhAAA.SDFAhABALCABAAIBbFAAOCCHhAAATFGAdDFAKGFDXEGD....hACA...cFEChCDAeHBG.fHDB.,1,17,-42,59
DBJPbgZcUOLAIeXCVdEHfSQTaYGWMFKRN,eAAACAAAdACAHAEAQADA..aAGAGAGAMCBB.RCCBBAFA.hAAAbEFAZCDE.OCGDhAEAAAAAXFDDEECBTEEAhBCAFGGBDIAAgGGA......hCAA......hCEA...,1,-8,-12,4
faBSCXZUPIWKbEDeFYVcGOdLQRTMgJNAH,HAAAaAAABADAXADBZAEB.UAGA..IAHAKCADECCBeBEHhAAAFBBH...VDFAGCFAhADAdGBALFFAhACARDCBMCIBNHCB.AHHA...CGBC..bFGDDIDA....hBGA......hBIA...,1,1,-16,17
ERKIVPFceLBGWOQYMNfCdXgAZUJTbHaDS,ZAAATAAAHAEA.aAGAEACE..RCAA.KAEC..ICGAFAGDeBHHGDEAhABAQCCAMCIBCEADhACAdDFAACEB.bFCBDEHBSEHHhAAA.cGGCBGGD.....hADA......hAEA...,2,-16,-4,12
aHdOcUZbKXLJSEWQGTIfDAMNeCPFYRVBg,eAAAFAAARACFBAEBHADAdAGA.OBHDZAFBKAHBLCCA.EDFFGCDAhBAA..TEGAhAAADCHBADIBMFCBCFAA..hCAAYEEFaFFA.cGGCXGEA..hCBA......hCFA...,1,-3,-35,32
STOaIHXReJLDFQMZcfdgBAGCVWYUbENPK,GAAACAAA..VACAUADA.EAFAKAFCOAHDHBFCRCAALDDAhAAA.QEGAhACAZDEAdFDAAAIB.bDBDSFFBhAAA.aFHDeFDEDIDA.MHBA....hBAA......hBCA...,1,-4,-22,18
dDNEYMecKIfObJWLCAgTFVPSHRGXBQUZa,TAAAFAAA..SACHHACBRAEAGCEBQAEAaAHD.dAHAECABhAAAeCDFKEADOEEBhACA.bFGBLDGBhAEA.ABGAgEEAPHAABHEADDIB...hAEA......hAFA...,1,9,-23,32
RLQSKIBEVADNWHcbUfXgMCPdaeYFZJTGO,DAAAHAAAUADAXADB.MAGBdAGAeBBBZBGBGCABRDDA.LEEBhAAAQDGCKFBAEGGAhACAAAIB.NIAB...bFBBCFDBaDHDhAHAFFFH...........hBAA......hBCA...,2,-34,12,46
MLAPSRcdQDOeNYWbEgXZaJGFIHfBUTCKV,RAAAdAAAQADCeADA....NAHA.bAFBEBFFZBGBGCAB.HDFBhACABCCDCEAA.MCFBAAIBSECAhADAODHDgEDDhAAAaEHD.FGFDIHHA...hABA......hAIA...,2,-18,-8,10
DPIZMSAcaHXLNKdWFEfJYTbCOVGBQUegR,HAAALAAAdADAEAFAJAEA.....bBFAOAHDGCABQBDDhABAeDEAREFA.DCAAZFAAACGBaDEChACAKGHBFHBC.fFDBhAAATEGABFFD.PHAAMIEA.SGHHhAHA...hACA...,1,9,-20,29
LKQgaVcUZXDPCAbeYIRGBEJWSdMOHFNfT,eAAARAAAEADE...SADAdAFAHBGBFCCATAGALEEB.QEGBhAAAaCCAUCGBZEAAhAAADAIBAFDAbCED.GEGAhABABGGDMHAAfGAA......hAEA......hAGA...,1,-6,-12,6
SFKfZaQVJUAINPdXELBbgeTOMWRGcCDHY,..IAAAdAAAEADALAGBBACA.eBDAMAEARCAAGDEADAIBHBCChACAFDHDZBFB.QEGAhBFAUGCAAAIB.XFDAhCAATGGA.OHCCCEDC.KDDD.aGGC...hACA......hADA...,1,-5,-10,5
NKdIYCVQaeLWfEFJgAPDRHMSUOcBGTbZX,RAAAHAAAMADAOACA.GAFAZAEEKBHBdBHACCCA.aCCALCFB.hAAA.EDDBFDEBAAHASDFDhBFABDHD.bEGDXFGAhAAA.IHFA....hABA......hAIA...,2,-38,-8,30
bBAHRNfgLcEVTQOPaFIWdeKMDZGJXCSUY,HAAARAAA...fADBLADBEAFATAGAQBGA.hAAAaCCBFCAHdDFAeCCAMEEBhAAAGCFACFAA.SDHBhACAbFCDAFCB.gFAAOFGD.IFDAhAFADFIB.XFGDhAGA..,1,5,-18,23
SeEMABNGabVXRCDfTKcQJZHWOYPgLUdFI,GAAAaAAA..XACDRADADAGAKBGA..QAEAHCDCODAHhAAAPAHBLDHB.hAEAdEEDSBBDhAIAEDCBAEHBBGGDbDDA.fDHA.TFDAhBAA.cGBA.WFHHhBGA..,2,-19,-5,14
HUeRNSfcGAEKFILMaYZBbgTXdPOJVWCQD,EAAAFAAAMADAZACBBAEA....TAGAdAGAOBHDJBCB.CCBCHCEBhAAARBEB..SCHHhAIAGECAACEBLFGBhAIAbEBAXFFA.PHDA.....hBCA......hBGA...,2,-19,-15,4
HLSQMNfWeIaOGcCJZTPRgAdEKXbVUYDFB,EAAAXAAAUADA.FADAHAFA.LBCDMAGB....fAHAhAAAeCFAaDDDGEGAhAAACBDDZDDAREGFACFBbFED.DDIBSFFDhABANHAB.OHAA....hAHA......hCAA...,1,4,-26,30
ZbJDGBeMPOcfCKQaIRYTWLVUENdHXgFAS,ZAAADAAAeABAMACA..OAEECAEA..aAFDRCCA....TCGAhABALAHBEEEAHFCAFCCAABHBSDEAhBAAbGFA.hAHAGEGABEHA.fFDA.KGFD.hAIA......hBIA...,1,-11,-27,16
GIZRgWfHUdMQeKSaNTJLDbPBFVcAECYXO,EAAAXAAAGACARADA.....fAEBHAGBdCDDeDABaAGATBGAhAAALEEADCBBbCEDhBCAFFHDAAAA.OGAEZEGBgGDAhBEAMGDA........hCAA......hDAA...,1,-3,-9,6
BWdXeDGHJQILSNZKOVUfAYcPECFRMTagb,...PAAAEAAARACAaAFABADA..dBGDeAEHHCCCQAGAhAGALDABZDFBOCCBUFCAACGBCDEAhBAAMDIB..bDGDDFHBhAAA..IGEAKHEA......hBIA......hCAA...,1,-4,-29,25
JVRATNUZGDfOPcQCYSaFILgWeMKXEbBdH,TAAAZAAAGAEA.OAGFQACC.SAEBaACALDDBhABAeAGBMAIBECDFdDFAhAAAHDFBREGFAAHADCCB.fFHAhAGACEECFGCA.IHEA....hCAA......hCBA...,1,-7,-14,7
DJaTFSIMQOWcgeRHYBALXdECVKZbGUNfP,dAAAEAAAKACAGADA.UAGA..fAEBDCCB.aAGATDFAhACASBFAMDABQFBAhADAOCCB..hAFAgCGAHFDAABFALFHBCDEAbECDPFFAhAAA.FGHDWHDA..hBAA...,2,-13,-6,7
NXBPbCeASgIQMRYLaKVEOTJFcDWfZUdHG,SAAAQAAARACALADAKAFC.EAHBTBGAFCCA..DCFAZCDBhAAAHDEAGDAABDHBbDEDhADAAAAAMEAA.aFAAODHDhAIAJFGB.fGDEdGDA.XGFAhBIA.....hAEA...,2,-18,10,28
QWLYHKCMTNEBGVFbgScfAORUZJadDeXPI,RAAAZAAAdADAeACE..XAFAQAFCLCCAHCCCMAIB.hAAAECGFGCFAFEFHbEGDSBHHhABA.AAFAOEEBhAIAaHAADEIB.IFHA....hCAA......hDAA...,2,-25,-1,24
dUgVKDReaJWQCTOXcIBbESYFfLPZANMHG,HAAAdAAAUADAKADCRAFA..eAFAaCAC..QCCCTCBA.OCFBhAAAXBGABCHAEDEAFEGAhACALEDAAEEBGGABDDHBhACACFGD.IGAASGHHfFHA.hAGANIEB......hAIA...,1,-7,-12,5
LQFdNROWbVAEYceGMKZHBCISUPfDgaXJT,EAAAeAAAGACAZADBHAFACAEA.UCFBDAGA...aCCBTBFALFFAhAAAdBHAREAAODBH..hABAbEDDAAHAMEEBBCBDSFFAhAAAfHFB........hAEA......hBCA...,2,-21,-5,16
bcEIDQgCOZUFVNRGdMBKWSfPeYHTXLaAJ,JAAAEAAADADA..QADCOAEE.ZAFBFBCBRCGF.dAHABAHA.KCCDhAFASCEA.hBAAeDDBHEDALDHBhAAAAEIBIGGACECDVGEAMFCB......hCAA......hCBA...,2,-29,-19,10
LbDOUSdZaPINFTfCYGXAHgEVQcKJWBReM,HAAAEAAA.QADCKACABAEBRAFFeAFE.bBFDOAHD.dCCAaCAChAAA.ICHAFDFHCDHDGEDAhAAAACFBVEDB.cGFBhACAMFHBLHAADEIB......hAHA......hCAA...,1,10,-22,32
gGLYDMKEIUBbVZfJXRSFcNAQPHOWdTCea,HAAAdAAAeADAGADALAHBMAFAEBFEBBFAZCAA..XCAAhACARDFAFFDAABHAQGGAhAAAODCDTEEAaGDCDICA..hACAKEAB.bEGB.fGDA.SGGDhADA...hADA...,1,0,-8,8
RXMEIfdKBbYgHQVUAFaecCGDSZOLJTNPW,eAAAGAAAZADBLADA.TBGAPAFCRCDA.EBCFdEADBCFA.hAAA.bDFAHCGBUFFAAAAAaEEBhAIADGIBOECDJFCBXFFChCAAMIAA.KGHB........hCBA......hCFA...,2,-12,4,16
LfPgCQGIONUSEHYFWBDbVecZTXRadKJAM,MAAALAAA...fAEACADAGAEAOAGFSAFHHBBBhAGAFAHBDAIBeCAAZEDARFGFdDDAhABAABBBQGDAhBAAIDGAEEAABDGDbDEDcGFD...aDHD.hCAA......hCDA...,2,-12,2,14
eUBCLgRFdJWfbcOZQYaVSXHETIGMNDKAP,eAAACAAARACA.dAEA..JAFA..bAFDZCAAQBCA.aAHBXCEAhAAAHEEA.ECHBGGEBhAAA.MBIBKECDAEEAhACA.BEGA.LFFA....hADA......hAIA...,1,-1,-39,38
dgGLZfJBCNeKAPHSYWMaOXIDQTEURbFcV,HAAASAAAMACAaAEEOACD..DAHBEAEARCCAFCGHdAHAGBFAhAAA.ZCDBBEEAeDHFAAIBPEHDhAAAXEAATFCAhCAAbFED...gGFBfGGE.CHBA.hABA......hAEA...,2,-14,-5,9
SCIVNaBOPAReEUHDKgdYbTWFfLGQZcXMJ,EAAAHAAAKACAdADA.TAFAFAEAGAGA.ZCCAMAIB.CCADVCEBhAAAaDFDBECA..ACCBRDGFeDHHhAAADDDB...gFCAhAIAbFABLHCAQGGBXGGA..hACA......hAFA...,2,-13,-3,10
UaPOWSDJKYfNLIAFREdBZGcXHVgTMQbCe,EAAAZAAAGAEAHACA..TAGAMAHBQCAAeCCAUCGBaDEDOCHDhABADAEA.KDDB..fEGAhAAALFFBAACAdGHAhAIAXEAC.bGAA.CFHDSGEFhAEA.....hCAA...,2,-13,2,15
DNGOJfdZYSHXPIgFBCRTAUeVaLbEWQKMc,eAAAaAAALADAEADAKAFA.DAHBGCCA.OAHDdCCAZCDB.HCFAhAEAXCFCIEHABEFAhAAARFAAAAIBVFGB.bGCAMBBBhAFA.JFEBSHAGFGGA....hABA......hAHA...,2,-9,-4,5
XBUMFNWeZfQDGOcEaKRVbHdLJACgSYITP,SAAATAAA.BADAMACAFAFA..eAEAZBCEQCFAhAAAGBGAEBDBRDDAHDAAdFCAAAIBCCHAIEEAhABAXFFCWEHHhAAAOEHD.aFGBKCCD.......hADA......hAIA...,2,-19,0,19
cPJDeYUIBAMHWVLQEdNCKaGXbZgFfOSRT,HAAALAAAEADEdAFAKAEAGAGAZAGBFCAH.SCAARCCA..TEEAhAAAJCEBDDDBeCHHUEAAhABAACCAMFIB.QGEBhACAaDGHXFFC.bGAA...fGHAhACA...hBIA...,1,-3,-11,8
MGCAXUWLOcEBKDYPNVHIJZfTFRgQdaebS,XAAALAAAEAEADADA.....PAGDHAECZCDA.TDBAhAAARCAAdCEAeCHHMAIBACHBODFDhABAKEEA..VFCBhABAfEAEQFGAaEDHSFHHhACACHAA......hAEA...,1,-4,-19,15
GKUHegAdFQcZTODMIEWXfVJbYBLPaCSRN,dAAAQAAAZABBDAEA.EACA....XAFAfAEA.bAFDhAAALCEB.aBHDhAIARDCAGEFAHDBCACGBTEGAhBAAMAIBIEHA.JFCFBGEASHAGhAHAKGGD....hBHA...,2,-19,-6,13
DOcEMaNHTBYIUbJAKReZVCWSGfXLgPQdF,RAAAeAAAZADB.CADA.GAFALAFAQDAA.dBHAOCCA.hAAAECFAaDEDHDFCTEGAhABABDDDIHAAbFFAAAAAKGAAhAGASFBA.XGGA..hADA......hAHA...,1,-7,-18,11
bGdQaAEHVCXfDTBZcIRMWKULgOYeFJSPN,HAAAXAAATAEAZACB.RAGF.KAEALCAA.OCEBeAGHSBHHhAAAbDFA.dCEAhABAAEAAEFFAfEDEhAGABGAAMIAAgFFAFGDC.NEIAaHECDGHBWEAAhAAA......hACA...,1,-1,-8,7
VMOYIWfRHNZXdJaFKCecUEGLbAQSDTPBg,QAAATAAA.BACAMACAOADD..IAGARAFAHCEBZCGBhAAAdBDAaAHDCFAAeDDDEBFBGDEAhAAAAAFADDIB.gEGBhCAA.YCCFfGDEXGGChCDAKGGA.....hAIA...,2,-17,1,18
AFOTJUQSDafMZcCdRKWLgbPeBEYXGHVIN,TAAAQAAA.aACEZACB.dAFARAEFLAGB..bAGDeCDBhAAAECABGDEAHDAAIEGAhADAAAIBOEBDSEHHhAIAMEDBKEGCgGGABFEAXGCC.hAAAFGGHDICA....hACA...,2,-10,8,18
NeZcSBdLMGFXJQDOCfIgPbYaTREVWKUHA,eAAAZAAABADBdAEAGAGAFAFA..QBEDCBCA..fDDAhAAAICAA.bEBDaAHDhABA.RDDA.EEFB.KEHBHDGBhACAAAGBSGDBMCCBDFFBgGGAhDDA......hDIA...,1,-17,-18,1
EJgHZGNQXfLKAOVFUWPCbaRBdSeMIDTcY,FAAAUAAACADA.RADABAGB..eAEHDAIB...TAGAECDB.HCCBhADAGCFAQCFDhAGALDABACCBODHD.hADAPEFDdDHAMFCAIHHAYHCA..hAEA......hBAA...,1,-13,-28,15
BdcSIaXLNCbeOgUPDVJKQAMEGRfZWTHYF,EAAARAAAZADBHACABAFAdAFA...SAHBaAGDLCCDCCCD.eBHHhAAAOBGD.UEAADDABKDEAhABAADEAGECB.TFGAhAAAFEHDXFCA.bFFD....hADA......hAIA...,1,-7,-21,14
fTNcERGbaMdUFYAeXgWILOKDZCHBJQSPV,eAAAXAAA..IAEALADADAGAHAGBBBCAQCDAhAAA.SDCDhABAfBFATEFAEBHBRCDBaDFDhAAAdEAAFFDDADHBOEHDCFHAPHECcGGCMIAA.hABA......hBIA...,2,-31,13,44
bKeUVfPZdQTJDIMcCGgFWHaBLORAXNYSE,XAAASAAAKADAeACH..UAFAVAEAZCDA.dBHAQCGAhAAADDAA.MCEBGECAhAAAFDFHHEAAaEECLEHBhABAAAHAEFGAfGHA.....hADA......hAIA...,2,-22,2,24
FSXeZLGbOCTaAKcYNBQVfJdEgIMUPRWDH,KAAA..NAAABAFAQACC.JAEAEAHB.MBBARCDAHCGB.XECChAAAeCCAGCFAhABACAHBACIB.VEAAdFFAIHHAhCAAPEEBFFHB.LHCATGCA....hACA......hADA...,1,-10,-13,3
LbTPeOKYRaBdEMCWFcVSDZAJQgHNGXUIf,QAAAHAAAGADAUADALAFA.bCACeAFA.KBHBRCFAdEFDhAAAECFFMDBAFFHDSGAAhACAADHBJEEF.XGCDhADATGAAOEHDaGGH.CGGD......hAGA......hAHA...,2,-16,10,26
fQZcUeHRIbJNASadLDYXgOFPGVMCTEKBW,dAAALAAADADA.XADDFAFDGBDA..MAFAEAHBBCBAQBFChABAZDFB.eBHH.hACAHCAAbEGD.ADEBaEFBOHCAhAIACEHATGFA.fHBB..hACA......hBHA...,2,-27,-9,18
QPJDIRfFLYBNEcWHXGTAUaMegZKSbVCdO,aAAAeAAAZACBKADA...SAFBCAEAdAGA.QCCADAIBRCEBLDGBhBAABAHAECFBHECBGDGAhAAAABBB.MEFBbGFA.hBGAOHAA.........hCAA......hCCA...,2,-23,-14,9
cHVZKFYDTgJENMbQafSBGPLUdAWRCOIXe,RAAAOAAAeADEHAGBZADBFAFDDBEB...TDCAEAHB..MBBBaCFHBCCChAAAGCGALEHBhABAACCACDEA.XFFBhAGAKFFB.gGDAbDBDQGDD...hAIA......hBIA...,1,-6,-16,10
XAVfJgOBbRSCLZcPDTFEYMaKIWdQHGNeU,VAAAJAAABADB..RADFLAFBZAEB.DAHBEAGA..MAIBaBGE.hBAAKDAAdCCAHDFCGDFAhCAAeDDBADHA.OFCB.hCBACFFA.PFEBFFHD.IHHA...hAAA......hADA...,1,-11,-28,17
IOCeZTEASPUQFLdHDMJNKVXWcfabGBRYg,SAAAQAAAdADAHACBMAFAKAEA..XAGB..fBFAhAAAGCEARDGFgEAAhAAACBHAeDBAEDFAADBAFEDHhABALEEADBIB.VFBAaFHDbGCCBFHA.IHHAhBCA...hAEA...,1,-1,-4,3
bfLTXNACIYGcEZDSHOeBMJaQdWgVKURFP,CAAAGAAAZACAHAGBeADABAFBaAGD...dCCAVCDARDAB..FDFBbDGDLEHBhAAA..TGBAhAAAAADA.IGEAhACAEEDFOFGBMAIB.QEAB..hADA......hAEA...,2,-22,-5,17
QebcHOIPSVAWNTXLEaDdUKgMRZCGfJYFB,TAAAEAAAdADA..KAFARACFGAEA.JAHBBAHB.eBCDHDFBOCEChAAASCADACGA.hAFAXEAAaCHDDDBBMEEBhBDAZEDFfGAAFFFA.cFGDIHHAhCAA......hCBA...,1,4,-31,35
PJYIEXQSFMaZTNcgeDdVfKAWGCLbROUBH,GAAALAAARADABAGBHADBJAFA..EBHFQCAAMCDB.ZCFBhABATCEA..gDDAhACAeDADdEEDKDHBhAAAACIBbDGDOFGD.PGCAXFBC..hAIA......hBFA...,1,-6,-13,7
ZcIKDLMHNfGAbUWEaRPOTCQYVBJSdgeFX,UAAAEAAARACA.OADA..TAGAQAGABCCDdCEAeBDBZDAAKCFAhBAAMCGBHEBAGEGAhAAAADDBaDGE.CCHA...VFEAhBCASFAA........hADA......hAFA...,1,-9,-19,10
HaKQNRUSFCTdLJGVBgDMObPEWXeIZcfAY,HAAAaAAA.QADCRACFFAEA.dAFAGAGABAHAMCABOBBHECCBeCEBhAIAZCEEACIBKEGD.SEEDhBAATEFALEHBhAAAJFCBDDIB.PFEB.IHAAfGHAhBIA......hCAA...,1,8,-18,26
cJOLYdgBZeVEUHRXaTCWSADIfFPQNMGbK,DAAAFAAAQADAGABBKAFC...OAFCdBHAZCCAECCBHDFB.REAA.hAEAaCEECEHB.AAHA..fCHAhADAMEEB.bEEBLHCAhAIABEHA..eHCE.XGGAhBAASGHB....hBAA...,2,-17,-6,11
QOeELJZBIPWTMGFgNUHDAdXbCfVSYRcaK,dAAACAAA.SADARACAKAFC..eAHFEAGAZABBBCAA....ICEAhAEATCDAGCFAhAAAFBHDUEEAHDACACGBbGAAfEHAhACA.VFCAaDCDLEHBhAGA.WHFGMICA.DGIBhADA...,1,-6,-14,8
POGNfdZFBHSXTCDeKLEaUIJWbQAMcgRVY,MAAARAAA..VAEAOACEGCCAdAFAZAGBHCFC..SBBDhBAATEAAeEFBECCEaCHDIFHAhAAA..bDEDAADAgGEDhABA.PHAAFECACFHALHFAhBIA....hCAA...,2,-15,10,25
bTgHQFefcUdBMILJEGVKNRXYaPWSDZCOA,TAAAHAAAeACE.UAFAdACAMAEALBHBEAHFGBDAKCCARDEBaECBSBFBhAAA.ZDFEhCAAADGAbGEAQFCChCFA.fFGA.BHDA.IHHAhCIANIAB....hDAA...,1,-5,-10,5
KNCBgYcTIbLUfdADFSMPZORJVeaGWEHQX,SAAAZAAARAEA.eACHGCAAHAEAQCCBKBHBBCED...hAAAgCFATDFAbEAAhABALEEAdFFDAAGAMEEBhAEAOEHDaFHD.EGCACGCD.IHAADIAA.FGGH.hAIA......hCAA...,2,-3,-2,1
bOMRgAaZHEdUWCfYNFISBXPDLVTGeKQcJ,HAAAEAAAdADACADB......fAFAFAFABBCCDAIBTBGAeBEHhAAAQCAB.hCAAbDCARCFFADDBZEFBUFFBYDHBhAAASEHBLFAAKHCA.OHAA.hCBAaGDD.IHHAhACA...,1,2,-29,31
eIQdUFBZWKaJPYHSVROcDGELMTbXfCANg,eAAAdAAABADAZADBKAFA..aAED..JBHBHAGBRCEF.DCCBGDBAhAAAEDABLDDAMEGB.TEGAhACAXGCD.AAHA.hABAgFDA.QGAAFEHD.hBDA......hCAA...,2,-19,-14,5
XHePGJRZbEdSKAIFDYNMfUBCOgVQaLcWT,DAAAMAAABACA..OACEQAEALAFB.TCCAHAGDeBBBhAEAGCGARDCFEDHFdECDAAHAhBAAFEFBfFEAhBBACFHA.aBHFXFDDZGFE.KGGD.NIAB...hAIA......hBAA...,2,-15,-1,14
HabMKQVOZCGPILgSYDdUWfTRBANXJceFE,XAAAeAAAHADA.aAFAMADA..QCCCZAEEGBCALCFAhAAASAHHdEEAfEHAhABARCEFAAAAJDGBFFHDEGCAhCAAbEFDOHCC.CGCC.......hAIA......hBIA...,2,-10,-1,9
RUfJHdYaVATLXCbFGONeEDgWPSKZBQMcI,TAAALAAA.CAEAGAFAeACEDAFA....PCAAZBDAMAIBhAAARDDBUEAAHCGB.aCCCAAHAFCHDhABAEDEFSFFBhBGABFGA.IHBAdHBBXGFCOFHD..hBHA......hCAA...,1,-9,-13,4
MdOLSXERZaPAcQCYTJfgeGDBINVUHFKWb,QAAATAAA.JACEeACE.GAFABAFA.IAHAUCDAHAGBhAAAKBDDMCCBdDFALEHBhAIAECHFRDEBZFAAAFHB.CEDDfEHAhAAADGGBNIBB.FGGH......hAFA......hCAA...,2,-20,3,23
WRIPVBeaHfObDAdMCKGJFNSXcgZTQEUYL,dAAAMAAAGADAFADD.SAFA..XAFAZABBEBHFLDFAhAFARBBBICFABFFAhAGAHDFCbGCCAAFAKEDA.NIAB.hAIAgDBA..TGFAYHFGhAIA......hBAA...,1,-9,-21,12
gBUEafXJFeORCTGAScPLDMHbIYVWQdNKZ,SAAALAAAHADB..IADAVAFAdCAAZAEBBCCDEAGAaBGEhAAAXCGA.eDEFhABARCCBGDGAAEHBDFAAMFFBhACAbFED.QGGAKGDD......hAFA......hAIA...,2,-8,-7,1
eWQaVKSZBUDHfAITbGYcLgFPOJXECNMRd,TAAAGAAALADA.FAHBOACAECDA.MAGBRCFBdDHAeAHBhAAAaDCC.SBDAhAIAZEAADEFBAAAB.bCCC...gDFAhBDAXGGANICBQFGA.BHCAhCAA.....hACA...,1,-2,-12,10
cfMUPIVFYSLGCOHbXDReaJdQTZAEgBKWN,EAAAKAAA.....NADA.MACA.UAGAIAEAFBCDLBEBhAAA.GDFAHAFBbCBDhAAARECBeEHHdBHAZEDBBGBAfFFAhAHA.PHFCSHDA.hAIA......hBCA...,1,-18,-20,2
TRFWabENfVDIAGHLcCSYBeMXJKQgPdZOU,HAAALAAASACEeADHMAFAKAFAQCCAdBFAZBGB.TCEAhAAARCABaDEH...EBHFfEHAhABADDIBAAHAGEFAhAFACFCAXFEAgGCA......hCAA......hCCA...,1,-6,-11,5
NgdSMVLHaGBOCWQPYIXJEfTRUZecADFbK,FAAAKAAAdACAMADAHAEAGAGACAHB...QBCA..ICGAhAAAEBEARDEBZGDAACEBbDDChAEASGGB..hAIAaCHD.OFDC.PFHB.XGAAhAGA....hCAA...,1,-16,-30,14
EYDCLcOaTbJfQRHXVSZgAGPdFNMUIKWeB,dAAAMAAAKADABADADAFA.LAFA.OBBBaAGE..JCBBRCDAHCGBhAGA..SCFAhACAACDAGFEBFGCBUEDAIHAAhAHAEDHF.CHHA.bFFD.....XGCChADA...hBAA...,2,-33,-17,16
fDZVMFUdGAWYSEaeCOTgJPQIBcNRXbLKH,SAAAEAAA.eACHTACA.JAEAQAEABAHB.RAGBbDDAhAAAHCCC.ZCFBMDIBhABAdDHAAFCAaEAAOFCE.hAEAgGGAIFDAXFFA.fHEBhAIADICA..hBIA...,2,-15,-15,0
IYXRafSJOcHFbAeCWLGVBQMUDPdNETgKZ,eAAALAAAGADAQAEAMAFA.DAHBdBFAECAATDBA.ZBGBhAAAXCDCRFEA.aBHDhABASDHHODFCHEAAhACAAEFBCGHA.BEEDNICB.KFGA.fGBAhAEA.FGFH....hAIA...,1,-3,-7,4
YPJXcQWOabNAIgGRLdfeKBMCHEUZFDSVT,GAAARAAAdADAKAFAMADA.HAFCEBHF.ZCDADCCBTEBA..JCFBQEEChAAA.aCHDhACAAAAALDDBeFHBCGCASGGDhAIAPDHD..XFAA.OFGBhAFA...IHAAhAHA,1,-3,-30,27
TSFaAcLfXRQGZWMKdJPgHDbBONEUYIeVC,LAAARAAAZADBKAFA.dAEA.JAGBHCEB.BAHBECAA.UDAA..eBHHhABACCGA.TDCAFDHDAAAA.hADAXEFCGGCB.MEBBhACADGFA.OEHD.YFDBIHHAaGAHhAGA.fGGEhAIA...,1,-17,-24,7
afIKTYgCZUVJALdcGWNQRPSMHFeBOXDbE,dAAAGAAAQADARADAMAHB.HAFABCDDDCCB.ECGAaCED..KDABTEFAhAAACDDAZDFA..VFFAhACAAADALEHB.cGAAhACAPHAA..eGCE.....hADA......hAHA...,2,-12,-11,1
WKCJgOfMDSPXYAaGVZeQcIdFEURbNHTLB,GAAAeAAAQADAdADAEAFA.RAFAHCCALBHBKCGACEEAOCDE.hAAAMEEBSEGAhABA.XGAAAAABZFAAFFFAhACAbGEABGHA.WHCA......hAFA......hAIA...,2,-17,-2,15
CXKWBGMFUOYTfdZHLaDRcbgVPJESeQNAI,XAAABAAAGACAFADA.OAEA..TAGAZBEFHBGBLCDAhAAARCAB..bEDDgDBBhABAVFFA.ECHFSGCDhAAAeEEBAEGBKEHBMIEAfGAADAIB.hACAcGGA...hBCA...,2,-8,-2,6
EfQYLgGTFNdZIVKOBDaMHCPSceJbURAXW,EAAAQAAALADAGACBFAHBZBCAKAGCDCGBHCDC.SBGAhAAAeCHFUEAAADAA..fDCEhADATDDAdFFAODGDhAFAaEHD.MDIBCHHA.cEEC.bGEC..hCAA......hCDA...,2,-13,-3,10
EPMbSNRYdDHJGWgIVZFKOAUaQCLTfBcXe,aAAALAAABADA.eADH.EAFAMAFA.SBBDRBFAdCAAHDEAGBEAhADAIFAAZBGBOCCDhBAAAAIBQFGACEHATGBAhBGAfEDE.PHDAbGFADEEB..hCAA......hCCA...,2,-16,4,20
ZQONUeVWFTLCYXDPbRJGcIBSfdEAHagKM,HAAAaAAA.MACAZACBQAEAOAEE.eAHBFBHDTCCALCEAhAIAXCEBDBBBREEAGGBBhBAABDGDdFFAAEEAKGGANEEA..hBGA....WFGH.CHAA.....hAAA......hAHA...,2,-18,-4,14
TXFNHeBYfZMIDbGaJOWUcVEdLPAQKRSgC,RAAACAAAFACAHADB.eAFABAFAZCFB.DBIBGAGA.OBCBUDAAEDDBhAAAdDDALFABADFB.hABAQEGBSDHDhADATFEAXGAAfFCEMIEAaGGA..hAFA......hAGA...,1,-7,-22,15
QfZPSDcAeJIXWaBdTGLORHYEUCVKNbMFg,eAAAXAAABADAGADARAEFHAGB..EAFACCCAKDEDMAIB..QDGBhAAAZCFBDDAAAAAAIEHAhADAdFFALGAA..hABAODDH.VFABFHGE.fGGAhAFA.SHDAhBDA...,1,-13,-16,3
eQgAbOdNcZTUSIKPaBRVCXWGLfEFMHJDY,dAAAZAAASACEKADABAFB.RAEF.CAHA.GAGALCCAECCB..HDFBhABADCGA.eEDFADAA.OEHDhAGA..TDFAhACA.UECA.aDHD.....XFFChADA.FGHDMIAAhAIAJHAA...,2,-28,-9,19
MKSXVAbZHQacFYCEgOfUPIedJDWNRLBTG,HAAAaAAA.FADAEADAOAFDUAGA...eAHBdBFCDBBBRCAALDEAhAAAGCCAMDABSECBhACAACCBZEFA.QFFAhAIACDHA.fHCBIGEANIBBKFHB..XGGChADA....hBAA...,1,5,-19,24
EFedGBVCLZJPUcXgYWbIHQDRKAOaTfMNS,aAAAMAAA..EADAeACAGAFACAFA.ZBBAUCCA..XDAAhADA..gAGHhBAAbDEDHDGBQFBBhAHARDFAABBBTFCASFFAdHBDBAHA.....hBAA......hBFA...,1,7,-26,33
NcBPVfGRUDLEXCQKgeHAZWJSYFdIbMOTa,ZAAASAAAdAEAMAGBOACD..aAHBBAEA..VCAARAFFLAHBhAAAECHF.QDEChABAeDEBHEBCAEAAYEAGhAEAbGEA.TEGANEIA...fGGEhCAADEGB.KHCA.hABA...,1,-10,-11,1
bFeVAXMTZgJDOdGSICPBQKERaUHLWNYfc,MAAAZAAADACAGACB.CAGB.QAEA.RAGBHCCCLCCAhAFA.YAHBbDFAeFFBhABAABBBTDFAOFHBdGDAhAIASEED.BEHA.EGCB.aGGA.hBIA......hCAA...,2,-13,-9,4
VGKNCegBPaIZUYJbcOMARLTXESHFQDWfd,RAAATAAAEADE..HAFBQACCDAIB.dAEAGCCACAGABBHAaDHBZCDEhAAAUFAA..bDFAMEFBhAAAAEEBLFFBFGGA.hABAfFHENIEBeFDH.gGAA.hAFAIHDA..hAGA...,1,3,-18,21
KLPfeEbDJgOVMcHXaYTWNdIRSQAGBFUCZ,GAAAFAAAZACBLAFAeADAEAGA.DBEB..OBHDMCFA.HCDA.hAGAaDAHTDEAdEFARFCBAAABCDGBKEHBhAHA..bEGDVGFAhBAA............hCAA......hCBA...,1,3,-28,31
HBFcSJYIfANLCZPbWMTeKdEOXDURgaGQV,LAAAZAAA..bADBMAEA.eAHFEAFADAIBRBCAGCAAHBGBFCAAhABASCFH.IEDAhABAACFACDDDTEFAdEHAXFBDhACAaEHDQFDCBFFAYHFAhBFA......hBGA...,1,-7,-9,2
fHCKPWeMcOAZRaFEXIVDGSQYgLdUbTNJB,RAAAEAAA..XADBDADAGAEB..QAFALBCBbCDDTCCAhAAABCFDHCEB.KAHBhABAeCGHMDHBAAHAaDHDFGDASGFHhCAAdGGA.NDIACHHD.....hAAA......hCAA...,1,4,-23,27
bDLVagQNEeBRTKOAWZCIYGFMPXcdUSJHf,ZAAACAAAGACAMACA....XAEAdAEBSAGHHBGBDAIBaBEDQCCBhABA.EDFBhAHARCABTDFAAEEB.IFHAhAAAFEHDcFCAfEEE.LHDAhACAgGGGBCHAWFFDhCAA..,1,-3,-27,24
GOaZTKVfSgHcWPYXDRQNBMLAUCEdbFeJI,EAAAdAAAeADAGACAZABBKAEA..SAGAHAGB..PCBBhAAADCEARCFAQDCAhAEAMCFBAAIBbDFD.FEGD.OEEDhAHAaDHDTGAAfGHAWEDH.NICB.BGHA.CHEA.hAEA......hAGA...,1,-2,-4,2
CeaHZLQBRMXTWGbFdJKSfODAVNEUYgPIc,EAAAUAAA....PACCCADAHAEB.ZAGBLAFBRCBA.MAHBhAAATEEAGCCAdEGASDADhADADAIBACCBVEFANIDB.hAGA.IGBA.eFHHaFCHBFED.hBAA......hBCA...,1,-8,-18,10
BFNgWRbYPSHeTDXZIUKAQCMELGVOadcfJ,MAAAEAAAGACA.OAEAdAEAJAGB.FBBA..NAIA.RDDA...bBEDhAAASBHH.hBCAHEBBeCGBDEHBZEBAKFFBhAGAABHBLFFAaFHD.BHHA....hBEA......hCAA...,2,-27,-8,19
IbVTUDgdHMCXNBfERQLJAYcFeOSGPZKaW,FAAAeAAAGACAZADBKAFA..aAEA..ICFATBGA..DBFBHCGBhAAAMDGBXDBChABA.BAHBREBBLEEBhAHAACCAOEEBSDHH.WHEAbGFA..hAIA......hBAA...,2,-21,-16,5
CWFbIPRGKMYcQAdTNLVeBHZSXEJUDgfaO,dAAATAAALADA.eAGHHACBZCAEEAEADAIBaAGD..CCEAFDGDbCEDRDGBhAAA..GEAAKCADMAIBhACAQECAADEBBEAAXGBAhAEAUGGAOFEDIHHA...hACA......hAEA...,2,-9,6,15
DRSaNeGBHEOIMKXbWLTUgcFCAPZJfQdYV,ZAAAQAAAdAEADAGA.RACA...aBFDeAFEHCAAEBFF.MCEBKBHB.XCGAhAAALDEATDAAhADAUFFAFEBDADDB.JHBAfEGAhAIA.SFEH.BGHAhCAAOEHDIHCAhCHA...,2,-18,-11,7
OEfKYQbLBaNUVRgISXZCeWDMHAFTJPdGc,TAAAdAAAGADA.EAFAKACC.QAEALBHBaCAEUBGARCFF.SCCAhAAAZDAEeFAAMFFBhACAHDEAAAHAFFDDJEHB..hCAA.cGFCfGGA.BHCD..hADA......hAFA...,2,-10,2,12
QJYCeNKBFMgaUTWfSRVIEZdLGcODPbHXA,QAAACAAAKACA.MADAaAEA...TAGASAGH.RBEB.hAAAEBDAdCAAGCDB.hACADCIBHCCBADBAeEEAFCHDgEGGhAIAfFGAZGCAOFFB...hAAA......hAIA...,1,-13,-18,5
aCYLSgbBHWeVFfQNRGJKTMAZdPIUcXODE,dAAAUAAAOADAEADA..CAFA.LAHB.SBDBbAGD.hADAHBFDeCBAFCBDQCEAhAIARDCFGEGAKEFDABIBZEEAhBAAIHBADEIBaGGCBHEAWFDH.....hACA......hBAA...,1,-10,-14,4
gOVUWZfeCdDGIPQEJXRbLASMcKTHYBaNF,MAAATAAAHACC.aAFAFACA.OAEDUBGBZCCAeAGBdEEDGCCAhAAAQFCCEDHFREFBAAHAKEHBBFEDhBIA..NBBA.gGCGhCAAfGGADFIBIHEA...hCCA......hCGA...,1,-4,-7,3
XGJcQdDUZPbOaHgLVCMWNSBfRIFeAKEYT,EAAATAAAGACA.QAEAdACAZADBOAFCHAGDLDFAhAAA.MCBBSCEHhAAAREDBeEADAFFAXCGAhAHADFHB.bEFDaGDHCEHDBGCA......hAIA......hCAA...,1,12,-26,38
LfDcOQMHIEKWYgUaPASebBVdZNXTJCRFG,eAAABAAAZACA..TADARAGBGCCALAFBDADA.QCCChAAAHCFBEEHFKFFDgCGHhABAUGAA.AAHAbEEC.dFCAhBHANIDB.CFHAfGGE.MIBA..hBIA......hCAA...,1,3,-21,24
RYUbOGMBKaJcQHXDIPSAWFeTNdECgZLVf,eAAAdAAAEADAZADBLAGBRAFA.UCCAGCEAKBFD.aCCB..QDAAhACAHCGDDDBBSEHHhAAAAAIBFDHD.TGAAhABACEFAfFEEOGFCMICABGBAXGGAhADA.....hAGA...,1,-5,-14,9
FUXZPRVMaWfQSeLgDOHGAETNJbYKcBCdI,EAAATAAA..JACBKACCBAEAdAFA..FAHBZAFBRBDB.MAIB..aCCHhAAAQDDCLDGBOEFBhBFAHCGBACEAbEABCGHA.hCAA..UFGB.PHBC...WFFDhAAASGED.hAEADCIB..,1,-16,-19,3
NXgJPVMHcaECUFQeDWfTBAIKLObGdSYRZ,LAAAGAAAdADARADFZAFB..XAFAJAHB.MAIBHCAAECEAFDHDhABAeDBHDEEA..TFAAhACAAAABODDB.bEFASFCBhAFA.gFFBcFECaFAH.hCAAQGGC.hCCABHDA.,1,-7,-12,5
UgFbVESHDMGfTaeIJZXCRONAQLBPdYKcW,LAAAdAAAKADAUAFAFAEAEAHB..HCACGBCBaBHD.eCABZDEARECBACHBQDDBhABA.hACABDGDPFFB..hADAcEGD.bGFADEIBMIAAfHBBhAIA.IHHACFFC.hACA...,1,-11,-16,5
AYJZHWEPTGeUMfRCBbISVOFadcNXQKgLD,ZAAAHAAAEADEGADA.eAFAMAFARCAABBHASBEAFCFDdDHAXBGDhABAQFAA.LFFBhAAAABIBJCAA..TDEAhACACHECIHHAaEDHKEHB.DFGB...YHEAhDAA...hACA...,2,-12,-3,9
eROQaXGcdILCFKNMfYDUBPgWAVbJTZEHS,VAAATAAA..HADBRACF.QAFAGAEAdAGBLBHBKBHDMCABhAAADDAABDGD..gDDAhAAAADEBZEABEEHFeFFBhACAaDGBXFAACHHA.fFFE.hAEAPFHB...hDBA...,1,2,-8,10
DXUJaVIKdBQAZbNGgFCfEORYSHTMceWLP,ZAAAGAAACADB.EADARAEFHAGBMAGB...eCABLAHBDCCB.XCDAhAAAaDDB.KDCDdDGDABHB.hACA.bEEAFEEB.OFGBhABATGEA..PGAAUFBBIHHAhADABFHBNIAB......hBAA...,2,-10,-5,5
FIJTUQBPGCEOdHNcWSKXLAeabMgZVDRfY,eAAAaAAA.MAEAZACBRAEAFAHD....TCFAQBCAGECAEBEAhAAAHEEA..cCEDhABAKBBDAAHAbFABDDHBfEFAhCAAIGGABCHBOEHDNEIA.SGGDhCBA.....hAFA...,2,-9,-8,1
XPQfcCFBORaNSgIVGLAEHWKDMbedYJTZU,HAAADAAAeABAdADATAFAZAEB..UBGAQCABCBDA.OAHDhAAAREEA.aCEDSCCDhAHAIDGAGFABhACAEFHFMIAAbEFA..XGCAfGGA.BDDChAFA.....hAIA...,1,16,-33,49
aHLQKPYRSdIcNUBOWVAMbCDXZFGJEfTge,MAAADAAAZABEGACB.EAGETAFA.eAHHHCCALCCAhADAQCFCKDFARECAdCHA.IFAAhAFAUFGAOFABhAFAABBBbEECFFHD..........hAIA......hBAA...,1,-4,-17,13
GUTBELJQbIZWeVdCaHNKcOXRfFSgMAPDY,DAAAGAAABACAEADALAEAQAFAZBBA.eBHHdCFAHDGBKCDAXDCChAAARFAA..SAHHhAFAADABPDFDTFCAhACAbFDB...IFHACDDDaGGC.OHBChADA......hAIA...,2,-17,-4,13
cFCGNbBMIVTHLEOJPfSeYaRADgQdXWKZU,QAAAdAAAKADAZABB.FACEGAFABAFAMAHB..TDCAHCDAEDCBhAAAOAHF.JDHFSCHHhAFA.eEFBhAIARFAAAEFBXFDDcFCCbFGDIGGA.hBIA......hCAA...,1,-11,-16,5
cIDSPHdRbOAUeLQfTZaXFgWMVGBYJNCEK,eAAALAAAQADAZADBaAFD.FAFE.MAIBGBGABCCAJCABECFAKDCDhABA..DDEBHEEBRDFAAAAAUFFBhCAAXFBA..hACA.WEHH.NIAB....CAHB.SGHHhCBA....hCCA...,2,-20,-3,17
BVLNXGUeAMQJOCYcPHFWKgIdDTSEfabZR,MAAAQAAA.CACA.PADCHADBKAFAdAGADAIBEBHF...aBBBRCFBLEEBhAAAGCCAACCBOCFBhBAAFFAAIGGA.hCAAfHABZEFBBDHB.NDDA.eHFA...hAFA......hAHA...,2,-12,-10,2
JFVCESQDLdATBagceRNOHXUWPbKZYIMGf,aAAAeAAA.RADAHAGBUADA.....bCCAZAFB.MAIBGDFAFBBHEDDBhBAAQEAALEGBhBDAAAAABDHA.gGAGhAEAOFBBPFEDKFHBYEEFfHCBhBFACHHD.DGIB....hBHA...,2,-20,12,32
VHTMaWcEdQINRFbLCYOAJKBXDSGZgPUfe,BAAASAAAZACAUAGAeACHHCCA..aAEAEDABdAHA..QDFAhAAARBDFLDFAODHFhADAAAAAXFBAGFABfFFAhBFAMFFB.IGHAFGGB.CHBAKHDAhBHADIBA......hCAA...,1,-2,-18,16
PdGZXgEYOSMDeUCIbcfaFNQBHKRAVTLWJ,TAAALAAA.JAEAGACAZBEA.EAEAOCAAMAHB..DAIBeCHHhABACBFA....bDFAaDDAhACAQEAAHEFBAAHA.hBIAPEDDdGDA.XCACSFHHIFFAhAAA.FFHHBEED.hACA...,1,-6,-12,6
PZeCKYSAaXgcbRVdMWIETBLQGFHfDNOJU,aAAAXAAA....bACDRADAdAGA.MAIBEAEALAHBhAEAGCDBHDAADBBBOBEEhBAAUEEBeEHBKDEAAEHA.gFFAhBHA.cGDCIHGABHHA..hCAA......hCCA...,2,-21,-8,13
DSYcQFVbWPJfAZTNHeEIGOaLMXBUKRCdg,ZAAAHAAAEADEGADALAFBMAFABAHARBFFdBHADCAA..SCAAhAAAQCDAFEFH.bDAAPCHBhABAAACA.eEFFaEHBKFBAhBFACGGA...YFHBWHAA....hCAA......hFAA...,2,-19,2,21
EGUdABcJDSCgOZeTIMNaXWLKYRQVPfFHb,BAAADAAACACA.ZACA.eAEEMAEA....aAHDLBBARCCA.QBFAhAIAVDAB.FDDAhBAAHDFAEDHFdFBAACCASEEDhAAATFFA.XGCCKGED...fFHAhADA..hAHA...,2,-26,-24,2
OUIeTfLGJRMWQPdgNcCBZFSHKaXVDEAYb,OAAAeAAALAEARADA.MAIBQAGCdCCA...gBBGhAEACCFAZCDBHCGBaCEDDDBBhAAAACIBUEGATFEAGGDBhAIAPFABBEDDKGHB........hBAA......hCAA...,2,-17,-4,13
HJQDRXFYSKICgMNVEfeGaTbcdZWLBPUAO,HAAAQAAARADFFAFAKBHBCACA..MAEA.EAHFeCAB.aCCHbBDAZCFFhAAA.LEEBBCHAABEADDDAhAAASFDF.hCAAIGGAgEEANEIA.fEHAhDAA.cGGC..hDBA...,1,-5,-33,28
JfOKUDIbaNEcQPBYgFGXZSHCRWVLTdMAe,eAAAOAAADAEA..aADDEAGA..QAFABBCAFBEBZCFBHCDCREGFLEEDhAAAdBHAABBBKDBAbEEAhAFA....NDDA.PGEChAIA..........hBAA......hBDA...,2,-31,-15,16
afHESJKdVNZIQRYPgMOTBcGXWCbeLFUAD,aAAAHAAA.EADEKADAdAFAZAFBRBGF......gCAAMAIBTCCAhADAGDCA.CAHBeCEBhAAALECAADIBDEGBSCGHhAFAJFHB.IFGA.PHBAhBAABHFA.WFHH...hACA...,2,-24,-5,19
ZFTROAVKQgeUSLDBHJGNPfcXCEadIWYMb,QAAAeAAALAEAHACAGBCA..fAFBCBHAECEEdDHA.hAAAICEAMEEAZFAARCFFAAHAhAAAKFFASCHBhAEABGHANIAB.XEGD.aDDH.YFFFhBIA......hCAA...,2,-13,-8,5
KOfQYeXFUHBcaNgLTCIMWbREZVPJDGASd,dAAAOAAAQADA.eAFAFADDHAFAaBGE.LCCA.hACATCGAMCCBRDDAEEEAZDAFhADAVFAADDGAADDA.fEGAhAGAXEGABGGAcFGDCHADWBBD..hAFA......hAHA...,1,-7,-16,9
QJGHFYNeVTSMAXUPZKfdIOBbEgRWDLcaC,XAAAZAAAdAEABAGA..EADARCAALCGB..aAFDQDEBhABAHBGBFCDBeDABhAAATEBAAAHAKDFD.OEEHhABAbFDD.DEIBCFHA.YFBBSGABMFHBfGGEhACA..hADA...,1,-6,-26,20
SPbaBfIgKJDZHQVEOdFRWCcTGYMANeUXL,eAAALAAA.SADHaADDBAFA...IAFAKAHBZCCAHCGBhAAAEAHBdCAARFAACDBDGCDBhABAAEEBUFGBbEEA...fGCAhACADFFBOHAEFGEA.WCCD...hABA......hAFA...,2,-19,0,19
HgYGUKQfOPeBTCJdFDcbIXNZELWaVMSRA,HAAAGAAAQADCOADAeAGFTAGAdCDADAIB..bCACXCGDhAAAECEAaCGE..MEEAhAAAACFBUFEAfEHAhACACEBAFGGA.IFAA.ZFFF.WGAA..hAFA......hAGA...,1,10,-20,30
XNdBMLCWIbfeJVPTSFcYZQGEKRDUAagHO,HAAAXAAAdADAMAFALADA..CBFA.IAHAeBGH.VCDAhAAATDDA.FCAHZCGBEDHFhAAAREAAAAEAOCCBBFFDbGCChABAfFBE.SFDA.QGFAhACADDIBaGHB.NIBB.hBFA...,2,-9,-5,4
MLdXDOQKPbENGHWUgZVFcJeBfYCaSAITR,RAAAdAAAOADAQADA.KAFAEAGAHCACUCCAZCFBFBHDeBHH.BDEAhACACCFAAAAA.MEDBLEFAhBEADEIB...bFCBWFGHhADA....gGEAJHAA.aHGEhCAA......hCFA...,2,-24,-7,17
GPNBSXHEIZeWRgbOQMcfdCLUFYATVKaDJ,TAAAaAAAGACA.BAEAHACBZAFBRAEAOAHD.MCABdBHALEABhAEAFCFDADEB.DBBBPDHBhAAAXEDA.EEGAhAIAeEAH.bFFDQGEBCHAA.YFCFhBAA.KHGA..hCAA...,1,2,-14,16
NSRGFeVCgJPMdXQZabcOHLKYEfAIDBWUT,BAAATAAARACAGAFA.FAHFeACE.CAFBJAHBdCAAZCCA..bBDChAAAHDGB.LECBhAAAEDEAACCBDDIBUGGB.SEEDhACAgEDGMFABaEHHKGFA.fHABhAHA...hADA...,1,-7,-14,7
BKVRHZbETSJfegCALQUaPIGDOMcdNFYXW,LAAAaAAAGACAMAEAdAEB.FAHD..XAGDKBDAHBFBZCFAECAASBBDhAIA.eEDAhBAAADDAQEEChABAUFGADFBBOHECcFBAYEHBWFBH.BHEAhACA......hBFA...,2,-21,0,21
NfaTZOcKXFCMVAeJYgUBQWIGSRDPHdbLE,eAAAJAAA.UAEAQADCGBCA.RAFFHCGBdAHAEDGA..aAHFZEBFKCCDhAFACEEA.ADEA.BEHA.SFGDhAAAbEED.LHBAhABAfGGB.......hBEA......hBGA...,1,-15,-16,1
IJLCfaNYHQSZAUPKFOVcWTDGbgBRdeXEM,KAAAOAAA..VADATADAGAGA.BCAARAFFeAHH.EBBBMCCBhAAALDDBCDDA.aDFChAFAHDFBZFFAADIBFFDBDHAAdGAAhACAIHFAfFHA.NIDB.....hADA......hAGA...,2,-17,-7,10
EWdfcAPXbOICBLVGYDMHSURZgeTFKQNJa,XAAAOAAABADAGADADAFA.HAFA.RCFAeDAATBEA.QBGChAIAaEFCEFAA.dCCAAAAAIGGAhADALEEAMBBBhBAASEHBZGEA.KHAAWDHH....hBIA......hCAA...,1,6,-24,30
ARNZdEJVbDOWUCeSBgFTafPKMQIcGHYXL,RAAAdAAAEADEJADA..DAFAUAGA..eAHFBBDDFBFD...aCCAKCBAhACA.MCFBQEEAhAAAGDGA.HEGDLEDBhBAAACIBNDDA...........hABA......hCAA...,1,-20,-39,19
fIgcEXBGQRdFSTYUOJHLCAPbWDZVNaMKe,...bAAAZAAA.aACAeAEA..IAFAEAHFGCAARAGF.dCCDTCDAhABAOCFBHDFAAAAADCIBhACAMCCBKDGB..fFGEhAEAXFCAQFFBSEEDYFAFhAFA....hCAA...,1,-9,-14,5
XAWYKRgSQIdZMEVJBCabeHLfcDGFTNOUP,KAAARAAAQADCZACB..EAEABAFBCAGA.eAGHHCABLCCAhAAADAIBGCFATDGAUFCAAAIB.hABA...gEEBhCAAdFHAMFFBaHGCfFHA.NICB...hCIA......hDAA...,2,-17,-12,5
MDKCaFQWUXVdYPgLNAZRHSbOceBfETJIG,HAAAOAAAeACEBADAEAFE..JAFAGCCA.MAIBCBBDFBEDQCFAhAAA.XEFChAHAdCGAPDCBLHDAhCAAACIBZEEA.SEHH..bGDA..hAIA......hBAA...,1,13,-41,54
XOFTWABdNYKRgEZUPCVLfQGbDMSJaecHI,dAAAKAAAEACEZABBCADA..LAEBGAEADAGAMAGB....aBGAHCCBhAAA.OAHBFCGDADDABEEDhBAAREFAgGEBhAIA..PEHD.QGFC.hCAA......hCBA...,2,-30,-20,10
UDHSIaAQPJLVcEfbRNKGWFYBTCdOXgeZM,QAAALAAAEAEARACAGAFAFAGD.BAHAdCAAOBHDeCDFZDABMCCAhABAHDGB.aEEBADDAVDEAhACA..fFFEhAAAbEAA.KHAATFGACHHA.....hADA......hAFA...,1,1,-11,12
TbagdeHDJLEMVQSfABNcXCIKRZFPUWYGO,BAAAXAAAKACARAEFZACB..FAGAUAFA.GDEAOCAA..aBEBhAAAeCFHHDGDLCHBhAAAEGDBMAIBQEAAhACAAFIBCGGD..IHBAPDDBTGFA.hABA......hBHA...,2,-19,-10,9
SWHODQTcLBIbGfVXdAaCYFENeZPKgJUMR,aAAAFAAAEADAZACB..KAEAUAGA..RAGFHCEBQBEALECBBCCAhADAGEGA.XGABhAGAADEBCDGAeDHH.PEFBhBAAMBBBSGDH.DCIBIHHAhBIAfGFE...hCAA...,1,0,-34,34
KdXSZFPJDUYERBACMcGIHNeLOQTafWbVg,MAAAGAAAHACCeADALAFBQAGAaAHB...bCDAKBBDdDHAZDCAhBAAFDCHDBIBEEABADDACDGAIEEAhAAAOEHD..TFCAhCAAfFGE.WHEGXGFC..hCDA......hCFA...,2,-13,5,18
INTYdWeUOMbQPHaVCZXRGKFLcEDJfBSgA,TAAAdAAAeADA.MAHBQACC.HAEBaBEEZABBRAGBGDDAhAAALDDAEDGBDDIBBDHAAAIBIEAAhAEANEAA.UGAAhAGAbFDACFHAFFGH.........hAEA......hAIA...,1,15,-25,40
PJIKQUMbaWgdDTBXcELYNSFAfVCROHZeG,CAAAHAAAGACAJADAKAGCUAFA....aBGEdBHABCADECABLDFBhAAA..SCCAhAAAAAEBREDFeFBB.QDEAhACAMEIB.bDGDDFHBTFCA.XGEDhCCA.....hACA...,2,-19,-12,7
STNIcBgCWaQZPYMeAfEKXRHODVbLGJUdF,EAAARAAAHADBDADA.LAFAGAEB.dCGAFBCBTDAA..ICEAhAAABCCDCDEA.aCGDZEFEMCIBhAHAAAAAKGAA..ODDBhAIAbGDA.SEFD.gGFAhCAA......hCBA...,2,-23,-11,12
JdNSZEOGMLfHTFRXDICegWVBPYUQKAacb,aAAAJAAA..dADAZACBGAFAMAFA..HBEARDDB.DBBBeAHB..gCGAhBAABCCDUFAAABGA.hBEA...bEDBEDHBLFFAhBIATFGAFGFHCHFA.....WFDDhAFA......hAIA...,1,-7,-23,16
KPZFDNCXRTOEecBdYGgMAfJUSWQHaLVbI,UAAAQAAAHADAaAFALADA.IAHAZBFEDCDBCDAA.RDFA.ECDAhAAABEDAGCFA.AAEASCHBhBCAVFGB.hADAbFDBFGDAXDCC.eFGH...hAIA......hBAA...,2,-22,6,28
dEFSZeXHgCUVKWIYDcJTGaQLMNbORBPAf,EAAAZAAAHAEAUADA.KBHB....IAGADACATCDAGCBAaCCH.hABAMAIB.OCHHhAAARCFFAAGAdEHAeDDECFFD.VFFBhBCA....YHFAQGCA..hBDANIAB.BEED...hAIA...,1,2,-24,26
QOMFIZUDNEYdCTXBAKWbfLRaeVJHgGPcS,KAAA..bAAARACFeAEEHAEAGCAA.SAGEMAIBZCAFDCEAhAAAECCBdCGACCGA.BDFCADEALEEAhACAaDHDVEDBJFHBgGFAhAAA..QGEA.hABAFHAA.....hACA...,2,-19,4,23
FfDBGIHbRcgeJLXCZOTaQNMAdYKESVPWU,dAAAEAAA.SADA..PACCFAGABBFAHAFBRCAA.eAHBLCEAhACAZCCAaDGDMCIBAECAKEEDhAAAUEABGGEB.bFAAhAFAgEEA.CFHDOHEANIAB..hADA......hAEA...,2,-20,9,29
bUESPaCfNXHJFIRDgTeKQOWGYVBdMZLcA,EAAAaAAA...CACA.XACDHADBFAFA.RCFA.TAEAKCCD..QEEChAAAGAGABDDAZFBBAAIBhBFAbDFDUGGASBBDhAEA.fFDAIEHA.eFHH..hAGA......hAIA...,1,-11,-18,7
BgcMPANOfTUHEVKDCRGeFZXLIbWYJdSaQ,OAAATAAA.HADAEACE.DAFAGAEAZBFELCCB..bAGBJDGBhAIAaCCBQGDAhBAABDDAMBIBABBB.UFFACEEAeFHFhBHAXEAC.IGBA.dGDA.SHGAhAAA..hAEA...,2,-11,-7,4
CXMYgedcPSERAFJQVHBGfKLaZbODTWNIU,QAAAHAAAGADALADAZAFADAGATCFAIAHA..XCAAhAAAMCDAeCFA.dDDAhAAASDDDAAEAFDHDBFEAhBCAaDHDbGEAOFEC.NHCBCHHA.....hCAA......hDAA...,2,-14,0,14
aQeOdCXKLGScgBPTMIUEZWRYJVNbDFHAf,aAAAeAAA.dAEAKADAGAGA..SAFBBBCAMDDAEAHBREBA.VCCAhADADDIBHEEB.AAAAQGAChAGAXCGDLFCAhAIAPHFC.TGFA.....hAIA......hBEA...,2,-20,-9,11
EgMOCGfQbXSHIJLAadWZYFcDRUTVKNBeP,dAAAZAAAFADARADAUAGAKAGA..BCAA..ECBA..MCCBGCEA.hABAQDGCSCGAhACAHEAALDDBAADAaFHD.hACA....cDFCDGGBNIBB.eEHH.OFFBhAGACDDC.XGCChAIA..,1,-14,-23,9
PXNZdJaQbgTSeOEYGFLUcKVRHBMADWIfC,DAAA..fAAAXABAdAEAaADAQAGA.bBCBTAGAhAGA.eCCBECAAGCEAhAAALDGBKDGCHEBBhAIAACEBCEHAZGAASEEAFGFD.cGCDBHHA.hACAMEIB....hBAA...,2,-22,10,32
bHMaYDUXTVfREeBPKNSZQdCgIGAJFcLOW,FAAALAAAOACDHADB.aAFADAEA.UBEATCAA..RAGFEDHFhAIAeAHH.KCFBZECAdEEACFHA.hBAAGGBB.ABFAcGFDhABAbGEC.MEIB.......hCAA......hCBA...,2,-32,6,38
IFKbLJQaOeGWBXdUENZSfPYAMVTHRgcCD,MAAAHAAARADF.CAFB.FADDLAHBQAFAeBGFGBBABCADdDDDECHFZDEBhAFA..SDAAhAAAfEDAAEHATFCAhACADEIBbGEA.aFFA.XGGAPHBC....hADA......hCCA...,1,-2,-11,9
NXEAJcWHfSLCIagMFYODUBZbReTKVGdQP,JAAAHAAALADBaACAMAFA..OAFABBEARBFFKBFAdBHA..QDEAhBAAXCCCAEEA..hAAAfCHACEGAFFFHDEIB.hCAAbFBA...eCCD.TFGA..hBFA......hBIA...,2,-24,-20,4
RZKNLMXWCIEgfDJTcHQGSYdAOePVBbaUF,eAAABAAAaACARADAZAGBLAFA..MBIBCBCA.ECCBDCBB..TEAAhAAAHCDAGCGAhAAA.dFCAADFBOEDChABAbFEBKGAB.XEGD.gGAAfGGEhAGAQGEC.hAHASGCH.,1,-3,-9,6
bNDRXLaBGJIdZMOQPFCYcKUEgSHWVeAfT,TAAADAAARABALAEB.GAGAdACAZADB.MAGBQDCChAGACAHAKCHBUEEAEEFBHFGB.hAAAeGBAABFB..bGFAaGEDhAIABEHD...OFDH.FHAA..hAHA......hCAA...,2,-20,0,20
HVeOKJaCPfWgMEDQBXZIAdNTcbFSRGUYL,dAAATAAAFADARAFF..GACALAHBHAEA.eAHHKBDD.aCACCCBA.fCFAhAAA.MDIBhACAEDEBQEGAhACAZEAAAAGAbEDDSFFAVFDB.OHEE..hAEA......hDEA...,2,-27,15,42
SgADMQcEFPOUCXGfedbaJBKLNZTHVWYRI,MAAAEAAAFACDUAEA.GBBAeAEAdBHA..aAGEKCDAZCGBHCFB.hAHAVEAARDEFSEBDhBAA.ABBBQGDChBDAOEEBfFGABEDCTGGAIHCA.hBEADEIB.CHHA....hCAA...,1,-7,-10,3
XKRYgZNSCcdHbfWUBFAPGTDMOIEaQJLeV,GAAAMAAA.EADAaACELAGB.eBFFKAFARCCAZCDFCAHBHCFB.hAAA.bEGBUFAAAAIBTFBAhACAOBBB.QFCAhAFAXGFDNDAAdFFD.BGHADDDB.....hADA......hBAA...,1,0,-11,11
VBLQAEKCONXTFGaPRdMfZISbcJgYHWeDU,EAAAOAAA..TACAaADD..RAFAdCFDZAEBSAGA.hAFAJCCFHDBADCGABDGAhAAAABBBCDHAFEFBGEAAMFHBbGAAhAGAgEEB.eDHH.....hAIA......hBAA...,1,-10,-23,13
dHECVDKNZeYTGbOLXFUfJQAPgRcMBaSIW,RAAAMAAABADB..aACESAEH.dAGAHAEB.EAGADAIBZCCFhAGAeCCBGCGALDGBhAAAFFEDfGGEhBAAADIB..gEDHWBBD.KGBANIBB.bGFA.hBIA......hCAA...,2,-23,-11,12
fZcJbQdHeEGCBMLUgOITWNSXYKFRPVaAD,ZAAAJAAA.dAEAHADBEAGAGCAAMAFA..LBFBOBHD..TDDAhABASBHB.KCCDhADARCFBaFFCACHBDEEB.bFFAeFHHhACABEHCgGAA.IHFAhADAWFDD......hAGA...,1,-3,-22,19
dcDCENgWRUGeHJITVFMXQYALOBfKbZSPa,LAAABAAAKACAZAEBaADD..dAFACAGA...EAHB....NAIA.RCAAeCGFhABAHCAA.TEDAhACAMCGB.QFBChAIAACCA.bFGDSDHDDDIB.gEAAhAAA.GECAIHEAhBFAXFED.,1,6,-27,33
NVERJaYdCcgPQeZFGLfOSAUDMBTWIHKXb,MAAATAAAHACC.KAFCXACB..bBFAEAEARCCB..aDGBdAHAhAAA.CBFA..PCCBhBHAeEFDFEHBGDFALHBAhAIASDHBABBBBFDAIFDA...hBAA......hBHA...,1,-9,-10,1
dEQJTSeIOgaCMFLHYNcfURZGBbKDWVXAP,EAAATAAA..eACAOACAaAFD..MAHBHAFA...cBDChAAARCCAGDAAKCCDDCHBXDFDhAAAAAHAdEEA.QGGAhADASDGDCDHALEEDfFCA.BFHAhCAA......hCFA...,1,2,-25,27
dDBgTUGYJAOELZaQKINeCfbMXRVcFHPSW,EAAAaAAA.KACA..eACHCAEB.MAEARAFF.FAHDHCCA..SBDHhBAAdAHABDGATEEAhAAAGBFAABBBLFHBZEEFQFBAhBFAfECEXEGD....hCAA......hCFA...,2,-19,-13,6
UEbZNPeJQVACYHOMIaSFcLKGRBdfTXgWD,HAAAMAAA.aACAFADDLAFARAFA.dCCATCBA..XCFAhAAADCFBECGA.ZCDB.eDHHhAGAQEDCAEGBOFEDSDHHhAFAKGCBfGGEgFGG.bGAChAGA.PHECCHAA..hAIA...,1,5,-24,29
CKWYEbAgOeHJBDNfUFPaQRcTdLMSXGIZV,eAAAHAAADACAUAEAaAEDRAGB...dAGAMBDBGCCAZDFA.KCHB.EEBBAAAAOEBBhAIA.BEDAhBEAFEFAQGDAhAAALFFBXGDBCFHA.....YFHFhBIAgGGG.fGBEhAIA,2,-24,-11,13
RVbHcXMCOJLDIEdFBeGNaQWfKTPAZYSgU,ZAAASAAARAEAHCAAMACAOACD..LAHBEAEAdAHABBFAeCEAaECAhABAQDEA.hCAAKDGAAEGAgEGAhCCAVEAAbFGD.CFEADGIBFHBA........hCEA......hEAA...,1,-6,-9,3
BQeXWZbaOGfPKMAIUcYSLDdEVFRNCJTHg,UAAASAAAdADAFAFARACF....CAEBHAFBQCEAeAHBZDEAOAHDhBAAGECA.KFFAADBA.hBCAIHHALDGBDEIBhAAAEDDB.VFBA...NEIA....gGFGhBDA..hBFA...,2,-19,-10,9
fgVHaKFDbEUOASYQGePWJXMcdIZLTRBNC,QAAAeAAA.JACEMAEA.dBDAZAFBRBFACCCC..VDCAHDEAaAHDhAAADDIB.EFBAABFBGDGAhBHAXFGC..IGEAhCAALHFA.BHDANIDB.gGBAhAAA......hABA...,2,-14,-13,1
aVCbANJPKHMGQRSUBFceIOZTfEgYXWdDL,JAAAHAAAGADARADFBAFB.eAGHZAFA..ECCBXCAA.dDDDaCFDhADACCHA.AAGAKCHD.MEIBhAIAQEFA.FFCAhAAAOFDAfGHAgGGDDIAA...hACA......hADA...,2,-23,-15,8
dBXcZaHKEDgUbTPICAWMVefJYFNOLQGSR,MAAAeAAA..JADBFADDLAFAGAFARBBBdCFABAHAZCGB.HDEB.ECHFhAFADCCB.UFDA..hAAAbFBBTGAACEHA.AAGA.hABAfGGA..NDIASGGBhCAA.....hAHA...,2,-18,-16,2
dPCELBIHcgWQYDbVNAGOKUJeTRMZSFafX,GAAAKAAAeACERADAZAGBFAFA...aCDCdCCA.EBHFLEAA.HEEAhAAA..gCFDhAAAQGAAbCDDAADAOCHDhACATFGA.fGCFCDBCBGFD.IGGAhAGA.....hAIA...,1,7,-27,34
QLVFGXdIcSDUCZNHWRKeMYfBAJEOTaPbg,EAAAaAAA.....bACALADA.GAGAdAGASBHHhAAACBBDHCDAREAAeDHHMCCBBDAAhADAAAEATFEAQDDAhAEAFGHD.XDGCDIAA.ZFEE.KGBA.fGHAhAIA..hBGA...,2,-13,-6,7
SAXPeZQDdcLWbEKIYVgCNRfTMaBGHFJOU,eAAAZAAAdAEALAEAEAGA.KBCA..ICAAVCEA..CBHAREFAMBIBhABAGFABHCECFDDHOCCBhACAAAAA.QEEChADADGHB.bGAANIAB.aEBH.BEHD.SGGAhAGA...hAFA...,2,-20,7,27
MdFEAQfBTHaKZPVGJWeRSIcgXODNUYLbC,QAAATAAA.HACAZACBGAEAeAEERCDASAHBIAGAXCGAhAAADCHBUEGBbEBAdECAhAAA.AEFBaGCEKCADPEHBhACA...WFFB.OHCANIDBCGHD.MIAAhAIA.....hCAA...,2,-4,9,13
gDGaIFdBNWQUZcKYAJfXSVPCOMLHebRTE,XAAASAAA.CADA.MADAHAEB.RAGB.EAGAGCCAFBDABBHAQDAAhAAAZCDAKDHBAAAAfDHAhABAOEEB.eEFBhADAbFGD.TGAA.aFHDdGCA.....hAGA......hAIA...,2,-18,0,18
EMAQIFbPXSULWNGdJOYaZDgCfHeTKVcRB,QAAAFAAA..bACDSACALAEAGCEAdAFAOAHBhAAAZCGBCECAHCDAKFAARGCAEDAAAAFA.hAIAXDGA.UFBAhADANEIA.aEFCDGGBfGGA...hBAA......hBIA...,1,4,-16,20
dbeXSBADETOcIYHgGMfaKFRPUNWCZLVQJ,EAAATAAA..OACC..IADAHAFBGCCAaAEDRAGBUCABhAAACAHAZEAFLDHBhAAAQDDAbEFBeCGDBHADAAIBDDIBhACAgFDHMFGBFGAAWHFA....hAEA......hAFA...,2,-5,-1,4
FKJbSZLdgMTNcaWHPXBYDRGUfCQEVAeOI,eAAAFAAAKADA..SADAdAFA.MAGBTCCA..aAHBHBGBhADABCCARECAGFEBhAHACCEAECHFAAAA.OHFE..hAIAbEAA.ZEEA.gGEA...hBAA......hBIA...,1,-19,-21,2
NCPOBbdfRgUIDAeLaKTYJMHVGFSEXQWZc,eAAAaAAA.KADA..TADAMAFAHBECGAFAECCBQCCChADAZDFACBHBBEDAdBHA.REEBgFAAhAFADFFAAAAALHDAYEHBhAHAFGGA...SBBD.WFDDhAIA.....hCAA...,2,-20,9,29
OYgFVRbDCBHQeIKNTZaEGLfJcAMUWXdPS,MAAAXAAAdAEA..OAGBFADARAFF..CAHB.HBBB.eAHHKBDDZCGBhAAAEDEBGEFALDEBfDHAhAHAADIBUGGA.SEBAhBAA.YFDB...hABA......hCAA...,1,3,-32,35
MZOKISRLBcJaNCbeGfdWUYFPAEXHDTVgQ,HAAATAAAQADC.ZAFBKACCRCAALBHBBAEAaAFDCAHAeDEBhAAAdCCAUDFAFEGHEFAADCIBMFIBhACA.SFCAhAFAJEDB.NHCB.fFHA...PHAChAAAAHHB....hAHA...,1,20,-37,57
eMGNPBcdDRLgEfAQTJIbSHKWFZXaYVOUC,TAAAJAAA..SADBHACBFAEAaAGD..OAFAeBHHGCEAhAAABBFAdCCAREBAECABABIBQCGDhBAAKEHBZGDA.XEDAhBFA.UGGAMIAA.cGGADHEA.hCAA......hCBA...,1,16,-32,48
MdOUCTWAJaDPcIYRXKSQeZGBfHbEFgNVL,aAAADAAA....IADARACFSAEB.eAGBGAEAHCDBEAGAhAGAFDGHVBBBdFDDCAHBABIB.JFHBhBAA....cDFDhBAAKGCD.ZEDF.bFGDNBBAMIDAOHCC...hCAA......hCGA...,1,-9,-13,4
RMfeUQAXZDOGdcTVbBgWJPCNLaIKYFEHS,ZAAAGAAAdAEA...TADABAGAJBHB..CAFBaAGDKCAA..FCFDHCDChAAA.RDGBeDADAACA.hABAODCB.bFFDgDDDhAGA..PEEBLEBB.hACAEEHFMAIBQGFChAIA..,2,-32,-2,30
FZNBAPXVGQdIMbEcDYgRSWafLKOUHJCTe,XAAAGAAAdADA.MAFAEADA..DAGARBFA..aDBDLBFA.hAAAOCDBHDDATEGAhACAeDABZDGBADHAQFDBhBAAbEEBgGBAfGBAKGHB.CGGDNIEB..hBCA......hBDA...,2,-5,-1,4
OeUFHBMEbAXISNZDGCagPYfJWTcdVLQKR,SAAAZAAAGAEAaACA....gACH.fAFAhAAATAGAdDDALAHBhABARDGBeFFBHGAAEBGFACEBXDDAhAFADCCBCGDB.PEGB.YFHBhCAA.....hABA...,1,-7,-15,8
AFRgODLafcJBdMZGXCQUIVbeWKYPTSHEN,RAAADAAALADB..aABEJAFAdAEAGCEAQAGAUDGA...hAAAICCAeCCDKFBATCFAhAGAHGCCAGGA.FGHDfDEEhBAAMIAA.ZEBA.CDHAbFGB...hABA......hAIA...,1,-6,-17,11
OTIKYcPUafSbDXAVJgBFRLCWZQEdMGHNe,VAAABAAARACA.LAFBZADBdAGAHCEB.eBHHTCAA.KAHBPDABhAAAUECA..aCHHbFBAhADA..AACA.FDCHQEFChAAAEFGAMIAANIEBOFHD.IHAAhAHA......hCAA...,1,12,-26,38
DHVcTRKAYMaGUPQfSWNJBEdFXZIegbOCL,aAAAGAAA.QADASACHJAFEEAEAdCGAZAGB..eCDBOBBHhAEALDFDHCEBTECAhBAAAAABMBIB.UFGAfFHAhACABDHAXGBCIHFA....hADA......hBCA...,1,-2,-16,14
UMbTVaINOZRQPSLDKcXgGeFBHWYfAJCEd,EAAAdAAAMADA..bACAaAFE...OAHDRAGBQCCALBDBhACAKCFB.XDAChAAAeCBFHCFBfDHAhADAACFBCEHATGGAIFEA.ZGAADFFBgGFAhAEABHDA.....hBAA...,1,6,-17,23
EfLIWAHGTdYURgXaOKMBbNeVZPcJQSFDC,HAAAdAAARADA.aACAMAHBBAFA..eCAAZAGBJCCAQCEA.DAIBhACAEDHFLEAAABIBGEEAhAAATEGAUFAAOFCFhAFAbGAA....PEEBFGHB.fGGEhADA....hAEA...,1,-7,-9,2
dCGNVMUYDbPTOgcLKRFaHWeJZfSIAEBXQ,EAAAQAAAGACAMAEADADA...TBFAOAEE.LAHBhAAARDFAHEBAeFFAZBDASDDAhBCAAAIBdHBBCCBD.UEGAhCAA.bGFC..........hCHA......hDAA...,1,-4,-20,16
MDSgXCYfLUWZaeRPAFKIHOJGdNcTVBQEb,KAAAHAAAGACAdADATAFAQAEA.EAGAbCAC..DBIBXCEDhAAACCAALDFBZCGBRFAAACHBOEABhAAAJFFF..NDIABAHBhACAMEEBSFHB.fHEFhACAaGDD....hAEA...,2,-19,7,26
MHJFVLcKgfBEeRZAGWPSOQdCDXUINYabT,GAAASAAAdADADAFAUADA....IBFAaAFEMAIBHBGBhAAAFCCHLCGBKDDABEFARFDBhACAAAAAODBHQFGAhAIAXEDA.bGAA...TGGA.hBAAcGEC...hBCA...,2,-20,-8,12
SJWTbZQEDXBIFcMLUAYHRGKedagVNCPOf,HAAARAAAeADEaACA...VAFACAGBOAHD..SCCAhAAAJBDB.bCEDECFBBCHAFDHHMCCBhAAAACCAGEGA.dFAAhAFAgEEBfGDAZGCAXGEDIGHAhABA......hCAA...,1,9,-22,31
ZdNLPUfceHWSRGCMYBbTXgJAaFKIVEOQD,aAAAKAAAEACE..QADAdAEALAGBUAGAeCCBHCCA.RDABGDFAhADAMAIBBEEA.TEGAhAAAXGBA.ABBBFFEHhBAAOGBADEIB.PGECfHGF..hBFA......hBGA...,1,-5,-18,13
VbTKRBJDWGMPQZaYLHAeSNCUOIfEgFdcX,eAAACAAAUACAOADC..EAEAdAGA.XCCA..bAGDRDEFDAIBhAAAGCEA.MCBBhAAAZDGBaFAAHEGBACCASFCHhABAfEDEFGBA.......hAFA......hCAA...,2,-23,-16,7
KUMVRNTbOGYaBJCQcEdPZLgSFefIXAWDH,HAAAMAAARACATAEA.GAGAaAFABBBDQCABdBGDZCDBLDGBhAIAFCEHeDCFXDFDhAAA.AAIBKEADNDIAbFEDOEHDhACA.CGAAEGGB.......hBAA......hCAA...,1,20,-27,47
bRMVXSgTPEIcLBNFOGAKUZeYaDHCWQdJf,ZAAAeAAAaACAHADA.QAGCdAFA.JCCBRBGFMCCB.SDDAhABATDFAEEDFLFBAhAHAFEHDAAAAKFAADDIBfFFEhAFAbFFB.........hAIA......hBFA...,2,-25,-5,20
CROfFKWeLSIXHVaYQTcJMGbZBUPdEADNg,DAAACAAARACA.FACD..eAFELAEA..XBEAHCDAaAHDQCAAhAAAJDGB.GCGAhACAZFAABFEAdDDAACIBOBBHhAFAKFEASFHH..IGHAhAGA......hBAA...,2,-31,-15,16
VJSWdbMBKNOcRQfegFTHaYPGCADUZXIEL,ZAAAEAAALADASACEdAHABAFAKBCD.OAGDRCEA..eDDBTCDAhABAHEAA.aDGEGDFAhAFAAAEADFFAUGGAXFCAhAIAJHBA.MBIB.........hAAA......hBHA...,2,-18,-6,12
dMZAYDPSVIUEQXGWeHCTLRbcfFNJOgBaK,DAAASAAAUADA.EADAGAGA.HBBBTAFARDEB...bCCAhAAAFEDH.ODHDaAHDdDAAhABAAAGB.PDGBQGGChAIAeECBCEEDLFBB..fFHAhADA.JHAA...hBAA...,2,-15,6,21
UHWRDaXGJBTMFNYAVSKEcbZgIdOCfQeLP,KAAAEAAAZACBdACA..CAEA.eAEALAGBHBFCRDEA.DCBBGCDABCEDMDIBhAAAFDHDAAIB...SFAAhAFA.bFGDOEABhAAA.QFFC.PFCBhAEAaGFB......hBGA...,2,-31,-5,26
FSQIfJLGabYKcUMHWRgZXDdAVeOPBNTCE,eAAABAAACACAEADA.FAFDQAEA..fAHAGBGAaAHFhAAAKCCAUCAAHDEARCDBZEAEhACAdDHAAAAA.OECB.hAEATGDASEGDIGGAbGBAMFFB.hAHA......hCAA...,2,-17,-4,13
UTMQZYgSCPJdDOLcBWNFfAGabREVKHeXI,aAAAEAAAHACA.eAEEXACDUCCBMAIBZAEA..SAGEhAFA.CCEAdCGDLCFBhAAABDDDFEFAACHBREGFKFDATGGAhBAAYHAA........hAHA......hCAA...,2,-26,-11,15
PNMeXbHIQSFaOWKBJLVDfGRUcTCZgYdAE,EAAAMAAA..eACAHACCQAFAaAFA.KAHBLCCADCCARCDAUDAAhAAATCGAZDFEdFGAAAIBXEEAhBAA.bFGDFHDAhADABGBA..........hBBA......hBGA...,1,-9,-21,12
AZCVTGBYedILfSQFRKJEHcagODbUMWXPN,ZAAATAAAGAEA.eAGBdACALAEA.QCDAhAAARCAAEDGBHEACaAHDDACAMCGBXEDDhABAAAFABDHA.fFDAhCAAKFHBcGGCbFFAPHAACHDA..IHFAhDAA....hDBA...,1,3,-16,19
WUBCMcagdNSYPXTfVKADLGbHJEeQOIFRZ,GAAAHAAAEADEeADAQAFCFAGDRCDA.ZCAABCHAMAIB..aDAHdDFAhAAA.SCCEhACAXECCTEGAKDHDAEEALHAAhAHAbFED.OFHDIHHACGGC....hAAA......hACA...,2,-18,10,28
UbeCVHDAINRMWSEFBfGLJdZOcaYXQgPKT,RAAAMAAAEADE.BADAGAFAdAFAZAGB..aAHFQBBCKCCA.UDDAhBAAeDEFHEGBAAAAIDHAhAFASECDLECBhBHAOFBHXFFA..TGEA.hCAA......hCCA...,2,-16,-10,6
RGXIDbfYJAZPQVCMeOcgHWaKBSLUNEdTF,ZAAAQAAAMACA.eACAOAEEHAFAKBHBLCDB.ECFBdCCDhABARDAAGDGADCFB.bFEDhAAAfCGEAAHA.hADACEED....gEGAaCHFSGHHhCAATGEA.FHAA.IHHAhAHA.,2,-40,22,62
ZLOSBbMYEJDcPaHRUTWfIgKeCXGAVNFQd,FAAAZAAALADBBADA.MAFAEAFADAIB..aBFAHBGBRCAB.TCCAhADA..fCFAhABAKCECeEEBGFABhAFAABIBQDGAdGGAOEHFbFCAcGFD...hBAA......hCAA...,2,-12,-11,1
SMQZcXYWEKHdINOAaBbDfRUJgTCVGePFL,aAAADAAARABA..UADA..TAFAGAGAeAHHLDBA.MDFBhAGAZCDAXEAAhAEAEBBBHFBAdFHAODHDAAIBbGDAfEEAhAFA.CFGDFHAA.SHEAhAHA.....hBAA...,1,-9,-10,1
gWfcCSZXObVBaJQIAYUTKHGLdMNDRPFEe,TAAAHAAAdADA.MAFARACFFAEA..EBFAeAGH..fBHAhAAASBHHZCAAOCABhAAAbDFAaEDDQDEChACA.ACEAKEGAGGDBDGGA.gFBFCHHA.hAIABFFB....hACA...,2,-9,-1,8
YDTNfMKAXLdJbBcOWIUgGEHSPeCRFaQVZ,dAAABAAAOADAUACAGAEBHAGB..eBDBRCDAFCBHaCAE..ZCGBTDFAhACA..MDIBhAAAAAIBLEBBJFAA.bFCDhBAA.IFHAEFEBCGGA.YFFFDHAA..hBCANIAB......hBEA...,1,-7,-22,15
FHgQTdIbJcGKMReEPBZNLXCfWUOSDAaYV,aAAAFAAAHACB.QAEAdADAJAFAGBEARAGB..EDEAZCGBLEAAhAEACBBDUDBA.DDIBADIB.gEFAhAIA.bGEAhBAAMEEB.eFHFNIBB.fGCA.hBIASGEH.hCAA...,2,-21,-1,20
CPQRNaIHLSGKYOAfbcMWTgVUeDdJZXFEB,...bAAAMAAA.TADAUAEAeAHB.dCAAZAFBECCBCAHARBBBaCFEHCGBhAFA.GEDAOEBChAAAACIBfFFBhBAA..gEEBDFCBFGHD.QGBAhABA.LEGBhACA...,1,-3,-7,4
MXHYNFUEILWJfBcSGdACKVZDeRbOQTaPg,KAAAZAAARAEAQACC..aAHDMAEAHCAAFAHDECEBLBFBhAAA.JCDBBCGDGDGAhCAAAACADDIBeFCAbEAATEFAhABA...PHAA...YEEFhAEANIDB...IGHAhAFA,2,-22,-8,14
QIfKCFUdWTMbERVGeNAcZJOPLYgHDSBXa,ZAAAOAAALADBHADABAGBaAFA.QCCCKBFAFCAA.dCFAMAIBhABARDGFeEEB.AAIBJFAAPDEChACADBBB...XEGAhBFACCHBUGGB...TGGA.EHDA..hDAA......hDHA...,2,-21,-6,15
HGNXSEZVJIDCULaPdOQAWKFTBYMfRcebg,FAAATAAAMADA..RACF.eAFAHAEBGBCASAGAEBEB.ZCGBICGAhBAACCADLEAAdEEAABIBhCAABEEA.fFHAhAAAbEFD.XGAADDIBaEHH.QGDAhACA.....hCBA...,2,-16,9,25
QeZgaJHEUFcSANYBRTCIOXDKdPfVbWLMG,BAAARAAACADB.OACAKAFA.dAGA....VCCALBCAGCFAeBHHhAAAZFAA.aDBAHFGBEDFBFEDDhAIAAAAA...TFGAhBDADAIBfCHE.MFCAQGBChBGAJHAA.SFFDhCAA.NIEB,1,-17,-21,4
CIWMgURcdYPOXNJDQFVeBTZLSKAaEGHbf,EAAAHAAA.CADB.MADARAEFdAGAOAFE..XCAADBCAQCCAhAAAeBHHZDCBLCFAhAIA.ACGAbEDAfEEAhAAAgFGHcFGAYHEAPGEC.NIAB..hCAA......hCBA...,2,-16,-3,13
XYSAQZJcaPOUgRbLTDNFIGHMdeVKCfBWE,ZAAAaAAA.OACARACF.LAGBDAEAFAGDHBEBeBEF..KCCDBCHAEDFB.hABASBBD.hAIAAAIB.QFFBhBGA.PGCCbECBTEFAIHHAdEHACHHAWBHHhCAA......hCBA...,2,-21,-20,1
PLfEVeaCOTGHNFAUQWXdDYgbIcMKJSZRB,QAAAdAAADADA....bABDMADAKAFA.ZAEEBAHBLCDAhAAA.EBHFeBEBaDBBTEEAhAIAHCGBACGBXDCAhBAA.IFFASDGAfFHAhBDAOFCBFFHB....hBCA...,1,-11,-21,10
FQAEXRfSDOdUgYNJeMKHWCVIBZcaTbPLG,RAAADAAAdADAUADA....NAFA.eAFAHAGBCBBABBHAZDDF..aCCH.hAGA.TCFALEHBhAAAGDBAAAGBEFFE.SGDDhABAODDFJDHBKHFAIFFA...hAIA......hBIA...,1,-13,-31,18
OaSUNFJMHTbZgDBIfGePQcECARVWKXdYL,RAAAKAAAdADALACB.OAEAaAFAUBGBFAHD.HCEBZBDB.BCCDGCFAhAAAeDGH..QFCAhCAAEEDBAAAA.XFGDhCBASEHHMDIBbFBDDFFB....IHHAhAIA...hCCA...,1,-13,-16,3
SGPeEWROUAfgZCQJcDXbLYVaMKNBIdTHF,ZAAAQAAADACALAFAaACE.KBEDBAFA.dAHAHCFAGCDAECCBREEBhABAACDBCCFA...XDAAhAAAbEGD..MGAAhAGATDGASHAAeFABOFCD.fFFAhADA...hAHA...,2,-18,-6,12
KUbXAdPcTWfHBJgFaOEIeYLSGQDVMCNZR,dAAATAAAHADA.BAGBFACA.EBHFeAEHLCCAGAGAQDAChACAMCCBZDDARFDAKDFAUGAAADIB.hADA.PEEBfFHAhAAAaFAEOFHBSHFGCGCANIAB.....hAFA......hAIA...,2,-2,4,6
DdPCURBOXFafWQgANSZeIVGEMTLJbcHKY,ZAAAeAAAGAEAEADALAGBJAHB.HBDCDACAdDDACCCDREDA.BAGC..hABAFDHD.aGBAQDGBhBEAAAAASGEAMCCB.hAIATFFAKHGA.....YFHBhCAA......hCBA...,2,-25,-7,18
bLYCdQgHDOKaIfGJRWUZNTEFVSeXAMcPB,MAAABAAALACAdAEAHAGBKBBAaAFD..GBGARDBAZDFA...ECCASFFAhAGAAADA..hAIAbDEDQGBAhBAAOEDBfFHAWGFA.NIAB......hBBA......hBDA...,2,-18,-18,0
RAPFLSdYHbXMZWIVacTJQOUNeDCGKEBgf,LAAAdAAAHADAMAFAZADB..IAGAaBFE..TCBAQCAAhABAOBHDeAHHGDEAhACAEBFBfDEAhACAADABSEDDbEGBXGGAcGFC.....hCAA......hCDA...,2,-13,-2,11
BcLDUJdWCaGPRMgVQSKITXeYFNAHZbEOf,HAAAEAAABACALADBDAEA.dAFA.aAHBRAFAMBEBQCAB.KCHBhAAATCGAeDEFFDGHACCAZEFAhAAAOFBBUFCACGEBgFFGhACA..SGGB..hAIA......hCAA...,1,6,-33,39
UbTeYdWGZKVfcBRPgELXAMDHOCSFJQINa,HAAASAAAQADC.aAFAbACDeAHHdAEAZAFBKBFB..fCAEhAAARCGFEEBAAAAA.MCCBhACACAHAFEEBJDDAUFGB..hBEATEGA.YFFF....hDIA......hEAA...,1,-5,-15,10
KaFVUXZPSgceHDEbfLTMQAGIOdWYCJNRB,GAAAdAAACADA.RADAKAGCFAFA..UCCAZBFE..SCDD.eDADhAAAHBEB.EBHFbDFATEFAhACA.ADAAODHFhADAYFFABGCA.aGHHXGDC.PHFChACADIAA....hADA...,1,-16,-24,8
EeJKVURMGCBfSPaXgQdLAObINTWZYFHcD,OAAA..bAAATADAZADBHAFA.ECAAeAFEKCFD.RBFBGCCAhAIABCHASEEAhAAAaBBHQEFBAAHA.IGHAhBAAYEGBDCIBJHCAMHCA.....hABA......hACA...,1,-2,-21,19
LbQWBCeDHadEZYgJfTUAOKcIMRFSPXVNG,KAAAMAAARACF.FADD..SAEB..XAFAGAGALCABhAAAbBBDBCFAeBHHhAFAHCDBEEGBZDDF.JFDFTGAAhAGAAAGBOFFB.IHHAPEHDQGFDhAIADDIB.aFCF..hBAA...,1,-6,-14,8
LXRUEAgPbSVZBQNceKJDTdWfHIaOGCYFM,...bAAAZAAA.QAEAeAEADAAAdBHAHAGD.aCAAGCCBFCEHMCIBhABAREAAAAEA..SEFAhAIABDAAKDGDTFGAhACAIGCAODDHLGEAXEAA...hCAA......hCBA...,1,-3,-12,9
geDJYdUFSVfaKPOMcIBALRNTGQbZHWEXC,RAAAGAAAZADBHAFAEADACAFAeCCD..DAHBdCFDFCDASCHH.hAAAaDABOBHD.MCGBhACABEEAADABLEEBhADATFGAQGECbEGD.WHAA...hAIA......hBAA...,1,-1,-23,22
YKebQTIFUPHdSMgfaWJGCEONBLAVXZDRc,ZAAARAAAKADCeACE.QAFCFAFDHBGBdCCAMAIB..aAHFGCCBhABA.EDGFBDFDAEFBDEIBbCDDhAAATGGA.IHAAhAHASEGA.fGGACHCA..hABA......hCAA...,1,-3,-31,28
NCFIRXJdcEUOAVBQKMZgPbeLTDGSHYfWa,QAAAZAAA..bADBeACALAGBGAFAHCAA.fBFAhABAaAHFFCDBRDABdDHAEDHFAAIBhACAKEEAMEEBTGGASFBAhBFANHBB.XFFC....hCAA......hCCA...,1,-3,-9,6
eHZUSVOcRCPaJYXQdWDKfLBFbMAGNITgE,GAAATAAA.EADAHACBZAFBUCDAOAEARCGF.aAHD....XFBAhAAAdBEAKCADLDGBhAAAFFFBAAIB.gEEAhACAeEHHSDADCGCA.YHBADDIBBGHA.hACA......hADA...,2,-11,-2,9
GZcJBdQRLKIXaSUbgMfWeYCADPTVNOEFH,TAAAOAAAHADA.ZAGBBACBRCCBLCFDXADDUEGA.MBBBhAFAeAFA.AAFADBIBPGAAhAGAECCBGCFA.hBAAdFDAIHHAbFGDWHCA......hAAA......hCAA...,2,-20,-3,17
cYQeXPMaZfRAHGDSKCBdTEVOWINUbFgLJ,HAAAGAAAKADCdADAEAFAOAFA..IBHAUBGBFCEDLCAAhAAA.JCEAQDGDhAAAeDEBMDIBZDBBAEGACGFATFGAhACA..NIAB........hBAA......hBCA...,1,-14,-19,5
CHBdOEQbGLJUXcNMFaIKDPTVWSZfeAYRg,RAAAHAAAdADA.EADEGAFALAFBUDDA..XCAAMAIB.aAHBDCCBhAAA..TDDASDGHhABAeBHHAEGBCFAAQGGAhAFAbFCANEIA.KHAA.......hAAA......hACA...,2,-17,-6,11
dNCLgQFHJPKIfMOaYXTESDZbVWAeGUcRB,eAAAGAAARADABAGBdADALAFA.QCEAHCCAKBHBMCGBhAAAaCGE...TEAAhABAEDDBZEGBVFCAAAABUGAACEEBFFHBhAEAIFFA.OHCASGGDDFIB.hACA......hAGA...,2,-7,-6,1
dNKYURDcWQfTCJIOEPLVeZAFBHSbGMXga,HAAAGAAAMACAaADAdAGAKAFARBDB..DAIBQCFCCCDA.OAHDhAAAECFBLDHBZEFEACCBSDDDhAHAbDBD.XGGAhCAAgEEBYHEAWGBA..fHEFhAAA.IHHAhACA.,1,2,-30,32
BgTEGJIUeRZLcPMDOVHafbWFQXKdANCYS,CAAABAAA.EACAGACAUAFA.RAEAZCAFLBEDMAIB.DAIBHCEC.aEAHhAAA..bCAAFEEBQDFChAAAdEHAAFGA.SDHBhACAgGGGTFGAeHAA.OHBA.hACA......hAEA...,1,-4,-14,10
ZNJSgcWMbOCFTHGXUERLdBDfPeQVIYAKa,ZAAASAAA..gADBMADACAGAHBCAGAGAUCGARCAAdDEAhABADDEA.eDGDQEBAhAAAIFAAAAIBaEEB.JFFAhABAbGAA.FGGH.........hBEA......hBFA...,1,-4,-20,16
RcebKIHZEOACfDWFYPMTGSgVBQNaLXUdJ,DAAAFAAAMADAGABB...SAEEBAGAaAHDLBDBdAHARCCAeCFGhBAAKBFDHEEAZDFBACCAfFHAhBHA.PHEChCAA...........hBAA......hCAA...,1,-3,-49,46
eXZEfTANSJgaVICBLPRGQDcdOKHbYMWFU,SAAAaAAA.CADA.LADAGAEAQAGAdAHAHCCAbCFDMCCBhAAAFDHF.UDGAZEAAEFEBhAEAADAAJDDB...gFFGhABABBBDDGGAKHBAeGAE.fGEEhADA......hAGA...,2,-12,-8,4
QeZWJSfcaXFHCdEOBIPYUKgNbMAVDRLTG,RAAAGAAAeADEZAGBSADA..aBDDHAFBEDCB.BAHA.ICDAhAAAPDHDKEEAbDEAAADAhACALGAA.TGEAhAAAQFDA.fFGEFHGECCFC.hABAdHAB.....hAGA...,2,-11,-3,8
VcObKgFPAELXGHaZQJISUeMDdWNYBTfCR,EAAAGAAAHACAZADAQAFCSAFEeAHHdCDA....NAIABCFDhAAATCDA.RDFBOCCHhAAAKDGBFEAHAEFBaEAB.IGHAhAEAMFGBDFIBfHABCHCA....hAHA......hCAA...,1,-1,-23,22
McbHPRFYTVAdSLZOWaJUXeCQIDNKfEBGg,dAAAZAAAaACAUADA..eAEHQAFA.DAIBfAGAhABAGCABMDFAHCFC.REEATGAAhAGAAEEALEGBOCCBhAIAJHBACFFAKFHB.EGGB........hBIA......hCAA...,2,-23,-2,21
KCaLJHXMSUcRQTbPdeEOZIWAfBFNYgVGD,FAAA..gAAAGACACAEALAGBHADAMAFAUEAARBFA.QEDAhAEAbCCCdDAA.EDHFZDEEhAAA.ADIBBFFA.YFHBhABAKFHBaFFDSGBA...hADA......hBIA...,2,-16,-4,12
YRbaSXAgQMHUCGeTDLfFKPZIcNdOEVWJB,MAAAHAAAGADADAEALAHBKAFAZCAA...ICGAdBBAEBEAVDCAhBAABAHBREFA..aCGBACIBQFAAhAAAUFFA.hBDAeFDBFEBHPHBA.NEIA.....hBEA......hBHA...,2,-11,-8,3
XGTdZVDAgWcNOUIYJfSRELMHPeCKBbQFa,....gAAANAAAOAFA.UADA.JAFERBBAEBEE.HCFCeBHFhAAABDDAQDBAhABAaDADGEFAZDEBADEB.IFHAhBDASFEDMIDAKGBAbEFD.FGCB...hABA......hACA...,1,4,-18,22
FIUQLNRcMCHPbWVfEGTaAYZDKOSBJgdeX,ZAAAOAAABADBdAEAeAEHFAGA...QAGARBCB.MCABHBFBhBAA.bEBAVCFB.ECCBhABAaBBHADIB.KDHB.SFEHhBEAXFFALGAACGGAfHCB..hCAA......hCHA...,1,-10,-20,10
XOWCQYVJKGEcgabTZdeHPRfIBUADSNMFL,SAAAMAAALAEAOACDQBBA.JBHBEAEA.aAGDZCEBhAFAHCDBRECBBEHAAAAAFCHDCFGDKGAAhAGAGDFA.bEABTGEAhAIAeFCB..fFHADCEB...hBAA......hBBA...,1,1,-13,14
BbOTXWAaQJICSYVNEZdKHDLcgGFMfUeRP,aAAAQAAA.CACA.SACH.VAEAEAEAdAHAHCDALBGDhAAAGCGAMAIBhAEAeCDBREAAbFEBTFEA.hAHAADHAIGHAYBBFKGGDDIEA.....hAEA......hCAA...,1,4,-18,22
QIWOFJgfRBcZYTXeUdPbADaEHNMSVGKLC,EAAAHAAA.MACAGACALAGBQAEAOBDCFAGE.JCBFRDDAZEGBhAAA.TFBAeCGFdEEAhAAAAAIBaCCCSCHHhAEA.CFDCgGGABFFA.....hBFA......hBGA...,1,-1,-12,11
faHJcWLESGVPRBQdNYOKADMFZeCbgTUIX,MAAAeAAACADA..TADAUAFA...XAFBHCCAJCHB.LECAhAAAEAHFGBBARGDAdGGAOCHDhBAAAAIB.ZDEBIHBAhABAaEDBSFHD.BGFA.YHDAhBBADDGB....hCAA...,1,-13,-17,4
WZJMLNQUDdYgeIRAfOVEabcTGFHPXCSBK,OAAAEAAA..aACDTADAHAEA..CAHBKCBDZAFBMAIBLCEAQCCChAFAdEADeCHHABBBVDGBhBAAGEEA.XGAAhAAABEEANHBBDGGBIGHAfFCBFDDH...hAEA......hAGA...,2,-10,2,12
JBfTcNMGeAHWbPZgKDIQFCEVLXUYaRdOS,HAAA..bAAAZADBDAAAQAFAFAEA.ECABLAHBUDFARFCAdCCChAAASBDHBAHATGGAhACAMCCBABHB.gDEAhCAACEHB.XEGA.aFCD.fGGAhCBANICB..hCFA...,1,0,-32,32
KRZYfEQBILdVGAaCHTJWXbUSNDcFMgeOP,HAAATAAAXADB.UAGADACAMAFAeBEHKCADRBDAZBGB.ECCBQDFAhAAALDFDGEBAhAAAACCAaDDHCDHA.JEHBbFFA.hBDA.NEEA.FGBA.........hBEA......hBGA...,1,1,-9,10
YSLWgebRPQIKJVFDBHNEAZUTOdaGMCfXc,ZAAATAAAaACA..GAEAMACA...XAGASAEA.LAHBhAAAeCCBRCGBQEEBhABAKBDDFCEDHDFBAAGAdGGAhCAAfFHA.cGCA...YCCFhBHA...hCBA...,2,-14,-8,6
XWKZaGAgYENeVRBLJTQICObUdMHDFfcSP,EAAAeAAARACA.LAEA.QBCDOAFAdBGDHCEBFCCHSCFDhAAAXBGAZDGFADAA.gFAAhAAA.YDDFhABABDGBTEDAbGFCMIAAfEHAhADA.cGFA..hCAA...,2,-38,21,59
EbBOYgQUGfedVDJNASKTCHZIFXaMLPWRc,TAAAHAAAZADB.XAFAaACA..MAFALCCDRBDA.ECABbBGBhAAAOBHD.QDEAhAAAGDBAeDDAdEGADFIBhACAACIBCEFAFEHDcFCDBGGDgGAD.hBDA......hCAA...,2,-10,11,21
BXeZCTOWbgFfENdMGJHPALISRDYQcVaKU,LAAARAAAQADCaADDBAFAZAFB..TDDAOAGD....hABAbBGDfCAAhACA.ECCBdFAAGCEAhAFAHFCAAAAADAIBcFFAKDHBeFHBCCCDFHFC.MAIBIGDAhCAA.SGFHhDEA.,2,-19,7,26
IGEQdYJRODUKBWbfSZgaPTHeNLFAXVCcM,CAAAMAAAGACAdAEARAGBDAEA..BBBA....bAEAZCDA.aDBBHCABhAAALEEAAACB..hAGAXCFCIGCAEDHFhAIAQGGAOEDCKFHB.SGCAhBIA.gGEHhCAA...,1,-19,-26,7
ZDCfPRWeYJLFBgOTVGIcHabUNQKMSdEXA,ZAAACAAARACA.eACELAFBBAFB..OAGDGCAAHCCCaAHB.UDGBQCCBhAAAMEFB.ECHFAAIBDFCAhABA...fGGAhCAAPEEBJFCB.TGFA....hACA......hADA...,2,-21,-12,9
RPMJcUVGSbdQWALgXDYIONCaZHfFETBKe,LAAADAAAOABEaADDHAEB..EAFATAGAeAHFRCAA..MCCBhAEAUDEAGDDAdEGAACAAXFAAhABAIDGAZFGBBGHAhACAKGAA....cGCDSGFF.hAFA......hCFA...,2,-15,-9,6
AcPdISgFLGfVMQeYaBDXTORUEJWZHNCbK,dAAASAAALADAGACAMAHB..eCAAaAEADAHB..TCEAhACARBEFECHFZEBAHEAACEHAAAAAIEGAhAEA.fDDEhAFAQFFCXFFC.UGCANIAB.hAIAKGHB.....hBEA...,1,7,-20,27
aLJZDeFQWcANgdbHXfPTMVIGRECUOYSBK,dAAAHAAA.XADBTADAMAFAGAFAEBFAOAHF.BCADaBHDZABBhBAAeCCBQDCAhCDAADHBbEDD.fDGEhCHAVFFARFBFCHAD.SEEB.KFHBDIEAFGFD.hAAA......hACA...,2,6,6,0
CaODSbVTAUgKIJNMYPRLFdfGQXcZWEHeB,KAAAJAAA.MACARADF.LAGBdAFAGBGA..QBCAZDAAHEEBeEHHhADAaBEEDAIB.SDEHhAAA.bEGBAAHA.hBAA..UFBANIBB.FGFB......hBFA......hCAA...,2,-18,-18,0
CRNHaIOQGYFbTDPMVZfXAgcEBeUSLJKWd,EAAAeAAALADAKADAdAFA.RAGFHCBA.aCFHQCCA.GBGAhAAAbEAADCIBMDFBZEEAAAEAhAAABAHBSFHHhAIACFHAOGEETGDA........hBCA......hCAA...,1,-1,-26,25
WfNARcFMOPKBLgCDYUZHaGQSdbIeEJTXV,RAAAMAAAKADCLAGBDAEAZAEE.HBDCGBBAdDDA.eAHHEDHF..JFEBTDEAhBAA..XGBAhAAAfDHAAAIBOCCHhABABEDDCFGDUGGAaFHDbGCA......hBBA......hBDA...,1,-5,-17,12
EMPFXefICBZHJQcLdaYKTSbANGWUDOgVR,GAAADAAAOABERADAEAGE..MAEAFCDH..eCFACAHAHBDC.QCGAhBAAdEADaDGEKEFDTDDAhBGAAAABUGCA..gEGGhCAAXGGABFHCcFFC.....hACA......hADA...,1,-12,-15,3
dVcgLZUOeQFKDXGNRSPIbAfWEBYTJHMCa,EAAATAAAHACA.aAEAdACA...VAEALAHBZCEAUEAAeBGFQEEAhAAADCCBGDDARGFA.hAEASFCD.hAHAbFGBAAIBBCHB.MDDBCHEA.....hAAA......hCAA...,2,-8,-6,2
KIWUGfOLXdgbeBDEQaNRCYPJTcMHZAFVS,SAAAKAAAUACAGAEBLADA.dAHAeCEFECCA...aCGDRCEACDHAhAAA..JEHBMEAAHFAAhAAAAEEBFEGH..IFFAhAFAOFAA...XGDDBGHADFFB.YHBAhABA...hAHA...,1,-13,-26,13
QdKUDLWaPfJOVMeZCbNTEHcRYGXgBFIAS,dAAADAAALADAaADA..JAGBMAHBZBDF.CBBA.....bABDECDAhAEA.HCFBRDGB.GFABhAFABFCAAAIBQFFBhAIAKFFB.WEHHOFDDNIBB.TGAA..hAGAcDCC...hBAA...,2,-29,-6,23
HMCTQEVOFLKNGdRbSWfIAcJUYBXeaDZgP,UAAAXAAAeADAZACBHAGB..MAFATCDAEBEA..FBGDLDABhADAGDEAREBBSDCDhAEAIEHA.AAIBcDEDhBAABEDCaGEHDDIBCGGA.QFGC.KGBA.hAAA......hABA...,1,3,-15,18
QbcMgLHSDVWPNJETYKfeaGXOdAFUZCIRB,ZAAARAAAQADCMACAHAECDAFA....PBHDEAHFKBFB.eCCBhAAAGCCBdDHA.AAHACEFABEEAhABA..bEGDLEGDhCAASFCANICB.........hCIA......hDAA...,1,-15,-18,3
YCUDRLNSbKBgeAFdETXOVPMaIJGfWHQcZ,EAAATAAA..OACCMACA...aAEAGAEBHAGBZCCACBDDRCDALCHBhAAASDFHbEFBBDHAhAAAAAHA.dECA.XFGAhAIAIHDAfHFBWCCD....hBIA......hCAA...,2,-17,-12,5
NfVIHXGeLFKDbMdREcAYUTCSJZQOgBaPW,TAAASAAA.ZACBQACCBAEA.aAEA..PAGBhAAAfAHAHCEBeBHHhABALCEBDECBdFGAECGBACIBCEDDOHAAhAHAgEGANEIA.XFBA.KGEAhAAA......hAHA...,2,-16,-8,8
bSgafJdOPXTEARGUWcBCLHVZQKDeNYIMF,RAAAGAAAUADABAFAHADAZAGB.QCDBeAGH.IEFAhAAAMAIBSCCDaCHDdFAAXFGAhACAAAAA.CGCAKHFAhADADDDAFDGD...bEED...fGGBhCAA....hDAA...,2,-36,8,44
QRVGcfBPKaJdCSFWMYIAeUDLXZEgTHbON,eAAALAAAEADAHAFAOADDRCCA.GAFABCGAKDHBdBHAFCAA.MDDBhABAAAAAXEEAZEEA.TFCAhAHAbFAB..QGGBhACAfFHEaHECCHHD.......hAIA......hCAA...,2,-18,2,20
fBUZGWERbNKMQHeaVCXATcJFgdLIDOPSY,TAAAFAAAdADALAFA.DCCBSACBBCFA.GAEAhAAARCGFKDDA.HAGD.eCCBhAEAaDBH.XDGAAAGA.hBAAgEBDOEHD.fEEEZFCBEFFB.hBDAbGAC.MFHBCHHD..hAGA...,1,-8,-23,15
gQIRdaUKeXYcDbMETLJPAGSHfVNZFCOBW,HAAAVAAA.ZADB.OAFCBADBQAFARCEF.dBHAaCACeCDBhAAAXCGBDCFB.EEGBTEGAhAFALHAAADGBGECAhAIAfGGECFFD..IHHA..hCAA......hCEA...,1,-10,-16,6
URDNEaFMWdOQcgYITXeCAVSPBHGbKfJLZ,SAAAHAAAGADAKADALAFAZAFB.RCAAECFAaAHD.MCIBdCCAQDAAhAAA..hABAgDFATDGAeEDFhADAAACABFGAbFEDfFAEDGAAFGHDOHAAIGGAhAFA.CHBA...hBHA...,2,-12,4,16
IFKQTMcJfPDBAOHXVWdRaYeEgUZGNCbLS,HAAAXAAAdADARAFA.eCABEADAZAFBGCDBCAHA.LCHBFCDB.TFFAhAAAMCHB..fDAAhAAABEEDAAFAOCCHhACAaEEAUFBASGEDKFFD......hAIA......hEAA...,1,1,-19,20
eRSUNBPbAOIcVQYEaCdDfWMXZFHGTLgKJ,OAAAVAAA..EADEdAEA.DAGA..MAFAZBCBHBFBGBEBTEDAhBAALDCA.KDGARFGBSBBDhBHABFFAABHAIFHAhAAA..YHCACHHA.fGFEhBIA....hCAA...,2,-23,-23,0
aSHfUDeRGAFZQWgICXcKPEMYLJOBbVNTd,ZAAAQAAA..gADBXACAKAFAEAFELAHBhABABAHBVCEAdCAAHDAADCCBRCFBACDBFDHDhAAACDDA.MEEBOEFHhACAbFAA.aEHD..fFFAeHCEIHHAhCHA......hDAA...,2,-8,-1,7
CBLASfXDJHgaIVRPGUYeZdNEWKMTcFbQO,XAAAHAAAaACARAEFGADA..eAGHdAFBEBGBMAIBFDAAQCCChAAABDFAAAAA.DDHBIEHAhADAPEEBZGAA.KFHBhAGAbFDACGFA...fHGF...hCAA......hDAA...,2,-19,0,19
begfBDAQEdXKYILTMRVSWNPZFJUCOGcaH,EAAAdAAAKADALADARAFF...SAGH..PBHDhACAZBCAFCHDCCBAGDCAHDDAeEABhAAABCEDAAIBQFFAhAEA.XGDCTEGAMDAB.VFEBhADA.JHAA...hAFA...,1,-6,-18,12
eCfgEOSWZFYDbHacMNKPJXGLRIQBVTdUA,eAAACAAA.EADASACAZAFB.DAFAHCCBMAIBKAHB.XCGDhAAARBDAQCAATFBAAACAOBGDhAAAFEFHaFHBNIDBGDEAhBGABBEA.dGGA.........hABA......hCAA...,1,-5,-18,13
JGRUALFXKgCcOfVBEDYbWTSdZPeQIHaNM,LAAAKAAACACB.OADDBAEADAGA..bAFA..SBEAhAAAZCAAeCEHHCGB.aFAAhABAMBHBRFFBAAGA.XCCChAEAfGCAEDEATEFA.dGHA...hACA......hAFA...,1,-7,-40,33
DBTGSdJHbXFKYcOVPAeEaUfRMgCIQZNWL,EAAAaAAA.RACA...MADACAFBZAGBLAHB.BBBDGCDAdBDAHBFDhBAAbDAB.KDCD.ODFHhBFAABIBeDHFUGGA.fHBBhBHAQGCCDEEBTGFASHEChCAA......hCDA...,2,-12,-12,0
WBOePbfZGJUCFLTgdSDHAYNIXVRQMEKac,..IAAARAAAEADEKAFC..aACABAHA.eCCA..bAEDGCFAhAAACAGALBCBdDHAHFDBhABAAAIBXCGB.MDIBhAGA.OECEfGHAZFEE....hCAA......hCCA...,1,-13,-22,9
bUVHSOQGTNDACZYacFgMLJIRPXKfWBEed,ZAAAaAAA.FADALADARAFF.KAHBBAHB.ECAAeBBB.dCFAUDDAhABAHDCB.QEGAhAEAGCGATGFAACHBCFAAgGGGhAFAMECB.IHAA....hAHA......hBAA...,2,-25,-13,12
IJEBTUQgacXSZdFONeKVDfHALPGCWRMbY,GAAARAAAMADA...bADAJAGB..BAHAQBDAaCDA..SCGAhAAAdDHAOCCBeDADhACADAIBHEEBADDALEEAhADACFCA.IGEAEGHB.TGGA..hAEA......hAFA...,1,-15,-20,5
cGdUPbgZTSIOeYNfaQHWXAVEMLFBKDRJC,EAAAMAAALADAKADA.RAGF.CAFBGAGAdCBAUDDA....bBBCZEGBhAAA.TFAAOCDEeGDAhAEA..fEEAhAIA.HFGBACIB.BGEADDGB....hBAA......hBCA...,1,-13,-25,12
NZKDWAOUTXeIYHdSFGaLfPQMJgVbBEcCR,TAAAeAAAHADA.dAGAGACAaBHD.LAEAQCCCMAIBVDFBhAAAECABRCEAZFAADEEBACFBOEEHhABAXFAA.SEHBhAAAfFHAgFFA.bFCD.hAFACHHA.NIAB.....hAIA...,1,8,1,7
YGEHWLTXgAJOcFaUbfPZedSNBIDQVKMRC,OAAAaAAA.UAEA..bACDZAGB.eBBAdAEABAGA.QCFAhAGAMBIBRDDAGEGAhBAAHEBATFEAADDAFGBASFFDhBBADAIBCBBDEEHFLHDA....hBAA......hBEA...,2,-13,-10,3
OFVMfYgWRKASHbQXUZEIedcTNaCLGPJBD,HAAAQAAAZADBEAFAeACAdBHA...TAFAaCACGCEABAHBFCDAhAAAMEHB...fGCAhAAAgCGAKGFBADAAbDAAhADAXGDDUFEAIHCACCGC...hACA......hADA...,2,-7,-6,1
NAFDZfJMbeIHdgQGOYVSPWERcKTBUCXLa,ZAAAMAAAeACEHACCdAFAGAFA.OAHFSAHBEBBB.RCCAKCGAhABATDCABEEACDHDaEFCAEGADEIBhBHA..JFAA.bFDDQGFAhCAA..PFHD.WHAChAFA......hAHA...,2,-27,-1,26
FcURaQDEbXMYOJCIVAZfSBPTeLGKHdNgW,ZAAABAAAeACEGACAHAFBdAEB....gCCAFAHBRBEFaCABDCIBhAAAEAHBMDFB.ODGDhABACDGAAEEB.SFAAhAFALFFAKGDAcGEC.QGGB.hACA.YHFG.hAIA...,1,-5,-26,21
QXUHFAeaPRgcCBNMLfWOSJIYVKZbTEdDG,eAAARAAACADB.MAEALAFA..OAHDSCCAIBDAKCFAZDFEhAAAEBFAGDDA.hABAQDGCHFCAAAGAaFHBhCAAgFBBBGFAWHCGYFHB..hAAA......hABA...,1,-16,-21,5
cIUZSdDHFaeROXPAJGCWTLYEBQVgMbfNK,GAAATAAA.EADAQACCMAGB....bBGDKAEC.IAHAhAAAZCDBdFBAHFDCeBFFRCGBhCAAOHFCACEBCDDDLFFAhCIABAHB.fGEENDAA.....hAAA......hACA...,1,-5,-6,1
BCegRJIEAcXfFDUHaSTGZWQPdbMLYKOVN,XAAADAAAHABCaAEAGADA.ZAFAQBEDdCGALDAAOAHBhAIABDFCeCCBRFFA.EDHFAAAAFGAAhADATEEA.bGEAMIAAhAGA...........hBAA......hCAA...,2,-12,-10,2
fTIOBJXQKNdHLASECFUVZYMRDWcGgbePa,EAAAFAAAZACBRACA.DAFAGAFA..eAHFaAHF...TBEABCCDQDAChAAAdDEDHEBAACIBCEGAhBAAVECA.MDHBgFFGhBEAbGFA.fGBEOHBA...hADA......hAFA...,1,-8,-16,8
IYOVRQLedEWHDSNBKgCUAFXPZGMTfacJb,XAAAGAAAMADA..aADAJAGB..IAGAOBHDRCDBeAHHhAAAEDCB.HBCB.SBEGhABAKEGACFBAAAABZFFATDFAhCAA.bFDB.QFGAWGEGDBFBNIAB..hACA......hAIA...,1,4,-20,24
cOMVEDdBYGTIaKbUfZQCHWRNgLFJeAPSX,XAAAMAAADAEABAGAGADA...aAFAKBBAUBGBZBDBHCFA.hAAARDBBLEFAeDAAAADBSDEHhABAOHCAEGGAdEGAhAIA.TFBA.bGFACBHA...WHDG.hAIA......hBAA...,1,3,-24,27
FUXOagYBRSMcbDZJGQeHKNWTVPAdIfCEL,dAAACAAALACAFADAUAGA..aAFDBBDD..RBGFMCCBDCCBGDDAhACAHDDAKDAB..TDGAhBAAAADAEEHF..OFDBhAAASFCDZFFF.eFGB.....NIBB.hBCA......hBGA...,2,-33,-12,21
YRJHNVecQfOCKbEZWaBUdIPTGALgXMFDS,LAAAMAAADAEA.RADFHAFB.eAHBQAGACCAA.EBBAaCCHdBEAhBAA.TDCAADFBFDGDSEEDhABANCGA.fFAAhACAbEGDZFEFBDHBIGGA...hBBA......hBIA...,1,-11,-17,6
EfgaFAIXKUNCbGPWTDSeHBdOJZVLQMYcR,KAAACAAAGACA..TADAeAEAHBFCdAFAZAGBLCAB.MDFBhAAARCAAEDEBaDGCAACAXDGAhAAAbEDD..DFIBOFDBhBIA.QFGCfGGA.gFAAhACA...hCAA...,2,-23,2,25
IOHBAfECZeUTRKSagWDPQXGJbFcYNVMdL,EAAAeAAARACA.KADA..aAFADAFA...QBFAGBEBFCCH..hAAANAIA.dDAALCCBhAAAHDFCAAIBZFDATEEASEEGhADAPEHB.JFHBcGECMIDA...BCEDhABA.CHCA.....hCAA...,1,4,-25,29
JeVEdAGKBNObLQcXZPSFIWHTRCfDMgUYa,GAAABAAAOACALADA.QBGAZAFBFAHDHBCARCDADDCBMCBBhAAAUEFA.aEAHeDEBEGHFAAABhACAKDGA...bFBAXECDhAEA.SHAATGFA.CEHA..hBCA......hBFA...,1,3,-21,24
KDCfYUIHXLbEPRASZJGTNWFBgaQVOdceM,ZAAAGAAA..TAEAFADAaAFD..QAGCdAHAeCDBMDFAhAAACCAAUCCBHDBBLDFAhABAEEGAAFFB.SEABhACA.NGDBBFHBOFHDDHDAfGEEIHHA.hADAPHBCWHDA...hAEA...,2,-21,-1,20
dUNLCbVZEOaPXWAIMDQFJHTRBeKgGfYSc,MAAAQAAAHACCRAFFeACAGCCA.SAHBdAGALBFDCBBDZEFAhAFAECDB.aBHD.XDAAhAAAACHBFGEABDHAKEGAfFFEhADA.cGDA...NIAB.hAIA......hCAA...,2,-15,-11,4
dBEJGDaWRfQXNLPAeTKUgSFYcZHOMIVCb,eAAATAAAKADA.UAFAFACAZAEB.HAGBMAIBCCCABDFAGCCADDIBREFA.hAAA..QECAhAAALGEAACCBSEFAhAIAOHBC.bGBC.EGGA.......hABA......hBHA...,2,-22,-3,19
SVKIbfLMeOBdWZCgAaPEQDNRXYGJFcHUT,EAAAQAAARACA.GACBFAFAHCCCUAGATCGAKCDD..bCEDMDABhAAA.eEFBdDAAZDGBhAAAAAIBaEHDDEIB..XFCAhADAcFAD.SGEHfGDABHHACHHA.hADA......hAFA...,1,2,-12,14
cGVMDLSIWgXdPRQHKfFTeaJNbECZOBAUY,UAAAGAAAMADALADA.SAGH..gAFAhAIAdCDARDFAHEACFBDBeFDFhAAAaBHDJDEAEFFBOFHBhACAAEEBVFFA.DAIB..IHCA....hBAA......hBCA...,2,-33,6,39
dFBTJgOVESWHZRaeMIGLcCfNKXYQPbDUA,dAAATAAAOADA..EACEHAGBRAEF.eBDBGAGALDFACCCAKDEDQEAAhAAAbABD.hAIAAAIBBEGDgEBAhBAASEHHaFFAMFIBfFFEXGBADGABFGGHhBEA......hBGA...,1,3,-11,14
SVBdCWgTHZfAYRPNIDbFaXJEUceGLMOKQ,RAAA..IAAAFADA..aAFDEACAUCCAeAEAGBGAMAIBQCAAhACABAHB.dCDACDFD.hAAATCFAHFFAAEIBPEFBhAFADICA.XFCA.JHBA.OHFChBHA......hCAA...,2,-31,-2,29
JYBWfTaRSdQgVGKFUbNXDcOAPCEZHMeIL,EAAAHAAA.eACELADABAFB.TBGARAGFdCCAQDFCGCBAFDDAUDGBhAAAXECAOEABhAEAACIBZFGBMFFB.IGGAhAFA.JHAE........hAHA......hAIA...,1,-2,-15,13
RIgBfATeWUFJXKDNCSLaGEbPZHdcOVQYM,eAAAFAAAKADACADA.LAFBGAEA...EAHBZAGBHCCBdCCAOCHDhAAA.QEDDhABARCGFBDAAACCBTFEAUGAADEGBaEHDhADAPFHB..cFCC.MIAA.hAGAIHHA..hAIA...,1,-4,-22,18
KPWDRHULQMIeVJcaFSGAZgdTfYXbBONCE,dAAATAAA..XADAOACA..EAFAKAGADAIBHCAC.LCGBhACAMBDBeBGFVEABaCEBhAAAGEDAACCBZDGBfFDAhCAABDEBCFHA.WEHH......hDAA......hDBA...,1,-15,-21,6
LHWeKBDZbCSIGNRVAQUFJMcXgfOPdYTEa,QAAAFAAAMADA...XACAOAFEdBDAEAFAHBFCeCCDDCFAhAIAbCDC...SCGAhBAAGDAAREEAAAIBUEEAgGGAhAAAfEHA.PHEA...hADA......hAFA...,1,1,-18,19
MZQTHBUgFAOXLbNRYfPWVKcGECeJaDdIS,LAAARAAA..fADBPAEAKAHBEAFE..eBDFDAIBdCCAhAAAMCABZCDBHCEABCFAFDHDhABAACHBODHDXEEA.hABAbGCANEGA...WCCD......hACA......hCBA...,1,-10,-27,17
DVGaCgfXbENPUMRSdZOBeFLTIYHQKAWJc,JAAADAAAGABB.CAFB.XADB.EAFAPAHB.RCCAZCFFhAEAeAHF.TCCAHEEBADIBhAIAVDFBaGHB...bFCBhBAA.MCIBdHED.FGHB.......hBAA......hCAA...,1,-10,-17,7
PYdDGScNAbHVaJRZCIgXLfUMOFKQTWeEB,HAAAaAAAZACBCADB....XAEDLAFAMAHBKBBDQCEAhAGA.eCHBECABBCCAhAAAdEBAGEGASCHHhACAAEEBbECD.RDEBfEDEFGFHWHAG.DFHB.cGAAhAGA....hAIA...,2,-26,6,32
RKGNOTZLaDCAESePfYdIFMBHQVXbJUgWc,EAAAeAAA....fACAdAEAMAGBHBCBQAEAXCGDhAAAbAGD.UFDA.gEBDhABARCDBGEAATEGAhAAAaAHFAEEA.SDCD.IGEAhAEABFGAWHBGKGGD....hBEA...,1,8,-17,25
HcQLGEdUSTDCNPBYOARZIFWbXJKMfgVea,RAAAZAAAFADA..XADBMAGB...fAFAeAHBHCCALAHBhABAEDGFdECDUFFBDCAACBGABDDAhACAAAAA..IHCAhAIAbDFCKFGA..aGDA.......hCAA......hCCA...,2,-21,-19,2
SBdVUHDAIGfcTQWMLKeOaFXYbZRNJCgPE,GAAATAAA.MADAeACEFAGD...XCDAZAFBRCCBCAHA..ECHBdDGAhAAAHEFAAAIB..fDCEhACAQFAALFBAhBAAaFCEYHEAbFFANICB.......hBCA......hBDA...,2,-13,0,13
TQBNHFfDOSgRJCXdYPabVeIWMEZKUALGc,GAAATAAA.QADAHACBDAEA.SAFARAFACCAD.dCGAaCEDeCDBhAAAMCHBEEHF.ZDEBACIBLEBBhAAABGAAfGFAhACAODFDJEDF.PFHDIHHA..hADA......hAGA...,2,-5,-5,0
dQeJRfYWIXVOMNKLTUDPSgabHBFEZcGAC,dAAAeAAARADA.....fADAIAHAOCAEMAFALBFAhAAADCFA.SCCAhABAaCGEHDCCEEABGDEAAEGAQFDBhACAYDGHXGBAKFHBTGFAgGGAhBGAbGAC...hADA...,2,-12,0,12
OQLaYPfdAgSCMBUFHbWKZIVXTNEGcReJD,CAAAMAAAFACA.HACC.KAFCZAEB...XAGAEAHFRCCBeCFB.OBBBhBAAaBCC...fCHAhCAAACGABDDDbDFAIFEAhCGA.TGGAGGDBDEIBYHAAhAAA.....hDAA...,2,-31,-12,19
WZJUgPAeOHYcMfFIKSRGXLdCTNQEVaDBb,HAAAMAAAFADDSACEGAFA.dAFA.TCCAEAHBDBBBBAHA.ZCFEhAAAUDDAAECB.eCBHOEEBhAHA..fDHAhAFARFGBLHCAQFBDaFBC.bGFA..hAIA......hBAA...,1,0,-14,14
ZgYKIXbPMSAWGCHcJBFRaQfdNTDUOEVeL,GAAAHAAABADBRADAQAGCdAFADAHBUCABECDB.LDDAZCFA.KCHBhAAAbEAA...MEFBhAAAAAIBCEGA.FEGB..aFBAfGHAhACA.NIAB.TGGA.eFDHhACA......hBFA...,1,5,-27,32
DUEWbMTAFGNcgOJBYdZHPfXLICRKSaeVQ,GAAA..gAAABADAZAEBHAGBXADALCDD.hAAAREEFaDAHeAGBDDIBECCAMEHBhAAAAADAFCFD.OCHDhABAdGBAfGDEKEDAQFGC.WHAA.hACA......hADA...,1,-9,-12,3
DWCAfOgHVNJaQFRLGYSBcMIXePZbKETUd,OAAAHAAAVAEA..aADDRCAAGCGABAFAMAHBeCEB.ZEAAEBBBdGFAhAAADAIBAACA....fGDAhAEAgCEA.hAHAQDBBYFHB.SDGA.hAIAXFAC.bFCDhAFA.TFFA.,2,-17,13,30
XeDHIPSdBTUOCMAYNRfGLQaWZVbgcFEKJ,RAAAGAAALADBaADAZAFB..VAFA..bBGDFCFH.ECHFXCDBhAAAHFAA..SCCDhAAAdFEATEBACEEDAEIBfGGAhACAQFGC.......hAIA......hBAA...,1,-9,-16,7
eGHUWXVYKQcLSPEZbJORfFaNMDACdTgIB,dAAATAAABADA.HAEBUACA..XAGAKAEALAGBECBAZDAAOCEDhAAARCGB.FDHDaDDFMDDBhAIAAAGA..CFEAeFHFhACAGEFA...WGCG......hBIA......hCAA...,1,-13,-22,9
JSbDTIGegQROUVACBPNFXWYfaHZMcKEdL,BAAAFAAA..XACD..fACAHAEAZCDEMAIBEAEAdAHAhAAALEABbBDA.TDGAhAEAeCABRDDAOEEBhAGAADDACDHAPFFAYFGFaEAHKGHBDFIBIHCAhAHA......hBAA...,2,-9,-7,2
bcUDLZEKGJMQNWTdISYHaRBePVgXCfAFO,OAAAUAAAZADAGADA.MAFAQCDA.TCGAdBFASBBDhBAAHEAAREFBeFDFhAEAgCGHCAGBAAIB.bEFAhBDALFHBEFEB..KGGA.WHBA..hBHA......hBIA...,2,-15,-3,12
CISdPfVaHceJAOKEMDLgRFXQZWYUTbBNG,EAAAMAAALADARACA.QBGAZAFBUCCBBAHAGCBA.SDDBhAAAdCHA.fDFAhAEAHEFAeFAAAAHADEHBhAFAFFEH.XFCD.TGFACGHA...hAFA......hBAA...,1,2,-25,27
dJSATGIZcRfOVMFLPBYDCQeNHKXWaEbUg,GAAAZAAARAEA.OADAMACALAHBBAGACBHA..eCDAHCCCKDCDaCFDhABAUDGAdEHAAFFA..TFEAhAAAIHCA..hCAAfGHAFGGH.DEEA.NIAB....hCBA......hCCA...,2,-18,-16,2
cfWKVAeZbUEHgYCISQFODdBJPXRGaMLNT,eAAAZAAAEADEHADA.CAGB.QAFCDAIBBCCA.XCAARCEAGEEBaAHDhABAMFAALDDA.hAAATEGAfGHAhABAKFDAACAAUGGBIHCAOHAAdHEB.....hAFA......hCAA...,2,-13,3,16
fUCPJTWOMgIaSRNDQBKEGXdbVYHeLZAcF,FAAACAAA..JACATADA..MAFAaAFARBFBDBCBBBHA..EBFAdCCAhADA...VEDAHCFChAAAeDHFABIBUECAOFHDhAIASEFB.KEHB......hCAA......hCBA...,1,-15,-41,26
BfcbXKGdLRQMWHIPVENDSeOZFTaUAJCYg,CAAABAAA....bACAGACA.RAEAMAIBHAGBICAAhAAAECABDCGB.eCCBZEAAaCHHAAGBJCEFhACA....fEEAhAAAKDGDdEAALFHBQFGA.PHAAhACASGGFFGFH..hADA...,2,-19,-8,11
efJYNPagQBZcIVSGAOUDEXMHRCLWdKbTF,DAAAEAAAHACARABALAEBdAFAKAHB..FAGAeCCB..JBGF..PCEBhAAAaCDB.QCGDhAEAZEEA.IFFAhAHAGGEBACIBOEHB.......hBAA......hCAA...,2,-35,-3,32
dgCeGFLfMWNIaKUHcTPDSQVZOJBEARYbX,RAAAXAAAdADA..eAFAGADALCCAMAFA...ICGAhAAAaBFAHCFA.TDAAhAAASCHHZEFABGGAAAFAbEEBhABAFHEC.NDDA.KGGA........hBIA......hCAA...,2,-27,1,28
GZSfULYBbJMPgOETcRXeNVKDQCAWadHFI,dAAAHAAAGADAZADBSAFALAFABCBAMAIB.OCFC.EDABhACARCEFeCAA.KDGAQEFAhADAAACAaFGAFGAAfGGAhAAAbGAAJFEF.gGCH..hAGA......hCAA...,2,-10,-9,1
CdOBEKUVDfFALbSQMgTNZWXJGYeHcIRPa,LAAAQAAAMAEA..TACAZAFEXBCAGAEAHAGDhAAARCAB.aCHDdCGAEDDBKDDDDDGBhAEAACIBSEFDhABAgFFAJGAAeEHFIHHAOFDD.....hACA......hCAA...,2,-15,12,27
OFWHZEdeGXfKcQagUBNTAJIMYDRLSPbCV,MAAARAAALADB..bABAOAFA.HBFAEAFAeAHFGDEAKCCAhAFAaCCBBCFAAAAA.IEEAhBAASDGACDHAFEGHdFBAhBFAXFCCQGGANICB.YHDA.hCAA......hCBA...,2,-21,6,27
ITWLXMFVDfZbaAOUBcdJgSQKGECeNRYHP,BAAAdAAASADAGACAEAEA..eAFHRAGBHCABTCBALCFBhAAAMAHBDAIBZEDBAACB.OFGDhAEAUDEBJDAFKHEANDIAIEHAhACA.FECD.bFFC......hADA......hAEA...,1,-3,-13,10
EQJDLFdRgbSCXcUfWIHNZKAVPOMTBaGYe,OAAAMAAABADAGADA.EAFAQAFA.LBBBhAFARBGBbDBBCBBD.XCFC.hAFAfDDAHDEBZGDAAAIBhBAATEFAaGGA.eEHHDICA.dHBB.SHEAhAIA....hBAA...,1,-1,-18,17
ZJacEDGXASfgTPWHIbQMFdOLUKRNeCYVB,SAAATAAA.HACBQACCdAEBLAHBRAEFeAGHCBFDBDEAhAAAaBHDEDDBGDFA.ABHB.hABAfEAAPEDBIHEAhCAAbEGBMFFBFHGEKGAA.NIAB.....hAAA......hAEA...,2,-3,-3,0
QKLPJeAcXVOfRBETMSFGaNdbYHUWCIgDZ,XAAAOAAARADABAGB..EADA.MAGBGCCAdAHAHCDBCBBDDAIBZCFAhAEALDAB.eDCDhAAAACGA.fDHAhABATEFAaFEHbFFA.YHBAIGHAgGEGhADA....hBFA...,1,2,-29,31
CKMEXDGOIUNZReWQJBFLbaPAcTHdYgfSV,HAAAdAAA...fADBCADAEAFAGBGAOAFAUCCARBEA..eBHHhAAAQDAAFCAHLCCBhACAaDFHAAIB.TEEA.hACASEHHMEIBDFABZFCBBGDAbGEAcGEDhDCA......hDEA...,1,-2,-7,5
IAbVcBZOKWMYDQCFUdgHXfNPJGeESRTaL,VAAAZAAAKADC..MADAQAFA.FCAAdAHAHCEAXBDAhAAA..fDDEhABAPCGBeDDBREGBaBHFABGAbEBDhBEAOECBDDIB.CFFDgGEGJFFF...hCAA......hDAA...,2,-15,-3,12
KEMLCXIASUFRgdcaQbZWJBVGfPYDNHTOe,FAAARAAAdADAQADAZAEBBAGA.GAGA....fBHAhAAADCCBHDABeDDAECCBMCGBhABALFFA.XGAAhADAADIBSEEBgGEGbEGD....hAGA......hAIA...,1,-9,-25,16
HCcSTLBaMXeEAPUZQFVIdKGgRbDfOWNJY,ZAAAQAAAFADAdAGAGCAARACADAFA..OAHD..JCDBHBFBhAAASBHHTDAAaCDDhADAeCFBAEFB..UFCAKEHB.hABAbEGD..fFEANIEBCGFCBHBD.EGBA.IGGAhACA...hBHA...,2,-17,-2,15
EDVILKTYJFeUbdcWAHPXMSCQZGNOBRfag,HAAAMAAA.QADCGACBBAGBRAFF.aAHDEBHF.DCABLCCAhAFAKCCDTDEAFCGHeDHH.hAAAdEEAAAHASDHHhACAZGFENBBA.fEDE.gFAAhAFA.IGFAhDBA...,2,-12,-10,2
QFBaJIYDEZVcLTKOGAMCHRbPUgdeNfWSX,HAAARAAAUADAeACE...fAFBXAFAQCFDhAAAaAHD.JCCFDCCA.ECEAZEEAhABALDDATGAAGGEBhAGAADHAbEFAdGGA.SHAA.BHEAhAAA......hAHA...,1,-7,-8,1
DOFAeYBCHNQJcbKRLXISaZdMWVGUgTEfP,eAAACAAAHACAQADA..bAFBRAFALCCBSAHHdCHAMCABhAAAGEDAUCCBEFFEDCFBhACAAAAABFHBJDGB.XGAAhAGAaEAD..WDHH......hAEA......hBHA...,1,-4,-21,17
EWLcNgFYKHZVOSCeUDABPIdJQaTGMbRXf,BAAAdAAAaADAGACA.RAEA.EAGALAHB..gBDBhACAKCAAHCFBZEAASBGAhAGAeEEBAACBJEHBMCCB.bDCDhBAA.fDHA.cEEAFHCA.OFHDhBCADGGB.QGEDhCDA.,1,-8,-14,6
VOEXDcgWbIZYaTGBMJAePfLHRdUNFKCSQ,eAAALAAAHADARADFdAFAFAGACCCA..QCAAECEA.DAHBgCGAhAAA.IEEAhABAaBHDGDDB.MEIBhABAAEIBfFAAKFGBOGDCXFGC.hACAWHCA....hAFA...,2,-26,-11,15
WQYJMPESaDcbgTZdBXOHCALVRfKFIUeGN,RAAAFAAAeADEGACA.QAEAMAHB.EAGAaBDD.DAIB..bCEAhAEAZCEBBEEAHEGBABIBLFGBhBAAKDCDIGAANDIA.hCAAJGDASGEA......hCBA......hDAA...,2,-19,-11,8
GFOASIafKgCBJZMdHPebRYEUNVQcLXWTD,aAAAKAAABACBZACB.HADBeAEARAFA...EAHFUDDB..QCEAhAFALCHB.TECAhBAAGEFAABBBfCHAhCAACDGBdFAA.bFFANCCA.XGDDDIAA.SHFEhCCAIHHA....hCEA...,1,-6,-19,13
WfXcSTGOgbJRFYHZaDPBdKLCQIAUVNMeE,VAAAeAAAEADA....XADBTAFAGCCAOAFCJCDFRCFAHEFChAAAZCFA.aAHFBEGAdGGDCFEDhABAAAHAUGCAMFCB...hCAA..fFFE.SFHHhAAA.....hCBA...,2,-21,2,23
XefBgMCGEQYRHVdOcLZWbITSJaNKAUFPD,FAAAXAAAeACHBAEA..MADAEAGARCEAHAFC.dBDALCHBhAEAbCED.TECAaCGCAAAADDCBhAIACEGCGGABQEGChCAAOFFB..........hAGA......hBAA...,2,-15,-10,5
YEUHdXBKgWMCcefRIaGZFVNTSAOQPDJLb,QAAADAAALADAEACAHAGBBAEAKBBAMAGBeCDF..RCDBGCGAhAAAZEABFCFH...TFCAhAHAAAEAODHDJFFB.bFFD.hAIA.YHBA.......hAIA......hBAA...,1,-5,-22,17
BWIeVYgacHUALdPETSMDRfbFQKJZXOGNC,dAAAEAAA.MADARACA.FAGDQAFC.ZCCAGBDABAHBeCGFhAAAgCAAHDAAACIBTDFAhACADEEBKEHB..OBHDhAIACFFDIHEAaFBALFFAfGHEJHFA..hADA......hCAA...,1,-5,-14,9
GPCOQFeHSaAYJDWEBRTZVNLIfgbcMdUKX,DAAAEAAARACAZABE.LAFA..fAFB..bCCAdAHAhAAAXCGAGCCBODABhADAeDABHECAACFAYDFGhCAABEGATGEAVFFA.gGAAMIFA.hCBAKGGC.CHCA....hCCA...,1,-3,-9,6
aMJLXcZDWPUBSYfACIFETVRQeONGKHgdb,FAAAEAAARACAeACH.GAEAHAFBdBHA.aCCCMAHBLDABZDDFDAIBUECAhAAABDGD..fEFAhADAAAEBTGAAQFFChAGAKEHBJHAA..XGGCWEHH...hBAA......hBGA...,2,-23,2,25
RZQYKdGbCVTIgPDJAUeSEFMcXNOaHLBWf,eAAAEAAAFACDMAEA....XAEAaAGEHBCALAHBBCFARCGFZEBAhAAAQCDAdFFACDED.hABATEAAIHHADDGBAAEAhAAASEHHOEGDfFDA.KHBAhBHA......hCAA...,1,-7,-20,13
JHYReMUgbVCASdaFWIcXELBPZDfKGTOQN,aAAAFAAA....IADAEADALAGB.ZBBAKAFAGCEAQCCAhAFAHDAAREGBeAHHMAIBhADAbCEDABGBSFBAhBAA..dDGD.XFGADGGB.TGCAhAHA.OHFC.hBFA...,1,-4,-13,9
URKTcWeNPICaXgQVFGBLZMSDYObAdHEfJ,HAAAEAAAUADARADFKAFC....TAFAeAHFICFACAHB.aCAChAAAQCBC.hACAGCGAZDAEMCIBDDEAbEEDhAAAAEEAdEGA.fGFEcGGD....hADA......hCCA...,1,-12,-15,3
NcEDKVXBJHCfdATgaLIPSObUMRZQFGWeY,aAAALAAA.SADHOACDMAEARAFAZCAAGBEA.eAHFhBAANCFA.EDHFKCGABEBAHEGBhABAdFGDAAFA.TGBA.hACAgGEBbEDD.......hAIA......hCBA...,1,-4,-19,15
eXEDAKPNQHWUaBJgMFfTIVbdRCcOZYGSL,KAAAQAAAHACBaAEABACA.MAEAFAHB...TBDAICAAhAAAdBFARCGFOBEDGEEAeCGBhACAEDDBAAIB..PEBAhBEAWEHH.UFGB.fGEACHBA..hCIA......hDCA...,2,-16,-9,7
ZVLJIFNSGBDPHWEaUegcYOAdCMRKTXQbf,dAAARAAAKADCQADAZAFB.LAGBFAHDGCCADAIBHCAC.EDEBhACAeDHB..gDGAhADAOEFBAAAAMFBBhBFAbFBAJFHB..SFCDBBFB.aGEH.cGGAhCAA....hCCA...,1,1,-26,27
bPJCQOZFRBcVgMASKaHITfeUdYNXEWGLD,aAAAHAAA.TAEAeACHdAEA..XAGBEAGAGCEBLCAAhAAADBBBJDDFQCEBhACA.ZDGBREBBBBHAgEAAhADAAEHAKFFAfGAAYEEFNEIA.PHFAhAGA......hBAA...,2,-14,19,33
cXBCfdWbSIAGLQJFgZEDMKeaOURHYTNVP,GAAALAAAQADAFAEAEAHB.MAGBeBDFaAHBRCAB.HDCA.TDGAhAAAPCFBBFBAdDHASEDHhABAABIBZFDBODAHhACAUGFAVGFACGCD.........hACA......hAIA...,1,19,-14,33
UERJbcdXVaHIDeLMYPZNQgKTGBfFWCSOA,RAAAJAAAdADA...aAFAHADB.eAFAMAIBZCFB.QDAAhADAKBFAGDDAFCHDCCCD.AAFAEDDB.hAAA.bDGD..XFDChBAADDGBLFBB.NIEB.TGGA.BFHBhBIA.....hABA...,2,-21,-4,17
OKSRDaGUfICLFJgTWAPNZEXcHVbBYedQM,ZAAAEAAAHACABADBeAEHdAFAMAHB..SAGARCCAGDFAIEAAhAAALCABFCCH.TCFAhABAAAIBPFEB.NCIA.hAEAXEEC.bFGD.QGAAhACAKHGA.aCHD.CHCB...hAGA...,2,-15,3,18
BbWLOVdASaQURXHKcDEPMCYeTFNgJIfGZ,aAAARAAAHADB.DAFAEADA..MAIBeAFAFBFAJBBFGDAAZBFE.BCCDhAAALDDAdDFA.ADABQEGAhADAKDHDCEEC.TGAAhAGAgFGA..fFFEhBAA.OHDC..hCAA...,1,-15,-16,1
LbfHceMTWPUBEdRJFSOCZADVgQNaXYGIK,DAAAQAAA.aACEGABB.LAFBHAEBeAGBMAHBTDAAhAAAPCCBECDBREABFDHDhAEACAHBACIBVDFB.NEIA.XEDAhAIA.KGED.fGGA.hADA......hCAA...,2,-15,-6,9
eCHTgMVKFRUdPWGXNSfBELcQaIJYbODAZ,eAAAHAAAMACAFADDRAFA.dAGAGCDB..SBDAEDHFLFAAhAAAaBHDJCCFOCCHZEDBTFFAhAAAKEEDUFGB.XGEDhABABDGDQGBA.IHHAhAIADHCAAHHB.CEBD.....hBEA...,1,2,-10,12
YTMaEGDcONbPXgBJLKQUZCfVeARSdHIFW,RAAAHAAAFADA.TAEA.EAGEGAFA.OAHFbCAA..XCEAhAAABCCALDEBhAAAQEAAZECBfEHAhABAAACAdCHAIEEAMHEAaFGADECBPHDAKHAA.CGGB.hAEA......hAIA...,2,-13,5,18
FJRWgCTSYMBEUALVaQNDfPZGbdHeIOKcX,aAAAQAAA.DADAZACBdAGAHAEA.eAHHKBDAFCHDRCFBCBBDSCEDhAGAMDBABDEAAAIBLFFAhAHA..fEFAhAAAPHFA.bFBA...OFHB.hBAA......hCAA...,1,-15,-29,14
NLQTMWfVUOeDEIYBGHSRAdXagbKcFZJCP,aAAAKAAAZACB..CADALAFAMAFA..VBEAeBBB.ECFABBHBhAAAHDABACAA.dDDA.bDGDFDEHhACA.JDGBQFEAhADA.fGAEDDIBGEBA.SGHBhBEA....hCCA...,1,2,-31,33
bSRTdDaIFXPEKBfAcMZgOVeQUCYHJLNWG,ZAAAOAAAeACEUAEAHAFBLAHBGCDARDGBdBBDDAIB..FDDAEFAABBGBhBAAAAHB..MFDBQEBAhBEACCCD.NEGA.bFFDhABA....aEHB.XGDA..hCAA......hDAA...,1,-3,-25,22
CXdYbQIHJFBTVUNGfcLSRKDWgaEPZMAeO,eAAAXAAAdAEAQAGAHADABAGBUCDBGBCALCGBRCFB.hAAADAIBaDHDEDAAZEBFAAAACEEDbEEDhABA..FFAA.TGDAhADAfGAA.KGGCgFGAMIBA.hAGA......hBEA...,1,3,-7,10
ZfHBgXMQTJcOEFYWLaUdCVSAPGKNIbReD,GAAAKAAA..IADARADAeAGHZDCA.HDGBXAEDMAIBTFCAhAAAOAGF..ECAAFEAHhACALDCAdGGDSGEHhADAAAIBbDFDBDHA.QGAA.YFHBhAAA...hAEA...,1,3,-17,20
EaDcgTRNSAOPXJIUMbQBVfFYGKdWZeHCL,XAAAUAAAMADABADA..FAGDGAEAdBDAZCFAHAGDLEEAhAIAECDBaCHDDDCB..TDAAhAAARFBAABIB.ODFD.hBAAIFHAbGEA.QGAA..hABA......hADA...,1,-9,-22,13
FCKRIYbAWQLgPZOcTSefBVXdaEUHGDJNM,LAAAZAAAOACATAEA..eAFABAGBdCCDEBHFHCEBGCAAhABADBIBMCHBKCCARCFBIEEAhACAACGBQFGB.gGAAhABASDHH.XECD.aGGAhAEANIEB.CHHD.....hAIA...,2,-11,-7,4
aJVbdBAQcNOZKCELHPRUfSGTFYXMegWID,QAAAOAAAZADBKAFAEACAHAEA.RCDBUCGAGCEA.FBBHMDCBhAAAeAHH..IFFAhAGAaDHD.bGDCACGBCGFAfHABhAHASHAAYHFG..WHEAhAHA......hBAA...,1,12,-34,46
TIBQAMFNUeaGfOWYgKSHbZJXLCcdVRDEP,MAAAFAAAeACHGACB.OAFA..gAEAHCCAZCFBLDHBhBAAdAHARCEAEDDBTEAAhAEAQFCA.ABBBaGGChBIAfDHAKHEA.bFFA.CGEDDHBA.BHHDhAFA......hBAA...,1,1,-14,15
EeMAHdTCgZULNPIWDJSYcRfVOFKaXQGbB,HAAAdAAACADAZABBLADB.IAFADAFA.SAGHRBEAOAHF.hBAAaBHDGDCABCADECFBhAAAAEEA.TEEAUEGA.PDCBhACAJFBF...fEHAKGFD.QGGBhAIA..hCCA...,1,-7,-28,21
cHUNPLXVgTBfGOAYZJdEWMQbaeSKIRFCD,ZAAAEAAA.MACAQACA.eAEAKAFARBDFDAIBHCFAUCFALEFAhABAXCCCTGGA.hAAABAHBGFABACCBdHCBaDHDhAFA.FFFB.CGHA.........hBHA......hCAA...,2,-17,-8,9
POLCAHVdMfXKacbSTEIZBQWUDRJGegFYN,HAAAdAAAMADAKADCaAFD..SAFA.EBDBZAGBBBHAQCABhAAADCCBRCFB.eCEBhACAFDDH.PDCDLDHBhACAABIBXEFDbFCA.IEHAJHFE.YFBFhBFACEBD.fGHAhCDA.,2,-21,-11,10
RJAPMZNWVeCKDcEgFBLdHbGQfUYTSIXaO,ZAAAVAAAeACE.DAFAEADEBAHAHAFB.GCDAQBFDUFAATDGAhAAA..XCCAhABARFFBAAIBMFDBCDFAKDHB.hAFAFFFA...........hAHA......hBHA...,2,-36,-4,32
fWZgKdIQHNTYFMbSDaPJXAOLBceEVRCGU,LAAAeAAARADAGAGAUAEAZAGBdCCAHDFB..TCAAMDIBbEAChAAAaCCD....XDFChABAAAIBBEECEGAACEDA.fGHEhABAKEHBQGBA.FFGH.DBIB.hAEA......hAGA...,2,-11,0,11
gdNfDCTebMUYOcLSJRPBaWHXQKFZVIEAG,dAAADAAAeABAMADAUBDA..OAECLAHBRCCABAHBHBFDQCFChAGAZCBBEEEBAEHA.GEGAhBAA..fFHAhACACCHB..YEEFSGFH.aHBAhBAA......hBCA...,1,-15,-25,10
NUgGcHfaZMOXWDRIFAbKCYTJSeLEVQBdP,CAAATAAA..eACAEACEBAEBdAGAUCAAGAFAHCDAZCCA.MAIBhAAAXDFARDGF.AAIBKFBAhAAASECALFFAQGGBhAHA.PHBANICB....hBHA......hCAA...,2,-22,-8,14
FZJLdgNBUfRATKCMYScbDPHOGWeIaXVQE,TAAAMAAA..SACADACAHADCGAGAeAEH.aCCAQAGAhAGAEDDBZDFFLFHBhAAAdCCABCFARFEBAAIBCDGAbEECOGAAhAGAXFGA.........hCAA......hDAA...,1,6,-16,22
QKbegSDYALTGHfMREPICUWBZJFNaVOXdc,GAAAHAAARADFEAFECADABAFAZBFE..FCAH..aAGDOCCBdCDA.QDFAhAAAeBHHDCFBAAABTGGAhACA..MDABIHAAhADAUEGBJGDA.XFADKDHBSEEDhAHA..fHGFhACA.,2,-31,7,38
NFDAESITUQBgdJHZVGYOWMLRebCKafcXP,EAAATAAABACA.dAEAHACBGAGAOAEALCCBRBEFeAHF.KCADaDGHhAAA..XDFDhAAAFEEBAAGBSEBDQEBAhACAJFHBYEEF.MCIB.fGGAhBEANIABDGGB....hDCA...,2,-16,2,18
efVLTGMUDXOAgZWNPRQCbHFSJKadIEcYB,ZAAA..PAAARAEAQCAAHADAFAGAKBHBdCCA.ECFABCDA.eCFFhABALDHBGDGAMEEAhAFAXEACAFCA..hACAgFCACGEASGGDaFFBIHHAhBAAfHAB.....hCAA...,1,-9,-14,5
CSfLNZAPaVWHEObgBFMYQRGXUeIKDJcdT,aAAAHAAA.EADEOACDBAFBMAHBRAEA.GCABeAHHDBBBdCFATECAhAAASCDH.LDFAhAEAAAIBPDHD.bFFDFFAAhAFA.QFFA.XGCA.hACAKFHBCHHB.fHABhAHA..,1,-3,-8,5
NCZRHVADETYbecSBgaLKMIWGUfJFdQOPX,EAAATAAA..eACABACBaAFDMAEA.GBDAUCCAFAHBdBFBQCGBhAAAXCGAZDABHFEAhAIAADABDDFB..YCCFhBIAbEFD.SGHHKEHD.fHFFhCAAOFBD.CEHA...hCDA...,2,-10,-6,4
aIgWXFHQAfGKDETeMRLSPcZYBOdUCJVbN,GAAAEAAA.eADARACALAFBSAGAZBGBOCCBdCDACCFA.JDABVDGBhAAA...aDAHgECHhAAAFFCAHFEBACHADCIBhADAMHAA..cFEBBHHA.UGGA.IHAAhAHA...hACA...,1,-4,-8,4
AfOEMLSdVRCKGXHQJeBTDNcYaPIUZFWgb,EAAAMAAAdADARACA.GAFAHAFB..eAHBDAIB....NBCA.aBBHUDDAhAAAZDDAFDHH..bDGDACEBLFAAhAFA.CFFDXFDDhAIAQFACBGHAcGFC.PHBChAFA.....hBAA...,2,-9,-8,1
LVEFUgZIaKcJDYBTPbdOANRMfSeWXCGHQ,RAAAMAAAeADE..CADAHAEBLAGBFAGAZBBFaBDD..KDCDDCHB.BDDBhBAATEEAdEFA..ACIB.SCHHhAAAGGBBEGHBgGCAhABA.IFHA.cGEDhAIA.....hBGA...,1,-12,-27,15
eDKIONACYPXUdTMBVESHaLgcWZQfGRFbJ,CAAAXAAAdACABAEA..EADAHAFBLAGB....gCBGhAAAZBDEGDAARDFAFAHFhAEAeCHHKEDAODEB.hBCAAAAAPFFBMFHB.aFDH......hADA......hAIA...,2,-29,-11,18
IeANTgdLZRXCBVPaHbEKcWSFfOMYDUGJQ,TAAAdAAARADABAGB..aACAHCAC.EBHFKAFA.SAHBhAAAOCFBMDEBDBDBGCDAhAFA.QCFAhCAAADIBLEAAZFCFCEHDbGCAFEHDfFFAUGGA.IHHAhCCANIAB...hACA...,1,-1,-10,9
IZebKMEdHLBaPCYQfATJNRSWXOVcFGDgU,TAAARAAA..XADBOACA.FAFDGAFADAHB.UCCAZCCAeBHHhAAAMAIBHDGBLFFAhABAaDBBCFBAQGDChAIAAAHB.SHFAcEDDgGGA.hCAA......hCDA...,1,-1,-19,18
HWcZbdaASBNUfOCLKQeIXTVEgRDJMYPGF,BAAAUAAACADALACA.eAFHTAFAEAHB.RCBA.DCCA..MAIBhADAGCGAHCGBZDAAaDEDADDASEEBhAAA.hAFAOFHDQECAXGDCgFGAhAHA......hBAA...,1,-14,-22,8
ERSbKPdaGIeLODcTANJYBXgVMWfCHZUQF,JAAAXAAA..MADACADAHAEBZAEEFBHDRAGBKCDD..dCCAGDAAhAAALCFBDDGBAAIBBEDAVFEBhABAUGGA..EDHFSHEChAIAaGAH..IHHA..hADA......hAGA...,2,-35,-8,27
aRfBXHYCJgDcOVKAULdSPZQGITEFWMeNb,dAAAZAAAGAEAEADA.MAHBeAFA..aACARCAAXBGAHDDB.CCEA.hACADAIB.OCCBADGALECAhADAQDGBTEGAhAGAFFGHbGECBGAA.gGBH..hABA......hAGA...,1,-7,-10,3
GKgYJFLECcDdZHAIPbUQMeaSWRXVfNTBO,..IAAAbAAA.UACAeAEA..aAEERBFAXCAA.VDDAhAAATBGAGDGAKCBDJCEBhAFAEEABDGGBHDFBAAIB.MDDBhAHA.SEHB.fGHEhAIA.NIBB....hABA...,1,-8,-12,4
FDdUWbgYaQfKINEMSJGXZOPHBCeLRTVcA,dAAAUAAA....bABDaADA.QAGAKADAEAFE.MBDBGCEAhADAZCDBHCFAeAHHRECBTEGAhAGAACEBDDIB...gEBDhBAAfFHESFEHOHACCGFALHEAhAHAFGGH....hBAA...,2,-7,2,9
QCPNGAgfVISWKZUdeTMHEFJLXRbYaOcBD,VAAASAAA.ZACBeADEHAEAEAGELAHBRBDB.aCECBCFBhAAAQEEACCHAGEFAAAAAfEGFhAGAKEHBdFECMDDBhAIAXGCAOHCC.DFIB......hCAA......hCBA...,1,-7,-11,4
JMcCLHfBVSEOQTKgPGdaeAUWbNRYXZFID,UAAA..bAAARADAZAGBDAAA..MAEALCFDHBDBBAHAECDBQDAAhADATBFA.KDHBGDGAhBFAdGAA.ACCBYEFFhCAAFFGD..IGEA....hAEA......hAGA...,2,-19,-12,7
PUXbLdgKHFQJcSNARCMeEYTDVfaBIOWZG,RAAAeAAAEADE.DAEA..aAFAOAFE.GBCAXBEAdCEAHCGBhAAAQCCCSEBBhABAAAAAMAIBTFFABDFDZEEAhCAAPGCCLEHB.FHCANIABCHHA....hAIA......hBEA...,2,-7,-6,1
XSNCOKgYQBERTZIaJGfVDbUMWecFdLHPA,SAAAOAAAKADA.QADARAFF.ZAFBaAHDGCCADBBBUCCAhAFAeAHF.dDAAHDFCAAAACDHABEFAhADAEFDA.JFBBbGFAMFEBhBFA.FFGDLHAA.....hCAA......hCBA...,1,-3,-13,10
MaVTdXKZLCYfFEgDcJWbeBRQIOGNPUHAS,aAAAdAAAZABBLADACADA.FAHBEAFA..DBBB..JAHBeCCABCEARCFBQEAAhAEAGCFAUECAhAFAHEEB.ACCAMCIBhAFAXFGDKGHB..fHDB..WFFDhBAA.....hBAA...,1,-10,-30,20
XINbYPCaLGeSgDUdTFcQEHMWfZBJVRKAO,XAAA..bAAACADAGAEAeAEADAAAdAGBFAHD..EBHBHCCChAEAMCDBZCFFBDAARFAAADHAOEFHhAFAIDGA.PEEBhAAAaEHDLHEA..SFHBhABA.TGFA..hADA...,2,-23,-2,21
VRZLICUceXPaGdQNgBTKEbMDWFOSfHYJA,RAAAZAAALADBCADB.eAFAaAEDGAGA.dCAAQCFAhAAABCCDKDEA.EDCB.MBIBFEDHODHDhABAHEEAAAFAIGGAhABAUGAA.XFCCPFFB.....hACA......hAGA...,1,-1,-23,22
LdRUbNcGBMEegZVQTSWaYAPJKXODHfCIF,KAAADAAAHABCCACB.LAEBRADF.UAGA..bAFBGDEBBAHA.hAAAECCBeCCBZECATGBAhBAAaCED.AFHA..XGGAhBGAfCHAFHDE.dEGD.MFFB.QGGAhCAA.SHCAhCBA,2,-20,-10,10
PMaDbGcFEVfSCLQYAIKJZTBNdORgeXHUW,KAAAZAAABADBdACARAEA.eAEHHCDA..UAGAMAIBDCAAGCGA.EEAAhAAASDDA.hAEALDGBAEFBTGCAOFFHhABAXGFCaGBA.FHACCHHA......hAFA......hAHA...,1,-8,-31,23
QNgMOAYSZKCfEFXUIaGWPVBDTdJHbeLcR,ZAAACAAAFACAUAEA.GBGA..PAFADAIBdCAAHBDCLDDBhABARCBBQCGA.MEEBhAAAACCBKDFD.EEBAaFFABFGDhACA.JHAAeFHH.gGEHSFHHhADA......hAHA...,2,-20,-8,12
CMXEJRfYAISHPedbUWTZNQKBDLVcgOFGa,HAAAeAAAdAEAUADAZAFBQAFADAIB.LBHBVCCB.OCABhAAAaBHH.MCCB.EDDAhACAREFAAAAASDFHhAIA.bFEATGEABHDA.FEBH.CHGA....hDDA......hDHA...,1,-1,-22,21
PDAgTKWbVSGBFLMHdZCNOfXYIUEeJacRQ,TAAAKAAA..VADAGACALAGBHAEAZCEE.OCABXCAAhAAAIEFAEDDAeCHHhACAaAGAREAFQFEAhADAACIB.gGCBbEGDFGCAMIEAdGGA....hAAA......hACA...,1,8,-1,9
aFYZVdcPMGINWfJSbBQUTOgEAXKDCRHeL,DAAAHAAAeABAaACAZAEBdAFA...MAHBGBDA..ICCAhAAAfAHASCFHhAIAQDFATECAEDCBACCACDHARFFAhBGALEHB.FFBB.YFFF.hBIA......hCAA...,1,-2,-13,11
MPAXIYgNUQaHVEfLZBdTOFbWGDKSeJCRc,XAAA..gAAAQADAHADAEAFAZBGBdAGATCCAhAAAFCDHGDAASBHHhABAeDFDRFGFMCIBACFBIDAAhADAUGCA.aDFD.LEED.bFAA.KFGAhAFA.CHHA.....hAIA...,1,8,-3,11
bSGZOHJKXMEUPeWdLNcYIaQfATgCFRDBV,TAAAFAAARACFBAEB..SACBZAFBHCDBKAHBEAEAUBGA.eCCAhAAAdDHALEGDhBAA..cDFCaFCBAFFBDGIBhCAAGEAA.XFFCPHCC.YHEGhAEA.fGCAhAHA.CEHB,1,-15,-23,8
ECTMSQWGYKbNDFPafcdXAOeVLJZUgRHIB,eAAALAAAZADBRAFAHADBBBCAEAFA..MCFBQBGA.GCAAhABAbCGD.FDDHaEEHdEGAhACAAAAA.OFAH.UGDAhAFACGAATGGASFHHKGDDDCIB....hAGA......hAIA...,2,-25,13,38
bMDHdOYKPJUcVSFNgWTGaXLBQCAfEeZRI,EAAARAAAMADAHACA.dAFAKAGAUCCB..SBDAFAHB..gCGAhAAAGCEBaCCHLEAAhAEAQEECAEFBeEHFhCAAbEBCDEHBOFDCPHCA...cGGChAAA.....hCBA...,2,-9,-9,0
VZbWYKAMaeOFfdNQBTJCXRIESUPcGgHLD,eAAAFAAAdADAQADABAFA.CAFA.RAGF.EAHBUDBAGCCAHDEALCGBhAAAZFAA...bFDDhABAKEHBACCBOFHDTGFA.hAFAXFFCSGDH......hAIA......hBAA...,1,5,-25,30
FKNAeBaQdOGfVWPLRYUICDScZbHTgJEXM,eAAAaAAA.dAEAGACA..fAGAVAEALAHBRBCBUDFADBBBhAEAZEBAHDFA.TEDAhBAAEFHFMAIBKFGAAHCAQGAAhAAAOHCE.PHCACHHA.SGGDhABA.....hCAA...,1,4,-7,11
OeNSRJfFYPDQXBEGVMaCbWdLZIHAcgKTU,KAAATAAAeACE.RAFF.FACA.DAFAQBCD.EBHFGBDBhAAAaDDC.bDDAdEGAZDGBHFAAhAAAAAIBUGBASFDBhAFA.fGFEXCCCMEIBLHAA.hBGAIHHAOFFH..hAHA...,1,-3,-5,2
JCSAabWNPfRdLZGOYeQHVIEgKXTMFBDUc,aAAA..bAAA....PADARAEAZCAAGCEBeAGFHBBCEEAAXECAhAAAMAIBDCFBUEEBhBAACAHBAAEA...fDHEhBBAdEHALFFBOFGDYHCEIHCA.hABA......hACA...,1,-5,-6,1
FJYVIOfTMKeNDRWQXSLUHEACbdBaPgZGc,dAAAaAAAZACBGADA.FAFAJAEB....ICGATAGAeCFFhAGARCAA..QEFAhACALDHBHGEAAAIBBEHA.hAIAgFBA...cFECOBBBhBAAMICADEEB....hADA...,2,-25,-12,13
VRcFLYTGCUIJPDWBefMdQgbENHaZASXOK,OAAARAAALADBGADACAFA.UAGA..IAHADBBBeCCBdCCCQDGAhAFA.EEFBhBAAHCFAABFA.KEEAFFDDTFAAhAAA.PEHBfGHAbFCD.NIBB.aGGHhABA......hAFA...,1,-9,-17,8
ESPMXCdNKJYBOHfIRTeGbgUcDWaQZAVLF,LAAAEAAA.MAEAdADAKAFABAHAHCBARBCAGBFAUCFADAIB.aDHDhAAAACAASCHBhABA.CDED.YEEFhAFAOEGDTFBAeFFG........hACA......hBFA...,2,-25,-20,5
CbPBfGgcRDYHAeKdWXOMUJEVFSQIZLNaT,eAAAdAAAOADAMAEAUBDA..EAGASAGAZBDAaBHD.CCCCBCFBhAAAGCAB.RDEBHEBChACAACHAKDGA.XEGBFEEBLFGBhABANHCB..........hCAA......hCBA...,2,-31,0,31
OMUIWKLVBFQSgYGAXCbRadHZPDEcNfeJT,CAAARAAAHADBZACA.EAFA....fAFBeAHFTDAAMAIBIDFAhAAALCCBBCCDQCEBhAAASCHHGCGAhADAAEEBaFACdEAADFFAcEECOFHDKGHBFGCDYHAAhAEA....hAHA...,2,-15,5,20
TeEYgRUVOdNKCQXfILADJPcbGHMWBSaZF,DAAAJAAA.....bABAHADB.MAFASAFAZBFBeBHFEBHFRDAAODHDhADAdCCA.CEED.QDAAhADA.fDFAhAFAAFDBcFGCBFBAaDHDTFCA.gFGGhAGA.NIABKHEChAIA..,1,-4,-25,21
afMdKgJPYFVUSGIWDROQETAXeZLcCHbBN,eAAAZAAALADBHADABAGBaAFA.dCCA.KBHBJBFBFCFB..UCAAGDGAhAAADAIB.REDB..EFAAACHBCDHAhABA....NIAB.MEEBhACA...gFBA.PFFAhBFASGGD..hABAIHHA.,1,-9,-26,17
EgVbfNYPCaMTDXeBSOGZUKdHJcFIRAWQL,LAAAEAAA.VAEAbACA......fAGAPBHDaCAAhABAMAIB.DCCAeCEBhACAOCGDZEAAdEGAHDAAFGDDhAEAAADAQDDCgGFGCDCATFFASHAAhAHAGGAB....hAAA...,1,6,-8,14
ZNGKbeUWTEgAFdYPSXLHIVcMaCQRBDOfJ,dAAASAAAHADAVBGBMADA...aAFERCAAOCEDZBAE.GEFAhACAeAHHTCDAAAFA.hADAFDFDPEDBLEBBhAAACAHBDEIBfDHA.KFHB.bFCD.EGGBhABA......hBEA...,2,-9,-3,6
GNVdJaHTYQIXMPSBLFbREcWOgZCADeKUf,eAAAKAAAGACAdAEAHAGBQAEAMBDBBDFALAHBREBB.ECABODHDhAAAZDFAABGA.DEEBUEABhAAAVFFBaEDD..IGAAhABASFFA.bGFA.....WHCGhACACHED.....hAGA...,2,-16,5,21
BFRCYcZXgUfAaTSPOMJdVLEGKHbWQDINe,aAAATAAA..OACDdACAEAEAHAEA.QCEBDAHBeBFFRDDBCAHBZCGBhAEAUDGAABBB..MDIBhAGALEABGGEBbGEA.hBAA..NECA.FEEH........hCAA......hDAA...,2,-7,-7,0
baDBTIGUMOLEVRQdHgJXAZfWYeNFKSCcP,ZAAA..fAAAeACEKAFCCAHA..bADABCCDGBGAUCEAMBCBhAAALCHBRDABHDDA.XFCDhACAADGA.YFAFhADASEDDaFFBTGGAEFFB....hAEA......hAFA...,2,-39,8,47
OFIWJUYdeDSbMRPZfEQcHBCVKAgaTGNLX,aAAAGAAALADAFADA..JAGBdAHA.eBBBSBHHRCFBZDCBEEABHCDBhAAA.CDCC.ADHATFEAhAEAOEGBUFDB.DEIBhACAMEIBQGAABEECKHBA.....hAGA......hAIA...,1,-6,-15,9
PAOSXQJgFbEBUWIZecDCfKMTYLGNRdVaH,XAAAQAAAFADAEACA.BAEAUAGAZAFBDBDBKAHB...MCDBhAAATCEAGCGA.REDFaFCHhCAAHDGB.AAAASECAhBGAbGFA.eFFBCCEC.fGEEhBIANIDB......hCAA...,2,-29,4,33
IVAEeKgGYdRMWBHfbLTDOZaXQSJFUNCPc,EAAAeAAAGACARADABAGBHAEALCCAOAHDZCFBaCBH..QEAAhAAAFCFDCDHD..IFFAhAAAAAIBKCHBdEECMEABfEHEhABAbEDDDFIBSGAH...hAEA......hCAA...,1,4,-20,24
GDYAOXZbfgLQcEaCJIBRSTNWdMFUVPHeK,ZAAA..bAAALADBEAEA.aAFACAGABBHARBFB..TCAAdCAAMCCBhAAAFDEDUFBAHDDAeCGBhABAGEGAADIBOFCChACA.fFFB......hAEA......hAIA...,2,-17,-13,4
VAfZJaHbTOWQNPDKFBUGgICeYRSXLEMdc,ZAAAHAAAOACAQADCDAGA.BAFBGBEACAHARCAALCFAEBGA.hABAdEDAACCBaCHD.TECAhBGAPEHB.FFFBgEGGhCAAeHAA.XGGCMIEA...fHDBhCBA..hCEA...,2,-22,-1,21
PIEBYHaXCSRMeWfGUFAJcdTgNDObZKLQV,dAAATAAADADAZADE.LAHBQACC.IAFAEBGFHCACaAGDhAAASCFDRCDA.hAEAeDEDGDGAAEHAJECBgECBhAIAOFHBKGFBBFFD.....hACA......hBAA...,2,-12,-6,6
OgSGaVKADfZLRTMYHcFbNWIJdEPUeBCXQ,ZAAARAAAMADAHAEA.FBHD....bAEAICAAECCA.UCCBeBHHhAAACCFA.QCEAhABA.SEEDhAIAaEABAAHALEFATGFAcGABWFFE.dGEABGDDXGGAhABA....hACA...,2,-22,-1,21
GeODaUFYcLEbRNVSKBXWZdJPMfHAQICgT,QAAACAAAGACADAEAaACE..FAGDLAFA.RCDA.SBEBhAAAXCGBdDAAMAIBHECAhAAAAACB.TFGAeDFFODGDhCAAcGAAEGEBbEDDKGGDBHAD....hADA......hAGA...,1,2,-21,23
EJIgbDeaXPBcCWTLfUVHGNSMQAFKROYdZ,RAAAdAAAEADEJADA......bAFBeAGH.aBDCBAHA.CCCATDEAhAAALDDB.fCBAhACAHDGBGECAMAIBhAGAACEAKGGDZDFADFFA.XGGA.PHDChBAA.....hABA...,2,-18,-13,5
GLgWEVdOcYKTXMaNZSPQBFfAeJUIDbHRC,eAAAUAAADADAHADAGAEBLAGB.ECCBdCDAOCEDKCFD.MAIBhAAAZCGBQDBAhAHAFEGA.ADIB.bFAARGEA.CFGD..hAIA............hBAA......hBCA...,1,-7,-27,20
MGUAbePTEJDOgRILWVQZHFNKCYBdXfcaS,eAAAEAAADADARADALAGB..QAFAHCCAKDHBBEAAdBCAfBEEhAAAaEEAGFCBAAIBTDFAhBHAOFHB.gEDBhCAA.IFHA...WHDAhCBA.....hAAA...,2,-18,-17,1
EbXJBKMRWLVPSCfAQNDHFTZGIgdUaeYcO,QAAAHAAAZADBGAFAdADAeAFAOAHFEBHF.JCAFKCEA..RDEBLCCDhAAASDBAADHBFEHDhACATEEA.UEGAaGGC.hADAbFAAMHAA...WFBACHHADFAA...hAHA......hBFA...,2,-4,1,5
eHEKUdWRIDPFaCBLMYcTgJVXGbQAOSfZN,SAAAZAAAHAEAEBHFdADARCAA.DAFA..aCECLBFA.MCCBhAAATEEA.JDHBGDDAhABAAACAOEABeDGBKGCAIGBAhAIACGGDBHAA.gGFB...hABA......hAEA...,2,-16,-15,1
OYeaJTIUcfXKBFCSbNHAdEgLVMDWQZRGP,EAAALAAADADA.ZADBRAEAGBCAOAFCeCAA..aAHD.TCFAhAAAICFA.fCHAhABABCBCSDHHhAHAHEEAAAHAdGEDMECBWHCGQEEC.PHEAhBCA....hCAA...,2,-17,-12,5
LcDdGTBOXbQNWZHFAeaPJKSCfYRVEIMgU,eAAAaAAA.KADACADA.RAFF...EAFAMAIBLBHBdCCAGCGAOBBBQEDAhAAAZCDAHECAACEASFAAhABAVFAB.gGGAhAFADDABTFGABFFB.NHAB.FGFH.fHCFhADA..hAFA...,1,2,-8,10
fJXCPNGOWFKBELZVcTaRSYebAIgDQHdMU,DAAAHAAAdADAMACAUAFAJAFB....CAHAGBBAFAHBEBDFZDEA..hAAA.TFFARDEAeDHHACCBQGDChCAA.hBAAXCGAOEDBBFBD.LGFAhBBA......hBDA...,2,-29,-5,24
aXZUQfeRNgEJBGYLFIcHWVOdACTKMDPSb,TAAAMAAADAEA..SACB.aAEAZAEE.QBBAhAIARAGFEBEBGDDALCFAhBAAFCCHHFBBODCEADGBKFGAbEFAhBBAfGFEeGCAgGGBBHHA...hAAA......hAIA...,1,-3,-12,9
CbaTSNGJVAIPZBcgXKeMDHfUOdYLQWERF,ZAAABAAA..XADBeACAHAFAOAFCdCAALCCAECAA.RCGBCECAhAAAaCDE.SCFHhABAGEEAAAHA.ICHAhACA.gEEGDGHB.fEHAhAHA.YHEA.hACA...,1,-8,-24,16
dKXAgBNEPULHMRSDIbeFJWYfZVcOQaTGC,BAAAEAAALADAHACARAFFDAIBeAGH..FCAAJBCF....fCEEhAAAZCEFOBHDaCGDGEAAhAAA.dEGAAAEAPDDBhACAMEEBSFHH..bFFA.YHAAhAHA...hAEA...,2,-19,-12,7
PcBbOGZaENLMDAWYHRTCIdJgfKVQFXUSe,HAAARAAACADB.dADA.JAFAKAFA.FBHDUCAB..eCCABBFDGCFAhAAAECGALDDBAAHA..hAAATFAA..fDFEhACAQFDASDHHbFGD.aFFChAIAMEIBDGIBIHEAhEBA..,1,-15,-27,12
dAXCEIGFRgcaVHJeQPDMLfZOSYbUBWKTN,EAAAGAAARACA.aADAHAFB.eAHBQAGAMCCBZDAFSCDAhAAA.bCFDBDDATEBAhACAADFBCDGAFEHD.gFFDhAAAcFEC.........hAGA......hBAA...,1,-12,-16,4
CKZJaEgDLdRfMAeSBPbcVQOXWHYFUTNIG,eAAABAAA....bACAQADA.XAFAHAGBFCAATCCAhAAAGDCAZCFEECEBLEEAhABAREABAADASEGAhAAAcFGDOGAAUGEACGHAaGAHdGEAMIAA..hAGA......hAIA...,2,-3,-2,1
LVDNWgEQZbfURFYPdGaICBSTAMcXJeOHK,MAAAXAAA..eACAHADALAGBDAFA..gBFAhAAAEBBBbBEDRDCB.FCDH.dDAAaCHDhAIABCHAABGBOFFAKEFAWEHBhABAQGGBZFEA.......hADA......hAIA...,1,-3,-16,13
RXBJDNceMFKZOHAgVGaWEbITLSfdUPCQY,GAAAEAAA..TACALADA.dAHACAEBRAFFBCDADAIB.eCEHMCCBhAAAZDFBHCGBAAABaDCHIDDAhAHASDHH.UGCAhACAQFDAJEAFFGHBKHECOFGB...hAEA......hAFA...,1,-1,-11,10
FcBUPSaWdDECTRfGAKQLXOZHeMgYIbVJN,LAAAZAAAHAEAeAHHMAEA....IBEAbCAB..VCDBhABAFAHDBCAASCGDhACAdCCAECFFRFFAAADAQDGAhABAOGAA.gEEGYHAANIEBPGBA.hAGAaGHB.DIEA...hAHA...,2,-7,4,11
EJRLOCDbXFUZIBMeGTYSQVHcNagPdKfAW,EAAARAAALADBDADA.FAFAZADEBBFDeAGHGCGA..TCBAhAAAQDEAHDEAaBHDdCCCAAAAhAIAOECD.bFGBXGGAhBIAMIAA.........hAIA......hBCA...,1,-11,-21,10
CMdBITRVHXAZeGYKFPfbJUcLEaDSgQNWO,eAAAGAAAFADD..bADAUAFA.LBHBEAHBDADA.QDDAhAAA.OCCBdCDATCGAhAAAHFBCAFGAZEFAKFHBfFCAhACAaGEDSGGDgGEA.CHGAMIAAhAIA....hBAA...,1,-2,-14,12
FPHJIUYTKSaWELRVfCgcbDdAMXBNGOeZQ,MAAABAAAGACAZABEFAFA.HAEA.UCGATBEAaAGA..LCABhAAARCCBCBHA...bEDDADGAODHDhAIAeDFD.QEFAhBAAIGHAKHFAEFEB.......hCAA......hCCA...,2,-26,-2,24
aPINHBZcRGbQYFVUOAfWEKLDgdMeJSTCX,EAAALAAAdADA.eADHSAFACAFA..aAGD..ICBAhAAAHCABZCFARCEAGEEBhAFAQEDAFFCBOAHDhAGAAAIBKEHDMFABJHEA.TGFA......hABA......hACA...,1,-10,-12,2
NaGRKYPMQHEZVLXSOeIBAJcWFDCgfUdbT,JAAAFAAACADA..UADAdAFA.....TAFAGBGA.RCCAKDAAMAIBhAHAHEEBZCCA.LFBBhADAOCGDBEEDAAHADEIB..hBAA...bGDAaGHH.......hCAA......hCBA...,2,-35,-23,12
QcDIZOMCABaUYXFeGHbJdgfWTSNKVLERP,aAAAXAAAGACAHADAdAEB.....fAGBTBGAKCEAECDBhAAAREEAQFBAhAHADCFAZCFEMDABAAIBBEHBFEFDeEHBhABAgGGASFAHNBBA......hADA......hAFA...,1,-5,-9,4
dJNGAcHaSUbBEMCXVDROWLeYfIQTKFPgZ,HAAAaAAA.SACEBADAEAFA.MAFA.XBDARBFALCCBeBGBhAAAIDAAQDDChBHATDGAFEGHZGDA.NBIAACCBhCAAbEDDCHHA.OFAB.fCEE.hDAAKFFA.....hDBA...,1,3,-12,15
aEUVXcQZDgObGJSWYdAeNPFLICKRHBfTM,eAAAFAAALADAKADAHAFBBAHA..MAIBECCAUCFA..XCCAhAAAZEAAOCHFGDEAhABA.SDHDhAFAdDECAFGAIGGAfGGAaHAA.....hAEA......hAFA...,1,-13,-29,16
RdHQOIYSAGEWLBVKXgNFMeCfDPbZUTacJ,EAAALAAAKACA.XADDFAEA..eAGHDAFAZBFBUCCA..aAHDhABARDFAHFCAQCAAhACAOFHBSDDBhBFAAAIB.GDGA.BFDDNICB.MFFB..hCAA......hDCA...,2,-23,-12,11
AYMaSJLOGIVgBRTZHPDbXEFeWNCQKUdcf,aAAALAAAGACAVAEARAEA..HCECDAIB.EDHFeCAA..CAHBQEAAhAEAdDDAACAAMCHBOEAAhABABEEAZGFA.PHCChAFAbFDA..FFHD.KHAA......hACA......hAEA...,1,2,-16,18
BVEOHLPdUWfCYMNDeFIagJTXZAbcRQGSK,RAAAGAAABADB.EADAHAEBdAGAUCDACAGA..MAIBeBHH.FEFDaCCB.hAAA.TFBAAAAA.QGDDhACAKCGBLDDBhAGAfGHADEIBIFFA.JHFA...hADA......hAIA...,2,-26,-10,16
PbJdeIBNECFgSHWaAMKQOVZGRYfcUDXTL,MAAAQAAAZABERAEF.....fACFDAGALBHBJAEBeAGBhAAABCCAECGFFCFDHDCBhAHAADEBKEFD.GEGA.YFFFhAIAXGCA.TGGA....hBAA......hCAA...,2,-33,2,35
fFOHZTEeADUcgGXYNaRQVdLJBWKbMCSPI,DAAAUAAAGABB..XADAaAEA.RAGBdCDALAHBBCFAKDAAhADAbCCA....MCGBhBAASDGAIECAOEFBhAEAHEGBEEEBAAIB.YHBAQGAA.hBHAWHFA...fGGFhAGA,1,-19,-26,7
ATJcLdbPfDeQgaGMOXKZBNIUHECVSFWYR,TAAALAAA.dAEA....bACBDAGAeAEAaBFDGCAAMAIBKBGBhAAAZCCFBCEAUEEAHDEChAFAEBHB.SCCDhCAAFDHHRGFAACAB.PEHD.fFFE..hCEA......hDAA...,1,-9,-13,4
LBZEQFdDMgOfVUIHbJAXYNTSGaRPKeWcC,XAAATAAA.GADARACFKAEC...eAFACAGAZBFEEBHF..dDEDMCGBhAAAOCABUDAAHDGBhAAAADDBSDHHaECB.hACAcFDAQGGBDGAAfGGA.hAIAbGAA.....hCEA...,1,2,-13,15
NJfWMaTgOEAeLcbHCPYBdFKVDZGSRXUIQ,eAAALAAAHADACAEABAGAdAGAKCCAZBFERCEFUEGA..QCAAhABA.JCDBMAIBaDGA.hACATFAA.EGFBAEABbEFBhAEAFHDC...GGABIHHAfFHAhAGA.WFFD..hAIA...,1,-8,-20,12
aWZbfXATYDPJVCdEFSeBNcRGgHMOLKIQU,TAAADAAA..VACAEACE..FAEAeAFEBAHARBFBHDDBLCCAQFGAhAIAaCFDZCGBXECAhAAAABBBJHCA..SCCDhBAANDIA.cGFCMFFBKGGB.IHAAhAHA....hCAA...,2,-16,-11,5
HJPXbVgfNOSGLaIDcATMBKWRCEeYZdFQU,MAAAKAAARACF...EADAeAEEdAGA.FBEDHBBA.XBED.VDGBhAIAfBHA.hBAASCABaDDCDBIBAFFBTGBAhBBACDFAZEEAQGCAUGGB.PHEAhAAA......hACA...,1,4,-29,33
UdFVDgWfZPMHIcNJeSQKaGCRAYOXBELbT,XAAAEAAALADAUADAdAHA.DBCB....fAFFhAAAZCEAHDCAIEAAJAHB.hABAeDHHQDBAhBDAGFABAFFABDEATGEAFDGHgFFGWHBG.hAAAMDIBcGGDKGCA..hAEA...,2,-13,-7,6
HRCXWILJZfFeBTKgOEMbNVdDcGUAYQPSa,QAAAaAAAHACBRAEA.CACA.....XBGALAEAZDEAeAHHhAAATEAAOCDA.EDDBhAFAbFDAdDGDDBBBGFEBhAGAAAEASEHHIHHAFHAABHFDKHDA....hCAA......hDAA...,2,-12,2,14
GPNCZSaVOgLIdfRebBTcDEJKXFYMWQAUH,HAAAGAAACADBZAEBaADA..OAFDLAHBdAHARCDBeBGF.BCADTDGAhAAAECCAKEEA.FEHBMDCBhACAAGBA.UFDB.SGFHhBAAgGBAfHBBDGGB..hBCA......hBDA...,2,-15,-11,4
XBVNWAZcGJCSHaKdDQTgLIfPebEMFYROU,GAAASAAAHADAdADATBGALAFA..fCDEhAAAeCCBECEAMCHBRDEFXEGAhACABDBDVEEBAAFAZFCFCAHBaEHDQGGChADA..gGAA.hBAAIHHA.FGDHhAAA...,1,17,-15,32
OcCRLPYFGfWIdBeQEAVUJSNaTZKHXDbgM,UAAASAAA..aADAZACBHAFBDAFAMAIBCAHARBDB.LBEAhAAAFCHDGDBA..fDEAhABAdEFAeFHBADBBVDGBhBFA.TGBAKHAA.XGDB.gGGAhBGA...hAHA...,2,-17,-6,11
CLUXVaPeWSDbQBAfTIOHEdFMJNYcRKZGg,TAAAHAAAEADE.dAFAMACA..JAHB..NAGA.RCAAGDCBLAHBhAAAXEGAaBDA.eFDBhAAADCCAbDDBAFFB.OEHBhBHAFGGBKHAAZFEB.CHCA........hACA......hAHA...,2,-8,-4,4
gbUeVOFDEdSLHQaPNAXJMGCRWKYcTBZIf,MAAARAAAKADC...TADAZAFB....fAHAbAFB.eBEFhAAAFAHDEBBBLCCBhABAHCEBaDCDACIBGDGACDHAcFGAhBAABEFC..IHDA....hBCA......hCAA...,1,-18,-22,4
SRgfeJLVOGUBaTPdZcKHNMXCQFDYIWAbE,EAAARAAAeADELADAGAGABAHA..aBDDdCBAZDCAHCFA.MDDBhAAAQEGBDEAB.IFCAhAAAACHAbEDD.fGAAhABAOFADTFFAKGDACGGD.YHFG.hAGAWFCD....hAEA...,2,-16,-4,12
DXaCIBMJEeVNGURPLfOHZdgFYbWSTcAKQ,QAAAaAAABADA.EACAeAEHGAEA.RAGBLDCBHAGBdCCAFDABhADA..bEDDTDFAhAGAAAIBXFFAMDIBVFDAhAIANDIA..fEBAOHFCgGBBhBAASGAD.....hBBA...,1,10,-5,15
WELObJIDFeAZHGMYSfTgVQKNXUdRPaBcC,HAAAGAAAMACASADA..TAFAQAGAXBDDhAAARCDAaDAHCAHBECGALDHBhAAAbDCC.DDCBACCAZEFBfEFAhACAKEHBNIDB.dGAABFCAOECD.FGGH.eFEDhADA.....hCAA...,2,-7,20,27
AZbQfVXURgBHedcENJDOGTSICLFWYKPaM,ZAAAQAAA..XADBRACAHAFBeAHBEAFADAIBGCDA.hABATDAACBGALCABhACAFDGDKFADaCCCAEIB..bFFCfCFEhDAA.gDGHBHHANIABSFDDhAAAIEEAPFHDhEAA..,2,-20,4,24
ZcXNRaKWVCSAfMYILbETPdOeQGFDgUBJH,MAAALAAA.EAEAdAEA.eAGBGAGADAIBBBBAHCAAZCEF.XDCAhABARCFBaBDB.KEADCDEDADIBhAHAfEHA.hBAAbGBATFGAQGGB.....hBBA......hCAA...,2,-38,14,52
OUJQdPVRHfLcSCYTZbFeEIXNBDMGWgaAK,OAAAQAAAdAEARAGBHACA.LAFBCBBDZCDA.eAHB.ECDAXDBChAGADCHBGEAAaDHD.hAIAAEABKEEA.PEHDhAAAfEEASGEAbGCA..FGGABHHDMIBAhBAA......hBDA...,2,-23,12,35
HbFPcfAUNeBCEZGDTYLKJSgIQdMaVXRWO,eAAAEAAAGACADAEALAHBKAEA..SAGBQBCAaBHDRBEAHDEChAAAFCBH..fCFAhAAAAEIBBFBAZFFATEDAhAEAYHBA.IHFAdEHAMFCB.XGEAhAIA....hBCA...,1,-7,-15,8
CcOJWEdITaYbKDRUSXLFAeQVGHfgMBZPN,eAAAGAAAHADAMADAZAGBCAGA.OCCB.EDEBdCDA.aAHDKDHBRCFBUFBAhAAALFAA.AAAAQFGChAFAfEHABFEAhACAcGCDJHDE.IHHA....hBAA......hBCA...,1,-2,-19,17
PMCVIBJacGeWZQDXTHUOSAERKdfNbgFLY,RAAAdAAA....bADBLADA.MAHBCAFABAHAaCAEGCEAhACAeCCBZCEBQDCAhAEADCHBHFGBSGDAhAAAEDHFKFAAfFHAFHAA.PGCC....hAFA......hAIA...,2,-19,-13,6
CdIPRQLGaMVBgFUNEDecZJHKfTbOSYXWA,dAAARAAAGADAaADA.MAFABAGA.FBDBUBFA.DBIBeAHH.ZCEBHDAAhAAAKCBB.TEFA.hACASEHBXDGAADEBhAGACCCD.QFGCLHCA.gGDAhBAAEGHB......hBCA...,2,-26,0,26
IQECMRFXfceWaNgJGUYSPdbLDZVHTAOKB,BAAAEAAARACA.FACA....XAFBeAEHaAGAJAHBGBFA.UCBAhAAASCCA.hBCAbCEDZEEFHDAAABHBKDHBQDGBhAAAMICA.fFHAcGGA..hADA......hCAA...,2,-20,-17,3
UcSbgCWRLBYGeNOEXdfJQMKAHDTPVIFaZ,HAAATAAAVAEA.FBHDZACB.SAEA.CAHALCEAhAAAGCABeDEFECABdEEAQEAChAAAACFADCIB.aDFDbEFDhACARFGBBEHBOFAAfHABMFIBKHAA...hAFA......hAHA...,1,0,-4,4
GWBROaJZdNbETUFXQMPfCLVDIYgeASKHc,HAAAGAAARADFOAFAZADAdAHAECDAFBFD..MBIBCDCDLDFA.DAEAhAAAgCAA.hACAAACAKDDDBEED.aFGAbCGDhAAATGDAQFECfGGAIGHASHBGhBAA...hCAA...,2,-13,-13,0
HQaZABbRULGYdMXISTcfCKDVFNeJOWEgP,RAAAGAAAdADA.MADASAFA..TAGACBHA.DBFBFCCHeCDBhAAAOCFBECGBHDBBhACAZDGBAAAABEDAbFEA.LFABhAFA...XGCA.fGFEhAGANCIA...hAIA...,2,-24,-12,12
aHYUKGCPAcMETJWLQIBfdbSRZFDeVOgNX,EAAATAAALADA.QBGABACBbADD.RCBAZDEB..eAFAhAAAOEABXBGAHECDKEHBhAAAGDEBABCBMHEAIFAAhAFASHAADCCBgFCAaHGE.CFFDPFHBhAGA.WHDAhCAA...,1,9,-19,28
YQVKAZEOaUdHCJRfDSGLPIgXcNeBMFbWT,EAAAaAAAHACBRACA.DAEAGAFALAHB..gCCAXBEBeBBDhBAAMAIBFDAB.TEEAhAAAQDEB.hADAABHBZEGBdEHAfFAASGCA.IHBAhAFABGFC.YFDFhAHA.OHFA.,1,11,-1,12
DANbfRcCBTgZJWEQMPGOXaVKUYLFISHed,...bAAARAAABADB.ZAEBEAEAMAHBGAGA.aCAAKCCBLCEBhAAASCFHHEAAeCHHhAAAAAIBfEGE.hABATGBAgECAQGDCXFFCUGGBhABAFGBHIDDADFIBCHHD.hAIA...,2,-28,25,53
FZNaUYOJAGELMcXbBfeHRPgTSdQKICWDV,EAAAMAAA...XACAbACA..eAGBHAFARCCA.TCCAdDAAQDFDhAAACBBDDCFBZCGBaEEHhAFAOEEHAAHA.LHAAhADAfFHASFHHKGDD.....hBAA......hCAA...,1,-1,-19,18
RdMaEfXecALDUBCKTYZbgWNPQJFOIVSGH,LAAABAAAKACAZAEB..bADD....NAHA.QAFAhABA.OAHFSCAAhAAAHCABRDEAaCFDEEHFeDCFhACAACABCCCCTFCA.gGFBPEABFEEH.hACAGGBBMFABfHDFhAFA,1,14,-40,54
JHFVTGAdfCMUZceYQIOXRPbKWENDLgaBS,dAAAMAAAZABB.eADAQADA.XAFARAGBKCEAEDCF.LEABhAEAaBBBBCCAHEEATCFAhAGAAAIBCDHA.UEDA.IEHAhAIAbGCCDFIBSGGBFGFD...hBAA......hBIA...,1,-2,-22,20
JMETLUgWZadeOVcRCfNHIPAYSFKDbQGBX,FAAADAAAGABBBADA.MAEAEAFALBHB.UCCAZBEEeBHHhAIA.OCCBRCFFCDAAHFAAhADAADFAKEEAQFDChAFAJEHB.TGGAaGBAdGEA.......hAIA......hBAA...,1,-15,-19,4
NZDIVMXPUfKeWbOdAcTGEaFJSYRCgQLBH,GAAAEAAAFACD.SADARAEA.QAGAHCDAZCGBDDIBMCDAXEAAhAAAfDDAeEFDhAEAbDGBAAHA...aDAHCGCABGEDhAFAIEFA.PFDDKHGA.dGAA.cGGChAAA....hACA...,1,-5,-13,8
YLTJZKdEWNbfaCgGUDcARXIOBMHPQeVSF,RAAAOAAAHADBeAFAFADDLAFAZCFBdDAAECCB....bCCAaBHDGCGAhAGADEEB.ABBBBEEDhAHAMEHBQGAAhAAASFGDTGCA.WFHHNEIA.....hABA......hADA...,1,-5,-13,8
OMGHLPdARXUbeYVESWgJZaDcFfKTCNBIQ,RAAAXAAAeADE..EAGESADA.JAGBaBDD.FCFATCDAhAAABCCCQDEDhAAAGDAAHDFCdEHAAADAbFCAYFFFhABA..gGFHDIAA.fDCEhABACHHA.NIAB..hAIA...,2,-21,3,24
fOFCSeQaMJWVLZGRPcEIgHBAbXTdKDYNU,TAAAdAAADADAUAGA..FACA.eAEHaBDA.MAGB..VCBAhACAGCCA.RCGFEAHBHDFAhBAAACCBKEFD..fEEEhBCASEHHQGBAWFDH.LFHBhBGAcGGC.BGGA.hAAA...,2,-21,-15,6
LFQgWBJKOeZGTdHSVIAYXcMPRbEUDNaCf,XAAAMAAARACA.UADADAFA....aAGELAGB.QDBAhAAABBBDOCDCeCHHhABAGCGAHDEBSFBDhAIAACFAPEEB.EFHFfGFAFGCA..hBAA......hCAA...,1,-1,-40,39
YZWVKCSDPAfcdbITBXLEQUgGeOMaJHNRF,dAAATAAALADA.EAHBQACCGCABeCFBaAEAHAGB.hACARBEBZDDFKCHDDEABAAIBbFFBXECAhAEAODHF.MEIBhAFA.FFFH..........hAIA......hBAA...,2,-12,-1,11
OJBdTWeYNbIHELMaCQcZGgAfDPSXFKRVU,DAAAXAAARABA.UADABAEB.dAGA..eAFA..bCDBHCEChAAALDFAaCHDQDBAhABAGGBBAAIB.SEEBhAGAKFFAOHFCTGFA.YHCA.hBAA......hBGA...,2,-31,2,33
YHgZGcWeXNIFdLPMaADTVBOUfKEQJbRSC,TAAAOAAAKADA..EACEQAFCRAEF.CAHB.HAGBGCCAhBAAeCCB.XDGAhAAAFBBHdCHAMEFBAAIBBEAAfEGEhCAAbEDDSFFAgGGAcGAAIHDAhCEAaGHD....hDAA...,1,5,-22,27
CZfLdaMHFSEKUXcgbYGPDBIQTRWJONVAe,eAAAZAAAdAEAHADAEAGA.XAGB..bCABGCCABBHAQCFDhABARCFBOBHDAAAALFABhAFAaDDB.MEFBKEEDgFGAhACADFCBTGGA.NDAACGEA...SEBHhADA...hCAA...,1,1,-6,7
ePDWGVIbBMKCQdFXfAcNULZREYHTJgOSa,UAAARAAAHADB..TADAOAFA.eBFGDAFAGBFA..bDAAhAAAMAIBQDGAhABAdDAAXDCAACCBLEEBhADAEEHBJFCBaGDB..PFEDIGGAKGGA...hADA......hBAA...,2,-17,4,21
PRBWQFgLXIEfMcSJCVADNZYOabTHdUGKe,ZAAAaAAAHACBGAEAeAEARAGBBADB..QBGALCABECCBMBBBhAEA.SCEHhAFACDGD.ADGBDEDBODHDdEHAKFFBhAIAFEDDXFFCIHHA.fGAAhABA......hACA...,2,-22,-2,20
LFJaNRgdHCXcMEPQOAefDISWUTYBVbGZK,eAAADAAA..SABATADABAFBGADAZAGBLCCAaAFA.hAIAREEAHGCAXBFDEGGA.hAAAQEFAABIB.hABAfCCE.IFBA.YFEFhBAA.KBHBNIEB.hCAACGHA...,2,-15,-12,3
VOaCKGYReLHXMAfDEbSNBJZPUFWQIcdTg,EAAASAAABACAZADBFADA..QAFAdAGA..TBCAhAAAOAHFaBHDGCEARCEBHEGBhABAACCAbDGDJGBA....hAAA.WGDGcGFCCHHA.......hCAA......hCBA...,2,-21,-11,10
aSYXRgTVQMfIbEBGKUWFCOLeHcdDNPAJZ,aAAAXAAA.RADA.TADA..MAHBIAGAECDBGCFAhAAAKBBDFBHDLDABHCDCdDADhADADAIBAEEBZEGBSDHHhABAgFAAQFCAbGCABFFBCGHAeFFD.hAFA.NIAB.....hAIA...,2,-5,5,10
TOLcYKMfbSgQaHJXBAWPRVZeFNECDUGdI,RAAAeAAAEADE.DAEAGAFAdAHA..OBCCLAHBKBFC.MCCB.bDCDhAAAQDDA.hABAHDFABEEAAAAAPEBBhBEAZFAFCEHATGFA..fFGA.hAFAaFHD.WHDG..hCAA...,1,1,-28,29
FRcDNOMgdbUBVECGIPKfYWJXHZeLTAaSQ,aAAAQAAA.RACADAFAMADA.dAHABAHAEBBBGBDAKBFA..hBAA.fBFEhBDAJCDBHDABeCHFABGAFDGDOEHDhCAAbEFD.CFEA...IFEA...hCDA......hDAA...,1,-20,-22,2
EPbScULeTZCaINKXBWMOQgdHAGJRFYVDf,RAAAFAAADADAEADA....SAEALAGBeBDAZAGB.aCCCKCCABDAAhADAMBIBQDEDhAIAHCEBAAAAGECAVFGBbGCAhBAATFGA..NBIA.OHEC....hCAA......hCCA...,2,-18,1,19
BfELOeIFRVYZANJXcbMKUaPdTGQCHDWSg,XAAAMAAAKADA.UADAdAFAGBBA.HBGBSAFABAHBEDEBhBAAeAHH.RCFBZDBAABBBJEGFhCAAaDHD.QFEDhAAADEIB.fGAALFDB.FHGE...hCDA......hCEA...,1,-1,-17,16
IRBbXWGLdeSDUMaCFOYNKZTgfcHAJPVQE,VAAAEAAARACA..BAFB..XADBGAGAeCCADAGAUBFA.MBIBhAAAaDABODED.hCAAKEGDZDCA.TEGAhCDAfFHAHFCAADDAQGDCIHHALHCAhCFA....hCHA...,1,-8,-15,7
aWVHXKGMBINCQEOcPRUbgYSALDFTfedJZ,LAAATAAA.eADHZACB..aAEDHAFAGAGAMCABBCADCCEAECGAODEBhAAAREEA.UEBAbFAA.hABASDFBAAHA.hACAfEHAdEHA.WFFDKGGD...QGGBhACA.gGAGhAGA,2,-12,3,15
UgcbHQaWSVeGBXNKPADYMCZdRTLFfEIOJ,MAAAdAAARADALAGBFADD..EAFAOCAEUCFA....bBBDHCEBhACA.aCHD.SEAAhADAeDDHXEGAhAFAKEDDAAIBCFGATGGA.fHBBgGCAcFDDhAIAWFHHBGFDDBBB.hBAA...,2,-25,-10,15
OVWFeZBUNMDLPERfcHCIKYaXgJTbGQSAd,dAAAOAAAFADAZAFBBADA.UAFAMAIB.LCCBRCCAHDFA..KAHBaCEBhACA..JEEFGCGAhBAAABBB.eDBFDFBAEGGACEFDXGGAhBCA.........hBAA......hBFA...,1,-10,-36,26
MKRNVTLDfBcOZbaPQdGHXYeJFEIACWUSg,CAAASAAAKACA.RACF...TAFALAEBBAHBZAGB.aCHDdCAAhAAAHECAeCCAEEGBACCAUDFAhACAMFIBDAGB.fGGEhAAAbEAA..QGGA.XFEChAEA.FHCC.hABA...,2,-15,-15,0
FdEDPBecRaMKTbOZLUSHVfWNQAXGJYCIg,GAAACAAAFACA.EADABAFARAFA..MCDBKAHB.OCEBZBCALCGBhAAA.HDDAfCGAhAAAQFAAACIBXEGAhACAJFFF.gFCGdGDADFIB.eDADaHAC.bFEDhADA.SGADhAGA...,1,-4,-18,14
UMHSPLefVNXAFBbYGacOKRIDWECQTdZJg,BAAAGAAAaACAKADA.RAFF.DAFA..EBHFQBCCZCDFUEGAHFAAhAAALBFA.eDEAfGFEhACAXEDCAAHA.bEGDhAAA...OGBCCHHA.dGFC.MDIB.hADA......hAFA...,1,-7,-15,8
NDRVICPJESLcaHQAXKUWbZFeMYBfTdGgO,KAAAUAAAZACBeADABAEAdAHAGAFA..OBFDRCAB.CCDA.EAHBLDABhADAHDEBADEB.XDCChAEAFDHB..MFIBhAAATEGADGGB..PECDSEFD.aFCDhBAA.WHBA.fGHAhBCA,2,-26,-16,10
QXJBCOKTMHGSgEFYcabZWRAVILDfdeUPN,LAAAdAAAeADAUBGAQAEABCBA.KAGAHCEBGCAA.ECCAFDAHhACA.aDCDZCFE.ACABDDEBhABA..fEGAhADAXEGAOFFBMEIBSGCA.YHAAhAEA...hACA...,2,-17,-13,4
acQVZPfYRWNUJEHKMgdCbXTLOSDFeBAGI,aAAAQAAAZACB.....fACFRAEAUCEBHDGBMAFAdAHAhAFAbBDATFEALBHBhAAADBBBBGHAABEAGDDA.hBAAIFGA........hCAA......hCHA...,2,-22,-15,7
CBDAYRLcPeGbETFXSKJQZMdNgfWUaIVOH,RAAALAAAeADEGAGAEAEAFAGDKBDA..ZCAAdDDA....fCEAhABAaCCHODGHHDFAhACADDIBAAAAPEAB.bECChAEATGAA.SFDAMAIBgFGAhCBAIGHABHDA..hCCA...,2,-18,-5,13
FdYXcMeSGbgVJCEOTBNHKWfRaDQAIZULP,ZAAALAAAdAEA.XADDeAGBGCAA..bAFAVDDA.EDHFhABATCAAHGCAKFGDRCEAaDDHhABAAACA.UEGAFHACMFIBhAHASFAACCCD.BFFC.fHABhACA.DAFA.IHHAhCAA.PHCA,2,-3,8,11
YcKJaUGPIFSfdTRWHeAbXODBNEVMLCQgZ,OAAABAAAEACALAEA.QBBBZAEBKAGAaBCEGCEA.hAAAFBHDdCAARECBHFABACGADCIBMDDBhACACEHA..gGFAhAFAJEEAUGGA..SGDA..hAIA......hDAA...,1,2,-30,32
ROEeQDMCWZgbXLcSdGFTPUVfKJYaABNIH,BAAAHAAAEADEeACAMAFAZAFB....XCAALBGB.dCADGCGAhAAATCEAVDDBKDCAaDHDhAAAAACARFBB.QFFChACADAIBCBEA.gGCASFGD....hBHA......hCAA...,2,-18,7,25
JeQKWAdTOPIXFgcNfRGVbDSMYUCEHLBaZ,dAAATAAAOADA..XACBFAGD....gBDBhACAfAEARCBBGDFAhAIAbAFDMAIBCCHAEFEBHDDAaEHDeEGFhAAA.QFCCAEEAIHHANEIASHAGhAHA....hBHA...,2,-12,0,12
TeEQgSVGINKaOXBLPcFDbUdYHZfWAMJCR,MAAARAAAEADE...QADASAFBGAGAKAHB.aBBBBCCALCCBhAGAFCEBDCHBdEEAHDFBhAAAZGBAAAIBCFED.eDGD.gGGAhBAAIGHAOHAA....hABA......hAHA...,1,4,-30,34
TXRgPeAVUWQKZSDabJHNBMFLYGcECfdOI,UAAAQAAAZADADAEAaACE..HBGBBAFAMCDBLAHB.GCDAhAAAECEBdEEDTDAAhADARFGBeFCBABHBKCFB.bFAAFHAAhAHACEHA....OFFB.IGHAhAFA......hCAA...,2,-15,-8,7
RYHPOEKUACXZLcfJTMVSIWdNbDagBGeQF,ZAAALAAAJADA.MAEA..SAGBdBEADAIBBBGAeBHHRCAAHDEChABAECAA.ACAA.CCDA..XCEDhABATECAIFHAhACA..bEFAaFFHGGCBQGBChBGAFHGE.OHDC..hCDA...,2,-13,-12,1
PEbfBAZKQWRXdYGCaSeHOUcDLNTFVgMIJ,ZAAAQAAARAEAdAHAGCAAaACE..HAEBOCCEDAGALBGBhAAA.TDAAFCGHMACAhABAIDDAEEEBBEHAABIBXEFChADASGFAeEHHNIDB.gGDBhCAA......hCDA...,2,-16,-5,11
CTaRBSVHEgQLeXZGPfUcbJdNFMIWAOKYD,KAAACAAARACA.BACBHAFB..EAEALAHBZAGBGCCAUCAA..JDHBdDDAhAAA.MEGBABGB.DEHBaCFHhAAASFAA.hAEA.QGFCeFEFfHBB..hACA......hADA...,2,-33,-18,15
HAYUPWJRaFgTceBbSOdVIfENKCXZQMLGD,UAAAJAAA.RADA.FADA....TBGAeAFHSAHBdCDD.hADA.fDFAhAEAECCACCGAZDEALFFAHEGBAAGAYEEFhAIAaHBABHHA........hBAA......hBHA...,1,-19,-31,12
EbBRVcQSeCgWdZMLJPHAXfYOIKaFDTUGN,XAAAOAAAKADADADAGAFA..EAFARCCA.QBDCeAHBCBBD.hAFAdBHAZEEAMCGBLEHBhAIAHEEBAAAA..fHDBhBAAaDCCFEHBNIABBFDCSGGD...hAIA......hCAA...,2,-13,-10,3
BbZASTCdHfGWJMUPcRaVDKIXLeNgFEQOY,TAAAHAAAGADA.MAFAUACARBFFaBHDKAEALAGB.eCDAhAAAFCAHECCBQEEAhAIABEFDAEHAdFBAfDHAhBIAPFGDDFIBXGFAOHBE.....hCAA......hCIA...,2,-17,2,19
EXgHDSQNVILeJGOFMUZPAKfaWdYRTCbcB,aAAAdAAARADA..CADABAFAEAGEHCAC..QBGAVCFA.eBBBhADAGEAAFCFH.ZEDAAAHAKDDBhAFAfEHA..hACATEGA.XGGASGHH.NICB.hADA......hAEA...,2,-31,-8,23
gbQXPIMEGRVJdASfLDaUYBZCFKTWNeHOc,LAAAaAAABADAZAEBKAEA....TBGAeAGFHCCBOCAA..hABAbCGDQCEChACA.XDGAMAIBRDABdEFChADAAAGADDDBCBBDFGHBNEAAgFFA.IHHAhAEA....hAIA...,2,-23,-6,17
NBQWcLXIUGSZFdfMOHKPVYTJbDgAeRCEa,RAAAEAAABADB..QACALAFAUCCAZAEBdAHA.MBGBHCFAKCCDhAAAVEGB..TEEAhBEADEFBAAAA.eDHBCFCA.aFHHhBHA..NHAB........WHCAhAGA......hAHA...,2,-31,-11,20
DRbHgZVPGBJSdQTaLYOCAIEKfXeWcFMUN,EAAAXAAA..eACAFADAUAGARAFAHCCAZCDAGCGABDBAdDHAaDABLECAhAAA.CGAAACIBhADAfECAMFGBDFIB.hAGAbEEDgGDA......hAIA......hCAA...,1,4,-32,36
BgXGMPVNWcSUCdYLZHAfaOTRIeDFKEQbJ,aAAARAAAeADE..KADAEAGEQAFCBBDAGCDBMAIB..VEFAhAAA..NBBA..SCCAhADAdGCA.ZDCEACCBOEEHhABATDGAFFFB.gGDD.hAIAPHAC...hCAA...,1,-7,-21,14
gFfNdYXCWKIESHQbJcPARUVaMOZeBDTGL,RAAAaAAAZADBBADAGAFALAFAFAHF..dCCCCBBD.KDAB..ECDAHDGBhAAAQCFA.JDAAhADAADFBMEEBDCIB.TFBAhABAfEEA.XFGASFFDbGAA.hAGAcGGDPHFC..hAHA...,1,-9,-26,17
MAOGLUTeCVFfQPgEBRaKZdXNbSHWcJDYI,GAAATAAA.eADAFACA.QAGA.ECDARAEFZAGBdDFAXDCChAAAbCCDHEEB..JDHBDDABhACAMGAAADHALEHBhADA.CFEDfGCABGHANIBB.SGGDhAEA.....hAAA...,1,11,-17,28
ZVSMRPDHIYTgNLUOabXWGJCEBKdcQAfFe,eAAAZAAAMACARADAHAGB..TAFALCCAOAHDbDFA..GEAAhAAAEBEBdDDAAAIBFEEH.SFHDhABADCCBgDGBhABAaGDCXGFDCFEAKGFAfHAB..hAHA......hCAA...,1,16,-22,38
dgOUbFLDNYZCPQSEBGXAeHJRVIWMTfcaK,HAAARAAA.VAEAMADA...TAGAaAHDdCADOBDCFCEHLDGBhAAADCCBZCFE.QEAAhACAEDDBGEGAADDBeEFFJFBA.hAAAfGHAKGEA.......hABA......hAIA...,1,4,-14,18
fXVBeYECFWMLPDbaUGdZgHARIQcTONKJS,RAAAQAAAOADA.KACA..SAGA..XAEBhAAAeBDFECEAFAGDMCCBLCDBhAIAbCGD.GDGAhBIAZEEBAAAATGGAfFEABGDC.CHAADCIBaGDH..hAHA......hCAA...,1,-10,-16,6
dKQNgGfCUFBVJTARZLWPbEHaDYcSXOMIe,RAAAZAAALADB..bADBHAFADAGA.SCCDMBFA.eCFAhAAAdCAAQCFAhABAGEEACDHABFAATEEAAAHAEFCAaCCHhACA.XFCCKGHB.fEHA.hABAFGGH.....hAFA...,2,-11,-4,7
EWgAGRLHTJBbSIUaFQNcXOCKMfVdZeDYP,RAAAHAAABADBSACEUAFA.aAEDQCCA..XAGAhAAAKAHBMDFAdCCAeEDAhAAADCGBECHBAEHA.GEDAhAGATFBAbFFB.FFHDOFGBfHAB..hAHAYFHB..hABA...,2,-31,10,41
ZfdMcSHeUbNPXWQLFRCTBVKIOaDEYJGAg,ZAAAdAAAMADAHAEAeAHHUBDA.....bCABXAGALDDARCBBBCGAhACAKDHBaEAH.EECBGEEAhAHAAADA..fFFAhABASDGAPHAAQFCACGHA.IGHAhBAAOHFC...hACA...,1,-2,-16,14
TdEMXOeSCfGZYbKAWIaVRHQBLPDJNFgcU,aAAAHAAALADADACAFAEDUAGAdAHA..EBBBMCCB..eCEBCDDAZDFAhAAAbDCD..ADGA.IDHAhAEARFFABGBA...PFABhAFA.JFGBNIBB.gGDA..hBAA......hBHA...,1,-11,-30,19
OcSJXLagDEQNCZeGIUBRTbKMYHFVdAWfP,...fAAAOAAASADALADAaAGDEAGA..QCCAhAEAZBCAeBHHGCAAhAAABBBDRCEAbEFAMDDBHFCAdEEAAEIBhACAcGAAXGEADBIBCGGAIHHAKHEA.YFAFhAEA...hAGA...,2,-6,11,17
OMISWYCRcLZUQfgDVNFHTbJeBAGXPKdaE,GAAAKAAAEACE.MADA..SAEBCAGARCDAZCGB.QAGAhAAADDCBFFBHHFEATCCA.eCFFhAGAAAABXGCDaDGDOECBhBIA.IGEA.cGGAfGHAhACANIDB.....hCAA...,2,-15,-15,0
dDaVQgXFULJfKHbTOWCMIYAcRENGePSBZ,EAAAeAAABACAdAEADAGA..aADDQBCA.FBGALAFAhAAAKCFAHEEAbCCA.TCGAhAGACDHAMFIBAEEBRFFA.PGCChAHAZGEA...........hAAA......hABA...,1,-16,-21,5
JeNZCLagYQIODEBSAWcdUbHXPRfTFMGKV,dAAAHAAARADAFAGAGADA.KAFAeCAAZCAAaAHD..QCEAhACADCGBEDHBBEFDACHAUDGA..hADAbFAAXEAA.hAAATGGAMFHBJHAACDDD.......hAEA......hBAA...,2,-21,-6,15
VPOaRSZWNGUYKEcMCTXfBIQJedFHAbLDg,LAAADAAA.VAEAaABERADF.ZAFBGCAA.KBHBEAHF.MCCBhAFATCCABCHA.QEEAhBAAeDFBHECCADDB.bFGDhABAOEGFSEHBNEIA.cGDCCFCA.fHABhACA..hAEA...,1,-4,-22,18
BKEeAWMFYLcDTbQJadIZNGXVUSgORHCfP,MAAALAAADAEA.TAEA..QAGAdAGAZCAAGDFAXBBAhBAASBHHRBEBHDGBfEBAhBBAKCEDACCAFEAA.hABAbEDDaEHD.IHEAUGGBCGCC.BFED..hACA......hAEA...,1,2,-10,12
QeLGBMHSDKYbZTcPNURfaVJECXWOIFdgA,eAAAGAAAHADAKADAZAFBTBGA....PAHDRCCBaAGAECFBCCDA.hAAAODHDdEEAADABLEHBhACAMEFBDFAA..cGFDhAAAfDCE.XFAA.FGFD.hABABHDA....hADA...,1,2,-20,22
MYcAQCaGIfEbUOgKBdVDLWTSeXHJRPZFN,aAAAGAAA.EADAOACDBAFAdAHALAEA.SAHHhAFAHCDARDFAZFCAMBBBAAABQGGAhACAfCEA.bCFDKHBAhADADDIB...eECB.XFEC.hBCAFGAAcDCCCGHA..hBHA...,1,-1,-10,9
ETLcSGQBVKeDdaNHCXJYUIFAPOMZbgWfR,MAAAZAAA....bADBfADA.EAFATAFALBBBhAFAGCAAQBGAhAIAKBHBeCCBaCFHHDGBXDDDhBAAUEEAAAHAOEGDgGDGRGDA.BCFDDFIB.hCAACGHA......hCBA...,2,-4,6,10
bBEcGaUXKVdAZTFLPDRWCMSHOegINYJfQ,ZAAATAAALADB.RAFA.MACAHCABeAEA..gCFAhABAIBHAJBDFQEGAhACAECFBaCCH.KEEDADHADEFBSFAAhAFAOEGDfGCAbFCDBGGD...hAGA......hAIA...,1,-1,-17,16
WPfIYaJTGCbZLAKdXeSEUDcgVBRNQHFOM,dAAAeAAAEADADAEA....VAFARAFAHBCAMCCA..fCGAhAAA.aCHDGDAAhACAZDEFAEBASEBAhABAgCGAQDDAOFHBWEEDIFGA.hAIAYFHB..hADA...,2,-26,-4,22
EWQAOaMeTCKgSDGPZNbLRJfFHXcVUBYdI,aAAAeAAA.KADADADAZAFBLAGB.RBBA.FAHDHCEBXCCAUEBAdEHAhAIAEDGA.ABFA..MFGBhBAATFAA..SGCAhBBAGFEBbFCB........hAAA......hABA...,1,-16,-19,3
ODfSLgZFPbXaIGKNdVeHMCTYWUERcBJAQ,QAAADAAALADAZACBFAHB..XAEAGBBAdCGDHBGBMDEBhAEATDEA.UFAARFABBDFDhAFAAAIBSECBhAAA.bFGBaECD.KEHBNICB.eFFB.CHEA...hBAA......hBBA...,1,7,-17,24
OCWbfSgEDcZTAeUJYXLPGHaBFNdRIQMVK,eAAAUAAA..JADALAEA.HBCAaAGABBDDdCGARDEBMAIB.hBAAOEDBCBGA.bFABSCDAhBCA.ECHFhDAADEIBZEEAAAAAXGDDGGDB.FGGBNEIA...hDBA......hDCA...,1,5,-31,36
DBTOHVLRbASEecYfKQMaNJWCUZgIGdXPF,EAAAeAAA....fACAMAEAaAGEJBCBCAEAZAFB..GBEAhAAAdBHAFCDBTDGAHEAAREEAABEBSCGEhABAKFHB.hAAAQFGBWHCA.......hAEA......hAIA...,2,-18,-11,7
cGEOgfePYANdDCSKLXHVJaIQRZFWTbBUM,dAAASAAALADAHACBaAGD.RAEAZCEE.FDHDTCBABAHBMEAAhAAAECFB..OBHD.hABAeDEBAEFACFAAXFFChAEAVEABQEGDUGCA.......hAFA......hCAA...,1,-5,-12,7
NYaTHIZJOXKPGWVReFbAUCLDfBdcMgSQE,LAAABAAAdACAMAEAQAEA.EAGAaAGEHCAAZBDB..OCBBhAAAKBHBGDCB.RDGFeEABhABAACFADCHB.fFDEhACASDFBYFFFTFEA.IHHAhAEAJEHB......hCAA...,1,8,-34,42
fPUaKdSYOJVXNDLGHeZIRcWTgMBEbFACQ,QAAAUAAAdADA.OACCJAFA...XAFBLCFAHBGBhAAAeDBARCDB..TEAAhAEAMEEAEEHFAAIBCDCD..aEGCSFBAhAIAVFCBDFFBIGGAgFFD.FHCAhBAA......hBCA...,1,9,-28,37
LaENGSMBQKCbAVOIYWDXTPgRUcFeZdHJf,OAAA..IAAADAEA..TAGARACAFAFAeAHHHBBCLBEBhAIAECAAGCDAMCGBhBAAQDFCbDGD.AACAVFGBhCAAXEDC..gFCD.hBBA......hCAA...,2,-22,-5,17
TdgaAFDSQcUMGIBJLHbCeOWNKXYPVfREZ,SAAAQAAAMADAGACABAGAHAEAeAHHOAHD.KCFAXBDAhAAAVEAA.EDBAdEEAhAAAABDADCGBIEHALEDBhBCAbEFDCGADNDIA..fFFA...hABA......hAEA...,1,-4,-11,7
BQXDKYWGaVTbAUdJfgcEHIPROeCFZSMLN,dAAAJAAA.....fADAEADEHAFBRCCAeAEHZDFELFAAhAFABAGAQCBDKAHB.GCFAhACAaEEH.bFDBACCAgGFAhAHAICHACFHAMDAB.DHFA.VGAAhADA......hAGA...,1,-6,-13,7
VJEPDMWUacgFIARKNBGYbHCZdTLfQXOSe,RAAABAAAGADAHACAdAFBTAGALCGB.QDAASCAAeDDDhAAAECEAMCIBUGBAaEHDhABAFDDHAAEA.KDGB.bFEDfFFEhADA..OECH...hAIA......hBGA...,1,-5,-10,5
LZIEFWORaQdVAHDcUbKSYNGeCXgMfTJBP,HAAADAAAUADASACEGAGA.eAEH.XAGAMBBB.TCFAhAAABAFAZCCAFCCBREEBdEEDAAGAKDHBhCAACEHA..JGDAIGHAhCHA.OHFCaGGA......hDAA......hDBA...,1,0,-36,36
ZKTAMJGQLVYUWERdbgIXeODfaCcPBFNSH,GAAALAAAUADARADFdAFA....bAFAXBGD.eCABhABAfCFACAHB.BCHDhAAASCCDHDBBZDDFhACAADFBMEEBQFFCVFFA.EEHBOHECaGAB.hAGA......hAHA...,1,-4,-12,8
McYCRPVadfWUDObAHgNXKJGTeBFESIZLQ,HAAAXAAAGADABADAEAFAZAEBMAIB.CBGA.RAGB..aCDBdCADUDAAhAAAbDAA...AAIBKDFAeDGBhAAAFEEHLFAB.hABAQFDAPEHD.fGFBOGCCNIDB.hADASHDG.hCAA...,1,17,-18,35
LMQKCeUFWXYfSPbRGcIBVaNJOdETDHAZg,ZAAAMAAAQAEAKADA.eAHBFAFA..XBBCSCAARCDAGCGAhAIABCEDaCGD.ODDBhABAEECBHFEBAACALEABhAEACGCD.UFEA.fGGBcGGD.hBAANIAB......hBCA...,1,1,-20,21
DfZIPVbECKcTdYQgBUaXASLGOFJHReWMN,GAAAFAAAHACBRADAeAGHMAEA..DAIBZDCA...IDHAVBFBEDEBhBAAKEAD.dFCAQEBAhBEABEGDaFGE.ADIBLFGBhBFA.OHBANIABfGAFCHEA..hAAA......hACA...,2,-21,-3,18
NQTOCRWScJDEVKMIBbZLUaXGePFAYdHfg,HAAA..fAAAQADCTADARAFFSAHBDAFAEAHFMBCBhAAAbCAC.ZCFALDEAhAAAaCADeDCHADIBdFAAOEDDhACACFDAcFFAKFFABFHB.XGBCFHCAYHFAhACAWHEA.....hADA...,1,15,-7,22
KFEMeZGgXHdaYWQAUDSPNCfcBbITLJROV,SAAACAAABACA...TADARADFKAFCFAHDEAFEZBFE..GCAAhAAAHCCBaDAB.QDGAhAAAACABDCFB.fEFEhABAIDGALFFAOGDCeHAEdGCA..hADA....YHFAhACA.,1,11,-46,57
RNGcSDPUBEAKHgZfFeLbXdQMCYOJTIaVW,HAAAZAAAeACELADBdAFA.MAFAOAHBTBFA..aCCCRDEBGEGAhAAADCIBBDEAABHAfCAEhACAXDFD.QFBAhBFACECAJFHB.WHDASHEA..hABA......hAIA...,1,9,-32,41
ZYFRCVEPXKOdcaMGbLIQNBUHATSgWJDef,TAAASAAA..JACAeACHZAFBRCCBEAEA.KAGAdBHA..aCEAGEFAhAAALCHBQFAAhAFABDDAHEAAACEADEIBFEFBhAAACFEC.XFDDMIAAIHEAgGGA.hAIA......hCAA...,2,-11,-2,9
FTJIRXZQPfSGBNadgbCHDUAVWeMELKcYO,eAAAEAAALADAKADA.OAGDTAGARCBAZDEBQCCA.SCEAhAAAGEAAaCHDbDFAhABAHECD.AAEAMFHBhAAAFFAAXFCDBGFA.dFFADFIBWFGH.cGAChAFA.....hAIA...,1,3,-5,8
XGaEQPRLKOANdCISMUHZfcgTDVFWJeYbB,dAAASAAAHADAZABB....fADATBGAFCEDeAEHBAHBhAFAaAGAEDCFRBFFLDAAhAAA.ACCBCCHAMDGBgEEBhABADDIBVGAAYEHBbEGD....hADA......hBHA...,1,-6,-16,10
gEKPIWCROMGAUFZXNHBQTDdcafYJeVSLb,ZAAAHAAAQAEAdADAaAFA...JAHBeAHHLCABEBFBKCAD..hAAAIDDARDDAGEGAAADAFDFBhABABCCDDCCBfGBAhACASDHH.bGBAWFFD..MFGB.hBGA......hDEA...,2,-15,-7,8
TJcKgCXPdZOIFBQLEMSGaAfbNVWYDeRHU,...bAAAVAAA.DADAHAEAUAGATCAA.KBHBXBDAhAAAZCEAFDDHLFFAEDDB.hBEAGGABADGA.fEAEhAAAYDHBRFEBJHFACGBA.......hBGA......hBIA...,2,-32,11,43
SKAZELfFbRGDHQaegWOITNUdVPCJYcXBM,EAAALAAAFACD.RADFHAFBeAEA.OAHF..TBGAdCAACCCDJDEBhABAXCDA.MDGBhAAAADHBZFAAGEAAaEHD.gECBhAEAIGFA.NDIAPHEABHAASHFAhACA....hAFA...,1,1,-12,13
IOdQANMJUFXRTCKcSbGLYHVWBDaEeZgPf,MAAAFAAARACF.KADA..SAEBGAFAHBBABAGAEAHBZCEA..fDDAhAFAdEEAAAIB.UEFBhAIATGAACDHB.LFHBhAGAYFDBDCGAeFHHIGGA...hBAA......hBBA...,1,-9,-28,19
YFQVKeGOSNDIWHdEUacfLMJXgTBbCZRPA,QAAAeAAAGADASACADAFAHBFBEAHFaAED.LDBB.hAAAMCIBXAGABEFDbEGDhAAARCEAAAGAFDAA.ODCDhADAWDDD.dEED.fDHA.TGGAhCAA.CHCA....hABA...,1,-1,-9,8
AZWQgcfMDRJETLINHeXUFObSBKdYPGVCa,ZAAAQAAA..fADBRACAEAFELAHBHAFBeAHBFCDDSCFBhAAAdCAAGCDAaDAAhADAACCBgFAAhABAMDFBTEGAXDGDOHCAKGGDPFFB.CHGADFDBhACA.NIAB.....hAFA...,2,2,4,2
cXSfWgPaQIOdCEVMeHZYGLTKDBNRbJUAF,XAAASAAA.....fADAgADAaAEDQAGAhAAAdAGAECCBeBHHHCDChABAGDAATDAABDFAhAAARDGBbFFDADABFEDDPEEBCEHAZFFALGAADIAA..hADA......hAEA...,2,3,5,2
BWGCYbUJXQTAdSEPaeODVMZKFfIHNLgcR,EAAAeAAADADAZADB.FAFDHAECLAHBRBCBGCEA.CAHB.UEEA.QDBChAAAACBBdCHAaECCMFHBhAAAKEHB..IHBAhABAgGDBBBCA.bGDC......hBHA......hCAA...,1,-10,-16,6
fZdDBPNWbQTXMREJaVUISOFHYGLcCgKAe,eAAAdAAABADA..PADC..bABDTBGARAEF..EAGEaAGAhAAAUCGAOCCA.HDDChABAGEDALEHBhCAACDADAEDBZFFBDFGB.QGDAMIAAIHHA.hCBA......hDAA...,1,-5,-17,12
gcWPdTUZBAEfaKRIVNXFQDObGeSCMJLYH,EAAAaAAA.RACA...VADAFAFADAIB..GAGAeCCA.MBBBLCGBhAAAHCCA...gDABhADAPDFDdFHAZDEBAAIBKGAAhADAXGEAOEEHCHHA.......hCAA......hCBA...,2,-19,-5,14
JEBKHZDSLRTOCGfeQXYdgUVAWFcPMbNIa,FAAAMAAA....bACDaACE.EAFAHAEAZBBALBHBRCFACAHB.eCEHhAFAQEAAdDGCVGCAhAIAAEEAPEGD.JGCEhAEADDDBOECCXFGA......hBAA......hCAA...,1,-9,-10,1
WPTfAbNYIMKXRLHgGJeBEQFdCaSZUcDVO,...bAAAIAAA.MACARAEAHCAAGAEBeAHHEBCBdCEDaCDDZDFEhAAA.DEABOCFBTFGAhABAAAHAKCHBLHAABDBAQEGChBDASEED.cGFC.PHCChCAA.....hACA...,2,-4,-1,3
faWeXMPFObNJQISREHBcCYKTDGAVZLdUg,ZAAAdAAAUADAaACA..eAEHMAGB..OAGBJAHB...QDDBhABARCAAHDEACEDDKEHBGCGAhAHA.AAIBLFFBhCAA.WCCDFFBBbGFCSFHHBHAD..hCBA......hCIA...,1,-13,-25,12
DWBSRGMgZTbXEPHNJCadLVKYecOIAfUQF,QAAADAAABACARADF.GACBZAFB...bAGBEAHFHCDC.CDAAdEEDhAAALDHBKDCD.eBBBhAFAOCHDADDBFEEAMFAB.hBAATFGAXFCAPGCAaGGC.....hCAA......hCFA...,1,13,-29,42
ZBNIHXCALVgYOaDReMJKEfSUFTGbdcWPQ,LAAAVAAA.OADDRADF..eAFEMAFAEBFFUBFAGCGAdCAA.hABA..PDAAZDDABBHAhACAHEEBACCBaDHDKGDDFGHDhAAATFCA...bFFC.....WHEAhCFA.....hADA...,2,-9,-6,3
ZMELNJCARSKFTgfcOGHUIdYDXVeQPabBW,RAAAFAAA..TAEA..fADAGAGAHCCAdAFADAHBeDABaBHDhADAbDFDZCCALECAhAAA.CEHAAAIBKDGDOGAEhABAIECA.XFBC.QFFBhAIABGHAMIDANEEASFHHhBAA.,1,17,-29,46
KYQHXfWOaCMcGSAFIETdNUeVLgDJRPBZb,EAAAdAAAeADALADADAHB.RAGFZBCAKBFB..HCAC..fDDAhAAAaBHDMDEB.GEAA.hACAAAEATEFAVEABgDFGhADABDHAbGDC.QGGA.OFFBhAEASHGANIAB..hAIA...,2,-10,3,13
cbdPeIFNCHZAJOVDTEXRaLYKWQgGfSBUM,OAAATAAA.RADALAGBKACC..QAEAGCCABBBDMAHBhAAAdCFCeCCBFDHDHEABhAEAAAIBDCEBEDGBaFFB...gFDAhBGASGGAbGFANIAB......hCAA......hCDA...,1,-4,-20,16
JICeDLEHZdfUTYPRcMQaAOBWNGVSFKbgX,BAAAGAAAFACAKADA...XAFBCAFAeAGHLCBAHBGBdCDATEFAhAAARDEB..MAIBhAAAAAIBODAH.VFCAhACAbDGDJFAAEFHF...ZGEA......hAFA......hBCA...,2,-26,2,28
GWLRHUNCdcQTVFEPaXJbIZSAgfMeODYBK,MAAAeAAADAEAKADAGAFARAFA..HBCACAHA.dCHAQBBChAFATDEAEEBAaCEH..bFGBZDGBhAHA.ADDBOFDABGDA.hAAA.WHDANEIA.........hBAA......hCAA...,2,-21,-9,12
afedIBTObGRQZADgFVLPHJKXNcMUEYWSC,FAAALAAAHACBKAEAXADD..MAHBEAFA.SCEAhAEACAHA.eCHHdCAATCFAhABAGEEARFCBACCBDCIB.gDDBhACA.PEGDcGAAUFAAaGHB.hAGABHCA....hAFA...,1,-8,-18,10
ITaLBSQHFPJOWCgKcdRXMADfNGUeVbYEZ,DAAAGAAAeABA..bADAEAEA.ZAGB..aAHBLCCAQCDAhAAAHECAFCHDOCHDCDCDKEADREFBhACAABGBUGEA.IGHAhBAATFDASFHB....hADA......hAEA...,2,-14,-8,6
DBZFICgLQOWUTdaSANKJeYMbREGXPVHfc,KAAAeAAAMACAEADAGAFA..XAEAHCCADAIBZAGBCDHALECAhAAAQBCDOFBBhABATDEAaFGAABIB..JDHBYHDAhAHARFCA.fGGBFGFDIHHA.hBFA......hBHA...,2,-13,-4,9
cRKAeMQPadGYFVIBHTbfEUZNOXWJCDSgL,eAAAMAAA.QADAdAEAGAGAFAFEBBBAHCCA..TDBAEBHFZDFEhAAAODDAXFGACBDCDDIBhAGALGCA.KHFAhABAAAIBaEEC.VFGB.bGBANIAB.....hAIA......hCAA...,1,2,-9,11
THBEJQYXSLcGKUagdeIPMRZWFNbCOfADV,TAAAHAAAEADE.QAFCSACBGCABaAEA.eAHH.MDFBhAAARAGFZBDBFDGHbCEDfECAhACAACCBBDGDJEHBLHAAhAHA.KFHB........hCAA......hCDA...,2,-20,9,29
RWCdcbDMZfEJOVeHBFTgYGNUKSLaXQPIA,RAAAdAAADADAZABB.EADAOAEEHAFABCEA.FCGDTCCA.GCEAhAAAKDCAaDHD..QCGAhABAAAHACEFD.bGCCMICAhBAAJHFE...gGGA...hAHA......hAIA...,2,-23,-21,2
XSIfLZgdceACBKHWTaEYOJVFbPQGUNDRM,KAAAHAAA.aACAEACEOAEDFAEA..QBGAGAGADCCBRCCAMDGBhAAASDCHLEEBdEEAAAGBhAAABFCATGFAJHAA.PEHDhAIA..NEIAfHFFcGDC..hAHA......hAIA...,2,-21,1,22
HgeXNOCfKDIRcQMVYUSTFaJLZEbGABWdP,dAAAHAAAeADAOACAKAGA.RAFA..MCCAUCCAFCGDLCFAZDDB.EDAAhACAACIBBEHA..gEDAhADACFFADDDBQGAAhAAASEHBaGHB.GGEB...WHCGhAEA.....hAGA...,1,-10,-17,7
SXceFNOTMZAafCBRPYKLHWDIgGbQJEVUd,aAAABAAA.RACAKAFCHACB.DAEAGBGAQAGA.EBEEdCAAXDEAhBAAeCCAODEDZDGBABBBCEDDhBIALGEA.IGCAhAAAgFDA.......hACA......hADA...,1,-6,-30,24
VcCXZIULPWOQBFDASMNYeKgaGRbfdTJHE,MAAAeAAAKADAGACBRAFF.dAGAHCCA.EBHFCBBDZCDALECAOBHDQEGAhAAADEEB.AAHASFABhABAgFAAaEHHhAFAbGEC...TGFA.....hAFA......hCAA...,2,-17,-5,12
beGHEgcOVZNXAaJDTLKIFWSRPYfQCdUBM,aAAATAAALADA.FAHBRACF....fAEBdCCAMBBBeCFBhAEAHAGBECABOCHDZCDBAAIBhAAAKEDASDGAhACAQFAABFEAbFEAgGCBcGAAXGDChAGADGIB.IGGA.hAFAWHFA.,1,5,-18,23
WZQeYVMdKSAcBIfgCTNDXbUPFGJLORHaE,BAAA..fAAATACA.XADAUAEAGBGALAGBhAAAHCAAEBCBZDEFeCAFMEEBhAAAdDEAAAHA.gDGAhACADEIBFGBARGFA.aEAD.QECA.KFHB.hACASGBH.hBGACGGD.NIBB..,2,-9,14,23
QXNYWGBMafLROZePAEJSVUgbdFcDKHCTI,EAAASAAAUADA.dADADAGAHAFA.TCEAQBFC.XCBChAAANCCAGDGAaBHDRFABeDDBhAAA.AAHAgGEAhABAbDECKEHB.CHCA.IFFA.BGHDhBCA.MHBA...hAFA...,2,-17,0,17
GcYNPZaMRKVAdDbUfgHWTELBXJIeOSQFC,dAAADAAAUADAHADAEAGELAGBBCBA..JCEBeBBB..QCGAhACAGDDA..NAIAZFBFhBAARFAAADAB..bFFA..fFGAhBCAgGCAXGEDSHFACHHA.hBDA......hBFA...,1,-4,-23,19
OFGTbWcaNEUCRdHIDVXKfLgePQMSAJZBY,ZAAAOAAAGAEA..TADA..bAGBaAFAECAARBFB.HDACDAIBKBBDhBAALDDB.eCHHhABAMCDBAACABFFAFDHDNEEAdFFAhCAAXGBC.fFHA..hAEA......hBEA...,1,-4,-21,17
OeVfUTPWNMdZQJDCXEBFcGHaRIAgKLSYb,LAAASAAAOADDeACH.UAFA..TAEA.PAHBhAAAMAIBZCAA.QDFAhABACCEDEDDBFDFDHEAAhABARFBAAEEBKFFDbEGD..fGHAdGADXGCDBEHBhACA.aHBC....hBFA...,2,-19,10,29
UHgMedBfTRDZCOaQJGNcIXEPWALbVSYKF,LAAASAAAFAEAHACBeAGHdAEBBBDARAGFZDEA..aBHDGFBBhAAA.IGGAECAAACFBVDDBhABA...KEHBMCIBhABATGEACCFD.QGGCNIAB...hAIA......hBFA...,2,-12,-9,3
BEGVHFQJYOUZNKaARIWXcPMDeSTgfCbLd,RAAAXAAAMADA.DADAeAFA...TBDACAFAdAHAEBDB.HCEBhAAAQCFAODDHZEBFhABAaBHDAAAA..IEHAhBEAPCCBSEEBbGFALHBABEHA.FGFDhCAA......hDAA...,2,-18,1,19
UVHfFXgQceLECZWbJdISAYBOaDRGPMNKT,OAAARAAAGADA.MAFATADA..HBFBXAFBQDAAhAAAeAHFEBBBZEFAJHBA.dGGAhABAACFBaCHDDBIBKHECUDEB.hADAFDCD.LFFAWDDD.SHFAhBAA......hCAA...,2,-12,5,17
DSgHPGdZEYQNXVUAKLeaCOFcbRBJfTIMW,eAAAaAAA.FADDRACFBAEB..TAFAMAGBDAHBHCDC.dAHAECEBQDGAhAAA.XEEChABAAAIBLDHBOCCHhAFAbEECJFCBfGGASBBD.GGEBhBAA.....hCAA...,1,-10,-15,5
IcEgPKXdeOJYCQNbVBMRGHSDUTWFaAZfL,ZAAALAAAEADE.KAEAeAFEOAGD..CBFAQCAA.hABAVCDBRCAAHCEB.DAIBhACATCGAaDHDACEBfEAEhAEAgEGAdGEAYFGFBGHAMIAA.hAGA.SGDAhCAA...,1,-2,-28,26
CSKgdHJeNbPcBEVXGWAaTMZFfIRYQUOLD,aAAAZAAAFADA.RAFF.QADALAHB.SAFAdCAAHCCCeEFAhABA..bCCCBFEDEBHFGCFAhADAAFIBMHCA.fEEEhAGA.IFHA....hAIA......hBAA...,2,-22,-20,2
GScQJWfANUIeYCTHBMaFgDbOKXZdEVRLP,UAAAeAAACADAHADA.aAFADAFA.KAHBdCDD.RCFFGDAAQBEA.hADA.JDHBAAAA..ICCAhCAABEEDMHCA.FGGHhAIAbCGD.ZEDB.EFFB.......hBAA......hBCA...,1,-11,-29,18
AeBQMRYLdgIUZaPOCXETSDNWGfVbKHcJF,eAAAMAAARACAdAEA.UAGAZAFB..OAHDEBCADDDAGCDA..VDFAhAAAHDGB.FBBHAEEBQGBAhABALFAAaFFHXFFChBGASHBAfGHAcGGD...hAFA......hBAA...,2,-15,-7,8
bAKSEfIBFHUVXdLQNMGZRWJcOTYeaPDCg,EAAABAAAHACAUACAdAFALAFAMAHB.RCDA.JCCF..OCBBeCHHaEABhAAADCGA...bEDDAAGAKDGAhAAA..SFFBhAEAFEFH..XEBDNIAB...WFHBhBCA.....hAIA...,1,-10,-36,26
bZaQgdJGHYcXBIeOSAMKLCPFRWDNUTVfE,MAAALAAAFADD.RADFDAFAUAFA....TBFAEBBBZCFE.QEDChAIAdBHAHCAAXDEDhABAeEHBABHA.CEGBPFHDhACAVGEA..aFBB........hBAA......hBCA...,2,-17,-16,1
HVRWXGbdTPBQUYJecMLDNOSIAKgFEaCZf,FAAAEAAAZACBHACB.RAEAGCEBdAFABAHA.QCGAUEAAeEEBMBEBhAAALEHB.OHAAhAEAABCBaDED.CGGC...fEGEhAHA.XFBA...hAFA......hAHA...,1,-11,-24,13
MWdRJCAfaEYLeFNSVDOQBUGIPKXcHZTbg,EAAAeAAAFACD..SADAOAEA.QAGAGBDAKAHBHCCAhAAAZCFB.bCFDMDHB.RFBAABFBhAAAaDHF.LEABhABADDIBBGGDIFCA.XFEC..hAEA......hAGA...,2,-22,-7,15
HaQVeCFXPBMdfTbWcSZONgDJKRAYULGEI,LAAAEAAAHACAaAEAeADH.FAFABAHA.dCCDTCAA..bCEDhAAASAHHZCGF.hAHAOBFBDCIBRGDAADGBGDFAhABAQGGCXEDD.MDIB.fHDBhACA...hCAA...,1,-6,-10,4
TGOEBVPcaJXdbUKQSIMYZCANeRDWHFfLg,RAAAHAAALADBGADAEAFABAFA.VBGBaAHD.dCADKCFA..QEFChAAAMCCBZDFEAAAAeDDDhACAFFAB.TFAA.OEHDhADAcFCB.bFGBSHAA.CAHB.hAFADGGB.WHBA..hAFA...,2,-22,14,36
MJTfEHFUBRPXaZQGYDACeOIKLNVbgdWSc,eAAAKAAALACB..bADAdAEA.SAGAMAHBJCCAEDFFHCEChAAABDHAREBA..aCHDGEAAhAAAAAGA.OEEHhABAIFFAgGFA.WFCBfFHAhBEA.FHCA...hAEA...,2,-17,-15,2
OHBCTRFEPYMeQbAXfdVGDcSWIgNZKLaJU,dAAAGAAASADA..gADAZABBaAFD.OAFDHBGBTDCAhAEAEAHBMCHBeEFBhAHAAAABfDDADAIB.hBAAIEFALFHBBEADRFDB.FFDD.QGGAhACA...hCDA...,2,-4,-4,0
cQgLKXPEbTeVJDaZOGMHYFAfIWRUNdBSC,..IAAARAAAdADACAFA...QACALAHBKCCDEAEA..eAGFhACADCFAZDEAGCEAHFAAAAIBfCCEhCAAUFDABFGD.hAAASCHB.XDGD.TGGAhCBAaGHDOHBC.hDAA...,1,-15,-20,5
aPceFQNSVZXIUWOAfdTGCHMRbKBDgYLJE,dAAAGAAAHADARADABAGBDAFALBHB.ECBAaAHD.eCDAQCEAhACASDADZDAAXEEChADAIDGAODCBhAAAACHBTFGAMDIBKGDD.gEEB.PHFAhACA....hADA...,1,1,-21,22
gPbKdMCWDeUVRfYBaJAHNSTcZGXEQILFO,HAAATAAAGADA.EAFALACBOAHD.bAEAdCAD.MCGBDAEAeBHHhAAAREGFBFAAACEASCEAhAIAZDAEQFDAFEEAKEHBhCAACHBA..WHDAfGGA...hAAA......hACA...,1,4,-12,16
gOJRbVDdFIWKBfCcGUZAHEeaNLPQXYSMT,HAAAEAAA.eACEaACDLAEAQAFCSAHHMAIBOCCBRCDADCBBhAAAdDEA.FCGDKDGACEHAGECAhAAAAAFA.XFGChAHATECAbFEAIHHAfGCE...hCAA......hCDA...,1,6,-13,19
RFCHbMNPXcEeGKTAVYSQBDdLJaIOUgfWZ,SAAAQAAAdADALADA.aAGDOAFA.UBGBfCCAhAAARCEBHDBAbDGDMAIBhABA.XCFCEFBBKGFDAEIBhAAABEAA.DDEBIHHAZEGBCECAcGEB.hBCA......hBDA...,2,-11,-8,3
IYUAbBgaMXWZLfNQCEHDJKdVFTRceGOPS,BAAAaAAA.MACAZACBLAFA.QCEAHAECKBCAdAHATCGAhAGARCDAeCBB.GDGAhAAASEBAIFEAhBCAABBBbEECXGEA..fFHAhAHA.NICB.DIDA...hBAA...,1,-9,-21,12
OIgcFTEGJYWRCadSXZbQAVDNMLfKUPeHB,DAAAMAAALADAKADA.eAGHHAFBBBBAOAHF...gBBBhAFATCDAECHFGDEAhAHAJDCFREAB.dECAZEFAADHBfEHAhBAAUGEA.IHHAFGHH...hAEA......hAFA...,2,-13,-8,5
VXBRdcHFaQGMCTISLAObEgYZNUJfWeKDP,EAAAZAAAUAEA..fACAeAHBDCAA...XADDRCGBHDAAaDDAhABAGAGA.MDDAhAAATFFALEEB.hACAAAFAbFBBgGBAJEGF.KEED.BHHA.hAIA......hBFA...,2,-14,-7,7
SPBYRHZMDCIJFWgTULNGfVQKacOAEXbed,EAAAeAAAdADABADAHAFAZAEBMBCBDAHB...CCFDFCHB..TDCAhAAALDDBGCFAQFAAhAAAaBHDACCA.bFEDSEHHhABAPEHD.RGBAIHFAWHAA...hAFA......hAHA...,1,-4,-17,13
OBUJKHGeXEdPbfQgDRZMFLSAVWacNTICY,aAAATAAA..CADABAFAKACCHAEAGAGAEBHFdCCA...bCDDQCCAhADA.RCEBZFAAhAFAMCGBLFGBhAIAAAGAcEGDNBBA.OHEA.......hBAA......hBIA...,2,-19,-9,10
UJVPDEacAOBHdTMgGKFLRIZfNSbWCYXQe,HAAAdAAAMADAGADALAHBRAFAZCAA..SCFACBDA.QEFAhAAAeBEHVCBBEFAAABGABCGChACAKEHBFFEH.IHHAhACAbEFA..XFEC.JHEEaGAE.hBAA......hBCA...,1,8,-22,30
UKTZDLXMOFYeRSWVNdCEafcgQJbHPGIAB,KAAAZAAALADBMACA.FAFARAEA...SAHHVBCB.dCAAEBHFhAAA..aBFH..fCFAhAHAQDGAHEEChAIAGEEAADIBBFHATGCAOHEAeCCD.CGHA.hABA......hACA...,2,-18,-11,7
ENAKaWDTROgcbdXVJHQUSBFePGfLZCIMY,aAAATAAA..RACFOAEA..bACBdBFDJAEBHCDB.QDFChAIABAGAeAHHfEHAhBAAZDEBMCCBEDHFABBBDBIBhCAAXGAASGGAGGEBCHDA....hAAA......hAGA...,1,-8,-13,5
gHCRTIPWLYcAFaJQfGZbUSBMVeOKXEDNd,aAAAQAAAZACB.SACAMAFA.eAEHXBEADAGAdBGAHCGBhBAARDAA.TEBA.hAAAIDEALDFAABBBfFFAhBEAbEECBFHAKGCAEGHBCGGD.PHBA.hADA......hBIA...,1,0,-12,12
bYEWDLZPVgAKUdTfOCXJGaQNeRcISBMFH,dAAATAAACADAGAEA..aACAeAGBRAEF..SAGBMAIBHCAChACAECCBLEDAZDFBgEDAhAAAAEHAfFGAhADAXGCCQGDA.IHAAFDBHYFHBhAIADGIB.KHEA..hBDA...,1,3,-11,14
afAVUgCZJeDXSPMKdFHEWQRLNbYIcGOBT,UAAAZAAAeACEDADA...SAFBMAGBdAHAHBDBEAHB..RCCALDGBhABA.bEEBIDBAhBAA.GDGAhBCATFCAABFBCEFC.PHBAFGHDNIAB.....hAIA......hCAA...,2,-26,-8,18
HfTYSEaNLPgZXDFKdeUBRWbMJOCAQIcGV,QAAAGAAAHADA.TBGAEACALAFAZCDAFDHDdEEAeBDFRFAAMAFAhAAACCEAAAGA..ICGAhAAAfGFAaCHDgEEAhCAAKHGA.BFHA.JHFA....hDAA......hDBA...,2,-13,4,17
KCGVNZUgOWdfHSQJRMcIAPXFaBYDEeTLb,FAAAaAAABADAEADA.LAFACAFA..GAGAZBBAOCEDdCCAHDABhADAQCGARDFBMDIBAAIBXDAAhADADEEB.eDDDhAGAbFCD.KFGA...NHAB.WFFDSGEHhAHA.IHHA.hBAA...,2,-17,-4,13
aLICSWQdbTHAOGXMDNUZJRKfeFcgEPVBY,GAAAMAAADAEAZADA.RBGFKCDAeAFA..FDCHEBBABAHBLCDA.hAAASBHHdEEAHFAAAAEAhACAXEBAUGGA.fEEAhBAA.gFGA.PHCAhBBAaDHD.CBEDWHFAhCAA...,1,-16,-28,12
eCTMHEJdbKAPfBVaROXFgGLNZWQISYcUD,BAAARAAAFADAGAFAZACAQAGA..SAHBUCCADADA.eCCBhAAAMCGBHDGB.ECEBhABAdDHAADIB.VFDAaEEHXGGAhBHA..gGAA.WHEAhAAA.....hCAA...,2,-25,-11,14
GLDCHMJcSbUdIPVEeKRAFQNBYgOTaWXZf,QAAABAAAOACAaACEZAFB.GBCALAFAHCGBMCDA.SCFAhAAAdCBCIEEAhAAAEDAARDDBAAIBFFBB.NICB.TFGAhADA.fGAACFGD.bDFA..hAGA......hAHA...,1,-6,-15,9
AfHdVFKCYXNeIBWQJSPUGEOMbRDacLgTZ,HAAAdAAAKADAXADB.eAFABAFBQCABSAGHGCEAhAAAECBA.bCGBRCEBaBHDLDDDhACA.ZGAAADABFDDHhACACFHAIHHAJEGB..OECHDGGB.TGDAhADA.....hAGA...,1,14,-26,40
fAZPJHMeCcQRBYXDSVIGLUabWNOgdFEKT,ZAAAHAAAeACEQADCRAFFBAHB.DAFA.SAGAGCDALCHBhABAbCAC.OCCBdCFAECHBhAAATFAAADEAMEEBCDGA.XFFAhACAUGFA.aGHDWFDDFHEE.....hCCA......hCIA...,2,-5,1,6
bHdaZSTCgFYKWQRNXDMGfOJILeUVABEcP,EAAA..bAAAHACAZADB.TAGAFAFD.KCCDRBGFDAAAGCFA.OCHFhAAALEEBeDEDAAHABEGDhBIAdEAAaECDCFDA...YFHFhAEAQGGAMIAA......hAFA......hAGA...,1,6,-27,33
RPgGbMKUOEYXZBdCVNAQaeSHTcfWFIDLJ,eAAAHAAATAEA..fADAFAGALCAARAEFGAGAMCEBOCFChAAAECCBZEDBdFFACEAAACHAaEGAhACASGAA.hADAIHHADFFAgGGA....hAEA......hCCA...,1,-8,-9,1
JKGRYOfFgWbHNZBUaITLcEPVQdAXSeMDC,eAAAMAAADAEAKADARAFF..OAFEFBHD......bCCBHBBAhAIAZEDBBFAAaCEDTCGAhBAAEFFA.QDBBhBBAAAAA.CEFAGGCBfFHAgGGBNIAB.hAFA......hAHA...,2,-27,-3,24
IYScfKFeNbVGQWaCXZTPEHgdJDUOBLARM,RAAAMAAA..SADBKADAeAFE...bAEDGBBA.aBEEZAGFhAAAECGAHCCB.dEFADDEBhAIABEHAABBB.IGBAhABAfDFEFGHBNIABQFFBCHEB...hAIA......hBGA...,1,-10,-22,12
SDgPHRXdBWFAbMULOCZJGcTeVKaYfNQEI,MAAALAAAZABEGAEAeADHKAFA..aAGA..fBHAhABAEBGEDCCBHDCBRCABdCFAFDHBAAHAODEHhACACFFA..TGDAhBAAVFGBQFABSGHB.....hCAA......hCDA...,2,-12,-4,8
aNIdTEXbBYUDOcGHKSVfAJQMWFRZLCgeP,MAAARAAAZADBLAGB..eACAaBFBdCCCEAFABAHA.DBBBGDAAhAAAHCCASCEEhBAAAAIBQEEACCHAgEEAhCAAIEHA.TGGAbGCC.OHCAKGHB.hABA......hADA...,2,-12,-11,1
GJCKdWVUYQBRPeIONgDMbZfAaXTLEHcSF,aAAATAAAHACB.FAEAGACA.KAEAdAHAUAGAQCEARCEB.hAAAeBBDOCABDDGAZEBAhBAAADGAEDHFSEHBhBEACFGD.VFFBBGHAIHBAMEEBbEAD...hBHA......hCAA...,1,-3,-8,5
CIYXDgdHBUQeJMWEFRZKbTAGLPOaVfcNS,GAAALAAAaADAVAEA....fAGASAHBCBHA.XCAAhABAdCDAHDBBQCGDhACAeDGBMDIBEDDARFDAbGAChAAAAEAAOEFB.IGGAYHDGBEHDhAEA......hCAA...,1,10,-21,31
MVcTHXNgKJOaFAGWPSEbYDQeLIdCRUZBf,GAAASAAAEADADAGAeACHLBFA.dCDARAEAZCEABDFAMAIBhAAA.TEAAHDGBXFDAhAAAKDDDaEFB.ABGAWDADhACAbGCCQGGA.CHAA.fGGEhADA.....hABA...,1,-8,-9,1
EJQYNXgKRbfTdDIVOePSMZLHFWGCcaABU,EAAAQAAA..XACARACA.TAFAdAFADAHB.OBHDhAAAeAHHMCCBHCDAGDAAhADAaDABADDABDEAUEFAYDFBhAAAKGHBfHFBIEHA.SFAHhADA.ZFCB.FGHBhAFA...,2,-11,-3,8
QMVEZaIWJfcKLHFPRObSdNABgXeUDYTGC,XAAAeAAADAEAGAGA..MADAEBCAZBEBaAFE..JBDBKECAHCEBhAAARFFA.SAHHhABAAAAABCDA.UDGATGDAhAIAQGCAIHHAfDBA.FGGAhBDA......hCAA...,1,-11,-18,7
GAZedIPOCJLEQUXKHMFgScfbYaRWVDBNT,eAAAdAAAOADALAEAUBEBHBCA.MAIBSAHB..hACAbCEARCBBDBHBTEEAADFBZEEAhBAACEHAEFAA.QGCAhAAAFGEA.fGGAaDGEBHHA....hABA......hAFA...,1,0,-26,26
aMCXVPWQGUgFSLYJeERZcDNKBIbdfOTAH,HAAAaAAA.MACACADA...XAEAVAFA.QCCAGCCAFBBHhADALAHBeCFBREGFZFABhAFADCFBBDGDdFEA.TFFAhAAAACIB.PHBA.WFHBSGHHhAIA......hBAA...,1,-3,-11,8
YQXOSJNFBdWDbIGRUcEPHACfZgVKTMaLe,ZAAAKAAAMACAeACEQAFC.OAHDSAEA.FAHBhAAAdCCDDBDBGDEARCDFECFEHEGBhCAAADGAfEGBhABA.TGGAaFED.LHAA...hCBA......hCCA...,1,1,-31,32
IEJHRVbMBOLKNPgCTXFdfaWAGecZDYQSU,eAAAZAAAQAEAUAEA.EAGAHAGD.RBCBMCIBLCABKDFA.gCCAhABACEBA.TCGAhACAdFDAaFFAAADAGEEAhBIADGGBIHHAJEHBBFDC..NIAB....hCCA......hCIA...,2,-14,-2,12
UOWdXFGfMDCSbQPcJAYgRLHVaKeNEBZTI,RAAAHAAAKADC.EADEZAFBUAFA.dBHAGCCA.MAIBSCAAhAAA.bDCAQEFAhAAA.PFBBADDALEGBhACAeFEBBBEATGDAOEHF.FHCEDFIBhAIACHHD......hCAA...,1,-3,-11,8
SFRGOPCLZAHTUIBfYWDadVbJgecQKNXME,HAAATAAABADB...fAFADACAdAFAVCCAJAHB..eCAAhAAAQCGAKCED.MDBBhAAAEDFFREGBGEFACFAAADDBUGCAhACAIAHA.aFBD......hBDA......hBEA...,1,-11,-20,9
fTIbLDOeCgUSHdEAGaBWNRJXFZVPMQcKY,aAAABAAA.RACAFAFAZACBMAFA..QCAAKBBD..TBEAhBAAbBFA.LBGBhBEADDDAeDEACDEDSDHHhBIAHECAAACAGEGAJFFB.........hCAA......hCIA...,2,-27,-13,14
KLUEFMBJHIZadbQGNTgePWYROcfSVADCX,XAAALAAAEAEABADAHAGBZAEB.dCAAGAGA..TCCAhABAeCDD.PCFBRDABODFDhAAASDHHAAIBKEHBMIDAhABAaEAEbGBA..gGBAcECDDFGBFGHHIHHAhACA...hADA...,2,-10,11,21
cXVfTGDagEZLMSRCeHWBIFPbYJUONQKAd,dAAAXAAA..TADAaADA.EAFEZAFBMAIBRBCFHCGB.BAHAhAAAFCBD...bEBAUCFAhACAQFFCADABfDDAhADADFIB.LFFACHHD.eFDF.IHAAhAHA.PHFAhBAA...,2,-16,-6,10
SJVHdEbMeDZcNQOBGIULFfWARCTgXYPaK,RAAATAAA..XADBaACA.KAFASAEHHCCAdAHAECFEeAGBhAAAZDFEQCCChAHA.GCFALFGBhAAAfEEEAEEB.CDBCPEHD.JFDFMFIBhABADAIB.....hBDA...,2,-14,-8,6
JcEGNbROALaMXZHDUBPTfVSFYKCdeQIgW,aAAAZAAAHAEABADA.TCAA..SAEHKBHBeCEB.QAGAhADAIDGA.JBBFEDDBbCFDhAGAAACALFGB.hBAAMEABDDDAfDHEFGCACHAA.dEEC.gGGAhBIA..hCAA...,2,-25,-1,24
AVCScIYDPBRWJXEZFMUHdTeGKQfOgNbaL,SAAA..IAAADADARAEA.XACAEBCFZCEAMAIBhAAAHAFAeCAAGEEAQCEDhACAODDB.bCGDACGACEHAhABAPFAABGHAFHAAdFEATGGA.fHABhADAaHGC...hAHA...,2,-14,1,15
fgWZKVdAcXNMeQBbDLIaRHUOSCTGJPFYE,XAAAeAAAQADADADA.LAGBRAEAHBCBOAHDTCCAGEEAhAAAFCFD.EDHFfDHEhAAAZFBBdGHAAAIB.MECBhABABBFBaEEC.UGGA.CHAA......hABA......hCAA...,2,-6,0,6
FKJfYbXMURZWNcPOgBdLQeHGSIaTECAVD,FAAAKAAA..JACA..bACDUAFA..RAEAZCFB....NAIA.OBHDhAEABCCA.dECALDEAhAAAHEGBSEEDhAFA.aHAAEECBAHIBDIFAXFDD.MFFAhBHA.....cGGAhCAA.,1,-10,-52,42
VOCPEQHZJSDNRXAfUTgFcKabMdLWBYGIe,TAAAFAAAKADA...aACAdAFA.LAHBBAFAGAGAeCCBCCEDEBDB.hADAHCEBZEEA.DCCBRGDAABHBfEHAhAAA.gFAAhAFAMFIB.IGDA.OFGHhAIA.....hBAA...,1,3,-34,37
QGbadDeVHLRBNJCKSXWOUTAFIYcZEPfMg,FAAA..IAAAZACBEAEA.MACAGAGAdAGAeBCAHCEBRECBBCBDCEHA.hAIASBHHOFGBACEB.hBAA..PCED.hBGAQEGADIBA.LGBA.KGGDhAIA.XDBA.hBIA...,2,-19,-7,12
feMRdFDVTHXcNZGWPYbKOUSJIaAQCEgBL,EAAALAAA.eADHRACAdAFADAFAHBGB.XCCAZAFEGCAA.hAAAPCFCbDAC.ODEBhABASAHB.aDFHhADAACABQFFABEHAMGEAFGHD....hCAA......hCBA...,1,-6,-14,8
ZafdDLFUENKHbgITWSAXBVOMRPYCcJeQG,BAAAMAAARACACACA...eAFEZADBdAGALCCAFCAA.EBGBHCEB..hAAAbDFATEGA.AAIB.hACAOECB.cEEChAIAGFBBaFHHDCIBKGDAgGGA.SHDAhBFA..hBGA...,2,-26,-4,22
SNZLUXWPfYEcKQaOAdHRIegCTJDMbBVFG,HAAARAAAeADETAEA.MAHBBAGB.GBDAZCAALDFAXBGAhAAAfEAAEDCB.hABAQECBACCAdDGACFCDbFEDhAIASCCE.UFFAYEHBaGADgGCAhAAA.DFIBhACA...,1,4,-7,11
CYPeNATGKSbfOFURHIcEVadgJMBLDXWQZ,GAAASAAAOADARACFHAEBEAGA..dCDAMAHBLCFADAIBQDEBhAAAZDBBCEFA.eDHFhABAAAABbEGDFEAA.UGAAIHCAhACAaFGH.BFEDWFHHNIEB......hAEA......hAGA...,1,-4,-5,1
PYAeCNJdOfcBaTFMSKGXRQbgZIHDLVWEU,eAAACAAAdACA.OADCBAEA.FAGAKAGA..RCCA..QCFCZCBAHCFALEAAhAAAEDHF.UEFBhAEAAAAAfEEEhAFA.aFHDMEIBXGFDbGAADGAAPHCA.hAGA......hAIA...,1,-3,-24,21
ADKONGUcBMQafWJHLXdYIFbVPCRSTeEgZ,OAAAGAAABADA.aAEDfADA.HAEBdAGAFCDHbAGB.hBAACCHARDFBeBBBZFDBAAABKDDA.hACAUDGBMDABQFFBhBGA..JFHB.XGBBIHHA.hADA......hAIA...,1,2,-21,23
gaKNUcRfSFIPVXQZYBMdHAJETCDWLebOG,EAAATAAADADA..LAGBeACEGAFA.aAHFKBCA.UDDARCCAFDBHhAAAVEGBZDGBMEEB.hAAAACCACFADbEBB..OFFHhAFANAIA.SHBA.IHHAhBDAQGEC.BBFA.hBHA...,2,-17,1,18
BVIYbKcaFgLeMJNEQODRXTUSCGWHPZAdf,dAAABAAA..IADAKACAaAEA.LAFA.eCAAMAHBECEAQBEDhAAARCGB.TCAAhACACDDDHEFBAAIBVDCBhCAAbECCFGAB...NICBOFHDXEGA.GGEBhCCA.....hACA...,1,-3,-15,12
YSXPeKZcBCEAdFaMbWIJDgVQGfLHNTURO,aAAAMAAA....IADADAEAQAGAGAEAHAGDTBBARCCBSCHHhAGAeBDEZCEACDDDADIBhBAAbEFD..JEFBfGDAhAIANIBB.OBBB.....hBBA......hBIA...,1,1,-24,25
MPTLbZYFQHdDSVfRWgCXEJGOceAIBUKaN,BAAAaAAA.MACALADAZADE.QBGAHAGBdCBASCFDhAAARCCACBBDEDFFGEAAeDDBAAEAKEGAhAHATFFAFFCA.DDIBfGGAhAIAXGDCOHFE.....hBAA......hCAA...,1,-6,-8,2
IbZCWHeLBFMTOEDgXPSAKaRdVcUNJfGQY,RAAAdAAAUADAJADA.GAGA..QAGC..bCCCZCAEHDFBhAAAeCEBLEEDhABAMCIBEDGBXFBAAEEB.hACAaGACcFCAfGHACFGDFGHDDIAA.SHDAhAIANIAB...hAGA...,1,-4,-11,7
ZIRKSCbGYVFcUXfQePMONaABHTEJWgDLd,HAAAEAAA.JADADADAZAGBRAEA..KBCACCAD..GCCAFBHD..UDDAQEFAhAAA.eFCDhACAMCBBaFEHAAHABDGD.hAGA.WHFAdFGAbGCA.......hBIA......hCCA...,1,-15,-36,21
PfdXYbNeAcgSGMJKVHIQZLaRWUCDETOBF,SAAAGAAAMADAKADAHAFCZAFB.RCDACCHAEAHFBDCD..FCCAdEFA.hAAA.XDAA.hAAA.bEGDACIBJDGBQGCAhACAaEEBDEIB..TFAA.OFCD.hAIAfGHE.hBAAeFFD.,2,-24,-4,20
NDVYLPHJSaEUTZfeIKQAOBGgCRdbMFXcW,GAAARAAAdADAFAFA..XADA..NAIA.DAGALCCAHBFBaBHFhAAAUEEAZCDFeDAD.hAAAQEGAACGABDGBCFBA.hABAMDDB.cGGC.YHCASFHBhBFA.EHGE...hACA...,1,-3,-31,28
ZIgHGXBOQCfYNeATFSKcJbWPRadMEUDLV,TAAAKAAA..JACA....bACBRAFFdAHAEAEALAHBZCCAHDGBGECAhAAAOBEEQDEAhAAACEED.fEDEhBHAeFABAECBSGEAPEHBaGEDMIEADCCB.hCAA......hDAA...,1,-8,-13,5
RQebNPJUdXgMLOKYEZFSHGDcIBfAVaTCW,aAAATAAA..RACFeAEE..bACBJBEBdAFA.MAHBLAHBhBAAKCEDEDFFZCFBHEBAGEGAhBBADAIBBDHAAEIBCFED.QFGAhAAA.........hCAA......hCBA...,2,-22,-5,17
TWLADEJYbIgCeGQSNVHRFUXdBZMPOacfK,EAAAJAAA.....bACACADBeAEH.GAGAQAGA.SCCAhAAAHCCBREFBXFDDhAGAZDAAMCGBOHFEhAIAaDHBKEEB.TGAAACCBDDIBgGBDFFHD.hADA......hAEA...,2,-11,-11,0
EQfYMaISTHVNDOcCLGUKdPZJRbgFeWABX,EAAAQAAA.MADAaACDSAEAHAFCDBDBCBED.GAGA.hAAAdCEAZCFEREAAFEFDADEBfEFAhAIATGDAOHFChAAALEHBKCBD.bGCC........hBCA......hCAA...,1,-5,-14,9
YLOKVMBEaQPHZfWANUSDIRgJcbFdCGXTe,SAAARAAA..gADBJADA.FAFAGAGA.eBCFhAAALCCBKCFDMDDBhABAEBHFaCEEHEECZEEAAAIBDDIBhAGAbGECCDHA...........hCAA......hCBA...,2,-24,-18,6
gUNDVASTRBbPLXQHYfcMdeJCEWZaGIFKO,RAAABAAALADBHACA....fAFBdAFAeAHBECGFaAHDGCAAhAAAKDCDODFHUDDADEEBACABbDGBhACA..QFBBhAAAMEGBCFCDZGCEFEHBNEIA.SGGA..hABA......hAIA...,2,-16,8,24
NLGXIaAdEVbBWUQeMRFSHcPCKJfDOTgZY,EAAABAAAUADAeACA.RAFAHCAACAFA..KAHBDCCA.OCECZCBALCGBhAAAGEEA..aCHDADFAdEFChAHA..VGAA.hBCA.WDHHFGHB.........hAAA......hACA...,2,-37,-12,25
ZEDWOXGMbdLSaBcUJRATNVHQfCPYKgeFI,TAAAHAAAQADC.CAFBKAHBeACEZCAAEAFEDCFAXBDChAAA.bCEAdDFA.aDHBBAHBhCAAUGGAACCBfEEAhCGA.gFGAFEDDOHAAMICA.hAAA......hACA...,1,1,-15,16
NCeWUXBPJSOHcKFLYbIGfdgQaVTRAMDZE,ZAAAEAAA.eACEUADABAFB..SAFAHAGBFCCHLDFAhABA.IFCAdBCCaAHDRCEAhAAAAAIBMEEBCDHAXEEAhAGAOFFAKFHB...YHFAfGGE.hCAA......hCBA...,1,-13,-26,13
dAOPTgBJMDfQSERYeZFHICcLWUGXKVaNb,TAAABAAAMACA.DAGAQACC.RAEFeAGHHBCACBFBLDDBhAAAGBGAKCBDaBHDdEAAhAEAABIBODEBgFEHhAGASEBAEGHB.ZFFA.......hAIA......hCAA...,1,0,-28,28
DGcLgdZbIREVKTOPASQFBUfYNeWCJMXHa,QAAABAAAUACA.....fACFeAEACAHA.MAFAHCDChAAAGBDALCGBZBFARDFAhAAAECBBTFGAACIBFEEH.YDCFhBGAJFAA.aFFHDEIBdHBBIGGA.hBHA......hBIA...,1,4,-24,28
PNdKMXUOYcHSWeTBLRIEgfFbGJDAQCZaV,ZAAAaAAA...VAEAdADAMAFAUCAA...OBBBHCDAeAHHLBFAhBAAEDHFFEFBGDBAAADA.hABAQDDACFHA.hACAKDGAXGGCSFEABHAAgGDGhBDA.fGHAhBGA..,2,-16,-1,15
WQXRNUbATVeBHfPYOgJGKLFIEdaMDZCSc,eAAAHAAA....fADBOADCGAGALAFBECCAaCEDZBGBSCAAhAAAQEFDRFAAhAAAbDCDAAFABEDD.gGGAhABAFEECdFHAMHAACGDA......hACA......hAHA...,1,-2,-9,7
HKgGAPMLOXCNefWSBZaEcTVDQFRUIJdYb,MAAALAAA.CAEA.eACA.SAFAaAFDEAHB...TCCAhAGAQCAARCEFUCGAdCDAhABAHFGBGCGAAAIBXECChBAAfEAEBBBDZFDADGFBIHHA.hCAA......hCEA...,2,-10,-10,0
eQCWFdSOVGADEYTLMJKgBURXafcINZbHP,EAAATAAALADA.MAHBKACCBAEA.RAFF.aBCC..fBHAhAAAICFAbDDCHCCAhAHA.eDHFQEAAhAAAFECHdEEAOFHDAAEADAIBgEFAXGEANIABCFHA.hCAA......hCBA...,2,-19,1,20
CWgYEeOKIRFdTfaQPcbXBUHNMZVAGJDLS,GAAALAAACADA.....gADHEAFAeAHFKCDARAFFdAHAaCFDQCAAhABA.bDDBhACABDCDHDFCZEEAAFFASFGAhCAAOCHDTFAA.fFCBhAAA.XGGAMIDA.hDCADDABIHHA.,2,-10,11,21
MQbSUZGBPRXVEgCTFfHeAIdNaOYKLWDcJ,dAAAaAAA.KADALADADAFA.MAHBQBFAUCCAGCFARCAA.EEABhAEATDEAHFCAAAIBOAHDhACA....YEHBhAFAcECAbFGBBHFA......hBAA......hBBA...,2,-23,-9,14
KZWHOPILfEJGDbRcFQMNTBdUXeaSVYCgA,ZAAAHAAAOACALADB.EAFAGAFARBFAQCABMAIBBCCDdDFDeDHHhAAAaCEH..SDGHhABACEEDAAIBKFAA.IFBAhAHADFGB.FFDA.TGGA....hBFA......hBHA...,2,-24,-5,19
IJKYfFTcBAdMLVDRSHObUQGgNEZWPXaeC,dAAAMAAALADARACA.HAGBOAFAQCBAGBEBEBBBZDDBXDFDhACAeDDB.CDHAKEAAhAEAFDFHTFGAAAIBDFIBSGGBhAFA.........hBAA......hBIA...,1,-4,-23,19
RTcKPXDQYBHaZAGfUVJbdgOMWLISCFeNE,GAAAVAAA.dADAMADALAFA.CCEAFCGAEAGARBDA..KDDDDBIBBDGDhAAAHCGBZEFAADDBUFDAhAAA.JEBBODBD.hBEASGABeFGB.TGGA...hCAA......hDAA...,2,-19,-14,5
bafDLBGKYUFVdZIJQSXNCOMTgAHcRPEWe,HAAARAAAEADE.eACE.aAFALAFBGBEBKCCAFAHBZCCB.QDGAhAAAXDEDODGFhAAAMEEBACCB...cGGChAIAbFEDBGGA..........hABA......hCAA...,1,-5,-17,12
NSAHPMDWYXOUaILVRbEecgBfFKCQZTdJG,HAAAMAAADAEAXADB.OAFCaAFELBBARCAA..ECEAeAHHhBAABCGAKCEAZDFEdDBANEEAAAHAhAAA..PDDBUFGA.hACAbEGB...fFEA.CGCD..hCAA......hCDA...,1,-10,-16,6
YZePAfSdMWUbDEXJIQVgcFBKLTOGCaRNH,dAAAMAAAUADADAEA...EAFAJAGB..QBGA..gBBAhAIABCBATDDAhACAGCEARDFFHFGBeBHHAEIBSFDDhAIAbEBB..XEGA.hBAAIGGA..hBAA...,1,-9,-36,27
ZFLOSRTMfXdEACNBVGJDKeIQUYbPHWcga,BAAAGAAAKACAeADAUAEA....bAGDHAGD....gCDAhAAAZCAALDFAhAAAREAAMEFAdFFAACCACFFAVGBAhACADEEBIHHA..PFHBaGDH...hACA......hAIA...,2,-32,2,34
GQVWZCHaegKdNMIDYJfUPOSFELTBbRAXc,GAAAQAAAZADAHBGBeACAdAGAMAEADAIBJCDBUCDA..SCFDhAAAEDAALDFBbEFA.hACAABFA.....XGGChAIAWDHBaFHHNDCA.fHEB..hAAA......hADA...,1,-2,-23,21
WAUBDFTMHfcaEIgPeQJKdOZRVbXCYNGSL,DAAAMAAAHABC.aAEAEADA....IAHAeAFAQBBChAGA.dCEARBEBbCGBCBHAGDFAhBAALDDBADDAFDHFTFFAhBAAfGCA.......hCAA......hCBA...,2,-25,-12,13
aLdNGEPcQbFZVeTADOXMWIYCSBHRgfKJU,XAAAMAAA..IAEASADAHAFBRAFFKBHBUBBA.dBHAECDBhAAAQDECZDAA.hABAeECBAAHAODGDCEGAfFHAhAHAaEFBNEIA..PFDD.FGGHDGGB.hADA......hAEA...,2,-10,-10,0
cLXYJgfWNIPHFMZRBAGDUOedTCKVQaSbE,GAAAOAAAdAEAKADAQAFC..bAFDEBHFLBDDhAHA.XDGAgCDBhAAAfAHAIEGAhACAHEDCZFFAAAHAeBBBTGDAaFHHSGGDhBAAYDAF.....hADA...,2,-16,2,18
dEMPKCZcVgbGWIeFOBSAHXfJUQNYRLDaT,HAAAXAAAUADA.QAFARADALAGBaBHDECDB..KCADZCEB.hAAAVDAAGDDA.eDGBhACABDHAACCBJHBADAIBdFGAhAAAMFGBCGEA...........hABA......hADA...,1,-3,-17,14
LfcESVJYZQPXUDaTFHMNCeOBKbdWgRAIG,GAAALAAAEADASADH.JAFAZAFB.QCDAhAAAUCAADBFB.aAHDHCFBMDABeCHBhABAKDCDdDHARDDBAFHB.fEFAhACA.cFBC...PHEAhADAFGGHNIAB.BHBD..hBAA...,1,-9,-11,2
VPSLeNfUcbBACJdWQDagXIKFYOGRTHEMZ,dAAAQAAAaADA...XACAFAGAGBDAHAFAEBGBZCDASCAAhACAeCHBfDAAhAAAUDGBBFCAAAHACEEADEHBKFEAOFHBhBAARFAAMFGB.........hADA......hAFA...,2,-18,-3,15
AJPSFaNUHbXdQTeEfBLIVYgROWGZMKDcC,SAAAaAAAHACBdAEBeACHBAHALAEA..ICFAhAHAVCEARECAGEGAZCGBMBBBDAIBhAAAADEBFFBAbFAD.QFEChBAAEGFB.fGHA....hBFA......hCAA...,1,2,-14,16
WfbDaKcNeQPAYCFOJdIXUZBSgTRHLGVME,FAAAdAAAUADAZACBBAEA..TAFAHAFBGDEA.EAHBbABDKDGAhAIA..eAHHACEBOHFChBAAXDEA.REGFMEDBhAHADGGA.aFFH.NIDB........hCAA......hCBA...,2,-26,-7,19
PTKINHdaDBQcAZSVYOREbgfLUWCXJFeMG,ZAAASAAAOACARAFAEADA.....bAFALCCA.CCGAFDHDhABAeCCAGECATCFAhAAAKEEAHDAAdGAAaGEDQEEChABA.AAGAgGGAfGGA.WHCAhADA.JDHB...hAGA...,2,-21,10,31
fWFITaUbZDHQMBSXEYeRNCcKGOdVAPgJL,JAAALAAA.FAEAaADAZAGBHAFBBBDAEAHBRCAA....CCEAGEEAhABAdCCAABEB....fDFEhAIATGCADBIBMDHBhBAA.XEDD.eFHHKGHB...hACA......hCAA...,1,-17,-28,11
CLUbZKcDRFONfWMSHTABIVdagJYEGQeXP,BAAAdAAAaADAJACA..EAGAGAFA..eBDBCAHALCBAZBFEDCCBRDFAhACAFCHD..ODDHhAGA..fDEAhAAAMEBBHFFCACCA..gFAAQGDDXFFAhAFA....hAHA...,2,-41,-1,40
NOfQVdGXHLCeKTSIPBgDZEYJWAcbRFMUa,RAAAMAAAUADA..aACEOAFC..QAFAGCEBHEEAeBBBhAFATGGASBHBhAIABCCDDEIBECFBJDDBAAAAFHAAfDHEhBAA.dFFACHEA.KHGA....hCAA......hCDA...,2,-17,-15,2
IZEPFeCcRaHbfGLSBJOUNgWMAQdVKTXDY,dAAATAAADADAZADE..EACEeAGHRAEF.HCACGAGALDEABCCAODEBhAAAUFCA.gEAAhAEAAAIBQFFAXDFDhAGA...IGGACFHA...hACA......hBAA...,2,-21,-8,13
MPZfLFDeXBUJIGdQHaVgKYRWCbOEcANTS,TAAAMAAAZABE.LAFAeACEBAFB.UCCAGCCAHAGBaCFAKCFDhAAAREFA.CDBC.EFEBAAIBSDGAhBDAFGAADCIB.XFFAhCAAdGHA..........hDAA......hDEA...,2,-21,-13,8
XHMdJDCFYZNaKRPIcBbOVUTEfGSgLeWAQ,HAAAdAAACADAZABBaACARAEF......IAFAbAGBUDCA.EDGBGAGAhAIALEEBACEAMDDAhBAAFGCBKGGABEEA.ODHDhBIA...TGEA...SEGDhCDA...hAAA...,1,-14,-26,12
NYHABIRdJcKaeUXDGTCbFLOSWZVPfQMgE,RAAAdAAAKADCeADA.DAHBGAFA.CAHALCCBSBEA.ZABB.hAAA.VEEBQDCAhAEAECHF.HDGBACEBBEHAhABAIGDAaFBC.XEEBFGHBOHAAfGGEhAIA.MBIB.hAHA...,2,-17,-8,9
PFDgSWHdTUCGfBaIAeOJbEQcXYMRZNKVL,eAAAOAAAEADA..QADA.XAFARAFAZCCAKCGALCCBhAGADECASEFAhAAAHCECdEEATFCACDHABFHAAEIBJGEEhABAcGGC.MBBBNIABFGAC.....hAIA......hBAA...,1,-11,-14,3
LWgUbSCYTDGVQNKJBMHFAaPRefEOdXcIZ,RAAAEAAAdADA....XACAZAEBLAHBUAFACAHATDFA.GGBBhAAAQCCCKCCDMEIBhABAHDAB.ACIBeDFBhAAAOFGDIEHA.bGDCDEEB....hBGA......hBHA...,2,-14,-10,4
cHaJMSWgRTCDPOIUGKZNVLQbfeEXdYBAF,HAAAaAAA.MACA.SAEARACFTAFADAIBOAGDGCDAZCCALECBhAAAQCFBeEEAhAIAEDHFdEAAABIBFEHD.cGDDhCAAgFFB.CHAA.IHHA..hCDA......hCEA...,1,-5,-7,2
PgbXDBGfdeYRaSVcWZAECHQMKUNOFTIJL,HAAAMAAAKADAOACA.FAFDJAFALAHB....bBBCBCCAhAAAdCFA.RDEAaECB.SEGAhBHAVEDBZCGBEFHFhAIAQFDC.TGGA....hCAA......hCCA...,1,-12,-30,18
aXGfKOTUeZcWAbFLSRYMEVHBIPgNdQDJC,LAAARAAAEADE.HADBBAFB..IAFA..gAGHhAAAdAHAQCAACCCAGCEAhABAOCFCeCHFZDDAACEBbGDAhCAASEGH.MEIBNEIA.aFFH.KHBAhABA......hACA...,1,-8,-13,5
eQbIYJLKAcRXSgEaFNGWVUTfBDCZHdPOM,RAAASAAAEADE.FADAGAFA.UCCATAGADAIBHDGBdCCAMCFBhAAAeEFD.QFAAhAAAbDFD.IFDAhABALDBDAAHB.XECANIDB.fCHAhABACHHB.ZGAA.OEHFhAGA..,2,-4,2,6
edSPIRNYCOUBVFAcTgMJZWKELbfGaXDQH,TAAAMAAAZABE.KAFAEACE.LAEBGCCADAIBHAGB.eCCBdCFASCHDhAFAREEACDHABFHAAAGB.hAAAJFFAbGDA..aFDD.hAIA....PHACIHHA.OECHhBIA.....hAHA...,1,9,-29,38
HMJRNdUTbZFCVDQBAIOgEKScLPaeGYXfW,OAAAEAAAKACA.LAEA.eAHHGAEA.fAGBhAAAHBBCRCEBdEHATCCAZFAACFGCDEEBhAFAACHASDFH.hAGAaDHB.XEAAMIDA.UGBB.FFHDBHHAhBAA.....hAEA...,1,-5,-13,8
HSOAagBRZIfTKGUWVeJdQYXCLEcFPbNMD,aAAARAAAZADB....TADAGAFA.VDAAeAFE.dCCAQEEChAAACBFAECGA.FAHFbDABMDHBhABAHEDAACCABFDCKDHBUGGAhADA....YFHB...hAIA......hBAA...,1,-9,-11,2
WAgOfLUdFXCVQDISYaeBZTcMJEGKRNPHb,OAAALAAAdAEACAEADAGA..SAGA.eBBAZBDEMBHBhABAECFARDDBHDFCABIBUCAAXFGAhAGAQDEAaGFCBHAAhAHATFGA.JEDFNICB.......hBAA......hBBA...,1,-6,-28,22
WKecLaYHGEbIVQNFMTOCAgRDfJPBdZUSX,RAAADAAA..JADAdADAZAGBSAFA.KBBBeCCA.aCHDHCEAhAFAGDEAEDBB..bEEAQGAAhAAA.MFIBhABATGAAACCA.fGCBBGCA.XGEBhAGA....hAIA...,1,-18,-31,13
QWeUEfIOBAbTPXSVJNdCaZRLFgGMKDHcY,TAAASAAA..VADAdADAZAEB.RAGBLDBBGAGAMCABhAAAHDECQCCChACAeDDDEEHFOFFBAAIBbDADXDFDhADACGCAaGHD.KFDADIAAcGGA....hAGA......hDCA...,2,-4,2,6
eBHCRUQDbYNWcAMfIKOTGgXSLJPaZFVdE,MAAAKAAAGACA..SACALAEAaAHDZAEBdAHABCAAHCCBhBAARCEADDIBbBFD...NBBA.hBHAAAFAOEEB.TFGAhAAAXEGA.FFFHEFCBeHDGCGFD...hACA......hCAA...,1,0,-22,22
cfQHYVKOWbEeBJSaPLNZIdGMUFTDACgRX,RAAAXAAAQADCHADAKAFC..OAFAEAHFBCCDaBGELDAAhAAA.ZCFAGCEAhAAAMEEATFFAACGBCCHAfEDEhABAYFHBbGFA.SEHF..hCAA......hDAA...,2,-19,2,21
VUKSMcaWBDEXFIeOQHYZbGNfPCdLTgJRA,KAAAMAAA..aACADAEAFAFAeAFA.HBBAZBCEGCEB..fBHAhBAAdDBDTEEARCEBABDAhBBASAHHBDDDEDHFOFGBhCAAQGGAbGCACHHA......hCGA......hDAA...,2,-19,-12,7
QHbBMCaEGVdfUSJTOINcPFgeDZWLXRYKA,HAAAMAAA.EADEdAEASAFBOAGB...IAHA..hAAAPBBAeCAAZCEALAHBhBAAREEAACHAbFCDaDDAfFHAhACATEFAFFHDDFCBYEEFBDDD.CHCA..hCAA......hCFA...,1,0,-19,19
CDcLTfSVWPGYANZUEaXFbKOIHdJQRMgBe,ZAAAEAAAFACDOACA.HAFAdAEARAGBBCCD.eCEBDCGBLDDBhAAA.SDFDhAGAPCGDAAHAaEEHKDHB..QEBBhAIAMCIBCFCA.TFGAfGFA..hABA......hCAA...,2,-26,-17,9
aOdSFfYTUCDcZgbJPRQIeWHLEMVNXAGKB,GAAAaAAA.dADAFADA..TAFADAGAZBBAJBHBRBFA....eDBBhBAAHCDCEDDBMEEB.XDBDhAAAADFBODGDfFAEhACACFFD.bFFAQGBBLHAAKHFAhAFASFHH.cGEChBDA.,1,12,-34,46
QLACXRSNZWJdOFPeVIDcbEaTBKYUgMfGH,RAAAZAAAdADAFADA..eAFADAGA..EBFAaBGEBBHAKCCD...UCAAMCFBhAAAHCDAAAFA..SDGAhABAJDGB.OEDBhCAAIFEA..bFGB....YEHBhABAfHDF..hDAA...,1,-31,-34,3
fgSaPWUNQOAXeLcbBdEZKGJDCIHMFYVRT,eAAALAAABADAEAEAGAEADAHB.HAGDMAIBFCCB.RDFF..TGAAhAAASBEA.aCAAhABAPEDBUDDAQDGChACAACIBbFGD.ZEAB.CFHAIGEA.hABAfGGE.hAGA...,1,-7,-11,4
cgOeUaJBXYCLfWNVDITAMRHPZEdSKFQbG,HAAAEAAAdADAFADAGAFAOAFDUDBABAHA..CAHALDEB.hAAA.fCAEhACAVGFADCIBAAFBRCCAZCGB.QEEAhAHA.........hAAA......hAHA...,1,-19,-27,8
KTADdSXCMJgaGRLHcefPQFVbEOBYINUZW,dAAACAAA.MADAaACAGAEAHAFC..eBDBQAGAFCBDECFBBCHAhACA..IBCAhAAAZEFATGCAADDAXDFDhAGAREBAfGGAPFHD.OEEH.YHDGhBIA.....hAIA...,1,-8,-10,2
YGdgCDcNTEWUOIaFAXMZSKBHPVLReJfQb,ZAAABAAAHAEALACARCAAeAHHQAGAGCFAdDECDCCA..TGAAhABAECEAODAAFECBAACAMDIBhAEAKDFAJEAB..bFGDCDHB.hAAA...NEEAIFFA...aFHBhADA.SGHHhAEA...,1,11,-27,38
BgRdGfHOTVQPDNLUbSCMeKXIaEZWYcJFA,RAAAGAAAHADBOAFAQADADBGB.LAGBUDAA.bDCAMBIBeCHHhAAAKDDDaDAHZEFA..cFBBhACAAAAAdGEA..TGGAhADAPFGB.CCDDEGCA.WFHHFHCGBDGA.hADA.fGEAhAIA...,2,-5,5,10
EXdHcAbLBCFZNVGfaQYeJWOPRITgDUSMK,LAAAFAAAZACBGAEAaADD..eAFAOAGFRCAA...TEBAhAGADBIBMCFBEDGBHEDBAAFACCGA.hABAfFFBQEGAhACA.JEDBIHHASGCD.XGEAhCAA.....hAIA...,1,-7,-14,7
fSZBNTUbWVMKeXaCdFLHAJcPGOIYREQgD,JAAAGAAA.OADARADF.EAGAQAFC.DAIBZBFEBCCDhADATDCAUDFAVDGBeEEDhAHAaEFH.dGDALEHBhBAAAAABIHHA..fHCB.SGGDhCAA..hCBA...,2,-30,-7,23
ObVDfSGWEJBgLTdNYKRAaFHMcXIeCPQUZ,HAAAMAAA.XADBeACAQAFAZAFB.OAHFbBGDDAIBGCCAhBAAECABBCCATEFAdEDAKFBBhAAAABBBaCFCFFFA.CGHA.PFEBhCAA...fGHA..hCCA......hCEA...,2,-8,-8,0
AOdFYcMfZWBIEgDSVLHbXKaGCQJNPeTUR,dAAAFAAAMADAZABBBADA..EAGASAEHHBCAKBHBGCFA.hAGAQEBAPAGDeCHHhAIAREDBABEAOFHB.hBAA.fDCAWHDA.DDFB.bDFD.aEDDhBIA.CGHA.....hCDA...,2,-27,-1,26
dDSGZWeYabNEBcJTgPfLUXIQKHRFOMVAC,dAAAGAAAeADAaADAEAGABAGA...TCDAfBHA.LCCAhACAXBGAQDAChADAHDBBRDGBMEFBACGBSDGAhAEAZGAA.bECAcGGCgGFAhBAA......hBCA...,2,-14,-2,12
CUgYdaQDIBEJRFKTXSPMbVWZecGLfOHNA,CAAAUAAAdACA.QADABAEA.RAFA.KAGA..TCGASCBDhAAAMCDB....bDABZCDBhAEAGEDALCGBHFFBhADAACIBaEHDEGAB.FFED.XGAA...hAGA......hAIA...,2,-34,0,34
JdPONgYbeTWDfUVMCXEFHZIRGBQcKASaL,aAAAdAAAOADA..NADA.....bABDeAEADAHB.VBGBMAIBhBAAEBBBHBFBZCEFREAAGEBAhBDAQFGAABEBLEDBhCDA.gFFATGEA.WHEA..hCFA......hDAA...,2,-7,-7,0
JUGPKWcdBNeYHFOAXLIRMEVbgQZfaDTSC,LAAARAAAEADE.VAEAQAFC.aAHDTCAA.CAHBGCCAhABAKCCAdDFAeDHBHCFCAEABhACAMECAZEFASGEAhAEAJFGBPHAA.BHGA.......hAAA......hABA...,1,0,-16,16
WMYBRNcdHaKVALJOZXeEGgSbTDQCFIUfP,LAAAZAAAEADEGAFASADHDAIB.QAFAFCAAUDDA...hABAfCAAMDHBRFAAdGFAhACAHCDCKHBA.AAIBXDGAhABAeFHH.bEEC.TFAA.CGGAIHDAhACA.YCCFhAFA.BHBA,1,11,-12,23
TQSMKXLCGbFcgWEJHeRAfNaOYUZDIdPBV,aAAAOAAAZACB.dAEABAEA..TAGAMAGBLAHBGBCAFCFD.hBAA...gCEDhBBAECHFHEBBABBB.fEEEhAGAUFFADEEBIHBAQGFASEHBhBHACEHA....hCAA...,2,-28,-3,25
HDNfcMbaTAGReSXVgOUKYCPWIEJLZBFQd,RAAAeAAA..XADBOADCKAGCCAFA....IAHAEBHFZCCAQDGBhAAAHCCADCFAfCHAhAAAbECB.ADGBGEEAhABASFAA.gFFBPEHD.hCAAWFHHBHHD...hABA...,1,-8,-25,17
SXDNPVYRBTCdEZGQfLIJUWKbMaFOgHAce,eAAADAAA..VACARADACAGBZBFEGAFA.LAHBUDCAKDGA..aBBHhAFAOEABHDDBADDB.XFGAhBAA.PHBAhBHATFEA.EGDBfGFEIGHA...hAAA......hABA...,2,-33,-2,31
fIFKAgHWJeRTdXLEYSaPCUMBbOQNGcZVD,HAAAeAAARADAdADALAGBEAFA..aAHDCCCAMAIBOCAB.GCDBhAAAZCEBDEAAFDHDAAAA..JEGBTFAAhACA.SCCDhAFABEDC.bEFDcGECfEEE.KGCAhBHA......hCGA...,1,7,-30,37
EaNgRQKPMZUbcJWdHBOeAVDTFSXILGfYC,TAAAXAAA.GADACACB..EAEAaAFARAGBKCCAZBFF..UDAAJCFBHEAAhAAAeAHHAAAA.FEFHLEHBhAEA.fFGAhAIAgFDDMEEBWDHH.OHFCSGFDhBIA....hCAA...,2,-13,-5,8
dfGZVKaHYWOBPDFSNcEUbCAQLIJXRMegT,LAAAXAAARADAeADH.dAFAZAGBKAHBHCEB.OCDBDCAASCFAhABAEDAAUFGAAAAAQEDAhACAMBIB.TFBAhAHAGGAB.aEAEBDHA.FFFA....hBFA......hDAA...,2,-22,3,25
CBSTRLFNgbWdDJKUHfcOZXQaeGEAPVIYM,VAAAMAAABADA.RAEF.LADB.FAFAbAGBdCFA.KBHBHBBBhBAAODCBZDEAaEHD.EFFBhBBAADHB....IFDAhAAASGCA.NIBB.DEIB.fFFAhAIA.....hBIA...,2,-31,-18,13
aHVSQPNEXgLIAWZUKJDBTefcOCbYRFdGM,ZAAAKAAABACBeACEOAFA..bADDRBEAGDDAHAFA..QCGAhAAAECCBLDGBAAHAUEEAhAFADBIB...fDCEhCAACGFD.dFHAMEIBaFCHSHGGhCBA.....hABA...,2,-20,-7,13
FQPWDULEZTRfadASVMOIGKgcXHCNYJeBb,MAAAGAAAKADA..XADAHAFBCAHA.JAGBeBBBBCDA..QDDAhAFADAIBEDCB.RDFAdFHAhAHAAAABODAH.IDHAhACANICB...bEEB.FFDD...PHFChADA....hAEA...,1,-17,-23,6
APgJTCEVKZaFBQLYXfSedMNOUIbcGHDRW,JAAAEAAAZACBBADBLAFA..XAEDeBEBdCBC.MCGBOAGFhAGAUFFB..bCCCHGAAhAAA.DCIBAAIBTDFAhBAAKEDBaGHD.FEEH.QGGASHCANICB..hAGA......hAHA...,2,-25,-4,21
daRWFfNSBOPTIVLceQUYDEbCJXGAKZHgM,HAAAdAAARADAFAGASACE.OAEDTCBALAGB.eCCBhAAAQCFADAIBEDHFbEDDhBGAXEAC.AADAZEDAhACAaFFCfGHABCHAIFHA...hCAA......hCDA...,1,-5,-23,18
VOXdKTLGWREBJAMbaQIUNSYcPHZCeDgfF,aAAAQAAA.UADASACH..PAFCHAEAeAHHhAEADCGAFDBAXCDDhAGAdDFATFGAGDFA.EFDBhAHAADHAbEDDIHHA.cGCC.CFHA..hAAA......hAIA...,1,-1,-26,25
VFPUKeQDZJcONGdCbWMXSLYHBIfaTAREg,EAAAFAAAKADADADA.ZAFB..OAEEdBHA.CAHB.MCCALBCB.HCFAhAAABDAA.aDDBRECAPEGDhCAAUEEA..eEHBhADAJHCA.....NHCB.WFHH..SFAAhAFA...hCBA...,1,-23,-30,7
VIaKNDbSXUYBdGLMWfcJERAHgPOFTCeQZ,HAAAOAAATAEA.eAGHZADBaAFD.DAHBbCAAUDFABCEDGDBAhAIAMAIB....fDGAhAAAEFEBABBBFGGACDHAQEAAhACA.KEEBNIBB.XGAC.hBAAdFHA.....hBDA...,1,15,-25,40
XcJdTUAWPaLSZCgYKOFbNBVEDeIMRfQHG,aAAAZAAACADB..KADAFAFABAFB..EBEFeAGHRCAA.HCCAGCFAXDAChADAdDHAAAIB..LFDBhABASBHH.OECEhAIA.bEGBDFFBMFGBfGHA.hBAA......hBBA...,1,-20,-24,4
DQSCfNVOgIcULdbRFBATWZeEGMYJaKXPH,ZAAAEAAAGACAMACA..aAEEXAEA.HBGBQBGAhABACAHBVEAA.OCCB.gDEAhAHAIEEALFGBhAAAREGBADEAeECH.KGEASGGDNEIA..hAIA......hCAA...,2,-16,2,18
RZTLfgaeKWUAEPICNFGOJHYVbBSQDdXcM,EAAACAAAGACAHACA..VAGBSAEA.dAHAMCCBRCAB.ZDDATCFAhAAALEAB.aDHDhAAAeDHFKFCAAAFAIEEAhACAOFFB.bFAADGHBfGFA.WHBAhAEANIAB......hAFA...,1,-1,-16,15
DGebgLNdQRMYBKPfWXZSJUCcVETaHAOIF,FAAAeAAALADAdAEARAGBBBCAKAHB......fCCAhAEAZCDESDGACCFA.EEBBHCGBhAFAAAAA.DDEBGEEAhAGAbECDQFEAMIAA.YHAA.XGGBhAHA...hAIA...,1,-7,-27,20
QBDEMYJLOZbFUXefHgINRAGadWTCcSPVK,dAAATAAASADA.KAGAQACC.EAEEMCCALAGBhAAAbCDA.XCDAhAIAHDAAgDGHhACARECAABIBaDHDCEGC.PEEBDGCB.OFHDFGGA.eGAA.hCAANIAB......hCEA...,1,3,-8,11
COgUbaeAWYNJTBEFXPKfMZLIGVQdcHDSR,...NAAA.TAAABAFA.EACEFAHBKAEC.ZAGBGBBAdCCAHECCRDEA.OCHDhAAAUFGA..eEAFhABAABGBJFGB..XECDhACAMIBA...IHDA....hADA......hAEA...,1,-14,-28,14
TeUHAPRVOaDZQBcKNJFXfLYSdgbMGCWIE,RAAAaAAAZADBBADAKAFA...FAFALAHB.dCCCbBBCGCFA.hADACDAA.EBFB.eAHHHFCAhAAAADDAODECDEIB.QFFAhBAAJHFA........hCAA......hDAA...,1,-19,-29,10
LURZXAgTEaNPSfBIVKGYdCbQeOMHJWcDF,EAAAaAAA...SACABADAKAFAdAHAQAFA.eBHHHCCAhADAJCCADBBBLDABhAAARCFFACEA.TEEAfDHAhAFAGGEBCEED.bFCDMFIB.FGGB....hBAA......hCAA...,1,10,-29,39
OHBDVgeZWdPMKfULXTScaRENCAbJFGIQY,FAAAGAAAQADAHADADAFA.eAHFdAGAMAIBKCDDLCFB.hADATFDAaCCBEDDAAAABJDHBhACAODFCBGGDZFBA.fFFAhBAASDAD.NICB.CGHA.....hBFA......hBGA...,2,-20,-1,19
SfKXOWGgDBZLIRYNFbcQJCHaPEedAMVTU,MAAATAAAUAEA..KACCOAGFGAEABBBAZAGBRCCB.FDHDQDBAhAIAHEBBEEFFAAGBSCHHhBAA.XDEAhBBADGGAIHHA.NIBB.bFDD.CBDCeFFAhBIA.fGHAhCAA...,2,-26,-3,23
aHPIUfEVLOCTFWgGBAbDdcZXMeNRYQKSJ,dAAAZAAAeACERADAKAGC...aAFAHCAC.UCFAEBFFLCHB.hACATDDAFEABGEDAhADAAAIBDCCBMDGBQFFChAEASFFDIHHAOHDCCCHA.BHHA..hABA......hCAA...,1,-11,-18,7
HNfPJURZXFYBLIdeDbEQWAMVKcSTCOgGa,MAAAKAAA..TADAOACEGAFAHAFB....fAHEhAFAPCAARDDBZDGBFBBHLDDBhAIAeDABEAHBADFBSDFAhBAAaFAH.UFFABGFDDDIBWEHHCECA.NIAB..hCAA......hCDA...,2,-11,3,14
POcZNRBQEFHYLaCDWeVGMdgUASTfJXbIK,TAAAXAAA.KADAOACA.ZAFBRAFFEBHFHCCBLCDBDAIBeBHDhAAAGDAAdDBCAEFASEFAhBDAbDED.IGGAhBFAcDGDBFHA.YHAGaFCEWFHH.hAAA......hABA...,1,-1,-16,15
KObFJNMRDVdBcXSeGYPAIECgZHWLQTUaf,EAAAZAAAHAEALADATCAAUCBA..aAGAOAGD.FCFHMCEBhABARECA.dCGABDHASDFDhACAeEAB.GGDBhADAAAIBCFGA.QEABKGFD.NCIADDDB...hAAA......hAEA...,2,-25,12,37
aRdVgPNJKZQCcWHLMOfAYeFTUEDbBXSIG,eAAATAAAEADA.BAFASACBGAGARCCAdAEA...VAGBgEEAhAAAJCCFZEDBQDGBhAAACEHAHFCB.MEBBhAGAAAIBFGGADFFB...XGFD...hABA......hCAA...,2,-13,-3,10
WGYOScHZFJgeUPMVQELNdaRTDBXIKfbCA,GAAASAAAHADAZACBFAGA.eCDAMAFAECGAdBEAREEA.BBGA.KCHBhAAAbDCCADGB...ODAHhAAAJECAUFGAQGGAhACAaGBA.DDIB.fHEBCHEA...hABA......hBGA...,1,16,-31,47
gOeQdDSERIJVcNATfPBHMLaGWKCbUYZFX,TAAABAAAHACA.aAEAGACA.CAEAUAGAZAGBXCAA.hAAAeCFDdDFAECABRDDBIEHAhAAAcEAC..ADHAMEEBhACALGCAKFGAbFCDFGGA.......hACA......hBIA...,1,-6,-11,5
XTOVUBcKPQGJCAZNDLMEfYWaRgSFdeIbH,ZAAALAAAEADE...fAEAaAFARBEAFCAA.eAFHHDDA.OBHDhABABAHAKCAAGEGAACCAMCHBhABA..gGDAhACAdDDAbEABTFEA.cGDC...hAIA......hDAA...,1,-6,-10,4
PgEWMaJDcbZCSIQNULfGFTBOeRKHYVAdX,dAAAXAAAEADA..aAFDDADA.ZADE.CAHA.QCBALCEAGEEAhAAATCGABAHARFCBKGHB.hABAHDDBACFA.PDABhACAMCIB.bFBDSHAAUFGAFGED.....hADA......hAHA...,1,2,-15,17
OUgeQCRGVHAfMdLKScBbXPaJYIWDEFTZN,dAAALAAASADABAEA..XAFDaAFD..IAHAhACAEAHBZCAAOCEBeCBARCFAHEAAhADAACCAMDGBbEDB.PFFAhAEAYDHBFGHDNICBQEAA.CFEAfHDBhABA..hACA...,1,13,-25,38
aLTPOBUAbFdeSKIDgJMCHEGVWQXfcRNZY,dAAAeAAAKADADAEA..MAFAHAFCGBEBQBCA.XCEBhAAARCAAZDCEaDGDTDGABFFDABHAhACAbFFA.FGDB.SEEGhABAgGEGCHHD.....WDHH.hAIA......hCAA...,2,-22,-3,19
TMYXWKQDGVJCdFegcRHEULSbfPaAZIOBN,ZAAABAAAMACA..XACAQAFAGAFACAHA.eAHBRBDFHDEBhABAECAALDCASCCDhCAAbDGDaCGE.AEGAOEHDhCBATFAAKGFDDGGB.........hDAA......hDBA...,2,-11,-11,0
cYQJeUNSMfWXTHZgDFIPAaVGLKbdERBCO,GAAALAAAdADARADFOAFAQAFA.eBHHSBFH.hAAAMBIBXCDAHCAAZDEEhABAFEEHADGBaFCBbDBDEFFACEHAJGFEhACAfFHA.WHCADFABIHBAhAFA.....hACA...,1,3,-11,14
PJNKUXELSfReCVQgAFDIbBGYWacTdMZOH,DAAABAAAGABBaACA.dAFAZAEBHBGB.JCCFKAGA.EBCBLEABhAEA.REDF.eCFHQFGAhAHAACHAbDBC...cGFChAIAMDHBOFGH.NDIA.....hAAA......hAIA...,1,-3,-30,27
ZTAgHCKJXWSPebFYIdaUEMcNBOfDQRVLG,HAAAKAAA.XADBSACBeAFAFAEAdCADEAHBMBIB.BCEADBEBRCEFhAAAGCFAACCB.CDCAPEEBhAAAIDHA.aDDHcGAAhACA..fEGELFHB.ZGCA.hAGAgGGAWHDA.hCDA...,1,2,-24,26
NgOIDaGbBUCXTfHAcMZWLSQJKVPRYeFEd,ZAAALAAAQAEAKAEARAGF.eAHBdCAA.OCABDCCAGCEABCCDCCED.hABA...TEGAhACAHCGBAEEAMDDBSEAHhABAPGAC.EFFB.gGBAaEAEXGDDfFHAhACAcGGC...hAEA...,1,-5,-17,12
MTbSYJdWLgIaNFAZRBPCGEQXfHVeOKUcD,RAAACAAAGACAEADE..QAFCHAEAeAHHKBHBDCAB.MCBBSCCAhAAAdDFALEEDaDEDAAHAZDFBhABAXFGAOEHBTGAAhAAA...YHEG...hCAA......hCCA...,2,-22,3,25
XQGcZPeEKSTYOBbdNIRJUWHVAfMCagLDF,MAAAaAAALADAFADDGAFAZAGB...EAHBTCCABBBA..dDDAREAAUEEAhAEAHDGBAAFBCBBDDBIBQFEDhAIA..eEHBhAFA.SGCB.....hBAA......hBBA...,2,-23,-13,10
WaecKORZbBTYAUMCLgDfFNdXIHJGEQVSP,MAAALAAADAEA.FAEAdAHAHAGBGBBAEBDFQCAA.SCFDhABAaBEAeDEAODHDhBAAREDBZFFBBDHAABBBCEDD.fFHAhACAXFDAIGGA.PHBAhBDA.....hAIA...,2,-17,-6,11
bJECAHQDMXSgfeYaILZKPUWTVFRdGNBOc,HAAAMAAA.SACEeACA.aAEDZAFBKAGAPAHDUCGA..TCCAhAAARCCBGDGA.OBBBhBAAbEEC.EFBBADFAQGAAhAGAXFEC.fFHA...hBFA......hCAA...,1,-1,-11,10
GTefHMJgOWYZNKLaRUQCDIBbdAXPFcSVE,FAAASAAAEADA.eACHHAFA.MCCAOAEAZCEELDAAhADARBDF.QEFAhAHADAIBbBGDAAAA.PFEBGDEAfGHAhAIAgFBAWCHHKGDBaGGA.CHFABHHDhBFA.....hBAA...,2,-7,-1,6
HbDAYZEfWXQSdBRVOPeNLaCgKJTGFcUIM,EAAAXAAAdADABAFARADA...OAGDeAGHaBHDKCBA.GCEA.hAAAFDAAIDEAHDCBAAAAZEGBhADAQDGBSEADhAEAPFAANIAB.LFFA.CHHA...hAFA......hAIA...,2,-30,10,40
dIbSUXDGeNOPfcgaLBAJKHVQMWFYTCEZR,HAAAMAAAFADDTAEAZAEB.RAGF..dCAD.SCEDDAHBeBBBOBGHhAIA..fDCAhAAAaCHDADDB.KDGDQEEChBAACEAAEEHFbFDBXGAAPFHB.gGGAhACA....hADA...,1,0,-25,25
dKGeJXOBcEAgYNZVRbQaDSTWUFILMfHCP,...NAAA.RAAAaADA.DAGATAFA.FBBAMBEBHBDBdBGAGCGAhABAeCCB.ODADEDHFAAAAZCEBhBIAbFCA...QFGBhCAASAHBIGEACGGD.....hACA......hADA...,2,-14,-13,1
LDYVUdeBQEZCAHcONFTRgWJKPIfbXGSMa,HAAAOAAATAEARADA..JAHBKAGC.ICCA..bCCAGCEBhAAA.aCAHLEAAhAEADECAUEFBeCGDEGGBABIBhACAFEEHPHCASBBGMFIB.dGAA.ZGFE.hADA......hAEA...,1,0,-11,11
XYJHOQDKTFeUASBgMILECadVbcWPGRfZN,BAAAMAAALAEAEACAdAFA...VBBA..bAGD..PBHDhAFARBDBZCAA..XEFAhAAAHCEBQEGDhAGATFBAeFEBACGBSEDDCGGD.aGHH...hACA......hAIA...,2,-17,-6,11
RWbMZDVBOLXIJAaEedgUFTHPGQYSNfCcK,EAAAeAAAdADAFADDHAFAGAFAQCBC.SCFACAHARDDBMCCBZDGBhAAABDEDLFAAhABAXDGAAEIB.aFAA.TFFAhAAAPHAAfHABKGFDDGIB.OFCD.hAFAIHHA..hAFA...,2,-6,-4,2
PGUQgbSOLXdVNEMRCcfWaBYFHDTZJKIeA,GAAAQAAASADALADAdAGAEAHBRCDACCHA....fCDAhAAAaDAHFDCHHEFAZCEBKCGAhAEAAAABUGBAbEGBXFAAhAFAMFEBBGHADFGB........hAIA......hBCA...,1,-5,-12,7
HegYScDdRbJfFMEZAPXVCIOWLTNaGUQBK,XAAACAAA..OACALADAaAFDGBCAQBGAHBGBeCDBhAAASAHBdDFAREAAbEGDhABAFEEA.EEHFAAEAIHAAhAHATFBABCBC.KGGD.YFDBDEIBMICAhAIA......hCAA...,2,-5,-4,1
gbcCXRTMFdaPUSKNfAHWBZEYDVJeQOIGL,HAAAZAAAEADEDACA.eAEAQAFCGBGALCCA.bECAXCAAhABA.RCFAMDDBhACAaEGHSFABhAAAfEEAAAIBBGCAVFGBOHAAIHHACEHB...hAHA......hAIA...,1,-3,-10,7
eELRZdGOBUCSVTYIAPgDfMQWFbJacXKHN,DAAAMAAAQACAFADD..aAFAKAEAHBBBEAGEZCCAGBEA.BBGDhAIASCFBTDGAABBBhBAAfCHAJFGF.hBIAXEECeEED.RFGBdHCB.....hCAA......hCIA...,2,-14,-12,2
cGVFENOJTbMLDfXQaZPRCSgWeAUYdBKHI,dAAAHAAAGADAEADEOAFAJAFA...MBGBLCGBDBIB.QCBDhACAZCAARDGFSCCEhAAAeDADACIBBDFAKEEBIFCAhACAFFDATGGA.bFBDaFHD.CHCA....hADA......hAIA...,2,-12,-4,8
aVCALYOfGHeMKbSQTEDJNIZcBdXWPgURF,LAAAOAAAHADAeADHMAFAKAFA..QCAAEBBBDBHB.JBHBZCEBhBAABCFAdDGDXFGAhBIA..gDEGhABARDCFaGFCAICA.GFAB.bFGD.SHAGhACA....hAFA...,2,-15,-4,11
JXbHCRGYdNaIPUKSAVcZOFTfeBLgDWEMQ,ZAAATAAAeACE.LAFBDACA..EAEAMAHBQAGA.hABAXBDCHCDBREGBdFCAhAIAaCCHUDFAABIBOFFBBDHAhAAA.gEDF.bGCACCCD....hBIA......hCAA...,1,-12,-15,3
JIdMFACNaYWLTbXfBQZDHKgSVReEOUcGP,aAAALAAA.TAEAXACD.QAEAHAGBSCAAhABARAGBEDDA.OCEBGDFAhAEAIEAAdEHAAAIBCFEDYBBFhBAAbDCDZFEBKDHB.eGAG.cGGAMIDA.hCAA......hDAA...,2,-7,11,18
FTYJVcKZeWLDGAUINQXPRgbOMEHSCdaBf,UAAAQAAARADA.OACCHAGBdCDDBAFBFDAA..TBGAJDFB.hADAKCDAeDHFLEAAhAAAAAIB.XDGA.hAEAbEECEGAAaGDCfGGEcGGA.DEEBIHAAhAEA....hAHA...,2,-18,-17,1
SRaNPOfZgAKCdeEQFMbWGVJXTYcBHLUID,dAAAEAAAFACDMADA.GAGA..XAEATBDA.BAHAHCACLCEAhAAADDFBREFF.aCHDOEHDhACAZDDAAAEAeFCAQFBAhAIAbFGD.WEEDYHAA....hAHA......hCAA...,1,3,-18,21
PJIRfEXYWLNGUBHdKODVCcbAaMTQSFegZ,aAAAMAAA..QADAeACAZAFB..JAHBRAFAEBBB...XCFAhADALCCBGDCAhAGAHEDBdFFADCIBCEEBABBBFDHDgEGGhAIAfBEA.......hBAA......hCAA...,1,-13,-18,5
XOeMVbTfFBaUcDALPWKQdZCIYNRSEHgJG,LAAAKAAAZACB.CAEA...IAFARAFFHCAAGCGA.eCCEhABAbAGDFBEHaAHF..DEABAAIBQCAAhAAAdEEASFHHhACAEEEAJEGBMIDATGCABGFA.....hAEA......hCAA...,1,-2,-21,19
ALWcIbSXHKRVOfDFMZBJeQNgdPGCUTEaY,LAAA..IAAAbADD.HACARAFAOCAAFAFAZBFEeCGFhABAQCAAdEEAGGABhACATDDAEFAAAAFASDFHhACAKFHBDGGBBHEAgEAGCHHD.aDHB.cFGDhAEA....hAIA...,1,5,-20,25
QEdFeUCHGWYOLIDaPVZTNcfgbXSMRAJBK,KAAAEAAAdADAeACEHAFAGAFAOBCHLAHBDCFB...aBCDZCGBTECAhAAAfEDA.hAFAXFAAREEFACEBQGGAhBHACFFDIGHA.NIAB......gGEGhAAASHEG.hAFA...,1,-2,-17,15
APNFEOXYBIbDJQHVSZCdTaMgfWRLeKGcU,FAAAEAAA.OACDBACADAEAHAEAZAEE..dAHAMAIB..fCEEhAEARCCBLCFBeCGBGEGAhAAAADIBXEEA.hCAAbGAAQFDDCFHA.aHCC....hCBA......hCCA...,1,-9,-19,10
BOTQPMAcCFdVKJWfUNebGYXDLagEIRHSZ,FAAAdAAAKADA..JADAUAFA..eAGHGCABDAIBLCCAhAGAECHFHDEBZECBODBB.QDGAhBAAAAIBCEHA.VECAhBDAfGEE..bGFAaGGA...hCAA......hCBA...,2,-20,-19,1
MGITVYOUdSDRBXZPfeJHgFAabKcECQNWL,aAAAKAAAEACE..QADALAEBGAGATAFA.OCCB.hADAdEEARCCBZCFEeDGDHEFAhAHAAAGBCGGD.MBBB.IGHAhAIAYECBDHCA.BHEA.....hAAA......hAIA...,1,-5,-23,18
WRHgfVFGBebEXSPJCMcaTZLYOKUQdANID,DAAAHAAA.VAEAGABBBAHBEAFE..SCAACAHBMCCB.aCECZCGBhAEALCHBKDDAdFDAACGBIEAAhAAA.RDCBFEEAhACAeFFB.PFHDTGGA.OHDC..hADA......hAEA...,2,-21,-2,19
FPTAZJHacfCdOSQXKLYVMIWBUDeNbgRGE,HAAAaAAA.CADBdAFAQADALAHBMAGBBCADeAHB..bCCBRCCBEDABhADA.FDGDABHBZEDBfFBAhAIASDGDKBBDIFEAhBAADEIB.gGGATFBAOFFBhAAAYHCA...hACA...,2,-20,9,29
daYIWCgNXSPcOBKLbZTDHVQReAFMJUfEG,MAAAUAAAEADAdAEA....aAGA..IAGACBBA..XBFDhBAASAHHOBDHhBBALCDAZDFEHEBARDAAADAAfDGAhADAYFGBNHBB.BEEA.bFBDDFIBeDHHhBAA.FGGH...hBEA...,2,-19,-6,13
TFSNJfaKYIWRCdOVAPGeBULQcgZHDXMEb,eAAALAAAQADAZADBHAFAMAGBECAAFCFHSAHB.JCCBhAAAaCHBKCHDIFFAhABA.CDCDdFHAADFBGEDAhABABHAA.gFFBDEEB......hBFA......hBHA...,2,-15,-14,1
KgMfWREaNJUGZFbSPVIXYeLTACOBQHDdc,BAAAHAAAdADAKACA.MAFARAEF..EAGEaBED.UBGAZCAAFCGA..bCAChAAA..SDFHhAAA..IEEAhACAeEABACCAQEDADEGAfFGAJEHBPHEChACAXGCA.YFHBhCCA..,2,-26,-9,17
WPYNFGABTXeZQJcKCVISMUEDaLbgOHRfd,TAAAeAAAZADB.QAFAKACC.CAHA.SAEA.EAHBhAAAaCCBLCCAOCFBHDGBhAAARCFFdECAPDHDhAFAFGEAACIBBHHAXFFC.JHCA.IHHAhAIAMDBBDIEA.....hCAA...,1,-9,-11,2
USdJGWecKQHMAVTPZEBgFfRLbXIaYCNOD,TAAAEAAAFACD..RAEA.LACB.XAEAaAHDCCDA..DCGBdAHAhAAAGDEAeCEBQDGAhAEAHEAAAAEAZDGBBGHAhAAAbFAAIGFAOHAA.SGDH..hAFA......hBHA...,1,-13,-14,1
BeVNXZEMGTbJRHOCIKDYfgUWdPLQcSAFa,aAAAeAAA...XADAEADAGAFA.TCCARAGBHCCA.CDFADDIBhAAAfAHEUEAAdFFALDABhADAQGCAABBBBDHAhAIANEHA.bECA.OFHB.KGFB...hABA......hAEA...,1,2,-12,14
MTNSADUcdIaXgEbHRQOJYZeVPWKCFBLGf,DAAAdAAAaADAEACA..HAEARAFF..QCBAOAHDZBBAeAHH.VEDAhACAKCFABDDD.GEFAhAGAMDIBTGGAhAHAAEFBIEHA..........hAHA......hBAA...,2,-28,-10,18
LIbADFOTZQfcgGePNUCYdHJMEWSRXKaVB,OAAAZAAAQAEA..fADAGBGAeCABUAFAdCCDHCCChAIAEDEFRFFBaBHDLGBAhABAABBBTDFA...gFBAhBAACAHBMEABWFHHKEHBBFFDDICA.FGHH.hACA......hADA...,2,-3,1,4
RcZBaWJNdYFISAHPDbCOTQVEfKeMLgUXG,HAAADAAAOABETAEA.EAGEeAEE.MAIBLCAA.XCEAhAAARBDAZDDAaCFEJCHBdEHAFEAAhACAACCB.bECD..CFFD.QEEChADAKHAA.gGGA..hAEA......hAIA...,1,7,-28,35
MFJGLREPIYZVgOBSHfaDUNbcWdeTQCKAX,MAAAGAAARACA.EADA....IAGAZAFBOAHDHCCCaCDBDAIBUEEAhAAA..bCFBdEHAeDHBhAFATFBAQFEChBAAABFBFHDA.PHFC.......hACA......hADA...,1,-2,-13,11
ZYdJefRUTgNWMGFDaCIEQAKSLVOXBPHcb,LAAAXAAAHADAZADBdAGA.eBFDRAGFTCEA..NAIAGCAAhABAaCDHEDAA.ACAB..SDGHhACABDHAbEFDfFAAhAAAUGGAMEEBCCCC.QGBA.OFFHhBGAcGAD...hEDA...,1,1,-2,3
caFUJLORfdINbSYWZMVBGEPeQgXDHCAKT,TAAAaAAA..FADALACBRAFF.dAEAICCASAGAZCGBBAHBhBAAECFAeCHF.QEBAhAAADBBBHDEDACEBKEDAhAGAUGGAfFGE.YHAA.hBDAMEIB....hAHA...,1,-9,-26,17
SWUGEOJIHAbNCTeDZfFPXcdYQBKVaLgRM,CAAAeAAAZACA.FADD....XAFBdAFAQCGAKAHBLCCBhAAARDDAMCCBUDGAGFBBECEB.hADAOFFAHEABAEABNIAB.TGEAhAEADGGB...fGGB..hCAA......hCBA...,2,-16,-12,4
MWIVDHKbcPgFOGASTLZYRCeafJEXNUQBd,TAAAZAAARAEA..eAHHaACA...ECAAXAEDQCDDBAGAdDGDhABAMAIB..IEAAhACAHCCAbCGD.gEEDhAAAGFABAEEBLFFAfDBEJHFAUGAAhAGAWHAAKGDA.FGHB..hBDA...,2,-1,3,4
NPEfQLDObXWRAKSCBMTIZcadegUVGFYHJ,CAAAMAAAZACA.dAEAUAGAGAGA.HBBB.JDEBECCA.LDABhAAADDGBODHD..bDEARGAAAAGBhAIABEDD..TGGAhBAAaEHDeFDA.FGBD...NIDB....hBBA......hBDA...,2,-18,-15,3
cBQNOUdVTaZYLWRFJCbPXKAMSGEfIHgDe,GAAAEAAAHACAeADAQAFCOAGDdCDAaAHDZCCALDFA.REAACFFAhAAAbDFD.KDHBAADAMFHBhACAfEAADAIB.BECAhAAAVGBA..YHAA.FGHD.PHDAhAEA.....hBAA...,2,-9,18,27
JdNEcVXGaPYTeIDQKHLUZCfSAWFbBROMg,FAAARAAAMADAdADA..EAFA..XAFAGBGA..aCCCTBDA.hAFAeBHHQDEDhAIAHDDCZFGBSDBDhBAAAAAAbGCAOCCBgFFG.cGCA..hBDA......hBIA...,2,-20,3,23
DLCXAIQgYNabfURBJcPWGdTHeOSZVFMKE,QAAA..gAAAaACEUAFARCDBBADA.JAFAPCHDhAAAdCCAHBEA.eCHFhAAAZDAAMDGBEDAALEEBhABAAAIBIFBANDGA.bFGDfHGF..hADAcFDD.WHBGhADA...,2,-22,-7,15
NTCHLdeQAaVRgfKYMBSZFXGPJbOWUcDIE,RAAAKAAAMADAZACBGAEA..JAGBOAGFUCCA.DAIB..ECHFTEBAhAAAHEDCdBEA.AAAA.hAIAaCAB...fDGEhACASEHHXEDDbGEC.IGAAhAGA.LFFBhBEA.eEHH.,2,-20,-2,18
cFHIQXPaNTgdMZSfUeGbJKLABYWOEDVRC,BAAAOAAAEACARADA.FAEDHAGB..QAGAaBBC..TCEAhAEAdCAAZCCASDDDhAGAeCGBbEFDLGAAhAAAAAIBDDIBCEGAXFFCPEEBMDIBfGHA..hBAA......hCAA...,1,2,-22,24
FgYKWaeZPNUMbLSAEIDXTHVCBRfOJcQGd,EAAAXAAAHACABAFBRADA.OAGDQAGCdCCDFCFHKCDD.eCEHhAAAZEAAUFFAMCIBbDABAAIBDCIBhAAA...CHED.fDGAhABA.GGDB.WEADaEEH.NIABSGGEhADA.hAEA...,2,-21,12,33
bFaLNMIVSRfPgWQZEXCYBOdJKGTDcAUeH,HAAAaAAALADAMACASAEARAGF..fBBE.hAAA.gAGHhCAAZCEFEDCACDGDODHDdCCAGDFAhCEATEAAACFBeDHBFGGBNEEAIHHA.PEDDhCIA.....hAEA...,1,2,-15,17
EXVFPODALIdTCUfWYaGgeRNMQHJcBZSbK,dAAATAAACADA..UAFA..fACB.aAEAeBHHRAGFMBFBhAAAHCACBCCAbDEBEECAhACAFDGHDCEBAEGB.LFFAhAIAIFHA...YFBFNICB.cGGChADA.....hCAA...,2,-18,-18,0
eIJVBMcYKfgCHESRXUGZAOQDFPbTWdaNL,QAAAFAAA..bACDdADALAEAeAFAICFABBHAMCFBhAFAKBHBCDBAHDGB.RECBGGEBhAGAAAFADDDB..TDGAhAAAaGCH.VEEB.fGHA..hBCA......hBDA...,2,-24,-7,17
WagGRHAMcdDQBYeILTCEJZUPNVKObFSXf,dAAAQAAAeADALAHBEACAZAEB.UCCA..PAGDKBFAFDABXDCChAAA.aCHDRDFBHFDBhACAAAIB.MFIBBBDAhCAAIHBATEFACFED.JFHB.....hADA......hAEA...,2,-16,-5,11
beRWZODcTXNLASKBVJaHgdMEfYCUGPQFI,BAAAaAAAHACBdACAEAEACAEA..GAFAFAGD.eAHBRCDAZDFEDBBB...hAAATEAALEAAADEAKDHDhAEAVFGBMEEB.fFFAhAIA..PHDCIGHA..hBAA......hCAA...,2,-26,-12,14
GHKTUeQPgXcRYLIfDaCNASWJBFEOZdMVb,SAAABAAAEACAdAFAMADAGBDA.HBGBTAGAUCAA.eEGBhAAAQBCA.XCEBhAAARFBALHAADCIBaDFDhABAAEIBFFFHZFBA.bFGD.......hACA......hAHA...,2,-8,-3,5
WcSAIYBLDGFTOMEUKCaQfdJbNXZPegVHR,BAAAGAAAOACAEADACAFA...aAFDdAHA.JCDA..XBCChAAAZDDAeDADHBGB.RDBASAHBhBDAAAABLDHBTGCAhACAMDFBQEGB.bFBAgGGGhADAcGGC.DFFB..hBCA...,1,-2,-13,11
HJEABcPUZYVWQGDOTSXfFRdbNIKagLMeC,BAAAUAAAZADA..VACAGBGADAFA.SAGEFAHD.RCBA.dCAAhAAA...ICFAhACAaCFHMEABHDDAAEEB.PDHBhBGAQFFC.XECDbFFDKCCD..hAEA......hAFA...,1,-20,-22,2
CXNPFLGUVSDBHfEadYWMIceTJQKAOgRZb,RAAAZAAACADB...XADBFAFAGBDBUAGA.DBFBHDDA.ECHFdCAAMCCBhAAAeCCB.QDGAhABAAAIBOEHD..bFFBLEEBhACA.BGBAaGDA.IGGA.hABA......hCAA...,2,-14,-14,0
BHgbLTcSaeZVEJKGUNRQCIAfPMDWFXYOd,MAAAFAAAOACDHACCLAFB.TCCAaAEAeAGHZBGBEEEBGCDAhAIARFCB.QDGAhBAAAAHADBBB.XEBChBEAdFHABGFAbFFC..........hBFA......hBIA...,1,-7,-15,8
BCEKQZFMNVSaDgURTLPAcdbJefGXOHIYW,dAAAeAAAGADAHADA..IAHABAFAEAHBZCCAMCCB..SCFBhAAAaCGB.DCHBRDGFTFAAhACAAAFAbEEC.XFDAhADAOEHDCGGDQGGBNICB....hAFA......hAIA...,2,-14,-8,6
IgKBZGeVSATaOcCXPNbFfMLRQHJYUDWEd,aAAACAAA....XACA..bACDMAFARAEAHCFAUBFAEEAAdCAAhAAAKBBDGCCA.eCHHhACAAAEATECAOEFBPEGDhAHAFGGA.LEEBYFCFDAIB.IHCAhBAA....hCAA...,1,-11,-12,1
GMQVfXRCWgbLYeZKIFHBdJUaANDPcTEOS,DAAATAAAEACA..GAEAMACA...QAGAXAEARBGFCBBD..hAAA.bCCAeCDB.ZDFBhAGAFDBHHEBBdEEDaDHDADIBPEHBhBAASECH.fGGA.hBEALHAA..hAHA...,1,-4,-11,7
ZFGCgRXfTWLOEPAKaNBIbMDUVYHSJQced,aAAABAAA.MACADADAUAGAHAEC..QBCCeBBAZBEB.GCEAhAAARDFF.TCGALDDDhBAAEEDBAAHAKEHB..bGFASGHDhBBA.dHDBCEHA......hBIA......hCAA...,2,-21,-2,19
JTIDRSAegdPaZOcQMGUKBVEXLfbNCFHYW,eAAAdAAAZABBQADAGADABAFAEAFALBHB..bAGDFCCBhAAAHDEBJCFBDDEBAAIBaDBEMFGBhABA.KFHB.fHCBhAIACEGBTFAARGCA.SGGA..hAFA......hBAA...,1,-7,-12,5
aRACKHMSOeEDYdNgPXQTIVUJbZFGLBfWc,HAAAMAAA.eACEEADAdAGA..gAFBQBBCTCCAUDDAZDGBhAIAGCEALECDhBAAfCHAaFHDABFASGDBhBIADECBPEHDXGDC.IHAAhAAA.....hCAA...,1,12,-12,24
cPRBfECSOAHVagXMGYZIdDJQKeNFbTLWU,HAAAaAAA.MACAZACBdAFAQAFAKAHB.eBDFFCEHLDGBhAHAUDFAREDBEFCBOBBB.ADIB.hBAAXGGAGEBADFFBhBEANAIA....WHBGBGHA.SGEDhBFA.....hAAA...,1,-8,-14,6
PCFeOBQEcRSNVATUgHXMIKfdbaWDZJLGY,TAAAHAAAMACA.KAFAdACA.aAEAZBEAGAGACAHBFCCB.BBEA.EDDAhAAARDEASDHHhAAAAAIB.UGFAXDFDhBEAIFDAbFECDDIB........hCAA......hDAA...,2,-19,-19,0
XObFQZYcJCSTLaHRdPVIKeAGDEWfgUBMN,EAAA..fAAABACAMAEAOADA.QAGAZAFEJBDBSCFAhAAAaBCAHCAARCEAdEEAhCAAIEGAACCBGGEBDDIBhAAA.gFCAXDGAFGCBCFFD....hCBA......hCGA...,2,-19,1,20
dBWXQCSKOAgENRVDecMLYJUPaFTZbHIGf,EAAARAAAeADELADA.UCBAaAGAZBEAHAGBGCCAdDDABCFD.QEGAhAAAKDHBAAAA.VFAAhAEAMEFB.PEGBhBHAbFED.IHHA.XGDDSGGGhAFA......hAIA...,1,-2,-10,8
AQKZPNaHFDORUCVTJWSbGdELgXYeBMfcI,ZAAAaAAAHACBOACARAEA.UAGA..TCFA.SAHBhAEAdBFCECCBLDHBXEDAeCEDhABAMBBB.IEHAhAFAAEGAQGFCKGFAFHCADIBA......hBIA......hCAA...,2,-23,3,26
FZSOYgBRbXUEMcTCJfaDNIKdeGPAVWQHL,QAAAHAAAZADBOAFCBACARADFUCAB..EAFEMCFACAHB.aDEDDCFAhAAA.KCHBGDGA.hCAAAAHALGDASDDAhDAA.bDFD..........hDBA......hDCA...,2,-33,-13,20
NIOVWERTcbSFZfJUHQBMDaeXLCPAYdGKg,GAAAKAAA..IADAOADAEAGA.RCDA.TAFA.SAHBhAAAZCGBfDCEhAAAHCAAMCCAeEFDCFHAACHBdDEAhACAgGCAVEGBbFAA.FGEB.....hACA......hBAA...,2,-16,-2,14
MJFNaTUZSEeHWAPGORgQYIbVdcCXfDKLB,GAAARAAAQADC..bADAdAFA.XBGDKAHBMCDB.FCEBaAHFhAAAZDGB.EEABHDDAAAABOEFBhACAgEGA.hADAIHEACGDADEIBBHAANCCASFDAWHCG.hAEA......hAFA...,2,-13,-1,12
NabdIZGWMELXRSYgTAcVPOeCJfDHFKBUQ,VAAAeAAACADA..DADAHAEBBAFAQAGA.aCCBdAHAGDDAhAAAEBDFRCEA.SDGAhABA.TFGAADIBOEEBhAAAFGAAKGFDbFCDZFGBMIBA......hAGA......hBIA...,2,-28,4,32
MGXaHZVObQDIeTSdPYfCgNWAUcBKEFJRL,BAAAEAAARACA.GACAHAFBZCCAOAEADAIB.eAHFdDAA....fDGAhAAACBEB..gCABhAAAAAHBKECALFFAhADAaCFDbEDDIHFA..TFFA.hAFASCHH.hCAAYHFG.,2,-17,-5,12
NLGDSVbMQXOWZedEFCIJgfHcBPTaRUYAK,LAAAGAAASADAMAEA.QAGAOAHDeBCAECDACCFAICAAhABAJDCFHEEABBFAhACAaDAHRGAAADDADDFA.bEEAZGEAhAAA..dGEA.fGGE.PHBAhBHA.....hACA...,2,-10,2,12
TAFgWJGSdDacBIbZfeLOVKMHEPRNXUQCY,FAAAJAAAGADAdADADAFA.BAFAZAFE..LCGBKAHBHCFA..RDBAUFDAhBAAQDAA.TEGAhADAACCB..SFGAhBDAaDDH.IHHAeFABMFFB.EGGBhAFANICB.CHCA.....hAHA...,2,-30,-11,19
GdUOBReSZbWXFNcPaCMVDEHQLAITKJgYf,TAAAKAAA..JACA....fACBdAFABAHARCCAeAEEZCGB.hAAAbBEDFEEB..PBHDhAAA.aCCAMDIBEEGFHGCAhAHAACCA.IGHAGGDBSHAAhAHA.....hAIA...,1,-6,-33,27
MgCXOKcDVWfFIYeQEdRAGbSTHPULJaZBN,GAAATAAA.HADALACBZAGBMBIB.XCDAKAEADAGAfBGAhAAAFDCHeDAD.ECEBAAABbEEAhACAUEAA.BCHACGADOFHDhADAVEFA..IHHAdGCASGEAhAFAaEEHNIBB......hAGA...,1,12,-7,19
eBgfNaJELHMdTcARVQFCGYbPWOXDUISKZ,RAAAQAAAGADA....bAFAOACCDAFA.SAEEhAAAeCCBBCFAfAHAhAHAaCGDEDABHFEAdCDAACFAFGHDCCHAPDFBhCAA.XEGD.KGDA.NIEB.MIDAhAAA.....hDAA...,1,0,-18,18
CgYHAUVPNGESMdOLDXfFTbKacIJReZBWQ,VAAAGAAA.EADAdADALAGBDAFA.FBFBKAHB..aCDBJBFBREDAeCHHhAAAZDDF.BFHA.QGEAhACACCHDHFBBAEHAUFFAhAAASDAD.MIAA.....hBFA......hCAA...,2,-30,5,35
RWZTbdECXHeLONGQgKSYaIDUBJFcVfAMP,RAAAZAAAdADAEADEHAFALAFBGCDBKAHB..aCCHDCAABCHBFCDD...hABAVEFAACHBMDIB..hACATFAAXEFAeEEDhAAAQFCASGHHIHAA.cGEAhAHAWHAA...CHHA.hCFA...,1,1,-24,25
FHbRNSPUGWLYdTKeDCJaXMVgEZfOIAQBc,QAAAFAAAHACBRAEA.SACAGCEBLEAAdAFAeAHBCAHB.aCDBMEEBhAEA..ECGFZFEBODABhAAAACHABGGA..bEDDhADA.PFBB.UFGA.WDFD..hAIA......hBFA...,1,0,-17,17
XLaZOcbNIUgHYPeFARCfTKVEMJBSQGDdW,RAAATAAAEADE..MAFASACB.GAEAdBGALCCAhAAAZAGBbDDD.IECAHEAAeCHHhAAAABIBKDHBBCCDQEEAhABAXFFDaFHHOGAEcGCANIBB....hCAA......hCDA...,2,-19,17,36
ZKCGLOSXRdFbNBeHVYgaEDAPJTWUIcMfQ,TAAAUAAAMADA.ZAEEGACA.LAEAXBGARCEAbEEAeBDDhAIAHFAA..gCFGhBAAECABAAFAJGEAIHCAhAAAQFEAOAHDdGGABEHA....hBCA......hDAA...,1,13,-19,32
MCGBbDIYFdUTNWJOcXASLaPEZgfVeHKQR,aAAAEAAAZACB..VADAHAEA.RCEAGECADAGAFBBH.dAHA.UFFATBGAhADA..NCBAOEHDhAAAADDALDFA.fEEEhBAAKGADCHED.bGDA.....IHHAhBIA....hCAA...,2,-32,0,32
eSJGWNXKaTLFRYUMPDVOgAbBdZCfcHQIE,dAAAZAAACADBHADA.EAGEeAEHGCAB..XAGAaCFALDFAhACARCAAUDFAMEEB.DFAAODHFhABAAFFABFGAQGAAhACASFHHJFEFNIAB.TGGA....hAGA......hAHA...,1,-3,-15,12
OcEIfSKTgDXNUCFYZaVBPLAbQGJdeRHMW,GAAAeAAAHADAMADAOAFAEAGA..SBFDTCCADBIBXBGAhAAACCFAZEEABDGALCDBhACAAAAAQFCCRDBFIEGAhBAAKGGD.gFFG.FHDAaHCE..hCAA......hCBA...,1,10,-13,23
CFJUaeXIEROAZNYcQHSgLDfdPGTBMKVWb,ZAAA..NAAA.QAEAHAFALBBAdAHAGCAAMCFBKCGAVCDBCDBA.hABAFDGAUEGA.eDDBhACAEEGBAACA.SFFDhABADFAAfGFETGBAbFAA.....aHAAhADAIHHA..hAEA...,2,-11,0,11
UJILRWEgTBfaCeZDYXKdHFSMPbGVNcOQA,UAAALAAAEADABAFAaADDZAEB..DAHBKAGAHCBCFCAA...MAIBhADAGCFA..VCFBhBAAOCHFACEA.RFGF.TFGAhBCAeDDBdHCB..SEED.NIEB.hDAA......hEAA...,2,-24,-12,12
QZRdWfVIaTAHLGYJCDSPBFbEgNXOMKceU,HAAAGAAACADBDAFABADA.EAFA..XAGAMAIBKBGBeBEF.ZCAAhAAARCDAdECA..fCFAhACAaDAHAAABLEFAhACASCGHFGEA.bEFA.gGGB.hADA......hAFA...,1,-9,-19,10
WKUIACQEJbRfPZedTMDNaYFXBOVSgGLcH,EAAARAAAZADBdADADAGA..aAFAFBFA..BBCC.OAHDSBHHhAAAGBEAHCEBKDDDABGBQDAAhABA.bEGDeDGFhAAA.MEIB.YFGBXGDA..hADA......hCAA...,1,-20,-23,3
LPfeacbSNMZVgdWHOEKBJGRQAFXYUIDCT,XAAAUAAACADA.LADA..eAEHaAGD.SAGAhADAZCDAdDHAHEAAECFABCHAREEBAAAAFGHBhAEADCDB...TEEAhAGA...fEGBNIAB.MHAAhAHA.gGGAhBAA...,1,-9,-41,32
TNIRJeBEbYLCHZVXcaMFdfPgAGSUQOWKD,GAAAQAAAKADADAFA..TACARBFABCDAEAEELDCAHAGBZCDBhAAA.XDGAaDAHdDHA.hAAAfFEAAAIB.hACAOFHBIFFAeGAAbGBACGFAMIAA..hAGAFGHB.....hAIA...,2,-16,4,20
dDBIYPCTQaXFfWbRKcLGNMAZEVOegJHSU,EAAAeAAAHACAdAEABAGA..IAGACBCA.aAHDFBHD..bCCAhAAARCFBLDDBGDFAAAEAZECBhCAAOEBBSEHBhCBADEIB.PHDCTGGA......hAAA......hABA...,1,11,-35,46
fQAXJRBVNLOHTUgdMaGKFYPSecbWDIZEC,RAAABAAALADBHACATAGAdAFAGBGA.FDCHSCAA.hAAAeCEBbEEBDAIBECFEQEAAhAAAACCA.XDGAhACANEIAOFBBMDDBaFDDKGGBcFGA.ZGAAhAEA.fGGEhAFA...,2,-8,-5,3
YFIeERAbaKWGUfcDLdVHCNBZgQTMPXOJS,aAAAGAAA.UADADADAdAGAHAFABBBDZCEEQEFA.MCIBhAAAOBDA.SBHHhAIAFFEHEGHFAAHAbDBDfCDAhBAA.LDFBCHFA.NDCAPEHBhCAA...YEEDhCDA.,2,-46,4,50
QWMNDZOCVHcAXPLgSKeTIfFEaUYbBGJdR,LAAAKAAAeACE.TAEAFAFA..EBCFaAGAUCEABBGA..dCHARCAAMCEBhABAZEDA..CFHAHGDAhAAAACAAXCGA.SDFDhACAIHHA.bEAA.GEGA.QGEChAEADIAA..hCDA...,1,-6,-19,13
AUKeOYWTcSZJDHaRLbFCIEBVgfGQNPdXM,eAAAOAAA..TADAZADBHAFALAFBCBBDECFB.BAHA.fCCAhAAAGDBAQEEChAHAdCHAADEBKEFA..cFCAhABADCIBbDGD.FHCEgFGA.PHAAhAHAMIFA.....hAIA...,1,-6,-7,1
fKJCUOLeDdHFAVcbIQGRBgMXTSaWYZNEP,VAAA..bAAAGADARAEABAHB..MAFATCAA..aBFAZCEAhAAAECFFKDDDUDAAeDHHHDGBhAAAAAEAQFEAhABASDDDNICB.fFFE.CGEDDBIBFGCCIHHAhACA...hADA...,2,-10,0,10
ZcSPYBQbCdWfHNTEOMJIFaDAReKGULgXV,RAAAeAAAGADALAEA..XAFAZBAESAHHBCCDbCFAdCEAhAAA.HDFB.EDHBMDABhAAAFEDHAAFAKEFA.gFAHhABAcGCC.QGCAfGHATGGAhADA.....hABA...,1,-3,-14,11
FLYEBfgAeGHbMJcNTaUWPIRZQCKOSXVdD,HAAAMAAA.JADA..TADAaAGA..UCABIAGARBFA.ZBBFQDDAhAAAOAHDXCFChAFAdDHALEGDBDDBAEGAhBAA.eEHF.bFFD.....cGCAhCAA.....hACA...,2,-21,-8,13
ZLEFeABcbHRUGDaVITMQWKJfPCOdgXNSY,BAAAHAAARADFGACADAFA.aAEA..TBFAMAHB.QCABhAAAKBFD.JCHBCCAAdDGD.XEBChAAASDDAZEDBEFFAhACAAAIBbEFD..IGHAfHBB..hACA......hADA...,2,-19,-18,1
FVENacXZSJDHORbCMQLPUdGfTBWeAKIgY,KAAA..gAAAFACAEAFA...aADAZBEEDAGAHCCBRBDB.MAIBhAAALBGBdDGAGFABhAFATDBAeEFDAAAA.IHHAhCAAVFCAXFFB.OFHDCFHA..hBDA......hBIA...,1,-5,-17,12
XJDMTNKcfUZYVeSFLdRQgACObPIaEGWBH,OAAA..bAAAaADDEAEAGAFA.HDBADAAAMAHBKAHBUEFBhAFAZCCAeCGDLFBAREAAAAIBCEEDhAEAIHAABFGDTGBAhBGAfGGE.SDHBFGHD..hAHA......hBAA...,2,-13,-10,3
TaEGHdYWXMPOeVBNARKSQbCgIFDUcLJZf,RAAAQAAACADB.FACEDAFALAFAZAFE.aCDAHCCA.dCGAXCFDhAAAMCIB.eCHBhAGABECDADDASEEDhAHA.bFFBgEEBIHHA.cGDAhAAA.fGHAhABA...,2,-41,-3,38
ecYSDgNfLWaIZXGJKTOCAPRdFUMHbQVBE,RAAAdAAAMADAHADA.QAGCEAGA.eCAASBDADCFB..hAAAfCHAaBGEZCCAGDFAhABATEDAADHAFEBAbFABBDDChACA..YEEFLFGBIHHAhBEAKGDD.....hADA...,2,-8,-5,3
EaecUBLNbfXHDWFCSIJPRAOZGMQYTKVgd,GAAAMAAA.QADATADA.KAFAdAFAEBHFeAHBBCDDLBBBhAIA..bCFDHCGBhBAAFFDBSDADhAAAIDDARFDAADFAOEHDZGFE.YHAA.aGGH.hCAA......hCBA...,1,-1,-5,4
dgeHAKDCMBZIbVfYEFRaNXLPScQUWOGJT,CAAAZAAA...IAEAVACA..EAFERAFFaAHDLAHB.SCAAhAAAQCAAOCEDhACAGCDAdCGCHDGBADDAMEIBhCAAfFFEFFGB.PHAA...hCBA......hEAA...,2,-22,-5,17
JbDHQGcWNEATOPCeLgXYSRVUBFIZaMKfd,TAAACAAALACA..XACBRAFFBAHBZCCAaAED...MCHBdAGAbCCChAAAHDAA.GECBhAAANAIAADGA.eEHH.SGEAhADAFEBHfEEADICA.QFGAhBEA.EGEF.gGBAhBGA.,2,-11,-6,5
HQLVdeFgYNEDTfXBbZMPRKcSGUWaCIJOA,HAAALAAAeACEFAEA..NAGA.EAHB.DBEBTCCABCAAZCCF.RCEF.hABASAHBGCGAUGCAhACAaBHHCCEB.OEEBhAAAAFGB.dFAAfGHAbFGBKHEA.....hAFA......hCAA...,1,-4,-14,10
UHfBMEdQeNIRYbZJFKXGaADLOPVgWScCT,LAAAOAAA.VAEASADA.CAGAHCCAMAIBECAA.eCDBhABARCFFZEAAKCGBaAHDADFBDEAAhACA..gEGHhAEA.TGAABECAdEGDIHHAbFFCFHAAPEEBhAGA.WBBD.hAEA...,2,-14,1,15
FPEWbVGaRTHAIfNUdCYMKLBcegZXOJQDS,..IAAAfAAAdACA.MADALAEAeAFAZBCAOAHD.QCDAhAFAFBHDECAFbCFDaCBHhAGAHDBAACGBUEGAKFEDBFHAhAAAXFDASGGDWHDA.....hBCA......hCAA...,2,-19,5,24
UdgeHDSFPIQTfBNRcEbMZGOXWLCKYVaAJ,dAAAHAAAFADAQADCBAGA.RAFFEBHFZBDAGCABOCABLDDBhAAAKBHB.aCCHADFBUEEBhACAeDFBSDHHhACA.TFAAfDHENHEBMIAACFHDJGAADIGA..hAGA.IHHA.hAFA...,2,-30,16,46
OKIPGaRYASfLedEgCTNXDZUHWFBVbcQMJ,LAAAEAAA.TAEADADAHAEC.BAHBVBGBQBCChAAA.MCFBKCAAGCCAhABARCGBACIBeEDBdEAACFGDXGEDhCAAZEFAFGEAcGAD.IHHAaGHD..hACA......hAEA...,2,-11,-7,4
QZfdVbcARBHeJEXgTGDYONWKaLPFICMUS,HAAAEAAA.TAEAGACAOAGDKAEALAGBFCAH.MAIBQCCAhAAAdCFCVEAAAAIBRDFBeEDHhAAAXEAADEHB.YEHBhACAaFFBCCBDUGGBZFDBbGAC......hADA......hAEA...,1,8,5,3
aMUYOWAdLfQZDBHGTCJReFIgcXbPKEVNS,dAAALAAAZABBHADAGADACAGB.RAFAFCAA..ICFA..hAFAXCFAKBHBEDCASDFAhAIAaDDHMCIBOEGBhABAAEEBQFFATFAAeFEF....hACA......hAFA...,2,-20,-12,8
CITVLBdcAQEJSPbXHaeYGOgNWKDFUZRMf,EAAASAAA..bACAHACB.eAEAGAGAOAHD.gCEAhAAAKCCAFDABRDEBMDIBhAAACDGATEAALECBhADAdFFAAAEAQFCAXGABaFHHYHBADGEB.hAEAZFGB.....hAGA...,2,-7,16,23
ULZKFENGYVfWBQTRXIPDJHbCaeSAOdcgM,dAAAMAAAZABBFADDEADAGAFA..VAFABAHARCEB...XBBDhAFADCIBHDCBaCHDADHBOFGBhAIAUEDALFBB.hBAAKFFCfGDA.WFHBIGHAhAHA.PHDA..hBAA...,1,-11,-19,8
eQCNFARHbGDKdfJaXTSVgEBWULZIYMOcP,HAAAGAAAdADAaADATAFA..SAFHEBHFBCADLCCAhAAAZAGBMBIBOCDBeDFFQEGAhACAFEBDREEAKFHBfGGEhAAAXFAAgGGGIHEA.YHAAhAFA....hAHA...,2,-4,-4,0
CAgENLaDSbFYGWMHZfeVUORPcdTIJXKBQ,EAAAaAAA.DADAFADA.GAFAHAECeAHH.OBCBRBBAdBHA..TDDAhAHAXDDABEGAADBBLEGBhAAASEHHbFCBMFDBhAIA..fHABPFFB..IHHAhBAA....hBBA...,1,-6,-21,15
RTSEKCDJdLbQfGVIPBMXAWOcYZFNHUeag,OAAAZAAAHAEAUAEAeAHH.RCAA.EAGADACAdBBDLDEB.QDGBhABAGCGAIDDAhBAAMECBAAGA...cEBAhBEAFFHDaGCD.SGFHCEFDbFDD..fGGEhBIA...hCAA...,2,-15,-5,10
ZWcEAVaefTdJHbgXMBIOPRYQFNLUGSDCK,eAAAdAAAHADA.XAGBMAEAOAHD.RBCAFCFDLCCA.hAAAGCFACDBAZEDAEDHBABIBaDABhACA.TFAAJFBBBFHDhABAIFHA.PEEB.NIDB.DBFA..hBDA......hCAA...,2,-22,3,25
CcBRUDaGeFKEIOYTfWANLZMXSgHPdVJQb,ZAAAMAAASACEHACCdAFAQCCC.CAHABCGARAEFaAGAeBGFhABAEDFB.OCCB.hAHATEDAABBBLEHBhBAAXDGDgFFA......hCAA......hCIA...,2,-20,-16,4
AbIMDRJXFQaLeNdcUHVYWBCSETOGKPZgf,MAAARAAAFADALAGBdAEAHAGB....VBBBBBFA.ECCAGDEAhAGAZDEAAAAA.bEGBDAIB..QEBBhAIAeEHHUFDACGBDSGDBhBAA.......hCAA......hCCA...,1,4,-31,35
GUHDWRCTJZMXdLfgBFOeNISQYPaVAEbKc,EAAAKAAAGACAHACARAFF.CAEA.ZCCA.dAHALAGBBDGAFEAAeBFF.SCABhAAAQFFAaCHDhACAADIB.UEABDEEBJFAFMEEBhAEA...XFFAOECD.NIAB....hAAA......hAEA...,2,-13,-3,10
OWEYZGXKNULRfHIQgDPMdBTAFJCeacSVb,CAAAeAAA..aACASADA.OAFDEAFAGBCAKAHBLCCBhAAAHBFCQDGBhAAADCEBdDHAAEAAFEFBcEEA.hABAbFAB..YFDBXFDDUGGAfGHAhAFAIHAA...hAIA...,2,-14,-11,3
CKURJcNIYLBHMXPaFdZQgGeDEAWTOSfVb,TAAASAAA..VADAKADARAFF..JAHB..ICCAhAAALCAAHCGBMCGBaAHFZDEFhAAAGDAAEDHFAAGAfFHAhACAbDEDCECB.NEEA.XGFA...hADA......hCCA...,2,-15,-7,8
DeJdSPFHgNWGVMYUEATQXfCZOacKLBbRI,TAAAQAAA.CACAZADBaACALAFA.RCCADCFAeAFAdDGAFBHDhAAAHEEBNCFA.GGABhAAAMCGBEDCBAAGAODBB.hAGABGHAbEGD.SHGGWEED....hBDA......hCAA...,1,0,-13,13
UgQaKLHdNIBXRFCYbcVPZEWSAJDMTfeGO,MAAAeAAAGADAUAEA.aAFAHAGD.dBBABBFBRDBAFDFBCBHA....hAIAbDBBVEGBZDEBEDGAACIBDIEAhBAA..OEHD.hBDAQGFD.NIAB......hBEA......hCAA...,2,-22,-2,20
KUbZMHGCcNQWXEgOSJFfPTDeIARVaBLdY,RAAAaAAAdADA.KAFAZACB.HAEAGCDBCAHB..QCEBEDHF.SCGHhAGAfEEETFFAhBAAeCCDAAAALFHBhBBAbFAB.MEEB.NICB.XGCA.OFHDhAFA.FGFD.DAIBhAHA...,2,-11,1,12
PEGZMUFISRegKNCOTBLVHfYJdWbcXQDAa,EAAAZAAAMACAFACD.RAEA.eAEA..KBHBOAHDLDDAHCDAJDHFdEAAhAAA...bDGDQFDAhABAACFAaEFB.PFGBhAHAIHBA.NIEB.BCED.fGCEhAIA.WCCD..hCAA...,1,-5,-27,22
VEbRYNeFMAdIOLTgHGZBJPQcaCKfXDSWU,dAAALAAAHADAZABBBAEAQAGCaAFD.KCEADAHBUEEAECAARCDBeCHFhAFAAAIB...ODCDhAIAGDFAJFHBCCHASDCDhABA.bEAD.FFHD...MIEAhACA......hAEA...,1,-9,-18,9
KGCQIVJBWReXZAdfSaYEOUDHNFPcLbMTg,dAAAaAAA.EADADADAHAFA.FCBDLAGB.MAIBTCGAGBBBhBAAQDDAVDEBBBFBhBBARFCBeDADAEBA.SEGAhACAOEDHUGGAcGEAKHEC.CGGBIHAAhADA......hAHA...,1,0,-11,11
GRVBKLHUeJSOPTgAYcNDEMIWbZCFadfQX,...NAAA.EAAA.MADA..bAFAZAEEFBBAdBCA.QCEAhAAARBDFBCFAHCGBeAHHODADhABATEGAAAGADEFBCEED.aFHDGGDBhCAAKGFB..........hCBA......hCCA...,1,-13,-18,5
dDAXCZFMfcaEeLBPNbYTgGHRVSJQUOIWK,ZAAAMAAAaACALAEA.BBBA..bAEDTCDAHAGBRECASAHHhAFAQEGAOCFDhAGAKCCDAAGBFGEAEDBBeDHBhBAANIAB.GFCB.JHFAIHHADIDA..hABA......hAIA...,2,-13,1,14
FJRaXdVQONWBCYHbKPcLeEDGgTZASfUMI,SAAAMAAAFADD.RACF.dAFA..QAECOAHBBBBAHAGBKDDAhAIALDEB.EDGBhAAAGDFAZGAAAAIBfFHAhABAIFBAaCHDXGFDVFDB..CHGA..hAGA......hCAA...,1,-6,-24,18
dQIVZebTBcRUFPXMKWaLNgAOEYfJDCHSG,EAAAJAAAHADBdADA..QAFAZAFAeCCBBCFARCBBFCHD...MCHBhADAaDDALFAAAAGA.hAIAOEEBDDIBGEEAhBAAbFGB....cGED.....hCAA......hCBA...,1,-7,-26,19
DSOHYGTPabNEfULQJZcIVCRMWgBeFXAdK,dAAASAAAHADAGAGA.aCAEEADALDDAZAFBIBHARFAAMDIBhACABBEA.eCCBAAFAOFDAhADATDAA.bDGDfGGAhAIAQEEB.......hBAA......hBCA...,1,-6,-11,5
EWRNDLbHYVCBXAdGIUZScaOPTMJfgeQFK,GAAAZAAAaACA.OADA.MAHBJAFAeBEFQCDA.EDCBRCFALEFAhABAHEFA.CCCDAGCAhAIAdGBAUGGASBFHhAAA.PHEAfHEF...gGCAhCAAWBHH..hCBA...,1,4,-24,28
YVZRAGTILWDfOcXFBMegbNdJKUCSQEHaP,GAAATAAA.LADADACA.OAGDFAEDeAGB..bCDBdCCAKDFAhAAASAHBHEACaDHDVFFBhACAACGB..fDFEhAAA.BDBCMIAAgEGHhBDA.JEDB.CGHA...hCAA...,1,5,-29,34
BQFaRbJTOUKEfNPDGWgCHSZLcVedYIMAX,QAAARAAA.JACETAEA.KAGCEAFA....fBHAhAAADAIBGBGACCCAHCFBhABAZCDBLDCDeDABdDEChADAMEGBADIBFECBbFEDOFGD.....hAAA......hCAA...,2,-18,-9,9
acLHAUCSIEgbeDJWQMZGFVOXBNfRYPKdT,SAAAEAAA.eACHDADAQAFAGAEAOAGFBAHARDDBKDGDhAAAaBCAHCCAAAEB.CCHAIEEAhAAAbFGD.MDGBhCAAZGAA.FEHBNAIA...fFCA..hCBA......hCCA...,1,-4,-25,21
YFZeMQHWGKacIXUbDAOCSBLJEdRfTPNgV,SAAALAAAEAEARACF.....TAGAgAEBFCAAeCEBhABAHBGBGDCAaAGAXCDDhAAAbEAB.AEGBBEHAhABAdCGDfEGAPFDBYFFFZGEAMEIBKGGC.hACA......hAEA...,2,-1,3,4
IfQUSVFMbYWOGLBeaAdZXCRKPHJgENcTD,ZAAARAAAHADBEADE...TAFADAFAQBFA.UCAAFBHDbDAAhAAAOAHDGEEALDDBhABAeDGBAAHAdEHAKFAAgFEHhACAIHHA.SHFA...hABA......hADA...,1,-7,-8,1
FfMTACIUKLPWBaNGcZVQXDgEbOSYedRJH,CAAAKAAALACABACBGADAZAFB..QCCADAFA.EAHFbAFASCHHhAAA.eDABhADARCFAHEFCMEFBACCBIGCAhAAAPEGB.aDDHcFCAXGGA..hCAA......hCBA...,1,-4,-28,24
LVRAaKCSgMYPJIFGWDbcQZdTfHeUNBXOE,aAAASAAA.MADAPADA.FAGDGAGA.DBDAbBBCZCCAhAAA.dECAHCDCeDHHBCHAhAIAEEEBRGDEAEEBCDBA.gEGAhBAAIHHAcGBCTGEA.....hBDA......hBIA...,2,-22,-4,18
WbSYBNTaPDZdJAfXQCRHUMcOFeLIGEVgK,QAAAHAAAMACAFAFDeACAGBDA.EAHBKAFA.bBFABCCCaCDBZDABhAAAACHBCDFA..REGBOFFBhAAALDFB.IEEAhADA.WDHDNIAB.DHAA......hAHA......hAIA...,1,-11,-12,1
fRBXFNJDYEVeIaUTdcQOgWPbHGZKMLCSA,RAAAFAAADADAEADA..eAEAUAGA..dBHAQBEAOCCA...hAAA..gCCBhADAbCFDHFDAKDDDMDHBLHCAhABAADIBXFEA.YFHBaGHB...hAIA......hCAA...,1,-15,-20,5
MCNbLaGAWDSJVFRUgdfTZXKeOEBcPIQYH,SAAAFAAARACF.dADAZAEBKAFAEAGA.BBHA..ICFAhAAAHCFBMDIBCAHBLCHBhABAAEAADECA.UDBA.TEEAhAFAeFFBOFHHQGEB.....hAEA......hBAA...,1,-17,-26,9
bPWJcBNCQdIVZgOMeLDUFRaAGfHYXTEKS,HAAATAAAEADE.SAFB..bACBJAHBBAEA.QAGAhAAAdCADZCEFMDDBeCCDhAGALEGBFCFBADHAGEDAhBIAXGDAKFFCPFHDNDIACHAA.....hAAA......hACA...,2,-10,-4,6
beKETfLYPZGMXDBRNVgaIQdAJOHCScFUW,HAAASAAAFADAUAGAeACHKCAD..EAEALCCAZAGBGCEAMDGBhAAABDDC.REAAgEGAhAAAaDHBdECAAEEA.CGBA..hACA.bGBAfGHA.XGCDhABADFFBIGHA...hAEA...,2,-13,-9,4
XUNdaMTOEeVYLGSPZcHKIQACFfbBDJRgW,FAAABAAARACF...XACAdAEAMAGB..EAFAeAHBLBHBGCGAhAIAZCAAHDEBQCEAhAAAADEBCGGDDFIB.JEEF.gFAAhACA.UGGA.aGDH....hADA......hAFA...,2,-22,-12,10
bBMWNZYRUfLFGgOIPDKEQdTHXaVCAJceS,eAAABAAAMACAZADBRAFALCCDGAEB..OBCBDCHBKDEAdCFDHFCChAAAaCHD.ACIB...SDBDhAAA.bDDCYFFBhABAFFFA.gGABEGHF...hAHA......hAIA...,1,-16,-22,6
dWbQOeIUfJBVLXYZaFSNCTKREMPAHDgcG,HAAADAAAGABBdADAQAFAeAEE.UCABBAHBLBHBZCCAaCEAFCHBhBAACCFDRDDB...EEEBAFAA.hAAA...gFAAhACAbGEA.fFGAXEGA.SFHHhAFA.KGEB.MIAAhAIA..,1,13,-28,41
eJHaPGYCOXbEfMcAFVSLgTUBDdQIRZWKN,SAAATAAA.DADAdACA.RAEAZCDEKAFAeAHHHCGBGEAA.hAAAOECEEBCAMCEBAAEALGFAhAAABCFAQEGAhABANICBaAHF.CFCAbFED.FHAA...gGGGhAHA...hCAA...,2,-11,0,11
eObQfPJdWMTCcNHXLIEgBKZAUDVRaGYSF,DAAARAAAGADAFACD.eAFAQAEA..fBHAdAHAMBBBCCDAhAEAHCFB.LDAAhAAAEDEAKDGAZFFAAAFAaDHDOGBAhBAAbFDB...PHFCTGGA....hABA......hADA...,2,-20,-2,18
MHKIaXQRYfgSWFZGePOdCbcUALNVTDEJB,LAAATAAA.EAEAMACAHAGB.KCAAaAEERCCF.....fAHAhAAASCFDZBDAeDHFhABAdDDAbDEDAAIBDEABBCHAhAHAQGBAgGFAGGDBCEHANCCA....hACA......hAEA...,2,-6,-1,5
gPbITVeCdfHJYAFWaREMUODXQcBZKGSNL,aAAAEAAAUADA..XACDQAFAZAEAGCDBLBCD..hAAAbEEATDFA.eDDHhAIAdFAAHGCAABHARFFAMCIBhCAADAGAKGGDSHDANBIA.IHHA.hAFA......hBAA...,2,-9,3,12
NSCcZEHFVgWMIJTRePYDaKLOUfGXbdAQB,QAAASAAAZACBHACAFAED..gAFBMAGB.TCDAhAAARCGFeDEBDAIBLFDBhAAAfDFAbGFAAAHACDHAEEAAhAEA.IFCA.PFGBaHBG.OHAAhAHA.....hABA...,1,10,-18,28
PHdBTObAUECGRMLWYNceFaIVSfDXKJQgZ,EAAARAAAMADALADA....NAHAFBDDaAGDSBCD.hAAAXCECQDEAhABAZDFEHEAAdFBATFGAhAIAAAEAGFCBcGCDeFHB.......hBFA......hBGA...,1,2,-27,29
OLHFgQSCTJdDBVIREYafePKXMAZGbcNWU,GAAA..bAAANADA.OAEAHAEAQCEBCAHA.dAHABBEAhAAARDGBEEABaCAA.eCEAhABAXEECACIBZDDAUFFBhACALGAASEBBDGGBIHHAfDHEhBEA......hDAA...,1,8,-24,32
DNFKcXbRWeUGATBEaZCfPdOYVLQSJMIHg,EAAAZAAACADBdADA..OAEDLAFA.QCBCMAGBHCAADCFAKAHBhABA..XCGAhAAARCGFeDEBAEIBaDEB..fGFAhACAPEGBSFEHIHAA.FGAA.WHAAhAGA.....hAHA...,1,-7,-27,20
CETJPYGZLcKXefUFSIDRBAVgabOMHNWQd,aAAAMAAAHACB.QAEAEADA.JAHBGAFA.ZBBALDEBhAEAXDDAeBBDFAHFDDHBhBAAADGBbGBCOEHDdFHACGFA.hAHATFBA.cGFA.....hBAA......hBGA...,1,-5,-13,8
HWbdFZIQMJCOTUcSVXBGAeRaKYNDPfLgE,RAAAaAAAKADC..DADALAGBHAECdAHAZBDEMBBB..OCCHUCCA.hBAASCHHBCFDADHAeEDAhBDA..PDFBhAAAEEGAFFHDQFBB.TGGA..hABA......hAIA...,2,-24,-19,5
LfBbgRdVFHWYUPCeNTGEZMJaDQAISXKOc,XAAAOAAALAEABADA.RBBA.dAFAHCEAUDAAeCHHGBGAEDDBZFAAhAFAaAHF.AAIB..KFFAbDCAhAAAFGEH....PFGBhABACGHA.MEIB.DGEB.SFBAhADA.....hAGA...,1,-4,-11,7
TNJdYcfFIWLBOeaZRGUgEDHPKMXbQVCAS,TAAAdAAA..fADAFACALAFAeAEHRCCAGCFA.ECHBhAAAHAGBKEED.bABDQGAAhAGAAAGBSDADYFGBhAHAIDFA.ODHDZFCFDFIBMEEB.hCAACFFAJHEE....hADA...,1,14,-15,29
OXYPUBJQTLIagWcCVDSbNHAKFZRfMdGEe,ZAAARAAAdADAEADE..eAFAOAFA..XBGAUBGBQCAAhABALCCAaDEE..gCDAhACACDHDSFAAhAAAHDFCAAFAFFFAMFFBYFHBBGGA....hABA......hCAA...,1,-8,-22,14
dBESOGfNVPHFATRYbDIZecLgQXaWMKCUJ,RAAADAAAeADELADA.QBBCaAGAKBDAUCGAdAHABCEA.ECGBhAEAGDDA.fCCEhAAAPDDBHFABAFGATGGAhABAbFEA...IHBA...hAFA......hBAA...,1,-16,-18,2
LGCIUHcQRZPEBMDdYFeNgTAOaWbSVXKJf,aAAASAAA.KADALADAGAFACAHAHAGB.RCCAEDFFMCCBdEAAhAEAeCHFTEGAAAAAODABhADAbFCB...XDDAhAFAfGGEUFGB.......hAFA......hAIA...,1,-10,-15,5
LZVgNWQfKMATEHPSRaJdIGYFUCBDbOecX,HAAARAAAdADAGAFAFADABAGADAIBeAHH.LCAAZCCA..VEGBhAAANCEA...QFAAhABAMCFBEDGB.aEEHIGAAhAAACDHBOHBE..XFGA.fGCAhACAAAFB.SGFDhAGA,1,-11,-20,9
TbOEeAXFgCIPMcdYQUDNVaJBfGKWZSLHR,FAAACAAA.MADAdACAQAEA.DAHBaAFE.BBCAGCDAZBEAHDDAhAIARDFF.TEGAhBAAECBBAAIB.XFDA.hAAAIHHAcEAAUGBBNIBB.fEHAhAEA.SGHHhBCA..,2,-26,-11,15
DaEgJeMXWBKfZIdSFVNALUTGRQcPYHObC,TAAARAAAQADC....PACAHAFBbCCCaAFD..EAHBeAHBhAAAMCCBBDGAZDCBdDHAhAAAFEEBAEIBGEEAOFAADFBBhAIAXFGCfGHASHFA.NIAB.hABA......hAFA...,1,1,-4,5
gHNeDKWJIaZUBQROTMYGFfSPEcdCLVbAX,HAAAeAAAKADAJADAZAGBBAFB..RCAA.MAHBGCEAFCCA...SCHHhAAAECFBdEEALEHBhAAAACEB..XGAAhACADAIBaGCBQGFATGFA.....hAGA......hBIA...,1,-17,-19,2
DXaKWfEGPgUJcbVYBSONQdFCTeAIHMLRZ,HAAARAAAZADBDAGAaACAKAFA..EBFAGCCA.UCFAJBHB...bEFAhAAABCCC.ODABhAAAdFAATGGAADFALEEBhABAfHDB..gEGA.VFBAhADASHAAFGHD.hBFA...,1,-1,-21,20
YgfeQFWHaNTXMRAKILbCEBGcPSZVJdUDO,LAAAEAAAGACASADHZAEAdCFA.OAFA..fCBEhAAAeBEHQBGBhABAHDGBaAGATCAAREDBACIBbFABBDFAhACA.PDHDUGGB.DDDB.FFFB...hAFA......hBCA...,2,-5,6,11
TJUDVeEHWGcRfBCYgOAXKbLMQNdSIZaPF,KAAAMAAAdACAZABEFAEAUAFA..eAGHHCCAGBDARDFABAHA.CECD.OBHDhAAA.AEGALFCAhAIAQFFB.SFBDhBAAaFHB.TGDADGGB.....hCAA......hCBA...,2,-27,-17,10
WaRDAIScGJVPLZEeFBgdMbTNfXCHYQKUO,SAAAGAAAJADALAGBEADA.BCDAdAGAMAIB.bBCATDEAhAAA..XDAAhAAAHDBBQEGAhACAODDBREFAADAAIHHAPFEBFGBBfGCAhAIAKGHB......hBAA...,1,3,-20,23
RdHZAbXMJKBeDSTCcGgaUWLEFPVfYIQON,MAAABAAAeACADAEA.CAFA.GAGA.aBBALAHB.EBGFFBEBhAIA.VDEBICAAhAAAQGBARCCAHEEAACCBXGGAhBAASEGETGDAgFCB.UGGAhACA.....hBGA...,2,-21,-6,15
FUXHCKOgMZJfQRBEYIeLdcPSaVAGDbNTW,GAAADAAA..TACAFADAHAFB.OAHFZAEBQAGAhAEAECDBeDBHdDFDSBBDhBAAAAAB.bCFDUFFA.KHAAhACAMDDBRECF.BDHA.LEEDaEHD.WECDhBIA.CGGA....hAHA...,1,0,-10,10
IVKSMODEWGcPbFBdTAQJeNYRgZLaHCUfX,eAAARAAAZADBHAFACADA.UCFB..XAEDKDAA.MAHBEEEBGGEBhAAA..bCCCdEGDhABAAAAAQDFDhAGANIAB.LGBA.aFGC.IHHAhAIA......hBGA...,2,-25,-12,13
CZcGBEJMAPHDONTRLfgWFXbKYQaSUVedI,HAAAOAAARADFLAFB..fADAFAHBKCADaCCHSAEHhAGAeCHF.dAHAZEEBGBFAhBAAEFCAAEIBDGGATDDAhBBA.XEGD.YFFF..hBHA......hCAA...,1,-12,-20,8
AGQZBDXfgOWIaePTLUSHJYKERVMNcdCbF,ZAAAXAAAOACA..aADAeAFA.LCCAHAFBKAHBRCFFMBIBhABAdBDAbDCAGECA.QFFBhAGAfDGAIHEAhCAATFGASHAA...hCBA......hCEA...,1,-7,-11,4
SagIRWQVXdBMFPZeGCNKbAHEOcJYDTfLU,HAAAEAAA.OACAJACB.DAGALAEAUBFA.aAHDRCCB..QEFAhAAAdCEAMCGBZDGBeECDGFABhAAAKBHBAEIB...YFFFhAFASFEDIHHAWHFA.BDDC.hCAA......hCCA...,2,-16,-7,9
XOWDNUBMeLQCPKcHJYdSfVaFIAZgRTbEG,RAAAEAAAGADA.OAFADADABAFA.eAGHLBFBQBCAhAAAKBHBHDAAdCEA.SDGHhAAAaBHDACBBZEFB.bFDBNEIA.MFIBhABA.CCCD..........hAIA......hBCA...,1,1,-30,31
KgSOYGENDbLHWJeVQPIZFCdafcRTABMXU,MAAAKAAAOACAGACB.EAGEDAGA.HBCAeBBBQBFCZCFAdDDAaEGBhAFARDFAABHABFEA.XGCChAIASDED.bFGDhAAALFHB........hBAA......hCAA...,1,-7,-21,14
LbFPIRdXWGUNECTeQaHDfgSYcOAZKVMJB,ZAAAMAAALADBFADD.RAFAdCAAGAFA.EAHBeCCDHBBBDCFBSDEBhAFAOCGD.ABBBKDHBhAIABEED..IFBAhBAAXFAAUGFACFGDaFHDfHDF..hBFAgGDA.hCAA...,2,-20,-11,9
GVaWcEdKPDONFMgBTXeRbSYfHIUCLQZJA,aAAAEAAAdADA..DADAFAFAMAGBBBCC..eAHBRBEF..SAHHhAAAHBBCCBEBZDEAADDBGDFAhCAAVFDAKGHBODHF.hAIA..NEEA..........hBAA......hBBA...,2,-26,-23,3
TRHfYUbAVOaMKSdIEXePQNBJGCgLcFDWZ,aAAAMAAA.dAEAEADA..eAGBQAFABAHBGBBALBHBDCGBZDEFhBAAHCCA.fDAAhADAbEGD.ABBBKDFBSEBDhBBAXECANCIA.CFFDFFHB.WHDA..hAIA......hBAA...,1,-5,-16,11
LEKNaQUVGCAWIMBDZbYeTJgPHSOFcXfdR,MAAAZAAAeACE..TADAJAFAHCCC.FCFAfAFBLEFAEGEAhABAaAHDUCBA.GCFAhAHAACIBBGHADDDA.bFCAhBAA...PEHDOHEE.....hBBA......hBCA...,1,-12,-19,7
KPdDcNAEWbIGefYLCgRQMZBVSJTOXUHFa,EAAA..bAAAeACALAEARAFAZCCABCGA..SAHHhAAAOCHDHDAAaCAAdCEADEEBAFCAGDFAhABACFFA.MDDBTGAAhAAAFDHFKFAA.cGCDIGHAfHGFhACAYHFA....hADA...,2,-21,4,25
IMCTfPdYRaAVJgHbGNOLSQcBWKeDUFXZE,VAAAHAAAGADA.LAFAQADCBCADeAFEFCCHECFAMBGBhAAATDGAdCHARDDBACFBJEFF.hAIA.bFGBSFHHhAAA.KGAADGGB........hCAA......hDAA...,2,-16,-4,12
MdYUgCAXDTZIHNWGPaScBEVfRebLOJQFK,TAAAHAAAGADA.aAFABACB.EAEARBFFeBHHLAHBQCABhAAAMBGBdCCAUFBAABHBZCDBhAAAIFEA.PEHDhACASEAB.fEGA.hADAbFEDFGFDKGHBCHHDDIAA.hAEA...,2,-23,21,44
aIBGDTHfOZFJALUSVgKcNbdYRMEeCWXPQ,LAAASAAAKAEA....bACDRAGFECAAeAEACCDA...XBFAhAAAaCEDGDFAHDEAZEAAhABAAAEAgECBhABAdEHA.MAIBQGAADEIBTGFA...hACA......hAEA...,2,-15,3,18
PAZLYBHSeWGDRFJONfVMaEQdIUCgTXbKc,ZAAALAAAHAEAeAHHGADARCAA.OAFA..fCEEhABAaBFDEBHFdCAACDGD...TEFAhABAbEAAKEEDACCBBDHADACAFEHDhAGAVFBAMFGB.IHAA...XGCChAHAPFHD...hACA...,1,7,-12,19
aFSARQcGJCDeMPBIUYObNEHdTfWgVXLZK,RAAAGAAADADA.eADAMAGBBAGA.UCDAOAHBEBHF.HBDB.dCCChAAATEFA.fEAEhAAAgDGALEHBhACAaEFHABFB.QFDCCFHAIHHANIAB...hADA......hAEA...,2,-23,-7,16
QWIeRDfbAJSCYBLZGKcEPgNHFdTUXMOaV,CAAALAAAGACAKAEAEAEA......gAGAHAGBdCAATCEAhAAAMCAAOCDCQEEBhACAeCHFREAADDIBAEAASEEAhABAZGAAPFHBFHEAaEHDIHAA.hAEAfGGE.hAGA...,1,-4,-5,1
FcNEaTKDSbJfgIBRUHVOLACGYeMWPXQdZ,GAAAeAAAMAEA..XADAZAFEFBCDECEBaAGADBGB..SCGAhAAAJBHF.fEBAhABABCDAHDEALEEAhBEAAAABCDCDPEABdGCATGEAbFGB.gGGBhCAA....hCBA...,2,-16,-8,8
eJWQHTgCLYKdGaMfRDEFPUcSZBIbONAXV,eAAAQAAAHADATBGALADA.dAHAaAGARCBAECFBFCCB..UDEAhAAAZDGBBEAAODHDAAEAXECAhAAAVFAA.JHBACGEAKGGAhABAMFFB...DGIB......hBCA......hBHA...,1,1,-9,10
SHdTZUDOYVWLXaKeGbcCPNQIERfABFJMg,FAAAMAAAHACBZABEDAFAOAEA...VBGBLBFA.aCCAeBEHhAIAGDDBCEBA.QFGAhAIAREFBAEIBBFEDSHFAhBAAdGBATGDA.........hBAA......hBGA...,1,-19,-20,1
fSTPGBYdWgaZCLAXEJFQKObVMUceIDHNR,EAAAQAAAKACA.OACCMAEA..eAHFHAFBRBDA.TCDAGDDBhAAAdBHAaDHDZEAA.AAHAFEFAhAAAbGBA.UGGA.DFFBSFGDhBGABDCD.WCCD.....hAEA......hAFA...,2,-7,-6,1
RXAgOBeSWfPTFbHEDYUGZKCLMaIJQdNVc,BAAAeAAA.SACA..fADATAFAHCAAEAFADAIBhAAAGCEAZBEELDDAhABAaAHDQDGCdDHAcFAAhAFAAACAOECBFFDAbGFAKFABMFIB.IGGAhAAA.NIDB....hCAA...,1,7,-12,19
DMGZPfcgYRLeUQCABNOJVTHFaSbEdKWXI,OAAATAAA.HADAFACA.aAFA..EAFAdCCAKAHB..XBGAhAIAMCCAZCDE..fCFEhBAAgDFARDGFeEDFhBBAQFAAAFFBBGGDVFGBWFHHDDIB.PHCChAAA......hAFA...,1,0,-11,11
QDMeRTOBFPaAEIZgScKCNWfLJHXbdGVUY,EAAAZAAASACEKACA..CAEB...fAFAHAFBdBHAGCCAhAAAUCCBQBGAhABAeEFARFDFTGGAFDFBAAHAgEGAhAFA.WHEAJHAA.....hAHA......hAIA...,1,-12,-15,3
bGUcHNMTQIZJfBRFKDCLaPOdXVYgWAEeS,EAAAeAAAGACAHADAMAFAQAEAZBFEBCCARAGBDCBBLDEA.hAAAaDHDdDFA.XEAAhAEAgFFBAAIBbEDDUGDAhAAATFGAfHBF......hABA......hBHA...,1,2,-7,9
QCRTIeHbFEDVGYPUAgNaXJKMdSZLBcWOf,aAAAKAAAdACAZACB.LAEABAEA..OAFDQCDARCGF.eAHHhAAAHDEBEDFEGECA.hAFAPFHDADIBXFFAhAGAMBBBSAHBfGCA.CHBA.....hBAA......hBHA...,1,-13,-17,4
DHRCSIdgJGfALaEWXQOTFPMYcbeUVZBKN,EAAAQAAAFACD.MADA..bADDeAFAZAFAKCFCHBDA.RCFASDBAhAAAdDHAGEEAAAGAaEEBhBCA.OEHB.PFFBhBDA..........hBIA......hCAA...,2,-31,-4,27
gLXCbROQaNKFdfJHIMeTABDSWZUcYVEPG,SAAAZAAAUAEA...VADAEAGAGCAALAGBCBHA.RCCBaCHDFDDA.hABA.dDGAHDAB.eEFBhAAAAACADDIB..cGCAhABA..gFFGbFGD....hBEA......hCAA...,1,4,-31,35
AOeJHaFGPRNcdUQDYbLgSEfBMVWZXCIKT,eAAAHAAAGADARADA.dAFBQAGCDAIBLCGBECCBMCFBZCAACDFAKFDAhAAAAAAAOCHD.aDGBhAEAFFHD...cGBAhACAbEDDSFGH......hAIA......hCAA...,2,-15,-13,2
YJHDPETeLNSOGUWdMaCgcXBfKVFRbQZAI,JAAAHAAA.EADEeADELAFB.OAHBGAGAdCADaBCECCEC.XCDAhAGAKDCAREFAZGEA.ACIBDGIBhAAATEFA.UGDAMIAAhACABFHA..........hAIA......hBAA...,2,-27,-5,22
SFCOXIgJUKWePEZDVfBATdRMLNaGYbHQc,RAAAMAAALADBGACBHAFAQAGCFCFHOCCH..XBBChAFAJCHB.KCEAeEEBECHFZDDAhAIADFABBGGAAEIBdFFDaGHDhBAAbFAD....CHCB........hCAA......hDAA...,2,-13,-6,7
bHLCgOKIGNAZeEFQYVJXURWBcTSdfMaDP,EAAAQAAA.JACERACABAFB.TBGAdAGAaBDE..DCCBHDDAhAAALDABOBHDGDDAhAAAADFAeEGFFCFHXGBAhAIAUFGASHAAMFFBCHGA.KHEA...hBGA......hCAA...,1,-11,-12,1
QdeEXbcLMBGfSCgOZAKDIYJFNPURHTVWa,DAAAJAAA.FACDUADAHAEA.....TCDAaAFEdCGA..EBHF.hAGA.XCCCLEAAhAEAGDEACDGDZEFAAAGAKEHBIGCAhAIA.YBBFNIAB....hBAA......hCAA...,1,-22,-36,14
dMUWKDICETOLgHNYeBScGVZQfJFXbPRAa,dAAAMAAAKADADAEA..EAFELAHBHCACeAHHSBBAGCFAZECBhACAQBEAFEHD.bDDChBAAACFBaFFH..IEBAhBBAOHAC...gEFABHHA.fFHAhBCA.XGCAhBEA,1,-13,-14,1
DCKOSHNfZgPdaMXUBRYTbcWVALeFEQIJG,eAAAEAAA.QADAGACAKAEAHAFAZAGBdCFCaCCBMCHBBCBDREAATDDAhAAA...bDFDcDGDhAAAAAHAFFDH..DCIBSEDHhAEAfGHAXFFC.UGABhAGA......hBCA...,1,10,-13,23
IVTDeBZPgaMAKJERWUYbfQXFNOLHCGScd,EAAARAAAUADA....bACAQAFA.FCCHLAGBhAAAHDFAGEDAdCCATEAAhADAeFHBBAHAZDFAaEDDAAAAKGGDhCAAYFFA.XGBDCCHA.SHFAhAEA....hAIA...,2,-12,-9,3
eNgIXFEHGTbOYcPCdKJWDaAUfSVLQRBZM,SAAALAAARADFZAFBeACH...IAEAEAHFHCAA.bDEAOAFDhAAA..PFAAhABAdAHAKCEDDCIBADDBfDGAhABAQFFCMFIBXFEC.FFHB.YHBAhBHAcFCD...hACA...,2,-15,-9,6
EJYHSOUWNaRIgBMVdeCcLQAFXZbTDPfKG,ZAAATAAADACAKAEA..EACEHAGBUAEA..aCCCRAGBBCCA.dDEAhAAAeCEHLEGBAAIBXDFDhABAfGDAGECAhAGASGFDOEHDIHEAMEIB.CGGD..hAIA......hBIA...,1,-11,-19,8
PfTVWbLdAFHKQNXcgZCMUEGBeDSYJIORa,HAAAQAAAXADBZACBMAFAEAFA.eBEASAHH.ICCAhAAARCFAaDEH.TCEAhACAbEBBABIBKEGA.NIEB.CDGAGGCBhBHABGGA.DDIB.OFFC...hAAA......hBCA...,1,4,-14,18
ESgZfKBMOUXDILcHCQTbRAGNdeaFJWPYV,dAAAeAAAaADAFADD...JAFA..PAGBEBFB.ZBDFBCCDUEGADCHBhAAALAHBHDEBQGEBhABARCAAACFB..WFFDhACASDHH.KHGA.MEDBIHHAhBAA.....hAIA...,1,-17,-24,7
PTcHbGCOBVJWagLSKIAFYdNeEfXZURQMD,dAAAEAAAZACBRADADAGA....TAEAHBFCGCABBAGB.JDEBaAHDLEAAhACAKCEDABCB.FDGHeCFHhAAAUGGAMDHB.bGFAhCAA............hCBA......hDAA...,1,-18,-24,6
FHGfcgAKEPbDCZNUdaBIQJWVMTXLROSYe,EAAADAAAZABEdADABAFA..QAFA.VCCAMAHBLBHBhADARCBBSCGDFDFDHFAAhAFAGDDA.fFAAhAAAAFCAbFGDCHDA.aDHD.IGFA..hAFA......hAIA...,2,-32,-9,23
SGEJWVXMNIDcYgABLbUdCZHFQPeKfROTa,LAAAdAAAHADAQAGCeADHRAFA.aCAEECAA...VCEBMCFBhACADCHB..gCGAhADAAAFABEHACFGDFGHDfDCAhAFA.TFGA.GEDA..hAIA......hBAA...,2,-29,-1,28
FbLcMBJYNWGVASCPOeafKRTUdHZXDIQgE,CAAAeAAAKACA.RADA..dAGAHAEBZCCA.DAGA..QDGAEBGELCAAhAAAMEAABDED.JDGBNEEA.hAAAGEAAAAIB.OEHDhACAaFCBTFFA.IHHAbGDC...hAEA......hBIA...,2,-18,-12,6
DMdYaTJbUBCfRZVScIKHQgWePGXFAENLO,EAAALAAADADA.dAEA.aAGATAFA.UBCACBGARCAAZCFE..SAHBhAAAKEBAHEDBQFFChABAeCEGGEEAACAAMEIBhACAYDHBBGBAfHCB.IHHAhCAAWHEA...hBEA...,1,-12,-13,1
GZWUIPcAHDJREQOLgdXKYeNfFCTMabBSV,HAAARAAAEADE.LADB.dAFAKAFCeAHBFAHDMCCAaCACBCGAGCEBhAAAZDCEUEGA.IHHAhAAAADDBQEEC.hACAXGGAfFBECEHASHEGWFFDDIAA.hAIA......hBFA...,1,-7,-18,11
ZeWILMQRAgFPHabDCSENdOKJGcYBfTVXU,FAAAHAAADADAEADE.dAFAKAFAGBGABAHB.TCCA..XBCAhBAAeCABLECARCEF.hBDAAAHAaEGHSCGBhCAAOFHD.JEGF.....YDDF.hAAA......hACA...,2,-41,-2,39
ZgAFETfYVcKPaSNIWdBRUbXJHQGOeCLDM,EAAATAAA..VACAKACC....aAEDSAFB.IAHAhAAAdAGARCCBbCFAHCDChCAAGEBAeCCDLEFBhAAAZCGBADIBfEEEPEHB.BFHA.XGEAhCBA....hDAA...,2,-14,-5,9
dbYVSAeNgBXTcZWFHEOILPaMGRJDCKQfU,eAAABAAA..TACAZADBHAFA.EBCFLAEBaCEDGCGARAGBCCAAQDFDhAAAdFFA.VECBhACAAAAAXGDB.hAGAFHAAOEHDMFIB.KCCD.fGFAhAIA......hBIA...,1,2,-17,19
WDZRfeBEHXcbSAVQCaLKUFOIPNTgGdMYJ,QAAAaAAALADAFACE..OAGD..IAFATCCAdCEAhAEAMAHBJDGFZCDARFAAeFFBhAFAHECAbEGDAAIB.KGCDNBBA.hBAAgFEA..YFHBDAIB.hAAA......hCAA...,2,-14,-1,13
dDcNgWbSGJMELOKHZYTFReAfXPIBaUCVQ,XAAABAAAaACA.UADA..QAFAdAGADAIB...gBCBhAAAbDBA.GCEAhAFAEDFALEHBHDGBZGDAhAIATFBAeCCDABHAfFFACHHA.NIDB..hCAA......hCBA...,2,-17,-7,10
ZEGWRMNIXABCFJPSedYVHOcQKUbTaLfgD,FAAASAAAeACHdAEAHACB.QAEAKAGAUCGA.aAGELDDBhAGADCHBEDEAREAAMDFB..hAIAXEFDAEBACFHA.PHAAhAAAOGFC.....cEBDfGHAhABA....hAEA...,2,-24,-9,15
BCUaJAgXWFScDHfQLIKROdGeEVbNTZPMY,XAAASAAAHADALADARAGF.GAGAECDB..VDAAbCCAZEAAhAAAMCIBBEEDUEFAAAIBFEGHhABADFABQFCAhAAAOFHDNIDB.PHFA.aGAD.....hAEA......hAFA...,1,13,-12,25
XfRYSdEBbOceWCGaLUMVKFZDINJHgQTPA,RAAAdAAAEADEOADA..eAFEGAGALCCAMBDBFBEHZCFBDCIB.hACAJECBHDFB.TGBAhAIAAAAAXEGDSCBHhBAABEEC...cFECaGBHKHDAIHHAhBCA......hBGA...,2,-17,-15,2
YUBTNEPGeKObXMQdDgSIcAHJLfZaRCVFW,HAAALAAAaACARAEFFAEA.UCAABAGB.EBHFeAGH.KCDAOCCBhAAA.MCGBdDHASEBAhABAADEBZEGBCFEA.VEEBhACA..WFHH.NIAB.......hAIA......hCAA...,1,-17,-27,10
BGIJcSCLDHbUTKEAWXgPZaYdFONeRMfVQ,XAAAZAAAdAEAOAGBRADA..MAHBQCAAGCEA..IDAAhAAASAHBLDCBhABAHCGBbDDBTEGAAACAgEBAhABAaEAEFGABfGDABFFACFHADIDAEGGB.hBEA......hCAA...,1,6,-9,15
WXHKOSRcUVYDFABCMZNLGbgJPafETQeId,MAAAZAAAGAEA.JAHBaACE.EAFA.eAHFdCAAHDDB.SCCDhABARCCAVDFBFFAAAADACAGC.hAFALEHBbFCD..hACAfFHATGEA.WBBDODGH..hBEAYEEF..hBAA...,2,-17,-3,14
XBZPAUISCQTDgRfaMWeJHdVKbFOcLYGNE,SAAATAAA.RACF.aACA..eAEEHAEBdAHAKAGAOBEDLCCBhAAAGDFAECGAZEDBAAAACDHAQECAhCAAfDBAMDIBhAGAJFHBFGCHNIABBFFA.IHFA.hCBA......hCEA...,2,-8,7,15
PgUTdKNLSbAaHIBYXQGFVfEOJWDMZcCeR,HAAABAAAQACAGADAFAFAEBHFOAECDCABZDABeAHH..RCFBUFFBhAAAdCAALCCAADDB.hACAaCFDXFBDVEGBfEEEhAAAMDIB.CGAA.......hACA......hAGA...,1,-1,-15,14
BTQHDYRIWJOAagPEfCUSVFeNLXGbdcMZK,aAAAEAAAUADA..FADAeAFALAGBGCBAdBBDZDDBBBFAHDFARCDB.hAIAICHAOCHDAEGB.hAAA.fFFEhAGASFDANIBB.XGGAMFHB......hBAA......hBIA...,2,-31,7,38
dDLTOMRIAKPCXaUSFBEJQVNHfWgZYcGbe,CAAAaAAAFACABADA..EAFAQAFA.HCCAfAHAhAAAZDAFGDFAeBCBdBHATCEAhAFARFCFABBBKFHBUECB.SCHHhCAANIEB.gFFAYFAF.DFIBhCBA.OHDC..hCEA...,2,-22,1,23
HWdNLeUaRKGMTIQAfcbVPgECYSJBXOFZD,...bAAAgAAA.EADASAEABAFAFAHBHCCAdAHAeCABhAAARCFFGDAAMCCBTDDAhABAAAAAfDHAPCGBhACACEEDXFCDZFAADDIBLHBAaFGEIHHAhADAQFFB...hCCA...,2,-2,12,14
SECTbRcQLgJZFKdOGeNUMDBAWXaIfHVPY,aAAAHAAA.VAEA..SACHEBHF.TAEARCAALDEBhAAAZAGBdDDAeDGBMBBBAACAXEAAhAEAfDHACGFAbECDhAHAQEAB.FFED.OGAENDIABHHDIGGAhAEA...hAIA...,2,-4,3,7
WedQPGSUKLVAMNCDRJOHXTaIFBbcEfZYg,MAAADAAARABAHAEB..aACEBAGAEAFAZBBA....gCGAhAEAeAHFdCFAGEGAhAFAKCDDAAIBCEEA.XEECFEHD.hAGA.bGFCYFDF......hBAA......hCAA...,1,-16,-26,10
GZTJWUeFYagMKdfDPBNOREcAHIQbXSLCV,HAAAQAAASACELADAGAEAZAGBTCDAUBGAeCCBaCHD.hAAAMEEBdEAA.DAGABDCDhAEARFFAAEIB.bEFCCHEA...VFCBhAFA.FGGA.........hAAA......hCAA...,2,-13,9,22
gYLXCEPJFHMWIQdRcUVDOZeNASabGKfBT,aAAAGAAABADA..TADALAFA.EBBBFAFAHCEAMAIBQDAChADARCDAVDGB.ZECBAAABKDCDhACAfEFA.hADAXEGDCFEAPHCAIGAAdGGD.DCGA.hBCANIDB......hCDA...,1,2,-8,10
VKMTAJIUDGZFOgdcNbHeaQXWCLRPSBYfE,UAAAZAAAOACAdADA......bAEDHAFA.eCCAaAGAQCGChBAACCGARDEBBDHAEFHBMDBBhBCAAAHADGEBGEEA.hABAFDDH..cGGCXGBA.PEHDhBDA......hBGA...,1,-11,-21,10
LMNODGRHAXfFJeZBVISTPcdCEQabKgUYW,FAAAeAAAZACBBADA..SAEATAFAdAHAEAHB..aCCAKCEAUDDBhAAALCGB.MDIBhAFADDGAHEFBAECA.fEHEhABAIEEACGEAbFAB..gGGBhAIANIEB.....hAFA...,2,-23,-15,8
FdDbVRUOJfZAWaePMGgKBEXSHLICYcTNQ,eAAAGAAABADAEADAHAFALAFACCDA..TCGAQCCA.hAAAdCFAbCEDRDGFOFDBhAAAZFGBAAHAaDAHMFFBKDCDSGEAhACAIGAA..cGGCDICA....hABA......hAGA...,2,-21,8,29
IWdQRLgJYTaUfEcSCFBeKVPbXGMNDAZHO,HAAAOAAAdADARADALAGBJAFA..aBEDEBBB..CCADBCCDeCEFKDCBhAEA..VCGBbEGBGGCBhAIAMEEB.ABIBIFFAhBAAQFFC.gGCD..hAAA......hACA...,2,-27,-4,23
CESXLfDKNFPJTcWaVBUbZYAOgHQRedMGI,HAAARAAAeADEGADA.EAFALAGBKAHBFCAH.TBDA.aCCHBCCDhAAAZDFA.ACGAQDFAhACAdFFAMAIBCGCA.fFAAhADADEEB.PFDBWFGH.bFFA.OHEChAFA......hDFA...,1,1,-14,15
TOKYbdUCWFJgQAPVMLaeNfDHIEGcBZSXR,MAAAeAAADAEAHACCGAGAZAFBRCCB..KAHBdBDAUEFAFCFH..QFBAhAAAABBBLFABaCCB..hABAIHCAEEEBSEGAhAIAOEHF.CGGA.........hBFA......hBGA...,2,-17,-14,3
dTFgCUcDOIAfHZGVXPLeREaYNSQWJKBbM,HAAAGAAAXADBeADAEAGA..aAFDSBGAQCABKCDAbAGDhAAAdDGA.FDCHCDCADAIBAAABZEEBhACALEEA.RFBAYEHBhACAJEAFMDIBTGGAgGEA..hBFAcFCD...hCDA...,1,6,1,5
KWbYSREaMQDVAPdfcTgOFXGJNLUBHeZIC,dAAATAAAFADAGAFA.LAHBHACBeAEAZCAEKCEDbBFARDEA.ECABhAAAaEFCDEAB..AEHA.fEDEhACAOFHDJHBABEHAhAEA.CFGDSFAH.MHDA.hACA......hBAA...,2,-24,12,36
KdFeQHBgUANMfcOVXYGEZPWaJLCbRITDS,MAAAOAAA..XACAEADAZAFB..aAHDLAFA.RCCBTCEAhAGAKBBDeBEFHCGBBDCAhBAAABBB.fDGAhBHAVFFBPHAACEHADEFB.dGGA.......hAHA......hBAA...,1,-9,-21,12
KRAFQOXeTHWMgYBJNCVPdSfcULaEDbIZG,QAAAeAAAHADAMAFABACACAEAdBHA.SCCBUAGALCDBhAAAECEADDGBZCFA.REABADDBXEEDhAAA..TEGAhAEAYEHBVFEBfHCB.aHEAIHHAhBGA...hABA...,1,-10,-17,7
DFIgUeEcZMWdCQBXYLHPJTSfaGKROAVNb,VAAADAAAFACD..UADAEAEA.ZAFB..dAHAQDDCBBFALDDAhAEAHCGB..JFBBTEGAhBAAaFFB.RFDA.AAIB..IGGAhAAAeBBDMIDA.CDHB......hBFA......hBHA...,1,-20,-22,2
eQLCfKPZgHIOUdaRYSAXTDGMbBVNEcFWJ,TAAAGAAAMADA.BAGAEACEFAEA.eAGHLBFAKCCAZCEFHCDAhAAAOBHDaDBDRDFAAEEBDEHBhAAAbFFA....NIABJHFAhACAQGEA.fGHA..hAIA......hCAA...,2,-21,1,22
cKTBVgDQWHYOFUIJAPCESaRLZGMNeXbdf,EAAARAAAGADA.eAFAdADAKAFABBHADAIBHCFAFCBB.UDAAACFA.CEFD.LDDAhAAAZEGB.MCHBhAFAXGAA..bFDAhAHA.....fFHA..hBCA......hBDA...,2,-37,-16,21
CXUdeHINESMPWFZgQKJbcYaDfAGTLOVBR,GAAATAAA.LADABACBRADF.XAGD.eCDBHAFBECEEMAIBhAAAFDGDZEAAQDDBhAFAbFED.aDGDAAABCGGAdGEA.hACASEHH.gGGG.hAEAKHAA.....hAFA...,2,-6,0,6
dGNXcJYFOHBSRTLZPCVQeAgDUWaKbMfEI,DAAAaAAA.MADA..EADAGAGA..XAFAJBBAFCEDHDFBhAIARCCAZCFFCBBD..eDDDAAIBUGAAhADAKEBB...bEEDdGBDhBAA.cFGDBCHASGGB..hAGA......hBAA...,1,-13,-24,11
YUTceEQbWSIOZNAHCDGVFBLPJfKMdgaXR,HAAAGAAABADBLADAJAFA.MAHBdCAD.aCDARBEBUCGA..eCFHhAAAEDCA.bDDD.SCHHhACAZEEAAFIBDGGB.FEAH.hAAAKFHB.XGFD......hAEA......hAFA...,2,-30,-4,26
REXdVLBWHFeZJTQYOCDgSKPGfcIaAUbMN,MAAAEAAAdADALAEAHAFAeBCDZBBA..TCFAQCED.CCHASDBDhAAAGDBAfDDEhAFAaEFCAAHAUGGAREGBBBHAhAGAFFAHOHCAKFEA.......hAIA......hBAA...,2,-15,7,22
fOJAeRYIDKZPQgWcGSNdbXTHFMCBUaVLE,RAAADAAAZADBQACA..gAFAGAEBdCFD.TDDAhAFAHCFCMCCBBBBDaCHDEDABOEEBhAAAAAHAeEGBKFFDcFGAhABASGHH..bGAA.CGGD...hADA......hAGA...,2,-11,-10,1
CKbYdIJGZLRMNDfPgcBTHXaAQUOFeESVW,QAAAFAAAEADA.SACACAFA.KAFAdAHAGCDARCCAMCGBDAIBhAAA....fDAAhADAgCFBTFCAhBAAHDABACDBUFFBeDHH.bFFDIHBALHAAhADANDIABEEC.aHEC.hAFA...,1,-1,-15,14
LeAXGRQJHCdIMPDfObFBUTVEaSNYWZKcg,RAAAHAAAdADA.MACADAFA.OAEEBAHA..UCFAEBHF..aCCA.SCEHhAAA.NCGAZEGBhAHAKCCDLDED.hAIAAAAAGGBB.QGGA.CFBA.hBFA......hBGA...,2,-36,-13,23
KNcWODBPLRSJQZMdgTFeaIfGUHYbVCEAX,KAAA..NAAA.OACABAFARAGFQAFA.dBHATBBAFBCDeCEBhAAAaBDDGCEAHEFBVFCBhAIAACIB..XDADhABADEIBLHFAZEGBMFIB.fGDAhACA......hADA...,1,-1,-21,20
YOIDKMFQUJTCgERdHXZaVBWcAfPGNLSeb,GAAALAAAeADAOADDKAGAFCDAUAFA..CCGA.RCAAHDEAZDDABDHAhAAAAAIB....fEHAhABASDADbFBADFFBhACA.MFIBQGFCTGCAEGGBaHBA...hACA......hBFA...,2,-16,-12,4
MEYXgSURTfFZGAecOPDKLbQJWaNBHIVCd,eAAAOAAAKADALAEA.QBBBaAFAHBECCCCAEBHF.XCEAhAFASBHH.RDEBTGGAhAAAZECAADDBDDIBJEDFBEGAhAGA.dGGAMIAA.......hAIA......hBAA...,1,-14,-15,1
FMOcYfTBPRbUXJEKSeDQHNgIGadVZCLAW,MAAAOAAA....fADATADARAFFUDCAEAFA..eAHFhAFAHCGBIBBAdEEAZFAAAAHAhAFAFCDDBBBDXCFDhBAASFHHQFCAgGFFaEGECFFD...hCAA......hCFA...,2,-16,-8,8
dOeUJEFbNWQfDVZHKAgXIBPRGYMcTLaSC,XAAABAAARACAGAFA..MADALAHBaAFEdBDAeCAB.ECCBhAAAbBFAQECBhACA.DEHBHDEAAEIBgFAGhADAIFGAcDCCTFEAOHBEFGDAfGHAhAAAKGHB.SHDGhABA,2,-10,-6,4
HUXcNFeAWCBITJZKfQVDGRMOSEbLYgdPa,BAAATAAAZACA.QAGAGACARAEAMAIB..ECCALCGBhAAAdDAAHCECXCAChACAFDHDAAEACEEAKFGDDDFBbEAD.gFGAhAEAaGAA.cGDANIBB..IHHAhAAA....hADA...,2,-22,11,33
BfETHLFGPNQbaIWXJgVMUKcedRAOCZYSD,ZAAADAAAEACAHAEA.GCAAQAEAaAGA..XCCAVCCAMAHBhAIAKCFAeCHH.AACACEFABBBDhBAALHCAFDFDbEGDIGGAhABAJGBA.........hBGA......hBIA...,1,0,-23,23
OZSJeMVLAfXQPFRWNDGadIUCEHgbcTYBK,QAAARAAADADAGAEBdADA.CAFA.HCCA...bCGDTBGA.hAAAKCEAZECAeDBBMHAAAAHAXDDChAAAFGEHaGGA.EDHFhAFA.....gFFBBHHD.SGEBhBCA..hBDA...,2,-23,-7,16
AfZBLgDeMHFCdYERJKOPTcXIWSNaUbVQG,ZAAALAAAeACEHAFBdAEARAGBKCAAOAHF...TCDAXCCDhABASCCDaCFD.bDGDhABAGEGABEFAMFAAhAFACEBDEFDAJGAAIHAA.NIEB......hACA......hAGA...,1,7,-19,26
ORJHYgQLXVMTNIBWFCUEKabcefZDdGAPS,OAAAHAAAQADCLAEAMAIBTAGABBBDCCADKCCD..bBDCeCFBhAAA.ZDGBGCGAhAFAAAFAREDB.gDEDhAGAXGCDIHHAFGDAEGGB.......hBAA......hCAA...,2,-12,5,17
FDEIceaGZMJHfUOLYdCAKgXVQWbBRPSTN,XAAAQAAABADARACA..SAFBFAFAEBEF.eAHBZCFBHDAAhAAAOCDCdDHAACHBKDAAVFDBhABA..bEEA.TFCAhAAADAIBaGGAGGEB.MIAA....hADA......hAIA...,2,-12,-1,11
SRQDJFaNUWfZLHgPTEdOeGCIVXYBcbMAK,RAAAQAAAFADA.aACEUAGA.ZCCAHAEB.TAGAEDGAeECBhAAAGDAA.CCDDXCGAhAAABEEDMEIBADABDEEAJFGB.hABAfEGA.PFHDdGBA.OFFHhADA.....hBGA...,2,-26,11,37
gRVIZSXJAUGHEeCTKaFMfLYdcBODNPbQW,HAAAEAAA.eACEKACAMAEALAFB.dAHAOAHDDCCA..bDDCQBEAhAAARDGF.ZCCFhBHAXFCAADHBGEEAaFFHhAAAfEHABHBANIDB.gGCB.hBHASGHHCHHB.hCAA...,1,-4,-9,5
RWeNDCBSMgQOEaYGPUIHJZdTAKVbcLXFf,KAAAVAAALACB.FAEARADFeAFE.CBFABCGAMAHBQCEAhAAA.EDHFGDAAhAAAIEBAHDDCdFFAACIBbEGDhADAXECD.fHGFDEIBSGFDhAIA.....hAIA...,2,-27,-9,18
SHKLgPGWBEAaMcdeITOXZNDfJVbYURFCQ,aAAAdAAAeADA.OAGDZACBDAFA..JCBBVBEA..UDDARDFAQEBAhAIAHEGBLGBAhACA..gFFAhBAA.PHBABFCDAADAMBBBcGFCTEDAhBEANAIA.....hBAA...,1,-5,-23,18
IULOGfYZQeXcWJBbMCVTDAKHgENaRPFSd,HAAAEAAARACA.SACE.dAFALAFBGBGAZCCAeAHBXECAhAAAcCCC.BAHBbCGD.hAAAMEIB.TFFAhBFAACEAKDAAaEDE.FGEA.IHHA...hCAA......hCDA...,2,-8,-8,0
KCEVQFHJfXRDGBbSYAaWTdcPLUNIZeOMg,aAAAdAAALADA.UCCAZACBeAEA.MAIBCAHAECFAQCEAhAFAHDFC.XDGDhBAAREABBFCBSFFBhACAABBBTECAPFFBOFHDKGDB.FHBCDICA...hBHA......hCAA...,1,-6,-16,10
fMLVAKHCWNSIegEZFRJGTBcaQDUYPdbOX,HAAACAAA.SACEeACAEAFAZBEERAEFGAGABCAA.aCCBDAIB.UDDBhAAAdDDAbFEA..XDAAhACAMDIBAAIBKGAA.WGDGhAAAIDGA.FEHD.TGFA..hADA......hCAA...,1,6,-28,34
VdgIELXaeCGDbZNcQOHABKfJMRUTFPWSY,KAAAMAAARACF.FADD..SAEBdAFA..EAHBaAGAeBBB.GCGAhAIAZBFBQCAChAAAHDDBADDBfFBAhBAATECAPCHB.VFFBLGDADCEB.NIDBBHHBhBCA.....hACA...,2,-18,4,22
cBPXbaEQZMDeHIgUWVTLGdKfRASYNFCOJ,SAAAFAAAOACDBAEA..bACDEAGAZAEA.eBHHHCDBICFAhAAAUCGA..TEAAhAEAdECAREEAAAFACFCA.JFHBXFFAhAGAaHAADGGB...WFHH.....hABA......hAHA...,1,-11,-21,10
ZDaecFTMUdAgYEbJOQBWPKNVSIRCfGXLH,EAAAOAAABACAKADA..SADHRAFFGCCAHCGBZAEBDAHB.eBGDhAAATFAA.dFEAAAIB..hAFAbDDCQGGAhAHA.PBBBIFFA.fEHAhCAA.aGHDMAIB..hBAA...,2,-23,-5,18
SFDKcYgHRGMdQbaLCUZEBWfPNJVTeAXOI,OAAAFAAAKADA.......gADAHAFBRCCAdBHAaAFDLDABhADAZAGBEBBBBDDA.hAFAfDFEPEEAVFGBhAHAABIBSDHHDIAA.GEAA.bFFChAEA.CHED.....hBAA...,1,-14,-19,5
NYUHcfQXOPFaGIRWZgDbKeVJMABCLSTEd,LAAAEAAAdADA.UAEAHAFAQAGAOBCHaCFCRCAAZDCE.DDGAeCHHhAAA.MDBBACAASEFAhABATEDA..cFEDhAFAXFGAFGHBIHAAbGEC.KHCA.hACA......hBEA...,2,-19,7,26
ZIaeMCKVHEDfFAJGgTbWNBYQPXSOdULRc,GAAATAAA...bADABACB.QAEASAHBdAHARCDAZDFEhAAAeCCBMDABKCEDHDGBhAAAEDCBFFGAABGAJEAB.gFEBhAEAYFABOHCAcGDC.aGGC..DGIBhCAA......hCDA...,1,7,-9,16
DUdeLCSQAgfHEJGFZMOIcaTXKPYbBNVWR,HAAAEAAAGACAZADBMAGBOAEA..aAHBTBGAKCAD...bBEDhAAABCCC.VDEBREBBdEHAhAIAeBHHLFFBQFBAhAAAACBBfGDAFEHDXGGC...hBCA......hBEA...,1,-1,-2,1
ARVPOYaGIFSeCTQdHKWZBMfEgLDNcXUJb,RAAAOAAAGADAFADDeAFA..QAFAHCFAZDAAMEFBEBBBLBHBhAFADEHB..XFAAhAAAbCEDADDA..PFGDhAIAaGFDCBHA.dGDABCCD.NEIA......hBAA......hCAA...,1,0,-17,17
egdEABQIcOUZTNPKYDSRaCFXGbVfHLWMJ,QAAAOAAAZADB...TACAKAFASAHBRAEFFAGAGCFA.hBAAVEAAHCEB.MBBBhBDAeCHBECGBADDABEEDUFGAPDCBhCAAaFGD.CHCA........hAAA......hAEA...,1,-7,-11,4
WgTfDSCLXGPIHMQeEJcUNRAFbBaZdYKOV,BAAAdAAAOADA..gACADAHBLBDAGAEAHCACeAGBhAAAECHFUDEAAACAFDDBZEFBKEBD.hACA...TFGAhAIACAHBXGDBMIBAcGEANCIAaHFE.....hCAA......hCBA...,2,-21,-5,16
NPVYUORgGIDWdbJABcHMCfXEaSKFLTQeZ,HAAAMAAA.XADBEADAKAFA.LAGB.eBEHZBBAPBHDhAHAUCABREFAGDCADCFBdEEDACGBCGBAaGEBhAAAFEHH...NAIA..hAIA............hBAA......hBCA...,1,8,-34,42
gUfVZSbeIBHQJcDOFANRTdPKLGXWCEMaY,RAAAdAAALADBGADACAFAEAFA..MAHB..aAHDUDAAZCEBeCCDhAAAHDEBQDGBhACADDGA.AAIB.TEGAXGCAhADAgFAASFHHbGECBHBA..hABA......hAFA...,2,-12,-7,5
OBSXaRQMVgdFfGIJZPUKELeCcTDWAbHNY,HAAAOAAAXADBRADA.MAGBdAGAGCCAZBGBKCADLCCAhAAAeBHHTEAAAAHA..bEECBBBDhAEAQFBAFEFBfEHAhAIAIGGAUGGB.EGDFDCIB.WFHHhACA......hBFA...,2,-5,-1,4
YBDUdgTJNeWIHRCAFEOVMafSKLbcQGXZP,EAAAMAAA..aACDKADALAEAQAFCZBFEBCBDdAHA..TBBAhBAAeCEDHDGBACEB.ODDHhAAASDDAGGABhAFAXDFDDGEA.gFGANIDB.IDHAhBBACGHA...hAGA...,1,-2,-21,19
cVUDgQHbWJFKAPMEOIXLTCBYRNZaGfSed,EAAAXAAALADABADARAGFZBCAGAEA.eAGBdDDAUDGB.QEAAhAAAHDAAbDDDFDHDhAAAAAEAMFFBTGFA.CAHBaDFDhABASGGADICA.......hADA......hCAA...,2,-12,-1,11
ZabLHXfPdUSQcYgVCEDFWTeIRMABKONGJ,OAAAGAAAaADAHADA...XAGBdAGAQCDA.gCGAhAAAEBBBFCEDeBHHhAFARDBFAAIBKEHBZEFEbDCDLFDAhACAfGGASGBD.....hBAA......hCAA...,2,-10,0,10
GZXKMJCadPRcUITeSOYBDbgLWfNAHQVEF,HAAAEAAAZACBMACA.aAEERAEAUCEB..eAGHOAHDDAIBbCCALCBDhAAA..fDGAhAAAADHBQFEAGECAhCAAKEHBdGGAIFHASFADBEEDgGGGhCCAWHAA...hAFA...,1,4,-19,23
gHKFSVPYEdJBXTUGQcfZaOMNAbLRICWDe,RAAACAAADACAHADB.FAFA..SADA..PBHDEAGAdCBAXCFDhAAAGCFAQDDAhAAAZDAAaEEC.MBIBhAGAACCBbFBCLFCB.eFGHKFGA....hBCA......hCAA...,1,-10,-19,9
ERGUaeMXJBbFDNWfAQYcHIZSVgPKTLOCd,QAAAHAAAZADBSAFA..gADATCFALCCDhAAAdAGARCDAaBHDeCABMDABhAAABBHADEFA.fDHAhACAAEIBIFFAKEEAEFHBGGABXGBAFFHD..hADA......hAEA...,2,-20,13,33
eIAWEgDPbXFQTadSNZcRVBMJOGHfUYLKC,EAAADAAA....XABATACAdAEAZADBRAFAMAGB.GCGAHCEBUDGAhAGALDDBeCCDAAHAgFEHhAAAFGGAaHCA.hAIASBHB.NCCABGHA...hBAA......hCAA...,1,-2,-17,15
FeNTacRCVUYOAgJfdbLIMPWKXSQDHZEGB,JAAAdAAALADA.MAHBKADCQAFAHCACECFBGEAAeBHHaCCAhAIARECACDHA...UDDBhBAAAAEA..bFEAIFGAhBHA.XFCADAIB.FGHD....hCAA......hCBA...,2,-24,-2,22
PFJOefEZbAWRMYSINcgDadXTGQUHVBCKL,RAAAMAAA..SADB..IAEAgAFAdAGAGBBAhAIAHCCACBHALDGBhAAAFCHDeDEBEEGBAAFA.YECBhBAADDIBaEEA...QGGBBGHA..hBBA......hBDA...,1,-18,-22,4
WfbcKgZJSQICBAURdOMLGeHXFVYEPNDaT,RAAAdAAAMADAeADA.HAGBFAGD.ECBADAIB..aCEB..TBDA.hACA.bDAAKCCDZEFAQDEAhAAABDGDAADALGBAhAIAGEGAXFBA.PHDCfGGAhBAA.....hABA...,2,-23,2,25
fdSCEMeYTcZGBFbaOWJAQUgIXDVLNPKRH,QAAAUAAA..XADALADAKAGAHAGBdCDA.ECDAeCFAhADATDEAGEAAFDCHaDHDhAAAODHDAAEADFGB.NIAB.REFBCFEDhAEA....cGDABGCAWHEAIHHAhAIA......hBCA...,1,-9,-14,5
YBOTRDAfSHZVcdPMGbNEgIWeUaXJLQKFC,HAAAZAAAdAEAGADAEAGA.IAFAeBHFUCAAaAGD.LDDA.hAAAQFDACCADOBHDRDAAhACAADIB.SDFBhADA.PEHBbFGBgGAAXFEC...hAIA......hCCA...,1,-6,-7,1
fbKJMVPNQIGcDSHFAOadXUZLCRegTEYBW,dAAAZAAARAEAeADA.EAGABAHB....bABDMACA.VCDBQCEAhADAGCGASFFBhABAHCGDABIBaEAALFFAhAEATGCA.YECB.WEED..hBAA......hCDA...,1,-3,-26,23
RMFdUZBPNbIgAeCfQcJEVWTOHKGLXDYaS,eAAAQAAAEADA...TACAHAFAGCCALAEBDCFBaAGARCGBdFFAhAAAZBFBBCHAPHAAbECBhAAAACCBCGEC..JEGB.OFHDhCAAKHGA.SHCA.MFFB.hABA......hAHA...,2,-8,7,15
FGKQXDEbHVOgeZacWUdCSIMPNBATYJRfL,TAAARAAALADB.GAFAQACCDAIBHDEBOAEAZDGBaCCBUBFBhAAA.dDDA.SCHHhAIAMEIBBFAAADGBfFEAhBIAXFBD.EFHB.......hAAA......hABA...,1,-10,-15,5
BHecRdWMaPNJUSYTDECAbKLgQfGIVOFZX,LAAAQAAAGADAOACCZAFAHAFBRCAAdCGAaAHF..JEFFSCDBhAAADAGA.AAEAbDEDhBHAKEHB....fFDAhABAFDGDeEHHMDDBNIDB......hCAA......hDAA...,2,-21,-6,15
HCLIGFJKbSgWDZMTedVEUNRQXfBAcOaPY,aAAAHAAALADAGADAKAFA.SAHBDAHBZBBAeBHHECABRCFAQDDBhAEABCCDAEFB.ODFDhAFACEGAFFAA.JEHB..bGCAhAAAMFCBdGGA..NEIA........hAIA......hBAA...,2,-20,5,25
LPfVTBYcCKFDRgXIeAZdJOMbSWEGUNQaH,dAAAMAAASADAGACBQAGCHAFBLAHB..fBBEhAFATCBABDADCCEADCIBhAIARDEBXECDADDBZDFBbEGDEEEFhBAAaEHBPHBA.cGED...hCAA......hCDA...,1,3,-12,15
DYKLVHROcIgQPGbECXAFUSMafWTedBNZJ,SAAAaAAA..TADAeACHdAEAZAFBDAIBLAGBHCCBRCGFOCHDhAAA..gDADhADAGDDAEEBAABBBMEFBhAFABFGANIABKGGAIGBAPHBA.bGFA...hBAA......hBHA...,1,0,-12,12
EDecAFbCZWGQaKdTHIORgYVLPfMJSXBUN,CAAAGAAAKACA.HADARAEF.VBGBLAGB..MAFASCAAhAAABCDDEDEFeCHHAAABZFCAaDCDhACAdGGA.ODAH.hAEA.gEDH.fFGEhAIA.XGCCDEIB.hACA...,2,-19,-10,9
VCKeLUgGDBWRNHIdQJcTEObASXZPFfMYa,ZAAAFAAAMADAaACA..KAFAeAFALAHBGBCABCCDRCEFHCGB.dEBAhBAAQCEAJFGF.hBEAEECAABIBXGCAhCAA..fEGA.CFAADEIB.IGDAhABA.OFFHhAFA.SHCG,2,-17,-9,8
BRKDJZdOWfaSEegIbACMVNUcPFGQHLTYX,MAAAUAAAFADAHACCLAGB..TAGABBDDRCEBDBBB.dCCAOCHDhAIAaCFBECHF.eDFHhAFA..bFGDAEEBCEHA.VGAAhAGA..PDDBQGGAKGBA...hBAA......hBCA...,1,4,-30,34
VKAJDFBWMIORSYegLHdNUPQaCXZfcTGEb,FAAAMAAARACF...eACAHAEBdAGAUBGA.QEAAaBBCZBEBTDGAhAIAEDEB..KEGAABIBBCDAhBAAOGEASFFBhCAALGAACHHAfFHA.cGDA.hAEA......hAGA...,2,-15,-13,2
NgfeaDOICVcJLMAXdRPbBWQUGYZKFSTHE,RAAABAAAQADCGACAZAEAFAFA.HCAB.ECFB..fBHAhAAAeBHHaEDDDAFACCCD.VFFAhAAALCFB.ADEAdEEChABAbGCC.UGGA.SDHHNIEB.IHEAhAIA....hCAA...,2,-20,5,25
OFQWeIVCZJfKHcAEGLBYDXdbUTgRMSaNP,EAAAGAAALADADADAdAGAUCBARCDA..MAIBaAGD....OBHDhAAAQDGDeCFBCDDBZEBBhAAAKEADHFEAAEFB.BGHAhACAbEGD............hBAA......hBCA...,2,-19,-17,2
HIMEgaAGDePfVcWKYZQOBFLNSdTbXJUCR,eAAAVAAA.KADAZADBBAFBLAGB.dCFCTBGA..bDABXCCAhAAA.CAHBHDEBhABAEDHFAAIBGGBBDDIBfDGEhCAA..cEECQFCCFGHB.hAAASGGA.hADA...,2,-15,-14,1
ZUOfPbDWGCKNLaVcQAREFBIJYTMXHgdSe,EAAABAAA.JACAMADA.HAFCdAFAZAGBOBCB.....bBDDhAAAGCBAKCFALEGBhAIAaCHDQDDCRFCA.hBDAFEGH...IHHA...XFDAhAAA...hCAA...,1,-13,-30,17
FXVbKTLgfNPCQMRJBIYWGOaDeZHUSEdcA,XAAAKAAALACB....fADACAEARAFFBAHB...IAFAhAAAGCGAaCEHeAGHhABAHEAAECDAAAIBFFDDbDABTGFAhAAAgDFA.QFDCMFIB.hAEAYFHBDICA.SGGFhADA,1,1,-21,22
CdZAKQFYBNHTPaLcUbgefSEMVGIOJDRWX,QAAABAAAHACAaAEALADA.UCDAeAGHEAHBGCAA.hAAAOBHDRCFACEAAAAEAFEGDTCDAhAAA..bGCASEFAhACAMEIB.IFCADGCA.dGEA.KGGAhAIANIAB......hCAA...,1,-5,-10,5
AgNKcQHSOTaXGPFVWMYEUDCfLBdZbReIJ,KAAAHAAAOACAaACAGAEA.FAGAMAGBECCB.CAHALCCAZCGB.hAAARCGF.eEDFABDB.gFFGhBGAQECAXGDDhCAAPEFB...WFHHDEIBdHAB.IHGAhAAA....hAHA...,2,-27,8,35
XFIGebRaWBVTZENCAPJSQgYMLcdUDOHKf,SAAAQAAAMADAdADADAFAHAFC.XBDCGBEARBGBaCEEBCCDhAAAZDEE.EDBBACIBPEBBhAAAJEGFLGBA..hABAOEHD.FFFB.......hAIA......hBDA...,2,-24,2,26
SXCVHMJeAdTbRaLUcgKFGEfDIWBONPZQY,dAAARAAALADBUADAKAFAEAFA..DAIBBAHA.OCCHZCCA.QCGAhAAASCGBCDFDHFAAhABA..eDBBAEEBaFFAhAFAFEEHGGCB.IHHAPEHDXGDChACA....hAHA...,2,-40,3,43
TLMFRdVfUeQPNgSIcOBZEAXbaJWKCYDHG,aAAAKAAADACAHACBGADBMAEA...RCCAdAHAUBEA.eAHFQDFAhAAA..gDGAhBAASEEDOBBHhCAAEFHFACCAJGAACEEATGCA.FFHDfHEBhAGA......hCAA...,1,1,-25,26
QILbNYWTaPGcUARSEgBFdDMKHVXCJfOeZ,EAAAFAAAdADAKACA.HAFA.CCCD.OAEAZCEELEFA..bBCA.hAFA...NDBA.TBGAhAAAGFCBAAIBRDDBBGHAMDGBhCAA.XFGDeHAA.IHEAaHEE..hCBA......hDAA...,2,-28,-9,19
MKJRLBVSECfDZTgIAdGYFNWHUPaOcQbeX,GAAAFAAAHACBaADAQAEA.eAHBMAGBRCGB.LAHBhAAABDEAEEAADCDAZEDATDDAhACAAFIBdGBA.NEGAUFDBOGEC.hBAA............hBCA......hBDA...,2,-20,-4,16
ZEeIYKDNAGQbLHWcTgMVPUdRFBSXCOaJf,GAAALAAAHADATAEAMAFA.UCDBRAGFBCAACBGA..OBHDhAAAaCCAZDDAEDGB..eCHHhABAKEEDADABQEAAhACA.bFDBgFGAdGGAXGAC...hACA......hADA...,2,-16,7,23
FILPdGWEfBVOZJUbSgMQcKTRDCNHAXeYa,eAAAaAAALADAGADAEAFABAHAZBGB.UDBASBBD.MCCAhAEAQFDAKCFARDDBCCHB.hAFAHFGB.AAAAFFAHdEHAfGEAhAHA.OHFC...hAFA......hAIA...,1,-10,-15,5
egZIPFMQSHDfbCaAUKNBcVXLOYREJdTWG,KAAABAAA..XACBLACARAEA.EAGAdAHAGCCAZCCA.FBHDMCGBhAAAHCFBDDHBCDAA..AADAUFFBhAAAVECA...OFCHhAGATFAA..WFDHeEHH.....hCAA......hCBA...,1,-15,-18,3
PTfeJFVBDGAZLUESMHdbICaNOKcWXYQgR,ZAAAEAAAHACAdAEACAGA.aAEA..KBHB..XAGDQCAARCCATDFAhAAA..eCFFFEEHDDIBhAIAAACALDDBMFCBIGGAhBIAODHBcEBDYHDA..fGAEhABA.BGEAhAGA.SGFH.,2,-20,4,24
KMPgXfHGeEdACVJbDaSFZLYNWOUIBRQTc,CAAAVAAADACA...FADAZACELAGB..NAGA.OCDABAHA.RDDB.hAAA.QFGAhAIAKCDAMCHB.XGBAHEEBEDCBhAAAABIBaGED..SEHHWDFA.IHAAhAHA...PFCBhCAA.,2,-45,-9,36
dcKXAIEQBgMRVUNGfeFDOZaTWCSPHLJYb,EAAAQAAABACARADF.UADAGAFAFAFEZCDE..aAHFCBHA.HDEBLDBBhAAAJCCF.dDHAXEGDhAAAAEEA..MEGBhAIAfFAAeHEG.OHBA....hAFA......hBHA...,1,-15,-18,3
MbVJWceNCQPRgXZIfFTEBHYSDdGaAOKUL,KAAAMAAA..VADAJADB...eAGHQAFARCAAZDCE.FBBBECHFHCEAhAFA.DAIBaEFDADIBLEEAhBAA.bGEAcGAAhAAA.CEHA.PHBCIGHA...hBHA......hCAA...,2,-20,-17,3
GHMFADBbPKLEXQOJaWURSdTcNVeYfIZgC,BAAAKAAAEACEQACA.OAECaAEARAGFdCCA..TCAAhAAAVDFB.eAHH.fCEAhACAZCDBCFBAMCIBAAGAbCFDhCAA.LEHB.XFEC..hCCA......hDDA...,1,-11,-30,19
MUSbCEWTeGFfVHBDZLKPXQYgcIAdNORaJ,dAAARAAAMADASADA..EAGAeAFHGBDAFAHBHCACZBFALCCDhAAAXCGAQDGChABAgDEGAFFBaFHDbEAA.hACACGED...TFGABGGCDIBAKHEA....hBIA......hCAA...,1,5,-8,13
cAXDSPJaHKTFVIeYdRfWLEBUQbNOZgCGM,SAAAaAAAHACBFAEAeACH..RAGFLDEBEAEAQAGAOBBHhAIAZCEAGEBAAAAADDDBKEAAhAEATGFAVEEAdEHABFHAhBIA.UGCA.........hBAA......hBEA...,1,-4,-6,2
RFUcKgdVWBLDaQPGJIEYSHOfCeTXNZMbA,RAAAFAAAKADCdADABAFALAFA.DCCBaAGDGCFA..ECCAHDDBhAGACCEA.eCHB.XFGDhAHAZDEEAAAAUFFA..hAIAcFCC..gGDD..hBIA......hCAA...,2,-41,-10,31
BbANEeFadXGWTPKLQYVfDOcMZHCSRUIJg,EAAAeAAAdADAGADA..TAFALAFAQCBCfCCEhAAAOAHDZCFBHEGBRDEAIFAAhAAABCHAAAGA.aDBHXEGAhAFAKFDADIEA.MEDB.SGGBhAHA.JHDE....hBCA...,2,-9,-1,8
gTOCKHAFPWIVXNYMGQRbacBeDJUfdSLEZ,FAAA..IAAAXACDMACARAEA.aAEEeAHH.DCGBUCBAdDDALEABhAEAEAHBZCFATEDAhAIAKDHBHFDC.AFAB.PEHBhBCA..WHAAYGCA...hAFA......hAHA...,2,-18,-13,5
YPAWEadUJcVCTZLRIfNeKBSHgMDQXObGF,EAAAdAAAUADA..VACAZAFBRCAA..IAGAeAHFBDED.HEFAhACAMAIB.QCEAhAAAOFBAFGHBACCBaCHHCDHA.hBAATFAA.LFFANICB.SDDDhAFA.XGDChCAA.YHFG,1,0,-21,21
KaOIZBLNecgVRQPMfWDHFbYJCSETGdXUA,aAAAZAAALADB.eAFAgACHRCAB.MAFADBIBHCFBhABAFBEDJBGBEEEB.dFADABBBOCHDhBAABEHA..cFDChACAQEEC.fFHEYHCATGGAhAFAGGBBKGGD..hBGA...,2,-20,2,22
THfIZUWFBJgLKbOeMPCQdXYDaScGVNAER,RAAAHAAAZADBFAFDBADB.LAFAKAHB.eCAAMCCBQCEAhAAA.dCHADCHBaDDHGDEAhAAAAAGAEFFA.TGGA.hACA.fFHAIDAAJHAAbGDC...CEHASGDBhABANECA.hCAA...,2,-21,-5,16
OKPHZXETdaNcfbLJWIVMGSRFgeYCBUQDA,KAAAHAAAEACEaACA.....fAFAbAEBLAHBJAHBICCAhAAAGCCAREFAeBGF.hAFABFEDQCEBhAHAACCBZGBAdGHAcDGD.MEEB.FFFH.CHGADFIBhCAA......hDAA...,1,-2,-9,7
SgPcOMdNFEZfXeDJVGTUKRabALCBQYHWI,LAAAQAAAHADBSACA..gAFBOAEDdAGAhAAAECAAZDAAeBHHDAIBGDGAhADATDEARFBAACDBBEEAhBGAIFGAMGDAfGHA.XGDAhABA.....hCAA...,1,7,-18,25
UTGFdPVOcfCaeXLEbAZSIYMQBKNRHJDgW,ZAAASAAAMACAKAFAHACB.DAEAUCCBGAGAdAHA.OBED.hABACEBA.eCFBEEEBAAAAQEBBhBEARGBA.gEGHhCAATGFA.FFEBcEGCaGCD....hAIA......hBEA...,1,-13,-16,3
PSYJIGWDCTXRAeBNMdbEaUcZQVLKFfgOH,eAAAMAAAdAEAEADAUAGAZAFBLBBB.FAHDOBED.HCCBhAAASBDDIDGAGDGAhBAACEHARFFBACCB.BEEAaGBA.hABAQGEA.......hBGA......hBIA...,1,-17,-18,1
fLgbIPaKMZCBETJOGNRQUXAcSHdFeVYDW,HAAAeAAADAEALADB.IAFAaAFEZBAEEBEBOAGD.RCEFQCABhAAAAAAAdCGAFDDB.VEGBhACA..fEFEhAIAgGEBbFGDMAIBTGDA...NBIA.hDBA......hDCA...,1,8,-19,27
HFQXgTECaGdNBbUKVDeLfPZJORWcAIMSY,MAAAHAAAQADC.TAGAEADAGAFAdCADBCEAbBBCKAHBhAHAeCFHLDDBZDGBRFAAAAFASDDDhAAAXFBBaDHBhBAANEIADGFBfFFA.OEHD..hBCA......hBFA...,2,-10,9,19
WKXPTceVDOQHUfJEZgbRMGIdNaSAFLYCB,LAAABAAAKACA.TAEAeAEE..DAIBHAGB.UCAAEBEFZCAARCDBGDFAhABAdCGA.aEHDACCACDFCXFDChACA..PEEBhAAAOHEC.QGAAJFHB..MHAAhACA.SGFHhAHA..,1,3,-27,30
GEAURMNKSeTYJIdWcfPZbCVHgOLQFDXBa,RAAAMAAAKADC...eACAJAFB.dAGA.....fBBEhAIAbAGDHCCBLEFAQBEAhBAAXGEAGDCAABIB.hAAASEEBIHHA.PEGB.CEHBOHDChCAADAIB.BHHA.hABA...,2,-29,1,30
cSdgbEHPDGAWBefNFJXaRQKUYMCIVTOLZ,eAAAFAAA..aACDRADAQAGCKAEA.MCCBCAGB..TCDAhAEAZDCBdDHAEBHFHEEB.DEABhAAAACFABDFAfGHAhABAXEFA.UGGB.......hAEA......hAIA...,1,-11,-35,24
OLbIGgPEQFDXTdWHJRcVeANZUMCKBSfaY,ZAAAMAAABADB..aACELAFAGAEAEAGAQCAA.XCDAhABAdCCAHCGBRCGBeECFhACAABBBCEDAfFFAhAGA..bEFDgGDDDEEBWHAA....hBAA......hBIA...,1,-11,-17,6
MgTNbFOaESLVJPDKcQGdYHIABXCUeWfRZ,CAAAeAAARACA.ZADB.MAGB..TAGAFAHB.ECAALCCD.hAAAVDEBDCEAQDDAhACAGEGAdHDB.HDFAAAAAXFBChBDAfFAA.bFGDOCHFaDAESHDAhADA...hBFA...,2,-6,-6,0
IDFgNAcJQLEPTMSfZXBUHWGdeOaYVbKCR,QAAAEAAA.MADAZACBBAEAHAFCdBDAeAFHaCEDVCGB.CAHA.hAAARDFFFDCH.ACIBLFHBhAAATECA.XGCAhAIAGEEAOCBH.KGHB.DHAA...hBCA......hCAA...,1,-4,-13,9
UbTABQcPKFeJGSRaCIVdYDZNMLXEfgWOH,QAAAKAAAeACEGAFARACA..aAFACAHAdCCAZBFEMCEBLDBDEDAA.hAAA....fCHAhAAAODFCHFFAbECAAEIBhAFABGBA.FHDASFHDIHHADDDBXGFDhAHA....hBDA...,1,0,-22,22
CaHeAPdLFQGKVIfbSUDZgcTEWYBNXOMJR,dAAALAAAGADAKAEA..IAFASAGBZABB...TCAAhABAEAHBBCFAOBHDRCGFHFEAhAIAACCAQCEAhACA.bEAADDDB.WEHHXEEC.MEHBhAEA.aGDE....hAIA...,1,-16,-17,1
HGfNUVQIXBgJROPSELCbDMdYTAKcWZFea,KAAAZAAAeACEHACBGAEBUAFA.QCACBAHARCCA.SCEHhAAAECHFLEEBDCHBdEGDADGBFGGAhABAaEAE.VGDA.XEDChACAOHFC.CGGBMIAA.....hCAA......hCBA...,1,14,-24,38
GKcVCTLAdQOSZHeRDgPYJWNFUMfXbEIaB,dAAAQAAAZABBHADARACADAFA..PAHBJAHB.FCEDUCEA..hAAAMCGB..bDAAEDCFhAFABDHAGEGA.KGAAhAGACFFAADAAeFFD..gGBANIAB.XGDDhADA.aFHB.hAIA...,1,-2,-21,19
NBRYbWOQEVfHcUGMAaSIdePTXgKFJLDCZ,aAAAdAAAeADA..TADAKAGALCCAZAFBRCCB....bBGDQCGAhACA.EDABhADAHDABGECAAAIBSEFDhADAXEEAFFHBCBBDBFHA.OHFA.hAEAcFCD.MICAhAFA...,2,-17,-8,9
OFCRYVIdMAUWHGBNSbgQJZXPaTLKDecfE,HAAAGAAASACEQADAZAEBaAFETAGALCDA.eAHHhAAAECCACCGDREEA..VGAAdEEAACIBhAAABEHBbEFD.XGGAhACADEHB.ODAH.......hAIA......hCAA...,2,-15,15,30
QCRdFTJgKBUPZIOEbXNLSDeMYWHaVAcGf,GAAAQAAARADAdAGAFACE..JCDFBAFAZCFA.EAHB...bCDALEGBhAAA.eDADhACAMCHBHFEDACDACEEATFAAhAAA.KFGD.IHHANIABDGIB...aFCDhAFA......hAIA...,1,-8,-26,18
GOPdQbYTLHfUXVJBCWEgNMKFIacDReSAZ,GAAAdAAAQADA..bADATAFAHBGBXCDABAHBECBAMCHBhACAFDCHaAHF.REEAAAABZDAAhADAODAHLDDBfFHAhACAVFFB.........hBAA......hBCA...,1,4,-9,13
FUSIQefDMARKTCPcXBYONHEgZdbLGWaJV,RAAATAAACADB....XAEDOACAHAFAZAGBLCCBaBDCFCCHSCFAhAAAeCHH.hAAAMCIBAAGBKEEABEDAEFHFdGEAhABAGEGA.JFEB.IHAADGGB..hAHA......hAIA...,2,-19,-8,11
AMdDSNBYIbUWCfZPTKcgaEQHLRGVeFOJX,dAAASAAABADA....bABDCADAZAEBKAFA.aAGDHCEAGCCAeCHHhADAOBHDAAHA.MDABhAAADECA..IFAAhAFAUEFAfGBATFFAEGCARGDE......hBAA......hBIA...,2,-22,-9,13
LXfgAOIdMQbFYRWUJTVPZScGaHCBNeDEK,dAAAMAAAQADAFADD.RAFA.UAFA.JBBBTCBA.ZCFEGDDAhAIAHEDABDADeBHHEFBBhBAALEHB.fFGAhACAADDBbFGB.VGAASGDDaGED.hADADGGB.....hAGA...,1,2,-16,18
CfMSaRVbHAIYZWLOgFdUJQNXcGeDTBEPK,ZAAALAAAFADAdAGAQAEA.XAGAeBHHTCAA.hABAECEBCCAAMCCB.RCGBHDDAhACAADDBIFCAOEABhAEAUEEBcFDCGGDBBFFAfGBEhABAaGHBYHAG....hAHA...,2,-10,-5,5
UOZNKYBQEaDfGgCJWXHILVRAeSMTbdcFP,eAAAMAAAdAEAFADDUAFAZAFB..KAHBBAHA..EBBAaCCCGCGAhBAA.CCDD.XCGAhAAAHEBALEEBADFB.SGFHhBBAbEEAOFBB.QGEA.hBEAfGHA.hCAA...,2,-21,-13,8
BNKTCUfDMEAgLeRaPZXcdSIbFHGQVOJWY,eAAARAAAZADBdAGA..bADAHCEB.GDAAQCCAOCHDJAHBBCCChAAAKCEAUEAAMFGBAAIBaDGEhAAA....XGBDhABASEFDFFHH.YFHBTGDA.DHAA.hADA......hBFA...,2,-12,-4,8
LaJYINdEOZFPVSHBeQcbAWRDMfKCXUTGg,RAAAMAAACADB.UAEAGAEALAHB..aAGAJBBB....ICCAhAAAEDCAZDFAFEEHSBGBhABAHGBAeFHBbDFDACIBhCAADGGB..KEDA........hDAA......hDBA...,2,-32,-14,18
NfcEgRLOYDSdHXUCWQeTIFMbAPZJaKBGV,ZAAAaAAAGACA..fADBEAEALAHBDAFAHBECCBFA.eBHHhABATDFAMCABABBBKEAAhAEABCCDVEDBNDEA..RFFASDFDhACAdFHA.WHBGFHBA....hAIA......hBHA...,2,-16,-2,14
ATYaDfCWPOIcFUVLeQSdEKgZNGRbXHBJM,aAAACAAA..OACAFADALAGB.eBBBdAGAEBCBZBDE.RBEBHDBAhAAAMAIB.AAIBDCIB..fDEAhBAA.IEGAhBDAcDFDQFGAKFFDNEDA.bGBABGHAhCAA.....hBDA...,1,-12,-29,17
CONEgVYZMXFaWLfQSBIUDbHRJGPAKecTd,eAAAdAAAOADAEADA....VAFAZAGBMBDBaCCA.LCEBhACA.QEBChBAABCFDDCIBHDGBREGBGGBBAAAATFEAhAIACCBANBIA.XDDC.fGHAhCAASGEE....hBCA...,2,-9,-8,1
LPBKJNcMOTFfSXaDbAHGRYQeEUWIdCZVg,HAAARAAAeADEEADE.UAFAdAGAZCCALBHBKBDA.JCAFMAIB.FDGBXCCAhAAA.aDEDAAAAQFFBhCAA.hACACHHA.gEGG.BGDANEEA.OHDEhAIA.SGGGhCCA..,1,1,-29,30
GeIKBTcQLSYCObVDMJFWNfHaZAPUdXERg,dAAARAAAeADEBADA.QAFALAGBCBDA..OAHFDAIBFCCH..hAAA..fCBAhACAHEDAACFAXDGAECEBGDCAhADATFGASEGA.bFAD.MFFBhAFA......hBAA...,1,-19,-20,1
SXWMIdYPLTaCQOgeFNZBEUKAGVfbJcDHR,GAAAVAAA.JADAHADB.RAFA.SAGB.MAIBdCHALDAAhAAAaCDA.QDFAhADAeCFHZDBBEDHBAAFAbFDBhAIAXEDDIGGATGFA....hAAA......hACA...,2,-16,-6,10
WUcKQCYTJHEFIPBNLDdZAXaefRbVGMgOS,eAAARAAAGADAMAEAOAFAUBDA...QBFCTBFA.HDAAhAAAECHFFDCHBCCDLEEBhAAAZDFEABIBaFGA..fEGEhABAgGGBSGGAKHDA.CAHA..hABA......hADA...,2,-11,-5,6
FEDVgKZYBRTALdbaeMScWfHJUXIONPCQG,dAAAeAAAMADA..SADA..fAGAHAFBXCCAhAAAOAHDCAHAGDEAhABAEBDADCCBKCFDZDGBREAAADBBaDDBhACAJHAAIHHAQDGD.FEEH...gGGAhBAA..hBCA...,2,-26,1,27
JEPYVFdNgKWTMGHZcSIfCeARUQLDBOXba,RAAALAAAOADA.aADD..EAGA..PAFAFBDDdCFA.KBHBMBFBhABAHDGBZCAA..SCCDhAAACBHAACGBQDGAhACAXFDAbEDD..YFFAgGGA..hABA......hCAA...,2,-22,-10,12
bEKPadIYDWURFGVLXAQNOTCfMJecBSgZH,QAAATAAA.MADAeACEBAGAZAFBHCCBEBDA.aAHDdCFADDBBRDBAGDGAhAAALDHBAAIBCCHBfEFAhAAA.SFAAhAFAbFDB.KGGD.IHBA.hBCAYFEF..hBDA...,2,-12,-9,3
caSNEXUZObCABYHFgRKTePJWLfVQGIDMd,HAAARAAAeADEJADALAGB..QAGCGBDAMAIBaCACECCEhAAAZEGBCCCCACEAFCHDKFCA.TDEAhACA..fFFAhAAADFGAdGDASGGA.....hABA......hCAA...,1,-6,-18,12
YKMUSIBbLNJGWOZDVAFgcTQRaPXCdeEHf,FAAATAAARACF...aACACAEBdAGA.HCDBKAFAMAIBUDFA.BBDDLEHBhAIAGCDBZFCAACCBQEEBhAAA.eEGHhAFAEGBBSGGDbGCCNEIA.....hAHA......hCAA...,2,-18,-10,8
XVIOFMfbZHaUWQgSdBTGERPeKJDcAYLNC,LAAAXAAA.OADDMADA.ZAFAHAFCUCAAQBDC.hABAdCGDGCFARDEBeDCBDAGAhACAAAAACEGBFDDHaEHDSDHBhCFAEGGB.KFHD.cFDDNIAB....hCHA......hDAA...,2,-19,7,26
CPaDKTZWcfVdSGHRQAJLUNXbBgYFMeOEI,LAAAXAAABADAFAEAeAGH..EAFACBDADAIBZBEE....fCHAhAAAdCAAHCEBACCBUDAAhABA..bDGDMDDBhADAODDHaEEATFGA.cFDDSGFDhABA.....hAFA...,1,-17,-23,6
KJLMeQIOdUFZSXGBRPfabVEYDCWgHAcTN,TAAAKAAAMACA..eACEQAFAdAFAZAGBGCCARBCA.aCHDECHFhAAADDBBCAHAHDBA.ADFAJEFBhBDALEFB.OFDDhAAASEHHBHGA.fHFF.hBDA......hBIA...,1,-12,-14,2
DJOWdSbCIXRNeQcgGaULYFTMfBZHEKVAP,DAAAOAAAdADA..CAFA.RADAeAGH..QBBAGCCAaBBHLAHBhAFAFCHD.MCFBZEAFHEFAhAEAEBGF.AAIBPFEBhAGASEDB.bFGBIGHA..XGEAhBAA...hBAA...,2,-25,-7,18
PGaDFdYJRSZMTVAOIHcKNbLEUfBQXeCgW,HAAAKAAALACBEADEBAFBeAEACAHA.....PAHDaCACdCCARCEAZEAAhAAAMCFA.ADFAODFEhAAAIEGA..bEDDQGGAhAEA.WEEDFFFASGHHhACA.....hAFA...,1,-12,-23,11
GSWUAODRIdeJTaHBFcMVQCZLPfgEbNXKY,RAAAeAAA..aADAHADAFAGA.MAFA.QBGAZBDELCHBfCCAhAAAEDEA.bDEBKEBAhAAAGEGASEFHhABAAEEBDFCB.dGHABGEDCHDA.NICB.......hABA......hCAA...,2,-22,-3,19
OcfEbNFKURVQDZWTYgHIdGeXLBPSJaCMA,OAAAEAAAFACD.RADA.DAEAZAGB....TAGAHCCAGEAA.hAAAeCHHLBEBSEEAhAEAaCGCACEB.bFCDKEFAQGGAhAGAgFGA.IHEABBBD..hAIA......hCAA...,1,9,-37,46
ZKAgRCSIJfaWNXMGYLPbFTOUVEQDBeHdc,RAAASAAA..fADBaACD.XAFBGAEALAGBhAAAFAHDOCCAEDDBQDDBhAAAeCHHHEAAZDFBhABAAAEBCFFAIEHANIABMFIBbGEA.....hCAA......hDAA...,2,-23,8,31
YOVJfNgQTFaLWCcXBUKGSbDPIdMEAHZeR,HAAARAAAOADAVAEA...JBHB..fAGAQCABaAHDLDDAhAAA.CCEDBEADhACAGBDADEIBdCCCAAHAeFFBhADAgDFA.TFCAWFHD.XFGAhAAA.SHFAhABA..,2,-18,-9,9
ceHQODgaEKVWbRGZTFNfSILMYJCUdBPAX,eAAAHAAAQADCDAEA.EAFEKAGAVCEARBCAZCEE.FDBB..SAHBhAAAMCIB.CCADdEHAhACAAAAAOEFBaCCHbEECGEGAhAIA..fGGEIGCA.LHCAhCHA....hDDA...,2,-25,3,28
SWLNDXeZKBHPgTVARMFQIbcOJCGfEdUaY,RAAAMAAAQADC..bABAOAFAGAFAEBFFaAHF..SBHHhAAALCCBXDGDhAFAeCCBZEDBHFFATFDAhBAAADGBIHHACEEBdGGAYFBFDIEABHCD..hABA......hCAA...,2,-5,4,9
JHDUCGVdTReNWOKXYPIgbFZMcQEfBaSLA,HAAACAAAdACA.RADFeAFE.OBFCXAEA..IDAAFAHBZCBAMCFBhAAAECCBBDFALDGBhAEAAACADDHBGFDB.hAFANDIA.KECA.gGEB....hBCA......hCAA...,1,-7,-28,21
UWAHGRMaYgNJSECbdLDXIBcfQPFeZKOTV,HAAARAAAMADAaACA.....NAFA.EAGAdAGALBEBDAIBBCCAQCCBhAAAeDEDZDGBOECBhAAATCGAUEGB.ABIBGGCBhABAgGDBCHGA.IHHA..hBGA......hCAA...,2,-18,-5,13
SXFEIMCAaWKYcTGZUHgdLOJBRNeDPbQfV,aAAAKAAA....TADAZACBHAEALAFBBAHBRCEAeAHBDBBBQECAhAGASCAAEDCAMCIBhBAAAACA....cDFDhAAAGEFAdEECOHCAPEHD...bFCD.hCAAfGGE.hCCA...,2,-12,-6,6
QUPFCfKaEWOeZcbSMDBTXLJdVAIHGNYRg,HAAAGAAARADFQAFCFADAKAGA.EBHFeCDAZCAA..SDFBhAAAMCHBTECALEEBhACAdEEAAAAB.IGGA.hACAYHAAgGAACDHAWHFAbGDABHHA.hADA......hAHA...,1,2,-11,13
PHBUFWaQdgYCJRVMADZTIbSXKfceGEONL,ZAAATAAASACE.KAFAeACE.EAFELAHBHCCAFBHDaCCChABAdCFACCEB.RECAAAHA.bEGDfDFAhAFA.GEGAhCAAODBBBGCA.WEED....hCBA......hCGA...,2,-25,-3,22
PTYaWZMNBLeAJQcUKgHGVfIODSFERbdXC,QAAAKAAAHACBGAEB..fACFDCABECEFRCGB.dAFACEAA.TCDAhAAA.aAHBZEFFMBIBhBEALHAAADCBUEFA.hAAAgFBAOFAESHGAXGDDPHFAhBFA....hCAA...,1,-7,-9,2
JZdcFGRUVCOIMgASaDHWLeYKEQfbPXNTB,aAAAHAAALADAeACEEAFE..QBGA..bBFAXBBChAEATCCAZDFAdCEAGDFAhAFARECACFGAMHAAAAHADDDBKGFDNIABhAAABEHB.FHGE........hBAA......hCAA...,2,-15,8,23
cLFHDIKAOJgMNZaWRPXbSUeBfVCTdYEQG,OAAAMAAAZABERADA.....XAEDSAGBeAGBBBBDCAHBdCCAhBAAECDBGDFALCFAhAEAHEDBKEFAACIBJFHBaEHDbGCAhAIA.....fGGE..hBAA......hBIA...,2,-24,-9,15
dDMAXKaIVPFcZReEgOJGLfWHTYCbBNQSU,aAAAVAAA..FADARADF...EAGAOAFAGBBBLCFAHCECTEEAhAGACBGDBDAA..QGGAhBAAdEEAADDBKEHB.IEHAhBBAZEFB.eHCAfHGF...hBIA......hCAA...,1,-5,-25,20
WNGdXJbVKCRBaTYZHcEDSFUeMfgLOQPAI,..IAAAGAAAdADA.XAFAVACARAFFBAHBaBHD..ZCDEHCAAhACAEEEAFEGDeCGHMEIBhAAALDEB.QFAAhAFAAAFAJFCBCHHD.TGGA.DCIBSDBHhACA....hAIA...,1,-1,-13,12
ICGBHNLXDQYJRUVTKgEMcWeaZSbFAPdfO,dAAAOAAAGADAHADALAFAQAGCRCAAUCGATCCA.ECFBMDFBhACAeCHFZGAA.FFHBABBBfEEAhAFABGDBDGGB.hADAVGFA..........hAIA......hBAA...,2,-16,-4,12
eYdcEPIOXAKVgMGSRaTbWJCFfZQDUNLBH,KAAAMAAARACF...aACE..TAFA..bAEDCAHBZCAFDAGALBGBhBAAHCDBeCGFdCCAEDHFOBBHhBIAAAEA.GECBhCAASFCHFEHDQGCCBFFDPFHDXGGChCEA.....hAAA...,2,-21,8,29
RECWBgZMfDXIVPaTcNLedQKbHOYUGSAJF,RAAAEAAABADBZACB.DAFA..XAEA..IBFAaAHB..hAAATCEALBHBeBHHhAAAdCCAbECBHDFB.OEDDhABAGEFAACHBCFHAMCBB.fFAEhAFA......hBCA...,2,-33,-9,24
RIKZPVTSDECGeYaFgBOAUXHJNfLMcQWbd,HAAAJAAALADBMACAQAFA.dBHARAFAZCFA.TEEAhAFAEBDFeCCDFDCHBEGBACFBXDGChAAA..fFHAhAGAbEDDKFGA.SGGDCHHA.aHCA.hAIA......hCAA...,1,-6,-23,17
TPeSEHXZfKIJWMCdFGQOaVcLYUNRAbBDg,DAAATAAAeABA.HAEAZACBKAEA..ICCAMAHBdCEAGCEBhAGAaCAH.LECAUDGBAAIBBEDDhAAASAHB.hACAEEGAfFFECFHAOHCAcGGCRGAAPFHB.hBAA......hCAA...,2,-11,-9,2
aZfNLBKIMXHDTVRJebUGYQFOdSCPgAEWc,EAAAaAAAZACBLADA.KAHBMAFAHCBADBBBRCFA..eEABGBEAQECAhAAAdBGBCCHDABEB.fEFEhAEABEGA.XFGDhAFATGEA...bGCAFGGASHAGhAHA......hBCA...,1,5,-29,34
YRCEIVUAWbcOJaNSQFfPdZXKgBTDHLGeM,...bAAAOAAA.aADDQAEAFAFAdCFAZCGBKAGA.TCAAhAAAHDBAeEHHRCFAEDDBIEHAhABAAAIBJFBF..fFDAhBAAXEAADFFBMFFBCGGA......hBBA......hBDA...,2,-18,-4,14
SHMOPfGBIaAEZNRLgbTVJUWCYcKXeQdDF,EAAARAAALADB..bACATAFA.UCFBCAGAKBHB.eCCBdCCCSAHBhAAAHCECMDABfEEAhAAAGEEBaFAAADIBhABAZEAB.gFGA.WHEG..hADA......hAEA...,1,-9,-12,3
eRTYbQMUZBFADLJIOVWXHGEgCKfNadSPc,LAAAOAAA.XADDHADAEAGE.KBBDaAFAdCDD...SCFHhAFAeAHHRCAATDEAhABAbCGD.MDIBZFFAACIBDBGB.hAIAIFBA.VGFAWEEDCEDD.NIEB...hBAA......hCAA...,1,-2,-15,13
DXbKIVedNZgRYPAMBaSWEfHGCUFOcTQJL,aAAAEAAAHACAGACAFAFA..OAEAQCCBLBEBXBGAhAAAbBGD.KCFD.eDGFZFFARGCAhAIAAEAAMEEBSBBDhBAACFHA..cEADDBIB.dHFB.NIAB.PHFChCAA......hCGA...,2,-4,12,16
EYHRPWKaeICSJZAfdMQNObBTXcgFLGUDV,dAAAMAAAQADA.OAFCbABATAFA..XCAAhACAFBHDGCCADCGAEDDAHEFAhAFARDFAKFFDeFCDCGDASGHBhADAAAHABFEDLHEAYHAAaGHF....hAHA......hAIA...,2,-18,6,24
AOdcMCYfaNERegSDZXQBTIJKGHFUWbPVL,dAAAMAAACADA...aACERAEF..eAGHDAFAZAFEBCBA..JBBFHDCAFCFD.hBAAUEGA...bGAAhACALCHB.ADDAOECChCAAfDAEEFGBSGHHXGFC.hADAIHDA..hCDA...,1,-16,-34,18
PZBaLMKSUICNeXDEfHQVFAGYcOdRbJWTg,GAAAOAAARADAJADA....TBGAZAGBaCDAMBBB..SCHHhAAACAHBeCCB.EDDBHCEBhAEAQFEAADIBdFGAbGAAhAGAPGAAKHEA.IHHA.DGGA..hACA......hAGA...,2,-23,-3,20
VWPSfNXZDdBRKJAILaQTgGCFcMUeOYHbE,aAAATAAAGACA.FAEAMACA.UAGAeAGHHBDBECEF..VDGBhAIASCCD.XDFAhAAAdEBARFEBABBBIHHAhBAALFBAQFFC.CHHA...hBDA......hBFA...,1,-7,-13,6
SbaVcAKFPMDUfgHNeGJXBOdEZQWCYLRTI,FAAAMAAADADAUAEAHAECGBBABAHB..EBCFZAGB.QDEChBAA.CDHALFGBhBBARCEBTCGAbECBaEBH..ABIB.fEHAhBAAeGBA.OFGH....hCAA......hCBA...,2,-23,-6,17
adZKPcEOCNULVRBfFJQIMWXDTHgbSYGeA,ZAAAKAAAEACECADBLAFA.BCAAFAEAQBGA.MCCAhAAADCCBHCFA.bDDDGDDAhAHAAAGA.dFGAOEHBhABANEIA...........hAIA......hCAA...,2,-36,-29,7
VQAEOSWeFGUafMDBIbCLTdKXRJYZcgHNP,EAAASAAAFACD.GACAaAEA.DAEABAHACAGA.dBEARBEF.ZCFBHCGBhAAA..VECBAAIBeEBBhABAMCIBLFFA.hAAATGDAXFGD.YHAA..hAHA......hCAA...,2,-27,-8,19
bSeAdKgcafWHQPEYJNFTGROVMDCXULIZB,dAAAKAAA.aADAHACB.EAEAJAGBFAGD..RBDB.MAIBDAIB...XCAChAAALDBBZDEASDDDhACAACFB..fEAAhACAQDGAPFFBTFEAOEHDhAEACGADBGHA.....hCBA...,2,-25,-18,7
MDbdZYRCFSgXLNQIVBJeWGTAKPUEHcOaf,KAAAEAAAHACAOACAaAEA..MAGBdAHARCCAFAHB..SCFBhAAALCCAQDGAhAAABDHAeEEBTGGAABDBUECADEFBhBFAYHBAXGFA.NICB......hBHA......hCAA...,2,-15,-10,5
UTIPDNWeHRVMLfFYXdbOgBGSaKCQcEAZJ,ZAAATAAADACA..eAEAHACB.RAEALAHBFAHDdCCD.OCABGCEAhABAaCEEQDGChAFAAEEA.UGCAIEGAhAAAPFHDVFAA.MEIB.XFFC.hCAABHCASGGDhCBACHHD...,2,-17,10,27
XVQAJYaRCHfUITLOKBDWeMNcbPgZESdFG,aAAAHAAA.UADALADABAFAeAGHMAHB....bBBCZCAAECEAdDFDhAAAGDEBQEDDhACAAAEARFFACHHA.TGFADAIBNDDA.PEHDhAIA..........hBIA......hCCA...,1,-7,-10,3
NZcRUHYIdfDKXLOCQGFaTSBEbPVMJgWeA,ZAAARAAAHADBdAEAKAGALAFA.QCFAaCAABCFA.ECCB.bDADMCHBhABA...JDABeDHHhAAAACIB.cEEAUEDA.hACAfGHAOEBDGGEBSHAA.hADAPHDA...hAGA...,2,-26,21,47
HfcKSCOMDGVYeQXATNELBUWIdbRZFagJP,EAAALAAABACAUAEAdAEARAGBZCAA..aAGEJCFB..HCCAKDHB.OCGDhAAAGEBA.eEEDhABAACIBTEBA.IEEAhAHAFGAH..fGGACFGDMEIBDGDA..hBEA......hCAA...,2,-23,-17,6
FaZSTgfeIHOCKMGVbXAdcJYUPLWEDQBRN,dAAAJAAA.UADALADBDAGA.RAFA.FBFAZCFA....SBHHhACATEEAeCCDHCBAKEHDGDEAhBAA..bFABADGBPEHBhBCAEGEBBGGDaGGHfHCB..hAFA......hAGA...,2,-18,-18,0
HUKWCLRfQMPbVSODIJagZEdBANcFGTXeY,FAAAGAAAeACHHADAKAEA.LAGB.RCEBMAIBbAGB.OCDHhAAADBIB.aDAHECEABEGAADDB.hAEATGCAXDFDUGGAhACAfECE.QGGASFAAhADAIHEA..hBAA...,2,-34,14,48
ObBSXNVdPTaEDWgfJRZcYeALQKHCMIGFU,LAAAHAAAMACAGADAOAEESAFA..XBGAhAAAdCAAaAHDECCBDCCAfCEAhAHARCFBZFAAeEFDADIBQDFAhAIACFHAFHDEBHHAPFFB.WDDD..hCAA......hDAA...,1,5,-22,27
gfMRbZUdQPGEcFHCBDeALXJTKOWaVYSIN,LAAATAAA.OADDaACA...SAFAIAFA..fAHAhAAARCAAZBFEdDGAGEEAhABAEBDBHCEBDDIBACCBKCHBhAHAVFAAgFGAMIAA.bGCA....hCAA......hCGA...,1,-5,-13,8
dMPXaFHgfIUZcJWTCGENLKRbOBYAQeDVS,eAAASAAAdAEAMAGB..aACDHBCB..fAEAhAAAZBGBJEBBTEEAEAGALCFAhABAKEHBOFDBACGAQDDChAEADGGB.XEGAIHHAcFFCCHAD.hAAARGAABGED...hABA...,2,-14,3,17
WdIMLFUQXTPDaEcbfSgJeKNABZHRVYOGC,HAAARAAAOADAGADA.dAFBMAHBLCGBQBDDTDAAaCCHECCBhAAA....bBFDSDFFhACA.eEHHhADAAAAAZEEACGBAFGEAXGGADAIB.....hBGA......hCAA...,1,4,-17,21
MSVRYdAeBOfIcNbgXTFDLQKHZUWCaGJPE,eAAAOAAA..IAEA..bADATAGALAHB.HCCAhAEAZBAECCDAGDFAECFBMCIBhAAARFAAABBBfFEEhAFA.NEIAFHBEQEECWHEA.aEHH.SGAAhABA.dHDBhAGA.BGGD.,2,-2,7,9
RTGSUJEXaQHOIVZPdgYDCNBfMWbeFcALK,RAAAGAAAUADA.EADA.QAFAHAFAOCCBZCDAdBHADCHBBDEA.hAAA.MDABeDFHACEATEEAhACAXGGAaEGD.IHHAhADAPEDBCEHANIAB.....fHABhAAA....hABA...,2,-25,4,29
DbOaMVURPdIGBCKSXWQgTFJceEHYNAfZL,ZAAALAAAOACAaADDUAGA..RAFAdCAAGBEAKCCD...XDGAhABAQCFB.TEDAhABAFCCHeEEDHFAAAGBADGGAhBGAbFGB.MIBA.IHHASCHH.hBIA......hCAA...,2,-19,-2,17
MAaIZWcTGLOVHeDJfNSKgXBEUPRbCYFdQ,ZAAATAAAGAEA.LAGBHACBeAEADACA.fAHAKCCDBDHAEEBBhABARCEACCADdEAA.ACIBaEEChAAAIEDA.OEGBhAIAVFCBSFGAUGBB.PHECFFHDMFFBhBEA.....hACA...,2,-7,2,9
ZVGXCbFHTBKdJcNWQMDSeaPfLOEUAYgIR,..IAAARAAAGADA.CAFAHAGBKACAdAEAJCCF....NAGAMAHBhACAeDABaDGC..LCCBhAIAEEFBAAAAZFGBXEDDhBIATFDA.BDHA.QFFCSFADOHFEhCAA....hCBA...,2,-25,-2,23
OIdPKHENcGTWfZgRaeCYXJVUFMQBLAbSD,DAAAdAAAHADAEACA.GAGA..TAEAZABBRCEBeDCFXAGBUFGAhAFAMBBBLGAAABIBOCCBhBAA.KCGDcGDDhAGAfDEA.aDHD.CFFAJHEA....hCAA......hCDA...,2,-24,4,28
CSfEHcGRWaIVMZLTdKQYNOPAJBeXDFUgb,eAAAFAAAUADACADA..EAFAHAFA.RCFA.aAHDMCCBZCCA..LCFBhAAAdDDAQEGAODHBAECAhABABFEADEEB..bFAAfGGEhAHA..cGGCWDBD.IHBAhAFA....hBHA...,2,-22,-18,4
IePYgHcGNOCMdQaWJbfVFTRALUSXBDZEK,LAAAXAAAZACBEAEAKAGA..eAEA..PCAAHBFCGDEAhAAACCEA.dDGDaCFDbECBhABAFCHBAAIBBFAADDDBIEAAhABAgGGA..OECH.MEEBhACA.QFFAhAEA.WFHH.,2,-15,4,19
HYgdBaJROIECMLVPDWNGTUZFcQASKXfeb,XAAAeAAAHADAdADAaAFA..RAFA.EBHFMCFBLCCA.DCGBGCGAhAAAZEEAQGGBhAAAAAFAfDBA.bDDDBDHAhABA..OFHD.CGFA.....hABA......hAIA...,2,-20,-6,14
PACDeXTBNKWRQfgSMHOLdGcFZEaUVbIJY,eAAATAAAKADA.RAFF.QACC.SAEBHCCAdAHAGDGAhAAAZAFBEAHFUECAbECAIFAAhABAPCHDADDAXGEAhAFABEFAfFGA.....hCAA......hCBA...,2,-9,-6,3
KOZdTMeUCFYBXWSHVNGEJIfcQPLDgAbRa,RAAAaAAAZADB.dAGAeACH.FAEABBFC..SAGHHDAAGDFAhAAAEBEB.IDHAQDDChAIALEEDABBBOBHDhBAAMFDBCDGDXFFA.WFHH...hABA......hADA...,2,-20,-11,9
IDdfKQUEPCbBJYgaNHOAGVZFMSeTWXRLc,ZAAAMAAAeACE..TADARAFFLAHB.DCCBdAFAKDDAEAHB.bBBDhAIABEFA..gCFAhBAAHEGBAEIBGFABhABASDDB.XEGAfHCFQGGChBBA.CHEA...hCAA...,1,-15,-16,1
VRNfKeEGCTQIgHPOSJWYcZLXbMAdBDaFU,dAAAaAAA.FADARACF.KAGAGAEA..QCBAHAGDSBBDhAEA.JDGFcCFAZEDFLGAAhAGAMCIBADDADDFBUGGBhAIA..VFGB.eEED.EGAA.CHCA..hBAA......hCAA...,2,-16,-1,15
aTZbBgECRFSGUfAQMYeDOWJIPVNcLXKHd,MAAAeAAAOADC..IAEA.VAGBLAGB.hAGAHCCAaBBAZCCAbDFAEECBhAAARDFFGECAAAIBQFAChABADEIBPHFAXEEC.dGGA.BHFC.hAIA......hBAA...,2,-17,8,25
MPQBYKgDLGFSENRUZVOfbIdJcXTaeAHCW,HAAAMAAABADAKADCLAGBGAEA.EBEARAGBZBBFOCAB..IEGAhAGAdCCAXDFC.hAIAeDHHADDACEEDQGDAhBAADAIBSEDHUGGAbGCA.....cGGChAAA....hACA...,1,-10,-16,6
YCHEWUfDNZFBKGbJVIdTgARXQPMaLceSO,RAAAQAAAMADA.aACEeAFA..OAEDHBDAEBHFUAGADCCBZDAAhAAAKDDDGDGA.bDDDhADAIEFA.dEHAhAAAACDBXGBCLGDASHFA.hBGA......hBIA...,1,-9,-10,1
YafPQFOdRDTJACNeSBHGWcgUZIbXVEMLK,eAAAHAAAGADA..gADAZAFAbCAC.EAGAMCGBLCCAhAAAaCHH.QCGAhABAdFDARFFATGAAAEAASEAAhAEABHHA.cEEA.XFGD.hAAAKGAA.fGCBhAGA..,1,6,-3,9
AGBTPXHCabWNQULKRgZfSceMJYIVdEFOD,GAAATAAA.HADACACB.aAFA...bBFAQAEA.LAHBhAAARDCAZDGFSDADhAAAeCCBMCEBIFFAhACAEDGBDEAAABGAXFDDUFGBfFEA.hADAYHCA..hAEA...,1,8,-22,30
RQZNWVeSKCJXTBgYOUAPGEaFcfdIHLbDM,EAAAaAAA.FACDdADA.HAFALAEADBBB.RCDAZCGB..VCEBeECBCCCD.hAFAJFABBCHA.OEGDhAHAAAFAGGEB.IFEAhAAAMEIB..WHCASGCD..hAIA......hBIA...,1,-15,-27,12
VZBHPEaJdRGYIcWXQTSULgKOfNFACbDeM,DAAAeAAAZABEHADA.EAGEdAFARCCB.GBGA..ICFAXCCAhADATDGALEFBOEFBhAAAFFBAAAHAMFABBHGAaGGAhABA.JHCA..cFDD.....hAFA......hAIA...,2,-27,-4,23
RPFEgdJCTMOSINQZUabAceVKWBYXLGDHf,eAAAKAAABACBLAEAHADBRAFAEBCF..dCHATCEA..MCCBhAAASAHHQDDBhAFAaDDHAAAAVFFAXDGAhAFAGGABfFFA.FGAACDGC.OHDChAGA.IGHA.hAGA...,1,3,-15,18
QSIeRHVWTagGFNcKDLbOfXPBdUYCEJAZM,ZAAAMAAAQAEA.eAHBHACC.TAGAGCAAFBBHKCDAbCEDhAFAXCGDBCGDdEDCCEEAAACAhABARFGB..aCHD.NIAB.LFGBhAEA.fGBAPGAC.EGDA.hAGA......hAIA...,1,-3,-7,4
bALTZKORGYFBVUNJXSgCWQMEfIdHacePD,ZAAARAAAGADABADBUAFA..XAFACAHA.MAIBECAAdDDAHCFBhAAA.eCCBDCIBADGATDAAhABA.OEHDFEGB.hABAVFDASECDQFABaFBH.PHFChADAKFEB......hAFA...,2,-39,16,55
TaeENGbRMZYcDgWKXHAFOVfPLJCQdBSUI,OAAAVAAA.LAEAQADCdBBDSAHHUAFA.aCDDECHFhAAA.GDDARCFB.ZFGBhAIADDIBKGFDHFAAABHA.fFEAhAFA.CFHDBGGD....hAGA......hBAA...,2,-18,-17,1
OHNSBVIQWbReFgTYGKCdAfUcDaMEXZJLP,UAAAaAAA.EADAZACBLAGBHAEABAHB.QCEBRBDAeCHHFDAATDGAhAGAGDEA.dGBAABBBDEEBhBAAMDDBJFFB...hADA............hAIA......hBAA...,1,-13,-22,9
NgJYZbVOCMQDSFRWeLPdfUITGAcXEHBKa,EAAAHAAAKACAaACA...JAFAZAEB.OAGDMBFBDCCARCCBLEABhAAA.dDGDfCGAhAAAUFEA.GDDAAAIBBGGBhAEAgFGA..YECFCDHAFGCBWHFAhAIA.....hBGA...,2,-22,-8,14
DUEPaFBKQONRVITHMXSfbCLZedYGcgAJW,DAAAEAAAFACDQACA.RAEA.TAEAHCECMAIBSAGB.hAFACCDAZCFEeBBBGEAAhAAAADDBUEFBaEECOFHD.hAEAIHAAbEGB.dHCBgGCA.hAHAWFHH....hAIA...,1,-1,-14,13
gNYHSCabVJMdAXKIfTeQLRWcZBFUOGPDE,KAAATAAAeACE.RAFF.ZACBBAHBOAEC.GCEAEBCF...gBGAhAAAHCGBaCEHbFAAhAAAMCAB.AAGA..fDHAhACALFFAWFDHFECBDFIB.SGFAhAIACHHA.....hAFA...,2,-20,0,20
VgcPbEfLdaYSQCNHZKRTeAOWMGUIJFXDB,MAAAGAAAUAEAFADABAGA..VBBB..gBGAhAAA..bAGDECDAdDEAaDBDhACAQEBBHDEARFGBADIBOGAAhAGAIEGADGFBfFHA.LGBAhAIA.SGGDhBAA,1,-12,-17,5
PJdYZHaIVDMUFcOBSTbfQCXEKWRLeAgNG,GAAAdAAAHADAaADADAFAFAGABAHA..TBFAQCBA.ECFAhACARCDBAAAB...gDGAhACAPCHDZDDFMDCBhBCAODABSFDACFCAKFFC.eFHF.YHDAhBDAIGHA...hBEA...,2,-15,-13,2
ebTOaAWEHPDQFNfVMLSBKCYdIJgZcGUXR,HAAAQAAAFADA..VAGBMADALCAAKAGAdBDA..JBFFZCEFGDGAhAAAREDBeDGB.bGAAaCHFhAIA.EDCBDEIB.SGGDhAAACEEA.........hBCA......hCAA...,1,2,-23,25
OSCALdKYUfDTPcIMBGeVXQbaWERHgZFNJ,dAAAKAAAUACADADA....TAFA..IAFAGBDAeAHHhACAQBGAaCBDRDFBHFCAhAHAZDDAFEBBOEHDAAHALEHBhAAAfHEBMFDBXFFC..hBEA......hCAA...,1,-1,-30,29
VcCMZfEJOHARFKBgITWLGNbDdSPaQYXeU,RAAABAAA..TAEAGACADAGAdAEB.aAGDQBGA.eCCBhAAAVCABMCEBECFBHDGBhAAAAADAKDGD...gEDAhACALFFASHFAXFBDCGGD...hAIA......hBCA...,2,-17,-17,0
AUDLSJWeTZFXQcPEgBdGIMafObHRCKVNY,LAAASAAAeADHZACBFAEDQAFA.ECAAdAGAGCEAhABAaBHDODEBHDGBRFAAKDGDYHBGhACAAAAA.DAIBTFGAhAIAXGGA..gGBABEDD.hAFAMFFB....hBGA...,1,23,-31,54
JKfTWCMeSgYGLDEOQUIRcANPdHZaVBXbF,dAAAHAAAaADAXADB.FAFDKAGA.TBDAMAHBeCAA.SCHHhAAAGCBAECHBQDDAhACARDFBAEEBZGAABFDDhACAbDFDfGHACFHALHEADFFBIHFA.hAGANIAB......hAIA...,2,-10,11,21
FEHOaPRLQZeYVfTcbGKSNXBdgIUWDMCJA,HAAAaAAALADAeACEVAGB..TBGAGCCASBBDhAEABCFDdEFAIEHADCCAMCFBAAHAhAFAEFAAREDBZGFE.fDGEhBAAKGHBXGAA.......hBIA......hCAA...,1,-2,-14,12
aLFMXEgCSDQNOWYZKIUPGRVHBfcATeJbd,eAAAdAAAaADAMAEA..EAGASAGA.QBCAhAAAOBDBZBFEKBEAIDGAhACAGCGAHDEBfCBAhAGAACIBbGDA.LEEB.XEBDDFIB.YDHBhBAA...hABA...,1,-8,-12,4
SVEIJODNLZKfTHCgABRGQeaWFbdXYcUMP,RAAAeAAAFADA.dAEA...XAGAUAGAMCCA..SBCHhAAAEDDA.OCEELDGBhAAAZDFETEBAHFEBADIBQGBAhABAbFGB..PHAAIHHAhBGADEEB......hBIA...,2,-21,-4,17
ZPRfHOJSGQVUXbcATgNIKCWFEaYBDdLeM,TAAA..gAAAKACCFAED.EADAaAGADAGA..dBGAeBDAhAAAZCCAREEAHBGB.SCCDhABAGGCBQGGChAAAXDADABIBNCIA.CDDBBDFD.MEIB.OFFBhADA.UGCA.hCAAIHGA.,2,-4,2,6
MCIGPgNXLRbHTcDEYaeVBSUOQKdWAJfFZ,FAAAZAAAMACAGACA.....PAEAXAEARBFAHDFCDAHBECCBhABAeEBBBCEAOEDCdDGAAAIBhCAACFHA....gGGGhAIAbECA..TGGA.aGEH..hCBA......hCEA...,1,-4,-28,24
ZYDOMXHcKPdaQWbfBNgRFeSAIUCTVELGJ,CAAAEAAAGACAZACB.DAEAMAFA.HBEAKAGAdBEAaBGA...QCAChAAAbDEA.BCGAREBAeEHHhAAAACIBUEEATGDALEHBhACAOFFF..XGCC.WHFGhAIA......hBCA...,2,-26,7,33
gKYJTAIaBFDefQZVSUPXGcLOHRECMdbWN,aAAADAAAeABAZACB.UAFAGAEA.LAGBHBDBECHFdEBA...hAIAbEDAgEFBhBAA.KDCDYCHBhAIAABHAFFBHQGDASGBA......hBAA......hBBA...,2,-18,-11,7
ZUTVIPWQfCKAYSHgdRcXbBeFLNEDGOJMa,HAAARAAA.XADBeADELAGBEAFA.GBDAMAIBZCAATEGAhAAAICFAQFCChABAKDGAABHBSEDAhAAAdCCCbFEDFGHDDAIBaFGA..........hCAA......hCFA...,2,-9,5,14
YaKGcIRHNAdPXbWOJCVfLDgUMQBZFETSe,dAAAXAAAOADA..CADALAFADAHBUBEBBCBAECDA..eCFAhAAAKCHBGDBBRDAAHEEAAAGA.hACA..bGCCVEFAMDIBhABAQFDDTGGA.aGHD...NIAB..hADA......hCAA...,2,-18,0,18
PGTfeFOQZYNHgaLJIdbCXVWEDcURKMABS,SAAAGAAAeADAQADAZAGBHCDBaCHDLAGBdDCC.bCCCXEGChAAA.EBFFDAIBhAAA.RDABADIBBEADTEEAhABAOFFHgEGBCHGA.cFBDMIBA.FGGHhADA......hBFA...,2,-5,8,13
WYSTDCZQagXHMVLfBRUIOFKedNJAbGcEP,GAAAEAAA...PADASACA.TAFAZAGBaCDAHCCAhAAAMBIBLAHBRDBF.hAAAODABeDDGdFFAACEAbDFDhADAcGBCDEEBCEHAXFADBEHDFHGE.KGHB.WHCAhAFA.....hACA...,2,-7,5,12
BPMgJXReTDQWONfdFVGLZabUcHESACKIY,KAAABAAAMACAJACA...RAEA.eAFEDAIB...QBFDOBCDdCEDhAAAGCBAZDFE.bDDDHFGBhAHA.ACHBCGFC..IEHAhAAA.gFFB...hCAA......hCBA...,2,-31,-24,7
QgaJEWbXKNUZBcRSGOfeMVdFITAPLYHCD,LAAAHAAAQADCaADD.EAFE.XBGAKAFAZBFERCAAGCABhAAAeDEAdEHATDEAAAHACEDD.DDHBhACA.gFCAhAHA.bGFABFAA.OFFBMIAA.IHHAhABA.....hAIA...,2,-23,12,35
XBGdOEJQUNVLgKPeaMTIbFcDZHWRSCYfA,GAAAEAAAUADALADA.KAHBeAFAaCDA.MBCB..bCFDDBIBhAAAHDDDRCFBCDDA..ACHBdFEAhAGAQEAB.gFGAhAAATGGA.FCHHWDBDfHABhACA......hAEA...,1,-4,-24,20
ZQNXYMbKGTcFLgOSaHedUfWDVCIRAEJPB,EAAABAAAZACBQACA..XAEAbAEA.GBGAFCAALCFAhAAASAHBHDDAhACAeCBDdEHAfFAAhAFADDEBCDFDAEIBPFABMFFBTFCAgGCAaFFBUGGAhAAAIHHA..hAGA...,1,6,-9,15
QePSETADNFZLIfBOCRaGVcKXUdYWMgJbH,FAAAZAAALADBBADARAEF.GAFAKAGC.dBHA.MCABJBHB.HDEB.hADAeCCDECCB.AAHADEHB.hBAA.IEEACFAA.hABA.aFBDXEGAUGGB.....gGCAhCAA.QGGChCBA,2,-35,-8,27
fWVbTJCDRPAYGFBQKZaHdeESXIMULNOgc,GAAAQAAAaADAHAFBEACA...XCDCMAFALBEAhAAA.OBHDfAHEhAAAbCDCTEEADDHBADIBBEBAhACAdEGAeFBBSEEAIHHAgFGAhAIA.....hBFA...,1,-7,-8,1
PIbDBUKcTOHSJdVgMLRZWYFeNGCXEfQaA,..IAAAbAAA.BACAKAEAOAGDHADBdAFBMAIBRBFFZCAA.FCHDeCABhAAAGEEAECCBaCEBAAIBDGHBhACAUEFA...TGAAhABA.SFDB.JHFA..hACA......hAEA...,2,-19,-6,13
aQCSKXUBZJEATDNdgbPMFOLWfIVcRYeGH,TAAAdAAA..bABDMACA.LAGB..fADAhADAIBDARBEFeAEHHEECaAGAhBAAQGBAKBGABDEAEDGAhBGAAAIBDCCBgEGAODHF.cGDACDDDSGHDhAAA...hDAA...,1,3,-23,26
PIKXODfEBNZHCJTaSUMgQLFRdAbVeGcYW,eAAAGAAA......cACDPADAKAFADAHBBAHBHBFBTCDAhAAAaCDBMAIB.LEEAhAAARCFFACHAVFAAIFCAhACAfDHAEFHFNIEBZFFA.CHHD.....hABA......hAFA...,2,-15,-3,12
gMcCITRSQFWYdXKUfADOeGNVEbHJPZLBa,eAAAGAAAEADAHADAZAFBLBHBaAFA.MCCACBHARCDAQDGAhAAA.FDCHdDDAKEFDAAAAOEGBhAIAbGCC.BFBAhBFAgGGAIHCASDADYFEBfHGFhCAA..hCBA...,2,-22,9,31
KORbTUNQCJdWFYVHcEaSDeLXAPIMgBGfZ,MAAAGAAAZABERADAUAGA..QAFAdCDDFDFDHEACECCAaBHDeDHBhAAAACFB....gDEAhAFAKFGBOEEHbEGDNIBB.hACA..CGFC..YEDF...SHBGhAIA.DEIBhBAA...,2,-20,-6,14
EXVaeKQgZBAIdYLMRCPNDFHTfWcJSbGUO,dAAAMAAARADA..CAGB.DAEAHCAC..TAGA..fBHAhACAJBBAGBEAECFBaCHDeDEBhADAQEBAZEAAADIBLFHBhAEAFEGHSEEDbGCC.OFHDKGGD.BHDAhAIA.....hAIA...,1,-1,-10,9
UPNBMYKeIJDGbHETcCfSQFWLZROdaVAgX,XAAAUAAABADAKADA..eAEHDAFAHBECEAGA...CAHAQDAAhAAALCGBRDAAaDFBACIB.hABA...gDDAhADAMBIBIGAAbDGDTGEASEED.hCAAZGEE.....hCBA...,2,-18,-18,0
FUMKICPcaEDWTVeGQJbHLdBSNgYfAXZRO,RAAAFAAAMADACADA....aAEDEAGA.DBEB..TAGAeBFBGCCAhAAAQCCCHEFCdCGDSBHHhABA.gFEGhCAAADAAZDFAKEEDIFGAPHCC.cGAAhADA.....hCCA...,1,-9,-28,19
MSVEGaJWCKZeURALQfTXYOBbIFdHDNcgP,LAAATAAA.OADDBACBFAEAHAFADAHB..NCAA...PBDDhAAAMCCBECGA.aDDCCCFAeBHHhAIAAAHA..QEFAhABAXEFCbFCBdFDASFAHGGEB.hCAAKGHB.....hCCA...,1,1,-24,25
cIWbROSVNKfQPLdYEaHeUBJFDMGTZXAgC,CAAA..IAAARACA.OACASAFBKAFA.QCAAhAAAdAHAEBCBHCDBeAHBBCFADCFBGCGAhACAZDBFADHA.gDDDhADAbEGB.fGDALFFB.aFGH.hBDA......hCAA...,1,-11,-16,5
eRcBbgHJMWSFAITDPCXVOGdKZNLaUfYQE,TAAACAAA..OACAdACAZADBLAGBUAGA.QBCChAAARCEFBDGAHFBAMAIBFEHDABFADCFBhCAA..XGFChAAAGEDAaFFA.EGCB.eFHH.....hBFA......hBGA...,2,-18,-10,8
TRgLaYONCZBJHKcPMDbFIeAUdGXWEVfSQ,GAAAEAAA.SADARACAaAFA.OAFDZBFEHCDBKAHB.MCCBbCDD.hAAAeDAB.ADGAdEGAXCGDhACAVGBA.TFGAhADALFFDCDCABEAD.PHAAFGHD....hAEA......hAHA...,2,-11,9,20
WBeVPACLRScHIZEYFQMKNTGbDXadfUJgO,RAAAHAAAEADE.QADC.MAFATAGAGBFAXCCAdCADfBHEhAAAUCGBODEDhAAAeDDBAAFALFCBhABASEHBZGFEKFCBDEHBaFED.gGGB.hAIABHFA....hACA...,2,-5,5,10
FGZIVTeLQACcBWgJRNSXOdPUKfEMaDYHb,BAAAJAAA.RACA...XADBdAFAKAHB..ECAAaAFD..HCDAGBGAhAHAZDFE...TCCAhAIAeFGBAACACDFD..gEEGhBAAOHAA.fFBAMFIB.DEIBFHDEhAAAIHGA..hBFA...,1,-16,-35,19
VegZRYDXOafWGIMFbBHTcCUdEAJKLPNQS,LAAAQAAAeADHRACADAFAOAFA..aAGEGBEAFCDDHCFAhAAATCAACDAA.EBGBACHAKEFDhADASCHHZEGB.fEGEhABAMFCB.BGGD.....hCAA......hCFA...,1,-8,-18,10
GERVBASZHCgOKbeDJLafYWPMdXFUcTNIQ,HAAAOAAAeACELAEAaAFA...fBBEPBFD.dCEAFBHDhAAAUCGATCCA.QECBhAIARDCBAAFAZFFAKGDAbEGDhCAADDBBJFEBMIAA........hAIA......hBAA...,1,8,-17,25
RJCZMYOVGFPeBKgbNfULTQXWcaAdESDHI,EAAAHAAARACA.ZADB.MAGBOAFAGCEA.eAHBKBFA...bCGDfCCEhAAALCCDTGGAhAAAQDAC.XCGAhADAaCAHAFBBDIAACDFDFEDD.BEHD.gFFBhBIA...hACA...,2,-14,2,16
cNgOMfEYLWGZDUPAdTRJBbHQCeXaFSKVI,RAAABAAAHADBeACAFAFAKBHB..IAGA..gDAAhAAAMAIBEBEFLCAAhAAAZDDADDFAADAAdEHAbCFD..QFDChACAaFBDSFFDcGGAOHFEfHEFhADA.....hABA...,2,-16,-6,10
MfJaXHOBYDeTPWEQRLdKcNgGVSCZAbFIU,FAAAMAAA..aACDHACCBAEAeAFE.TBFAEAGARCDA.LCCBhAIA.dDHAKBHB.gDFAhAEAGEDACFFBABBBUGAAhAGAfGHAOECFDEIB.QGGChBAA......hCAA...,2,-23,-2,21
GcXUDEfTPSYVLCBabdJRWNFgMKAHeZQIO,HAAAeAAAZADBQADCGAFAUEFBEAFETCEA..SAHBhAAALAHBaCACdCCCRFBAFDDHhAAAMDIBACGAOEGBDDBBfGGEhABAPFHDCHEA.BHBD.JHDA...hACA......hCCA...,2,1,1,0
MdPKIEDJGFXBHNaUYOVLSbQCeZcTRgAfW,MAAAdAAAKADADAEAGAFABAGA.HCAC.aAHFOAHD.LBBAhBAAbDED.eBEHZECBRFAFACGB.hBCA..fEHAhACAIDBAEDGFFGHD.XFECYHDGSFHBhBDA.CHGA...hCAA...,2,-32,8,40
FOcabQefJdNgWZLMTCIDKXUHYPGRBASVE,EAAAOAAA..aACDeADAdAEA...NAHA.ZAFBLCCAMAIBTDDAhAAADAIBKDFB..HCGBhBCAGEAAAEBAFFFBQECAhAEAfGHAgFFACHBA.IHHAhBAA.....hBEA...,2,-18,-7,11
aYNQCTAZUWcJfeKPBdFSRMLGEHOIXVDgb,ZAAAUAAAJADAeADA.BAGAdAGARCAAGCBB.HCFBOBHD..hABAXDACDCEB.aAHDhADAQDFCADHA.hAEA.fEEEFFCAMFHB.EEHF.gFCBhBAANIAB.CGGD...hBCA...,2,-31,-10,21
eRgKcfBdYaVLMXPQJSFOHZWUNICbGTAED,EAAARAAAKADCBACA.dAEAaAFDLAGB..MAHBQCCChAAAFCCAHDEAZDFAUFBACEBDGGBBhAIAAAAADAIB.eFFB..hBEAfEHA.XGDB.SGFHhBFA..hCAA...,1,-11,-31,20
bQUfMIFCPJdDNXHAgaOYBcLRZeEKTWSGV,aAAABAAALADARACAZAFB.KAHB..TCAAGCCA.QCFAhAEAMAIBCCEC.dDHADBHBHFABhAFAAACA.OBBBeDDBEEHBhAAASEFDUFAAFFFB.....NIEB.XGFAhAHA...hAFA...,1,4,-20,24
gRTaOWCLefZGINBYMVXSQdKbAcJFPEUHD,FAAAEAAAHACARACF.aAEACAEBLAGB.ZCDBGAGA.BCCDhAAAMAIBSCEBhAIAdEGAABGB.PEDBDEIBOFEDhBAAeEHFfFFA.NIBB....hCAA......hCBA...,2,-37,0,37
YDdbUNcMJEeFGgHSLTOQPIXKWVAafRBCZ,RAAAZAAAdADAUAEA..MAFAEAGAGCAAHBEBLBGB.TFFAhAAAQCGA.XDDAhABAKCCDABIBaDHDCCCDbEFDhACAJGCA............hADA......hBEA...,1,-15,-21,6
IXEHAeKYJBgUWaCcDLOMTdQZRGSbfFVNP,eAAAKAAABACBUAEA..aADDDAHB.LBDDMAFA.dDFARBEFGBGAhAAASBHH.FEHBPCCBhBGA..EFEBHEFBhBIAAAAAJGBACEEDOFHD..QGGBhAIA.....hCAA...,1,-17,-22,5
RMOceCNSIaKfZBHLUdXWTPgJbYGVEDAFQ,RAAAMAAAeADE..SACAaAGA.ZAEBHBDAdAHA.TCGA.hBAAJCCFGCCADEEAAAAAQFDAhBHACBBDKCGDLEFAhBGAXFGAgGGA.YHBAEHFA.hCAA......hCIA...,1,-9,-11,2
SWYbVULfZGaHTXgJNIQDdAPKCROcBEMFe,CAAARAAABADBFACA...eAEHSAEH..bAFDLAGBhAAAGCCAHEFATCBAJAHFQDEChAIAAAAAOFEBEGHBhAIAMBIB.VEGB.ZGBA......hBCA......hBGA...,2,-18,-8,10
WaVDJXKPfYdBUSMQTeZFIEcgHRAbGNCLO,GAAALAAAaADADAEAKAGA....fAGAdCDASCFAhAAAMAIB.eCHHZBCEECABHDBBhACAACHB.bEFDODDA.hAGAVEBAXGCABEGATGEA.FGGA.hAIA......hBAA...,1,-7,-10,3
ZVUcDAIYPQWNfLMCOGEbSRgFHBeTKJaXd,..IAAAQAAA...fACFMACAGAEBEAEARAGBHBCAhAHAeCDATCGAaDCCZDFEhAAAcCBCAAIB.PDFBhAIALFGBOEDDbGDC.FFHB.....hCAA......hCDA...,1,1,-3,4
faWTFcUCQHVNJZPgXLAGEYIRSKdObBDeM,EAAARAAAdADABACADAFA...eADHMAIB..aAFAFBFAUBGBHCDC..hAAAVDEBZEEA..XGEAhABAABFBGEGA.SCCDhAAAOCCH.fHDB...hCAA......hDAA...,1,-18,-26,8
EAGWQLJBRbMVTODedHPaYFCUgNISKZcfX,GAAALAAARADAMAHBTAEA..DAIBHAGB.aCAACCDDUDGB.hABA.gCEGhACASCEHZEAA.XEEChAEAAAABQEABbFGDeGAEdFFDFGAHKHEC.EGCABDCAhAGA......hAIA...,2,-13,9,22
cfGMWDgVUSLAZCYJTKaeFQRNIEOBbXdPH,ZAAACAAA.JADAaACA..FAGARAEF....EAGEBCAAdBCAHCFBGCCBMCIBhAAADCFA..UEFAACHBTEDAhAIA..eFHHhABAQFGDOHDA........hCAA......hCBA...,2,-36,-19,17
EPLVZSGYfAdBDgJaHXCUcNFKIeORMbTWQ,dAAADAAA.aADAHABC.CAEBUAGAFAGAKBDA..eCCARBFF..MCCBTDEAhBAA..ECHFLDGBhBGAZDDFSEHHhACA..fGFEADBBBFFBJHFANDIA....hBAA......hBCA...,2,-23,-21,2
bSVZePDUBfMNaCELWKXgYATRIQOFGHcdJ,RAAAQAAAGADAHAFAdADA..SAFAeCCBDCHBBDAAMAIBaCDEhAAAEEFBLFABKCGB.hAFAXFDDADBATEEAFGHBhAAAbGAA.ZGEA.........hABA......hADA...,2,-8,-5,3
LRHGQgOCSIcFbKdMBDEAWZfYTUPJaVeXN,ZAAATAAAUAEA..aACAeAHB.LCABHAEBGBGAQDDAhABACAGCSBDDFCGDdFGAMCCBhACAEEEAAAIB..fFGEhAAAPGBA.........hADA......hAIA...,2,-13,-13,0
FUSTLPNfKBcRgWOCAQYVZMeHJGEaXdIbD,QAAAZAAAHAEAEBHFdADADACAFAFA..SCCATCEA.LDFAhABA..fBHAhAAABEEDRFGBOGAAhAGAADBAMDDBeHAGaDHDbEFDPGDCKEED....gFBDhAIA.CHED.hBCA...,2,-22,-1,21
HcEXSWgfaUYDCPLIbVBRKNOZQdMFeGTAJ,HAAAEAAA.SACE..fACAaAEDDAGALBGBhAAAbADDRAFAOCGDdCCAeCFFAAFAXDCChAAAgEGACEFDIGDAhAIAKEDBNIBB.MCIBFGHD.TGGA..hCAA......hCBA...,1,3,-15,18
QPFEDXfeZaCLUGKOJMWAVgHTcIBRYSdNb,HAAATAAABADB.RAEFdAGAQACCFCAH.EAEEDAIBeAGHZCCFLDGBhAAAGCDAOBHDhAAAMDIB.ACFBgFFAhAGA.IHHASEEBNIAB.bGEC..hACA......hDCA...,2,-19,8,27
FTVgAXZaBPeWGLbRJYKDSOUIHNMEfCQcd,aAAAeAAAGACARADA.KAEAOAGD.HCCAEAGEQCEAhAEAdDGDFEAA.TCGAAAAAZEEABFCAhAEALFFA.YBBFhAIASFHH.IGAAMEEBCHFA...hBAA......hCAA...,1,-9,-18,9
JFQGLdCKXMDbUeaAZcTORgWPYSfEIVHBN,ZAAATAAARAEA......gBGAPACASAFAhAAAECAAHCDBBDHAFBHDGCCAhAGAdEAAXEGCbCFDeEHHAACAOFDBhABAfFEEIGHANIAB....hAEA......hAFA...,2,-14,4,18
YESAPfFBWdgXQKaMDOTGeINbZcJHULCRV,FAAAdAAAQADAMADA.OAFCeAFA..IBDAZABBHCECLCCAhBAARDCBEDHFAAHABEEBhBAAXBGAaFGC.GDEBhCAANHCB.bFFA...JHDACHHA......hCBA......hDAA...,2,-13,-2,11
gMbHZCDTEWNYIRaBcOJPeUKQFLGdASVXf,XAAAMAAAHACCZACBDAFA..EAEA..NAIA.RAGBBCEA.OCFDhAAAeBBBQBFAhBAAGECAAAIBSEHBhABAfDDAbFGDTEFA.IGHAaFFH.PFDDhCAA....hCDA...,1,-2,-21,19
UODFeHRVWdaTLSPGBcfCJYgZXQEIKbMAN,OAAAeAAAHADARADA.dAGALAGBGCCABCFDCBBD.JCHBZCEBEEFBKCDDhAEA.AAIB.DFAAFDHDaFHD.hBAA.SEGDhCAA..fGEA.....hCIA......hDAA...,2,-34,-15,19
BIQgNbEadSFCGVWAYRKLecZJTfUOMXDPH,RAAAeAAAZADB...TADAOAFC.DCCBHAFBBCFAQCCChAAA.bDFAECHBdFAACDAAGEEAhAAAAAIBLFDA.fFHEhABAMEHBXFCBIHDAaGHDFHAA.hAFA......hAHA...,2,-19,-3,16
ACcSHMVEBGaIURdJgFWXZfQDbTLYNKOeP,SAAAHAAAEADEaAFARACF..dAEAFBFDZAFBQCABDAIB.TDCAhAAALDEA.KEHBeAHHhACAAAAAMFFBGEFAJHBA.hBHAWEHB..fGGAYFEF...hCDA......hCEA...,2,-25,0,25
TBeHdgVbDMWJaScRAGEQZIPKUCFOXLYfN,EAAAZAAAKADCFACD.LAGB..fAEATBEA.HAFBdCAA.hABAbDDBMAIB.aCCCRDFAAAHAhAAAGEEAQEAAhAEAIEHACBHBXFFABGBA......hCAA......hCBA...,1,-7,-16,9
fQYFKCcNeAMLEWPHDVdIXgbZOJaRUBSTG,EAAAHAAAdADAXADBZAEB.OAFCRAGBBBCCGCAB.QCFAhAAAKDDDCDGD.eDHHAAIBMDIBhAAALEEB.DFCAhACAIFEAgGGAaFHH.SHAAhAHA..TGCA.hAIAFGFD..,2,-28,7,35
ESVFIKUGRZbNPYDBaXJCLedWOfcMQAHgT,HAAAEAAAFACDKADC.RAFAZCAA....bADD..PCEBBAFAaAGDhAAACCGALEGBdDGA.OFCBhAAAMAIBAEEA.TFAAhAFASFFFUFCANEIADDIB..eFFBfGAAhACA....hAGA...,2,-20,-9,11
fYUcSGHPBRWCTAgONdXFebKVaDMZQIELJ,OAAAdAAAeADAKADADAHBZAFB..EBFFLBHB..fCBAhACAUCCAGEDBHDCARFAATGGAhAFAAADAXCGAFGEH.hAIAaEFDMBBBIFHA.YHEA.hBAA......hCAA...,1,-8,-9,1
ebXQTCDYPfJMFEAGNSHUZcIRVgKWdBLaO,GAAAHAAAZADBRADAKAGCdAGAaBFB..eBHFQCABDCDB..fCEAhAAAMAIBADGASEEAhAAAUEAB.IEHAhACAgEFBBGGAbGCA.CGHA.....hACA......hADA...,2,-20,-15,5
eNfBaIWOUbMKcCEDQHgJXYPAZTRFdLVSG,RAAAdAAALADBGADAeAFABAFA...aBGEOAGDUDAA.MAIBCDFA.hACAECFBHDGB.XFDAhADAAAAAZDCAFEGD.SFAAhAFAfGAAIHHAKGGDDDDB....hCAA......hCCA...,2,-28,-4,24
DYadFbOXGPZHMeLTJRWgNKIAVcfEBUSQC,VAAAEAAABACA.UAEAQADC.DAFAdAHAFAHDXCCChAAA.ZDEBHBFBLDHBhBEARDDBgFCDKGBAABGASGEAhCAAaFGAOHEC.......hCBA......hCDA...,1,-10,-25,15
WSOeBYTUECaAGVIFHdQMRfLPZgDXcKbNJ,GAAAFAAAHACBdADARAEALAHBZAEBDAHB.KCFBJCGF..ODEBBDDDUFEAhAAAEEAA..AAEAQFFAhBAAMAIB.fHCBhCAAXDBD....NEIA.eHEGTGBAhACA...aGGD.hCBA...,2,-19,-10,9
DRFdESbMIHJgQYcCeUWVaTPLBGZNXAOKf,KAAARAAAEADEMACA.HAECQAFC.CAHB.eAHHUCCAaBCDLCHBhAAAZCEFADEBDDIBdDFASEGBhAAAJFEF..gGGAhABA..cGDA.WHAAhAHA......hCAA...,2,-31,-14,17
JVIMQZGXCDOeaHfNSPAFLKgWcTRdYBUEb,LAAAKAAA....gACBTAEARAGFdCAABAEBECCAVAGBhAAAMCIBGCEADDEAeEAAhABAHEGB.SCCDhAGAAEEAFEFD..cGAAbGDC.IGHA.hAIA......hCAA...,1,-6,-19,13
MRHUFJdCWfNXPGcgYbBLZAaeKETQSIVDO,eAAAEAAA.QADASACADAGARAEFHAGBFBFAdCCACCCA....fDAAhAAAXCGAGEDAhAAAgDEAbFFBBDFDhABAAAIBaDHDKFGDIHHAMEDBUGAA.WHEAhADA......hAGA...,1,-4,-6,2
WbZYOBgaeGPJMNLICQVHcfAUFSXDKTREd,SAAAKAAAEACE.dADAZAEBBAFAeAGFGAGAMAIB.LCCAhAAA.QEEAhABAHCCBACCBXCGDRFAA.bEADhAAAODHDaEFC.NIABCDBDfFHADGHB..hAEA......hCAA...,1,-6,-17,11
JQYUOEFXbNKPIfAaBLeHTgdSDRZGcWCMV,aAAAeAAAHACBdAEARAGBGAEB..CBCAMCGBQCED.OBBHhAEAEDDAFDHDXDGDhAFA.bFECKEBA.fFEAhAAAAAHALHCATGAADGIB...cGGAhABA.....hBAA...,1,0,-24,24
PKeBcgZIYSdfUORMAVELbTDHXQaJWFCGN,EAAATAAAHACA.aAEAFACA.GAEAKAHBeCCABAGAZCFB..SAHHhAAAdDHAOEEHACCAbDDDhAGAQGGA.CHAA.hAAAcDFD.gGGA.fEHAhCAAMFDB.DDDB.hAHA...,1,-9,-12,3
VcTIGULOEQgYaSXBRfZHKbJWDFMPeNACd,dAAATAAAGADA.LAFAEACE.QCBDaAEABAHARBDAHCFAhACAKCCD.JEFFFCGD.eDEFhAAAAADBCEHA..VGAAIFFAhAHAOHECSDHH.fGHAhCAA.....hAGA...,1,-8,-11,3
ecMfELagbYZRIXAUPSFDdNTBVJGKCOQHW,SAAAdAAABADAGAEAOACDHAGD.eCAAMAEALDDBhACA.aCHDbAFAZFFARCDFAAAAFGAAhADATCGAKHFA.QEBChBEA.fEGE.EFEF.hAGAgGGA.hAIAXGCD.,2,-3,-1,2
fAHXRCSBLcdTDNQgWJIFPVGbYUMKOEeZa,HAAARAAABADBdADADAFAQAFA.JCAFFAHDGCDBUCCAKBFBEDHFZFAAhAAA..AAAA.SCCDhACALDFA.TFFAhAFA..NFBB.IHBA..bFGBMEEBhAIAeHDAaFHD...hBFA...,1,16,-44,60
JaDXfVHebQGRPSCZMUETOLcKNBgWIYFAd,aAAAXAAAHACBeAEAGADA..RBFACDEAZAFA.ECFALDHBKDAABDGAhAAAIEAAAADB.dFFAhAEAfEFE.hAFAbFGDSBBDUGAAODDHcEDC.WHEAhAIA.....hABA...,1,-4,-14,10
GQKYLHfPCRASBUONdEMZbWJXVFIegTDac,BAAAOAAAEACAZADB..JAEBFAFD..eAGBTCGA..aAHFGDBAhAHAKCAA.HDEBCCCBACGB.hAAASBBA.hACAdFHAbDEDXGEA..gDGAhCAADAIB.YFHBhEAA...,2,-40,-5,35
CAZPVLKgEHORDeQGaUJISXFfTbMYNcBdW,ZAAALAAAEADEHAFBRADFeAFEGCAA.aAHFICAA.FBFDbCDDhABA.MDHB.NDIA.dCHAhABA.ACCBKDDDDEGBJHBAfEFAhACA.TGGABCCDCHHD..PHDChAIA.....hACA...,1,-2,-13,11
FJRYgIdeMKXQCEcUNTaPDVGHbZBOfALSW,LAAAFAAARACF...IAEAeAEEMAIBQAGA.ECAAhABAUCEA.aCHHDCDAHFBAhAHAZCDEfDGAhACAAEDBSFFAYDHBKGHB.CEEATGAA.hBAA......hBFA...,1,-7,-24,17
baWdDTfUSCHVEBYOeFPKMJgAQcNZLGRIX,QAAAZAAARAEA..XBGAaACEdAFADAHBUCAAHCDABCDAeBHHhAAAKDEA.MDAB.ADCBLEFAhADAGDGA.bFBATFAAhABACGGA.EFFB.FGDB......hACA......hADA...,1,0,-20,20
PGDcMKAOabZeISHXFWTgNJVUYdRQfECBL,aAAAeAAAHACBFADD...TAEAJAFA.UAGARBEF..ECCBLDEAhAEAGCGADEEBMBBBAAAAZFFFhAIAXEGA.gFDAhBAA.NIBBdGGAQGDB.BHHBhCAA.....hBIA...,1,-3,-17,14
EGgMQcaSJKbRWNTOLVfFIHZYUXBdAeDCP,eAAACAAAGACAMAEA..aAEAKAHB.RBCA...TBGALBFBFCABHBEBhAAAZDBAXDGDhAAAAAHAEDHFQEBCSFDAhABAbEFDOHCA.fGGA..hBDA......hCAA...,2,-17,-3,14
cdNAeWYHQfKBabCTUMXIZDORSEJPgLGVF,eAAAHAAAQADCBADACAFA.MAFAZAGBRCCAEBFA...JBHBLEEAhAAAGCABFDEDdFAAABIBfEGEhAAAaEHD.bGDAhACATFCA.XGEADEIB....hABA......hAFA...,2,-28,9,37
DXFaGEQdYOTUeKVAfWLBNgbSMHZPcICJR,LAAABAAA..bACAHADB.ZAFA.ICAARAGBFCAAECEBdCGAOCGHhAAAeCCBAAGA...hACAfEEAgDAGhADAMDIBCDDDDDIBGGDBTFGA.KGAANIABSHGAhABA...hAEA...,1,5,-23,28
RDGPaLSbIWOETVHXYUdKMFcfZQACBJegN,BAAAeAAARADAGACALAGBSAEA..bCCAOAGD.hAAAECABHEAAUDGBdEEDMCFBhAAAfDHAAAEA.hACACFHAgGCADAIBaEDDTFGAXGGC.hBCA......hCBA...,2,-21,3,24
VbJRMTfaBYLFeEKPGdIQgNSZWHACXOUDc,OAAADAAA..VACARADAMAHB..aAFALCCA.EDFFGBFAhAIAdEAA.QDDChBAASCHHHEGBAAIBXFGAhAEAbFCAfBBEFGCAeHFEKBHB...hAGA......hBAA...,2,-17,-7,10
YKVaIZHdLMgERcDbSOUNfPTWXeQCGBJAF,KAAAaAAAHACBdACALAEAEAEA.RCDA.DAHB.OBBHUCGA...fBFAhAEATECAeFABhAAAGDEBAAIB.FEDHIFFAhAFAZFFAMAIB.........hAGA......hCAA...,2,-30,-2,28
YZPfEXHCDVLIOFScAeGKBNgRQbadJWMUT,eAAAGAAABADARADAQAGCdAFA.MCDBTCCA.ZAGBECEFHECChAAADCIBLDGBhAAAFDHDABIBKFBD.bFEB..aFGCUEABhACA.fGHACGEAIHHA....hABA......hBFA...,2,-22,7,29
GVWFHEcDSMPIUdgJNLZAbaQeRCTBKYfOX,aAAARAAABADB.KAFAOACD.GAEAFBHDHCCAEAGA.DCEA..MBBBhAEAUEEAdCHA.gEBAhAGALEHBAAAAeDGDhBAACFAA.fEEE.XGGAcGDCSHAAhAFAIHDA.hBEA...,1,-13,-33,20
RZeDTKPLMNbOISQJGUBCfWgcXEFdHYAaV,RAAAeAAAKADCLAGBMAEA..OAHDQCCAGBCACBFA.fBEBhAAA.gDGBhABAEDFBHEGBAAAAZEEBTFBAhAIAPGBANBIASFFDBGGAWHBG...hBGA......hBHA...,2,-11,-10,1
FCbMEVSRHZQAYJaIdGWPXDfULOBcNgTeK,aAAAGAAA..XACDfADA.LAFABAEA.gCDAhAAAeAFHCAHAECGARCFFHEGBhACAABBBJDDB.dGAADDIBOECBhADATEAAFHCE.MFFBZEGFQFEAhAEA.IHAA.hAGA...,2,-14,6,20
UMLOdNBPbEfDXgIcRAeWaSQFZVYKGJTCH,eAAAaAAA.QADAZACBKAEAGAGACAFA.HCEBMAHBdECABCCAEEHF.hAGAXCEA.IEEAhAAAAAIBFGDD.VEGBhABATGFA.OBBBNAIA......hBAA......hCAA...,2,-16,-10,6
VBXUNGMTSICAQaeZgEJLfRYFcbWdDKPOH,eAAAEAAALADARADA.FAHB..bAGBdCBAKCCAHCFABCFAUEDAGEAAhAAAMEAB..TEEAhABACEHAADDAZFABJDHB..fFFBhAAA..cFCADGIBOHEAhAEAXGGA.NICB...hAEA...,2,-18,0,18
YUEBaRVJgeLDTZAMNXCfSFWcQGOPKHbId,MAAACAAAFACA...QADAGAEAKAGAHAFA.dBBAEBCBRCFAVDCAhAHAeCGFLEDBZEGB.hAIAACIB.fFFAhBAA..SFFA.OFHD.hCAAIGAA.BHEAhAAA..,1,-10,-24,14
DFeCGPTXHOYLKNgBbIAZEQRWaMcSUfVdJ,EAAARAAAMADAUADA..dAHAFAFEGBDA..TCBAHCFBLCCDhAAAKBHBBCFA.ABFAZFCEaDEC.hAAAfEHADDHB.hAIAeHBAXFFC.NEIA.gGGAhABA......hBHA...,2,-30,-2,28
ODTHJEAcCbdNSGMUPBaWQYRLXfZgKeFVI,CAAAdAAAGACAMADABAGA..aAEAQBDARAGFLBEBZCFBeCABhAAAFCBDOBHDHDFBACIB..hACA..NEIA.SDDDhAIAPHEA.XEGD.KFCDDIAA..hACA......hAIA...,1,-10,-17,7
DAZBOEcaSJTXWHfQYIUCKLgPbFRGeMdNV,ZAAAEAAA.aACA..TACAHAEBQAGA.UDEBLAEBhAAA.bAGBREGFeCCBhABAdDGDDCCBADHAOFFHSDDDhBGAXGAAfEEB.CFGAKGCA.FGHDhBIA.MICA...hAGA...,2,-8,-1,7
QHbZJISCMGPcfAERKDdNVTLUYegaOBXWF,RAAAdAAA..TAEALADAUAGAeAGH.aBHDXCCAFCBD.HDAAhAAAZDCBSCFDhACAGDFAfDHEEEABDEEBVFFAhAEAOFDBBEHB.......hABA......hADA...,2,-11,-7,4
VdNADHcXSRMBUagYfWITPEKeOFbQCGZLJ,HAAASAAARADFMAFABADAUBGA..aAED....fCAEhAAATAGAECCBeCCBbCFA.hAAAGCEAZDAF.LEHBhACAdEEAAEHBXGACgGCAIGGAOHFChADA......hCGA...,1,5,-12,17
cUJMFXDHRVaSYbKTZeNQOgPWdBLAEfICG,EAAACAAAGACAUADA.FAEAHAFA.RCBB...aAGDSCGAKCAA.hAAAeDDEQCEDhACAOEEB.PCHDdFGAAAHAfHCBhAAAIEBAMEFBDFIB.....YHFGhAIA...hBCA...,1,-14,-20,6
PJUTLIAagFYVZMENdGXBcDKOSQCWefHbR,aAAAFAAAZACB..EADAGAEABAFA.KAGAQBGA.eBBBhADAHCGBRDCF.PEBAUEFATGDAhAHAACIB..gFFBhAGAMFIB.dGDADIAA.CHFA.WFHH.hAIA......hBAA...,1,-14,-17,3
WUIgRdTeLCOVaMJcKDGHXAbFSEfQZBPNY,SAAAEAAAZACBBAEA....PADA..YAFBhAAAIAHARCGFdCBCeBCFLEDBhAHAOBEEaCGEMEIBKDDAhAAAHFFBAEGAbEFAfHBBQFDC...hAIA......hBCA...,1,-7,-12,5
gDHJXIPLfWAVeEBFMRaSTdcUbZCQNOYGK,EAAAMAAARACA...aACEdAFA.UCCBZAEBQAGA.OBBBhBAAGBGADCDBHDABXCFDhBIALEFB.AAHAeEHHhAAASDHBbFDB.CECDKEED.gFGBhCAA....hCEA...,1,-3,-22,19
IQTVRCFaZSMBLfcHOGEWXNYdgKDbPAeUJ,eAAAUAAAQADARADA.FAFEZAGBBBHALCCAHCBCECFFXDGAhAAA.dEAADDABABIBTEEAhABAaDGDMDIBOFHBhAEAGGEB..YGAGKEED....hAGA......hCAA...,2,-16,-8,8
FTQWdZJREOLeaGUSMKIPHYXgfAcbNVCBD,...bAAACAAAFACA.QAFAZADBEAFAeAHFGCBAUCAA.MCFBhAAAKAHBHDDB.XDGAhAAAACGBVEGBDCIBdFAARFGBaEEHhABASGDA.......hACA......hDAA...,1,-8,-12,4
GVTKZBcXdYAgWEaPIOeJFHLfMDNbSQCUR,EAAAaAAA...OACCeACHHAEAMAEADAIBSAGE.QCEBhAEARBEAGCCATEFAhAAAZCGBXFFCACCB.PDDBhBAAFDHFLHBAfGHACFEDKGHB.BHGDhBHA......hCAA...,2,-10,3,13
WPFEJVHbBdATZMYfSCeDgGRQUaILKXcNO,ZAAAMAAASACEDAEAGAGARAEF...aBBALAGB.XCCChABAOBDDFCFH.EEHFhAIAHEEAdFBAACCBTGCAhAIACFFA.eFHF.........hBAA......hBFA...,1,-7,-32,25
UJWgLXGAYVHCDNMPZEFcadbfKITRBSQOe,HAAADAAAMADAEADEaAFA..dAHAKBFARBBABBEBQCAB.eBHHhAAAUDDA.JCGFLDDAhACAGFEB.ACEBCEHAZGBAbFDA.hBAAIHHA........hAIA......hCDA...,1,-5,-33,28
GFLMXRZVYaJPefEQUdDNCTKcSOHIbgBWA,GAAAMAAARACA.ZADA.aAFAeAFE..EBHFdCCDDCDATBFA.SCHHhAIAHDDAbEACBDHAhAAAABBBLEEBXFDAhACAYEGFfGGA.NIAB.KFDD...hAEA......hAIA...,1,-6,-12,6
FOKefGBCDPUSXcHVQYZdLRMaTNIbEAWJg,JAAAOAAA.KADAeADEGAFADAGA..UCCASAHB.HCCAhAFAQBGAdDHARECAaFEEhBAATDFA.IFCAhBAAABBBFGHBCHBA...XFDD.cFFChBEA.....hBHA...,2,-31,-13,18
PFQadecHWbKGBZIYOETRNXUVDMgSJfLAC,FAAAdAAAHADAKADAZAFBOAFA.RCAA.UCCAMBIB..SAHHhADALCFBACHB.QEDAhACAeDFA..bEFABEHDhADAEFAA.TGGA..XFCA.hBAADGGB.fHBBhAFA.CHHA,2,-33,-13,20
SYRAKXTZUJGHOPLVMaeICcQbgDBFfENWd,TAAAZAAAGAEA.HAGDLACBaACAeCCBCAEAQAGA.hABADCEAfDGEhAGAEDEAdDHAREAAAEAAXEDDUGABOEFDhAAAMCIBbFFDFHEC.NIAB.......hAIA......hCAA...,2,0,1,1
BeYfENFRLZIbUXSgOPHAQCJWdKTVGMcaD,QAAACAAAdACA.KACAGAEA.aAGAeAEE.EBEFRBGFZCBAbCFA.hAAAUEAA..SCDDhAHAODHDHEFBAAIBTEFAhCAA.MFEBBHHAfFHA.hAAAFGCBXGBA.hCGA...,2,-15,-12,3
IFNZHfMdeABSLcWPVbXJOEDKgTGUQaRCY,LAAA..PAAAbADD.OADCEAFAKAHBGAGA.aCCAhAFARCABCCCCFCFHHCFB.dDHAhABAAAIBSDDDhAGAVFCADFABTGGAQFFA.NDIA.....hBAA......hCAA...,1,3,-24,27
deTDMKPcNSCHUbLQagfOFRZEWBJAVYXIG,XAAAdAAAeADAMAHBKADA......PAFASBEAhACAHCDALCGBaCBDOCHDhADARDAAEFCABDDAAAAAIGEAhADAGDFATFDADBIBCGGA.bEAC.fHGFhAEA.....hCAA...,2,-19,-1,18
NSgLAeDRfacPHQXVKBGJIMYFOTbUdEZCW,RAAAaAAAHADB.QAFAKADAGAFAMAIBOAHFUDAAZBBA.CDAA.SDDAhAAALEEAADDBeDFHhABADEIB.fDHEhADA.XGGABFAAIGGAFHBA.dHABhADAWFAAgFDGhAFA...,1,14,-26,40
CUDHJWSAXKMdPebcLFZEGVBaTQOgNIYRf,MAAAeAAALAEAZABEGAEAaAHD..TAGAQBCD.OCEDhAAAgCCB.hABAIDGARDGBCFAAHGACSDHHhAGAAAFAdGDAbGFA.EFFB.BHGA.NIAB..hCAA......hCBA...,2,-9,3,12
TVDFKJgWfNOLXEUbQdeGPMZaHRIABcYCS,BAAACAAA.SACATACAFAEAKAFA..JAHB....fBHAhAAALCABECCBbCAA.hACAeCEBGCEAZCFFaEEHhAAAHEGBADIB.VFAADFIB.NIABOGDCXGGD.dHABhACAMIFAIHEA.hADA...,2,-10,-5,5
eAaTOgNXBYLRJVcQbGdKPESIDCfMFUHWZ,aAAATAAA..OACD..XACBLAEARAEAVCDBQCEAhAFAdAHAECGBDAIBMCCBhAAAHCGDeDHHABBBBECAcFAAhAFAGGAB.SEEDfFFAFFHD.hCAAZFFF.....hDAA...,1,1,-7,8
dOLATBUScCPDHWZFgeERQVYbaJXMfNGIK,TAAASAAA.CADA.HACBZAEB.eAEARAGB.QBGA.hAAAbCEDaCCBMCABGCFAhABAdEDCAEHABDAAUGGADDDBFFADhAAAEEEB.JEHBfGEANIAB....hACA......hAEA...,1,8,-19,27
MLAEWQHFeXTYIaDUcgRSBJdKZGPONbVfC,EAAAHAAAFACDeACE.TAGAaAEA..DAHBUCCARBDF.BCFAdCGDGDEAhAAAOCHD..bEDACEGBAAIBhBFAQFAA.hCAAXFGDIGGASHDA..hAAA......hAFA...,2,-29,-7,22
KTZRgIdNGJSBLUCObYfMWPFAVDeEQcXaH,eAAAEAAA.QADAaACDHAEAZCBARAFA.dAHAGCCABCFALDHBhAAAOCFEbEFAMEAA.FEFAhAEAAAAADEFAKFFD.TGAAhAGAgGAAIGGA.NICB......hAGA......hBCA...,1,7,-6,13
WTZaJNDXdYMbSKRcAEUQOgfCGPLHVIFeB,EAAAQAAA.OACCCACAGADAHAFBFAFAeAHBBBHAZCDFaCCHDDDBhAAA.dEAAMCGBKDGAAFGAUFBAhAAA..fFHAhAEALEHBIFEA.JHDENIAB...hAFA......hAIA...,2,-17,-7,10
EfcFTDPXAOBVYLebRGaUdCHgMQNWSZIKJ,BAAALAAARACAGAFAdAEAHAGB.MCAAQCAASDDAZDDBKAHBhAAAEDGBFEBBDDDBAACAOEHDhABA.eFFBaDHBCFAAgGAAhACA..IFFA.fFHAhAFA.PHAAhAHA.,2,-32,4,36
fLAFRMUGgeWaScVPbdBDJHEZKQTICNXYO,RAAAGAAAeADE.aADA..SAGB..PAGBdCCADAIBHCDBhAAAEBEBZDFBTDGACDHA.hAAAXDBDOEDDAFHAMAIBhACA.gFDA.cGFBBGCDKGHBhABAIHAA..hAHA...,2,-19,-13,6
RGSIBNQdDVMZHXTPFLaJYCcUEeKgAWfOb,OAAARAAAGADABADAdAFBDAIBZAEBHAGB..TCFALCCB.hAAAaBBHCCCDEDABeDGBADIB..hAIA.bEEDSEFAhABA.QGBAMDIBFGBA.cFEC.hBAAKGGC.....hBGA...,2,-10,-9,1
JQZDLMUCAdEGcWNRTOKHeISbPYFfaBVXg,EAAAGAAA...NADA.RACATAGAHAEAeAHHSCCA..hAAAbCDDFCFBaCFDXDAChADAQEABZDGBMEEBhAFAAAABdEHAOFGHKGAAIHHAfGAEBFFC..hACA......hAEA...,2,-4,-2,2
ZYETfdWMUROQbHKcJPBeVGSIgDaNCFXAL,ZAAAEAAAdADAMACA.RAEA.QAFAHCCC.KAHBJBHBBBCCGDFASCDAhAAADEIB.aDEEFFEHhABALDHB.TFAAhAFAfGCAUFFA.......hCAA......hCBA...,2,-19,-16,3
NQALMFgPaREWfeDJHCTZbGBYdKcVISUXO,MAAAFAAA..aACDEADA..eAEAHAFAZBEEGBBAdDDDKCHBICHAhAHAUEAA.ODEBAAIBLEGBhAEARDFFDEIBCFCABFFAYFGBhAIA..SGDB...hBAA......hBBA...,1,-10,-25,15
OaGERBSYQDAKXMCFHTZbfPdVJeWLcIgNU,MAAAHAAAZADB...bAFAdAEA.eAGBLCCDIBBAUDGAGCFAhAHARDEFSCADhAAAQDBAAAGACGCA.TFDAhAIAfGGAPFHBWHCANBIA......hACA......hADA...,1,-3,-10,7
XgIBafYGUDbdCWKOPSTcAeQVEFNLJHMZR,eAAAEAAALADAHADARAGF...XAGDBCCAaCEDGCBADCIBdEGAKDDChAAAOEDBTDFAAAAAFFAAhAFAMDIB.ZFAF.fFFEhAEAbGFA.CHDASFCHcGAC..hAFA......hAIA...,2,-9,-5,4
GPeXIBROcWaYEdCVSFNAfDQJgZLbMKTHU,QAAAZAAAMACAHAECGACB.eAFEBAHBRCDAOCGDaCCCdCEASCGAhABAACIBDDAALFEBhAAATEFAXGCB.hCAAIGGAcFGDEHCA.CHEA.....hCBA......hCHA...,1,-2,-16,14
ZEdLCTObAWgMReUHQBJDcXKYaGFSPNIfV,MAAARAAAHADBBADADAFAKAHBGAEA..SBFB..IAGAhAIAZDAAECHBdEEATBBAhBAAAAAA.eBHFQGFAhADAXDDD.aDGH.FFHDfEHEhCAA.CCCD.....hDBA...,2,-21,-18,3
UTKgcGVOIaFfQMdCYJLXADBbWeZRHSPNE,BAAAeAAAHADASACAEAGEKCCAGAEA.OAGFaCEDQCGAhAAAdCAACCCALEDAAEGBbFAARFFAhABAUGAA...TFGAhAAA.VGDAIHHA.MIAA.hACA......hADA...,2,-11,4,15
DWZNBQVJSTXPOfEaeRLIYCAMcHKUFgbdG,HAAAFAAAdADAGADAZAEBBAGAQAFA.SBHBTCGA.hAIAOCABECCB.RDEFLDGBhAAACDBDABIB.MCCBhACAKEEAUGCAbFAADEIBVFGB......hBAA......hBDA...,1,15,-28,43
IHgeLbEcZUNVWJfCKOPaMXBRSQDFdGYTA,HAAAeAAAEADAZADBVAFA..JAFBKCADaAHBBCCC..RCCBQDGAhAAAdDFAGEGAACIBLFEBhABAUFCA..NIAB.CGDAMECBhBIA.DGGA........hCAA......hCBA...,2,-17,-16,1
QabEAgWNUXCBZdLROYPSDeKMIJGHfcFVT,...NAAA.CAAAdACALAFARAEA..OAHDSBBAeCBBMCGBhAAAGBDA.HCFBFDDAQFAChAEAECHBAAGAUFFBZDABhABADDHBKFFDfFCA......hACA......hADA...,2,-26,-7,19
SKVRFDEQgTPdbHMUICGXZNecBYAOafWJL,aAAAJAAALADB..KADARAFA.EAFEQCFBTCCA.dCCCHCEBhADAUEFBGDGA.hAFAZGCAeFHHBAHBACIBfGAAhAGASECGDBBB......hBAA......hCAA...,1,-17,-19,2
UdQLAVaZPXRcEObBWNGFJSHKTYgDfMCeI,ZAAARAAAEADEBADB.GAEASAFBHAGDKCAA..TCCADCIBMDDBhABAeAHB.dCEAAEEBaEGBhACAXCGD.bFFAFFHBhAGAJHFA..fGDACGDA....hAIA......hCAA...,2,-22,-7,15
JIVeUCNBLRfKgQHTGbDYcASEXOPWMdZaF,EAAAOAAA..MADAaADD.FAGD..IAFAeBCACCBD..LCFAhAAARAGFKBBDHCDCGDBBhAIAbDBD.DEGA.AFFAXFGAhBCAdEEDZEGB...JHFANIAB......hBDA......hBIA...,2,-16,-9,7
SPWFATBcDCZMJgKORQYEVUIaGebNHdXLf,TAAADAAAZABE..MAFAKACCRAEA...EBHFUBFAGCCAeCCAHCFBhAAAdCHALDABSDHHhAFAFEEAAAHACFFD..OFGDhADAYFDB.aGHBNIBB.......hBAA......hBIA...,1,0,-25,25
bXIdYcZaSFUAQJOEeWMTfDVKLGPRHNCBg,QAAAEAAA.eACAMADADAGALAHBRBDAHBGBBDAAbBCAdCGCZDDAhAAAaCBCFEHD..ABGAODEBhAAATFDAKGBAGEBAhBCACGGD.XFFA.......hADA......hBGA...,2,-10,-1,9
UeHfASbPFgBDLOVdXWRMQCaYNIKGZcETJ,SAAAFAAADADALAGBdADARAFA...MAIBaCCC....ICHAhAAAZBCBEBEAUEEAHCEBAAFAhABA...bEGDBEHAhBAAXDBCQGCCCGDANIAB.KGHB....hCAA......hCBA...,1,-6,-28,22
JEFaVISRfeMDCABLXHdZPQGTWNbYgUOcK,LAAAHAAAZADBGAFATAEA...bDABUAGA.KCAAEAHBaCCASDEHhAAA.RDGFeFBHhACAMDDBADHAdGGDQEAAhABANIDB.OEEA.FEHD.fFFEhACA.BGDAhAEA...,2,-23,13,36
BKJQMYbOFfZUNLCcHSGeDXAaVIdREgTWP,aAAAdAAAEADA..TADABAFAQBGA.MCCAbAFBfAHAhADAZDAALDDBHCCAhBAAeEHBABBBRDFA.gFCAhCAAKFFAOHAAFFFHCHHD.SHFADIEA.hACA......hADA...,1,4,-13,17
DOUWZLYGMeEIcNSCTRQHJKVXFdBfbAgPa,aAAAOAAAZACB.GADA.EAFAIAFA..SAHHhAFARAGFHCEBKBBDFBBHdEBAbCFDACIBDEDBhAIALDHBeEGFCFHATFDAhBAAQGDAXDBABHHAfGGEhBDA.PHBC.hBAA...,2,-12,11,23
FWMRXYIebCTBLaQVAfdKgZGHDSOUPcENJ,dAAAZAAAHAEAOADAUCAA.EBHFFAGD.RBDB...XCDDeBHHTCBAhACAaCGH..AADAKEHBhABAGDFASFDAhACA.PGACcFCANIAB.MEIB..IGGAhAGABHGA....hAHA...,2,-14,-12,2
YcTXSGRUPdJMFBCLQZNgKfHeIWOVbAEaD,EAAAaAAA.DADA..TADAGAEB.RBCBdCEAMAFABCBDLBGB.hAAAZCCAKCGAHDAAeEFAODHDhADAAAHA.XEEChBAASFGAPFCBCGEANICB.fGGA.hBCA.IHHA.hBBA...,2,-21,-8,13
MePIaUfGCJEWXbNHgYdcFTASBDOVRQKZL,DAAARAAAZADBeABA..aAFDGAEA.EAGAXBGDHCCBdCHAFDAAACCBODGHhAGAKDEA.MEBBhBAAIEHA.CAHB.WFFDhBEA....bFBA...gFFBhAAA....hABA...,1,-10,-34,24
ZeOQfdbNKaJDFLVEYRGcUgIWACPMSXTHB,MAAATAAAHACC.eAFEQACCdCCAKBFADBBBLAEB.EAGAhAAARDFAGEDAUCGAgDDGhAGAACIBSFHBZFGBbGDChBIAaGGB...........hAIA......hBAA...,2,-14,4,18
eDOXMBbFfHadYQVSIJEKGRANPLWUZTcCg,LAAAZAAACADB.eADHOAEDMAFABAGAFBFAHCAB..dCAAQDEAhABASAHHECHFhACARCFFACCBPEDB.TFGAhBIADDDBXEDDaGED.VGAA.KEHBWFCDhCAA....gGGBhABA,1,-4,-24,20
IRNKcEMHZDaYLWfSJVTdeUPXQCgFbGBAO,RAAAKAAAEADEHACB.aAEALAFB.SAHBTBGAdBEAeBHDhAAAXCACQCCAhABAFDFDGEGAAEFAOEFEIHAAhAAAMFCBDGGA..YEEF..hACA......hAHA...,1,-10,-14,4
dUPSfgCJcbLXeQGMEDAOFaYNRHKZIWTBV,aAAARAAAHADBZACB...TAFAdAFAUDEA..fBHACAHA.hAHAJCCFbDGDLDABhAAA.eDGBGEBAEEEBAAHAhABAFGEBKGFABBBD........hBAA......hBEA...,2,-28,0,28
ABSUKDZYJRCWLcXFgVdOMbEIHaPfGNeQT,SAAADAAAZABERAEF.LADAFAGA.dAHAMCCBECCAHCEA.aDGEhAAAGCGA.eDABhADAAAEAKEEDCDDA.XFGAhABA.OGCCbFEBfGCA.QGGBhBAABHBD...hBHA...,1,-13,-16,3
KDfgIJbVBHPWUZaQdFGXLSERNAcMeTCYO,eAAATAAAOADC.DAFAIADA.JAFAbBEA..HBDChAAAUDCAaCACdDGDGCGAhACALEEBRDDBACIBMFGBKGGA.hAAAfGDE.BHHA....hAIA......hCCA...,2,-26,-6,20
YPLTXdMHaUNgGfFZEICAeScDVWBJKOQbR,eAAADAAABACAOADCRADF.LAGBdAFAHBGBaCCAUDDB..GCEAhAAAZFGB.EDHFAAHA.SDDDhABA.cFAAhAFAJBBFQGEB..bGFA...hBAA......hBIA...,1,0,-31,31
FDZKWXQfbVYBEOIagRMCdALeJSUcNHTPG,eAAASAAAUAEAHAGDGACAZBAEKAEAQDDA..bAGBhAAABDFAECEA.aCHDRDFBdEAAhABAAAAALEBBJEEF.TFGAhAIADBIBfGHA.....hBEA......hDBA...,2,-10,-8,2
ODaGNSbAeWIKQCUTRMVfHXJdFcEYLBZPg,eAAAKAAAQACCCADA.RAEF.MAFAHAGBdBFAEDDBLBHBZDFEOEABhAAAGCCA.bEFCAAIBIFGAhAEAUGEB.TGDAhAGA...fGHA..hCAA......hCBA...,2,-21,-7,14
BNZOQCbYfGAJgMUEIdeRDVKTWFSLPacXH,MAAAEAAAdADARACA..KAFCFAFA.LBCD..aAHDHBEBZCCAQDGAhBAAbCGBGEFAAAIBUECAhBBAeFHHDFFB.TGGAhBHAWEED...........hAAA......hCAA...,2,-21,-9,12
fIHAXLQagdeSDPTMJOWVNGRCZBEKUcbFY,LAAAaAAA.eADHDADAMAGBOAFA..VBCARBEFZCAB.EBHFKAHBhAHAUDGBFCHH...IGBAhABAHDEBABBBQFBAhBAAdFFDSGHHTGGANEEA.BFHB.cGEChBFA....hCAA...,1,-2,-23,21
GINYbWEUKOASPXJTBLMRgfHCVdFQDacZe,XAAATAAA.LADARACFHAEBdAGB.QCGAaAGDeBHHGCDAhAAAIEAA.bEDAECFBhABA.ODCHACAB.SEABhAEABDEDMFHBCEHADFABNHBB.UGFA..hAFA......hAIA...,2,-2,1,3
gbEKXBGPCcAOfIMZUFeWHLJNdVTQYRaSD,OAAAMAAAZABEFADDHAEBLAFAdAGB..TCCARCDADBBB..ECGEBBHDhBAA.GDFACEFAAAGA.hBAAfDHEeCCDJEHB.hCAANEEA.....YFEFaHGE.SGGDhCIA...hCAA...,2,-19,-14,5
JSPcQWGaBXdCMURIgbHTKAOYFLDfVeZNE,FAAALAAADADA.eADHEAFA...SAFAQBCAaAHDdBHAMCABhABARCEF...bCEDHECBhAIAACCB.fEHAhBAAZDGBPFACGGEBCEDCgGCA.OFHDhACA.....hCAA...,2,-18,5,23
ROEKMBLQXagbeGdZYDJcFTANICPSVfUHW,CAAASAAAUACA.HACBRAEA.EAEAMAIBLAHB.QCEAhAAAaCBC.eEAAZCEEDEFAhAAAFEEHABGA.IEHAhABAfEHAKGDDXGFAGFABdFFA.YHAAhAFA....hAHA...,2,-30,9,39
WOgPZaVQEABCdXTGReKDMSUNYIJHcFfLb,dAAAGAAARADADAGAMADA.UBFA..IBHAHCDBFDHD.LDCDhAAAOCAEZCEBaAHDEFFBhACAADEBBDGACGED..eHAAhAHASDHH.JEAAfHGF.hACA.bGDA....hADA...,2,-39,5,44
AKGNQTYILVZSJMfeEUCdBgWDbPFRacOHX,GAAATAAA.LADAZACB.MAHBEAEAdAHABCDADBGBFCFBRCEBOCABhAAAHEACAAABQEEBhACA.IEHAhAEASDGHfGGAeECBCFHAgGGGhACA.WEED.aHBC.hAFA...,2,-14,-4,10
AEJgHXKZTYFfWVUODLbRMcIPdQBNeCGSa,EAAAHAAAZACBTAEA.FAGAVAEA.DAIBRCAAMCEB..IDEAhAAAdCGAQEABhAAABCBCeCGFGFDBADIBXECChAHAfGHA.WCHHLFFA.PHEAhBCACDFC....hCAA...,2,-24,7,31
MZKGNXbaDPYFJgHOERAIVfULcBedTQSWC,VAAALAAA.eADHdADAQAFACAFA.ZCFAGAGA.hAAAbCABaDDBDCFBFEEAHDFBhABAREGFAAIBUFAABEDASEHHhACAMICA.XFAA....hAFA......hAIA...,1,-11,-16,5
OZNgGSIJHTLCUfaWAQXKDFdBecREMYPbV,QAAADAAAdADABAFARACA..EAFEMAHB....bBFAZBBBGCDAhAAASCFBHDABTDGAhADALDDBfFFAhAHAAAIBFDHDeDFDcGDCVFAB....NICB.IGHAhAIACGHA...hAFA...,1,22,-26,48
UOHPXDaJWRcfBLYQINEAeMKdGVbSZTgCF,eAAAdAAAGADA.SAFAZADBTAFAFBHDHCEB.DAIBaCAERCGBBBCAhAAALDFBQFGBhABAEEHBAAFAKGCA...hAHAbDAA...CFEC........hCAA......hCBA...,2,-17,-13,4
QbFDWZIBSXUeAgPEdJcaGMVYNOfRLHCKT,EAAAdAAAaADAGACA.MAEA..VAGBOAHDRBDBHCACKBECQCFDhAAADDGBZEGBBFCAXEDDhBCAAEFB..gGABhACAcFFA.NIDB.LFHB.CHBA..hAGA......hAIA...,1,-2,-18,16
bIAEPaHUCYeGSDKVTXcBNOQLfRWMgFJdZ,EAAAHAAAUADAeACEGAGAKAFC..TBGABAFAQCBChAAARCCA.MDEBFDFDZEGBAAIBaDFBhBCASEED.hBDAXFCDODHDfFGEWFHH..hCAA......hDAA...,2,-21,-8,13
cFDbELJXPQYfUOINMgHadAGKSeBCVTRZW,GAAAeAAACADA.RADAZAGBFAFA.DBIBLBFA..XCDAQCCAhAAAUEABODFA.hAAAMEFBHEECAEGBBEHAhABATGAA...cFGDEGGA...YHEAhACANIAB.aGCD..hADA...,1,-16,-18,2
SRELQNBPTdHZbIGgcXeDYFMWfaJKUCVAO,RAAAEAAALADBBACAdAEAHAFAZAFB.GCEA.XCGAeAHFFCCBMCCBhAAAaCHD.KEGA.CFAAAAHAQEBBhAAA.TEEAhBEAgGGADFHBfGEEJHCA..hCAA......hCBA...,1,1,-23,24
DROgBMKUNFCHfJZYTXcLSQGIbEWeVdAPa,aAAARAAABADB.KAFAFADA.HAFBZBFE...TBCALCCBGDEAhAHAEDGA.eBBDAAAA.OAHFhBAAMCEB.CDGAJEHB..hCAAXEGASEDDbFAC..dGGADGGBgGDAhAFA.fHAFhAHA,1,-12,-20,8
PTXfSJQZDBYdVEKgLcReCFHMGANabOWUI,aAAAOAAA.UAEATADA..SAGAZAFBBAHAdCCAEBBBLBDDhAHARCGFeDABHEDAACHA.hBAA.bDFAIGGAhADA.fFCEQFDADBBBKFGA.CHDD.MEIBhAFA.NICB....hCAA...,1,5,-20,25
XOVDQacCeHSMWNJBTdEIKgULGRAbfFPYZ,FAAAZAAAOACAQADA..aAFDeAFAHBGBMBIB..JCCFdCCAhADAEEEAKCFALFBBhABAAEEAbEDA...fEHAhAHAXFGDDGAASFGDBHCAIHEAhAGA......hBAA...,2,-20,-10,10
gObAEUSJaBNZKDCXHQGMFRVWTfYcdPIeL,EAAASAAABACAZADBCADA.HAFAGAEA.RAGB.TCGA..fCCAhAAAdCCCeCFDLFFAhAAAbDAD.AAHAaHFAhCAADDABMDEB.FDGH.YEHB.PFFBhABA....hADA...,1,-9,-18,9
REdIPQSUZgFWLAGVHfTbOKYDeMBNCXJca,HAAATAAAKADC.eAFAMACABBHA.CCAD.XAEA.aAHBECCAhAAAdCCAQCEAhACAZCDBFCHDADBAGFDBbDGB.DFIBhAAAcEECPHFCSFHH.gGAAhAGA...hBDA...,1,-6,-11,5
XKcfUZJWPRIVdBSgYCGaMQeEONLDTHAFb,XAAAKAAAUACAZAEB..JADARAGB...dAGABDDDSBCHhAAA.CCEAGDEBaCFDeDHFhAAAEECBLEBBHFFCAAIBFHDAhABA..bFFD........hAIA......hBEA...,1,-11,-31,20
HaYVObMfEcXPAJWZDTRgCUKNSQLeGdIFB,ZAAARAAACADB.KADC..QAFAeAFAdCAABBHAHCCA....aBHDOCCBhABAMDGB.ECGBXECAhAAAADEA.DEHBTEEAhACANEIA.GECAFFABbFEDfEHA.hABAcGAAPHBAgGEAhAGA,1,-15,-17,2
adSRJDLBXTGOPHYeZUfQACVcNMIWEbKFg,CAAAVAAA..MACAEADE.FAFD..dAFARBCBLAHBBAHAGCDAHDFAhAAAeCFAZEBAUFFBACDB.hAAA.IEHAKHBAaGHD.hBCADFFB.TGGA.OHAA...hBEA......hBHA...,2,-17,-13,4
RPOFVXJAaTMKdfEWDbSQcIHLgCZeNBGYU,aAAAMAAA.dAEAEADADAGA..QAFAHBBBLBGBZBBAeBHHGDEAhBAARCEFFDAAXEBAhBBAADDBTFGAKEHB..fGEAhADASGCAIHBACGGANIBB....hAIA......hBAA...,2,-11,-6,5
TVYOUaLFBSGJRWcNbPCMEAHedQgIfXKDZ,HAAAeAAAdAEAQADC..fAGADAFAZBFBTEDAOAHDhAAAaAHDLBDDBCADGDGAhAAARDFAcFDAbCCCMFCBhACAACCBXGAA.KGDD.UGGASGGDhCFA.....hABA...,1,14,-8,22
HMRcYZJeKBXLSDfTIPNWQbGdVOUaACFgE,FAAAHAAARACFZAEBeACE.XAFBLAHBDAIB....TDFAhAEAICCA..PECBhBAAQCECdFFDOFHDhBGAABHBEDGAMEDBJHCEBBGAfEHA.bFFDhAAA......hCAA...,1,-12,-19,7
XFQDKOAgfTCZReMUBaYSIJEPHbcGWVLdN,TAAARAAAeADEBAGB..aACA..SAHHEAFAHBFCGCCAhAAALCCAdDBCFCGHQEFAhAFAODHDAAAACBDAMDIBhAIAUFEAIHFA.......hCAA......hDAA...,1,3,-31,34
RIUFHOAWBGVYNbLKDSMaQcfePdgZTJXCE,GAAAVAAA...bADALADB.SAFAaAHBQCDAhAAAeAHHdCFAZDFBTFAAhACACDCDREFAFFAAHFDBAADABDCDKGADhAAAMBIB.fEHE.gFDDhAFAEGHB.IHGAhBAA..,1,11,-9,20
QcAPUEFdHeXMSBYLZVOaDJNRCfKGWgbIT,EAAAHAAA.eACEMADABAFBZAEE.aAGDDAIBRCCA.KBCBGDFA..bCEAhAAATFCA.AAIBFCHDhAAAdEEASCBDhBCA.LFCBOFHDCEECfEHA.hCAAgGEA.hCCAIHHA.,2,-14,0,14
GHBKOQeFTbADJMaEcURLCfVgYXPWSZIdN,MAAAEAAARACA.LAEA.CBBA.fAFB..gBDGhAFAXBGASCCAhAAAdCGAHEEAODDBeCEHbDAChADAAAIBaEHDVDGBPGACZGDAIHAABGGD.hAGA......hBAA...,2,-15,7,22
RTbZVEeMdYCWUINGAgFfOSHLJacPKDBXQ,FAAASAAAHACBaAEAKADA.BAFBRAGF.ZAGBECEF..eCCAdDGDCEBAUEEAhAAAGFBBABIB.OFEAhAIALDAB.PDHDhABADFIB...TGCAMICAIHGAhBAA..fGHEhADA..,1,-14,-17,3
MecQTCBDGFfSXJEObLPgdAHUWaNVIZKRY,HAAAaAAA.VAEAZACBRAEA..eAHHQCEBTCCA.DAIBGDAAhAAASCGHEDFBLEHBhACAdFAAABBBUFFAIGDAhADAMDIB.BEED.fFGAOEEH...hAFA......hAHA...,1,15,-19,34
fZSRBeIAdFMVDaPHXJQLgCGKOcYUNbTWE,dAAAMAAAaADAHACC.QAFCLAGBGBDAOAHDUDCA.hACATDGAECBAZDFEREEFeHAAhAHAAAIBDFCBXFGAhBAACBBD.KGFDcGGA..bFCD....hBCA......hBDA...,2,-13,7,20
PMKNSEOfAJCdHFRTXcYQgbGBWIVZUDLae,dAAAHAAARADA.TAEA..XAGBQAGCGCABBCADICFAhACAZCCALDGB.hADAeEAAMBIBSEEAhAAAEDGFAEAAFEEB.YFHBbEAAUGGADCIB...hAEA......hBAA...,2,-10,6,16
IfXMFLUgWNaJRDAESKVHbGPYCOdQeBZTc,EAAAKAAAHACBGACACAEA.dAEBBAGAZAGB....TEDAICAAMBFBhAAALCFAUFGA..hAAANCBA.REAAAAIB.SDEDhACAbGCA.OEGB.eEHH.XGAAhAEAWBHHDIGAYHEAhAGA..,2,-14,-7,7
HQCXWSfLEYATJNRBPDKeadOUcFIgZGbVM,TAAARAAADADA..eAEAdACAOAEA.FAHDZBEEGBDAMAIBHCCBhAAAQCFCXDGChABAfDHAEFDAACCBBFGAhCAAaFBAUFGB..IHDA...hAAA......hBFA...,1,-12,-15,3
BdJTIeYVQcLGaFHCAWNgZSKDREbXMfPOU,...NAAA.ZAAA.DACAEAFAMAFA..OAHDdBEAJBGBeBBA.QCDAhABAGECAHEEAhABAABBASCGDKCCD.hBGARDAFbEFAfFHABFDATGGAIHEAYHBAhACA....hADA...,2,-23,-14,9
PJMXZRYgecTIObBSfLVKGUFaCWDHANQEd,EAAAdAAAMADARACA..eAFE..TAGAOBEESBDAhACALDAAGDFAaCBDDCGBHDDBhAIAACCBQEDAXDGDhBAAYDHHgGGAIHHA...hBCA......hBDA...,1,-6,-16,10
XAEDUeSdTFOQbHMNJYfaWKPgcBCVGZLRI,EAAAeAAAdADAOADCHAFAMBCB..JAHBaCFCKCCA....gDDBhAAACCEBZDFERFAAAAAADAFAhCAATEGA.QFAAhAFA.bGECfFGAWHAA.BGDAhCBA......hCCA...,1,10,-39,49
LSZOTUCGBVINFebAQfXMaWDRHcgEKJYdP,QAAAMAAADAEAHAFCEACA..KAEAdBBALAGBZBCBOCFBUCDAGDGAhAIABDHA..IFDAhAAAeEDFACIBaGCHRFFA..hBAAgGCG.......hCAA......hCBA...,2,-16,-14,2
NCGefTLaYJAgEHVDZOIUbFMcQPdBRWXKS,HAAAZAAAOACAUADAMAGB..QAFAdAHARCAAKDEA.CAHAeCCAhABALDHBaCGE.AEDBEEGFDDFBFEGAhCAA.BFGD.SEEDhCBAfFBA.YFFF.JHBEhAAAIHHA..hCCA...,1,-5,-28,23
cAeTgEaPdUVDOMRIZBGXCWJbYQFSNfHLK,eAAAEAAAdADADAEA.RAFA.ZAEBGBCACAGA..JBHBQCEC.hAAASCGHHCBBLEEBhAIAAAAAaDHD.PEGBhBCAOEBBMEIBXFFC......hAIA......hBEA...,2,-19,-19,0
dJOXTbVCQFNHYfGaRUBWgSePMcLKDAIZE,EAAAdAAAOADA..bACAQAGAHAGBGCCARBDBBCBASDABhAAAeCFG.MDIBLEFAhACAAAGBZEFBXGDDhADATGEAFGGAfHGFaDBE.WEAD..hAEA......hAIA...,1,2,-8,10
gSaFUQdIPfGcYCJZbXLNOTWeAHEBVMDRK,HAAAEAAABACAMACARADF.SAEA.aAGDQAFC.hAAAdAHAfCCAhAIAGDDBCCCDbFGBLCFA.hAAATECAADGADGGB.FEEA.IEHA.cGGAhBIA....hCAA...,1,-17,-22,5
MVESWbKATUPCGOJXIfHQBFdLNZcgDYRea,TAAACAAAGACA..OACAJAEA...XAFAHCABQCFAhAAAdCCAZCDBDAIBREDAeDHHhACAaCFDEDHBSAHBhBCA.KFCDADBAIFFAFGGH.LGAAhAAA.NIDB.....hAGA...,2,-16,-2,14
IKCgMbSQcBdfGVNWDHOEeTZUYLaPFAXRJ,RAAAKAAAMADAQACC.dAEAGAGA.VBDBDAGAHBFB.hAAAEBHBeCCDZDDFLEHBhAAAaDGHAAIBXFBCCFFBSHFGhBIAfFEA.OFHD...hCAA......hCBA...,1,-8,-17,9
EgLHBCKIYZfXFDPOdWJebRNUcAQMSTaGV,MAAAaAAAGACA..EADAHAEAKAFAZBBAFBHDOBBHdAHA.eCFFhAEARCEFUEGAAAGA.QGCAhBAATEGA..gGEAhAIACGFDIHHAXEDDDDDB....hBAA......hCAA...,2,-18,-8,10
XYeUOGfJaVNDcCEWQdFbSZTMPAIgHLKBR,HAAALAAARADFeAFEGADA.aAFADBGBEBFEdCAD.SCEHhAAAZCAAMAIBADFAKCHB.BEFAXDFAhABAODDH.fEHEhACAVFFB.CGGAFHCA......hADA......hAIA...,2,-14,-10,4
VLIBFOPJMeHQCdUYgDGAWXacTKESNRfbZ,aAAATAAA..EADARACFZAEBLAGBBAGAFBHDOBBB..MCABhAAAHCDBdECAUEGA.DAIBhADAAEEAXEFASBFFhBAA.bGCAIGEAeDCDCHHA.gGGAhACA.WEAH.NIAB..hCAA...,1,-7,-13,6
bDKSaTLCPNFAUXQeZfWEMHYgVBdGORIJc,QAAAeAAAZADBEAFAHACA...gAFBdBHARCEFJDBBDEGAaAHFLCEBhAAA.CDDAFDGAhAEAAAAAXFGAMEGBBFHAhCAAGGCBOHFE.......hAIA......hBDA...,1,3,-24,27
OPYfVXGTLMBAZUKDFSQENdCJeWbIHgcRa,ZAAADAAAQACAEADE.dAFAeAFE.bBFDHBGB.RDDAaAHFOCABhABA...fCCEhACAGEBAMBBBACEAFCHFhAIACCCDIFFAgEEGPEHDYFDF.hBAA......hBEA...,1,-5,-13,8
HYBLSdPGREUITQaJOWNVXCDFgKMeAbfcZ,...bAAAZAAA.HAEALAEAdAHARCAAECEBTCAA..aCGCOAHDhAAA.VCEADACAKEEDhABAAAFA.fEHAhAGABDDDGEGAQGEANECAFGFH......hCAA......hCBA...,2,-17,-1,16
eHWgFTODAaXJUdPZcIYGSCENLRbBQVKfM,aAAAXAAA.dADAZACB...IAFAGAFAEAHBRAGFBBBDQDBAhAAAKBED.eDEBhABAHDEAFDHBTFGAAAFBPFDDhAIASGDACFHA.NIAB......hBDA......hCAA...,2,-20,-10,10
HgNTKBJCRAdUVPcEGfMYQXOFeLSDaWIZb,dAAAVAAAEADA.GAFAMADA...QCBAFAGDeBDFLCFAhAAAaAHFZDDBHFBB.TFFAhACABEDAREGBADAB.PFBBhAIAfEHEOFEDDIDA.IHHA..hADA......hBAA...,1,1,-13,14
ZKRaMBXegQIdTLbDWPYEUHGSJVOcNFCAf,ZAAARAAAMADAeACE.QAFCdAHALBEBDAIB.....PCCBhAAAECCBHCFCGDFASCEDhABAODHFFGBAAEGBaEHDhAHABHBDXGGCIHHA.....hCAA......hCBA...,2,-16,-12,4
BcQUITMAWGaRESZVgYDFHKLfNbJPCXdOe,aAAAEAAAZACB..VADADAFAHBEA.LBHB..bAGBCCBCdDEDhAAAeBBBQEBAhAIAUDDAMBIBAFFARFGBSCFHhADAFGBHKHDA.fEGA.PFHDhBAA......hCAA...,2,-21,-3,18
OBCNRYUGaeQVTEDMXcgLHfPIJWKdSbAZF,ZAAABAAARAEAGCAAeACAQAFA.ECAAMACA.XCCAhABALBHBHCFAICDAhAAAKEFDbEGDAACACCFD.UEEAhAIAaAHDDEIBfFHAJHAA.dHDB....hCAA......hDCA...,1,3,-15,18
MSHVbBDRdTOWgaIcAEKUZXFQJfGePYNLC,EAAAZAAAQAEAGACAeAEA....PAHBLBHB.MCBBhAAAHCAAbCEDRDEAdEADTFGAhAEAODHD.aECDACGAXFAAhAFAfFGECDGC.BGBDDIAA.WFDH.hAIA......hBCA...,2,-3,-2,1
XKZADaebcLQNCUMOTFHWIBVGJgdRSfEYP,eAAALAAAQADACAEAUAGA.MAGB.FAHBHCAABCCAGCEAhABAdDEARDGB.EDGE..XFBAhAAAACCAbEAA.OFGHhABATGBA...IFHA.gGGGhACA....hAEA...,2,-13,-12,1
ZGTAIUFPCabQBJcEVSeWDOYNXdHKLgRfM,FAAAaAAABADAEADA..eAFAOAED..XBGAHAGBLCCBhADARCCAZDAFACCA.IEEAhAGA.CDGDQFGAhAIAcDFBSEEDDBBBdGBAfGFEMEHB.hADA......hAGA...,2,-25,-8,17
UGQYLRfeFTDPOAdabVCcZgKHXIEWNJMSB,aAAACAAAZACAHACB.EAEAJAFA..BAGAGCCALCFARCFA.eBBDhAEADDAAAEAAdEDA...bFEDhAIAVEGBKEHB..XGCChBAA..IFEA.MIAASGGBhBIA...hAAA...,1,4,-41,45
cXPRMfNSaDOCZHUdWgebGATFIEYLQVBJK,TAAAEAAALADA.QBGABACBKAEAXAGBRCBA.MBIBhAAASCFD.hAEAaEABCCCAHCEAdEHAeECFhAAAAECAFEEHIFFAVGFAcGCAfGDA.hCAAOFAD.WHFAhAEA...,1,-11,-16,5
RUTHcCLXBIAOSPebfWJYgNFDZEGVQdMKa,SAAAeAAA..bADAJADA....gBGHDAGAEBCFGBGAhAAAdCCAaCFHRCEBHECBhABALEABBFGDAAAAfDHAhAEAYFHB.ZFFAMIBAKEDB.....hAFA......hAHA...,2,-12,-11,1
fRQaYDCXSZMdFGbELBUTJIAcWHKNeVPOg,HAAAeAAAOADCRADFQAFCDAFA.CAHBZCAAdBHAGCCALCHBTEFAhAAAADFAKEEA...PFEBhABAaGEASHDAhAAA.FHGEECFABDGAIGHA.WFCD.hACA......hADA...,1,-6,-12,6
AdMbSWELJeUBcKFXNOTPDfgaHGIYQCZVR,dAAAMAAASADALAEAeAHHBAGAFBHDOBBB..DCCAaCDAHCDChACAGCFAQDAAhADAZDBBAAFAEEDBUEEBKEHBNIDBTGAAhAEA..fGHEgFGH.CGCB.hAGA......hAIA...,2,-15,0,15
IDCVJPeOALFRacdSBKNbYfTMXEGQZHWUg,RAAAdAAAKADC....bABDTAFA..EADAZCCAHAFAUDGADCEBCAHB.hAAAVCGB..eECBhABAAAHAaDACBEED..fEFEhADAGGEBWHCGgFCA.IGHAhBAA...hCAA...,2,-27,-9,18
dOLFBEYQVGXDRNWUcPIZHTJKgeMfAabSC,aAAACAAAdACALADABAEA...EAHBQAGAGCCARCFA.UCEAIEAAhAEAHDGBKCBD.eDDDhAAAABBBbEFAFEAH..XFAAhAFADFFB.cFECZGAEgGGAhAEAMIAASGGB..hAIA...,2,-10,-8,2
dZAQBgXHSEaLIOMGTFKJVbRNCYfecPWUD,QAAAXAAAHADAEACALAFA.MBEBGAGA.TCEAhAAAKCFAbDCDRDAACEEDeCHHhAAAPEGBDDCBAAGABFADaEFBFFHDhCAANDIA...fGFAcGAD.dHCB.hABA......hADA...,1,10,-12,22
UeKTafLCADGVWBYPbXJcNQMIEOZRgFHSd,GAAABAAA...bADAXACA.JAFAQCDA.hAAAEAHBRBEFHCAAdDFAeCHBhAAAaCGDLFFAAADADDCBVFABhACAPHFAMEHB.IGDA....hACA......hADA...,1,1,-30,31
SDHZaAUTbPcEdQCNKFfJIgBGVYOWRLeMX,TAAA..bAAAEACEdAEA..QAECKAGAFCAA.JAHBBCFAhAAAGCCAOCGDRCFBeDHHhAAAMCIBDEFBHDDBAAGAcGGChCAAfEBA.gFGG.YGAGhABA...hCCA...,1,-9,-15,6
fFDZdaGJICeTcAWUMQEBLPYbgNVSRKXHO,MAAAEAAALADA..bABAVBGB.RCBAHDEBFAFAdCCAGEAAhAAACBFDeAHHAAEAQECAhAHABDFA.PEHDgEEGhBAAKGGD.fDHA.aFDH.IGHAhCAA...hAIA...,2,-16,7,23
QKeCYAaNTGPRJFMZEfWIcXdbBSVgOUDLH,aAAAGAAA.RADAMAHBEADA....fAFAICFAdDCASAGHhADAOCHDLEEBhAAAHCCAeBHHAADATGAAhACAFDFDZFGBXECABEGDgGGADBBB..hAGA......hAIA...,1,-5,-14,9
fgEJaTbPMdWQDXFLOZcVKANBeRHIYGUCS,eAAAHAAAGADACADA.SAFAEAFA.aAHDbBEAdCAD.QCFDhAAAFCCBZDEAKFAAAAFAREFBIFDAhAAA.UFGBhABA.....gGDA..hAFA......hAIA...,2,-20,-11,9
bAURgGMBHPYQWSTCILZcedJOXDKfaFNVE,RAAAGAAAHADBQAFASADACAGAZCFEeAHHdDAAOCCB.KEEDhAAAaCDAFEHBEDDB.AAABMCGBhACABAHA..PGEChABATFEA.LEHB.XEAADGIB.hADAfGAAbFAA.hAFA...,1,1,-3,4
eGgdaDCXZcTVfObNAJEFQHYRLUMPWBSIK,EAAAHAAARACA.MACABAFBKAFAGAGAdAHA.DCCBZCCA...TDGAhAAAOCFBABEBQFCAhCAALDABUEGBSFFBhCDAeDDBaGHHCCFB..........hAAA......hADA...,2,-20,-8,12
dXDfBKJNEHgGMQSaOIWbTLURCecFYPZVA,dAAADAAAKACAEADAHAFAGAEAMCCA..aAGAOCFE..bBGDTDAAhACA.RDDBeEHBhADAFBBHZDCBAAHABFGDJEABQFFAhAEASGEH..WEEDCHHD....hBAA......hBGA...,1,0,-24,24
ZGFLJSUfMCVRBTDbNEPcAedOYXKaQWHgI,eAAAdAAAOADAKADA..aAFAHAGB.ZBDFGBEBLCCBSCCBhAAAMDGBRFCADDIBEDFBAAIB.hACAQEDDIGHAFGBHhAIAfDHABHEA.TGGA.PHDChABA.....hBAA...,1,-2,-13,11
HVPfZYXFAGDJKegIcMCTNSOaUWQRbdEBL,GAAAKAAAeACE..IADAMAFA.CAFA.TBCA..OAGDhAAAaBFDUEDARCDAEDCBHCGBhAAAVEFAZFFF.FFHDAAIBDCIBhACAJHBA.....gFAA.SFEDhAFA..hBAA...,2,-23,-7,16
NDBLYSHaUgMCPWVKJbROQXTEeFIfGAcZd,dAAABAAALADAHACAaAEAMAHB..CAHA.VCBAKCAARCEA..QDFChACAEDDB.eDHHhAEAfDHAAAIBZFAADEEBSECDhAAAUGGB.gFFB.PHAAhACA...WFHHhAHA..,1,-14,-17,3
QXOFbLBeKIgJRaNWdCVATPDESGfHZcYUM,TAAAEAAAGACA.HAEAZACBUAFAMAIBQCFAFCAHLBHBeCBBhAAAKCED.JEABRDFBaEBDdEEAAEIBhAEA.SFHDhAGA.fGFAcFGDOHDCBHAAIHDAhAHA....hBCA...,2,-14,8,22
HITSbfDRQLECJPMeZNAOaKFUVYWcGgdBX,aAAAFAAAUADA..VADA......cAGAdAGAHCCAhADA.TDFASBFBhAIAbFFADAIBRCGFECCB.CDBDMDFBhBAAeHDAABBBKEDB.....YEHBhBDA.....hBAA...,2,-22,-21,1
DbYVWdIaCgUAEPcQHfLReTFXKOZNBJGMS,EAAAQAAAHACARAFFFBHDOACC.ZAFBBCCDGCDAMCEBDAIB..hAAAVEAAdDCCaBHH.CEAAAAEAhCAAfEGALEHBeFFBhCDATGEA.KHAA.SHGA.hCFA......hDAA...,2,-7,-5,2
UERDPAdOcTBKIeXGSbfJVZMCHYQFWaLNg,dAAATAAAKADA..eAFEGACA..SBEAbAEA.JCBBZCEBhAAA.HDGBFCGDLDDBhACAgCAGRFEFACIBBEADhACA.fGAAMDABCGHA.QGDAhAEAaHGCNIAB.EGGB.DBIB..hAFA...,2,-16,3,19
cWSKOVZJAFXYgTMEUfQLINGaPDbdCHeRB,XAAATAAA.UADALACB.GAEAaAFEDAIBdAGB.HBGBhAAARCEABDBASDEDhAEAKDDDZEFBAAAAFEBA.MEGBEEHF.hAGAfEHA.IHHAPHCCCHHA.hBEA......hCAA...,2,-23,-6,17
edaYQFDHMAWTSPZNOEcBVURgIXbKGLfCJ,TAAAZAAAEADEBAFB..RACF..XAEBGAGALCABhABACAGA.eCCAaAHDQCEBhAAAHDEBAAIBSDHHhACAOCABcDFDgGDBbFGD.fGGAhCCA..YEEFhACA.MDIB,1,-2,-12,10
GOFADLZdXTMIfKQPEVBRaWebgJNUcSCHY,ZAAAdAAAMADAKADC..EAFARAFA..eBDB..bBEAJCBB..UCAAhABACCFDHCGBGDDAACIBLFEBhACATFGA..fGFEhACAQGGABDGDWDDDNAIA.....hDAA......hDCA...,2,-17,-13,4
WUcQHgJYbeFDCPILTNRGdMSaKVEfZAXOB,BAAAUAAAHADAJACA.eAFEDAFA...CCDDLCFARBEAGCBA.dDAA.hAAAaEEAECHF.ZDDFACGAOEGDhADA..QFFChAIA.YHBA....hBCA......hBHA...,2,-34,-23,11
VgNYJCZEbTOAScGMKDUIWadeBHPQXfRLF,GAAAMAAADAEAUADA..aAFEeAFA.HCECQBBARDBFLCHBhAAAFBEH.VEEB..hACAgBGANIBB.hAGACDHAEEEA.TFGAAGHA.KGFDIHHAhBAA......hBCA...,1,0,-23,23
FaIbTAMZgJYGOHCXcdKNSfREULPWBQeVD,ZAAAJAAAGADAHAEAXBGA..dAFBSCAAEBGBLDAAhADABCEDeCHHFDDHbDGDAAIBMDFBhBAA..OEABhABAKFHBRGDE.PFED.WHAADDGB...IHHAhACA....hADA...,2,-16,-12,4
OKGIWCLaMYUQEDegXRBVbcNdJAZFfTHSP,ZAAATAAAHAEA.OAHDGACA.CAEAMAGBQCAA.ECDFeAHBhAAARCFBBEADVDGB.bEABhACAdEEA.AACASEHHhABAKEDALHCAaGAADCFBXGGCcGGC.FHAC.hAEAfHDB.hAIA...,1,8,-3,11
IPFVGcSAYagZQDHJBKeUTfLOCbXMERWNd,aAAAZAAAHAEABADA.eAHHUAFALCAB.CCCD.MAIBRCFB.dCCAFDEHhABAGDAAAADA.QDFAhADAKECBTFGAbCDDEGAAhACA....IGGA...PHBChBAASHAADFIBfHEBhBBA,1,-12,-16,4
WEfIVUTcDLBPgFXNZbKYeCAGOMRaJQHSd,GAAARAAAQADCHADAdAGA.ECDBVAGBTDFALCCA.BDFAhAAAFEHDZFAAKDHBeEEBhABAAAABaBHDSFCEhACA.fFFEIFAADGGA.XGAAhAFANIABCHHA.OHFC.hADA...,1,0,-5,5
HdBcAWDZOQXINYbKFLTMCSJeGRgVfaEUP,ZAAAQAAA..XADBIADA..bAFALAFAhAAA.MCDASCAAhABAeCFARDDBfDHAhAGAECEAHCGBdEEAAFGBOFHDKFHBTGAACGEAJHAAgGDGhACA.aDDHBHGDhAHADGGB...,1,4,-8,12
bSDgGXZPeCTdKIMVAHQWFBUaJOLRYEcNf,HAAAQAAABADBaAEDLADA.EAHBfAGADCDAGCEBZCAAhAAAeDDBdCHAMDFBAAEAFEHBOFEDhAAARGAA.NIAB.bEFDhACA.XGDDCGGD.......hAIA......hBCA...,1,-2,-10,8
WJGSMVFCBgNLQOfXPUTaRZYdKEHAbIecD,eAAADAAAGABBMAEAFAHDBAFB.LAHB.QCCBhAEAXBCATCFARCEFdEGAHGCAhBAAAAAAbDBB..IHHAhBHAcDGD....SEEB.CBFCOFHDhBDA...hCAA...,1,-11,-14,3
WLHKJZgSOYVBfcUANbFCdaQXeRPMEDTIG,FAAAaAAA.eACHRACF..EAEEDAEA.GAGAHAGBZCDBOBDDBDGDUEGBhAIAAAIBCEHA..dFFAQFBAhBAAMBBB.TFDAhBFALGAAKGHD.SHGA....hAGA......hBAA...,1,-10,-16,6
PWcgfKXRdZFSQJLMbeCTIHGAYVUDaNEBO,UAAAaAAABADAOADA......PAFAgAGAKBBDRBEBZCGBhADAQBDC.hBAAMCIBeCDBCDCDHDFBhAHAADIBDFFBEGCAfFDAdGGA.SGHBhBAA.LHEA.hBIA...,1,-4,-27,23
XUHSYcEKRCTNQaGZAVdIgOeLDJWFbPfMB,dAAAOAAAeADALAEADAHB.FBBH..bABDMAIB.BCEAHBFBhADASCFHEDEBREAATEGAhAEAaCHHZECA.AAFA.gFCAhAIAJFHB.fGGE..hBAA......hBIA...,1,-10,-27,17
cgOWIYfXDTQMFdaULKVNBPAJeCSHGERbZ,eAAAHAAARADFZADBOAFA..IAGA..XBFDhAAATCFAMAIBaCACLCHBhACAKDBABBCAADDBSEEAhADAEEEBbEGD.gFCBfFBAQGGAhBIAdHCB....hCCA...,2,-9,-7,2
TGUVgEdIcCLYMaAJQeZRbSfBDWXKFHPON,eAAARAAA..SADBDAEAKAGAHBCAOAFAGCEBUBGBEEBAdCCACEEALEHBhAAAaBED.ABEAQGFAhABAbDGDBEEAFGEBhAAAPHCC.........hABA......hCAA...,1,0,-24,24
fWRPSNHLQBVdOICYaMJUKEAgcZGXeFbDT,ZAAAeAAADACA..TADARAEA..SAHBHAFBLAHBQCCBhABAdCCACDFDaEDDMCGBKEHBhAAAACHBGEEAFFAA.bFAAhAFAfFFA.PHBABEHAIGHAhCAAYHEG....hCBA...,2,-19,2,21
eTHXRDKWQafLCUNZEOMVdIgFSbPGcJBAY,eAAAHAAARADFKADAQAFCLAFB.CAHBZCAAEAHB...MCHBdCCAFCHHhAAASDFBGECBBFGAhABAACIBTFEADFIBaGEDfGHAhAAA.........hAIA......hCAA...,2,-22,-5,17
FeANLTWUfJcDPRGQHdZYMIXaObKSgBECV,TAAAUAAA..JADADACAGAGAHADCZAGB.MBIBaBDC..KDDABCCAhAAA.ECEBFEFDAEEBLEGBhAGA.fFFAhCAARFDBdGAAIGHAXGCASDHHhAGA......hAIA...,1,-6,-31,25
WYKDEBAFRSadCZPQHfeLUGVNOcTMIXgJb,RAAAdAAAZADBHADALAGBGAGA.OCAEMAIB...XCEDhACAJDAA..bDFCKEDDEFBAAAFAaDHDhADA.QFFChAIAeEEDUGGAcGDBTGCAIHHA..hBAA......hBCA...,1,-4,-5,1
GPMHbOFTICWDRUBYLfXVcSeKJQgNAdEZa,EAAAGAAAHACAFADACAFB.RAFFBAHBLAHB...XCCASCDBhAAAeBGFQDFBhACAACFBaEAAMEFBbDBD.TFGAhBAADEHBfGGEKHCA.NEIA.....hAAA......hAEA...,2,-13,-10,3
YFORKdPCWUZgAIJGXENMbcVTaHSDfLeQB,GAAAEAAA.MADAVACAHAFC.DCDAeAFEQCFDFBFDRCGFdDDACDDAZDBBhAAAACCB...XEFDhACAbFED.aDHDfGGBhAAABGHA.........hAIA......hBAA...,1,-10,-19,9
DQNSIWPZYFXeJfTaRbKMgCEcdOVUGALBH,HAAAQAAASACE..IADAZAEBXAGAeAEHTAGAhAAARCCBMCGBECHBdCGDOCDHhAGAGEGAAECBLEFAhAIADEFBPHAAFFDDaGED.KGGA.....hAAA......hAHA...,2,-2,2,4
VBRTUMQAecGbZgJCLSDWYKPIHOdXNEfFa,eAAAGAAAZADBCADALAFADAGA..KBFAHCDAdBHAEBCFaCFAREFAUEEAhAAAAAAB....bGAASEHBhABA..hBFAPDCBXGDCFFEHBGHA.MDABcGFDhCAA.....hACA...,2,-23,-8,15
YCEgKLMbDOWeVIAcPafBZFUdRNSTXJHGQ,aAAAZAAAdAEA.RAGB.TADAHCAAGCFA.QEBAEAFELAHBhADAMDIBbCCA.OBBBhBAAeEEBAACA..fDGEhCAAFGABSGHDXEECCHFADIBAIGCAhCDA.BFHA.NIEB.hCGA...,2,-16,7,23
PTWFIBbXgaeSdJZCRHYNGVUQLEDAKfMOc,MAAAOAAA..TADAFADDBAFA..XAFBeAGHdDDAZBBFHDGBhAFAGBGAQFEDhAIAEDDEAAIBKEFB..fBBEhBAAPFCB.IHHAaEHDCFDB.NIBB...hBIA......hCAA...,1,-9,-22,13
BRZfIObGJTMWVaHPDeNASQYCFdgEcXUKL,QAAAFAAAEADA.UADALAGBRAFA.ZBCEOCFEGDAAMDBAhAAAaCHDHDDADEEA.AAIBCFDDdEHAhAGA.XFFBBFFAbGCChADA.....WHFA.....hAIA......hBCA...,2,-27,-3,24
aKgXLcbYUIfAFdSMBTCNOGZEDQHeRPVWJ,dAAAMAAACADAGAEAZABEDAFA.HAGD..RBDA.VCBAaAGE...XDFDhACALCHB.bDDAIGAAhADA.ACIBBEHBhAGATFDAEGGAeHDAWEEDKCCD.gGGBhBAA.....hAIA...,2,-16,-8,8
NeOTPVABQZIaDXfJLGHWECdbgUcYFMSRK,ZAAAaAAA.DACA..XACDLAFA.HBDBEAEAdAHAUCFA.FEHDRBFBeBBDhAEA.ODDBhBAATGAAADIBQEFBhBHA.fFHAWCCDbFFD.YFDBhCAAKHDC......hDAA...,2,-19,-9,10
JACZfcXGQMLKIdUgYaSDHTeVbEBFWPNOR,ZAAAXAAAGAEALADAdAGBUCAA..aAGDHBGB.eDDBECDAFCHDhAAA..PEHDhABARDEBAAEAfDCEMFFBKGGD.hACAgGDBDICA.TGGABADB...hCIA......hDAA...,1,-4,-9,5
XZSgUOHGAbEDMWKIVBRQcTNCfFaYJLPed,EAAAMAAAKACABADA.RAEF.QAEC..TBBACAGBFBHDaCCBhAAALAGB.eCHHhAIAZDDASEGHhAIAODDBHEFBACGBbFDBDFEBIHHA.NIBB.fGHAhCAA...hBAA...,1,-17,-21,4
JcMSbOaLNdCgEXYIDTWBUHKQZRfFGPVeA,MAAAOAAALAEAdAEA.EBBAXAGA.DBBBTCDABCCAHCEChAGAZCFBREGFGFABhAFAeDHFAEBASEBAhAHAaBHDCDCD.IEEA.KGFA.FHCA...hAGA......hAIA...,2,-12,-11,1
GMOgCEYURceWVHXaSQJfLZdPBKFIADTbN,TAAAGAAAMADA.CAGA.EACE.RAEFeAGHHCDAaAHD..QCCChAAALDHBdEFAKCHBAAIBhAEAbDBDOEEA.gFFAhAGAcGCDWHEA......hAAA......hACA...,1,-9,-14,5
YVGHCNMdgRefELXJDTcPZQSaWKBAbFIOU,FAAAOAAAUADAGADAHAFA.MAFARCFA.EBBBLDBA.DEFBTBGAhBAAZEGB.aDBCBCCDhAHAABFA..bDFA.IFDAhBDA.CFFAdGHA.fHFF.hAIA......hBAA...,2,-34,3,37
bWDQPdcIYTeZRBXHSGFUfgNMEJaOCKALV,LAAAVAAA.DAEAdADA....IAHAeAFARCDAHCGBGBCBhABAfEFEMCABECGAaDDChACAKFAAAAFA..bEFAQGCAhAAA.cFGDZFBASGEHhBFA.FGGB...hBIA...,1,-1,-17,16
fGaDdCWXIEYgcZMBTVJSFeNOKPAUQRHbL,RAAAHAAALADBaACAdAFACAFA.....XBGDEAHB..gCEHhAAAZCCAMECBTEFAhAAASCCDeEEDKCHDAAHA.hBFAQEFDfGHAGFABDIBA.IHHAhABABEHB....hAFA...,2,-23,0,23
RXNITMQPaCFOKDAHgZbdYLcWJEeBVGfSU,HAAAZAAAdAEALADB.JAFAEAGABBFDGCAAUCABRCFA..XDDChABATCGA..MDFBhAAAaEFEOEHDAEEB..hACAbGEA..cGAC.eGCASEGAhACA.NIAB....hADA...,1,-10,-14,4
bHeUZTVMdcFSNXRBAPKCGDfWLQIaJgEOY,CAAAGAAADACA.LADA.aAGDEAEAOBHDHAGBeBCBZCDAMEABhAAAdCEASDBBhAAA.RDFFAAIBfECAhACA.QEECgFGHbFADTGBAhBDAFEHHBGGD....hAEA...,2,-13,-3,10
NGHfTVIEgSKLFeWXbDdBOCaJcAPYRZQUM,RAAAZAAAMADAHAEA.TCAAEAGA..KBDAeAHH..XBGAhAAAdCEDCDDDaDGEACCB..QDDAhABAGEABfFEAhABAIDGALFBBbGAAOFHBPEHD.YFGFhBFA...hACA...,2,-6,1,7
ZaKYHMTLWAdgPNVDCGOQecJXFSUBbREfI,dAAA..gAAAVADAGAGAeADA.XAGASCAABCCAhAAAEDCAZCEAKDFBHDAAMDIBhACATEEAAAIB.DCFAQFDAhADAFEHDRGEAaHAA.YFGB.PGAChAGA.....hABA...,2,-2,1,3
fACgaHFQIYGRNcTLXWEZUSKMJOdDVbBeP,aAAAHAAA.QADCGACARAEA.TAGALAHBECABZCCAKCFBMBBBhAEAdCGDDEEBBEDAeEHBAEHAFFAAhAFAIFAA.cFCChAAAXFEAUGFAOFHB.PHCA.hACA......hAFA...,2,-6,8,14
ILWPEQgcKXVHeZYNFaCMBOTJDSRdGAUbf,UAAA..bAAALADAEAEA.QBGAKAGAHCAAeCEAZCBEFCFHhAEAaCHDMEEBOEABTFAAhAFASECA.hAHARFEAAAAAfFFAIHDAPHFC..hACA......hAEA...,2,-15,-3,12
FXLGBWPAfOgEeJZICMScTYNaQRKDUHVdb,OAAAEAAAZACB..MAFATADA..aBEARAFFDAIBHBGB..dCCAbCEDhAAALDFA.GEDAhAFABCBCABIBeFFECECASEHHhBCAcGGCYHAAQGEA..hCAA......hCEA...,1,-5,-16,11
PVELNTWSUFgAZMJQBKOdebCRHacYIXDfG,ZAAAMAAAQAEAKADA.eAHBRAFFHBBAaCAA...ICHAhAFADCEBGCGAEDDALEFAhAHA.TGEASDABhABAFGGAAAIB.ODDH.bFED.CGBAXGGAhACA.fGDAhADA.,2,-14,-9,5
ZCWHFQKaBegDfUVTEGISRJOYbAdMcPXLN,dAAAMAAA..XADAZABEHAEBQAGAaAGAeBGH.DCCAUDCAECFFGDAAhACAREEF.ODDBhADAACCALEHBCDHAKEFAfFHAhAEATGBASGGDYHDA...hBAA......hBGA...,1,-1,-6,5
VKDCbESdMIXQYcePFTUOaHZfWLAgNBGJR,BAAARAAADADA.EACAdAGA..MAFAQBDA..eBCAFCCHOBHDhAAAHBFAZCAALEEAhABAABHAGDGAKFCAbEDDXFGAhAIA.....cGBC.TGEAhBGAaGGH....hCAA...,1,-12,-20,8
YJENKULHISdXbAPcCfegDRaZOVGQWBMTF,CAAAeAAARACA.ZADBGAFAQAFABAHAFCAAEBCF...KCEDHCEB.hAAAdBHAACIB.fEGAhAAADDAB.aEHDODDHhACAMIAATGDAJDHFLFFBIHHA..bFADhADA......hAFA...,2,-27,11,38
IMCDKZJfOScWFgURHNGXTVQLYEdbBeAaP,aAAAMAAA.KADAZACB.OAEC..SAFBFBHDRCEB.HBBAhAHAGECATCEALEHBhAGAEAHFdDHAeFGFADDBCEEDDEGBhBAAfHAB.WBBDNHEB.....hBBA......hCAA...,1,-9,-25,16
DQEWFcBgaVOMLIeXPKbZdUfSRAYTNGHCJ,TAAAHAAADACA.EAEAFACABAGA..aAEDMAIBeAGB..KCCAdCCAhAAASCEBAAHAGCFAQEDDhBIA.hAAAWCHHgCGD.LFFAIGHAhCAAbGEC.....hDAA...,1,-18,-20,2
KNgaOfbIVJHZGAMeDUTRFdWScEBYXLQCP,eAAATAAARADA..dAGASACBBCCALCFAQAEAKDED.aAGEhAAAOEAA..bCCChAEAIEGAHCGBACIBMEEBhAHAFFFHEHGACECAgFFB....hCAA......hCEA...,2,-25,-5,20
YFXNJPQUEBAdDgeIHfSRTcWLCVaGKZObM,dAAAeAAAHADARADA.TBGALAGB.aCCBZABB.MAFAFDDAJDHBQCEDhBAA.EDCFAAAADAIBhAEAIEHASEFHhCAACEFDKGGA.OFCA.bGCCNIBB.BGHA..hCBA......hCFA...,1,-1,-18,17
DGXBQWYUaMVLCFPJdAZONHcSTIgKRbEef,ZAAAHAAASACETAEAKAGCRAEF...EBHFeAGHGCABQDDChABAUDGBaDEDMAIBLEAAhAAAFDGDdGAAAACAOFGDhAEA.IGCAbFFADCCBBHHD....hAGA......hCAA...,2,-8,10,18
KbfaTBLZVXgECcePDOJRdSIQMGHUWAFNY,FAAAKAAA..aACATADAZAEB....XAGAEAFEeAHH.OCCBhADARBCFdCGA.QDEAhAHAHEEAADIB.bEGBLGDAhAAACEDDDFIBSGCAMFIBWHAGNIDB.BHGA..hAHA......hCAA...,1,-1,-15,14
KgXJObCARLfeaBSYdcEHQGFIMPNTVZDUW,RAAAeAAABADBdAEAHAEBGAGAMAHB..TCCAZCCFDAIB..KDBDXDGAhAAAODFBAAAAaEEDSDHHhAGA.EGBAhAIAQGAAFGDD.IGGAPGFC..hABA......hAGA...,2,-25,-5,20
VFbSNBIAgUPGCRHLcaYKfQdZEOTMDWXeJ,UAAAGAAAHADAaADAKAGAdAGAECDB..MCDADAIB..eCFBFCGDSDBHhAAABDAAADHA.CDDARFDAhACALEHB.fFAAhADAZGAAOFHBTFEA....hAFA......hBAA...,2,-21,-15,6
GUObBdSAeRTNFMLHYEgfDCWIPacJXZKQV,RAAATAAAMADA..HAFCEACE.DBEB..CAEB...ICCAaAFDXBGDhAAAZCEBQDGAhAAAGCCAbEFAdGDA.AFGBFGHBhABALGEA.fHAB...hAIA......hCAA...,2,-15,-7,8
RPeSVUHdYOQLgacTbEBfGNWFXKMCADIZJ,ZAAARAAAeADESACEHAGBdCCA..QAFAaBEH.TCDAhABAEDFFGEGAFCHDMCCBAAAADDIBhAGAIEFAVFCA.OFABhAFA.LFHB.bFCDNIAB.KGGD.hAIACHBC......hBIA...,1,12,-4,16
fRbQYdAENGaVFCDWHcgJTLeZXMUBIPOSK,EAAAaAAA.FACDDADA.HAEC..JAEAeAHHZBEAUDDABBBDOBDBhAHA.KCEAREGBQGDAhAAAADIBGEEACEHD....hAHA............hAIA......hBIA...,2,-34,-26,8
GaMKHcQCgeOLbDVUATfNJWZFYESIRXPBd,TAAAJAAAZADB...EACERAFABCCCGAEA.aAGAHCEB..QBGChAAAeCHBLDABhADAbCCDDCCBAEHB...fDHAhAEAFFGHSGAAXFFCdGDA.MFIB.hAGA......hAIA...,1,4,-19,23
AEIDGOReZFYCPUfSbHXgLVQTdcBNMJKaW,EAAAGAAARACA.eADAZAFBFAHDCAGA..UCDA..SCCAhAAAHCFALEHBTDAAdEADBDGAhADAMFFBaDHDAAABDAIBOEEBhAFAfHCB..bFCD.XFGChCAA.....hACA...,1,-4,-16,12
VcHfEbDdTMFKZNOXgRCPUJLAWeIaQYBSG,eAAAaAAABADAGADAHAEBEAFA..dAGBMAIBZCCFOBBHRCFB.CBHD.hADAPCCBLDGBAAAAQFAChAFASEEBfEHAhBDADDIBKGED.XFEC...hBAA......hCAA...,1,1,-21,22
LBCfNcPJAZEQOSeFYMbGIXdKTWRVgaUDH,EAAAQAAA.eACAMADAGAFAdAHATBCARCDB..aAHFHBEBhAAALDABfCBEhBCAPDCBABGAZDGBFDHBbFDAhAAAKEBDgEEABFHACHBA.cGCA.SFHHhBEAIHHA..hCAA...,2,-10,11,21
bfDGAdNKIOMWCRXEJFZaSgeVLBPYQHTcU,dAAAKAAAMACARADA..EAGEZADE..aCAEeAGHLCFABCCDQDEChAAAHDCAUEGADEABAAIBOCHDhCAACFFC..FGCASECBhCBA.gFGB.PHDAhCEA....hCFA...,1,-20,-27,7
TcXAeGaYdZbNICMRKHBUgDfJWOEFSLPQV,eAAAaAAAZACB..IAEARAEAHCECBAHB.DBBBfAGAhAAA.OAHDEDHFLECAhAFAQBCDTGFAhBAAACFBdDGACHCAMFIBKDDDgFEB.FGAA.hCAASEHH.hCCA...,1,-10,-15,5
VENAYXeDFGgLSQaIfKOUJRBZWbCHTPdcM,eAAAGAAALAEAaADAKAGA.OAHD.RBCBZCEBbCDA.HDGB.dFAAhAAAMCHBEECB.AAABDCDASGDAhABAQEBAfGGEhAFABEEATGAA.cFGC.NCIA.hACA......hAGA...,1,7,-20,27
GJcFHdAVTZSfIebLWKBRPOXDCNUQgaMYE,ZAAASAAAeACELAFBBADARAEF..OAGDCAHAQCCB.hAAAaCGDECCB.GDAAhABAFEEBHFCBAAIBTDFA.hABAbEDDKFGADCIBgGFGMFIBJFGB....hAHA......hCAA...,2,-10,-3,7
RdVQBJZgaLIWPbEcKMYNTSAeUDfXCHOGF,eAAADAAACACA.HADAGADARAGFdCCABAFAZDFALFAA..IAHAhAFAbEDD.KBBDMFGBhAAA..TCFAACIB.hABAXEFA.FFEH.QGGBhBAA.aCHF....hCAA...,1,-7,-34,27
FeXWLTfVPECgYHBaDAIGRZUJOKQMcbNdS,RAAAZAAAOADAMACA......bAEAdAHAeBHHLBGD.TBDAhAAAfCCEECCBCDHBHEEAhABAaCEAADFBGEDAhABAKFDDQGGASFFB.XGAA.hCAAPFHB...hDAA...,2,-11,1,12
XTHVAZWPbDOJeMQfKNCcdLUgBIRFGYESa,ZAAA..bAAAOACAeAEA.MAGBKAHBCCAAdAHA.LCCABCCDRCEAGEAAhAAAEDGA..aECAHECAhABAAEIBDFBAQEGAhACA.fGEAcFEBgGGAhABAFGGH.SHBAhBFA...,2,-27,8,35
KMRbLDZgfENFeTXPAUYWHQCdJaGIcSBVO,UAAAHAAAdADAGADASAFAOAFARBFFLCCA.ZCFBECHFeBHHhAAA..TDAAhADAAAFAQFGAaDDHBEHAMCABhACAbFBD.fFEEFFEDXGFD...hAIA......hDBA...,1,-1,-9,8
OXBQRNGMTWZFVcfKLSYCAedDIaPJHgbUE,eAAAdAAAaADAHADA.UAGAEAGABBDARCCBGDGA.MCFBZBFEFCBD.hAAA.fFAAhABALDDACDHAADGBDGGBJFFAOGAAhACANIBB.......WHDA..hAGA......hBAA...,1,-2,-29,27
AQCfeSVKdYETJXUFOBNaIcHWRDMbGgLZP,QAAAeAAAKADAdAFAEACA....TCCAXAEA.OAHBhAAAaAHBHDFARCDAMCIBGFDBhAAAZECAACDASBHHhABAJEGBBFAAIHHADECB......hAFA......hAIA...,2,-13,-13,0
TLCDVdKaGHScOWeIfQbXgYUMRBAFPJZEN,FAAAZAAAEADELADA.DAHBdAFAGCCAHBGBOCAB.eCCBhABAQCFCXEDDgEABhAEAMECBAAHAPEHDhACATEGA.KFFDaFFDSFAD.IHHAhAFA.bFDD.hBIA...,2,-9,-9,0
PDHaYeWbOdLKTEAUgVBRQGNZJMfSXFICc,VAAARAAAGADA.ZAFAMADA..XCFACAGADAIB.HDAA.eDHHhAAAbBDD.dEFALCFBhAAAEGAAAAGABCCDQFBAhBFAfGCAFEHBIHHAaGHD.OFDChCAA.KHDA....hCDA...,2,-17,7,24
WTVCRBPFQYKEGALHOcMedaUJNZDIgfSbX,HAAAMAAAdAEAaACAUAFAZAFB..DAIB..fCCASBBAXCGAhAAA.TDEAhAIARCGFFDDBQFEAhBAAKECAABHALFGBeEBBIHEAgGGBbFBC.CHBD.hBBA......hBCA...,1,4,-21,25
DfZUELGgcCdbJOVeNPKBHTaMQRFXAWYIS,..IAAAfAAAZACALAFBGADACAFAdAHAOAHB.eCCBhADAKCAAHCFA.aDBEREABACEBhAEASEFAEDHF.hAIAbFAAVEEBBFEDMFIBQGGA.FHBChAAA......hACA...,2,-4,-3,1
JAUDXCPbHeKcSTFGBMgIdfNQORYaZLWEV,XAAACAAAHACAKAFC..SADAGBGAMCABdAGAQCDAhAAA.RDAAZDFBECCBAAIBDAIBhABAeCEBTGBABFCAfEHAhADAOEADaEEHLFDBVGFA...hAAA......hACA...,1,5,-14,19
TYUHebMFaWQGVKJdXfgLECZNDARSIPcBO,RAAASAAA..IAEABADATAFAHAFBeAHB.bCCBhAAAaAHD.GCCAKDAAdEEAhABAfCFEEDGF.hADAZDABAEIBOFHBMDHBQFEA.JHAAhAAA......hABA...,1,-6,-17,11
YUHLJbFADRfKPWSgMaecTGQIECdZBVNXO,RAAAKAAA..SADBaACA.eAFAGAEAEBHFZCCABAGA.XBCDhAAAOCGHHFAALCHBhAGAbFFAAAAAfDGAhAIA.gFFGMEEB.TGDACHFA.hAFA......hAGA...,1,-7,-13,6
aBXJHYGDPTcNOSEQeFdUIgbRWVAfMCLZK,MAAAZAAAaACABADA.HAEBGAEADAGA.TAGAOBBB..ECCBeBGHhBAAdDGAUGAA..hABAbDCBREDBADIBLEEAhBCAKFHB.XFGA.YGBAcGED.NIBB.hBGA......hBIA...,2,-15,-6,9
CMFGPTHebYADBaWRLZOJQXEKUdfcVNgIS,aAAARAAAZADB..QADAEAFA.dAGAVBGB..gBBGhADACCCCGCEAHDAAeBHHABFABEHAhAAALDEBOGFCKEHBhAIA.fGDENIAB.SGFAhBAA......hCAA...,2,-14,-10,4
bCgBFcNWJafTYRdSGEVQPZAKOLXDIUHMe,LAAADAAAHABCeAEECAEAFAGA.....NAIA.aBEE...TCAAhABARBEBGDDA.ECCBQCCChACAACGAXDGDMCHBhAEABGGAJDFBdHABSEHH.ZFDF.hAHAKGGD.....hBAA...,1,-11,-14,3
dgRaKeUGXWJDTHSOAQNCbPEFVIcZYLBfM,QAAACAAA.EACAFACA.IAFAZAEBLAHBBAHAdCBARDCBeBGFhAAAGCFAJEBFHEEBhBEAACFB...PEHBhBGAcDCDMIEA..aCHF.XFGD.hCAADFFB.OHAA.hCDA...,1,7,-32,39
TdYGcSbPLCKXeURIMJVNDAQBEaHWOgZFf,EAAAHAAA.OACAZACBFAEDdAGAGAGA..bBEDLCBDKCCAeBHHhAAARDEBMDIB.VGAAhAAAAECAaEGE...fFFEhAIATGGASEDDXGBAIHHAhBGA.....hAGA...,2,-8,-5,3
GFMdRNYLOJUDAICcWaXQegESbPBTHfZVK,CAAAaAAA..eACAEADA...SAFABAFAHAGBZBFEGCCAdCAARCCBLDGBhAAAOBBBDCFBACEB.hACAIEGAXFEBbFFAhADATGAAKGDA.MDIBNIAB......hADA......hAGA...,2,-14,-7,7
SOCFNJfYBQAgTGHWZKIdXcVeRMPbEULaD,GAAAHAAAZADBdADAXAFAeAFARCDA..MBIBECABLCCD.hAAAaBHDOCGDFDEDJDGFBEFDhACAAEIB.TFAAKGAAIHHAhAAAPFHDbGCASGCB...hAFA......hAGA...,2,-11,-2,9
LdYDCBUTcPbWEKQSeNVgXAHMRGJaOfIZF,HAAARAAAGADAaACAOAEDZAFAdCGA..DAGABAGA.UCGA.TCCAhAAAbDAA..EEFBQEEChAGAeDHH.gGDGhAIAAAAAfFDAFGGA.CGHA....cGDDhADA.....hBIA...,2,-14,-11,3
cGTaZObNSJdQVKUgDIYLAEeBCFWHPRMfX,EAAAeAAAFACDHADA.RAGFMCCB..XAEAGDDAZFAAOAHBhAAAbFGB.SCDAhAEA.dDGDKHEADECA.LFAAhAFAAAAA.CEFDfFGAaCHD.NIAB.hAIA......hCAA...,2,-25,-3,22
NBFeGfAcOQPCgSLaVMREWdbTIXHYKJZUD,QAAACAAALACA.aACERAFF..dAHA..bAED..TCCAHAGBKDAAhAAAZDAFDDFBFDDHeDHFhADAADHA.OFEDSECAhAAAEGAAXGGAUEGABGFDcGBD...hADA......hAEA...,1,12,-25,37
RZYJaKWNIVXEPUOcbGfTMFHBDSCLdeAQg,RAAAZAAA.aACAKADC.....IAGAEAFAOAHDGBDBMCCBHDDAhAAASCGDdDGAAAIBQGGAhABAJDDB.NCCA.hCAAXEGA.cFAA.TFEAhABADCIBCFFD.eHBA...hDAA...,2,-16,-9,7
bdEGZBNKCcfUgJYSFaeWMIDHVRTXOLPQA,EAAAZAAAKADC..CACAUAEAJAFB..FAHBeAHB..MCABHCCA.hABARCGBTEBALDDAAEEAGEFAhAAABCHA.fGBEhAIASECDaFHDDEHB.OFFB..hACA......hCBA...,1,0,-42,42
IBcXUQCTfJANFMRDGVWedEbZaOYgPLSHK,MAAARAAAGADA.eAFAEADAZAFB..aBGEOAHD..gDAAhAAALBBBHDCBhBAABDFAXDGDQEEChBFATFDAADHBDEIBdGGAbGACSGGAKHBA.hBHA......hCAA...,2,-10,-3,7
aZUKFcVGXdBfQRHgWeESIPOACJNbTYLMD,CAAAJAAA....TACAMADAZAEE.FBHDGAEA.dAGBQCCChAIAHBGBeCABECFBSCCDhAAA.ODDDhACAAEEAbEFALGCAaEAHKEHBXFFCfGGAhBAA.....hAEA...,1,-11,-20,9
eDNFHfcIXEQMLRGaCYKSOWZJBUAVdPgTb,dAAATAAAeADA.FAGDHACB...fAEBXCAAECFBMAHBhAAARDCF.aCAC..KCHBOCEDhACAZEAFBEFDAAIBgDGAhAGAbEGD.DEBANIAB.QGCA.hACACFHASGGDhBEA...,2,-12,-11,1
BVIaKQdLeHCNfDXbUAcMSPFTRZOEWJYgG,MAAAFAAARACFZAEB..EADA..JAGBGAFA.BAHAaBHD.dBBAHEAAhAEAfCEEDECAUEFAhAIAACIBSDCHhAHA.TEGAOEHFgFBG.KEEDhBAA.eHDACHHD...hBAA...,1,-3,-28,25
bGPEIJUeQcCZgXSaFODNRMdBWALfTHYVK,TAAAHAAAKADC.GAFAEACE.UCABeAEEQDDAZBFASCCAhAAAaAHF.DDFARDGFdFBAAAHALEEAhBIA.fFHAhCAAYFHB.........hAAA......hACA...,2,-13,-11,2
YfKIOXMHWgQLANDPcBaETdeSGUbJZRVFC,DAAABAAAEACAeACA.GAFAUAFAZBBARCAAFAHF..CAHA.KCED..XCGAhBAAHDGBQFBAhAAAABEA..PDDBhCAAaEFHSGHH..bEGD.YFEBhDAA....hDBA...,2,-39,-8,31
PcMTeWBKUGDNREQOSfAVZagYHdXFIJbCL,aAAAHAAA.dADAFADAJAFALAGB.MAIBeBEH.KCADGBBBhBAARCFFECCB.QDEChBBA.fEGAhBGAACHAZEGB.XGCACFFD.cFGDWFHHDIAA.hCAA......hCGA...,1,-15,-22,7
TbcMSCDIKXQUgYFRWOJZGaPEVLABefNHd,eAAAHAAAdADA.TAFAbADA...MAIBDAHBXCCAUCABFCFHRDDBhAAAOBHD.GDEAhAAAEDHBAFAABFGAfDGEhABASFAAKEAAQFCDgGFG.YHAAhACA...hAEA...,2,-16,2,18
YBRHCVUWDTSJPANbGIZefFgEOcLdKXQMa,GAAAeAAAFADDEADALAFAdAGAKCDA..MAIBaCCCBCFA.HCGBhAAACBFCUEEADEEB..TFFAhABASDAD.AAABIEHAhACAZFCFOFHDXGDCQGAA.hADA......hBCA...,2,-27,-2,25
QIXKeDRcAaYLJCHbUNGSBfOZWEPdVTgMF,aAAALAAAHACBUAFAGADABAEDZAFAECAAdBHA.....TCFAhABAMBBBQDEAhAIAKDHBRFEAAAGACGHA.bEGB.fEDEhBAAODDH.WFHHPHCC....hACA......hAIA...,1,-7,-13,6
UdAHSNeFRGMKYCIOPZQEgJbDBcfXWTaVL,HAAAeAAARADAGADA.MAFACAGBOAHDZBFBEBHF..JCCBBCAD.hAAAXDAAaCGHLEABhABAADDBFDHDKFBD.IFDAhAAAQEDADFFBfGGATGFA..hACA......hADA...,1,-9,-20,11
eYOFASHbgKUcQBfIGPaJREdTWDLZNCMXV,HAAAKAAAQACCBADBGAEA.aAGAEAEEdBGADAGAZCAA..MBHBhAAAeCHHFCDDACCA..bEDAgDFDhBIA.fFCAhCAAIGHA.PFFB....hCBA......hCFA...,1,-11,-29,18
TNXFCbVOYUKGBceaHdAWJDLMZPQISEfRg,DAAAZAAAQAEAEACA.RAGB.TAEAFCAA.CAGB.OCEBKBBDGCDAhAIAeDABHDFAABIB.LFFAhABAMCGBSCHDhBAAfHFBXFFA.YDCFhCAABHHB.aGHDWDDD..hACA...,2,-12,-10,2
XWEMdfOUTgKFDCNZSIRYQbaBVJcHLGPeA,EAAAdAAAOADAUADA.KAGACAFA..ZAGBRBDB...QCBCaCAE.hACABDEAVCGBHEFAGFCBhAIAABIBMEDB..fFHAhBAAFGHBSGCD.IHEAhAAA......hBCA...,1,-21,-22,1
UPfDXKQAcGMbSZCIgHBJNVFREdaYTeWLO,GAAAMAAAZABECADAHAEBBAFA...JAHBFAHBRDCA.ECCA..dDGDaCEDeDADhAAA.LFFAhACAOCGBUFAADGABQGBAhADAACIBSEDDIHFAVFGB....WFFDhAFA.....hAGA...,1,-3,-19,16
WJRLTcPBUYdFgbHfGQVDeZEAMOCIaXKSN,MAAACAAA..aACASACA.JAFARAEFTBGA.BAHBhAAAdCCAbBEDHBCB.GDFAhAGAQCGAeCBDADIBXFFAhAIAKFED.WFHHPFHDFGCA....hBCA......hCAA...,2,-19,-15,4
dFQUcTNPSDKaIVBOECgGAHLJRZfMXYbWe,HAAARAAAZADB.MACA..XAFA..bAEAeBHHdCCAQCFChAAATDAA.SCHHhAGAaCFBBCCCEEEBGECBhAIAAAAALFHBfFGAFGAAcGDADFIB.hBIAKGGD.....hCAA...,2,-9,-3,6
gUINGLfKBAbFREZYJTMDcCXadeSPQVWHO,RAAAEAAAZADB..JACBMAGB..CAEA.dAHAeAFHQDAAHBGBOCEHhAAAUDFBGFBBLEAAhAEABFHAAAHAFEGHDGGBaFFHSHBGhAAA..WEHHIHHA.hBIA.NICB.....hCAA...,1,-13,-17,4
WVRYKFXcNBdCODQHLASaGMPJfZUgIeTEb,GAAAMAAA.JADAZABE.UAFAeAGH.ECDAVCCA..RDBFFCHD.hAIA.XCGABDFDdFFAhAAADEFAHGAAABHA.aEEHfFBAhBAA.TFFAYHFG..hACA......hAGA...,1,-10,-27,17
SFDbLJWBRcMZGHUdNAXOgQTPIVCEeaYKf,OAAATAAA...VADAEACE..eAEEaAGA.KBEA.FBHDLCCBhBAABCCARDEAZFDAHBGBdFHAABBBQEEAhCAACHAA.hAAASEGADIEA.bGCC.....hAHA......hAIA...,1,-6,-19,13
YXZVQRJGLNBAEMSaOHTFeUcbdfPWKICDg,EAAAaAAAHACBFACD.eAEAUAEA..dBHA...fCEAhAEAKAGADCHBXDDAZCFBREGFGFABhAFALEBBABBBMIAATFGAhAAA...bGDC.......hAIA......hBAA...,2,-28,0,28
GUWISNZXTgVJOfQPBbFacEeCHRAYdDMLK,dAAAMAAAGADAUAEA.SAFAZAGB..TBBAVCBBOAHDhACAQDBBBCGDaCHDEDFBhADAHEDAAAFA.LFHBhBAAKEHBIGGAXGBAfHEBFGEDCGGA..hBAA......hBCA...,2,-21,5,26
bPTXJOYRHWFGVQCUaSdZINcgKeLDBEMAf,...bAAATAAA.OACAHAEAGCAAQAFAaAGAZCCAICCAhAAAgCGALBHBhAIAEECAAAAAXCEChBDARFFAFGCACHCD.dEFA.KFCABHHAMFHB.fHDBhCAA.....hACA...,2,2,4,2
SPdYQAeFEUDIJLBXfHZRGVgOMTaWKcbCN,EAAADAAALADABACAHADBRAGFGBBA..OAFAaCHD.KBGDCDEA.hAEASBHHdFAAABBBeDFHhAFAFCCH.IEEAhAAA.fEGAZFCBMFHB.TFBA.bGEAhBFA.NEIA.....hCAA...,2,-21,-14,7
UTgAbQJEOIHeFNKaCBPfWdSRMYZLDGXVc,QAAAEAAAHACAeAEEKACABAEB..fBHAdAGARCDAZDFEGECAhAAAXCCAUFGAAAHAbCEDhAAA...ODHDhCAAFGBH.aCGH.CGGA.........hCBA......hCCA...,2,-20,-8,12
XbATNPcGdEfYHBORWVKFDCgUaLZSJeQIM,TAAA..cAAAEACEHAEB.RAGBKCCACACBUAEAZDFE..eEAAhAAAMAHBAAIBGGABdDCABDGDhAIAOFGBFEEBDBIBaEEHLEBDhBAASFHBQFGA...hAEA......hAGA...,1,7,-25,32
ERKYMXAOLUBQVeWIdaTNJcCPgHDGSFfbZ,LAAAQAAAeADHdADA..aAFATAFA.JBHBCBFAHCFC.hABAGDBAfCAAhACAEDDBRFEAMEIBAAHABCEA.IEEAhAFAPHFCDAIBbDFDKEHB.OCCH.hAAA......hBCA...,2,-7,-4,3
VeYcWHJbZGgXEfKPIaRSBFLQONdCUADMT,MAAAeAAA........cACDHACCZAFBGAEAEAHFKBBDhAFAaAGARBGFFCDHLDDBhAAAQDGAdFFAADIBTFCAhBAAYGBAbFEB..fGGASHFA..hABA......hBGA...,1,-3,-11,8
PaWGNXEdbZOMQLFTIfKYHRgCBcSDJVeAU,aAAAGAAA.EADAZACBMAGBLAFA.TCEAKAHBHCDB.RCGFBDCChAAADBBBeCGHABFBPFDBhACAXEBA.bFFAQFFChADAFGAA.fHABCEEDSHAGhAGA.JHFA....hAHA...,2,-11,0,11
fcGgBWLXIEeNOFDSTdYaVbQCRJMZHPAUK,KAAAGAAABACBLADA.EAHBeADHFCDADCGBdAFAaAHB.QDEAhAAARDGFZEAAHEEBABIBUEGAhBFAfDDE..hAAA.WHCGIHDASGHHYCCF.hACACHHA......hAEA...,2,-27,-6,21
aFCWEPdNQZeJBGcbUOYLIfDHXKSTRVgMA,aAAACAAA..EACAdADAZAEBeAFAGAGA.UCAALCCA.DBBBHDCBhAAASBGAREEFMDIBAAIBhACAFDFD...PDHBhAFAQGBCBGAAOEEHfGGAKGGD..hBEA......hBGA...,2,-19,-9,10
FDbNcWTUaMRGEALVPZYCIeXfOgQSBHKJd,LAAAZAAACADB.eADHOAEDQAFAHAGBdCAADAIB...bCABhABANCCA....TDDAhABAaCEDRDFFADHA..PDGBhACAXFAA.SEDDKFHBFGAB.cFGDhACAMFFB.....hAGA...,1,-5,-19,14
JBYbGeKWRHXEPQZAUcCdfaFTLSIONVgMD,CAAAaAAALACA..OACD.VAEAMAGBBAHBGCCAeBBDhAEARCGFHDAB.EAHBZCFEhBAAAADAdFEATECASGFHhAAAgEGADEIB.bGEC......hCAA......hCEA...,1,-10,-19,9
XcAICKbBfMOEdQFLSagTWZPDVUeHGNRYJ,KAAABAAAMACAEACAdAFALAGB..aAHB..TBCAZBDBDBIBeBEHhAAAHCAAREBA..XDGAhAIAACCACDFAODGDFFEDSGBAhBEA.gGFHPFDBUGGBhAAA......hACA...,1,-5,-24,19
MBRXQVGOAEHNLaKeCPfIJcgdWFbYUTZSD,HAAAaAAA.eACECADA...fAFBJAFAdCCA.FBHDUCFAZCCAMCGBhAAARDAB.QECAhAHAGEDAEFFELEHBhAIA.KFFDIHFA...WCHH.hCAA......hCDA...,1,0,-29,29
TQGcfBLDbdMXaKFJReUCSWZAEYOHVNIPg,EAAAHAAA.VAEA..IADA.TAFAGCAB.BAHBhAAAbBCC.dCHA.aDEDFBHDREABeDGDhACASDDAAFIBOECFhADAgDGGfGGEMFAAKHDACFFAYHAAhAAA....hAFA...,2,-28,8,36
EWIOfbJGHUQLKPReYdVACDSXFgBMacZNT,SAAAFAAAMADAZAEEEADA....OAHDbAFA.HBCBLCCAhAAARCEFeDGFdCGA.AAGAXDAChABAaEHD.TECAhADAfGCAGEEAKHFAPEHDCHHB.BHHDhCAA......hCBA...,1,-2,-12,10
JGQKIbLUHMSOBEgFeNAYZVfCdPXcTaDRW,ZAAACAAAdACA..XADB..aAEARAFAGCAAQBECKCFDLCHBhABAHBGBMCBBBCCDhACAEDDBeECBADEBVFFBfEGEhAAA.TFEADGABIHDASAHBhBCA.FGHD...hAGA...,2,-17,1,18
cZCJgTMWHYadbGBUQVAPefRSXOKNFIDLE,eAAARAAAOADAFADDLAFAZAGB..CBDA.TCEAHCEBdDDC.GEGAhAAAQCGCABGBSGFDhABAKCCDDEEBEEHF.hBIAgFFDMCCB.aGAA.BHAA..hAAA......hABA...,2,-18,-13,5
AeUCHYacIKJDMQEFRGPWbLZOTdSXNgVBf,eAAAHAAAaACAKADADAFAEAFA..GBGA..bBDAZCCA.dECAXCCChAAAgEEA.fFAAhAAAAAIBCBHD.IGGAhAFAMDFBRDGBWEED......hABA......hCAA...,2,-37,4,41
eYXEVMKTWNSIgQfCaOFRBbALZDHPcJGUd,ZAAAHAAAJADAdADA.eAFA.EBHFMAHB.KCAATCEA.SCAAhAAAQCEAaDDHRECAAAIBhABALEGBDCIB.GFABhACAXEGDNDIAfFFAFGAABGDAbGFC.hAFA......hAGA...,2,-23,4,27
QYaDOBSfEcFKGWLbdIMJVAeRCXNHTUZgP,RAAAXAAAHADBZAFA.QCFAaADA.BCCDEAGAKBDAGDAALCGBhAAAdDHAMEEBABIBeDBAhABATFFAUEEA.gGAAhAGADAGA.fFHA.FGDHIHHAhAAA...hBDA...,1,0,-15,15
bGERVYOMdeXJWgTfDNQZSCPLBFAIacUKH,aAAAKAAAHACBGACARAEA..OAHDeAEAXBFA..gCABhAAATDFADAIBZDEACEAALFDBhAEAAAEAUFDAEFGBMFFBhAFAdGCC.fGGASGHH.BCFA.hBAAIHAA..hACA...,1,-1,-11,10
GXJbLNKTPEABOWdSgHecQfZCDMRFVaIYU,OAAAdAAAHADA.eAFEQADAZABBDCFARDCAaAFE..UDGAGCCAhAGA.bCFALGEAhAIA.NICB.TEFA.hBAAAAIBSBBD.fFEEhBAACFFD.MFIB.FGCH.hCDAIHGA.,1,3,-10,13
AUZIdGQaWKFEBVcMRSfNbYLJDCgPHTOXe,ZAAAGAAAaACA.FADABAFAMAGB..RAGF.SAHB..bCCAhABALCDBCDGD.HCGBhAAATECAeDBHACIBdFAAhAFAQFEAEEHF.fGGBYFFBDIAAhAIAOHBAIHHA.hACA...,2,-15,-12,3
SXGdODabgPQKVYRZIFTBJALHUNcECWefM,HAAAUAAAEADAeACE.MAFAGAFAdBGAaCCA..bCBA..QDDBhAAAKAHBRDGFZDAATFBAhADAABIBLEGB.CFCASFFFhCAADEFB.gGCAYFDBBGGDhAHANEIA.WFHH..hBAA...,1,4,-11,15
bNJECcQKSgUAHTRZYOXPfVDdaBLMeIFWG,HAAARAAAZADB.XADB..fAFAdAGAaBEDMAIBeAGHFCAHGDAAhAAA.JCHBECCBQDEDhABASDFAAAIBTGGAhADAOEEBDEIBBCCCLFGBWFFD.CGBA.hAAA......hACA...,2,-8,0,8
KZGVFYeUdTaMXEQOJRSPHfWbDgLNIcCBA,GAAAFAAAeACHdADA.aAFAEAEA...QAGARBFBHDBB..bDDBhAAALCEB.IDDAhAEABBHAADIBZFEBUDGAhBAAMEHBOGCASGGDfGGADIAA.NIBB.hBIA......hCAA...,1,-1,-18,17
cQXgGYWARSfLKTZIbdHaVCDJOUMeFEBPN,RAAALAAAZADBdAGAHCEBaADD..DAFAOBHDeAHFBBFA..PDABhAAAQCAAGEGAhABAACIBKDDATFBA.VGDAhADACDFBMEHB.EFBAcDCCXGFD..hABA......hACA...,1,11,-29,40
SZfbOGCNdgKFAWPQRJHLEIeDaUcVYMBXT,QAAAHAAAEADEeAFEaACE.UCAB..VAFAMBGBBCDA.TDAAhAAAZCGBbDCD.CEEAdGGAhAAAFCFHACIB.RDGFLFAAhADADDIB.XGGA.OEEBNIAB..hAFA......hAIA...,2,-5,-1,4
ZgTRbeXOIcJPULCMYNGdQHfDVFKBAaEWS,EAAAZAAARAEA..eACAOAHDJAFB.LCAB..MAHBGCCBhABAHCCBDADAKDABADHBaEFBSCHHhAAA.bEFCXEGAhACA.IGCAcGDACGGAdGGA.fHABhAHA..hCCA...,1,-16,-20,4
dbSQZfLFHTDcgNAYJaMRGIXUVCeEWPKOB,aAAARAAAGADA.UAGAeACH.EAEAKCCDdAHA.QBFAZDAFLDFAhAAAHDDADFAB..gEAAhAEAADGAMFFA.XEGAhBAACGGAOGBEbFDC.FGHH..NIBB.IHEAhBBA....hCAA...,1,-1,-16,15
GdRZBfVLNCSgQPEcbFYOHDUTeXaJMKWAI,dAAARAAAZADBBADALAGBCAFA..QBGAEBFFFDAAHEEADCCAUDAAhACAeEHH....aFBAMDDAhADAAAAA.GEEA.hADA.fGEESEHB.gFCFhAFA.....hAIA...,2,-23,-17,6
LUTVYRDHQPdMSXNgIFCAWaKbfBGeEZJcO,aAAAKAAABACBGACAZADB..OAEALAGBUBFB..TDEAhAAARDFBHEBAdCCCMAIB.SBBDhBAAXEGAgFBAhAIACEHBAFFB.fGGAEGHB.cGCDhBFA.DBIB..hBGA...,1,-4,-32,28
cDbWBJIFLAGCYKXMOgNTfZdaeRQUHPESV,GAAAKAAAMACAOADA..TAFAdAHARBFBHCDBEBCA.SDBHhAAADAIBBCDAFCFHADIBXEGDhACA..fCHEhAAAeFDAPHBAbEEAIHAACHHA.gGGAhAHA..hCAA...,1,5,-38,43
AKHTbDZQJMWLNEIPaefYcGgSUVOBCXRdF,HAAATAAAZADB.MAGBLACB.EAEAaAHBeAGF..fCAEhAAAGCEASAHHhAAAOBHDXCEDhACARDGFACEBbEAAQGGBNCCA..IFFAhADA.PEHB.YFBFhBFA,1,-5,-6,1
QYZGcAOfSNUKJIPCLeBEFDbWgdVaMHTRX,SAAAKAAA..IADALADAEAFAbAGD..dBHAaCCAHCAAhAAARDDA.QCEAhACAGEAAAAAAfEGAhAEAUECACEHAeFABDAIBVFFBMEIBYHCAZFCFOFFHhAFA......hCAA...,2,1,2,1
XcWZaJfHTQALBdYFEUSICgMPRbGOVDeNK,dAAAEAAAUADACADA..MAFARAFAGCBA.DCHBeBDA.KBGAXDDBhAAAZABB..aDDAHDFBhAGAADGALEEAFFHD.hAIASEHH.IGEA.gGGGhBAA..hBIA...,2,-36,-17,19
PTXVUQJEgLGYDNCWcIfRMaSZAHdeBFOKb,HAAAeAAAOADCKADC..bAFA..TBGAXCAAQCCAhAAAECFAGDCADAFACCEAIEGAhAAARDFBaEHD.AAGAdEEAFHEA.hABAPFHD.JHDE.......hAIA......hBIA...,1,7,-20,27
bfJFBcQXdgPDTCKAWSVZYaRLEOUGMIeHN,SAAAZAAARAEALAHBEADA.GCAA.eCCBHAFA.bCCAFCFDQCGAhAAAdEHADACAKEEDAAHAVDABhABA.aECDMFABhABAfEEEBFGC.XEGCPHCACHHA..hAFA......hCAA...,1,9,-7,16
SXPYgTJKGHMaDCLWdfVAEFbQZUIcBNeRO,EAAAQAAAZACB.UADABAEARAFA.SAFH..XCFAhAAAgBGHTDBAhAGAGDEAHDDBaCBBLFGBhAIAdECAAAHAFDHDcGEB.NCIA.....hBCA......hBDA...,2,-16,-6,10
AKgFSWNdTMULIHObeCZPGDREaYQfcVJXB,FAAASAAAdADAUAFAHACB.eAEAZCCAGDFAEAHF..aCEDQFBAhAIAVDGBBEAAABHAKDBDhBAANEDA...MCIBhBDAOFFB.CGHADGCBfHDF...hAAA......hABA...,2,-21,-12,9
QabPZdYSCUIWMeNALHDXVJTOgEKFfBcGR,HAAAXAAATAEA.EAGEFADA.BAGARCAAaCECZBDA.dCHA.CDDA.ICHAhAAA.eEAAhACAAAAALEFBDEEAOEFEhADAfFDAGGCBQGGCbFGD..hAEASGAAMIAA.hAIANIAB...,1,13,-27,40
AXQEJDOdPRCaLNITSgYeVZWBbKFcUMfGH,EAAAOAAARACA.LAEA..TAGASAHHeCCAZCFEbBBC.hAFAFDAB.MEEBHCDCAEIBQFAAhAAAdDHAaDBDgEEAhAGAVFFAKHEAfGCA.XGGAhBAADIAACGCB.IHEAhBDA..,2,-4,6,10
bATLRCQBZSHFUPIEfeGNWOaMgJXKcYDVd,RAAAQAAAZADBHAFAFCFHUADA..ECHBeAFAGDAAOBHD.aCEEhAAAMEEB.JFFAKDBADCCBhAAAbEEAAAHA...TGAAhAGABHEAIHHA..fGEAhBCA.gGGAhBDA..,2,-16,-2,14
GQeHDfFNbUagJcMPYOEZKXRdLBACWVITS,CAAAVAAA..TACAGADAHAEBFAFAUCGAaAGA....gBGBhAAAMDAAODEDECAAZDDAhACARFBAdFHAAEAA..SEAAhAEAQGFAeEGHDIAA.fGDAhCAA.NEIA.....hDCA...,1,-7,-9,2
QYeAEgKVMBbHDLPfZacCJRdFWXTNGOISU,EAAAKAAAMACAHACALAFBZADE.CAHARCDBdAHA.FCCH..TDGAhAAAGCFASCCDhAEAQEDDACHABFCADDIBaFCHcFFAhAHA..WFHDNIDB...OHDChAAA......hBHA...,1,-2,-25,23
MYECJPKHcQXNRAOaFIVUTBdZDSWbegfGL,aAAAFAAAUADABADAZAEB..SAFA..eAGFGCEBhAGAMAIBECCBCBBDKDAAHEEAQDCChADAXGGAAAIBOCGDhBAAIHCAdFEADEIBWDBD..fGGAhCAAYHEA....hCDA...,2,-25,-11,14
afbEIDTWCQFZNLBKPVJMOcURGgdXSeHYA,aAAAEAAADADA..TADAQAFA.ZBCALAFBKAHB.PAHBhADAMDBAODEEhAAARCCBdEFAeDHFHEBAABBBfFCEhAIAbFFACDHBBHFA.........hBDA......hBEA...,1,-12,-15,3
INRYEJKgMbDFdfSQLeaUTcWPVBOXCGHAZ,ZAAARAAAEADEKADC..MAFAFAFDdAHA..QBFAeCAB.aCCATCDAhABA..PDDBhAAAOCCHGEGAHDFAADHAhACAIGEAJFFF.DBIBLHBAWHCG.BHHAhBHA.....hABA...,1,-7,-22,15
FZILDHSOBCMUcPXdeYNGJEgAWKabfTRVQ,aAAATAAA..RACFQAECZACBLAFAHAGBBBEDMBBBUCGAXDEAhAGAeCABGDEAhAAAEDHFAAIBKEDDbGAA..FGGASFFDhBAACEDC.dGGA......hCAA......hDAA...,2,-5,-2,3
GaCVURKAZPfXSEMNTbLYcWHBeFIOgQdDJ,ZAAAXAAAEADE..MAFA..bACDLBGB..cAEAhAAAHCAAeCEBOAHBdFCAhABAGCEAaEEHCEHARGFAABEBSCHHhABANIBB.TGAA.BFHA.hACAFGDB.QGFDhAGA..,2,-7,5,12
LTDHaeRGEIbUSKQAOYZcBdCgWVPJNFMfX,ZAAAdAAACADA..VAEA..JAFAMAIBLCCAHCAARCGBGCFA.hABAECHBbDED..KDAAAACAOEABhAEABECA.gECAhAHAPEEB.fFHADFBBeFHB...hACA......hADA...,1,1,-28,29
UWIKfgCaTDeLRAcVHPMGFBOJbZXdYNQSE,HAAAGAAAOACAZADAdAHAQAFAECDA.UCCAKDCDCDFADAIBRDGF.ACFB.hAAA...VDFAMEABhAAABFFDXFDASFHHhBHA..fGGEaHGC.eHBAhACA......hAEA...,1,-10,-20,10
LUbTBNZDgJPIdCQReOWHVaFAGYcMEfXKS,GAAAMAAA.EADAKADALAGBUAFABAHAZCDBDAIB..JBBBdEGA.hBAARFBBeFDAHDCAaCGEAAAB.hACA...fGHAhADAbEFA..TFDA...gGGBhBBACBFB...hBCA...,1,-11,-24,13
VENdKfgMGUODRTZPSXFeQLJAYIWCBHbac,..IAAABAAAHACA.aAEAEACAdAHAKAEAMCABGAGA.DCAARCCAZCFFhAAASCDAeDHBLEEBhACAAAIBCDCD..bDFDhACAcGGA.fHBBODHDTGAAhAGA.FEEB....hCDA...,2,-19,-3,16
gGUZYKbTfCPFSEVINDeacLMXRHOBdAJQW,QAAAGAAAZADAKAGC..bACACBHAFCDAEAGA.....VDFAhAAADBIBeCDB.aCFDMDDBhACAHDAAdEADAADAgEGAhAAATGGA.SFDANEEA.LHCAhAGAOFFB.BGHA.hAEA...,1,9,-20,29
DgARfFYcISKUHCNLJQXZbdEMWOBGTVaeP,RAAAFAAA....IAEAKADAHAFBLAGBQCCAZBDEEDAAMAIBhADABDEAGDGA.aEDEhAFAeCHHDGEA.AAAAfEDEhADASGHHCHAAXFFC....hAIA......hBIA...,2,-29,-16,13
MWaYEJPZGLSQOXfBHCdAFUIbRgDNcVeTK,FAAAUAAARACF.DADA....VAFAeAEAKCEAaAHD....ECHFZBDAhBAAGEAALDDBQECAhAEAfDFEHEFAhAFAADHA.IGHA.NIEB.MEHB.YFFFhBCA.SHBAhBHA.,1,-5,-36,31
aVGOUJHIeSQDKcgWEANXdCfbZTBMRPYFL,dAAACAAAZACAMADA.RAFA.FAFALBDBGCCAUCGAHCAC..eCFAQDAAhAAAKDHB..gEFBhACAAADA.fFCAhAIAbEFCBGDAaGGAOFFH.IHHAhBAADIAA.....hAIA...,1,4,-28,32
UCQWbYEaPIVXBNAFMfdLDHTKecSZJRGOg,MAAAdAAAHADAKADA.eAFEZAFBGBBAOCAECCEA..QDGAhAFA..bCFDEAHFaCHBIEDAhBAABEECADIBfFHAhACATFEASGHB.....hADA......hAIA...,1,-11,-25,14
PdQVeDFHfGSaNXIRUOAcETKCZbLJYBWgM,EAAATAAAZACBLAFA.BBEDMACAdCBCeAEAHCFAGBGAhAAAaDEH.XBDCREGB.hAAAAAIBCDEAbGAAJEDF.gFFBhCAA.........hAGA......hAHA...,2,-14,-12,2
XQDFATbPYGWHdIRMgKZSLBVeCfEOacUNJ,TAAA..bAAAGACAHAEARCAAMAEAZCEALCHBeAHF.EEABhAAAaBEAUEEAXCAChAAAQGABACFBPDFDdGHA.hABAKDHBSGCHCEDAOFGDNICB.....hACA......hAEA...,1,6,5,1
FPIfagEWVAUJeQXNGbHDRZKOTdYCSBcML,eAAAQAAAGADAHACARAFAZCFEOAEA.dBHASCCDhAAAMCEALDDAFEFD.fEGAhAAAEEHBAAFAJHCANDBAbFDB.hABAKFHB.CHHD.BGHD.......hAIA......hCAA...,2,-9,-6,3
caFXWOZePATINGBHLJEfMURgVCSKbYDQd,TAAAGAAAHADA.EAGEMACARCDA.CAFAKAHBDCGAdDHA.FDCHOBDBhAAAeDADAAABBCEA.LCGBhAHAfEFAgEBBhBEASFEDbEEBQGGAaGGA.hACAXGDDWHEA..hCAA...,2,-22,3,25
MSeQDOAagZNXfFPJERTGdYbCKBUWVHcIL,ZAAAXAAAFADA..EAGARADAdAGA..CBHABCAAVCEB.HCCCLDAAhAAAeCFG.QEGAhABAAEFA.aBHDfEGAhABA.TGAA.YEHBKGGD.hADAWFFDMIAA...hACA...,2,-30,-6,24
PSbaZAQLfWYOgXEUFKMHNJedcBIGCTVRD,LAAA..fAAAOADDEAFAKADAHBFCeAFEdCAABBCDhAAAGDDBTBFARFAASDHHhABAZDAAACIBQDGDhACAgFGGFDDAMFFBcGDBCGGADGIB...hACA......hAFA...,1,-6,-12,6
bIYKOLQdWAgaVBfCSFTUJMENDXPZGHcRe,aAAABAAA.SACAFADAUAGA...EAFADBBBZBEEHCCARCAA.eDFAhBAA..bCFAKECDLEEAhAAAdFFAAEEB.VFAACEHAMIBAhBDAXFGA.cGEAOGBE...hACA......hADA...,2,-19,-13,6
JcQdSEeKGZMfRWTLUVXaHCbBgFPYIOAND,DAAAQAAAEACA.eACAZAEBRAGBLAGB.XBDAHCCBbCFDhAIAFDAA...IDDAhAAAABBBJEBFdEHAGEFAhADAMFEB.TGBAaGGC.BEHA.YFEFhAIA......hBGA...,2,-13,-5,8
KCbWEZOBdJgUPTVIMcANXeQHaSDFfLRGY,eAAAHAAAaACAFADDRAFAGAEA.KAGACCCD.ECCBZCEE.dEFAUDGA..hAAATFAAMEEBACHAQFCChAAADFFBLGAA.hABA...YEHB.OHECBGGA.hAGA......hAIA...,2,-12,-12,0
caYfPXJRMNITGdUWAbOEHQCLeZBVSgDFK,EAAAHAAALADAeACEZAFBBAHASAHHFBCHKCEA.aCCA...fDDEhAAAXCGBREAAMDHBhAFA.TFCAdEEAAAEAbEFDhAAAQGEA.CGHADDIBPEHDIHBAhBHAWHAA.....hAHA...,2,-24,15,39
OJIGHPgQNdSUWRVCTYFMfeKAXLcaBEDbZ,LAAAaAAABADA.EAEAZAEB..OAGDGAGAHCAAQCCAhADAdCEASCHHRDFBCBBD.TEFAhABAMDIBeFFDAAIBDEABbGBAhACAIGBA.NIAB.WFHH....hAEA......hBGA...,2,-11,-8,3
AYJMECGQHaOZVLfXDcbSFKUgdeRTWIPNB,MAAAEAAAGACAHACCZAFBLAEADAIB.SAHHKBBDdDCARCGF.TCEAhAAA..IEEAhAFABCBDAAFACDGAaEHDODHDhBCAXGFCbFFDFEEH.eGCGPHBA...hCAA......hCGA...,2,-11,-1,10
JDREaIKXBUFfTONQVGWgYdLAcCMbZSHeP,MAAAZAAAHAEA.eAHHDAEAEAGAKCAABCED.FDDHTBBA.QBDChBAAGCFAgEAAhABAdCGAABIBCDEA.SDHHhACARFBAaDHDXFFCOFFH.NHAB....hBBA......hBFA...,2,-21,-3,18
RcZCBFaEYITHWJAbVUOXGefPKSDNLQdgM,UAAAGAAAeADAKADADAFALAHB.dCDARBFAZCDFFBFD.EDFB..TDAAhADAHEGBAAAB.ODAHhACAXEFA.SFEDhAEAQGBAMEIBBDHBaGGH...IHBAhBAA...hADA...,1,-8,-18,10
KZMaCAYbgEHXdcOTPGLIeUVJWDQBNfSFR,...bAAAHAAA.dADATAEAGAFAeAGHVDDBDAAAQCABhAAA.BAHASBHHhAEARDGFZFAAaFHDACCBECEBOHAChACALEEA.IGAA.UGEAhAGA.NDDAKGHB.MIAAhAIA...,1,8,-9,17
AdBfQIRHVWLObZGcEUPKJCFaTXYeDSgNM,dAAAQAAAHADALAGBZACBEAEA.KCBAFAGDaCED....TCEAhAAAeCHHSDADhACAMAIBADHBBECAREFBOEDBhADAGEEB...cFAD......hAFA......hAIA...,1,-9,-17,8
WFdJMDabKQNfBUOVCPcgIXLSHeAGTYREZ,GAAARAAAEADE.ZADAdAFAMAEADAHB...aAHDQCCABCDA.OBHDhAAACCFD..gDCGhAAALDFBeEHBhABAADHATEGAFHGC...bFEDNIAB.....fGGEhACA.PHBAhBAAcEDD,2,-28,-14,14
SKFBZEUYDLcNdHAObIMQCgJTWfRVeXaGP,OAAAMAAA..QADACADA.TAFARAEFeAGH.GCCAhAGAKBBAZCEEEBBBDAIBLDHBhAIAdEFAADDB.bEFBIEHAhAHA..WFFDfGHA...hBAA......hBIA...,1,-16,-23,7
GOTVHBWYXUKfbIASReFDgMaQdZPcLJECN,RAAAeAAADADA.MAEAdAGAZBDBLBDA.EAHFGDFA.OBHDhAAAHDDABCCD.XCGAhAAAfCCAABEAFEGDaFCAhABAQFDB..cGBACGHA..hAIA......hBGA...,2,-32,-6,26
NfKQbRAaXUEdZIFHBgJYWLGTMCPeVDScO,aAAAEAAAZACBHACBBAEA..JAEALAGBGCEAMAIBeBFFSCBDhAAAOBBHKCGBREBAAAIBdEDAhBCAFEHD....gGCAhAHATFFACDHADFIBfGFA...hCAA......hCCA...,1,1,-24,25
NcRGWEUVeDLIaFTgCXQMAfdPSBZbKJYHO,dAAABAAAZABBKACAHADA.OAFARAEFEAGE.eBHFLCAA.FCGATCEAhBAA.CDCAMDIBhCDAADEBSDFH.JEAAhAAAcEECGEGAVGCAaFEH......hCGA......hDAA...,1,-9,-24,15
XCIAZNeVQaLfESMGPKRFcbHBUDTWgJYOd,eAAAaAAALADAEADAGAFARAGF..FBBHHCCADCEB.TEEA.JCHBhAAAdDFACAHA.AAEAZEGB.QFCAhAIAMECBKFHBBGGDhABA.WFBD........hAHA......hBFA...,1,-6,-29,23
aSBOHRKYGDTceJdfUAMZCFWbVNgXLPIQE,ZAAAFAAA...VAEAXACDLAHB.QCAAEAEABAGAHCDChAEARCDBGDFATDGAeEABhABAdFFAAACA.MAIBCEHB.NEEA.hBAAgFDG.aHCCKGCBDGIBfHGFhCAA....hCBA...,1,9,-18,27
OfCeJNLDIgXGYZAQUcdVbWKMSEFBTHRaP,QAAAdAAA..bABDMADAFADAHAFBRAFAaBDB...OAHFhAHAeCDHLCFADCEB.hBAAXEFAZDFAAFFAcGGAhBDAKFEDEGGBBHDAfHCBCHFA....hAAA......hAIA...,1,-13,-16,3
DMKUYbVdeXTPWINBGcZQFfJOaERHACSLg,LAAAMAAAKADA.UAEA..VAGBeAHB.TCAA..IBBAhAFAGCCAZEFAQCDAhAGAfCGAaDCHHEFAhAIAAEHASFDHDGDAdGHAPHEABGBAFGGB.hBAA......hCAA...,1,-3,-17,14
cVagORCGIFDWYEUdQTLKAbZPSHBJfXNeM,ZAAAHAAABADBXADBeAEH.MAGB.aAHBRAGBGCAA.DCGBECABhAAAdDDDTCCAAAIB.bCEDhACASDHH.hBFAJFFBfCHA.cEGDOGAEFGEBhBIA......hCCA...,2,-25,-3,22
bEGMCDZXgeFNLdWUVYaABfKPcOTQHIRJS,KAAAOAAAHACBRADA.SAEAGAGA.MAHBZCCAeDFH.LEAAhAEAdCAAVCEBAAIBBEHAhAGAfDHATGGAQFAAhAAA.bGFADBBBFGCAWEED...hACA......hAEA...,1,-9,-10,1
UaJBdLcFEGNbRKXYgZCQOMSTeDfIPAHVW,HAAAUAAABADAdADALAFAFAFA.ECABGBDBRCDAKCGC...XCGAhADAZDFEQFGAhAAA.MCCBeDDBfGAAhACAAAIBaEHHJFFB.cGFC.....hBAA......hBCA...,1,6,-36,42
JWDPILFQXOcdSVMReHBZaNUgETbYAfCGK,GAAAKAAADACALAFAQADA.OAFCdBDAMCCBHCEC.aCDHUCGAhAAAEDHF...TEEAhAGAAAABCEFDPFHD.FHAAhACASFCHeDAD.BFHA.gGGGhAHA....hCAA...,1,10,-34,44
fZGIEYKUSBcXTReLCJdVbWQDaAFHNgMPO,HAAAMAAA.OACAGACBEAFAKAGCBAHA..TCCARCCAeCFELCFAhAFAdEEA.VEEAbEFDDEHBhAAAABBBFFHD..NEIA.fGCAhBAA.IHEASGDD.hBIA......hCAA...,1,-6,-17,11
bRNUfYAJTaFgOcWMdQXEZDeIVLKCGSBHP,aAAAOAAA..MADAdAEAEAGAZAEE..eAHHLBDDGBCAHCEChAGARCEFUEGAABBBTEGA.hBAAFFEBgGCAhBBAQGGBDGFBKBHBBHHANCCA.......hBAA......hCAA...,1,-7,-8,1
GZPaYAfNWUVSBOHMeXgIDFKTEcQdbJRCL,...fAAAUAAABADAHADAeAEHXAGBDAGAKBGA...EBCBhAAAdDAARCABGCFAZDCA.hADAaBHDADFA.VEDBMDHBFFAHhACAQGBACFHALHFA.YFCFSEFHhBAA.OFHD.hADA...,2,-26,17,43
VPKAMdQIcFNTRJHBWbEYXSUegaCLGDZfO,dAAAQAAAFADARAFF.HACABAHBEAFE.SAHBeBDB.aCDDGCBAhACAZCEB.OCHBhBAAKCGAAEAAMEGB.IEHAhAAATFDAJDFF.....YFHBhBCAXEAA.CHGA.DICA.hAEA...,2,-15,-12,3
BKUYNaEVLZeAIQObCWDdHRFJSXPgcMfGT,QAAACAAAdACAHAEARCDBSACA..XBGA..hAAAgAEHMCBBGDFAhAEATBGAKFDDUGAAhAGAaCDCEDAALEHBAAHAbDFAFEEHPHDCBFHDNIBB.ZGDAhAAA.IHHA.hAHA...,1,7,-3,10
VFDOgeSMWUdLcPQAaGBJXYIKfTRCEbZHN,GAAAXAAAKADARADA.EAFEHAGB..FBHDOCDBeCDA.MCFBdECALEEAhAAAQDAAAAHAaDAHhACABDGD.IFGAhAAATGDACGGAZGAA.DEEB.SFHH.hADA......hBAA...,2,-15,0,15
BRZbYXfDcdgeOSENHPTIMCJWVQAFLGaKU,GAAAaAAABADARADAZAGB....XAEDDBIBdCDDeDADEAGAHCCAhADA.TCGAMEEACEHAVEEAhAGAAAABLFFBKBBD.hBAAUGABfFHA......hBIA......hCAA...,2,-16,-15,1
dCTKfEgHPORWXaVbJBMFSGLeNQUDAIcYZ,..IAAAZAAAdAEATAGAKACA..EAEEHCAARAGF.aCEE.JCHBMCAAhACA.GCDAeEBAQFEAhABAACFBCDGD.hAGAfGAAODHDXFFCBGGB...hACA......hADA...,2,-23,-12,11
PHfRSdcTMIKUXCNWZbOFVBeDJQEaLAGYg,GAAA..gAAAHADARAGFdCDDMADAKDFACEEDZAEE..FEHDeAHHhAAAQFAAECCBABDB.hABA.fCEAhCGATGFA.XDFDNIAB.bFEC.BDHADDAB.aFHDhDAA......hDBA...,1,-7,-15,8
cdaMeFWNCRKYTOXLZQbUEIBHPVSfgDGAJ,dAAAeAAAFADACADA.RAFF.KAFA..OAHDZBFEUCCABBDD..HDFA.hACASFAADCCBADDA.hAHAaFFCMDFB..NHAB.hAAATDGALFHBEFHF.......hBAA......hBCA...,2,-42,-15,27
DJNeSKBGEfLZbagHQFPAVMXYCRUcdOWTI,MAAACAAARACA.dAEA..OAFA..TAGADBGB.eBBABBHAECFFhAGAZCAA..aCHDHCEBhAAAQEDCACEB.XFGAhAIAcDGDJFHBKGEA.LHDA..hACA......hADA...,1,-13,-32,19
ASOcLXgFNKWJbPQTYefaIEMUGRZHVdDCB,OAAALAAAFADDKAEA...JAHBQAFA.eBBBaCAAECEAhABAGDDAHDCAdBHABDGDhACAACFBXDGC.hAEAgFAAbEFATGAAfFGAMIDA.hAGA......hAHA...,1,-8,-20,12
BCQHfNVXOIPRYFEUKGeDMTWbAgdZacJLS,ZAAAaAAALADACADBHAEB....VCAAOAGDRAGB.EBBBGDEBhABAeCEBMAIBTFGAAAEAdEGAhBAASEDDQDCDhCAAXGAAIGDAYFFFKGFDDEIB...hACA......hAGA...,2,-6,-3,3
ASCeQVYTZGEbJKHdBfXOIWgcFULNRDaMP,eAAAQAAA..TADAEACAKAEAHAFBdAGABCDAOAHF.gCCBhAAAFCFHLDHBhAAARDFAaFAAAAIBCDCDZFDA.JFHBXEEChCAAIHAAcGGC...DICA.hABA......hAFA...,1,-1,-19,18
dKSLZBVfbUPWITXFYERQcJDOeACNgMGHa,CAAAMAAAHACAdAEALAFBZAFBBAHA..bBGDUBBA....ICAAhAAATDGAFDEHRCDBQEAAhACADEBA.AAHAgFCBhAEAaFGCKHCA.fFFA.hBAAPHFC...hBEA...,1,5,-36,41
PNRSDCQHeKfbgcFMLJXZOTAdIVBGWaYUE,dAAABAAAaADAEACA.RAEA.CAGA.HCAA..eAHHKBHB....bCECFBDBhACALEFAZCEBACCBGEGAhAGAUFAA.SEDDhBAAQGCC.fGEBMIDAOGDEIHHAhAAA.....hBCA...,2,-23,1,24
VYbBGPEeSTCaLAMUWIcOgHJNXFRZKdfDQ,MAAAUAAA....IADAOACEHAFB.XBBCRAEFdAGAQDCAhAIAVCDBBAHAECHFhBAAeCHFCEEB.AEGBgFAAhAFAFEGHZGDADEIB.bFFA.SHAA.hBCA......hBIA...,1,0,-22,22
KbCESNAHMVQJcXBYUFDTROLGdPIfeZagW,HAAAMAAA.QADC.XAFBBADAFAFARBGFGCABdBBAfBEAhAIAeCFDaDHDKBHBEEEBhAAAACGB....VDCBhBAAcGGADDHBLFFA.ZGEA...hACA......hAIA...,1,4,-23,27
IZQUEDXPNFBLMHOVdSKaAefbYgGRTJCWc,eAAA..bAAAGADARAEA.TAFACAHB..ICAAZCFEECCBXEFAhAAAFCCHMCGBHEAAhAAAdFAAaFHDAAEA..fCHAhABAgGEAcEDDDIAABDBDLFHBhACA.SGGFhCEA.KHCA.,1,4,-13,17
WUVZGbAJaeMQXFcfRPTgYLCSBOIKEHNDd,eAAAMAAAFADDRADA....TBGALAFABAHBKBBBHCCAdCFAVEDBhAGAbDFA..AAAAaEAAQGFAhAHA.fCHAhBAAgEEGSDDCEFCFDFHB.WHCGhBBA......hCAA...,1,-5,-26,21
JLQCYRPZfSeTNWBVbdcaMEFUgDIGOKXHA,LAAAQAAARADFZAFBeACA...TAFABAHAdCAA.aCCHEBHFhAAAFCHBDCDA.GDAAhADAKEEAHFAAAAHACDDA..fDFAhCAASEHHVEGBbGEC.MFDB...hABA......hACA...,2,-19,3,22
afHBUVgPAXWNDKYEbdCFISZORLTGecJQM,XAAADAAAEACA.dADAFAEDZAEBLAGB.GCCAeAGFQDBAhAAAaBBH.HCGBhABABDHAgEEBhAIAAAIBKEFAbFDD.SFHH..TGBAMIBA.hBDAfFHA.hBIA...,1,-8,-20,12
CLaQVefHbIFNOMWdEKcJARSDGgZTYPUBX,RAAAGAAAZADB...TADAUAGACBFCLAFB.aAHBeCCDHDCAhAAAFDABMBIBEDGAKEEAADABDDHBhACA...gFCAhADABEHAQGDAbFFA.IGGA.hBAA......hBCA...,2,-28,1,29
AZPXNSYRDHIagKFBOJdbMGcVWECQLTefU,ZAAAXAAASACERADA.HAEB.aAGAFAGABBGBdCDDGCFAhAAA.VDAAECCBLDGBhABAeCHBAADA.PEDChCAADEEBKFHDbGECMFFB........hABA......hCAA...,1,-5,-12,7
aMLPgHONJVCTEKSXBZfIcGdUbWYRDQeAF,aAAAMAAALADAHACCOAFA..VBGBEBBBKBFABAHBZCFE..hBAAfBBEGDCAbEGBhBIARCEBeDCFAFFA.FEAB.hCAAPEHD.gGFB.NEEA..hCDA......hDAA...,1,-3,-10,7
MNfGPXSAbDFBdJQaIgCTUOZVeYcRHLWKE,FAAAdAAAaADACADA..UAFAZAFB..eAHFRCCA.HBDDLBHBECBFMCIBhACAGDAA..SDDDhBAAACCABDFA.QFEAhBCATFFA.OEHH..YFHBhADA.KEED.fHDBhAIA,2,-26,-14,12
cQaFTAKJdCRZNHfUbXMDIgPGSVOeLYWEB,dAAARAAAHADBUADAMAFADAGA.....gBFBGBFAOBHFhACAeCCBLBHBECBF.hBAAQDACaDDBAEEACEHDZFBAhBCAbEEB.XGFD.SFDHhAAAYFFFBGGB.FHBA.hABA...,2,-12,0,12
CRKVXaULgTBOYJfFeNdcAbHDMSIGWQEPZ,HAAAMAAAGACBEADEZAFBRCAAKAGC...aBBCLBHBBBHA.OCEHhAAAJCEB.eEGBdDGAADDBbFAAhACADDIB..SFFDhAFAQFAACHCD.XFFC.UGCA.hAIA......hCAA...,1,0,-18,18
AMaWTHNYfEZJeVPRDUIdgCKXLbOQBcSFG,aAAAHAAA...fADBEADAeAFARCCADAFAdCFAKAHBLCHB.hAAAQDACSBEAhACAABBBMEEBTCCAZFFAPCGDhCAAgGAAbEEDBFDAFHEE.NDIA....hADA......hAGA...,1,1,-7,8
IWACFKVeQGbNLXUHfdMgRaEZDOcBPJTYS,KAAAeAAAGACALAEAHAEAdCCARCABZCFBOAHDBAHB..TCFAhAAASCHHAAFAFEDDQFFAhABAXEDD.MDBBhBDAEFHBDEAB...PGACIHEACGGD..hCAA......hCBA...,1,-7,-14,7
ZWIeOSVKRcdCHMTAQYFXUJbGNfPBELgDa,QAAAXAAAUADAGACB...fAGBEAFALBHBhAAAaCDCZCFBeCEA.SDBAhABARDAAdDHAHFACADBAFEEAhAIAbFECBGHADFHBOHDAKHEAMIAA....hAAA......hADA...,1,11,-13,24
LUHEfaAKMFPCeQYbgWBdXRGcDTVSIZJON,MAAACAAA..eACAQADA..bAFABAFARCAAGCEATBBAhAHASCGBZBGBODDAhAIALECBHFFAEGCAAACAFEHDhAAAYHFGdGAADGGB.IHHA..hAGA......hAHA...,1,-5,-10,5
BQaIGOegfYbHALFZREMdNSTKXDPWUJCcV,ZAAAEAAAdADASACE.KAFADAFA.UBFACAHBBCCDaAHD..GCBAhAAAeCEA...fDDBhBCAHDFCACEARFAAMEEBhABATEFAXFFC..PFHD.cFCDhBDAIHHAOHEChCAA...,1,-19,-24,5
SRVgWCUEYFLHOGXZfPKQbeIBNcDdATMJa,MAAAaAAA.RACA...VADACAFB..EAHBLAGBHCCCGCFAZCCAKDAAhADAeCHBBDHADBBBAAIBSEEAhBAAUFCAOFFHXFGAhBBAfHGFbGCA.NIAB......hCAA......hCBA...,1,3,-23,26
FfBRCaPZUKbGOgHWTALYQIVNEcedXSJMD,LAAAQAAAVAEAEACA..dAFA.SAHBMAIBFCAARCGBaBDDZDCBhABA..KCGAGEEAhACAHDEAADCBIEAAeEHFDFBAhAAACGHA.bFBAOHAA..gGFDhBFA.YHBA.hAEA...,2,-11,11,22
NcPXfGgCDHABeIJKEUTWdMYbLVFSROaQZ,eAAAKAAAEACEUAEA.dAHAMAEALBDD.FDFARBDAaAGE.ZCFE.hAAA.PEFBGEEBDCCBhABAACCBBDDD.IGHAhAAATGBA..YEHBSHCA..hCAAOHFC...hCBA...,1,-15,-27,12
WSEUNKbaPGJDgAFMTLcHVIZRQCXfBYOde,MAAATAAAHACC.ZAFBRACFQAECCAHA.BAGBdCCAeCGHhAFAEBHFKCADaBBHGCFADCIBAEEALFCAhBAAIEDAfEHAhAAAOFHB.SFDA.NIAB.hACA......hAIA...,1,-13,-14,1
KITVeHEDNQLfJdaZOSCAYMbRGUBPFXgWc,MAAARAAAGADABADAFAFA....XAED..gBGAhAAAKAGATBBAHDAAECGAQDDAhAGALDFAdFFAhABAZEGBCCCDAFIBUGEAcFBB.eHFADIAA.NIAB..hAIA......hBAA...,2,-20,8,28
fBHGDOIVYQUTcNFERdSgJebKaLCXMAPZW,ZAAABAAAHAEAGACAOAHD..IAEAQCAAUAGATCDAhABAFCABRCEB.dDGA.SEADhACAeDGHaEEHXGBAhAAAAEFAfFFE.DEIBYEHBEGCA..hACA......hBCA...,1,-1,-21,20
CWGbLdOEgePYADSQBIcNUMFXJTfHVaKRZ,QAAABAAA..IACAUADAMAGBFAEA...TDBAhAAAHAGBaBCERCGFZDDBGCEAhAAAdFFAEAHBeDDDAEIB.SDHHhAIANIAB.fGDECFBD.bGFA.hAIA......hBCA...,1,-10,-14,4
FSJKUBfCMPgdHacRNQGAELIOXVeTYZWbD,EAAALAAA.XADDeACAZAFB.DAIBSAFAKCCABBEAMBHBhAAAdCAAHCEC.REEBGFABhABAADAAODHD.TEEAhADAYDHB.FCCHfGEECBHAaHEC.QGGChCAAIHHA..hCBA...,2,-29,9,38
JfeFKDNTaGVRLUXSEYAcZWMBObPgdCIQH,ZAAAMAAAOACA..bABAdAGA.QBEAHAFAeCCBDAIBaCEDRDDBLDHBhABASCGAACCBBFGChCAACEFAJEHB.KGEAGFABhAFA...........hCBA......hDAA...,2,-24,-5,19
WUfSOHXbFdgLeZYAGRcEIVTBQPNKDaCMJ,RAAAEAAA..TAEAQACAKAGC.aAEEMBIBUCFA..OCCBhAAAHDDBbFABdCGAeDABZFGBAAHA.hAAAGDEAIGFABEDChABADCCBCGDAfGGAFHDC.....hAFA......hBHA...,2,-6,-1,5
YITbaVJdCcNPXQfRDKULeAEMOWGBFgHSZ,EAAAMAAAGACAFADDHAFAZAEA....TCEAaBBBdCFD..CAHB.PCCBhAFAQDGA.hAHARFAAKCBDeCHHAAFABEEDhAAASEDAbGCA.cFGCfGGADGEB..hBCA......hCAA...,1,-8,-14,6
KecFfXCgVUHLOTYNIJRBGdWZAEbQaMPDS,EAAAaAAA.DADAKADA..eAEAFAFA...CAHAUCBAHCCATCGA.hAAA.ICFARDABdEEAAAIBMEIBhADASCGH.hBAAXDDDgFCFLFGBOGEENCIA.BBBDhCAA.....hBCA...,2,-35,-4,31
eRPITSNgaFBKAbQOVGDLYXcJECfdWZUMH,QAAAGAAALADA.XAGDEACAdAFAZAGBHCDARBDBTEFAhAAASDCD.aDGDKDHBhBFAAAABOEABDDDBJFEFfGHAhBIAMDIBeEFDIHHA.FGEH.hCAA......hCIA...,2,-14,11,25
aKJBLFMYVIdNASOHXfEGPZbRCTUQWDcge,HAAAEAAAZACBRADFCAFB..QAEADAHB.eAHBaBHDBCADLCBDhAAAMCCBIDEA.hAAAACHBXDFDGDDBbFCDhACATGBAUFGA.gECB.FFHD.hADAdHEB.....hAIA...,2,-19,12,31
BgPIMCNGRcbTaOSfZYDeJVdFQUXLAHWEK,HAAAEAAABACA..gADBMAEAGBCBRAGB..TCCAaAGESCFAhAAAZDFAeCABdFADhAAAQEEALFFBACIBKDDDhBFACFHDbGAAfEGFDEEB.FFHD...hACA......hAFA...,1,8,-9,17
cLAdJeITORXaUGKPSMYCWNZbVDEHBQfFg,eAAATAAARADA..UAGAGACA.KAEAMCCBCAGBZBFEDDDA..HDFAhAAAQDFAFCAHLFFAhACAAAAAdEAA.OEAE.hAEAaEDDSEED.YEHBNHDB.hAEAEFCF.fHEBhBIA..,2,-16,-4,12
XeIBfdTbgCDJGNWcPEULMaHFKOQSAVZRY,RAAAeAAABADBdAEA...TAGACAFAGAGA....NBDA.PCCAhAAAECFFMCCBHDEBOCHDhAAAAAIBZFAA...XEDDhABAbGEADDIB.JFFA.cGAA.LHDAhAGA.....hABA...,2,-26,2,28
RJVIcGQOTXEKUCWDMBSFYaHeZdbAfPNgL,...fAAAgAAARADA...IADAGAGATCAAhAAAKAFACAHBDCCAMCFB.FDCDHCDChAAAeDGDbCGBAAIBLGAAhACAVFAAQEEBEEABBGGDaEHD....hABA......hAFA...,2,-12,6,18
NcAMDIYXEWKPeSCTgRVfGBLbUaZdOFQJH,MAAADAAA..XABAEADAKAFA...eAEATBBARBFAGCDA.hAHALDHBaAHDdCEAQDGAhBAAHEAAAAEAIFFAhAIAPEDBCCCD.VFFBBHEA......hBAA......hBIA...,1,-10,-12,2
MeXgDEdTbZWCJVQLNYcUBRHSGAfaIKOPF,aAAAOAAA.FADDeACH.DAEAEAFA.dBHAZAEE.CBHA.QCEAhAFALCFB...cBBChAIARDDFHFGBGEGAABBBKDHBMIAAhAIATGDAJHDA........hBAA......hCAA...,2,-14,-13,1
dRBYSKLgcJDMXWFOQEbZPVHaACNITUeGf,CAAATAAAGACA.RAEA.SACBLAHB.JAEAMCAB..FBEHECBBhAAAZCFBHCFBAAHAUGGAeEAHhACAdDHAKEDADCCBOEHDhAEA.PHCAaDDCfHEFBGGD...hAFA......hBCA...,1,5,-21,26
FgecXCNdPMKVSDWLYGUfTAQIJOEHZRbBa,QAAAOAAAHADARACABAFBaAFA..eAHHCAHAdCEAMBBB.SCCBhBAALCGBGDAAhAAATCEAADIBEEDBZEEAbFFAFGCAhCAA.XGEDKGDDDCIB.......hADA......hAHA...,2,-14,6,20
MIfbeAXYEaZWSQJDdgBONHLCFTKVGPUcR,EAAAZAAAQAEAdADABAFAHAGBLAHB.TCAAGCBAUDDAhABARDDFMDGB..bEGBAAIBaDHDhAAASEAADFABOFFHhAFAFGBAKGFB.........hBCA......hBDA...,2,-15,-3,12
CIKEPGZfDOgYANaQWcBXLSRVHUFMTJedb,aAAAQAAABADALAFARACAHAFBFAHF.MCEBeBBB.dCFACDAAEDFBhAAAZCGBODAB.ADDA.hADAcEGDSECAhAGATFAAIGGAKGHBfHDBDDIB..gFDAhAHAWDDD..hBAA...,2,-24,0,24
XSMKTeOBgQCERDfdPcWGAIFNUZLabVHJY,FAAAZAAAaACAHACB.JAEA..SAEHKBHB.eAGBBCEAQDDAhABARCFFdEBA.PDGBhAHAGEGAAAIB..IGCAhCAALHAA.YEEFMCCBOEHD.hAHACHHDDICA....hCBA...,2,-20,-16,4
LfUECNBSdYQXaAFKIMPGOTHDJWVRcbZge,KAAAMAAAGACAHACCDAFA..VAEARBFAZCCAeAHHLDHB.EEEBhAIABCAAdGBA.QDFChAAAABBBFEGB.ODHDhACA.TEAA.cEDB...fGGAhAEACHHA.SHAAhAHA,1,-5,-23,18
aYBGfbOELdMWFAXZQPDcITJReHgKCNVUS,ZAAAQAAADACA..TAEARACAHAFBKAGCCAHAUDAA..aBGEGDDAhAAA.OCHDhADAECCBdDFAMFGBACEB.PFHBhAFAIDHAeHAAgFEGSGEHfHGFhABA...hAHA...,2,-33,3,36
gKSMEaQVHXUIFWeCTNbdPcZfDGJAYOLBR,LAAARAAAKADC.EAEAaAFDHAGB.UCAAFAHB.eCDBCCCA...bDEDhABAdDEA.ZDFBGGBBhACAAAAABDHAMEIB..QECAhBFAIHGAWEAA..PFHBhCAADIAA......hCCA...,1,11,-36,47
gUREGHMWfYQNSIALbeKVaZOCBDPFXdcJT,eAAAaAAAZACBBADA.FAFAdAFA...TCGARBDAHCFC.MCCB.hAHA.fCEEhAIAQEEASEBAhBAAAAAALFHBbEECODDBDBBBXFGAgGFAEGEF.hBEA......hBFA...,1,-7,-21,14
caYHOeJGCWfTVRZDAEBNFILSXPQgUMdbK,EAAAFAAALADA..XACAQBGAMAFAdCCAKBFAaCFHHCCAhAAAeEABGDAA.hAEAfCHARECAAAHABEGASEHHhAFAgEEAbGDAOGDCCHBA...hADA......hBFA...,2,-11,-10,1
BfCZdaeXTEHGLKFObJcQMISVDYUPgWRAN,BAAAZAAAeACEEACAHAEAGAFALAHBFAHF.OCAAJCCF.MCEBhAAASDGHDCGB.UFAAhABAgEGAADIB.hAFACFDDaFEDTFDA.KFHBbGAC.IHHAhACA......hAGA...,1,-14,-15,1
BCWSTGQEIeKMLUdFZONARPcVYXJDHafgb,RAAAVAAA..XADBHADB..aAFAbAFACBFB....SAHHhAAAGCCAECFAeDAAMDHBhAAAdDFAZEFFADAA..cEGDhADADDIBBGAA.WFCDIHDA.KGHB.hABA......hAGA...,2,-17,-8,9
RWVbCFAYGScLHXUfJadPOKNeZQTgDIBME,GAAALAAAHADAXADDUAGAaCDC.dDGAKAFAZEEBQCAAhABA.TCFADDABMDIBhAAARDDBVFAAbFAAAEEBSAHBhACA.fDHA.OFGBhAFAgGGBEHCACHHA..hACA...,2,-12,11,23
BFKQUgJeZAIMHfRYXGELDNbaPdcSOVTWC,HAAARAAAGADAEADELAFBDAFA..aAGEdAHA.OCAB.TCCAhAAABCCDQCFAhAAAUECBeDGFADIBMCIBXFEDhACAbDACSEFDCHBAKHGA.ZFBA.fFHEhABA.YHDGhADA.,1,8,-25,33
STgWbCXZdGPVKAQUEBMNYFHJaLIRDOcfe,EAAAMAAAFACDHACC.aAFARAEADAIB..OAHDeCDF...TCCAhBAA..bCFDZCEBGEAAhAAAKBBDADGAQEGAhBGABCHDYEEFIGEASGGACGGD..hAEA......hAFA...,2,-24,-4,20
QXMNDFBYLJfSeaZEAURWVPHTIKdgcGCbO,RAAAVAAAHADB.KAFAdADAGCFA..bAEDQDAA.MAIBhAAAFAGALCGBhAAA.SDDDhBGAeDDBEEHFACHBPFEDgFAGCGGANCIADEEABGHA.YFDFhABA.aFFH.hCAA...,1,9,-23,32
ELfBKdNPCVeYMJgTRAcHQDZWIXObaSUFG,HAAAZAAA.XADBaACAFAFAGBEAEAFA.LCGBKAHBdCADCCEAeCCBhABAMCGB..JFHBRDCBACHBQGEAhAIADDIBOEEDSECDhBIABGGA........hCAA......hCBA...,2,-14,-11,3
NORebWKGITADaZHPVYXSJMgcLCdBFfEQU,ZAAAHAAA.VAEASACE.MAFALAHBdBFAFBHBECABQCCBhABAOCCBRDEAeEABhAAAKDHBGEEAADEAaECDXEGAhACAgFCDBGGAfGHA...hADA......hAEA...,2,-7,-2,5
eRSPbBQNFWVaDKIgAHXZOdGfcTEUJYMLC,HAAAZAAAGAEATAEAEAGAUAGA..MBIBeCAARCAA.SCEDhAAABCGAQEABFDFAaDDHKEAAhACAAACAdEDAJEHBLFFAhABAbFFD.NHEB.DFFBXGAA....hAEA......hAGA...,1,6,-4,10
OaWSPGUefBYKNCMIJHLEFcgQAdVRbXTZD,RAAATAAAZADBDAGA..aACA..SBFAGAEAeAGBBCCCKCCAMBIBhAAAHDFB.EDBBFDABcFGDhAAAABFA..bDEAOEEHhAHA..PFDA.UGGANAIACHEA..hABA......hADA...,2,-28,11,39
FaPDZeVbOMTANSgcXJHfKUQYBWGdLRCIE,SAAAXAAAHADAKADA.UAGABAFBdCDDRAGF...EDAAaCCAZDEEeCEHhAAAODHD.AAAA.gDAAhABAJFAA.QDGBhADAGGDBCFFB.FFFBDIBAMDDB.NIABfGHAhAIA..hCAA...,2,-18,-1,17
NeJBadGIXRLcHfQAUDPCOTSEVZFbMKYgW,DAAAOAAAEACA.ZADBFAEDKAFA........gAGAhAGAeAHHaBBCGCEARCCBHDGBABBBhAHACDBATEGASEFDhBAAMHAANICBBFDAdGDAXGGAfGHA..hCAA......hCCA...,2,-22,-12,10
EKaYFIJCQbeSBOWMNZRGdUXPVDAHcfgTL,HAAA..fAAATAEAEAGEaADAFCAHCAGA..eAHHOCCBMBCBhAAARCGBdDEAUDDA.XCFDhACADEGBACIBLGCAhAAAKBDAIFGA.bGAABGHA.NIAB....hAGA......hBDA...,1,-3,-18,15
HWBYCIdGJcNfVXRDETFgZKQaUbePOASLM,MAAAHAAABADB.CAFAGAGANAEA..XAFAECABFCCAZDEBaBBA.hAFAUFAA..eBHHhAGAAAIBLFHBICFA.hAAAdEFAfFCFDCCBKEHB......hACA......hAFA...,2,-27,-14,13
IaVGfNbJQSHBcTULAedCMXgWRKOFEYZPD,eAAAdAAAMADA..XADARAFAFBDB.EAGAZCEEDBIB..aCAEGCCAhAAA...bCFDQEFAhACAHEABTGGAhABAACIBCEHAKFCAOFDD..IHHA.NIAB.hAIABHCD....hAEA...,1,-6,-22,16
QCZLNPXgAGeUDFbOdWRSHfMKEYTBIcVaJ,eAAAFAAAdADARADAHAGBKAFA.ECCBBAHB..IDFA.aDHDQCEAhAFAZEAA.LCHBhBAAXEECACCBGGDBhBDAbGACSGGAMDDB.YHEA.hCAA......hCBA...,1,9,-35,44
SFWCePEIcaHTNRfDKBMJYOQZGULdAgVbX,VAAASAAA.CADA.EADE...aAFAHAEBRBEA.KAGABCDDMCCBhAAAOBHDGCGAdEEAACIBbDADhABAFDGH..eFHFIDDAhADA..NIABDGGBQFEA.ZGAEhAGA......hAIA...,2,-17,-8,9
dBgAPSHKTMWXQUfFbLVOJZNECcIGDeYRa,HAAAMAAA.QADCFADDLAFAOAFAZBBF.EBFFCCFA.GCAB.hAGAeBHFRCGFdDDAADGBKEEATFEAhAHAXFGA.fHFBhAAAJFCF..IGHADIDA..hBAA......hCAA...,1,9,-25,34
ZLBeSPdCMEaTNQAUHRgJXGDfFObVcWYKI,HAAARAAA.XADBGADAFAFAOAFC..bCFAVCCB...hAAA..cCFAKCCDZDAFhABAeCABdEFAEEHBaCHFTEFAhAAAAAIBgGCAfFDAIHGASFHHhACA.MIAA.hADA...,1,17,-16,33
cdXDITJFVgKBASHGQMPfLCaYUeOWZRNbE,HAAAGAAAMACALADAaAEE.eAGHZAGBRCCAECDAdEEADAIB..TGCAhAAAFDCHKDGABFCCAAABQEEChACACFHA.OEABhAEAbEFD.XGGA......hAFA......hBCA...,2,-10,-9,1
ecdZaCBPLWSMGQAfIHbXNUgEKDOTJVRFY,HAAAXAAAUADAKADAOAFC..TAGARCAAeCEAZCDABCHALDABhAAAMEEA.AAFAIDHAhABA..bEFAEECAhADADGGBFEFHdHABaFCECHHA.SFHB.fHGBhAIA.NICB.hCAA...,1,-13,-17,4
fgVeIRBCDLHFUMaGcbNQWZKAdSPXTOEJY,dAAAXAAAEADA..JAFB....fADAeAHBRCAABCGALAFAhAAAHDCCFEGAaCDDbCEDhABAQFFCZCGFAAGATDAAhADA.OGDA.......hACA......hADA...,2,-24,-5,19
NMBfCHYJRZKWPSTEIFeAXcbVdOgUaQLDG,XAAAVAAA.dADAOADA..aAFALAHBGBEAMAIBhAAACBDAHBFDRDBAZCGFKDDASEFAhAAAEFGBFGBA.AEIB.gGEBhABAQFDC.BGGA.fHBBhBHA....hCAA...,1,0,-22,22
XKMHTPAFDcSQeJfGNWLVdIEYRUCbaOZBg,DAAAQAAAeABAGAEALADA.dAHAEAGARCBACCFAOBHD.ZCCFhAGAXDFAHEBBAEBBSEGBhBAAfEAAVECAhAAAIFFAUFGBaFHDKHBATGDA...hAEA......hAFA...,1,3,-8,11
dbPRWJKZSOCYGQEXeBMNHfcUDIaLgFVAT,dAAARAAAKADCZABB.CADA.GAFA..EAFAeAHBMAIBHCCA.UECBhAAAaBFELDDAFDHHAFBB.hABA.TFFA..hAIAbDGD.PECB.SFAB.hBFAOFDD.XGFChAFABHHA,2,-27,-16,11
fgUPLMeNBJGEdaATZQWcVDOSbKRYHXICF,ZAAAQAAA..VAEASACARCAAHCFCCAHBFAFA.UCDAMCEBhABAeAHHBEADEDAAAACA.TEFAhAAADEGB.KDHBXFEDhAEAfFBA.LFDBNEIA.dGHAaHFEhCAA......hCBA...,2,-22,6,28
INTHWdOAcXLCGMbFVRQSeJYDBZgKaEPUf,LAAAGAAAMADAFAEARAGFeAFA..DBEBZBFEKCAAECDB.UDGA.hABA.fCFEhACATEBAHFEAdCCAACIBCGHA.QEEChAIA.SEHB.BGGAhCAA.aHFCNIEB....hEAA...,2,-26,-1,25
PRBFMTfWdaKOZJcXASYUEbQeGgHIDNLVC,SAAAEAAA.eACHHACA.DAEALAEACAGARCCAMAIBTCEAhAAAdCFAKDHDZCGB.XECAhABAAEEBUFGB.GGAB.hAAAgFFGIHCA.NDIABFAA..WFFDhCAA.....hAFA...,1,-3,-22,19
MVJTECGdKRfePHgbNDOFQIBWAXSZUYacL,ZAAAaAAALADAMACA..TAFAEAHBdCCARBDF.eCFBHCFC..bCDDhAEAOCCH.QEFChABABCGBABBBSDHHhAFAYEHBJHAAKGGAfHEB.NIAB.hAIADAIB.....hBAA...,1,-1,-15,14
cPQEMdVaHDBeJKNXfRGAgSZYIUTLOWFCb,ZAAAUAAALADBFADA.CAFA.....bAFDQBGA.hAHAECAAdCDAHCEBeBHBKEGAhABAfDBAAAHASFAAhACATEFAOGDAPFCBaGHBDICABFED.NHEB.hAIA......hBAA...,1,-6,-28,22
dLJXOEAfVTKIQcCMUWPbegBRDaYGHZNSF,TAAAQAAA.MADAUACA...bAEAeAFA.RBDBaBGEHCDChAAAZDBBFCHDdDGALFAAhAFAOEFHADBBKEED.CFGAgGFGhAGADDIB.NIAB.XFCD.EGHBhAAA......hBCA...,1,1,-12,13
eLcSGFEBdWXADMIKUHgOJbfYQVNCTZPaR,MAAAKAAAHACB.OAEAJADB....bAEDQBEC.hAGACAHAZCAFRAGBeBBBLCHBhAAAGEEAEDFAdEHAAEEBDFFBhACAgGCBfGGA......hDAA......hDCA...,2,-17,-15,2
eEOQBgFKLSVPRfAIYDcHJWTUbaNGZdXMC,DAAAHAAA.TAEAaABEZADBdAGA..MAGBECABQCCAFAHB.hBAALDFASCCDhBFAREAAAAIBIFFAJCHBUEEA.hCAAbGDCXFCBeHFA.BFHA....hCBA......hCDA...,2,-28,16,44
FbVSfZaBKLTCXgOcHQedNRJDIUYGMEPWA,FAAASAAAZACBKAEA.LADA.TBGAXAGB.OBHDhBAAHCCAeDFF.REAADDIBhAAAICEAGEGAEDFFhCAAAAEAfHABCEGA.gFCAhABAdGCAUGGAMEEB...hAHA...,2,-22,-2,20
VaHNefEbWMKBRgSTXUOQFLCGZYJcADIdP,dAAAaAAAHACBeADAEAGAMAEA..RCAA...TBFAOBHDLBHBhAIAZCEBJDGF.ABBBDDEB.IEBAhBAAPEAB.fDFEhBEAKECBSFHHQFFBCHCA.cFBDhBFA.....hACA...,2,-21,-1,20
EeWVMDBQTIRKGfcZPOFUAYCgNXdJLSbHa,CAAAXAAAdACALAEAHADA..EAGEeAHHMCDBQCDA.hAAARCFBGFABZCEBFCGDACIB.hAAAgDAASCBDhAFAaEGEDDIBTGGAfFFEOFAEYFHFhAGANIAB.....hABA...,1,3,-5,8
TXPQHLUeAWNaDfYEGMIbFKBgOScRJdCVZ,aAAADAAAEACAGACA..MAFAFAEABAHA.OBBHRBCAdBFAZBGB.hAHATEDAQCEAhBAAHFGBeBBDACHA.NCIA.fDGBhBEA.bEECSGFDCFHAXGGChCAA......hDAA...,2,-20,-8,12
TfMgUZORXBGHYLbAIcSKEDNQWaPFeCVdJ,SAAAEAAADADA.QADAaAEE.eAFAdAHATBCA.hAAAMCBBZCCARCGBGCEAhAAAHDAAbEFDACGBKDHBPEEBhABACEDDVGFAfGAA.gGCDhADAOHBA......hAGA...,1,4,-8,12
DOMLVYRFeKNPATHcXdfCIUGSgaJZWEbQB,HAAAdAAACADAGAEAaACAZAEB..EAGAQAGA.OCAEMBIBLCCBhAAARDFFKEDB.ACGATEEAhCAAfEHASDGBhCEAJGAABGHADFIBFHDEeGEA....hDAA......hDBA...,1,-7,-11,4
QdGATMLbNXPUCWEeZDIaROcJSBFgKfHYV,MAAALAAA.XADDCADAEAFA..eAHFZAFAaCAARBBB..OCFBhAFASCEAFDHDKECAHCGBhABA.QEEChACAAEGBbGCA.PFHDDGCAIGGABGAAYHAGhAGA.....hBAA...,2,-28,5,33
RScIfHNMYVFXbBeUJOgTCWDPdLKEAaZGQ,GAAARAAA.SADAfADBHAFBMAFAFAHF.BCDAUBGAODAHhAAACCCA.DDCBdCEAEDEFhACAAAAAZEDAQDGAhADA.IFFAVGCAeFGH.....hAEA......hBAA...,1,-9,-19,10
PDTNBIVMEYabeXFcdSfAUQHgGZCWKOJRL,HAAAZAAAKADCRADFLAFBDAGA.BAHAMBFAECAB..aCAAeCCBFCEA.hABAdCHA.AEEAQEFDhAAAGCGAODDBJFCF.TFEAhACAIHAA.YFHB...hCIA......hDAA...,1,4,-31,35
CKITSYJOUAXHGNdMERZWVbBefPQFDgLca,HAAAdAAARADAZABBVAEABAGB..eAHH.QCABDAIBLCFBhAEAaCECKDCA..TDCAhBAASDGA.OEABhAAAACHBGEGAEEFBbFGDFFDD.CHAA.....hACA......hADA...,1,-1,-27,26
CKTUHYQNVSPRBIcaFGfdDWEbAOJLgeXZM,LAAAeAAAZADBMAGBTAEA..HCEBQAGCSAHBRCAABCEDhABAaBHHGDBAdDGAEEABACAAhACAOEGD..XEEBhAEAKGFDNEIA.IGGA....hAIA......hCDA...,2,-18,-1,17
RIMPXKCOGUFJEYZBdbLfgDHSacNWVAQTe,eAAARAAAMADAKADA.GAFAFAGD..EBDAZCCAdDDALAHB.DECAhAAAHDGBaEFE.NAIAAAAATFAAhABA..XFCChCAAOEHDJHBEbFEDSCCD.cGGChCFA.....hAFA...,2,-15,-5,10
FDLAQgHOGVceITBJMUYWKCERPaXfdZNbS,HAAAGAAAeACEBADAMAFAUAFAKBFARCDB...aBHDdBHAZCCA.SDFHhAAALDFBAAABQECAhBHAODAH.IEHAhCAATFBA..JEHBCGGA.EDCB...fHEBhACA.NIAB.DGIBhCDA...,2,-11,-11,0
WdXFURTNPgAVBCMDKIYfbGcOJZEeHSLQa,CAAAMAAAKACA.....fADAGAEAOAGFEAFAHBBBLCAAhAAAaAHDdCFAFDGHRDGFTECAhAFA..gEAAhACAABBBDFFBIHBAbEDDZFFAQGGBXGAANAIAhAEA.BHHD...hBAA...,1,-1,-6,5
OdfRGLTUXQBaSJgEWbFMcDZKHACVNYePI,CAAAVAAA..eACAOADARAFAGCAA.LCCATAGAQBDDhAAAaCGD.SCFHhAIAEECAbEFA.MCIBhCAAZFEAHGACADEBPEGD.dHDB.....hAAA......hACA...,1,-3,-9,6
baONQBZHDdcKMgfIWEGFRAPLSUeJYCTVX,LAAAeAAACADA.TAEA..bAEDaAGAQAGAHBGB.dCCAhAAAMCAA.IDDAhABAEDGARECAAEIBSFEAhABAUEAAVEFBOFDBZGAAKFHD.WEHH....hACA......hAEA...,2,-6,-2,4
TAXPDZBKHcMeSFdIROYNQEfLJGUabWgVC,DAAAZAAAHAEAeABAdAFARCAAOAHD..QBDAECEBLDGBGBGAhAHAaEAC...bDDCgEEAhABACFFA.AACABGAAhAEAMCCBFFHD.NIAB.fGCA.hAIAWEHH....hAGA...,2,-13,-13,0
ZfBAaXSFKTYGdCUJVRDIgWHEeQcMNOLbP,aAAAFAAAKADAGACA.dAEBCAFB..UCCARAGFDBBB.....IDFAhAIAHAGBECFB.eDABhADAMCIBLEFAZEEAABFBSGGAhBAATGGA...YHEA.hAIA......hBAA...,1,-15,-30,15
RKLBAGWbVZYDFcISgJCaMEfNOeQTXHUdP,GAAAVAAA.ZADAFADASAFE.CBHA.EAGA.OBHDeCDBTDFAhAAAHCDAdEFAREAALDHBhACAACFA.bFCADDCBhAAA.gGAAaGGCMIAA.fEHEhAGA......hCAA...,1,10,-27,37
fCSMLcbTeXYaREGgQdNBVJOZHPDWFUKIA,SAAAMAAALAEA..TADAeAHHaBBAEAFEGCCAdCCDBCFAhAFAOAHDHEEADDIBFCFBKDABhAAAAEGACFCA.bEFARGAEQGGAhAGAVGEAJHAA.........hABA......hADA...,1,0,-3,3
GFDQPTKLUMOWSYCVaZABcNRHfIXEJdbeg,BAAARAAAHADB..XACAEAFAdBHA..eCCBGAFAQCFAhAAAKAHBMCAASDABhABA.CEEAZFAAAAFBfDAAhAAAbFGBDGGB.TDDA.LDHB.hADAOFDB.YFFBhACA.,2,-35,10,45
fUNBWMKFYHSgbTOARaVGQZEJXPedcIDCL,RAAAGAAAEADE.JADAeAFE..dAGADBGBLCDBUCCABCHAMAIBFDFHhAAAHDGB..SEGHhABAbDBDAAAB.aFCAZDEBhACA.XGEA.IHHAfGHAhAIA.KHCA....hCAA...,2,-30,0,30
KQIBeWNRcSgTFXEPaAGJdOYZVbLDHfCUM,dAAAZAAALADBHADACAGBKBHBQAFA.eBHHRCAASCEAhACAFCAAECFB.ADHBGEEAhADAOEEBVFAADEIBMFAABFGAhABA.NEIA....gGFG..hACA......hAFA...,2,-23,-3,20
LAbaCRHDWTNOBgEYVKGdScXUFfZeQMJIP,aAAAHAAA.TAEABADAEAFAKAGCGCAB.dCGAXBBCFDEDeDHHhAAAMAIB..IEAAhACAABHBRCDADDABODFEhADAVGDASECHfECA.ZFFA.QGCAhAFA.PHFChBAACHHA...,2,-16,10,26
TCFGZKBdeYaHQNfcLRXSWOJUAIgbDEVMP,..IAAAbAAA.DACAEAEA...MAHBTAEAGCAAZAGBdBCAhAGAeCCAHDEAQDEAhAAAfECAREGFSGBAhABAODHDABIB.gGEBCFGDBGCA.NAIA...hACA......hAEA...,2,-17,4,21
UdWYVPEebFLZJDAcRBIMOGgXCHQNSKfaT,RAAAMAAAGADA.CAFA.HACC.QAFCKAHB.aAHDdCGAVCCBhAHAECCBeDABLDGBZEFAAAAAhADABBBD.OEFBhBAAXFDCfFDA.WEHHPHAC.hCAAFGGBDIDA....hDAA...,2,-11,-6,5
HMVFKBbZACfGYXceTSdQOUIRDJPEWaNgL,GAAAXAAAeADAdADA.QAGAUAFARDBA.DCDA.ECFFaBHDLDDBhAAAHDFAMFBBKDHBZEAEhACAAAAACFDA.fFFAhADA..TFGAOHDC.IGHAWFFD.hAIA......hBDA...,1,10,-20,30
XFCSfOHLZcEJRdMGQYTIUWeDPAbgaVKBN,aAAABAAA.FACACADA...OAEDHAEBZAGB.EBBBRAGBGCBA.hADAQDDCTDCAIEFAhAGAeDGBAAIBVGCAhAAAXEGDLFFBdGBAMIDA.....hAGA......hBCA...,1,-11,-14,3
BGdOLKDIbWAHMZFVfJNCTQPXaUScYgReE,HAAAZAAAFADAVAEA..JAGBCAHB...QCAAaCACUCCA..SCFAhAAA..hACAgCDAEDHFdEAALEFBhADADAIBbDFAAFFAMFIBTFGA...XGAAhABA.YHDAhACABHGA,1,-11,-39,28
UKVAGYZfWXRgTENaLFbcQCDHSPMBdeJIO,ZAAAXAAARAEA..EBHFaADALCAB.FCCHbAFD..QDFChABAHBCBMAIBeDHHhACAOEBBKEDBAADAGEEAhAAA.fEHATGCACGGDSFAAhAFAdHADIHHA.....hAHA...,2,-12,5,17
JKHeERZGBCINMDOgdWfTYFcAPVbSQUaXL,VAAAQAAA.aACELADB.HAFARAEFGAGACCFDMCHBOCDBhAAAdEEA.TDAAhADAFDCHAAHASEHHhAAAXEEAeDHHEFABBGFADGAAfGDA..hAGA......hAIA...,2,-13,-7,6
cCTKXOWEaSebIDYfAPBUVJMNdFQLGZgHR,BAAAVAAA.MACA.dAGALADBZBCA.HAFARDBA.TCGAOBHDhAAAEDCBeDFFDCFBAAHAUFBBhAIAFEEHGGEB.CFAA.hAAAXEGD........hBDA......hBEA...,2,-26,-6,20
eHOURWZLfAJgPFaXcbSQKDGNEVMTBYCId,JAAAFAAA..aACD..XADB..bADDQAFAGAFAEAHBhAFAMAIBBDHA.CEEAeFBBhAIAHCCARDFAZFGBAEEBgFCBhBAASGFF.DFFB.TGGAIHDAOHBChBHA.....hBAA...,1,-5,-18,13
LDEXfNZVPgYOebFCUMcBHdaJRISTKAWQG,GAAAEAAA..XACAZADAVCDA....gAFAhAAAeAFEbCGD.CBHAMCCBHEACaFFChAAARDDATEGAACIB.LDABhADAfGEEPFFBFGHD.BDHB.dGDA.hACASGAA.hAEA...,2,-3,7,10
aILgFUYNERDTcedfKCJGQAHbZWBPXSMVO,HAAAZAAABADBSACEMAFA.aAEDLBFAFAGAUCGAECAA.RCDB.TCCAhAAAdDFA..CDHAGGBBhABAADFAbEEC..XFGAhBGAOFGD..........hCAA......hCCA...,1,-13,-18,5
GPLIMVReKbHdaJBfQSFUDYCNWXcgZATOE,EAAAGAAALADAMADARAFAeAGHHCDA.aCGDBBCD.QCDAhAAAFDCHDCIBCEFD.XDGAhAEAZFGBAAAB.TFAAOFCEIFDAhAFA.bFFB.dHDB.....hACA......hAIA...,1,5,-14,19
cQCYAPIFdXBVWUgLKJZESMDbGfOaReNTH,FAAAdAAABADAUADALAGBZABB..EAFAMAIBGBGA.aCEBRDBAeDFBhBAA.HFBCQFAAhAFAABFA.XDEDhAIAgFGHSEHHfHEBTGEAhBAA.CDCAIHHAhBIA.KGCC.,1,-14,-17,3
PATKeVdDZOXfSaNJHbEYICMLgUcQWGFBR,eAAAdAAAZABBOADC..SADAaAFAHCCAEBHFCAGALCEAhAEA.UEEAQDFDhAAAGDCARGFAACEATGCAhABADAIB.fFGE.NEIA.....hAIA......hCAA...,1,-9,-23,14
TbLDfAQdNUBSEKRIGgWMXPeJaVZFcYCHO,dAAABAAAEADARACAGAFA..MAGBeAHBaAHBZCAAFBEDCCED..HDGBhAAATCBALEEB.hACAAFAAQGGBhACASBHHKDAD.gEEAXFAA.PEHBhADA......hBAA...,2,-25,0,25
VAQaedZLNPCcGBgUXWFTYSfIJDbMORHEK,eAAAZAAALADBCADA.GAFABAFAXAGDTCAA..SAHBhABAJCCA.bDEDRDEAHFAAhAAA.EEHFAAFBdDHAhACAPHDAgGFA.FHBAIHHAhABA.MIAA...hBHA...,2,-15,-7,8
bZDCGVYQLNUJSMaRWKBTAXdgFeOPfcIEH,dAAAeAAAOADA..fADAEAGAHBDAZCFEGAEAQCBDhACALAGBUEEBMAIBRFGFBEHBhBAAAAAAFCCHIEGAhBGACHCA.VEDB.YFHB.SGGFhCAA...hBCA...,2,-9,3,12
fFWPTLCEOdXZYJeIgKBGDRQMVSUbAaNHc,HAAAFAAA.TAEAEADAdAGAZAGB..eBDAKCADGCCARDAA.MBIBhAAASBHHACCB.aDDAhADAfEAALEEAXFGAhAIAIEFADEHBQGDAbFDD..hBAAcGABCHHD.OFHDhACA..,1,7,-15,22
ATBWYQMUXadHOLRDVgENPZeKJFIcfGCSb,TAAABAAAQACA.MAFAaACAHAEBRBEF.DAGAEBGEZBGBeCABhAAAFCCBIEDAhAAAGDFAbEBDACIBUFFA.dGBAhBDALEHBNEIA.KDDDfGDASHDAhACA......hBEA...,2,-2,-1,1
MYTAPDeWUSZJQGabEVCNfLgXdKOIRFBcH,eAAASAAAZADBGAFAEADA...CAHALCCDdAGAOBEDRDEBBCHAhAAAHCCBMAIBADBB.DDAAhAAAUGGAaDGB..bEGDfFBEhABAKFFDFGBA...YHAA.hABA......hADA...,2,-11,-11,0
CVfLJGBSbQdTYEZOINKFAHgUXDPMcWeRa,HAAAXAAAMACA.eAEARADA..aAGAfAHAGBGABCDDQCCAhAAAdCFCEDAAZEAEOCEChCAAKEEDAAAADCIB.cEFAhCCACFGD.LGCASFHHYHEGNICB.hADA......hAEA...,1,9,-11,20
ISYdeCaBfLFUHbPDXRNVcQEKZAWTgGJMO,TAAAGAAAMADA.OAFESACBeCDABCGALAEAHDBBhAAAbBFADCIBRCCA..VDFAhAAAEEEAAEHBJEEFdFGD.CHHA.aFAAhAFA.FGAB.UGGANIAB.......hACA......hAIA...,1,10,-12,22
ceMTZdCFAJIDURWPQbBgaOKNEYHVXSGLf,DAAARAAAQADCBACA..aADDKAFC.EAHFHAFA.SBBDhAFAGCDBLEEAeCEFZCGBhAHAdGCAADDBUGDAbGEAOCCHhAAA.NEIA.XGGA.fDFAhAIA.....hABA...,2,-14,-5,9
OTSZcdIRFfKXJDNAgWLQHBUEVMYCebPGa,LAAAHAAAEADEMAFAeADHGAFA.aAHFTBFAZCAB.dBHARDEBKDHBhABADCABACCA.QCDDhAAABEDDVFBBbEEASFHDhACAFGEA.fHDFNEIA...hACA......hDBA...,1,1,-5,6
WZMYabAcHfELGeBPOgXRDVCFQSITdKJUN,HAAAEAAAGACAeACEOAFARAEA.DBGBFBHDQCCATDFAdEAAKBHBhAAAUFDAZDFA..aFCAAAHA.hAAALFFBBCBDXFGAhAEASFHD.IHDANIEB...hAFA......hBCA...,1,0,-12,12
YLUNQSTJcDaRPCWZGgOMbIeBfKHEdVXFA,LAAAQAAATAEADADARAEA...CAGBGCAAMAIB..eBDBhAAAKBHBHCCAECFAdEFAFCGHADDB.hAHAUFEASDHDhBCAaGGA............hCAA......hDAA...,1,-13,-25,12
ZbRBPQMSECVWdIHeTUKDLcOJgGNXaFYfA,RAAAQAAAEADE.CACA.dAFAHADBeAHBTAFADCCALDDA.hAAAOCHHGCGAaFDAfDDEhAFAZGFE.bFDAhAHAMIAASDFF.IHHA.hAAA......hABA...,2,-20,2,22
EYaQfCgHLOUVZBGAMeTFdXKWDNPSJbRIc,eAAAdAAAKADADAEA..SAFBRAFA..EBCAaAHBQCDAhAAA.CCGAHEFALCCAhACAOFDBZDAAABIBMHEAhABATDGA.XEECNIEB.bGDA.IHHAhADA....hBAA...,1,-12,-28,16
FadUHXbGCcIZYTPBOEWMKNLAgSRQJDVfe,RAAAQAAADADA.eACAdAGAHBDBGAFACBFCZDFBTCDABCCCEAHB.hAAAMDABLEHB.hAAAAAIB.SDCDhADA.fDHAaFEB.bFBAIHFAhABAOFFBKGHB.NIAB...hAIA...,2,-30,5,35
dZaNUVJBgQPEADXYLbWfFMTGCeKOHSRcI,XAAALAAA....bADDFADAGAFAeAFHHBCBRCABdBHAaEEBVCGBhAAABCCCQECBhABA.AAHADFFBfEHAhABAMFIBKGGBSFAA.ZFFFJHBAEHAA.hBHA......hBIA...,2,-5,5,10
PUBaXGdQfFONMbVWTZcLKgAYIHESRDJeC,HAAARAAAeADECADBBAFAGAGAdAHAFBDD..MCAB..bCED..TCCAhAAAZFGBLGAAhAAAACEAECFF.DCCBUEEBaGDD.QFAAhACA.ODHB.NIDB...hAFA......hBHA...,2,-15,-8,7
VRdOAPEWDFXZYSIQHLJNGaMcfBegUKCbT,EAAAFAAAZACB..SACAHAEALAHBGAEAaCECMAHBBEEAeCCBhAAAKEGA.CDAA..bEDDRGAAAGAAhAGA.DGEA..XDGAhADAIGHAQFFA.cGAAhAGA......hAIA...,1,-11,-24,13
LcDdTWSIGNECaOZeRQbYMUJKXVPBFHfAg,LAAAdAAASADAGADA.EAFAaAFDeAHFRBGF..QCBAhACAMCABKCCD.XDDBhADABCFAHEFAAAHADDIBTFAAhABAIEAAOFEBZFEBUGGA.....hACA......hAFA...,2,-6,-3,3
QHgMBeXWdfRDcLVCOPJKTGabSEZUYFINA,HAAAMAAABADAeACEdAFARAEF.LAHB.OCCBKAGCaBBBEDEAZCCFhBAAFEDHABIB...QFFAhAAAXCFDDDIBCEHBPHBAhBHA..TFFASHGAIHCAhCAA...WHFA.hCAA...,1,-4,-32,28
bOPgAVZDWCTHSIJfXYKGEQMFedRLBcNaU,ZAAACAAAHACASACE..fAFBKAFAEBHF.MAIBeCCARCAALCEAhAAABCFAaDGEOEEBhABAACAADEABTEEA.hAFAXEGBQFGAdFCAcGGCNIAB..hACA......hAEA...,2,-15,-9,6
JabBFOVcDMKEIRUCGZXSfPQdAYeWgHNLT,eAAAHAAATAEA..bADAOAGDDAHBECCARCAAGDCB.ZEAAhAAAfCEAdEHAAACAgFFDhAEALDGBaGAAFEAAhAAAMAIBKEFDCFAD.SFHHQGDDNAIABGEDhABA.....hAGA...,2,-9,13,22
UbcNJTPHBaKYWELFfGOIeRgZCQSMAdDXV,dAAAXAAAUADA......bABDcADA..TAFAhAHAHAGBaBCDKBHBEDEALDEBhAAAGDGAeDGB.RECFZFABhABAQGEAAAFADDIB.NEDA.BGFA...hAIA......hBAA...,2,-15,3,18
RMObVgCcTLEeQfdNZHYUKGBWIaSJFDAXP,RAAAMAAAOADA..VADACAGA.LAGB.EBBBeAHH.dCCAhAAAHDCAKBEDGCFAhABABDHAaEFDFEEHAAIBXFDDhBAA.PHFC.......hCAA......hDAA...,2,-33,-7,26
eFMDSLVadHETPXIAYBbQUcfNgCKORZJGW,BAAAQAAAUACA.....fACFCAEARAFFGCGAeAEADAIB.hAAALBHB.dCDAhAAAHDDBECFATEFAhAFAXCBCAFCAcFCDKGFAOHAAWFHHMFIBaHDE..hAHA......hBCA...,2,-26,7,33
BCLDXZbANQEKcWSVfdMgYRaGeTOFPHIUJ,EAAAKAAA..SACBdADAMAFA.RAEA.GBEAeAHH.FBGAHCCCUDBACDFALEAAhAAAZDGBABCA.QEGAhAEAVGCA.fFFEhAFAaGHD.TGCA.IHAAhAHA.DIFA...hAAA...,2,-18,7,25
WfDbUSdcaTGCMREPFZAQKVHLXJBOIeNgY,QAAAHAAALADBBACAeAFA.NBIA.gADH..hAAAfCAEbAFD.hAHAdCCCaAHDGCFARDDBEDHFZFCFhBHAAAFAXFCAOFGBIHHADFFBSGHBhAAACGEA.FHCC.KHFA.hCAA...,2,-8,12,20
DIfTRONdgBEYQVZceCLPWKbaHGFJAMUSX,MAAAXAAADAEA.....TADARAFAdBBAEBEBQAFCZCGB.hAIAeAHHLDDAKCDDHDABhAAAFFFHADIBSDFBhABA.ODHDBHGA.cEEC.CGHDPHAAhADA.aHEA..hAHA...,2,-33,-2,31
TfeUDBXFdgaVbOQYRZCKEMPIJNLGcSHAW,TAAAeAAABADA.dAFAaACA..OAHBRAEFZAGBECCBMCCB..IEEAhAAALDDAGEGAhAGAHEFCAAAAUGCAFFBHbFDChAIACDBDKGEA...NBIA.SGHH.DCIBhBFA......hCAA...,1,0,-15,15
QbUITYBKXDVgZeOCHRdEcLJaAMPNWfSGF,MAAA..PAAA..fADAGADAbAFATAFABCCDDAFAhBAAZBBFeAHHHCFAEDBBhBDALDDBAEFBSEGAhCAAQDFCIGGAXFAAOHCARFGB..hCBA......hCHA...,1,-2,-7,5
EZGBdFMWDgKQSfTCVaXAHbeILPcYROJNU,HAAAeAAALAEA..cADARBCBOAHDUAGAECEEGCABhAAAdEEAMDHBDDFAQECAhACA.TEFAhAFAaFAAAAAAbEFDIGBA.PFHDYGAANIBBBDHAhBGA.....hAFA...,1,13,-17,30
VMZGTEfcKHQXYbLOFNgRACWDeJBIPSadU,DAAAeAAABACA..SADAdAEAMAGBGCCAEAGAKBHBHCCA.hAHAQCFCXCGDLFEAhAIAFEAAREFAAAAACGAAIGHAhAEAaBBHZGFE.cECDOEBB..NIEB.JHBEhBAA......hBEA...,2,-17,3,20
bOFWdDfagURQXNTHMVKIACPcYEeZBJLSG,CAAA..PAAAEACAZAEBLAEAGAGAFCAAdCCADAIB...aCFARDCBQEEChAAA.hAFATGBAHDFAMDBBhAGAKEBDAAIBeEHFSECA.bFFA.fHFBhBAAXGEA....hBDA...,1,-3,-21,18
FQgaBDKZXMeJEYUWLSHAbcPORVCGfITNd,...bAAAOAAA.RADAGAGATAEAdAGAQCCCaBHD.KCFDhAEAZCAAeDHHECEBUEAAhAAALFFBHDFBAAIBPGAAhAGAfFHAFGEBDBBBMEEB......hABA......hACA...,1,-1,-3,2
TSaYGgAIPfWRQdKDBOHbcVUMXECLJFeNZ,..IAAAfAAARACA.dADABAFBHAFA.VCAAMAHB.ECAALCFAhAAAFCDD.eDEBhACAZCEBaCHDGEGAAACAQFGAhAIAOFAAcGECCGDA.NIAB.SGEHhBIA.....hAFA...,2,-16,5,21
XSCWHQegcfLbMOBJUVTEPKRYaINZGdFDA,CAAAHAAA.eACE..fACAbAFB.MAEABAHA.VCCAhAAAEAHFRBDAaCGDZCAAdFCAACIBSDFAhAAAQFEAgGGBhCAALEBAOEHD.TGBAKEHBNICB.hCCADFFA.XGDBhACA.cGGC.,2,-5,15,20
DQBWJXgPIGdOeKcZFMbANfLERHTVUaCYS,LAAAHAAATAEAaADD.CAGB.DAFABBHA..XAGA..hABAgCAAGBEAeCABhACAZCEAbDCDACCBECGEREEAUGGAhAAAQEGA.PDDB.dGEAcEADhACAFGGH.MIAA..hADA...,1,6,-8,14
JWLOGfPQSRKHXAagDbCYUeIFMVdcTBZNE,aAAADAAACACA..eACHFAEA.dAEABAHAZAFBEAHF..LBBAGDDAQDGAhBAARCDAHCGBACIB.hAHAbEBBUFEA.MFIBhBAATGFA..........hBBA......hBEA...,1,-5,-35,30
dGQOXFJLEDVKSaIUTbMARWYcBeHZPCgNf,RAAA......cAAAHADBZAFA.CCCD.fACBGCFAQDAChAAAFAEAEAHBKCDAaDHDhABATCGAAAGABEEDeDCBhAIAPFDBdEEAXGCC.LFHBhBAASGHBbEFD....hADA...,2,-17,6,23
RBPUgAdTXEHMFSbLKJVQNfGcWaIYODZeC,dAAAEAAAHACAMADAFAGDLAFB.KAHBQBDAGCDA.aBHDOCCBhAAAZDBA.RCGFBEAAhAEAUEGAACCBTFFA.bFCDhAHAVFCB...fGFEIHHA.DIAAhACA.CHHA.....hAIA...,2,-21,11,32
XfeDOgcVZBTSLINKPbJCQEGYRMFAWHdaU,HAAAaAAA.XADBeACHOAEA..gAFAZBDBSAHHhBAALCAAKCFAbDFAQCGAhAAAGFCBRGFAAAIBdDEAhACADBBBBHBATFGA.IGAA.NIDBCGEA.hBHA......hCAA...,1,6,-6,12
GLVgfNSIKAaDOePQXJZBdEbFRHCUMcYTW,aAAAeAAA.QADAZACBEAEA.RAFAHCCAUBGA.MCHB..TDEAhAHAGEEALECBhAIAfGAASEGAhBAAAAAAOEHDXGGABGDD.FHECCHHD.....hAGA......hAIA...,2,-11,-1,10
YKgOfXSeFMNWAHEdPJBbUcGaICRQLTVZD,HAAAEAAAdADABADB.UAFAaAFA.RCAALBHBZBEBKBHB..OBCHhAAASCEDeCGBMDBBhAIAADFAJEFB.GEFA.CEDD.hBDATFBADEIB.fGHA.FHDC.hCAA......hCBA...,2,-16,-13,3
TKSGRQaUZWFICNDdgVbAHPcMeXYJLBOfE,HAAAMAAA.eACE.XAFBLAEAOAHDEBBATCDAGCCARCFFQFAAhAFAZEFAFGDDCCFDdGGAhAAAbEGDACCB...cDCChAGABHBA...SAHH.WFCAhBAA.DDIB....hBBA...,1,-1,-11,10
HAOdBgKTZVfeIWXLJbEMRcPaQDFUSYGCN,dAAAKAAAZACBeADA...XAGALAFAECBARCABaCFA..QCEAhACAFDEAUFFAGECAhAAAHCGDAADABDDD.TFFAhAHAfGAAIHHA.bECCMCIBDEIB.hBAACHED......hBCA...,1,-6,-14,8
cOYKNaZSRBCTMeFHLIbdQJPgVAXWUfEGD,XAAAUAAAEADAGAFADADA..OAEEKAHBZCBERBCFBAHB.MCFAhAAAHDEB.bDGDdDFAQFBAhADAJDHB..hAHAgEDFADIB.fGGE.hBAAYHDA..hABA...,2,-34,-3,31
CIEFcSLKMbDWfBRNUTePaOdGgVJXQHZYA,EAAASAAALADAMADADAHBBBCD.RCDA.TAGA.eBCAhAAAaBHDGEAAVCEAQDBAhABAHECAAAEAFEGAbEEAfFGEhAAAUGGB.OGCE....hAIA......hCAA...,2,-11,-1,10
fOaSCQJgZFIEXBcNVDdMAGUKWPYbHLeRT,GAAAKAAA...PADAHACBRAEA.TCAAaAGD..QCDAhAAAZCEEEDHFBAHBVDGBdEADhAAAAAIBUFDA.bDBDeEFBhACASGGACFHAFGCAXGEDDICA...hACA......hBAA...,2,-6,-5,1
QIAcbMUagKWNOYVPXJSFLHTefdGZRDECB,MAAAaAAA.KADAOACD..VAGBJAEALAHBHBBA.eBBDhBAAGCEARCFB.EDHFQEBBhBEAAAFAbGDA.gEDHhCAAYDDF.SEHH.fGGEhCEADFIBBHHD.IHCAhCFA.,1,-6,-22,16
JZdgMaePIWOTGYADEUKfBHRCVbcQLSXNF,EAAAKAAAHACBRACA.CAEA...VAGBQAGALCCASCABhAAAFDABdDGD.aCEDeECAIDGAhACATFAAGEABhAEAAECADFFABFHAbFFA.XGGCZGAAMIEA...hAAA......hADA...,2,-13,11,24
KHbeNDfFRCQWAUMYXOBPacLgTEIVJZSdG,MAAAOAAABADA..aADDLAFA.EBBBIAFAZCEAGDCAhAGAHAGBeEEEfBBEhAIACCHBAEIB.XCEDhBAAgFFGTEGASGCDbGDAFDBHWDDDhBDA......hBIA...,1,-13,-17,4
KJGUOaEINTSVMfBbDLZFYCWQAHRgPXcde,HAAARAAA.XADBeADEGAGAOAFCEBDF..TCCAMCCBBDEAhAAAbCED.ZEDAFCAHCEHAAAIBgCGAhAAAdGAAKGDAaGHBSEHHhACA.DGCA.LHAA.hABAYHFA..hAHA...,1,0,-10,10
ZMcOSVNfGWTdFPEAIKHgQUeBJDLbaYCXR,HAAAQAAAeACEDAFAaACE.CAHA.ZAEB.MAHBSBEA.VCCBhAAAGCFA.dCDCECGAhCAAAAIBKDAABDHAbFGDREFBOFDDhCCAfGBA..WFHB....hDAA......hDBA...,2,-13,-8,5
UgCHZJOALGDSXPFEWfKNcTQaeBYbVdIRM,GAAAXAAAEADAKADA..TAFA.eAHHbAFB.dCDARCDBMAIBhAAACCFDHEFAZDAAAAABLHAAhACA.SDADhADAFDGDfFCEcFECaEHDBHEDIHBA.hAHAgGGGDGIB.hBCAWFFD.,1,20,-30,50
gCMPDOcENAKZIfUeHRdLGTYbVQFaJWSBX,ZAAAUAAAHAEARADAGAGATCAA...VCFAaCBE....SCEHhADAXDDCMEABhABAODFDEEHFAAIBKEAAeECDdFHAhAEAbFFDQGAAFHAEBHHB.CEDDDIDA...hACA......hADA...,1,5,-10,15
AVZCfJEMGPbReUaYFKSOTNBQHdgXWLDIc,ZAAACAAA.EADEGACA.RAEAUCGAaAFAKBFA..OCABBCAAHCCChABAdDFC.XCGALFHBhAAADEFAAAHA..JEDBbFFAeEAHhACAFHFA...SGGFNIAB...hACA......hAIA...,2,-19,-13,6
PaNXJAObdLWTgCcVRHeBKUQYIZDFfGMSE,dAAATAAACADA..RAEFHAGBeACEKAFC.QBGAZABBFDCDGEDAhAGAEBDB..aCCHXFFBhAIAACFBLEEA.gFGAhAAABDHAIHHAMIAASGDAhAIA.NIEB.....hCAA...,2,-15,-9,6
ZLUBQTVWFdRGfKPSAXOcMgDIaEeCHbJYN,OAAAMAAADAEA..EADAHAFC..bAFANBBA..ZCCALCCAhAGA.QCGChAHATDGAFECARECAGFEBKFCDACIBXFFChAIAIHHAaGDDCEHA.......hBAA......hBBA...,1,-9,-17,8
GRJHUCEMNVKabWeOcLIYAXSDdZTgPFBQf,DAAAZAAA..TAEAFACDQAEARAGF.HAGDECAAMCEBKCDA.aCHDhABAeBBDLDFBACIBdEAABDFAhAEAGEAACEED.NDDA.VEGBhAIAOFHB.........hBAA......hCAA...,2,-20,1,21
JZSKPTfVBNHgGaRdLMECYbUFIXOQDcAWe,eAAAZAAAKADC..TADABAFAHAGBGAFARCAAdCEAEAHB...CDGD.bCCChAAAFEDH..ODGDhABAQFFAADIBSEEBhAFA.fGGENDIA.....hABA......hACA...,1,0,-30,30
ZUOXDKMSfFEJdgPbARLYTIeacWNCGQBVH,RAAATAAAeADE...aACA..NAHA.GAEAQBDDHAGDZCCFOCCHhAAAKDBBMCIB.FDGHhAAAEDFFdGAAbEDDAFFBIGGAhAGACFGABGAA..........hAIA......hBDA...,2,-18,-3,15
SedEGAcVQNHDXJWbUgYCLZPIKRfaBMOFT,QAAAHAAAXADBJACE.UAGA.CBFCZCAAKAFARCDA.BAHBFDFAeDHHhAAAECGE.GEDAACDA.hAAA.VEFADGGB...hACA....WFED......hCAA......hCIA...,2,-37,-10,27
JKAMTgSDNFbBUfRYQXVGaPOEdLWcZCeIH,MAAATAAADAEA..FACABAGARAEF..QAGCGBBAaAHDECCBdBEAhBAALDGBZDEE.eEDAhAAAHECBACIB.SEHHhBBAbGFA.fFFA.YHFGhBDA.....hAIA...,1,-7,-16,9
SJNGRTgVUOEYCKHacAQXfPWbFBMDLIeZd,QAAAXAAA.....fACFbACDMAEA.LAFAhAAAeAHFdBEBSBDHhAGAGCEAREGBTGDAgCEHhAHA.OCGD.EDCB.KFFAaGGHACIBFGHDhCAADCIB......hCDA...,2,-8,0,8
VfNacbHSeXdLCMTQYJPGUZIFDRKOgWEAB,BAAAVAAA.aACAHADB.eAFAdAFAMAHB..TCFAQBCChAAAPDAAZDEA.DAIBREEBOBHFhAAAEFBAADIB.fEHEhADAbFDA.LFAACFHA....hAFA......hAGA...,2,-22,0,22
JOUBMPXRWbaZcLQDYTCdEeVSHNGKFgIfA,OAAAMAAARACA...aADDZAFBLAFAQCCBDBBB.CAHA.dCFAECHBeCCBhAGAHEEAGDGA.hAFAFEEHfFCAhBAAACHABHAA.XGEA.WBBD....hCAA......hCFA...,2,-22,-14,8
JbPWYBDQFIXAGcTadCUeEKRfZgMONVSLH,GAAAaAAA.dADAeACHRAFAZCEEMAEA.OAHDSCHH.HDBBhAAAbBDD...PEFBhACABBFAQDFChBAAFFAHADDBCGHAKHFA.fEHA.gFBAhBBANIAB.LHDAhBFA...,1,-1,-18,17
MIfHQYLceZDPSVCWdREgAFTOKXUbGNBaJ,TAAAXAAA.GADAaACA...MAFAHAEBLBFBeAGBZCCFhAAASBHBCAHBREEFACIBKDBBUGGAhBDAbCGDBDAA.fFDAhAAAcDGC.DDDB.PFFB.WDBHhABA.EHGA...hCAA...,2,-8,4,12
ZTCGdDeNUFBSWQcagLVRHKAYJIXPEOMfb,JAAAXAAA..EADEMADAZAFBGCCA.dBHAeAFA.FBDBhAAASEFAQCEAhABAaEHDLCHBHFABACCBIGEAhAFAfEEECGGD.DGDBBHCAgGFAhBIA.....hAIA...,2,-18,-10,8
KXNHBTMbPYGcQFeACVgEDZRaLSUOfWJId,CAAAEAAARACA.LADA.OAGDJAFAdCAAKBCDHCCCBCEA..MCFAhAAA..bDDAGDFAhACAQEAAADHADEIBaFEHfDHAhAAA.XFFCNIAB....hAEA......hAFA...,1,-23,-26,3
ERAbfCZMJHFVeLWcKGgQBYIPSdNUaXDTO,CAAAZAAAHACAeACELAFBKAFCGBGAQCAABCCD...IAHAhAAAdCEAaEDCDAIBECDAACHAMEGBhABAFDGD..VFEB.hCAAgEAGSEHHNDIA.TGCA..hCBA......hCGA...,1,5,-22,27
JgUWFcBMdSQRTafbDNVYPHIXGeEZACOKL,KAAALAAAUACA.FAEABAEAdAHARBCA....aAFDDCAB...VCFBhABAHBGBGEDAEDDAAAHAOEFBhAAA.JEHBgGGAhACA..MIBASDHHhBHA......hCBA...,2,-34,-23,11
GJIPFHROUQZWXDNEcfdMVLgabKASYCBTe,CAAAeAAAGACA..IAEAHAEARCABQCFAZAFBDAIB.EEDAdCCAhAAALAHBaBHHADBABEDAhABATFFAFEGA.UGAAXFCChBDANEIA...MFFB...gGGAhCAASHFA..hAAA...,1,-2,-17,15
CEaMGBgJKUcVQPdALbWTDNOZHeYIXSRFf,LAAATAAA.OADDHACBeAEA.XBFARAFACCAAECCBGCEAhABABCADKDEAUDGAQEAAhAAAAAFADGGA.ZEDASHCAhACAaCHDMFHBgGDA...hAIA......hCAA...,2,-23,10,33
FBMEDUefZVATQHGacObNSCLgPXRIYKWJd,HAAAaAAA.OACA.SAFALADAXAGDRCCAKBHB.dCCAhAEAMCGBECFBeDGHZEEFACCAGEGAhAAAbCDD.CFCAgGABhAGAIFAAYEHBFHDC.DBBB..hAFA......hAIA...,1,7,-20,27
DCIKRNTPAadYcXBfHFgGMWeQUSZELbJOV,dAAAXAAAHADAGAGA.eCAAQADAZDAEECFBLEEBhACAbAFAOCDBCFAARGAA.TGGAhADAAAAAaCFDBCHD.FDAAhADAMDIBSEED.DEHB.KGAA.YFFBhAGA...hAFA...,1,8,-6,14
baLEFCVXBGgIRQJUTHMZPWcDYfNdOASeK,eAAAaAAALADAEADAFAFD...CAHABBBDGBGARCDA.QCCAhAAA.TFDAHCGBZEAAhAEAPFHDDEFBfFHAhAFAdFFAAAHA.bGCC.XGFD.IHAAhAHAMIBA....hBAA...,1,0,-16,16
WXOEGBNeUFgCVLJfRYdKMQcPTDHZAISba,SAAAaAAA.OACDEADAGAFA.eAHBFAEACAHALCCBhADARCDFdCFAKCHBMBBB.QEEChAIATEBAHEGBhAAAACEBbDGDBFFCNIEB..gFBGfHAB.hBAAPHCA.DIFA.hBFA...,2,-10,-1,9
dRYZWKUbgaNfIeVFPCSMABcXHJLDGOETQ,XAAAHAAALADBGADAEAFA.dBHARAFAZCFEKCADUCFA.aCCBfDAAhAAA.eDBHhABAFEEHSEHHhAAAAADBBEFADDDBTFGAQFAAbGAAIHEAhAFACGFAMFDBOHFE...hAGA...,2,-8,7,15
BOTNJXIAVUECKZeYHPfMRSbagFWDdcQGL,EAAAZAAAHAEA.MAIBRACAaAFAFCAA..dBGDGCFALCCAOCEBhABATDAAJDAF..AAGACEHAeDEAhAAA...fDHAhADASFFDbECDDDDBQFFCBHCAIHHAhACA....hADA...,1,-1,-18,17
XIEBTSQKcJUYAbZGDWHCdPFaOfLgMNReV,GAAAHAAAdADAaADALAFA.MCABRAFFeAHH.XCDChAAAECCBTCEAQEBDhACAKCGCUEEBADIBZEEACDHAFFHBfGEAhAHAVGAA.SGGA...hAAA......hACA...,1,2,-3,5
agcIbRDPCAHVXNYWfTKMJBUQLZOdFeSEG,HAAAXAAA..NACB.....fADAMAHBBBDALAFAhAAAdBFAeCCBECDAaCHDgCFAhABA.bDABhADAREDFCFGAAAGA.YFCFTEGAKEED.QGCChCAAZGFA.SGGAhCBA.,2,-11,-9,2
JeAQNXTEaBLZOHcIgdWGPFDfKYMRCUSVb,QAAATAAA.EACAaACAZAEBHAEB..IAHAdAGBGBGAhAAADBGBKCHBRCCBSDBDhBDA.bEFDABEBBDCAhAAALFEDOEEA.gFFA.FHCAhCAA.MFIB...hCAA...,2,-15,2,17
KASNRYBdPZXbGJcOgEeLaQHWVCIfUDFMT,RAAAdAAAZADBGADA.OAFAEAFAeAHFLBFBHCEBCCCCUDAA.MBIBhACAAAAASCHHhADABEGA.XFGAbFDBJFHB.hADAaGCA...WHFGIHCA.DGGB.hCAA......hCGA...,2,-19,-7,12
bAPdUJGCVgFaXcLZDKRIMNeHEWBSQTfYO,dAAAGAAACADA.FADA..aAEDLAGBZABB.RCDBMAIBHAGBEDCASDBHhAAAQDFCTEGAhACAODHD.AAGBJFEFhAIAXFCDKGGA.eFFB.BGBC...hBAA......hBIA...,2,-18,-5,13
JCNRAEgSKZDQaMbBdfFUPGWHVOXIYcLeT,EAAAKAAAZACBDADA...aAEDMAGB.BAHAdAGAFCABGBCAHDEAOBEFhAAA..XCGAhAAAICHALEBBhACA.eEDBTEFACFGAAAIBSFHHbEBDfFHAhAHA.PHEC.hBEAWCBFcGFC,2,-34,-7,27
QVBaIDdZJXUcgAWOeNMRFPYGSfLCEHbTK,eAAARAAAFADAGAFALAEAHCCAKBCABBHA.DCFBZDGB.XECAhAAAUDGAAAAA.OFED.hAFAMEIBSDDBhAGAEAHB.bFFC...TGCA....hAIA......hCAA...,2,-32,-5,27
GCRDVcWPZaSMFdIYeHENJOXKQgTfbLUBA,RAAADAAA..VAEA..PACCZCCA.MAFAdAHAeDAB.HDFBhAAAEBBBOBEEQECAhABATDCALDHBBBHBADGAhBAACHEA.aDGEIHHA..YEFFhCAA.JFDB.KHGA..hCDA...,1,2,-28,30
fPFKeEUCJTgYbBXLZNADIOWcHMGSVQdaR,OAAAHAAAGADA.QAFARADAFAGAEBBB.CAHAJCAF..TCEAhAEA..bCFALCGBhBAAACCBDDDB.IGEAhCAAMEFBdEGAaDCDKFADgGGABGHA...hAAA......hACA...,2,-17,-8,9
RMbQYSPdANJIHOXUTaKDWZECcfBFGLVge,JAAAHAAA.XADBUADA.KAFAZAFB..EBHFCAHABCCDGCAB.LCFBhAAA.eDEFhACARCGFMDEBbFGD..SEHBhAHAAEIBOFBBDFFB.......hAIAfGGA.hCAA...,2,-49,1,50
JKfMFHELeGPQcOgBTIZRaUSbdVXCWNADY,DAAAKAAAMACAHABCEAEEGAEB..QAGCOBCCBCGAZCCARDFFUDDAhAAAdDHACECA.ACEA.JDHBFGHBhAIALGFAeEED..hAHA............hAIA......hCAA...,1,-8,-31,23
edQCGWXANfZYHBMRTKcSbPDIOLVFgUEJa,ZAAAHAAARAEAKBHBSACE.DAFALCABFAHDEBEA.eCCB.dCEDhABAGCCAAADA.fCFAhAAAMDHB.bEFAOEEBhACAUGEAaGHHQGFCCDHC.XFAAhAFA.BHAA..hAHA...,2,-16,3,19
LBDJcPEeUYVXOWMQHdZSNfFgTIRbCKAGa,aAAALAAABADA.DAEA..JAFAEAGA.eBCAUCCA....XBGAhABAMBBBHCFAZCAAfCEAhACATEGARFBAKFFDhADAADGAGEFA.YEHHOHCC.dFECFGHDhAIA......hBAA...,2,-18,-2,16
BIWeSQaTDXOCYPZcKEdHFUNVgJfGAbLRM,RAAAMAAABADB..eACAaAED.DAGA..CAGAZCCAEBBBHBDC.FBGAVCGBhAAAJDDB..GEGAhBAAAAIBLFFASDHBhCAAQGAATGDAOGCC.....hDAA......hDBA...,2,-27,-10,17
VBWcIODHTbGYageXZLPRMJEQAFdKCSNfU,dAAASAAAUADABAFA..IADAHAGBGCABaAED.eDEFhACAZAFBRCCBEDGBAAAAKAHB.CCHD.hCAAfFFA.hCBA.cEDDDDIB.bFGB.XGEAMIAAFGHBhAIA......hBAA...,1,-13,-14,1
XASNTIUORgQYKGMDBWcFPCEZLVfHbaedJ,TAAAOAAARADA..QACCGAGAMBBBBAEB.FAGAECCBZCDBLDFBhAEAHBFBeCHHdFCAAAIBhAGASFEA.hBAAIGHAYEEDDHCAPFHB...hAAA......hCAA...,2,-15,-5,10
SXUbOKJDFcBNYWHeafPMdVZRQgLETCIAG,GAAAXAAAOADADADA.BAGA..NAGA.HCDA.eAHHaAHBMBDBhAAAZDFERDBFLFGBhAAA.EGCATEBAhABAAFIB.bDGD.FBEB.cFDB...fGFEhBIA..hCAA...,1,-3,-33,30
PWcUCVRFeAEYIHDMOgZXLKaSGTBJQfdNb,EAAAHAAADADAMACA.ZAEELAGBKBHBGCCATBCAQCFChAAA.dEHAbBEB.PCBBhAAAcFDD..CDHAREDBACCBOGFChAGAaFFABGCANIAB.UGGB.....hAIA......hCAA...,2,-5,0,5
VbXQZfFReTAPELKYBgdaMGWCScOIHDUJN,EAAALAAABACAdAEAGADA.SAFAOAGBHCCADAIBUCAAhABAVDGB.QCFAhACAZEBARFEFAAHA.KEFD.aDDHMIBAhAAACDHBJFAA...bGACFGHDeFHB....hAFA......hAGA...,2,-9,1,10
IMaGdeCcKSgRVbULEWBXDQfHYPOTNZFAJ,MAAAdAAAeADAKADA.RAGB.UAFALCCA.EDABXBBC.QCDDhAIAHCFBODHDhACAZDFBABHAaECA.CFFDSGHDhADAbEGDDCIB.........hBAA......hBCA...,2,-30,-7,23
DUZRTMdSXGAPEKJYNeOfcgbVQLIFaHCWB,EAAAKAAA..JACAeACA.OAFC..fAFB..hAAAbCCALAHBaCGAHDAAhAAABCCAZDFBRECAdCEASEHBhADAACGAPDGBNEDA.......cFGDhCAA....hCBA...,1,-2,-45,43
YQLbRcBENZJaTFWPCAIHKgXVUMdGfODeS,HAAAXAAAMACAGADADAGA..eBDAQAFARBGBECCB.ZCFEaDFBhAAATDAAFEBB.CAHAAAAAKEDBhBEAUEGAdFGASGEHhBIALFAAbGFC.........hCAA......hCIA...,2,-6,4,10
cNPeUfgJMSQIbVBKCXOZFATaWHYLGREDd,aAAAHAAAGACAEADEdAFA.....PAHBeAEAfAHAhAEA.MBBBQCABhAAAbCEDKCGD.OCEBhACAACIBTFAALEGBREGFDGIB.cFEB.NDDA..hAFA......hBAA...,2,-7,-6,1
gILMWYaJbZDeRHAGKQSBNCPcEVdTUfFXO,GAAAQAAABADACACA.EAFAdAEA..TBGAFAGAOBFD.LCHBhAAAMCDBaCEBZDCAREFAHFAAhAAAADDAKEBD.SFDHhACA.NIAB.cFGCfGHAIHDAhBEA......hCAA...,1,3,-28,31
IAVRMCXYLdUfeHWDEQNTPGKJZFaObcSgB,RAAAMAAACADB.LAEAdAFA.eAHHHBGBEBBATCCAGCDA.ZCFFaAHFhAAAODCH.bFADSDFDhABA.BECDhBFAAAFAXFFCfEHADDIB.QGEAhCAAKGHB.FGHD...hBAA...,2,-6,-2,4
BHcNUeWJSdGRODKMAXCfPaLYFTVQbZIEg,CAAAaAAALACA.FAGATADA.QAFCZBDEECGAHDAAUDAAhADAeDFBSAHBhBAAREDBKDHBAADA.fCCBhBBA.PCGDYFHFbDEDBFHA.NIDB..hAAA......hCAA...,2,-16,0,16
fMgHPEKGFBcbXDSaeRQCZLdUWYNIVOJAT,MAAAHAAAEADEGACBBAFB..XAGBaAGDRCAAZCEAdCCA.UCGB.hAAA.NAIA.OBBHAEEATEFAhACAfEDA.hCAAKEGAbFCBeFABCFHA.YFCFIHHAgFFGhAFA...hCDA...,1,1,-11,12
UVPeCdTFEXRGZbQacLOgDASKfMYIBWHJN,KAAAMAAABACBHACCUAEAeAFE.dCCAFAGERBFBZEDB..QCCChAAALCHBDBBBACHA.fFFAhAIA.IGHAhBAANDFACDGA..EEBB.XEGAaHEE..hBEA.gGDDhCAA.SGGB.,2,-32,2,34
RVeASEIaHYZMWBfTOFCdJNLgPcQGbXUKD,EAAAHAAAZACBMACABAEAOAEE..dAGALAHB.gCCAhAAAQCECbCFBKCHBhAAA.REFAAAIB.aCBBfEEAhCAATGBA.CEHAPHEAXGECDFDBSHGAhBCA...hCCA...,2,-17,-13,4
PcRbEVaQMCYONSgTFGefWAIHXJBKZULDd,HAAABAAAZACALADBdAGARCCA.EAFA.QBGAMAIB.OCABhAAASDABTDEAeDFFhAAAACCAXEGA.KFAAhACADDHBbFCBaEAHCGGAYHEAFFHDGGBB...hAFA......hAIA...,1,8,-20,28
OIcRXVSBNUTQHAfgLMdWZEJabCPeKDGFY,LAAAdAAAEADA.aADDCAFA..KAHBGAFA.OAHFRCAA.SCAAhABABCEATCGAHDDBhACAAECA.MDHBZECEJEGFeFABhAFA.FGFB.IHHAXGCA....hACA......hADA...,1,5,-35,40
eBfLWPHAGFTCSJRUgdDNIYQKMOXcabZVE,GAAATAAA.SADARACF.dAGADAEA.IAHAQCDAhAAAMBFBXCGA.hAAAbEAAEBGBeEFFLECBhACAHEGBAADACEEDgEGAKGBA.aGDD.BGHAhCAAWFDH....hACA...,1,-2,-11,9
cWUJYGTdEVHgbfCAIOaFZDBPXLQeNSKMR,aAAAZAAABADBLADAeAEHKAHB..RAGBUCAAGCCA.EBBBHCFB.hAEA.bCFBAAIBFDDH.DDIBhABAQFAA.hACAMDHBcFDDYEFFdGAA....fFHEhAGAOFDDNDIASHAGhAFA,1,8,-28,36
AeFWgOTSHIKaMJbVRPZXdNGfCYQBEcLUD,eAAAFAAAOACDHADAaAFA..MAEA..bBFARBEAZDEAdCCAGDFAhAAACAHABCHA.EDHBLEBBhBAAADFB..WEDHTFFAhBEAKHGA...........hABA......hAIA...,1,-6,-29,23
YBbVPWGefJdaHUEANTQZRgKFXCOLcDISM,TAAARAAAFADA..OAFDLACB.DAEAMAHBBAGA..VCCAhAAAGBEA.eAHHdEFAaCHDhABAHEBA.ABEBZEGBKFHBCHFAhAIASGCA.......hBIA......hCAA...,1,-11,-30,19
OYIQeKScLgfCbaEABWJRDHGTZXdFNMUVP,BAAARAAAHADBZACAdAFBMADAUBGB...OCCBQAGA.eCCBhAAASDABLDGBhBIACDEAEDGFACEBDDIB.GGCBhCAATFGAFEEA..NIAB......YFFFhAAAIHHA..hCBA...,2,-21,-12,9
LUHCJcDbeVKgaBPXMOQASFGNIZYRWdTEf,GAAAZAAARAEAdAHAEADALCABHAFACCDA..DCFBeCCBKCGA.BCED..hABAMDABAADAFCGH..IEGAhAAA.TGGAhACAfEEAJDCF.bFGBaEEH.OHAASFAAhACA....hAFA...,1,-4,-28,24
WRSXEICTYNDfHMeFKaBVPGULZQdgJObcA,RAAAEAAACADB.....TACADAFAHBDCFAEABAHAGBGAZCCAdDDAOCEAhAAAAAAA..XFEAhAIAIDHA..fFHAhBGAeEEBaEGCPHAA.QGGAhAHA.....hBIA...,2,-33,-7,26
DOVRYIFNabBSCHPTWgQJcXUZEMLKfeAGd,dAAAOAAARADAFAGA..aADDBCBAHAFA...TCEAQCEAhACAXCGDECGALDAAhADA.eDHFAAHAGDBAhAFADEEB.IFFAbFFDCHHB.PFHB.WEEDhBAA.....hAEA...,2,-19,-7,12
XIMebQAKGcWDSRfdaBNUZOYLgVJEPHFTC,GAAADAAARABA.aADABAEBZAFBLBHB..gAFHhAIAECDAHDBBTEEACBHA.MFHBhAAAeCDBACHBKGEDSDFAhBAA.dECA.ODHD.VFFB.hACAFGDD.....hAIA...,1,-5,-18,13
ZEgHAYJBTCSeMXaOdNQIGDVLfUbWPRFKc,BAAATAAAeACA.MAGBaACA..dAFAQCAAGBGALCCBhAAAUCDA.bEDDRCGFKAHBECEBHFFAhAHAAACACFBA.ODBBhAIADEIB..VFDA...fGHEhAAA.FHAA....hAHA...,2,-17,12,29
JdGeRXVUHQgOcWbfECTNDZFBSaIPLMYAK,dAAARAAAUADAHADA.QAGCOAFC...bABDECCB..TCEAhADAZCEESCHHhAAA.aEFBLDHBhAFA.AEEBGGEBeFHBXGCA...hAIA......hBAA...,1,-7,-22,15
JUXQWgGfPdaDHNEeLROMVSIFZCYTcAbKB,BAAAXAAAQACAGADA.dAFAHAFAEAHBLCABRCFAMDAASEFAhAAAZCCACCGA.TFAAhABAADIBKEEDUFGA..hAAAfFEEaEBDeHEG.OEHD.FGGH.hACAYHAG..hADA...,2,-7,-2,5
TOLNKaYQDGfVMbZgHSXFBPdJWeAICREUc,RAAAEAAAUADA..TACALAGB.KCCDaAEA.QBEDhAAAGDEAMAIBZBGBHDEB.hAAAFCCHdEDCeDHHABFACEHAOHEEhABADGGBfHAB......hAHA......hAIA...,2,-23,-6,17
IYSOQdUBXacNLKHfZAMECgRPJFGeDVTbW,EAAARAAAFADAGACA.eAEATAGA..bBFA..ICCAhAAA.OCEBdDFAXEAAhAAAaCFDLDHBHEDBAAEAhAIAMFCBCCBDgGGADFFAYHEASDHDhBCABGAA.KHBA...hABA...,1,14,-26,40
ZJAOBSaGcNdDUVEgRPbLFfCQKYIeTHXWM,SAAAGAAAdADADAFAEADA.RBFA.LAGB.CBEA.QDDAhAAAKCCAeCHHHDAAMDHBAAIBaDFHhAAAUFBA..gFGAhABAbGEC.fGBA.IGEAhADA.XGCDhAIA..,1,3,-27,30
HBNZXAJbeOKCMScYEVFGPDTIaLWgfdURQ,eAAACAAA.MAEASACA.EAFAGBCADAIB.aAGELCAAhAAAfBEBRBGBHCEBZCFEAAAAhCAAbECDKEED..cEGDhACAFEHBTGEA.IHCAdFAABGFD..hADA......hAFA...,1,-7,-9,2
UFQeRZaPCVKYNbfXHOWdgILTEDSJBMGcA,QAAARAAAZADB.aACECAFAKAHB....bAEDHCEB.dCCCLAHBhAAAECGBDDABBEHAhAAAGDAA.AAGBeCDD.hABAPEGBVGFAfHABOFEDgGCDhADASHCE...hBHA...,1,-6,-22,16
gYcRBCDbALKdVNJZGIPaSOUEWMHFfTeQX,dAAAVAAAZABB.GADA..aADAOAFAEAGAHBDAFBGH..eCHHhBAAQCGA.XDDAhAAAgDBAREFFDFIBhAGAADFBLFFAKHGANIBB.IHHA.SFBAhBDA.MIBAhBFA.fGEE,1,-2,-11,9
MVDZSRKEYbWcaAILeGXPCdBJQgFNHOfUT,eAAAGAAACADA.dADABAFAQAFA.FCEDHAGBUDGAMCCAZDBBRGEAhAAAEDDA...bDFAaFABhACAAAAALFAA.hAFAXFFAPHBC.NIABOGDC...hAIA......hBAA...,2,-8,-8,0
UbOZKdRECABfVDFHcSMWIYgQGNJaePLTX,BAAADAAAHABCMACA..IAFAQAFAGAGAaBCA.LCCAhAEATCCA.XDEAhAIA.bECCZCFA.REEAAAIBFEHDhBAASFHHgGGGeHBA.OHEChAAA......hBHA...,2,-18,5,23
eMZBaIgYWHCRdVSEDTAPcKfNXbOFUGQJL,KAAAXAAAFACAGAEALADAZAGB.BAHA..aCCB..gCDAhAAAHDDBRFGBdGAAECGAACIB.hAAA..fDHAhABA.bEABQGEDeEFBMFAB.IGCAhAEA.CFHADGEB.hAGA...,2,-17,-1,16
dASgJCVMTQKEFLONYXPcGaefHIbZRDBWU,SAAACAAA.MADATACA.EAEELAHB.OBCChAAAXAGBGCFAeBHHhAAAHDDBZCAARCEBBBGBdECDACGBhACAgEBDQFGAFEHDNIEB.....hCBA......hCCA...,1,-7,-13,6
JHIVSPCGYLbXNeagDTUEcZOBdAFWMKQRf,MAAARAAAHADB..SACAGAGALDAA.bDFDeAEHaDHD.hAAATAGAUFAAEEEFZCCFdCGDhAGAAAGB.KEEC.QEGAhAIAfGHAIHHA....hBAA......hBBA...,2,-23,6,29
NXEcFMYLaBeVQKOPbAJIHZGdDCWfUgRST,HAAAdAAACADA.UADARAEF.SAFA..TBGAEBHFFCAHMCCBhACAaCCC.BAHB.eDABhADAQDEAKDDA.bEGBhAAAADGBZEFEGGABDGAB.WFHHfGGA.hACA......hAGA...,1,-6,-27,21
RMTEVeHbFZQUgLIYfKBGXSNDdaOAPcJWC,JAAARAAAEADEHADB.ZAFAQAFCLCGB...ICCAKCCDGDAAhADASAHBdEEAAAGA.hAIAPCEBCDFBMDIBeCGFhAAAFGGB.gEGH.BGHA.DFFB.hBAA......hCAA...,2,-12,-7,5
fSTARHLCUMKcEJXgFDIbWPQVNGYeZaBOd,HAAALAAAMACAEAEAJAFBFAGD..DAHB..ICAA..hABAbBDDQCCAhACAGDFAeBHHaBHDdDFASCCFhAAAREAAKEHBXFCAPFHDNIABBGGA.OHEChAEA.AIAA....hAIA...,2,-13,3,16
HPOgCBKLWRIXedGMYTNfZADFUEQVSbcaJ,FAAAEAAA.QADA..bACAaAFEHAGBOAHDBCCA.LDABhAAARCCBeCFFGDAAhADAMCEBTDFAZEFBAEIBDGABSDHHhADA.PFDBKHDAIHHAdGGAfGBAhAEA...hAGA...,2,-8,3,11
HQXSMJFTDbVeBUKcWLfAGCdgZEaRPYOIN,dAAAEAAARACAOADA.HAGBQAFC.MAIBTBDADCCBeCGFhAAAKCBALDFAADAA.hADAGGBBZDDBaEHBIFFAhACASFEHFGHBBHFAcGGC.CECAPHAAhAHA.....hAIA...,2,-15,-1,14
PWDOGEZaLfdUYNbQFCBIXMKSHceRJVAgT,TAAADAAAEACA..ZAEBaACALAHB.dCCAUAFA...bCCBhAAAQDFDBAHAMCIBhBDAHGBAREDFADHB.gFGAhBAAOFBB..fFGANBBACBGAXECASGEHhBFA...hBEA...,2,-13,-13,0
DLYZJQaNdbegcIBRAWfFMTSEVHPCKGUOX,FAAAMAAAEADAHACC.KAFCGAFAUCDBDAIBZCCAaAHF..dCGAeDABhADA..IFFAhBAAADHATECASBBDhBHA.CEHAOGDCLEHB.QFFBhBAANIDB......hBFA...,1,-13,-18,5
SUGNYQPJadcBKHbOVeAgZXTILfEMFDRWC,ZAAATAAALADB.EAFAMACA.RAEASAHBGBGAQCAAhABAaBDHBCFAHDEBOCCHhAAAAAIBXFAAFCHHCEEAUFGAhCAAPFHDdGEA.bFCD.gGEGDIGA.hCEA......hDAA...,1,17,-10,27
fZFcTLGUHNOQKdVBbSeCDAPYaMIEgWJXR,aAAAEAAA....JACBRACFZAEBFAEA.LAHBHAGBQCECdCGCBEAAeBBDhAEAAAIB..MDDBhAAAIEEAXEFATFGAhBAAGGEB.OEBBbECDDGBB....hBGA......hBHA...,2,-16,-7,9
XDNdRAabIHEQZUCFJfVYgcSeOLBWKPTGM,aAAAHAAAZACBFADA.JAGB..VAEA....gCAAhAAAeAHHLDEBKCEBGDCAhACAMBBBDDGBREGBAAIB.EDHFQGAAhAGAfECASFFDBFHAPHAANIDB.hCAAIHHACCHA..hAHA...,2,-22,3,25
GLYIcKEVgJeRQNOTWSfHDaZBFPCdXMbAU,GAAALAAA..IADAEAEAJAGBRCAAQAFA.TCDAhAAAfCEAHDFAZFAAhACAFCHDdEADbFFA.AAIBUFEAhABAKAHBeHDAOECDDDCBBHHDXGGB...hAFA......hBAA...,1,7,-12,19
aLVWfQOSPXJMFCRTIGbNEAUYHBKDZgedc,HAAADAAAeABAaACALAFA..fAEAQCCASAFHhAHAXCEAMCHBhAAARBGFGCCAEEFBAAGABEFAZFCAdGHAhCAAcEGD.OFDD.FGHD...hCCA......hCFA...,1,-2,-15,13
OLQGdbWBMUDPYgIZJaRcXTVNFECKeSfHA,LAAAdAAABADAMAFADAEA....gAFAZABBRBEA..TDCAhBAAFBDDEBHF.eCABhABAHDGBACCBGDEAUGDAIFBAhBFAaDGC.XGGACGGA.KHBC..hBHA......hBIA...,2,-18,-17,1
LGXNDPEHaMbKfgdCFIWQSOUeAZRYcBVJT,RAAABAAA.JACAGADA.DAFAHAFBaAGEKCCDdBHAFBCH..QCFAhAAAOCEBAAHAZEGBVFBAhABALFAA..hAAAXEFCEFEA.MCIB.fDAAhADA.CGGASHDAhBFA.,1,-18,-27,9
YcSIJEDAdKFQLZgNfUXBeRWGVCPTHbMaO,dAAAQAAAZABB....fADABACARADFGAFACAFAHAGBaAHFhAAAOCEBSDDAhAFAEDFFAAIBLEHBUFFAeDHBhBHAPFAAMIDA.IFGA.DIDA..hAFA......hBAA...,2,-16,-8,8
YfCOXDTPHaAJNWBKIREdMeFLGgSUZQcbV,JAAABAAA.RACAdAFAeADEGBGAUAGA..ZCCAQCAA..hAAAbDFDVCDB.CAHB.DDHBhBAAHFFAABEBKEED.EFCBMICAhACA..FGHD........hBIA......hCAA...,2,-30,-12,18
BAFCEdcIRSGOMUZKeTWLbJfVaYHgNPDXQ,EAAAdAAARADAGACAUAGA.eAEALCCA..bBFA..VDABHDFAhAAA.gEAAhAEADDGAQEEAACBBCEDASFDAhAFAZEGB.TGGAWFHH.aHBA..NIBB.BFHBhAIA.....hACA...,1,22,-25,47
gCeXEGZbFHKNYRdfVQUPOaWLIJcDBTMAS,CAAAEAAAZACAHACA.KAFCRAGBdCCA..QBGAOCFD.aCCCLDABhAAAIDFADAEAMEAAhAAAAAIB.eEEBGEDAbEGDFFCBhAEA..fDHA.UGGA.hAIA......hCAA...,2,-20,-3,17
OgHENZABMaUIYXSbdRVecDWCJFLGQfPTK,aAAAUAAA...XADAdADARAFAeBBB.DCFBCAGALCDAGCGAQEDChAFA.TGAAhAGAOAHD.HDAAhADAEGFBACIBMDHBSDBDbECAcGAA.FGEH.hAIAKGGD.....hBAA...,1,-9,-11,2
cOBEJQRHGXLUYIbFaTMNCeZSWKVDAfPgd,...fAAAdAAABADAEAFARADAHAGBGBGALCBBUCCA.bDCDaCFBhACA..MDABeDABZEEAhAAAKEFBAAIB..PGEChACAOEHDQGAD..YFAFhADA......hAFA...,2,-25,16,41
VEedHbJTNZCKYSOcDFUBAQIWGaMXfRLPg,QAAAGAAAaADA.MADARAFFLAHB..gAFAhAAAECDBHDBBTEFAZBDFKBHBODCBhAIAFFDDAAAB.XDFBhBCAfFHAeEGH........hCAA......hCDA...,2,-15,0,15
CgLGOfKPDBXANZVFaJbcSRYWdUeTEHMQI,ZAAAaAAA.JADA..SACHRAGF.dAEAeCABHAGBMCCBQDDAhAGA.CDFAGEBAhAIAKDDABDFBABBBFDHD.bGFAhBAAcDGD.UGAA.EFFB...gFCHhABA.fFHAhACA,2,-23,-12,11
fAKTFeCcYMGBPISWQabLJONZUVREHdgXD,TAAAeAAACADA...MACAGAEABAFASAGAQBDCaCCBLAHBhAAA.OCCHhBHAZCGBRDDBHGAAdCGCDDFBAAAAFFHDhAGAPEHD.IGFA....hCAA......hCDA...,2,-19,-10,9
NDPTHXEUReKICOgJYGAVMWLBcQbdZFSfa,MAAALAAABADAQAEAZAEB.SAGAaAGDDAIB.HCAAhABAEBBB.RCFAeCEDKDCAODFChBAAgEAA.GEGAhACAADHAVFFAWHAAdGBA.fGFE.hBCA......hBGA...,2,-30,16,46
HbSVgdUCWYNfTGMIBaAZFJERXcQeODKLP,ZAAAEAAARACAQAEA.eAHBKAFCHBFCSCAAdCCDCDAA...hAAANCEA.GDEABCGAAACAXDGAhADADDDBLEABhABAPHFCbFED...gGBH.YEHBhAEAMIAAaGDF..hAIA...,1,0,-16,16
ZOgHMXWfFCTEVUIKPeScRGNQbDLJBAdYa,aAAAZAAAHAEA.MAIBXACDFCAA.EAEAUCEB.KDADeAGFRDGF.hABAGCEA.bCGDLFEBhACAAAIBdDDC.OGAAhADAfEAACGGD.TGGAIHAASBBDhAEA.NICB.DDDB.hBAABHCA.,1,7,-13,20
dMQSEVRADOUWcKaYLNFBJTPGXfbIeCHgZ,OAAAUAAAKADALAEABAFB...TBCAGAGA..bBFAeCBAhADAHDEAdDEA.MDGBhAIAEEDBAAFADDIBaBBH.FEHDXFCChBAACGDDZGFA.SFGH...hAIA......hBAA...,1,-5,-28,23
YIDfMBQbNHJTeGVWgPEKOUaLZSRACdXFc,dAAAFAAA...IADAMADAQAGAHAEBeAGBGBCA.VCFBhBAAgCAA.hBEAEDCAODHDaAHFZDFEABFBXFFChBIADEEBbFGB.NECA.WGDA....hACA......hBAA...,1,-7,-11,4
WRAVUfKaGdNZJMPYXQFBDEHeCcgSIbLTO,UAAAaAAAGACAZADA..MAEA..XAEAQCDADAHBHCEAhAEAeAHF.CDHA..SBBDhAFAbDFDLEHBTEFAhAIARFDBACIBKDCDdGHANEEA........hBAA......hBIA...,1,-10,-14,4
PFebSTYaDLBOVcRNUAZgdQXGHIWEKMfJC,dAAAGAAAHADAEADAMAFACAFA.FBGD..eAGHSCAAaBHD.LDDBhACAOCDBREEAABIBZDFAhADAQGGAXFFAKFCDhAAA.fHEB......hACA......hADA...,2,-15,-14,1
RaDcWXCNSLPYQJKMTAeZIEfgVHdObGBFU,eAAAEAAA...VADAHACA.bAFBGAGAFAHDRCCA.aCCB..DDHBXDDAhAAASEAALFGBhABAQEEAMDIBAAIBhAGAZGFEfGDAOFCD.cGED..hCAA......hCBA...,2,-10,0,10
SWdBCQHNYcAbPfJeDRZTFGVLOKMIaXEUg,...bAAAfAAA.eADARAEAZCAAGAGALAHBMBCBaCEChAAAECAFSEAAhABAdDDAQEADHEEAcGCAhACAAAIBDDGBTFEAOFHDXGBA.WEHHhAAACGGC......hACA...,2,-8,3,11
WedMVRGUCgPcBITZfNOHEDSLFaXYKbJQA,eAAAdAAARADAGAGACADA....PAFABCBAZDAAOBDEHEDBEBHFhAAALFFB.aCFHhACAKCCDQGAAhADAADEAMDGBgFEDIFHA.fDHA.hAEASHGA.hAGA...,2,-22,-7,15
GJfDORAUcFBeNCVTgbdXZaSWKIELYHQMP,FAAAeAAACADA...TADAdAFAZAGB..aAFAKCCALCCAHDAA.MAIBhAAAGECBDBGBACHBBDHAhADAVEEA..XFGAhBAASEHBEGEFPHFCfGHE...hBFA......hBIA...,2,-19,-15,4
XLPOUBcaINHeEAKTFdDQJMGCSgVWfRZbY,TAAAdAAAQADA.GAGASACBVCBA.RAEAZCCA.bCFDhAAALDFB.ODABhACABAHBaCHBHFBAAAEADDIBhCAAMDIBCECAfGGAPHFAIEEAeEED.hCEA......hDAA...,2,-13,10,23
gfMEBQeANVUDSTIbRYFLPGZHOcaJdWXCK,UAAATAAARADALAGB.ZCEBHACB.aAEAdDAACAHAKBFDMAIBECABhAAABCDDACHA..DDEBSEGAhADAIDGAbEBDhACAFGEA...GFEB.OHFEWHEA..hAHA......hBEA...,2,-25,-8,17
OFASUEKCJaQTZHYLVceNbGXgfBPMWRDId,EAAACAAA..aACAZACBHAEBLAFA.eBEBGBCA.XAGAhAAABCBCMCGBRCGBdCBCAAGAKCHBhAAATEEAVEDB..bGAAhAGAfFHADFIBFGEHSGGB..hAHA......hBCA...,2,-20,2,22
gJWXLcPTFAIOEZQSRYfNVGDebKMdHaUBC,EAAAZAAARAEA....fACAGCAAeAHHMAEAHCCCBAHACDFAJDHBhABALBEB.TCGAhAAAAACAQGCASCDFhBGA.VEFBbFFDaFAHgGCA.WFHHhCAA.....hAEA...,1,-5,-8,3
ADCfHdNcMXKSQIJgEYeTUWRVbBOZaFGLP,CAAAHAAAdACA.MACAKAEA.QAFA.JBDBEAGE.eCBBUDFARCGBBDDAhAAAaBHFGFCBLEABhAEAACCBDEIB..fDFEhAIANIAB.SFCAIHGA.TGGAhBCA...bGCA.hAAA...,2,-17,-14,3
QIXCMfYbPRNdJFSeGcDLHOaVEgKTWZUBA,QAAACAAA.MADAbACA..RAGBdCAASAFAGCCALEFAhAAAHBDAaAHDEDBAKCFBZGAAhACAADFAXDFA.fEEEhAAAPHEA.FFHDDGGA.....hBCA......hBDA...,2,-13,-11,2
UaXWSbYcTQfJEBZFeDHgLdKIROPMNVGAC,aAAASAAA..bACDTADA.QAFCEAEAZAGBeBFFhAEAHCCAdECARCGBMAIBGEEBhBAAAAAAXDAC.hBBAcEEABDHADGHBLGEA.OHAAhADANIBB......hAHA...,2,-8,0,8
JDTYGeCFWEZBgfcAXQHPRSLMNKIOUabVd,HAAARAAAMADAKADC.OAFCUBEA...aCACdAHA.DCCAGCCAFDDHZDGBhAAABCFA...fCHAhAAAAEGBQGCAhABALEFA.bGEA.JHAAeFFD.CHBDWEHHhBHA.....hACA...,1,-16,-20,4
bCMDdOVeTcPWSRHfBZXGAKEQgYFNJUaIL,EAAAQAAAFACD.UADAaAEA.LAGB.MAIBdAHAeBDHhAAATDBAPBFB.RDGBHFFBhBHAZDDBABFAKEHB.gFEHhAAANEEA.IHGA.DGCB.hCAA......hCBA...,2,-16,-7,9
NWVbOCZaTJKYfQUDMFdXecPGRgHILSEAB,BAAAVAAA.CACAZADB..aADAKAFA..QAGADAIB.dCDAeCAAhAAAGCFAHCEBLDHBhAAAACAA.bEBCTCGAhACAfGAEMEIBXGCAPHFA.IFGAhAHASFDA..hAGA...,2,-30,-10,20
BFQEaJUHODYeRIVcgWdPNLGCKZbXTSMAf,FAAAEAAAUADAHACBDAEA.RAFA...IAGA..gCFAhAIAdBCCLCGBGEBAhBAAZDEBbFBBTEDAAAIBQGGAhAAAaDHDOFGB........hBEA......hCAA...,1,-13,-15,2
DMcdZIQLWEbXBAfFOGeTgYRHKPCUNSaVJ,OAAAeAAA..TADARADAHAGB.CBBDUCDBaAFADAIB..dDGDZCCALEABhAEAEBGBBDGDAAIBFEEHhAGAGFCB.KFHBSFHBhBAAMIDA.QGFA...hAAA......hABA...,1,-8,-22,14
HAYWDUMECfFcKabXIGRNBLVOQPgdZSTJe,DAAAEAAAFACDKACA....aAEAXAEA.RBGFLCEBQBEDhAHAdEAAZBGB.TDCAhAIAHFGBAAHAUFEAMDDBfBBEhBAAIGEANIBBODHD.SGGBhCAA.....hAAA...,1,-15,-17,2
LXeVSCBbZRIcAGdNfDWETMJKPHUgaFYQO,dAAADAAAEACAMADA.KAGAHAEA.UCCAFBDA.QCFALCCBeCEAhACACAHBZEFA.RDGB..ACIBGEEAhAIAfGAA.TGGAhAGA...PHDCaGHD.OBBHhBAA......hCAA...,2,-19,-11,8
MacBJbDHGQdNCYRUOKeSVFEPfATXIZLgW,TAAAZAAALADB.MAFAaACABAFA.DAHBHBFAdCCACCFARCABKDEAhABA.eDGHFCHDEEDAABHAXFBAhACA.IGHAhBFAgEGG.cFAA...JFFFhAAA......hAFA...,2,-34,-8,26
fLGDQYObXEKFHRTWCeBIAdPMSUZagVJcN,dAAAMAAAZABB..aACEVADA..JAFA....fAGBhAIAGBDBQDDChAIAOCEEEDCFHDGBREEA.TGDAhBAAeEHHACHASBBD.gGGAhCAANIDBDHEA.....hBAA...,2,-18,-4,14
GRNdMUWAOFHbBSVIcJaTCgPZYDQKfeEXL,HAAASAAAVAEA...JADAaAHD.CCADZCCAQAGC.eBCFhAAAEDGAGEAARDDAdDGAMCIBhABAAEABbECBBFCA.TGGAhAIAgEGADFFB.XGDD..hAAA......hACA...,1,-3,-12,9
DVNCSAQFEOYZcJLgeKRUMaHPWGbfdBTIX,EAAAZAAALADBKACA.RAFAUCAAHAEBGBGA.dAGBTCGAhABADCCBCDDAAEAAQDEDhACA.OEHDcEFCeFAAhAFAaFHD.bGAABGEAIHFANICB....hAGA......hAIA...,2,-19,-3,16
VLHSOKUJCWaXFIABDdNQEMGTeRbcPgYZf,dAAAEAAAGACARADA....bABDPAEAZAGBLCFDHBFCKCBDCDAD.hADAaDFBFDHDAAIBBDHA.hAEAQEBDeEDBgGAAhAGAfEGESGEHOEEHUGGBhAAAXGGA....hBAA...,2,-15,11,26
WDPeFaGHZACMNLTUOKSXcIfJQREBdYVbg,MAAATAAAKADA..SACB..XAFBIAEAQBBChAIAEAGAdCCDbBFADBHBhBAAFDEDHCEB.ABIBLDDDhCAAODGBfEHARFGBBDHAgGDAhCBAeGAAaGHDCHDANECA....hAAA...,1,-3,-11,8
DIeXQgTEVfGBRYaHWPALCdZcbSFJUKMNO,dAAAZAAASACEFADAKAGA..MBDBDAFAeAHF..QCEAhACAEBEAGCFARCGBHECChAGAACCBLDDBCCBA.bFGDUFGBhAIAOFFH.........hBAA......hBCA...,2,-21,-11,10
GYBeHLdVFTAMgJZDaSIfWRcbKQUNOXCPE,MAAAZAAAaACA..SACA..fAFARAEFKAGCUCGAXAGDhABAEBBB.GCCBhAFAeDCFHEDAdDHATFEAhAIAAFHADGDBIGGA..cGFD.hBAA......hBIA...,2,-21,-15,6
HSXgPWFIGOUTZebNJfYVdcADKRCBaMEQL,RAAAaAAAEADEHACB..SAFBXAEA....PAHBFAHBGCCAhAAATCEAeCFBbEAA.hAEAfCHAdEEDABBBCDHAMFHBhAFALFEA.IHHA...hAIA......hBAA...,2,-12,-6,6
PIgZWLUTeJSbdNAKEQCcVMOYFHDaXRBfG,EAAAQAAA.CACA.MADAFAEA.HAFCDAHB.RBCAGCEB.gDBBhAAAZCDALDHBhAAAeEEBbEBAABCAKEGAOFEDhAIAaGGABHHDIGCA.......hAIA......hCAA...,1,-5,-22,17
IaTfRDQcVFbJOWSXgZHGEMeLAdKCPUYBN,dAAACAAAUACABADA...aAEDRAEADAIB..QAGAFCBH.OCAEhACASCFAZDCEHDFBhADAGDDAEDHBeGAAhAGAADDBKDHB...NIBBfGHAVFAA..bFGDhAAA.....WHAAhAFA..,1,-15,-26,11
ZBfNCDYUQTHIFeGKROgVdWabLSMEAJXPc,XAAAZAAABADBCAFADADA..UCAAHAEC.eAHHRAGF.OBCDdDDA.hABAaCEBLEGB.hAAAEFAAADFAcDGD.hACAfFEAQGDATGGA.FHAA.hAFA......hAIA...,1,-3,-32,29
cBgUIQAGeKLTCHdMESObPYXZVFfDRNJaW,eAAATAAAHADA.EAGEOACA..bCCAXAFAZCFB.fBDEhAAAREGFaEEHBCHAgCEHhAGAQFAAAAIBGDGAhCAA.CCCDdGEAMIAASGGDhCIA......hDAA...,1,2,-12,14
RDJQBcEMYfWaeNKZOFPHbAGUICVSTLdgX,GAAACAAA.SADAdACARAEAQCDDEAGAMBIB...fCDAhAAAeAHHZEAAFCBHHCEBhACAACGBUEEBTEGALEHBhAAADDABBCGA.cEADaHAAOHFCbGAAgGGAhADA...hAEA...,1,16,-13,29
PRXAFVCHEKSLdcgeQTZGIOMNBUaWbfYJD,CAAAHAAAKACA.dADA.eAFAZAEBGAGAMBIBBCADUCAA..aCCC..hAAA..bDCDfCFAhACADDIB.RDGBAAFAEEEALFCAhCFAQFGCTGFANIAB.YHCAhCHA..XGDAhAAA...,2,-27,9,36
CINPTfAHdLMKRZOGbXcQFDYJeWBgUSEaV,HAAAdAAAMADARADFGAFA..XAFAQCABDAIB.eAHBBBDAhACASDDAECBF.hBAAaDGDCCEAIDGAhBCATFAAAEIBZFFAbEEC..FFHD.....YGCAhBDA....hCGA...,1,10,-30,40
QGYHAMJgIDVRKCBNfdTPXFZaWOESbeULc,MAAAJAAA.DAEARADFBAFB..dAHA.TBBAFAHBZCEB..aBDAECCBhADA..eBFHLDGBhBAAGDDAHGEAADDBgDGAhBAA.KFHBNCIA.fGGE.hCAAPHBC...hCBA...,1,-10,-29,19
EeJXMQUBAIGDTRNLcVbOfCgSYPHdZFKaW,GAAARAAALADB..bADACAFA...SAHBHAGBZDCAaDFFECDAeBGHhAAAMDIB.BDCDAAAADEHBhAFATEEA.cEAChACAfFCA.gGGGdEHAKFDDXGGChADA....hAEA...,1,-6,-18,12
UMbDFQZPeXEcJKBfCgLIdaHGRYSNWTVAO,MAAAFAAAZACB..eACAEAEA.KAFABAGA..CAHBLCCAaAHD.hBAAHCFBRCEASDGAhCAATECAABBBOCHFDECAQFCAhCBAXFFAfFFAdHCB.YHFGhCCA....hCEA...,1,-9,-31,22
PJaGURHeQAWVFKYSEDCIXZgTMbfdcLONB,FAAASAAAEADA.CADA.ZAFB.MAIBdAFALAHBBBEA.aCCARCCBHCGBhADAAAAA.KEFDDDAAXGGAhBAATDEA..bDAAhADAOHBA..PEGD.UGDA.hBHAeFBB.WFHH.hCAA...,2,-19,-7,12
gNXFHWCSIbTBeYERDdKfVAGUJZcPQOaML,GAAAZAAAQAEAaADALAGB..XAGAHCDBSCHHhAAAbCABBCDA.EBFFRCFAdEEAhABAfEBAAADAUGGAJHAAhACAOEGB.MFFBFHEG.CHGA......hAHA......hDAA...,1,3,-4,7
gKCeUVJDfSMPIYRALFHOWTdBGXcbEZNaQ,HAAATAAAGADA.XAFAEACEZAEBaAGDQCAB.CCFAeBHHhAAAVDCBDAIBMDDBIDHAhAAAAAFALEFAOEABhAEAdGEABGGA..bFEA.KGBA...hACA......hADA...,1,3,-9,12
QOBVLMbIFgJHRNCdWUXATaEKPYfGcSeDZ,EAAAKAAA.....fACAGACAeAEAZADBQAFAhAAABAHAMCABFCEDHCEBRCGBdFFAXCGAhAIAACIB.aDCH.cEFDhBHAOEAD.........hBIA......hCAA...,1,-11,-31,20
JdegEHZTARbfBcCIFSPVOKUMQNLDXaGWY,RAAABAAACADB.SACA..OAEDMAFALBFAaAGAGBGAhAAAJCAAeCCBHDCCABGB.bDFBhAAA..fEEAhABAFDAHKDHBQGBAXFGA.dGHAEGEF...hACA......hADA...,2,-17,-6,11
LIBGCEJHQAafNgMKPXcOVZSbWYDFeRTUd,aAAA..fAAAMADAKAGA...XADAOBBBZBFASAGAhAAA.bCAADCDBRCEAdCHAhACALDFBGEAAEDHBhAIAHECCACEBPEBDcFGA.VGEAFEEBeFHBhBAA......hBDA...,2,-19,25,44
eETBbIaPSXCQWYfcDVGZdANKOgHLUMJFR,OAAAHAAAMACARADA.EAFABAGB..aAHDXBBCQBDD.hAEA..fCGEhAAADAIBZCDEACHBKDHBLEDAhBHAFEEAeFCBbFEASGHHCFGA....hCAA......hCCA...,2,-32,-4,28
RASIVYcUeTNKWfQLGHDdbMOgZCPaBEXJF,SAAAVAAA.UADAeADE.KAGCQAFAHBDAdCHAMDDBhAAAZCCAaBHDBEEA.EEGBFDBHhAAAAFIB.IEGA.hBIATGDAfGDALFFADGGB....hABA......hAIA...,2,-19,-15,4
YNPMXQGFEUOISKVAJgecaWRCfHdBbZLDT,eAAAaAAA.RADAHAGBdADAZAEBLCCADAHB.TDFA..PBBBhAIAMDIBGEAAFCGHEDDB.hBAAOEEB.KFGBABIBJEHBhBDA...gFEA.CGBA..hAAA......hABA...,1,-4,-26,22
REAcYIBUQGNZVKHPaXTLOfJdbWCMDSFeg,..IAAAQAAAZACAHAGBaACELAFAOCCB.dCDA.bCEDMADAhAIA.FDEARCGBAAGABDHAhBGAGDAAKEEDTFGAhBIAJFHBDGCASGEAEGFB..YECBhCAANICB......hCBA...,2,-11,6,17
aBeHSZgDUfPYWRKVTCNOIbJXFdMAEQGcL,EAAAGAAALADAeADAHAGBZAGBDBCBUCDA...fDFBhAAAPCEBREAAKDHBTFFAOEGBhAAAbEACFGBA.AADAaFHDhACASGCA.WFFDCHFDNIAB...IHHAhAEA....hAFA...,2,-26,20,46
VTcNOSELHJYIXCGZMKFPbDQWUdAgaBeRf,aAAARAAA..TAEAOACDLAGBHAEAJBHB..XCCAZDEBMBBBhAEAFDABDAGAQEFAhAAA.dFDAACEBeEHFhBAAfGHAcGCASGCDEGFF.CHFA..hCAA......hCGA...,2,-17,-5,12
QGKZTcUBRbCdJNeLFOaWMHfYSIVXAPgDE,DAAAEAAAGACAZABEUAFARAEA..dAHA..eBHHLDFAFCCA.aCBHHDAAhADA..SEADhAAAXDFDADFBQEDDhAEAKFBABFHA.bGCCCGGDOEEHMFIBfGGAhAFA..IHBAhAIA..,2,-21,-3,18
ScYMgTODKVGWQIaPRNHEFLZfeJCXdBbUA,SAAAMAAA.OACDKADAGAFA.QBBCaAEARAGFHBEBhAAAEAHBZEBAeCEBCDHAdFFAbDGDhAFAAECA....YHFGhABADDDBIHHA.FGFH.....hAIA......hBEA...,2,-17,-7,10
VHLGTcCEYFBAIZRJQfUXdaWNDePbMKSgO,RAAAQAAAUADA.aACEDAGA...eBFEbAED.KCCD..OAGDhAAAHCFAGEDATDAAEDCEhADABFFBAAGBZDFEJFHB.dFGAhAIA.NIBB...........hBIA......hCAA...,2,-30,-4,26
CaOeJBENIWdHSDGZYPbcfTRAUVQXMFKLg,QAAAMAAALAEAaACE.eAHHBAFAEBBA....IAHAhAAAHCDAGEFAZCDAbCGBTFAAhAFAACEA.XFCBhAGAKDAAOEEBWEHBdFAADIDAcFGC...hBAA......hBBA...,2,-12,-2,10
RZMgUHfPTSYaIKbcOCVGAQeXWFBJdLDNE,eAAAFAAAdADALAEADAFA.RBCBZBFEMAIBHDFA...TFAAhAAAaBEDKBGBOECEGDBAAAFAQFGAhABABDDD.hBAAEHDAfDGE.SEFDhBDA.bGFA....hBGA...,1,8,-37,45
PgDGXaVbBQfLFAdCUIJNZcKWESYeHROTM,dAAACAAAUACAJADA..ZAGBKAEA....EBDBeAGHHCACRCEB...MBIBhACADAIBGDGA.hAGA.aCFBBCBDLEEAhBAAADDB.IGEANEEA.SGGAhBCATGAA......hEAA...,1,-21,-35,14
VcbReWHDAMdKXYCIgfNGOaPEJQTZUFLSB,dAAAXAAACADA....IAFA..fADAhAAAGAGAaCAEEAFA.TBGAhABAZCEFLDDBBCDAbCEDRFGBHGDChACAAAIBMDAB.KDHBNIAB.OFAD.QFGDhADA.SGDAhAFA,2,-21,-3,18
fGFdPATWZcIDMQCJEOYSgbeHaKVLXNRUB,ZAAADAAAMADAQAEA.EAGASAFA.eAHHHCAAaBBAhBAALCEARBDF.fDHAhABAdDFAACCBTFGAhCAAIEEAOFEBbEAAKDHBXFGABGCA.FGEBhACA......hADA...,1,-8,-12,4
ZLKBOIJQPbRCYaGFHEASVcgDNWMeXdTfU,SAAAVAAA.DADAMADA.dAHATAFAZBDBLBGDBAHBOBCChAAAQFCA.hABARFEAaDCBHCFC.ADDAgEBAhBEAeHFA.fEEA.KEHBhCAA.IGFA.hAAA...,2,-18,-14,4
BRbFSJVHEDWdegMQYcKGLaAOZUXPfNITC,ZAAAXAAA..fADB..TADARAFFSAHBhABAHAFBEAHBdCAAeCDBMCCBhACAQDAAKCHDaDDAAEEBOECDhAFAPDFBCDHAbFFAFFAHDFFAgGGAhAAA..cGEC.hABA...,1,-3,-10,7
XcCEUfSROgBDYJQTKVLNabHGWPZMAFIed,eAAAdAAACADA.EADAUAFARAFA..BCCADAIB.QCEC.KCHBLCCBhACA.bCECHEFAhAAA.GGABZDABADABFDHDhADAIGHA.fEDEOEFBgGGAhBAA.JHBA.hABA...,1,-17,-21,4
HFUVPTbZDLgMBIESaAdGQJRfKXWOCcYeN,GAAARAAAKADC.OADACAFA.eAGFHAGBFBHDUCCA..TCDAhAAAZDFALFCAMDCBEEFAAAAAdGGAhAIAQFGA.hBIAXFCD.cFEC.NIAB...hACA......hAIA...,1,-3,-30,27
CYTKXFfJPWNAVaSgdMOcBbULeQDZHEIGR,aAAAdAAAMADABADALAFADAHB..HBDAEBBBGCEARCAACCHA.KCGAhADAFDED..JDCBPDGBhACAAAGA..SEGAhBAAOEHDUFBAeHEA.......hAIA......hBAA...,1,-19,-24,5
FgGINUEJMYHdXRZecQOLTKCSDfPabBWAV,FAAAGAAAUADAEADA.MAGBHAFA.RCFAZDBAeAHB.QCDAhAAALEHBCCCDDCHB.aDAHBFEAhAHAADCBVEFB..gGFFhAIAIFDAYFBB....hACA......hADA...,2,-23,-8,15
RdPDOYUGHecEANWBTbQXaSLfKJIZgFMCV,BAAATAAAQACA..aACALAFAKAFAZBDAMAIBRCAAdCFAOCHBhAAAGCGAHDDBhAAAEEBAAAGA.bFAB..fEDAhACAgGFBCFFADEIB......hBEA......hCAA...,2,-24,1,25
MHEQRBVSgDYTNcXbZeUCIGKFdLaJfWOPA,HAAARAAABADBSACEDAFA...TAFAXAGAeAHHCBEA.GCCAhAAA.dEFAaCCBfDHAhAFAOCFCAAAA.EFHFhAHAQDDCYFCF...bEGB.ZFFF.hCAAKHCA.....hCCA...,1,0,-26,26
GcIYdJZRFaefWgDTULAECbQKPSXMOHBVN,EAAAQAAAKACA.SACAMAEAHBDCBAFAGBGA.IDDAhAAAdAHARCDAeDAB.fDCEhAAADAIBTFEAADHAbEFAhADAOEHD.cGBAZFEAaFAH.gGCBhAFACEFB....hBHA...,2,-7,-4,3
ZYKGXUOFdeVLDIcRPTbgHBAEMSNQWaJfC,EAAAMAAA..QACAaACE.CAEAZAFBGAEAOAHDeAGBLDDBhAAADAIBRCCB..bEFAHDFChBHAABBB.SCCDhCAA.JFFBKGDAFHGEdGGA.IHAA.hCBA......hCFA...,1,-3,-16,13
BALVXDaMECOYbJRSNZcQdFTUWPKgGHIef,LAAADAAAEACA.OADD..bAEARAFAZCAAdCCAFCFBUCFB.KEEDHDGBhAFA.eEDFAAFAaDHDMAIBhAGA.CFFD..SBBDhBAAQGEAWGEG......hCAA......hCEA...,2,-28,-15,13
OgDSNBHULICeRbMEVWXfKJZQadGAYTcFP,TAAAFAAAOACD..SACBHAEALAHBeAEARBFAECEBXCCAhAAAKDGDZEAAdFFDGDEAhAEAACGA.PDHBDEEBBGAAhAEACFAAMIAA..fGHAaGEHgGGAhAFA......hAIA...,1,0,-15,15
cJEeKaQAgRXWHfCBbLDVFOdMGPYNZTUIS,RAAAHAAABADBLADBFAFA.dAFAGBDB..PAHBZDDATFGAhAAASCAA.EDEAhAAAeBHHaDGEAFBAXGDAhABACFFADFHBMFIB.YFBGNCCA....hACA......hAIA...,2,-19,-14,5
dbWfUeEVQMcFLORTHABDYPCSNJXIGgKaZ,DAAACAAA..SACAXABAGAEAKAFAdAHA.....bAGBfCAAhAAAECCB.MCCAhACALEABRCEAHEECABIBBDGDhAEAPFAAIFFAaEHD.WDHHeHEAcGBDhBAA.OEDFhBEA.YHFA.,2,-6,-6,0
QWGFTOgLYSAPDbfMRUXeCHJIcENKdBaZV,DAAAMAAARABA.UAEA..eAEEHAGD.JBBBEBEF.dAHAZDCB.QEEAhAIAGCFATDCAhBAALEHBADHA..bFDDCEBAIHFAhBAAKFHBBHFB.aGDD......hBBA......hBDA...,2,-15,-15,0
bOScaQDLYNEXgKRGVUMdBZWfTJIHPACeF,eAAAOAAA..aADDLAEA.EBBBKAFARCEAGDCAMAIBZCCA.hAFATDGAHEGBAAIBFDBHSBDGhAGAQFCADCIBhBAAXFFCgGEBdHABfGHAhAAA......hABA...,2,-16,-1,15
CgUVDKJOeXQYPMaTGdIBFZLbENcSHWRfA,CAAAVAAAKACA...eADEQAEC..MAHBGAGAdCDAFCFBhAAAZCAAEDFBSCHHhAGAHEDBRGAAAAIBDEBBOFHB.hAIA.XEFD.aFHD.BHFA.bEBDhBEA......hBIA...,1,-12,-19,7
VHXaIEgReYMPZOJFWNSDbTfUAKCdcGLQB,dAAAGAAALADAQADAHAGBaCAEEAFARBGBeCEBMCDBZEAA.FDHDSDADhAAADEEB.bEDDhACATGEAAAIB.CDCABGGBhACAXFFA.........hAEA......hAFA...,2,-12,0,12
baNEOCFUcYdDKBPZgJRHWTfeXAGVMLIQS,GAAAMAAALAEAQADA.aAFEEBBAFBHDUCDAdDCABDGDZCFBREGFHFAAhAFA..TEEAhAAAeFDHAAIBSDADhACA.bGAACCHADGIBKEHBgGGB.hAGA......hBAA...,1,5,-11,16
ebGHcKBZJWTAOfUaCMIPLSdQRENVXDFgY,OAAAaAAA..MADALAEAdAHA.EBBBXBBAFBDH.eBEAhBAAHCEBBDEAZCGBTFAAhAFAABEACDGA.SEHHhAGARFFADDIB.bGCAKEDDfGGEIHHAQGDDhBBANIAB...hAIA...,1,-9,-17,8
QTSOHdRGUaFDXPWLbIcEAKNfMeZBJCYgV,KAAAMAAAeACEZABEBAFA..CAFB..VBCBTBGA.HCCARAGFGCEAhAAAaDFD.DCIBXECAhAFALFHB.IGDAhAIAAAHAfDHA.gFGASGFAhCAA......hCBA...,2,-24,-16,8
QbLDgKVcAdUPaGeMEIFXCfORHTJWSYZNB,dAAAaAAAGACAEADA.FAEACAFARAGF..HAGB.TCEASCAAhACAZEBAQFFALCEBKDCAhADAAAIBeBBDMCIBfHEBhBAAODGBJFHFNDIA.DIAA......hAIA......hBAA...,2,-23,12,35
PGMLUREdBcfKASeaVCQXbTHgNOJWDIYZF,eAAAaAAA.QADA..bACDHAFAOAEADCCBZCFEGBGAhAIAMDDBRDEBEBEEdEEDfEHAhAAAABBBCECA.XGGAhABATGGANIBBIHAA.FHCA...hBAA......hBIA...,1,6,-16,22
COKPVRJcYgDLWGTAfaebBHSFUNMIZXQdE,eAAAHAAAFADAMAEAZAFBdBDAEAHF..KAHBRCAA...JBFB..gDCAhAAALCCDGCGAhAAAACIBaDGD.SEEDhABAUGEAIGHAQGFDCEFC.OFBB.hACA......hCAA...,1,-7,-14,7
SMOVfJaYGIDAdgTWHBFeXPCbLNEKUZRQc,dAAATAAAHADA.eAFECACBLAEAECBA.ZBFERCEAQEEBhACA.MCIBfCCAhAAAaDACGEGAAAFABDEDXFCChADAbDFDKDHBSHCAOECCYHDAhAIADDDB.FGHD....hCAA...,1,20,-18,38
UPaKcXANEBFTeQHIWgVGLJCSbdZRYODfM,EAAATAAAHACA...IAGAVADAGAGALCCACCAD.dCGARCCBDDGBhAAAMAIBUFFBaEAAXECDhAAAAAIBFFDD.eEEBhAEAQGAAgFADSGHHYEHB.hACAOHFC...hADA...,1,19,-12,31
eLPWcAHXSaJRbfBZGNOFICMDUTEYVdQgK,HAAAaAAA.RADFBAFBGACAFAHBMAEA.DAIBECABdBEAKCCDLBGBhBAA..PCFBABBBSDHHhCAAJCHB.ZEEFOEEHhAAACGCAUGGA..TGFA....hACA......hADA...,2,-24,-10,14
MJKbUdCTQAaNIHcgLOEGPZXSYVRWeBfDF,aAAAHAAALADAEADEZAFB..SAHHRAGFBBBDFCDAMCAB.KCCAdDGDhAEAQDGAADDB.hAFAIECAOEEBXFGAhAIAVEEBeFAFDGFBJHBACHHD......hAAA......hACA...,2,-27,3,30
cNCGADdKSTPJgEVQbXOWUYRfFBaHLIZeM,dAAATAAAJADA...EACEQAGC..bAEBOBDBUBGARCCBhAAABCBAHEFAZCFAeECDhAHAMEEACFEDAEHAKFFA.SFHBhACA.........hAIA......hCAA...,2,-32,-11,21
aNZKgfSWLRcCXGPeVOdAFJbEYTQHIBDMU,FAAAEAAA.QADAHACADAEAMAHBUAGAZCCAKBFB....SCCAhAAARDABXDFDeCHHdEHAADHAhADAbDED...IGHAhAIAaEEH..fGBA.cGGChBAA.....hBIA...,1,-14,-22,8
YcdFGTWMQXREeCNLAVJbOHgfZDSBPaKUI,VAAAOAAA.HADAZADBBAFAaAFA..KBBDUCFA..ICFAhAIAdBHAGDAAMBIBRFDAEDCBhAAAeCDB.LEGBhBAAAAHA.bFEDDEIBSHCCPHFA....hCAA......hCHA...,2,-16,-8,8
bZfEYKTNHXIOcRPWQGJVDLSeBCFdaAgMU,MAAAZAAAEADEKADAHAFB.OAHFRAFF.QCAAGBBADAIBeCDFhABAFCHHABBBUEEA.bFABTDEAhAFA..XDGDhACAIFGA.PEDB...JHAASGHBhAFACGHA..hAHA...,2,-22,1,23
ANPYdcGCLSDKbZOXaeHVQUBfRTWMEgFJI,...PAAAdAAAGADALAEAKAFAZABBaAHD.HCFA.QEFBhAFAfBCA.RCEAMDDBhAFAEFHFFHAAACEA..cEEChAGADAIBXDBA..eDHF.BGEDhBAA......hCAA...,1,-8,-19,11
MGeXgOcAUfJSaRHPTEbICdWBQVZNDKLYF,UAAASAAAHADAEAGECADA.BCDDZAEBKAGALCFA..MCCBhAAAeDABOCGBACGA.aCHDhABAREEATGGA.IHEAhADAdDAAQFECDFAB.GECA.hAFA......hAIA...,2,-15,-15,0
ZAQWHEFLUeRKMgcfbdGDSBVYXNPICJOTa,HAAAEAAALADARADFMAFA.....fAHAGBFABBHAXBCChAAAIDAA.OCCBhAAAZCEBAAEAQDGAhAHAFDHDeEEBKFCAbGDAdGGASDDFYHBA.CHHA.hCAA......hCBA...,1,3,-15,18
SAWdYFDEMCRUVNaZGPKgcbQJOLefITBHX,dAAADAAAEACARADAUAGA..aAEDGCAB.KCFD..bAFD.QCCChAHALDHBeEABhACATEEAHEECAAIB.FHEAMBBBhBAACHHA.ZEGB.cGEC.OHBC.hADABBHD....hBEA...,1,-10,-16,6
VGSeKIcQUJZfXCAbBTdaYWPFDEMNRgOLH,TAAAaAAA....PADAEACERAEFLAGBHAGBGBBBeCCBKDEAhAIAQEAAZEDACDHAAFHAdGBAhBAAFDHDDGDAMEEB.OFFBhAAASGHBIGHA.....hBBA......hBGA...,1,2,-13,15
SQUEAPNIDCJBeZGHMcdFVbXaWLRKTgOfY,..IAAACAAAeACAHAFAdACA.FCAA..bADDaCEB.LCHBhAAARAFAKCBD.ODABSCGAhAFAEDCFAAHA.DEEAZDFBGEGAhAGAMFDB.XFCA.WFFDfGHAhACA.YFEFhADA...,2,-12,-11,1
bOCHWDEfFLcGRaBUKgZYVAXJNTQSPIdeM,XAAATAAA..QACCSADAdAEAeAFHMAGB.CAHAHCGBhAAAEAHBLCDBRDDBBFGDKGHBhAHAZDABAAAA.PCGDhADAOFDHfFEA.FFHD.aGFD..hAEA......hAIA...,2,-8,-7,1
XeSCJVNORFBPDfcKGHTAgaMZEUQdIWbLY,aAAAEAAAdADA....bACDLAFA.eBCDCAEAVAGBRCEABCHBhAAADBBBKCFDHEEC.AAGAZFCAhBDAQEAAIGHAXDGAhAEASHEAOECC.fFGAhAGA.....hCAA...,2,-16,-13,3
VJWMTROcFISGAPLaEgefNCYQUKbZdHBDX,aAAAEAAA..eACACADA.QAFAKAFAZBBAHCEBDAIB....XCCAhAAAVDAA.MCFBRCGBFFAHhADAGDAAAAIBLGCAhAFAfDGAUGGA.dFHA.BGDA....hADA......hBHA...,1,-8,-13,5
efHSRYbJGLgaNQOdPCUFcBZWMIETDKVXA,HAAARAAA.JADAGADALAGBaAFA..QBFCdCADCCEA.FCCHZDDAhAAAMAIBEDHFKECD.AAIB.hACAeDAB.SDFAhAAAbFFA.OEHDcGCBBFFA.IHFAhABA....hADA...,2,-14,-14,0
IfUdYKQeGWAZCSROgTMHBJPEXDaVLbNFc,ZAAARAAAOADAMACAHAECBAGA...EBHFaAHDLCCA.bDFAFBDDhAAA...fCFAhABAdECAQFFAeCCDADHAhCAASGDHTEFAXFCADGIB.cFGDhCFAIHAAKHEA.CEED..hDAA...,1,3,-25,28
MSbdZeKRgTNfAOaPHWCXcILFVBEUQYGJD,aAAAHAAA.XADBLADABAFAEAHBQCCAGAGAMCABdCFAeCCBhAAARDGF..TEAAhAEAAAIBOCEDCBBDFFDAUEGBDFIBSGGDhAFAZGDA.KHCA.....hACA......hCDA...,1,3,-5,8
WfQTdcYaEFGeOAKHMILgJNSDXRbZPCBVU,HAAAMAAALAEAJADADAGA.RBBAZBFEBBGAUDEB..QCABhAAAdDHA.aBHDEFAAeCEBhACAAAFAKFFD...IGHAhAIASDCH.bEFDCHED.fEHAhCDA.cFCD..hCFA...,2,-28,-21,7
LSbdWKNfCFBHADZgRQacXIETGYOUPJeMV,ZAAARAAAQADCaACA..XAEDEAFEGCDBOAGFUEEBeCCBhABAMAIBLEEAdEHAKGCACHAAhAAAHGAA.AAIBDCIBIHFAhABATGEA..YCCF...hAGA......hCAA...,2,-13,-2,11
HdYNUASOafGbVDeWJXPCMRLBEIKZgFQcT,aAAAGAAA.DADAeACH..XAEAMAEARBDFEAHFZAGBQCDAhAAA.HDBBdBFAUEFAhBAAABIBfDHAhACAWBBDCCHALFHBKEFBFFDDcFGD....hBAA......hBCA...,2,-14,-6,8
KINbBYdZAPQCGcXOfETSaRJFDLeWVUgHM,QAAAGAAAOADAEACA...aAGDRAEADAIBeBHHUCEBHCDAMCDBhAAAKDCD..IEFAhAAABCHDZEFAAEIBCFCAXFAAhAFA.TGGAFFGDLGBA..WHAAhAHANIAB......hCAA...,2,-16,1,17
SBDgFUZGKXbaAHIPJCdNEWOYTQVRcMfeL,HAAAJAAA.dADAEADEOAFA..TAGARBEFMBIBeCCALDGBhAAADCGBFCHDGGBB.bCAChACAAAFACDEA...YFFAhAIAQEEB.fGHABHFA..hBGA......hCCA...,1,1,-33,34
WfKSIYUgHZDebBdTEVaJRACNQLFGMcXOP,QAAAGAAAMADAOACC..fAGASAEEICDAhAAAUCDAHAGBZCFAeDBHhACAdDFAEDHFaAHDAAIBCFHALEEAhBAAXGGCKFHB.DGEA.BHHD...hAAA......hCAA...,2,-16,0,16
CgaNTRPGJEMFYfIVXDOWZQbBKeSdUcLHA,aAAARAAAGADA.EAFAMADA.FAGD..fAHAXBBAOBEBhAIAZCFEQDAAhAAABCHAeDEHdEGALFAAhABAHFBBADGBCEHATGFAYFFF.DEIB....hADA......hAFA...,2,-14,-1,13
CESLeZGIUHbXFaPfOdYATJWgMQNBVDcRK,TAAAJAAA..MADAQACCBAGA.DAEARBCA.EAGALCGBhAIA.eDEBGBEAHFBAhBAAbCGBaEHDODDB.hBFAADIBgFGANIBBKGGDCDFB.SGEBhAAA......hBIA...,2,-14,-14,0
PIJcWZNCYaBMLDAfQGREVSUgTHeKXOFdb,GAAAEAAAUADAHADA.eAFEOAFCdCDDICGA.JDHBZCBAhAAA.CCFAaCGDMDABAAHARFEASEEAhAAAKEHB.FGGHhACA............hADA......hAIA...,1,-10,-37,27
DgcNREKVJLAWYaSCdOeITQHUBGZFbPfMX,aAAAdAAAeADA.QAGAHACBGAEBZABBFCEAbCEA...MDDBhAEADBBBNCIAREEA...EEAAKDHBhBAALEEBAEEA.SEGDhAEAOHDAIHHATFCABHAA.hBIAfHFF.hCDA...,1,5,-17,22
eWJZfYVUDgaILFGRdSEMHCPQXcOABKTbN,TAAAeAAAZADB...VAFADACAaADE.LAGBRCEFEBCF.HCCAhAAAQDGAOCHDAAIBbGFAhAAAJECF.UEEA.FFHHhBGA............hCAA......hCCA...,1,-13,-16,3
dKgJGTBCbMXVHDFUIYSAREaZeOQWPfLNc,EAAAeAAA.QADA..fACALAGBdCCAKAEAGAGAhAAATEDACBFBbCDBMAIBhAAAHDFBFEHBIEAAhAEAAFGBRGEE.ZGAA.OEHD.WDDD...hABA......hCAA...,1,5,-13,18
ZJVUSMgdIXfbPKBGTQLFaReNAODYWEcHC,DAAAEAAAHACAZABEUAFAMAEA..dBHA..fAHAKCCAGDAATCDAhAAALDFBRBFBACCBOCHDhCAA...cEFChCBACECBSEEF.IEHAPHFA.hDAAFGHB...NIAB..hDBA...,2,-25,-7,18
CSbYeEcHKRQTLdWFAZaOgBUNJVPDXGfMI,aAAABAAA.UACA..VADADAFAGBEA..MAHBSAGAhAAAeBBBHCFBRCGFLEBAhBCAdDAAAAIBZDCBOEHDhBEAgFDHJGCA.fFHACGFB.EGAB.hCAAKHFA.....hCBA...,1,-2,-22,20
JPgYdVEASLNFKMOcBITHaCfGZeDRXbUWQ,LAAAKAAAMACABAFAHADBaAFA.GBFAeAGHRBCAUCAA.QFBAhABAJCHB.gDDGhACAdDBAAAIBFDEBOEGHhAAATFGACBHA.DDIB.WHEG..YFHBhBDA.....hAIA...,1,0,-29,29
XPIfGCTFOSgMVKNLAQReZDJYaUcHBdEWb,RAAAeAAAZADBDAGA..aADDHBFAEAFA...XDAAIBHAGDEAhAAATCEAFDGE.SFBAhABAMCCBKDDDAAAAQGGAhADAUEGAdFAAbGCACHBA.......hBFA......hBHA...,2,-10,-8,2
FIOWcYUAHXaEBfDLZPQJTKgdReCGVSNbM,HAAAEAAADADAZADB.QAFAKAFA.RCEFeBHHGBCA.SAHBhAAAbDAB.MCBBOEFDhAAA..cCEAhBCAAACAaEHDLHBATEEAdDHACHFD.FGCAIHHAhAIAUGGAfHEF.hBHA...,1,2,-3,5
DIPGESdJFBbOHCVUeNgZMXLWATQfaYcRK,TAAAaAAA..RACFDAEAGACA.EAEAdAHABAGAHBEBCBHA.eBBDZCEBMCABhAAALDHB.ABGAQECAhBAAfDGAKEHBhACASEFAbEADOGDAVGEANIAB....hCAA......hCEA...,1,4,-8,12
AQFXHNEISaPVKMLefgGUODZdRCWTbcYJB,QAAAHAAAEADEaAFAKACA.LAEB.eAGBGBEBDAIBRDCBTCCAhAAA.bDFAcEEAhAAABCADAAIB.XEEChACASCGDMFDBfEHAOFGD.dHAB.hCCACGHA......hDFA...,2,-10,0,10
aINYXFSQZCRVbKUTBEdHMeDgJPGcAfWOL,OAAAaAAA....IADAXADAQAFARAGBKBBDBCDAHCCAhAFAeCFFDAIB.gDFAhBAAGEAAAAIBLEGBhAEAFECHZFGBCBBDVGDA.......hAGA......hBAA...,2,-26,0,26
ALaPDJHdEeNQXGgKCfUORTSMYFWcBVZIb,aAAADAAAHABC.EAEEeACH.QAEAGAGACCCDOCEBRAGBMBBBFCEHhAEABDFAZEFBAAIBLFCAhAGAdGDA...XGFAhBAAfHGFSDHHYDHB..hAIA......hBAA...,2,-14,-14,0
XUVLBZAIfCNPDGTFYEaRdQWeHcJKOMbgS,CAAADAAAGACAFACD..EAEARAEAdAHA..eAGFHCABKBHBMCGB.SDHBhAAAXCDALEAAhAEAAACB.fDGAhAIATEDAaEHHQFFBcFAC.OBBHhBAAgGGGBHHANEEA.hAEA...,2,-19,-14,5
GKWeaPBIHQfCbNLVJXZcSAgDMdTFERYUO,MAAAdAAAEADARACA..UAFAGAFA.eAHBaBBH.BCBAHDDAQDCAhACACAHALDGBXDGDhADAZGFAACIB.TFBAOECBhBAAKFEA.IGHA.NIAB.....hAIA......hBAA...,2,-16,-4,12
CPfJUHYTFIRcEZQONWAKXLMBSVebaDGdg,LAAAMAAABADAeADHDAFA.dAFA..CAHA.JAHBHBBAFCAA.RBEFZCGBQDEAhABA.ODHDhACAADDBSEED.hAHAaEHDGFBB.fGGATGBAEGGB.hBFA......hDAA...,1,-17,-26,9
WQSFCgEZPbeBAGaXIUfdDMORVcYNTLKHJ,aAAAXAAA.UADAdADAMAFA.RBEF.VAFA....cBBChBAATDBA.HDDBhAAAQBGCCCHAEDGBbGFAADBBGEEBhBDADGFA.OHEANIAB.....hABA......hAIA...,2,-16,-12,4
BgEOAMDfZVNPSCdJcHKXFQLUGTbRIYWea,MAAAZAAA..VAEASACAdAHAHCAAFAFALDEAGBDBRDDB..hAIAIECAeBBBaBHDEEABhABAADGBDEHB..fEHAhACACGFA.KFDA.QGFD.hBAA......hCAA...,2,-26,0,26
faAdOLbJcSXZHKPeQBUCgWDMNYFRTGVIE,dAAALAAAJADA.XADDHAGBKBDD..eAFAQCEDCBHA.hABADCCBMCAB.FCCHREFAGGABhACAECFFADHAOEDChACASGHBZEGBBFAA.gGAANIDB.hAGA......hAIA...,2,-19,-6,13
WZVKTgAIBSbRPeODaCfULEQMYNHXdJcFG,SAAARAAAeADE.DADAaAGA..CAFALAHBEBDF..MBHBhAAAHBCAdCFAFCFDZEDATEBAhAAAACCBBEHAODEH.hABAQFGANICB.cGFC.WHBAhABAKGHB......hBEA...,2,-23,-20,3
PSNXVBDCKWUbZJGIFYREAagecLQOHMfdT,eAAALAAAHADAdAEATBGASAGA..XCCCDCAAKCDDUCGAhABAZDEBGGABFEBBEEEBhACAAAAAaAGA.QGFAhAFAMFDB.NDIACFCBbGFA...IHAAhAGA......hAHA...,1,14,-23,37
OEJSVYLXZFAPdfHMWTaBgNbRGKICQcUDe,dAAAHAAAMADAaACABAFA....bABDRAGFGCCAKAGA.QEFAhAAADBEBEBFB.SDHHhAFALCHBZDCEACCBfFEEhAIATFFAIHDACCFD....hAIA......hBAA...,2,-28,-9,19
MfNBSXFRdCAEOaHeWDYZgPUQcbJKLVTIG,EAAAHAAADADAZADB.UAGAQAFA..bBEDLBCB.hAAATDFAGDAAMAIBhAAABCCCFBEHRDGFAACAeEEBgGBHhBGAcEGDKGHBfFFESHBACHHAaGDDhBIA......hCAA...,1,-4,-8,4
SMWXaBDUgIbGOFcAZLfPCNQEJRTYedVHK,ZAAALAAACADB.EAEARAEF..eAGHHAGBKCAAMCAA.aCDDDAIBUDGBhABA....bDDCGEAAhACA.FFCAADHA.fFFEhAEAQEGAYFHFdGAASFFDhABA.BHHA..hACA...,2,-31,5,36
CYPWXVGBAcaZLdHRFDgQSIKOfEeJUbTNM,ZAAAHAAARAEADACAQADC.KAFCEBHFeAHFUCCB..TCEAhAAAMCGB.CCAD....PCCBhACAXEGDGEEBhCGAAAHAaDEDdGHA.SCHHfFAA.NIDB..hEAA......hEBA...,2,-31,4,35
FMSfELUWeQHVCITGBOKbRaJXgPZcDdNAY,MAAAEAAALADAUAEA.eAGHHAGD.CBBAGDBAKBCDRCEB..aBHDXDDAhAIAZEAAdEHAADDBSBDDhBAAQGFCTEGAhBBA.OGDA.......hAAA......hAEA...,1,-7,-16,9
XUMeFAHScWRZKJELVTNGYBObfQaDICPgd,HAAASAAARADFZAFBEAHFLADA.TBGAGDAA.OCHDhAAAbCCA.aCCHDCCA.CAHBdDGDhAAAMEEBAAEA.KFCB.VFFAhACABEED.QFGA.....hADA......hAFA...,1,0,-17,17
TPSQXgWNBcDdAaJYReIKbCGEZVHfMULFO,aAAARAAAeADE..KADAGAGAEAFE.HBDBMAIBLCCD.TEFAhAAAQCCA.hABAXCEAgFCAhAGABBBDdGHAACHBIDAA.ZEFA.fFCAhADA.OHAChAHA.SGGB,2,-14,-5,9
ATgLFQPBUVECJOHIMNeScDRXaKdYGbWZf,TAAALAAA.QAEABACBEAEAOAGDHAGDMCAA.eCDFhABADAIBRCCAaCHDdDGDGEAAhACAZEAAACCAFEEBPEEB.CFHAIHFAhAEASFGA.KGBA.bGFC...hAIA......hDAA...,2,-9,4,13
PfGTAJeZbFSCVWHcYOLDgKIBXdUREQaNM,eAAAZAAASACECADA.HAEBOAEDLAGBKAGABCCAdDDAEDHFhABAaCFD.MCCBGDGAAAIBFFEDhBGA..VEDB..hAAAcGFDDCIBXGAA.....hCAA......hCBA...,2,-23,-12,11
PDUaWKMJNRLFYIgZGQfVXETdeOSBCcHbA,DAAAaAAA.MADARACF.LAHBFAEA....IAHAGBBAQBEAhBAA.XDEChBBAECEAeBBDBBGAhBDAHCGBAEBBPEGDKECAYEEB.fGGAhBAA....hCAA...,1,-18,-31,13
GAMRPDbYSZNETJfVeLBIKHFOCQWgaXUcd,RAAADAAA..SADBEACA..TAEAfAFAeAGHLCCBhAGAKAHBHCCACCGAQDGAhAIAaDGEUFAA.GEDAhBAAAAAAMEEBbFFDZFEBNBBABCEDFGGA..WHAA..hAFA......hAHA...,2,-8,5,13
BASTbZQMfDRFIUeJHdcXaLWPYEgKNVGCO,TAAAZAAAMACA.RAEA.FACA.UAFAHCCCdBHAaAHDLCCB..hAAAPCGBECEBKDGDVFEBhABAOEEBADIB..SHAAhAHAbFGD.DGIBeFBB.....hCAA......hCBA...,1,-8,-15,7
JdGaSVKfEbBANHLXcDOZRYCUFeWPIQMgT,HAAALAAADACARAEACAEAFAGA..eAHH..ICAAMCCBTDDAhAAAGBEB..aCGHKCCAhABAEEHFADFB..XDGAhACAZFAAUGGBQEAAdHABSFFFbEECBGGAhAEA.OHDC..hCCA...,1,6,-17,23
QAeVJUEHXPBYgZCGDWMIFLcNKadOTRbSf,eAAAUAAAHADABADAZAEBGAGADAHB.MCDBLCCBKCEA..dDAARDGB.hAAASDHHAAIB.hABAEEEAXEEC.hADAgGBACFGDFGAAaGHD.......hAFA......hAGA...,2,-30,-10,20
IVPLSEGANTaUYOdBHRgZDMfKJQecWbFCX,aAAAOAAAHACBRADAZAGBMAEA..KBBD..eAHF...bBEBXCDAhAEA.IEGAhAGALEDAGGCBhBAAABBBTFGAdGGADBIBQGCAFDCHCEED.SHEEhBAA....hCAA...,1,-12,-14,2
XfIAcYJZBdRUDCbWKNgFaPMETeSLVGQOH,JAAAdAAARADA.DAGACADB...KBGAFAFA...MAIBECBA...eBEFhBAALDAAGCFAHDFAhACA.XEDDACCAZFDBBFHAhCAAUGGA..NDDA.aFCBSHFAOHDA.hADA......hAEA...,2,-30,-18,12
NHWcQKLeFfXgOPSBUZRTJYIVMCdAEDbGa,EAAAGAAAHACAQADAeAEEFBHD...XAFAOCCBBDEAhAAARCEATDCAIEGA.hAAAMEDBAAIBaCHD.cEGChACALFFA.fHABSDAD.ZGAAhADA.YFFFCHHADIEA.hAHA...,2,-17,9,26
WGPLSXbVJYRgcUEIdKHfMQaTeNDAZFBCO,ZAAACAAAGACALADB.SAFAXAEA..JAHBRCABUCFA.hAAAEEEBdCAAHFACMCFBaBHDhABAeDGBAAFA.OEAEhACAbGFA.gGFB.KHAAfEHAhACANDIADEEB.....hAEA...,1,3,-13,16
VSHIBUJPWDReKbZQcNXMACdLYTgaEGfFO,dAAATAAAEADAGAFA.FAHFSACB.HAEABCBAPBHDhAAARDCAeDABZCCAQEGAhACAXDFDAAGALHDAhADAaEAAOECDIHHAUGGADEEBKFDA.NIABCHEBYFBBhBAA...hAEA...,1,2,-1,3
GAZDTFQNUIJYOacdPeKfVCWRSEHgBXLbM,ZAAATAAAQAEA.UBGAIADAOCABdAFA.eAHBKCCDCDEAhABARCAAHCGB.XCEChAAAbEAD.AEFBFFBAJEDFaFFAhACAfFGE.SGHHEGGBBHEAMIAAhADADIAA....hAEA...,2,-13,3,16
GbVdRTEUSIgDYJHFZWcPNXQfLaOCABKMe,MAAAeAAAGADAdAEARAGB.EAFAUBBA..SAHHDCGBHDCCZEGBhAGAPCCB..QFDBhAIAaCGCAAAAKDFDbEGD.hBAA..TFAAYEBFFHBENIEB....hAFA......hBDA...,2,-13,-3,10
eQcYZWTHGNMCbfJERLBSaXPDKgdAVIUFO,UAAAeAAAQADAZADAHBGBGCBBMAGBCAHA..JEAARCCBLCHBhAAABAHB.aEFBDEEAdFBAAAFAFEHDhAEAOFDD.cGFBhABATGFA..........hBAA......hBCA...,2,-25,0,25
gCRSJfYbWGBLdDFEMHXVZPKaIeQAOTcUN,TAAAUAAACADA...RACF...SAEHJAEA..bBFAGAGAhADAdDEAECABHCBC.ZDFFhAGAaDGBeEEBAAHA.ODHDhAIAgECDfGBABEHALHEAhAAA.DGGA....hACA...,2,-13,-10,3
eXZdNBJbFGRTAMEPgCKfDQHLVIYUOScaW,EAAACAAADACAHACA.LAFB..IAFAOAHBaCCC.eCHHhAAAdAHABBCAFEAARECFAEEAMBEBhAAAKFFA.QCFChBCA.UFDASFHHXFGANIAB...hAEA......hAIA...,1,-3,-41,38
LgaBdZOTWfJDSRPMFVCIQUGcKEAXbYHNe,XAAAHAAAeACELADAaAFAZBDE..OAHDTBGA..fDEAhAAASCDARDFFMCCBhCAACAHBQDFD.hDAAGEAAEEHFAEDBYHDABDCDdFGDDEEBFGHD.IHHAhAAA...hDBA...,2,-5,1,6
RaCDfSMKgUBAeFOQIGVPJHZNdYXbLTcWE,eAAAQAAAGADAJACEHAFA.dCHAXAFATDBA..EDFARCDAaBHDhAAADFAB..MFDAKDCDBEFAhAGAAAAAOFGD.PHAChAFAZEGBbGCA.........hAHA......hAIA...,1,-1,-16,15
YIEJROGQZcHKgLDVNfCTBaUedAPXFSWbM,FAAASAAAMADA.EADARAFAGBCA.ZCEFHAFALCHBDCCAfCEAhAAABDGAUGDAAAHAXCGAhABA.bDAAhADAIEBAQEFAKGGA.NHCBaHFE...hAIA......hBAA...,2,-21,3,24
XOJNbWYeHSQgKPfGRZFVAEMUBaIdCLcDT,EAAAMAAABACAdAEALAGBDAEA..TAGAOBBA..JBDBbCCChAIA..eBFBHEEAQEEChAAAKDHBGGBBZDGBhAIAABGBaGGACFDC..NCCASFHH..hCAA......hCBA...,2,-25,-5,20
egIdMGCLHXVQRDYPabUNAJBEWSZOFcfKT,EAAAZAAAFADAKACA...eAFHdAEAGAGAHBGBQCAARCCBDDGB.aAHFhABAUFFB.AAGBBFDAhAAAOCDD.TFEAMDIB.hAIACEHA............hBIA......hCAA...,2,-30,-11,19
ZORCPEGJgabHMBTWUfXSKVIcLFYQNeAdD,ZAAARAAAEADEGAEA.aACAHAFB.MAIBTAGAUCCA..SCCDhABAKDFDIEHALDDBhAGAQFAAACIBdEHACFFAhAIAgFGGBHDAfHFB...hAAA......hABA...,1,-9,-18,9
KBUYPQRaXLGSOfeJTNHbEICgMVdcZWAFD,KAAABAAAUACAQACA.RAEALAHBGAEBOCDEeCABTDDAhAAAHCGBEEEB.CFAAMFIBhAAAdCGCZFAA.ACCBDEIBaGFD.hAFAfFFAJHAA.IHGA..hACA......hAFA...,2,-15,-10,5
FTVMaGYKNbJgISWXLDcRdZBPHCeAOQEUf,EAAAFAAAMADAGACA.KAEA..JAGB..SAGBLBDBRDFAZCEBhAAAHFBAAAIBQDGAhAEAUFFB.TGDAaCCBNIAB.hAIAgFGG.WCBDDBFB....hBCA......hCAA...,1,-15,-18,3
UKNaHSTEAGLJMYeCFbIgRZXcdBDWOfPVQ,GAAAMAAA.eADAFADD...IAHARAFAZBBFdCFDDBGBOCHD.hAAA.fCDAhACAQDDCKCHBHFAAEDFBAADALFFBhAFACEEDbEGD..XFCCBFHD.PHCChBAANIAB.....hAGA...,1,-1,-11,10
fNHFXdPZbUCAMLEKITcYeDSgGaROQVJWB,EAAATAAA..eACASACBaAFD.RAEA.QCCA.hAAAVCGBBAHBHDABdCCDbCFAhAEAAAHAMDFBLEEAhAFAKFHBIHBADFIBGGCB......hCAA......hCGA...,1,-6,-13,7
bWVYaGJfPKAEScZQLgUeBDdCRTXOFIMHN,EAAAZAAALADBUADABAFAdAFA.RBGF..OCABMAHBHCBA..hAAA.bCFDVDEB.aCCHhABAfDEAAAHA.hACAQGGAeDHHTFBAFHECWBHH..hAIA......hBCA...,2,-18,-12,6
eLJKUSROCAcENPVBXWaTIGHFgdbZfQMYD,EAAAVAAABACA..aADAGADA.HAFAdAGAZCDAMCCBeBHHLCHBhAAAKEBAREEB.AAHAPDFBhAFATGBA...FGDBfEHAhAAAQGGADGIBSDDDCBED.hAIA......hBGA...,1,1,-17,18
aAdNLUFJGOPIHSKTBcXeWCZMVQDYgfRbE,dAAALAAAFADAGAFAOADDHCACKAFABAHBeAHBZDEF..MCABhABAQECADCCB.fDHEhACAECFAACIBUEEAIGHAhAIASDDD.TFAAWHFG.CDHD..hBAA..gGFAhACA..,1,-9,-21,12
GbSDHgOIZUdFAKLNfETPeaWJRcCBMYQXV,LAAAEAAA.eADHaACDRAEABAFA.MAHBQCDDGCAADAIBhABAHCGB.OCBBZCFFdDEAhACAAAEAfEEEhAAATGGA.PFHDWFADCDHAXGCA.SAHBhBCA...hAFA...,2,-16,0,16
aBRQLKYIXMCHebNgVWGZJPOFEUTdASDfc,DAAAaAAABADARABALAEB..KAFA..XAGAHCCAeAHH.hAGAbCFDVCGB.ZDCAOBBBhADAEFGBdGCAACEAfFAAhAFA.QGGAMFIBCHAA.WEEDhAHA......hBAA...,1,-17,-24,7
IEXgcFPGaWRdONQSbBJTMfVZUKHADYLCe,LAAAeAAAEADA.XADDFAFDGBGA.RCCA.dAFB.QBGBhABABAHBMEEBZCAAHFFAADFACDHAIEEAhACA.PEGBhAIA...aFHDNICB......hCBA......hCCA...,2,-17,-16,1
baQYdRKZECFIJLHTcPSUDeGMWfBAXVgON,XAAAOAAA..aADDdADAZAEBEAFA.FAHDLAHBHCDC.TDBAhBAASDBB.eDGFhAAAGDFAMDIBBBBDhBDAAEEBgFABbGBA.YFFFCBGAIHHAhBGAcGCD....hABA...,2,-14,-9,5
NIDQWGOJRSUEVBAfZTdYFLbcCaHPMKeXg,ZAAAdAAALADACADBHAEBKAGAeAGH...XCAAICAAQDDAhACAGCGARDDBEGAAAAEATDGAhAIA..bGDAaFCBhBAAMCCBDBIBOFEE.SFHHhBCABHHA......hCDA...,1,-9,-12,3
HGXDALQOMFJZIRTNaBKVPgYSWbEfdcUCe,LAAAMAAAZABERAEFaADD.BAFAKAGC.....VBGB..gBGAhBAASCAAECCBhCAAdDDACDHA.HFAAGEDAhCDAAAHAQEGBFFFA.TFEAYFHBfGHAhABA...hDAA...,1,-9,-21,12
CPVAGJaScZNDEdBFUTIeYWMRbOXLQfgKH,aAAAZAAAEADEBADA..FAFAUAFA..eAHHMAIBRCAA..OCEBhABALCCBQDFDhACAKCEDHDADCFCAACFAGDGA.hCAASEFDDDIBdGFAIHHAbGDC...hADA......hBAA...,2,-20,-10,10
UQIdaKGeObFMJWgDXNfALHYVTEBRSCcPZ,HAAATAAARADFCAFB.ZAGBQACC.aAEAeCAB.FCCHMAHBhAAAJDFF.DAIB..XFCAhAAAABFBLDDA.EDHFhCAASCHHPECBdFFAOFGDbFDD.NIBB.fHGFhCEA..hCGA...,2,-14,-10,4
TgNePCLAFWSbJdMYVKRUGfOQEBIZaXDcH,SAAAdAAAMADAKAGARACFGAEA.QAGAEBDAZCCADCFAHDFBhAAA.TEAAeCHFLFFAhACAADEBFDHF.bDBCYGAGhABA.fGHABGDAIHHAhAIA......hBAA...,1,7,-26,33
cSVTAIOLbJBZgUGWYQDPHKeNFXdaMCfRE,LAAABAAAZACAGAGAQAEAHCCAeAHBFDABdECDMCAA.RCDBECGFhABASDGD.AAGBOEHDhAAAbEAAUFFADFFBKGBAhACA.aEHDCFAA..fGGE...hAEA......hAIA...,1,-1,-17,16
QCLGeJdUYcEWbHSDKVPNaXTOAgFfIBRZM,FAAABAAARACFZAEBMACA.LAGBGAGAdEAAUBCA..EDFFHBEDKECA.hAEAVEFA..aDHDTGBAhAAAAAIB..IGFAhBAAeEED...JGBE......hBGA......hCAA...,2,-21,-16,5
ODITBdgRZceKLSGYFEPWCbAUaMHfJVXNQ,aAAAHAAA.VAEAQADADACA.BAFARCCAeAHHLAHBGDFAEBBBhADACDHA.ABHBMCGB.XDCAhBAAOEEHdHABZEGBSFDAhCAAFFHD.WFHH....hCDA......hDAA...,2,-14,-7,7
VCLHEcKDTGQgFOfYNMUSZJWXAdRaBbPeI,RAAAaAAABADB..eACHCAFAHAGBEAEA..DAHBGCCAFBFD.OCFBhAAA..fCHAhAEAMDIBZEFBXFAAhABAAAIBdDDAbFEA.IHHALECD......hBAA......hBBA...,1,-12,-23,11
agAUOWXMVRBLDKfPcZbeENCYJHQFIGdTS,OAAAMAAARACA.LAEAKAFC...fBBEZBEEEBBB.CBDDHCEAhAFAQDDBGEEBdDGAhAIAaAHDABIBUGEA..hBAAXGAADDIB.PHEA....hAGA......hBAA...,1,-14,-23,9
KGOVEfNPJQWRFZXHUgCbLSDcYMdaITBeA,GAAAEAAA...fADAPACCQAFCRAEFZAGBHDDACAHBLCCBhAAADBIBMDABaEGDTCGAhCAAAAAB.OCEB.hACAVFEAWEHH.XGAA....hADA......hAGA...,2,-10,-9,1
IZRAVKaBYMGCESFXHUPQNdbgWDLcOfeTJ,aAAAMAAAGACA..EADAFAEAHAFAUCFAQBBCdBHA.bCEAhAHADBBBLECAOEBBeEDFhAHATFGAZFFAACIBBDDDhAIASEGAXGECNIAB......hBAA......hCAA...,2,-10,-4,6
KMcEPSZTNCAUeILbGJQXDRdFVgfOBaYHW,eAAALAAAGADAQAEARAFAdCHA.FAGEVDBBOCAA.aCECHEFAhAAA.MFABECHBZDDAhABATFDAAEAAUFFB..hACAIGHAXEAA.DFIBBHDDWHEG..hAEA......hCIA...,1,2,-8,10
CeGdbHYaONFDLEUgPSVcMIWKQXJBTARZf,RAAAZAAAeADEdAEAHAGB.aCAAFAGA.EBDFUDDA..SCCDhAAAMDABKDGD.QCFAhABABEBAAAIBGGABbEDDOCHFhCAALFHBPFFCIGGAWFCD....hABA......hACA...,1,1,-12,13
dABLbITJNVHSeFMEUDYZCGXcQfgRPOaWK,LAAATAAA.VAEAHACB.eAEAFBHDUCAAZBFEGDEB.QEAAhAAARCDBaDFD.dFFDhACAAAHABEHAIHBASFDDhABAEEDBCGHAfHDBOHECKGGA...hAEA......hAFA...,2,-20,9,29
GMRFTWHQeZJIXEUSYVdKCgAaOfcBDLNbP,aAAAOAAABADALAEA...bBBCGAEA.RAGBTCCAhADAHCDCeAHHZEEAXDGAhAGAEDBFSDGA.hAIAdFADCBBDAGDADEEBMIBAQFFAIHHA.YGDGhBAAKFHBfGCAhAFA..,2,-24,7,31
WRPQbCTDJIAFVOXcHeBNZEgYdUMSLGfKa,OAAAHAAAeACEZADB.EAFEdAGAUCCALBFDGCFAKBBDRFCA...QDBDhAIACAHBDCIBACFBFFHBXCGAhBAABHCD.NEEA..hAAA..MFFA.aGGA......hBDA......hBIA...,2,-18,-12,6
DCWMbQVfGTUOYaLBJREPFIgAedNZKcHSX,eAAAZAAAHAEADAEA.MAIBQAGAGCAAOCCELBDBBCGAEBFBFCCBhAAAAACAdEEA..KDFDXGAAhABACDHA.bEFDTFGAhABA.aGFHPEHDIHDA...hAEA......hAGA...,2,-13,-7,6
DaKQPYUEMAJNBTgefFcRSIHOWVbXLGCZd,BAAAeAAAFADDRACAHAFB.OAHFVAFALCCAZCAA..aCEHQDFAhAAAUEGA.ACIBTFAAhABAfFAASEEDhAFAIFDAXGGAdFFCKHAAEHDEMIAA.hAAA......hACA...,2,-12,-5,7
ANfIZLdTHJGXaSKQYUBFOMPgcCeWRVEDb,..IAAAdAAAHADAGACAaAFAQCBABAEAMAGB..gBGAhACAeAHBRCABDCFBACFBZDDFhADATDGASDGAhAIA.KFFCFEDDOFHDCFFAEFHFfHCBhACA......hAEA...,2,-18,1,19
fUcgSAXWHBVJOYIERCFTaedMDbZLQNKGP,HAAABAAAOACAEADERAFFFBHD..eAFAdCADMCEBZBCALCGB.hAAAQDBAGEGAfDCAhACAUEDASEHHhAAAAAHAXFACVGAAIGEAaGEEDIDA.KDFD.hAGA......hBDA...,1,2,-8,10
KBSJFVfCHAWXGDaRNbYIZeMLUOEdgPTQc,GAAARAAA..bADBZADA.eAFELAGBECDAdCHA..TDCAhAAAQDEABBFAFDHDCDCDHFGBhAAAAAIBDEFBaEAC.IGEAhACAMEGBOFBB.PFDDSHDGhAEAfHGF...hAIA...,1,-4,-13,9
CQWJNUVdHeDOKfMSAIBLPFbYRZTaXEcgG,LAAAFAAARACFZAEB.aADD..EAGAGAFA.QCAAJBHB.hAEAVDDBHDFBDAIBfECAhBAAAAFBBDHA..bFGBhABATGCA.cFECCHAAWHDA..NEIA..hACA......hAHA...,1,-15,-16,1
XFgINQYbZULDJMAEKCGWHeTScRfPaOBVd,EAAAGAAAHACAeADASAEERAGB.aAGDBCDA.dCFAFCCHgDCGhAAAQDFAZEGBLEHBhAAAMDAB.AAIBCEDA.hACAcFCCOFDEXFFCNIAB....hCAA......hCBA...,2,-10,-6,4
LaOfNDAZFdTHEQMBJSXGUYRcegPWIbVCK,dAAAHAAAEADAMACABAFASAEAGAGARCAA.eAGH...gCCAhAAAICEACDFAaBHDODHDhACADCFBACCAZEEA.TGEAhAIAQFFC.......hCAA......hDAA...,2,-25,-9,16
UeTPNZWAFJbRgIGfBMQLDYaOKdHcXEVSC,FAAARAAAGADAMADALAHBDAFA..aAGEdBDAHCFAEBFA..CCCC.eCCBhAAA.TDAAZDEBAEEBJEHBhBAAIEHABFBAOHCAhBFAXFBD.SEFD.NICBbGFAhABA......hADA...,2,-25,-6,19
ZgAJOQPDFSIKcfVbTMCWEGNHYdeBLRXaU,QAAAFAAAKADA...VACAMAFAEAFEHBEC.eBHHRCDAaAHDZCCAhADAADHA.OEEB.SFGAhBAAfEFAbGFChBHATGCA.GEGA.....hCAA......hCBA...,1,-8,-18,10
XZNGcFDWAKLabdJRTBYMHVfEOSCPIQgUe,aAAAdAAARADABADAHAGB.ECBACAFA....QBGAeCEFZDAAGEGAhACADBBBAAHA.LFFDhADA.bGAATCCA.hAEAMCFB.ODAB.SDGDhADA.gECAhAFA.XFGA.,2,-29,8,37
GgKCHYRJZaFSQBIDTPefWAbUdOVLcMEXN,dAAALAAAEADAGAFACAEAHAFBRCAA.ZCAA.FAHFQECABCED.TFFAhACAeDFAACCA.OEABhABAMAIB..NEIAKFBDaEECDEIBhACA..fCEEbFGD....hADA......hAHA...,1,-9,-12,3
QgSGUbFPdXMIRaZYWfLJKEVADBTONHCec,TAAAHAAAeACE.QAFCGACAbAEAdAHA.MCCBRCEA.ZDCBfCAEhAAALDHBEEEAhAAAAAEAOCHDCEGASGDAhCAAFEEHXFCDaGGC.YFHF.KGAB.hCDABGFA....hACA...,2,-5,14,19
RVUFMGJHSDbXNgOYBEIQLWCZPAdefTaKc,eAAAaAAA.RADA.FADAGAGAHAFBDAIB..bCCA..XBBAhAHA.OCDDEEAALFFAhAAAZDFAADHAdFFATGAAhABAKHBA.cGDA........hAEA......hAGA...,1,-12,-22,10
OcYMQHKUbWfgNAeVXEPGDZBIdJRLTSaCF,eAAAEAAAGACAZADBdAGARAEALAHB..aBFBOCBBMAIBHDBAhAAAKCFBUEFB..bDFDhABAfEDAABDB.hCAAXFAABDHDIHFASFHHCFEC.FHCEhAAA......hAEA...,2,-14,-8,6
gCXcIDJLRNKfYOVHGFbSBMdZePQWUaAET,EAAATAAA..XACADACARADA..KAGCOAFAHCCAGCFAhAAAFBFBBBHAZFCAeCCB.QDAChAAAaBHDAEEBCEHAIGHAhCAALDGB.fEEAYHCA.bGFA.hCCAMIDA....hADA...,2,-20,-2,18
VOGfUQINBSYMJLWEXeabRZPHCcKFATgDd,TAAAdAAAGADA.QAFABACBMAEALBHBEAHF.eCBFhACARBDAHDDCKDFBAADBDCCBODDHhAFAfCHAUFFBSGHHhAIAYEBFXEGAaHDC.ZGDA.CGGB.hAAA......hBEA...,2,-11,3,14
PRfaQbLZGTCcEgVNMDYIOHKSUeFBAXJdW,dAAARAAAQADCZABBGADA.CAFA.EAFE...VCEAMAHB.DAIBOAHDhAAAHCFBKEHBeCCBADDB.hAFAXEEC.PEHBhABAbFDB.LHAATGGA.NIEB....hBAA......hBDA...,2,-21,10,31
AdJaPFVQBCMKENWYOeRHgSIcfDGXbZULT,aAAAFAAAQADABADA.KAFAEAFA.....NAIA.OAHDhADAHCCASBFAhADAfCCAGCFAZDFBTFAAhAFAADEAdFHAPEHBMEEBeFFDRECA.IHAAhAHADBBB......hBAA...,1,-2,-17,15
bNdUORaWTXJVGBACZMEcLFSgPQHeDIKYf,ZAAAEAAALADASACEQBGAHAEBeAGBKBCD...bCEDdDDAhABA.REGBaAHF.TFEAhCAAXEAA.GEGAhAAAACCBMIDAFDDB.DGDA.fHAB.hCBA......hDAA...,2,-9,-2,7
VHLcIgafREbTYOFQMUKdBGDPZJASXWeNC,XAAAeAAACADA.HADALAFA..gAGBRCCAECFE.bCDAhAAATEEA.FDHDMDABhABAdGAAGGEBZDCAADHASEGAhADA.VFCAaHCC.OFAD.hAAAQGGA.hABABHEA.,1,4,-6,10
BXLbfIVFGSRPZUTecgOCDMAHEaKJQYdNW,HAAAEAAAKACAQADC.dAFABAEBbAGD.fAGA.hAAAFBHDRCAAZDEAUCCAeEHHhACAOCFBMFDA.AAIBaGGHhCAANEGALEHB.GGAB....hAAA......hAGA...,1,7,-24,31
JbHNEDWZPMKTBQVacdgGLYfReSUFIAOCX,XAAAHAAAEADEZAFBKADA.QCAB.aAHDdAFA.GBGAhAAALCEDRCDBeDABFDCDADHACAHBbFDAhABADEGAMFAB.TFGAhAAABDCD...cGFCfFHASHBAhACA....hAFA...,2,-14,0,14
dcPMKXDUCOeQJHNfgRaVTbGBIZLASFYEW,FAAAEAAAdADAMADA..DAFAOAFE..eAHFHBCA..fBFAhAAARCEAaCHD.bCBCGEBAhAIA.ZEEAACIBSDEAhBCAcGEA.XEFACHHA.QFBAhBDA.gGGAhBFA,2,-21,-16,5
NObIPAMWKcaJgEGHZCFTURfLdBDVXeYSQ,MAAAKAAA..aACAEADAHAEBZAFB.FAGARBBBdBHADBDB...eBEFQCGAhAAAOEFA..IFFAhAIAACCBJDEFGGBB.hBAATGGALHCAXEGCSGHB.hBGA......hCAA...,1,-11,-15,4
FRAgGWJUfKEVHSBcLDPYdIMXNaCebQTOZ,GAAAUAAAEADAHADABAFALAGB.DAIBdAHAMCDBaCBEeCEBhADAbCED...QDGAhBAAZEGBAAABJFAAKGEBSEEDhBCA.PFCB.XGFA.hACA......hADA...,2,-11,-10,1
bgQMZaXdfBYFAcWLJRDOeHISGVCKTUPNE,LAAARAAAeADEHAGBGADAKBDA.UAGA.ECAAbCCC..MDDBaDEEdEHAhAAABAFD.ADHAJEFAOFFBhABA.SGAAhAGACFFDTGDA.NIAB..........hABA......hACA...,2,-27,1,28
NEfJebKRATIBDVaYZXMQcFSGULdWHPOgC,TAAADAAA..aABEZACB.MAFAQAEAFBEAGBGAdAHAHCCAhAEAOCABCDFAEDHB.eECBhBAARDEBABIBBECA.XGEAhAAASEED.LFFB.gGBDhBGANEIA.fFHEhBHA,2,-22,-5,17
dXDQTfNLecBJaWgKUZSHCFPEYOAMRVbIG,RAAAVAAAGADA.dAFBQADC..TCFALAFBeCCBhAAABAHAaAHD.KCHBZDAFHDDAhAAAFDHDEEFBAEHBbFCADGHBfGGAhAHA.JHCAgGBA.hCAA......hCFA...,1,-2,-11,9
gHVLCQXZIUYbeFWRaJcOMSdPKAEGBDNfT,EAAAGAAADADA...TADAHAECLAHB.QBCChAAAZAFBIBHAbCEDeDGBhCAARDCAaDAHODGDdEDCAEIBfGGEhCBACFCDXGEAFHCA.......hAAA......hACA...,1,10,-23,33
XFaUCEYcGgfAHPQWOMTINdbSZeLDVKJRB,HAAAQAAAMACA..TAFAdADAZAEBeAHHLAHBKBDA.RDBAFBGBhAAAaCCCEDEAGEFA.ADBAOEHFhBCAbEFADGEABGHDhAAACFEC...YHAA.fHEBhAHAIHEA.....hBDA...,1,9,-12,21
HJZWKQecSVMGbANTDPfXLBOEYRUFdIagC,TAAADAAA..XABALACBBAEAEAEARAGBdAGA...aBHDHCEBhAAAZCCA.QEAAhAEA.eDHFSDFHhAEAGGCBAAIBfECA.OEEHhAIA.FFHBCECA.KGBDMFIBhCAAPHEC.,1,13,-34,47
BadfVbJLZXKDPTMENgQASRWFYGcOUHeIC,RAAAFAAAGADAOACDHAFA.eCCBBAEAdCHA..VAGBLDABhAAAZCDBDDGBMDGB.EFDAQEAAhAEAAAHASFGHhABA...YHDAIEHA.aFDE.bGAChAGA.KGGA...NIDB.hAIAWFHH.,1,-4,-17,13
CHgYPbcKIfFEOdMeVJZGDWNRALSXaQUTB,LAAAaAAA.TAEAHACB..PAEAKAGCFBHDEAHF..dCAAeBBDhBAAZCCAGDFADCFBRDFFACIBQEBBhBEACECA.hABAbEDDfFHAMEIBWFGHXGCA.hCAA......hCGA...,2,-14,1,15
NYLKGUQeRAOFJWdVBaEgMTDIbPZSfCcHX,FAAAdAAAaADAEADA...MAGBDAGA....IBFAZBDFCAHAHCAC.hADAXCGDLBHBGFCBhACAeCCBACEBOFFAhAHAVEEATGDASGHHfGHANICB..hBAA......hCAA...,2,-31,0,31
QPHFZUOTYbWcXBICSMRKEfLVegANadGJD,dAAAGAAAQADAHADAZAGBOAFCTDCA....bABDXDGAhAAACCFARCGF.EEFBLEDBhADAeDADABIBaFCCDEIBFFFBhAHAYFGBBGHDMIAAfGAE...hAIA......hBAA...,2,-11,12,23
KYaHUXAQJBITGRVCebcESdOgWNFDMZLfP,QAAABAAAGACARACA.eAEAEAFE.dBHAOAHD..NCAAMCBBhAAAZCDBLDAA.KCFAhAAAHCEBAEGATFEAbEGDSGCAhACAFEHDDHAA........hAEA......hAFA...,1,-6,-16,10
JSGaVcAZYDWQCTBFIHMUbLOgePfNdKERX,ZAAADAAAQACABADBHAEBMAHBLAFA.eBBB..fCAAhABAdCFARDDBSCHBhAGAaCCCAAGB.CEBDFEHHUDGBbGFChAHAOEEB.gGGA.NIAB..hBAA......hBEA...,2,-16,-11,5
VFSfCcUZPJTYeLBHWGgQRdADXbMaKOENI,XAAAaAAA.KADAEADA...VAFASAFBCBBD.ZAGBTCDAhADAeCDBHDAAGDFAhAIAREGBAAAAbFCBMBIB.OCFHhADAFCHDfFHA.....hCAA......hCBA...,2,-14,-6,8
HDeTXRdCPZaLJBObMEAGYVfKIQSFcUNWg,GAAAVAAA.KADAQADCFAFA.UAFA..gBGAhAAAHDDAeBHHRCDBdEGAZFDAaEHDhAAALFCAOHBAEDCBAFFAIHHAhAIASDAD.WEHH...DIAAhACACHFD......hADA...,2,-17,4,21
JfSdFCTLDZKQGeNVgOARBaHMYXEWcPUIb,RAAAHAAAMADAEADE.....PAFAbAEA.SBGAdCCACCFALDHBhAAAZCAAGCEAeECAVGEAhABAACCAaDGAXECChAAA.cGFBIEGAfEHEDAIB.hCAA......hCEA...,2,-14,11,25
WKPfdgYBVFSHJTZLeAcaRXODCGIUbQENM,RAAADAAAGADAUADA.EAFA..MAGBKAHBdCGABAHA..FCCHHBBBZDAFAAAAhADAaCGD...CDEAQFBAhAHA..hBAAPEFBfEHAgGDDSFFBhBBA......hBDA...,1,-21,-34,13
bgPLQNBecASIGDaYHMFRUTVOCfXWJZEdK,GAAAaAAAHACBRADAUAGAOAEA..CCDD.XBEDZCFA..EEABbBGDhAIALEEA.QGEAhAAAeBBDABIBDEBBMIBAhACATEEA.fFHAdGHA.KGCA.hADANIDB......hAEA...,2,-9,1,10
bGPZSeFIRXEfNTcBDLWACJMadVUgOYHQK,MAAAdAAAUADA..OACEHAFAQCBDGAFAZBBAeAHBRCFAEEDA.hACATEEADEHBLFFBhAHAADDBaDHH...YFHBhAIAbFAAFGGA..........hBAA......hBCA...,1,-6,-10,4
ECBTNOaIVYDZMdXbAcgfPUSRQKLWJGeFH,...fAAASAAARADALAGBGACAHAEAEBCBBCAATCFAhAAAaCEDIEAA.hAAADAGAdEAAABIBPDHDhABAQEFAKEDAeFGBCEDDODHDYHCAZGCAMIAAhACA......hADA...,1,6,-3,9
AbdKZGQWNcaOSYXfJHLPIDTMVBegFURCE,dAAAGAAAQADA..cADAaAFESAHH.XCAAhACAHAGBLCDBhAAADCGBMDDBeDBHFDHBREEBAAFAZDEBhACAOGACfDHAIGHATGBA.hADABFHA.CGFA...hAIA...,1,-4,-8,4
WDBQMLPdGJIZKaSeTUNAcFROgXYbECfVH,RAAAXAAAEADE..CAFBHAGBBADAMAFALCCAGBDBZDFEaECAeBHHhAAA.UDAAAAAA.ODDBhABAbFGB...fEFAhADADGDA.dFHA.KGBANIAB.....hAIA......hBIA...,2,-16,-6,10
WTHFbKULBEdNOGSIcCQARJZYMfDXVPgea,RAAAZAAAMADADACA....XAEAVAGB..eBDFaAHB.HBEBKCCDLCFAhABAEDHFdEEDOFHDhAAAGECASGGDhABACEEAAEHAJFAB....fFGAWCCD.FGEDhAFA.BHHANIAB...hAIA...,1,-7,-13,6
FbQEdSgaMWCfVIZcATGYLDJBeOPURXKNH,GAAALAAABADAeADHOAEDRAFA.KAGAHCAB.QCFBhABAECDBdCGA.aCHDMCIBfDEEhACAZFEAAAABDDABPFABhAFAXGAAFFGASGGDCGDD..IHFAhACA...hAGA...,2,-19,-3,16
EHKCTIGQdOZfbUPaFgJSAXYBMVLWRcDNe,BAAAMAAALAEARACADAFA.EBBAHBEC.CAHAGCAAdCDAZBFEbDFAUDDAhAAA..FFAA.SFFAhAFAAACA.XGAChAGAVDGB..cGGCeGDGIHHAhAIA......hBAA...,2,-27,-8,19
bLNgIcAHKSXdFECTPfDQeVGMUBWJZYORa,HAAAXAAAEADECAFB....TADADAHBeBHHGAFAMCABBAHAhAAAZCCARECAbDAALFGBhAAA..gDGHhABAACEAdGCD.fEEA.QFAAhADA.UGGA.WHAAhAFA..,2,-15,9,24
FXJRTaLQZYCHOGWBPeSdIcfDVMgbNUEAK,XAAARAAALADBZACBHAFAGAEABCCCeAGBdCFD....fDHAhAAAMAIB..bDFDhAAAEEEAADEBFEBAaFAAQFGBhABAOEHFSHAADHAANIAB.KHEA...hAFA......hAHA...,1,-1,-11,10
HNJUSMaEAKVCFIOgcDXYGPRbQBdZWfTLe,CAAAOAAADACA.GADARADA.QAFAZAGB..TCBAHDBBUDGAhAFAMBIB.AAIBFFDD.hAAAgFFGXDECbEGDhAGABBBD.fHBBeFCBSFFFhBCA......hCAA...,2,-29,1,30
bLKAICGSYREJZFVdfWgOeUaBXcPTNDQMH,GAAARAAAEADE.ZADAdAFA....fAGBOAHBeCCBaCDAXCGAhAAATEEA.QDDChACAHEGBbGDCAAAASEAAhAEA.FEGB.WFFDBCEDNIABDGHBMCIBhAIA......hCAA...,1,4,-13,17
NSYKGAQIZRbXHVgCUdMaDEPFeLcWOBJfT,ZAAARAAAHADBCADB.dAFBMAFAEBGB...FBEDeCCBLBGBOCHDBCAAhABAJDAB....TEEAhAAASCCDGGEBABIBQEEChACA.bGCC...XGGAhCAA....hCGA...,2,-32,-4,28
AKJScFZXTdeQPYOBLMgRNGUfHDVCbWIaE,SAAAZAAAdAEAeAGBQADA.OAFCMAIBRCAAGCCAhAAAHCFBCDECICGAAACA.hABAKDABFEBDTEFABEHALHAAhAHANCIADFEB.bFFCEGHB.JHAA.PHEChABA.....hBEA...,1,10,-12,22
XdANBaVLCTDEFWPJMRKgbHQfYcUSIOZGe,aAAALAAA.TAEAEADAFAFD..JAHBRBGFKBBDHCAA..QCDChADAfCEEUEGBhAHAOCGHeFEBAAGABEADhABADGHBMIAAbFFA..SHFA...hAIA......hBAA...,2,-20,-9,11
JQIdCNgLfeWGZObXEDUBcRTMHaKPVSYAF,QAAAdAAACADALAFAeACAZABB..bAFAECEA..BCDARCGBHDCAhAGAaCEDKCGA..SEFHhAHAAAGAFDAAJEFBIEHAhAAAfFHA.........hADA......hCAA...,2,-24,-18,6
FKPBAVXZMdecITYfbURHLDJCaEgNGOSWQ,ZAAAeAAA..TAEA..bADAHAGBLAHBCCAAECCBGDFAhABASCCAQEAAhACAKCFDAAAAMEAAdEECIHEAhADAUEEBRFAAaEHBODHFFGHDBHBAXGAC.fHGFhAEA.DFDBhAGA...,1,8,-2,10
AfZeJdKbOGHNRLXPBgUTaFECDYMVIWQSc,eAAAdAAAOADAHADARAGFLAHBBCCAUDEAFBDB.DCIB..MBGB.hAAA.IFAAQEDAhACAAEGAZFCAbFFB.GCBAhBAAXGGAPFHD.aHBA.CHEA....hABA......hAFA...,2,-24,5,29
IPdcFDgZfOYLTMHVUeCASbNJXGaKRWBQE,SAAAJAAAGADA.RACFBAEB..EAFAdAGADAIBZCDB..OBGDhADATDGAHDEB.eCCBhAFAAAAAXFDAaDHDQGCAhBAAIGBAFGGAfGGA.MAIBhBGA.....hCAA...,2,-22,-11,11
MKcUCZTJNfPQGdYLOHSAWVbeaFXRBgDIE,VAAAeAAAFADD.RAFA.DADA..ECCBMAGBKCEA.CAHA.ZCGB..TBDAhAAAJEEB.....hAAAfCHAQFAAhABAdDDDOFHDHEFAAFBAaGGBBGHA.gFBAhAHA....hBFA...,2,-26,-16,10
UVfLOGQHaBZeCbdgJIRXMKTYDEcNFSAWP,UAAALAAAGADAHADBZAFAeAFAdCGA.ICAARDAA..MDFBhADATCFAEEHF.FCCHAAGA.PDHDhABAOGDC.BHHAhAIAbEEDJFAA...KGADDIDASGGBhACA.fHCBhAFA...,2,-18,-3,15
dTYCOAVGScaUFZHBWfDRLbJXeENQKIgMP,GAAAaAAAZACB.HADABAEADAFALAGBJAHB..ECDBQCEAhAIAKCFBMDAB.dECA.TEGAhBAAODHDABBB.SEFDhAAAFEEH.RFCBeHEAgGBG.CGGD..hACA......hADA...,1,-8,-13,5
VCIBAWgacfLOKRYNDJEQUHZPXbTeFSdMG,aAAALAAA.RADFDAFAEADAHAFAZBFB.XBBCeAHH..dCAAGCDAhADACCCDBDHAAAHAgCFGhBAA.ODHDhCAAKEEDJFCBQFFCUFGA.PHCC.hABA......hACA...,1,9,-26,35
WeKaRTbCcfZXBJELGUHgQSPAFNdYOIMVD,dAAAOAAAMADADAEAKAGA..RAFA...TBDACBBDZBDFBCFD.LCHBhAIAHCACQCFAhACAACDB.FEEBIFFAhBAAeDHHbFBB.XGFCEGEB....hAIA......hBAA...,1,-11,-40,29
OGeZXVEdRBPALYSUFQHMcJbgIafTWNCKD,LAAASAAAQAEAHACBMAEAJAHB..IBFA.hABAaAHDTCAA.CCCBOCEBhACAeDEAZEBAEDFFRFFAAAAAhBEAFDHD...bEAAfHBBKFGDXGBChAEABDHA.....hAHA...,2,-13,-5,8
AXNVMbceGPQLORIDJZTSKgaFdYEBHUCWf,XAAAMAAA..eACAGADALAGBRAFADCHBZDAATBEA.KBBDhAIAaDGHdDCAEFAAHEDBCFDAAAAA.hADAbFFB..QGGAhAFAOCHDSGBB..gGAAhAGABHHA.WFEH.hBAA...,1,-2,-5,3
VWBSeQdgJAcNHGaEOULDIYCZfXKbFRMTP,HAAAEAAALADADACACAEAZAFBKAHB..RCCB.MBCB..TDGA.hAAA.PCFBBAHAeECDhAAAdDDAAAEAGDGAaEFHOFHDhCAAIGCA.fHAB..hAHA......hCAA...,1,-19,-26,7
QSIZGWRbCPAgMfKXdODTLHeFaBYJVEUNc,MAAAXAAAdAEADAGAHADA.FAGABBBA..VCEAEBGA..UDBAhBAAQDAAZDEAGFDBhBBARDCBbEGDACIB..KGBALFFDhAAA.eFABaGHD.NCIASHCAhABACHDA......hADA...,2,-23,9,32
bQeXLcSMZfWNJCRUDIGgBPTVAKYdOHFaE,dAAAHAAAEADAeACELAGBMAFAZBDE..fBEAJBHBRDEB.DAIBhACAGGEBBCBATDCAhADAACCBOEDBFDHDaHBCbEFD.hAAA....QGBA.SFDHhBAA...hBHA...,1,-5,-10,5
CSAKeEcYNOQaTZHDbMRfGUdWJLXgBVIPF,EAAA..NAAA.aACDHAFADAEA.RBBAGCEA.dCHALAHBBDDC.hABAIBEACEAAAAHA.eBFHhAAAOEBDZCBAbEFAMFHBhACAUGEAXGDC..PHBASGFHhADAKGHD.....hBCA...,2,-14,-6,8
GPRXYOZeDEKWNUdLcSVHCfIBgAJMQTFab,MAAATAAAFADD.GAFARACF..OAEAeAHBKBBBUBFB.dDEDLDDBhAFASCADHFBBhAIACDHABECAADFBaEHBbFFDXFFAhAAA.DAIBEHDA....WFHH.hBAA......hBBA...,1,-5,-20,15
aQeUWTFJOMNdVXcDfbGSZIBEYACPRHLgK,RAAAHAAALADBaACAeAEHUAFA..FAGAMAIBdCCA....XBFDhAAAfDCEGEEAhCAAZDGFEEEAACHACDHAKGHB..hDAATFBA.OFGH.....hDBA......hDCA...,2,-17,-12,5
FcQMBRUAPXYCaHKNSJfGTDdgOVWbIZLEe,XAAAaAAAHACBKAEA..SADAGAGAdDEAOAFD.bBGDhAAAZEAA.EEGBFCDBMBBBhAEARDABAADACAHBfGAAhAGA.TGDADDFBgFGAIHHA.eEEDhABA......hCAA...,2,-19,4,23
WQLGEUFJABVTSgHecdabMOKfYRCIPNXZD,TAAAHAAAeACE.aAFAMACA.KAFARBEACCCA....IBDAhAAAXCGAZBFEQEDAhAAAECCBFDFDAAHABDHASEHDhAIAdFHAbEDDfGFA....hBIA......hCAA...,2,-14,-14,0
JXeWdfGIEcQALbaUYKBHMZVCPFORNDSgT,aAAAKAAAHACBZACB.CAEA.OAECRAFF..SAHBJBHB.eCABhAAAdCEAGDFA.EEDBhAGAACHBbDECBBBD.MEIBhAHAFEHDDEAB.TGFAfGCAQFDBhACA......hAEA...,2,-21,-13,8
dBZATfWMIPOLXCRcFVQSDHGNaUJegEKbY,TAAAMAAA..OACELACBRAFF.FAEAQCCAHAGBaBEHeDFFhAAAEBHFKBBDdEHA.AAIBIFCAhCAACDFDSDHHDEEB.hCCAGFABJHFA.bFFC.BHAA...WHEAhAFA.....hCFA...,2,-7,-6,1
VGXfZbdeMDLaFgNEJBRATYcWKSIUHQCPO,TAAA..cAAASACB.HAEAQADAOAHDGCCBhAAAZAFBeAHFMDHBhAEAaCABFCDHEEFBRGAAACIBKEFACGEA.hAGAXDADfGHAdEHADFEB.gFBAhACA.BGGD.hAHA...,2,-2,-1,1
PWLgcMdSaQFHJEGKOBDCTUReAVZfNXbIY,ZAAAXAAA..bADB..IADA..PAFCLAFAhAAAMCABaCDAHCEBECGAGDDAhABABCCDTCGAhABARFGBAAGAfGCAYEHBgGCASGEH.hCAAFGFB.....hCBA...,1,-1,-15,14
KZBEaPACGWdFLJeQNMgTUYRVfScHIXObD,GAAAdAAALADAeADAMAHBUCCARAGF..SBFHHDFAOEABhACAbCDB.ZFCABDHA.EEABhAAAACIBFGGAQFEAhACA.gGGB......hADA......hAEA...,1,-8,-20,12
cMZHOWURaFYeESGNPbLITdBKVXQDJgAfC,CAAAZAAAHACAOACARAFF.FAFDEBHF..GBGA..bCABTCDAhABAdDDAKDHBQFEAhAHADEABAAHA.MCCBaECBeEGBhAAASEHH.NIABIHHAXFDA...hACA......hAEA...,2,-14,-5,9
JRWHBAQPZYOdfgVTLbEDFUeXMGNacCISK,ZAAAdAAA..VADATAEALAGBEAGE.FCBDeCAB.GCCB.hACAaCGACDDAKDFDRDFAHFFCAAIBQEGAhADAOEAH..hBAA.bGCADIAA.MIFAIHHA...hABA......hACA...,1,4,-20,24
VISKBNMeWXGHdTLYPOcRUJfCFEAbQZDga,ZAAAaAAA.SACEBADA..eAEHGAEAHAGBdAGBTDAALCHBhABAOCCFRDDBUGDBCBBDAAGBQDGBhADADCCBIGGAhBHAMEEB.XFFC.....hCAA......hCBA...,2,-14,-6,8
JfLcNFCaRPSWObUGTKXBIQdAYEHZDgVeM,HAAAZAAADACAeACE.MAFALAFAFBFDRCCB.SBDH.OCCHhABAGCGA.TFEAhAAABCGAdEEAEGHFJHBAfDHAhAGA.CFCAaFHD.....PHAAhAHA...WEFHhCAA..,1,-13,-23,10
BXTUEMGFAIJPSNZgWYDQVfadHLcRKCObe,JAAASAAAZADB.......gACHDAGAQBFAhADAaAEDHAGBRDEBOBHFhBAAeDDATEFAEDCBGEGAhBFAAAAAIGAA.PFHD.YHEAhAGAfGEEcGBD.hCAA...,2,-30,-2,28
aRKJegEUWdMfSIZFGQCANHTOBYLPcXbDV,HAAATAAABADB.LAFAXACBDCABRAEAKBHBeCCA.UCGAdCCDMCGBhAAA..SDEHhAAAZEEFGEGAAAGAOFGBhACAcFAA.aFHDEFDBfGDAFHACCHDD..hCCA......hCDA...,2,-24,6,30
ZGNbLDgQJIXPCSHaKVYMcUfROABFETWed,EAAAeAAAGACALAEAQAEAJBCB..XBGASAGAhAAAHDEAaCBHKECAMCHBfEHAhAAAACIBTEDAZFAAbGDAhAEADFGB..IHAACHDA.....hABA......hAFA...,1,5,-16,21
aBCWIOdDFAKcXbfVJLNUYTMRQGHZEgPeS,XAAAVAAA.LADAUADA..MAGBRAGFHCDAZBGB.EDCBeDDBhAAAaCHDBEAA.CEFAOFAEhAAAdFBAAAHAKEHB.bFEDfFEEhABA.YHFGTGGA...hBFA......hCAA...,1,0,-21,21
QGFBTfIRdEbMcJHYOVaUXAgNZDLCSWPKe,ZAAALAAASACEKAEAeAGHGAEABCAA..TAGARCCAdDHAEEAAhABAMCCB.HDDB.OCHDhABAaEEAAAIBDFCACDGCQFGChAGAFFFH..bGAA......hACA......hAEA...,1,1,-21,22
dCJgBNRXeUSKDMaFTfbOLWcPGHAVZYQIE,ZAAAQAAAEADE.dADACAFBBAHARAFA.UCAADCFBaCGD..FCDDTDBAhAAA..bCFALDDBhAFA.PEHDhAGAHEFAACFA.IGHAgFFDeFEBMIAAhAIAOHAA....hABA...,2,-26,-4,22
aKCIEFgGMNZVXWYAOBRTcSbQLPfeJUdDH,RAAATAAA..bADBLACB.eAEAdAGAHCCBaAHD.CBFCECHFhAAAGCEAZEFA.XDGBhAAAAAIBBFDAQGEAhABAfEAADECBFGHH.MEDB.VGFA.OHBChAEA.....hCAA...,2,-12,14,26
MbESeRPOUdQDYaTKVHcFZgIXNGAJWfBLC,JAAABAAALADBMACA..EAFARAFA..OCCHdBCAQBGAhAAA.aBEHTCGAHDECZFCAhAIAXEEAAEIBCGGA.eEHFhAFADGIB.KFCA.FGABNICB.......hCAA......hCBA...,2,-20,-14,6
QGcMILdHJOTNPBaAXfeWRKDCbgVFSUZYE,eAAARAAACADB...VADASAEHZAGB..ECCBGAGA.MCCBhAAAdEEAHGAAODDATGFAhAAABEEDAAGBfEHAhABADDIBFEGH..........hAGA......hBIA...,1,-14,-33,19
FfSPEdgWLMNZADRBCGHIKebcUJOVXaQTY,RAAAGAAAHADBeAFAUADAOAFC..aBGEQCFATDAAFDDHhAAASDBHEDGA.hABAdDDALFFAZFEBAAABCCHAKEHBhACAbFACJHFA.XGDDfGGA.PHAAhAHA....hAIA...,1,14,-13,27
XWgReNQJdOIEbMTPFZLfCKYBcHADaUGSV,aAAAGAAA.SADAXACD.RAFFeAHHQAEAdCDA.EAGAbDFAhAAAMBBB..TFDAhACAZCEELEAAKEADBFFBhADAHEFAAFHBDGIBWBHHJHAA.OFEB.FGHB.hAEA......hAHA...,1,7,0,7
WMIHZYRCPJKOLUbQgdBfNAETVDXGScaFe,EAAATAAADADA..GAEBaACA..FAFAeBCBMAIBHCEA.RDBBCCHBKBDDhAAALEEAQCEAhBFAdGEABGGAACCBSCHDhCAAIHAAZEEA.PGDA.....hAAA......hAHA...,2,-12,-10,2
UfVagCBYSIWFNbHMZRAXEDJGKdLcPQOTe,EAAAGAAAdADALAFAQADA.eAFAVCBBaBGEBCGA..SCDDhAAAFDFHHEDBRGAAADABDDFAhACAKFHBOHECTEFAfFEEhADACGGD.IGAA.NDIA.hAGA......hBAA...,1,-9,-11,2
QXVYLAFZCUKOcGWMNRDIaebBHdfSEgPTJ,ZAAAKAAAGACAMACARAEA.DAEA..eAHHHAFCdCCDECAB...TCEAhAAAQDEA.XDGAhABALDHBAFHBCGCAOEBChACA.cEEDIHAAbGCCSGGDhAIAgGGA....hBEA...,2,-15,-8,7
NMECDFWAgXSOILUKYZHVPRQBGedbfcTJa,SAAALAAAKAEAHACBRAGFGCAAeAEAdBHA....bCCATCEAhAAA.aEAAEDGBFEEHhABAACABOECCIEHAZGAAhABAQFACfFGEcGEDMCIBDCCA.hAEA......hAFA...,2,-8,-2,6
TaLPHVBFDYMICNRUcEXZJdQWGbOfKAegS,eAAATAAALAEA.HBCAFACAMAFACBHARCEAUEEBEBEAZBGB.dCCAhAAAGGABODFHAAAAaFAGhAFABEDADDIB..IFHAhCAAXFGDQGCA.fGGEhCGAKHEA....hCIA...,1,1,-18,19
FKYdIALGgHQRSVOXZTUfNWbMPCcBJEDae,GAAAHAAARADFOAFAZADAUCDA....fBFAbAGB.MBIBhAAACDFBBDHAECABeCCBhACAKEADdFFAACHBLEEAhADA.QGDASHFATGGA..hDGA......hEAA...,2,-30,4,34
GgNIMdVeaOKcWSBfEJACTDUHRLFXYQPbZ,TAAAHAAARADFLAFB.FAHBQACCZCAAGDGAgAEBhAAAMEEBdFCA.eAHBaFFH.hAAAKCDA.SCGHhAGA.EEEBACIBDGIBXEGA.bGDA.IHHAhAIA...hACA...,1,5,-8,13
cKQMNOGHWTZRIdeFCUSVLAgYXafbBEJDP,XAAAaAAABADA.DADAKAFA....MAGBGCCAHBCBZBFERCGFeBEBhAAACBBDUDAALFBAhABA.AAHA.fDHAhADAEFFBPFHDQFEAOHBA.IHAAhAFA.dGGA.SHDGhAHA.,1,2,-24,26
gDFecXZNELaTJKbVCWdHUfYGQSOIRPBMA,FAAAeAAAZACBEADALAFA..aAFDTCEAKAHBCCCAHCFC.UECAhAAAGCGAQEFChABAOEBARFFBMEIBAAGADFIBNHAB.hAHAVGCA..fHGB...hBAA......hBEA...,2,-15,1,16
GDUHcgaCMbBQZfWVOJYSeIERPNLKFTAXd,GAAAHAAAaACAMADAQAFAZAEE..fBHAOAHFSCCAhAAAECDBRCFB.LDFBhAFATFCAAAABdEHADDIBgFCAhCAAbFEDBGGA.JHDEeDBHIHHA.hACA......hAIA...,2,-5,7,12
dbTFaRHYLcCPENVJOUBMIfWQASgeGXKZD,eAAAGAAAZADBdADAFAFDHAFALAHBCCEA..ECGAJDBBBDDD.MDIBhAAA..fDEAhAAAAAHAXDBDDDGBaEFAREGFPHBAhABAOFABIFFASFFDKGHD..hACA......hAFA...,2,-14,-14,0
MTCfeKVDYEWFJNRSdaABZPQUOcLbgXIHG,ZAAAQAAAOACALAGB..bACAXCCAHAGBGCDAhAAAMAIB.TDAA.hABAeDFGDBFBEEFAFFFARGAAaEHDhBGAAADABGHAPFEB.gGGG.fGCAhCAA..hCBA...,2,-22,8,30
ATJXLKgPIHdYURfCZNDOBebWVGEaFMQSc,TAAALAAA.KAEA..IADAHAGBdCAARAEFZAGBOCCABCADeDDAhABA..bCCDGEABhACAEDHFMEGBQEGAhAEAABIBXGAAgGABPFED.fFFEhAGADCCBaHGE.SGEDhAIA..,2,-14,13,27
cWYTgMIJHCeNdabDQREZFfGSKOUXPAVLB,LAAABAAA......cACATAEAMAEAHAGBeAHFhAAAaCAAbDCARBEFZCBB.GDFAhBCAODGBUGBAAAIBVEABhABA..YEEFgFGHCDHADDDB.EHGA.hACA......hAEA...,2,-11,1,12
NKCPcFRHOXQbTeLDEISJYAdGgUMZBaWfV,GAAAMAAAZABEaADA....VAFACAGAFBHDHCCAQCDAeCHFEDFFhAFASCGDACEA.hAIAdFDABFGD.fGHAhBAAKDCDRFFAXGAA......hAAA......hACA...,2,-17,-15,2
RZXTULEfOCMWeDYHKcVNSQPFAaIbJGgdB,aAAAJAAAGADABADAZAEB..UAGALAHB.EBBBCAFDeCCB.hADAHDABKBGDVDCBQDGAhADAAEGA..bFEARFDAfGHAhBAA.MIBADEIBYHBAhBAA.....hBIA...,2,-16,-10,6
OJTHaCZfNURMPdLGIYbFXVcSEQgAWeDBK,eAAAKAAAOACAHADAZAGB.UCDBRAFAdCCAGEEB..ICHAhAAAbFAA.FCFH...hAAAXECASCHHhABAEEHBADBABGHA.aHGCfFFAMCCB.LGAAhAGA...hAFA...,1,-7,-21,14
AWfQXYKPMGCISZgeEDJBULNcaTdOFbVRH,QAAAKAAAGACACAEAZACB.EAEABAGA.LCABaAGDdCEAFCHDRCEAHEEChAAAAAIB...XFCChACAMDGBSEDDhAAA.eFFDDAIBNDIATGBAOHCC.WHEEhAEA.....fGAAhAGA,2,-21,-10,11
CGHeNcOVgBdYTMRZXFKPLQaSDbJIAWEfU,EAAACAAAHACA..eACAOAEABAFAdBHAMAHBRCAAZCEBKCCA..LECBhAAAaCEA.DEGAbDACACAAUFGAhACAGEEA.NAIA..hAIA...gGDHYEHF....hCEA......hCHA...,2,-17,-11,6
PFKQaCTJBcUZSHgYeDEdfXGNMWLbAROIV,RAAAOAAA..IAEAFADDQAFA.CAHA.TAGABBBDZCFAhAFAHCCA.eCEEEDDBdEGAhBAAGDAAMFFBbDFAAGIB.hCAAKEED.aFGB.........hCIA......hDAA...,1,-6,-27,21
cINbAHCLfPOQFVadeRKGSEYUBDZWTgMJX,HAAALAAAOACAQAEAaAFD.RAGBGCAAEAHBBCCAZCCATCGAhAAAMDGB...XDEChAIAIEHAAECAfEHAhBFAFECDeEEBSGHBDFDBgFFDNIAB.hABA......hACA...,2,-6,-3,3
IdAZSWaEgKXVBHNUbTeRYGJQMFcCOLDfP,ZAAAaAAA.EADEKADABAFBHAFB..UCAAeAHBRAGF.GCCA.MBBBhADACCDALDFADDHB..hABAfEFAdFCAAEEBSFFAhACAXFAA.bFDD.TGGA..hAFAYFHB..hAIA...,2,-34,5,39
XSCFDbLKATBcGgEfeIOJRdMYPZWQUVNHa,TAAAGAAAEADA.eAFAOACA.RAFAdCCAMBIBZCDBQCDAhAAA.VEFAHCFCaCFEhACACDBCbFEAADABBDCD.fGAAhADAIGAA.PGCANEIA.FGHDDIAA.hAGA......hBAA...,2,-7,5,12
JgKfQCRcHWaVeUTdMGAZYIXDOSEFBLbPN,ZAAAXAAASACEBADALAFA..bAEDJCDAKAGAQCGChAAARCGFHECA.aDAAeEHHhABAdEEAGGABACCBDFGBEGAAhAGAFFHBNIAB.CGFA...WGCA.....hABA......hADA...,1,-1,-15,14
eOfRDgPdWFZMAXQTJEcaNVYLSGBIbHCUK,TAAAEAAA..aACD..VADALAEAGAGABBHAHCACKCBDeDEBhAAARCEADDDBdEGDZEEAAACAQGAAhAGAJFAA.cFDChAIASEGECGGA.fGAE.hBIAgGGA.hCAA...,1,3,-22,25
ANaXYgPSbEWMdTeJUFIDHROZGfVQcKCBL,aAAAXAAA....gACHSADAEAFAdAGA.eBHHhAAAFAHDHCDARCDAGDAAQDGAhAFACDCDAADA.PEFBhBAAbEFAMFEBTFCAIGGAOBBH.fGHAhCAAcGBD...hABA...,1,4,-16,20
fGZTSaeFAJBONKPUYQIdEcCDVLgMHWRbX,OAAAKAAAUACA..QADAEAEA.DAGALAHBHBFBRCCBXEFAhBAAZBFBaCDE.ABBBBBHAhBFA..PEEBhAAAdGGDCFEDMHBAbGFA..fHCB..hCAA......hCBA...,1,-12,-29,17
CfBQONAZIgPdcDUTHMKEFbJGVaLRWYSeX,ZAAA..gAAAdAEADAGAHBFBEADAFAFDGCAALAHBRDDB.SCCAhAAAeBHBCCCDQFGAhABAABHBIDAA.cDEBhABAMIBAKGFD..bEGB.aFFB...hACA......hADA...,2,-9,-5,4
RBSQdMYVcADNEKIGbCWJaPeFZOfgHXUTL,EAAAGAAA.CADA.aACDeAEHZADB...OAGBHAFATCGARCGF.hAAAQDEDdDCAMDABVEEBhACAAAHAKCBDIFCAhAAA.bFFAPHAAfHFB...hADA......hAHA...,1,2,-15,17
OKEBNQLGMeIUAadJVHDWSYbgRFPCXfcTZ,dAAAHAAASADA..bADBRAFFCAHBfAFAZABB.EAHBQDCAhAEAGCCAeCABhAAAACHAaDGDDCGB..gFDAhBAAXEFAOFDDBFHAMIDAIHHAhACA......hAIA...,2,-17,-7,10
gTQaZBKMdRbHPCeVDcSNWJfXFOUEIAYGL,GAAATAAA.ZADAMACARBGFHCDB..eAEADAEASDCDhAAAJAHB.FEGHEBDBAAHA.LCFBhAAAaFDEBGHAbEGD.CCCDVFDBhCAANIBB..........hDAA......hDBA...,2,-13,-12,1
YJARWEbCGcgBVeLZOIdafXDQFNMHKPSTU,EAAAGAAABACAeADAZADB.dAHA..aAFDDBGBFAHBHCDB.SDADhAAATDEA.UEGAACCARDGF.hAAAbFCACFBA....VGDAhBFALHBA.IHHA...hCAA......hCBA...,2,-26,2,28
FAXMbZKIOdcERgPWGHCJeDUNfVBTYQSaL,MAAAZAAAOACAdAEARAGB.......gAFAGBBAHDEAhAGAeAHHDDIBUCCBfEDEhAIATDFA.QFGChBAAaDHDAFDAKFFD.EGCBCGAA.NEBA.BGHA.SHGGhABA....hAGA...,1,0,-21,21
IHMdRZBCAQPUgcDWOeJfKaESbFVYGLNXT,QAAAUAAADADA.eACAKAFA...EAFAFBDBGBGALAHBTCDAhAAAHCEBRDAAZEFFACGA.PFCAhADA..gEGAhBAAOEHDaGCCbGDCNIAB.....IHHAhBCA.BEDD.hAIA...,1,9,-28,37
NFDWLcTIgBPUdMGQVOCSXYeHEKZJARbaf,RAAAaAAAFADALADA..TAGABAHAdCCAGCCAQCFAhAEA.CCHA.XCFChAAAHECCEEHFZEFBABBB.bFGDDFABIGAAhABAgGFBMCIBSHAAeGCA.hAGA......hAIA...,2,-8,-8,0
ISTYWRBVMGPKCQfUXbJDcHZOFLAgaNdEe,aAAAEAAA..eACA..TADARAFAMCCAGAFACCGA.QCCChADAUDAAJDDA.HDGBZEFELGAAhAAAAAHAdEEASBBDhAFABGGAKHEAXGGADIAA.FHBA....hBAA......hBHA...,1,-2,-12,10
RgMUcaLVeGAbWKBTJNSXfPOIDHFQEZCdY,KAAATAAA..SACB..fACBOAEAHBDBhAAAEAEEdAGARBFAMCCBaBHDeCCAhAAAAAIBBDGAXDEAhAIADDIBZFBACEFDgEGHLHFA.bFDB....hCAA......hCCA...,2,-16,-14,2
NYARETZebCQHKPGSdVFfUMJOgDWacLBIX,EAAAeAAA.QADAHACAGAFAdAGAFCCBMAIBOBHDDCCB.aDEALDDBhAAA.XEAChAEAAAAAREEBZFBAKGHBSDFDhAFA.fDHE.gGGAhAHABHFANIAB.YHBAhBHA.CFGA,1,-6,-16,10
ZULcJYfGdQEXaWCMKPVTbgHORBAINFSeD,FAAAeAAAZACBLAEA.JBCBGAEA.EAGAaAHDMBIBKCFA..hAGA.TEBAHECAREGBACHBSDEDhBAADDIBUGAAfGEAhAAAdEGAQGDA.CGHA....hABA......hAFA...,1,-7,-16,9
DNBFQcJdgZeACISbaTPHMYXOGfEVKWULR,SAAAaAAAHACBMAEAOACD..EAHFKAEALBEBRAGFBCEAQDFDhAAAdCGDeBBDAEDBbEFAhBAATEAA..XGBAhBGAGECAfFGEUGEAFGHH.gGAGhABA....hAEA...,2,-18,17,35
CKWTHcNRDbZXVYPELJMfBgSeOAaQFdUIG,aAAAdAAAGADA.KAFAHACBRCAA.ZAEA.XCEAVCFA.ECHFMEFBhACABAHB.eBBDAAHAQFAAhADAFEEBCEHA.TGGAhAFADFAAbFAA.LGFA....hAFA......hAGA...,1,-7,-14,7
BPYVadUAceIEgSWHDbXFZTfJCMGQRLKON,eAAAEAAA..SACAHADAXAGBZAEBTAGACCCAGCEA.RDGFLFAAhAAAOCCBBCGDhAAA.PDABaFHDABIBgGCAhABAbDFAFEEH..MFHB.KGFB.YECBhADA...hAFA...,2,-5,3,8
MbTGeacZIURJVCYSFXBQHfDAELOKNWdgP,EAAALAAAKACA.dAEAMAEAGAGA.eCAAZAFERCCACDDA.FCGABDFAHDFAhAAAAAGB...OEEBhCAANDIA...PFGDhCBAaEBBUFDA...YFGB...hCCA......hCDA...,1,-16,-20,4
COTZILMdJcfaNAeEgBGRYFDXVSbPUQHKW,EAAAGAAARACA.DADA..SAFBUAGAHCDACAHAZCCAMDCB.dDHAJCGBhAAA..aEFBACEAeDABhADABBFCFGFD..bFFA.hAAAKEED...OHAAIHHA..fHFBhAHA..hCAA...,2,-22,-22,0
gYFGOTVAdJQDRcPXeKNUbfESCIMLBHWZa,dAAAQAAARADA..XAGBeACAKAFAUCDBEBHF..CCDAMCFBhAAAHDABaBHD..FDAAGDFAhACATEGAAADADCCBPGCAhADAbGCA...SGGABHGA.WHAGhAHA......hAIA...,1,-8,-21,13
SKaUTBOFGJeHWbcVfDYINdLPXQREZgAMC,MAAAKAAAUACABADAGAEBHAEB....bAGBVCEB..DBBB.hAAA.ICHAdCCALEEAhBAAQEGAEFHFABIBaGBAhBCATFAAFGEA.eDDD.fGGEhAFANIDB......hAHA...,1,-7,-23,16
QZGMDPCBIKYdbgeASRHcUFEXNOVLWfaJT,HAAAFAAAEADAOACA.LAGBaAFD.TBEAGBGA.MCCBhADACCCAKDEDdDDAeCHHRFDAXGFAhAHAVFFB..fGBAhAAAJFBFDAIB.........hBAA......hBFA...,1,-6,-17,11
dYNBSGXQDFOTKCWJLMPEUVgfbeAIcZRHa,ZAAAHAAAdAEABADBGAGAQAFAOCABKCCDCAHALCAA.ECEBhAAAVDEB..bDFDAAGBRGDEhABA..aCHDSEBAhACAFFAAJHDA.MDIB.gGGBfGHAhACA......hAFA...,1,-6,-11,5
fPbHgdKFALEQURZXcCYVBTJGNWSMIOaeD,EAAARAAAZADB..CACABAEAGAFA...SAHBMAGBOAHBeCCDhAAADCCA....bDADhABAHCEBdDHAADABLDDDhAAAQEECXEAAcGGATFGA.WHEGhAEAaHBAfHEBhADAKDHB..,2,-30,2,32
aABMRXUCDHLSKbeIEdFgGcZWYQNOVJfPT,RAAACAAAHACALADBKAFC.eAFAdBHAGCAAZBFE..QDFAhAAAOCCEJDFBTFAA.AAFAMCCBhABADCFASEGHhAAA.EGHFFEEH.gGGAWEED..hCAANIAB......hCDA...,1,-10,-14,4
ALGSRMQNJEfCXaFYcgDHPZbKdVIUWeTBO,GAAARAAAMADA.QADA.EAFAXAFAaAHD.FBDDgCDGhAAAHCEBZDGBdGCAIDGAhACAeCCDOFHDhAAAADABLFFASGFDfGCA.CHFA.DAIB.hADA......hBAA...,2,-9,-5,4
NYKXIJDQeWTRVALHdPcCbgUSBFMaOZGEf,HAAAdAAACADA.UADAFAFA.aAFEGBDB..EBHF....fCBAhACAKCADXCCCDAIBeDADhADARCFBADIBLEEBhAAA.bGAABDDA.ZDFBIGGAWDHHPHEAhBAA.....hACA...,1,-13,-22,9
RWZBFbNSGDUOEaMAVcdIJfTHCgXQYPKeL,dAAAJAAAHADBCADA..QAFAKAFARCFA.ZABBFCCH..SBHBhAFAGDAAOEEBECEBADDB.hAIA.VDGBIFGAhADATFCAXGCD.eFHHBEEDDAIBaGGC.hAFAcGDD...hAHA...,1,-11,-15,4
aBWMIFHbgDLEfPAVSQGJTCcXONdRZUeYK,QAAAGAAACADA.OACCRAEFZAGB..eCDBaAEABAHA.MCDAhAAAHEGBDCHBEFEA.AAABSDADhACATDDA.XGAAhADAdDFAKEHBFGGB.LHAA..hAHA......hCAA...,2,-17,-9,8
gEfSFINKeDVTaOURQWdZYPBCGcMLAJXbH,XAAAHAAAEADEFAFAKADA.DAIB...aCACRAFFdAHA.ZCDFBCCBGDAAhAAAMCEAADAB..JDGBbDEAhAAA..SEHHhABAeEDBTFFAOFDBWFHHCHHA......hACA......hDEA...,1,-14,-18,4
YVOaKXDUZCLTINAEgQePGWJMcBHFRdSbf,EAAAeAAAGACAMAEAHBCARAEA.dBFASAHB..bBGDfCBEhAAAODEBaEBADCGBhAEAZFFATEDAAAAA.QFAAhAFAPHFC.cDGD.FFHD.KHCAhBCA......hCAA...,1,-4,-5,1
DcfFWABYVNXOaeRPJZKLgIdUTMbGHSCQE,BAAAVAAA.OACA.RAFA.ZADBLBCBdAGAMAIBHCFC.QEDAhAAAECFBDDAAFDHHACCBXFFBhAGAeEEB.KFCDgFBAhAAA.TGGASEHH.hADACHHA......hBFA...,1,-11,-22,11
VTOdKBFRaeQIGfLYbWSJUXCHZgPcEANMD,MAAATAAAdAEA.FAGARACF..eAEEGBBALAHB..bBFDSBEHhAAAUFDA.HCFBhACAZFGB.gECAhCAAECHBABBBDEBB.KEHBBDECaFFCfHCB.hBAA......hBDA...,2,-19,6,25
eLHXJNGDSOMfRIVCEbYdKcZWQAaFPTBUg,aAAATAAABADA..eACEHAEB..XAFBGBGAOBBBhADARBGFCBDD.ECDBdDDAZEFFAAIBFEGHhAAAgGAALFCADAGAhBAAMDIB.IHHA.....hBGA......hBIA...,2,-16,-9,7
CBTSdLWXaNbIfcKRYQEOHFeVGgZJAUMPD,MAAACAAABACAdAEALAEA..aAGA..ICAAKBBARBFFECHFHCCAhAAAFDBA.eAHHGEDAhBAAZCFFAAFADEBB..TFEAhACAXFFB.fFHAQECB.ODHFhCCA....hCEA...,1,-17,-18,1
fHWNDVFaGUTOAdQJeXYIgcLMSECBRPbKZ,dAAAeAAA..XADAIAEALAGB.ECBARAFFKBCAHDDADAIBhAAAaCHDGCGAODABADDAQEEChABAJECF.hACAgGGAMFFABGBDPHAAfGGAhADA.NIAB.....hAEA...,1,-7,-12,5
NXDTYRPUOAZHfQWICKGgFBLeSEbdVaMJc,HAAAQAAACADBGAEABACAeAGBEAEAdAHAaAHF...MBGB.JCDBhAAAXCAA.TEDAhAAARDGFOEABADDAZFGBfFCEhAEAKDGD.LFEB.SGGAhBHA...hACA...,2,-12,-7,5
ZDAfTHQXaKSFIYgUbLeNJGOEcWdVPBMRC,HAAAaAAA.FADA..IADAUAGAeCAAGAEAECEB.dAGBBDDDRBGFZCCFhBAAADGA..QEFAhAAASBBD..bFCBLFFAhCAAOEHF.cGEC.....hACA......hBGA...,2,-15,-10,5
YGLCfIbOJVMRATDEBgNQdPSXUFWcKeZaH,EAAABAAA.QACAdADASAFAFAEEKAHBeAHHHCAAGCBALCFBhAAACDDB...bDGDODFBhAAAMDEB.AAFATEGAhBCADDIB.PGCC.XGGAWFDDaHAA.hBDAIHHA..hACA...,1,-2,-21,19
cOPTYSICgAURVDHFKJQGLdEbZMefWaNBX,RAAAHAAAKADCGAFAEADEZAFBeAHF..aAHFXCAA.OCHDhAAATCCA.SDFDhAAACDDAAEFADFAAQFCAhACAdDHAbFBA.MFFB.fGGABECDPHBChABA.gGGAhBFA...,2,-18,3,21
GWCAdPZObHRIMEeUFVTLYfDacKBNgJQSX,ZAAAHAAARAEA.EADEeAHHFAFALCAADACA.aAHDBCCD.JCEFQCEAhAAAGEFA.ADGAdECAhACAODHDbEEA..MDIBhCCATFAA..fGGEKGCASHAGhABA.CHEAIHHAhAFA...,2,-25,7,32
LBEYfRGOPUMXTedNgAVZHCaIcQDbWJKFS,HAAAaAAA.QADCDADA.JAFASAEAECAB.RAGFGBBBhAIAOCCBMCGBeCHHdDEAhBAAACHAZDEFCFGD.IDHAhAAA.bFCDFGDALFHBfGHA...hACA......hAIA...,1,0,-19,19
LTdOXHDaNYQCSGgUJEeKWRBIZcMbFPAfV,LAAAdAAAHADAaAFAQAEAGCABUCFAEAGAKBHBBCHA.ZEEAbCAAhABAAAIB.....TDFAhACADEIBCFDD.SEAAhAEA.eEDFIHHAMEIBfFFEhCAA.OHDChCBA...,1,-6,-24,18
XVcDfEeBNWYKSFdAUgJZOCLRTHPaGbMQI,UAAAZAAALADBHADAGAGAMAFA.QCDB..XBFAhABADDAAEDFFeDHHBCAAYCCFhACAFFAAAAIBOFGHhADAREEAaCHDbGAA..IGBA...fFHAhBFA.KGDAhBGA.SGGD.,1,9,-10,19
IgPVSKENbcJHZedMBaTUADROfQXCWLFYG,RAAAQAAACADB.LADAGAEA.IAHAVCCB..EAGAbCBAhAAAHCGB.dFFAaCFAAAAAOGAAhAGAXDEDFGDDgDGGhAEAKHGA.cFAA....hAFA......hBCA...,1,-9,-20,11
IdRPfWMJBONAbGDScXVFZHUCYeaEgLQKT,GAAASAAA..XADAZACBHAEACAGAeAHHEBHFLDEBhAAA.TECARCDBfDCEhAAAMCGBODHDAADAbCFDDDIBhACAFGAAaGGBQGAAIHEAdGGAWHAABHEAhAGA......hBAA...,2,-4,9,13
bPODYGAVLQgIJfTESHcMXKaCeUFNWBdZR,LAAAQAAAJAEAEACAHBCC..MAFAaAHD.eBDAFCABBCFAhABARBGBODDAGDGAABIBIEBAhAAATFEA..XDDChACACEEDUEGBdHGB..PHAA.DGIB.hBEA......hCAA...,1,-2,-10,8
PSYZXERafTdbLDQBKVFcAHMUWgOCGIJeN,HAAAMAAAUAEAOACAGBBAeAFA..SBGAZAGBRDEB.aCCAdEGAhBAALDDAQGBAhBBAKDHBFFCAABIBCEDD.JFFA.PGAChAAAEGHF...fHDFDEBB.BHHAhAGA.....hBDA...,1,6,-15,21
RDAcKLMFNZgCdaGObPfYQXUVJeWTIBSEH,LAAAMAAAZABEdAFAGADA.OAFA..bAGD..fBFBhABAQCCAXCAAhACAVEFAeFBATDFAhBIASGHHHFDAACIBFFHBNIAB.aHDC....hCAA......hCBA...,1,-5,-11,6
bCGNgKePULTADaWREdYOFVfXIJHBQMcSZ,aAAAEAAAdADA..FADA..XAFAHAFBMAIBZCBAGCFAKBBDeCDBhAHALDHBADFB.RFAAOFDDhAAAfDBABHFAhAFAQDGD.bECDCHHA.gFFAhBAA.....hAGA...,1,-4,-12,8
ELHKUXgYVePQMAJNOdfTBRGcWSFCbaZID,OAAAdAAABADARADAGAGA..SAEHCBBDZCDA.EAGAHEAAhAEAXBGAVEEBeDHHhAGAMCCBADAA...fDDAhACA.TDGAFGHD.aEFHDIAALGAAhADA.KFHB..hAGA...,1,-4,-28,24
EbORLDCSIKdMJGTQXFfAPeWBVHaNYUgcZ,eAAABAAAHACA.aAEAUAEAZAGB.EAGARCAALCEBSBCHdEDCGCGAhAAA.QDEAhABAfDHAABIBPEBBhBEAVGEA...gGGAcGCC.DEDB.hAAA......hACA...,1,-3,-16,13
VYgCMZWcKXOABSEDGQaTfJPIFbLNRUHde,EAAAGAAA.aADATACA..JAGBFAEALCDBRAGFHCCCeCHHhAAAVDGB.CDFAZFCAKEBBAAABDFIB.hACA.QFEDhAGA.IHHAbFFDNIAB.......hAIA......hCAA...,1,-7,-15,8
ZHLCRSFePVXKBWGDNTYgfJaAbIcdUMQEO,..IAAAdAAAMADA.EAGAHACALBDBRAFFeAHH..XBFChACABCAAGCDATCBAfDHAhACAABIBUDGAZFEAFEAAhAEA.KFADDGIBgFFB.aFDH..hAFA......hAHA...,1,-4,-11,7
XceVFKQUOZBfAYLHIGdNWERDCbMJagPST,HAAAdAAAEADARADFCAFB..MAGB..aAGDSAHB.TCBAhACAeBHHKCAD.QDDBhAAAZDEAABFBLDHBhADAGDFADFDAbFCCgGFBcDADFFHDBHBA.hACA......hADA...,1,-8,-11,3
GbJWfQSOCHNgYdAVZDEUXRITcPBKaMFLe,ZAAAEAAARACA..TAEABAFBKAHBMAHB.eCABGCCB..bCCCJCHFhAAA..QDFDhABACDAAHEFB.gECAhACAACFADFEB.XFGAIHAAaEAHLHFAhADASGCA.NAIA...hADA...,1,-2,-18,16
TLcgOYIEUbHDGBZRQfPaAKXCFVMeNJSdW,CAAAMAAA..eACASACAdAGALBFDOAEDECAAHAGBGDABhAAARCCBQDGBaBHD.hACAAAGBFEFHVEGBJFHBTGDAhADA...........hAIA......hBAA...,1,-5,-20,15
EbCUMDOFRdAagQcVeYfKWPTGXZJLISHBN,aAAAQAAA.eACAKADATAGAZAFBLBHBHCCAECFECBEAMCDBhAAAFDABABBB...gDGAhADAcDAA.fECEhAFAGEDAXFFBSEEBBFHAbGACDIAAhADAdGGA.....hAIA...,1,3,-8,11
fgYGMHOIAaCEZcKdJVQNLePWbSRFDTXUB,EAAAZAAAdAEA.QAGAeACA..bAFARCAADCGBUCCABDEA..hABAfCFAGDGAHEBAhACAAAGAaCGDKFFD.NIBBLGAAhADASDAB.TFCA.XFFAhAAA.MDIB..hADA...,2,-21,1,22
ANCHFebJadPEcODfTKWgIVGRSLYUBXQMZ,HAAAeAAA.aACAEADADAFAKAFA....IBFARCCALAHBBAHAMCGBhAAAACCAFCDDdEEA.OEHBhABATCGA..gFCDhCAAGEFASFDB.YFHBhAAA.....hCBA...,1,-15,-20,5
RPbVXJHEcZODTKICNYBWGMSFLfgdQUeAa,RAAAVAAAHADB.EAFAZADBDAIBKAFA...CAHB.BBGAGCEAMCCBLCGBhAAAdDAAeDDA.AAAAaDGDhADAXDAA.OEHDhADATGEA..IGDAWDHH.FGGH..hCAA......hCDA...,1,-12,-19,7
ZfdXKMaQFWRcDIUJeGObSYTBEAVPCgLHN,CAAAHAAAZACA.dADAKAFCaAFA..FAHDRBEF..DAIBUCCAGCGA.SCAAhAAABCFAAADA.VGBAhACALDHB..XEEChBGAMEFB.QGGB..IEGAhAAA...hCAA...,2,-51,-5,46
IeXBfNAFECcDPMWYZVHLTQgSOdUaJbGRK,EAAADAAAMADAZACBHAEALAHBQCEB.OAHDaBBAGBDAhBAARDGBeCBDBBFAAAGA.CDFA.PEEBhAAAVEGB..TFBAhBFAdGGD...JHCE.......hBCA......hCAA...,1,0,-16,16
IYdKMOSWJbeTagAEQUXHRGNfcFDLBVZPC,EAAAQAAAHACARAFFGCDA..fACFDAIBLDHBZAEBCAGAhAAAdEAAMAIBSFDDhAAAbCFD.eFFBaCDBACHBNCCABHAAhAEAIEBA.OEEHWHCA.TGGAhBEA......hCAA...,1,9,-18,27
SYHBQdFZaMcIXARPEWOGCNDKLfJgVTebU,EAAAGAAADADA.LADA.JAHBTAFAeCDA.SAHBhAAAHDECdEADaDHDMBCB.XBDChBEARECFOFFBKCGAfGHAhAAAbDECBEHAZFDAACDACHAA.......hACA......hAEA...,2,-13,1,14
gVAeBXUNYMLQKbCIDJSFRfHcGPWaTOEdZ,eAAAXAAAUAEA..MADALAHB.QBCAbAEA.hAAADDFBFBDHHEFBGCEAhABAaEHFEGBAZDGBAAIBBBGBKGCACGHAhCAASGDH.......hCBA......hCGA...,1,-10,-19,9
eTaIcDUMZANLVREFQbfOPSHWCXJBgGYdK,LAAAEAAAFACD.QAEAOAEA.HAGDCAHABBEAGCAA.dCCBhABAeCEAaCHDDDDBZDDAACIBREEA.hACA.bGDASDHDhAAA.XEBC.gFFGhBEA......hCAA...,1,5,-32,37
EfJYPAVXcOaIDLgZBeRKGQNWTHbFdUSCM,XAAAaAAALADAZACBBAEARAGF..GCCAQAGA.TCEAhAAAHEABdEFA.CBBDEDHFhAEAfDGAPFHDACFBhAFAODHDDIAAKGDAbECB.SFFD.hAIAMIBA....hABA...,2,-23,3,26
XcOfSAYCgIdZQebEHRGBMDPNaUWTJKFVL,CAAAdAAAZACAeADAHAGBRAGBGCABDADA..aCCAUDGB...TEAAhACAFDDHLEGB.hADAOFDEAAIBgECHhAEAbGAC.EFEFMDIBPFHBNIBB.....hAAA......hAGA...,2,-21,-1,20
OXJKfdDCUVRHcEMgAIPQZGSFWeTabNBYL,QAAAGAAAFADAeAFHaACE.BAHALAFA.XCDAhAAAKCDBdCHACDCDRCGBHDAA.EEEBhADAAAABZDFBTGAA.bGEAhAGAOFEHDEGBUGCAMFIB.IHAA.hAHASHFA.hCAA...,1,17,-25,42
aSRHFCfEMIbcUZGDYAKQLeJgPXdBWOVTN,LAAAeAAA.JAEAXADABAHB.OAGB..TBDAhABAaAHDHCCACCAA.EDGAbCFAZEAAhAAA.GEEAACCB.KEHBhABAQEEAdHAB.VGCASGHDhAEAfGHA....hACA...,2,-32,12,44
XRgLFEYDeTSfNVbPACJdMWHGOUQcIZaBK,dAAAHAAAGADAQADCZABBKAFARAFFLAHB.ECABeAHHTDDAhAAAfCFA.hACAVEFAACCBMEGB.OEHBhAFAIFAAaFDCBHCAFGHDSDBAhAFANIEB.CHAA.....hAHA...,2,-18,15,33
FUTQDdGVWMLSXAZRKNCHBIbeYPcOaEgJf,RAAACAAAHACABADB..eAEH..PAFAOAGBEBHF..JBHBFCAAUDDBhAAATCEA.dEAAGEFAhABAMDDBLEEAhAAAAAHAKEHB.bGCAaCCBQGGA.DDIB.hCAA......hDAA...,2,-26,11,37
YLgZUAGMOcJBfbXFIdTSQHDeEVCNKRPWa,GAAAMAAA.OADABADA..XAEDdAHATCDAHAGD.EBBBCBFARDBFhAAAaCHDLDGB.hAGAZFEBADDAfDEAhAIAFGHDSHBAeDFH.KFHB.PHFC..hBAA......hBCA...,1,-6,-16,10
dSPMBWgbDRUFEXNfeGQTVJCYOIaHALZKc,ZAAAdAAAMADABADB......bAEDRAFAEBDB..XAGAhABAeCBFGCEATCAACCGAOCHDhACAHCGBAAGALECAhACASDDDgFGAFFHHfGFAQGCAhCAAYEBBaGFH...hCCA...,1,-5,-7,2
CdXAWeKVcfOMaNETQLJSIgGZRbFUYBDHP,eAAAKAAA..VADAOADC.MAFAEAGELCAA.SCEAhAAAGBGARCCAbEEBFCHBBEEAhACAHFCBdGGAAEGB..hAAAfEHANEIA.QGGB.hABA......hBIA...,1,-8,-20,12
AQELbKgcFXPMRYGDHIWVONaJeTBCfSZdU,EAAALAAAKACA.FAEAMAEARAGFGBDA.HCABIBFA.OAHDhAAAaCHDeDFFBCCASFCBhABAdDEAADGA.bGFAhACAXECBDIAA.VEGB.TGEACCCC.hAIAfHBB.hCAA...,2,-19,-1,18
QZGdKcNYfTFLIAeVBWDCRbgJMHaOPEUXS,eAAABAAACACARADA....JAHBHADB.aAFAECCBUBGB..QCEAhAAAdCAAKCCD.NDIA.TDEAhAAALEAB.AAGADEEBhABAbDGD.MEHB.XGDAGFBB...hACA......hAIA...,1,-13,-22,9
QPWDZcXFHRNIeVOEAaLMgdKGUSJBfbTCY,aAAAMAAA.dAEAGACAUAGA.BAEA.TAGAQBBA.DDEAhBAAZCEBFDGDHDGB.REAAeGAAhAEAEEBAADIBLEEBhBBASBBDJGBEbGDACGGA........hAGA......hAIA...,1,-1,-20,19
fOKZMgTUYISFJRQaCDHEdNbGcVPeBLWAX,OAAAZAAAMACAUAEA..SAEARAGB.aAGDHBCB.EDFBhAIAbCCAGEBA.PDHDhBAAeBHHLECBhABAABBBKEED.TEFAFGGB.CFHADEEBcGDDBHHA.hBEA......hBIA...,2,-9,-8,1
MULdfNGPKRXIJeHZWDTQYAECBVSOagcbF,EAAABAAA.OACAaACD.....bAFAMAEA.dBEAGBCAhAAARBGBXCBCeCBDHCGBhAGAZECATGBAACGBSEEBhAHAFEGH.fFDAKGHB.IGGAhBCADAIBQGDC..hAAA...,2,-13,-5,8
HJQZBTOECVDeXLGKSIPRNFdAUbgYfWaMc,UAAA..bAAA..fADAaAEAHAGBZBDBOAEDECAADAAAeAGBhADAGDFAKDDA.SEHBhAIARDFFdFHAAAHA.gFCAhBIAMBIBQGCACHGA.....hCAA......hCFA...,2,-15,-4,11
gWMPBdceNVCUYZEXJHSfDaQFRLbKIGTOA,MAAAdAAAeADA.CAGA.ZABE.EAFAHCACDAIBFBGDRCFALEAA.KEEAhACAGCCAAAIB.gEFAhAFABEHAVGCAXFDDhBAASGGA..aCFH.IGHAhCAA......hCCA...,2,-25,-14,11
UbReYaIGNDABPWTdQXEHfOSZFgVMLcCJK,BAAATAAAdACA.EAEAHACB.SAEAZAGBFCBH.MAHBLCFDhAAACCADKCEAREAAeCHH.aDDBhAEAGEEA.AAEAQGCChAAAOEEH..gGBA.hACAcGED...hAIA...,2,-18,-8,10
dASgYBHFGeQUaZVEKWTfLRCXbDPJcOINM,SAAABAAAHACAeAEEQADAZBFEECAAKAFA....TDDAhAAARCCBbCEA.DDGA.JECFODABhAAA.MAIBAAHAFEGAhACAaEFBfFFALFHBXGCAIGHA.hCAAgGFA.hCEAYHAA.,1,3,-6,9
agQSfZDOXLHecKVJGNbWAPFIBECYTdMUR,FAAAEAAA.CADA.dADA.RAFA.QAFAZCBA.DAIBLCFA.HEFAhAAAeCCAKFAAGDAAhADAbGAA.ACCABDEAMFEBaGHBhAFAfDGA.XFFA.cGDAhAFA...NDIAPHBChBAA.,2,-35,-5,30
XKHTNQSObfIVLJYRZAWePdDBFaCGEMcUg,eAAAdAAAFADAGADA.EAFAMAGB.UCCAKAHBHCFA.TDBAhAAAQDFBOEFBbFCAhACAfEHA.hAHALFAAYBHHAGGBDGIBaDBBCGGA....hAIA......hBAA...,1,6,-30,36
TVSgEMYIaOfKXWFGCRPAQbdeDHJNBUcZL,dAAAHAAABADAZADBTAFA..SAEHEBHF.MAGBaCACKCFDhAAAFAHBRCAAAAHA..eDHFhACADCIBUDFBLFFBVGFAhACAIGEA..XDCACHHA..hADA......hBAA...,2,-29,-5,24
HeGNZYRCcTEDWOXVJBQdbMgaPULSFKAfI,HAAAeAAAZADBRADFCAFB.EAFADAHB....XBFABCADdCFA.MAIBhAAAaCCBLDFA.hACAKEEDACCBGDGA.hAAANDDA.TFGAOEEBQGDB..hABA......hAIA...,2,-24,-19,5
DVRKNAITcQEXZdFSMBeObGJfHagWPCULY,TAAAEAAAdADA..MAFAeACE.GAFAHBEBaBCB..gCCAhAAACBGALDHBDAIBREEAABIBQEEChAFAZGBABDDD.bDGDhAHAfGGEPHBAYDBF.NIEB..hAAA......hBGA...,1,15,-12,27
bENIGJPgOdRTaDSZMUXYWfLeKFACVHQBc,HAAAQAAABADBEAFAGACB..PAHDdAGARCDAaBHD.ZDAAMCABhAAAUEFA..XCCAhACAfFAAeCFBAEIBCGHAhAAAbDGD.JFABOHFCTGCADIAASFEBhAFA.....hADA...,1,4,-6,10
abZADUNJVBSHKMLPXEGYCeIQdOTRFfWcg,DAAAUAAA..VACAHADALAFBEAGEGCBB.eCFEdAHARDDBFDAH.hBAA...fBBEhBHAgDGGZDGBAEEABFFAhADAMEIBXFCDCGHAOFAE.cGFCaHGCNIAB..hCAA......hCFA...,2,-18,4,22
dYXUZOWRDMJIHANeScbQfaTKCLVGPBFgE,eAAASAAAQADA..aACDTAFALAEAGCCAFBHDECDAhAAAdAHAXEFAhAAAZDEBRFAAMEHBHFDBAAFA.cGGChABAKGFB...........hABA......hAIA...,1,7,-21,28
WMdYfeRScFVaNHKJIABECULGQgDbXZPOT,EAAALAAAGACAQAEADAEAZAFE.TAGAdCGAeCBB.REDAFEHDhAAAaCAAHDCA.KCHBACIBCGDDhAHAbEAD..OEBHhBCAMDGBSEHD.cFDB.NIABBHHAhABAXGGC..hBEA...,2,-13,10,23
NcdHgeYVPXRJZCBbAFLMQETIaUSOGfDWK,MAAAEAAA..aACDOACEGAEADAFA.KAHBdAGB.HBGB.eCBBhAAAPBBBRDDBZEAF.bFGBABGBLCEAhBAA.TDCAhCAASGEA.NICB.gDGAhCDA.XFCA.hAEABFFD.,2,-36,16,52
ACdYVXUHDKOFMbgcGITRNZEJWLPefQBSa,dAAAXAAAHADAOAFAFADA..MAGB..bABDGBCARCEAEDABLCHBhADAeAHBQDGDhAAAaEECAEGA.CCEBUFFBhABAKFCAIGGANEEA........hBAA......hBIA...,2,-8,-7,1
eXTUHfgPZVWLIFDCEdcRMAGbYaBSKJOQN,GAAAaAAABADAKADA.QAFCeAEH.UDCAHAGB...fBBEhADAZCGBLEEBhAAADDDBEDGBdGDCMDABAAGBbEED.hAIASGGA..NDIAXGGDhBAA......hBIA...,1,-11,-21,10
QdeXYBJINTRgLVbZPSEaMOHDKUAWcFGfC,FAAAGAAAQADAeADABAGA..IAGARCDALCGBZCCAEBHFhADAaDAHHECA.KFHBACGBfDHAhAIAdGEA.hAAAXEEANAIA.TFBA....hBAA......hBFA...,2,-27,-6,21
ZRDNdOVKFcgeHafQYJWSBMXTGbIPELACU,ZAAARAAAdADAKADCFAFA..eAFAHBEB..aBGEQCGC.JCCFhAAABCAA.MCCBTFFAhABAbDDA...IHHAhAIAEDHBADDADFDAOEEBgGAA.fFGAhABA...hBIA...,2,-26,-20,6
SOKeWXQTJEPcdaUDZFgfILACbGHYBNRMV,GAAAHAAABADBRADAMAHBOAED.KAGAeCDA.QDFDhAAAECABdCCAaCFDZEAA.FFGHICHAhAAAAADACDCD..bGACVEDBhACA..SEEDTGAAPFHBDBIB.hACAfGFANEIA.hAGA...,1,-2,-6,4
FTAaNRCdIGJEOMZfQPSBHLVcXKegWUYDb,RAAAdAAAGADAEADAZABBQAFABAFA.HDAALAHB.XCEAhBAAeBHHgDFDhAAA.UFABbDCDABHBaEHDhABACEEAOEHBMFFBSGGDKGFB.DIAA.hCDA......hCEA...,1,16,-24,40
GUbIPFATXJWdcaBYLCNRZDHMVgKQSEefO,TAAAXAAA.dADAaACALAFA.RCDAHCGBMAFAKBDD.EBFAhAAAeDBBGCGAIFEAhAAAABIBJDEBBFBACFHAZGAADGGBhABAQGDB.fGGE..hBFA......hCAA...,2,-20,-3,17
WBYgAFSDZLRVEbNXQJeMTPacHKUOCdfIG,DAAARAAAEADE..XABAeAFE..MBGBaAEAHAGBOCCAdBEAGDEAhAAABCCDAAIBZDGBLECAhBAANDDA.TEGAKGHBCHCD.hABAfGDA.IHHA.gGEHhCAA..hCBA...,2,-22,-9,13
fdXJNaZADLQBGUOMcIVFTKgYRWCbPSeHE,LAAAGAAAMADAVAEAKAGA..RCAA.CBFD...SAHBhABAHCDAECHBdEFAXCECaDBDAAABBEHDhACAOCGDFGHBTFEAhACA...gEAA.YEHBhAEA....hCAA...,2,-21,-18,3
YNMUAZISDKfaTRXWVJCHPgOBFEQLecGdb,ZAAADAAAKACAaACA..RAEF...XAEB..VBGBHAGBOCCBhABAEBBBeCEBdEDA.bDCDMEIBhAGA.AAHA..SFEHhBIATFGACDHABGBDFGGB.QGEDhAIA......hBAA...,1,-18,-19,1
VATafXZWYceMELQNgUCJdHOBRGbPIDSFK,aAAAZAAA........cADAEADALAGBQAGAgBBGhADACCAAHCCCRCFFbBEDDDIBhABAKDHBAAFA...TECAhAIAXEGDeFFBMFFBUGCB.OFHBBHHA.hACA......hBIA...,1,1,-18,19
VNcUDdGXTEICHZaBeFSLMAQOgJWYfbKPR,QAAAOAAA.JACE..fADAKAFARCDA.VAFAUCGAGCCBhAFAEDCB.HDFCaEFCBAHBhAAAeFCALGFAhAIA.ABBB.gFGA....hCAA......hCDA...,2,-29,-2,27
cLWTDbUGYMCgJBSNHfaXAPKZEdRIFQVeO,ZAAARAAAQADCeACELAFBDAFA.GCDAMAIB.CAHABCCDHBFBaCCChAAAACHA.KEEAEDGA.dFCAFEHBhABAOEHDTFCAUFFAhABA..gGGASHAGfHBBhBHA.....hAHA...,2,-10,2,12
HFbPODWVTIdeACYSKMQNGRUZLgEfJBcXa,SAAAMAAAGACBRACFZAEBEAGE..BBBDaAGD.HCDC.FCGAbDEADDCBhAFA...TEFAhAIAeEAAAAAAKFHBQFFChAEALHEA.fGBA.XGDBhAIA......hBGA...,2,-17,-6,11
gcWYLXNfbDaRFISQOBCUPVMEHdGTeKJZA,....gAAA..cAAALADAfACBhAEAaAGDRCCASBHHQAFAhAFACDFAVEAAHCDAGDGAhAIAeEEBZEGBABHAXFCADFIB.OFFB.hAAABDCDMIAA...hBAA...,1,3,-15,18
CQEGTVIdWHfeXJSLcZObgRaKNBMUPYADF,CAAAEAAAGACA..TACAdAEBHAGB.eBEHSAEBZCAFODFChAAARAGBaCCCBFFAMCGB.hACAPDEDAAIBFFHB.QGAAhAAA.IECA.XEGDhAGA.....hBCA...,2,-20,-3,17
HKNePcDJQXYZCfaOdRbBTMLIWUgGVFESA,HAAAeAAADAEAQADCZAEE.aAFARBCBBBHAMAIBLCCAUDFAGFCBhAAAEBGBACAB.KDFA.PEEBhAAAJFHB..CDHA.dFHAhACA............hDBA......hEAA...,1,-3,-34,31
IWKeEMGJTABNfcbdPORaCUFZSgQDLXHYV,BAAA..fAAAdACARAEACAHB.ZADA.QCAALCBAHCFAhAAAIAHAeEAAECDAGEEAhAEAAAEA..bCFAaEHBhAFASEEADGIB.XEGD.VGAAhAAAKHCA.MIFA..hACA...,1,-13,-14,1
PIKHSTGWcEUBLAFZfeNDXVCJQMRaObYdg,ZAAAeAAADACACADA...MAFARAEF..aAGAOBDDdCCA....ICGAhAAAHBFAGDEAhABAEDHFLEEBABHAfDGFhBFAXGFDQGGAYHBA....hABA......hBHA...,1,-17,-26,9
RHPWdbTcOeBXCNfEQUVMgGAJFZKLIaDYS,ZAAALAAAaACA.SADHHAEBdAGB..TCGAeAFACBHA.ECAAQDDChABAUDDA.MCCBhBHAAAFAKCGDDEGBREGBbFCCBEHAhCAA.fGHA......hCBA......hCIA...,1,-13,-18,5
MKWbXdAUfVBCTZEDJSFIYcPROQLaegNGH,VAAATAAA..EADESACB.FAEAIAGA..hAAAPAHBRCDALCGBhAFAeBDHGCEAHECAMAIBhCAAbEGDACCBBFHAZGCADDIBcGEA.....hAAA......hAIA...,1,-11,-12,1
EdAZLFPDKgcOVJQSXefCBTNRUWYbHaMIG,ZAAALAAADACAKAEAOADD..QAGCeAFABBHARCCAUDGAhABA..bCABHEEBaCEDGDFAhABAAEEBFFCB.gFAAhACA.cGCBSGHB..hAIACEHBNIDBMICA...hAFA...,2,-18,-16,2
ecfOTPDYBKCFXZRELAgGMVNIJWUQHSdab,GAAAMAAA..VADAIADA.UAFAHAGBdBHAeBBB.ODCDhAGATCDADDIBKDCDXEEAhAIAEDFFAAAB.gGDAhBAAJEGBQFBBbEGD......hACA......hAIA...,2,-19,-3,16
DJFgNYAaTEXWCLMcVQKdHebPIBfUGRSZO,EAAACAAALACA..MADAQAGAHAFCeBCB.ICEAhAAAfCCARCFFZDBFDCFBFDHDhAIANCGA.AEBBaEEH.TGGAhBDAXDAD.cECD.dDHA.bGAC.hBEABGHA.SFFDhAAA.,1,7,-30,37
PfWGUOHbVcEYTLdZADKRXMJBQFSeaCINg,RAAAMAAAQADCFADD..eAFAaAFACBFA..IBBA..hAFAgCCG.hAGAfBHAGCDBHEEChBAAbDFAEFDATGCAZFGFAAAAXBGASGDAhAIAPFHD.OHEChCAA...,1,-2,-17,15
cDNATEdIXRVQKWgUCaBFZHYMbfOePJLGS,EAAAdAAARADAKACAUAGA..aAEAZABB.HCEAMAHB..ODCDeBEFLCCBhAAAGEAADDIBAAIBTEFAhCAA.XFDDhCBAQEEBCGCCFGHBbEGD......hAEA......hBAA...,2,-11,-10,1
YOLbCRBKSdZHEgQJfeUITcAMPWGNXDVaF,MAAAGAAADAEAaADA.FAGALAHB.RBBAKBECZCDAHDBB.EBGBhAAAQCFAeCHHTEEAhACAABBA..PDDBhBAAXGGAOEHD.bFED.BGGD.dHBB.hBAA......hBCA...,2,-10,-7,3
AMYVBILTUHdQRfPDbgZKaEeGJWcOCSXFN,MAAABAAALACAHACCRAFFDAIBZAFB.EAHFeBBBGCCA..JCHFOCHDhAAASDCHFDABACCB.hADAVEEAUFEA.dGGAQFAChAFA.fGHA..hAHA......hBAA...,1,-14,-15,1
BbUKNAHgMSRJdYVeWCGIXTfaFDZcEQLOP,HAAAMAAARACAdADA.eAFAGAFA..TCEAaAHFZCCAEBHFLDHBhAFABCADKCCDABBB..SECAhBAAVEFACFAA.fEGAhBHADEEBQGCCOFFH.....hAAA......hACA...,2,-12,-8,4
KCPcdQWXZGLUeIfBSbaMETNJDVAFOYgHR,OAAAHAAARADFCAFBdAEA..QBGAZAFBGBCAeCABBAHA.aCGDECCBhAAA.JCFFABBB..FEBBKEEDhACA...PEHBhADAXEECLHAAUGGASDHHMIEA.hAHADICA.....hAIA...,2,-19,1,20
bUABJDXKGafHMWQOFgELZePcTdSYCRVNI,DAAAGAAAHABCMADAQAECFAGDLCDBeAGH...TDGAhAAAdDDACCHAREGBVFBB.IFFAhACAAAIBXFDA.aCCHhAGAOBFH.EFHF.......hBAA......hCAA...,2,-20,-2,18
agRCFXGAITVeWfLdcMEZUSYQNDJKObHBP,TAAAeAAALAEA.dCCAEACEZBFESAEBQDFADAGAODBHhAAAHBFBaBHFREDBXGAAhABAACCAIDDA.fECEhAAAMDIB.UEFBYHEGKGGDBHCAhCAA......hCEA...,2,-14,2,16
bQeLRcfBDdOZYIVSNKaGPJgWMAXCUEFHT,CAAAEAAAHACA..TACAeAEERCAABAEB.dAGAZBFE.VDFAKCCDGDEAhAAA.JCHBMCEBhAAAAAIBFECDbFFA.LHAAhACADFIB..IGGA.aGBC...hAHA......hAIA...,1,-7,-20,13
USLBZDcFTINEYbQXKCAVRJfeGHaMPOdWg,RAAAeAAAHADBMAEAdAFBUBGBLBDAZDAA.FAHD....TDGAhAAAECCBQDFACCCD.hABAAAAAfEBAhBEAaEEBOFFBSGHBDDIBIFDANIAB.bFFC...hADA......hAIA...,2,-10,-6,4
MPRYWQNeUZBLEOKVHcGSdfIDJATFgCbXa,TAAACAAA..aACARACF..QAECeAEHZAFBEAHFKAGCHCEC.hAAAGEEAdBCADCIBABIBFCAHhAAAbDEA.MDIB.WEHDhACABFFA.OFHDSHCA....hCHA......hDCA...,1,-1,-27,26
SHFNIVCMcZebUQLDATWRKaGXBdPgfEYOJ,RAAAGAAAdADA...fADAEAFAOAHDHAEBFCCH...IAGAhAAAMCFBZDFBeAHHQFAAhAAAADABTDDAaEDDBDGDhACA.gEGASEHBCGHA....hABA......hAFA...,2,-21,-1,20
COZNHcPdaRBDIbYQfVULTeGWSXMEKJAFg,CAAAZAAAHACAdAEARAGBDAEA......bCABQAGA.fCAAhAAALDDAeDHFhABAGCCBXEBDhACAEDGAACFAOEFBPFDAaEHDBGADIHHAUGGB..hACA......hBIA...,2,-21,-6,15
HDNdLcUAVgSeZQIWJROTGBFbaPMCEKfYX,SAAAeAAAZADBQAFA..IADARCEFGDBAbAEDaBHDhAAA..MAHBEEGAfFHAhABAHCCBdEFALEHBhAAAABDB.gGAAOHBETGEAFHFC.hABA......hAGA...,2,-14,8,22
ZLCBOWKVMDcIAXPfJEFdQYGaHgReTNSbU,XAAAJAAA.dADAGADAHAFA.RAFAeCCBTCEA...bCGDZCFEhADA.LEGBBDBAKDDDhAAAMEIBDCIBAAHAEFAAQFAAhABAaFFB.SFFDOGAE.cGGAhAFA.....hAFA...,1,0,-16,16
NGRQPEZILKcACOdBFWYbXaeSUgVDTHfMJ,dAAAFAAA.....bABDeACH.SAEAVADAHAGBMAHBGDCBhADARCEBEDDBZEGBLEABhAEAAAIBBFDDXGAAhAGAaCHDDECBTFGAfFFAQGCA.KGFD.hBAA......hCDA...,2,-6,1,7
MTPEWVFISZBHLQCeOJXabKgfdNYcGRADU,MAAAEAAAFACDZABE.HAEBLAEA.eAHHXAGAKCDA.dCCA.hAAA.NCGA.GCGA.hAFAAAGATEDAPDHDIEEAhAGAQGDBOFCBaGFD.fGHEhCAA.....hBAA...,1,-12,-14,2
ScQKMFWHNfJGdIPVEYBUADTgZCXbaeROL,TAAAZAAACADB...aACARAEFLAGB.QCAAMAFAHBDChAAA.fBGBhBDAdDDAIEGAECCBBDFA.hABAADHAXEDDeEHHSFEHFEHBNIBB...hBIA......hCAA...,1,-13,-24,11
ZHWMeNTCXUISfYBLGdJKAPFbRQEcVaOgD,FAAARAAAEADE..aACDDAFAHAEA..eAHFTCDACBFA..UCCAfBHAhAEALDFAdDGDAAAAQFFAhCAAOEFBZGAAMFIBhAGAXGDCSGCE.BGGA.hCIA......hDAA...,1,0,-25,25
fPHcCFTVAWJNIdaXBQUgMeYDGLObERZKS,JAAAdAAAaADABADB..QAGAUAFA.eBDBGCCALCFBhACAECHF.RCBBZDGBKEFA.fFDAhAGAHFBBFFEHAAIBIHHAhBAA..MEIBOEBHSGGBhBAA......hBFA...,2,-31,3,34
NYeGBSVWHZRLXMTAbJCdEIPKUFcfgOQDa,CAAAEAAAKACAFACD.......fAEAQAECaAFDeAGHhAAAGBGASBHHhACAHDDAREAAMEIBACCAdDDAIEGAhAGAcFDDDAIBBFEAWHAGXGGA..hAIATGFA...hCAA...,2,-39,6,45
fNIAEBTRaLUYFQbZgJGeKcVHODXSMWPCd,EAAARAAALADBFACD.ZAFAGAEAKCFA.HAGDDAGA.MCIB.CDDAdEAAhAAAIEEAADGB.BCCChAAAaEFEQGGAhAEA.bEBDeDHF.OFCB.SFGDhABA.fGEAhCAANIAB,1,-11,-39,28
JUZMNSGHCdYgQVFDOKcIRfWbBEPTAXeaL,eAAAaAAALADAZADBMAGBGAGA.HCCAdAHAQDBChAAADBBBKDFBREAA...bBEDEEEBACCAXDGDhABAUGGACEHA.gFFGhBDA.OHBA....hBHA......hCAA...,1,-8,-11,3
QRKPOHEVWZTaNDAefMgbXYGSIUcdLFCBJ,eAAAMAAA...XADAGACBSAFE.UCDBdAGALCCBhAAABBBDRCGBOEEBhAIAHDGBECEBZGFAaGCBAAIBbEABhABA.IGDA.CEEDQGGBhAEA......hBGA...,1,-10,-17,7
URIZBKgSVdbCHQXAFTWOMLJEaDPGfcNeY,TAAAMAAALAEA.EBBAaACA.GAEA..fBHAhAFAeAGBRCCBZEFBKCDASAHBhAAAbCFDHFCAADCBODBBhBDADDIBcGAAUGDABHGAdGGACEECFHEGWDHH..hCAA......hCCA...,2,-4,8,12
eWMEFALKTfYQRcaNUXJdOBDbZGCgVSHIP,TAAAQAAA.RACA.aACAUAFA.dBHADAFAGCDACAHA.SDAAhAAAHBDCeCCBEDFEACHALDGBhAAAKEHB.fDBEhBDAcFFANIAB.OEDD.ZFEB.gGBBhBGA.IHHAhCAA,1,0,-19,19
FceXbPJNQEBGYOVASICUDfLMTZaHWRKgd,CAAADAAALACAZABEHAEBRAFF.dAGB.FBHHeAHH...XCCAhAAAJCCBEDAB.GDAA.ODEDhADAADGBSEDAhADAUEGAMIDAaEGD..KGFD.......hAEA......hAHA...,1,-13,-26,13
TJNfFHVAXYZcSdIEQLaDMeBKROCgWUbPG,ZAAAdAAAEADAaACA..DAFAeAFA.RCAA.CAHA.UCEAGBEA..TCGAhACAJCCF..FCGAHFFAhADAAEEB.XEDC.hABASGAALEGBMEIBOHFEbGBA..hBGA......hCAA...,2,-28,-1,27
MgEVOaKHfSLcPTIeJdWYRCNDAXQGZUBbF,GAAAZAAABADBMADAEAFA.OAFEHBFCLCAB..TCDAhAAAeCCBdDGDRCFFDCIBAAIBQEEChABAbDBD.FFHBhACAaEGDSECDIHCAYFFF.hAFACHHA......hCEA...,1,-6,-9,3
FYTCRNXBPKcUeLGOSEJVfHWZDMdbAIgQa,QAAAaAAA.FACETADARAEF.BAFBKAGCeBHFGAGAECDBfBBEhADAHDFBZGCAdGHAhAAAAAIB..IDDAhBAACFED.XDFD.cFCA.OFHDhCAA.SGGDhCDA..,2,-14,-9,5
ABKUCYTcaMPQeFNWbEIGOLfgZHVJXSDRd,KAAACAAA...TADAaACA..MAFAeAFEFBCB..bBFDEBEAGCAAhAAALBHBZCCFHFDChACAXCEADCIBACFBBDDDcGFDhADAQFEA.IHCAfHCBhAIAgGGB..hAAA...,1,10,-36,46
aQZYWUbDOVEGLJCMRPfceTSNdAXFBHIgK,BAAAHAAAKADCZACAUAGAOAFCGCCALCAA.MCEARDAB...hAAA.fDHAhADAeCHFTDEAdEFAACCBFEDHaFAHQFGBhAAA.YHAAbFDDEFHF...hAEA......hAFA...,2,-17,-1,16
NgPIRWVXfQAEBZOYJTDCeSUFHbMKdGcaL,EAAAZAAAOACA..TACAeAFAFBHDHAEBKCCDGBGA.aAGAhAAALCFB.gECAhABARDDBXEAAADEABEHAhAGADEIBSFGDMHEA.dGBD.NICB..hCAA......hCBA...,1,5,-26,31
KURdYMTCPGSHJecWFgXEIQVAaDBbNfLOZ,aAAABAAA.....bACALADAZAFBRCAA.dAHA.MBBBCAHAGCGAhAAAHCCAeCEEFDEHEEABQEABhAEA.ADIBfEEAhAFAKECBTGFA.SEHD.hACAcGEB...hADA...,1,-6,-22,16
BgFXPUYdGEODVJWMSRLZaeCHKIQTfcAbN,BAAAXAAAUACAGADADAFA...VAFAMAIBLDAAZBEB.hAAAeCHFHCGBQFAAhAAATEBA.ADBAbDFDFFFBdGDAhBCAEFDAOFHDSGHB.aHBG.CDDC..hABA......hADA...,2,-17,4,21
YXEUALZHPGKMdgcDJTBVRFbWaCOeISfNQ,HAAAGAAAdADADADATAFARAEA..FBHDaAHDeCDB..SCAAhAAAQDFCECEFAAABZECFhACAMDDB.JDHBBFGAbEFDOFABhACAfGHAXGDDPHAC...hAFA......hAHA...,1,-1,-14,13
YZFTaPQVLDBKESfMORedHIgUXAWJNcCbG,JAAACAAAGACAZADB.FAEA..aAFD..QBGALAHBKDAAECAB.hAAA.MCFBRDEAHFBAUEGAhACAABHB....NEIA.bEBAhAHA..TGFADGDBfGFE..hAIA......hBCA...,2,-22,-19,3
cYdFIPCTXLZSNRMJEAKDGVfgWaUeBOHQb,GAAAVAAA...fADAaADABAGAHBDAQAFA.bCDDhAAAdCHA.FDDH.CDGCTFEAhAAAZCFAREGBEFAA.AAIBDDABhACAgGAAeHBAcGEAIGHA...hADA......hAFA...,1,2,-18,20
NECQbdTHBcPKRAVLOfgWeSIJXaFMYDZUG,LAAAOAAA...fAEAeADASAGAJAGB.aBBCMAIBhABAZCDBGCFAECAAbCED.hACAHEABBCDDKCHBADHBVEAAhAEAgFDA.IFHAFEHDDGABCGEAdHADcGGChAGA....hCAA...,2,-10,3,13
fcBdVWYNCPgJRZUOeMSaLTFXQGHbIDAKE,EAAABAAAdADA..VACA..NAFA.CAFB...JAGBRAGFZCAA.UDGBhAAAeBCD.aBHDLEEBhACAFDBHGEDAHFCDDFFAACFBKGGAhAIA..fFHA...cGAAhAAA....hAGA...,2,-27,-20,7
NLagCVPWEOXZQRJUDbAHMfBSGTKceFYdI,HAAAMAAABADAGADAKAFAeAFA.dCADLAHBaBGE.CBBA.PDFAhAAAECDA.ZDAERCFBDDCBAEFBTFAAhACA..FEEBIFGAhADAVFAB.OFHDQFGA.JHCEhAFA......hBAA...,1,12,-22,34
NBIFWeKJdRcbSfUMZTACXQHLPEaYgGDOV,QAAAHAAAEADEaAFAGACB.OAFABBFAFBHDeBHFdCADRCDASDAAhAAAMCEBADDBLDFBhAAAgEFBDEHBIHHAhACAKGCA..........hAIA......hCDA...,1,-5,-21,16
aeZUgYfLGbMdNROHVFPBSQXDICKEJTAcW,aAAAeAAAZACBUAEA......fAEAbAGDdBDC.RAFFHCGBhAHAFDEDSCCDhAAAQEDADAIBKBBDEEGAAAIBgFFBhBAAGGBBMFIBNICB.OGEA...hCAA......hCIA...,2,-13,-4,9
BgYUeHFRMLGKIDSbPZXOfcWdJaQAVNCTE,CAAAEAAABACAUADAHADB.RAFA.GAGA.DBCBSCAAZDBA.hAAAOCFEfDFAhAGAdEEAaDDHAAIB..TFBAhBDAeEHBMFABLFGBbGEA.......hAAA......hACA...,2,-20,-14,6
TJKMHNEaWZUDReOPYXgGVSBCdFfLAIcQb,QAAATAAA.MADAHACB.EAEAZAEERAGBeCABOAHD.XCBAhAAAGCEABDHA.hBCAdFHALCFBAAIBbGCCKEDDhAAAaDHHDEABgEDFCGGC.fGGAhBDA.....hACA...,2,-5,5,10
ebJTKVOCXPLgHURESZAdBQWcFIfMNaDGY,dAAAQAAAFADA.MADAaAFDGBGA..eAFAJBDFKCBBCBDALCFAhAAA.HDBAhBCAEDFBAAHABEFA.IEHAhBDADEIBTGGAXFEC.gGCDhBIA.SGHBhCAAWFFD..,2,-41,1,42
ZAHUYIQeXFcaOMGKNJPfVWRTgdDLSbEBC,HAAAUAAAQADAeACEFAFAOAHDGAGAKCCAJCDF...VDABhADARCEFdECA.LEGBhAAA.EHDAZDFFAFGB.XFEDhAGAMFIB.fGBA.WHFA.hCAADDIB.....hCCA...,2,-9,-4,5
FeEISOAaNUHTcZGYfMQgBWVCPKJXbdLDR,aAAAHAAAZACBGADA.MAFAQAEABBFBCBHAKCADXAGA.hAAAdDEARDEFECCBOBBBADGAUGGAhACATCGA.fECAhAHA.gEGAPHBA.bGECFEGEhADA......hBHA...,1,-1,-8,7
dLKeEWUgaFHVRIABZYCJMbfOcXQTDNPGS,ZAAACAAA.MACAOACA..QAFADAGAGBCAdBHALBFAhAAAEBEBUDEBaCBBHEGB..hABARDGBABGABCCD.YFFFhAIAbEED..fFDA.cGGDhBCA...NECA..hCAA...,1,-16,-17,1
FcDMXICZHbgKOGAVQLEfdPWBRTUJNSeYa,LAAAEAAAdADABAFARADFUAFA..SAGHeBHHFCAA.MAIBCDDD.hABAHCBAKDFB.ABCAQDEAhAAA.fDHEhAFATFDANEIAaGGBXFCA.bFGDOHBChACA.....hCAA...,2,-18,-18,0
ZIOXSRUMcedWHTabABGDfLgQEJYFVPKNC,GAAALAAAEADAFAEAKAFAZAGB..OAHDRBCAMBIBeCDA.HDEChAAAaCABBDEADDABQECChACA.VFGBCEDDSEGBhABAdHAB.bFFDACDAfHDBhADA..gGCAhACA..,1,4,-21,25
OHNAeUZCRDgKfWGJMVcQSLadXPFbIBYET,eAAAZAAARAEAKBHBGADA.MAFAQCAALBFBdDDAFBHBBCFAECCBHEFChAAAAACA.DDBB.fFDAhABAVDGB.aGGChBDAbFAB...TFEANIDB.CGHA....hCAA......hCBA...,1,3,-20,23
bXLDNdJeBYgQHIAEOTPafScGWFZVMKCUR,EAAATAAA..aACDSACBGAEAZAGBMAEACCBD..RDDBLEABhAAAdBEAeAHFBCCD.hAEAQDFDHFGBAAGBfGEAhBCAFECAKFGDbGBADBIBYFHB..hAAA......hBGA...,1,-3,-14,11
YOJZEPbTQRCLANeXgfHGIdBKFUSVDWcMa,eAAAXAAAHADAdADAFAGA.UCDBDAFAMAIBOCGB..ZBEBEDHF.hAAA.TDBARFAAAAAA..hABA.fBGAhBDABEEDSFGAVDGBaFFHPHCACHHA....hAFA......hCAA...,2,-18,-11,7
FEPGNQDdeTfKMUOALWBbaIHCJZXgRVcYS,LAAABAAAaACAHAEBZADBRAFA....VCABSAGA.EBCBhAAAGCGAQCGAhAGAeDEFTGAAMDBBADEBbEFChAHACFCAXFFD..gGEA.hABAFHGEDFIB....hACA...,2,-13,0,13
LVHIZefDUESWKGFBdTNAbROJPYaMcCXQg,RAAAOAAA..PADAaADD..MAFACAGA.QBFALCCAHCFBhAAAeBBBDBIBEBHFKECAhABAGDDAdFFDADIBJFBB.XFGAhBAAIHHAfGFE...hAIA......hCAA...,2,-22,-8,14
UcJKFXDABWGbTHNLCfEOMQVISePZYgRda,GAAAHAAALADBEADAMAGBQAFA.SBHBhAAAeAHBZCDBRDGBaCACUGGBKCFDDDHBhACAAAABbFBCTFAA.fEEEhAFAOFEDIDCAgGEA..hAIA......hCCA...,1,-1,-7,6
EDMNFAKQCaVOGPYUTXIfWLBecSbJRHgdZ,QAAAaAAAGACAUAFA..TACA.fAEBhAAALBHBeBBDbAGB.HDFBhAEAZCDBECFFMEBBABIBCDHAOEDDhAIAXEGCBFHASFFD...hBAA......hBEA...,1,-1,-12,11
EWHBKcFaRPdXOAVTIfLgJeDSZMCGQNbUY,TAAALAAA.eADHZACBGAEAQAFAUBGAECAAHEBABAHAFCAHhAAARCEBdDGAAAGA..fEGAhACADCIBMEEBbFAAKFHBaFFHhAIAOFHD.........hBEA......hCCA...,2,-6,-2,4
CWJHMRcebIXAVdYZPONaFgKUGLESBTQDf,dAAAZAAAOACAaADA.KAFAGAFA.EAHBTCDADBDB..CCBAHDEBhACARCFFeCCD..bDGDAAHAVFGBhABA..PEBAhAIAFFCH...........hBIA......hCAA...,1,-14,-24,10
RUgVCFbWeOcHPNGIQEYfDKdXJZaTMASBL,LAAARAAAUADA.CAEAFAGAeAFA.HCECGBEBECCB.DCAA..dCHAZCAEhABAaEEBADEABDGA..hACAbFFAODHD..hAEAPGAAQEECKHFA.TGGAMIBA..hEBA......hECA...,2,-22,0,22
UdILXVcHWOMBNQDKRFAPCTeYSGbEfgJZa,TAAAeAAAGADA.EAFAJACAZBGBdAFALDBB..XBGDhAAAHDEBMCIBQCCAhAHARGCAAAAACFACSGGAhAFAbDFCaFGA..IGGA.....hAIA......hBDA...,2,-17,1,18
VJWECSRAZXKcfMLGTDYeINOQBHPagbUFd,ZAAAKAAAMACAGAEA.DACAeAEA..OAGFHBCAaAHDUDGBdDEA.hABAJCGFECCB.REBBAAIBXFGAhAAALHFA..IHBAhBHAQFFBBGFDgGAD.hCAA......hCBA...,1,-6,-22,16
TLRKBJPaMNecHgbIAFQZOdEWSXCVDGfUY,ZAAAEAAA.SACECACA.GAEAUAEATAGARAGBBCCD..aDEHeCCBhAAAHEGB..bCFAAAIBQGAAhABAdEBA.hAIAXGDAfEEA.LFGB.hAGAKGEA.MFIB..hBEA...,1,-2,-17,15
QSPDHNIfFBGcJaKAUbdXeVOMWYEgRZTCL,dAAAeAAAMADAEADARAFAZAEE.LCCA..QCCADAIBHCFB.hACAfCFEBCHDJDBFAEEBhBAAbCGD.OEFH.hBCAgGAATFGASFFDIGHA..hBDA......hCDA...,2,-21,-5,16
gHSPJOIDecCYZAQLbWfaBKMRXUGNEVdTF,LAAA..bAAAaADDMAEARAFAGCAAEAHF.dCFDFBEAHDDASCAAhAAAOCHDeFADhABACCEDACAA.QFFAhACABCHAXDDC.VEFA.TGDA..hABA......hACA...,1,6,-24,30
AaDCPKSOLUNMfIcXRdJFVZQBEgTHYGWbe,aAAACAAAKACALADA.UCCAMAEA....IAHARBDAdBGAFCAAhAAAZCFAEDDBHEAA.GEFAhAEAeCHHAAIBSBBDhAFAODFB.fEHEXGFA.QGCAhBAA.BHHA.hACA...,1,12,-36,48
ZePfAHNEODFgRLQIXaTGUJCcbYBSWdKVM,HAAAEAAAFACDRADFLAFB.QCABaAEAGAGACAHA..bCGDSBDHhAAA.dDFAhAIAMDDBeDHHACIBDEEAXFBAhBFATGGAUGGBYFCFKFED....hAAA......hACA...,2,-10,-6,4
TORcSeAXNHbaEVGQDBCWgLfYMdZUKPJFI,HAAAEAAAGACAQADCCAEA.LAFBMAGBZBGBKAHBFCBHTDDAhAAAREDA.eCABAAHA.bCGDaDHDhAAABCCD..fEAEhAEAdFCAPFFBOFCBSHAGXGGAhBCADGEB......hCAA...,1,18,-14,32
GMeCWDKFfgBSdIQAUXTcEPYaJHNLVbZOR,TAAAEAAA..aACDHACBLAEAZAEARCEAeCABDAIBFCBHBAHB.dEEDhAAAAAFAUCFA.XDDBhAAAPDHDJFAF.bFCChACAGECA.MEIBKGGA.SFFAhBCA......hCAA...,1,7,-22,29
HBSFLPWRMgZCAQYKfDJcXdGbUEOTNeIaV,QAAAKAAADACA.JACEdAFA.GBCAUAGA.EAHBOBED.eCDDhAAAaCFEHEBBBDGALFFAhBGAREEAMDIB.ZGDAABEA.hAAA.fGGA......hAIA......hCAA...,2,-21,-20,1
JZCVOgGeYNAQPXKBcEWDadFSRILUMTbHf,QAAAKAAAEACE.aACEdAEA.RAGBLCCBUAFAMAIBHEDB.ZFFBhAAAOCDBeFHFAAIBBDAAhAAADCGBFGAATDGA.bEEDhADACDHA...VFBB.gGGB.hAGA......hCAA...,1,1,-10,11
SVWLYAeJCZMFNdEGQgXIKBHRcfUPbTDaO,eAAAZAAAMACAdAEAEAGAGAEB..QBCAXCCA.BBHAHCFChABARCFBUFFBTEFAaDHFSEHHhAHALGAAAAAAFFCAhAIA.IHHA.......hAGA......hCAA...,2,-17,0,17
TXILVGbaMKRWYQBAEUSDOgFdCNcHJePfZ,EAAADAAAFACDdADA..CAFA.HAEA.eAHHZAGB..TCBALDDAGDEAhAAAaBBHREAA..QEGChAFAAAGAODHDNGCBPFCBhBCA...fGHAXGFA...hAEA......hBAA...,1,-12,-20,8
YgDcVPNfCIKTOaASUHWMEJZFebRBGLXdQ,HAAAEAAAZACBeACEBAEAGAFALAGBdBHAQCCADAIB.PEFBhAAACBFAKCED..aCBBAAHASEHBhAFA.hAAAMFDBbDFARFFAYHFG.....hBCA......hCAA...,1,10,-32,42
IJHETKOVRLUbQWeDZCGaNcMAYXfBdPSgF,XAAAdAAASADAFADA.HAFBKAGARBCFLAHB.QCBAhACAeCEAZDFEaEEHMDABAAAABFCAhAGAgDDB.hAIAEEGATGFAOFDB.bEADCHDA.GGEB.hCAA......hCBA...,2,-24,24,48
dZQgUeXELTKHbcIDWSVAGPRJMCFaBYNOf,RAAAMAAAFADABAGA..OACEZBFE.QAFCeCCBLDGBhAAAHCCAbCGDDCEB...SAHBhBAAADIBGGABCEFAaECChBBA.fFEA.dGGA....hCAA......hCBA...,2,-32,-13,19
EDgZMYONfKQRAXCUcWVSdLFaHPTBIeGJb,CAAAUAAA..VACAdADAaAFAHAFB.BAHAeAHHGCAA.ECCBZBEBhBAA.MCGBOCHDKDBAADDAhBCAXEDA.SEGDhAAALEHBFFFHIHAADIDA.YHDAhACA.fGHAhAFA.,1,-21,-22,1
ATLZIYefdGMJNHbUFCXEgBScVaRDWKOQP,ZAAAeAAAGAEAMAEAHBCAFAGA..ECAASAGA.aCEERCGBKDDBhABAQDGAAACATEAAhAEALEBA.fFEAhAAAdFFAbGBACHGA.BGFADFIB.OHCC.hBEAIHHA..hABA...,1,-5,-12,7
LfdYEbTaQHSMPXIJDgFVBNZAUcOWCKeGR,OAAAKAAARACFLAEBdAEA..EAGA.aBBCHAGB.MCAB.XDEAhAAADBIBFCFDBDBAhAGAAAGBUFFBCDDAeCHDGECA.hBAA.bFFBSEHB..IHHAhBDA.....hACA...,2,-23,-14,9
PZIARBDHLdGMESfYWCFaXcgbJUQOeVKTN,RAAAHAAAGADAEADESAFB..fAFBCAHAFCAH.aAHDhAAAXCCA.bCEDhAAAQCFD.hACAeCCBTCGAZDAFADIBLFHBdFFAMFIBcGEAhAHAJHAA.....hABA...,2,-9,-1,8
dUKOJfbFMLYCgHTVPDAeXGZSNRaQIBEWc,eAAAZAAARAEA.QADAEBHF.dAGAOCABJCCB.FCCHMAIBLDFAhABACDFAHDGB..TEDAhACADEEBAAAAGGBBaEADBFGAhADAUGGBKGCA..bGFA.....YHAAhAEA....hAFA...,1,-4,-10,6
OKJLPEFgZBTdGQVRcXHbIDMaNYUfAeCWS,eAAASAAAKADALAFBEADA.ZBGBdAGAGCCARBEBHCCB.bDABMCIBhAAA...aEFCUEGAhAAAAAHAOFCHFGBDBFFChABATGGA..........hABA......hCAA...,2,-17,-9,8
KLfARgeCaIQbFUGTPEZcNXJdSYWDMHBVO,RAAAeAAACADB.QADAFAFA.GAGAEBEFZCCFXCCC.dDFAhAAASAHHDDIBHFBAOFGDhABALDGBAAGB.aEEAhAAA.UGCA.........hAIA......hBFA...,2,-29,-6,23
VdDFLgMSNAYaIfUGcJZBKCEOXQTRWePHb,aAAAUAAAGACAZADAKAGC..EAEA..QCDARAGBeBBDHCFBdCHALDFBhAEAMDIBAAIBfEAAhAEABDCDOFAATEDAhBAA..PFHBbFGDFFCHSHDAhAFA......hBAA...,1,20,-26,46
SCQMbgPIZFaXWUDROVTeLBGYcfNHKAJdE,EAAAQAAA.MADAbACA...IAHAaAGAUCCA.RBFFOCHDhAAAeBDAGCEB.hADAfDBAHEAAAEFBdFGAhAEACDDDZEFAFHBADGIBTGGA.LHCA.hBHA......hCAA...,2,-4,3,7
KcWVfZDILaNRgPCYdGOAQJBUXeETSFbMH,QAAABAAAeACAEAFAFACEHAEB.KAGAVBGBZCGBLDCBhAAA.REEBCGAAGCAA.hAGAAACAXCCASEHHhAIAbDEDMIDA..fEHAIHHA.aFCBhAAA.NIAB.....hAIA...,1,0,-23,23
LfbQKRMBNYJcXDdHAFPIOUeCWGgTVEaZS,FAAAOAAAeACHGADA..TAEAEAFAZBGBLAGBQDBAhAFARDDAMAIBBBBD.YDEBhAIAXEAA.HEGBhAEAACGBIFHACFFCgGCAaGFD.....hBAA......hBDA...,1,0,-16,16
KZgQbNBfWUAeJacMOFGLITSYPEDCdRHVX,eAAAaAAA.MAEAGACALBDASAEAEAHF.dAHAHDDAKCEAZDFEhAEAbCFABCCDUFAAABBBOEBBhAAAFFGA...TEGAhABADEEBCGCBXGGCQGGB.WFFD..hBEA......hBFA...,1,2,-11,13
QRXABfeLNEZgICVJdFGDcPYTWaUHOMSbK,eAAAEAAAZACBCADA..dAFAGAEA.DAGA..PAHBTCGAaCCAHEBAhAAA.MEGBKDDDREFAABCBLFHBhBEA.gGBAhBGAIFBAFFDDWFFDSGEHhAAA......hABA...,2,-35,5,40
LfIQXeTCZHRFSMGaYdAPbBKJDWUOEVNgc,BAAADAAAOABEEACA....VAEA..gAEBLAHBQCAAhAAAeAHBZCCAHCGBhAGARCDBMDGBaECAAFFAbEGDKFHBhAIAUFDB..fGDA...hACA......hCAA...,1,-13,-17,4
FaZLKdESPGgHOVYJQNADWXRbIMBcefCUT,XAAARAAAMADA.BADAeAFA..CAFAFAHBZBEAdCCA.EDFBGCDAhAAAHEDBOCHDVDABQCGBhABAAAAADFHB.bFCD.hBIA....fEHAaGGH.LFFBhADA....hAFA...,2,-15,-11,4
TANBEQSeYXfbHgIKVWOCFRGLDdUMcZJaP,EAAAeAAA...XADAHACAKAFC.OAHDRAGBGCCAdCCDMCFBhAAAZEAFaCFDACGBBDGA.QEAAhAEAfDHAbFGBhBHAgFDH.IGGAWEED..hAAA......hABA...,1,-10,-19,9
GdPDSgTNJceUEWBIXOfFCQARLHMYVZabK,HAAAMAAAZABEaACAGAEAdAFA.DAGASAHB..TCCAhAAAJCCAeBGHEBGEBDGAhBIAODHDCEEDRFGBLEEBhBAA.bFBBKGDA..gGFH..hBFA......hCAA...,1,-13,-15,2
MHfEVUKdWJYSRDGFLIPXCQTeNZcBbgOAa,HAAAEAAAKACAdADA.JAFARAEFGAGALCCA....XCCChAAATCGAeCABZEAABEEAbEEB.hAAAAAIBaDHD..MEIBhACAfFGEUGCASGFHFGAACGDA...hAEA......hAGA...,1,3,-17,20
bSMDBVNLEedWKYUCFPgHIRXQAGTJOfacZ,GAAATAAA.OADA..aACAZAGBMAFABBFALBDAECDBeCHHhAAAdBHAKDFDCCCDFDEAHDBBREFAAEEBhAAAJFGF....bFBBhBFADFIB.NIBB..........hCAA......hCHA...,1,-7,-17,10
IJTZVYbXHRWOFGNBUgAELCQacdSDKPefM,EAAALAAA.aADDdADA.KAFAeAFAMAIBJBHBZCBA...VCFBhAAAbCAB.HFAA.RFFAFHCAhAFAGCEABHADAAFAQGCAhABADFCA.fEHAIHHA.TGFAhACA.....hAHA...,2,-12,-6,6
SKBGJVfACYRLbXTDgeUaOZdEMPcIQFWHN,RAAALAAA.TAEAeADEaAGA.dCCAEAGEMBEB..ICAAhABAQBGDHCCAKDFDhAAAGCFAVEGBAFCAbEABDHDAhABAOCHF.cECDNIEBSFCAfFHEhACA.CHCAYFFFhAEA..,2,-18,14,32
ABTMLZQYgVePDbadJWRHSINfOEXUFcKGC,MAAAZAAAQAEA..gACAeAHBDACAdCCDRAEFHAGBSCFAhABAfDDAEEEAFEGDhAIAGEFAAEIB.TGAAhAGALGBAPDHDaGHD.IGDA.OBBHhAIA....hBAA...,1,-4,-8,4
OMgdDIbQBAceNFEJPTXfUaRKCHVZSWLYG,eAAAEAAA..JACBTADA..XAEAaAFARBFB.HBGBZCCALCHBhAAAGCEAMDDBdFFADEEBhABAbEABAAHAFHGE..fEHAhAAACHED.SGFH.WFADhAEA.....hAIA...,2,-17,-1,16
EBKPOAUYHfVWLIZJDedNMScRTaFQXGCgb,HAAAVAAA.LADBZADB.eAFAdAGAMAIBRCEFaBGE..FCAHGCEAhAAACCCC.EDAAKDGAABFAUGGAhADA..fFAAhAAAJHDESDGBTFGA.......hCAA......hCDA...,1,-7,-14,7
KGNOBZAUYRCLdcFbEDfIVXPHgWTQJaSMe,RAAAdAAAFADAEADA..DAGA..IAGA..XBEAHBDCTCBAhACAaBHB.eAHHGCCAhAAABDADACCBCDHAbDEC.fEHAhADAVEFB.gFFD.QGDChBAAMFEBOFHDhABA...,2,-31,10,41
cSALKTPJIBCeGDQadbOHRWYZNgfVXFUME,TAAAJAAABADB..eACEGAEADAFAdBGAHAGDRCCA.ZCCF....hAGAfDBEFDGHEFFBACIBKFHBhAIACDHAaEEA...bFCAhAAA...OHFCNIEB......hAIA......hBDA...,1,-19,-25,6
JADPgRFfTISdWOeHcMBXaKbZUCVLQYEGN,DAAARAAAFADA..TACAdAGA..eBHHHAEBMCCAaAGAZBGF.CBBDLDDAhAEAEDDAGDFAACIB..hAAA.fFEEhABASFFAOEHDBGHA.bGBC......hAIA......hBGA...,2,-21,-13,8
QcWRXfZAKdHLUYDETGgMbSOBIaPNCFeVJ,HAAALAAADACAEAEAGADA.MAFAOAGDaBFA.CCCA..FCEBeBHHhABAQDFDRCAAZDEBACAAdFHAhACATGBASGCBhCGA.BGFAIGFANIEB......hAAA......hAIA...,2,-29,5,34
MPNTKFOUdEGIASZfWJYRbHXQDLcVBegCa,ZAAAJAAA.RAEAHCAADADA.LAHBBAFA.eCEACAHA...aEACMBEBhAHA..TEEAOCCBhBAAEEGEACGA.SECBhABA.fGGAbDEDQDGA.gFCFhCAA.KGHBhCBA...,1,5,-48,53
IGdTQBJWSAKHbVFCgLMENYPfXcDeOURaZ,HAAAFAAALADAEADE..PAFAXAGDeBHFRCCAZDFBdCADTCEAhAAAQEAABDCASDHHhAEAADIBKEEDCFGA.MEEBhAFAfGCAOFCDaGHBIHHA...hAIA......hBAA...,1,-4,-11,7
RGAHKJLcgDeSMQWZVNBbUaTIYECXPFfdO,HAAALAAADACAeAEAMAEAZAFEBAHA.UCCAaBCE....TCAAhABAECFACCHA.FCFDdEFARDDBACHAKEHBhAAA...JFAASDGHhACA.QGGANHEB...hAFA......hCAA...,2,-26,-13,13
NXGEMUJQOCSRbLFdITAKDVHPWfeZBgcYa,DAAAHAAA...fADBeABAZAEBBAGA..gAFBhAAAaAHDGCCAECABMCGBQCCAhACASDHBRCEBbDGBhAHAdFEAAAIBKGFA..PEBB...cGGAhBAANEIA....hBEA...,2,-30,9,39
FQRgIOcAaPdCNXHbJLWUKTBYEZGfSeVDM,dAAAXAAAHADALAGBKADA.BCBAEAFEGCDAeCEFMAIBRCFAODAAhAAAADAB..aDCDCAHBJEHBhABATEGAZFCFSFFBhADAFFABQFED.gGCD.hCAAIHHA..hACA...,2,-11,-7,4
AJCaWGLTSBNPXdKcEVIbHfUeRZQgFMYDO,aAAAGAAALADABADA..XAEDdAHAEBBB...VCGBHCEAeCDBhAAARDCBZEAFFAGAMDIBODAHhACAAEGACFFA..SFHDhAEAKFDDbFED..QGGADFABWHBA...hAFA......hBAA...,2,-7,0,7
LBaUSbNDYPAdQOMXeEfCVRgKWcFTZHJIG,dAAAMAAAEADA..CADARAEFKAFA.FBHDHAGB.GBBAaCAE.UDEBSCEAhACADDIBAAIB.QDCDhADAeEGH.fEGAhAHAgGAATFCAIHHABFHA.bFEDhAIA......hBAA...,2,-24,-14,10
DYWTISdbHAaOUcLJRZEgCBXKMFVNfGePQ,aAAAOAAALADARADAZAGB...EAHBBBBDMBBBFCDH....fCCAhAEAeCFDQEAAhAEADCFATDEAdEHAHGCAhAGAADGAUFAAgGGGKDHBGECA.PFGBhAFA......hAIA...,2,-6,-6,0
HCcXAULPODJNaWVbYfeBIQGSKdTRFEZgM,LAAADAAA.aADDbABA..eAFABAFAGCAAdAHARCCB.EBHFZCEBHCDChABA.XDGAhACAADAAODGBNEEA...VFAAhADAfFFA.QGABKEHBFGHHMHDAhAFACGHA......hBAA...,1,16,-21,37
CFGOKEHSIfMcTbgdeQRJaVYZNWLXBDPUA,GAAAEAAAHACASADAMAEA..bBEAeAFH.RBGFaCDBZCCALEEAhAAADDABAAAB.OEHDhAIAfEDATGBAdEGDhACAQGDCVFEBYHAA....hADA......hAEA...,2,-9,8,17
WFQKITOJUZfVGbHgDcARBMePNLCaESYXd,RAAAeAAALADBEADA..SAFAdAFAQCGAKBHB.OCCHhAAAZCCAGDFAHEEADFBBAAAAMECBhAGACAHAaFDHXGCDhAIA.FFHDTGGAfHEB....hCAA......hCBA...,1,-7,-9,2
afZGCLgFJXSPcQMIeBVAdODYHNEKWTRUb,dAAADAAAHABCEADA.KAECRAFAUCCA..aAGDGCGALCCAFDAB.SBHHhAIAQFCAeDFFhBAAACFB.OECB.hACANEEA.bFEDZGFECGAAXGGA.MIAA.hBGA......hCAA...,1,-3,-16,13
GMUINfSOADRXbQeEPHLaJFgCKVZBcYWdT,RAAAQAAAEADE.HACAaAFA.FAFAKBFAZBFEBCCA....cDDAhAAAdDEAGDGAUDGAIEAAhAEASECBAECAXGEAhAIAeGDA........hCAA......hCEA...,2,-28,-13,15
VEPUfTCSgKQIABDbMYReaOHcJFXdWLZGN,DAAAMAAARABA...eACAHAEBFAFDdAGBZAGBGBGA.ECDBUCCACEAA.hAEAKDFDAEFA.BDHA.aBBHhBAAOEHD.XFFDhBAALFGB.NIBB........hCAA......hCBA...,1,-23,-26,3
KEDBWdRSgLVbPJINcMXAGHUYeZTfQOCaF,HAAAeAAAZADBTAEAQAFACAGB.KAHBEBHFBBCARCAALDEBhAAA.VGFAbCEDIDGAhAAAMCGBAACAGEAB.hABAfDHAaDHDDGGA.......hCAA......hCBA...,1,12,-27,39
PBRdfIgEJNGHAQXSYLOFbUKZCacVTWeMD,QAAASAAALADAFACEKAFA.aAGD..TCDAeBHHMCCAhAAABAHBRCFFdDDA.fEAAhABAEDCBGEGAHFDChAEAACHAOFAB.ZFCACEHAcFADDDIB.IGHAhAFA.NIAB...hAIA...,1,-6,-10,4
JAgCLSPIOfadDbNMZUYcBWEeFQRVTXGKH,LAAASAAAOADDdADADAFA..MAFAZAFEUCGABBFAEBHBeCCBhAAARCAA....TDEAhABAGEDAHDGBADBBCFFBIFHAhABAbFBA..cGGC....hACA......hBFA...,1,-15,-24,9
WAMIHTFeNSUbcQRGJELgZXVBKDCfaPOdY,HAAAeAAAUAEAQADCRAGB.EAFEZBAEBAHBCDDA.aCACdDFA.AAAA.MCFAhAAA.TDDASDHHhAIAGDFALEBBhBEAXFDCDFEBOEHDIGGAFHDE...NIBB.hBIA......hDBA...,1,15,-23,38
FJDAEKVbUYXMNWRScGHfCQZOeBadLgTPI,EAAAKAAAUACA..MADARAEAGCEBHAFCQBCAZEEA.eCBBhAAAdAHATFAAFCGHACIBbDEDhAIA..XGGAhAAASECHCEHB.aEHD.LHFA...hAFA......hCAA...,1,10,-24,34
TbBNMHJCFGORPUXLIYDgdAKaSfWEZVcQe,aAAASAAA.EADAZACB.QAEA.eAHBbAFAMCCAhAAAHCGBFCEHRCEAUDAALFFAhAIADDDBAAGAKDHBfGBAhBAAVEFBBHCACBBDOGDCIHHA...hBGA......hCAA...,1,-6,-8,2
JYIPLDeKdFHbOaCTAMUWXScZVRNgfGQEB,MAAAXAAAZABERAEF......fADAEAGEBCCAJCGBIAFAhAAALEDBKAHBHCDAhABAOFFBaCFA.ADAASDAAhADA.cDGDNCIA.GGEBhAHA......hCAA...,2,-32,-18,14
HURSIGMOVAKXEfDbCcBTLeNYPWZJdgaFQ,EAAADAAACACABACA.LAEAeADH.....PBHDZAEBdAHAaCCAhAAAHCFB.RFFAGGBBhBAAMCFBAAFAKDDD.bEFDNBBA.hBGA....YGCEWCCD.FEHH..hAIA......hCAA...,2,-24,-20,4
OgQfeDaKFIRYScUCWAdGLXEBTZPHNbVMJ,GAAAEAAAZACBHAEA..bADAMAIB.OCBHQCDADCGBaCHHhAAAFAHB.RDFFSDADhAAAUEDAAAGAdFFABHGATFDAhACA.PDCB.JFHB.eHDA.KCHB.hBCA......hCAA...,1,17,-16,33
CfFeRLJYHGTNPSEcbgQWDVZKOUMadBIXA,FAAARAAALADBHACBGAEB..TAFASCEHEBHF.bCGDQDEAhAAA.DCCBhABAZEAAODHDaFFCdHABXFAAhAFAADIBfGDAeGEAYHAA.hAEA......hAFA...,2,-12,0,12
bCQaWRGdYKTNgHOeAVXfMDUFEJcISBZPL,XAAAMAAAFADD...EADAJAFA..SAFAZBBFLCFAbBFA.hAAAQDDC.hABAREGBdFBATCDA.HDAAhADAAEIBDFFBIDGACHCAaGEH.GFEB.KGAAhAGA.OHFE..hAIA...,1,-3,-18,15
AGTNOJgRQFScMVXdafKCDbBWeIYHLUPZE,GAAATAAA.OADARACF.QAGASAEBMCDAdAGAaBHDCDDABDFAhAAAeCABHDBBLDEBhAAAZDGBAEIBJFDBFDGHXECBhACADFFB.bGBCIHHAPFHD....hACA......hBAA...,2,-9,12,21
ZRCcQeJHEaOAgfXLDKbIMYTPBGUFSdWNV,XAAALAAAKAEA.MAHBTADA.GAFASCAAdBHAVDAAhAAARCEBQDCDhABAHDDBEEHBAAHADAIB..bFACIEAAhACABFGD.FDHDNIEB.ZGAA.eFGB.aGCAhAEA......hAGA...,1,12,-8,20
cIUdeKMXWBSLHFAOYPGQaCNRbJTfZEgVD,OAAAGAAAaADARADA...JAGBZAGB.EBBBDAIBUDDAdCDA..eCFDhAAAMBIBBDHAHEABAFFB.QEGChAEACEBA.bGCAhAGATGAA.fFHA...hBAA......hCAA...,1,-9,-29,20
VRagDOFbXIcGHMZAJELSNfTPBYeUQdCKW,EAAALAAA.SADHTACABAEBeAFAdAGAKBHBRCCA..aBHDOCABhABA.FCCHbDFDXCFChACAGGBBMEIBhAAAAEEBJEGB...fEEAPFAC.YHEGhAIACGEA.....hAFA...,1,1,-22,23
ALJFeEVZRfgOaHBdTGcSQXbCYWPMKDUIN,LAAAeAAAEADARAFAOADD.HAFAdCCAGCGAQCAACCFD.PCFBhABAMEEBDFFB.UGAAhAAAAAHAFCHB.ZFAAaGFDTFGAhACA.SDDD....hAFA......hCAA...,1,-4,-17,13
PLQEURgJdWYAKGZfITHSObBeFaXNVDcCM,ZAAATAAAHAEA.OAHDeACEFAFA..aCAAXBDCDCEB.MAIBhAAALDAAUDEARDGBdDFAhABAACCBGGCBSDHDhACABHHAcFEC.QGAA.EGGEhADA......hAEA...,2,-11,-7,4
WLQKDSgTfabEJCcYNdPFRHAUBXGOIeMVZ,XAAAGAAAeADAZACBLAFAQAGADBEBTCDA.aCFDECFAhAAA.CCHA...cDCChAAAdEEARFCBHGFAAADABDHAIGAAhABAMFCBKFFASHAAfGHA.YHDAhACA...hAGA...,2,-15,5,20
WKcFNOQCYRAaXEZgMdIGLUDSHPBTbJefV,EAAAZAAAdAEAGACALAGBDAEAHAFCBCAAJCBFeCCB...VEEAhABAKCGDFDHD.QEDAhAAAREBBAACA.aFFDMAIBhBEASHGA..PFHD.fHEBhBGANIAB...hAIA...,1,-13,-15,2
EPRfCBdFeIGKXcaAbgJZMNDLYQUTSWOHV,JAAAZAAAMACALADBUAGA....TAFAOBDDHCEB.EBHFhAFARDEFBBFCdCCC.eCCDhABAGEGAKDGC.aGDAAEIB.NHABDDIBhAHAQGFA.......hAIA......hBAA...,1,-8,-26,18
EXLVDCgIPTfOWBcQUbNaZMRAYKeSFJdHG,eAAAFAAAHACBEADALAGBCAEA..IAGATBEA..OCCBhAAABBHAQCEAhAEAUEDAaCHDRFFFAAIBSDGBhAIA.dFFAXGBCDDIBfHGF.hABA......hBGA...,1,-10,-25,15
fQRAgMKUeVabJYFCBZWdcIOHEDSLPNGTX,MAAAeAAA..aADDJADBFAFAZAEB..dCFAOAGDHDBAEBHF.LEHBhAAAGCBA..TDFAhAIAQFBBABBA.KFFAhABAbFFABHFA.WFDHDBIBSGBAhBAA.PHFC.NEEA.hBGA...,2,-23,-2,21
eLWYFfcIMdZJGXPbAQTUgSCNOKaEVHBRD,TAAASAAA.OACDEACEHAEB.RAGBeCCBLAEAFDGH.fBHAhAAAMDIBZEABGEDAhAAAbCDDAAFA.QGGChAEACCFAaDGEDFCB..cFED.dGHA...hAGA......hAIA...,1,12,-13,25
TICSVZAadcRfJMOKELPgUFQWeYbNXGBHD,dAAARAAAMADAEADALAGB.UCCAQAGA.eBDFbDABGEDBhACAHBEBTDGAhAAASCHHACCBaEECfFHAhABAKFCDFFHD.YGCABGEDDGGB...hBIA......hCAA...,1,-7,-11,4
DTRaMNIFZKCVLHBPQUJdXWAbgYScOEeGf,...bAAASAAA.EADAeAEAGAFATBGARCCAMAIBFCAAZCEFhAAACDAAHDGBQDGBhABAdEEAAAAA.gEAAhACAOFBAaGGCKDDBLHAABFHA.....hAEA......hAFA...,1,6,-7,13
NMgIOFcPTYDVSBJfRAbHQGXWLadCEKUZe,HAAAGAAALADBdADAEAFAZBFEeAFA.MBIBODBDFCAH..TCFAhAAADDDBBDGAREEB.AAABQEEChACAaCCBKEGAUFAAIFHAhAFAPHCCSGHBbGDA.CFCA.NIAB.hAIA......hBCA...,1,16,-16,32
AeWPUBKSJHYcbfGZgaQOTdCIXDLFRVENM,eAAAUAAAKADAHADA...bAGBZAFB.aAHDTCCA..dCDAXCEDhAAALDABREFAEFAAhABAADHABEFASGCAhAFA..JEHBfGHAGFCBOHBCDBIB.hCAA......hCBA...,1,3,-27,30
VUCbDaJeONXfEHTWLYQGPKZdRAgSMIBcF,MAAABAAAFACAUAEADAFA..eAHB.OBBAXAGA.HBDChAAATDDALCBBGCGAhAIAZDDAACCBSFDAhBAA.IGBACCGAaDHDfFFEEGFF.hBGAYHEA..hBCA...,1,-7,-38,31
YFVeTHAaIRBMJXOEQKfDdgLWUZbCPNGSc,RAAAMAAAOADAKADA..dAFALAHBZAGB.CBDAGCEASBBBFBGB.hAAAeCEBHEGB.ACCBaDDBhABABDCA.EDHFDIEAgFGAhBAA...WEED....hBIA......hCAA...,1,-16,-32,16
fcUCEPMGSFKTOAIYBXHVgJDbQdWaNZeLR,BAAAHAAAVAEADACAdAFA..aAHDeAHB.RBCB.UCAB.EDDAGCGAhAAAKDFAADHA...XEBChAIAbEAD.QEEChBCAZEFEfGGACGDDMFIB.FGGH....hBEA......hBFA...,2,-18,-6,12
RfPHbGOJgeAXMFaZDEBTNSQVcdWCLUIKY,MAAAZAAAEADEBADA..TAGAQAFAdCAALCCAKAHBRBBBHDEAhAFAGCFAODHDeDHHADGAFECDhBAAaECASFAAhABA..cFGCCGHAIHDA.YFFFhACA....hAFA...,2,-16,-6,10
AHIJMESBbNXCdLUGePTcZVDYWRKOaQFfg,HAAAMAAABADAXADBdAFAGBBAeAFATCCAZAGB..DBIBRCEFaBGEhAAAQDECFCAH.ABBB.hBAAEDGA.bFGBLEHBhBFAcGAA...YECB.OFGBhCAA......hCDA...,1,14,-19,33
HfXUZMSLBgcERYKIQTPWFJGaeAVbdCOND,dAAAOAAAHADAUAEAZABBMAFALAHBBBGA..EBBBRCEBKCHB..hBAATDCAFDCDGEGAhBIAABDACBGBDDGBSEEDhCDA..gEGH.IFEAhBAAWGDG.aGHD....hCAA...,1,-7,-32,25
ebDEBMLdPfagOZQXGVJUNFCHRYTcWSKIA,eAAAEAAALADAdAEA..aAGAZAGBGBCAUCBACCFCHBFB.REBBTEEAhAAASCHH.AAEABDDBhAAAMCIBfFHEhABAQEFCJFHBFGGHYHBG...hBCA......hBIA...,1,15,-26,41
cLEKNTIGOgaeHSUJBAFZbDXYRQdVfWMCP,ZAAAXAAARAEAdAHA.....VADAMACACAGBLCDAECCB.KBHBhAAATCFAGDAAaCEHHDFChABAUFFAADABDEEB.QFFChADA..WDHHNIABIHHAhAIA......hCAA...,2,-27,-2,25
FcTICREBDeUHJYfKVONXgaZMAPQWGdSLb,QAAAdAAALADAFACE..TBGARAEFEAGEBCDDeCAAHCEB.hAAAfDHAOCFDXEGDhAIAZEAAAAHAGGDBhACASCHB.IHDADGGA.JEEF..hCAA......hDAA...,2,-25,4,29
NZcFLSMJTHCWKIgBGfbaDXeAdPQYORUEV,dAAAQAAARADAUAGA.EACAZABBLAFA.MBEBHCEA.KDCABCFAhAAAGEAAaCGDeDCBhAGAADIBOEFCVFEA.FHAATGGAhAEACEHA..IHHAfHEBDIDA..hBAA......hBIA...,2,-16,1,17
gHIRWaMSPOGdDNXYCJBFeTfALcKVZEbQU,LAAAKAAAEACE.QAEAHAEBRAGB.aAGEMCCB..OCAAhABAdDDAXDGACCEDFCGDeDDBhACAAAIBZEAFUEAA.gFEHhAEASFEADCIBYFHFBGHA.fGDEhAAA...hAHA...,2,-12,-9,3
aVAWKfLUXQDBZRSIeTJMEFPNdYgbCGOHc,KAAALAAAQACCZADBRAFA..eCAAMAEAECFBFAHD.dBFA..bCGDhABAGCDA.HDGBhAAAaEEBACAAfFCAhCAADCIBSFFDTGEAPGAA...gGGBhACACHHA...hCBA...,2,-11,-2,9
GaVMgdbDILCcZUWJQREYFBeKAHXOPNfTS,HAAAOAAA..fADBGADAaAFAMAFAdBFADAIBLBGB.hBAAZCAAUDBAQCEBhAAAECHBBBBDABIBXEEChACA.TFGASEFAbFCD.CFEDcGEDhBDA.....hCCA...,1,-1,-23,22
YEOdfRIUBVWecGPKSCLDHTJbNXZagQAFM,MAAAEAAAdADARACA.BAFA..eAFEGAGASBBDLBCDHBEChAIATEDAJCHB..bDDBZFAAhAAA.aCFHAFFA.OEHDhAFAfFHAIGFA.......hBAA......hCAA...,2,-22,-7,15
DKQCZFcUdbNJgAIOYHfLRXePaGTWBMESV,OAAAHAAARADFeAFEGADABBFAEAFA.DCABQBGAZCFE.FBBHdEEDhAAAJDFBACCB...fEHAhAFALEHBaDADMDDBhAIAKHCACGGD....bFDDIHFA..hACA......hADA...,1,-3,-19,16
feCSIRVOEWUZXdJGKFTYNPaADgBLQcMHb,BAAALAAAMACAHADB.eAFASAEARCAAEBHFZDEBdAHA.GBCAhAAATFAA..PCFBhBCAAAFAQGCD.hBHAbEFDCDHAOECH.XFGA.FGFHhCAAaHGEDEEB....hCBA...,2,-21,11,32
baKORWZJeEIdLAHcQUSTgDfCMPFXYBGNV,HAAAQAAATAEADADAMAHBFAFD..BAHAGCAB.VDEAaBDBRCDFhAAAZEAA.EEHFdCHAAACASGAAhAAACDFA.XGGAhAEAbFFAOHAA.eHDAcGCD..hAGA......hAIA...,1,7,-19,26
ZefgNVHXQWdIDCKTYbLSEaORGPMcUBJFA,eAAA..fAAAVADAHAGBQADAdCCACDFA.TAFAhAAALEEAEBCBRCABGGABhAAAMAIBBCGAAAIBZFDANDIAXDEChACA.DEHBKHGAbFDA.aFHD.OHAAhADA......hAHA...,2,1,1,0
HDMQIfUNOaCGETRPSdFcBKLXWgAVbYJeZ,VAAAJAAAHADB.DAFAMADA..QBFCUBEAOAGDGDAAhADARDCB.dDHABDHALEEBhAIAXEEBABIBeCCBZGFE.hAAAfGGA.aEGB.EHBA...hAIA......hBIA...,2,-28,9,37
RUZXdTDNPVJBQAgcGYObHFEWMILaKeCSf,GAAAOAAAHADAEADAMAGBaAFA...eAHBSAHHRCDBZEGBdFBATCCAhBAADDAB..PFDBhAAABBBDACFA.gDFAhCAA.bFDCFFFBLFHBCDCD...hACA......hADA...,2,-7,1,8
dJHOfREXBGbAQCTFMSNcPYaKZgeIVULDW,TAAAMAAA..SACA..PACAaAEDZAFBeAFAUDCAhAIALCCAdBHAHEEBRCFFEDHFhAAABBBDABIBQECAhAGAFEHB.cFFCKGHBIHCADFIBOHCAhCAA......hCDA...,1,-5,-13,8
fWOcGKAHNDIbFBVMQSLgJPTXeYCEZaRdU,HAAADAAAFACDMACALAEAJAFB....TCCAeAHHECDAZAGBREBBdDFAhAFAUEEAOBBH.GEGAhAGAABEB..bGFAQGCAhBAASDHH.......hCAA......hCGA...,1,-9,-16,7
DPQSdBNGLZKRVHeTJIFcgfEUACMYbXWaO,MAAAXAAA..aACEDADA..QAFAdAGAGBCAZBBARBEBHDGBhAAAeBHHTDEAFEBBfEEEhABAADDBCEHA.bGBAOFAAhAFA.BFGDKGGD.IGDA.EGHFhAIA.YHBA.hAIA...,1,-4,-10,6
GSTRaACfJUeYLdKQOcHZBbVgXMFDPIWEN,CAAAUAAALACAdADAKAFA..QAGAHCDCZCGBBAHB..bCCAhAAA..XDBChAFAMCGBDCCA.IDAAhADAEEEBGGCBREAAADHAeEEB.OEGDgGGBhBAAFGAHNEIA......hBCA...,1,3,-19,22
VYQNeHEBgRAPTWSfbUFCZcLaKJMGDdIOX,TAAASAAA.UADAZACBaAED.MAGBdAGAXCCC.hAAAQDEAHCGBEAHBRDEBhACAAAAA.fEBAhAIACCHALEGBKEDDGFBBOFHDNEIA.BGGC...hAIA......hBDA...,1,4,-17,21
aHOQYFIgGWCNJSZfDXEAeKRcdBPbMLUTV,RAAAdAAABADBMADALAFAUBDA...aCCAHAGB.QCBAhACAFCFAGDDBCDFA..SDHHhAIAZFGBXGAAAEEBeFCBhBAAKGFD...bFFC.OHEE...hAAA......hABA...,2,-27,-3,24
TNXaVHRcEBGIbZLDedKJPfSFCgYUMQOWA,TAAAaAAAHACB.EAEAGACA.ZAEAeAGFdCFAKCADJBHB..SBBDhAEACAHBUFAA.MCFBhAIAQEDDADEB.XEGAhAAAREFFBFHAIHHALHDAfGGBhACA....hAFA...,1,-9,-10,1
ASVQMEJKNIUHecZTWbYDaLGdCfORFgPBX,QAAAEAAAKACA.UADAHAEBZAFB..bAGBaAHDGCCA.dEAAhAAAODBAREFAFFEHBGBAhAEAADHAMEEA.JEHBIGHAhBGAeFBA....cGFC...YHBAhAAADBIB.CFFB..hCAA...,2,-12,-5,7
BYTSZLGaXKUOcEeRHbQWfANPDJMIVFgdC,DAAAMAAAFACDdAEABAEA..TAGAZAFBGCDAKBBA..OCEEhAGAEAHF.HDBA.bDFAQDGAhAEAABDA.PFCBhBAAIFFA.CFHD.LFFB.aBBHhCAA......hCFA...,2,-26,-17,9
UXIFOfeSRgQbHGZYJTcCPNKAdEVDWaLBM,EAAADAAALADABACAUAEAFAHB...eBBBRAGBQCCCHCFAZDCBJEABhAEACDFA..KDHBAEEAdEHAhAFA..aEBCMFFBOEEBhAAASGGD..bFGD....hAIA......hBEA...,2,-28,-13,15
bfXPFNEMWHgeOYdUKCQRJcSGVTADaIZLB,aAAAZAAALADBBADA...XAFAFAFAEBBBHBDCeBHHdCAACBHARDAB.hADASCCDGDDAADDBDDGAhAIAbCFD....fFAAhABAMEIBOFGBKFCAQGGAhACA......hAFA...,2,-13,-10,3
bVXdLJHQFDcSPOEfeaZAICWKNBgGRYTUM,CAAAKAAABACARACF..UAEAMAEA....XAGAdBEAHBGBDCABSCAAhAAA.EDCFhACAeCGFAAIB.IDEAhAAAgEEAGEGAbGBCLFHBFHAAOFFHaGGBhBGAWCAH....hACA...,1,-10,-29,19
HDfYWCgGMTIELOeSdbBXaURcNQPVZFJAK,HAAADAAA...fADBCACAGADAMAFAEAFELAHB.eCAAhAAAbBFBBBBDaCEARDDAQEGAhACAZCGBADDB.KFFDhCAAgFDAOHCC.dGGA.....hCHA......hDDA...,1,6,-30,36
OPfYeHRQaBGNAIKFTXcDSEVUCJbLWZgdM,FAAATAAADADA...EACECAFALAHBZAEB..dAHAMBDBOBGHhAAA.fCCAhAEAHCEBREBBaEGDGECAABEB.XEFAhBHASFHHUGGBJHCE.....hCAA......hCCA...,2,-27,-5,22
MHDcVYJSWZaILdNCQKbfEOFeXPRGAgUBT,BAAAHAAADACA..VACASAEAZAFBLBHBdAHAQCCAhAAA.KCEAECAAeDFAhAFARDDBACHBTFAAMEIBcFFAhBHAJFGB...aGCACFCBfGEAFHFC.hCAA......hCCA...,2,-22,-8,14
YRJVabFAOIQdEgUeTZBfGHWcXPCDKSMNL,QAAAEAAAUADAZAFBGACB.HAGBXCBCDCDBMCFB.LDABhAAARCGFaDEH.AAFAdDGDhADAeEHHTFGABAHAfFBAhAAAPEDDSGFDNICB....hAIA......hBIA...,1,3,-17,20
PKFgIMfTJLXVHWaeDQcGZYOdBCSARNEbU,EAAAUAAAFACDMADA..JAEALAHB.HBDAeAHHQDBAhBAAZCDBdDGDSEBBhAAARDEAbFBAKFGA...fFEAhAHAXGFCaBFADFHB.......hBEA......hCAA...,2,-33,4,37
VdeAKfgMZQbLJENTSUPIRDYHWcXaCGBFO,KAAAMAAAZACBLAEA.EBBATAEA.SAGBICDARCEFhAFAHCAB..XBGAhAGAGCFAOBHDhAAAeDGFAEIBfFHEbECDNIABDEEB..cFGDBHHD.hAIA......hBAA...,1,1,-21,22
AeIWgULcPMBDRbGHVOQYKXTJfdESZaNCF,eAAA..gAAALAEAMAIBRADAHAGBQBCDXCCCTDEAhAAAdCFAEDDBaCHHFDABAAIBhABAUFAABDHAGFDBhAAAOFCBKGHBSFGACHFA.IGAAhADA.PGDC..hAEA...,1,5,-5,10
EAbLJPSUVMNCQGBZXYdDOagHeRfFcKWTI,LAAASAAAMAEAQADAZAFE.dAGAaBCEHCCARCAB.FCHDKCFAhABATDAAACHA.bDFDPDDBhACA..VFBAhAAAGEGABEEADDIBeFHHfFEAIHFA.hCAA......hDCA...,2,-19,13,32
SdcbLHWfaTCORZIMKXQPGgVUEYeANDJBF,DAAAFAAAdADALADAHAFA..aCCCTBBA.RAGFZCEFMCFB.QCGAhAFAGEAAUEGAEDBBAAHAhBAABDDA.SGDAhAEAbEFD.CHHA.OEEH.....hAFA......hAIA...,2,-17,-9,8
MBUJRYaPfKbegNdAVSWGTQXODLFEIcCZH,SAAAGAAAQADADADALAGBEAFACAHAHCECMAIB.BCHBRBCA.hAAAaCDHKDBA.eDFBdEFDAAABhACATEDAFFHD.ZFBFYDAFhADAbFGD.NIEB.WEHB.....hBCA......hDCA...,2,-3,-1,2
HQfDIdbcMVFeNLPaZCWBKgOYXEAGTRSJU,RAAASAAAHADBQAFADADA.dBHAMAGBeCCBLAHBZDAFBDGDhAAAOBCCEEEBAEIBTGFAhABAfDDA.bEBD.hADAFEFAaFAH..KFDA.XGGA..hAAA......hABA...,1,7,-27,34
MNbaIVfQPBDcHCKeTZSRFXdgJGOUAWYEL,EAAAMAAA..aACDVADA..QAEADAGAHBBBKBGAeAHBZDEARCDBdDFAhAAAGFDBACBBLEAAhAEA.bDGDfGHAhBAABGBACHCA.FHDC........hBBA......hBIA...,1,0,-17,17
eTUcBCJHDRfSXYALNgKIMZWPQOVGEFbad,LAAAKAAAZACB.QAEAGAEAEAGAaAGEdCAA..eCAAUDGACCEDHCGBhABAREBA..XFFChAAAACAAgDDG.hACAMEABOGACbGDABHAAfGHA.SGEDhAGAIHHA..hBEA...,1,4,-18,22
XBSZAIQeHKLcfgJTYROFDWNaGVCbdEUMP,eAAAHAAALADB..fADATAFARCEFDAIBaAEDGAGAhAAAbCGD.ECCBMCABBDFAhABAACCAQFAAhAAAKEDAgEGAOGEAFGAANIABCHAD.......hACA......hAFA...,2,-4,-2,2
gVFTXMWHdfaPKGAJCYEIDRcQBLbONeZUS,CAAAEAAARACA.BACALAFB..OADDeAHBZCAASAFAFDGD.hAAAMAIBHECCdCFAaEHDGDGAhAAAACEA.JCCFDGGBbFABhAFANIAB.....gFDA..hAGA......hCAA...,1,-17,-18,1
cPfKJdIZOFXALeEYNGDUWgQSRCMHBTaVb,EAAAGAAADADA.UADA.QAFARAEAHBCBaAHD..VDDA..hAAAbCFD..fCHAhACAdCBCZFDAFDHFAAIBeDBHhBAAYHAAgEGA.MHBABEEC..hAAA......hAHA...,2,-12,1,13
aSAHdXNZVFRTCIDYGMOPEWbJBKgUQfeLc,HAAAdAAAZABBRADFCAFBDAEAGAGA..MAHBECAB...JBEBKCCDUDGBhAIAeCFB.LEEBhAAA.aDHDABGBXDBAhBAAFGGA...TFEA.OHFC.hACA......hADA...,1,-9,-33,24
MWRPQgHFJBESUNYCKZDacLAOdTbXeVfIG,dAAATAAAeADA...VAGBGACA.RAEAQCFAHCACBCFDEDEBhACASAHBUEGACEAAZGFAhADAaCACAAEA.XEDAhAAAMIAA.gEGAFECD.YHDAhACADIFA......hDEA...,1,-2,-9,7
BSVCYfdWJgaQPALOMNIHUFEZcTRDeXKGb,MAAAHAAAEADEZABERAEFeAFE.GBEBBAGBCBHAdCAD.JDCB..aCCBADHALEEAhAAA.OEHDhACAIDDAFGEADIAAhAIAbCFD....SDHB.fFEEhAIA.QGGAhBAA,2,-31,-7,24
BeURIVQASFOdJDXcbYgaENKPHLTMCWZfG,OAAAdAAADADA...XADA..bABDaAGAEAFA..KBBDHBFChAIAMBGBZDBEGCDAhAEAeDFBRFGFQFFAhBAAADIBFGDA.YBHFNIBB.LDCD.CFHA.hCAA......hCDA...,2,-12,-10,2
XaeVNgKLITFGSfBWbdJZEQAcORHUPDYCM,RAAAHAAADADA.MACA.eAEAVAFAKAHB.LCCAFBDDGCEABCGAdDGAhAAAEDHF.AECA.OCCHhABAUEEACFHA..aEHDgGCBhAAASGGD........hAIA......hCAA...,2,-25,-10,15
CXLRNMUeHSBbOgKfGWTVDPQaAYdJcEZFI,dAAAEAAAZACBCADALAFA..RAEAMAIBHCACBCFAOCBHKCHBGCFAhAAA..TECAhACADDEBaECDAAGAJEEAFEHDIHAAhAFAXFGA..eHCASFFD.fHCBhAHA..hBCA...,2,-19,-19,0
eOPUIBAbNLQFVZSfJCYgKWGTdRDXaEHMc,LAAAQAAAZADBSACACAFA.KAFAGAGARCDA.aCAAHCGBhAAAeCEHODABUEGBAAIBhABAbECAFGDA..fFHAhADA.gGCAdHGBDIDA.EGFF.hACAMAIB.IHAAhAFA.BDCD,2,-19,14,33
gULPBHITcebdaKQFJOSWYZNGEMCfRAXDV,DAAAUAAALADAHADA..TBGAeAGHaBBBQCDB.ODABhADASBHHZDFEEFGAhAFAMCCARGAAAAIB.XDDAhAEAgGDBBEGAIHHAdFAAFFHD....hAGA......hAHA...,2,-21,1,22
VJOgTAHfIMUaNbFEdKBXQYSWcZLeGCPRD,HAAAMAAAUAEAaACAFAFA..EAGAdCCA.BBEAQBBA.SBHHhBAAZCFBeBHHGEDAhAAARDCADDGBOEBBADFBfFHAhAIAbEGD.KHFAXFDA.YHCAhBBA....hBEA...,1,-10,-16,6
WEGDQHOZTKJSNRfdbBPUMCVFaXIgcYALe,eAAAEAAAGACAHADAZAGBKAEA.SCCBRAGF.dCFCbCEDBDHAMCBBhAAAFEDD.aFAA.XFFAhAAAgDGG.ACIBLGAAhAEAQGACTGGANICB....hAGA......hAIA...,1,2,-9,11
CHfaERbMcdIJKeBFLXSUVGNPZgQADYWOT,DAAAOAAAHABC.EAEERADAMAHB..dAGAKBBDeBHHLCDASCCAhAIAGEAAZDEBAAIBTEEAhAEAaEHD..bEFDIEHAhAGAFFCB.XFCD.UGGA.hBAA......hCAA...,2,-12,-5,7
gFXdfWDQGbIeSYNAKVaUZMPLBCHcJTORE,aAAAZAAAMACALADAHAEC..JAHBRCCAEBHFFBBH...dDGDDCEAGEEAhABAeDCA.SFCBhAHAAAEAKDFA..UFFACGHA.hAIAOEHD...fHAB.hCAA......hCBA...,2,-28,-11,17
GUWBOeSgbADJPCNVcFZYREfdHaIQTKLXM,DAAACAAA...VACAZACAEAFEHAFB..aAHDTDDALCCB.GCEBhAAABAHAeBBB.hADAbDGDAEAAPEEBFFAARGEEdHABhAFAQGFAMFDB.OHAA...hAHA......hBAA...,1,-2,-12,10
dRCZVcebEGYNgWKaHOQIPBSJALTfFXMDU,TAAAXAAA.DADARACFZAEB..eAEAEAGAGCFA..gBDGhAAAaBHDHEAAOEEBhAAAQBGABCADADDBLEEAhABAMEIBdHFBCHCAbGDA.NEIA.....hAIA......hCAA...,1,9,-22,31
AaICZbNcGMOfREDedFUXSQHPYLKgTVWBJ,aAAAZAAA....bADBGACA.MAEARAFAECAAeAHF.dBEAXCEDhABAHCFBLFFAhBAAKCGATEGABGBA.ABBBCHFAODDHhACADCIB.SFFD.QGAAhAGA....hAIA...,1,-11,-13,2
AZJebWGBSXaFQDPOMNgKLICRTVdHEcYfU,eAAAGAAABADAaADADAGAMAFA..KBFALBFARCDB.dCCAHDBBhAAAEDFA...fCHAhACAAAAAbCDD.XEGAhBAAQEGAOFDEgGBACGHD.cGGChBGAYHBA...hBHA...,2,-26,-4,22
OLeXaIREYGSUgNfCZVMTJKcQABDPdHFbW,DAAAHAAAFACDOACALAEAeAFA..aAHDEBHF.GCCAUCEA.fCFAhAAAZDGB.MDIBhAGATFAAKEFAACCBdDDCXGGChCAARGDASBBDCHEA......hAFA......hAGA...,2,-24,6,30
CBHPNVFgIcYXRDdeKAbUOWfMaEGSQTJZL,OAAAMAAAGACB.QAGCZADBLAGBHCCAPBBBFCHDIEEAhAFA.XEGChAIARDEBeCHHAAIBUGDAaFBAEFHFhBAASFCDTGBABGEDNBBA....hBDA......hBFA...,2,-14,9,23
AVeBGJRZICSUHXaONFPcDKLEbfdQgTWYM,eAAAGAAARADAZAGBSADAHCCA.OAFDFDHDDEAAEAHB..dEEATCDAhAAAMFCBBGAACCHDaDAH.hACA....cGEDhAAAbEFAQGEA.YDCFABIBIHHAhABANIABKGHD....hADA...,2,-14,-2,12
WROeUPaEDYQXLTBMIcJCASgfVGbKdHFNZ,SAAAVAAA.GACAdADAHAFAZAEARCEAeCEFUEEBECGA.QEGAhAAATFAA.MDDBhAFAIEHACFEAAAHA.bFCDFGGHhCAA....WAFE.aGHBDIDA...hAAA......hABA...,2,-14,-2,12
GIMWJgfcSHPaYedBKTUXECVFbDQRLONAZ,GAAAMAAA.JADA..fADAHAGBaCDA.eAEHdDDABDGDKAGATCBAhAGAEEHF..FFEDbCFAhAIARDBFLGAAABBA.hBAAIHHAgEEASGFHPEHBXGCChCAADIAA...hAAA...,2,-7,-2,5
PUHBMeKYXVZJRODcCSaTLbEIGQfWNFgAd,dAAAHAAAeADAXADBZABBRAGB.DAGA..SCEAaBEDLBGBEDCF.hAEAGCCA.QCABhAAAfDHAFEFHAAIBBEEAhBAAMBIBKFHBVFCBOGCETGFA...hACA......hCGA...,2,-8,1,9
UcHIMCQEYFNKGTPbVOARDZWXfaSdLgBJe,RAAAZAAA..XADBaACAdAFALAHBBAFAeAGHHCCC.MDGBECCBFCEDhAAAGFBB.PEHBhABAbDGDAAIB...fHBBhBFASFFD........hABA......hCAA...,2,-31,-1,30
PWDFNdZCSTcELQYVbXAGRJKUOfgBaeHMI,RAAAKAAAOADABACBHADB..MAHB..IAFADAIBdBEDZCCAhAAATBGAEDGBLFFAhABA..QDDBhAAA.bDFDADIB.JHAA.fDHAhAHA.eFHHWEEDNCCA.CHHA.hCAA...,2,-31,-9,22
OIBKFVcXGWfdHDUPEMQSJCaZLTRYbeNgA,BAAAFAAA..XACDGACAdAEBHAEADAHBEBHFMAIB..QDDAhAEACBFDZCAF.RDFBeEHHhAGAADFAKDGA.VGCA.fHABhAHASEDA.aFGA...TGGAhAAA.....hAIA...,2,-33,-3,30
GWLTMcQUgAJZIEHKYBeVDFNSCOdRfPXba,ZAAAHAAABADBeACEFAFACAFBRAGF....XBEDGCCATEFAhAAA.MCIBQCAAhABAACCBEFEBKCFDDAIB.OCGDhACAdGHA.bECAaHEC....cGCA.hAIAgGFA.hCAA...,2,-25,1,26
CKJGTNLIPeYDARgMHUQdSbVfcFOWXaEBZ,RAAAHAAAdADA.SACE..bAEDfAFAOAGD.aAGDECCBhAAAZCCAKDHBGDFALEEBhABAeBHHAAGBMEGBQECAhAAAFHGE.BFAA.CFHANIAB.IHHAhAFADAIB......hAIA...,2,-14,4,18
INfCVMJUOdZGKgebAXcYDPEFQSBaTHLWR,XAAADAAAEACA.FADAQAEA.BAGAHAFBRCCA.fAHEhAAAMAIB.OBCDhABAGCGAeCEBABBB.PDGDhAIAaEEBTGFAIHHACFFC......hCAA......hCBA...,1,-18,-20,2
AIPFGDXeRfQHCYEKOVTgbNWcBLaMSJdUZ,FAAAGAAAeACHRADAHAGB.ECDBOAEA.TBEAbCED..NDAA.hAAABAHALEGBaCGDMCIBhBAAdGDAAAIBDDDB.QEEChBEA.KFHDgGAHSGDD.hACA......hADA...,2,-16,-2,14
eICQbVfBPZDcHUXaTLNJEYdOMGAFWSKRg,SAAARAAAeADE.QADAVBDB.BAFAZAGBHEFAUCGAaCCBhAAATGAALDAB.hAAAEDDAdGCAGFEBACCBKFEDCGHAhABAfGDEDIEA.......hAGA......hBIA...,1,-7,-9,2
JfZgaGVQRATeMCdPWcKESDUBHFIYOLbXN,eAAAdAAA....PADAKADAEAFE.DAIBHAGBFCCA.OBDBLCFBhAAAXCAAJCHFZFDAGDFAhACA.REDBAAIBMFHBhABACDHASFCDBDEAIHAAYFHB..hBAA......hBCA...,2,-24,-11,13
eEgUcMRINVCASBKGXaPdfQFHbWLTJODYZ,KAAAaAAA.dACAFADAHAEALAGBOAHD.ZCDEEBBB..UEAARCEB..hAAAIECACDGAAEEA.GEGAhAIAXEGAQGBAhBAA..bGAAWEEDTGGADBDB...hBGA......hBIA...,1,-15,-16,1
bdDcXQaJWYCfIVeLKHRNMUFZgETOABGSP,GAAASAAAdADADAFAQADA.aAFEJAHB.CBFA...fBHAhAAAeDBHHDDARCCBMCGBhABAZEGBEFDBADAAbEGD.hAAAXFDAIFFAKGAANIDB......hADA......hAGA...,2,-14,-13,1
QeTCSBaHJDXOcFVAIRWYdMLEPgZNUfKbG,RAAAdAAAEADEZABB.UAEAKAFCGBGA..eAHBSCCAHCGBXDBAhAIAFDEDAAAA..IFCAhAIAMEEBLFFAhBAA.gGBAbGCATGGABHHADEGB..hBDA......hBEA...,2,-14,-11,3
aMTDFZVLgENXJdIfAeQKUHBcYGRCWPbSO,eAAAQAAAHADABAGBGACBRCCB.CAGB...bBFAaAHD.DCDBZDGFLCFBhAAAEEFB.XDAAhADAdFAAAAAAKFDAUGGA.hAFA..cEDB.PFABMIAA.FDHBNIEB.hAIA......hCAA...,2,-7,3,10
ZLCMAeXGPSFJYTUgcERNKfObWaIHVDQdB,eAAAGAAAFADDJADAUAFA..EAGERDDA.KCDA..OAHF..hAAAaCFAHDGBQDFDhAAAZFBAMCCBACIBSDBHhACA.TGFAgGGANEEA...hAIA......hBAA...,1,-16,-22,6
NDQCEFBKdRHeTPgbaVcSMLUJYXfOGWAZI,ZAAADAAAEACAKADCHAFA.eCABTAEA....bCCAaAGASCGAhABAMBBBLCCBhBAAUECAXEFAGBGAACEBQEEAhCAABGEAdGGDPHAAgGCA.hACAcGFD...hAHA...,1,-3,-5,2
bRJIGKaceEfPXdBVMNCUYOLFQASZDTWHg,ZAAATAAAHAEA.RCAAGCEBaACA..EAFAXEAAdBHABBDDMEEBhABACCCDUCFALFFA.hAAAAACADAGAbEDC.KHCAeEHFhAFAfHFB..NIAB......hAEA......hBIA...,1,-7,-14,7
fRTJNLZgKbMDVaHAPUXFSEYcGBOCQWedI,XAAAEAAAGACABADAQAEA.eAHBdAFARBGF.TCDAhAAALDFBZDAAKEFAbEABMCHBhAAAaEHDHFBAACBBFEDDSGGDhABAOEHDCHHD.fHABNIAB.DIDA.hAEA......hAIA...,2,-3,6,9
HDEZfMYdSBcCOKeLbJAgRPTaUVNWFXGQI,RAAAaAAAUADA..VADAFAFEGCEB.HEEAEAGEZCCA.MBBBhADAdEHABBHAOCGBeCCBhAAALCHBAGGB.TGGAhAIANIAB...WEEDIHHA...hBAA......hCAA...,1,-16,-21,5
fFBENJObIRcSATDdPHWKMaVXCYGeULgQZ,dAAAHAAAMADAaACACAFAGAGA.LBDBZAGBBCCAECBAOCEB.hACAREGBABIBTEFA.DBFBhAIAKFAAXGBAeFCG.hAAA.gGEAFFEHNEIAIHGA...hAFA......hCAA...,1,-2,-20,18
VJeUTOAISaZEPYXLGDQFRfNMgKCdWHbBc,aAAAEAAA....XACAGACAQAEA.RAGBMBBBhAEACAFAHAGBBDFAcCCAeDHFhAIATDAAAEEBZFDAYFHBhBAALDFAfFAE.KFCA.bFFAhAAA.JHFA....hADA...,1,-3,-12,9
TBECZUPfLJVOYSRGFXcDaHKdQgebNIWAM,MAAAEAAAZACBUAEALAFA..OAGFRCEAGEBAFBBADAIBHEECdDDAhBAAeEHH..IEBAhBEAAAGACBEDfHEBhAAA..VEGBSCBFaFDE....hBCA......hCAA...,2,-30,-2,28
BNbMUYJVDHPICASWFcGRfQeLKgEXZOdaT,FAAARAAAeADELADA.EAHBZAGB.aBDDBCCAMBIBUCEA..VDEBhAAAHCGD.CEAAAAEASCCDhABA.GEGAhAGAQFFCXFCCOEDB.NEIA...hAIA......hBAA...,2,-25,-4,21
MYRfbAECaZBGNPeSJQOVgKTWIUdDHcLFX,EAAAZAAAGAEA.eAGBQACA.OAECKCAATEAAhABAICFAdDDAHEGBLAHBhAAAMAIBRDDBACCBaACABEHAhAGASFFDgFGGDDGBFHAAfGEAhCAANIEB......hCBA...,2,-22,12,34
eWbaTZcADCKNUHIXQfRLBOFEVdPMgJSGY,KAAAHAAAQACCRADFLAFBFAEAEAHB.dCADMAHB..SCGHhAAAeCDAaCHD.ZDAEAAIBCDFAIEEAhACABECA.ODHDhADAPEEBgFCB.YFGFhAIAbGFADIFA......hCFA...,2,-20,2,22
LUCRSOgKXdaJZMFPcTHDIAWGebBfYVNQE,eAAABAAA..VACAEADALAGB.RBDAOCCBXAFBaCHDZBGBhAAA.MCABFDEDTFGAhAAAHCDCACCB...bGBAfEEEhACA.QGFASGFDKEHBhAIA......hCBA...,1,-4,-22,18
GbHKUBSPLgVJRadOEMWTYDFcXQCfAINeZ,eAAAGAAAHADABADALAGBJAFA.RCCBdCFCEBFB.MAIB.TEGAhAAAFCDBQDFBhAAA.ACHAZFFAbFABSFFDhABAPHFC..aDAH.....WEEDhACADGIB.....hAFA...,1,-4,-18,14
EALCgVSNdeMJDcKPWIQUBZRXbYFOGTaHf,LAAACAAA.SADHeACAMAGBDAFAKAHB....IBFAhABAQCAAZBGBRCAAbCDBhAAAODEBGCGAHFFAhACAAACAVFBAdHFD...PFFBBEHAFGDHaHAC..hAIA......hCAA...,2,-10,-6,4
ROfKdIBFHagWGUQZEcCeYASPVbMXDJTLN,SAAAVAAA.MADADADALAGB.RBDAKDDDdAHAFBCDHEBBhAAAaBEAGEFAZCEAEEEAeEHBhAIAAAAA..XEGAhBHANIBB.fFCABFEC.gGGBhCAA.....hBEA...,2,-11,-11,0
QGDTgcWUPeZJfXFdKYLVABRCEIbOaSMNH,RAAAEAAAOADA..aACDMAHBHAEA.GCDADAIB.TCFA.hAAA.gBEAhABAUEAAeCHHZCCFXFFChAAAdDGDLEBBAAHACCBDbGAAQEEC.PFHBhBEAFGHD.....hAEA...,2,-9,7,16
LMSFAcTDRBPHCgJfOdaKbUWZeQGNXYVEI,TAAARAAAHADBCAFA..JACAdAHA.KCCDUAFAZDAF.GCCA..XCFDhAAAECHFMEFBADHABEEDhABA..fEGEhAAAaEGE.eFDHQGGANEIAIHBALHBAhADAFGGH.DFAB..hAFA...,1,-2,-15,13
OYRfZLVdJCNHGUPDaMeBXFAQIKTcSgbWE,QAAATAAA.SACA..bACBEAFARAEAZCEAdBHACCDAHEEAhAAAGCEADAIBeCCDhAFAFDAAACGAKEGAgGCAhAHAOFAALGDANEIA.aHGEBGGA...hAAA......hADA...,2,-7,4,11
BDdUZXTLbPOYEcaQWFefNICMJGSRgKAHV,HAAADAAAZABETAEALAFAOAGD.ECABaCCA.FCFAeCCB.fCEEhAAACDAAGDDBRFGBAAIBdDGDhACAUGAAXEAAhADA.bEEC...cFGD.QGAChAEA.NICB.MDIBhADA.SGFD.,1,34,-20,54
fRWaecdNQgBKYZXVbFOSDTCHJMAPUELGI,EAAAGAAARACA.eADAdAFA.QAGAKAHBZCCA.XCDAFCGD.DCGBhAAAHDAAAADALDHBhACA.fDCEhBAAaDHDgECABEEDbGFCTFFAMIBA..IHAAhAAA....hADA...,2,-24,8,32
XcbPEJZBLIeQGOYNACVRMSWTDKfdUaHFg,RAAAMAAA..TAEAKADAdAFAHAGBFAHB.XCCA..bBBCEDABhAAAZCFELDFA.hBAAeFFAGDDAOGAAhABAADDBSFGAfGDAaGED.....hADA......hAEA...,1,-4,-24,20
OZLYdRQUPaWHCXTAIKbNSfGDBeVMFgJEc,KAAASAAAGACAeAEAMADA...FAHDEAGAZCAFdBDARCEA.UCFA.hAAAaBHDHEEC.TFCAhACAAAAAIFBA.bEEChBFADDIB.BFAD.JHEAOEHD.YFDFhCAA....hCBA...,1,-5,-24,19
DaCcHVAXJLYZdbUgNROKWEQMfIGFSTePB,LAAAdAAAUADARAFAKAEA.EAGE..MCCBGCAAFCGD.eCCABDDAaCFDhABAHFDA..ACABXDGDhACAZGAA.bFDBOFFAhACA.fGHATGGACCHB....hAGA......hAIA...,1,-3,-24,21
OCfKRDWAFeNJQdbIVBELYgTPGHXcSZUaM,eAAAQAAAdAEA..VAGBEACALAFA.TBDAHBCBSDFBhAAAaCFDMCHBfDDEhAAAREBBADIBFEEBbFGDBFDDhAGA.gFFBXGAD.....hABA......hAGA...,2,-10,-1,9
KPULGDbaNSdgOTVMBQXFEefIWRCHYZcJA,KAAALAAAGACAaADDdAEB..OAFAMAHBQCACEBFB.hABAeBFBfBHAhACAREDAHFGB.ZCCAAAIBDCIBbEEASFHHhBGA.TGEABHEA....hCAA......hCBA...,1,-9,-14,5
KOXaNCdLIYADRHJEWQGbgFTcMZfUVeBPS,HAAAEAAAGACAFADAMAGBZAEAUCGBBAHAKCAD..aAGAdCCALEEAhAAAACFB.RFAA.QDGAhAAATGGA.VEDASCBDhAFAXGGA.CHAADHCA...WHCAhACA......hAHA...,2,-19,-4,15
XAfOcJSWgTVKMHPQINFECGdDLeaBYUZbR,OAAASAAA..TADAMADAHAFCQAFCFBCDEBEBdAHAeCFHhAAAaBBCBDDAZDGBREDBAEIBJDFAhBAA....WGFAhABAKEFDIFHA.CGGDDIDA....hCAA......hDAA...,2,-25,-7,18
PIfGNVWbcSEOdaFHeRZUTQCLJMgADKBYX,BAAAXAAA..fACAGADAVAFA....bADDECHFhAAAaAFAHDAA.RDFBZFAAhABATBFALFDBMAIBACAAhAAAKFHBIEEAWFFD.ODCB.eDGFhACACHHDDIAAPEHD.SFBDhBFA,2,-11,3,14
FYWcdUagbMfEKRCTVNXPSLZIGJeHDAOBQ,QAAAFAAA....cACDaACEbAEDEAFA..RAGBTDAAhAAAXBFA.LDAAhADAGDCAHEEBAAIBBDFAdEHAhADAMCIBCGAAPHFCZEEAeFAADGCB.OHEA.hAGA......hAIA...,1,10,-10,20
XEMDZBPfJUgeLQdKaSWTRGcVNHFOYCbAI,EAAAZAAABADB..fACAUAFAeBHHdAEAKCAA..aAGA.TBGAhAAARDDAGFBB..hABAcCDCHFFBOEHDhACAbDFDADIB.MIAADEBAgFDD.QGBChBEA.SGHHhBGA,1,2,-21,23
XeBSOJFVQPcREfCUZHgIaYdNKGDbMALTW,TAAAeAAAOADC.FAGAQACC.RAEFEAGECCCAHCEAaCFDdCHAhAAAGECADDDBAEAALCHBhAAABEED.SEEAhABAPFGB.fFAAgEAAIGGAhAFAKHDAWFHB....hAEA...,2,-16,-4,12
cYXBVGISCFZKbQMgHDURadeNJOTEfALPW,LAAA..cAAABAEAGAFA.CAHAZCAAbACBMAFAhBAAHDGBREAAeBEAOEDDEBHFABEAhCAA....PFFBhABAXDEASCCEQFDADCIBdHABTFGAhCBA.....hACA...,1,-7,-11,4
WRgFcNeQYKAfGLBSbVCHadXTUJIODZMEP,GAAALAAASADACAEAHAFBdBHAUAGAOCAAZCDAEDHB.REAAFEEBhAAAeCEB.QEAAhABAAADABFGA.aDDHTGBAhACADEGAMFGB..gGFGYFHBfHABhACA...hBAA...,2,-10,-1,9
cWCXbSEKHIOTZDePQUNdBMYRfJaLAgGFV,GAAAFAAA..VADACADASAEHHAGBOCCBZAFBDAIB.eBHDhAAAQDEA.dDAAhADAMCDBREGFaEDHADABgEDHhACAXGAAKGEATFGANIDB.BGEA..hADA......hBAA...,2,-24,2,26
aYMLQEKTPUObeDAdgZWVXCfGJFHRISNBc,ZAAAXAAAGAEAHADARAGB..SACEBAGBaAHDLCDAhAAAECCBKDGDUFFBeDAB.ADHAdEEAhABAVGAAfEHAhADA.FFCBNDIAMEEBTGFA.OFAH..hAFA......hCAA...,2,-6,2,8
OdZVgUaAXLQFHBWKCRceIEYMDNTbfGPJS,LAAAHAAAKADCRAFAeADH.EAFAMCAB.DCCATBGAGCDBSCAAhABAZEEAUGAAACHAQCEDhACABDHA.CDHAIFAAhAFAbGEC.fEFE.OFGDhAIA.....hAAA...,1,-3,-17,14
KLfFYAbHMeJDXQZNEUITdGCWSRagcPBOV,HAAAeAAADAEAZADBEAFAUBDAdBHA.GCEA.CCAD.RAGBaCCB..PDCBhAAAOCFD.LEHBhAAAFEGDACCAMEIBQFCAhABATGCA.SFFABHHD....hAIA......hBIA...,1,0,-23,23
TXLAIKPbHFMSQEdNBWfZCUVDcgJRYGOae,KAAAHAAAMACAEADEdAFABAFAZAGB.UCABDAHB...JDDARBCAGCEBhAAA.eDBBTECAAAIB.hBDAIEHAFEEB.QFFChAAAfEHACHHA...gGFBhCAA.....hACA...,2,-22,-15,7
HBbZVCGPIYaWUMcJSTNQOgDfALRKdFEXe,RAAAdAAAEADEHADA.ZABBGAFA..IAHAaAHFMCCB.SDDAhAAATCEAQCGChAFADDHBADDALFAAXDCDhAGAeEHHbFFACFFAPHBAYHFA....hBAA......hCDA...,1,-4,-11,7
QCGASIdZabcURYVfgJEXTHMWOBLPDKFeN,dAAAaAAA.UADARACF....VAFAJAFE..EBHFHCDB.MBBBBCBAhACALCFAKCFB.eEABhAEAQDDCAEGAZFFAYHFAhAFAXEGA.TGGA...OFFBhBAADIAACEHA....hBCA...,2,-36,6,42
ZDEGgJYPaNLObMQWIeFcHKVSCXTUBRdfA,EAAAGAAA.JADAaACDLAGB..bADDMAIB..QAFAhAAAeCDAHDBBSBHBhAFATEEAREGFAAABZDEEDGEBhACAgEGA.PCBB.OFCBhAIA.FGDD.KGHB.hBCA...,1,5,-12,17
WBUSEIMFODbVdJNHaeZARCKfGPcLXTgQY,RAAAKAAAGADALACB..TAFAQAEABAHBECCBMAHBDCHBdDEAhAAAHDABeCHHAAAACDFAfEAAhAEA.XECBhAIAgEGAUFGBFFDAbGBANICBaGHD...hBGA......hBIA...,1,-2,-6,4
fKAXcEWGgVILROTJNZFSbdeDBMPaQHUCY,EAAAGAAA..IADARADATBGA.ZCDASAEHdEADBAHBMDIBhAAAaAGAHBFB.CBCDKDDAhAAAAADAXEEC..hACAgEFALGAAOFGDFFHDeBHB..hCAA......hCBA...,2,-20,-3,17
ZCNSMVYbXGHeFJTAWDEPBcQdOIRaULKgf,EAAABAAAdADARACALAFB.KAHBZAEB.SAGAMCAB.bCBDhAAAHCDB.eCGHTCGAhAHAACCBDDIBQEEAhBCAOFCBaFFCfEHA.CDDDVGCAYHFAhAAAFGHD.WDAH.IHAAhACA,1,-10,-12,2
NfOLWcQAEDFdRYaHbeJIZTSCUKVBMPXgG,EAAAdAAARADAHACA.eAEEZABBCAGBKBHBBBHA..MCCB..XCEAhAEAGDDAOCGBhAAA.LFHBQDCDhAIAAAHAFGGBbDGD.TFCA...SFEHhBAA...hCAA...,1,-10,-24,14
WTNGOVXgCdKFfcYJHRbLBMaUEZePIQDSA,TAAAGAAAOADA..XACBdAHAFBFD...fAEAhAAAJCDBHDGBREBBbAFDMEFBhAAAEAHBeCCBQGGBhACAADIBVEEACHBD.KFCD.LHEAaGEH....hAIA......hCAA...,2,-2,0,2
eKbAcOQdEUZWTgNMBPfDRVILYFGaXJCHS,QAAAEAAAZACB..TAEAMADABAGADAGA.RBDALCHBhAAAGBGAaCBBCDBAHDDCKCEDABIBdEFAhAAAgFGG.fGDAhAIAIGCAFFHDSHEA..hBCA......hBDA...,1,-14,-15,1
KPMSRHOWNXEYGfgIQDbeUZaVdLcBFJCAT,TAAAMAAAHACC.OAFAXACBGBFA..fAEAhAAAQCCCeAFHaBBHdCHAhBAALAHBFEEBAFCASFGAhBIARDDBEDGBgFGADHFA......hBHA......hCAA...,2,-13,4,17
XKPJHbYVGdETIWBaLefcURACDNSFZgOMQ,DAAAFAAAZACBMADAKAEAHAFC....VBGBEBBA..TBDABAHBLCEBhAGAeCFFUEGAADEB.hBAASDDD.hCAAOHDAQEGB.XGGA.hAIA......hBAA...,1,-20,-32,12
COWceBERHGJAbPaLVQDFXdYUTZSKMIfNg,aAAALAAA.QAEAXACDdAEBTAGAZAGBKBFD.MBBBhBAAfCAA.CCCAOCEBhABAeCHHRDDBHGEAhBIAACIBbDFDDDHB...FEADSGGEIHHANIABhACA......hAEA...,1,-9,-14,5
CAGIBYXdUFbDTeMJSaNcEKZLOHQRVfgPW,GAAABAAAdACAFADADAEAeAFH..MAHBaAHB...EBEAZCDFHCFBhAAARDBF..VDFA..hAAAfCBEPFHDABIB.hACAXDDB.bFFASGGDKEBDOHFChAIA......hBCA...,1,-6,-27,21
CcYfRIMDUOGWJZNbgELPBSKdXVHaTAFeQ,eAAAQAAACADA.....fACFRAEFMAHBOCCBGAEAhAAAZDEAbAGBEFFBLDCBhBEASEHHdEEDHEGBhBGAAAAAFGAA.cGDBDAIB........hBIA......hCAA...,2,-25,3,28
ZTadcJYSKHCONFDVUebWBRELMgXfIQAGP,ZAAAdAAAJADAKADCHAFA.OCABDAGAUCCA..eCCABBGAECGALCFAhACAMDFB..fDHAhABAADBAGEDB.aEGHhACA.SFHHFFHD.WEEDXGEAhBAAIHAA....hAHA...,1,-17,-35,18
QdULeRWIYAaJcVCPXbBMHGSfTZENFDgOK,aAAAVAAA..CADA...XADBMAFAHBDCGAFA..TCGAhADAEAHBDCDBKBBDdDHAeDDBhBAAREDA..IFBAhAAAABGAPEHDSGGAZFEBFGGH.OHEC..hAIA......hBFA...,1,-9,-14,5
XgICJTUZeHWcbaKfdVABGOLPNEMRYQFSD,GAAALAAAEADARADFQAFCDAGA..XBFACAHBUCAAHCFChABAbCDC.KDDDdECDAEFAOEHDhACAMBIBSDADhAAA.gEGBTGFA.eFEFaFFG.BGBAhACA.....hCIA...,1,3,-11,14
QVMBEXDePIWKRacHFCJfLTZNUdbOASGgY,GAAAQAAAMADAEACAeAFA..IAFARCDAHCGBCDCDLAHBhAAAZECEdFGDAAABSBDHhBHA.gCEHhCAABGCADBIB.KDCD.aEFD.FEHB.fGHAhCDA.NHCB....hACA...,2,-17,6,23
WKPLYdVERbODBFgXcfQUNTSAJZGaeMHCI,GAAAeAAAHADACADAKAFALAGB.dCCARCDADAIBFDFH..XEDDhAAAQCGCTFAAAAABZECAhACAaCHD.MFHB..hABAIFAA.PEHD...EGFFhADA.BHAA...hAFA...,2,-21,-8,13
gYSPMIRbeVZECANGLfXTBdHQOcDUWFKaJ,GAAALAAA.TAEAHADAQAGC.DCDBFAGAaCEDgCAAhABASCGAMCEBhACAREFAeDADECFAACIBXGEChAAAdEGAODCD.cFEBKHGA...YFHBhAEA...hACA...,2,-6,-6,0
SMIQgfGEdJBLATDPcCUWaFeZOXVbRHNYK,TAAADAAACACA..UAEAaACA..ZAEB.OAGD..bAGDHCCBhAAAKBBD.MAIB.QEFAhBDAGDCAEEEEdFHALEBDhAIAACCBcFECeEGHRGBANIEB.SFHHhBAA.fGEAhBEA...,1,14,-31,45
RSNIJWTAFXcBZUPGCLHabVdEQKgDfeYMO,XAAAZAAAGAEAHADAaACA.dAGA..EAGAQCDBDBIB.eBHHhAAAMCCBRDAASDFHhABAJCGBADDABEED.CEHAbFAAKEHB.hABA..fFEEOGAAIGGATGGA.hADA......hAFA...,1,4,-22,26
LTeCUFJaDPdIKbSHQWcgREGVXfZBNMYAO,TAAAeAAAFADD.DAFAdACA.KAEAHBEB.QBGA..hAAAgAGBECCBGEEBhABAfCDAZGBAMIAAAGHAhAIALCFBCHHA.aDHB.bEAB.SEEDhAAA.cGGAhAEA...,2,-32,1,33
CdSgbZDITAeOWFRELNVKGMXUBPYacJHfQ,eAAAFAAAEADALAEA.KBCAGAFAUCFABCHAaAHFHCCA.QDAChADAdDDASEGAhAAAZDGBTEEAAAFARFDAMIAAhABAXFBA.YFHBfGHACHBADIEA.hAIA......hBIA...,2,-24,11,35
BaeJbDTMECdSfYKUPWRAVZIcHQGXLgNFO,ZAAAHAAAGAEALADBFAGABADBeAFAbBFADCAA....ECGAdCAD.hABAfDEAKDDBUEGARGBAhACAAAFAIDGA.hBGAQFFAXGFC.OEHD...hDAA......hDBA...,2,-22,4,26
FcUWMEATSdLORDNIaYJQGfCKHZbVBeXPg,dAAARAAADADAaADA..QAFAGAFAKAHBHBDBZBDFBCBA..eBHHhAAA.XDFDhABAFDCDUFFAEDCBADHALHAAhACAOEHDIHBA.fFCECEHB.hAHAPFEB.cGGChAIATFDA.,2,-24,0,24
YeOJZEWVLaKdBcTbPMQGIFDUSCNHAfgXR,XAAARAAAeADEZAGB..EADALCCA.dEBATAFAMBIBGEEAhAAADAIBCCDAHCEBAEEB.fCHEhAAAOEHB.VDAAhABAaGACBBDAbEGDQGDA.FHAASGCHhABA..hAGA...,1,11,-11,22
JRQNMOEHYBbKZUPdXGTaVIFLgCWAfSceD,SAAAeAAARADA.MADAHAGB.BCCAZAEEdCCAGCEA.aDHDFBHDhAAALEAACCFAADBADEEAQEGAhABAEGAAKGDAUGGATFCAhAIA...gGGG.WFFDhBDA.....hAAA...,2,-13,-10,3
RHMECQYeDSZUgcaWfOXdJPTNKLFbAVBGI,GAAAHAAAEADEQADAeAFEZBDE.UAGAaCAC.OCDBdCHA.TDGAhAAALDEB.ADGABFHAhAAAREEBMDABDGGBSFBBhACA.gGDD.fGHAhADA....hBAA...,1,-3,-17,14
LNOXPKRCZgQDbJMdBcSfVUaFHIWYAETGe,EAAAeAAALADAOADCKAGCRAGFZBCA..QCCADCIB.MBIBhAAAdDDASDGDhAAAUCFAHFAA.IEAAAFDA.hABAGFABXFFACFFDJFHBfHDBaHEA.hAEAWFHHNIAB....hAFA...,1,1,-20,21
NVacEJIdBTFeOUXWALfCGDRSZMYgHPKbQ,LAAAGAAARADAZAGBMAEAHCEBKAHB..QBDAaCHD.EBGBdDCAhAAABCAAeDAD.XFGAhACAACCBDDDB.SGAAhADAgDGAPHFCbEED.cGCDJFCFFGGA.hAEA......hAGA...,2,-13,4,17
CINKFTXWdYDQUVPgcSGAebLaZfOREBJHM,eAAAaAAAZACBRADABAGB.HCCAMAFA.CBBD.KBHBFBEA..TDFAhAAAdBHAQDEAUEAAVFGBhABA....gECBhBAASEEDAEHAbFGDLFCB..EGEAhCAA.IHCA.hAEA...,1,-9,-14,5
dLVbXPMeRCFYSQNWAKIOagTUcEfZHBDGJ,OAAAaAAA.UAEAEADAHAFAGBCAdCCALAHB..bCDDMBBBhBAARCFAFDABQEEAhBEA.ABGAKEGATEGAhADAZGDABHCDDFCBXGGACHHA.SHAGhAHA.....hCAA...,2,-13,1,14
TLOMVDKFWGYafPAUENBRQcgdCJbHZSIeX,EAAARAAAQADCdADA..CAFAHAGBZAFBeAHFTCBAMCCB.KDDAGDEAhAAA.aDGCAAAABDHAhAFAJFAA.bEFDXGGAhAFAOFCCDFIB.........hAIA......hBCA...,2,-13,-13,0
baGIZUNdVAOSQHDLgcEFBXYPTfCMeKJRW,QAAAHAAALADBEACABAEAXAFA.TCFAMAGBeAHBhAAAREEBaCAC.ZCDB.dEGAAAFADAIBhAAAFDCB..fFEAhAIAKDHBbFCDIGHANEIA.OHFCSHCGhCAA......hCDA...,2,-12,8,20
aGdePBbOWVXIZfSNAEcLJYHgDTURFMQCK,EAAALAAAHACADAEARADFMAFAKAGA..GCCBeBFABCAAOCFA..hAAAXCGAZDFESFGAhAIAACCBJDDF..TFFAhABAFGFHCHHA.dFHA.bGBC.......hCAA......hCBA...,2,-13,-10,3
CeZTfcPYKQIJOHVDBGFbLdgSMUaAENXRW,EAAARAAAeADEZACB....TAEA..fAGB.PBDDhAAAQAGC.hABAOCBHHCFABEFDhAIAbCFAdEDAMCCBAEHBXFEDCEHAKFCAIGGADFIB.hAAALHCASGGBhAIA...,2,-21,-7,14
ZRfBAKXLPFcQDYSUEINTOCJdagbVeHWGM,LAAAFAAAQADASADHUAGA.EAFA..TCCACAHA.aDABhADAbCAB..HDFAGCDBhABARFBAABFAKFFDXDGAhACADFIBIHDAOEEBdFAD.eFGB.MICAhAFABHFA.....hCGA...,1,-3,-5,2
SaeHRBNYIJQKXZPFACLgfcdVMUbGWOTDE,LAAA..fAAAdAEAMAGBGCAATADADAFAEAHBeCCBhABAHBFARCAABCHD.IEEAhACAQDECZEGBAEGBhAIACAHAgDGH.cFGD..hAAA......hACA...,1,-10,-25,15
LXefWEHGaJFITMQVgAcBCNYOKdRDUPZSb,CAAAOAAARACA.DAEAZAFBLAHB..eAHFEBBBHBDAaCAAFDABMDBBhBAA..QDDChAAAABHBBDDDKDFAdECCSEGAhBDAbEGB.fFDAJFABIFFATGGAhBFA.....hACA...,2,-20,-14,6
BWFTQMOJSaRAYIdDGfZHEcNXgVLeUKCPb,dAAAGAAAHADAEADAXAGBLAGB.eBFFCCBABCEAFCDB..MAIBhAAASBHHADAB.DCGBhACAZEEA.gFBAhACAKDADbDCDQEFBaEGAIHHAfFAAhADA.cFGD.NIEB.hAFA...,2,-23,2,25
QYNESGDZJIaOcdfPCbUWVTLKBAFgeRXMH,eAAARAAAHADBQADAEAFAGBGAZAFB.aAHDdDAA.CCCDUEEA..hAAATCCALFDDAAAAXDFAhBFAMFIBSFAAhABADDIBOEEB.fFGE.PHBChBHA.....hADA...,2,-5,-5,0
YZReBQPcgLDHUTCfWIEGJMSVNKXOaAbdF,dAAAZAAARAEAeADABAHBQAGA..PCABLCCA.HCFBhACATCDAfDAAhADAECGAGEFAMDIBSCCDhABAKECAaFFCAHDAFHFAgFAADIBA.CDHAIHHAhACA.VGCAhADA...,1,7,-18,25
OcZbfPeSANEVGBLMCUFRWadKDIgHJXTQY,EAAAGAAALADAMADAFAGDRAGF..dCBADAIBHDCB.JDHBTCDAhAAAQEECODBDZFAFbDFAhACA....fGGEhAAAeFCHAFFABFGA.CGHAaGDD....hBAA......hBCA...,1,-6,-13,7
SLFMQRTOEIAXKCcgVWNbePaZDfJYBHUdG,CAAAVAAA....bACAeADE.ZAGBDACAJBDBHAGB.GCCAhAAALCFDMDIBREGFEGAAAAGBKEFAhAIA....gGEBhAAAPFEBaGGB.BHHA.....hAGA......hBIA...,1,-15,-22,7
UWVgRFeJBaLINfYXAGcSTZDMCPEdQOHKb,GAAATAAA.ZADAMACAEAGE..dCDAHAECKCFD.UCCA..VDGBhAAARCFAeDBDBCHBaAHFLFAAhACAfEFEAAEADFFBCEHAOFCDhAAA.WHEAFGGHNIAB.....hBDA......hCAA...,2,-10,-6,4
dIXOCfYTZgAaEGBJSMNKVUeFQcbDRPWLH,EAAAGAAABACAMADAKAEA.eAFA..QAGCDBIBRCDALCGBhAAAHCCAdDGAODBDCEAATFCAhAAAAEFAaEHD...SEEBhAEA.UGGAbECDIHHA.hAIAfFFE.hCAA...,2,-20,-6,14
aFULGXJSbEPAWTIZfRdHcKgODBYCNVMeQ,TAAAZAAARAEAHCAA.KBHBDACABCEDCAEA..MAGBeCFH..aAHBLEAAhABAGCCASBHHhAAAEDHBAACA.fEFAhBDAdFGAOEEHYEGBNIAB....hCAA......hCCA...,2,-34,-8,26
cDNCRGSVTbJPdBFfEQgHXIeUMYALOKWZa,LAAAKAAAZACBDAFARADFGAFA..TBEAJCAAdBHA.BDEAEAHFHCABhAAA..eEFAhABAMCIBAAHAaFAACDED.SFGAhACAbDFD..fGBA..hACA......hBEA...,1,-20,-31,11
MUVZCJTQYEAFWagfPOcDHXBdIbGRSeKLN,aAAA..fAAAOACDHAEAdADAGAFARCDFeAHHLEABhAEAMAIBZCABTDDAEDFFAAGAFDHDgEGAhAAADBBBBFGDbGCAhBAAKFBANHAB...CGHAYFFF...hCAA......hCGA...,2,0,5,5
UXAdFIBCTMSHQZLNKYRDcgeObPfVaEJGW,dAAABAAAMADAHACAZAEELAFB.KAHBRCAADAIBeCABOCEC.hAAA.bCDD..fDHAhACAECCBGCGAXEEAhBAAAEABCFCDTGFA.SHAAQGCA.hACAcFGD...hAEA...,2,-23,-7,16
SBKaQTdHROPXZcJGeUMNCfDEgILYAWFVb,FAAASAAAKADA.QADAHAFBRCCAOAHFZAFBGCCA.eAHFhAAAMDABCDAADCIBEDGFLEEBhADAACCB.bFADaEFAhABA.dFBA.XFFCcEGD.....hAFA......hAHA...,2,-19,-3,16
UXeAWPcdIMKTZORaFYHgSJLBfEVNCGDbQ,...PAAAdAAAMADAZADB.RAFAFBDBHAFA.SCCDLCFAECBFhACACCFDGCGA.bEEDQEDAhAIA.eEHBhBAAAAHAIHHATGFAaHCAYDBF..hBAA......hBDA...,1,-8,-15,7
OBYcAQHIFXCVPWLENZeGDgabfKJSdTMRU,HAAAXAAACADB..VAFALADA.EAHBeCAAGCDAaCEBKCHBhAAAdCFBRDFFBDFAAAAAFEAA..hAEAPEGDZFAADDIB.bFGDhAFASDDD.MFAB.OFFHhACA......hAFA...,2,-18,3,21
HdcaTIJPMBXFNQfVLCODGgWSAZYeEKbUR,eAAAEAAAKACARADAHAGB.dCCAaAEA..TDFAJAHBBBEA.FCCBQEAChAAA.LFDBhABADCGBGDEASDHHhAEAADEBZEGB.bFFCIHAAXGAANIDB.CHHA.hAGA......hAIA...,1,4,-31,35
fGgCEbFRMVdeBaIcUJNLHDPQXYZWAKOTS,TAAAGAAAEADA.RAFA.dACABCDAaAEAUBFBLCFAHCDBDDABQDGBhAAAZDCAAAAB.SAHBhBEACEGAMEIB.eFFBhCAAIGAAJFHB.XGEA...KHCAhACA......hADA...,1,1,-19,20
QEaSKZOUTVCNPBcdgJXIGDHfbYMFLeARW,RAAAEAAAKADCZACB..OAFCUAFA..CAHABBECdCCA..JCFAGDEAhAAAHECC.....bDGBhBCAMEHBLEDDAAAAaGED.hAHASGGA.NICB......hAIA......hCAA...,2,-37,-15,22
KMabBNPCQWDUEVcAeJTSYOLdZGfRFIHgX,eAAATAAAOADC.ZAGBRACFHAEB.KAGAbCCABCAD.CCGAQEAAhAAADBIBEECAAAAASEFAhAFAdEDAGGEBFFHDXGAChACAaGAA.PDHDUGEA.....hAGA......hCAA...,2,-14,4,18
HVTUdZLbgJBKPGfQNESOcYIAMRWXaFCDe,RAAAaAAADADAHACB.UAFAZAEELCCA..bCFABBHAGEAAhAEAQDFAEDEBOEFDhAIA.IFHAAAAAMDIBFEEHhAGAeBBDdGCAKHEAfGGA...hBAA......hBEA...,2,-26,2,28
cTfMaEVgQCIKJNDZHOeAUPdSXbGBFLRWY,dAAAXAAAGADALADARAFA......cCADMAHBECDAhAAAQCGAKCFBDAIBHEAAhABAAADBSDDDhACAbEEAFGGH.TFAAaDCC.CEGDIGGANDIA.eFEFhAFA.....hAEA...,1,-4,-9,5
adYTZLAURcDbOKMFXVEgJGIPBQCSHfWeN,RAAADAAAKADCMADA..FAFDEAGAGBGA.BAHBQBBAHCCAeECAhAAAdBEAZCFBLFFAhABAABIBbDGD...XGEChCAAgECAIHHACHHA......hCCA......hCEA...,1,-11,-21,10
KUPdOGBECgcFHfMQeXNaDRIbWZLYVATSJ,TAAAKAAAdACAGAEA.BAGAEACECAEBFBHDHAFB.MAIBeDDBaCCAhAAARDFF....IEAAhAAAZDDALEHB.hAEAAAHBSFDAPEHDOEBDfHDBhCAA..NIAB.DGGB..hDAA...,1,-13,-16,3
VHgcIKAdTYZGPUfLSXFQOBbDCWeNRaMJE,dAAAZAAAGAEAUADALAGBFAGABADB.DCAAeCBF.RDDA.MCHBEDHF.hACAHDDB..IFFAhAIAACIBTGBA..fFBAhBAAQFGBCFHAaGCD.....hABA......hACA...,1,-17,-24,7
QFAXYHVEeCdgcPUGBZONWbJSfTMRIKaLD,HAAAEAAAdADA..gADBUAFAZCBA.OAFA..bCFAfBGEhAAAREFA.aCACLFBAhAAAQCCCAAIBXGEDhBCAeCHHCDFAGFDBBGHAJHBEMFIB.DIBAhACA......hBIA...,1,0,-9,9
LHKBaFMIXPfSAEGeOCNgcRUYbWDTQZdJV,EAAAeAAA.CADA...NADA.RAEFUAGA..bAEADCCB.ZDCBdCBALDHBhAAAHCFAaEAC.MEEBhAAA..XEEAhABASFCHAEEAGGDBOFFA.gGADhAEA.cGGC..hAFA...,1,-15,-19,4
aXKHGVCYQUWfFIODTNLgBdEePMScZJARb,RAAAaAAAHADBGACACAFA.UAFAFAHB..DCCBLBHBBCFA.EDFAeCHFhAAAMBBBZDAF..AAEBKEDAhAIAQEEA..hABAfFBAODDBgGFAdFGA.SFADhADA..hAFA...,2,-19,-14,5
QMgANDVUSEOeadIRbHPWZfLXBCKTcFGJY,DAAASAAAEACA.eACHdAFARBDBHAEAZAGBLEFACAHBKCED.FBBHGCFAhAAA.QEAAhABAABIBUFBA.aCHFIGEAhBAAbFGDfGAE.BHDATGGAYDDFhAEAMIDA....hAGA...,2,-18,-1,17
GAWJQcdbEMSFCgHBZYLRTNUXIaOPfDeVK,QAAAdAAAEADA.MADACAFAHAGBZAEERCBAUCCA..aAHDOCFBhACADCFBKCGDAAIB...JDHBbDABhADAFEEHBDHA.TFGAhBAAXGFD..fGEA..hBCA......hDEA...,2,-20,-19,1
WEIAbcRYXFZUdGHMBSNOCaJQLKVeDPTfg,RAAAFAAAdADAHACBBAFAOAEA..aAGDLBEBKCCD.eAHFDAIB.hAAATEFA.fEDEhBAAECFBADEB.bGCAXDGDhABA.GFABMCIBCGHAQFEChAFA.....hCAA...,2,-26,-12,14
ZCRPJfHWKUSNTILFGEBQcVgDaXbOeMYdA,RAAAJAAAHADB.KAFASADB..TCFALAFAECCBQDAChAAAVCCB.aAHDhABAbCFAeDHFdEFAAAGAZEEFCEHD.hBAAfHABUFCBFGHBBHCADFIBOFAE.hCAA......hCBA...,1,12,-18,30
fIVSBNMLYAWZEQgCFUaTbdecJXKROGHDP,EAAAQAAAFACD.aACEdAEA.eAGB..XAEDRCFBHDDBDAIBhAAAfAGBSDHHhAHAMCDBADDBZEBFCCGAUDAATGGAhBEAbEDDKFFA.OCHD.IGBAhAAA.BGHA.NIAB..hCAA...,2,-10,3,13
UVHKfZQWJBEcTbGgCIONPSMRDFALaeXdY,eAAAdAAAUADAHADAZAFBQAGCBAHA.ECCB..TCBAGCEAhAAA.CCHAOEGDSCGHhACARFAAAEIBaGDD..XEDAhBAA.KEHB.fFBA.hABAcGFB.IHHAhBCA.,1,5,-44,49
AYSgdJTCINXBOMDQGcPUFKWEbVfLaeRZH,SAAAdAAACADA..XAEDMADAGAGAUBGA.KBCA.ECEFVCBAhACALEBB.RDFBAAAAhAIAJDAF..IGHAhBEAODFBQEGA.FGAHWDDDaGGC.hADAeFFD....hBFA...,1,-16,-18,2
gSHYeBEDJMUdRLZCNFPVaKcIfTAGXQWbO,GAAAQAAAOADAHACAeAGFEAFEMAIBRCDBZCGB.FCDD..aDBDKCFAhAAA...fEAAhAEAAAABbFCA.SEFAhAHADDIBdGGANIAB.cFCA.TGGA.XGEDhCAA...hACA...,2,-12,12,24
PFJXdAVLIGDcfNMeRTYBbESKQagWCHOZU,LAAAGAAADADA..fAEAeAEARBFABCDAEAGA.KDCD..aBGEhABACDFDHDGBZCAAFCEDdGGDACCAIDGAhACAMEEB.bEABhAEA...QFFAWFFD.OEHDhAGA......hCBA...,1,-5,-22,17
LOYeIgKAfZGdHWDXSVPUNQRbaFMJBTCcE,GAAAHAAAXADBSADAUAGARAFFaAHDMBFB.BCAD.CCCALDGBhAAAeCDBKDFDAAABdEDADDABhACA.VEGBQGBChACAbECD.TGEAEHAEOHDEIHHA..hBGA......hBIA...,1,5,-6,11
GRBEfOWQebDMJZCHcgPKSFXYUdIVLTaAN,RAAAEAAAOADA..eACAMAHBZAFB.HCCB..PBDDFAHDXDABhAAAdCFALEHBhAAAADHAGEFAfFDAhABAQFBDbFFB.CEHA.KGBBSFEDYCCF.IHHAhADA...hAIA...,2,-16,3,19
ZEeUYgfCKVGAcdBbaMOQJNIXPFRDTWHSL,dAAAaAAA.MADA..QADAJAGB.XAFARBDBDAIBHCACZCCAECGBhADAeDFAUEEB..hAGAfEHAKEHBAAIBBGHDhBAAOFBANBBA.FFFB.SGHH.hCAA......hCDA...,1,-15,-18,3
GQgNLZIScEYWFfVCMbPJRTOKBAdXHDeUa,HAAAeAAAGADAQADCLAFAZAFBSAHHECCBFCFD.CCADMCCBhAAAbCGD.RDDB.KDBDADHAdEHAhACADCIBaFFC..gFABhAFAIGAAYHAGfGEA.PHFChBHA.....hAAA...,1,10,-14,24
FcYaHRWQAVXEIdPZeUNSgMOCLKTDJfbBG,EAAAdAAAeADAUADA...SAGAMAGBLAHBDCCA..bCDAGCBAhAAA.FDDAaCHBHEFAhBCARDAAAADA.IGHAhBDAZEEAOFCBKHBAfHEBBGGDWFHH....hBFA......hBHA...,1,-8,-14,6
DACFPgUYZEfKdecVILBJGQSaNHXWTRbOM,FAAAUAAAEADAdADA..eAFA..IAFALCCAGAGAaBGEHDAAhADATCEARDFA.MDBBhAIAAEEBCFFD....gGAAhAGAZEEAKGEABHHAQGDCNDDA.WHFAhBAADDIB......hCAA...,1,-9,-15,6
NdgYDCXEVUfcFbTLWIPZaHBQSeAMORGKJ,RAAAGAAAKADC.dADADAGAEAFA..UBFAFAHDLCFB..ICCAhAAAaDBDHDDDQECAhABAAAABMDHBOFABhACAJDHB.NDIA...CBHAXFEBfGGE..hAFA..cGGCWFDD.hBCABCEC.,2,-46,7,53
XKFUSNRCWDaYLGMIOVJbEZTdQegAcfHBP,HAAAXAAAFADASAFHRADA.DAHBaAGAGCABMBHBOCDBhAAAJCHB.ZCEBdDFAeDABhABAAAIBBECAKEGDUGDACEEC.hAAA....YFHBIGGA...hADA......hAEA...,2,-25,-14,11
HDeXACFTYOPcQbLdJGSfWMUgBVaNERKIZ,TAAAOAAA..QADAdACAGAEASAFAMAHBBDDAaAHDRDFFZEAAhAAAHCCADAIB.AAGBFEHDhAEAcCGC...bEEBhAGA.JHFE...WBBD.....hBEA......hCAA...,2,-20,-5,15
HWdDPaZEOKUgQMBSYXATRJICLVGFbecNf,RAAACAAAGACAeADE......fAGBHAEAdAHAaCABEBDFKCEAhAAAQCFDMCCBSCGBhABAADIBTEAALFFAhAAAbEEB.NEEADGABODHDBHFAXGFDhAIAIHHA.....hCAA...,2,-15,0,15
ULdFJBEQXaeVDfgWMHYIcAbKGSONZCPRT,GAAAOAAAZADBRADALAGBdAGABBBD..ECDBQDBCeCFDDAIB.hAAA....fCHAhAIAMDABHEGBIDFAhBAAADIBbGCA.KEED.CEHATGBA.FFGH.hACA......hADA...,1,-9,-19,10
HUbXNBPdfDETeGZQMJgVAaRFcLIWYOSKC,RAAALAAA..IAEAOADDCAFAHAFBUCAA..XCCAhAAABAHAdCFAEAHBeCHBZDAAMDHBhABAJDDF.ACCAaEFBFFAA.hABA....cGGCSEHDbFDD.fFFAhACADIAA..hAFA...,1,0,-33,33
HbNVTeYAUPCKcLIBMGgXZOSdFJaQEfRWD,CAAALAAABACAGADAZADBdAGA.FCAAQAFARCEF.HCAAVDGBhABAeBHH.ADFAKEFAMAIBhACAOEHD.aFAAEFBAhBFADFEBbGBA..YHBAUGGB...cGGChAAA....hACA...,2,-17,-4,13
LNPKfHcGDVXTEegCZJWYAbIFBOSdUaRMQ,FAAASAAAdADARAFA.MADALCCA.KCGAHAFC.GBCAhAAADDBB.TCFAEEEAeEGFhAFAZEBFYEEA.hAGAACIBBEHBaEHD.QGGANIAB...hAIA......hBAA...,2,-30,2,32
aAHgPVCFdYJIEOfKSBcMGULRebQTWDNZX,HAAAVAAA.dADA.JAFAEADE..KBFDBAFBGCABRAGF..eCDBTCGAhAAADCFBZECF.ACIBCEGAFEEAhACA.OEHD.SGGDhAIAMEIBUGEA.......hCAA......hCIA...,1,-18,-24,6
DEadYGOWJcTRKLVPZIXNQSUMeAbFHgfBC,HAAABAAAEACAdADAGAFA.OAHFJAEBRAGBLCAAZCAA..hAAAXDGDQDEAhACAMDFBAAIBFDHDCEDAaFAA..hAAA..cGAATGGAKGCCIHAASGEAhAGA.....hACA...,1,-10,-18,8
HCDagYbPUILQXEGANKeSFWBRdcVfMTOZJ,eAAAFAAARACF.dAEA...VAGBMAEA.ZAFEHBCBDCEB.aDFB...hBAA.bCFAIEBAhAAA.LEGBEEFAACGASFEDhCAABGAA.TFGACGFC....hCBA......hDAA...,1,-16,-32,16
OLDBEFJVfgKCMRSTHcIYbZWNUXedQGAaP,aAAALAAABADA.EAEAFAFA..JAGB..VBEBKCAARCCF..HCCBhADA..IDHAhABAZCGBUGEAeCFDdGHAAAIBDAIBCBBD.hBAAMEAB...TFGA...YEEFhACA...hCAA...,2,-25,-18,7
HfOVTSFbKQdPDaUYGIgCMeANEcJWLXRZB,EAAAJAAALADBRACA.HAFAOAFA.TBFAFCFHQEGAhAFA.dCCCaBHD.GCDAhAAACCHAAAHA.cDAAhADAXGGCZFFAfHEBSEEDKHCADFDB..hBAA......hCAA...,1,-2,-18,16
KgLZSTfbCAVHYMOcBIEPNQeJRDWdXGFUa,HAAAMAAABADAEADEQAFCRAEF.dAHAGAGAaCAC.LBBBhAGAZCCBTDGAbDCDAAIBOEDDhAAA..IEEAhBAAeFFBDFIBFEHD.KGEA.......hACA......hCCA...,1,-2,-16,14
eBSXDYKPcTQAVWIUONaGJCfMZFLbdgRHE,VAAAUAAAOADA.GAGACADBZAEBLAHBdBDAHCEBBDCDDBGBKDCAhAAA..TFGAABHB.hCAA..IGBAhAIAaEFAMEIBbGDCEFFB.........hBAA......hBCA...,2,-32,-14,18
ZdcCgaLXWYGbNJBEVFPUQfTSAIMeRODKH,eAAARAAAKADCHAFAdAEACAGA.LCCA..XBCDGCGAbECABBHAhAAA.ECFFFGDB.QGFDhAAATDGAAEBAMEEBhABADECA.ZFFAaHAA..YGAA.NIAB..hABA......hAHA...,2,-15,-4,11
OcHTYIfQebDCVWMZBURKFALNgPJXEaGdS,LAAA..gAAAXADDEAFAdADAOAFAHBGBTCAAhABAIBFA.eBHFhAAAbDDBCEHAMCCBZFAARFEFADBBPDDAhABAaGHB...GEFA.SDHHhBDA....hDAA...,1,7,-19,26
RWbYfZeIPLTACOQdgFSHcXNVDGKUaBEMJ,QAAAdAAASADAHACA...XAFBDAGAGBEBaAHDECDAhAAARCAA..bDCAZDEBeDGFhACALDHBABHA.OEAAhAEAFEAHNDIAKHFAMHBA.YHEG...hADA......hAEA...,1,9,-14,23
JaHecdMBANSfIWgOEFUPVQKCXZGbYLTDR,SAAA..fAAA.gADAEADAFAFDPAHBhAAAQAGACCCAGDAAhABAbCADLCCAhAAARDEAHECBeEHFdDGAAADAIGFAOEEBKFHB.ZGAADGIBhADAaGEDMIAABGGD..hACA...,1,6,-4,10
AOESMPTcIUJgfNXeYFBGQCWDLHKRVaZbd,EAAAMAAA...TADAIADA.UAFAJAFA....fBBAhAIAeBCBBAHAGCDBhBAAQDFADCGAHEEChBBARECAaCHDdEHAACEBSFBDPDCBNIDB.FFHDCHHB..hAAA......hBFA...,2,-22,1,23
JegDKUBAHMZPXGWfQROLIFcSTaYEbNCVd,HAAAZAAAGAEAQADCRAGBLCABFAFATCEAECCB...bCACCADBdDGDhABA.eEDFKBHBADHBMFFAhACAXEEA.OEHDhAAASGAAaGCAYHFANIAB..gGGAhAGADIAA..hAIA...,1,9,-6,15
HfECeDTRVFIJdKbAgGOPSMWXUZcNaYBQL,GAAASAAAMADAUADAZAEE...aAFEQCDBHCEC.EBHFhAAAeCCBRDBFFDFDdCHAADIBOEGDhACAXEEC.cFGBhAAABGCA.LGAADFIB.IHHA.hAIAKDBD.....hBAA...,2,-11,1,12
HcIaeYNBKfGTQSJLFRUbMDPZdVOAWgXCE,XAAAHAAAaACAeAEHBADAGAEA.QAGALAGBRCCBMCDBhAAAZEFAdGBAADAA.CDHAEFDFhAAAIDGAKGEASGGBhAIAFEEHbGAA..DEIB.OFHH.gDAAhABA...hBGA...,1,-1,-4,3
FUTONBHcVWKQICZEfJYdADPgGSbeLXRMa,DAAAGAAAeABARADAMAHBFAED..UAGA..TCEABCCAHDEAhBAAVDCB.QFGAhBGAZEGBEEAB.JEDFAAAB..SFFFhACALHDA.aGAC.cGCD...hBIA......hCAA...,2,-23,-2,21
YZSQHaVCePcGMEAJRdOLNTfBbFXKWDUgI,RAAAdAAALADB..TADABAFAXAGDDAFAUBGA....hAAAICCAZCFAHEEAaCEDhACAeCCDGDAAAAIBOFABhABA.bGEAKEDD.gEGA.QGCBhADA.CGHAMFFBhAIA.,1,-7,-23,16
TDJUXMZHRLCSgBVEPObfNFAIaYdWGKQce,aAAAdAAAGADA.QAFAeACHTAEADAIBUDAAZAGBHDDARDEFLDGBhACASCHHBGHAhADAEEAAOHBAbFDAFFHBADDB.hAFAIGAA.KGCD......hAEA......hAGA...,1,-1,-11,10
KPMfIeBdSCGJgWbZNOFDLHYVcERXTaUAQ,QAAAMAAA.eACAdAEAGAGA.JBBBbAFAZDCBFCDAHEEAhAGAVCGBRGDE...aDAAAAIBKGBDhBAA..fDDEhAAASGGBCFEAgGAANDIA.DFIB.hBBAcGFB.XGCDhADA.,2,-16,-8,8
CVdAcDbHPUXSeNKaRZJFQLGOBgWYfTMEI,DAAAHAAAUADAeACE.aAFARAFAZBBB..QBFDGCGABDDAgCCAhAAA.fDFAhAIAEEFBCFDA.ABIBbEGDhCAASFHH.KGAA......hAGA......hAIA...,2,-38,-1,37
SBZIPAMaDXGNYOVFeKRUbgCQcJdHLWETf,aAAAGAAA.OADAeACHRAEAUBGA.CCDA.QCEB.dAHAhAEAHCEBEDDB.TEBAhAAABDGAZFAAAAHAMEHBXEGAhAFAVGCA.KFFD.........hACA......hBAA...,1,-9,-17,8
dFPTWYcSLIEfUMHZQKbeJagNGBVCXDOAR,RAAAdAAAFADA..TADA......cAFDLAFBEBHF.hAAAMAHBHCCAZABBbDFAeCHHhAIA.aDCDGECBhABACEEAOEGHAFHBPGAASFHHfGGE.hBAA......hBIA...,1,-3,-20,17
KJFOUPZXBNHQISEaGfbMWgTdVeYCLRcDA,FAAAOAAAZACBBAEAHADAQAGC.EBBBGAFA.bDEDhAHAMCFB.TDCAhAFAeBHHLECBRDGBACIBKGDAUGGBhAIAXGFA.SHBG..hAIA......hBAA...,2,-27,3,30
PGHAIYSMUfcaQNVFOgTLKbWDdEBZJeXCR,SAAAMAAAUAEA...aACDQAGA.FBBATAEAhAAALDDAbAGBdCEDEDHBZEBAhBAAeCHHRFFA.HEAAAFFAIHHAhBEAfDDE.cFEBNIBB.OFHDhABA......hAEA...,2,-10,-5,5
BFgVQHdXbNcKZPWDETSfYROAeIGaCJULM,eAAAaAAA.CADA.LADAFAFA.QBGAHBDCdCHA.XBBChAEA..bDDAKCDAZFFADDGBhAFAEHDATFCASCCGhAAAREEBAAHAIEHA.......hABA......hAIA...,2,-20,-9,11
PaEUNXVALGQBCgRZdJIDObKSFeMWYHTfc,GAAAQAAACADARAEF.dADA.DAFAKAGC.FBHDeAHF.MBFBHCFB.hAAATDCA..fDBAhBCAaDAHUFFB.XDDDhBDAAAAB.LEGB.ZGBA.OGDAhBGASGHH.hCAA...,2,-17,-14,3
HcCRKbSFGVXJUaWZOATLMDNdYIQgEeBfP,MAAAdAAAQADA.EAFAeACA.fAFAHBGBRCAAbDCAGAGAhAIA.XBBChBAAaEFDZGCAAAIBTCDADEIBIHGAhACABDFACEHAFFFB.......hADA......hBAA...,2,-12,-5,7
FOLdKQVbfIcJTgeBUaSEGPYWCDNRXHZMA,LAAAdAAAQADAVAEA.....bABDfBHA.hADAJCAAeAFABCEDaBGEEDFFhABAGDCB.PDHBhAGACDHAREAAHFGBADFAKFFBIHAA....hACA......hAEA...,2,-18,-9,9
JbPWDRBOXgaQYVGATSeNFUEdMKLfZIcHC,eAAAFAAAEADAdAEA.MAGBLAGB.ZBCEHBCBCDAA.JAHB...hADAbDFADAIB.RDDAXEGAhBAAaEBBQFDAGGBBhBGAAAAATFGASFFGKHAA.IHHA.hAHA......hBEA...,1,-9,-11,2
UgQTedPZAcMCFNSHYEGVRLbOXIDfaJKWB,MAAAFAAAHACBGACBRAEALAHBOAFADBBB..aCEEKBHBBEAAQCCChBAAeEEAZFAEACFACDFASEHHhAEA.EGGBhAFAbDGD.XEECIHCA..WFDD.hBAA......hCAA...,2,-16,-8,8
XbKCNMTRUDOZIWEgVYJBeQHcfFdAGSLPa,GAAALAAAaADAKAEA.MAHBRAFFDAIB.ZCDFECAA....VDGBhAAABCDAHDBBFCFBAAIBXGGAhACACDCDUEEB..OCHDhABAIHAA.YHCAeEABfFHEhACA.SGADhAEA..,1,-13,-18,5
VSLNOYBgUCQaIReWbKZAJHGXEFTdDfcPM,HAAAEAAAdADADACA.....fAEAMAFALBCDOAFDBBFAhAAACAHAaCCBRBGFeDDE.hAAAbEECACHAGDDA.hBFATDGAPFHDSFGANIBB.gGFGhAHA...hBIA...,1,-9,-17,8
JDUIcaBGQNRgZEeMKHbWdXfOAPVTCYSFL,TAAASAAA.LADADACAUAFAaAGDGBDA.RDBBECHFeBHHhAAA.HCCAdEGDOFBHhAAAAAEACDFAFECHIFFAhABABAHAQFEDNEEA..MFHBKHGA....hAIA......hCAA...,1,-6,-15,9
ZMDEdNaCJPLgGQVKbIOSfcUAYeTRBXHWF,eAAARAAAHADBZADBEAFAdAGA..aAHDCBCALBFD.GDGAQCFDhAAAKEED.bDAASGDAhAAAfEEEAAIB.TFAAhABA.XEGAMICADGGBPHBC.hABAgGEG.hCAAIHHA.,2,-16,19,35
ceFBKGTfANIDQSXOCgMPYULWHRbVdEJaZ,DAAAQAAAOABE.MADAUAEAHAFC.RBDBdCFAEAGAZCCAFCHDGDBAhAAAABIB..SCGHhBAACFFAPFHB.LFFAhCAA.bGDC.aHFE.......hAIA......hBCA...,2,-20,-8,12
HRQMGKbUZfPJNVOIFDWSBELadAceYTCXg,eAAATAAACADA..HAEBRACFGAEAKAGA.ZAGBJCCBOCAB.DBIBBCGAhAAALEDAACIB.XEADhAAAMEEAUFFAfEHAhACAVGAA.FGGHSEHHaGBE..hABA......hAGA...,2,-27,6,33
XGQIeBWcgTLRdUEaKJYbNFPVCMZHfDOSA,GAAAeAAABADA..gADARAEFEAGEKCCA.JAGB....bCFDhAAAFCED.CCHAHEACDCHBACIB.hABAQEFA.hAIAIGAATGGAdEECaFHDYHFA.hCAANIAB......hCBA...,1,-2,-27,25
YObfaQDdTZPJCAKHUWNGSeLIRXcVBMEgF,HAAAUAAAGADAeACERAFF...XAFABAHBECCAFCFDOCGD.hADAaDEBdDBAZFAACCHAAAFAKFEASDDDhAIA.LEHBhBAAIGHAMFFB......hBCA......hBDA...,1,-15,-20,5
BZIXDfdVaFbHLMUgGeEKAOSCYcJTNWQRP,CAAAJAAA....TACAQADCBAEBZAFBDAFAdBGA..aAHDHCEBhAIALCABMBIBGEGAhBAAECCBACEA.SCCDhCAANDHA.RGCA.XEDA.FGEH..hAAA......hACA...,2,-32,-10,22
SMIVcXPfNEdWZOKGAbgaJURLYeCQFTHBD,aAAARAAAeADE..QADAHAGBSBDHMAGB...IDFAhAAAXBBC.fAHAhADAEDCBZEEAGGABhABAACIBbDDBUFBACGGDBHEADEHB.PFFBNDIA.WEHHhAHA......hBAA...,2,-22,3,25
FDMePOZcSKHCYQJVaBEdGbIRgLTUWNfXA,MAAAeAAAZADBKADAHAFBQAFA..aAHFEBCFGBBARCEF.TDEAhAFAUEGA..fGFEhAAAABBBDDHBOECDCAHA.hABAVGFABCHA.IHHALHBA...hCAA......hCBA...,1,0,-19,19
UfMNIEPgSZbOKHLeAYFCDWRBTdJaXGQVc,CAAARAAAdADA..aACAGAFA.QDDAUAFAMAIBEAHB.SDGHhAAAZBCFKDFAHFBAAAFBDCCBhABATFFA.JHDAXFGAhAIA.........hAAA......hBFA...,2,-30,-15,15
EcXORIWGebNfBPZYgVHLdDSQKFCaMTAJU,EAAAOAAARACA.GADAeAFE.....bAFABBFAZCFB.VCDBHDBBhAFAdCHAQFDDhAGACDAA.aEHBACCBUFFAXGGAhAHAIGDANIDB........hAAA......hADA...,2,-31,11,42
fJgTdXYZCcaBUAERMKSeIQVFOPLNHWDbG,RAAAMAAAeADE..QADAOAGDLCCAHAFADBBBGDEB.hAHAJEBAdCCAZFFAaCFEAAAAEGAAhAGASCHH.FEDDhAIAPHFCbFEDTGGACBDA......hBAA......hBCA...,1,-3,-11,8
WaPODALdNJZcSEIUTfQHbeMVFCBRYKXgG,dAAAZAAAEADEUADA..QAFCHAFAeCBFMAIBCCGABDDA.REFA.XCAAhABA.GCGAhACAaFDBDCIBADDALDFDhAHA.cECBTGEAbGFAFHAA.KHGA..hACA......hAHA...,2,-19,6,25
UZENOXMGLYbFCAgKaJHTWdSQeVIBcRfPD,aAAAHAAA.dADAeACHBAFARAEA.DAHBZCEA.EDDBXCAA.GCFAhAAAbEAB.AAIB.KEGDTEDAhACAQGCA.IGHAhAEAfEHANAIAMFABLFAB.CCHAWFCDhAFASFEH.hCAA...,1,0,-20,20
DHBTOaEdgMAPbNYQFZLGUecfRXWIJKSCV,...bAAAQAAA.ZACBGAEAeAEARBFAXAGAJCEFCDGA.hAAAHCAABEHAaCGDEFAAdEADhAAA.AAGAPEDBFFGH.hAFALFFA.fHFB..hABA......hACA...,2,-25,-4,21
VaBdECZOFKINLcTSHYfMRgPJQDXWGebUA,aAAAEAAAZACB..KADALAFA.TCEAHAFBMAIB.RCCAPDABhADAQCGCXBBChAFAeCBDAAGA.dFFAFDGDhAHAIHHASEEBfEHADEIBWHBAbECDhAAABGGANICB....hBAA...,2,-17,1,18
gUJAbYTdaHOIeDQXCZVFfScMBLKGWNPER,TAAAHAAAeACE.QAFCZACBFAEDSAGAMAIBLCCBhAAAGCEBPCEBREEB.gDGBhAHAAAGAdEHAaCAHDHCAhAAACFFAfGEEKHFA.EGHB.....hACA......hCCA...,2,-14,14,28
JMNFZRXTDYGCLEcObVHQWedaPgSIfKBAU,MAAAZAAARAEADACAGACB.EAGEOAHD.HCCCeBBB.aCFASCFHhABAKDDAACIBUEGAFDHHTFAAhAFALFAA.bFFChAFAQFDA..dHABIHHAhAIABHHA......hBAA...,2,-10,-6,4
ZDaPINbeJEcASVQCLXgFMHGWdBYUOfRKT,QAAALAAAFAEAHACAdAHABBDAOAEARCAA.ZBEE.aBHD..ICFAhABAeDDAEEFAACAA.CEHAMIAAhAAAGDGAUGGATEDAhACA...DGGB...PHBA.hAIA......hCAA...,1,-2,-19,17
dgJcADWXVUaTEFQBHSKYZbfNMeGRCIPOL,XAAAaAAA.FADAHACB.KAEAZAFB..bAGBMAIBGCEARBCFCDGA.hAAAOBBHdEEA.gEAAhAEAABHBDEIBUFCAEDHFQGFAhABASEDD.fFHA.hCAANIBB......hCBA...,2,-19,6,25
MXDJAYBabNQSGOKCWVdURgLIePZHcfTEF,aAAAQAAAGACAKAEACACA..dAEARAGFLDFAeAGBHCFB.TDCAhAAAEEAAMEEB.DBBBAAHAbFDDhBEAOFCB.UFFAhAEAgFFA.IHHA...hAGA......hAIA...,2,-14,-2,12
CXKgJZOQbELAWUHMVecGfFRIYTPaNBSdD,HAAAeAAAGADARADF..TAGAaAFASAHHdCADXCEDKCCDZBFFhAAAQCGBEEFBADBBMDIBhABAfEHA.hBDAFFAAIFDAPFFBDDDBCGHDOHDAbGAA..hCAA......hCBA...,1,12,-8,20
NOLcTCFbIWBgYaRHGAdUPSXeZDKJVMQEf,dAAASAAAeADAZABBKADA..MAHBEAFEOAHDLCEB.TDCAhAEAFCCA..ICFAhAAABDGDaDHDHDAAAAIBXFGChBAADDHBQEEA.fFHAhABACGBAgGCHYHAA.hBGA...,2,-17,-10,7
YUIWaHOJZBFGQDAVMeLdgcNCXRSKPEfbT,eAAAdAAA....gADACADARAEFKAGC.EAGA..TCCAUCFAaBHDhACAHCFB.ZFFAGCBAhADAAAAAMBIBLDDBhAEA.XFFAfHCBbGAC.IHFAhCAAWFHH.BHHDDIEA...hAGA...,2,-14,-7,7
fbQdgVeTMSEOGYJAHBLXWRNCaZIFKUDcP,HAAALAAARADFCAFBZAGBKAEADAGA......fCAEhAAAdBHAeCAAMCEAECCBGCEAhACAACAABDDAXEGA.hABAaGCAFDFB.PEABQGGCTEGA.SGGAhACA..hAEA...,1,3,-34,37
ZJBMRAUSWdXIPCGTKVHDELagbfYFNeQcO,SAAAdAAA..XADACADAGAEATAGAHAGDECCBLCCBhACAaCHD...bCECFDABhAAAeCHHQEDDhABAZDABMEFBAEGBIFHAKGCADDABfGGAcGAABGDAhADA.....hADA...,1,3,-14,17
ROeLVACcTaPgYFEZXQBWHGUbDKMJfSIdN,TAAAaAAA....PADAFACAEAFAZAGBQBGAHBBCGCEAhBAADCCAMCFBSCHHhBBAdDDAREGBeFABABGBCEDD.gGDAhAAABFHAWHFA.KGFA......hBIA......hCAA...,1,-3,-13,10
gGBYfEbUOCNAcSWPFLIZeaMKDdVXQTRJH,SAAAFAAAZACB.eACHaAED..DAGAdAEA.QAGARBFFHDGBGEBAhBAAfCFAUGGBCBHBhBEAAAAA..PDDBLEDBhCAAMDHB.XFFD.TGAA.hCBABEBA....hAGA...,2,-17,-7,10
cWdVBaKUFHGQZRSOgYALCbeDXPTJfMNIE,LAAAeAAADAEA.TAEAMAHB...EAGEdBDABCAAaBFB..FDCHHCCAhABAZEEA.RCFFOCHDhACAAAAACDGD.bEAB..XGCAhAIAfEEE.IGGAcGGC.KHCA.hBIA......hCAA...,1,4,-34,38
WECHSDPIaZMFdALBGYbcUJefgNRKOXQVT,GAAA..bAAAUADAeAEA..fAFFRBFAOCABQCCBhAAATBGA.EDFBHDBBhAAADDHB.aDDAZEABdDGDAAIBLFFAhABABEEDcFGANEEA.KGGD....hACA......hAIA...,2,-12,1,13
PNfVOaSdAFeMBEYXTWGLZDRgUIbJCcQKH,eAAAEAAA...TADAGACAZAFBRAEAICGACAHA..QCCChAAAHEAA.fCHAhABAaAHFAAEAMDIBXEEAhAFALEEADEIBbGEAKFCA.PHCA.OFGDhCAA....hCBA...,2,-15,-6,9
YCJfFBALSVGXabQRgDWPOEIUZMNdeTcHK,LAAAGAAAaADARADFDAFA..OAFDEAHFZCAAdAHA.eCDBHBFBCDFDFDHBhAAAACIBSEEBhABA.XEGAbDBDQFFChACAPFCBMHEA......hACA......hCBA...,2,-12,-9,3
UdEWOARHGJFQPYeKTIaLcfDbgZBXVSMCN,HAAAGAAAQADCeADAKAGA.aAFALCDADAIBZCAABBFASCGHhAAAMCHBUEEAEEABAADARECAFFHDhAAATFGA.fGFEhACAbGDC.........hACA......hCCA...,2,-10,-1,9
AKcfEFTWbYSQMLXDRUJNIPaZGeVOCgHdB,KAAAEAAAFACD..TADA..bADDQAFCMAFA.LAHBhAAARBFAUEEA.JCAAIDHAhAAAZDAAeDGB.CEEAHGFAhACAABFAfFHASHCADIBAaHFC...hADA......hCDA...,1,-10,-16,6
NbGeJfZUgQFCHDTBaKIRYcXdVLASMOEWP,MAAAEAAA....PACCGACB.eAFEZAFBQCCAhAAAHCCATCGAaAHDREEA..XFCChAIAdDHAAEFAOFAA.hBAAbFFCfFHAFHBABHEDIHHA.hBBA......hCAA...,2,-13,-1,12
GARbVWSQXNKcUHdOJITBPCfLYegEZaDMF,RAAAVAAAQADC.KAFCHADB.dAFBOAHDTCFABCCDCBHALDAAhAAAeCEFZDFBaDHDMEHBhAAAAEEA...bGCCXFFChADA.cGBA...IHHAhAIA....hBGA...,2,-18,-18,0
fTRJZUbIQOWANVLPEKdHaDgGFXecYCMBS,LAAAEAAAHACAaAEAGADA.eAFACAHAMCCBSBGA.RCAAZDEBhABAbCGB.QDGAhACAADDAPDED.dFAA.FGFDXECDhAAABHHA.TGFA.IHAAhAHA.OEHD..hCAA...,1,5,-13,18
EDWAJBIcdGXZYTFNLCVRUKgbQMPHOeSfa,BAAAdAAAZABBFACALAEARAEF.KBHBQAGCHCEA.eBCBaDBEEEEBhAFAACIB..JDFBGEGAhAGA.TGCACDHDUGGAhAAA.MEEB.........hAIA......hBAA...,2,-30,-11,19
VFXfaMCgOIYdWPQHLRebGTUScNKDBZEAJ,FAAAaAAA.MADA..OACDdAHA.QAEAHBCARCEAeDHFGBGAhAEASEBAKCEDZEFFAAHAXEEAhBAACFHA.IGBAhBEAPGBA..........hBFA......hBGA...,2,-20,-20,0
dfFHWTXOJRVgANYPKabeIQEMDCLGZBUcS,...PAAAbAAAeAEA..EADAMAIBLAGBZBEEBCAASBDAhAIAdDDDHDFBTDDAhBAAOEABREGBABGBKFHBaFDCDAAACCCD.hBIA...cGEDFHDAWCCD....hAEA......hAFA...,2,-9,-3,6
MSWAFKcHETCUbQJDLgPRNXVdeYIZOGfaB,KAAAHAAAEACETAEA.CAGB.QAECLCAARCEAXAGBdCHAeEAAhAAAZCCAGEEBaBHDMCGBhAAAAAIBFGHBUFFB.DEEB.hACA..NEIA..........hADA......hAEA...,2,-12,-1,11
GVRCWeKaJANgbZMFOTSHEfdcBQPDLXUIY,...bAAAZAAA.MACAOAEAHAEC.EBHFdBEAQCCBLBHBXCAAhAAAUDGBGEEAhABARCFFeDDBaFCBAAHAFFFHfGHAhCAABHCADFIB.........hABA......hACA...,1,2,-13,15
DTXIGVJbCFLQfPRSMHBadcNKZUWYOgAEe,EAAAeAAADADA..TADAGAEB..VAGBCBCALCBA.QCFBhAAARCCBHCEDdEGAKDHBhAHAZFAAUFEAOFHDAEEAXGGBhAIA.........hAAA......hABA...,2,-15,-13,2
BRbEHWQYFfDXgCNOSAVGeIcZMKaLdUPTJ,eAAAZAAAaACAdAEA.UAGA..TAFARBCBHDFAQCCBFEBB.hAAAXCEDCEEDOFDBAAHAGDGAhABAMFHB.LFAAhAFABGBA.EFFB.fGDADFIB.SCHBhBIA..hCAA...,2,-19,-8,11
FXSMENQeAdTKZJIbcgDBLUHVaYCORGWfP,dAAAZAAAJADA..bABDDAGA..LADAHBFC.aAGDOCAB.hAEARCCAGDFAfCEAhAFAFFEH.MAIBEHGA.eDFFhBAAADIB.TECA.KDHD.gGFAhCDA......hCEA...,1,-11,-21,10
RAfGVIeObMTHPCNWLSQKacgZDYJEdBUFX,GAAAeAAAMAEAHADA.CAGBLCDAQBCAaAHDZAFE.DCGAEDGAdDFAhAAAFEEBADHA...fEHAhAAAOECAbEGDTFAAhACANIEB.KGFA.YFCB....hADA......hAFA...,1,-5,-12,7
UBgdIObEMRVJNCaQYXeSPfcHZFTLKWDGA,BAAAdAAAOADAEACARAEA...JAGBCAHB...QBDCeCAA..hACAfCEEHCBBZDFATFFAhAIALCGBDBIBACAAgFAAhAAAMEEBaHDC.SDDD.hBAAFFFH.KGDB...hBCA...,2,-16,-14,2
ZcbgBIFYSXRKHALQCfPdaJVOWNMEDTUGe,LAAAQAAACAEAdAGAaACE...OBHDMAFAEBEADCAA..GCDAhABAeBGFZDAA.bDDBBCFDhACAFCHD.XEAAhAEAHFEBAGGA.fEHE.PFFB.WGBGhAIA.....hAAA...,2,-17,-8,9
CULNeVRFKgYQWESZJfAPbHOMdTGaBXDcI,HAAAdAAAaADADACA.CAEALAGBeAFH.RCCA.KAHB.QCBAhACAEDHFZEEBAAIB.OCGD.GDDAhAHAXFCBIGFAhBAAUGGAFGBB..YEBF.SGDDhBCA.fHGFhBDA,2,-24,-6,18
EAdKGeMTgHDQZWbLJCYFaIBURPSOXNVcf,GAAAeAAAMAEAHADAZAFELAGB.CCDDaCEDBBCA.RCDBOCFChAAAXDGA..VEBBhABAEFAAAAABdEGATFFADEIB.hBEAbGCCFGFH..IHHASHCA..hCAA......hCBA...,1,3,-15,18
eQOafYcbNBXPDRGFMWILUKVgAEHZSCTdJ,HAAAZAAACADB.dADA.eAFAaAED.....fBHA.bCAChAAAXAGA.RCAAGCEBhABAMCFBLEDBhACAKEEAAAGAEEHBTFAAQGGCODGBNHCB.DDIB.hACAFFHH.....hCAA...,1,10,-23,33
BMaHgTRKIUXcSCYEfWJAGbDQeLNVOZPdF,GAAAQAAAeADALADAOAGDdCDAMAHBHDFARCBA.KEADXCFDhAAACFCA..EFFBfEAAhAEAAAABDAIBZGBABFHAhACAaDHDTECAIHHASFFB..hAFA......hAIA...,1,-3,-17,14
aecJbXWKTUOGfPDMVQSIHLdERFYgZCBAN,eAAAJAAA...XADATAEA.GAGADAGA.MCCBQBGAhADAHDDAEEABRCCAFDFDZFDAAAAAaEAAhAEAbGAC..KEHBfEHAhAEASEEDIHHAdGGACHEA.NIBB...hAGA......hAIA...,1,4,-17,21
GSZUCFPecNYMIHVDJdKaLTOXbQAERWBgf,RAAABAAAGADAZACAFAFAeAFA.....NBIA.MAIBHCFBDCCAdDAALCGBhAAAOCCBQFDAhAAAEDAA.fFGAhABACDDA.cGAAIDFA.KFFDaHDChADAXEAAAGIB.SEHHhADA,1,-5,-38,33
PcRDSGEMgKLFXQOYCBHIAUTabNVdJfZWe,aAAAVAAA..dADAZADBeAFARAFA.GCDB.EBBBMCFB.LCHBhAAAQEEBCDAAHEFBhADAAAFAbEGDJDCF..fDBEhBAAPGAC.SBGAFHDE...hAGA......hAIA...,1,-4,-10,6
HZeVEbCFDQPLcWBgRJaSGOdYAUNfKTMIX,UAAAKAAAMACAHADAZADEEAGE..FAHBQCDBLCCA.BCGARCFF.hAAAaCHDGECAdDAAAEFATFFAhADAeCHHCEED..DFIBPGCChAFA..gGGDOHFENIAB...hAIA......hBAA...,1,-2,-14,12
aTDeYSbgHQABdZNIUFCPVXEJLfKcRGWOM,ZAAAUAAACADB...XADAEAFALBHB.KCAARAGBGCBB.hABAMCGBaCEAeDDB.hADASDFDHEAAAAIBdEEAhAEAFFAAPDHDVFGBfGEAOGAETGGAhAGADIAA......hBAA...,2,-11,-5,6
EbDcROVUQSYCFTeGPNJKgXdMaHLfAWIBZ,BAAAEAAADADARACAUAFA..QAFA.CAHAFBCAeBHHGCDBhAAAPCABKDHB.dEEDHCCChAAAACCB.ZEFAOFGDhCAASGDA.TGGANICB.....hCBA......hCIA...,1,-21,-22,1
QeCPAIZfSHUGBcVNJMRXLWOYFdDaETbKg,ZAAAHAAAGAEABADBVAFAMAHBLCAB.OCCBdCADECEBKDGDhABAeCHFAADA.SDCHhAAAUFFBJEDB.REFBXFAChACAFGAADAIB.aEEH.gGDG.CHHA.hAFA......hAIA...,2,-13,-4,9
bWJTGVecEUZfaHCPOLNAXFKRgdYSDBMIQ,KAAARAAAdADADACABAFA..MAFAQBGA..bBCAJCCFGBGAhAAA..eCFBEDBAZEBEhBDAHEDBOEGHAAAAFFAASFHBhAFATGBA...cGGCaFEDCHHA.hBEALHAA..hAHA...,1,-9,-17,8
PWSQKAEdCUFLHcMOebgfTXYRDVZNBJGaI,EAAAdAAAFADAHACA.MAEAeAFH....bBEATCBA.RBGFZECBhACABCCDGEFAaCHDIDEAhAAASFEDAAIBLFFAhBGAOHAC.XGDCDEIB.JHFE...hAHA......hAIA...,1,-1,-15,14
CEABVSLDOdRbJcUWFPNHZgMTIGeXYQfaK,SAAALAAAdAEARACF.JAGBUAEA.FAGEHCAA.ZDCEMCHBGDGAhABAeDEBQGAAhACA.aFFHEFDBAAIBDGEBhAGAbEFD....WDHH...NICB...hAAA......hABA...,2,-24,-5,19
WXfVEGbZLNDcOaUSFBdKTgHPMYARCeQIJ,RAAAeAAAQADC..IAEAJAFA.XAFDECCBZCEBLCHBhAAADAIBaBCD.FDGBdDEAhAAATGGAHDGBMECBhABAAIAA.fGDA......hAHA......hBHA...,1,-17,-23,6
deXZSBDcKRUfLbGIQANHCMYaFPEWJTgOV,HAAAMAAAFADDEADEJAFA..OAFAdCADeCEAZBBFDBFB..RDCBLDHBhAAAGCFAABIBCCHDaEEA.hBAA...TEDAhBGAXGGCBEHA.KGHB.......hACA......hAIA...,1,-15,-26,11
XFTQLWMefbYRHgIZUSACNKEBPVJcGadOD,KAAAEAAABACA..PACAJAEA..GBCBdAGADAIBFBHDLBFDhAAA.eCCBbDDAHEGBhAAAZDGBACEB.CFDA..NHAB.aEEChCAA.TGDAMFFB.fGHA..hCBA......hCDA...,2,-24,-17,7
WdHNeSDIFPfGXAKUCaLcVZOMgEbRBTYQJ,CAAAaAAALACAZACB..MAFAEAGABBHA..TBEAQCCAhAAAdBGAHEBAeCFBDBBBFDABhADAGEEAADHAKEHBVFEBhAEAOCHDRGAA...........hAGA......hCAA...,1,-11,-14,3
ZWKRAeCTMLaPUIVgFHQNGXJcOSDYbEBfd,eAAAMAAALAEAUAEA..VCCBHBBAGBGAXBGA.OCEChAFADAIBEEBBdDBDZEFFREEAAEEAhAGAaEHDIGGA.hAAAFHECQFDA.cGBC..hABA......hAHA...,2,-11,-4,7
MbcFASJgCTKOaPfQUNZEDWBedLHXVGRIY,SAAACAAAKACA.OACDaAEA..QBEDZAEAECEABAHBeAHBhAAAHDECGCAARECBMCIBhAAAFCCFACABJFAB..TDGAhACAfFFEDDFBdFGDLHFAIHCA.YEEFhAIA...hABA...,2,-10,-8,2
ZHRANdEWDaXbUTcfJPIBgOVYQCMKLSFeG,EAAAaAAA.UADA..TADA..fAFFIAGAOAHDhADAQBGAKBBDLCDAhAFAeBCDHDFAADHBdEEAXEDDhAAAbEFD.PDBBBEHAgFCDhBAACFHAMHFA.SHGAhCAA...,1,-2,-18,16
IBMcfeXTOAKDbWaQGPRUVgZYNSFECJHLd,DAAAaAAAGACARABA.UAFAZAEBSAGA.FCGAECHFHDCAhAEAdDFAMBBB.eEABhAEATEFAAAIBKEDBQGDAhAHAgFGACFHAIHHAfHBF...hBAA......hCAA...,2,-22,-10,12
THeBSKFLfGEJaYXZCMQcObPWdgAVUNRDI,UAAARAAADADAHAECeADAKAGALAHB.ECCAaCBE.ZCEA..MCFBhAAAQEAAODGB..hADAbEDDdEEA.ACFAIFHAhAEASFGHGGEB...YHCAhAIACHCD.....hABA...,1,-6,-19,13
YgdEKBfRcJFWMPXTHeDAZbCNSaGIQOLUV,ZAAACAAA.aACAGACA.QAEALAFAVCDAdAHAECABBCGBRDFAFEAHhAAAMCCB..TEDAhACAHEFAAAGA.SCHHhABAOFGDUGDBKGHB.fGBA..hAEA......hBCA...,2,-16,-5,11
YSfTJHdPNUXQMacFIOCGeBVRKWZbgLEAD,SAAATAAA.HACBdACAUAEAMAEAaAGEFAGE..CCGA.GBEAhAAAeCHHBDDARCGFZEBAbGCAEDFB.hAAAAEIB..DGGA..fEBAhBEA.PFFB....hCAA......hDAA...,1,0,-28,28
CZaSXJgFYAHKVNBcOWIbGedMTfDPRLUQE,HAAAKAAABACBOACA...IAGAeADHdAFAMAIBTCGADBFBRCCBhAAALDEBUEFAEGCAaAHFhAAA..SFHBhCAAJEHBFFBAACCB.NIEB.....cGED..hBFA.WHBC...hCCA...,1,-14,-21,7
TJWEaBIgZSKVPXLAeHUfDRdYGbFcNCMOQ,HAAADAAARABAGAEAFADACAGA..MAIBQAGA..TCCAhAAAECDBaDFDBCADZDGBKEAAXCEBhACAAEIB.eCGFdGAA.hAEAbEGD...OEEBIHHASGAAhAGA.....hAGA...,1,-4,-19,15
FRDHZIXVfLBYEMSbPaONGUWKcdQTgAJCe,eAAARAAAHADBZADB..XAFALAGBECCBMAIB..SBHHhAAAaBFBGDBAKCFBdEEATDAAhABAAAAAFEHBDGGBVEEBBBCAhCAAbFAA..OEHB.NIAB.....hADA......hAFA...,2,-15,6,21
RKgXVWCIFPLMASJZQOUdaHEbfDBYTceGN,ZAAAQAAAdAEAHAGBEACADCAABAEA..TDAAeAFHRBGF.XCDDhAAACDDAFDFBLEHBhABA.AAGB.ODCHUGFA.hACAbEFA.fGEA.cGGANIAB.hADAKHAA.....hAIA...,2,-16,0,16
JCULVMdGfZYbeWIREFSOaAgBNHcTXPDKQ,BAAAHAAATAEADACAKAEA.QAGC.CCADLCCBdAGAZBCAeBHHhAAARDGBECEBODBAACIBNEAA.hAAA....XDFDhAIAPEEBUGGBMEEB....fFHAhBDA....hCAA...,2,-43,13,56
OSZJWaTPRIQAKEdVCMDFNebHBGLgfUcXY,EAAAdAAAMADAFACD..eAEAHAFCGBGALBDBUCEAXCAAhACA.SCFBhAIAZEAAaEHDRFFBAAIBCCHADDFBBDDCfEGAhBAA.OEHD.....hAAA......hAEA...,2,-20,-8,12
eNGJHYQRZWgDTEcOUBadXPKCMIVAbSLfF,LAAAeAAAGADAHADBRAFAZCFEDAFAEAHF.OBFDaCCHdEGA.KFAAMCABhABAAAAA...bDGDFGFHhAFA..JCCF.QEEChACAWEHH.TFBABHCA.CHHA....hAGA......hAIA...,1,2,-20,22
LGWeFITMYHJOEdSUfgBPVXacbNKCRQDAZ,GAAAeAAAFADDMADAHAFAEAGAdCFD..SBFDUEDABCCDXBGAhAAAaCHD...bCDDhACACFAARFFFACDBZEBBLHAAhAAATDGA.OFEE.fGHA.hABA......hAFA...,1,7,-18,25
GSYNdCcaXEQJKfLVeMgIHbTWBUZORFADP,GAAASAAAdADAaAFAEADA...KBFALAGB.eBDAMAIBhAAAHDAATDDABCCDZDBBhACAREDAAAAADDFAPDHDCEGAQGEAhBAAfGCAIGHAbGEA....hBCA......hBDA...,2,-17,2,19
JXEIWcQLKOGDPgbNeAFCVRSBMUdHaYZfT,CAAARAAAMADAHACAZAFB..JAGBEAHF.....ICAAQBDAhAAALCEDGDGADCCBhAAAbDDCAAEASCHHhACAdFCDaFFH.TFGA.XGEC..hDDA......hDHA...,2,-19,-18,1
ZUJcKHTaYPONIfQLGMegADBFEXVRdCbWS,FAAAEAAARACAdADA..CAFB.SAFAZAGB.UCFAKCCDHDAB.aCHDhAAAOBHD.IDBAhAFALDEB.eECHhADAADDAXEECbEFD.JFGB...TGAAhAGANIBB......hAIA...,2,-34,-5,29
DdQbZcOWBgAPCIFYeMGXHETNJaKLURVSf,CAAAFAAA.eACHGACAHAEAEAEA..JBHBaAGDLDDA.REAA.fCAAhAAAdFFAZFGBOFDDhAEABCEAAACB..IHAAhAGAMAIBTDFA.KEAASGCDhAHAbFFAgGBA.PHDChAEA..,2,-9,-9,0
CLMRPOTeIFEBgHSWaAGVYbJXKNdfcDQUZ,GAAAVAAA.JADAKADC..dAGADAGAZCDALBFARDBF..TEEAhAAAeCDBEDFA.HECBhAAAaBHDAEHA..XFFAhBGA.fHBBQGGAMEIBOFCDhACABHEA.....hAIA...,2,-19,-6,13
TdGbPMKLJXOWSeRDUINFgZBfECAHaQVcY,HAAAaAAA.QADC.VAGBTADAGCABbAFB.MCFBLBHBhADAODGBeBBBRFAADDIBhAAAIDDAFFHH.ZEFAhAIA.EFCAAAFAYEEFdGEAKGGA.....hBAA......hCAA...,1,14,-5,19
NEXVIaBZRdSHYJKeOcTGFWfACbQgDULMP,QAAADAAAMADA.EACA..XAFA..aAEDRBBAHCEAhAIAKAGAeCDBTEBAGCFAhAAAfDDEACHAbEBBLDHBhAGAPDHD.IHFAdFFASGCAOFDB.hAIAFHGECHHA.NIBB....hBEA...,2,-1,4,5
cEOPeZYHfUTgFIDLSdNGAWMBJQVXaKRCb,MAAAQAAA.aACERACACAFB...EAHBeAEHHCCCTAGAFCFALEFAhAIAdCGDACDBBDAAXGEAhBAAbDED..OEHBhAAA.ZGAA.........hBBA......hCAA...,2,-27,-5,22
eRIEXFgBbfVcCKdZPSDMLNaHOWTYAGUJQ,GAAAQAAARADAEAGEFACE.BAFA..bCDAVBGB..KCHBZCDBhAAADDABMDCBLEEAhAAAHFABTFEAADCBeFCBXFGAhACAfEHACHHD.SGHH..hAFA......hAHA...,1,-6,-14,8
dOWQeafZTAUYHIJGLPEbcBVDRCNKSMgXF,HAAAGAAAEADEBADARAFFKBHBMAFA..FCAHdBFAQCCAeBHBZCDBAAABhACAUDFB..IDCAhADALFAA.bGFADDHBhBCASHAAOEGHaFED......hBIA......hCDA...,1,-1,-22,21
EKFZNRgaBPbeAYCIDTWfGOXUJMcdSQLVH,CAAATAAAGACA.UAFAMACA..dBHALAGBHCABFDFBRBDAaCCHBEDAhAAAeCHH..AACBDEHBhAEAODBH.XEEAhAAASFBHEFDBKFHBZGFA.NIAB......hAIA......hBEA...,2,-23,2,25
eSRCULAMJBDgfdaPKXYcNEFbVGIHWQTZO,MAAADAAAdADAKADA....XAFA..cAFAEBBAFCEDGBBAhAHAHDFBQFAAhAFAZDEAeECHRFDFLFFBhAIAAAIBBDHAaDDHPFHD..YFHB.hBAANICB......hBBA...,1,-11,-12,1
YRJESaNAKZfUBbdFeGLODCQHXIWTMgPVc,ZAAABAAAdAEAeACAGAGALAGBCCAA.HBDC..XCCChABATCAAMAIBVDEBRGAAEDDB.hACAaEGAAAGBKEBDUFFAOEHDhADAQGBA..gGDB.hAAAcGGCSHGAhACA...,1,-4,-7,3
LbVUHBeMQXAgDfIWTEcSCaGZYFdKONJPR,DAAA..fAAATACA.EADACAEBZAFBdAGAOBCB.JBEBRCDBbBGDhAIAHDAB.BCHAeBBBhBAAMDDBABIB..gFCBhCAAIEFASEGHaFFAFGGH.KGBA.hCFANEIA......hDAA...,2,-16,-7,9
AOVXCSRIgWTFZDHBfJPQGMNUEKaYLebdc,XAAARAAA..gADBFADAHAFBBAHA.JBDFGAGAhAAAMCIB.ECCB.aDFBeDEHhAAAdEGDAAFACDGA.SEDHhABA.TGBAZFGFfHABQGGA.hABA......hAHA...,2,-25,-2,23
aObZSeKNFPDVHLUcCGgAQfYIdMRBETJWX,QAAA..fAAAdADARAFAECEF.TADA.XAFBhAAAbCGDeDBBFAHDDCIBHCAAhACALEFDCCEAACCAMDGBhADABFAAaDHBZGAEKEEB.PFHDcGGA...hBCA......hEAA...,1,-2,-15,13
OJHaMAWcZLReUPBQYKDNTbEdCXVGfFIgS,ZAAARAAAeADEBADB.QAFADAGA..bBDDECAA..dBHAXCDAhABAGDFAFCCB.SCFChAAAHDFBAAIBLDHBhACAPFHD.KECACHEA.fFAA.OHBAhAFA.aHEE..hBHA...,2,-15,-13,2
FHVeKXMZDROIGUCJNbLSfQWcYBTaAEgPd,EAAAdAAAHADAKACA.ZABBRAEFGAGACAGB..JBHBLCCB.QEAAhAAA..hAEAcCEBTEEAADDBFDFDhAFAeDHHMEIBOGDCIGGANIABSGAGhAGA..WHFGBHHA.hAIA...,1,10,-40,50
ZSVFQDNaRPKWbMEgYcCeXJBIUOTfAHdGL,HAAAGAAAZADBFADAQAFADAGA.RCEFKAHBMBGB.EBHB..gCAAhAAACCDA.eDGFhACABDCDODHDAAABdEEALEHBhACASGHDaFCB.PHDA..hBCA......hBDA...,1,-1,-27,26
McHaIABebdSDZJgLQTNFUVKEPROCYXfGW,eAAAdAAAZABBLAEAQADAFBCDKBHBRAFA..CCGA...XCEAhAAAGDCAMCIBHDGBAAFASEEBhAGADECATFCAVGFAhAIAEFEE...........hABA......hAIA...,2,-18,-9,9
RZgUeBQCMaAKGTWHEOIPFVLSdDbJYXcfN,GAAAHAAAEADEOADAFAFALCAAdAHADBGB.JBHB..XCDAhAAA..fCEAhAAARDBFZDGBeEEBQECChACAaGEHAGIBKHBA.TFEA.IGHA.SCFHhAIA..hCCA...,1,-9,-15,6
MIdRZVSNHcEKQPaJXAFTWODGfeLUbBgYC,TAAADAAAeABA.LAFABACBCAEA..dAGARBCAZCEE..SBHHhAAAHEFAEFEBQGAAhAGAaCCAACFBODDB.GEAAhAEAfGHAUEFAYFHBMIDA.IHFAhAIA....hBGA...,2,-21,-3,18
GSCDBJAYXdNfZQMbHcUPKRWTgIaEFVOLe,dAAAZAAAMACAHADAUAGARAEA...TCBAaAHDFCCHLDEA.hABAeDABGCFADDIBACFBXECAhAHAQFFAbFGDKHDAhCAAgGDB.......hCBA......hCEA...,1,-3,-18,15
KRZATXVNQOJIbBLFDPWYGacMgedfEHCUS,TAAAXAAA..QACCOADAJAGBBAEB.LAGBhAAADAIB.PCDDGBCAaCFBhAIAMCFBeCHHEDGAHFFAhBGASEBBKGEDAHHA.IFGA.FGHD.hBIAYEEF..hAAA...,1,5,-31,36
IaLNeHQCgFEKBXYdRcSfOJGVMbUZWPADT,TAAAaAAALADA.HAGBQACCFBBHECEB.XAEB.hAEARAGBSCDHhAAAODCDGEEBbCFDZFDAAAIBDFABeEHHhAIAKGDAdGHAfHEBMIDAWFAH...hBIA......hCAA...,2,-2,2,4
YLFWDeCfbIMdEZJUSgTQHGOXacNRAVPKB,KAAALAAADACA.eADHCAEA.....bAEDdAGAZAGFSBCHhAAA.QCEChAIAHCABGEEAaBHDREFAAAIBBEHAhABAFEDH.fGBAEGBB.....hBGA......hCAA...,2,-32,-9,23
LOJIMYZSCFVQWGDBbRKgaUNXfTeEHdAcP,LAAAOAAA.MAEAZADBFAFD..QBDAGBGABAHBRBFAaCAAhABAXBBC.eDBFhBAAHDFCADFB.PDDBhACAIFFACFFADFIB.bGBAKFHB.NEEA.EHGE...hBDA......hCAA...,1,3,-25,28
OSbcUWMGFKTPBIEXNVDgdAeYZQaRCLJfH,eAAAZAAARAEALAHBHADASAFEUCAAGCDATCCA..BCFAhABAEBHFXCEDDADA.hACAAAAAaDHDfEHAhCHAOFFBcGCAMFFBKGGDIGHA...hDAA......hDCA...,1,5,-19,24
RULDeWbPEaXFVdOGfNHMZTgBACIYJcSQK,CAAAJAAA..QACARADFLAFBeAEA.....bBFAEAHBaCAAhAAAFCCHdDDAGCGAHDGBZDEBhACATEEAAFAA.IDAAhADASFAA.DGGBXFCCfHBBhAFAMFIBBHHAKGGD...hAIA...,1,9,-22,31
ECeVKdcDMPZJUfRWFTXYALHgNbSGBIOQa,HAAA..bAAAGADAOAEAEAFA.eAHFdBEAMAIBZCAAUDGBRCAAFBGDhAAATFAAACAA.LFDBhAAASECAQFFBhACAaEGAKFEADFHBfGCA....hADA......hAFA...,1,11,-18,29
eJGLgRYIONWZFMDfVSEBUPCHTXbdKaQAc,eAAAGAAARADA.OADAZAGBDBIB..SAGAECCB.BCDACCEAHEAAhAAAbCED.dEEAKCGAAEHALFHBhABAIEHAFDCH.hAEAMGCAfGAEUGGAPHAAaGCB..cGEDhAGA....hCAA...,2,-12,-4,8
IDZgKUPWJSOTEAdGFXQMLYcVCfaeHbRBN,GAAAQAAAMADALADA.VBGBaAFEHCDABAHBDCDAZCGBKDCDhAAAUDDAPFCC.hAAASEHHEEAAAAEAdEGDXGGAhBCACGGD........hCAA......hDAA...,1,-12,-17,5
BGIbaRTWESQAPZYCJcKgMNFfVOdLHeDXU,ZAAACAAAKACAMACA.FAFDOAEA..HBDBeAHFXBGDGBEA.hAAAaAHFRCAA..EDHFACCBJEFAhABA..NECA.dGGALGEAhACADFFB..........hCAA......hCBA...,1,-22,-23,1
PLTcSbJeGQdUWYRCafDXFMBOENIKZHVgA,TAAASAAA.eACHdACAUAEA.RAGB.aAEADDDAMAHBBDFAEBEBhAAAKDHBHCFB.AAIBLDDBhABAJEBA.QFBAhBFACFFAFFHH.OEHDNIAB.IHFAhCAA......hCBA...,2,-33,-5,28
KUDcXISEGdVOCMJbLNWYeFTRfPBAQaZgH,ZAAAHAAADACAXADB.EAFAdAFA.CAHAMBEBLBHB.YCAFhAAAeCCBRCFA..BEFDhABAACCAaCDEKEHBUEEA.SFHBhACAOFBBJHEAbGCC.FHGC..fGGBhAHA...hAIA...,2,-31,1,32
BaZWDJIVAFKPQGXRUdONSeHfLYTgMECbc,KAAAGAAARACF.dADAOAEAeAFAHCDC.LCGBTBEAEAHFbDBDBEEDhAAA..ZCAFDBIBhACAIDGAAAFAQGEAhBAAXEDASGHBfEHA.MICAhAAA.aGGC....hACA...,2,-30,9,39
WVDFLQgOdASTUNXCcGMbYIZKPfaHREBeJ,TAAAXAAA.GADAMACA...IAFAZADEKAHBaCCC.HCEBhAAAEAHBeCFFJCHFDECBLDAAhAAAQFGCdDHAADBAhABASGCACEGCcGGAPHCABHAA...hAHA......hCAA...,2,-13,2,15
SRIXBZJfHNAFLcUMVDdYOTWKbEQGgaePC,LAAAMAAAdAEA.TAEAKAGA..EBBAGAGA.eCAASCDDhAGARDDABEAAZFFAHCECAAIBFECHhABAcDGDDDIBOGAChACAbEBC.aGDDCFEAXGGAfHFBNIAB...hAIA......hBAA...,1,6,-17,23
LGDCRSePFcKJIVgEaBOHdbfXWNAZQYUTM,ZAAAQAAAUAEALAHBGACBRAGF.eCDBFCAAKDAD..IDAAhAAAEDDA.OCFBhADAHDFAdFFDbEGB..XFAAhAFAABGAMFIBSEBH.JHCAaGFB.hABA......hACA...,2,-16,4,20
XZYRLgBGVSeWAcbINQMDUEdTCPJfKOFHa,..IAAAMAAAEADAdACA..CAFA..JAHBOAEA.HBDBZBBARCEFhAHALBFAGEFAeDDDhBAAACBBbDFAQFFAhAIADDIBTGCA.KGDA.aHBC.......hBCA......hCAA...,1,-6,-19,13
TKdUROGEaQcfZNIAeXLBYbVMFWPgJSHCD,eAAALAAABADAVAEAMAFA..FBHD....gBDAhAAAHCAATDEAdBGARDEBEEABaCCHhABAQECCZEGBABIBXGCAhCAAbEGDJGDE.DCCA.OHAC...hCBA......hCGA...,2,-17,8,25
PVfCLBTGcYDaUMROWHgeNdISXQFEKAbZJ,ZAAAVAAALADB.GAFADADAaAEERCABHDEB.eAHBdAHAXCDAhAAAEDHBAAFB.JCGFCFHDBGGDhABA..TECAhBHA.UFGBMIAA..WFFD...hACA......hAIA...,1,-7,-25,18
QgXcRKBeSMHdFLWJPVOUYfNCGITAbaEDZ,EAAAZAAAQAEA..XACARAGBeCABHCCCdAFALAHBhAAAPDFD.OCCB.hABAfDAACDHAIFHAhACAABHBaDEADEAB.KEEAMIAAFEHBJFBF.UGGB.hADA......hAEA...,1,-3,-10,7
PdNVZMcDJBGQIAOUXTeFYCfaSKWLEgHbR,XAAAeAAACADA...aADAKAFA.EBHFHAFBRCCA.dBDAZCFFMAIBDDIBGEEAhAAAAAAAODCBFFAASDFAhAHALHAA.bEEChBHA.....PFHD....hCAA......hCBA...,1,-13,-19,6
YBfVIWQUSDdcFZeLMJEPTbACROgNHXKGa,RAAAOAAAHADBGAGABADA...IAFAQAFADCCBdDAAZBBAeBHHhAFAMDDB.ECFBbEEBADDBCEEAhAIA....XEGAhAAAaEGE.fGDAUGGAFHBA....hABA......hADA...,1,-8,-16,8
NIXRWHCYDTKaZESOAPQMbUcBVeJGgLfFd,MAAAUAAABADA..eACAGAEALAGBdAGB.XBBChAIAHBGBDCDBaBEDEDAAABGBbDDCVEDBhADA....fDHAhBAAFFHB.RFFBCFHAKGFBOECH...hBAA......hBCA...,1,-2,-18,16
EfCaVMFTWIGUJQcbYeAHZXdRPOBgNKSDL,HAAAdAAARADABAGBKADCLAGB.EBEAaAHDMAIBFCBD...TCCAhAAAGCFA.QDDAhACAbDFCACAB.ZEAAOEEHhACASDHBCFHA.IGHAcGCCeHFAhCCA......hCGA...,1,-6,-21,15
XRbITaONfEFdeBZMCcQVSJYLUDKGPWHgA,RAAATAAAOADA..EACEeAGFZAEB..MAHBQBDD.SAHHhAAALCCBKDGDhAAAGDGAHEABACCBbEDBaDHDFEEBhAEACFFD.cGBD.......hABA......hCAA...,2,-19,-2,17
QNObAaXKGeLgSVMFRITZHCYJfDcWEPUdB,aAAAGAAALADASADAFAHB.RAFFZCDFHCCACAHB.JCGF..DCHBEEAAhAEAdEADBBBDQEGBhAAAOECEACIBeFDB.gGGAhACAMEIBTGFA......hAFA......hBAA...,2,-18,-2,16
acKJSBQVedUbGDfgOWHMTIELANYXPFRZC,XAAARAAAZADB..aAFDKADABAHA..eAFEdCCCGCGADBGBOCDBhAAAHDABMCFBEEEBAAAA.hABA.PCHBCDFC.SDAAhADAQGFDbEFDfHAB.hAIA......hCAA...,2,-27,-9,18
SQBJWUKOYgfRAeTaXEcGIFMCdLNPbHDVZ,eAAAaAAA.EADAGACAFAFD.dAEBLAHB..bAGDHCCAZCEBQEGAhAIABDFAUECBOEHBhAAAfFBAABHBXGFDhABAMBBBCGEADGGBSFFF...hBAA......hBFA...,1,-6,-12,6
WIJQgcCOPdEaeLFBRGAHSbXKYUTVMNfDZ,HAAAXAAAKADCUAGA..MADADBFBZCAAIAHA.QBDAhAAACDFAdDHAEECBLFFBhAAARBFBACHASDBA.hACAbEEATGBA.NEEA.fGGE.hBGA......hBIA...,2,-18,-15,3
JKDNQHTGRUXeLPFOgEbISCWBadAcYVZMf,VAAAZAAAMACA.KAFAQADC.HAFBRBDFeAHHLAHBhAAAOCCHEDDA.SEFAhAFABDFAADIB.fFEEhBHADEHBGGCBXGGAFHACIFFA.CFDC.hABA......hAHA...,1,4,-24,28
FPdXGVAbceMHOYafCISLDZRBWTgQEKUJN,eAAAHAAAaACACADA.LAFARAEFBAGB...TCCAEBHF.KCECUDCAhAAAFCGDdEEAGEEAAAGAMCIBhAAAOCGH..fFHEhCAADDIB.........hABA......hAIA...,2,-32,-10,22
cDdbIfVMZCPKHBAWaQXGFUSYJTNEROLge,aAAAGAAA.SADATADA.RAFFLAHBeAFEdCCA..bBFDfCDAhAAA.ZDFAhACAKCHBHEACABBBQDAAhADAFEEHUGGAYHCAEEDFOFFA.DGGB.MHCAhAIA.BHHA..hBAA...,2,-9,16,25
VKgSUIcLaRDePOHGNFQTYbfEXJCAdMBWZ,dAAAMAAAZABBKADAUAEALAFB..RAGBeDBAHBBAGCGA.hAIAQDDCbDFA.hBAAEAHBCEEDADFABFCD.gFFDhAIASFGB.aGGHDFIB.NIDB...hBAA......hBBA...,2,-25,-7,18
OVUAZWDgXICBNJcGSPFEaLfHMYQRTdeKb,ZAAADAAA...XADBBACAJAEAGAFA.FAHFEBBBLCABhABAHBDAMAIBRDDBeDGH.bFBDhACAOCGD.ADDBIEEAhAHACCCDSEHHaEHD..QGDAhBAA.TGFA..hCAA...,1,4,-33,37
EDLaZISQNVCFcWKbdXAfGegTPOYUHBMRJ,eAAATAAAOADC.HAGBRACFEAEELCCAZAGBQCEACDFAFDHDKECAhAAAdECAAAFA.GEGA.hABAgGABPFFBBHGAhAIAMCABDIBAaEEC........hAAA......hACA...,2,-13,0,13
JMBNACcWfePLQXFUVaRYHTKdgGIZSObED,CAAA..fAAAeACALAGBQADAFBEDUCAARAFAHCAA.dCHAhAAAGDCAZDCEbDFDEEEEMFIBhACAAAIB...PGAAhADAaCHDTFGAKHDASHFEDGBBBGEA...hAAA......hACA...,2,-20,23,43
KQHdfSERCbgTFAMGWJXPONBaVUILDZYce,GAAAXAAAOADABADA.UBGALAFAZCDB.eCDAHEBBdCHAEEGAhAAARDAACDFA..TFEAhACAAAAAMEEB...PFFAhADAaGHBDCDB.KHAAQGAA.SGHHhAGA...hAHA...,2,-8,-8,0
IKPNJSXAEaYeZBdTHfGMVLbCRWOFcQDUg,EAAAeAAAdADAHADAGAFAMAFALAHBRBFA.FCBBQCCChAAADDDAUEFB.KDFD.PDHBhABASFAAAEEBZGFA.fGGEhAAA.CHBA......WEEDhAFA......hBCA...,2,-23,-5,18
KWacGRHeCXVNOZULQEIdPfBJSbAMFTgDY,MAAATAAADAEA..KACC..aAFERAEAHCCAeAHH.CAHB...XBBAhBAAOCFDZDGBLCEBhBBAEECBdFAABDGD.bEBBhBCAACHAFEEH..gEGAYFHB.cGCDhBEA.....hAAA...,2,-15,-15,0
KeUQEgWVOZcYdJRGPNIBXHaAbTMCLfDSF,MAAALAAADAEA.KAEAUBBAEAGE....VCAAZAEEdCFA.RDGFGEDAhAIAICFABBHAHCGBhABAADEA.TECA.SEADhACAeFHH.QEEC.OFHDhAEA....hAIA...,2,-28,-11,17
XaJAMIGeZQOBWdNLPDRKFbUcVfYTHESCg,GAAAeAAAZADBQADABAFAdAHALCCDRAFAFCDHUDFA..VDEAhAAATGAAHFCC.EFHBCDHAaDAHhAAAADBB...MFEBhACAOHBC..PFHDKGGD.....hABA......hBDA...,1,-2,-10,8
HBVEOWfdSXUQgcYIDeNLTKbPAGaRFCZMJ,RAAAZAAAHADBEADE.OAFAdAFAUCAA..QBFC.gDAAhAAAIAHAeCDFhABATDGAKCGAABIB.GEEAhACAaDDCMFFBBEHA.fGHAXGGA.DICA.hABA......hADA...,1,-10,-18,8
JZYTNUbeXCdFgfIDLcWHBVEKMaRGPAQOS,QAAASAAAZACB..TACAUAFAeBEDdAEAFAGA.fBGEhAAALBHBHDFBhAAAEDDAaCHDRFBAAEEB.OFHDhABAYDFBNIAB..CHGDDHDABFHA.MFEB.PHFAhCAA....hDAA...,2,-14,0,14
gMTbZYVRCKAOdLXIQHaceGFDWEUSfJPBN,dAAALAAAQADAHADBeAFAGAGADBIBECBASCAA.hACAJCFBBAFA.MDABhADAZEGBRFAAAAIBXDDAhBAAaDDHFHCA.fEGE.gGDAhBCA......hDDA...,2,-19,-8,11
TOJSNcFBMDdfRIGQEXLbYWeCHKZaAVPUg,UAAATAAAOADA..SACBFAGDDAIB.RAEAGCCB.hBAAEBHFbBDDeDHFHDBBaEAAhAAAABDB.VFABJDGBBFDAhBCAdEFAfGHA.XGCDYEHB.hAEAWFFD....hCFA...,2,-33,18,51
OTVXcIJSDaLUWMEKdANQHCPeZgFGRYfBb,HAAAeAAAZADBGADARAFABBCATAFA.XCAAJCFF..aCHBLAHBhAAA.MDDBhACAEEEBAAAAQEFAhADA.CEHAFFAAbGAAOEHDIHCADGAAKFEDdHFB.hAFA......hCAA...,1,7,-21,28
LEUCeIBAWbdQJRFgcNXGaDPZSfHYKTMOV,dAAARAAAFADA....gADAXAFDGCCADAGAZABB.HEFAKBFA.hAEAMAIBLBHB.hAAAEDDAeFDHADGA.WHEAhABAbEFC....QGEB...hAHA......hBHA...,1,-17,-19,2
OgHVQZJcPUCFMIDYRGbXTNEBfWaSLedKA,HAAAZAAAJADAUADA.MAGBDAGAGBGA..bBGD..TCAAhABAECABBAHB.aCCCeCEBhACAACIB.ODDBQEEChAAACFGDFGCHRGEEfFBA.LFDDhACA.dFHA...hBIA...,1,9,-22,31
TdNFPbIMJCHfEKVcSXgLBGWARDQZOYUae,RAAAZAAAOADAaACA..eAEHdAHAFBDD..IAGAMBGB.HCFAhABAEDEF.KCCD..SCCDhAAALEEABBHAhAIAADHAQEGATGGA.bFCA.CGGD....fHBBhABA..hBHA...,2,-27,-15,12
fXNKZLOPMEYRaQWcHbUSCVIJdDBGegFAT,TAAAXAAA.ZACBLACB.MAEARAEAaAHDQBEAhAAAHCECSDHHCAHA.IECAhAAAdCGAGEBAeEEBhABAADEBKEFDEFAB.cEGDUGGA.DGIBBHAD..hAFA......hAHA...,2,-5,-2,3
WbJAGVCcdEYDXgfRPBLSHeTOQFUMaNZKI,GAAACAAAdACA.EADADAEA..XAFARAFALCBAHCDA.eBHHQCFBhAAAMDABZEFAKDHBbFCBhAAAAEBA...VGEA.hAIAgGAABEEATFGA.FGFH.aEBE.hACA......hADA...,1,15,-27,42
WCbVEJQPaOGfKLUBgDXAZIFHRYSdTceNM,ZAAAHAAARAEAdAHAeACE.MAFACCAA...EBFAQCCBaBHD.GCFAhABALCCBBDHBXCEChAAAAACAFEAA.TEFAhCAA.cFECbFAAPEEBKHCADFIB..SFHBhAEA..hAFA...,2,-20,6,26
cNOASBQHdXagLRVbPEZCGMUITFfWDJKYe,QAAAHAAAaACARAEF...VACAEAGEGCCAMAFA.UCGAFBFDDBHBhAAAKEFDeFHBOCHDACCBBGDAhAAAdDDALFFB.hAIAPFHBCGGD.fGEA...hCAA......hDAA...,2,-8,-8,0
UeFONVTGQZRfSEaDYIWdCLcHKPgbABMJX,MAAAXAAAFADD...OADA..TAFAZAGBRBCFEBFFaAHDDBBBhAFA..IEBAhAAAdDDALDGBHEDAKDHBbFCAACCBhAHABFGA..eCFDNIBB......hBAA......hBCA...,2,-24,-11,13
CHQGTOVRUJZgFfYMELWadIBDNAbXeSKcP,eAAAKAAACACB.HADAGADATBGA..RAFAZCFEFCCBMAFALEGBdDEADDGBhAAAAAFA...bEGDSCCDhAAAQFCCOFFBhAIA..........hCAA......hCBA...,1,-3,-31,28
bOTIEaFMYfDLWKHReXANZUSCcPJQBGVgd,ZAAACAAA.JADAGACA.dAEBOAGDEAHBFBFH..MAIBDCABLDHBhAAAHCAARCEB..AECASECAhABAQEDABCBDhACAVEGB.bFFB.aHCAfGAA.eGDEhACA.NIEB....hAIA...,1,-5,-18,13
ePTFYAQISZRCfWLUNBXJEVKMDdGHabcOg,QAAAZAAARAEA.CACALAEABAHBECAAMACAGCDA.HCFAaCDD.hABAbFAA..OCFChCAAeEHBTFFAACHA.SAHHhAAAfEFANIEB.XEGD..hDCA......hDDA...,1,14,-35,49
XWGHPgMOYVLIKZRSDQbBUNCTdJEaAFfec,eAAAXAAAHADA.MAFAOADALBHBZAGBRBCF.QCCChAAABBFACDFD.dCFAEDHFACHBfEEEhABAGEBA.gGFAhCAAIFFADEEB.......hCBA......hDAA...,1,-6,-23,17
QMaWYfSIBACbReEPDUZGdJgTVHFKOcNLX,RAAAEAAADADAGACA.dAEBTAFAHAGBOBEDLAHB..MCBBhAAAaBDD...fDGEhAIABCCCAAAAeCEHZFFA.gDGGhCAA.KFFANEEA.....WHCAhCHA.SGHHhDAACHHD..,2,-19,-9,10
gRPTBFQfZHVWJbCKSceIYMdANaOUDGXLE,aAAADAAAGABBLADARAFFBAHBFAHB..ZBBAHCCC..VCFBbCGD.hAEASDDD.hAFAeDHHMEFBAAEAOFCBhBAAEGGA...gGGA...hBAA......hCAA...,1,-11,-27,16
aEVeBHNPQWKCDYUSZAbXIFMcRfTJLOGdg,XAAAMAAARACA...JADAGAFA.aAHFEAGEBBBDHBCBQCDDhAFACCEBDCGAUDGAADHAFEEHhBAA..TFEAdEHAeHBAhBHANIAB.KGFA..SEEC.IGHAhAAA...hCAA...,2,-17,-13,4
WILANHVOGbUPgQSYdeCERJFDMKcfTZBaX,HAAAGAAAUADAQADAdAGAECAB.RAFADCDBMAIBKCGA...TEDAhAAAaCCC..XDEAhAAALEHBABFAODHBhACAbGAASDADeFDBFFFHfFGABHHA..hACA......hADA...,1,0,-11,11
TfWUBRDQIHKEMSaJcPgOebYCGAVdNFLXZ,dAAALAAAZABB.TAEAUAEARAGB..QAGCHDBCEDGB.aCAA.hAIA.JEFF..gCEGhABAeEHHCFDA.ACIBFDCDhACA.fDHEDIBA.MEAB.SEEDhAEA.OFFDhAIA..,2,-26,-1,25
XNdQHfELKeYWUIAZVMCGTODRBJaPgbScF,ZAAAMAAAGAEADAEABAGAaACA......bAGBFBBA.dBEAHDDBhABAEBHFLDDAeCHHUFGBhBGAADIB.CCCD.REFA..JECFSGDAhBIA..NIABKGHB....hAIA......hBAA...,1,-1,-31,30
XOeFAJEgWUKYIQaVfHZMCNRBbPTDcSLdG,EAAAUAAAKACAQADA..aAEAHAFAZAGBMBFBRCBABCGA.TDEAhADASCCAGEGAhAHAeCHHACIB.JEEF..hAAA.gGCB.IGGACGFDNIAB.hAIADFIB.....hBAA...,2,-17,-11,6
QgdGHJARbMTNDYZeSEXfcVLKFWOaBCUPI,RAAAMAAADADAZAEE..EADA...XAFAVCCBLCFAFBBBaBHDBCDAhAGAUEFA..QGAAhAAAGCEAHEGBAAIB.hABAbGCC.NIEB.eFHHfDCEKGCACHFA...hAGA......hCAA...,2,-16,1,17
gQSZdWYBaILeKEJRTGFACMHPVfNbOUXcD,HAAAVAAA...bADBOADA..XAFADAHBQBDDhAAAdCADBCFAaBGHeBHH.EDCFhAAAREDAGGEBAEEAMEGBfEHAhACANAIA.gFCA.SGABhAGA.WFFDhAIA.IHHA,1,8,-26,34
aXWNRfQJSZebKGACIPUDHEVcFTBLMOYdg,CAAAUAAAHACAEADAFAFALAGB..MAIBdCDA.aCAA..XDAAhADARCEAQEAAZDFAeFBAhAIAGECBABFADBIBTFGAhAAAOFFB..YHCAgGCA.fGHAhBAASHEE.hBCA...,1,-3,-18,15
XMcBZJLEFVPdAabTUDKegCIGOHWfNYRSQ,aAAATAAA..KADAeACECAFB.GAFAHAGB...fAHEhAAARCCAQDACMBDBZDFEECEBhAFAFFCAdDHAAAIBDFGAOEEBhAIA.YFGFXGDABHEA....hCAA......hCCA...,2,-20,-1,19
afEdBZPCIQeHcSGYAMNVbJOLWgRUTFXKD,MAAAVAAA...OACELADBRAFF.TAFAKBBDDAIB..EBHFZCDFhAFACCFD.eCGHHEEASDHHhAHAAAHAJDCF.UGGAhBAAaEGAdFAABFDDQGGA....hAAA......hAFA...,2,-22,-7,15
XOMRSTFBbLNdZaYgeGIDEfCUJPcKHAVQW,QAAAOAAARADA.FACELAGBZAEB.aBBCeAGF.GCGAhAAAECEACDDD.PDCBHEAAAAIBXEEChAIAMCIBBEFAdGGD.hBIAIGGADICA.fFEE..hAEA......hBAA...,1,-2,-23,21
fGSHPaNUFbOcCYJDQEVBZdKXgWLReITAM,GAAAHAAAaACAFADAOAEDCAGA..DAIBEAGAZCDAdCCA..KCHDXBGAhAAALECARDFAeEDFhAGAAAAB.MFFBSEGAhACAUGGA...bGAA.....cGGAhAGA.....hCAA...,2,-27,-3,24
MJPRTeUIdWZYBHVXNSKcfDOFbCEagAQLG,GAAAMAAARACA.eADAdAFAZAGBHAGB...XCDAKBBDDBIBFCDDEDCBAAABhACA.LEEA.hBAATGBAIEFABEADhADASEGHOEHDaGDAQFDC.hAEA......hAIA...,1,2,-32,34
XdUZcMgNJbPSfIBYLAVQeHDCROFTKGWEa,eAAAHAAARADFFADDGAFA.EAHBdAFAZCAAMAHB..JDHBSCCDhAAABEEAAFAADFDBTDFAhABAKGFA.aDDD.UFFBgFAAhAAAbFBC.........hAIA......hBFA...,2,-18,-12,6
TWedEOSJaQZLCAYXBMgIbURDFVGfKPcNH,BAAAMAAA...IACARACAFAFAGCCB.KBBD..PAEAhAAAHCGBeEFBEAHF.SFCAhAIAaBCEZCDEACIBXDFAhCAAbGCADBIB..fHGFTFCAdFFA.OEHDhCBA....hCFA...,2,-25,-4,21
bNcPQYUfgVWOdBXCKMGAEDeTLIRaHFZJS,EAAAeAAALADARADAHAGBZCCA..SAGH..bDFDPBCBhAAAQEAAUDEAfCHAhAEAgFCBOFHDhAAAdFAACECAGGEBAAIBDGABaHEENIAB....hABA......hAEA...,1,0,-2,2
GVeNIaLJPCFbWSdYODKcXZfATUBMEHQRg,TAAAMAAAHACC.RAFFGCCAeACE.aAHDLAFB.CAHAbCCBhAAAdDHADBBB.XEFBhAFAACHAEDBBQDGAhAHANHAB.IEEAFGHBSFFDKFGD...hBDA......hCAA...,2,-15,0,15
VEeMHbQCUATfSPNgWLcXJaFYDdGOIBKRZ,TAAASAAA....PACANADALAEAJAFB.FBHDdAHAGCEAhAAABCCARDEAEECBHECBhAAAQEGAACEB.fFAAhABAgFGAXGCAaGFHOHBCKGGD.hAFA......hAGA...,1,-6,-11,5
CGYEPRVSBfeaNODgdbUQIFZWcLHMJTAXK,CAAAEAAARACA.BACA..eAFEaADD.DBGB..dAFAQCAAZAGBLDDBhAAAHCDBMBIBAACAGCGAhAAAVFFA.SFCBhAIA.OFFBbFBBFHEC......hBFA......hCAA...,1,-12,-15,3
FLaTgZBVHRSGCAfKDMbcENQdeYPIJUWXO,DAAAMAAAEACAdAEA..eAEA..IAGAUCCAOAHDaAHDZBBBHCFBhAFARCFBGDCAABBB.KEHBhBAAbFCAQFEDhBBA..PEHD.WHBAFHGE....hBAA......hBHA...,2,-22,-4,18
DOcKfELeWMaIJRZCUQPGFVXTSbYgNdHAB,OAAAKAAAEACE.LAEA.eAHHaAEARAGFZBBAQCCAGCEAXDBAhAFASBEHbEGD.hAGA..gDGAhAAAHGCAACGBDEIBfFEA.MFIB.CGGA.hAIA......hCAA...,1,7,-23,30
BQEUbTAJLYWOGKCPZMIgVNRXdSaFDeHfc,LAAAOAAAGADACAEAZAFB.MAFA..IBHAVBGB.RCAA.dDBAhBAAFDEHHDEB.BBBDhBDAEDGAUEABADDBJEHBKGBA.hABA.gEGASGEAeFCH.fGHAhACA...hBFA...,2,-12,-10,2
AIdRVDEZCFTOegcUGXJHfQBSYbLaWNKPM,RAAAEAAAZADBFACD..eAFAUAEAGCEAHAGDQDDABBHA.SCHHhAAAbDABLDGBhAAAaDGHKEBAACCAdGAD.CGHA.TGGAhAIA..gGCH...hBEA......hCAA...,1,-8,-15,7
MFVIZSXHRDWBdQGNgCAcOfLKUPbETaJYe,OAAALAAAKADAUAEA.EAGAaAFA..eBHFMAIBFCAAZBBAHDCAhABARBFBBDDDGEFA.CEBDADIBhACA..fEFEhBAA.bEGDTGDAVFDB.IHHADIFA.hCAA......hCHA...,2,-19,-2,17
SLRDIWgUcNTMQaeCfBPbVGOJKZdAXYFHE,FAAAHAAAEADARADFDAFA....IAGAUBGATDAAMAIBeBEFhADABCCD....bDEDGCFAhBAA.KCCBAACASEHBhAAALFDBgFGHQFCACHCC.fGHEhAIA..hCAA...,1,-12,-26,14
bFMAZOKLfSgXYIVUTGDECPRJcNWHeQadB,ZAAALAAASACEXADD..IAFATAFA.GAGAhABAEBHFRCAA.JCCF..cDEAhABAHEDBeCFB.dFHAhAIAbEGDADIB.KEED.fFAA.gGDAhACA...hBIA...,2,-16,-2,14
agcOPZdNFQfLXARUYMGKSBICeJWbHTEDV,RAAAMAAAGADABADAeAFA..JAFAHCFADBBB.aCCH..OBEChAIAdDAAQEFBLCCBACIBhBAAKFHB.CBHATGAAhAAAEDGBVEEB...........hABA......hADA...,1,-2,-36,34
VBFcGdbfUYKDACXaHgTQJWLMNIeOERZSP,aAAAHAAA.TAEAQADALAGBMAGBeCAARCCBZBGBSCEDhAAABBBDGDAAbDAAfDHAhACAKEFDAAHACEHA.XEFDhADAgGGANIABEFDAFFDD......hADA......hBAA...,2,-9,22,31
OdYBFbWfTEeXZHGLSPAQMCcagJRVUIDNK,MAAAaAAA.RACA.UADADAFA.KAFA..dBGAFBBH....bCCATCFAhAHAEDHF.ZDBEHECAGEGAhAIALGCAABIB.QGGAhAIACEFDJHCA.NBBA.......hBAA......hBIA...,1,-11,-25,14
FRfVOaGMTHgCEeKUcLWZSbNBPAXDYQJdI,DAAAQAAAdADARAFA.OACCGBBAHAFB.EAHBeCGFKCDALDHBhAAAZDEFSCHHBDCDAAEAhAIAJFABfEEAhCAA.aFGBMEEBCGEAWHEAbFCD....PFHBhAFA.....hCDA...,2,-10,-10,0
ePbBcfQDdRaVKZAFEMgUTWNOGJIXHYCSL,EAAAMAAAUADA..TADAOAFCGAFA.JBBBHCBA.SCFAhAAAeAHBBDCAQEEAhAHARDGFaEDDZFABADFBFDHDhAIA.gGCAIHHACFFDbGFADFAB...hBCA......hBDA...,2,-11,-5,6
XLDTHFUcfBMaIANebOPdgWCZEVRSGKJYQ,eAAAOAAAdAEA.CAGA.EADA.RAFA.GBCA.KBHBQCCAhAGALDGBHEBBFCFHUFFABEEAhAAAaCHBAEBB...NBBA.bGEChABA....WDHHSGAD..hAGA......hAIA...,1,-15,-22,7
LZSbEVTNDQXKGeACJfIMBUWHRdYOaFPgc,CAAAJAAA..MACABADBHAECRAEF.dAHA.OBCBaAGA..FBGD..hBAAPCFBLCCBZDDFEDHBhAAA..TEEAhCAAQGFAGEGAADBBfECA..hBDA......hCAA...,1,-17,-32,15
JYbXUANfRcODISBgaMCQPKLZEVFHGWeTd,RAAADAAABADBMADA..QAFALAHBEBBAHCCAGBDAeBHHdECDhAAAJDCF...XEGAhABAABFA.fFAAhAFAOCGHSEHHaFEDKGGAFHBATFEA.YHBAhBAA...hAIA...,1,-4,-18,14
QbSMKdWPLfYcTgDRHaeGBEIJNAUFCXZOV,CAAAZAAA.QAEAMACAdAGALBCA..fAGFhABA.TCAARDBAHDFAeBHFhACAEFDAIFHAhAAAACEBXDDAbGBCKEAD.PEGBgGGGaFHDBGDAhADANICB......hAEA...,1,-7,-12,5
LUgAWKZRPTMHbDOdEVFcSCQNaJXfeBGIY,ZAAARAAAMADAHAEA.OAHDEAGA.FCAA..CBDAQCEAaCEC.hABAJBHBeDAB.GDGAhACALFBAAAGAKDDDbFFAdEFChADASCCDfGCABHFA....hAAA......hABA...,1,-1,-24,23
gCJVKAMHPfIFDabEBNcZdOGTYRLQWXUSe,HAAA..fAAADACAEAEABAGAZADAGBGARCCALCFBQCAAhAAAUGGA.eCDBCBHAKDHBhAAAAAEAMCFBFFEH.bECD.hAIAdFGD.OHAC.......hCAA......hCCA...,2,-24,6,30
QKIRDFTfMPSHbZceEaUGCdNXWOLJBVgYA,QAAARAAAFADA.MADAHAFBZAEEEAHBGCBBdCCA..XDFAhAAALCFBBEDAVFGBADIBDFFBhABAfBHA.hAIASEEDcGFD.aHEC.CDHA....hCAA......hCEA...,1,1,-25,26
DPAQHBUYWEJROFSCNGVMIKbadTfegZcXL,HAAABAAAUACAEADERAFFFBHD..CAEAGAFA..MCABKAHBdDDAhAAAeCCBZDGBLEEAhAAA.AAHAQFAAhACAJCBFSFDAIGEA.aGGAfGHAhAHAcCECDIEA....hAFA...,1,-4,-34,30
NHCYVKdEebRcLZMSAIJPgXWFQGaBUOfDT,JAAAXAAA.FADAaADA.BAGAUAGA.DBDBHBCC.CBHAKCFAECEBRDFFhAAA..ZDDAADHA...hABA.IFCAPDHDQGAAhAGAOEEHfFHATGGA.YHFAhBGA....hBIA...,1,-24,-34,10
PbJaIEXcCAOKUDGHQTLZdVBeYRfgSNWFM,KAAAGAAAHACBLADAdAEBeAGHRAGF..SCDAFCABMAIB.JDCFECEFhAAA..CDHA.ADHBDEFBZEEABEADhAAA..fEGEhACAgGDAPFBAaGGC...XGGAhBFA....hDCA...,2,-21,-14,7
TdHNJEfXIBURZWQMgKbFaCVDYSLeGPcOA,HAAAEAAA.XADBBACARADFZAFBMAGB.KAHBaAHDDBFB..LDHBhAAAeCAAGCGAOCCBADDAdEEAhAAAJEEA.IHAAhACA.QGFDbFAACGGDSHBG..hAFA......hBHA...,1,4,-21,25
XDNaMECdLYJcgTFfZeWIGUHQROAVSBPKb,BAAAKAAADACAaACA..EAEAdAFA.LAHB..JAGBTBCAhAAAZCCAeBHHGDEAHECAREGFABHBhBCASBDG.hBFAXEGAMEDB.CGEA....gGGBhAAA....hAIA...,1,-18,-28,10
eNSRgIJYBaZWGUHMODVXLdCbcKEAfTPQF,TAAAQAAA.eACARACF..JAEAaAFDGCDAHBGBMCDBDAIBLCFBhAAAdDAACAHBKCEDACABFCHHhACASEFB.gFGHhAAABFGAWFDDOFBC....hADA......hBFA...,2,-22,-6,16
WRgdDIPZeNMJEBfCYbQHUaTGSLKcXFOAV,RAAAdAAADADAZABB.eADAMAGBBAGA..CAHA.QCEAHBDBUEFAGDCAhAEALCCDKBHBFEGDhAIAAAAA....gFBGhAHAIHHAPHDCEGHF..fHDFhBFA....hCAA...,2,-28,-14,14
QfTcGZPLKSeJOVNCHWXdRFDEYABMUIgba,MAAAUAAA....IADAaACEQAFA..TAFAhAFAZBBALBHBeAHHOCBEhAHACCFDHEEAdCEARFAAEFHFADGBbEFAhBAAfGEE..PHEASGGDhAFA.NIAB....hBCA...,1,6,-25,31
NRECfBLPDHaWgUVFAGIYQcSTKOMJdXZbe,GAAAQAAASADAOACC.dAGAZAFBeBHHEAHFBCDALCDBhAAAHDFCaCFHUEAAAADAIFFAhACATFFAKEED.MFIBhAAAbGBACFHADICA..WHFA.....hAEA......hAFA...,1,-2,-7,5
ZNLQJKdgMDPEUAaBObVWCHTGfeFYcSXRI,aAAAOAAA..VADAHADA.GAGAFAGA.SBBDRCCBZCFBLDABhADAQCCCdDHAMFEBhBAAECFBAAFABBBDbEECTGGAhAIA..fGGA...hBAA......hBIA...,2,-17,-7,10
HFCMIWJdXaAYSVEeGbNcKQPfOBgLDTRUZ,SAAAEAAAGACA.....bACDKAEAQAEAOAGDLDFAhAAARAGBHDEAMDIBIEAAhAEAdEAAAAAAeCBBPECBhAEABEDATGDAZFCECFHAXGADaFGB.YHFAhAGA....hAIA...,1,15,-12,27
NBPOJUbVMYRDeIfHWESgZQXCFKcaAdLTG,dAAAGAAABADAOADAUAFA.MAHBRCAA.eBFFHDCC..ECDBZDFBQDGBhAAAFDHDKAHB.AAIBTEBAhACA.PFFBhBAAbFBBDGHB..fHGF...hACA......hADA...,2,-29,4,33
BIGWHfNdLPCMKDZgUFYEcSRaQAObJTXeV,OAAATAAA..eACEBADAGAFAHAEBdAGBLAHBMBBBZCCFFBDHEDEFhAAARBGFADIB...bEGDXEEBhBAA.IFHAhCAAfFAA.CFFADCCBgGGGYHBAhAFA......hBHA...,2,-12,-6,6
CeIQfPEGUKcXBAdJSVHZaLWYNgbRTDFOM,dAAASAAAHADAaAFALADA..NAIA.RAGFTCCAFCBD.MCFBhAAAeCFB.QDDChACAEDGBGEAAKEHDBECDhABAACGAJFFFZGFA.WDHHYDAFDEEB.CHDAIHHAhADA....hBAA...,2,-14,2,16
gWaRVbJGXBCULFTQfYHZMcAKOSDPENIed,SAAAEAAA.eACHdADAaAFA.RBEF.bADDGCBA.CBHALDGBhAAATAFAQCGAhAAAHGBCZGFAABCADEEA.IFAAhABA.gFCA.VFFAhAFABEEDfHABhAHAMIEA...,2,-16,-4,12
NQVUdZJPgKOLeHWEBDIcSMXFTGaCARfYb,RAAA..bAAAQADC.dAFAZADBJAHBKAFALDDAHCABEBHFDCCBhAAASCFB.hABAMDFBTEGAaDHDAAAAfFDAhAHAVGFA.gGGAeHAABHED.hCAA......hDAA...,2,-23,2,25
KMCOQGDYbVgeUZSfRNBLHaEAPXITFJcWd,XAAATAAA.FADAJACA..dAGAKAFCMAIB..QBGAhAAAGBCADCFBVCCAeDGBZEFAhAIARFFBLGBAHFCAAEHAIGGAhCAACEED.........hAAA......hABA...,2,-16,-9,7
ITWgVARODCdUeHYNcKQLSEfbMGBPXZJaF,RAAACAAAdACAHADB.....NAGA.QAEALAHBECCBMAHBGDAAhAAAXCBCaDFHTFGAhABAVDEA..AAIBDCIBeEEDhADAKEADfHBFBECAZFGBFGBAWHEG...hAAA......hAEA...,1,16,-21,37
RYSJAdCUTLGEMfbBQFZWcPeOVHgNDKXaI,dAAATAAAEADA..MAGBBACB.ZADB....PAHBeAFAHCEBhAAADBFBKCBAaBGE.RDGFSCCDhAGAACEBLEEAbDAChACAQGDAFFHD.OFHDgGEA.hCAA......hCDA...,2,-16,-8,8
YgSTBDHceZIQXGMCANfJUWPbEOKFdVaLR,JAAAUAAA.....bADAEADE.FAFAaAHBRCCA....SAHHhBAATCDAHDAAeCFGZDFBhADAQEEAGFABABIBfDHAhAEAOEGF.dGHA.....hCAA......hCBA...,2,-31,3,34
dZPEGUJNRVeMFIaHXYWcAKLDbTBgOSQfC,LAAATAAA.OADDQACCdAFAEAHBGAEA.UBGARCAAeCGFhABAMDDBFDEDHEABXEGDhACAcEEC.AAHAbEGBhAAASFBA.CHHA.......hAIA......hBFA...,2,-18,7,25
RXZJgESeUGLWDYVbMKONAHFfIcdCQaBTP,HAAAFAAA...fADBdADAaAFABBFARAFFZCAA..EBHFeAHHGDBAhAIALDFADDDA.bECChAAAMDGBOFABADBBCDHA.TFGAhACA..XFEDSCCE..hAFAYHFGKGFD..hBAA...,1,19,-39,58
PdeOWJgcVUaIYMTDEQRBCLbfGNZSKXHFA,eAAAOAAA..JADBVADAUAFA..aAGAMAIB..EBBBRDEALFBAhAAAGBGAZDCBKEHBHEEBhBAAACCB.dGHA...hABA.gGFA.IHBADICA.hCAACHDA......hCDA...,2,-21,-11,10
BRWDOCaVSgcbJdZGKLQFfIPXEUeYNTHMA,RAAAOAAACADB...aADDSAEH..bAEDZAFBGAGAhAGALBHBQDBAhAIAFCCBIEDAEEEAeDHHTFEAhAAAHGBA.ABBBDFGB..cGFD.dHCBhABA......hAIA...,2,-29,4,33
NZVCOcPYfHXBFSdGMUJWEALbKeDgRaQTI,LAAAeAAARADA.aADDQAGC..TAFAZCCAOCHDhAAAPBHDHDFBBCAAdEAAGCEAhABAMEEBJFCBAAHAbEGDDGHBhABA....gFAA.IGDAhACA.CCCD.YHDGhAEA.,1,-9,-10,1
YGDPfObBgJAeQaUZHWKEcdNXIRMVSTFLC,eAAAaAAAHACBEADAdAGA..XAEARBEB.MAHBTCCALDEBhAEAGDGAfDGEhAFABEEDAAAAZGBAKFCB.IGGAhAIAFGEADAIB.OBBH......hBAA......hBIA...,2,-12,-11,1
GLOQKSWgDIPeAfYHXZJcTEMNCFUVaRBbd,HAAAZAAAJADAEADE.MAFAFAGA...UBGARCAABCEAGCAB.LCFDhAAAQCGASECAhACADECA.eEGHACAA.hABAXGEDTEFACFED.....bGCC.hCAAdGHAWEHH...hACA...,1,8,-32,40
gdSIeQWRZJcbLNCEUYDaOGPVHXMBTfFAK,dAAAeAAARADAZABB..bADALAGB.ECEADAHB.GCCAHDCAMAIBhAEATEAAAEGASEGAhBAAQEFAcFEChAAACFFD.aBHD.OEHF.....hCDA......hDAA...,2,-19,-5,14
gHZEXFBbTfWVLKGaMCUOJNPQcdARSDeYI,RAAAeAAA..IAEAHADAEAGEBAGA..bCCATCCA..hAAAfCGALCEBaAHDhABAMCIBOCGBPEEBhAAAdDAAACCADFAAZEGBFGAAKFHDCGCANIDB.SGFHhABA......hAFA...,1,-5,-9,4
JIEYCTRebQOPZNVgfaWUDKXdSBHMGcLAF,FAAAEAAA.CADA.RACA..eAFEQAFAZCCA..VCGBaBHD..DCCAdDAAhAAAHCDCGECAADAAJEEFTFFAhADA..bFAAOFHDhAIA..gDAAfGBEKEHBBEEDhBGAMIAA.LHEAhADA..,2,-8,-3,5
abGgTVAOWcIDKQSeXRHFZULMEBPdfNYJC,OAAA..IAAAQADAeACAHAFAZAFBMAIBEBBBdCHA.hACA.fBEAhADAJDCBbEDD.GCCA.TEFAhBHAAAHADDGBXFFAFFEHLHDA.BHHAhCAA......hCBA...,2,-10,-9,1
fOaZdIXKWcMSFJNTPDgUGbLHCVeQBEARY,RAAAOAAAdADAKAFA..MAEAFBHD...TBCADCCBGCFAHBEBeAHFhBAABDDA.ABBB..aCHDZFAAhAAAXEBA.SEEAhBEAPEHD.bFGDLFDBQGBChBGAEHAA....YFFFhABA.,2,-31,8,39
CGLWNIMRecbdOSKBQUXYPEZAgDTaVfJHF,TAAAaAAA..VADAHACB.GAEBLAGBICHARCCB.eCABhAAAdDAAKDHBQCEDhACAXEFCEEFBAAIBDGCAFEHBCFADhAEAMICAOHAABBBD.UGGA....hADA......hBAA...,1,15,-16,31
IZEVUdafFCWJHGYMOSTDLbRgQeNKPXABc,BAAAZAAAEADEdACA.FAEACAFBHAGBGAGA..MCABOBDDDCCBRDDA..hABAeCBBKDHB.AAIB.VFCBhACAaDED....fEGEhAAAJFFA.TFCA...gGGAhBCA...hAIA...,2,-21,-20,1
LdAcDQbJZCXVIGUFMKOSTPRNEaHeWgfYB,QAAAZAAACADB..XAEDGACBMAFAKAGA.TBGARCAA.hABAECDBHCFCeCFBfDEEhACALDABADIBbEFDIFEAhAAA.OEHBSEHHaGGH.gGAAhAGA..hAIA...,1,8,-26,34
JIdMWZTDSHEegYGCAcKBXPRVQbNOLUFaf,BAAARAAAQADCOACALAGBFAFA..aAHDJBCBdCFAZBEBSCCDhAAAHECA.EDHBeCHHhAAAGDDAAAIBKFGDXFGChABA..bGCANIDB.IHHA.MCBBhBCA.....hCAA...,1,-11,-12,1
FRdCUbTYJKOBIDgeMQXAcaHGLSZVWENfP,HAAAGAAAZADBEADA..fAFARAFAdCDACCFD.UCAB..bCGDTBGAhAAA.KDEABEFChAAADDIBeEGFMDABACIBaGDASGAAhACA.NIABFGGAOHAA.IHHAhACA....hADA...,2,-13,-10,3
JfPQCIaLWgAXdUBHFZbeMcNYRGDKSTVOE,dAAAHAAAZABBeACEMAEA..NAGA.RBEAGDBB.KAHBTCCA.hBAAEAHBJDGBQECBhAAA.aCHHLFBAhBDAAFAABFEAbGFADDIBOFFH.CHGA....hAFA......hAIA...,2,-16,-8,8
gBbdWCeHUJRFEafYPZLDKNVIQTXOAcGMS,GAAAMAAABADAdADAeAFAHAEBRAGBFBHD..EBBBaCDE....fDCAhAGAZEEALEHBhAAAKDFAVEDBTFAAAAIBSDHHhBAAbGCACDFA.UGGA.....hACA......hAFA...,2,-9,-5,4
GBJKEMDPFLbZYSfXTgHRACWOQUdaNVceI,OAAAdAAAaADA...VADAeAFH.GBGAKAGCDBBBLBDB.hBAAZCAEfBHAhCAATFEA.HCCAAAHACEFBWEHHhACAQDFD.cFGCBHGDMIBAFGCA..hBAA......hBCA...,2,-17,-10,7
EOKNWLHUaCGBFgPIfDMQbdeVXcAJTYRSZ,TAAARAAAEADE..KAFCLACBHBFC.aAEAGCCAFAHB..IBEAhAAAMDIBdEFA.eFDHhAAAXCEAAAIBSFHDhABAZDGBOEEB.WFHHBHEA..fGFEhCAA.DICA..hCCA...,2,-21,-6,15
SVHAEcMeITOFaGJQgBbdLCfUDNYWKZRPX,EAAAeAAA.OADCGACA.QAEABAGBdCCALCFACAGADAIB.hAAA.NCBA.KEDARCFASEDAhAEAHEGBAAAAMFABTEGAhBCAaGCA...gGGAfGFE.YHCAhAFA...hCAA...,2,-15,-15,0
TAZRUcfDNWeVOQgJXGFSdIHKLYBEbaCPM,RAAAUAAADADA.eADA..QAFAJAGB.GBDAdCDAHDABLBHBhAAAECHFCDFD.MCCBAADAZEFEhAIAfDFA.hBAAVFCBXFCAFFGAKGGDBGGA....hBCA......hBIA...,1,-4,-19,15
VaQPOJKLdYFBXIEAbceCgZHSRWMfUDGTN,eAAAZAAAHAEARADA.MAIBDAGAGBGA..TCAAaCCB.QCEBhABAOCFHLDDBhAAAdEADBDDDEEABAACAbCGDCFGDSFHHhABAUGAA.NIBB.PFFB.KHGA.hAEA......hBIA...,2,-13,6,19
bBeNLcWTXMSYJCFHVKRAgQfIEdGDUPaZO,QAAAEAAAGACADAEAaACE.ZAFEBAFA.eAGHLCGB.TEBAhAAAMAIBSCDAhAAA.CDAAHDFChADAREDFACBBfFHAdECAOEEBcGEDXFABFHAA.hAHAKFGD.IHHAhAFA...,2,-9,-5,4
OSBTaLHVePGUbZCYEKQcMDFJXfAIRWgdN,RAAAdAAAOADABADALAFAHAGB..eBDFGCABZDFAEEDFQCFAhACAMCCB.FECDfFFAhAAAAAGA.gGBBhABATEEAaDHDPHFCCGGAKHDADGIB...hAIA......hBGA...,1,-6,-16,10
gbWBAGcVZDNETQIeKRdOYfXFJCSUMaHPL,GAAAZAAAEADE.QADAeAFE.RAFAdCHAOBEE..XCDChAAACCAAMCCBHDDALDGDhACAbDGB.ADABDEEB.TGAAhADAKFDDFFFBSFEHaGHD.PHFC.hABA......hACA...,1,8,-11,19
cTfKRdaCZPLAFHMgUDJYOGebWNBXSEIQV,HAAAMAAADAEAOACAGAGAeAFA...bBFABBBA.EBDAQCCAhAAATCEA.RDFAaFDAhAGAZDBAAAIBFFHBUEGB.JGBAhBAAYGDA..NIDBSFFDhBBA......hBDA...,1,6,-18,24
YVbDPaNEWGRcUBTZXFdeSOKCJMIQALHgf,HAAA..fAAAbADB.aADAEAFARAFFBAHBZBFEdCAD.eDCFhAAAKBCAMCBBADGALEEAhACAgCGHDDIB.PDDBhAAAGGEB..TFEASHBACEHA..hAIAIGHA.YEBBhACA,1,-5,-13,8
JGQLaHNeSKVWOUbYgfXCDARcPFdTMIEBZ,RAAAFAAAdADAMADABAFAGAGALAHB.HCDCeBCA.KCEAOCCHhAAAUDBA....bEEBfEEEhABA.DEGAhAFAAAIBTGBAEFHBZGCAaGGHSEGA..hBAAWHBGXGGACBGA.hCAA...,2,-13,-12,1
LDFOSbIVZgaJGdARCPKEHQfUBXceTNYWM,RAAAKAAAHADBQACCBAFAeAGH..TAFA..NAIAMCCBhAAALAHBFDAB.bCDDZDDAaCFHhAAAdFDAAAEA.EFAFUFGAXFFAhABA..cGDADFIBSHDAhADAIHCA......hAFA...,1,-3,-10,7
QfGKageECcObZXSPWNHRMJIUdALYVDTBF,LAAADAAAFACDGAEAaADD..EAFAOAGFZBFE..SCAAhABA..PDDBhAEAHDDARDGFMAIBIFAAhACAABBBTEGAQGDAKEBBeFFBCGGD.bGACWFHH.hAGA......hBAA...,1,3,-21,24
EGXJYWOfAQBDCUgIVeaLNdZMRbPcSTHFK,QAAACAAAUACA...IADAeAEAaAHDdAFA.RBGF....hAAAbCBASCBDhAFAHDEBEEHFGGEBXCDAYFBAhAAAfCGEAAHADIBALFFA.ZGEAhBCA.MIDA...hBCA...,1,1,-16,17
dTXIDeSgHEWfYPQZGcUbMACRLBFVONaKJ,RAAALAAAFADA.OADDaAFD.dAFA..TCCADAHBeBHH.HCAAhABAEAHB...fDEAhACAQCGDGDFAhAIAbECAAAAABEGAKFBAIHHASFHH..hAIA......hCAA...,2,-31,-6,25
MXOTUPaNQWJVdYEBcCKfZIDFLbGgAReSH,RAAAHAAAMADATAEA.UAGAaAFE..QBDDVCCA.EBHFCCADZDFBhAAAFDEH.GEAA.hAAAADIBeEHBOCCHWFEDhACAdDGDBFGA.fGCADGHB.bGFA.hADA......hAEA...,2,-12,0,12
QKJGScfTMRWbNLeCZXEYFgUDABOVHPaId,OAAAHAAAaACAdAEAQAFAGAGA.SBHBTCCA.RCCA..hAGA.bDFDeDFFZEBAEGBAhAIAFDHHDEEBABBBBEEBIFAAhAAAKEHB.fFCAMIBA.NIABXGFAhAFA.....hBAA...,2,-11,13,24
IEOQUdYPcCDGTFbARHLfgaeSMXBKZVJNW,HAAALAAAaACAeAEHMAEAKAHBZAFB..JAHB..IBEA.hAAAEBGBQDCChCAA.dEFAcCAADDIBFFHHhCCARDCFSDHHBHEA.VFEA.WHEAhABA......hACA...,1,-9,-27,18
VXKONCcHeFGAYDBQPZMEdRfSIgJWUaLbT,BAAAZAAAEADERACA...SAFBJAFA.UCAAaCAALCEAhAAA..bAGD.TCDAhABAKDAACDDDHEFAeEFAAAIBQFCAhACAdFCAIGEA.gGGAhACAWHEA......hCFA...,2,-27,-12,15
ZIYfXMcdWbGTRHSECUNOQDLKgVaJPBAeF,eAAAZAAA..IAEAXADAdAGAGAGAHCAAECEBCCCA..OCEBhAAALDGBKDFBaDHDBEEDhABAAAGB.fFCAhACA.MAIBbEAATGGARGEESGBDNIABDEAA..hADA......hBGA...,1,-7,-8,1
gXYSEBaOcfDNZGRTMeQPdLCVJbFUAHKIW,HAAAKAAA...gADBSACBEAFEaAEA..OAHDDAHBGBDAhAAARCAAeCFFdCFALEDBhAAACCHA.bDGDAAIBXEGAhBFABGFDfHABTGGAMCCB..hCAA......hCBA...,1,11,-32,43
MHbRgNXPUSQJBCVfAdLGcWOKEYDFeaTIZ,GAAAOAAAKADAEADAFAFD..eAFE.aBBCZAGB.HCDBRBEA.XDGAhAAASCGAQFDBhACACDDAAEFALEHBhAIAcGFBDFFAMDAB.NDCA.......hADA......hBAA...,1,-4,-29,25
LacWCZRfVBNGPYeSUgHdDFMOATJIXbQEK,TAAAXAAA..EACEaADA..CAEBRAFFBAGAGCCAeAHH.SBCHhAAAHCGBdFEAMAIBhAAAABEBICFAQGGAhAHALEDA.ZEGB.fGAA.NIDB.hABA......hAGA...,1,-1,-25,24
HUZJMfFLPYXaDIGgWRcKdQVOSBNCETebA,HAAAZAAAMACALADB.XAFAaAEEGAGARCEFdCADQCCBhABA.SCEHhAIACCHAEEGAeFAAADGBUFFAFFHDDGEAhAAAWDHHKGCA..........hBIA......hCAA...,1,-5,-18,13
WLQCbPcJZBKVSgTXFaMRAINDEGUYOHdef,DAAAEAAAGACAOABEHAEBeAEALBHB.QCEAhAAAbAGBJCCBZDFEKCBD.SEAAhAEATFGAFEABRFFAACHBIGBAhAEANEEA...dGDACHHA.BEDA...hAFA......hAIA...,2,-8,0,8
eQZfgEWCRTULBDFOJVPKbcNGaMYHAdSXI,dAAAXAAAeADAZABB..EADARAGBLCEBFAFDOAHB..PDCDhAEAKCDA....bDABhAAAGEGAaCHDHDFBAAIBQGCBhBAAfFEECGFD.BGHADIEA....hABA......hADA...,1,-4,-18,14
bCWDRKPYgXSTefGQJOZIcMLFaEAdHBVNU,HAAABAAAUACACADBRAEF.KAEA....gAGBSAGBeCAAhAAAGCDB..QDDChACAZEEAMAIBaCBHACGBdDHAhAIA.bFFCDEGA.XGCA...fGGEhAAAOHEE..hBCA...,1,-2,-38,36
GUbeNOQSRWYHcPfLMdXTVFCIEaKJZABDg,DAAAGAAAeABAQADARAEA.HAFA.fCDEdAHATCCAhAFACCGAEDFBaCFDZDGBAAABBDHAhACAUECBbFFAOFFH.hADA.SHAA.YHFA.hBAA......hCAA...,2,-23,11,34
GZfFRcaLJWIBCMSPHYdATNEKXObgUDVQe,EAAAOAAAUADADAEA..eAFAZAEERBCBLBCD..ICFAhAIAMBIBHCFBABBB.TEDAhAAAXCGDVFGBGEEAhBAAFGAAaHCEBGHA.SHGG..hBIA......hCAA...,1,5,-32,37
QMgHcdEJVKDaSTCeZFBWXbIGfOPUALRNY,RAAAQAAAHADBEAFAKAHBaACE....TAFAeCCBZCFBBAHBXDAChAAAGCDAOCFEhAAA.ACDBLDABhADAMDHBdEECDDIBFEHBbFCDfFAAPFFB.UGGB.hAFA......hCAA...,1,6,-1,7
FPbZTRfHDMOKCXULVWJEgQcSYBNAedaGI,eAAAGAAAFADDZADARAFA.HBGB.MAEACCCDLCFAJCDB..EEFBQEDAhAAA.SEHBhABABEHAAAABaFCCbFABhAFATGEA.DAIBXFFB.WHCAhAGA......hAIA...,2,-22,-15,7
HOWRLJcZNYEAdbGBUXTaMeCfVDISQgFPK,GAAAXAAAaADA..eADACAGA.DAHBQCDAFBFDHCDBRDABLCGBhAAAZDGB.EDCBAAAAbGEChADATFDA.MAIB.hAEAfFHA.SGAA.hAIA......hBIA...,1,-4,-16,12
TXgeQYWdCVacGUZMONKfBLJPIAbERDFSH,RAAASAAAHADB..TAFAeACHQAEAdAHAaCCH.GBGAhAAAZDAFMDFAKCEDLEAAhABAIEEAAAAAEEFBXEGAhADAgGBA.CAHBcFGDOFAHBGEAhAFA......hCAA...,2,-8,1,9
PDGbHTdMCIRWgFONAQBSfaXcLYJKeEZVU,QAAASAAA.aACELADA.KAHBEAFAZCCAUCDAGCGAhAAAHBGBdEAAMDAARECAFGCHAAIBXEFDhAAA.cFAAhADAeFGDDCEA.CHAA.gFDD.hABABGHA....hAFA...,2,-12,-6,6
TPdVYfgQFbEZBOXNHSaUAGDCcMeLRKWJI,GAAACAAA.eADARACAKAFCJAGB....TBGAdCDAVDGB..hAAA..fCAAhAAAQEABECCBZFCBXCEChACAHFEB.aDGEAADAMAIBLFCAIHHAhACAgGFA...hBAA...,1,-2,-22,20
fgVGQcLHSTedMBUAJCDPNIKbEFROWYXaZ,DAAA..IAAAEACARAEA.OACA..XBBCZAFBVBCBGCDAhAFALBHBHCFAeCBDhAIAdAHAMEHBABFBCEEAKEGDbFFDhBAAFFHD...aHCA.......hCAA......hDAA...,2,-13,-12,1
VFbEAISHdPcLJBgDYUeTQNRGXMKaWOZfC,HAAAdAAALADABADBDAFAeAGHQBEARCAAGCEAMAIB.aCACZDGBhACA.CEADFECBABHB.SFHHhAEAPDCC..gEFAhAAA.TGCANIAB.KFHB..hACA......hCCA...,2,-20,-10,10
cIgeXSHdRZQJLAPYBGKbWaNETUFVCfDMO,BAAAGAAAKACAaADA..EAEEFAGA..CAGB.MBGB.OCDB.hAAA.gBGAhACAeCEHHDGBRCCAZDFELHCAhAAAACCA.bDBDTFCAfFFEDFGAXGGAhAIA......hCAA...,2,-34,6,40
cdMBTAWbaYVFOESePRHfKDJQNUgCZILXG,aAAAFAAAEADA..eACHHAFADAEAQCCA.UCFBZAEELCFAhAIAGDAAdEGDMBBBhBAAAAHAbFFCODDB.REFAKFEDhBIANICBCHHA.IGHA.BGCD.WHCAhCAA......hCGA...,2,-21,3,24
KBXRIMEVJUGWZTODafQegNSYHFbCALdPc,dAAAKAAARACFEADA..UAEAZABBDAGA..aAGEeBEA...SBHHhBAAHCABCCGAACABLDEBhAAABDCAMDFBGGEBhACATEGAOCHD.fHABQFBA.hAHAgGDB.hDCAFGGH..,1,-13,-20,7
GQIfgbXBaEDOLZSJYMRcCTUNKdFWAPVHe,HAAAeAAAGADAQADC..fAFBbAFBBAHADCABZCFBSAHBhAAAMCCBRCGF.TDBAhABAKDDAdFDAADFBIDHAhBDAaFFBEGGA.LFBA.cFGBNICB.hAAA......hACA...,2,-4,4,8
dLEceDHQbUPFaGBJCRMOZAWSTVgNYXKfI,TAAAVAAA......NADB.KACCdBEAEAEADAIBHAGB.bCCAFBGBhAAAGDFACCDC.RECBMDIBhAAAADHA..SEEAhCAAXGBDLHEAeEGH.....hDAA......hDBA...,1,11,-40,51
TEMeRVZSdOUWDYJIAagQBNPKcfbLXFHCG,aAAAQAAABADA.KACA....bAEDLAEBHAGBGCCAhADAEAGARCFFZDCFdEFAOBBBhAGADBIBIEHAAAIB..gGBBhBAAPFFBXGAACEHAeHEA.SHGAhAAA....hAGA...,1,1,-20,21
KFQcOVEdNXbSGfCRegHDYTMIPLWAUaZBJ,ZAAAKAAAQACCOACAdAGA....XBEDGAEARAGB.HDDBhAAATDGAMDGB.LEABhAEAAAIBaCCHBEEAFDHDEGHBhAGASFGA.eGBADIAA.IHHAhABA......hBGA...,2,-30,1,31
LYbGNECDHdfTOFBPWKcZaRSAVMQgXeJIU,MAAAQAAA.eACAIAEALAGBGAFAEBEAHDAAdBBATDCAhAHABCDDKDFDZDGBRFDBAAIBXEGAhAAA.UGCAhADA.YHECCAHAfGHA...hCAA......hCGA...,2,-18,1,19
ASCfXQLRMWFIJdKYTZNHBPbOGgUcEaeVD,CAAAQAAARACA.MADAFAFAdCAA.KBHBZAEE.HCBCBCCDbBFAGCEAhAAAUDFA..EFEBeCGBhACAAEEA..XGGAhAAALECB.JFHBNIAB........hADA......hAIA...,2,-29,2,31
dGEDHcWNJgeKQARULVPFCZBOYfSMIXTba,RAAALAAAFADAZAFB.OADD..SAHHMAFA..TBFAhABAdCCAEDGAHCAA.cCGDhACAJEDBeEHF.AAAA.hBHAPDEDBFFA.fEHA.bFBBaGHDhCAADGGBWFCD...hBFA...,2,-22,-19,3
EXRYcJFDHPCKZBAMWgVQLIGaeSfNObTdU,MAAAVAAA.LAEAGADA.eAHH.SBBAOAFAdBFAECDARCGFJDAAhAAAHCFB.KEEDABIBQFEAhADAaDHD..hCAAbFAAXGGBFGGADFAA.......hAFA......hAGA...,1,-6,-9,3
OALdaceRBIHFPUDSYCKQGJgbfVZXEMNWT,aAAARAAAHADB.FAFADADA.CAFA.GCFA.JCCF..bAGDZDAFEBBBMAIBhAAA...TFDAhABAAAIBdBDAeCEHBFHA.IEGAhBAASHCGQGCAfHFBXFFChCAA.WEHH.hADA...,2,-22,-13,9
bJWUIQZYeGOMXgLEaDHPBSAKRdFNfVCTc,RAAAdAAAFADA..VADACAGA.....bABDUCCA.ZBFEeAGHGDFAhAAAMAIBLDHBhABADDABHDCCBFEDADHBKEGD.TGAAhADAJGAA..IHEAQFDB.OFHDhAGA....hBAA...,2,-27,-5,22
fgObHWVFAEGJXQCDacSKZMBRYdLUPeITN,EAAAGAAA.QADAaACDKAEA.ZAFBRAGFdCEALBHB.eCDBhAAATEAAfEGEhACA.bFBBHDFB.FEDHhAAAADABCFEASCBGMFIBBGGDPFHDIHDAhADAOGAE.JHEA.DCIBhAEA...,2,-10,14,24
gEIWKFYZNVXfAHLdaRSTMePDbJUCOcGQB,HAAAaAAA.RADFMAFAeACHDAEAUBGA..OAFEGCEABBEDECABKCCDhAAAZCEE....XDGAhAIAAEHAdFHATGCAJEFFQGCAhBAAgGFFFFHH.NBBA.....hCAA......hCGA...,1,4,-19,23
gUIVPBLJRfNZEKdFSXHWGCObQTcYMDAae,eAAAUAAA...IAEABADARAEFZAGB.dDAAXAFDHDCAGEFAhADAOAHF.QBCDhAAATGAA.MDDBACIBaEHFhAGAgEEA.LEHBfGCBhBAAEHAASGGDhABACHHA...,2,-19,-7,12
XFdVTcRAGBfeQYOEaZDIbUKHCJPSLNgWM,GAAAeAAAQADAEADAZAFBDAIBUAGA.HCCACCDA.SDFAhAAALDHB..NDAAMDCBhAAAdFBATFFA.ADIBfGDAhABAaEEAKFFDJHBA.WFHBFHFE.....hACA......hADA...,2,-12,1,13
OVLcSgPKZNWdYETUBbMRaQGXJHeFACDIf,DAAAOAAALADA..SADAKAHBZBBAdCFAEAGABCHDRCCAGCFAhAEAHEAAAAEACBBD..fBHAhAGA.gFCAhBAAPEEB.YEHBbGFAaHAA....hCAA......hCDA...,2,-26,-21,5
TLeHPNcdWFfQEVZUDJGCRMAXSaOBIKYbg,aAAABAAA.KACA....bACDTAFAHAEA....PBHDhAEAdAHAfCAAECFFZECADAGAhBAAGCCAREGBABBBSGEAhCAAOCFBgEFH.eEAF.WDHBhAAA.FGHH...hCCA...,1,-6,-13,7
LaBDJTEIVHbQZScFfOYNgMReWXKPUdGCA,aAAADAAAEACAHACB.ZAEAFAED..OBBH..gAGAhAGARCEAeCHHKEEDdCCAAAFALFCBhAHABCHATDFAIGFAhAIAbEDD.SHGA..fFFEhAHA.MBBB.WHFAhBAA..,1,-10,-21,11
DUBYAHVdZLOeNJPMRFGESabfWKgCTIXQc,HAAAZAAAeACEJADARAGFEAFE....aCAC..bBFAKCCC..TCDAhABAQCEDDCCBBDFAhAHAACIBdEFDLEHBOEHDMGAAhAAASFFA.fHDBCGGD.hACA......hAGA...,2,-19,-11,8
QLOCgEbKMZNFcBDUeJAXIYWdSHaTPfRGV,XAAA..IAAAdADAHAFAaACATCEARAEFGAGALCHBhAAACBCA.EDBAMCBBZEFBFEEHhABADDDBeDGDAAHASFAAhAFAfEEAOHDCbGAAKGGDBHHA...hAGA......hAIA...,1,14,-23,37
IDEXSUJdLKZHecYTCFaWVMNGAbOPfRgBQ,OAAARAAAQADCDAEA..EAGASAFB.dAHAZBBAHCDChAAAeBDETDGAaBHDMDDBhBAAACCBbFFA...fHBBhABABEEAXEGA.LGEAKEEDCHHD.hBHAFHCC.....hCAA...,2,-17,-3,14
aFdgbAIOGQKXJRPWBSYDEVCcLUTHMfZeN,GAAAQAAAKADARAFFBACA.DAEAEBHFCAGA.LCDBHBDAZCFEeDADhAAAFDDH.dEGAAAIB..OEGBhAAAXFDA.PHAAhACASEHB.cFBAMDIB...aHCChBFAIHHA..hADAWFFD.,1,0,-32,32
fZcLJKCUVDBMAdOXTEaGNYHIFebWRgPSQ,dAAATAAAEADAGAFA.HCACeACERDEB.SAFBZDGBLFBAhACACAHADBDBAAHAaFHD..ICEAhAAAFHBA.bCGD.hADA..gDEA.QGGAhAHA.....hBAA...,1,-4,-15,11
JYgDAeZBaRQfWSNMFKdLHGUEbCOcXIPTV,eAAAaAAA.RADA.QADA..SAGBMAGBdAHAHCCAhADAECCBOBHDXDFATCEAhAAAVFBA.JFFBDEAAABBBfHGFhBAAFEEHGGEBCGCA......hABA......hAEA...,2,-20,2,22
CQbNWBTVUKfHLMGJYIZDFEaeAPOXcgRSd,XAAARAAAdADA..QAFA..bACDBAHATAEAKCCDHDEAhAAAGAGAJEDFZDEBEFAAhABAAAAAODHD.SEAAhAEACCHAVFGB.LGAA.MIAAhAGADGFB.eGEA...hAFA...,1,9,-18,27
eVJSCaFDObLWcKTAINUQZXBYPgfMRGHdE,UAAAZAAABADB....gADARAEFHAGBECAAeAFH.SAHBhADAaDDBODGBbBGDLEEBhABA.KGAAADDAQEAAhAEAPHFCMDIBdEEA.CFHADGDB.TGFAhBAANIAB....hBCA...,2,-15,-5,10
KHLQWRPXDOdNgJIfCZYaATeEVScBFMbGU,EAAASAAAFACD.GACAHAEALAHBRAEADAIB.dCEDJCFBCDDDaEAAhAAAAAAA..eCHBBEFAMEABhAEAKEHBQGAAhAEA.XFECOEDDgFGBhAFAfGHE.YHAG.hAGA...,1,-13,-14,1
YDUSZTAMgVFbfNIWJGXCHROLdaBEPKeQc,MAAAFAAA....bACDfADA..IAEAGAEAHAGDhAGARAFFdAHAEDEFeBBBQDGAhBAADCIBZDDFADGBgFFBhAIAVFFBJECB.OHEC.BEHD.hCAA......hCBA...,1,2,-15,17
MTgUHDSfbCBRAJLeZWQEGIKYOdFNPcVXa,eAAAZAAAEADEGADA.KAFAdAFAFBHD..PAHB..XCFDhAAAaCAA.MCCBTDDAhABAHFAASDFBhACAbEFARFDFAAHA.LEHBQGGCOECB.cFFDhAIA....hCEA...,1,8,-22,30
LQfXDYGSPcAObJBeMaHIFRVCNKZUdgTEW,OAAABAAAeACAHADARAFA.CAGBZBFEdCAA..ECCALCCB.QDGAhAFADCFBGCGASBBDhAIAACIBMDEBFFFBKEEAUGAAhAAATGDA.XGGA..cGDChACA.aGHD...hBAA...,2,-14,-12,2
dIPUKgQCYecfMSXFEOTNBRHLaWJGAZbVD,ZAAADAAAdADAUAEAKAFA..QAGA.eCABMAIB.FBBBECCBhABAOCDEBDFAHDGBhACALCGBaEBDGEDAhADAAEEA.IHHACDBA..fFAAhAFA.TGEA.WHAAhAHA..,1,-8,-41,33
LDZbSTAFJVNeMCBYcaRfEgQOIdHWGXUPK,FAAAVAAAeACH.BAEAaADA...EAGAQAGAdCEAHCGBGEAAhAEAXBDDKEDDZCFFTFFAhAGAADCBMDIB..CGDA.REEBOGAAhAAAIHHAWHDA......hAGA......hBIA...,1,-7,-17,10
DKRXLFWHIEPZSObNaYCcdTGgMJeVAUQfB,QAAADAAARABALAEBHACA.EAFEZAGBOAHD..aCDBCCDAdCFAhAAAGEEAMDHBeCHHAEAABEEDhAEAFGAA...IGFAhAHASGCHNEIA..YFDF..hCAA......hDAA...,1,-11,-22,11
QecGdCIXgbHUEDJNPVaFAKYfRMWTZSOBL,KAAARAAAMADAZACBBAEA.LAGBeAFAdCCA.CBED...XCABhAAAHCFAEEDADAIB.JCEBPEGDhAAA.FHCAABGB..hABA..fDHASFFDQFFChACA.GECA.hBIAIHHA.,2,-21,-9,12
gVZdMYRQXONGPTAHUceFabCJfLISWDEBK,HAAAeAAAFADDaACACAFALAFA..SAGHECCBKCEA.ZCCAdCGAhAAARDFFQECAhAAAODHDGEEAAAIB.UGAAbFADIFHAhAFABGHD.MHDA.NIDB....hABA......hAGA...,1,3,-15,18
BMAIKcgTNeWbRfQLDZYVaCdPGJSHEXUFO,KAAATAAAeACE.RAFF.LACBZCCA.aAEAdAHAGAGAHDGBEDBBFBEBMDFBhAAAADIB..IFAAhAAAgEGA.bGDChAIAQGEADEEB.CEEDSECHhAFA......hBDA...,2,-15,-2,13
cSJQBHGWUZgLDIbFfeMVPKCOAETXYdNRa,EAAATAAAdADA..RAFA.aACA..SBCDBAFAHAGBGCEAZCCALECBhAAADCHBFDBHeDHHhAAAMDBBKEEDAAFA.XFGAhAFANEDA.QGEDUGGB.....hAIA......hBDA...,2,-13,0,13
BDbZOGSLRMEPIKHJdAUfeaXQNCVWFgYcT,eAAAaAAA.QADACADA.FAFE..gAEHTCCADAIBZAGBhADAGCFARCCB.ECHBKBBDhBAAHFDBABIBXDGAhCAA.VFDAcFGDOHFC.SGCDhCGA.....hAAA...,2,-11,-9,2
GXDfHBLJIFPQZbcCeKVMOYRgUSATaNWEd,aAAAEAAAGACA.DAEAHACBLAHBFAEAZAGBCBEB.eBBD.MBIBhBAARBFFSCBDACFA.hBEATEDAdDEABEGAIEHAhAAAbGEA.KFGD.OHBA....hBCA......hBHA...,2,-16,-16,0
CFbfBIUQdcHPTNREeOKJGDSgAZMXYWaVL,ZAAAMAAA..XADBaACELAFAFAFDBAHAQCCAHCAATCGAhABAECEAKBBD..GDEAhACASCGAADEB.VEFAhAGAfEHAdHABPFEBeHAADGIBgGGAhAHA....hCAA...,2,-9,-1,8
TKgedNBUSQcWXRACGOYfDEFHZLaJbPIVM,GAAAOAAADAEAHADAZAEEaAFA...bBFAVCCB..MCDBKBBDdCFAhAIABDGA.QEEChAAAXDGD.ADABfEHAhACAEFDALHCAIHHATGGA.gGDGhADA....hAIA...,1,-6,-19,13
EXHLQZRaGVbMeOUNcCdgFATfDPIKBSYWJ,TAAADAAAKACABAEB..SACB.JAEAHAFBZBEARDDAGCCAhAHAMAIB.eBHHOCCBhAAAUEGBCEGA.dFEAAEIB.fBBEhAIAIGDAEFFB......hAHA......hCAA...,1,-21,-27,6
AgbNaBJLfKSRdWEYOMZcFCIVGUHeXPTQD,...bAAAaAAA.LADASAEARAGFEBBBMAHBZCEF...CCAAGCCBhAAAHDCBeCHH.TFAAhAEAAAEABDHAKFHBdEFAOGDChAFAFFCAIFHA.XGCCDIAA.hAIA......hBAA...,1,-2,-14,12
aScFJefWDOBbEACZVLTYHRUdXIGPNKQgM,ZAAATAAAHAEA.RCAAdAHAGACAKCED.MAEA.aAGEFCGH.eDHHDBFBBCADhAAAAACALEAAUCGAXEBChACA.IEEAhBEAQFEASFGAfGAAbGDCCHHAhDCA......hDEA...,1,-11,-12,1
NOJRDBPAEXdMWSVIcgZYGbCFLeTUQafKH,EAAAdAAAMADA..SACA.IAFAZAEEbABDLCFAhAIAeAGHQCCAhAAAaDCEHEFAOBHDRGCABGHAACFBXDAChADA.cEDD.GGEBhAIACHGD.FFGA....hCAA...,1,-9,-11,2
UVDMIHKfLPaOcXGTJSZCBgReEbNYdWAFQ,QAAADAAAHABCLAEBaACE.OAGBGAEA.TAGAZCGBBAHBhBAARDAAECHF..bDDCdDDAhAAAACCBFFFHMDGB.fEHAhADA.XGAACHGAeECDNDIAYFFFhAGA.....hCAA...,1,15,-17,32
TBfZVOGXPIWJcSaFENgYQMdDAbCUKeLHR,CAAAeAAAHACARADABAGBZAFBGCAA..XBGA..IBHAhAAAJCCB.aCCCEDFANDHA.hACAQEDD.hAEAdEAAADIBbECALEHBfGEEOHFCWFADhAFA.SGGDhAIA...,2,-21,-15,6
aOYZFbGATXCKBLcgedWRUfMVDINQSPHJE,TAAAKAAALACB.eAEARACFMAEA.DAIBQBGAHBEAECABODEBhAAAZCEFGEAAABGABDGAhACAdEDAfEHAhAAA.IHEASDHHaGGC.bFFC.CGDD.hDCA......hDGA...,2,-13,-2,11
KWNVRUgbSPAYEDfIcOBTCQJZaLMGFHXde,EAAADAAA....IADABACATAEA.QAGCaAEDGAGAhAGAHCCAeBBBKCHBVDDAhAIARDFBbEABADIB...fEEEhAAACFGAZGBAMFIBdGHA.NIABSHEEhAEAcGFC......hAIA...,1,-1,-13,12
RTbQgXHdWIYMPDFKaGfBZOJNECLVASecU,eAAARAAAQADCHADAdAGA...ICCAMAFAFBFDGCEAZBGBOCCBhAAAECHFLFAAhAAAACIBSDEDTGDAXEGAhABAPHFCaGGABGGA.......hABA......hAFA...,1,4,-18,22
BDfbTVSUGaRCJWNEOQIZdHLecgXKPFAYM,MAAADAAA..TACASACAGAEARAEF.CAGA...JAHBEBBBQCCChAGAdCHAHDDBeDGDhAEAXCFDFGAAAAIBBEEDfGGEhAGAbFGB.aHDAOBBH.LHAAhAHA.....hBAA...,1,-7,-8,1
acPCbRSHDEVfBKWNQGOdUAYZFeXgTILMJ,ZAAAeAAA..TAEAMAEA..aAGECAGBRCAAHBCADACA.ECFABBHA.KCEDhABAQDGA.hAIAdEBAACGBXDFAhCAALEDBPFFBSEHHfHGFNIDB..hAAAOGFC...hABA...,2,-24,-8,16
LSNcTGdWbPgDEIRfZCMHXOBVUFYQeKaAJ,LAAASAAATAEAdADA....bAEDDAGA.RBGBZCAAHAGBBCEDhABAFCCHeDBDABIB.cDGDhAAAGDFA.gEAAhACAEEEACFHAMIAAOEEHYGAAaFHDNIEBIHHAhABA....hAGA...,1,-6,-9,3
ebaJVHAMLOGKRYBgdWXEZIPNTfCSFcQDU,MAAAGAAARACA.BADAdAFA.EAFAZAGB....IBHATCDASBBDhBAAQCDAeCGBhAAAaCHDHEFAADABLFAAhACAKFED.gFDH.XGFAhADAfGHACDCDDDIB...hBIA...,2,-21,1,22
HOQcFNKUfaTDWRMJXgESZYPLIeGbCABdV,dAAAHAAAQADAFADAKAGAUCAB..aAFEDCFARCAA..MAIB.JCFBhACAECHF.ZDCBLEDBhADAeEEBCEGD.ACHBOFGBhAGA.NEIA.TGAA.XGDD.SGGAhAAA..hACA...,1,-10,-24,14
LfedITMCOcDZGYJBHXAbgNPUWQEKVRFaS,...bAAAgAAA.UADAEAEARAGBaAFELCAB.eCCAhAAAdCGAMAIBOCFDZCCAhAAAGEGABDBDHFFAhABAAAIBPEEBQGAA.FGDB.SHFAhAGA....hBDA...,2,-4,-4,0
AWSJOQMafLgedYTZbNKVHBXUICEDGRFcP,SAAAQAAAaACELADA.eAGHdAFAZAGBKCCAHCEBXCDChAAACCHAEEAARDABFDHD.ABIBOEEBhADAMEHB.fFGEhBFATECANEIABGFADGIB......hAAA......hABA...,2,-14,-4,10
XPbRCNUEeOfGBcadDMLVTFAgYQJKZIHWS,QAAAZAAAHAEAXBGARACAUAFA..ECDFeCAB.GCCBBAHAdDAAhAAAMDHBLDFAhADAFEFBAAGA.JEEFKGGD.SEADhABACGDDOHFCaGGADEIB.......hACA......hADA...,2,-10,-9,1
BETbICHYRMfDPOcWaLgAQNGdFJXeUSVZK,GAAAdAAAFADA.eADAUAGAZAGBBBDDEBFF....TDCACCBAHCEAREFAMBIBhAAADDDB..ODHDhACAaDAHACDAQGEChACA..XEEAKHGA.bGBA.fGHEhBAA...hADA...,1,1,-30,31
FKGfeDQSdHJCZgBPEWNMYOXRcAIUVTabL,VAAAaAAALADA.GAGAeADEQAGCHCCAZEAABBBDEBDFMCFBhAAAXEEA.AAIBTGDAhAEAbDFDKCHBSEDBhAIAdGHACHFA.PHEA.....hAFA......hBAA...,2,-6,-4,2
XBSOYCZWfcaFRMdALEIHKNDgPTQJUGebV,EAAAHAAADADATAEA.QAGCGAEBeBCBXCAAOCEBZCFEhAAA..fCGAhAAAaDCDREABAACALEEAKDBBgEGAhAHAPFHDUGEAbFCASGHH.hAEACHED......hAIA...,2,-5,16,21
BReZdWMQEPIOSaYLKFVAHGbUgTfCcXJND,HAAAGAAAUADA..TADACAFA.XAFBDAHBRCAAeBHHZBGBdCDDhAAAMCGBEEEB..ODEBhAAAaDAHLFHBFEHDAFDB.hACAbGDA....fFFENIAB.BHHAhAIA.....hACA...,2,-17,-4,13
IDeTHJBUFQAPfdgGZLbWVaCMXcRONESKY,dAAAZAAALADB..bABDaAFAMADARBFB.EAGAKBHB.DCAAHBEAhBAABDEAQDEBhBDA.ABIBfDHAhBEAGEGACFBAOFFHSFGA.eHDA..hCDA......hDAA...,1,-7,-30,23
LaWXVgQGECHBJPIcYdSUDONRfKZFeAMbT,MAAATAAALAEA..aACAXBBAQAFAEBHFHCDBhAFABAHAICCAdDFADDIBRFCBKFGAhAGAeCEBABBA.VDGBCHEA.hAIAcDBC.SEED.OFABhAAA.ZGDA...hBAA...,2,-11,4,15
WfbEZTPUYgdKLVFMcJRHIXNSBGDQeCaOA,...bAAAEAAA.ZACBUAEAdAFALAHBFAGE.MBEBRCAAHCFCXDEDhAAABDEDGEBAhAAA.eEFFaCBBABHBTGGAhABAgDGGKEHB.cFBA...IGGAhBCA.DGIB.hACA...,2,-11,-5,6
cFBPSVHYCabdKJTAWUfMIeOLEQZNXRDGg,UAAAMAAA.eADAEADAZAFBRAGB.GBBAFCDABDAA..SAHHhBAAHCFBaDDH.dDHA.TEDAhBBAAADA.IGFAhBFALFFA.NIABDHFAPHBA.CHGA.....hBHA......hCAA...,2,-20,-9,11
HTQbcICEAJNBDKfOXFUeRdgZPSWYGLaMV,BAAAKAAAOACAFACARAEF.ZAFB....SAGBGBCAaAHDHCBAhAAAQDGA..hAAAbCFDCBEAAEEADAIBUGFAeDHBhBCAdHBB..PFEB......hCAA......hCBA...,2,-28,-18,10
PgWfVZaReNMESGQTACOIdYBUbHFXLKDJc,OAAAdAAABADAHADALAFADAFA..JAHB..PCBC..hACAfBBEaCEA.hADARCEBeDCFECHBGDEAhAGAADIBCEGAUGDAbEGDKHAA..gGGA.hAHA......hBAA...,1,-15,-20,5
JdgABILSXRYfbeKcWUTQOCGHDNVMEZaPF,LAAARAAA..bADBeADH.KAFAUAGATCAAQDCChAAA.GDGAHCEADAIBhABAMBFBEDHFaFFHFEEHdGBAACGASFAAhACAfGDA.OFHDNIEB.PHAAhAFA.BGFA..hAHA...,2,-10,0,10
HeDPRgQUfFBYWNKESdJbAXVcGCLZIMTaO,XAAAGAAAZADA.MAEAaADA.HBGB.eCDBRAFFQCDChAAAFDFHBECA.NAIA.EEHF.dGGDABDACDGAhABA.LFEA.hAAAOFHDDAIB.PHAA.....hACA......hBAA...,1,-10,-12,2
LYJeECBAVOdMRPQgUaZSXINWfFbHGDcTK,dAAARAAAQADCaADA.ZAFBXAFD..IBHA.hACA.fAHEhAIAHDDAGDGATCBALFAAhAAAeBEDEDGAACCBMFFBgEEGSGGDFEHDbGDChBAADIAA.....hABA...,1,-4,-8,4
deJgRWOGUMDZbCBaIPEFNLXfcHYQTSKVA,eAAARAAAGADAMAEAZAFABAHA..aCCHEBCALCGB.XDADhAAAHBEATDDA.hABAKCHBAAGAdEFCgEGBhAAAOEHDbFDDCFFAFGBA........hABA......hBGA...,2,-18,-3,15
PaNJDMZTHgFbSfXeWIEGUdVRKCcYLBOQA,aAAADAAAZABEHACBFAFA..SAEA.eAGHEBEFdCCARCEBCCHALEAAhAEAQCFAAAIBJEGBhAFAMAIB...bDABWBBDhBAAGEEA.KEHBBHHA.OEEH.hADA......hBAA...,1,0,-24,24
WaYEeMKXdUITDVSbfBCNLQJZGFAgPRcOH,RAAAHAAA.aACAEADEeAEHMAFA..dAGATBFASBHH.BCCAhAAALBHBZDEBAEEBPEHBhAIAOCCBKDEA.XECDhAAADGBAfGFAQFFA.FHDA.hBGA......hCAA...,1,-9,-14,5
EcLQOeWTgJADVCFGaMUIbXYHNRKBZPSdf,CAAAaAAAUACA..XACDHAEARCEA..ZEEAdAEB.EAHBLEHBhAAA.eCBBTCEAAAGAFGEAhAIAGCGA.bFBAKBHBhBCASBBD.QGFC.hCAAWFHHDDDB.MIAA.hDAA...,2,-15,-2,13
ZNfUDALaMWBRcEbFJTPgSXeKQHYVICGOd,aAAAMAAABADARACA..EAFEFAFA...JBBFTCDA..SAHHhADAeAHHHCFB.IFCAhAHAGBEAZDGBfBBEhBAAADDBLGCAbFFAPHFCKGHB...hBAA......hCAA...,2,-31,2,33
MScBCeDQEIZJLabUPRYTAHNKVdGWXfgOF,HAAAKAAAGACAXADBOAEAMAGB.BAHAeAHFECABZBEF.aCABbCCAhAAA..REDB.ACCAdCHA.hAAA.fDHAhACASEEADFIBQFBALFFB.PFGD.hCGAYHAA..hACA...,2,-7,-5,2
SeFWBbTGEaAKCVUgcHDOJPZRNYfMQdXIL,CAAAUAAAHACAOADAZAFBRCAA.......fAGAdBHALCEDhAAAeAHHBEADGBDAhBAAACAAKEGAgDBBhBCADGEAJHCA.PDGB.MDIBIGHAFFED..hACA...WFAAEGHB.hBDA...,2,-23,-12,11
fdACFgJbEMcaQKPBWDXOSYeUGLIZVRTHN,FAAAJAAA.EADA..aADAQAFA.BAHAXAFD.SAHBhBAAeCCAGDAAhADAZCCARDFFHDEAdDHAABEBbFGBMEEBhBHAKCHBDGDA.........hCAA......hCBA...,1,-6,-31,25
MDFBERCPbTLUOSNVAecQJgfWXHYGZaKdI,eAAAQAAA.JACEfADA.HAEBZAFBdBHAMAHBBBEAhAAARDDBCCCD.bDCBLEHBhAAASEEAAAGBgGDAhABAXEGD.aDGHDHCA.......hAIA......hBIA...,1,-7,-24,17
IgTBYSPHKWcLDVERMAXbQJGafedZNFUOC,QAAAaAAA.eACAZACBFAEDUAGACAGA...TCDASAHHhAGAHDAAKDFALDEAhBAAEEHFADHAJFBBdFDAOBBBhCAA.BCFAPFFBDDIBRFFAbFCD.....hDAA......hEAA...,1,6,-20,26
SbJDfFCEgLMQOBVdRZcKPGIeWNHXYTUaA,SAAADAAACACA.EADAMAEA.BAHARAFAZCCA.KCGAGBCB.hAAAeBBDHDAA.TEFAhABAABFAJCGB.FFCALEEBhBAAQGAAdGGAIFDANEIA..YHEAhADAaDHD....hAGA...,1,-9,-27,18
SfcLWMKVXYECRaDQPOABdgNTFeJIHGZUb,dAAATAAAeADA.HAGBZACBUAFA..bABDSBEDLCEBMDABhADAXCGAEDGBRGBAaCAHhAAAQFGBAAIB.hACABEDCFEEAGEGA.fFBAhBFA.KHBA....hBHA...,1,7,-12,19
XHRKDYgEUcNACTOVFdfaJLQbBGeZWPIMS,TAAAFAAAdADA...aACALAFA.QCEAGAEAeAGBhAAAZCGB.ICCAMCCBHGAAhAGARDFFDAIBEDDB.UGDAhAHAADBBODHDfFHAbEDDBGHDSGGDhBAAKHAA......hBDA...,1,-3,-5,2
PWMHbCQGdfULKRNVDBXZeOTEFJaAcIYgS,..IAAASAAA.MADAHACAQAGAdAFALAHBRBCADCGBhAAAZCAAeDBBECEBaDFDADEA.hABA..gEAAhACAbDGDfEEAKEHBBGGAOFBHFHBAYEEFhAEACGFDNIDB.....hBDA...,1,8,-14,22
HLEAQIaMBFKfTXWdeNcVbSCgOPDYJRUZG,aAAAMAAABADAKADA.....TAFAdAFAeAHB..VCCAbBBC.hAIACAHB..OBBBDCHBRDDAGGDBhBAAHCGBACIBQFAAhADAfFFBNEIASEFD.gGDBhAFA...hBCA...,1,-10,-22,12
HgFVMaQJbXfZYGcODLIUPKeWBREANTSdC,TAAAdAAAHADA.FAGAaACAQCBA..bAEDZCFAGAGAhAAADCGALDDBICCAKDADhACAeDBBRFABAEHB.CEEAMDIBhAGAfFFAOEGB.UGBBBGHAEHGASHGGhADA....hAFA...,1,11,-8,19
VfORDacePLAKGYCFBZgEINQbUWSXMHdTJ,GAAAFAAAZACB.EADAQAEAUAGA..XCDAHAGDdDEATDGAhAAAVEGB..RECBaGEDeDADhACA.ACDACEED.BFGD.hAIAIGDA.bFBD.MFIB...hBAA......hCAA...,1,0,-17,17
GFVDKRTSfYaBXINWEHPOJdgMQcZLbCUAe,eAAAGAAADAEARADA..SAGBaAFE.BCDDXBCA..hAAAICFAEBHFHCEBOBHDhAAAdDBAMDDBZEAAbEEAhACAACGBKDHB.TFGA.fGFEYFHBNIABhADA......hAEA...,1,-6,-19,13
VUWONecTAZDSfQIYGFLKPEHCgbdBJRaMX,ZAAASAAAQAEAGACALAHBKAEAHAGBCBGBdCAARCEB..aDHDMCCBhABAUEAAODDA.hAAAeECHAAIBfFGEhABAFEEHEEHBBGFAXGDANIEB.DEEB....hAEA......hAGA...,1,-2,-7,5
HQdgRfTNbLEOVWaPYXDcCUeAIFZGMSBJK,ZAAAGAAAMACABADAHAECdAFARCCA...TCDALAHB.EDFFOAHBhAAAaEEH..XFCDhABACDCDACIBSDADhACAKFHBQGFDfDFA.bEGD...PFBChADA.DEIB..hAIA...,1,-1,-25,24
YJQICNVUKcTgWAOBPMLeZGHDRadXESbFf,BAAAMAAAZABEHACARAEF.dAFA.EAHBFAGA..JCAAQCCC.hAAACCGA.UDEAKDHB.TDGAhACAAEEALFFBeEAAaFGEhAEASFHD.bGCCfHCB.hBAAIHHA..hAIA...,2,-23,-17,6
SJCKRgacVefMWbTAIYDPBHdLXGNEFUQZO,DAAAHAAAdADAGADAFAFA.ZAFA.SCAAKBBBRBEF.aCFDeAHHMCHBhAAA...TFDAhACAADBB.IGAABDDDLEGBhBAAEFFEOFHDCFFA..gGDBhBBA......hBDA...,2,-42,10,52
AVKOPbgEGTSQdXUJFWZacIRCBYDNMeLHf,OAAA..bAAAEADAGAEA.TAGAdAGAXBBC.hAAAFBEDaCAARDEABCHADCIBeDDBhABAHFGBAAEBKDGBSDDDhAIAQFFCUGBAZGAACGFC.MFIB...hBAA......hBGA...,2,-12,1,13
HCOKFdETRcSbWQLfVBeZJagDNIYAXMUPG,MAAAGAAAHACCKADAEAFERAFF..SAHB.QCCChAFALAHBBCDAeCGHaBBHhBAADCFAIDFAADFBXFFAhCAACDCDdEHA.bEECWEEDfGGE..hAAA......hACA...,1,3,-30,33
LPMGYVUDATWgORNcXaJKdSbQIEHZeFfBC,TAAAOAAARADA....XACBaAGAdCCA.QAEAHBFCeDFBhAEABAGALEHBGCCBhAAAUGDAAAIBgCGHhCAA.cEFCSBBDEGHF.fHFBhBAACEHA....hCAA...,1,-1,-13,12
WFIbBAdHSEfCcONTUZGKaMQgYXeDVPRJL,HAAAEAAA.CADB.OACCUAFAGCABMAEAQBFA.XCCAhAAAeBHHDDFB.RECBLFGBhAAAFDFHbEGD.AEEBfFBEhACANAIAKHCA.aGED......hAIA......hBFA...,2,-13,-10,3
ALUHJbGICBgKDSaXWOMREFeTVPQZNcdYf,HAAAGAAABADBDADA.aAEDOAEE.EBHFeAGB.TCCAQCDAhAAAZDFAdFFAAAHALDFBhACAbFGD.CDCDSDHHhBAAMAIBFCAHPGCAcGCAfHABhAAA..IGHAhBCA...,1,9,-26,35
NUWADPYJgKZcEIXHbeOFTSGCVfLMQdRBa,DAAAJAAAZADBEACA..HAEA..eAFAFBBHGCEBCBHALCCDdAHARDCBBCGDhADAUFFA..ADIB..hAGA....gEEAhAGA.KEHD.XGGAOEHDSHEGhBAA..hCAA...,1,-19,-34,15
QPEINFAdaeLKXBJRHcVgCUWSTODYGbZfM,eAAALAAABADAHADB.VAFACAFAUCCA..TCAADAHBGCFAhAAAZCFEMDDB.EEEBFEHDhABAAEGAdFAAaBHD.KEHBRFAA..hABA.gGFAOFDD....YFFFhAFA....hAIA...,2,-28,8,36
VOHJDNaWFREcTMASGKYQdXIgCZUfPLBeb,GAAAQAAAdADA..XAFACACAZADBUAGALCFABBFCeDCBhAAAODBDHEEADDDBaEDDRGDEEGGEhBIA..MEHBADIB.KFADhAAA.IFFA.......hCAA......hCDA...,1,-14,-15,1
SYZfcQCXageLAOGbITUFRWPdHBKDJVMEN,GAAATAAA.RADAdAGAHACBDAIBMAEA.EAHFSCDAZBEB.QDFAhAAAaCACeCGBACIBODAHhACAbEBB.FDCHBEFAhAAAKDHBJEEFYEHB..CGGA.....hADA......hAEA...,2,-14,7,21
XPUgTSDLQINCVJHeRGZFKbBaAWYMOdfEc,MAAAdAAAEADA..XACAUAGA..TCBALAFA.QCCChAGACBEAHDEARFGBZGBAbCFAABBBhAHAODAB..fEEAhBAA.gFCDDDGA.IFGAhCAA.JHEEFEDHhACABHCDaGFH,2,-21,-12,9
GTENbUdgBXWSOMPHDCJRaFQYfceIVLAKZ,GAAAEAAAUADAdADABAFASAFA.MAIBHAGB.CBCCRDDAaCDEQEGAhAAA..hAIAfCGAeFFBIGDAhBIAAAABZEEAbDBD.XGAC.OFHDhACADIDA.FHEA...hCAA...,1,2,-22,24
CZMHeSBJVXOENaLPAFDbRKTIGcgWdYUQf,DAAARAAAKADCGABB......gAFAdAFAQCCBhAEAZCCAHCGBeAHBBECAXCFAhAIAEEEBLGAAhAAAAEEAbEFA.TGFA..IGEA.cGGAhBAA....hCAA...,2,-28,-16,12
ATLKUSeDRXJHfFMGZdaObNPWYgQCEIVBc,TAAALAAA.SADHRACFHAEBFAGAZAEBdCHAOAGD..bDFDhAAA..PCAB.hACA.gEAAhAEAECCBBDFAAAIBeEDBXEECMFIBaGBDYCHBCEEBIHFAhBGAKGBADGGA...hCAA...,1,0,-12,12
cgeUdEMKJCBSYVATPNOfDGLZWRQXFHbaI,TAAAOAAAGADA.ZAFARACFQAECHCFAaBBH.IAHAhAAAeDDDEEHBMCABKFFABGAAhAGASCEAAHCA.fCHAhACADIAA.LEEB.FEGH.hAHAbGAA.....hAIA...,1,3,-11,14
DSTLNfPWMGHIAgeVbBYURdZEOXaQcCKFJ,eAAABAAARACAEADA..aAFAQAFA.KAHBDAIBLCCAhAAA.fDFAhABAMBGBHCAAADHAVECBbCEDdDHAZFGBhCAAXECBFGFB.TGGA...PHCAhAAA....hACA...,1,6,-27,33
CYeVPQacRLXUIBHgNfAZTWEDGSOJFbdMK,ZAAAEAAAGACAOACAFAFDdAEBKAHB..eAHBQCEARCCA.LDGBhAAAXCGDBCBDhAHAHEEAfEEEhBCAAFIBDGDBSGGBbFBB..MDIB.CHHA...hBFA......hCAA...,2,-21,-6,15
JDMBEHFPdNceIAQbgaVGULWOKfYXCSTZR,QAAAaAAAGACALAEAKACA..XAEBTCEARCGFMAHBhAAAHFAAdCDAeBBDAAIBVDFBhBGAOEEB.CFGDSFHHhAFAZFDFBFHAEGCBNIAB.IHHA...hAGA......hAIA...,2,-11,4,15
fMDNOWYFZRgUBaSdTIecXGVHbJCLKEQPA,MAAAOAAAFADDRADABAGB..dAFA.eAHBGCCAHBBBCBBDEBHFABBBDCHBhAIA....NCFA.ZDEBhBAA.aEDB.SEHHhBFATEAA.XGEAbEFDKDHBQGCBhAEA.WHFA..hAIA...,1,-11,-24,13
dGTeVUgKQONPEWDZXCcJAbfMHaISFYRLB,MAAAHAAAaACAFADDLAFAGAEA..eAGBUCFAQCCChAAA.OCHDEBBBZDDBCAHBADGBhCAAbFFASEEDhDAARGAA.dFFA..........hDBA......hDCA...,2,-24,-2,22
BIFWJaQeZbVdMYcPGNKEAHgUSLfROXCDT,HAAASAAARADFCAFBBAHAFADA....aAFDeCABZAGB.dCFA.MCCBhAAAPBCDGDGA.EDDBhACAAAAALDFA.hADAXECADCIBIHAAQFFAbFDCYHCGhAHAKFHB....hCHA...,1,-7,-18,11
CBcSYaLWFdMVTPQXDIZbOgEGHKJAUfNRe,UAAARAAAeADEBADA..SAGBaAED.LCCAdAGAMAIBTDFAhAAAQDAADAIBZEBAhABAODCCEEHFHGCAADFACDGA.hADAcFFCFEHD..XFFD.bGBA.hBEA......hCAA...,2,-20,-4,16
AbfBHgFETGLRSMdcXePWUIJYKVONDQZCa,BAAAHAAAEADEGACARAFFdAHAeAEA.UCFAICCAKAHB..OCABhAAAQDECZEABADHA.bDGDhAAAFEDDLECB.hACAMCABXFFAPFAD.WGFG...hAEA......hAFA...,2,-23,12,35
MQKAUfLGWXeOJVcPDEINTdHbagSYBCFRZ,LAAAGAAAeADAOADDJAGB...VAFADAIBECDA..TCAAhABAHDEAaDAH.SDCDhAAACCFDRDFAZFAAMEEBADHAfEHAhACAXFFA.IGFANIAB...hACA......hAFA...,2,-14,-8,6
JbDdSQGgIPBWROaYKFfcCAZLEMXTUVeNH,EAAAMAAAUADA..eACAHAFADAGAdBCCGBDB..gCFAhAAABBBDRDDBaBGAFDHDCDFAADHAZEDAhAHA..LEHBhBAA.XGFBNIABSGHB....hAIA......hCAA...,1,-14,-19,5
RIQABGdCaTVMNHSXegJFZEYPKfUWODLbc,dAAAaAAA.MADAHACB.eAEAFAGDZBDB..EAHFKCBAUCGBDAIBLDFAhACARDEBAAEAGEGA.TFCAhBAASFCA.JFFAhBAAYBBF..fHDB.hCAA......hCFA...,2,-31,-3,28
JGeOKVSBDQaCfNAHbXIgUTdLcYEFZWRMP,HAAAXAAAUADAdADALAGB.ECABZAEBRDDA.MAHBGEGAeCFHhAAAKCCDBDBADAIBaFBAfDDEhABA.AAIBIEHAhBDATGBAFGFHPFGB...OGBAhBGA.....hAAA...,1,-6,-12,6
NZUDGBQFOcabVAJTYLdgHPKRfECXIMSWe,TAAAdAAAHADA.RAGFECBACACB..MAEA.eAHFZDAAGEDABBDAQCEAhAAAOCFBbFABABFALEEAhCAAKDHB.XFGAhCCASFHDUGDAFGFD.....hCIA......hDAA...,2,-15,4,19
VSJXHOBYICEQPdcRWaKGeAUZLDNTbfFgM,ZAAALAAADACA.TAEAFAED..MAGBSAGBHCGBBAHACCAAECCAhABAdDDA.RFDA.KCFAACCB.UEAAhACA...bDECfFHAhABAVFFA.OHAA....hAHA......hCAA...,2,-30,-9,21
WKgLUMVJXHGbfFBODaZdeCPQTNSAIREcY,EAAA....cAAAKACALAEB.MAGBXACBHCCBbBGDhAAABAEA.aAFDeEFBhAHAQCDDSFHBhAIARBGFgEEA.UGGA.JHAA..hAHA......hAIA...,1,-10,-21,11
BATeZgVUEPKFdScaQWLIYDRHJfMCNbXGO,eAAAZAAAUAEAEADAFAFDdAHA....aCAALAHB.DCCAHDAAhABAMDDAbDDBGEEA.hACAAAAA.TDFA.gFFAhADAKEHBSGHDQGBAIHBAhBHA......hCAA...,2,-26,-3,23
RTXJMNWfaYGAHSdDPFIbQeZLgBEUOVcKC,HAAAdAAAFADAQADCZAFBLBHBEAFEOAHD.KCADRCAATECAhACAMCCB....fCGEhAAAGEEAACEADGHBhAIAbDDBeEHFBHCA.cFED.CFCAJHAA.aGHDhACA......hAHA...,1,4,-23,27
fYDJIEORKWMLeVHPdNUagTCcGXFSAQBZb,ZAAA..bAAADACAEAEARAEAKBHB..MAHBLDDAHCAAdCEA.aCGHhAAATEGAGEABFECHAAIBQFFAhABABFAA.hABAfGBEIHAAeFDHNDIA.CFFDSGHHhAFA...hACA...,2,-25,2,27
bWQNaIRYeAJOFDLKZGSBPUHgCMTXdfEcV,FAAALAAAGACABAEAHAEAMAGBdAHAECFF..VCAAQDGAhAEAaAHB.REDBAFFADBIBZGAASCFDhABAUGGA.TECAhACA...fDHE.bFFBhAEA.IHHA.hAGA...,1,-3,-17,14
GXKEWPdTIOFZLMcBeHRfVSgUaQAYJbDCN,JAAACAAAGACA.KAEAEADE.dAFA..TBGAFAHBZCCA.LDGBhBAAMCABBAHBHECARCEB.SFHHhCAAaCBH.ACIBDGEBhCBAXEGA.IGAAcGFC.eEEDhAAA.fGDEhACA.gGGB.,2,-15,-12,3
VCaBRMZWKLFHSDENJQgGbTOYIdXPUefcA,aAAARAAAZADBLADAHAFAECFB..QBGAGDAAOCHBdCCAXDFChAEAeCCDAAAABEEAMBBBFEDDhAFADEIB.JEHB.bGDATGFAhADA..IHAA....hAHA......hAIA...,2,-10,-3,7
gaEJfABDHLWGXYVUPdKMICOTFeZbcNSRQ,HAAAGAAAXADBUADAdAGAMAGB.OAHBeBHHZDBB..bBEDhAAASDEARCAA.hACAaEDCEDHFAAABLFGBhACAVFFBKEDD...........hAIA......hCAA...,1,-1,-18,17
JQcYMIRAUfGaONVLSWFDTBHePKdbEgCXZ,GAAAaAAA.OADALADAFAGDBCDAHAGBeBBBdDFA.ECFBXDBDhAAAZDCBQEAChAEA.MDIBAAIBfCHAhACASEEBTFGAbEGD.CEEC.....hBAA......hBCA...,2,-27,8,35
WKDTQYJIVcPGLCANbFEaOBSfHXUedMgZR,FAAAEAAABACAHACBeAEAdAEAZAFBRBFA...DAIBTDEA..QCCChAAAIDHAVEAAhAEAGCGALFGBAEBB.hBEANIAB.aEEB.fFFAMFIB.KGHB.YHBAhBHA...hAFA...,1,-6,-16,10
DBXJQfSRgTCMcEZPbFIWdGKVNYeAHLOUa,HAAALAAAaACABAFAQAEARAGF.TAGAMCCAZDDA.FDHDdCAAhABAGFABKCCAVDEAeFDEhAAAACIBDECB..fGHAhAFACEHAEGGA..bECDNIAB.OHDE..hACA......hAEA...,1,1,-8,9
HAVWMbgfRXZeTBDPKcLECGaONFdSUQYJI,MAAA..bAAARACAeAFEDAAAKAEALCCA.EBGBaAGA.FBGDdDGDhAIAQCCBJECAHFECABBBhBAAVEAA..WFHBhCAAXDGA.ZEEA.BGGD....hAEA......hCAA...,1,-7,-20,13
CXbZWeQHGTSUacRgKIANYVdFPfDEJOLBM,VAAAdAAAFADA.DAGAEADE..LBDABAFBMAHB..XBGDhACAZCDAeCHHHCBAGECAhAAATDEAaEEC.REGB.KFHBABIB.hBAA...NIEB.fGGE...hBCA......hDAA...,1,-13,-19,6
USVdFXacHTIDNgKOMGLYJebQZWERfBCPA,SAAAdAAAaADA.HACBDAGAKBDAGAEBLBGBeCEFZCGB.REAACFEAhAAAABIBFCBD..TGGAhABA.IHAAhAEAODDAMDIB.bEECEGDBBGCA....hACA......hBAA...,1,8,-38,46
cWbTYABHMXKCZEgQNdGFPRJSVaOLUfIeD,HAAAMAAAKADAEADEQAFCGAFA.RCAA.SAHBaAHD.LBBBhAFAfCEEeDCHhBAADDGAbDGDAEEBCEGA.ZFFAdEEAhBHAFGEH.PHAA.......hCAA......hCBA...,1,5,-17,22
IYRMGXJKUTgedNOCfDLBVSQbHPaAcWEFZ,EAAAZAAARAEAGACAKBHB.UAFA..eCABdBHACAEDLDDABCBD.QEGAhABAHDFAAEEBFFDHMCCBhACA..TFGAhAAAOEAHDFFBbFDB.aGCB...IHHAhADA......hAEA...,2,-17,-12,5
JPFUTIQXSeLCEgDYRfdBAcaHWMNVOGZKb,HAAAMAAA.OACAZABEKAFAJAFB..FBHDUCCA..TCCAQCGAhAAAeCEHLEGBhAFAEEFBDFHB.RGCABECDAAHAaGEB.hBHANEIA............hBIA......hCAA...,2,-23,-17,6
QKXTSIJHCUgbeWLOGZPNEcMDVYaRdAFfB,BAAAQAAAKACA.SACAHAEBCAGAUCAAeAEH.LAGBhAAAZCGB.EDAAMCDBDAIBaDCDhADAAAIBFEEBTEEA.gEGBhBGAOEHDGGABcGCA....hCAA......hCDA...,2,-27,-7,20
GCYQdUgKWOEMcbJBTaVXANeLZSFIHDfPR,eAAAZAAAFADAHADADAGA.RAGFGCCA.QEFAdBGAKCAAECEAbFABBDDDhABA....aDHDhAAAABIBLECAfFEEhABACDHA..UFGA.......gGEDhACAMICA..hCAA...,1,11,-37,48
BQZFaVYKeUPdRCbfXTHSDEcGLAMWNIJgO,MAAA..IAAAOACEZAFBaACAKAFAeAHFdAHA..RCCBCBBDXBCChAFAHEFA..EFAAGCEAhBDAACEA.JDHBBDHAhAFAQGCAFFEH.UGGBfGHADDDB.hCAA......hCBA...,1,-12,-15,3
WOgUBeVbJFSDGafdLXEYMcAQHRTIKZPNC,HAAARAAAKADCZAFBCADB..OAEDBAHA...eAGBJCCB.DAIBGCGAhAAAdCADEDCA..MEEBACGBTEEAhAAA..IFFAhABAPDHD..gGEAbFCD.aHAAfBEAhCAA.YFHBhCCA,1,-25,-27,2
SEDKJQbMFfXBIGCNcOHPAULgZTWeRYdVa,LAAAZAAAeACERAFFdAEA.aAGAEBHF..KBGAQCCBFCAA.BDFDhABAGDCACDHA.OEBHhABAHFAAAAHATEGAVFFADEEBhAFAMFFB...XGGA...hCAA......hCBA...,2,-14,-9,5
cRFeYIdUEAXMLPQbgTCDJOGSfHNZBVKWa,MAAALAAA.QAEATADA.DAHBGAFAHCAAZCEAKAHBaBBBhAFAREAAeDHHdCCAADFB.XDGDhAHAbEEB..CGBASGFHhABABEDA..cFFCIHHA.hBAA......hCAA...,2,-26,3,29
VbFKPXIOHBJaQGYLEAdSgCWecRZNDTUMf,dAAACAAA.eADARACAZAFBDAHB..MAIB..bABDKCAA....XBEAhADAHCGBaCEBGDCBhAEAEEFBAACA.SBHHhAIA.gEGAcFAANDDA.fFDEhBAAFFHD.OFFHBHBD.hAAA...,1,-3,-24,21
RKAOZUbcBaPYHWdXFJTSgfCEDLQNeMGVI,ZAAAUAAABADB..aADAHAEBdAGA.FAGA.SCAACBDALCFAeCGFhABAGDBA.RDDBAAIBbDDDhACA....PEHBhBAAXGBC.TGGAEGEADGBBMCIB.KHEAhBGA......hCAA...,1,-14,-19,5
XOIMcRCFGKVAgfTZHDPWYJLeNdSbQEBaU,TAAAHAAADACA.....PAECJACAeAFEdAHAQCCAhAAAEBFFaCCA.OCECMCHBREEBhAAAGEFAACIB.ZGCAYEHBhAIANDIABFEC.XGDDCHHD.KDDD..hCAA......hDAA...,2,-16,1,17
fVWHTLJKNASYIEPaMZUDGXeQRObcgBFdC,SAAAEAAA.MADAZACBGAEA.eAGBRAFAOBCC.hAAAbCEABAHB.dCBCfDDEhAAAHDFBLEDBhBCAKEBAACIBIFFAaCHDDFIB.XGEC.hBEA......hCAA...,2,-16,-11,5
YaeDIFCQUBTHWXJGcPLAbgEZKMdSNORfV,EAAAZAAAdAEA.OAGBRACA..fAFB.aAHDeAHHFCCHQCFChAAATCAAHDDAhABAXDADGEBALEHBhACAADABbEDDKFFAMDIBSFFA.NIDB.DHAAhADACHAA.BHFA...hADA...,1,5,-8,13
EWIXJHcfMUADBGLKROSgaYdTbQZNCeFVP,GAAARAAAOADAaADA.dAGAQAGAZCDA.eBDFFCHDEEBA..hAAAXCEAHEEAMFIBhACAAAAALDHBSFCHhAIATEEACGBC.PFCBIGGAfGGEhBIADIBA.KHEA....hCAA...,1,0,-13,13
RNHDOeLdgMKTAIYFSEcPQVbXfaZWJBUGC,FAAAEAAA.QADA..bACAaAFEZAFBBBHAGCCARCCB.HCGBhAAAeCFFdDAAMDABAAIBSEFDhADAVDGB.fFHAhAEAUGGBDIAAOGACLHBA....hBHA......hCAA...,2,-7,-3,4
PeUNMQVGZHAIXYgdbJcEKSfaLFOBWDCRT,XAAAdAAAJADA.KADA..aAGALAFB.BAHACBDDRBFA.eCDBhAAAMCCBGCGA.HDAAhABAADDA.gFCBhADAEDEFFDGDDDIBTGFAUGGA.......hACA......hBAA...,1,2,-36,38
ZFgIPCKHdRNfUcLYAbVaGSTMOEBQWJXDe,aAAAGAAA.MADAEADABAFAQAGA.JBFFeAGH.ZBBAFCDBhAAAIDAAKDHBHDBBRDDAUFFAhADALEEBAAIBSCHHhBAATGGA.XFCCDIBA.CHDA...hCAA......hCFA...,2,-19,-1,18
BGQJdFKbHWZRVfgNIXOUaELMTeACcSYDP,SAAADAAAGABBdAFAKADAHAFBRBGF...VCCA..fCCEhAEAIAHAOCHDhAAAECEBMDIBADAA..CEFAPFAAhABAQEEB.FGGBZFEANHAB.aGHD.eHDAhADA......hAFA...,1,-6,-16,10
dHLePZNAIUcbXfTOMVCKRaJWFYSDBQEgG,UAAAXAAAOADA..MADAKAGARBDBaAFE..FCFADAIB.EBDBdDBAhAIAHCEBLEFAZCGFAAAA.hBEA.IGDA.hBAAbGFATGEA.CGGB....YDDFhBCABFGD.....hCAA...,2,-22,-18,4
JKeXSGYHdIWRgAaDEfBMUbOQFZVPcLCNT,EAAAMAAAUADA..QADAZAFB.VAFALBCD.TDGAhAAAeBBBGDCAhAIAHDDBdFBAREEFACIBaAHDBEHAbGFA.hBFAFGGACFGD.KHDA..SHBA..hBHA......hCAA...,1,-5,-9,4
ROAGQXKPCdMBaTSVWZEYUfgHJeLDbIFNc,GAAAQAAAKADAdAFAaACE...SAHBZAEBEAGAUCGAHBGBeCDDhAAAbCDD.FDAA.RFEAAFIBCDCAMDABhAAABGDD...TFGAhACA..YHFGfGEA..hADA......hBAA...,2,-13,-8,5
JKAOVREcGXfPUMDCgTSNHLbFYZQdWBeaI,RAAAEAAAGADA..fACAMAFADBFA.CAEA...TCFAHAFBbCDDhAAAZDAAdCHABAHAeEFBhAAAaCHDKDCDACCB..OFHBhABAXEAD.gEGGNIBB.LHAAhAEA.FGGH..hAHA...,2,-7,-7,0
BbGIDLMOVCEQfAXWNPUaYHRZcgTdeKSFJ,XAAA..PAAAaADA.HADARAFFZBCBTBGAdAHA.eCCBhAFAFDFHBDHAGCEALFHBhAAAMDIBCAHBEEGFAEEBNHDB.cGAAhAGA...SGDB.IHGAhBAA...hABA...,2,-27,7,34
XBgGVcbePaHRDEdSWOQINTZACKYULMJFf,KAAALAAAMACA.FAEABAFAGAGA..VBCAeBDF.HCABEAHB.hAAAdDFA.ODHDQCFAhAIATFCAADHACEEA.UFGAhCAAXGGC........hABA......hACA...,2,-30,-9,21
SZfEFWGOTDMUKNCcLBgVAXQHbRIJPadYe,HAAARAAA.JADAdADA.eAFAZAGBECABGCDBDBIB.MBIB..KCCACEEDLEGBhAAABCEBAEEAQEFAhAAAIFAAaCCHSFHBhACAFGCA.TGAA...cGCAhAGA.....hABA...,1,-17,-20,3
OdYfDeAJZITLPcVFaSbWCKMRgBQHNEUGX,ZAAATAAALADB..VADAaAFASAHHCAGB.RBFBBCAAhABAHCACEBHFGDEAdDEADCGBhAAAACCB.IEHAhACAFDHDbFBB.MFGB.NIAB.XGGA...hADA......hAIA...,1,-6,-18,12
AfELdcBYVZMSRGKDUeNgCWJHITXPaOFQb,EAAAdAAABADAZACB.RAEFGAGADAFAUBEA..eCAACAHA.HDDA..hACATDGAaDHDFFFBABCBLECAhAAA.VGCAhCAAMGAA.KGDB..gFGAIGHA..hCBA......hCEA...,2,-27,-12,15
BXGgeKOWVaSRUCFJTHfdbYEZIPNAMcLDQ,MAAALAAABADAGADAKAFA.OAFA.aBFDRBBBFBHD.HCFBhAFAbCAB.EECAZCGB.IFEAhABAAAHAQFDA.hACAeFGFSEHHCHHA.TFBA.fGGEhBFA..hBIA...,2,-21,-15,6
JVDHGIECXfdgFcOAPZNQBLYbaeSUTRWMK,ZAAAQAAALADBaACEeAFA.UCAARAEFMAHBKBHB...DAIBHCFBhABAECDB.XFAAhACAdDAAFDFDADIBBEED.bFCDTFGAhAAA.VGAACEHAfGGAOHEC..hAFA......hAGA...,2,-11,-1,10
ZTQYRGINCUFebaAXdPSfELOBVMHWJgDKc,dAAASAAAEADALAGBBADAHAEB.JAHBKBEAZCCFTCBA.hAAARDEBGEGACAGCeDABADGBfDAEhACAMDIB.DAIBhADAQEECIGBAFEDHaFHHOHEC.hBAA......hBCA...,1,-7,-9,2
ZVHFTMDUJeWLcKYSfaIREgXGCdObNQABP,ZAAAHAAAMACADACAeAEALAGBKAHB...SBDHaCCA.EBFFhABAGCEAdEEA.bCGDAAIBBDHAhBFAFFAAUGGAJFHB..hAAA...cGCBfGFA...hAFA......hCAA...,2,-25,-11,14
aZXdMVETOJDQfgCFeUHKYSRbPGBcALINW,LAAA..IAAAaADDdAFAEAHBTACA.DAEAQCAAhABACAGA.eCGFHBEAhACASDDARDDBGDGAAAIBhCAAZEGBMCCBOFBAfGDE...hACA......hAIA...,1,-14,-20,6
KbUSMFcGNRfPJLgDQadHCIWXYAZeTEOVB,eAAAEAAABACAKADAUAFAFAEA..GAGARCCA..JCHBLCCAhAAA.QEBAhAIAHEEBCAHA.XDFDAAAA.hCAAZFEA...........hCBA......hCCA...,2,-41,-16,25
EQDLNPUHgFXZWTVBaOCfbKSAcIJReYGMd,JAAARAAAeADEGADA..EAGELAFAUCCAHCFAFCCHZCFB..TEGAhAAAaCHD.CEBDKFCAAAGA.hADA.IFDAdFEAQGGBhABADFHB.NIAB.PHDA....hBAA......hCAA...,2,-28,1,29
UXOCTMdHQKSFaBWAIbRDNVGcfEPZYgeJL,RAAADAAAGADAEACA.ZAFAeAEALCGB.OCCBMAIBHCCA.hAAAQCFCFDABaDEDAAGA.hABAbECC..VGDAfEGAhAFA.PFHDgGGBJHBACBBD..hADA......hAIA...,2,-10,0,10
dgKabLBSWUeMcXJOVAPTRNICZfDFQGEHY,RAAACAAAZACAFADAGAFAHAGBdCCA..KAHBLDABBCCA.SAEEhAAAeCEBMDHBJDFB.AAIB.TGFAhAAA..fDHAhADAEHAAaEEH.bEDD.UGGA....hCAA......hCBA...,2,-19,-12,7
CWQdGRXTbEANgUZBMfSJaPOeHDIYVFKLc,UAAAZAAAMACA..SADAaAEE.eAFHHAGBDAHBICEAhABAFCDBLDABCCCDdDGDREEB.hADA.TDFAAAIBBGHAfEEEhAEAOHFC.KCHB.QGGAhAIA......hBAA...,2,-22,-17,5
PXDMAgdEHCVFfILBGKSNUaJTQZOcRYWbe,EAAAHAAAFACDLADB.GAFASAEAaAHFQCABhAAAZAGBRCDB.bDCAeCHH.DEAAhAAAAAFBdDHAfFAAhAEAKFGDJHBA.TFCA.OFFB....hAFA......hBIA...,2,-19,7,26
SWFTfQJdKaVHcZDMOgeBRANXGUIbLPYEC,GAAAUAAALADAEADACAFA.FAHB..TBGAQCDA.dCGDhAEAaCDAHEFAZDDAMDABhAAAeDCBAEHAXEGD.hAFAbGDCSFDH.fGHAhBAAKHAADIEABAHB.IHHAhACA..,1,1,-19,20
VGSNPRdTgIcMCAXOfWLKBFYJbQZEeDHaU,OAAALAAAFADDJAEAZAEB..EBDFHAGBUCAAGDEB.SBBDhAIARCFAdEDA.TFGAhBAAgFEH.MEIBhABAADDBfGBABAHB.YFFFeFCDaGHHhACA......hCFA...,1,-5,-17,12
RTXgQYSPWJHLIKfMOcFdGBZUaVADCbENe,CAAAEAAARACA.....TACAQAFC.SAHBPAEAHBFChAAALCABfCCEhAIAMCCBFCGDGDFAZDDBaDHDhAAAACEBbFDDeFEH.XGFDYFHB..hBIA......hCAA...,1,-5,-8,3
dQYVZSTLHUFfWGRNOgKCXJIaADebPEMBc,eAAAEAAABACAdAEAQAGAZADBLAGBHBCBFBFB.GCFA.REBBODHDhAAACCCCJDHB.AEEBDFFBhABAMEEB....cGAChAGASFFB..fGHEhBEANIAB.KHDAIHHAhAAA...,1,13,-41,54
ASPRFLfKaegJQNVCEGBITWXdHcYMUZObD,RAAALAAAKADC.eADHQAFACAFA.ECCAGAGA.TCAAhABAdBHAHCEBMCFBZEGBDDEBhACAAAAAFEDHaDGH..gFAAhAFANIABBGFC.XFGA....hAIA......hBIA...,2,-16,-15,1
ORYLgfdTGPUEBMVWNXACKbHZeQJcDaSFI,KAAAHAAAeACEQADCDAFA.aAFAFAHDRBFBLCHBdCCAGBFAECABBDBChAAAMCCB..VEDBhBDAXDDA.AAIBZGFAhAAASDHH.OFCH...fGGAhCAA..hCBA...,2,-29,6,35
DOZEYAXGceaHMKfLbRVBSPQIFWTgUCdJN,GAAAeAAAHADAMADALAGBRAFABCDA.QCCCFCFH.TEEAhAAACCHAdEHADDCBEDHFAAIB.aFAAhABAKEED..VGCASFGDhAAAIGGA....WHCA..hACA......hAIA...,2,-35,11,46
UBVeAPOdgIaCSWLQJRKDFGNHYETZfbXcM,dAAAaAAA.SADALADARAGFFAGAHCCA.EDFFZABB...bBFDMBBBhAEABCEAACEAOCHDhAFA.CFGA.QDCDhAEADEEBNIAB.TFFAXGFC.....hBAA......hCDA...,2,-30,-2,28
TPWQEgVOZdALXYSIbGFCNJMfecURaBHDK,LAAASAAAGADACADA.MAFAeAEHRBFFHCAAKAGA..TCFAhAAAQEFB.EFBAhABAOCCBABHAIGHAhACAbDADFDHDfHDBaEEBDDABgFFB.hBFAdHCB.....hCAA...,1,-4,-7,3
ELTRUGXgfDBMdNHabSPFVQIOYZAWcJKCe,JAAAeAAALADBRADAGAGA....XAFADCCBdDDAHEAB.hAFAbDEDFCFB.QDGAhAGAODHDAAAAKGDDEDCBTFFAhAIAfGHEMEEB.NIBB......hAEA......hAGA...,2,-14,-9,5
AEXILTNFGRSbfJHQKPBdCgaZcYUOVDWeM,EAAALAAAFACD.RADF..SAFBJAEAHBDBQCFCBAHAdCAAaCCHhABAZEFE.UGGADCFBeCGFhACAAAHA..IHCAhAAAGEGAKEEDCBHA.YHAA....hAHA......hCIA...,2,-16,-16,0
XQdJVIUfMOKGHcaENYLDFSeWPATCRZgbB,RAAAZAAABADBdAEA..JAGBUAFA..MAIBGCCAHCAAECHFLDEAhABAFEFB.eEBFAAAACAHA.XEGAhACA.QFDAhADAfEHAKGGAaFBBDGAB..SFDHhBFA....hCAA...,2,-38,1,39
JMfGgCWPVHNKDSERabLedFXUAOZYQIcTB,ZAAAQAAA..TAEAMADAGAGACAGB.VBDBHCAADDBBhAAARCEAbEAAeDFF.dFHAXEEAhABAAAIBOFBCIEHAhACABGFA.JHCA.fGHA..hADA......hAEA...,2,-16,-9,7
AICfacNbSGYRZVBHedLOXETQWDgJKFPMU,CAAAaAAA......bACAGACAZAFBHCAAeAEAdBHALBHBhAEA.ECEATECAQDFAhAFADACAKEECMBBBACCAfEGAhAAASEED.YFHBBFHAOHCAhAIAWHCA.....hAIA...,1,-13,-17,4
XTZGLedYaIVOfQPSHMBUDbWNcJRFCAKgE,EAAAZAAAeACEdADA..aAFAOAFA.QBFDHBEBMAIBDBIBbCBDhAAA....cCCChABARDGBABCAXEECGDFALEHBhCAAIGBAfGGEBECDWFED.FHCEhBGA......hCAA...,2,-8,-7,1
UJbWMNHEeDTXgdSRZcLBVGaFYPfOQKCAI,UAAAJAAA.MADAHADB.EAFAeAFA.DBDBTBGA..dCEARDAAZDFAhADALCGBGFABaEBAhBAAFFFA...fGHAhAFAQGDAAAIB.IGGA.NBIA.SGDAhBAA..hCAA...,2,-23,-8,15
QOIXgZTNUELJVdMebABcCKSGHYDWafFPR,CAAAGAAAHACADAEAaADAFAGA..RAGB..QCAAXBFDZCDBUDDAhAAAEDCFLEGB.hAAAdGCAeCHHAAIBBCFBSEGDhACA.fFEA.OFHDhBAAgFEA.NEIA.hACA...,2,-23,-6,17
UBfDHIWOgMcKFJYdVXNZCPTRGAESeLbQa,EAAAeAAALADAQADABAHAHAFA.OCCBMBCBFCFAdCHAXDEAhAAAZDCBCDHA.RFDAAAHAaEABhAAADFHB...WFHHhABAKEEAVFGB.PHAASHDA..hCAAfGEA.hCBA...,2,-16,-6,10
GeaWcOIJAEfMVdHPYCXZLBNbDSQgTURKF,EAAAMAAAHACA.CAFBZAGBLAEA.bBBBQCCB.TEAAhAAARCFAGDCA.eEEGhAFAaCEDOCHDAAIBdEHAXGAAhAGADEGBSFFDKGGD.FGCA.IHHAhAEA....hBIA...,2,-10,-4,6
cWYMFaJLONHBRQCTVdIGeEfPgUZAKXDbS,DAAASAAA....cABDMADAaAFELAEAHBCARCEATCDAhAFAdCHAeEBA.EEFFhAAAfBHAUGGAAAIB.hABAbCFD.FDCH.ODHFBHFC.QGAAhAGA.CFEDIGGAhAIA..,1,-5,-10,5
RJBdZPCNVagEebIHTUfcLDXOKFAGWSQYM,GAAAQAAARADAdAGAZACB.CAEA.aBHD..EAGAeCDBHCEAUEABLCHBhAAAODFBAECASECAhAGAMEHBBGDA.PFFBhBCA..NEIA.gGCA.IHHAhBIAfGFA.DIAAhAAA...,2,-20,0,20
KPAJMcHYQGTCINLUXgRSbBefDEWFVdZaO,MAAAHAAAGADA.TAFACADALAFAXCAARBBBBCFA.eCGHhAGAEBHFFDFBZECBaEFHKDHBAACAhAAA.JFAA.QFGChAFAIFHA.NHABSDDDDCIB..WHAGhAHA.....hAHA...,2,-27,5,32
VeLGOBAbfQFacPZJSEDCKXNITYWHRdMgU,QAAAaAAAZACB.EACAKAEA...XAGBTAEAHAGB.hBAARCDBdDFAMBBBVFGBeBHHhCAAGGABACEAFCFDPEDBhCCADDCBCHEA...IFFA...YEHBhDAA.WHFGhDEA...,1,7,-32,39
fKWFSVUNGaHCdRTDXZLEYbOMAQecgPIBJ,eAAA..gAAABADAKAFAFBHDSADAUCCA.aAFDHCFBhAAARBGFTCCAZFAALFDBhABAEDABODFBAAHA.QECBhAAAIFHAJFFFfEHA.NHABdGGDhABA.DIAA....hADA...,2,-17,-1,16
bcWDCMUHQNGeaBgZYKfdXEVFOPTLRJAIS,SAAA..bAAADADAMAEAHAECGBDAeAHHaBCDZAFEfCAAhAAAECEBFDGH.TCGAhABARFCAAAAA..IGGAhAHACEGDQFEDNDIA.BFHA.KGCB..hACA......hCAA...,1,-10,-11,1
fGZaRBSOAYWHLPEbXgQCMJVcUNdFeDTIK,HAAAEAAA.XADBQACAMAGBJAEEUCABdBHADCCBKAHB..ZDCBRCFBODDBhAAAABFBLDHB.hAIA.bFEACEEAVGEA.hCAAFHAAeFCD..IEGAaGHD...hCBA......hCFA...,1,1,-10,11
XBZeLfVHEbcQUIRCWDKYPaTGFJNgMdAOS,XAAAeAAALAEAHADA.EBCFQAGC.RCDADCIBKBHBaCEAhAAAGDAAFDDAJDGBMDHBAAFABFHAhABAZEFFfDCEhAAA...........hAIA......hCAA...,1,5,-34,39
ABLCKJOGUcIZFDHeTMbWPQfdVaXEgSRNY,LAAAKAAAGACAUAEAZAEAHCABeAHBMCAA..bCFA.QEDAhAAAdDDAaCFE.EEHBREBBAEGAhABACAHB.OEHDFFAHTGCAhACA..fFEAXFFDSHGAhAFABGFA....hAGA...,2,-14,5,19
YNAEcgMHXFWaBTVQIdUPfJODRZCSKLGbe,EAAAMAAAHACAFADDBAFAQAFC.dAHAUCFAJCCF.RBBBZEDA..hAFAKDGALAHBeEABAEEAXFDAhAAAaEHD.TGGAhAEAIHBA.OHFADIDA....hBAA......hBBA...,1,-1,-29,28
GORWfANTZbLIHdCDUeKFYQPVaXBMEJcSg,ZAAALAAAHAEAdAHADAEAeAFAFCAA..QCEBaBCEBBHAECABSDADhABA.GDGAhACARCDAADHATEFACDDDKFFDVGAAhADAMEIB..JFEF...gGCDhABA.fHGBhACANIDB...,1,5,-23,28
gTKFWaBQSHZUbdGMXIDJefOEAYCNPLVcR,CAAALAAARACA.TAEAFAFABBHA.HCAAZAGBdCAAGCEAMBIBDDGAhAAAeCCB.ECEBAACA..hABA.PEEBVECBKEHBhAIAaEAEQGAA.bGFAXGFAhCAA......hCCA...,2,-25,12,37
XPDfOQdAFaJVBIZeKENYGMcgLHTRSbWCU,aAAABAAAZACBEACA.GAEAMAFA.LAGBHBEARDEA...SCAAhAAAbEBB.CDCAXDGAhACAfEHAdFFAABBBFGFBhBAAIGBAeHBA.KEDB.YHFG..hAIA......hBEA...,1,-5,-18,13
DefgZUKbOHLIEBQaYNVTGRFSMPWAJXcCd,XAAAdAAAeADAZABBKADA.HAGBLAFBBCEAQDCD.hAAAaDFDVDAA.RCGFMEEBhABAAAIBCDHADEABfAHEhADA.bFCDEFGATFFAGGBBSFHHhAIA.....hAEA...,1,2,-12,14
NgbFHSGBeUAXOcLZVWTPMdDKEYIQfaCRJ,OAAAZAAA..TAEAdAEAEAGA..QAGCaBBC.RCAAJCEFhABAbCDAHDBAGDGAeBHFhAGAAACALEAAVFEAMDIBhBAAKGDA...IHHANIABSGGD..hAEA......hAIA...,1,3,-10,13
aLYXGPKQZJcCAReUFTfdbgVNMSDWIEBOH,RAAAeAAAFADA.dAEA...VAGBMAGB.DAHBEBCAHCCALDDAGDGAhAAAQEGAZECACGEDAAIB.hABATFDA.bGACSGGDhCAABGGD........hCCA......hCEA...,2,-23,-5,18
HXeYNfJICcBFagQMGOUDWSPAKZLRbTEdV,ZAAARAAAEADEHAEA.eAHH..fAFBCCAAFCCH.aAHDMCGBGCCAhAAADACA.SCFBhABAAAGALEEBdDHA.XFDDhAHAYDHBIFFABFDAOHEEWHEA..hABA......hCAA...,2,-21,-1,20
aQRABGCeLDXHKNFbTJZOMWIgEVdfPcYSU,GAAAeAAALAEAHADAFAGAJBCBZCDA.MCFA..ICFAhAAAEDHBdEEA...fBHAhABAcFAA.SDEDhAFAaFHHAAABDGGB.KDHB.bECD.TFGA.gGADhAGA..hAIA...,1,-7,-20,13
EdeZUgLWTfSbNBYFKCIJGaHORPQcXMDAV,EAAAeAAAZACBLAEA..TAEASAHHBAGBKBHBCBCAGCDAhAAAHCECRECAQDFChABAMCBBAECAdEHAgFAAhAFA.bFCDFGFBaEHD.OHFA...hAAA......hAIA...,2,-16,12,28
CPHVOYfBTLZAgNMDFaEbSeWRXUKGcdQJI,MAAAaAAA..EADAeACARAFA.KAFAdCCA.QCFBCAHBHCCA.OBBHhADABBBDZCFB.ACEADCIBhBAAbECA.SDHDhCAAUGAAGEGAJFEF..IGGA....hDAA......hDBA...,2,-27,-2,25
MfLEJYVDOFdecNTQZWURgIbBHAPXCKGaS,CAAAaAAA..MACAEADA...JAFBDAGA.dBFAeAHB..TCCAhADAZBCBRCGB.IBHAHECCABCBKFGDhAAAGDGA.LECAhBAAOFHDFGEDQGEA....hBBA......hCAA...,2,-20,-16,4
PIbUWKeHDTQcaMXYgJFZEdCOVSRfANBLG,LAAAGAAA..bADAKAEA.HAGBDADAQCDAaCAAMCEB.XBGDhAAAJCFFZEAAEDHFdEGAODCBhACARGAA.AAHABFDAhBAAIGGAeFFD........hBCA......hBIA...,2,-13,-9,4
JQOIBeEASHZfMCgcYVGTWLUaFKNRbDdXP,HAAAZAAAMACACADB......gAEHVAFAGBDATBGAhAAALDGBaCACKDCARFCBdFFChABAXDFC.QFGAhACABHHAACCB.fGDA.cGFChAHA.....hAIA...,1,-2,-23,21
eMXdKLbBOgfUYDWVcQENAHFRJGPSCZTIa,HAAARAAAGADACADBZAEB..aAFAeAGF.dCADLBFBOAHDUECAhAAADAIBVDAA..EDHBAAAAFCHHhADASEFBMFDAKFGAhCAABFHD...YFFF...hCCA......hDAA...,1,-10,-18,8
ARSLFOBgKWUQIMPCDJZYVGNTXfHbaEedc,RAAALAAABADBKAFAQAEA.MAHBDAIBZCCAGCAA.TCCAhABAHCGBEECA.eFABhAAAAAIBOCHDUFGBCGCAVEEAhACA.fFDEaCEA.dGHA.FGBDWFFDhABA.....hAEA...,2,-22,2,24
RZYCBIGNKHbJdUWcPSQefDLTXEOMaAFVg,FAAARAAAZADBBADAGAFAHAEBdBHAUBGA....PDABeCCBLDABhADAEDCB.aEDDAAAAVEEBhADACEHA..KFFAbFBDhAHAJHAA...SGHHDEHB.OHEAhAGAMEIB.....hAIA...,2,-14,-9,5
aPRBUKNQbLSJMgHCFXefdDTWZEcYGOIVA,RAAAKAAAQADCLACBMAEAHAFBFAHF.eCCBdBEADAIBZDGBEEEAGBGAhAAA.OECAAAAAaFAABGFDhAFAUFGB..bGBA.hCAA............hDAA......hDBA...,1,-10,-20,10
LWFAUCZcDVeHBXgbPfMGNQKRaSJEYOITd,ZAAADAAAHABCBADB...XAEB..bAEDMAHBGAGAQCCBhAIARCAAaDHD.ECFFOECAhABAdEEDLEHBhBAAAAGBCFFA.eFGF.fGBASGED.IGHAhACA...hBGA...,2,-23,-12,11
MDYZKVNCLFUOXEeJSAbQHfRaIgTWGcPdB,HAAARAAA.aACATAEAGAEAdAGADAGAZCCAKBGCCCHA.LCCB.OCHDhAAAEDABeDFH.AAAAQECAhADAfEEEgGDBhCAAPEHBMIAA...NIEB.XGGAhDAA....hDBA...,2,-12,-3,9
IHRMFWPCEXBAZLdaGNKQSeJUbDfTOVYgc,dAAAGAAAQADAeADAUBGADAGA..OBFAVCDB.....hAAAgCAAHEACREGBMFFBhACAFCFDCCHAEGCABDCAAADAaGGHhAHASEDH.bFFA...fHEBhACA...hAIA...,2,-20,-2,18
bTBZFHaKRWOAEIfQdUMeXCgcVLSNJDGPY,EAAAQAAAdADA.eACACAFA...VAFALAHB.SBCDhAAADCDAGDAAbCEDZDDAhAAAHEGBREGFACIBfFDAhADA.MFFBXDBCNIAB.PFABhAFA.TGCAaGHD..hBDA...,2,-23,10,33
VBTYRGICEUcfPDdSQHWOJNKMLZgbaXAFe,eAAATAAARADAGAGA..EACEUCDBfAEBdEAAHDFBOAGDhAAAKFHBZGAE..aCCAAAAABHHDhAEACCFDDAIBQEEAhAGA.NDDAMDIB.bEGD....hCAA......hDAA...,2,-13,-12,1
DMSKOXLbYfTIGVWPFEJgcdAUBRCeZNHQa,RAAAeAAAHADBQADAMAFAKBFC.LAGB..bCFATCCAhAAAGDAAPDFBECCBJEEAdEHAhABAAAAABFHAZFBAaGGCOHCAhADA...fGGEWHFG...hAIA......hBFA...,1,1,-5,6
aKWCHUDcIYBLOfeJZTdFQAgSNbERVMXPG,SAAAEAAARACA.MADAGAFA.aAHFCAGAHBCADCCB...ICGAhAAALDABeCHHhABAZDDBdDHAAAIB.bFEDXDEChBEAKGGA.UFBABECAfFFAFHBA.hAAA......hADA...,2,-13,-5,8
QMEYFSefLIGcZBNUbHKXPOJaRVWCTAgDd,dAAAEAAAFACDeADA.LAHBGAEAZAGBBBFAUEAAHCAC.KDEAOCHDhAAAREAB..CECAAEHAQEDChAEAMFFA.fFGAhAGAIGDA.NIBB.XGGA.aHCC.hBEA......hBGA...,1,-13,-17,4
cSCNWGPUXaKIEYbRJLABHfgQTMDZdVOeF,HAAAQAAAMACAdAGAeACAFBDD..CAFAGAGAXCEDKCDAECHFRDAAAAIBhAAABEHA..TEEAhADAZFBAOCCH.SFFBhAAAPEHDaFCBIHHAbGDA...hCAA......hCDA...,2,-9,-8,1
KXWGYcOFMVdLUZTfCEARBIJDSNgbPQHea,RAAABAAADADA.SACA..bAEAHAEBeBHHaAGA.KBHDGCCAhAAAOCAAMCFBLDAAhAAAZFGBTGAAEDFFADIBIFGAhACAgGDAQGBA.YEEFhADA.FGHD..hBGA...,1,-7,-11,4
BYLMOgfaZWRXDVHTcbUEQKANJSCdPFGeI,SAAAdAAAGADAeAFABADALAFA.MCCAfBHAhACAZCDERCGFDDAAHCBB.bDFAhADAEEEBAAFACFDAFFHD.OGAAhAAAaFFAXGCC.cGGCKGFB...hABA......hADA...,2,-19,4,23
fTVICDBOcMHaUWAQdKYLXZbFENGSJPRge,dAAALAAAZABBEADAGADA.SAFARAFAeCEB...TCAAhABACCGAOCHDHCFAaDCDAAFAQEFBhACA.hAGAKFHBbEFDFHCA..NEEA.......hAIA......hBAA...,2,-23,-2,21
NbVTQJCZUKdceMagGYBSPDREFWHIXLOfA,VAAATAAA..QADCZACBdAFA.eAFEaAHBGDEABBFADCHBECABhAAAHDDALDGBACIBJEHB.hAAAKEBA.MBIBSFDAhAIAFGHD.XGFD.....hACA......hBEA...,2,-10,-8,2
XKeUYZdSAINQWOgPCDTHEfcaLJGBVFRbM,QAAAOAAA.CACAHADBEADA..aAFDGAGAFAHB.RDDAbFAAMBBBhBAA.eCCBZFFAAAFAIDGAhBFA..WHFGhAAADCEBTFDA.LFFBBEHA.KFHB.hAIA......hBFA...,1,-10,-12,2
dZVcSNYXKLHPJAERBgTfMQDeWUIbFCaGO,RAAATAAAMADA..DAHBeACE.UAFAFBDDGBFAZCCA..SBHBhAAAXEEDHFBBhAAAABDBEDGBBECA.QFFChAIAIEHAaCCHOEEHdGHA.NEIA....hABA......hAIA...,2,-20,-7,13
fQUNEVbMFdJROICGcZSBXWAgTPaLYDKHe,TAAAaAAALADA.KAHBHACB.eAEAQCCAEAHFMCABdCFAhAEARCEACDHAZDGBBEEDABBB.PEGBhAAAfFAA.hACAVFDBbEADOFCC.IHHASGHHhAFA.....hAEA...,1,0,-10,10
SaLYdHZcNWeRFKfODJQXTgUPCGMVIBEbA,aAAAdAAAHADAZACB...NAHA.RAEAKBBD.DAIBQCBA.TEDAhACAPCEBGGABhADAMCGB.BCFA.AAFALFGBhAIA.cGEDeCHBOEGD.hBAAXFAA.CHAA.hAFA...,2,-36,2,38
ZVYbTXNfSaAEWBJdGOFKHCUILgeMcQDPR,EAAABAAAGACAKACAHAEBCAEA.LAGB.eCAAMAGB.QDFBhAAARDDBZEAA.bEABTFGAhAAA..fAHAhAEAAAIBdGBAFGED.gFCADDIB.PEHDhAHA.YFFFhBCA...,2,-24,-8,16
FGWfEMOgceBYRHZVUdPJaTXbQSCAKDLIN,LAAAFAAAGACAEAEAMAEA..OAGDeAHFRBEFHCAA.ZCEFdDGDhBAAaCHDTEBAQEABhABAAEEBDFFA.IEDAhACA.fFGABFHAUGBBXGBACGGD.hBEAKGEB.....hBGA...,1,9,-13,22
PATGDVgUeaJBQMYfRdLSWHOIcENCbXZFK,GAAADAAAUADAeADABAFAMAHB..RAGFLBBBHCDAOCHD.hAIAEDCBCDDAZDFAKEADAAAB.TEFAhACA..aFFAQFCBhADAdGDA.SGBDIHHA..hAEA......hAIA...,1,-1,-40,39
OGBTUKZaAgWYdeFfLJcHPbQDXNCMSRVEI,....gAAAdAAAeADALAHBHADAbAGB.QCBAhACA.XBEAMBIBRCCBECEAhAAAGDDATDAAZEAFAADAhBAAFDGHfFGAPFABCFEASFHHhABAOFHDKHCAaGFH....hBCA...,1,16,-3,19
UPJdRLQAbKNaDfOCTFHXeEGZcBVMgYISW,KAAAaAAA.OACAFADAHAFB..EAFAZBBABAHAMAIB...IDBAhAHASBCH.PCEAhAAARDDAADHBDEIB.TFFAhBAAeCHFGEDA.gFFBYHBAWHFAhBDA....hBHA...,2,-23,-20,3
UdLgBRZeXfDcKIEJPFSNCVYTHbGMQAaWO,aAAAOAAALADARADAZAGB...eAGHDBBBKCCAEBBBFCEB..CCFC.TDGAhAEAHEAAGEEAhAEA.ABIBdEHAXDCDhAFA.fFEAIHHASGAAhAGAVGFAMAIB......hBAA...,1,0,-21,21
RWYZGNLcXQVKfPSUAECHMgBFeJTOdaIDb,HAAAMAAAFADDeACE.TAGAdAFADAHB..RCCAZCFFGBBALDHBhAAAQDEAfEEAhAFASBHHEGAABGGDaEDH.hAIAIHEA..bFGD...YFBFhBAA.cGEBhBBA...,1,8,-29,37
OYVNMfPDWCedcBHbQSTaJLXGgFKRAIEUZ,EAAAZAAAOACA..VACAMAGBDAFAeAHBdBGAHCEB.QEGAhAAAaBEDLECAGGCBhAIAKDGAACCBIHHAhBIAUFGAfHCBCCCDBEDD.......hCAA......hCBA...,1,-10,-20,10
LdIHFGUCQcMagERWbfSeYJVPNKZDXOTAB,dAAAHAAAGADAQADCaAFA.RAFF..bCACeAHH.JCBB..PBHDhAAAZDEBODDHAAHALDEBhACAFDHDCFBA.MEHBEGFA.hACASFAA..NDAADGIBBGFA..hAFA......hCCA...,2,-9,-3,6
aKCGJOEVABUDSePdQFXYIcHLMbfZWTNRg,DAAAeAAAdADAQADAFAFA...XAFAIBBAHCCALBFAhAIAbCFDZFEA.TGAAhAAARDBAaDFA.CDHA.GEDBhBAAEHDAAAIBSGHH..cGEC.hABAMDIB.fGGBhBDA.,2,-33,16,49
KaIdZfQMULTECXSgJbGYHWeRPFBNOADcV,DAAAKAAAdACAZABE..MAFALAEA.EBHFSBDA.JBGBhADAGCDA.HDFBhAAARDDBBCCDAAFAaEHDQFGAhBAATGCACCFC.XGBAYHEGeHEE..hBGA......hBIA...,2,-26,-13,13
abMAHDFPYgSfZJNCIKBQVUXLcedTWGOER,HAAAFAAA...gADBZACBCAEABAGAQAGAUCEA.LCAAhAAAeAHH.dDEAGEGAhAGARDGBbFAAAAFADDIB..SFGDhACAJEDF.NIBB.KGFD.....hBIA......hCCA...,1,1,-37,38
gHNAPfRdbTDLCOWMQBGJUVEZKYSXecIFa,RAAAdAAADADALADA.OAGDMAGBGBDAUCCAZDFAKAHB..SEABhACAeCCDFCHHHFBAhAAAAAIB...bFEDTFCAhAEAQGGABFFAEFHB..YHAAhABA.....hAFA...,1,0,-27,27
KUAQIZDVdbCHNPBJMESfYGOcgaRLTXWeF,ZAAAdAAAHADABADBEAFASAFE.GCABOAHD..aAHDRCAATCEAhABAeCFBKDHBACAADDHBhACAbEED....CGCA.PECBhAFAfGGB..gEEAhBHA.XGGA.hACA...,2,-19,-14,5
cSLJfYFBgZabOPUWGRVCeEQHAKNTDMIXd,TAAAMAAAdAEA.LAGBJACA..FAFAZBBBOAHDUDDAREGBeCCAhAAAHGBA.AAIB.DCGB.XDEDhCAASGEBBDHDhCCAaGGH..bFGD........hCDA......hDAA...,2,-26,-15,11
KONAdWSMFfLTeBEZUGIYcQHJXRgVDCabP,dAAAMAAALADABADAZAEBGAGA..IAHAQCBAHBBAhBAARDDFDDGBCBGD.aDHDKCHBAAEAFFCHhACAeDDB.UFFAJFFF.hAIA............hBAA......hBCA...,1,-14,-29,15
OaFNKULRYIeVHQACZDBGEXWMSbTdgPfcJ,ZAAAGAAAEADE.MADA..TAGAdAHA..fBFAOCABaCCChABAKCDBRCEF.eDBHHDGBAAABBDFAhACASECB.hBCAbFADgDGHJGEANIDB.LFFA.hACAIHBACGCD..hBDA...,1,12,-21,33
QVKBAbOUHIJMLPFdWECgXfRYGaTecNDSZ,OAAAHAAAMACALAEAdAGAEBDACBBD...XCCCRCDAGCGAeBHHhAAADAIBZDBFQDEAhAIABEFDAAFAUGGBIFCA.hBAAFEHD.fGBEaGCE.TGEA.hBDA......hCAA...,2,-20,14,34
OJBRNWPdcXHKZGDIYeQULgCEaVTFMbfSA,BAAARAAA....PADAdACAHAEAGAGADAGAeBHFLCCAECBB.hAAAaDEEFCFD..bECCADDAODHDhAEA.JECBcEGDhAAAZFFF.QGBBCHHBMEEB.SGFDhABA....hAIA...,2,-14,-13,1
KbNIdUYgeLXBESDZVHJcGPaTQAMOCFfRW,MAAAFAAARACF.KADA....IAFAdAFAUCBA.eAHBLAHBhAEAECGF.ZBEEHDDBGDEAhBAAaEHBABBAfDGEhCAA.NEIA.XGFCDGGB......hAIA......hBAA...,2,-25,-15,10
gPGEbNQHcCZDFOaWURKTBLJXVAYIeMSdf,eAAAdAAA....fADAGADAEAFAQAFAHBGBZDBBODEDhAAAaBHDRCAA.TGCAhABALCEBXEGAADEBMDGBhACASFADbEGD.CGGADAIBFFAAKHBA..hADA......hAFA...,1,8,-10,18
XPOYERGDeJFVNTMIgACfQcaHKbSULZBdW,QAAAHAAASACEZACBdAFA..XAEDOAHBRDEAeAGBFEBA.hAAATCCAMCIBAFBBfDFAhAAAKFDA.bEGDLHFAhAIABAHBPFDBEGGA.DCIB....hCAA......hCCA...,2,-9,-7,2
aEPWXHIbRONVFgSdMKBQJTecZLfAYDUCG,DAAAGAAAEACA...XADAHAEARCCAOAHDFAGAdCDABBGD.QDFAhAAAeCFHZEGBAAGACDHA.hACAaBBC..IFDAhADANEEA.SEAAMFIB.TGGA.hBAA......hCAA...,2,-18,-12,6
XbKTVcAYJQBWLFEdGCUMISPNOgDfRaHeZ,QAAALAAAEAEAGACBUBGA.MAFA.SBFAOCAADCEAhABARDAAHDDBeDDBZDFAbCFAKEHDhAAATEAAADAA.BFFAhACAdGFACHHA..IGHA.PHAA.hADAfHFB.hBIA...,1,3,-7,10
acfNTBLGUdQRMebAPWIJEOHXVYSZFKgDC,..IAAAEAAAHACA.XAFBSACAZBGBKCCDCAFA..aAGDfDEAhAAABCAAGCCAhACAdEAARECBeBHHACIB.PCFBhADAOEHDFEHDDFFATFAA.QGFChAFAMIAA.....hAEA...,1,-1,-7,6
CaebIYUHPgOfADQKGSRZcMWdJBEVXTFLN,QAAAGAAARADAZAGBMADAdCDDBDHA..EAGA.TBDALEAAhAAAaBGE.eEEB.bGAAhACAIDBA.HDDChAAAOEGBADGASDHH.cFBAhBCA.VGFAFHGE.CHED..hADA...,1,8,-10,18
VcHIDGOFZPRNBbUYaJLAfdWCQegXTSEMK,dAAAQAAAeADA..TAGAEACAMAFAKCBAHCEAGBDAZDAARBFABDCDhAAAUEEB.aDFEACIBCEHASDHHhBFA.IFFAhBGAFGCBPHEA..NIBB......hACA......hADA...,2,-13,-3,10
WaYVMIDKegUTFPfXCOASdbcBLGJQHZENR,dAAABAAAGADAHACAEAFERAFA..aCAEMAIBKCGA.eCAB.UCCBTEFAhACAFCFA...XDBAhADAADFBbEFA.LEHBhAFAZGEANEAA.VFDB.DGAA......hAGA......hAIA...,2,-7,-7,0
UCOLgXHbfKVaMWGEcZFYSJNBITeQADdRP,RAAACAAALACAHADBKAFA..MAIBEAGAZBFE.FCCASCCD.hAAABCFAeDABAAAAdDAAODEEhADAXCGDVFFAGGABhAEAJEEB..TGFADDIB...gFAAhADAaHDE.YHAGhAFA.,2,-25,-4,21
MZANLeGSbHWFTfIEKXVgRBUQPODdJCcYa,eAAAGAAAHADAFADA.TBGAEAGA..XBGARCCBQDGB.hAAADAFAdCDACCEA.aCFCAAAALFEBhAIAbDBD.fGGAhBIAKEFABEHBOFEB.cGAC.hCAA......hCBA...,2,-9,-8,1
JQVWgAEdIRKOGaCBeTfLbMDUHFSPNYcZX,EAAARAAAGADABACA.eAFALAEA.MAIBHCFA.SCCDhAAA.PDABcCCAhAAAZEFAQCFAhAFAVGAAAEHAdGGAOECB.aEFC.TGGA.DEIBhAGA.FHDA....hCAA...,2,-18,9,27
SWGCOXERABdFUZeLcDTINfPJaVQYMKgbH,dAAAZAAAeACELADADAFA...TBGA..fAHAhABAaCAEQCECMBGBbCCAHDCBhACAGDGAXEABACIBFECAhCAAIEGAJFFF.KFFD.SEHHhAEA.OFAH.BHHAhAFA.NIBB,1,-4,-20,16
KSDFbAWNUOTeCGcfMBgLYEPJHaRQVZIdX,UAAAeAAAGADAMADALAHBEAFAHBGBRBDA.ZDBB.dEFAKDBAFEHDABDA.OFAHhAAA..TDFAhBAAfFDABBGB..hABAPEEB.aFHBIHHADFDB.NIBB..hBCA......hDAA...,2,-29,8,37
MXWcAeILadBYZJRDGfCFgPKTHONUESVQb,eAAAaAAABADAZADBRAFAGAEA..FCFHKAGAHDBAUDAAECHB.QEGDhAAAMCHB.XGAAhABAABBBdCCADCIB.CEDA..hAGA..TFFASFFDVGAA....hAIA..cGDAIHHAhBDA..,1,2,-29,31
bIPSBOMDZWVTUARHCLdQacfJeKGYgNFXE,HAAAdAAAaADAJADA.GAGA..NAGAFAHBECAB.....IBDAhACABCCAMCEB.ZDEBhAAATCBARFCBLFHBhACAQEDAfGAAeCHFKFCDgGFAhAGAbFFDOEHD....hBAA...,1,6,-22,28
eHGaUNKfMFDSCAcVEQTRYbILOBPJZXgdW,EAAARAAA....bADBLADA.BAHAZAFBdBHAHCBAaCCBKCFAMDDBhAAASCHB.hABAAAEAQECAhAAATEEAOEGDXEFAeFBBNEIADFIBCGED.cGEB.hAIAIHAA..hAHA...,2,-27,-3,24
UFGDcVbBdHWEKXRCfIYaQPTSJeZOMANLg,LAAAFAAAGACADAEA..VAEAdAHAHBCCKBHB.RCABCBGC..IDFAhAEAaDDC..TDGAhABAeDGHMEEB.AAHA.hBAAgFBA.bFDDEFHF.YFFFhCAAQFFC...hCBA...,1,-6,-24,18
CTeLBMRgHXUKJZVNEFGScbPaWQDfYOdIA,eAAAMAAAHACCKADAZAFBEAFEGCCA..bBFAaAHD..QCCChAHADDHBOEFBABBBTDFAhAIARFABUGGA.VFDA.SGHBhBAA.WHDA.....hAAA......hABA...,2,-23,10,33
WLaHcNRdKUfVSgFIJDPZBbATeXECGYMOQ,eAAAEAAAGACAMAEA.QAEALBDAHBGBRAGBdDFA.KCCDUEAASDEBhAAAFDHDDEEBBCBDhAAAAAIBTFBACGGA...OEEHhABA.aFHBNIAB.fGFA..hBEA......hBFA...,2,-12,-11,1
EQZTUWBdJfOeVYSCIHDNFbaRXGgPcAKLM,MAAAEAAAZACBUAEABAEA..dAHAOAFD..eBBASAHBhAAAHDDAFDGARCGFGDEAhBCA..gFDAhBAAACEBLHBATGFAfGGACGBADFIB....hBHA......hCAA...,1,-16,-18,2
ASPKJMeNHLbFWBUacIfZGQDXVdREgTOCY,KAAAeAAAHACBLAEAFAEABAHAaAHD....ICCAGCAAQCFAhAAAXCEARDGFEDBBhAAATEDA.CCHAACABSECHhABAMEIB.bEEDcFCCZFAFDEEB..dFGAhACA.OHAC..hAHA...,2,-12,5,17
gBdOaNeMKXRTFbJDEACUHGcYSQWfLZIPV,HAAAGAAASACEQADALAFAZAFBIBHAPCCABCDDhAAAaCFD.eDADMCHBRDFATFGAhACAbFDA..EFHFAEEB.hADACEEDUGAAcFBD.YFFF...hAAA......hAGA...,2,-2,9,11
IAgTHBeVaXObKMELDdGJRcUSYZCNfWPFQ,HAAAeAAA.aACAOADCMAFA.EAGELBFA.GCCARCCASCFBhAAAZEFAfGBAhAAAFCHBACCATEEAXFDDbFAAdFHAhABAcGGA..CGGCNIABWHDA....hBGA......hBHA...,2,-2,1,3
DKaNHASGZCFbeMUBROWTEdLfgXcVIPJYQ,ZAAAFAAAeACHMACARAEA..OAEA.EAHFdAHA.LDDA.hBAAXDGDIBEAJECFhABAQCFDKFFD.hCAAHDDBACCBCGHABHGDTFGA.fGEAhCAA......hCBA...,2,-24,-23,1
WMRKEdCIbBASeTJYQONgXfVUaGDZFHPLc,eAAATAAAQADA.OAFCXACBUCGAGAEAZCCAHFFAhAAALAGBMEEBEHAAhABAdDDAbEBBAAHA.SDGAhAAAYHFG.fFFAaGDH.FGHB..hAIA......hBEA...,1,10,-8,18
ACVYTNDIcFbWJOPRBKXQLMZfaGdeEgHSU,CAAATAAADACA..FAEDJACA..RAGB.KAFCLBCBZBEEGCCA.ECHFhAAAHCFB.AAIB.VEFBhAIA..IFDAhAAA..bFDDODHDBHHA.MFFB.dGAA.hBIASGGB.hCAA...,2,-26,-15,11
KYQUJMXPZFSBVcdWHfOCNETLIDgeAbGaR,aAAARAAAQADC.UAFAMADA.ZAEEBAHAdBBDHCDCCCCD.EBHFhAIATDEALEEADCIBAAAAhCAAGGCB.KGGCXDGDhDAA.SEDD.cGDDhDBA...fGGAhDEA,1,-21,-25,4
EgVKRHUJYAcSCGIaQNFBMWeTODZbfPXLd,CAAAaAAAFACABADA..eAEHDAFAZAFE....bAFDXBBChADA.ECDFKAHB.HCBBhAAAUCGAACBBGEEAQEEChBAAMDIBTGGAfGHEdFDC....hAHA......hBCA...,2,-24,-15,9
aQACSDdELcNMGebFTJgBHXUIWYPRZKfVO,DAAAEAAALADAMADAGAGAeAGH..FBBATCBABBEAHDDA.hAAAUFDBIDEA.hAIAPCHDKEBBOEHDhBAAAAEAdFCAbEFDXGFD..WHFA...hBEA......hBGA...,2,-20,-5,15
XORINUfMHaZbWcDSGTdgCLJYEBeVKQAFP,XAAARAAAUADAHAFAZACB.....bCCCDAFA.GBEAdCHALDGDhAAAEAHFeCHFKEEBAAAAOEBAhBEA..fGHAhABAaEFDSEHHCHAABHFAQGBAhBGA.IHHA.hAHA...,1,-4,-19,15
WEAXDGcaCTBPNLHSgUJQfVKdRFObYMeIZ,GAAAaAAABADALADAHAEB.SAGHUBGAQCCCKCDARDEAOBHDhAAAMBBBZEEAAAEADDCBTGAAhADA..gFCAhACAfGEAdFGAFGGH......hAGA......hAHA...,1,-11,-12,1
CGKUeNcLXWVOfHIDEJMQYdZPabTSgFRAB,GAAAeAAALAEA..XADAOAHDHBCAEAGAMBIBdDEAaCGHhAAAbCDA.TFAA.hAAAFEHDAADAKDCD.cECDhACAfGFADCHBQFEA.ZGAA.hABASGGBBHDACHHA.hAFA...,1,3,-8,11
FOfIeUSDQZWMEHXVAgPCGLbcRdYKBaJTN,CAAAGAAALACARADAdAGABAGA..aBHDJBHBFCDH...OCFBhAAAeCCADCGBZEAA..EEGAHDAAhAAAAADA...bEECKFHBhACA.TGEA.NIAB.fFHA.hAIASFDD.hBAAMIAA.,2,-42,0,42
fXUACKPTHZQEOSJYaIgGMVcRNFLDeBbWd,KAAAHAAAEACESACE.aAEDGAEAMAGB.RAGBLCCBhAAABAHAdCCAXCGDAAIBTEFAZEABhAEAQEDAODHFIGDAhAGAgFFB.NHABDFIB...WHFGhAAACGHD.....hCAA...,2,-12,3,15
aBCYVQOZAKEFPbRHGLJXIfcNgedWDTMUS,EAAAFAAARACFHACAGAEALAFB..XAGAfAHA.NCCA.hAAAeCGF.dEAATDDAhAEAMDEBaDHDCCHAQEGAhAHAAFFBKGGA.bFCDIHAAgGEBDIGABHEAhAEA.....hCAA...,1,-1,-11,10
gWeEQPFSLBXAaDNIbKJZHVMTYRGfOUdCc,aAAADAAA....IADAKADAHAFB.MAIBRAEFGAGAOBBBdBBACCDA.hADA....gDCAhAGAEDCBQDGDhAFASDGDLEEBAAIBbFECJHAA.TGGA.hBAAfFDAWFHH.hCAA...,1,-2,-34,32
eXEdSbKUJFRQcgaCGBNILZMVWAPODTHYf,DAAAHAAAeABAEADEdAFAKAEA.FAHB..RAGF.QCAB.aCECGCCAhAGABCHALEEAhAAAZEFAMFCBACCBTGEAXFDDhAIAbDCDUGGA..gGGB.hACA......hCDA...,2,-22,4,26
FfAMVGcJUPETeXOKDSWRIdZNgQCbBHYLa,GAAAUAAAEADAeADA.KAGASAFARCDA.ZBFEQCGChAAABCDAHDAAaDAHADGAMDIBhADAVECBJEHB..TEEAhAGADFFB.dEGANIAB.CHHA........hACA......hADA...,1,-9,-13,4
ZYaSNCHOgDbJPBEKWUGceLIdfTRAFQVXM,QAAAMAAAZABE.aACECAFAHAGB.DCCAbAEDBCEA..EAGAKDDDhAFAGCGALEFAdCDCRDABhAAAAAIBFGDAXFEA.hBAASFHHOHEE.gGAA.hCAA......hDAA...,1,9,-28,37
UXbaVHJWCZQfAgDEONBcMYLGKIPRFSTed,EAAABAAA.MACAGACAKAFA.RAEAFBHD.eCBBdAHAUBCA..aCGHhAAAHCEBCEAAZEDBACGBODGDhAAA..NEIALFFBhAEASECB.XGGAJHAAWFAA...hCAA......hCBA...,1,2,-37,39
VDTSGAJcbNEWLOXUMaBFCPRIZeYgfQHKd,JAAA..bAAAEADELAEA.UCAAaAFACBFARCDAZCGB..eAHHhBAA..fECAhAAAHCCAdDGDTEEAAAFA.hABANECA.XFECMFHB.FFHD.....hCAA......hCBA...,2,-22,-10,12
YbcBTHJFMSEXOWQfKVZCIDPgaGUNeLARd,RAAAdAAA....bADBTADA.HAFBMAGBEAHBOAHBQCBAhACAKCCBZDFADDAB.aDDAGFBBhAAAeDGFADIBBEEDSEEDhADAfFHECFAAIFHA...hABA......hAIA...,2,-24,-1,23
gXaDKdVBWbYEcQCAFNRIULMTeHGSfOPJZ,RAAALAAAeADEHAGBGADAOBDDZAFAaCAAdCCCBCFD..bCFDEDHFhAAA.QFEAhABAAAGA.FGAAIDHAhABAMFIBSGGBfFDA.gFGAhACADIAA.WHCA...hAGA...,1,-2,-12,10
cbIOWfLBgKGFVTHQZaMRPSNYCXeAUJEdD,EAAAdAAADADA..IADAOAEELAHB.KBDDGAEAhAAAFCBD.HAGDZCFBREDBSBCDhAGA.CDGDACIBUGGAhACAbEDCBEHA.TGGAaFCH.MIAA.hBAA......hBCA...,1,-8,-26,18
afOFIENdDbAcReJMVUPgQWKYSHTGCXBZL,RAAAeAAAMADAUAEA..QAGAKAGAHBCBGCGABBDAZCCAaDFBFCGHhAAA.EEEBdEBA.AAAA.VFBAhABA..gGFBhAIASEHH.TGFA.....hBEA......hCAA...,1,-9,-17,8
OTcIKUJeLFRHdYEfVBQAZbDSgaWMXPNGC,ZAAASAAAaACA.MADA..XAEDGAGAOBCCTAGAKCCDhABAeDDARDEAHFDAEEBBBEFAhAAAACIBDEIBPEHDCGAAIHFAhAGALGBA.FGGH......hABA......hAIA...,2,-11,-8,3
bQJOSBNUeKWZVFEAXGRdICDYPaLfcMTgH,RAAAdAAADADAaADALAGB..MAGBHBDAQBDCSCCDBAHAhACAeCHHZCBBEDFBACHAGDEAhAHACEED..fFBAhAAATDGA.gFGA...hBAA......hBCA...,1,-11,-24,13
BHKVYLZGMedJQAEbDWUPOTfFSICRcgNXa,EAAADAAAUADA..TACAFAFE..CBBA.RAEF....gAGBhAAAaAHDHCEC.KCCDLDBBhBAAGCFAeDEDdEEAADDB.hBBAbEAAODHDSDHB.IGHAhAEAXGFABHFA...hBDA...,1,7,-31,38
GfAUODMHIKRaTQXYBbNZWPSCgJEcdFLVe,DAAAHAAARABA.aACA.QAFABAEBZAFB.SBHBCAHA.ECCAdCDAhBAALDEAeCGHACIB.MEIBhAAAKEHB.TFAA.hCAAbFCB..PFCAgFFAFGGB...hCBA......hCFA...,2,-38,15,53
LYSceOWKJdEAaQBITfNVZRbHMPDFXUgGC,aAAAQAAABADA...TACAVAFARCCAHAEB.MAHBFCHDUEEAhADAGDDALFAAhAFASCHHeFHBKEAA.EFGAhAAAABBB.fGAA.bGFADIAAXGBDhAEA.....hAIA...,2,-25,21,46
MXGDeLRWBYVfQFNASCUPTdgcIJHKbEaOZ,CAAATAAAdACA.....IADAHAEAEBHFZAEBGCDAeAGFRCAABCBDhAAA.VEAAQDGAhAAAAAGAUDGB.gECAhACAKFFDaGCD.MFFBDGHB.......hAEA......hAIA...,2,-14,-4,10
cNeOWEdFbIRZUGLJYAKVBfgHQMCDXaTPS,BAAAHAAAMACADACA.aAEESADA..eAGHEAGAdCBAbCCARDGBhAAAGCFALECBABIBKDDBhAAAfEEE.hAGAQGFDTFCAcFGDNAIA.FHDE..hBCA......hCAA...,2,-31,11,42
KJecXMdFGAOVBWZUbYCLNDISaQETRHgPf,BAAAZAAAUAEACACALAEADAHB...aAHDECAA.HDAC..fCAAhAAAeBHHMDDAGCCAhACAAACAOEEB.VFGBhABAbCFCIEGA.TFAAgGBAhAIAKFFDXGCA.hBEAdGHA..,1,-7,-15,8
SCFEJWeBDRIXPagQVKNLbcdYGAOTHfUZM,HAAAZAAAMACAFADAEAGA..eAEARCAA.XBFAaBGE..QCEChAAAKCCDLDEBdDHAAEDBhACATECASEFHhAGACDHABFHADGHBIHFA......hABA......hAIA...,1,-12,-27,15
YJUbfLHXDgZKFOPRITeCAScWGQVdEBMaN,SAAAGAAAdADAEAFAMADA...aAFEJAHB.UDDALBDBhAAAHCFBDDIBZBFEOCCBhABA.RDFAeFFAAAABQFAAhACABGDANIAB.bFGDfGHA...hAFA......hBCA...,1,-3,-13,10
OgfEFULIWCHeKdZJYGacXVAbQPRSBNMTD,QAAARAAABADB.MADATAFA.DAIBfAGA.EBDAhAAALCCACBHA.HCGBhAAAeCEFZECAGDBAhAIAaFABXGDCADBBbDGBSFEAgGFHFGHD.hABA......hAFA...,1,4,-23,27
JQGIRTBDWOXbceEHFACMYgZPUKdNfLaVS,MAAAZAAAKADCdAEALAGB..aAGASBEAGBBARBFFTEDAhBAADAIB..XCAAhABAeCHFHGFAACAACDDA.PHBAhBBAUEFA..VFBA.IHFA.OEHFhACA....hBFA...,1,-1,-22,21
SbVfZUaXdITeFgYPEOBNMGRWHKLCcDJAQ,QAAASAAA...VACAZACBaAEDdAFAeAHBFAGA...PCGDhAAAEBGBBDEA.GDFAhAAAHDDBLGFAhAIADCIBAEBAfEDE.IHEA..hABA......hBEA...,1,-6,-31,25
RgdTDMYAUWNOZFELaQfCVeGBJIPcKbSXH,UAAAOAAAEADALAEA.QBBBCAFAeAGHGCBBBBHAICEAhAFAKCHB.bCFDHECChADA.RFGBdHEBMDDBAAIB.hBAAZFEA.aDHF.fGAA.PHEChAGA.....hBCA...,2,-17,1,18
DTXEdZBLAYSGKVHOCaWQJINUPfgRFbeMc,GAAAHAAAaACAQADA.JAFEIAFAUCGA...fAHAhAAARDCAeDADMFFAhAAATCCAEFDFdGGAZCEBACIB.hACAKDGA.CECDPFGB.FGDADIBALHAAhAHA.....hADA...,2,-7,4,11
ZQfPXYIdWJaRDSTgBEHCFAGOMUbKeVcNL,GAAAMAAAKADAeADA...VAGBLAFBZCDAQEABhAAAXBBCdAHAaDHD.RCDBTDGAhBAAEEEBHECBAFCA.OGFChACAbFCA.NIAB...fGGA.IHBAhBCADIGA....hBHA...,1,20,-25,45
HYNAOEWCPeMSKbfZdDIFVLgGacUTBJXRQ,EAAACAAA..eACAMADAKAFAZAEE.dBCAFBHDLCFAGCAA.UEDABCCAhAAARFFF.HCFBAAIB.ODEHhACASEHBDEIB.IHCAhAAAaECD..TGGA.JHAA..hADA......hAHA...,2,-18,-16,2
AMZGbYSFEBaKQUPWDVIcgHfCJORLXeNTd,GAAASAAAEADAKAFAQADA.UAGADAIBICDAhAAAHCCACDAARDFALFBAeCEHdCGAADABhACAbFFABEHA.aFFBPHFChAAA..cGDC.JHAA.XGGAhADAMIBA....hAHA...,2,-19,7,26
ESNefTaAXPIYdGgCRMcUQVFDBbKHZLWOJ,XAAA..IAAAGADARAFAMACAQCGADAGAKBCAHBEBhBCAZDAALEFBOBGFEDDBhBEAeFAB.aFDDABIBdEGDhBGACHGA.UGGA.........hAAA......hABA...,1,-8,-21,13
HEOTLQMdfUSRGXADaYKNZVPbeJFCBIWcg,aAAAKAAAZACB..VADAeAEA.FAHDBAGB....ICAAhAAAgBBGHCEAEBHFTECAhACAMCGB.dEGASDABhADARFABADIBDFFB.PDEBCGHA.ODHD.hAFALHEA..hAIA...,2,-27,-8,19
LBXdTfMaCHPJRWAKgYFUSeNVIcOGZDQEb,KAAAFAAAeACH..IADAGAEAZAGBEAFA.LDDBBAHAdCAAMBIBhAEAHCCAREBF.ACEAUCGAhAAASEHD.VGEAhAGADEEBbFAA...TFFA.aFHD.CHFD.hACA......hAFA...,2,-20,-4,16
HCEDWZecNFOAdgSUaKTQbYLMfIPBXGJRV,dAAASAAAaADA.QADALAGBMAIB..fAFFhAAABBDAGCABRBGBHCCAhABAEBFFZEEAeDABFGEAAAIBKDFBhADA.bFFAIHHAPHFC......hACA......hBAA...,2,-22,11,33
STQVBGXOEIHLUWgPcNRYCFKZbaDAdfMeJ,dAAAeAAASADAQADAGAFAEAFAHBGBLAHBUDCAPEGBhAAARCAAFCEHZEAA.DEHBAAIBMEIBhABAJFFB.BEEB.OGCAhCAAIHBA...WEHHNICBCHHD...hCBA......hCCA...,2,-11,3,14
RbMKVPUTCaSQHYeJGgXfAIWDLBcOdNEFZ,DAAALAAAOABEEAEAZAEBRAGB...KAGAUCAA.CCDA.aCCBHCFB.hAEAeDHHGCFA.fCHEhAIAAAIBBEEDdFCAFDDHhBAA.MFFB.........hABA......hACA...,2,-25,-22,3
HFKRcLVWAPbSBCNeOgYUafQdZTJXIMEDG,SAAACAAA.eACHOACA.UAGAaAEAdAHAZBCA..TDBAhAAAXBDD.EBFBHDDBhBDARDFALFFAABFABDGANDIAhBIAfHBB.IHFAGGDB..hAAA......hABA...,2,-19,-19,0
IagVeGRXDOLJNYCfQHFdKTScEUMBbWZAP,aAAAeAAAGACARADA.DAEALAGB.JCCBCAGAHBEBdEAA.TDGAhAIAEDFBBDHAZEBAABBB..hBAAIFHAXBGAOEDDhAAAfFFAKFFDSGCDMFIB..hABA......hAEA...,1,-6,-24,18
SKWCUeJbcTERaMgfVGHQFANDBIXOLZYdP,BAAAOAAAZACAdAEAKAFCUAGA..eAHF..JBBFTCCARDCF.hBAAMCGB..fDHAhBDAHDABAADADCIBLEFBhBEASEEBCGBAEGDAaEGD...gFDDhAAA....hCAA...,1,-26,-27,1
gQVYTDOUBAXLSCGZeKRWcbMdENPIFHfJa,LAAAGAAAeADARADF....bAFBEAGA.ICDAHCAAaAHDQCFAhAAATDEAODGDhABAAADACCHAZEEAKFCAMEIBdGGDFHBAhACAfFCA.......hBHA......hCAA...,1,0,-8,8
YaPKEMWTOReNbUVDBCJZIHQXLcAGFfSdg,GAAASAAAdADAaAFAEADA....MAGBTBFARCCA..eAHBhAAAbDBD.DCHBBCHAZDAFHEEAhABALDEBACCAFFHDfDDEhAAAgFCBKEHBNIAB.CGFAIHHA.hADA......hAIA...,2,-8,-4,4
LFCQARUcXZTHNGWSVdMegYJabBfDIKOPE,RAAAXAAAHADBGAGA.SCCDdADAeAFAJBHBaDAB.BCEADDFBODGHhAAAEDBA.LFBAhABAQEEAAAGBcFGDhADAZFAANEIA..MFHB.......hAFA......hAIA...,1,-6,-16,10
FDPGYUQSWbCdKeTVZXNcgAMfREBaJLIHO,RAAAEAAABADBLADAHAEBDAGAGAGA.QCBASBGBbDDBdCCAhAAA.eCHHZEAAXFEDhAAA..gEDAhABAAAIBaDHDIHHAFFGH......hAEA......hAFA...,2,-23,-4,19
PaNFZcOGUSBWYQLMEARCTgIbVHdDfKJeX,RAAATAAA..bADBHACB.dAEBKAFAeAGH.aBEDZBFE.GCCAhAAABCADQDGAhAAAEDHBAAHACEFA.gEEBhACADFEBXFGDFGHB.........hAIA......hBIA...,2,-24,-7,17
ZHeBYGJCcdVgfNbaPFSWXQKDOALITMURE,TAAARAAAHADBeAFA.GCFACACBdAEA.VDAA..fAGAhAAA.aAHDSBHHhAAAQCCCOEEBhABAADFAMDHBEFABZEBABFHAcEEANIEB.FGAA.KGEADFDBhADAIHHA..hAGA...,2,-18,9,27
WRPEYHFKaIVDeXZJfLMGOdAUQCBTcSbgN,QAAATAAA.SACA..bACB..gAEHhAAARAEAEBHFHCDBaAGDDCCBeBHHhADAZDFFLEHBhAAAGDCAADCBBEEBcFAAPEGBKHAAIHFAXGDDhAIA......hCAA...,2,-9,4,13
MfQDFcUSTdZXePJIOACgLEWGRbHYVBNKa,LAAAEAAARACA.HADBBAFBaAFAMAHB.DAIBFBGH.SCAAhABAZCCAeCGD.IEEAhACAACEACDAA.GEGA.bFBBhAIAVFFBfGEA......hBFA......hBIA...,1,-7,-34,27
gUfRHKDEGZdFTWaQJSNYCbAIOcBVXPMeL,OAAABAAA..XACAeADALAHB.UCCAHAFAEBFAdCAAhAAAFDFBaCCB.QCFBhACASBBDCDDAAAHAIEAAhAEAPDHDMEFBREGBDGGB.ZFAAJHCANICB..cGGAhADA.....hBAA...,2,-16,0,16
GXHTVQUMIYCERKSfLaBWOeDdPNJbAcgZF,ZAAAGAAAHAEAQADAMAIB.CAFARAGFfCAALDCAaCHDOCCBhABA.dCGAJEFBAACAFDEBhAEAXGDDUFFAEGAABGHAhAAAeHAADDAB...NEIA.......hAGA......hAHA...,1,0,-11,11
TOgIWAUbDFBcdLKJZMVCGYNRSEaHXefQP,DAAABAAAdADALACAZAEB.MAGBGAGARCCA.EBBAHCGB.eAHBhAAAQEEAODABIEEAhADAAAIBFEHDKDDDCGBASFCBhAEA.aFGCfGDA..hBAA......hBBA...,2,-31,-8,23
CYFLUBdHEbKATIcJGDVRPeNWOXQfMZgaS,TAAAJAAAGADA..RACFeAEEOAFAQBEDZBFF.aAHDCBHALDAAhADAdDFDHFFAECABhAAAACCBDDFB..PHAAhACAXEGAMEEB.SHFAFGGBBHDA...hBAA......hCAA...,1,17,-27,44
GLRFcTWNIVEeaAPYQXKHfbgOUSMJDZBCd,QAAAHAAA..bADBOACCMAGBZBGBdAFARBGFFCAH..TCDAhAAAICCAEDCBAAHAXDEDhAAAKEAAUEGBDCIBCFEA.GFBBhACA.LFHBNIBBaGHH.fGGAhAHA.....hAEA...,2,-13,12,25
feSXNBFPZQVKdUgELcHbWYaIRTMAJCGOD,GAAADAAAeABASADABAEAZAFB.QAGAdBHA.ECDAHCCBhAIAbCFD.aEFAREAA.ACCBOEHDhBAAXFDD.FGAHKFCDgFGAhAAALFFB........hACA......hADA...,1,1,-20,21
DHOFIQgeJUcMbCTdLNZKRaXEWYPSVfABG,GAAAHAAAFADAQADAeAFHUCABMAGB.TDCAdAHAZDCBRCGFEAHBhAAA..PDHB.hACASEEAADABOEFBgFBBhADAbGDA.CGGANEIAaHBCWFDH..hAIA......hBAA...,1,2,-5,7
FRgcMHVUfAZaCQLGWJXNDIdeEKPBTOYSb,aAAALAAAGACAXADDDAEA..eAFAEAFABAHAOBBHSCAAhABARCEA.MCGBhACAHEBAUDDAABIBZEGBQFAAhAFANIDBKFFD.TFGA.FDHF...hBAA......hBEA...,2,-11,-5,6
EBUPfANTMaVbDeSIYRdgXcFZQOKJLHWCG,MAAAaAAA.DAEAeACH..SAFARAEAdAHA..XCEAhAEAZBBAQCFAKDDDHDGBGDBAhAIAEFAABFEAfDDEhBAAABBBNIDB.bFEA.IHDA...hAFA......hBAA...,1,-11,-15,4
NfWRLOYKaQFeGTIVXPBHAJcdUDZCgEMSb,dAAAZAAAEADEMADA..SAFB..bABD..fAHAhABARAFALCEAKCAAaCHDeCEBhACAGEBATDGAXEEAhAIAHFCAACIBJFHBDFIBCHFA.gGFA.hBAAOHAC...hBDA...,2,-14,4,18
TVfKCIPOeZUadHNYgEDSQJRXAMcWGbBLF,MAAAGAAALAEAFADA..TAGAKBBACBHA.OCDAeCDAaDBBHDBBhAAA...NCIAEDDBQDFAhAFARFEA.ADIBbECBhAGAfDGEZFFA.dGAADHEASHDGhACA......hAGA...,2,-12,-2,10
GLFPRaCJgYVDUMQAETIKBNWbfeHXZOcSd,EAAATAAABACA......bACBHADBZAEBSAGAhAAAGAGALDDARCFFaCCHCCHBgEGAhAAADEBBUFFBAEEBKFAA.hAHAfFDAOHEE.FGHD.YFFFhAFA.MCCB.NIAB.WEHBhBEA..,2,-15,-2,13
XLCZWdcDaSGbgBFATUIQVHYNRKMfePEOJ,TAAAQAAA.HACARACFMAEAeAEEEAHFXBGA.ZCDBdBFAhAAAaDGBbCDDFEHB.AAHAVFEBhAAAKCADOCHD.LFGBhACACHHA.DFCB.SGEA.hCAABHDD....hCFA...,2,-9,4,13
GPOZbYcVgeCHfaSWRXIBLJQdDTEMAFUKN,KAAAGAAAZACB...bADAVAEA..eAHBHCABaCDARCFABAHB.hAAALEDBdDDAECGFAADAFFFAhAAAPEGD.OFABhACA..YFHBCFEASGHH..hAFA......hAIA...,2,-19,-9,10
NZVJGbSMLcUfXeWdgKRTDOABFHaCIYPEQ,HAAAaAAA.CADB...IADAEAFAZBEEGCCAMAFA.LDHBhAAAUBFAeBBBdCADREFFDBIBAAIBFFAAhACAQDDC.VEGBhBAAbFDD.SFCD.XGEChCAA......hCDA...,1,3,-19,22
fQeaBCSGVMRPZUcXHFOdDKNTJWbEYLAIg,..IAAAQAAABACAGACB.RAGFZCDAXADDHDAAdEEAhAAAKAFAJBHBEDHFAAFA.eFCBhADAaCAA.SFHHhAIAMCGBUDDAFGFDDEIB.TFAA...bFEA.hCAALHAA..hACA...,2,-26,17,43
GJBOWbTSfFQgZLXERVcUYKNHIMPaDAdCe,eAAAGAAAOADC..bADASAFEFAHBZCDALDHBRCCAUCFAKCHBhAAAHEAC.MEEBaEECAAIBhABAdFFABFGA..WHEAhAAAfGHA.......hACA......hADA...,2,-21,-7,14
EXfNQVKUcIYBTaZMAeJSHORDLbGWFCdPg,eAAAHAAARADFLAEAGAFACAHAdCCA.EBHFXCAAQDFC.KEDBhAAAIDHABDBCZFAAAACAODDBhAAADDIBFFGD.fEFEhAFANIAB.cFGD...aFDD.hABAMICA.SHAChAHA.,1,-7,-15,8
HJQGKSRVBFPdcZWAYXLgUNOTMCfeDEaIb,LAAAUAAAOADAMAEA..eAGFEAHFaBCEHBDB.GCGARBEFFCABdDGAhABAZDBFAAIB..XFFChACATFEADFIB..hBAAbGBA.KDDDBHHD.......hBGA......hCIA...,2,-13,-11,2
DIcfZdBgTYMaFVEWNACbOSJLHQRGKPeUX,OAAALAAAHADARADFGAFAeAFEDBBB..fAHEdCCABCFATDGAhAIAaCAA.EEDAADDBbDGDhABAQFFC.hACAKFCDXEECIHHAZFAAMICA...hAFA......hAIA...,1,0,-11,11
gSCKMUOIJdBfLPHVaFGbTXEZWDcRANeQY,eAAAQAAA.SACAMAEAOAHDdAFALAHBHBCAaBEAGDEAhAAAbCDC.EDGBZDABhAAADEDBABHBNECACGGAKHBA..hABAIEEAfHDBFEGATGFA..hADA......hBFA...,1,-3,-6,3
MgDXGaPcLHeOVWYTFQINJdASRCEBZfUKb,RAAAEAAAZADBKACA..MAGBDAEAGAGA..aAHBLBFDHCEBeBHHhAAAOCCB.VEDBhAAATDAAFFHB.QFBAhABA.IFGANIABAGGB.BCCC.fGHAhADA..hBFA...,1,-14,-20,6
DTIeZGEJUOdXVPSAgcCFbKMWLHRQYNfBa,CAAAKAAALACAHACBRAEA..QCAC..fAGAhAAAaAHDTCFAeAHH.ECCAODEBhAAAdDAAXCEDhADASDHHADIBFEDHbEAAMEHBYFFADFFBGGABhAEAJHAAPHEA...hAGA...,2,-12,14,26
VLbIMPZfSgTQUGHdAEaDcOeRWBXNKFJCY,EAAAaAAA.DADA..eACHRAEABAHBKAEA..CAGBLCEAMBCB.ZDDASBDDhAAA.TCFAhCAAGEAA.HEGBhAEAACHAODHDXFCBFECDVEEB...IHGAhCBA...hAIA...,1,-17,-21,4
KJcSaHUbCdfMBZXYDGTNQRPVgFeAOELIW,EAAALAAAKACA.SADHHAEBCAGA.dAFAMAIBZAGBDBIBGCCAQCAAhABARCGB.VDDAhACAeEAB.ACCBOEFBhAAA.IGGAcEGBbFBB.BFHA..hBFA......hCAA...,1,-9,-14,5
XFcBIEKLdGPOeDJMaWfSYZNUgCbTRVHAQ,QAAAFAAABADAKAFAGACB.eAFEMAIBaCDC...SCFBhAAAZCCAUECACCFBRDAAHDGBhADA.ACHAXEEDhAIAEDABdEHADFABfGHA..gFFDhADA....hAFA...,1,13,-41,54
CbQDGXeHKIdWNRZEUaOLYMJBgTPfcFVAS,CAAAQAAAGACAHAEAdADARAFAZCAF..ECEFaAGALCHB.MDBBhAAABCGA.TEDAhAAAfDFAFDHDAEABbGCAeDDDhAFAKGGAIGFA.UGAB.OHDChAGA......hAIA...,2,-10,-2,8
QgcaVOSXbfKTGBENMUIHPZADYWLeRCJdF,DAAALAAARABA.dAEAQAECaAGA.OAGDXBFD.KCAAhABAGDCAEBHB.MAIBhAGAHCCBADCBeEEEFEBHgEFAhACASEHBbGEATGGA.BFFDNEIA.hBEA......hCAA...,2,-14,-7,7
WfUJLCXZcRBSMAQgFPGOTeYaDHVKEbdNI,QAAAFAAAGACAeAEAaACE.HBFCKAFAEBHFdDFA....IEAAhAEAfCDALEEDhAFAZCEBRDABMDGBAAIBODHDhBAADDIBbEGDWHEA.CGGC.BHAA.....hCAA......hCBA...,2,-6,-6,0
WAPSRJTMbeCQOBEGUgDfaFcXZVNKYLdIH,RAAAMAAAeADE..QADAEAGEGBDADAGAFCFAZBBF.KBFCdCCCHCFChBAAAAAA..SCHHhAIATEDAOEHDBEGDfFEAhCAAaFGBXGEDYFHB...hBIA......hCAA...,1,-10,-14,4
XRQaJNTebALBEWdgOSZYMfVHcPCDUIFGK,EAAAdAAASADAZACB..MAFAHAFBCBEADBGAFAHFGCAB.hAAARDEBaDGETCFAAEAALFHBhACABCBCOCHD.hADAfDEEPECDKGGDQEBA.hAEAeFGB.WHCA.hBAA...,2,-20,-1,19
eMPQYZcHJVWbXdCNDaIUKGfFSgBTAOREL,EAAAeAAA.MAEAQACAZAFEHBCBJAEE..VCFAXBFA.hAAAdDDADEBBaCCHKECDGEGAhAAASEEBTGDARGFA.hABA............hBEA......hCAA...,1,-9,-14,5
YUaQLHGKFSDPdNgZfMTWAbeJEIRBOXCcV,eAAAEAAARACA.OADC..CAFB...VBGBaAGDHCCCGCCASBHHhAAAdEFAZFABMAFAADAAJDFBhADAXFDD..hAAAcEGDYHFGLFCBDEIB.PHEAhAIA......hCAA...,1,0,-19,19
RHadLOFPVMCUBKYNDTWQgGIJAEbZefcXS,EAAAeAAA...XADAHACAdAFALAGBFAHBMCCBBCCAKCHBDDDAhAAATDEA..QDFDhAEAGEAAAAAAZECFSECHhCAAREGBaGGH.OEEH.CFHA.NAIA.gGGGhCBA...hAEA...,1,-8,-9,1
LNJaTECYgBIMHbXDOVSfGcFeAQKWUdPRZ,QAAAKAAAdACARAEA.ZACBLAHB..aAEDECDFCAGABBHAHCFBDEAAhAAASCEAGFABeEEBhAEAADHAUEBA.PEEAhAAATGGA..gFGA.bGACOHCChAFA....hCAA...,2,-16,-4,12
VCOHJRUPfQGYKLdWaeXTgBDbcINFMSZAE,EAAAOAAAHACARADA.UAFA..QAGCGCCBLBHBaBBCeCEFhAEATEAADCIB.bEFCIDGAhAIAMHDA.ADDBCFEAfGGBhAAAdFHA..XGFD..hBAA......hCAA...,1,7,-21,28
QWeIdbCOVABNcaSRfKYEMJPZGUgLFDTXH,BAAAaAAA.RACAKAFCEADA..MAGBZBEEGCAA.LDDATCCAHCEBhADA.eAHBbDGD.hAAAOBBBAACA.SCHDhAIAfFDAPECBFGFHDAIBQFGAhBAA.WFBDCHHA.cGFChBFA.,2,-17,-12,5
NQVUOaXAZHMPBLKgdTcEJIRDGFSbCWeYf,HAAAMAAALAEAdADAEAFARBFA.GBBA.SAHHbCAC.eCGBhAFAfDEAQDEChAGAODGDABBBZECBKFAATGFAhBAAIGEADDIB.CGGDNDIA......hAAA......hACA...,2,-13,4,17
YgLIOUAXHeKfbFWEZPTNRGMDVCQacdSJB,HAAAeAAAKADAFADAEAGAZAFB.....TCCARCCBGCGADBIBQCEChAAAdFAABCECLFEBhAAAOCABACGAXGGAhABA..bDGD.PGAAMAIBaHBESFFDhACA.....hAFA...,1,-2,-13,11
KZfJFVHRSMWPdICLbYeGUDNgAEaXQTOcB,EAAAaAAA...QACATADA.BAEAZAFBFAHDHAFBRCCB.MAIBdDAALDHBhADAeCCBGDGAhAAADEFAABBBOEDDKFCDJFFBSFFDhAHA.IHBACHHA...hAFA......hBAA...,1,3,-17,20
KeECAaWMZYIbBLdSNOgXfUJRDcPVGTFQH,aAAAZAAA....bADBdADA.OAFA..fAFARBEFDBBB.hBAAVBGBGCGA.TDBAhBDAHCAAEDEFABIBMEEBhBGABAHBLFFBSEGA.XFFChABA......hACA...,1,-15,-19,4
cZTaEbLOFSNGdJVPXQDfHeRYICUMKWAgB,BAAAZAAAEADELACA.SAFHdAFAPAHBQCCAhAAA.HBGBRCAACCEDMDGBhABAAADATEFAaDHD.FFDBJEEBDAIBhAHA.eEHH..IGHA.KHEA.hCAA......hCBA...,1,-14,-21,7
AXNFYVSdTLWgDCUbfJEeRZGBQPaHIKOMc,FAAASAAAdADALAFADADA.UCFA..bADAECCBZAGB.GCCAhAAAQEDDHEFAOFCHhABAAAGA..XEGAhBAAYFEFTGGACGHA.eDBBBHGDaHDAMBIBhCAA.....hBDA...,2,-19,1,20
QCNfJOZbXdFEGMegaHcASBVUDTWLYIPRK,BAAADAAALADA..IACARAGFQBBCCAEA..fAGAhAAAZCEFdDDAEDGBeAHHhAEAHEABACCA.SEHHhAEAUDDATEGA.PFCBKGGDNIAB...bGEC.hAFAFGAB.....hAIA...,2,-21,-6,15
PecHIAaOFBDQJXCWUYfEbgdMKGZTLNVRS,aAAABAAA.QACACADA.UAFAEAFAdBHAGCAAZBBALCFBhADARDDAeBHHHFBBADDBDEEBXEGAhAAA..fEHAhAFAMFFBTGGASFDD.IHHAhAIA.FHEE..hBAA...,2,-33,6,39
AaHEJRODWZLIFSfQXgGNBbUcMdPYTKCeV,HAAARAAADADAZAEELADB.SAFAQCCCGCEABBHAUDFAhAAAdCADTCGAKDHB.eEHFhAAAACFA.EFAAOEEHhABAFGCAXGFD.NIAB.bGAA...cGGAhAGA.....hACA...,1,7,-24,31
DOSBCVWRgHMNdFaeETYQUGcPJILAfXKZb,KAAAZAAAOACACACB.RAFA.HADB.dAFBeCCAEBGB.QCGAhABAGDDBJEHBADFB...XGDAhAAAbEECBFHA.VGAAhAGAMAIBFGEDaGGH.........hAIA......hCAA...,2,-18,-11,7
WZMYBCDNPUOSEdAILeRVbfXcgHTGQaKFJ,eAAARAAA..VAEAXADAHCCAGCGA.aAHFFAGA.ZCCAMDABhAAACBGDDCIBUECBEDGBAAAALFFBhABA.bEADfEAAhAEA.TECAQGDBKFFAYFHBhCAABHHA.OHDAhCBA..,2,-14,8,22
UaXIMCOWTfKYDBVHRFbeZPNEdQLgJGASc,SAAAaAAA.MADAOACD.TAEAKAGABBCAHAGBRBDFeCFAhAAAZDEAEEAAdEFALFDAhAEAGGCBADIBXGAAhAGA.CFHA.fFBADBBB.FHGENIDB...hAIA......hBAA...,2,-15,-5,10
aCLUGYDPWQHZbeSfRJVBKdTINFgEOcAMX,aAAALAAAGACADAEA.QAGAHAEAeAHHRBCABCAAdDFA..TEAAhAEAFCFDEDHBAAGAMDIBhBAACEDA.UGCA.PFGDhBBAbFBCSFFA.fGHAhABA......hACA...,1,6,-27,33
SEPGJXbgQYAIMZRKCOdFVaUWNDfLeHcTB,ZAAARAAAOADAdAEAFAGA..UBEBDBGBLCABHCCBBAHA..ECCBGCGAhAAA.XFDAhABAbCGD.QGGBhAHAACIBMDFBKEDB...aEBDNICB.eGEA...hCAA......hCCA...,2,-20,-9,11
NMUTEJGIgBKWeVDASRPQYfCaZOLbXHcdF,RAAAQAAACADB.ZACBLAFAHAEAdAHAMCCAECEBGDFABCFAeCGHhAAAADHASEEDhAAA.fFHAhAGAbDDDFEHDTGAAgGCBKGGDDDDB.....hBCA......hCAA...,2,-21,1,22
VEPbJCKRHAYOBUSeaXIMFgcfWdQNLGTZD,BAAAeAAA.aACAMAEA.FAHD....fAFAdBDALBFBhAAAZAGBEBCBbDGD.KCEDHFCAhABAABIBODBBXDCCIEFAhAAA...gEGH.QGCAhAFANIDB.DGIBhBDA...,2,-31,-6,25
XKPTWaMAHIENJVeDBbdCSUGcOZRfFgYLQ,HAAAEAAA.VAEAeACABAHBdAGACBEAGCAB.ZCFERCCBFCHDLEAAhAAAQDACKEED.TEFAhAAAaEHBAACA..JHCAbFDDSFGDhAEA..OFHD.fGBAhADA...hCAA...,2,-6,-6,0
GWQEaMeCbKTYARVUfFIgXOLHcPBZSdDNJ,RAAAUAAAFADA...XADAHAFBBAHA.dCCADAGAGDGAEBGAeCBAhADAKDFDAAAA....fCHAhAEAOEDDLHAAhAHAZDEBSEDF.WEFHaGGH.bGBC.hCAA....YHFGhBAA.,1,-15,-32,17
dIbKLUYDHVSQgcJGXTOeFPZNCMfABaEWR,EAAARAAAdADAKACALAFA.DCCBHAEB.QAGAJCFA.GCCAhAAATDDAeDHBZEGB.hAAAMEABAAGABFDDaEFBbGDAhAEA....YFFDSGAH..hAGA......hBIA...,1,-4,-32,28
aAIVSbgFYPJOLCXHWcRZBKUTeNDdEMfQG,SAAAFAAA..PADALADAHAGBRAGFZCCAKBCA.eCHHdDDAECFBhAIAMDGBGEGAAAAAIEAAhAEAVGBA..bFEDgECAhAFA.OFFH.CHGA...hAIA......hCAA...,2,-14,-4,10
QSEgUABbJCLaVIWMcRNXfTPZFdKGOYDHe,BAAACAAALACAaACA....VAFAMAGBRBCB.XCCA..hAAATDFAZBGBdDAAGFABhAAADCFBHFFAeDHHEHAAACBBIHDAhAFANICB.FFFH......hAIA......hBCA...,2,-18,-16,2
abDMSNROLXgWZJGHfEFABcTeKVdYPQCUI,TAAAeAAAdAEA.QAGACACB.UDBAbADD..DAFAMCGBRBFALCCDhAAA.XDGAhAIAZBAEHEDB.EDHBABFAKEEAhBIAPFHBaFGDOHDCgGAA...hCAA......hDAA...,2,-16,0,16
GQScbEgIdNRCFaJfUYVDAZMHWKeXPOTBL,HAAAeAAAOADCTAEAGAGA.QCABbAGB.ECEBdCCAhAAARDCBaDHDfCFAhABA.VEDBAAIBZFFAMBIBhAFAXEACLFHBSGAAgGFACGDA.hAAA......hACA...,1,8,1,7
TEUJNcFQfCRGKSPMeAVBWOIdYbZXgDLHa,BAAAOAAAdACAZADBDAEAHAFA..EAGAUCFB.JBBFFBEB.QCFAhAAAREEAKFHB.MBIBhBCAAAHA.....IEEAhCAA.bFGB.LHDAaGGH..hCBA......hDAA...,1,-31,-32,1
KFfOGXPYWBIMQNTbUVgLADZdSEaeHRCJc,dAAAEAAAHACARADA.CAFB.KAGCFAHBGCAB..XCCA..hAAAPBHDBCFAMCIBhAEATDEAbDGDUFCA.LEABhACAAEFAZFCA.eEGF.fFHAhADA......hAEA...,2,-17,-16,1
ZMTONUAXIJWcFaSBHVCDGdPQEfYKgbRLe,XAAAJAAA.FADAaADA.HAFBDAGAdBGAEAHB...KBDDRBDBeCCBhAIAZCEB..MBIBODGDhBAAAAAA.IFEASEDDhCAACGGD.GGEB.fFGB.hCAA......hCBA...,1,-22,-23,1
ZKfAHEUNaDTOCIQVBRYePMXbWScGdJFgL,HAAAEAAAUADAaACAOAED..QAFARAGBeCCB.MAIBbCFD.hAAASBCDGEDAdGAAhAGAFDBH.ZDEAADIBTGGAhAIACFDABFFAPFHD...WHBA..hAAA......hBDA...,1,10,-21,31
GMWPSBdFUcTQCHAJOEKRgDaYbeZXLIfNV,EAAARAAADADA..aACDeAEAZADBLAGB..fAHAhAAAGCEAMAIBSCCAhABAdEHAFCBHTFBAHCEBACCAKCHBhCAAgGGGbEGD..XGCA..hCGA......hDAA...,1,0,-20,20
THaJFdYKBOgeVDARcfXSUQGMPLCIZWbNE,RAAAXAAAQADCGADALAFBZAFA....bCFDEAHBHDAAhAAAaCCCdDHABCHDeEEAAADBSEHBhABAMFCBCGGA.IFDAhAGA.TGGA.FHAA...hAAA......hABA...,2,-19,7,26
XWMPgQZBVeUOJLfGNRFIYTKdaSAbcDCEH,DAAAHAAAMADAQADCZAEE.eAFEOAHDLCCAGBBARCFFFCAHhAAA.TFGAaCGHABBBCDEAEEEBhACA.XGBA.hBAAPHECBEDDUFFA.fHDBhBDA......hCAA...,2,-31,20,51
XLFEMDWBAPTaYVJGdeRZUgKfIOHQbNCcS,aAAAVAAAGACA.RAEA.ZADB.KAFAOAHDHCEBQCGAhAAACCFA.SDAAhADALEABEDGFMFGBBEDAAAHATGCAhBIAdFFDeBBD.fGHAIFHA..hAEA......hAFA...,2,-17,-5,12
TcdSfQUGARCaMbLVOJKYHPBZXFeNDgWIE,RAAAaAAAMADALADA..OAFEKAHBHCCAZBEAeCCBDBBB..ICGAhAEAEDGBdEEAQGFAhAAAACEACDHA..bEEBhAFA.JHAABHHB.NCIA.TGGA...hABA......hAIA...,2,-18,-16,2
XKVQfHTCUSdGMbPRgaWOIEZALFcYeDJBN,LAAAFAAAeACHBAEAKAEAQAGCHAFBCAHA.dCAAGDDA.MCIBhAEARCCAaCGE.OEAEhABAEDGFADDBDECBXEEA.hAHAfEHATFGA.SGHH.hBAAPHEA...hCAA...,1,-5,-19,14
RgAZaFDNQfGIPEOMKeLYUTWdVBbSCJXHc,aAAADAAAQACAGACA..EAEAMAFAeAGFLBEBUDFBdEAAbBGBhBAACBHAHEDB.RGFAABBBZEDAhBBA.fEHAhCAAOFCH.TGCA.BCCD.XGEDhCBA.FGHD....hCGA...,1,-1,-5,4
gWBPQeMfJRbIOUdSTZGHcAEVKXCNDLFaY,EAAAXAAADADA.LADAFAFD..aAHB..gAGHhAAABBCAeBDHMCDBRDFA.bCECOCBBhAAAdEAAZEFAHFDAACIBCFCD.hABANIBB...PGEAfFHAIHHA.hBCASHEG.hBIA...,2,-25,5,30
gRMZdWJOYLXfVaPHGEBUNAQIbCSFDKecT,QAAACAAADACA.eACA..TAEARAFAdCDAOCFBLAGBXCGDhAAAaBCBHDCAEDAABDHAhAAAACIB.SEFHhAIAKFGAMGAAZGFAJFDBfFHA...hADA......hAGA...,1,-7,-23,16
ZFgALUGYXSfWRPdHKOcCEQbDMaNBIJeVT,GAAASAAARADAHAGBOACDECDB..QDFCMAEABAHAeDADhAAAZBDBAAAALFCBUCFA.hBGAfEHAdDHACFDAaFFB.hCAAIHHA.JFEFTGGAFGAH...hACA......hADA...,1,11,-21,32
UcWCZPBXLQDaROSVAbYEMgNIGdFKfeHTJ,EAAAMAAA....IADAdAEAKAGAHBBBUAFA.CCFAZCGBBAHALEBAhAGAaBCC.RFEBOEHDhAIAACIB..bDDA.gEGHhAAA.GFBB.eHDA.hBAA......hBBA...,1,-14,-23,9
ALIcGWYFUdOTbDHJNBMagKVRSPCXZQeEf,LAAAGAAAFADAdAEAOAFDDAGAHBFB.BBHAaAHB.KCAARCDBCCHAZCCF.hAAA..EDHFADCB..IEGAhACA..cEBChABAUFDBTGGAJFEBMFIB...SGFHhACA...hBAA...,1,-14,-25,11
SAFXULfedRJDKYMINWCETGOVQBcaHPgZb,XAAALAAAeADHRADA.KAFAMAHB..ICAACCDDGCEAQCEAhABAaCHDHDAAZGAAhAAAAAHAFBHDdFHADCCB.NEEA.EGDEhABA..OFAABGGC.gFFA.hADA......hAEA...,1,-1,-15,14
RGXMeOYETfIbLdQBHacJCADKPZWUSVgNF,KAAAZAAASACE..gACBRAEFGAGAeCCBEAEETBGAhAAA..bEDDdDDAHFFAhABAaAGACCFDAAIBDDIB.PGAAhAGAVEGBXFEDOHFE.....hCAA......hCBA...,2,-17,3,20
JZUDNTdAaQfeOSVEgcKYXPbFHBCMLWRGI,aAAAeAAA.OADCEADAKAFA....XAGBFBBHHCEAMBIBRDCBGEGAhADAZCCADCEAdAHAAAAAQEEBhAFASFFDgGCAhBAAPEHBBGDA.WHDA....hCAA......hCBA...,1,-2,-22,20
aULfeTAbSOBEgNVQGcJPMIYHdWRXFCKZD,OAAAEAAA..VACAGADA.JAFAMAFAHCFARBFA.FBBHZCCADDDBaDGDhAAALEFA.eFBBhAIAADIBbFFABGGA..hBAAQGBAIHEA.WEED.CHHD...hBGA......hBIA...,1,-12,-16,4
BCVHMTJOSQZWFEdUeYagAKLDIRNXPGbcf,LAAARAAA.XADDbADBBAFA.HAGBMAFA..OCCBhAAAZBFBEBHFeDEFaCAAADDADDGB.hABAIEHAGEGACEEDTGGAhABAQFBAFFCD.......hAIA......hBIA...,1,-8,-15,7
XNCKZBPHIdRAQfDSMVFcabgUTJWOGeYLE,QAAASAAAMADAFACE..aAEDUBDA..TAGAOAGDhAAAeCDBEDCBCDGDZCFEHEEAhABAREGBAEIBDFFBVGBA..bGAAhAAAgGGA.......hAGA......hAIA...,2,-12,-7,5
RMBAabdJDZOQPHLcSNVICXgWfeGEFTUKY,dAAAZAAAQAEAHADALAGB.SCAAIAHA.CCEAXDCDhACAfCAA.ECCBTEGAhADAKCEDRCGB.AAIBbEEBOEAChABA...cEFCgFABeFHHGGBBhACAFGGHMICA...hADA...,1,7,-7,14
JMTSFQCdbLVaHYEgUPNIDKAGRWOcfZXeB,RAAAOAAAZADBBAFA..MAEAFAHB.dBBDLCCDHBDBEAHF.UCGBhBAA..IDAAhAAAABFAGEGA...fFCAhCAAeCGBTDEAQFEAbGFA..aFCEhABA......hADA...,2,-29,-5,24
GLTeMfdIJHYgZSPEKNAVcOFDRQUWabCBX,OAAARAAAQADCUAEA...aAFABAGAGBFAeAHHdCHAHBCBZDDFEFCBhAAAABBBFDFB..DCCBCDHALEBAhBAAMFHB.IFGAhBEA.....YFHBhCAA......hCCA...,2,-24,-12,12
AgcPRMWQbCeELUNdVHFYSKJZBaIXTfDOG,...PAAARAAAMADA.QAGAeADAEAGALCCAdBEAHCCBSCFHhAAAZCFBaBHD.TEGAhABAOEAAACCBgGGAhBIAbEGDCEEC..NIEB.FHDA.....hAEA......hBAA...,1,2,-13,15
fNYTCBLKOMHdJAFgXDbQaUIVSceRWZGEP,XAAAQAAAUADASACA.RAEFGAGAEAFA..fAHAhAAATDAALDCBhAAAMCGBHDBAAAIBDDIBaCHDhABAIEEAeEFDZFDFPEGBCFHABHHAdGAA.FGDDhADA......hAGA...,2,-1,1,2
gdFQBPSGWXJMfZceKALDUTObREIYaCVHN,LAAATAAA.RADFEAFEaACA..HAEBdAHAQCAASAGAGCCAhAAAJCFB.ZCGBeDDBhABAAAGAODBH.bFECCDHAgFCDhACABGHA.XFGAMIDA.KGFDhCAA......hCFA...,2,-10,7,17
ZQBSaONTgbXLcEWYDeAIUJfGHMFCKVRdP,UAAAGAAAHADAMADAKAGCRAFAZCDABBHA..aCHBOCBE..TEBAhAAAXCEDLEEBhACAECGB.DDIBADABIFAAhADAFGGACHFA...dFFA.SDHHhAFANIABcFCD......hBAA...,2,-28,1,29
BCLdGZNWSgUKIDOEYbfPRFaecQHJXMATV,TAAACAAAGACA.ZAEASACB.KAEAOBHD.ECABbAGBhAAARCEBFEGDeCCA.HCFBhAEAMAFAABIBLFDBhCAAdGCA.gFFADEEBfGHA...hCCA......hDAA...,1,-8,-21,13
HCJbUYNgfQedOcEAWRTaXKZGVDLBPSMIF,RAAAaAAAZADBGACALAGBBAEA..MAIBHAFBCBFA.UDFB...hAAAgEAAeCCDdDAAEEEAhABAAAHA.TEGAKEDBDBBBhAEASFBHFFGHJHBANBIA.QGGB.hBAA......hBHA...,1,-3,-10,7
WBbGFQEdDSfMCOeXZHYVcTaUPLANKRJIg,RAAAJAAA....IAEABADBGAEA.EAGAdAGA.SBHHhAAAMBIB.eCCAHCCBhAGAVDABaCGDLFFAhBAAACCAKDEA.bGDCQEGACHHA.ZGBE.cFFChABA....hADA...,2,-18,-12,6
aNGOeIYEFbURXZPScKTHBMWDJAfdCVgQL,dAAACAAA.QADAaACAGAEAeAFA.EBHFFAGA.RBCBZCGB..SCAAhACAKCBDHGBAMDIBhAAADCGBADDAfDEAhADA.LEHBOFFBIHGAbFFBXGAAhAGA.....hBCA...,1,1,-18,19
CFRQAMVDGHJbdSNecaEZgITYLfXUKPBWO,MAAAGAAAHACCdADAeAFAEAFEZBFE..TCEALCCB.XDGAhAHAKBHBBDDDCEEARFGBAAABDDHBhACASBBDaDBD.gGDAhAIAfEFA.PFAB.FFHD.hBAAQGCA.hCAA...,1,-5,-6,1
YETfaVeBMIAZFKSXDRLQdWbgGHNUJcOCP,ZAAASAAARAEAdAHA.....bACDHCAAUAEAOCEB.CCGDEDHFhABAaAGEeCFA.MDIBhAAAAACAXEAALEBAhABAQFEAGGEBJHAA..cGGA.hAHA......hBEA...,2,-13,-6,7
GaZCYbAdSRfULKTEPFXVMBWgNOHJcDIQe,RAAALAAAEADE.XADDMAFABBFA....gAFBhABAHBGBDCCAeDDBZCAAbCFAAAAAdFFAhBIASEDAKEHBFHGE.hCAAVEGBOFDHJFBBQGEC.CAHB.hACA......hBFA...,2,-13,-3,10
DSfOaLTCRZPIEGXUHJAdYWbBQFMcgKVNe,dAAA..bAAAQADAMAEA.KAFAeAHFSAHBaBDD.TCBAhACARCABZCFFEDEF.GFBBhAAAHCFAADABBEHBFDEHgEGAhADADGGA.LHCACHHA.IHHAhBAA...hABA...,1,0,-9,9
QSYGdUJFMTDPcaLBOIZHbXKNReWECVAgf,QAAAGAAAdADAFAFAMADADAIB..aAFELCFBBBDAZBFEHDBBhAAAKDBARDDFECHB..ADGASDGAhAAAUEDATGGAOFFAhAIAIHEA..XGGA..hBCA......hBDA...,2,-20,-7,13
UDSIHEOBRFZbcJPfWCGdNAgeKLXYQTMaV,eAAALAAAQADAaADD.DAGAHAFAEBFEBBHBRCAAZCEEJDHB..hABAfCCAGFABAAHAXFEBhACAMDEASDGAhAAAFGGH.bEEC.PFHD....hABA......hCAA...,2,-18,-2,16
dPXAMgRFbBfESYZOeVaUHLNQICcJTGDWK,RAAABAAAEADE.ZACA.eAEEaAFA.HCCALCCAQCGACBGD.JDABGDEBhAAA.KECAdECDAAIBMFFBhABAbFEA..SGCBhAAA.........hCAA......hCDA...,2,-28,-12,16
RHDGSVAcgKMCfPQJFaUILBXNbWTEZeYdO,KAAAMAAACACB...QADAFAEA.aAFELAHBBBBA.XBCAhAAA..bCDAEBGFhCAAeAHHdDDDHEFAGEEAhAGAAEHA.fDCEUFCAIGHAWDHH...hBAA......hBBA...,1,-21,-24,3
JdeIOVcNHfUgFMXCPaGKAZEDbWTQBRYSL,EAAADAAA....TACARACALAFB.eAHBOAEA.VBEBhAIAHCDBUEEBMCCBCBBD.GCGAhAAAABHA.bDADBCHAhBAASFCHdEHA.IFFAfHCBFGHD.hADAaHFA.....hAIA...,1,1,-28,29
BSfTEZYUXJOPaKWVGCAdDHMQIFcNLRbeg,HAAAMAAAFADDLADB.RAFAeCAASAFAECFBZCGBUCFA.OBBBhAFAaEEBKFAAGDDAhAGAAAFAdGGADDIBQFGAhAIA.cGFCNIAB.BCHA.....hAAA......hACA...,1,-5,-11,6
bdRHgAUQOVGIWSEBaNceFDXLfKZTMYCJP,QAAAGAAASADAEACABAEA..aAFDeAFHDAHBLCDBhAAAZAGBMBIBCCDAJCHB.dEADHEEAhAAAAADAOEGHIGGAhCAANIAB.XDCCKFEB.YHEA..hCDA......hDAA...,1,-10,-12,2
gaFULeEVQTMGScDZOABCbJXHWKIRNfYdP,CAAAXAAAHACAKAFCRADA......fAGBdBHAaCAALCEBhAAAECDB.TEAAGCFAhAAADCGBAADAbFCA.ICHAhABAPEGDFDDBeEHFMEIBSGHHOHCA.hACA......hAEA...,2,-14,-1,13
TUSbMFIPaDYVJNdGgfKZHXOBQcWALCReE,RAAAEAAAUADA..MADAFAFE...aAFEDAIBJBCAGCEB.KCCDHCEChAAA.BBHAQEEChAAAACCBeDDBTFFAhAIA.SDHHIEHAPHCAYHEAdGGAhABA......hCAA...,2,-26,-11,15
FVBdCSKNQYAPULZWMRJcHDIbTOfeXgGaE,LAAAZAAARAEAHCAADAEA..TCFAeAFAGBCBEDEB.BBHAdAHAKDHBhABAQCACAACAUEABMFGBhAEAIDFA.bDGDhABAfFHE..aDDHCHHD.SFFDhACA.NIDB.WECHhAFA...,1,-6,-10,4
fbGXNceVRUOAQFPLJTBHIECDYdWMgaKZS,QAAALAAATAEAHACAEAFE.DAIBdAGAMCEAaBHDZCAA.SCCEhABAGDDAXDGAhAAAeDFBREAAAEAAFEAABEEDhACACFGAgGFGKEHB.fHABbGDC.hAEA......hAIA...,1,5,-4,9
OdLKFCAXDHUEJRIMZPVTcSYWfbQgGaeBN,HAAAEAAARACA.ZADB.TAFASAFB..fBHAQCCBhAAAaCACeAHBBCFDdCFDLEEAhAAACDAAAEEADEGAIFFAhADAMDIBcGEA.YHAAWFHB.gGGBhACANIAB...hAIA...,1,5,-23,28
gNSHBCdcTYWaZGMKJQfPIVAbFLEXRDeUO,LAAARAAAeADE.OADDSAGBHAFAdCAA..TBDAaCCHGCGAhABAMAIBQCFDhAAA.fCCEhABAIEEAAAHAEEEBDFAAgEGACFCAcGDBZGFEhACAKGED......hAFA...,2,-11,3,14
JgLDeBNFRZUIbdSMTYHGWXCVAEcQPaOKf,EAAAQAAA.aACEfACA.LAEAeAEHFAGARCDAZCGBhAAAbBFDdDAAMDCBHDCBhAAAGGCBCCHAADCB.OFABhAFAKEHBDFFBBEFCIGGASFGA..YHCAhADA...hAGA...,2,-11,2,13
OSQbCBLacgZMTFYWAfKRVHJGDIdUEeXNP,RAAAHAAAGADAdADAEAFAeAFA....XBFAOBHDQCFAhAAABCADaCCCZDEBMCCBTFAAhAAAFDABADDB.KEFDDAIBIFHAhABAPDHDbEFDLGAA.gGGGhADA....hAFA...,2,-2,-2,0
EAPTSVGMJDeKObZfYcCIUFaRLHXgdBQNW,TAAAGAAAMADA.eAFAOACAZBFE...fAFAhAAACCDAFDCHRDGBHEEBdAHAQCCAhBDA.ECFFAAABSGDDhACADDHBbEDAIGHAaGHD.LHBAhBHA......hCAA...,2,-8,-7,1
QXCARLMHTKUeYDEfVZdJcWGFIBbNgaSOP,RAAAHAAAKADC.eACEDAGA.EAFEZBDEdAHA...JCCAGBGABCFB...hAAA.bDEAaCCH.ODFBhAAAQFFCABIBLFBAhABAMDIB.UGGA........hBFA......hCAA...,2,-24,-10,14
SWXDdfOHLbPQBAZRTGNIUeaMFKVEgYJcC,RAAAGAAAUADA.eADAFAFE.EAGA...JBHBSAHHDCDA.dDDAhAAAHDDALDGBbEACQFFAhAAAACCBZFEB.TGCAhACAaGCAMDIBKFHB........hABA......hCAA...,2,-27,7,34
badPSIURLEXNJQOWFGKZDeYMVHfATgcBC,TAAABAAAaACA..dACA..SAEHRAEAEBHF.JAGBQCDDhAAAFBCBZDDA.eCGDMAIBhAAAHEAAADHB.CEEDbGFAIFDAhAGALHAA..OEHD.KFFDDGFAhAEAfHFF.hAFA...,1,3,-28,31
gcEDfMAeXCOdVZIQPJLFKBRbGUTNWaHYS,eAAAOAAAZADB.QAFALAEABBBDRCEFGDBATCDA.aAHDhAFAHDGB.SBHBhAAAECFEMDBBADCBdGEAIEFAhAGAFGGH...bEGDWBAA....hABA......hAIA...,1,0,-19,19
XKZMEDRSIQJUabcBVfFPLCdeWGHYgONTA,ZAAAEAAARACAQAEA.UBGAbAFBBAHAFCAALDAAdCCDGCEAhAAAHECCOCHBAAHA.MDABhADASEHB.hCAAaFGBfFHACGEA......hCBA......hCIA...,1,-14,-16,2
HfaRGeSBCZUgJEWTMYOXKFcLbNQVPdIDA,HAAARAAAeADECADBZAEB.UBGAEAGE..MBEBOCABFCCBLCFAhAAA.QEFAhABAdCCAAAHAGECBBEHAJEHBTGCAhAIAKGCA...cFECNICB.IHHAhCAA......hCGA...,2,-19,-11,8
PUcCHZbLFEYSKRNQDAVWTeMBdXOIfGJag,TAAAeAAAdAEA.OAGBGACA..aAHDgAEB.UDFAhAAAHBCBZEBAbDFAEAGEKEBAhAAAQGGAAEEBMFFBXGGAhABAfHCBPHAACCAD.....hACA......hAIA...,2,-8,-2,6
gKAbcPMFfQZEULBRXYGTNIdHaWCeVDSOJ,...bAAAMAAA.QADAEAEALAHBRAFAGBBATBFAdCHAHCAAhAAAaDEA.eCEBDEEBOFEDhAGAKEADAEEBFEGAUGGAXFGChABANIAB.CHBA.........hACA......hAEA...,2,-7,1,8
bHGeNSEFMJfYULcOCIZPBdgWaKADXTRQV,TAAARAAAQADC.HAFBeACE.EAFEMAIBJBDF.UDDALAHBhAAACDGAZFAAdFGAaCCHACFADCCBXDFChCAA.GGDBhCHAFHAA...cEGD.....hAAA......hABA...,1,0,-14,14
dHgBPbaJWKLGIMZXUFESOTefRAcVCNYDQ,CAAADAAAHACABACA..aAEAKAEAGAGAZAGB.FCAAEBBB..OCEBhAAAeCEB.AAIB...VDCBhAEAQEGB.dFCAhACAbEGBWFEHLGCAXGGASGABhAGA......hBAA...,1,-5,-31,26
QPCFSUIbfVDKJNWAZLBREYXedMcgHGaTO,ZAAARAAAEADEeACE.dAFAMAFAHBGBGBEB.OCCBQCCBhABAFDEBUEGAbEEBDAIB.KEHBhAHANHBB.AFDABGGA..hCAA............hCBA......hDAA...,1,-13,-24,11
XVOePCYSabfUEcgQKRMJNABHTdLFDZGWI,HAAAdAAALADAZADBGAFA..XAGDeAHBCCAD.aCAEUEFBECEB.hACAQFBARDCB.hAEAMEEBAAIBTEGADCCBIHHAhAAAOFABSFCD.bGEC.hACA......hADA...,2,-11,-5,6
DXfKeJcPCRVLBHFZYETIAOaNMbGUWQdgS,aAAAMAAAGACAUAEA.dAEBDAHB..KAHBeBBA..JBFFCCHARDDALDHBhAHA.HEDAZEGBEFFFhAIAABBBOHCA..hBAAbGBAgGGG......hCAA......hCHA...,1,-13,-29,16
afLKgcSCZYNAOdJFGMQHXWEReBDTIbUVP,dAAAGAAAHADAEADARAGFeCAADAGA...TCEAbBFA..UDCAaCHDLFAAhACAKDGA.SEEAhADAZEEFAAABFFBHMDABhACAQFGABGDAIHHA...hAFA......hAGA...,1,-6,-13,7
KIOaegPJAVXMTBYNFdCDSfRUcEGZHQbLW,MAAATAAABADA.FAFAdACA.SAEARBBB.EAHBHBDCLCEAhAAAKBHBaDECeDDBJDHF.hAIAAAEAXDGA.hBAACFCAfFFAGGDB......hAIA......hCAA...,2,-25,-18,7
VfJUgEMSYDNdTZCcKPIQBeWaXHLGRbAFO,OAAAVAAA.UAEAEADE...MAHBDAFAdBGAZBCB.KCDA..QDFChAIAeCHH.aBBHHEEBhAAAREDB.AAIBFDCH.fGCAhCAASDHH.TGBACGHA.IGGAhBAABHGD....hBGA...,2,-25,-16,9
SefUWYVMFObCGRZPQdBDaNEIcAHKJLTgX,HAAALAAATAEASADHeAGH.UAFAVCCAFCAA..bDADRDDAZDGBhABAdDHABEFADAIBEFBAAACAKFEDhAAA...XGGAhAEAfGDAMIAACFFC.......hACA......hBFA...,1,8,-25,33
CIVUdbcEgOLHWaTZAYKBNPMSfFXeJQRGD,BAAAMAAAFADDeACA.RAFAGCAACAFA.UCDAdAHAEBBB.LCFBhAFAHCFCaEFDADDA..KDHBSEHHhAAA.XGAAhACAQFDCDHFA.IGGA..hBAA......hBCA...,1,-8,-38,30
JYAEGbPZaUMHfCNXLBdIgWRKTSeOFVcDQ,EAAAGAAAZACB.aADAHAEA.CAHB.LAGBBCBCdCEDICDA.hAAARDBFSCHHhAAAeCGHFEEBDCIBQEEAhACAAFHAUGAA.MFDBXGGAKFHBOHFC...hAGA......hBCA...,2,-18,2,20
edMOUfSWPCJVcZHAIXYGERFgDLBaQNTbK,XAAAEAAARACA.DADAaAFA....TAFAeAHHdCCD.MBGBhAAAfBDA.SAHBhAAACDAAVEEBHFCBhADAACFBGCGAFGHBBHFAbDBAOFED.UGGBhABA......hBDA...,2,-18,-6,12
QDVTFJNMUgbPGAXCWEeLRdHSYKIOaBfcZ,CAAAEAAARACA.HACA.KAFCaAFABAHA.ZCCAQBFDDCEA.FCAAMCHBhAAAUDEB..bDFDAAIBeCHHhAAALEAA.SFHHhAEAODABfECA.TGGAhACANEEA.....hCAA...,2,-20,-19,1
VTUbGDRXAcYLHNBSQFIZJfWeKOaEdPMCg,LAAAHAAASACEQAEAZAEBJAGBeAHBKCCBECAA..dDHAMCDBhABACECD...TDGAhACAGEEAREABACEBNIABFGHBfEEAhAEA.aFGC.gGDA.hAAA......hAIA...,1,6,-17,23
bASOKGTgXfCLBEZedQVNMcPYaRJHFUWDI,KAAAGAAA..TADAfADALAFBEAFAZBFEeAHB.dCAAQDDChAAAMCCB.PDGBhACARDDBHCGBFFAADFGBADABOEHDhADACFCABFHANIABaFFH.WHBAIHHA.hAFA......hAIA...,2,-5,-4,1
gEeUQPXKHALCbTcaJOMIFDZVRdYBfSWNG,LAAATAAA.aADDMACA..DAFARAEAdAHABAHA..SBDDhAAAGBEAEBGBeCCDQCAAhABAKCFAHEEAACIBbEFDhACAODHF.ZGEAfDDE.NEIA..hCAA......hCEA...,2,-14,-5,9
bdEQXcGFPAOHKZIgCTSLWMefNRVYJUaBD,HAAAZAAACADBLAFAeACERAFF..VCCAUCAADAIBdCFA..ECHBQDDAhABAGEFAAEFBKFAA.hACA.TEGAMFIBfHABhAAAJGAABGGD........hAFA......hAHA...,1,-5,-24,19
UcFBNaHbZQILJMGDgXYWKATPfROVdCEeS,TAAARAAAdADA..EAFAeACE.UAFABAHAHCCAZCCALCFBhAAAGDFAXECAKCHBAEEB.OAHFhAAASEGHFFHDaHDAhBDAQFAA.MFIB...YHCGhABA...hCAA...,1,-3,-17,14
UITGdRNDYBLCVcWFaOSJPQXbKEfgeAHMZ,HAAAZAAAUAEAGADARAGB.DAFALCABCAHA..VCFAFCCHODFBhABASCAA.QFBAhAAAKDHBEEDF.eEFBhACAAAIBMFHBdFHANICB..BGDAWDAAaGFD...hADA......hBFA...,1,-5,-20,15
RBEgfAdXcJMLPeDTKOUVSQYNHaIZFCGbW,dAAAXAAAMADALAHBDADA..TAFAOBDA.UCCAQBDChAAAHCFBZFDAGCGAhABA.RDEBEDCBABHBPEHDhACAeFHHSAHB.aGDBCHHD...hBAA......hBCA...,2,-18,1,19
cRLAgbCWVMJSGUKIaYFPHQBNZOfXdEDeT,CAAAMAAAGACAKADA...aAEAFAFA.HBBAQBECZBFEODDBdAHAECABhAAAeDHB..RDFAAEEBbEFDhAIAJFFF...SGDBhACAIFEA.BHBANIDB.DFIB....hBCA......hBHA...,2,-15,-11,4
JNIGSFWHQAbYKgZRBOcXfTEdPeMaVCLDU,KAAARAAAOADA..fACBEAGA.eAEEaBDDLCCDhAAA.DBIBUCCA.ICFAhAAAGCGAFDEDHCGBhAHAACGBbGFAZFBAXEDA.dGGA.MAIBhBFA......hCAA...,2,-15,-14,1
TaYeScJHPMUXfBZEKDGLOVNFbdRIQgACW,TAAAeAAA..SADAHACBMAEAXAFDZAFEECABGCEBhAAA.LEEAOAHFFCCAhAAAREBBQGGAhACAADFAaDFEcEAAPHCCBEED.DEIB.bFGD.dHAB.hBEACGFA......hCHA...,1,16,-7,23
IcZaTAHWJCNLYfEgRMBVebPXGdQSFOKDU,HAAACAAALACAEADERAFFBAHB..eAFHXCAAdAHAQCCAhAAA.ODABDCHBIDDAhAAAaDFDADHA.NCIA.fEHAhADAMDFB.PFEBGFABKGGDZGEE.hAEAWHFA....hACA...,2,-14,-9,5
fTGRLFSVdgXPZEBINYbCMJeQDKcAWaHUO,HAAAOAAAGADARADALAGBSAFA.dCADXBBCEBHFBCFAhAAA.IEFAbCEDMAIBhAEAeDDDQEGChBAAKDHBAAFAaFGDTGCA.FDDB......hCAA......hCGA...,1,-3,-9,6
NKaZAeJPFGXSgbUCTOMVfWIDHRcEQBYLd,eAAAFAAAGACA..SADAUAFAOAHFMAGB..VDFAhAEAfAHA.DCCAhAAAHEBAECEFQDGAhABALFFA.dEAA.aDDHABEA.XFEACHHA.hBAAIHAA.BHGAhAEA..,1,-4,-21,17
GAaIcPBEXYHbTgfROCNLJMWdFQSeDUZKV,aAAA..IAAABADAEAFAHACA.bAFBTBGA..RCAACAHALCCAhADAMCEB.dDGDQDFBhACAeECAZFAAKFFAhAFAACHAXEAAfGHAODHDWBBDDFFB..hAEA......hCAA...,1,-9,-12,3
BWgNRJITSHUbdZYGAfeDMVQEcXCOFPKaL,eAAAMAAA.EADACADA.FAFDKAFA..LAHBBAHB....NBBA.RCCATDFAhAAAHCCA.dFFDGCFAhAFAABHBDEEB.QECBhBAAOFHD.aCHF.gFGH.SHDAhBCA..hCAA...,1,-17,-25,8
OXaVMcLNfUWgEKYZFQdRJCDePHITAbGSB,GAAAOAAA.aADAMAEALAGB.UCDAEAHFZBBAdEGA.RBFBDBDAHDBBhAAAACIB.BFDA.XGBChACAVEEB..fEHAhBAAKGFD.FGHDCHHA.eFDD....hCAA......hDAA...,1,-8,-20,12
dTHVDLeQZCWgYacGSIBNRKAUXOMFJbfPE,OAAAMAAAFADD..JADB....bAEDEAFAHAGBLBHBZBBFCDHA.hAGA....gCEAhAFAaEEAGGBBBBBDhAIARFFAAAIB.fEFA.dFCADIFAeFHB.hBAAYHCG.SGGDhBAA,2,-16,-16,0
baWAKNDMdQgUFcCHBEPRZYVXTJOefGLIS,DAAAdAAAQADAFACDHAEABAHBRAFAZABB....XCDDTCGAeDCAhAGAGCGALEFAhAIAbEAB.AGEAMICAUFDAEGFEhAEAYGEG........hBAA......hCDA...,2,-16,-6,10
aJQKAZdgXEbNVHLYfICcSRFTGBWOPeDMU,dAAAEAAA...VADAHACALAGBIAGACCBA.RCCAGCFABDAD.OAHDhAAAeCHHDDDAMEABUEEAhACAaEEHKEHBZGCA.bFAD.hADA...fGHAFFCBPHDAAAIB...hBAA......hBCA...,2,-22,17,39
DHYFGEgReZSCUfXILBMJVTNbcKdaQOWPA,HAAAGAAARADFeAFEZADACAGB.UCAB..XCDALCFABBHAMDDBhAAA.JEEATDGA.hACA.bGBAdEAD.aECDQGGAhADAOEEBAAABFFGH......hACA......hAEA...,1,3,-23,26
PKZCEIRWHVDFUAMTSXJOefGaYdLgcbNBQ,MAAATAAA..XACAeACEGAFA.dBHALAFA.hAAAbCCAQCCAhAFAZCFBECHFRFGBHGAAFDBHAAHAODFHhBDAaBBC.gEGHNEEA.KGHB...hAGA......hAHA...,2,-4,1,5
ELDcSGOPMFKZYTIAaQWfBXJdVHCbReNUg,aAAAQAAABADA.dADAHAEBRAFA.eAGBUCFBEBBBLDBA.hADASDHHGDCAMAIBhAHAZFAATFFAAEEAXEGAhBAACGED.bGEADGIB........hAAA......hAFA...,1,-1,-15,14
BSKbeHLRTNDaYMWZQOfCdGUgFIJEXPcVA,KAAAHAAARACF.TAEADAEA.MAHBZAFE...QCABCCAAGCDA.FCEHhAAA.EDCF..XCFAhAAAcDGCAAIBBEHAeEABhACAaFFBOFFB.dGCAgGCBIGHA.hADA......hAEA...,2,-35,6,41
JgHBOfESULDMcFeaKWRPQYXGZCTNIbAVd,dAAAHAAAOADAEADELAFBDAHB.MAHBeBDBaCACRBFB...QCCChAAAGCBAZEFATEEAhACAIFDAAAIBJDHBBDHAhACASFCBFGGB.KGED......hCEA......hCFA...,2,-21,-2,19
VZbUXIATOWDdHEGPafRMegCKNJLYBFScQ,TAAADAAAHABC.EAEEaACA..RAGF..eCCAKAFALAHBFDED.hAGAQCCAbDFD.hAIAXCEAACIBdFHAfHEBhBAAMDBBCEFDJEHB.SFAD.ZFCAhAAA.OHCC..hAFA...,2,-10,-10,0
BKVbFaLdPNeOETXARWHYCIgUDZMfQcGSJ,HAAACAAAUACAZADB.MAGB..QAEAGCEABAHAKAGAFCBHdCADeCHBhAAA.EEGFACHARDDAIFBAhACADDGA.SGHBhADAbEGD.aHAALFFD.NIAB..hAHA......hBFA...,1,-4,-28,24
aLESNDOecGVMZPXdAKFHBCgRfTQYJUbIW,HAAACAAARACA.TAEA.QAGCUAFA..bCABaCAC.ECCEDAIBhAAAeCHFGCDAZDEBdEAAhAAAADABBDFBfECAhACA.IGGALDHBNEIA.OFFBMIAA.KHBAhACA......hADA...,1,26,-27,53
RPAaVNYSgHdUIKeEFMcDLTJbfZCWQBGOX,aAAAVAAA....SACHHADBdAFBKBGDEAEAFAGDMAIB.LDAAhAAATCDA..bDFAZDFAhADA.QFFAhCAAGEAARFCFAAIBYHDAIFFADEEBCFHDBHHA..hAEA......hBAA...,2,-12,1,13
VcBIJfNeQDEbaOARMFUSXZdKTPYHWgGCL,RAAAMAAAFADA.UAEAZAFB..dBHAKAGA....TCCAHBBBGCGAhAIALECABDEA.fEBEhBAAeEGBEHCAaGGHhAAAABBBXEDC.PGDC....hBDA......hBEA...,1,-20,-24,4
EHeSaADKQOLZIGNTUCgJPbfXBRMVdWFcY,QAAAZAAAGAEAUBGACACA..JAEA..bCABBAHB.RBDBdCFAhAAAFDDBEEFAHDGB.eDDDhCAAAADAOEBDLHCATFGAhABAfFFE..MIAA...hCHA......hCIA...,2,-15,-11,4
QGCNFVgbSRAYDKefOZJLTWdXaBPHcEUIM,KAAAeAAAZACBLAEAdAFABAHAHBCA.EBHFMBEBGCFA.FEDB.hAAAVFABSCABhACA.ACHADDFAODHDJDHB.hAHAWFFD.aGHHPEFB...IFBAhBFA...CGHA.hCCA...,2,-42,7,49
JZecHdNbaUVXPSTKWLGRMYCFAIgQEDOBf,QAAAEAAABACAZADBHACA.dAFAaAFDXBGD..TCGAhAAALDDBRDEB.MDFBhAAAFAHFACCADAIBOEHDeEAAbGEAhAEAVFBAKHAA....YHFA.hAHA......hCAA...,1,-2,-14,12
AaYPDBTfSHGWUEFbdeILZKJQMXCVRONgc,aAAADAAABACA..TADAHADBGAGA.EBBBdAFALDDAhAFAZAGBQCCCMDIBCAFARFDAhAIAOBBH.gDFGhADAAFDAfGHESEEDFHFC.eEHHhBAA......hBIA...,2,-23,-6,17
NGZLDFgecEBUdTSHRMCfbAQXPYVJIaKOW,QAAAXAAA...VACAaADAOAFDGAFAZDDBLAHBhAAAFAHFeDHBEBDBdDDDHFABREBBMEGBhABAbFED.ABHBPEHBhBEAIGGA..NIEBDFFB......hCAA......hCBA...,1,8,-5,13
FAUNIMeCdELZbDWYQfVaJHgBXcTOKSRGP,UAAAMAAAdAEAEADAZAFBDAGA....QBBAaAHDHCBCBBEA.hBAA.TBGASDADhADARDCAGEFAADHAeEEAbFDD.hBBAfEHAJEBF.XGGAKDHB.FHBAhBAACHHA......hBCA...,2,-13,-2,11
cOgUbdXGERFAPMfNCHYVTJQZBaeILKSDW,MAAACAAAHACA..TADAZAFBeAHF.LCABDAFAOAHDUCCBdBBAhBAAEDHFABGA...fEFAhAAAVCEAQDCDhCAAaFAEKFHB.SEGA.gFFGhCBAbFCD.....hACA...,2,-11,-9,2
LUVZBFdIHfQWGbgOYXCRDKEcPJMNSTeAa,aAAALAAAZACB.dAEAHAEAQAGAGCEBOBBBCCAA.RECAEEGAhAGAPCCB..MFIBhAHATDFAAAIBBGGAFEDDfEHAhABA.bGACYHCAKFFD..hBAANIBBSEBDhACA...,1,0,-17,17
AcSFXHTUJCQaKRdeIMGOEZgYBfPbDNVLW,FAAAHAAAUADAQADC.RAFFeAHHGAGAECABZCCABCCD..hAAAbDBCDDEBLFFAhAGAADFBXDGATFBAaFAAdFFAhACAMHFAOHAA.fHGFNIAB..hAFA......hAHA...,2,-12,2,14
NYIQeHJBXFEADVLOPbKGUaRWSMZCfTcgd,LAAAOAAAKADAaADD..RAFF.MAFAZBBA.CBFA...TDEAdBHA.hABA.ICAAHDGBXFAAhAFAACCBDDDA.PHCChAHAGDEBUGGBfFBANAIA.eFFA.hBAAFGHD.EHCAWDDD.hACA...,2,-17,0,17
aKCEUWBHSeGPYgNXAFbTdIRfcDZOMLQJV,TAAARAAADADAZAEE..MACALCCA..QAFAaAHD.hAAAEBDBBCGDHCEBeDHFhABAGDGA.gEBAhAAAAEEAdFFAfGAAOAHFKCCDCGEC.SGDAhBEA.NIEB...hCAA...,1,2,-28,30
ZDbdWIVJEXKPTUBegGOHSfLQNCFAaRcMY,RAAAMAAAZADBdAGA..IAEAECFB.KAGAUDAABBBAGDGA.hAGAHEEBLCDAQGBAhAAAFCHBACEAaDBBDAIB.bEEBhAIA.....JEHB.XGFD.hABA......hADA...,1,-11,-21,10
cfWIdZQTAGDYbORSUEaCXLJBHMFgeKPNV,GAAADAAAOABERADAEAGE..CAEB.LCDAHAFBMAIBeCGH.KEADVCCAhAHA..fEEAhAAAdEFAZEGBAFIB.bFCDaHBABEHAhACA.FGGA.........hBAA......hBHA...,1,2,-25,27
UIYKaGSHBRONgFJCTdLWQceZPVEXbMADf,DAAAUAAAKACAGADAHAEBRAGBOAFA.FBGHTCCA..dDAALEABhAEAQEFAeDFFhAGAZDBBEDHFMBIBAAIBfFHAhBAAaFDBBFHB.NEEA.CHHA.......hADA......hBAA...,1,-7,-15,8
OHTVUfAIGKZEaLRbcXWdQBegMSDPJFNYC,GAAAEAAARACA...bADAXAFB.dBHAeAHB.MCDBDCCBFCFHhAAACCEAHCGBUFFAAAABZEEFhACAaDABLDDBQEABhADASEHBNIAB.OHCCfGGBhAEA.IGDA.hADA...,1,11,-18,29
eIEBFLgCaQAfVYNdHbOUTWcXJRPGZMSKD,VAAAdAAAHADA.OAFAUADA...TCBAXAFA.RCEAZEEAhAAAMBIB.DCFAEGAALDEAhACAaCHD.ADABfFDAhADAbGEC.cFFA.....hAGA......hAIA...,2,-21,-15,6
gGcODWefAXZBIEFRbJVSUHKPLTNQdaYCM,ZAAAEAAARACAJADA..UAFAHAGBLBHB..TCAAdCCDaDABMCEBhABAGDEADCFBeDFHhACAADGABGGAFDHD..SGEDhAAAKGAAQGGA......hAGA......hAIA...,1,-16,-19,3
ELCXZWGJcTbOKAMFDeSgNfHBYdVQURPaI,MAAAeAAA..SADA..fADAHAFBdBHAQCCAhAAARAEFaAGAEBBB.LEABhABAZCFBGEDATEFAhAEAKCHBADDADEIBBFHAVFDBIHBACGHD.XGGChBAA....hBCA...,2,-22,8,30
cTSfLabIXKPDeVJAQUZOHgWFENRCYBdMG,ZAAAHAAAFADARADFBAFBGAFA..TBGALAHB.aCAAXCAAhAAADCEB.eCFBADDBQEFBhABAODDBEDHFCFDAdGHAhACAMEFBSHBAfGGA.KHAA...hBHA......hDAA...,2,-17,2,19
fNVUeRKMGCgIbaQTYcEWJBdAXSDHFZLOP,DAAAHAAAZABELADB.OAFAfAFAUBGBRDEBGAGA.hAAACCCA.bDGDaCEC.TDAAhADAECABBCCC.ABFBFGEHhACAPEEB.eDHH.MFABIHHAQGFDhAFA....hAIA...,2,-13,-3,10
LbUWJSHNAMeZaKPEIfCGVdXgcYFBDRTQO,eAAAaAAA.EADACADAGAEAdAGA....XBDA..gAGBhADAFCCHRDFATEDAhAAALCCBUGBASFGAhABAHDGBABBBZGBAKEEDfHFBcGGCDIAA.hAIA......hBGA...,2,-14,-11,3
ACYeNgDcKMSVdZfUPaWJHXbQLRITBFOGE,eAAADAAAMADAdAEAZAFB.UDBAaAFE..HBBAQDGARCEABBHAGEBAhAIAAAAA..CAHA.gEEAhBAASDEDfDHAhBBAPFGBJHCAXGGA...hBDA......hBEA...,2,-26,-7,19
DKbcgRQVXUOMTPZCHSeYfIBLdJNAWaEGF,EAAAGAAAKACA...bADARAEF..QAGCUCDAMAHBZCCF.HDGBhAAAeCHH..fEAAhAEALDFBdEADACIBaEEDDADAhAAAgGDGOFHDCHGD.SGGA.hACA......hAIA...,1,2,-11,13
FaeKZbfQJETBGdXPDARgYMWCOcSUNHVIL,RAAAMAAAOADAUAEAHAGBLAHB.FBBAeBDF.ZDFAQDDAhBAAEEDFGGDBdEBADCCBABHB.hBEA..gGBDhAAACDFASEGA.IGGAaFFA.KHEA..hBGA......hCAA...,1,1,-25,26
XDcYPHObNJdLgZVUIRSECfAQaFKWGeTMB,aAAAKAAAeACEBADA.DAFA......PAFAHBCAbBFDdCCAZBFAhADAUFDARDFA...EAHFABBBQEDDhBAAFFGA.hAAATGDAMICAXGGCOHFC....hCAA......hCBA...,1,-18,-19,1
SdeMNcRPXFQTHEUCgIVYOJGaZDbAKBLfW,LAAASAAAeADHMADARAFA..FCAAHAFCUCFBCBCA....gBEGhAAAIEDAODHDhABAaCHDZDDAAFFBBFAAdFHAPHDAhABATFFAEGEB.....YGAGhACADIAA....hAFA...,2,-21,-5,16
OBGZHSPcfKCNMYDaELeQWJFXdUVTAgbRI,RAAABAAAHADBSACA..fAFBCAFAMAHB.aAHDECAAeCCBhAAA.QCFDhABAFCDAdDGDTEEAADAAbEECGGEBhADAZDAEKFAADAIBLFBBXGCA.gGGAhAAA...hAHA...,1,9,-15,24
TVZUYDOSFfKgXNeEJIRLACcHdQaBbWMGP,HAAAaAAABADAMACAGAEA..TAFAZAGBDBBBFBDD.KBHBXCCChADAECFBRDGFAAHA..dEEAQEEBhAGA.bEGDhBAAWCCDUGBASFHHNIEB....hAAA......hCAA...,2,-17,-7,10
YPHMXgWZVARSIcNKfeEdaCbOLGTBUDQFJ,RAAASAAA..IAEAKADAEAFEdAHAaAFD...OCCAhAAAGBGATCFADAIBQCCAhAAAFDAAJDDF.HDABhABAMDIBXEDAZFEBAEHBfGGAeEGDLHAAhADA.....hABA...,1,1,-18,19
MaSYAEfcIJbPNGTdLXQOWRUFZCVBKgHDe,EAAA..fAAAJACB...bADAGAEAdAHALCBAhAAAQAGARCEFZDAABDDAHDGBhACAeDFHaFAAACCAIDHAhAAATGEAOHBCFEAAKFHBMGAAcGGDPHFChAEA......hAGA...,2,-17,20,37
VfTgNJZBLCSeMDQdcARWbFOUXEKPHYIGa,RAAAFAAAOADAEADA.HAGBGAFA..aBDDTCCA..gDCGhAAAZDAFLAHBeCFBhABAMDFBdEHAAAIBbEGDKFEAIHBAhADAfGBABECDDHFAWEED...hBGA......hCAA...,2,-13,-1,12
UDBcOaRgVfWIHbZFTXYeCGJNMKSPEdLAQ,QAAABAAAaACA.RACA...VAFA..fAFBHBCAZCFETEDAhAAAeAHHGCDAhAAAMCBBKEHBECFBADAA.DDIBOFABhAFAgDAAIGFAbFFBXGCChADACHEDSHGA....hAIA...,1,8,-14,22
BZUNcXdGMbgHWJVCTAEIOFeLQRaSfPYKD,EAAAFAAAeACHRACA..aAFASAEA..fBFAhAAAKAHBZCEAUEAAXCCAGEEAhAEAbCGDHFCB..VDABhADAACFAIGHALEFD.QGGChAIA.DBIBBDDDdGDA..hAFA...,1,14,-15,29
AeKPQCbGNILRcYaXJDfVMBZgUESHWFTOd,eAAAQAAAGADALADARAFA.aAGDDCCB.MCHBZCBEECFBHDEBhAAAFCHDdFAAAAEA.CFHAIGDAhABAXEEC..fFGAhAAABGGD.SFHH...hAFA......hAGA...,2,-18,-12,6
LOfcYXHWZVbNSRgGdBFJDUAMQeTEKaPCI,eAAAEAAAKACACADA..LAFAOAEA.....fCCAhAAAXBDAHBGBZCFA.bDDCRECAdEGAhABAFEHDDAIBAAGAMFIBaFFB.hAAAIHCA.cGFC....hCAA......hCBA...,2,-19,-19,0
fUSVCcdDXLYHaIQZRWJNOgEFbTABGMeKP,GAAAeAAAKADAUADA.CAFA.dAFALAHBHBGBaAHFZCDERCCA..JEEAODBDhAAA.FEEAAAAAMEIBhCAA..SEGHhACADGGB.IHBA.NEIA....hCBA......hCCA...,1,-15,-27,12
WXLZRQDKUTceJMSafYbCPgOGdIHANFBVE,BAAAEAAALADARACAKAFC.UCBA..eAHFMAHB..aCAAbCFDCCEA.hAAA...OCFDhACAdDDAHFAAACIB.FFHDXDAChADADAIBJHEA...fDDE.gEGHhCEA.IHHAhDBA,2,-31,-19,12
PZAdJNQVCWRBgHXDTcaLfbKeGOMSEUYIF,dAAAQAAACADABAFA.HACA.DAEAaAGDLAHB.KBFAeBHHhACAGCDAMCCAEDFEUDAAhADAFEHDAFFA.JHBAVDDA.hAAARFGB.XGGC..TGDA..hAFA......hAIA...,2,-25,0,25
BcVgUQNAMbaTfOHXRWEPFDLCKISdZJYeG,aAAATAAAHACB.RAEA.EACEDAIBLAEB.KAGAdCGAZCCBeBBDGCGAhAAABDEA.VEABQEEChAGAAAEAMDIBOEDBhAHAXGCCFFFASFHH..cGDDhBAANIDB.....hAIA...,1,-2,-8,6
UBXbZAIFQaCOHNEfLJcWRSdGPMVDYegTK,QAAAaAAAHACBEAEALADA.JAHBRAGBGCEA.MBBBhAEADCDAeCFFTEGABDDAhAAAZGCAAAIBCDHAOEAB.hBAAfEGESEDDdGGD.PHACgGGAhCAA....hCGA...,2,-15,0,15
RIXQFLDHZPJWbNdfUeMBgTcACVGEOSaKY,GAAAEAAA.aADARACAQAFCLAGBHCDBZCCA.JDHB..bCGDdDCChAAAUECAeFDA.MIAAhACATGEAABGBOGEEKDABXGGBhAAADGIB.PHAA...NAIA..hAIA......hBAA...,2,-3,5,8
eSbHMYVWaPfIAOZBdQUcXLCTKNJFgGERD,ZAAAdAAAQADAUAEALAHBKAFA..FBHDECAARCAA...eDAAHCFBhACAMDEBVEDB.aFHBfDFAhABA.AACABBGBhBEACHAANIEB.JEHB.DFDB.SGFBhCAA......hDFA...,2,-19,-11,8
eAFCOPYDJZTdIXLcSHgfMWGURNEBVQbKa,OAAADAAAZABEdAFALAEAHBGB.MAIBGCCARBBABCEAQDAAhADA.aAHFAAFACCGA.JDDFTEFAhBAA..XFEDhBAASEHH.fFEEUGGAEGCB..hBFA......hCAA...,2,-22,-11,11
aUfTZIWGQdMKeCYJgLbHPcARXFNBSVEOD,RAAAFAAABADBEADA.DAFAUAGA..ZAFEGBEAdCCA.eCCBCCFA.JDABLCHBhAAA.HECChABAADHASECD.hCAAaEEHTGEAQGFAKGGC.bGBC...hCEA......hDAA...,2,-29,-7,22
fBJVNWEYXcIbaCULZQHeMGPdgOSKFATDR,RAAABAAA.JACAVAEA..EAFE..XCCA..bBCCaAHDhAAALAHBHDAAeDFAhABAGCFAdFDASFFAhADAADDATFDADEIBfGHA.YHAAhAEACGHD.....hAAA...,1,5,-36,41
FTGdJVMZQSaePDXbKYNgOcAfEIBULWCRH,EAAABAAALADARACAHAFBGCAAdAHA.MAIBZBCAaCFD.DDDBbCDDKDHBhAAA....gEGAhAAAAAEAIFFACCCDTGEAhACAJFHF..SEDHeFAD.PHBAhBHA.....hADA...,2,-19,-8,11
UaBQFefcJKSgHbZDRVTANdWLPYXCEGIOM,dAAALAAA.XADDEADAGAFA.MAIBaAFAFBGHeCAAJCAASCEDhACA.HDGBhADAZDEARFBAAAHB.PFFBhABACFBAODDHBHGAQGGB.cFDDhBAA......hBCA...,1,-4,-19,15
LTAPMZbXYFgdEINWOHaSeKJQfBcVUGRDC,ZAAAXAAAFADAdAGA..EADA...IAGAOBHDHCAA.hAAAeCEBQBEDhABABDGDUFCARCGFLDAAhADAAFGAMFIB.bEED.gGGBaGBBKGGB.fFDAhAIA....hBIA...,2,-18,-11,7
THMFLJESQgUKWbdDNfcRPXZAYaBVGOeCI,aAAAGAAA.eADATADAHAGB.MCDBLAFBECEB.QCCChADAKDGDdEADDDIBfAHAhAHARFCAXGGAABBBBCHAhBAACGBD.FEEASHFGgEGH.bFCBNIAB..hCAA......hCFA...,2,-10,9,19
WNUOZdgGBHPXSRCMQAaELcIVKDFefJTbY,EAAALAAA.VAEAFACDeAEA.TBGA..bCAA.NAIA.hABAZCDBGDFAHEABSDGAhAAAREAAMEEB.AAEAaFDEhAIAKFHBfHABJFHBWGDA.dHDD.BHHDhACA......hAEA...,2,-6,-2,4
CLefDGIHdAbcPgBKETQYFNOJWZUVSaRXM,...bAAAgAAA.EADATAEAQAFAFAGAOCABhAAAZCCASBHBRCCAMCGBeCHBhABAGDAAHEABAAAABDGAhADAKEEBYEGBWECBaEEC.LFHBDGIB.hACAIGGA.cGDDhAIANICB,2,-11,0,11
HfSMXWLdFVPRDeJCNTQBYcbZOUIagEAKG,HAAAMAAALAEAdADAFAFARBEF.eAHH.CBBA.TCGABBDD....hAAAbCDAZCAA.OEEBhACAaDHDAAFAGEEAXFGAPFCBhBAADAIBNIEB..........hBBA......hCAA...,1,-9,-19,10
RUAHLVFOBGZCNDMEfPWKdcJbgSITeYaXQ,HAAALAAAOACAZADBDAGAEAFA....fAHAKBFAdBHAJCABSCCAhAAA.eCEHhCAAaCCBRDEAACCABCGDGFBBhABAMCIB.cEGCbGFA.gGGGhDAA.IHEA.hACA...,1,4,-24,28
bFSdVfgOXacQGWTYPLBDMIAHRNJEKCZeU,HAAARAAAEADE.ZADB.eAFAFAFAdCCA..fBHAOAHD.aCACGCFAhAAA..TDEAhAAALFCAMDIBAEEBKEHBhABAbEGDSFCA.XGACWHDABHHAhCAADGFB.....hACA...,1,-9,-18,9
SWVbGdNUEHBFeXZcTYQKJfRCIMOADPgaL,DAAAaAAALADA..SABA.bADDdAHA.EBBBHAFAhAFAeCEBZCGBTDCAhAEAQEEAfCFBhAFARFCBMCCBADIBgEFH.WFHHNEIAFHAAYHBAhBAACHGA...hAHA...,2,-12,-5,7
ZWKfPVCBNgSETHdXDFAaYGQLeRbOIUJMc,GAAAeAAARADA.OADAUAGA.MAHBZCCAKDGA..VCDABEAASCHHhAAAHFCAdFFAFHGEAAIBaDBDhACA.LFFA.hAAAbGBA...IHFA....hBAA......hBCA...,1,-11,-27,16
dOLXPYVcBHNKCAZMDJSIQFfaUGTgWRbEe,ZAAAMAAASACEFADD.UAFAGAFA.TCBARCCAECHFeDFFhABAdBHALDEB.XFAAhAFAPEHDVFBAhAIAHGFACBBCABHADGGBIEHA.aHAC....hAHA......hAIA...,2,-10,-7,3
fVUbNDPdTHMgXLQIGFOAcSZYRCaKeEWBJ,ZAAARAAAKADCEADEBAFA..VAGBUCCA..DCAAdAHAHCDA.MDIBhABALCFBGEFAAAAA.SFAAhACACDHA.eFCHhAFAJFDB......bFGD....hBHA......hCAA...,1,-3,-43,40
LcXZUPIASTWQNbdKgJDYGaVfHRCOMBEFe,TAAAQAAA.dADAKACCDAFAGAEA.aAGAHBEB.RBGBMDBBhAAAEBGEeCCBLFFAhAIAZDGBIEBAABIBSDDDhBCAbEDD.gGBA.YHFAhBDACFFCFGHD......hBGA...,1,0,-8,8
YSKJfeXPaMBGgIDQOcFZbECHNVLdRAUWT,TAAAKAAAeACE..aACAGAFA.DAIBQAFAFBCDZDEF.EBDBhAAAHDGBLBHBAAHBUECAhAAASCCD.hAFAXCFCMIDABGHAOEEB.bFAA.CFGANIABhAFA......hAIA...,1,-10,-15,5
RJIKAfPcXBFGgdQVDbSOHTWCaZeLNMUYE,...fAAAXAAAGADAdADADAFAOAHDHAFATCGA.hAAAaDAAeBCDMDDBEBFAREFBKEHBhAAAADBBBDFAQFAAhABAbDGDCEDAZFBALHAA.YFEFIHHAhACA.FGFH....hBDA...,1,24,-15,39
bCYGTMPQUFSLJfZeKBDOVNIAcgRXaHEWd,RAAAHAAAEADE.dADA.CAFAGAGAMAFA..QBFASCAALCCBhAAAZDDAeDHHDBIBOFAAhAAAIEEAAAIB.XEGAhABAbFDD...TGEAFFFHKCEABCED.hACAcGGA.aHCC.hAFA...,2,-9,-1,8
XUYLWEZMQaOBCgVeHNADcTGKFbdSIJPfR,TAAAGAAAFADA.dAGASACB.JAEARCDAXDBDhAAALAHBEBEBZDGBaEFBBCCDCGBA.hACAeCFHAAIB.KEDBIHHAhBAAfEHA.UGGBMICAOHCA.hBCA......hBDA...,1,-5,-18,13
PEbVaBcdeHWCJNYRQKLgXIFAZDMGOUSfT,ZAAAGAAASACE..TADAEAFAaAHDdAFA.HBGB.CAHBNCDAhAAARCCALCFB.hACAXEGDADABMEEBfFFAhADAbFAABEECeHBGYHFG...hABA......hAFA...,2,-14,-9,5
fPEeIdZQVbBNWMaLJDXTSgUKOcRHFCYGA,EAAAeAAAZACBQADABAEA.MAGBaAFDLAHBDAHB.SCBDhAAAKCCARDEBHDGDCDEAABHBfFBAhAAA.dGGDhABAbDFDNIAB.JECB.........hAIA......hBFA...,2,-26,-8,18
WNJTMZdDfIQKELeYOBUScHgAPVabFRCGX,aAAARAAAGADA..XACDJAFAZCFB.dAEBDCCBQBFB.hAAAECHFeCHFBAHBSDABhABAHDDAABBBVFFAbFBA.hADACFDD....NIEB.MEIB.KGGB...hBAA......hCAA...,1,-13,-15,2
APSdVcCeGIHMKYQRgUXWLDOaJbTFNEZfB,dAAACAAAGACAHADAMAFAKAEA.RBFA.UAGALCCB.ODABaCAB.hAAAJDGBTCEA.EDGAhACAZEDBBEAAADIBSFFDhACAeEEBQGGA......hAEA......hBCA...,1,-10,-20,10
JdSKNbeGBMEYaVZcACPIFQRHOUTDWgfXL,CAAAFAAAHACAOACDDAEA......fAGALAEAdCEAKBHB.hAAAeAHHGCAAEDGBaEDChAFAZCCAACABQFGBhAGARDFFUFCA.TGCAXFGDNIEB.MIAA...hBAA......hCAA...,1,-4,-15,11
LDEIYcNdbSafTPJeBGVOXZAFKURQWCMHg,KAAARAAAQADCMACAHAECLAFB.EAHBICCA..hAAAcCCCbCEA.aCGDTECAhAHAeDHHGFCBhAAAODBBAAIBFGHDCEEBDCIBNIAB.dFGA.fGEAhBDA......hCAA...,2,-16,9,25
ZONDMXfbSCWTaUgeGFLEARHJcPVdYBIKQ,HAAAJAAA.VAEAdADABAFAKBHB.ZAGBDACA...MCCB..bCCAhAFACDDA..aDFAUEEBeEFBhAAALEHBAAHA.RGCE.hBAAPEHD.IGEAOHFC....hCAA......hCDA...,1,-25,-26,1
fHgaWUdKMZCSEJPBFGRLXeVDNObcTYAIQ,QAAAHAAAaACAdAFAZACB.EAEABAHA.RCCAeCGFDAHBOBFD.hAAATECAACCAIEEAhAHA..fCHAhAAAUFBAMCIBSCEDFFGD.LFFAhAIA.NIBBYHFChBCAKHEA...,2,-17,-6,11
cOZAQBfVbYGMJRdXHTNKgaIFeCSUDLPWE,QAAABAAA..bACAGACB.RAGFHCDCTAGAKDAAaCAAeCHHhAAAUCEBLFAAhADA.EEEBZDAAAEGBfFHAhAFAMCIBdEFDXGAANIAB.FGGADGGBPHDAhAAA.....hAGA...,1,5,-8,13
KeOWfNDQMBFJASUIcZEgHGVaPXRdYbCLT,SAAAUAAAZADAHBGBGACA..aAGARAEAdAHA.CCFALDHBhAAAeCBAOCED.fEAAhAEAQEAAMEDBhAFAFEDDAAEAEEGBgFEH.PHFCXGGAhBAA.....hABA...,2,-11,-4,7
eVbfMCQADITPGUBXHREKFSgdZacLWYONJ,TAAAGAAABADA.HAEBEACEFAEAdAGBaBGDLAHB.OCCAhAAAeCDBVEGBMCGBABHBDCIBhAAAUDDBRFEB.KEHBSDADhACA..gGGB..hCAA......hDAA...,2,-21,-5,16
gEKIfVOGCWLbdNYJUQDTeFacSZBMPXRHA,EAAAKAAA....IADAOACCGAFA.LAHBdAFAJAHBQCAAhAAAeCCBaCEHZEABhAAAMCDBREFAHFDBADGBVEEBhACACGHA.....bFBD.....YDHBhAHADEAB...hAEA...,1,0,-21,21
NFXYEgCfWaGAHecJUbPBDMKRISQLVOdTZ,HAAAeAAAUAEABADBMAFARAGB..QBCALBFAdCADZDEBXDGAhAAAECEBCDCA.aFHHABGAJDGBhAAA.DDIBSGFHhABAOEEB.NIAB.FGHB.......hAIA......hBIA...,2,-19,-13,6
PfdJeHINcRSVTUGDQBWFgAEZKYCLOaXbM,EAAAZAAACADBLADA.OAGDaAED.MAIBdAGAHCAA.IDEAhABARCBATDEA.GEAAhAAAQDGAFEGDAAEAXFCBhBCAbFFC.fGHAeGBANIAB.SGDHhCAA...hACA...,1,6,-21,27
AOLDQVbTdHKgeSBaECZfWNUMJcYPRGXIF,LAAAQAAATAEAHACAeAEE.aAHDEAGEZCDB..fCAAhABAUDGAMFFBcCCAhACAPHAA..RCFAGEAAhAEAFGGAADDBDGCAdEFD.SECB.CFHANICBhAIA.YGCG.hAAAIHHA.,1,12,4,8
PEDTRGVHAgKOQBJSNaWbfeCYFLZXUdIMc,OAAAQAAABADASACA.aAEDbAED...eAGBhAHAFAGAZCDAdCCAMAIBEBGBRDAAHEEAhAAAABBBKEEA.NCIACGGALEGBhBAA.XGCAIHEADFIB...hADA......hCAA...,2,-18,-6,12
XAbcCIgLZMSJDGTfPEQVaRUKFeOHdNYWB,CAAALAAAZACA.MAEADADAGAGA..TBDAECCA.aAGERDEBFEDHhAAAHCAA.dCGA.NCIABDEAhABAAAGB..bGDAgFBAhACA.fFFA.PHFChBFA....hCAA...,2,-35,-14,21
ZHOfUNVGDYaJFBPbKTeEgSXcIQLMRWACd,ZAAAHAAAOACAUADAGAGADAGA..aBEDBAFA.KCADEBGAXCCChAAAQDFALDFBhACARECAACCB.dFEC.fGHAhAIAYEHBFGBB...PHECeDHH.hBIA......hEBA...,2,-15,-8,7
LgVPbdWEAXJNfGeQSacBRKMDFHOCIZYTU,XAAAJAAAGADA..eADAQAFA..aAGDRDAAMAIBhADAHCDACCHAZDFATDAALFAAhAFAgEFAVFFAdHBBhBAAAAAASEHH.KFCA.FGBH.IHHAhADA...hBHA...,1,-1,-2,1
GNeRISMBHOcCbLKUWYfDXJgTFPaZdQAVE,EAAAeAAARACA.MAEAHAFB.CAHA.LBDA.KAHBUCCB.fCHAhAAAXCCCTCGAhAAAaDABdEFA.ABEAGDEAhABA.SEHHOEHDbFAADGEBFHAAPHFChCAAZFDB......hCBA...,1,6,-13,19
RZQXfUVbBCYIJOdMeNTacSFLEAPWGKHgD,GAAAHAAARADFZAFBQADAUCABBAHACAFAJAHB..dCHA..eCDBhAAAaDDC.FCFDAEGB.KDHBDFAAXFFAhACA..bFAAhAAAODAH.MHAATFGASGHHhADAEHDA......hAHA...,2,-13,-13,0
TaGCRSJULBWDZEVcfHPOMKFdYgbIAQNeX,eAAAaAAAGACARADA.UAFALAGB.DAIBECHF..VCCBHDFBhAEAMCFBdEBAbEDD.AAIB.hBAAQEAC.hBBATEGASGHBBGCAZGEAfHBBhBEA......hBFA...,1,-9,-10,1
gAfaVTSWBNLKDUFdZHOcXGPMIQEJYeRbC,aAAATAAABADA.LAFADACAdAFAHBDB.OAHBGCCAMCCBhAAAEBBBeCFARDFB.bDADABDBSCHHhAIA.hADAKFBDZEFAPFHDQGEA.CDHAfGHEhAGAWFFD.FHAA.hBFA...,1,5,-15,20
dCJMaePGDgfSTOIXcKFUYBHVAZLENWQbR,EAAAQAAARACA.dADAMAFAeAFAGBEBDBIB.SCCDhAAAOCDEXCGDFDABBDDBHDBAhAAAABHAZDFALFAAhAFA.bEFCaFFA.fGGETGGAcGCDhAGAKHDA......hBCA...,2,-10,1,11
JHaCWRVBUefIDcSLAZPYgEKOQdbGTXMFN,ZAAA..gAAAEADEQAFCGADAMAIBFAFAHCFA.aAHDhAAARCAABCEDeCCBDDABLDGBhABAADBBKEFDdEHAbEEBNEIACFBA.hABA...WHFAfHAB.SHCEhACA...hADA...,2,-4,-4,0
AdHMBeTLRXEcGFODgSfKQJCaWPbYUVZNI,HAAAeAAARADAEADEGAGADAFA..SAGAQCCCaCAC..bDFDhAAAVCEAZEAAAAIBdCCAMDIBhABATEGALEEDFEEHfGGEhAAACGAAPHFC.YHCA...hAEA......hAGA...,2,4,7,3
MNaYcTdOBKVXCUAgZLISGPeWEQbRFJfHD,ZAAALAAAGAEAeADHEAGA.RAFA.FBHDHCABDACA.aCFC...TEDAhABAdDDAKDGD.CEBAACCBSCHBhACA.QFABhAFAbFFA.MEHBcGAABGEA.XGFDhAGAIHFA...hAIA...,2,-27,-2,25
LQSeFOYEMDBGKRUHWcPTAbdafXCVgZJIN,aAAACAAAZACA....IADALAFBeAEHOAHB..EAGAMCCBhAAAGCCARDDBHEABPBBBhAGAAADAdEHA..XBGAhBAAgGEAQEFA.FFEHBHHAhAIAKGHBWHDA...hCAA...,1,1,-19,20
QFITJgMeZXOGRbLKYHPdcEUaAWBVSCDNf,BAAACAAADACA.QACA.FAEETAEAMAHB.eAGHZCAAGCEAhAAARBCBLDFAHEGBdECDEGCAhACAAAIB..SFFAhAAA.IGAA.JHDA.OCBBhAGA.KGHB....hBCA...,1,-15,-17,2
ZWFeadgOUKDVBXTCbPLIQcRSAEYNJMGHf,EAAAJAAAHADBZACB.FAFAeAEA.dBHAOAHDDCBBBCEA..TCFAhADACCGCLECA.QEGAhAAAREEBACCBMDDBfEGFhBAAaFAB.KFBBbGECIGHA.hAFA......hAIA...,2,-20,-15,5
YRIABJDPLNVcTMHSWdGCFKfEeOaQZgUbX,DAAALAAA.VAEAMADA.HAFCdAHAGCAAKBBAEBDE..eCFFhAIAaCCAZDDAUEGA.XEDDhBAAREGFACABBDHB.PFDBhABANHDB..SDDF.CCHA.OFFHhACA.....hBBA...,2,-21,-3,18
DCXFTcfYSERVZQUGAJbIWPBaKOeLNgHdM,JAAA..bAAA....IAEABAEAaAFDeAFHLAHBHBGBdCCAhADAMCABCAHB.FCCHTEDAhBAAfDFA.EEDFhAAARFGBQGEDABHBKEGAOEAD.DGGA...hCAA......hCBA...,2,-18,-13,5
HMPcFTOYDgbaZEBIUVeJCQGKfWLdASXRN,RAAAHAAAMADAFADA.OAFDDAHB...aAHBEBDABCADUCGB.eCCBhAAAQCCAGEDAKCEBhABALDFAAAIB.XFFAhAAAPFFA..TGBAYHDA...hBGA......hCAA...,2,-17,-16,1
LPMSfAYUKcZbGgQOTIXeWJHECBdVRNFaD,KAAAZAAAGAEAQACCOAGF..TAFAeCABHDDBBAHBRCDAaCCHhABALCHBMAIBAAEBUFGAhACAbEAA...XGAAhADAEEFAdGGAFFEHSDGG....hAGA......hCBA...,2,-8,1,9
LPXIaRSZHYNOeUGVgEJcQTMFbBWDfdCAK,LAAAXAAARADAHADB.OAFAeAGHGCEAEBFE.QDAAhAAAMBIBBCAADAIBdDDDAADAKDCBhABAaDFDZFGBUGAAJHDETEGAhAGA.FGGHWCCDCDHB......hABA......hACA...,2,-14,8,22
EKdBPFQgZNDfIbAJSVLcGYWUXCROTaMHe,SAAALAAAGADAUADA.RAFA..aCAAHAFA.ECCBdCHAFCGDZDEBhABADCIB..bEFDAAAAVEDAhAHA....cFAAhACAXGGAODDHeDBBBGAD...hAIA......hBDA...,2,-18,-2,16
NHYSQbDeMGcVXRaWgJOEKFCPfIUZdALTB,TAAAHAAAQADC.eAFEGACAXBFDRAEAaAHDgCAGhAAAECABCCCD.fCFAhACAZDEAACHALFCAhAAABDGASDHHbGFAMIAA.cEAC.VEDBhAEA.OGFC.hACAFHAA..,1,16,3,13
HWJPUeIFMfYXaNQEZcKBATSGdOCLgRVbD,GAAAdAAALADARADADAGAHBFCJAHB..eCAAMCDB...XDGAhAAAaCEAEDDA.ZEDBBDHAhACAAADAOFFBCEAA..bEFChAEA...UGEBfGHA..YFAGhAFA...hACA...,2,-21,-14,7
NeFIDKdBYCXOVSHfJAbaZLPQMTcgWUGRE,ZAAALAAAMACA.TAEA....gAEAGAGAECAAeAGHhABADCDBdDFACCCD.OCEHhABAHDEAAAIBaDHDQFGAhCAAUEAAFGGA.BCHA.YEDF.SGFDhCBAbGAA..hDAA...,2,-20,1,21
cRDbBSCgWGZMUPNAQYLfTFEJOeXKVaHdI,LAAATAAA.EAEAeACEKAGA.HAFB.dBHARCAABCEACBDDGDDAZCFBMCIBhABAUFAAACCB.QFGAhAAAFEAHOECAaGEDDDHBhACA...SGGAWHAA.NIAB...hAEA......hAIA...,2,-19,4,23
PMDcaGYQgRISHFONUeTVWCAKXdEfZBJLb,dAAAEAAAZACBLADA.MAHBaAEDGAGA.QDEAhAAARCAAHCEBOCHDeCBDTFGAhAGACEADAAIBXECCBEDDbGBAhAIADFGB....gGCA.FFHH.hBCA......hBEA...,2,-10,-5,5
OGSUTDPFgdbJMQCRIeLHBEWcfKXYZVANa,aAAAGAAA.SADATADA.FAGAdAFAMBGBRBGFLCCBHCDBECHBhAAA..fDAAhADAXEAAZFDAAAHAODHDhBAADEHB.bEDDCHHA.eFFB.BHHA....hBBA......hBIA...,2,-7,-3,4
bHNVACFUDeSLcORQgZGKWdMfEaBTXJYIP,FAAAeAAALADARADAZAGBGCCAdAHA..ECCAaCFBBCEA..TEAAhAAAXCFD.JEAAIEGAhABA.HGAChAEAADHADEEBOEHDQFFAKFFDMIDAfFAEhAEA.PHBC.hAGA...,2,-21,0,21
NSMYHUQOPCacgZGDXIABWEJVTfeRdLFKb,EAAATAAARACA..dAFALACBKAHB.SAEAHCCCQCGDhAAACAHAaCEA.ZDAAGCGAhAAAXEFAAAEABDEA.JEDFhAHAeFEBbFFD.MHAAOFHDgGGADFFB.hCAA......hCCA...,1,4,-9,13
HJdFETbGUfgcRDNWXAKBVePCLZIaOYMQS,BAAAeAAALAEAaACA.MAIBHAEBdCCAEAGAGCFAUCBA...hAAAfEDARCGBDBIBXDDDhAGAAAAAKEHBCDBCZGEAOFABhAFASFGAFGHH........hBCA......hBDA...,2,-19,-7,12
SbZFWAJOGYLMEgTUVCHRcBaIDXQPfNdeK,GAAAMAAA.EADATADACAFA..HAGBRAFFBAHBaCDADDAB.QDDChAAAfBBAeDGBhACAbCGD.ZFFF.AAIBOFHDhADALDCA.gFAA.cFFChAFA......hBAA...,1,4,-26,30
MBFTRbDfJgKGcIPAEHUaLVYNCWOSdeQXZ,HAAAaAAALADAVAEA..CAHB.SAGHdCADeCEBZCGBMAIBFDCDRCCADBBBhAEA..JEABGDFAhAFA.IFCAhBAAEFHFUGDAYEEF.WHDG....hCAA......hCCA...,1,-10,-15,5
CfYDGLEHATOSaBgXUWIJZbdFVQRPKeMcN,TAAAaAAABADA..UACA..IAFAZAEBdAHAQDFAhAAARAGF.eDDBMBBBCBGCDDIBhBEAECCAHCEBAFFB.SCHHhADAXGGAWHEGbFGBFEDH....hAIA......hBAA...,1,-12,-23,11
AKEfOPJFSYICaRbNdUBMWTDgVLQXZcGHe,EAAAOAAAFACD...SADACAEA.RAFFdAHAMAGB.DAHBLCCBhAEAZCDBHDGBABBBfCEEhBAAJEAB.aDGDbDEDhAAABEED...TGEA.QGGChCAA....hDAA...,2,-30,-20,10
FXcGIOfZPQgCaVDbJSTYWdHeNLBARUKEM,RAAAEAAAMADAFACD..GAEAOAFEZAGB..QBDDaCHD.DCCBhAAAbDDD..TCGAhABAdEAAHFFBeDEBBGBAAEGBXGCAhAIA.fFHA.CHFA..hAAA......hAEA...,1,-10,-16,6
bdOTgIYRLQBCUPecJDWNKFHAMEZaXGSfV,EAAAaAAAGACA..fACAdAEBOAGDTAEA.IAHAhAAARCEBLEHB.QFBAhAIACCDAeCFADDCBKFGDhBAAHEABABBBMEEBZDFESEED.bGFAhAEABHFD....hBFA...,1,2,-12,14
QOfSGZVdEJNKHbLYDIAcCBaeWTPXMgFRU,BAAAeAAA...TACAMAEARBCA.UBFAQAEC.SAGBhAAAZDBAEDHFKFEAHCAAhACALHCADAIBACGBaDEB.hAAAXDFAFGHB.fFFA.dGHAhCAA......hCCA...,2,-22,-21,1
OSHMRTXELDeUNBVGPdgZcYCJWFAIbaQKf,aAAAQAAA.OACCHACBRAEA.EBHFeAEEBCFAGCDAdEAAZDEAhAEACAHBFCFAAAHAKFFAMCIB.hAFATFFADBBB.NDCA..hBAA............hCAA......hDAA...,2,-26,-11,15
eDaNKVfUQMXLGcZYJFbIgWHRCdOPAESTB,EAAATAAADADA..KAFAUACA..MAIBGAEBZBCA.FCED.ICHAhAAAHCFBRDBAdFFD.ABDAeFHHhAAAaDDH..fDGEhAFALHAA.cFFA.JHAA.WFHHhAHA......hAIA...,1,-13,-26,13
GaSdcAIZXgDMBPVNUbYETFQJeOKRWHfLC,ZAAADAAAMADABADB....VAFAUBBA.EAGAQCAA.hBAAeCDFRBEBHCGBLCFAhABAaDCEdFFAAEEA.XEBChBEAgEFA.bFABTGCAOEHDfHGFhBIASGED...hCAA...,1,-7,-17,10
dFKRIWNGJQgeSZAHCaUBDPEbfLVcYOTXM,HAAAaAAABADAEADELAFB..VAFAOAHBMBBBdCADRCCA.IDDAhAAAGDFAQFAAhADAeCHHACEADEFBbEFDfDHEhAFA.TFCA.KHGANIABSHGAhACACEEC...hAIA...,1,1,-16,17
FbHcKAeIMaYRdBTPWDSXLfCUgEQZOGJNV,eAAAaAAA.RADABAGB..TADADAIBLCCACAFBEAHB.ZCFBGCCAhADA.VCFAHEAAABBBMEFBhAIAdDHASEEDhAAA.fGGAQGGA.OFCHhBAA......hCAA...,2,-16,-13,3
JaLXPgOAHGdCYWDTUNSbQBKfcVRFZMEeI,HAAAdAAACADA.DACAUAFASAEA.QBGAKAHB.VCCAhAAARCAAZCEA.EEEA..eDFFhAFAaDHD.LEHBhAHA.XFCAOFBBAFGBYHFA.NIAB.hAIAfGHA.hCAA...,1,-5,-39,34
BIZOeQMNSaHAGLbfTcdFRXDEJPVCUKWYg,GAAALAAA.TAEAdADARAFAECEF..VBGBKCGA....gDBHhAAAZCAAeCCEMEABhABAaEFAHFFAAAIB.bFAAFEEAhACA.DEIBCHHA.YFGB.OHACNIAB.hACA......hAFA...,2,-5,-2,3
WXEDAHQfNIYPVMKGcSbgeadULJBTFCZRO,HAAAQAAA..fADBIADA.PAFAMAFAGBDBhAAASBGAeBHHdCADLDDAhBCATCEAZDGBRFFAXGBAhBGAADDBYECF.KEED.bGFA...hBHA......hCAA...,1,8,-8,16
YIHSEDPOebGBUJKdMCLcRAWVFNZaTXQfg,FAAAaAAA.QADA..fADA.IAFAhADAHAFAECCBOAGDeCFAGDAAhADABBBDKCDAdEEAMAIBhBAALEHBADGBVEEBNIABXGEASEHB.bFCDhCAA.CGHD.....hCFA...,1,3,-22,25
MaZWACQNFgOUPbKLTRfXSDBeGdHEYVIJc,QAAAFAAAOACD.UADAKAEA.RAFA...SAGBeCFAHDBAECEAhAEAIEFA.MDIBhAAAZDEEAAIBCFGA..gGAAhAGAbECDTFFADHEAdFHA......hBAA......hCAA...,1,-3,-27,24
bEWSeNARFQJBPHaCVYXZGfDOcULIdKTgM,RAAAQAAABADBHAEBaACECAGA.....XAEDGCCAOAHDhAAALAGBdEFATDAAhAAAMDHBEGAAeCDB.AAIBFDFHhADA.PDHDYFHBZGBADGGB.IHHAhBGAKGDA.....hABA...,2,-18,12,30
cEACUJOWMZVPSTQBNaLXeIbDYfgFGdHRK,CAAAOAAAZACA...SADATAGABCCAaAFD.LDAB.hAEAeCEBbAGDDAIB.fBBEhBAAGDGAHGAChAAARDCAEEFAAAEAUGDAMEIBQFDD.XGGDhCAA...hADA...,2,-16,-1,15
HPGETeVFbAROcQdIaLfUKSYWNZBXCDgMJ,RAAAQAAAdADALAFAKACA...SCCDNAEB.ZCFACBEAMBGBhAAAHDDBEEHB.eFGBhAAAbCGDABHAOGAA.aGEDhABAfCDE.UFDABHAADCIB.gGGAhCAA..hDAA...,1,4,-31,35
dLYCTIbUXFgRaNZfJKOAHWBQVPDMESGce,HAAAQAAADACAEAEAGACB.eAFEdAHALBGDTCEAICHAhAAAbCCA..FECARDAAZEEAhADAKEHBACCABEHBMFFBSGCAhAIACGGA.XGED.aGGC.hAAA......hCAA...,2,-21,13,34
KEBHXFCbOITdaPAWYJDLceNRZGSfMgUQV,JAAALAAA.eADHRADFGAFAMAFAQBFAEAHB.HCABhABACCCDODABdCHAACABDDEBZDGB.hADASDFDUFDABDEAhAFAbFBDaGHD..PFGD...cGEChACANIAB.....hAIA...,2,-21,8,29
gJXHCTIUOFZQBWPNVKDfbdGSaAMLeYRcE,eAAARAAAEADE...XADAHAFBCAHA..UCCAZAFBQCCAhAAABCHA.PAHDKDFDbEGDGDGAhABA.AEAAMEFBhAEALFAA...YHAA...hCAA......hCBA...,1,-14,-20,6
LHdBNGEPCOegFUfXVKRAIacYbSDTZWJQM,aAAA..bAAADADAZADB..QAFAHAFAdCAAGCEAEBBB.OCCHhAAAeBDBFCFHXCGAhABARDGFAAIB.IFHAhACASDDDTGFAMEBBLHAABFFDCGHAfHBFhBAA...hAHA...,2,-14,7,21
QFfJXbGBZKURecLEYSTdgPMWHNOCVADIa,aAAAQAAA.FACEXACDGAEAZAGBRAEAeAHHECDB..TEFAhAAAdDDAMBBB.HCFBhAEACDHAAAGBDFIBfEHAhAFABHGA.KFFD.LHAA.SGHHhAHA.....hBIA...,1,7,-24,31
PKWFYMdLAUfeRJaVQZEcTDIBSNXbOCHGg,eAAARAAA..aADAZADBEAGATAFA.BAHBXBDD.CBHAHCFBhAAAGCEAKDCDFCGEdDHAAAAAfBCAhCAAQFCADFFBhABASEGA.OHEAgGABhAGA......hCAA...,2,-16,-12,4
RYbcUQENVHeAJKZdWOIXSLgfFBDGPCTMa,ZAAAdAAAOADASACELAHBFAFA.GBDACBEA..aAHDRCBB..hABA..bBFDQCFDhCAAEEHFHFCAABHBKCCDXFFDhACABEDATFFA.MDIB.cGEChCBA......hDAA...,2,-26,2,28
CVdQJOXGTgSINBHRDEFWZfKPYeLUbaMcA,dAAAQAAAOADAGAGASACABBDAHAEBRCAA.EAGAZDEBKBHBeDHHhACALDAA.aDFDhAAAAAIBCEDAXEDD.hBAATGAAgGBADDHBfFHAUGGB.hBCAMIEA....hADA...,2,-9,-4,5
DJdfISeVBNWXFOEgUcCaTKMYQHPRAbLGZ,GAAAZAAAdAEA.SADAeAGBBAHB..XAFDECAA.gCDBhAAACCFAKDDA.MAIBhACAHEBAAADALDGBhAHADCIBfEGAIGEA.WHBGOFFHaDDH..hABA......hACA...,1,-2,-32,30
BNaZdRVJOILCTMDPSKgYUAEbfFGWHecXQ,EAAAFAAAHACB.eAEAQACABAHAZCEBRAEAOAHDLCHBMCCBhAAASDGFKCGD.UEAAhAEAADDAGDEA.XEGDhAFAdEDCIGGADHAA.YHEAWHAANIEB.hAHA......hCAA...,2,-14,-4,10
UbQMaIfPKGdLXFSDWZVTEOYCHNJBecgRA,QAAAaAAA..fADAGACBdAGALAFASBHHhAAAZCCAECFECCDDHCEBBCHBeDABhADARDABAAGAMEEBKEGADFABTFFAhADAOGDA.NIAB........hBAA......hBBA...,1,2,-19,21
fcGeRLHZbXYATVOISMKBFDJQPEUNdgWaC,TAAAOAAA..MAEAFACADAFA..QBBBEAHF.dBEAaBDEhAAACAHAGCFARCEAHEECbGBAhBGAACHASDDD.hCAABDHBPCCBUGBAWFHHeFFD....hBAA......hBGA...,1,-4,-18,14
IHZCaWKcQFTDBgbSVGYLURMNdPOEJfXeA,HAAAaAAA.KADCQADADAGABBEA...bAFAGBFALCCBRCAAdCHAhAAAECGB..XDCAhACAAAGAZDABCEEAFEGHSFEHhBHAYFHBMFIB.NIBB.OHCA..fGGAhBIA..hCAA...,2,-16,0,16
eYgdJGTOICXWBVFSUNAPDcZREMabLHKfQ,DAAARAAAEADEMADA.LAHBHAFBQCCA.eAHBdBBAGBEAhBAATDGACEFDBBGASFAAhAAAABEBZEFBbBCDfFDAhABAJEHB.XFGAFGBA.NIAB...hAFA......hAIA...,2,-16,-2,14
aRFEDVPWCcZTMdYXAOKLNeHBfJQUSgIbG,LAAAHAAABADBQAEASAEH..bAGDRAGBECAB.DCCBPCAAhABACCFA.ZDDAdDDAAAIBKEAAhACAeDHFUFDAGGABhAAAaFGDFGBB..cFFCMEIB.....hAEA......hBGA...,1,-2,-9,7
PXAMRSNeKaIDBYgJGbHfFCcTVWQEUZLdO,RAAAeAAAKADC.DAEABAFA..JAGBHAGB.CCCA.TBCA.QDEChAAAECEBZEEAdDGDXDGDhABAAAAA..MFCBhAIAaEBA..IFBA.gGGAhAIAfGGE.....hBEA...,2,-32,-30,2
TcaJbeBCAgPHGVWOZIEXLKdUMSFYfNRDQ,HAAAGAAAOACAEADALAGBdAGAMAIBFBFB....fBEAhAAARCDBTEGA.aCCBeDADhAAAADDBPDFBZGEAKDCDSDGBhBGADAIB.QGGA...hACA......hADA...,1,-2,-8,6
BcYVfXKAPHNCILUFQEGRdWTeDOgMSaZJb,HAAACAAALACAQADCRAFF.dAFAeAHHOAHBMCCBZCAA.bDFABDAAhAAA...VDDAhADAKEDAAFGA.IGDAhAAAEDHFTGFASGGA..aHAA...hACA......hAIA...,1,-11,-15,4
CHcWKZISVELYTGAXOUbfBaDQFPgeMJRNd,OAAAUAAABADADAEA.FAFA..eAFARBDA.dBBDHCFCKBEDZCFB..hBAASDAAECHFLEEDhBIAGEEAADDB.fDDEhADAaFGD.PEHDMEIB...CHHD.WFDDhCAA.....hAIA...,1,-17,-28,11
YMSFIDQbTWPBReAGCgdVcHOJUaEfLKNXZ,GAAAdAAAHADAOADAaAFALCCAKAGAZCDA.MAIBFCGA..DECATDAAhACABEFD..AAAB.CCGAVEEAhADAUFCA...EFHFXEGDhACASGCA..IHHA.hBAA......hBCA...,2,-28,-8,20
WgLdXNRBZCOEJfMDacIeFQKYVAHPUbGTS,HAAAUAAAGADATAEA..SAGBLAFAdCGARCAAZCEAEDAAMAIBhAAAaDDH.eEAAKEHBAADBbEEB.hAGA...XFDAhAHACEHAfGCADGGBIHHAQGGA..hACA......hADA...,1,6,-14,20
eWAgaYSKCHPVQOIBXbRcTNdDZUGMFfELJ,aAAAKAAAHACB.QAEABADARAEF..TBGAdAHAZCAFGCCAhADAMDEAEDHFeDHF.AAGASBBDhAIACEEAOEAHbGBADEFBhBAA.FGDDLGFA..gGGAhBIA.....hAAA...,2,-8,-7,1
bPHXBAgKdDeUFfQCGaVJSZIYcWMTLONRE,dAAAeAAAFADAQADAGAFA..aAHFSAFAZCAE.ICCAhAAA..cDEChACAMAIBTCFALDHBhBAAREDAEEHBHECBADEBDGAACGGDYHBAOHCA...hABA......hAGA...,1,-7,-12,5
TJaABPYRUWLcbNfEOFCQdDgVGeSZMKHXI,BAAARAAALADB..bACAEAFA.FAHDdAGADCCBGCAA.eBHHhAAAZCFAHEEA.TFAAhAAAAACAPCCCUGEBNDGA.CGCA.hABAQGBA.SEEBMFIB.hAFAKEHB.IHHAhAEA...,2,-21,-4,17
RXaPCAKDJFWQIcLNEbYVfTBHGOdUMeZgS,DAAAFAAAQADALADAEAHB....bAFAVBBBBCCAHCFAdCGAeDABhADAZEAAREEB..aEGEAAGAKDEBhBAA.JEDFIGHAhAEA.NIAB.TFGA......hCAA......hCBA...,1,-5,-20,15
YRKAUGCWZdfPaXLMbVSDHFOTQeNIcJgBE,GAAAZAAAdAEA.aADAMAGB..SAFHHCAATDEAeAHB.ICDAhAAAJAHBBDHARCGBADFBCEBA.hABA..fEBAhACALFGBDEDBQEEBNHAB.EFHF...hACA......hADA...,1,1,-19,20
ZaTRFHKXQYOEBNAgfUeGIdDVcbCLPSWMJ,UAAAeAAAdAEADADA...VAGBCAFALAHB..SBCHhAAAMBDBZBEE.RDEAHEBAKDFA.hBAAQFGAEEBBBEEDAEIBhBCAfGAA.cGFCbFDA..PFHBhBEA....hDAA...,2,-30,-4,26
QDWHCNVXfgJLeMBZbRPOaTYEcKdAUSGIF,GAAAQAAAHADACACA.XAGB.JCDFeADHZCFA.RAFAaCEDEEGBdFAAhAAAAAFAUDGA.FEDHDFFBhACA.NIBB...fFFEhAAAgGGAMHCABGCA.....hAIA......hCAA...,1,4,-27,31
ZADBHfEMSVWLJcIQgPXdKOGeFTURCabNY,HAAAEAAA.MACASACALAGB.IBEAQAFA.XCCAhAAAdCCAGEDAeBHHhADATGBARDEFbFAAZGFEAAIBfDFEhAAAWHBA.gGGA..hBGA......hCAA...,2,-11,3,14
ANYRfMPDdbILVJgTOUGKWZXcaHSEFBQCe,RAAAMAAAdADALAFA..gACAOCCBGCGAZAEBaAGDHDEBhAAAECHFBDDDeEDDAAGA.hAIA.fDFAhBAADFIB.bFGB...IGBA...hABA......hCAA...,2,-17,-15,2
WAKfHPJabTDNUcBXYdLRMEGSeIOCFVZQg,HAAAaAAA.TAEADADAUAGABAGB.dCADRBBAGBEAeAHH..CCEDZDAEhAAAQDGAACGBKDHBJEEA.hBAA.bEBA..XGGAhACAMFGBEGBA.IHHA....hBBA......hBEA...,1,-12,-18,6
KEVbTfNgWOZMPcXSILdGBDUFJCaReHAQY,QAAAEAAA..bACATACA..fAGANAEB.hAAAOAHDZBEBMBHBXCCAhAAALDDDGDAAhADADBIBFEFDaDEDHDGBACGBKEHBWECDSGADdHGB.hCAABGDA.CGGD...hAEA...,1,-2,-6,4
JREcGKOdYfPUWABeSICNaXMZTVgHLDFbQ,eAAACAAA..aACAZADB.TAFAHAEBLAGBFBHD.QCBAhAAAEBCFGCEAdDDAfEGAhAAAPDHDAAIBSEGDhBCAXGDCMEIBDFFBRGBAKHAA.....hBDA......hBGA...,1,-4,-10,6
MPfWNJBXVDeYIGAFTSbCRdHOgKEUaQcLZ,TAAACAAAHACAKAFC..EACEQBGAZAEBMAHB....fCCAhAAAJCAAXCECeCFHhAEAGEAAAAIBSCHHhBGAREFAdFCAOFEBaECDLFGB.NEEADFIBFGHB.hAAA......hACA...,1,4,-4,8
AOaBHEQVLGYSfCXTZdRIMDNbFKJWPUceg,aAAAHAAA.EADELADAGAFA.SAGHCAHAZCAARDGF.MAIBDCCAFEDDhAAAKBBDJCDAUFAA.eFEHhACAAAEAQDGD.hAFAfDDEdGGD.bFEAWHAA...hBAA......hCAA...,2,-24,6,30
RcgeJYDfLKPCXWOZBTdFaVUbIQASNHEMG,HAAAEAAARACA.eACE.DAFALAFBCAHA.OAHBZBDEdCHAFCCHaCCHUEEAhAAA..QDFAhAAAACIBMDAB.GEDAhCAAgFCDfFHAXGFA....hADA......hAIA...,1,-4,-24,20
MTHGIcdQJfVXKENgZaRUFBDPebAOWLYCS,LAAASAAAHADBGACAdAFBQBGB.VCAAEAEAZAGBhAAARDEABEHAeBFFAFDAOFGBhABACDHAMEABTEDAhABA.IFGA.fGEANIAB.hACAaGHD.DIBA...hAIA...,2,-8,-3,5
gJLKEXAINYRaBMCPfcVQUeOTbHSGdFDWZ,..IAAARAAAaADABAGA..MACACBDA...fAFAhAHAQCEAeAHFTCGAHBCBhBCAdFFADCGBZFGBLEBAhBEAECCBAAAA.PDHDUGAASEEDGFDB.hCAA......hCBA...,1,-7,-13,6
KTgJcORDeUPAWaGMfSVNHYBXbFdZECQLI,GAAAMAAA.SADAHACCXAFBdAGAECDALBHBKCHB.TCCAhAIAJDCFREEA.eCEHAAABaDAHhACAfCGA.hADAVFFABFHA.ZGBACBBD.gGGGDIFA.hBAA......hCAA...,2,-4,-4,0
fUHRXPgWGOcASEeCNJYMLDFBKQdZbITaV,EAAAeAAA.CADA.JACBLAFABAEA..dAGAZCCA...TCGAhAAAaBHDUDDAHECA.RFGBXGAAhABA.gGEBhAGAGEAAACEASDGD.MEIBhAAADCEA.KGGB.IHEAhAEA..,2,-29,-9,20
ZfUBJEYFgQcKLOHdebCDIAWaVXMNGPTSR,aAAAMAAAGACA..TADARAEAZCEEBAHBEAFEFBBB..QEAAhAEALAHBHCDCeCHHbEFDhAFADDCBACGA.XEEAhBAASBBDfEHAYFEDKGHBCGCA.IHEAhCAA....hCDA...,1,4,-16,20
DFLZHgXNSRBWUQOKCPMdGfAVIYcaJETeb,VAAA..IAAA.aACAEADEeAEHbAFB.LAGBHCDBXCGDhAAARCBBBBCBQEEAhAIACAHAdDCCACIB.cDGDhBGATFFAZGCASFHB....hCAA......hCDA...,2,-12,-9,3
UREASWFGdXNCagQeOcYZIPJLDMTHVbBKf,FAAAdAAACADAQADA..eAEHOAFCZABBJAGBMCCBHDCABCGAhADAKCHBRDDAAAHAGEFA.hBAA.aCHD..gFDFhAGAIFFALFHBDFIB.bGCC..hCAA......hCBA...,2,-18,-18,0
YRDLWdaOZUQSFGPJMHXKcICgNeEBfATbV,TAAAVAAA..RADFLAFBaACA.ZBGBQAFAGDAAMCIBhAAAHCCA.KAHB.CDBDeDFAhAAAEDDBAAHADFFAdFAASECAhAFAFFCD.XEGAgGGAfFFEhBDA....hCAA...,2,-11,-5,6
QTbZNGKLMaBdUDVAPeWRfHXgEOCIScYJF,eAAARAAAHADBEADACAFA...SAFAJAHB.QCCAZDAAGCFAhAAAMAIBdFAADDIBAAAAfCEFhAGAOEEB.IDGAhCAAFFHH.TFEA.KEHBaHAEBGHD.hABAPHCC...hADA...,1,1,-15,16
fMGNgVbQcFdORWZAIUKBPaCXHLSJDETeY,KAAAaAAAHACBLACBDAEA.EAEA..eAFAMAHBGCEA.gBGAhBAAbBFD.QEBAhBBAdDECREAAAAIBBEHAXEGAhBEATGFAfGGA....hCAA......hCBA...,2,-22,-5,17
OAPLVQZJdETHgfaXUCYNKWDRBIceSbGMF,LAAAZAAAEADEHAFBaADD.CAHA.KAFA..RCAABCEDeAHHGCAAFCHDACAA.hABAQDDAdEEA.hACATDFAXFAAUGCAhABA...YEHBDFHBSGEAMFABOHFChACA....hAFA...,1,-1,-18,17
BETceFaPHGbRCDSNVOdXfUALKIMZJQgYW,LAAAMAAAZABE.QAEA..gAEHBAGAEBHFeCAAhABAaAGDHCCARDDADDIBSBHHhAIAOEABdFFAfDFAhBAAACAAKECD.IEHAYEHFTGFAhCAAFGDB......hCCA...,1,-2,-25,23
CeZTULKWbHBXIEVPRSdfGNDOMFgcJYQAa,eAAAZAAALADBKADAHAFBBAFA.EAHBRCCAdBHAGCAAOEEA.MEIBhAAAFCFAJDEB.ACAB.aFAAhABACDHA.UFFB..bFGBhABAIHAA..SFAD.hAFADGGB.....hAHA...,1,-14,-17,3
GcTOaSJBURfeZHCgDXdIYLVNFWPbEQAMK,GAAATAAA.aADABACBRAFF.ZADBHCDB.DAIBdAGALDCDFCFH.hAAA.bDGDAAABMCHB.hAIAOEGHSCCDhBFAfHABeEEBXGBAIHHA.NBIA.WFFDhACA......hAHA...,2,-16,-12,4
LMNBZHWACJfRPcdaETUYIKVFXgSOGQDbe,CAAARAAAdADA..EACAUAFAKAEA.FCCH..SAGBGDFA.QCAAhAAAeBHHLEEDhAAAMAIBZCDAHFBBACFAJDHFfHGFhABA..aECD.TEEA.IGGAhACA...hAIA...,2,-19,-15,4
fbGOLRgFYDABJdeXPECNMTHWcKSVaUZIQ,dAAAeAAAEADAMAEAHAFAKAHB..aCAEZBAEQCECGBDARBFBFDHDAAHABCHAhACA..JFBACDCATEFAhADA..SFEHhAAAIGHAOHCAgGFHDIFA...hBAA......hBCA...,2,-14,-14,0
KNJaTPMCIfUAeZVbQBHGWSFXEOYLdcDgR,eAAAZAAAQAEAHADAGAGAFAGE.ECCBLCABdDFADDIBREDBKCCDaFAAMCHBhABA..CFHD.fDEAhACAAAAABGAA.XECDhADAcGGC..NIAB.TFFA.IHHAhAEA.....hAFA...,2,-8,-7,1
MOgeJRXZLdAcBWGFEDTaIUbKYNCfSHQVP,BAAAGAAAEACAaADAUAFAKAGA....CCDAHCEBQBDA.MAIBhAAAeCGBRCAA.ZEBBACAAFDFDhACATGFA..bDGDfHCFhAAA.SGADOEEHJHBA.hACA......hAGA...,1,-13,-17,4
YGXdCecUKfWQTFbLIgVZOJRMSBDHPNEAa,GAAAdAAAeADAKADAQAGAFAFALCDA..ICCAZCGBRECAMDABhAAADCEAHDAA.EDFAhACAAAIBaEHDCDHAUFDA.TFGAhADAbGEC..........hAEA......hBAA...,2,-15,-10,5
TgeOIDcQNWbULVFGaAdBfSZHYXPJEKRMC,dAAASAAAHADAXAGBEADA..RAFAMCCATCBA..eCFAhAAADBIBQCFChACA.bEDCLDAAhABAGEGAADABZDFEPFABCEDAOFGB.IGAAhADA.WFHB...hADA...,1,-3,-10,7
GFWJCYZVbTNefKIHXBDUaAQERMOcPgLdS,RAAAMAAAOADA....gACAdAHAGBDAFAFACBFAZDFB..hAAAbBEDeCCDKBHBHDGBhAIADDIBAEHB.ECDFLHBAhABA.SGHBYBBFTGCA.fFFEhBAA.BHHAhCAA..,2,-21,1,22
aIcNHEOfBdCDUXGYbALgSTZPFWJMVeRKQ,LAAATAAA.ZADBFACAMAGBRAEF..aAGA..IAHAHBGBECCBhAAABCAAdEEADEIBGCEAhABAAFHB.SCCDhACA.PCHBWEFH.eFBAQGCCOFHDCGFAhBFA......hCAA...,2,-13,-10,3
gOGLCDIKbAZWERMafJBTQYcPUSVdHXeFN,EAAARAAAMADA..aACDBAGA..TAEAQBDA..PAHBhAAASAHHHCDAeCBBhAEAFCCHOCFDGEFAhAGALDHBDDIBbGCCAEFBZFCA.fGGEhAAA......hABA...,1,7,-25,32
OQMYHUJERFcDbBCgLVWGdNTSXAKaPfIeZ,aAAA..fAAAeACHZADB.MADAHAFAEAGARCEFDBBBBBCALCHBhAHAGBDAdCFATGEAABIBKCAAhAAAIHHAQEGAhACA.UFBA.FFFHCDGA.......hAIA......hBAA...,2,-10,-1,9
BFLZdVONHUGIWCEXbSJTDYKRfMAaQcgeP,aAAAQAAA.eACAFADAdAGA.OBBBHAFAGCDA.hAIACCFDECHBbCDB.TDAAhAAAKCHBRDBFADFAgFFAhADALEGBZFEBNHAB.UGBBIHHA....hAHA......hAIA...,2,-10,1,11
XbGPQRSeFaLCNWIfJBAcUOgdMDTVYEKZH,OAAAdAAAMADADAEA....TAGAEAGAHBBCGBDARBEFFBHDaCAELEBAhBAACBFD.IEGAhBBABCHAADGBUFFA.hBEA.gFFG.KGDA....hCAA......hDAA...,1,-15,-31,16
fHZRMWgFLYTaOXQCSPeDbUNGBdKcIJEAV,HAAARAAAMADAFADA.LAGB..aAFEQCABSAHHeBFFhAAADBEBUDDBGDCAdDGAhAAAKEGAJFCFAAIBZFFA.gGEGhACATGEACCCC....NEIABGGB.hCDA......hCEA...,1,-1,-19,18
BKeNOLGTPCVaDAQHdIMZgRSYXJUcFEWbf,HAAAdAAAZABBRADF..XAFBUAEAEAGA....bBGDKBHB.eDBAhBAALDAAGDFATEEAhAAACDHD.aFCBADFBMEEBhBDASFHB.cGDAfFHABGGANIAB.hBEA......hCDA...,1,5,-25,30
XVYOeIZdUBSWKQHDGaRgELbCfJTNFMcAP,XAAAOAAAZADBdADABAFA..KAFAHAGBaAHD.EBBBLCFBhAAA.CDBA.TDEAFDDAADHA.hABAPDBBeEGHSFAAhAFAQEGARFCAfHABMIAAcGGCIHHAhAHA.DEIB..hBDA...,2,-24,-1,23
VOSeYCPEXZGKJgfaQADHbdIFNMRTLUcWB,HAAAdAAAFADARADFLAFBUAGA.BAHAOBDBeCAB.CCCD.ECBFGCGAhAAAKCEA...fEEAhACAADHADEEA.bFCDMEHBhACA..TGFAVGBASFFBhBAA......hBCA...,1,3,-34,37
eRcQbaUWVXYTDdJCEIAMfFSZPGHgNKLBO,MAAASAAAGACBHACBKAGCLCCAeAEARBFAQDECUCGA.hAFAXDGDTEEAdFHAhBAAEEAAAAAAZGDA..gFAAhAEANBBA.BGGA......hAFA......hAIA...,2,-9,-6,3
WSPURQLCcZBMIVDfTEgJAXYOKNdGHeaFb,OAAAdAAAHADAFADDSAFE.RCAALCFAZAEBMAHBDAIBEDEBAAIBhACAKBBD.GCFA.hADAeDDBbEFDUGCA.hBAACEHA.BEHA.fGBA...hBAA......hBCA...,2,-29,-9,20
aPTZbGMQVHgdfCNUBAFYDWEcIKROJXeLS,DAAAEAAAKACARABA..OAEAeAEELAHB..aAHDZBCEGBEAhBAAMCGBHDDBdCDCCDGABEHAhBHAADDBFEHB....cGGChAAAXFGC.TGCA....hCAA......hCBA...,2,-32,-12,20
fLPcFMaVBRYDJgSNQeIdAWEObKGZUTHXC,EAAAKAAAZACBHACA.CAFBLAHBFAED.MCCBaAGARBFF..DCGB.SDDAhAAAeCABACIBODEBhAAAGEAA.TEGAhAEAXDGDfFFE.cFCDBFFDYHBAhACANIEB.dGHA.hBHA...,1,-7,-23,16
bXALZPcgTFOWVMYSfdHDIQGEUBaKeNCRJ,ZAAA..gAAATAEAOAGDMADASAFAHCAAQDEAhABAEBDBBBHAeCHHRCEFbDGDhAAAAACALEAA.FFHDhAEAVEBAdGAADGEAGGCB......hABA......hAIA...,1,10,-5,15
QbWKGdNCXFfTSRHPcEAUDJaOeVBZLYMIg,DAAAaAAA.eABAZACBLAFA..MAFAQCEAKBDAdBFAXCCChBAATCGAHEBAEBHB.hBIAAAGAOBBBBDGAIEEAhCAAbFFA..NICBCHHDSEGA.cGGAhCBA....hDAA...,2,-38,2,40
ZODYcQTFHadgNJCfPKGLeIXBAWbRUVMES,RAAAMAAAEADE.ZABE.DAFAQAFC.HCCAdBFAJAHBCAHB.KCCAeCGFhAAABDHAACIBUECB.hBAAOEHBTECAaFED.hCAA..NIEB.GEEA.IGHA.hABA......hCAA...,1,-8,-32,24
AWUFVfRacKNJSPXTdZCOeGILgQDBMbYEH,FAAARAAAKADC..SACH..TAFAZADBeAFAGCCALCFAhAGAQCFBMEEAEEHFhBAAHEFCACGAUGGBaAHFcFEChAAANIBB..........hABA......hCAA...,1,-13,-21,8
fPgZQVDXNCMUbYKdLOcWIGHEAJSTRaFeB,TAAARAAAeADEBAGB....fACBZBEAQCCCXAEBhAAAMAIBbAGDdDFALCCBhAIAOEEH.IEEAhBGAEFHBAAAA.aEGAFGGHgFGB.DGCACHEA.hCAA......hDAA...,1,2,-17,19
AWXFMGLTJbEQfBVCdOURPDHYcgeZKINSa,FAAAGAAALADAJADA.EAHBQAGC.BCDAdCCARCFAHCEBhAAA..gEABhAEAeCHFZGDAKDCDSEDAhAFAAEIBMGFA.bEGDCHHA.OGCCDIAA.....hACA......hAIA...,2,-11,-10,1
eSDXPRWALdbgFYCEKBaUcTMIZHQONVGJf,dAAAFAAAEADAaADA..UAGAMAGB..HBDBQCCAOCBDGDFAhACAeAHBDBFBRFCALEHBhBAA..bCGDCGBDBHDAhBCATDAA.ZFEA.NIAB.......hADA......hAIA...,1,-4,-17,13
YbUKOBAeJadQGIRLFXfMSWgCPHZDTcENV,eAAAdAAAGADARADALAGBFAFA..MAIBSCCBCCBA.HCEBhAAAZCFBTFBAEDHF..hACAVEAAUGGABFGDAADBaDDHhBAAQGCA.fGHAPHDA.hBCADAIB.....hBFA...,1,4,-16,20
UWIRNDLBXTZCAJMOGbcYSgFaPKEfHVeQd,MAAAGAAA...bADASACA.aAEDEAHBHAGBeCDBdCCAhAGAIDFARDFBLEHBhAIATEGAABBBOEDD.hAAAgGBBKEADQFCCWFFD.BFFD.hBAACGHAYHCG.hBGA...,2,-9,-1,8
JALUMXKNRgSIGDfYFeaCTEHBVWcdbQOZP,MAAAKAAARACF...SACAGAEADAGAFAFA..eBGHaAHDEBBBHCABhAAABBEA..cDGDhACAbCFD..ZDCBABIBLEDBhAEAXFDDgFGAfFFECFHA..hBGA......hCAA...,1,-16,-18,2
TdUQODNWaEHXReVILSfBZMFCAGgYKJbPc,GAAAKAAA.JADA..bACB..TBGAdAFAQCGADAGA.hAAAaBEBHCDA.RDBFeDHFhACALEEBBEFAMCCBhAAAAFEBgGGAcEGCOFDBWFCH.EGGB.IAHAhCAA...hBAA...,2,-16,-7,9
FQaIELMYCDTcSHZfbNJAeKOUgXBRWdPVG,eAAAOAAAUAEABADARAGB.dAFAGBCA.FDGHaAHB.LCCBhBAA.MBBBDDIBTFDAhAAAHDGBZEDB..bEBDABIBXFBChBFA.PFFBQGGA.hCAA.IHHACEEB.hABASCEGNIAB,2,-18,-5,13
UKCINRgFGABMeLQYaPWcOfZXHVJSTbdED,eAAALAAAQADAaADD...PAFCOAFAZCCAHBEBSCGAhAAAdBGDECAAKDDDCEEDREGBGGCBhABAADHAMEGB..YEHBhABA.fHEB...hAIA......hCAA...,2,-11,-10,1
LHBGVeZIOATSKNJcfaQCbgDPREFdXMUYW,TAAAKAAA..JACAaACA..QAFC.CAHB.bAEDDCCAEAGAhAAA.dCCAMCHBUCGALDDAhAAAHECCGGABhAGAeEHHZFDAADBASFGA.fGFEhBDA.....hCAA...,1,12,-36,48
XaGUDcNOIJeMPAgSCBHLKdbfEQTRVYFZW,CAAAHAAAdACA.EADERAEA.FAFAZCBA..aAHDGCFADCAB..OCCAeAHHAAEAhAAABCFALECBKDDDQDGAhAAA.TFEAhACAYEHB...WFDHcGFDIHAAhAHA.MFFB.hDBA...,1,-14,-19,5
eIBFQUTcLdZaYWPGJgVMXCbEfRDNHAOSK,KAAAeAAAFACAQADA.UAGATAFAdCCAZDFAaAHD...PEDDhAAAGCCA.gCFGhAAAMFBBCFFA.EEFBDFHBhABAHFABADHASGHHBEHA.....hAFA......hAHA...,2,-22,-9,13
eIBLZOEPTcJRGXdHFYUNKVgMWfbCAaSDQ,aAAAQAAABADAZAEBEACA....TAGARAEAdAHAHCDA.FDCHhAAAUCCAKDGAMEFB.hADAbFACABBBeCFH.LDHBhAIAOHFCcGCDXGFC....hBAA......hCAA...,2,-31,5,36
WgUGDdZSLRQYBcfVbMIAJPCXOTeEKFaHN,CAAATAAAKACA..HAEB..NACB.UBGAdAHAZBDARCAABDED..fCCEhAAAMEAB.ABEAXDFAhBGAEEFAFEHD.aEDDhBHA....gGAHSEHH.LFFBhCAAcGGC.IHHAhDAA.,2,-30,-23,7
KOZDUdMEcReCTWPANbgLXHVfBSJFIaQYG,...bAAALAAA.HADBBAEAFAFAaAFDGCAAZAGBdCAAEBHFRCCAeCHHhAAATDEA.ACABXEGAhABASEAAQGCAhACAOEEBMFGBCCCDPHEANIBB..fFHAhABA...hAIA...,1,-4,-5,1
LTGJDFHCBaEOgPRfMYVAcQNZeXIWSUKbd,QAAAeAAA..XADASACAKAGAdCCAGAEAFCFDHDGBhAAAaAGAEBGEOEABRDAAMDGBhAAAACHA.ZDDFUGGBLDHBhADATEDACHEABHHA..gGAHhABA......hAEA...,1,8,-12,20
LAVTUfZWFDCNYKJaXdgceIEHbOGBPMSQR,TAAAZAAADACA..CAEA.KACC...aAEDdAGAeAGBHCCCGCCAMAIBRDFAhABAAAHAUEFA.FEBHJFCAhBGA..XFDDhAAA.IHHAEFHBbGDABHHD....hCAA......hCBA...,1,-10,-24,14
CUIZHDbVYBOQEaLdMWATPRGcFgefXNSKJ,RAAAGAAAFADA.eADA..XAFDKAGACCDAZCEBHCCADCHB...bDFAhAAABDCD.EEABdECDAAAB.hACATFFA.gGDBhABASDGDIAHAOEHDaGGH.MIAAhADA.....hCAA...,2,-18,-18,0
LCKRdDIgObMWEVXcHfJZGBQUSaFePATNY,TAAALAAA.RADFdAFADACA..OADEMAHBECAA..XAGBhAAAHDDCZEGBGCCAQGDAhABAaBHDeCFBAAIB.CEHAKFEAhCAA.bGCCWFHHfGHA...hACA......hCAA...,1,-1,-11,10
UHZMNSKWIbeJXGODQBaEVARfdLPYTcFgC,RAAAdAAALADB..TADAFAFACBFDHCFCZABBMAFA.KBFAIEEAhAAAeBHHGDCA.hABAQEECEDCBAAIBfEGEhCAAPEHDgGEASFHH...hCCA......hCDA...,2,-28,-3,25
ELAQeIdcOUXfRgJYDMNTGHPFCaSKbZBWV,eAAAdAAAOADAUAEARAGB..JAGBDBDB..MAIBGDEA.HEBBhAAACBDAKCBAZEGB.BEDCECEFLEFAhACAAAIB.QGEAhBAAXGDD.fGHA..hBCA......hBDA...,1,-17,-32,15
BeIEaXZJNLTMgFGVPbfCdRSHOUADQcWKY,QAAAKAAAeACE.EACAZAFBLAFAMAIBGBCA..bBDDdEEAhAAAHCFAABHBDDHB..cEFDhAAABFAAaECHJFCBNEIATGFAhAFAFGAB..........hCAA......hCBA...,1,3,-22,25
BaAUGceNWOJEbfLKZVRTgISHPXDFQdMYC,GAAAeAAAOADCEADALAGBZAGB.RCDB.TCCASBFFHCEBDBIBhAAAdEGAMAIBBECDAAFAUGCAhAAA..NEHAbGCAKDCDgGFGhACA.......hABA......hCAA...,1,3,-18,21
QPaFRefXZbTCgMLENGIJdVcHWKSOBUYAD,QAAAaAAA.RACA.eACHZAFB.TAEAMAIBLCEDEAGEGCEBhAEAdDAAHECASCGHhAAABEGAABBBFFHDXEGAhADACHCANIEB.IGGA.cFAD.OHBChAFA.DDDB...hAIA...,1,7,-10,17
QPdXNDMgTeSfFYCLAEIcZKURWJVaHGObB,EAAAZAAARAEA..JACBHCAAGAEABAHB.dCEDDAGAMACA..eBGHhAAAFCHBLEEBAAEBKDDBUFFAhBGAaEGC..OCHDhBIAQGGA.........hCAA......hCBA...,2,-29,-15,14
FURDOfVMTXELaJQCSIGHBWAKeZcNdYbgP,eAAAZAAAdAEA....bADAFAGA.RBFFOCABMAHBECCA..LDDBhABAaCEDQDGBhAAA.SEAAhABAHEBDACCBKDHBcEDCgFEHDAIBTGFACGHABHDD.hAEA......hAFA...,1,-12,-16,4
HedFbBgANOVCRDYEJUaQKIScfTZGLXMPW,OAAARAAAEADE.UAEAQAFC.KBHBSAGA.TCCAhAHAGCCALCHBhBAAMDHBHFDBeDBBbFFDABBBCDFAhBDADHAAaEEC...fFDE.XGGAhBEA.dHDDBHHBhAAA..,2,-18,-7,11
BRKWZYaLCfMQSXIOcDAbeTFdPGgNHUEVJ,eAAAdAAAGADAHADAEAGEBAFARCCB.ZABBLCFAMAHB.QEFAhAAA.XFAAhABAOCFDAAIBFFEHgDBAhAFANEIA.VFDAKHCAaHFESCHH.DFIBhBAA.PHFC..hBDA...,1,17,-19,36
WHCLYdQOeKPENDScfFGBAXIbZgVRMJUaT,XAAAZAAARAEAUCAA..aADAHCDA.LAHBdAGAeBCHKEFAEBEBDADAhABASBHH.hACAFDEHACGAIGGAhDAAVEGBMGBAJFEFTGEA.......hDCA......hEDA...,1,-4,-22,18
eTHgCObYGadfDPNXEVJSQLRUcKZFBIWAM,eAAAHAAAOACAGADAdAFBDAGA...XBFDEBEASBGAhAAARDBBKBHBZEFABCCA.ADEAMDGBhBHATGEACDHA..aEEBfGGBhAAA.NIAB.JFHB.LHDAhCAA......hCCA...,1,-4,-18,14
CPBTXcaDRVEILebgfWZMFUGJOHYNSQAdK,dAAACAAABACA..TADA..aADDRAFFEBHFeAFA....bABDhADAfBHAZDCE.hAFAMCABGEFAHCDCSDHHhAHAACCBXDGADIAALFFB.FFADhAAA.OEEH.YFHFhACA,2,-21,-11,10
gDWTJXLFMVBPHARENIbaOdfYKcQCZSGUe,EAAA..bAAAdADAKAEAQAFAZAGB.GCBAeCABDAAA.TCDAhAEALBHB.MDDAhAAABDHAHEEAREFBaCCHfFAAhAFACFCA.SFCHgGABXGEAhAIAFFEHACFAOHFEhAGA...,1,4,-12,16
VUGLgTCBcINMAZEWeKRSdOHFJPfDYbQaX,EAAAeAAARACA.dAEAHAFBFAGA...JCCFDBDBQDGA.aAHFXBFDhAAA.GEBAhABATEEABDED.IEGAhBEAADAAZFAASGGAfFFEYHBAhAAA.....hCAA...,1,1,-40,41
gTPcNVeUXICdARWbaEBQFfOKSZJMHLYDG,RAAAaAAAEADEBADA..QAFCOAEDZAGBHCCALCCBGCGA.hADATEEA.cECChAAAeBBDXDGAhAGA.dEEAAAHAbGDAKFHDMIBADBIB.PGBC.hABA......hCAA...,1,-1,-11,10
AcUMIRfOBCDZTVQLWGgNPeSaYXKJHFdbE,MAAARAAABADBZABE..QAFAGAEA..PAHBeBHHaCCAKCCAHDFBhAGAdDDD.ADIBUGBAhAIAODFDDEEBLFAAhAAA.gFGHSFHHYHBAFHEA.hBAA......hBGA...,1,-9,-10,1
PMfWJRIAYOGbKZgNFCcQeBSdHVUDaLTXE,GAAAZAAAFADA.QADAeAFHBAHAHAFA.DCDBaCAATCGA.hABAEDFBMCEBJEDBAAABOCGDhACAKEHBCFFD.dFFA.LHAAhAHAfGHE.IHAAYEHBNICBSDADhACAXGDB..hADA...,1,-5,-16,11
RWPXKbOILYfCEUdSZaTBeMAJGFNHVQgDc,GAAAHAAAQADCDADARAEA.XAFBOAHDLCDACAHAdCADaCEDBCGAhAAAAAABFDGD..VECAhACAgDGA.PEDBhACAKFHBIHAAEFFBSFHH..hCIA......hDDA...,2,-20,-4,16
XQEeLIHZSGPNUJAdVbOTRFgKBYfacWCDM,dAAAOAAARADAKAGCBADA...aAEDCBHADCCB..MAGB.EAHBeCFBhACAHCCAGDAAUEEAABBBhAIA..TDDAFCHHfFHAhBAAXEGDLGCASHFGNIDB..hCAA......hCCA...,1,-20,-23,3
dIeAMCWRXgSJHfYVPbTKNUDcOFBaZLEGQ,MAAARAAA..SADBHACCVAGB..bAEDTCCA.KBBDDAGAhAAAFCFHZBGBGEGAdCCAABGBXEEChABAJEEF.fEHAhCAAPFAAcGACaGGC.....hCIA......hDAA...,1,0,-22,22
KDQASXILWGNPRJgMaCdHbEVFZceTOYUfB,XAAALAAAGADARADA.MAFAdAGAHCDCEBFEZCAAeBHH.TDAAhAAAOBHDUEEBKDFAAFDAhABASEHH.hACAIHFAPFFAaGHDCHHA.FHBA....hBHA......hCBA...,1,-3,-10,7
cIbVLYPECaZHTRKMfSGJNgdeUWFXDABOQ,QAAA..bAAALADAEAEAZAGBHCAARAGFMCDBGCEAhAAANCEA.eCHHFCFHAAEAOEABhABA.IECAhACAPDHDaFFBTGBASGGBdGGA....hAAA......hAIA...,2,-20,15,35
gaGWKXUbHcRLEIfABPTdYOZDeCJNQVSMF,TAAAdAAAZABBeADA..CACBQAEAMAHBFBFDGDCAKAGAXCCAhAAAHEABREEFLEHBhAEA..ECGAAAIBBGGChBAAODEDDCEBVEAA.aDGE.bGFA...hCDA......hCIA...,2,-5,1,6
ALPYeOcQSVBKbMCNDFEXZaIdWgGTJRHUf,LAAAeAAAQADABAEAMAGBDAGAEBFEZBGBdCAAGCCA.REFAHFDBhAAAAAHAOCCA.SDDAhABAbCFAFGHB.aDHDIHBAhABA..TFFA....hACA......hAEA...,2,-33,11,44
DCRGVEbMISaOgTLQeUJAcFXdWPYfHKBZN,XAAAdAAA..PADAHADAZAGB.CCDDRDAAEAGA.MBDB.aBGEhACATEEA.eCHHhAAAACCBFCEBfFAEhABABDFAGDGAbFCD.OFFBLGEA....hADA......hAFA...,1,-1,-22,21
fZFeLaAIRXJUbdMBEVQPWOKcgSTNHGCDY,RAAAXAAAUADA.dADAEAFA..QAFA.OAHFKAHBSCCDhAAAHCDCGDBAhAAADCGBZDDBeDGFACHBJDHBbFGDMEEBhABABFFA.PFAB......hAFA......hBDA...,2,-39,10,49
XcORBYMDGfWeJTFNVPCaQEbLSdHZAUgKI,KAAAXAAARACFBAEBDADA..GAFA..eAEAFAHF.VBGBaCAB.hAAAEBDBLDEBHCEBAAAAIFGAhAIAODGDMDIBhACAfGHA.WDDDTECA.CGGD..hBIA......hCAA...,1,-19,-23,4
EGAUKeWIdRVTFPObfgCSDLHaMZXNBJYcQ,eAAAdAAARADAFAGAOADC.....bAGBCCBALCFAHCCAZCFFBDHAhAAAJDAF.QECBhABAACGA.KFAAIDDAhACATFEAfGHADEFAaEGE.MIBA..hAFAXFFC..hADA...,1,12,-45,57
dUIGaHLMDPbSOEQYZXKTANVFJegWCRcfB,FAAAeAAACADA.RADABAGB..dAFAGCCAHBGBMCCBDAIB..SCFAhAAAEDABZDCBKEEAACCBJDHBhABA....gFGAhADAfEAAaAHFbEFD...QGCBhAEAXGED....hCAA...,1,-20,-22,2
NZUABWCYOQeHafGEdgXDbFVcRIKPJMLTS,CAAAQAAAHACAGAFAEACA.dBHADAFAFCAARBDA.KCED..MAIBLEAAhAAATDEAZEFA.AAHABGGAhACAOBGDeHEGaDDHXEBDhAAA.bFGB.......hAEA......hAFA...,2,-11,-5,6
cfLHBSPVGECIJOTWXdgRDQZUYFeaNAbKM,MAAALAAAHACCSADHGAFAEAHBCAFA.OBBB..TBGAhABAdDCARDGFZEDBFCAAeCEFhACAAFAAKFFDBGHAVDFBIFAAhAFA...WDDDDIAA...YEHBhAHANIDB....hAIA...,1,1,-25,26
IBAFTEJUgaLOMGbRXYCHDedPVSfQWKNcZ,EAAAUAAALADAGADARAFACAHA.HCFC.eDAAdCBASCFAhAAA.QDDChAEAKEFAZFAAAADBTGGAaCHDMEGBXFEChAFADFAAfFHANIAB.BGCA.FHAChAFA......hAHA...,2,-14,1,15
CZIebRTOBFXAEKDUYSNVMGQaHLWPgJcfd,EAAADAAAUADA..SACAMAGB.aAEDHBBBLAGB.hAHA.gCGHhAIAfCCAZDEFeCHHRFBABEHAhBAAAAIBKDABNIBB.GDEA.QGBAWGFA.hBBAcGGA.CEDC..hBDA...,1,-2,-21,19
RQBYfAWFONbeKMXDVEJCGLaPTZISHUgdc,OAAAeAAAMAEADAEA...EAHFGAGALBDAaBBCZBDBHDDAdDBARDGFQEBChAAABDFA.hAIAACCBFFFHbEFA.XGDDhABACFCA.IHHASFDH.gGGBhBAA.fGBEhBDA.,2,-25,12,37
WIgPQLfOGTKMUHEVNAZeJaDSbYCXcdFBR,eAAAaAAA.DAEA..SACHCAGA.dAEARBCA..ICGAhAAAQAGALDBAGCEBhAGAMAIBHEBAEDFBABBBbEEDhBAAXEGDBDDDgEGAOFBA...hABA......hBDA...,2,-29,-1,28
SPBAgfXVUTNLQdcWCEMFRKeHDabJGOIYZ,XAAATAAA.LADAdACACAEA..EAGARAGFHCDA.aCHDGCDAhAAAODCBZBFEBEAAADGAfDHAhAEAUFEAQGGChAAAMFFBeGAAbFCD.IGGA...hABA......hAEA...,1,1,-9,10
FCWTgaBUEVfSHZbdADKMJLQeGOXPYIcRN,MAAALAAAGACBXADD..IAHARAFACCAA..TCGAhABAaBBCECEA..SCCDhACAHCGBdEEAAAFAKDDCeFHFhBAAOEFBcGDCFEHDBFAA.fGGEhAFADDDB....hAGA...,1,-4,-22,18
HbTcASagMGBFOdZPKNWEeXDRCQUYLVfIJ,aAAAGAAABADAdADAZAEBKAFA...EBHFeAGFRCDA.QCCAhADALEFAVFAAJBHB.HGEAhAAATEFAAAHA..SGGEhACAMBBBOEHD.PFEB...hAFA......hBAA...,2,-14,-7,7
WcLZMAOCBdIfJKYEbSRVNXPeGQUTHDFga,BAAAdAAAJADAEACA.RAEA.....XAGBeAHHGCAAQCBAhACAHCCAFDFDaBHDLCFBhBAAACABCDHAKFGA.SDDBhBCAPGCA.TFGADFAB.gFDGhBDA......hCEA...,1,-14,-19,5
CYTNVgSLKeEfGJdBPXWcMRbAHQaIOFZUD,HAAAaAAA.FADAZACBCAGA...TAEA..gBGALAGBECEBhAIAGCABdEEDXEGDhBAAMCFBADIBQECAhAAAOBBBDBIBVFGBeGCABGAA.....hCAA......hCGA...,1,-7,-11,4
RgGEcJKXbLMFDTfHYAZaPdBSICNVeQUWO,aAAAdAAASADA..CADAeAEHQAGAOAGBRCAAECEAKBBDLAHBhADAMDGB.TDCAhBAAHEACADHAZEFABEEAhACAIGEANEHA..WGAAgGGB.hADA......hAEA...,2,-16,-15,1
DcRdFTIYfNAgaUQEKBWHSLMVGOeXJZbPC,aAAAEAAABACAHACBMAEAGADA...eAFAZAFECCFARCFA.dCHAFCCHTEBAhBAA..fEFEhAAAABBBQEDCSEHBhAFALFGBXFGDPHDA.DGAA.cGCBhAGA.....hBEA...,2,-10,-7,3
MLgEbNVCQeJGASaPcBXKWTFIYRHdODfZU,aAAABAAA.KACAFADARAEF.HAFB.dBBDDAGAZDDALBHB..EAHBhAIA.VFDAeCAAACEB.SCFHhAAA.XDDDhACAIDHAfEAAMFIB.bFGBCHFA.hBAA..JHCA...hCAA...,1,-20,-26,6
ZabecDLPBSGQCdEXUTWJNHRFgOfIYMVAK,aAAAeAAALADABADAGAEAdAHA.UBGATCCA..JCCBHCEBhAEAREDB.OBBB.fCGEhAFAMEIBAAAAbFFBDDIBhBAA.QFGC.EECBXGAAhAGAFHBA......hAHA...,1,9,-26,35
DMdgSJIcObNEYCGXRAUZKPLBFQWefaHTV,ZAAALAAAQAEAeADHHAFADACA.dCAASAGAJCEB.OCCBhABAECGAGEGAACHAKDEAFDGAhAHAaCCHMFAA.gGEBhABAbECDCFFA........hACA......hAFA...,2,-23,-3,20
cZQeGUaOPNVEWBYJHXDCbRILFSgMdfTAK,ZAAAeAAAaACAOADC..VAFAEAGEBCCAHCCCDCIBRCEALCHBhAAA.SECAhABAdDGAAEFAQFAAGGEBPFABhAFAYFCGCEGC.FFHD.MIAA....hABA......hAFA...,2,-15,-2,13
QZfDRSVYLaeHBCWMOXcEIFbNTJKAGPgdU,GAAAdAAAZABBRADASADALAGB.HAFBBCEAMAIB.OCDBhAAAEDCFFDHDbDGD..JEABAADAgEEAhACA.hAEAfHABDAIBaEEAeFFBCHHAWECD..XGCAhBAA.IHHAhCDA.,1,11,-26,37
YFMTacBOADISWdQHKUegXLJbEfZVNGPRC,SAAAdAAAHADAeAFELADAECBA.ZAGBGCEARCCAFDHD.aCGAOEABhAAAADABDDDB...QEEAhABAKDHDXGDCbFCD.hAEAfGGA.......hAFA......hBIA...,2,-16,-6,10
aZRHSDKTbCeFYMGPINdJgEQBWOVUcXfAL,ZAAAHAAAKADCTAEA.eAGHMAGBGCAB..IAHAhABAdDFDEEABQECAhAAAOBEDUCAAfEHAhACAACHARDGBDDDBFEEHPFFB.gGAABGFA..hADA......hAEA...,2,-30,11,41
bfBPTCQdUFOXYRaWEcZKJGgLVNMeHDASI,SAAA..bAAABADATAEAdAFAOAHBRAGF.ECCAZCAAhAAAGDAALDFAMCIBhAAAHEAAADAB.fEEEhABAQDEAXGAAaEDHKFGAJHEAgGDBhACANIAB.DGGACHHB...hABA...,2,-12,9,21
VSQAKMXLPfZBbdNcIJYTaERWUCeGgHDOF,MAAALAAAZABEdAFA..IAEA.TAGARBGFCAHBeCCBHCAAhABAFCEHQCEAhACAADIB.XCGABEFAbFBAhBAAcECA.aEHHEFGAGGABDGIB.SFFBhAGA...hBFA...,2,-28,12,40
GVFcROIBAbXNZKHMCPDJSTYQEULfeWdag,XAAAZAAAHAEAMAIBDADA...SCAATAFA.ECEBLAHBhAAAeCGBaDDHGBCAhABAFEAARFFBBFHAABEBbCEDCDGDPGAAhABAQFGA.fHCBWHAA..hCAA......hCBA...,2,-17,7,24
NDUdKfceGVZaCSAIWbXFRgTBLHPJEOMYQ,..IAAAbAAA.RACA.TAEAHAFBEAHBMAHB..QCAAhACADAAAdCCDKCFBeCDFZEAAaCHDhAEAADHAFEEALEEBOEGDUFAAhADAfGAAVFDBSGHHXGFDBHHBhAGA.....hAFA...,1,9,2,7
CBYdLIASDFOJVGKfEZgWcbeMaNRUPXHQT,FAAAOAAAGACAKADAZAFB....gAEB..bBBChAFAeAHBaAHD.RCGBXEBChAGAHDDATEGABEEAdFCAhBAAAEGBDFIBfFFEEGGBMIAAPHDC.CHBDIHHAhBHA..hCAA...,1,-12,-14,2
OUaHCYTdPNZIbDeEGKAXgLFcfVRWQSMBJ,LAAAFAAA.VAEARACFQAEC.MAHBOAHDHCFBTCAAhABAdDECZFGBDCCAEGAAADDA.hACA.XDEA.hAGAfDHE.BEAD.aFDA.CFHDPHAAhAEANAIA.IHHAhAHA.,2,-25,-15,10
QJRdCEXbZLVUHSITFgMKfaWGDeNBcOYPA,RAAAEAAAZADBLADAHAFA..TCGAMAHBaBCCGCEA.DCCBeCDAhAAABDAAOCHDAAAA.dEAAhAEAbGFASDEAhAFA.FFFAfEHANIAB.PHAACGHA.hAIA......hBIA...,1,-3,-9,6
bJDRMBAILaZUfTNPdVgQFeOXCWGKcYESH,aAAAZAAAUAEA..TADAdAHAQCAA.FDDAeAFE.hABACBBDGBFAKDGAEFFAHEBChACAbDAAREDFACHALGBAhADA.fFHAPDHDOFCH.XGGChADA....hAIA...,2,-14,-3,11
QegRXMBPHaYFdOUSIAEbLGCWcJNKVTDfZ,EAAAGAAA.CADA.JACBKAFADAEAZBFE..eAFARCDBBDCDHBDB.aBGEdDGAhAAA.UFAAADGA.LFFAhACA..cDGDhAAA.TFCAfGEEQFECMIAA.hADAFGHBIHHA.hCAA...,2,-23,-14,9
QcKPBSTbZDeGYRIgOaMWVCFdUNXfALEJH,EAAAHAAAKACASACE.ZAEBeAEERAGBOCCBaAHDMBFB.CCCA.hAAAdDGDUDGAfEEAhAAAACEBLGCAQFGAhAIABEEDTGGAbECDDGFBIHAA...hBIA......hCAA...,2,-18,0,18
WQBFbaCPLUDJfVOMGeYXZTHRSAEcgNKdI,EAAA..gAAAdADAQAFAFADAaAFDLBCD.DAIBfAHAhAAAMCFBGDGAhAAAeBDBZDDFHDEBADGBKFAABCCDhABACHBA.PCHD.UGEB.OHAAhAHA......hDAA...,2,-10,-6,4
VScTOYLaCHEJBUbFAZWXDeNIPdgGRQMKf,ZAAADAAAeABA..IAEAdAFARBDB.MAGBKAHB....SCCDhAHATCAALAHBhABAHCGBEEFBBCEAFFBAAFIBXDDChACA.gEFAGGDB.fFHAhADA.OECHhBHAaHGE.CGED,2,-32,-20,12
DLRgbFdeUJPXaZHCETKMNfWQABOGSIcVY,GAAASAAA..IADAVADALAGBRAEFFAGA.dCCAeCDBhAAAUDAAJCGB..aCHDHFEAhACAEDFBKEDAMCIB.fGCAhBAAAAAAOFGDDFIBPHFCZGCANIAB...hBCA......hCGA...,2,-8,0,8
LdAHXBgeZaJEMPSITfQWUcbCKGNVDFRYO,HAAABAAAeACAaACAEAFAMAGB...SAHBTBGAQCCAhAAAUCAA.bCEDGCDAhAAADDIBRFAALEGBhAFAABFBZDGBIHBAfGDACFFCKGHB......hAIA......hBIA...,1,6,-20,26
CUHagJKTcfVFdXNLOBZGIbeQWSDRAYMEP,EAAACAAAHACA..aACDKAFC...TBGAfAEAdCAALCCAhAAAZAFBGCGAeDFFQDDChAAADDIBAAIBMECBgEAAhAEAVGFA.XFFDBEGA.IHBAhAIA.WFCA..hBCA...,2,-19,-6,13
ZfWHIcJESCdaQUXVeMFbTGKNgDBPLAYRO,RAAAZAAAHADBJADA.EAFA.dBHAQAGC.UCAAeCCB.bCFDGCDAhABAKDAA.DCIBLEEDhAAAACFB.fFAAhABAIDGACFFAaFGEMFHBFHCC.....NIAB.hACABHHA....hADA...,1,3,-23,26
TNJBegMfdAOWUCHFXPELaKcSQIRZGDbVY,OAAACAAAHACAFAFA..EADALCABKAFAQCCARCCAGCFADAIB.hAAA.VFCA..TCEAhAHABBHAeFHBMBBBACGAhBAA.XDGAaHDE.SFFA.hACAbGFA.YHDAhCAA...,2,-28,-3,25
VNZDJcTeBCRFSPbKdXLMIQAagWGYfEUHO,aAAAGAAA.EADAHACBOAFCZAEADAFA.JCEBeCDA.RCGBSDADhAAAKCGDdEHALFFBhAIAMDCBAAHA...gEEAhACAYBBF.fFHA.NICB.BHHAhBAA.....hADA...,2,-21,-15,6
NMAaYEbDTRcXKLWfJeZCPSOQHdIBUFgGV,EAAATAAARACA..KAFCLACB.JAEAeAHFZBEA.SCCAhAAAHDEAdFGABAHBFCFBGDAAhADAMCIBAEDBaCHDDGDAXEEAhCAA.CFHAOHFA.....hAAA......hCAA...,1,-6,-23,17
bXHYWgIZGMCEcKATdfRLSNaJUVQOBDFeP,dAAARAAALADBaADA.UAFAQAGABAHA.eBDB..bCFAHCAChACA.gCFBhAGAGEEAEDCBADFBTFFAhBAA.SDHHVFBBFEHH.XEBAIHHAhAAAMIBA.CHHA...hBCA...,1,-2,-8,6
HdfeYKBbWMcNAFZRISEgXPaVGJQLUCDTO,RAAAEAAA..XADBaACDGAEALAGB.DAIBHAGDdCCAeBEHhAAABCBDbDDD.MCIBABGBZDFEhABASDFHVFGB.hCAAQEAA.TGGA.fGAEhAAA.KHEA.hDAA...,2,-18,10,28
OIbefcRGZVNBaDTSdMPKALJYCQWUXFHgE,LAAACAAAUACA.HADB.EAFAOAEC.eAHHRBGBZCAABCBDaDFBTFAAhABAdCFA.MEEBhACAAAGAQDDAFFGA.hAFA.gGEHbEGD......hAIA......hBIA...,1,0,-36,36
gHfQRLaBKJNUZXDGOebdVMTYFSCEcWIPA,HAAARAAALADBaACAKAFAUAFAZBFE.GDEA..eCCBdBHAMCCBhAAATDGAFEGAEEEB.IFAAhAAAAFBBQGGA.hAFABGDAXGDCDIAA.......hABA......hAIA...,1,-9,-15,6
UKRSCMJHGTLgYAZNbaFQPXWODcBdEeVfI,ZAAAaAAA.QAEA..XACDDACAdAHAECCBeAEA.fAHAhAEAKCEDRDFA.MBBBhAFAHFFCGCDBTGBALEEAhBAAABGANIDB.bGCA.FGGA.....hABA......hCAA...,2,-14,0,14
GMecaTOESZVAdIDXRQJWBfYHNbgCPKFLU,dAAAXAAARADA..QAGCBADAHAEB...bAGBCCBAFCEDGDAAhAAAeCHFaCDHEDABZDFEADDBDDGBhACAfFGA.hADAgGBHLFFAMIAAOFHDIHHAhAEA.....hABA...,2,-14,-3,11
UKgfWZJOTFQSVbDLeCBdYNcPXIGaEAHRM,HAAARAAAMADAKADC.....fAFAZAEETCCAQBGAhAAA.bCAAeAHHdDFANCEAhACAXCED.aDHDhAAAAAHAgFGAOFFBSGCALHFABGHAhABA.....hCAA...,1,-5,-16,11
HUILNPSgebWfGcYFREdTVaZKOQJBDCXMA,HAAALAAASACEeADH...bAEDGAFAFAGA.EAHBdCCAaCAAhABAZCGBQEDAhACADDIBMEEBABGBIDHA.hAAAgFAAfFFERFFF.KHGABHHA..hAFA......hAIA...,2,-8,-4,4
EcdBUCgIGODFAfVMXWJPRaHYZSQeTKbNL,MAAAXAAA..JADBRADAHAGBZAEB.eCDBKAGALBBBECFB.hAAAdCGACDAAGEGAFEEBACIB.hAIAfFEA.hBAAPGAAaEHDQGDBNIAB.BGGD.hABA......hADA...,2,-24,-4,20
BKaPbSFZWJgDMYfcdRVEQHACNGLIOUTXe,GAAALAAAOADATAEAeAGF.aAHDSAGB.ZCAAhABAgCDAMAIBfCEEhACARDFAEEBFHFFCACCACCGDIEAAhAEA.BEED.bEGB.FGFBDIDAhAAA......hACA...,2,-9,-2,7
VLMAPBUEaSJbCXNQZIOYfTFRDdHegWKGc,BAAAEAAA.aACASACA.CAFAQBGAZAEBOAGDTBCAhAAARCCAHDABeDFF.KEGAhAAAGDEBLHAAAAIBPCBBhBCAUGGAXFCA..IFHAhBGA.FFFH.DICA.hADA...,2,-18,3,21
VdEBPKCGHLMDSfZFTNgYbOaIXQUWRecAJ,dAAAEAAAKACAHADA.MAFADAEAZAFEFBGD....TCBA..gCCAhAAAOCFHaCHDQCFAhAHAREDBADAB.BCHAhCAACFHALHFAfEEA.bFGB...hACA......hADA...,1,-14,-24,10
FdeUcAVaWRYbJfIKGOBEPQDMXLHTZCgSN,aAAARAAA..JADAKADAGAGABAFB...ECCAQBGA.MBBBhADAHCEBZCCASDHHhAAAdECAeEEAAAHAVGAA.hBAAbGFAOEHDDEDBXGDDTGDACGGD...hABA......hAGA...,2,-15,-10,5
JUbXdLNMZVDIKEeTfFPCaYSRQcWBgGHOA,UAAAdAAAMADAZADADAEAKAGA....EBDAeAHBFCBD...aCBERCFAQDDChACABCEAHCGBAECAJEGBhAIALEEB..hAIAIGCATGGACGDCSFHH.WFFDhBAA.....hBAA...,2,-26,-19,7
BFGNbQKPHJSTLAXDZeOdUacYgECfRIWMV,ZAAAeAAAdAEAUAEA..aAGA....gBCFEBGBRCAA.MAHBhAAAFDEAGEBA.hABAbEEAQDEAhAIA.HEGBSFHHABIBOEDB.CGBAfGEAhBGA...hABA...,2,-25,-10,15
PJbAGTIMFCOaWRLVNXYeDHSQUfgcdEZKB,GAAAMAAAFADDaADALAFA..XAFDeBBBHCFAQCDChAAAUEDA.fAHEhACAdEHAEGAAZFFBBDFAPHCAhAGAADHATEBACHHA.REFANIAB.SGHBhAIA......hBAA...,2,-8,1,9
PGJEgYMDfUeLCRFVBcOHdZaQTANIbWKSX,..IAAAbAAA.KACAXAEA.GBGAEAEEMAHBDAAAeCCAhAEARCAABCEAHDEBZDFEaECAhACAAAHASEHH.hAGAgFAAfFGACGEDFGGHOFHD.dGCAhAIANIBB......hBIA...,2,-21,10,31
XENMcLIdSRTYAbKOQFUfgCDGeHVZWPaJB,OAAAQAAAFADD.UADA..CAFAeAGHHAFAZCEE.aCHDXCCChAFAEDBA..MEFBhAAALDFAdGGASEGGhAHARFCAAAIBbFFB..fFHADIAA...hAIA......hBCA...,2,-22,-8,14
NKadTAbRPfUYSMEXCegcGDOBJLVWHIFZQ,RAAAUAAAMADAEADA..eAFAGAFABBDALAHBHCDCZCGBQCDChADAaCCH.AEFBbEGDfEEEhAAA.XGCAhABACFBADEIBOHBA..WFHH.FGGBdGFChBAA......hBCA...,1,-5,-7,2
OeTSYAIgGVbRLfZQMBPJFNaHKdWcUDXEC,GAAARAAAZADBBAFAFADAHAFB.dBHAUCFAECDB.eAHB..TECAhAAAAAAA..VDAAbEGBLFFBhACA.MHAAhAHAPEEBNIAB.aFHBWFHHDFDB....OHDEhADA.SGHHhAIA.,1,12,-30,42
fVRBCMgAcOEWdHTPNLQZKbGFJUaSDYXIe,EAAAHAAA.TAEALADAZAGBGCABFAHBaBCC.DACA...XDEDhAAAeCDARDEAMCIBABIBODHDhAGAdEAAQFGChAAAKECBbGCA.SHDAIGGA.....hCAA......hCDA...,2,-6,-2,4
RQWTIPVBDKZbXCYaNSUgFeAHdGcEJLMfO,HAAAGAAAEADEMADARAFF.QAGA..TCCAICDAhAAABAHBZCEBbCGDCDGAaDBDSCADhAAAFEHDAFGB.dECDJGDAhACALFAB.OFDE.WGEADIBA.hBAA......hBCA...,1,3,-12,15
CfWXaEZQcbeHAJVNRBKTMOdYPSgUGFDLI,VAAARAAAKADC...MADAdAGA..SBDAGAGALBEB.hAAAfCDAaBHDECCBZDFAhABAbDFDHEDA.AFHBBGBAhAIATGBAOGDEPHFA......hAAA......hAIA...,1,-13,-14,1
XVINYZREfQDBHOPcGJLFWSgAMUaCdbKeT,aAAAdAAAeADA..TADAXAGA..IAGAZABBECEAQCGDhAEAHCCAOAHDGDCAhAHALCFBSEEBhBAAABBBMDABbDGDKEGA.YEEFDGGABHHAcFADhADA.....hCDA...,1,-2,-5,3
aAIPFgVRHWXZBUcQCJbEYOGKMTDeSLNdf,FAAARAAAHADBZACBBAEAQAFA.CAHAECCBGAFA.MAIBeCHFLDEBhAHAdDAAAAAA..gEEAhADAXDGDUGGAhBAAbFAAKFHBTECA.SHBAaGGH.hAFA......hCAA...,2,-14,3,17
MKDHZUgQNRYJdFLfbVBXeTSaAGEWOPCIc,EAAAOAAA..CACAMAEAHADAZAGB.QCCCRBCAdBFALBHBhAAAbDFA.BDED.eEFFhAIAaBBHAAFA.GFCBIGGAhCAADFFANIBBFHCA..fGHA..hBAA......hBIA...,2,-20,-9,11
RIKWTaDGVdHNBfZLgFbSJOQeAcPMEUXCY,MAAAEAAAUADA..CADARAEFKAFA...aAHDGAGA.HBBBBBCChAAAZEDALDDAbFGDOGAAhAGAADHAXEFA.hAIA.IGEATFDAdGGDNDIA.FGCH...hBAA......hBBA...,1,-10,-21,11
UPdDNWbYMGZfXTeISVgABRLOacHQECFJK,RAAAaAAAHADB.EAFAFADAKAHBdAGA.DAIB....bCFDGBBBZDAA.hAAATDEAeCHBSEEDhABAADGALEHBQGBAhBAACCCDPFAB.YFGDMHEA...fEDEhBBA..hBGA...,1,4,-27,31
dfYPEJGUWXVFLeaHRIcgbSAMDTKCOZBNQ,MAAATAAAKADA.ZAFBQACC.dAEAfAHAEAGAGCEBhAAAUCBAXDDCLDDBhAFAHEFCRDFA.gGAAhAGAABBAOFCHBFFDPHCCWFHBFGGH...IHGAhBAA...hBIA...,2,-16,12,28
IeXaPWCEUHVLBNgcYDKRTbJdOASMQZFfG,MAAAZAAAGAEA.eAGBaACECAFAHCAA.LEAABAHA.gDGAhABADBBBRCCAJCFAACCAQGDAhACA.fFHAhADAXEEAEEHB.UFAA...NICBKGHDhAFAdHABSGGDhAEA..,2,-35,19,54
bDMaKBSdXTfYIcNPFOZgLVJRWHQCUeAEG,EAAAGAAADADA.aADABAFAdAGA....TCDAIAHA..PCHDhAAAZBCALCGBhAAA.RDBAHFEAQEBAhACACDFAABDAMCIBXDFDfGHAcFEC.FGBHhAIA.gGGBhBAA...,2,-18,-13,5
fEZaPcbGVWBJSDdHOXACITYLNgFRKMQeU,TAAALAAA.FAEARACFKAECeAGH..EAGAaBCE....bBFAGCAAhABABCAD.DAIBHCDBhAAAACABCDDA.IDGA.hACAgEGAMCFBQDGAfFDEZGFA.hDCA......hDDA...,1,-8,-17,9
ZNTOIKYfQdXbGLUBVCPcRWSeaMHgEJDAF,ZAAATAAAKADC..QAFAdACAGAEALBHBBAGACBHA..RDDBeDGBhAAAHCAAECEB.ADGAOEEBhABAfEAAUFGAPGAChAEASFCB.aGEDMDIBDIAA.FGFB.hACAIHHA..hAGA...,1,0,-13,13
WKQXJZFMEHfcaeALDCgPTIYdUVGRbNSBO,LAAACAAA.TAEAdACAGAEA.RAGBSCBDOAGDQCAAhABAZDDFFDGHHGAAhAAAaCDBAAIBDCIB..gGGAhAEAIDFAVEDB.bGAC.BEADXEBAhAGAEFHBeHEA..hACA...,2,-9,-8,1
MUCLPFaWQSbEGNAOgdKXHBJZTVfcDIeYR,dAAAHAAAZABBTAEA..fADADACAeAGHRCCAMAFALDHBhAAAaBED.QEEAhAGA.EHEAABGAKBHBBEGAcCGChBAAIHHACDDDFECH.bEFC...GGEBhCEA.....hAIA...,2,-7,-6,1
SLRGVYAagOFPfXCEcDQHBMJNUKbeZWTdI,aAAAFAAA....XACDEADAQAFAHAEAMAIBUCCA.eBHHhADAZCDEdEAALDFBRDFAGGABhAEAABBBOEHDCEEDBFGAKFCAhAIA...WHBASFHHYHFA..hBAA......hBHA...,2,-12,-7,5
QEVWfZSHXFKbDaeITYAOBNgRCMLPdGUJc,BAAARAAAMADAdACA.GAEAUBEA...QAGAEAHB.VDGBhAAAZCCBHCGB.KEEAaCBChAEAeFHF.TGCAhAAAADEBOEBB.CFFD.........hAGA......hBCA...,2,-29,-14,15
NgWBHQADFGOMbKUJeXIdcaPSTRCELfZYV,GAAAMAAAKADAeADA.dAHAaAFA..TCDAEBBBZBDE..VDFAhAAA..gCFAhAIAHEACAADAOFFBUFFAXEDDhBAAIGHASGBACDHA...hBCA......hBIA...,1,-1,-26,25
caBNgCeVFAKXHYRQdOUPEMJDZLGWTbSIf,HAAARAAAdADAUAFAEADEMAFA.ZBDEGDDA..bBGDSBHBhAAA..fCAEhAAAaCCHBDGACFBAeCCDAEIBKFGAhABAQEEC.OFHBDGDB.LGDAhACAIHHANIBB.FGFH.hBIA...,1,5,-21,26
TgHXOBVNUQMPDYZAdRWGLJSfEFceKIbCa,RAAAGAAALADBSADAEAFA.eAFHKAHBCCCCaAHB.HCDBBCFAUDGAhAAAMCHBDDAB.ABIBdDCChACAJEEB.FFFH..bFAA.hADA....TGFA.....hAEA......hBAA...,2,-29,-4,25
UJFNKRHfAXLMIEdCZTSbGgcOWaPYBVeQD,MAAAEAAAZACB..TADAGAEA.OAGFaAFABBBAeCBD.QDGBhAAADAIBFBFDRCGFHDCAhBAAAAIBLEDBdFFACHGASEHHhBBAbFFA..gGAA..hAGA......hBCA...,2,-15,-5,10
dfXPISNacDMGURWeBJOCbTLYVFZQgKAEH,HAAAdAAA.XADBSADA.aAFDMAGBRBGFBAHBCAHALCAAhAAA.FCEDZABBQDGAhACAACEBEDCF.fFBAhAHAIEAADDFBUGFAeDHHOHCAbEFD...hAEA......hBAA...,1,8,-24,32
FNafMPJcdQCYLeXHIUTgGAKRDbOSBEZWV,RAAAOAAAEADE.ZADBFAFA..aAFDMAIB..JAHBdCCA.QCFAhAAALCCDHDEAUFCAGEEAhABAABBBDDBBBEHANEIA.hCAAfFGECHGA.eGDE...IHAAhAHA...hCEA...,1,-11,-17,6
EgAKRSbaFYMWXcNBZVLCdJGIHQUefPTDO,RAAAaAAAMADA..XACDBAGAZBDB.LCCDdAEBGAGAHCGBeBBDhAIA.TDDAEEFBAAAASFCAhAIAbDFD.hBAAFFHDcFBA.CEHAIHHA..hBFA......hBIA...,2,-18,-11,7
ZIBgXcQOCRVKUPGFSAfTbYWeEJLDHMadN,TAAA..bAAAeACEEAEA.LAFBHAGBdCAAZBGBBCCD.XCEChAAAQCCAREAAKDHBhABAGEDBAAIB.fDBEhAAAYEFBDFEBaEHDgGGGCGBA.hACAPHAASHFAhAEAMIDA...,1,9,-11,20
dRcISDfVJbUMGWgTaOEHNAYZPCKQFBLeX,ZAAAKAAAQACCLADBeAFARAEF..SAGBDBIBJCAB.MAIBhAAAGCEA..TDDAhAEAECGBHFAAACGB.CEHAXGFAhABAdEGAfGFE......hCAA......hCBA...,1,-10,-27,17
UdNWAGaBVeSPJDbLTZHcFEKQOgIMXYfRC,aAAAeAAA...SADADADALAGBHAFBEBBBQCCAhAAA.OAHFMAIBfBDAhBAARDFAdEAAAFDAGFDBhABABBFAPHAAbDBAZDFAKGHBXFBACHFA.UFFAhBDA.....hAEA...,2,-8,7,15
NSebWDKBOJTXYUZIQEcFafHCgRPdMVGLA,eAAADAAAOABE..TADAUAEAZAGBEAFEFBHDHCCA..RCCBdCFAhAAAGEEAAAHA.SCHHhBAAbEFABFDA.XGBAhBGAQGGCaGHB.CHEA........hBIA......hCAA...,1,-10,-16,6
dAMCfBVFQcbeUJIHLKNWYEPZgRXGDOTaS,MAAABAAAQACA.eAEAIAEAHBFCLCABhAAAKAGANBBA.ECCBZCCARDFBGEDAhACATCGAdECAAAIBCDHAFFHDbEEC.hAGA...UGGA...WGCAgFAAhAFADIAA....hDAA...,2,-14,6,20
HDAOefRUIQgTJdNaVbEXSBWFZPMLCGYcK,eAAARAAAQADC..TADAdAFAaAHBEAFEBCCDZBFEMCCB.hAAAGDDAKCHBHDEAAAAAfDGAhAHAgFGAVFGBhAIASEDD.WHFA....hABA......hBIA...,1,-3,-21,18
DCfaZWdMeKSFQILYAORHBXgUGTcJENPbV,HAAAXAAAGADA.TAFAEADA..bAFACAHBZCAA.dCHAeCDAhAAAFDFBLFAAAAGARCGBBDAAUECAhABANHDB.DEFBaFGAMFIBhADASHGAQGFA.....hAAA......hACA...,2,-2,-1,1
XNUfSLFAEPcDJbOCdVBGIYaZReKgWHTMQ,EAAADAAAOABEdADAGAFA..aAEARCBBeAHBKAHB.HDDB.MDHBhAAAQBEDUGGBLFABhAFAACCAJCHF..bDDC.hAIABFDA...ZFFA.....WHAAhAHA.....hBCA...,1,-1,-29,28
CJSGdUVDHBfRAYQZgTcEeObIPLFaWKXMN,ZAAATAAAEADE..eAFEOACA..ICAALAGB.aBDCXBEAhABAMAIB.CCCDGCGAhACAdDDADCCBHEGBRDEBACIBQGGBhAIAbFBCFGED.KEDD......hDEA......hEAA...,2,-6,-5,1
egIPLQcbaAdUWTCYNXEHRDSFZfGVBOKMJ,dAAATAAACADA....XAEDHACBRAEAFBHDGBGAOCAB.MCGBhAAAeCAA..gEAHhACALDDBbFEDAAHAUEDAhAEANHAB.EEHBDAGAfGGAKGGA...hACA......hADA...,2,-23,5,28
CAMDGEcaFLPbYgIHRfOXeZSQVJdTUKWBN,GAAAEAAAFACD.LADA..bADDgAGHHAFARCGB.XCDAhAAAeEEBZFAA.QGGAhAAAdDGATECAKHAABEADhACAAAHAMIDAaEHDIGEA.SGGDhAEA....hAFA...,2,-14,4,18
DVfNYEPRMCIHJOZQgeUWTacXLSBFbKdAG,GAAADAAA..VACAfADA.EAFARAFFMAIBHBFCZDDAeBBBhAFATFAA.aCECLDDBhAHAFDHDdGGAAAABPDFBhBAA.CDHD.OFFHQGGA.WHCAhCAA......hCHA...,1,9,-26,35
LOCSNYgIebDKXRTMZcJBUHGafAQVPFdEW,QAAAFAAAEADA.LADASAFA..gAGHhAAAeAHHbCCA.XCBA.hADARCEBZDGBBDGDHEAAaDHDACCAhAGAdGDACECAIFFAKGFD.MEEB.cGCChBAA.....hAEA...,1,-1,-16,15
FeOEYaKfTAQLGNJBSgUWCXHVIdMDZbPcR,GAAABAAASACAUADACAFA.HAEBdAHAZCDE..bAGBRDFAFEEHECAAKCDDhAAA..AAABLFHBhACAgDAA.XDFDhACAMHBADGGBeEEDODBDaCHDTGBA.hBCAQGGA.hBDA...,2,-17,14,31
OFBTUCVZHWaEKYMcdDJGegbLRSAQXfNIP,QAAAXAAA...IADAFADATAGACAFAHAGB.ECDAMBDBhAAAdDFAGEGAeCEBbDFDhABARFAAAAIB...fDCEhAAAOCHDBFCA.ZGAAaEEBKGHBDDIB..hAFA......hBCA...,1,-3,-7,4
MLCOJFagbfDXWHGVYQTcKRedZUSBAEIPN,EAAA..IAAAMADALAHBOACAaAFD..bBCADAHBHCFBhAAAGBCAQDBAhBCAKCHBREEAeCBDZEDFBBGBAAIBCFBDFFHDhBCAXFFA..YGDA..hBFA......hCAA...,1,3,-18,21
BFZXcYdVAPSDNJeCTQEgKUHLRabOMGWfI,DAAAeAAAQACAEADAKAFA.HAEARCCA.aAGAMAIBGCEB..fCFBhAAAFBBHZEEAXGGAhBAAdEEAACCA.SHCAhCAACEHATGFALHAA..WDDDBHEDhABA......hAHA...,1,1,-16,17
PedKacfWZBXSUFVbMHDQTLJgNGROAIYCE,CAAAEAAAdACAKACA....aAEA..fAEBZAGBBBEAUDDAFAGAMCCAhAAAHEBBQCFAhCAALEGB.NCIA.OCBBhAAAADDAIEEA.eFGBcFEDSHDAhCBADBIB......hDAA...,2,-21,-21,0
SWHTbVJQeACfPDUENXcOgLdKMaBFGIZYR,CAAADAAAUACAEACA......XAEAOAECdAHAaAHB.GCDBhAAAZBBARCEFHDGB.bFAAQEEBhAGA.ACBBfDHAhBCAcGEA.KFHBMBIBFGCASGGDhCAA...hAFA...,2,-18,-16,2
PgYGBaTRQLFVcfXMKZIbWANdCeOSJEHDU,dAAAeAAASADAHADADAFAUCDB..gAFHGBGAaEECRCAALCEAhACAFFHD.fDHAhADAMCCBZGCA.bEAAhAEAAAAANIABOEEB.EFGB......hAIA......hBAA...,2,-11,-8,3
PBYMSNZGgWLRCFdDQAOeUcbVKXHEaJfTI,eAAAUAAA...VADAHADA.EAGE.aCBETBGABCEA..MCGBhADAZCCAGDFALCHBRGAAdEHAhAAAADHBOEEB.KFAAhAFA...XGGAIHHA.SAGEhABANIAB.WEED.hAIADIDA..,1,-5,-15,10
RBdUAYEMTIXNOZGSbcWfgCeaPFDKVQHLJ,EAAAMAAA...TADAXACA.ZAEBGAFASAGA.hAFA.bBBDfCCAhAAAeAHBaDDADBBBQCGAhADAHDGBJEEFREEAdGCAAGGBIHHAOFHD....hAIA......hBAA...,1,-3,-8,5
FCbZQAHNWGJBcLDUgSMTOXKIPefYRdVaE,HAAAGAAABADBLADADAFAUBFAMAHB.TCDAKBHB..eCAAhAAARDFBaCHDEDDB..bEAAACEA.hACA.JEGBSFFDhAAA.XGCAfFEA...YFHBhAIAFHGE...hACA...,2,-26,-3,23
ZWGYSNBUJbMdVcDgReFICLAafQHOXEPTK,aAAAHAAA.EADEKADAGAFA..SAFBBAHAbCAA.dAHADCEBRCCAeDABhADACCHALEFAABBBQDFAhBAAXFAAZFCANHEB.hAAAMDIB...gGGBfFDAOHBAhBHAWHAG....hCAA...,2,-11,1,12
QgTGFKERNYSCJBHeIWdaVLDcMfAXbPOUZ,XAAAOAAAZADB..QADAGAFAEAHBRAFA..SCDDhAAABBBDHDBAeCFAdDHAaDFHhAIALDABMFBBABDBbDFAUGGAhBAATFFAKHEC.CHFDIHHA.DIAA.hBFA......hCAA...,1,5,-3,8
GACERgSOHWQUJTYKcBbaIXfLPMZFDVeNd,RAAAOAAAHADBQAFAUAEA..TAGAKAHBBCCD.aDABfBBEhAIAMDFAZEEADEGAhAAAeBDDGFABECHFSDEHhBAA.YDGFIHHALEBBhBEA.FGHD...hABA...,2,-11,-4,7
GZUEBXbDNKIdgafPCMSWVLeARYFOHTcQJ,RAAAOAAAHADBQAFAZADBBAFA.DAIBKAHBdDAA..aBBCCCCDMDFAhAAA..SCEHhAHALEEAAEIBTCGAGFABhABAEDBBbGEA..gEGAWHBG.eFFDhBAA.FGCA....hBDA...,1,8,-26,34
RfHgJLCUWGSNVZEPOYQMbcIXFDaABKeTd,eAAARAAAHADBLAEACAFAGAGASAHH.ZBAEECCBOCDChAAAMDAB..IDFAhAAADDHBAAFATEEAdFFAJEHBUGCAhABANEEA.PFHD..bFADXGEA.hABA......hADA...,1,0,-7,7
PSXfJROIQTgZEAeYFHMVWCNdKBGbLaUcD,eAAAHAAAMACACADA.dAGAGAEALBEBaAGA.DAIB..SBGBhAAAfCCARCCBQDGBhABAZDFBADIBFECD.VFFBhCAAKEHDbGBA..........hAAA......hBGA...,1,-10,-13,3
fVSFbEMcYNDKURTeWCILXAGQgBZJHdPaO,GAAAQAAAZADAHBGBaACE.OCDB.SAGEEAFAMAIBNBHAhAAAKEAD.REEA.eCDACCEB.hAAALDABAEEABFHA.dECAhADAfGGEbEEBDEIBTGGA.XGDDhAFA.....hACA...,2,-17,15,32
NcSgBOWDTfVPMKaJdIRHEUYGeACQbXZLF,QAAAZAAALADBFACESAFABAFADAHB...TCAA.hAAAVCFAMAIB.aCDAdEEAhABAHCFBEEHFGGABhACAADDAbFAA.XGFD.NFAB.OEEB.fFGAhAFA..hCAA...,2,-31,9,40
GIdfZUSbWVPLEYRQCegTAaOXHBDMKFcNJ,aAAAHAAABADAMACA.FAFD..JAFAdAHAZBBASBDH.VDEAhAAAEBFBRCGF.eDAAACCADDIBhBHAKDEB...NEIA.fFGAhCAA.WHDGPFGB...hDAA......hDBA...,2,-30,-24,6
dKPfaIRTgJZWUbFDVLcNYeAGOEMBXCQHS,EAAAMAAABACA..QADAHADBdAFBKBGDaAFERBBB..TDEAhAAAZCFBUEDADAIBLDHBhCAA..cGAAhAGAeCCBAEHBXGGASFGDfDHA.hCBAIHDA..hAIA...,1,-11,-25,14
bNFcMCYfBPDGaVOTKgIQUAZHEJWSeXRdL,HAAAEAAA.SACERACAdAFALAHBFAFAMAIBCCCD.BBEAGDAAaCCB.hAAAOCEBKCFA.QDFDhAAAADDAZEEAeFHHbGFANHCB.hCAA....fHBFDEGA...hCHA......hDAA...,2,-13,-5,8
NBRKAeHaEbXJGWSPdFZfITDQCLgOcMVYU,HAAAEAAA.XADBGACASAEAdAGAZBEB.TBGAQCABhAAALDFAOBHDMCBBhAAAUFFAREDBAAEAeFCBbDCDWHEGhACAfFFB.CAHB......hAIA......hCDA...,2,-2,5,7
XFCERaWBLYZMKcOVQDbHTNdJfgePGUSIA,CAAARAAABADBZACA.KAFAOAEA..QCCAHBGBdCCA..JDABeAHHhAAAGECBSCEAhABAAAIB.EDHFaEHDLEFBhAFAMHFADGCBbFCB.fHAB..hAHA......hCAA...,2,-22,-19,3
ZPWIBYCFTVHQfeAcEObRDgaLUdXNGKJMS,EAAARAAADADALADA.dAHAGAEBKBCD.MCCAZCEA...ICHAhAAACDDDTEAAHDDAeDHHhAAAAAHAOEGD.aFDChABAXFCA.SFFBWFHH.FHBAhAEA......hAFA...,1,-18,-21,3
UPGgaAZCeQJRTSKWMEBbXVNLFdIOHfcDY,eAAARAAAKADC.EADABAFA..XAFALAHBdCCAHCCADAIBUDFAhAAAGCFAACFAZEDBQECBhAAASFGAMEIB.bFGDhABAFGAA.OHEC..fHBBhBHA......hCAA...,2,-11,-11,0
TBFMZacQWURYeHdGDPLfKIOAbEXgJNCVS,EAAAXAAA..NADA.SADABAEAZAFB.aAFD..QDGAhAAARBGFHCDBGDAALCBBhAEAKEGDAAAAbEDDCAHBFFDHMFGBhAIA..cFGD.WFFDeFCF...hADA......hAEA...,2,-9,-9,0
JdNaPDbSWOFGeYHLRUQcETXfBIKZgAMCV,MAAACAAAdACA...aACEDAEA...SAFAFAFAeAHHHBDCRBDFUCGAhAAAEBBB...TDDAhBAABCBDZDEBADGBJDHB.bFFDhCAAOFHB.........hDAA......hDBA...,1,-13,-41,28
MPVTZJYcLXdOIFbfKESNAaHgCQUBGeWRD,HAAAQAAAGADARACADAFAMAFA...TBGAZBEEJCHBLDAAhAAAdDAAFDDH.bDFA.EFBAAAIBCFEAhAAAeFDA..VGBAhADAXGGA..fFHASHFGaGFDhBGA......hCAA...,1,17,-21,38
BZCGUFKLWOPdaHSDcgYeTMEbVRXQfNAIJ,BAAAGAAAKACALADA.OAGDaAEAHAGBDAIB...gBDAhAAAeCDBECEEREAAQCAAhACAAAABZEGBFFED.dDFA.hACASDHH.TGGAMFIB.XFEChAIANIDB.CHEA...hBIA...,2,-23,-2,21
UFOeRQMXIKdPJZCBWEAVcYNSabDLTGHfg,VAAA..NAAA..aAFALADB.HAFAfBBAFCFHRDGFMDCBhAAAKBEAdCHAZFAFBCHBhAFAAAIBSCDDDEEB.GDBAhABAOFFBeDGDIHHACFDAEFFB..YFHBhACA....hADA...,1,-7,-22,15
CFaMJgIfZTVSeLbBANWGRKEcHQPUOdYXD,GAAAEAAAHACAQADAOAEA.dAGADAIBaBHDMBHB..gCDGhAAAZCCATECAeDADhACAbFFA.ADGBREFA.KGBAPHFChAAA.UGCBCGHA........hCAA......hCBA...,1,-3,-4,1
TLbDSUCAXRHQgfEdPaBMONJZKGYWecVFI,HAAAQAAAEADEaAFAMADA..OAHDZAEEGCBBeBFFFCAHTCGAhAAALCCBDAIBCEEARFCBdDGAhAAABEGDKEED..cFGDhACAIGGASGEHACFA.....hBCA......hBDA...,1,6,-17,23
eWPOUSVfJFTZCMdKXbIDNBHGcQYgRELAa,eAAAOAAAUAEA..SADAJAHB.ZAFBdBDCKAHB.XBBChAEAbDED..DCCBHCDBhBAAGGBBQDGAhCAA.RFCBAFFAaGHB........hAAA......hABA...,2,-33,-10,23
SbNfIKJYUHFEPgdCBQTDWGaeMVOXAZLcR,ZAAARAAA.SACE..bADB.IAGAKAFAUCCB.HCFAhABAEBFBdCCAQEFBhAFADAIBaCGD.eEHH.MFCBhAHAXEECAAIB.LFHB.fGGAhAAA.YFDFhABA..,2,-21,-12,9
GSWPCIQBgVFTHJabfOMZYADRdeXKUcELN,RAAAeAAAKADC.EADAGAFA..SAFACAHABCCA.FBHDHDEBbCCA.hAAAMCIBACCA.dECAXDFDhABALFBD.PFHBhAAAQECA.TGAAaHDA.OEHDhAGADGGB.cGGC.IHEAhAIA,2,-20,1,21
fUTeXZJGBgYKRWAHaNEDMbOcIQdVSCPFL,HAAAEAAADADAMACA.OAEEQAFA.dBCACAHBLCCAhAAAUDEAeBHHZCFBGEBABCHAKECAhCAAABEBaEHDbEGD..IGEAhAAA.SGGD...hCDA......hCEA...,2,-20,-10,10
VXZfINdSYGMHJDFKeCAgRPQWBLbUcaETO,RAAAQAAALADBUAFAEACA..OAECZCFE...ICDAhAAAdCCCGEEBHCEBFFBAeAHHhAGAAAAA.gEGAhAHABAHAaGHB.TGCA.fGHASHEAhBFA......hCAA...,2,-23,7,30
KEPNcJGDQLgeUZbVIaOFYWdHSRBXTfCAM,EAAA..PAAAJACBGAEALAEA.eAHHZAGB..VEAAaBCDFCEAhAFAdEDAHFFAREDABDHAXGAChAAATFGAADEBMBIBhAEAKGAADIFA..........hAGA......hBAA...,1,-3,-18,15
aBAWLMRJYgNTbXFVdCHZIGOUDePcKfQES,MAAARAAA..JADA..NAEA...TBGAFAFAdBBAHCCAGCFADAGAeDFFhAAAKBHB..EDCFaDHDhABAABFBLFDB.hBIA.bFCBCFHAOFFHPGFC......hAIA......hBAA...,2,-24,-10,14
cZNQKSVWGHRUeMBgADPYXCOFILJdEfTab,DAAAXAAAFACDLAEAdADA..EAFAaAHDZBFE.QDBAhAAAKCDA.SDEAhABAGCFAHFAARDGFeFABMBBBAFFBCGGDhAFAODHD.fEEE...hAIA......hBDA...,2,-21,-9,12
RgUEacGHeTYSWLfOBbNICJADQZPdKXFVM,ZAAAdAAAFADARAEAUCAA..EAGAGCDAHCACeBHF..TCFAhABASCFBLCHBBDEAhACAbFAACECAADIB.DFFAQFFChACAXFGAMGAAaHAA..WHEA..hADA......hAEA...,1,-5,-19,14
eaODcfWEJZNdHURXgTFPbKGMIBSCAYVQL,QAAAeAAADAEA.....fACFEAGAZBAEHBDBRAEATCDAhAAAbBFAGDFAMAIBSCFHhAFAAAAALEHBaFBAhBFAOCHHJFEF.dFFA........hAHA......hCAA...,2,-16,3,19
PRMYLIdgTAOSNDfXaVCEbZUWecFKHQJGB,SAAADAAA..aABEEADAZADBUAGAeAFAKBEBHCEBGCCARCGBMCCBhAGALDAB.dDHAhAAAABIBOFGBXEFBbGCAhBAAFGBDBHHAIGHA.TGDA..hABA......hADA...,1,-7,-12,5
NAcVIBYJdUREbKTGWfPDgMOFZeCXaLHQS,VAAABAAAdACA.EAEAKADC.GAFA..fAGADAIBMCDBZDGBhAAAeAHH..aCEHHCDAhAAAQFBCACBBIEAAhAEA.UEFARFDFbGFATFCA.PHFAhBCA......hCAA...,1,-6,-17,11
CdODSPTQRcbZBVXIFLaJHWKENYeMgAfGU,GAAAdAAASADAQADARAFF.ZAFBBAHBXCGDLCCBHDCAhAAAECEBeDADAADA.CAHADFFAhACATDGA..bFBDFEEHhACAaFGEKFHB.MHCA.fGGE.hADA......hBAA...,1,2,-14,16
ZATIMVcbFdCaHfeQYJXUKGENWPRSDOBgL,MAAAVAAA.FADD..aADAHAFA.eBBBQAGAJCFF.KBDAECHBhAFA....PCFDhAAARDDBOEHBLDDBhAGAAAHA.TFGA.IDHA...hBAA......hBCA...,2,-24,-18,6
fBEMPWbICFeKcUYATLXdSRQGZOaJgNDHV,TAAAdAAARADAZABB..aACA..JAHBDAFAHCEBBAHA..EDCAMBDBhAAA....bEACFBEDhBGAKDHBcCFD.ACCBLEEAhCAAQFGCGGCBOGACgGGBhCGAfGDB...hCIA...,2,-19,-12,7
eQHcCBaRfbTPZIUNVEOKYSWGJMdLDgXFA,HAAABAAARACATAEAZAFB.UAGAEAHF..KCAASCAA.GDCAhAAAdCECLDHBhAAAXCECAACAeDDDQEAAhACAaFAA.bEGB.IFFAOFFB.YHDGhADA.....hAFA...,1,20,-29,49
IHRZWPUCBDfMOFNGgXJSQTbdYaKELVAce,eAAAHAAARADFZADBUAFADAGA...MAIBFBFAGCEA..XCAAhAAAQDBCdDDDaDFDhACAECHFAAAA..IEHAhADACBCAOEHDJHBA.TGGAbGDA.....hBIA......hCAA...,2,-20,-6,14
LDMgXCGcdWUbYNAIeSZVfBROPHEaQFJKT,eAAAZAAABADBRADAHAGBEAFA.QCCC.KCFDTBGALEABhAAAMCABCDHAdEEDUCCBbFGDAAIB.hABA.SCFDhACA.ODHD.aFADDFIBGGDB..hAFA......hCBA...,1,-1,-19,18
YBPLXZaOCGTfREAQUNIWFMdDbJKcSHeVg,QAAAUAAA..IADAMADAdAHADAFAKBDAHBDCeBFH.VDBAhAAABAHA.LCHBhBAAaDGDGGEBRDDBADGAFFGHbFBC.hBCASGBA..PHBCOHEC.hBDA......hBFA...,1,-1,-20,19
TbeNKGWXBIJOQEYcCfVFSADgRLZMPUadH,RAAAZAAAMADAaACA..HAEBeAFAGBGABBDA.OCCBEBHF..CCCDFCEDhAAAAAGALEDA.dGBAhABAbCFDKFHB..XFGAhABA...IHEA...hAIA......hBGA...,2,-23,-16,7
ZVFKgBPecWbNdaSRICTDEHOAXUfMQGJLY,XAAAMAAAGACBLADAZAGBKBBDBAHA.eCDA..bCEDaCGDhAAARDCF.CDCD.DBIBHEAAAAFAUEGAhBAAQEEC.hCAAYDHBFGCH.gGDG.cGGChABA.dHABIHHAhCDA.,1,9,-22,31
DEJQgNcGRXaTfPYZCSUBeAdMVKbILWOHF,dAAAMAAAKADALAEAHAFBEAHBQBBA..gCAAhACAGCEARCGBaECBTDCAfFAAhAFAZDGBSEFFhADAeFHFAAIBVGCAbFABOFDDDGGB.....hAGA......hBAA...,1,6,2,4
WTCePEFJKaNfYdcBUDOGRVSZbgLXIAMQH,HAAATAAAeACE.EAFEKACC..aAHDfAEAdCCABCFAODFEhAAARAFFZCCALAHBAEEB.hAHAMEEBQFCChCAACFFAFFHB.YFFADIEA.SHFA.hAAA......hCAA...,1,0,-22,22
NAEfCHMcVdaDeKRFTWQbLBXYUZOJIPgSG,EAAAHAAA.MACAdADAeAFARAEAFBHD...TCBAQCCALCFAhAAAXCEAZDEAOEHDhAFAIEHASFFBhAGAGFEBAAHACGCAaHCE.........hAAA......hCAA...,1,-4,-15,11
BgSEYdbIOGZeHXNacJWfQVAURCLFMPKTD,RAAALAAAMADA.TAEABAGA..EBDAdAGA.OBHDeAHHHCDChAAAaCAA.JDHBQDCAhABA.ADGBFEABDCCBSEEAhABAbEEDGEGANIABfGCA.CGGD.hCAA......hCGA...,2,-26,6,32
IRDgEUBcKGfeWPbdHCVXMJANZYQFaTLOS,ZAAAQAAAaACA.LADASAEHRAGFECDABAGAGDEA.eCHHhAAAbCCCHCFBCDCD.MAIBhABAAAEAFGDBOEEBDFIBgGGDhAIAKFGAfGAA.dHDD...hBCA......hCAA...,1,-3,-4,1
caZQHUgNECfYXTRVADMPSIBFKWJGbLdOe,MAAASAAAFADD.KADAGAFALAFBeAHBZBGBHBBBUCCAEDEBCDAA.hAAA..XDGDhAFAREDAAAHADCIB.BFBA.bFDCdFHAhABAaGHB...NIAB.fFCE..hADA......hCAA...,1,5,-26,31
fgIFSOQDcXRPTNHdMBZJGeACUaELWKbYV,aAAAEAAALADA.KAHBbACD..VCBAIAEA.OAFDhAHAQCFADAIBRCGF.TEAAhAAAHDEBdECAZEEAeFCFhAEAABBBCFHA.UGGBfGGESDHBPHBAhBAABHAA.....hBHA...,2,-12,5,17
KBJUCgeYNVAXQRcPLHMaTdWbZEGSODFIf,RAAALAAAHADBMAFAdAEAZAFBGBFADAIBFCAAKBHBBCCD..CCHD.eDABhAAA..VDCAAEEAQFFBhABA.aEHFhADAbEGBEHBAOEBB.IFFA.fHBFhABA..hACA...,1,1,-34,35
KPXJCBTeOAFHNEfdaLMWbQcGZVDIUSgYR,HAAAEAAAdADAaACALAFAMAFA...QCBCZBDEDBHBSCCDhAAARCFAXEDABDFAeEGFhAAAABIBfDHAhBFA.bEDDGGAB.IHHAgFFBhCAA......hDAA...,2,-17,-4,13
SefADOFHTEBWLKaYcdPgUCZXRbNVIGMQJ,FAAAHAAAEADALADB.aAFAdAGAUBGBZBCERDAB..VDEBGDDAhADAMCABQDGAhAIA.eFGBABFBTGGAhAAAKGBA.PDCB.CDHDNIAB......hACA......hAIA...,2,-12,-6,6
dEPQAbHgBGUIXCYSJMZLWRNfceaVTOKFD,HAAAGAAAXADBSADAZAFBRCAA..fAGAeAHF.aAHDhAAATEDAFCDA.EDHFAADAbDDAhACABFBA.CFGDMFIBhAAALDHBNICB.OFFBKGEA.dGAA....hAGA......hBAA...,1,5,-6,11
LAFXZgTaWQUMEdOBKRYNVbDfCcHJPIeGS,ZAAAaAAA.QAEAUADA.EAGAdAGA.KBBDRCAA....VCGBbCFA.hAIACCEDHEAC.IEEAhABAeDBAGEEALGFAhACAABFAFEHH..........hBAA......hBDA...,1,0,-27,27
eUSLHfgdKIDYBaCZPMTFcOWVXbGNRAEQJ,EAAAeAAALADAHADAdAGADAHBaBHDZBCA..MCCBFCGH..ODDBhAAAXDDAGEAAAAAAQEGAhAFASDHHKFCABEFDhAEATGEA..cGGA....hAFA......hAIA...,2,-22,-5,17
cJbNXQLaYBEKIMdRDZFfVOSeHGAgWCPTU,CAAATAAAUACA...JACA..XAEALAFBBAHAEAHBMCCAhAAARCDAZCGB.FCHH..OCBBhAAAHDDAAFFA..PFABhAFAbFGD..NIAB.aEFB.KFHBDFIB..SGGDhAHA...hAIA...,2,-23,-13,10
efWYZbXGODLQRKMHNPBaATSCcdVUgJFEI,TAAACAAAdACA..UAEAFACA..EAFAeAHB....fAHAhAAAZCBAGCGALCCAhAFAREBAHFDCBGBDACGBSCHHhCAA.gECAIHHA.bFEADIAAMFIBhCDA.aHDA...hAAA...,1,4,-23,27
WCFAdeQBgSLfGcRHDXNTMPVKJUYEbZOIa,eAAAQAAABADALAFAGACBHAGBDCCA.TCEAMCFAKDDAUDAAhAAA.EDDBZDFBODHDhADAaDHD.FFFBAAAA.dGAASFDBhAGAfGHE........hAFA......hAGA...,2,-34,9,43
UeZgWAbDBPCIQaNEHOcVTSGJKLMXYFdfR,BAAACAAA.aACAHACA.OAEA.TBGAGAEA.LAGBhAAAMCABFCCHRBCBeCBBZDFAAAIBDEEBhAAAQEEB.hACAEDHFSFCBXGBAdGGAfFFAhCBA.WHFA...hAIA...,1,-13,-15,2
APDEORbTNgVKHeGaWUJQFcSMCLYdfZXBI,EAAARAAA..TAEA..gACAHAGBeCCBaAEDUDGB.QDAChAAASAGAMEEBhABALCGBdFFDZGAABDAAhAAAAAIBDGIBbDDB.KFFD.GGAB.FGHB.hADACDFA......hAEA...,2,-1,3,4
dcMgVEGBZSKLAaDNQeTWfJPYXRObUFHCI,aAAAQAAA.eACATADA.JAFAXAFA.RCDAOBHDhAAAbCCAHCGBdDAAMBBBhADAEDCBZEFALFFAAEGADGAAfGCAhADAPGCC.FGGBCHHA.....hAIA......hBAA...,2,-16,6,22
GEOfPcgIUDJMaYRKSVXLZWABHTFCdNeQb,HAAATAAAdADA.eAFAGACAEBHF.OAEA..fCAEhAAA.PCCBgBEBhAAADCGBaDFHRCGFSCADhACALEHBAAFACEDAbEDDIHFAMEIBKAHB.ZFFFhDBABFGA....hACA...,2,-8,7,15
bLYfJSgVTWadRZXMPECUNIGAFHOcKBeDQ,HAAAKAAAeACEQADCLAFBJAFA.SCAATBCA.dCFARCGFZEDAhAAAMCHBEAHB.CFCD.IDDAhAAAAEEA.OEHDhACADEIBfGHEgFDA.aGFD...hAIA......hCAA...,1,1,-21,22
GVPIDbKAUJOXaEeNWfdCYgMcHQFTRLBSZ,OAAAEAAA..eACA..fADAdAGACBEAMAIBHAEB.TAGAhAGARCCBLDABZDDAGEGAhAIAIDGAbGDCABBBXEFChAAAaCGENCCA.gGBA.QGGAhADA...hBAA...,1,-2,-7,5
cHLGfASQMbFNZCgXJDPRaYUWKeOdTVIEB,MAAAFAAAZACB..XACADAFARBEA..UDEBeAFA.dCCA.TCFAhAFAECHFHEBBGEDAAAIB.hBAAbFFBCEHA...gGAAhAGAaFFC.KDHBOHBEBHCA...fGHAhBEASBBD.hBFA...,1,5,-31,36
QLeUVYPKgJWfZTCHBbAdRSMXDNGcOEaFI,RAAAMAAADADAGAEB..EADAFCCALAGBUCFB.PBBBKEED.hAAAJCEBZFGBHECBAAHA.dEHAhAIA.XFFB.hABAOFBHaGED.IHHA....hBAA......hBCA...,2,-36,-11,25
REVDPabTHSfXNQFAcMGOBLgCKIeUWZYdJ,GAAALAAAKADAeADHZAFBdBHAEAFA..DAIBaCDBHBGB..XEDAhAAAQCAA.ACFAMDEBhABABEGACFAAIFAAhACAUGEBJFCFRFEF..........hACA......hADA...,2,-25,-4,21
eDGdRSZEcAJfBOHaWTICXQFgMYKUbVLPN,BAAAHAAAaACA..TACAXAEDFAEA.MAHBKAHB..UCAAbCCCLEEAhAAA.eEHHhAGAdCFARCDFEGBAACHBODHDhAAACDFA.QFFC...YHAAhACANIABSGGD.hAHA...,2,-31,7,38
cFXVKQOgHPLaMeCIDfGAZYWEdTbBJSNRU,ZAAAEAAAdADABADB..SAFARAEFFAGA.KBHBQCAAHCBAaCFB.hAAAeCFHDDGB.GDGAhABAAAFA..TFGAJDDB.hACANEEA............hCAA......hCHA...,2,-26,-21,5
XfMgHICWUJDVacSRYGKBEbNALdOeQTZPF,dAAAeAAAZABBFADDMAEAHAFA..CAHA.UCFBDBEA.aCCC..RCEAGDCAhBAAEEEBAAAA.LCHBhBDA.QFFChCDATFAAfEGE.gGGAIHHA.hCEAWHAA....hAFA...,1,-13,-26,13
ISGRLFQZUNdbcKVaWDXfMCegJTHPABYOE,OAAAEAAAGACARADALAGBZAEAdCFA..KCBDaBBCDAFA...MAIBhAAAeCDA.TEAAHDGBAEEBhBCABDHASFDAhCAAQEEAUGGBbGFA........hAEA......hAIA...,2,-17,-5,12
OWFSCNTdBXMJbcQUDZGVRYEeHgaLIPfKA,FAAACAAAdACAMADA..JAEAQAGA.ZBCBRBDFEBHFHBEBLDFAhAAAIDHA.KEEDAAHAOCBBhBCASFGABFFAhCAAbGCADFHB...GGCB....hCGA......hDAA...,1,-11,-28,17
gbZQUHYfBcRLCFIWMETdAOaGDJeXPNVSK,GAAAeAAA..XADAPADA..SAGAKAGAZCCAHCGBBCDAhAAAREAALFFAFCFA.hACAMEEBEDCBACIBaGACDEEANIAB.hAAAbEFA.QFDD.fGGAhAHACGCBIHHA....hABA...,1,-6,-8,2
YBTRGNdfUbVEAXWKZDeFgOaHISPcCMLQJ,KAAAeAAAOACAHADASAFE.CBHALCCAQAFABCGDhAAARBCBdBHAUEEAECEEAEEAZGFEhABAFEFDaDHD..IEHAhAAAMIAA..........hAIA......hCAA...,2,-35,-6,29
QDYRaGWgCeObLIZXPKEJVHSAFMfBNdUTc,MAAABAAAdACAUAEAQAEA.RAGB.GBBA.CAGAeAHHhBAAbCBA.ZDEAKDFAEFDAHEAAhAAAABBBFFGH..TFDAhAEADDIBaEBHODHD.LFFBXGDA..hBDA......hBEA...,2,-18,-3,15
CeDFYUWJHZVIKfXQMAEgdabOGScNTLRPB,EAAAaAAAGACA..SACA.TAFARAEACAHBeBBDFBHDUCCAhAAAHCFAZEAAKCFDQDAAhADAACHAbEDD.OEFChAFALFFADGGAYHAAJHFE.fHEBhAHA...hAEA...,2,-7,-4,3
PbIDJEMVLAUNGSTFHYQKgCdXWcRZeaOfB,GAAATAAA.HADAQACCCAGBdCDD..XBGARAEFeAGHaBHDBDFAhAAA...IEHAhACAEDDBMEABADABSEEDhADAKEGAgFFGZFAAfFFBDGEB.JHDEhAFA......hAIA...,2,-8,-6,2
FLDSINMcVTYCXAbOHKgUGWRZdJEQaBfPe,HAAAKAAAGACARADFdAFAEAHBQAEA.BAGAeCABLCABhAAASCCDMAIBTCGAhAAAXCFAADFBOEEBUEEAZGFEhACAaFGAFGGB.DIAA.......hAEA......hDAA...,1,3,-12,15
cZdUHGTKfJVEbWDXMAaLgBQFYRPSeONIC,aAAALAAABADA.QAEARAEF.eAHBOAGDCCAA.dCCAHCCAhABAGDAATDFAKDFAJEDBhADAEEAADEEB.ACHBFEHDSEHHhAGAIGBAZFFBfFFE..hACA......hAEA...,2,-21,-10,11
QXeYCJdUEOFDMZVNSRPBIAGKacLfWbHgT,aAAALAAA...bADDHACB.TAEAeAFACBHAdAGA.ECHFDCAAhABAZDEBSCFBhACAREAABEDBAAIBGGEBfDCEhAFA.QEEC.XGAA.hAEAUGGAMBBBPHDAhAGA...,1,-4,-11,7
SPOGLHZWICBdMcUXTAgQefKEYVRaFJDNb,eAAAEAAARACA.FADD.DAFASAFB.GBGAHBEBZBGB.CCCDdFFAhAAAMCCBUGBAAAHAQDDAhAAAKEHB.aDABNEEA.hABAbFCD.LGEABHGA......hADA......hBIA...,2,-23,-10,13
VOLWPRAaQCdbZUIfGeHgMTcFBNXKYSJDE,aAAAdAAAZABB.UAEAGACAHAGDMAEA.FAHDXDBAKBEC..hAIASBBDEDGBLEEBhBAARCEAADIBQEEBhBAACFDA.bEGDfGGA....hBDA......hBEA...,1,-10,-19,9
PdOWSQYZCFaDAXbMfLIBcENJVGKRgUeHT,MAAALAAABADAEAEA..JAFAGAGA.RCAAeCEBHBBAdCFASDGDhABAZCGBaDDBADIBbEAA.hAIA...IFBAhBAAcFGDKGBATFDAOEEHQGGA.hACA......hAEA...,2,-15,-6,9
dGefVBFIQTKHcYWCOgZUAPMELbDaXSRJN,EAAALAAADADA.aADDRAEA..dAHAeAFABBCAQCAAHCDA..hABA...cBGDhACACCBDZDFEAFGAbDDBSFGAhAAAGGABFFAGTGCAKFFAOFHD.PHEChAFA......hAGA...,2,-25,8,33
JacOSECGUebXLRDQfWNYBHZAgIKTdFPMV,KAAAdAAAMADA..aACASAFAEAFA.GBDAeAHFbBCDRCBBQCGAhACA.fEGEhAIAYCFBHEGBhAAAAFFBTFCAFFAAPFDBcGGC.....hBAA......hBCA...,1,-12,-14,2
YbERWHKFZPNGfDUadCeMcIJXQBOSALTVg,TAAAVAAA......bADBRACFHAEBZAFBGCGADAGAdBGAeCDDhAAAMBIB.JCAFQFBAhAIASDEDABFBLFFBhBHAEEGBFGGH..........hBIA......hCAA...,2,-16,-5,11
JIOGBCPdeWDMbEYXQZFTfcgRLVKAHUNaS,HAAAaAAA.SACEOACDGAEACAFA.eAGBMAHB.ECCAQDGBhAEAZCEBTEGAfEBAhAHARFAAKGDAAAIB.UFGBhAIAIHHAdEDADBBB........hBAA......hBEA...,1,-8,-9,1
YfKcgZPEFReWDUCSQAHMVXGLIJaOBdTbN,HAAAMAAAGACBLADB.aAFAdAGA.TCCAbBED...fCFEhAFAKBGDZDGBECABRDGFeEEBhAIADAIBSCCDhAAAABBB.XGFCIHHA......hBAA......hBIA...,1,-2,-18,16
FMCSOLXeHQUDNZEAKbdWTcfGVgRIYJPBa,dAAATAAAGADA.RAFA.JACABCBA.MCHBOAFA.eBFFHDEBhACAQCCADCIBEDABAAFAKFHBhADAbCGD....fFFEhAAAgGDBIGDAaGGH.SHGAhBIA...hAIA...,2,-16,-13,3
UOEYKRFfcDPJWXgLNdaQGBVAeHSZMbTCI,HAAAZAAAMACATAEAUAGAEAGE..RBDF.FCAHDCCBJCCA...XCFDhAAALDFA.aFBAGEABhACAAFFA.eCHBCFGAOFHDhABAfFFA.PHFCgGBBhBFANIAB......hBGA...,1,14,-30,44
JeZNDcVObRYWAQFEgLKafGdCXIPTMHSBU,EAAALAAAKACA.GADAdAEA.CAFA...XAGATBGAHCAAhABABCCAeCEAZDEBDDIBODFEhAAARFAAAAHAQGFAhACAFEEHaFHB....fGAAMIBA.SGFHhAGA...hAFA...,2,-24,-4,20
NEbdcFZeDRJCVGLSKTaIBUAMgOHYWPXQf,MAAAHAAA....PADAQADA.EAFAdAHAZBBFRBFBCCADGBGAhAIALCCBTEDAaCEHBDHAhAAAABIBOEHD.XGCChBAAbFDAeFHBDDDASHBAKGFA..hACA......hBHA...,1,0,-11,11
cMFSBeYTfRdAOXUWZNQPGIEKDHCLgaVbJ,XAAAZAAAQAEAGADAEAGAHAFA.LCHBaBHD.bDAAMCABhABABDGAeCCB.TEEAhACARFAAAAAAOEFBUEGAPHCAhADADDAACGDA.gEAHcGGASHAAhADA....hAFA...,2,-1,7,8
aPgMUfZDBIXJKLVERYCWbAcGSHdTOFeNQ,GAAAHAAAdADAFADAeAFAQAGA..aBGEMCDAZCAABCEAhAAAXDBDLDGB.hAAAREEFCFAAADDATDEAOGAENDIAhACAgDGB.DFGB.KGAA.EHGA.hAFA......hAGA...,1,-5,-8,3
AUTLJPNDacSZMfeKVHQOCbREGWgYdXBIF,TAAALAAA.JAEADACA...aADEZBEAeAFHHCAA.QDEAhABAbAGD.EDHFGCCAhAAAgFGAdEFABEHAhAIAAAHA.PHEASEDDMIBA.KGEB...hBIA......hCAA...,2,-12,-6,6
gDReYdIOVBcEPHFJLbWAGSQCXNfKMaTUZ,GAAAQAAACADA...XACAKAFAaAHDZCDARAFAeCDB.dCFDODAHhAAABDAAEDHFHDGBLFAAhAAAACEASEEBhACAMEGB.TGCADFFBIHHA..cFADhADA.FGGH...hADA...,1,-6,-13,7
fNTIGKFPCdSYgMOAUXQbDZBJEaeLHVcWR,QAAAZAAAEADELAFBHACA..VAGBRCAA..TDGAGCDAFAHBhABAdDFA.SDHHhAAAMCEBACAAXFCCbEABBFCAhAEAeFEHfGGAKGGA.CHEA.....hAFA......hAGA...,1,2,-4,6
FKOXNDbRSMecgQWVGHJPAYCULfIdBEZaT,CAAALAAAdACAZADB.aADD..KAFAOAFA.DBFBRCEFeAHH..hAAAQBGBGEFAHGCAhAHAACAAfCCEhABAECBB.TDFANEIA.bEDD.MDIB.gFFGhACA.WHFAhDAA...,1,-14,-27,13
SFEVYGbRIJBdQcKZOPNaCLXUATDfgWeMH,TAAADAAA....fACAeACEHAFBEAEAGCCA.REFABAHAhAAAdAHAQBFAhAEAZFABOFDDaBBHCCHA.LDDBhBAAACCB.MDFBFGHB.bGEA.IECAhCAA.KDHB....hCDA...,1,-1,-18,17
ABbTDPHJQYUgZVaFLCfOecWKNXESIMRdG,TAAAHAAAQADC.UAFAZACBaAEDLBHBOAGBeCABhAAAKBHBECABMCCBGDEAhAAAADDAbDED.DDHB.JEBBgGDGhACACEDC.fGHAcGGA..NIAB.hACA......hAHA...,2,-15,8,23
LdMCFegfQSUYIJEGBaZWOAKVPTbNHcRDX,KAAATAAAHACB.RAEALAHBdACAMAEAeAHFQCAC.SCEAhAAAIBEAECFFaEAEZEEAhACAACIB..VEDBbFAADEGAhAEAFFHBfGBA..UGGB.hAAAYHCGBDDCOHEChBGA..,1,2,-2,4
cFPDYHKLUIZbCGMaEAfBTQJOeNVRgSWdX,TAAAQAAA.eACARACF..SAEBdAGAFBEDDAIBHAGBLDAAhAAAZDEAGECAEDFAADIBBEEDhADAOCAB.gFFBhAAAXEGDPGBAKGAA...bGFCMEIBhACA.....hBGA...,1,8,-15,23
bLKBTZPVGdUOgcEIDfJHWCeXSQYRFNaMA,LAAATAAA.ZADBGACAdAGAOBFHEAEADAHBHCAB..eBFFhAAAQDGARDFFaBHDACABBEAAhACAPEEB.UGBAgFGHhAEAfGFACEDA.SHGANIAB.hAIA......hDBA...,1,0,-8,8
bPFEgKecAMXUNadHDCVZJIYBORGTQSLWf,MAAAXAAAUAEAdADAHAGD..CAFAZAGBJBBBBDCARCEB..GDBAhAAAQDFCLEHBhABA.fDDEhAFAbEBAEEHFKGGDABIBaFGBDIAA.........hAIA......hBAA...,2,-22,-9,13
IcRDaOEeJdTCMAYBUGVNWSPXHfKQZLFbg,BAAAGAAA..VACASADAHAFBQCAAZAFBLBHBFAHF.hAAAbCDB...gEAAhAAARDDAaDGDEFAAeEHHhACAdFFAMDDBADDA..YFFFWFGHfHCBhACA.....hAFA...,2,-11,2,13
LMFGRDWTXfNCJUVKHgeObSYQIaEAZdcPB,dAAABAAAMADARACADAFA....TAGA..fAHAhAAACBDAUCGBHCACeBFFSBEHhACAQCAAEEEBAACAZDDFhCAALFHBGDFANIABKGFAbECDaFHD....hCEA......hCIA...,1,-4,-17,13
KWaCMQAIGNPHeSJOBZRXbYgVTfcdUDFEL,GAAAHAAAeACEOADARAFF..XCCA..bAGDVDGBTCDAhAAAdAHAFFAAEDCBLEFAhACAaDEDMIDA.AAIBIGBAhBAASGGAZGEA........hBCA......hBDA...,2,-10,1,11
fdORTebKSZCPEFUcIVWYGgLDJHANaQXBM,aAAAQAAABADA.dADARAEF.eAFAKAGCZCCFEBHF..FCEDUCGA..hADAIDBA.VEFAhAAAGEEALFAAhAFADBBBAGDBMIBATGDACGHA........hAGA......hBCA...,2,-33,-8,25
LIgMFcbKOPYdDHBAUVEGZCWaXSNRJTQef,EAAAZAAAaACA..SACARAEF.TAFAeAGHLDDBhABA.MAIBbCCAOAHDhAAAdEHAHFEBACCAGDAAhADAXGAAQDGCIHHA.FECA.KFFDDCCBBGHAhAFACHDD.WHAA..hAHA...,2,-7,0,7
DbJfYNELWMOZGKBFATgXcUeQVaISdPRCH,TAAAXAAA.UADAeACE...aAFAdAGARBEAHCCBDAIB.JCHBfDBAhAAA.EDDAhABAMDBBGDFAFEFBAAIBQFBAhBDASFHHCEHBYFEFLGDA..hBFA......hBGA...,1,-3,-17,14
AbGVfeZINMRQSYBLFKcUPXEgCJaDdOHTW,GAAAeAAAZADBMADARAFA.QAGABBCALCFAKBFDUDCA.EDGAhAAACEEAaEGA..dEEAHFGBhAAAAEIBVGFA.fGDEhACASGAA.FHCE......hABA......hAGA...,1,-2,-22,20
IgPAHYOTScNXeUDZJaLdEGKWRCFBMbVfQ,HAAATAAASACE..XACBeAEHZAFBaAEDEAHFGAGAhAAARCCBBCHAbCCCQEFAhAAAgDEAAEIBOFEBhCAAcEBC.DGIBdFGACHFA.MDIB.fGAAhAGA.....hCCA...,2,-4,11,15
SeWEbCRMXUZFVBfgLPQIKOcHJDTGAdYNa,dAAAaAAA.eADA.EAGARACFMAEA.ZAFEBBHALCEAQCBAhACAOBBHHCFA.TEAAhADAACIBSEEACDDBFEFHfEHAhAEAgEGHKFCADGCANHEB.bGCA...hBAA......hBCA...,1,-5,-13,8
FYAEMHLCaJGbSRWfNVDXcTgUKBeZQOPdI,HAAAaAAAGACARADF..fAFBDAEA..TAGAKBHBeCABhAAAZBEFQCGBhAIAdCFAFCCHEDHBMEEBLFFAbFFB.hACASBBD.NEEA......hADA......hAHA...,1,-6,-10,4
VXPTFRAIESGcZgQedKbLfDMaNBUHYWOCJ,EAAAGAAAZACB.eADAdAFALAHBMAHBBBFAHDEAOCDBCBEC.JDGFXEGAhAAA.TGDAhBCAAAABSDAD.hBHAQFDAfGGAaGGC.NAIA..WECDhACA......hADA...,1,-8,-22,14
VHPEbFOcgJIMZCSRNWGDeUaXfBYdKQTLA,HAAAEAAAFACDOACA.JAFBZADB.RAFAGCEAeAHBUCCA..aCGEhAAABCGAdEHAKGAALEFAhAAAAGGB.bGEA..IHHAhAGAMIAA.SHCADGEA...hAIA......hCAA...,1,-14,-19,5
LfNPAbFBOUcYgVJeTQMWKRZGaISDEdXCH,BAAAOAAAUACA....gADAeAEAMAIBRAFFGCGAhAEA.aAHFDBHBdDDAHCDChAAALFFBfCBEhAFAABBB.bEEAYFHB..TGCA.hBAAQGEC.hCAA...,2,-16,-14,2
KAWLZNSFeHJEgIdRXYVaCOGTcQPbBfMUD,ZAAAFAAAHACBEADE.dAEBRAFF...XAGDaAHDGCAAQCEDhAIABCCDMDEBKDHBAEFBLDFAhABAeFBAJFGB..gFFAhACAIHDA.CECAOFAH....hAFA......hAHA...,1,-10,-12,2
IfdBDJNUHRWgCeVTMKEbaLXcPYQOSFZGA,dAAADAAAUADAHADARAGF.CCBA.eAFA..MCFBEBBALCGB.hACA.XDAC.hAGAPDDBQDDAhBAAFDHDAEGBBFAAWDHHTGDAaGAEOGDCSGGDhBBAIHHA...NIAB.hADA...,1,-20,-22,2
GFeRbBDHdNZcUMOKPJaEWVAXCQSLTgIYf,QAAATAAA...IADAGACARAEADAFAHCECZAFEMCDBhAAAKBHBaCAC.EEAAACEBSCFAhBCALEEAfFHAhAAAeCHHdEEAUGGAOFAEWGCGCHAA....hCAA......hCGA...,2,-17,10,27
OJeTIcDFLQAGPSUXKZEHYagbBCNVfRWMd,GAAASAAAKADAHAFB..aACDbCDDCAEA....VAGBRDGBdFAAhAAAeCDFTGFADCFBLEABhAAAAAIB.XDGAhABAEDCFBHBA..fEEE.MFHBhAEA.OGDC.hACA...,2,-13,-10,3
OLUFGfRcXVJPDNSbBAKCdQWaEMHeITZgY,dAAAaAAAHACBeADAZABBOAEALAHB.GCEARBEFXBGD.hAEAVEBADBGBbDCD.ABHBQGFAhBAAEEGAMBBBTGEAhAIA.UGGAfEHE...hBAA......hBEA...,2,-5,1,6
GZAWSEBVJHRCNTcgbOPFdfeXLIYDKaMQU,EAAABAAAHACARACA.CAFB...TAGA..bAGDFCAAeCCALCEBhAAADAIBaDEDMCGB.GEGAhACAAEAASEAAhAAAVFAAJHDAgEGA.dGCAXDAChADAKGEA......hAFA...,1,-1,-11,10
JXTPgeBNRQLZaGEdDSFVCOcfIKUWAHYbM,HAAAMAAA.TAEAeACARAFAZAGBGCCAdCADFCEHOBBB..fDCAhAAAKCFDACHA.bEADXEFAhAGABDHA.LHDAhAIAEEFFSFHBCGEAIHHAUGCA...hBAA......hCAA...,1,7,-15,22
OdVNRFcAEZMSbYWPXDGeIfQaCLKgBJTHU,EAAAZAAAMACA..bACA....PAFCGAGA.eCCBQCCBhABAaCECLDABhAAABCFAHCGBdEEARGAAAAIBSEBBhAIAXGEADDIBCEEAKFGD......hBEA......hCAA...,1,4,-27,31
KQLENYbHFgJMZVXGWADIcUfaOeRPTBdSC,DAAAUAAAOABERADABAGB..dAEAKBHBLAGB.ECCB..bCDAhADAHEDA.FDHDMDCBhAEAZGBAXGGAADHB.hAIA.fEEA.eEHF.SFCHhBAA.CGFA..hAIA...,1,-24,-30,6
HDfSVJEgCROQKTZLMYdeUWNXcbGBaPFIA,HAAASAAAEADERAFFKBHBZACBLAFA.dCEAeCAAUCGAXDDAhAAAGEBABEDDaDGDFECHhACAAAAADFFAJFAB..OEHDhAFAMFIB...YGEAcGDB..IGGAhAGA....hAHA...,1,2,-24,26
PMbAcBfeHLNTaSVKCEFgZXDUGOIRWYJdQ,BAAAHAAATAEAaACA.KAGCEAFAZCAA.DBIBGBCA.RBFAJDGBdCEDMCHBhAAA.ACCAeEABhACALCBDSEEAhADAFEEBXFACOEHDIGHA....hAAA......hAFA...,2,-26,-5,21
LKWVRTDYMgICUfdcQeNZbXPOGSEFaJBAH,HAAALAAAKADCRAFATAEADCAB...MAHBCCCAdCEA..eCAAZCGB.hAAAbCFDOEDB.EFFBhACAaCEH.AAIBVEAA.hAGAgFGAfFHAQFDDXGDD.hAIASCHH.hCCABGAD.,2,-13,-9,4
DVRafeSOWgBYJdIXbLKTQAUcHPEMCFGZN,HAAAEAAAFACDZADB.DAGARAEA.eBFA..OAHDBCADdCCC.XCGAhAAAbCDALEAA.hACATEEAABFAUEEAMDHBhAAACEHD.....NEIAaGGHSFDD.hAEAgGFAIHAA.hAFA...,1,-17,-19,2
JQYIOEcaFXNDfSCWTHPMKbVdRBUeZgLGA,QAAAOAAA.EACAaADD.FAFADAFA.CAHAHBDAMAIB..KBBDdCHAhAAARBEFBCGAeDDAZFBAGDBAhBAAAFFAIFHA.hBDAXGEDSEEA.TFGA.PHEChCAA....hDAA...,1,-7,-23,16
dfPBHSEQFNgKeDUGZIVOYacRAbLXJWMTC,LAAAXAAA.MAEAdADABAFAHBCCEAHFQBGAFCAB.KCEAeBFHhABAGDBAZDGBODDBhACAaDDCAAAA.JFBB.TGEAhBFAfEFA.SEGHDEIBIHHAhCIAYFAF...hDCA...,1,1,-19,20
RVUKQcHLCdAZDGFMEXObPSNYaJfTgIeBW,GAAAEAAA.OADASACA.aAEDTAGA.eCDARAGBKCCAhAAAHDBBdDAAAAIBZDEEMCGBhADAbFFA....PHFChAAAYDEBfGDABDHAUGAA.LFHBhAGADCIB.FGGB..hCAA...,1,10,-9,19
DBeJWKOLMNbcQGSYZIRTUaEgXCHdPFVAf,BAAAeAAAKADAMACA......bAFBGAEBZBGB.RBCBaCBHECCACCEAhAAAHCFC.dEEAFEEBAAHADEIBhAAAODHDLFCBhBCAQGFASFHD......hCAA......hCEA...,1,-16,-22,6
VNFMDBacdPgRCZHObTfIYXWQeSKULGAEJ,EAAAVAAAFACD..MADABAEA.dAGARAFAHBDB..TCDA.hAAA.fCGAhAIAXCGAeEAAKDCDGEGAhCAAAAIBDEFAaFCDgFCAZFFAOHFCbFED....hAAA......hAEA...,2,-21,4,25
gJNEFQMVUYcOdaKGLHAbfZWCSeBIXTDRP,ZAAASAAAeACEBAFB..TADARAGF.JAFAECCB.MCEBUCDBhAAAOCFBaCGAGDAAhABAHEGBACIB..bDFDCGEADIAAhABAPHDA..NIEB........hADA......hAIA...,2,-16,-14,2
ALeOMWRBJFKUSGNXdIabCDQEHcZgfVPTY,eAAAMAAARACAFADD.KAFAGAFA.dBHAaAHDDBBBHCDCZCCA...VDGBhAAATECALFAAhABABEGAUGGAXGCACFAA.hAFAEEEB...fGGEAAHAOFFH.SCCDhAFA.IHAAhAHA.,2,-15,-14,1
KgSOcRYPHXFfCaAMdVGLBQeTZDINEJWbU,dAAAGAAALADAeADAZAGBDAHB.EBFF..JCBBUDCAKCFA.OCHDhAAARDCF.HEEBFDHD.aDAHAAEABEFAhACA..IGHAhACA.NIBB.bFEC...SGHHhAIA.....hADA...,2,-35,-4,31
ceOFdIaUWVGTSDENbMLQZKAJPXfCHYgBR,XAAAHAAABADBRADA.eAEH.dAGAaAGAUCABGBGADAIB..EDDBbCEDhAAA.LDAAZDFAADGA.hAAAfFHACFFA.hACAgGCAFFHHIGBA.....hABA......hADA...,1,-12,-17,5
CEMHAZbDGcfFYSXJNdOUgKeIaLWVPTQBR,ZAAAGAAAFADA.SADA..XAFDdAGAOBHDKAHBeCABhABAaCDALDDA.hACAPEABTCDAREFAEGBAhAAAHDFAAADADGHBfFFENIAB.IFHAhAHA.WCCD.BHDAhCBA.CHHA..,2,-27,4,31
EObcdHNMSPQKVYaAJUFZCfeILDBRgXWTG,FAAAZAAAeACELADARAFF...XAGDGCDAEBHFOCCAdEHAHFAAhABAMDDB.QFFAhAFAKDHBaEAA.AAHACCCDDEEA.BFAAhAEA.TFFANIDB.SFDH.hCAAYHFG..hAFA...,2,-28,7,35
SZNPebUAEdMJIFcgQaYCXHOGfDTRWBKVL,EAAAdAAAMADAFACD..QAEAaAFE.CAGA.HBDAGCDATCBAhACARCFAKEAALCHB.hAAAZDEBeEHBAAIBIGGAhBAAgFFBOHDCDAIB.BDGANIEB....hBCA......hBDA...,1,-7,-9,2
fDEgaFGcXMIObRVdeCQZWPHKASTNLUYJB,TAAALAAA.UAEABACBEAGAFAEA.GAGAMBIB...bBDDRCAAeCGFhABA.ZDCEHDFBhAAAACAASEGHJFCADCCBaEHDhAIAIHHA.OFFHCHHA....hACA......hBEA...,1,-12,-15,3
TKYEMceJRPaIQUNLCBVDAWGZOFgbXHdSf,ZAAAFAAA...XADBHACBdAEB.TBGAEAFAeAHFRCEB..aDHDQCAAhABALFBABAHBhBAAACFAGDDAOFGBbFGBKHEAhACA..cGDD.IHHACDGDDCIB.hCAA......hDCA...,2,-8,-5,3
QLEbBPTNGdMgVaORFKceHXYDZJACWUfIS,CAAAUAAA..SACAEADABAFA...TAFAdAHAMCDA..hADAaAHDRDDAKDGCHCAADEIBAACAfCEAhAAALFFB.hBAAbDFA.GECAOFHHeFAB.ZFFAIHBAhBCAPHFC....hBHA...,1,11,-31,42
KAQNMdFeXPIDTEcYZJBVbWLfUGHROCagS,MAAAeAAA...XACADAEAEAGAZBAE.BBEAVAFALCGBhAAAGCCAHEFARDDA.aBBHKEBAhABAACFBdFAAFFFH..IGDAhBEATGDA..........hBIA......hCIA...,1,-7,-25,18
QcPFfIMXHSVJBKTRZgdEaYNAUDGbOeWLC,GAAAeAAALAEAQADAFBCD.MAGBHCEASAHBBBHARECAdEGAhAAAECDBaFABAAABDBHB.bDEDhACACGCD....fGFEhABAXDGAKFBA.ZGFENDIA.ODAH.hAFA......hAGA...,1,11,-14,25
WGXUAYeZLIJPfgRdNaCDMFbEScQOHBTVK,eAAAZAAALADB.JAFAfADA.RAEFaAGAMBFBEBGFQCAAhABAHDDABCCDTCGAhACAKCHBGEGAAEEBIFFAhAIAdFFC...DEIB.bGCC...OHFChCAA....hCGA...,1,-2,-19,17
SBMcVaYTfJIURbOQKWgCAHZGEdXDFPNeL,HAAAEAAAdADAFADA.eAFHLAFABAHAMCABaBCB....TCEAhAAAfCCAUCGARFFAQCGAhAAAKDDD.CDEDAEGBhACAGGABDFFBSECH.cGGAhAHA......hCCA...,2,-20,-12,8
MbBLXVWdZDPeRYIOGATEgNQFHUfJacCKS,EAAAQAAAHACAUAFAaACE.KAHB..MAFALDDA.XDGDhAAAdBFAZBGBeCDB.hAEARDAAODHDACCBTFDAFFCBhAAAfGGACFEABGFADICA.IHHANECA.hCAA......hCBA...,2,-16,-3,13
RYNOFXQGWefCMcUPLgaEBdKVHTJbSIZAD,RAAAOAAAQADCGADA.eAFAMAFAUCGALBGB.ECCBdDBAhAFAHCEDbDEDZGAAAAAADBIBFFHBhAGAXEGACBBD.gGCAhCAAaDDH.KGGA......hCGA......hDAA...,2,-6,-3,3
bYGEAJPFRMaTOSULWVXKZfHCdcDINgQeB,FAAARAAAMADAOACD.LAEA..XAFAZBFEHCDBdCCADDGAhAFAICFAQEGAhAGAeBHHBFFDGECBAGEB.hAIAaEBH.TFGA.SGEH.hBAA......hCAA...,2,-23,-11,12
JCSTFHdaGZYOEVKgIALcPWBfeUXQbNRDM,LAAA..PAAAfAEAeADAQAGARAFFDAIB.hABAMCCASCAAhACAHCECGEAAZDCBECHBKDDDAEAABEEAhAEAbEFACFEDdGGAaEGBOFGDIHEAWHAA.hAEA......hBAA...,2,-8,-2,6
YMZAeCQEBNbIRKDgVGOJXSUdHacFfTWLP,eAAAEAAABACA..bADARADFDAFA..GBGAOAHDSAHBhAAA.HCCAaBFDfCCEhAAATEAALEEBhABAMDHBAEEAQGGA.KFCAgFCAhBHA.XFFDhCAA..,1,0,-27,27
dFBJfACKHaUSNYQXcgOLPVGMEbZRWDeIT,HAAAaAAA.SACEQADA..XAEDOAFCLCCBhADAGBGAECCBRCEAeBBDdAGBBDFDhAAAAAHAKDHBUFGBNEEA.YEDBhCAAgFFAMFFB......hCDA......hCIA...,1,-3,-5,2
YNUCIBVDbTOWdcSJEMRZPgAGXfHaFLKQe,GAAAHAAAaACALADAeAEH.UCDABAGADAHBTCFAdCGD.SAHHhAAAEEABREFAZFDFAAABFCCB.hACAQEECCGHA.hAEAbGAA.OEHB.......hAFA......hAIA...,2,-19,4,23
aOgIbNeCWPMSfQGFdJZYLXKTVUDBHcERA,aAAAOAAA....bACDeADA.CAGAMAIBQAEAGCCAdAHAhAEAZCFBLDFAKBBDTEAAhAEADBBBHECA.RFGBABGAhBAAgEGHIHDA.PFEBFGFH...hCAA......hCCA...,1,-3,-9,6
UgKbEJOQFLDIeRTPBCVWMSfZYHdXANcaG,aAAAGAAA.KADAEADAQAFCLAGBeBBBRCDBBAHB..CBEAMAIBhADAZCGBHFDCABGB.NDAA.UDDAhBAA.JEGBDDCBIGEAhCAA..........hCDA......hDAA...,2,-23,-19,4
TKPAWgEMLXOHcZJaFBfRUICSVYQdGbNDe,EAAAMAAALADAHACCZAFBFAHBRCCB..UEFASBCD.QCEAhAAAbFABDAIB.eCHFhAEAKBBDACHBXECA.hAFAOEHDaDHDfGHACFAAdFFA....hBAA......hBHA...,1,-4,-16,12
cbMfHaCLOSAJVDNUETZRWKIQFePgYBdGX,DAAAEAAARACAKACA..QAFCeAEE....PBBBBAHBGCCBhAAA.bCGDHCEAhAHAaDABLEFDAAIBVDCBTEGAhBAAIHHAFFBHdGEAMICACGGD.....hBFA......hCAA...,2,-18,-2,16
KFdagHENJeORbCMIYXPcWTLSfUGDZBVAQ,QAAAdAAAHADAEAGEeACARCAA...bAFAMCFA...XDCAhACAcCDA.LDFAhADAfCFBGFABZDAAAAGAhAAAaFFAgDGAOFHDCHDA.IGGA.hAFAPEEBSGGDhAIABHCA...,1,3,1,2
TBaPIfZHJDQOGKCREVSUdAMYFgebNWcXL,MAAAFAAAeACH....bABA..NAEA.XAFALAFAaBHD.hAGA.fCFAhAHAHCCAQDFDGCGARFCAEFAAhAFASFFBAEEBgFGAWFHHTFCA.hBAA......hCAA...,1,3,-21,24
VQbPHEWXSFgeLMARCTfGBZcOJNdUKIDYa,RAAATAAAGADA.ZAFAOACAdCGA..KCCDDAGA.aBDCQFDAhAAA.HDABEBFESBHBhAAAeDHHAAGABDFCcCCChCAAUGGB.VDFA.bFDB...XFGAhDAA....hDBA...,1,-1,-21,20
HVBFGaceKLOgIUMfTRNDSXbAYCJQPZWEd,CAAAQAAAZACA.EACAHAGBBAEAaAEAeAFHLCCB.OCEBhAAAgBGHUDGBMDABhADARCDBSDCD.hAIAAAHAPDHDdFFDFGHD.GGEB....hAAA......hCAA...,1,-9,-12,3
OgfIMFGBPYSUEZCJATcNKbHVdQaXRDWeL,TAAAKAAAHACB.dAEBaACARAGF..DBFBLAFA.OBDBICAAhAAAGCEABDEDSCGAhAAAEDGBZFFA.AAGAbEGDhCAA.QGCA.WCCD...hACA......hAIA...,1,2,-33,35
LcVGMgDOPYHSTfKZUeJIWRdaEAbFQCNBX,QAAABAAALACAGACBMAGBOAFAHCCA.SBGAhAAAKAHBeCGH.IDAARDABdEEAAADACEHAhAAAXCDA.gDCGhADADGGAPFCDTDGA.ZFFA.WGDGhCAAEHAE.NIDB....hAHA...,1,13,-15,28
YUKOePRGbXdDJHLaMNWIQFZCSEBgfTAcV,VAAAKAAAeACE.RAFF.GADA.dAFBHBCBaAHD.MAIB.IEEAhAAAZDAAECFFBDGA.hAFATFFAACHBUEGAbGBADECBhAHA.JFDFLFHB..WGFG..hCAA......hCBA...,1,-2,-20,18
JSFNOaZgLUYCHXcQPAMGdBKeVWEIbRfDT,dAAAeAAAEADARADA..DAGASAFA.OAHDZBFELCCBhAAA.CDGAHEABQCBAhACAADIBGEDAKCFAIEEAhADAbFFB.TEGAFFHDaHBEgFCBhAGA.XGED.hABAcGGC.,2,-12,1,13
YcJIVHCbSTBGAfFDOURWMLKaXdPZEeQNg,DAAARAAAMADALADA.KAHBdAHAZBBAEBDA.eBFFQCFA.hAAA.gCCGhABAJDDFHEABSDHBhAEAGDFAADHAOEHDaFED.PHBAcGFDCHEABHHD.hAFA......hAHA...,2,-23,-1,22
DTLfeBREdKAaHSgWMIOYUJcbXPQNCFGZV,HAAASAAAMACAOAEEUADA..JAFEXBGA.QCCAhAAAFBHDZCCATEFAhAAAeCFBEDHBACGB.aEDEgDBGhABAIGGAYHAAPFHD.CHFD.DEEB.hAHABHEA....hBDA...,1,7,-27,34
CGFOaQUdESYITeBbDJZMXPNRVfgALcKHW,LAAAHAAAGADAaADD.dAFB.EBGBSAFATDAA.eAHHbDED.hAAAZCAA.MCFB.XDGAhABARGFAfCCEhACAAAFAKEDBFFGBQDGBIGCADAIB....hADA......hCAA...,2,-8,7,15
NfYdZACEgObcRaUPIQTSFBJDVHWGMeXLK,EAAAOAAARACA.UAEAQAFC.FBHDDAHBHCCCGBCA.eBHHhAIALDABKBBD.fDFAhAAAZEBFADGBCEEA.bEGDhADAaEGEIHAABGGA.......hBAA......hBEA...,1,0,-29,29
CSXMHQOWdbTRULNVIBFYaZcgGPeJKfDAE,EAAAXAAAHACAQAFCdADA.RCCALAHBIAFAFAHBZEAAGEEAhAAAeCDAKCHBAEEBMEHBhAEAODBB...bDFDhAAANEIABHCA..aEEB.PHEA..hABA......hBDA...,1,11,-22,33
abCMSQEJBVNOIYeGFTgAKDZURHXWdfcLP,ZAAAHAAAdAEALADB.aAFAbAFD.MAIBEBFBBBHA.OCABhAAAeCABGDDAFDCHACCADDHBhACARFGBfCCEhABACEEA.SEBHQFGBJHAAIGBAhAIA.TGEAKGFD..hBGA...,1,3,-14,17
bfPNKHUVXeBFWdgcAOIZGELJSTaCRDYMQ,ZAAAEAAALADASACECAHA.RAEF...MBCBQAGC..hABAbCFAfCCEhAIAKDDAHEAAXEFAeCHFFDFDdGGAhCAAAAEAGFCBaEDDDEIBPHAA....hAAA......hAHA...,1,-3,-10,7
cCMVbGZfgQOeYLKUDSXFIdPRNBHWJaETA,MAAAGAAAZABEQADA.eAFALAFADBIBFCDHdCCARCFBHFEAhAAAaCFAAAGACDFA..bGAAOCHDhBAAKEHB.UFDASDADhACA.IHHABFGAEGHF...hADA......hAGA...,2,-26,2,28
CYfMNBGASTHXeWaQVPUILDFRgbdEZKcJO,HAAAeAAAQADAUADALAGBRAFA.dCADECCBZDDAKCGAOCHD.hAAACBFB.MDFBGFDBAEEBTEGAhABAaGHD...IGAAhAGADIAA.bGEC.......hAAA......hACA...,2,-13,-6,7
VfIZdYQbPEAHOagGCRKMNcSJXLTBFDeUW,HAAAaAAAGACARADFMAFA..SAEALBGBTDAADAHBUCGBVEEBhAAAZEAAdEEA.QGFAhAEAECCBAACACCFAKEHBNIAB.XFCDhBIAeBBD.fGHE...hAFA......hAIA...,1,8,-9,17
XPFcWAJRbfgOULSaQeTHYBDGVNCKdEMZI,RAAA..bAAAOADA.LAHBaAEA.eBDFHAGBDBGBGBDAhAAACCEA.ECAAZEEAXDFDhABAFGEAAAAA.fFBAhACA.SEHBYHBABEHBKGGAMIAAhAIAIHHA.WCCDhBHA...,2,-35,12,47
FNRUKVOCXBDEYSgMPaWGeLQJcAbfHdZTI,HAAAZAAAFADARADFKAFC..CAGADAIBEAHF..SCAA.MCFBhAAAaCAAeCEALDGBQDGAhABAAACAdGCA.TECAhACAIGEA.NEIA.OEEDBDDD...gGAAhAGA..hCEA...,1,-8,-37,29
LYaVQSBgDUCNZcEGMJeKfRWIAbPHXdOTF,HAAAdAAAFADAaACA.QAFABAGADAIB.CAHAZCCAGCAB..eCHFhAAARCFAACFA.XECALEEAhACASEHHUGAA.hAGAEFABMEIBfFFA.IHHAhAFAbECD......hCAA...,1,-7,-21,14
NaJDAXcSCfPVQMOUILFbKZYWHgRTGBEed,SAAACAAA..fACAQADAMAEAOAFCLBEAhAAAbCCCZCFBHCAA.RDCAGDGAhACAECHFeDABaFBBAAAAXFEChADAPFDC.IFHA.KHAA.hAIA......hBFA...,1,1,-11,12
YTGecEMFaCUSNAWZHLgPXOIdfBbKVJQRD,HAAALAAAXADBdAEABAGAKAFA.QCAARCAADAIBGCEAEBHFaCDChABASCGB.ADIBZGDAhAAAOCFD.bEBAYHAAhACAeDHFMFFBCEDD.UGAAgGGBhAHAfGGE....hACA...,1,7,-6,13
dRDYKBeOCTAJEIPSbZMHXaFgWUGcVLQNf,EAAASAAAZACBHAEAFADAUCEBGAFALAHBQBCDdCBCREFAKFEDhAAAeAHB.CDDD.AGAA.IEHAhAAAMIEA..aGAEgFDAhABA.cGFBfGHEBHHA.hAIA......hCAA...,1,-2,-18,16
LdFESUBMTIeWcRZOJXPfANHYQgabKVCDG,HAAAQAAAaACAKAFADADAGCCAdAGA.EBHFBBDA.MAIBeCFBRCDAZDBFhAAAXEGD.AAHA.hAAAgDFAbFAB.hAFALFHBSFEBIGGAcGCCOFBHhBCA.....hCAA...,1,-4,-10,6
LdCTOZUAFIBMgQbKWRfeHGcENVYJSXaDP,BAAAMAAA.QACAKADARAFF.HAEAEBBB.VCAA..SAHBhAFAaAGALCGBdDDATDGAhBAAZDEBACIBFEDB.bGEAeECDhBCA.GFEB.YHCGDEIB.CHHA.hCAA......hCDA...,1,0,-11,11
GLXKYHcWVRCZFOgIBMdPQAUJaefTSEbDN,aAAAeAAA...TADAEADADAGAGAFALBFAKAHBHCCA.VEEBhAAARCCAZDAFFDHBODFChADABFAAdGHAABBBUFFASHAAhABAbGBA..........hAFA......hAHA...,2,-16,0,16
RAIdFSUKfDBLWOVaYZTePCXHEGbQcJgMN,dAAASAAAKADABAFBLADA.OAGDaAGDZABB..eCCAhAAACCEAHDCAEDEAGEAAhABA.bEFAQDGAhAIA.gFFBRGEAAAEA.FGDADAIB..hCAA......hCBA...,2,-25,-6,19
dPWgAKYXVNEZJRUfIHDLTSQCObecGFaMB,XAAAEAAARACA.UADAHAFB.LAHB.TCDAQAFAhAAAOCCHeBHHGEFAhAAAaDBAdDFAgFABhADAAEEAKEHBYHBANEIA.fGGASFED.hABA......hAIA...,2,-24,14,38
GZfNQcTJXbAHVLBOPeCgWFREIMUaSYDKd,HAAALAAAOACAeADHCAFA.FAFARAGF..ECCAMAIB.UCAA..hABAaCEDDBFBGDFAZCFBQEDAhACAJEDFACIBBFHAPDHBhDAAIHHA.KHEAdGGD.....hAAA......hAIA...,2,-16,-6,10
THPdKXFAafcOUBDIRYQNVgMbGeEZJWSCL,aAAAOAAABADARADA...QAFA..gAGBhAEAGCCAEBBBZCCASBHBhADATDGAHFCAdEFAFDHHABBBfFFBhAIADFAAIGHAYFHBMIAA...hAFA......hAIA...,2,-17,-10,7
dSFTCVMWARZfGYcILXHJUeDEObKgPNQaB,RAAAGAAA..IAEAHADAeAFE.ECDBKAGA..PCFAhAAAaCCAdCFATEFAMCHBAAAAZFDFhACA.fFHAhADALDAAXEECDIAA.bGAA.QGGAhADABDHA.....hAIA...,2,-15,1,16
UgTZVDPHOCYbAFeSaQGfBIJKWNLcRMXdE,eAAAaAAAGACABADAKAFALAEA.RCEAdCHAEBHFUCCAZEEA.DCFBHFAAhAFA.CGEAAAIBQDGBhAAA.JFAAcGGChAGAMFFB....TGGAOBBHFHAA..hABA......hAFA...,2,-25,0,25
PIEJHaTDgRdYcGKQCeOAMSbUZFXWVfLBN,MAAASAAAZABEFAFA..XACD..fBEAhAIALAEABBHA.ICFAhAAAHCCBaBGETDDAhABARDGBdFEAcGGCGDGAQFAACGDCACCB.UGEAhAFA.....hBAA...,2,-20,-2,18
KMRFcVOXBDQSfYegaCGIbAUNHZTWJEdPL,HAAAZAAAJADAEADE.dAFALAGBRBGF.FCAAOCAB.DCCAQCEAhABASDDAeCHHhACAaDHDGEFAAAIB.NHAB.hAAATECA.KFFAMIAA.....hCEA......hDAA...,1,-2,-29,27
CIQfXgUTYcSPRdKeMaNFBJDAGWZLEbVOH,ZAAAEAAA.OACAHACAQAFC.XCCATAFASAHBhABARCFAeEAAMEFBaCCCBAHBhAAAACEAGCGAbEGD.CDEAIFFAhCAA.fGDA.YFHBhCBA...hAEA...,2,-16,-5,11
dVLOXTQSUMeGFKIYBDHPCZcNJAEfaWRgb,EAAAaAAA.RACA.dADALAFB..TAFAQCCBMAIBeBBBhAFAGCGAKCFDBAHAHCGBZDAFhAAAJDDBACIBfEEAhADA.bFCDXFFCFGFBDGIBCHAAWDBD.OHAAhAHA.SGHHhBAA.,1,11,-14,25
PWMYObUXQdBSZAfTENLGcDaJVCHIgKRFe,EAAAGAAADADA.aADA..CAFAHAGBKAGARCDAFCGAeBCB...MBEBODBDhAAAUDGBdEFAZDBFAEHA.TFEAhAAALFHB..hACAJHFEgGAB......hAGA......hAIA...,1,-13,-18,5
UOEVCaKTQDZBJXgLdFSGNMfWPcHIYbeRA,EAAAaAAA.KACADADA.ZADEBAEB...XAFDdAHAGCCB.MBBBhBAA..fAHEhAAAPDGDHFCAbCCBADGAOFHDhBHATEEA.QEGC...hCAA......hCCA...,2,-25,-19,6
VWEJBKPUDXcQTAaZbIfYHOSRMgNGdCeLF,ZAAA..bAAAIAEAHAEARCAA...MAGBGCEBeAHBLEAAhAAAFCAAECEB.KEEA.DAGAQDGDhABAABIBaEGDOFHDhABASDADdHCB.CDDDVFCA.BFHD.hACAXGGC..hACA...,2,-15,7,22
WGScORIEgYNfeHZFdQbBVLKPAXJUaMCTD,XAAAaAAA..MADADADAGAEBOAFEEBBB..NBDAHCEAhAAAdBDAQCFABCHBLEEAhABAACIBCEEA.TGEAhAHASEGAIHHAfFCAeECD.FGGA.hAIAKHDA.....hCAA...,1,-8,-17,9
GRDNfLgXTZBWEdIVCYPFaOJQSMUKebcHA,RAAADAAALADB..TACAZAFAECFAdAEACCCC.FAGA..ODFEhAAAQCFAMEEBeFCBhABAHDDBABBB.GGBB.hAGAfCCEBFFAIFHAPFGBaHAA..hAHA......hAIA...,2,-19,-14,5
FgNKBGSIPDMcOJdZXEafTLHYUbQWeRCAV,FAAAKAAAGACA..SACHDAEAMAHB.OAEAZBEB.EAHFaCABhAAALBEBHDFBUGCAhACAbCFD.eEBF.AAIB.gECBhBAABEHB.IDHA.cFGDhCAAdGHA.....hBEA...,2,-21,-9,12
bZaOGRBUIEDKVfgYCXcSLMPTHJeQNdAFW,FAAAZAAAGAEARACFBAEB.EAGA..KAGA..fBHACCEA.SACEhABAMCGBHECAeCCBhAGAdCHAAEEAaDGC.OEDDhCAADFHB.gFFAXGAALHDAhAGA......hAIA...,2,-33,0,33
XBaNELWYcfKVIRQCSbUZDeOgJdMGTFHAP,BAAAEAAALADA....cACAKAHBRCBAQCFAhAAASAEBZAFBeDHHOAHDhAAAdEAAGECAHCBAADHBaEECYEEAhBCAfGGECFHAbGECDGIB.....hBHA......hCAA...,2,-22,2,24
MbUNRaGeEVgXfSKCOFZAIQPTdLWYcHJDB,QAAAdAAALADA......cADAHAGBBCBAUAGARCBAhAAAeCEBEDEA.XDCDhACAKDGAFECDAFAATEGA.hAFAYEABMFFAaGBCGGDBfGGA.hAEA......hAFA...,1,-9,-15,6
VSHZKCBbUPFAdQgLTJYERDMaNIGOXefWc,dAAALAAAJADA.RADFMAFA..aAGAGBFAeBDB...fBHEhABAVBGBHCACZCAABDFDhACAUFCAAEIB.QFFBhACATFCADFFAOFHDXGGA....hBAA......hBCA...,2,-23,1,24
SDAJMedLCQINbWGPOBgKEZafYUVXRTFcH,eAAAdAAALADAQADA..bABDGAGABAHAKCEAECCBaDFBUCGAhAEAREDBFFBBHECA.AEEAMFABhAFACAFAIFHA.NIAB.hAAAOFGB..fGFAYFHB..hABA......hAIA...,2,-8,-8,0
dICTAfVaRUeObPFKEGgQLHWBJSYNMXcDZ,aAAARAAAeADE..OACDFAGAGBDALAEAHCFBBBHA.SBBDhAFAMCCBDCIBdFFDTCEAhAGAAAAAVFCBUECAKGHBEDHBhAIA.QEFD......hBAA......hCAA...,2,-19,-7,12
QaYdLgfUHeTMcCEWFSJGDXKZVRNIOPABb,QAAAdAAALADAUADAHAGB.eCAAMAGBECEBFAHBGDFA.hAAAKDDDRDBAOCHDAAEABDHAaFCChACAfDFE.hAIATFGACFHA.SFBADIBA...hBAA......hBCA...,2,-16,-7,9
aCKeXNgTJfMRbLdZYSODHPBWFUEAIVcGQ,VAAAGAAA.aADAeADE..XAFD..TBDAMAIBRCDBhAAAdAGAZDFBOBHDHDBBBEHAhACAFDDHADGBQEGDhAAAKGHBJHAAfHEBbFEDSGHD.DIAAhAIA......hCAA...,2,-12,6,18
UQBMLTPdbKRZIfcODJEGWAHeCVSYXaNFg,HAAAeAAACADASACE.aAEDFAFAQAGAMAIBLCCAhAAAdCCARCFBZEDB..fCGAhABADDIBEFFBAFHBXGAAhAAAgECABHHAbEGDKFEAOHDE..WFBDhBFA...NIEB..hAGA...,1,2,-17,19
PMZcBNDWTXSgabJHIAVQYFOKfELdCUReG,QAAAOAAAKADALAFBdADARAFAGCDBZBBABAHADCIB..TDBAhAAASCGH.aDDChAHAHEEC.AAFAFFHDEEHFeFCAhBAAMHCANIAB..XGFC...hAIA......hBCA...,1,-5,-20,15
ecVaIWLRAKQbPHTSdEXCUgMFZGfJBDYNO,QAAAHAAAdADAEAFACACA.UCABFAEA..GAGABAHADCFA.OCHDhAAAeBDFaCED.LFFAhAAAADDAKDEA.TGDAhAIAXFAA.ZFFAfHFFJHDA...hACA......hAFA...,1,-10,-18,8
AJaPbEDTKOXQgZRMVUCBFeIcfdYLSWNGH,aAAAEAAAKACA..QADARAEF.MAGBCAGBeAHH..fAHAhADAdCCALEABSBBDhAHAGCFAHEDBhAAAACCAbDDBTDGAODHD.ZFBBBGHDFFFBIGHAhBAA.....hAEA...,1,1,-13,14
aQFDHZUgfWReNLTAVKYEBdPIOcCMGbXJS,KAAAEAAAdADAOACA..MAFAGAFA.JBCBaBCB.QBFAhAAAHDEBZDGBUFBA..hAAAfDDAeFHHNIABAAHA.hBFABBHA.IEFA.bEGD.FFBB.hBHADDIB.RFDB....hBIA...,2,-12,-4,8
EBHPTJNZeAfMXaQCFGKbUWLSYDRdgIOcV,MAAAaAAA.FADDGACA.KAEAUAFALAGBDAIBRBBB.dCFC.OBBHhAEAEDEAHDGB.JEDFeCHHhAIA.AEEBQFFChBAACFBA..SFFDIHHA.BHBAhBAANIBB......hBBA...,2,-31,-4,27
HfBQIJWVSFPYdKGROeUgTMcZEaALCDbNX,LAAADAAA.XADDHABCQAEC.IAHAhAGAVAFAFCAAdCGARDDAeCHFTDDAhBAAZFAAACCBCEHA..bFFABFDDhCAASGDHKFFA.......hCBA......hCIA...,1,-6,-24,18
YacAdHgeCQNOIGTZSRUFVDbWfBEJKMPXL,HAAAeAAAQADAOACAGAFAZAFBRCCBFAHFDAIB....bCCBBCHDhAAAEDHB.MEFALEEBhAAAaFBBAFFAdFHACFBATGGAhBFASGGD...WHBAfFDAhCAA......hDAA...,1,-3,-13,10
IAXWdGQYfPHZaFLTKCUEgbNJSMcDOBVeR,dAAAGAAAQADA..fADAHAFAaCAELCHBhACATAFACAHBECDAbDAA..SDGFhADAMCHBODAHeEDHhAHAAAABXDEAPFFBKHGAgFDANIAB.hAIADCIB.BFHA.IHHAhACA,1,4,-5,9
WYMdLICAKURXOTGFQbfaEPVNBSceZJgHD,RAAATAAAGADA.QAFAaACA.ECCBPAFA..BAHAhAAAeBDBZCFEHCFADDABMEGBhABAdEFDLFBAAEHAKFAAOFHBhADAfCCE.SEHH.hAFAgGGGWFFD.hCAACBHA...,2,-14,1,15
QBETAaZeYNfWRIUPcKbgCHXdMDJFLOSVG,eAAA..fAAARADAUAGAKCCACADAHAEB.dAGBMCFBFBCHLCHBhAAASDGAGCAAhACAEEAA.ADEBZDFB.YFEFhADAIFGA.bGDCDGHB.....hAAA......hABA...,2,-33,2,35
ZARYGFOUcVCgNTXbIfeDHPLMdEBSaKQWJ,RAAAGAAAOADAUADA.CAFA...TAGA..bAGDeBDFHDBBhAAAMCCBEDDABEFAaCGCQEDAhAAAZEGBAAIBFFEH.gFFBhABAXGCDDFIBLFHB.KHEA.hACA......hBAA...,1,2,-8,10
NcQFbCPAVEXagURYeTHIfWdSMBKLJZODG,EAAAaAAA.RACA...eACHHAFB...fAHEdAEAMAGBLAHBhBAAZCCAGDAAQDDAhBBAbDGDADAB.XEBChBEAgECBTEGASFFDKGEADGIBFHBACHHA.hAAA......hADA...,2,-6,0,6
KaeRNOLGTfbUdQHPWZYJXgDEMCFVISBAc,aAAARAAALADBGACA...TAFAUAFAHDFAZCFA.XEAAhAEAEDCBMEEAFEDD..SAHBhAAAAAIBeFFAOBBHhBAAdFAAQFFAPHBA.YHCADGIB.CFHA.hABA......hAFA...,1,4,-9,13
bVfMKENXOFDLdeQAYGSBRHPUCcZaWITgJ,GAAARAAAHADBCAFAaADA....TBGAJAGB..VCDBMCCBECHFODABhAAALFCAeDDAAAABBEHAhACAPDHDZGAAgFFBhABAKGFA.FGEBDGIBdHAB.....hAGA......hAIA...,2,-15,9,24
IOQSgNXJUeYdaMVDHWLRFTcCZABPEfGbK,EAAAGAAAKACA.QADA.SAFAXAEBeAGFaAHDMCDBhAAAHCCARCEAFDHDTDGAhAAAZFFAADABfECEhAIAOGAAgGEGUFEAdGGADBIB.WHCGCHHD..hCAA......hCBA...,2,-8,13,21
RZEcKTFadAXIYJbgeUSfWHVPMGONCDLBQ,XAAAJAAA..eADESADAHAGBMBEBGAFA.CAHALCDBhAAARDCBECFBKDHBaFEDAADAbDEDhABA..UGAA..hAGAfCHAPHFCDGGAZGFE.FHAA...hAIA......hBAA...,1,-2,-12,10
RKfVBgOUeJFPIGNSDbWQMLcZaACdEXHTY,EAAAHAAARACA.KADCBAFBOAFC..eAGHFCAHGCCADAIB.QCFAhAAAMCCBZDAFADDAdDHA.hAAATFEAVDEBUGGAhADAIGHA..bECDLHAACHEA...hCAA......hCBA...,2,-14,0,14
dCgObfXESPTFReKIWYJULVZaDQNHMGcBA,dAAAOAAA..bABDEADA...SAFATADA.RCCAeAHHhAGAKAFC..IBHAhADAJDFBLEHBaCEDQDGAhAIAHFCBMBBBGGCBACCAfHFBFFFC..hBAA......hCAA...,1,-7,-12,5
TJCYNUMEAXWSeaFcObPHGdRBVgLDQfZKI,SAAAeAAAFADD.OACDHAFARCDA.BCHALAEAQEFAhAAAZBFETDFACEHA.UECAhAAAAAHAaCCH..bFABdFAADDIBhABAKFEDIGGA.YHDAEGHFWHCA.hAFA......hAGA...,2,-13,-7,6
KaFSIRCWbXDeZEMdNGVgPJAUBOcfTHYQL,OAAATAAA.HADALACBaAFA.FAEARCCBCBBD..XAGDZBFEEDGA.hAIAdCEAGFEB..hBAAgDFHAEFBBEHAfGDEhCAAQEBAIHHAbFGDMDIB.NIAB.hAAA......hAIA...,1,-1,-13,12
JDaEHNUGcQgBbMdeWRFKXfLVZPYOACTSI,TAAASAAA.DADAHACBGAEBQAEABBCAdCEARAGBXCAChAAALCHBZDFBODEBhACAAAAACDDC.aDFD.EDHFNHAB.gEAAhAEA.eFDDKGHBfHEFhAHAPFHD.....hAIA...,1,12,-20,32
YTNgeGbQKVUCaFdESJALPfRIDXBMHWOcZ,LAAARAAADADABAFAHADB.OAFAZAGB.TCAAeBDFGCEAhAAA.QEGAhABAKBGDCCHAdDDDEEFAABIB.IFBAhABAMCCB...cEGDgGCA..hCAA......hCGA...,1,-11,-26,15
SWXGdMYgeKfJUZOAFQREPcVICHaDTbNLB,RAAAEAAA..VAEAHACA.aAEADAIB..bAGDLCCB.SCEDhAAAGCDAdEHAMCHBhABAeFCBKDAAfFFAhAAA.JHFEZFDBAAIB.QFGB.IHAAhADACCCD...hCAA...,2,-17,-3,14
IZEHXVCJUDRgbAScBPaMfTKWdGeYLFQNO,BAAAaAAA.MACAKADAGAFALAGB.QBCAOAHFZBBAHBEDhAAACDAA.DAIBRDEB.ACBBSDGAhBCA.fEEEhBGAdEHAeDDDFFAAEFHBXGFDJHAAgGGGhADA.....hCAA...,2,-21,-5,16
XGUMNCaDPeFRYJSHbZfAWcKOIVdTBgQLE,KAAAOAAAdACABAEALAEAGAFAMAIB.CBBD.DAIB..eBDBRCDB.hAAASCFAHDGBZEAAAAHBhAEAIEFA.TFAAhAFAEFFBNIDB.aDDH.FEHB.bGCA...fGGEhAGA..hBAA...,2,-21,-16,5
JMABGLEcKQHeNCRfWDgTVOSdZbUFYIPaX,GAAAEAAAKACA.HADA.eAFERAEFDAGA..TCEASBGAZCGBbDCDhAAAFCCB...IDGAhAAAaDAHMDIB.ADCBBEEDhACALEAAQGEAfEEA.gFGAhAEA.dHBB.hADA...,1,6,-23,29
aORZBTUWbcVNXeIHfJdKGAFgLYMSDECQP,LAAAMAAADAEA.EAEA..QAGAaAGDRCAAZCEA.BBBA.TBDAhBAAbEAA...VCFBhBBAeDHHHDBAdEEAAAIBFEHDSGBBhABAOFBBcFFCXGEA.IHHAhACA....hAEA...,2,-11,-8,3
gcWQaCMEPUIFRTGLbSdOeKBHZYJDAXNfV,XAAAVAAA......gADBQADAaAFAEAFAUBGBhAAARBGBGDAALDCAhAIAdDCBeDEHHDGBZGEADAIBAAAAhADA.fEHACFFD.MDGB.FGHD.hCAA......hCDA...,1,4,-10,14
JUGODKedgWEIZAHQPXBRafTNVLSCFcbMY,HAAAQAAABADBRAEFaACE..TBGALAFAFCAH.MCDAUDCAGCGAhAAAKDGD.eDAAdEEAEEHFhAAAAAGAfDEAhADA.SEDDbGAA.OFFBDAGAgGGAhACAIHHA...hCAA...,1,-3,-10,7
OKQVgIANJYSURdEfHDbTPZeLGMWFBCaXc,JAAASAAA.RACF.EADEHAEBDAFA.TAGAeAHFGCCA.hAAAMBGBBCHA.aDECOCHDhBAAQEAA.hCAAgEFAACCBUFEAdGGAbGAA.PFHDWFCD.hCBA......hCEA...,2,-21,3,24
QRfPNDBgVWMZGbeTEXOYIJdSKUHFaCcAL,RAAA..fAAADADABAFA...VADAZAGBeBDFEAGE..OBCBhAAAJCEB.dCGAKDHBHDABhACAFEGH.aDDA.ACIBLFFAhADAQGCAgGDBMCCB....hAIA......hCBA...,2,-38,-1,37
DSaLJbGfgEWZAcKUeXMNVIPBQCdFYTORH,KAAAeAAAMACA..IAEAQAFAdAGAFBCDOAHFHCEAaBCDLECBhAAA.GEEBhABAEBEBADEBXDFAhAAAPHEACGBC.RFFBSEHH.fGDAhCAA.....hAIA...,1,-10,-12,2
XMSGcFbKPaTLdDYNgEeIJWVRQAUCOHBfZ,OAAAHAAAZADB.MAGBGADAFAHB.KAFA.aAHDdCAD.DBFB..NBBA.hAFAECHF.eEEB.JEGFhAAARCFBACCB.BDHB.SDDDhAHA.bFEA......hBAA......hBDA...,2,-28,-24,4
PLXBFYNWMbgedECaURTGKSfJVOcZIDAQH,HAAALAAAFADA...NAEA.bAFD..eAFAEAHBUCABRCAAGCFASDCHhAAAJEHB.ODHDhACAZFAAABIB.QEEAhAIABCHDMFCAdHCB.aGFE.......hABA......hACA...,1,7,-20,27
BLHWODgYbdeIRVTMGQSZCFUfAPXEJNaKc,EAAAaAAABADAHACADAEA.....bAGDeAEH.RAGBMBBBGCDAhAAAZCCFFEHBAAIB.XFCDhAIAKCFBLEEBOCCBdGAAhADATGFAQEGACBFA.fGGEhAGANIBB......hBAA...,1,7,-18,25
DaQRdVCcEWNFUbBXGPJHYLSIOATfMKeZg,MAAAeAAAZADBDAEA.RAFA.dAHA..CBCA.EBBAFCFHBBDAGDGAHBEBLGAAhAAAODDB..ABGAKDHBhBAAaEEH...QEFDhBBA..WHCAbGCCXGGA.hABA......hAGA...,1,-9,-27,18
GBSXMIVYaWCPbeLAfROdcQKFTZgJHDUNE,RAAAdAAAQADCFADAZAFBHCACDAFA...EAHFGBFABCHA.MAIB.hACAVDDBaDEC..CECAeEFAhBAAAAAAOCCB.TFGAhBHAgFCA.UGGASHCA.hBCA......hBDA...,1,-9,-14,5
TYPCSdQZUIXLVRbBgAEFOafDcMeNWHKGJ,EAAAaAAA.DADA..eACHHAECGAEA.TAGACAHBdBCAZCEA.XEEAhAAARDDBBCHAAAEBODHDhCAAMBBBKDGD.PEHDhAGAQFCC.IHGA...hAIA......hBAA...,1,-17,-19,2
LXcKAbEaBGNSQVWdTYIFZeUHCJMOgfPRD,EAAAGAAA.QADAdADATAFAFAFEeAHHHCEC.MAIBOBCHhAAAfDCARDEALFAAhAFAKEEAAAABaDBHSDADhACA.VFGBIFGACEHBPHCAXFDDhAHA.BGHA.NIDB..hADA...,1,4,3,1
SKLDBbEdGMCcVJZOeYXFRQgUHTPaNAIWf,..IAAASAAALACABADAEAFAGAFAMAIBCAHA..VCCAhADAZBEEeCCB.FDABRDGFQEAAhAEAHDGBaEEBAAAAKFAAhADAdFEAOHAAXGDAgGGAUGGB.hAFA......hCAA...,1,4,-2,6
EYLWCVBXgSMGNIaJZHPDQbKRdTFecOUfA,EAAALAAA.CAEABAGASACAGCAAaAEDHCCADAGA.KBHBRBFFdBHAhAAAeCFHUDAA.ACCA.VEGBhABAMDDB..IFCAhACAZEDBQFFAFGAHfHDBWFHH..hAEA......hAGA...,1,-9,-12,3
eOgPGUYQXfZDHNBCLEWJcFVSAMKdTIaRb,dAAAaAAA.RADA..eAGHOACDGCABUAEAQDEDZAGBHDEACEBAECHF.hBAA...JEDFFEABABBBKFGAhBEAbFCA....gGGAhACAXGBCDCIBBEHA....cGFChBGAMIAA....hBIA...,1,6,-24,30
JEXKINaDBdFMOGUYVSbCQRWZeHAcfLgTP,LAAATAAA.EAEAKACC..aAGDdAFAMAIBGBDA.UDGASCAAhABAQFBARCEBeDCFhACAHFEAADGA.fAHAhAAAgEGA.XGBADCCBOHAC..hAHAYEADCGHA.WEEDhAEA..,1,-5,-7,2
NQLRSJFVTPKCgYaIZUHWbMeDfcEOAXdGB,GAAAQAAARADAFAGA..TACACCDD.aAEAZCEBHAGBMCHBeBEFhAAADCIB.EDFB.AAIBdEHALEAAhAAASDDDJFGFKGDAhACAgGDA.IHHA..hCAA......hDAA...,2,-24,-2,22
LeHdAaGDfQCRINcXKMOTPFUWBSYgVZJbE,GAAAQAAARADA...IADAXAGBMAFATCEA.FCHDhAAABBEA.SBFHhAAAgDCBZBGBEEABHCBChBCAAADAaEGCCEEAKEHBUGCAVGFAbFFC.....hACA......hBAA...,1,-2,-6,4
CIBbVXZAGRYdSHDJNeTMWPLKQfgaOcFUE,RAAAdAAAHADBDADA.eAFAMAGBLCGB.QDAAaAHBFBDAUDCAhACAEDDBBDFA.bFAAZDGBhBAAAAAA.SEEBhBCA..TGGAKGEDfGHAOFFB..hBIA......hCCA...,1,8,-34,42
XdCeMLTcUFDfQSYBVIbAgGOWPNHKJaERZ,GAAAOAAA...PADAHADAaAFA.RCCBdCFAeAGFLCHBhAIAUCDADAIBQFDAhBAABCHDbDBD.ABBB..NIBBEFGBZEFBMEIBhAAA.FFDASGHH...hACA......hBAA...,2,-12,2,14
faFBGITHJDXcgYdCPWbVMNLZSKOeEQRUA,aAAAGAAAHACBDADA..XAEA..gAEAdAHACCEA.hAEAbAGDMBBB.ZDEEOCDBhAAAEEHFRFAAAFAABEEATGDAhAFAcEGA.PFGBWFFB.LGCAhACAKHBA.eDBH...hBAA...,1,-4,-5,1
LSdeGMJYcgbQTEHIRVBPKOfaZFAUXNWCD,XAAACAAALACAdADAGAFA..MAFAJCCA.....gBEHhAAAbDAB.EBHBhABAHDGBRDBABDFAOAHFhAAAZEFEADBAUGGBDGGAeHDAYEEB....hADA......hAEA...,1,-11,-16,5
YDWAFHXCRbISBGfcVQJKNgdPaUTeOEZLM,HAAARAAA.SACEGADAVAFAQAFAKCCD.dBHAaCGEeCCAhAAAEDAB.ZDCELEFAhAAAMDGBDEHBAEGACFADbFAA.fGHAhAFANIAB..gFDB.TGGAhABAOFFH...hADA...,1,15,-12,27
EYbWRANOXZILDCFgaGBeUMQVdSPKcHfJT,XAAAZAAALADBFADA.GAFABAGAUCDAMAIBdCAA..KBHBHDEBhABA.TFAAECGB.hAAAbDGDADBAOEFC.hACACFDAeGAESCCDfGGAYHAGNIAB.hABADIEA.....hAGA...,2,-32,12,44
WKfETDceJIUXCZLHFVPNOSGdYRagBAQbM,MAAAKAAAEACEDAEA..eAEEUBBAZBCEHAFCFBHD...VCEAOCFDhAAAdEBAREFABDDA.AAHAQFDAhCAA..hCBAbECDTFGAIGHA......hAIA......hBAA...,2,-22,-19,3
eAQNKFWXZfDGOHREPdgSbIVUJCaYLcBTM,QAAAFAAAZACBGAEAHACARAGB.EAFE.dAHASDED..hAGAbCDAUDGBaDGDLEAAhAAATEBA.ACEAKEEBfFGAhAIAOEHD.IHHACGGD....hBAA......hBEA...,1,2,-23,25
fVTIBdAHSKEbQCeLYFRcgUaGDPJONZWXM,HAAAEAAA.QADCeACALAGBRAFFUCABGCCADAIB.OBEDhAAAZDDAMCHBTEFAdFAAADIBbDABhADAFFDA..aCHDPFHDhAAAWFHH....fGBA.BHGChAIASGGD.hBGAYHAGcGCD,2,0,14,14
EYQVbgXHZKUeJBCdaODTIARPcGNLSfWFM,RAAAGAAALADBSADAFAFA.EAGAQCFA.VEEBhAAAbBFAHCDA.ZEAAeCCDhABACDCDaDHHTFBAAAABcEFChACAfEHA.MAIBXGAAKGHBBHDAhBFAdGEADGIB...hCAA...,2,-8,15,23
TFaQRIMJKYUgeVNEdGDAZLcWCXBPfOHbS,ZAAALAAACADBBAFAOADD.HAFASAGHaCAA.RCAA.MCFBhABAKCEA.UDGA.eDDBhACAECHFGECAAAHA.XEEAhABAbFAATGEAQFAAIHHAgFGHhACA.NIEBDIAAhAFA...,2,-23,3,26
EaRDJPZWXKNQOFALYBGfbUTCgSMHceIdV,LAAAGAAAUADATAEACAFA...MAHBHAGB.eDBHdCAAECCAhABARDDADDIBZDEAKEGBQFDAhACAAAABBFFD.bGACSGDBhACAIGGAaEAE.......hAIA......hBCA...,1,4,-23,27
YAQgKeCDILbVHZNMTXFSaRcUJfOPdGEWB,QAAAeAAADAEALAHBHACAZAFB.MAIBTBCAFCDD..RDFAUEAAhAAAOBEAdFCAECEFBFFDhAEAAAAACDFA...IFHAhAFAbEFA..XGGCaHBC.fHCBhCAA.....hBHA...,1,-3,-13,10
TXgNZBfcVObYGCRDMLEUAFadHIeQKPSJW,dAAAHAAAeADAQADCKAGA.SAFBJCBB.TCEAXCFAhACAZBGBfCAEhAAAODCDGEEARFFAMCCBEEHFAADAhAIAaDDH.IHAA..gGCGhBAABHHA.....hACA...,2,-15,4,19
BTXFJPKcEYGSeLfDAOaNdCQHVMUbZgRWI,aAAAdAAAHADA.MAFAZACBRAEABBGAFBHDKBBDECBA..GCEALDEBhAFAABIB.CDGD.QDGChACA.bDAAgECAhAHATGGA.XGFA.....hADA......hBAA...,2,-25,-8,17
eDQXSZaTOcFIKCbYEgPJUdfBVHNMGWARL,RAAAeAAAQADCZADBOAFCFAFA...CBCA.EBHF..JCFAdCFABDEAhAAAHDDBGEFAAAAALEHBhAIADEIB.aCCH.IFGAhCAAKHAA..........hDAA......hDBA...,1,-12,-37,25
KZYWEODbQHPgRcULfJIVXaFdCeTGBNSAM,ZAAAEAAADADAHAEA.RCAALAHB.JCEFXAEA.dAHAeCGDhABAGBCASEAAhACAABCBMCFBKDGAOEHDbFGB.hAAAQGAA.gGFBfGDAhBHAaHCA.....hCAA...,1,7,-32,39
aNETfGHSMDFgAKedVIUXWOPLQBbYJcCZR,eAAAdAAAUADAOADCLAGBBAGB..JBHBZCCA.REEA...ECCAGGBBhACAHCEBMEDBFDBHAAIBKGGAhBAAXEGA.QFAAhAAA.cGDDNCIA...TGGAhABA.DIAA..hAFA...,1,-14,-21,7
KTbIAeHZGaSRcOBJgCDUEPQdWYMfFLVXN,HAAAaAAA.RADFBAFBCADA.EAHBdAFA.MAHBLCFB..XBBChADATDAAAACAeCDFGEGAhAAAOCHDDDDBQFDDhAIAfEEAFFBBKHDA.ZFGF.SGDAhAIA.....hCAA...,1,-9,-13,4
VJfDeSXLNcdbaPYEFGBHWZQIRAKOTgCUM,TAAACAAAUACA...MACA..VAEADAGAeBDALAHBdBHAaCCChAAAECBB.GCFAHDDAZEGBhAAAREBAABDAKEHBOFDB..hBCAfGHESFFFXFDA..hCAA......hCHA...,1,-10,-13,3
bGJLQRHIfdBPEWTMYgNXOKZeCDSaVcUAF,GAAALAAAHADAdAEAEAGAMAFA...gBFAOBHDeCAAhABASBHHaCEE.cCDChAAAACAAbDDC..REBBBEGAhACATEFAXFFCCEHBDDABFGHBIGAA.hACAfGHA.hADAPHCC.,1,7,2,5
XQDOcAZGbCURVdgeWJBTHKENSYMafLFPI,GAAACAAARACA.dADAeAFEBAFAHBECEAHB...SCAAaCDELCGBhAAAFCHD...XDBDhACAQDDAOEEBhAFAAACAbFEAgFGA..WFHH..hAAA......hAIA...,1,-10,-24,14
FPfDcAagGLeNXYJTVCMQEBZObHdWRKUIS,GAAAeAAA..XADATADA..MAFAEAGAZCCAHBFARCGBKEAASCDDhAAAFECA.DDABAAAAaEGHhAEALDFA.YFFAhACACGAAQGCAOHBAWFFDIHFAhADAfGHA...hBAA...,2,-10,-9,1
OfCabZKUSEIPTcdRWFLJDAgGXHBQYVNeM,GAAAHAAAQADC.VAGBeADAMCABCAGAZBFE.SCDBhAAAECCBTCEARDFALEAAhACAADIBBEEDOEGBbFFAKGDAhADAIGAA.PFHD...WHEGhAAADIAA.....hAEA...,2,-11,8,19
IVfFXSQdGUKMJYPZRAWEaBNOcTDbeLCHg,EAAAaAAABADA..OACCDAFALBFAHAFBIAHAFBBH.QCCAhAAAGDCAMDABhADAPCHDABGA..NDIA.bEABhAEA.eDFBCCED.fFHEdEEAKGFA.YFFFhAFAWHEG....hCAA...,1,-11,-24,13
OMCeSRPBGQfLcJIYEWXFVAKZUaHDgNdTb,ZAAAHAAADACAdADA.TAFAMAFA...eAHHRBDFGBFALCCAJDHB.hABAECAB.FDFDABHAKFBAaDHD.hAAA...bFAASCCDhBFAQGGAfFEAIHAAYEEFhACAXGGA....hAFA...,2,-29,4,33
UNLdKWeScCZabRTEQfMHYFIBAXOGVDJPg,GAAADAAA.JADAUADALAGBdAGAeBBB..CCDAZCEBRDDA.EDCBMAIBhBAA.HDGBFDHDAAABODBHhBCA..gFGGhACAKFFDSGBAaGEB......hBDA......hBFA...,2,-22,-22,0
fOBcTXIZJAUGYbRLdaWeFgHDENPCVSQKM,GAAARAAAdADA.eADAHAFAEAGACCCD...QCDAMCFBBCGATCFAhAAAZEDFAAAA.UEABLFAAhAFAaCHDFFFADCIB..PHCAhACAKFGAOHAA..IHHA.hAHA.YHEG.hADA...,1,-4,-16,12
DfeMHBVGRONILCTAYQdUZKJFbSEXWPacg,dAAAZAAAFADAEADA....XAFAaAFDDAHB.eBHHHCAAGCABRDEA.hABAOCFBLDHBAEEBQEGBhACAKECASFGDhACAcGAAMIAABECA.IHHACCED.YGCChADA...hAIA...,1,2,-21,23
XJQdeLGEVgcWIOKYaNfZFbHSPCBUMRTAD,XAAAdAAAeADAEAGA..VADA....gBGAhACAIAHAKCDDaCBDZDCBHCFACDACMCFBhADAAAAAQDAAhADAGEFAODHDfEEA.bFGBBHEARGAADGGB.hAEA......hBAA...,1,3,-6,9
TEVQGFNOHdcUgLIAXDWRYeMBabCSKPfZJ,DAAARAAAeADEMADABAGB..aAFECBDA..KBHBZBBA.EBHFGCDB.hAIAOCCHHCEBdDBAUEEBhAAALEHB.ACGBXGFBhBAAbFGD.SDDDfGCA.hBCA......hBDA...,1,-18,-22,4
eCRYLbZVMTgUEGBfFOaHAQXSNcdKPJWID,QAAASAAAdADAKACA...JAFADAEARBEF.LAHBZCGB.MBFBhAAATDBAEBGFGDCAhBGAFEEHHGECACDA..XEGAhCAANDIA...PFFB.IHHAhDAA.....hAAA...,1,-6,-23,17
CZgXIEdfTMLOAUKeaDNVBcbRHJFWGSYPQ,eAAAaAAA.DAEABADARAFA.HAEBFBCD.GBGA.SAGChADAQCECZCCFXCGDhAAAEEEEdGEAMBBBACIBKEBAVFFAhABAcGGA...........hAIA......hBEA...,2,-26,-3,23
ZDXFGVBNMbUaHeOTKdWIQJRYLgAPECcSf,EAAASAAAZACB.FADAGAEABAGA.MAHBUCCAHDFB.eCBDhAAATCFAdEDAQGAAhAGA.JFHBREDALCHBhAAAAAIBCDHA.DDBB.XGAA.NHEB.hABA......hAGA...,1,5,-30,35
YJAHfNRUMESBTDeOQbLVKCGZIdaPcgWFX,HAAARAAAEADE.TAEA.eAGHQAFCLCAACAHBZCCAaBHDPCEBhAAA..gCGAhAAAXEAAAEAAfECAhABAMEGBDEHBbGAAKEEDdFGAWEHHFHCA....hCAA......hCDA...,1,17,-12,29
QcVTJdaeARBIfKSNFLWXYbEHPUDgGZOCM,RAAABAAAKADC.FACALAGB..XAEDEBEAHCCADAGAZDFEMBCBhAAAQFGA.TGCAhAAAaBGAACHB..SDCHhCAA.YDGF...bEDDhCBA......hCDA...,1,-13,-47,34
GXZJFETRODKYIeASbcLVWCHaUBMPNdgQf,SAAALAAACAEAHAFBBADA..MAFAdBHAQCAAGBDBZDAAECHFhAAARCDBKEAD..eDDGhABAAAHAVEGBaEGEUGBA.hABAgFFGXFDA.TGDADIEA...hACA......hAEA...,1,5,-11,16
SDHFQaOUJLAPZTIfXRGNBcgEdVYMKCebW,ZAAATAAA..XADBRACFGAEABAFAEAGA.dAHA..MBIBeCABhABASCADHCDCaCCHODGDhACALDGBADIB.fEDAhAAA.gEAAKEEDbGCAFGGHQGEChACA..hAEA...,1,-5,-9,4
JfBKaCcFVSbeLXDdEPYNWIGMUTAHgRQOZ,HAAARAAAZADBBAFAaACAFAFA....SAGHeAHHLCCAdCCCECFBhAAAPDFD.NDIA.GDAAhABA.MAIBAECAQFBAhAAAfDHECHEAbFGDDEEBIFFAhADA......hCAA...,1,1,-24,25
cZCRJGXAefIQPHbOEDgWYFMaLNBdKUTVS,eAAAQAAAHADAEAGEDADA.....gCCBFAFDaAHBLBDBhAAAdCFATEGASBHHhBCAZFAACCHAJFDAACDBfDFAhCAAIHHAOHCEMEHBKFDA....hDAA......hDBA...,1,7,-28,35
CTBXNgQGEYMbZLOWHKDSFARdPefaVcUIJ,RAAAeAAA..aADAUAEACAGA.BAGA..XBDDQBCAEBHF.hAAAMAIBZCFFLCCDhABAHCGBSDEHADIBdEEAfFHAhAGAIGDATGFANIAB....hAAA......hABA...,1,-12,-27,15
XWCPZfVHAeIQEBObSUaFgGTKJLYRNdcMD,eAAAEAAABACAOADCUAEAFAGA..GBGAKCCALCEBRCCB.dCGAhAAAMEBBDCIB.CAHBZEFFHFAAhABAAEIB.QFGAhAFA.aGDDTFDA.NICB.cGFC..hCAA......hCBA...,1,-9,-21,12
KHMRWgOXQeIfbaAGYLFNcPBDEZCJdUSTV,GAAALAAAFADA..PAEAEAGAZBFEdBHAUDCA..TBDAhABAHDGBRFEBOCABeGAA.bCFDhACAAAAB....cGGDhACACCCDSEED.MEIB.XGGDhAIA.fHCBhCBA..,2,-13,0,13
EKLeGRHgNOZTACVdDbWYFPfQJXIMUaBcS,dAAADAAA.....bABDFACD.QAEA.XAGAhAEAMADAaAFESBBDhAHAEBEBeAHHHCFBOCEBADEBCEHAVCGBhBAAPFFBJFEBBGGAKHGA......hCAA......hDAA...,1,-12,-24,12
OTMebdULgHFIfGQXPYDKcaZAVBSRJWNEC,SAAARAAA..NADB.EADAOAHD..eAFAdBEALBGDhAAAHCCAfBHAhAAAGCCAQFEAhABAXCFDDDABaEHDACEABEEDCHDA.bDAD.FEHDIHHAhCAAKGFAZGAE.....hABA...,1,-3,-10,7
YERBcVTLSGdUFNgQeXIfAaZMCPHbOWKDJ,ZAAAMAAAHAEA.OAHDDAEAEAGARCAA.BBBA..TCFAGBDAdEADhABAFBHDQEDAhACAeBFBXDBCAAGAaEHBbFFDKEGAJFEBhBAA.....cGGASFHHhADA......hAEA...,1,-1,-18,17
HVMQZcdYBSgFbGAWIUaTPCfRKOJENDXeL,UAAAaAAA.CADA.RACFKAEC..EAFADAHBLBHBHBFB..MAIBZCBEdCFAhADABCECFEEHABBB...hBAATFAAOEEBXGFAhAFAeFGB..........hAIA......hBAA...,1,-26,-31,5
RgXAMDGdBWSeLFCPNcZfIYHKUbJEQVaTO,GAAAdAAASADAeADALAHBFAGA.CBFA...PBFDZCDAfEAEhAAAHCACKCHBbEAAhACAEECAaEFC..REEBAEAAMEIBhACABEGANHBB..IGGAYHCA...hADA......hAEA...,2,-9,-8,1
HANZbEJfBcKRCOWdgUSXYaIDQTPMeVFGL,ZAAAEAAABACARAEA..OAHDdAEAUAGA..XCAAaCCB.QCFDhABAMDDAFDGDHEBChAAAAACAJDDB.KFEA.CFHA.SEABhAEADGBB.eEGB.LHAAhAFANIDB.fFFEhAHA.WFHH.,1,-8,-22,14
VHDKQZYgCBaANMGSecFfXEOIdWPTRULbJ,GAAAeAAAFADDEADAdAFA..TAFARBGFLDDBJBHB.HFBBKCDAZDCAhAAACAHBAAAA.MDAB.SDGDhACAXFEDOHFEhBFAIFCA.UGGADCCB...YHAAhADAaGGAfDFE..hCAA...,1,4,-17,21
LEGWaFAHXINbZROJQDKCTSPceUMfVYgdB,HAAAXAAA..bADBRADA..QAGCCAFASAGHeCDBMAIBhAAAfCFE.gDAAhAAAdCADECFBaDCDAADAZDGBhABADDHBTEEAPFED.cGGA...hAIA......hCAA...,1,-6,-7,1
BScGCdNYRXbPfELDVHTeMIOaKWQZFAgJU,UAAASAAAGADAdADARAFA....XCFAbAED..EAGALDAAhADAHCGBeCCBMCIBhAFAaDBHQEFChAGAAAAABEEACFGDPGAADGHB.IHHA...hAIA......hBAA...,2,-18,-5,13
eQCTKWMZAHXSJNgUOLGIFdRDbPEcaYBVf,HAAASAAAJADAUAGAGACA.dAEBRCAADCEBEAHB....aBEDBCFDhAAAeCFHQDGAhACAKCHDZFGBAAAA...XFEAhBIAOEEH.FHGE........hCAA......hCDA...,2,-25,-14,11
FDRQeEPfdbHKTaLZJcXGBOSCUNMYVIAgW,FAAARAAAEADEdADA.HAFAKAFCLBHBZCCA..XCGAGCCASCFAhAAACDBDUEEB.MEFBhABAIFAAACCBDEGBeFCDhAIA..bFCDaGHBBEHD.....hCAA......hCEA...,2,-19,-14,5
DHCeBZcTROWMaNAKfdGUYVLbSJQFXgPEI,dAAAGAAAUADALADA.SAGHQAFAXCDAhAAAECBFHDDAeBHHZDGBRGDAMDCBhACAAAIBKHBAfEAEhAEA.bDFD.FGHDIHHABEED....hACA......hBAA...,2,-21,10,31
BACefaLGTMbHQIDcOFZUPRVKdSgWYJNXE,eAAAaAAAGACAMAEAHBCADAEA.FAHDZAFERCEA.dCGA..SDGAhAAA..gEBBhAHAYEBA.XEEChBAAAFFALFHBbFGDcGDDOGBA.....hABA......hBEA...,2,-11,-11,0
DYPKTVWEHZbgJeQacAdNFSUfOGBRCXILM,dAAASAAAOADARAGBCADA..LAFADBDB.KCCA..TCEAhACAECEEHCGBZEBA..bFFAeDABhAAA.aEEBAAIBFGCBGGABhABABCBAMFFB..PHEAgGGAhADA......hAGA...,2,-19,-6,13
VeETYSQFaLAfMZDXBUPNcCdgIWHbGROJK,ZAAABAAAUAEA..PACACAGA..dCAA..IAGAHCFCRDDBKCCDhABAEBCB...TFGAhACAQBED.aAHDhAAAAAIBMICAXDED.gEGB.hADAWHDA....hCAA...,1,-24,-42,18
OTURCcPVdfKNXYLZbgHQSeDGMFWBAEJIa,EAAAaAAA.UADARACF..CAEB...VAFAdAGAKCEA..XCBChAAAZDEEHECBeCHFMAIBBDEAhAIAABBB.ODFD.PEDBhBCAfEHA.LFFB..hBAA......hBGA...,1,-17,-26,9
XabeDMfdPWEACVLGgZQcJNKYITFHOBUSR,LAAAZAAAQAEAJAEA.KAGA..TBDAHCAABCED.RCGBaEAChABAeAHH.MCABdEEAEFHFhACAACCBGCFA.gFDAhABAcGED.IFHA.OHAChACA.SDDDhAHADIAA..,1,-8,-15,7
OSGZaNFeIUYTAJDRgEKBMQdCLVcWXbfHP,RAAAEAAAMADAdADALAFA..VAGBXCBCHBDBSCCDhAAAZCEBaCGD.eDFFIFGAhAAATEGAAAGADCIBBFBAhABAQGDACGGDbFCD.OFHD...hAIA......hBFA...,1,-6,-10,4
JKNbSPQHZLaFeIBOdcGADUXTVfMERCYWg,XAAATAAA..MACARADA..CAGB...gAEAKBHBSCDAhAAAHAGBaBDHeCFHOCCHhAAAGDAAAAIBDDFBfDCEhABAEDGBJFGFNDIAbDGD.ZGFA.....hCAA......hDAA...,1,-5,-10,5
CYdLfDTNXaAQFUKOZcGBgWMeHbSJPIEVR,QAAAKAAAZACBGAEABACA.MAEAHAGD.SCABJAHB.hAAAEDGBRBDAdDDDLEDBhAAATEBAaEBDADGB.OFFBhACA.gGAGeDHFbFFD.IGHACGBDDFFB.hBEA......hBGA...,2,-18,9,27
JPWVGSbLYCOEXZIdHQMNRfgTAKDeBFacU,eAAAaAAA.UAEA..PADAGBCALAHBOAGFZEBFHBBCMAIBhAAARBFFTEDA.AEHABFCDhBAAFDGHJEEBSFGAhBBACFHAEGGB.dHBB.fGFEDIEA..hBHA......hCAA...,2,-12,-8,4
IBUOPWGNVYgKLdCQSZfAcaDMXRTJeFHEb,aAAAMAAA.RACA.eACHHAFBEAEABAHA.OBBBGAGA.VCEBKCDAdDHAhAFAQEAAZEEBAEEBDGGAhAHATECA.bFGBIHHAhBAA..WGBANICB.....hCAA......hCIA...,1,3,-19,22
UCAWgHZRNfdLIKEXeMaVFJYPGbQOBTcDS,HAAARAAAdADALAFAEADEeAFE..MBGBaCCCFCFAJCAF..GCCA.hAAAQEFBTDEASCHHhABAACCB.ZFGBhAGAfCHEKGFD.XFDDPHAA.BGHAhAAA.DFCB.CHGDNIAB.hAHA...,1,11,-17,28
bHcKBMZSAJEGPDLRIQTYNWCdFeUOgaXfV,EAAAGAAALADARADAQAGC..TBGA..YCDFhAAACAHBeBCBOCEBhAAA.aDFDfCFEhACAHEAABDHAZDGBAAEADFHBIHHAWFHH.dEAD.FFEDhADA......hAEA...,1,-9,-12,3
dPSIHCLAUDOREegXWJNcFZVMBaGbKYfTQ,OAAAEAAA..eACAXADAJAFB.FAGAZAGBBBBDGCCA.KDABhAAATCDAdEFA.SBGDhAEACDHAABIBDFHB.REFANDCAMFIBhADA....bGEA......hBAA......hCAA...,2,-28,-22,6
CfcGLMZXDUgaVISNHPdFQJbORWKATBeEY,eAAAEAAA.CADA.GACAZAEB.DAEAUBGA..aAFESCCBhAAAHCEAdCHAQEBChAAAOECBREEAAAHA.TEFABEHB.fFHAhAIAMICA.XGCAgGGA.hBCA......hBEA...,2,-22,-7,15
VSgAGCEWTQZdFBNPfeDLcKXYHROIJabUM,EAAATAAAdADABAFA....fACBeAGHLBCDXAEBhAAAHDDBRAGBOCCBhAIAaBHDbFAB.MCGB.SDEBhBIAAEHAGGEBCFGBZECB.FEHB.DGGB...hAAA......hAFA...,2,-11,2,13
IFQfTbGYPSNLXEMVWdORDacgABJHKeCZU,HAAAeAAAZADBFADAQAGA..bAFAGCABSCCDhAAALCFBECFA.MDHBdDHAREEBhABAaECDAAGAKFCACEECUGGBfGHAhBDATGAA.........hAAA......hACA...,1,-4,-9,5
FRVfABZSGeUMPQgEaDJdCNLTXbHIYcWKO,ZAAAeAAAMACAQADA.EAFAaAEEdBHALAHB.bCCAHCCAhAAA.IEEAhABA.cDGCOCGHRGCAACGAhAIAGECAgFGGCEEDTFGA....hABA......hBHA...,2,-22,10,32
gdBEXKFeCAQHLPJRfWIDVcUTGOSYaZbNM,HAAALAAARADF..IAGADAEAUBEAGCEASAGHZCAAMAIBhAAAdCAABCCAKCGB.eBHHhABAAEIBQFAA.hACAfFHEcECATFFAaGCA...NEIA.hAIAEGFFCEEB.....hCCA...,1,6,-29,35
ZAMWbNGfJHPVDgYKIQBRcEaeLdSOTXUCF,MAAA..bAAAGACBHAEADAAAKAGCQCCCRCCAEBHF.eBHFhAFAdDGDTEAACCFA.AAGA.hAEAfEEAPEEBgGCDhAIABEHAaBBHLFCBXGFA.ZGEE.hCAA......hCBA...,2,-4,-3,1
MLRFdDATINEHfCPeBgQcYGVXSZbaWJKOU,TAAAEAAAHACA.CAFBBAHAQACC.GAEASCCAaAGAKBHDhAAAMCFARDDBdDGDADFAIDHAhAAAfEAA.eFGBhAEAgEAAVGBA.bEEBWFHBOHAA.FGGAhAEA.DIFA....hAHA...,1,17,-17,34
NEBcMSTWFLDaGHfZKAQbRPgXdCIVJUOeY,RAAAXAAAdADA..CAFA.JADAeAGH..EAGEMAIB..TCDAhAAALCCAGCFAHDFChAAAZDBFAEEBQFAAhABAbFGDICHAOFFB.BGHASFFDhABA.DEIBaHGC...hAIA...,1,-7,-16,9
RJWcOIGPKCBHQdSgfTbLZDAeMYNaFEVXU,eAAAMAAA...aADDEADAUAFARAFA..JBBBOAHFGCEA.CCGA.HDBAhAAA.dDFASCHHhAGATFGAZFBAACEBFDCD.hABAXGFAWHDA........hAIA......hBAA...,1,-10,-26,16
FQRJKSfYEVCLIMaZWXTcDbUBdOgHPAeGN,eAAAGAAAQADARADAKAGC..SBGAEAFALBHBMCDBZCCAhAAA.TEFADCFBbDGBdGCAhABAHEDBACHBFFHD.YEEFhAIACEADaFFD..........hCAA......hCBA...,1,-2,-13,11
QKCTPfJBeLdaNARSDVUWIbOgMYEXGHFcZ,RAAADAAAUADA..IADAOAFC...MAFAECCBHCECZBBAQBFAhBAACCHB.TDEAhBCAfEEA.eEHBhAAAaCHDADDBSFGDVFBAbFGB.YHAAhABA......hAHA...,2,-23,-13,10
LcWVdRUKSEGTHeObQJYXFBIDCZfNMaPgA,LAAAVAAA.RADFKAFCEADEHAFB.eAHBQBGA.XCAAhABABCDACDCDZDFAMCFBhACAaEECADDB.dFAAGEFAhAIAbFGDFHDAfEHE.gGDBhCAA......hCBA...,2,-15,-3,12
SVRIQcLaGZfJEADeOUgWMdTFCHKPXNYbB,eAAAOAAAUAEA..MAEAdAHACBCAHBBC.XAGA..hBAAbDDASBEBhBBAREBB.QCGChCAAaDHBZFDBEFHFADEBDEFB.TGDA.KGGA...hAAA......hABA...,2,-27,-8,19
MFJQRXeNGSaDbOIUBAgHZLYTPCEfKWdcV,HAAAZAAALADBTAEAEAGEKAFAdAHA..MCABQCAARCCA.hAAAeCFBGCFADDHBOEEBhABABCHAACCAgEAHhACA.CEEDfEHAcFAAFFHDXGCDhACAaGHDIHCA..hADA...,1,-6,-12,6
ZJeFgXGSfNaDLAPQMYKHCbVIEdWRTcUOB,MAAAHAAACADB..VADAEAFARBFA..UAGAZCAAeCCEFBBB.GDGAhAAASCDDaEEB.ADFA.QFAAhACAKDGA..hAFAdFEATGEABGGA........hAIA......hBIA...,2,-38,3,41
OCLMIQTaAbGFEJDgPZfRKVBNUHXceYdSW,GAAAEAAADADA.ZADARAEA.BAGBHBCBeAHH.dCDAOAHDLDFAMCBBhAAAQEABACGB.hAHAFFCDgDFAhBCAKFFA.UECBXGDDSEHHCFHBIHHAhAAAaGGC......hACA...,2,-10,-9,1
cfQIXWZeRJGELUVbMgPBTdHSAOaCYFDNK,aAAAFAAAKADA..QADA.XAFAeAFERBEAECCB.LDABhADAbCCC.MCIBhAIABCGDHDFBAAIBCDAADCIBfEDAhBAAZEEAGGAB.gGEBdGHAOHDAhCAA......hCBA...,1,-9,-10,1
MTEJWYFKgVSZOBeIUGAabcDXRHdfLPCQN,aAAADAAAHABCLADAQAEC.MAHBEAHBJBBF.FCFAKCCD.hAEASCFHZDCBeDHFGEEAhAFAAAIBXEDCfGHAhAIACDHATFGA.gGAA.BGFDhAGA.....hBAA...,2,-16,-9,7
PHEbITdMSAfeOGaZDcXWJNBVKFUCQYRLg,eAAAaAAAZACBDAEA....XAEAJAGBBBCAFAHBUDDA..QCEChAFARDGBLEBBHDGBhBAA.EEDBTGFAhAAAdGGDABBBfGEA......hCAA......hCCA...,2,-37,-13,24
TEaVbXPIMWGfJFLcYRKDOUCNgdQSAeHBZ,HAAAZAAAEADEaACA...XAEDMAFAGBEBFAGALCCBRCAADDEBCDFD.hABAdCHA.ADGAeEDHBDHATFFAhACAbFED..IGBAhAAAfHBBcGGAOFHD...hBGA......hCAA...,1,-6,-14,8
PMAfXeIVLNEOQTFYKZgGHbCUcJaRSdWDB,eAAALAAAEADA.TAEAKAFAGCCA.HCFAbAGB.CAHB..UEFBhAAAaCAARCFBdGGDBDCAACCB.XEAChABAIHCAODHDhACA.QEDA.FGGB...hABA......hCAA...,2,-16,2,18
fQYcLSNVGabeKCgXHREOFATMUJIdDWBPZ,MAAAUAAAdADABADAZAEB..QAFALAHB.SBBBhAFAGCFAeDBBCAHAHCEAEDDBABGATDCAhBAADEIB...fDHAhCAANHCB.bEFDKHGA.....hCBA......hCDA...,2,-20,-16,4
PWcEeFUVXDGbfNQBaCMgZTLYAIKdSORJH,dAAARAAAHADB..PADAEAFAeAHF.FCCHXAGAGCFA...hAAA.bDADQCBAhACABEEDaDHD.MCFB.ZCGFhAHAYFDFADDASECA.OEGH.hABAcGDADDABCGHA...hADA...,2,-16,1,17
LXQAZCMPgfFJRYdEODcSGUKaHWVNbTIBe,ZAAAMAAA....fADBRACAEAFEDAIBGCCBaAFA.HCGBVBFBhABATFCABCAAeCCBhACALFEBAAIB.CBBDFGGAdEEASCHHhCAAKHAA.bGFA.....hAHA......hBAA...,2,-12,-7,5
cWeHNaMBDEXLQKSdZfCRYGTgPFbIOUVJA,eAAAHAAAaACAMAEAEAFALBDA.QCGAdBHAZCCARDFFGECAhAAATDDA.FEHD.bFABOCCBhAAA.VFFAACEA.hAFAcFBCBHHA.KGED.CAHA......hAIA......hCAA...,1,2,-1,3
KMgLSCXWHYdRZEUQaOBNfTcVGDPAIFJbe,FAAAeAAAMADALAEA.CBCAHCDARAFAEBCAUCFBaAHD..BDGA.hAIATFAAGDDAAAAAJEFFhAFAbFGB...KEHBXGEDhBAAdFCA.OECHfHGFDCIB...hCAA......hCBA...,2,-14,-8,6
eWIJEHbKACaNVgMGBQOXYcZDLfTPURFdS,aAAAVAAAGACA.BAEAQADC.XAFBZAFBLBHBhAEATCEAREDAdFHA.eBBDhAIAIBHAEFCBKGEAADDBCDGAhAAA.MDIB.OEEB.DFGB.fHGFhAIA...hBAA...,2,-13,-12,1
RgKeEWAXMTUOdQSNDbFBaPcYIfHVGLZJC,MAAATAAAdAEA..QACCDAGABBBA.aAEA....PBGBhBAAIAHAHDBAGBEAhAAAZEFARFDBKGGAECGEADDB.OECBhCAASBDDbEFDFEHBfHBB.hCEA......hCIA...,2,-20,-6,14
KJDOFcfBSXCadHZUAYMbTNQGILPRgeVEW,MAAATAAAGACB.LAGBRACFeAEEEBEFKBBDOCDBFBHD.BCFChAFACCADHCFBAAIB.bFDBQEEAhBAA.gGFAhCAAVFGBDHAA.SCHH..hDAA......hDCA...,2,-19,-3,16
AfdOZRKaEWBPVIbXJYFTQDcHUNeLCgGMS,dAAARAAAEADEBADA...VAFAXAFB.FAHDTCBADCCAHCDChAAAeCFBLDHBGECAACIBhACAZEEEKDADaGED.IHHAhABAbEED..QFAA.cGGAhADA.....hCAA...,1,-7,-14,7
MKEFUafNOCJcLAIBGPVTYdeRWSDHZXgQb,GAAATAAA.eADARACF.DAHBHAEBZCDAQEABMAHBECAB.aBHDOCHDhAAA.CDEDLEAAhACAAAABBEEAVEGBdFFAXGAAhAEAbECD.FGDBNIAB.IHHA..hAGA......hAIA...,2,-4,4,8
PgfXJGSOUAEHCMKdNWRQabZLeVcYBTDFI,HAAAMAAAdAEARADFQAFCZAFBLBBBeAHH.VDAABAHA.TDDAhBAAFDFB..IEHAhAAA.fFGEhACAGCGAOFFBEHAANEEAaGHD......hADA......hAHA...,1,8,-25,33
GceZCAKLPIRJQXgFTDMdfaBEHbVYUNSOW,LAAARAAAQADCFAEAMAHBdAFABAHA.HCFCVBDBUEDA.OCCBhAAAGCAA.eCFHhABAAEIBKFFCIEHA.hABAXFGCDGHBEHAANICB.......hACA......hAIA...,2,-22,-8,14
HFGPWOQYLADVIETJcfadCUMSBRKeNZXgb,DAAAEAAA...TACAJACB..aAEAdAEAUBFBMAGB.RCGF.KDDAeBBBhAHAZEBA....XDGAhAAAHDDBFFGHGGDBhAHAOHBA...........hAIA......hBEA...,1,-18,-28,10
NfdMRScgVEHZBTOXQDGbFCUKJaWAIPeYL,eAAALAAAdAEARAGBSADH..gBCFHAFAZCAATCEAhABAQDEAGCGAhACAbEGB.CEEDKFAA.aFGHAAAAIGAAhAGAPHAANIDB.MEDB.....hAFA......hAHA...,2,-14,0,14
GXTEcVBAPNZLFabKJRdCSYIQeUMDgfOHW,ZAAAaAAA.KADCRACF.dAGA..SAEBQBEAeAGBDAIB..OCABhABAHCDBGDFA.hACAEFDBBCCDAAHAPFHDhBAALDEAFGCHCHEAIFFAMBBBWBHH...hCBA......hDIA...,2,-36,10,46
ecHSRNfLbZOBdXQUaMIPTgJFVYKWEGDAC,eAAAHAAARADFLAEAZAFBdBHAUCABaAHD..MBDB..TEEAhAAAFCEAKDGAEEGEAAAA..SEDAhAFAbFAA.XFGAhAGAQGGA..gGFGYHCGDFAAhACANCCA.BDDD..hADA...,2,-14,0,14
HRQXEWIKSYeVGfTgJdDUMOAFCBZLcPNab,BAAAZAAALADB..PACAaAFAHBFARAFA.ECAAKBCD.eCEBhAAAGDEA.TDGAhABAdCHAMDDBAAIBCFBA..cGGAhACAbEFDQGAA.XGDD.hBFASHGA.hCAA...,2,-15,-8,7
NEGMIVWZgdcLFfDJXObHAQUTeSRBCaPYK,TAAARAAACADB...aACAKAFA.EBHFGAEA.MAHBVCCAZCCFdCFAhAAALDBB.DAIBhAAAODHDHEGBAAGBeFAAhABABFFC.YGDAIFFA...WHAAhAFA.FGHH...fHEBhAHA,1,-12,-20,8
DJPaLBVQNTXcdCSYMUfEHKgbIFWOGRZeA,DAAAaAAALADAQACA....TBGAdAFASAHBhBAAMBBBECCAHCEBbBGD.FDHDGDDAhBBAREAAAAEABAHBXEBBhBEACFGDUGDAKFGA.gGFGIHHA.OFBHhBFA.....hBAA...,1,1,-6,7
HfSBWcaOGEeTgZQNJdAMbPXYLIUKRCDVF,MAAAXAAALAEAKADA.RBBA.DAFAHCEABAHAaAHDGBEB.ECDBhAAAeDDB.ZFAAQDAAhABAdEHAABBAbFFBIHHAhAFACDFDfDHA.SFFB.OFHDhADA....hCAA...,1,5,-27,32
PeIEAfWXQDHFadMBRCZNGgLYScVTKUJOb,XAAAHAAAdADARAFAZACBGCABLAFA..SCFATCEAKCGChAAAOCHDeDHFAAGAQEEAhAAAaEBABEEDCGEAgFAAhACA.cGFDUGGB...bFCD.hABA......hBEA...,2,-14,7,21
TKcfCSAQWPdZLEaVNOgBGXRbFeHIJDMYU,QAAAdAAAEADA.aACEOAFC.GCABRAEFeAGHHCFADAIBMCDBhAAATECAKDAA.CDGAADIBZEEFhACA.LEHB.hADANHAB.XEDD.bFFB.FFHD.IGAAhAGA....hCAA...,2,-15,-1,14
EbNfAOVQBYFGJMPRXdUgIaKeCHcZWTDLS,QAAAFAAAGACAMAEARACAdAFA..UDAAaAGE.KAHBHBEB.ZCGBTCGAhAAALEBA.EFFBhBAAbDDBADIBBFHA.PGCChBEAXFED.eECHCHHA.DEIB.fGGBhADA.OHAChAHA..,1,1,-7,8
aOXJSbBeCEMLgUNRTdcVAFYKfDZQGPHIW,KAAAZAAAGAEAHACBaAEAOAGF..SAGHeCABECCBMAIBhABALBEB.UDGARDFFdFHAhACAAAIBFCABDEABQGAAhADA.PEDDXEDCBHGDCGEATGGAhAAA.....hAEA...,2,-17,4,21
CUZLbeBgaRQDAGcYKEVPXfHOMNSdIJWTF,GAAAKAAAEACE...XADAHAEBMAHBdAGAJCDBFCCBZDEA.eEABhAAAaBHDREFAAAGB...VFDBhAAAOEHD.SFFBhAEAIGBACEADUGDABGHADAIB.....hACA......hADA...,2,-20,-3,17
NCDeEHFaJXMAWfPgQObRZTYBdGIKVcLUS,...fAAAQAAARADAZAGBTACAdCBAGDCAKAECLAHBhAAASCHHDBGBHCDBaDABMEGBhAAAABHBgEGAhCAA.bFCABEEB.IFHA.cGAAhACACGHA.....hCFA...,2,-11,-6,5
PLeIUBXDZcGQfSAOdaREHNFWVTYJbgCMK,aAAAHAAA.FADA..TADAJAGB..CCADKCCAeAFE.BBBDZCEFGEGAhAAAQBFD.ACDBRDAAhADAEGAAVDFB.bEDDMAIBhACA.LHDA.IGEADCIBSGHBhAIA...hAGA...,1,-5,-19,14
YFfBdVabLcMHgeCGQRUJEOATZDSIKPNXW,ZAAASAAAKADC..XAFAFADAdAGAaBCDLCAB.HCCChABAeBHHGCFARCEBEECAAAAATFCAhACADEIB..IFGAhAIAPEHD..YFFFBGBAbGDCMAIBCHHA.hBGAQGAC.hCAA...,1,10,-20,30
eURAFcMQVPSBYJXgOTHfbGCKIZLEadWND,MAAAQAAA.SACABADAXAEDOAEDHAGDGAGAhAAAKBBAZDDAECDBdDAADCIBREGFAAGBFDFDhADAVFDBJEHB..TGAAhAGA..........hAIA......hBAA...,2,-15,-10,5
MXCHQYDPbgNEKOTWIRVJcGSABZedfFLaU,eAAAdAAALADAMAEAHBCAQBGADAIB....bBFBECBATEBAhAAARCEBVEAAGDEAhABAAAEAZEGBFGDAaCHHCGGA..PHAAhACANIDB..........hAHA......hAIA...,1,4,-8,12
bVBXeTNWSCfLMOdgIPaUDEZHRGYJQFcKA,BAAAeAAA...TACASADALAEBdAGA..ICCAhAAAaAGAEBGBHCAARCEBGDGAQDFDhAAAKEAAAAIB.bECBXECBhABACFGDMCIBOHBCgGBBDGIB...hACA......hBHA...,1,-5,-10,5
UJeDNFTWAHXKEaCQcLfMIVOPgbGYZBSdR,HAAAEAAA.aACAQACALAFA.MAFAOCCA..bBEBZCFBdBHAhAAAREGFeDDBFCCHACGACDGDfGAAhAAAVEDB.PHDAhAGAgGFABCHA........hCAA......hCBA...,1,3,-10,13
aUHMNdKScOGZCTFWbBPEVYQXIRfgJeLAD,aAAAHAAA.dADAKADAOAFAZAFB.FBFBBAHA.EBBBQCABhAAA.RCGBJDDBACEAMCHBSEGDhACAGDAATDCAhADA..bFEDPEFB...YEHBhAFAfGHA..hBIA...,2,-22,-16,6
gGUFeVJXfIKERbQWdPCcZNYHLSADMBTOa,MAAATAAA..aACEGACA.eAEAXAEDKAHBRCEA..QEAAhAAAdAGBCBBDZCDAHDGBhBAAAAEAODHDFEEBJHBAEEEBbFCDhACA....cGGCLEGD.SHGAhCAA...hBHA...,2,-25,18,43
BUaWEgKcAGeJYDQLCFTNVISfdHXPMZObR,eAAADAAALADAFADD..TAFAVBBB...SAHBhAAAHAGBMCFBZCCAREABBDGDaCGDEEEBhABAKECAADIBGFABQFGAhAEACFHAIHFAfGFE.....hAFA......hCAA...,2,-11,-10,1
SGXQfVPeDCRBbTUcgIYZHNJEWdaKOLMFA,GAAAQAAA..fADAeACARAFATCDAUAFA..gCEGhAAAZCGBHDAAEDFFaBHDLEEAhACAADIBXFCADDABhADAbGACIFBAJFHB.dGGA.MDDB.SHBAhAIA..hBAA...,2,-8,14,22
OTHJAMCUYaLBVXDGcWRbgfNKdQePFSEZI,MAAACAAAUACALAEA.BBBADAFAGBEARCDA....bCGBhAFAfAHAdDBA.hAGAeCBBSECHhAIAZDGBTGBAHEFB.ADIBaFEBXGECWFHHNIBBKDDD.hBAA......hBBA...,1,-13,-24,11
fWICbQUDcFOVAJKSdEGXNZPMBaYLeHTRg,SAAAEAAAGACAZAEAMADABAHB.LCFAHAFCRBCA..fCFAhAAACCBDQEDADCIBODBBhABAAAFAdEHA.XDGDhAIAaFFDeHFATEDAgGCBbGEA...hBDA......hCAA...,2,-9,-3,6
QDPKBYJCfbgAENXeGLOFdVacSRZMTUWIH,EAAAeAAAGACALAEAdAEB.aAHDRAGFZDFA.UFBAHBCA.QCFDhAAAKCBDBEED.CEDAbFABACIB.hAAAODHDFFGB.SEGDhABAMIAA.IHHADGDA.YFFFhAFA.....hAIA...,2,-19,12,31
KSGgEDWMVBQCRcJLadeTYFPONHAUbXZfI,XAAAZAAAKADCGAFADADA...MAIBQAFARCAALDEBeBCHhAAAFDHHOAHFHECDAAHBbBDDhABA..SFBDhABAECFBBDHDCFFAaGFDdFHA........hCAA......hCBA...,2,-17,-3,14
BNdePaCIDKfRcASbFULVEZXTYgHMOQWGJ,FAAALAAAEADA.ZADB..TAFAHAFAMCAAQCCAGCEABAHBhADAeCHBaCFCDEHBREDAACHAbGDAhABAUGGA..YHAAhACA..........hAHA......hAIA...,2,-21,-6,15
cZRPFXYAMHDUCQVWEeSBafGONKgTdILbJ,HAAACAAA.QADCEACAeAEABAHAGAFAKCAAdBHA.bCACZCCBRDEBFEDHhAAAACGA.DEHBUDGA..hAAASFAAaCED.hACAOFHDTFAALHAAPFFB.MIEAfHGFhAFA...hACA...,1,14,-22,36
FPgKXINebScRfJDaMBUGCZTVOdALWYHEQ,LAAAHAAAEADEQAFCFAEAKAHB.XCAAeBDF..bCABRCFADAIBhAAA.aDCDMCFBGEDAhACAZCGFOEDDAFFA.hAHAPFGBgGGASGEH.fHABhABABFHC...hCAA...,2,-11,1,12
EUMHLTFNIZdYQGKbaAWVeCgSfXOPcJDRB,eAAASAAAOADC..JADARAGFBCCA.ECEBHAGB.TBCAhAAAFDGHZFAAdDEAQGGAhAAAbDFDAAIB.CEED.XFCChABADCIBMIAALEHB.IGAAhAGA.KHFA....hCAA...,2,-15,-12,3
HcbNDdQGSPJfKgEMWLVUXBOAIeYRaCFTZ,eAAARAAAFADAHAFB..bADAdBHAGBGA.SAHBfCCAhAAAECCAMDEBLDEBhAAAXDFCAAEAaEHDZFGBDFCAPECDhABAKGFA...WHAG.BGFA..hAHA......hAIA...,1,-5,-11,6
bgBWTRCXeMDQJPOYUVHAFSEIZNKLGcdaf,EAAAZAAALADBdADA.aAFA..bAEDBBFARAGB.eAHHMBCBQCAAhABAODBHUEEAHDEAhACAAAIBFDHDSDHHhBFA.KFGDGGABfGDAgGFACHHA.hCAADDDB.....hDCA...,1,-1,-8,7
VNBKQeLXUSWPRECDfJcadOYHgGbFMZITA,BAAAeAAALAEASACARBCBDAIB..fAFAaCEA.dAHAhAAAHCGBGCAAbEEDZFAAhAAAAACAKCCAQGGChABAXCFDPECCCFDB.ODHD.FFGH.MFABhAFA.IHBAhBHA...,2,-16,3,19
EHLSRWBVQDKdGAXTMabFINYOcCgePZfUJ,MAAAaAAA.FADD..IADAOAFA.CAFA.eBBBZAGB...UBGBhBAAHCCARDDABDHDQECBhAFAdFBAADDA.bEGB.cFEBhBAAfFFA.EGHBSGCDDIFA.hBCAKBBD.....hBFA...,2,-23,-6,17
ABVPLTWDJgcKeRUaOMHSZdIXEQfYGFbCN,BAAALAAADACA.JAEAKAEA..RBCA.OAGDHCABdAHA..EBCBQCFDhABAGCDACCFD.ACABTEDAhACA..gDBDhAAAeDHHaFGHSGEHZFFAfDHAhAGA......hAIA...,2,-40,-1,39
eLYXCRcHAJBZgMGWPVbUFQEdIONTSaDfK,ZAAAGAAA..PADAbADA..FAHBEAGAdCDA..OBHDSCFDhAAAaCAA.KCHBeCEAhABALFAACDDDHEFAAADABEGAhACAMECB.UGGAIGHATGDAfFEEhACA.....hAFA...,1,-5,-11,6
TNSRUVJMFgcLKdIQfPbWDeCEBOZHaXGYA,TAAARAAAUADA...MACAFAFELCGB.dDDAQAFAhAAA.bBDDeEHHECCFZCFAhAIAHFDCGEFAAAAASCCDhAIAJHBA.........hBDA......hBHA...,1,-8,-25,17
cdRNTHMXeWYAbVDGUPQfILaZKSBOgFJCE,DAAAGAAAQACALADAZAEBBAHA.FCDAEAGARCFFHEACeBBBABIBUFFBhAAA..ICGAhBAAaCHDOHAACDDDdEFAMEEBhACAXEBC.bEGD.......hAEA......hAFA...,2,-12,-7,5
IJURaFGbgCQYcfZPELeVTWSDMKAXdBNOH,dAAAOAAAHADAUAEARAGFGCAB..CAGAQBBB..hAIAfCFEEBHFLDDAhBAAeCHHTEBADEEBAAFABFFAhACAIEHAaFHD.bFDA......hBEA......hCAA...,1,-17,-22,5
eKZFVbcBATYUPHCOGWfdSgJRDNIXaLMQE,TAAAUAAAHADA.GAGAdACASAEARCBADCFB...XAGDhAAAaDAHMDGBECDAeDHHhADAZDEBbDGDAAIB..CEEDOFAEhAFAfEAA.NIABIHHAKGHB.cFADhAEA....hAFA...,2,-17,-5,12
aRSQFeNWbCcMIdgKfJDBLEZPXAUYVGTHO,VAAAHAAARADF.QAFCeADE...bCACMAHB.dCDAfBHAhAAABCFAEDHFZEBAAAHAGDEAhACAaFEDFGAACDGDgGGAhADADAIB..XGFD...hCCA......hDIA...,2,-17,-2,15
HcBDeMZUbKVRLOINWXfaJCgSQYATEPdFG,EAAAdAAAHADADADA.eAFEZADEKAHBRCAALCFA.ODCEICBAhAAA..XEFAhACAaCEACCHD.QGCAhADAADDAFDEDGEGAMFIB.VGEAfGEA.SHAAhAHA..hBCA...,2,-35,13,48
gFOJMRNYGTdIDAbZfKQWVHSXEBUCLcaPe,ZAAAQAAAHAEAEBHFCACALAEA..aCAAeAHHOCEBRCDAGECAhAAAdDAAAAGAKDFASEFAhAFABEHAUGCAPFHDhAGAFFFB.MIEA.........hABA......hACA...,2,-19,2,21
ICKbBVagZDScGOHfMedWFXPNRLQJYTEUA,KAAABAAA.aACAZACB.SAEAGAEAHAGD.eBCBdAHAXCABhAAARDBBLEEA.QGAChAAATCEAADHACECAbGDADEEBhACA...OEHBMCIB.FFAB.JFFB.EGCBhAFAIHHA..hAGA...,2,-12,-4,8
DSgQVCYRINJEbPadfHLTUeOZKWMcBAXFG,GAAASAAAQADACADA.RAFAJCDFEAFA..aAHDHCFC.TFEAhAAAeCCAZDAAKEHBMDABhACAAAAADCGBVEEB.IDHAhADAbGAAdHGB.LFAB.OHFChAFA......hBHA...,1,12,-16,28
KfRLWaIFOAMdVEeZTcPSbDHgNYGBCQJXU,dAAAEAAAZACB..TADASAEAHAFB....gCAAhACAGAGAQCEChAAAXDCAfAHEhADAREFBaCBBODHDADFBeDGFbFAADFAABEHACHHA.KFAA.IGHAhAFAMIAA....hAIA...,2,-12,6,18
VJINaFXWLebKECRAUMQPTDgOdfHSYcBZG,MAAATAAADAEA..dACAHAFC..SAEABBBAGBDAIAHAhAAAaCFDFCHDLCEAhAEAeDBBEFFAACFAQEEAhAFA.OCHDfFHAZGFENDDA.bFCD.hCAA......hDAA...,2,-13,-12,1
abgGRBWOATcQYFdVECeISHLXNPDMJKUfZ,TAAAQAAA.dADAEACEeAFAHAEBLCFAXAGADDBAMCCBhAAAKDEDZEGBaCGD.GFABhAAARDDBODHDAAFAFFFBCEAASFGDhAEAPHCC.fGAA.BGDDhAGA......hAHA...,2,-3,-2,1
RDKeOBcYFdMNafEXIHPTbJAVWCLUZGQSg,CAAAZAAAGACAQAEARAEA.eAHBBAHBFCAAdCAA..aCECECFAHCGBhABA..TDGAAADALEEBhACASEAAKGBAODDHhAIAMEEB.XGFDbFAAVFFB....hAAA......hACA...,2,-16,6,22
SUdTDaYJeRIHCAWNLZVOFPcbXKfEgBMGQ,LAAAZAAAFADA...bADDKAGA.ECAAMAFAGCDAUBGA.dCAAaCFAhABAeCCDHDFB.ACIB.VEEAhABAOEHD.XGAAhACABBFDSEHB.DGHBYFDFhAGA.....hACA...,2,-16,-6,10
BGYdJNcRfEUQZPTXbWSFOgVIaALKCeMHD,LAAAeAAAHADAGADAdAGAJCCBRAFAUCAA.ZCFETDFA.XEDDhAAAbEFA.FEHDODDHhABA..gFABhABAaFAAAEGAMHCABGGDNIAB.EHDAQGGChACAWAHH.IGAAhAFA...,2,-1,-1,0
eNHYEPfFOWRKABIgQXGSDZdTcMUbLVCJa,BAAAQAAAGACAZACBdAEBMAFALAHBCBEA.eBEHHBFBEBGFFBHFhAAARCAB.ADEB...XEFAhAAATEBAUEFB.hACA.bGECaFHD.NIEB........hBCA......hCAA...,2,-13,-6,7
KMTdPcLRJDOVXeNZgYSGACaHWfEIFbBUQ,HAAAEAAAFACDBADB.QAFAMAEA.dBHALBEARCAADCEBOCFBhAAAeBHHZDDA.SEHHhAAAAEGAaEGE.fFBAhAIAbFAAKGGA.TFDA.PHFA.hACA......hAFA...,2,-17,-10,7
EfVMScAdKQINJgFYZWCDGRHTBLbaeUXPO,dAAAQAAAJADA.FACEZAGBDAFAHCAC.LCFDeAHFUCDAOCHDhACAEDFE...MDEBhAGAABFAKEHB...gFFBhAAACECARFGBTGEAaGCA.......hBAA......hBCA...,1,-15,-23,8
EIFZPRDaXNMfBTdGAVJSUeHYLCbgWOcKQ,SAAAHAAALADBCADA...bAFAOAEDQCABEAGAZCCFRCEFaCGDhAAAMBIBBEHA.GFABhACAAAAAUDAAeFGBgDGDhADAKHAA.FFEDDAFAfGAA.hCDAdGCA.....hCGA...,2,-10,12,22
WYLfdXOGUaQHFRAPNecMZgVEDTbSKJCBI,eAAAZAAAEADEDAEA..SAFBCAGABBCA.....IAHAhABALBEBdCAAGCGAhAAAaCCCHCEBAAIBPECBMCHBTECAhACAKFFB.YEHBOFHDQGDDhABARGDA....hCAA...,2,-29,5,34
UADXIHMQKfFWdZgOJLaBceSVbTRCYPNGE,XAAAHAAAMACAKADAFAFD.ZAGB..OAFAaBDDBCCCeBFF.SBHHhAAATDEAREGB.CCDA.hABA...PDABhADANBIA.EDCBAGGB.QEEB.dEHA.LGDAhCAA...hAAA...,1,4,-25,29
WEbYKOZSdIQcJeBTMgHVPGRUFNfCXaLDA,EAAAKAAAZACBdADA..QAFAeAEABAHAMAIBHCAB.GCFARCBBFDDA.hAAACCHALDEDABCA.hAFA.bDFDSECHhAAA.IFHATFCAPHDCfFAEhACAaGHD.DHCA.WHCA.hBHA...,2,-14,-6,8
abZdNIVOFXeHSCcKDUYTWJgfPLEQABGMR,GAAARAAAZADBdAGA..IADAFCFHHDAACAFA.DAIBUCDA...TBGAhAAAJDHB...fDFBhACAEEEBAAAABCCCbEFAhAFAOFBC.eHDAKGGAYHAA.hADA......hBFA...,1,-12,-23,11
OJNXfcQYdTFKEIaBeHWRbZUGACPMLVSDg,MAAALAAADAEA.OADD..XAFAQAFAdBBATCEAhAIAECAAaBHD.HDBC.RDGBZFFFhBAAACFBCDDDSDFHhABAJGCA.fEHA.FFAABHHBeFEBhACA.UGGB.PHBAhAFANIBB..,2,-15,5,20
CZHDAPNLfJRUaMTWObIFESYdcgVeBQXGK,LAAARAAAMADA.TAEAOAFE..FAGAEBDFdCAA...VCCAhABAeCCDBCGAGCFAZDFEHEAChACAAAAAfCHEhAIAaFGAIGGASEDHgGCAKFHBDFCB.PHFChCAA....hCFA...,1,3,-16,19
RGLaTZFbHBQIYUPSMCJeEDXdcAfVNWKgO,VAAAKAAARACFGAEA.LAGBZADBHAFABCAAQCFB.hAAAIDAAPDHDMDEBhACAeCHHEDCBdEAAAAIBfEEAhAAA.gFGAaFFBTGBAFHAA.hAEA......hBGA...,1,5,-18,23
OEMZfIUJHRSYDaQeBNAVKLXPCgbGdWFcT,LAAACAAAGACAdAEBFAEAOAGDZAGB.UCAAHCAB.REDADBIB..hAAAeCDBAACBKEHBXDFChABA..bFBDTFCAhACAEGEA.MAIB.fEHASGHDaFGHhBEA......hCEA...,2,-22,-10,12
OHEYdGDVRcbIFZQBaCUWPgTSXfLAMKeJN,eAAAOAAAHADAdAEAGAGARAGF..bCCAZBCBBDGDaBBH..CDFA.PEEBhAAA..TEDAhAGAfFAAAAIBKEHBEFGBhBAADCIBIFHAFGBA.QGFD.hBGA......hCAA...,1,-3,-18,15
THUGVYCNEgAaMRZPQdJbFSecOLWKfBXID,RAAAZAAAdADAFADA..eAFALAGBKBHB.BBFADCCBHCFBGCAACDDA.ECCBhABA..AAAA.MAIBQFAAhAFASDFDOEHDhAGAXECAUFDA.VFGB.....hCAA......hCFA...,2,-19,-11,8
IPLAcgaQNdSWbTMHfJOeZRYEUKDBXVCFG,aAAAdAAASADA..bACDHAFBOAEARCAAEAHBDAIBBCEDCBBDGBGAhBAALDHB.AEABQEEAhACATBEAMEBAhBEAeHEAZEFFKFHB........hCAA......hDAA...,2,-16,-6,10
UYNTZDWFeVXMEOBcKdgQASaIPbHCfJLGR,aAAA..bAAAHACBCAEA.LAEARAFF.UCFATCAAZEDAFEHDeAHHhAAAMAIBECEB.BFAAdEADADDBhABASBBD.hACAfHDBGEEBDGHBXGAAKHAAIHEAhAEA.....hAFA...,2,-16,1,17
TdGALHeFafSBbWVYJgNEcICQOUDZKMRXP,HAAAeAAAFADDaACABAFA..VAFAJAHB.ECCBCCCA...UDFAZCEBRECBhAAA..TFAAACEBLEHBhAFASCHH.hAHAbEDDgGEA..IGGAhAAA.DFIB.MIAA.hCAA...,2,-24,-6,18
ZbBPVHgCcTJEfeONQUGFLXdMDAWIaKRYS,aAAARAAAZADBBADAHAFA.CCCC...TAFAECFB.eAHHQDAChAAAGCCALDABdCHAAAHAKEEASFGAhABAbEFA.hADA.gFEGfHDBOFCHFHFA.MIDAhAFA.IHAAhAHA...,2,-10,-1,9
FOTUcYVHKQedaPLJRMfIEBGNSAWbgXDCZ,...bAAADAAA.ZABEOAEATAFA.UCCAVBEB.HCAAKBHBdDAAhADAaAHDLDHB.hAFAREBAMEGBECFBGDGAhAHAAAAA.XEDAFHBAYHEA....hACA......hBEA...,2,-20,0,20
PLQeZADFOJcSRfNBHWgCTKIXGYMVUadbE,OAAASAAARADABAGBHACB.CAEA.KBBDGAFA.MAIBaAHDECDBhAEALDEB.eDGHhAAAACFAFDFAfEAAhABA.WEHHTFEAIHAAYDHB..hBAA......hCAA...,2,-40,0,40
KPLQRMGeaEUDAcIdCFBNHSYWZVbfOTJgX,dAAABAAAHADASACAZABB..bAGBTAFA..XCEAhAFALAHBRDCBeCHHECAAAACACCDAhAAAFFED.NIBB.VDEAfGGAhBAAODCBKEHB.MFABaFCH.DGGB.IHCAhAFA...hBIA...,1,2,-11,13
PWNXdYbKgFEAZRaMJcDeTHQUSOCBGILfV,RAAAaAAAMADA..DADAHAFCQAFAOBDCGDDALBBAVDGBhAAA..PCED.hABAXCGAdGGDKCCD.EDBAhAIAACIB.ZEFB.eHBASGDDBHGA...hBAA......hBDA...,1,-6,-14,8
TDIMcPJLSYRGVKbENeXAUHCFZaQBfgOdW,HAAAZAAAaACAQADC.BAFBOAEDdAHATCEAMAGBJAHBLDHBhAAARDDB.GGCBhACAbDFA.ECCB.eEEAhBHAACCBFFGBWHFADGIBIHAA....hABA......hAHA...,1,13,-28,41
WKTSeUaBHGLDJcOICZfFgQAYXdRMNPbVE,dAAARAAAMADA..bABDEAGA..KADA..eBDFaAFA.HBEBGBEBhADALCGBDDEB.OEEBhAAAZDFAFFFAABIBXFGAhABA.NCCA.PHDA......hAIA......hBAA...,2,-24,-4,20
RSXVLgZcDANFUITfEKJYdOaWMPbBQeGHC,FAAATAAAEADA..KAFAdACA.OAEA.MAIBbBFA..BCCAeBDHhAAAHDAARCEF..XCGDhBFALDFBZFGBAAHAIEEAhADAfGCAaDHH.......hBHA......hCAA...,2,-24,-15,9
XQFGBaAHSMUNTOZdWLJDegEYcVRKIbfPC,HAAAMAAAUAEATAEAZAGBdAGA.LCAADBBA.ECEB..VCCBhBAARDFFbEAA..CDHAQEFChBEABCHAAAIBOEEHeFDFhBGAYFHBKFHB.IHFA...hBIA......hCAA...,1,11,-27,38
LJHgRZcQaAVIGTNPSbdYXfCBeDFOKEWUM,GAAATAAA.SADAdACA..fAEAeAFHOAHBEAGAMBIBhAAAHCDBRDFF.ZEAAaCDEhAEAAAABIFHA.hAGANIAB.bCFDCDCCBHHAKFEDLHCA.gGGAhCAA...hACA...,2,-5,-2,3
XYCLGJbIVFeBaORAMgdKfPTHESQWUDNcZ,dAAAKAAA...TADAHACBEAEAQAFCDAHBZCAF.CAHBGCAB.hAAAJCGBbCED.FCGHeDEFhACAaDHD.ACIBMEIB.fFFEhADASEADWFHDcGBB.XGGAhACA....hAEA...,1,-3,-25,22
FaHQSEVUKcNfdgCIYDXTPOBZWLJReGAbM,MAAAHAAAEADEKADA.....fAFBdAFACAHADBBB.TCCABCCAZCEAhAHALAHB.RCEFACABhAAAaCHFQEGAhACAUEEA.gECGXGFA.OGEC.eHCGhCCA.....hBAA...,2,-44,24,68
fZLKSIPNYeVFaXGDWCTQdOEBAcMbUgRHJ,MAAAUAAAHADAZABELAFASAFE..ICCA..hAGAPBHDeCEAaCHDGCBBhADACECAdEEAEDFFBFHAACFAbEGDhAIARGEAKHAA..YEEF....hBAA......hBCA...,2,-15,-15,0
FgNbWZSCEVYATJUPLadRXKMOIQGHecDBf,TAAAUAAALADA.RAGF.MACA.QAFAHCBCeCEHBAHAhAAAFDGH.bBDDZEAAECCFACIBaEHDhAEAdDFAOCHD.hAFAGFCBfFFEWFHDCHDD.....hAIA......hBAA...,1,2,-13,15
TWRYFVIJeUbaNCMAdOfLXKHBDgEZQPGcS,dAAALAAAHADADAFAEAEAZAGBGBGA.SCAARCAAFCEB.JCEBeCHHhABA.aEACMDDBABGBOEFBhACAKFFAQGCBhACA..TGGAYFHB....hADA......hAIA...,2,-16,-13,3
BcZTQGWCSVFYEbXedOHNIRLDPAKMfUagJ,MAAAaAAABADAZABEGAEA..SAEHFAGAECCB.eAGBHCGBhBAARCCBLDABACIBKEDAUFGBhBGAgDGA.hCAATFDAQGDACAHBYFHB...hCDA......hDAA...,1,-8,-14,6
NdJGBgDTSefIAOKZFHcRMaCPEYUXbWLQV,ZAAAHAAARAEA.aACAEBHFUAFA....bCABLBHB.QCCAhAAAdCEDGEEADDFAeDHFhABAAEFAFFBAMDABCFFAPFHBhAIAYHAA.........hBFA......hCAA...,1,-7,-18,11
EKObTdXQPfcLVDYgAWeHZNJRFSBUMIaCG,HAAAZAAARAEABAHBMACAaAEEGCAA..EAHBOCCEdCCA..QCFAhAAA.fEDAhAIALCGBDACAADHAeEHFhCAAFEEBSEHHCFEAKGFB.bGDA...hCEA......hCFA...,1,-8,-23,15
OYAWIUKVXBSgNJMCEGeTQPcHfFDdbLRaZ,UAAAXAAABADA..SADAJAFA.EAGAeBEF.QCFAhADAHCDADBIBbCGDRDCBZFEBhAIAAAAAKDAA...gFCAhADAMCIBTGGAfFFE.dGAAhAEA.aHGE....hAGA...,2,-23,-12,11
PHLUKSMCfEbOgcJGFYZQWRDdXaIeTBNVA,HAAALAAASACEMAEA.EAFAOAHDJAHBGCCAZBCERCABdBGCaCFB.hAAAeDDBBDHA.ACCBKEFAhAFAbDFC.FFHD..QFGAhABAXGDA.........hCAA......hCEA...,2,-9,-6,3
IbdGQFZgPTAeDESCVWOJKUMaRNYBHXcLf,EAAACAAA..OACAKACAMAEARAFA..BBCAHBDCLCBA..hAAAbBGBGCEAZDDATFGAhAAAACHAeDGHSFFDhAIA..VGAAWCCDaEHDXGDDfGDBhAGA.IHHAhAIA...,1,-6,-24,18
aOGRVQWCNdUMLXTHPbBDEKJIegSFZAfcY,...fAAAaAAARACFQAECCADA.dAGAMAFALDEAHBDCbBGBhAAAEEHFKFDA.eBBDhAIAFCADACCBOFFDGDDANIBB.hBAATFGABHHA.DCIB.......hBIA......hCAA...,2,-7,-6,1
FeSXCAMBZcIdPRfbYOEWQJGLNHUDgTKVa,ZAAAdAAARADA....bADBEAGE.QCBAGAFAHCAADCFAKCHBaAHFeDEFhABA.CDHAAFBAMDABhACABFFAIDFA.hACA.fFHAODDDLFFAgFBAhBFAFHEA.SHBAhBHA...,1,-10,-14,4
IfdGYSEZReAQOMcJXUPWNFVbDCaLHKBgT,MAAAXAAAUAEA......PADAFAGEDBBALAHBhAAAHCCABCGATBFAdEBAGEEAhBAAEBDBRDDAAEHA.OCHDhBEAcFFA...NHBBCHFAaGHB......hCAA......hCBA...,2,-22,-10,12
aNGCQWHFPIAZXKRDBJfMETLYOdSeUbcgV,ZAAARAAABADBMACALAFAdAGA.UCCA..bBDD..VCFAGDFAhABA.QFBAhAIAHEDCFEHDAAAADBFBEFCBOBHDhBGAeHAE.aFHDCGGD.IHEA.KCCD..hCAA......hCBA...,1,-9,-13,4
QgAZbfNPBGWaRUDCHcLJdMSEeVKFXIYTO,ZAAA..bAAA..fADBBAEAaAFDRBGFCAFBHAGBLCAB.dCCDhAAAECAAeDEFFCDDXDFChABATFFA.QFCAhACAAAHANDIA.PFGBWHFGDIBAMDIB...hABA......hACA...,1,-2,-13,11
HIbcYRaAdMVKGQOFPBeTLfSgUJWDEZXCN,dAAAMAAAGADAFADDBAFAeAFA.LCGB.SCAAhACAgAGHUFAADBBBECCBZDEBCFHAhADAHCEA..IHHAhAFAbEEARFAAACIB..QGEAODDH.fGHAhAFAXGEANIBB..hAGA...,1,-6,-9,3
HGFeCBLNYEQTMAUDSWgbJKRZOIafVPcdX,SAAA..bAAARACFZAEBaAEA..VBEBdAHAHCFB.eDHHhAAALAHBEEAAMEEBhABAAAAADCAAJECBODDB.hAEAfEBAXGGACFFDBEFA.QFGAhACAWHBG.KHBA.IHEAhBEA,1,-11,-12,1
WMIQLDfTXCRBZAKbcEYeJGUSHgFOadVNP,KAAAEAAA.eACEGACAHAFBOAEAdBHA..VBCB..PAHDhAAAMDFBLEGBTCEARDGBABEAhBCA..bFAAJEEFSHAAhAAAaGCBIHHADEEB.......hAFA......hAHA...,2,-10,-4,6
aPSXGcCdYVWOTJZERKDHALQefINbUBMFg,eAAA..fAAAIAEA.UADAMAGBaAFE...XBGAhAAAGBCAdAHA.VDGBhAAATCAAEEEBDCFBHDDAhACAAECBLHBAbDGDFFDHSFFDCGGD..hAGA......hAIA...,1,-8,-13,5
ZKCSOeBLdVPNRMJFaYcWDXHAbfgTQGEUI,...bAAATAAA.EACEZADBKAECOAFCeAGFLCCAdCAA.hAAAVDGBRCEFMCCB.aCGAhABA..cECAXDGDhACAHFEBAAHAQGEAIHCABBHA..hAAA......hAIA...,2,-9,-4,5
WfeRBaKAIcJgMbVdPOXETGNQZLYFSHUCD,JAAAMAAA.dAEAOADA..EAGAGAGAZBBBLCGBSBCAhAIAHDCBDCFBeEEHRDDBaDGHABBBIGAAhAGA.gGGAhBAAbGBC..XFGANBIA..hBAA......hBGA...,2,-26,0,26
SETXgeOYVbAWMadIKJBLcUDGZHFPfNQRC,aAAAdAAAKADALADADAFA.HAGBFAHD...fBBERBFB.ECEBhAEATCBAeDCFODFDhAFA..bDEDAAIBMDIBhBAABDAD.cFCDZECBPEHBCGHDSHEAhCAA......hCDA...,1,-2,-32,30
KRFXaEgbBMLPeQTYDIdOcNGZHVUCAWSJf,SAAAKAAARACF.FADAEAEEBAGALAGB.eCABTBCADAIBdCEAhAAAOAHDGEFAHCEAhAAACDHA.AEEBJEGB.aFHDbGCChACAMFFB...QGAAIHHA..hABA......hAGA...,2,-19,-10,9
UYbNDXPCAELRFeJIgBKHdGQaVZOMWSTfc,RAAAeAAA..IAEAKADAHAFBGAFAaAHFZCCAMAIB..TDGAhAAAfCCAUECA.bDADhAAAXFAB.AFFAEFHFhABALDEBFHBE.BDHD.dFHA.QGFAhABA.OECFhADASGGDYHAA,1,11,1,10
cGKPULYNOHbQAeTIRSVaZDBWFMfgXECJd,eAAARAAA..aADAZADBBAGAMAGB..XBDDEAHBdCCCGCGAhAAA.KEEALCCDhAAAODBHHFCAAAIBTCGASFHHhABADEEAfEHA.CFFAPGAAhABANIAB.IHHA.hAIA...,1,-4,-21,17
XKCINUYcdgSJbLWQZRAGVMeEOPFfDBaHT,GAAAeAAAEADAFADABAFAHAFB.KAHBCAHAUCCAdCDA..SDBHhAAALCFAZEDEADFB.MEHBhAAAfDGADEIB.aDHDhACAXGCA.IHAAcFFCJHAA.hABA......hAHA...,1,-8,-26,18
WdaVQNBOfFGPCKTUeIRJMLASZDXcEHYbg,ZAAAXAAAHAEA....bCABdADA.aAFAQCDDOAHDGBEAhAAAKBHBeCGBRDBALEGBhABAAADADAGAEEEB..gGBAhBDAVGFA.fHDF...hABA......hACA...,2,-8,-4,4
TbYUfSEgcFBXdKJONVIGeLQWHCMPaDAZR,RAAATAAAUADA...EACEFAFEBAEBdCGA.OAFD..IDDAhAAAeAHBLCCBHFDAMAIBhABAaCEHACHBZGFE..bEFAhAAASDFDXFDDKGGANCCA.....hCAA......hDAA...,2,-20,-6,14
ZQbUWFKLYXdBETgIeaCDROSAfPVGHMcJN,VAAAHAAAMACA.JAFBZADB.QAFAUCCAKAHB.LBHBhAAA.dDAAECGFTDEAhADAeDHFaEBCRFCAADCB..fFHAhAIAPEFB..NHABFGHDBGFA.CHDA...hCAA......hCDA...,1,-5,-10,5
LfGEJcPFabVCXYDHIMgNASRBWOdZTKUeQ,RAAAOAAAZADBKAFAUAEA.LAHBEBHF..JCFBFBBH...aDBEhBAACCCCDDABHDFA.MEEBhBDAAAAABDHAdFFD..eFHHhBEAGFCB..PHBCXGFA...hBGAIHAA..hADA...,2,-43,-2,41
SNBVCPXQcgGORWbDHfdEAMYUJaKZITeFL,MAAAUAAAKADAZABE..eAEHLAFBBAGA.CAHA.QCFAGCDARCGF.hADADAIBHFCBdCCAADHAaCBEFEEBhAGA....SFFBhAHAPEHD..XGFCOFHD...hBAA......hBCA...,2,-19,-16,3
SUgWJVeMKFQXdabREfZAGTcOCYNLBIHPD,GAAATAAA.CADALAFAHACBDAEA..SAFAUCDA.JBHBeCFAhAAAFCAH.dEGA.RGAAEGFBhACAACFAODEBBHHA.gEBAhAAAMDAB.QFFA.aEHD.hADAfGDE.hAGA...,2,-16,-7,9
OcFWBIJadCNPEZDXQSbYVgMKfReLGTHUA,FAAABAAA.aACAdADA.CAFA.EAFAZAGB..QBCC.SAHHhAAAbCCA.VCEAhAFAMBIBREFA.eDBBLHBAhBHAHEECAFAA.OFHDIGHAPGCCDEEB..hAFA......hBAA...,2,-25,-9,16
XZaFSIPVfcCYKRTJegUHQDEbdMWLABOGN,GAAAZAAAaACA.SADA..IAFAfAGACAHARCCA.eAHHhAAAHCFBECDAdDHAMDABhACAACHAOEEBFDCHVEEAKFCB.hABATGAAUGGADHAAbGDCBHGA.NEIA...hADA......hAEA...,1,9,-14,23
DJfeOdCaWRMYTAQLIcFSKBNgUEHbPXZVG,LAAAFAAABADAUAFAHADBXAFA.GCAADAIBeCCBdCGDaDDChABARDAB.MEGBACEB.QFDAhACASDGAKGADhAFAEEEBZFGB..VGFA...OHBAhADA......hBAA...,1,15,-34,49
cJTPXdBWbUGSFLeOQAMEDZVNRfaIKYCHg,EAAAZAAARAEA..aACDKBHBHAEA..JCAATCDA.dAHABCEDUDGAhAAAGCFALEAAeDABhABAACBBMEFBDEEB.fGAAhAEACEHA.gGCAPHAA.XGGAhAGASFFD.OHDChACA.,1,11,-36,47
RHTefNOZFSGIBgLEVKCdJbAWUMcDYXQaP,MAAADAAAQACARACA.HAEAeAFEOAHDZCCAGBEBBBBDECFFhAGACDGAdFFAADDA....UEEBhAHAYDHBaDHHfGHAhBAASEED.IHHA...hCAA......hDAA...,1,-16,-19,3
AYcMbZSHKGDOXEeFgfPIJRBUadWCNVQTL,MAAAZAAAHAEAGACBXBGAEAGE..eBBBFCAA....fCEEhABAICFARCGFaDACdDDAhAFACDDD.QFEAhAIAAAGA.cGGAbDFDDDHB.OFHD...hBAA......hCAA...,1,-10,-11,1
SPJDfIbedOFcUXZLaHEBKQGYAWCMgTNVR,MAAATAAARACA...SACBDAFA..bBEAeAEA.dBHAFBBHhAIAXCCAaCHD.HCFBhAAAEDDAQEFChBAAAAEACEHAgFCAPFHDfFFEOGBA...hBGA......hBIA...,2,-18,-7,11
ZYRdMeNHAaBJGgXESTCLOIKcPfFDUbWQV,aAAAGAAA.EADATADALAGB.KBFD..fAFBhADADAIBUDCAQEEChAAAZBFERCCBeDGBHFEBADABBDHAJHAASFHBhACAOBBBIHHAFGBAbGEA.WDHB.hADA......hBAA...,1,3,-8,11
dVeGZOMPWYQLRcIBTAfHgEXKCFJSaDNbU,HAAAEAAAKACAFADA.aAFDDAEA..UCABeAFAZAGBMBIB....hAAAPDDBQCCAhCAAREGBBFEAACFAXCFAhCBA.SEDANBIA.dFGA....hCCA......hDAA...,1,-22,-25,3
fPDKbBFTeLaSYMNWVHUXdRGOAgIcJCQEZ,..IAAACAAAEACAZAEBDACABAGA..eADALCAA.aAHDMAHBhAIA.VCBAHCFBdCFAhBCAREBAABEBJDHBQFFBhAAAKEEDTGBASDHB..YFGFhBGA.....hACA...,1,-15,-19,4
LNYWGEZgSBUCHMTDXcRbIfKaJAeFOPdVQ,eAAAOAAAdAEALAEA..NAGAGBCAEBBBZBDABBHAHDGBMAIBhAAATDDADAHB.REBB.bDGDhAFAKEEB.AGGB.FFDH.QGAAhAGA.gGFGCHHA..hAIA......hBAA...,2,-13,-11,2
WGgFJEKQLITfDMACaUVOPRBSNbXHYdZec,aAAAOAAABADA..SADA..bAEDHAFBZAGFeBBBhADAGCCAFDDHEAHBLEGBhAIATEAAMDHBABGBCFEA.PEFBhAEANEIA...YFDB...hBAA......hBIA...,2,-26,-3,23
IXAYWUVaBgGMdEeCZOJDPTHRKFcLbNQfS,UAAAaAAAGACAEADAZAFBDAEA..HCBCRAFAFCEDLBHB.QECBhADASBBDABFBVFEAhAIAMCHBeDFH.OEBBhAIAPHCCTGGA......hBAA......hBEA...,1,-2,-19,17
MWcIPTGdKYRSUeBEHDVfJFZbOQNXLgaAC,MAAA..IAAAGACBdAGARACAeAFEHCCADBGBVDFAFCAAZCEFQFAAhAFALCHBAAIBCBBD.hACA.PDABKEEDSFGAhBAAEDDB.bFCDXGEA.aHDC.hCAA......hCFA...,1,-4,-8,4
eJXaFBQObALTYRVZCWgdKMNIHPGcEfSUD,TAAARAAAZADB..CAFA.dACAKAHBMAEA.HBDBGCEAEAHF.UDAAeBFBhAAA.aCHDQDGChAAA.ACCALHAAhABAVFEAgGBA.IHHAfFHAhADA.DGCA....hAHA...,1,5,-22,27
bFRfBXPaYdZSJTUCDAEgGMLWecHOQKNVI,EAAAGAAALADAeADAHAGBQBGAKCDAVDFBFBCHRCEB..XDCChAAAaEAAZECB..TEGAhAAADDABAAIBMDIB.OFCChACAbFADBGGDdHGBSGBD..hADA......hAEA...,2,0,1,1
adMDBTLXcgJYCAZHQWPSVIFKeUfERNObG,HAAAQAAASACEFACEKAFAeAEH.EAGARCDAOAHDGCCAdCGAhAAAMDCBTFEA.XGAAhAGAgDFACEHAABIB.hCAAZFAF.VFGBfGHAaGCEDIEA....hCCA......hDAA...,1,5,-5,10
fPbQDGSIVYJATMWBKdFNEHCgcLXOaZReU,MAAAKAAAdACAFADDHAEA.CAHB.LAFA.aBBBRCDBeCFA.UEAAhAAAbCCAGCGA.hAEASEEDIEGAVGCAhAGAAAGATGCABFFDEGFF......hBAA......hCAA...,2,-18,-16,2
JLKRIYSaEHcOTgBAVfUNMXCbQWFZPeDGd,UAAAMAAA.CADA.QADAZAEB.eAFAdAHALBGDRBBB..hADASBGAHDCATFFAhBAAADEAfDFAhAGA.bDGDFHDADDIB.KGFDIHHA..hBCA......hCDA...,2,-28,-10,18
UHKPBIYGWZVbCdDXQJNAOeaMgFSLRTcEf,eAAAaAAA.MAEAFADARAFF..EAHFHBBCBBCAGCGAZBDB.CAHBdDEAQCFChAAAACIB.SCHHhABATGFA.fFDAhBGA.KFFA.IHFA..hCAA......hCBA...,1,-23,-24,1
MJDcKPaVHYRdgEABFCIWebUNTLQSGOfZX,CAAAeAAAUACALAEA.GBCAZAEBMAHBDAIBKCEC..aCBCHCGBhAAA.REEBEFAAAAIBFDFDbGAAhABA..QEBAhAAA.OCHDfGHAXFGD..hBCA.cGBC.YEEFhBEA,2,-26,-9,17
EPTMFaDJLWgHUNOQCBeRbYfZIdVcGSAKX,EAAAMAAADADALAEA.HBBAOAEEQCEAeAHHRBCB.bCGDZCEBhAAA.dDGDGFABACBBKECD.hAHATGGAFFGA.aDBC.hBCAgGDACGGD.BEED....hAFA......hAGA...,2,-23,4,27
BeZUWGfLMEVFgOJbHYcRCNSAIdXQDKaTP,dAAAQAAAaADA.BACAeAFHZADBGBGAMAGB.EBDBFAHB.OCEDhAAAHCACREBA.SAHBhACAACIBDDCBKDGA.TFEAhBAAUFBBLFGB.......hBCA......hBEA...,1,-3,-20,17
LaUFDWOdRKIJgZEGMcNfbCHBTQAVePYXS,eAAAXAAALAEAFADA.OAHDRAFF.KBCAJBDFZCDEGCGA.hAAAMAIBfDGAhABA.HEEBTFDAAAFAPEHDhCAAaDFHDFIBdFCAEGGB.......hCBA......hCFA...,1,-7,-16,9
WTLVYPOAHNBUIREDFefZQdaGMJgcKXbSC,HAAABAAARACAEADEFAFAeAFE.ZBDEdCAAGCGA.MCABJBHBKCCDSCCDhAAA.TEDAhACALCFB.VECBhAAAOFGH.ACIBUGDBDEIBQGGC.hAIA......hDBA...,1,9,-34,43
dDKXLVASPeUFcWbGQOHBRgCJEfZNYMITa,eAAAFAAA....bACDGADA.HAFARAEACAHB.ECCBZCFBMCHB.hAEAaDBHdDHAKDFBLECBhAFAAAAASEHHPFEBcFAChAFAQGGA..BFDA.fFFEhAHA.IHHAhAIA.,2,-18,-14,4
CVaNWHeMOSUZTFPRXBcDfKQELdGYJIbAg,CAAAaAAAHACA..eACHMAEAOAEAZBEEFCAARBDFBAHA..fCHAhAAAECFAGDGAJDDFABBB.hBAA.VFBA.SEFDhBFATFFAXGBADCIB.LFHBhACA......hAIA...,2,-19,-8,11
GBcDLVFMXRfAJUQWgSbYCadHONTEZKeIP,QAAASAAACADAHACA.OAEAEAFAeAHFGBGABCCALCEBhAAAMCEB.RGCAAAIBUDGBhAAAgFGAaCFBdDAAZFAEhABAKDDD.IGGADIEA.......hCAA......hCGA...,1,-2,-12,10
IOYUQVLCFRAadceNBDHGXJPMbfSTgZWEK,dAAAeAAADADAHADAGAEBXAGB.MBIBbABD....TCEAhAHAZCCAECFE.OEEBhAAAQDGALFAARECAACHAaFGChAIABFGA.fGFE....hABA......hAFA...,2,-14,-6,8
LTaYDUBefAXcKbSVIGZJPgFdQENWRCOHM,KAAASAAAGACAZAEA..JADAFCABEAGERCEAHEECLCCA.aCFDhAAADAFA.eEHHABDBXDGDhABAVFCB...gECAhAIA.dGGA.WHCAMAIB..hAAA......hACA...,1,-13,-14,1
GPdINFOUMYDHWJZVTcXKQfbgCeaBSELAR,RAAAdAAAFADAMADAHAFBZAEE....TCCAKBHBQCBA.hAAA.bDFAeCFBaAHFEECBhABAADDAGEEA.IEHAhACAOEEBDFGB.JFHFXGCCCHBASHDAhBHA.....hAIA...,1,4,-25,29
eTVYWOBQaIXCGNFPJcLZSdURbAEMgDKHf,EAAAMAAAKACAHACC.eAFE..TAFAVBFB.OAHDQCCChAIAaCCA.CDHAGEEAhBAAFCFHPDDB...LEABhAAAdGHA.REGBAEIBDBBBfFFE.hCAABHDA....hAEA...,2,-18,2,20
bDQfOCKNFASRLZJMVgcTUWYBIaeGPdHEX,RAAAZAAAMADA..VAEA..TAGAUCAABAHBeBDFdCFAHCDAECHFhAAADCHB..QEDDhABACEFAFEHD.ACCBLFBBhAIAJFEF.gEGA..cGGChABAIHHA...hACA...,1,4,-36,40
OdRPDZaQNYXbCSEBecTMGJIKFAWULfgVH,LAAAVAAA.HADBRADFZAFBaAFA..QDAAXBFDSAHHhABAEAHFBCHA.eCABhACAMDDBGEEAKEEAAEGAUGGAhAAAOCCBDFABYDHBCEHA.cFBD.hADAIHHA..hBFA...,1,-5,-12,7
WULBQJbeIPNHSfCTKaMdGZXVREgOAYDFc,FAAAUAAALADAQADAeAGH..IAGAHCCACCHAKEAA.dEEAhAEAZCDARFCB.EBHF.ADAADDIBhADABFHAJEEB..bEFDSFBAhAIA.aFHHMIEAXGFD.hAFA......hAIA...,2,-15,-15,0
KIeQaGOJRcXBAPdTMYSVDfbWgHNUEFLCZ,dAAAMAAASADADAEA....bAEAHAFB.EAHBLBBBhAIAZABBeCEBGCFARDCBBDHAhAEAABDBTECAfEGEhAIAgFGHFGGHKHDA.aBHD...cFDDhBAA......hCAA...,1,0,-23,23
AFaMRWeXGHYgLPcIbEZBSfOdNQVDTKJCU,aAAARAAAeADEHACBLAGB..IAEAEBDFZCEBBDHAOAFDdEDChAAAQDECDAIB.hABATEGACFGAACCBMFIBXGGAhAHA.YAHBgGFGPHBA.hCAASBBD.hDAA...,1,2,-19,21
ATYDVcZgQEWfdLORKeGUFIbXMCNBPaHSJ,TAAADAAAZABE..EAFAdACA.RAEAGCDAFAHD...XBGAhAAAMCCABCFAHDFBADAA.cEAAhAEAQDDCLEHBhAFAeDGFIHAACEHA.aFDHSDAAhADAYHDG.gFAAhAFA.OFFH.,1,21,-23,44
KNLTUGIMDHPWSbAeVdXcOZCgRYJBEFQaf,eAAAdAAAOADAZADBRAFABBCAFAGD...QCFBaBDB.KDHBTCEAhACAGEEADAIBHGAAhAAASCBHAEEB.XDGAhBAACGHA.gECA.EFFA.hABALHDA.IHHAhBCA,2,-22,-14,8
LaUVGCYIgKHODfBeQcXFANSJEZTdMRWbP,SAAAEAAAdADA.RACF...bAEDaAEAGAGACAHA...gCBBhAAAHBEAfCHAhAAAeDBDQEEAhAGAFDEHADGBZFGBMHAALFHB.UGBBIGFADIEA.hAIA......hBCA...,2,-12,6,18
UAcbTZdgDaMEVFXKPNQBIeJCWLOHfYSGR,TAAAdAAAaADA...EACEFAGA.KBDAQAECBBGD.eAGHCCBALDDAhACAHCCASBHHhAAARDGF.AEEAZEFBMFDBhBAAXGAA.IHHAOFFBfGHAhBCA...hAGA...,1,-7,-32,25
bZRMCVUPSGDEQOdefcIABXWgHLNaFJTKY,XAAAHAAAaACAFAFAKADA.ZBFA..RAFFMAIBCCCA..UDEAGCDAhAAAEDHB.dDAA.eCGHfECAhAAAACDBBEHALHAAhABATFGA.bFFCSGEBOFAEIHHAhADANIAB.....hAIA...,1,9,-21,30
MGVYAXRNfZgaDCLBedFOQJEbIPcKSTHUW,RAAAZAAADADALADBBAFA.eAFAdAHA.FBHD..QBDDECAA.hABA.bCED..IDGAhAAAKEGCHFAAMCCBGGCBhACAADEB.fGGBaDHDOEFB.JHBA.SGCEhABA.TGGAhBHA.,2,-35,6,41
NBVWXUbTdYIaKcOEZJCDeRSAGMLfgHPFQ,GAAAMAAALAEAHADAQAGCBBBA.XCDAbBDC.dDGAhAAAaAHDODAHEDEAZDGBDCIBhACARFAAAAFAfDCEhADA.FEEHWEDATGGAKGHB.cFAD..hAFA......hAIA...,1,7,-14,21
VWgNIQLfJPXOTaUEFMYRDKABeHbSCGZcd,HAAACAAAZACA.dADA.VAFA..NADB.LCCA.JCAFOAHDhAAAUDGA.ECCAFEEBRCEAABGAeFAAhAAAGEEB..gGEAhACAfGHA........hCAA......hCBA...,1,-4,-35,31
GSNVgYJfPHZCcaeQdEWMLDbIOXBRTUAFK,GAAASAAA..gADAJADAHAGBZBAEaAFD.eCDF.ECFBhAAAMAHBLEEADAIBbDDAhAAAXFGAREAA.AAIBKGAAhABAVFDA.fDHACHHD.dGHA..hACA......hADA...,2,-4,-2,2
CDEHWRILAdeGOSTNcVbMQJaPZgYKFfBUX,eAAAGAAAOADCSADA..TBGAVAGBMCDBQCCAhAAAaCEBZEFAKCEA.BAHBhABACDGDHFDAREFAAAFAdGEA..hCAAbGAC.gEAGfGHADGHB...hCBA......hCCA...,2,-16,10,26
RUgaVXKPdSNOcbHfBJFIEDTYWAZeMLCQG,eAAAMAAALAEAGADARAFAUDBA..aAHDKCGAdBBA.OCEBhAFAHDEBBEGBFCGHEDCFTGAAhAAAADIBZFCE.QGGAhABA..XGADNICB.bGFA...hAFA......hAGA...,1,-5,-8,3
cGFWMRbTSNPXDfgQBOJHdCaIKEAeLUZVY,eAAAZAAA..VAEAGADAFBHD.RAFA..TCGASCAA..hABAXDBADACAQDDAhAHAOEFBHFAAaDGCEECBhAIAAAAAUGGA.YFDBMFGBPFHB.hAFA......hAGA...,1,-7,-11,4
BCPgWGYFUOdAbNJfaEVSeQMHKDXTILZRc,JAAAEAAA..eACAHADBDAGA..TAFAZBCERBFFBBHBCAHB..PCCBhADAGDAA.FDDBdCHAADAB.hAAA..bDFBaDGDQFAChAFAMDIBKFEAIHGALEEBWHFA.hADA......hCAA...,1,-1,-16,15
TSMWZQNKCIeOaPfFXHYGALbRUDgdJVcBE,RAAADAAAdADA..VACAEAFA...MAFAZBFEQDDCKBBD.eDGBhAAAaBFDFBHBHFAAADDALEEAhBAAbFFD.UGEAhCAAJHBEBHHB.SCCDCFCAOEHD...hCFA......hDAA...,1,2,-26,28
IVKRcJeHbUFdSPgYCDOQZGfTXMNBEWLAa,aAAAKAAARACF..eACHHAEBFAEAdAGB..SAGH..gCABhAAADAIBZCEAGEBAhBAATCGAMBBBEDEBAEABIEEAhBEAVFGB.bFGBPHBACGEA....hACA......hAEA...,1,-9,-17,8
GbOYULQRBVFSATWDNdgeMHZIXKEPfacCJ,TAAADAAAdADA..eAFAHACBZBBBKAEA.EAGE..aBGECCADGCEAhAAA.OCGFLDDAhAFAREAAFFHDABBBgDGHhAGAMIAAXGCA.fGFAbFCAQGGAhBAA......hCAA...,1,9,-23,32
JSAPFXfDQLOWIVHGBTaCcYUZgedEMRKNb,XAAAQAAALADAOACC..VAGBHAGB.GCDABCDAaCEDhAAACCFDUEAAZEAAeDHFhAEAEDHFRFFBKFHB..bEFDAAAA.hAEAFGAADIAA..........hAFA......hAIA...,1,-6,-7,1
QDSRPdAWfVgbZGaEBKNYITFJMHLceUXCO,VAAAZAAAEADE.BAFBKADC.....IAHATAFAFBHD.HCDAhAAAeCABCDCD.QCCBhABAREFAAAHA.fCFAhACAbFCB.aCGDYGEAMCIBLFCAhCBA.XGFASHGAhCAA..,1,-12,-19,7
NcBgFVXLHJDGCfPEUYQZeAROSWIMaTdKb,RAAASAAAMADA.dADAKAGA....bAEDBBDA.FBFHLAHBhAAAHCGBGDDAfAGEhABAECCBQFGBhAAAACCBODBBaDDCNIAB.gEFA.XGCAhBDA.CFHA...hCAA...,1,-13,-20,7
aNAJXVCBcTULIgKbMHQfFRZdYOWDePEGS,XAAABAAAUACALADAKAEA.HAGBQAGCRCDAdEAA..ODCBhAAAeCBBGDDAhAAAaDGEAAIBCEFD.TDGA.IGFAhAIAbFGD.MFIB......hBCA......hCAA...,1,-6,-27,21
XEgfHRJTLdOeVMSKBaUPAYQICNcGZDbFW,QAAACAAAGACAZAEAFACE..ECABHAEBRCEA.TAGAdEED.eCDBhAAAMAFABCHAUGGAADGBIEHAhAGADBIB.bFEDXFCChAAA.fHEF...hAIA......hCAA...,2,-16,-15,1
FYCObcgaePKQTJBWZXAUVSfdIMHNLRGED,SAAAdAAAHADARAGFECBAFADA....OAFD..bCEDaAHBeCHHhACAQBCDTFAABDADhADAZDDAAAAAUFDAIDDAhAFAMBIBGGDBCFGA.......hCAA......hCBA...,2,-26,10,36
eTXYNKRaQdJDgLEZGObMIWSBCFHAcUPfV,UAAAVAAA.eADA..TAEA..XAGAKAGCRCDB.dCDADBIBhAAAECFAGCGAMDAASDFAhADAFDAAHFDCACGBfEAEhADAaDHDQEAA.LFCB.hAEAbFFCBGHACHAA...hAEA...,2,-10,-4,6
ZLHFdYaBCIWcUgEVTKXDAMSRQNGfObPJe,RAAAGAAAOADAJADAZAGBHAGB..dBEDaCDACCCA.....IDDAhAAAUEDAEDHFKDFAAAAA.MDIBhACA..QFFChBIAbDBDeFFB..FGAHBHHA..WFHD.hCAA......hCCA...,2,-30,-1,29
KMfRaNYWBeEIOHcdVXQSAGCFUZPbJTgDL,GAAAFAAAZACB.JADADAFALAGB.KCDARBEAaBHD....NAIA.hAAABDED.EDGBHDBBhACAdEBA.QEEAhBAAAEIB.CEGAPFHDbFFCMHBAfGCA.hAIA......hBAA...,1,-6,-36,30
bJKRDXQNLZTAVdBUSgHeaIYCWMFEGcOfP,dAAASAAAHADAeAFE..aACDCCBAMCFAEAEAGAGA.OCDChAAAbDAA.REAA.QDGAhACAZEEAAAIBBGBAIEEAhADAFGEA.fFGE.KGDADDIBNIAB..hABA......hAEA...,1,1,-15,16
ZWfEBSMReGPgQaLdTJUKXIFcAbONHYDCV,OAAAHAAACADBZAEB..EADAMAHBRAFAGCCAQCABdCFDUEFAKDCAFDFDhAAAABBB....bGAChAGADAIB.VFGBBEHAeGBAhACAaGHD...........hAIA......hBAA...,2,-18,-10,8
NPYVHfgWXLaDZeMIOABERQdGJcFTSKUCb,RAAAGAAAFADA.KADACAGA.....bAFB..PBHDHCDBfAHAhAAA.XDGAhACAaCCAeCEHMDABAAAAEDGBhAGAdDCCJFFBTFFA.SHDAUGCA.hAIA......hCAA...,2,-32,7,39
WOegFcbVITRMCdfQNXALSUaPGYZEHKDBJ,LAAAaAAAGACAEAEAHAEABAGA..OAHDeAHHFCAA..bCFDhAEATCEAREDBdGAAQGGAhAGAADDBSDGAYBBFhAHAZEAADEEBJFFA..WHDGgGCGhABA.IHHA.hBAA...,2,-9,2,11
MOCHNFPKYUWcgeZGRfXTdEaAJIbVQSBDL,JAAAVAAABADB..MADAHAEB.FAGAKAGA.UCDA....hAAAgCCBeCFAREBBTEFAhAIAECGAADIB..QEFAhBAALEHBCHGDPFEBcGCD..fGBAhBGA.aGHD.hBEA...,2,-22,-20,2
eRYbJFVBOHZCGgUKXEQNaAIdWLMcTfSPD,dAAAMAAA..TADASACAeAFERBFBJAFABCBA.HDCAGBDBhAIAKDADEDHFaBBHACIB.LDDAhBAAfFDADDHBbFFAhCAAOFFB.CGHA.........hACA......hADA...,1,-12,-18,6
XDeUNOEWSCBVbJQcdIYMFHTZfARaLKgGP,RAAAaAAALADBGACADAEAeAFA..UBEAEBHF..CCCC.BAHA.VDGBhAHAbCED...QFEChBAAdDGDMFAAHFGBhAAAfGCAAFIBKGAAXGCBOBBHSCGEhCAA.IHHAhDAA...,1,0,-23,23
QcaLGeSfPFMOTIVAXgHYBdbWNKDUZCREJ,HAAAdAAA...bADBKADAZAFBEAFE.QCBAaAHDGCCAeAHHSCAAhAAAFCFBMDABTEFAhACAADDA..XDGAhACABDHADFBBRECALFGBOFCHIGHAYHAAhADAWFED....hBFA...,2,-6,3,9
BYSXEOfHaVbRWZcdLMCegPIFJNDUQKGAT,TAAASAAA.EADAHACB.aAEARAFAZCCAdAHAMBFBeCGF.IDGAhAAAFDABDCIBKECA.AAAABEHDhADAOCAB.bEBALGAAhAGACEHAJFFB.QGGAXGCCfHGFhACAWFFD...hAIA...,1,5,-16,21
fLXWBTKHYONEaIDFMecbdQVJPgSGRCAUZ,ZAAALAAABADBHAEBOADDEAGADAFA.FAHDeBHF.dCAAQCAAhABAJCCF.SBFBhACAREDFADIBUFGA.XDDAhCAATGAA.KDGA.aFCA.MFGB....hCFA......hDCA...,1,-12,-20,8
KXfZCHDgcVAJaUMIOTYBRQFdPGNEWeSbL,aAAAMAAA..OACDTADARAEA...dAFAGCDAEAHB.eAHHbBBD.hAIALDFB.fDHAhAEAHCFCDBBBgDDBhBAAABBBIFAAQGCCFEGHWEHH.KFHBhAFA.CHAA.....hAHA...,2,-8,-5,3
MDVJSbEYgOaQWBcITZCeNFXKRAGUfLPHd,GAAALAAAHADAdAEAMAGBDAFASAHH.ECDBOAHBhABAaCFBBDGATCAAZEFEeDADhAAAXCCDAGDAUGGAfDFEhACAPHBA.bEGD.......hACA......hADA...,1,2,-19,21
CJZRXTIeDVEYNBadKcFbGHQALfSWMUgOP,LAAASAAAMAEAOACD..CAHARBCATAEADBGB..ECABBAGBhAAA.dCEDFCHBHCGBhABAADEAUEEAgEAAhAEAZFBBeEHFVEEB.aGHB.......hABA......hACA...,2,-24,-3,21
SXERfbMGTgOYUHaeFZWNIJDKALBPcCVdQ,LAAABAAACACA.dAEAQAEAEAGA.RAGB.bCAAGCAA.OCCChAAAHCECeCHH.hACAZEBAIEEAKFFAACAAcGAAhABAXDGAMFIBTFGA.UGDA.hACA......hAGA...,1,-5,-12,7
NYOSgTPfGRQHFMcLbDXCadKBJeWVIEUAZ,ZAAAOAAASACE..TADAGAEAHAFBMAHBLAHBhAFAbDDD.CBBDdDCABCCDeEDHhBAAIEHAAEHA.gFFBhABARFEFFGHB.XGAAaHBC...hBHA......hCAA...,2,-11,-6,5
NSeTaIFHRcGCLQKJdOgYPUfbMVEBWXZDA,eAAAaAAAHACBRADAGAGALAEAKCCA.dCFAOCED..gDGHhAFAUEAAMDGBEEDBBEHAhAAAZFFAAAIB.TGAAFGHB.hABACHCA....YBBFbGAA....hAGA......hBAA...,2,-11,-4,7
HAWcMgfBKNeCbJLXGaFQDUSdTIOVPYEZR,MAAABAAAeACA.CAFA.bABALAHB.GCAAaAFAQBFChAIASCCAdCCATDEAhAAAOBHD.PEDChBAAEEGAHFCAAEGAgFCGKCFCXGGADFHB.IHBAhACA....hADA...,1,-5,-12,7
BbOFaSPfWNdEKgALRXeCGIYHTUZMDJQVc,RAAAeAAAGADAHADAZAFAMAFADAGA...QBGABCCDFCFD.aCCB.hAAASCFD.hABAfDDAdDAAECHBAEHBLFFAhADACEGATGDAUGGA.....hCAA......hEAA...,2,-26,3,29
UcHBaEgfICJeTNARbWVPYSOKQLDMFdGZX,RAAAVAAA..SADBQADCMAFAGAFAZBEBUCGAHDDBEAHBhAAA..fCCAhAAACDHAeFABADDB...bEDCPFGBhAFAKFGALHBAdHDB.BHHA...hAIA......hCAA...,2,-9,0,9
XDMSUaYgJfPROKdCEeBAQTcGbHZWVFLIN,TAAAGAAAHADA.ZAGBFACALCFD.XDCAMAFAaBDEhAAAJDHBRBFFdBHAEFAAAAABbDDD.hACA.IGEADCCBSEHBhCAAgGAAOFFDCGGD.BHHA..hDAA......hDBA...,2,-19,6,25
BMeCTaJcSZGWfLKQVFbUDEPIgdOYHAXRN,RAAAMAAAeADE..aACESAGBGAEALAGBQBDDFBBHDAIBhBAAECGB....gDEGhAAAdDDAHEGBADIBBEHAhABATGBAcGGAfGEA....hBGA......hCAA...,2,-14,-12,2
KafEZOXNdBGLPSRTcQYJVIAMWFDbCHgeU,MAAADAAAHABCUAEAaAEAZAGB....XAGDdBBAGDBBLCCAhAIAREFAQFDDVDFAAECAFEEHhBAACGBA.KFBAEGHBBFHAhBFA.SGGD......hBIA......hCAA...,2,-18,-13,5
TGHFOXNSafCBWARPEbMDUZcJQVYIgdLKe,EAAAMAAAZACB..QADA.VAFAgAEA.dAHAhAAAeBBBHCECXCGAhAIAaCBBBDHARDCFbEFBDEEBcFAAhAFAIFHA..TFFAOFDDSFHBhBCACHHAAFFB....hBHA...,2,-18,2,20
BgVJDFHdMUSXAQaPeWfKZEbOCIRGLYNTc,aAAAeAAA.KADAEADA..CAFBGAGALAGB.TBEABCCAVCEBhAAAFBBHHDCA.dEGAMDIBhABAXGBAAAIB.PDABhADAZECFbFGDOFFH.IHHA.NAIA.hBAA......hBGA...,1,0,-19,19
VOTPfSdBNILeYEcQRUHMGAgbDCKZaFWJX,DAAAZAAAaACAFACD....JAEAOAED...TAGASAHBhBAAdCGDBCCDLCEAhBBAEDEBREFFHGAAACFACDDD.KFHBXDGAhBEA.VFEAfHEB..hABAeHFA....hCAA...,2,-37,-8,29
VKXFZTACbHBYMUISNDWcaGRLdPQfJEeOg,HAAAMAAAUAEASACE.DAFAaAGERBDAdBGAQBBA.ECGAhAHAeCCB.OCHDhAAAKDEAZEBAAAIBbEEBBDHAIGGAhCAAcFFA..LFHBfFDA..hDAA......hDBA...,2,-14,-14,0
UDQeaLKZVWSIdNRBOCFYPETHAbMcfXGJg,MAAAXAAAGACBUADAeAFE.LCCAZAFBSAHHdCGAREEBCEHAFGDBhAIAEDBAHDFC.AAAA.hBDAfGHADDEBaFBAKFFAhBFA..WBBDBGHA.OHBA...hBAA......hCAA...,2,-13,-6,7
dVaWYHJEMgecQNPBRFZKbTACGDOXLSUIf,GAAAXAAALADAUADA.dAHA.aCDAHAFA.ECGAeCFHQDBAhAAABDDARDGFZEAAbDECAAHAhABAOFHD.fHBBhAAAVFFA.........hBDA......hCAA...,1,-6,-12,6
TIYSJHLaOUgdZDFbWeMEBcCRXPfANGKQV,GAAAQAAA..TADASACAHAFBaAHFOAEDdDCAZDGBhAAAbAGB.eDADBCDDREDFfGFEhACAABGBKDAA.IHBAhADALEEADEIBMBIBCHHA.XFGAhAAA.PGDC..hADA...,1,17,-21,38
PKSDGQegaMLWACVfJIEFBYOdNcZXTUHRb,CAAAVAAA..JACAEADEBAFB..dAFAZAGBUDCAHCBARBGF..KEECGDEAhAAA.eCHHaDHDMFGBhAAAACFAFECD...OHAAhAHAXGGA........hBCA......hBIA...,2,-28,-22,6
THLaOgJXANCGbQKIeFcDMZfPBdEWUSVRY,GAAAQAAAeADADADAZAGBBAFAEBFFUDCARAGFHBDBLEEB.hAAAaCHDOCHD.XDBChAIAAAABCEADKEGDFGHBMDGBhBCA.dFCA.SFEB.YHFGhBDA.....hACA...,2,-13,-2,11
SBDePUETdHcFNCKfaWYGIVZLXARgQbMJO,RAAAQAAAMADA.SACAeAFAUCCAEAFAHCFA.FEBHKAHB.hAAAaCDAGEDBZCFBADAAJDDBhAAADEIBdGGA.CBHA.fDHAhADAIHEA.LFAB.XFGAhAFA.OHDA.hABABHHD.,1,-5,-10,5
VdceNaZOFBMUJKSHGQTDfWXACbIPEYgRL,CAAA..bAAAEACA.RAEA.dAEA.eAGBZCAABAHBMAIB.KCEDHCAA.GCFAhAAAQCGATEBAhABADEFBXEDDACCA.hAAAIFHAPEGBLFAANHAB.aFHD.hACAOGCE...hAHA...,2,-19,4,23
YNeLDbPGRSOfdJaCTUZMgAVEKBWXHIFcQ,EAAABAAAHACAFACA.QAFCeAEHLAGBDAIBGCCBRCBB.fCHEhAAAaCHD.TEAAhAEAZEEAAAIBKFDD.XGBDhAAAIEFA.cFGB.YHAAhAHAPGEC.OHEC.CHHB.hCAAMFIB.,1,18,-27,45
bQNaDCdRFYMIVHGZESJPOWgLTcAUefKBX,eAAABAAAQACADAEARAFA.MAFAHBCAEBEESCFA.hAAAOCHDLBGBAAAAKDEDhAIAbCABaEBAdDDA.FEHDIFFAhBEAZDEB.PFHBTGFA..fGEEhCAANIBB...hACA...,2,-10,-10,0
EcNdeXUZOIPJAWSbRQaTGfDMBLHFgCVKY,SAAARAAAQADCGACADAFA.LAEAHBFACAHA.KBHB.ECEAdDDAhAAAeDFFZDGBOCCHhABA.IGEAAAAAaDGDMEEBhAFAFGHD.gGAA.cGGA.hCAA......hDAA...,1,-2,-15,13
fgXDWLCYeaNEIBVQTKdZOHGbRcASUMJFP,MAAAFAAA....fADADAEALAHBeAEHEBBABAGAQBDAhBAAdCGAHDAARDEAABGASDFDhADAUFCAJFGB.XFGAhAGA.CCCDaEEHNEIA.IHFA.KGDDhAIA......hBAA...,2,-18,-18,0
XOJgLPGcMCZYTWVdDfHabURAeKNIEQFBS,eAAAKAAAEACEQADA.BAFAOAEALAHBGBDBMCCBhAAAZDDATFGAdCGCHDDBbGDChAAAADDBFEHD.XGFChABAPCHDCAHA..YHBADCCB....hBHA......hCAA...,1,-5,-11,6
LCdWQaSUNODcIVgPBfHGJAKFRXEbTMYZe,RAAAEAAAMADAZACBLAFA.dCBCaAFEUCFADAIB....ICCAhAAAPECC.HCEAAAGAFEHDhAAAbEBA..eFGDQFFAhABAOHDC.gGCBBCHA...hBCA......hBEA...,1,-13,-14,1
ARWSEFQMedKbONJLBUHYDPGXcgCITZfaV,RAAAEAAAMADAdADA..OAFALAHB.HBDADBCBGBEA.XBGAhAAACBGBZDDAaEGDADBBFDDHhBDAeFBA.KGDA.NEIA.BDGAhBGA.PEHD.gGFB.hAAA......hABA...,2,-18,-13,5
XUebYcCPDfgRTFMIBASZNaWLHGQOJEVKd,ZAAAaAAAHACBGAEAQAEAEAGA.dAHAeBHF...bCABCDEAfDGAhAEARDDB.hABAMBBBAADASDGDhACALFFAOEDBKFHBXEBDcGBCDGABFHFABGGDhAGA.NIDB....hBAA...,1,3,-8,11
TecfPJRFVBdKNUAXGbHOaYCMLEDZQSgWI,GAAAHAAAaACAMADAEAFA.ZAEE..QBGASAHH.ICFAhAAAeCCAfDEAhAAA.RDFFBEHAdDCAKDGAhACAACCAbFAACEEALFGBDFAA......hBAA......hBCA...,2,-22,6,28
KVDIZMWJCRgTbPHaNOYXfQeFGESLBdcAU,KAAADAAAZABEMACA..CAFA.RAEA....TBCAHAGBaCCA.OCEDhADAXBGA.eDEAhAAAEDGBLFAAdEHAAAHAIFDAhCAAgFGA.NIAB.QFFAhCBA..SGFDhAFA..,2,-26,-17,9
ZJRAOUePLMVHBNTCIDFfQGScaWgKXEdbY,eAAAMAAAHACCBADACAFAFAFA.GCCA.aAHDKAHB.ECCAdCFAZCEBABBBODHBhBAALDGBTGFAhCAADDIBQFAAhAAA.SEDDgFDHbGFA....hABA......hAFA...,2,-25,-1,24
cHFCfJPAYZNXRODEbILBMSUQGegKVWdTa,ZAAARAAAEADELADB.MAFAQAFCGBFAeBHBKBHBdCCAaCAAHDFAhAAA.CEDA.JEEBAAHAXFDAhABADFBABFHASGGDhABAUGGA.........hCAA......hCEA...,2,-15,-15,0
DLIHTdfabAVGYSWJUQFPcBCeXNMEKRgZO,GAAASAAAUADAQADAFAFEBBHA.eAFA..MCGBRCCBZCFBhAAALDDBHDABdDHAaDBDhAAAABIBVFDB..YDHBhACA.PFFBXGAA.EGGA.hAIA......hBAA...,2,-27,10,37
GbVgKcJTAfFHaSLCdQYUBXDMNZIWPeORE,HAAAaAAALADAdADAQAFABAHA.MAIBZBBA....ICFAhAEAeCABECCBGCGAhAFAbCEDKDGATEEAAFAB.SFHHhAHACFGAXGDADDDBWHBG....hAAA......hACA...,1,-9,-18,9
NXUAQJLBRfZgKPFISdbMTEWaCcVODGYeH,LAAARAAAZADBKAFA.FAEA.dAHAMAIB..EBDFCCCC.OCABGCEAHCEAhABAUGCAACCBBDHA.hAAA...fDAAhABAgEEASCHDbGCCaGGA.DFHB..hADA......hAHA...,1,-12,-27,15
FAMcHVLNRaXOQeTbSEZPJgfIdBGKDUYCW,HAAALAAARADFOAFAeADH..SAFAEBFFZCAA.JBHB..fBHAhAAAdCAAGCEADDGBhACACEDDAAFAMDIB.cEEChADAaEGETGCA.gGGAKGHD..hABA......hACA...,1,-5,-17,12
YWFAVPbTDKNEgJSLCfQIRdUeMHGcXBOZa,VAAATAAA..KADCEACE....SAFALAEBQAGAhAAARCDAeAHHHECAGCCAhAGABDHAaEGCFCGHACCBbGACDDIBhBIA.gEFG.fGHAhCAAdGGA......hCEA...,1,-9,-13,4
cgdRFbAPHaSCWGXTZEYDUVMIBKNeQOJLf,HAAAaAAA.CADBGAEAZACBEAEA.DAGA..MAHBKBGCeCAA.QDGAhAAALCEBfDGEhAIAdDDARFFBAGDA.SEDDhBAA.TGBA.VGFA.BBBDhBGA.NBIA....hACA...,2,-18,-6,12
cTXHZIVKBUCOWfNDbAdagQFGSYLePEMJR,aAAAQAAAGACALAEAEACA.RCEA.TAEAHEECZFAAKAGCCBHAOAHDhAFA..fCDAhAAADBBBAEHAdGHA.SCFHhCAA.eDCD.MDHB.XEEChCDA.BGGD.hAGANDIA...,2,-10,-7,3
SPYZOMWVFHGdXAERQLJDIaTebKfCUgBcN,RAAALAAADADA.aADDeAEA.KAHBCAFABAHA..SCCAhAAAZCAAMCFAFDFAHCEBdEEAECGBhABA.QFGAhCAAJEHB.IHCAbFAA.fGFE.hABA......hACA...,1,-13,-30,17
SgIPLDXUWMfKcGJHeaEZFBdQOARbVCNTY,RAAACAAA...TAEASACA..gAGBLAFAXCAAhAAAMCCBKCGD.GCFAhACAHDDBEDABZDCBdDHAAAAAbFGBYEEFhADADGGB.fGAA.eHCGhAGABDHA.....hAHA...,1,-7,-14,7
fdXaWZQPDUgIMCNLVEBSOKJTGbHYRFcAe,eAAAdAAAaADAZADB.QAFADAGA.UDFAMBDBLBHBEBEBOBGBhACAKDBAGFCB.hBAA.HDGBFFHDAAAAXEDAhBCA.gGGACBCANIAB.SBHBhCCA....hDAA...,1,-7,-23,16
JLROcfCBGeMTFPHXaKbAUZYSgVdDWNQIE,ZAAASAAAdAEADAGA.QADA.EAFARBFFOBHD.CCAAGDABhABAeAHFMCCBFEFH.hACAHDDA.aCHDADDA.gFDAhAAA.VGFAIFHALDABhABABHBA.PHEA.hADA...,2,-29,2,31
VSLDCcJEYRIFAZfXgOedNTaPBWKUbMQGH,ZAAAXAAAeACEdAFA..aADABAHA.KCCDbAFDGCGA.HDEBhABALBDBCECA.EAHBhAAARGDEACIBODCH.TEFAhABAPHACMDIB.SFEDDGIB.hAHAYHCA.fGHEhAIA,2,-19,-4,15
aSUWKYQCZBNTMOXeAVGgbHcEPfRDJFLId,GAAAHAAAEADERADAFAGAdAFAUCAB..KCDDQCGAZCEBBCGAMCIBhAAAeDCHAAHA...bEDDhAAA..fEAEhACALFFAaHBCSEGBCHFA.TGFA.hACA......hBHA...,2,-21,-1,20
bYQcRGgfDOLWaXJeSZdCUKMEFIPVBNAHT,HAAATAAAQADC.RAFFGCABDACALAFAaAHD.eBDBhAAAdDFDKEEDECCBFCFAIFAAhAAABDFDAAGAbFGB..gEBBhBEAOHAA.XEFA.SFHHhCAA...hACA...,1,3,-17,20
MEKRfVQSXBOWYGNZcCTDgIUHLaPdJeAbF,MAAARAAAQADCBADA..OAEDGAFAZAGBTDDADAGB.IAHAhAAAHBBBaCHD.dEDAACCBECHFhABAKFFA.SEGAhAFA.XFDAYFHBCGGA.....hCAA......hDAA...,2,-26,-9,17
DMfUCRKOcFHAVbPWdZYEBegGXQNaISJTL,VAAA..bAAAdADAEAEABAFAGAGA.QCAAaAGD.SCDAhAAATCEAMAIBhAAACDFARECAODHDHDGBADDBZFAAhAFAeEABXGEAIGFADEEBKHGA....hABA......hACA...,2,-11,2,13
AIPVDfdQUESZOBWMXTRacKJeYNbFGgLHC,VAAAdAAAEADA.ZABBBADB..MAGBRAEFKAGCeAHB....bCFDhAAAGCEA.HDCBhAIAABIBDCDBQEGAhBAAODHF.XGGCaEDDJHCAFGGBLHCA.CFBD.hBFA......hCDA...,2,-26,4,30
fDXVWaHYOKSNCIJMGQcReZdUbAPgTBLFE,TAAALAAA.EAEADACA....XAGAaADEHAFBKCAACAHAMCCBhAAAGCCARDDA.eCFBdDHAADDAhAHABCGBFFFB.fDHAhABA.VEABOHEESEFD.hCAAIGHA..hACA...,1,-13,-16,3
YPBAaNDWecCKMGfJETHbFIUZXSgVLROdQ,aAAADAAAeABA.KAEAGACA.EAEAHAGBFAGDZCFASCCAhAGALEABRCEFdEGAQEDAhAEABGFDAAIB.NEHA.CHHAMDIBhBAAfGFA.........hCAA......hCBA...,1,-6,-27,21
ONUaeACQRPJbLMKcFYGZVWgEIfTBdXSHD,RAAAJAAAMADA..FADAZAEE....VAGBEBHF..TCCAdCCAHDFAhAGAOCEDUFCAAAAAQDGBhAIALFFAKHFAGGCBhCAA.IHHABHHBDIAAaFGC...hAIA......hBAA...,1,0,-25,25
AWdQOMFTJYZKeGHNEBfgaSUbXcVILDPCR,dAAAMAAAFADA..TADAZAFBeAHF.HCACEAFEBAHB.aBBBbDEChACA....XCCChBAAIFCALCFAhCAACEHAACIBQFFCOEEAKEHB.GGCB.hBAAfGGB.hBCA...,2,-20,-7,13
FIQSYafcHeLWBNEgUPVGXJARMCKZDTbOd,RAAAMAAAZADBDAGA..TADAdBFA..QDAAaAFAHBBBeAHHhBAALBHBBBFA.EDEAUEEAhAAAGEFAACCAKFCBFDHD.hABASEDD..fFHAhADA.WHCA...hBBA...,2,-23,-11,12
acIOKWJLZPfGXgMSYFCHTeBRVdDAbNQUE,QAAAEAAA.aACEOACC.KAFCLAFAZBEEGCCAMCDAhAAAFCHDHCFCeEABRDAAdDDAhADAAAIBUFEAIFFA.hAAAPEHDXGGBSGAA.CGEDBHHDhAGA.DICA...hAEA...,1,11,-20,31
NMFfCSVWAIaDJeXKYTPgQHdZGcLRBUbOE,aAAAeAAA.KADA..TADAQAFCHAFBGCCARCCABAHBOCGDhAAAEAHBMBBB.CDHASDADhADAACCADCIB.XEFChAFAgEEBZGEA.cGDA....hABA......hCAA...,1,5,-34,39
FLAVMGBWdPcINEQHeRaCgYDJOZSbKXUfT,GAAAdAAA..IADAEADAHAFA.RCDAaCGDCAFADAHBZECA..KCBAXEGAhAAAUCEA.TGGAhACAAAIBBCHA..PHAAhADAQEGA.eEDB.JFAA.SFFDhACA...hAHA...,1,-2,-35,33
SLRCUcTedVIgOJEDNBHQYFWfXPGaKMAZb,ZAAALAAARAEAUCAAeADH.dAFA..VCDBOAHB.ECAABAHBhABAHDEAQCGAhACAFEDHXFBDGFABKEHBACIBCFFA.hADATGFAJFHB.DIAA.......hAEA......hAFA...,2,-18,-2,16
JZEbadcHTFNLCPSMeIfRGQAXBVKYWOUDg,BAAAKAAAOACADACAZACE..EAFAdAGA.HCDAFAHDLCCA.hAAASCFHeBHHREFBADCBXFCAhAIAVECA..hBGAUFGA.JHDAaFHDNDBA.MIEA....hCAA......hCBA...,2,-24,-15,9
eQUZAJXgPBEHdTNGKDbSOYIcRWfLMCVaF,XAAABAAAHACAdADAGAFA.DAIBbAEDOCAB..IAGAhAAARCCALDHB.MEEBhAAAaAHDeDBBZEABAFFAJHEEhACAEDDBTDGAKHBA.SFEA.YFHBhABA.fGCAhBDA,1,-9,-13,4
SZRXHNFLeGdMgVPTIJcYWDbEfOQUCAaBK,aAAASAAAZACB.HACBLAFAeAEAdBHAMBBB..VCEBTCEAhAGAIEAA.JEGBhAAAcCGADEIB.EEBAQGCAhABAAEEBREGBFFFHPHAA.....hAEA......hAFA...,1,-5,-10,5
VFIRfUWJNYcDKPGaTABHZQESLbXCeMOdg,HAAAEAAALADACADB.eAGHdAFAFAHB.RCAAUDEANAIA..DBCBGECAhAAAAAEAZCEF.QFGAhACAbDCD.MFBBODHHhAAAIHEAfGEA.....hBFA......hCAA...,1,-11,-14,3
YbTaHIZPScXeLORABFCNEKUQdGfDWgMJV,CAAAEAAAKACAdADA.GAFADAEA...MAIBJAGB...VCBB.TEDAhAAAHCAAZCEF.SBHHhAAAeDGHRFABAAFBFFHDhAHAQEGC.fEDA.gFBDhACA.aGHDhAIA...,2,-43,1,44
bcdaQJWSUXRVBMNgGTALfeHCIFZKOPEDY,eAAAHAAAFADAZADBOAFCEAGA..DBIB....bCEDaCACQCGAhAAASCCBRDBBMFHBhABAGCEAAAHA.LCGBhAAACBCAKGCA.cECCdGEA.UGAA.BFHA.hCAAgGGG.hCBA...,2,-8,2,10
EHSOLVGeKZcRNBPDMWQgaAXCJYdfTFUbI,CAAAdAAAFACAUADA..EAFAHAFA.LCHBeAHFZBCARCAABDEA.hAAAMDGBQDDChAFA.ACGBXDGAhCAAfEDEbFFBOFFH.KHAA.....hCBA......hCIA...,2,-26,-17,9
SEPIWOGTDBNaQLYMeFUZgbXfRCHJcAKdV,dAAAEAAA...IADAGACATAEABAFAQBGAMAHB.eCAAhACAZDFAbEABRCEB.HEDAhAAAAAHASDDDOFGDaGAHhAEALEHBFGCB.XFAACCBDcGDDKFGD.hAGAWHFGDGIB....hAFA...,2,-22,24,46
TCUfAbIXRMJSdeDHGPBLcZQNYEKgFVWOa,XAAARAAAMADA.dADAHAFCGAFALCCAZDBA.QCGBhAAAEAHBFDHBODFHaEBACBDAAEEAJFAAeEFFhABABFHA..cEGDhAIAKGGD...........hAAA......hABA...,2,-18,-1,17
DgQdLcHeYaECBIbMPUXFVGJROfNWZKTAS,DAAAdAAAHADAeABA.EAGEBAEA..MCCBXAFDGCGA.RDDBODABhACA..fAHEhAIAZGCAACIBQGGBhADALCCBaFADbCEC.FDHDNIAB.TFEA.SGHBhBAA..hCAA...,2,-34,14,48
eZVKOUgGSTXYaNcPfLDQFbBIEJCWMAdHR,HAAARAAAeADEZADB.OAFCGAGA..TCFAaBDD...PCABhAAALCCD.QDEAhAAAbDCCBCHBEEGACEHAAAIBdGAAhABAKFCASFFDXFCAcGEDFGGAIHAAhACA.MIFA.hAGA...,1,9,-13,22
RaCIFPASEdLODMHfYQZKBWcNTXVJUebGg,EAAAdAAALADADADA.HAGBQAFAZCAEBCEA..NAIA.TDFAhACAXBCAUECAeCBBhAAA.GDDBREAFaDHDFFFHhAEAADGAMFGBKHGA.VFCA.JFHB.CHBA....hAFA......hAIA...,1,3,-4,7
ELXbfcIDUCMePNaRZKHgQAWSYGOdVBJFT,SAAAGAAAdADABAFAFADALAGB..bAGD..fBCAhAAADAIBMCFBeDBHhAAAaBEERDDAHEGBADDA.OFFHhABATEGA.EGCA.XGEA.IHHAhACA....hAFA...,1,-14,-23,9
YafPNDKBAHIgULMReJObWTQZdSVcCEXFG,HAAAUAAARADAeACE.OAFA..bAGBTBFAZCDA.dCCASCHHhADACCHAEDFB.GEAAhAEAaECE..fEHAhAAADEEBACFALFFAMFFBQGGB.hBAA......hBCA...,1,6,-22,28
KHOXGRWFgCLSPbDVUZEeYJNIfABQaMdTc,aAAAdAAAKADAHACBGAFARAEA.FAHFLAHB.SBBDhAEADCCAZDAAEDDEeCEA.YEEAhAFAIDHABEHBMFABhACATGEA.XGGBCFDAbFFA..JHFA.hBAAAFFA......hCAA...,1,-6,-16,10
NGFZRSgLDYeXTEbVcMBHAdUWCKQfOaPJI,dAAACAAAKACAQADA.OAFCaAEA..JAHBGCABZBCE.RCFALEEAhACAeCAB.EFHFhADAVDDAMGCAHEGBAAHA.hBAAUGCA...fGFENICB.SHAChAAA..hACA...,1,-1,-26,25
CacQAUMDgBJRWfXSEZLHeVIGYPbFOTKdN,MAAABAAARACA..XACAEAFEHCAA.eAHHGAFA..bCEBTCCAhAFA.dBHAaDGCAAHADBBBhBAAJEDB.SDFDhBFAZFGBIGFAFEHBKGGDCHAA.......hAAA......hACA...,2,-14,-14,0
XZPOSRTIMKJUcNCHLYDaWfgeAbdBGQVFE,dAAAGAAAQADAEADAZAFB.OAFCRCDB.MCCBKAHBUEGA.CCHDHFBAhAAALCGB.aDABhACAfDCEAAHABDDAXFDAhADASDADTGGAIHHANCIA.DFFBhACA......hADA...,2,-10,-10,0
WQgaBKROJcHeNACFdDTPGZEIUbLXYSVfM,dAAATAAAZABBEADA..UACALAGB.SBEAMAFAQBEChAAAaCHD.RBGFODDBhBGAHDCAAAIBDEGBGEFAhBIAbFBA.YFEF..fFHAhBAABHHA.KHFA....hBFA...,2,-14,-4,10
YVRIESBKZUJcTPLWgdfNDAFGCQHMabXeO,GAAAHAAAaACAeADAOAEDRAGB..ECDAKAGAZDCAUCGA..TEGAhAAALCCBdFDADCGBAEEAQFFAhAAAMDAB.bGAAhAGAXGGA........hACA......hADA...,1,-9,-10,1
FgdBLKRZaASOXEGTNVcPMQefYUDCbWJIH,XAAAEAAAGACA...TAEAVADAMAHBeAGHUDFB.CCBD.hAAAbCDA..JEAAHDAAhAAAdFGDLGAAREEBAAIBOCHDhABANAIA.QGAADEEBIHHABGHA.aHGC.hAEA......hAGA...,1,7,-3,10
dURfWgPKDGETZCeMcLNQJbaBXFAOIVYHS,OAAAVAAA.HADAdADARAFA....fAGB.gBBGhAFADCFBECGAZDDFeCEAhAIAMDIBLDHBQFAAhAAAaEEAFFCAAAFASFFBPFFB.KHEACHHA.NEHA.hAIA......hCAA...,1,4,-19,23
WaVUFGNYADHQbZgOXeBfCKJPRSLcETIMd,HAAAZAAAOACAeACECAFBKAFARAGF..LCCA.EDFFMAIB.aCCChABAFDHDGCEAAECAQGFAhAAAXDGDBHHBfECAhAHASECATGCA.dGGA...hAIA......hCAA...,1,-10,-12,2
ENPTWfLKeBJbAVUMHaCFSZOYGRdgcDXIQ,MAAAHAAAaACAFADDZAEBGAEA.RAGB.dAHADCCBQCBC.ECGBhBAATEDA.LEHBhAAAeDHHBEEAAAIBCDDCODGHhAGAgGBA.XGEANIDB...hCAA......hCDA...,2,-15,-9,6
HDAagVPSTNYcEbIQCLFKJXGfBZORMWUde,aAAAVAAA....TADA..cADAEAFEQCCChADA.LAHBKAFCGBGAhAAAZCFBREGFMCDBdEECHFCBhBAAAAIBSCEDNBBA.bEFD.FFDD...hCAA......hCFA...,1,5,-21,26
QWMZCOTJIYgDceFHSNUafPdBXLAKRGVbE,RAAAGAAAEADE.MADAZAFB.OAFE..TCCAJCDA..ICHAhAAADAIBeBHD.HECChAAASDBHaEHHdFAAXGEAhABAADDBbEEA.CHHA.gGCA.FGGHhACA.NEIA.....hAIA...,1,-4,-20,16
YWLFPVfCQdaHDAbBEReJKXOTGMZUScINg,EAAARAAAeADEKACA...OAGDGAEAZCCASAGA..IEBAhAAANCCA.gDGAhABALCHBFDDBfEEEhAGAdEAAHEFBAAIBbECDXGDC..MFIBhBEA.....hAAA...,2,-16,-10,6
AcIDYTJWedVBKCfNGOSgaULPZFEbQRXHM,DAAATAAAeABA.dAFAKACC..CAHA.GAEA.SAGAhAAAaBCELCHBZCCFECGARDDAHFBAhAHAAAGAIEBAJFFB.BDHAhBEAfHGFOEGBPFHD...hBAA......hBFA...,2,-24,-6,18
GRdLOcZfKgIFXHTSBUbNAMWDCVaQEJPYe,MAAACAAA..aACAEADA..JAFAeAFA.RBBBdCFALBCAZCGBKECAFCFDhAAAHFDCBCHAUGAAADBADDDBhAIA.....QEGAhBDAYEHB.GEDA...fGGEhCAA.IHCAhCBA,1,-18,-28,10
cVKPZNMeEJdOSHXIaGRYgWfbUFQLCBTAD,DAAAKAAAZACBeABAdAFAHAEA..aAHBRCCA......gBGAhAGAbBDD.QEEAhAHALCABTDGAhAAAACCAPDHDEFBASGFAGFDBfGHAhACA......hBFA...,1,-8,-19,11
WeDGPbaANQCLFMYKcUJgIVfERTOXSHZBd,QAAALAAAMAEAKACAUAEA..gAGA.VBDBhABARAGBTDCA.SDGAhAAAHCABdDGAeEFDhACAGFDBaEHDAAIBFGHDcFBB.fGEEhBFA.....hCAA...,2,-24,5,29
XcWdEbBYHTVfJIOaRgDKFCPQZAeMNLUSG,eAAAMAAALAEAGADA..XAFAdBBAEBHFBCEAHCFATDBAhAAAVDCB.JEFF.aEHBREGBKFAAhAFACFAAZGAEADIBUGEA.hABA.SFHH......hAFA......hAGA...,1,0,-20,20
EPBZgRTCDWJHaMeXNGOLAdYQbSfcFIUVK,dAAAQAAASADAFACEUAFAKAGA.BAHARCAADCEAHCDA.eCHFhAAAGCGAADCB...bDCAhACAfEFA.hADAIFBAEEABZGAATGFACFHAaFEHMIEAXGDBhAEA.....hBFA...,1,-3,-19,16
OYeVfXWFCHEZIDcbUJgGTaLRNABQKMPdS,QAAAMAAAdAEA.OACCeAGB..XBBACAFBHAGBECDA.ZDCAhAAADAIBUDGBGCFAaEABRFDBhAEAABBAKEBA.SDEDhAHAfFGAFEHDIHHA....hAIA......hBIA...,1,-4,-21,17
IfKUPXMTaSWJHeORFAZDCNQEYVGdcBLbg,ZAAACAAA.EADEGACABAFBLAHB..bAEA..ICAAhABAKCAAXCEAaBFESCCAhACAHDGBREAAAACBQFEChAAAdDFAfEHAMAIBJFEFeGAADGGB.NIEB..hCCA......hEAA...,2,-21,3,24
NdcZbTMSDgAXGCYPRQBWOHEIaJKFfLVeU,GAAACAAARACA.QADAOAFA.HAFAEBFF.aCDC.FCGDLCABhAAAeDADdEEAZCGBMCIBDCCBADABhACAXGFABDDAJFEBfHABhAAA..UGGA....hADA......hBIA...,1,12,-26,38
ZHaYOQdEPfXGBcFVSUCTMNRWADbLgJeKI,LAAAeAAAZADBHAFAaADD.QCFBEAFA..XBFAhABAGDBAFDHDSCAAhACATEEAMIAARDDAAAIBDCIBgGGAhAAAKEGAOFAA.dGDABBCAcFFC..hAFA......hCAA...,2,-13,11,24
VKdJZYgMRLeCaAGNSPDHEQWFfOUcTIbXB,GAAASAAAHADAEADAQAGC.fCDEOAFCTCCAhAAAbCED.BCEBdDGBZFAAhAAAMCGBREGF.eCHBADABDGIBhACAFDAB.IEEA.KFGA.YHAAhABA.LHEAhADANIAB...,1,18,-15,33
AaNKFBHWIgDPSXZVbfTRLJEGMcQedOUCY,aAAAFAAAHACB..IADADAEASAFAZAEB..VAGBbBFA.hAIARCCBLEFAGDEAMDHBhBAAeECDdEBACBBDAEGABEDChBEA.gGDDfGGAEGGBcGDD.hCAA......hCBA...,2,-10,-4,6
MVFWNaSIHCYJgdBZTPAEKeRbXGODLUQfc,EAAARAAAGADALADAQAFAMAHB.FCCHaBCCHDAB..CCEAJDDFhAAAdBHAZDFA.AAAAeFFBhADAbCFD.DFHBUEAA.fFHAhAEAcGDANIAB.SCHH..hAFA......hAIA...,2,-21,8,29
dTBRPXeDLEQHFVNbMYKOgASWJcIfZCUGa,SAAAJAAA..IAEAZACBGAEAdAGABCCARAGBeDEDLCEBhADAHEBBFDHD.bGDAMAIBhBAAKGAD.ADEB....hAAAfDGACHHA.aEHD...TGBAhBGADIBA.EGDE...hABA...,1,-3,-28,25
DWdKJVcINOTbPXSCZMAYgFaRBUeGEfLHQ,FAAARAAAeADEEADA.HAGBDAGA.dCCA.KBED..VBEA..IDFAhAAATCCA.XEEChABAZDAFABHA.aDHDGDGALGAAhAGAQEEAJHEAcGGANICB.....hADA......hBAA...,2,-21,6,27
IbeLTZDORgVWMAEdYHXJaBFQSGUCcPKfN,EAAAHAAA.aACAQACAGAEAUBGACAEAKAGA....fCCAhAAAbCCALCGBZEDARFGFVGAAhAAAAAGAdGEA..XFFChAGABEHB.SGDB.NDIA...hAIA......hCAA...,2,-11,-3,8
XFLKUZVHJESeQDfYagbPMIOWGTNcBAdCR,RAAALAAAZADBHAFAEAEAeCCDDAHB...aCFC..bBDAMCIB.ODABhAAAGCAA.TDDAhABABEEAAAHAdDHAFEGBKFDDJHCAhABAQFFC..fGHAhADA......hCAA...,2,-10,-9,1
bCSLgTMNBHDWZYQVEeGfRXFPcUdKaIAOJ,OAAACAAALACA..MAEAHAFBZAFEQCCAEBBBGBDARDABFAHFhAAAUCGAdDFDKDBDAADASDHHhCAA.TFFAhCBADFFAVGDA.XGGB....hBAA......hBDA...,2,-18,-7,11
ILCdRKNQJDXaZOMgAYSPfHFcebUETWVBG,SAAAHAAAeACEEAFE..TADABAHBGCCALAFBRCFAQEFBhAAAXCCCZBGBMEIBhCAAAAAAfDAAhADAbGCA.VEEBCHGA.dFCA.KEHBDICAaGHH.OHAChAHA.....hCCA...,1,11,1,10
bFIMSHZPEGQRJOXeAVUfKdDYgaTNcBWLC,UAAAdAAADADA..aADA..TAFABAGALBDBFBDB.MAIBhAGAHCBBZCEBEBHF.RDFBXEDDhACAACDBKCGB.NDIA.CEGDSEHHhBAA..PHAA.JHEAhAHA......hAIA...,2,-36,-14,22
GOVIBKLPWAbRNfYEeJZHMCQaDUdXTgFcS,RAAA..fAAAEADEeAFEHBECMADAaAFEdCCA....TDGAhAAAFBCAGCAAODFHBBHAhAAAKEDBPFHDACCBbCFCYDDBhACA...ZFFADGGBXGCC.hABASHEA.hAIA...,2,-8,4,12
dRMAgLYHIceOPZGWBFaDTVbCKXfESUNQJ,LAAAHAAAeACEZADBGAFAFAFDDAHB..bCCBKCAA..EAHBSBHHhABAQEECRDEA.ADHAgFAAhAAA.hACAIEHAOEHDBFDAaGGACHHD.fGFAhAIANIAB.....hAFA...,2,-30,6,36
QVUcMafXWEOdIABKgJHTbSPeYDGZRLNCF,KAAAHAAA.TAEASACBeAGHGCABRAEALAHBFCHDQDEDhAAAUCCBMCGB.aEABXEAChAAAEECFdFFDAACA.BGAAhAEAbDED.DFIB.CHHD.fEHA.OHCAhAEA.IHHAhAFA...,2,-23,20,43
aAdMXTCJBYKUNQLFDgIVHfeRGbWcOESZP,dAAAMAAACADABAFAKADA..QAFCLAHBDCCA..IBBAhAHAHCDCRDAAGEEB.hAIA.bCDCOFABEBHFZDFEhBAAABHBJGCAUECB.FFGA.fGGEeHEA.hACA......hADA...,2,-17,-4,13
OQGFZLXDaEKSMVdPgNJIfBcWYCRbHUAeT,eAAATAAAGADA.ZAFALACBDAGAECCB.MAEA.dBEAPCFChAAAgAGA.IDGAhAAABDBD.cECAhCAACEFAHEGB.AEIBFFEHaDHDSEEB.hABAVGFA....hCCA...,1,-10,-16,6
WJXINeAZKUgdEbQDTRSFLMYOBCfHcGPVa,ZAAAKAAAdACAEADE.DAEARAFFLAHB..MAHBBCAAHBDBGCDAhABAaBFF.XFAA.hAAAeEHBAAIBbDFAQFFChACATFCA.FHCECFFAfFHE..hCAA......hCBA...,1,3,-34,37
RIafWVPMLDdTCOKUGgEeFQbXYSBJHNZcA,RAAAaAAA..VAEAMADALAHBdAHA..TBCAKCCAGDAA.hBAAEDEAeBBD.bBEBSECBhAAAHDFBZEDFADHAfEFAhABADEIBOHBCFEHB.QGGBhADABGCB.JHCAIHGAhBHA...,1,7,-8,15
aHJLUCbEYNXSMWITKDQGVZBReFdPgfOcA,HAAALAAACADB.EAEAXAED.MAHBTAGA.QCAAhABAZCAARDFBeEDFdCDAfFHAhAAAACFAaCGEUEFANAIA.SEADhACAKGAA.DEIBBHEAFFDBOHFAhAEA......hAIA...,2,-6,-5,1
NgVFeSHZMAbRQUOaIEfDJGPTKYcCLWBdX,RAAAQAAAOADA.EACADAHBGAEA.KAGACBDALCCAdCHA.hAAA.XDCAVDFAeEEBhAAAHDFBAAIB.aEBCJGBATGAAhAGA...cFGDBGGANICBSHDAhAIA....hBEA...,2,-26,-1,25
OGCRQAfELBKYTXeJZbWaHSFgcVUPDNdIM,EAAALAAAKACA.TAEAeAEEZBCE..aAGAHCECFBGD..VCAAhABADAIBdEEA.MDDBGDEAhACARGFAADIBBEHDXDGAhAEAJHAA.bECD...SGGA..hCAA......hCDA...,2,-15,-7,8
NJEWaIcBHFZQVDeXTCPUKAdbSMfGgLROY,dAAAMAAAGADARACA.OAFAJAFA..EBBBaBFD.BBHAHCEAZABBQECAhAIADDDB.eCHHhBAATDGACEFAKFHBAEFBSFBBhBAALGCA.NIDB.cGGCFFGH...hBDA......hBFA...,2,-20,-2,18
YCXabcQFLIUMgEBGDSVPJTZNRHWOAKdfe,dAAAeAAACADA...aADDQAFALAFAMCCBECBA.GCGADAIB.hACASDDAVCEBJDAF.hADAZFCBHDGBAAAAKFFBXECChAFAFGAAIHHABGGDPHBA.NIEB..hAGA......hAHA...,1,-3,-12,9
AOJUaXbMRcdFLCEBgYVeDTPQGHWKZIfNS,OAAAaAAA..MADARADAdAGALAHBBBBD...VBCAeBHHTDEAhBAAGCEA.HDCBhAEAZEGBfBFBhBBAADCBXEGAbGDACGDAEHBE.DFIB.......hAIA......hBAA...,2,-14,-7,7
ICSZeWEMLDYGFQNBgabUOHTfXJdVcKARP,RAAACAAAZACAEADE.LAFBGAFAFAHFBAHA..aCCAOCCB.HCGBhAAATEEA..XEADhADAdDHAKDDDAAAA.SFAAhAFAeDEBMFIBQGGAbECD.fHEBhCAAcGFBIHAAhAEA.DICA,2,-18,-6,12
dGfXNeTWALUMaKSZVDgPOFYCHbBJIcERQ,MAAAaAAAZACBDAEA..OAECCAGA..HBBABAHBJBFFECEA.RCGBGECAhAGA..XDBAhAIAeEEBABBBKGGASBHHhBAA.gEDH.FEHB.bGFAhBBA.IHCA.hBAA...,1,-19,-24,5
faTgAQJRBXeCNHLIODWUVbKZMcYGdPFSE,RAAAeAAAHADBLAEADAFAUBFAKBCA.ZBFEMAIBGDDA.dDGASCCDhAAAEFAA.aDABAAAAQGGAhAFABEEA.hABAXGAACEGAOEHD.bGEC.....hAGA......hAIA...,2,-16,-11,5
KWAgGXdJYPeDREQMfIBHFNCLVSZabTUcO,GAAAdAAAJADA.eADA.EAGAMAHBBBHAHCACCCDA.LCFBZCEBaDAH.hAAAUEDA.KDHBADCBXDGAhACADAIB.RFGBQGDAhADAFFHHSGAA......hACA......hAGA...,1,-3,-27,24
dGRPECNYHeKMUSbcOBXWFZAIQfTJLVaDg,QAAATAAA.LADAaACA.dAHARAEFEAGECCDAHCEBKCCAMCGBhAAASCGG.bEAABCHAhAIA.FDBHAAEAfEGAhAAADEEBgFFAPFHDeHCEOHBA.hBDA......hCAA...,1,2,-18,20
OPJNaISCfYVEeUQXgAGbKBZDHMLcFWRdT,GAAABAAAHACAMADALAFBFAGD.RCAAdAHATCDAOCEH..hAAAPCHDaDGD.CDCD.fEAEhACAEDFFUFBAQFGChAAAADIBZFCADFIBJHBANIAB.SGGB.hACA......hAIA...,2,-11,0,11
TJBGNYHFAfMKWaRdbUEPCOZeSIXQDLcVg,MAAAaAAA.RACA.dADAUAFAEAFA....OAHDeBBB..SBHBhAIAQCEALDDAhBAAgDBATEGAGDGAhAFAHFDAABBBKEEDWHDAbGDACHHA.IHBA.hCAA......hCEA...,2,-11,-5,6
ZAKdSeUMbJfLDTXRVYCHcWFIOEQgPBNGa,dAAAeAAAMADA..bADALAHB.TBDARBGFCAHBHCCA.FEAAhAAAEBFEQEEAhABABCBAaDBEADFASDHHhAEAUEEADEHB.XFAC.cGFDOFHD.PHBAhACA....hBAA...,2,-22,4,26
UZLWfFbMPIJaCKHGQNRcDASEVgdOTXeYB,EAAAdAAAOADA..eACABAGAZAFBLBDBFAHDMCCA.JDAAaAHDhACAHDDBGCFA.RCBFADHAhBAASDGA.hBCATFBAXFCAUFGAbFGDCHDA.....hAAA......hADA...,1,-11,-14,3
FAUdNMbKVWHePQTaDEYOJgSZLGfcRXCBI,dAAAMAAAKADAHACC.eAFETAGADBBBEBFF..OCAE.SCEAhACAGCCARCGBBEFAhAIAAAFAUECAbFEC.WFHHhBAAaCHDJEFB.LHDA.....hCAA......hCCA...,2,-22,-8,14
cWgOfeHZUAMPbVSIFNCTDaXBRKQYJLGEd,MAAAVAAA.FADD..CADB.DAFABAFA.RAGF.QBFALCDBdDGDhAAA..gBBDhAIAeFABHFDCABIBSDEBhBAA.TEGAaFCHKGHBGFBB.EGGBhBFA.OHCE..hCAA...,2,-18,-18,0
XMBQAUYLEDSHKRJaTFCecdPbGOWgNVfIZ,LAAAEAAAHACARAFFaADDFBHD..eAFAdCCDGDEAOBHD...NEAA.hAAAfCAAZEGB.hAEAMCCBAFIBDGEBKDDA.TEFAhABA.CCGCbFAA.....WFDHhACA.IGHA.hAFA...,1,-6,-15,9
IfbGJXdaKNQVWUASFeCDgTZROEPBYMLHc,eAAADAAAZABEEADABAFALAGBHAGB...IBFAGCCAdDAAaCCA.hAAAQEFAUDDBAAIBCDHA.hABARFDFOFHD.MFCBhADAbEFD.KHFANICB.........hCAA......hCBA...,2,-18,-7,11
LPTBRHXEAaGDgCIeFYNJSWdKOUQbfZVMc,GAAACAAAFACA.JADAdAFA..OAGDQCBAZCDA..MAIBLAHBhAAABECAHEEAABHBaDDADDGBhBCAeEHH.SGAAhAAAKEEDUFBA.fHEBPEHB....hACA......hAGA...,1,-14,-24,10
GcQPUYKdONFageHTJBbXLSMEfIWVACDZR,ZAAARAAAGADAQAEAUAGA.dAHAFCCH..eCABHDABBCCDLDFAhAAAECEB...fFFAhABAIDGAABGADFIBPEEBhABAOGBC.aGHHTGFA....hACA......hADA...,2,-25,-5,20
OFeELAKdRGbcZWTNXHPMQYgSUJBIfVaDC,RAAAGAAAZADB...TADAHAFAMCCB.QCGASAFBhAAABDAAfAHAhACAaDEDOEGBECDBACFBdHABbDFANIDB.hAAAXFFA.gGDB.IHAAhADACFCAFFHD...hABA...,2,-7,-2,5
KcAUBCWSVQXJHNIaeRPYFbEOgLTDMZdfG,CAAASAAA.QADAHACAaAEARAGFFAFEECAALCCB.hAAAMAIBdCEAGDFAhACAAAAABCGAXDABIHEAeDDDhAIAbEDD.OCHDTFFAfHGFhCAA......hDCA...,1,-9,-11,2
gKcZaDRfObBGLIMCANEFXdQVJPHTSeWUY,EAAAdAAAQADA..PACCHAFAeCAAUAFAKAHBaCFERDDBOCCBhAAAGGEBLDEAhCAAMCIBAAHA.XECDhCBA.TFFA.SDHH..hCDA......hCEA...,2,-20,-6,14
TSQgcPCaUVbKIZfWOAYedJLXDNGBHMREF,eAAAdAAALADADAEAGAGAHAGB.ECBATBCAQCEC..hACAgDEACDDCaDGEbEAB.hAEAZEBB.ODHDAAIBXFFAhAFAMFDBRGFASGHH....hBAA......hBCA...,2,-8,-2,6
LFOegfdXcBGVWKNIUDMPEbYQTASaRHZCJ,RAAAHAAAZADBLAGBeACEdAFABAHAGCEAKCCAUDAAMCHB..EDHFQDEAhAAAAAAA.aECBhAHAFFHDOEHDXFBAhADAVGEA..NIABDGGB.......hCAA......hCCA...,2,-9,-9,0
MVgYQfRBNSEObCJDTLXUZeAHWcKdGaIPF,HAAAKAAAGACAaACAFAFAMAEA....gBDAQBECRCFABEEAhAAAEAHFCCAA.DAIBTDFAhAAALEHBZFFAACIBdGCAIGBAhACA.PHDAfFGA.OCCHhCAA....hCGA...,2,-15,-7,8
MDAeIWdKXaTRFbcHESUPLQfYVZNOBGCgJ,eAAAdAAAaADARADA..FAGAHAFB.EAHBSCCBLBDB.QCEAhAAAfCBAZCGBBDFDhACAGEAACDHAMFFAADIBKEEDTGGAhAIAbGDA...PHDC....hBAA......hBCA...,1,-3,-10,7
cRLbVfOXWHAPdTBGQDSECMNeIaJgYUFKZ,dAAAGAAAQADAEADAMAGBeAFA.aBGEJAHB.UCDAZABBRDCALEGBhAAA..bDGBODAHhACAHFDAAEIBTFBAhADASGAACFDB.IHHAFFFBKHAA....hAGA......hBAA...,2,-7,0,7
LcYEfAIebdTRCPDUHaOXBSVZMJQNFGKWg,eAAAdAAARADADAGAHADA.aAFABBGAZBFE..MCCBQCBAGDDAKDGAhAAALCFAEFGA.AADA.bGFAhABACDDB....OEFAhACASGDD..VFFB...NIBB.hBAA......hBCA...,1,8,-31,39
IKJRPGHWZUSgAaDFMTQObLEdYcBCXefVN,aAAAMAAA..QADALAEAEBBAdAGABBBDeAHH...fCDEhADAICDARCEFHDEBhAIAZEFBSDHHhAFAABFATDGAbGDACGAAXGCA.KHGA....hAGA......hBAA...,1,-9,-12,3
WSVaTZKRbfeIXgcQdENMBGUYOAPFLDHJC,LAAAHAAACADB.SADHaAEDZAFB.RAFA.eAHF..XCAAhABAQCABECFBMCHBhACAGDCAODDBACIBDEEAVEGBhAAAbFAB..IFEA.dGGANIEB...hACA......hCDA...,1,-1,-7,6
MGfXDcTJdgFNRPAOIYbEZeKULBVQCaHWS,OAAA..bAAAEADAeAEALAGBBAHAQCAAHBDCMAIBGDDAhBAADAAA.TFGAhBBAdCFAFCDD.RDGFAAEAIGBAhBGAZFDAKHCACCHBaCCHSFHHXGED...hCAA......hCBA...,1,-3,-9,6
AYGCEOJLaVbcdePRHBSMXTIDFZgWfKNUQ,GAAAEAAALADAaADA...VBGBdAGARCDAHCBAMAIB..TDEAhAAAFDCHZEFA..fEAAhAEAKDGAQGBAhAAAAAHAOECD.bFGBcGGA.....hAFA......hBCA...,2,-11,-8,3
FZWbPLCGIHKBDdTQgROSANEMfeJYaXUVc,EAAAeAAA..aACDXADAUAEA..FAGEZAFB...bBGDLCHBhAAAGCCAHEABDCBBdDDAhBCATFEAREBBADHBMEGBfGHAhAAAJFEB.........hBEA......hCAA...,2,-19,2,21
fIFgSKGYcJabCURdVLNETDHMQPZWXeAOB,BAAAFAAAKADAGACA.JAEAaAFA..CAHB.RBEAdCCALCAB..hAAAECHFHCEAMDABZEEAeDFFhADAACGAOCHD..hACAfEDASEBHbGFAVGEADIAA...hAIA......hBAA...,1,-9,-27,18
aQVNGgIFZfPedLCEURDKYJMTHbBSWcOXA,aAAAQAAAGACAFAEAZACBeAEA.dBHAEAHBRCEB.KCEA..MECBhAAAHCGBSEEDhAFAOBBHAEEAVEBBIEHALFFAhAIADGDBTGFABHHAcGCD...hAIA......hBCA...,1,2,-12,14
dRSTEQGCaFNDPVZgBHUOIJXebcKWYAfML,MAAARAAAEADE.GACB.FAGADAFAZCCAHBECUCGAOAHF.XCCChAAAeEEBKFAA.ABBBdFCAhAFATDEA.QEGAhABAaGDD.PHDABGGA.IHHA.hBAA......hCAA...,2,-19,-2,17
SNDBPRZGbFMgYOXfQeAdVKIacEUCLWHTJ,dAAAKAAA.aADAEACE.LAEBHAFB..TCBASAGABAHARDEBGCCAhAAAMCIB.OCFDhAGAQEBBACCBVFGBIGGAhACACCHAJHAA.DDHB.PHAAFHEC....hAHA......hBAA...,2,-14,-6,8
WaVBXSTQRFGePDgfHIEJKUNMOLAcZCdYb,ZAAAdAAA....bABDaACA.BAFA.SAGHRADAeAGHDAIBHCCChABAECEF.KCHBUEAA.MDHBhADAAAIBCDFA...VFEBhAEATEGA.GFAB.fFFEhAFAIHHA......hCAA...,2,-28,-11,17
YPRENKQHZIfaAFMWUdOcDbXSCJVeTBGLg,MAAAdAAADADA..SACACAFA.eAEHGAGALAGB.hACA.gBDBhAIARCCBEDHFQFDAHCBBZEEAaFGChAIAADGBFGGHOBBB.XGBC...hBAA......hBCA...,1,-2,-29,27
ACgfRVbSNMLQOFPWUKaJIGEHZeXBYdDcT,CAAARAAA..SADBMACALAGBFAFA.UBCAaAHD.GCEAHBEBeCCBhAAABBFBdECADDHBADIB..hABAVEGBQEEBhCAA.OFHD.KGCA......hCDA......hCGA...,2,-30,-9,21
DLCUQJcHKOeTXPabgMVWGEYdFSNARfIBZ,RAAABAAAZADBLAGBQACAHCEBeAEA..TDAAaAHD.MAIBhAAAGCAAdEHA.SCCGhAAAABGBDFGBCCCC.cCFAhACAXFBAbDED..gGFAWHFA.EHBA.hABANDIA......hADA...,2,-12,8,20
KBbCVNUXREeWDZdcLFAOgaGIJYfPHSQMT,aAAAGAAA.JADA..fADAHAGBMCDBBAFA.CAHAUCCBhADAECEBeDBHZCFALEFBhAFAAAABODGB...gGCAhAHAIFHASEEDKHGANBBA.RGAADIDAhACA......hAGA...,2,-15,-12,3
AIFeCaGOEfJMXcTdUPgYVLHbZKWDBNQSR,eAAAGAAAEADAMADA..TAFAdAHAUBFA..PBHDVDCAHEGBhAAAZCCADDGBQGEChACAAAAACECAaEEH.fFCEhBAAXGGA..YHAA.KEHD..hAHA......hAIA...,2,-16,2,18
PKAUEYQJWTCLNZDOSVGcbgFMaeRIfdBXH,EAAAQAAA.JACETACA.LAEBZAFBSAHHhAAAGAGAbDDAMCDBRFFAdGAAHDGBhBFAACCB.UEEACECDDDIBOECHhBHA...........hAAA......hAGA...,2,-14,-12,2
bCAWSKVLZRONJQaPYGFeXfEcTgMIBHUdD,KAAAZAAARAEAOACA..QCAA.aAHDGAFA.eAHBhAAAECDFTCFAMBDBHDGBhAIAdEEACDHAACCBSCEDhBFALFAAPFHBXFDAfGFAgGGAhCAABHAA.DACA..hABA...,1,-7,-10,3
XTVHJcGUROKgINFBeDLfAdCaQMZWPSbYE,aAAAZAAASACE..EADA.TAFAHAEBGBGARCCA.hADAKCCDgCGAhAHAFDEHeEGDLGAAAAIBdEEAMBBBhBAAWFHHbFCB..XGFA....hCAA......hCCA...,2,-14,-11,3
caIeOFDdSQBfLUPgTWEbNACXHRZVJYGKM,HAAARAAAZADB.VAEAGAFAKBHB.MAIB..aCACeCCDDCCA.dDAAQDDAhAAALEEAPFBDhAAATDFA...EFHFAAHAXEAAhACAJHDA.IFHA.SGGDhADABHAD.fHDBhAEA,1,-8,-11,3
ZVYaJgECPDHRdfFUSXMWTOKQeINbcGLBA,ZAAAaAAA.EADEDADAHAFB.RCAA.dAGAFAHFUBBB..MCEBOBEBeDFAhABA....bCFAGFABhACAAAIB.VFFAJEFACFBAhBAA.....SFFD.XGBAhBFA.KGGCNIEB.hAFA...,1,-2,-27,25
WSEeHUKRTCMQYNAdLbcaPXfOFIgZGBVJD,dAAALAAAaADA.XADDFAGAZBDA..GCABBAFADAHB.ECAAHCGBhACARCEA.MDFB.QEBBhBAAAAIBbEEA.fFHAhBCAODDBgFAAWEEDUGBBTGEAhABA.CHHANCIA...hBEA...,1,-4,-10,6
gIWOdfZSXMGbNLAFDCeUQPKRHYETcaVBJ,CAAAeAAAUACAQADA.RAFAHCCAEAEAaAGDBCGA.JDHB..hAAAIDDAdEEAZGAAXGEAhABAGDFALDHBhAAAAHHADIAA.KCBD.TFCA...cGBChAIA...WHEAhBCA...,2,-35,-2,33
eWBDVZbfgJFNLPHREAOSCaQTcUdMYXGIK,CAAAaAAA..QACAUADAdAGA.MAFAGDBAeBEEDAIBZCAA...hBAA.bDDAfCEAhAAA.FCHDLDHBhBBAHDFBABHASFEDTFDAXGGCKGHBBHGDhACA......hCBA...,1,-10,-13,3
NCdPZKbDMTQaBXYISUELFfHVOWgJGRceA,dAAAZAAADACAMADA..aAEDBAGA...XBDASAGAEBHFLDBAhACAHCECOCCBhABAJDFBGEGAREEBAAGACCHBKEGATGCAhAIA..IGHA....hBEA......hCAA...,1,-16,-30,14
WGcIULXebMAfSYDNTaKHVOgEPRdQJFCBZ,SAAADAAA..aABEHACBOADDEAEARAGBdAFAQCEAhAAAFAHBZCFEGEEBIEAALFBBhBAAeDHFAAIB.fEEEhABANDDA.TGDAKGHBPHECBGGD..hBFA......hCAA...,1,5,-18,23
SEMKZcFDTJWGfIBdQYNPbLHOgVaXCeRAU,EAAAZAAADACA..TACAGAEABAEBdAGBQCGA..hABAPAGBHDDBOCCBhBEAaAHFeCCAAFGAMFIBFDEDfDGAhAAAIGGANHBBbFGD......hCAA......hCBA...,2,-28,-7,21
NSWgVAGDOIPdZeLUcFKEabJTYMRfCHBXQ,GAAAOAAAdAEAeADALAGBFAGDKCDA.EBBB..aBHD..bDBATDFAhAAA..REGBHFDChAIAQEABSBDFhBAAgFCAABGBDBIB.ZFFA.JHFAMIEABEHA.hCAANIAB......hDAA...,1,6,-9,15
YSFRAKDBJLgEZICXNbcPGTHMWOVUQadef,BAAALAAAEACAZAEBXADD....bAGDGAGAHCAAMECAhAAAOCABUEGAdDDAeDGDhABASFFDAAGBDCCBgFAAhACACGBA.PFED....hAFA......hAIA...,2,-19,-15,4
dGZRKLbICTUQEgaMeODcXNJYfPVWAHFSB,HAAABAAAZACARADFLAFBCAFB.QCABEAHB.aAHBeCCBDBIB.hAAAXCEAJDDF..hAAAfDGAPCHBAADAdEEAhAIAbFED.UGGAMFCBOECHcGGA...hCAA......hCBA...,1,8,-22,30
VRbcYaNQGMFHUBfXTWZSCJeOLDIgEAPdK,dAAARAAA....bADBaADA.GAFAHAFABCCATCBAZCFA.CEEAeEGBhAAALAHB.DBEBEHAAhABAADFBKEED..YHCGhAHAMEHBfGFA.SHBAhACA.....hAIA...,1,-17,-19,2
ELaPDBeTJcFbAMNZYXgIRQfVGCHUKWdOS,ZAAAXAAARAEA..QCAAGADAHAFAKBHBdDDAECGALDAAhAAA.aDFCBCFAeDHHhABATDGAFFAAAAHAMFFBhADAgEAGfGGECFEAOFHDDGIB...cGFBhABA...YHAAhACA,2,-19,0,19
IOBeXNURPFCJZbYSLVfEMKGAWTHgacQDd,HAAAaAAA.QADCdADABAFA.eAFEUCFARBFBCCADZDBA..SCCDhAAALAHBEBBBGDDAhACAADDA.TFGADEIBOFAAhAFAPHEC..bFDA.....fHBBhBAAMCIB.KHGA.hAIA...,1,3,-17,20
dNUAbWYKVLHTOICBRGFaZcePXgQSDfMEJ,...bAAAKAAA.HACBOAEABAEAGBDAZAFBeAHF..XBFAhAAAQCACDAIBECAAhABAdEDAACIBVDFBTFFARFBAaEHDhACA..gEAAMIDA.NEIA..YHEAhAAACHHA....hACA...,2,-18,9,27
ACTMcWVHRJUFdBSPeKQDfLbgGZIOEYXaN,MAAAVAAA.HACC.RAFFFBBHdADASAFA.eAHHQDCAhAFALCFBGCGAhAHAZDDBEDHFaEEDAAFACFHATGFAhAIA..cGGC.......hBAA......hBIA...,1,-9,-14,5
DdgRHJVcMLSPNbfEOCeBaUKTYXAFGIWQZ,GAAAQAAAdADAHAFAJACE.MCFBLAGBSCGA..hAAAbBEDEDDBeCDFaDBDTEGAhACAAAIBFDHDZFFARGEAPFABhAFAOGBABHHDKHCA........hAAA......hBGA...,1,16,-16,32
bRfOeSLXKHBMYIDCdWNEGFcJaZPAVUTgQ,TAAAQAAA.RACA.eACELAFBHAFBMAIBDAHBdCECEBDBGDAAhAAAFCCHaDFCAAIBUEGA.hAAA.bEECSDDDhADABFAACFHAcGGCZGFA.PHAAfHDBKHDA.hAFA......hAHA...,1,5,-1,6
WVeacROCHTFSGKLAfMDNQIBYXPbgUdJEZ,MAAAQAAABADA...XACA..bAEDdAFAEAGAZAGBeBBBhAGARDAAHDDBFBHDGDCAhBAAABIBDDIBIFGA.hBCAPFBDgEEBWHEA.aEGA.CFHDSGCDhCAAKGEA...hAAA...,1,-6,-11,5
NGaBUCYbFEdMLZDAfcRKegVTSOJWIXHQP,RAAAeAAA..TAEAOADC..JAHBXAGBHCCAQDAChAAAGCCAaBHDCDFAFDHDdCFAZEFEhAAAAAGAKEEDSFAAhABA.IGGABFGDbGCAEHEEDGIB....hABA......hADA...,2,-13,-2,11
AMTBVfXHDcYFQbgPZeaRKSNIGdCLUEJOW,MAAATAAABADA..XACBHAEBDAGAFAEDQBBC.hAAA.bAFDZBGBRDDBSAHBhBHAGDDAdFGACGBAEDHFWFHHhBAAACCBfFGE.YHCA.hBGA......hCAA...,2,-20,-6,14
EbACdaMPDIFQSGfWYUHOLceNZVRgKBJXT,aAAAMAAA.DAEAQADAGAGA...fAFFUBBAHBEBLBHBhADAeDHHZEBARCCBBBBDhAIATGBAACGAdDGCFFFBSGHHhAIAOEFH........hBAA......hBEA...,2,-14,-9,5
SDcYZOXBIdFRebMVWJATHQaCGfEgUKPLN,HAAAaAAAGACAEADEKAFCLAEADAIB.ZBFEBBGAdDGAREDBeCAA.MCEBhAAAVFAAACFB..TDFAhACAQGGA..hAFAfEHA.gGGANIABSBBDhAGAOFFB.IHDAhCAA.,2,-26,4,30
WCBUTgbFGaXHQcMZDVKeOYEIfSLdJRPAN,CAAATAAAFACA..GAEAHACBMAEAZAGB.KAHBeBCBEBEE..SCADhAAAdEEDREGFAAGB.BCGAhACA.bDECaGHD..QFDBhBGADBIB.ODHD.fGFAhDBA....hDCA...,2,-32,-4,28
dTSRaZICBYHeNGJDWFKPAUQOMcXgfVEbL,QAAAMAAA..XACAVACAEAFEdAFA.RBGFZCCABAHBHEEChAHAeCDAGFBBDCHBKDFBAAIBOEHDhBAA..fEEEhAAA.TGGA.aDHDCHHDNBBA.hCAA......hCIA...,2,-25,-3,22
bOdCQBcJPRFLDYUZaNVfIKEMGSTXHeAgW,...bAAAdAAA.QADABAEA.JAFERAFFLAHBDBIB.ZCAAhAAAaCAEfCEEhABAKCFAEDCA.GEAA.TEFAhACAHEEAAEGAOEEHCFHAFGGH.YFHB.hACA......hADA...,2,-30,5,35
IUHKOGgaMdEVZeSPRCFDcXfJbABTQYNLW,TAAAQAAA.LADAUACAHAEAGAGAaAGAdCGAECDAeDCBhAAARDDBDCIB.XEAC.hAAAbEEBADFABFGA.YFHBhCAAIGGAKGFDMDIB.SFDHhAEA.....hDAA...,2,-18,11,29
UJAKBXbVcNZCGRQDLdEgHPIYMfOWSeTFa,XAAAVAAA.ZACBRADFLAFB.EAHBHAEA.ICGAhAAAMCHBODAAeCEBaAGAhABAADIBBEEAbEFD..CDHADEEBhCAAdFCAgFGA.fGEAhAAASHGA.....hADA...,1,-5,-21,16
ceZLgFXJPRfSDaVNHYdMGIEQBWKTCbAOU,OAAAeAAAZADBLAEAFAFD..JAHBRBBADAIB..aCCBHCEAdDFAGEGAhAAAEDDBQEGAhAFAKFED.bGAAADBB.gGEAhAGA..fHAB..hABA......hAHA...,1,1,-30,31
HNMYBScgTEdZeVLJAGFOaCXWbKUIPDQfR,GAAAaAAA.CADA.XACDKAFA..UCDADAEARAFAHCFA.MDABhAAASBBD.TCEAhAIAEEGAeFAHLCHBhBAAABIBOFFBbEBAQFFCfGHABHCAhACA......hADA...,2,-19,-10,9
SeYfQBNMZDRTJcHUXGIgEaCVbKAFWPOLd,FAAAOAAAdADA..eAFAQADABBHAZCCARAFA..JBBFHDFB.GFABhAFAECGACDDA.KDBDADFBLEGBhAGASDHBfFFAhAIAMHEADGIB.........hAGA......hBAA...,1,-17,-24,7
CRdBaHZPcbSXVGMgJNUQTeLYWOAFDEKIf,EAAAKAAACACBRACA..BAFBHADBZAGB....bAFAXCCA.GDAAhAAAMCCBJCGBUEFAeDDBhAAALFDBODHDABIBDFIBhADAdFAAaFDHSGCFgFFG...hCAA......hCBA...,2,-14,-10,4
TaFYdENHcSXGLCQPfMeIZbOKUARBDgVJW,RAAADAAA..VAEATACA.FAEAEBHF.HCCASAGHGDAALEEAhAAAQCCBMDIBhABAeBHHbGDAKCFD.ABBBBEEDhAIAWHAG.dEGD.XGGACDFAIHHA..hADA......hAEA...,1,2,-18,20
dgXDIbEfUOLCAVPRcFaeJNSTQKYMBWHZG,RAAAaAAAeADE..SACHQAGCMAEAHBDBGBDAdCCCDCIBEAHFhBAAODFDABBB.PEHBhAAAFBFFTDGA.BFEAhCAAZFCAIHDAbGFA......hABA......hAIA...,1,-7,-10,3
VJegIWLMECBOTYKaRNbQcfAPGDUFdXHZS,GAAAFAAAHACBZADASAEAeAFE..ICDAMAHBBCEATCGAhAAAaCFD..REAAQEGAhAEAACFBDEABdEEA.XGGChAFAgGEAEEEB.CHGA.......hACA......hAEA...,2,-22,-6,16
BeIbTUQRDFOCEgNVWLSPMHGcfdJYaXZAK,eAAATAAARADA..OAGDEACE....gAEBVCCBLEABhAAAMAHBHCCAGEFAdDGDhAAAaCHDAAIBBECDUFCBDFIBhABACEEASFGA.fGAA.hAEAXGFC..hAGA...,1,-3,-18,15
SMgaYKVEIeTULcHBAWdONfCQJZGXDFbRP,dAAAOAAACADAZABBGADA.FAFARAEF..MAHBaAHD..KBBD.ECFFeCFHhAGA.LDDBhAIAHDBBADDB..fDGAhBAAQFGADDIBSCHHgFFA.IHHAhBDAcGFCNIBB...hBFA...,1,-16,-18,2
ORLWZEQcPSYgDbFJGMXCTKIBaefUdAHNV,HAAAOAAARADFZAFB.EAHFQADA.SAFADCABFCCHGDAAhAAAMAIBCBBDTDGAhACABCDDeCFFdEEAACIBVGFAhADALEGB.PGAAbFCD.KHCA.aEEH..hAGA......hBAA...,1,14,-19,33
eQSBfWFOTRGJaXKCUHVPALbNDYcZdMIgE,LAAADAAAZABEdAFAMAEA..EAHBeAHFBCCAFBDD.RCABGCFAhABA.aDHDCCEDHCGB.hACAADAA.bFBANEEA...IGHAhBFAQFBASFFDOFFB...hADA......hAIA...,1,1,-34,35
YZBXQWHVbfMONeUDKGJdTREIcLFCAPaSg,aAAASAAAZACB.QADAHAEA..bCEAMAGB.eAHBhAAAKBBDdECAECCBLDABhABAAAGAgEEAXCGDhADAfEHAODFHDAIBTGGAIHHACEDABFHBhAIA.WFBH...hBAA...,2,-24,9,33
RbBLAYKEfOaDePZQGdWMXVIcFUSJgTCHN,EAAAaAAA.DADAZACB.dAFAMAGB....XBGDIAHAFCEHSBCAhAAA.TDBAhBCAHEBAREGBLCHBhBDAAAHAfFFEeDDEGFBBcGEC.gFFBhBFACBBD.BHDA.hBAA...,1,1,-28,29
UEbXGTVBADFYKPLRWZMNJfCgQISOadHce,FAAAKAAARACFZACB..MAEAJAEB....CAGA.QBEA.OAHDhAAAHCFAeEEBUEDAECABhACAGEGABDHDAAIBDGAAhAGALFFB.fFHASHCAdHBB.hBAA......hCAA...,2,-34,-11,23
TbINPeSfZEGFHgROYQKJUcCDBWXVMaLdA,TAAA..bAAA..IADAeAEAZBEEEAFAHCAA.RDEAQEABhAAAKAHBUCABDCFAXEGAhABAaDCDADGA.SBHHhACAGEDAODHDcFDABFAAMIAAdFFAfGGAhAEAFHGE..hAFA...,2,-4,-4,0
MRaGWQHSJCOBLdcDZeKYPIVgNFTXUAEfb,EAAAMAAARACA.GACBHAFBCAHALAGB.dCCAZCCAeCFDKCHBIDAAhAAAVEDB..FDHDTECAhADAAAIBaBBH..QFAAhAFAOEGBDFABgGGA...hAFA......hAHA...,2,-21,6,27
ZdagEVAGDHXOLUPKWRSeQbcNJYMIfBFCT,HAAALAAAKADCRAFAeADH.QAFA..bCAAJCABMCEBhAAABAHATCGAaCCHECFBACFBGFEBhACAOCHDPEDChABASGAA.YHFGFFADdGGADHDA..hACA......hAFA...,1,-4,-5,1
SXLOAZBPWfaTYMCNHUJbdcKgEDRQFGeIV,ZAAABAAA....fADBaACAMAFAHBCAUAFAdBHAKBFCEBHFRCAAGDEAhABA..eCBBhAAASDGGLDEBACAATGGAhACACDGDbGFADDIBQECA...hBCA......hCAA...,1,-5,-20,15
bdAVYIDcSHPUZFQfKCgeGRBOMXEaWTLNJ,VAAADAAAHABC.ZAEBQADCCAGA.eAFERCFFMAIB.ECCBaBFDhAAA.TDDALEABhAEAbCGD.AECB...IFCAhAIASEEDFFFHKHGABEHA.XGGAhBAA.JHCA....hCAA...,1,-3,-16,13
CFWGANfZVDJbESQPRIeOKTBYLdHXMagUc,ZAAADAAAEACAQAEA.RAGB.eAEAKCAABCEDdBHAHCCA.aCEAUDGBhABAFEEAABBB..fDDEhACAVFAA.SEAAhADAOEGD.TFEAYHCGMIAA.CGHA.hAEA......hAIA...,2,-21,-13,8
AYTCaXFIBGMVUPgKdecJfRObHWQNSDLZE,TAAAaAAA..FADAGACAMAGB.UAFAKAHB.eBHH..fBBEhAHARDFBHEAAQFDAhAAADBDBECEB.AAEBXCAChACABCHDPEEBdGHAOHBCbFCD..SFHBhBAA...hAIA...,1,9,-24,33
BeHSXEKafLFDGdYZUAPROgCQMJWIbNVTc,RAAACAAA.MADA..IACA..bAEA..TAEAeBHHHCCAhAAAEAGEKCCAaCEA.LEEBhABAGCFAZEAAAEGBOHFChAIAgFDH.WCHBcEGDBFHD.SHDAhAAA..hAEA...,1,-2,-31,29
TfLbBOZRSEXQUMcKJaPeCgDVGFNAYIdHW,dAAAHAAA.TAEALADAOAGDRAGFECBAQCABMCEB.KCEDaCFHhACAeCHHDCIB.GDCAhAAAAAEA.IFFA.hAIAbGEAZFFAXGAAcGDACHHDFEAH....hACA......hADA...,2,-19,14,33
GPbHaDeKILYBMXZWUTcOdEAQRVJNgSFfC,RAAAVAAA..JADA..SADBCAGBGCCAHCFAeAFALCDAhAAABBHAZEFA.TDGAdGGAAAAA.hAIAQEECFHEG.hCAAbFAAaFCHKBHB.MFIB......hAFA......hAGA...,2,-19,-9,10
BIbdGMUOZXRWQLYPFDNJcfKeaTSHgCVEA,BAAAdAAAGADAMACAZADERAFALCHB.FCBDDAHB.JCBBKDFA.eDADhACAaBHD.HFDA.CGADADDBhADAICFA.ODDBhAAAXGFA.WHDGQEFA.hAFAPFEB.fGHAhAIA,2,-36,-13,23
OBGTadHEXSQZURFCLJAYVIgeKcWPbNfDM,VAAAeAAAKADA......PADAbAFBDAIBMAHB.GCDAhAAAdCCAHCGBEBFFQDGBhAIARECALGFAAAAAgFFBhBIANIDBBHBA.aDCB.......hBHA......hCAA...,1,-3,-19,16
PLHNZVdaRACfDFXeYEKQIBUcTSbgJOWGM,DAAAeAAAEACAQADA.BAFATAEASAGHJAHBGCCAhAGAMAIBHCFBZCCAaDFDABBBFEHDhAHAKDHD.UGGAbFDD.OEEHhAAA..........hABA......hCAA...,1,-12,-14,2
gMQTfOFCNYJBVGeDHLUbWcEXZIPKSAdaR,RAAAMAAAQADC..TADAFAFACBHA.JAFAGCDBHBBBLCFAhAIAUEEB..bFGDEDEBhBAAZGCAKEGA.ABBBaGCAOCCHhAAABGGADDIBXGED.IHCAhCAA......hCDA...,1,-8,-14,6
NVYgHBTefUEOJQRDdMPKZGabAFSCLWXIc,CAAALAAA.XADDIACA..VAFAHADB.eAFAECAAQDDAhABARCFAdEEAMCCBZFAAhAAAbDFA.ABIBFEHB.SDDDhAFAcFAAgFGBTGFA.OGDAhACA.DIAA.KHDA.hAGA...,2,-12,9,21
QPAdZKOTLIGYcUWXSMgfVJeHCRDaFbBEN,ZAAATAAAGAEA.UBGASACB.MAEAfCAAhABA.eCCBHBDBREABaACAhAGAbAFAECFE.QEFAhAAAAAHAdEEDLEHBIHCAYHFAcFEC.hCAAWCCD....hCAA...,1,5,-17,22
gOcJNRSbUaeLIDXfFHTYWEKQAdGBPZCMV,GAAAZAAAMACAOADA..JAFBRAGBSCDAUCCBLAHBXCFDhAAAHDFA..TFGAhABAEDCBAAIBdFFABEBDCEHA..hBEA............hBHA......hCAA...,1,-21,-26,5
LHEIACBdZgWYDVKUfTNeJRQPOcMbXGaFS,dAAAZAAA.....gADADACAKAEATBGAeAFH..RBGFQCBDhACAOCCB.bEACaAGAhABA.LDEBHEDBAADABAHBhBAAVGFAUDGBfFFBJFCB.MDIB.hCAAFHFA.....hCBA...,1,13,-21,34
NFXCYWcILUJbHBOMRAPEeVSTKGfQagdDZ,EAAAeAAA..SACAGADAaAFAdAFAZBFFXBGDCBHA...hAAA...cDBAhABALCCBbEFA.HDADMFEBhAIAAAHATEEAQGGCDEGAFFHB....hAAA......hADA...,2,-18,-2,16
MPEIcXDbJdNKLSOgAWBHRCGfYaQeVFTUZ,HAAARAAAGADAaACAeAEHFAFAZCFB..EAGA..XDAADBIBdCCALCGBhAAAOBHD.ADFACEEAQFBBhAAATGAAMEIBhAGAIFHAJGEA.SFDH.BGGDhABA......hADA...,1,0,-20,20
TKJgMQGCLeBRHFIOZfdcPAYVDUNEaXSWb,DAAAEAAA...aABESACA.TAFAKAEAMAHB.GCCAhAEAeAHHHCCAOCFBdDAAhAAAAAIBUEGAXDFDJGAA.hAGAQECBBGFDIHHAfFHA.hBAAPHAANICB.WHEGhADA...,2,-23,-16,7
URLAXOCTEVKfQgHSPNBJDFbdZWeMGIcYa,CAAAEAAAKACA..QACAHAEB.SAEABAGAFBHDZCAAeAGHGDFAhAAAIDDA.aBHDhAAAREAAACCATEFA.fFAAhAFAgGAAPFCBDEEBdEHAMEIB.hACAcFDA.LHEAhAIA.,2,-16,-6,10
OSITHdAMRaENGYcFCeQfXJWbULDKgZVPB,RAAAEAAAGADAFACD.eAFAQAEA..XBGAJAHB.bDAAhAAALDDA.KDHBhAAAZDGFBCEDSEFBhABAHEAAAFFAaFGDcFAAfGBADDAAgFDAhADA.....hAEA...,1,5,-25,30
LcNQbYGaCMUFeBTWgZOEIHKDVdSPRJfAX,LAAAQAAAGADAaACE.MAFAFAFAeAHHBBFB...TBEAhAAAZBGBECAAHDAADCIBdDFChABARDDFACDBXDGA.hACAbFFBCFGAWDDD.OFHDKGDD....hCAA......hDCA...,2,-20,10,30
NQRCLfOHDeKdIMGXaFcPgJWbYZEUSVTBA,RAAALAAAHADBeAFAdAEAGAGAFBHD...PCAAgDAAhAAAJDDA...bCFDEEBASDDAhABATFFAAAGBQGDChABAOEHDKGAAMHEAaDHD.....hACA......hAIA...,1,5,-13,18
gCELGbHMWeVYXadITfOPcASQKZUDFNJBR,QAAAZAAAFADABAGARACA..EAFEGCAA.HCCCeAHH.XCDAhAAAdCFATEGAOCGHhADAAAIBKCHBDDIB.JECALGAAhABAbFGD.MFFBYHAAaGGC....hAHA......hCAA...,2,-10,-6,4
HFYRKUZBefVIDbgNdWTAJcCaLMGSEXOQP,CAAAaAAAGACA..EADAQAEAHAFARCCAZCGBeAHB..fDAAhADADCAB.bEEBdDFAhAAA.ACBBLEEDhACAMDIBOFCBFDHHKEAABBBDgGBATGGASGDHhAHAXGGA...hAEA...,2,-16,8,24
ONJVfBbTLFIaQZRceYdDGSXEMCUWAKHgP,HAAAOAAAVAEABADALAHBFAFA.aCACRBDA..eAHHdCCAGDFAhAAAEBBB.MEABCDDDADFA.KEDBhACA...PFHDhADAfDHAIHCAZEFFDFFBSHEG.hBAA......hCAA...,1,14,-36,50
EFHBSYLDAeRTdJCNOgXKcVQGIZPabWfUM,RAAAdAAACADB.OADA.KAGAQAFA.ZCCAbABDUDGA.EECAhAAAHCEA.SCGEhAIALFABACEAeEBATGEAhABAgEFA.XGECcGGA.IHHAhBAA...hAFA...,2,-25,-8,17
MLRAOQCGdfENbKgDYJeaUWBHPXTScZVIF,QAAAdAAAEADA.KACADAGA.eBDAaAEABAHAHBGB...TBEAhAAAZABBFDDARCGB.ABIBGEFAhBAA..bDCBgGCAhCGAUEEAXGFASFHBIHAA.hDAAMFIBCHHD.NICB...hAHA...,2,-14,-2,12
MgDaSYLOAQTKWZfUeXVRGIJdFENCcHbBP,TAAAZAAAeACE.RAFFGCDAdACAEAEA..CAGAHCDABAHBMCCB.DCHBhABAaAHDLFAAACFAQDGAhAAAKEHBUGFAXEAAhAEA.IFEA.FGFD....hCAA......hDAA...,1,-8,-15,7
QYJBNSIFWDfZUaRKgbXOcTdeELCMHAGVP,GAAAQAAABADASACAFAFADAIBZCDARAEFKAGC...XBGAhAAATECA..ECGEMCDBhADAHEEBADGA..PEEAhCAANDAA...fEHAaEHBOFBBdGGDCGHA.hAAA......hACA...,2,-18,-10,8
gNLYcEFAbVUfdWRPGTBKQSIJMaXODHZCe,UAAAdAAARADAGAGAKADA..QAFCSCAAMAIBOCEDHCBChADAeDCFLDFB.hACAEDHBAAIBbDFD.fEAAhADAPECBBEEAaDHDZGAECFHDYHAAFGHD.hAEA......hAGA...,2,-7,2,9
fSOaCYHZNgJDIMQXLGcPAdWRUTBEKeVbF,RAAATAAAEADE..eAFEFACA..OAEDCBFAHCCAZAGB..JCGBMBIBhAAALECAGCCAAAAAdFHAhAIABEFA.bEGDaGGB..hCAAgGAADCIB.XFEC..hAGA......hBGA...,2,-13,-12,1
PQCTEHaeYDbGcdRVMWgXIBfLSZJNAOUKF,KAAAQAAAEACE.HACAeAEEDAEAGBDBRAGBMCEB..XCCChAAABCFALEGBZDEEAAHAFEHDhBIATFCAaFFB.bFEDdGDAhCAA.gGGG......hCBA......hCIA...,1,-4,-10,6
JFXLZMIdgQAPUDaOHeYCTcKWBEfbRGSNV,DAAAHAAAeABATAEAKAEA.EAGE..RAGFGCCASCAA.VCFAhAAAXEFAZDAEdEEAACCBUGAAhAGAaEHDCGFABHHA.NIAB.hACAFCFH.MDIB.gGGG..hAIA......hBAA...,2,-21,7,28
RUcAMdPIBGNLbWFZSfCYXKJTaEVQHeODg,dAAABAAAGADALACAFAFAZABBCAGA..KBHBaAHD..ECCAHCFAeCEFhAAADDDB.REFA.AADAMCGBhAGA..IFBAhBAA.NIEB.bDGD.fFEA...hBDA......hBFA...,1,-16,-33,17
eYBDPbcCXURFfSMHGVKJAQNEOWIaZTdLg,EAAAOAAA..aACDdAEALAEAeAGBDAIB....bBFAXBBAhAHARCDBSCBDHCFBGEBAhBAAKDFCAAFAQEGAhAAAIEDAZFFAgGGGBEHACHHD....hAIA......hBCA...,2,-11,-7,4
VOKLXPQcbEaDGMdefHAZYRFSBNUIgWCTJ,RAAABAAAUADA..IACACAFA..JAHBKAEA.LAGB.hAAAQCCAECCBGCFAhABAeCFDHEDBAAIBZEAASDHHhAHANCIA..TGGA.XGCAhAAA.....hCAA...,2,-32,-16,16
SVbEYRFWJZQfCAcNHdOgMLeGBKDaXIPUT,HAAAdAAAMADAeACEGAGADAFA..aAGEXBDAUCCA..TCFAhAAASCAA.EDDBhACAREDAFDHDZEBFQEGBhAIAACHAOFCBBGGAKFEAIHHA...hCAA......hCFA...,2,-14,-4,10
VWeCaMINPbYFUGAcKfdEDgBZHXSJRTLOQ,KAAAEAAABACAHACBSAEARADF.LAHBQAFC.eAHHhAAAaBFEMCAB.IDEAhAAAbDDAFDHDACCBdEGAZFDAhAHATFAA.OFFHCHGA.NEIA....hCAA......hCBA...,1,-3,-21,18
PJXYUOLTVMfRKdgNDEbeWIBHCFaSZGAQc,QAAAJAAA.UADATAEA.MAHBRAFAdCHA.DDBA.EDEAeCCBhADABEDDHCFB.aDHDhAEAGGABAAIB.XEGChAAALGAAKGHBbFDDCHGDSHDAZFFA.hAGA......hBAA...,1,-11,-12,1
ZgIUKGEHBLOPeDFVTXQcdbWfAYMaCRNJS,aAAARAAA..SADBZACBUAFAGDEAHAFALCCA.eCGFhAAAFCHDTEBAQFAAhABAdGDA.bEEDAAIBMBBBCDHAgGGBhAFAEGGABHBADEEB.......hBAA......hBEA...,2,-18,10,28
WIYTNVDaGfHJCPKgLOFZQAUceREXbMBSd,eAAAEAAA.MAEAdADA....IAFATBCADAIBGAGAHBEBCBCCKCEAhAAALBGBZDDAAAIBRFFAbEBAhAAABHHASDHHhABA.YFFA.aGCB.....hCAA......hCBA...,1,7,-28,35
QXMOaSJRHUIdAWgfLDKFYNZecEPCGbTBV,...fAAALAAAFAEAZADA.EAHBGBGATBDAQCAAhAAA.MAEAaCAARCFAHCDBhACAdEEAADDBDAIBKEHBeEGDhBCACGCABGFAOFCBSHEG.IHHAhABAYFFF.NEIA...hCDA...,2,-13,0,13
eVCZGPUWXDIBfEHObLFJATMdNYaRKQgSc,dAAAaAAA.RADAKAGC..QADA.SAFAeBHFZABBGCEAhAEAPBBB.XDCDhBAABBHAHCECLFHBhCDAADABMDDBgGCACDHADEEBEFFAbGACTGFA..hCGAYFHB..hADA...,1,0,-18,18
RGAKVDfMIXdWJQagHbScFYNePBCOZTEUL,DAAAMAAAdADA..QADAHAFASBBBFAFEeAHHCCEA.ZBBFECGARCFBADDAhBAA..KDBD.VEEAhAFAXEED.aDHD.hAHA............hAIA......hBAA...,2,-34,-19,15
XObNEMZICFfdUceJDLPQAaBSGKYgHTRVW,aAAAGAAA.KADAHACBRAFF.XAEAOAHD.EAHBZCDF.FDGDdCFDUFAAhAAAeBBD.LEAAhAEAADABBFDD.SDGAhAFA.TEEAWEHH.MFHBCGGC....hAIA......hBAA...,1,-3,-26,23
AfdVaWFOLNegTXRQKMSZJHPBYDGCEcUbI,dAAAaAAA.OADALADA.eAGHTAGARCCAKBBDZBDA.HCACBCHAGDEAhACAEEAA.UEBBAAEAVEEAhAIAFCHDXGGAhAIA.SGEDPFCBCEHBIGHA.hBAA......hBCA...,1,1,-11,12
IgfMdaOGENJbBKeQZPYSALUFVCWRTXHDc,LAAAFAAACADA.RADFHAFBDAFA...IAHAMAIBdBFAGCAAhABA.ECCBJCCBKCHBeCGHhADAZEEASDFGhACA.AFABUGGBTEDA.XFGA.fHBBhBAA.aHFAhBHA...,1,8,-48,56
FRgeETXdbMVLUKHOZDCIafBQJGYPNWASc,FAAARAAAEADEdADA..MAFALAFA.HCDCZBDECBHAaCCHBDEA.GDFAhAAA..PCHBhAGAACCBSDHBeDBDbEFDhAHAKEDDDEEB..fHBBQGCDYHEAhABA....hBHA...,1,-5,-31,26
FNegXHdLJACEOITPQVKbMcWUSfYDGRBZa,EAAATAAA..QACAKACC.MAFAUAFA.SBDHhAAADBEARBFAaCCC.eBHHHDEAdCCChAIAADHAOEHDIDFAPHFChAAAbEEC..fFBABFGC.FFHD.hBIANIEB......hCAA...,2,-14,-6,8
RgITEMScfUHKXebDVWCPdaFQYJZGBAOLN,LAAARAAA.TAEAEADEMAFA.SBEAUAGAHCAAeBGHhAAAbCEC.DBIB..CDHAaEAChABAQCCCZEFAACCAOGEAhACAgEEB.fEHA.XFDDhABA.WHEAhCAA...,1,-2,-31,29
afKHTGXcUYVRSBFJgbMNCILWQODEZAPde,eAAAaAAAHACBGADAUAFARAFAFCCH..JCHBMCHB..CAEDLDEBhAIAQFAAEFHFAAAAdDFAhAFAKGDD.TGGA.XFEChAGAcGEDSBBD.BHBAhBAANCIA......hBHA...,1,2,-23,25
UBgHTbeaDMNLSKEVJPQXRYGOCfAIFdZWc,dAAAZAAAUAEAHADAeAFEDAHB.MCCBLCABECGA...JCCFQDDAhACA.REGBGGCBhADAfCHAADIB.FEEAhABABFCA..bFDD...aFGD.KGBA.hAIA......hBAA...,1,-5,-28,23
BJSFHYVUCWAPQZMdEgGDKLXbNRfeITcOa,ZAAAEAAAGACALADB..XAEARAFAeCAB..TCGAaAHBSBHHhAAAHCEBUFABAAEAMCBBhBCAdFGADCCBKCEA.bEEANEIA.hABA..IGEA.BGGD...hACA......hAFA...,2,-5,-5,0
UgRPacdJDSXYIHVGATeBZFLfbKEMNOCQW,eAAAZAAALADBKADA.EAFAMAFA.CBFA.QBGAUCCA.RCABaCFHhABAdBHASDFBhAAA..XEEChACAHEGBAEFBFHCAbFAAOEHB.....hABA......hCAA...,2,-28,-4,24
BNfDAIEPSOHYRVcTXMGFadZeQJbWKLgCU,EAAAOAAAHACARADA...TAGAGAGAdCCDeBBBQCFC.hAEAbEAALDDA.hAAACEHABFCADAEAACIBSEEDhAIAcFDDMIAAZFFBKGAANEIA.fGFAhAGA.IHHA.hCAA...,1,-1,-11,10
RaGfLMIFJEcHKNXAPbWYeVOgZQDUTSdCB,...bAAAeAAA.OADCZADBQAFADAFASAHHdBHARCABGDEAhAAAMCCA.FEGAECFFHFCBhABAXDDDACCB.PDGDhAAA...YFHBgGGACHBA.hABA......hBHA...,2,-30,8,38
XScTZMHYKOebEgCWVAUdQPfJBNRLGFIaD,dAAAQAAAJADA.RACAGAFAFAGA.aAHFSBDD.ZCEBhACAHCDB.ODAAhAAAECBFCCGA.ADHAfEGAhADALECBDCIBTFAAKEGAeGEAgFDA.hBAAWFHH....hAFA...,2,-25,-7,18
OaVDdWRbJgFEUSPTNMIcZKXLGYBHQfCeA,aAAAdAAARADA...JAHBEADA.UAGA..TCBAMBBBZCCA.LDGBhADAGCFAHEAAhACAQECAeDEDAADADDIBbGAAhAGASFBD.IHHAKEHBBGHDOFFHhBAA....hBFA...,2,-20,-6,14
YFGdIUQfNMPeVHDaBSRbXTCAKJWEgOZcL,KAAAEAAAZACBLACBGAEAdAEAUBGA..QAGAMCBB.eCFFhAAAHEBBaDGDREDBbFFBTEBAhAGAAAGA...gFGAhBEAOFHD.FGEBNIAB.DDEB.....hAAA......hAIA...,2,-7,-2,5
eNBcgPKCUFZEWSMfbdaLDOVYXTAQIGHRJ,GAAAHAAARADFeAFEBADA....PAFACBFAZCAAECGAMBFBdEEAaBGELEHBhAAA.OFDHhACAXDCAAFHB.QDGAhAAA.IFFAcGED.KGDA.FGHBhACA.SDADhADADIAA...,2,-22,-3,19
YFgJPSKVBGCNWEdAZeUOcTXILQHDbafRM,eAAAOAAA..TADALAEAHAFBaAHDRCCBMAIBFBBH..JCEAKDGAhAAAGDBBCEFD.EDHFAAHBZFAAhABA.XFGAhAFAQFAAbFDD.fEFA.gGGAhAFASHFE...hAGA...,1,7,-17,24
WQRSeDKEGUCFBdPOMcJITZafYVgXHLbNA,RAAAeAAAEADE.GADA.FAFAdAFA.MAHBICGAaCCA..VDEAhAAAHDBB.LEFAhAAAAAIBQFGAKFDABGGAODDHhABA...........hABA......hAIA...,1,-18,-23,5
DFAOHZLRYVUBQWNKJGMdgeSTCaPbfXcIE,HAAARAAAUADAQADC.KAFCGAGAdBHAeCABTDDACCCDaCED.hAAA.bDFD..XDFDhAAAEFBAAAGBLFHBhABABEDDJFHBMIAASGCA.fHEFhACADCCB.....hAIA...,1,0,-14,14
SGfNdBgIHEJTRKbeVZDLWcCOPYXMAQUFa,QAAAaAAAGACAdAEBBACAHAGBEAEARAGBeBBDZCDA.LDFA.hAAACEDAOFBBXEAAAAIBSFFAhBAAfDHAgEEBhAEATGDAKGHBDIFAPFHD.MIAAhAIA.FGCE....hBIA...,2,-10,11,21
dQeNUOVDKGISTPEMBbCAgLZcHfRJWFYaX,ZAAAHAAARAEAFBHDaACAdAFA..eCABOAHBKCCD.GCCA.TEFAhAAAECFFMDEBBDHAAAEALEHBhABAfFBAJECBXFDDhAIA.NICBDGHBSFFA.CHAA.hACA......hADA...,2,-23,3,26
ZGNbFVRHgQMSEXWYfecTLOaUPACBIKdJD,BAAAdAAAZABBGACAFADDHAFAMAEA..ECEFXAGA..fCGAhAFAeBEGLCABhAAAaCHDAAHA.KDFA.DDIBbEFChBAAREDBQFFC.SHDGhACAcGGAODDHCHHA...hBCA...,2,-10,-9,1
bMDJTPGeKSdNFcAOgBWfHaIRZUYQEVLCX,BAAAHAAARADFZACAQAFCEAFE.LAHBXBGAMCAB.TDEAhAAAeCCBdDAAFCCHAEHAOCEBhAAA..fFGAhACAaDGBIEHAUGDACFEADGGA.JHAA..hADA......hAEA...,2,-24,7,31
UgIcCVQOHDNPeJYLXKRMGBSdEaZWFTAbf,UAAA..gAAACADA.QADAHAEBDAGAeBGHLAGBhAAARCBAGEEAdCCAEDAAZGBAhADATEDAABIB.bFBDfGHAhBAAIEHAOFGB....hABA......hADA...,2,-18,-8,10
AOZTbdEIXVceQDGKYPBRMCFJWagLUfNSH,ZAAAdAAAEADA..XADBeAFAGCABKAFABAHBRCFAFECD..aCAALEEAhACA.fFHAhADAHCEAACGAbEEAIGAAhAGAQGEADGGBMIBACDDD...WGCAhBAANCIA......hBCA...,2,-20,-8,12
UFaBTDAPdQMZINXKGgcLbRSJYeEWVfOHC,dAAAZAAA..XADBGADALAFARAFA.SCAAeCABECCBVCEBhABAHCFAFEFH.aDBEhACATEGAAAGAMEHBKCHB.hADAbGAAYHCA.WFHHCGGDDGAA...hBAA......hBCA...,2,-10,-1,9
JEeIVPBFYbODLTAHcdURCaXKGgfQMSZWN,HAAAdAAARADA.aACAGAGAQAFAZABB.JCCAECEF...eDCFIDGAhAAABDFAFEAB.ODHDhAEATEEAAAIBCFFAKAHB.hAGAMDIB.SFAA.WFCH.hBAAPHFADGHB...hCDA...,1,-4,-15,11
YeCGfWRZQUVDTdFIXgKSLHaMEBJNOPbAc,eAAAGAAARADAZAGBQADA.DAGAdCCAXBFBSCFDHCGBhAAAEDHFBCDD.ODAHhACAAAAACEAAUFGBTEEAFEDDKGAAhAEAaFDHMFIB.NIBB.......hADA......hBAA...,2,-20,-1,19
fHOKSaXRcMBQDPJeFgWVINbUGCTAELYZd,EAAAZAAAHAEAKACA.aAGARAEFBAGB..QCAADAIB.eCDFhABAFCCB.VCFA.bEECGCFAhAAA.ACHBdEAASEADhACAMDEBJEHBgFGA.NICB..hAEA......hCAA...,2,-33,9,42
KWHOaYILSDCVXBMcRdAPgJGEbZNUeFTfQ,JAAAEAAAZACB..eADEFAED..QAGAHAGBaBCELDDAhAGACCBC.BCEARCEAADIBGEEBhAAAbEFA.TGAAKGGAOHEChAIASGHBDIBA.MHEA....hAGA......hBCA...,2,-14,-14,0
BXgVGbJTUDPOWYSaeFNIQEdCRcZHALKfM,LAAAMAAABADAXADDGAEA..JAHBTAFA..DBBBOAHDhABASCBHeCABFCCHhACAQDGBEDFAREDBHFAChAFAAAGAKDDBfFFB..bFFAPHEChAHAaGBA.....hBAA...,1,18,-33,51
fPgeXJdbRMVBQKLDTaWcNYIEFSCAUZHGO,HAAAGAAAOACA..fADAeAFAdCCARCFAMAFAQEDAhAAALBFAaEHBNCEAEDFACFCDABIBZFFFhAGA..XFFAhAAA.bGBCBHHBDDABWFHH....hACA......hADA...,1,-2,-13,11
NOgfeCPHYQBEXcSAbGKIMRUdDaFVZLTJW,GAAAMAAARACA.dADAFAFAZAEB.LAHB.JDDFOAHD.eBBBhBAAHCFBQCFChCAAEEHFSDBHADDAKECADEHBhCEAaFFHTGBA..gFDACBGBBHHA.hAAAbGFA.....hACA...,1,-5,-15,10
eFcbZgCKLUNWVBdDAOSaTYXGJEMHIQPRf,aAAATAAAGACA..EACEHAEA.QCFARAEFeAGHFCCBZEAAKCHBhAAALAHBUEDAVEABhAEAdEEAABBB.SEHHhAEA.XGAAMEHBfGFAgGGGhAGANIABDGIB....hAGA...,1,15,-10,25
DWLgPaVeUcXRJCNABfFdQSZOEGMYIbTHK,FAAAdAAAZABBEADA.GADA.MAFAIAGAHBFBDBIBLBFA.hBAAaCCAeDDDUDAARFBBCEHAADDBQDFAhADAOFEDTGGAhBDAKDHB....gFDA.cGGAhAIA....hBAA...,2,-24,1,25
IeAOVDKgBYNcPbZaEQWMTCUJRdLfXHGFS,DAAABAAA....NADA.bACAZAEA..EAGAMAFAUCAA..RCEAdBBAhBAALCDAHECCGGEBhBIASBHHACEA.KECA.hCAAgEEBPDHD.aEGA.TGAA.hCBAfFHE.hCIAFHCE..,2,-16,-11,5
gWYbQcKOHEZaGIXRMUCPeABdNfFTSDVLJ,dAAAFAAADADALADA.JAHB....gAEA..hAHAbABDQBGAhAIAOCEBHCFBEBCFGDDAhBAAREAAMDIBCFFDADDBfDGE.TGFASFHDhAEA.YHAAhAFA..,1,-10,-32,22
MXYgDCQcGSbWAdTZOBNRPLIVfeaHKFUJE,ZAAABAAARAEALAHB..fACAHCAAFCEHEDGBMAEA.XAGAhAAADACAQFAAhABAGBDAbCADACGAdFFATCGAhACAOEHD..IFFA.eDCB.hAFAaEHD.KGCD.YHFAhBFACHHD,1,-10,-20,10
KEFNHRPQcGZCefAbXMaLdODVTJIgBUWSY,MAAAdAAADADA..TADAJAFB..BAHASAFB.EAHBHCAChACARBBB.QCGAhAHAZCFAeDEBAEGAaDECLFHBhAIAOEBB.gGFAUFFA.KHCANIDB...hBAA......hBCA...,1,1,-28,29
BYVZdSbRIHQNLOeXWGgfCDFPMJEcaATKU,TAAABAAAZACA.dAGARACFHAEBLCCB..eAGBGDGACAHBFCAHMAIBhAAAEDEBACIBKCED.UEAAhADASDGD.bEAAhAAAQFECOEHDWHEADGDB.....hAEA......hAFA...,1,2,-20,22
dWfHKcBNYLRUSVTgFPCMGOeEbDZQIXAaJ,dAAAHAAABADALADBRAEF.SAFA.TCFAFAGAMCCBhACAeCAAECGAZEEA.QFAAhAAAADAAaDDB.fGGEhACAKDHB.YHCGgEEACDHAOFCChAFAbGCCDGGA...IHHAhADA,2,-32,-3,29
XGaJFdEeSDRZCLgVUcONIBMQWHAYPfKbT,...fAAAbAAAGAEAFADAdAGB.EBHBeAFH.RBCBZAGBLCABhAAAUECBOCADBCCDMDEBhABAHFEBAAEBKDGAaCHDDGGAhAAACFFAgGDG.......hACA......hBCA...,1,-6,-7,1
cXVFYTdKEBUANQCOWPfDgHebZaRLSJMIG,QAAAOAAA....fADAHACAeAEEaAEDRCDALAHBhAAAMAGBGCGAXECChCAAFAHFdDDAEEGAABBBCFEADFFBZGFEhBAASGCA.IGGA..hCEA......hCGA...,1,-7,-14,7
AXKCSJRaHbLgDVIWBFMYdeUOfTPGNZQcE,CAAARAAAHADBLACADAFA....VBGBBAGAFCCHdCCA.eAHHUEEATDFAhAAAGDAA.ZGFEEDAAhADAAAAA.KEDA..aFDBbFCChAEA.....gGADMIAAfEHAhADAQGGA.SDHHhAGA,1,-7,-14,7
EUMaIcRSWTbGHJFZfLQgBVDPdXKeNACYO,OAAAEAAAUADA..aADDRAFA....TCBAHAFAZCCA.LCHBhAFAQCGABDBDDDEBhAAAdEEDeDFBAAHAMFCBSFFDhAGAGGDB.fHGF...hBAA......hBBA...,1,-16,-18,2
LKAPGgaYTMQEWHcbRSUDCeIVNBOFdfZXJ,GAAAaAAA.MADAEADAHAFARAFA.DBBBeCDB..ICCAhADABCEBdCHAZCEALDGDhAAAAAHAPEEBTEBA.WFEHhACAbFCDCCHB...OFHBfGHAKGFB.hBAA......hCAA...,1,-9,-13,4
DeHSXWZKNdFTRQCcMOBbPEIGUVLfJagAY,eAAAHAAAXADBZADBdAGARCEF.QAFA.MAIBbDBDECHFGCABhAAALFGBaCFCAEEASEFAhACAKGEA.TGEAhBHACBCA.BGGB.......hAAA......hABA...,2,-23,9,32
RSKUAFWPJaZTGcOHYENbgeLCXIQVDBfdM,FAAAJAAAZADBGACA.HAEAEAFA...bCEAeAHF.LCCDhADACAHBQEAABDEAdDGDREEAKFHBhAEAAFFA..aFCETGCAhAGAOFGDNIEB...........hBAA......hCAA...,1,-1,-27,26
BYFLPbJTRGfaXgICcHdWOVAZQEKeUSNDM,EAAAeAAAUADADAEABAGALAGB..JBCBRCBBGDDA.aCHDXBEChAAA.CBHAHDEAhABAdFGAOFBBADGA.KGCBhAAAMDIB.FFBA.bFGD.....fGFAhAIA..hBFA...,1,-15,-32,17
VQSNZdPHgEBLaWARXYCTcMDUIKOeFbJfG,RAAACAAA.MADADACA..KAEAeAFA..FAGAJBDBGBCA..QCFAhAAAZCEBHCGBEFGBaBHDACCBhABA....TGDAhAAAIEEAOCBHbFCCSEHH.hBCAdHFB.....hCAA...,1,-13,-27,14
MRSQGAFdTHUVbcLCJBafXgZYWDPKeOEIN,dAAAHAAAUADAVAEALAGBBAHB..aCAC..XCAAZCCBDCHBeDGDhAAAEDDA..MAIBhACAREABGEDAABFAFEFATGCAhBAACGGD...fFFEWFHH.OFHDhBCA.....hACA...,2,-13,-12,1
CVGUKESYPacRNLMWOJfQFIBgHZXDTAdeb,eAAACAAAGACAEADA...SAEAaAFD.RAGFLCABMAHBOCCBhAAAQCEDBDEAHDFBhABAZEFATGGAAAIBbECDKFBDhBFA.PFHDcFADNICB.fHEB.hCAA......hCBA...,2,-4,-1,3
aPbOCTfBKRgMcSDGXVZJWEQYLAeIHdUNF,HAAAdAAAFADAaACA.OAEDCAGABBDD..RAGBMCCBDAIB..GCABhACAZDCBEDHFLCFBAAIB.hAAAeCHBIEEA.hAGAPFGBbEGD.TGAAKFDA.SGDAhAGA.....hBAA...,1,4,-32,36
XPTUdMHWfeAYbNSFCgRGcaKILVBJDZEOQ,...bAAAFAAA.RACFaAEALAEA.BBHAZAGBEBEFQCAAhAAA.TCDAdEEAHGCAhBAAeCFGABIBSGFHhCAAGEFAKEHBIFAADEIB.XGAA.hCBAMFEB....hABA...,2,-22,-5,17
HcNZaCREbSBWKPdfUQOLXAFMJVeIYTgGD,MAAAeAAA...TADAGADA.HAFAZAFBRBBBECCBBAHAKCGAdEFAQDGAhAFALEHBACHAFDEHhBAAIFAADFCB.aFDBbFCDhBBASHAA.fDBEXFGC.hCAAYHFA..hAAA...,1,-7,-12,5
fbEUZDHQgdPeYKcGAFTIaCNWMSLJBVORX,TAAAaAAA..CADA.MACALAFABAFARAGF..XBBCEBDBZDDAHEBAhAAAdCEAeCGBKDHBACCBFDAHhADA..IGDAhAIASCHBOFFBbEDAQGAA.PFHDhAGA....hAHA...,1,-7,-14,7
CfWYEKDHAIRNgTPJVLMbQUZBOXcSdaGFe,RAAATAAA..PADALACB.MAEAQAGAZAFEBCEDXCCAhAAAdCGAGEBAeCFBhABAfEEAEDHBHFEAACCAhBIAgFGAJHFE.......hCAA......hCGA...,2,-10,-9,1
FMCSbaILgWHJcDVOENfXKZdeTGBYRQPUA,MAAASAAA..aACELADAHAEBDAGAEAHB..XBBChBAAdCCAeCFBGBGAREABQEDAhAAAABIBbDDC.gGGAhABAcFFA.OCHBKGBA.TGCA.hBGA......hCAA...,2,-15,3,18
eGFBQTWUcCPgVbYZHRJdKIANXOfSLaMDE,OAAALAAADAEAEAEAGAGABAGA..QCAAUBBB.CBHA.PBEBhAIA..bCDAHDFBhBAARDGFdEEAABFA..fFEEhBIAaEACeECHFGGHWDHH......hCAA......hDAA...,2,-27,-7,20
BbfEXUHOAJgGRDWeVLCSZdTNIQKcFaMYP,GAAARAAAeADELAGBZADAdAHA..TCDAQBDDFDCH.aCCHMDGBhAAABDHAEDHBHEDAAAEADEFBhACACFGASFHHhAAA.KGCAPFHBXGEDOGAA.WHBAhAGA......hBAA...,2,-14,0,14
XeQAVPfJNDYgMLWBSGIERKHcdOZFUTabC,VAAAJAAA..DADAMADALAGB.BBDAGAGA.RBDBHDFBhAAAdCFCZDDFTFBA.aDDHhAIAbFBBeEHH.ABFANIBB.hAIA.gFFB.SCCDhBAA.EDHF....hBFA...,1,4,-36,40
AdZMHaYCDJfXLbQOWTcFENeKVSRUIBPgG,ZAAAHAAAaACADACA.JAEBLAFA.QCCBTAGA.ECFAeCCBhAAAKCHB.RCFBBCHAGEEAhABAAEEAdFFDMEHB.fFCAhAGAbGAA.OHACFGHD.SGHHhAHA.....hAGA...,1,5,-19,24
GMQCIBAcHFNWdJfOXRbeDLPSTEVgKZaYU,HAAAFAAAdADAOACARAFA.eAFALCCA..TCCAECGAKDBDaBGEhAAAGEEAMCFBQDGAhAGABDHAAAFA.cECChCAANIAB.JFGF.XGDADGHB....hCCA......hCEA...,1,-2,-28,26
dcXfIEDZTFAGQHeJKYaWPOBgRLUSCNVMb,HAAAeAAAKADAaACAOAEDRAFF..LAHBCAGA.MCCBdCCAfBHAhAAAEDDAZEFA.ACGBGEDAhAGAQFACYDHBhAIABGEASGGB..bFFDIHCAhAAA.DEGA.hCAA...,2,-16,-10,6
ZXcLIPgeYJGUAVCMbEaSHQRdTOBfWNKFD,MAAAEAAAHACARACA.dAFABAFB....fAHAKAHBZCCALCFBhAHAgCCAeCHBGDFAhAAAABBBCECA.aCHDTFGAhBAAOEAB.FFDBDEEBIHHAJHEA...hCAA......hCEA...,2,-24,4,28
ANBKaXVFSTfHIYCWPebRGEZMJDdgLUcOQ,KAAAaAAA.FACA..TADAHAEBCAGA..eAFERCCBZCGBMBBB.dCCALEFDhAAAOBFCADABXGAAhAGASDFA.fEDAhADAIGDA.PEHDEGGEDDIB..gFFDhAIA.QGDDhBAA,2,-29,0,29
PIRMKYOWgGUfDceFSdVCTZENABLQXabHJ,LAAAaAAAHACB.JAEARAEAKBHB..OAHDGCFADBEBeBBD.dDEChAEATCAAEEHFBFAAQCFChABA.bCCDMHAAhAFA.YHDGUFFAFHAACHHAAIAA....hAHA......hAIA...,2,-16,0,16
CIGTWJBDgRdbZFeAHcLfKOPQNUEXMaVYS,HAAALAAAOACAQAEAEAFA.aAGESAHHGCAATCCAhABABCCARCEA.ZECAACABKCGAhACAPDHDXDFC.hAAAMEEBCGEDIGGADEIBbFGDeHAAfHBBhBHA......hCAA...,2,-16,12,28
EQAVLZPHeSgBMfdCNIXTRbaUKYDGcJWOF,ZAAAHAAAeACEBADBdAFACAFA....XAGDRBGFaCCC.KCADGDEAhABAJCCA.FECBAAIB.LHAAhAHASDEAMEIB.fGGAhAIATEGAbFAADGEB..OFFB.hBIAEGHF.....hCAA...,1,-5,-18,13
WNaMYPfILTKScEgGXbDRJQACdBUHFOZVe,dAAAHAAAZABBeACE.aAFAMAEA..fBFATBEA.SAHHhAAAEAHFGDBBbCCBRDGBACIBhBAABDGAOFFB.VGBAhBDAYDHB.LEEBKGHB.XGFDhCAA.DGDB.CHHB.hDAA...,1,-1,-6,5
ZBHdeUgTGCFSYMRIDJNWaXVPKObELQcAf,ZAAAHAAAeACETAEAGAFAFAGA...MAIBRCAADACA..JCCFaCEC.hABA.XDGDKCGCEDHFLEEBhAAAAAHBdEEACFAASGGAhAFAIGGA.NIEB........hCAA......hCDA...,1,-12,-17,5
IBcfaKeEMSFVAPJONZGXTRUQbCHWYgLDd,OAAAGAAARADAUAEAQAGCHAGD......gBBAhAIAdCDDBCHAaDAHEDDAMCIBhBAAFDFDAAABJEHBZEBAbFEDCHEA.hACA....YDGFDEEB.fGHAhBBASGGD...hBEA...,1,-9,-20,11
LEVDfSCOPXbNQdeJZAaKMYcIRWHTgFBUG,aAAAMAAA....IADAHACCTAGABAFAGAGAEBBBDCFBCCGDXBBChAFAQDCAeCDFhAIAAAFAKDHBRCEFFEGHLFFBhAIASFHHOFHBNIBB.......hBAA......hBIA...,2,-17,-5,12
ZTbMVROGNHEYUXAeWJgSKBcFDfQPCLIda,eAAAJAAA.KADAFADADAFA..QAGALBGBdCCAZCCA..MCGBhAGARECAGFEBHECAEDHBXGCChAAAACEA..SFGHhBAABHFD.........hABA......hAIA...,2,-27,-22,5
RFdKcfIMVJAWEGBHaTNgDPCUSZQYXbOeL,EAAAHAAA.aACA..TACADAFACAHA.ZAEBQBEA..bAGDhAAAeCCBREAAdEEAKCGCfCCEhAEAMDIBAEEAGEFAhAAABEHAgGBA.SGEAhAIA......hBGA...,2,-15,-15,0
DJLGBKVFYURANXTCSZQPgWedHbcEIMafO,TAAAZAAAQAEA..PACAeAHBHCAAEAFA.aCECDAIBGCGAhABAKBGBFCCAREAAAACACCFDSDGAhAAAdEEAbGFA.MEEBhCAAOGBCLFFA.BHFA...hAEA......hAIA...,2,-14,12,26
SUNeAEbMgTfYVWPHXIQFDOJcKGdLRBCZa,EAAAMAAA...TADAfACA..VAGBHADB.QAFAhAAAOBBBKCDDdBHARCEFZEFBhAFAaDDCSDFBhAFAeDHHAGAAbGAA.gEGH.YFFFhAIA......hCAA...,2,-13,-6,7
KPOWcVZXDbNQaIYLABgRfUFJCeGEdTMHS,RAAAFAAAeADEEADA..dAGAHAGB.KBDAOBED..VDDAZCCBDAIBhADAQEGAaDGA.LGAAhAAAACCBBEEDUFGAhBAACCCDMIAASGBA..cGGCXGEBhBGA.....hABA...,1,-13,-19,6
GJSLFOKVeZICWTBYEbDHAPMXgdfUcQRaN,MAAAdAAAUADARACA.GAGALAFB.KAHBeCBFZCDB.CAFA.BBBDEDDA.hACAHCGB.ADDB.XDFDhAIA..fFEAhAHAaEHDSFEDOFHDIHHA.hBAA......hCAA...,2,-28,-19,9
CWcXJTFIfaUDBgReSZEONYdGVAKMLQbHP,MAAALAAAHACCCAEA...XAFBTAGAFCAAaAHDBBBD.RCDAeDCBhBAAECEAOCHD.hBHAdDGCADHAbEFA.cFEChCAAfDCA.DEABSGGBZEEFGGABhABA.QGGChACA...,1,4,-10,14
VQRJCZbPfgKTdOLIXBUGEMWYSAacFNeHD,aAAAFAAAHACB.QAEARACFZAEB..bAGD..fAGFhAEAKEAAdECALEEABBHAEDEAhBAAMEIBSDGAhCAAAAIBeGCADBBBCEDDTFFA.OFHDXGGDWHDGhCBAcGED...hDAA...,1,-8,-14,6
gJXGZMEbHYePWdFRfOAQBNTVKLIcUaCDS,QAAATAAA.LADAUACADAFASAGH.XCBAhAAAZAFEECFAHDDA.hAEAeCHFdCEARDFFAEBABFFAhAAAKCHBaFAACFHA.gFGHMIEA.....hBEA......hCAA...,1,-5,-21,16
dSKYHAIXaWcgLCeQMOZTfNRJBUPVGFDbE,aAAA..gAAAeACHMAEAZADA.TCCARBDFBAHA.UCGAGBGAhAAADBBB.EDFBdDFCKEAAHFBAhBAAAAEAXFCALFHBhBFAQGACfGGAPFFB.FHGE.hBGASAHB.hCAA...,2,-9,12,21
DabQgHBIfeASKNUFCERGdLMVZOXPTWJYc,KAAAFAAARACFdACALAEBZADB..OAFC..TAGAJCFA.DCGBhAGAQDEDHDGBfECAhAIAAAHA.SEEBhBAACEHAEFFB.MICA.XGGAYHEAhAAA......hCAA...,2,-40,-9,31
dGUHJFfSZbEMeaRWIAPNTKBVYgQXcODCL,TAAABAAA..VACAQACC.OAEALAFBGBEAhAAAHCAAfAHAhCAAbBGDEDEBeFCBRDGBACIBKDDD.XGCAhCEACAHBdFGA.FGFBMFIBIHHA..hCGA......hDAA...,1,0,-11,11
TMaOefdcVUPKNJWGLXEDSICRQBZHYgbAF,MAAAeAAAdAEAUAEAKAGA....JAHBGBCALBBBECFASCHHhAAARDCFZEFA.HEBBhABA..bFDDAEBBaEEAOHAAhAHAfFFE.PFHBXGGCCGADBHDAhAGA.....hBAA...,2,-25,2,27
NRWTaIOYZAgbUCfBJeFXLMEQKdGVcHPSD,UAAABAAAeACALADAEAFA.dAHAGBGAHCBCDCEARCAA...aDFAOCEBhAAAAAEA.CFCAFFEDMDIBhBAAQGGAKEEA.hBCA.PFGDNIAB.IGEA.YHBAhBHA....hDAA...,2,-23,-13,10
ISfARKOLbQEVdMUBPZWDNgaTYGHJCeFcX,RAAALAAAEADE.dAEAMAFABAGAZBDEDAIB..aBGDGCAA.HCCAhABAeCCDXCFDhACASCHHACHBODHDbEDDQFFAhAAAUGAB.NIBB.TFFA.CEEDIHHAhAGA...hABA...,2,-13,-1,12
ZAcBPCLORdeGQVFJNbEXSMTgYaUWHfIDK,BAAALAAARACAGAFAQAEAFAHF.JAHBECAA..MCAA..hABATCDAaCDDHDFADDHBAACAhAAACEAAeFDB.bFFASEFDhAFA.gGFAYHAAfGBBhACA.KHFAhAEA...,2,-26,-8,18
GNDIegOATcBVbfLCSJKEHUYZPaFWMRXQd,TAAABAAA..VACALACB.SAEAEAFEHCAAZBFEaAGDMAIBhAAARDEAdDHADEDB.eFGBhAAAAAEAbCEC..CHAA.KEFAhCAA.PFCB.XFEC.NEIAOHEChCCA....hCFA...,1,-9,-19,10
OgYaWFfPBHDRUJVdXAQSEcLKCTZbGNMIe,EAAALAAAKACA.ZADBGAEAMAGB..eAHBOAGF..aCAAfCCAhAAAHCEBRDGFVFBAhABAAAIBQDGB.hACACEAAbEDCgGGA.YHCGFFHDDGAA.hAEA......hAGA...,2,-18,7,25
bHOKFcdefUWgJESCLaGBVNAQXYPZIDMRT,QAAAXAAAZACBMADA..RAEAHCECFAGDeBDBUECA.JDHBECFBhAAALFABGDGABEBAhAIAAAAA.IFEAhBCATGFAKEFDcFBDdAHA........hBEA......hBFA...,2,-16,-2,14
YbUCGJQLRPcTVfFZaMEIAHdNXSBWgOeDK,HAAAdAAASADABADBOAEDKAGA.UAGAGCABLCAARCFA..hAAATEAAFDEHaDGAEEEBAEGA.hACA..XECDhACAeFGBbGBAQGFA.cGAC.fEHEhADAMFIBIHFAhBGA..,1,-4,-17,13
FcfKOWIQCUPEbANYRVSDGdZTMXaHBLegJ,RAAADAAAZADBMADAHAFALAHBeCCD..FCFHKBBAOCHB.QFFChAAACBDBEBFAADDA..VDEAhBAAdDAAaEEH.BHAAhABAJEHB....fFBAIHHA.PHCAhBBANICB...SGGDhBFA,1,-11,-27,16
cWVdagKfbCOBAZQEUHYFTPSJNGMDXLRIe,EAAAHAAAFACDTAEA..SAEAGAGAMCABLAHBRCCAeDFFhAAAVCDAaDHDKGAA.bGFAhACABBGA.AAEAZEFB.hADAYEHBNEEADIAA........hAAA......hCAA...,2,-29,18,47
DZIEGHgFdJBQOVCSNLfPebcAYRKUTaXWM,RAAATAAA..aADAMACAZAFBGCCAHAECdAHAQEFACBDDLCCAhAAAeAHFADGAKDHB.XEEAhCAADBEBEFEBFGHDBFHDSDHHhAAA.NICB.......hABA......hCAA...,1,-8,-15,7
BOQPHZEcLXfNAWUSGeCIFTKdbaRMVDYJg,SAAAeAAAFADDdAFARACF..DAEA..JAHBOAFEHDDAZEGBLCEAhAAA..fFBAhAAAACFAGEEACDHATGDAhABAaGHBMIAA..........hABA......hAIA...,2,-27,-18,9
OCHTGEDRVceSfMJBXUFgAdPKINWLQbZaY,dAAAKAAA...IADALACBZAEBaAEACAGA.HAGBGCBARBEB.eAHHhACAMDEBBDFAFDHDAAIB..hAAA..PDHDQEBAhBEAbFFD.TFFAEEEBVGCA....hBAA......hBCA...,1,-8,-10,2
FfUSWZOMeIQBbJgVDHNcTRKPdCALYXGaE,LAAAGAAAEADAFAEAUAGAZAGB..eBDFQCDABCAA.JDCFDBIBhABAHEFA..TEDAhACARFDFdGBAAAABaCFBSDADhACAMCCB.IGHAbFGB....gGEAhCAA..hDEA...,2,-24,5,29
AYFMgNPfUVbXcGQJIWKDLRaBTeZHdCSEO,MAAA..gAAA..fADAbADAGBGAQAFAhAFAICCADADARBBBaBHDhAIAeCEBHDEAdFCAEECFAAAAFFGHhAHAPEHDXGEDcFCD.KGFA.LHBAhBAA....hBBA...,2,-7,-1,6
JEABKVUFbaZTdSLIgfCGMPHcRNQXDYOeW,KAAAFAAAZACBdACALAEA..fAEAGCDAHCFARAFFQDEChAHADAIBeEHBEFAAAAIBBCHAhBAAUGFAaEGD.SFHHhCAACFCAMHCA.cGFC...YHCAhCBA....hCCA...,1,-8,-27,19
YXANFZcJbDWRdeLEUKafgTSICQGOMHPBV,ZAAAJAAA.DACARADF.dAFALAFB..EAHBKAHB..aBDD..TDAAhADACCGAGDEAHCGBBDHAhABAXDDCACCB.FFCHhAHAbFBBeFFB.fFHASGED.QGGAhAIA..hBFA...,2,-29,-10,19
NbATHGZOCUDeWVPaYdQBMSgXFEfIRcLJK,HAAAZAAACADB.eACE.VAGBaAED..dAGAMCCA..XCAAhABAEDDARDFBLEHBKCHB.AAFAOFFHhAAADDDA..PDFDhACA.QGBA.SEEDhAIA.fEHEhBGA.,1,-5,-36,31
gNXBEMRFUZLOGbafeYSVcdTWDQIPKHCAJ,JAAAXAAABADB.RADA.ZAEBGAGA..aAGDeCDB..SBHHhAIAdDAATFCAQCCAhBAAKCFDHFFAAAAAEDFFMIAAhADALEHBfGABVGBADFGBCEHA...hAEA......hAGA...,2,-21,0,21
WYCAMEVgNcUSbXZTHGeaBKLJFdfDOIRPQ,EAAAVAAA....NADA.SADBZAEA.HAFAeBHHaCDCLCBBhAAAdCHAODFDRDFBQEDDhAFACEECAAHA.MEIBhAGAgFAAbGCC.XFCDBHAAFHGCDFHB.hAHAWFHH...YHDGhAAA,1,-7,-8,1
cgIFaKeGSLZDBRUXCNAbWQJdVEOYMHfTP,QAAAdAAAEADA.MADAHAFA.TCBA..gAFAhAAAaCFCeCHHGECAZBDFRCFACDCAAAIBhBCAbEEBVEGBODAB.hCAAfGGA.IHAASFFDhCDADFIB......hCIA...,2,-16,17,33
SDAbZfgHNVQXGcYBIPWRCMFUKLdEOTaJe,ZAAAHAAAQAEAGADABAFA..IAHARAGFMCABKCCDdCAAECCBhABAaCHD...eCEBADFA.hAAAbCGDfEFAhACA.gFAAXEAAPGDAFFHBOFEHhADASGBDDGGB.NIDB.hACA...,2,-15,5,20
gGSIXLPJYDZWFTbdERUCNKaAHfecOQBMV,HAAAeAAAQADAMACAGAEB..XAFALCCA.PCGDhAAADAIBZCCAFECAdDGARFEACGHAaEEHhAAAAAHA.OEHD.BGAAhABA.SGCB.....hCAA......hCDA...,2,-15,-10,5
ZBaQJSEbXeNdUfRPYDcgGLWTKVCHOAIMF,MAAAZAAAaACA..QADAEAFA.eAFAdBHARCCADBBBGCFALCCBhAGATFAACBHAHCECAEEBBEHAhABAbEEA..UGGBfFCBhAFA.PHCA.....hBAA......hBCA...,2,-11,-7,4
ZdacARBEWbONCHKTXFVYMDPIQJSUfGgeL,EAAAOAAAHACAKADAFAFA..MAFADAIBQCCBUBGA.GCEAhAAAeBBBdCFCACGARDGFBEAAhAEA..bDCDTGDAhCAAXEFA...YFHBIHHA..hCBA......hDAA...,1,-8,-24,16
HfLcOWbIedAPVYCSTKFNRJEaBDUgXMQZG,VAAASAAA.FADARADFEAFEBAGA.DAIBUCFA..MBDBGDAAhAAAHCEALAHBhADAODHD.bEECeECB.AAAACEEDhAGATGGAKFGD.aFDHXGED...hCAA......hDAA...,1,-6,-20,14
bBLeMYCNVagOSdfcTQDJGZWPEIARXHFKU,HAAAKAAABACBeACE.MAFACAEA...aBEESAFHdBHA..hAAATCCAQCCAhAEAGDFAZAGBEFDBREDAFDHDLHCAhAAAVGEA.fHGFDIBA....hCAA......hCCA...,1,-1,-27,26
dEMICBPAgDSbNRaeLGcOVTfFZKQJWYUHX,SAAARAAAeADEGAGAOACD..TBDAZAEAQCEAhAAA.JCHBUDDBHECAEEGBhAAAMAFABGAAAFGBDFIBaFHDLGDAhABAfGDA.KHGA.....hAGA......hAIA...,1,-7,-13,6
cUJLPAHOdaKENeBWbQSRYTFXDGgIMfZVC,HAAAaAAA.EADEeACHBAFBQAEARAGF.FAGEGCAB.MCFBhAAAZCEACCHBUDGBLEAAhAEAAEEBdGGAKECBbEEBTGGAhBAADIAA...........hACA......hAIA...,2,-15,-5,10
GJTMRISNfcFKZdBQCbgWEeHXOLVAUPaYD,aAAAGAAA.MADARACF..SAEB..fAGAhAAAKAGAdCEDQDGAhAGAbCDBEBHFHDBBLEEBADDBPDGBhACADBBBTGGAIGHAFHCCCFEA.....hAIA......hBAA...,2,-14,-11,3
YESXTIHOWfLdKMBVAZJFecbGgCNUPQRDa,ZAAAeAAAGAEACADA.UBGARAEFDAGA..ECAA..TBGAHDACfEDAhABAdCCABDFAAAAAFDHDhBIA..bEGB.gGAAhACAQEDDaFFBXGFA...hADA......hAEA...,1,-6,-27,21
BYgJXAFPTQSHRKcdDLVUOfZeMbaEGICNW,TAAAHAAARADFdAFA.LAHBOACAeAFAaCAC.EBDBGDDB.hAAACEHABFGDgBGAhAGAABHBQGDAKCCDDCFBfDHAhCAA.bEFDIHHANEEA..hAAA......hACA...,1,-3,-15,12
KAPDOESCVJGTRafUHMYLeZFcWBIXbQNgd,OAAAEAAA..CACAGADARADAUAGAHCCALAFAeDFAZCFB.FCCHBBBDhAEA.XEEChBAAbDGDQFDCdFCAAEIBSFGHhBIATGAAMCIBcGDDIHHA..hAAA......hAGA...,1,-6,-7,1
RKcACegWdGaXDQJIZEPTNOYLMVBfbFUHS,eAAAdAAAaADAQADA.ZAFBEAGATCCAOBDB.MBIBfAHAhAAAFCBDHCFBRDFAACIBCEDAGFDBhACADEEB.IGAAhAGAPFBBLFFABGHASFCDKHFA.hABAWHDA....hBAA...,1,7,-14,21
NgGbefIPAMOSHCFRBTdQLXJaDWcEVUKZY,MAAAHAAARADFdAEALAFB.aAHBDAGAECABKBBA.ZBFB..gDDGhAAAeBHF.fCHAhACAABDACDDABEHATFDAhBAAQEGB.XFCCJGFE.cGGChADA......hBIA...,2,-38,-4,34
bKWPYVfNOUdDLTBXJEaIgHSZRQFMGecAC,KAAA..PAAAVADA.OADCdAGALCAABAGB..EBHFaBHDHCCAhAFARDEA.MCGB.eDHFhAIAADEACEHA...bECAfFGEhAAADFIB........hACA......hADA...,2,-36,-12,24
MUBYRPcETNIXfZeLGDWgAJCVKHOabFQSd,CAAAHAAA.aACAQACAdAFABAHA.RAEAEBHF..TCCA.XCFAhAAAeCABGCFAhAAADCIBAECBKEEAbCCCMDIB.hAHAPEEBIFHAZFAALHFAgFBAOHAChACASGEA.hAFA...,1,9,-14,23
MbIBVdQFfLDWYcNeUGgSPCaTRJOKZAXHE,HAAAEAAA.MACABACAdAGAQAEALBEBDAIB....cBGAhAAAeCCBGDGAhAAA.SECDhBGAaCCARDDAKDHDAAHAbGDAFEAA.fFFA.NIBB..hCAA......hCDA...,1,-9,-20,11
NdYIETWgAeObUGVRDPMFSfLcQKJXCaHBZ,eAAAOAAAGADARADA.MAFASAGBLBFBQCCChAEAKBHBCCCDHDGBZCFAdFDAEEEA.TEGAhAIAAAAAUGGBDBBBfDBEhBDAXGCAaGGCBHBA......hBHA......hCAA...,2,-4,-4,0
SYUNECgWaKOeHFXfMdJBbcQADGITZRVPL,GAAAZAAARAEALAHBSADAUCAAEAGA.CBHA...aCDDeCDAHCFBhABAfDCEdFAABEHAQFDAhACAAAABTDGAPEABhACA..gGGAOEEBMFGB.hADAcGADIHCAYFHBhADA.,2,-15,-2,13
YfTegOEJACLGcMPDIUHaXZQFWbBRKdNVS,GAAAMAAADAEAHADAZAEE.QAGC.bCDCRBBBdCFA.SAHHhBAATDGAeDADEDHBABDBhBBALEEB.IFCAhAAAaDEBFFFAKGHBNIABfGGA..hACA......hADA...,1,6,-27,33
DMIVgYfSJOeZCKNbTABHRLQWaGcXEPFdU,HAAARAAALADBaACAGAEAEAFA.dAGBDAIBMBHB..VCFA..hAAAfCCAOCCHeEEBhABAZEDAKEHB.bGDCAEIBQFAChAFA.XFCDFHGE.gGFHhBHA..hCAA...,1,1,-14,15
RUOTEFaMCSZgVKQILPGcfBdNWbAXDJHYe,DAAAHAAARABA.TAEAFAEA.MAHBZAGB..KCDALCAA.GCFAhAAABDCDdEEAbEAAAAIB.XFDDhACAeCHHEFCAaFGD.hBAASGAAQGFA......hBIA......hCAA...,2,-35,13,48
RSKTeIXJDWFBUEcYLfHgZdOGPCbMANaVQ,aAAARAAAKADC..eACH..XAFADAEABAGAECCALBEB.hAAAHCGBdCFAGDGAhABACDDCAAIBQFFCTEDAIGAAhAGAFECH..cGCD....hBAA......hBBA...,2,-26,-21,5
MYXGFdLfJNQKZHICPbgeDaUARVTOcSEBW,RAAATAAAOADA..EACEMAHBGAEA.dAGBLCCA.fDFAhAAAQCCCHEBAhABACBHDbDFDeCHHaDHBAEAASFGAhAIABEED.XGBAFGHD.KGFD.hAAAIHHADIEA..hBEA...,2,-13,0,13
BfWbNgXOKELFVSQCDGeRIMcJTUHaYdAPZ,ZAAABAAA....bADBXACA.EAFALAGBFAHD.QCAAhABAGCAARCCBMCFBhAAATDEAHDGBdEHAAAIBfGCAhACAgFBAKGEACBFAeFGDIHHA.hACA......hBFA...,2,-15,-7,8
GJHDXBYbLdAIUfFWZMNPaETQOgCeRKcVS,UAAAFAAAZACBMADA..aAEDEAGA..QAGACBDA.RCEAKDHBhAGASBEH.HCFBhBAABEBAbDBBAEEBfEGEhBAAPBHD.OFFBeEEBcGGA.hBEA......hBIA...,1,-10,-33,23
WdgFHaYNSLbKUfBOTRDPEcZCQJGeXMVAI,dAAAHAAAaADASACE.LAFAbABDKAGABBEDRCCAECFEZDFEQCFAhAGAeEEDMFIBACIB.hAIAgGAAFDEHUFGAOHDChBAADGGBCHCA.........hAAA......hAGA...,2,-17,1,18
EYRJAVLeHTMcBXgQGUaSdbKfFCNZDOPWI,eAAAHAAAMACABADAQAFAaAEE.dBHAbAGDFCCAZCCA.OECBhAAA..IDFAhAAAREEAAAIBTGGAXEEChABAgGCHSEHBCHEA.DFAA.EFCF.YFGBhAFA...hCAA...,2,-14,-5,9
LcKJBOeHMTIdDaFQECfYPRVUZWGXAbNSg,SAAALAAAKAEAOACDHAGBMCAA.dCEAaAEAFDGHEAHBCDDC..hAAA.fBEAhABAREAAZFFAGGABACGA..bDEANIDB.hABAgEBA.BFDA.eEHH.hACADFFB.....hAEA...,2,-7,-5,2
DXgWQSBLJNPZOKHGfCdbITFAMEReVcUaY,RAAAeAAAUADADAEA....XAFAQAGALDDAJBCBZBDBHDGBhAAAGCFAdFDATGAAhABAAAAAEEHF..aFCAgGGAhAGABGHAOFFHCFFD.IHDAMAIB..hBIA......hCAA...,1,-1,-17,16
baZIXcJPCGLNEDeUQWKMOdFgYfSBVARHT,HAAAaAAAZACBXADB..JAEBGAFAEAGA.eAHBUCGAQCABhAAAKBBD.dDDAFDEDhAGAfDHEBFGARGDA.hBAAbDED.IFBACHHADIBA.MFHB...hBIA......hCAA...,1,16,-29,45
bgQcCKAGFSVBeOHfTZDNIXEdWRLaJPYMU,GAAASAAAeADAHACBZAGBDBIB..XAEAEBFFRCDB.aAHBJDCFhAAAMBIB.UDEAbEGB.hACAQEAA.hADAKDGBAEABBFFATGGA.dFCAWFHH...hAAA......hABA...,2,-11,-7,4
CFfHSRQAaNMITGXJLDKZUVYgPbBdWOcEe,aAAAMAAAGACALAEAZAEA.UBBA..VCEA..gBGAhAFAbEEA.dCEAOBBHhAFAEDHFeEDBFGAASAHBhAGAAFFATGAADFIBKGGDBGGAWFHH....hBAA......hCAA...,2,-12,-9,3
SaOTLJWdPXEYZDGVUfMKQICcbBHeNRAgF,SAAAaAAALADAdADA..EAHBZAEBGCCAUBGAMCCBQCFAhAEACDDD.BBBDHEFARFABADHAhAFAOFEBTFEAPHAAhAAADEIBKGHD..IGHA....hABA......hAHA...,2,-21,-1,20
NceDXfKFTSYIaCQRVgAMOZbELdHPUBJGW,ZAAAEAAAHACABADBGAEA..NAEBeBEAXAGAFBHD..TDDAhAAASCAA.aCGDhABARDFFACCB.bFGDdDDAPFDBhCAAUFFAJGAA.DDIB.KGDC.CHAD....hCBA......hDAA...,2,-13,-4,9
RUCdbIOLTHGSBFKYVQMEZePWNDAafgXcJ,aAAAXAAA.RADA.dADA.OAFAHAGBGCEAFBBHKBFA.QDAAhAAAECHF.eDDDPDDAhBAADDIBAADA.fFHEhABAJEFBCEHA.bGAATFBABGFA.MIBAWHEA.hBDA......hBFA...,2,-28,17,45
IaLJcbEWCDdRgHXFKAQeTYVOSBNGZPUfM,eAAATAAAOADC.BAGBZACBUAFA.MAIBaAHDLCCAhAAA.JCGFECABDDIBRDEAHEBAhAAAKECAAEEA.QFGAhACASFABPHBAfFFAcGFCCGHA..hBEA......hBFA...,2,-27,-4,23
aINSLPeBcgVMZTDQdFYfObXRAJCGEHUKW,GAAAHAAAKADCaADASAFALAGBeBFFBBHA....gCAAhAAAZCDFTEBAdCEAfDHAhAAAXCGCADDAEFGBhACAIEHANIAB.cFFAMFIBFGEC..hAIAbGAA.....hBAA...,1,2,-13,15
cFRMPXDHfTeOWKEYICLSVJNUdZgGQBAba,aAAARAAAMADA..DADAHAFCeAEAKBDA.ECCBCAHALCCA.SCFHhBAAVCFBUFFBZCGBhBBA.GECAAAAAFEDD.fDBEhBDA.TGGA.OFFBhCAA......hCBA...,1,-13,-23,10
bZVSJdXKOCcMGPFTLHEIWQRaAgNBDeYfU,BAAAeAAAUAEAZACA..SAEEdAHAOBCDMAHBGDFA.FDHFhAAAHCCA.EDABQEBChABAAAIBDCGB.bEDDXECAhAAACHBA.TFFAIHHAaCHDYFHBhADA....hCAA...,2,-28,-8,20
QFYENDTJLcIZfCdKSbXBeWMGgPOHVRAaU,aAAAQAAA.EACATADALAFAZAFBdBHASBDHBBBDeCDBhADAGCEAOEGBHCGDhAAAAEHAFFAADDCBIGAAhAGA.KFHBbFCDMICAPFED....hAFA......hAIA...,2,-17,5,22
ZKUcDSbYLQFVNWIRePgMTACOdfGXBaHJE,dAAAGAAAaADA.HADAZAFB.KAGCDAIBSBGA.LDCAhAAAQBDCFDGAVEFBIDHAhACARFAAeFHHMCCBADAB.fEEAhBAA.BFGA.EGEF...hACA......hADA...,2,-23,1,24
AKMQINJWZfgSTUYCXPELOVHBecdGDabFR,MAAAQAAA.JACEZABE.SAEHUAGA.XAGAhAGAEBEALDCAHCCAeCFHhAHAGDFAbCGDADDAKDHB.IHDAhAAAfGGA.YEEFCHGA..hBAA......hCAA...,1,-13,-18,5
BMLEFUgYSPZdIDCTRJHOcaKbVAfXWQNGe,XAAAQAAAGADAeACALAGB.EBEAFAFAUDAASAHHhAAAdDDACDHA.RCFBHDAAhABAaEGCKFEAAADBfEHAhBFABGCAMIAA.gFEB.YHDAhCAAIGHA....hAAA...,1,5,-16,21
XJZbaYeVDNfCEOGcLBRAdIQgFHKUTMPSW,dAAAQAAAHADATBGAMADA...SAGEXAFAbBDCeCAAhACA.DCFB..CCHAEDEAhAAAGDDALEBBADDBFDGHKFAAhADAPEDBJFHB.aEHB.VGEA.NIAB...hAIA......hBCA...,2,-2,-2,0
cKEMYLFTNXWBHUVgfGeRaAbPZSOICdDJQ,ZAAAOAAAdAEAQAGAKADA..EAFEMCABLAHBFCCH.TCCAhBAAXCFDHCEBVEDBhABAGEGA.RGCAABBBbDADhACASECDDDIB..cGFB..hADA......hAGA...,2,-13,-5,8
NZbPRTdLGHeXFJQDgIVOcKWBfaYMUACES,EAAAZAAARAEAdADAHCAA.eAHHFAFAQCBC.DAIBgCEAhABAOBFB.KDHBfCGAhAAAaEACMACAAECASDEDhBCAbEFDLHAAGEGA.....hAHA......hCAA...,2,-17,-1,16
gNZcDMaIOQeHTPJbSBfKLAYWUVdRXECFG,UAAARAAAEADE.GADAZAFB.MAFAOAHD.HCCBTBGA.JDAAbDGDhAAA.BEFALDFAhADAACCB.VFBAdFAAFFCHNIBB.hBAAaFEH..eFFA.fGHA.hABA......hAFA...,1,2,-11,13
LabUKRJfIOFCXPDNAEcSeVWYTBQGMZgHd,EAAAeAAA...VADATACAGAGAZAEBHAGBdCCALDFBaCCHKDFAREABhAAAJEDB..ODHDhAEAXGAADEEBAAIB.SFFBhBGABEHAMIDA........hAAA......hABA...,1,-4,-17,13
QEMOJHAaSKXfIgPZUGRbCFeBVYTdcLWDN,aAAAXAAA..IADAZACBRAEA.FAFAeAHHBBBD..TDEAhAAAdCDALBFADDIBEECBMEHBhABAHDFAADHA.fFDAhAIAgFABPFFBbGDACHAD.....hAFA......hAHA...,2,-22,-10,12
JXRIMQgVfBabeUZHAFcTdCOEYWNKLDSGP,TAAAdAAAEADA......NAGA.LACBGCAB.XAEAhAAARDEBMAHB.QCEChAEA.fAHAhAFAbECDeEGH.HDGBAAIBCBEAOFHDKEDDSFFD.hACAIHAA.BHHAhAHA.aGEH,1,3,-18,21
GIJYVMbZFQLHeNPWUXOKABSDERCdcagfT,DAAARAAAdADA..aABE..TAFAGADA.JAFAMAIBZCFB.LCCAhAAAHEGBeCCB..PCGDhABAXFBCAEEAEFAACCHA.hAIA..fFFA.IGHAhAFAbFDD.FHAA.NIEB...hAHA...,1,-10,-16,6
KCdWbaQgGASYTRcEIfePDFBJMNZXOVLHU,TAAAEAAA..eACAFACABAFAMAGBZBCEOAGDHCGB.CAHAdDAAaCCAGCEAhAAAACIB.REGB.fDDAhAAADAIB.XFDAhADALFAAKGGAbGDASHAA.hAFA......hCAA...,2,-17,-4,13
RNKfHMQcEaSAbYCWOgUZedDVGLFIJPXBT,CAAAOAAAZACA.dAEAGAGALAGBFCCA...JBBFBAFB.RDAAKDFBhAAAHDCB.MAIB.EEEEhBAAAADA....bFDBgEGBhBDA.eEBDDDIBIGGAhAIAXGGC......hBIA...,2,-38,-6,32
aJPbBESYAMIcWHRNOXegKZTGUFDLfVdCQ,MAAA..IAAAHACCRAFFOAHDeACAZAFBGCCADAIBLCAAhACAdEFAaBBH.JCHFBDHDEBEFAEEAhADA..NHAB.KEFAFFAACGGA.hBHA..PFHB.......hCBA......hCCA...,1,-1,-27,26
cGNgfVCBMYHeRJQKUEZFXbLPTOAdSWIDa,dAAASAAADADAGAEB....fADABBDDHCACRAEFQAGChAAAECFBZCGBFDEHLHAAhACATDAAACCBaCGEgFGAhAHAMDDBeEEA.KEHB.XGGChABA......hADA...,1,-10,-14,4
ABdQXOPgMGZFCSecLIYUJVWEabHDKRfTN,dAAAQAAAOADA.MADAZAGBFBDB..eAFALCFDUCDAVCFAhAAAECBFHEDBRDBB.TGBAhACAABDAXEGA.PFFBhBCACFHASGGD..IHHAhBIA......hCAA...,2,-12,-10,2
WYBFGSUAaJeLfMbcgCKEdQIDPNOVTRXZH,eAAAMAAA.....bADACADAEAFA.dBBAQCCADAIB.OAHBhAAARBGBHCEBBCEAGDCAhAFAAAEAaCHDLFGBhBAA.gGDHKDFBIFHA.PFFBhABA.NIAB.....hAIA...,2,-24,-8,16
GFZRQXTKBNMgfVbSdCAWLDJPUEHIeOYca,LAAADAAAUADAHAFAeADHOAFA..aBBBZBEBRCFA.QCAAhABAKCCDBDED.MBIB.hAHAfCGAbEFA.hAIAdFFAAGGAJHEAEEDBIGCA.YEHFhACA.....hBAA...,1,6,-31,37
WLAVaBYUXOCfIJcEMSDQPeTNZRgbHdGKF,aAAABAAA.UACACADA...JAEEEAFA.MAIBDAIB...eBBBZCBARBGBhAAAHCFB.GDAAhADAFCFHLFFAACHBXDDBhAFA.fEHASHFATFCA.gGGAhBAA.KFFDhBHA...,1,-5,-42,37
JQLXdePGBAbOTcEgKVMNaRIHfFYUZWCDS,TAAAEAAAKACA...MACARAEFHAGB.FCCBZADEDDEBQBGAhAAA.dCCDeDFFGCEAhAHAAAIBbEAAOEGD.gGDBhAIAaDHD..fGAA.hCAAUGGASGHHhCIA...,2,-10,-10,0
WKeNRDAXaSHdLfBbFVQgGOPcMYEJITCUZ,aAAAHAAALADABADBFAFA.QBEDGAGAOBBBMAIBECABTCDAhAEAZCCF.KDCD.RDFBAAIBdEEAhAAA.bCGD..gFABhAFA.cFGDIGGA..WFCHhBAADGIB.....hACA...,1,-2,-13,11
MEFfNadWIbLeSJGRUAODXBZHgPQYKCcVT,XAAAHAAAQADCKADA.CAFB..TBGAEAFEFBHD..aCACdCDAhAAA.ICFAeCEFGDFAhAAAAAHABDAAPFHDhACAVEFA.MDDB.fHABWFED.SHEGhAHA...hABA...,2,-37,14,51
CegSbcODXGHPIEWJFUAaNfQVKdLYBRZMT,aAAAQAAA.dADALADARAFAZCEE.MAHBeCHHSBBDhAEA.OCCAGDBAhAAAHCFBEEFBFFAHAAIBfDDEhAFAKFHBTGEAbFDCDIAAIFHA..hBAA......hCAA...,2,-22,0,22
aHCTSQUWXYJfZcRMLFOVGNPdDBAgIebKE,eAAAEAAAHACACADA.QAFCUAFA.XCCAJCCAZDEE..RFBA.MAIBhAAALFFAOCGD.hAAAGDEAdHBDAAIB.bEAAaHFAhABATGGA.SGDH.fHABhAEA...hBFA...,2,-27,19,46
KNYIFCRVBEUXQaTZGWMOADgbJdeHSfPLc,DAAAJAAAHADB..fACALAFAKCCD..IAEAhAGARCFAEDABUEFBaAGDGCDAhAIA.MBBBAAGAdGCAeBHHhBAASFHHcFCCFFFA.BDCC.XGEDhBGA....hCAA...,1,-18,-21,3
QJeXTPLfWHNaDIECMUSbcAFVGZYRgKdOB,GAAARAAAdADABAFAeADA...TAGALAHBHCDAaBFEECHFMCCBhAAAbEAA..AAAB.ZDDAKEFAQFAChABAXFECfFHAhACADEHBCFDA.SGCDFFFH..hADA......hAEA...,1,2,-19,21
RGJgTMKNVIfFbUQaPdLSeBOHXAYcWDZCE,......cAAAZAAARAEAGCAA.TCDAMACAKAFAICGAhABAbBCD..aAHDdEFAhACAeBEBOCHDHDFBAADADFABhAFAEDHBgGCA.fGHAhAHAFFHHPHAC....hAHA...,1,-2,-17,15
MPbHQcAGSNOdYFgTDWaXZLURVIJCfEeKB,GAAAOAAAdAEAFADADAGA..aAGAZBFBRBCB...VDCBCBGA..ECHFhBAAeBHFBDFA.MBBBhBEAHFFA.AAABSCDEhACA.NIDB.TFDA.LFFBhBGA.IFHA.hBCA...,1,-18,-23,5
BCQeDJHYbTWXPcELVIgGZUNMAfSdRKFOa,dAAARAAAOADAaADA.BAGAeAFH.HBGB..TBDAXCAAEBHFLDDAhAAAIDDAZEBAhACAMCCBAAHAKEHBFDHDQFDAhABADFFB.YFGF....hAIA......hCAA...,1,-15,-19,4
ECeYILMRBVfANXSKcJbDQWFgZTGHOadUP,SAAAKAAA..bACBQADA.FAFEZAEBHCCAdAHAECGBhAAAeAHHLEBAhBEARDABfDFAABGAXEGAhCAADDIBTFGAaCCHCFEAMIDABGCAcGFC..hAAAgGGB.hABA...,2,-10,-10,0
OaLXQdEWZDSgYecFJMHKNVBAUICGfbTPR,CAAAGAAA..TACARADAaAGALCDA.dCHAEAEEZEAASAGBhAAAeEEBFEGHMFIBhAAAHCAAKCEABHBAAAIBfCHAhACAOHDC.QECA.DEFB.hACAgGCG.hADAcGFB.,2,-21,2,23
ZYdbVSTRHaecGUPXOEKNQFJDLIWCgBfMA,dAAASAAAHADAeAFEGACAUCDB.OCBDEAEAQAGAhAAA.DCFBLCGBhACACCGDfDHAACIBbFFARGDEaEAA.hADAXEDDNIAB.FFHD.WFFBBEEDMIBAhABA......hAEA...,1,0,-13,13
bRcUBJFCSEDKLWYTfOPeHNXVQZGAaIgdM,aAAAdAAARADABADAFAGA...EAFALCCA..TBGAOCFDHCCAhADA.XDFDhAFAZDAAACHAMDHBbFCB.UGGBSEHBhAIAKEED.fGGA.NBBA..hACA......hADA...,1,-5,-28,23
ICaHeXQcSBZKRNUVPfGgJYbDEAWTFLdMO,TAAAdAAAMADA..CACBHADBeAFA..QBDCBAFARAGFUDDBVCFAhACAGEFA.JFAAbCBDhBAAACCBLEHBOEEBaFGAhBCASGDHKGGA..NIBB.....hBIA......hCDA...,2,-7,-7,0
JAEfMXLUaCVbWdeOQZcIBPKTNFRHgSGDY,EAAAMAAALADAUAEA.CAHA...VBBBdCBAeCFAZAGBBDEAKDDAFDHDhAAAHEBCGEFADBIBAEGA.aEAChAEA..OEHD.hAFAQFFAIGCA.TGBA...hAHA......hBCA...,2,-17,-13,4
DFaRTIcWPKSECfUXVHbJGAOBMgeLNdYQZ,MAAAeAAAdAEAZABEFAFARAGB....TCCA..ICCAhAIA..PCFDEBEFfBHAhBAAXEBCHEGBhAAAGCFAAAIBBEEDLFDBQGABaDHDKGHBCHGDhCAA......hDAA...,2,-17,-7,10
OKdXDWRUPLTJIVaASNeMEbGBCfQFHcgZY,eAAAEAAAGACACADA.QAEAHAEBZAGBKCCAdAHADCBBREEALEHBhAAA..TDFAVGAAAAGBhABAMDIBBGGCFEAH.gFDAhAAA.XGBD.PHFAhAEA.....hBIA...,2,-18,5,23
FcDRSMWOLUPEXaNJbgfHZAGQdTIeCVYKB,dAAAeAAACADA.KADAFAFARAFF....MAIBLBFAUCCA.ECBA..aCGDhAAAJCEF....bEFAhABAHDGBGFABTGDAhACAIGGABDADSDDDOHAC.XGGAhADA....hAIA...,2,-28,-8,20
eDYcSdGNATZRPJUaEVfHKQBOMFIbCWLXg,RAAAUAAAEADE.HADABAFBMAFA..FAHBCBGALCFAeCCA.DCDBSCFHhAAAGDAAADABZEDBhADAaCHDKEED..QFFAhBAAbFGB.WFHHYFDF..NIBB.hBCA......hBIA...,2,-23,-9,14
aDBWTKJXUeZcRCGQOIEFbSdPAHgfNLYMV,HAAA..fAAALADBMAFAaADABAGATBFAKBCAXBGAhAAAeBHHRDEBGGEB.hACAQCABECBBbDDAdEHAhAGAAEIBgFBAVFCADDDAJHFA.....hAAA......hACA...,1,3,0,3
VHgdLCcTPWQZNDFbYeKBJUGEMSfAIaOXR,aAAARAAAHADBLADACAFA....TBGAQBGAZDAAFDGHeBBBhAEABAHBGDCAEEEBMDIBhAAAAAHAXEEB.dEHAhAFAPFABDGGB.KGGASGDH.IHHAhBAA...hABA...,1,-4,-16,12
JXdYFGTIKcZPQCWDaEUfRAVNObgMSHBLe,OAAAMAAAHACCLAEAeAFEdCCAGBBBKBFAZCFEQCFA.hAIADAIBEEDFREDAAAFAVEGB.hBAA.bFGDBGEA..hBAAYHDE........hBBA......hCAA...,2,-14,-13,1
ZCPaHYIJELWQfUXTBdSMcNAFKRGgebODV,RAAAeAAADADAZAEECADA..HAEB..JBHBEAGALCCAQCCC.hAAAXCGAdEEAMCGBAAAAGEEAhAGA.OEHBhBIAaEHD.IHCAfGAA.BGGDSGHHhCAA...hABA...,2,-38,3,41
cfgKdTJVORGIHWNMDUeSPXQABZYaEbCLF,ZAAAEAAALADAFADA....fAGAdAHATCBAOAHDhABARCFBHEAAMCABeDEBXCCAhACAAAEAaDHDCGGA.KCFDJHBAGDGAhAGA.IGEADGIBSFCA.hCBA......hCCA...,2,-21,2,23
SVLBfaXGHOUNKbPZMgRdeJCQWIFTAEcYD,EAAADAAALADABACA..aADDHAGB.OBBBKAFAZBFERCDAeDCBhAEAQDDCFDHD.AAHASCCDhAAAXEFDUFAAhAFA..bDGBMFEBdFAACFFAIHHA..hAIAcGEC.fGHAhAFA,2,-19,-14,5
QXULfWFKbDCGMPEBSZcYHaReNgIAVdJOT,dAAATAAAQADA.LAGBFACAbAED.GCAB.EDEFZAGFhAAAHEGBRCCBeECD.gEFAhAIAAAIBOFBBfGCAhACADEIBMFEBSGBDaFFBNIDB.IHGAhBGA....hBIA...,1,6,-13,19
DEbLfBSQMZJYVTcUPHFNCdIAgXKRaeWOG,KAAARAAAeADEGACA.EAEALAGB.SBDHZAGBVCABUEEAhAAAHCEBCCCCABGB..aCHDDAIBhAAA.bEGDBFCA.MFHBhACATGCA.........hAEA......hBIA...,2,-20,-12,8
CAVGfIMSROcLDgYBeXbQFNJaWZKHTPdUE,GAAAMAAARACA.LADADAFA.BAHAeAHFQCDAFBBH.aCFEhAAAZCEBHEACdDGDEDDFAAEAfDHAhACAOECH.gFFBhAHAbFGB.WFHH.KGCA...hBAA......hBGA...,1,5,-23,28
ZQCXcSDKVdFAJfUERgBYTILaNeOMGWHbP,UAAARAAABADB..TADAaAED...eAFEGAGAHBFAZCCAQDAAhADAXDFDDDIBdDDAADHAhAIA.EEGA..gGAAhAAALFFA.MEEBbGEC.CGGA.....hABA......hAGA...,1,4,-30,34
BdCWXHDbIUJAPgSNLYTZQKOcRafGEMFVe,SAAALAAAZADBQADAOAFCRCABGCFAEAFA..MAIBhAAAeCHBdCCACCCC.HCFBDEEB.hABAbDABJFCBABHB..gFDAhABA.TGGAaFFHFHGEBEDAIHAAhACA.....hADA...,2,-5,-5,0
EXDIQNgFARbJdHTBCUKPLVMeafZOcWSYG,RAAAdAAAHADBCADA.KAFALAFA..eAHHZABBOCEASCCDhAAAECHF.DCGB.QEEChABAFDCDAAGA.bDADTEEAhBAABDHAPFHBMEIBaGECfHAB.hCDAYFDFXGGD.hADA...,1,-12,-18,6
fKOVDJNLHgZYTcFGAIUXdbWMCQBeSRPEa,XAAAdAAAMADABAGARADA..EAGEKBDADCDBLCGBHCEAZDAB..hAAATCBAGEEBAAIBUEDAhACAbGCACGHA...eEHHhBAAaCGA.OFBBNIAB...gGEAhBCA......hBDA...,1,5,-23,28
eYRDIfUGMVHdBANgLKWZTFEOPQXacCSbJ,LAAAZAAAEADE.QAEAaAFA.SAGAeAHHRCAADBGBICAAhABAGCEAHECB.hACAACAAKEHBTCCAOGFChABAXCFACHED.bEAB.fEEA.hACAMCIB.dFGA.BGEAhAEA.WHAA,1,2,-8,10
fICLAZdcSFRJebUaDHXOMPKNgEBYQGWTV,dAAAFAAARACFeADA.UBGAHAEB.MAHBKCBA.EDEBQCEA.hAEAGEAATEGAIECAhACAAAGBZGDA...SEEDhADA.aEHBDAIBOFFD..hAEA......hAHA...,1,-17,-25,8
YceZWVEHRQPfICdgSMUKFLaAbBGODJTXN,GAAADAAA.JADATACA..XAGB..cAEAhAGAeBHHZCDAEAHBHCCCRDBFQEEChAAAfCGAdFHAMIEAhACAFDHDABBBbFCAOFCDNIAB......hBAA......hBCA...,1,-3,-9,6
HVACaNbRSgeKLUWIXZdDMYOfQcPFJGEBT,aAAARAAAeADELADA.UCCAXAGB.dCCAMAHBOBEBQDFChAEAFCFDGDGAEEHFHFAAhAFAAAAACFFD.SBBDhAIA.KFED.IHHADBIB...hCAA......hDAA...,1,-2,-24,22
EHbXDgVQfdRAcBPJaGeFZCMNYOUIKWLTS,BAAAaAAAGACAeACAZAFB..MAEAOAHDKAHBLBEBEBEF.hAAAHCGBbCAA.DBBBQDGDhACARFFBABGB.PEEBhADACFHA.UGGATGDASHBA..hBHA......hCAA...,2,-10,-10,0
PAJSFQCWfbBHETZagUIVOKYLGcMXeDNdR,FAAAQAAACADA.....bACAHAEBEAGAZCDAaAGAUDAA.hAAAOBGDLCGBGCCAhADAMBIBeDHHdDAAAECASEFBhBAABEEATGAAgGBBKFHBcGGChADADFFB......hAEA...,2,-10,-5,5
gQFDbfBOKcTALPZUNICXMVSdYJGRWEeaH,ZAAAUAAACADB.MADAdAFAGBGA..EAGAHCAAQBDADAIBBCEDhABAKBHBAEEA.LCFBhBAA.IDBASEFHhACAREGFeDDBaEHDbFBAOHDA....PHAAhAHA....hBFA...,2,-22,-8,14
GJWPTXYHedbVcBaNZAEQMSDLUKCFgROIf,EAAAMAAALADAKADA.FAHBRAFF..OAHDGCBA.JCHB..TBBAhAFAHDDBeEABdDDAVDGBhAHAaFGCACBB.DGDBCECC.IHHAhAAA.fGEAXFDAcGGChBAA.....hAEA...,1,-12,-20,8
DBYgcWLKFGEAHdIZTRQJeNPUMOVabXCSf,HAAAZAAARAEA.eACEUCAAMAFA..aAHDbBDA..CCDA.DBHBBCFA.hAAA.gCCGhBIALDHBGEEAACIBdEFAQFDAhCAAJFAA.OHEESHAA..hABA......hACA...,1,4,-29,33
GKaBMZVEFQeObUfWLTCSDIHdAPgRXJNcY,RAAAXAAA..NADBGBDAaADA.ZAFEEAGA.eBCHOCCHUCFAhAAALCGBSBEDhABAHFEAABIBJEEFKGDDMCIBhAAAQGAA.fEHACDFADGIB.dGGD.hABA......hCAA...,2,-10,-2,8
GLKZEbCJMaQAYOBPRHSVDdefITgWXUNcF,BAAAHAAADACAeACA..TAEAXAFAUAGAFCAAGCCAZCEAEDABCDHA.hAAA.MEFBAAIB.OEGBhBIARDCBdEEA...fGDAhCAAgGAA.NCIALHFAKHGA..hAAA......hACA...,2,-13,-7,6
MJdNAbcgSDTKPFVEQLHGZeIYRBfWUXOaC,...bAAASAAA.TADAFAEAEAHBHAFBeBDHRCCBfAHEhAAAXCAA.aDABMCFBhAAAdDHAAEFADCGBKFAAQEGAhABAZFDBBFGD.OEEHCGHA.cGGC.hABA......hADA...,1,-5,-8,3
ENWPSYfaJHQTdIbVFDKOcGeBRAMLgZCXU,MAAAZAAACADB.UAEA..EAFA....PAHBfAHAHBBBdDEAhAIA..bCABDDGBOCDChABAeDHFABBBLDHBhACAXEBASEEAaFHDTGBAFFAH.GGCBhAFA.BFCA..hCFA...,1,-10,-11,1
OfQHBKadTIgPJMGNWSEDCcZeAbYXFRLVU,XAAARAAALADBUADAQAFA.HCEBaAFEdCGA.TDBAhAAAgDGB.MAIBhAAAGDDASCCDhABAEFGACGAAZGFAAFAAbFAA.FFGH.fHBBhAFA......hBHA...,2,-14,0,14
TXCFLcWIZJVDUBbaYPSHeRKfANMGQdEOg,GAAAEAAA.OADATACAFAGDLAEB..ICDAhAAAZAGBDAGBbDDCaBHD..SCEHhACAHEFCeECDRDBFADGBMBIBhAAAdEHACFFAcGGC..JHFA....hAIA......hBAA...,2,-16,5,21
bQUFEWRLJIYMHOCfSVBadPAZDXTeGcNKg,ZAAATAAAeACE.GAFAKACC..QAEAEAHBRCCALDHBJAHBMCCBhAAAHEEA.CFAASGGDhABAaDDAADGBDDIB.NIAB.bECDhAHA.FEEH...IGGA.OHEChBGABHEB.....hAFA...,1,-4,-7,3
fCbVSQZHRgKIUdLPTcWDeYJMGNOaXBEAF,CAAASAAAHACARAFF.KADAdAHALAFB..TCAADAHBeBHHhAAAMCEBGCCAODFBaDABhABAEDHBACCBFEFB..bEAAhAAAQGGAZGFE.......hACA......hAEA...,1,-11,-13,2
AFXYHZKBQfIObgWJGPDSecMUNLdRETVaC,XAAAHAAAZADBQAFA.OAHFbACDJAEAGCEA.hAAASCAAeAHHMCFBhABALDGBEDGBaEBAADIBKGHBhAAAfFGE.gGCADIEA.hACA......hADA...,2,-11,-8,3
WcXNeJaZbAUdHIEfSgOMRDBFTCQGPLKVY,HAAAEAAA.SACEMADARAFABBCACAFAGAGALCBAKCCA..VDEBhAAA....cCFChAAAeDHHZECFACHAdDHAfFAAhAFADEBATEEAQGGB.WFCDhAIAXGGA.NIAB..hBIA...,1,-3,-18,15
SFXMJCeZgfTQRGDdUOLHWbNKBaPYIVEAc,FAAAMAAAeACHZABE....TAFARAEAdAHALDDAHCCA..bCGDhAFABCED.aDGDIEEAhAHAAAEA.XFCChAIACFFDQGCAGGDBOEHD....hBAA......hCAA...,2,-28,0,28
QFPDJBXfTbaNYHOWgCKEIeVcSdGZULRMA,QAAADAAABACA...TACAaADDHAFAOAEACBBD.KAHBECEFeBEFhAAA..SCGAhAFAZCFBREGFADDBFFDBXEFAhAHAfHDFbGECNDDA........hAIA......hBAA...,1,-7,-30,23
UYBdCMIQWGPEaALfOFTHVDKbgJXZcSeRN,LAAAFAAAHACBKAEAJAEAZBEA..eAGHRCAA.UDFBdDEA.MAIBQDGBhABAGEAAEEDBAAHA.hACAOEHDDFGB.XGFChAEASFHH.NIBB.......hBIA......hCAA...,2,-28,-4,24
BDFAVXOEebNgMWcYZGdULQaHSRJKIfCPT,OAAAEAAA..eACA..bADAMAGB.....cBDDhAAAGBGAdAHALCCAhAEAHDAARDFAKEEDCAHBTECAhAFAFFGDACCANHBBgEEB.ZGEA....hBAA......hBBA...,2,-17,-6,11
gEZMSIdJPYUaeOVFKBQRWfHCALGXbTDNc,GAAATAAA.DADA....NACB.EAFAZAEEMAIBdCCA...PBGDhAAAaAHDeCFB.FDHBQCDAhACAREDB.HDBBhBAAADBAXGCDbEFASFDHIGGA..hAAA......hBDA...,1,-4,-19,15
bCXKZFTfYSDUPgMNVHROGeAcaBQdJWEIL,aAAAdAAAEADALADA..XAFAZAGBTCCASBHH.hAEADCCAgDFGhAFAMCFBHDAARECAeEHHACGBQEGAhACAWBBD.bDDDFGCHfGAA..hADA......hAGA...,1,-4,-13,9
JFGTEfCdOXcAQRLYSMIWaeKHDPUNgBZVb,RAAALAAAMADA.aADDHAFC.DBEBUAFABCCAZCAA..JCFBGDFAhABA.ECHFdDHAXEDDhACAAAAAQFCA.hAIASFGDeEHHKFBBNIBB......hBFA......hBHA...,2,-30,-8,22
PLXBFQVKbfRUdSDCgZMWEJOcaNAIHeTGY,HAAAeAAAGADALADBFAFAQAFAKBHBRCFB.dBHACCCD.ZDCAEDBBOCABhAAA.aDFFAAAATFEAhAIAXEGD.bFAASEHHhBDAMIAA.cFBCIHHA..hACABHDA.fHFFhBFADIEA,1,0,-24,24
XRgKeSTLcVEBJWGFHIOdDbZfANMQYUCaP,MAAAQAAAUAEA.aACERAGB...KAFAeBBALAHB.ECDABDDAhAIAGCFAHDFAdDAAZFDAhBAAADCBCEEDPFHB..hBBASEHH.cFAD.WFDDhAAA.OHFADIBA..hADA...,2,-18,-16,2
ZaALcQWHUECTfGbISgJNXdFeKYVOPRBMD,LAAAQAAAHADBEACA.TAFAGAEASAHBJAHB.dCAAhABAeCDBKCCDOCFEhACARDFFMDIBaEBAAEEAUEGACAGCbFGDgFAAhAFA.FGFH......hDAA......hEDA...,1,2,-2,4
aBLSQcHgDbKdUOeWVNFPIEMRfGJATZXCY,ZAAACAAABACALADB.QAFAHADBDAFAdBFAeBHH..VCAAhAAAFCAAECFB.REEBGFABhABAAAIB..TDGAhACAaEHDSHBAbEED.OHFCPHBC.MFIBhBHA.....hACA...,1,0,-20,20
VIZbCdUSELOPfcHQBXNaAYRJeKGTFgMDW,RAAAeAAAGADAFADDDAFA..IAFAZAFEdCGA.EAHBLDDB.hAAAOCCHfCCEhABAHFEBQGGChAAAXCFAADAAKEFAMCIBbFECCDFC.SFHH.BGCAhADA.NIAB....hABA...,1,1,-13,14
gTLEaSVcRJUXNCBWdePOKfYDMZAIbHFQG,HAAAGAAATAEAEADA..aAFDSAGB.RCAAUCEBCAHAdCDAeCFAhAAAKCHBDACAADABbDFAQEFBhAAALFBAcFGDhAIAXFFA.BHAA......hACA......hADA...,1,-4,-13,9
gaOcHGPYDNXVJUQRAeCSIBFEKWZdLfTbM,eAAASAAAFADDKAFAdADA.LAFA..bBFAaCCCHDDAGCEAhAAADCCB.XCGAhABAUFAAAAAABDGBEDBBZGAAMEIBhAFAOEGD..PFDB.VFFB..hAHA......hAIA...,2,-12,-3,9
gAIKUHQTMVfEZeDdBbWSNLYJGPFRXcCaO,KAAAHAAAMACAEADEeAFEBAFA...SBEALAHBGBCAhAAARCAACCGAaCHD.ABEBQCFAhBHA.TEEAZDCEbEDAhAAANEIA.PFHB..XFCC..hCAA......hCBA...,2,-22,3,25
KBgJUCWXcNbHITaYFeSfZPdDRQAOLGEVM,GAAAEAAAKACA.BADAUAEACAFA....XAGD..bAGDHCDAhAAAaCCB.eDADZDDAdEHAhAAARDFAAAIBLFCAMFDBJFFF.hAIANIDB....IFHAFGBB.SGGGhACA.fDCEhADA.,1,-16,-17,1
JWObHDeRcdATMgSfXLaEGCUYQBPNFIKZV,MAAASAAALAEAEADA.GBBA.CBHAUDEAQAFA.hAFABAHAFDGEZECBVCCAOFGDhAGAHDABRDFAABBB.TFCAhAAA.XFFA.aGHDNIAB....hABA......hADA...,2,-17,-6,11
JWSEAZYeGVMFTDdKgNPLcHQXaOUIBCRbf,eAAAGAAAMAEADADAdAGAKAHB.....PCDBHBCAaBEA.OCFEhAAABBFCRDGBJDEFEEBFAEGAZGFEhABAFEFH...gEGAhCAANAIA..QGDC.IHHAhAAA...hCBA...,1,-16,-19,3
ZJdLYXDePgNOaVSRWKAfGbUQcFCMTBEIH,GAAAQAAACADABAFAHACAZAGBdAFA.LAHBDBIB.eCDF.hAAAgDGGaCDARDDBADABUFAAhACAMEAB.EEEBJEHBXGFAhAAA.OHBASGCB.fGEAhADA..hAFA...,2,-33,13,46
WJKdXDUeEZSYMObVIAcPgFRBTGNaHQfLC,...PAAARAAAGADAHADALAFA.CCCDKCFAdAGADAIBUEFAECCBhAFAZDAAMCFB.bDFDAAAAFGAAhADABDHA..aDHDfEDAhBAA.JHDAeHCASGHHhCAA......hCBA...,2,-16,-15,1
cMQWEKFgeACRHUNTBSfabVGIDZOYdPLXJ,HAAATAAASACE.aAEDGACAZAFBdBHALAEA.hAAAXBGAMCCBEDDBFCAHhAAAAEGARFEABCEA.bDFDDEIBhAIAOEEBPHCCQFAA.KDHDCHHA.hCAAfGHA.hCDA...,2,-6,-1,5
baVEWPRcYKNfJdBCMGLHFXUDIegQASZOT,ZAAATAAAaACA...EACERAEFKAGC..fAEBdCGABCCDGEDAhABAHAGBXCCA.hBIADCFBeDHHAAIBODFDhAAAbFFD.PDHD.cGAA....hAGA......hCAA...,2,-22,-16,6
gCdcMHTOBYKJeXAbERLaZUFVWSfGDNIQP,RAAAZAAAFADASACEGAFA.DAFAQCCA.CAHA.dBFAHDGBhAAATDDABFDAKAHBeFEHhABAACCBECHBaGGC..VEGBhABAfHAB..IFCA.gGEBhCAA..hCBA...,1,-5,-31,26
CgeEISDXAZMcfUYLdOFKGRNHTQBPaWVbJ,ZAAAMAAAUAEAdAEAKAGARAGB..HCAABBBA..aDEA..VCFACDHA.hABAECDBDEEB.AACA...hAIAfDBALFFAGEBAhBEATFEAQGAAPHFA.JEHB.hBIA......hCAA...,1,-12,-22,10
EBVKDRNcfOQZYbFPGIaHMUWAXgLTSeJCd,LAAAeAAAdAEAEAGAKAEARAGF......fBCAZCAAbCEDGEAAhABAHCECMBIBACCA.hACATEBACDGDDCEBODHDhAEAQEECFGGB.aEHH.XGAC.SGGDhAAA.BHCAhABA..,2,-17,8,25
IgSFGTJMNBRbEUVHOQWLPDacdeCXZKYfA,SAAAGAAAMADARACF.EAGAHAEB.QAGALBFAaCDBeDEAhAAAZDFAKDHBAAABFEBD.TEDAhACABEAAbEDC.OFGDhABADDGAdFGAXGAA.....hBCA......hBDA...,1,4,-9,13
gHBeLSCYcQUFfXZOPbKWNMJaRAITdDEGV,dAAAEAAAGACAHADAeAFELAEACCBA.QCEAFCEDZCFB.bCGDKCHBhACA.MDABRFAA.ADDBDEHBhADABCBD.SEEDhAAAUGGB.XGGA......hAFA......hAGA...,2,-21,-7,14
EXGaCPYQBKNdFZHWVITbeOSfMcJgDLAUR,EAAAaAAA...CACA.QADAKAEA.dAGAHAGB.ICCAhAAAeBBBfCHAMCEBJCFFLEAAhAEARDABGDDABFGAhADAZEGBTGAAbGFASGBADFFBAAIB...hAGA......hCAA...,2,-14,0,14
QOTHVDGIEZdcLgKYXRfCBWAJSMbaUPeFN,MAAAaAAA.UAEAeACH.QAEAHAGDGBBAEAGAZCEAdDEALEGBhAIAKBHBREAABDDDABBBSEBDhBAAFEFBOEHDDBBBgGDAhBDA..fGGE.CHFD.hAEA......hBAA...,1,-7,-10,3
dJVROLIKAGePaBgTEQYbSDCHMcFNXZWfU,eAAAaAAABADAEADA..QAFA.SBHBHAEBMAHBFCCAhAAAZCCFUDFAdDAAREEFLEEDhABAAAGBPDHDTGGAhAIADAIBCGDD....XGGCfFCA..hCAA......hCBA...,1,-9,-19,10
ALPUYBGcaZVbdJKNIOfFCWQESTHDXMeRg,LAAAUAAAGADAZADBdAGAKAFA.OBFHFBHD..QDAAhADAECAAHDGBMAIBRDEF.ADCBBEEDhABAaEGD..VGCAbGBA.hACAJFAF..IHHACGHA.....hAFA......hAHA...,1,-6,-13,7
GMEZULIHDKYcOdSXebfRABVFNCaQJPWTg,FAAAaAAA.QADA..PADA.TAGAGAGAEBBBZCCAhADALCEBHDFBKFBAOBDHhAIAdGHAeEEDRDGBACGBBGFAhBAACAFA...........hAIA......hBAA...,1,-14,-16,2
IZcLSVBCTUeYXFfEJADMNWgGadQPbKORH,MAAA..gAAAdAEAQAGAKADAHAFBZBBBLDDAhAGABAHATCCAeDGHFCHDEFDAAAAADDABhADA.GECBbGCAIGHAhBAASFAH.CFGAXGED.hBBAfGHA.hBEAWHAA.,1,0,-22,22
HCYOJDZAeKXcEMUbVFLQfWaBRIPTgdSNG,eAAAXAAAEADAUAGAFADA..LAGB.QCDAhAAAaBDERDDATEGAdDBAGEFAhABAHGBAOCCBZFDBAAIBMCIBhBDAfFFEBGBAIHHASDGE.CHHA.DFDBhBGA......hCAA...,1,-2,-4,2
SeDLgRPZGfNEAXQKBVbJCYFTacUOIdWMH,QAAABAAAJACA.FACE..aAFAOAED.dAGAHBECeBHHLCBBhAAARDCAGEFAECHFACDBKEHBhAAACDDA..TEFAhAIAIGBAMEIBDGDBZFDF.fHGB.hAIA......hBGA...,1,-13,-14,1
CFIVOBUYLdaZGeHcgSEDQRJNTMPWfKAXb,CAAAFAAA.OACDBACALAEAZAEA.HCAASAGEEBHF.RCDF.hAFATCEAMCGB...hBAAfDHAACIBXEGDhCAAbECBIFCAUFAAaEFDeFEFDCCAJFHB.NIAB.hAAA......hACA...,1,-9,-18,9
AaDFNQGYTUVSfbXEKdBPHgCcWJMZIRLOe,aAAAFAAAGACA.UAFAfADA.EAFAdBHAHBFCCAEDJDFBZCCAhADA.RDFFeDHHAEEB.QECAhAFA..hAIATGGASGHHKEHBBFDD....hAIA......hBAA...,1,6,-40,46
FdKYcGPIRLXBQfZUOHVgSTNEebaWCJDMA,dAAAKAAAGACARADALAGBQAEAZABBHCEB..SAGAhAAAEDCAeCHH.aCABCEAA.DCHBAAIBFFGHhAEA..PDFBBGCA.hBAAODHD.TEAAWFHH.MEEB.IGGAhACA.fHABhAEA,2,-19,-6,13
cAQgWdJYfGSZaBNMHbKDVXLeFROITEUCP,QAAAdAAAJADA.GACBZAGBBBDDHAGB.bCDCDBIB.LCCAhACARDABTEEA..EEEACDHAAAFAhAAA...gGEAhADAfEGAaFCDMEIBKHGA...eGAA.hAIAFHGC.....hBIA...,1,11,-29,40
fRSBZJNHECaXgcLGOUMDIFKeTYbWQdVPA,RAAAZAAAHADBEADE.CAFA...aAFA..XAGDLCABGDAAMAIBFBGHhABAeCCB.TDGAhAAAbCCAdECAAAIBBEEA.gFGAhABAOEEBDEIBKGDAQGFA.hADA......hAFA...,2,-5,-5,0
TcFJAQUGPVegXDIRdONKWMLfHSCZaBbEY,GAAAeAAADAEARADAdAGAKAGA.LCFAHBCAZCEEBCDD..EDHFTEEAhAAAFEBAAAAA..UFEAPEABhACA..XFBChAIAOEGDMEIBCGGB.aGEC......hADA......hAEA...,1,-14,-18,4
cBCWdXREbKfaUNLGIVMeOFTZPQSJgYDHA,CAAAdAAARACA.EADA..KAFCaAFDLBHB.GCAAMAHBeCAA.hAAATDDAZCCAQECAhACASCHHJEFBDDGBACGABGHAhADAbFBBUFFB..IHDA.OHFChAIA....hCAA...,2,-16,-11,5
gWJQefYNVZXETaLOcHDIPdCKUGMABbFRS,FAAARAAA..SADBJADA.eAFA..fAGBVCCBEBHFLCFBhAAAHBCADCGAdDEAhAIAKDHBGFABADGABDHA.bFGDhABAQFGA.......hAFA......hAGA...,2,-36,-3,33
NVHWcXEULPdJQSMYBgAIefRKGTDZCabFO,eAAARAAAGADAZADBCAFAFAFA...OAHDHAGBXCEDLDAAdDFAhAAAQDBCMDHBBFBAhABAAAAAKDHBDEIBaFFA.bGDAVGCAhADA...EGGB.......hAIA......hBDA...,2,-16,-4,12
aDJdSOWUNBQGLAcCMIYgEPXeVHZbfTKRF,MAAA..gAAAEADA.eADAHAFAZAGBbBBCTCCA.hAHARDABaCEDdCFDOCHDhAIA.UEDAQEFAhAAAADDACFFBIGHAXGBAKHFA.DBIB.SFHBhABA.BHHD.hBAA...,2,-15,8,23
VdMDHEALaGIBfJRbWFSPKYUNeZOXQcCTg,GAAABAAARACAFAFAKADAUAFA.ZCDAQCAA.CBHA.TECAhAAAdCFAHCDDAAIBLDHBhACAaDGD.JFEBSEHHhAAA..PHFCeFFB.ODAH.hACA......hADA...,1,-15,-23,8
CSDcUJXEFPKGaWHfRbBZLITMgVdeANOYQ,OAAAQAAADAEA.UADA..EAGAKAFAaBBCHCEC.RDBAZEFATBEAhBAAMAIB..dCHAADBACGGAhAAASDBA.hAHAXDFDFHCA.GEDA.fFHAhBDA....hBEA...,2,-26,-15,11
XNSVEGMZgPdDRBQaYWCfbHOLAcJKTFUIe,KAAATAAAFACA..UAFAeACE...SAFBECCAZCFE.dAHAREDBBAHAhAAAaBDCCCCD..HDEAhAAAAEIB.IFGA.hBFAXGDAVGFA.MDIBDFFA.YHBAhBHA.fEDEhCAA...,2,-36,-15,21
LRPNWVMdCUbOZGTBAcXeHaKQYEIJfFgSD,eAAAHAAAaACAQADAEAFA...fAFFSAHHRBGB.PCCAhAAAVCCB.dDFAbEFAGEGAhAFAAAAA.KFEDIGDAhAIAFGCBDDIB..WHDAMIBA.CGGA....hBHA......hCAA...,1,-2,-6,4
JTgeBYHGfUdWOLXPNMcKSaVRQAFEbZCID,EAAAZAAADACA..TACAeAEAHBFCGAEAdCCDLAGB.XCCChAAAMDFBSDGAhABAREABAAIBCDHA.gFAAhAFAfEEEOFHBcEGCaGDBFGGH...hAIA......hBIA...,1,-1,-16,15
XUMaDASOeQBRcCYLJdHgfITPZKVGEbWNF,eAAARAAACADB.LAEAHAEB...ICCAZAGBGCCAEBHF.bEFAFCEAhAAA.MDBBAAAA.QEDAhABABFEDJGAAdGGATGFAhAFAKHEC.NDIA..aFFADBIBOGAE...hAGA......hBGA...,1,7,-14,21
XgEaHOFQdJbfCePGWLVNYUTBKcARMSIZD,RAAAMAAAZADBDAGA..EADAHBFAQAFAdCCC.JBBBCDAAGDGAhAAA.LEEBVCEBUFGAhAIATFBAKCHBABHASGGDhABAXDCDaHECOHBE.....hBAA......hBBA...,1,-3,-19,16
eCXUBVHFGWdOMLDgSbacTQJZEIfYARPNK,RAAAKAAAeADECACB.BAGBHADBGBDAdAFBLCGBDAIB...SCCDhAAAaCCBQCFChAAAEDFF...fDHAhABAAAIBXFDCFFFBMCIB.gGBDhBGA.TGGAIGHAhCAA.PHCC.,1,-10,-12,2
BOMTbFJRdSQAPafWZYKEHUIVDgCeNLGXc,aAAAZAAAEADEHACB.UAFADAFA..eAHFGDEABBFAMAIBFCAARDDAdEAA.hABAABBB....fDGBhAEAKDHBIFFACEDCLHBAhBAAOECBTGDASGGA..PHFChACA....hCEA...,1,-2,-25,23
MLHUZKICGRaSbPeDTWAEcVQXgBYfFNOdJ,EAAAQAAABACAFAEAdADA.MAFAHAGBZBEBCBDAGCEARBGB..bDBBhAAAeCCB.DDIBABIBXDFDhBCA.fEDEhBDAOEGD.UGGAaGDBSGHHhAAA......hAIA...,2,-25,0,25
BULOQIZeEbSHKfCgXdRWTJFGPYaDcMAVN,BAAALAAAQACAeADHEAFAHAEA.CAHBdCAARBFAJCABGCEB.hABAaCCHMCCB.AAIBUDFBhACAZEEAbGAAKEDB.XFADhAFAFGGHDEIB...VGFAIHEA..hAAA......hACA...,2,-4,-3,1
IfRVCLWFEGKcTgDOdPaYXMJSeHbNAQUZB,ZAAABAAARAEALAHBEACAGAEAKCAA..TAGAOCEB..aCAAMACAhABA..eCHFHCFBhCAAADDAQEBAhAAAIFHACFFDFHCADEEBdFFA.XGAC.SEHHhACA...hCCA...,2,-21,-4,17
PWOYQNDTMCUeREVgKZXfHaIdGbcLSFJAB,BAAAOAAAQACADAEA.MAFAeAFAEBEEKBBD.ZBEAHBGBdDCAGEDAhBAAbCAB.LFFBhBDAFDDAABIB..PEFDhAAAYCHBTGBACHHA.......hBIA......hCAA...,1,-3,-20,17
NdPDBJKUbSZVTGCXIgfEHRLYeFcMaAOQW,QAAAdAAABADAKAFASACAZABB.GAEACAHB...XAGAhAAAICEAECDBHCFBhAFARCGBeDABFCHFMDDBhBAAAAGAOEFD.PFHDDEEBUFFB....hCDA......hDAA...,1,5,-31,36
DOYaVbZTHQSgMKeNdcfFJBEIRXGCUALWP,LAAADAAAOABEaADDZAEBHAFA..QAGAMCABeCCBdCCAFCEDhABAECGBRCGBGEFA.hAEAAAHA.PEEBVFAASFHHhACAKFHB..fGFA.hAFABHHD....hBAA...,1,15,-33,48
XbRMDEJBZYLKTUWHCFaNAOfPdQScGeVgI,OAAAdAAAQADAGADAeAFA..gAGAXBGARDBBECBAhACAZDEBLDAAKBBDTDGAhAFAHDFA.aEDDADDBSFHHhAGAIFBAbFFADGGBBCHA.YHAAhADA.CHFA....hBAA...,2,-9,13,22
POLXNMEUVKYDgGJRQTcBdHaICSAbeFZWf,eAAAZAAA....fADBLAEAMAIBEAFE.KBCADAIBGCDBhAAARCAAQCEATEFAdEHAhABAHCGDaEEHSECAhABAAAFAbGCC.FFFB.OEHD.NHAB...hACA......hAHA...,1,-5,-7,2
eJZMdBPaXLEbNRAcWVCfHDIgGKFOSTYQU,VAAAHAAADACA.GAEAOADA..TAGAQAGAUDCAeCHFhAAAZCDAdDHABEBCaBECEEEBhAAARFFBACCA..CFHA..IGAAhAGAFGFD...SGDBMIBA..hAIA......hBEA...,2,-14,-11,3
UERVMfZDQbKYGgaOcCSBPTedLXFWHNJAI,EAAARAAAMADAZACB..QAEAKAGAGBDAOAGF..SBFGhAAATDEALCBDhAAAFCHDHDFBAAIBVEGBDCCBYFHBhABAaECDBGDA.........hAIA......hCAA...,1,-5,-21,16
XEWGNcVZgFaeJKPMfYRbQTLOICBdSAUDH,HAAAEAAAGACAVAEAZCAAFAEA...eAHHKAHBMCBBRDFB..bEABTCEAhAAALEHB.CEDAdHADhAAAACGAXDGA.hACANEEA.aCCA..fFFAOFFH.SEBHhAHA.DGHB.hADA...,1,7,-13,20
JANWgZRdKIbXCETceHBYQMGLfaPFSDOVU,...NAAA.ZAAA.RAEAdAHAKAFA...XCAAEBBAeAHHHCFABBDAMACAhABAGCEALDDBhCAAaDADFDHDOEHB.JFFBhCBAACGBIGGACECA...cFAD.hCEAfEDEDGIB.hEAAWHAA.,1,1,-42,43
TPcEHdSVZfeLKIYCFabBWGgMXNQDJRUAO,TAAAEAAAHACA.dAFAZACBeAHBLAFA.KBEDCCCDaCECBCADGCGAhAAAMCGB.QEAAhAEAREEBAAGAOCHBSEEBhAIA.fGFAFFDH.....hAAA......hACA...,2,-26,8,34
WXDbUREJANTZIOLPHFYegCadSMVKcfBGQ,ZAAALAAAHAEAeAHHaADD.dCAAMAFAKCCDBCFAGBEA..QECAhABADBGARCAAACAA.TEFAhACAOCGD.FFGHCDHASFHHhADAfGCA.bGAC......hAEA......hAGA...,1,-9,-20,11
gPBXEaOCVAUGMLeFdKYDJbWSRQcTHZINf,GAAAeAAAdAEADADA..JAGBSAEA.RAGF.TCCAHCDAZDFEhAAAIDHA..hAAAfDCEBDBDEDFBaEEHhABACFCDAFGAMFIBLFHBKGGB.bGAA....hAGA......hAIA...,1,-11,-22,11
WZURYdGAEFQNBKgIJcMTOHPbaVLXSCeDf,EAAAQAAAKACA.JACEMAEA.HBDCaAFDLAHBCAHA.eCDBhAAAfCCEZDEBRFBBGGEBhBFAACHABDFA.gDGHhAAA.TEDA.bGBCSECBhBHADFIB....hCAA...,2,-13,-9,4
VFHZJDCEBQXOGgfLYeIMTSdWPRbNUcAaK,aAAAFAAAHACBZACB.CAEABAGAQAEA.GBGALCFA.eDEBhAEAMBBBdEGARDEBbECDUGAAhAGAAAHA.KGCA.DEIBEFHF.hAIA............hBAA......hBIA...,1,-11,-24,13
MDJUHGPfOYZKgcWQNeabSCRdEFATLIXBV,TAAALAAA.BAEAMACADAGAHAECGBEBOAHDZCAAKDFD..hABAgBDGQEAAhACAeCCBaDGD.bDGDREDBEFHFhAEAADGBXEEC.JHAAfHBB.hAAA......hAHA...,1,-4,-7,3
WGJfOMQTdScYXNRAUVaKbBFegHDLPEZIC,aAAABAAA.eACAHACBLAGBEAEAZAGBCBFAGCAA.OCCAMBBBdDEAhAEASCHHXDGAhBAAAACAKDDDFFGBDGIB..hBIAIEFA.fFDA.TFGAhAAANICB....hAIA...,1,-7,-29,22
ZNdWMGaRbXgVFeTDABSHfKLIcEQYUPJCO,HAAALAAAEADEQAFCUAEACAGA.ZCAAdCAAGCGARCCB.bECAXCFAhABA.FEBDeCCEhAAA.AAHAfGDAhACAKEFA.IHHAPFEB..NAIAaGGA.hBIA......hCIA...,1,5,-22,27
UGcfALKXdBRDaMbCIVSPEegNQZTFOWYHJ,LAAAdAAARADADAGA.aADD..MBHBCAFA..SAGHECBA.eBHHhABAQCEAZCAATCEAhACAODABHEECGGDBhACAAEIBBFAAbEECIGHA.....hADA......hAEA...,1,-8,-22,14
IGBCNQKDdeTSMaWXJgRPEFUOVLHZcfbAY,GAAACAAAKACA.eADA.MAHBaAEA...XCDARAGFEBEF.OCGHhAAAHCAAZDCE..bEAAhACAACCABDGDQFFBhADAdFFASDHHgGBBFHGE.....hAEA......hAIA...,1,-7,-23,16
REdFAVLNfTXWZGeMPBQbCHYOSaIgJKcUD,LAAATAAA.ZADBeACEMAGBBAFB.QBGAHCABSAHBhABAaBDC.IDHAhACAKCCDDDEAEEEAABHBVDEBXEGAhAAAPFBCCGGAOHAAgGGA...hAHA......hAIA...,1,1,-20,21
EKcXRIBAHdfQZPOVYeTWDNLJFUSGbaCgM,HAAAdAAAZABBOACAeADADAHBLAGB.FBEDGBFAaCCB.MAIBhAEAEDDBKDHBRDCABEHA.AFCB.hBAAQFEA.hCDAPGBCTGGANIABSGGBCFFD..hAAAcFCD.fHEBhCEA,1,-16,-17,1
fSgCDWFdAVaLQXNGOcTKZMeUPEHJYRIBb,aAAALAAA.QAEAGACATAEAZAGBeCAAEAGEHCECRDDABDHAhABAbEAB..SEAAhACADBBBdCHAAEEAXFFAhAEAOFFAMGBA.UGGB......hAEA......hBGA...,1,4,-6,10
CYGfAWSdaITMRbeQOEDVcLHgZFKXBPUNJ,dAAAaAAA.MADARACF..eAEEEAGA..DBDALAHBHCACZBFEKBEABDEDhACAUDEACDGA.GEGA.hBAAABBBSGEBhBAAbECD..QFFA.OFHF.hCAA......hCHA...,1,-10,-22,12
DJAIXaPMOfNBdUHQGcVgeEbCLSTYWZKRF,aAAAMAAA..OACDBADAHAEBGAEAVBBBEAGALCHB.hAGATEAAZAGBREDADBIBAAEBXEDChAGAfEHAdEGCQGDAhBAAeGBESGEHKGHB.FGGH..hBAA......hBBA...,1,9,-12,21
gUJETMcHLAWdFBCNQXRfeOSaYVbPKDIGZ,dAAACAAA.QADARACA.eAFAaAFA..VBFBKBHBGCAB.hAAAZDEBUCAAEDGFMEIBhACAHCDBAAIBBGAAXEGAhACASGCB.PHFCDFFBgGGBhADA......hCIA...,1,-1,-26,25
FCRZVHQNPJfEGUOSeIXKDdbMLAgTaWcBY,aAAABAAA.CACAZADBHACB.QAEA.JAHBEAFAGDEASAHHhAAAeBBDKDHBdCAAMCCBhACAADEBTEAA..cCGChBHARGBAPHFC..ODEDDGGA.bFCD.hAEALFHB.gGEGhCDA,1,1,-16,17
ZMVHDSIFbPYJAKNRTUfWCBaLgQXOGeEdc,RAAATAAAUADA...CACBLAEAQAFAGCCAECCB.ZBFEHDFAhAAASDHBFEDD.bEFBhAAAPFFB.AAIBfHBBhABAaFAAOFHBeGAG.MFFBDGIB..hAFA......hAGA...,2,-11,-2,9
TUADEgcGHXVBfYIJWMbCRKeFNLPSaOQdZ,EAAAGAAAHACABADA..fAFBIAFAMAHBRCCAeAHHLCDAhAAAaCFDdEAAZEEAAAIBDCIBXFCChAAAJECA.CDHAFGGHhAEASDADOHAC.TEGA.UGEA.hAHAcFCC...hCAA...,1,12,-15,27
AYCNUIVcPSZWRMbLXGOEgKdDfBTQHaeJF,CAAAUAAA..VACASADAZAFB.RAFFLAHBGCAAEAHFdCDABCCDhAAAHDAB..eCHFhACAAADAIEFA..hBAAPDEBbEGD.OEHDDEIBTFDAaFAHFFCBYHCAhBCAcGEB...hAFA...,2,-16,-2,14
TYBNQPJGEXgOVIHMaFWcAKRefSZCbLdDU,RAAAeAAAZADBLAGBdAEADAGA.UDAABBCA.QBGAGCEAEDHFODDAhAAAHFBC..aFHDFEBAhABAAAAA.SEEAhBEA.TFGANIABXGFDgGBA.MIEAhBGA.....hADA...,1,-7,-11,4
PXcabBCfIDeOWFSGMgEQTAKUNJZLYHVRd,KAAAUAAAZACBHADARAEA.dAGA...XCBAaAHDBCAACCEA..DAIBeCEBhAAAFDAH.GDGA.hADAEFAAADGALEEAhAFA.PFHDbGCAOHACMIDA.....hBAA......hBCA...,2,-18,-18,0
NALRdCOYBfFUeaGJSQITVMPWgXKcZbHDE,RAAAdAAAOADABADAFAFA..eAGFGBDBQBDD.TDGAhAAAMAIB..PCBDhACAXEDAZDDAHEGBEFHFAAIBLHCAhABAfGDAaCCHSDAD.hCAAWFFD....hADA...,1,0,-25,25
IVcCYRAHKWUJDPMFEQNeOTgXSbZadBLfG,HAAAKAAAUACADACAMAFA..EAEAeBDAOAGD..TBGAhAAASCDAaCCCdDFALEEAhAAAGEBAIEHAhBEACDFAAAIB.PFEBQGBAXGGABFHA.hBIAfGGE.hCAA...,1,-1,-30,29
OUSTDfBcNdPVZMRQYJLHCAKbgWIaXFeGE,KAAA..bAAA..IADAaAEA.eAEHEAHBSBDHhAAA.TCAABAGAdCAAhAAAZCEBRCGBQCFAhACALFBBHGEAAAIBXCCD.GFEBDEGB.fGAAhAGA.PHDChCCA.,2,-34,8,42
NSRTCaWQbEBXYdMGUHPKLeFfOcDAZJVIg,ZAAAVAAA..IAEA..SADBRAFFaAHD.bAEDECAAXAGAhAAAdDDAGDGAHCGBhAGALECDeCDDOFEChAHAAACAgGEATGCACGHABFEAMIFAKHAA..hABA......hAHA...,2,-9,9,18
SXYRIAHCTLgGcaWfNJKODbBEeQPdVMZUF,HAAATAAAGADA.aAFA..fACBKBGDDAIBECABeAEEdDFDZEFEhAAASAHBRFBA.hACAABFBLCCBgGGAhADAcCEC.JCHFBCCDQFFA.hBFAMEEB.XGCDhAAA..,2,-2,1,3
EIHMCBTLXdKQgfPAcUGZNFYVeWDbJaOSR,GAAAZAAAFADA.eADADAGA.aAGDRBEA..HCAAMAIBBBHBLCDB.hABAdDGAQDEBhACA..fEAEhAAAADHAUFGANIEB.VFEB.JFCF.EHGA....hACA......hADA...,1,-4,-24,20
SRLIPQgNHOZAEbcJaXWCBDTVFYfKUeGdM,EAAAJAAA...aACDCADBBAFADAEA..FAGDKAHBGBDA..dCCARDFALFBBhAAAQCFAHFFChAIAADHA.bGDC..XECAhAFA.TFFAfCBE.MIFAhBCASFHB.hBFAIHAA.,1,7,-48,55
eWOaPRUdFgGNICfZHBATXQMEcKDbYVJSL,TAAAMAAAKADA..DACA..VAGBLAFA.eBDBaBBBRCCAdCFAhAAAGDFACCCDHDGBAAFAEFCAhAIAbEBB....SFDAhAGAODHFFHGEgGGA.fHABhAHA...hBAA...,1,0,-21,21
FVYMIKGbdSQZDfAceXBCWTaJULHgENPRO,eAAACAAA..aACALAEAHAEB.EBCFRAGBFBCBMAIBGDDAdCEAZCFBAAIBBDGDhAAAJDHF..UFAAhAAA..gFGAhAGAODDHIGGASGFD.....hABA......hAFA...,1,-14,-17,3
fTZCWOBQSDGJUdIEYFKgLRHaNAPMecbXV,eAAAXAAA..TADAZACBOAECBAFBQBGAGCEAdAHAECGBhAAAKCCARCEFHECBAAAAMEGBhAHAbGFA...CEHADGIBIGAAhABAFHEC..........hAGA......hCAA...,2,-21,-4,17
EaNQTXDKBIbfUVdJWMAZCRGYSFHgecLPO,RAAAGAAAFADAHAFBeADALAHBEAGA.QCCATCDAKBHBBDFDhAAA..bCFDVEGBdEADMEIBhAAAAFFBCHBA.SFCAhACA.gGGD.OHDChADANIEB......hAEA...,2,-15,4,19
SFUNAQeYDHXdbMBJIWGVECZgfTcPLaORK,eAAAHAAAdADAMAEABAFA.JAHBGBCA.EAHFZCAA..TBEAhAAALCFBRDGBFEBBADFBQFAAhAAAXEECbGDAIEHAhACACGBA.fEDA.aGGA.hABASHAG.hBEANIDB.DCIB.,1,-4,-14,10
BZWJgOMRVGPbaIUNQTcYSFdfKCXEDHeAL,ZAAAJAAA.MACARADF.GAEB..aAFAUCCBQBFD..hADATCGASCCDhAIAdEFACEHAEFCAHDFAAAHABGHAhABAOEEB.bFGD.NIBB........hCAA......hCBA...,2,-25,-11,14
MRbLSBKFaWYCVJUZOEGdIDPeAQfXgcHTN,QAAAXAAAHADAMADARAGF.LAHBBCDDFCFHaBDA..CDAAUFAAhAAAEBGFdCDA.DDFBACIB.fEGAhAAATEGASEEDhABAKFHBVGBA.........hBCA......hBGA...,1,-11,-19,8
QgYNdEGHAMVaSfJBTUDeFLOZRIXPKbWCc,aAAASAAABADA.DADAeAEHLAGBZAFBRCCB...XBCAhAAAKAHBCBBD.QDBAhABA.gDGAhAIAdDAAHCGBAEFBMBFBfFGETGBAOEEB.hADAIGGAWFHH..hBDA...,2,-23,-19,4
LeTDfaWMSRNIbcGPYHZgAdQUBFVEJXKOC,dAAAQAAAFADA.EACAKAGALAFAeBDBDCCBaBDD...MCFAhAAARCFA...IDFAhAGAGEGAHFCAADCBBDHAXGAChACATFFASFHBNICB.PHAAhAHA.....hAGA...,2,-25,-5,20
DdZBaWFgYcPQXCOMbNJKRLIeAHSUEGfTV,HAAAEAAAGACATAEAdAEBZAGBBAHAFCAH......gCCAhAAAPBFBQDGAhAAAOCHDbEEBKCBDRGAAeFDBhACAACHAfEDAaGFD.cFFACHHA...MHAAhAHA.NIEB....hADA...,1,9,-8,17
YWbVEKINJRLeHSUZXgCQDOcGAdPBfMTFa,dAAABAAAMADAaACA.......bABDEAFAKAGAIBCA.hAIARBFAHCDBZBEACDEAQDGBhBAAODGDAAIB.TFBAhBDAFFAAVGEALFFA.eEDB...hAAA......hAFA...,1,-8,-23,15
bVFdJGSYORKgMPQCEeWAfcUDITXBaZLHN,UAAATAAABADA.ZAEBHACB.VAEAdAHAGCFAOAHDRDEAMCDBhADAQEAA.EEDBhAAAABGADDIBaCACLFGBhACAFEEH.SHAAKFHDCHDAeECDfHDBhAEA.....hBAA...,2,-30,24,54
YRbLWXgPdQfecNAGHUCZOTISMFDEKVBJa,HAAAZAAAOACATAEA.MAHBEAFABAHA..aCACRCCALCFBhABA..XCCBhAAAdCHAeEEDAAIBGCFAhACACGGAFHDCDGIBKEAA.VEDB.bGAC.PFHB.hCAA......hCBA...,1,15,-20,35
CcQdEROFNfgVPBaSUAIWKZMHDXYGeLTbJ,KAAAHAAADACAGADALAFATAFA.CAHBdCADRBCAFCFD....fCGAhAAAVDBBBCHAaCHDhACAAAGA.ZDAE.MDFBeEDHhAAAbFAAQFFAEFHB.OEHD..hBDA......hCAA...,2,-26,16,42
LabHDWMVNYQUBRJEFAGZSIcOPdXKTfCge,ZAAASAAAOACAdAGAKADA...CBEALDDAHAFBMAIB.VCCAhAAAQEGARDAB.EFDAhABAAAHBGDGA.IFEAhABAXGBCgGEAeHDADAIBNCCAYFAFhADABHHA....hAFA...,1,-12,-13,1
eAXDQfRYOHIVUSKNTBJMbLdGPZgCFWEca,QAAARAAAHADBUAGAKACABAFD..bAEBGDAA.ZDDAFAGDEDGEhAAAeBHH.ACDAfDDAhAAAOFDBSFFAhABATEFAMEIB.dGDACGHA.aGHHDCCB...hAIA......hCAA...,2,-14,-8,6
QVFRTSOPEcKIWZCdBbfaMeUNJYHDgAGXL,GAAALAAAQADARADFOAFA.EAFAKBFAZBGBBCAAaCDC..eDADhAAAUDDBJEEBHDGB.ABIBFGDAhABATGFA.SDHHhACAIHHA.dGCAMCCB.DGGB...hADA......hAIA...,1,2,-18,20
FgPQNfbILUSDdVZJcOHEKCTWBMYeGaAXR,RAAAFAAAQADC..bACDLAFBDAEAZAEE.OAHBHCEBEBHFhAIATDDABDHA.eFGBhBAAAAAAXDGA.gFCBhAIAfGCASFFA..hCAA......hCCA...,2,-20,-20,0
SbVAJBUTeYWcgdRQGOLMXCZDEKHPfIFNa,BAAAeAAA.......cACARADAGAGAMAEAZCCA.EEAAHBEBhAAAfEEEFAHDaBCHSDGAhBGAAAAAUEGBTFCAhAEAgEEGdGAA.LFHBDGHB.KGCAhCAA......hCBA...,2,-19,-4,15
JQYHMSXTgcObDBNeKdPILfaCZUVAWGFER,GAAARAAAQADCHADAMAFA..TAGAOBFEBCCDeCDBdCFAhAAALDFAaCHDZEDAAAFAEFFAhAAA.SDADhACAXFGD.bGDCKHDAfHGF....hADA......hBAA...,1,3,-16,19
dGFMBQPEKCDAZfTUVgOWXYIHLJcNSeRba,ZAAATAAAUAEA..OACA..XAGAHAFALCCAhAAA.cCFDeCABRCFAdECAhAHAGDDAMCIBQFFAhAIAECCBDEIBAFGA.fHEBgGGB.IHAAhABASDBDaEBDBHEAhACACEED,2,-23,-11,12
gcUQEJbZDNSLVFWeKOfXHYdIMABPGCRTa,GAAARAAA.aADAUADA.EAFAZAFBDAIBLBHB.FCDBeBGFhAAAODBDHDDBdEEAACCBCDHATGFAhAAAQFGA.hACAJHDAbFCD..........hAIA......hBAA...,1,-10,-23,13
cXOaBVRMEdZgDCSUYAPIKFNeTbWHLGfQJ,KAAAeAAA..TADAHADAGAGA.QCCCXAFBaAHDhAAARDFBEEEBZCAACFAA.UDFAAAAAFFCBhAFA..bEDDfFHAhAGAOFCBMDIBDIAA.SGGB..hACA......hADA...,2,-17,4,21
gcYfMGbCeVALIJDNQBSWPXRZaUOdFTEHK,LAAADAAAQACASADH..XAEARAFAaCAA.dAHAECEFhABAHCDCKCGA...gDGAhAFAfEFAbFFAhBAAeDDDABBBJHBABEHAWCCDZFAA.FGGA.YHEAhACAMEEBCHHD....hAFA...,2,-12,-1,11
CSGbYOeZRUBTDXVQFHdIEgaPKLMAWfJcN,JAAACAAAGACA..OADARAEABAHBDAHB..QCACHBCCECFF.hAIAaCEELDHB.hAAAABIB.fCHAhACASDDDeEEBZFFBTGBAFEGHdFAAIHCAhAEAKGED.MEIB...hBAA...,2,-24,-3,21
RIEQUZPcJLeHBaWYDbSgVFCAGMOdfXTKN,GAAAdAAA..TADARADAEAGEZCDA..PAFALCGB.HEAChAAAaBGEDCCBbEEDSGGBhACAFCFHADAA.MCIBhADAXDCDNIAB.QEGAcFCD.eFFBhACA.BHDA...hAEA...,1,5,-20,25
VGAcSKYefNaODEIUQTJZBbHdLPWXCgRFM,KAAAeAAA..aACAEADAUAFAQAFA.ZCCAHBCBdBHALECBhAAAXCGARECAMEEBAAIB.hAAASFFA.hBFAfGHADEGBIFHABHEAPHBA.hABACHEA......hAIA...,2,-22,-13,9
fEBOSaWMZJRUKVXFHQCcIAYDLdTbeGPgN,LAAAdAAAeADAGAGA..gADHECBAOCEBaAFDZDAARBGFKCAAhABAFEGHHFEBQDDAhACACFCDAAIB.TFGA.hACAPHAABGBDMDIB......hADA......hAEA...,1,-6,-7,1
gYbERTWVOLCNcBfaUedJAXSKHPFQGDIMZ,KAAAHAAAQACCGADAMAFAZAEB...bBFBRAGB..TDFAOBHDhAAALEAACCADBCCDaDEDhACAeDHHAEHB.SEEDhAAADFGBIHCAEGCB.WFHHcGGC....hAEA......hAIA...,2,-11,-5,6
GSYAPRUMLcWBEFCgaIDfdHeKTVZNQbXJO,RAAAMAAALADBBADAFAFACAFA....aAGDDAIBHCEBeBBB.KBEAZDGBhAAA.QFAAhABA.bGDCOCFE.hAFAGDCAAAIB.cEEAEDCBIHHAdEHATGEAhBAA.....hCAA...,1,-9,-27,18
WBQRDAKITaOMgcJbedYXCPGSVNLfUZFEH,TAAAaAAA..MADAJACA.dAHA..CAFBGAGASBBALCCAhAAAZBDBHBFBQECAhAIAADIBOEFBbEFAeEGHXGDAhBIAPFCB..fGGA..hCAA......hCDA...,2,-12,-12,0
gWKYJBXDPTFfbHcUEVGOQLZAICaSdMNeR,aAAAdAAAeADA.RAGB.KADABCBADAFAFAHDHCEB.EDABGBFA.LCCBhADAAAIBSDCHhACAMBBB...gEGAhADAYCEF.XGCATFGA.fGHAhAEA.....hBAA...,2,-36,-3,33
UZKPARYFgHWVIESJdGaXDQMLcBeOTCNfb,RAAAFAAAHADB..IADAEAFAdBHAGCFA.aCCHQAFAhAFA.MAIBLDABhAAAeCCATDEAfEEEhABAZDGFACCAYEHBgGFBSFDDhADADHBA.OHFC.CHCD.hAFA...,1,2,-15,17
AONYHSWcQbeKJaVUdDgGRfFIPEBMLCZXT,OAAAHAAASACE.QAFAeADAaAGDdCCAGCCARDFAFEABhAEAECFBMAIBZEFAAAIB.YFABhAAA.cGGAhAFAbCDDKFCD.UGGAfCHABGDACHFC...hBAA......hBBA...,2,-13,12,25
aTbdHEgIKRAFYSLOcVGUXDNPeQCWfZJMB,SAAALAAAOADDGACADAFA..eAEAQBFACAHAZCEBMCHBhAAAaAHD.dEAAHCAAEFGBKGDAhABAADFBFDHD...cEEChABA.UFBANCIA.fGEE.hAEABGHA....hACA...,1,-10,-15,5
eVMHDCgOabSPLKXWRJGFEIQYBNfTUcAdZ,eAAAHAAACADBOADC..bAEDLAGB.XCCARAGBGCCAhAAAEDFBQCABhACABDHATFAAAAIBZEFAMFCAaGAAKGEAhAGAFFGDNIABfGGB.....hAAA......hABA...,2,-16,8,24
XJeCLUWTKVIfMgNESOFRYPAacbGBdZHDQ,aAAAGAAAZACB.HADADAFA.QAGC.eCDBLBEATDFAhAAAKBBDfEHAhACAMAIBEDEAFDGDRFAAACIBBFFDdFBACEDDUGGAhBAAIHDA.SDADOFFH..hADA......hAFA...,2,-17,5,22
IJMDbORPgZcLHTNKYCeSBUXaFVfAQdWEG,dAAAEAAAGACAMADADAHBRAEAZCEE..HBDAKCBD.eBHHBAHBUDBAaCHD.hAAAFDED.ADGB.QEABhAEAJEHB.OEFBhAFAPGBAgGCA.TGGACGFA..hBCA......hCAA...,2,-22,-4,18
ITYNMOeZRAbPKUgWXBLHDafJVQSCcGEFd,KAAAUAAA..XACBHADAaAFA..VAEAQCDB.CBHAECGBhADAdAHATCDA.hAIAMCCBeDHHADGAbDFAgFEAhBAALFFBfGHASFHD..hAAA......hCAA...,2,-22,-10,12
fNaVOWYQRFJIdDAeCPHMKUgcZETSBLbGX,eAAAHAAAMACAKADAUAFAZAEEEBHF..BAHAGCCA..fCCAhAAAaCFBODHDQDEAhABAREFBFGAA.dDHAACCBCGDAhAAA..gGEA.TECA.hAGASHGA.hAIA...,2,-19,-5,14
DGadJEcTQCgFeRSWZYfIHBXAPbNULVKMO,...bAAALAAA.MAEAGAEAdBEAEAHFTAGAQCAAhABAFCAARDDBZDFB..fCGEhACAHEAAAAAAPDHDhACAVECADCIBaGACCGHDeFGB.SFHB.hAEAIGBANIAB.KGEAhBGA...,2,-12,15,27
IPWXBgEcQNaZbDUeMJLdCHTAKYfFVSGOR,KAAAFAAAGACARACF....IAFAXAEAEAHBQCEDhAEA.ZCGBbCADeEFDhAFAMCEAdHABHDEAADIBfFHAhAHAODHDBEDD.gGDA.hAIAaGFD.DCAB...hBAA...,1,-10,-13,3
KGUTVEWfHLASaMXJQDIcNdORFZCbBgPYe,aAAAMAAA..QADADAEA..IAHAdAGARCCBZCFEBBBAPDABhADAeBDA.GCEBhBAATEFAEDBAHFBAABDAXEEChBBAcFGD.FEHBCBBD.gGGAKHEA.WHCAhCAA.....hAIA...,1,-3,-15,12
PaAfdbIBKJcZRgVeQMNUTLWCXODGSYHFE,dAAABAAAKADAZACARAFF.eAEE..MAIBUCCALCCB.CCED.DAIBhAAAGCGAHCFAEDAAADAA.hACA..bEFAJEEB..hADA.VFABTGGAOFHDFFEHaHAA..fGFAhAFA..hAHA...,2,-19,-11,8
eUELNJXRSMfbcQgdVaOFYIZHGTBDCPKWA,EAAALAAA.XADDRACAMAFA....bBEAQAFAhABA.dBHAaCCCFCAAZDAAHDDAhACAGEEATEGACDGDKEHBhAAAADFAeFAAUGBASGHDfFFE...hAFA......hAIA...,1,-4,-9,5
dPGKXHLYDbSBFQAMECZgOfeJIRVWNUTac,EAAAZAAAOACA..eACARAFA.VAFAUCCBaCCAdCFD.GEFAhABAHCEBLDAADCIBBEHDAEFBhAGAMCIB.fEGAhAAA.IGDANIAB.....hAIA......hCAA...,1,-3,-28,25
ePQRTIHGgWCUZSEFKYXdOJcDVaBNbMALf,eAAARAAAHADBGADACAFAZAGB.EAFA..KCCDdBHA.OCCBDBIBBDAAMCGBhAAAAAAA.LEHB.hADAQFACTDEA.hAFAgFDASEGAFHFCXGCA.hABAcGGAaHCC...hAFA...,1,2,-28,30
TMQRZIXNELYKdFcCPWGUJefObgVABHSDa,HAAAaAAA.MACARACFZAEB..XAEAEAGALCGBdAHACCCAGCEAhAAA.eDGHbEAAABBBDDIBTFEAhAEAQECC.hBAAIGHAKGHB.FGDD......hBHA......hCAA...,1,-2,-16,14
CgUERBcLaTeVZNQSPbYXIDHAFGOMWdJKf,GAAAMAAAdAEAKADA.CAFB.EAGABAHALBBB.eBDDZCDAQECAhAAASBGAbDEDXCGBhACA..HDGBhAGAACEAODAHfGDERFEFaDHD......hBAA......hBEA...,2,-18,-13,5
HcUNZFgRDTLPQbBdMKACESVIJfOXYGaeW,EAAASAAA..IADAOACDGAEAeAEHHAGBUBGAZCBBhAAAREAALEDBbDDA.hAGAdFFAAAIBCDHAfGAEhAAAaFDAcGBAFHGE.DEIBTGGA.BFHBMICAhABA......hAEA...,1,4,-6,10
AGfVQNBZUDKETLYPbdcCRgaHFSIeXJMWO,GAAAQAAAZADAKAGCEACALAFA..bCDBdCDARCFAHEAChAAASCFAeEGFMEIBhACAAAGAfDHABFEADIBATEBAhAAA...cEFCCHGA.aFHD.XGCAhBEA...hAEA...,2,-9,-3,6
eIWfPXSNLcQdJKbBEDHGTaFOgRVMCZAYU,eAAA..fAAASADALADAdAGAKCCABCEBHAGBaBCChAAAOBHDRCABMCFBZEAAAAAAIDDAhACA.XDGAhAEAQEEAEFABGGDBTEGAFGBB.CGDA.hAEA......hAIA...,2,-23,13,36
TSOdXDVMEPCIgFQLKYAbaHWBRcNUfZeJG,HAAARAAAUADAeACEGAGATAGA..dDDADCCAEEGBCCEA..FCGHLFBBhAAAAAFA.aCCHBDDDhAAA.fEFEhAIAZGDASGAFXFGDMDIB.IHHA.hCAAKFEA.....hCIA...,2,-26,-2,24
SdfDEQGAJXWVbeHPOaIMBFgLZRNYKUTcC,XAAAVAAA.HADAaADA.BAGBLAGBRCDAKBHB.UCDA.CDHA.dDAAhAAADAIBEDCB.ADHBJEFBeEBBhAAA.OEFCMEIBFGCAhABAZFDA.....NIAB.......hADA......hAFA...,1,-12,-21,9
RFMQZVAdESDKBLbgXPfOTWHUYaecGICNJ,EAAAKAAALACB..bACAXAEA.OAHBHAGBaCCAhAAAeCEBGDAA.CDDDRDFBhADAMCIBZFDBAAGBdEAABDHAhAEAfDGEWFHH.cFCA.JFGF..hAAA......hAEA...,1,0,-25,25
bQCNZadPLKYefFBSHRDMWcUVAETGXIJgO,EAAAGAAA.JADAOACC.QAFCZAGBdCDALCFDeAHHBCCAhAAAHDBBRDEAMDIBUEGAAAABhACATEAA.XECDhAEAbGAACHHA.aFGB.KHAA.FHGEDBIB...hAHA......hCAA...,1,0,-9,9
OgCXIFKSTZMJYVUEDdcNALaQWRbPHfeBG,aAAARAAAHADBBADAGAGA.CAFA.FAFAKCCDZBBA.MAIBJDAB..UEEAhAAAEBFB..dDAAAAIBLFDDhABAQDDB..bGFAhADAeCGH.XFFA.SGHHhADA.....hAFA...,2,-15,-13,2
PATgLdebZURMIEaJVFCSYBGNHKQOXcfDW,TAAAdAAAeADA.ZABBRACF..EAEEaAGD.FCEBSAGB.GCDAhAAAHDCBQEAAhAEAXCACDAIBAAIBbEGBMCGBhACAIFFACDHABFCAOFFBfGDA.WFHHhBAA.....hCFA...,2,-13,-2,11
MZNBRWIUfXaHADScQVgTFJPLbCEOKdeYG,SAAAQAAA..TACAFADALAGBEAEE.dCCAeAGHGECBhAAAZCDBRDGBIEHAhABAXFDAHGBAAAIBDCIBgBEAhAIAbGACKGGD.MDBB.BGGA...hAAA......hAGA...,1,0,-3,3
ERPJTHMSbFYadCNOgILDKUZcGWXAQVeBf,eAAAEAAARACA...TADAHAFBMAIB.FCCHdAFA.OAHBLDABhAAAKCCAZDEBGDGAAAAAQGFAhAIAfEDASCHHhCAAaFEDCHAA..NIEB.DFIB....hCBA......hCCA...,2,-22,3,25
acPVGNJXgYWDBQKMTCIbAReEdZLOFUfHS,EAAAZAAALADBFACD.HAFAaAEA...PCABGAGA.XBDDhAAA..gCFAhABADDGBQFBAhAIAMCCBTEGAbEEDABFBeHFAdGGDfEEEhACAcEGD.VFAB.NICB..hBIA...,2,-16,8,24
IDdBLFbeCgENHXGYJVQTcMARafSWZUOKP,RAAAaAAA..SADBZACBKAEA.DAFAdAGALBFAeBHH..ECEBHCCAhAAAGDFAVDFATFCAhAIAABGAUGGA.OEEBhABABBBDCFHA..NIAB.........hAIA......hCAA...,1,-11,-20,9
WVCOSYUAdRQbgFILfKZHDBNJaTPGecXEM,RAAAQAAAFADALAGBZACBHAEABBFA.aAGAGCCA..eCEAhAAAEDHF.MCIBCEFA.SDFAhBCAAAAAdGGA.bECBfFEEhAIADFFATGGA.......hBIA......hCAA...,2,-31,5,36
eKFYRaUdVJWPOMSDCGLHgEANXTZIbBQcf,TAAAZAAABADB.QAFAeACEFAFARCCAdBHA....VCGBPCABhABAMDBB..CCCDHCEBhACAAAIBXEEC.bFCDhAAAKECA.aEGDUGGAOFACDFCB.GGDB.hBDA......hCAA...,1,-5,-6,1
UVeADGYfbWcBMTLZQPIESFOaHdCJgXNRK,GAAA..bAAABADAMAEAZAEB.QAGAEAHFFBEA.HCFBhAAAdCAACCCDXDCCRDEA.hAAAKEHBeDHHADABDFFBfECAhABATGGA.LGFASHDGaFDDNICB.hACA......hADA...,2,-16,-2,14
QWYdTEAPZSNFUHLDcOfRIbGeBXVKMgCaJ,ZAAAFAAAHACBLADBOAEARAFAGCAABAHAKBFDMCFB...aCGDQCGAhBAA.dEBAhBEAAAFASDHHhABADDEB.fFGEeEGBXFEDCGDA...hACA......hAIA...,2,-23,-20,3
DMEfHPNQRCGBbJVdLaKITYSZcWAgFXUeO,XAAAeAAAMAEAHADA..QBCARAGFGCEABCDDVBEAaBHDhAAATDAAZEEA.AAAAFDHDDEGAEGGBhABA..fFAEhADACHBA.dGDA.KGFA.SHGAhAFA......hAGA...,1,-3,-12,9
WgADaZBKIEdCYUXPQNTfGMOHLcFSRVJbe,ZAAAKAAAEACEdAEACAGA..UAEA..QCAA..TAGAhAAAGCFAHCCALCHBhABASCGARDDBbGAA.eEEAhAIAAACAaGHBBEHA.XGGA...hAGA......hAIA...,1,-13,-22,9
ZIBdbfGgEPTVDaeNRJWULKOHQcXASFYCM,FAAAMAAAZACBdAEAGAEA..EAGA.TBBAaAGARBGF..UEBALCGBhAGAHEDA.QDBBhBAAADIBCFGABGEA.bEDD.fDFAhBBA.gFGADFIB.NIBB.hBDA......hBEA...,2,-22,-9,13
DdWITeJUOPbLVcHaBXQYNgECFfMAKZGSR,GAAARAAAdADA...TADAeAFAOBHDLAFBHCDCaAHBQDCAhAAA.gDGAhACAEEEBfEGAhAAAABIBZEEFDDABIFAAPFCBbGAABGGBXGEChABACHDAMFIBSCCDhAFA...,1,15,-18,33
ATMOQVaFeYLDKCfXGSEWJdHcZRNPIgbBU,MAAAQAAAFADDLAFACACAGADA.EAFAdBBA.HCEARBGB.IEGAhAGABDFAAAIBODDHhAAA.eEHFKDDDSCGEhAHAJFABZFFF.gFFG...hAFA......hCAA...,2,-20,-9,11
CdKZSHPfDJcNeMOYLXEBIFVbWTQgARGUa,RAAAaAAAdADAZACBHAFA.DCCBJAEB..eCFAMAGBLDDB.EDHFhAAAFAHB.VDEB..hBAAbFABTGGAAAHAGGEBhABAKBBD..SCHH.fHDBhCAA.....hAFA...,1,-7,-20,13
CRJdDXTabgHZeFWEGKQcOPfVANLIYMUBS,LAAAMAAABADARADFdAFADAFA...aAHBHBBAZCAA.eAHFFCHDGDFAhABAQCEA.OCHDhBAAfFDAABFA.IHHAhACASDDDCFHA.TFFA.gGDBhBBA...hBIA...,2,-19,-16,3
OPZaSWfBbTRCMGALdYIFXKeJDEgHVUNcQ,dAAAFAAAeACHEADAHAFAUAEAQCBA.ZCFAaAGE..fDAEhACAbCEA.RDDFGGEBhADAACIBLEBAIHAAhAHAKEGDDEIB...NHABOFEFSFFCBGHDhAHAMICA....hAIA...,1,6,-18,24
LBTeDQCNPIdHMUgafKAGYZWOSRXVJcbEF,ZAAASAAARAEA..XBGAVADA..JAHBECAALCCBhAAABCDAeDEAQDABhABA.CDGD.IEAAhABAHEDBMDIBaEFEAACA.GFABOFFDFFHDTGAAhADADGGBNIAB......hAGA...,2,-7,-7,0
KJMeRIBCVagcNQGZfPSWFLOAEXDUHbTYd,EAAADAAAHABC..bACAdAEA.MAGBRAGBCCCA.aAHB....gCEAhAAAQDDAZDAASBHHhBAALEGBAAIBTEGAhCAAKFFDeGAABCCDNDIA.GGEB...hADA......hAEA...,2,-11,-8,3
YZBIDUgefPNVdWGCTLFAKaXMEJROSbcHQ,aAAAEAAARACA..OACD..bAFBHAEAZBGBDCCBeAHH...fCEEhAEAPDABdDDAGDFAhAGALFCAABBBMDIBhAHASDHHQGCABGFAIHHANIABCHGA.hAAA......hADA...,1,2,-13,15
bFYBULKHgXMQZTSRDWeVJNGCPcEOfAdaI,aAAAFAAABADALADAHAEB..MAHBZAGBRCCBeBBB..VDABGCFAhAEA.CDDAEEHFAAGBdEFAbFAAhAFAKDHB.....hAIA............hBAA......hBIA...,1,-16,-34,18
JAaWDKCdUYHeZbOBPLMGfEQSTRNcXFVgI,aAAAKAAAdACAHACBZADBBAEALAGBGAFA.EAHBQDED.hAEAREGF.XDEDFFBA.hAAAgEGHAAIBCGBD.hBFAeBBDOFFHMEDB.SGHHcGCD.hBGAJHDEDGIB....hCAA...,1,6,-21,27
CgKBJXOWUDAbENfVHSLdTMeYRcQGFaIZP,EAAAVAAAHACA.dAFAeADERBGFGCDAFAGAZBEACAHB.BCDD..OCCBhAAADCIBADFA...bEADSEEAhAAAMDIB.QFGAhCAAaFDHIFFAKHEA.WFHD...hDAA......hDBA...,1,6,-30,36
ObURKFNefLETWJaCXdHQMDBAPgGSIZVcY,GAAAZAAA..VAEAOADARCAA.FAGDeAHHECDA....TDEAhAAAaCECdEADHDBBDACAADIBSBHHhACA.IEHAhAIAbEEAKGEALHAACFGDQGDAMFIBBGHAhBAA.....hABA...,1,3,-17,20
WSAdXVRBOMKYEfCUTQFHPeJacbLNIDGZg,dAAARAAAMADAEADA..CAFA.QAGAHAGB.eBDFaCAELCEBhACA.DDDBZCEB.SDGAhAAAAAIBBDGDKEHBfFBAhABATGFA.FFGA.cGDA.IHHAhBFA....hBIA...,2,-24,-24,0
MRNfTWOKAGBCFQDbZIagecLPYXVdESJHU,GAAAFAAAQADAZADAaAFA...eAFALCDBXBGAEBHFHEGBhAAARCCB.TGDAKDAAADGADEFAhADA..gEAAhACAPEHDdFFA.SFDHMIAA.fGAAhAGABFFC.CHHD..hAEA...,1,-2,-7,5
aDNRTOBCfeEVcYPUZXAKgLGSWQHJdbMFI,LAAAGAAAQADAHADBdAFBMAIBaAFERCEABBHAeBFH..ECAAVDCBhAAA..PDDBhABAZEGBADABSFFFhACAbCGD.DFIBTGEAfGAAcGGA...hADA......hAGA...,1,8,-6,14
FSJVdAaMXGNcfbTBLIZPUCKgRQDHOEYWe,aAAAGAAA...fADAbACD.LAFAZAEACAHBRCEFHDGBhAFAECDAeCFASECBhAGAdEEAAAABMDABXGCA.hACANBBABGGDIEHA.KGAADCIBOGEE.hBAAWHAA....hADA...,1,-3,-13,10
WdgOFDXcUHQRJfTVLNYPMIZbeKGSCBAaE,EAAAdAAAFADADADA.UAGAHAEC.RBCB...JBDFTCGA..LDFAhACA..PCBBhAAAZFCAeCBFGECBBFFBhBAAAAHAaEHDOHDCQGEA..fGBEhBCA...hBCA...,1,-13,-29,16
ZHXePdgDKVILGWFSaANJOcMTRbUQEBYfC,OAAAMAAARACA.UAEABAFB..CAGA.HAGB.eBBBdBBDKBHBLDDAhAIAGDDASDHHhBAAADDB.JFCAbDGDEFFEZEBFhAIAPHEADDGB..IHHA...hBIA......hCAA...,2,-25,-10,15
POJAVTXEeSDNWHcMLbQKdfZIgYBFaCRGU,TAAAEAAADADA..HAECMACALAHB.QBCCdAGAZBDBgCFGhAAAFCEDRDFF.GDBAhAIAOEHDABDBeDHHhBGASHCAcFEAfHFBBHHA...hBIA......hCAA...,2,-11,-9,2
NSAVgKFQOHGTdYMBRDXePLIUaWJcfECbZ,KAAAQAAAHACBdAEBMADARAGF..eBEHLAHBUDGB.aBDAJCABEBGFhAAA.ZCBEAEFB.FDEDOFGDhAAAGEGA.TGBAhBCADGIB.XGEC.......hACA......hAIA...,2,-25,10,35
JTZBWCdNaIegUAbFQcfVEOGRDLXHPKSMY,QAAAVAAA.EACARADFLAFBHAEASAGEMAHB.TCDAhAAAZDAACDHAdEEA.aFCHeCFHhCAA.ACHAbDGDFFHB.ODCBhCDAXGEAKGFDBHHANIAB.....hAAA......hADA...,1,13,-15,28
NYPESKaIcQDXTMLgFWCJdZVUBeHGbRAfO,OAAA..PAAAEADAKAFA..aADDQCCADAFA.MAIBhAHALBFAFCEECBBDZEFAhBAABCCDHGEARDEAABGAfDBEhAIASCGH.XEGA.TFDAhBAA.gGGBhBDA.dHDD.,1,-11,-30,19
OfMLeEQcUFgGdWYDaSHZbABCVPXJTIRKN,CAAAXAAA..TACARADAKAGC..OBHDMAEAEAHF.QBEAhAAAFCDHdCFADDAAHCAAhACAAAAABEAAPCHD.IEDAhCAALFDAeEGB.gGCAhCCAYEHFaHCAbFED....hADA...,1,9,-32,41
OaLYBXeGAdESHWPZbJcFUNTMCKVDIRfQg,EAAAHAAAZACBJADA.FAGAUAFA..MCABKAHBDBEBRCCA...QDEAhAAAaCFALEEABCBChBCAeEHHADHA.dGDASEGBhBFA.....WEHH..hCAA......hDAA...,2,-39,-18,21
gLbSCHMDIaXRKWZGfcQUedTJNOFPAVBEY,EAAALAAA.CAEAHAFBMADAaAFERCAA.ZBCAGDCB.QEGAhABAeAHHdDBATDDAhAAAOAHFACAABDGD.bFFADEABhACAKGCAfFDE.cFFCNIDB.FHAAhAEA......hAHA...,2,-8,-3,5
ZWOCPSQFfNKAdLEaeVMRTXIbDHBGYJUgc,EAAAeAAARACA...TADA..bAFBHAFBGCDAUDCAZBGBCAHAQDGAhAAAFDAAKEHBACFBaFFBMFABhABA.DFFBBGGAgGFHhAFA.........hAAA......hADA...,2,-21,-6,15
SaGPDOFKdRVBXQcNgWITfYHEJUCAeMbZL,eAAAZAAAaACAGADA.OAFAdAFARBGFBAHBQBFC..NCCA.hABAgDBA.hBFATDGAHDDAEEHFCEFDAAAAMFIBhBDAbFDA.SGGBDGIB....hBIA......hCAA...,1,-10,-20,10
agNUBLGeFKZOMcRCPXQfDAJdYEWTSIVHb,dAAAEAAA.SADAHACAaAEA.UAGAGAGAKCBA.ZCCA.MDGBRCEBCDAD.QECAhAAA.AAIBJEHBhCAATECA.bEGDNIDB.hCBALGBA.OHDE....hACA......hADA...,2,-24,5,29
NRCFgdALOZYIDJaQEWSBHVbGMefTUXKPc,ZAAADAAAQACAEADEBAFBHAGBGAEB.eBBBTCAAKCFD...hAFAPCEBRCGFFDDBAAHALEGBhABAOEHD.JFCBaFFBSFFFhACAMICA.XGDDCGGD...hBAA......hCAA...,1,-3,-12,9
RGYJONVHTcWKUfgdMFEIbQPLBDXAZSaCe,aAAARAAAGADA.OAFAHACBTAEA.KAGCfBFBhAAAdCGAEDEAQEAALDAAXCGAhABAABBBZEDAeDHHYDFFhADANIBB.cEGA.....hAEA......hBAA...,1,-4,-8,4
BQYKJIcbFXdMPCfOeLWUTHRGSNEZDgVAa,aAAAQAAA.KACAIADAFAEA.dAFAMAHBCAHA..eBBBhAHALCDAUDDAHCGBhBAARECAGEGAEFBBZGDADAIBACEABFGDhBFA..cGEA......hAAA......hCAA...,1,-12,-23,11
QBARLCMUagKeTFXGfOYSPdHcWNDVbIJEZ,RAAAMAAAUADAKADA..eAFAFAFAGBBA..OBHDSAHHhBAAHCFB..NCCADDDAbDEAEEDBhBBAZFFABGAA.AAAALHCAhAGAaEHDTGCA.fFFA.hCAA......hCHA...,2,-16,-10,6
NJCQKaPTcSYdXOGgHWFIUeAMfVbRBLEZD,MAAAVAAA.RACA.LADBZAFB.DAFACAHAKBBD..aAGE..TDDAhAFASBFD.dCGAhAAAGCGAHEEAFDCHeECBhBAAACIBBFHAEFFB.NIEB........hCAA......hCEA...,2,-25,-14,11
eEXLNMQIdSbOKCaDVAWcPRFTUgZYBfGHJ,...PAAARAAATAEAZADBBAFAHAGBECCALAHBMDAB..dDEAOCCHhBAAaDGC.ABDBFDFBgFGAhAAAGEGAeEEDhBHAQGAASFCHCHFD.DIEA....hCAA......hCBA...,1,3,-15,18
agGZTMOSEFDeAIPLWVXKRNJHdQfCcBUbY,LAAAXAAARADAHADB.dAFBQAGCCBGDBCAAUDDBaCDCZDAA.hABAMCIBECHFDCCB.AAIB.hACAIDGA.PEEBhAAAKEGDfFHA.bGDCgGFAhABA.OFCBhADA...,2,-16,-13,3
WPUBKeOcLQAJSIXdECVHNDfgbYaMGZTFR,SAAAdAAAEADAHAFADADA....bABDaAEEZCEARAGF..UCCAeDABhADALDBDAAHA.XDFChAAACCHBfEEAhBAAMCIBGGDBTFGAFFCBBFCBKGEA....hCDA......hCFA...,2,-14,-1,13
LMcODSFaZfRPXTBedVHUGQgbIWCKNYAJE,EAAAMAAADADAFADD.ZAEBRAEA.....TAGAeAHHHBCB.GCFAhAAAbBBD.CCBCKECDABBBLDGBhAIASDHHaEEAXGCAhBAAdGHAQFDAIHHAYHAAhAHAOFFH.....hBCA...,1,-6,-10,4
OKIgWCBATbDaGFdUceNVEfYLSJHPZQRMX,TAAAaAAAGACA.dAEBeACE.EAFELAHBHCCAZCFBRBEFMBBBhBAAKCHBIFCACDGD.AAHAFEHHhAAAUFFA..cFEChBDAfHBB.SEED..hBHA......hCAA...,1,-4,-20,16
UEgeBCfHXISAaOcMbFdQDPNGYVTJRZKWL,aAAAMAAA.dAEAQADADAGA.GAGATBBARCCBZDAF.LEFAhADAEBGAeCHFCAFAHFDAhAIASDBAABBB.bDFDFGHBhBAA.NIBB.JEDB.KGBB.....WEHHhBAA......hBBA...,1,10,-27,37
HZgNFRdePcDUEKWXSYAGfVLObIaJMBCTQ,GAAALAAAOADAaADDBAFAQAGA.HCDAZAGBFCAARDBFeDFAhAAADBIBECEAXEGAhACAADDB.bFCDMEEA.TFAAhABAdGGA...PEHD.KFFBSFFDhBAA...hACA...,1,21,-28,49
ATQBbdKCRNYcaMIVeLPGZEgUXWOJfHFDS,TAAAQAAA.dADARACF....NAEB.aAFA.MAIBeBEAGBEAhAAAEBHFUDEAOCGDHEGBhAAASDBAACABKFBACGEA.hACAIGBA.LGFA.gGCHhBCA...hBFA...,2,-17,-4,13
QGUHYcVIJAWDFXBTRSeLZdEgaMfbKNPOC,FAAATAAARACFLAEB.ZAGBEACE.aAEAMBIBKAHB...OECAhAGAGBDBHEGBVDDBABGBDFFBhBAASDGA.hCAAeFGB.dGDD.fHAB.NCCACHFAhAAA......hAHA...,2,-23,-8,15
XbRYSIWafNCKATgUGDQFdZJVeOcELBMHP,TAAAGAAAQADA.ZAFBeACEEAHFMCDBHAFBbCCBRDGB.hAAASAHBaDAH.hACACDBAADHADCIBdEEAOEDDhADALEHBXFBDIFAAfFFAKGFBFHBA.hAAA......hAFA...,2,-5,8,13
bRXGHNFQCBcEeVZaTISKgOWdDMAJYPULf,JAAAUAAALADBRADAHAGBFCDHBAFA..ECFBeAGH.ZDCA..aDAAhADASBHHODHDdEAAhAEAACCA....fEGAhAFAGGABQFEACFCATGEA.KHGADEIB.hAGAMIAA....hAIA...,2,-34,6,40
BNgOFCJPXTRMHYcaVZedGWDfKSQIELUAb,BAAAOAAACACA...XADARADFHAFB..aAHFeAGB.GCCAhAEADCAAKDDDQEFAhAHALDHBAEFAbFDD.FBBHTFAAhAAAMAIB...VFDAdFHAfCFAhBAAEHBA......hCAA...,2,-18,-3,15
VWDEGaOFCLAQPIJXZbHKfMdUgBcYSRTNe,QAAAJAAAZADB.HACAMAGBdAFA.BAHA.SCDHhAAARCGFeCCDDAIBECGAGDAAFDFHADIBXEAAhAEAKEEAUGGA.gFGAhAHA.YHEA...hADA......hAHA...,1,3,-28,31
FSfeMXVWDPKLEJAQCcbYdHgONTaRIZUBG,QAAACAAA..bACAHACA.OAEAaAGARBFF.ZBEEGCAAhAAAfCHAeCCBMCIBhACAXDDADDHBLEEBhADAAAIBdEGDTGDABGGASGGAPHBC...hAEA......hBHA...,1,-3,-9,6
fXGHLPbUENTeKORFDdMBAVYcZCaQJISgW,VAAAZAAAaACA..QADC..SAEH.fAGAhABAHAFBbDDBEAHBhAAAeAHHRDFAdFAAACCBCDDAgDFBhAGAXFFA.LFEBNIAB.TGGAhCAA......hCBA...,1,1,-26,27
NOaGVCLAFHQfWPbRTYSMJZUEIgBXcDeKd,HAAAQAAA..fADB.bAFBRACATAGA.hAAAMCEBZBGBECABBCFADCCAhACAeCHFdDDAaDHDGDAAhAAALFCAADABFFCDPFECSGFAIHHAhADA......hAFA...,1,2,-14,16
QafJCOXYbPcEIDBTLGgZSUKdRNWVHAMeF,eAAAaAAA.CADA.OACD..XAED..bAEAEAGABCEAhAEAGCCAZDEEKECBRCFAVEGBhAAAHFABABIBFFEBQFFAhAFAJGAA.cGCDDIEA.......hABA......hAGA...,2,-11,-10,1
TbEDcYKageCZIJLHBFMVdXWPfRGNUAOSQ,QAAAEAAADADA.KACAeAEAZAEBLAHBHBCAMAIBdCDC.XCFDhAAAfBGA.RDEBGEGAhAAAABGATEAAcCBChBCAaEGECFFDBGHAFGEH.PHCA....hAEA......hCAA...,2,-13,3,16
CGEXaBPSbHRYFZfAJceUWOMNDVLKIQTdg,eAAAOAAAMAEADAEALAHBKAHB..TBCAdBBDGBDA.hAAAEBFAaBEABDFASCEHhABAHEGBRFBAFGFHACHBcDGChCAA.UGFA.NEDA.......hCBA......hDAA...,2,-21,-13,8
WASDQgcHbFePLTEVCaNIXOfBUdKJZYGMR,QAAAHAAAeACETAGAEACA..aAEDXCCABAGAdCGAZCEBGDCAhAAARDGBAAFADCIB..bEEDhAGALGDACEBC.IHHAhAAAfGGB.......hAIA......hCAA...,2,-13,-8,5
JZfeYbGcdVgRPFHNWQIDSEKAOTMLUCBXa,MAAALAAABADAaADDZAEB..eAFAGAGAdCAARCDAHBBA.QEEAhAIASBGAADDBTGBAhBAAXDFA.fFAAhABAbGFA.gFFBNIDB.DCCBEEHFhBBA......hBGA...,1,-5,-12,7
OBHLAQUgGZKeMRfXWdFbcPSDIENYTCaJV,QAAAGAAAeADARACA...XAGAdAFAFAHB...bCDASCDHhAAAECHB.TDAAhADAaDAHODCBHDFAACIBZEEAhAAAMFDBfGGE.PHAADFFBIGGAhCAACHEA....hDAA...,2,-19,12,31
MTSBaWGEAYUXPObfRLVgNKDcQHdFeJCZI,XAAAOAAARADALAGB..gADADAIBHCCAeDHFhAEAZAFBMAIBBBBDGCGAhAAAACFAUEEAbDAA..fGHAhBAAKEEAdGGDCFCDSHBA...hCAA......hDAA...,1,-3,-21,18
ETBDCgfAMcVSWaJdFIPYNRUZXQObGHKeL,MAAASAAA..aACEdADAFAFA..IAFA..PBBBhAIARAGFZCCAQDGBhAAAGCEAHCGDeDBBEDCATFBAhBAACEEDAFGB.cGCDJFHBYFCBXGFAhBFA......hBIA...,2,-15,-10,5
SdGXFNUTgHcOWCIMbBZAeJVfRQKEPDLYa,eAAAVAAA.RADA..EAGELADB.aAFAGCCA.FCFATBFAhAAAHEABOCHDCCHA.hAIAbEFDADCBQDEDhBFADEFBSFDHdEHAXGGCNIAB....hBIA......hCAA...,1,2,-22,24
CBJcWfSIdgZMEONPKTALFVDYRQbaHeGXU,LAAADAAARABA.aADDHAEBGAFACAGABBHA..JCAA...fAHEhABAdDCAZDGBEEAAODEBhACAKEEAADGB.FDHBQGAAhAEAeFAAXFFC....WEHHhAGASGHH.MIAAhAFA..,1,-1,-34,33
UWdNYZLgPMGVBReOJFDCSaXEIHfcKTbQA,dAAAZAAALADBMADAGAGARAFA..eCABFBDACCBAaCCH...ECFBHDCAhACAKCHB.TEFA.hABAAAIBUGBANEEA.PFHDhBAAOFAB.SFFAfGDFbGFA..hACA......hAFA...,1,-6,-12,6
WDHYgabFJLIGAZXVSPcRTOfBNKEUeMQdC,ZAAASAAARAEA.OACDBAHBECAA.eCDFdAEADAGAHCFAaBFDFEAAhABALBHBAACA.XDEChAAAPEEBTGFAhAEAKEBAMFFA.QGGACFAD.YHCAhABA.....hAFA...,2,-18,-7,11
UeTbGcZDSARQJfKgOMFPNdYaHBWCVILEX,RAAAQAAAKADC.MADAFAFDdAHAHAFCBCCACBDALCFA.EDBAhAAAeCEBGEDAZDFBAAAAfFFBhAIA.OFHDhBCAPDHDaGCH.IHFA...hBHA......hCAA...,2,-46,15,61
CcSNPYXMRbKDLgAVTJOEIfaFQWBeUHZGd,TAAAEAAA..aACDQACCBAEAHAFBdAEASAHB.hAAA.PAGBMCBBRCDBbDDBhAHALDHBAAIBOCHDFEGBhAAAeFEHUFDBCGGA.YEAFDGIB....hAEA......hBCA...,2,-7,-7,0
KYCJPHbBRAVZUSQTdfgDcFeMOEIWGLXNa,ZAAAQAAAdAEADAGA.eACA..EBGAGAFALCABaAHFCCDAHDDAhABARDAAADAA.SCGAhACA.TEGAfDHAhAAAFFDHMCCBODFHXGBDKFBAPFHDBFFD.hADA......hBEA...,2,-9,-3,6
dGNRMXLOSaIcJVfFQKgAeHWCDbYPBZTUE,HAAADAAA...bADBBACAZAFB.EAEAGCCARAGBLCCAaAHD..IDHAhAAAVDFB.QCABhACAAAIBeEAA.CEFATFGAhBFAdGCAMBBBSFCDfFHAKFED.WHBGhBHAYEEF.NIEB.hAEA...,1,20,-30,50
agQFZDAbIOBYPUEMTSNVJWXLeGKHdRcCf,OAAABAAAUACA..EADAMAFA..TAFASBEB.hAHA.VCCAXBGAhAAAeAHHHDFARDDBCCBD.aFCAQDFAhBCAZFFAABBBIHFAPFHD.JGBA..hBGA.WHBG...hBAA...,1,-14,-17,3
eCXfIMFUSGJVOYQcTKLHDNEaWgRdbPABZ,eAAAXAAAMAEAFADAGBCA..OAFDQBEAKAHBHBCBhAAAEAHFaCHDRCGFdECD.AEIBZFDEhABAfEBA.SEEAhAAAYHAA.TFGADGHB.gGCAhABA....hBEA...,2,-10,-10,0
fYPbFeWAgZDcJXaLMUCGBHENSdVOQRITK,ZAAADAAA.JADAaABE.LAEAUAGA..GCAAHCCAEBHF.dCFAQCCBhABARECAKDHB..hACAfFAAbCFC.hBIAeFGBAEEBXEGAMIAABHFASFFDhCAA.IHHA.hAFA...,2,-14,-12,2
REeUOGXHDYaZgTMbPKLCAINdVSWQJBcFf,dAAASAAAQADABADAFAFERAEF..EAGEeAHH.GCABHCCBaCFDhAAAZDEBMDIBKCHBACCB.IGCAhACAVEGB.JHEAfDAAhABA.OFFH.DHCA..hADA......hAIA...,1,-10,-13,3
gQMULKPHJfVWESdBZFYDTeNIacCAOXbGR,XAAARAAAMADA.LADAHAFC..fBDAEAHBdCDAZCEBDCCBeCGFhAAA..aCFBAAEAGEGAhABAQDGA.KEDAhAAA.PFGB........hABA......hAIA...,1,-16,-20,4
HSZeCEBYAUaMPIXTKDgLFOWbfVcNdJQGR,aAAAMAAA...XACATADA..DAFALAFAOAHD.bCCAVCCBhADA..dCGAGBFAhBAAHFFAeGAAEEHBABBBIFEAhBHAFGDDWBBD.fFCE.cGGAhCAA.....hAGA...,1,-8,-16,8
fPXOgCTQFLWZYBDAUeaMbGVNcSHREKIJd,eAAAaAAAGACA..VADASAEAHAGBECCBKAHBdDFA.XEDDhAAACCEATCGALEHBhABAZEAADBBBAEEAbGAC.NIBB.REFBfGCEhAEA.OEHF.FHACBGGChAGA.....hAFA...,1,11,-9,20
CReVQYLdcAKNZOWDXTGPbfJgMaFSEUBIH,ZAAADAAAGABB..bADBJAFA..aAFDECCBBAHAHCEA.REAA.eCABhABAQEEBdCHAACCBODDBhACATGCA.fFHAhAEAMEFBSEGDCHEA.LHAAhAHA.KFBB.WHFA.hAIA...,1,-6,-15,9
cBDdaJXPTVIQNHeZWCMOYEGfRKFUgSAbL,LAAADAAAdADA.aADDJAFA....TAFAQBBAHCAAeAHHhABAZBFA.MCFBEDEARDGBFDGHhACAUGGBADEBBFAA.XFGAhAFA.IHAACEDD....hAHA......hCAA...,1,-11,-34,23
ZBDQOVEbHWdcePUfYATgCRLIaGFMNKXSJ,TAAARAAALADB.GAFAMACAKAFA..SAHBZBDAQDDAhAAAEDCBHDGBdAHAeDFAhBEAfEEAACCBCEHAaFGCXFAAhAAABHHA.OHBE.....hCAA......hDAA...,2,-17,-1,16
MBXbfUCZDNQVJWLKGRETecSdgIPOHFYAa,aAAAMAAABADA..XACAUAFAZBBAQAFA.VCCBhAFALBHBGDGAEDAAeEFDhAIAdDDD..IFBAhADAHFDBABBBCBHBDDGBWFCDRFFASHDA..hAIA......hBAA...,2,-26,4,30
eQBRDFLAdIaGVcYKHTPCEUNgXbWfMSOJZ,aAAAGAAA..VADAKADAHAFB.TCDAEAGEUCGA..XDFAhAAA.bFAAMBBBhADAOAHFeCCBRFFBFHAAhACAAEEAdFFA.IGDA.YHFGCDCDWFHHSDADhADA.hAIA...,2,-29,11,40
dTJOSLKYBRHfMQAaGICXWVgEPbFcDeNUZ,GAAAXAAA..VADAEADA.FAGADAGAUCGAdBFA..OBHBLDCAhAAABCDAHFFAMDABADABaGDBhACACDCD....gEEAhAAA.bFCDeHFA..TGGAhABA.KEHB...hADA...,2,-12,-12,0
PMgRLfHCAQdZWSaGYUKcTVFDBNbeJEOXI,ZAAAaAAAGACAKADC..TAFADAEABAGA.eAHHEBHF..XCAAhABAMBBBRCEBHEBA.hACAADIBdFGASCFDhAHAUGDA.FDDB.bEFA.OGDA.IHGAhAIA.....hBAA...,1,-10,-14,4
FYGLBEVbPeWZKMQOXJUfADINaTScdCRgH,DAAAaAAA...TACAdADARAFAHCDCGAEAEBBB..VCGBeCGHZDDFMCIBhAFAQEAA.hAGAXAGAfDBEhAIAAAGASBBDCEEDFFGD.LFFB.BFHAhAEA.....hBAA...,1,3,-13,16
ObGBRQEFDXcHCSWVJUdYPALNZMfTIgKae,ZAAAMAAA..TAEAKADAeAFEGAGABBBAECAADBGBHCDA.SDAAhABAVCDB.dEFAACHALDHBhAIAfEHAaDCHhBAARGAAFGHDCEGA..UGEA......hBBA......hCAA...,1,11,-27,38
fSOZLYXJBdEaPGNbMQDUWVCeATRKcIHgF,RAAAKAAAHADBFACA.OAFAZAEBLAHB..XBFDdCCA.ECCBhAAAGCFAMBIBQDAChABADEEBVGBA.AEEATEFAhADA.IGHASFFDBFBAaHFEPHCAhBFANEIA....hCAA...,1,-4,-22,18
NHGdQacgFMYISPCZVEeDKUTWfAXJOBLRb,OAAARAAAHADBdAFB.QBGBaADDFAFA.MCCBSAHH.hAAAZCCAEDABeBFBKDDDTEFAhABAABBBBDBDLDHBhBAAGGDB.gEEG.IHEAhBDACFDADDIB......hCAA...,2,-23,4,27
eOJMDYUQFLACRcPVdbBXaZSfKENWgTHIG,RAAAVAAAdADABAFA.ZAGBKADC.EAFA......gCCGhAAAHBFCeCDBMBIBDDFBQDGBhAAAACFA.hABACECAbGFAaDFCfFAA.TFFAhAFA.OFHD..hCAA...,2,-28,-16,12
LWPdHYSBfQaIKegCFDXbOEGTRVNUcAJMZ,ZAAALAAAdAEAHAGBBAEAaCAAeAFH.FAHBXDAC.EDDARCAAUDEBhABA.ACAAMCIBhACAPDFD..SEAAhAEAQGAAKFFDDDIBGECANEHA.JHFE..hCDA......hCEA...,1,-8,-9,1
eRUCVgQNIJGOWbTBYPDLdKZXfcaFSEHMA,RAAACAAA.QADC..IACAGAFAOAHFTAEABAGBhAAADCCBdDDAZCCA..fDHEhAAAaAHDECGBHEAAAFAAeFDAhABAgEEAJFHFYHAALFHB.KGGDhAEAXFAA.SGGDhAFA,1,5,-22,27
CNYLTWXAdMfaKJRQGBZgFIPHDVUeEbcOS,dAAAaAAA.RADAGAGAZACBFAED.HCAC.DCFBeAGB.ECFFODEH.hAHACEAALFGBTEDAAAIBMBBBhBAAKGAAQGDBhACABDHAIFGA........hCAA......hCCA...,1,-8,-29,21
DfZGKEcMagYOAUNTBFPSRJLeIWHCXdbVQ,TAAAFAAARACFLAEB..eACEHAGBdAFAQDFDZAGBEBDBaCCHhAAAOECBABIBBDFDSEEDhAGAJDHB.CFHAXGFDhAIAbFFDDEEB.........hCAA......hDAA...,2,-18,-9,9
VFRABGaMcYNTWEUbOZQCXPSdKJDfLHIeg,aAAAMAAA.....NAEA.EADA.OAFCZAFAQBBAXBBCdCEAhADADAGAHCFAeCGBFEDHhAHAAEFBGEGATFFAbFCBSCHBhAIAKGFD........hBAA......hCAA...,2,-17,-10,7
XdOLDbcfQgVJCZUYIWGeHaETBAFNSPMKR,SAAAMAAARACA.dADALAFBDAFA...bBGDQBFAhAAA.gCCGhABACAHBZCDBIFFAeCHHHEFBhAIAEBBBACIBFFHBKDBDOFBC.fHCBhBDA.....hBAA...,1,-1,-27,26
NZYKJaQUIPFOLEgRfVXMAbcCBWGTSDHde,CAAAGAAADACA.HADAdAFAZAGBKAGCaBGE.QCDBUBCA.FDFDEDEFhAAAREGF....XFAAhAAAABIBBDHA.SDADhACAeECB.JHDAOEGB...fFBEhBFA.MFFBhCAA...,2,-46,6,52
XTaAZPOCIUWcRQBKJGLVFeNMbfYDSgHdE,ZAAACAAAUACARAEAKBHB..GAEBLCAB.FCCHeCBB.MCHB.hABA.bCFDDCIB.HDDAhAAAEDHB.aFABAADA..OEDDhACAIFFAQGGABFCANIAB.SFAAhAFAdGHA.PHAA.hAFA...,1,-5,-18,13
LUXDGYJZIRTCWFPQAKdgSNaOBbEVeHcfM,dAAASAAAaADA.BADAEAGAHBDA.MBIBLAFA.DCCAhAAAGCBAZCDERCGFTDAAhABAFDFAAEEAKFFAOEEBeFHHfGAAhACAXFGAIFCACHCA.QGAChADA.gGFGhAGA,2,-16,-7,9
BTdWMQHJSegUNIRZPKCOFEDLacVGYAfXb,XAAATAAA.dADAMACAHAFA..eAEAUCFBRBFAZCCACDBA.EDBBaDDBhAAAGDGAAAHA.bECDQEEBhABA.SDHHhAFAgGEBIGGA...hAAA......hAIA...,2,-14,-6,8
VCWYZLJGMTBEFNPgKXSAbOaeRUdcIQDfH,aAAARAAAdADA..QADAHAFACCCDZCEEGAGABDHA.EBBB.FDAB..hADA.gDCAhAGASEFBAAIBeDGDIFAAhAAAfFBEVFCALFHBMDIBTFDAKHAA.hABAXGGC..hBAA...,1,-1,-12,11
KLTeORFVXCQZaYGWMUdcAPfDHJgENbBSI,DAAAHAAAEACABADB.KAFAeAEARCAA.FAHDCAHBZCEAGCCA..MCFAhAAAdCFAABBB...fDHAhAFANDIA.bFDDLEEBhACA.TFAAXFFCaEGH...hAFA......hCAA...,1,-18,-23,5
PcRNWSVKQHdbALUGDCEfJIeBZaOYFXMgT,GAAAEAAA.JADAeACAZAGB.aAFD..FCDAMAHB..TEEAhAAARCCASCHHQEGChACAHDABABIBLGAAhAGACDFABEEDXFGAgDBHcFBDNIDBKGHBdHFB.DIAAhAAA......hADA...,1,2,-10,12
YagQXGHZMVATLfWCFeEOKRScdUIDbPBJN,TAAALAAA.CAEAFAGAEACE..RAEF.dCAADAGABBFA..JBGBaCCAQCCChAAA.HEAAhAEAZCFEADDBeCHHSEAAhABAIEEA.bGFAPEEBNIBB...XGFAhACA.MEIBhAEA.fHCB.,1,5,-25,30
UYNBfSOcPMaVAJTGXgKWDbZIQHdeCFRLE,GAAAKAAADACAZADEHADA.eAFERAGF.ECDBUCCBBCFA.OCGD.hAAAMCIBACFBJDFB..TFCAhAAA.XFEBhACA.gGGAbEGDdFAA.....hAFA......hAIA...,1,11,-43,54
XIKMUgEfWCdLeNVPSBcDFHbaGRYZQAOJT,TAAAKAAAMACA..EACECAFA.LAEB.eAGBPAHBBAHBFBCDhAAAHCCBGCEAREFAZGCAABEB.hAIA.ODHDIGHAhAAAUGCA...fGFA...hCAA......hCCA...,1,-9,-25,16
TVRQWIOAbfFaBGZDXcCgNLeMKUSJHdYEP,FAAAGAAAZACBDAFACADALAFA..eAHFMCDAKBEAUDDAHDEAECGAhAAA..TEBAREGBQGAAhACAODHDAFGBaDAHBGBDhBAA..XGEAgGDA.SGHDhBEA...hADA...,2,-18,-11,7
BQWUOPDgeLFSXHbJaEVfAZIYRGNKTMcdC,ZAAARAAAGADAKADC.MAFAdAGAQBEA.UCAADBFAeBHFhAAALDDBXDAAHDFCaFFBhABAEDFBACGB..IGGAhACATFGA..........hAIA......hBIA...,1,-17,-22,5
gQAPeYBUOLVaJdXMCWfTSHDFRGZcNEIKb,eAAABAAALACA.aAFDdAEA.MAGBCAHA.TCCAHCCARCGBZBGBhAAAEDABKDBD.QEEChABAACIBUECBOFEDXGGAhAHASGGADCIB.FHAANIAB.....hAIA......hBDA...,2,-14,-11,3
VRLebMNACZdGQFagHIUXYEKODTfcBWSJP,dAAAGAAAaADA.HADAUAGAEAGE.DCDB..TBDABCEASCFHhAAA.VEGBRCAAeDEAhACAbFAA.ADIBZFDA.QGBChBAAFCHF.XEFAOEEB.WFHHhBCA......hBDA...,2,-18,0,18
IJATMRQXLdgBVfNUcEKaOHWZSDCPeYbFG,RAAALAAAdADABAFAVAEA..UCFAKBHBHCAAZDDB.DCCAeAHBFDEAGDGAhABAAAAA.MEABhACAQFAA.XFFAhAFAfEEEECCB.aGGHOHDACHAA..hAIA......hCAA...,2,-24,-5,19
OWgHKMCAITbPUFaLQeYZNXcSRDVJfEdGB,TAAAUAAALADA.eAGHZACBXAEARCBA.DAHBfCHAhAEAECABGCEAOCFHhAFAHDGBMAIBAAIB.bECDhAAAaECDQFAB.cGGCSEEDhBAA.dFHA.BGFAhBCA...,1,14,-19,33
PJRYVfKXUZCHASGIWbBQFcdNegOETDMaL,GAAA..bAAAQADAdAEA.eAFAEAGAMBIBaBGELDCAhAAARCAA.VDGBXCEAhAAAZGAAADABSFFDhACABEBAFEEBgFGADGIB.PGAA.hADAfHCFCGDB.hAGAWHFA.,1,10,-30,40
POEAbIeaMWJfcUCVdKQHLRSgZFNGDXYBT,eAAAaAAA.MAEA..fADACAHA.dAFAHBCARBGFZCCAGBFAhAAADBBBBAHBTEBAEDABADIBhADAbEDB.JDHBUECAQGGBhABALFFAFHCCYHFA...hBEA......hBFA...,1,0,-9,9
IFCDdOZLWHJaBSPXUgfNVKbYQEceMRATG,GAAACAAAdACAZADBHADA.aAFABAFA..XBGAUCFA.fCDEhAAAKAHB.bCEDECBBhAAA.eDHHADABFDGCLFDAhAHASFGA.PHFANHDB....hACA......hADA...,1,-7,-34,27
AEZgLSNCcFBJbXIWQTaDPGeHVOUYRMdfK,EAAAZAAALADB.CAFABAHAbACA..XAGAQCAAaCCAGCFAhAAAHCFAOEEBhABARDAAdDHAAADASFAAhACAFEEHIGAATFGAeFDDYFCBKGHB.cGFChAFA.....hAGA...,1,-2,-4,2
YLdMfaNOJHBVXGRcECbATIUKSWZeFgDQP,TAAAKAAAZACBFAED..QACCLAGBdCAAaAEA..OAGDhAAAHDEABEDDGBEAEEHFAAIBSCHHhCAA.hAAAeDDBDAIBMFGBfECEVGBA.RFGBCGEAIHHAhACA....hBGA...,1,8,-21,29
BMbYQOLIaPXfVCZgHDSWcFdENJeTUAGRK,RAAAMAAAQADCLAEA..aAFAXBBACBFA.HCDBSAHHhAAAFBHDECFBeEGFACCBGDDAhABAbFAA.ODGB.hAFAfFHA.......hAGA......hAIA...,2,-16,-11,5
KQHDBWYGcUaSENPAXJVeMdfFgLRbCOITZ,XAAAeAAAdAEAFAGARADA...OBCDZAGBHCEBBBGDGDAA.hAAAaCHDECHFAAAA.MDFBLDCBhADACEBAKEDB.QFGAhAEADDGB.cGCDSEHH.PHFAhABAfGFE..hAGA...,1,-3,-26,23
GJSHOPUYdIDNaZbBVLMXRAfcWEFKeQCgT,...fAAAEAAAeACAQAFACADA.GCCAHAEBOAGFhAAAPCFBdBHADAIBZCABhACAbDABLEHBRDCAACDBFDGHTGAAhADASFGFIGGANIAB.....hAAA......hADA...,1,1,-8,9
VdeYSOMHcLUfGTCWbPXRNDFZgJBQIEAKa,aAAAeAAA.OADCHACBLAEAGAGACCCA.bBFARCEB...FDEAZECBBDHDhAFAEEHFAAAAdFFA.MBBBhAGAUGAA..fHGFhAIATGFAXGDDDEEB......hAFA......hAGA...,1,-4,-10,6
cDULWCQSMVRAJXeNfBOZHdgKaTPbYFIGE,eAAABAAAHACAdAEAKAGAaAEA....TCCAbAGD..FCAAECFADAIBhAAALDHB.QEBChAAAMCEBACFAXDFChACAOEEAZGAA.gGGGIFGA..hABA......hAGA...,1,-13,-26,13
EDXOQGYIPeZRgaLFdHfBSJVcWAbCTMKUN,TAAAMAAAKADA..EACEOAFAGAEA...IAGAeBBBRBEAaBHDhBAAdCCAHCGBBDDASDFHhBCAcEAAAAIBbEDDCEHADFEBhCAAQFGB..PHEC..hCDA......hDAA...,1,10,-27,37
EAIdRYfWgaQLGNKUeCHcVFZPbMSXJBTOD,RAAA..fAAAaADAGAFAKADA..eAHBHAFBFBDDZCAB.bCDDMCCBhAAA..XDGAhAAATEEAEDHBAAHAdFGAgGGAhABALDCDCBHBPFDBBHDADGIB...hAIA......hCAA...,2,-10,0,10
ARIdgbFKSDcGLNEOWYTJQMCXVeUBZHfaP,RAAAdAAAFADADADAGAFALAGB..EAHBOBDA..TCCAhAAAMAIBCCBAeDFD.ZEGBHDCAhACAaECCADHAIEGAhBAA.KFDANIAB.JFHB.XGCC...hABA......hAIA...,1,-13,-19,6
JbgGeXOfBAcRHYDZQSCNVIEKaPTUMWLFd,HAAAZAAAQAEACADB..IAFAEAGAaBHD.TBGAUCAAMDDAhABALCAA.dCEAbEAAhACAeDFH.fDHAhAAAAADAREEASEHBKEDDFFHDgGGBOHAA.hACABHCADGGB....hCEA...,1,5,-6,11
EZVSMKHgUNPIYJXeQcfbAaBGDTCFdWORL,GAAATAAA.dADARACFZAEBMAFA.HBFAUBGA..IDDAJCAF.hAAAeDBHQECAhACA..bDFAAAHAaEFACFDAOFFBhAAAEFFBKFHBPHBAXGCCBGHADIEA..hAEA......hCEA...,1,5,-12,17
gRYOaQCdJUXVIKEMLAZTGHBbPFfeDNWcS,GAAAHAAABADBFADAeAFHDAFA....NAIA.SAHBRBDA.hAAAaBGDdBGAUDCAXCAAhACAKDHBEEEEADDBZEEA.TGEAhCAAbFGD..fGEA..cGGDhDFA....hEAA...,1,-11,-24,13
fVSRUPXcNbGAFHBTJMECaOKgDIYQLedZW,HAAATAAAEADE.aAFAKACC.DAFA..QBFDeAHFZBDB.fCAEhAAARCFBUFCA.XCCAhACA..bFEAAAIBBDFAhCCAMCIBCCCAOCHD.gFFAhCDA.IHHAdGBCSGHHhAAA,2,-18,-12,6
VdGZgYSLBEOQReHNPUXMCcWDaIfTFAKbJ,KAAAVAAAZACB...SAEAEADERAFF.HAGBUDCA.MAIBCCAADCEBhAAA..aCGD.TFAAhAAAAAIBdDFAGEGA.hAFALFAAQEECeFEBXGGA.hACAWHAA.fEHAhAHA.,1,-13,-21,8
VRQSdETNLWUOCGHeXaYgcIbfAMBFPKJDZ,MAAAFAAAKADAZABE.RAEF.dAFA..EAGELAHBUCGA.GCCAHCCBeEFBhAIAaDAB...gGDAhBAAbEFABFEDDGGBhADASHFA..WHBA.CHHA...hBAA......hBHA...,1,-5,-29,24
CLQYPWaTSDZHJeVKfNRUAgdXBOEIGMcFb,dAAAOAAAEADAGAFAFADDLAFA..QCBA.PCHDhACAaBBHTCEAZDDBHFBBhADAeCGHfFFAhAHARFFAAAGABDDDMCIBCAHASGHBDGCA.KHFA..hBAA......hBCA...,1,5,-21,26
MYLeHTdNSaPEQbBfIZXDJCRFOVKUgAcWG,GAAAMAAALAEAHADAdAGA.aBHDEBBAQCDBBBHAZCDADCEARDFBODAHhAAAKDHBAAFA....hACA.cFADeEEBTGGAhAIASEHB.fGHEIHDA..hADA......hAFA...,1,-2,-25,23
KNRMIbWEcaTgQUBXZVeHFDOYfLJdCPSAG,GAAARAAAMADA...bADAEAGA...aBDDTCDA.UDGAZBFAHDEAhAAAODAHLCCDhABAdAHASDCDADGAKEHBIGFAhBIAgFCABHGAeFEH.DGGA..hAAA......hACA...,1,-8,-10,2
NWQZHbYcAGOPXIDKCVLfRJdBEgMFeUTaS,GAAAXAAAKADALADARAFFBAHB...EAHBMCDBeCDA.aCGDSCEDhAAA.QDGAhACAHEAAbEECAAAAODAHhADADDIBfGDEdFFAFFDDNICB.....hAFA......hBAA...,2,-13,-5,8
dRDYVJTHIGCFSWBeXNQEZAfgPOMLUcbKa,...fAAAOAAAMAEALADAUBBBKAHBRAGFDBCB..VBEAhBAAHCAB.GDCAFDEHBDGAhBEAeCHH.QEEChAAAADIB.gFAGbFGB.dGGA..hACA......hAEA...,2,-33,6,39
FfCUSNIZTeGgDEKALYBMROXaHcJdbPVQW,LAAAMAAARACA.aADDHAFB.dBHA..bAEDQCCB.hABAfDFESAGAhACAZEGBeCCBGFABECGEAAGAhCAAOFFBXEEA.PEHBFHACNBBA...hAFA......hAHA...,2,-13,4,17
AXCSfIQJTdabDMGZFBcUVYWNRKgLHOEeP,SAAAQAAAdADADADAZADEBAFA.UCFA..VBGB..hAAANAIARDBALCCA.hAAAHECAEFABAAHBfEGEhABATFDA.aFHDbFFBMHAAFFHD.....hAFA......hBCA...,1,-11,-18,7
OPZbBNSWGUIgfCTRVEXLeKHMDacAQFdYJ,dAAAOAAAZABBBADA..SADAGAEAUBGAIAGA.hAGACBBDRCDAEDCA.eEEAHCGBhAEAaEHDAAIBQECChBAA.FFEDPHAANICBfGGBXGGC.hCAA......hCDA...,1,-16,-18,2
FMRQbZOPUBSKfeVJWXDCNTHAgaIYGdLEc,aAAAGAAALADAEADAMAGBRAGF..ZBBAOAHBBCFDKDDD..eCDBhAAAJDHB.DBFB.TEGAhACAHEABAAEA..gECDhADAdEFAFGHD.bFED.SGGA.hAIA......hBAA...,2,-20,-1,19
FMZQXDdGaTSRBUWLNKYCHEfcPbgJAOIVe,OAAAeAAAZADBDAEAGAFA..aAFERDBBBAHALBBAKCHBHDEBhAAAEBHF....fCEAhAIAbEGDABDB.FDBAMFBBhABAdDGDTFEA.SGCB.hAHAWHFA.CGHC...hBAA...,2,-29,-8,21
XKRdgfZQOIGSBHULPMbJVFCYaATeEWcDN,EAAADAAAKACARACA..dAFAZAEB..QCCBGAGAHCCBLAHBhAAAMBBB.bDADFEAH.aDGHABHBeDFBhADA..NDIA.fEEEhCAAOEFHBGBAPEHBCHGA.TGDAhCBA......hDAA...,1,-2,-18,16
XUdRGDgePfBZEHbacCKQIOSFVWNATJYLM,TAAALAAA.MAEAdACARAEAGBCB.eAHFBAHBHCAAaCDDKCFAhAAAQDEAOCHDFEAAhAEAVFBAAEFA.XFGAhABA.DCIBfFAEEGEFCHFA.SFFAhAFA.JHCA...hACA...,2,-15,7,22
NRSCfIZHeXPUBMYOKQgdEcDLFJWaVbAGT,GAAARAAACADB.ZADAHAEBeAFEUBGABCDA.MCFBKCCAdEEA.DAGALCHBhAAA.FDCHaEHBhAAAADGATGEA.SEADhACAXGEA........hAEA......hAIA...,1,-18,-37,19
aEZHIGQAcDgCSebXFUfTNPKRMJVLOWYdB,DAAASAAAeABAFAEDUADA...TAFAKAGARCCB..MCGBLAHBhAAA.OCCBhABAdCHAEFDAHDEAGGABADBBCEDDbFGBhBDAfFGA..PGDA.WHCGhCAAaFHD.....hAGA...,2,-27,1,28
eHXUQcEfPAbRdIJTOFSMGVZCWDBgNYaKL,RAAAdAAA.JADATAEA.FAGAGAGA.ZCAEDCCABCEA..gCEAhAAAaDEELECBhACAHCGBQFFAhAGAEDAAAADAbFFA.SEHH.MIAACHHDYDDFhABA.....hAIA...,1,-6,-22,16
WZGgacVFRfNCIBXKPTOJSDELHdAQUYebM,QAAAeAAAMAEAGBCAaACE..FAFARBEACAHABBEA.KBHBTDGAhAAASCDDLEBBhABAHCECACIBUFEA..hBEAbDABgGGBfEFE.XFGDhAAA.OHECDGDB..hADA...,2,-19,2,21
SJgbBQKceNPMHZGWFAEIXTDVaOYCdRUfL,EAAATAAADADA...aACACAFA..RAGF.LAFA.SBDDhAAAbBCBQCECeCCDMCFAhAGAHEFA.GDGAACCBIGHAhAAAOEEBdHEBfHABBDHA.cGEDhAHA.....hAIA...,2,-23,2,25
dYCPRcIUTXLVMbSfZBWFDHKaNJOQEAeGg,eAAAdAAACADA.RADA.UAFALAGB..MAIBSCCBZABB.FCEDhAAAHDCAaCHD.ODGBhBAAAAIBGEAA..gFBBhBFAcEGC.XFGDbGCABGGDKHDA..hBHA......hCDA...,1,-5,-25,20
BTLMDdbVIXCHWcJQKZUYSANGFfOPRgeEa,GAAAOAAARADAEADABAGBMAGB..dCCAVCDB..CBHAHCFA.hAAAJEABZBGB.SDADhACAABBBFEDD.fEHAhADAeEHBLFFBbFBDXFFD..WFCDhAEA.....hAHA...,1,-9,-21,12
UbVGWQILHTNXPFdfZagCcDSMJOAEeKYRB,EAAAeAAARACA.BADA.UAFAGAFA.QCCBHCCATDFAXDAChAAAdBHAZECA.aEHDCAHASCHHhADA.hAAAMDFBAFBBKGGDbFAA.IFHANIAB.fGFAhAFA.DEEB.hABAOHAC.,1,6,-11,17
OeTVPKHfUZBSGXIYAgEFcJabQWRMdNDCL,EAAAFAAA..aACDQACA.RAEAdAHACAEAeAFH..TCFAhAAAKAHBHCDBZDDFSCCDhAFAGCGAXEAAADIBgFFBhCAAbFFD.MFIBLHAAOHECfGDBhAEA.BHHBhAHA...,1,7,-15,22
VPFeXWKAZGRcEOSYMBaQCfLHTdDNbIJgU,RAAAEAAAOADA..MADAQAGALAHBHBDAdBCADBEA.ICEAhAAAgDDAVDFBhBHAeDGB.KCCDACGA.ZFFFhAAASEEDaDHFCHHBNIBB.JFHB.....hABA......hBIA...,1,-1,-20,19
RVPDTXaBCIEgbcFYfOKeQUZNdAWGHMSJL,HAAAMAAALAEARADFDAFA..aAGECBBAEBDB....bCACFBHDOCEDhAAAeCEHZEGBACGAGDGAhACASDFHJGDA.TFAAhAFA.BGCA.......hADA......hCCA...,1,-17,-19,2
HbgFEaSXZIBYGCcQNfLUKeOJWRMDVAPTd,dAAAHAAAFADAEADE.aAFAZAFB.BAHAGBEB.QCABLCCBeCEDhACAODCCRCGFMDBBhBAAAAIBbDGD..SFDAhAAA.IHHACFGDfGHA...hACA......hCDA...,2,-30,-2,28
JUOeSYKDAIGdBgMECVRNZHPXTQaLbfFcW,dAAAMAAAEADARACA.HAFA..TAGAaCAELCEAFBBH..JCEAeCHHhACAKDDA.AAHAGDCAhADABDHACEFAZFAAQEEChBAA.bGEAfFGA...WFHHhAFA......hAGA...,1,13,-35,48
UePWgFOJXdRMbBTHVECKGfAILZSaNDcYQ,ZAAAaAAA.DACA..QADAeAEA...PAFCFAHDXCCAhABARCCBMBBB.BCFAHCECEDGAhAFAGEGAAEFBLFCBhCAASCHB.cFEBUFGA.ODAH.hCBA......hCCA...,2,-25,4,29
OcGKXULbYaVdDNIFZMgfTRPSABCJWEeQH,CAAAEAAAHACAGACAKAFCLBHB..aAEAdCAADAHBFCCHZBEFMCFBhAAATEDA.RDGFAAIBBCGAhACAeCBBQFGAhAEA.XECAbGCA.NIAB.fGGEhAAA..SGCGhAIA..,1,-7,-16,9
ZLgObIEAfeQGWcTCYFHNUSDRJMdaVBXKP,eAAAGAAA..TADAFADAHAFB.SAHBRAFFdAHAaCCBBDDAhAAAKCDAZDCALDFAODGDEGEAhAAAAFAAQFFAhABACGHA..YHBADFIBJHDAXFAA.hACA......hBAA...,1,-2,-14,12
YHTeNIBQaFfMXKbEWLOAcZURdVPDJCgSG,ZAAARAAAdADADACA..CAFAGAGAHAEAeAHH.BCCDaCCC.MCEB.KCFBhABAECFBLEHBAAAA.hAFAUGAAPEEB.SDHHhAIATFEANIDB.QGFA..hBIA......hCAA...,1,-11,-26,15
fGcRAFZdUXQOKgIDJVMHWbeYSTCNBLaPE,dAAAQAAAKADADAFA.MADAHBEC..eAFASBHBCBDALCFAhAAAECBA.GDBA.ADBBZDDAhBCAODABIEHAhBDAVDDA.bFFCTEGABHCA.aGGC...fHDBhACA...hBIA...,2,-16,-4,12
SBdabMTLfcHNgGeICXOVYAURDFEWJPZQK,RAAAEAAA..JADAZACB.QAEABAGBdCCA.aAGE..MAIBLCBDhAAAHCFBGEDAeCEBXCGAhAHAOFCHAAAAFEGBKFHBhCAASEED.fFHAcGGC.hCEAIHCACHFD..hBCA...,2,-17,-14,3
KCQXHaWZLGDEUbSfPRAgFNBIJOMedYcTV,FAAABAAAOACDeACAdAGA....TAEACBEAHCAAZAGBGDCBhAAAECEB.SBHHhACAREAA.ACCA.gDGAhAEAIEHAMFDBVGCAQGGAaFFBDGBBUGGAfEEEhAGA..hBAA...,2,-17,-3,14
NRMBcGLebPXCWIEFAOZKQJHaVYfSUgTDd,ZAAAQAAAHAEAaAGA..VACA.SAFBTCAAdCEDRBGFMCFBhAAAGCGA.eDDBbDDD.hAHACEADEFFBAAIB.OFHDhABAKEHBfGFADACA.BHGA....hCAA......hDAA...,1,3,-15,18
TJDdLBbAOWXgFYSIVRcPMQeGEfNKZUHCa,XAAAFAAA..SACHRADA.MAEAeAGHGBDAECDBKCHBhAAAHBFAaCFHDDAAdDHAbFBBhAIAAAIBOEAA..gFEAhBAAIFFAPEHBfGHAZGAA..hBFA......hBHA...,1,-9,-16,7
XRSYQKHZCeVLMEIBANObDPUTcgFfdGJWa,OAAADAAAUADA..TADAFAFEGBBA..aAFARCGB.QBFDhAIAHDEBeEDDMBBBEFHFBGCDhAIAABIBbCCD..gDGAhBAA.dEEA.XGDCSGGDhBAAKGGA......hBBA...,1,4,-22,26
VKCUYFfOWZQPSBNaMRbLeAXGdTHDEcJIg,dAAAHAAAEADAJADA....IAGAKAGCCBHAFCAHOAHD.ZABBQCCAhAAABBEA.aCEEhACARCEAeDCFGDGATEFAhBAADEFB..VFCBfFHASGGDMEEBhCDAAIEA......hDAA...,2,-21,-9,12
AfUcZEMCgVTSGeLYaHQNKWdIFXBPJDObR,UAAAEAAA.MADACACA....TAEAeAFAaBDBHAGB.QCCAhAAAKBHBdCEAFCGHBDFADEDBRFFAhBAAAAIBZEAA.SDHHhAEA.GGABNIEB.XFFC.hBCAOHEE...hDAA...,2,-28,8,36
fFIaEAQdZDgYNUcPXOLVHSbWBRCeGJTMK,ZAAADAAA.....gADBUADAXAFALAFBHBBBSAHBhABABCFARDFAeDEDGCAAhACAMAIBFCHH.ECCBABBBdFHAhAGANEEA..OFFA......hBHA......hCAA...,1,-13,-22,9
fHKUONaAPJeRgbZQGXEBYcFSTDMWLIVdC,eAAARAAAZADBGAFAEADABAFAFAHF..DAHBMCCBLCCA.dCGDHDEBhAAAOECAADAAJDHBQEGAhAAA.XGEAhABASFBA.IHDACHHA.KGGDNIAB.hAIA......hBIA...,2,-20,-16,4
KPOCERXQMNYGFdWZfTHBUJbeASLDaIcVg,LAAAaAAA.VAEAKADACAFB..RCAA.MAHBGCGA.dDEAZBBAHEAChABABCFAUGDAeCHHAAHADBIBhACA..gDAAhADAEGGB.QEEA.FFCB.fFHAhAIA..hBAA...,1,-3,-31,28
TUGLBPVadSebQINOWMRfZYAEJKcDXHFCg,EAAAKAAADACAHACA.CAFB.UAFAGAGALBDBBCCD..aCEBeBHHQEAAhAAAOCCBRDFBZDEB.hAAAAAIBJEHBFFBH..TFDAhAIA...dGHASGEA.NIDB.hAEA......hCAA...,1,-9,-19,10
UaOCDLJfgZecFWIMQHNYTXEdbBGVAKPRS,RAAAaAAADADALADA..JAFBZAGBFAHBMBBB.HCCA.TEEAhAEAEBDFdDEDGEGAAAAA.hCAASECDCCHA.hCCAeFABIEHANICB...XFFChDAABGED.KGHB....hDBA...,2,-45,11,56
JIbXEPNgcdGHASZYaUBQRFMVKODeCfTWL,ZAAAaAAABADARAEAFBHD...MAFAOCAB..eBBBCCCD...TBEAhADALDEB.IECAhABAEBGEgDCHhBAAGEAAHGCAADGASDGAQGGADEFBfFHAhBIA.WHFAhCAA..,2,-20,-18,2
JFIEaOBZKbRcTQefHAGYDLSPVWNgUdMCX,GAAALAAASADAVAEA...gAFHdAHAMCAAXCDDhABAFBHDECDBBDFAZDFBREAAhACATECAeDHFHFDBhAEAAAABDDABPEGD.NEIA.CGHA.aFFH....hACA......hADA...,2,-11,4,15
EKAVZGdUIRBfgDcTbWPNeFQOLMJSHCXYa,GAAAdAAARADABAGBDADA....TAFA..bABD..PBHDhAAAeAHHQCEAhADAMCDBHCEBXEBDhACAEDHFAEAAZEAEIFFAfEGAgGDBcFGDFGDDhAHA......hAIA...,2,-12,-11,1
HVXUEeRIBFgYONbKcCLAaTZdGSfDQJPMW,ZAAAGAAADACA.QADAMAFA.HAFAUBEARCFAFCDH.ODAHhAAAKBGALDHBAAHAdEFDfFHAhACAJCCF..PEEAhABA...XGGC...hADA......hBAA...,2,-35,-6,29
cfQWKaPDFXBLYNdgCHVRSIeTMbGAUJEZO,EAAAZAAAOACA..QACAaAFD.FAEELAHBdAHAHCDChAAARCCAeDFFbDGDGGCBhBHAABHBUFBAfEEEhCAAKEGAXGGABHHA.YCCFNEEA....hCBA......hCGA...,1,-1,-13,12
gJUfEKaNTGCIcdHPRWAFYBbLXVDSQOeMZ,BAAALAAADACA.QAEAeADAZAGB.UBGAKBCD...aCAAGCEAhAAACCEDdEAAHDCARECB.AAHAFEFDhABAXGBD.OEHBhBGAMEHB...fGFANEIA..hBIA......hCAA...,2,-30,-8,22
fIbcaDJXZROPYEUQMeFGVHKSTNCLAdgBW,dAAABAAA..IADAaACADAFA.ZAEB.RAGB.OAHD..ECBAMBCBhAAAeCFHGBEAHECBTFGAhACALEGBAAIBfGFEhBAAbDCD..XGBC.PHDChBDA....hBGA...,1,-6,-30,24
gKCEJLbNWPdSAHUZGOIeVcQfYFBRXMDaT,HAAAGAAAeACEQADAFAFARCCA.MAGBaAHD.TDCAKCGD.EAHBLEEAhAAA.bFCCPCHBhAAA.ADABZEFFOEHDhCAAIFBAfGGEXFDADIDA...hCCA......hCDA...,2,-6,3,9
cAOfYNEXWICKHDQZJdLBVgRUFMTPaSbGe,OAAA..fAAAEADA.XADACAFAHAGBZBBALAGBhAAABCFDREEAMAIBaDDCSEHBhAIAeBCBAADA..hBAAYCABIGGAQECB.dEGAhACA.gFEFhBGA.FGCH.,2,-18,-15,3
cEXCKbIAdJZOMGSNUeVPaDYQgHFTWBRLf,ZAAAGAAASACEeADAaAGDDAFA..QCDAHBEAFCCHTDFAhABARDFFLDHB.EDCBKAHBhBGAAAABdGBAMDIB.VEDBhCAAPFDD..gGGBfHFBCHDDIHFAhCBAODAH...hACA...,1,-1,-2,1
RTZYKUGCFbfQDaJNAcLIgMVEHSWeOPBdX,LAAAMAAAHACCeADHBAFBRAFAZCABKAHBGCCAFCED..QCGAhABAaBBHACFA..gCFAhAHAEEFFOFAEdEHATGGAhACACFFADHFA..NIDB........hAFA......hAGA...,1,-11,-13,2
CLfZKXNHOMGdEBaJgPVRUFAYSWceIQDbT,SAAAeAAAQADADADA.CAFA.ZADEKAHBHAGBGCCAECCBaCEBJCFB.hAAA....gDFBhAAAREGBACCB.cFEAhABAIHAA.LHCAfFHA.NIAB.hAIA......hBIA...,2,-22,-15,7
JKMRAVCSaFEWGcYNLfeDdHOgPbUBTIZXQ,SAAAEAAAGACA.....NADAeAEAHAEAOAHD.bCFDhAAATBGAZEAAQGAAhAEAMCCBAAAAaDFBFCBHcDGDhAEALEED.dGGAgFABBDHD.XEDDhAFA.RGEA..hAGA...,2,-6,12,18
SPCRKXFVYbHGZWOABdQDfJgcMUTIEeaNL,dAAAQAAADADA.JACEMAGB.UBDAEAFA..eAHFLAHBhACACCDARCEF.FCBD..bEFDHEEAhBAA.ZFCFACIBfDCEhAAATGGA.aEHBSEGEXGCA..hBCA......hBHA...,2,-21,-10,11
RbdVGAXagEBLCcTfZJFPIHNSMQDKeWOYU,aAAAEAAALADA.CAHA.TADAZBCAFCGAHAFB.MAIBQDDChAAAeBBBODABREABdEGAAAEAhAHABDDA.fDFEhADAIGDADEIBKDHDUGGAbGFC.XFADhAFA......hAHA...,2,-7,-6,1
DCJRYSLFdaKbEeZcfgVBONGQWMUTPIAHX,HAAACAAARACA.LADBdAFA.aAFAEAHBZBEB.....fBHAhAAABCAAGCCBMCABTDGAhAAAACCADCGBSDHHhACAKEFDeFHF.gFFBOHCA.WHEG.hACA......hADA...,1,0,-29,29
bFTBOYRAfQWIUGdeXCEKJDVHPgcZSaNML,QAAAUAAAeADA.EACADAHBHAEA...PBHDZBDEaBHDMCDBhAAALDABFCEHBDGDRDEAADEA.hADAfFFA.hAEAGGABdFGA.KGHB.......hAIA......hBAA...,1,5,-28,33
GMIPfZbWBSQUTDeLARgcEOCVNHJdFaYKX,RAAAEAAACADB.HACA.dAFAaAEDKAHB.GCCB.MCHBfAGAhAAA.ZCCAbEAABBHAQFEAhAAATDGAeEEBhABAADIBOHAAVGAAFGGAXGDD...IGGAhAGA...hAEA...,2,-11,-1,10
ACeNMfPBHJXTIDRGVbaZgQESLcdOWKUYF,eAAAMAAABADAHADATBGARAEF..GAGAaAGAZCCAEBBBLEEAhAAAdDDAKEGD.FFAAAAIBCFEAfFHAhABA.XFCDhAFADDIBbGAA.QGECSGHB...hCAA......hCBA...,1,7,-25,32
PgeCXKaTUZSOdGAJHMYbfDRWEILBNcQVF,HAAAMAAA...bADBRACAEAFELAGBBAHB.QCABFBBH.eBFFhAAAKCEAaCGAZEEAdFBAADDB.hBAAfGEADDHB.hCAAIHHAVEEBCECD.XDGASEHHODCFhACA.....hCEA...,1,21,-33,54
EOLQTBRKMPJIGdCUfXSNZHbVcgaeYAFWD,DAAAEAAALADAQACARAGF.KAEA..MBCBJAHB.dDDA.UDGBSBBDhAGAHEAB.VCEBhAHAaFDEAAEA.OFHBBDHAGGCBhBAA.XFGANIAB....hCAA......hCCA...,2,-26,-7,19
dHaNIXESYWbMcPJVLRUKBgDGefFTAOQCZ,QAAAdAAAHADAaAFA..XACAEBHF.SAFA.hACAbBFAMCCB.PDABhADALDAARDDABDHAGDFAhAAAeFCFTFAAADDAZFFAIHFAcEDBJFHBKGDBhAIAfHDBCHHD.hBAA...,1,7,-2,9
PbBIDTCKLeONgZSaMdYXJHWcGQFUAERVf,RAAAVAAA....bADBDADA.KAFAeAFA.OBHDZBEAaAHFdCCA.hAAAJCFBHDCA.GEFAhCAAQEGDADIBEEHBBFDAhCDATFCACHHA.LHCA.SGABhAAA.....hDAA...,1,-2,-19,17
USBgLRZYKEdabeXOWGAIfHPNTDQCFVMJc,HAAATAAAQADC.FAFAMACAUCABBAFARCFAZDDFEAHBaEHBeBDBhAAA.OCCBAAIB.hAAAfCGADFCBCFFB.hACAcDGDSFHHLFDB.dGGAbFCDWEBDhAIA.....hCFA...,2,-9,-4,5
RLFMbcIZYEXdUJfPNKCaHQOGeSWDAVBTg,TAAARAAAMADA.....IADAEAGAdBEAUCCAJAFA....hAAAfBEAKBHBHCFBQFFBhABAeCAADCGAADDBBDFAhAAAFHDA.ZDGB.XEECCHHA.aFDH.hCAASFHH.hDAA...,2,-15,-15,0
YKJLPbTXCdAOVZGcNQHIUDBMaFSgRfeEW,ZAAAGAAAQAEAHADADAFAMAHBaAHDFCDHRCAA..ECEBKCFA.LEFAhAAATEFA.dFCAAACAOCHDhABAVGEA..NDAABHBDhACAfEAE.eEED.....hADA......hBAA...,2,-6,-5,1
EQGHbfSXTVOYDCeJBMPdUFgcNRaKIWZAL,EAAAHAAA.SACE..TACAOAEDCAEBeAFHMAGBdAHAhAAAFAHB.NCCA.RCDBaCCH.KCHBhAAAZDDAADGBGEGAbDGDfHBBhBHA.YFFFBFFC....hCAA......hCDA...,2,-15,-8,7
XCOVQBEdebATKDfHRPWYcNGSMFZLJIUag,TAAADAAAHABC.RAEF.....PACA..cAGAGAFAhAAAMCCBZCCALAHBhBFAUDEBaCGF.CECAQEGAhBHAEEABeDHHADDBKFFDfEEENIABFGHD.gGGGhCAA....hCDA...,2,-7,-1,6
XefTCBRKUSJYdbEPZacGWDOFMALHIVNQg,HAAAVAAA.QADC.eAFETAEARBFBSCAAdAGAECDBaBHDhAAAGDDADDAA.MCIBhAAAADFALEAAgFGBhACACEFAKEHBYHCAZFEAOHEC.....hAIA......hCAA...,1,6,-8,14
TQDcSILWBCbXANHJfOZYEUaeKMPgVGdFR,HAAAOAAAEADEUAEAeAFE.KBFAMAHB..VCCAdBBDRDDA.QEBChAIASCADLEHBhBAACCHAADGBJEFF.ZFFBaEHBGGBBhBEADFIB..........hBGA......hBIA...,2,-15,-6,9
FGUMOVCPgcATXWfbZQLBENaYJeISdDHKR,TAAAXAAA......bACBZACBLAFAEAEAaAGDeBHHhAAAdCEAHCGBRCEBGECAMCCBCEDDhAAAPEHDAAGAQFFChBEABGBD.YGCESFGDDFIB....hABA......hAIA...,1,8,-9,17
YPHGSNKXRCFgJDeMAQfEVbdTIWOLUZcBa,EAAAdAAA..TADAOACCZABBBAFB.aAGDHAFB.GDCAKCCARCEFFCHDhAAADAIBAAHB.QEEChAFAVEAA.bGEALFGBhAEA...cGEB....hAIA......hBIA...,2,-23,-4,19
aQANLPOETGVKZMJFIWXSfbgRDHUCYBdce,LAAAEAAAGACAZADBMAEAFAFD...XAGASAHB..hABAbBEDRCABHBGB.CCCCdEEAhACAeCBBAEIBOFDHhCAATCGAKEHBJFHF.fFFADGGB.BGCA.hDFAaEBH.....hEAA...,2,-8,3,11
FbCUfQEGXdLaVJIHDcAOZMRBYWKgPeNST,ZAAARAAABADBKADC..eAFASAEH.FAGAbBFA..UCGAECAAdDDAhABALCCB.aEDDhAAAIDGA.HFDChACAAFFAMFHBgGAATGBA.fEHAhAGA.....hABA...,1,-5,-35,30
ASeGMFXOIPZWUNBDKHQETgdCfcRaVbLYJ,eAAAGAAAMAEAOADAZAFE.UBGADBDBHCDBECDA.dCGA..fDCEhAAAREBBaDHD.LEEAhACAAAAAXFFC.IHHAhBEAPFHDBGCAKGDB.TGEA.CHAA.hAHA......hAIA...,1,-6,-15,9
VbcgTCQIeGSBZfKaOFYDJUMRWLHAEdPXN,EAAAdAAA..XADA..bACA.TAGAQAGAGCCAZABBhAEAaCFDFCEHDCIBMCGBRDABHEFChAAAADDBVFGBCGAD.eGAAhAGAfGGEOHDC.YFDB...hBAA......hBIA...,1,8,-10,18
TfUKDebgJadCWQYEIHRFPGBXOMcZVSLNA,TAAAKAAAeACE..JACAdAFA.QBCD.EAHBHAFBRCFAGEEAhAAAOAHF.ZCCALEHBhAIAADHBDECAaEFDCDDD.IFAAhAAABHGD.MEIB.SGHDhAFA.fHABhAHA...,2,-28,-7,21
dFZJEYDgLQCRIAOTXaHfbMVWNGSecKUPB,TAAAHAAAMACA..VADAGAEB.eCCAKAGCBBHAZCFEEEEBDCABhAAALEGBRCCBACGB.aHAAhAAA..bDADNEIA.SDGAhACA.PEFB.dGHA.FFDD.hAHA......hAIA...,2,-8,-5,3
fTdQGLeSDabRIXFUZHMNgPWOEcYKBACJV,CAAAVAAAdACAGAEA.LAGBeADEaAGARDDB.FBDDHEAA.MAIBhAAA..gBFAhAAAOEHBECBBKCHBAAEBTGBAhBCAQEEA.bEGDXGEA...hCAA......hDAA...,1,7,-24,31
GZWFXLIRcSNKYJVQEgDUfebTOdCMaABPH,HAAAZAAAFADALADBRAFF.SAFAKBHB.VCFAECAADCEBeCAAhAAA.OEEBdDFDaDDHAAFABFCAhACA...PFGBhAIAXEGANEIA.QGGC.fHABhABA..hACA...,1,2,-38,40
WRdcEYXLAFCgbTIVNGSPMDUHOZfQJKaeB,CAAATAAA..IACAGACAMAEA.HBEBZADBQAFAhAAAaAGEeCABRCGFdFFAECFBLBHBhAIAAEEBFGCA.bDCCSHGAhAAADFFAOFHD.KHDA.BGGC..hCAA......hCBA...,2,-19,9,28
LOTKJHCAPWNSRQgMeYbEDBfacZGVUXFId,...PAAASAAARADA.MADAeAGHEAGABCCA..aBCDGCEAhAEAXBECdDHATGAAhAGAHCFCAAAAQEEAhBFA.bGFAfEDE.ZGFE.hBIA......hCAA...,2,-16,-11,5
TSNFEafOeVJKRXGcMYdUBZbgLDPQCAWIH,HAAATAAAFADA.EAGAaACA..eBHFKAFARCCAGCAB.MCFBdAHAZCFFhAAALFGBQFAAhAFAACGBSECAODHFXEEDhBDAcGAABGEADGHBCHDANDIA.....hAAA......hACA...,1,-4,-5,1
WdeISEDNXJaPOgFBMbRcfACUTHVLKZYQG,TAAAHAAALADB.ZAFAGACAeCAAECFAXAEA.aAHBhAAAODFEBCADRCEBAAGACEEDKCHBhACAQFCCdEAADEEBPEHBhAEAMFGBfFHAUGDB....hAAA......hACA...,1,2,-9,11
HRNdOVQfTZXAMSCFbPaUeIYcKWJGLgDEB,MAAAFAAA..aACDeACA....IAEAKAFAGCCALAGBhAIAEBBBHCFARCDBdEGAQEFBhAHAZFCAABGBCGHA.PFHDhAIA...YFCF....hBAA......hBIA...,1,-13,-33,20
QJWUBaOgYHcPCZITRGSKeMADFXVfLdbNE,XAAALAAAdAEA.EAGAQADA.UAGAaBGEOCAAhABAHDAACCDDZDFARDDAGDGAhACAeEEBAAAAFEBBVFBA.fGGAhADAbGAAJFFF.BHDA.....hAGA......hBEA...,1,3,-6,9
PgIAJHBMVWcDUZdFKQbSaTGORYNCfEXLe,HAAAMAAA.VAEADAEAdAHAKBHB...QBBAaCACGCCARBDACDEAEDHBLDGBhBAA.eEBBhBBAgEABABGA.BEFAhAAA.cFECZGEA.SGGB.hBEAOHAAfEFAhCAA...,1,3,-22,25
NWJMELVTAQcYfKIBRHCFdPUOaDbSegXGZ,QAAA..fAAABACAHADBdADAOAFAbAEDeAGBhAAAGBFAZCAB.JDDFEDDBTFBAhAAAAAHAKDHBRFEAFDHDaGCBSFEHhBFA.XGGAWHFA.MIBAhBIA......hCAA...,1,-6,-8,2
FTPHDEYNJadUILbBVcSKAWeGgMZQXOfCR,eAAAGAAAZADBQADAOAFC.RAFATCGAHCEBEBCF..JCDFdCGBhAAALFDABDHDSFGAhABAAAABMDABCEHADGHBaGFCIHAAhAHAVGAA.WHFA.....hACA......hADA...,2,-7,-4,3
TcaZUAXPONVFGWSMBLKCJDfgHdYIEQebR,OAAAFAAAGACA.MAEALAEA.CBBDDAIBHBEBdCDAEAHFeCFBhAFARDGBaEBBZCGF..ACIBXEEChBAAVFEB.BGBAhBEAfDBAIHHAbGAA......hAGA......hBAA...,2,-22,-5,17
gYaTKZHSCNXAfOQBGcIWDLUJVdeRPFEMb,QAAAGAAA..IADALADAVAFARAGFECDA.MCIB.hAAA.bCDBaDCCZCFEHDFBhAAACEGAADDBBFAADEABdFDAeEHHhACAFGHBgFAHTGEANIAB.fHEFhAEA......hAFA...,1,2,-2,4
DdXOPKbEBJgWCTSQVZNMeaFGLfAYRUcHI,RAAAHAAAdADA.OACAKAFABAHBJAFB....CAHA.QCEAZCCB.hAAAeCCBGCGALCHBhAAAACCBUFEADEEB.XFAAhABAEHAA...TFFASGDD.hAFAMFIBaGDC....hAHA...,1,-15,-21,6
GPgDXUCZIObTVRfAHdSJBMKaNFecEYLWQ,HAAAdAAABADAaACAeAEHEAFA.LAGBGBGADAIBCCCAZDFA..OCAEhACATFFARCEB..AECA.MAIBhAAAFFAA...cGBAhBGAQFGB.XGCAIHHA..hCAA......hCCA...,1,-11,-21,10
JYMDXFgBSeOfaEQWVbNAdTPcZULCGHKRI,dAAATAAAZABBLAEA.HCEARACFIAFAMAIBFDCDBAHAeEEAhAFAaCAC..EEHFQCEAhAAAVGAA.ACHAcDGAhACACGGD...GEAA.KECADGIBSFFAhAEA.fGHAhAHA,2,-12,-8,4
TOJUPLbAZKYDRfeGMNIXWcCFHEVgaBdQS,ZAAADAAARABAeACEGAEAMAFA....XAGACBFAHBGBECCB.aCEHhABAdDCA.TCGAUEGBLFDBhBIAAAGAKEAB.fGHEhCAAIFFAFEHD.BGEDOFFH.hAEA......hBAA...,1,4,-27,31
dEVaeYNbLDfMZAIOSGKJHCPUgXTRBFQcW,SAAAGAAAHADACADA.UAGA..TAFARCDAQDGA.hAAAdFAAEBHFeDCBbCCALDABhABAMEFBAAABKGGAgDGAhADA.FECA.cFFC.aGDBDIBAhACAfHAB.hADAOFHF.,2,0,3,3
GgMDRdXVIUTbEAfSQLaNPeHFOCYBWcJZK,QAAAaAAA.eACAHACBFAFDCAEABAGA.JBHBGBGA.hAEAMCDBRCEBdFGAXDAAhAAAIGAAbEDD.AAHALFFAhADAOBBH..cGCA....hAGA......hAIA...,1,0,-34,34
QTKeVYZPMdbFCSNIAHJLOacGEBgWDXfUR,HAAALAAAaACAEAFABAEA.DAGAUCCARBEA.QBGAeBHHZCAAdEAAhABACCFD..SEDAhAAAACCAODFD.GEGA.hACAXFAAKEDB..PEHDMIAAFGEBIHBAhAEA....hBHA...,1,9,-27,36
EVTJcSfDbLOZMAIYBNCHGgRXWKdFaUPeQ,BAAAHAAARADFKACAdAFAFAEAUCAB..eAGHEAHB...JCAASCFAhAAA.DDDBbCEDZEEAhACA.ADIB...IDHAhAAACGEAXGGA..aDCE.QFGAhACA.TGEA.hADA...,2,-32,-18,14
RIYQMJebKBCVDZfdaSUHAPcWgTFLNOXEG,...PAAAgAAALAEAOADAEBCFGCEARAGB.QCGAhAFAeBDBbCEDCCCDZECFaCGHhAAAHGFA.AAIBTGAAhAGAXEBA.MDIB.BFGADIDA....hABA......hAIA...,2,-14,9,23
aPMGHYZeEFQCgbOLcJVRfWDAKSdINXTBU,dAAAXAAABADAUAFA..aADAGCABHAFBeAHBECHF.QCDChAAACAHA.bDBBLDFBhACAVDGB.RECADEIBhADAAEBBSEFDIHFA.NIAB.MFBBFGHD...hABA......hAIA...,2,-21,3,24
WTcCMSQXJKLBYZgEbGaRUHDAVdeIONFPf,eAAAOAAAFADD....fADATAFAMAIBQAFAhAFA.KAHBLCCAhAAAZCCAEDGAaECAHCGBABBBdFCAIEEAhABAPEHDCFAAXFGABFFA.bGDC..hAFA......hAHA...,2,-15,-7,8
ITdYNBAUREZfGHbQMJKSgeLXPaDcCOFWV,EAAAGAAAHACAMADASAEEeAFALCDAaAGD.CBHA.FCCHIDHAhAAAdDFABCHA.REDBfFCEhAAAbDBD.QGGAhAIAKEEAXFGADIBA.OGEC..hACA......hBAA...,1,0,-12,12
UYXQMGNbPWJaKgTHAEIfVBLFZDCcdeSOR,EAAAVAAALADA.ZAGBCADBeAEHRCBA.UAGAQDEDGDCA.hAAA..bEAAJEEAaCHDTGGAhBGAHFFCAAEA.BGCDhAAADDIBSGDH......hBIA......hCAA...,1,-1,-22,21
KMUAZfGgceHaSXJTRODINdQFLEWbPVYCB,GAAAeAAAHADAaADA.XAGBRAFF.DBIBdAHALCCAECDB..hAAAbDBDPCGB.CEEAMEIBhABAAAABZDFAfFFAhACA.SGHBTFAAOFGDIHDAhBCA.FHFE...hAFA...,1,5,-12,17
fLCMTPgSdcOZNWHVYQeJbKBXEFDAaIGRU,GAAARAAALADBMADA..TAFASAFAdAHAZCFAHCDA.QCGChAAAeCCDKEEAEEGEhAAAAAIBaDBDUFAACEFD..gFCAhACA.OEHD.WHFG.hABA......hAFA...,1,3,-15,18
fYHeOaJEPUCLMXWNcFVAZSbRQIBGgdDTK,ZAAARAAAQADCGAEAdAGBKAFCHBGB.eCABaAHD.ECCBUDDA.MCCBhAAAXEBD.NEAA.hABAFCGHAEEB.SDHHhABABEGDTGGAOFEECFFD.LHBA..hBHA......hCAA...,1,4,-15,19
HNFLVcJRfOeaSXWYQIUPMGBbKgTZECdAD,HAAALAAAVAEARADFeAFE..aAHDXBFDQCAB.IDDAhAAAMCABGEEAhABAbDFA.KCCDZEAAEDHFAFFAFFGDhACAfFCASFDH.YHAABGHACHCA.hACADGIB.....hAIA...,1,14,-12,26
gKGQCEWXdPNOeUaMHRYTBJfcDALIbVFSZ,LAAAVAAA.ZADBGADAEAFA.dAFBOAHDeAHHUDAAHCABRCFBBDFAhAAAJEEB.DDDB.ABGB.bFCDhABAFDHD..KFHBQFDAhADACCCC.XFGCaGGH....hCAA......hDFA...,1,-2,-14,12
fAWdcgSTIBeUaLROYVFQGKZHMEDJPXNCb,dAAASAAABADAeAEHLADA.RAGFOCCAFAGAGBFA.HCAChACAEDDBDCIBXEEDhADAbDFD.ACHA...gEAAhAAAIEHAaGHBYFDF.KGHBMIDAhBAA......hBCA...,2,-20,-9,11
fAMLgdbDXKYWZCaRVOHTEUSQPeJIcNBGF,MAAAdAAADADAKADAZADE..RAFFHBBAEAHB.QDDAeCBF.JBHBICEAhACA.BCGAhAIAGFABADDBLEEAhBAAbFGBXGEACFHA.aHACTGCA.SGEBhBCA.cGGChCGA...,1,0,-28,28
eKNCBgbGacWdHDRZFMESfVPTOIJQLAUXY,XAAAeAAACADA.BADAGAEA..aAEDdAGBHAGBRBGFZCCFFCDHEEGBSDAAhAAA.VDFBhABAOFFB.IHHAhAAALFDBADIB.KFHB.bGAC.DGBA...hABA......hCAA...,1,-1,-24,23
HbYFCReXAPSEIfgUVaNTcZdQMBKGDLWOJ,EAAA..fAAAUADA.aADATAFAdAGAMAIBGCBA.LAHBhAAAOBCBHBDBhAAAbDDBCDFA.RDFAADBB.SFCAhACAgFFAcFFCBEHBDGIBYFHHeHCE.hBCAXGBC..hBDA...,1,3,-9,12
DXUaOKVHCFWgJRceLZQSGTAMdIYBPNbfE,dAAABAAA....bABDEACA.XAEAOADAHAGBFAHB.JBEFRCAAeCEBhAAAZEEAGGBBACAAMCIBhACAIHHA..hAIAPDGBDEGA.aEEH.CFAA....gFCDhAFA...hBAA...,2,-16,-15,1
UaXHNLZSdWEVbJfFTBKCIPOQgYceRAGDM,GAAAMAAAUAEAHADAZAGBdAGA.ECDB.VDFAJBBB..FDCDKFAA.CFCB.hAAAOCHD..QGGAhACA.gFDHhADAeEDHAFFAaFGDNIAB.SGBB.hAFAfGEA.hAIA...,1,-2,-34,32
DRfCNXBaPSegVZWMTGHLJEQUFOAbYKdIc,KAAAdAAADADARACF..CAEB.BAFA..aAFDeAGHZAGB.MAIBHCABLBDBhACAEDEB..QECDhAAAOCBDADFB.bFGBIEGAhBAA..fGEAXFCASFFDhBCAWBHH..hCDA...,1,-14,-41,27
LTQMRXdeKVEWPUfbYcGBAgNFZaHISCJOD,FAAAHAAACADA.DACALAFAMAFA..RBDAeBGHECCA..UCFA..hADAbDEDGEDAABIB.ZFFBhAGAaCCHSDHBhAHAODHDTGBA.dHEB.KEBD.....hBAA......hCAA...,2,-26,-2,24
XNHEQGfKLaYTWBbeOcDCFPVAMJURZIdgS,MAAARAAAdADA...XACAHAFAECCB.GCEALAFA.aBBCTCGAhAAABCEAeCFHDEIBFFAAhABAAAGAZCGBSFHDhAFAQGGAKGFB..YHAAODDB....hAHA......hAIA...,2,-14,-6,8
PBCFDUZcTfRWbHINEYgASVLOQdKGaXMeJ,LAAAdAAAaADA.eADHBAGADAFAZBDA..TBFARCAAHCGB.EDEBAAIBOCABhABAGEBAMAIBhACACCHAFDEB..UEGA..hACAfFDBbFBB.IGGAgGFGhBFASGAD..hAGA...,1,-8,-16,8
UWHZVISgdKDPAQLYcaOGMFNRbECTJeBXf,LAAAaAAAGACAMAEARAEA...EAHFTCFAeBCABBFA.XCAChABAfDHAHDDAhACAZEAASCGAhCBAdAHADBBBAEEAQFFCOEGDFFDHCFFC.WFHHIHHAhAEA.....hDDA...,2,-7,-3,4
TgGFReCQBPWcMKSNadHYVEDXUbOZLJfIA,GAAARAAAeADEBAGB..PADAMAIBKBDAaAGDHCDA.ECHFXCCChAAAODBDZEFALCGBhABAIGEAADFATFEAhCAACGBDQGGC.WFCHSEEChDAA.dGHA.DIEA..hDBA...,1,6,-19,25
cgLXQGBfOENRVaIJSDKPCdbMFeWZTAHUY,HAAAUAAA...gADBLADAGAGAOAFA.RCBA..aCFHSBFHhAAAKEAA.dCADhACAbECDeBHF.ZDCBAAEAXEEChAIAQEEAEFGAIFHADGIBMIBA.hCDA......hDIA...,2,-9,-7,2
VdGSQOeIBHRgKUTZNcLPCaADMXbYFfWEJ,MAAAXAAAFADD...EADAdAFAGAFAQCBCeAHBHCDBRBGFKDEAZEDAhAHALDAB.aDCBhAAAAAIBDDIBbDGD..fFDEhABAVFBBOFGDBFFC......hADA......hAIA...,2,-15,5,20
dRDaYecgfHNAbVPTIQMGUKFXJLCBEWOSZ,VAAATAAA..MADAGACA.FAEALAHBEAHB.SBDAhAAARCEAaCAC.eBFHfDHAhAAAHDDBABHBbEBBQEBChACAXFGABEEDOGECdFGDDGEB..hAIA......hBEA...,1,1,-6,7
JSNfVEeDQIRUdgWCTZcFXLOHMBPKbaGAY,SAAAVAAA.EADAeADE.QAGCRAFAdCCACCFD.ZCDAXCGDhAAAHDGBMEBA.KFCAhAAAGDAAACIBJFFFDIAAgEDAhABA.TFGA.FGFHBHHAaGAH.hADA......hAGA...,2,-11,-6,5
JHSKBFQbDIcOVgYefNEMXALUPdTGRZaWC,LAAAdAAARADAZABB.aADD..CAGBHCEABAFAQBGADAIB.OCABhABAVDCB..eDHFhAEAECCBAAHAUGCBGCEA.hBAASEGAFFFB.bFAAIHHAgGGAhACA.....hCDA...,1,-2,-16,14
AFLJHMZRVEBNDgfKPGcYXSTUIbaQOWCed,LAAAHAAARADFEAFEDAEAKBHBGAGA..XCAATBDAUCAAhABAaCFB.QDDBhACACDDD.AAIBMDGBZDFBBEHAhAAAfEHAPHAASGHBbFBBeFFD.dHEBhACA......hADA...,1,5,-10,15
CRWNXgcOaDFLMdQJeYGTKPVSfbBZUIEAH,HAAARAAA.XADBOADAaAGDLAGB.dCADeBDFGCEATCEAhAAAKDCBSCHHhAAABCHAZEEAEGBAAAIBCBFB.gGFAhACAFGEAMCCB.........hABA......hAIA...,1,0,-19,19
LeNKSFOCcVQYIZaHTUAgXPfWGMbJRdDBE,XAAA..fAAAGADAMAFARADAdAGAEBFEeBCB.SBHHhAAACBHBQDAAhAAAZDABHCEBAADBPDFAbEGDBGDAhACALEFA.FGGA.ODDH..hABA......hCAA...,1,-5,-7,2
WMLGZYHecgKdaFCPDINURfETVJOBSQbAX,MAAAZAAAHAEA.eAHHKADAaAFACCAA..DACAUBGBRCCA...EBBBTDFAhABAOCEBBEEDQDGDhAIAAAGALFHB.hBAAGGCBgFCB.dFFD.FGHD..hBCA......hCAA...,2,-18,-9,9
ZVXcSNfHeRETQDUdGFYLJOKIMaBPWgCbA,ZAAAXAAASACEHADARAGF..EAFATCEAQBGA.dCCDhABAGDAALDFBKDCAaCHDhAAABEEAgEGGhABAAEHAcFAAeFHBFFFH........hAFA......hAIA...,2,-17,4,21
WFZBGVeTdOKLJAXUYSbQCNEDRPHMcfIag,XAAASAAA.QADAEADA.RAFAHCCAMAGB..fAHAhAAAaCGDFDABGEEAhAAAeBEFdDAALGAAACDBbDEDDCIBhABAIGHAZGEEBDGA.OHAA..hADA......hAHA...,2,-9,3,12
KTHYbJLdIFaWfPMXCVOUQEGRBScDZNgeA,HAAAJAAALADBdADAaAFA......fBFAMAFACBFAOBGDhBAAEBHFRCAABDED.DDGBhAAAZDCAeDHFABIBTFBAhBFAbFBAFFFHXEFD.......hACA......hAIA...,1,-8,-30,22
UDOMePTJVNfaIFgdLSRHbXCGcYBEWKZQA,OAAAeAAA..TADAVADA...aAFAFAGAdBGDRCCBHCEC.CBBDGEGAhBAABCCAECEFZFEBAAAAMDGBhAIA.JDHBfHCFhCAALFEBSGHH...hCHA......hCIA...,1,-12,-16,4
eOMQXBcCDZPYTLEfAFKVgUGdSHIaWJbNR,KAAAUAAAdACAHADA.aAFAJAEA..RCBA.eAHHMAIBBBED..DCFAhADAZCDE..TDEAhBAAEDHFAEEA.FDHHGEFASFGDhBCA.IGDANHABOFHD....hAAA......hAHA...,2,-32,-9,23
FNBMGfLVbYJgXCQcZADaPdHeKTOUREISW,aAAAHAAA.eACEOACDEAFE...SAEAFBHDMCCAGCFAhAAALAHBbDDBgBFAhAEA.QECAhAFAAAHAdFHA.TEFA.IGHABHGD.fHEBhBAA.YBBFhCAA,1,-4,-14,10
eCIKEONLFDXWcJMYdTUSaVbfAZBPHRQGg,ZAAAHAAARAEAGCAAeACEKAFC.EAHFLAHB.XCCAJCCAdCFATEGAhAAAaCFD..bEFAhABAACIBQGGBhCAA.CEEDOHDCDACAMFAB.SFDBhAFA.BGGA.IHCAhCAA.,2,-14,-4,10
fbFTOIDHUeSgQWGLRaXdVPcBZMCNJEYKA,FAAATAAADADAHAEC.UCCAeACE.QAFCGCGAREDAdDBCPBDBhAAAZGDA...MAIBhAHACAHB.ECGFACIB.ODFHhCAA.SEGH.WCCD.aFHD.hBAA......hBDA...,2,-24,0,24
agAGQRWBEVLZXedSFOMNPITJbKUHYcDCf,RAAAEAAAZADBdADAFAFD..MAFA....IAHAbBED.HCFChAAADBCBaBGAACCAGDAABCGALDDDhAAAeEEB.ODBBhBDATGGAKDHBUEGBCFFAfFHE.hABAgGCG.hADA...,2,-12,-10,2
LXFQEOBCIaWeGRNUKfbcVgJTZDAdHPYMS,HAAAMAAALAEAQADCEBBACAFB..aAGDeAHHRCAA.KCDA..bCEDhAAAVDFB..TDGAhACAAAFAdFCASDCGhBAAOEDHBFHAIGHANIABfGGE...hBBA......hCAA...,1,5,-20,25
fMdAVTOINDRJGBgECQcUKHeZYXbaFSPLW,TAAAOAAADAEA.GAGAEACE..QAECKBBDHBEBeCDDhAIAZAGBbCCCFDBDLEEAhAAA.MBIBADIBIFFAhBAARGAABFHACGEAUGBAaGGC.SFHB.fGEEhBDA..hBEA...,1,7,-18,25
HAJLYGNVKcICXMdPeZaFDRQOEbTSUWfBg,LAAAGAAAKADACAEAdAGAeAFEZCAA..aBFDRCEB...ECDASBHHhABAUEEABCHAHEAAAAAB.hACANEEA...IEHAhADAMFGBDCCAbGFA.fDCEgGBAYHCAhAIA....hBCA...,1,-11,-20,9
DeISLbMCKGUFJZPYfcHBATVaQXNEgWROd,aAAAQAAA.EACARACFdAEA.eAGBLAFAMAIBGCFAhAHAFBDDZCEBfCGAhAAAHEDBABBB.TEGANEIA.OGAAhAGASHFAKGGD.......hAHA......hCAA...,1,-8,-12,4
BgKTFRWEULNdQAIMGbOHPZYCcafVSDJeX,GAAAHAAAZADBCADA.aAFD..SAEHeAHBBCADKAGARCGB.UCGAdCCCADFBhAAAMCDB..bEFDODAHhAAA..cFBAhACADEEBXFED.TGAAEEEBNIAB.QGGChACA...hADA...,2,-13,-8,5
aYKZGJPAEgCTVDbIedOSFUBfLXHMRWcQN,EAAATAAADADA...eACEdAGAFBCABAFBLBFDHAGBRCCA..QDFDhAAAaBHDZDDF.GFCBhAIAACCBCEHA.bGFA.SDBDhBDAXFFDMIAANIBB......hAAA......hAIA...,2,-34,14,48
SJUEMcKWeIADZHGOCLXdVaYQPTfFBbgNR,HAAAGAAALADBdADAaAFA.QAFA.TDEABBFAbCEAhAAARDGFSBHBEDDB.hACAMCABKEGDeDBHACCAZFABXFCAhAAAPFEDFGHBgGGANAIA..hACAcFBD...hAFA...,1,5,-3,8
YLgWbOSQNBdTCIXJAZEaDRFUMKVPHcGef,EAAARAAAMADAKACA..HAEBeAFALAGB..bBDDQCCChAAABBHAdDCCCCGDXDGAhAEA.AAIBaEEBFDHDPEFDhAAAGGBBfFFB.YHFGhBGAOFDDSHGAhABA...,1,12,-26,38
HWbVUBXLOePRfcINKaEZYJMgFGASQDTdC,QAAAdAAAHADAVBGBBACA.LAEA.eAHHRCAAfCEAhACAICDA.aAGAECFBZEFAhADAMDIBGFABAAFATEEAhAAAbGEA.OEGD.cGCA...hAFA......hBAA...,2,-7,2,9
VAJQMdHXFTGLNfDOUBeICSbRZYWEacPKg,MAAAHAAATAEAGACBLAGBDACABAGBeAHHSBBDZCCAEDGBaCCDhAFA.KDFDADIB..dECAFDHDhAIAOEEBCEDARGCA...hBAAcFGCgFGG......hBIA......hCAA...,2,-10,-9,1
IPHZQTKBdSYGRNVaMEecDXAFCWgObJLUf,CAAAOAAALACAUAEA....IAGAHAGDZBCBQCCAhAAATDFAdFDAGCEBRFFAaBBH.hAIAEDABDCIBAAIBFEFH.bEGDhADA...JFCB........hAEA......hCAA...,1,-12,-16,4
faPebWOKXDTHUgFSLQCAVBYNdJEMcGZIR,BAAAdAAAEADAGACAZABB.RAEA...aAFDeAHHOAHBDCABHCFB.hAIAFCBHLDDAADIB.hAAAVEGBJEDBMFAB.hBAA.fECEbFFAKHFA.XFDD.hACA......hAEA...,1,-11,-14,3
aMFHfULbYVOQEZJgRSCXTNABIWKGdePDc,BAAAKAAAeACEDACA..MAFAHAFB.LAHB.VBCBEBCAZBEBhAAAREEACEHB.TBGA.ACBBGDFAhBCAdFAAaFDHfGGAhAAAbECD.OHBCJFHB.....hBIA......hCAA...,2,-26,0,26
eEUGXOfWMIJDZATaRSLFNgKQHbPcCdBYV,RAAALAAAFADA.KAEAHAFB...bCCBCAGBdCAA.BBHAeAHBECCAhABAGDGA.fEEAhAAAMCFBDCGBADEBaGEDSDGHhACA.QGGA..hAEA......hAIA...,1,-10,-40,30
CBNOZTPKERYfQeFJSIaHVGLWUdAgbMDXc,MAAAXAAABADAZACBKAFA..RAEA..QCEBeAHHFBBB.SAHBhAAAHCDAGEFALDHBhABAdFAAACFADDCBCEEDTFAAhAFAEDHF.JGEAaFEBWHCG......hCAA......hCBA...,2,-16,-12,4
ALFaVQXeUYHIdbKOCfBEcMDPGgJTSZNWR,aAAAQAAA.eACAHACBdAGAbAEACBEABCDDECEA..MAIBGDAAhAAATDFAZDEBRDGBAAEALFFAhAGAXGBDIHHAhADAfHDB.DBBB.PHFASGFHhAIA......hBGA...,1,5,-10,15
dbaLKBWICXTGgHRcOAEeUfVFNMJDQYSPZ,EAAAeAAAUADAFADD..MAFAQAFA..SBEHhAAAdBCCaBHDLDEBBBGACCCDGDEBhABAHGECOHBCABIBfFFEhBGAJDGFDFIB.PFHB.KHDA...hAAA......hAIA...,1,-11,-19,8
egScbOJWaGXEMfUCHYAQFZBVLDKRINdTP,ZAAALAAARAEAdAHA.eADH..SCAAOAFAaBEDECEB.MACAhABACBGDHCAB.ABIBQDFAhABABCGDKDDD.TGGAhACAgDGAJEEF.XFFC.fGHAhCAA...hCAA...,2,-20,-14,6
dDTIGLSfNPeRJQaKYZOCAMHbWFgXVcEUB,HAAAFAAA.XADBEADAdAGADAIBGAFA.LAHBSBDAfCAEhAAAeCCB.RCCBaEFChACAZDAFADGAMEIB.bFBAgDGAhADA.cEDDBGGAIHBAhBFA..PFHDhBAAKHEA...,1,24,-33,57
YaZGLVWfQeMAEgSKDJXTIORPNcCUHbdBF,EAAAKAAADACA..TACARADA.....PAEACAGBHCCAdBHAFBHDhAAAZCCAGCFALCFBhAAAVFCAQECAhAIA.AEHASFGAIFHANIAB.....hAIA......hCAA...,1,-8,-28,20
EAUTDfHcOMCWQLNKXgBFGVIJdbeSZYPaR,TAAAHAAAMACA.QAFALACBXAEAFBDDGCEAIAHAhAAAbDGB.ZCEAaCCHAAEADCIBhCAAOFHDCEEA.KAHBBEGDhCCA.dFCASGFHPFHD....hAAA......hCAA...,2,-12,-2,10
aMfFZJeAGUOSTYINXDHcPdBLVCKgbQERW,GAAASAAA..TADA.IAGADADAHAEC.dAHALCDAhAAAKBCAbCEDRDGBaAHDMDDBhAAAZDEEADABUGGBODHDhACAXGDABFAACFCA.EFFB.FHGE....hADA......hAFA...,1,-7,-9,2
cgVYHPBJZASCMfRENWXaTDFLeIKGUdQbO,MAAAEAAA...XACAaACDFAEALAHB.eBDHGAFAhAFAdCFAQEGAhAAAbCCCOAHFgEEBhAHAHFDABCBDABHBfDHE.RFBAWFHDDIFA..hBAA......hBBA...,2,-13,-7,6
AEeRUZVBPOQYSHdfCJNaFDgMWGKLIcbXT,RAAAZAAABADBQAEAHAEBdAGBCAGA...aBGDDACA.MAIBGCCALCEAhABA..bEFAACCBEDDBhCAAeFEBUEGA.OFEDhCBAfGGA.......hDAA......hDBA...,1,-13,-21,8
LXUWTQcegZEDOSGJRFHdIYMCKVfBANPab,aAAALAAA.XADDTADA..eAFEEAFADAIBGBFA.RCCBHDABhADAdCAAMBHBKDHBBBBDhAIAACCB.bFCAQDDAhABAgGGAZFAASHCAFEGHCGHANIDB...hACA......hAFA...,1,13,-13,26
KAOHgMRSNZPDXQbYJGFUVCEeTaWLdcBfI,HAAARAAAZADBDAGAQADC.JAFAGBFAFCAHUCFAEBHB..eCCDhAAAaCCCLDHBdDAABEEAKEHBhABAAEEBMFDB.SFFBhAAAXFBD.YHFGTGGA..fHEBhADA...hACA...,2,-12,-11,1
AOZIXWgaJTUdKQVRbHCYENcPSBLMGeFDf,ZAAAXAAAaACA.UADAdAFAKAHB..RAFAHCFCECCB...PDBAhAAALCEAGEEAeDHFhABADEIBAEEAOEFD.hABAIFBAgGAAJHAA......hAGA......hAIA...,2,-19,-14,5
LOCQTWNFPGAVEfbBMcaKXDSYeRdHUZIJg,EAAABAAA.aACADADA.eAEAHAEBZBCA..IAGALBHBQCBAhAAATDBA.FBHDACGAVEDAhAAAMDGBKEDA.SEHBhAIARGEA.dHFB......hBCA......hBDA...,1,-17,-20,3
VgASGXZPfIdYTHEJWQKDOCFNUeabMcBLR,GAAAZAAA..fADBdADAHAFAECEFQAFCOCGDFEFHeAHHhABAaDBDMCAB.LDDAhACARGDEAAABSDDDhACAXECCIHAATEGAKFFDCFADNCIA.....hAFA......hAHA...,2,-3,-2,1
BaDETHUKOMfJFQIACeNcGdRZbVSgXPWLY,eAAAGAAARADAZAGBSADA..XCCCLAGBBCFCEBFFHCDBhAAAOCHDMAIBFEABAAAAhAEACDCCdEGA.bEACgEEAhAGAYFFFDEIBTGGA.....hACA......hADA...,2,-19,1,20
XZJeTNUYcSRdaFMQBCIfVLPAODGbHWgKE,GAAAHAAAKADCEADAZAFBeAFAUCAB..SBGARCGFdDDA.aCDAMEIBhAAAQDDCBAHACBEA.hACAfDGALFFBAHHBhCDAbFFA.XGAA.TGDA.YDAFhAAA.FHFE.hCIA...,1,21,-20,41
VcJHUXDNdEOYMAeCPbBZRGKfTFagSIWQL,eAAACAAABACARADAGAGA.KCCATAEA.FAGAaCED..SCAAhAAAQEAALCEAhACAVEFB.HDCADDIBEGABhAAAMCIBAAIB.ZEAFfGDAgEFAIHHAhABAcGCA....hAEA...,2,-14,-14,0
EfGRBCIeHDUOAKYQNPcVTLMJZXWbgFaSd,QAAA..cAAATACAMACAZAEB..XAGAhAAA..bADAaCFDEAHBRDGFCDDDhAEAHCDAOECBACHBKDCDPFFBhAHALEFA.gFCASHCAGGEBhAIABHHA.DIDA..hBAA...,1,5,-13,18
RPUTOeLQVHBZMdYAEfcKDGagNCXIbSJWF,EAAAKAAAGACA..aACDCAEA...bADDSAFH.FAHBhAAARAFATCGAeCABLDFAhACAHEEAZFAAdFFAACBBDEIBhAAAXEDDIGGAWEAD.....OHDChAEABGEDMIAA.hCBA...,1,-4,-20,16
FcdYLeDbJGKABZOaNWQPTSIgERCVXHMfU,ZAAAaAAA.QAEA..TADASAGAEAFERCCB.XCAAhABAHCEAMAIBFCGDdDDAeDABhADAbDEDGEFAAACA.OEHFhAHAPEABCBBDfGCAcGFDLFHBhAEA.KHAABHEA..hBAA...,1,12,-2,14
KYfdPHZcLFbIGNQVeCBTDSaJMRgWAUXEO,EAAAKAAAdACAHACAZADBLAFB.FAHBGAFAQCCBeAHBTEEAhAAAaCHDREAA..AEAAOEEBhAAA..fDHEhAIAbFGB.IFBACHDDDGGB.MFDB.hAEAgGGA.hCAA...,1,0,-20,20
UJTVBWCaOfeFREHLDPZbKdIgSAXMGNQcY,GAAAQAAAUADAJACEBAFA..aAFDeAGH.ECHFHBGBLDDBhAAAZCDFdEGD.SAHBhAAAAAIBMDFB.cFBAhBFATGFA.CEHAODBDFGGADDDB.....hCAA......hDAA...,2,-14,-14,0
UVCDLNIWHebROaQTXZcSBdgAfEJFPYMKG,EAAAFAAAMADAGACA.CAEA.LAHB..IAGAHBCARBFFaDEHhBAATCEAZEBBBEGA.hAAAABEA.fBHAhAEAJFHB.KCBDDGGBeDHFOHBEQEEB.hBHASFHH.hCAAdGCA..,1,-3,-14,11
LEDVbXRUfGgdCWOSTPJNAIYBFeQKHaMcZ,BAAAeAAAHADAaACAZAEBEAGE.DCCB..XAGARCFAGDCA.dEEAOBCBhAAATFAA.JEHBACGAFDDHhAHAKGFB.MDBB.LDGBhBDA.bFED.....fGHAhCAACHED...hAAA...,2,-17,-7,10
PTcSAHRFVfWbGQUKCdDXEgBMJZOLaNYIe,HAAARAAAFADA.VAEA....bAFDGCABKAHB.dAHADCCAEDEABDDAhAAAZDGBaEAB..IEFAhABAeECFTGEA.hAHAAACA.QFCACEFAMEIB.LFHB.hAAA......hAEA...,1,6,-29,35
ISHBLXKedATCDYPaZJgWcVfbGNOREFMQU,TAAADAAA..aABEZACB..JAEA..gAEA.VBGBhAAAGBCB.RCFAEDDBhAHAMCABQEGAhAIASDEBHFEBLFGB.eEEDABIBCHHA.PFAChACA.fHABhAFA.NEIA,1,-13,-28,15
eYJTHaZGIANBfEQbWDdgORCKScVMLFXUP,BAAAEAAA.QACADADAdAGARBCA.KAEA..SBHHMAHBLCABhAAAFCBH.XCCChACAeDEBTEGAHCFBGFCBhAGAABFA.fFHAbFDDgGGACHFA..hAAA......hAIA...,1,-1,-23,22
JNMIeWfOdbSGCUcVBgZHYFEXKARPTLQDa,RAAATAAALADB.QAFAaACA.MAIBeAEH.OAGBhAAAdCCCGDFACAHBVDBAZFAAHCGBhBDAEFDEAAAADEFB.IGGAhCAAfFHASFDHBHBAFHDE...hCCA......hCDA...,1,3,-12,15
UGFYbAPgDLWTQSdVJZMHNIaeBfCKEXRcO,DAAATAAAdADAZAEB.HAGBaACABAFA.KAHBRBBBODBHGCCAFCFAhAAAAAIBLEEA.QGBAhBAASDBDMEIBhBBAeDHF.EEFBXGDAcFAC..bFDDgGGDhBDAWFHH..hBGA...,2,-12,-8,4
BVYbLMOWZceQJSUDXIGFHKfRgPdaTCAEN,EAAABAAA...VACAbACA.LAFB..MAGBZBGBeCABhAAAQCCAUEDADCCBGCGAhAAAHFFBRDABdFDA.aAHFhADAAAHAODHDcFFCSHBG..hAEA......hBHA...,1,-7,-17,10
MEfKcXASgbHIdORVJQPWFGaCTYLeZBNUD,SAAAHAAAdADARAFAQCABFADAGAFACAHALCFA.eDDBhAAAZBAEBCDADEHB.ECHFKFAAhACAAAAA.bFEDODED.hAFAPEHDaGGC.TGFA...YHAAhAHAMIAA....hDBA...,2,-25,8,33
cXFQDLTPVEJWYAaSfNBHeCbUZKMgIGdRO,aAAASAAABADAHAEBeACH..CAGAZCCFMAEAGCGARBDF.OBBHhADAFAHDLBFB.hAGATEGAEEEEJGDAAAAAbFDBhCAA.KGGDIHHA......hAIA......hBAA...,2,-19,-10,9
GHWdZVPDbCaYgETLXSMIBNeKcRfFOAJUQ,QAAAHAAAZADBDAGAaACEEBFA..LAFAMBIBBCADeCDARDAA.OCGDhAAAACCA.GDAAhADAdDFAVFBAbECBCEFD.TGGAhAGASEHD.KGGDcGDDFHDE...hAAA......hACA...,1,12,-10,22
PVaTeQSYBWcMdJARHOLNbEXDUgGFIKZfC,HAAALAAAEADEDAFAGADAKAHB.ZAFA.CCAA.aBEEeCCB..QCABhAAABCFAMCHBACHBRDCAOEFBhABAXDGAFGAAIGGAhACAfFDA.TFFASGED.hACAWHAAdHFD....hAGA...,1,1,-21,22
QePGYNdaTUSAfWXHMZgFIcLBEKODRbVJC,XAAAHAAAZADBFAFDLADAEAHB..DCABRAGFJCDA..eCCDGEAAhAAAdDGAaDADSCHHhABAADIBMEEB.IEEAhAEABFFDOFHDbFGB.CHCA.QGEA.NDDA.hAFA......hAIA...,1,-5,-12,7
FCWSVGZBfOURINAHcQaLMTEbXYPJDdegK,HAAAaAAALADAEADE..bAFB..XAGDJAHBdCAD.eBBBFCEBSDCHhAAAZCFAODCDREABhAEAADIBMEFBTEEADEGBCEGB.hAFA....WEGHBFHA.fGGEhAIA.NIBB....hACA...,2,-19,4,23
PdDFbWBUgRVIeSETYcLZJaOMXKfQNCGAH,HAAAdAAAFADABADBRAFF.eAEH.EAGATCBALCAAZCGB..aDEBMBIBhAAA.KCFAQFEDhACAGEEAAEEBDEHB.bGAAhACAWDHH..........hAHA......hAIA...,1,-3,-30,27
KQWOFLPVJdZIbcCSYTfUaEReMNXHABgDG,DAAAGAAAQACAFADALAGB.JCDBZAEB.bAGD..SCFDhAAATEBA.aCHDREEAeEHHhAIA.MBBBHFFAhACAABGBKHEAODBD.dGBDCCCD.YHFG.hBAA......hBEA...,2,-12,-6,6
ZBVOKIXLGcfDePUYEHaRgFTJWACSMNQbd,MAAAQAAAZABEBAFAKACALAEBGAGADCCAeAGB.UDGBHCDChAFARDCBFFEDTEFA.AAIBCFHAhBAASAHB.hCAAdGGAOEEH.IHHAfGCE.hDAA......hDBA...,2,-21,-10,11
RfeGNYEgXMTFPVWHIbcaJUSQKLOCAZDdB,dAAARAAAeADEGADA.EAFAMAHB.FBDDVBGBHCEB...bEGDaCAEhACA.SDBAhADALGAAAAAAZEFABGFC.YCCFhAGATFAAIFDA.cGEBhAFA......hAIA...,2,-15,-8,7
dfIBaKLDSUXceTHVOFRQNGbCMZWAEPgJY,EAAAJAAA.dADABADBLAFA.DBCBXAED..eCEAHAGDhAGAFCHDRCCBGEFAMDBBAAGA.hAAAPDHD..fDDEhBDAaFDD.SEGD.TFCAhCAA.OFEDhCBANIABCHHA...,2,-25,-17,8
gGATPJKfDOBZMHaWbIcYRQdCVNSEXeFLU,TAAAKAAAOACA.ZAFBHACB.aAEA..IBHARAGFdBEACCADSCHHhAAAEBCF.eDFFhACALCEDUGGAAEEBfDGAhAAAMIAA.bFBB.QFGAhAIA.NIDB.....hBFA...,1,0,-27,27
FTaOWZHBGCdRQMgEDKIPbfVUSJcNXYAeL,eAAATAAAOADC.HAGBGACARCCAMDGBEAEAKAGA..bEEDfCAEhAAA.SCEAhACAcFAAXFCBhAAAACHAaDFEZEAACGAD.dFFADDIBIHHA..hAEA......hAIA...,1,-3,-12,9
YAdeEfPOZWTgDQUJaLVcGBCbFRSNMHKXI,EAAAOAAAZACB...TADAQAEA.aAGELAFBGCGACCBChAAARCCBMAHBHDEBXECBhAHAAAIBeCHH..fEFAhBAAgGGADBBB.UFCB.cGGAhCAAFGDD......hCCA...,1,8,-18,26
CbONVWYSFBfHDURPMTAGKZXgEIJceadQL,ZAAAEAAA.JADAeACA.dAGALAGB.OCABVCCASBHHhAAA.BBFCHCCChABARDABMDGBAAIBGEFAXFEDhADAgFCAaHFE.CEHA.NEIA.....hAIA......hCAA...,2,-22,-10,12
IbJRFBHNdTgcDWOfLMYXVKCUZePQAEaGS,EAAAGAAA.SADAIADA.RAFFHCDBdAFA..TCBADAIBfCHEhAAAMAHB.XEAAhACACDEAeCHHAAIBbEGDBECAhAAA.gFBGOFDBLFFDKEFBPFHDhBCAaHAA.....hADA...,2,-11,2,13
cTfQZACYRbJEHIBKWPFLGVDOSMNUgdXae,RAAAEAAAHADBKACA.FAFAGAEADAIB...MAHBUDAAdCCAeCGB..hAAATEAAZDDAADIBCFDAbDFDBFFDhABA..LEHBhAAASFHHXGAAaHCA.fEDAhAEA.YHFA.hADA...,2,-23,1,24
ILbfcdJROeAGaVPXHNUZKgDYMQSWFBCET,aAAAXAAAHACBZAEADADA...MAFAQAFAFCEDBCGDEBDBLEGBhBAA..bCEDdGFChBBARDGBAAAA.GEBANBIA.hCAAKAHB.SGDA.CDDDfGGEhBEA....hCAA...,2,-16,-12,4
LEMfCcBDKaZFORYGPHQbdJVWTXNeAUSgI,SAAALAAAEAEAMADA..CAGADAIBZAEERBCBGCAAHCEBdCGBJCCA.hABATEGA.eHDAhAAAACABICGABHHA.aDGEhACA...OEEB.QFGAhAEA.bFCD....hCFA...,1,-10,-19,9
WIPdVEZOgKJQDHTAMNCBafULFGYcbRSeX,MAAABAAAaACALAEAGAEA....bBBBRAGBeBCB.XDBDhAAAICFA.dCHAEDGBhAGAZDCBKEEDQEEAhAFAHGFAAAIB.fFHA.FGABSEHHhBDAPHDA....hCAA...,1,-3,-12,9
WVgXbCNDHadAPfeMGZRFBTIcLQYOEKUSJ,eAAAZAAARAEABAHB..TADALCABQAFCECCB.SAHBhAAAVCFA.bCCCDADAhABAHCGBACEB.MEEBGEEAhACAFFFBIGHAOEHD......hABA......hCAA...,1,-9,-19,10
RYUJOSCVFAQBfHNLDGEeXMcdWKbTagIPZ,QAAAHAAALADBEACA.eAFA.MBIBdAFAbAGDaCAC..ICFAhAAARBDBUEFAODDHhAAA.CEHAAAIBfDGAhACA.GEEAXFBDKFAA.....hAFA......hAGA...,2,-8,-8,0
JfSdWTDLBPCZGRUMXKgIFbaVQcAeHYEON,HAAAEAAA.OACAJACB.dAGADAEALBFDBAGAZBDBRCCBMAIB.KDHDhAAAFBHD..aECHQDFChAAAAFFAeFHF..fGDAhCAATFCACEHAXGGA...hCCA......hCEA...,1,-7,-35,28
XIEgWedQbACKTVYJMDBLUZRfGacSONPHF,TAAAVAAA..MADALACB.RAEAaAHDOAFE.HBDAXCEAhAAAECGAeDDBdDHAAAEAKDFDhAAADECAZFGBGFEBSGFFhAIAFHAAIHEA.WECACDHA.BHHAhAHA......hCAA...,2,-7,-4,3
ZceFADEVbBPOfdSRJTGQUCNKHaLgWIXMY,EAAABAAA.OACAdADARAFAGCBAUAGA.KCHBHBCALDDB..hAAAgDEAXDFCZFAFhAFAeCBBABCADFGA..hAGAbDGDSGDATGBACFDDaGFCIGGAMIDA.hAAA......hBCA...,1,-3,-16,13
BLFgaNIbcSOXeYWPfKRMZDJGCdVEAHUTQ,HAAATAAALADB.aAFAbACB.OAECeAHH...PBHDhAAARCEFZEFBGFBB.hAGAdCADAAHAQCEAhCAAFEHDIHHAXECA.fEHEhCCAMIDACBFB.EFFB.BGDD.hAAA...,1,2,-2,4
OFJZSaVIAHXgBGYcMLdefTDQNPWbKUREC,HAAABAAAGACAMACAeAEADAEA..QAGAPAHD.KBFDECCAFCABhAAAZCEB..aDFDADEBXDGChAAA.gFGAhCAALDHBdEBAfHDBWEDH...hACA......hBCA...,1,0,-27,27
bPQWFOTIJYDLGdegUVaNEXMHcfZSRAKCB,BAAAQAAAOACAJACELAGB.eBCBVAFA..EBEAHCDAhAAAZDBFAAIBbDFA.FDCHTEDAhAAADFFAdGGA.aFCEMCIBhBDA.SEHDCHDA.IGFAhCAA......hCBA...,2,-23,-7,16
AQBFeGgHCbVOWLUcDZTRfIXKYSEMNPdaJ,QAAAeAAAHADACAGBOACCLCCA.DAIBRAFFXCDCKCGA.hAAAEBHFMEEAdEAAAAHAGFABhABAVEEA.UFFA..hAFAcECC.fFHASEHHaHEA.hCAABDHA....hAAA...,2,-14,-7,7
dDINOKCWSYbMFfPJcVRaTgZEUGAHXeQLB,HAAAeAAALAEAdADADAFAOAHDCBCA..SAHHMBFB.FCDDhAAAfCAEJCFB.hABARDDBaBGBZDGBEFAA.AAFAQFCAhCAABCCDKDGAbFGBcGFC...hAAA......hACA...,2,-19,-9,10
SJVFHPWBDdaMIXGcYfLOgUKNZReQTbEAC,SAAAFAAAHACBBAEAdADA.MAGBGAFA...fAHEhAAALAHBOCEDKCCDRDEBeDBDhABAbEAAABHBCDHA..PEDBhAFAaEFD..IEHAXGGA....hAIA......hBDA...,1,-10,-21,11
bMYSQIOcdKVBgUHWLJZXNAEafFRTCPeGD,EAAAaAAA.RACA...TADAeAFEGBEB.MCCBQAFChADA.OAHDdDAABDDAhAAAHCCALDFAZDFBABBBCEEAbEGDhAHASFFA.KGHB.....hBAA......hCAA...,1,-12,-15,3
MYNHgGAdOKSIVPJTaXeEbLcDCQZURFfBW,dAAASAAA..IADAVADA.TAFAeAGHECCB.LDABhAAACAHBZCAERCEBBCGAhACAMAIBHDFCACIBKECAaEGDbEDDQFGBhABA..fFAAhAFA.YFHBgGAAhADA..,2,-37,15,52
KZbPYeEMGAQIdJUcBXWNHaDgFTSLfORCV,dAAAUAAABADA..XADAHAEBaAGAFAGALBGB.RCAAKDEDhACAbBFD...eDHHECDBAADAhBAAQGDA.hBCAIHHAcECADCIBSFFBCFFAPFHB.hADAMHCA...WHDAhCEA..,1,-16,-21,5
EaHYMFcUNKQRdPbSIgBTAZWOGLJXfCeVD,ZAAAGAAALADBJADA.CAFA.eAGHDAHBHCABMAIB...FCFBUCDAhAAAQDGARDGBdFDASDBHhACABEEDAAIB.XFFDhAGAEFABaFGC..NICB........hBAA......hBCA...,2,-18,-15,3
FbEMIKCeNTBZaAXRSLQfGPUJVWOHcYdgD,RAAALAAAGADAUAGAVAEA.HDAA.dDFAFBHD.ECAAMDHB.CAFD.hAAAeCDBBCCDAAHAQDFChABAJFEF.OEAAhACAgGGAbFEANEIA........hABA......hADA...,2,-16,-5,11
NPIaAVRBTEULCHYQSDfWZXKgeFGOdMcJb,RAAAEAAALADBHACAQAFCDAFAZAFE.KBHBeCCDGCCB.dEAAMCGBhAAAJDGB...bDGDIFEAhAAA.AAHABFHAhAEATFDACHHA.SCHB....hABA......hCAA...,2,-25,-6,19
TWOJFfQBERVLGAbIaMYZcSHeXKdUPgNDC,aAAAZAAAHAEA.eAHHdADAUAFA..gCAACAHAOBBBFCHDhBAAQCEB.REAAGEEBhABAADDAMDFBSDBHhBDAKGADDACAJHEABDDDEEGBLGDA.IHHAhBFA...hAGA...,2,-23,2,25
SdBeKCJXUIRLagNFcfTVOPbQHEGDYWMAZ,dAAAeAAACADA.UAEARAEF.LAHB..aAGAFBCD..TBGAhACAODEBQCBAhADAHDFBEEBAGGBBDDGBMDIBAAAABBGBhBEAXDDDIGHAgGGBNIEB.fHEBhBAA..hBCA...,2,-29,0,29
LRANYEMCcdDZWeBJQXOHSgaVTKUGPIbFf,EAAAMAAAdADAZABEBAFA..QAFAHAGBaBCB.TCCAGCEA.hAFA.bCEDLDDDhAAA.AAIBCDHADAIBeFABODGFhBAASFHBKECDIGDAfGFAYFHBhBHA.....hAFA...,2,-14,-7,7
PBYeVLgGcICOENTHQbZKfRFSDAaJMUXWd,aAAAMAAA.UAEAdADABAFA..eAHBLAHBGBBACBBDEBGFHCGBhAIA.ZDEBRCEB.DDEBADBA.XGBAhBAA.PFHDhBBAgDBA.OEEH.TGFAhAFAKGFBSEBD.hBAA...,2,-33,2,35
YLGcZVIfQDeWgOMHaTCNAXRKUPJFEdbSB,RAAAKAAAUADAFACA..dAFABAFAGBGAZAGB.....VCCAQDDAhAAADAIB.eCHHOEFBhAAAHFEC.aFHDTFBAhAHAACCBXGCC..EGGA.SGEDhBFA.....hABA...,2,-21,-20,1
aRCUSWQbONDKJgIfLBeMVPXcGAYZEFHTd,EAAAHAAAdADARADFCAFB..SAFAQBGAOAHDKCAD..IDFAhAAALBCD.eCFBhAAAMCCBXDDDAAHAZEEAaEHFhACAbDGDDDDBJFAABGGDcGAC...GGCBhAFA.....hADA...,1,8,-18,26
gVIOeDXdENLacUGRPKFHSQMBYbTAWfJCZ,JAAAZAAA..VAEAeADE.dAGAEBHFLCCA.UDGARCAAFCEHHEBAhAIAMDGBBBDA..bEAAhABAABIBCEEB..ODHDhACAXGEAaFFH..PHAA.KHGA...hBAA......hCAA...,2,-26,-2,24
gcXCVYaSZHMAIOLFTEJUfbKNQGDePRWBd,LAAAEAAAUADA.KAEAGAGAeAGH..RCAAdCEAXCBC.CAFA.aBHDhABAHDEBACAA.FEHDTEFAhACA..bGDAQEABhAEADEDBBHHA.gGAA.cEDChAGA.SEHBhAIAMIAA.IHGA,1,-2,-17,15
IeWZKFXdOSNGTUJYaABCRHVLEPfgcMDQb,RAAAHAAAEADE...fADBMAFA.QAFCeBEAZCCAXCGAhAAAdAHASCAAGEEBhABATDCAJHCAAGHACHHALDGBhAAA.gFDA.bGFA..hACA......hCAA...,2,-12,-4,8
AaMBUJfZKHWGQLDVYXPONgbSICdcFEeTR,aAAAMAAABADAUAEAZAEBHAGD.GBBALAHBDCIB...XBBChADAODEB..bDFDCBGAdECAhBAAFGHD.EEEA.REGBAEIBKHEAhAIAQGDA..YEBF.hBGA......hCAA...,2,-18,-8,10
TaRAZeWFbHVMCcPfBKGNDdOSEXgQILYUJ,eAAAFAAAHACBMAEACAEA......fAGAGBCAdBEBEBHFQCFBhAAALDEBUDGBhAEAaBHFAEEAbEFA.PHEAhABAKFCBOFHB.XGAC...hAIA......hCAA...,2,-14,-13,1
QdTWSLHYORBDIgCPKAaJFGUbEXfVNZceM,aAAAGAAA.EADAXACD..fAFAZAEAeBBDdCFATBGAhAAALAHBHCDAREFADDDAhAFACAHBADABFEEH.VGAAMDCBhACAQGFASFEDBEHAIGHA.hAGA......hBAA...,2,-6,1,7
cFLQDGKRCeNTHJXSfOPMWVIbBAaUZgdEY,ZAAAEAAAFACDLADB.GAFARAEAeAHHHCAB.SAHBhABAOCDCMDIBIDHAAAEAaEEA.hAAAdEEA.QFABhACACFFDTGCA.fFHA.PHBCbEGDBHAAhAHAYHFA..hAFA...,1,-1,-12,11
acKQgWHDPFMALSEGCTZOUBfJNdeXRYbIV,EAAAGAAAZACBBAEAJADA..eAGHRAFF....ICHAaBHDQCDAhAAAHDEAFECBADCBLEGBhACATFGA.fFDAhAGAdHAB.YFFDcGFC..WCBFhAAAMEIB.....hAHA...,2,-24,-8,16
SQTHGUdbJacIFfCAWZOMePgBRLVYDNEXK,ZAAAeAAABADBRADALAGBDAFA..EAHFSCCBHBEBdCAA.aCEDFCCHhABAAAAA...MCIBgDGAhAEA.VGCAhAIAXECAQGGAGGBB.bFFB.IHHAhACACFFD....hBGA...,2,-18,-3,15
RVDXagJMPEYQbBCLAGeKIHOWTdcFfUZSN,eAAAHAAATAEAdAEAFAGAZBAERAGF..DACA.aCCAMBGB..EDDBQDDAhAAACDFAGEGAOFDBhAAAfCHAUGAASEBBhABA.XEGA.gGGBhBEAYFFF.LHCAhCHAAEIB,2,-19,-12,7
TfEBGLcUgFOAHQNVWSJaYKRbePICDZdMX,HAAAQAAAVAEA.SACA.aAEDRCAAeAHH.CCEDdDGDhAAAMAGBTEEAEAHBGCGAhAAALEAAgCDGhADAAACAJFHBKHAAbFFDDGGB........hAEA......hAHA...,2,-3,-1,2
bKCgDHIMXedQFEWZcYNBLPUTGVaORJSfA,CAAAHAAA.MACAeACAdAGAEAFAZBDB....NAIA.LCCD.hAAATDGAaBFERCAAfCEEhACAAAIBbFCA.DDGBQGGAhAAAFEEH.cGBCBEHDPHDAhADA.UGGA...hBGA...,1,-9,-12,3
XSZTObVcJDYeafFWKHUBCgPAQRMNIEdGL,RAAAMAAAEADE.GACBLAFBZAGB..OBBBVCCB.DBIB..eAHBhAAAaCDCFEEAHCGB.CEFDAFCBQFAAhAFAdGGA.TFCAhAGAcFCDJEHB.fHEB..hBAA......hCAA...,1,-7,-11,4
UYKfGDMgJLZNFSAdQVHOabEcePXBTWRIC,dAAAHAAAaADAEADE.eAFEBAGARBEA.UCCA..fCAEGCFAMAIBhACALCCBZEBAFEHDACIBQDGChAAA.hAGAbEDDPHCATGGACHHA.DIAA.....hBAA......hBCA...,2,-23,14,37
YHfGJXcMaWeFINZCSbLURBAgTDKPOEdVQ,TAAAKAAAEACE..dAEAQACCHAGBGCCAXAEBMDIBeEFBhAAAFAGDZCEA.CDDD.LGBAhAGAREFBAAIBDCIB.OFHH.hAAA.fFEEaGED.IHHA.hAIA......hBGA...,2,-11,-2,9
NLYXUbKcSTCeRMIHJZOWVAPDBGadEFgQf,BAAAdAAAEADAQACALAGBUCCAKAEA..TBGARBEFHDABZCAAOCHDhACAAAGAGCEAFEFD..hAAA.fDHAhACAXGBASFHDeFHFMIAAIGDA.hADA......hAIA...,1,-6,-8,2
HXCZWSKFBIbRGJPYUEQfVgadALcNOMDeT,LAAAOAAADAEAHADBZAEE.KAFABBBDRCAAGCFA..JBHBPBHDhABAUCDB...EEEBQEEBhAIA..hBAAfFAAaDBBACGBMEIBeFDB.CFHAFHAEIGGAhBDAYHFA..hACA...,1,-6,-32,26
GXBfWYCEQRcFVadISgbNHZPMLDATeOUKJ,eAAAKAAAGACABADA.....fAEBCAFARAGFFCCAdDFASAGBhAAA..bEGDHCABhACAZFAALEEDhAAAAAIBTCFAOCHD.XEDA.EFCB.hABAQGFA.hAFA...,2,-30,4,34
XIYCaZAbJWEOeRVGDcLTPMHSQKBdgfNUF,JAAAEAAARACAGADA.LAFAMAFAHBECKCCD.dBHA...fCCEhAAAFCFDXDADCDAAADFBOEDChADAeCHBDEHBTFGAhCAAQGAABEHBgGEBIFFAaGHD.hCBA......hDAA...,2,-14,-10,4
gPWSLDMUHTKCNeVdZAIQORGFBXcYbaEJf,QAAARAAAGADABAFA..XACA..bAGDEAFAJCCFfAHAhAAA.gCDAhADASDABMCGBhAFAHEFATFEACFADeFDFdDHAAAAAFGHBaDCHLHEAhCAAKHEA....hCDA...,1,-3,-10,7
OdBKPEFHefbYVIWaJGCRNDScLMTZAgXQU,QAAAdAAAKADAFAFA.HACA.eAEE..bABDICEA.hADAaAHDGCEARCFFDDDBLEHBhAAAZCGBAAIBXECChBAABEEDEFGFVGCACHAANIDBMFIB......hCDA......hCEA...,1,6,-18,24
OdPQYFbXTMBcGZDIWSKUVCaENfJHARgeL,RAAAeAAAdADA.QADAFAFA..TCEAMAGBGCCAZCGB.DAHBhAAASCCDKCHBCEFAEEHBJFBBhABAHFBA.AAAALFFAhAIAOFDD..........hBFA......hBIA...,2,-22,-11,11
bZVXdfEPQJBSLYNDAgTecIRHOUGaCMWFK,eAAARAAAHADBGADAMAFAKBFCZAFAdCGA.ECCBQCGABDBD.LDAAhAAADAGAAAAA.TEEAhABAODFHaFDHFEHDXGGAhADA..fGDASHFGgGGGhBDA...hBIA...,2,-17,-8,9
BaZLRUdeHJEPOWbDGFIXYSTgCNVfAKMcQ,MAAAQAAAZABERAEF.eACAHAGB..EAFAOCCBDAIBGBGAFDEH.hAGAXCDATEGACGDAfDAAhAAAAAIB.BDCDhADAaGEDdGGDPEEB.bGFA.SGCBhCAA.....hBAA...,2,-16,10,26
KabXRCANUGOdfMLJVDIHBZTeSEYcFPgQW,GAAAdAAAMADALADADAHB.HAGBZBDAeBHHECDAFDCH.QDGBhAAAaCAE.REEBAAEAODDBhACAfGHAVEFBTGBAhAIA...SEBF.YFEFhBAA...hACA...,1,-7,-12,5
ILDFOdYJHgbcNBKZaWeGAREPMXSCQVTUf,EAAAMAAA..CACA.TADAUAEALAHB.FCCBdAFA.HBBBhAHA.bBGDBBGBaDEBeFEAhAIARDEASEBA.hBAAQFDDfFHAOEHDgGDGhBBAKGGD......hBIA...,2,-21,-12,9
SYcNLgfFHDMEOdbKJUABGICaPeRZTXVWQ,GAAAaAAA.RADAZAGBTADA..XCDAQAFC.SAHBhADANBIALEAAFBBHHEEChAAAECGFdDDAKGAAAADACDHAeFDAhBAA..YGCCfFHAOHEE.hCAA......hCDA...,1,4,-18,22
AHGJeaDOEKZQfBCUSINWLMdPYRcVbFgXT,HAAAeAAAOADCEADEZAFBQCABBAGB.SAHHICCALCEAhAAAdCECRDCB.bDFAhABAXEGAAAIB.aFAAhAAAfEEECDHCUGEAMHBAcFAAFGHH.TGFAhAFA.DICA...hACA...,1,13,-14,27
gZaCTfXQJeORBKFSEPGIWAbdYMcVDHNLU,dAAAMAAADADAHACCLAGBZAFBCAHA...TBDAQCCC.eCGHhAFARCAAFDEDEEEBGEGAhACAABBB..bFCDVFBAgGGAhBAAaGED.fEHA...hAIA......hBAA...,2,-17,5,22
eYBbIVUXCHSPdfKFMEOWQNDAGLcgJZTRa,GAAALAAAJADARADFeAFEBAGB...VBFBCBHAHCDA..dCAAFDCHhAAAECCBQDGAhACAACIB.ZFCEaEEB.bFFAXGFAhAIA..fHEB.MIAAhABA.....hBAA...,2,-21,-7,14
EDLHRGTbMceNfZSCPIgYAUFXWKaJVBQdO,XAAAaAAABADA.dADADAFAHAFA.GCDBMAIB.eCHHZBBACBFAIDBAhAAA..ABHBFDAAhADAKEEDQFAAhABAEDDB.RGEA.bDFBNIABSHGA..gFBAhBAA.YEHBhBFA,1,0,-33,33
DUgKYHfZdbBeXaRNEOQcPMCIFTJVWLSAG,GAAADAAAKACAHAEBdADAeAFARAGB...EBHFQCCCMCFB.FDFDhAEATEGA.VFAAhAAALEHBAAFA.gGAAhAGAZDDFbGDABHHAaBBHOEEH.CGGCWHFGhAIA.....hACA...,1,-4,-7,3
QCRdMfJDBXKOgVEWLFAeUaGYIPTbHSNZc,eAAAGAAA..IAEAbADA..HBGBZAFBQBCDhAAARCDBdEADMEGBDADAKAHBOCGDhABA.EDDBLFHBhAAAADIBaFCBTFEASAHBCGHABHGDXFCD.hCAAWFFD....hACA...,1,-4,-10,6
YFPcGXRNJSebWIULKaAdQCVODMTfZHEgB,dAAAQAAAOADADAHBMADA.ZAEEHBDAEBHF.BCBA.FCHDGCBBhAAARDBA.SCFBhAIAeDFB.bEEAIFHAhACAKGGDADIB.TGBA.fGDB.hBCA......hBDA...,2,-16,-13,3
IMLBDXTUKeSfVOaNGgJdHWcEFRAPCZbQY,ZAAAQAAAMACALAGBDADAUAGA.KBDAeBDH...fBFAhABAaDBAGDFAdEEAHEDBhAAAEDHFAAIBCDHA..bFBBBFBAhBFA.TGFAOFHD......hBCA......hBDA...,2,-14,-14,0
WQgUeBFALDZdKHJbaOGPTNICfRcEMSVYX,ZAAAHAAAaACAGADA.TAFACAFARAGF.EBHFMCCB..SCAAhAAA.XDEDhACAQDDAeDGBACIBdEGAhABAbDAAOFABIFAAfGGEcGDA..hADA......hAFA...,2,-31,6,37
WPCMgeGKIXfcUaTYSABRVbZJLDFNdQEOH,RAAAZAAALADBFADAdAGA.EAFAHCAA..CAHA.eBHHGCEAKCEA.XCGAhAAAUECA..aEFBTEGAhABAAEIB.BCCCVGFAhABAbFAA..DGBBQGGB.OHCEhAFA.....hACA...,1,5,-19,24
aZgSDFEPURKTXWMJdCBeQcAOfNVIHGYbL,OAAAVAAA.HADAGADALAGBZAFADAGAEBBB.RCEB.KCFA..TDCAhAFAMDAAdEFAeCHHADIB.hAAAfFGE.hADAIGCAaEHHFHCA........hAIA......hBAA...,1,-9,-23,14
WbKCeGcOgVSXQBEHTNRMdDaLZPAfFIUYJ,FAAAUAAA..JADAKADAGAGAOAFA....SBCHhAGAQBFDHCEBRCBAdDGDaDHDZECBhADAAAIB...IFEAhBAAbECDeFGBVGFA........hBCA......hBIA...,2,-18,-18,0
ALPcSZQTNYgUJBWDRXbadMFeEGOKHVfCI,LAAASAAAZADBQADA..TAFA.gCAAhABABAFARAGFaCCBdAHAeCHHhAAAECFBGDGAHDABCDDAADABhABAcEECUFDADDGBMIDAKGGA.....hACA......hCAA...,2,-14,-4,10
FMeAORKLXbYcNaDESTVBJCIWGdfZgPQUH,RAAALAAA.XADDbADB....NAGA.EAFA.SAHHhABATDCABAHACCAAGCEBhACAZCGBQFBChAAAHEEAeCCBACCAKFEAaEHDDFAAIGHAdHBBfGGEhAFA.....hABA...,2,-28,13,41
GfTZEdbaXFQDNUgWLYAKeIcHMSCJPORVB,eAAAHAAAMACACADA.OAEERAEFGAGAZBFEECCAdCCA....aDFDQDEBhAAADDIB.gDGHhAHALEEDAAAAKFHBhAIASFGH.PGAAfGGEhCAA......hCCA...,2,-20,-12,8
NWePXcQHESAGbIRDgMUaCVYTBfLJOdFKZ,GAAARAAAMADA.aADA..CAGA...TAGALBEBdCDAZCEBeAHHXCGAhAAAHCCDAAAAbCFDDEGBVEBBhACA.BEHDODHFhCAAKGAD.NECA....cGGAEGHB...hAGA......hAIA...,1,-4,-8,4
cZWJQdTOagbRBXFSAHNDPEYUVMGLCKIfe,HAAADAAAEACAVAEA.GCABLAFA.KBBDeAHHZBEA.QDEAhAAAdDCAaCHD.REABFDHDAAGA.hBAAPGEAMDGBCEEAIHHAhACA..fFHAWECH.OHFChCAABHAD.....hADA...,1,6,-25,31
fTIFLQRJHbXEVGBcWSgCPaMAeKUZNdYOD,eAAAZAAAdAEADAEA..TAGALAHB.RBCAHCFBECAAGCEBBBGBSDBBhAAACDDD.hABAaDEBAACAKEBAUFBBOEFBhAGAFEHDJFFFbEGD.........hABA......hBDA...,1,-10,-16,6
TKLNXHJBDWbQVPSZAaIFEdUMORefgcCYG,aAAAEAAAdADA..MADARAFA..eBCD..fAGACCEAGCGATEEAhAAALBBAHFAAhAFADAIBbBEDQGDDhAGA.SGGAACHBFDBAODHDcDBCKFFAXGDChBAA.BHHAhBDA...,2,-25,12,37
cWIbgNZUVKeAMLYREBSfXHDQFJaOPGdTC,MAAARAAAEADE.BADA..XAFBHAEBQAGAFAHD.aBBBGCCAhAAAdCCA.TEFAhABACDFAIDHAbCFC.ZEEAKFHBhCAAAFIBLGAAfHEBDGGB.....hCCA......hCEA...,2,-11,-11,0
TSJUYdNRVbFgLGHEKCfMZDeIBOcQXWPAa,aAAATAAA..SACHUACAdAFARBGFFAEAGDDAHAGBKBED.MBBBhAIAeDHHBDDDQEBAhAAAXDFCAAHAYFGFhBEAbFGB..EGDA.......hBFA......hBIA...,2,-14,-10,4
QdbLDIOJVSFRcBaGAHYPUTgKXMNEZWCfe,HAAAUAAAKADAMACAZAFBCAFA....eAGHdBHALCDBOBDDSBHHhAAARDAABEGA.ACCATEFAhAIA..XFAAhADAEFCAfFHAQFEDDCFBIHEAhCAAFFHD.....hAFA...,1,-3,-28,25
acNHAdXbDZKFBSPYIMRTeCEULWQJOfgVG,dAAADAAAZABEBADA..SAEH..IAFARAGB.eAGHhACAECCBLDABhADAQCBAfCFAhAGAGDDAaBHDHEDAACFBKDADFDHDMEIBTGEACFGAJHEEgGGBhAIA...hADA...,2,-25,-3,22
TVdbegPUCRcFOZfMLDaHKEXQYAJWISNGB,JAAASAAAGADABAFAdADA..eAFAUCGARCDAOBHDZDAA.MCCBhAAAaEFC.HEFA.EFABhABAQFAAACGA.hAFAIAHANHEB.bFDDCFED...FFHDDDBB.hADA......hAFA...,2,-24,-1,23
eHWVUdMBgIRJOYbPaEGZLDcAQCSFKfTNX,QAAAFAAAKADA...TACAeAFEHBECUAEAdAHAMCCBBDDAhAAARDDAOCHD..bDFAhBGAEDABZFDALFFBhADAAFFAfFHENIAB.WHBAIHHA...hBHA......hCAA...,2,-19,-8,11
OGJdMSXBVUeZHQTAKDgLFcYWIRECbPaNf,DAAALAAAFACD.......cADDIAEARAFF.EAGACAHB.hABA.aCAAOBBH.hACAdCEAMCHBBBHAeDDBhAEAHDFBACIBKDFD.gFGAbGAAfEDEhAGASGFD...hBAA...,2,-39,-17,22
JQESdZeXaORHGVTbLCBPKFNgAIcYDUWfM,..IAAADAAAUADA.MAGBEACAZAEB.eAGFaAHB.HCAAGBBAhBAATDGALDEABBHAFEBDhACAABBB...cEEAhAIAfEHASFHHdFBDRFDFbFFDCHGD...hBEA......hCAA...,1,-9,-11,2
PGBENRJeIXdLbATCKcYHQSDfZOVFWMagU,TAAAKAAAHACB.QAEADACAZADE.FAGEaAGDUDEAGCCB.ECHFhAAARCABeCHB.dEGAAAIBCEFAhAFASEADOEHDMFCBhCAABGHAJFEF.........hAAA......hACA...,1,-11,-14,3
ZeHKJVcUSdXDfYINgObBPFGRaEWQCMLAT,eAAAHAAAKADC.JAFBUAEA.dAHADAHB..fBCA.hAAA.ICCAODDAbDGDhAAAFCAHRDEA.EECBQEBAhABAMAIBAEIB.ZGBASFGBXEEC.YHDAhACABHHA.aGHD.hBEA...,1,-14,-21,7
FJgCYTDSZAOXIMbEeaQdRLKfHGWBNVcUP,XAAAMAAA..EADAeADAdAGARBBBLAHBHBEBGDGABBFAVCDBhAAAUGBAFECECDAA.TGEAhAIAZEGBAADAODCH.hBAAaFFB.KGDB.fHBB...hBBA......hBGA...,2,-7,-7,0
aAdgJCYZHKRfFGVXNcIPBeMELOSUQbTWD,dAAACAAAHACARADAGAGA..XAFB..ICCAeAHFECAAhAAALDABSCDAhACAbCEDDDIBACIBJDFBZGAEFEAAVFGBhACAPEHBBEDCMEEB.OECD..hAEA......hCAA...,1,-7,-8,1
GWbgUVNBcHTZPSYDIXOMeFdECRKJAaLQf,aAAALAAAGACA..bADDUAFA.BAEDHAFAZCFESCAAhABADBBB.OCGDeEDFEEGAhAIAREEBAAHAQFAAhACA.fGDAgFFGcGFDYHBAhBAAMCIBCGED....hAFA...,2,-12,-5,7
BQgYaDMUFCcdHSNRAebGKTXEIOZfVLPJW,eAAAGAAAKADAEADAZAFBLAGB.JCDBQCCA.aAHDhAAAMAIBCDGA.HEFAREDAADIB.hABAbFBA..TFAAhAFAOBFBVFGBBGHA.DDABFHBESHEAhAAA......hACA...,1,-5,-10,5
OMcXZKHFIBVdEJQUgePCGSNbALDRTfYaW,RAAATAAA..aADAMACAZAFBHBDDBAFAEAHBQDGA.eCCBhAAAGBDA.bCFBAAIBLFEBhABADCCB.fGGAhBHAODBHKDHBFHCGdFFD.JHDA...hCAA......hCHA...,1,-6,-9,3
ONbHTLRBaKDPUdfYZXAgeQMGVWIECcJSF,eAAAGAAA..IAEAEADACAFA..SAGHOAFDHBCBRCDAKCHBhAAADAHB.dDFDZECAAAAAMAIBhCAAVEGB.JECFFGEHTFFAhCBAaDAH...........hACA......hADA...,2,-15,-15,0
WJdTGDeUgQYNCLcHVSMAFXfKRBaOIZbEP,XAAARAAAOADAZAGB..EADA..JBDBGAFA.eAHBQEEAhAAACCDAHDAAMDFBhAAAABGBKDHBBFCAbDGD.dGHATFBAhABADCCB..........hADA......hAIA...,1,-5,-35,30
IcGKSJRUBQEMgWLPTHXbDfYZaeOdAFCVN,CAAAVAAA....IACAGADASAFARADFBAFB.EBHFMAHBhAAALDAAHCEBDAIBhCAAZDFAeFAAACCBFDHDKFGDQFFAhAAA.gGCATGCA...hCBA......hCGA...,2,-34,2,36
aNOPDdcbWQUEBVSAZTeXKgHJYLICGfFRM,eAAAKAAAHACBLAEAGAEBRBCB.MCABOAHDdCFD....bDECQCEChAAABEHA.AAFAZEFBhABATFAAXGCAhCAAgFFBIHHACHAD.......hAAA......hACA...,1,-9,-15,6
IAfLbBZJVaQSHRPXCcEgUdFNYGMDTWKeO,LAAAZAAAaACA.HADBRAEF.CAFA.EAGEdAHAFCCHGCAA.MCGBTCGAhABAeCCB.ACABBDHAhABAQEDASEEBhACAXFFBUGGADEIBOFAHbGCC.PFDD.hAIA......hCAA...,1,10,-18,28
JefPLWCMOUDbcXAVNTGHdagSIEYBKZQRF,TAAAHAAAaACA..SACBEAFAKAHBRCCA.eAEALCFB.MCHBhAAADAIBbBEAACCA.GDDAhAAAdEECIFAAZEABQDGBhAEAfFHACCCDOFGB....hAFA......hCAA...,1,-4,-6,2
fdBKXWHTGOQegPNJLAEICSFaUYVMZbRDc,EAAASAAAFACD.UADAMAEAZAFB.RCGF.DAIB.dBEAKAHBHBGBGDBAhAAAeDDB..PDEBhABALFFA.ABGBaECHhAAAbGFABFGD..WHFA.....hBDA......hBFA...,1,-17,-18,1
EabZHLKeITOUFNWGdJYgADXQcMVSBCPfR,QAAAMAAABADA.CACA.RAEF...EAEAZAGBHAGBeBBBOCDBFDDBGEFAhAGAdCEAJDGF.AAIBDDIBhAAAXGCA.SFHBhBAAaEAAbGBA..KFFD.IHHA.hBCA......hBIA...,1,-2,-24,22
KFMOBgPLQIAHfNCYGJeSXWcRaVbUTEDZd,HAAACAAAGACAeACE.XAFBRAEA.aAHDbCAD..UCCADAIBdCGAhAAAMCFBBDFCLDGBhAAAAACB.fGEAhBHAJEDBSEHH.......cFFBhAEAEGHF.FHAA...hCAA...,1,-9,-22,13
SXUfJOTNgaAdbeHZQCYKFBVcRPEWDIGML,eAAAHAAAZADBQADAKAFABAHBRAFA..ECCBDCABGCGAMCCBLCGBhAAAXEDA..fGAAhAAATDEA.aFHDACIBdGDAhACAbGDA.FFHD.........hABA......hAGA...,1,-3,-19,16
IdVeLUcNHfOAXTgaQYBCPZMbGKFERWSDJ,TAAAaAAABADA.ZAEBGACA.EAEARAGBDBBBdAHAeBFFLCCBUDGAhAAAHEEAACAB..QEAAhACACDADMDIB.bEDDFGCAhADASFFGJHEE.IHBA.NIEB.hAEA......hBHA...,1,2,-20,22
OUSGcefJMAYVbgWdLXICNTQPEDRHFBKZa,VAAA..bAAAdADALAEA.CBHAQCAAEAFAHBFCKDDAaCDDhAAASDFBGCFAeDHHhABAMDIBAAFA..gFCAhACAXFAATGGADFFBBGHAOFFB.hAIA......hCAA...,2,-12,-4,8
GJVeSZgXWFHfKCRaMYAPBDTdUcEOIQbLN,DAAAdAAAEADAQACALAGBGAEB.eBBBZABBXCEBhAIAHCFCCDDAREFB.aCHDAAHABEHAUEEBODCDhBAA.bFGDVFAAhAFA.SFEDFFBHMIBA.....hBFA......hBGA...,2,-2,-2,0
WJeDOLFfQZaTAKXRCSGMbgUdNHVYPcEIB,RAAAGAAAMADA.UADAHAFC..VAFA..PBDDECHFBDDAeCCDhAAALDFBQCFChABAaDBDAAABCDHASFDAhAIA.dFHAYEHBcGFB.IHFAhACADICA......hAIA...,1,4,-24,28
EGYQMbVNgSLWRFZJPcOBdUaITfCDAXKeH,eAAAHAAAEADEGADAMAFA..VAFA.SCCDRBEAZCAAJCHBODFDhAAAdDFAaCHD..TFAAhAAADEEBABHAKFHB..bFEAhABA.LHDA.WFHH....hAFA......hAIA...,1,0,-22,22
VdKNGQPUYESaZHCDcBFORJXMTLWfgAIeb,eAAAdAAAGADAQADAUAGA.EAFAZABBHBGBDDDBBAFDRCCB..MEFBhAAALDGBfEGEhABAADIB.bFDDKEFD..hBAA.PFDDaGCBFGGHOFHD....hBDA......hBIA...,1,17,-25,42
fGRcFKbCZQIOATJSDaXBLMPUWYHNgedEV,TAAADAAABACA.LAEAMACA..UAGAHCCAeBDAEBHFGCFAhAFARDBAKDFAZEFEQECBhAGA.ABBBaDHDXFDDhAAA.WHDAYFFFgGGB..hBDA......hBEA...,2,-16,-9,7
EOVWFNKSfAbJDGHgZaRIBCceXTMLdYPUQ,DAAAHAAAZABERADFCAFB..eAEHMAHBdAGA.UDAAECAB....OCCBhAAAFCHDKDCAAAIBGDEAhACA.aCGHBDFA.TFDAhADAPEHD.QFCDVGFA.SGGDhADAfGBA..hAIA...,2,-35,3,38
efAQFbaBIRXOcHDPUVYMSWJgdLNKECTGZ,QAAAaAAABADA.RACA.OAEDHAFBDAIBUAGAMCEB..SBBDhADAJDAAdDFDLFAAhAAAECCEGDEBeDHHADHAFFFHhBAAbFFD...XGBAPHAA...YHFGhBGA....hBIA...,1,9,-25,34
ASOGaEeMgfCHLBDJUIQWZTRNcKFdbVPXY,GAAAEAAA.eADAMADACAGAHCDALAHBDAIBUEABQBCA.hAAAZBEBRDFAKFFDdCGCbECCXFCDhACAACBB..aEGEBGHAhADAIGGANIDB.FHBA......hAAA......hBCA...,1,-5,-11,6
NcKMJfaRPOEIFUYXbGDSWgHdCVQBeZTLA,KAAAMAAA..aACARACAEAFEFAFA...UCCB..bBCAGCFA.hAAASAHBHCFBdDBAQEDChAIAeCHBZFCAABBBJHFEhBAAOBHD.XFGADFDA.CHCABHFAhBDA......hCAA...,2,-16,-8,8
QMGWDYCaUSBdJITKOLcfVHXERbPeFANZg,ZAAAMAAAGAEADAEA.aACABAGA.dBBATAGALBEB..fCCEhABAHCGBRDCBeFFBhAIAACIBQDGCCFHA.hBAASEDHKGCD.OFFBXGDDEGAAFGHBhAGA.NIAB....hBDA...,1,6,-24,30
RWLZFVUfXQJCNbeYGMdcTESBAOIDgHaKP,DAAAHAAAKACARADFZAFB.FAHDUAEA..QCABCAGA.eDDBhAAAGCCAdDHA.EBBBAFAAOFAEhACAaAHD.LFFBhADAXEFA...bFDD.....cGGChBAABGEAIHHAhAFA..,2,-46,4,50
fPUDZXgMKIQVHbJWRSOaYNCTdLEAeFGBc,eAAAGAAABADA..fADADAFAZAFEMCCBQAFA.hAAAHCDAbCGB.RDFAaBHFCDDAdDFAhABAAAABFFAA.UFFBKFEDIGGAhCAAWFCH..SGHHNDIA.hCBA......hCDA...,2,-28,6,34
KTOXFYDWRZIgCUcVaAMPEBGdLfQHSNJbe,EAAAdAAALADAHACASAEEJAHB.eAGHOCAEFCCH..DAIBRCEBZEAAhACACDFD.UFGA..hAEAaDGDACGBBDHAGEDA.hAFAQGGAKHAA.YFCF..hAAAWEED....hAHA...,1,2,-28,30
BgJMGfPZFCaRTQWEIKXNcOeVHAUDSbLYd,SAAALAAAdAEABADAMAGBGAEAZBGBFCAARAGB..QCCChAAA.EDAAXDCAhABAODFDHFGBAAHAbFDAJEBFhACACDHAaEEH.TGAAKEHBNICB.......hBEA......hCDA...,1,7,-16,23
OGFKTbHCSAIVELcgZaYedDXfJPUWMBNQR,EAAALAAAZACB.eADHdAFADAHB..fAFAUDEABBECRAGFGCAAhABAKCHB.HDEAAAIB.hAAAIFGA.gGDAhACAaCBBXEGDWFADMIFANCIA.FGEBCEDD.hAFA......hAIA...,2,-31,-2,29
VJcEBQYPgXFDTabLeUSfAWMdGCKZRHNOI,dAAAGAAAZABBHADAOADAJAHBEAGA..QCEA..gBGAhAAADAFA.bCDBhACAeDCFSDBHhBAAADIBMEEBRFFAIEGABHEA.XFDA.aEHDhBCA.fGGEhBDACHHA...,1,-15,-19,4
DAVWKLZTPEIfbcXSMCGBgFJaNYdOQeHRU,KAAAZAAAEADE..IADA..bAFBSAEHGCAAFAHDaAGAhAAAdCCD.eCFDHBFBREGFACABhABALCAA.TEDAhACAfEEEMCIBBFGANIDB.OHBAhBHADHDA.PHEC.CHHB.hCBA...,2,-17,0,17
dfecOYZHbSQBIJVGWRPTKMNaUCDFgXELA,eAAAOAAAHADA.QAGCBADAVAFARCCBKCEA..aBBCDCIBFCDDhAFAEDGFACFB.dFAA.fFEAhAAAZDFBSCHHhAIAIFHAJFHB....WFEDMIAA.CGGD..hBAA......hCAA...,1,2,-32,34
cEOWeBYNdZRAUHCIbFXSKfgQVaLJDTGMP,HAAACAAAFACA.KADC.QAFALAFADBCBGCAB.MAIBECEAeCGFhAAABCFDdEEAZECAAAGAbDGD.hCAA...SCHHhCBAfECAaDDCPHBAOFHBNIEB....hCDA......hCEA...,1,3,-27,30
ZQJRYcFCKBVGDUPOIabTMSeWdgELfXAHN,HAAAZAAARAEAFBHDBADB.GAEADACA.OAGF.aCACMCCB.eCGDhABAdCCAEDGBLDDBhAFAAAIBQEDDJFFB.CFHAKGAAhAAA..PHAATGFASEHHhAHA......hAIA...,1,-2,-27,25
IZdLDcbYePGFMJaKfQUEWgBVTCANHSRXO,HAAARAAAOADAdADALAFA.DCABbAGDeCCBGBDAFCEDMCGBhAAAaCCB..KEGAUFFBEFCBBBFAhAAACCHA..AAGASEHBhACAZFFA.PHCCfGEE.hCHA......hDBA...,2,-13,-13,0
fNXILVUAKOWRPTHYQEgcCMFZGBaDeJSbd,OAAARAAAHADBEAFA..CADAZAEBaAHD.DAHBeCCB..SBBDhAIAdDAAXCFDLCCBhBAAAAAAKEED.TDGAQFGAhADAMEEBBFFAfGFEIGBAWHBAPFHDhBGAgFAA..hAFA...,2,-22,-5,17
NKZVeTXJaLQGAbHSOdWYUIMPEcfBgCDFR,HAAAdAAAUADAMACA.EAFABAFA.DAHBRBDBZBGB.eCCBJCBB.aDHDGCFAhACAACFA..bFEBOBHDhAIA..IGDAhAAA..fDDAFGGANIAB.TFDAhBAA.LFHBhBCA...,1,6,-39,45
fGJRSPIbYQUNEBdDWZgKCMTAHcFXLeOaV,HAAAXAAAeACE.aAFAGADA.RAFASCFAbBDA.QDAAhAAAEBHFdDDAZEGBCDHAAADBhABALFFDODDHfEGEhAFA.IGAANCCADGEB.KFEAMIAAhAAAFGHD.....hAGA...,1,4,-8,12
XaFWIZJCQLUNMKdEeVTgDPRfOcHSAYbBG,BAAAaAAA.FACAZACB.QAEALAFAMBCBEAGA...eCFAhAAATCGADDDB.RDEBOBBBhBAAHEDBAAGA.GECA.hCAAXGEAIFHACHHA.KGCD.dFFA...hBIA......hCAA...,2,-25,-6,19
ELZSIdGWVHbBMCeADUcgYfaFKXOTQNRPJ,DAAAUAAA......gABAaADAXAFDQAEAhAEA.RAGBECDBZBDFdBHAGDEAhAIAHDCBMDIBAAHAfEGAhBAAOECBTGGAPFHDSGDBhBAAVGDA......hBIA...,1,-10,-13,3
fYcSeMOLBRVaUPZDNAgKbEHXIGTWCJQFd,KAAAHAAAGACATAEACAEA.QAGC.dCADfAGAhAAASCEDeAHHMCIBLCABhACARDCBaEABZEGFACFBEDFFXGDAhAAAIEHA.FEDD.OFGBBFFB.PGAChAEADIAA....hAGA...,2,-17,18,35
gDcTVEJdAXKCQZONMLFHUeWYfRBIaSbGP,CAAAZAAA.MACAHACAUAGAeAEE...fBHARBDFBDFA.aCAAGDGAhABA.DCCBTCEAhAAAEFBA.AAHAQECAhACAOFDC.LEHB.FEFD.IHFAhCEASGHHgGCGhCGA.,1,-10,-27,17
IfNHaZRMBWOdJeLVbFAPYTEGXKDCQgSUc,TAAAEAAAGACA.DAEAQACC.SAEBIAHAHBEBhAAARAGBMCEBOCBBhBCAeCFFbEGBABGBXCGDhBEA.CEEDgFGAfGAAaGFBBHFDWDDDhAAA......hAGA...,2,-14,-6,8
WCGZVIUPMafcFXDbdgQLeTARONKBJSEYH,RAAAKAAABADBEACE.HAEBGAEAZAGBUDCA..aAGAFDHDDBHB.dCCALEEBhAAAACIB.OEGHhABASDFH.CEAAIEHAhAAAMGAA.XEDD.bGBC.hAGAQGGANIBB.hBGA...,2,-19,-15,4
fXROHWCSYIQagPUKAdMLNeEcBJZDGVFTb,dAAAMAAAeADABADAZABBGAEAFAGD...TAGAXCEC.HDCBhAEASBBBQEGAhAIAaCGEUEEBABIBEFEFDGGBhBAAbFGDRGAACHDD...gDCF.KHEC.hCDA......hCFA...,2,-9,-2,7
EaSHLbAgBNRVDdTeYKXIMUCfQOGFJWPcZ,BAAARAAAdADA.eACAKAFA.MAGBUCFA..QCAAGDDA.FAHBJFAAhAAA....cCDAhAAAECCBHFGBLDHBhACAAAHA.gEEADBIB.TFBA.XGGChADACGFCWHDG...hABA...,1,-6,-27,21
EaTQNSRPWUZFDHLJBKOdeAfYIgVGbcMXC,..IAAAGAAAbADA..MACA.EAFAaAHB.QCDAhAAARBCAUCGAZDBAHDFBLDFDhAIAKCHBeDADABCA.fDCEhACAgGFAXFDDCHBA.SGHBhADA.WHEA.hBHADIBA..,2,-22,14,36
EGKYFdMBVgCAaJcbPDWXQRUHTIfZNLeSO,aAAAJAAA.......bACDDADA.QAFAHAEATCFAZCCAeBHHhAIAEDHFGEAAFEBAdEEDhBAAMECABBDACAHBABBB.PFFBhAEARFGBUGDA..fHCBSHBCKHGAhAGA......hBAA...,1,-1,-18,17
NGCMXTPLaAbQeJUOWgEFYHIcZdSRKBfVD,eAAAOAAAEADAHADAZAFB.RAGFBBBDDAIB.GCEAMBHB...TEGAhAFAaBDEAAAA...bDCBQDDChCAAUGAA.FEGHhCBAIHHASCCDfGDACGHA..hAGA......hAIA...,2,-18,-10,8
eCEZbgDJKHVRASMWfPcLYQFBOUXNdaTIG,MAAA..fAAALAEAQBBAOADAXAGAaAHDGCEAhAFAEBCAZCBADDGAHCFAhAAAACEBSEGAcECABEHAhACAdGAAeGCEbFEDKFCDWHEAFGGA.....hAHA......hBCA...,2,-4,3,7
SVHaCJPgIfMTUNZOdWDYbGBAQEcFRLeXK,EAAARAAAeADEKACA.HAGB.CBDA.JAEA....IDDAMAIBTCCAhAAAZDFAdFCA.DCCBGCEAhAHAAAAAQFFALCGBhCAASGABaECC..fFHAhCBANIDB.OGDC..hCCA...,2,-22,-7,15
WgfDSATICOdZeMGYKEXBHaLVRQFcJbPNU,TAAAOAAAZADB.GAFAEACEHAEBLAHBRAGBQCCCFBBHJDEB.hBAAbDFA..UFBAfEAAhAAAAEHAdFGA.eEEBhAEAMFIBXGAA.aGDB.PHFCWHBA.hBDASGGE.hBFA...,1,29,-15,44
cJfaRWFEGXAMLdDZHgCYVTNeKUISBPQOb,dAAAHAAACADA.TAEAKAFA.UAGABAHB..QCABOCAE.bCEChAAA..JCEARDCBEDHFACHA.hACAMEABZDEA...gFEAhACAVFAA.IGHASEHH.hADA..fFFAhADA..,2,-42,2,44
UNWHefXACbMQJGZVEFdcTBKSgLDIPRaYO,MAAAGAAAZABEEADAdAFABAFA.KAHBLAHBDCDA.RCCAODFChBAAUDDAHCFBeEEBAAABQFGAhACAFFBA.SDADhADAgGFHaHAAYHBA..fHDBhAHA..hBCA...,1,-9,-20,11
DUWHKIQVBLOadSRebYXcJZGMCEAfTPgNF,TAAA..gAAADACAHADCQAGCLADAdAHARCCAeCHFhAAAbCCA...XEEAhAIAZDFBGEAAEFHFACCAfDHAhAAAFGDA.KECA.BFHA.aGCD.hCAA......hDAA...,2,-6,-5,1
BGNYTfXSHJUREgCIDLdFMPWbaZOVQeKcA,GAAATAAA.SADAHACBRAEA.EAGACAHBLCGBdCDAMBIB...hAAAbDEBZCEB.QEABhACAeCABAAEABFHAfCGAhADAXGEAgFGADCIB.FGAH.aGFHhAEA......hAGA...,1,6,-6,12
KLDdgRZJYOQUcbfHaMXSPCTeIBEFNAVWG,GAAALAAAdADARADFZAFBOAFAUCAA....bBFAHCGB.aBHFhABAMDDA.SDBHhAAATEEAeFAAEDGFAEEAKFHBhACADEIB.gFBA.QFFBhACAfGGECHHA.BDDD.hBAANIAB...,2,-9,0,9
fNYUgdPSJRGbCDQMaOFBeHILKWZVXATEc,EAAA..fAAAUADAdAGA.SADARCBBGDDA.DAGA.aBCCBCHAhAAAHBFALFGBhAIAZDAAABHATDGANEIA.gDDBhAAAPFBB.bFDACDGD.MFIB....hACA......hADA...,2,-15,-8,7
FeGKagWZOHAXdRfNUSPMDEQbTVIcLCYBJ,RAAAUAAAMADAEADA..QAGA..bAFATBDA.VCFBhAAALCDA.BCHDhADAeCCBaECAZFBAHEGBhAGAADIBdFFDSFCBDFIBCHHD.FFED.KHAA..hAHA......hBAA...,1,-3,-17,14
bWRDTICdXJYGFAgBVeQcfUKMHPZEaNLOS,BAAAeAAAQADAUACAHAEAZCBAEAFAaAHDLAHB..bCCCRCFBDEFBhAAA..TDFAhAAAdFHAJGAAGGCB.ADIBgGGBhABA.fEEEMIEA.hAGA......hBCA...,2,-23,12,35
YbEXIUHOeQLfVFPNcWKGaZRgSCJBDdTAM,MAAAEAAAUADAHACC.eAFELAGBFBBH....PBFDNAIAKCBAZDBEhAAARDCACCHA.BDFD.dFFAhBCAAEHAbFFA..OEHBhBDAfHCBVFBA.WHFG.....hBFA......hBGA...,1,-6,-15,9
HIfEKPWGZUeOYdTXQaRMCcDgNLJSFBbAV,HAAAEAAAKACAGADA.eAFAdAEAQAGARCAAMBIBDCGB.LCCBhAAAFEFHAACA.fCGEhAGAZFAAOEHBTEEACFDB.hAAAgGEASGHHBHGA....hBIA......hCAA...,1,-1,-18,17
FUaLeIZHOJXBRbNcAKSYMdPgQTVWfDCEG,SAAAdAAAQADA..TADAVAFADCCBEAFEGCCA.hACAaAHDeCHFHCFAXDADhADARDABbEFAAAAA.MDDAgFEGhADACEEALGEAOHAANEIA.KHGA...hAIA......hBAA...,1,23,-15,38
AOBDRKbQLWaeYHdFZNEVTfMGCUSIPcJgX,DAAARAAAQADCLADAeAGHHAFBZCCA.EAHBTBBAGDGASBHHhAEA.ICEAhAFAcEECXFAAhAAABDDDbEFA.aGECdGEANIAB.MIAA.CGGA....hABA......hAFA...,2,-11,3,14
LPaHDMIRfUNVgFBEOJCceSAGYTZdWbXKQ,GAAAZAAAdAEA...bADAQAGA.aCAAHBGB.MCDBhAAARCEAUEBAgCEDhACAEDHFCDAC.eDADAEEB.TFFAhADAKFFADFIBfHABFGAHBGED.OEEB.hABASFHB.hACA...,1,13,-17,30
MSGNdQTPBKDfOLXHZIeCcabEUgJWRYAVF,MAAAGAAAdAEAQADABAGA.DAGALBBBHBFBeBHBaAHDECFFhAGAgDCA.REFAAAABhACASBDD.hADATDGAfFBEZEBECFFA.cFECJFHB..hBCA......hBFA...,2,-17,-4,13
LWfaHMBZbSQgYNKOVPCERcUTdDXGIeFJA,LAAAaAAAHACBZAEAQAEA..gCEAKAGAOCAACAHBRDGBhAFATCGA.dDDAGFCBhAGAeEAAAEAAMBBBbFDA.hABASGHH.NICB.EEHF.DGIB..hACA......hAEA...,2,-11,0,11
HMbLBJOTVUAaSdcgPQfXRIDeCGNEKYWZF,dAAA..gAAAQADARADA.eAFAGAGAEBHFKCBAZCCAHDAAhAAAMCGBLDEBODFDTFCAhABAADABaDHD.SEHHhADAfGAADGABCGGA.YHFAFHEC...hACA......hADA...,2,-13,12,25
YJOAPcDfWQFBZLbHINCGKRUMEXeagTSdV,DAAAQAAAZABEHAEBCACAGADARAGB.EAFAeCCB.aDAB..TBGAhAAAdDGDJEEBAAIBfDFAhAFABFHALGAAbEGDKFDAhCAAMHFA..........hADA......hAGA...,2,-15,-9,6
ITEDUaPOMWCRBHVYSgcQJZbNGXLFedKAf,TAAAEAAADADA..UAGAaACA....MAFARBCAHDBA..SBDAhAAAQDFAbBFDGFBBhAAALCHBeEHHABHAfCCEhBDAOHEC.BEDA.gFDAhCAA.ZGFE..hDAA...,2,-14,-8,6
VDQeGTOgfYMcHSRbdCIWEPKLXaJANFUZB,FAAAZAAADACAeACHGAEA..TAEAOAGF....fAGBhAEAMAIBHDDBRCEAdCHAhAIACCCDEDGBLECBaEBBAEIBBFGDhABAQEEB.gGGASGAAhAGA.IHHA.hBAA...,2,-16,-12,4
WbSEMAeVIaXNLGUHPZBRYTFOQKgCcdJDf,eAAAaAAALADAHADAZAGBRAGF.FCCB.KDEACBBDdCDADBIB.....bCEDhAEAEEDB.AAAA..XFAAhAFAGEGABFAA.hAGATGDAQFFA......hCAA......hCBA...,2,-20,-18,2
aeERdXVGYBZKQSJOHPAFbNMLfTIWcCgUD,FAAAMAAALADA..TADA.IAGACAHADCCAECEARBBBdCFAhAFAGCGAZCGB.QEAAhAEAODEHAAIB..fFHAhBAAgDDGeFDDXGDA.BGGDhAFASGGDPHAC..hBBA...,1,-12,-21,9
RWQUceTgVGYSHNMPFZIAaDfCLdbBOKJEX,aAAACAAAdACABADA..KAEAEAFARAGF...QBGAeCBB.TCCAhADAGDDA.HEABMBBBhAFAZFGBACEALDFBhAIAODGB.WEED.........hAAA......hAEA...,1,-20,-24,4
EfCIAgbTaUeLSFOBKPGVcJQXHdYDRMWZN,TAAAeAAALAEA.OAHDKACCGAEAJBCB.HAGDdCFARDGFZCCFhAAA.EDGBCDEC.ACIBaEBBFECDBFAAhAAAVFFB..QGABhAGADFFBMFIB.NEIA.fGGE..hABA......hAFA...,1,10,-22,32
JKFGdWTQEXDIBYCNZeLaMbPVAfROUcgSH,RAAAOAAAUADA...SADAHAFAFCCHdCHAQAGADDFA.BBBDhAEACEDAZFEBeCDA.aDCChAGAMHAAVDFA.AFFB..hAAAfFHA..gGGAhABA......hAHA...,2,-29,-16,13
YDFIEQCeGAbHBLNSgZRMOXfTWKPcaJVUd,HAAALAAASACERADFMAFA.OAED.TAGAKBFAaBHDUCGBhAAAdCAAFCCHECCB..eEDFhAGAADFABEEAZFEBXEGDhAIA..fEGA.cFGDhABA.YHBAIHHAhCAACGEA...,1,-1,-22,21
VNEcbPZSORMGJYWBTdHaeKULAfgCIDQFX,CAAAQAAAFACA...XACAEAFA..bBCCZAEB.RAGBGCFAhAAAJAHBBCFAHDAAeDDBhAAALFHB.AAIBfEEEhADADDIBVFAAPFFBMIDA...YEHFhAFA...hCAA...,2,-22,-1,21
CXeTQJdFKMUHBOPGZEYIDARbLaWcfSNgV,RAAAaAAA....fADBSACH.VAEAeAFE.QBFDhAAAdAHAMBBBHCDAOCCBhABAZDFEEDEBDEABACIBbDFDLFGBhAEA.WHDCNEIAXECD.FHEA.hBAA......hCAA...,1,3,-12,15
BDVdNfGWQPbKIRaCeHgZOYLEcSXUJFMTA,DAAAdAAAGADAQACAKAFARCAA..eAEAHCFAZBFELEFAEBBBXDDChAFAFFAAAAHABBHA.hAIA.fDGAhBAA.bFFAaGGAOGDCSHEAMIDA...hBHA......hCAA...,1,-8,-18,10
bGZPKaMAJfdgeXEDSRIFNWTYVCLcUBOQH,dAAAeAAAEADARADA..FAGA..TAFACCCA.LAHBBCEAHCFBZABBaCEBhBAAAAAA..JEAAXDCDhCDADCIB.SDGDhCHAIFHA.NEIAVFEBOEEB.....hDAA......hDFA...,1,-5,-35,30
JcVgZbXBCFPKWSDfUGYMRHEOdINLeATQa,aAAAVAAAZACB..BADBFAED.KAFADAGA.GBFARCDAHCGB..EBHBdECAhAAALEDBAAHA.QFFBhBAAgFADCBBDSFHHhBIAUFEAMFIB.OHECNIBB...hAFA......hBIA...,1,-8,-17,9
RKJXdcBDFHVNGIEeAWLOSafMbTgCUYZPQ,LAAAaAAA.MAEATADAUBEAZAFBRBGB.KAHB..dCAADBBBHCCBhABAGCCAEEFB.ACCBSCGHhADA.bEFACEHAQGEChACA..XFAAFHGE.hAIAIGGA.eFEBhAFA..,2,-12,-9,3
GHWFgNSdDCQEXAPLTIZYOKaMRJeUBbVcf,TAAAZAAAKADCRAFA..eACEBCAA..bAFB..VCDAGCCAHCGBhABAFAHD.SCFDhAAAdFFAQGAAACCBLDHBhBDAOCCHaEFE..MFIBcGGC...hACA......hAGA...,1,4,-19,23
HDKLBaVZENQJdIfATgcXFeSWOPGYbMRCU,TAAAXAAA.FADAeACE..OAFDGAFAMAHBRCCAHDGBLCDBhAAAaAHFEDBBQDBBhABAdEEAACCASFABhAAAPDHDbFDADGGBBHBA..NIABfHGFhAIA.....hAFA...,2,0,4,4
UPCIgYRFKbeVJMdaHfDNBWAEOLSGTcQXZ,EAAALAAAGACATAEAQAEA.ZAGBCAGB....gBGAhABAREAAbEDD.eCAAhACAMBIBHDDADCBBBFFAhAAAADIBSEAAXGBDIFFAKGHB.dFHAaHEEhAEAfFDE.hBCAOHEC.,1,11,-4,15
GEbHKAUReFgMfSOVWQcNDIBXYJaPTCZdL,RAAAeAAAMADAOADC..QAGADAFABAHA.XBDAaCCACCFA.hAAAdDDAGCGAHCFBAAAAFDDHhABASCCD.hCAAcEBCIFFAPEHD.LHDAhBEAEFCBKGHB......hBIA...,1,-7,-21,14
GUSNTgdFDEcVMRZACOeYLabXHJQIPKBWf,eAAAaAAAHACBQADAKAEABAGBGAGA.SCCBTCEAdCGAhAEAEDFBMAIBAAAAODHDhAGALFFAbEDD.JHFAIFBAhAIA..WBBDfFFENEEA.DIBAhBFA......hBGA...,1,-5,-12,7
aIEdJUMefAVHKYRLFPXGbDNZcQWBSOTCg,HAAARAAALADBXADBGAFADAGAZBEB.QBGASAHBTCCAhAAAaCCBEDEF.dDHAMCABhACAAAAAKFAAFDGH.bFFANHBBBFFAhAFACHHD...IGHA...hCCA......hCIA...,1,-4,-9,5
cDBfUQGeRITWaPEAHOFKXZMbJdVYSgLCN,HAAAKAAAZACBMACAdAFA.SAEALAHB.CAHA.DBEBBCCA.QCEAhAAARCAB.TCGAhAHAaDEDABHBFDGH..bECBhCAAVFBANEIA..fFFAeEHH.IHGAhCCA....hCEA...,1,-16,-25,9
eKZUdMRcLIAQSOBgFYDHEWfXNPaJGVCbT,QAAABAAAFACAHAEBEACA....XAEAaAGAGBGA.CBCD.hAAAeAHBZDDAdGBARCDALECAhAAAAEIB.OCGDhAFADFFBfGGAPFGB.......hAIA......hCAA...,1,-13,-24,11
KbIgfGBeTUZDHAXNYcJaMESWPCFVdOLRQ,XAAA..cAAAaADA..EAGASACB.CAEAdAGAhAEARBCFbBFA..fCDAhAIAeDFBZDGFHEBAhAAAABIBJCFFMDHBFGABOFFHLGBAIHHABEEDDDIBhBAA.....hABA...,1,-2,-21,19
edWLKaVFJURfCXZAgSPbcQEBDIYMOHGTN,SAAA..bAAAEADADAAA.MAEAHAFAGBDAeCCAdCHAhAAALBFAaDABFDEDRDFAXFFAhAIAAAHAPEGBQGDAhABABGBAOCCHWFHHKGDA......hADA......hCAA...,1,-7,-12,5
INXJRTBFWDcQHLKYCMPdgAeOZSbVGEUaf,eAAAZAAASACEGADAEAFAUAFA..aAHD..IDDAhABAXCFDRDFAFECHDCCBHFAAhAAALFFACDHBdFDAAAIBOFBHhBFAbFFA..fHFBTGDABHFA..hBHA......hCAA...,1,7,-17,24
PAVcaJNURBZIKHObSYMfdLTeGEWFDXCgQ,aAAAUAAAZACBHADA.SAFEMAFALBEAeAHHGCBBECHFDBBB.hBAACCFB.QDEAhBFAADAB.VFGBcDGDRGBABEDDhBGAOEEB.fFHAdGEA...hBIA......hCAA...,1,0,-10,10
KFgXQOMZBIGWYdCHVASLTJDbNaePREcUf,TAAADAAA..aABERACFUAEAFAEA..QBDDZAGBGDEAdAHAHEGBhAAAACCB.LEDDhACA.NBIA.ECGBKGBBODEBhBAA.MDIB.BFFA.IHBAhBHA.CGHDSHFGhCAA..,1,-7,-25,18
UMHgBOAVaJLSCNPGYIWDbRdEKcFfXQeZT,aAAALAAA.CAEAGAFAIADA.DAFARCAAEAHB..FAHDQEABhABAeBBBZBDEMDEAhBAAHDEBODHBADIB.SECHhACAPEEAbFBAdGGDKFGA.....hAEA......hAIA...,2,-20,-3,17
GOALZPFaRYTXcDNUgIJdEeQHSVWbMfKCB,ZAAAaAAA.RAEA...TADADACAUCCB..IAGAEBHF.HCCAhADASCFHVCGBbEEDMDIBhABA..CBBDGFABhAFAAAHALFAAFGGA.XEFANIAB...gGGGhAFA.eFDHhCAA..,2,-15,-5,10
SVCYGfLKdgPJTEZDReFWMcbNHOXABaUQI,aAAAQAAA.SACACADAGAEALAGBdAFA.PBBBhADAEAHBRCDBeCGF.MDABhAAAbDCDHEECADCBBDHAIGHAhAIAfFBAKDHBgGBGZFDAFFHBNIAB.hADA......hAIA...,1,-1,-3,2
SCIWBLQKJbGDPOVXHdAZcgeENMTUYaRfF,ZAAAeAAAEADEMAEA.UBDARAFFFBHD..CAHABBFALCAB.QCCBhABAKCGAGEEAODFBhACAXDCCHEGBAAAA.gFAAhAFA.YHAGaEHBSGHHhCAAWEEDDIEA....hAHA...,1,-6,-25,19
RVCLfASBDEQgdFeUIJPZMaTGWOKYHNXcb,DAAAEAAAdADAeABA.UAFAJAFA..ZBFA..aBCEGCBA.KDDCHDDAhAIA.XCGAhBAARDFALFFAABHAQEGDhBFAFGDBMHFA.OFDB.YFFF..hCAA......hCBA...,2,-18,-18,0
FHYRaKXONULQMdACWJDeIcbfgSGZBTPVE,CAAADAAA.eABA..bACASAEA.ZAGBTAGA.ECAAhAAAHCCARCDBKCFAOCHDhAFALEAAdECDAEGBJDHBfFEAhBAAGGABBFFAFFHHaGCB.....hACA......hADA...,2,-16,-11,5
aTeAMZFNDHOLVCgQRbSXWIGJfKdYcEUPB,ZAAADAAAHABCLADBCAEB.RAFA...XAFDGCAAKCFDdBHAECCBBCHAhABA.eEEAAAHAFCEHOEHDhACAQEFA.bGDChBAASFAD.IHCAYHFGPHFChAFA....hAGA...,2,-19,-11,8
VgRWYCITEdbXZHcPJQGLfOKUABDNeaSFM,DAAAeAAAFACDMAEA.RBCA.CAEA...EAHFdAGAZBFFHCDA..PDBBhAAAGDGALDEBhABAKEAAAAIBBEFCaDHD..SGFAhBDAVFCA.YHDA....hCAA......hCBA...,2,-37,-9,28
ZXIQcCbWFdJKPUeagOETLRDNYfBSHGMVA,ZAAAQAAACADB.FACEdAFAKAFAeAHB.OCABEBHFRCDA..DDCB.hABA...fCCEhACAHECBGEFAACEBXCFAhAIAbFAD.JEEAaEHFTFBA...YEHBhBFABHHA.SGGDhCBA,1,-15,-19,4
QJcTIYKRAGgSaHVWeFbNXfBMDCOUZLPdE,GAAAaAAAHACBeADAFAEA...XAGAMAHBOBBHZCDAdDHAECEAQEABhAAA.TEEAhACAKDFAAAIBSDHHhBAAVFCB.bEBABGGACFFA......hADA......hAEA...,1,-1,-12,11
ZXEcdGIRYCJFSNLMWTfQbAUeaDKOgHBVP,eAAAaAAA.OADCHACBBAEAZAGB.EAGAGCCARCEA.CCFC.SBBDhAEAMBIB.TEFAhAGAbEFBAAAA.KBHB.VFCAXFAAhAFAdGHAJHEELFHB.WFFD..hAGA......hCAA...,2,-14,6,20
gSRfWJdeGHZDPUYBTAICXKQcbLNOMVEFa,XAAAQAAALADAMADA..EAGAaAGDRBDA...JCDAeBHFhAAAHDFCZDBADAIBUEGBTEAAhAAAADFAKFEB..bFFANIDB.hBCAFDDHSHGE......hBDA......hBEA...,2,-10,-9,1
QWfcPAMVHTgGeKXZaBUJYSOLFRCIbNdDE,HAAAGAAAeACEZADAaAFABAFB.UCCA.SAGHLCDBRCFACCFD.hAAAbEGDdDHA..EEABQEFAhAIA.fFEEhBIAAAABMFCBTFEAKGHB.....hCAA......hCIA...,2,-16,-8,8
FGVbdgYRUNXBcKCDZaEIfTWPOeQLJHMSA,GAAAdAAARADAUAGABADA.CAFAZAGB..ECBA..TCDAOCECeCHHhAAALDAAHEFBACFAFDHDhACA..VFAA..hACAbEEBNIBB.KGGADDAB.aFEB...IHHAhADA.fDCEhAFA..,1,7,-30,37
dGKYXJgQPCAEMLVSeaHRNDTBWZcOfUFIb,EAAAMAAALADA.eAGHHACC.RAFFTCCAZBCAOBHDFBHDdEEAhAFAGDDAKBBD.XEAAhAAAQGFAAAEAaFGABEHAhAHAfGGA........hAIA......hCAA...,1,-9,-16,7
PALGbcBTWdMJUeOgKCIQaVNSYRXfEZFDH,GAAABAAAdACAMADAeAEAKAGA..QBGAaBFC..SCDBhAAARCDAECBBZEAAHEFAhAAAACIBbDBD....TDFAhACAJFEF.OEHDCGHANIAB.fFDB.hAEADGGB.....hAFA...,2,-12,-10,2
HFQIgbRPWVZDdGYEeKaAMfcTNJXOUSBLC,MAAATAAA..XACASACB.LAEAHAFAQCCChAFAbBFA.RCFAPEEBhAHAZCCAGDFAEFCBeFHBhAIAAAFAfDHEJHEEOBBHCECAFHGE.WEED.DIAAhAAA......hAIA...,1,12,-9,21
CATVBeDMYWcUZXSEQfNgdbGJRFPILHaOK,TAAAeAAAMAEA......cACAZAFEEBCA.QCDDhAAAfAEBdCGAGAGAhAAARFFAFGDBIHHAhABAHCCAaDFDCEECACIBDIEAUGAASEEGbFGD...hAGA......hAIA...,2,-9,-3,6
VZNWgOcXUKabDdfLAGCBIHQSPeJEFRYTM,GAAABAAAHACAQADAeAEEEBHFRAFAMCDBZCAA....gCEAhAAAXCFAaDAHdEGAAAHAhACASDHHFECH.hCBATEEAWEHHOFFHKGAAbGEADGIB...hCCA......hCEA...,1,4,-10,14
fBSLgTXDPFQZObNYKUcCEGMaWHJVdAReI,RAAAeAAABADBLAEA..TAFADAIBQBCDZCCAOAHDbCEDhAAAKDGA..UEGAEECAGFCBhAAAaCGCHFAAdFAAAAFASHCAhABAXGFA.......hABA......hAFA...,2,-18,0,18
eGDKHXMOPWcZNaAgbdSJCEfTIQRLFVBUY,dAAACAAA.EADA..TACARAFALCCABAEBUAGAeCGFGDAA.hAAAHECBMCABOCHDhACAPCCBZEEF.ADABSGADhADAfDFAQEGAFGGA.DEEB.hAGAXFCD.cGGChACA.,1,18,-46,64
eDHUNKFGgcPfZSIYXdaTBEbWJAVORCQML,RAAAMAAAeADEHACC.KAFCGAGA..gBBGfBDAZBFEhAIASCCD.hBAAXDFDaDECEDGEbFFAhBHAAAAACEDALGAADFFA.FFHD.....hCAA......hDAA...,1,-9,-15,6
HgTXOVWEGJAUbIMBadRKNfPeQCDYLZFSc,UAAAMAAAdAEARADA.KAGA....fAGBeBBAQCFAhAGADCDBZCEBFCGDHDDB.TFGAhAIAODABEGFBACIBBEHAhADAaDHF.CFGD....SGHH..hAEA......hAIA...,2,-34,-9,25
XOILYJgAZPTfQSCMDNVREdKbHWBGUFaec,ZAAATAAAQAEA.MAHBDACARADAECAAdAGA.HCCAGCDAaBHDeDFFhAAAOCHDLEHBhAIAgDAAAEEBSFCBhCAACDFBKFFABGBAFGFDIHFA....hABA......hACA...,2,-13,1,14
LZMYAfURSTCIFPagdKQJGBNbDHcXOeWVE,RAAATAAAFADA...aACAdAGA.QCCAGAEABAGADAIBHCEAhAAAOAHDeDHFECCBZDFBAEGBUGBAhABACDBD..IEHAhAAAKFFD.bEDD.XGAA....hAGA......hBDA...,2,-17,-10,7
NTDbHKAePZBfcSRWJOEXULCdYMFVQIagG,eAAAZAAABADB..SADARAEFOAGD.EAGALCABdCCAFBHDQDFChAAA.aEABhABAGDDADEEBHFCBAAIBfCCEhABAJFGBCGAA.MCIB.gFGBhACANEIA.bGAA.KHEA.hAEA...,1,-6,-11,5
TGefXIDNUdEVFOMSgHcBYZbRQAPCLWJaK,LAAAaAAAGACAeADH..XAEADAFAdBFAEAHFOAHB.MBBBhAEAHCABBCEAbDEAACABCDFAKDHBhAFA..TFCAhABAfEEEIFFAVGFASEHH.hAIA......hBAA...,1,-4,-18,14
cSMGVFULRJfDOIaNWPgQBEYAdTeHKZbCX,eAAAHAAAZADBCADA.SAFAGAEAFAGARCEFDAIB..aCCB..PCABhAAAQCGA.hACAEDDBACCAdCGATFFAbFGBMGAAhADALFHB.OGBA....hAAA......hABA...,2,-13,-8,5
MdGYbJAKRVFCaDHBLTeQgZfNcEIWOPSUX,RAAACAAAHACALADB.eAFAZAFB....fAHAEBHFOCCHSCAAhAAAMCGBGEEAhAAAbDDC.AAFAFDHDBCECQFCAhABAgDGHIGHAPEABdGGA..hACA......hAEA...,1,1,-18,19
QeSYGCOJFbVLcWXfHgaZKEPDMUIBNARTd,RAAAdAAAeADEGADA.OAFAFAGALCCA..XBFDhACAHCFBZEBAECBFMCIBBBHAAAAATFGAhBEAQEFACHCA.hCAAbFBA...cDBDWFFD.aDHDDECAIHHAhADA....hBAA...,1,-5,-18,13
OTRZCGJHBeXNKfaFYPMEbLASDVQcdIUgW,DAAAQAAAdADAUAFAOACC.ZAFBGBBAHCDBeAHFKAHBFDEAMCIBhAAA.EEAAABBB.SEGBhAEA.IFCAhAFATEGARFBABFFAXGGAaGHD...PHDChBAA....hBDA...,2,-34,8,42
bGdfRYVLFAeEXUMZPgSBaWJKIHCNcQTOD,EAAAMAAAZACB..SACAaAED.KAFAHAGB.CCBCQDEAhAAATCCADAIBdCEAREBALEGBhAGAABBBeCGBUFAABGBDWFHHhAIAIFFA.OEHD...bGEChAFA......hAHA...,1,-5,-21,16
RZcKFUXLefYPWaCHbdAESBJgNIVOTDMQG,EAAABAAA.JACA..IADA.OAEDMAFARBEAZAGBFBCHLCBBhAAA.eCHHfCHAhAAAPDDBaEGHHDFBhBHAAAGB.SEDB.NEIA.DFFB.QGCBhBCA.KGHB.hBIA...,1,-2,-41,39
YDJgcTeGSEMAaBXUZKPdIFQVRWLHNCbfO,aAAAXAAAZACB.dADAQAEA.RAGBHDEAbAED..OAGDhAAADBBBJECBTDBAGGDBhAIAEDHFACEB.KEEA.FFHD.hBAALGAANDIA.fGEA..hABA......hAGA...,1,-6,-15,9
FKQgdHBMZPCUTWRANLeEXOfDIVGaYJSbc,eAAAEAAA.OADCDADAGAEB..aAFASBCBFBHDKCCAdCEAHCDBhAAAZEFB.CCFDUEGA.hAAA.TGCAAAHALFFDhCAAfHGFICHA......hCBA......hCCA...,2,-23,-19,4
FfCEUKPGgTVMWQINdOHZRcSeAbJBDaXYL,BAAAaAAALADACACA.KAHBGADA.TAFAMBBBQCCAhAEA.dCFAHCAAhAAARDGFeFAAAAHAbCFAXFDAhAFAfEFAEGGBPHAAgFAA.IFHAhACA.OFEHhAFA.SGGDDFIB,2,-11,8,19
ZXNYUROfTeKaPbGMIALVDgBQSJdCFcHEW,LAAADAAAQACAdAEAFAGAHAEAZCAA.XBGAUCGA..REBB.TDDAhAGAeDFD.KBBDaEEHGDFAhAHA.ADHBBFDDhAIACFHAEHFA.YEHB.......hABA......hACA...,2,-23,-1,22
AeDgObKNQaPEIZcSMXLFRJTYWGHfdVBUC,eAAAOAAAKADA..aADDEAFEZAEB..MAIBLAHBRCCA.TDBAhBAAGCFAHDFAdFCABEEDhAAAABBBDEEB.bFGDQFFBhBDAIHAA.XGBAFHDE.YFHBhBGA......hBHA...,1,-7,-8,1
FXBcaSVeCLfUPZHMQOGIbEKTgAJDdYNWR,dAAA..NAAA.RADABAGB..aAFAeAHHLBBAUCDBHDABMAIBGBEAhABAEDGB.TDBAhACAAADADCCBFEEHSCGBhADACFHAZGCA.QEGB.bGBAKGGDgGGAhAEA...hACA...,2,-17,5,22
UEVRYLCBIQbPASdfeFKgXNZcHMODWJTGa,dAAAeAAAKADA..XADAZABBHAFB.MAIBDAGAJBGBGDCA.ECEBhAFARCCALEAB.hAHABDHAbEGBAFFAFEEB.gFGAhAAAOHBCaGGH.......hABA......hAEA...,1,-3,-29,26
QTFPNfdKZXeSJOILaBHYRMAGWEgbVcUDC,EAAAVAAADADA..QADCFAFD....fAHAhAAAZAFBeAHFOCHDaBCAHCCARDDBAFAAhAAAGDFA.WDHBhAHAbFAACFGA...TGEAdEECSHEGhCAAIHHA.BHHA...hAFA...,1,-7,-14,7
bMGWUaELHZYNPKeQVgAXRcTSdFIDBCfJO,RAAATAAAdADADAFA..CACB...OAHDGADAUBFAEAFAHBGB.hAAAZEFA.PCCBeCCBQEEAhABAAAIBSFABhAAABEGAbFDCMICAaEHD..YFCFKGHD.hAFA......hCAA...,2,-24,5,29
USHfQWKbZEIYgADTLNBaVcPRJeCdOFMXG,TAAALAAA.aADD..VADARAFA.eAGHdCAAMCCBGCABHCGBhABAQDEDKDDAZFAAEFDEhACAgEGHACIB.BCHAhAAAPFHDOFFHXGFDfGAA.hAFAIHHADIAA..hACA...,2,-12,6,18
DHLEcKMCUbYBOfJFPgeZARTNSaIVWQXdG,RAAATAAA..aADA..IADAQAGAGAEAHBDAEAGAMCCBhAAACBHAUCABBDDDODCDhAAAFDFAeDHHADHA.SEFDhABAXEEAdEHALGAAbGACJHFAZGFE..hAGA......hBIA...,2,-2,5,7
eBGZYXdUbaWgDFCHOTLAINREcQVPMJSfK,RAAAEAAAQADC..MADASAFBeAFAZBCAdAHAaBGEDCCBHDBAhAAATDDAABDA.IDGAhAAAcDFB..PDHDhCAAKEHBGFDBUGFA.WFCDCHHB.....hCBA......hDAA...,2,-9,-8,1
WdALGEaHJQVgTPDSRNXYKIUZeMFbBOcCf,EAAAHAAA.QADC.TAGASACARCAA.XAEDhAAAKCEAZDEEeDHHbAGBOCCBhADAfFAAABIBaDEAgEEBhBGADFFBIGCAMDIBBGGDCGHDdHEB..hCAA......hCBA...,2,-13,4,17
fgZDLMCJHSEQPdTBcaOWYeFNbRXUGAKVI,KAAAVAAA....fACBZADBMAGBHCEBEAEE.dAHABAGBaDAA.hAAAOAHD.eCCAhAAAbDGDRFBAGCFA.ACCADEEBhCAALHBASEHH.PHDAcGFChADA......hBFA...,2,-16,-5,11
PTOQMAJVeKNbaUYCfRgcHZdBFSDGEWXLI,eAAAKAAA..aACACADARAEFHAEBZAGB.dAGBBCCADBDBGBGA.EDEBLEDAhAAA.TFGAhABAMCCBAEGB.JFHBbGAA.hAAA....fHEB...hCAA......hCBA...,2,-26,-24,2
TFdCOYIABRXLabEKcGeWVUQPfDgHNMZJS,RAAAaAAAEADEGACA..eAFEUAFAQBFDDAIBHDFAZEAASCCAhAAAdFFDOBBHACCALEEAhABAKGHB.VGDAfHBBhAEAMCIBFGGACHDB.BDFA.....hBAA......hBEA...,1,4,-12,16
aXOQVAZEJISgdYbPKGBcRHLfMUeFTCNWD,EAAASAAAdADA....bAEDGACARAGBHCBBMAEA.eAHFhAAATEEACBEBDBGBODHDhAAAACIBZDFAJEDBIGAA.hABAgGCAKFFALHFAFGGB.....hAGA......hAIA...,1,-3,-13,10
WTQKDGeUIRgcXNFMSBOAfZJdYLPCbHEVa,ZAAAdAAALADACADBHAEB.EAHBaAGA..TCBAQBGC.GCAAhABAeCFBREAB.XECAhACAMDDBODHDAAEAfCHEhAIAPEEA.bFEDKGGADEHB...gGGGhBAA.FGCD.hACA...,2,-11,9,20
WSQHKLTcaBARXGIZNDFdMgeEbUYfOPCVJ,RAAAGAAAZADBFAFDdADA.eAFAUDAA..OBHD.CCEA.VCGBSCFHhAAAHDEBLHAAhAAAaDBDBDDDABHA..XGGAhABADEHBEFAB..bFFD.....fHCBhACA...hADA...,2,-20,-12,8
fHUXgYANZRGWScKBLQdaCPOJFMIVbETDe,RAAAGAAA.SADABADBdAFAaAHBOAFDFCCA.MAHB.ICDAhAAAECHFDDFB..HEFBhAAAXDEDAEEBZFBA.KDHBLFHBhABAQEAB.CFGA......hBFA......hBIA...,2,-22,-12,10
HZEVBNcKRFLDfdJIMgeQGWTXPaOUAbYSC,SAAAHAAAEADEBAFBKADALAFBdAHA.MAHBeCAA.GCEAhAAATCCAaCGC.ACEBbEGDhACAZDAFVEEA.RFCFfFHAhAAAIHBAWDDDOHEC....hABA......hADA...,2,-10,-4,6
WADTNJBHEGOMKgRZfePFXSdLbUCVYcQaI,TAAABAAAHACA.EAFEGACAKBHB.RAEAeAHHFCAAdCEALDFAhAAA.bEABCCGDVEAA.hACAQEFAaEDDACGBDFABOFFAhAEAMEIB.fGGESHAAYHAGhAFAIHFA...hAHA...,1,-1,-16,15
fQbCPOSHFDGdBgITVecEZKJAWXLMYaUNR,LAAAaAAA.RADFQAFCCADAOAEDHAGBGCAAdCCABDAA.hABA.TCGAeDFFEDHFhADAZDDAAAHAMEEBUFDAbGAAFFGDhACA.DEIB..gGFA...hBIA......hCAA...,1,-4,-9,5
NWYcUREgaLFVBZIeSAbXODJCPQKTfGdMH,OAAACAAAKACA.GADAHAEB.....NAGA...cAGAEAHBaBBHhAFALCAABCHDeDDDhAIAACHBDDEBQFBChBAAdDGDMEAAUFFARFEFFGHB.ZGBA.SHGA.hBDA......hBFA...,1,-6,-14,8
SQVPgNaGUAfLOYTDKXWRdCZJbHIeEMcBF,LAAATAAA.XADDRACFZAEBHAGB.ECABMAFABDFAQBFChABA.VCAAgEAAhAAAGDGAABHAODHDhACAKDEDdGEAbECD.eEEBSGGDaGFD..hACA......hCAA...,2,-8,10,18
NaIAGTCXSMdVQOHLPUefbcDgJWYBKZREF,GAAATAAA.SADAdACA.QAGAHAEALAHBeCDAbDCChAAADCEBgCFFhAAA.JEAABDGAREFAEGAAhAEAaDAHADDBMIEAODHDfGHEcFFAKGAA.hAGAZGDA.NIBB....hCAA...,1,15,-3,18
XKLYOSDTZdJBHVNCGEeARWPgIQUMcabfF,RAAA..PAAAQADCUAEA.aAFA.FBFDLAHB.SBCHhBAAZCGBdDDAHFEACBGBEDEAhBEAAAAAIHHA.hCAAMCCBbEDAKEHBDDIB.BGHDNIAB.eHEE..hCBA......hCCA...,1,-6,-18,12
FTIGKcaUSRdWJLCeQgPHNZOAYXMVfDBbE,MAAADAAAEACAFADD.GAFAKAEA..UAGARBBBdBHALCCA.eDEAhBAAQEDAHECAZEGBhBBAAAFBXFFBBGFC.hBIAIHAA.aEHD.SHEGhAHA.CHHA.NIDB....hAIA...,2,-20,-17,3
VQbcCKGMdAOUJfHaPTBWXDRegINZELYFS,OAAAUAAAHADA.aAFATADA.BAFBDAIBRCBAeAGH..ICFAhADAEBBBLDDBhAIASCGHbDFAKFFAdEEAABIBJHDAhBAA..fEHAWFCD.XGFDhBAA.....hCAA...,2,-18,-15,3
MRYNLbCPdVSTAZIUKafeOJFQWHXDgEGcB,ZAAAKAAAeACEFADAHAFBDAFA.EAHBGBCA.BAHARCAALDEA.hAAACECAdFFATBFAACAA.aCHDhCAAODHDQEEAhCBA.XGFAMIAA.YECFPFDDSHGAhABA..hACA...,1,-11,-12,1
PMfDUCbWQYXVdEGTAZaOeSKLNIgHcRFBJ,aAAAeAAALADA..gADAHAGBRCCABBBDMAGBDDGBbBGDQEAAhAEA.XEEDhAFAECCBAAAAZEAAKDHBIEEAhAEAFFHH.fFGACFCB.YFHBhAHA....hAIA...,1,-7,-25,18
MQTHEWbXRgDCPfNacOGUKLYeZSdVJABIF,FAAAMAAAHACB.EAEAXACA.RAFADBBBfAGA.aAHDhAEAGCCALDEAeCFAhAFAdFCAACCBQEFAhAGAbEFACGGA.cFEC.KEHBSGDHhBAABHHAWFCD.....hCAA...,2,-13,-8,5
TQBXELcGeAOPHgIFUbaCDYVKRSNZMJWfd,HAAAFAAAUADAaACADAFA..KAFARBDAZBGB..MAIBJCCF.dCGAQEEChAAABCCDLDBAhAHAeDHHAGBA..ODFHhBAAIHHACEHA..SGDBfGDEEGGA.hAIA......hBGA...,1,-19,-32,13
HCKfJNeBYGDcQaMELSUPTXdWOZVIgbAFR,HAAAKAAA.JADAeACEGAGAQAFC.EBCFLCAA.hAAASCEBTCGAdDDAhAHAZEDAgEGAhAIAAAIBRFGFfGAABECCDFFBaGDAMIDA....hAAA......hACA...,1,-11,-14,3
JBeQWfbFVdSUDTYcGNLMOXCIgEPKARZaH,RAAAHAAAeADEQADC..bAGBdAFADBEBTCGAGCCAMCABhAAACCFA.EAHBAAAAZEFABCCDFGEAhBIASDEB.hCAAcEGCLHEAXGGC....hACA......hAIA...,2,-12,-11,1
gSYUPRFeCEKJIOGDHMTXNVacLbABdQZfW,dAAAZAAA....fADBSADAUAFARAFFeAHH.KCBAOAHFhABAHDCCMDAB.TEGAhACAXCAA.aDDAhACAbEADADGAQECA.gEFAhCAAFFDHEFFBIHHADEIB.hCBA...,1,1,-26,27
WCKOVcJbQGfSgeHEALdBPRTUXFMaNIZYD,dAAARAAAUADAMADA...aAFEZAFB.DAIBKBDA..OBHHJBHBGCABhACA..SCCDhAAAHDEBACGBLFHBhAIATEDAFEHDIGGACFBAVGEA..cGEC.hABA......hBFA...,1,-11,-26,15
PKagYXQFZWHCOGIJRbDMcTeLfSUBNdEAV,KAAAaAAA...XACBZACBHAEAGAEARCEAMAIBeAGBLECBUDGBdDDAhAAAAAGA...gEBDhAHAQEEBCFFDOFHBhAIAbEGDDBBB..........hBEA......hBIA...,2,-14,-9,5
OTVfQHXDgeaGNSKIBRWYZFdMACbJLUcEP,CAAALAAAUACA.EAEA..OAEC..TAGAQCEAhAAAHCAADCCAeAHHGCEAhABAKCBDREFAZGAAdCGDAEAB.bEGDPDDBhAGAfEDE..aGHBNIAB....hAHA......hBCA...,2,-18,2,20
YGWdScEBFOIUQXAVKgTMbDJNRfHZCaPLe,KAAAMAAADACARACA.HADCZAFB...aAGAeAHFGBGAdCCDEDHFBCCAOEEBhAFAQDEC.AECA.hAAATGFAJFGF.CFCA.LGCAhCAA..WBBD.....hCBA......hCCA...,2,-19,-18,1
JKbCZRGMXaEcAHQTBSLeWPNDIVFOYdUgf,HAAATAAALADB.eAFAPACADBIBFCAHdAGAUCCA.JCFFhAAAbCEDZDGBRCGBGFABhAAA.aCCBAAIBQFBAhBFABFHASGEAIHHA.OFFH.hACA......hAFA...,1,0,-8,8
FKNPfCYaecVZSDIQbXdUGORgLJABETMHW,EAAAHAAAKACA..fADBCAEB.eAFEZAFBDAIBQBFDhAAAdCCAGCGARCAALECAhACAAEEABFCA.MCIBFFFB.PDGBhAIA.aGHBSGHH.IHBAhAAA.....hCAA...,2,-33,0,33
TQPFEbdNcXVIWDLYgZfSaOBKMGAHCJUeR,HAAACAAAUACARADFQAFC.EBHFdAFA.XBGDIDAALDDBhAAAZDDAaDHDKFDAAAHAeCBBhBCATGGA.FHAAbDFChBEANCCA.....cFBC...DFGAhBFAfHEBBGGAMIBAhBIA...,1,11,-27,38
CEIcXOdNbVRLAHDSaUeWgfQTZJBPKFMGY,HAAAaAAA.eACE..fADAZAFBBAHAFCCAGAEAECHBXEEAhAAAdAGBbBGD..RDAAABBBSEHDhAFAUFFAQGDAhADATFCA..........hBAA......hCAA...,2,-12,-8,4
DRHLMVafFIgXJAECbGTKcdZNPWUeOBQSY,EAAAGAAAKACA.ZADA.....PAHBeAEEQBEDhAAADAEAHCDAMDCBaAHDFCCB.XDEDhAHAAAABbDFAdFFAUEGAhCAASFCHLHDAfHGFIHHA..hACA......hAIA...,1,-7,-12,5
BIWOSYCPKGfdaDLcHXMTENAJgZRVeFUbQ,ZAAARAAAeADEFADAUAGABAGB....OAHDCCAAGCCBdCCALCFBhAAA.HEDBMDHBEDHBhABAADIBJEFB..gGGAhBEAQFCA.SGBD.KGHBhABA.DIFA....hACA...,2,-29,-9,20
GgMLJfOAYBdbaSCDIVPcWTeHNFQZEXUKR,dAAAaAAA.DADA..VADA..PAFC..TBGAHBDAQCBDhACAEBBBKDAARDCFGEFAhADAMCHBLDFBhAIAODHDAAGABFECCEEAIGHA......hBAA......hBCA...,2,-24,-13,11
BYAdLeDWGFXEKMVgPUZHaTcfIQCNOSbRJ,eAAAGAAAEADAMADA..VAFAUBFAHCCAaAHD...TDFAhAAAfCDAQECBhABAODBDRFFABCHAAAABLEEAhACADIAA.XFCD.KFHB.gGEBhAHA....hBCA...,1,1,-13,14
QCWTXUfBMHSeJcNKIEDOgPYALaZGRbVdF,ZAAARAAAdADAQAEA.CAGA.TAFA.XCCCBBHAHCAAhABAeAHHNCEA.KCFDDACAODHDhAAA..gDFAhAIAAEEBGFABbFFDFEHDfGDESHAG.IHHAhCAAEGEF...hABA...,2,-15,-9,6
TWDFRfgaVLZdAEPSYUCNJcQKOIMXbGeHB,EAAASAAAUADA.CADA...JAFEQAFAKBHB.MAIBGCBAhAAAHCCABDDBTDAAhAAAFDFARFEAaDFD.ZEGBABCA.PFABhABA..YHFGOEEHbFCD.DFCBhADAfGCA.hAFA...,2,-31,5,36
geBISJVWPFTNYHDXGdAUEQKaCLZbMOfRc,EAAAaAAAZACB..MADARAEA.eAFABAHBSBCA.VCEAhAAAFCEHTCGA.HEFAhAFAGDBAABBBQGCAhBAALEEAfFHAIGHA.PHCChBCA.DBIB....hBDA...,1,-11,-17,6
eVXaGTEbSNcOJURCfAPQDMKWgILYdHZFB,QAAAMAAAKADA...IADAdAFAHBBAZAEBeAHB.aCFEEAGAhAAA.bCFDSDDBhAIA.OEGBRDCBABIBDCHBhBCALEHBBFHAXGGC....hCAA......hCDA...,2,-19,-16,3
OAbLDNVJBSTdfeGIZRFYcWHEPKgUCMQaX,LAAADAAA.VAEASABA.dAEAeAHHZAFBRCCBFCAA..hABA...cCEChACAHCGBEEBBKDCACDHAaBHFAEAAJFFAhAEATFEAGGDB.IHAA...hAIA......hBAA...,1,-6,-29,23
ZTWJEGSHMUdeXLNIFDPOKaBCVRbfQcgAY,ZAAATAAAEADEHAFB.dBHAeACELCABFAFAOAHDaCCC.CBDDRCDAQDEDhABA.AAHAJECBhACAGDGAMEHBXFEChAAADEIBBFFDfGCA.YCCFhCAA.SGHHhCGA..,2,-6,-2,4
UgVBbCMXNPIHJFSATcWDQOEGadYLKZRef,TAAADAAAEACA..dAFALACBZAGB.RAEAeAHHUCCABDFD..hBAAbCFDMBBB..XEAAhAAA.IDEAhAEAHEFCSFBAADIBQGGAaGGC.fHABhAFA.CHEA.NIBB.hBEA...,1,-1,-32,31
ZTBSKgOJedLCUcFMXPIQNVGaYfAWRHEbD,HAAAEAAAZACBTAEABAEA.KAGC..OAFDeBHFdCADLAHBCCEDFDCD.hAAAMCBB..XEADhACAQDECGEEAhADAaECBABHBWDHHREGBDGGBSDGD...hAAA......hBCA...,1,3,-22,25
CZPUAbXVFGSfTNHEBLWOadIQecJMYRgKD,XAAAGAAASADA..TADAHAFBEAHBLAFBhAAAaCDBdDFDeAHBMDABRDAADCHBhABAZEEAAAABbDDDFGGHBEHA.hACAOFCH.QFFC...hADA......hAEA...,1,-1,-7,6
aQNLVUKcWAIXfFbTeRMDEdgHJSOYZBPCG,XAAAFAAAeACHRAEADADA..dAHAHAEC.OAHDZCEACDDDGEAAhAEA..aBCDLEFAhAFAKCEAAAAAbDEAEGCA.SGEAhBAABECAQFFCNIDB.....hCAA......hCBA...,2,-18,-8,10
TdKDUVPCIWfBcORHNXFZeGaQbJMSEALYg,LAAATAAA.dAEADACAUAGA..CAEA...fCAAhABAOAFDHCCAFCCBGDEAhACAbBGDMAIBADEBKDGA.IGBAhBEABDBDRECAZFEE.eFHHaGDBQGGAhBGAEHAA.....hAAA...,1,-4,-8,4
bMaEXReKJSOPZYTDIcfGAgQBCLUdVFHNW,QAAALAAAdAEAHACA..bAFDEAFERCAA.eAHHKAHB.OCDChAAAZDEADDIBfDHAhAEAGEBAACAABFFACEEAFFCBMEGBhAHAaGHB.SFHH......hCAA......hCFA...,1,-4,-15,11
FPHeBRXWVLZAdIUQCaDfJgTOcGYSMENbK,dAAAQAAAaADA.DADAJAGB..OAEEGBDAMAIB.EBDBbCBDhACAFCFA..HDGBRDDAXEGAhAAALGAAAFFBCGGATFEAhAGA.SGHHKHAAeHEG....hAIA......hBAA...,2,-11,-10,1
baZSFMYUXCNKVEeBAHTOLIgJfPDWQcdRG,HAAATAAALADB.IAFAfACBDAHB.QAEChAAARCEFaBHDZEFB.MAHB.XCCChAGAKCADEDCBACCAOCFDhAIAgGCAPDHD.dFDAbFGDFFFH.CHGANIBB.hAAA......hACA...,2,-6,10,16
TZXWRDOQIfMKLGHYdagcbeSENUACBPJVF,BAAAVAAA.ZACA.RAGB.QADC.MAFAGCCAHBFAaCFD.hAAA.bDDBEDAA.AADACDHAFDGDhBHA.TGGADFAAOFDDhAAAKFFD.LFFA.dGAA.eHFANIBB.hBIA......hCAA...,2,-12,-6,6
KXQOJePTcAYHNIadCfZEDVWbgRBULGSFM,HAAAaAAA.dADAZACBEAFADAFA....bBFARBEALBHBGCABMDFBhAAAQDEB.eEBBhAIATDGAABBB.IFAAhACAfFGAgGDBSFHHXGGAhAFAOHDC....hBAA...,1,11,-26,37
VdfQZOBXWGYMLSRCJbEHgKaeUPcFIADNT,TAAAdAAAZABBBADA.GAEAMACARAEA.CAHB.EAGAHCCA.aCFDeBHFhAGAUECBFDCD.ADGBDDIBhBAAfCHA.QFFAhAAAXEDDLFFBSEHHJFHFKHCAhBDA......hCAA...,1,-9,-12,3
GbUcJVRWZLYQfNgFeICdKOPMDSAXHaEBT,HAAAEAAAGACAUADAJAFERAEAZCEE..LCGBQEAA..fCAEhAAAFDHDeEFBdGEAhAAAOCCBMHAAABIBaDEABCBDhAEA..TFEA.......hAFA......hAHA...,2,-18,-5,13
bHRBWTCEedQMGDVNLcafUXFPKASgIOJYZ,SAAAOAAAZADBHAFARACFBAEB..TCGAEAGA..eBHFdBBDGCEAhAHADCEALDEBhAAAaEGEXGGAKEHBADGBgGAAhABA.IGGA....hAGA......hCAA...,2,-26,-10,16
caYPGFgNQeDCLVbSJUMAWEdfHRBIKOZXT,EAAAHAAARACA.KADCZAFB..TAFA.aAHDGCDA.FAHDQCABhAAAeDAALDHBhAAAbCECSDCHMFAAADAAdFFAhADABDHAOHFEXEFC.PFHD.hAFADGEB.CHAA....hCAA...,2,-6,3,9
BEcOAMHZJWNTdCISDXPRLKGFVbfYQageU,HAAAZAAAJADATAEA.dAGASAGBDACARCCAGDFAFCAA....hAAAVCEAfCHAhAIA.aEEBeCHHEFHFACCAMDDBhABANIBB.XEEC.KFHB....hACA......hAIA...,1,6,-29,35
SGDQZWTMObAfELIXaCgYVeFHPNJRcKUBd,EAAALAAA.aADDCACA..VAEAHAFA.JCAARCCAKBHBdCFDGEDAhABA.ZDFEMDGBAAHAXFAAhACAeDHBFEAA.PEEBhAAAUGGABHFC..DFHB...WHAAhAEA......hAHA...,2,-28,2,30
FCebREaXfJAWMZPYLgcVTIHUQNDOGKSdB,ZAAALAAA.VAEAHAEA.QCAADAIBGCAAdAHABCCAeCDFhABAECGFaCFD.JDHBACABMDEBhABA..gEAGhACATFFA.IFFAODHDFECDRFDBfGAEhADAPHAA..YHEAhACA.,1,10,-20,30
ecgPOEGFCTLKHUIXNYVDaWQMBJbRSfdAZ,eAAA..gAAAEADAGAFACADALAFAHCCAXDGD.hAAAVFBAaCCAMCFABAHAREEBhAAAdDAAACIB.ZDDAOHAChABATFDAKGHBIDHADIEA.QGAAhABA.SFHBhADA.fGGA.,1,12,0,12
PZRWIbXQBOcMGCKUVHJDgAfFYdTaEeNLS,FAAAdAAAEADAeACHLAGBZADB.RBDA...bAFAQCBD.hAGAOCHDGCEAKDFDHCGDhAHADDABAAIBTGCA.hACAaFHDSEED.IGBABGFAMIEAhBAACFHD.....hADA...,1,0,-23,23
ADOdUPJLgVfaNRHFcZKQIMSeWBXGTYCEb,dAAAUAAALADA..fADARAGFHCACZDEAQAFAhADAMCIBeEABXCDAGECATFFAhACAECHFAAIBODFDhAFA.gECA.aEHD.FHBAIHHAhAEABHFACHHA.DIAA..hAFA...,2,-2,-1,1
FIMLAcCDgOBNJZbWREQKYVfTXSePHaGdU,DAAABAAAZABERACAKAFC..VAFA..TBGAeCCAHDAA.dDFAhADAFCAAMCIBAAIB.CEEC.OCEBhAAA..bDGDEDABhACAQFABXDFDaEHDIHHALFCBhADANIAB.JHEA....hCFA...,1,-1,-25,24
STgWCaZLRNQGJXPEKOefcFbUMHAYdDIBV,dAAABAAASADA..TACACAGAZABBRCEAGAEA.XAGAhAAAEDCFeCHHFCAAMEABhAEAHCGBAAIB.DDDB.gEAAhACAaEECLGEAQFFCKFCB.fGDAhAEA.cGADhAGA..,2,-19,-8,11
EKNGIgTBQZfRCADWYdVUMXceOaLFHJSbP,DAAAdAAAMADAeABALAFAHAFC..bABDEBDF.GCEA.TCGAhAGAZCEAREBAACIB.VFEAhAIAXEGAaGCD.SCCDhAHAKEHBIHHAQGCA.CGGA..hBAA......hBDA...,1,-4,-7,3
FgbCIOfHBPDNTWLVQGAaKZceUMEJXdRYS,ZAAAeAAAEADEdAEA.RAGB.FAFA..CBCA.OAHDHCFBDDDA..TCAAhABALEBAGCEAAAAAaDHDhAGAKDHD.MDDB.XGCAhACASFFDbGFA.BGGB.NIAB...hAIA......hBEA...,1,-6,-23,17
REXGbFcKZNJIMASgdUBWQOYeDaPHLTfCV,dAAABAAAQADAeACADAGAHBDCLAGBCBGB.ECBAGCAAFDAHZDDAJCHBhAAAAAIB..UFDA.OCHDhACAaCCC..TEEAhACARFBFXFGDKFHBMIBA.SGDGhADA......hBIA...,1,0,-18,18
eQLMAgTENfaCHcWKSPDBFRYbXGJdOVZIU,EAAAaAAAHACBKACA.DAEARAEF.....bAEAGAGA.dCCAZCEBeDFFhAAAMAIBAAIB..TEAAhAEACDGASBBDFEDDXGAAhAGAOEDH.IFGALFHBfGHAhBAAcGFB....hCAA...,1,-2,-25,23
QTecUgfIaCBEbASRFWMNOYGJVKdXDLZHP,RAAAMAAAOADAGACB.KAGCdAHALCCAHBDATDEAeBHFUEEAhAFA..fCCEhAAAaDHDEGCBABBB.FDGA.YFGBhABAXGFAZGBA........hBGA......hBHA...,2,-10,-9,1
MSPVAIGgaceBdJELXCRfOUbNTWHQYZKFD,GAAAaAAABADAEADALAFARAFA..OCDBUCCA...bCEDTCFAhADAHCGBZGAADBBBMCIBhAGASDAD.AAABgFGAhACAeEFBdFCACFHDfHAB.hADAWHEAKGDC....hAHA...,1,11,-29,40
DYFXOVZaJRIdTBAKHEPSfecCQbGWNMUgL,HAAAEAAA.SACEeACAQAFAGAEAMAHBLBHBFCCBOCHDhAAAaCCARCEFdDAAAAGBfEDAhAIAbEFD.UFFAhBIADDDBYHDAXGDD.......hCAA......hDAA...,2,-3,2,5
bKSAQEZRGOWULcXVCaeIYJNTFgdDfPHMB,EAAARAAAGADAUADALAGB..XAFAaBCB.eBHHIDDAhAAANCCA..TEFAhAAAdEFADAIBHFABMDIBbFDDhABAABFAZFDBODAB.cFGDCGCAFGHH....hADA......hAFA...,2,-15,-2,13
LeYBXEUFaAMGCNTOPDZgVSQIJKWRdfbHc,GAAATAAA.DADAZACB..SAEAQAEAKAHBRAGBdDEAHCDAeCABhAAAXCGDEDGBaECBAAABMDCBhACAOEHD.gGFBhACAIFEAfFHA.bFCD.hAIALHFA.BHAAhAHA..,1,0,-2,2
YHVNUBEMLDCJabRgAZcfIFeQKTSOGWPdX,ZAAA..fAAAeACETAGAGADAdCCDHCEBUAGAECAALDGBhABACAFDaDAE.RFAAAAFA.FGFHQDFAhAAASGCAODDHhACA.XFFCNCIAMIAA.DDIB...hAIA......hCAA...,1,2,-2,4
GcREMXKPAFCSLbVIdQJOUeNYgDHafWZTB,SAAALAAAVAEAdADA..QAFAUCAA.eBHH.NCCA.hAAADAIBHDDAaCDBZDFAGFDBhABAEEDFMFFBKEHBADBBbFADhAFAOHAA...fGGABHHA..hABA......hACA...,1,11,-25,36
SQBKWXbIdRTCLHgZMGEPYJOacFDNVAfUe,eAAAQAAAKADA...XACAdAFARBGFLCCBHAFAZCDAECEBPCHBhAAA..ODHDhAAAaDAADEEBAAHASEEAhABABFAAbFCDTFFAMIBA.YFHBFGGB.fHAFhADA..hAFA...,2,-15,-4,11
CAVcUgDGMYHRXQWENdKaSePbLJBZTOFIf,UAAAGAAAHADARADAQAGCEAGE.dCDDaCBE.eCEALDGBhAAAZDAAFCHDCEADAADA..gEEAhADAMCIBXEEBhACAKFAASFHBbGFA.BGGA....hAFA......hAIA...,2,-9,-3,6
DPbXWVQOATRGSBaFfIKLZgHcYJENCUdeM,RAAAGAAABADBFAFAKADAZAFB.HCDB.JAHBEBEF.CBHA.dDCC.eDADhAAAMCCB..DDIBXCGChAAAQFFA.AEGAaHGEhACALEEA.gFDG.cGGAhABA...NIAB.hAIA...,2,-42,-6,36
JYLIVFaTdEgODMWHfCBGKePUXZAbScRQN,SAAARAAAQADC..JADALAFB.FAHBdAGAECCBDAIBHDFChAAABBCAeEDFXCDAhAAAACIBbFFA...cDFDhABA...IECA.aDHD.TGDAhCAAMFCBCHHDKGGA..hCBA...,2,-39,4,43
DQEZJdOgMUIABfHFaceTXKVWRLCYSNGPb,HAAAaAAA.eACEKADARAFFLAFB.SAHBGCCADAIBECCAdDAAhADAMBHBABBBFCHH..TEDAhAAA.XFGAhCAACEFAPFEBQGED.OFCBgFAAhAFABHHD.fGGAhAHA.,1,15,-34,49
KFTdAXbJNOBZUSHRCgeIaDPQYWMfcVGEL,XAAAJAAABADB.ZACBHAEB..RAEAeAHHaAGA.DCEB..QBGChBAAMCGB.fCCAhCAAGEGAEFAALEDAhCBATFDAAAAAODHDCHAA.gGGBhCCA.IHEA.hAFA...,2,-19,-12,7
HNbGgVOBDXJKPIeULQdFSaACfZWRTYMEc,ZAAARAAAMADAHAEA.GCAAOAFEDACA.KBHBeBDFLDDAdCFAaCHBAAGA.hABA.CDHD...TEDAhAAAEFDA...bFGBBFGAhAIA.XGCC.IHHA.hABAFGFH.....hAIA...,1,-7,-27,20
JaMdOGTIPZbDAVBNXEYSceLWKfgQRFUCH,BAAAEAAA.SACAeACALAGBKAFA.QCCARCAAFBHD.HDABhAAAaCEA.dEFAGDCBhAAATFCAZEGBAAIB..NCIA.XFAAhACA.cFDCfCEF.CGHDOHEChADAIFFA.DFIBhADA.YHAA.,2,-11,8,19
PXdYRTeJNBIcZKaMASgGQUCVFbWOfLDEH,GAAAQAAACADAFAFAOACC.LAFBHCDAdCGARCDB.eDADBAHAhAAAZEFAaCGDAAABUFCA.hAEA.bFCADAIBEDCBXGGChACATGGAJHAA........hAHA......hCAA...,2,-12,-6,6
NKGHbJcXECMdAWQBeYIRTLgaFDZVSOUPf,QAAAeAAARADALAGBaACE.ZCCA.OCHDfAFA.GAGAhAAAHEAAbEECXCDChADAEGCBdGGAAAIBBDFA.hAAATFAADIAASGEHPEEBKFHB.CECDMIDAhAFA.....hABA...,1,5,0,5
IZYWXPQRGDUKFEfObBSTCcaAMgdVNLJeH,dAAALAAAHADAZABBXADDRAGFGCEA.KDCBEAFA.OAHDBDHACFAAhAFAACAAMCCB.VDDAhABAeFHB...IGDAhAGAPDHBQFACFGFD.bGCA.SGGAhACA..hAFA...,2,-11,-10,1
TZWGUVXALQbENDcBCdaYgPIHJROeSMKFf,LAAAEAAADADA.CAEAdAGA..aAEE....gCAAhABAHAGBRBCBeCBBMAIBfDFAhAAAZCEAGDCAXEGAhAIAACAAbEEBBEHAIFDASGBBTGGAUGGAhACANIBB......hAEA...,2,-8,-1,7
RIBTHSFgcaDPVLOdZKMGYUAQJfXbeENWC,QAAAXAAA.EACACADABAFAHAEAFBHD..aAGDDAGALCDBhAAAZCDAGECAAAIB.bEEAeCFBhABA.RDAASCHHhADA.PFABdGGDMIEAUFFB.fHDBhAFA...hAAA...,2,-5,-5,0
KIfaSXEQdMBVFRCPeDcHJTbNWYGUOZgLA,KAAAaAAA.EACEdADA.BAFARAEF..eAGHHAGB.TCEA..bCCDhAAA..NBBAGEEBhAFAZDGBAAIBSEABMCCBCDDDDGHBhAIAJFEB.UGAB........hAEA......hAGA...,2,-19,-14,5
FfVCZDBeaWOLIdPKJQATEYbSHXcgNGRMU,EAAASAAAHACA..XAFB..gACHRBGFMCCBfDDAhAAAZAEBeAGFaAHDhAAALEABdDHAKDDDAAIBbEFAhAEAGEFAFFDDDGGBOECHIHHA...hABA......hCAA...,1,11,-15,26
XLQfZEPGbSRWYVgTKODaeUCIFMABHNcdJ,HAAAdAAALADAZADBEAFAGBGARAGF..VCBATDAADCFBUDGBhACAFDEDAACABCCC.JFCBQEAChAEA.bFFChAFASEGD.YFHBOHFC..hAAA......hAIA...,2,-14,-11,3
EcgICMQeUGaSRKdXHAFYWBVbNOJDTZPfL,FAAABAAA..VADAOACA.DAGAZAGBLBCAECCB..IDAAhADAMBGBUDBA.GDEAhAAAREDAdEHAHGAAABHA.hBDA.bDGDTGEA..fHCBhCAACHHA......hCBA...,1,-10,-31,21
AIZBPFJKRaQeEbDVXTfUSOHCNLMgYWdGc,ZAAAFAAARACFeACE.EAFEDAEA....TCDASAFAHCFBLAHBhABAMAIB.gFCAhCAAdCEAACGABDGAKEHBaEDChBAAQGGC..bFGB.XGDAhCAAOCCHYHCGhCBA...,1,-1,-32,31
MWGVHDZXIeTdBRSOaJbUCFfYgEQPLcNAK,MAAAGAAAHACCZADAeAFEdAFARBGF...aCDAUDCAFCGD...fEEBhAHAEDDBLFFAAAIBKBBDhBAADCIB.XEAAhAAABEHAOGEACHFA.........hACA......hAEA...,2,-19,-16,3
YREIgUSBHVcCdNDfaGPOQXAMLbZTFKWeJ,MAAAZAAAKADC..eACARAFA.EAFAUCAA.HCDACAHAdCCADCHBGCFAhBAA.QEDDhBBAACIBLEFAFCHFJFCAIFHAhCAABGAA....NIAB.aFCH..OGEEhABA......hACA...,1,-5,-24,19
VJDeATEISXaPCNcQGMFYOWLgHfZBdRUbK,EAAAXAAA..aACDCADA.QAEAGAEAMAHBOAGFLDAAhAAAHCDAZDFERDFFKEDBDAIBAAGBSDHHhABAPCBBFFGAgGGGhAAAdGHA.......hADA......hAIA...,1,2,-16,18
eKUFZYVAEMOINSJcWaTCHfXgQGLPDdbRB,EAAAMAAA..OACCSACA.JAFAaAEA.HAGB.XCCAhAAAGBDBLDDAhAIAdDFAREGFeFCBFBBH.ZDGBAAIBcFEChCAACFFCfGHA......hBAA......hCAA...,1,-4,-25,21
IWePfGEAYSHTgdVJaBNLOZURCKQcDMbXF,HAAAdAAAaADALADB.ZAFARAFFQCBAMCABFCFAeCCDGCGAhACAAAGA.TEDAVEEABDHAhAAAOEBBKFHBDAIB.bGFAhAHA............hBAA......hBCA...,2,-11,-10,1
DCXQgTObHSAcfRIZPMLEUWJdGaeKNBFVY,RAAAZAAAMADAEADE..UAFAdAHAGBDA.eBFBBAHA.FCAADCCBQDDAhABAODGDHFEBhAAAACIB...fGBAhABALDGBaECHNDIACHHD.TGEA....hACA......hCEA...,1,-1,-29,28
cdDVeHZbYUKTMGJISWfgPQECaLOBRNXFA,dAAAeAAAHADAZADBUAGAMAFAGBGA.SCAAfBCAQCEAhACAECFBLDHBhAAARDCBFFFBABFADEEB.bFEDKGHBhADA....IHHA....hABA......hBIA...,1,-2,-23,21
YWQLfaFGcOJZHAPRbVUIgNEDMBCTKXSed,RAAAUAAA..IAEAEADABAFAKAGA..eAGHdCCAQCFAhAAALCDBaBHDGDAA.hADAOCHFHEGBACFBbCDDgFEFhAIAMFGB..CFHDSGADhABA......hADA...,1,-12,-20,8
KFXIENASgMRTOBWZLUdCDQbeYPJaHVfGc,MAAARAAABADBZABEdAFADAFA..eAHB..JAHBHCCAGBEAFCGDEECBhAAAABGB....TDCAhBAALEEBUEGAQGGAhABA.PFBBaCCGfGFEhCAA......hDAA...,2,-33,-9,24
JTeHPUXQRSVZgcbDNOLaWEdFMCYIAGfBK,GAAAKAAAeACEHADAUAFARAGFZCDA...bEEAOAHF.aBCDEFAAhAAA.dGGDMCEBCFCAAAFA.BDFAhAAA...TEGAhCAA.QFDB.SGGAhCBA.....hACA...,1,-16,-19,3
MGOCWIKEeRXSBQPYTfVcJabZLDUdFNHAg,GAAACAAAKACA.RADABAGB..QAEC.TBGAfBHAhAAAJCAA.ZCDALDEBhAAAdEADHEEAAAGAMDGBhACAODHFEDHFeFCF.SGGBPFHD..hACA......hADA...,1,-13,-22,9
TUADXbSCGgefBEWKVMdLHNYRcaIPZFOJQ,XAAACAAAGACA..eAEAEADA..KAFAdBHAHCDARCAB..aCFBZCGBODFDhAAATDAA.AAAAbFCAhADASEAD.BEDAhACAMDIBLEHBcGGAFHAAJHCADIAA.fHFBhAEA..hAFA...,1,3,-11,14
KFEIWSPaRMGcQeOXVTdYfLbBDJUANgCHZ,CAAAHAAAZACA.EADE.SAFBRAGBGCCA.eAHBOCFD..TCCAhAAAdDAALEHBDCABACEAKCGBhACAFFFHIEEA.hAAAaEGCMIAAQGGAXFAAfFDEhAIA.....hADA...,2,-23,6,29
FZRJGCPVWBdKfSAgQELObeXaMDHTYUIcN,EAAALAAA.eADHaACDHAEAUAFA.ICGAFCAARDEA..GFBBhABACAHB..PCBBhAAABAHAdFHASCHHhAEAACIBQGFAbDDBMFFA.TGAA.cGEBhAGA.....hACA...,1,1,-18,19
ePFMNTCbVLBOSEXcWYgQaDdfUKZGRIJHA,eAAAMAAA.CADA.LAEABAFA.EBBA..XAGD..cBGDhAFA..gCCAhAAAaCDAdDDAKDHBRDFAHFAAhABAAEGBFFEDbGAASEEDQGGAfFHAhAFA.ZGDE...hAGA...,1,-12,-16,4
AOXCZgFKaUJSYVBMEWHDfQPbTdRLNIGce,CAAAZAAAKACAaACA..UAEA..SAEHBAGA.EAGAHCAAQCFAhABATCGARDCALDDBhAGAGEFA.ABIBXFEDhCAAFFDD..YFHBMCCBfGGBhCBA.dDHANIAB...hAAA...,2,-26,-1,25
XIVfSYEMCeFLcATRHUGKZgPdJWBNDaQOb,HAAAGAAAZADBdADABAFAaAFA.QBGA.OCABbBFAXDBDhAAAVDEA..SCCDhAAAEDDAeDGBLFEBhACAAAHARFCAKEHB.gGBA.WEHHDGGBIHHAhACA.MICAhADA..,1,2,-10,12
UKLfQgOAEFYcadGHWZIPMXNVbSDJTCBRe,EAAAFAAA..aACDHACAZADB.MAEA..XAFAbBEA..DAIBTCFAhAGARDDAeDHF.LFFBhAAAQEECACCBdGBAIEHAhAIA.PFCBSFHHBGGA.fGDAhBGA..hCAA...,1,-8,-20,12
HKONaQVTdYScFeJbZRDXGCIAPgMLUfWBE,MAAALAAAUAEABAEAHAGDOAFD.QCAAdBBASCHHhAIAeAHBZCDFRDBAGDFAhBAAACHB.fFDAhBDAEDFBaEACTFGAFFHD.DDDB.CEHB......hBEA......hCAA...,1,-7,-11,4
WdGLMENgfHYcUQZCeJXDOATaPFbRISVBK,aAAAFAAARACF....SACHKAECGAGAEAEA....fCEAhAIAHAGBcCDBZECAeDGDhBAADBBBAAIB..bDFABGBAhBGAdEAAMEEBgGGAQFFA.XGBAhAEA...hBIA...,1,2,-25,27
WSIHGMQTfVAFEXNJZUgedCKRbacLBDYOP,EAAAXAAAZACB.UADAeAEA.dBHARAFA...aCBBLCHBBCEAOCFDhAAASDBA.hAFAHDFDGECAMEEBTFGAhAIAAAAAFGAANIABCEEDKHEADFDB....YFFFhAGA.IHHAhAIA...,1,-8,-12,4
EMfBYaNVXSFPCUTZQLRgIcGdbKDAHOJWe,HAAAOAAAeACE.EAFEMAEABAHB.aCCAXAGA.FBBHCCFAZCGBhAAARBEB...gDDGhCAAGCGAbDBAADIBfFCAhCFAVGCASFFBTGEAIHHAhBAAdGGA......hBDA...,1,2,-14,16
cIVUgDLTFKHbeWYZdMXfBQSAJaEROGNPC,EAAARAAAGADA.CAFA.IADA.UAFALAHBKAHB.HCFBhAAAeBCBZDAAdDFAMEIBBDHAhAAAABHBaFAAOCEH.PFBBhBFAgFDA.FGGBbFGD...YHDEhCAA...hABA...,2,-11,-11,0
UNAZXPECOceMKWgdaSYbLHJTBVfRFDQIG,ZAAAEAAA.OACAeACAMAGBKAFA..dAHAaAHB..SCCAhABALCCAHDAABCFARDFAQDGAhAAAGFCBAFCACFHAgECAhADA.bFEDJHFATGGA...hCAA......hCBA...,2,-25,12,37
UGVNRAFESKZWHdafgCTJLQMIXOcDPebYB,EAAAZAAAHAEAdADA.aAGACAFALAHB..MCABOBCHDCCBeCFAhABABBGAGDEARDDBADIBKEHD.hACA..fDGEhAAATGCAQGFCXFAAbFCDYEABUGGA.hAFA......hBDA...,2,-12,1,13
GFSbfQWOKIJdUPTLcXeMgZEDVaHYCNABR,RAAAGAAAFADA.SADAQAGAKAGAdCCAUCDALCFB.eDHBhAAAZCFBECHF.aDAHHEDBhABACEHAAAAB.bGAC.OFHHhAGAIFDA.TGAAMIBADGGB...hACA......hADA...,1,8,-23,31
OBaeRYUACDWMgKVfSNdcGZXFPJTILbHEQ,DAAAMAAAKACA..SACAdAEAZAFB.FAFA..TCCALBFAhAIAHCGBEBBBBAHARDCAADGACDHA.hBAA.VEEB..fEFAhBAANBBA.XFDDIGHAQGGAhCAA...hCAA...,2,-32,-13,19
IJDSXTWCfFRMVPLgENUKZcGBdOaeQHbYA,DAAATAAACACA..RADF.MACALAFB..EAFAKAHBGBDABBBD.hAHAaAHDHCGBABDB.SDDDhBAAfCFBFFCHgDGAhAAAZEEF.dGGAQGGCIHBAXFEDhBHA.WCCDhCAA..,2,-27,-1,26
HKeZfGbcWQRXaFdVSMNPYUABODgTLJICE,DAAATAAALADA.CAHA.HACBZBBAGCEAbAEA..QCEAhAAARCGBFEAA.dDGAMDDBhAEAPCABACIB.OEEBhACAJFAF.EFAAeFHFfFHAXGCAaGAESGFHhAFANAIA...hAEA...,2,-10,4,14
ZWcVODGJBgFIPfYNHRaTdLMUECQeSKbAX,ZAAAVAAAGAEA.BADBFADA...IAGAfAGA.HCDAhAAARCAAdCHAMAIBEEDBeDGDhABAbCGD.AAIB..XGGAhACAODCBDEFB.gFCHPHDC.aGABhAGA.TGGACFFD..hCAA...,1,-7,-14,7
gdJcDHVTRPLCKNFQUXYIaOfSAebGBWEMZ,eAAAGAAAEADAZADAdAGADAEAHBEBRBGF.LCCBKCDA.QDGAhAAAUEEA.XEEChABAaDCHSDHHAAIBbGBCMICAhBGAJHAA.TGGA..CGHA......hCAA......hCBA...,1,14,-29,43
aGBDfNUZcFSQPTbKXMLEeCdVgJYWIOAHR,HAAARAAAGADADACAUAFAZAFAFCCH..QBDA..bCFDMAIBhAAAECHB.eCCB.dDGAhBHAgDADJEEB.hCAAIFDAAEIBaGGABHHDfFHA.SGAAhAAA.KHEAhABA...,1,-9,-21,12
dAObIMDceGYQLHXfZgBVTJCSPUKFREWNa,OAAAMAAADAEAGADALAHBHAFA.ZCFEBBBATDBACBDA.SEFAhAFAKBFARDBA.EFHFaDFBhBAAAAHA....IGEAhBAAeEFHQFBBfHCBJEHB...hBBA......hBDA...,1,-8,-25,17
CXMcOTEBJaRQdWAZgefDGLbNYVKFSHUPI,eAAAGAAALAEA..bADAVBCBSAHBHCEBUDGACCDAMBHBhAAATFAABCFDRGCAdGGAhAAAAADAZDCADAIBKEGD.FFAA.hABA..IGHA......hACA......hAFA...,1,1,-21,22
CRgTNPHYKXeWJbfSVOAaEQMGFDZLdcIUB,EAAAGAAAZACBLAFAdADAUAFARDBF..TCEAHDDBKAHB.eDGBhAAAbCGB....SCBDhAAAADHAaFGH.MDIBhAGADEIB.BECA.CEEDgGEA.PHAAhAHA....hBCA...,1,-15,-18,3
GfTLUeYVHcRNIDXQgMWdKSCEFbaOAJZPB,ZAAAGAAALADBeADAHAGBRAFADCAA.QCDA.MDABdCFDCDHAhABAEDCBaEEAAAABBDGD.hACATFDAVFAA.IFHAhACAXFFAKGBASGHHbFFD...hADA......hAEA...,2,-23,6,29
REcBLNgOMUJGeDZPXQFAKfISHdVaCbWTY,KAAASAAAHACBaAEACADA.....TBGAEAFALBHB.hAAAOCCAMBFBGCAAhACAeCFFZDAAQDGBhAHAAAAAdFAAbEFD.REDBBFFB.NIABJFHBDEEBFHCA..hADA......hAFA...,1,6,-13,19
bcPFAGMaKdNCfXSURIeEJOYBTVWZQDLgH,aAAAdAAACADA....SACHRAEFEAGE.OAEABCBA..TCGAhACAZBDBLBHB.hADAHCFDbDCD.FFCAAEEAGEFAhAIAMBBBfFFE.IFHAhAIAeFHH.YHCA.hBAA...,1,-7,-25,18
CPdcDFKSVEbXWTHNYfUOZBLAQgaIMJRGe,aAAAMAAAGACA..eACAdAEBFAHBSAFAEBFB.XBBChAGAHDFC..fEDAhBAAZBFEACEBQDFAhAIAgFFBIGGA.CDDDDDIB.KHEAWBBDhCAA.NICB.....hCIA...,2,-14,-12,2
BedZcGDJCQWHSPVbfMFaYLTKgXIAOUNRE,OAAARAAAEADE.dAEAGAFADAGA...QCCAHBCBSBFHhBAAbDGD.MBBBFAHFaDFHhAAATDGAKFAA..IHHAhABAABHABCHBeEBF.ZEEF.CGGB....hAFA......hCAA...,1,-11,-14,3
afdQWBCYXAUJVFMIKRHbETSOeLNcgGDPZ,VAAAMAAARACA..HADBEAFE.OAFALAHB....gBFBhAAAGCCBZEFAdDAAQFCAhBAACDDDABIBFDFHbEGDeGEEhBBA.DCFA.aHGE.BHEA....hCAA......hCBA...,2,-14,-5,9
AbCaDEcLgQIHXZPNURTKSBJdfMWeYFGVO,aAAAEAAALADA.QBGAHACBZAEAPCECRCBAKCFD.BAHBhAFAdEAAMEEBeBBDGEEAhAGAAAHADEIB.IEHAhBAAXFFA.NICB.SGHBfECA...hCAA......hCIA...,2,-13,-7,6
eYKRgEQLcMfSUHZTWJBOGAadNVFIbCXPD,dAAAFAAACADADADA.KAFARAEF....EAGELAHB.MBDBSCCBhADAHCEBZEBATCGAhAIABCBAACEBaEDD..IEHAhACAbFED..eEHFQGCCfGCEhBAAUGFA.....hCAA...,1,-16,-26,10
YEMFIBOcGAVWSZgDPbKXdfTHCUeNLaRJQ,SAAAZAAADACAKAEA.dADAHAGBUAFALCCARDBA..QDFAhAAAEDFFMDIB.BAHAGECAhABAACCBVFDA..gFGDhAGAPFBBfGHAeHEE.aHEE.hAIA......hBIA...,2,-11,-11,0
HbJfcKFeRWOAYIXLNGPaDdVUCTEMBgQZS,XAAAGAAAaADAdADAUAGA..EAFAMCDBQBGAHCEAJDHBKCEAhAAA.RDBAADBALFFBhAAA.DECBTEFAZGBASEEDhACAbFAAFFEHeHEA......hABA......hAFA...,2,-6,-2,4
eHFCJSLGbOMDIZPQKfaBNcVYUdEAgTWRX,TAAARAAAHADBCAFA.LAHBGACAMAEA.ZAFEQCFAhAAAKCADaCEEBCHAVDAA.dEEAAEBAXEEAhAAAeEHFSFADhABAbEGD.DGGBfHCBYHBG...hADA......hAFA...,2,-7,-1,6
faeSGFWVMdJIZABLPUKDEbRHXOCgNYQcT,LAAAKAAAEACE.HADBCAEB...NAGAQCAATAGA.eAHBhABAGCCAFDDH.MCFBdEHAZFAAhACAACCBBCGDDFFAXGGChAFAOCHD..gFGBfHDFaGAA.hAIASGEA.hBFA...,1,0,-25,25
AUcSgVRDNIfPCZFXWaYTbEGHKOMLQBeJd,SAAARAAADADA....fAFAZACBXAEA.aAHBbAGDhAAAHCEAKBDB.MBIBLEEAhABAeECBAAAAUGCAgEEAhAFAIGGAFEHHYCCFEGGB...hCAA......hCBA...,1,-8,-20,12
gLJbadCRMAcNeDVSUKQPFHOBYGTXEWfIZ,eAAASAAAQADAHACBBAEAGAGAEAGAICCAZBFELDEAhAAAaDEAREEB.ADIBDEAA.KFFAhABAODHD.TFBAhAAAfGAA.bEAAdHGBMFIBcGAC.hAEA......hAGA...,1,7,-13,20
EbQaOGCfAHKPZYIRNeFUMXgJWTBdDSLVc,HAAAZAAARAEAFBHDMACA.JAFBBCAA..dAHALDDAEBDF.QEAAhABAGDEBACCBKEDD.hACAIFHAeEFAXFDChADA..gGGGTGGASHAAhAEA....hAFA...,1,-18,-22,4
IBQPRbLNTDMVcWedFgKUJHZEaXGfOASYC,CAAAQAAARACA.LADATAGADCAAMAHB...VCDAeCDAhAAAdEAAKCHBHEFAZDAAEDGBhACAGGCB.AAIBSDCDhAAABEEAbFAB....cFGCFHGE..hADA......hAFA...,2,-26,6,32
MCJFGUEfKZWNaVBYSIAXQHdeDcObRTLgP,HAAAeAAAOADCRADFLAFB.MAHBFAGAECCAZCAA..aCHDBCEASEEAhAAAAAAAdCGADCIBTFCAhACACEEAGFAB.KFGAVFGBhADA..XGDA.....hAIA......hBIA...,1,-1,-22,21
NJSfcFegGAMDWZBaERHbOXVCTYUPdKLQI,MAAAZAAAEADEHACC.OAFACAFBUCAA..dBGDLAHBQCCChBAAJCDB.fCFEhBBA.eDGHABHBBCFARFEB.hCAAbEFA...TGEAKHGASEHHhCBAFFCHDEFAaGGD.....hDAA...,1,-2,-20,18
UeRXTQDfEadgWYSFPBVCZKLOcAINMHJbG,MAAAHAAAGADARACA.TAFAQAFCEBHFdCAD...gDEHhAAASAHBBDHAhACAZCCALDGBAAHAJFAAeFGBhADAfECAaFHF.FEEH.CGHAOHCAhBAA.NBBA.....hCAA...,2,-18,12,30
CZKUAFLBMcbDGOVRPEgYXIJTNWaHdeQSf,LAAAMAAADAEAGAGARADFEAFE....XBGATBBAaBDAHCAAhABA.eCEHQDDAhAIACDGAZFFAAAHABEHAbDFDODHDhBAAgGDBIGBA.NIBB.....hBBA......hBGA...,1,-3,-12,9
NbWVgUcMfDFHRSdAaGeXLBECQJTYZIOPK,eAAALAAAEADA.QAEA.TAGAZAFBOAHD.KCCAhAAAbCAAgDFAhABAUDFAMCEBFECAHEAARFBBABFBaEHDhBHABDHA.CFHAIHHA.NIAB.cGGChCAADCAA......hCBA...,2,-13,6,19
eXKWfANQOGgcJaLPBYDMdEbIVZHSRFCTU,QAAAGAAAJADALAGBBACAMAEAdCDAEAHF....bCEDZBDBhAAA.HBFBREGF.TEGAhCAAeDBHKGCAACDBOEFHhCFAaGEDDAIBSGHH......hCIA......hDAA...,1,-12,-13,1
cSgNRXdPJVCQEIFLBGHebMUYZKDTAWfaO,aAAASAAA.RACF.dADA.VAFAEAEELAGBHCDCeBBBbCDDMCIBhAFA.ZEEADAIBADBBOGEChAIANDIA..XFCChAAACDGA.QGEA.BHGB.hBAA......hBDA...,2,-13,-8,5
WTaPJBUQGEdRIHADCYXOVZFgNeKfLcSMb,CAAAOAAAZACA.FADDeAEELAFA..MAIB..bCCAaCCABBBDhAGAGCFARCGBHEFBACHBDDAAhAAAXGCA..hAHAgFDA.fDDESFHHhBAAPFHB.JHAA.hCAA...,2,-18,-17,1
NKJAFQbBITfODacMUVdEXSGRgZeHYLCPW,QAAABAAA..TACADADAaAEEMAEAdAHA..EBDBGBEAhAAARCEFZDGBHGCALBGBCGHA.hAAAPCAB.KCCDADDB.hBCAbECD...OFGB.....hBHA......hCAA...,2,-16,-14,2
EORHYQFDJVWaGUgLbCMAZKdISPcNBfeXT,dAAASAAA..PADABADAeAEHEAGAHCACQAGAhAAA.DCCBVCFAGCFAhABALEDBbDADADABZFDBKFCDIFFAhACAfFHAOFHBRDCFFHFC....hBAA......hBCA...,2,-18,9,27
NMILeBTfQcOFSGAPYZHXJdEDRCUgKWVba,ZAAAHAAAdAEARADFCAFBKAGA....VBGBaCAA..MCGBeCAB.TDEAhAAAQDAC.FCHBhABAAAHAXEGAEDDA.hACADCCBgFEBbFCBIGGALGAA.hACAfEHA.hADA...,1,-12,-13,1
QVHJNRacPYCDOEFGLIMABUTgfWbKdSeZX,TAAA..fAAAKACCdAFAZAGBQADAHBDBREFA.aAFE.hAAA.PDCBDAIBEBCBLGEAhBFAACGABCAAgDAAhAAA.bDEA.eEDB.JFFBNIBB.CGAAFHGEhACA.MDIB.SGDDhADA,2,-19,5,24
YCSIXKgGcMTVeLRUNbaAJFHWPZfBOEdDQ,HAAAZAAAOACAEADEdAFADAGAQCAB.SAHBKBEAGBGAhABAMBHBeCCBRDCAbEFAABIBFEEAhBGA....fFDAhAAACFDAXFGATGEA.....hCAA......hCBA...,1,10,-31,41
CHBPdTfWNGKLcQZYObEXRIeFUAVDJaSMg,DAAAaAAA.MADAHACBBAGAdAEB....TBGA..fBBAhAIAGBEALEGBhAHAZBEAbCDCRDBBeBBD.AAIBSEEDhBAACDHA.NDIA.QEEA.hCAAEFHB.....hDAA...,2,-24,-7,17
FfVBMaARNcSOUYGPTEdXCDbKLJWZeQIgH,RAAASAAAOADAGAGAEADA..dAGADBEBLBFDZCCF.eBHHhAAAQEECHCCBfDAAhABAMDIBAAAAUGBATFFAhADACCFDKGGAIGDA......hAIA......hCAA...,2,-17,-11,6
XcLGQeVgaAdPBJSUZINROEWDMTfbFKCYH,dAAABAAASADAZACARAGB..ECCAMAGB..TDAAFAHBCCBAHCEBhACALDEBeCHFaCGHAADAUFGBhBAA.ODCDhBCAfEHA.bFAA.XGFD..hAAA......hADA...,1,-13,-26,13
QLDISaMZAgfdYXJWGcRTHPebUONEKCFVB,dAAAXAAAGADARADA.HAFA.eCBFOAGDECGAFDFHQCDBhAAA.LDABSDDDhACAZDFEAAIBfDHAhADAJFGBTGDAbFAC.KFHB.BGGDaGAEMFIBYHAGhAFA.....hABA...,1,16,-9,25
MULWJgYEVFHXAZQCPdbeaOfGSDBTcINRK,ZAAAQAAAdAEAeAGBaACEGCAA.BAHBTAFA..IDDAhABARCDAMAIBLDABhAAA.gDFAhADAECFFHEFAAACAbECDSCHHDDCBKFGAWHAG..hAFA......hAHA...,2,-16,-3,13
SHIBaUDKXAEGLCgRfOeWdYTZcFMQbNJPV,EAAAGAAALADARADAeAGHdAHAZDCAFBCH..MAIBQCEA.hAAAJDHBSDADhACAHEAAaECAKFFBACFBfDGAhADA.OEHDTGDAbGAA.PHFCBHBADGIBhAAA.....hAEA...,1,0,-8,8
GCJEHNZfBDWITgeOcRFMKSYQPUbadVLXA,GAAAEAAAHACAZADADAEA..TCDAeAGFRCCAMAEAKBHB...QCGAhAAAbDGD.dEFALEEBhAAAAAIBCDCDJFCBBFHAhACAgFCAFHFA.........hBAA......hBCA...,2,-11,-8,3
GgRFdWXHZDeOCSYAEPfQTBNVIULbcJaMK,EAAAQAAABACA...IADALAEAJAFAaAHD.GCCAhAAARBDAdCHAHDDCeCFBSDHBhAFAADGATFGA.UFFBhAGAMIAAFGCH...WFEDDGFB.....hAAA......hAIA...,1,-8,-18,10
ZaWJIReTBOdFQYCXNGPHDcfgVSEAbMLKU,MAAALAAAZABE.aADD..JAFARAFABCAA.dCFDQBEDhAIA.XCCDGDDAHFAAhABADCHB.fCCEhACASDFDAAFAbFGBKEHBIGEA.TGGAhBAAFHEECDHA.NICB...hCAA...,2,-32,0,32
AcSYJCQUOPbHWIXMDZEeGgBFVaNdLTfKR,SAAACAAAUACA.OACDHAEA..XBGAZAEAECEAGDEBhAAA.FECBaCBCdFAATDEAhAAARFFAAAGA..JHDAbDGDMAIBhABAeEDBBHHALGAA.KGFD...hAFA......hCAA...,1,-4,-7,3
aUcTXHGVEFbgQMLOIKRDZdBNSWfJYePCA,aAAATAAAHACB.EAEAFACA...QAFAMAHBLCFBKAHBRCCAdDGAhAAASBBDJEEBeFAAhAFAAAIBXEAA.hCAAbEDBOFHDZFGBBDHANIDB.fGBEhAEACGGC......hBAA...,2,-6,-4,2
GCUFEONgPBRVSXAJdDHYITKQeLWcMfZab,dAAAHAAA.TAEAeADALAHBMAHB.aBEEGCABFCBD.ECFFODAHhACAgDGARDCFSEFAhADAAACADAIBKEAAQGDAhAEAfEEECFHA.PFHDXGGCIGAAhAAA.WECH..hAEA...,1,-3,-6,3
PaBbHJFXNLdQGOKTAReDCgESUcVZfMYIW,RAAAeAAACADB.EADAUAFAZAFB....MAIB..ICCAaBDEHCGBhAAAFCEHLDDBGDFAKAHBhAAAACCBSFEHhABA.fGGAPFBABDHAJHBA.dHDB..hABA......hBFA...,2,-30,3,33
KDeZXacWOGURHMfYVTIJBgNSEdQbLPFAC,DAAAeAAAZABE..aADDOAEDRAFA.HAGBMCCB..VCCBJCGBBDDAhAAA..SDABhADAEEHFdFAALFDBhABAAAGBXDGA.GFEBfFFEIHHA.hAFAgGDG.hAGA...,1,-9,-25,16
HZdBfWTISRFVgCeQPUJaNEGbXAcLOKYDM,LAAAKAAAMACAHAECdAEABAGA..TBCARCAAFBHD..CCFA.eAHHhAAAUEDAaCED.GDFAhAHAACAA.ODHFZFFB.fEDEhCAASEBH.....gGAGhABA.PFHDhACAEHGA..,2,-27,-11,16
gcYbLEICaZQAFdKGPBMSeWUJHDXTfVRNO,dAAAGAAAMADAeADAUBDAHAGB.DCDA.TDDARAGBOCBD..hACAgDFB.hAIAbEACEDFF.aDHDAAABKFFDhACASEEDXGBAfFCANEIA.LHEAhBAACHGA...hADA...,2,-19,1,20
LcDCKGOABQRPUJYfSTadFZgNVIeWMXHEb,RAAAUAAA..JADASADAdAGAZCCA...VAGBeBHH.MDGBhAAAHCBC.ECEELECBhABACDADGEABAEEBBEHAQEEChADA.fDHAaFFHFHGE.gGABhAEANIAB.XGEAhAGA.DFIB,2,-25,13,38
DKEOeZaSbYgXMQBfJIdAPNCLHcTRFVUGW,CAAAHAAARACA.FADAGAFAKAGA..ECABeAHBZCCA.aCAA..SCEEhAAA..bDAAXCGDhACAMDHBQEEChAAAfEEEdFAAACIBLFHBcGGC.TGAAhAGA.....hACA...,2,-16,-6,10
QMJKAbFWSgdNOCVDGcLZaYUHPfTRBEeIX,FAAASAAAdADA.CADA.GAFAZAEB.aAHFHAGB...TDAAhAAAECCBeDBBQCCAhABAMDFBAAFB.bDFA.gFFAhADAODGDDDIBLGBAPEDDBGGDIHHAhAIAKHBA.NIBB....hBAA...,2,-22,14,36
FaOGDBbCWIZYPRLUTJMNKcXQdegVHEAfS,FAAAGAAABADACADAZAEBRAEF.LAHBUAGA...MBGBKCCA.QDCChAAAeDABHDECABHBaDAHhACADDIB....IGGAhADATEGAJFEB.XGGAdHDB...hBAA......hBIA...,2,-33,-4,29
DABTdEHfgSbIWPFCeZOGNMYLQVXJKRUca,dAAAHAAASADA..bADB.IAGAFAGAeBFFGCCAhAAAMCCBLCHBQCABhACAXDDDRCFAaEFCAAIBEFBBhBFAfDAAgFGACDGAZGDAOHEC..hCFAYGFC..hACA...,2,-24,23,47
ITedYHNSQBfCAFEOcDLgbRWZMPUJGXKaV,EAAADAAALADARACA.ZAGBMAFAUCBAGBEB.aCCCTEDAhAEAeDABHDEAQFAAhAFACDHBABHAOFGB..bFGBhBAA..WFHBXGCD.KGEA...hAAA......hADA...,2,-12,-10,2
ADSaEJcCKTNGYebXFQdVOgPHIZWURBfML,aAAAEAAA..CACA.KADAGADA..eAFEFAFAdCGAOBBBHDEBZCDARFBAMAIBhAAAABGBDCHB..SDADhADATGGA...hBFAbECA...QGFAPCCB.WCHHhAIABEHA.....hBAA...,2,-31,-3,28
JRHUYIXQDdcEPKFAOVZMCWaLNSgeTfbBG,ZAAAMAAAaACALAEA..SAEHeAHHTBBABAGARCEBHDBChAFAICGAQEGAhAGAdDDAEDHFFFEDACGBCGGDNIDB..hBAAbGAA...UGGA.DAIB....hABA......hAGA...,2,-21,4,25
CGeXLWOHDPRIQUBJSgdAcfYMVNaTZFEKb,...fAAAMAAAaACEZAEBEADA..CAFAGAGAeAGFLCCBhAIAHCAARCEBQECAhAAABBHASBBDAAIBVFGBTDGAhBAA.KEEAXGDADFIBIGGA..hCAA......hCEA...,2,-24,11,35
WdaLePCGKcDZbgTFHUQfNYMIREXSJBOVA,aAAAeAAAGACADAEAZAEE....TAEAHBCBQCFAhAAA.fEEAhABAMAHBECFFSBBDhAEAOBHDAFCAdFGALEEA.KFHB.bGAA.FGEANIAB.hAIA......hCAA...,1,-3,-15,12
UdCaTLDOJIeYPZFKGgMHfWQbcEXBNSVAR,RAAAdAAACADB.aADALAFA..OAFDeCCAZCFBGBDAHEGBQCBAhACAEDEFBCHASGAAhAAAAAHATDGADBIB.IFFAhBAA.FFHDMIEAfHBBWHAA.hABA......hAGA...,2,-17,-11,6
FLBPWRMeAVTcHdXGgENDZbIYafUOQKCSJ,TAAAHAAAGADA.EAFAZACB..bBGDaAED.OAGBQCABhAAASAHBLDFDhACABCADRFAAAAIBdDEAXGCAhADADCHBfEBACFHAFHFA.MDIB.eEGB.hAFA......hCGA...,2,-16,16,32
BeRaKZfUOTWAcDJFPbEgLCYXSQVNdMHGI,DAAAFAAAEADALADA.CAHA.SAFA.QCCAhADAdBBAHCEAGDCAeAHHRCEBZEGBhAGAOCHDACGB.PEABhAEA...bFFB...YHCGNIDBBGFC.hBAAfHAF.hCAA...,1,-9,-18,9
dfbCBNPFLDgAKSRHYXOWeQTZUIJaVcGME,RAAAHAAAOADAeACEZAGBUAFA...aBHDGBDAECCA.dCCCCDEABDGDhAAAFDHDLFCAAEDB.hAIASGBDXEGATGGAhBHAIGGA........hAAA......hABA...,2,-24,-14,10
VfYWJCULHQTgIFZeGcDPNKMBdRSbOEXaA,VAAA..fAAA.JADALADBHAGBQBCChAAATAFAFBHDeCAFGCEAhAAADCFBKDGDdEHARFAAbEDDEDCBAAIBCFFDhACAgGGG..IGAA.hAFAPHFCMIAABGDAhAHA...,2,-4,2,6
AERHXbTVIJBDSCaMONeZQPFWLGdUYfcKg,HAAATAAAVAEA.BAHBCACB..aADDMCABeAFAZCCA..QCEAhAAAFCGDGEAAdCHAfECBhAAAKCCDEEEBRFAAbGDAhAFADCIBOFFA..NIBB......hACA......hADA...,2,-12,2,14
QACUgGOVZcMRSKEYJFaNIWbDLfXBTPdHe,CAAAGAAAZACA.RADAEAGEFAFA....aAHDICFA..bCCBLCHBhAAA.BCDDhACAdDAAHCECAADAOEEAMDIBhAAAKFFDNEEA.fGHA..TFFAhADAeHDG......hAEA...,2,-25,-10,15
TUfJLbgOPcRSYMQdNHDFXKeCaBEVAWGZI,ZAAATAAAUAEA.LAHBOACA..RAFAMBDBdCAAHDDA.XEBDhABAeCEBaCGD.EEHFABHBGEGAhACAJFCA.bGBAgGAAhAAA.SGFHYFFF.DCCBhAGACCCD.BHHA...hADA...,2,-8,-1,7
USFAGXTLHCJZNcYadDQPRbVEeMWgIOBfK,GAAATAAA.HADAZACB...NAHA.aAEDdCDDQAGARDFB.ECABhAAAeDADMCGBgGAAhAAABDEAKDHBFEBDACIBCEEDJFHBhACADEDBbFFC...IHDA.fGAEhACAXGCD.YHFGhAGA.,1,2,-15,17
gPdFKERXQTJDVICGfAHcZeNbYOUSWaLMB,HAAAeAAA...bADBOADC.SAFEaAFDMAHBBCADdCCAEBHFhAAARCCBQDGBhAAADCFB.CEFDAAIBZEDEUGGALEHBhABAFFBBTFDAIHFA.fGCEhAIA.....hACA...,1,-2,-13,11
EeFJfHYIAWXbBCDZQgKPNUMLRacVTSdGO,XAAACAAAZACA.KADAUAGA.RCCA...aAFA..TDAAGBEBhAAA.ECDBeDFAFDAAHDEBhABAAADABEEDQDGAhADA.gGGAMEIBLFAA.SFGBhAAA.OGDChAFA.,1,1,-30,31
YQUHMdKBOJgXVRbFAeILScfWaGNTZCEDP,eAAALAAA.SADHfADAGAFAZAEBEAGADAIB.QCAAhABAHCFBdDHAOCCBhAAAXDDARECFABIB.IGGAhABAaDGDTFAACHCD.PFHDMFFB.BHAD.hCAA......hCBA...,1,-3,-6,3
HOPWKUJdITagLRCefcGXFZSYMDbVBNEQA,HAAAOAAAKADCdAEAaAFDRAGB....eBBAGBGAZCDE.MCABDDIBBEEAhAGAECCAAAHA.UGEA..hAIATDEACGHA.XFBAhAAA.SEHH.bGFC..hACA......hBFA...,1,-11,-35,24
aAcDeLVPUHCWYdETOMFgGQBNbKZIRJSfX,eAAALAAAUAEAHADB.CAFAdAHAEAGAMBDBGCAABBHAKCFAREEA..hABASDFA.hACAaDHDACCBDDDB.PFHDhAFATEBAFHBAQFDA....hAAA......hABA...,2,-29,-10,19
AWMTaVHRCbFDEJIKgYQGOBZcUdLNXPSfe,MAAAaAAAHACBRACA.FAEAEAFE..KAHB.QCEAGCCBZCGBdDGALEFDhAHA.XFCAhAIAfEBAABBB.TGGAhAHACGGBDDIB.IHCA.OBBH.hBAABEEDNIBB....hBAA...,1,-11,-18,7
TZadCJRBgeVGDNKPMcEQAHYUbWXFIOLfS,HAAAUAAA.XADBOADALAHB..TAFAdBDARBFFeDCBhBAAGCABKEEAMAIBEEHB.hBCAACFBbCGD.FEEBSFCDhBHAaGDCBGGADGIBcGGAYHAA..hAAA......hACA...,1,-4,-13,9
DRcXNbHFAWPeBfEVOaKMCGQdSJZTgILUY,eAAAEAAA.OADCaACDKAEAGAGA.dCCAZAGB.TCDALDFBhAAADBIBREAAXECA.hAAAHFAAACBBBEFAMDIBQFGAhAEASFHDgFCA.IHEAhAGA...hABA...,1,-9,-14,5
adRJcVTebfEAZWKLBYXHGQFSMgINPDOCU,ZAAALAAABADBHAEBGADAQAGAMAFA..IBGAhABADCAACDDAdDGARCAAJCHB.TFBAhACAeEFDEFHF.ADIBKGAAhABAFDFBSFGA.gGFGhBFANIBB......hBIA...,2,-16,-11,5
PQYMNZIdKaCeTWOgfbSRHBLcJDGEAFXVU,XAAAUAAAQADA..MADAZAFBdBHAaAFEeAHHOCBE.hAAA.bBCDHEEALCFBhABADDABAEGAFFBAPDHDIGGAhADATFDA.fEBEBHCA.cGGAhBEA.....hAIA...,1,4,-20,24
UgBCeFTDQKJHdAESWbRcOVGPMLZafNIYX,EAAASAAARACA.OACDGAFA.MAIBaAEA....fAHAhAAAIDAAXCCAhAAABBEAeCFFDDFBQDGAhABAHDGBAAHBbFAAPEBANIEB.gFGGhAHACGGD.....hADA...,2,-12,-12,0
KIRHdSJagWXENBUVLCbYGMZOPQDcAeFfT,eAAATAAARADAHAGB.dCCAaACA..XDFCEAFABAHALEABhAAAbBDC.GEDAZCEEQEFAhAAAAAIBKFHBSFCDhABAgFAAWHFGNCIACFED.MHFA.DCCB.hAEA......hAGA...,1,1,0,1
gDEfJMFbGAXRQBOdSTeNZPIHVUaKcCYLW,RAAAQAAAdADA.eACAZAEBHAGBUAGAKBEBCCCDLEEA.DDIBhAAAECDB.MDABGGBBhABAADGAODHDTGGAIEFAhAAA...aGBA...cGGAhADA.YHEA.hAIA...,2,-19,-9,10
AEGYPWNSJZCdTcaHQOKRDFVULBegbXIfM,EAAAGAAA...PADASACA.ZAEBdAHAaAGDHBFBQCCAhAAARCDBFDCHLEHBhAAAeBHHbDADfFFAhACA.AHBANIDBTEFA.KFED.DDAB.BFHAhADA.XGBAhAIA.MIEA.,1,8,2,6
ESgaBDYVWOXbMQIKFdHcNAfTCUReLGZJP,TAAARAAAeADEZAGB..EACE..aBDDDAEA.VAGBXCED.hAAAMBIBQCCAhAIA.FCFHHEFCADIBCEGAGFBBhBFASCCDBFHAOGAAKGGD.dGGD.cGCDhAAA....hABA...,1,-8,-14,6
APRYMdNgIQaSKLUJGBXbZfVHEceFTDCOW,RAAAdAAA...IADAaADALAGBGAEABBDAZAGBHCACEBFFeCCBhAAATEDA.DBIBOCHDhABAAAGBMEHBQEEAhAIA.KFHDXGEA.....hBIA......hCAA...,2,-21,-9,12
RGPHQFJBfDbYeUOVLdNWTMaICZXcgAEKS,EAAARAAAHADBFACD.BAFADAEA.eAGH..OAFEdDAA..TDEAhAAAaBDDZCEBXDGD.hAAAAAIBGFABQCGAhAIAfCCEbFGBUGEANICBIGGA..hABA......hADA...,2,-20,-6,14
XbQcZEaFSRVWUKNIBCMYPOAHLDGfdTJge,HAAAGAAAdADAJADAeAFA.QCABEAGEFCDA.RCEAUEEBKCGABDDDhAAAMBIB..ODBDhACAAAFALFCBDEFA.fEHEhAAATFFA..XGCA...hACA......hCFA...,1,-6,-27,21
AVSafBCNEIXWgecZDHYMbRUQPKTdOJFLG,aAAACAAA..EACA..XACDeAEAZBEEHAEAMAIBRCEAUEAA.QEEBhAEATCAAdCCAFDHDhAGAADFASDFAhAAABAHBIGGA..gEEGDBBBPHCAOEHDhACA.GFAB.hBAAfHFBWDDD,1,-1,-3,2
VTJGFPWdeBNIEZcYHKLAgXORDQCbUMSaf,OAAARAAAQADCUAEA...aAFA..TAGAGBFAFBBHdCHAeCHFhAIABCCD.EDEBZDBEHFCAhAAAADFADEFBMFHB..hABAfFHA.......hAIA......hBIA...,2,-30,-9,21
bMKFJgXWNcPVOeHLTCGQBZaUIdSDfYARE,EAAAMAAAFACD..XACA..NAEA.VAFAHAFA.LCFAhAAAGCCAZCFAaDDHdEGAfBBEhAFARFAAKFEB.gEFAhAIAPHCC.eFEDCGHABHADSGHBhBAAAFAA......hCAA...,1,-4,-13,9
MaUcfeTLNEHbDPYdASBXQOKFIVZGCRgWJ,XAAAQAAAFADAZACB.RAEA...JAGBaAHDUCDA..eCEBhAAALDBBHDGBbFAADAIBdDHAhAAAADIBBGEAKEFB.IHAAhAFACFDA..MHEAfGGEEGAB..hAHASHGA.hBCA...,2,-23,-10,13
fGcKLIEWZPQFVSObCNgdXHaUABTRJeDMY,RAAAeAAAMADAGADA.LAFAEAGAZBDBQCFASCCDbCFAhAAACCCA..dDHAHEFAAAAABEFDhBIATGAADFCA.fFEEhABAKGGA.IGHA.FHCENICB.aDBHhAGA......hAHA...,2,-23,6,29
DFbSGBARTKQLPWIZgJOYNdEcaHUCfXMVe,RAAATAAALADB....IADAZAFAOCCHdAFAEAHBHCGBCCADMCCBhAAAeDFDFFCD.SEEDhAAAACHBQDDAhACAgGADYDGFaFHDXFBADIDABHGDKGHBhAIA.PHEC..hBFA...,1,1,-15,16
RIGXeNgWbSaEYKDBAcHTVPOZFCdLfUMJQ,HAAATAAAOACA.ZAFBdACALBHBMAEARBDFGBFAeBEFNCCA..hAAA.bEGDEEFB.DDDBAAIBPFBAhBFACFHA.fBHEhCAAQGEC.IHCAWFEH...hDAA......hDBA...,1,-4,-10,6
baUJQMAPHIgeWCRSKYOTVcFfEZdGBLDNX,HAAAeAAARADAKADC.OAFC..TBGAFCAHECCAGCCA.LEABhAAAXCEAaAGAQEEChAAAACCBIEFACCHASEHBhACAVFGB.ZFCBDDIB.bFDDMFHBhAHA......hAIA...,2,-12,4,16
DQeAfYJHISONbEKgWdUcRXFCBZPLVaGMT,JAAAHAAA.OACAEADE.KAFAdAFARCCA.FAHBZCFBLCCBGEGAMAIBhAAADCEB..ACIB...fFCAhAHASDGBNEEA.hCAA..bEFD...gFDA.hCCA......hCDA...,2,-31,-11,20
DdVEFNeHAMGZgLbfJaCPITYWSXBQUcROK,ZAAALAAAJADA.aADD..CAGB...TAFASAHHBAHBQCAAhABARCAA.DCFBhACAECEAeCGFHDECACIBGDDAhAFAbECC.fFGAIFHAXGGChABAOFHDKHEAdHDB...hCAA...,2,-15,-9,6
PUTWdBQCZDSFAOYRfNIcbJVeKHaXgLGME,RAAA..fAAA..IAEAJADAeAGHHAFB.aAHFLBCBhAAAECCAUDFBdDFDQDAChAAAZCABFEDDAAIBODHDhACAcEDC.bFFDXGFAGGAB.MDIB.hAGAPHBABHHBDFFB.hABA...,2,-15,11,26
KbASeITcOBdCDYPRJZWEMVLNfgXQGaUHF,eAAATAAABADA.dAFADACARBGF.ZADE.EAHBMCCBLCCA..hAAAfDDAQCGChAFAaDHDHECA.bFEAAAAASEFBhAHA.OFBB.CFDAYFFFhAIAWFHHNIAB...hAIA...,2,-21,-13,8
aHYZScJMLTGgUXREPAIdWDCbFfOQBVeNK,dAAACAAAFACAQADA.eAFAaAEDHAGBZABB..SBGAhAGAMBCBGDCAXDCAhBAAEEEEAAGBDDIBbDFABFDD.hAAAKFFAcGDDLHDATGGA....hAIA......hBIA...,1,3,-25,28
RCaVJFKTEUIOZDcMBLQSAGHfWYNgdeXbP,HAAA..fAAANACB.eADAbAEA.RAGBaBCCFCCA..ECFBOCAChAAAZDGB.MCFBLEEBhAAAAAIBGEAA.gDGAhACAdGCACGHA.KEDB.TGCADAIB.QGGAhADA..hAEA...,2,-11,1,12
YLcNIVaHCAWFUbQJRKMSBgGTdDPOeXfEZ,FAAAQAAARACF.MADABAEBGAGAdAGAOBHDeBDA..EDBAZCDBhAIALDEB.IFHAhAAAHEGBADGBbFEDSEBAhAIA.TGFAXGBAfGDEhBCA.....hBAA...,2,-32,7,39
ZBcOQSYgXDVCKJRLHUNdeWaTFMGPEIAfb,ZAAAOAAAQAEA..SADAXAGACCAARAFFHCCA.hABAdAHAeCCBaDFEMBBBhAEAECEBAACAbCGDBECD.gEEGhBAAKEAALGDAWDHHFEEH.IHAAhAEA.fHGFhAHADHFA...,1,-8,-10,2
RVEYHdJMKPGcSBOFCXQTZUNbDeIgaAWfL,LAAAEAAAHACAdAFAMAEAGBGABAHACBDATCDA..ZBEBbEAAeCABhABA...aCCCAAHAREFBhAAAJCGBKFED.SFHHhAEAXFFA.NIBBDCCBgGCA...hBIAWFHH....hACA...,2,-34,16,50
bfOLYSIVJGFKNTCWegMcXPQaEHRDAdBUZ,dAAAZAAAOACALADA.SAGHJAFB.GCABKAHBCCCD.eBHHhACA.MCFBXCGDhABAaDGHHEAAACEBBEEAUGGA.hAHA..YEEFFFGATGDA...gGGGhCAA..hCBA...,1,8,-40,48
KSNCLJEgfbPHdBTeGFAYaQZWRIODVMXUc,aAAAZAAARAEA.DACAMADA.UBBBKBHB...CAGALBEBECCB..hAIA..bCECHCGBdEFAeEHBhABAABIBQECChBAA.OFFBXFAASGCAgGCHhAFABGHAFHGC.IHAAhAHA..,2,-22,-10,12
FEILMDaPfHQTYWAVbUXdBJceORNSCgGZK,UAAAdAAABADAeADARAEF...CAGAZBFEEAGELCCB..aCBEHCGBhACAQDEBTDAAACGBhADAXDACOEDDSFFBhAIAGDGAFECDMIAAfFHA..hBAA......hBCA...,1,-13,-17,4
EbCcgVHfAROZDYKaJILTPWUGBNXFSMdeQ,RAAAZAAAKADCaACALAGB..TAFAUCCAGEDBBAHBFCCHdEHAECFBhABA..CBFA...gDGHhAFAHFBAAAAADAIBIEEAhCAA.PFHDXGEAeHCA..hCBA......hCEA...,1,-19,-20,1
XHTOPSFZKbJeLVWCfMGYRcQEDIBNUAdga,aAAAHAAA.TAEAOACDFAGAZAEA..KCADeBBDLCCBCAHB.GCEBhAAARCFBEDEBBCHAACHAdEEAXEADhACASECHbGFAhADAVFGBMIEA..QFAADEHB..hAFA......hAGA...,2,-15,14,29
SVEWFCKeHZPLbfAdgNOTBRXDMQIYcJGaU,dAAAOAAARADADAGA..MAEA..QBGAIBDA.JCBBaAGEUDDAhACA..EBBBCDGDHFEChADAZBFALDDA.hAEAADHBTFDABEHAcFCCSFFB.FFHBhBAA......hCAA...,2,-23,-22,1
SbCNVJaHBUZdfFeRXDQcGKMLWYPOgTEAI,SAAACAAA..VACAHACBZAFBdAEBeAHFRAGFQCEDhAAAGCAAMCIBLEFA.hAAAPFBATDDAACIBIGGAhABAbEGD.aHECfFCADIAA.KFFDhACA.OFAH..hAFA...,1,2,-13,15
YXPacRBWTGEDIdKNZJCAMfQeSUbOLVFgH,MAAAeAAAUAEALAEAFAGE.HBBA.XBGAaBCDBCGAGCEAhAFADCIB.dDBDZDEAADGAQEGAhAGAOEBB.gGGGhAIA..cFDA.TGGAhAAA......hABA...,1,6,-38,44
JFMGNeQcBKAdLaPECXfRUgOTIYbDWSVHZ,aAAAEAAA..CACA.RACFUAEA..TAEA..bAGDSAGBhAAA.HCCAZDEAMBBBhAIAeBHHQEAAhAEAKFDAABIBdFFAXGBCOCFDDEEB.VFGBFHGE.NIAB.hAIA......hCAA...,2,-14,-4,10
EIXGQKCLOJgfFRWSMHYPAZecbUNVdaTDB,eAAAUAAAdADADAEABAGA..EAFAGBCAQBGALBEBOCDEhAFAJBHBFEFD.RGCA.MDBBhAIA.HEEAAAAA.bGEAhBAAaECH...IGHA.CHFA...hAIA......hCAA...,2,-26,-13,13
AeVgdfFJURBENObLMSZKTHXcQWGYDPCaI,eAAAdAAAFADARADABAGB..EAGAOAHDMBDBZBFEHCCA..QDFAhACAGCFADEAAaCBDAAAAVFCAhAEA..fEDAhAGANEIA.bFFAKHFA......hCAA......hCBA...,1,-12,-19,7
SeHAgEXcLNOGfWCBIFMJdKDPaVYRbUTQZ,EAAALAAAGACACAEAFAGAdAEBDAHB..aBEERBEFUDGA..ZCAAHGEAhAAAACCA..XCFAhABAOCBBBEEDMCIBKEAAhACA...VEDA.bGEASGGEhAIA......hBCA...,2,-19,-14,5
DMVBXALTGJCYdNZOQeHfFIUKWRgcSEbPa,GAAACAAAdACAZADBeADA.HAGBFAFD.KCDARBGF.SDAD.EDCBhAAAaCBHMDGBBAHBAAIBTGBAhACA..NDFA.fEEAhADAUEGB.gFGH..hAEA......hBAA...,1,-2,-46,44
WEHXSRYaUVAFfJIOCKMbLQBgdcNDPTZGe,FAAAJAAA.CADA.KADCLAFA.BCCAdAGADAIBZCEA.GBEA..hBAAEDABHCCBREEA.aDGDAAGAOEHDhADA.MCFAhBAAbGBAQGGA..cGGC.hBGA......hCAA...,2,-28,-27,1
TAPeJUDLGMbXIBCSfRKZWFgNHcaQVOdYE,eAAADAAAGABBMAEA...XAFBCAHARBCAZBFF.FAHDHDBA.aCHFQCCBhAEA.dDFAhBAAEEFBADHAUFCAbFDDSFGHhAAAKFGANIEB.........hCAA......hCBA...,1,-6,-19,13
fLTZYWbKFaOQHcdRMNJBegAVCEGPIDSUX,EAAAGAAADADA.SADAUAGA.LAGBZBCA...bCDBaDBAhAAAHEACRDFAMEBBBDHAAEEB.hBDACEGDXFDA.hBEATGGAKFFDOHFCcGBCdGDA....hBFA......hBGA...,2,-23,2,25
MOVEKdABYWeZPGLfQNJDFHbcgRISUCTXa,BAAAeAAAGADALACAQAFADAGAHBEC...bCFARCCBSBHBhAAATDBA.aDABMEFBhAAAEDGF.AAIBZEGF.fFAAhABAFEHDgEAHCHBAXGFDKFDA..hAFA......hBDA...,2,-12,2,14
bHMFQDEJafgcUXTBLPGKCIdVWYOSNReAZ,HAAAMAAADAEAEADEaAFA.....fBFAgAFAXCAAhAAATBBA.LCHBhACAGBDACBHAdDDA.VFEAhAIAODBBSGDDRDFAAFFBbGDA......hBIA......hCAA...,1,-2,-17,15
gGDKaALHCJMIFOQZSUVRXNfYdEWbBecPT,HAAAMAAAFADDZADBSAFA.RCEF.fAFAEBHF.BAHAhAFAeCAATCBAGEFAhAAAaCFDAACALEHBhAGA.CGCA.OCHB.QEDC.hAIAXFGA.dHABhAHA.cGFCDIDA,1,4,-18,22
QNUDVOGYZbdFaHSEJTRLACfWKcPeMgIBX,CAAAKAAA.eACEMACABAFB..QAFADAHBGBCAZBCA.dBHAHCEBhAAAEDBARDEAAAIB..fCGEhCAAPEDB.XEGAhCBAVFGB...OECH.FGGBaGFH.hCCA......hCEA...,1,-11,-20,9
QIAXagSfeHKdUODLRVcWZMETFPYBJNGbC,aAAASAAAHACBdAEBDADARAGF....VCEBZADEEAHB.FCCHBDHAhAIAGCFAQFBAhBAAAAAAXECAeBBD.OFGBhBFALDHBMFIBPHCA.JHFE...hCAA......hCIA...,1,-3,-12,9
egaACMFJGLSEUBDOQfdHcVXTWKNIbZRYP,MAAAGAAALAEAEADADAGA.QBBAHBFAXCDCKBHB..bCEBhAFARDFAeDAD.AAABFECHhACASDCAOEEBdFHAhADATDGAIHBAZGAAgFGAaGGB.CGDB.hAGA......hAIA...,2,-13,15,28
eWOTLHJAXdSbIVaUNcBKEDCYGgPFZMfQR,dAAASAAA..bABDaACDUADABAEADAGAGAFA.FAHFZBFBhBAAMCEBRDGFeDED.OFBBhBDAHDGBAAAA.XEAAhAEAIHCAVFEBKGGDEFDBCHHA.....hCAA......hCBA...,1,-11,-13,2
LXIbPaJNSGMOgFCAcVTKdHREWDQYUBeZf,TAAAHAAAEADE.QAFCBACBeADHZCAALAFA.bCEAaAHDhAAA.SCCEhACAGEEAMCCBFDFAADIBKEHBREEBDFIBhAHAfFCAIHGA.......hAAA......hAGA...,2,-17,1,18
bcMDYHXBedTOIGRfNFSJKPEUWQLaVAZCg,ZAAACAAA.....bADBMACAHAFAeAEAdCAAOCCBRBCBFAHD.KCGAECBBhAAAUEEALCFB.hABAADFBDDHBBEHA.IGHAhACAfFHASFCH.PHEChAHAaECE......hAIA...,1,-12,-27,15
KLESABDdJcbMaIFGRZeVgQXfNCTOWHUPY,dAAAJAAA.MADAFADA.RAFA.ZAFB..eBDB.QCBDXCCA.CCFD.hACAOAHDHCGBPEBDhAIALEFA.ACCADFCAaEFH.hBAAGGEB..fFHA.NICB.hBCAWHBG....hBAA...,1,3,-38,41
fIFOJXgPEYGRKNcZAabeWQLCdBSTVMDUH,eAAALAAAdAEABAGATAEADAIB..HAGBFBCD.XCAA.hAAAEDDARCEAKDHBZDFEAAIBaEBAbEAChABA..QEEBhABA.SFHDMFGBfFHAOGAAPHCChAGAGGAB...hACA...,2,-17,0,17
GPDcLFHYMUgZTAObJEIXdVCWKNaQeBSfR,OAAAEAAAdADA..CAFA.KADA.QAFCeAGHBBCCRCCAGCGADAIBLDDBhAAAHEEBMAIBZDFAADHA.hAFAIHAA.XBBChAHAVFFAaFCBfGDE.FGHD.hCAA......hCBA...,1,6,-24,30
TcbZOeQUMHfAYdRaFXGIVLEBPWJSgCDNK,RAAAaAAAGADALADAEAFA.BAHA..JAHBCBBDKCDA..TDAAhAAAZCFBeCHFMCGBHEAAACCBdEHAhABAXFCA.IGGAhAEAPFABSDDDDEIB.bFEDOHAAhAFAfGGE.hAHA...,1,-4,-17,13
JYEMfGCAIceHTUFPZWdRVgLObNXSBDaKQ,eAAAHAAATAEAFADDZAEB.RAGFLCAA.OCEBbAGD.SCHHhAAAaCCHQEEAhAAAEDFFGEAAAAIBUGBAdFGAgGFAhABA.BEGADFIB.....hACA......hADA...,2,-9,3,12
HVeXLDUZKTbFOGQIEcNYgAMafWPSdRCBJ,aAAA..fAAA.SADARACFBAEBHAFBeAFHLAHBhBAAZAGBbCAAGEAAhAAAECEBcEECgDGAhACA.ABCBMCEBdEGBCFHDJHBADFFBTGGAOBBHIHHAhBHANICB...hADA...,2,-8,5,13
GaKeTXDEILPCHFQJOfAYRZMbUNSVBdcgW,RAAAZAAAMADAUAEA...SAGAdAHA..gBDAhAAAaCAAeCFA.TCFADDABEDDBLEBAhABAHEBB.QEGAhBEAfDHAABGAbFEDBFEA.GGEBIHHAhCAAFHAC.....hABA...,1,-2,-10,8
QWgBJFEcLSfAHCeZdVXNPKTOabMRYGUID,HAAAeAAAdAEAXADBKAGA.OAFCMBDBRCEAGCAB.DCFAQEBChAAABCHAEDEALEGBhAAAACCBZEEA.PHAAhACAbGAAUGEAIFFA.WFHHFGHD....hAHA......hAIA...,1,-4,-7,3
KaHeUfWdbTgFVZNXLAGCJOPIYDBEMRScQ,GAAAOAAA...IADABADARAEFQAGCHAEBeAGBfCDEhAAAdCCA.bDFATDFAhAIA.FEDDZFFALDHBhBAAAAHACGDAPHFCEFFBMBBB.SHFAhCAA....hCIA...,1,4,-18,22
VaRPfHAICOcFMLdGYBTgXDbKNZeUJWESQ,OAAAMAAAGACBBADA...TBGADAFAKAHBeBBBUCCA..ECFBhAFAQBFCRDCFHEFCAAGACFEDhAIALDHBdGGD.XEDAhBAANIBB.ZGEA.SBBD.hBAAaFCH.....hBIA...,2,-22,2,24
VPUgLAEbSYJBdCXcfeMIZNHGOFDaWTKQR,EAAASAAABACAdAEACADA.....XAGAeAEHZAFBHCCAGCCAhAAADCGB.aAHDKCHDRDABUEFAhABAAAGAJEBB.MDIB.OHBAhADATEEA.QGGAPHFA...hBHA......hCAA...,2,-22,-3,19
SRgBMPFNAWEJZLOIDKeaXQCYVTcfUbHGd,EAAAZAAALADBDADA.eAFAaAEE..QBCCCBHA.TBGAhAAAfCAA.HCEBhABAdDEAREGBMCCBFFCBAAHAODGDhACAXGDAVFAB.bGDASGGDhBIABHHA......hCAA...,2,-20,3,23
aWgETScXBOIVAZdFfGPNKCQReULbMDYJH,dAAAGAAAKADARAFFeADA.LAHBMAIB.DBGBHCACaCDA.EDEBTDDAhAAA..XCGDhACAODAHABHBZFAAFEGAfFDBhADACFFA.bGFA.JHAASGHBhACA......hADA...,1,-1,-17,16
SADeZYfTQHBUWEJbIFacKNdMXVPLRGCgO,eAAAZAAA..TAEAHADABAGBEAGE.bBFAaCAA..KCCAdCEDMDFBhAAAXCGDLDGBRDABGEEAhABAOFAAAADAfDDEhACAWEED.FGHBNEIA.......hABA......hAFA...,2,-17,4,21
dNRJCIcageYFOPHDKGATXUZSbEfBVLWMQ,TAAAZAAAEADEBAFB.LAHBMACAdAGARCAA.CBDA....aBEDeBGFhABAOBHDHDEBGDBAhAAAACAASCEFVEEAQGDChAIAIEHAgGGAFGHBDGBB..hACA......hEAA...,1,1,-17,18
bOYUMTNPLcefgWSRIXKdQFaZVBCHEJDAG,GAAAOAAAUAEAMADA....TAGALAHBeBFB.fCDAhAAASBBARDGFKEBAhACAdDDAaDGCZEEFCFDAHEBBDFIBACIBhAIAbDED...PFHB...WHBAhBAA......hBBA...,1,0,-22,22
RBeZOKPQYVTILdfJaEXAFHWGDCbcNSMgU,HAAAGAAACADB...bADASAEH.MAGBRBGFeCDBZBGBKCADhAAAQEAB.TFCAhAAAdCCAaDFHAADADDIBgFGAhACAOFEDPHACIHAAfGGAhACAEEDFWHFA.....hAHA...,2,-22,5,27
YbTVZCfWIDGOHUFdLMJPRAEXeKQBcgaNS,EAAAeAAABACA..aADDSADH..bAEDZAEBCAGA.fAGAhAAADAIBHCGBdDBAMAIBhCAAREEBAAAAQDFAhCBA.gFFGTGAAIGHAOCCBLHCAhCHAXGCBKDDD.hDAA...,2,-15,-7,8
HbfEYPcLUFaCANGJWRTMBegQDIKOXSdVZ,GAAARAAAMADA.eADADAHB.OAGD.dCDAHBDAECFB...cCCChAAALEFA.aDAHAAIBJCHBhABATGBABDFAQGGAhAAAXFBAZFDBfHEBPFGB...hBFA......hBGA...,1,3,-21,24
LNKUOWfTYcEXMSZQaHGRbFdDPAIBJCegV,BAAAeAAALAEAKACAUAEA.OAHD..TAGAEBCFMCEBZCAAHDFAhAAARCFBdFAAAAAA.CEHA.VEDBhACA...fFHAhAIAXFCCaFEDFHFCDICAIGGA..hAFA......hAGA...,1,-16,-17,1
RXIHVPGTgQbFMZLEdNYcUfDeABCJaSKOW,CAAAaAAAKACA..RACFHAEBGAEA..QAGAMAHBZCAA.EDEBdDGDNBBA.hAEAUEAA..eDGBhAGAAAIBBEDAOFGH.IHDAhBAATFFA....bGAA.LFHBhAAA.....hBIA...,2,-15,-10,5
ECLAcPdWVFGISBNYeTJHbQXRDgZaOUMKf,dAAAFAAAGACABADAeAEHHAEA.QCFARAGBZABB.aAGAMCGBEEAAACIBhAEA....PDCDhAGAIEEA.SEGAhBAATFEAJDHBDGGA.OHDAfGHAhAIACHHA......hBAA...,2,-29,2,31
FACObMUZHWTLGBNdKQPIRESfVcXDagYJe,OAAAMAAAHACCLAEAGAFAdBBDQCCCRCDA.EAHBfBHAhAFAXDGDaBBHJDHBAECAhAGAbEEDZECE..TFAAhAFAKGCASFGDDEEBgGGB...hAIA......hBAA...,2,-22,23,45
JAHRdZYTLcSEOXMKefQNIbBVCPaFGWUDg,HAAARAAAZADBLAGBEADEMAFA.KBFD..eBEAQDAA..hAAAbCAACDHAFEEAGCGADAIB.hABAABIBdDFC.cGGChAAAXFGAfEDABGBAaHFA.....hACA......hCAA...,1,-4,-21,17
HYQFKUfZbNAIMXdGDJPaLEeTgcRBSWCVO,MAAAGAAADAEAaADALAHB..EAGAeBBATCDARBEA.SBGAhAAACDDAHDFAFFBAfDCEhACAZFFAABBA.dDGAPHBAhBAABEFCOEHD.QFCBhAGAKHFA.NIDB.....hBAA...,2,-8,-8,0
FIAKHWLCENbBZaeQcTUdGPSVXfMRDOYJg,HAAALAAAEADEBAFBeADHQAFAUCABGAGASBHBhABA.XCAARDCFODHDhAAAgCFGAAIBCEFAZFEA.hACAaDEH.dFAA.fEHA.MFGBhACA.DIAA....hAFA...,2,-13,-8,5
bPAJHZcKLIYWeMaBRUEQSFdOTgXDfVCGN,HAAAZAAALADB..IAEAeAFAaBGERAFFEBHFFCAA.dCADOCEDhABATDCA..DDGACDHAGEFAhAAA.bFDDAAFAKEGAhACAMHAAQGEA.SGHBhDAA.....hACA...,1,-8,-15,7
dISDOTWHgeFaCLJERNUbPfcZGQKBYMVXA,dAAADAAAOABEHADAeAFE.CCBA.EAEE.RAGF.UCFA...bDAAfCCAhAGA.GDEAhAIAQFDABDGDMCIBhBAAACIBTFGAFECDaGGALHDAPHFC..hCAA......hCBA...,1,-8,-18,10
fECGaRTcSXHYPFAgUdKMJbINOeBWVQDLZ,dAAAMAAAJADA....bABAOAGD.BBDDQAFAZCCA.hACAECCBaCHDRCEBSBHBhAFA.HDGBFEEHAAIBhAGAKGDAeDGDDGGBCHHA..cFCC.XGGAhBAA....hBCA...,2,-37,-5,32
SeTOPDaLQBWdcEUgFZNGbRMJIfXYAKVHC,HAAAeAAAOADCaACALAFABAGB.dCCAEBHFFCFAGCCARECA.MCFBhAAAIEGA.XFGAhAAAACCBCDHATFAA.QFGAhABAcGAA.ZGCENIDB......hAFA......hAIA...,1,-5,-10,5
RIYNfWZcMXdJLEbGHUSAVBCKgaOFDQTeP,CAAAaAAADACA..eACHRADA.....IAEA..fAGBhAAAZAFBMAIBdCECEBCBHCEAhAIAABBBKDGAFFFAQEEBhCAAPHBA.NCIAXGCA.LHFAhCBA.....hBAA...,1,-14,-30,16
LFKZMADCYPfREOTXbgUcNJQWedSaVHIGB,CAAA..fAAAEACA.OADATAEA..XAGAUAGAJCAAhAAAeBCBdDEA.aBDFHDGBhACAGCAALECBZCFAACGADEEAhAAARGEA.bEGD.NHABSFFF..hACA......hAHA...,2,-13,-1,12
GWTOFYCaZAUPRKdQJgeENcBIVLXbDHSfM,RAAAdAAAQADCeADAEAGA.BAFBLCCA.DBIBHAGB.MCCBhAAAGCFATDDAFDABaECAhACAAAIBKDGDJEHB..gFDAhABAIHCA.XGGASFFD..hADA......hAEA...,1,-10,-17,7
fEQLSRBOIgcHGTKFbaPWCUZYMNDXAeJdV,eAAAdAAAEADALAEABAFA.OAHD..gAGHHBCAGCFAhAAAFCBD.aDEBCCFDZDCBMEIBhABADCIBAAFAJHDA.fHGBhCAAREEATGGAKHDA.....WDADhACA......hADA...,1,2,-27,29
AVfFNaWBEHYbQMdSDUXZPegGOJCRcLKIT,FAAAaAAABADAHACBQAEA.dAHADAFAZDEAeAHFGEAACBBDRBDALDAAhADATFDAADFA..hBAAVGFA..fDFAhBGA.EDHFMDIBXFDC.OFHDhCAA.KGFB..hCIA...,1,3,-27,30
gYSFIZRPLAaKUNHcGWfEeTOXBQVJCMbdD,aAAAKAAAHACBGACAEAEA..eAEAOAGDQBGACCAA.dDFADAIBhAAASBBDZDEAREAAADIBUFGBhACANEAA....fEDAhAEATFDABGBAMEHB.YFCFhAFA......hAIA...,2,-13,-13,0
EWQMCXIPFLHbfTOYdAeUKagNRSDZJVcBG,eAAAaAAA.RADAZAGB..VADAGCCA.EDHFMAHB.CBBD.XEAChAAAFCDHHCFB.bDABTFEAhABA.dGHAAAIBKEHBhADASGAADFDABGAD.QGGC.hAEA......hAGA...,1,-11,-12,1
WUPfcXNaCgROFDeVQTKLYMIBEAHSGJbZd,HAAAGAAAZADBdADAUAGA..fAFAXCAACBFCRAGFDCIB.eDBHhAAATDEALDDAhACAMDHBEGDAAEHBSFADhAFA.bFDAcGGCaFHD......hAAA......hACA...,2,-21,5,26
XQIHJADPVWULcZFOKSgeETBbGMaRCNdYf,DAAAVAAALADA.ZAGBKADC.eAFAEBBBBCEAGCDA.RCFAdDCChAAAXDCDHFFAABIBUEAAhAEAOGAA..TEGAhAFAaHECCHHA...fFEA.QGGBhBAA...hAGA...,2,-19,-9,10
TWABGfaZcYLFNgOPbKESUdMJCeDRQHXIV,GAAAZAAALADBFADAOAFDKAFAUCAA..dAHAMAIBeCDBRCFB.HDBBhAAA.XDGAhACA.TFEAACHBaEEBNEIAPHBAhBAA..EFAACGHA.QFFB.hBCAIHAABHFA.fFCAhABA,1,-5,-18,13
OgYPIaJVNQAKBGbCdFXSRUfLcMDHeTZWE,GAAAdAAASADARADALAGBDAGA.HCEBeBEAZDCB.EDHFOBHDhACA..gEAAhAAAICCAaDABVGFAADEAbDFDhADAXGCA..fEEAMIAA.YEABhAEA.PHCAhBAA.JHFE,1,5,-5,10
CWDSbQEKYOdRLaBZVPgGJHXFMcUNIAeTf,eAAATAAACADA..DAFAQACC.EAEEOAHDRAGF.aBDEZCDBhAAA.PDGBGBFAHFEBhAGAMCCBNCIA.AAAASDDBhBHAKHGA.dEHA.LHFA.BFEAhCAA.....hAIA...,2,-17,-4,13
VNEDbWZHeJaUgTdSFBKcLCXRIGOQYfMAP,VAAAEAAADADA..ZADBHAEC.eAHHaAFDUDAAdBCABCEALAHBhAAARDEAGECAQDEAhADA.MEHBAECBbFGBgFBAhBFAFHAA.CGEAOHBE....hBHA......hCAA...,2,-7,-7,0
MJDWVcTSICPFEAZGNLdefUagBOQXRYHKb,GAAAdAAAeADAaADAOAGDRAFF..HCDBMAIBDAIB...VDGBhAAATCBACDCC.ECFBAFDBLHAAhACAUEDAQEAChACAKFFD.bFFB.WEHBSGHHFGBD..hAHA......hBAA...,2,-11,3,14
dDBcQCHFOWbMUaEJYeVGIKRZAPfSLgXNT,SAAALAAAXADDdADABAFA.QBGAHAFAOCABMCCBhAAAECCB.eCFAGDDAhABAREDAAAHA.fDGEhAFATFAACDHAbFGDaFGCJHAA.IHHAKGEA...hABA......hACA...,2,-8,3,11
LZJgYKVPBcFbAXRfdETUSDWOHMIeNCGQa,RAAAEAAAUADADADA.HAFA..eAEAGCGAaAHDZBCAJCCF..KEEABCGDhAAAFGDA.ADBAdDDA.SDGAhBDAMFIBCGGD.LFFAhBHA..YHAAPHFA....hAAA......hABA...,2,-23,-18,5
UZWCHVNQAGTPFYBDXbgREMfcILSaKdeJO,GAAATAAA.FADADACA..XAFDRADA.EAHBMAHB.fCCAhAAALCDBaDBDeCFBhAGAODGBZEDBHFFCNDIAAAABBFEAhACA..........hAIA......hBCA...,2,-21,-15,6
bRAUMDSeYGEXfVZPNQcKBOdJLIaHCWgTF,MAAAeAAAEADA..XACAZAFBQCCABAFAdAHALBHBhAAAHCCACBBD.TEFARCFFADIBSEEDhAFAGFBBfFHAhABA.PHDCKEHDOFCB.aGGC.hAIA......hBFA...,2,-16,3,19
TZUAPgINGORQFSLbcMaWJXfeDYVCEHKdB,..IAAAGAAARADAFACALAGB.MAIBaAED..JAGBeCDAhAAADAIB.CDCDHEEAdCBAZDCBAADA.hACA.PFHDODHBQGEBhBAASEEA.bGAC...XGGAhAGA....hBCA...,2,-30,3,33
EDXdIJBgSaLPGFVQYNMcTRWeOZbKUAfHC,HAAAEAAAdADABADB.aAEDGAFA.QCBCMAGBRCAA.eAHBhAAAbBGD.AAFBDDEB.XDGDhAIAgDCA.LFEAhAAAFFDHNIEB.WAHBZFFA.fGHAhACA......hCAA...,2,-20,-2,18
NbCEAdSPaLcFMRYHBIeDXGZVfWUJOTQgK,dAAAaAAALADAMADAHAFCBAHADBDB.ZBBA..VCEAUCFA.OCHFhAEATEBA..QFAAhAFAKDHBCCBAABEB.SDDDhAHAFEEHRGFA.eFDA.fFHEhBAA......hCAA...,1,-17,-20,3
eVYXbJGgKfTFZCBSUAMREcHaNPQWLdDIO,EAAAHAAA.aACAQACAdAFADAHB.eAEA.XBFAGCCAfCHAhAAAZCCASCHHhAAAAAIBREFB.PEEBLFBBhBFAODGHbFDD.KFAACFHBBHHAMFIBNIAB.IHGAhAFA.....hCAA...,1,14,-5,19
bIQTKCXESRYGeFVHdcgfZJMUNBaODLWAP,..IAAATAAACACB..EACARADFGAFA.eAHBHAEAdDDDfBHAhACAZEFEMCCBBFAAhAAAaCCALDDAADHB.hAFAbEFAQGGASFDB.FGAA.gGGBhAGANIAB.DIAA.hAIAKHEA..,1,6,-6,12
bVOeRcQAJBNHaLTZUXFgDMSKdGfIPYWEC,BAAAHAAAaACAZACAFAFAMAFA..dCCAGBDB..ICGAhAAAPCCBECHF.CDFAbEDDeCHHhADA.REABAAIBLFFAhAAA.XGBBSDFDfHFFVGEA.hAEA......hCAA...,2,-31,16,47
ITgeVZCGDFbQXRBLMcSEOWJHUfNdKYAaP,aAAATAAA..eACHZACBGAEAFAEA.QAGARAGFMBBBECEBOCABhAAAHDFB.UDGAdEHAACIBhAIAgEBADDDBBEBASEEDhBAAfEEEKGADIHHAbGEA..hBEA......hCAA...,2,-13,11,24
dZDcJUFTgRWQVOaHGPYXNKCIbLfAMEeBS,EAAAeAAAdADAZADB.DAGAUAFA.FCBBRBFAQDBC.ODFBhAAAHDDAGDGA.hABAXFBACBCALDHBhBFAAAIBMFFBSGBA.TGFAWHBAaGGHhAAANEEA......hBCA...,2,-22,-8,14
eZaOTMFCKfHLGUSXQdYcVENgAJWIBRPbD,JAAABAAA.RACADAFAeADE.ZAGB..aAGEMBEB..KCAAHDCBGCEAhAAAXEGAdCGB.VFEBhAGAEDHBAACA..IHHAhBAAODDHFFHHCCCCfGCESGFH..hCAA......hCCA...,1,-10,-30,20
UACJfROZFLBMScYNTWEeHXbaVKPIdDgQG,CAAARAAAZADBLACABAFA...MAGBSAGH..NAHAECCAHCEBhAAA.aBHDKCEBdCCCQDAChAAAADAAOEGDFGDATEFAhADA.eEED........hAEA......hAIA...,2,-26,-23,3
JQMXBaWPbdDZINRcUefLHVYTAOgKSCEFG,KAAAEAAAGACAMACABAFA..aAEA...bAGDZAGB.RBCAeCHHhAAAHCEBTEBAADBA.SEGAhAAAFDEBQFFChBDAXGCAdGCADFIBIGGA....hAIA......hBCA...,2,-25,-9,16
OBQECcURPHXGVTWedDfaNJIMASFbZKLYg,FAAAZAAALADBOACDBAEAEAFA..UCAAHAFBGBGA..TDEAhAEAeCFDdFAAaAHFJDHBhBAAAAIBKEED.QGCChABARECBXGFCDEIB.fGGAIHBA...hBHA......hCAA...,2,-23,0,23
DcUYeBROfVAdbPNgIFEaGKXZQMLCTHJSW,dAAA..bAAA..gADAEAEAGAGAZABBMCABLAGBHCCCSDFHhAAADAIBUDDAeDHFhAEAREAFfEHAhABAABGB.IHHAaFCCQGEATFCA...hACA......hAEA...,2,-14,3,17
DEFQIYJOUBMPaNRWCSXcVZGHKAdLbefTg,dAAAeAAA..TADAEADAQAFA.JCCABAFB.aAGDRDEASBHBhAAAXCAAZCFAhACAHFCAAAIBLDDBhADAbGFADIAA.FEHHOHDCMFFB.......hBAA......hBCA...,2,-23,3,26
IKMcQBAPEFHegdYLJNVRCObXfGWTUSDZa,EAAAHAAAdADALADB.VAFARAFAOBCH..bCEDGCGAhAAATDGADCFBZFAAaDBHMCCBhAAAQEDCACABFFHDgGDHhACANIAB..fFAESGGDKGFAhAFA......hAGA...,2,-17,16,33
COLJZdVKXDSGNYgcIeHfWBQMEUTPabRAF,OAAAZAAAdAEAKAGADAEAGAGA....gCAAeBBAHBEBhAIABCFAEDDBUEGB.hABAaECHAACALCHBhAGA.XDDCSFFDcEFBfGBEhBAAMHDAPEBDFHGE.CGGBNIABhAIA...,1,-1,-32,31
KREUZSeFNLVOXbdPYJQafIMGWHDgCcATB,TAAARAAAEADE..ZAFBeACELBHB.OCCAdAFAPAHB.hAAAQCCAaDDCMEGBHFAAhABACDBDADFAKDHBFFHBXEDAhAAAJHCA.GGEBDFFB.BEGD.NIAB..hAFA......hAIA...,1,1,-5,6
KWgZCHYRGOePfBdSNIELVQTFJUAaDbcMX,aAAADAAAMADA..KADAZAEEHAFBRBBB.eAHBBBHAdCCA..SCFBhAIAEDAALEEAQEDAhBAATFAAFFDHABDB.hBBAXFGACDHAOFFANIAB.IHDA.UGGBhCAA.....hADA...,1,-11,-18,7
DULOWNcgSRFGYQIdaJEHKeACVPbXZfBTM,CAAAVAAA..XACAZADBBAFADAFALAHB..OAHDhAAA.NBFA.SBFAhAAAGCAAQDCChACAaDAAHDEAAEIBbDGDMFGBUGCAgGDARGEE.IHHAhADA...hADA...,1,-11,-13,2
LYUGdXZaTAVNRDSPKWcfJBHFIOECMegQb,RAAASAAAKADC....fAFAHACBOAEAEAHBeCCBhAAAbBEDLBHBGCEBZEEAhABAAAAADEBA..PHCAhAIAcFFAFGGHMFIB.QGCA..hAIA......hBEA...,1,-4,-18,14
LfGNJYVIBEdHaUbSXQFcZWReAOgPDCMTK,OAAADAAAMADALAEAGAGA...JBBFVBBAEBHF..HCFBaBED.hAIASDCHFDFD.hBAAZFAAREBAADIBCEEDKEHB.fGGAhAFAIFHAdGBD.XGGC.hAGA......hAIA...,2,-17,-13,4
EfXdHQPTKSNDCFJRaWYgbGABOLIeVMcUZ,LAAAeAAAMAEAZADB.EAFAdBDAHBFCQBFAKCAADDFB.FDCHREFF.aAHDhAAA....gGDBhABAACCAODHDIEEAhABA.UGEAfHGFXFBC.SGHDhBFACDHA..hCAA...,2,-16,-13,3
CaFHJNTeIKUOLSVWQDRZbYGXBMdEcgPAf,aAAAHAAA.TAEAeACHKAEALAGB.SCAAQAGCRDCAZEAFhAAAGCEAMAIBECHFgEFAhACAABBBFEAAJEDFIFHAhAEAOEHDDGCAXGFDBHHD....hAIA......hBAA...,2,-16,13,29
TgaQVEbXPKIYBSUGcFdRLJfZODWeMANCH,HAAAaAAA.EADE..XACDKAFCBAHAGAEBdCADRCEALCHBhAAAZCEEDBBBeCHHACEA..TDCAhACAQEAA.bEFDhAEAIFFASDDDFGEHfGHAhCDAMFIBCFEAPHAA....hAFA...,1,-6,-8,2
LQWVIXgTMNEOYUPHKAfCBGScaRFdbZeJD,BAAAGAAAaACARADAdAGAZAEB.DAIBLAHB..QCDBhAAA.IDGATBCAEBGFhAAAODAHPCBBHFEAhACAAEEASEFAFGHD.eEHH.VGBAhBCAMIDAUGEACEHA...hADA...,1,2,-12,14
eObABfdDERUGMTCNHWagFQYSZcKVJLPIX,dAAARAAAGADAMADA.CAFA.HAFC..aAGDQBDCZCFE.KCBBLDAAhAAAXCFDeEFAhABAACIBDEEBEFAAUFFA.NEIA.hACAFFHD.SGEA.....hAIA......hBAA...,2,-20,-10,10
HWRSYMXIJeGAPdLBcDFZVUbENTOgfCaQK,dAAALAAADADAZADEUAEA.EAGAOAGD..CBHAQCAAhABAHCACRDEAMAIBJCDFGECAhACAADFABDGAFEHD..bFEATGFAhBAA..aGHD.......hBCA......hCEA...,1,-11,-23,12
HbNgMQGIaKYAZBScTfDJReLEXWdVFUOPC,ZAAASAAA..TAEADADARAEAEBCFdAGAFCAA.OBHDHCECbECAhAAAMCEB..GEGAhABAaDACADDB.fHABhAHALDFB.WCHBPEHBCDDD.NIAB.....hABA......hACA...,2,-20,1,21
LWFUXCcVYHeOBMgDPNRGTAQbKIJZSadfE,QAAAKAAAZACBdAFALAHBFACEUAFA..CAHA...VDEAHCDABBEChAAAMCIB.DDCBRCABABHBJDGBhAAA....aEDHEFBBhBFA.XFEDeEHF.......hACA......hCAA...,1,-15,-27,12
OReQXPcBVADSGLfCFdIZYEgUNWTMaJHKb,GAAALAAAFADAZADBEAGAUAGA..TCDAaBFBHCAB.ODEEhABARCFFeCHH.QFCAhAAAXEGABCCCADCBfFFEhACAdGGAIHDAgGABMFFB.KFHB.hACA......hBIA...,1,4,-12,16
fDLbOCSXIAVUHgRdeWBFPKYaETZcMQJGN,HAAARAAAeADEFADA.KAGAEAGEZCAA..MBEBGCEADCCBLCFAhAAACCGA.SDCHhABAACCAUGAAdEHABEFAaECCQGCAhAAAfEHAbGCAXGFDIHHA..hAIA......hCAA...,1,-6,-20,14
QXUHDJCOSYTNMVEZWgdFBaKbLIefRcPAG,GAAAQAAAHADACACA.SAFE.TCEAMAEAEAHFZCGBdDCAhAAAaBDDLBFBhAAAeDADRGCAAAIBDEIBOCHD.VFCAhCAAFGGBBEEDbFFBIHHA....hCDA......hCFA...,1,10,-14,24
TKQYFJSPfLVgHBWIdbcROMGEADCUXNeaZ,CAAAXAAA..eACAZACBQAEAFAFDSAHBLAHBhAAAHBGBBCAAdDEARECBGGEBhABAAACADCCAUDDAaFGAKGBBJEGF.hAAA............hCAA......hDCA...,2,-35,0,35
cgfSFXZRMJbEDdOLVHaYeGWCAQNTBUIKP,TAAABAAAKACA......gACBFAEARAGFMCAAEAEEdCEALAGBhAAAHDFB.eCCBhAIACDDCACIB.QCEAhBIA.IEHAfFHAZFFADEEBaHEA...hAAA......hACA...,1,4,-40,44
gIfCREXDTSdBVOJUNKGZcQHFWYeLbPMaA,..IAAARAAAEADEDAFAdACABAHA..OAEAUCCAGBFAZBDBHBFChAIAFDHDeCBB.bDFAaEDEhAAA..ADFA.CFCD.TFFAhBCASGGA.JHCANIBB......hABA......hCAA...,1,-5,-27,22
FTGISVegQKCZNRUPaEBAdfObLDcXHJMYW,dAAAOAAALADADAEAHAFCMAHB..FBBHGCAB.SCFBhACAeBEBQCGBhAIAZEAARDEBaCHDADDAbEEC.XFGAhBAAYFHB.IHFAKGEACHHD...NIAB.hAEA......hAFA...,2,-10,-9,1
gTZLDCEeXFSHPfMdIYJBNOGVAWcRaKUbQ,RAAAaAAAKADC..QADAZAFBLBHBEAFAeAHFFCCA.HCCA.MBBBhADAdEEAJFBBOCFDAAAA.hAIAcEECUGGA.bEGDDHDAhBFA............hCAA......hCFA...,2,-31,8,39
GNObQZeSXEYKILDHBfVgdPCUaRAFcTWJM,TAAAMAAAGACB.OAFAZACBeAEAEBBB.KAHBLCFAHCEAfCAEhAAAdDDACEGA.RECAACGAhACAFFEDJDHBQGGAhBAA.XGCDDEGBBFAA.....hBIA......hCAA...,1,-6,-9,3
NABSWEQZXHVaUPMJCGLeKgDYdfIbRcOFT,SAAAEAAAZACBHAEAUADAMAIBGAGA.eCCBDCBBdCED.bCGDhAAAREDFFDBH.AAAAQFGAhAGAaEEBCFFDLGAAKGBAfGFEhAIAIGHA.......hAGA......hAHA...,1,-6,-10,4
MXFIcgJUQBHYRZCTLfeENGSOaDWVKbdPA,MAAAFAAA....IADAJADBQAFAHAEBRAGBZCCFLBBBhAFAEDGB.GDEA.aBHDhAIADDIBKEGCdEEAADEBXFCChBAAgGAABGGATGFAeHBA....hBHA......hCAA...,1,-10,-16,6
HLNFXDaYGZMRPSJecdVBUQWgECTIbOAfK,HAAALAAAXADBaADDZAEBRAFA...SAGAeCAAdCFDBDDAhAAAQCAAEDHFCEFATGAAhACAbCFD..ACHAKDDDDFEBMFIBhAGAPFEB.cGGA...WDHBhABAIGGAOHAANICB..hACA...,1,2,-18,20
KJeaCdUAgbZHETYOPIDcNMQSXfVFBRWLG,ZAAAHAAAEADETAEA.OAGDDAFAMAIBQCAB.fCEEhAAABBFARCAAGCGAhABAeCHHdEADACAAbDEBIFFAhACASECAFDDHLGAAaFHDCGFA.gGEGhADAPHBA.NIAB...hAEA...,2,-11,14,25
aDNBQHKJMgUObWLCSfRVTdFYEAIPXecGZ,XAAAeAAAZADBDAGABADAHBFA..MAFAOCCHLBFA.hAAASCDBRDFAdFBDEEEBABDBhABAIDAA.GDEAhAAAaFHBKHBAgDGB.bGBA.fGGAhABA..hADA...,2,-24,-13,11
EHecCPaBNIGZFOTMdgKQJWbfLDVSXURYA,HAAAeAAACADAaACA.BAFAGAEAZAGB.FAGAMBIBdCCA..KCGAQCCAhAAA.JDFFbEDALFAAhAFADEHB.XFGDhCAARGBAEGHF...cGCD....hCCA......hCFA...,1,-10,-23,13
OIBRFAYMSVacTUJEQGdLCHPZNKgXbefWD,MAAAaAAA.UAEAEADAdAGAHAGDZBBA..KBBA..XCEDeCHHDDBAhAIABCHAADEA.SDAAhADATEBAGEEALEHBhAIACGDD.gFBA.bFFBfGHAhBAA....hBBA...,2,-21,-5,16
UaAbXQfcYIOKDNFSBTEMLHGRWCZdeVPJg,QAAA..fAAAIADADAFASADABAHAEBEAhAAAHAFBRCBA.ZCABeCFAhBCAPCDBUEEAAADAbDGDXGCChCAAOAHFFFHBMECB.LEFDCHEA.hCGAJFDB.aHAC...hDAA...,2,-12,5,17
UeLVEfFPKcHYGdZXRgNAJIObMTaSWDBCQ,OAAAMAAA..aACEDAEABAFAQAGA.eBBAEAHBFBBHKBEAHDDAhBAAdCEARCGBADDA..bDGBhBBATFAACFDD.LFFAhAFAfFFA..cGCB...hBIA......hCAA...,2,-21,-20,1
HIGFWaONKDLTPbVXcBZEQfSAMdgUCRJYe,dAAACAAARACA.eADAHAFBGAGAFAHF...aCAEKCAALCEB.TDCAhACAbDAA..XDGAhAAAZEAFEEGBQGDAhADAAACAMEEBUFAAIHHAOFFBDGHB...hAEA......hAIA...,1,0,-14,14
fIPWNAdaQEHZTbUgMJBYLKCFeSVcXGROD,aAAAHAAAZACBTAEA.UAGAMAFABCADLBEAFCCA.eBHHSDAAhAAAXDEARDEADDIBhACAIFBA.PEDBhBAAAFDAEFGBJHDA..CBBDcFFC.fEHAhBFA...hADA...,1,-9,-16,7
XZOYgdRDMAaGTIQCLUPKJHbcVSFNeEWfB,GAAATAAA.QADALACBKAEAHAFA.bCDCSAGBhAAA.eBHHECHBBEEAhAAAZCEBODGHdEGAMDABACEBaEAAhAEACGFDPHAAJFHB........hACA......hADA...,1,0,-10,10
QVBLaKeFSUOfAGWPCcDYbJdTMZgENXHIR,GAAACAAADACA.JADAdAFAZAGB..EAHBHCDB.REGBBCFCaBCA.eDBHhAAASCCB.OCFEhAAAABIBPFFB..hACAbEDA..gGAAXFBCIEHAhAIA.....hAGA...,1,-13,-31,18
OeMJBgFZfSCaVRdXGAbPLUHDYQTWKINcE,LAAAHAAAQADCTAEA.KAFC.IBHAEAGEeCAA.MCEBhABABCADZCFBCCCDRCEAGEAAhACAADIBUEEBDCIB..NEHA.ODHHhAEAFFCB.aFDC.dGGD......hAIA......hCAA...,1,4,-15,19
dBKVTRaZOGSeNUHEWIYLCXAPgbFcDMfQJ,...bAAADAAA.MADAQAEAdAHAKBBA.RAGBZCAAGBDA.eBFBhBAAHDFA.EEAA.IFDAhAAALDBBAAIBFFFHfDHAhBBABHGA.aFED.SGBA.hABAUGGA....hBDA...,2,-23,-2,21
gGbDMVPHXLecNZEIAKSQJOFTRWdBYUCfa,QAAAFAAARACFBAEB.CACA....aADDGAFAMAFA.HCDBLBFAhAAAeAHBZEGBABGAKDDAOFDBhAIAdDFAUGGA.fDHAhCAADFFB.PHDA.....hBAA......hCAA...,1,-10,-24,14
bDOFRVWKMgGJQIXUHeYCacEfdLZNPBSAT,TAAAOAAARADA..KACCGAGA.QCCCXAEAHBGBhAAAeCFBCEAAECCA.dDEAZEEFBAHBhAFAAAIBFEHDMEGB.gFCBhCAAIGAAaBBHLFHBNIDB...hAEA......hAGA...,1,-2,-11,9
CLKfTadARNHJXGecBbWMYESUQOgVDPIFZ,HAAAGAAAeACEBADAMAFAEAFA.UBGA.QCCAOAHDDCDAFDFHhAAAZCDELEHBKDGAaDAH.hAAARFCA..NICB.JEEB..hACA.XFAA.bGFA...SHBAhADA...hCAA...,1,-6,-10,4
YbgUWeKJXLAEcBPaZdVGORNHDQICMfTFS,EAAABAAAZACBGACA.RAEAHCABQAEAMAIB.TAGAFCFD.SCBDhAAA.bCFAhAIAgEEGUEDAeEHBhBCAXFAAAFFAaGEE.dEHA.OHAC.DHDAhAAACHGA.fHFFhACA...,1,7,-15,22
IBEgGJHYAVWMCeXZdUPOaSbKfNQRcDTLF,MAAAeAAAdAEAUAEAOAGB..aAGEKBCBQBBARCGF.DCHBhAHATEBALDEBBAHBhAAAEEBAGDEAHGECACIBCGGA.hABA............hBEA......hCAA...,1,-18,-26,8
dNEMBaVSfIQZLJWCXAcOUGeTPKgbDFYRH,OAAAeAAAKADADAEARAFF.HAFC..EBHFaBBC..SCCAhAAAQBDCZDCELDFAhAIACDHAAAHAGEFATFFA.bGCChBAAdFAAMFIBBFHB.IHHA...hCAA......hCGA...,1,-11,-14,3
bJMeLXFEDdGRISZQVcWPYfKgBHAaCOUNT,aAAAOAAA.UAEATADA..MAHBeAFELBDDEBBB.GDFAhAIARBFBZDAAQEEChADA..cFDAhBAAPDHDKBBDBGGAHGBAACHANIAB.....hBGA......hBIA...,1,-2,-22,20
TPbfHaeFGcOKUSALEVgZJIRCNWDYXQBdM,EAAAZAAARAEA..CACADAEAQCAA.dAHAMAHB..TCDAhABAbBCA.HCFBFDDBGCFAhAAAKEADAACALDHB.hAIAgGGGIEBAYDHBBHFD.aFFHhBEAcFADSGBAhBGA.NIBB..,2,-31,2,33
FPdWCDMQgRHVaKGJTYNZBOLAfXIeSUbEc,XAAAeAAAUAEA..EADAFAGE.dBDCDAGA.MBFARCFAHEEA.aCCHhAAAGCDA.TCFAhAAANEIA.ZDABLHEAhABAACHASDHH.bFCD.PFFBCGGC..hABA......hADA...,2,-14,-11,3
XHVSFMZQbUGeNODEPRBJKfCcaTIgWYLdA,HAAAFAAAZACBQADCGAEA.eAFEDAGARBGFKBFA.CCAD...aDEHTDDAhAAA..gEBAhBAALDFBACCBSDHHhBEAbEGDOCHFEFGB.BGEA...cGBDhBGA....hBIA...,1,-1,-27,26
EZdgVecASNMPBKRfWGYLaJOCIUXQFDHbT,MAAAKAAARACFGAEALAEA.OAHDCAGA.UBBAQCACHCEAEECAhAFAdCHA.eDEDAEGASEGAhAGABDGC.fFFEhBAAaEAEXGAAbGCC.ZGFE.....hCAA......hCBA...,2,-11,-11,0
bDXWPgOMRaKcINEGFUdBZfeACTJSYVQHL,TAAASAAA.QADAHACBLAEADAGA.XBGAhAAA.gCAGhACARBFFaBHDKCCAIDAAECFBGDGAhAFAdEEAZEDBAAAACEHAYFFFbFBBOGFCMGAA.NIAB.hAGABHED....hADA...,1,33,-21,54
EdKGbegZIfUPWNLQHJDRaVOcYXFSATCMB,MAAAEAAAGACA.eAEAZABEIAFA.UCCAPAHDLAHBhBAAHCEAREAAOCFBhBHAXEEAACGABEGAbEGDfGCAhAAAQGEAaGHB......hCAA......hDAA...,2,-23,10,33
VMdLgXQNJCGIeDUTSZHfPYRFKaBcAWEOb,EAAAOAAA..MADAdAEALAGBQAGACBBDGDBAeBCATCEAhAAAHDDA...fCBEhBCAREGBaBDBAAIB.bDGDXFDAhBAAIGCASGBDZGEAFDDHBFFC.hBGA......hCAA...,1,9,-13,22
YBIDMJRLgSdKVAbWNXcHCZQUGEaFPfTOe,...bAAAXAAA.HADAZADBGAFAEAGEaCDC.fAHEhAAA.eCABBCFBMCCBhABARCGFLDABdDHAADFBcEEChACAQEECFGHBOFBEDEIBSGGBhAAAKHEA.NIAB....hAIA...,2,-5,3,8
ZNeCaEBAWKUGQTYRfPFDgMcLOJXSVbdIH,KAAAGAAAQACCRADAFAGA.DAEAMCDB.LCFAXAFASDADhAAAdCEAHDFBeBHHhAAAEEEAACGA.TGCA.fEDEhAIAgEGAOFHDJHEA....hCAA......hCBA...,2,-12,-11,1
YCIMUQTXcPNfLSBaeEDAZJHFWVRdbKGOg,HAAAFAAARACF.dADAGAEAOAFA..CAGAUDGATBFA...XCAAhAAA..PEAAhAEALDDBaAHDEEDFABIBZDFAhACA.VFFAKFFDIGAAMFBBNIDB...BGHAhAGADHDA.....hBFA...,1,-1,-22,21
fOPcEJQALBUKXaSGYTIMFZdbRNHVCWDeg,LAAAKAAA.aADDGACA.TAEAMAFAdBFARAGFHCABCBHAeCABhABAOCHD.EDFBACCBXDDChACASEDHFDGDbFFChAAA..NDIA.DGAAfFCEPHFC.cFFChBHA.....hACA...,2,-15,-4,11
eVOCbAEGIHRKLfYWTJBZPdUaSXDcQMFNg,EAAAHAAARACA.LADB..fAFBTAFAZCFAdAHAaAHDDCCBMCABhAAAFCFBeDABCCCCGEEAhACAKDDBJDGBBEHD.SFAAhAFA..cFGDNHAB....hAAA......hADA...,2,-28,8,36
KGFWecNEQBaJVULSOIMPYHRATbDZXdgCf,TAAAZAAAdAEACAGA..GACAFBHD.eAEA.EAHFaCAAUCGBLDAAhABAOCAB..MCGBhACAHEABADFB.bCEDDEEBfEHEhAAAKEHB.cGGAQGAA.BFFDhADA.SGHDhAGA.IHEA,1,-2,-21,19
cNGUYeSHdQBVCfFOAMRPDbZgXKJWIETaL,RAAADAAAZADBKACA..JAFBEAEE..LAHBGAGAeBBBHDAAdEEAQDDAhAGACCCC.ODFFhAIAAAAAMDGB..bFCC.hADA...WEHBaDHDNIBBSGHDBGHA.hBAAFHBA.....hBIA...,2,-16,-15,1
EUDFPKQHATBZWSaXNfJLOGVbgcICRMedY,ZAAAaAAA...XADBJADAGAGA..bAFA..ICCAhAGARCAAeCEAEDGAFCEBKDBD.HDFBhAIAAAGATEEASEHHhBAALFCBOFEBgGGACHHA...hBBA......hBDA...,1,-2,-17,15
GPHgALKFQZMTECfeJOUBDaWSXVcIdYNbR,LAAAQAAAZADBEACAeAFA.UCAAaAED..SAGAhAAA.XCDCICFAhABAdCGAbCGDREBBHEEAABIBMEEBhACATGDACFFD.OHACDGAA.cGGANIDB.hAGA......hCDA...,2,-21,13,34
PcDGNaXRgfeHCWAOdSJQFLIETUbKVBZMY,dAAAQAAALADAEACAUCCA.KAHBZAEB.MAHB..PCFBhACAGCFA.aCDBRDGFeEABhAEAHEBAAAIB.SDHHhAAAFGCA.bGBABGGDDFFB.NIDB.fGHAhBEACHAD.....hAFA...,2,-22,13,35
GLPgbMCfKJcSTQRFUXZWOIeVdENHYBADa,GAAALAAA..bADAMAEA.KAHBSAHBRBCAFBGH.ZCDAOCABhABAeBHDEEABHDEAAAABaECAhACACEDD..JEHBTEGAhADAQFBCXFCCIGFAdGGDYFEBhAEADIDA.....hACA...,1,18,-17,35
TAgIMOFLGRPbYKdBHJCDUaQeESVXZfWcN,MAAALAAARACA...bADDdAFA.HBGBDAFAQBFAEBBB.hAHAXCAAZDDAfECEhAIANAIA.ABIBOEHDhBAAGEEAKEHDCFFDeFDHSFBAWHFG...hCAA......hCEA...,1,-7,-11,4
gTFYdVGDeEaSOQIRNJPbULZKACcXWfMHB,XAAAMAAAHACCBADAFAFAdCCAGAEA.EAGAaAHD...QCFChBAARCGBJCDFUDAAZEEAAAAA.hADACDHA....fFDEhBBATFFADBIBeFHHOFHD.IGAAhAGA.....hCAA...,1,-8,-16,8
NDTbfHPAZUQWLOKYCBSJFdaVXgGIMERce,ZAAAQAAALADBKACABAFAFAEA.dAHA..aAGDXCAAGCDAECFBhAAARCFB..eDHHTFFAhAIAHEEBABIB.OFAAhABASDCDJHBA.IDHA.MFIBDGIB.hACA......hAFA...,1,-8,-9,1
eaHNBFOICSgLfUJPdEGZKWAbTcVXMDYQR,TAAAXAAA.DADARACFHAEB.FAGACAFALAHBUDEB.dBDAECABhAAAZCEBACHA...bDFDMDHBhACA.eEAAaDCCOEHFhAAASFFD.fGBAPHBAKHEAcGGDhAEA....hBGA...,1,-12,-13,1
HLJZfPAaOMdEBbcTXKYURQFIGDWVCgSeN,aAAAdAAAEADABADA....TAFAKAFARCCAFBHDGCAB.DAIBCBBD.eCFBhACAHCFBZDGBAAHA.bECA.hADA.XFAA.hADAQFFBIHAAWEHHSFHHLHCAhAHA.....hAFA...,2,-34,6,40
QbcOHVEIWeYfaGLKTBdMRNPUgSFAZJCXD,ZAAAXAAAQAEA.OAGFHADAEAGEeCABaCDCGCCBLCFBhAAATEFAdCHARDAAPFEBhABASEED.ADAADFABhABA.cGGAIGHAfHDBMAIBNEAA.hACA......hADA...,2,-5,6,11
BSUMaHKWQJICXRNOFdgeYZcDGLfVAPEbT,EAAATAAABACA.UAEAHACB.QAEA.CAGARCFAFAGEeCABhAAAZCCAGCGALEDBACIBSEBAhAAAaEAHKFFAIHFAhACAOEEB.dGFA.....YFHBhBEADAIB....hCAA...,2,-28,7,35
BPAgMbVKGTNHFIaRLUfWSEcXYZeQOdDCJ,MAAAKAAAGACAHACCaAFARAEALAHB.UEAASAHH.hAAAEBBBXCFDeBFFdDDAhBAACCAABEDAADGAbEGBNIDBFEHD.hCAA..IFFAfFFA..YHCAhACA....hAEA...,1,5,-24,29
WCDARYTaQEfVFKJbeHBZINSXgPMGUOLcd,RAAAaAAAEADE..FADAKAFC..eAFHHBFCZAGBSCCA.XDEAhAAAMBBBGCCAhBAALEHBdEFADBIBAAIBTFDAhABAfEHA.JHEABGGC.NIDB...hCAA......hCCA...,1,-13,-18,5
QOJAXGTbDILRfgYCEHKcaZNdBMUPWFeVS,GAAATAAA.DADARACF.....fAFACAEBHAFBaAHFdAHAMCABhAAAPCDBFCEH..eDGFhACAQCFDADIB.bDBDhAAALFHBEEFFKEHBcGGABHBAWFFD..hBHAOHBA...hDBA...,1,2,-11,13
VQEdSaGXMJbLfYBDWOPRZIHcTUeKNgCFA,EAAAaAAAGACA..MADALAEABAGAOAHDRCEAHEECTFAAhAFAeBCAKCBDCCHB.ACFAdDDAXFCDhAGA..bDEDDBBBhAIAZDGFIGHA.NIBB......hAAA......hBCA...,2,-30,7,37
ZXegYHUNcEKLRTWfCMAJBabPISVdOQDFG,aAAA..bAAA..SACHdAEAQAGAGAEAeCABHAGDUDDAhAAAEDDBRDFFTDGACEAAAAEBBEHAhAGAIGAADBBBFGHBZGCAhABA.XFEANIAB.KHGA.....hAIA......hBAA...,2,-12,9,21
IDJVRBFeNEWGdQbOPaKHYSfCMTXUALgZc,ZAAADAAARABAeACE.EAFEdAEA.QAGA..bBFAaCDCHCCChABA.fDFAhAHAMCGBTFEAADHBLFGBhAIA..gGAA.IDHAhAGA.BEECNEIA.OHFChBAA..,1,-14,-16,2
IJBNLYfDXVZEUeCHMOaRGdTSbFgPAWcQK,QAAAKAAABACBLAEADADAZADE..EAHBeAHHHCDA..aCCARCGFdFCAhAAA.SEFDhAIAFCFBAAFA.IGHAhBCANDDA..XEEA.CEHAMHEA..hAAA......hCAA...,1,-7,-39,32
NBcLPfdAeSOMbVQXJKCGTagDFUEHRWZIY,eAAAMAAA.QADAKADAGAFA..aAFEFAHFHCCARBBBZDEF..ICGAhAAABDHALFAAhAFAdEEAAAIBbEFDXGFAhBAA.CHDADEEBEDHFYGAA.NICB...hABA......hAGA...,1,-5,-16,11
OZVQBHRJXbALWNSGEYIDeaMFgPUdcfTKC,LAAASAAAEAEADADA..eAGFMAGBFBHDUBDAdCAA..TCCAhABAOAHBZCEFQEEAhAAAHEACREGF.XDCChABAAEEBNIAB.IEHAaGEC.gGFAhAIA.fFCAhCAA...,1,8,-29,37
beXgNLDRWTUCYHSBAdVafZQcIFPGJMEOK,aAAAZAAAQAEA.FAGEGACA.EAEAbCABeAGF.XCEDhAEALCEARDGFUGGBhAIAHEEAAADAdHCBfFHAhABA.IHEAMBBBKBHBDCIB.CDDDSGGDhACA..hDAA...,1,-4,-11,7
IegYLEUHbMKQfBOSPdcRAWCVZTXGFaNJD,CAAAZAAAGACAaACA.DAEAeAEH.LAGBHAFCMCABQDDBhABABCBDSCEAdEGAAAIBTGBAhBGAFCHD..JEBBgGFGhCAAEEEAKFGA..OFCD...cGFChAAAWCCDNDIA...hACA...,2,-20,0,20
MQXWHDEeRLZYbSJIUONVTKaCPFAGcfBdg,GAAABAAAdACAMADAQAEAHAFCECDARAGB.ZCFE...SDBHhAAAIDDA.OEEBhACATDFAaFGA.FGCBAAIBfCBEhAAAXGEDDGHBeDHH.bEAC.UGGBhAEA.KFDA....hBCA...,1,10,-16,26
cQHGFYMACDEdfNabPBJXeTKUVLZOgISRW,EAAAdAAAaADABACA..eAFHKAEALAGBZAGB.OCCASBDBhACARDDA.QCBAhBAAHEAAGEGAMBIBAAIBfGCAhAAAbEEAXGEA.......hAEA......hCAA...,2,-19,-7,12
dDNLIUbXSKcVfPOYaJWMeTGEZFHCRAgQB,QAAAdAAALADAUADASAGHKAFA..VCFAOBHD.hAAAaCAEMDBAGCEAEEEBHGFAhAHAAAEADDDB..bEGDfEHAhAIA..YECF..hACA......hAIA...,1,-12,-23,11
JBQDUTXKZSFPWHVLNeaYGMOfEbcRdCgAI,BAAAQAAADACAUAFAKACAZAEB..FBCAHAGBLBHBeCDDGDFAhAAA.MDIBECCBRDFBhAAAdEAAAEEB.TGBA.hAIASHEGPFBB....NHDBaFDCfECEhAEA.CHHA..hBFA...,2,-37,12,49
FNGRAUdSQIbCcOHKgEafMYZVLXDPBJTWe,dAAAQAAACADAHAEBKAGAEACA....aAEDMCCBZAFBLBHBhAAADCHBBDAA.TDCAFDDBREFB.ACHBSEBDhAIA.hACAbEFCODHD.fFEEXGEA.PGAAhADA....hAGA...,2,-32,2,34
MVFbNCIBLJSgKdfGaceTURDQHZPOEXWAY,MAAAFAAACADA.LAEA..SAEHdBBAaAHD.eAGBRCEAHDBChAFAZCCAEDABADIB..bEFDBAHBhADAKEHD.GDFA.hAGATGCAQFCBOFHD.....hBAA......hBDA...,1,-10,-19,9
YcfJEPSaHdILFACRVeGUgBQDTZWbKMNOX,RAAAeAAAGADABADAQAFAZAEBKAGA.MAIBOCCB..XDAAhAAA..fCGAhAAAEDFAaDDHHEGBdEEALEHBhABAADAACFAA.gGCBDFFBWHBA.YHFAhAIA...hABA...,1,-8,-22,14
IGCMNRHOKWEJZFLScbafPDAQeVgdTYBXU,eAAAdAAABADAUAEAGAEA..MAHBHAGDKBCBECBAZDEALDAAhACASEBAaCHDDDGBAAAA.hAIAQEDD.hBEATGAAXFDACFHAOHFAFGBBfGGAhBGA.....hADA...,2,-23,-6,17
cCaMdZLSIKXNGgEBDeYOTQbWfFHVURAPJ,JAAAaAAAZACBLADB..KAEAGAFAEAGEDBBBeAHB..TCEAhAIAbDCA..FDHHHCGBhBAARFAAAAFB.CECAdFFA.XGCAhCAABCCCQGFA..fHGFhCCA....hCEA...,1,-10,-20,10
MAXUBQFJaNGPCZcDIdOHeKTRLYgfEWbVS,BAAAQAAAaACAGAEAZACBDAFA..dAGBHBEAeBCBRDEALDHBhAAA..fBHEhAAAEEBAbGBA.MDBBAAIBFGFBhBCAPDGBCHHA.OEDD.KFHB.YFFFhBDA....hCAA...,2,-21,0,21
NJHIAZUXfcFGKYREMWTCLaPVBDQOdgSbe,ZAAAXAAAFADAGAFARADA..EAGEMAIBCCDD.LCAB.aCCChABABCFA.QDAAhAAAdECAbEEA.eCGHJHAAAEEAhACAfEEAKGGD.TFGADEIBSHDEhAHAHFCB....hBHA...,1,-4,-10,6
XOaPDNFAZcSdRgEBHTLYJfWeIQVUKMbCG,ZAAAdAAAEADAHAEALAGBJBHB..eCABQCBAKCCD.bBEDGDEAhABA.aEAHDAIBAAHARECBhACATEGA.fDAEhACAIGGAMEIBOFFB.FGBASGAAhADABGHA....hAEA...,2,-9,-2,7
MeNWdVbSKUCZFfQYGXEcDaOTBAJHILRgP,HAAARAAAMADAeACE.dAFASAFACAHAZCCAFCGD.QBDDGECAEEEBhAAAaAHD.BCGDACIBLFHBhAHA..gDEGhAAA.PDHD.WCCDKGFA.fGGAhABA..hCAA...,1,-3,-33,30
YcKWdZRbEMJCLNDOFQeTGBXPafUASgVIH,SAAAVAAA.HACBKADCZAFBEAEAMAHBLBHB.DCDAQCEAhAAAGDDABFBAaCHDAAIBhABA.IEAA.hAAAcEECRFGBCGFDFHCCeFHB.TGBA.fGDBhAEA..hBGA...,1,-9,-23,14
EHPdWLTNQUJXOMDIBVKcSZCgeAGFbYRaf,GAAAFAAARACF.EADAHAEBdAGALBFDQAGAUDCAODEBDAIBBDGBhAAAKDGAZEAA..eDADhACAAFFAaFGD..fEHAhADATGAA.XFFDMFIB..cGDDhAEA......hAGA...,1,-6,-11,5
PXNcSWJbMGAdRKTgOCLFeVQBZYEUfHaID,RAAATAAACADB..eAEHQACCZAFB.EAEEHCCBDAGA..XBFAhAAASAHH.bDGDhAAAABIBdDDA.ODGBhCAALEFDBECCfHBBaDHDIGHANIEB.cFDDhCEA....hDAA...,1,-8,-21,13
KcgJZLBGNCbTAUYFRfHVeDWdQXSIMEaOP,FAAAHAAAeACHdADAQAFA.SBHBEAEAaAGDKCEAJCAFZDDAhAEAGCDBCCHA.ACCBREEADECBhAIA..XFAAhAAAMEHBOFFBgGGALGBABEHBNEIA...hBAA......hBGA...,2,-20,7,27
LdOMDbSWgTPYCfZUQKBJHRGIEcAaeVNFX,eAAAFAAAdADAMAEADAFA...SAGA..TBFACBCAZBDBQCFAhAAABAHAHDBARDFAhBAAEEFBACIBaFBCXFCAhABALFDBbFGD..WDHBgFFA..hBDA......hBFA...,1,-3,-26,23
OdPHNLUQGFZTVgRfCJYacXEDbKBSAMWeI,eAAAdAAAHADALAEAGAGAZBAE..TCBARCDACBHA..aDFEECFBKECAhAAAAAFAMDAB.ODEBhACAPEHDQFFAhADA..FFAB.fFFA.cGADhABADDIBSHGAhAIA.NIBB,2,-27,-8,19
adAHLJGMNcOeRDQVUfEYWTZBbICKXPFSg,HAAAGAAAMACAOADARAEADAIBQAGA.UCDAECCATCFAhAAAZDBBBDFBCDED.KDHBFDHDaFFAhAAAAFFALHAA.hACA.cGCBfGGAYHDG.IHHAhBAA....hBCA...,1,-12,-15,3
eOFJIcWMTdfQbPDRKGCBgaVYLHANSZUEX,ZAAAEAAA.eACEFACD...JAFA..IAEAMCCB.dAGAQCGAhABADAIBRCDAGDGABDDAaECBhAAALEFBHFEBADIBSGBAhBGAOFCC..WHFA....hAIA......hCAA...,2,-29,-8,21
RGTFaMcHICPgAXUKeQfSdBLbJODWNZVEY,KAAAeAAAQACCdAEALAGB..bAEBDAIB.ZBAE.EDDARAGBGCDAhAAAFDHD.aCGHHEBAhAAACEHAAAIBUGFABFEAOGBEhABA.VGFA........hBEA......hBGA...,2,-16,-6,10
XSgRTVOBCcLPNKEYIQbeGfaAUMDFJdWHZ,MAAAFAAAdADAHACCZAEB.SAFBRAGB.OAHBCCCDLEEA.hAIAKDBDEBBB.QCEDhBAAeEHHGGCBACIBDDDB.hAIAXEFA.gFEGBDFA.NEIA.hCAA......hCDA...,1,-12,-26,14
aVKWHCLbSZDGBAfgIYMJTQPdXORUcENFe,..IAAAMAAATADAdACA..RAEAEBHFeAFE.KBBAHCDALCFAhAIAZDFEGEAAABGB.fCBEhAEAgDDBQFGAhAFAOEGBNEIAaHCACGCADGFBBHGA...hAHA......hAIA...,1,-1,-12,11
JbLgMGEDYITXHBdNWZCfVPKROSAQFaeUc,aAAAeAAA.UAEA..bACDMAHB.EBCADAEA...TAGAhAIAHDDAdEHAZBEFCBBDVGBARDGFACGBQECAhBAAFFFBJHFE.hAAA..gGGA.....hABA......hAIA...,1,-9,-13,4
EIKXVLfGPegCQFcJDbSadABTUYZRMHWNO,TAAAZAAAHAEA.OAHDEACE.KCAALAEBGCFA.eAGB.QCCAhAAAFDDBDACAaECHAAHABDFAhBIARFDF.MCIBIFHAhABAfEGA.CGCA.cGAASFFDhCAA.....hAGA...,1,-4,-18,14
NVOadHfGFSUBPLDXIQTMERWJbCZecAgYK,KAAAOAAAHACBGADASAEABAFALAHBDAHB.QCFAhAFAECABRCEA.JBBFZEAAADDB.hBAAgEEAVFEAdHBB.hBDAFDHD.XGGAMEIBCHHD......hAAA......hACA...,2,-18,-1,17
LSRMONWKZXJaYFgUbdBIHCGTEDAfQeVcP,eAAAVAAA.LAEA.RBCB.MADAOAHDKAGAZBDB..aCEAFCFAhAAAUDFBdDCCHEFAGFABhAAAEFDFAAFAQFGBhABASCHH.NIEB..........hAIA......hCAA...,1,1,-21,22
CXdUTYAPJZNQHEbKIcDMVWFOeRLgGfSaB,ZAAAHAAAEADEKADC.DAGAMAFAFBED...RBEAGCAAaBGA.BBHBdCADUDGAhAAAACAB..PDDBhABAQDCD.bFEDhACAIDHA.cEGC...OFEDhACAgGCACGGD.hCCATGGA.,1,-11,-14,3
HcXaFQKbADOVeJPMCZRSBfTYLdUgWEING,OAAAeAAAMAEARADABAGB..TBCAdCCAUCFAEAHFGBEA.hAEAHDGBaBBHKCHBAAAADCIB.hAIAPEBAZEEA.fGBAhBEA.gGCHIHHAXFDChBAAQGGB...hBIA...,2,-36,16,52
cZXYQVEKAeIDCaHdUbFROGfPBJSNgLTMW,eAAACAAAHACAdAEAFAFARAGBGBCABBHA...SCFHLCABMCCBhAAAZEBFQEGAhAAAECGBADDADDFB.aEEH..bECDfGAAhABA.NIBB.TFGAXGGCKGFD.hACA......hAEA...,1,8,-24,32
CBWURTFGObgcedJaQZSIKDYLNfHMVXEPA,BAAARAAAGADAOACA....bAFAeAFAaCCH.ZBCA.KBHBLCGBhAAAHCFBMDBAEDABAAFACEEDUGAAhAAATFDA.FDFBdFHAhAGAQGGADGGB.fHAB.hBDA......hCAA...,2,-19,7,26
aEIZdMCQHSUKfDOBJTWRNeXAgLbFPGYVc,LAAAFAAAGACAVAEAEAEA..ZAGBdAHA.MCAAHCEB.KDHBOCDChABATEAARDFA..eEAAhACAABIB..bFGD.PGBChAEAaEEHQGGA..fGFAhBAABHFD.....hAEA...,2,-13,4,17
cEIaKHNPfSXQeUMFGRCZDOgLAJYWBdVTb,JAAABAAA.dACA..TAEAEAEAKAGA.HCDA..fAGBhADAQCGCeCCBMCBBRCEAZEABhAEAOEAHACHA.VFCAhAAAbEEAaFHDSFFB.FFHBDGEA...hAEA......hAIA...,2,-12,-11,1
CQLReNKSOcaXUGbVIdPfZMTgHYABDEJFW,EAAAFAAAQADARACA.KAFAOAFA.aBEEGCCA.bCFAhADAdCHAZEFAMCCB.HDDAhAAAAAHADGCBCDAAeFDASGEAhBAAXGGAIHHAfHDB..hADA......hBIA...,2,-16,-13,3
VeNFLJWSKIXcbaBAdRECOMDQGTgPfYZUH,EAAAMAAAGACA..TADA..fAEBZAFBHBBBeAHFhAFALAGBSCHHhBAAXCEDaDECAAIBREBBDFCAQEGAhAAAgFFAPFFB....hBCA......hBEA...,2,-15,-7,8
CaWNZMcFBSeAIJOEPQdLbTUXRfVGYKDgH,OAAAEAAAdADALAFAUAEA.RCBB.GBCADCGAHDDBaAGEZCFE.MBBBhAHABDGA.AAGAIFGAhAAAQEEB.bEBDfGDEhBCAKEHB.CGHA.cGGA.eHCAhBAA......hBEA...,1,-7,-20,13
fQXFOMBePJKHTUYWSIDAEgdRCbVLNaGcZ,EAAARAAACADB.LADAGAEAZAGBQBGA.OBCBeCCBKDHBHDDAhAAAUEEBSEABhAEAAAAAdGAA.bEGD..aFGDXFCChAFAMICA.BFFA......hAHA......hAIA...,1,-3,-21,18
WEDVQSaJeHIbRdMZOYKcNATBCfFPLgGXU,TAAACAAAFACA..LAFAGACAUAFA.ECABQCBAhAAA.aCFAHDFARDDFZFFAKAHBhAAAAAGABDGDfEAEhACA.XEDDDCIBSHFAeFBHdFHA.MHDAhAEA.....hBCA...,1,13,-33,46
eZHPTYCUKSGacBXDIMNfdRQEbAWVLJOgF,LAAAOAAAFADDHADB.TAFACAFA.SAHBaAGDBBBDDAIBhAFAMCAB.dDDDRCDA.ECGFADHA.hBAAVEGB..eEFAhCAAZFABYFFFGGEB.......hDAA......hDBA...,1,11,-34,45
XbEQIZTWLHYUNecPdFVMRKCgAJaDBOSGf,aAAAOAAAGACA..XADAEAEAZAGBLCFDHAGBUCCAeBBDhAEAdDFAMBBBREDBKDHBABIBBDHAhAEA.SFEDhAGAQGBATFGAYFHFcGBA....hAIA......hBAA...,1,7,-17,24
fMEDcVQBFAdGeCZSgNJWXULaYbIHPTROK,eAAAZAAASACE..gADAJAFAUCCB.aAFD.bAGDHCFAhABA.REFAKFBAECCBDAIBhAAA.QEAAhABAABFBdGHACFED.XDFCLHCAIFGA.OEDDhAEA.MEIB.hAIABHHD.,1,-9,-12,3
UegdZaTEMbYXOGVKANLHWFSfDQPRIJBcC,HAAASAAAQADCRACFBAEBCAFBUCAB.eAGHZAFBEAHF.MCEBhAAAbDDB...OCHDhABAGDGAAEGBLFCAhCAAfFCADFHBPFFBIHDA....hCBA......hCFA...,1,6,-24,30
XZJfSTNMIFdYGcKQBeLaUEDWCOgRHVPbA,ZAAASAAAMACAdAGAGACA.KAEAeBDHLAGBECFB.CCEAREAAHDGBhABA.VFBAAAAAXDGAhAEAJFFF..NAIA.FEEBhAIA.QFGCBEECDCCB.OGCC..hBIA......hCAA...,1,-8,-11,3
WQUfIYOPCHMNZRbTGDXdKaJScEBAFgLVe,LAAAeAAAQADAUAEA...fAFFOAGFHCAAZBGBRCCBhAAAGDCBdFEAKGCBaCHDSCEAhABAEFDBAAIBFFFA.gEGAhAIAIHHA.CGHA.......hCAA......hCBA...,2,-12,-6,6
VdeXZDNYSOaGLPbHWAKQIFCMRUTgcJBEf,QAAACAAARACA.UADATAGA..JAFEECAAdCGAZCDBDBIB..hAAASCFHGDBALDDBhBCAHDACAACAFCHDMEIBhBDABFAAeFEHXFDAOHFC.aGAE.PHFChAAA.....hCAA...,2,-12,-4,8
NKWMUHJACOXfcaGRQdSTYbBFDEIeVLZgP,XAAAaAAAGACARADA.dAEB....TBGAbAGD.DAGA.ECDBeBBDhAIAZDAA...gDFGhBAAKCFDMDIBHEFBhAAAABFBfEDASHEGFFFHIHHA.hABA......hADA...,2,-16,-6,10
DFfBSKNHCIZTPdAVQReXUOEJcYGWMbagL,RAAAeAAAOADAEADA....JAFBGAGA.MBEBaAHBLCCBhAAAFCCBSCFDHDGBZEDBhABAdFFAAAAAQGGBhBIAUGBA.WFFDbFGDfGDF...hCAA......hCBA...,2,-9,-8,1
WSPGJRQUcENOTAbZfdMKFVHBDXagICeLY,ZAAAdAAAMADAFADAHAFBDAHB...aAHFCBDALBFB..SCAAhABAGCABRDGFQFCAhACAECEBTDGAACAAKFFDXEEChACA.eFHF.PHBA..hBHA......hDDA...,1,-13,-26,13
IfWbABHMSPQRENZFaOcXJYdTDVCGUeLgK,HAAAMAAA.QADCEADAZAFB.aAFAOAHDXBFDdBBADCEB.GDCAhBAAeCABLCHBhAAAKEGA.fCCEhACAABFBSFEHREDAFFCHcGGATGEA.CGGB.IHBAhBHA...WHDAhCAA..,1,6,-15,21
LfUCPJeMONSIZDHGEQRXFKbTgcBAVaYWd,aAAAdAAALADA.CAHA.eACH.MAEASCAAZAFEHBDBECEAhACARCFFKDHB..bCGDTFGAhBAABDCA.ABBB.VEABhAEAfHCBUEEAOHAEDFFB.....hCAA......hCHA...,2,-16,-13,3
CfJHSaWeXBdRPOgDAIELUQVGNTMcYZbFK,EAAALAAAUADAGAGAMAEAZAFE..KCBACBDAHCAA..aDEAeCEAhABAdEEARFBBOCHD.hAAAAEEAQEFDhACATGFA...cGGCFEHDSGADBHDA.hCAADIDA.....hCCA...,2,-13,-11,2
DRGLXgIaNWFHAbMJTcYOeUZSdCEPfQKBV,MAAATAAA..OACEeACEZAFBdAFAEAHBQCCA.BAHAhAAARCCAGCGALCHBXBBChAIAaDBHFEFBHEEBADHBbFAAhAFAcGDCUGGA.CGHA........hBDA......hCAA...,2,-5,0,5
KVIQMDREUYFGLPWdZSegCfTANHOJcaXBb,HAAAOAAAaACABADAKAFA...QAFARCCAEBHF.FBBHGCFAhAAALBHBdFAAeDHHCCEAADDB.hAFAJEEFXDFD.hAFAIGGAMFCBDGIBPECB...SEEDhAIA.fHDBhBAA,1,-10,-21,11
aHCVgEbFSePAOGfUQNIRTJLZYXDBWMKdc,GAAAQAAARADALAGBZACBDAFABAHAKCDDdCFCHBEA..CDHAEEABhAAAbDEA...FEEHeEBBhAAAAADA.OEDBUGGA.TFFAhBCA.XGDDMIAA.aFHD.SGBDhBEA...hACA...,2,-21,9,30
LAENDCMKbcgJOFUWeYRQGTfPVdaBXISHZ,EAAACAAAKACA....bACAJAEA..FAGAUCAAeBFH..RCDA.GCCAhAAA.TEAAVDGBBAHBhAAASCGH.hACAHFFAACDAMEFBOHFE.WCHHQGCAhCGA.dGGDaDAG..hADA...,1,-3,-29,26
UHbACXeJWDOPFELGBTfRaSQVKcgZYIdMN,eAAADAAAFACDEADAGAEABAFA..RAGF.QAGAKCCAZCEF.dDDAMCIBhAAAHDGB.AAEBCFFD.JGAAOEEHhABA.TGGAhAIAaBBHSGDB.......hCAA......hCBA...,2,-24,-16,8
PJFSdAWBcYRVaLgIfMZOKDCQXTGbENeUH,BAAARAAALADB..fACAZAFADAGAQCFAGADAEAFAeCCDhAAAHBGB.FCABADHA..hAAA.cDFCaEEBMEIBhABACFAATGCAUFFASFCDdGGA...hACA......hAFA...,2,-14,-10,4
WSKcVGOUaAINFeBRXJYTMdPCQDfELbHZg,FAAARAAA..XADBTADAdAFA..QAFAEAHBHCCAZDAFSBHBhAAAKCHDGDFAaCCBACFBhABAeEEDBDDAMEIBDDGBbDGDhAIA...gFED...hADA......hAIA...,1,-5,-14,9
GHWRFSLgDITPOZdXbMVAYUJKaEQNfcCeB,UAAAaAAA.EADAQADA..fAFAeAFAHCCARAGFLCDBhADADBBBTCGAZDEBbEEBhADAACIBKEHBCEHAGGABFGFD.hAIASGFHIHHA.......hBAA......hBCA...,2,-21,8,29
MdVfXOCcLFHRIbSGBDTAPJYZKgQeUEWNa,JAAAZAAAQAEA.EAGAaADA.dAGAXCAACBDALCCAHCFChABARDEA.SDDBhACAGGBBDAIBABIBKEAA.eECHhADAUFGAMEGB.OEHD.FFED.BHHDhAEA......hCAA...,2,-31,8,39
ZScfETYNBHLeGRXWIMOFKVdgbJDaQAUPC,CAAAZAAA.SACEEACA..TAEABAFAHAGBeAGHRCAAXCCAhABAMAIB.KCFDdDEAbEFAaDGDhAAA.ACAA.UFAA.fGEAhAFALECBGGEBIGGAFGAB..hACA......hAGA...,1,-4,-7,3
QcgBOHdXVPZeIEFJWLRNbTKaYUAGCMfSD,GAAAMAAADAEAQADABAGA.HAFAdBBA.XCDCZBCBEBEFFBHDhAIALCHB.RDFFNDAATDFAhBAAaEEBAAAB..SGHBhACAOEEBeFGFIHDA..WFDDhCAAKHAA.CHHA.....hCBA...,1,17,-28,45
DUERXVBPWabIFOeAdCgLGJHNQYKZMfScT,dAAALAAAHADAQAGCZADBMAGB.SCAATCAA.ECEFRCGFBAHAhABA..aCGEbCEDhACAODCDACCA.GEFAhACANEIAKFBA.DEIB.XFACPHAAFGGBeFED.hAHACHHA......hBFA...,1,9,-9,18
EZQBLXKJATUGWHcRYVfDSMgPNeIdabCOF,GAAAHAAARADF..VAGBSADA.MAGBPCABeAHBaCCHOCDBhAAA.EDGFZDFALCEBhACAKEEDAFCAUGAAcEAChADADFGB..IHHAbFGDFHCA.QGDBhAAA.....hAEA...,2,-5,3,8
HSceCMJYbPDKOUIgBEATWFZVNfdRQLaXG,TAAAZAAA..fADBRACFLAEBGAFAHAGBeCAB.MDGBhAAAbCABKAHBODHDIDDAhABAEECAAAGBFFEB.dHGBhACAaDFH.SDHBCHEA.PECBDIAA.hAIABFAD.VFGB.hBIA...,1,8,-1,9
bRXKBGQDEAOYFSfdCIVeWcTaLNMZgJPUH,FAAAdAAACADAeACH....TAFAaAEAMAHBZABB....PBHDhAFAHBDBRDFB.BBFDGCEAhAHAEFHFAAIBSDCHhAIA.fEGAIHEA.cGDA.hBAA......hCAA...,2,-29,-16,13
HMCUKFJEABaSgLbRcZNYOWVGIePTDfXQd,aAAALAAA.RADFZAFBOACDGCAAeAEADAIBQBGAHCGBMDDBhABAKCEA.EEAAACABSEEBhACAbECA.NHBB.VEGBhAEA....TGGAXGEC..hAFA......hAIA...,2,-14,-2,12
BSebLPaXFRdIJZMfgYGCHETcKOAWQNVUD,QAAAUAAABADA.eACALAFA..aAFDRCBAdCFAZAGBMBIBhAAA..fCHAhADAGCDAHDABEECATFDAhAGAOEHBACDB.WFDDDEIBbFFBFFFB...IHAAhAHA...YHCAhBAA,1,-8,-13,5
dKUXIDHAVTbROECPGcFYBNaWJMgZSeQLf,TAAARAAAEADE..GAFAFACABAFA..aAHFMAHBZCCA..eDGHhAAALCCAdECAKEEDXCFDhAAAHFABADIBOFHDhABACECAPEEB...cFAA...YDHBhAFA...NIABgGGGhAIA,2,-15,-9,6
gYRMXPeLKCfQGAJVFBbDHZNEdcIOaSUTW,FAAADAAAHABCEADA.dAEAOAFCUAGA....TDDA..gCCAhADARDFFMCCBeDHHhBAALCFAKFDD.QEEAhAHAAGBABGHA.ZEGBNIBB.aGCA.SHCGhAIA.WFHH..hBAA...,2,-24,-12,12
EDJARLPXbGQcZOYHBTfCdKWgFIVaUMeSN,RAAALAAA.XADDGADAZAFA.HCFATAFAdDAAKCCDFBHDaCAAhABAeEFA.EFEBAAHAQDDAhACAOGAABGGACDFAgEGAhAFAIHAAMFIBDGIBPHEA.hAAA......hABA...,2,-7,-3,4
SbMUZEgeBFKIARODdCQLHfJGTWcVNYaXP,RAAAdAAALADBHADAGAGA..TAFAVCBA.aAHDSCFDhACA.MDABECFBeCCDhAAAKEEDAAIBCEHAQEEChABA.fDHAcFADXFGCbFABgGGAhAFAFGDHIHHAhADADHDA...,1,6,-9,15
MVaZGEAdLgWbBNIcHSfXOPYDTQFeKRCJU,dAAALAAA..bABDBAEA.IAGAHADAXAGBOAHDDCAAhABATCEAFCDARCFFCCHAMDABhADAZEAAGEGAAEEB..hACAgEGANEEA.fGCAYFFF.hAEAeFAH.KGEA..hAFA...,2,-12,-6,6
ASPLNefOBHGMWEbQgZaRUICKYXdcFTJDV,LAAAeAAABADAHADBGAEAEAFA..QBGAaAGARBGF.CCAAXDDAhABAdCCATEDADCCBAAAA.hBGASDGD.hCAAfFAAMDIBbFGDgGEAIGGAKHEAhACA......hAFA...,2,-15,-6,9
ROAFEdCYPbfUaDHJSLcGKVITMZBeQWNgX,EAAAdAAACADA....bACAaAED.HAGBLAGBGCABKCCA.TDAAhAAAZDEBeDHF.QGAAhACAgDFGRGEAAAGBFECDhADA.fEEEDGIB.SEHHhAEA.IHHA.hADAMAIB.,2,-20,-3,17
cZCODgIAJELXMHWbafPNTGSRKdVYBUeQF,EAAAMAAAHACA.aAEA..fADA.TAFARAGFdCCDBCFDhAAAeAHHQCBChAFAZDFEDEEBAFGAXFGAbDEBGECAhAHA.KEHB.VGFA......hBAA......hBBA...,2,-22,2,24
TWVRgCeAQESLMaHDOGfPdBNIUZJbFKcXY,EAAAMAAAHACAGACBdAFABAHAUAGAZCCAFCCHKCGA..XDFDhAFA..TEAARFCAeEHHhBAAADFBLEEAaGGHDBBB.hBIAfFHAIHEA.cGEA.YHAAhAAA....hAEA...,2,-26,-4,22
KfaMTIbPLWAGDYgNeSOHXdRcQVZFBCUEJ,GAAADAAA...NADA.eABAHAEARAEAQCCAZCEACAHB.EBHFfEAEhAAA.aCGAhACAMCGB.bEGDLEEBhAEAAAHASEDAdEGDFGAHBFAAKGGA....hAFA......hBAA...,1,5,-31,36
FPbXKUAcIOfHgWJYERBdaVTeNGZQDLCSM,OAAAHAAAJADARADABAGBdAGA....aBHDeAHHZCAALCEBhAAAMBBBFCCB...XDGChACAACFA..fDEAhAEAgFGAEDGBNIAB.QFFCSHFG.hBAA......hCAA...,2,-31,-7,24
gfISENdBAcYKVGXLaRDUQTHWObeFPZMCJ,KAAAGAAALACBRADAQAGCHAEAOAHDeCDBZCFAMCEB.CCFA.JEAFhAAA....fDGAhAAAEEGBdGGDAADA.cEAAhAEAYFEB..aEHDDIAATFEA.bGAAhAGA.FHFE....hAHA...,2,-11,-2,9
ObMeHRBCdaEDVIKSgGQPALTfXNYZJcWUF,TAAAXAAA.ZACBJACA..UAFAFAFA.MAIBHCCA.RCFFdCHAECEBDDGBhAAAKECD...GEBAhABAAAIBLFFA.fHFBhAAAcEECbEGDCHHB.aHDA.....hCAA......hCCA...,2,-18,-8,10
dVESXPbYfGZAUegWHQLOMICaTFDcNBJKR,eAAAHAAALADBMAEA.aAFATBCADAIBBBFARBEFdBGA..ECABXDGAhAAA.bEBAGCGAhAAAZFFA.ACCAgDEFhACAOHFC.FFBANIAB.KGFA.....hABA......hAIA...,1,-5,-9,4
ScGKXbOLQZeWANFERHJaYgTBCDMUVdPIf,EAAAHAAA.aACA..TACADAFAMAIBdAEA....fAGAhAAAGBDBbDDALCHBhAGAeDHBABGARFGBgCCGhAIACCCD.PDFBSFFDXGDC.QGGAhBIA...hAAA...,1,3,-11,14
gFSZbMIAdVOLNRQHBKGYUXDJTcPefCaWE,dAAALAAARADAHAGBGADAUCDB.DAFA.JAHBTDAA..eBFHhABAaDFD.ECAAFDHDZEFBMEEBhACAADDB..ODHDQGAAhADAKFBA.XGGAfHGF...hAEA......hAGA...,1,-6,-16,10
QcFHIOXJRWBbaZUYNDfEGCPVTAKLedMSg,eAAAdAAAMADAQADAHAFC.OAFCRBDBBCBAZCCAUCGBDCGAEDGAGEGAhACA..CEEDTFGAhAAAADDBLFCA..SGDAhABA.FHAA......hAHA......hAIA...,1,-15,-20,5
PUEWYBIKeHAJQLOTdXfVbZSNFGDaMRcCg,LAAAdAAA.XADDbABDZADA..FAGAaAFA..RCEB.CBFBUCAAhABAECGABDHAKBHB..HDDAhACAAAEAQECATEGASFDAhAIADFGA.MHDAgGGA.hDAA......hDCA...,1,-14,-20,6
JGdebDFOZVcCTSNXPIWgKRHQAaMELBfYU,EAAALAAABACAUAEAdAEAeAGB.FCAAZAGB.CCCA.SAHBhABA..XDEChAAAIDDAKDHBHCFBABIBaEBAMDIBhACA.fEBAGFDBbGBCOFDB.hBEATGGAPHFCWFFDhBEA...,2,-16,-16,0
KZMeFcXgCNLSHEWYBIdQVJGRPUTOfaDbA,ZAAAeAAAFADA..XADACAGALCABHAGB.ECCABBHAdDEAQDGBhAAAGCCBRDFA.TEAAhABAaFCA.AAGBMFGB.hABANIAB.SFFA.IGAAPFHD.hAEAfGCA.hAIAKGHB..,2,-24,1,25
DdTNKfgOCXYZAbWRBeIFGSHVPMLcJQaUE,RAAAeAAAGADAHADAMAFALAGB.QCCCEBFEdBHAKCCDOCFHhAAACDAA.ZEGBAAAABDFAhADASEED.cFAAhABAaEFETFDA.fFHAXGCDWFHHhAFA.....hCAA...,2,-28,6,34
fTGEXdcBAaRZIJMYHbOgSKUWNLDPFQeCV,RAAAZAAAMADAHAEA.OAHDKAGA.UCAALBEBFCDD.eCCB.CCGA.hAAATCFAEDHF.dEFDACEBaEFDhABAJFHB...bGCCSGAAhABA.DGGB......hACA......hADA...,2,-20,-18,2
dbXRMaOIAQSPfJZCDgcTWBNeVEKGYUHLF,QAAASAAA.JACEZACB.DAFA..TAFABAHAeBEB.hAAAEBFEGCDAHDFBdEDAhAAARCFAaAHFACIBCDHD..gFCDhCAA.cFFAWFHH.KHEA...hABA......hCAA...,1,-8,-28,20
PCBULGRMXgONdJeTVDEFZcfSWaKYIAHbQ,HAAAQAAABADBGAEARACA.MAHBOAFAdCADeCHHTBFAEDCAhAAAZDAA.SBHHhAAAaDFDKFHBAAGB.bDDBCGGD.LEHBhADANEEA.DFFA.fGEA..hCAA......hCEA...,1,-6,-7,1
UKJLAENgYWdVOePFTDZBHMCfcQXIGRSba,EAAA..gAAAdADAeAFAFBHDZADAHBGB.MAEACBCCQCEAhAAAGCCAREFBaFCHKDDDAAFANEIA.hAAA..VEGBOFEBhABATGDABHFD.........hCAA......hCBA...,2,-22,8,30
cbPRNAKLZIgfWBSGUCFOVXTMJeDQEYdHa,ZAAA..fAAASACEGADAFAFAOAHDTAFA.eAHHhAAAEBEFHCFBaBCB.bFDBRCABADDBhACALFHBgDFBhADABCCDCFADMDIBDGGB.dFEA.PHAA.KGGAhAFA......hAHA...,2,-11,13,24
dcRXVSIHYFNaTPMJWZeQEgfbLKDOUBCGA,RAAASAAAHADBFAFA...aACDMAIBZADBEAFA..bCFDLBHBhAAAOCCBBDAAACFAdDFAXFEChABAVFDB.IFHAhAIATGGAJFBFeHCG.......hAAA......hABA...,2,-10,-8,2
TAUHCJMNKfPWeVDIgdGFZOSBcaXQLYERb,HAAAMAAAKADA..fADBeAFE.DAFAdBBAZBDEBBFA.aCEChAIALBHBRCGF.ACABCCGAhAAAPDCDIDEAGEEAhBAASCCD.QEFDEGHB.hCAAUGGB.NIAB...hACA...,2,-15,-14,1
MCQFdXWAZGIEVNYBcHDLSUOfKeaPJbgRT,GAAAEAAA..VACABADAHAFBLAFAOAHFeCDA.aCGDbCCChAAARECA..MCIBQDGDhAFAdFGAAAABZGAAIEEAhAHA.cGGASDADKHFA....hACA......hADA...,2,-14,6,20
ZQRMLTPWBIfcdKFaNSbJGegACHDYVUOXE,HAAADAAAUADAEADERAFFLAGB..TCCABBBA...fBHAhAAAdDBAaCHD.bDFAeDDBhAIAAAHA.CDFD.OCABhACAZFFAMIBAIFDA.FFADSFBAhBAAgFFAYHFA.hAFA...,1,-7,-24,17
bPfZQeETOYJIDVHScCFNKBGgULXRWadMA,...bAAAZAAA.EADEOAEAJAFA..DCAAHBDB.CAHAKCAAGCDAhABALCFBRCFAdEHAACFAQFBAhAAA.eEGHhABATGFAIHHASFFCFFEHNCIA....hACA......hAIA...,2,-29,4,33
UIMCgTNJfHWVZeBcQEPdGXFaYSLbRDOAK,KAAAMAAACACB...TADA..fAEAHAFBZBBFeAHBQAGAhAAAEDDEGDGAaCCBLCFBhAEARFAAAFAAIGEAhAFAgDDANIAB.VFGB.BDHA.dGAA.hAIAFHDASGGDhBAA.DFDA.,2,-3,5,8
eOEFNgLUKXVRYTJdDIZbPBaQWfCMSHGcA,EAAAFAAALADAKACA.RAGF.TAFAdCCAZCDBBAHB..aCHDQCCAhAAA.CCEAHCGBhAEAAAEAeDGDOEFBUGGBXFDAhAIAVFAADFIBIGGA...hBAA......hCAA...,1,-9,-21,12
IABFHLMefRWOSTNgCUGVEKQPDbJdZYcaX,HAAAeAAARADASACE..TBGACAFAGAGAECCBQCEDhAAADCCAdDDAZDEBaDHDAAGALEABhABAMFABOFCBgEFAhAEAKGFA.PFHD.YFEF.hAAA......hAFA...,2,-11,9,20
HYRVZDdTIgUOaKBMQLEFWGCAfbecPNSXJ,eAAA..PAAAXADAHADA.RAGFZCCAdAGATCCAUDGBaEEHMAIBhAAALFAAFDFAGEAAhABAAFHB...bECASGGAhAFAVGFADEIB........hAGA......hAIA...,1,5,-16,21
PHSEDIeMWGBYVONabTLAQKcdRXfCFgUJZ,QAAAdAAARADA.CACA.FAGAUAEAZABBHCEADAHB.eCHHGDCABDCAhAEAOBHD.aEBBbEFDhBAALEEB.AEGAKGBBhAAAfEEE.gGCASGFHhAIAMFIB....hCDA...,1,-14,-18,4
RNfecLDVXBMIPSEFHQGCATgJdOKUaYbZW,TAAAdAAAKADAUAFA..aACAZABBRAEFeAGHLBHB..XCCChAAAMCEB..SDCHhAIAHDFCGGABADGA.hBAAODBH.bFFAfEGEDAIBBEED.EFEFhCDACHHD.gGGAhDAA...,1,10,-36,46
OGeACWTERdFfaZKgVPIJMXUNYDbHSBQcL,TAAARAAAdADAFAFA..ZACBKBFD..VAEA..JBHBMAIB.XCEChAAAUDEBDCCBHCGBhACA.QFEAhAHALFFAeHFAAFIBEGGE.........hCAA......hCCA...,1,-5,-41,36
cJBSgUFefCQDTGPRLdEaHYXbKOWZIMNVA,BAAASAAAFACA.eACHQAFAGAEARAGBEBCBHDDB.bEABOAHFhAAA.ZCDBMDGBhAAAADGAJEGBfDHAhABA.DFIBTFAA.dGEAaGAH.KHGAIHHAhAFA....hCAA...,2,-28,14,42
XGFRebQKLAJfYUHEcBNSaDdWVZTgPOIMC,JAAAUAAAHADBEADABAFA..aAFAdAHAZBFF...TDAAOCBEhADAMAIBGCEA.RDGFeECBhBAAbDEDLFHBhADAACGB.fCCENIDB.DHCA.gGFAhBAACGGD....hCAA...,1,-7,-17,10
YVTfHdKgaGJSeQWcPEXUIADCZLFMRNOBb,ZAAAMAAARAEABAHB..bABA..TCAAHAFAdCCAKCED.GCGAhAFAeCFH.QEDAhAHA.PFCBECHBXEAAhABAAFFACGGDNIDB.ODDH.fEGAhACA.aFHD.SHGGhADA.,2,-27,4,31
SGdJBXQEWMOKAHfaTbgVULPRYNeCIZFDc,HAAAaAAA.TAEA..bACDUAGALAEARCAAeCEBZBFEDACAGDEBhAFAdDGABFHAEECBMBBBhAGAADIB.VFGBPGECCHDA.hAIA............hBAA......hCAA...,2,-14,-4,10
fVXOSLQIgEFABDMZKPUNTWYabeCcGJHRd,MAAAZAAAKADCUAEA..TAFA..aAGEeAHHGBBAHCAARCGBdDEAhAHAXCECLGEAhBAAQEFA.EFCAhABAABBBDEBBPHAANICB.YFHB.CHFA..hBDA......hBEA...,2,-20,5,25
JgAPeTUKILdYQWCXSVBaOcZHFDbfRGENM,eAAATAAAKADA.dAFAQACC.XAEBBAHAaCCAZAGBHCFChAAADBIBRCDBEDDB.MEGBhABAABGBIEGALFHBCFDDOEHDhAAAbFED.fFFEJHAA...hAHA......hCAA...,2,-10,-9,1
PSILNYAWbUfOgJGEReZBTadQFKDXHcCVM,UAAAOAAAGADARADAZAGB.BAFA.dAHAQCCCDCGB.HEAAhAEACDAA.MBIBSDBHhADALEEAADDB...bGAAhAGAfDHAEFHFaBBHXGEAVFDA..IGHAhAFA.YHBAhBAA.,2,-41,11,52
LWAMXaYbceVGKCQgPOZIDEdTHUBFSfNJR,aAAA..bAAAeACHGAEAQAEA.OAGFZAGBECAAHDDAhAEAFDDBfDHAhAAAREGBAAIB.MEABXFDAhBAAcEBCCECD...gFFBDBBB.dGEA.hCAABGBDSGGDhCEA...,2,-12,5,17
DeBNbAZOaWVHIMKUXcLRESPTGfdYCJgFQ,aAAAHAAA.MACAKADAUAFALAGB.EBDASBBDGCEAdDDCCAHA.hADAFDHD.eGBABCCBAAIBZGFEhAAAOCEB.IDGAhBAA...RFEA..fGHAhCAA......hCIA...,2,-40,1,41
YNBGbIOLaAHfWcCJSDQUePdVFXgKZERTM,HAAA..fAAACADBDAFAeAHFdADAFBEDKAFAZCAARCAAMAIB.BCEAhAAAGCFAOCFDACCAJEEFhAAAQFAAUGBA.hACAXEGDEEHF.YEEFIHHAaHAC.hBGASHDG.hCIA...,2,-12,-7,5
XeDaRNJBKWIUOEZdcQHSgfGMATVLYPbCF,TAAALAAA...bADDXACB.eAEARAFABCAAKAHBICEAhAAAECGAdCCCHEEAfCCEhAFAAAFAPFCBDCGBaEGAhABAJCHFUGGAZEEAQGGB...hACA......hAIA...,2,-4,-4,0
EKQBLgYRVWTDPSCfUOdIXcGMFJAHabZNe,HAAAZAAAEADEQADCLAFBRCAATAGA.SCAACAHAOCEHdCHAhABAXCEAGGEBMCIBhAAAACAA.bDGDeFCBBDDDhACAgEGGVFAADEFB.fHABIHHA.hAFA......hAGA...,1,7,2,5
PdCMXOBNLWATYQScbDJaIeUGHKgfEZFVR,TAAAQAAA.SACADACA.aAEDeADA.HAGBfAGAhAAAECCAZDEARFCAdCHAMDIBhAAABCDDLFFBhAIAAAIBbDABIDFAKGBD.FEEHCCFD.OFHB.YGAGhADA.JHDE.hBGA...,2,-6,4,10
PTbMDREaZFVNGYUBHJecOKIQWXCSgdfLA,TAAAMAAARACA..ZAFBFACAGCDABAFAHAGB.eCCAKAHBQDGAhAFACDEAdDGDLFAAABBBDCCBhBAAEFFA..aFCBYFHBhAAAUGFAJHCE.........hAFA......hAIA...,2,-15,-10,5
NAUJLYFaPIcKgeDRTZCQSGfXdWVHBOEbM,LAAAaAAA..IADAKAEAeAGHRAEFZAGBQCAA.GCDAhABAdCCAHEDAECHFbEAChACAABBBUGAA.FDHDgFFAhAEATGCASGEHXGAABHHA.hAGA......hBAA...,1,6,-14,20
RFEgfSVCcIUWaHBKJdTXDGNLeAMbPOQZY,MAAAOAAAZABERADA.FAFA..EAGE..SAHHCBBDUCDB.HBDChBAAKCGAdEAADCCBGDDAhCAALEEAADDBQDGAhDAA.fFGEIGCAaEHD.TGEAhAEANIEB.....hDBA...,1,-13,-21,8
caTgYBRONWVQCfLXSePUMGAIKbFHDdZEJ,KAAAHAAAZACBEADE.aAFA..TAEABBFARCAAOAGD..VCGBhAAAQCAALDEBeCHHhAAAMECBAAIBFDEAdGGA.JECBhACA.....gEEGNIAB.fFHAhAGA..hCAA...,2,-23,-6,17
cRMTdfSCGFQIYZXAHKBeWJVULNgaPObDE,HAAAeAAA.VAEALAEA.aAHDOAHDEBCF.RCAAdDEACCEA.GDGAhAAAQDFAZEAAAACABGDAhAEAUECAPFABDECAMIEAhAHATGGA.FHEC.......hCAA......hCDA...,2,-3,-3,0
dCOLDJIeWMcNAZBfPTFYUgHXQRGaEbVSK,ZAAABAAA..TAEAFACAUAFAHAGBRCBA.ECAA...SCDHhABAdBHALDFBDACAeDFBhAGAMEEB.AAIBfDHAhCAA.gGDAQFBAaGHBKFHB.OHEChAAA....hAIA...,1,7,-34,41
afZIGKQXJNORdgbBVPCSUeLDAEcTWYHFM,EAAATAAAHACA.aAEAZACB.GAEAKAHBQCCBXAGAOCABhAAARCEFdCGABEHA.CFGDeHAAhAAAAAGA..cDFDhACAFGHDMIDAfEBA.IEDA.hAHAgFGA.hCAAPHCA.,1,5,-3,8
UZfRPLTaFMNeHWEKCDAXGBIbdJgQcSOVY,GAAABAAAdACAQADAOAEA.UAGARBDFLBHBaCDC.FCBHeDADhAAA.HDECECFADEFBhAAAADHAbFBD...gFFAhACASEGD.ZFBA.fGHAhAIAMEIB...WHDACHHD.hADA...,1,3,-21,24
dDUceZOYGWSIELVfQgCMKRJAXHPaTFBNb,HAAAaAAABADAdADADAFA.eAHFZAEBGAGA.SBBDhADAEBFBLDDBQDCDhAIAMCABRFEFACCBTFEAFDHD.bGBChBAAcGBAOHFCIGHA...fDFEhAAAKDFB..hACA...,2,-16,1,17
TSEgLZIVdGPaFXROQeMcbBAJWYNCDfHUK,JAAA..NAAA.DADAHAFA.KBBAEAFAZBDFdBHAGCGA..aBCERDAFeDDDhABA..bCDAAAHACCFDhACA.UGGB.SFFFhADALEEAIFCA.FFHD.OHCAhAIAMICA....hBAA...,2,-38,1,39
baQUHLNfICPOEZMdWVXGeDFYTcRSBAKgJ,KAAAJAAA.QACCHADBLAFA..fAEBCCCDECFA.dAGAhAAAXDACeBHHFCDDTDGAhADARDFBACFB..aEHDIEEAhAGAOFFHMIAAVGFADHAA....hAHA......hBAA...,1,-9,-16,7
cIRVQWDSgPBLTMANdHUGJEFeOXYCaZKbf,HAAAGAAAEADEeADAOAFACAGAZBFE..KBFA....bCDDfCAEhAAARDGBQEABSBHHhACABDCBMFGBACCAdDDAhCEAFGDAaDGCIHHADFFAgFGA..hDCA......hDFA...,2,-18,0,18
OIVBGNJRfSXYLaFTZgdUMcKECbePHQWDA,OAAABAAAGACARADA.SAEALAGBaBBCZAGBdCAA.MBIBhAAAECEAeCHHHCEBQEGDhACAAAIBVEAA.fFAAhAEAFEEATGGAgGCA.KGHD.hAEA......hBAA...,2,-16,6,22
SEXGFacAVJdWHMCPQTUgLOBYfIZeNRKbD,dAAAHAAAMADAQADCUBDA.LAFBBAGA.fAHAhAAAeAHHRCBBDCGBECAB.GDDAhACAaDHD.ACCBVDGB.CFCDgGGAhAHAOEEBZGFAbFCD.....hCFA......hCIA...,2,-20,11,31
bVAEcBNTgZMQHePSIfUGRaWXCDOFLKYJd,EAAABAAA...TACAZACBHAEA.eAHHSAEBIDEAGAGAhAAARDFF.aCAACCBCFECBhAAALDDAKEHBdGAAAAGBgECGhACAMIDA.QFFAfGCAWDHHhAIADGHB.....hAGA...,1,-9,-12,3
UIbATWDJVQPFEBYOXgLeZCfRSMHGaKcNd,TAAADAAAQACA.FAEEEACE.OAEALAHBeAHFZCCARBDAHDDChAAAaBFE.KCCDdEEDbEGDhCAAABBBJEHBBGDA..XGDAhBAACGFCMCIB.........hDAA......hDBA...,1,-3,-21,18
VeTNLSbFPKZWUMcDEIYQHABJGOgadfCRX,GAAAaAAA.dADARACFeAEELAFA.FCEDZBFAMCGBECEB..QDGChAHAHDBBAAABOCHBhACACEEDTGEASEHHhAGA.KFFDcGGADHAABHHA.....hAIA......hBAA...,1,-5,-21,16
CFVUNETSGRKIWDHPAaYQOJefXZMgcbLdB,aAAAQAAA.eACAZACBMAFA..bAFAdBEAFCDAUBGAECGBGDAAhAAARECAKBBDDEGAHEEAhADAAECA.ODDB.XGEAhAGALFGBCHADNDIASGCAIHCA..hBAA......hCAA...,2,-30,23,53
IWJPLeKAEVCXFGQOHbgcZdMaRUNDYBSfT,EAAAXAAAGACAHADA....bAEAZAGBdCFARCEBDBIBBCBDTDAAhAAAJCHBLEABAAFA.hABAFEDDQDCChADAOFFBMIAAaEGDUGCA.SFHHfGHAhAAA......hAEA...,2,-13,3,16
LSWbdfDaNOXKBAQERFPJZMVHGcCYTIegU,RAAAFAAAZADBHACBGAFACAEA....TAGAeAHBLCCD.hAEAbDADdCFA.aCHDXDEDhAAAADEAEEEBMFHB.VGAAhAGAIEHASGFHDDABKGGABHDAPHDChABA......hADA...,2,-6,-6,0
VLFQHYRaBIKWgTGXMcOCASJDbEUefZPdN,DAAAEAAAUADAeABAZAEB..dAGALAHBHCBARDEABCHAKBGD..TDCAhBAAGFBB.MEIBhAAACBDAACCB.SGFAhAIA..bEFANIBB.QGEA.aGHH.hBCAIHBA..hBHA...,2,-28,-6,22
CEXWbDOQFUMZPHcBRLSGgYTIVAefdNJaK,eAAAdAAAaADAEADA....XAFDDAGAQBEAMAIB.HBGDhAAARBDBGCBATCCAAAHBJDFBhACACEEAODHDZEGBBHDALGEAhABA..........hBIA......hCAA...,1,-13,-17,4
RTBKbdGaCHISMQEfcPFONVYDJLeZAUXWg,XAAARAAAKADCGAFAHADA..MAIBEAGE....fCDEhAAAFCCAODEDVCFADDHBeEHHhAAAADAAgDAABFBAaGFDhABASEFD.QFCAPHAA.hAHAYFHB..hABA...,1,-11,-15,4
FUZEbeXHgBMSNIOWfLVGRdKCDaTYQcAJP,FAAAEAAA.eACHHACABAEAMAEA...SAGAOAFDLAHBhAEARCCAdCFADCHBaCEHQFFAhAAAABHBUEGAZFDB...hCAAXGFCNCIAWEED........hBAA......hCAA...,2,-25,-4,21
cOALHeBWCVZfJSKDbPdTFGUQNYIRMXagE,HAAAeAAACADAZADB.SAFADAFA.dCADGBDBQCFA.hAAA.IDDAREEBaBHDEEHFhAAAAAIBLDGBBFCAfGAAhACAbFEBFGBANCIA...MCCB...hADA......hAGA...,1,-8,-20,12
RXbNceTgEKHYMLPWdZIVDOGBUSQCFfJAa,RAAAXAAA..bADBeADA..EAFAHAGBMAIBLCDBhAAA.dDAAZCCFDCFBGCEAhAAASDGAQDGChABAfFFAABHBaFHDTGCAKGBAPHFC..hABA......hADA...,1,-3,-16,13
HfQULEYRbdXPcgNISMCOJFKVAaDGTZBWe,GAAAZAAAeACEHADAQAFCEAGERCDA.dAHAXCGB..gCCAhABASDADMDFAhCAAODCBKEEAAEGAaDHDTFGAhCBAfEFA.UGGA.YFEFhAAA.....hCCA...,1,14,-20,34
dSWgIAKFXJMGDPQaRcLNVBHYZeOCTEfUb,XAAAGAAAQADARADA.LAGBBAGBHCDCeCDBTDAAhAAAEDFBbEGDdCGA.SDHHhABAgFBAAADAFEEHhAIAMAIBaGFDcGCD.NDAA......hBIA......hCAA...,2,-17,17,34
MbTANLIZGFKQVfSecJHaYWUXPEDdBCgRO,LAAAGAAAQADASADHeAFAHAFAaBGEUCAA.ECFBdDCAhAAACCHA.RDGBbEDD.ADABZFFFhACAKDDAfEGAhABAJGAE.XFAABHHB.MEIB.IHAAhACA.FHCE.YFFFhAFADIDA,2,-14,2,16
AJHDSUeLfBWKOTdFGVECNRPaMbIcQgZXY,HAAASAAAeACELAFBBADAKAFAdAHAGCCA.EAHBRCCAaCFDbCGD.hAAA...QFEChAIAZDAFAAAADDHBUFCAOFCHhCAAFFFBCGHAMIDA..IGHA..hADA......hAFA...,1,20,-30,50
XSfeKLHdOQCIYUcJGWbTRBgFVPEDAZNMa,ZAAAaAAA.SACEKADAHAFB.dAFA..QCCACAHAUCCB.GDAAhADA.TDGARCFAFEFHEEHBhABAAAHAMDFBeFBAOFHDhAFA..IHAAcGFBJHBEBGHD..hAHA......hBFA...,2,-22,3,25
DQWSUXARdHJEBFePCgMGYNLKObcVafZTI,HAAAEAAAFACDeACE.CAFBGAGALAEAOCCAVCDA.ZDDA.DDIBQCGChAAAUFDA.RFAAdFFAhAFABFGAMEIBKGHB.aHFEhAGA............hAIA......hBIA...,2,-17,-11,6
NREbSUCTKGMWYALXBFPgOVecZQIadHfJD,LAAAFAAAOACDeADHZAEA.QAFA.dBHAHCDBDCAAECEFhABAbCFACAHBGDFA.MEIBhACAAAFABEGA.gFCBhBAAIFAAaFEHfFFENIAB.SFHHhCAAKHGA...hAFA...,1,-4,-21,17
BRNMODUgAZFKaSEWJHIYVCLcTfQbXeGdP,ZAAAaAAA.EADEHACB..VAGBLAEA.TCEAQCAAhABAeAHHdEEDRCDAMDIBDBBBAAFASECHhACAIEHACGCAbEFBhAFAXGGABGAAOFHH.....hBAA......hCAA...,1,0,-15,15
XWAHQBfZCbUIOgSMVFdePRcNDETaJKYLG,HAAAQAAAZADBCAFAUCABOACC..MAHBdAFARBGF.DCDB.ECEBaCFBhAAA.KDGDGEAA.hACAAAHABEEDbFFA.SDHHhAAAeHFE.cFGCNAIA...TGEAhAEA.....hADA...,2,-20,-7,13
YSQNZLBTXfRVWCEdUgKeJFPOcbaMGDHIA,QAAAZAAALADBBACA..TAFARADFCAFBdAHAKBHB.eCABFCFBODDBhAAAaCCHGDFAHEFAhBHAAAHASEEDhABA.fDHEEGHBJHDA.bFAA.DCFB.IHHAhACA...hCAA...,2,-21,8,29
cBLVWJKeYgXOFbPZRSECAdINDfGaQMTUH,dAAADAAAGABBaADA.MAEAHAFB.LAHBJAHB.eBDB.XCAAhACAbBFDZCCEEECAADDBfDFEhBAA.TFGAhBCABEHAKFFAOEBBFGHD.SFFDhBEA.CEHB.....hBHA...,1,-3,-24,21
afMGCZUNKbISBVWQYLOAcHTPXFJgEReDd,HAAATAAAFADA.EAGARACFdAEA..aBGEGAGAZCAAKCEASCADhAAA.BDEAQDGAhAAALEDAACCAXECAhACAeDHHMGAACFFAbGAAIHHA.VGDA.hAGA......hCEA...,2,-13,3,16
adTYfVNUGADPOEQSWIBKcLgJMFZCXHReb,OAAAEAAA..QACASADABAEALAGBMAGBZBGBHCCAhAEARDDBeDHHdECDTEGAhAIA.fFEAhBAAUGGBAAHADCCBIGBAKFCB.gGGA.hAAACBBDaBEE.NIBB...hBIA...,1,-8,-15,7
SRFcBdbHIaJLZMANQWeTVUKgGfOYCDXEP,QAAAeAAAUAEAGBCAOACC..DAEAEAGARAGBBCDAHCFCaEBBZCEBAAIBhAAA....TEEAhAAAKDCD..fDGEhCAAXGEA.FFGH........hCDA......hDAA...,2,-28,-9,19
YDXJLORPgAebMScHaNVITKGBQECUZWdfF,eAAAMAAAHACC.aAFAIAEA.GAFAEBBBZBFEdBHAFDCDXBCDhAAALDGBRDEBAAHAbEDDhAIASECB.hBAANEHA.KGBB.CFFCfGHADEIB...hABA......hCAA...,2,-20,-1,19
cabeINLOdgBYFDZRSUEKTVCGAPfJXWHMQ,JAAAHAAA.MACAQADCaAEE..eAGHLAFBdCCABCHADAHBRDDBhAIAEDFBKCCDCEDA.ABIB.XEGDhAAA..bDFAOFCBhAIAFFCBZFGFSFFD....hBIA......hCAA...,2,-20,-13,7
PYFHVSAfcGXOBINCdEegMaKbLQWTUDJRZ,GAAABAAACACA.EADA.eAFAaADD.LCDA.QDGAhAAATAFADAIBRECAZGAAFCAAHCEAhAAAABIBXFEAODDBIHHAhACAdEGAMDIB.bFAB.....JHCA.hADA......hAGA...,1,1,-15,16
RgVALQKEFCUTdSNBJIYMDZHWGXOcePfab,LAAAEAAAFACD.TAEAdAEABAGA..IAHAMAIBHCECGCAAhABAODDBeCCBaEBBRCFAACABhACA.QEEChAEACEFD.SEHBYEGBZGAAXGAA.hAAAfGGA.hAGA...,1,7,-21,28
OfgAUaGZXMVNJTHLIYKEdcRSDebCFPBWQ,GAAAZAAAMACAJADAHAECLAGBKBHB.dCDARCCADDGB..eCFDFDHHBEEAhABAQFFB.hAHAfGCAAFCAaGGA.hAIAXDBD.NAIAIHEA..hAAA......hACA...,1,-16,-30,14
AGYdCUQOWLBRXINJKSFPcTafgbDMZVeHE,dAAAQAAALADARACA...XAGDJAFAFCDD...TCBAhACAaCFA...bCFCZDABHEAAhAEAACIBGDFACEDBOEGBhAFABEHBKFHBSFDBfHEBMIAA.EHGAhAAA......hADA...,1,5,-17,22
aDWCXRNcMAQdGJZVFKSgYUBEfHPLOTeIb,GAAAZAAAKADC.SADAUAGABBEAHAFB.LAHBeCAB.aCDBhAAACCCD.REAAMEEAADEA.dFFAhACAFDFDEEHF.OFDDhADATFGADGIB..XGBA...NEEA.hABA......hACA...,1,16,-43,59
HRBOPaICUZWAfDMQVbFESNeXgKYGcdLJT,MAAAQAAAFADD.EACAeAFA..KAEAGBBAdAGALCDBhAAAHCGBRDEBOEDBaBHDCCFDZEGBAAFADBIBhBAASFEA.hBBANIAB.XGDD.gGGA.hAIA......hCAA...,1,-2,-18,16
GaRLTIKYSPeHZFWAbgBMDJUfCdXNQEVcO,BAAAMAAADAEAUACA.dAFAQAGA.EBBAOAHB.RDDALEBBhAAATBDAKCFASCBGhAIAHEEAZFBAADDBJDHBhBCAXGGA.NIBB.GGDB...hBAA......hBBA...,2,-23,-15,8
OdXQCDJPFSYBZIKEAgWHTRbfaMeGLNUVc,HAAARAAA.aACAeADEGAEALAGBUBGAOCCBdCCAQEDAhAAA.DAIBFEDBBBEDZEGBEFFFhAAAADIBTGCAbGACMFIBhAGAVGFA...........hAHA......hAIA...,1,2,-13,15
CPWXIFBHQYLbSZRMNcAKVfOEJDaGdTUge,KAAAOAAAEACE.DAEAdAEA..UBBBeAGB.CAHB...XAFAhAIABCCAHCFBLCEBZEDFRFFAMCIBhAAAABIBVDGB.aEBA.hCAAGGCB.........hCBA......hCCA...,2,-21,-20,1
VOTFbKMEBegQPYSdRCGaDZNXWAfcULIJH,UAAALAAAHADATAEAKAGCBBHA..eAGHQCDBSBHHhABARCFFGDAAZCAAXDFChACAADAB.IEAAhAEAODHDMFFBEECBgEGAdGGA.aCCA.hADADEEB.fGAAhAGA..,2,-14,7,21
BTDUPLCbFWESXNRgKcaQVfGJeZYOIdHAM,MAAATAAADAEA.LAHBFACA..EAFASBBARBFAKCCA.aBDDhBAAQDED.hBBAGECAeBFBZEEAOEHBhAAAHGBAAAIBBFAACBGBXGGANIEB....hBCA......hCAA...,2,-19,-10,9
MBHNbUCAIXZaVLWYJcQKFTSfedOGgRPDE,ZAAAaAAALADAJADA.KAHBSAGB.dCAAGCCA.hABARCFAEBBBHCCCUEFBAAIBXCFDhACAVEAB...hAEAcEGDQGGBTFCAeHAAOFFHDIEA.hAFABCHA.CHHA...hCCA...,2,-23,7,30
PWcRDTfYNEaMOCBQGLdKHSZeFAbgIJUXV,..IAAAXAAA...VADA..cACARAGFDCDBTDAAhAAA..fAEBhAGAEDFBaCHD.MAHBBEDAhABAGCBAdFFDHGAAeCHHAFIBgGDBhADAPDDAYEFBCHHA.QGCAhAIA,2,-12,-9,3
TgEKCYIbBPDafUVJdNXOcMARGHZWSFQLe,HAAAZAAAFADAeACE.EAFECAGA.....bBFADAIBUCCAdCAAOCCBhABAAAHARDFAGFDB.SGHHhAAATCGA..KDEAhACABHFA..aECD.VFFA...XGAChAGA.MIEAhCEA...,1,2,-32,34
ZdeGfONacXISLgPHWEMKYAJFCUTVRBDQb,CAAATAAARACA..QAFCdACAeAEAGBGA.OCDDaAHDXCAAhAAALCFDHDDAhACAEEAAMEIBADFAFDHBBFFAhADAZFAEfGEAIGHASHAAgGGD.hAAA......hAEA...,2,-15,0,15
ZSHRGJcXIMfQFYKOEDVbWLBTAPgNdUaeC,...PAAAdAAAeADAZADBHAFARAGBGCABJCFF...XCFDhACAMCCBQFFBKEAAEEEBDDIBhADA...VFCBLEHBhAHAAAIBUGGAaHCACHFC........hAIA......hBAA...,1,0,-16,16
aNGKceDTBLQOXHYMZCfAFUgbPIVdJEWRS,FAAAUAAA....bACDIADA.dAFAEAEARBGF.aAGDGCBBhAHAeBHHBCEBLECAQEAAhAEAHFGBZFBAADGBgEEBhAIA.PEHD...WGBAhBAASGEH.hBGA...,2,-22,-11,11
AdIUgQFVBHXaLGNJMfOcWRZSbEPCYTeDK,dAAAUAAAQADABADAHAEBLAGBGBGAMCDBOCAE.RDCAZEFBhACAEDAA.CBFB.eEDH.AAGAFFFBhADAaDHDJFDB..fGBAhAIASHGAYEHBDAIB...hADA......hBAA...,2,-13,-6,7
JGPDYRaOUCTAcMfHKQVBNFWELSXIdbeZg,MAAAHAAAQADCBADAFAFA.EAFELBBBXBGAdCFAZCAAGDCAhAIADCFBRDFF.OBHDCEDAAAHAKEHBhAAA..VEGBSGHDhACAeFBB.PHDAaFFH......hCCA......hDEA...,2,-11,1,12
ISTPQaDYHECKgOFNfAMUbdeJcRGXBWZLV,MAAAdAAAeADARACA.GAGABAFBZAGBLCCA.SDABhACATCDAaBBHHDFB.EECAKDHBhBAAFFEHABIBUFCA.JEGFhCAAXGBA.IGHADFFB...hCCA......hCFA...,2,-25,2,27
IDLGTCZFNEKBgVQAdSceOJHYMRXfWbaUP,dAAAeAAAHADARADA.XAGB..bAGBaBHDUCDB..DCCBGDFAhAAAZCFFEDABBDHAQDDAhACAABIBOEABMEIBhADAfFHAIGGATGCAFFAHKHEASEEDhABA....hAEA...,1,4,-18,22
BGaQKZWPTOELIDJYMdcgfRFUHCXNSbVAe,eAAAaAAAZACB..TADAEAEA.LAFBDAHB.MAHBdCEA..fCGEhAIARCCBHEFAXFCAhAAASDHHAAIBBDHAhABAGEFAKGHB.OBBB.IGBA.hCAAYEDF..hBAA...,1,-3,-28,25
VHOJRZeScIFBQGYMgTAEWDaNPfbLdXKUC,EAAAaAAA.....fACAdADAKAFACAHBHCDCRADFZAFB...eBBBhAFASAHHFCGAGEEBhBAAMDDBADBBDGHBbEEALFABhAAA.XGEA.OFCHIHEAhBDABHHA....hAFA...,1,-9,-20,11
BgaKVNMfdFIUcLETSDZebAOGJHQCYXPWR,GAAAHAAAQADCCADA.XAFBRAEFaAGAKBGAMAIB.dCADFCDHhAAAIDDALDGBECFBhAAATGEAZEFAABHBOHDAhACA..YDAFBGGB.NDIA....hDHA......hEAA...,2,-17,0,17
TeLAYGVIOcfXUJKZgNWDCQFBdPREbSHMa,GAAAOAAA...XADAKADAZAFB...NAGA.CAHAQCCAhAFABAHARCDB.ECHBHDGBaEDELEGBhBAAAAABIHAA.hBBAfDCEgFCGFEAHdGFCSCHBhACA.eFFB..hADA...,2,-13,-10,3
UFBAXfIYVRTWGLObdaEcCQKSNPeMJDgZH,XAAA..fAAA.IADARADAGAGALAFAhAAAdCDDEDAAQEEAhAAASBCDeCAFMDIBDFHBhABAHCEABGAAAAGATECAbEAAaGDDKDHB.PEGBhACA.ZGCA...hADA...,2,-10,1,11
gMYAaXSHJGBIcOZPENbDdfFQLCeVWRKTU,aAAAHAAAGACABADBOAEDZAEA..ECEADAGAdDGAQBGAhAAALEEBeBBDRCAAKDEDTEGAhACAMAFAABIB..SGGAhBAAIGBA.NIDB.bGDA.CHHA......hCAA......hDAA...,1,-7,-10,3
AYcUMBHCeVEOGIDJSPRKTLNXZdbafQFgW,UAAAHAAAeACEEADAGAFADAFA..SAGARCBALAHBZCCAaDAHQCGAhAAA.FECAhCAAADFBMEEBCEGDOFCBIFFAhADAKFFDNIDB.dFHAfGHEgFBA..hBAA......hBCA...,2,-14,2,16
NOVGdLeWRcICfDEJFaBZKYTXUPbHAMgSQ,MAAAQAAA.OACCdAEAeAGB.RBBBCAHBEAFE.aAHDZDEATCDAhAAAUEBBHFDB.ABDA.hBAASCFB.hBBAGDGALFFAIEAADCIBBHHAXFEChAEA.PDCB.hCAANIDBWHAC.,2,-8,1,9
RZfXAFNJYLgGHCVUIOEPdMWDKcSBeaQTb,FAAAJAAALADBHACBCAEA..UAGAEAFAdBHADCFB...KCFBBDGAeCCDhAFAQEAA.hAIAREDBZFFBAEEAgEFAhBAA.IGHAMDIBSGBAaFCC.hCAA.fHCBhCBA...,1,-22,-28,6
TBaDHXKRYIGUJcObCNEgFdQWAfPZVMLSe,ZAAAMAAAeACEBADAHAFBRAEF.GCDAUAGA.OAHF..bBBDEDGFhABA.dFAAABBB...fEHAhAFALDDBaDFDhBAAKCCDIHHACDHAFFGD.PFFBSHDAhBIADFDB......hCAA...,1,11,-30,41
EHUWVdAGLYKXaQfRSgPMDOBcTFJbeIZCN,GAAALAAAKADAaADDRAFF....SAHBMAFABBFAFCDBeBGHhABAZDFAEEEBHCAA.VEDAhACAAAABQFAA.hBFAfFHEDBIBTGGAIHDACEHA..hACA......hADA...,2,-19,-10,9
PYTOZISJGFAgDfeXKNUEbcMVHWCBLQRda,DAAAeAAAKACAEADA..MAEAHAFA.BCCARBDA.aCEB..TCGAhAIAZCFESEFAGDEAABBB.hBAAXFGAUGBA.bGEChAAA..cCCCCHAA.dGGA.OEHFIHCAhABA.....hBGA...,2,-21,-1,20
NBSRFUPYOLZKbWECgeaITQdGcXMHJAVfD,DAAASAAARABA.FADAUAEA.OAGFZAFBKAHB.EBCFeCDB.hAAA.aCEBTDFAGCGAhABAMAIBHFEB.ADDB.fEHAhBAABHHA.PFDB...YFFFhCAA...hCAA...,2,-20,-20,0
WGLQDUMFYfgRebJXCKATNBSVIOcEdHZPa,TAAASAAA.OACDEACEHAEB.aAGAGAEALBGBQAGAhAAAMCCBFDDBfDGAhABAREABeDHHXFEAhAAAAAEBBEDAIFHAcGDC.ZGAADGIBgGDBhAGA.CFFD...hBIA...,1,20,-17,37
cNVEGRBSfLHJMOCAYaQPKIeTWXDbUgFZd,aAAAQAAA.KACAeACH.TAEADAEAUBFAZAGBdDDA.VEABhAEARCDBSAHBhAAAHEGBMBIBADCB...IGEAhAGAbEGBFFCB.EGCFfFFA.OHCChCAA.....hBAA...,1,-4,-18,14
bICBfQZDeGKMdFTLUJaAYNgcXPHRVSOWE,...NAAA.XAAAHAFARBBA.OADA.EAGAbCEABBDAZDDAeDAHhABAGCDBdFCALCHBhAAA.aDBBAAHAgFFAhACAVFFBSGCACHHADCIB.MIBA....hABA......hBDA...,2,-11,0,11
UIFTHGELBAWCfbVNPRMOcaXZYeQdSgDJK,CAAAVAAARACA...MADAaAFA..ZBFE..eAFAdCAADCCBKBDAFBHDHDDAhAAAECFFLDGB.hAAAADIB.bDDD..OFFHhACAXFFBQGBASEHB...hADA......hAIA...,1,-18,-19,1
HUAIfLXRNPGMbEDQOSadKCZJWFTYgeBcV,LAAARAAAGADAEAFAQAEA.aAGEdBHAZCAAFCCH..TCGAhABAeCFFBDAAHEAAACCAXEFDhAAAMCEBOEGBhACACEHAJFAA.gFDA......hAEA......hAHA...,1,-3,-20,17
BJEISLNYTFdbRGaeKQXcWgDAfOZVUCHPM,ZAAACAAAHACAMACABAFB..EAFALAHB.TCAAbBDDRBFAeDGFhABAQCEA.XEAAhAAAgFDAABHBODDBhACAPFHBSEFANCCA.dGGA.aGDDhAEA......hCAA...,1,-7,-8,1
WBIbMPYDQFXNOHdKJUZASgETfRCeaGLcV,EAAARAAAeADEGACALAGB..VAEABBDAMAIBDAIBQCEAhAAAFCBHOCGDHEDAdEHAKCCDhABAZGDAAEEB.SEADhAAA.fGGBaFFBIHHAPHAC.hCAA......hDAA...,1,14,-24,38
CIWafVZMAHGcBQJLUOKFbYgDdRTeXNESP,HAAAGAAAQADCLADAKAHBFAFA..bBFADCDA.RCEAeDDB.hAAAEDHFCCADaCCCZEAAAAABBDEAhACAUFGBODFD.dEHAhAIAXGEDSHDAIHAA.fHCFhACA...hDHA...,2,-11,-2,9
dfBXRaFGPgDJHAYcVKbMTUCSeEOZNQILW,VAAAMAAAUAEA..eADEEAGA.ZAGBQBBALCDBdCFCBBHAhBAAREBBGEGADDEAHDFCABIBKGABhAAATEBA.OEEBhBBA..WFFDaFGC.......hBEA......hCAA...,1,-9,-16,7
EDTCGKVfgZRBLSHOWNAQUebPIJXcFdaYM,eAAA..bAAAIAEAJAEA..FBEHaAFDEBHF..CAHAGBCAhAAAKCAA..VDFBZCFEREEAhABALGCAOECHAEHAPDDBhAAAdGGAMFIBDDIBfGHASHAG.NIAB.hABA......hACA...,1,-3,-19,16
ZANWeYFVPKUJSBETIRdDCGHLcOQabXMfg,eAAAFAAAKADAUAEABAFB..EAGARAGF...dBDCGCCAHCFCLEEBhAAAQDAAaCCHMCIBhADAfEGE.ABIB.hABANEFA....YEGB....hAIA......hBAA...,1,-12,-36,24
HUNOCEQXIVcZBFMdLATYKWSabGRDfeJgP,TAAAKAAA..aACARACFDAEA..eAEHJAGB.HAGB.OBCDhAAAEBEFQDEDXDFCIFGAhAGAZDGBMCABAAIBSEEDhAIA.GGBBfGHA.hBGA......hBIA...,2,-23,-16,7
CaPQdeDHYOEcWMLUVFZSgfAJINXbTKBRG,JAAAXAAA.KADARADFGAFA.CAHA.aAFA.dBGDHDAA.ECHFhADAMCDBLEEBFCEBZDABhAAASEGAADAB.hABAbFAATDGA.QFEAeHAEDGGA.cGDChADA.UGGA.hAFA...,2,-10,-7,3
bDEVUINGHWfPXTQSOBAJgeMcaRdZYLFCK,eAAAaAAAZACBLAEA.KBCAEAEAUCFAGAGAHDDB..fCEAhAIATFAA.QECChBAABCHAAAAAMEIBRFEAFGBHhBBAbFGDDDIB.IHHANIAB.....hAFA......hAGA...,2,-13,-3,10
OEDBcaIXLbRPVGeMTSHAYgCKdFNJQfWUZ,CAAAdAAAFACAQADA.UAGAEAFABAHA..aCAELCBAhAAARDCAGDGAeCEHMFBBHCGBhAFAADGBKFDAfFFAhBCA...........hACA......hADA...,2,-29,-23,6
IDeaMKbCAcFSXZWLQYVRgNEfdGTOJUPBH,SAAAZAAALADBQADARAFA.EAFAGCAA.TCGAhABAOAHDUEEAHCCAeEHFhACAaCFDbDADAAFAFFCBXDGDhAAA...YEEFNIAB.dGGA.hAIABHBADGIB....hABA...,2,-4,-3,1
PJVYaQUBgWGeEARbOZDcCFMHKIfSTXdLN,RAAAZAAACADB.HAEA.KBHBSAEHdCAALDDA..JAGBaDGDQCCChAAABCEDGEABAAIBDCIBhABAMEIB..TEEAhAGAXFFC.PHAAUGEBeDHD..hCAA......hDAA...,2,-27,-4,23
OgRBFEUfcXQaKHTPCWLVISZdbDJGMYNeA,RAAAEAAAUADA..XACAQAFAHAFA.TCCACAHALDDAhAAASCEHdDHADCCBGCGAhAAAMFDA.eDAB.AAHABFFAhADAfGGAaFAHKGDA......hAFA......hCAA...,2,-27,-1,26
McDVUHgQGZdJETXFbCPSLeAfYBWKRIaON,BAAARAAAOADAMACA.DAGAHAGB.GBDAdBCAEBEATDFA.FDCHhAAACBGALDEAAAIB.hABA.fEHAhBGAKEBAaDHD.cFFCUGDAZFFF......hAAA......hBEA...,2,-31,-3,28
XPMORgGUCVLIcESfJZAHBWKYQNTaFbDde,HAAAKAAAQACCaACADAFA.dAEAeAHF.MBFBRAGBGCFA.CDDALFDBhAAAECCASCGDhAAAZFGBAAIBBGAANCIAFEDBbFFBhBGAOFFH..........hAGA......hCAA...,1,-4,-14,10
GgFdTbLHUQDKZSOCAcYeIWPVENfRXBJaM,eAAA..IAAAVADA.EACARAGFBCCAaAEDGAGAdDEALEGBhAAAHCAAQDEAhACAZGAACGDBACIB.cEBB.PEHDhAGANEIA.JGBE.MIAA.TGEADGFB.hABA......hAGA...,2,-22,19,41
CKgYBVQabPGXRSNFIMdUAcZEfLDTJHWeO,EAAALAAADADA.HADBeAEAKAFABAHAQCAA.aAHDGBCAhAAARCFBFDDH.dCBCADHAZFAATCFAhBCAOEHDCCHB.VFEBhABAbEEA...SHAAMEIBfFCEhCAA......hCEA...,2,-24,13,37
QUbeDZcGTOHPKRJgVMLfXEYANBISadCWF,BAAAaAAA.dACAFADAQAEAUAGA.DAHBGBBB.HDEARCDBJCBFhAAAMDIB.LFGBhBAAECHFAAIB.SEDDhBBA.bGBCeDFH.ZGBA.TGGA.hBGAKEAD.....hBIA...,2,-19,-9,10
APZWBEeGRYSaJTcfKHQgOdFCNIUVMDXbL,ZAAAEAAARACAaACA....TAGAKAFAHCCCQCCBdAHACCFB.UCGBhAAAMDHBDCFBLEFBhABA.ADIBBFAAeDABGEGAhADA.SEED.fGAEhAFA....hAGA...,2,-29,-10,19
HCVSbgTGFcQUPYfeJMKRXZLAdDEOIBaNW,EAAABAAA.aACAHACA.SAEE.TBGAGAEAQCCBhAAAPAHBeBCBMCFBhAHARDBBZEEAAAIBdDGDODHFhAAAIFGACGAAVGDAFGHDYEEF...hAGA......hAIA...,1,6,-13,19
DeSdKXVUCaRLOITPBMYQgFZGbfcEWHJAN,eAAAdAAAKADAUAEARAFF.LAHB.OBCDTCBA.BAHBMDFBhAAAQDECZEBAGGBBhABA...fGGAhBEAECHBHECBADABDEIBXFABCBGB.aEHH.IGFAhACA...hCAA...,1,-12,-17,5
RZFQDXgIOAcWTBKLeYMJGCUNEHPSdabfV,TAAALAAA.eADHMACAGAFA.CAHAUCAAHAECdAHA.bCCAhAAARDEBZDGBQDGAhBDADEDB.XECAOFABAEIBhABABFFAKGHB.NIEBSGDGaFBD...hACA......hAFA...,1,4,-10,14
gcXWDPTZAHdECBNVaJRLMKQfUIYObSFeG,HAAAEAAABACAaACARAEFLAEA..MAHBQCCAUDCAOCGHhAAAFBHDeCFBGEEAXEDAhAAADAIBZGAAAAFAdEHACEHA.hAGAVGCAfGHA..IHHAhAIA......hCAA...,1,0,-14,14
AMcgYbfOTeXKWRDNaQPdBHSIFJZVLCGUE,MAAA..gAAA..bABATADAeAFAKBHBRAFFaAHDdCCAhAFAHCCAFCFBZEDELDABhAAAGEGAADHAfEEAhABAOGACDIEA.QFGA.SGEHhADA.IHAAhAFA..,2,-19,15,34
OKeLEcBYbNHMaJCAGdgfFZIWQRSVTUPXD,dAAAFAAAZACBQADARAEA..SAHBTAFAUDAADCEBKCFAEBHFBCCBhACA...bDEBhADAHEFA.aFAAAAHAGEGAhBAAfFEE.IGHAWEED.PHCChAFA.....hBCA...,1,-12,-22,10
QaHKCVedbEGRWTfFLXDZUPBONMScYAJIg,JAAAQAAAHADBKAFAeACA.dAGAEBHFRBEB....TDAALDAAhADAZDCBBCHAMCGBSDHHhAFAAAIBaEEC.bEEDhAHAGEGAFFDBDGGA........hAIA......hBAA...,2,-16,-7,9
DQSZEWeOdgJKCbPXTFUBIfaHGRMLcVANY,DAAAZAAAEADEeABA.dAFAKAFC..CAHA...bBEA..TCCABCAAaCCChABAHCFC.REBBMEEBhAHALDFAABEA.QFFAhACAOFFA.gGDBXGEDFGHD..hBAA......hCAA...,2,-16,-14,2
eLZYUFTVQNMERJAGWbdBgOfDcSKXICHPa,GAAAdAAAOADADADAKAFA..CAGAHBDAeAHHZCDAFBHD..QCBDhACAEDHFAAABBEBA..fDFAhAIAXECDaEEChACALEHB.TFDAMFIBJHAAgGFFhBAASGGB...hBCA...,2,-15,-15,0
UXGcdDgLEQFIbWOfBTZAMSKPeVRCHJNaY,MAAAKAAAeACERACA.HAFB..aAFAUCCAGBEBdBHALDBDhAAAEBBBQDDAFDFH.bDFAfEHAhAFA.BGGDhAHAAAIBSFGBCHEA.YHDADGIB.hAIA......hBDA...,1,-7,-15,8
MeQWTRfadLENCZVAgcIKGbPJFXUDOSHBY,..IAAAbAAA.FACADAAA.HAEABAFAeAHHQBGARCCAdDGDEEAAhAEAZBCAAAGA.KDDAGEEAhCAAXDFDSGCBhCBA..MEIBfGHAaFAALHAA.hCCACGGA......hCGA...,2,-19,2,21
VYgHGIUceFOSEJKRfWMTLDPNABbXaZdQC,XAAAdAAAQADA.CAFA.VADAHAGBGAGAUDAAFDCEECDBRDAAMDFBhACALDFB.DDIBhAAAAAIBaDGCZGAA..IGHAhABAeFHBSGFHKHFAWFEF.....hADA......hAGA...,1,-3,-9,6
TefVgPEBJFGaHOZAMKQNSdXYUILDWRcCb,MAAAQAAAdAEAUAGALADA.RAGFCCDAeBBA...fDDAhBAAgDCGEDGAFCFHhAAAHFDAAAEAKDHB.XFFAhAIADEIB..cGBA.....hBCA......hCAA...,1,-21,-24,3
HEAWCYRPZJafKQLbceMDBXOgFNUdGIVST,CAAARAAAZADB..aACAQAFALAFAeBCBMAIB.BCEA.OCFDhAAAFCFHdCCC.GDAAhAAASCHBHDGBADABPDBBhAGAKEEDDGGB..XEGD...NEEAIHAAhAHAEHBA.YFFFhBDA,2,-18,-12,6
fRAWUcKVIaFCDdBeETLOYbNXZJgSMPHGQ,UAAAKAAA..aACADADAdAFAEAFALAHB..OAHD..hBAAbBCDZBDA.SDDAhBCAHDFAGFBBRDGBADDAVEBBhBEACFHAeHBG..TGFAXGGC...hBHA......hDAA...,2,-22,-8,14
NXWEfbPegAOQTLIJcdHBKVGYMDZFaUSRC,TAAALAAA.JAEAHACBBAHBGAEB.MCABZBEAaCAARCEBXCGAhAAA..EDCAbEADhACAeCHHAEEB.QEEAhABAdFGAKHCADFIBSFDDCHEB.fFHAhACA....hCDA...,1,12,-28,40
gXGFUYdPbMTEafCKDHZVNRQSOJILeBWcA,GAAAFAAAdADA.MADAEAFA.CAGA.HBFCZBFARCDBQDBA.ODEBhAFALDFBBDGDAAABXDBDhACAUFFA.bEGDaEHDhAIA.DIBA..SHDA...hBAA......hBDA...,1,-15,-17,2
BFaVDSTEGgCPeUJbIAfdQRKOZYWHMcLNX,dAAARAAAZADBHADALAGBBAGBaAHDDAIB...ECBAGCEA.CBFBUDAAhAAAbCED..ACGBQDGAhACAODHD.MDABhADAXGFASDDF.TGGA.eFAHhAFA.....hABA...,1,4,-28,32
bPdMHAKcQXWCSBDNFZGIUgTReVOLJYEfa,QAAACAAADACA.ZACBGADBUAFARDEAeAHHLDHB.EEBAbCBAhAAA..dBECHCFBAAIBKGFAhAAAXFDABHBA.FEHDhAGA.gGGG.OHAA..hAHA......hBCA...,2,-18,-13,5
AWDdbgNHSIMVfCUEOLKeXTRPaQBYcJFZG,dAAA..bAAAHADAMAEACAGBEBHF.LCCAeAHFRBDF.QDAChACABBFBJCABGDEAACGBDDIBSEEAhADAIEHAfGDAhAAAKFGAXFAAaCCHFHEA..gGGAhABANIAB....hACA...,1,2,-12,14
TgPYWecAFdMfEKSVRUbBLaOHNGCIJDZQX,dAAAEAAAKACARADABAGB.LCCAHAEBGBGA.CAGCDAIBZCFBTDAAhACA..gCCBhAAA.PEABhAEAeBHHAADAMEFBSEEDUGGAaGEHOEHD.hCAAIHFA..hAIA...,2,-33,3,36
gNCTUQVZMWIdAPXOYLSBRefFcEDGHKJab,OAAALAAARADA.eADHFAGA.EAFAHCCA.KBBDaAHD...bCABCCFBQDGAhAEAZCEB.hABAMEEBdDGAADEB.XFAAhACABFFADGHBGGEBNICB......hAFA......hBHA...,2,-21,-5,16
FSdMBeUPRgEKNDaAIWZXOJYHTVbfGCLQc,ZAAAOAAAHAEA.TCAAVADA..GAGALAHBQCCChAGASCEAdDFAeDHHREAAEDDBDACAhABAAAIBXFECJEGBbFED.hAGACGHAMBBBBHCA.........hCAA......hCCA...,1,1,-3,4
TRPVYeHZKWLUaMEDCJbXNcOgQFSfGdIAB,RAAAVAAAHADB.ZAFALADBMCCB.DAFACCGA...JAHB..bDAD.hAAA.XCEDODDBQEFAhAAASBFBdEHAhCAAAAHABEHATGFAeFDHKDCDaGHD....hABA......hADA...,1,-7,-21,14
RJLPEAfZMVSUFGgbeXYCNHaQDdOWIBKcT,ZAAAMAAASACEGACBeAFE..CAFAHAGBaBBCdCFAOCCBBCHAKDDBhAIARDEALFAAAEHA.hBAAfEHAFFDHXFFAhCAAQGFCDFIBWHCA......hCHA......hDAA...,1,-9,-17,8
WZdFSJOTbHVfDIgCYQLeaXAcGPNMREKUB,GAAAMAAARACA.EADABAFBdAGAFCDA..OAGDHDECDAIB.CDHBLFBAhAAAeBBBAAIB..PCFBhBAAKFFD.ZDDFSGHBhACATGFA.fHFFIEHAYECBhCAA....hCEA...,1,-11,-32,21
UcgCHEeABMdZVNXfOYSQKIJFabLWGPDTR,dAAAZAAA..XADBOADAQAGAKAFA.FBDBbBFAGCBAhACADCAARDDA.UDFA.CDHAHEDBhBAAAAHAMDHB..fFHAhBCASFFBaGGHWEHH...TGDAhABA.....hBIA...,1,-9,-21,12
YRJaOUIKQPXcGgFeTCfVENSWHZBAMdDLb,dAAALAAARADA.aADDOAGD.KCBAQAFA.XCAAhABAGCEAeCHHCAHAECFB.hACASDADHDDBACIBbDGDhAFAUGAA.IGDAgGFGTGFA.hCAA......hCBA...,2,-18,-11,7
IHEcfNOXdgUaYADbVLWZFKQePJRMCGBTS,DAAALAAAZABEKAFAeADH.RAFAGCAABAHB..SCCAhADAHCFCEDEB..fEGEhABAOCEDdCGAaFAHACCA.bFCBFEHDhAFAQGGBMFGBCGDA......IHHAhBAA...hACA...,2,-37,7,44
TGCYgIWXcaJOLKUdfFPNDVeHMSRbZEABQ,TAAAGAAACADA....IADAXAEDaAEDLAGB.hAAAdDCAFAGADAIBHBFBREDFEDHFhAAAACABQCCChACA.gEEBcFGCKGBAfDHAhCHANDAAMIFA.SFHHhCIA.BHGD.,1,-2,-5,3
STJOHFRceEdLMKZIBaXQbPUVfgGDAYCWN,CAAASAAA.OACDHACARAFF.EBHFdAEAMCABZAFBBAHA.hAAAaCGDbCCC..PDEBhAAAfDHA.GEAAhACAACIBNEBA.TECAFEHDeFGDLEEB.hABAXGFD..hAEA...,1,-6,-15,9
CJWHgQaGOSMXeLRYDcdKTZAUIVbNPFBfE,VAAA..bAAAFADAEAEA..CAGA.HAGB.aCAAGCDAMCEBeCFBhAAARCFADAIBdDCCZEAAAAIBUFFAhAAAIEHABEHB.fFEAhABA.gGBBQGAAXGGAhACA....hAEA...,2,-23,-1,22
PORCMfgIKLNUaedTJESBWbQHcAZVGXYFD,GAAAFAAAOACDRADAMAHB....fAEAKCDDLCFBaAFD.hAEAeCHH.dEADEAHBBEEChAAAQCGDHGAAAADAZFDAhACAXDEDDFIBCHGA.gFGA.IHEAhAIA.NEDA..hAGA...,1,-2,-18,16
HVPbUeGNJODTgaScMCQWZAXKdLEYBfFRI,dAAAEAAABACARADAHAGB...VCBAUAEAGDFAOAGF.DAIBaDAH.hAAA.MCCBQFCAhACAADDALDFAFFHDIGAAhADAeEBD..TFFA.SFHBhBEACHEA.XGDChCAA.KEED.,1,2,-27,29
QKLFWOYJZRXVUTedPgbaMcIBASNHDGECf,HAAAEAAA.QADCLADAOAGDZAFBRCAAXCGDTCBAeCFBhAAAdEDA....bFABaCHDhAEAMAIBBDEDAFFADFHBGECAhAFA.KFFDWFHHYHFG....hAIA......hBCA...,1,2,-10,12
CIOJAZBYRGeTWNFDELVPdUfaXSKgMcQHb,ZAAARAAAeADE..TAEAFAGALCCAdAGAUCAA..aCFDKCDAMCHBhAAAHDEC.CCHA.OEBAhABAAADABEHA....YEHBhBEANIAB.EFFBfFFE.SHGAhABA..hACA...,2,-32,-14,18
EZeVabACXJTGPNScdDYIUgMBFKLQWfORH,XAAAGAAASADAdADA.DAGAIAFAMBGBBBHALAHBhAAAQCDAOCDEHDGBhAAAEDBBeEEAbEAAAADACFFDTFGAhABA..PHBAcGCA....hBDA......hBHA...,2,-20,-3,17
UDVcRgJKFAYSIPTCNMBbfQaHLdeEXZGOW,SAAATAAA.MADABACB.QAEAHAFCeBCFEAGAGBDAhAAAOBHDDCGBRCCAKDFAACIBIEHAhABACEAA.bFCAaEEChAAAdGGAZFGB...WHCA.....hAIA......hCAA...,2,-10,-10,0
FUeaQTOHSMPdGNIXAbYcgJBCLWKVEfDZR,...bAAAgAAA.CADA.LAEAKAFA.EBHFZBFERCAAeCEBhAAAaCCAQDAAhAAAHEFBMDIBGDEBXFAAhABAAAHAcFACBGDAWHEADDDBTFGA.SFFDhABA.NIDB..hACA...,1,0,-8,8
FXDfaMVTdNWAYKBSCJHZIeEGgbLORUQPc,BAAACAAAHACAeACAGAFALAGBRCAA.QCAAFAHFDCEB.aBFBMDFBhAAA.dDHAAACASCDBhAAAZEAAEGFA.bDFA.hACAODDH.cFFA...fGCEhAIA...hAEA...,1,-12,-16,4
DEWFONUMJTXeZYgHcRfdKaGIQAVLSPBCb,LAAABAAADACAFAEDOADD.UAFAMAGB..JCAAeAHB.ZBCFhAAAHDEARDFA.dBHAGFDBhAIAAEIBSFBACGHA.hCAAEFGBNCCA...TGDA..YHCAhCBA.....hABA...,2,-25,-18,7
fMaDGRQICNLPJdFXTbWHUgKcAZeVESOBY,eAAAEAAABACAMAEAGADARBCA..QBFCCAFALAHBdBHAFCCHbDBAhAAAHCFB.KEHBADBAZEGBhABAOFAAaFEDDEGB.NIAB.hAIAXFDA.TGGA...WHBAhAAA.....hBDA...,1,-5,-7,2
gSTeIZVbdKYQfXUPBcJWGANMDROEHLaCF,MAAARAAAHADBLAEAFAFA..TCFAeAHHZBBAdCHAKCCDQDBAhAFAUFBABDAAJDEBACGBOEEBhAAAEDHFCFGD...SFGAhABAbGAA.XGFCWFHHDGAA.aGED.hADA......hAIA...,1,0,-13,13
ERDbBJQPWOHTCdcGaIYXfUVSAMLZgFNKe,ZAAAFAAAeACHRAEABAHB..QAEAOCABHCCCdAHAGDDA.hABAaDGAXCFDUEAAADDBMFGBhAEALCHB.KFAAhACAEFHBbFFCJHBA..WHDACHHD...IHHAhADA....hAEA...,2,-19,0,19
bTOZQaBMELHVARDYSgJKPfNeXcFUCWIdG,RAAASAAAKADC....fAFAeACHFAEACAHAdAHAGBDAhAAATCCAZCFB.aCHDECFFHFCAhABAAAAADDHBJFHB.PHAChAHAXECA.cFFAIHFA..QGEDhBHA.MDIBhCAA..,2,-14,-7,7
PdcBTSYabFLDWCfOKEgZAUIMVRNHGJXeQ,MAAARAAAHADBGACBeAFAdCGABAGB..TDAAaAHDLCCA.hAAACCGDKDHBECCBAAFA.IEEAhABAVEEA.JEHBQFAAhAFASFDDFGHBfGFA..hADA......hBIA...,2,-13,-13,0
gRTISfVPbeJNUZYMLadGADQXOKFECcBHW,QAAAKAAAEACE.BACAHAEBRADF.SAGA..fAFBhAAAbCCDeCGFUEAAhAAAZBFEMDDBdEEAACCBODHBhAHACDHA.gEEATGGAIHAA..hAEA......hAGA...,2,-21,-6,15
SGZQKCAFbMDfcRXgdePIVWBOTUEaNHYLJ,MAAADAAARABA.dAEA..eAEE..IAGABAHBOBDEEBBAHCEChAIALCHBGDCAZDDAQEEChBAAADFAFFFH.fEHAhBBA.XGGA...hBAA......hCAA...,1,-1,-40,39
TdOXAeJIFQfgaBZSLYEPKcbGHRVWCDNUM,eAAAFAAAQADA..aADDZAFBLAFAEAHFKCCA.GCDBhAAAHDAARDFACCHBDCCBUFFBdEEDACIB.hADAfEHABFBASGHHhBAAPGAAcGCD...WHEAhABAMEEB.....hAGA...,2,-24,-4,20
YBJVbDCdgZRcETQOXHeGNAKaLSPMIfWUF,aAAALAAA.MAEAIADAUBEABAHA..bAEDdCAARAGBEBBBhAGAQCCA.HCGBhABAeDCFACIBKEFDfDHAhAIAFFHDJGCA.CEEAZGCE.TGGA...hACA......hCCA...,1,-3,-15,12
VHUEWDReOLfcFYdTJGZCbPAKSXagMQBNI,XAAAaAAA..MADAQADABAGA.VAFAHBBC.EBEERDAAeCHFhAAALCHBFDDAdFFAhABAGDEACGDAADAA.SEDDhAIAIHHADEIBfGGA....hBAA......hBBA...,1,-5,-21,16
FKIDdUJAEQXLgbZTVaYOHfSePcGMNCWRB,EAAALAAAZACB.aADDHAEA.eAHHGAFAMCBBCAHARCAAKCED.dDGDAAFBQEDAhABA.hAAAXDGDbEFCTGAAhAGAOHAASGCB.cGGABGGADGIBhACA......hAHA...,1,6,-17,23
FBgIPcCXbNETfVGdaHSRKYUeLDQOAMJWZ,MAAAZAAABADB..IAEACAFA..XAGDEAGA..TBBAhAGAGCAAHCEARCCAKDFAhABAeCHHLDHBQDBBhBAAAAIBFEEH.gEEAbFCD.fFHAhBBAaFAHSGFHDGCB.hBDA...,1,-12,-14,2
cYFDVbUXBTWNeGLREPKHgadZSJfCOMQIA,FAAADAAAUADABADA....TAFAeAFARBBBKBHBHCFA.dEDAZCCA.hAGASDABCBHA.hBAAMDGBADBBVFFA..hBBAbECBNIEB.LEHB.EFAB.aFFH.OHAEhADA....hAFA...,2,-20,-20,0
TJcUPQSDedFIbMAfNVWKLaOCXZRBHgYEG,VAAALAAA.aADDCADBZAEBHAFA..EAGAGCAA.TCGAhABAUCGAQDCChAAAeCCBdEEAbEFDAEFB...fEHAhACAKFGARGDABHHAYFAF.PFCBhAFADIBA......hAHA...,2,-22,10,32
DQCEIWPRJXdTAKMYSVUbOZHFNgBfacGLe,MAAASAAAUAEAZAGBHACB.FAEABBBAaAGD.GDBALCFAeBDDhBAAQEBA.hBBAEEDAIEFAREGBdGEAAAAA.hAIAKDHB.bFDD.OFGD.....hBEA......hBIA...,2,-14,-6,8
WXYaGLFcRQdBJSMOZeDCbNKAfHIPETgVU,HAAAEAAA.TAEAUADA...XAGBGAGALBCDRCAAdCEDSBHHhAAAZDDBeDFFbEAAAAGBfEHAhAAA.hACAgFBDVEEAaEHDFHEAQGFDBHHA.hADAMIAA.DGIB..hAIA...,1,19,-7,26
BIYWQgSRPKCfJVNFDTEGXabHAMOZLcedU,ZAAAeAAAdAEABADA..IAGAQAFARCAA.CAHA...VCFAhABADCCAECEFGEBA.aDEHhACAHDFA.AAAAMDDBhAFALFGBcFFC...YFHH.hADASHDA.hAIA...,2,-19,-17,2
VZTBDaKMSOGYFbLgIUWdfEXPHQRNAJcCe,CAAAeAAAZACABAFBKADA..MAFAGAGA.FCCALBGB.gCCAhAAAIDAAdDFAhAAAECFFHFCAREAA.ABIBVGFAhABAaDHD.SEEGOEEHUGGA...hCAA......hCBA...,2,-19,-10,9
WPdFTZHXSVgaQcAGbEJeNRCUIKfOMLYDB,EAAAeAAARACA.CADA..KAFAMAFA.LBGBBAHBdCCAZCCAHCFA.SECAhAAAaCEAABIBGDAAhAAAJEGB.IFFA.hABAODHDDEIBFFAB........hAFA......hCAA...,1,-10,-32,22
cYBAGWHfDgSaUOMLJXbVdCFPZIRQKTENe,HAAADAAA.aACAMADALAFA..bAEAdCCA.FCFAZBBARECATEGAhAAAECFB..eBHHBGAAhAGAADBAGDBB.fEHAhAIASGEAOFFB.XGCAhBAACHHA.IHHAhBCANICB...,1,-8,-19,11
LMTEFBZQCbIcaOXJgWNdUPKDSHAGRYVfe,RAAAVAAAeADE.LAGBEADE.ZCCAQAFCCBDA..bEEAaAHDhAAA.XCDC.hAAAgDFAdFCAKGEADAIBhABAHFGBADIB.fECEMFIB.TGDAhAHA......hCAA...,2,-17,-8,9
aTPFRNHXYEZGOQBSMfCAdKgDWecLbUIVJ,dAAADAAAeABALADAUAFAJAHB....aBCETCBA.RCFBHEAAhACAECHFGDDABDEDMDIBhAEAAAIBKFBA...gFCAhAFAbFGB.IGGAFHBAXGED.hAHA......hBAA...,1,-16,-18,2
XcCDWVePOBHZYdGRJTAfQFaSNEgUMbLKI,QAAAaAAA.EACAMADALAFAKAGA..XBBADBEBeCDDhAAABBEAHCFAdCGAREGBAAGASDEBhAIAgFCBbEBAhBAACFFD....WHCAODHD.GGDBhBBA......hBEA...,1,0,-22,22
BDWeRVNJSHaGLTdgcKAUXMZbOPfFIYQCE,MAAAZAAAOACAFADD..QAFAEAFABAHADCCBRBBB...JCFAHDEAhAFA.GFCBdDDAKEGAhABAAAIBbGFA..fFEAhCAACCHAeHBE.SGGA...hBAA......hBBA...,1,-7,-36,29
XGYTDFcWJREQOSfMKHACZLVbdPaBgeIUN,ZAAALAAAdAEABAGAeADHUCAAGAFA.TCAAFBHD...JCHBhABAECFFQEDAhACA.fFAAhAFAHDDBADDBbFGBaFBD.IGGAXGAADFIB.WHAAhAHASGEA..hABA...,2,-35,9,44
AdWUGNVEfFSDMcCOXJagbRILPeZTKQHBY,dAAAGAAAEADA.SADAMAGB.OAFDaAHB.RCDBLAHBhAAAeBEFZABBQDFBhBAAHEACAADAUEGAfDCAhBIADFFBCHBA.XFFA.......hACA......hBAA...,1,-8,-9,1
VZbIAWBOcfQUHMPJaSLdTeGXYENRFCDKg,OAAAQAAAHADAMADAaAFA.LAHB.eBDAGCCAEBGFRDBAhAAADAIBKDFDZCFA.ABBBBEFAhBAAfEGAPEHBdGHAhBCAXFEC.FGCH......hCAA......hCCA...,2,-12,-4,8
FfZdMULHWAeKCJNYBRVOIPaGTDgbcSXQE,eAAACAAA..JACABADA.RAEFOAGDaAFAGBEBDAIB.....hAAA.bCCDXCBAhAAA.EDFBZEEBdDHAMDIBhABAHEDBACCBKEGBNIAB.IGAATGGA.SGDDhAGA.fGGEhCAA.,2,-28,-15,13
QBFSfcTgdMbeHLDXNIZWaEPGJVUACRKYO,RAAAOAAAQADCFADD...SAFBTAFAdAHAeAHBHCDCLCCAhAAAXDGAZDEEEBBBhAFAGGDBUFFAAEEBKFFCfHDBhBAAMEIBDIAA........hCAA......hDAA...,1,1,-12,13
MdcAIaCRGgQEbNDFHfXUTKJWeOLSYBZVP,aAAARAAAGADA.EAFADADA.HAECUCGATBCAKCCD...eAHHhAHALDABBCEAZDFEMDFBhAAAABBBCFGAQGDChABAFGDA.XGFD.......hBAA......hCAA...,2,-28,-9,19
PLWEdRDAfebcJSNYZKCBTGUXOgFVaIMHQ,eAAAJAAA...SADAZADBBAFAGAGAOAFDFAHB.aCCAHCEBhADA.LCCDhAIAECHFRDDAAAAA.bFGB..cEAAhAEAKGDA...TFFA.....hBAA......hBIA...,1,-16,-25,9
OWSgDbNMefQdFCEBZcXATaRIJULHPGKVY,RAAAUAAAHADBGADAKAFA.OAFASAHBDBGB.MCCB.eCGBhAAAdCHAEDAAZDAF.AADBaDDHLEEBhABA..PEGBhBAAYDDF.gGFHbFBC.fHCBhADACHDABHHA...hBCA...,1,4,-23,27
NFWKLVfHSPGdXeZaAQgYDURJIMbEcOCBT,QAAADAAARABA.MADAEAEE..CAGBBBHATAGA..FCDALBDBhAAAHCFB.GCFAhAIAeDDBADHAgCBAhBCA.UFBAbFFAOHFCKEHBSFDA.hAIAdHGB.aHDE...hBAA...,1,16,-32,48
SNgeHEDAQXdJIGaTWPUfYOLCBcKMbVRFZ,dAAAGAAAaADA...TADAUAGA..OBDBLAFBBCBAMAHBhAAARCEB.ZDCA.SCHHhACAeDGHHEBAAAIBQFCAhADAXGBA.IFGAfFHACGEBKGHB.hACA......hBAA...,2,-26,-2,24
GWJgIAeVXCZdDPBTUKfEbSQRMLOcHaFYN,eAAACAAAdACABAEAKADA..EAFE..QAGARCCAMAIB.LCBAhAAAHCFBaEEHFCFB.GDGAhAEAgFCDADIBZGAATGEAhAGAfFHA.OHAC.NIEB...hAAA......hABA...,1,-13,-16,3
CZYXLSfDgOHQWaBGKcEJTRVUNeAMdbFIP,dAAAFAAACADAZABB.LAEADAFA.HCEAQBEAaAHDGDCAKAHB.EEGAhAFARCCB..UEFAAFFBMFIBhAGA....bDADIGGAhBAA..XGCAfGEEOFHDhADA.BHFA..hBAA...,1,1,-33,34
PDaegYRSHQNEcKTWFAJVIMbLCGBdOZfUX,VAAAMAAALAEA.GBBAdADAZAEBXBGAaAGD.eDEAhAFARDEAHFGBEEDB.TGBAhAAAABBBIEHABGFCODDHhAIAfFFADBIB.SGAA.NIABKGHBhAGA......hAIA...,2,-10,-10,0
VYHeXMQgbLGRcPKTNEWCOUfdDFaZJBAIS,SAAAHAAAeACEMAFAQADALBGBRAFAKCCAECCA..OCFEhAAAdDEAaDHDZDAAABIBIFCAhAAAXEEAGGABhABA.PFHBTGDACHEA.DFGB.BHGA..hCAA......hCCA...,1,1,-7,8
fDdNcZWBbMgaKTRLAOEUVGJQPFXSHYCeI,EAAAGAAA.QADAXACAHAFAeAFADBIBdCCAZCFABCDDbDABaCFDhAAA.RDGFLFDBhACAAAHA.ODAHVEDAFEHHhAAACFFDfGAAcGEDMFABKGHB.....hADA......hAGA...,1,7,-1,8
CfWUgKebVOaGdNJAHPITSLXZEDYBMFcQR,HAAATAAALADB.EAFABACBMAIBQAEARCEF.fAGFhAAAgCAAeBHFhAEAbBGDOFAAdCCAADFASDHHhCAAZFGBFGCDCGFA.KEDA.GFEB..hCEA......hDAA...,1,13,-15,28
LGPKXbfMQHeVASJZgTOUdaWcFNCIYDERB,ZAAATAAAdAEA..aAGAFACA...CAFADAHBRBFFGCAA.KCHBbCCA.hABA.MDDBHDFBAACA.SBHHhAAAOEEBUFGAhBEAcECA..IHBAEFAALEHB.hBHAfGCA.hCAA...,2,-19,-11,8
AXUNTbDCEfZSFIVYLRMHgWJcdaPQKOGBe,XAAATAAA.DADAEACE.ZAEBFAFD..VAGBRBCFHBGB.JDFFaCCBhAAA.QDFDhAEAGEBAAAAA.bECDSAHBhBEA.LFHBMDIBgGFAWEDH.hCAA......hCBA...,2,-14,3,17
fMEHdbVYQLKNOcDARWIZXSGgPeJBTaUFC,RAAAZAAAGADAeACEBAFBUAGA.FAHB..MCCBHCCCdDAA..bCFDQDFAhAAA.LEHBhABAOCHDAFCAXFBAhADASFCAJFFF.aGGA.EHDA....hABA......hCAA...,1,-6,-22,16
fbAVYFLeZCSEgcWHOPJKTQBUXRdaGIMDN,FAAAeAAAZACBEADA......gAEAHAFAOCCAKAHBQCFAhAFAXCFAREEAaDDChAAAGEDAMCIBDDIBfGGAhABAAEDBLFFBSHAAPFHBBHAA.hAHA......hAIA...,1,-10,-12,2
OWEfRVZdcTAXeSQLJNUMHabGDYIgBPCFK,eAAALAAAUAEAHADBGBCADAFA..IBGABAGAFBHD.ODGBhAAAECAARDDAZDGB.dFBAAEBAQFDAhABAMEIB.hABAbFGDgGDA.CHHD.....hACA......hAIA...,2,-18,-10,8
UHAIaPWNQOMXCFeRbgYVfZDcJBGKELSTd,aAAA..PAAAQADAMAEA.FAFERBCA.....bCCCgAGAhBAAVCGBZDAFDAIBBCHAhBDAEEEBTDEAHGCAABBBIEHAhBFA.OEDBCGGA.eFGB.cGDDhCAA....hCBA...,1,1,-22,23
NCgdGVODTeJbfcFPYWEMSQaRUKAXIHZBL,HAAAZAAALADBCADBGAEADAFAeAGB.JCAF..bAFAFCCB...hABA.PCABEDGBMAIBhAAAaCCHRCFAADEBBFFA.dGHAhACATEEA.fEHAYHAA.QFCChACA.XGGAhCBA.,1,-5,-20,15
SKCaZTJcDXEULYRebAINPQOfGHVWMgdFB,..IAAAQAAAGACAHACA.MAEAdAEBSAGHhACAaAGEZCDBTCFADAIBECBBLCHBhAAARDFAABFBOEDDfFEAhCAAVFGB.FGFD.CHHA........hBCA......hCAA...,2,-15,8,23
NRGFHIfLSDCTYQeWUVcOBJKZPXMgEAdba,aAAARAAAHADBLADACAFA..QBGAeAGHVCCABCCD.ZDAAMAIBhAEAAAAAdEEAGDGAFDGH.hADASEFDTFAAUGGAhAFAOBBB.KFAA.XFCB.EGEBhAFANIAB.DGIB....hBAA...,1,-2,-3,1
EMTfbFDCPgKOGBdSXRYZWIJaVHeUANQLc,LAAAEAAA.MAEAbACA.DAIB..CAGAKBHBGBCBBCCAdBGARCEAZDAAhAAAJCABHDDC.ADIBQEGDhABATEFAFFHDOEEHhADAXFBA.IHGAeGAANIAB....hACA......hBFA...,2,-13,-6,7
GFXPHZTKLMQRdJgSaCfIAcYOBeWUNDVEb,OAAAeAAAUAEADAEA...EAGAGAGA.XBBAHBCBZCFELBEBhAIAREBBdEEDSEGHhAAAaDFDCECA.AEIBBGHAhABAVFGBFGBAKHCA.MIBA.......hBEA......hBIA...,2,-12,-10,2
faTNSKgHJFbOZcALMXPCBEVRYIedWDQUG,MAAACAAABACARACA...eADHdAFAQCCBGAFA..aAHFTCGAhAHAKCAAHDEBFDFHZFGBAAFBLDHBhAAAEHBA.IHBAhACADAIBNBBA..SEEDgGGG.OEDHhBHA....hCAA...,1,-8,-17,9
YGCJSgQTHEdLeKVFfbMDXZcOAPWNaRUIB,...PAAAaAAARACFBAEBGADA..SAFHTAFAHCFCEAHBLCEAhAIAeCCBFDBHbEFAhAFAMBBBZFEAADIB..UEEAhBAACAHB.JEHF..........hCAA......hDAA...,2,-25,6,31
YPHUGBTXRZJeKIbdQECMDgANfFcWLaSOV,FAAALAAAOACDVAEAHAEA.GCDABAHBRCAAeAHH..KCEDdDFAhAEAECGAMDIB.AAGA.fDHAhABAaFGD.SEAAhACAYGCA.TFEA....hAEA......hCAA...,1,-6,-29,23
SLbQEgGeOMHVJZYBXcWPaKdIfANTCRUDF,TAAARAAAFADALAGB..EACEeBFFHAEBZCCBXAGA.hAAAPCCBdEEDAAIBCDHASCGHhAAAQFGAGEAAhAEAMICA.VEDA.BEHA.aGDC.fGGAhAGADCCB...hABA...,1,16,-23,39
KAGeFTYUOHPbJBQLZdNgfcDVWaIXSECMR,eAAATAAAOADC.HAGBJACALAFBdCCA..fCFEhAAADAHBaBHD.SDHHhABAECCAREDAADEBGGEBFEDDPFABhAFABFCD.ZFEBNIAB.gGGA..hAGA......hAIA...,1,-1,-16,15
NeMfUacXHKGbOZBdQWYIDASPVLTRFCgEJ,SAAALAAARADFCAFBEADA....eAGHMAGBUCAAaAHBHCCAhAAAGDDBZDAFdDHAQDGAhABA.IEEAhADAAAIBTFCAFFGHJFGFfECE...hABA......hACA...,1,3,-21,24
LWPCBdMaTKVRHNYGceXgIDbZQUfSAOEFJ,EAAALAAA.CAEAdAGAaACDKAEAHCAAGAGAeBHH...XCBChAAADCCAZDEBQEABhABASCEBAAIBFEDBJEAFBEHAhACAMDEBRGBE...cFFAbGFA.ODHD.hAEATGEA...hAIA...,2,-6,1,7
QFVAagYcNTIXbWRZKEBHDMSLfPGeOJCUd,aAAA..gAAA..cACDTADA..XAEDhADARAFFEBHFHCCAMAHBLDABhAAAGDDAeBBDCDHAdEEAQGFAhABAAAGBIFGAWBHHBHAADFIBfGHAhAIA....hBAA...,2,-25,8,33
eFGCYIKBaLgMZWDRfEAXNQcVUHObTSJdP,QAAAUAAAHADAOAFASACA.dAFAeBHFGBGACCDDKCFBaAHFhAAALDABZCDFRDAAADAA.XEEChADAVFBA.TFGAhBAAFFGHBGEA.MEIBfFCA.NIDB.hBCA......hCFA...,1,9,-14,23
XgFbTWDYcQHSOZCGPEBMRVaJAKfNLdeUI,KAAALAAAeACEUAFAXADD..FBCDTAFADAIB..QDEAhAAAHCAAZCEEGEFAhABAEDGA.RFAAaAHFACEBdFHAIEHAhACA.WFEDSGGDCHHA.MHBAhBHA.....hAFA...,2,-26,-1,25
LITSQbNaYUCABERPFGXDeJgZMWdcHVKfO,RAAAGAAAeADEZAGBdADAHAFA.KCEALCCASCGHQEBAhAAAaDBD.CBDAEDHFFDDHDCIBhAAAMEEB..VFEAOFFBhABAbFAC...YGAAAFIBBHAA....hAGA......hBIA...,2,-13,-1,12
IecfOdHWKRNVaFLXZMQTSCbgDGPAYUJBE,UAAAEAAA.eADAOACCHAGBRAFF...aCBELAHBZCEF.MCCBhAAATEAACDDADDFBAADABDGDhAIA..fEAAhAEAdEDAKEHBFGBDQEGASGGBGGEB.hBAAYHCA..hAFA...,1,-3,-18,15
MZFdTJPEOXQGBAfUCVNWYRKcIaSbLHDeg,CAAAVAAA....NACA.RADFKAFC..aADALBHBHAFB.eCEHhAAAZBDFdBHA.JEFBECGFODCDhAAAGDAA.ADABfFFAhADA.UGCAYEHBSGHBhAIAbFDDMHAAFHFE...hCAA...,2,-18,-4,14
geCWEGMQNSDBZbPHJVRLYTacAOXUFdIfK,XAAAdAAAKADA..eAFEEADAGAFA.MAIBQBFDhACA.DCCAbCDDHDAARDAATEGAhAAAACIBFDFDIEHAhADACFBASGGAZDDF.PHAA.....hAIA......hBAA...,1,3,-22,25
WAGQefcDHZFSCdKYPbEMILUJTVORXagBN,eAAADAAAHABCZADBCAFAdAEA.KAGA....bAGDECCB.MCGBLCCDhAAAUFDA.TDEARFGB.hAGAaEGDBCHAAAIB..GGCBhABA..........hBDA......hCAA...,1,-16,-32,16
UCKfELZFDcSeORgYQbAHdBXWGJTMVaNIP,HAAAdAAABADAGADAMAFAaAFA...ICGACBEAKBGA.LDAAhAAAZABBDDDA.eCHH.REFBQFBAhACAADGA.hBAAJFEFTEEANIAB.fDHA.EFHFhBGA.SGEAhBIA...,1,15,-51,66
LfANXCYcJeOBKbIVGMgUSHQTZdaEDFRWP,CAAAJAAABACA..KADC..VAEAGAFA.MAIBSAHBhAAAHCCAZECAECAARDGFLHAAhAHA.AEEA.XCDChACAeFHH.bCGD.gEAA.TFEAhAEAaFBCDGGBFGDH.fGHAhCAA,2,-18,-15,3
CSBJbHGQAUNdTVODXKWFMegaZcILYPfRE,dAAATAAADADAKAFA..MACA..eAHHZADELAHB.hACAfBGAEBDBBCBAHCEBhAHAACCBVDDAXEBAhBAAFECHaEGD.IEHA.RGCASFGDhBCAbGFA.....hAAA...,2,-18,-15,3
TAUgGYKBXHQIfdSeRVWJOMbPaCFDNZcLE,GAAABAAAHACAQADAdAFARBGF.JAFEMCAB..aBGEDCCBZCDAEDDAhAAAAAABUEFB.KGGDfEFAhACAeDAD.ODHDhAEACDHB.FGGBNEEA.LHAA.YFEFhAHA....hAIA...,1,-10,-15,5
gBDHVJKFMPdERSQYNUaOWLcebfITXCZAG,GAAADAAAHABCKADAMAEAEAFE...RBEAQDDCUCDAOAHDLBHBhAIAeCGB..bEFDTFBAhBAA.ZFFAAAABBFDAhACAFGDDdHFBSDADaCCH.fHABhADA.....hBFA...,2,-11,0,11
aKJHQcZdXPWCVEgeTfDRMGBNSOIFLbUYA,aAAAHAAAZACBdADA.XAFACAEA..EAGAeBHHDBBB.RCAAGCEAhAAABBHA.OEDBLCEBhAGAbFAB.ACGBQDGAhBAA..PEHDgFGGTGFAMEDBhCAASGCD..hACA...,2,-25,3,28
cRXaQbgGWHdUBKZEIJPNLMFYeCSODfTAV,RAAAaAAAQADCGACAHAEAdAFABAHAZCEEEDHF..JCCFLEABhAEA.MEFBeCFAOEGHhAGATEEAAAIBXGCAhAHA..bEGB.WFHHIHHAFHAA.SBBDhBAADGGB..hCAA...,2,-15,2,17
BbIFUafPJcGWNQSEDeYOHKgLTCRZAVXMd,MAAAdAAABADAFADD.UAFA..aAFA..JCBBGBBA.QBFChAIAECHFDDAB.eBHHhBAAHDCBLEDAREEF.hACAABBBbFEAfEHA..WFHHSGGAhADA.KHBA.CAHA.hBAA...,1,-6,-31,25
MdEGNBIDQATCXeOaRLKbfZHgWcFVSJUPY,TAAAeAAARADALAGB.KCCAZACBHCEBgAEAFDHD.SAGHhAAAUEAAMFGBECABhACABGCAQDEAhAFAAAAACHHA.aBHD.bEGB.fEDE.WFHHhAIA.....hAEA...,1,4,-21,25
EQRdbXFDUcHICKMNBOgTAZGfJSeaPVWYL,GAAASAAAeADA.aAGDVADA.LAGBRCDAdDHAFDCHDAIBHEFBhAAAKCCABDAAODAHAAAAZDFAhADAJGBA....WHEAhACAEEEBbGCC...XGFD...hADA......hAEA...,1,-5,-15,10
PBVAJaRMKDLgXbICSWTGfdOUYeFQHZcNE,RAAAMAAALADB..bABASAFA.GCEAdAFAOAHBhAIAeAHHHEGBZCCAEDGBBCCChAAAACIBaEECDDIB.XFAAhABACFBATGGAfGDA....hAFA......hAGA...,1,-9,-20,11
OKbMBQFEWdaNgIecLRYVUCDHfZAJGTPXS,GAAATAAA.SADAKACCBAEA.EAGAdAGAaBGE....gCCAhAAAeCDBRDFAUEABHDFAhAIAAAABXFCDMEEBQFFBhBGAFFFHIHHALFCBCGAADIDA...hBIA......hCAA...,1,5,-16,21
WeHdPcUAVYXGZOKLTEMIQRfSbgNDJaCFB,XAAAZAAALADB.EAFAMADA.RAFA.SAHH..hABAbBCDDCAAaBEHBCFAHCGBhAAAdDHAPEFBAEEAGEFAhACATFCAQFAA.fFCFhAFANIABFGHB.eHBA...hABA...,2,-8,-3,5
QYgFLXIfUVZPeJMbBacGTEWHARODKSNdC,RAAAKAAAdADAQACCFAFA.LAEB..fBFEhAAAZAGBeCHHMDDBaAHDGDDAhABAEEEAHGAAACCBDDHBCFGD.XFGAhCAAIHHA.........hDAA......hDBA...,2,-30,-8,22
cGPSUJFRNadZMCWDfLQAEOKHXbgIBVTYe,EAAAHAAA.XADB..bACABAFATAGAeAGHGCCASBHHhAAAFCFDRDABdDHAZCAAMCFBhACADFFBLHEAACCAKEDBgFGAhAIA.IHEAcGAC...hAAA......hADA...,2,-9,-2,7
FNBEfYWcGVKbHDMgaOdIPeTUCLRSQXJZA,BAAAEAAA....fACA..cACAGADAbAEBHAFAhAAA.MCHBOAGDhAAAdDFAeDDDTCBALFABhAFARDEAQFGAXFGAAAIBFEDHNICB.YGBAhBCA.KGFD.DCIB.hAHA...,2,-7,-1,6
NZJCRXfTDSYBWEdOUPecbGFALaIgHVQKM,aAAAHAAA.QADCMADAZAEE.RAFF..TDDASAHHBAHBECABhAAAdBBDOCDEeCGHGFABhACAADHALEEAIFHAhAFAKFHBCGCADCCBUGEAPFFB......hCIA......hDDA...,2,-18,10,28
ScUPZGaAKOWJNXRYDTgFLdfbVBeQMECHI,OAAAJAAA.RADA.DADAFAGAdAGA....VCCBeBCA.ECEFHCFAhAEA.SEFAhBAAUDGAGGBBABBBKFCD.XFEChCAATGGA..fFEBBFHAMICA.CHHA.hCCA......hCFA...,1,-14,-31,17
ZTdNVLRePJFXHfDMEWKSYIQCcOaGUbABg,ZAAAdAAALADARAEA.eAGHFBHDHCAADAIB.ECEBSCAAhACAQEABOCEBGDFAAAEABDCAhBAATGCA.PFHDhABAfDGAMACAKHAACEHAaFCB.UGGA..hBCA......hCDA...,1,11,-22,33
HVgLaGSIPNATKedfZUFDQcYOBRJbWEMCX,eAAAZAAADACAQADA.OAFCRAEAJBHB.ECCBMCCBHCECLDDAhABAGEEASCHBhAAA.IGHAhABAAAHAdFAAFEHDBEHDCFDAXFFDaHAA....hAFA......hCAA...,1,11,-34,45
JWXGTMHKLDCYbIcEZUVOBdSefPNAFRgQa,RAAAaAAA..XADBGACAHAEALAGBCAHB..ICGAEBFFZCCFOCHDhAAAdEAAeBBDfEEBhABAACIBQEDATFBAhAIAMEHBDFHBbFFDcGEA.....hAEA......hAGA...,1,-3,-4,1
bOTaGcESRBDZPVXLNAdeYUKfHCMgFQIWJ,eAAAKAAAHACBMAEAQAEA.JAHBbAFA.OBCCGCAAECFAhAAARDEAZFDA..XDDChABAACABdFHA.UEGACGBA.hAAAFEBBWHAAaFFBBHDADIEA......hBEA......hCAA...,2,-12,-4,8
EOUcKYNSaXeFWgLRHGbIfJCTBADQPMVdZ,QAAAMAAAZABEUAFAKACA....SAEBeBHHFCCALDFBhAIAHAGBbCDC..fDHAhAAATFBAAEEADEIBdECDEFEAhAGAOFHHNIAB.aHBCXGEA...hBAA......hBFA...,1,3,-21,24
SPVDTdCbQBIegJMXFGWRNHfLYEUcOaKAZ,ZAAASAAADACAdAFA.QADABAHA.eAFAMBEBGCCA.hABARCFAHDABLCHBEEFBOEHBhAAAACCBTDFAbGACJFBAhAHA...FFFHNIBB.....fHDBhBFA....hCAA...,2,-35,17,52
eSTYEfJKADbHUFBdWcCRNgMOLGVXZIaPQ,HAAABAAAdACACADBRAEF.MAEAGAGA.ZCAAaAGE..eDFF.TGAAhAAAEBEBKCBD.ACGADCIBbEDD.hACA..FDDB..cGFDhAGAODGB.LFBA.XFEDhAAA.IHHAhBCA.SHDG.,1,3,-24,27
RFCdHDJMTLgYcAOfUKNbWIBXeEGSPaZVQ,OAAAKAAA....bACBBADA.EAFAGAEAaAHD.ZAGBRCCAdCFAhAFAHEBADBBBMBIB.TEGAhAAALDHB.gEEGhBAAAAGBfFFENHBB.IHHAeHEA.hBHASGED.hCAA...,2,-21,-7,14
TORgGPfEBcDdCYeIAMbXFJKHaNWUQZSLV,MAAAFAAAHACB.aAEAUAEA.ZAGBLAHBOBBAGDDAEBEEDDEAdEEAhBAAeCHHABHB..XGEAhCAAKCCDQFGBhBAA.TGBA........hBGA......hBIA...,1,-15,-22,7
BaHEXIdSgPbNGCWLQUDfYKORFAJTcZMeV,TAAAZAAAeACE.BAFBHACB.EAEAdAHASAGA.bCEAGCCBhABA.LDHBhBHAQEAAfEFAhCAAODHDACABMFCBaEEAXFCBgGGGCFFDDGHBhAAAKHEA.FHAA....hACA...,1,2,-12,14
LRHEIFfKdQMPeJGYcSaZWCATVUgOXbNDB,TAAAUAAAOADA..XACBDAHBRBDB.HAEAFCGH.dAHA.MCCBhAAAeDBBGDDA.hAIASCGDZEFAABIBbFCD.hBAALDHB.EGAAKGBDQGFChAGA......hCAA...,1,2,-26,28
VGbgfaENeACZPOKHXIBFDLcJMYSQTRUdW,ZAAAKAAAHACBBADBLAFAMAEA..QBECRCAAdCEAGCGAbBGB.hAAA..aEDCECABAAGA.ODFDhACAFGCA.DCIB.cFEChAIASFGD..WHFA...hABA......hACA...,2,-28,-4,24
fIUYAJBPQeHWXSKDGaZdLOECgVTNRbcFM,BAAAeAAAHADASACAGAGAdAFAECCBCAHA.TCEA..RCAAFCEHhAAAMDIBUDGAAAAAQEEBhAFAKFBAZFFA.LGAAhAGAOHAA.gGGB.NIAB.bGECIHFAhAIA....hBIA...,2,-22,13,35
FACcVRJeGYQBafdgDbPILXEZWTUOMKSHN,CAAARAAAeADEGACABAGBdAEB..DAHB..ICCAEBFB..ZCAFTCEAhAAAMAIBHDFC.hABAAEEB.VDGBQFDBhAAAaAHD.bGFALEBA.XGCAhBEA.OFFB.SGHHhCAA,2,-18,-6,12
OENVBgXFabAQPULTHYKMCGcIdZfWSJeDR,QAAALAAAHADBMADAGAGA.dCAAZAEESCCDhABAeAHHRCBAECFBBAFAFDHDAEEATEEAhACACFFA.IFAAhAFAJGCADGHB.ODHD.gGDB.aGGBhAIA......hBIA...,2,-17,-3,14
HcCbUedPODIXMTNKLVWJSZQABGEYgaFfR,EAAAaAAA.RACA.HACB.CAEA.eAFEdAGA.DBGBMAIBKCCDLCHB.hAEA.VCEBSCFDhAAAABBBGDGAFDAB.bECDOGBAhBAA..TFFANIEB...WHEAhADA......hAIA...,2,-22,-12,10
abBfDNEKIYUJXCPHcVSOZdWTgQGMFALeR,RAAAaAAABADB.DAFAEADA.KAFAUBFA..CAHBHCCA..SAHHhAAAdCFATDAAGCCAhABAABBBeCHB..bEFAfEEEhADA.IGGAXFEC.PHEChCAAOHEC..WFCDhCCA..,2,-29,-25,4
WDbFcYLMKUQCNZBdGAXTRIOgPeSJfaEHV,RAAAOAAAeADE...SADAaAGAHBDADBHBFAGALCCAKCCD.hAAAQCGAZDEBGGEBhABAABBBTEAAgDGAhCAAfECB.EEEE.bFGDMICACGBAdGEA.hCIA......hDAA...,2,-5,-1,4
HNabCJBOURKSDEPXdVfYTgWZFQIceLGMA,HAAAaAAA.CADBBAFARACFDAEA...EAHBdAHA..VCCATBEA.ZDEAhBAAQCFC.hBBAeCABGGBBADIBbEGDOFFChBGAKFAD..SFFF.fHCBhAAA...hBHA...,1,-8,-28,20
BXfEQbONCdcLFPRAZMGUIHaSTKeYJWDVg,GAAAHAAAaACAKADAeAEH..JAFADAGABCDAEBGA...QCFAhAAAbCCD.CCHAdEEALDGBhAAARFCBZGFE.MCIBSDADhACATGBAYEEB....hBGA......hCAA...,2,-20,-10,10
gEYTUBPXfSALIeDNGCHQWdVJKbaMZFROc,eAAAGAAAHADAdADAKAFAaAFAZBFERCDA..OAHDECCBUDGA.BEDAhAAAXDBDAFFBLGEAhABADDHB..QFEAhAAA.JFAFMIAAFGCB..gGGBhACA......hAFA...,1,-9,-14,5
cGVAKSQXYNTCOHBIWUdJafMZEbgLeFPDR,QAAAXAAA...TACAHADABAGBUAEAdAHAaAHDZCDAEDDALDGBhAAAeDABDDHBREEBGGBBhBGAAAAASEHHhADACEFAIHHAfFCA.MFAB...hBHA......hCAA...,2,-10,-4,6
CPKBaJLUOIcZeEWAdgRXNYGDMFHfTSbQV,RAAAXAAAGADAMAFAHADA....TBGAQBFCCAHB.BBHBhAAAaCDCLDABhAAAOCCBZDAFEDFFADHAdEFANDIAFEGDbEGDhABAKFCA...........hADA......hCAA...,2,-11,-5,6
LJWCgUMeBTPEVcZKaXRAYFNSOdIGHQDfb,FAAAOAAAGACAHADAQAEADAFALBHBCAGA.MBBBBBHAECCBZDFAhAEAKCEAREDB..ADGA.SEEAhAIAdFFA.bFEAWHFAhAIAeGCG..........hBAA......hCAA...,2,-22,-13,9
bLcXfYDOTACFQaPJBZVHeNUKSGEWgMIdR,QAAAaAAABADAHAEBeACA.KAFAEAGAMAIBRCCBLCHB..hADAfCDAOBBBADGAFEFBhAGAZCEBUDAASGGAhBAAGCGAIHEAbGDAYHAADIBA.CHHA..hBIA......hCAA...,1,6,-10,16
GZXNcgDFfEYbLJWaRABdSIePQVMKUHOCT,dAAAeAAAQADAMAEAHBCACAFA.ZBFB..XAGD..gDGHhAAAFCBDEDDALDGBhACAaAHDABEASDEDhABA.IGGAKEFDODAH.NDIAfGEEhADAYFDFWFHHBHHDhAIA...,2,-22,-8,14
ROBINMQSdeETLUJPbXFZKGHVCADWaYgcf,aAAA..gAAARACFBAEB.MADAdAGAECEBLAHB.PBDAhAAAFCHDGDFAHCCAABHBDBBBhAIA....cDGChABAOEEHQEECeFCBJFHB.ZGCACGBD.fGGAhCCA...hBAA...,2,-20,8,28
eEbDUTZWKgGPYRCcfBQOaHSLJIdFXVANM,eAAAEAAADADAZADB.KAFAGAEB.RBCB.CAHBBBCAQCECHCEBLCGBhAAAdCHAFCBH.ACIBMEIBhABAbEFD...TGDAhCAAPHAA..fGGAaHGE...hAAA......hAHA...,2,-18,-13,5
FEKUdgQONfILGBCSJTVXeRPcMWAHZaYDb,HAAAaAAA.DACAEADAdAFA.QBDAOAFC..ICCAGBGASAHBhAAATCEAeCGHhADAREEBMCCBAAHAZECAbGCCKDDDNEIAhCAABGGACHGA..........hBAA......hBBA...,1,0,-18,18
ATEVYWFQeNRfUIKbaDZMGXcCLPSHOJBdg,EAAAVAAAFACD..eADERAEA..UCEBKAGCDBEBGDGA..CBHALCFBhAAAHEAABAHBACDB.TFEAhAAAQFDC.hAEAIFHAaCHF.MIDA...cGGChCAASGHH..hAFA...,1,-19,-24,5
ZJNSVgbAdXEICHFRcGOBTaMDefYUKWQLP,EAAAHAAARACA.GADABAFB.aAFADAHB..eAHHUCCBQCABhAAAZCFA.SBFBhACAVEFAAAIB.dEFA.CDHAODDHhADAMDABKFEDLFHB..NICB....hDFA......hEAA...,2,-31,6,37
OTIXMbJPaKWLeNYdGgHARBCSFVfcQZUED,RAAASAAAFADA..VAGBQADA.EAFATCCAMAIBJBGBhAAAaCED.LCCBhABA.eDABdDGDHFFAhAAAAEEAfEGAZGAAOHFEbFDDKFHBWECG...hADA......hCAA...,2,-9,-7,2
QCLOPbaeEcJgSDBFNMTdIGXHfYKURWAZV,ZAAAQAAALADBOACCaAFA..EBFBJAFA.DCDAFBHD.MCABhABAdCGAGDDAHDEAKEHBREABACIBhAAACFGD.eFGB.SFHBhAEATGBA..IHHA.YCCFhACA....hAIA...,2,-17,-12,5
AaXENJFfcGICSROeMBYVPQdDbKTWHUZLg,EAAAFAAAGACA.CAEA.RACAeAFEBAGA.VBFBdCFA..KBHBHCDBZEAA.hAEAACCBaCHD..XEEChAGAfDAA.SFFAhAAAMDHBQGGBbGFA....hAIA......hBAA...,1,-3,-28,25
HPXJWQCAZcGbMNIEKdReTOYDLgaBSFfVU,GAAAMAAA.EADARACAeAFEOAFCLCCA.BBGDfCDAhAAAHDECXECCQCFAhACAABBBZFFAbEECKCHBdFCADHFAhAIAaDAH.FFHD.PHDC.CHAA....hBAA......hCAA...,1,13,-13,26
BAgdYPNZXeELWDJOIRVfKHGMUcTCaQSbF,dAAA..PAAAZABBEADALAEADAGA.OAHDRBEAKCHB.HBCAGDCAhBAAMCGB.UEDATEGAhBFAaDHHQFAAhAFA.FGGAABHAgGDHNIEB.XGGAhCDA....hDAA...,2,-26,5,31
CeAPFNGOTKaQSfcRUXHJEbBMdDgIYWVLZ,FAAAGAAAKADA.aADA..QAFCSAFHRCCAHCGBEAHBBCDAdDAADAIBhADA..gCFAhAAAIEEA.VEBAZGDAACCAhAHAODHD.TFFAfFGE..hBAA......hCAA...,2,-21,-4,17
AdgUaHTJSPcKGefRLDXWOEMbYIVNBCFQZ,dAAAaAAAHACBSADAKAEAGAGARAFF.LDEBXCAA.EBHFbEAAhAEA....IDDAhACABEHAQGAAhAGAAAHATEAAJDFFeBBDDDIBMIDANEHA.FGFE...hADA......hAEA...,2,-24,13,37
URIcdXPOTbGEJaNLQMgVFCBKfYASeZWHD,eAAAHAAARADFdAEAOAFAGAGA..EBFFaBCDLCHB.MCABhAAAFDEAKEBAACCBZDDADDIBIGDAhACAXEEC.bFGDQGGAhADA.CFFDBHEASGAA.hBIA......hDBA...,2,-20,-1,19
OYUGHJPKgMIFDRAbZNTfLdcEQXCVSBWae,ZAAATAAAdAEAEAGA..QACCCBHA.BAEBeCABOAFDhAAAGCEBHCDBKCCDMEEBhABADAHBAAIBbDGDLFFA.hCAAXGAASFDAaHEE......hCIA......hDAA...,1,-10,-20,10
WSIEdLHZGYabOJDUAXBeRVfQcNFCMPTKg,eAAARAAAQADCFADD..MAFAKAFCSAHHEBFAHCFCGDDAhAAAaCCC.OCCBDCFBAAAABCGDhBHAfFBE.CFGA.hABATEFAgGFGdEHAYEEF..hCAA......hDAA...,1,3,-28,31
RXdIBHJYVafOKNcgLPGeFWQADEUZCMbTS,EAAAZAAAMACA..bACARAEAdAHA.HCCCVAGBOCFD.KDHBgCCAhAAALHDAeFHBhABAQDFCAFFB.CDAATFGAhADA.XGAA.BEEC.hCAA......hCBA...,1,-6,-14,8
MUGcTdVKDYQXHNgJWCAbPfSILBOEeRZaF,...bAAASAAA.LADAEAEARAGBaCAAMAHBGCEAdCCADAIBhAAAQEAAHCFBgEABhABACDDCAAAA.fEDAhAEAODHDeGDGZFFAFHFAcGGA..hACA......hAEA...,1,0,-9,9
PFRQDMgdfIaEHWVBOACNKJSUebZYcXTLG,KAAASAAAeACEZAFB..XACDGBCARCGFMAEAdEEA..aECHHBEBhAAA.BAHAAAIBCFAA.UCGAhABA.bEBATGFAhAAALFFAFHBADEIBfGBA.EHFA..hBEA......hBGA...,2,-12,-7,5
aAbPDTCcOURJfeBEIHGVNQMSgLYZKdWFX,DAAATAAAOABE..RACFeAEEEAEE.HBEAGAGAQDEBhAAAMCCALDDAZDGBdHABXCAChACAAAIBCEHAUFDABFGDhAGAIHHASGHHKGFD......hBAA......hCAA...,2,-24,9,33
PaFHEfceRJCMZSOYQVbWgDNTKALBGUdXI,GAAAdAAA..XADAaADAHAFB.EAHBeAGBRCDB.MAIBZDGBODBDhAAAQCBA.bCFDhACADEIB.TGEAAADALDDBhAHABFDDIHHAfFHA.CHEASGGDhBAA...hACA...,2,-8,-4,4
KbdLZOPeSEDVMAFcHgafIWNYRBCGUTQXJ,HAAAaAAA...fADBIADA...NAGA.RAEFGAGA.hAAATCCAQCABhACAKBBDdEEAZCEFeDGDEAHBMCHBhAFAAAIBFGAA.gDCABGGD.XFGAhAIA......hCDA...,1,-9,-12,3
DIaKTJRNZUgAFdVSBXWPGbEHMeCfOcQLY,dAAABAAA..XADAGACAHAEAeAGBOCAELAHB.DCABaAHFhACATDFARCFBZEAAACEBSCBDhAAA.bEDDEEEBhADAMEIBfEHA.QGGBhAEAKFGBUGAA......hBAA...,2,-10,0,10
DATQRCPIVMJdaUWeNgcYGOLFZbHSEKBfX,RAAACAAA...VAEAdACAaAEA..eAHH....gAGHhAAAGCCALDABZBDBHDFAhBCAEDHFfFCAhCAAAAAATFEAIGHAMFFBUGGANHAB.OFDD..hCBA......hCFA...,1,-7,-13,6
NMZSCPIQKTLagEdUHceOfGVXRDFBYbJAW,MAAAZAAACADB...QADALAFAECAAHAFA.eBBBGCDARCFABDDAhAHAJCFA.AEFB..SEGAhAIAKEHBaFDH.dGGAOFFBhABAfHEFDGAAFGHH.....YHAAhACA...hBAA...,2,-17,-14,3
YIBcRMTEKAbWFGVXZJUdHefQCgDPNOSLa,FAAAGAAAZACBdAFAHADA.eAFEQCGADCDBOCECLBED.hAAAaEFDBCHB.REEAEFHFhACAAAHA.bGCCXFDBhBAA.fFHA.CHBANIDBSDADhADA.....hBHA...,2,-24,-1,23
aYTMVHBAURfCOZXSEJFeQWbDIPKLcGNgd,RAAAOAAAZADB..EAFAeADA.QAGADAIBKBGBGCEAdCCAaBBH.hAAAMCFBHDAA.ACCACDHASCGDhAEAFFHB.bEDDhBAALGDA..gFGA.hABA......hADA...,2,-18,-7,11
YaUcVIFRdTNDAQKLGOfWbMgXeBSECZHJP,LAAAGAAAOADA..bADDMAHBeAFAEBFFHCAB.PBHDhABAaCDBVDFB.REBBdGHAhAAATDFAAAIB.QFABhACAKEDB.fEEE.XFCDhAFA.CCCCYFHBhAGA.IHFA,1,23,-16,39
IHEdUSYaTKLOFGcZBCPRXeMVgDAWfQNJb,QAAAJAAAHADBdAFBSACA.aAEDTCFA.LCHBhADAGAGAZCDACCCDREEBeGBAhAIAMDABDDIBAGBA.fEEAhAAAIGHA.EFGB.KGAAOHEEBHFA..hBAA......hBGA...,1,-6,-14,8
KYOBUbPJTEZNgIGCSDLeXFaMRdAVQcWfH,QAAA..fAAAHACAOAEAbADA.TBGAZAGBICBAhAAAGCDADDGBeCEBhACAaDHDRDCBAADA..cFCChAAAKDHBBEGDPFFBEFAACGGASHGA.hAFA......hBCA...,1,6,-18,24
SgQGOCZKLPHDYeRUJMFWBfacXbVAEdITN,EAAAdAAA..TADASACAGAFAZAEBLAHBHAGBeCCBRCAAMDEBhACABDAA.aDGC.bEECADFBgFAAhADA.hAAAQFFAKFHBDECBUGBBFHBEfHEBhAFAcGGC.....hADA...,2,-4,10,14
eMJQOVdHBcDYFPbXSCEKGRLNUTAIZWafg,ZAAAaAAA.eACE.MAFAQADA.dAGAHBECDAIBFBBHbCCCCBHBEDABhADARDFA.LDDA.hABATEGAAEEBfFFEhCAAOFBCBDHBPFHBKFFD......hBAA......hBFA...,1,-3,-17,14
cCNIOFRKDaEMVLPSdBAYQbeXGUWJgZTfH,QAAAeAAAGADAUADAJAFA.ZAFBHCFACAHA.OCCBRCGF.aEFCEDBAhAAALEHBdEDABFBAAAAA.hAIA.XFBATFFA.hBCANICB.IHHADDBB.MICA....hBDA......hBFA...,2,-16,2,18
LPDSWReQaGFcBYVJCKTHbEUXgNfdIMZOA,LAAASAAARADFeAFEGACABBFA..VAEAKCAAHCFCEBHFXDFChAAA.fEAAhABAdEEAZGEEADDBDFIBaDHDFEDDhAEA.JFGF.CHAA........hABA......hACA...,2,-26,2,28
QgTINWRSDOaZbcXMVLdCEKGeFJUPHYfBA,TAAA..IAAARACFDAEA.ZACA.XAFBMAHBdBFAEAHFeCABhAAA.FDEHUCCAHECBhACABCHAAAIBQFGAhCEA.NICB.ODABaCHD.bDFC.LFGBhADAKGEA.PGDA.hCFA...,1,0,-16,16
HeVMBaNJIdYbOfgQEcLDKSXPFZRCGWATU,HAAAeAAAMAEAaACA..JAFAdBDA.OAHDQBEDEBFA.LCCBhAAASCCDFCHBREEAGDFAhAAAAEEAUGGABDHDNIAB.hAIAbFBA...fFHA.DFBA.hCAA......hDAA...,2,-8,-6,2
YMNTZAadRKEGcLXIUSPbOJBHDFCfgeVQW,RAAAEAAAGADALADAUAGA..SAGHOCCBHDEBCBCD.eDABhAAAQCDAMDHBZGBEAAEAdDFAhAAAKGGD.XEGDhAIA.IHDA.......hABA......hADA...,1,-9,-19,10
gcbKDPHRGJUOfXLQZESMIBaVdANeWFCTY,eAAACAAA..TACA..gADAKAECHAGBRCAAGAFAUDEAODHDhAAALAHBEECAMCCBhAAABGBAdDDA.AEAAFEGDhABAbGEA.DEIB.fFEA....hAEA......hBHA...,2,-13,-13,0
MTaGPeNdVASHKfWIQLcJbBOREYgZUDXCF,HAAAKAAA...fADBQACCLAFBJAEABAHBEAHBZCDBXCAAhAAAFCFD.aCGDeCHBhAAAdDDAADIB..SEGHhCAAIFFAOFCBgGFGCFHAMHFA.hCBA......hCIA...,1,3,-36,39
ceAaUTYRbMEIKZOfdPDWGBJgLCXNVQHFS,aAAATAAA..RACFEAEEZACBdAFA.DAHBGAGABBECLDEAhAAACCEA..XDEAhAGAQFDAHECASCADhACAAAIBbFGDMBBBODHD.fFGEhAIA......hBIA...,1,-9,-22,13
VSdIbQBLYGKNUCJWaRDgefFcMPAOETXHZ,EAAAHAAAZACBdADA.QAFALAFAGCEAKAHBCCAD.aCBBRCDAeCCDhAAAFCGA..MECBADHATEFAhACASEDD.bGDAhAAABEHB.UFAADEIBfGAAOFEBIGHAhAFA....hEAA...,1,-3,-6,3
XZReBVSFaJODQfbYHPcENILdCMAKGgTWU,GAAATAAA.UADARACFBAEBFAFE...aAFDDAIB.QCFAhAAA..bAGDHDBBECABLDEBhAAAdDHAADDAKEEAXGGAhACAeECBSEHB.fGFAhACA.....hBAA...,2,-18,-8,10
AKNLbCHMPeEYaJRfZcFWGXTdgOQIDVBUS,LAAAHAAAeACEEAEAaAFARAGB.ZBDE..FCAAGCGAdCEA.QDEAhAAADCGBBDCAAAIBKEDDCDHA.MAIBhCAA..JEABfGGEhCCA..XFFA...hDAA......hDBA...,2,-37,-3,34
VecPWYCdQSKLNUaMGDRABZXFHfEOgJTbI,ZAAAHAAAEADEOACA.JAFBTAGA..IAHAeCABPCCBhABACCCA..dCHAQCGBhACALDGDaCEHGEDAhAFAAFFBFGHDbFFB.cGAA.SFHHhAGA.....hAAA...,1,13,-29,42
MPdDNHWcfGJaXQAYOZLTbSIBCUFVReEKg,ZAAATAAASACE.BAFAFACARAEFEAHBMAHB.dCCAHCCC.hAAAfCFBaCFDAAIBLEEAhAGAbDFA.CFHA.eFAAhABAKGGDDCIBNHCB..cFFA.....hCAA......hDAA...,1,-3,-24,21
LgZFQbCSeUKVMdHYAJPEOXGDIaTBNWRfc,EAAAGAAADADA.aADABAFARAFF.LAHBZCDFQDFB.SAHBhAAAeBCBKBEDdCGCHDBBhACAADBAODFHTFGAfHCBhBAAFEHDCGGD.MIFAPHBA...hBCA......hBDA...,2,-28,3,31
RODLQMTfUFNdAWYeECIKcbJaPGVHZSXBg,eAAAEAAAKACA..JADBGAEAHAFAZCEEBAGAREFALFAAMAIB..hAAATCCAFFEHAAHACGHAIDGAhAAA..aCCHSEAAhAEA.OEEBDCIB.QFGAhAGA.fGFEhCAA.,1,-17,-26,9
EbKXSTGAWDCceNHPFOVUMBILgdJYaZQRf,CAAAeAAAHACAOADCUAFABAHALAGB.dCCAaCAARECA...ECEBbEGBhAAA..KCHB.SDDDhAAAAAIBDFAB..cFEDhABAFDGHMEAB.gFFG..hACA......hAEA...,2,-28,-18,10
DWaKHcNSEIeRbCVLdGOTYQZgMPJAXUBFf,BAAADAAAKACAHACA.SAEEEAEE.RAGF.CAGBdCCAGCAA.TCDAhAAAZBFEMBBB.ADGAFDHDhAIAaCHDIEFAhACA.eFCBbCDDLGEAQFGA...hBAA......hCAA...,1,4,-34,38
RbZPUKHWeVBcGYDgdQCXaFETfLNOASIMJ,MAAARAAAZADBKAFAHACC.eAFEBAHBGBFA.DBBBdCCCQCCChAIAaCFA.EDHFTDFAhAAALEEBACIB.SFCAhBAAIDAA..JEEFUGGA.WHCG..hCAAcGGA.CEHA..hCFA...,1,9,-33,42
gUQNXaPOZWITeJdbKCSVfYLRAHcMDEFBG,HAAAMAAAFADDGADA.QAFAaAFA.ZCAATBFAeBHHbDFDhAAASBBB.fCHAhAIARFAAADFBEGHFBEHAhACAgDDANIAB.OEGB.IFBAhBAA.KFHB.CHHD..hADA...,1,9,-13,22
fHKdDZVePICbEMgRUYQXBLFAOaJScWTGN,aAAASAAA..TADAGACAHAFBdAEBZAGBeAHBCBFDEDFBRCCBQDAChADALEHBAAAAODGDhAFAJEDB.NEFADEIBIHFAhBIAMIAA..gGGG...hCAA......hCBA...,1,10,-22,32
YReEOSAFJgNUVfTKGMCLZBQPIbaXcWHdD,FAAAJAAA.UADA..TAEAGAGA.MCCBZAGBQCCAhADA..bDDAaCHDXFBAhAGAHEAAdEFA.RFDBEGABhAEAAAIBVFGBCGCDBGHA........hAGA......hBAA...,2,-23,-6,17
gHOeZVPIbJdTcfCYUGMFaBKESNARQXLWD,RAAALAAADADAHAECeADHZCCA...VAFA..bCGDdCAA.TCEAhABACAHBGECAFCHDaCCHEEEBAAAAhCAA..QEEBhACA.XFAAOGEE.IFHA.hCDAfGGEMIEA.hCEA...,2,-14,2,16
RaPJcgDZQfUMbYdOATEVFSLHXGCIBWeKN,EAAASAAAHACAGAFABADAKAFARCCA..aAHFJBHBDDHB..ZCCAQEAAhAAAMCGB.dEEAhAEAAAAAFDABLHBA.hADACFHAIHHAeECBcEECfGFA.hAFA.YEHB.hAFAOHAC.,1,13,-27,40
FLUEGDMTWJAeIbSOPVQdgZaNRcKHCXBYf,eAAASAAAOADCQADAZAGB.RAFAHCCABCCAFCEBLCHBhAAAEDHFGEFAMDABTDFAhABAAAAA.IGGAhADAbFAAdFEC.aEEH.KGAACHHA.fHDBDFAA.hAFA......hAGA...,2,-17,15,32
FcXGMBdSHPWKCVZfeTbQNEIJaYLDRAUOg,OAAAFAAAGACAdAEAHAGBKAEAZAGB..eBBAQCEAEDDA..hAEAaDFDLEEAAAGBUGGA.hAIAXFGAMFEBSDHHhBAACGAA.........hAGA......hBAA...,1,-11,-27,16
dTZeRKPOJADbUCaVNSfHFXEMLGcgBYWIQ,DAAACAAA..aACASABAHAEB.EAEAGBCABAGA...IAGAhAAAdCCAeAHHRCGBOCBHhAIAACFAbCDD.UEEA.fFHAhBCAMDGBLEAB.gFGHhAEA.YHEAhBAA...,2,-26,-10,16
XTIZMNfacRDeHFbdCLYSEGgJQUPKBWAOV,XAAAZAAAMACA...aADARAEAHCCC.dAHALAGBECGBGEFAhABAQBDCKEHBAEFB.TDEAhAAAIHHAfDCEhABADIDA.eCHH.bGBA.SFGAhAIA.gGFGhBGA..,1,7,-16,23
QbaFPOZHKfBCYRgeIEVDMTJNWAGScXLdU,GAAAXAAAdADAUADAaAFA...FAFEZBFAHCECBDDARDBA.eDBHEDHF.hAAAMDFB..TFEAhABANDGA.AAIB.LEHBhAAAPHCCKGHBCGBA..IHDA.DIAA.hBDASHFG.hCAA...,1,-9,-13,4
FIOKVcEdQgXDeGAbNHLSRWZaBJTfMPCYU,HAAARAAAZADBBAFATAEA.MAHBCAHA..FCFAKCAD.ECCAdCCC..QDEAhAAADCIBGDAAAAIBbEAAhACALEEA..hAAAaCHDJFDFfFGA.PGACIGGAhABAOFHD.gGEDhADA,1,18,-37,55
XSACHPVKTNceGIDaYgJRfLEWFOBbUZMQd,HAAAKAAA.TAEAeACEGAFADACA.aAHFJAHBLCCBECCA.OCEBhAAAbCFD.ZDGBdEDAADBACFAAhAFAPFHD.VGAAhAAAIHBA.RFEB.FHEAMEIB....hBDA......hBHA...,1,4,-8,12
dTCKRaHQGDOWecLgEAUPMfZYVBFNXSbJI,MAAAZAAABADBFADD...SAEHJAFA.dAGATCBARCAA.HBEBhAIAGDEAOCGDeBHHhABALFFAACAAUGBA.fGCAhBAA.NEEA.XGGACBBC.aGEHhACA......hAIA...,1,-13,-20,7
UVLYZHaAGMPNFcbOITXRQJBeDEdCKfWgS,GAAAMAAAFADDOADA..TAFARAGBQCDAeAHH.EDCBdBBAhAFAKCFB..fCEAhAHASDHHLEFAhBAAHFFAAAABNIABbGDA.IHHABHEBCHHA.WDDD.hACA......hAIA...,2,-9,-4,5
eWYECJZBcMQbOaDgUPdSKHXLRAVFNIGTf,FAAAGAAAeACHEADAZADBMAGB..QAFAaAHB.DAIBgCDAhAAAdDFAHEGBRFCAABIBIDHAhACA.TEFAhADAfHBBCECDBFBD.OFEB.SFHHhBAA...hBAA...,2,-22,-2,20
PAGBaRgFdTEJebHSOZKVIfNQWUDLYCcXM,aAAARAAAdADA..EADAeAFAHAFAZBFEKBBD...VCDAIDDA.hADAQDFADCHBLFFAhAHACDHA.MDCBAAAAGFABhAFAFGEH.TGGA.......hAIA......hBAA...,2,-17,-13,4
VGAEYfPTDZFXeNHCISWgcOdULKBMRQJba,EAAA..fAAADADAZADEFAHBeADA.HAGBSBCD.hAAA.gBCGhACAdCEALDGBMCFBRGCAbEDCGDAAhADA.AAIBTEGACGHA.IGDA.hAAAcGED...hCAA...,2,-26,4,30
aMNTCWgKcLeUHBFVIXbPdYQEAfRGSOJZD,RAAAGAAAOADAZADA.aAFAMAHB..TCDACBDA..KBFBeAHHhAAAHDDAFDCH..XEGAhAAAdDGDEEABAEFBSFDAhABADFGA.NCCAgGGBcFCDBGGAIHEAhAIA....hBIA...,2,-26,-8,18
IAeGDBYTfNcXaUEHgWQPKOMJbdFZCLVRS,eAAAGAAABADA..TADA..fAFAXAFBEAHFhAAAHAGBQCDBhACAOCCBbDEBZDFBLEGBhAAASCHHAAIBDDIBYDAFaECDgFADKFHBdFECCHFAhADA......hBAA...,2,-7,2,9
TEJSKROZcUGgCfMANHbdaVQDePBWXFLIY,HAAAaAAA.QADCeACHBAEAFAFALAGBTCEA.EBFFKBHBRDDBZEAAhAEAGDGA.CCADACCBdEHADDDBhAAAXGEA.IHHAhAIASEED.OGCC...hBAA......hBBA...,1,-6,-14,8
BNMbEDAKVRfWZOcSFdXTQGIJLeUYCaPgH,RAAAZAAAOADAFADAdAGA..QAGAGCAALCCAeBDF.CCHA.aCEDhAAAHDECMCCBDEIBACGBKDGAhABA..VECB..hABAfFFASFFAIGHA..hBIA......hCAA...,2,-25,-12,13
ZHCMNGLSAQYfVcDeBURKbgTaIdEPXFJWO,QAAAVAAA.eACARADFKAFC..bAFAaAHD..dCDA.ECFAFCFBhAAAODAAHDAAMDHBhADAGDGAADIB...fFCAhAAABEEDTGEAXFECJHBACHHA.LHAAhADA.SGHHhAGADEGB..,1,16,-18,34
dTVQSGABWfMLUXaOKHPDZgYERCNJFbIec,BAAAMAAALAEAaACAHAEBZAGBEBBA..RCDA.CBCA.FBHD..eCBBdECATEFAhAFAQDDCACDA.hAGAfDHAOEHDDFEBhAIAgFFBJHEE.bGAA...IGEAhAAA....hAGA...,2,-18,-9,9
OYGdeZJWKNFPabSfIgUcTMEHCXQLDBVRA,GAAAeAAAZADBKADAFAFD..aAFA..SAHB..fBFAhAAAIDBAUDFAhAAAMAIBHCDBQGGAhABALDCDBBCAACHBdEGANEEA.bGFA.gGDFhACAEHBADDIB.ODAHhADA...,1,-8,-14,6
DLNYKTgAOQWPZeJIMEdfbCFcHRXUSaBGV,QAAAZAAAeACEMAFAEACA..dAFA.CAHAHBDBRBEASBHBGCGALFBAhAAAKCCDADEB.OFEDhAHAPDFCfDCEhBFAFFFA.XGGAaFHD.DICA...hABA......hCAA...,1,15,-27,42
FWPBSfAYORLaIdgcJKZDQGEHNCXeMbTUV,RAAAaAAAdADA...JAFAZACB.GAEAHBEBCCCDeAGB.MAIBUCGAFDGHhAHABEEDABBBLEBAhBAA..IFGAhAAAKFFDEGHB.....NIAB.......hABA......hAIA...,2,-39,-12,27
bNYfSWcJdUGKaDTMCPQVXERgIFZeHBALO,LAAAOAAA...bADDfADA.SAEHhAGAJAFAGCAAaAGDMCFA.QDFAhABAEBBBRDDAFCHDHFFAhAIAACABYEEFdGBADGDBTGGACHFD.XFBDhACAIHHABCCC.NIAB.hAIA...,2,-10,-1,9
TcLVRPEDgJKSZFfHOXAGbBeIMYNdaWCUQ,GAAAeAAAMAEAdADAaAFAUBDA...QBFATBFALDDBhAAAREEAEDCB.DAIBKBHBZDFAFFHDhAAAHDBBACCABHEAIFFAhACA.NHDB..WHFA......hBAA......hBCA...,1,-4,-20,16
CKUcfdTOSJIVMDGHRPZNAWgeLYXaQBEbF,eAAALAAA.aADDEADA.CAFA.KAFAUCCAdAHA..OCABSAGHhAAA.JCFFMCCBHEGBhABARDDAZDGBAAIB...gGCAhABAYFFFBCHAbGFAFFAD....hACA......hAFA...,2,-20,-11,9
cYMUbPHIRLdQWJXEeFVKCBAfTDNGgOZSa,TAAAGAAAZADA.aAFAMACA.UAGAHCDARBDBLDBBdCHAQEABhAAAJDFB.EEFBeDDDhAAAKFCAAAIBDDHBOFGD.hBDASGEHcGBDPFHD....hBFA......hBGA...,2,-14,3,17
SgUYeQcTdDKfWFJaMVGXZIACNHOLBbEPR,HAAALAAAEADERAFFSADHUCAB.eAFATDDAdCAA..KBHBFBHDhAAAaCCCGEGA.ZFAAhACAAAFAOCEDBFFCgGEGhAFAQDGCfHABMFIBXGCAhABA.CGGA.....hACA...,1,11,-19,30
eOadgWRfXLYQFIHZGcDEbPKJNMUTCBVSA,eAAAdAAARADALAGBQADAHCACGAGAEDEB.KCCA.MDFBCCFCSCHHhACAAAAAaDGH..fFBAhAGAFEABZFGBDEGBPFHDhAIANIAB..........hBFA......hBGA...,2,-15,-9,6
FLDePHaTXbQdRGVIcESJYUKOZCBNMfWAg,LAAAeAAAHADAaADDTBGA..bAEDRCCBGEFA.IEHAhAAAEAGASBGAhABAUFAAZFDBBCAA.MCCBhACAAAGADIAAQDGA.dEEA.cGAAhAGAKCEACHHA.fGFAhCAA.FHGE.,2,-14,8,22
HSQVDPdBUcACbJRZXYTMeIEKLWgaONGfF,CAAARAAAZADB..TACAeAFAKBHBLAEB.aAGAGCEA.HDAAhAAAQBGCDDHBdGAABCCChABAACAAbDDC.XGCAhADAMCCBEDHFOFHDFFFBSGCA..hAAA......hACA...,2,-17,-4,13
aSTRLdGKCEVUBXYWeDcPZQIOANJbfMHFg,JAAAMAAAHADBFADD...aAFARAFAGBBA.ECGABBFB.XCFAhADAeDEBDDIBZDDAQFAChAFAAAIB.bEFDSDHHhBAAdFDA.CFFD.......hCAA......hCBA...,2,-37,-5,32
BVDAWQXZdEcKHPTIbUCOGfLSgYFaMJNeR,QAAAdAAAEADAHAFA..TACAUCCAGCGALAEBSDABhACAFAGAaBGCMDDBeDFDREEADDIBhAAAAAHAZFCAKGDAIHHAhADAOHEE....fGGB..hCAA......hCEA...,2,-11,2,13
KFICGPdcNDAMSHJfELUWRgZTBeOVbXYaQ,HAAAEAAALADARADFZAFBeAHFOAGD..XCAAaBCC.QEEAhAAAFCEDGDFAdEHADAIBhAAAAACAMDDBfEAAhAEAgFAABDHAYDDFCHFA...cFADhAFA.SFHHhCAA.,1,3,-21,24
dBfXOVSCWJFEZGegbLYQDRTPNIUKMaHAc,dAAAXAAASADA..CADAFAFAEAGAeBHFLBFADCCARCDATCDAhAAA..IDAAhACAMDABHDFAADIBBEFAODCBhABAVFGBZFFAGEABYHDAQGAChADA......hAEA...,2,-6,-5,1
SeFbGgLHQYRWOIXcPaKMVBZdETNAUfCDJ,CAAASAAAFACA.GACAHAEBRAGB.OBCBXAEA.aAHBMDDBhAAAZCFAdEAA.EEDAAAIBDDIBhAGAeEGBLEEAhCAA.QGDAIHEA.KGGABFFD..hAAA......hABA...,2,-17,-15,2
WDdJOMPKLEGgfbISHcNAZTaBRVQYFeCXU,aAAARAAAQADC.FAFAeACH.XAEADAIBdCFA.MAHBLDDBhAAAECEBGDFA.hABAbEAAHFFA.ACCBBCHDhCAACDHAJFHBOEEHKHEAIEHANIAB....hDAA......hDBA...,1,0,-20,20
VcNHYKTWeZPEafGCABRbOdUIgSMXLDJFQ,RAAAdAAAUADASADALAGBFAGA..QDDA..cBEDhACAHEGBTFBAhAAAZCBBECGAGECAAAIBBBFBIGEAhABAMDABDEEAVFFAKCCD.eHEG...hCAA......hCIA...,2,-15,-1,14
XBJVagKWLNHTYCfDMcPSUdIeRZEObGFAQ,QAAABAAAaACA.KACALAFAHAEBTAGACBCA..MCBBSCDDhAAAdCEARCGBZEDAECHFGGABhAAAADGBXEAA.hAGAgEDAYFHBDIDAPEHD.eFGDhAEA.bGAC....hAGA...,1,0,-12,12
WEMgTXdPbDZaHNRVQefACUYSGLBOJFcIK,CAAASAAAGACALAEAOACD..FAEAKBHB.ECABMAHB.TCEAhAAAdCFADDHB.HEDAhAAAREBAeCHHAAFABFHAJFFBIHHAhABAXGGC.........hACA......hAIA...,2,-23,-15,8
YdGVIJRDHaLeCSbNXTPcOMZWABUQFfEgK,QAAAEAAAKACA.GACBJAEA.HAGBeAHHbCDC...TDAAhAAAOCCAZDFEACGBFDDHfFAEhADAdEGARFEB.aEEHLHAAhAAASFCBNEIA.XGFA.MFIBhAFA.....hAHA...,1,28,-25,53
TKYAHSRDCFNcMJLWVXfPaEOQgbdUBGZIe,HAAARAAAFADA.MACALAGB..XAEAaBEE.EAHBQCCChAAAdCCAGCGAeCHHTEDAhAAAAAIBCDFD.JFCF.fGFAhAIAOEEBbGFABHHA......hCAA......hCEA...,1,-5,-14,9
RgCLMTaQKbJeANUXOFVZEfPcYGDWSHBdI,XAAAFAAAEADA......fAFAcADA.GAGAhADASAFBHCCAdECDRBCFLAHBhAAAaDGHbFEDAAIBODFBhABA.ZEGBDDIBBEDACGGA.MFIB.TGDAhBHA.....hBAA...,1,-5,-10,5
NHeGDVYfdgIacTJWAOPbRZSXFMBKECLUQ,OAAARAAAZADBFAFDKADA.LAFBUDAA.HCCBGBGADAHB....hAAAVDGBdEEAaAHF..hABATFEAACCA.SBBDhAIAMEIBEGFACFDCeFCB.fGHAhBAA......hBIA...,2,-20,-20,0
VKMYfXQWHNTOaUJgBeSGbPRCIZFcLDdEA,MAAAXAAAHACC.OAFAaADA..UAGABBBDeBCHGBFARDEAZEBAhAAALCHBdDHA.ACDBKDEDhBAAQGBATFCASFFDhBIAbGFACFGD.FGGA.....hABA......hBEA...,1,-2,-7,5
TMYWVQPNDZCXELOSaKAUHcGRFedIJfBgb,HAAARAAAeADEdADA.JAFABAGB...TBDAMBFB..VCGBQCFAhAAADCABZDDFEFFELDHBhABA.aCCHACCB.GEEAhAIAfGCA.....YFHBhAAA....hACA...,2,-26,-12,14
PNOYDcREHFKebTgVIfdaAJLUSMZQBGWXC,LAAAMAAAZABEGAEACAEA..OAFDDAGAEBGEHCAA.eAHBhABATCCAIDEA.hBAAaCGDADGASDGAhBIABEADXECCPEEBcEGDRGFA.KGFD...hCAA......hCCA...,1,-12,-17,5
TZfYSaBFPCXGcKeVEJDWNLRAUdIbOMHQg,dAAAOAAAHADA.TBGAZADBSAFA.FBBHXCAAhACAGCEAeAHHECFBDAFALEHBhAGAAAIBbDCD.MIDAQEFBhADAfGCAaEHDCHHA......hBAA......hBCA...,2,-9,-9,0
fbLQREHNcYGCTWVJBMSODaAdPXIZKUFeg,dAAAXAAAZABBFADD..eADA...bAGDRAFAHCEA.NCIA.GCDAhAAA.TDAAhABAVEFBBDDDMEHBDAIBAAFAKHCAhAIAfFCA.EFFBCHEB.SGBDhADA.....hBAA...,2,-27,4,31
SECeAULMXaZgWPFYKDBbJTfQROIdNHcVG,MAAAZAAA....gADBFADDDAFABAHA..TAGARBBBdBFAHCGBhBAAGCAAEDEBAAFALDDAhABA.aCHDPFCBhBBAbFDAJFHBQFGBOHDC.NIDB...hCAA......hCFA...,2,-19,0,19
BGcfEPUdDKZgeLHOWICSFAXQVMYNbJTaR,QAAAMAAA..bABAaACE.RAEFGAGAEAFAdBHAZCCALDAAhAAAHDFBOEEHCDFAAAIB.XFAAhAFAVEDBJFHBBFHAhAIA.fHEFDGAAKGFB.WFCH.IHHAhBAA....hCAA...,1,-5,-9,4
JMPBQKVdUXWbSFHLfeDZRCcGAITYEagNO,TAAAEAAA..aACDOACA..MAEAQAFAdBEAUBGAbCCAhAAAHECALBHBeEEERGCAhAAAGDFAACBB.gDBGhAIANEIABGGA.KFHB.WEED.SHDGhBDADIAA.CHHD...hCAA...,1,-2,-9,7
BVGUMKXIJeODdYRLCZabPgSHfAcTQNFWE,TAAAQAAA.FACEEACEGAEAKAEC.JAHBeAGF.dCCARDCBZEGBhAAAaAHD....bCDDSFFFhAGAHDGBACFBNIDBBGEAhAAAMFIBOGBC.DIDACGGD.....hCAA......hDAA...,2,-9,-9,0
EdObRacWXLUHGeMVJYDfZSgCTPFKQIABN,EAAAdAAARADA..aACD..XAGBHAEAeAHHMBIBVCDB.DCBBZABBhAEACDGD.TCEA.KDCAhBAAAAGAODHD.bEAChAAALEGBGGCBfFFBSFFFFGCAhCDABHHA.....hCGA...,1,8,-18,26
dgCAfRcDZVNTUBMSKaHOeIQbXYPGWJFEL,RAAAZAAA..TAEAMACAaAEEHAGB..eAGHbCCB....XDAAhAAAGCDAFCHDEDGBdEEAhABAAAIBDCCBUGAAKFCBQFFAhABAPFHD.WFHH......hCAA......hCBA...,1,8,-23,31
dXNfURGcDYPaHVEJeLFbWOAQIBTZgCSMK,QAAATAAA.ZACBSACBdAFA.XAEAfAHAhAAARBGFGCDADBEBaCGEHEAAhAAAEDEFeEGBbFFAAAEABAHBhCAAMEIBKFBANIDB...YFFF.PHAAhAHA.....hCCA...,1,2,-3,5
OUfRLaBebQSdAZJMEgXVIWFcNHPYCGKDT,ZAAAEAAA...XADBIADAFAFD.HBGBCAFAGAGADAIB.TCBAhAAAOCAB.RDDAaCCCeCFBhAFA.QECAhAIAAEIB.MDIBgFFAcFEANIBBKHAA..fHGFhBCABHHA..hBIA...,1,-11,-16,5
TbSIdUfKCgXeGLZDMHQaBFcANYJVPOREW,JAAAOAAA.RADA.EADE....TBGASAFBdCCAKCFDXBGDhAHAeDHFZEAA.HFFBhAEAaCCAFDDHAAGA..NEEA.PEGBhAIA...bFCA...IHHAhBAA.CEHB....hAIA...,2,-21,-17,4
cLfTgQNCZPbGIdeHFJaAMSKRWDVOBXYEU,MAAARAAADADABAFA..EADALAHB..TAFAQBDDhAAAZBBAGCEAeBGFHEDAhABAaAHDADDBKDGCOCCHXEGAhAHAUGGAfHEFCGGA.IEHAhCAA.....hBAA...,2,-26,-2,24
GXcHAJLZCMIEOSdYNQDPKUFeRVfTbaWBg,ZAAAMAAAEADEdAEA..QAFCKAGAFBBA.RCAA...TCFAaAHDBCEDhABAGDDAHDECACHALEBBhAGAODHDSFFDhACADDIBeFGB.fGGB.WHAA.hAIA......hBAA...,1,1,-24,25
TKIYedGcPDRHObSNXELFWBUVAafCgJMZQ,aAAACAAA..MACAZACBQAEAKAFA.eAHBGBCA.DAIBHCGBhAIASBEGECEBLFFAhBAABCBCACHBfGBAhBBATEEA.dGDAREGFbGDC...FHAA..hAAA......hAHA...,1,5,-28,33
WNTQSDEfdPYBLXHcOVGbMaIUZCKAJegRF,eAAARAAAFADA...TADAQAGA.ECCAdAFA.BAHAHCEAOCCBhAAAGEEBaCGDZGAAACIBJDEBhABANHEBDGCA..fEHAhAHA.LGDA....hCAA......hCBA...,2,-24,-11,13
KTdOfYcegBHJRZUNECVSFIXDWLAbaMQGP,aAAAGAAA.KADAdADAOAFA..fAFAeBFFHCGBRAGFZCCAhAFAECDBCECAFDBH..DBIBABBBMCIBhAIATFFA..gEEAhBAABGDANDAASFHHXGDCWHEAhBDA......hCAA...,2,-24,-7,17
bNdUFXLCaeDTSMJfBEHPIcgGYKRWOAQZV,ZAAAVAAAdAEA.FAGALADB..eBFHTAFAMCABBAHBHCGBhABA..ICHAhAAAGDDAREBBACFBQDFDhAFAUFGBCCCDDICA.fDCE.EFGB...hACA......hADA...,1,-8,-16,8
aBLfKGYegFDWVTQUdJSbXIANHPMcORCZE,HAAAMAAARACAEADE.aAFALAFB.GCDAeAHHDBGB.TCCAhAAAdAHAbDGDACAB..PDFBhACACBBDZFCFKGEA..FDHDhCCA.QECB.SGGAhCEAIHBA......hCFA...,1,-7,-14,7
EdcSFeYRBfNXaMULGCZAgWQKVJIOPbTDH,QAAAKAAA.JACEOACA.TAFAHAFAECDA.dCHAFBCDhAAARDEBBDCDXCECaFHBMHAAhAAAGCGA.AAHAgFCAhBIA.IFFADGEBSGGDhAHAeFHHNICB.CDGC....hCAA...,1,-7,-25,18
RZGLfSVXMNKeHgAdITYUFEWQCbcaBJOPD,dAAATAAAFADA..EAGAQACC.CAEB.aBDCOAFDRCAAGCEBhACALAHB.SCDHhAAAMEEBeFFAHEFAhBHAABIBIGAAYFDBbGFABGHADIEA....hCAA......hCHA...,1,-10,-15,5
fGeJANbOHWDCBIYSLFMcZUVdXRaPKQgET,OAAAHAAACADBBAFA..SADAMAHBZCAAdCEARAFFaAHD.QCCAhAEAEDGBGFABABBB..hAAA.bFFADDFB.LDHBhAHA.FEGB........hBAA......hCAA...,2,-26,-17,9
FBXDVLZGWMcSUJdEabgAPQTHfOYCNReIK,TAAAHAAAOACA.CAFA.RACFeAEEFAHBDCCAZBFA.GCDA.MCABhAAASCDAdDFAEDHBaFGDhACAACGBQDGAhAAA.fEEAIHAA.XFGC.hAHA......hAIA...,1,-5,-25,20
cPXJBEeWQDGVUbNSFLdRCgaOAITKZMfYH,TAAAZAAAMACA.HAEC..XACBEBHFeCCAQAEAhAAAGDEAUEGAbAGDFCCHdGDACHAAaDFChAIAAAHA.KEDA...fEHAhBGA.cGFABHHA.DGIB.NIBB.hBIA......hCAA...,2,-9,-7,2
HaYRBNMASCDTcbZPLQfOEXGegFUdJIKWV,DAAATAAAZABELAFA..QACCECCAGCEAeAEEFCGAdDAAhADAKBEAHCFC.RDDBMEIBhAAAAAGACEDD.bFGDOEGDhBAAgGEA.IHAAaGDBNEIA...hCAA......hCCA...,2,-18,9,27
bOMaBGUNKSRZeHAdWJDTYPIVCFXLgQfEc,dAAADAAA...TADAIADAFAFALCCA.QCGAhACAEAFAbBBC.aDABGBGAhAFAKEEARFGBHGCAAAIBJCEBPFFBhBAA...XGCA...fHGFhBCA.MDDBhCAA..,1,-12,-15,3
EdOfbZUDGBFacHINRAJKePYMQSWCLgXTV,eAAAMAAA.QADACADALAFA..TAFAEBBB.dAHAOCEAhAGAZCCAGDFAaCHD.IDHAhAAAADDAKDEA.SEEDhABAXFFA.fFHADFIBFHAA....hCAA......hCBA...,1,-7,-26,19
aFBfSXREANgdZTGJWPICeLHMYDVbcKQUO,dAAAGAAAJADA...IADAeAGHHCACMAFADAIB...VDEBhACAbBFAKCDA..QFCChAGAaDCCBDFAXDGDhAAAADIB.ZFBATGGACFFDYHBAOHDCSGHBhACA..hBAA...,1,-14,-18,4
fAJUQSbDKGFMdLWHXNaCeIEgTcZOBYPVR,QAAADAAAGABBdAFAHACA.aAEAeAHBEAHB...TCDAZCDBBCFAhAAAVDFAACHBSDGAhAIA.bFEAMCCBhAEAWFHHCFFDIGHA.OHCA..hAIA......hBAA...,1,-2,-20,18
UTJHRLfCQaANYXBSZEcgFMeVIOdbWKPGD,XAAAZAAAEADE.FADAeAFE..OAFDdCAAKBFAGBCADCCBUDDAhABAHCGBLDGBQEEChAAAACIBBGEASAHBhABAMEIB.IGGA.PHBA..hBHA......hCAA...,1,-9,-25,16
fFIANcQKbYSZTUMWHCRJgPLeDVGEBXdOa,QAAAKAAA.SACAZACBMAFAHBEARAEF.JCABLAGBhAAAeBHHGDFAECDBdDAAaEBDhAAAFDHD.AAIBbEFDUEDACFEADGCBhADABFHA.OHBA.IHHA.hCAA......hCGA...,2,-8,-3,5
QcTFJUELBHVNaDWZXdeYRObMKIGfASgCP,CAAAQAAAFACA.EACAHAEB.aAGAZAEBdBGARAGBMCDBGCBAAAIB..hAAASCFH.hBCA.gDDBhCAATEGALEBBBDHADEGBeEEBbFGD.fGGEhAAA.....hCBA...,2,-21,1,22
NRCSJUdPZELGgYXFKHMeWcBOfbQIDTAaV,aAAARAAACADB...UADAZAEBGAGA..XAFAHCCBeDGDBBBDhAGAOEFHQCFDhAIATGBAABIBSDBAhBAA.dEEDEGHFLFHB.FGGBMIDAhAAA......hABA...,2,-16,-13,3
QMVNBFRIOTUgPEeGWDJaYXZbSCLdKcAfH,HAAAMAAABADARADFOAFAUAFA..EBFFeBBBGCGA.DBIBaBHDZCAAhAAA.CEEALGDAhACAdDDAADGBQEGA.FFBBhAIAIHHA..TFEA.PHBChBAA.....hADA...,1,-10,-19,9
ACUXHMJbZLVGWYKcETNePQdgfIDaBFSRO,XAAAHAAAMACAZACBGAEB.KCCAEAEAeCEGdAHA...fDHAhAAAaBEESDEAhAAAAAHACEEAUFGBbDGD.LHCAhCAAVFDB...........hABA......hBHA...,2,-21,-2,19
acGLfOJeAKFETNgIPdZQBSCXUHDYbMVWR,EAAATAAA..IADAZACBQAEA.CAGAHCFCbAEDMAHBhAAARECAGFEBLCBBOCABhAAAAAGBFDDH..NIABdHFDhACAXDGA.DAIB.VFEA.aGCB..hBCA......hCAA...,2,-15,10,25
YPDNgFJKTIOSGEZRHQCVMLeAcUWaXfdBb,UAAAaAAA.dADABADA....bAEDDAFAFAGATBEA.SAGAhADAEBGBHDBAQEFAhBAAMBBBACCA.cFEChBCAfCGA.PDDBNCIA.KDHBOHFEhBDARFEACGHA.....hBAA...,1,-2,-35,33
EGVSCeZUJbRafWgIKTcHMdOLDPQXBFAYN,EAAAGAAA.CADAZAEBUADA.RAFA...aAGD..fCBAhAAA..gCGAhAAATCGAHDDAdCDCLEFAhACAQFDBFGBAABCAVGAASDADeFHB..hADA......hAIA...,1,2,-24,26
WMbAQHVENZIRcXFaSCgJLDBTKGPefOdUY,HAAAEAAAZACBRADFFAFA..aAEDCBHALCFBBAGAGCEB..eCABhAAAdCBCUEFBMCCBADDBQGAAhAAA.IHHAhAGASDHBDAIBKHCCOEEH.YFHFhACAbEBA.NIAB....hBCA...,1,-9,-12,3
LHQEKYbaXSeJCZTfWcNPFDUgMAdIBORGV,dAAAOAAARADAGAGAHADAEAGEKCBA...aBBCeCEFZCDE...TEAAhACAfCHA.NEEA.hAFADDGBUFFAAADABEHALFCBhAIAbFED.SHGACGAD..cGGAhAGA.....hBAA...,2,-17,-6,11
DUNFKAYPLIfMTXSORJeBGcaWgbEHZQdVC,LAAAMAAA.TAEAOACE.RAFFeAHHGAGA.aCAA..bBBChAFAHDCAZDDA.dEAADDIBFEFDhABAAEHB.IFHA.hAHASFDHBFDAgFFG...hACA......hAEA...,1,-11,-21,10
VODRFGNbCTZIHXYQMLBUcWfegKaJdSAPE,EAAADAAARABAGACA.CAEA.ZAEBHAFBQAGAMAIBLEABBCDCUDGAhAEA..fCBEhAAAeEEBaGCA.dDFDAGGA.OEDChAEAFGHD.bFGD........hAHA......hBCA...,1,1,-28,29
bAGeQVKRPdWMEcZYTOfFXNSJUHaBLDICg,eAAAQAAARADA.dADAEAGEZAEB..TCCAFAGDSBHHhAAAHCEBaCGALDGBCDBA.hAIAAAAAGEAAKDDDMDGBOFHDhAEAXFED.NEIABHGADGFB....hBCA......hBDA...,1,7,-22,29
AaQIDLVGRecPfEbOYWBSJgZMUTCNFKHdX,aAAAQAAALADARACA..eAFE..fAHAEBFFOCDDBBBDhAEASCGAZCDAMCIBhAFATDAAFECAHEGBAEGADEIBhAAAGGCBbFEA.YHAAJHCA.CFCD...hAHA......hBAA...,2,-7,2,9
IACdLaGHQOeVKfYEJFgUBXRDScZNTbWPM,dAAAGAAAHADAeADAKAGCEBHFFAGDBCDA.RCEF.SCAAZDGB.hAAATCEAbEAA.MDDBhACAAADAaFHDQEEBhADA.fDHAgGEBDFAANIAB.IGGAhAFA.OGCE.hACA...,1,4,-14,18
OXVFfcUNIdSRAgTLBWDaECJYQHbGKMePZ,TAAALAAA.DAEAEACECAGA...QAECHBCCGCAAeAGHZCFBhABAXCCCFCHDUGGAdDFDhAAAAAIBBDDDaDHDbFFCMFDBhACAOGAA..fFEEIHHA.SFBHhBFA...hAGA...,1,-5,-8,3
JFKWDbfMINYQcREgGLCPAeVXaSBUTHOdZ,eAAAaAAABADAHADAZAEBKAGC.DBIB..MAHB..ICCAhAAAQCCAECEAGCGAhABALDABAEEASFAAhAFATDFAdFFDFGBDbFFDfGDAYFHB...hADA......hAIA...,1,-1,-21,20
fGOPeNMATIUBCDbdVYQcaSgREZJKLFHWX,TAAABAAADACA.dAFAQACC.aAEARBCBEAHBZAGB.LDFAhAAAHBEDXDDDGEBAeEEBhAIAABIBCDHA..bFGB.hBCA.cGFDSGEAKGDB.....hBEA......hBFA...,1,-1,-22,21
TDUSAQeagcXKFIBGOMbPEJRHVCYdZfLWN,eAAAaAAA...XADAFADAGAFA.MAIBEAGAHCCA.CBHAZDFBhAAALCCBTEAASBBDhAHAADIBQGABhABAKCEDODGDbEGD.RFEBdHBBfEEADEIB.hBAA......hBDA...,1,9,-14,23
UNETeKbMIXWAJYDCSgBFcdQRfOGLVPHaZ,DAAASAAAFACD.dADARAEAGCDALAFAHCFAZCCAECFEKEAA.MCIBhAAA..XFFAhAEAAAGACDBDBEED..fHABhAFAOEGBaHCANEIAeBBDIHHAJHCA....hABA......hBDA...,1,-4,-23,19
ETCQJAFLXSZbGUdIKWHDgVeNOcMfRaBYP,LAAAZAAAGAEAdAEAKAGAHAGBDACA.eCAA.ODDAMCCBRCGBaDGEBDDAhABA..EEBATFFAhAGAQFFA.AAGBSHGAhABAIHHA.WEEDNEBA..fGEEhAIA...hACA...,1,-11,-23,12
FaUPLZfCYNBEJQVbIgXGeScTKRWOHADMd,dAAAaAAALADAZABBCADA.BAHAEAFA...QCCA.ICFAhAEAGBGAeCEBhAFATDGARDCBHGCC.AAIBMFGBhBAAFEFHfFAA.YFHBhAFA.JHAE....hAHA...,1,-16,-23,7
PWFUQaeLKRCOIVSXMbZTNdgAcYEDJGHfB,EAAAGAAAHACABADAFAFAUCCBeAEHRAGB..OAHDSCDD.hAAAMCGBZCFFdEAA.ADFBDEIBhAEAfDHAQGGChCAAaDAHLFDBCHDA.XFFC.hCBAbGAC.....hDAA...,2,-11,-3,8
fVbSYRFXPUdLgBEZAHCQOWDKTcGIMNaJe,HAAAQAAADACAKAEAGACB.MAFAaAGAeBGF..bBFARCCAFCHDhAAAXCDCdEEALFCBhCAAEDAAADGAOEEA.hCCATFGAIFHAfHBBSGFHYFFFhAAA....hADA...,2,-11,-11,0
OMPdHWVNfLeKaEcXCFBQTSYbAgRJGDIZU,RAAAGAAAZADBUAGAMADA.HAFC..VDAALCDA.eCHFhAAAEDFA.CEBAQEEAhACA.TFCAbEEAAAAADDIBhADAOEHDdGBAfFDE.aGGC.hAIA......hBAA...,2,-20,-2,18
EeDIKUdFbMfVOCNLYWRaTQPJZXHgGSAcB,EAAAeAAAKACAdAEA.MAGBOAEA..LAHBRBDA.aBCDTCGAhAAAQDECZDDAHFDAhAIAGEBAABHADCCBFEGDfFHAhCAACGHANIEB...YHFA..hCBA......hCIA...,2,-18,-8,10
AUdYEXNfQScTKPLagGBbWMODeCJVFZRIH,dAAAEAAA...XADAQACA.TAEALAGBGAGAbABDMAIBhADAeCCBCEEA.FEGHRDCAHEABhAEAAAIBUGAA.fGDAhAAAKEFAaEHDBFDADEIB.ZGCEIHHASGGDhBAA.....hAGA...,1,11,-10,21
BdOaAVbRKLJgcZeMUQXTGCEFWDIYPHNSf,RAAALAAA.JAEAZADB.eAFAMAIBQCFAGBCB.EDAADCABhABA...IDFAhACAHEEAfFCAhAAAdEHAACHBbEEC.KFHB.gGADXGGCFHAAPHDAhABANDDA.BHHD...hAHA...,1,4,-16,20
FLfAEPKXcCBZDUHNJQaWVgbMIeRGTdOYS,EAAAXAAABACAZADBHADA..QAFAaAFA..gBGAhAAAbCED.eCDBRDGBdCCChAAASCFDLGDAAAIBhBHAKDAADCIBUFFA.WDHHIHHA..hCAA......hCBA...,2,-15,-3,12
aYGHbUQfMIcPBKJLReVXFTOgWdNADSZEC,ZAAAEAAA.aACAHACA.QAFCMAFA.ICHABBEALBGBhABARCCAeDFFFEAATDDAOEGDhAAAdFDDABIBCAHB...bGCChCAA.UGGA.........hAEA......hCAA...,2,-14,-11,3
aWVZSQfFdAIBYHXTJEGDKOMeCcbURPgNL,BAAAHAAATAEAEACAGAEAOAGD.eCAACAGAUCAARDDA..PDHDhAAALCHB.aCDHZEAAhACAQEFAdFFAAAIBXGAAhADAKGAAMHDAgGDFNIAB.SHGAhAEAIHHADGDA..hAAA...,2,-21,25,46
TgOFfYcQXAEPRNDMUeLVSWHJGaBCbKdZI,RAAAMAAAeADELAEA..SAGBHBBAaAHDCCEAdCCAZDBATCFAhAAAFCGH...fDHAhABAQFAAEEBBDDIBhAFAVEDAGFEBKFHB.OHFEcGGC.AAIBNICB.hAGA......hBAA...,1,0,-4,4
SYfTUHXVAIRQONGbKWJgBdZMCacFDPeEL,RAAAQAAAGADAKAFAJACEBAHB..ZAFBMCCBaAHD...DCGAEBEFhAAALDAB.SDDDhAAATDCAHDGBhBHAADGAODHDbFEDdGGDFFED.eHEA....hABA......hADA...,2,-20,-4,16
WTEKGURfDNYMQZXcPAJCdISVBFgLeaObH,dAAASAAAFADALAGBeACH...aBDCHAEA.EBHFGCABhACARCFBDAGAMCEBZDFAXEEChAIAAAAACEAABEHAOFGD.hAEAbGBCTFEA.fGHANICB..hCAA......hCBA...,1,-2,-18,16
EUVTbegdcAMWBNRKCOJYHDFIZQPXGfLSa,MAAABAAARACAKADA..OAFAHAFBFAHFZBFE.QBBCGCAALDDAhAAAECEB.UFFAbDGDdEEDhAFAAACA..CDHADFIBIHHAhBAA..fGBA.aHDC.hCAA......hCBA...,1,-17,-21,4
abZeSAGBdKDCFEHUYLgRONPWTcJXMVQIf,dAAACAAAHACALADARAFF.OAGD..PBHDTCBA.JCFFMCABhAAA.QCCBhACA.aDFCeCHHAAHAGEAAhAEADDEBEEABUFFAgFFGNEEA.XECDhACA....hAEA...,2,-28,4,32
dHRDWTgaCKBUOYeZcJLAVFGIfSMPbEXQN,GAAASAAAMADAEADAQAGA.HCDARAFATCCAaDBDBDGAhAAAOCEDeDHHZCGBLFEBhACAAAAAFDAB.fFCAhBAAbGAAdGEADECBCGGD.KGGAcGCD...hADA......hAGA...,1,13,-9,22
YQFdJSbeXaCfBVDKHMLGcTIZRUAgEWPON,EAAAOAAA..QACAdAEASAGAeAEAaAHDBBBD.KCDDHCDChAAAGCFATDGARDBBAAGA.hBAAgEEG.hBDAPFAAFCHFbFDDfFHAMFHB.LHBAhAFA....hBHA...,1,-2,-14,12
MFGUcNYJbQLDRPaATeWXdECgZSOfKHBIV,eAAAdAAAEADAZADB.OAFCHAFABCBA.MCEBGCEAUCFBNCCA..hACA.JDAFLCHBhAAA.RGCAAAHATFFACDGBSGFHhABAKDCBFGEHYHAADDBB...aDHDhADA......hAHA...,1,-10,-15,5
NEbDYUfOZXacBCHJQMIgATLdFSPVGKWeR,dAAASAAAGADAeAFAEADA.DBIBUAGAZABB...aBDECCFAHCGBhAFAMCCBAAAALFEB.hADAFGAAKDDA.RDFFbFDDfGGAhAGAODHDBGBA.IHGAgDBAhBAA.....hBGA...,1,0,-21,21
EPUYOZXJSIBAVbaWHeTQDMKCfgGFcNRLd,aAAAHAAA.eACEQADAMAFAKBFACAFAGAGAFCCA.RCCB.ECHFUEGBhADAZDEBSEHHhAAAAAIB..bFDDTGFAhBHAfGHENIBB.........hBIA......hCAA...,2,-13,-8,5
dMYVDOZbNUGQJSHLTAceRaCKfWBXIgPEF,RAAAaAAAKADCBADA....XAFA..gAEHhADAECCAdCFAMAIBDAHBZCCA.bCFDhAIAGDGA.QEDChAAASBHHHGAAABBBeEED.fGGAhBAA.WEHB.hABA...,1,-18,-22,4
DNegLfWHMRQEJSYCVTZXGIBPAOcabFKUd,aAAAKAAAdACA.DAEAeACH.LAEAHAFCRBDF.EBHF..SCFHhAAACCEAZDDAGEGABCHAAAFAOECBhAIAFEGDUFDAfGDAhBAAMEIB.YFFF....hBBA......hCAA...,1,-13,-28,15
AELbdKJXVcWCMHgZPaFIQGYNfUSeTBROD,EAAAdAAAKADA..XACA..VAGBCAFAHAGBZABBFCEBGCCAhAAA.fCFEhADAeDCFRDFBAAFALEHBbEFA.hAFA.cFECMFFBaHGCQGGC.NIAB.hAIA......hBIA...,1,-2,-20,18
CTHKDEVSaWXGMYJIZRfPQOUBdeLNAgFbc,FAAACAAAHACAEADA...aAEAGAFA.MAIBIAHARCCA.QCAAhAAABDAAeDGHACFA.bEEDhADATCDA.DCHBSFBAhAHAXDFDZFEAOHBC....hBAA......hBFA...,2,-15,-15,0
RFcBYTAfaNPOZQSDGIdJEbLMUeXKHVWCg,aAAAOAAAZACB.DAEAdAFA..EAGAMAHB.UDEAeBBA.HBEACBBD.hAIARDDBBCHAABEA.fDGEhBAAQECASEHHhBBAGGEBJDHBbGFC.......hBAA......hBIA...,2,-23,-11,12
fJgLNSRcQXHKMUYZGODWAeEVdFbBTPCaI,EAAAdAAABADA.CAFA.aACD...JAEALAHBRBDF.QCBAhACAHCFAMCBBZBEEGEGAhAAADDABADFAFEEAbFEBIHAAhAHA..fEHASHCAKFAA.hAIAOHEA...hBCA...,1,-12,-30,18
aGKBHCeLXdZWJMFYQbOUVETfDSgcINPAR,RAAAGAAAHADBeAFAdADAZAEBMBIBQAGA.OCFDECCBTCFAhAAASDBH.IDHAhAAAAAFAaDABCEEALFGBhABAXFFAFDDHYHCA.....hACA......hBAA...,1,3,-15,18
DJWILHAPZfGNMEdKRFTSagbCOUecVQXBY,ZAAAGAAAEADE.RADAFAGA..aAFACCDD.UBGB..eCEHQCAAhABABCGADCIBJCDBLEAAhAAAHDGBACFB...fEGAhACAdEFCSGHHbGCA......hACA......hAIA...,1,-15,-21,6
WDARcSeBgLJIZVXfGbQPNFUEdKaHCTYOM,RAAAeAAALADBZADB..XAFAGAFAQEECFCFB.EAHBhAAAaBHDHFAATDBAMCCBhABAAAAABBCAIDHAbEEAUGAAhAGAdFHACGGC...OFHDDIAA.SGEAhAIA....hCAA...,1,7,-11,18
DSGfEdIUOWFJeNMVZcPRQLTYbaCgHKBXA,GAAAEAAAdADA.OADAFAFA.eAGFMAIBZCDBRBEF.LCHB.TFEAhAAAaBCBHCGBBDCAADDBSEEDhAAAIGHA.hACAUGGANIAB...cGDC....hCAA......hCBA...,1,-7,-18,11
NLYbTQISCBKfOZdAHEFRUaPVWeDXcGJgM,HAAARAAAUADAaACA...VAFAeAFA.DBIBGCCA.MCFBLCGBhAAATEGAQDDAhABACCHAKFAAZGDEACCBEFHF.FGAAhAGA.XGDA.......hAAA......hAFA...,1,-9,-16,7
KCHgRMIXVBJNdOeabYGEULZPDTSAQWfFc,QAAAFAAACADA.HACARAEF.MAEA.XAGABAGBdCCAeCDAhAAAaAHDGCFAECGFZECATEGAhCAAADAA...fGGEhCEAKEDAIFHA.JHDA....hADA......hBAA...,1,11,-40,51
NGdLYIaDMCWZcAVRFSKQHeXOJbTEPgUfB,RAAAKAAAHADBeACEOAFA..TAGAEBFEUDAABBCAdDDDLCEBhAAAaBHD.MCGBZEFBAAAASCHHhAFAQGDAbFGDhAGAfHGF..YDDD.hADACHDA......hCAA...,1,-6,-13,7
eKRdHPaDBbgATfLVYCJXUQSIMGNOcWFEZ,TAAALAAA.CAEAUAGAQACC.MAEAGCAA.OCCAhABAFAHDEBEAeDDARCEAHEEChAAAaDGDBFFDADDBfFHAhCAAVGBA.YHEA..SFHHhACA.NIEB....hDAA...,1,-7,-9,2
FCEBMVRSgAfcTONaLWJDeHGZdQXUKPbYI,TAAAaAAALADA.DAHBHACB.dAEBQCCAKAHB..hAEAbBEDFCEEECABMAIBRCGBAEDBOFFBhAAAJDGBeEHHXGCAhACAPFAA.CGHASHAGfFEAWBBDhAFA......hBAA...,1,3,-23,26
ARCJTYgeBaPKDbcVfFNQMWdOGZLSUXIHE,RAAATAAAeADEBAGB..aACADAIB..bAED..VBDBFAGAMBDBhAAAdCGAZEFALCGBhBGA.XECAHGDAAAAACGGBhCAAgFFG.......hCCA......hDAA...,2,-27,-8,19
SGLOWcEYUaJIPDXRBCgVdAHQNFfTZebKM,HAAAQAAAFADAZAFBeACAMAIBGAFA.LAHBOCABECCAhAAAaCDBJDABDBHBBDED.hAAACEFA.dEEAAEHA.TFBAhADASFCAcGFBIFHA...XGGChACA...hBFA...,2,-18,-6,12
AVQRKEUTSGPWBcbOdFDZICNMageLHXfJY,RAAAEAAAUADAGACABAFAOAEA..dAHAZBEFCCCD.aAHDLDEAhAAA.HFDAfCBEhAAAACGB.QDGChBCASDHHcEECDGHBIHBAMFIBeGCE.hABAYHBA..hBHA...,2,-29,-7,22
eGVYLRTOUfKcMbXWQFPCZdHSJEBNagIDA,eAAAGAAALAEARADAOAGDKBCA..MAIBXBGA.QCEDhAAACCDDHCEBEEABaDDHDEHBhAAAAAFA.TGDAUFFAfDHEhABA..cGAC.FGGH.hAIA......hCAA...,2,-21,-5,16
AEWLDBPgGKJHOQRIUacVFeSXZCNTMYdbf,EAAALAAABACAGADAHADBRAFAUCAA..aAFAFCGDeAHHZEEACFAAMBGBhAAA.dEFDAAFADCIBKCCDQFBAhBFA.hABAIGGASFDDTFDAfGGEhACA..WFHH..hCAA...,1,-15,-20,5
ZGRUBQOJLgSFYKMdacDEVNTbPIeCHWAfX,ZAAARAAAQADCLADBFAFAKAFC.dCAA.DAIBEAHF....TCFAhABAbCCA..eCGBHEEAhACAAAAAGEFAOCCHSEHBhBFAaFHDNEEA.CFCAXGGC.BHCAhCFA.....hCAA...,1,-6,-15,9
bZGWaCUEJIQTFVLfPKRcASBMDHdgeNOYX,MAAAHAAAeACE.OAFAbABA.GBEBaAFA.ECCBQBFChAIAFDFHLDHBKCCAABIBDEEBdDHAhBAAgGGGXEEAZFCAhCAACHEA.IGHA......hCBA......hCCA...,2,-13,1,14
BJQYRFeEUZbTcaLNWMGDOIKdXAPfCSgVH,CAAASAAAHACABAFBQADARAGF.EAFAZCAA.TCEALBHBhAAAMCIBGCCA.hAAAOCFDdEAAAECBfEEEhACAgDADVFGBFEGB.eFDH...hAEA......hAIA...,2,-20,8,28
AJGMPecYDdgZCEIVKfNaBWHUSbQOFTRXL,GAAAeAAADAEAZADA.EAGEKAGA...aBCDHCDA.bCGDQBEChAAATFAA.RCGBACIBMEFBhAAA..PECAdFCACDCDfGGAhACABFFASFHH.XGEChABA.....hAEA...,1,-3,-19,16
DUSQWNOYIbcFHJVTgGCZLedMEBRafPXKA,SAAAQAAAOACC..bACDHAFB.TCDAGAEAhAAAZDFEeAGBEAHBREAAaAHFXFGAhAAAAAEBDDGBUFFBYHDAhAEA..........hAFA......hAIA...,2,-23,0,23
UdLZSXTNFcaIMEKebVAQfRDYgOHPGBJCW,RAAADAAAOADAHABCGAEABAGA.CAGA.dCCAZCGB..SAHHhAAA..TEAAFBEHaCFDhABAECCBKDHBeEDF.AAIBQGABhAEAfEEEPFHBUGEANDIA.MHDAhCAA......hDAA...,2,-30,3,33
WPaQbMRedJUILfZNGETXYBgFSAcVKOCHD,KAAAHAAADACAaACA.MAFARADA..eAGHdBFAUCCALCCAZBGBEEFB.hAAA.TDGABEHASFCAhAAAAAIBOEEBCFGD..hCAAQGAAIGHANICB....YFHBhAGA....hCAA...,2,-30,-7,23
TfWQbVGaHNUJPRXKdEcYOBFMDSAgeILZC,eAAAZAAACADB...TADAQAFAGAFAHCAAUDCARCEB.dBHAECHFOEEDhAAAFECA.DEHBAAIBLFABhABA.bFGBaFABhABA.PHACKGDA.BGGD.MEIB..hAFA......hAHA...,2,-9,-5,4
ARGMNHSWLPEQeadbYDBJUIKcfgOVZTXFC,RAAAGAAAHADBLAFAEADAeAFA.dCGADBIBBCCDUCDAKDAA....hAAAfCFFODEDZGAAhABATDGACEHAACIB.MDABhAAASGDBQFFCbGFA.IHHA.hADAgGAA.hAGA...,2,-13,0,13
TdNCLRKQZgEJMPBcIFWHXAaUDbeYfSVOG,aAAADAAAeABA..SACHGAEAdAGBLAEARBGFZCCF.EBHFMDIBhBAABCDAFEBBHCEBAEGB.hBEAbEGD...fFAAhAFATGGAKFFDQGCA...hCAA......hCBA...,1,-9,-16,7
SJDCIONAELYVPBgXFeGRZWTHdaUKQbfcM,EAAALAAA.VAEABACA.FAEARCAAZCEAHAGB.aBCEQEABhABA..bCEDMAIBhACADDDBODHDAEEA.gGDAhAAAeEFFTGGAdGGA.fHABhAEA.SHCEhAHACDGD...,2,-13,-12,1
IaKACQbPSRMeUZLBDgJVdFcTHYNWOXGEf,QAAASAAARACFeACAZAEB.LAGBBAGADAIBVCDB.dDAATCGAhAAAHEGB..YDCFhAAAOEAAEEEA.aEGEhABAAAIBbGBAUGCAFGFH....cGGA.hADA......hBFA...,1,5,-13,18
LWTUgYIEXQPaHVfJMRZBDOKcdbGFNSACe,eAAATAAAUAEA....IADAEAGAQBCAHAEBfAGBhAAARCFAZEEAOFHDdCADGCGAhACASGGDACIBLDDBhAIA.gFEH.XGBChBGA.aGHDMIBAhAAA.BHEB.,2,-11,12,23
PVQfBXIMOeKSbFCJRGWZHaAUYLDNgcTEd,LAAADAAA..NADA.TAEA.EAGEdAEA.QAGAhAGABCAAMCCBeBBBSCGAhABAbCFD.CDDAREABZEBAHEFAhACAADHAUGGAgFDB......hAEA......hAIA...,1,-12,-23,11
fBcVeOYHUdQTKJIXWMZgRLPAbECFDaGSN,EAAADAAAGABB..fACABAFBeAGHHADBdCCDKCHBXAFAhAAAZEAALEEAAAFAFCFDaBHDhAIA.SDDDhCAAVGEA.OEGD.YFFF...hAEA......hAIA...,1,-2,-26,24
ZUHGcBVMgCLJWYFQdTIeNAOfabKDPERSX,aAAADAAARABAZACBHAEB.GBGABAEAMAGBLDCB..JAHBFEAAdCEAhAHAeEEBABBB.OEGHhAEAKDHB.EGABSEDDhBAA.UFFA........hCAA......hCCA...,2,-34,-8,26
NKDcdVGFEbBYCLHaRfASQIMXgOeJPWUTZ,QAAAMAAA.OACCeACAJAFB.UCCAZAFBDAIB.dCDAGBGAhAHAECHBBEAALEFBhAIAHEFARFAAABBBSEHHhBAA.IHHAPFEB.NIBB.KGHB.FHBEhAAA.CHGD.....hAEA...,1,-5,-13,8
BVMDTPeHAdWOSgKFCIEQUJXGRbaLcYfNZ,dAAASAAAFADA.EADAQAGA.UCCAGAFARCFBLDBDhACAfAHEZFCBMEIBhAGATCCA.HDABAFFBOHFChBAACDHAXEEC.aFDH.cFGBBGGB.hBCADGIB.....hBDA...,2,-12,-1,11
FDKSCMUPaIZfWdJNREHQXVgBcAYObLTeG,OAAATAAA.GADAKACC.MAFAUAFA..aBBHZBDB.dBHARBFFHDGBhBAAQDFCXDBAhBDABCCAABHALFBAhBFAeEHFSFEDCFFDfGHANIAB.....hAAA......hAIA...,1,8,-23,31
EHPWLKSaIVMYfQBJRGNFgeOAUdTbZDXCc,dAAAZAAACADBHADALAFAaAFA..MAIBQCAARCAAGCEAFCDDeCGBhACAAAGAUCFADEDB..EFHFKCHBhABA..SGFHhADAVFDABGHAJHCEOHFC......hACA......hCAA...,1,5,-17,22
dUJbITPOMAHZSCNWagGKLFYDfQEXcBRVe,HAAAZAAACADB.aACAGAEALAFADAGA...ECCABBGBRCEAdCHAUCAAJEEF.hAAA....bDDDTGAAhAGA.MFIBABIBSDFHhABAgFCDFDHBfGGAQGGAhACA......hDAA...,1,7,-29,36
XJIYSOTWDKFgPRBaGAVcCeUQdfHZNELbM,CAAAeAAAdACAHAEAEADALAGB..bCBAMAIB..JBHBSBDAhAAAOCFD.TDDAhABAKEAAFEHDREGBGGBBhBGAAAGAUFDA.fFFE.NCCA.XGGChAAA......hAEA...,2,-22,7,29
KFecDaVRNUPbJHMBZQgdfOLEICYTGAWXS,SAAAeAAADAEARAFA.UADA..JBCBHAFAZCFA.dCHALEBAhAAAECCBCDBDGDFAACHA.KEDBaEGBhABA....PFHDhAAAbFEDBGHA..fHAB.OHDChABA....hAHA...,1,-13,-26,13
gNJdeSEVLFZUYQDbTMXKCaRAcIPHBWOfG,..IAAAHAAAOACAGACAJAFB.eAHBEAEALAHBZCCB.hAAAQCACbCGD.hAIAMBGBCEEAACCBBGDAfCEAhACAdGGASGEHFEFHDEHBKGHB.REAAPHBAhAEA.....hCAA...,1,13,-17,30
MKLOgXUcSEDHBWYZTPNGQbJICfFdaRVeA,MAAALAAA.XADDSACA.HAEBBAFAZAGBTBGAhABAGCCAQCAAhACAbEFACBBDdGAARGEAAAHAODDA.hAGAgDGA.EEEBDEFAPFAA.hBAAIGGAaHGE..hAFA...,1,4,-19,23
QJCeEFKcdUbafOPXSVRHIWLBNAYDGMTgZ,GAAAMAAAZABEQADA.eAFAEAFAKAHBdCGAaCDCOCCASDADhAAAHCFALEEAhAFAABIBTEEACFHAFGGHUGAAfHCBhBAAXGDCIGGA.NEIA.DDDBhCAA......hCHA...,1,12,-17,29
AIaOEVZbXfdWHGUYKQeSDLTBFgNMCcPJR,aAAAEAAAZACB..XACDdAFAHBGB.GDEAKAEAeAGHLCBDhAAATDDAFEHD.MEDBCCHAJEAAhAEAAAHA..IHHAhBCAOEGBbFCA...fGAA.YEHBhAGADCEBNIBB...hBEA...,2,-10,-5,5
EceNVJWUMYASTfdDLZGQXOgKICBRPFbaH,TAAAdAAAZABBGADA.QAFAOACAKAFABAHARCCAFBHDHDEBhAFAEDBB.eCHF.JFHBMCGBhAAAADDBDGDBLEEBhAHA.XEGDCGED.aFCD.NIAB....hBAA......hBDA...,1,-6,-12,6
MKNbUVJfFZPTOYGQWcDBeSIaARXLgEHCd,RAAALAAAHADBdAFBMAEAKBGD.UBEA..VDAAFAHDZCAA.ODFEhABAGDGA.QEEAhAAADCCAeEEB.aFDHAFIBEGCAhACANAIA.....fGGA..hCBA......hCGA...,1,-6,-23,17
JWDcACUbBXLHeREVIMOYKGFSZgNQaPTfd,CAAABAAAHACAEACA..MAEAKAEAGAGAZBEEQCAA.aBHDTCAAhAAA.dCCADDDBAAIBXDFDhACAREEAOEHDSGBAhAAAPEDD.fGGEcFGDbGAC.hACA......hAIA...,2,-17,-13,4
THYLXAQECNFMWgfaBeJbGcKPOSDURVZId,EAAAFAAAMADA..fACAeAFAGBCAKAEA.OBHDDAGARBFAZCDFhAAAdCEAHEBBLDFAAEBBQEFAhBAACEAA.gGDAhBEAaFGABGGAJHDAPHFC....hCAA......hCBA...,2,-19,1,20
KMNZHSFgRePOEdYQLBWDAXIVbaGfJcTCU,XAAAVAAA.GADAJADA...TAFAKAGCZBFEHCFCFCDB.RDAAeEFBhAAA.EEHFdDGALFAAhABADDIBAEEA.aAHFCFFD.hAAA............hCAA......hDAA...,1,12,-46,58
AMaPZNTcJLGKCeEYHdIDbBXSFWOfURQgV,aAAAZAAA..TAEALADAGAGAeAGHHCAAdCCADAIBBCEDFDFHfDFAhABAREAB.QEABhACAAAEAMDHB.cEGDhADACEDAEGGB...bGAASBBDOEEH..hBAA......hCAA...,2,-24,14,38
DCYcWSgOLQAdaJBePEKNXTGbRfIVUFMZH,aAAAeAAA.EADAKADA....TAFARAFFVCCAMAIB.HCCACAHB.hADA..cCFDSCGHhAFALEEAABBBdFEABECDhAAAXEGAfFHAFGGBDICAYHAAhABA......hAHA...,2,-25,-7,18
ZNCgQLaPJDHFGEMbKOATdRXWYSeIUfcVB,RAAAXAAA..SADBeADAUBGAVAFAZCDB..CDAALDCDhAAAaCCBDCFB.HEGBECHFMDDBhAAAbFED..AADAdHABhABAIFAA.BEED.QEGBhABA.FGDD.KGGD..hAFA...,2,-20,-1,19
PEBQAIYNafJbVKdORWTXZgHeCLUSMGDcF,..IAAAaAAA..bACDdACA.RAEA.TAEAZCBAHCFA.eEAAhAEALAGBMEFBGEGAhAFAFDEDEDHFAAIB..fHABhAHAKBBDXEAACHCBDAIBBFGD.QGCAhAEA.YFHBhBAA..,2,-8,-2,6
KdDCBabgLIVTJeZQROMEcHWPUSfXYNAGF,GAAAdAAABADAaADALAFA..TAGAeCAARCEAECDAHECAUCGBhAAASCHB.hACAXEGCADCBDDFBbEBAIGAAhACAZFGBMGAAPHEAfGFA.NIAB.hAGA......hAIA...,1,-9,-10,1
BfYgZCOKFWDVIGPceUdTXJLAaNEQHRbMS,EAAAHAAARACA.MACABAFB....fAFAZAGBKCCDDBIBGAGAhAAA.eBDFdCFCTECAhAAALDFB.AAIBaDHDQEGAhADAbEDDSGHBCFFD.WCCDIHHAhCAA.....hCAA...,2,-26,-3,23
MgYPeFdVAXZUGcKLDIQSCaEbNBHTOJRWf,ZAAAGAAALADBQADAaAFA.EAFABBFAHBGBOAHDRDCAMDAB.hABA..gEGAhAAAeCABdDFAACCBXFDAhACAKDHDSEEDCGCDNIAB.TFBAfGHAFFHD.hACA......hBFA...,2,-19,22,41
DMPIcNYKWQfSEXaRVAeJFbBGOZTLgCHdU,eAAAFAAAGACAZADBLAGBHAEAdAHADAIBMCGB....IBFAhAAANDFA.KDBAQEAAhAEAEDFBREGF.ADHAbEGDhAGAOEEBCEDA..........hABA......hBDA...,2,-29,-8,21
SKOBgDXFeGUbcYVEAHRTWLMCZJdPNQaIf,HAAARAAALADBZADBdAGAQAFAaBFB..SBHHBAHAXCEDhAAAeCAAGDEBhAAAUDGA.bFFAVFAAAACAMIAAhAIACCCCJFFF..IHFA.....hABA......hAFA...,1,7,-18,25
ObdXUMVBaZIDJEeTNLRCWYPAKgHcGQFfS,HAAAGAAAQADCSADAdAFAMAGBaAHBZCAADAHB..ECDAeBHHhAAATDEARDFBCEDA..PFHDhACAAAABKCHBFDCH.bEGDXFDAhCCABEAD..NIAB.......hACA......hADA...,1,7,-13,20
MORDTdYCbUJNHPagFVcWBIEZAGXLeQfKS,GAAAeAAAQADASADARAFA.dAGACCCAUDEAHCDAaBHD.FDCHVFGBhAAABEADZGAAAAABLEFAhACAMCIB.TGBAhADA.bGEA..........hAEA......hAIA...,1,1,-17,18
ISXKROJYUCWZVNEBHPGTdaQbALcefDMFg,eAAAMAAAFADD..SADARAFA.OAFDUCFBZBBFEAHBHCCAhAAAGDDAaCGDAAFALFGBhAIADDIBXEAA.KEEAhABA.CFGA.NCIA.BGHA.......hBAA......hCAA...,1,-9,-26,17
JASbWcDYGeBILHRdXONKCUQMEZVPaFgTf,SAAA..bAAADADAeAEALAGBHBFCRCAAdBDAOCEBhAAACBFAMAIBEDFFZDCA.aEFDTEGAhABA.AAEAcGGChACABEHAXFBA.KGHB.....hAIA......hBIA...,2,-25,-10,15
ANIBTMcEQHaOPCXZSRgFJbLVKDfUYdeWG,BAAAMAAA.EACAHACC.aAFACAEAZAFB.RCAA.FBBHLBHBDAIBUCFAdCEChAAAeDCAGEFAADHA..hACATFFAOFHDSFHBhBAAJHCA.bGBA.......hAIA......hCAA...,2,-18,-8,10
YKGfTdOQWXeBHRVZUCagEPbDNSJcAMFLI,MAAALAAAKADAGAFAdAEAQAGA.eCAAHBBARCEAZEBAaAHFEDDAhAFADDIB...SDGHhBAAACAAFFFA.fFEAhBBATGAAXGEDBFHACGGDPHBC.hABA......hACA...,1,-7,-12,5
TVcKQbZCdXFGEODPIHRMSNAWBUYJgLfea,BAAAUAAA.JACALADA.eAGHaAFA...TCDAKBCDZBFEdDHAhAEAGDDAEDCB.DDGAHEFBhAFARFGB.MFCBADDB.YFEFhAIA..fGBA..hAAA......hAIA...,2,-44,0,44
VfbHeRFNUTZAXDaJcEIgCOLYKSQGBWdPM,aAAAEAAA..CACA.LADAKAEA.GAGAdAGAMAIBVCCA.HDFBRCCAFDFDhAAATEAA.AAEADBBBhAIAIEAAOEHDQFCAhAEABFCAfFEEeEGH.NIBB....hCAA......hCBA...,1,10,-29,39
fAHMTLcRSGDNeKVCXdZQgUYOPIBJaFEWb,HAAAMAAALAEARADFGAFAeAHBCBBA.ZCAAQCDAUEFB.OAHDhAFABFAAaFDBECGB.fGGEhAAAABDBTEFADEIBhAGAKHDA.dFDA..........hBAA......hBBA...,1,-2,-21,19
RDTfgEdIaOYWJQMbcSBVLHCPGAeKXNUFZ,eAAAXAAAFADDRAFADADA.....TAFAECCBaCED..OAHDhAAAJCGB.MBDB.bCDDhABABEHA.HFAAGDGAhAHAAAAAKFFDZEBFdGHAIGEA....hBEA......hCAA...,2,-22,-16,6
OVZePXKaEdDIFAfNbRHQTYMCgWBJGcSLU,...bAAAHAAA.TAEAMAEA.CAGBBBHAGBDALCAAOAHDeBFBhAAAKCEDECGBdCAAFEAAABGARDGFhABAQEFC.hACA.gGGAJFHB.SCCDhDAA......hEFA...,2,-14,-7,7
TGfMHSOgIdXQBWeJUYaCFPNLVERKbcZDA,GAAAHAAAOACAdADAQAFAeAFAUCCAaBHDFBHD.LCFBhAAARCDAKEFAZFAAADFB..MEHBSDBHhAAAXGAABEHBhACA.JFEF.CGGANIAB........hAFA......hAIA...,1,-6,-12,6
gXCPJIHQZdVecGBYWMbEaOUDNAfRSTLFK,RAAATAAALADB.KAFACACB....IAEAHCEBdAHA.eCCDhAAAGAFABCGDMAIBEDHFaFAAhABADCCAAAHB.FDDAXFGAhAFAQEGA.cFFC...YHDAhAAA...hCAA...,1,-17,-19,2
VGMEDaUYNSJHZRLdgQcXPIWTBfFOeACbK,KAAAGAAAEACE.aADAUAEA..SAFHHAGDRCCBdDGDQCDChAAA.XBGDhACAIFEATEBAFFHBAGGB.bEFAhAHAMIAADAIBJFEF.gGGB..hBAA......hBCA...,2,-24,-1,23
MYTXbCIHcPJaGeDgBELAQROSdFZfVKUNW,RAAAdAAAZADBKADAUAGA..MAFA..TDAACBFAHBGB..JCFFeCAAhACA.BCEDAAAAQFBAhADAFDDH..fEGEhADAVFGB.YFEBIHEAaGGCDDIBhBFA.EEEB....hBGA...,1,-23,-25,2
UWgENPJeGFBfMZXSdQcYRAbCDHIaVOKLT,DAAAHAAA.aACAKACALAFAUAEA..EAGAPCCA..eBBBhBAAGCFABBHAZFDBdDDAQGAAhAAARDGB.AAGAbFGDhCAACFEAOGFC..WCHBNIDB....hDAA......hDBA...,2,-34,1,35
QHWgPcFUbYDdCSVNAeRLTGZKaOMEIJfBX,RAAAGAAAZADBKAFAaADA...EAGAJBHBBBHA.HCDA...gDFAhAAAFCFBUDAADEEBhAAAdFCASEHHhACAAAHA.eHFATFFAIGAA....hAGA......hBAA...,2,-47,-8,39
WVSDeHcUObXdMBAgCPQYaZGKNTJEIRFLf,CAAAQAAAZACAGAGAKACA...JAEARCCALDAB.VEEAhAAAeAHH.HCDA.ODCBhAAAdGDAAAEA.gDGAhAHAaFHDEGBF.fFEASHGGDFIB.bFCDhCAA.BGGA...hADA...,2,-18,-2,16
JSBCdgeUaFNXAYDbOLVfPTQWcIKREMGZH,DAAALAAA.VAEATACA..QCAAIAFAEAHBZCDAHDGBhABABBBD.dAHAeCDAhAEAaEACXECDACHB.hAIAbEEDfDFA.cDGDMIDA.GECAhBAACHHA.FFHD..hCAA...,2,-29,12,41
MHbLZUBdQNCcXFYfeaDVSGITAEJWKORPg,EAAAKAAARACF..MADAHAEBZAEEdAGB..QCBACBHDFCAB.eAHHhAAAaDEC.SCFBhBCAGDGAADIB.ODDD.bFEDhBDALGDABDHAXGGADGIBTEAA..hAAA......hACA...,1,-1,-19,18
CKfbOBAdQUSLeIPaEGZMYWDRNHcTFXgVJ,dAAAQAAALADAeACAaAGD.ZAFB.MAIBDAIBHCAC.TDEAhACAXCDB.gDAAhAAACDGBKEAAODHDABHBSDDDhADAEEDB.GDGARGFA.FFBD.fFEAhBFA..hCAA...,2,-9,-9,0
FgMcYeGWfRZKXPJALVdTICUNEbQOBSDHa,dAAATAAACADA..EAFAQACC.SAEBHBFCaCAEMCEBhACAeAGBGCDARDFBZDAEKDHBhADAXDFDAAIB.LEHBhAAAIGHAbGCADFDBFHAC..gFAAhAFA...YFFFhBAA,1,-6,-8,2
WGfPMOBJIEVSTLbCKQZcUAgXYFeDNaHRd,XAAAeAAADAEAHAFCRADA.GBCAMAHBBCDDEBEB...TDAAhAAAbCFDKCHBZCFF.AADAFDEDhABAdEECfFHAhAAA.OHECIGAA.LEHB.hABACGGC......hAIA...,2,-16,-6,10
RdTCELPgcHXZBfMSYbIUNDJeWVOFQKaAG,RAAAdAAAEADELADA....gAFBHAGBZCAEMCEBSAHBhAAAbDED.ICCAhABADDGBeDHFOCEBQEAAhACAADGAGEGACFCB.XFCCfGHAYFEBhCAANIAB....hCFA...,2,-17,4,21
MBQVGHgCeLKfPScEdJYTZabRFXOUDANIW,..IAAAMAAAQADAHACA.eAFALAFBKBBA.SAHBhACAEBHFdDDA.TDDAhAEAbCFDRGAA.OBHHADIBBFHAhAGAGGEBCGGD.fECE.cEGChCAAYHEA...hCBA...,2,-20,-10,10
gXOdDQFHYMAeNEJfGLUZKbaVTWRISPcCB,EAAAGAAAZACB.aADA..TAEARAFF..SAHBCAGBBBHAOCBHhAAAdCDAQDFBhAAAHCFAADEBeECFfEBAhACALEFAbFFAIGGA..PHCA.hAIA......hBCA...,2,-15,0,15
TRgHbGXJQEVUYMOLSWfcCAKNDIFeaZPdB,DAAAeAAAZABEdAEARAEF.HAGBGAGAQBCA.EDEAUDAA.MDDBhADALEGB.fFFAhAAAAAIBKEEAFEHDaGAAhAGATGAA..XGDA....hBAA......hCAA...,2,-25,-4,21
WGceSMEPQAYVIDRXBCUgZbJLdNTHaOFfK,VAAARAAACADB..ZAEBLADB.dAFAHAGBFAHB.KCCBGDEAeDFFEDHFhAAAACIBDDCBBECD.UGBAhABAJDHF...aFHDfFBEhAAA.SGDBMEEBQGFAhAIAXGGC...hBGA...,2,-18,-12,6
BATNYfCKMegZcOLWIGJPHUaSdDEVXQFRb,TAAA..fAAAMACAZADELAHBGADAHAFAUCCBdBCChAAAEBGFQCGAhACA.RDABAAHACDFDeEFAODEDhADAIFCAaEGCDFABFGGABFHANIDB.KGGD...hAFA......hCBA...,2,-12,5,17
CJQNFGgRTEAeSUBZMIOabfXHPLDWdKVYc,eAAABAAAZACAMAEAOAEA..aAGE.XBCAHBGBLCCBhAAAdCFAKCHB.VEEACDBAQEGDhAAAGGCBRDAFAAIBSDDDhABAIHHA.bFBC.DFFB...YHCAhBDA....hBFA...,2,-16,-8,8
VfMWCeZEdTLPgBAYUKQFbIGcRNaXHOSJD,KAAAQAAAFACAGAEARACA..aAFAHAGDOAHDDCCBMCIB.eDCHhAAAEBFFdDAALEEAhAGABCDAADGAUGDAIEEAhAAAXGGASEGA.fGEAhADA.CGGA.....hCAA...,1,-4,-23,19
RgKVfdcTYXFZNOEWGLQHIJUeBMSCADabP,aAAARAAAKADC..dADA..TAFAFAFAZBFA.EBBBGCCA.HCFChAAAIDDAeEFBMEIBhABAAAIBDDBB...bFGDPDFBhBAAfGEA.YFCFODHBLGDAhBDA....hCAA...,2,-29,5,34
YKaVZJPTRFMHbDUAeGWOLQIcNfSgCBdEX,eAAAGAAALAEAQADA..ICCAfAFFCBHAECEAKAHBhAAAZDBATCFA.RDCAHEFChACAbDFAAAAA.ODAHhADASFAAdGGDaHCAPFFB.MIAA.DGIBhAFA.WGAA...hBAA...,2,-7,8,15
gQKOGUNFACcEJedMLHIPTbaYWfXRVBZSD,EAAAeAAAdADAHADA.TBGAaAFA....fBFARCCBZEFADAFAQFCBhAAAGCBAFBHDABCAhAAACCEAMHEALDDB.hABAbDFD...YEHH...WFBDhAIA.BHHDSHGAhAIA.,1,-2,-13,11
PFSBaXDdWUfeKHMVTIbgJAECZQGcLORNY,EAAAZAAAGAEALADARAGB.....PAHBBADBaCAAdCBAUDDAhAAAeDDBHDFBMCGBTFAAhAEAbGAA..AAIBCEHBQFGAhAFA.OHECFGHBDGAA....hABA......hACA...,1,-4,-10,6
MUIWDRBeHcVPOaECbGfQKYAJTSXdLNZFg,TAAAdAAAZABBMAEA..IADARBEAHDBC...VAFAaBHDEDGBhAIAGCABKEFD.ACFBXCGAhAAALFBAFFHDUEEABHBAhBAAeECF.OEHB.bFAD....hACA......hAFA...,1,-4,-6,2
WMYUfSgRFEeXGaIZLDVcHKdbNCOTJPQBA,MAAAUAAA..SADARACAEAFE.GAFAZBFELDDADAIBHCBCdDHAhAHACDADODFHTFFAJBBFhAIAQECBBHEAAGIB.fDHAhADA.eFHF.aHAA.IHDAhAEA....hAHA...,2,-18,-8,10
NMBQXZcIWEfOSgFCPHaAUYTGeDbKdLJRV,TAAAeAAAKADA.dAFARACF..MAEAQCCAZAFE...IAHAhAAAECABSCDHhAAAFCGDHEDCACGAGDFALFHBhABAVFDBBGGA.........hACA......hCIA...,2,-14,-14,0
ORJSBKeHLDWGZMgNUfYVXPcQCbTdAIaFE,aAAAEAAARACABADA.HAEBLAFBGBGAZBGBMBBBUCCB..VCCBhADAXDAD.QFCAhAAAbEFDAAGA.OFEChADAKFEDDAIB.NEIAfGBAPHACCFHB..IHHAhAHA...hBAA...,2,-12,-3,9
SIQMDLWRYfCdcgBTeHKXFUaAJPbGZOVNE,JAAAGAAAZADB.OADA.EAGAQAFA.MAIBLCDAhAAARCEF.CBHAdDHABCCCHDBBhACAFDABADHBbEEB.SGFHhBAADEGB..fEHAcFCD.eHBAhADA.KGHB...hBCA...,2,-24,-8,16
XUFJAPeWOIBZgTCGdKMNfSVcEbQDLHYaR,eAAAOAAAZADB.CAFA.dAEA.MAGB..SAGHEAHBDBBBHCCAhAIARCEFFCHDACHB...IDBAhAAATEBAGEEAhBAA.fDHAbEFD......hBDA......hBEA...,2,-32,-18,14
WbgAHcIQSEBZGaKLPRFCVNedfJYXTMODU,HAAAQAAAEADEGAFAaACE.LAHBRAEFCAGB.eCAAdCGAJCDFTDDAhAAA.MECBDAIBUDAAhAAAbEGDAEIB...SDHHhADAZFAFFFDHfFFAOFEC..gGDGhCAA.BGHAhDGA...,1,28,-22,50
PWYMLcSJTARZNbeHXfGQIaECVUgKDdBFO,RAAAZAAAeADEHAEAGAGAaAGA..ECAACBDAUDDADACABCDA..OCCHhAAA..PCFChABAMDGBLFHBSEEAhCAAAAIBbGAAQFGA.IHEA.hABA......hAGA...,2,-15,-13,2
PNeRdKBXLAUDEfQOIgTbJYMZVSacGFWCH,EAAAQAAA.OACCTACA.JAEAZAFB.aAHDGCCB.hAAACAHBHCGBeCDBRDFAdFCAXEAAhAEAACIBDEFB.fFFEhAFAbGFA.MFHB.SFCHhBHA......hCAA...,2,-15,-12,3
KdegXVHcRMSPNBObFCEIGJQfaLZUTYADW,KAAAeAAA..XACBHADARAGFMCCB.SCHHBAEAbAFDEAHBhAAAGDDA.QFAChAAAaCCCZDFEUECAADDBdFGAgFGAhAIA.PHCANIAB....hCAA......hCBA...,2,-16,3,19
LZCQNHaRBFGSPWVXUMTecDgIfbAKYOEdJ,OAAAEAAAdADAZAEB..QADAHAGBRCBBGDFASAFA.hAAAPBBBXGBAMAIBhAGAeEEDDCGB.fHGFhAIAACHBKDCALEFAaEHDBHEDFFDBUGGA..hBAA......hCAA...,2,-13,10,23
SXLEegPRHOTNWQabDUfdCVFKcMAJYIGZB,JAAAGAAAZADB.SADALAGB.EAGA.eBHFRDAAHEEA.OCHDhADATCDA.QEABhAAAaFBDDFDB.dEFAFGEHMDIBhACAAAIBBGGAXFCA.gGAGhADA.PHFA..hAEA...,2,-21,4,25
QUceBPdIDEgGWOCaXMJNYZASRVHbfFLTK,RAAAHAAAFADALAGBTAEAQAGC.eCAAdCCAEBFFGDDAhAAACDHAMEEBNCIAAACA..bEABKFFAhAAABDGADAIB..OFHDhABAaFGB...........hAEA......hAIA...,2,-30,4,34
fOQLIgBMbSNAEdKJDTGUZCPRaFYXVWHec,EAAAdAAADADAGACAZADE.RAEA.FAHB....XBGAHCACeCFBOCBBhAAALDHBBDFAbDGDhAEAADEBKECA.UGCACEDAaFAC.hACA....YFFFcFFC..fHEBhBAAIHAA...hAFA...,2,-20,-16,4
AVFeOIBSZCKLRQUYfcMHbWNXDEgTPJdaG,eAAABAAAZACALAEARAGB.QBCDUCCA...fBHAhAAAHCFBbDAB.XCEDhABAEEHF.TEGAdFDAAAEAOFFBhAAACFAAKFFDMDDBDGAB.gGAAaGHD.hADAFGDD.SGHHhAFA..,1,16,-18,34
cCYIJgGEHaQTKXWODSdFZeVRLUfABMbNP,MAAA..bAAA..PADCCAEA..IAGAGAGAHBBAhAGAaAHDKCAAOCED.dDDChAIAeCEBRFGBfGDAhBAAAAAABCFBcDGB.gEAAEGFB.TFGAhACADDGB.FDDH..hAEA...,1,4,-30,34
RgMTBSDHVOKEGUFcLbPQdNeJICfZWaXAY,RAAAMAAABADBHACCKAFA.EAFEGCCA..FBBHLAHBQCEAhAHAeCFBCBHAZDGB.aDCDAAAATFAAhAFADEEBOFFHUFFBhCAA.....PHCCNEIAfGDEhAIA......hBAA...,2,-16,-10,6
EVJLSUcGDCIFNMRPfeOaZQKBYdAbXHTgW,HAAATAAAEADE.LAFBSACBGCABCAEA.FAHBRAFF.eCHFZCCAQDGAhAAABECAAEEAbEFD.hAAAXEAA.gEEGhAEAWFCA.JHAADEIBMIEA.fGHEhAHAaHGE...hACA...,2,-5,2,7
YaFcWICHgATJLVPUdSRZQKOfDNBEebMGX,TAAALAAA.UAEARACFZAEBQAGA.OCAADAHBECABeDDAhABAGCFA.aBHDFDGDhACA.IEBAHEACAEEBPEHDhAAAdGGASFFDfGBENDIAMIBAYFFFhACA.CHHD...hAEA...,2,-10,0,10
NWPJDTKQREFBUAbOGHcgZXVeYfSMICLda,GAAAHAAAZADBeADASAFAMAHBLCDAaAHD...PDHDhAAATCFAREAABEEAAACAbDCC.hAAAOEGH.XGBAhACAfDHACHHA.dFFA.JFCBDAIBEGAB.FHGEhAGA......hCAA...,1,0,-2,2
DbZBaeLVHERgfdJMcUSCTOIYAKPNFQGWX,KAAAFAAAGACADACAZADE.eAEAHAGB..RBFAdDFDMCCBUEAA..TDDAhAAAODHD.AAIB.QDFChAFA.bFCDhAIAaEDDEEHFfFFA.SGHDhAEACGGD.....hBIA...,2,-19,-13,6
GXSQLYcHfKVZJADbUeERBTFOCMaWIgNdP,DAAAeAAARABABAEBOADC...aAFA..IAGAdCCAGCFA.hAIAQEDDLCDAHCGBhBAAKBHBJEHBABIBEECACHDAMFCBhAAA..gFCA.XFEDhCAA.SGGBhCBA..,2,-20,-18,2
KIMXTQOPAUWFRDCeagVGHJbZLNSYEcfBd,FAAARAAAeADE..aACDGAGAHAEAZCDELCCA.SDEAhAAAEBHFBDHAdEAAMDIBTEEAhAEAQEBAAAHA.DFFAhABACECDJFHBbGAC..cGGAKGEDOGAE..hAGA......hBAA...,2,-14,5,19
OAKeCHNbYMDXVPWILGTUBcRFfQJgadZSE,eAAAHAAA....bADBMAEADAGA.XAGA..PBFAhAAALBDBGCCATCFAhAAABCADREFAQFBAhABAaCFCZEFAEGEAACCBCCCAYFEFIHGA.FGHB...hACA......hCIA...,1,4,-9,13
ETLgXfaBSUZbQJNMcdPRCIWDeOAVKFGHY,FAAAHAAAEADATAEA.LAGBXAFAaCACBCCAZCCB..bEABQCEAhADA.MAIBhAGAdEEARGCECDGBDECAAAIBKGGA.hBAA.gEGA.SFFDhCAANCIA.IHHA.hAAA...,2,-19,-1,18
EOcBYbXTePSIdGFKgQLWZNRJUHAfCVaMD,CAAAaAAADACA..EADABAEA..XAFAeAFH.SBBDhADAGBCAKAHBLCCBZDGBREEF.hAAAHCEAABCB.MAIBOECHhAHAbEEATGAA.dGCAFGHDQGEAhAGA.NEIA.fHCFhCAA.,2,-33,24,57
YQWXAScPDFZHKOIEegGJfBbVULTRNMdCa,SAAADAAAHABCOAEAEADA.GBEABAFAUCCARBGB.dAHAaCCHQCFChAAAAAIB.FDABhABAZFGBeDHFfGEAhBAAbFDALHBAMEGB.CHHA.XECA..hCAA......hCBA...,1,-1,-12,11
SWLXPUVMTcfEeODCAQdRKaNFIZHGgYbBJ,RAAAaAAAFADAHACBGAFA....bAEASAHBLCFAXDEChAEAVCCA.MBBBTEGAhAAAEEGAeFAADEFBADHAdGGDhABAKFFDZGAEBHBA.........hAFA......hAGA...,2,-18,3,21
bfFQdaYIXEUgNARBGOHPJecSKWTMVLCDZ,RAAAGAAAHADBeAFAKADAMAFALCGB.ZDAAFBFDaEEB..XCDDhAAAEFAAUGDBABHAOCGDhACA..cGADhAAATFFADCIB.QGGAdDCCIHHABCCDSDADhADA..hBAA...,1,15,-28,43
FLfVGUPJMBAdHEIaDeNgKRQcSbOCTXYZW,HAAAEAAADADAeACE.KAFCRAEA.QBGA.SCCAhAAAbBCDTCFAZDCELCBDhAAAGDFAPFCCMAIBAEFBaEGDhAHANEIAOHECCGFD..YHCA.WEHHhBCA......hCAA...,1,13,-22,35
QBWKIELVSbRUPCJHDFZNYgOaeXfTcAGdM,dAAAMAAAQADAKADALAFB..bABDRBBBUEDA..CAFAHAGBhADAZBGB...gDCAhAIAeDHHTGFAADGBGEGAhBAABFCCEHAASFDADICA.NIBB...hBIA......hCDA...,1,-7,-16,9
YgWLPHbfUeGcTIMJXQKCOVAFBZEDNaSdR,ZAAAEAAADADAaACA..RAEF.......gAEALAGBHDDAhABAUCBAeAGHGEGATDGAhAAAMAIBQGCAhCAAKDDCOEFBAAIBBCCDdGGA.YFFF..hCBA......hCGA...,1,-7,-19,12
SJRVZAIDPXNKQMYbfeHUcBLWgOdCEaTFG,DAAAXAAAQACA..MADA..bAEAHAFCBBBDLBDBhAAAOBHDdCFAECFBaCHDhABAGDDARFEAACDBIGCAhAIAKFAAeFGB...WHDACFHBSHEA.hCAAZGAE.....hCBA...,1,-4,-14,10
IOXSMEfgHPaWVTYZFKeQbDUdRBGJCLcNA,XAAAEAAAHACAaAEA..TADAZAGBeCCAQAFCDBIB.RCFAGDAAhAAALEEAAAHASCDDhABAMEIBfFDEhAAAgEDA.PEHB.WFGDFGCHKGGBhCAA.....hADA...,2,-10,2,12
RFYUMVTQEcJDCBgAaPObSLNGedXZHfKIW,aAAAOAAALADAGADAdAHAHAFA.KBBDRCCAFCGHMCHB..TEAAhAEAEDBADCIBBBBDAAHASDEHhAFAeDHHZEEFIHBAhAFAUFGBQGDA.CHHD.....hBAA......hBDA...,2,-13,-6,7
OgHaKEJLIXbGVTFQWPdYDMARUBefNCScZ,RAAAeAAACADB.ZADBHAEBEAFA.LAGB..bBFAGCCA.TEFAhAAAQDBCdEHAMAIBhABAAAAAfDFAhAIASFEDODGDaGBBIHHAFFDBYFHB.hBGABBCA....hBHA...,1,5,-16,21
KOaBFAJUYDeVbIPdXWENHgSRLcZGCTQfM,UAAAeAAA...VADAbADA...dAGAEAHBHCBCRCCAZDFBGDFA.hAAAQFDCMDIBaEAAACCAhABADAIB..XFAChAEAgDAGLEEDCFHAKHEABHHAFGHHIHCAhAFA.....hADA...,2,-12,10,22
WJGOZQBeVCKYFIdXbTDHUANgaSRPMEcLf,aAAARAAAEADELADA..JAFAZAGBBCCAeBBBKCEAFDDA..dCGATEAAhAEAHECAAAAA..SCHHhAFAMCIB.fEFAhBAAGFEBOHFEQFCA.CFHAXGGChBIADIAA..hCAA...,1,-13,-20,7
aLGBbWCgUXcDPQIHNOKZdeVRJSFETMYAf,aAAAGAAABADACADAUAFA..DAFA.QBEAHCDAKAHBeDADhAAARBGBFBBH.EDCB..MDABhADAADHALEFA.bFBDhACAXDCA.IFFAZGEA.dFHASGGEhADAfGEE.hBAA...,2,-29,-3,26
EFdcTeIZVDWKRPbfaBSOUJLHGNQYXMCAg,EAAAdAAAeADAZACB.DAHBRAEA......bCEAaBEEBAHBOBHDLCBDhAAAHCACGDEAhACA.QEAChADAMCIBAECAFEEATGGAIGCAKGDBSEDFhAEAUGGAYFAF.CHFC...hAFA...,2,-17,4,21
dEJWAFIROBTeMQZXaSgUVCHKfbGNYLPcD,RAAATAAAeADEZAGB..aACAUCCAHAEBKDFDGBGA.LCCBhAAADBIBEEBB.AAGAODBBhAIABEGA.MEEBQGAChAAASFFBCFHA.fFHAbFCD.NIBB.cGGChABA....hAGA...,2,-24,6,30
KgcAFMeDSLRfICQNZdXVTOEHaYUBbGPWJ,eAAALAAARADA.CAEAZAFBdAGA....TCCAHCAAaAHDBCFDGDCBhABAJCHB.KDHBAAAAMEABhAEASEAD.QFCChACAXEEAEFHFbFFB......WHBAhAEA.....hAIA...,2,-33,1,34
OVcXReJLfaEdbASGFQUHBTYZKCgNMIDPW,GAAAQAAAHADABACAZAGBCCDDMAEADBIB.OAHD..XCEDhAAARBDAeDDALEBBhAAAEEGAAAFAFFFHUGCATDGAKHGAhACAgFFB..NDAA.WFHH..hBEA......hBGA...,1,-5,-13,8
QScbdTWVDfJAZUeNHOGCaERFgKXPBIMLY,eAAAHAAAGADAEADARAFA.KAFABCCAMAIBLCEAQCAB.SCFAhAAAdEEATGAADDDBhACAAAAAZEFBOEFAaDHDXFCBhAGAIFAAbFFAfHGFUGCAFHAG..hADA......hAFA...,2,-3,7,10
BgfCTSANVdRIDbEFLGYWPQXcUMeHJOKZa,dAAARAAADADAEADAGAEB....PAFCQCCAUCCAHCFAhACAKCEAaCGDBDAA.CEFDACHAIFEAhAAALEHBXGFAhABAeFCBOHFC..fHABhAHA.SDHHhAIA...,1,-10,-31,21
OBUGcZHNTAXSCfWedLYIaFbKVJPgMERDQ,CAAAeAAAdACALAEA..aADDKBHBPAFA..ECBBRBEFQCGAhAAABCFAGDDAHDBAhABAAAFASDGHhAAAfEFA.IFHAFFCHJFHBMIAADGGB...hBDAcGEDNIBB...hBIA...,2,-19,-12,7
GYUTVDPaZEMRdHNAeFIXOKBQcSJfCbWLg,eAAAXAAABADA.QAFASADACAHA.LAGBGCCAUEFAhAAATCDADCIBZDAARFABHFDBhABAAAAAOCHDKGHB.fEFAhADA.bGBA.gGGA.hAFA......hCAA...,2,-11,-3,8
AbVfSYXMCLGUBIZQWTadgHOcPENRFKJeD,VAAASAAA.MADAGADA.BAFAZAEETCCAdAHAHCFAOAHDhAAAEDAAREFAKFAADCFBACGB.hAAA...fFEEhADACDBDLEEAIGHAaEHDgGEAPHBANIEBhAFA......hBHA...,1,-2,-16,14
VbZgMBYDCGEPLOfSTQecFWHKURXIdAaNJ,aAAAVAAAZACB..MADADAFAGBEA.LBGBSAFAeDHHhAIAFBDDHEBARCEFdCGAABBBJGCEhBAABEHA.EFGBOGFChBEA............hBIA......hCAA...,1,-8,-33,25
FGPDKWbRSACZfYeUINETgdXcLOaVHBQMJ,ZAAAeAAAUAEAEADAdAGALAHB..aBDEHCAAMAIBGDEA.hAAAKEBARDDAACCBCBGB...fDGBhABAIEHATGGAhABAXFFA.OGBABGDA.....hACA......hADA...,2,-18,-15,3
FaeNPMSdHQVbCKEJcTGOIZgULWYXAfRBD,RAAAFAAAeADEMADAHAGB.QBDDCAGA.EDEBTBCAGEFAZBEFhAIALEHB.XGAAhAAAABIBDCHBaDEHSCCDhABAbFGB.KGDAOGCA....hBAA......hCAA...,1,18,-36,54
fVZPOEKNGSQFTHeCcBgURDaJbWXYMLAId,dAAAZAAAEADEGADA.QAFAHAFBeAHBBAHARCAAaCEH..bABDXDGDhABALDFAACAAVFAAhACAKDADFFAD..TGEAhAFACFFA.UGGADFHBYGDAMIAA...hAIA......hDFA...,2,-11,13,24
TXfGZHUSDQPIWRYgKOaNeMVJBbLFCAEdc,EAAAdAAA..TADAGACAHAFBDAEAQAGA..IAHAhACARBEFKCBDaDFDeCBFMDHBhAAABCHAFEBDADIBfDCAhADASEEDPDFBgGGAOEDDNIBB.JFAFhAFA.LFHB.hBCACGGA...,2,-10,8,18
QUBafDSeITZPGVCcXKObWRHJAFMNLEdgY,MAAAEAAAdADA..QADAaAFA.SAFAeAHHZBEBGCBAhAAACBBAKBHB.ODFDRCEAHDCBhAGAABCALEHBUEGADFFBIHHAhAIATGCA........hBAA......hBBA...,2,-18,-7,11
OPBREUeFWXMVSNLTAKCYHgbJIGfcZaQdD,CAAAHAAA.JADAGACAZAGB.dAEBOCABRAGFECAB.FCCA..MBFBSCEHhAAALEEAABIBKDHBhACA..bGDA.IHHAhAAAaEFDQGAADCIB.BFHD...hACA......hAIA...,2,-20,-16,4
BcRgMfTEPOJALFeZYaQSdGKVUHNIXWbDC,eAAAaAAA.dAEAGACAKAGAHBCB..XAEADCGABDFARBGFMBBBhAEAEDHB.OCEDAAAAZEBAQFFAhAGASDHHUFAAhAFA.IGEA.CGGA.....hAHA......hAIA...,2,-24,-14,10
eMPfYOIAdFEVXcHUbZRGNDJBCSLWTaKQg,EAAAXAAAHACAZAFBRADA.GCDADAGA.CAHALCHBaBFE.QEAAhAAAeBHHMCDBfDGAhAEAODABAAAAdEEAFFFH.hAFAUGGAbFCDBCCDSDGDKHGA....hADA......hAEA...,1,21,-21,42
ZHNaXGUSQWMKPFREbALCTdJVIYcDBOefg,TAAAdAAAJADA.....IADADAGAeBDBZAEBHBFC..aAGDhAAAGCBAQCABhACAMDFBFDGHECHFAAIB.LDDAhBGACFHA.cECCfGGEXFFA.hACASGHH.hBAA...,1,1,-31,32
JQMGIPZVeCdBFAWbOKNULXYgHDETRfacS,OAAAKAAALACB..XADAHAEAEBHFRAGB.aCECSBBDhAEA.MCEBGEAAhAAAZDEBeCCHdEEAAAHAbEFDUGAAhAGADDIBTGCAfGCAQGFA..hAIA......hBAA...,2,-5,-4,1
ASIXHBJQMRKYZULPDecTbEfgONaWFVGdC,XAAAHAAAQADCRADA.ZAFBLAGBeAHFTDDAECDBOCFHhAAAaCACFDHDdDAA.AAIBBDHAhABAMEGBKFAAUFGADFFBbGCAhADAfFCB.NICB......hAEA......hCAA...,2,-12,10,22
AGKCIOBNVcDRWgPUaEdLbMZXfeHJYSTQF,GAAACAAABACA...VADARADF.....gAGBaAFAEBFFdCAAhAAAMCDBZCGB..eCCBhACAHCEC.SDADhAAAQEEAADIBOEEBDDIB.PFGBbGDCfHGFhAIA...hACA...,2,-15,-15,0
ZUPFJSWQCfAcHgbMYNTKaDdBXVEILeOGR,HAAAMAAA.TAEADAEAdAHABAGB..EBBAeAHHRBDA.ZCAAFDDHSCCEhAAA.QDFChACAABGAbDGB.KEAAaEBBhBAAXFECLFFBODHD....hADA......hAEA...,1,-7,-27,20
SOUPbQKCYNeZXIdDMBFHfLgaWcRJEGTAV,OAAAUAAAQADAKADA..CAFBeAGHZAFBdBHABBBDHCBCLCDBhAIAaDACREEA.GDGAhBAAAEEASEHB.bFBBhADAXFCC.MBIBfGGAgGEAhCAA.....hAIA...,2,-19,-9,10
PdVaGDCIKHTQWcRfbFEJZOSgNMAXUeYLB,eAAALAAAdAEAGAGACAEAHAFB..QCAARBCBFDFBZEBA.SAHBhABAMDIB.ACDAXDDAhACABFGAaGAAKGFDTDGAhAEA.fFGE.EHBA....hBHA......hCAA...,2,-21,-9,12
LaQVUDSdFNbHAJgMGeRWPBKOfIECXcYZT,MAAARAAABADBKADA..OAEDEAFE..CAHB...XAGAZBBAaCED.hBAAQCCCDCGA.hBCAdCGAbDFDHEEA.AAAAGGABhAGAeDDD.fFHAIDHAYFHBhCAA....hDAA...,2,-33,-12,21
NQcEZXKUIbJVPeADMdCYgLOGFRWaSHfBT,dAAACAAALACAGADARAFA..aAFDHCAC.TCGAQCCAZEFAKFAAhACAIAHA.VCGBhAAAAAFAMFDB.OGEAhADASDABBHHA.EEFB.bFDD.eEADDIAA.hAIAFFHD.....hBAA...,2,-5,-1,4
PALFSCYdTeOHNRVBWGZKbXaQcDIgJEUfM,LAAACAAAdACA.eADHHAEARAFABCAAZCBAKBHB..aCCHQCFDhAAA.DAGAgCFAhABAEEAAUEGB.MCIBAFFBFECDhAEATEDA.OEHH.VFAA.WFGDhACA.....hBCA...,1,-2,-21,19
OZIKdRFBXNUeVJfaPHQTgMDbLYWCcGASE,EAAAZAAAdAEARACA.BAGAUAFA..eAHH..fCCEHCAATDEAhABAMAIBLEHBhACA.CEBAACGBOCEB.hADAFDABXGAAVDFAaFFCQGFADFIB.hAAAYEDFWHBA..hAGA...,2,-14,-14,0
NcRDdCaLgfVUHPIMeJOTZKGYbQSBFAXWE,EAAARAAAdADALADA..fAFAHAGBMBCBeAGHTDDAGDDAhAAAQDFCFCCHAAIBXDGAhABAcEAAaDHDUFAAhAFAIGGAZFGF.bFCDBHDDDFAB....hCAA......hCIA...,1,12,-3,15
RBTgULPJKdXIEbCNMaWVYHGAZfOFQceSD,ZAAAFAAAeACHRAEABAHBUAEALCAB..KAGAdCCDECGA..CCFA.aDDAhAIA..VDGBHEBAAADA.hABAQEGA.hACADFFBTFEA.gFAAXGGC.IHCAhAFA...hBAA...,2,-23,-22,1
UdXKRbGLaeFMBDTWVCYQJNAZcgSHOIEfP,ZAAASAAAHAEAEBHFUADAdCAA..RCCAGCFAeAFAMBIBBEEDDCCB.hABA.TGAACCFA.JEHBhACAAAAAOCGD.fDDAhAGAXEAA.bFEB.FGGA...YDBFhBDANIDB...hADA...,1,-4,-16,12
YOWFAgVTGHMDLbPfceEXdJSQKZCaUNRIB,TAAAHAAAMACA.LAGB..bACBfBDAEAEAdAHAQBFAhAAAZBEBaCCHREFABGCAhAAAOCCHAAIB.GEDAhCAADCIBeGEGSDFD.CDHAIFHAhCEA.FGGH....hDAA...,2,-3,-3,0
dENVfKFacLDeOAITbRCYQHWBZPGUXJSMg,TAAARAAAQADC.HAFBZACBGAEAUDDA.SAGAhAAAdBHAEEGA.fCAEhACAaCCHLFABeCGFAAAAbGEACDHABEBAhAGA.XEDCMFIB.gFGAhAHA.NICB.....hBEA...,2,-7,5,12
SFOGNHPVebKdcMRAfIQYECLZaJUTWDgXB,QAAAEAAAZACB.aACETAEA.DAGABAFA.OAGDHBGBeCBDhAAAdCDARDABAAIBIDEAhBCALDFAUEGBXFCAhAAAGECAPFFAKGHDMFFBCGHA....WFADhADA.....hBIA...,2,-7,-1,6
BUKETDPLSIdNQVcgZGRHbfYWMeaJOFCXA,KAAAEAAADADALACB.dAEAQAFA.VBCAZAFBHCGBhAAA.bEBAfCBEhAAA.MAIBeFEHaDEDhBCAFGGAADGATEGASBHBIGEA.gGGAhBHA..hCAA...,1,-15,-22,7
OGPfSeWHKLcYJAdVFMNagbIRCBXEZDUQT,dAAAMAAAaADA....bABARAFFBAHB.EBDBZAEB.QAGAhBAAGCBASCHBhACAHCCBLDGBJDFF.ACCBFEFBhBIAgFGHXGCADEEBOFHDeHDE...hBAA......hBCA...,2,-17,3,20
RNHTdgPZLCKcFVSMBDUJbIAEfQWXGYaOe,EAAAQAAAGACAOAEARACAHAFBdBHA.ZDAALBEBKCDA.FAHDhAAAMEEADCBBUDGAJEHBAAHA.hAAAXFFCeFAB.TGCAhBCACFFA...SGHH..hCAA......hCGA...,2,-13,-8,5
gUcaGAMdeEIOSWQLJHBRZCNPVDfTFbYXK,eAAAEAAA.OADCQACAHAGBRCCAZAEBCDFA.VAGB..DDIBTDFAhAAAFEEH..XFAAhAAAKCCDgEBAaEHHAAFAMIAAhABAdFFDSFHH.WEEDBGFANIAB.hAIA......hBEA...,2,-10,-6,4
OLZfRdGcAVbYBeDEXIaMUSPWJQKgCFNTH,VAAABAAAEACA..aADAMAFA..SAFHJBDB.QCDChAAACBFAFBHBHCABZAGBRDFBGFBBhAAAABIBeDHFXEBChBEAIGHA.UFEAKHEA.......hACA......hBFA...,1,-9,-20,11
TbcYMeaXANdHWSLGPIFBRZOJEVgUKCDQf,HAAALAAAGADAFAEARAGFZAFA.ECABUCAADAGAQCFA.hABATFEAbCDBMCIBeCCBhAAAADDBdDFASDHBhACABFGAOHEAJHFE.........hADA......hEAA...,1,5,-23,28
feQbcYABWFXSPdTVJGRUNHDMECgLKZaOI,FAAASAAAdADA..TAFAGACARCDA.HAEA.EBHFLAHBhAFAaCEEODHDeCCDbEABADBBXEFAhBAA.PFEBhBDAUEEAMHEA.CHAD.KGGD.IHCAhCAA.....hAAA...,1,-6,-7,1
fMKRLOGHFZDdbTVIXBUPEaNeWQcCAJgYS,JAAASAAA.MADARADFGAFA.HDAAZAEEdCCA.bBFATEEAhADA..XDFAhAAABAHAECHFeDBDQFABhAFAADFAfEDALFHBDEIBIFFAhABAaFDHWHAGCCCDKGHDFGGB..hAHA...,1,-5,-6,1
TgWGbFMDaeHNfKYULcXQOSEZBIRAPdVJC,dAAACAAA...TADAGACAMAFAeAEAHBFAKAHBLCABQCBAhACAECEAZDDBRCGB.ABHAPDABhADAVEEB...gDFAhBAAbFAADFIB.aDHDfHGBcGGA..hAAA......hACA...,1,12,-14,26
XSQECZcIMVHeGNUKBLRgdYJfWFOADabTP,aAAATAAA..SACHEACEZAEB.MAEAHAGBGBDAKCCBRDFBdEAAhAAAJAHB.FECHABBB.DDIBXCFDhBAACEED..IGHAhAEAeDHHBBFC.LFFBfHEB.hCAA......hDAA...,2,-21,-6,15
HZTFDKCfcQUJNIbYdaOXVEGARPgMBWeLS,RAAAMAAAeADEHACCZAGB.DAFAKBDA..CAHAQBFDUDDA.JBBFIEGAhAAA.dGAAaCHDhBAA.XDCDEFHFACCBBGCAhABALEEB.TGGA....hCAA......hCDA...,2,-28,-19,9
NUegTOCKLVdfMcXSIBAQGYDbWRPEHaJFZ,GAAADAAARABAHAEBaADAZAFBUBGA..eAHFOCDBLCDB.dEGAhAAAMEABSDBHhACAAEEAQEFAbFCA.EGHFFGHDhBAA.NICB.CEHAKHAA........hAEA......hAGA...,1,8,-24,32
AfOGPUDgeMXSZHLIaRFENJCcdWBYVTQbK,GAAADAAAeABAMADAZAEBHAGBLAHB.RBFFECDACBDAdDGD.BCCDTEBAhAAAQEEC.hACAAAIB.OEEBUGBASFHBhBAAaFGAFGGBJHBA.....cGGChBGA......hCAA...,1,1,-19,20
THcXgPWGVBOMaeFANYQZfDbUSKLdRJCIE,QAAAZAAADACAUAFALADA.RAGFCCDAECCBHCEB..XCEChABAPDCB.GDGAhAIAOCHDeEBBAAEA.fFEAhBEAbFGDdGDA..IGFAcGEDWBHBhBFA......hCAA...,1,1,-28,29
DcHCTZIKadSVQMXRONPGbgAYWEJBUFfeL,EAAABAAAFACDeACA.LAGBHAEAZCDEaBDEdAHA.QDGAhAAARCAA.OEABGDEAAECBJEEBhAEADAIBTGBA.hAGASDGAMIEAXGGAPHFC...hCAA......hCBA...,1,-7,-15,8
IKEcXHAQFdJVOWgfSZUYTMaCeGRNbPLBD,dAAAOAAA..fADAZADBUAGAMBBBeAEHGAGA.RCAA.hACAbCEDLDFB.hBAADDIBEDCBHGAAABFAQDGAhBDAFEEBWFHD.SGDA.aGGA.hADACHHDNIBB.....hAGA...,1,-6,-12,6
JYTbOadAZeNIKLfDMQHUPGFWCXERcVBSg,eAAAKAAALACBMAEAHBCAGAEAFAHDCBFBRAGBBDGD..SDEAhAAAJEAA.TEBAhABAaDEHAAIBZFGBfDHAhBEA.QFDAPGAAEGFFgFGAhCAA......hCBA...,1,-7,-19,12
gOEBKAWNfZdSCRcHaMIbUTQVLGJFYXPDe,...fAAAdAAARADAHAGBMADAUCDBQAGAGDAAFDGHXBCAhAAAeEEB..EGGAABCAZCEBhACA.CDDDaDGA.bEGDhBFA............hBIA......hCBA...,2,-21,-15,6
GONFRZgXHbKEMePATIDUQSCaLcfBdJVWY,TAAADAAAQACA..aACALAFABAFAdAHAVCEAGCCAhAAAFBBHREBAZCFAHEGBEEFAeDBDhAFAAAGASCHBCFED.hBDAfGFEYFHBOHBA...hBAA......hBEA...,1,1,-13,14
ebNcDYdXKHUIGfBSOAPgELWRMZQJCTaFV,EAAARAAAZADB..QACACAFA.aAEEeAGH..bAGDDAIBdCFCHCEBhAAAGDDASCCDhABAAAIBLFABMDABTFGAhAAAFDHBVGFAcGFC.KCCD.....hADA......hCAA...,1,13,-19,32
IZBKeDUCVdERbTOMFgQAHXLNaWSPfJcYG,HAAALAAAaACA.SADHJAFA.GAFAZBFAeCCBCAHA.ECEBRCAAOCHDhABAMDGB.QEDAhACAADHBXFGDPFABhAFAfEEE..IGGADEIB.dHDBhAHA......hBFA...,2,-11,-9,2
gFfZQVWdcNGCbXAKaBOMIRPeSEUYTDJHL,aAAAMAAA.RACA.eACHUAFADAEA.HAFCLBHBFBEHZDDAQCCBhAIA.dDFAGEGAhAIAbFEA.ABBBOCHF.hBAASFFDEHDA.TGCA...hBBA......hCAA...,1,-6,-17,11
gVcDdLPYCJHaTXBZGfRQeFKWANbEUMISO,EAAAMAAA..OACCVADA.dAFALAGB.CBBA.HBGB.aAHFhAAATDCAZCCAREAAeEEBhAEAKDHBAAIBUFEASEGAhCAADGCA....YHFGBGGA....hBAA......hBBA...,1,-5,-31,26
KSPIgAYWUCEBGJedXFRVLafTQcbMODZHN,UAAAEAAAGACAeADAdAHARAEALAHB..aBEETDFAQDAAhADAMCBBZFAAHDCASEEDhAAAgDGAAAEACEHAXFDAhAEAFGGA.fGGAOHCE.KHBA.hBCA......hCAA...,2,0,0,0
VTegBGFYIfCNSbWKOEdQcUAZLHPRDMJXa,HAAARAAAMADAaACA.eAEHGAGA.FBDDfAGA.SAHHhAAAbBEDOCCHECCBdFFAhAAAQDFAAAIBZFGBLGBAhABADDIBXFDA.TGAA.BGGAhAGA.CHED....hBGA...,1,10,-11,21
ObTcMgZFaPSNHCfQJEBRALXIWUVKeGYDd,LAAAXAAAUADAeADHGAFA.dBHAbAFAMCAB.ZDEFaCEEhAAASCCDHCGBQDBAhABAEEGAAAHA.IEEAhAGAKFAAOFHDTGFA.FHAACHGD....hAHA......hBDA...,1,-2,-7,5
WYJcSQRaHZCbMAeOPLKIgEVGBFNTXdfDU,eAAALAAAKADA.EAEAGAFAFAGD...TCCAdCAADAIB.UCCAhABAJCHBQECBhAAAHDFAZFCAMFIBAAHAOFAB.hACAgFEABGGAfHDBYHBA.SGHBhABA..hAFA...,2,-16,-13,3
HcTdXJIOVPbDRCSKYUWgaMBNFQEfLAZeG,eAAAHAAAdADA.XAFAOADC..bAGBRCAAKCEA..UCCAaBHDBEEAhAAAQDFCLEGBhACAAAAAGFABTFAAIFHAhAFADEIBSGCAgGGGMIAANIBB..hAFA......hAGA...,1,-5,-7,2
fZWLURMHNAXdCKIPTgJEaDcSeBFObVYGQ,dAAAKAAA...TADAEACEDAEAeAFEBAGAOBFC..VBEBGCABhACAZCCFLCHBhAAARDEAHFDAADHACFHA...IHFAhADAgFFB.aGEB......hAIA......hBIA...,1,-4,-36,32
SFMCOcHELNaIGZJVTDdXfReYKbWUQgPBA,MAAAOAAAHACCLAEAaAFA.ZBBA.JBHBTBFA.dCCARCEFeDBBhAFAKCHBUEEA.PEHBhAIAADDBCEGDEFHF..NBBA.GGCBhAGADFDB..........hAIA......hBAA...,1,-9,-16,7
RLWeFaTGVQOXPdfbCBJDUMNIKAcHEgYSZ,HAAAEAAA.SACERACAeAFE.aAEDGBEBQAGAXCCCdCCACCFAhAAADDABMDHBKDEAADHA..hAAAgEDAZEFELHEAhADATGAA.OFGH.fGEAhAGABGGC.NDIA....hAIA...,1,14,-11,25
KbMPeWcIAGaQTSOUNJCZDYFXLgVfHEBdR,aAAATAAA..OACDUACA..CAEAZAFBFAEALAHB.VCEBhBAAHCGBBBGARDDBbFCDeBBDhBEA..IGFAhAAAAEHAGECASBHBDFGAXGGAEHGA...hAIA......hCAA...,1,-11,-14,3
FZJHIceBDXCRWAMgTaUfPQNdYOGSKVELb,MAAAaAAA.UAEAQADA.dAGAGBBAKBBDECDBLAHBhBAA.ZDEAHDACeEBDXCGAhADARFDAABBB.TEFAhAIAfFHAPFBBOHBEbFDDFFHD...hBDA......hBEA...,2,-15,11,26
DRGHSBeFAbgLVUYEWcXaNJCdPQZITOMKf,LAAAUAAAEADA.XADD..aAFDCAFAdAHAZAGBOCBE.hABAMBIBDCAAHCEC.hADAeDDBADFBVECA..hBAAcDGDPEHBTFAAfFBERFEFBGHAFGEDhBCA......hBFA...,1,-9,-17,8
TScBdeWbZCLOFDXQPaNgYGAEIHVRfJMKU,HAAARAAAMADATAEA.BAGBeAFAZCAALCCADAIB.QCGAhAAAaCCA..gCFAhAAAABEBEEEAfFGAhABAKDHBSEAAdGCACHHA.XEEC.PFGDhACA.YGCAhADA..,1,-3,-19,16
ebUASDWOfFVXEQdcPNRBgLaCTKHIJMGZY,DAAAOAAAFACD...EADAdAEA....PAFCRAGBLDDA.hAIAaBBHTCCAHEBAMDIBhAGAZCEBeCGF.ABBBfDHAhBAAQFFABGCAKECDIGGAYHEAhAIA......hBAA...,2,-22,-15,7
QdAcXNWeSbfHPLUIaCTDYVFgZBJGOKMER,XAAAeAAA..bADAHADA.LAGBaAHBDBIB.FCDHZCCAGDAAhAAAMDGB.REFAAAIB.NICB.fDHEhAAA.IEAAhABATFCA.gECAOGEC.EFHB.hABA......hADA...,1,-6,-12,6
DILecMAXYTEGBVgSNRbUQCWKFOHfJZPda,TAAAEAAAGACA.BAEASACBRAFF.QAEAKBHBHDFCZEAAhAAAaAGELCEAhAAAeEEBAAHAXGFDgDDGhAEA.bEGBCCBD.OHAA.fGFAhAHA......hCAA...,2,-9,-8,1
MEfDVUeQWHLZKBgcRaYdJNOPXTbIGSFCA,EAAADAAAeABAHACAZAFBBAEARCDB..dBHAOAFD..TEAAGCCAhAHACEGAAAEAMAIB.fDHEhBAAQFCDLEFBhBHAKFFDaCCH.JHCANEIA.bFGDIHGA..hAAA......hAIA...,1,-7,-10,3
HPECJMgIFSOZaWNbKDXBAVfGQLTUecYdR,GAAATAAA.eADAdACAHAEAEAGA..MBIBFBHDZCDE.aEAAbCDADAGAhAAAAAAB...QEEAhAEALEAAUEFBREGB.hCAACGGDgFCA.OHCENIEB..hACA......hADA...,2,-6,0,6
EHLCgAFadNVfZBRWTYIUDXOQGJMSbKceP,dAAAVAAAZABB.RADA...TAEAUAGADCFBQAGC.GCDAhAAAMDDBKDHBeCHFHEABhAEALDAB.ACDBaDFDhADABEEDIGGAOEGBSGDA.hAEA......hAIA...,2,-27,-8,19
cKdTSFJVYDAHGCeMXRbBfWOZNUIQPgEaL,HAAAeAAARADABADB.OAEDZAGBUCDB.QEAAEAGAaBGELCAAhAAAdEEDFDHD..JGCEDDEBhACA.ADGAGEGA.hAAAMFFBfGAEIGAAgGGAhABA......hAEA...,1,-10,-17,7
LFJIegADSYNWKZcRXMBbdUQPOGTVECafH,SAAA..YAAAKADARAFFMAIBdADAQAFAhACA.GCDBECCAaCGDHEEChAFALDABFFHDeCCDhAIAAAAADDEBWBHBZFDABEHAPHECOHAA.CHGA.hADA......hAFA...,2,-21,3,24
LaAQEFNCKJdcPbDTIfGXRYZMWOBUSgHeV,EAAACAAAdACA....bACATAEA.GAGARAGBZCCAMCGBBCBDUDDAhAAAHDAAeDHFLEABhAEAAADAQGAAKEGD.hAGAPEEBfFHAXGGAOECH.SGDAhAIA..hBCA...,1,9,-21,30
aARNeUOEHTcCfJGFQPgDMIbZWYLSdVBXK,RAAAeAAAEADE.HADA.TBGACAFBGAGA.QCCADAFAMCCBZDCBhAAALDFBdEEAXGEAhABAAAAAODHDfDHAhAIAFFCAIHGA.........hBIA......hCAA...,2,-15,-7,8
WeSULfVcBGDQZNOJbdAPIRCgHXaFTEMKY,RAAAHAAAFADA.EADEKAGAeAFE.LCAA.VBFBGCCA.ZCFAhAAAOCEHdEFAACCBCEHDaCHD.hABAMFFASGAAhAGAUGGA.BGHADIAA.JHCE.......hAAA......hACA...,2,-28,-3,25
HIYVWPDCQBJZUGEFSATbOdaRLMfcNXKeg,TAAAdAAARADALAGB..MACA.fAFAXCAAeCFDhACAHAGBIBDAhAAA.VDDADAIBQEAChADAZEGBEGDAAAIBOCCBaDDBKDHBWFHHBEED.GGCBhAEA.bFGD..hBAA...,1,7,-9,16
RUEQGVeHfNWZADITbBgMLCJScPKYaFOXd,TAAABAAAMACA.LAGBSACBKBCA.aAEAFBEA..dAHAECBBhAAAGBDAHDDA.fBFEhAAAZEGBAAIBDFDB.bDFACFFA.hBCAPFFB.OCCH.....hCAA......hCIA...,1,-2,-26,24
bSOIZNXHaLWGdgBJDMfcVFTQUEPReKYAC,SAAAZAAAHAEAaAGAGACABCAA.DAEAMCCB..VAGBFCGAQDDAhABAECEFRDFB.eDGBhACAAAAAbEBCOEAB.hAIAXFEAdEHA........hADA......hAEA...,2,-13,-11,2
JEILQVTeSHBRKFWAaGXUbMCNOfZdgYDPc,GAAAXAAAMADA.OAFEdADADAFA.JAHBECDA.LCGBhAAA.TDEAHBEBRDBAFDCHhACAAAAAbEFACFHAZGDA..gGBAhBDA.PGEAIHHA..hAIA......hBAA...,1,-10,-14,4
YEAdFQOGPfJIWXRLKTUHMVCNZeacbDBSg,dAAAQAAAGADAJAFA..XACARCAALCGBTAFA.HCDChAAAMCIBCAHBeCGH.hACAbDABSDEHhADAEEEBACIBOEHDfFBAKGGD.VGDAaFAH.BGGBhAIA......hBAA...,2,-17,16,33
aObNdSQeKUcFCgPHZXRGLfJAVITBDMYWE,TAAAMAAA..EADAaACA..OAFCdAFAeAHBKBBAFCDD.CCFA.HCCAhAAAZCGB.RCGBGECBhAIALEFDADBBBFBDDDIB.bGEAhBDAQFCA.gGGB.hBFAfHAB.hCAA...,1,-2,-17,15
LCEAZdGefaQcbVHOXgNKTFBMPUDSYIWJR,GAAAeAAAQADA..bADAHAFAXBGDKCCATCGAhAAAMCDBDADASDEHhABA.IFGARCEBEEGAAAABdGGAhACAaFHDOHAAFHAA.BGEAYEEF.hAHA......hAIA...,1,-4,-7,3
KOFbDUCdAWYeIJLQNPXTfGHgVaZBRMSEc,eAAALAAAQADAXADDGAGA.HCCAaAFARBFFEDFFOBHDhABAbFBADDIBdCAA.ACCB.IFGAhAAAJDDB.NIABfGHAhABAZFBFMEHBKFEACAFA...WFHH..hACA......hAIA...,1,17,-13,30
SNcdRAVWGQDXIZJPTHaYCEOLgMfKeUBFb,GAAAQAAADADAZADEJACE.HAGB.aCDDEAFA.LBHB.hAAAMCDAeCFBFDDAbEGDSDFHhAAAdFEAAAIB.XFGAhAIA.IHCA.PHFChCAA......hCHA...,1,-15,-20,5
EMdaLIbVZSgOGXNURCHJQFPcDATYKBWef,TAAABAAAeACA.EAFAaACA.LAFA..bBEAZBDAOCAAhAAAGCGAUDDAHDDBQDAChACAFCCHDFGBAAGAYFHBhAAAfDGEMICAdFGDIHHA.hCAA......hCIA...,1,-4,-8,4
IYCegDFRPOaNbELAQUVGBXKJHMdScWfZT,QAAAGAAAKADAHAFBdADA..SAFAfAHEZBFETCDAhAAACDBAeDDB.FDFDRDFAaDAHhACAEDHBAAFABDCD.MFFBhADAIGGADGGAOFAELHFA....hAAA......hAIA...,2,-17,3,20
NCKEcMZRaSGILTVfOFQXBHYgdAJWbPUDe,JAAA..bAAADADAeAEA..KAFAEAHFZBEARCAAGCEALCCBTECAhAAA..OCHDhAHAQCGBHEDBdFFAAAEAPEHDhABACHGAMIAAaGFD........hACA......hCAA...,2,-30,3,33
HcQePbLMJVZRGWTYadNSICBXOKEAgFfUD,FAAADAAAHABCeACHLAEAMAEAZAFE.GCEA..TCDAdCGBSDDDhAFABCGAKDHBACCBfDHEhAGAQEFCbGFAhAIARGCAaGHB..NECA........hBAA......hCAA...,1,-4,-19,15
MECbgOLaJQVAHGPKTZDRBXFYWNIfdSUce,HAAAGAAATAEARADAFAGA.....YAGBICFA.dCHASCAAhAAAeCDB.ECEBhACAbEAALEAA.hAAAaCHDQFEAAAIBZEEAXGAAfGGBhACAMFIBOGEC..hADA...,1,1,-10,11
VbDIdQHOSBJPKLGMCNZEXaRAfgTWUYFec,TAAAUAAAeADA..VADADAHBdCDA.HBFBBAGBKDAAGCABhAAA.MAIBZEFAEFCARCFBAACA.hCAA.fEEAhCDA.gFGAFGGBIHEASHCAhCHA.LHFACDHA.hADA...,1,7,-28,35
HdAUOJKXYgDcMFLeICBTfVGWQSaREZbNP,OAAAXAAADAEAFADALAHB..eAFHBBBDTCGAGBDAhBAAQDBARDBBEBFAZEGB.hBDAbEDBHFEDAAAA.KGDDgFFAhAHAMFBB.fBDE.SHBAhAIA.NEIA.hBHA...,1,-3,-18,15
eIAgaNcSbLKUWHEBYRDCFQGMfXPdTJZVO,aAAASAAALADAKADAHAGBBAFBRCCAFDFDGAGA..MBBBXCCAhAAAdEADZEGB.eEEDhAEAAAIB..gDABhABAbFAA.EDFBDFIBQFCA.TFGAhADA.OFFHNIAB.hAFA...,1,3,-8,11
eHcTKYLfWVJRUQXABdCDMFOIbZNPgGSEa,dAAAMAAAOADAZABE......gAEHEAGAHBDATCBAhACALAHB..fBHAhBAAVCCBRCFBQFEChBAAADFADDIBbEEAGGEBeHBEKGHB.....hBCA......hBDA...,2,-13,-3,10
XPWVSJTRgGYeOBLcDQbAKfUdMHIaENFCZ,KAAAdAAAHADAEACE.CAGBZABB..XAEB..PBHDSAGAhAAARCEBGDCAeCCBLFABhAFAQCEBACGBMEHBhAIAaCGDFEEH.VGFAgGFDBEHADHAA.hBAA......hCDA...,2,-7,-6,1
eAIVQMZELSbXfdJPRTgHYcCUOKNFDWGBa,QAAAEAAALADASACA..bAGDdAFARCBAHDEACAHAKCDADCHBhAAAGEAABDAAAAEAMEIBhAAAZDCAJEGFTECA.hADAgGCAUFBAFGDAaGHDeFGB.IHFAhAIA.....hAHA...,2,-17,24,41
VcDAgfFSBILKaGCJbMHOeRTXYNUWQPZdE,FAAABAAALADAGACACAEAMAHBHAFB.RCAB...TCCA.XCEBhAEAUDFBQFGBhAAAdDGDEEEBDAIBAACBSAHBhAEAaFAAOFHB.eEDF.YHBA.hAFA......hBAA...,2,-20,-7,13
AGcaELFHZYPbBRDeUfJTMKXONQICSgVdW,aAAAEAAAHACAZACB.....bAFBRAEAeAHHUCCB.JCEFMAIB.OCFHhAAAQDGBCDHDSEABhAEAdFAAABBBGGCBhAFALFGBFGGA.BHBADIFA.......hAHA......hBAA...,2,-12,-2,10
YcCTBfgbUHLeFdaWQIVEKNJZDXSAROGPM,RAAAGAAAMADA.CADABAFA....bAEAHAGBLCCAeCDBaCEFhAAAQCGBEDGB.KECAhAAAZFAASEEBhABAAAIBOEHDPFFBTGFAfEGE..hAIA......hBIA...,2,-20,-8,12
VcEGbZSHXAIUfegPTaMJDONCQWFLBYRKd,UAAAeAAA...TADAaADDMAFA.OBEDQAFC.LAHBhADARBGBdDBAEDDBZCDAHDFBhAAAAEEAfEGAhBAAPFHDDGBACFHABHCA.YFFF...hABA......hBDA...,2,-15,-11,4
cSDCaMFJETNYeVRfdGOLKZbIAQgWPUBXH,QAAA..gAAAUADAHAFADADAaCFEMAGBFDBAEDHFhAAATBDA..eEDAhAHARCGFGDBALGFAbDEDAAAAhAHA.BAHA.SEHHNIAB.fDDEhBDA...hAIA...,1,-11,-12,1
WAdQLTKgMNIcJYbeVOZUEXaRCGHfDPBSF,dAAATAAAMADA....IADAJAGBeBDBZAEB.EAGARCAAHDEBhACADBIBBCADFCHD.ACCALCGBhAAAKEBA..gGEAhAIAcDDC..bGDA.OECBaHGE.CHHA.hACA......hCEA...,1,-15,-19,4
GRVOKBfUPbAdgQcMFTDLNHXeaJZSIWCYE,dAAAQAAAMADADAHBHACA.eAEEZBDA.SAHBCCBAGDDARDGBKCDAhAAA.BCFBUEBAACHBFDHDhCAALGFAaEEA..IGGAhDAA.WFFD......hDBA......hDCA...,2,-28,-15,13
gdWXMNeISHaFcJRCBKPYAUZLEfQOTbGVD,ZAAAEAAA.QAEAOACCGAFADACA.dBHAMAHBeCCBHCCC.aCHDhABAFCEHRDFB.KEAA.AAEALEHBhAAAbGBA.gFFAhAHAWFFD.NIAB.SGHB..hAIA......hBGA...,2,-14,-3,11
XcHFGKRBeVCJYdAZUgIETQPbaNLODWfMS,ZAAAUAAAEADEQADA..aAFALAGBDAIBMBGBXCBAhADAHCAAGDEAREDAeCHHCCECdDHAhABAAAIBTFBA.bGEAhBAAOHCC.SGGA...hBCA......hBFA...,2,-10,-7,3
UNWTVPRcLZAQFOBHdYIaCDXMJSEgKGbef,QAAABAAAHACAdAFAaACE.DAHB..MAFAECAAGCDAeBDAUCGAhAAA..TDGARDAAZDDBABHAhADAOEABCFFA.SFDDhAAAKFHBfHFBVFFB......hCAA......hDAA...,2,-12,-9,3
MHTENLUIJRCOFSKfAQPYWgDdcbeGaXZBV,QAAA..PAAA..gADAdAEAeAGBaAHFhBAAZAFBMAIBHBCBECFFLDAAhAAAIEBARDFAFEDDfDHAhBEAABHBDFCBbFFABHFATFFA.NEEACHHA..hCAA......hCBA...,1,-3,-16,13
FfNdORLTZHbYaUMgXGWSQIPeBJCcEKDAV,FAAAdAAARADAZACBHAGB..aAEDMCCBGAGAQDDA.eDABhACACDEAEEBAAAIB...fEFAhAGALEGBbFCDUGBAhAIAXGACSDHHBGFCKGDADFIB...hBAA......hBEA...,2,-23,5,28
FARUfEQXHeOPJWSGBLaYVNMcZITKdCgDb,RAAAEAAAHADB.eAFAOACC..JBHBGAFAaCCH.VCCA.MAIBhAAAZDAFTEEAdEAADDHBAAHBhAEAQGCA.hAFAXGEASEFDBCFAYEHBIHHAhAAA.CGAD.....hABA...,1,-6,-14,8
SaLcWNPZfYMTXCJeUEBAHKQIFVGRbgdOD,HAAAQAAAFADARAFFdAHASACALCAA....NAFAZAGBMCEBhAAATDAACDFDUFFAAAGBKCDBhAAA.GEFAODHFaCHDhADA...PGCCfHDB...hBIA......hCAA...,2,-17,-8,9
UOVJBHDMNgFIeCSQZLGRWbaPdfEYKATXc,TAAAXAAA.UADAOACA.BAFAHAFAMAHBFCGDeDBA.hAAAQEECGCCARCFBaDBBhAIAdFDCEFHBABIBJEHBDCIBIFEAhBDASGGD.WHAG....hAAA......hABA...,2,-14,-10,4
DUCMNJFSbWBKVTcdXZeAPEgfOIRYQHGaL,EAAAOAAARACA.HADAGAFAaAFA.LAHB.CCCD.MAIBFCEH.bCCAhBAAKDAA..TDGAhBBAdEHAeFAAACCA..fEEEhCAAQFFADFIBJHBABCGC.XGFAhCBA.....hAAA...,2,-11,-1,10
AaOKLWHcQDCJBMVfZGPgEIbRFSNTYedUX,aAAALAAAHACBQAEACAEABAGA.MAHBZBFEGCAA.ECCAhABARDEASBBDhAEA.TFDAeDEAdEHAhACAAAIBKFHBDEDBfGBAgFFDFGFDUGAB.hBAAWHFA....hAEA...,1,5,-16,21
JNLPeOUHGDfFIMSCVEARXbadBYcWKQZTg,RAAAaAAAdADABADA........cAFAQAFAZCCA.hAAATCCAJCGFLFBAhABAeBHHHCEBDAIBFFFBMBBBhADACGHA.AECBbFAAKHAA.gEGA.OHBChAFA.fGHAhAIASHGG.,2,-31,0,31
ALUfWBcRITJdDQMNOGVXSHeCEgYbaKZFP,LAAAUAAABADARADF..JAFAdAFA.MAHBGCAA..SCBAhADAHCFAECCB..bEEAZDEAhAIA.ABIB...fFCAhABAIECATFDAQGGBOFBBeHCAhACACFFBaFHD....hBAA...,1,6,-34,40
AHCgJMSNUIfLQEZXbaFGYBcKPWOdRDTeV,HAAACAAA.MACASACAUAGALBEBEAFAZBEE.aCCAGCAA.hAAABCCAKDGAODDHhBGARDEAeDHHAACAgFFAhBIA.IHHAQFDCFGDD.cGGC.hCAAWFAD.DICA..hAAA...,1,2,-20,22
MTFZNdVYSOeJRIcCKPbHDUGXEWBaQAfgL,LAAAMAAAZABEdAFASADH.eAFARBGFCAHBKCCAHCAA.GCEAhABAEDEF.aBGEADIB.TEGAhACAFECB...VFAAhAFAOEGBIHDA.cGGCDFBB..WFFDhBAAfEDE.hBFA...,1,16,-38,54
RJCcfdGZANQEBbPWgLVXDYFSaMOeKUIHT,EAAABAAA....bACAgACA.LAFADAGASBFHhAAAaCAB.eBHBKCDAHCFBhAAARCCBCDAAdEFAAAGAQFCAhACAPEHBXEAAMCIBODADIHDATFGAhADA....hCFA...,1,-8,-18,10
PZJKTLHBCOgQSfEbXDIGFeYNRcdaUWMVA,ZAAATAAAHAEA.OAHDQACC.EAEEbCABDAGAGCDA.hAAAeCGBRBFAaCDDMDABADFBKDGAhBIALFFACFFA.fGAAhABAFFHBNIDB........hACA......hADA...,1,-2,-14,12
QUNADHWOKZCFJRTeSVaXYIgLGEfBcdMPb,HAAAKAAAZACBFADARAEA.eAFH..aAHD..XBGD.ICCAhAAAGCAAECFFBAHBdDHAhAAAMCABbECD.QECAhACAACABOEFD.TEFASFADYEHBfHGFhACAPHEC.DEEB.hCEACHEA...,2,-13,-7,6
DBXCWKTIeNLSGaOHbMdUPfgFEYAZJcQVR,ZAAAQAAARAEABAHB.CACA.KCAA..eADHLCEAaAFAHBEB.dBGDhAAAUEAA..fDGAhAIAEDDBAACA.cEEChCAAXDGA.TFEASDHH..hDAAOHFC...hDBA...,2,-29,-18,11
eJKUMEHdYbWLQITaRZgCFPfNBOAGSVcDX,GAAASAAADADAeAEAKADA..EAFEHBFCdAHA...bCDCLCCAhAAATEEA.RCFFZDAAFDHD.hAAAfDHAODBDAAIBXGEAhACAMEEBQGGAIHHACFFD...hABA......hADA...,1,5,-12,17
ALSDcXEOZPgJCHBeKaVTNbYMIFWQUGdRf,LAAADAAAEACA.ZADB.JAFBHAEA.eAHHaAHB.TCCA..hAGAbCABMBBB.FCFDQDFAhABAdECDADIBXEGDhAHAOCHDCFFCBHHAKDCDYEEF.IGGAhACA....hBIA...,2,-26,-6,20
eGMSPQINUTdbYgWRaOAcLEfVHDBJFZCXK,EAAAHAAABACAZADBKAFAGADAMAIB..QAFAUCABdCFA...hAAAbCFA..gEEGhACAREFAAAIBLFAADCHBCEHAeFEBhAAASFDDIGHA.YHBAaGHBfHABhADAFCCH...hAFA...,1,-4,-9,5
BJGgRFeVDOSIbfMcaNAdUCYQHTPELKZXW,dAAACAAAHACAEADAZABBBAFBGAFARAGF..eCABOAHF..bCCAMCEBhAHA...aDCDACIBQECAhAAATEGALHDAhBAAXEFAJFBFFFEDSEADIHHAfGEAhACA.cGGChAEA.,1,6,-31,37
NHLSQITZEWdDAFJGfYCeBVKgcabMXUOPR,GAAACAAABACA.KADA..aADDMAFA.OBFCRAFAHCAALCDBhAAA.QDGAhACAZCEEEDHFdEFAABHAFFEDJFAAeFHFhAAAgGFH..bGAC......hACA......hAFA...,1,-13,-18,5
XYSNgFKCOdfMVHUDJLQGIeAWbEBaRTZcP,EAAARAAAZADB....XACASAFAFAFAOAHDdCCCMAIBHBEBhAAADCFALDABGCCAACCBbDADhADAaDFA...TEFAhCAAPEEB..gGCAfFHAJFHBeGAAhAAABHEAcGED.hCBA...,1,2,-11,13
ICTHcBYXJeGSAZNbaQVEOUgKfRPLDFWMd,ZAAAaAAA.EADEUADA..KAFCRAFALCHBFAHDdCAA..CCCD.HDBABCEAhABAXDFBGCFAADHAbFEChAGA....QECAhACAOHEC.fEHADBBBMIAA.IHHAhCEA...YFFFhDAA,2,-22,-17,5
ZPeDHbFIVSUTKMQcARfGWdXLaCYgEBNOJ,RAAAGAAAdADALAFAaADA..CAGA.ECCBOAHDZCEBDCHBHCDA.FDCHhAAASDGDKDGA.hACAMCIBAEFBXFCAhAGABGAA.PFGBeHAAIGGA...hBAA......hBCA...,2,-20,-16,4
PFGCRgMVNHWDTKIbaUdJOcXLeQZYASBfE,BAAAEAAAGACARACA.MAEAHAFB.TCAAKAHB..aBEAdBHAOCBBhAAALDDBZCEEADIBfDFEhAAACEFA.gFAAhACAVFCADFHB.bFFA.JHEA...eHAAhADASGGD..hBCA...,1,8,-19,27
MKZedXfaPRWOCJNUBbLIHYgTcESQVDAGF,GAAAMAAAZABEeADAdAFA.aAGDRBGF...CCDAUDFALCCB.HEDBhAHATFCAECEB..QFFChAIAAAABXDCCfFBEhBAAOCHDBEADIHHAgGGASDHHhBFAFGBH....hBIA...,1,-5,-8,3
EeTZQHMaYPGRSKbBWgLDVXOfcUCJAdFNI,dAAAFAAAEADAeADA.ZABBHAFA.MCCAaAGDGCEARCFA.KCHBbDAABDCAhAEALEEADEHBOFHDhAIAUGGAAAHA..TGBAhBAA...QGDC.SGFHhBGA...hADA...,1,-4,-18,14
YNgQKfdXDZIWECVFPLBbHRUcGTAaeSOMJ,eAAAMAAA...JADB..gACAQAFAdAFAZCFAEAHBFDEHLCEAhAIAHEGBRFAA.GEEAhBAAAAAAaCCH.OBBHKAHBDGEBhAFACDDDBDHA.bFBBcGFCSGHB.hCAA......hCBA...,2,-10,1,11
DaTACKYJWIfGXQBHFLbceMVOESdNRPgZU,KAAAJAAA.....fACBGADAQAFAHAEBLAGBhAAAeBHHMCCBECCBdEAARDEFZDAFhADAaCHDAAIBCEHA...IEEAhAEAFGDBVGFASEGD.gGBAhBGADDDBYFAFBFHB.hAFA...,1,-2,-8,6
aSRZPUGCeQMIVBHcJdOLTKgEbADXFNfYW,FAAA..fAAAaACDRAEA.ZADAGCDAeAFEMBCBBAHBHCFAhAEAdCFDTDDAEEHBACHADFAAXDGAhAAA..YFFBhAFASCAH.CFFAIGHA..hACA......hAEA...,2,-19,-19,0
VKPOdAeaFMbLCYGQSZXUTWgNfERcDHBJI,eAAAaAAA.MAEALADAGBCAZAGB.TCCA..gAGAhAAAEDFBREAAHEGBBBEAIGCAhAEAKCHBdEBA.ADGBbEEAhABACBBDSEEDXGGA.NBIA.DIFA....hBEA......hCAA...,2,-11,1,12
QSaXTLgCRPFEIDGebWOdJMZKcNfHYAVBU,BAAAQAAAaACALAFARACAFAFA..EBHFGBCA.eCBDbCDA.hAAAdCGAZDAAKEEA..fDHAhADAHFGBAAGASGDAhAAATEEACFCDDFIB.......hBCA......hCAA...,2,-19,-7,12
CPFcTYQZfUEdSOMNVaDBAeIRbHKJXGgWL,RAAAHAAAKADCGAFALADB.FAFA..TCCAZBFAECAB.dCCCMAIBhAAAaDFAAAIBeDFD.IEHAhABAbEEB..XEGAhAAACECD..cFBCQGGCSEEDhAHA.OHDC.hACADGHB.BHBD,1,-5,-7,2
AKHVgeaFBcSMEPLDQdUGNZXRYTIJCfbWO,HAAAeAAABADAMACAEAFALAFA.dCCAGBDAZCDBRCFA.TBGAhAAACEGA.bDFAAAAA..KFEAaCCBhAIAFFHDSFCBhBIA.QFFAXGAA......hCAA......hCFA...,1,4,-28,32
YZPacCFNERTDbKGfMLgSWeBVAUHIQJdXO,HAAAQAAAdADAOAFAZACB..aAEDFBFBRAGBDCGBGCAB.MBIBhAAALDEB.SDHHhAAAeCGFAEEAIFHAhACAXEBAPFFBCGAAEGFA.......hAGA......hAIA...,1,-7,-21,14
FAPeWcfXKYSCTDRJQOBagVENGZdILbMUH,eAAA..fAAAKADACAFB.RADAQAGCaAGD.EBCBZCCAhAAAdDAAbDFDHCEA.ACIBPEEBhAAAXECATGFAhACAOBHD.BEHDNEIA.IHHAMIAA..hABA......hAIA...,2,-33,10,43
WDCFfHLZQYSbBIENXRJdgcAOTKMUVPeGa,TAAAMAAAUAEA..eACEGBBADAFAFAHDHAGDZBDAQDEAhAIA.SCHHhBAAbCCCEDGAREEBdGBAABBBKEDDaEGEfFGAhBDABGHA.XGED...hAAA......hBGA...,2,-12,0,12
SgQINJFOPRVDTMLGCKZHYcAdfWUbeXaBE,dAAAUAAAeADABADAEAGA..QAFA..ICCAhACAFCDARDAADAIBMBIBGDFAZCEAHDAAhADAADAA.bEEBaDHFSFCAhAEA.gGFHOEEHPFABhADA.....hBAA...,1,-10,-22,12
CdLaNVJTRBWHcIUFQGAMPDfgKSZXbYeOE,MAAADAAAKACAZABE....XAEBeAEHEAGAdAHALCCB.hBAAaBGEVCCARDGB.HCFBhBBAIEEAQFFBhBGAADIB.fHBBbFDACGAA.JHDABHHA..hAGA......hBAA...,1,-14,-15,1
OgHDPIVMSGbJTFBfZKeaUEAYXNdLRWCQc,XAAAdAAARADA..QAGCOADAHAGBDCCB...IBDAhAAAMCFBGDAATCEAfCHAhACAeDDBEDHFAAIBLDDBhADACFFAgGBASEHHbGEA.BFGChAEA.aGDE.NIAB...hAIA...,1,7,-15,22
WfUNBgDRaJXYCSZcVAeGOPbTKHFLQMIEd,eAAAGAAAOADC..bADAHAGBLAHBMCCAEDDAdCDAfCFEhAAABDFAREFA.aDAHXFAAhAAASEFA.hABAZFAEAAFAKGHBQGGA.IHBAhACANIAB.DFEBCHGD....hADA...,2,-5,-2,3
LQKbRGHPIDaWdJNBUFCVMOeTAZSYXgcEf,ZAAAXAAAEADELAFBKADA.RCAA.HAFBDAHB.dBHABCECCCDA.MAIBhABAeDAB.AAAA..SDCDhADA.gEEAhAFAQDGDPEHBaEEBJFFFFHAA...hACA......hCAA...,2,-26,-9,17
CKTdcFgJRBWSHMGaXZDfQEVbAPNOYULIe,OAAALAAA.eADHTADAdAFAFAHB.RCAB.SAFBHDEAaCGE.hABAZAGB.QCCChBAAEEDBACCB.PDFBUFGAKFBAhACAgEGH.BFCAMIEADBBB.fGHAhBIA.NEEA.hCAA...,2,-21,2,23
OTMdEDgAGWYQaNPZJSVfIbFBUeLCKHcXR,GAAAQAAAaADAZAFBSACA..fAHAFAFAeAHHLCDAhAAAHCDBRDGBMDCBhAAAEDAAABFBNICB.PDHD.hACAIECAbGFACFFAXFCDdEEADGGB....hBAA......hBCA...,1,2,-3,5
eDUJaBEZOVbXNMGFWSLRYIATKcHPCgQfd,TAAAHAAACADB..QAFAeACEDAFAUBGAaBHD.ZCCA..bCAAMDBBhAAAGCEAFECALEGBhAIAREGBACEBKFAA..gGDBhAAAdGCAEFFF.........hBDA......hCAA...,2,-12,0,12
OAXbTHPKMCYfGFLNcZRgeBaUIQEdVSDJW,TAAAHAAAMACA.CAFAGAGALACBZCCARAEAeAHHBBDA.UCEBEEEBdEGDhAAADDIBOEAA.hAIAAEFB.bFCDKEGBFGGANHAB..hBIA....aFAC.QGGB.hCAA......hCFA...,1,-5,-7,2
OZDKHRUVTIdeSgAaMWBbNcYCFPfLGXQEJ,aAAAMAAABADA....bABA..NAFA.CAFAFAHBLAGBGCCAEBBBhADAZCFAHDCBREFA.TEGAhAIAeFABACCB..cFFChBAAfFEE.XGCCQGBCDGHB.hAFAKGED.....hBAA...,1,-7,-13,6
VOBTDbFJQXSMCgcAIRHGUYedZWEaLKPNf,HAAAGAAAeACEZADAEAGEaAFALCCA.KBGDfCDAhAAABCHATECAbCED..QCGAhACAMEEACEHAAAIBRFFBdEAD.hAAAPFGD.NIABDFIB.FGEF....hAEA......hAFA...,2,-8,2,10
HdfeTOZPgUVFXGbIKAECRYJMQDWcSNLaB,RAAAMAAAQADCDAEA..SAFAaAFAHBFAeCCBZBBAUCFAXDGAhAAAGDBA.KEEDEEEBhABACDHB.JFHF..NIABLFGBhAIAdHDB.........hAIA......hBIA...,1,-4,-20,16
OCdERTFNVfZAeGgMKUIcJPLBXbYHaSDQW,eAAAGAAAMAEAKADAUAFA..IBDAJCDB.LBFAhAAABAHA.bCCCHDGB.aDAHhAAAQDFACEFC.hACARGBATGGAFFDD.fEEEACIBgGGAhADA......hBAA...,1,-1,-26,25
eOYFgacGSBKMDLTIQXdRHfEbNCVAUZPWJ,ZAAAJAAA.eACEFADA...aAFAGAFABBFADAIBLAHB.QCCAhBAARCCAHCGBEEEBCEFDAEHAUGGAhABA.OGDC.hBHA.gFDB.KGGA.MIFA.hCAA......hCBA...,1,-17,-21,4
cPIfaOYSXJHBDAMEgWZCGFVbLdQReTNUK,EAAAZAAAGAEAFACD.LAGBRAEA.eCABTCDAKCCD...ICGAhAAAaCHDODEHXDGAhAEAHFGBAAEB.MIAAhABACAHBdFAAQGEAUFEAfGGBSGBAhACADICA......hADA...,2,-15,0,15
VPIOLAYbadRZJXWBDcNKTGCEUFfgQeMSH,aAAARAAAZADB...JAFBBADA.DAFAKAHBGBDB.EBBBFCGDQDAChADAeCCDHDABVDDBhAIAODHD..ABGAdDGAhBAAXEEC..cFGDTGGACGEA.fHABhAAAMBIB...hCAA...,2,-19,-18,1
XaISOCRgcWEQfZNBeUdMJbPTAYLVKDHFG,LAAADAAAHABCGAEAaADD.OAGFRAFA....gCAAhABAECCBZEAAeCHHdCFDbDDChACAAAIBKEEDFDHDSFGAhAEA.CGAAQGEDBFAAMFFBTGGAhAFA.XGAAIHHAhAGA...,1,-1,-8,7
fSTUaNeDFLBWIgHVdZKCObAXYQcREMGPJ,QAAAEAAAGACA.JACESAEA.aAGDeAFA.LCDAhAAABCBDIDFAhAAAHCGBZECAOBHDABIBXGAAhAGAREAAMEEBTGFADFFAFFHD......hAEA......hAFA...,1,-5,-13,8
fVDZbSQLPRNMAJdTOXEFaWBYgHUCeKIGc,dAAATAAAEADA..FAFDaACABAHA..HAEBeCAAGBGA.fCCAhAAAZCEAQEEAhACAREDAAAGAXFGA.hADAgGBAKDDDIFHADAIBSDBDhBDALHAAMIEAOGEC.hAHA...,2,-22,15,37
UXPgWebcFfaRAQYKdHZMONJDLGVSCIBET,QAAAdAAAHADAZABBMADAOAFA.DBIBGAGA.CBDAECEFTCEAhBAAUDBA..XCGDhCDAgEFBeDDBbFBAhAAAfFFAAAIB.KGCANDIA.JHFESFFDhBCA.BHHD.hCGA...,1,3,-12,15
dPKgQOHCaRIJEbMZVFYBcXASefULNWTDG,eAAALAAA.TAEAdAEAKAGA.QBCAHAGBRCAAECEBZCFBFDGHBCHAhAAAAAIB.SEEDhABAUEABDDIB.GGABOEEBhABAaFHBbGAAMIEA..cGGA...hAGA......hAIA...,2,-14,7,21
AeSTUDWMJBKPIEVbgGHRfCLOFXQYNaZcd,eAAATAAADAEA..MACAKAGA..EBCAVAFAGBEAHBDB.RDBBLDGBhAAAXCGBQECAhAAAaEFBZGFEABDB.SDHHhABA.UGFA.BHHB...hAIA......hCAA...,2,-11,-8,3
QeaJBgIDPUbdcTWCVEMYGNOKRfAHZSFLX,HAAAZAAALADBeACEaAFABAFA.DAHBbBDAdCAA....TDDAhAAACCFAECHF.GCGA.hABAKCCDAAIBXEEAhACAQFDBJEHBgGGA..IFAAhAFA.cFCAMAIB.hCAA...,1,3,-30,33
aRCZNeBEGKYcSdJVFHgbMUXfWLAIPQTOD,QAAATAAA.aACERACFZAEB.BAGAEAFAGBGAKBHB.SCDAhAAAdDGAFCAHHEACbDABMECAhADAXEEB..hAAALFFAAEIBOGCCCGCAeFAD.cGEChAFAgGGA...hAIA...,1,0,-9,9
RYJCEBbMDVQFNPAKaTfWGHSgZOceXUILd,aAAATAAAGACA.HAEAZACBeAEAUCGAdDFCRBFACCAD.BAHB.MBBBhAEAQDEC.FDHBhAAAAEEBfFGAhAGASECBOFABIHHALGFA...hBAA......hCAA...,2,-18,-5,13
cEILJKQTASBYRHaZgMbDGNFVCfXOeWUPd,BAAAHAAAZADBMACAGAFAFAFD.CAHA..OCABeAHBUBCA.dDFAhAAAECHFLECBQEEChAAAAEEAREGF.bFBB.DCCB.hAIAfEHAPHDC.IHAA.KGGDhACASGHH.hADA...,2,-20,-3,17
DHGWfNOSUKbCeLMZcBTRgPaVQIAYEdFJX,EAAAdAAAFADADADA.HAFBGAEB....fAHESBCBKBDDhACAeCCDZDEABCBARCFAaEDDQFFAhAAAADHAJFDA.hAIANEIA.bGFAMFCB........hAHA......hAIA...,1,-14,-20,6
QNJgIfeMRaDSHUYOLGACFVdTPWZcBbEKX,FAAAdAAA..TADAZACBBAEAKAFC.QAGA..gBFAhACAeCEBRDGBDEEBHCBAOFCBhAGAAAIBCCHAPDAB.hBAAbEEAEGFB..XGEAIHHAMEIB.hBIA......hCAA...,2,-28,-2,26
LEHGQJMKZPdRWfITUaSVBcbNeOgYDFACX,LAAAHAAAGADAMAEAZAFARBCA...fCAETBGA.aCCHBCAAhABA...bDEBeCFFhAAAODHDDAGAACHBEFBAQEGAhACAKGEDdGGA.IGEASGBAcGGChADA.....hACA...,2,-17,0,17
PQDcWaUeTSdgbHVRXZfIAOGLJNKMCEBFY,GAAALAAAKADAEAEAFAFA..QAGADAIB.aCAAeCDAdCEAHDCBhABARCGBZDCAAAABOCGBhACAMDAB.BDHA.cEABhAEATGEASFFA..gGGBhACA....hADA...,2,-25,3,28
RQUSLYGHBCIcZgfPAKJVbFdaWEMTeXOND,KAAAVAAAdACA..EADEeAEA..OAFARBFAQCDDLCDAHDGBhAAACBHAZDEE..fEAAhAEAACEAFEHDaFFBMGBAhAAATGEADGGB..........hBGA......hCAA...,1,-16,-20,4
YPNBMZRbGJDSKFeQfgLdTHOUVICAXWcEa,XAAAEAAA..aACD....PADAMAEARBDFGAGASAGAhAAAeBCHQDEAhAAALCGBHFBAODHDhABAIDFAAAIBcEDCBCBDbGBCKFFDfGGAhBGAdGHA.....hBCA...,1,7,-14,21
RaEJSfOGYUdPCAXeHZcDMKFbQTIVWNLgB,HAAAZAAAMACAFADAQAGA..TAFAICCAVCDALCEBhAAARCGF.ECABfEBAhABAGDGAdEDCAAHAeEHHhBEAKGAAbGDA.NIBB.aFFB.SGGDhBIA......hCAA...,1,13,-20,33
NEHXFTeDLcgJVObdWAKQZRPfaCUGBMIYS,ZAAARAAA.aACAGADA.MAFASAEHHBFBTDAAeAGBLDDAhABAJDHB.OCHDhAHAdFEAAAAAQFBAhADACFDABFFAIGHAECCBDGGBgGCGWHBG.fHFBhAIA...hBFA...,2,-14,-3,11
KQbfYPNIUMLEOSZGDVaWBTCAcFgeRdJXH,FAAARAAAdADAHACBKAFA.QAEA..bBFA..fAGFhAEA.PBHDIDDAhAAAMDEBEDFAZDFFGEGAhABAaFEDBGHAAAHAeFAA.XFDA..hAFA......hCAA...,1,-6,-23,17
TdFJBgLEKCZGMXHefODbWaRPQAcNIVUSY,..IAAASAAAdACABAEAEADAZAFBGAFAHCCBeAHF.DCIBhAAAaAHFRDABACCB..cCBChAEAUEFAFGHD.gFCAhABALDDBMDFB.ODHB.bGFAhBCA.PHBA..hBHA...,2,-21,1,22
NTUAdgLVPXCBbcfIKGHYRJEWZeaDSMOFQ,dAAALAAA.XADDbABD..IADAHAFARCAAECGA.eDEBhABAaAEDMAGBQEGAhACATDEAAAHAVFAABAHAKCHBhAHAGGEBJEDFZFGBDIDA.FGFB.....hAFA......hCAA...,2,-11,14,25
JbcLHMYCeVPATQKEIDOSXNfFdRZUaBGgW,TAAAEAAADADA...SACB..fAFARAEAaAHDGCCBhAAAgAGHJDGBLEAAhAEAHBCBMCBBeEHHAEFBhAFAQDFAOGCAFHAAZECA.BDHA.cGGAhAAA....hBCA...,1,9,-24,33
EaHJUSVfWdLGBTMZKbCYDAQIOFRPNceXg,QAAAFAAARACF....PAEAeACAEAFAHBFCSAHHhAAA.fCDAhADAdDEAGECAMCFBbFGBDGGBhAIAACGBODCH.XDGAaGED.VFGB.hBAALHBA..hBHA...,1,-5,-11,6
AeBfFLdQXNHcVKPSIOZTWbRJMUGYagDEC,eAAAFAAAdADAQADAHAFAKCCD...SAFAZCFA.bCCCREDAMDBBhAFAGCFAaEHHEBHFAAHALHCAhBAAXFGDcGAAhAAA..IHHAOEEB....hBDA......hCAA...,1,7,-19,26
NfAcZCOIGXDJEQWLFKeUHdSBRaTbPYVMg,ZAAAOAAAGAEADAEA.EAGALAHB.eBBAHCAABBEARCGBbEAA.hBAA.VDDAMEEB.fFFAhABAABGACCGC.XGAAhACAQEGAKGHB.SGGD.hADA......hAEA...,1,0,-28,28
SAIXfYDGMBUEFKQPcaORNHWgJCeLbVdZT,XAAADAAAGABBBADAEAFE...QAFAaAHD.RCDAHDAAhAAAgCCAeBHHbECAZCFAAEAAhAEA....fEGEhABAMEEAKFFAOFHDJFAFCGGD.dGCA.SHAChAHA.IHFAhBAA.,1,2,-21,23
fVgFNZLWUbcMCDPRIdYJOBSHGeXKQEaAT,TAAAVAAA..FADAZACBLAGBUAFAMAIBDAIB...RDEAdBECOCDAhAAAHFGBGDDAKCADEHBAhAAAADDB....fDHAhBGA.gFGA...hACA......hBHA...,1,-15,-22,7
NQbVgFMIeJcORYHSdWPXBALZfUGaKCTDE,ZAAAGAAAaACA.CADADAFA..EAFA..QBFAVBGB.MAIBhAAAeCCA.ODEDHCDBdDCChACAXEGAADABLEGBhADAKFAAbGEAFFBH.IFFA.JHCE..hBAA......hBCA...,2,-13,-7,6
KEOLgbecdYMfQUJSDIXBTWAVCaFGNZRHP,aAAAGAAAZACB.HADAKAEA.EAGELAGBeCDAdCHA.MDABQCEAhAIASDCDXECAhBAATEEAABBBFDHDRFAF.OFFBhBIAbGDA...fGHADFIBBDGCCHHD..hAAA......hACA...,2,-13,11,24
MNYHZXAdCIKPRcQUTEFOVBJGSagDbLWfe,dAAAKAAARACFQADA.EAFAOAEA.BAHAGBGAaBEDDCABhAAAbABDLDEB.hACAeDABMCGBHGCAACHACDHA.hCBAIGGAUECATFGA...FHDA.hADA......hAIA...,1,-1,-29,28
VdJPAcIXBCQFNHDZMGKabLOTfYeRgSUEW,XAAAQAAAHADAZACBGAEAKAGC.aAGALCDA.TDAAhAAAeBGHREBASBHHhABAEDHFdFFAAEBABGBDFEEAMEHBhADAfHGFgFAA.WFCH..hAFA......hCAA...,2,-9,-3,6
aXgIKEbGFNUfSYcdOeTMPCLZWBHVAJRDQ,RAAAaAAA..XADBKADAGAFAFAFD..UDCASAHB.dCCAhADAeAHBMBBBLDGBhAAAZDGBHECCACCAQEEChABAEFABbGFA.fGHAOHBC.CHCA...hAIA......hCAA...,2,-18,5,23
PZYFEaNJdCTQBSMXcAWIGeHbUKOLDVgfR,GAAAHAAAKADCLADADAGA.VBGBRBDAZBGBECDA..aCACdEADQDDBhAAAMDFBAAAB.eDHHhACAbEFD.UGBA.OFFBhBGAfEHAFGHDCGDA.SHAA.WFAAhACA.....hCCA...,1,-2,-3,1
MBDXUZCQWLNEcefTAdGPHgSIVRaJYKFOb,GAAAHAAASACERADA.aAEDKAGCOAGBbBFA.BAHBDCDBZDFAhAAAQCCCLFFBECHBhAAAeDADADFBdEED.gFGAhCAAIGDAYFHFMICA...CEDA.hACA......hADA...,2,-15,2,17
QWXIReGEZCaHJUDgMTVfBdYNcSPAKOLFb,LAAAQAAAXADDRACAGAFA.EAHBaAFAHCDB..DAIBMDAAhAAATCAABDHAdBFAcFAAhADAACHBFDDB..bEFAeFDAhAFAZFEA.CFHAJHDA.gGGGfHEB.hAIA......hCAA...,2,-11,10,21
VaKGMCRfFeAbEZSJLWgDUYXNTPBHIcOdQ,EAAAZAAALADBDADA.UAFAXAEA..TCAAHBCAOAHBhAAAdBHAaDED.GDEAhAIAREGBeFBBACBBbEGB.SEDDhBCAgGDANICB........hABA......hACA...,1,-3,-17,14
ISEXZYKRdDPGgebMcNCJUaOFHWBfTQVLA,EAAAZAAARAEAdADAGCAA..eAFAMACACBCCUCFAFBHDHCCCBCHAQDFDhABAAAFA.XFGAhAHADDDA..bEECcGCAhAIA..aEHDfGFE..hCAA......hCCA...,2,-40,-3,37
bWIdEMgHaLURCeZfBXDJNVTYSQFcKGAPO,OAAA..bAAAdAEAEAEAHAGB.aBBCRAGBeCABZDBABDFADAAAJCCFhAEA..TEGA.hAIAQFDBKCFBADIBIEEAhBIAMIAAUGGBCEGAXFCCYGAAFFHD..hAGA......hAIA...,1,-9,-15,6
XDTLCVJfYHGUgMIPedZFWOQNSbaBEcARK,RAAADAAALADBCACA..JAEAHAFA.GCEAMAIB.eCCDZBBA.OCGFhAAA.QFAAhABAbCED.EFHFACGATDGAhAHAfGFA..gEBA.hAFAdGDANIAB.aFGE.BHHAhBAA...,1,14,-39,53
DJHEIKWOZNbGRAVdPfLFXeUQYaCcTSMBg,dAAALAAAeADAQAGAaADD.CCBA.TAFABCEA.DAIBHCFBhACAECAAKCEAZDAA..bFFAACHBVEEAhABA..FHDAXFAAhACA.YEHB...MDDBhAFA.IHAAhAHA.OHEC.,2,-15,-3,12
OPcMZeYHWIbEAfBFaTSKLGQJRdUgDXVCN,FAAAaAAA.KADAGACA.RAEA.dAFADAIBCAHA...OBBHMCCBZCGBHCEChAEA...IEEAhAFAADAABDDALDFDhADAQEGAJFHBXGGC.PHAAeHAA..hAHA......hBAA...,2,-37,-7,30
EMROCFGaBPXSgQTAHdfYINKbDZcJVULWe,HAAAdAAA..IADAbADBZAFB...VAFALBHB.ECABRCAAFCEBhACAaCCBBDDDSCGAhAFATEFAAEFA..fEGAhAIAKFBADFEBJFHBeEHHMIAAOFFH..hBAA......hBCA...,1,2,-21,23
TDIAWYdQMPOcbERJZgKUXCefHFNGBVLSa,dAAAMAAAOADA..EADARAGBZBDAKAFACAHBHCACGBBALDEB.hBAAaDGETCGA.ABBBQDEChCAAbEBC.hACAgEGAeFHBFGFDNIABSECH.hAIADGIB.YGCGhCDA...,1,7,-24,31
GRDaHNAWfJUdXeLOQgZSKMPBYCTcIFVEb,JAAAdAAAeADALADBQAGAZAFA.MCCABCCC.CCFA...TCFAhACAFCHH.EDAAREEAHFCBhAGAAADAUEDAOFHDKDHBPFHBhBAA..IHAA....hAHA......hAIA...,2,-30,-6,24
GOHAYdeBUVQSIfbgWJTFRLZaECMXPNcKD,eAAABAAAQACA..fADAbAEA.gAEHhAAATCAARCEAZEEAEAHBMCCBhABAXDGAPCGBKFAAOFCDhAAAHDDBADDBdFHASGGAIHCA..hAIA......hCAA...,2,-8,-6,2
KaSNUDbGAEVZLRBWMcJYTPIeOQfHdgFXC,EAAAZAAARAEABACA..MACAJAEA...TCDAeAHH..QBDDhAAAHCFBdAHAFEHDKDEDaCCHhAHASCCDDCGB.ADHA.hABALEHB.cFFBIHHA.fFFEhCAACHGD..hCBA...,1,-21,-26,5
LJSMUEeNFdPATHKRVbWgfCIGYaDXBQOZc,HAAARAAA.VAEA..bADB....fBHAGAFAaAHFBCADhAAAZCCFLDHBhAAAMCCBEDDAeDFFdEEAAEHBTFBAhABAKDHBCEAADFHBQGFDOHAASGFHhACA......hADA...,2,-12,1,13
dfebOQDAaNcgGZVCHIMESLTWUJRXPKFBY,aAAA..gAAAZACBHAEAEBHFLADAUCEB.RAGFKCCABBBDdCEAeDHFhAGAQDGBAAHA.hBAAGEAACEFDMFIBTFFAhAAA...WFHH......hABA......hAEA...,2,-20,-10,10
HAegUPVKYFLBWNQdIETfMDRbacOSZGXCJ,eAAAUAAAKADALAEABAFB.QBCD.EBHFMAHBRCEFaDDHSCBAhADAGEGACFAAHGAChAAAAAIB..VCEBFGEB.hABAdECA...TEGADDIB.OGCE.hAFAXGGA..hBAA...,1,16,-38,54
TWALXdJUQHfYgbCBODPMIReZFcSKVaNGE,dAAAQAAAHADA..fAGB..bACAOCAEMAGBRCDBhAAAeCEAZBGBSDAAhADAaCHDEEEAAFAALFCBhACAXEGAUFGACFDDDFFB.FGGB.KHAA....hAEA......hAHA...,1,0,-7,7
NfQAGBYKDIHdRaPcMgLeTUFCXbEOSZWVJ,GAAAKAAAHACBRADA.aAEAMAHB.LCDAeAGHFCABCDHA...ECEFZEAAhAAAJCHBQEEAhACA.AADADAIBdEBAgEFDhAAATGAA..bGFASFHH.hAGANIAB......hBAA...,1,-8,-11,3
QDaHfILMXNRgcOKSePFBAZEGdbJWVYCUT,EAAAdAAAJADA..VACAUAGA..QAFCHCACLDEAMAIBRCGBhAAAODHDeCCBBEEAhAHAACFBGECAbFDA..CFHA.aFFBhACAIHHA..XGGC..hBAA......hBCA...,1,-2,-19,17
HABNZaCTKRJdDXOfUEgYQVeIPGWFbMcSL,ZAAAaAAA.KADCRACF.dAGADAEA..OBEDUBFA...ECAAQECAhAHA.eBBDGDFAhABAFDHDMEFBLDHBAAIBCGGA.hBAATECA.fGBAYHCA.IHEAhACA....hAIA...,2,-29,-19,10
YFEacHRBGXMbUedWVPJKZOQADfTLSgNIC,TAAALAAA.SADH..gACBCAFAEAHB.HAFAhAAARCAAGCEAbCCAeCGFhAEAdDGAPEDBZEGBAAHAfEEEhAFAIFAAaEHD.XGGCMFIB.WHCAhABA.....hCAA...,2,-10,-2,8
VIcNdEQfXGaFMTHWUYPKgSAebLBCDZJOR,eAAALAAADAEAZAEERADF..VAGB..ICCAdCAAECCBQDFChABAGCEAMAIBHFAAhACAUGCAKEHBAAAABDBDOEEHhAFA.fGGAaCHHTGFA.....hAGA......hAIA...,2,-20,0,20
ObaYFUTSENeIfBJdVgPQRHKMDZWGcLXAC,OAAAaAAA.FADDTADA..EAFAeAFEBAHAdCCA..PBBBhAFAHBFAMBBB.ZDFAhADAGCEALFFBACGAbDGBhBAASEDH.fFHEgGGAhCAAKHDCDDDB....hCIA...,2,-28,2,30
VbRSeLXWHJZCgIYAEaBfKPcDMUdONFGTQ,EAAAaAAABADAKACA..DAEAdAFA.FAHBGAGA.QBEAhAAARCCAeCHFLDABHCCBZEFACBBD.hADAgGEAADGB.hBAAfHGFMEEBOFBD.TFFA.hAIASFHH.hBIA...,1,-14,-17,3
UXgQSWGecINPVRBfJDbHMZdLOAFaYCEKT,aAAAEAAAKACA..TADAUAEA...QAFCGBGAeCCBICCAhADAVEEB.BAHBDAIBHGBAhAAAdCHAABBBCDEA.SDFHhBAANEIA.RFGBfEDE.MHDAhCAA.....hAHA...,1,-9,-18,9
VHgXPcMOAZfIGedKbaLSJRUTYFWNECQBD,ZAAAGAAAeACEdADAKAFCaAFALBHB.RCCA.TBFA.FCHDECFEhABAQDDADEEAHFFA.hAIAXDBDMHCAAHHA.bFEAhAAA...SGHH....hACA......hAIA...,2,-16,-13,3
UEOaAcGVFWgfTDZSXLQNIBKCeJMRPYdHb,GAAAFAAA...fADAZACBLAFAQAFABBEDeCEAhAGARCDAdBHAHDFCEECBAAABVFFBhAHATEFADEEB...XFAChACA.KFEDMFIBPFHD...hBAA......hCAA...,1,8,-25,33
HAJRPaQBONdWKbYFMGLSXVCcDUEZIfegT,RAAAaAAAQADCBADA.dAFAKAFA.FBBHGBGALAHBSAHBhAAA.CCCDDDEBECEAZDAAhADAeDFBHEEAAEIB.OEHDhAFA.bGDAMFFB.......hBAA......hCAA...,1,-16,-18,2
CDWegJYdcMXTQOPBZHFGfKLVIAEaRNbSU,RAAASAAADADA.eACHJAFB..dAHAMAEA.QBEAhAAABBDAHDDAGCGALDGBhAAAAAIBEDDBaFFBbEBD.CFEA..hABAgGGA..YHBA.hABA......hBEA...,2,-34,-8,26
OMVEeHXJTKWSaPCBcQfGIFdDNYAURLbgZ,RAAALAAAZADB.MAEAEAFAHBFC.JDAATBDA.KAHBaDFBBBFBhABA.QCAAhACAGEFAdFHADCHBAAAA.bDDA.hADAODHD.eFDBWEEDCFFD..IHGAhCAANIAB.....hAIA...,2,-18,-4,14
YDTVRSPdcILbQJCNHUMBWEKfZeFgGaOXA,TAAARAAAdADALAFA..bACBQCEACAEAHAFBBAHAECCBZCGBhAAAeCCDGGABOCHDAAGADDIBhABASEDH.hCAAIFFAUGGAMFFBfFHE.aHAAhAAA.YHDA.hDAA...,1,0,-2,2
LRKSgCEfdeGNBQZPJHWADTMcVaYFXIOUb,MAAAaAAA.FADDOACDLAFARAEA..SAHBEBBB.eBBDhAEAGCEABCFAZCGBHCGBhAFAAAGATGCAVECAXFGAhBAAIGGA.KGFDfEDE.NEIA..hCAA......hCEA...,2,-14,-8,6
fTZGWVYdCAMcgRKXNEHLDOQBaJIbFeUPS,MAAARAAAKADC...EADAHAFALAGBQCCAaBBB.JCFFFBEDeCHBhAAASCCBZFFA.GEEAhAIA.VGBAdHABAEHBhABA............hAHA......hAIA...,1,-14,-18,4
KEcXCfQNPDYSRFUJOeTGIdgMZWVbLHAaB,aAAAEAAA..CACA.QADADAEA.RAFAFBBHOAFEGCGAdCCAZBEAVDCAhADAHDFA.ACIBKEDAfFFAhAGA.NIAB.SFGAhAAA.eHFAIGDAMIAA..hAIA......hBAA...,1,-12,-21,9
JXVYTGbSDUZecWaHAFPOKMQEBRdLINCfg,OAAAMAAABADARADALAGB..CAFAJAHB..XBBChAEA.TDDAbBBCDCFBeCHHhAIA.aEGHHDDBACFAKFDDhBAAEDGB.dFAAfGHAgFGAYFFFhBIASGCB...hCAA...,1,-12,-29,17
SNGDOBCdcWXKUPfRYTLJHbZgFAEQaeVMI,EAAAeAAA.MAEASACAGBCABAHAdAFAXBGDKBEA.UCCAhAAARCFATEEAHDABZDFAAAAAQGBAhBEAaAHF.IEHAhBGAOFFBCGHAcGGA.....hADA......hBFA...,2,-9,-6,3
PTWISOEZXJcgVNHeUBdbLFCQfMGRKaYAD,TAAASAAA.EADAZACB.JAEB..VAFAHAGBBCCAdDFALEEDhAAAQCECMCABhACARDABaCHDAAGBDDIB.IGGAhAIAXEDC.gEGGNIBB.eHDAhAAA......hABA...,1,-9,-17,8
YKGZdcaHIOEMFCDQfNWSLPTVJUABRbeXg,RAAAeAAA..XADBKADAdAFAHBGBEAFAMAIBDAIBQCCAhAAA..fBGAhAAASDFDTCCAUGEAAGHAhABAbCEDYHAAZEGBaGEB.IHHA.CEHA.hAHAWFHH....hABA...,2,-18,-3,15
BCOFSHbLNDEdafMGgVRIWKZAUcPJXYeQT,UAAAJAAA.eADAQADCBAGA.FAFAHCBCLCCAEBHF.aAHDGCEAhADA.REAAKDHBACGBXDFAhBAATGCASFHDhAEAbFFA.DGGBMEEB.....hAIA......hBAA...,1,-7,-21,14
EKLZUQHVNbcfeDWXMCGJaRPIdgSTAYBFO,FAAAEAAAZACBHACB...VAEA..bAEAeAHHDAIB.MDEBGCEAhAAARDFBdEAATECABDHALHAAhAEAQEGAfFHAhAHACCBCaCGC..gFABAFDBOFFH.KGGDhAFA......hAGA...,1,4,-10,14
ZCDWARBIOfGLbEXVgSPMNUHQaJYKFTdce,RAAAOAAAGADALAEAEAFA...XBBASAHH.MCCBhAAAHCDBaCGCKBHBdDAAeCFBhAFAZDFADDDBADHBfEHAhAGAbFFB.gGCAPHBA.QGGBhAIA....hBAA...,1,0,-11,11
bTdgEfCYKIQVHDNSZGBJRPLcAaMXUFeOW,aAAAMAAA.FADDeACH.OAEA..bAEDdBEA.EAHFCAGAKBBBQCGBhBAAHCGBDAIBZDDAGEEAhAGARFFA..cECChBBAADDBXGCC........hBAA......hBBA...,1,-6,-26,20
CfEgRBLdUbYXaDTJGSHKeFVNZIMWQPAOc,CAAAEAAARACA.dADA..UAFA..bAED..aBHDTAGAGCAAHCBBhAAAFCDD.ZDFE.MEEBQDFChAAAABCAOFGB.fGAAhAGALFEADEIBKGCBeFHHIHBA.hAIA......hCAA...,2,-23,4,27
OdWBKSHbEQZJXaIUfTRGMPYgFCcADVNeL,DAAAeAAAdADAKADAHAFA.EBBAZAFB.aAHDUCFBRCCB.GDDA.MCIBhAFAgDGA.hAHACCECAAAALFGB.hAFA.BFEASGEHQGGA.IHBAhBHA.fHDBhCAA.,1,-12,-33,21
aYXVfTNCUHdeKZPWSOQDMAbgFRLBGcJIE,FAAARAAAGADA..IADAEAFA..aAHDXAED..hAGATCFACAGAHCCAeCCBhAAAZCGBSEEBhAIAQDACADIBbGDALFEABHHA.cFAD.YFHBhABANIBB.dHEB.hBAAKHBA..,2,-25,13,38
dQCAUOSMTDeVBRHfLXFJNPcYZaWEGgIbK,SAAAMAAADAEABAGAHACB.LAEAFBBA.JBHB..PBEBhAIAZCEBEEGB.GFABhAAA.bGDAdCGAAAFA.TFBAhBAA.RFEA.NEIA.aDDH.IHHACEDC.ODHDhBFA....hBIA...,1,6,-34,40
NXTMZDAQKYbHFBcaWgGOSefPJVIEdCRUL,QAAAKAAAHACBBAEAaACE.GAFA.eAHBfAFA.hAAAPAHBICAAECDBRCFBhAAALDEB.TEAAhACAZDAAADIBbFABFDHHgGFASEFDdFHAhADANIAB......hAFA...,2,-3,-1,2
bTZXeQcHMBEJARFYOCNgdPWGKfDUaISLV,RAAAOAAACADB.dAEAGAEADAGA.UBGA..aBBCLCCB.hBAA.bBFDZEEA.eFHHhAAAHDBAEGAAABDAFBHB.gEGAhCAAKGEASHAATFDA....hDAA......hDBA...,1,-15,-24,9
LMQIWcKYGJTCRUaHfdbOPBEVgDeSNAZFX,ZAAALAAAMACA.QAEA..IAGAKAGAGCAATBEAhABARCCAHCGBdCHAOCCBhAIAEEEBDFIBeGDGADEB.XGGDhABAcDEDCFGA.aEBH.....bGFAhBEA.BHDA...hACA...,2,-14,-4,10
IDSgEHNQRPYefOBZCdbTLGVJXaKMAcFUW,FAAAUAAADADAEADAHAEC.RBCB.eAFABAHBdCDALCEBGCFAXDAAhADAKCGA..AEGA.ICHAhAGASEGAQFCAhBAA.fFHACGGA...hBAA......hCAA...,2,-40,-7,33
VWFSadMKZUfYTcIBAgLOGPbHRJeXCQNED,LAAAGAAAHADARADFeAFEQAGC.ECDBDBGBFCFHdCAAZDGBfCCEhABATFAABFFChAAAACFBOCGD.JEEBCGHANIABhACA..SFHHMIFA.KGFB...hADA......hAFA...,2,-18,3,21
EgbFVMSBJOaQADKCXIefdcRZPWHULNTYG,CAAAeAAAdACAZADBHADA.LAGB.TCCAEAFAFAHD..MAIBhAAABCBDaCEDACFAKDEA..hAAAfEFARDGF.hBCAPEHBUGDA.GFAB..gGGAhCAASGGD...hDAA...,2,-35,8,43
IGEHBCAZVMTLKacOYedPNDbUfRFSQJWgX,ZAAAMAAALADBKADA.aAFAOAFA.eBBBdBFADAIB.UCAAhABARBEAQDDC.hACAJCHBXCGDEFFBCFHAADGB.hBAATEEA.PFCBNIBB.FFHB.SGGDhCFAIHHA...hBCA...,1,-12,-25,13
EBOCALMfaUIWQdVGbYZKPDRJXHFTgcSNe,MAAAaAAA.UAEAQADAGBBA.ZAFBDAHBRCCBHCGB.FDABTDEAhAIASBHB.EEFBhADACCHAABBBLFBA.hBAAfFHAdEHAbGBAKEDD.XGFCNIABBBBD.hAIA......hBAA...,2,-17,4,21
VSAZJHNfGYcIOCbQXUEeKRWMTagFLDdPB,HAAAGAAA..IAEAbADA.UAGAEAHBRCDAMCAB..aCGDLCCAhAAAdEADBEFDADGAZDFEhACAfEHAOECBQFGAhADAeECHKGGD.WEED.....hAAA......hACA...,1,-5,-14,9
KfAbYCGXELDMNQTPHcRgBeUaVZWIdFSJO,CAAAEAAALACADADA..MAGBQAGAHBCARCGFBAHAeCCAaCFDZDEFdEBAhAAAFDAB...OEHDhAHAACCAGDGA.TFDAhAAA...gGAAWEED.SGGDhADA...hBCA...,1,-5,-26,21
GHcaIJPRUfVYTEFegNQOBdSLWDCKMbAXZ,GAAAHAAAaACAJADARAEF..UAGA..fAGB..TCCAhAAAECDAeCFAQDFAhBIAdEEALEHBCDHAbFFAAEEBhCAAZGCA.cDCC.......hCCA......hDAA...,1,-9,-14,5
gERWJbGQdLCTFYfMBeVHAPKNUXIaDSOZc,KAAAXAAADACAZADE..EADARAGF...JAFBGCCBdAHALCDBhAAAFDHD.MDAAeEFBHDGBhABAAFAAUFCAaFED..OHBChADA...gGGA...hAAA......hAFA...,2,-36,0,36
ZfRaAUEOWBNPSMgKCcHGDIbJFdYeXLTVQ,EAAABAAA.SACAMADACAGA.HAEBGBCADAGA.JBFFdBGA.eCAAhAAATEEAZDAEREDA.AACAOCHDhBIAPBHD..KEBBbFGDhCAAXEGD........hAAA......hAIA...,2,-26,-5,21
MTBLNAJdVUQOaSPHDYZGCefEWRFcbIgKX,dAAAQAAAaADA.HACAZAFBeAHFEAFERCDAFBHD..IBDAhACAKEAAMEFALDDBAAHA.hAAAUFFASECBhAEADCCBCDHA.fFFA.cGCC..hCAA......hCEA...,2,-26,-13,13
LBePagDYdfcOMITKNXSZEbCWGFUQAVHJR,HAAARAAAeADEaACA.DAFAdAGA.OBDDMAIBKBEA..SBHHhAAAECCBCBGBGDFAQDFChABAADFBLEHBBCCCPEDDhAAAfEHA.TFCA.XGGAhAIAWHDG.....hCAA...,2,-17,-8,9
QOJeZNTEBgFIXbGPKaCfSUVRdMADHWLYc,HAAALAAAQADCeADHZAEBEAFEFAGDXBGAGCAA..aBHDSCAAhAAA.RCEBAAHAhACADDGB..cDGAhCAAOEEBTFGABFGAIHHAKDDDfGFEhEAA......hEBA...,1,1,-23,24
JcBOQHLAERbPKUCYfMFZIGNaXeVSDgdTW,RAAAKAAACADB.MACAZAEB.GAEB..aAGDeBCFDAIB.dCFD..JCCBOCHDhAAA.HDDAEDFAUFFAhAAAFFFAIHAAhAHA..XGBASGHH..WEHBhABA......hBGA...,2,-41,-6,35
cCOQWFGVURLeJZbgdMSfNHKXEaABIPTDY,BAAATAAADACA..CACB.QAEAGADARAFALCHBeAHBZBCFdDFAhAAAMCCB..SCHDhAIAHDEBEFABADDB.IDGAhAAAcECCFFGDUGGAbGBCNIAB......hBGA......hCAA...,2,-23,8,31
dOMJZWDBTaHbFUSNAKgPEQXYVeCRIcGfL,KAAAEAAA.QACC..XACAeAEERBEBGCGAdAFAMAHBZDDFhAAABCCAHFFBbDACSAHBhCAAAAIB.gGCBhCBAPDFBCDHAfEDA.LFBBhAAA.OFHBhADADFIB.aGDD.,1,9,-22,31
DISVNYZdcgQBEPOWJeUaGRCMFTfLAXbHK,HAAADAAA.SACEVACAZAFB.dAFA.QCCAEAHF.OAHBhAAAeBBBGDDARDFBMCIBTFBAhAIAACIBKDGA.IGHAhBFAcFAA.BFDBPFGBJHEA...aFHF.hCAA......hCCA...,1,2,-16,18
ZBaVeWNDGOFILSdHfJMCgRcXbTKAYUPEQ,UAAAEAAAZACBBADA..eAEADAFAGBDBFAHDLCBDHDAAMAIBhADARCEA..XDGAhAAAKDFAABGA.QECChAFAaDDD.VFFAOEHD.dFFA.CHDA....hBCA......hCAA...,2,-20,-6,14
LHaSAMcVfPJTgeQINYZBXdRCKFUEDGbOW,MAAAVAAA...JADBeADE..QAFAIAHA.ZBBFdCDARDFAFEDDhAFAECFAGDGA.hAIAOEBBHFFCABHAfFCAhAAA.TFEAYFCF...hAGA......hBEA...,2,-19,-17,2
IeHDJBTWGPXOUFKCdfgERZbNSLacQYMAV,eAAAHAAABADBGADAOAEDKAFAdAHA.ECCBRAGBZCAA...bCFDLDFAhAAA.aDBHQEDAhAAAACGBDFAB.TGAAhACAXFFACDHAfFHASGHH.MHDAhABA.....hAGA...,1,-9,-18,9
WJFdRgVbBaCTQcEKfeUXIOMDAYGSZLNHP,GAAAZAAAHAEAJADARCAA....VCFAaAGAQBGDEDEB.eCDBhAAAXEAA.MEIBhABAACEALEGB.hACAPFDBdFGAbECDCFFA.KGAB......hADA......hAEA...,2,-17,-2,15
LcYHUETIJBGNKODPRCfgbVFAWeQZMSaXd,eAAAZAAAaACAdAEA.LAGBHAEBEAGA..TCCABBHAGDDAhABA.OCCBREBBfDFEhAAAbDGBAEIB.MAIBXGAAhAGAcEECUGGBIEHA.KGHBDGFBCHGD.hABA......hBDA...,2,-16,8,24
CUPHRdJETefFAcZVIGaKbXSNQLBYOWDMg,ZAAAGAAAaACA.KADA..SAEHLAFBOAHBMAGB.CCDAHEEAhAAARCGFEAHB.eDADACCBVDDBhABAXDCC.QFCDhACABFGDDEIB.gGGA...hAIA......hCAA...,2,-26,2,28
fbOJDXSeICHNRWaYcdLAZBFVQgUPKMTEG,ZAAAFAAAQADAUAEAKAGA...EAFAGCAAOAHDDCHB..eCCBhADAHDDARCEA.aDHDdEEDAACABCCDhABAgEGH.hAIAMHBAbFDA.SGHHCHGA....hBAA......hBHA...,2,-21,-10,11
IfZENbDHJGYBMcKdaeWRCgTALSUVXFOQP,LAAASAAAXADDQADA..IAFAEAFADAIBHBGBhAAAGAGAMCCBdCAAeCCBhABARDDATFFAAAIBFEEAfDAAhABAbFDDBFGAaFHDCEHAgGCA..hADA......hCAA...,1,-3,-6,3
GBLXIFcRbUEQJDdCOgfNAeMPaVTKWZYSH,eAAAaAAA.KADAZACBHAFBGAEALAHBFAGARCGB.ECCA..QEBAhBAAdDEAOEGB.fFAAhAAAABBBMEEBTFFAhBEASEHBXGBCIHBA....hABA......hAFA...,2,-17,-4,13
VICFZDdXWAgcEOSPeHTKaYQLfBJRbMGNU,EAAASAAAHACAaAEALADA.BAHARAGFGCCBUCCACCFAZDFEdCHAhAAAAFCAOFCE.eFHBhAAATEAAQGFDhAIAbEDA..MFHB.IHAADICA.WHDAhABA.....hCAA...,1,2,-18,20
EYSaFZPDdTAULfMGVeWKbQNHROcBXgCJI,LAAAGAAAeADAKAEAQAGCHAGBRCDABDCDCCAA.EDHF..aCCAZEAAhAAAdDDDAADAMEFB..hACAbDFDOEGH.XGBChAIAgEAAIHHAFCHDTFCA.hBAAfGHA.hBCANIAB...,2,-9,2,11
QLdZbRTDPgCXceJFNYWISMUHABVaEKfOG,aAAAEAAAKACAGACA.dAEBRAEFDAGA..CAHAeBBDFBGD.....hAAANBFA.ICCAUCGAHEDBhAHAABIBBDEDOFHBZEAA.hAEA.TEFA...PFHD..hCAA......hCBA...,1,-13,-34,21
CYOVGaLMDgeSAPWQbJKcBXdNZIFETfURH,QAAAKAAABACBdAEAZACB.EAEAUAGA.HCCAOAGDGDFAaCEBMAIBhAAADDIB..eEBBhAAAADFA..bEFAJFEFXFEChBCAFHGE...TGBACHDD.YHEGhBGA.....hBEA...,1,4,-24,28
bJUVLGIESTAcMHNZdKfeXPDBWFRCYaQgO,HAAAdAAAeADADACAFAEDRAGB..CCBA.aAGA..QCEAOBFDUDCAhAAAGDCA.EDABABHBMCIBhCAAZEGBKFFD..XEEDhCCA.BFHD...YHDAhCDA......hDAA...,2,-25,-18,7
LDPYWRfZAcNeKFgXbQGEVdJaSTUOBHMCI,eAAAFAAA..XACDGADAEAFAdAEB.aAHDSAGH.OBEDhAIAHCFAMCCBLDGBhBAADDBBPEFBRGEEABIBKDDD.hCAAbEGD.JFAFBEFAYDDF....hAAA......hABA...,1,-4,-18,14
LGfYSWEbUMKQNABHRCgcPeVdFOJIaTZXD,HAAARAAACADB...gADBeAEHdAGAFCCBOAFA...aBFDZCFEhAAALCAAGEEBSGBAhABAEBHFbDEC.MHEAhAIAQFFAAGBA.BFHA....hAAA......hACA...,1,-9,-22,13
GRSUMgINJdWOLZQPFAbHcBfeTKVCXYaED,HAAABAAAeACATAEACAFA...aAGAEAHBRBGBMCAB..ICAAhAAAdCCALDFBZCCAQCGChACAAEEAbDADKEHB.XECAhADADGHB.GGDB.SFFEhAIANICB......hCDA...,1,5,-19,24
ERaFdXSIgQMAUeLcVZNbDGTOWPBHCYfJK,eAAALAAAZADBDAGAGADA.OAFABBCAHBFACBFB.JDEBRCAAdCHAhABA.SDEHhACAQDGAADGAUFGAVFBBTGFAhAAA..........hABA......hBFA...,2,-20,-19,1
TKYZbIFWXNfdMgGVeODLCURAPQSEHJcaB,QAAAHAAAaACAKAFAZACB.FAED..XBGAdAGAGDEA.eBHHhAAALCCARGBAADEBEGGABDFAhAAA.bDGD.IECAhAFANIEB.MEEB.OFFH.CHAA..hAIA......hBCA...,2,-11,-7,4
TWDXCUEJbKZMNcYdIVfageGQBFARHPOSL,HAAASAAATAEADADACAGB...EAFAKBHBZBAEMCAB..NAIA.dCCAhAAA.IDFAaBDDeBGFhAAAGDGAQEEChABAAEEBREAFLGCAXFCB.UGGA.JHDE..hCFA......hDBA...,1,0,-7,7
aLFDcMGJQbgdNEABRfOVSYHIePZXCTWKU,RAAAOAAA..SADBHADAeAFEZAEBTCCAKAGALCCBhAAA.DCGAGCEA.hABAbCGBdDGAABBBfFHAhAIAIEEACFHAaGEAMIDA.......hAIA......hCAA...,2,-30,0,30
bXJCLceTOQMNUaSGPKdYIDBVgRWfFHEZA,XAAALAAAeADH.QAFAMADAaAFEGBCAdBHADCAABCEAhABARCEFFBHDHEBBADGB.bEFDhAAACEEATEGA.OFAAhACASEHBKGGD.......hAFA......hAIA...,1,0,-21,21
gZdHKRFOBWTIPCYaVGDbLQXMEAcJSUNfe,SAAAUAAAeADAdAHAHACB.RAEABAHB..TCDACCFA.aBGBhADAGCGALDHBMDEBhAAAADCBJEABfEAAhABA.ZFEBOEFBIHHAPFCBDGGB.XGGChAEAcFAD....hBAA...,1,-4,-19,15
SRVICaAWgMKQYZONBHEPTXfbUdLDceJFG,MAAAQAAAZABEBAFAHACA.EAFE.TCDAXAGD.UCCAhAFAdAHALCFBDCFB.hAIAeDHBGDFAREAACFEDAEAAKDHBhBAAOFHHfHDB......hBIA......hCAA...,2,-30,8,38
cPBQUEfRCTGeYaFWAgIMOSVNDHdLZXKJb,MAAASAAADAEAHAFCZACBKAEA..JBBA....bAGBBCEAhAIAECEARDEAGCFA.eDDBhBAAaDHDAAAAOCHFdECALGFAhBIAXEBC.PFHB....hBEA......hCAA...,2,-20,-13,7
XeJMOCTWNcBSgZYEVdPHRaFIAQLKfDUGb,LAAADAAAGABBeADHMAEACAFA....TBGA..cAGDhBAASCAAZCCAECHFdDEAhABAHDFBREGBaFAAACEAQGBAhBGAfGDAXGEDOEEHBFHA..hCAA......hCBA...,1,-11,-12,1
IXFfYNeTOJRQKBMSCbPHZgVcaDAdEGUWL,EAAAGAAALADAFADA....fAGAeAGHTCBARCDAQDGAhAAAMAIBCDEAHDGBZECAgGAAhACAaEABAEDBdFCDIHHAhAAAXGFAOFADBHCA.SFFDhAEA.....hAGA...,1,9,-11,20
LFENBGAMIZTHVDUOJCPeRadbQYXWcSgfK,ZAAAHAAADACAOACA.CAFA.RAEAdAHA.QCCBXAGDSCCAhAAAKCFA.ECFBGEEAhABAAAIBMDHBTFAAhAFAUFEA.eDHF.aGHD.......hCAA......hCCA...,1,-13,-26,13
fGaSIVLWHCQBXbKEMANFdPRUZYOTcJgeD,dAAARAAAZADBOADA..TAFAJAGB.eAHHGBDA..aCCBSBHHhACALDABHDEAhAAAQCBAbFCBEEHFAEGAFEHDhAIAUGGB..gFCBfHABIFFAhBAA.CHHA...hBCA...,2,-27,12,39
XEUfgADGMIKWVNFHPQOSYTZcbdBaLReCJ,GAAAMAAAKADA..VADAHAFB.QBBCSAGBZDDAdCGDaAHFhAFARDCAeDADCCED.EEFAfDHAhBAAAAAB.DFFBhBHAIFHAFGGAOHDCTFDA.BGGD.hCAA......hCBA...,1,-8,-9,1
TCJGDQSNcKYaMgPFIdWLHAVRfZXBbOUeE,RAAAZAAABADBOACAUAFA..EAFA..CAHAGCCAQBGA.SCCAhABAKCHB.aCEDhAIAMEFBFDGHdGGAHEGBAEIB.hCAAXFBD.bFDD......hAAA......hABA...,2,-28,-18,10
FbZVEXefCdNWLMcPAQDHJSOaYBUgTIGKR,HAAAOAAAaACABADAUAFA....TAFAGCCARCCA.ZCFEEBHFeEFAhAAA.dFBALEEAhAFAMFIBAAIBQGEAhBFASBBGgFCB.FFHD.XGEDhAHACHGB....hAIA...,1,4,-24,28
DQNIfaAETJZeBOSdWLgbKXRCPMYcGVHUF,EAAAZAAAeACEBACAdAEALAFB.KAHBRAGBMCCBGCDAHDDA.DDIBhAAAQDGA.hAGAfFCAAAIBTFFASEBDhBEAbFFCCCCD.cFDCFHACIHHAhABAaHFE.....hCAA...,2,-24,2,26
UIRNVAGBcZfgMDHeYJFEdWaPCKQXbOSLT,GAAAZAAAMACAHADA.eAFEFAFDEAHBaCDCKCFC..QCCBhABAOCHDTEEARCFAAEBABEEAhAIAfFHEDEHBdGFACHHAbGEChAAA.SDAD......hACA......hADA...,1,0,-23,23
bGQMFgfZcHAYCEaeLOKPXURdISNWVDTBJ,EAAAeAAALADAKADAUAFARAGF..dCBA..SBHBVDDA.BCCAhAAAGEGAMCEBfEAEhAAAHDFAAFDB.aFCBXFFAhABA.IHDADCIBbGDC....hAIA......hCAA...,1,-2,-31,29
YfPIcFMERgJOdTXDeQWUBNVSLAKHaGCbZ,HAAAGAAAZADB..fADAIAGAMAIBRAEF..OAGDhAAAdCADTCFAeCHHQDDChACABEEASEGAhAAAAAIBaDAHbFFAcFBAEGAAXGDCDGGANHEB...hACA......hADA...,2,-17,11,28
IXUEcSAKDfLYWMdTeagBZCbRONQJGFVHP,DAAALAAAMADA.eADHBAGAZAEB.RAGB.QBBAGCAAHCFB.hAIAXFFAEBDAABIBKCEA.hABA...WEEDaCGDbEEChBAANDIA...FFHD.IGCA.SGGDhBBA..hCAA...,2,-34,1,35
TFKVdQfHOPAGNWRaSeBDEYIcULZMJCXbg,GAAARAAAeADEBAGBEADA....IAGALCCAZBFAMAIBXCDChAAATDFAKDFAdEBAHECChACAAAAA.aDAHDEEBcFGAhADACBDAFEHD..QGCDOHDANIAB.SFFDhCAA....hCGA...,1,10,-17,27
QYfVaZOUgbdEFceGDNHLXJKRTIPBMSACW,QAAAVAAA.ZACBOADAUAFAdBECEAGA.FCHDGBDA.HCFBhAAALEEBKBHBRFCBTFGAhCAABAHAADGBCGGA..YFFFhCDA.........hAAA......hBCA...,2,-35,4,39
NRZWgAMSPGEXHfDJQaLUFOcVCYKdbITeB,MAAAGAAAHACCDADAQAFAaAFA.LBHBOAHDCBBDdCDATCEAhBAAeCFBREBBZDCFAAABEFEBhACAXEEA.fDHEhBGAFGGA.cGCCKHDA.BFHD..hCAA......hCDA...,2,-14,-4,10
VCPWLJAdZFQaRDYNOTecfGMUHSgBIbEKX,ZAAAaAAA.RAEADACA..OACD.eAEAGCCBHBFCBAHBECEBXDFDhAEACCGBLEFAAAIBdEHAhAFAQFAA..hABAYBBFTGEAfGGBMEEBSGGDhBAA.....hAFA...,2,-32,1,33
CagJOEXdRVAQFHbTGBSfKUMIWeNPYDLZc,HAAAGAAASACEKADAMAFA.eAEH...PAGBLBGBhAAAZCCFaAHFOCDAdDHAAEEAbDDDhACATFFABEHAfFFBhADAIHEA.NIBBDDDBCHHA...EGHF..hBAA......hBCA...,1,1,-17,18
DQbJPVIWdEceHCONLKMYBXFTUARfSZGag,RAAAZAAAGADAaACA.QAFA..bAEDVDAAdAGA..ECCBHDFAhAAAOBHDLFAAhABAMECBBEEATFGAAEGASFGAhABADAIBIHBAeHFAKHDA.....hADA......hAFA...,1,3,-16,19
TENfIDKPeZAQMVBCgFUJGSOLdRaYXHWbc,MAAACAAAFACA.GACBLAFARAGF...aBCCHCCA.bDFAECEA..hAAAfEEEKCGAeDDBAAGAhCAAQFAABEHAUGFAhCBAOBBB.dGDA.XGFA..hAFA......hAGA...,1,3,-29,32
AcKVDPfORTeYIgdNXFGJLHBCEWbZaQUMS,KAAADAAAOABERACF..eAEE..IAFAdAHAFBEDGCAAhAAAHAGBECCAZDEEUDEAACAB.VEAAhAEATFFA..gEGBhAIAXGCALFHBCGGD...hBAA......hBIA...,1,-9,-22,13
KJOQPFDEdaVeZAUTbLWSgMHfIBXCGRcYN,TAAALAAA.SADHHACBBAEAGAFARAFF..NAIAOCABhAAAQCAA.DAIBEDEBhACAaDDAeCGHAAFBUFFAbEADMFDBhAEAfDHE.CHAA.KFGA....hAHA......hDCA...,1,-1,-16,15
TEVefKFGLJMcQbYSBdgOZUPaXNDAIWCRH,CAAAHAAA.EADEeACAFAFAGCABMAGB.QCFASAHBdDHAZBCEhAAAaECDDBHB.AACARDDATEEAhAAAKDHB..LFFBhCAAcGGA.BFHD........hCBA......hDAA...,2,-26,2,28
LOMSYFCagUQXZAdcfNbBJReIVWGETPKDH,dAAA..fAAABADARAEFeAGH..IADAGCABECHFTAFAhAAADEEA.HCAALFFAhACAMAIBFCEBaGAA.QDFAhACAAAIB.bFAAWHFAOEHD.CFFD..hADA......hAGA...,2,-25,2,27
OWSeITbJdaKPRFEAVYNcMLQZGBgCDXUHf,VAAA..NAAAMAFAZADBGAFA.CAHA.XBBAHDAA.OBEAhABAeCHF..TEEAhAAAdCEAaBHDRFBAAEIBLEDAhACABGGADGIBfEAASHAGbEGD.KGDA..hADA......hAEA...,1,3,-20,23
IcgFPfWTAXeLSBKQGEVYMDRaCJdUZOHbN,eAAALAAAKADAGAFAEAEA..MAHBRCCACAHA.dCAAZDGBHCCA.bBFDhABA..IEEAhAAAFECHfEEEACCABFAA.QGFAhACADEIBaGFCOHAANAIA.....hAEA......hCCA...,2,-21,-3,18
YaBPFIHQVSDGfOgcKUWMTNEbZXRLCeJAd,aAAAFAAAHACB.QAEADADAGAEBOAGFKBBDMCDB.ECEBZDEAhAEA.RFDAeFHFAAHA..hAIAdCHA.BDBA.IFFAhBAA.fFCE.gGEGhBDA...hBAA...,2,-25,-22,3
BQZVYDAITHKCbPdfgEFONMWecRGJLUaSX,HAAACAAAdACA.EADEFAEAMAFA..eAGHRBEAGCABLCBAUDGA.aEEBhAAABCHAZFFA.DCFBABHA.KEBAhAAA.....bEEAhAIA.....fGEANICB..hBCA.cGGC..hBEA...,1,-5,-41,36
HVAbWYEeZSGUKJFaBRQCMTOdNXPgIDcLf,...bAAAEAAA.eACAGAEAKAFAFBHDRAGBMCABdCCA....XCFDhAAAgCCG.DAAAhAEALDABHDFBAAIBZEBAhAGASECAaEHDCHEA.TFFA.OEHFhADAIHHAfHABhAHA...,2,-27,7,34
aQbHeKZVAFPTONdGDIELSfBCRJWMYgXUc,TAAAdAAAGADA.EAFALACBBAHARCAA.MAEA...XAGAhAAAaCFDHDGBeBEBZFAAACHAhACAOCGBDFDA.fDHAhBFACGGD.YDEF.gGGAhCAA....hCCA...,2,-21,-18,3
ceWgRaLdUEIHbZBGVMCPADfYQJFOTSKNX,DAAAQAAAOABE.KACA....XAEBeAEERBDAdAHAUBGAHDDChAAAZCCAGECAMDHBADIBJGDAhCAATEFA.SEHBhAHAcGGD.aGHH.......hDAA......hDBA...,2,-19,-14,5
feMTNFBCRdHbLDcVEPaSQUWXgZYKGIAJO,OAAAeAAAMAEAFADDBAFARBCA..HBFBLAHBDAIBEDBB.aDEHQCEAhAFA.XEEChBAAZEGBGFBBABBBTFGAhBHAdHCD...bGDC.....PCCBhCAAWFHH....hCHA...,2,-25,-2,23
KeDARbaBXQWfNYPdEgIOTSUVJMFLZGCcH,RAAAaAAAQADC..fADA..PAFAEAFAOAHDhADATCEASBBDhAFAVDGBMCCBZCEAGGCBhAAAHEEAeEHHABIBBDDDXFCC.YHBGhBAAIHHA...hBHA...,1,-7,-13,6
cOMLbAUWRDZgTdJFGQeXEfVNIPKaCSYHB,RAAAZAAAdADAGAEA.eAGBEAFA...VCAAIBHA.aCCCSACEhABA.HDFBhAHAOCEDbEDDAAIBDCGB.hCAATEGAFGHB.QFAANICB.CDHBBGGDhAAA.MIAA..hABA...,2,-29,6,35
YHZeGFEIRAWDfdNbJOPXcQCBKLMagVSUT,DAAAdAAAJADAOABE....XAGBQAECKBDD.aAGA.SBGHhBAATCEAHCBBhACAeCCBECHFACIB..fEEAhCAAbEEC.CEHAMFGBgFGA.YGCAhBAAZGCAIHHAhCBANIBB...,2,-25,-8,17
CNTUfQVdJeROMagEbIHLAWZcSBDPXKFYG,ZAAABAAADACAKACAGAEA..TAFAQAGAdAHARCAA.aCCCECEBHDFBhABA.ADHA..SEBAhAGAFDGACEADUEEBfFHAhBEAeFAA.MEEBbFGD......hBIA......hCAA...,1,-13,-21,8
GEYBPRMbDVcJOSFKWHTNaUZAfIQLeCgdX,QAAAeAAAdAEAEAGABACA.RADF.MBDBDAFA...VCFAOAHDhAAAKEBAHEDBaBFDZDDAAAAALFFBhAGACDHDGFCB.PFHBhBEAJFHBFHBA..........hBHA......hCAA...,2,-15,-3,12
SQBfMNGIYDUATeELCZcFPRKWVXJObdHag,EAAAZAAAFADARACA.KAGA..XAFB.OAHDHCAAaCEA.QDEChABAMCCBGDDAhAAADCHBACIBeDABLFGBhACACDGAPFGBVGAAdHBB.BFHBNEIA.....hAGA......hAIA...,1,-2,-14,12
WBEgPFSbAcKXIDNUMadGVJQZeLCTOHYfR,XAAADAAAMADAGAGA..QADAeBBALBFDTAFAhAAAHDDBRCFAECDBFEHDAAHAKDAAhABAIGFAaEFCdEHA..hADA............hBIA......hCAA...,1,-14,-21,7
gGIRVNLWSeQCZBfXbAEaOPTdYKcJHMUDF,EAAAaAAA...OACCdADAKAFAHAFBDAIBGCDBRCCALAHB.eEABhAAAZDBABBBDXEEAACGA.hAFAPEHBTEGAJHBEMFFBhAHA...FGGH.......hAEA......hAFA...,1,-5,-25,20
LOARQZJafSMTIePUBGDVENHdbKCgYWcFX,RAAAZAAA.aACAMADA.eAFABAFAGBDAEAHBHCCCdCCCKBHB.CCFB.gCFBhABA..hAFAcDFDLEFAAAAAQFGAhCAASGGA.IHCADIEA..hAIA......hCAA...,1,-14,-23,9
XBCcIHZYELdebKMVGfFgQWPDATUNaSROJ,TAAAaAAA..RACFOAEABACBCAEA..HAFBEAHFLCEBeAHBMCCBhAAAGDGAFDDA.QFBAhBAADDHBAEAAUFGBSBBDhBFAXECD.IGEA....hCAA......hCGA...,2,-17,-17,0
DaVSEAGFcbICQLTMRgXeHOUdWJPYNBKfZ,GAAAFAAA..IADALADA.RAGFeCDBHAEBdAGBJCFF...hAAAPBHBBDHAZEAAaCCB.hBAAEFFBADDA.CFHA..MIAAhACAODFD..YHFGfEHA.SEEDhCAA..hCBA...,1,-8,-35,27
KECSJWcRDeNdBPYaIUOFAXfQVTZLHgGbM,QAAAZAAAHAEAGCAAMADA.EBHF.SCCAJAGBRBDB.eCFFhABAdDBABCHA.aDDHODHDhACAAAIB.fFGEhADATEGA.bGAACFEADGGBPHECIHHA.hAEA......hAGA...,2,-25,5,30
RWDQIXfSZKEbTOcGMVJgUHaCAYFPNeBLd,FAAAeAAAdADARADA.DAFAQAGC..XAGAZCCAECHFTEAAhAAAGBEA..MCCBgEEAhABAHCGBADBBPDDBhBAALFHB.fFCAbGCA..cGGAhBDA.....hAEA...,2,-13,-8,5
SdcXMaIOPFRCWDeETAQVNJHYLBgKZUfGb,QAAAVAAA.HACALADBKAFCZBEEGAFAdDDDMAIBaAHFODCBhAAARDFFDEAA..EEHFAAFBJDHBhBHABGHAUFDA.SFGDhCAAIHDA........hCDA......hDAA...,1,-11,-15,4
RCNQcLUZHEVFdMgfJKDWOGSPXabIeATBY,TAAARAAAQADC.LAFBHACBEAEAdAHAMAHB..fCCEhAAADAIBGCEAXDFAhABAbEAAABGBCCAD.UFCAZEGBFGDDhAAAKFFASFHH.aHBC...hACA......hAEA...,2,-4,-2,2
ZXYDUVObMdNfaGLQCcTBeKWPSAgRFEHJI,RAAAHAAAZADBDAGAOACA.dAGA..aBFAGBEALCCDQCCAhAAACCGD.TDGAeCHHKDABhAAASFGAAEEA.hABAEGBAXEFD...YFDBhADAbGFCMAIBfGHAhBIA...,2,-32,9,41
ALZFNBfXQUSDgaCEdPRKecMbJVOIGHWYT,ZAAABAAAQAEADACA.CAGA.EAEA.RAGBKBCAeAHH.MCAB.JCCFhABAOCBB.HCEBhAAATEEAAAIBLDDDhBCAFDHDXEADSDHHdGDA.bGCAIGGAhACA......hADA...,1,-15,-22,7
XgVOcRGENfBLbQYDZdeFHaKIMUPWCJTSA,XAAAOAAARADAGAGA..EADABBBDbAFA.QCDBhAEAZCDAeCFEHDAAaDFD.MEEBhAAAPEHDCFFASFHBhABA.AAGA.gFEGNIEB.LGAAhAGA.DIAA...hADA...,2,-6,-3,3
gMHTWIBfZFdJQALDOcVaNGXSYUKbPCReE,LAAAOAAA.aADDGADA.SAFAKAFACAHBRCAA.EBBBHCEAhABATCFABCHBZEFAdEEDAAFADAIBhBAAVFAA..XDBAhBDAUGGA.eHCA.gGGBIEHA.hACA......hAFA...,2,-16,2,18
WQINgPFaBbZLOfYJGUEXReMdcAKDHCTVS,HAAATAAASACE.QAFAgACBaBHDZAEBLCCAhAAAfAGAGDEBhAFAEBHFRDEAeECBdEAAACCBCFFDIFHAhAIAFEHDbGFC.OHBCYDDF...hBHA......hCAA...,2,5,7,2
fWEGgMNSKPbTJcOeFLZaUQRIdYHACDXBV,XAAABAAA..fACAEADAGAFAMAEAKAHB...TBDAhAAAOCDBLBFBhACAaDAARDGFdEEAHDGBAAAADFBBgFDAhAIASFHH.bFBDeBHB.FDDH.QGGBhBIA..hCAA...,1,-3,-9,6
EFNWcSbTZgXQKdCfMPVYOAeURILHDBaGJ,RAAAHAAABADBGADAFAFA...NAGA.SAHHZCAAQEFBdCCAMBFBhAAAVFAA..ACGBeDGFhABALAHB.aEHDEEDFhCAAbFDDXFGDCHHA.......hAAA......hACA...,2,-26,5,31
EJHUQXZCAPgbVaDLNGMKIeOWBYfScFTRd,...bAAAaAAA.LADAGAEAMAHBeAGHBBBDSCAAFCDARDFAEDDBhAEAHDDB.QDGBhAAAZFAAAAIB.gEAAhABADFFBKGGA.OFGB.fGBAhACA......hAEA...,2,-22,1,23
PNIKZGWXDJSULQRegdVaFbOYMEcTfACHB,HAAABAAA...IAEAGACADAEAUAGARAFAeCABdCADFCEB.ODCDhAAAECEF...TEFAhACAACHACDFAKDHBZGBA.JFHBLFFBhAAA.........hADA......hBGA...,1,-15,-34,19
fcFgUbNeHDSLaPRWAQXVKZOEBCIJYdGTM,QAAAKAAAEACE.CACA.JAEAGADA.MAFAFBHDUCCA..hAAAeBFEHCFBLDFAhAAARFCAAAHA.ZFFABEHAdGCAfHFBhBIA..gGGAhCAADDDB......hCBA...,1,-3,-33,30
EgGMBfcLFDTYZHOAXbJCKPSWUQNedRVIa,XAAACAAAKACA...SADAQAECeAFHRAGF..aCAAEAHBhAAAGDCAMCDBfCGAhABALEEBDCIBZDABHEGBhAAAAADAbEDD...PFFAUGAA.NECAIHHAhAIA....hCAA...,1,-9,-10,1
aAJGYHZOVcBSQgPKefWCdEIFXbTURMLDN,GAAAHAAAZADBOADABAFAQBGAKAGA.eCAACCDAECFAXCEDhAAATDGA..RDBFMEEBhAAALEHB.aFFAACIBVFFBhACASGDA.fHABWFCH.hAIA......hBAA...,2,-15,-3,12
VLQdYEPUbeIHFRcXJATWfKaZMGgOBSNCD,TAAAKAAAZACBGAEA.BAGACACBLAEAdCAA.EBHFUDGAeCCAhAAAHEBARCFB..XEEDhAFAAAIBaFFC.MDIBSGABhAAADFHBQGAAbGEC....IHCAhACA...hAGA...,2,-14,-12,2
BOJRHKTPFaWMbdEIeAXcCSLNVQgDfUGYZ,CAAALAAA.QAEAfACAGBGAZADBBAFARCAAHDCCKAHBFCABhAAAaAHFMEAB.EFDBhABAACFASCFAhACA.VEEADEIBOFFBPDCB.dGBA.IHGAhACAeEHHNHAB....hAEA...,2,-19,5,24
OUMLWbVdQDSPHZACIcXeaYKRJBNGFTEfg,CAAAXAAA..eACAaADA.RAFABCAAGAFAECCAOAHF.MBDBhAAALCFA.bDEChAAAdEBA.QEDAhABADEIBHFFBAACAIEHAKGAAFHCE.TGFA.fHABhAHA..hBEA...,1,-15,-16,1
LDMIQKRCfdEOeBNUSHXagAWbTYJcPVGZF,TAAAJAAA....VAEAZACBLAFA.MBEBQCCAhADARCFAdEFDECABeAHHBFCAhAAASDFBHGAAaEHDAAGAhACAbEAB...PDHDDGGBCHHA.OEFH.hCCA......hCFA...,1,-1,-20,19
RbZOWMBILaEfdXCNPVAKTcSDeUYJFGQgH,TAAADAAAeABA.UAFAFACAGAEA.HAGDRBDBZDFBMCCBLBHBhAIAEDDBdDGDCCCD...PFFAhAAAAEFBSFBAhBAAQGAAOFHBBGHA.......hBFA......hCAA...,1,7,-28,35
GCERZIAcSVUBfdMOWPJegYLDFHXNaQKTb,SAAABAAAdACAMAEAOACD..JAHBeAEA.LBHBhAAAHBDBaBFFTCEAGEFAREAAAAEAhABAUFCA..fEEEhAIAPCBB.DEGBNDIA.bGCCCHEA.EGHB...hAAA......hBCA...,1,1,-19,20
WeJCSTDHUbfFEdRaNGMXcIPVLQOYBZKgA,eAAASAAAHADAUAGAFADA.RCCBGDGAMAGB..XBCDhAAA..IFAAhAAALAHBQFCBhABABCEBZEEAABHBCCEAbFEDEGEAaEGA.......hAFA......hBIA...,1,-4,-20,16
WHQLIgGRTBFebcVDUKPNSCOAMfXdEZYaJ,MAAAdAAAEADAZABE..aAFDHAEB.LAGBGBGARCAATCCAFCEHeEFFhACAVEEA..KFBASCHHhAIAAAHA.XGBAhBAAYEHBWFHH......hBGA......hBIA...,1,-10,-17,7
KRFADObacYSCLUQNXMdIVBZHTGJWfPeEg,OAAAaAAA..SACHLAEAQBBBMAEA.dCEABAHAhBAAHCGBGBDAJEDFfFAAhAFAEBFBRCGFABBBbFEDCFFA.hAGAUGBAIGHA..TGGA..hBGA......hCAA...,1,-12,-13,1
FAVUEcNZSKILQaOXPJTDYbWCMeHgfdGBR,EAAAZAAAKADCLADA.QBGAaAFD.OBCBXBGDTDDAhAAADAIB...bDFDMCABhABAHEAAdCCDBEHAADFBUEEBhACASGHHJEHBCFBA.eHAA.fHEBhAEAFHAA....hAFA...,1,1,-23,24
VQBDYAHCNKSbMLEPIfgJUcZTFROXdGeaW,HAAAKAAAMACAEADE....fAFBUAGAZBCBRBEBdAHAGDGAeCAAaCEAhAAA.QDDAhACADEEBACCBCFFD.bDFA.LFGBhCAAIGBAJHDE........hDDA......hDHA...,1,13,-36,49
dfKWRYVXOQHeLAbNISGBJUgZECMacPDFT,..IAAAGAAABADAUACA.EAFA.aAHDDAFA.dBEAKCDARBGB...hAIAXCFDHDFBABIBSCBDhBCAZEEAMDABFDCHTGBAhBGA..fGGEYDDFOEHDhCAAeFAHNDIACHBA...PHDChAAA.,1,-10,-18,8
VIBbHaTUXERKDgecNPFfAZWMGLJdOQSYC,ZAAAGAAAdAEAQAGACADABAFAHAGBUCAARCDA.DCGBeDAD...hABA.PDDBAAABMDCBLDHBhACASDGAIFFAhADAaEFCEFHFKGAANIAB.fHEB..hAGAWECH....hACA...,1,-11,-18,7
SEbPKQGBTLWJZFNfXVMcReIDAHadUYOCg,HAAAdAAAOADASACE.EAFAKAGAGBGATBDALCCAhAAA.ZECAfCBAhACAMEGBRFABeEHHACGAaCGECGCB.bDDChAIA.BEGA.FFDDNICB.XFFC.IHHAhBAADAIB...hAFA...,1,9,-13,22
IeMFCdXZOWJBgHYaGbRcQUAPDNESVLfTK,DAAAEAAALADAKACA.eAGHMAEA.dBFAZBCA.OBHDBAHAHCCBhBAAGDDARCGFUFCBAAEASFGAhAAA.fGFEhAIATFFACBBD......WFHH.hCAA......hCBA...,2,-30,-17,13
MSVXAZgYDdLRFCWcGNBEIPUTQKfOHeabJ,ZAAADAAARABACADBGAEABAEB...EAGAUAGAKBHB.HCDA..eCABhABAaDCH.MCCB.XDDDhACAADHAdEFALEHBhBAA.FGBAcDGA.IFGA.TGAAhAGAOHFCbGEC..hCBA...,1,-16,-26,10
ESNXUTZLFfAWVagKHDPMROCdeJQYBIbGc,aAAAHAAA.MACARACFdAEAeAEA..QAGABAHAGCCAECFFXDGAhAGAZCFALEFBABBB.hBAAgGCADDEBCFFAIGHAhBIAbFGD...SHDA..hCAA......hDAA...,2,-23,1,24
LJKTacIBPFHOegCXdQSZGWfMDAVEYUbNR,EAAAUAAARACA.LADA.KAHBaAFABCDAHBEC.eBHHCCFA.dDAAZDCAhAEAGDDA.MCCBhAAAACHBVEGBbFGB..NIAB.JFAAhAFA.....TGEA...IHAAhAHA...hADA...,1,-3,-29,26
FUENQZGJTRfPLHeDSIXObYgCBdAaVWMcK,aAAAMAAA.FADDEADAZAEBGAFA..RAGBLBBBHCCAeAHBSCFHhAIAOBBB..bDGDhADACDDDADIBVFBA.KEEAQEGDhBAA.fGHEDIAAIHHAhAIAYFFF...hBAA...,1,2,-21,23
BVKAOENMaCFgRQZeJfcYTbUIGDWHSPLdX,EAAAaAAA.FACDRACF..ZAEBeAEA..JAGB..fAHA.hAEATCDAbDEAGECAhAIAHCFBLDHBdFFABHGAABBBhBAAMEAA.QFAA.cFFChAAA......hAEA...,1,-9,-23,14
VaDTGbeNHEIJPYSdfcXOBRMAWZCKLUFgQ,ZAAALAAAFADA.QAEAaAFD.GBGAeAHBHCAAECAAICDAhABAJCEF..SCGHhABAdEAAXDEDRFGBAEIBKGDAhACAgFGADIAA.bGBA.....hAIA......hCAA...,2,-19,3,22
HAFUMZILYbNecVOdPBEfaWTJCGQSXDgRK,MAAAZAAALADB..bABAeAFA.OBHDdAFAEAHB.aCCBTCAAhABAGCGAQCFAhACADDDAREEBHFBAAAFAFEEBIHHAhAIAcFCC.BFGA.fGFEhCAA.CHHA.....hCCA...,1,-2,-12,10
ZCVSaWEOXcLfHBDgYPJKTRedMbQANGUIF,GAAAFAAAZACB.SADAEAEA.OAFDLAHBHCDBDBGBgCGHhAAAJCEB.REAAeEHFhACAdECAMEGBAADA..IAHAhBAAaEHB.XFDABHBA..YFHBhBAA....hBHA...,1,10,-36,46
JEISDZTFbGXLPNdgAMQOHcBaRfCVWKeYU,MAAAHAAAaACARACA.CAFA.KAFC..eAGHUCCBECCADAIBZDEA..FBGDGFABhAAALDFAdFFAAAIB.hBAAOEHDBFCAVFFAhBBAYHDA..........hAFA......hCAA...,2,-33,-5,28
OBVDMWdRgCbSPLIUNZeGYFKHTafQEXcJA,BAAAMAAARACACACA....SADHLAFBIAHAZAEBGAGAKBBDhBAAHCAA..aCDDEDFFhAAAXCGDAAIBDDIBdFGAbEFChCAAUGBA.eEEDTFCA.QGGAhCFA.....hACA...,2,-13,-5,8
LBASEYHNbQdOWMDTfcCIaXUGVFKZPReJg,EAAAHAAA.QADCdADAMAFA.TAGA.CCAD.aBCBGCDBKBFARDDAeBHHhAAALEEABEHAAAFASCCDhAAA.hBFAbGCADFFBfGGAXGDDFGGA...hACA......hAIA...,2,-20,0,20
ABQDWeRSgNbKYVZHFfGcPUXCaIELMOJTd,QAAAeAAARADA.SACA..bAGBKAFAZCCAHCDAGDFAhAAAPBHDCDHAEEAAMDABhAAATFCAAAHADDCB.gEFAhADANIBBFFHD.fFCA.XGEChAFA.aHGE..hCAA...,2,-14,-4,10
FOSWRACZbYNBegHLPcUadXIJVTKMDfQGE,ZAAA..bAAABADBHAEALAFAUCAAdAHAXCAA..IDDAhAAATCFAMCIBhABAQCFDGDDAEEFFSFCDhACAADIBCFHAeGAAgGGGaFGBKGABFHGEWHCAhAGA.....hABA...,1,-3,-11,8
aNcXURDPfebLZWKYgISVdQACGBEHJFOMT,GAAAHAAAOACAaADA...XAFARAFFDAIBeCDBZCCAKCGD.IECAhAAAdDFDAAABEEBAMAIBhAGATFFAUFFA..fHABhACAWEHB.SDHH.CHCBBHHAhAHANEEA....hBCA...,2,-15,-7,8
JbUfcTXNgIEHAMPKDCWeSZQVFaLdBYGOR,MAAADAAAeABAZABEFAFAdAFAGBDA.RBGF.UCCA...TCFAhAIAXEGA.IFBAhAHAHEDCABFBCBHA.QGGAhBAAaCCBLGEABDHA......hCAA......hDAA...,2,-25,-18,7
YTNdgDEbKLJHaIVSFRUWCAOBeZQMcXPfG,eAAAZAAAMACA..XADAGAEBTCDAdAGAECCALDEAhAAA.HEAAaCCHSCGAhABARFDACFHAAAIBQGBDhABAfEFANIEBDCIB.bEGD.KFCA.IHAAhAHA.FHCA....hAIA...,1,8,-16,24
VHSeYdQFGaTEBKWXICDbOLcPNJfAMUZgR,ZAAARAAAHADBeACEdAFBGAFAEBGB.KAHB..XDAADCCBLDDBhABA..PDDBJDHBADFBMFAAhAFAgEGA.hAHASFEHQGFCaGHDBHDA...hAAA......hABA...,1,-12,-17,5
ADJWLCFUONGPbITYXRaBQESMeVZdgHcfK,DAAALAAAFACD.OADDGAEA..IAFATAGA..RDDBBCHAhAEAEAHBeCABZEBFHFGBhAGAKCCDACFACCGA...PDEDhABAXDGC.aBBHMDIB.dEGA...hAIA......hBAA...,2,-17,-17,0
BgCGDKUSRNOFXVTJQdYecWbfAZLHIMaPE,HAAAaAAABADAGADA.KAFARAEFFAGA..TCFAdCCA.eCAB.hADAbEFAABBBZCFB.MCIBhBAAECCBDAIBUGGAOFABhAAA.XFECQEDAYHCAfHDBhCAAIHGA...hDAA...,1,13,-28,41
ZHIOASgTLJGXEUVNKWfeRdQDaMCcYBFbP,TAAAGAAAEADA.UAGAKACCeAEA.RBFAdCCAaBFBMCDB.CDGABEEAhAAAbCDDHDGB.AAIBLFABhAAAXEGAVGDAhACAfGEAQGGCDGGB...YDAFhADA....hBAA...,1,1,-12,13
KdQfgWcYTBNbVGZeUHEXJLOaAICFMSPRD,FAAAMAAARACF.dAEA..QAEC..fAGA.hAGAgBBAcAGDTDEAhAHAbCEA.ZDGBHEBAhAGAEEDBLGFAAAIBSDDGKGDD.BEGDNIEB.eEHHhBAA.JFFF...hBAA...,2,-15,-2,13
dKJUXEALgFafBNQDTSYbWHORcMVGCPZeI,LAAAaAAABADA.QAEADAFA.TAGASAGA..hADAbCAAHBDCRDFA.MBBBhBAAGEAAZCGBeCCBdECDKFFDhABAXEDDACAAfGDAYEHBOHFCcGEDhCAA.....hACA...,1,-1,-14,13
BDUGTLfNCcVXMIgeAZOYSPHaEbJQWKFRd,ZAAASAAAHAEAEBHFQADAFCAA.RAFAdCCADAGAGCFALCHBhAAACCED.XDABMDABeDDBhABAADFAOEDC.aGAAhABAbEADKGEABEHAUGGAfGHANIAB..hACA......hADA...,2,-10,9,19
WFLHcMfKTQEXBSCVbRNZUYAgePJGaDIdO,eAAAGAAADAEAdADAFAGDHAFA.MCFBKBCA.ECGABBEB..CDDAREFFZCFEhAAAAAAB.JDDB..aDBDOEGBhABALEHB.fFAEhACA........hAFA......hAHA...,2,-49,-9,40
YGWgUbEfRBCIMeFSLAKNcdDPQVHJTXZOa,KAAAdAAAQADAHACBJAEA.ZABB..aAHDGAGA.UDDAECABRCEAhAAACAFAeDGDLEEAAAIBDDIBhBAATEBA.OEHDhACAgGGABGEAMHAA.SGGDhAHA.....hCDA...,1,-2,-20,18
UgXbaCKOTGBdRYFWZNSQfJVePIMcLDAHE,HAAAEAAAUADAXADB.CAFA.TAFAGAGARCBB.FCAHZCGB.QDDChAAAfCCAeEHHhAHAMCFBLGDAAAIB.hAAA.aDGH.BEDA.dGGANIAB.....hAIA......hBCA...,1,-5,-8,3
dAWGPSFLQIfHDVNMacEXCJORTgZUYebKB,GAAAFAAALADAQADAHAGBDCCAMAGBECEFCAHARCGF..ZDFEeCDBhAAABEAAADAB...SDDDhAEAfFBAaFAEXFDAhACATFGAgGDAUGGAYHAG.hAFA......hAIA...,1,5,-19,24
IEAYaBJZCUWFcfRPXdGNgTDMHQVSLKObe,aAAAZAAACADB..FADARAEF.dAGAGAGA..TBCAHCAAQDEBhABALCFAOBBHeDHHAAIBhACABDEDUGAA.fGFAhAGAXEFADEIB.MGBA.KGEAIHHAhCAA....hCCA...,2,-22,-6,16
DOCHXAGSbVgLMQFWdaRBJfZUPNKcEeTYI,GAAASAAA..bADALADA.MAHBQCDAhAAAdCCARCFBBEAAZAGBPDCBhACAKEDAEEHFeFCBTEFADAIBHFABhADAAAAAFGGHaEHD.fFDA.NHEB..hAEA......hAFA...,1,16,-19,35
dWXIEQVLeGZDOANFBSKfTJRUYbcgMPCaH,BAAAKAAA.JACARACFUAEA......bAFBMAHB.aCABHCBAhAAA.dBHA.XDEDhAIAEDEALEDAeECFZEGBhBCAAAIBSCHH.TFGAgGEDhCAACGBA.....hAAA...,1,-13,-37,24
FODMYdGRIHgTLZAUJQKVefaEPWcbXSNCB,QAAAeAAAEADA.....PACCbAFA.SAFBhAAABCCADCEAdDEARBGFHCDBTCGAhAAAAAHAKEGDaEGCXFCChBIAFGAAMIEAIGHALHAA......hABA......hAGA...,1,-6,-12,6
OYdHBZUGPXAfgcbQJeSITVFWLRaNDECMK,...fAAAbAAAeAEA...TADAFAHDRCAADAAAEAFEKBCD.dAHAhAAAHCEAZCEBGCAAhACAAAEAQECASDDFhADAIEHALDGBaEFDMIDABGEAXGCChCAA......hCBA...,2,-11,6,17
WJVAYESOUBFfDNIbMHcgCTKaZPGXRLQed,EAAAOAAAFACD.DAEA....IAEAHAFCCBBDaBDBGAFA.RCDBeAHBhAAAdCEAVDGBADHBSEGAhAIABEDD.bFDCMFFBhAIA.TGCAKGHB.XGGA..hBAA......hCAA...,1,-9,-22,13
PDbGZdJUgKXAEWBNTRYFeLHQIMaCcOfSV,EAAABAAARACA.eACAHAFBMAGBCAHA...OAHBSCCA.DCIBhAAAZBCEdDAAUDDAKDEAADHBTDAAhAAALFFAQEGAhACAaFAE.fGEAPHAAJHFAXGGChADA.....hADA...,2,-12,-7,5
WZJecINLORgTPBHdbQFCUADXaYMEGfVKS,aAAAEAAAGACA.KAEAZACB.eAEA.IBHALAGBRCEA.TEAAhAAAHECAdEGAQCEAhAEACBBDACEADDIB.MAIBSFABhAFAcEECOEGFBGFD.....hAIA......hBAA...,2,-18,-4,14
UdEfGTYBDRAOgSVKcZFaPbJQNCWXIMHeL,SAAAKAAAZACBFAED...aACD..JAGBQAEA.CAGAXCDDhAAAHCABeBHHdCHAhABAEDEBGDFABEGDACABOEABhAEA.gFDBPFDB.WHDGMEIBhAAA.fGAAhACADIAA.cGGCIHHA,1,4,-26,30
ACcYTMLRgePUHSJDFKIaVGOZfEXBQbWNd,CAAATAAARACA..eAFEHACB.DAEAKBFAaAFEGCAAZBFE..ECABQCCBhAAA..hACAbDEAdDFAADIBMEDBLDHBhADAgFFBSEEDFEBD.OHEAXGDDhAAANIAB.....hAIA...,2,-13,6,19
EWJDXTfOCRbGHYeVBQAZcINKdPMSgFLaU,ZAAA..IAAAdAEAMAGBFACALAHBUAFA.ECAADAIB..TDDAhABACBCDRCDBHDFB.eDHBhBFAQEBCAFDB.hBHAKEGASGHDaFDEXGEA.OHBChACA......hADA...,1,-12,-25,13
RCESDVTNcafWIOdPeGbgKAFQBHYLXJUZM,QAAAHAAALADBUADARAFAECABDAGA...TCGAaBFA.IEEAhAAAdCGDeDBA.bDFCAAFABCCChACA.XEGAhAIAZFGBMEEBSFCB.cGEAfGFAhAAA....hBCA...,2,-20,3,23
AWONbTIMGcJBHUDQaEZVXgCLPfFYKRedS,OAAATAAA.GADABACBHADBQAFAEAFAZBGB..XCGAhAFALDFDFBBHRFAAeCCBhAAAAAIBbDED.MCIB.cGCDhAFADDDBaEHH.CHBA.fFHE...hBAA......hBDA...,2,-15,7,22
RfXGQBIJVPAbYNHcFEKLZTOeMgCUdDSaW,...bAAAHAAA.EADEZADBeAFEMAGBCBFAdCADaAHB.RCFAGDCABCAAJCHBhAAAACEB....NEHAKFEAhAAATDEA.OCCHhABADEIB.fFBE.QFGBhACA......hBFA...,1,-12,-17,5
EIZMAfQYTSGVbOWFUNCHgKaPBcDdRLJeX,QAAATAAA.GACBOACAFAGACAFAHAGBaCDC.BBDDdCFARDAAeCCBhAAAECHB.ZEDB.AAIBSDGAhCAAbEEA.UFFAhCFAKFADDFIB.........hDAA......hDBA...,1,-7,-14,7
GMeWcNRLaHZfYBgPEOFSJQbUCTVKdXDIA,eAAA..NAAARAFAHADAZBBA.BAGB.EBHFSCEHQCCCCCGA.hABATDFAdDBA.DDIBAAFAGEFAhACAMEEBLFAAhAAAaCHD.fFFE.PFHBODDHhADA......hAEA...,1,5,-26,31
EJAQPTVCcRDMBKSFLNdUYXIbefaOGgWZH,TAAACAAARACA..MAFASACB.LAEAdBGAXCAAhAAAeAHHaCCCGDDAZCEBHECBhAAAAACAQFGAPEHBDFAAhAFAFFCH.NIDB..IGAAOHECWBHHEGEA.hAGA......hCAA...,1,5,-16,21
HQAJGfNOFgWZeIMRDPYaEbXVdTBCcKUSL,GAAAOAAAFADDZADAeAFE.RCDA.DAFA.aAGEECHB...bEAAdCFAhBAA.TEDABEFAKEHDhAAALCHBACDA.fBBEhBFAgFEGMFGB......hCAA......hDAA...,1,-11,-34,23
CBXFSTYJNDAaKIMceHZWREQgOdGPVUfLb,aAAAMAAAHACBRACA.EAEAQAFC.dAHAGAGAUCCBLDFAhBAAbCEDXEAAFFFASFHHhBBATFGA.JGDAhCAAAAIBKGBD.eEDDWHDGOBBH...hCBA......hDAA...,1,10,-13,23
cfTKLUYdFBXNHVIDPgeSMaGOCZRQbEAWJ,JAAATAAALADB..dACABAFAHAEADAHBeAHH.aCDDGCEAhAFAZDFAREAAEFFAAAIB.fGAEhAAAKCHBFDCH.XGCAhAEAIFHASGHBMHEA..QGCAhBAA...hAGA...,2,-32,3,35
VLEGBZQNFXTSWeYHOCIKgRaAdcDMUfJPb,dAAAMAAAUADA..JADB..VAFAEAFAZBBFFCBD...SAHHhAFAeCHFHDDACCFAKDGARFDAADFA.hACADEEB...bFCDBFHAhAIA.NIEB...TFFA.OFHDhBAA.aHFC....hBHA...,1,-18,-24,6
RYFKWeXMIgDbEGQcUPTVNCLJSdBaZAfOH,HAAARAAAKADC.eACE.MAFADAGAEBEAGBEB.QCCCUCGA.hAAATDGACCCALDEBhABAdEEAZGFEABHA.OFDHFFHB.hCAAIHBA..bGDA.....hAAA......hBHA...,1,6,-33,39
LOUBbJVQEdaHCDgcAYfGKIXFRSeTNMZWP,GAAAXAAARADAeAGH..MADAZDCALDHBBAGAVBDAEEABHCGBhAAADAIB.AAIBKDBAFEGBSFCAhAAATEEA..hACAPFHDbGAC.dGDACHHA.......hADA......hAEA...,1,-5,-10,5
FbSZWIGRfagUcQXdMCOJTLDNHYVeAEKBP,EAAABAAAFACDZACA.GAGARAEA..aAHDUCCA.QDAAhAAAdCEDMDDBODHBLDFBHEABhAAAeDHHAAEAKEEASEDAhADA.fFAEXGEACHADDGIB.NIAB.hAEA......hAFA...,2,-14,-11,3
NIgWdCQfGMEPbKUBHTLVXAReDJacOSZFY,RAAAeAAADADA...aADDSAEAZAEB.FAHBIAHA.dCGAhAAAQCCAGDBAEDDBhABAbCEDBEHAHDGDTFEAhBDALGCAACIB.cGGC...NICB.CGDDfGHAhBGA.hAAA...,2,-23,-7,16
GUBaOYPLcHNRMeCfXSAKVdWFbETDZgIJQ,dAAAFAAAEADAZABB..JADBGAFA.BAHAaAFA.OCCBLBFAHDEBhADARDEA.eCHF.XECDhAHAADEAKEHB..VGBAhAIATGGA.DEIBQGFAYFBF...hBAA......hBFA...,2,-23,-9,14
MRfBTNXJOPeESdHgIcGYZCVFDLQWAKbUa,KAAAaAAA.RACFBAEB..TADA.XAFBOAFDEAHB.HCABhAAAgBBGGCDAZDGBhACAFAHDLDABhADAAEIB.bCEDMFDBfDGB.PFGDhBAAeFFDIHHACEDCDFIB.hCAA...,2,-11,-11,0
PIfKeVWcQTYRUSdMbAFaEJCZXLDNGHOBg,EAAAZAAALADBGACAHAEABAFA..gBGAIAHAeCABhABAVEAA...QCFAhACAREDFdFGAAAGAaGEDXEEChAFAODHF.KCHB.TFGA.SCCDhCBAMIAA.bFCDCCBD.DFCB.hAAA...,1,5,1,4
bJZMgBVWSAGHFDCNPLaYdOKfcEQRITXeU,HAAACAAALACAdADAKAFA.EBHFRAFF....TCCAeCABUDDAZCGBMDABhAAABCFB.SCCDhAAAAAHAGEEADDIBaDGEfFAEhACAQECBbEADgFEAFGHB.PHFChAFA.OHAEhAHA...,2,-8,-1,7
GAOJebQVcTSXIaRfNUHCKBMWDFZPEgLYd,eAAAQAAA..TADAXACARAFFUDCAHAFABAHBMCDBFCHBhAAAECEFLEEBGCGAAAHAhAAAOEGBbDAB.SFABhABAaEFHCGDADFABZGFE.......hAFA......hCAA...,2,-21,17,38
VBXEdbAZgJPNKMOQDGFSLReaYUcCTIWHf,ZAAAJAAA.KADC..MADAQAFAGAGALBEBRCAA.eCCBhAIAaBHDUDEA.TFCAhABAHEFABGBA.EGDAhBAAACAAPEHBDGHB.SECC.CGEAfHBBhACA.hBGA...,1,-14,-23,9
CRgJOWAadVYIeDMLfTFQNGBZcXbESUPHK,dAAAVAAAeADA.MAHBLADB.TAFAQCBA.GCFAhACAZCFAbDCCEDABSAHBhAAAHDDBRFGFOFCBhADAAEGAaFABDFFANAIA.BFHA.XGGC.KHCAhAFA......hCAA...,1,9,-11,20
BUYDHdIMePCZKfaVSNRGAEJLTXcbOFQWg,EAAATAAA..XACAOACA..QAFABAFADAHBHCCAhAAAdBHAeBDBZCFFaBHDSCCDhAAARDABAEEALEHBbDFCFFCAhAIA.gFGA..YFAFhADA.MFFBCHFD...hCAA...,1,-5,-6,1
GbgSPWcUAQEZaBOReHMFCLfJKDTYNXVId,EAAAaAAABADARACA.HAEBMAFALAGB.KBBDTBFA.XCCAhAAAdDADbDCDSCHHhADAPCHD.UFEAhAIAABHAZDAAeHFAfEFADEEA.YFDBhADA.IGGAgGBGhBAAWHFA.,2,-27,4,31
ZFIYXdCKeEQWAJbDVMgaSPNRLBfHTGUcO,DAAAMAAA..aABESACARADF.LAFAHAFBGDDBOBBBhAGAZFAAFCDAXEGAhAFAdCGAeDDBEAHBACIB.JHDEbFED.hAIA.gGGBBEHATGGA.IHAAhAHAKCCD.....hBAA...,2,-5,-5,0
PGIFBUXHWacLgZSAJENVedOCQYTKbMRfD,EAAAeAAAdADAQADA.KAFARAFADBCBGCCABCEAHCFAaCGDLEEBhAAAZEFAAAAAJHAAOHEAhAHACDBD..TFAAhAFA.MCIB.fGGA...hAIA......hBIA...,2,-24,-10,14
FBXTcKNaSHOPIbLgeWJRVCQfdYEADGZUM,ZAAAMAAABADB..TADAKAFA..aAHDHAFB.OAHF.hABAbBBDeCAB.RCCAQCFChACAdDDAABBBGDGAXEEChAFASFAALEHBgFDAJHAAfFGAhAHAEHAADGGB..hCBA...,2,-24,7,31
cAYCKaZOVTQdFfGgJBSPRNebIHEULMXDW,KAAAZAAAOACAQACCdAGAGBEABAEBRAFF...eBHHHCDBECCBMAIBhAAADECB.ACHB..aEGATFGAhABAFFDH..fFFAhAHASEEDPHFCbGBC.....hAIA......hBGA...,1,-12,-15,3
DVNFUfWRJHcLSGMXCPAIYZQbeEaTOgKBd,ZAAAeAAAEADEOADCBAFB.dAGADAHB..FCCAUCAARCEFHDGBLCFAhABAGFAB.MAIBCCDAAAIB.QGEAhAAA.aGHDhABATEEA.KEGC.fFHA.hAFAJGCA...SGGDhACA,2,-27,-5,22
ZMgASRKeQWIGXbTHfYCOEDBVLJUFPacNd,RAAAeAAAQADCGADA..TAFAHAFBCAHAEBHFBCCDLDBBFCHDaDEBhAAAdDFA.ZEGBAEGBKFAAXFEChAAA..bFEAOFAHhABADFIB..JHAA.......hAFA......hAHA...,2,-13,-1,12
CQIcWYSdUTGJKDbMLAZXVBfOPEHaNeFgR,ZAAABAAAOACAHACAeAEERAFA.QCAA..ICEAhABAcBGD.SCCDhAGA.dCHAGCDAhAAADDGBbEEDAAHAfDHAEGGEaHDC.FFCB.CFFAYFHBhACA...hAIA...,2,-25,-1,24
LHNVfCAIWBQgJUYPXOZedTcEKGSMaDFRb,BAAAQAAAUACA...XACAeAEAdBHAEAFAGCEA.aCBChAAARBFAHDAA.fCDEhAAAACGA.gDFAhADAPEDBZFABTFDASEHBMDIBFFAHhAFALHFACGGAWHFA..hAIA...,2,-16,-2,14
fIZMbOWKSCJTLXVgBPcFQREHeAaNDUGYd,aAAADAAAGABB.dAFAZACB.MAFAOAHBSBEACCCD.TCGAhBAALDEB.XDGAhAEABBBDFDEBEECAHEBBhBEAAFHBUGGBfEGE.IHHAhBFAKGDD.JFFF....hBHA...,1,-17,-19,2
GVTIAXfgFQLKCeUZHcdbYMWRNPODSJEBa,XAAAFAAALADAKADA.eAGHHAFB.dBHAMAIBRCDB..ODABhAAASCCAEDCBGEGAhABATDEAAAHAQGEChADAZEAAbEGD...YFABPHDC....hAFA......hCAA...,1,3,-13,16
AFdPVWCQcfGZRXYTbLBUNaDJHMIgOKSeE,dAAAVAAAQADA.GAGARADFTAGALCCBBCFAaCHDHDADhACA.MDGBODAAeDHHhADAAAFAFEEACAFAZEDB.YFFFhAIAbFCB.DIBAgFGA.SHFGhAAA...hBAA...,1,6,-13,19
eJZICTLQfSHdPNVcbGaFAMDBgKEWRUXYO,MAAABAAAEACARACA.UAFAOAFA..eBCAZBFECBBDLBHB.hBAAQCACHCDBdDGAPFFBhBGAVDDAGGDBhAAAADIBKHGA............hACA......hAIA...,2,-20,-16,4
EQAeTSNWMcbBYLICHKfFJDXdZgUOGVPaR,eAAATAAA..SADAMACABAFALAGBHAGBFBDBDAIBZDEAOCCAhAAAGFCB.aCCHEDDBhABAAAIB.NDFA...bGFACDHAfEAAhAEA.dGBA.gEGGhBGA.....hAAA...,1,-6,-15,9
TKcGNRZPgWXQVbOaAUHMEeSfIFBLDJCdY,HAAAEAAA.eACESACAFAFALCCACAFAdAHAKCCAGCFA.RECAZFGBhAAA..gCEBhAAA.QDAChADAOAHDAECAMHDABDHADEEB.TFFA.PHBAhAFA.WFHB.hCAA...,1,-6,-11,5
AQHXLNbOGRKVgUBaSMJYedcFWPIZCDTfE,HAAALAAAOACARADFKAFCUAGABAHA..aBDEMCAB..eCCBhAAAdCFAFCCHIDGAZCGBDDIBhABAEEEB.ADIB..QGBAhBGAXFDA.bGFA..gGGAhACA......hCBA...,1,-3,-28,25
cOESJbCfdBYNFVMaQIRAWTPHZXGUKLeDg,TAAAHAAAGADA.LAFAeACEDAFAOCABEAHF.SCCDhAAAbBDA.dCGABCCDhAAAFEFHaDHDRDEBACIBZEGBKFDBgGAAhACACDBDfEDENICB.MFIBIGHAPHDChBDA......hCAA...,2,-10,14,24
IUASOBCdRNYMTEGDgKJWVbafcXZQeHPFL,BAAARAAAMADAEACA.GAEAKAGA...VCAAaBDD....XBFChAAAeAGBHDFBLCCDhABAAAHACDHAdEDATDGADFIB.hAAAgEEB.bGDCfHGBhACA......hBEA...,2,-19,-13,6
JSaKNcUQTPLHbXWREfFgDMAGdZVYIeCBO,ZAAAVAAAeACE.OAFAaADA..KAGAUBGB..TBDAHCCCbDGDhABARCFAFDDH..MEFBhCAAAEHAdFFACFCABHHA.SGEDhCBAQGAA.XGCA.EHGAhAAA......hAGA...,1,-7,-19,12
gIcADLBfRFZMaJeVEHNbPSGCQdTXOUYWK,LAAARAAAZADB.aADDeAFAHAFA....bBFAGCAA.dCFDhABATDAAOCHDUDFAhAAAKDDAgFFAhACAACCABEECMEIBEHAASGAACCCD.XGGDhABAIHHAfHEFhADA...,1,3,-20,23
NGPVgFZJQKaHMfOCDSeXdYBRTAIbEUcWL,EAAAUAAALADAGADA...VBGBZAFAQCFAHCBAMCFBCAHBeDAAhADAdEAABECAAAGA..hAAAbEFANEEA.FFEH.aGGBDFGAhAEA.XGGA.......hAIA......hBAA...,1,-4,-16,12
AgMOLFGNEUTbeQcZKdXISHBfJVCDRWPaY,MAAALAAAGACBEAEAUBGAeAFEZCCA.dCGASCAAHFCABEEDhAIAVDCARGFA...aEABhABAABBB.FEGANCIA...bFCAhACA.KGGA...fHAB.DIGAhAEA......hAHA...,1,-9,-13,4
aEIfRYFQDPLKgMVeNCGXTdBJcAOUSWbHZ,SAAAHAAAEADERAFFFBHDQADA.LAGBMCABeCCBGCCAhAAAdEEABCEDAAIBOCHDhABAbEFDZFABaDAB..fEFAhADADEHB.KFBBNEIA.TGGA.cGCDhBFA.....hAAA...,1,4,-6,10
cAgTbUGIQNOZVXKELWaePBRYdCDJFHMfS,TAAAGAAAQADA.ZAFBKACCEAHFaAEDeCDBRAGBdCCADCIBHCFBhAAAMDABSDHHhAGA.AAIBUFDAODGDhAAAXGGALFBBBEBDCFEAfGGEhACA......hADA...,2,-7,-6,1
eGLdEPUBafcOYVCZXWTKQMSbHJRDANIgF,..IAAAeAAAdAEAUACAaAGA...OAECCBCAZBFB...TCEAhAGAMCHBHDDB.REBBAAAAhBEAFBHDEFGBfCBEhAHA.VEFAWFHHQGCA.SDDDhAIADCIB..hBCA...,2,-24,-12,12
VKeUSPgQBOGJMLHWfIZXTcACaRNYEDFdb,RAAAEAAAdADAKACAUAFA..SAEB.QAGAGDDAMAIBhAAAHCCA..fCCEhABAZDFBTGAAADGAaFBBhBFADDIBbECC.eEHDBFGA.LGFAXGCDhAAACHBANIEB.....hAGA...,2,-15,-4,11
BUdNAWafPHEJLQbKVeTgGDFCMSXZYIORc,aAAAHAAALADAQADCKAHB.eAFEGCCACBFAMCABZCFA..OBBBhAEARCFABCCDdEFAADEBfEFEhAAAEEHB.bEGDTFAAhAFADEIB.XGCA.IHGAhAHANIAB......hBAA...,2,-8,1,9
dNRIKZBWbVOGaLUPTcXSDeEgfQHJFACMY,MAAAdAAARADAZABBBADA....VBGBaAEDLAGB.TBBAhAIASAGE.ECEFhAEAQDDAHDCBAEGBCEHA.hBAAIEGAKFEA.bGBA.OFHD..hBAA......hBBA...,2,-29,-20,9
JcRNQAFGLMOXIZKfCDPegUaESdYWHTBbV,GAAAMAAA.OADAZABECAFA.eAGFUCCAEBHF..dAHAHCDBBCFAbDBDhAAA..JDGBREGBADIBLFAAhAFAKFFDDGEB...aEHDhBAA.....SFEB..hBHA......hCAA...,1,-2,-35,33
GOVADgePXTSbLHfCZBRKUIadcQFNWMEYJ,eAAATAAALAEA.HBCAZACBRAEAKBHBaAHDdDEAFCAHMCGB.EDHBhAAAGCEBAAFA.DECAXFGDhABAbECA..BEGAhAAA.IFAANIAB.YEHB.hAIAOHAA...hCAA...,2,-13,-2,11
BXKFDHMfbSQTIcGYJLdRgeUVZAPCWaEON,CAAAEAAABACAFACD.HADB..MAEASAFAQBEA.TBGAhAAAGCAA.LCGBhAAARDDBeDHFZEBFAAFAaDDCXGEAhAIAfFDA.bFFAIHHA..hBEA......hBIA...,2,-15,-11,4
POBTIWYCXDLgVbcMAKNdREZJFHeGUSQfa,dAAAEAAAZACBHADAGAEAQAGC.aCAEBAGA.TCGA.hACAIEBACCEALDDAhADAVEDBbDGD.ACIBRFAAeFHBhAAAfGFEOGACXGFDDIAA.MIAAhAGA......hAIA...,1,-1,-7,6
HBWDCJbaMAfYPcFdVKTSZIeNRGUEQgLXO,...fAAAPAAAdAEAKADAZAFB.eAHFRAFFEBCBLBDDHCABDAIBhAAACDHA.aCDDACCB..FEFBTDGAhACA..SFHBhBAAGFABQFECXGGD.BGHA.hCAAWHAAMICA...hADA...,2,-15,-3,12
HfdMDebEagLRVFTQPBAGOIJKYUSNZCWXc,GAAAOAAAKADASADAZAFB.CAGA...XBBCHCDAdCGAeAHFhAFAEDCBaDAHRCDB.TFEAhAAAQEGAAAIB.IFCAhBAAUGAAcGFDMFFBDGEB...gGGGhCAA..hCFA...,1,3,-21,24
VIgJWYbcadQOHCeMAUFRPNBEfGXTLKDSZ,RAAABAAAEADE.GACALAFBSAEAZBGB..ICCAJAHB.hAAA.bCADdCEC.HFFAhAAAeCEFAAHA.FDFDNICB.TFGAhACA.DDIBWCHHaGCACHAA.....PHEChAEA....hAFA...,1,-12,-14,2
DXWAIcTJQOBRYfGSeHMagZdVFLPbUCKEN,TAAAQAAA.RACAGAFAHACBaAEAdBHALAHBUDAA.EBEEXDDAhAAAABHBJCAF.BEGAhADASDEAeEHHZFAEFEDHhAAACHAADGGBIEHA.OFFB.fGHAhACA...hAFA...,1,1,-5,6
SFdWARGEPIKQcfaZegLXTMOBCUHbNVYDJ,EAAAKAAAQACC..aACDeAEELAEAMAIBBBEAHCDAbBFAhAAAVCFBDCBB.FDGDADDARFFAhAAAGFAB.IGGAhAFAfHABZFEF........hAHA......hCAA...,1,2,-27,29
cDOeSHLUAWdVZafbXKBEGPNTRJgICYMQF,dAAAaAAA...XADAEADAGAFA..TAGARCCAJCHB.CCBAMCEBhACAQDAC.DEEBeCFFhADAHFBBACIBZEAAKFFABAHAhADAgEGAFGHDSBBGLHDAUGAAhAEA......hAGA...,2,-9,-1,8
fFELZPQCDSBTdAeKIJMbRWgGYXOVNcaUH,eAAAKAAAMACARADAGAGA..OAEE..cCCAHBCAEBHFhAAAZDEBQEAAhAAASCEAdEEAAAIBIFHAhABAbEFD.gGAGYDHBNHABaFCF.FGFD.CHHA.hAEADIAA.....hAGA...,1,3,-5,8
FaIGSAdRgMHPBNEJCVQDLfXceOTbUZKYW,RAAAHAAABADBEADE.CAFB.QAFALAHB..XCAAeBHHTCCAhAAAZBEEKDDD.FDGHGCEAhABAAEFBdGGA.MECB.PEHDhAFAVFDBDFIBOGDC......hAIA......hBHA...,2,-13,-3,10
IdKHaRQLJBEGcWSYTfOPZUCVMbFXDgNeA,dAAAHAAARADALAGBEADEGAFA..SCAATCCAOAHFZCEBCDCA.hACAMCABFDHD.DDFBeEABhADAADHBaECCQGEAhAEABEHA..cFGCfGHAPFAD...hAIA......hBAA...,2,-12,3,15
OYQgAIMJXSdDKEZFHBNVCPecfGLWUbTRa,MAAASAAAdAEAKAGAEADA..HBBBBAFACCFA.eAGHGCGALCCAhAAAUEBBREEBaBHD.QDAChABAABBB.XECAhADAZGAAFGHD.PEHB.fFFAhAIA......hCAA...,1,-13,-14,1
BNEYLDQcCeHSFKaWfPdMbgVGOZTRXIAJU,BAAAEAAALADAQACAeAGHHAEA.KBHBaBCC...fCEAhAAAdCAAbCCCGCFAhAAAZDFEREAAAAEAUGAADAIBSFGAhCAAFEEHMEIBOHDAXGFC.IHDAhCBA.....hACA...,2,0,0,0
fCeMLBEPFNUHcQTbRgdJXSAVZGIYDOWKa,GAAADAAAKACA.aADA..eAEEMAGBLAHBEAHB.FBBHHCDBQBEDhBAARCGFdDCCSEHHhAAAADDBZDFA.OFDEhACACEEDBFGANIAB...cGFC.....hAIA......hBAA...,1,-1,-29,28
RLUENPSAeKQgaHIXGOZMdJFTWcCDVBYfb,eAAAQAAAHADAGAGAZACBdAFAFAHB..TCCACBECBCHAbCEDRDEA.hAAAEEHF...SFAAhAAAADEAaEGE.OGDAhABA.MIAAcGGADGIB......hBCA......hCAA...,1,11,-33,44
DbXgcVHIQAMGJfWCUSLRaZdePBTYOFNKE,GAAAJAAA.CADALAFARADFdAFABAHA..TCDAFCCH..KCGAECFEhAAA.DCIB...bEFBhACAXDAD..hADAgGAAHEEAAEGAMEIBfDCE.hAHASDADeFDB.hBAAOFHBcGGC,1,-7,-28,21
UTEDOfaXcRASMFebdZBKYLVWPGCNJHQgI,MAAAeAAAZADBKADALAFB..PAFCGBBACBCA.HCGBQCFAhAAAIAHAEEEBfDEEhBAA.aECDhBBARFCBACIBFFGHdFHA.BGFAWFHHNIEB.....hABA......hAIA...,1,-5,-19,14
UQIAORFZMPCfVcNJXbaEKgBSdYDGeWTLH,RAAAZAAAMADACADB....VAFAJAGB....aBDDECAABCCCdCEAGDFAhABA..eBHHhAAATFAAHCEB.QFBAhABAACIBFEDH.fEHANEIAKHDA.SFGDhAIADIAA...hACA...,2,-20,-19,1
bLYgeJSVGdUXQACWBOEMcIfFRHKPDZNaT,BAAAEAAA.MACA..fACAHAECDAIBaBCBTAEA.LAGBhAAAeCEBSCGHhAAAdCDAQEAAADDBODHDhAHAFDFHREGFZFCAbGCA..gGFH..hCAA......hCBA...,2,-20,2,22
VREcbFIadMQULSDTXfPGWCKAJeOHgNYBZ,eAAAHAAA....gADBBADARAEFEAGEFAFAdCCAMAIBLCGBhAAATCCA..XEDAhABAGCFAKCADACIBOEHDhAIAZFDBbFGDaGDB...SGEADFDB..hCAA......hCBA...,2,-18,4,22
fFeYbDKCMBWGQELZHIcRNOaXPUJSAVTgd,TAAAdAAAeADA.DAHBMACAGBFALAGBHCACREABaBDA..XECAhACAPCCB..SCHHhAAAAAIBVFGB.FDFHbFEDhADABEDA.EFGA.ZGBA.IHHAOCHD.hAEA......hBAA...,2,-2,2,4
TCacIJDgPXWYKHVFQNGBAfRESOeZMbdLU,EAAAeAAAZACBdAEALAFACAGA..aAHDICEADBDB..XCEAhAAAKCGAHEBA.QEEChAAAGDGAACCBREBAMEHBhAGATFEAgGEA.PHAAYGAAhABA.NIDB.SCBFhAHA..,1,6,-22,28
SRVQaFfGMZXBPTIDJbHdENULWcYeKOgCA,RAAAaAAAGADAZACB.BAFA..TAEADAHBHCFAEAGELCEAhAIA..cDAAeCHHOBBBhBAAAAAAQEFBhADAMEEBXFFCIFAAdGHA.WDDDKGCBSGHHhCAA..hCGA...,2,-12,-10,2
cJONHGfTQVRAWdSgaYePLEZbBFUIDXMKC,dAAAaAAA.eADALADAEAGA.ZAGBFBHDDBBBKCBA..CCCA...OCEBhACAHCEBGEAAQDFDhADAAAEASCHHhBAA.gECBbEAABFGDXGCAMFGBJFHB.hBIAfGHA.hCAA...,2,-14,-10,4
PgXSHcLOBWeCdAUZQFJYaTDEIVRfbNMGK,ZAAAQAAAFADA.aACEEAGA.RCAA...bAEDGCEA.KBHBXAGAhAAAHDGBLECBhABABCDCeCGHACAAUGAATDAAhADADGGB.fEEA.MDIBSGDHhACAOFGDdGAAIHHAhAGA..,1,1,-11,12
TMRLOBUeFEgdfNbZDCHSVKIGPcAJQXaWY,QAAAaAAA..TADARACALAFBBAFBeAGHEAHBdCEC..hAAAbCCAZDAAHDAAKCHDGEFAhADAAAIBXDGAMEIBFEEHhADANIABCHHDSBBG.IGGA.hAIAPHDC...hCAA...,2,-1,1,2
EPaYBCfOILGUgASWKdTZHXMVRQebJcDFN,KAAAZAAAHAEAMACA.RCAAeAHH..JAFBFCEHEAHB..aCGHBBCAODHDhABAGCDA.ACHBdDGDhAAATFFA.QEABhACAbEBD.DGABPFFACHHA...fGHAhAIA...hADA...,2,-25,-6,19
QaDKJNPHMLTCUIeEGcZYFXbWSOgRVfABd,dAAAaAAA.KADA..JADAHAFBLAGBCAHA.UBBBECBAZDAA.FCHDXCDDhAIA.SCHHhBAAREDFADDAQFAAhACADEGBMFCAeFGBGGCB.bFGDWFHB..hADA......hAFA...,2,-16,-10,6
WZHJCNeAbYUBGMOcaLTPQKDFSXIdVfgER,UAAAGAAAMADAaADALAGB.QCDAFAGDXBDAdEGAVEBAhAAAECHFZDBA.HDFBhAIACFFCAAIBBGBDOEHD..hBAAcGCD.KGHBDIBA......hBCA......hBDA...,2,-21,-4,17
HCRYAeJdGSKTLaFEDBfNXbWVgUIOQcMPZ,eAAAGAAAKADAaADADAFABAGA...XBGAVBFA..UCCAhAAAQCDAMDFBHEGBhABARDBFAAABdDFA.LEHBhACAEGEBNIAB.bGAA.IHFA....hAGA......hAIA...,2,-21,-8,13
IaZHPDRAFMGBCVKObXSNTgdQLJWfcYUEe,GAAACAAAKACA.OADA..SAEBTAGAdCDALAGBhAAA.JCAAfCFAhAAAUECAEDHF.eCHFZEFFDAIBhACAAEGBMEIBBFHAbDBDXGBCgFFG..hACA..WFFD..hBGA...,1,2,-31,33
TMVZaERYKdCQNLFbIADcUSgHJWXGeOBfP,DAAASAAAHABCJAEAGACA.BAEATCDAZAFBRCGF..dAHAQEAAhAAALCFBbDGDhBAAAAIBUFCA...XEEDhABAeCCDfFEEMEIBEHGECHBDIHHAhCAA.....hAEA...,1,-8,-9,1
YZQLFMCGNUORAVWbEKDPJfHIdBTSXcaeg,VAAAEAAADADA....JADAHAECBAGBTBCA..XBGAhAAAeAHHZDEALCDBhAIAMCBBGFCBOCFBACFBbGFAhAAAfDGAdHAB.aEHD.....gGGGhCAA..hDAA...,2,-34,5,39
WMXQLGbCVFOcBSNKYIETdJZRAeDPUagfH,eAAADAAAUADA..aADDHAFAMAFALBBBGBEA.CCGA.OBGFhAAASCHHKCCDEEGBdDDARGBAABIBhABA....fEGEhAHAQGGBbDED.FGHD...NIAB.YDBFhBDA...hAIA...,1,-1,-24,23
FRMEPHTgYCJSUZfDQOaIBLKXWANbGVdec,GAAAeAAARADA.EADAHAGB..TAFACCCASCEHZCDAQECAhAAAaDFD.LAHBhACAKDHBAAAA.bEFAdEAAMDABgGAAhAEAYHCAfEDEOHEA.XFGDhAGA....hAIA...,1,20,-20,40
dVPbYSeEUNIaCHRBXZJAFWTGOQLcgKMfD,TAAAGAAALADA.KAHBMACAdCDA.bADAeCFB.ECGEIAHAhAAAHEACREGFZFEFACCAOCDChCAA.QDGAhCFAfHABDEEB.PFFBSGHHaHCABHGAhCHA.....hAAA...,1,-3,-4,1
XJSUTacOfCBQGPKZFbWNeHDRgVIdAYEML,EAAAMAAALADA..SACAaAGDOBCBBAFAGDDAZAGBbBBChAFAeBHHHCEBREABIFGAhAAAABIBXEGA.TGCAhBAACCFDKGHBNIABDDDB.dGGA......hCAA......hCGA...,1,0,-12,12
MFGBIXAaQDHVfJbcgRUKPLWYCNdSTeZEO,aAAAHAAA.VAEA..bACDRCAAKBHB.LDEACAEAdAGA..eBHHhAEAEEABMECBGCEAXEGAhAAAABBBQECC.hACAfEHAgFDAUGGBYHAATGDAhAIAFGGBDGBB....hBAA...,2,-7,10,17
WbKfYNCMDPGRSOQgdJHEeAXLFVUIcZTBa,LAAAFAAAUADAZAFBaADD..KAFA......fAHAhBAACAHBMCABGCDBRDBA.QEEBhABAdDHAHEDCACCBXEGDhACAIGGATFAAbFBCDGIBOCCH.hBDAEGCAeHEGBHHA.YHCGhAFA,1,-3,-19,16
BgfYdGJFcbUWXROaSCKQTMAIPDeNVLEHZ,DAAAeAAALADAHADAZAGBBAHA..fCCAGBBAFCGAbDECUDEAhAEA.REGF.ODHDhAAACFAA.TFAAABBB.IFFAhABAVFCB.EFCE.dHGB.....hAFA......hAHA...,2,-28,10,38
QABZNUYDeROITdfEKFCHWgVXPSJbcaGML,ZAAAUAAAeACERADA.OAFAdAGAKCDD..HBEC..VDABSBHHhABA.bCCCGDFAhADAMEEAAEIBBCHADFFATGGAhCAAEFCACEHB..........hCBA......hDAA...,1,-11,-33,22
ZMVYOcNHQDGKgeUfWdJEbLSTAaXPIBCRF,aAAAXAAABADA.RADA.ZAEB..MAHBOAGDHCDCGCCAeCHHUDAAhAAAdDAAEBBBLFFAhABA.AAIBCGAAFDHD.cEFChADAQGCA..KGBA.fGEAhAIA.....hADA...,2,-13,-7,6
HATPgXaDSQELFZMbGBJcKdNYCOWUVfIRe,TAAAXAAA.DADAEACE.ZAEBGAEB.BBDDKAGAdCCACCEAOCGDhAAAVCGBREAB..HEEBhABAAEEAaFFBLHAA.hAAAMDDBcGCBNEIA.UGGAIHGA..hAHA......hAIA...,1,-4,-17,13
YQAEBCSdfLHMKRVDOaFgcGWNJPeIbUXTZ,EAAASAAAdADAHAFARACF.OBCHFAEA.GCGAJAHB...eDBDhAAAICEAXDEBZDFEAAAAhAHAfFAELFGBMEEBhCAADEEBaFCD.gGFBcGCC.NIAB..hCBA......hCGA...,1,14,-28,42
VdBfLeWYGaUHMRFSKZEACcITJDXbgNOQP,CAAATAAADACA.....XACB..bACAOAECQAGAhAAAdAHALCCAhAAAeCCBGCEBHCFBRECAKEEAADHAIFHAhAGAgEGHNIEBBGGDfGAA.hCAAaECH.MIBA.SGHHhAGA,1,-10,-12,2
LERFSeNOPAJBMUTbgXdVDWYcKfHIaZGQC,MAAATAAA..XACAdACADAEA........cAFDhAAAHAFAZCCAGBDALCHBhAFARCGBeEGDODFDhAHAAAIBBFBAbFCB.WBBDfFEAaGHBEHEA.SGHHhBFA.NICB..hAIA...,2,-14,-12,2
FGRYKQBZJMOgdXecIEDWPLaTAUVbNfHCS,VAAA..bAAAHADBFAEARAGFQAFA.ZCFEMBEBdDAAeDDBhAAAECAADAAALEHBhADAACFBUDGBCFEASFAAhAFA.KFFAODDH.XGGAIHBAaHFChAIAfHFB.hCAABAHA.,1,-2,-15,13
JIMbKUSOYLZFXgTdWDcAEaPfHCNQVBGeR,EAAAaAAAHACB.QAEAGACARAEAMAIBKAGAUDEAOCBB.ZCEEhAAAXCGDdEFADEABAEHACEAABFGAhAEA.eBBDbGCC.hAEASFHHFGHB.......hAFA......hAHA...,2,-10,-9,1
ODPSNagcFVfXCbKGdHJQITZEeRALYWMBU,LAAAMAAABADADAEA..SAEHaAFEFBDD...XAGAhAGAbBFA.dBBAHCABQCFAhAHAZDEBRDGBACABUGGBhABAODCC.gEGA.fGHAhBAA.KHDA...hACA...,2,-15,-12,3
VBXNMHRUgCZIdFDfOcSKYLJPQTGbaEeWA,XAAAHAAARADFCAFBZAGBdADA..DAFA..OCABKAHBLBFB.hAAAQDBAbCED.hACAECHBABIBBCCDMDEBIFFAhAAAfDHASEHDPFHDaGCA..hADA......hCGA...,1,-19,-22,3
IEbFWQJCgTHcKSdRAXMZPaeBGNfDLOVUY,ZAAAeAAAGAEADAEALAHBOAGF..UCAAEBCAFBED..QDGBhABACBGAHDECKEHBRDDBAADAMDDBhAAAaFGC.BFFD..hABAfGAAIGBA.......hBGA......hCAA...,1,-16,-23,7
WFJgIAdKePVYRUHSLZGaXEfCMObQcBNDT,eAAAVAAA.RADAHAGBZADBGAFAECCB..MCFBQDAABDGDTEAAhAAAFAHF..JDEBAAIBdFGAhABAKDHBUGFAaEDD.CHDA.bGAChAEA.DDIB..gFBA...hAGA......hCAA...,1,0,-10,10
XBTIcAOVLfKDPbEFWZSGHgdCeJMRQYaNU,LAAADAAAEACA.ZADBHAEAdAGAeBFDRCCA.QCAAaAGAUCGABBBDhBAA..TEEAhABAAEEAOFFAKCHBbEGDFGDASGGAhCAAGGBB........hCDA......hDAA...,1,2,-22,24
ZKUdFCTSLDHgaRXJeOBAQVPbfMNGIWcEY,QAAAVAAA....bADBMADAGAFAIAHA.EBDAhAAAZDCAdCFATEGALCHBhBCAHFBARDBAeFDAAAHAfGGEhAAAcGBAKGGACBHBDGIBaHECOHDC.BDHBhBFA.....hBDA...,2,-5,8,13
JOLAKQgYaCFGESdIDbfBWcVXNHTMRPeUZ,QAAAaAAAGACAdAEBDADABAFA..VBGBHAGBRCEB.eBDBZFBALFGBhAHAAAIBKCFDCDHAEEBASBBDhAIA..hBAAbEFD...WHFANEIAMIBA....hBFA......hBIA...,2,-22,-4,18
KdIDLeXWfbTHBORNcCJAUgEaFSVZMQGYP,EAAAaAAA.FACDZACB.GAEAKAEA..dAGALAGBeBHH..XCDAhAAAbEBAHFFA.RGBACBBDADGBSEAAhAEAMAIB.hBAAQFFAIHHADEBAWECHBHEA..hBEAOEEB.NEIA..hBGA...,2,-16,-1,15
gWbeZXLdFVTKUJcGIOfaDSHBRPQMYACNE,EAAA..bAAAeACAZADBdAGAFAFDKAHB.UCCAGCAA.OBHDhAAAaCFEHDABRDEAMFCB.ACABCFDAhABAgDGALFGB.hACATFEA.IGHADFIB.BHAA.hAIA......hBFA...,2,-9,-5,4
QXCKPSJOILeUFRdEHGNcZTgfbMVYWABDa,aAAAQAAA.KACASACH.OAEAeAEERBDAHBDBhAIAGCGAZBFATDFAhBAAbDEDMAIBVFGBADDBDFIBCHBAIHDAhBBALHAA.........hAAA......hAHA...,1,-6,-13,7
aAHeZFXQERbNOWSILfVKDcJGCYPMBUgdT,HAAAeAAAZADBQADCRAFA.OAFASCCDLCCAKCFDDCHBhAAAGCFACEED.MBIBBEGDhABAdFHAABDBFFHDECABbGBA.hAGAWFFD..........hAAA......hACA...,1,4,-35,39
EATRSQJOcUPNBFWZYXDLVIfGedaMbCKHg,RAAAQAAAOADA.UADABAGAZAFBDAIBLBHB..fBDAhAAAeDBAaEEAMFBAhAAAKCEAHCGBACHB..TFGAhAIASCCD.PEEBWFFD.XGCDhABA.IGGAhCAA...,2,-36,-9,27
XVZfBObNRTCGQaPdYgUJcADeEKWSFILMH,EAAASAAALADAHACBZAGBBBCDOAEARCDBGEAAaAHD.dEGAgBEBhAAAUFDB.ADEBeDFAhABAFGHDMCIB..hAAAfEHA.bFFDCCFC.PHBA.hAEA......hAFA...,2,-9,3,12
WbDfOUGXRJAMNQLSZPEgTKVcHdeFBCaIY,MAAALAAAZABE.EAEAKAFAHAGB.dCAAeAHHCCCA...aCCAICEAhABA..bCEDODEEhACAGEGAREAAAAIBQFAAhAFASDHHTGDAFFFBBGBADCGB.fGHAhAEA...hAHA...,2,-19,-4,15
dfMgaCQDOFETGBAePJcWXSVZINULKRbHY,eAAAJAAA...XADAZADBUAGALAGBRCEF.HCCAdCCCMDABhADAaCHDQEAAhAAA.FEEAEDGAGGBBhABAABFA.cFGBSEGAIHHAKGGA...hBAA......hBIA...,1,14,-36,50
ONaLUIBbcGXHTPSCKRgMVeZYEfdFWAJDQ,QAAAaAAALADABACAGAGAHADBSBBDRAFAMCHBZDDAECCEdFAAhAAAAAEA.OEHD.UFDAhAFAbCED..TFGAhAIAKGGD.eECB.FGEBDIAA......hAGA......hAIA...,2,-4,2,6
FYLdDcRTEZJBAVIQKaUNgHSMbGWCfXPeO,QAAAaAAA.UADAHACB.bAEAGAGACCEA.XDBAhAAAeBBDFCGHdEEAREABEEEBZFBFAAGBKEHBhAEASDGDMAIBfGFAhAFAOEHDDGGB.......hAGA......hBAA...,2,-8,-4,4
DUGEYgLWHTaeSFROBVMXbICAcKNfJdPQZ,KAAAJAAA.dACAZADBGAEA..EAFALAGBHBFCeCCDRDDBBDHAMDABhADA..XEAAhAAACDGDAAIB...fFGAhAEAQEECDAIBgGGAaFHDOGBE..hBEA......hBGA...,1,-17,-19,2
KXFOJbQcHNDeSEUAfVIGTPLBCZMWaRYgd,VAAAGAAA.LADAZADB.aAGDRAFAdCFDFCDA.OCHDQDFAhAAAHDAADEEAEDDBAAEA.TGGAhACACFFA..MFHBWBHHhAIAKGAA...........hBAA......hBCA...,2,-22,-13,9
ZNBCLMXWaKDQIRYTfAeVFJGPHgcOUEbdS,eAAAFAAAGACAHADAOAFAEAEA.dCCAZAGBCBHALCFBMBIB.aDHBhAAAQCEA.hABAREAATEGAADFBPEDDgGBAhAEAUGGA.SEED.XGGAhBAA...hCAA...,2,-12,6,18
dLXUfbFSAEZRTWeHMQBGcgNYKDOCPIJaV,RAAAeAAAHADBMAEAGAGA....gAGAKCCDCAFAJDABdDFALBDBhAAAUGGA.FCCBEFEBZCFAhABA.TEFABEHA.cFBAhBFADIAA...OFEB.aFHD..hCAA......hCBA...,2,-19,-7,12
QaGPgURebBCKAWJYOfETFSLZNIHdcVDXM,JAAAOAAA..EADETADALAFB.ZBGBHAFB.dBHADCCAMBBBhAFAGDDAUDCARFGBeFCBhAHAbEEBKEGAACIB...fGGAhAHASGFDNIAB.......hAIA......hBAA...,2,-19,-10,9
MHAUDfSbIVGWEgZFONePdCLKYBRTacXQJ,DAAASAAA..bABAGACA.EAEAZAEBOAGDeAGFdCCAhADALDFABBHARDFAaEAAQFFBhAIAHEDAAAAAfFGAhAEAIHHA.gGBANEEA.CHHA..hBAA......hCAA...,2,-22,1,23
OLPNaRKMdHeVIYXcQSAUFWCDTgEBbZGfJ,FAAADAAAEACAZACBGAEA..OAECLAGBaAGA.REBAdEGAHCCAeFFDhAIAICGA.XDGAhBAAQGBBABBBCECDBEEAhCAA...bFGD...fGFAhCCANBIA....hCEA...,1,-11,-23,12
JIdYBNeACTcGKaEWOgbDUQZPSVRLFHfXM,TAAAGAAAEADA.OAFCDACAZADE.SAGHRCDAHCGBMDABdCCDBCFDhAAAAAABKDCD..aEFHbDEAhAFAQGCALFFA.hAIAXGFAIHHA.NIBB.CHAA.....hACA......hADA...,2,-13,-1,12
eTaVNFXBGQDPAUYMSgfZHEbOCIJKLWcRd,MAAASAAAZABEHAEBEADA...CAGAKBHBLAGB.RBDAeCCBhAAAaCCBFDDBGDAA.QEEAhABAADGAUEFAfGAAhAGAbEGD.OEHF.....hADA......hAIA...,2,-22,-8,14
JedEAUPVCMFOKRZNQfWHLcGIbSYBTDaXg,VAAAMAAAKADA.ZAFBQADC.HAFBGBBASAHBhAAATDGADAIBaDDAXDGAhAFAeDEBABBB.CEEDRFGBfFAAhAFALHBA.bECDBGFDdGGA.....hBAA......hBHA...,1,5,-20,25
MROcNTbCUPYZaBJfWFdeQDKIVGAgESHXL,EAAAHAAALADARADFOAFA..TBGACBFAUCABZBCABBHA..fDDAhAAAdDDDeDFHQGGAhAAAKDGDGEAAAAEASDHBhACAMDIBbFEA.aHEC......hADA......hEBA...,1,0,-11,11
KVgMTNWFCfBcObXIGSeYRdDaQPJELZHAU,KAAAMAAA..TADAFADDBAFA..bAFBGAGA.eBBBRCAAaAHDhAAAQDDA.hACAEEGBHCEBAAIBUFAAgDGHhADACFCAOFHDSEDDDGGB.LHBAhBHA....hCAA...,2,-14,-13,1
GPbcLMIgQCVJEXaKTUWSHORBeNFfAYdDZ,dAAAGAAA..bABDMADA.QAGACADA.EBFBaAEDTCDAhAAASAGAHDBBRDGBeCEAhADAfEFEAAGAZDEELFFAhBAAIHHAJHFA.......hACA......hBAA...,2,-17,-3,14
EFGdCOVYagIXSLUQbBRAKDPTHecMJNWZf,DAAAHAAAeABAMACA.JAFBZAEB.EAGAdAHA.OBDDaBCE..XBGAhBAALCCD.bDGBADDBTDFAhCAA.NEEA.FEFBhAAA.CGGD...gFFASHBABHHAhCBA......hDAA...,2,-24,-13,11
LdMHKCaeDWQPcYUZEBTfOIbJRGgAFXNVS,XAAASAAAdADAHACB.CAEA.eAFAQAGA..cBGDhAAAZCEBEDGABCEATEAAhAAAODBBJEHBRGAAAAFAFDDHhABA.LEGBaEDBDFGB.PFED.fGCAhBDA...hABA...,2,-11,-6,5
gKBYbXHdQEMTCePAUNFSRafZLWODGIcJV,FAAARAAAZADBLADADAGA.GAGA.JCCAKBFA.BBHB..bDFDhAEAHDAA.EDFAMDIBhAFAeDHFAAIBUFCA.aHFAhBAAOEEB.IGFA.VFBB.hCAA......hCBA...,1,-19,-23,4
PYgfNEAQKTUIbWVdJRBOeHCcaFSMLDXGZ,TAAAUAAA....bADAdACA.RAEAeAHHHBGBaAHFMCEB.LDFAhAAAGCBBZEAA.gEEAhADAEEAAAAEAQFFAhAHAKEHBIGGAVGCA.......hCAA......hCGA...,2,-4,-3,1
KfWagCITBMPZGUNQHVRAJFOEcSLbdDXYe,OAAAEAAALADAdAEADAGAeAGH..KBBDaBCC..CBGABCDDZDDAGEAAhAAA.QFCChAEAHDBAABIBFDFAbFFA.fHDFhAFAIFEAMDIBPHFC.NAIA.RGBASFHDhBAA.XGFDhBDA,2,-27,3,30
SdHDKgINPEbZfFROMTQUXWeYBcGJLaAVC,SAAAHAAAKADC..IAGAEADAZAFBRCCBMAIBUEFA..eBEFhAAABAHAGCFAaCHFAAAAdDAAhADADCABPCCB.bFDBhACAOECH..XFGDYFHB.LHDAhBFACHCA...hCDA...,1,-7,-9,2
eHJMGYaZOgKLBPVbdUXSCWRQEFcAIDNTf,DAAATAAAHABC.GAEAZACBKAEALAGBBAGB.VEAAdCEASAHHhAAARDDBFDHD.ACAB.fFGEhAEAeCGB.MIAAhAIAaEDCOEGH.......hBAA......hBGA...,1,-8,-27,19
CWKfSeUBLMRDXaHGZdbFJYOIQVTgNAcEP,EAAACAAAKACA..eACALAEBRAFADCCA.HAGBdCFDFDAAOCAA.QDFDhAAATDDA.AAGB..hAAA.PDHDSDDDhACAMEGBGGABbGFAYECFIHHA..hADANIAB.WFFDBFGD..hAIA...,1,-3,-18,15
PCBODSWQFZKTNgdYVGReIEbJUcAHaXLMf,HAAAaAAALADAMACACAFABAHADAHB..QCCAZBEAKCCA.TCEAhAEAdDFAGEGA.eEEDhAAAECHFbEFAJHAAAEIBfFAAhAFA.SGCA.FGGB.hAHANIAB......hCAA...,2,-18,0,18
JaLACQZHMTReGYdIVOUbDBESfFKPXgNWc,ZAAAHAAARAEAGCAAdADAOAFADACA.BBFA.EBHFFBHD.KCDA..XCAAhAAA.NDDA.cDEDhABALEEA.ADIBMFBBhACAeEGFVGCAUGEAfGHA.hAFA......hAHA...,2,-25,-2,23
SbBZGgWCHJOaXfAPdEMFDKeQNVcTRIYLU,EAAAMAAAKACA..eACAQAEC..cAEDRAGFLCCBhAAASAGHZEDB.GCCAhAIACDGDHFFAaBBHACIBdGAADBIBTEFAhBAAIHHAbFDDBHFDJFHB.....hCAA......hCCA...,1,-5,-12,7
SbOaABCgdQHFGXMVKePZfJLDWEcTIUNRY,CAAAdAAAHACAGADA.MAFAeAEEZABBLAHBDBFA.ECAA.TCDAhAAAICGARDFB.SCHHhBAAaEHDACFABHCAQEFChBDAFHEA.KFDB.fFHA.hACA......hCAA...,1,-11,-18,7
MYFIUTCXROQbDVdaKfNGHEJLAWgZSBecP,ZAAAeAAAMACAFADDUAFA..TAFARDDA.QCCBDAIBdDGAKCCDhAAAGCEA.HCGDhABAEFBAADIBSAHBhBEA.BFHAPFFBCGFA.OHBA.aHGENIEB.hCAA......hCBA...,1,-8,-23,15
WYACOKbEHcJQgUMISaRDGPVXeZfTNdLFB,KAAAHAAAQACCMACAaAEE.RAEF.GAGA..XAGBeCCAZDCEhAAATDDAdEGDLGDAhAIABCGDABIBODHDEHGA.hBIAgEAA.SEGDDIDA.hCAAfHEB.hCCA...,2,-17,4,21
WQOAaXcCUJETZPMeVYISbLfNHgDGBdKFR,aAAACAAAUACA..EADAZAEB..eAFA.VCCASAGA.hADALCGBHCFBGFCBhAGAdEBAREEBODDBABBBJFHBMBIBhBAA.IHCAfGDA.DCIBBHFAhCAAFGHB......hCCA...,1,-5,-21,16
GOYZDbAKRQFegdISMUNcTLXJHWfPEBCVa,RAAAeAAAdADA.MAEAUAFA....TBCALBHBHBEB.fAHAhAAAECCBCDFAGEDAZDGBABGBhABAQFBAFEBASEEAhBEAXFFBWEHHBFHA.....hCAA......hCBA...,2,-17,-7,10
BNTDHZAVaRLgKOMPYUCGFEecIdXWQJbSf,RAAALAAAOADA.MAEAUBEBGBCB.EAHFeAHB.dCCAQCAChABASCGHBCHAhACADDFBHFGBABFAaDDCKDGDCGFC.hAAAFEHD.XFDA......hDAA......hDFA...,2,-25,-11,14
aDPeNLYdEgSbWQFOGfJMKHVXARUBcTCIZ,RAAABAAACADB.aACADAFA..eAEHLBFA.dCCAEAGA.SBCBhAAAQDFAGCFAhAGAMDIBHECCABIBTFDAZGBA.hAAAPFHB.YCCFgGGBFHCC..hABA......hAIA...,2,-21,-4,17
KRCELaFPQecBSMbVXJDYGWfdHZTgNOIUA,RAAAEAAALADBFACD.eAFASAEA.MAHBbBFA..XDCChAAADAIBGCDA.dDFAhAAAHDFAZEAATFGAhAEAOFABACCAaGCCQFDABHEA.VFGB.WHDGhABA.....hAFA...,1,12,-14,26
LCISecPObJAUYdQDXBRETKFZNfaVMHWGg,dAAAQAAABADAEAFAFACE.ZAEB..aAHDHAGBGCABLCDDhAAACCFA.eDGBODFEAAIBDDIBhBGARECAKFAAfEEBhCAA..MFGBgGGASFHB.PHBAhACA....hADA...,2,-26,1,27
ROFeBPHUZbCDXaYEgQKJNITWAMSfcVLGd,MAAASAAA..fADALADARAGFeAEHHCCAZAFBbDFAXBBDhAIA.EBHBQEAAhAAAKDGA.IFFAhABAABBBGEEAdFCABGHACFHDaGDD....hAEA......hAFA...,2,-11,-6,5
SKceDGVIUgCTWQMZHOAdNfbYFPXLJaEBR,dAAA..bAAAFADALAEAEAGABBDDRCAAKBHB..eBHFGCEAUDDAhACATECA.MDHBhAAAHCBBAAFA.fEGEhAGA.XGCAaFHDDGCB.gGGAhBAAQGDD.....hBCA...,2,-22,0,22
ERVLMBXIANfPQTdcCaGKUgJSDWZYbFeOH,...fAAATAAAdACACADA.GAEA.KAGAgAEHhAAADCHBZDDFFEAAHAGBRFFF.MBCBhACAXGAAAAIBQDDAhADAaDHD.SDGA.bFEAEGDBBGDDhCBAIHHA...hCDA...,1,-8,-13,5
PZMeHcRgUYKDdFNAEOLXGICSVWBTaQJfb,EAAALAAAGACASADHBAEA.aAFAQAGA.bCEDhAAAZBEBHDGDRCAAUCGADCBBdEADhAEAAAIBXEDCCGAA.hAGATFGAfGCAMIDA.eFHH.gGDHhBCAFGDE...hABA...,1,13,-16,29
cVZATSXeEIfdQCOHWgLJUBGRKabMNFYDP,TAAAeAAAEADA.dAGAQACCHBEBLCCBBAEBRAFFaBHD.MEEBhAAAFBHDDCEB..cFFAhABAAAHAXDED.CEGBOEHDhAAAgGBA.......hCAA......hDAA...,2,-29,2,31
cJYTaZQHdKMWPVCAUGEFRBDNLXeIbfgSO,EAAARAAADADALADA.eAGHIAGA..bBCCSAHHhAAA.OBDCcCGDhAAATDDAZDDBHEAAdDFAMCCBhABAPEHDADHAGEGABFFANIAB.fFBEhBFA.....hAEA...,1,-3,-12,9
HGgFDQRNELcWASBaZYXeVOIdKfbJTPUMC,aAAAZAAAeACE.OAFAdADAKAFA..JBFBTCEA..MBIBhABAHCGBGDDADAIBRDBAEBBBhAFALECDAFFABFHAXDGDhCAAVGCA..fGGEUGGACCCD.FHAC.hCBA......hCEA...,1,-6,-11,5
FOCBTDGYcEKdgLfPSaIHUVMJbANXQWeZR,QAAAeAAARADA.CACABAEAGAGA.ECCBdAGALDFB.SDHHhAAAHCDAMAIBAAIBXEAAhABAZEAATEFADEEBhAEAKFEDfGAAaFHDIGBA....hAAA......hAEA...,2,-22,-5,17
KEaYSGFcXNPVBCbHZLegfQAOJDWIUTdRM,DAAAUAAARABA.EADA..aAEAGAFA.FAHFXAGD..PCDBhADACBEAHDCAZDGBeDGBhAIAQFBCADHA.OEFBhBAAIFFAMEIBSFDH.NEIA.hBAAbFDD.....hBIA...,2,-33,-1,32
SbWJNQLEDgGKIfVTcaCHOdeAZBFPMXUYR,ZAAAFAAAMADAUAEARAGB....SAFAJCAA.LBDBhAIAEDABGDEAfBHAhBAA.TDFAaDGCHEBBhABAeCCFAAIBXGGAbFCAQGGADIDA...hACA......hADA...,2,-16,-3,13
bBZMLDRdIYfNXOSeaHGcAKWPQTEFCgVUJ,KAAAQAAAEACE.CACA.UAEABAEAZAGBMAGBRCCB..dEFA..fAHAhAAAOCHDeFDFhAAAHCDB.ACDB..TDGAhAEAFFHH.VFCB.bFFADGBB..IHAAhAHA.....hBGA...,2,-27,-3,24
IbHgMSRZVQacYfALCBPTXOdFDGJKUWNEe,LAAABAAA.TAEAdACAGAEA.KAGAUAGAECBB.eCAAHCGBhAAAMCEBRDDBZEAAaDFA..hABA.fEAAhACAACIBXFGADDDBJGAAIFFASGFDcGECCHHD.hAEAFGHBNIAB.....hAGA...,1,-3,-7,4
BWHXfZdbcDOeFVSYRMJKGLgaQAEIPNTCU,EAAA..IAAA..TACABACAHADBZAEBbAGDOAFAhACAeCCBFEAASBFBhBIA.RCGFMCCBGEEAaDDChCAAAAIBCEHAXFDAdGBADGHB.YEHB..hCBA......hCIA...,1,-6,-19,13
cAUDCeQIFJZHMGEWbaORXNPTdKfgYSVLB,CAAAeAAAFACA.HADAGAEAEAGE....aCCBRAGB..XCBATCFAdCHAhAAAKDGD...fDDAhABASDHHLFABhAFAAAIBQEDDZEFAbFCCOGACgGGBhAIABGGADGIB....hAAA...,2,-28,23,51
LSebdcWGKQOaAPDXTIMRVJUYCEBZHFNgf,XAAAMAAARACA.UADAEAFE..HCCCFAFE.....fBHAhAHAeAHHdDBAGDDAhAAAQDFDACGBTFGAIFCAhAIA.VGFACDHABGFDgGCA..hBAA......hBBA...,2,-20,-6,14
bDOgPYLCJFdZMVQRaHXSNEATGWBeUfIKc,GAAAeAAAUAEAKADADAFA..OAGF..gAGAhAAALBDDFDFBZCDAMCIBREGBaGGH.hAAAHECA.SDADhACAAAIB.TFGAWCCD.fGFEhADA.IHDA.hABA...,1,-2,-34,32
JDTVIUKdZeMXfPORSaQcHEBbWgNLFYCAG,GAAATAAA.UADAZACB.eAFAMAFA..XBGAOBEARCEBaDBDHCGDhAAA.ECABBDDAbECB.hACANDFA.LGFA.hAAA.CDGAAEIBDIBAKGAA.dGDA.SGFHhACA......hAGA...,2,-18,7,25
bHgaLfJVXNMeCPSFcDUABKGOIZRWYEQTd,GAAAZAAARAEA.EADAdAHAHAFALCAB..fCDAXCCAeCFFhABASCEH.hACADCHBAADAODGDIFFAhAAAQGEAbGDCaDAHNCIAMDCBFGHDcFADKHAAYHFGhACA...hAFA...,1,16,-14,30
EGBUVaeLcPTYKfRDJIObMXASZdFCNgQHW,dAAACAAA.QADAHACAEAFEGCAABAFAaAGDeAHH.LCCAhAAA.TDFAfCBAhACARECADDIBOFGDbCFAAAIBZDCBhADAFGCHgEEA.UGGA...hACA......hAEA...,2,-6,4,10
QdaKDHbegcLUZFJCfBEPORNMWGIVSXAYT,TAAAaAAAHACB.eAEALACBZBFE.CAEAEAGARDEAMBBB..GCEAhAAASDHBABIBdDGAbEAAhAEAgEAA.FEDHhAEABFHAOFGBIGAAYHBAQGCBhAGA.DGGB...hAFA...,1,1,-3,4
GFVCIMcZDRLUSXYadQfHAOBbeNTJPWEgK,BAAAeAAA.JACAEADA.GAFAFAFA...CAHAMCCBZBCARCFFLCHBhAAA..XDDAhAAAdDDAQGGAHDGBACIBbFBAhABA.PHAAKFFD.IHHADIAASHEGhAIA....hBIA...,2,-29,4,33
IBaWeDCMJKSNYGHRdfAETQgUVPcbLFZXO,EAAATAAAUADA....VADA..bAFAZAGB.OCABaBCBeCEAhAAAMBIBKDDD.SDGAhAGAGCCAHEFARFEAAEFB.hAHAQGAA.cFECLHDAFHGEBHEDhAAACHHA....hACA...,2,-7,1,8
FJCEWYLcMXZdaOKGfgbTeRUPBDSNQVAHI,HAAAFAAAEADALADB.MAFAdAGAaBDEGBFA...bDCCRDAABCHAhADASBHBQDDChAIAABFBCCAD..cEGDhAAAZEGBfFFAeFFDDHCAIHHAYGBA.hBAA......hBGA...,1,7,-25,32
USFHDbeXYAPKcGWIREVQZMJOgaLTBCfNd,KAAAGAAARACF.EADAZAEBMAGB..OAGDaAHBLCDBCCAA.dDHAhAAAFDFDHFBAeCHHABFBPFFBhACA..IEAAhAAA.QECA.TGBAhACAfHGFSFGAhAEADDAB...,2,-32,-1,31
QbOaXDYGdKZLCAUcIVNMeJHPESRTBfWFg,UAAAVAAA.eADAHADB.EAFARAGBBCDA.FCFBbBGD...aDAADDAAhADAdDDDZEAAAAIB..IFAAhAAAMDIB..SEEAhAEATFFA..fGCAQGGCXGDDhADAKHEC.LFHBhAFANIAB,2,-31,-5,26
KXBWRQVCTGZPFAOcHDUMLIaNdegJSfEYb,HAAAMAAALAEAaACAeAEH...SAHHEAGAKBHBBCCARBBAQCEAhAFATCFA.ZDGBAEEADEHBhAAAIGAAdFFAfGAAhAGAbGDC.WEHHCDDD......hCAA......hCCA...,2,-17,-9,8
YMRcSFaHJZbETgBWGKdPeNLCXfQOAIVUD,UAAAMAAARACAFADA.HAFBZAFB..EAHFBAHAGCDAdCDA..eCHFLDHBhAFACDBA.QFFAhBAAADFBDEGB.SBBDhCAAaEHD.bFCD..WFFD...KHAAhAHA......hBAA...,2,-35,4,39
QSEZWVGUgeNaYDXLCKfTbAPFdJBOIMHRc,dAAAOAAAHADARADA.QAGCZAGBGCCAeCAA..aBBHXCEDhACALCFDKCHB.bDAAABIBFDHDhAEABEGAMGEA.EGAAhAGAUFAA.gFFGDGIB.TGDAhADA......hAFA...,1,3,-9,12
DfVAMIPBSCFZRLOabHNXJEWQUYdKTGegc,MAAABAAAFACARACA.LAFAOAFA.HCBA..XBEAECFAQDGAhAAAdCHAGDDAeECAhAGADBBBAFFA.SCCDhBAAaGGAJHAA.UFGA........hBIA......hCAA...,2,-20,-12,8
HUfSdAaMKRDTPYQbENCLGVXcOIJWgBeFZ,aAAARAAADADA....TADAQAFA.EBDFLAFBGCEA.hAAAXBBCOAHFIEHAhABAgCGHeCCDhCAAHDACSGDBAAHAMEEBKFCBbGFACFFAJFHB.FHBChADA......hBAA...,2,-8,-2,6
HZLcAGTeSKUCXdJaQgFWIRVBMYPbDfNEO,eAAAKAAACACB.dAEA.QAGAFAEA.RBCBBCFAMAHB.....hAAAbDFAfBDAhAIA.ECEAHEBAZDFEABIBTFFAhAAASCCDXGACaEEH.IHDAhABA.YHFGDFHBLGDAhCAA.,1,3,-36,39
FcXVeSaNJBRUAITKYDEZfdCLGMgbWQOPH,TAAADAAAEACA..dAFAGACA.MAEA..bAGDQBEChAAAHBDBXBBCeAHFaCAChACABEFAACIBKDFAZEGBLFBAhAIAOEEBFFGA.SGBANIBB...hBAA......hBFA...,1,3,-15,18
BeEZfKINDAgaTQXRSWPYcUGbJCFdOHLMV,aAAATAAA..RACF.SACB..PAEAUAEAbAGDFAHDHCDBhBAALDDBMBBBeCCDhAAAECFBZDGBKEBDDAIBAEIBQGCAhCAAXFEDcGGACFFC....hBEA......hBGA...,1,-5,-14,9
WNOfHJGRbZCBFXUeEAQPaTVDdMSIcLYgK,aAAATAAA..dADAMACASAFALAGBKBBDOBDAHCDCRCGFZCCAhAAAFDBDeCHH.AAIBQECAhCAADAIBIFFAgFFBhCDA.fGCEbFAABFHA.EGEFhCEA......hCGA...,2,-17,-4,13
YSfRJaEFZeOdCTXDGVMQcBUNIbWHLgAPK,KAAASAAARACF.EADAeAEE.dAHATAFAGBEA..MAIBhAAAQCACBCCAICEAhABAHDGBADIB..fECAhAAAaCGDZDAAXEECDEEBcGEBbFGDLGDAhADA.PHAChAHAFGCDCGHA...,1,-1,-9,8
EdgMBPDCKbUHXYJRafQFAZVcLeGWITOSN,ZAAALAAAeACEGAFATAEA...SAHBEAGEdCAABCCACCCDKCEDhABAHCEC.XEAAhABARDGFaEFHFFAAACHAVEEB.hAFAIEHAOFHDMHBAbECD.....hACA......hAEA...,2,-8,-5,3
XKOQZPIJSfdUEWbDNLGBRYVMcCTFgHeAa,aAAAOAAAZACB...JADBdAFA.EAHBDAFAGCGARBEF..MAIBTEBAhAIAHCGB.ABBBQFFChBAASBEDfEEAhBAAUGBA.bGDABGDA.YCCFhBGACBBD......hBHA...,1,-7,-23,16
UQIYGCbaTKdJSWRHXPLBEgeNAMFVcDfOZ,MAAAFAAADADAZABE.UAFAQAFA.GBCAaBHDdCCA..SBHBhAIAHDFALFBAhAIAEBEBeDGBAFFB.fEEAhBAAOFHBCHBA.bGFA.KHDA.....hBAA......hBFA...,2,-22,-9,13
BKSUMFDRJLXHVCTENAQGaZbIWcefgOYPd,aAAAZAAA....bADBIADA.eAEHOAFC.dCAASAGAhAGAMCCBRCGBLEEBhABAHCCBTCFAAAHAQGCAhACAGEGAfBBE.gFEDhAHABGGA.FHCADDDB.hBAA...,2,-11,-8,3
CBaOYTPGfKEZWNVSbHdIFALcUgDMeRJQX,LAAAUAAAMADARADFQAFCBAGA.OAHDTBDA.GCFAhAIAECAAZDDA..VDBAhBAAHEGBdDHAADFADFFB.eHAAhABACBHAaFBC...fGHAKHDA.SFDHhBCA..hBDA...,1,-1,-22,21
gUERWdTXFDHYKCIfOcQaJSAeGPBVNZLbM,eAAAGAAABADAZADAMAEAEAFA..RBFAdCCATCDA..DDFBHBGBhAAACDGA.ODCBQFAAhAAAaEFBAAIB...PEDDhABALFHBUFGAFGFD.YFCB..hACA......hBAA...,2,-20,-4,16
NGQHPWIYLXUJAbCcRZfgSVEaOedDBKMFT,CAAARAAAZADB..SACAEAFA.eAEHdBHAKCFBMAGBFDAAGCAAhAAAHEEA...IAHAhACALEHBXCGDhADAAAAAbFCD.fCCE.aDFHBGGCTFGAhCAA.NEEA.....hCDA...,1,-13,-18,5
DPGeOCJMHFQUXVSaYKWfBERTcIdNgZbAL,LAAAGAAAeADACAEAHAFBQAGAUCAA.SCDAaAHF.hABAKCGDBCDAREAA.TDEAhACAdEEAZGFEADHADEHBJDHBMIBAhAAAXGFC.....YHBAhAEA......hBHA...,2,-25,2,27
OeMDQAfGTVgbNCISRZLXPcFUdYKHEJWBa,GAAATAAA...bADACACBRADF..ZAGBLAFB..XCDAhAAAFAHBdDHAHEEBEDCBBDHAhACAeCCBMDABAEEBfFCEhAAAgEEASGHBcFADKFHBaHECDGGBhADA.NIBB.....hAEA...,2,-10,-5,5
MTLDJZdYcSeCXUOKWHIBbagARFfEQGNVP,RAAAEAAAGADA..PACCMAFALBFB.ZCGBdAFASCCDhAAAeAHBXCCAhAAAKDABHFDAbCGDACCAFFHDQFDAhAIANIBBDHBA.cGGA.CDFA....hABA......hADA...,1,-4,-9,5
BRaQJcbGKTFWgYNEIVPfLMdHODSXUeCZA,RAAAaAAAQADC..bACDGAFA.TDDAFAEA..gAGHhBAAEAHBVEGBLFAAhAAAHCEBSCGAhBBAeFFDACCBBDHBKEBAYEGBNIAB....hBEA......hCAA...,1,11,-25,36
UAQDNCXWMLVERfFYdeTBZgHbGJIaKPScO,QAAACAAA.MADAEACARAEA.FBHDeAFAZCAAHCFBGBDA.aBGEhAAASCCEODBBADGAXDGAhBCALFAAfEEEhAAAdFCATFEABGHAgGGA.IHAAhACAKHFA.cEGDhAFA..,1,-3,-10,7
QIFbgVWUDdYAJLfGRHMNEcZeTCPOSKaBX,LAAARAAAHADBEAFAeADH.CAFA.SAHHBAHA.QCFDhAAAFCAAVCEA.DCCB.ADAAGEEBhABAMCIBZEEATFAAhADAKFAAaGGCIGHA.WDDDdHABfHEBhABAPHBC....hACA...,2,-20,15,35
WIHdCJZANGbFTEQeYMcVPUaKBLXSfgORD,GAAATAAA.EADAeACEMAGB...VCDBaAFALBDA.hAAAfBHARCGFDAIBHFBAhACAdDDAZFFAACCBFDGH.QFEDhAAAYHAA.PFHDBHHDSDADhADA....hAHA...,2,-3,-3,0
bVaCFcABLOJREKDTXdYGNMQIPZfWeHUgS,LAAARAAAEADE.TAEAdAFAGBGA.MCCBQAGCZDCBeEEBhAAAHCAA.SCCEhABAaAHFFGGAAEGB.OCHDhACADIEA.XDEA.IFDA.fEAEhAEA.gFFAhAIA,1,0,-21,21
bdYUANHPZcXKVeWFgCLOTSIafRMEBGJQD,HAAAZAAAKADCeACEFAFD.LAFB.TCCAaAHBRCAA.BAHAGDEAhABAQDGAdDGB.ACEAPEEBhAAAXECBgGFAhAHASEGHfHCBEGHFDIBA...hACA......hBIA...,1,4,-22,26
LWXAZJKTabOVBdHIfDPNQCMcUREFGSYeg,ZAAATAAAaACA...OACAdAFAHBGB.DAIBQAFAMCCBRDDAGFBBhABAeBDBLBHBhAAA.ACCBbCEDBEHAfFGAhAIACFFBEGHBSHAAgGDA.WDDDhCAA.....hAHA...,2,-12,1,13
QaCTIeUGNZcHXEADBSfOMJRVFKbLgdWYP,SAAAMAAARACA.KADALAFB.dAHAPAFAaBBH.TCCAhAAAeCEDGDGA.hABAZFCAHCEBADDBBHBAOBHDhADA.FECH.bEGD.gGCA.hBAA......hBHA...,1,-7,-18,11
VTROMASPLBNebWcZaHJgCGDYEXQIFUKfd,LAAAeAAA..bADAZADB.HAFA.CCAAGCEAEAHBQCCAhAAAFCGEKDCDdEHARCEBAAEABCGAhABA.NDIA.aGFDDEHBIHAAhABAfGFA........hAIA......hCAA...,1,-14,-19,5
WfFeZEdJLVPCMBONRQXgUYGAHIKTaDSbc,HAAATAAAaACA.DAFASACB..bAFA..fAEAhAAAeCCAECFAdDHALAGBhAEACEEAMEGBOCCB.hAAARDEBQEGC.XFCAYHEAhCAAAAIBKGBD.FGHD..hBGA...,2,-10,-6,4
dBMAEVWUGaDeXIFfOKSNZCbPRgLHQJcYT,EAAAUAAAGACAeADAFAGDKAEAZAGB..CCDA.RCEBHEAA..QDAAhADAJDHB.TDEAhAEAdGADABIBaEEHDAIBXDGBhBAAOGFCSGCH..bFCD.LGFAhBCABCBD.MIFAhCDA...,1,0,-19,19
CXgbFdcQSaRWEJYZVKUTDAPfNMGIeBHOL,...fAAAGAAAeADAHADALAHBXAGBbBFDdCBAQCDBhAAARCFBEDDBZFAAKCHBTECAhACAADAAMFFBODAHFGGA.hAAAaEGE.JFFF.YHBADIBA...IHHAhADA...hACA...,1,17,-2,19
NVdSUPJXgDBCHAFIQGfYEKOZaeTWMcbLR,QAAAGAAAEADAZAFBeACA..MAIBbAFA.RCDBdEGA..SCDAhAAAUFBAJHDEDDABHCFBhADA.AAGAfCHEhCAA.ODCB.aEEH.TGGA.hAAA......hACA...,1,7,-22,29
ZDcSWAVMNRHXeYPLEQGIadgTJbfFCOKBU,MAAAHAAAeACELAEAEAFEGCCAdBBA.TCFAbBCD..CBHABCFAhAFAZEFASAHBhAAAADHA.NHCB.REDAXFGAhAGAQGGCaFCH.fGEA.KHFADIDAhCAA......hCCA...,2,-12,6,18
LQTNUcBeZYWADgPSMFOEXbdfIJRaCHVGK,DAAASAAAMADA.EADAdAHA...JBBARAFAHCCAGBEALCHBhAAA.TDAAUEBAeDHBhBAAZDFBAEEAFFCAXEFDhBEAbGACaGHBKHBA.NEEABHFA.....hABA......hADA...,2,-18,2,20
LKAgIYQcBDRWVfbHTSECeNMZXGFOUaJdP,..IAAAQAAADACA.RACA..VAGBHADCECDAeAGH.ZCBAGDAAhAAAOBHDaDEDdECALEGBhADAACCA.gGDAhAFABEFAbEGDTGAASGADMFEB..hAGA......hAIA...,2,-15,6,21
gCUefMLFNSQIPKYTAcGOWVaZHbBdJXDER,GAAAOAAA.aADAHADAdAGA.DAFARCDA.UCDBeBHHLBHB.SBBDhAIAQEBAKCGDhBAAAAABVEFBZEEABGGDEGBBCHHAhACAMFIB.FHCA........hCAA......hCCA...,1,-7,-13,6
bAYZJXEFdRBfNVUaODCMeWPcgSKLGIQTH,ZAAAEAAARACABADB...VAFAaAFADAIB..eCAB..PBFDhAAASCCAGCDATDEAhABAHDABACCB.XDGDhADAdDGAfFAEOFFBCGHAMCIB.gFCAhACAKHCA.QGGAhAFA,1,-10,-17,7
VfXOKdTCSEMgLZeFJQGDWBNaHIPbcARYU,RAAAVAAAOADA..dADACAGA.EAFALCCA.ZCFBeAHF.QCEAhAAAGEBABBDAhAAAHEFCbEGDACIBfDDEhAFA.TGDAMAIBFFEHDGGB.aHDCIHHAhCAA....hDAA...,1,-10,-11,1
DPHUafgVJROeNZFCTWcKdSMXYbQLBAIGE,EAAAHAAAUADAaACA....VAFARAFAeBCDZCCACCHA..TCGAKDGDdECAhAAAMDBB..bFABLEEBhAAABEED.AEGBDEIBhAGAfEHAOFDBFGGBSGGA..hAFA......hAIA...,1,-7,-16,9
SVHLIeOXKFJGcBWCDRUPYfMQZAdgaENTb,aAAAEAAA....TACASACHHAEBeAGBKAEAGAGABAHBDCCBhAAARCDAUEAA..fDDAhAEAZEFAAAIBdGEAbECDLEFAhCAA.XGDAFGGB.cGGA.hAEACDGD......hAGA...,2,-10,-1,9
YTMPQSLKNUXWbeBJgCEDROGVdfcHIFAaZ,ZAAAMAAAQAEALAEAKBBAUBGA..XBGAeCABBCCDCCDA.hAFARDEBGECAdDBAHDEAAAHAaEAHhABATFCA.SEHHhAGAbGEA.EGFBDEIB......hACA......hADA...,1,-8,-9,1
OQUBcCgNTLfDXAVRGFYPIbeJdWEMHZaKS,RAAAGAAAFADA...IADAeAFHdAHAEAFAHCCBZBFE.KDGA.QFEAhAAABCDACDCD..TDFAhAAALHBADDIBAEEBYHFGhABAJFAA..aFFC.OHBA..hACA......hAFA...,1,-10,-22,12
YgSQJUXPdNLFaBDcIVfMAWOeCTGbERHZK,eAAAGAAARADAHAGBZADAKAGC..SCCBQCDAXCEDhAAAdCHALDFBaDHDDEAAIFAAhAAAMFFBAAIB.CDCDEFHBgGAAhABA.UGGAFHDABHHDfGDAhAEA......hAGA...,1,-1,-9,8
SUaLJAgVOcNZGebKXBMPHIfWYRTCDdFEQ,OAAAZAAAeACEKADAMAFAHAFB....IBGAfAHERCCADBIBhABAEBBB.UDDALDGBhCAAADHA.VFCAGEGAhAFAbGFA.BECC.........hCBA......hCCA...,2,-18,-14,4
LUOaZBEcMVbWFHYXNCdfKGTAJPgISQeRD,JAAA..gAAAQADCRADALAGBUAFAZCCABAHAECCBMAIBhAAA..VDGBFCEDHDABhABA.XEFAhADAdGDAKFFDACIBSFHHDGIB.aGCA.cGEDhAEA......hCDA...,2,-29,2,31
TcKDFVZadAROIJPeYGbBCWNXgUMLfSQHE,RAAAOAAA..IAEAeADAGAGABAGA.CBBD...XBGAhAAAMCDBLCEBQCCAhABAHEABECFBTFGAhAEADDABZEFAAAIBPGDCbDADgGGB.SHDAhADA...hBAA...,1,-6,-12,6
ZUbYTeDBFIGcRWEQMAOJLHKdfPgVaSXNC,LAAAHAAAdADA...fAEAgAFAaAFDSAHHhAAA.CCADZCCAbAGDeCAAhABAFDGAGEEBRDDAEEAAAAIBKFAAXEGAhACA.YFFFBGHAWGAA..hACA......hAFA...,1,0,-9,9
fRLWZOCYSTBPFaIcdMbUKGgXJDEQeVAHN,HAAARAAAZADB.CADB..SAEHTAFA.FAGAaAHD..dCADUDAAGBFAhAAA.JDCBEDEAeCHHhACAAAAALDHB.OEFDhADABEEAIGGAMHAAKFCA.DFIB...hAHA......hCAA...,1,-13,-15,2
dNfeBWXYcOMLQSaCHEGZVgDTbURKAIJPF,JAAAdAAAeADABADB...XAGAOAEDLAGBQCBA.aCFAhACAHCCBZDDB.DAIBbDFAREFAABGBhBAA..FDAH.fFFAhADA.YHAAMFEBEGHB...hAEA......hAHA...,2,-32,-8,24
EOWHaCTgXSdAeMZPFVbQDIUYRKGNfJLBc,eAAAZAAAFADAQADADAGA.UAGARBEAGCAAJCCB.LBHBhABABDFAEDHBHDDA.aFFATEDAhAAA..SFHHhACAABFAMFGB.bGDAKFHD.NIBB.....hABA......hBIA...,2,-19,-8,11
FfaADXMOHGEZPCgYJVRQcNKTdLIebBUWS,MAAAHAAAEADEZABE.CAFB...JAFARAGF..QCABKBEAdCCALCHBhAIAeCEBBDCAUEEAFDGHADFA.hBAAOEEH.gGGAhAAA.YFCBcGFD..IHDAhCAA....hDAA...,2,-38,-1,37
gLNZKTeXIVQFdPGHJAYScbOfWCREMUBaD,SAAAOAAA.CADA.EADABAFADAGALBFAZAGB.KBBDeCCAhAAA.XDACQCDChBAAdEEAHFAAABGA.bEFDhABARDFAaFFC.TGDAFDHD.PHFC..hCAA......hDAA...,1,-10,-20,10
eOHcSaTVILQDfbPUKZMBAWGCYNEFdXJgR,GAAACAAA.EADAdACA.XAEARAFAHCDAaCGD..TCDALEFAhAAAQCGAbFCBKGAAMDABhACAAAEA..YCBFhAAAFGGA.eEFB.SFCADIAA.hADAfFHA.hAGAPHAABDCD,1,18,-20,38
LZINGWOPAHCQFSKEBbUTcVYfaXRMgdDeJ,HAAAQAAAKADCEAFABACA.UAEA..TBGAVCGB.aCACRDCAdFFAhAAAeCCEZGBAGDEBhAAA.ODDHAAHASHGAhBEAbFFA..fHFB.MFCBhACADIBA......hAIA...,1,-4,-17,13
GEgTLMKDZCQAXBUOHVPNfFdWbaYJSIRec,BAAAHAAAVAEA..fACAdAHA.aADDSCAAhAAA.RDCAeDGBEAFATBGAhAAAMDIBZEAFAAIBOCABhACAFFDDbFFDIDDA.GDFA.LEHBhAFACHHB.QFCAhCBA.,2,-20,7,27
WODIReNSFGQXKCAPUZaVdYEMbBcJTHgfL,ZAAAdAAAEADAMACABAFA..TAFAHAGBLCCADAIB.RDABeDFFhACAFBEHGCGAQECChADACCCDAEEAaFFBVEGB..hAIA..cGDC.fGGE.hBAAOHACNIBB...hBCA...,2,-17,0,17
OEWAbGCHTMdZaQFSRPDgXfKJYULNIBecV,GAAAHAAAdADAaADAQAFARAFF.DAIBfBHAKCAD.UDCAhAAALCCABDHAeEEEhACAODEEAAHACFFDZEFESFHHhBAAXFAAYHBG...IGGAhAAA...hBCA...,2,-21,-8,13
fWJRdDXcFPeKUBQTNZHLMaEbOSCgYAVGI,GAAA..fAAARADAdAGADAIBFCDHeADABCFDQAGAhAAA.ZBCAHDFCaCADECGBhACAbEAC.CDDAAADA..IFFAhAAAXEFCKFHBTGGAMIDA.SGEDhBIA.....hACA...,2,-22,-3,19
feDXQaRIVTWGKSBFOPAdgcMJYbNHZECLU,dAAAMAAAJADA....bABAHAGB.EBDBLAFAUDDB.eCCBhAGAQDGBRCEATEFAGFCBhACABCHBOEEHhAHAAAIB.YFCFZGAADCCBaFHDIGHA.KHEAhBAASHGG.hCAA...,1,-5,-8,3
OEKdVLPNUYQgXMIWCJFfTbRZGHcSaBADe,eAAAEAAAdADALAEA.UCCAQAFAMAIB.CAHAFCBB.TCEAhAAARCFBHFAA.aEDEACIBKDDDhAFAPEHD.NHCB.XDGDhBCA.IGEA.fGGAhBDA....hCAA...,1,-9,-28,19
ZXNGVfOQUYCLIgWbBMPdTecSRAFHDEaKJ,HAAAEAAAKACAZADB.GAFAOAEAQCAB.CAHALDHBhAAAgBDABDEAdBHAeCCDhAAARFBAAEHBaFFBXCFDhAIA.fEEEIHAAMICATGFAFGGHDEIBhCAA.JHCA....hCBA...,1,11,-15,26
HfbMTKWGDcXJZESCUFgQReBaVONYIPAdL,HAAAMAAAKADAGADA.XAFAEAFE.CCADFCCHRBBBeAHH.aCFBOBHDhAAA..IEDAhAHAAAFAdDFAbEGDDDGBZGCASDHHhBAA.QGGABFEDNIAB..hBBA......hCAA...,1,4,-28,32
DQFUfZcJgaTXbWNSBGHMOVEPYLCdAeIRK,RAAAQAAAFADAZAFB.JACE..aAHD..TAFA..bCCBSAHBhAAAHDGB.MCDBhCAAEEEALHBAhAAAACEAeCGFDDIBfFCEXEDDBFHD.OHEAhDAA.....hABA...,2,-20,-11,9
DJfYCVNbagQPdIKSXLFMUZETcWeOBHAGR,RAAADAAA..JADACACA....VAEAaAGA..QBGDdAHAKBBDLCDBhAEAMCCA..EDDA.hBAA.TDGAeDGFHFEBhAAAADDBGFDBfHGFNIDB.....hCAA......hDAA...,1,-14,-30,16
gREMVIQbcFOeAYBTHfKCZGPSDXNWJUdaL,TAAAHAAACADBGAEA.DAGAXACB.JAEBaBGARAGBECCBMCABhAAA.QCCChACAFCFDAAIBBDHAZDFB.SDHHhCHAUFFAdGAA.LHEA.....hAAA......hAGA...,2,-22,1,23
WDQYgCdFXJTAKZaMScRefILEBGVPUHNbO,aAAAMAAA.RACA.eACHLAFBEAEA.GCDAUBGAHCEBOAHBQEAAhAEACBBD.dDDCXDGAhAIAAAHAZEGBSGCAhBAAfFCABGFCPFFBNICBDBBBFHGE...hCAA......hCEA...,1,4,-9,13
KPVGDcZfUQFAXSBIEeagRJLCNOHMTdbYW,BAAAEAAA.eACARACALAFBOAFC.HCDBdCAA...bBGDKCCAGDAAhAAAZCEBQCGAhAAAAAHA.SECBhACAaFCDCCCDMFFATFGA.PHAADBIBfGGAhADAFGEB.....hADA...,2,-17,6,23
URFMLWeNZVYSEJTcQKCBAGIHbaDPXgOfd,HAAAaAAA.XADBOACDdAEARAFALCAA.eCEFZAFBSAHHhBAAECGAJDHB.TDGAhBBAQFEABDEDAEBAbGAAhAAADFFB...fGGA.MFIBhBEA.WHBA...hACA...,1,-1,-24,23
IdUTJHBGCQPaNeOLKMXVZcWbYgSFDEfRA,dAAATAAAHADA.GAGAQACCaCAEeCEFLAEB.MAGBhAAAZDAEbDFDSAHBhBHA.ECHBAAIBIGAAhACABDDDCECDOEFBKEHB.XEGD...hADA......hAFA...,2,-7,-6,1
CHaVQXDPYIFdBSefMNZWKAJgUbRTEcGOL,UAAARAAAEADE.GADALAFBHAFA.QCGADAHB..ICCAhAAAdDAAeDDDMAIBZFEBAAHAhADAJDEFbDBD..TDGAhABACGGA.aECB.XFCD.FFHD.fGFAhCAA..hCEA...,1,4,-21,25
SfPaJTGBcKgVXUCALFbIQEdMZNYRWOeDH,LAAAFAAAQADAEAEAZAGBRAFA...eBFFHCCA.SCGAhADAaCAAGDCAKEEA.XEGBhAGAABIBdEAAMDIB.YEGBhABADFIBfGGE.PHCABFFCcGEChACA...hAIA...,1,-1,-17,16
TQMSeRcVNLXdGHKODPAICFgaYWEZUbJfB,FAAAaAAA.EADAZACB.UAFA..JAFBBAHAMAHBRDEA.....VCCBhADALDHBGEFAHEBAhBAADAIBADIBCBBD..gGFBhBEA..YFEF...hBFA......hCAA...,2,-31,-25,6
BMbVXfGgeAUadIWcKSNYLHPZFRJODTQCE,dAAA..IAAAKADASAFBLACAHBGBZAFBRCCBDAIBQDAChADAECBA.MAIBbCED.hACAfDGAGECAACEBaDAChADAcEDD.PEHDOEHDBGGDXGEAhAHAeFCD.....hAEA...,1,0,-10,10
eNRfJHCbdGYDQLOWAaEIVFZSPUcTBgMXK,EAAAFAAAZACBUADABAEA..MAGBeAFHRCBBHCGBdAHAGDEB.DECBhBAALDDB.AAHAaBHFhAAASEDDTFFAKFBDhBCAfFFECHHA.....YFHBhBHA.OHDChCAA...,1,-7,-32,25
cTXRYHgfJNVIeWSGUbLKZEMaADdCPQBFO,dAAAQAAAOADA...TACARAGBHBDAJAEAVCBB..eAHHhAAAGDFALCEBEFDBAAIBCDHAhACAFDDB.XDGAhAHA.fFGAIHHA.SGCAhCAA......hCGA...,1,-10,-16,6
fTScPdXNUHRWLABaKgeMYbJICFGEVDZQO,aAAAeAAA.MAEA..bACDCAHAGBCA.EBEAZAEA.QCEChAFATCFA.SAGEhBAAdCHAXEBDHDGBREEBAAAAhBEAKBBDJHFEFFFH.DCIB.fGCA.hCAA......hCBA...,1,-4,-7,3
PdCTcGXYfgEAFVIbMUQZKNRSJeBWDHLaO,FAAAVAAAMADA.ZAEERADF..eAFEDAIBHBCBLCFA..aCEDdDAAhAAA.TEEAGCGAXEGBhADAfFFAABGBIHCAhAIAQGCASFHHBGHA.ODDBhCAA.....hBAA...,2,-22,1,23
HgZWVFYfRKGNIJCMTLcDBdEAQaUOSXPbe,aAAASAAA..bACDHACB.ZAEAFAEARCEAGEEBJAHB.MAFAhAAATDEALFCBhABABBBDABEBOHEAeDHFVFCAhAHA.KGFA.CCFBDFIB......hBAA......hCAA...,2,-18,-5,13
CUBJHbKQScPGWTFfNAdDeMXEYLaRgOIZV,eAAAEAAALADARADA.OAGDZAGBCCCABCEAHCBAQDEAhAAA.SCHHhAEAGEAATEEAfECAhAFAAAAAdEGAMCIBaFGDgGEDIHHA..VGCAhAEA......hAGA...,2,-20,9,29
SATLYKVUJeEHBQRWfCgPFOdNGIaXcbMZD,TAAALAAA.KAEAUACAEAGE.HAEABCAARCEACAHBFCCA..dCHAGCEAhABAaDDH...bCGBZFFAhAAA.AEGBVGAAeEAAQGDChACA.fGGAOHFC..hAEA......hAIA...,1,-2,-17,15
NRPKgEGeVCTDWYZJLMASbfIOFQXdUcBaH,SAAA..bAAAOACDQAEAdAEABAGAHAGDRCEAKBHBhAAAECAAeCDF.TEAAhAAADEBAZEBEMCIBAEGAFEHDXEEAhABAaFFB.gGDAGGABCGGD.YHFGhACA....hAEA...,2,-15,-5,10
CFdHWLSaJeMOKPbVcZAIRNfGYTgQEUBDX,RAAAGAAA..TAEAEADADAGAFAGAHBFALCCBaCDB..eDADhAAAMCEBKDFD..bCGBZDGBhACAAAAA.fEDAhADA.gGFGQDABXFBDdFFASEHHhADA...hBAA...,2,-15,-3,12
dbVeKDZHTNPgJGQBFILXYaRcSCAfMWOUE,MAAAOAAAdAEA..eADAZAFBHBBB.TDGAgAGA.hAIAGCCAQEBBhBAAFBBHLCFAaBHFREDFCFGDABBBfEAAhAEAEGHFKHCA.DEFA.PEHD.BFFAhAHA.....hBDA...,1,-3,-6,3
cdLZWBVRUeaCIOENTSJQGXYgFDAfbHKMP,HAAAMAAAdAEAZADBBAFARAGB.eAGHCBBA.ECAB..TDBAQDEDhAAAGDDAXEGDhACAFDGHAAIBKFHBLCCD.hAGAWAHHaBDB.OFFHSGCB...hADA......hCFA...,1,-4,-22,18
JgEYFTPLXIMUfObRBCQeNZadSAWGKDHVc,GAAAHAAAVAEAJADA...EBHFFAGALCAAMCDA.OCEBRCFABDDAhAAAeDFFZDBB.dEAAAEFB.DDIBhAAA...gGFAhACATEGA.IHAAfGGECEGA.NICB..hADA......hAEA...,2,-25,2,27
acMPJYXNFgEeHfVGUOABLTWRKSDCbQZId,TAAARAAADADA..QAFAdACAMAEA..JAHB..XBDDhAAAFBEAECDF.HDECGDFAAAIBLCCDhABASEEDZFCEaDHDhBHAPFHDgGGAeFDD.fHDBhCAA.....hAAA...,2,-16,4,20
LNAWKRPgIQfGDbFCUdMHZScETOYBJeVXa,RAAA..IAAAGADAFAFAdACAHAEAZCFBECCBTCDA..BCHAhAAAeAHHaDABAAGAKCBD.QDFDhAEAbEGD.MDIBhBCAOFBAVGCANIAB.gGFBDIFA..hCAA......hCGA...,2,-13,-2,11
KOUNLZPEWdHDTfQeBJGbagVcSCXYIMRAF,OAAALAAAZADBEAEAHAFADAHB...TCGAeBFFGCAA.hAHAaBHDgBBAhAIA.SCEHhBAAXCCAMDGBAEGBKEHBPFFBdEHABHFA....hABA......hACA...,1,-9,-20,11
NGOeVFSYPUAgLWMQHZdRJBIXEcafTDKCb,LAAAMAAAHACCRADFBAFBEAFE...aAGDTCCA.CAHBGCEAhBAAeBHHSCAAhABAUDGAABBBQGCAdDDDXDFDhACADCGAKGGAbFCBOEHD.FGGH...hCAA......hCCA...,1,-4,-6,2
OSRJBdbZAIYNHXKGLUcfEWaeQMgDVTPCF,..IAAAHAAAGADALACAfAFBEAGA.eAHHMBIBDCABhAAATCCAFCCHRCFBdFBAAADAXCEBhAGAKEHB.cDFDhCAAaEFH...QFGA.gGDAhCBACGHDSHAG.hCCA...,2,-21,2,23
fIdeFcEOAWVXZJKPBCSbLQYUaHNRDMgTG,XAAAZAAAKADCBAFA..SADALAHBQCAAhABAaAFDHBGBRCDBMDABGCDAdEGDeBGFhACAEDCBAAAAJEHBCAHBbEAD.hCAA..UGGADFCBfFFAcFDD.OFDHhCFA....hDCA...,1,13,-16,29
MZQSJEcBaLOdTFPUeDfAVCRIGKNgXbHYW,RAAAGAAAKADC...XADAHAFAMCCAZAFBQDCAECGABDDALDFAhAAAdBHATEGAFFFAeFHHhABAAAABCEAD..gGEAhACA..YHAASEEB.hAHA......hAIA...,2,-19,-5,14
fDFTIGgBRKHVacYMUeQXPZAbLESOJdCNW,EAAAOAAAdADA..CAFA...fADAFAHBGCBARAEFHAGB.aBBHhAGAMCIBeDDBQDDChAAAZDFEAAIBLFGBSDGBhAFAWGDADFIBTFFA.BGCA.KGED.hBAA......hCAA...,2,-11,-6,5
TUMKWDJLSbYFOeaEXdIQgRfPBGZNVcCHA,MAAADAAALADA..bABAOAGD.EBBBdAFA.QCCChAHARCEBBDCAZEAAVCGBHEGBhAEAAAIBTEEAKGDA.SFBAhBAA.eFHF.aHBA...hAFA......hAIA...,1,-1,-27,26
WKUYMRaLZBQXTedIcOCgfJbDVFGSPHNEA,KAAAMAAARACFZAEBBADA...QAFAeAGFdCAA.OAHFCBHA.JBBBhAFADDHBGCEAHEACADIBUGGAhBAALEEB..hAAATECAIGGAfDHE.FGDDNIAB.hACA......hAEA...,2,-23,-9,14
JODUbGRTLBeMWVaPdKEYZCXFQSgNHIfcA,DAAAGAAARABALAEBeADAMAHB..aAGAdCDA.EBFFZBFBFDFDQDCChBAASCHHHDGBhCAAIFHAACHAOFFBbEACBGGDhAAA..........hACA......hADA...,2,-18,-14,4
OYJZgLEBfbdeCVWINHTARMUXKDQFcaGSP,RAAAMAAAKADC.FADDGAFA..OAFAZCCAEAHBBBBA.dBFAeDGHhAAACBHA...IECAhABAHDDAADHADEHBaEEHSEHHhAIAJFCBLFFBfFBE..WEHHhBAANIDB.....hBFA...,1,-18,-29,11
dcWaXObgARGJPZEBCeVQLfHSUTFNDMYIK,RAAAGAAAZADBBAFAeADALAHBHAGBSCDA.TDFAhAAADCCBMCFBKDCDdFFD.aDAHhACAbDADAAIBEGBA.CGHA.QEGAhAAA.FGCDNEEA.IGEA.hADAXGGC..hABA...,2,-30,14,44
XgODfKGNAJCYUWePEcLMdaHFTIRZSQBbV,CAAAUAAA.eADAEACAMAFAHAGBFCDA.RDAA.ZBCEBDFA..bBFD.hADA.XEECDBHBGCAAhAAAAAIB.JDDB..PDHDhAEAdFFAaDHDSGBA.QGGChBAA....hBCA...,2,-19,-13,6
ELdcXQPBNFDWUJMgCYSVbeRIKZaHGAOTf,TAAAEAAAdADA..QAFABACBDAEAUBEAMAIB...CAHA.SBCDhAAAeCCB.RCEBZDBAhAFAHCGBADGALEHBhBDAXEECFFHDgGFD.YHBAbGCAaECHfHABhAAA.hBHA...,2,-13,-7,6
cMLEHXKPeCVUNbYdZBJaSQAgDWFTOIGfR,DAAATAAAGABB.RAFFLAHBHACBKAEAeAGHUCCB...bCEDZDFAhAEABCADaFAA.AAIBFCHDOFFBhAFA..fEAAhAAAEGHBCHCA.VFGB.dEDC.QGAAhACA.....hBAA...,2,-18,14,32
EdIBFeQARUWNVSPJCgbMLOafXZHYKDcGT,RAAAUAAA..VAEASADA.CAGA.bCCBLCDA.OAHDhADAaAHDZDAB.HDGBhAAADDHBGEAAEEEAdGDAFGGHhABAACEA.PHAAMEEBXFFC.KGHB.hADA......hAEA...,1,-1,-22,21
fHDQSUbMJLTCgAFNPKEVBcXRIOWZadeGY,FAAAKAAAEACEBADA.RAEF.OAEAZAGB..dCCAeAHFGDAAHBDC.QDDChAAAUEEA.bEGBhCAAMBIBLFFB.hADATGDAAEHB.NCCA.cGCA...XGFAhAGA...hCBA...,2,-25,-3,22
HfCdYVQIcgDXLSFbUBOZGRWNEPAaMTKJe,aAAAMAAA.KADAHACB.dAEBQAFC..gAGHhBAALAHBbBBCOBBHRDDAEEGAhBAAABFBeCHFCFFD.IDEAhCAAXGDCFEFDBGHAZGDANEIA.....hBCA......hCAA...,1,0,-17,17
MJZNGVbRXAKgPTfHDQYELeaUWOIScFdCB,KAAATAAAHACB.QAEAEACELAEBeAHBaAGAUDEA.OCABhAAASBGB.dCCAhAAAMCHBZDFEGGCBhCAAREAFAEIBfGEADFGAIHHACGGA.....hACA......hAEA...,2,-11,0,11
bHJXRYWTSgcDeIFLZdECQPVONfMUABaKG,aAAAGAAAHACBRADA...TAEASAGBDAGAFBGDdCDD.ECGBQDEChAEAODAH.MBBBhBAAAAABbEEBXEGA.hACAgGGBeDHHIHHACHEA.NIAB...hADA......hAEA...,1,-2,-12,10
XOEGdYKbRgHSTcINDeWQPMJLACBfVZaFU,BAAAZAAAaACAFACA.UAFAEAFA..GBGAdBHA.KCCDRCBAHDEA..hAAATDEA.IFAAhABAeECFQFGAhAIA.MFBBAAIBfECAOGDC.bGCA.hBCASGGADIEA.hBFA...,2,-17,-16,1
cXLVTKFWYSMbReOACNdBZUPfaQIEGJHgD,dAAAZAAAUAEAaADA..EAGAHAGD.DCAALBDBKDAA.FBHDSCHHhABARCAAACFABDFAQEGAhACAGDDA.JFDAXFGAhACA.WHFGbGAACHHA....NIAB.hADA......hAIA...,1,-12,-26,14
QCLDGNbPVcHdAfeXWKTaZSJOBMgREUFYI,eAAAKAAAZACBOADCBAEA.RAGF.FAGA..QCCALCABGCEAhAAA..bCEDVECBhACAHEGB.AAAAXFAAhAFA.aGDAMCHB.EFHF.....hAGA......hAIA...,1,-11,-26,15
TfMQSKaeNUbOAPXdLZIBRFJYECcVgHWGD,dAAAZAAARAEAFADA..EBHFCAGA.....VCAAHCACGCFATCFAMACAhABAQECA.hAHAaAHDeDEDUEFBADIBLFHBhAIABGAA.cFDCDDIBKGGD....hACA......hAGA...,2,-22,-4,18
IXNJEPLQGFDCBUgTedKOYHcaRSAZMVWfb,ZAAAMAAA..VAEA..bABA..XCAAEAFALBHBGCGAhABACCCABCEATDDAeCFHhAFAdEAAOFDBHFGBaEEHAACAfFFAhAEAIHCA.......hAIA......hBAA...,1,-8,-17,9
EWeDMTPgdLVRBbHNQOZGFcKaJCAUIfSYX,UAAASAAAEADA.eACHMAGB..TAEAdAHARCBAHDEA.QECDhADAGAGAKCEDaDHDhBAAAAAAfDFAhAEA.XEGADFBBLGFAbGAA.OHBChBCAFGGB.CBEA.....hBHA...,1,-1,-5,4
QWGeXdMAJBNDYFSbLRKUHgcafECPOZTIV,BAAADAAAFACDLACA.RAFFHCCAaAEAEAHBOAHD.ZDAFTBEAhAIAQDGDGCGAeECAhAAAdDDAABBB..YFFFhADAbEBBKFEA..gGDGCGGBIHAA..hAEA......hAHA...,1,-7,-16,9
FHSKVOLbQTaWAeMdBPGXZDfERJIUYNCcg,eAAAdAAAGADAZADBEAFARAFAUDAA..CAHAFCFAHCGB.KEFDLCCDhAAAQGAAaCHDADBBMDDBhACABDEA.DEGB.JFHBIGGAhADA.YFDB....hAFA......hAGA...,2,-28,-11,17
JWUeSAaEILMXgVGNTRbQZdBDHPOCKcFYf,EAAAMAAA...XACAGACARAEA.ZCEEdAFAHEAACAHA.FDHDJBBFeEFBhAAAACHA.aAHFLDDAhAHAVGCA.TEGABCBDDGIBhAEAKFBA....fFDB.SGGAhBAA.IHDAhBFA,1,-5,-23,18
DcLZFMETRfPCYabISANOHJGeQVdKWBUXg,HAAAeAAAdAEABADBUAGADAFAZAFE.FCAHEBCA.RDDA.CCCA...aDGASCEAhAAA.ACHA.hACAOEGDGDGAQGBAhAAAKECA.WFFDXEEB...hABA......hBGA...,1,-26,-28,2
cfaAVPJEIOUgHMTKFWSXZLQeNBYRCbDGd,VAAAEAAAUADA.HAFAMADA..FCBBXAFAZCEELEFA.hAAAeDDDBBDARGEADGIBdCFAaBHDhAIAAAHA.IDDAhCAA.TEGA.SFDA.QGGBhDAA..hDBA...,2,-24,-15,9
bEYdfeLOKXZDgcUAIPTFNSQaCMRGJHBVW,TAAASAAA.QADAaACA.RAFAHCCABAFAbAGDdCHAeDABhAAALCCAKDFBZFFADAIBgDBGhAAAAEEBFGAHMHDA.hABAGEEA.VFAB.EEHBOHFEXGCDhAFA.IHGAhBDA...,2,-3,11,14
agRGHbBXIOVKfWJcMLDUFTASCNQZYdPEe,CAAAZAAAdACAEADE..eAEARAFFHCAABAHA..OAHDKCBD..JCEAMCEBhABA.LEGBhACAFDDBAAEA.QFAAhAFA.aDFHbEFAIHDAVGEA.WFHHDEFASHCGhAAA..hBCA...,2,-40,6,46
RCWQXAFSPZJNLOKcgMIEBbYUDTefdaGVH,SAAAZAAALADBKADAMAFABAFB.UCCAeBFA.dCAAGAGAhAAAHDEARFBAQDAAhABAABFA.FDFBPEHDODHDhADAgGDAEFCADFGBaHGECGGD......hAIA......hBIA...,2,-13,-3,10
WCKOQdIDYVFMBNPXcEeSgRZALfbaHJTGU,LAAAaAAAHACBGAEBCAEAKAGA.dCFDDCAAFDEHBCDA..XDGAhAEAECFA.eBBDRDFAACIB.bFAAhAFAUEAA..QFGChAHA..IFHAMIAA.cEEChABA...ZFCF.hAIA...,2,-35,5,40
ICKcLfMFVPebdSOBZDUgXHTYERJQWAGNa,aAAAKAAALACB.MAEAFADAeAFH.dAHABAHAZBBADDBAXBEAhAAAHDECEEHFRCGFQEBAhBEAADHA.GEEAhBFACFFDfGHA.PHBAOEHD..hCAA......hCBA...,1,-15,-19,4
WENIQXALgMTVPOcFJDeGYadZbfSRCUKBH,MAAATAAA..OACEFACADAFAGAFA.dBHAZAFE.SCCAhAAARCCAKBBDHEEAECFAQFAAhAFAACCALDHBgGGAhAHAcEEA..eGEG.aHECCEHB...hAIA......hBAA...,1,-7,-12,5
USIFEeZDbWHdTXAKYgPCcBVOfQMGLJaNR,KAAA..gAAACACBBAEA.OADAMAGBGCCAaAGD.RCGF.SBDBhAAA.ECCBhABAeEABbCEDHDGDdFEAAAHAPHBChAAAfGBAQGGALGDA.NICBIHHAhAIADCFB..hBGA...,2,-21,-4,17
NDaJfcLeGQWFIRAOYCUBgKHXSZMTbVdPE,CAAABAAAHACAZACA.MADATAGA..dAHAECAADBGB..aCDDJCCALCFAhAAA.eEABhACAGDGAQEFAhAEAFEEBADIBOHBAgGCA.SFHBhAFA......hAGA...,1,-4,-40,36
CPaNbZLcfXKJIVGWMEDeBQAdYOFHgTUSR,dAAAFAAAHACBUADARAFAaAEA..ZCCALAHB..XCGAhACAKBFDIEBAGEEBEDEBeDBBhAGAABHB.OHCA.hBAASGHBCDGDbFGB.......hBEA......hCAA...,1,-13,-24,11
CQRdWgUMDXaBGLPIfJcAVbYNeFHZSKOTE,VAAA..bAAAeADEHAEAZAGBOAHD.ECAARBDBdEFAUCEBMBIBhAAAaDDHGDGALFCBfEAAhAAAADDBFEHH.TFEAhABAQGABDGIBBGAAIHHAYHAGhACA......hAEA...,2,-6,8,14
bHVZBTSIKPfYJcQRAFOEaWUDLeMXNCdgG,EAAAaAAA.DADALADA.eAGHMAGBCBBDGCDAHBCAZBGB.TEBAhAAAKCHB...fDEAhAHAcEAAAAIBOEHBhAEAXEGAdFFA.bFCDSFFD.IHHAhAIAPFAB...hAFA...,2,-13,-12,1
BGcWMIfJaSeNRbLPdAYEgKCUHOZVDFXQT,EAAACAAAHACAZACB.FAFAQAEAGCAA.MAHBJBHB....eCCAhAAARDEALCBDACAB.KEDDhAAAOCFDXEGATFDAhACABCED.IGBAaFHBSGGDNIABdGGA.hAIA......hBCA...,1,-6,-13,7
BGZHcKUdVOAaLESMbDNWgRCfFYTPXIJeQ,EAAAMAAADADA....NAEA.RAEAFBCB..TAFA..XBGAhAAAeAHHGBBAHDDAKDHDhAHAdDFAABBBaECHbEGDCFFA.fFAAhAFA.PFCCQGDDBHAA.hAHA......hBAA...,2,-22,-13,9
XCUFIHQAPMfaGgNcObSTKZeWJRBdEVDYL,MAAAGAAA...NADA.bABA..KAEAeAFARAGFBCEAEBHF..DCCBLECAhAAACCFA.FDGHHDCBhAFAACIB.aDHDOEABhACAZEEBdGAAXFGAQGGA..gGAHhAEA....hAGA...,1,2,-21,23
MCfJXTWFUdHADOgZIeKLQbcRPGSYVNEaB,OAAAZAAAeACELAEAQAFCRBBAGCEA..SAHBhABAVEGBEBHFBDDCMCCBfCGAhCAATFAA.FDDAhCBAHGCAADIBDEHB.KFFB.bECD...YFHBhCEANIEB....hDAA...,1,3,-12,15
AZaKBHTWQPfEgNGSbcUdCFJVDXRIMeYLO,aAAAHAAA.TAEAQADAEAGE.GAGASCAAUDAAdCCAFCEHDACAhAAARDFBeEDFLCGBhAIAAAGBBFHAfDCAhCAA.bFFACHHA.XGDCMFFB.....hADA......hAIA...,2,-12,11,23
LbIKBVXZCfSMgcaAdOUHWTQDYGPReEFJN,dAAAHAAAQADAGADARAFAECABFAFELCCB.KBHBXCFAhAAAZDABCCGD.MCCB.aDDHhACAADABOEDDTFAADCIBhADAeFFAbFEABGHASGHH....hAFA......hAGA...,2,-21,7,28
DdgEbNRIVFGMXeJBZWKSOATCPHfLUacYQ,TAAAHAAALADB.aAFAQACCdBFAEBHF.RAEFFAGAGEEAhAAAeCFHZFCBSCHBhAAAACABfEHAUEAADCCBbDDDhAEAIHHAMDHBBGFA......hCAA......hDAA...,2,-5,1,6
bRPeBHLCFVKTcZGfSIMUAJdONaDgXWYQE,dAAAaAAA.DADA..XACDQAFA.RBDBBAHAHAEALAHBhAEA.FCFDTCBAhACAGDDASCGAhBAAMBBBADDBOFGBgEFAEGAAeFHHKFCAZGEEfHCBhAGA....hBAA...,2,-17,-3,14
cTUEeWHONbdRIFJfagXBYQGLKZCVPASDM,MAAATAAAUAEA..EACEHAGD.OBBAdAEARAGBFCCB.aCFDBCCDhAIAGEDAZDEACFDAAAIBDDIBhAAAeEHH...bFFDfFFBhAGA.YHFA...hBAA......hCAA...,2,-24,-9,15
XgJbSCKOUZAVTNDQPYHLIMRaFfceWEdBG,TAAAQAAA.HACAMACARAFFFBHD.eCDFEAFAGBDA.hAAAXBFAbEABKEEAZEGBhAEAAAIBDCCBLHAAaCHDfDFAhAAAdGEA.BFGA.SDBDhBDA.OFHD..hCAA...,2,-18,11,29
CAaRFTDWQIYMVdKJPGNUgEZBcHbXeLOSf,RAAATAAAQADC..MACAdAFAKAHBGAEBUDDAEBDBZDGBHCEBhAAA.eCCBLGFAhAAAfCGFACCBaGDBDHAAIEHAhAHA.VGFANIEB.......hABA......hAHA...,2,-18,8,26
YRHMBTVacIfdEOPKbXSAgeZFWUQNDJCGL,eAAAZAAAFADAQADADAGA.GAGARBEAHCAAMCCBBBHB..aDDAhAAA.IFFAEDEBKDGA.hABAbFBAAFGAUGDA..hACACAFALFHB..TGGA..hCAA......hCCA...,1,1,-27,28
KMCNcYTZeRbWUXVSIFJABaHOLDdgQEfGP,HAAALAAAdADAEAFAGADAKAHB.MAFA.CBFB...NCAA..TCEAhAAARBGFbCAB...XCGDhACASDDDFCCHAEEBaDHDhABADFFAQFEA.fGGBhACAcFADeFHF.VGCA.hBIA...,1,3,-15,18
VJGOAPXUCRTecFLdfEHKQDgZYbNIaSWMB,XAAARAAAeADELAGBdADAHAFADAIBZCEE.....bDBBaBDDMCIBhAAABCCCGEFAAAAACCFCFDHDhCAAEFAB..QEEAhDAAgFCH.IHEASGFAWHAG.hDBA......hEAA...,1,13,-28,41
IXUJSWcDKGFVCETRYZQfHbNeLOMBdaAPg,..IAAAXAAAUACASADA.DAGAGAEBFBFDEBHBRCDAZCGBhAFAHCDBeCBBLDABhAAAMDIBaEFBACDBJDGBKGGACFHA.hABA....YHAA....hAHA......hAIA...,2,-15,-15,0
gZOMNIKBEPSTYXRJAHedcfDQVaLGbCWUF,HAAAeAAAdAEADACAaAEDGAGA..CAGAFBHDZBAEMDDA.KEBAECCB.hAAA.TEEARCFBAEBAQEDAhAAALFHBbGAAUGAAhAGAOGEEBEHASGGA...hABA......hAGA...,2,-15,-6,9
CfRedZKSNFWHgEUbXJGaTAYLOcQDIVPMB,LAAAQAAADAEA..IADAMAHBCBDA.RAEFZAGBKBFB..FCAAHCBChAAA.EDHFUDDAbEEBGGABhAGAAAIB.cGFDhBCABDHAeEGB.dFBA.SGGDhABA......hACA...,2,-35,13,48
YZdMXJDVfEWLFacQRKeOPTHbIGAUSBNCg,BAAACAAAZACA.dACA.MAEADADA..EAGALBEA.FCBHaBGERDDA.eCCBhAAA..TEGAhAAAHDGBGEDAAAIBUFBASDGEhBCAgCEGXGAAJFFF.fGGEhAGA...hBFA...,2,-22,-11,11
AZUYdDHTXESPOIMbaRWcgLQCeFBNGJVKf,ZAAAdAAAHADAEADE.OAFAMAFA.RCAA.....gBEAhABALCFAeDEBBBHAGCAAhACAKEGAACGADGEBTDFASGGAhACAbFFAaDDH.WHBA...CDHBFHFA.hADA......hBAA...,1,5,-21,26
HKWEPJeRBdTfMNUGSFgOLVcACQaIXbZDY,aAAAXAAAZACB.HADAEAEA...eAFERAGBdCEAMCDBGDFAFCEDLCGBhAAAAAIB.QDAAhABAbGCAKBBD.PFFBhADABEDDfHGFSEHH.....hAIA......hCAA...,2,-14,-4,10
UPTYKcZgMWIJQXbEGLdAfVHSOaeBDNFRC,HAAAaAAABADAFADARAFF.UCAB..TAFAKBHBZDCBMAIB.JBBFQEEAhAAA.EDHBhACAdCFD.ADABSDCHhADAeFHBCHAA.cEDD.gFABhAFA.XFGA.hAHALHAA.,1,-8,-12,4
NLYXAUQWbaTVCfJDgGRFPOEdIHSBceKMZ,QAAAaAAA.CACA.DADARADF.OAEE.EBBBHAFBBAHBeAHBhAAAZBDALCHBADDBUDFBbFAAhAFATDDA.VFFBhBAAfFGE..JFDF.....hAIA......hCAA...,2,-17,-16,1
RHOLBbJeMKZIFGcCXAYWNPQgEaDVSdfTU,...NAAA.QAAA.EACAaAFASAEAdBBATBEAHAGBhAAALCHBbCDB.eDBAhABAZDEBGGEBXEEAAAIBPDHDhAFADGBAfGDA.OHECMDDB.hCAAFGHF.....hDAA...,1,3,-6,9
XRIZYfUPGFcWVMQEDNOJLdAaBgSbCeKHT,aAAASAAA.eACHHACB.RAEAZCEEUAEAGEAAFAGE.VEFAhAEAECGAODDB.dEBAhAAAAAHAbGCATEFA.XFDDhABAfGHAcFGD...MIDAhBEADBBB......hCAA...,1,-3,-13,10
OPSRdEFZMGQTKYHDXcNBeWAJCUVbLagfI,CAAAVAAALACA..aADA..IAGASAFHEBHFZCCAGBDAhAAAQDACKAHBHCGBhAHAXDFDBDCDAFFAbGDAhCAAODHF.RECBdGGAMFIBDGCB.....hCDA......hDAA...,1,-5,-13,8
cWSIFLJYCQVZUDXPAHbNTERdeOKBMaGfg,HAAATAAARADFeAFE.BBFAGACA.fAEB..hAAAgCAASAGBhACALCHBCCEAZDFBXEBChAIAAACAEDDBdDFAMBIBaGGAIHDAFEEBQGCChBEADIAA.PFHB.hAAA...,2,-18,11,29
GCWZAgPbEBFDLaceNOUXQYRKMIJSdHfVT,...bAAAEAAA.DADAaAEAeAEA.UCBAQBECRBFA.MAHBhAAASDDBHCAATDFAhABAGDGAZECAAAIBBDFDhAAALFHBOFFBKGGD........hBCA......hBDA...,2,-26,5,31
OeYHKUEPLDVCNdZFWMAgTSfBJRGIbcQaX,TAAABAAARACAGAFA..bACBaAHFeAEAHCAAKAHBUECA.EDHBhAAALCEA.CDHAZEEAhAAAMEFBACCBfFAAhAFAIFAAQGGAOFCBDFIBdHBBFGEA..hCAA......hCFA...,2,-4,3,7
OGHdRJULcZbMgWfVKeXQPNFDSEAITaCYB,aAAABAAAHACBRACALAFBZAEA..MAFA..fAHAhAAAeBBDQCFCFCAAECHFACEATEDAhBAAODABdEHAUEDAhACAbGFC...VGFA.KEHB...PHAAhADADBIB.....hCAA...,2,-5,-2,3
VCAOKHYSQRJeMTBXbdIfUZWLPNEgFGDca,HAAAQAAARADFeAFEMADABBFA.dCADIAHAZCFELEEA.hAAAEFHFGBDA.aBFChBCAADDBKGEASCGAhBDA.TEGAfHCBPDCB.FFEDDIAACGBD.hBGA......hCAA...,1,-9,-12,3
PIdgKSRQHMBbcFfUXGWJZOVeaAYENDCLT,EAAACAAALACA..TACAdAGAKCCARAEFHAGBBCEB.FCCHUDGAGDFAhAAAZDAA.eEAB.AAIBDDIBhAEA..gEEDhAAAMEEBfHGFJGBAaGHB....NIAB.SGADhAGA..hCAA...,1,-5,-26,21
RIaXYcJWCUdADENVMefZgHFPOLbGQKBTS,EAAAMAAAZACBHACC.OAFAGAEABBBDRAGBaCBB..XBFDhBAA.JCDFCDGDAAIB.DDEBeCHHhBIAFEBDLFFAhAAAQFCCSGADIFFAYFHB.hAGAWHCAdHFB....hCAA...,1,-9,-17,8
VaWPgDdKEObcXGZFIUHSYBeMCRfJNQATL,TAAAaAAA....PADAdACAEAEAOAGDXAGA.ZCDBFBBHhAIAHCFABCEAeEAARDBAJDFBhBAAAEAALEHB.hBDAgFEAbEGDGGBBSHAAMBIB.hBGACHFA......hCAA...,1,10,-13,23
OWNHDACaEIGMdULPefJSBQVTbFZYRXgKc,EAAAGAAAdADALAFAeADASAGABBCCQCEA..hAAAbCDAZCGBRDGFKDCDODDBhAGAHEEBADIBaFFCMDABfGDAhAHAJFCBFGHD...YFHB..hCAA......hCBA...,2,-15,3,18
PDfaQSHZTUCEFgKVbeLWcMJXGOIdARNBY,RAAABAAADADA.aACAHAECZAEB.CAHB...EAGAKCCA..eBCBLCEBhAAAMBIBGCFAdCHAADGA..hAAA.PDBBQFGAhABASEEDTGEAFFHB......hBDA......hCAA...,2,-22,-17,5
SAcEXJNIPeMLFRQgHKdBCaVDOTYfGWZbU,EAAAXAAA..IADAeADALAHBRAEFHAGBdCBAaBEEOCDBhAAATDDA.GDAAZEGBSDFHhAAAAADANDGA.MFIBhAGAQFDA.BHBADIAA.fHGFhABA....hBHA...,1,-5,-9,4
FdOUJGTZEbceLSaQKDWBYPRHICfANVMgX,MAAAFAAAdADAUAEAGAFAZAGB...EAHBeBBALDBA.aDFHQDDAhBAA.DBIBhBBABCCDREGBHGBAfDHAhAFAAEIBgGEBOFBA.TGGA.SHDAhAIA..hBAA...,1,-8,-20,12
WbfDGVARHNEPQYLOKgUIdZXeJMScFBCaT,HAAAEAAA.QADCLADAKAHBUAFAZBCAeBHHMCGBFCAHBCHDaCCC.hAAA..TDDA.hACA.bDEDGEAARGFAPHBAhAIAOEGD.........hBHA......hDGA...,1,1,-19,20
YNFaHbPSUBXdEDMLeRAKcCgZVGJfTWQIO,CAAAZAAAGACAJADA.....TAEAQAGCOAGDFCAAHCABhAAASCEBXDFCECHFhABAMAIBRDDB.AACBKEDBVFGBhACAfEHA.IGAAaGDC.bGDAhAEA.BHHADIAA...hAIA...,1,5,-20,25
ZLOeXDbdEcSQRfTGBNYFJKgUPCIHAMVWa,MAAAaAAAZACBLAEA.eAHHDAFAEAHFQBBARBEB.GCEAhAFABBBDFCHDKDHBgECBhAGACEBAHEDAABGB.OFHBhBAAdFHASGEAfGCE.....hBAA......hBEA...,1,4,-27,31
PMSQUXeRJdTDFNVGaOgIYELZBbAcWKCfH,KAAAHAAAMACAQADC.eAFERAEAdAHATBFAFBCDGCEB.hAAAOECAgCAAhACAEEGA.ZDDAAFFB.CCHASEGHhAIAXGGA.DEIB.aFDA.IHHAhCAA......hDEA...,2,-25,1,26
ODVeFdZPCEMRWgbSUacKGYXJHLAINBfQT,BAAATAAADACA.FAEDZACB.EAEARAGB.....bAGDaBCB.GCFAhAAAXCEBHDCBAAIBfCAEhAAAQGAAeDHHhAGAdEDAMEHBSFFDKFFBYGBAIHHAhAIANEIA......hBIA...,2,-18,4,22
YBRTGfQCOVADSNgKaHcXLMbPeFZWJdUEI,SAAAKAAAHACBLAEAMADA.eAHHZAEEdCCAECABBCEARCFAGEDAhAAAQDFDODBHAAIBDDIBhAAAaFFAXFAA.hABAbGFAFGCH.UGGB.......hACA......hAFA...,1,-1,-10,9
EYBVgTDPNLdfAQIbJOHFKaSUWZeMXcGCR,QAAAJAAAHADBKAFAaACE..UCGAZAEBeAGF..MCCBGCGAhAAAEDABBAHBTDAADDDBhADALCDD.AAIBbEEDhADASEEB.XFACCHHA.RFDBgGFHhAFANICB.hCAA...,1,-1,-16,15
JIACSDBZdeREcPFYOLMfGaXTUKQNbWHgV,DAAAdAAAEADAFACDLAEAGAFA..aAHFUCEAQCBA..hACAbCGDHDDB.gDGHhADAIFAAAAIBBFBAhBAARGAA.PFHDMBBBTGGAKHBA...WDDDhAFA...CFFD.SGGDhBCA,2,-36,12,48
RLXUJMeYCKADHVBQbEcFdgTWPOIGaNZSf,HAAAQAAAEADEdAFA..TACAOAHBaAEAZCAA.RDFBLEHBhAAAUBFBeCDFKCEDAAHABDGDhAAA.bEEC...FFHDhBIAWFFD..........hACA......hAIA...,2,-17,-11,6
CANMIHVDKbREeFdOTJYcBPSfZgGUWQLaX,MAAAHAAAKADCRACA.EAFAeAFE..dBHATBFAJCAFBCCA..fBBEhAIAGCEAQECChAAAaCEHACIB.IEHAhACAbDGDODDH.cFDDZGDE....hBAA......hCAA...,2,-21,-10,11
IBQKYGcMACSOXUeDPTfFLVbHgZNadJREW,OAAAeAAADAEA..TADALAHB.HBCAZAFBdBHAEBFEBDEAhAAAQCCCGDFAABBBXEEAhAFAfEBAbEGDaEDHhABARFCB.KFHB.MHBA.CHEA......hAIA......hBAA...,2,-17,1,18
VCNDZgITLdAeOKaGJYHfRWSMEPbUBcQXF,eAAAaAAAGACAHADARAGF.MCCBEAEA..UBGAQDDAFCED.CDFAZEGBhAAATEAAAAFA.KEFAfFCAhABASBBDBGFChAIAXFGADFIB.LGCA.OHAChAEA.YHEGhAHA...,1,-4,-10,6
FUPRJNKVYgGLOCIEABZMWDadcXQbHTSfe,ZAAAMAAAaACAdAEA..QAFAHAGBSBBAeBHH.FDDARCCAKDFBhABAVEBAGFABLEGBhAGACEEDAEIBDFHBXGBC.hAFAfFFA.......hAIA......hBHA...,2,-18,-4,14
gTEFIcUeHSfCZVWBAbPYDNJaOMKGQdLRX,...bAAADAAA.aABEMAEAGADALBEARAFA...TCAAhAAAECCBFCGDIDDAeDFDHFAAhAFACCHAZDFABEHAAAIBPFBAhABANIABKGHB.dFFA.XGBC....hACA......hBFA...,2,-12,-6,6
FUQIAdBDZESPbLVJfRaHOCcWeXGNMKYgT,dAAAZAAAEADESADALAFB..JAGBRCAAHCGB.CAHA.eBHHGECAhABAMCCAKEEA.TGGAhACAQDAABCECDHAAhAHAbDDBaEHD...OFED.XGAAhACA.gGGGhADA..,1,-5,-8,3
WBfDgdHJRbMXGQAZTKNFOSLEUaIVeYPcC,ZAAATAAAFADALAGB.UCAAaACAeAEH...cAGAhAAABBFADAIBHBFBRCDBMDIBhABAGCCA.ACCBODBHhAIAEEGB.IEHA.PEFBfFDEhACAdGHAJHCAXGGChDAA...,2,-33,17,50
daYTcGFHNPKEgBDUbSVCRILAeXMOWQJZf,eAAAMAAA.QADAZABEdAFA..aAHBTAFAGCCAHCCA.KBHBhAAAECHFDDGBSEFBhBAAREEBAAHAODHBJEHB.fFBAhBFAFGHD.gFDH...hABA......hCAA...,2,-10,-8,2
DIBSHFZVYXCAUbGgLNEKQJTPdWMefcORa,GAAALAAAEADAQAEA.TAGAdAGAeBFD.OBHDhAAARCAAaCECBCHAHCDBZFFAhACAXEAAACDBbGBAKHFAPEEAhABAMDABDEIB.FFGD.......hADA......hAIA...,1,1,-7,8
QHLDBCAOUfGbIEgdVKNZPYFRXMJTacWeS,OAAAGAAAEADAdAEAKAGAZAFBFAHD..RBCB.MCDB..aBBHeCEDhAAAHCFALDHBCEBA.hAGAABFBUGEAbEEA.IHHAhACAgGGA.PHCAYDAF..hADA......hBAA...,2,-14,-9,5
TFOQKBUMbWPdZIDRLGAJCfgVSeXYHacEN,CAAAVAAA..eACAHADBEAFAFAFA..QBGABBHAMCGB..hAAAbCAAdDAAZCEFREEBADDBJEDBSDHBhADA.aEHHhAIATFGA.KGEAPFBCDCAA....hBFA......hCAA...,2,-15,-14,1
TaZGQNXgdCAbOVfFRcPSeIMBWJEKHUYLD,OAAAFAAARACF...SADAeAEEMAIBBAGA.EBBBHBEALCEAhAEAaDECGDGAQDCDhAGAXGDAdEGAAAIBfHABhAHAIGCAKFEBDGGB.NCIACHHA....hBAA......hCAA...,2,-18,-6,12
ASXBIUYHfRcVeFMPZCWQdLJaOEgDbTKNG,BAAAUAAAHADARACA.eAFEMAFAZCDA.QDAAdBGAaCAA.ECGEDBIBhAAA.KCEBAEEA..XEFAhADA..fDAAhACAFFCDCGGD.LECB.OEEBhADA.bFGBNEIA.SGEHhCEA.,2,-34,-4,30
fCSbGRLIUWBZXYcaOeDQMKTgVAPNEHJdF,EAAAHAAAdADACADBGAEALAFAUBGAZCBA...XCAAaCFADCIBMDFBhAAAKDDB...TEGAhAGAAAGAPEGB.FHECbGDAhAHA..IHHABHHA......hAAA......hACA...,1,-12,-21,9
BQaDINSGdUCcFJOWbLAERePMgZfKVHYTX,RAAAeAAAMADAZADB.KAFAHAFC...TBDAQCFADCCBSCFHhAAAdCCCCAHBFEEBOCHFhAAALDHB.EDDBfFCAhABAXFDAaGFDIFGANIAB....hBDA......hCAA...,1,-1,-29,28
OILMNDFcHbYeSQTdWEBVKGUfACJRPZaXg,RAAAaAAAOADALADA.DAHBHAGB.eBDFTCCAECEFBDFA.hAEAGEGAAAIBCBBDZCEBXGBAhAAAMCIBFDGB..YFFFhABAdFAAKECDfFGA...hAIA......hBGA...,1,-11,-19,8
AYMRQLCSdGgUJbEcNKBFHTVDWOfXPIZea,RAAALAAAdADAGAFAUAEA.EAGAKAHB.HDDBDBIB.OCCB..hAAAXCAAZDGBAAFBMEIBhABAQDDA.SCGHhABAgGFGbFEABHAAFEBH..WFHHhACA.fGDEhBEA...,1,-7,-29,22
dGNQJaXefLgBMFURPcDVSWKZITYbHOECA,GAAAQAAAaADA.eACALAGBBAFAMAHBRCDBDAIB...SCDAhAAAZEBBTEGAHCFBhADAEBFFAAABdECA.XFFAhAIAFFFH...........hACA......hBCA...,2,-16,-12,4
UAEbJOFRVGcfYDPTLKCdXgaQeMIBNSWZH,EAAAOAAARACA.GADA..fAFBDAFATBGALAHBhAAA.dCCDaBBHeCEHMDDBhAIABCGCSDHHhBAAHDAAAEGAbFFAFEFB..cFBCKHFA.XGDDhBDA.QGGAhBFA...,1,1,-18,19
SKEGBOLZfQACYWFcRTXHeNJPaDgdVIbUM,CAAAFAAARACA.HACB.eAEAJAFA.DAIB..dCAA..ICFAMCCBKCGAhAAAECHB.GEAALDDBhACAZDEAAAEA...cFFAhBAATFFA.XDFCaGHD...bGCChADA.BHHA...hBHA...,2,-25,-14,11
UHTQGDaJVPgEAcYBdFfOSRKINZWXMLebC,BAAAdAAAOADARACAKAFC.ZAGB..MAIBeBDB.CBFA.HCAAGCBAaBFE.hAAA..VEFAECEBAACAFFDBhACA..SDFHhCAA.IEHANIBB.LHDA.hBAA......hBCA...,2,-19,-19,0
GXYWBFHfCTIedgKMNcabDLJURQZAOPVES,OAAAEAAAGACA..XADABAEAHAFBCAGA.eAHBdCCAMAIBhAEAaCBHLEEARCFB.ADFBSEADhAAAFEDDTFGAKGAAhAGAbGEADEIBJHCE.........hBAA......hBBA...,2,-22,0,22
KdRYSacEHgOeNPQXFLGZWIJUDTVAbCfBM,CAAAMAAARACA...aACEHAFB.eAHBQAFALCABZBBAIDDAhAAADAIBACFBBDDD.dDGAhAFASDFAEFEBOEHDhBAAXECCFGGHJHBA.TFFA....hACA......hADA...,2,-24,-11,13
AcfgLbVCPOUJRNMdKEQYBaHSIGeTFDXZW,...fAAAbAAACAEA.OADARAFF.dAHAEBHFQBCAhAAABCAAHCCCGBFAeDHFTEAAhAAAXCADAAHALEFBhABAPDHDUFCAMFIBaEED.FGGB.WHBG.hACA......hAEA...,2,-8,12,20
GHcYgCIVdNSWBULJMXAZRDQfTEFPKeOba,RAAAQAAAEADE.KACAeAFE.OBEEGAEAHCCA..gAGBhAAACCHAdEEASDGDhAAABCDDLDGBhAEAMEIBAGGAfHEBTGBAbGECaEEC....hAIA......hBGA...,1,-7,-16,9
GBVWfHebNCaZdTJQUgRLIcYOAKMXFDEPS,MAAADAAAEACAGACB.BAGBVAEAHCCA.eAHHCAHBdCCAQDFDhAFARCFALEEAIFCAhBAAOBBH.ABBBFFGH.SEEDhCAAfFHANDIA.aGGH.....hCCA......hCFA...,1,-2,-24,22
bBHQAgUKVZYCETXOPDWINFLfGSJdRecMa,KAAAZAAAEADEOACA..DAFA...IBGALAGB.GBCAhAAAdCAARCCA.eBFFMAIBbEEAhAIAHDFAABIB.UFCACFBATGEAhBFAXFFA..NDIA.SGHHhABA.aHDEBHHD..hCAA...,2,-19,-5,14
PFYTILbgJEXSdKeZDNQMaRCUOVcBWHGfA,FAAATAAALADA..JACAEAHBdAFAeCCAZAGBDBIB..MCGBhAEARCCAUEEAOCHB.BDEAhAFAHGFCACCA..IGGAhAIA..........hBAA......hCAA...,2,-33,-29,4
MSGTBcVaZNRPDefFJbWQUHXEIdAOCgKLY,CAAALAAA.MAEAGACABAHAaAEARBCA.eAGHFBGH...bBEDQCAChABA.HDEAhACAECABAAIBKEDDTEBAhAAAZFBFDEIBfCHAUGFA.dFFA.OEHDhACA.SHFAhBCA...,2,-15,-5,10
CFLGfEZgHNPYeJUXSKbBdQcARWIaOVDMT,RAAAaAAADADA..MADAFAFDGBDAZAEEHBCB.....PBHDhAIAeAHBXCGDKBBDdCFAAEEBOEGDhBAATFEALCCDhAAAEFDB..YFFFSGDD.BGHAhABA.....hCAA...,2,-16,-13,3
CINTXFGgSfOLBAWPKVReQbDcJaZEHdUYM,KAAARAAAeADEQACC.DAEAaAGA.HBDAdAHAMBFBCBHD..TDEAhAAAGDDA.fCGEhAAALDGBACCBPFGBhBGAbGFA...JHBA.......hABA......hCAA...,1,-17,-20,3
PeNMFHJRBDQZTEKOdGVIXLYbScCfAWaUg,aAAAUAAA.eADAMADAHAGBRAFA.DCDAZBBAKDAAGCEA..XDDAhADAbCGD..CDBAABDAPDGBhAEAFGDBBGGA..hAIAEFHF.dGBA.........hBAA......hCAA...,2,-22,-17,5
GRdcaYEgPHWZfXbKDCQNVOSMTBUJIFAeL,eAAARAAAdADA...aADDEAFAHAFAZBFE...bCCACCCD..QDEBhAAA.ODGDMCHBTFAAhAAABFAAUGGBFEEHAAHAhABALHBAGGEBgDBG.WDHHhAFA.....hABA...,1,7,-21,28
cdDTCBbPJMUFGgVKHaOYZEWRfeNAXSLIQ,LAAAQAAAdAEACACABAEAJAGB..MAIBGAFA.KAHBHCAAhABAaCDB.ZDCE.RDGBeFFBhACAADFBSDGHDGAA.bEABhAAA...FEDD.OEHDWGAA...fFFEhAEAIHHA..hAHA...,1,-14,-25,11
KPIMTcWXUSHLJOfNQAdCDEabVYBGFegRZ,dAAAEAAA.aADA..VACAGAFA.FAHFRAFFZCCAKBDB.MAIB..TCBAhACAXCGDHDEBLFAAhAAAODHBQGGBhBAAAEEBbFFABHAAeHFE......hAFA......hAHA...,2,-8,-8,0
gABGbSQJdcKIeaERFMDNUZPOLWCVXHTfY,GAAAQAAAdADAKAFAeACARCDA.DAGAZCGBLBFA..CAHBHDBBhAAATCDA..fFAEhACAABGAbDAB.SEFDhAFAIDGAEEFBMDIBPEHDOGCC..hBAA......hBCA...,2,-13,-10,3
JSYGXZbcQdOUKMfACBLaIETWPHNgeDRFV,LAAAEAAA.TAEAHACAeAEE.RCCAFBHDSAGBGCFAbFCAhAAAdCAAKCCA.AAIBaCFDhABAIGHA.PHAAhAHADCIBVECA.XFGA...cGFChACAOHFCfHDBhAEABEHA,2,-28,-3,25
bIcOaUTZRFBefPXJYMHKgELWGdSDQVNAC,CAAA..bAAAOACA.UAGARAEAeAHH.XCAAMBCBHBEBECFFGDDAhAAAdDHAQECAhAAAAAEAaDGEZFGBBBDD.fEFAhBGAPHAAKGFDLHEA.DGGA.hABA......hACA...,2,-10,2,12
HSKUaQgWEJYcbdONMFIZCfTXLPRDeVGAB,HAAAKAAAQACCEADEJAFA.....bAEBdCAD.MCEAZAGBTDDAhAAALDDA.RDGFeFDBhAAAABGBSCHHaFFH.hACAgEGGcGGD.FECH.fFFEhBIADIAA.BHHA..hCAA...,1,0,-18,18
STDVLUCEPYcfXOJKgHMaBZINFdGAQWReb,RAAAeAAA..TAEALAEAEAGE...PBCD..fCCAhAAAOAHDKCEAHCFAhABAaDFEZECAFDABACHAQFAChAAAbECADEHBCGFA.XEGAMEIBBHHDdGGAGGCBhABA.....hADA...,2,-14,11,25
TBfLKIDUEYZgVeFJSdPbOXNGcCQWHRMAa,aAAATAAALADA.DAHBEACE.ZAEBeBBBSAGAdCFA.OCCBhAAAGDCAQCGAhAEAHEABAAEAKCHBIEEAhAHAgFFAFEGHbECDNIABCHHA.MFIB....hCAA......hCDA...,2,-6,-6,0
RHPaEcdXMfJGONFSUBQVYTLegDZWAbKCI,CAAAHAAA.EADEdACAMAFAGAEA.FAGABBFA.QCABhAAATCGAeCBBZBGBACEB.bDCARDDBaEABhAAA..XEGAhACAOEHDSFGDVGDAgGGBKGBA..hCDA......hCIA...,2,-11,1,12
dTQRbGMNKAfWEYeSHOPVFaJXIDCUcBLgZ,EAAAeAAAHACAOADCFAFA...aAFAXBGACBHA.BCCDZCCAdDGAhAAARCEBGDGAMDIBACEAfEAAhAAASEEDPECBhAEAIGCADEEBcGDDTGGA....NIAB.hABA......hAIA...,1,4,-23,27
NRdfQFcbHDABKMGVgLEITJWeCYUZOaSPX,MAAAGAAALAEAEADA..TAFAeAHHCBBAZCDAOBDBaAHDXDGDhAAARCEBdEHA..QFAAhAFAbECAACEA.KGCCgGGAhACAIGFAYHFGSDAD.fHABhADA..hAHA...,1,-7,-8,1
gIEFCRZJcGDbBXTAUVHSYLKOPaefNMdWQ,HAAALAAAOACAeADHMAGBdAFA..QCAAEAHBRCCAZDFEGFBBhAAABAHAACHAUDEA.SDGAhABAKFHBaGFDfHDFhAIANHAB..gFGACHHD.DFBAhACA......hAHA...,1,3,-22,25
bdCFcTfXJODaUPHBRNZgSQVWIEYLGMKeA,dAAAFAAA...TADAXACDDAFA..aAGEHAEA.RCEAZEAAQCBAhACAVEFA.ECFAGGABhAEAeCHFADABCDDD.JEDB.OEHDhADABGHASAGE..IFFAhBAAMIDA....hBCA...,2,-19,-4,15
BfCebOSVEcQgdUXTJAGNRYFWMLZPHDaIK,RAAAFAAAMADAZACBHAEA.DAGAaAFEBBHA..eAHHOCEBEBDFQCEAhAAAdDGA.TEGAhABAADIBGGCB..hBAAYCCFLFFAKEEDCHHA.bGDA....hCAA......hDAA...,1,-10,-21,11
dQeEYMbUJISZgVTGPfWFLHaDcKBRXNAOC,dAAAEAAA.MADAUADA..SAFAZAFB..TCBAGBDA.hAAAfBHALBHBHEDAhAIAaCAEKDFARFBBABCAQFCChACAeFGFYFHBbFFAIHFA..hAIA......hBAA...,2,-18,-1,17
HSAVOGdgPJCBMWRUTYZfEKLIacFQDNeXb,GAAAdAAAJADA.MADA.RAFA.UAGAZCDAECHBLCCA..aDBDQDFAhACAeECHHEEAABDB.hBAAOFHDCDHA.BGGChAAATECAKHEA...FFFHDIAA..NIBBSHGAhBCA...hACA...,1,-1,-23,22
URAePGFCXcNBbZDJMVfIHgYLdEKTOQSaW,eAAAGAAACADA...XADABAFAZAGBMAGB..ICCAhAAAHCDBLAHBECEA.TEGAhAAAQECAaDAHRFDAABHBhACAFDHDNDCADGIBfEFA.dFAA.SGGAhABA...hADA...,2,-18,-2,16
fNVgXZQKeOHGCFRbASWBcLDMPITdaEYJU,BAAALAAAMACATAEAdAGA..EBCAUAGA..VCDAZCAAeCCEhABAHDGBGFBBRDFAAEAASEAAhACADAIBaCBHfGGEhAAAXFFAKEED.FGDH.....WFHHhAEA.....hBCA...,2,-18,0,18
CMaJSTcIEPdYBVgQXDefFRWUKANZOLbHG,ZAAALAAAHAEAGCAAaADD.SAGE..TAFAhABAECCBdCGABAHBQEDAhABAeCABRCDAKCHBAACAbFFBMCCBhACAIHHAPEFBgGDGfEGB.FFAHhAFANCIA.CGHAYHCAhCBA...,1,17,-16,33
OTKXCGNAYHeSIFEbPQdVcRagfWBLUDZJM,HAAAeAAAFADDEADEQAFCdAFA.RCAA.aAHB....fBHAhAAALDDAZDGBMCEBhACATFBACDFAAAHASDHHhCAAbFDB.cFDCBGFDDCCBKFFA....hAAA......hABA...,1,3,-25,28
YQMZPXOBWdeIFLDAGKRgfCbHUcTEVNJSa,RAAACAAAHACAUADA...EAFEJAFE..aAHD.MCABZCCAOBHD.hAAABCGCeCCA.LDFAhACAAAAAGEEBfEEEhAEA.bGCC.TGGASGHB.hAHAPHEA...hCBA...,2,-35,-8,27
IZgbBVdCJaWEYXSMLDGcHAeKUfRQFTPNO,eAAAKAAARACF.QADAFAEA...TAFAOAGDZCCABCAAdAHAaDFDhAAAECEB...SDHBhABAMAIBGDFAHEGBhCAAAEEB....fFCANEEA.IHEAhAAA....hACA...,1,2,-43,45
VagHEXGORJZYWIebUMfcNdLASQTDKFPCB,TAAAFAAABADA..aACAHAEB.EAGAGAEARCCBZCGB...IAGAhAAAeDABMDIB..hADAfBHAdEFCAGABQGDChAGAKCCACDBDXDFD.ODHF.hBAAYEEF..hAIA...,2,-29,-6,23
QHSOdJUDIZTeFYMLPcRaGbKNAfEBWgCXV,EAAABAAA.CACA.QACAHADBdAFB.DAFAZCAAeAHFFBGH.MBFBLDFAhAAARDDBGEBAKEEDAAIBfDHAhAAA.XFGAhBEAOFGB..IHHATGEA....hACA......hCBA...,1,5,-33,38
LOUIYWFgDJKBQRfMbPcESTNXAaGHCeZdV,HAAAeAAAdAEALADBOAGBIAFA.FAHBDAIBBCADRBCBMCHBhAAA..bCEDEDFBTDGAhAAAADIBGEBAZGCAUGGAhACA..gFFGKDCD.....hCCA......hCDA...,1,-3,-17,14
IKMeELBaYWTXSbJUfNGgPVcFdCOQDHRZA,MAAAEAAALADABADA..aAEDTBGA.SBCDUAGAGBBAhBAAVCEBdDEA.QDGAhBBAHEAAAAEAeDHFXFGChBGAbGFAfHAB..gGDAhBIA....hCAA...,2,-23,9,32
SWMedFIRVgLDCUbBHYNQJXaZfGAcKETPO,EAAATAAA..SACAeACEdAFARBGFLAFADBDB.CCCABCEAhAAAHCDBQEGBhAAAaCFD.ZFDAAAGAKCHBOHAAhAHAMDABIHHAgECA.bEGDNCCA.fFFAhADA.PHCChCAA..,2,-13,-4,9
IgaUbQWGTJPODNfHZMEFVSYeXBRKALdcC,dAAACAAA.aADAQACA.GAEBTAGAOCABDBDBHCBBECCBFCEDhAAASCGA.hACAeDFBRCGBAAHALFFAhAFAIEHAbEDDWGEGPGAANICB.MIAA..hACA......hAGA...,2,-12,-2,10
CLEAGOFMWVHdDKgNeTBPfQYRJbaSXIZcU,GAAAMAAAHACCdADAKAFAeAFEBAHB..QBFDRCDA.aBBChAIAXCGBZDDACDHAAFFBFFHBhBAADDIB..TEFA.hCAA.fGDAbDBDSFAD.IGHAhAAA...cFEChACA.,2,-35,-6,29
XEbVPgJQCcGLKTAIRUeYWdNfHMBOaZSFD,RAAAeAAAdADAHAFAMAEABAHAZCCADCHB..EBCA..VEFBJBEBQCGAhAAAGFABLHAAhAAAABGBUFEA...NDDA.aFHDhABAFGGA...........hAFA......hAHA...,1,-9,-22,13
PLYCeaAdFDESNGMXbHWJTQOfIUKVBcRZg,dAAAEAAAGACAMADAHAFC..TAEAQBDCOAGDUCGBBCBDhAAARCBBZEEALDFAeFDBAFIBhACASEAAXGGC.hAIAbEDD.fFFB.KGAA...hBAA......hBCA...,2,-1,-1,0
MTIZJKcPGfXBHdaFAWUCSgeVLOYQREbDN,CAAAeAAALACAQADARAFF.EAFADAIBMAIBZCCA..KCHDGCCAhAAABDAA.HCFB.aEHDAADAUECAhAAASFDH.hAHAOFFB.YHBAbEFA.IHHAhABAPGEC.....hCAA...,2,-37,17,54
dRSFfegKIMOTUZXWALJNPEGVbYCBDQcaH,LAAAJAAA.EAEAGADA..bAGDBAFA.QBGAhADAHCAARCEBfEAEhABAeCCBKDGDMEFBTECAZFAAAAIBPEGDhACACEHAaGGA.dGCDFHAA......hAFA......hAHA...,1,9,-18,27
IdNYXVOSaPUZRTgeLHQAKDCFbcfWMJEGB,CAAAFAAA.....bACDfACA.MAEAEAEAGAGAhAEABAHAdBEAXCEDOBGBaCABhAAAZECARGBA.eFHBHDCAhACAAAIBDDIBJCHB..IFFA...YFHBhCDASGFH.hCEA...,2,-29,-6,23
UCRQMFYJdbOPNLXTDSgaIKHWBfAGEeZVc,EAAAeAAAZACBUAEA.RAGB.MAFA.FBEAdBDC.OCCHLBHBDDFB.hAAAaCBBHEFBBCEDAAIB.GDFAhAAACDHA.JFEFNEEA.SHCGhBCA.KHGAWFHB....hABA......hCAA...,1,-10,-27,17
ZXJHLQUWVNDIAPEFCBfYcegOGbaSKMdTR,EAAABAAA....fACAeACAGAFAaADD.MAIB.RCAAZDCEhAAAHAFALEHBQCEDhAAAUFBBVEGBDFFAAACACCHAgFAAhAFASGGDdHADXFED.NDDA.hAHAFHDE.....hAIA...,2,-7,0,7
XKQBAFfgMSDEZRceaTWPYCbdIHGOVNUJL,FAAAMAAAEADARACA...eAFAaAFA...TCCA..PBBBhAIACBHAdCEAHDABGBFAOCGBhADAUECALCHBhBAAQFFBADDASEFDZGAAYFHBIGHAhBIA.JHEABHEA..hAGA...,2,-4,-2,2
EMeVFdfHAWIYQGSCKXRZbOPUgDLcaBNJT,..IAAAGAAAKADARACA.ZAFB.OAHDUAFALBHBBCDAJDCF.hAAAECAA.eCDFdEEAHFABhACAAACAQEEACDHD.hADAbGDCDFHB.aGEEMFIB......hAIA......hCAA...,1,-15,-17,2
deOWKcQRGNbHFXLSEJBTfAZCPMUgYIVDa,ZAAAMAAAUAEA..IAEAaAGE.eAFHKCAARCFAGBBA.HBGBhAHALDDBEDEBTFGAhAIAAACACEBA...gGEBhBAADEHBdFFAOHAAWECH.....NEIA.hABA......hAHA...,2,-29,2,31
JfUWeBYMRATVNKSDdgLIHOPaCZbEcFGQX,TAAAKAAAdACALAEA.HCDAaACAbAEDEBHFGEFA.QFAAhAAAfAGAeEHBhAFAMAIBADIB.SCCBhAAADFEBOFCFZDBF.XDFA.UFGBhAGABHHDYEEF.hAGANIEBIHCA.,2,5,8,3
cZQdeMHaIPLVFBOKSYCJgAEbRNDTUfXWG,RAAATAAAUADA.....XACBGAGAZCCAeAEAHDFB.aEEHhAAALBHBBAFASEHHhABACCCDACEAECFAbEDADIAAfFAAhAAA.cFGDMIDAIHHAhAIAFHDA.....hAFA...,1,-10,-15,5
VfTUQdMHWJaZLDGcOeAYgNPEbXKFCIRSB,...NAAA.EAAA.KACACAFA.RAEFBAGB..TBBAdCCAHCFB.aAHDhAAAZAGBGEAAeBDGABIB.hAEAPDDBFEDDSDHBhCAAUEGAMFABLHFAOFED.gFFGhCBAIHHA.....hABA...,1,8,-29,37
THfRQgUSDOBeNAXYJbZaEIVFLCKcPMWGd,XAAAJAAAZADB...EADAFAFDLAGBKAHB.MAIBdCCCHCFChADARBDAQDAAUEEA.ODDBhAAAeEHF.AEFAaEFECHAA.hAHAPFHD.TGBASGHHDGGB..hBAA......hCAA...,1,7,-29,36
XWdHMGfDZVCUILTOQANSKJBPaYbEFecgR,KAAABAAA.aACAEACE.eAEERAEF..dAGAHBDCGBCAZCGBCAHBLCBDhAAAQDDCAAIB.SCCDhAAAPCHD.bFFAFEEAhBCA.XFGDMIDAfGDBDGDA..hCAA......hCBA...,1,-12,-14,2
cEQJIKRFGSWdbMLfTZXDeaHgNVOAYBPCU,BAAACAAAUACAEACA...QAEAKAEARAGF.GBGAdDDALEGBhAAAZCAAeCCEHFDC..hAGAgEEAOCBBACFB.hAIAcGBA.FFHD.SAHBMCIB.hBCA......hCAA...,1,-4,-26,22
dgZaEYfFDPHORbINQSTcGAeLCBJXWUMVK,eAAALAAABADAXADDMAFA..dBFAaAFAEBHB..FBGHHCCBhAAARCAA...bDGDQDEChABATGEA.AAIBCDHAWFCDhABAKFBAZFGB.DFGBIEFA...hACA......hBFA...,1,-8,-19,11
AHZYBKeTEXGgfCUdLQRWNJMcVbSaODIFP,HAAAZAAAKADCEADEGAFACAFBLAHBRCAA..JCEFMCAB...bCCAhAAAaAHF.DDHBFDGHACAA.eECBhACA.TGGA.hABAfEEEdFBAQFGBWHBA.NIDB...hACA......hBFA...,1,7,-24,31
QafFYPEVUOJbLCTABcXgKZIHSRWdNMDGe,XAAAZAAAHAEARCAAdADAMAIBGAFA.eAHBaCEC..FDGDEDBAOEABhABALDEB.AAAABDHDhAFAKEEBSEHHhACADFBAQGFAfGCA......hADA......hAEA...,1,-10,-17,7
ZQeRbEdNSOfXMYHBDTPCIVcAgUKWLJFGa,KAAALAAAGACAZADBRAEA.EAFAdAHA..OAHDMCABHCECDCAACCFA..hAAA.IEEAADCB.hABAUFGAFDGDeEEB.hACAbFCDfFAABGGA......hAEA......hAFA...,1,-17,-23,6
UWZKTEPQFecBVRGICOMHYdfaSXLNbDAJg,UAAAZAAAEADEQADA.FAFEeAFEBBHARBEAGCAA.OCHDhABAHCBCdDFAaCCCLDGDhACAbDGDADAB.gFEDhAIATGCA..cFECCHHA.MIEA.hCAA......hDAA...,2,-11,-5,6
CUWMQFecdGgPaSVATIRHbDBLKXZENfYJO,RAAAHAAABADBLADBZAEB.EAFA...fAHAOAGDCCCAMAIBhAAAeCAAGCEA.hABAaCGCADGBTECAbEGDXFAAhAAAJEGB..QGBC.dEEA.hACASFHHDEIBNICB.hAFA...,2,-24,7,31
JbVaCAfWdQEYPKRZFgcOHSGMLDIXeTBUN,dAAAEAAAKACARADAZABB..FAEAOAGDHAGBGCCALDDADCFB.eDHFhAAABCEA.UEAA..hAEAbEFDaCHDAAIB..QGDAhCAA..gFFA.MFIBhAGA.....hCBA...,2,-22,-14,8
beLEQCVFMIcfYZaGDOKTgPUWHXASdJBRN,dAAARAAAeADEEADA..QAFAFAGA.MAIBfBDA.aCCHhAAAGCAB.KCFDTCFAhABAgECAUEFBHFCBhCAAADHBBEGDNCIACGGDIGGA.YHBAhACADEEB.WFFD..hADA...,2,-24,-2,22
DfKPgBaXdIVNOUGTSFCQRJEYbAHWLZeMc,HAAAZAAAeACEMACADAFAKAFABAHAdAHA....ICCAOBEEGDDAhABAFBEHRCFF.ECCBADIBLFFAhAAA.fHEBhCAAaCGEXFGA.NIEBSGFGhCAACHHA......hCBA...,1,-13,-25,12
RMJTCfPSNgGFYbDeZBLVHcIOAQUdWaKEX,dAAAaAAA.EADARACF...MAGBCAEB...SAHBGAFAFAHFDBFBeBBDhBAAZABBLDDBhBAAHDEBODHBABHBQFFAhCDAKECBXGGAfDHENIDB.YECDhCEA......hDAA...,2,-19,-7,12
ACfSDeaPLdcVbEJWQZgXOTYKMFIRNBUHG,SAAAeAAALAEAdADA...VBCBEAFAQBGAZBFEODFCKEEDhAAAMCCBRFAA.BDDAHFGBhABAAAAADDBBaGFB...bDFChAFA.JFCB...XFGA.FGFHIHDAhAFA...hAIA...,2,-19,1,20
SeXOZbUDfgTRVEWaYNdGCPKJQFLMHBcAI,eAAAZAAADACA..TADAEAEA...aAFAdAHAGBFAKBFBQCCBhABAMAIBHCCBADFBSDGAhBHAbEGDUFCB.RFFA.WFEHhAAACEED..FHDABHCAIHHA...hABA......hCAA...,1,-2,-21,19
SHaUJPTWGEVKdgYDQbFZXcBAfeMILRONC,eAAAMAAARACACADA..HAEBUAFA..JAHB..TCDAECCB.dBHADDGBhAAAQDFDZEDBBAGCADIBhABALGFAOFFBaGHBhCAAPBBB..........hAIA......hBAA...,1,-21,-23,2
TREgCBUeAZHVIXdLbGFNSDOQaJcPWfYKM,HAAAXAAAdADAGAFAFADA.DAIBQAGAaCAC.JBDFPDDBhAAA..fCFAhAAAMDHBEFAABFEAADHAZEFBLFCAhABAbGFA.OEHDYHAARGAECHHD..hACA......hAFA...,2,-11,-1,10
WLQbSKgYUBHZdFAeNCfMGTDaOJEPcIXVR,eAAACAAAGACADAEA..OAFEEAEA....IAHARBCALCGBhAAAQBFDKDBAUEEAHCABhAAAdFDCACIBMCIB.aDFDhACAPFHDXEDD.WEHD.SGGDhAEA....hBCA...,2,-23,-13,10
RWbMUHBJYPGaEdDIAKZSceTFXCLVQfOgN,ZAAAeAAAFADALAEA.QBCDOAFDRCAAMAHBHCEBBBHAhAAA.PDHBECEBdEEDAAFASDDDhABATFGACDHA.hABAfGCA.gGDHNIAB.hACAUGGB....hAIA...,2,-22,-3,19
TGeACNWdYbVgRSLFHUcIOZfXKEPJaQBDM,CAAAdAAA...VADARACALAFBHAGBUDAAOAHBZCCF..KDGDECAA.hACA.aDHDQCDAhAAA.MCIBeEEHAACANEGAhAIAbGAA.FGGA..fFHE..hCAA......hDCA...,2,-30,-4,26
KfBWcEGUZHNRaFJIeSbYgTLCMPVOAdDXQ,dAAAQAAABADAEAFAZACB.HAEARBFA.aAGAFCBD..eCEA.bDEAhAAATDDA.MDABhACAOECBAAIB.KFFA.fGHAhBCAGDGAUFDBNICB.SFAHhADA......hAFA...,2,-24,7,31
OWNYVMeQfPHLDZIUXgREJcTGdaACKFSBb,FAAABAAAOACD..NACA.MAEA..eADAQBEAHAGBZDAFhAAAXBGAECFB.TDGAhAIAaDCDAAIBSDHHhADA.bEDDVEBALFFBDFFBgGFHhBAA.JHBA..hBEA...,2,-17,-6,11
CRUaIOHAGYPQcVZbMNTeKLSgEJfBFdWDX,GAAAQAAAZADAMAEAeACALAGB.EBEABAHAdDAAXCDChAAARCDAaCGDHECAAAIB.PEHDhAAAbDFA..TFFAhADASFEAJGCAWHFACHHD......hCAA......hCGA...,2,-12,-1,11
KJeAYQDBgGSZNITMHCUWbcEVOLaRdfPXF,QAAABAAAGACAZACB..TAEAHAEACAHBUAGA..bCEAECABhAAALECARDFAdEADXEDDhACAKEGDACIBDEIB.SGAAhAAAMFHB.cGCD...aGHH.hAEA......hBCA...,1,-4,-17,13
RDIKZOAPYdEHVCMNfeJbLgaGcFXSUWBTQ,dAAAHAAAMADAeACELAHBGAFAFAHF.SCCABBDARBEFKCBAACCAEDEFhAAACBGB...fDHAhAFAJDGF.aFFBXGGAhACATGGAIHDAOEEB....hCAA......hDAA...,2,-33,-6,27
DBbTWCFIAdEQaMZeJPRXGKSUOVNfYLgHc,EAAAaAAAZACB..eACARAEAGCEBSAFAUECA.OAHD.VCCAhAAAfEFELCFBhADAHFABBDHD.bFEACBBDAAIBhAFAdGAAMEHB.PHCC.....hAGA......hCAA...,2,-11,-4,7
UgOTbRCYdWfcEKVSMBZPeHFJXAQNDaGLI,QAAAaAAAGACALAEAUADA.OAHDRAFAdCHA...fCEAhAFAEDBASDEAhAAAZDFBHGAAXEDCABBBDEHBIHHAhAGAbFGB.CFEC.cGAA.MHDAhAGA......hAIA...,2,-17,-1,16
SMecQNPAfWVIDEKgOHGbXJaYTBdLUZRFC,VAAAEAAAKACA..HADBGAEA..bAFAaAGABCFAdBGAZCCF.REAB.hAAASCGH.hAEAeDAAQEGAhCAAAAFAfEEADFFBXGGCTFGALHAAhAAA.CGFDMIEA..hADA...,2,-12,-8,4
RLXcgCfVdNMJABTPeZbFWHDaYQUGSOKIE,TAAAeAAAZADB.FAFDHACB.aAEAQCGAGAGAKCADRDBBLEEBhAAAXBED.CAHAdGGAMDIBhAAAABDBBEGD..bEBAhACADFIBSFEHEFDFfHABJHFE...hAIA......hBEA...,1,-1,-8,7
EMPYQBdFafbLHTgAKRSCDZVGOJXIUWeNc,RAAADAAAGADAOABE..XAFAUAEA.eBHHEAGA...MCCBhAAAQCCCdDAAFDFBaDDHhABAbCFA.HFGB.AEIBCGAAZEEAhBAAJGCAIGEA.cGGC.BHCAhBIA......hCAA...,1,6,-28,34
UMQEdJRPfCYHXTOBaZWKbLNFGeDVSgcIA,MAAAEAAARACA...CADAHAEBOAFAZAGB.KBBALCCAGDDAeCHHhAGASBGA.gDABhAAAADDBdFGD.fDFAhADATGBAaGEDbDGD.DDIBIHHAQGBAhBGA.YEEFhCAA.BHHA.,2,-6,4,10
RFTUXeIYZaBVKPHdDSCcJEMGOQNfLbgWA,RAAATAAAeADEZAGB.BBDAKACCHAEA.dAHACCCD.ECCAGCEA.hAAAQEGALDEAbEFAhAGAAAAAFEDHXFDChCAA.aGCHDBIBSGGBMIFAfGAAhAGA.gGCGhCAA...,2,-23,6,29
eadHcACGVXKUWBZIgYLMEJFbPOQRfNDTS,GAAAKAAABACBZADA...IAHALAEAECDAFBHD.OCCAhAAARCFADAEA.eCFFHEEAAAFA.XDCChAAAUEGA.gGGAhACAMDDB..bGFC......hAIA......hCAA...,1,-4,-33,29
XKOfLbNZQGgTWJEcAIPFSDVCBdRUMHeaY,FAAADAAABACARACFHAEB..eADHaAGA.KAFALBGBZBFE.GEAAhAEA.TEDAEBBBAAHASDEAhAFAdFGAMCIBXGDAhBAAODGD..fEDE.QGGBhBAA.WFFDhCAA...,1,7,-46,53
LdJMPIWHfYcQgVbeZCDAUFTEXKNSRGBaO,TAAAEAAAKACA..RAEF.aACALAGB.dCCAMAFA..IEAAhAAAHBDCfBGBhAAA.QDBAhBDAbDFAeEDFZFFAADEBXDGASGCDGFEBOHFChAEAPHDC...hAIA...,1,5,-14,19
FfYIEBDKQVdZUJOceHNGCTRbSMgXPAaWL,aAAALAAA.FAEAIADAEAHB.KAFAdCAAZBBAOCCA.HCFAhABAGCEAREBA.bCGBMEHBhACA.XEEDhAIAAAHAfFAADEIB.QGDCJHCA.cGFDhAFA.....hBEA...,2,-18,-6,12
GYWaUSdCDOMVTJBQRXPAFELKcgeZNfbIH,EAAALAAAKACA.eADHZAEB.....bAEDHAGBGAGAaCCBdDGDhAAAOCABMDDB.TEAAhAEAQEEAREEB.AAGBFEHDhABANIAB.IHHA.YCCFSGHBhAIADIAA.BGBA..hBGA...,2,-9,1,10
CTBFLMDeOWZVgYfIEXQAbGRdUaSPNKHcJ,RAAAaAAA..SADBKADAHAFB.CAFA.FAHFMAHBeBBB.ZDAF..VCCBhAAA..fDDAhADAECFBAAIBdEFDUFAAPDGDhAFAJFHBTFDABGCBDCIBOFHD....hBAA......hCAA...,2,-17,-10,7
NeKQZGRVSaWBYTLfIgPAHCEMcXdbJUOFD,HAAAEAAA.MACAdADAUAFADAGAKBDAGCBA.RDDF.aBFABAHALDDAhAAA..fCHAhAAAgDGHABCAXFFAhBFAbFDBFFHD..NCCA.ZGDASGCH.hCAA......hCBA...,1,-6,-17,11
ZfJIKUQVAEaYFTbRGBDSdgLPMcOeXHWCN,EAAAaAAA.FACDRACF..GAEADAEA..dAHALAGBMBEA.eBBDHCDAhAAACDHAZEAAJDGB.KEEDQFCAhCAAAAIB..bFGBhAEASFFD..gGBBhBAA.cGEB..hBGA...,2,-24,-13,11
LYbZFTaXgOIQPJfSBUNedCAVRcMKEGDWH,RAAAMAAAEADE.GACBHAFBLAHBZAGBFBBH.aCCAOCED.QDCAhAFAfDDEBDHAhAGAeDFBABIBKEGDDEHBbFAATGCAhBAAIHBA.SFFDdGHA.CHHA.hAAA......hABA...,2,-6,-6,0
fNHDcIPKQEOXBLYMeVGJRAgaTdZUbSWCF,aAAAZAAASACE.FAFAHACB.DAEA.IAHAQBEDhABAEBEEBCGAMAIBeCCBhCAAGDEAACHBdEEAbEGBfGBAhBAAPEHBKGFB.LEDD.YBBFhBGA....hCAA...,2,-16,-13,3
ZGgJHbRTNLKSeVAYCaFUDcfXBIEMOQdPW,aAAADAAA....XABAEADAMAGB.dAHAZADBGCCAHAFARCEFTEFAhADALCHB.eCCDhAHAABBBFBEDUGEABDHAIGHAhAIAOFEBPFHD......hBAA......hBHA...,2,-15,-12,3
cIDMAdYUaFTefXEOSgWJQKbZVPNBCRLHG,dAAAaAAA.eADA.EAGASACH.JAEAbABDZBEA..PBHDhADACAHBHDDA.GEGAhBAADCEAADEAFDFDTGDA.OBBHhCAAQEAA.KEHDBFFCcGGCMCIBhDAAYEEF..hAEA...,2,-21,-2,19
TaMOKLefJQPCIZGFHWcUABXNDgRYbSVdE,XAAADAAARABA..SAEBEADA..aAFDMAGBLAHBhAAAeAHB.QCDChABACCDA.GDAAHCGBcDCChAIAADABBDFAgEFA.YEHBhADAdEEATGFAfHBFhBFA..,1,4,-32,36
GdVgBHCJNaETfPISXWUMcKOQLZFADYbeR,DAAAeAAARABAGAEAdAEABAGAHAGD..CBCA.aCDHEBHF...TDDAhAAAfDGE.SEAAhAEAXDFDMDIBhABAOEHDZEBFACIBbFFDgFDGPGAA.IGAAhAGA...cGGAhAIA.,1,-2,-32,30
LgZIYeDXGadBRVSfbMKcWFCAQNJHEUOTP,QAAAHAAAEADEOAFALADAZBDEeBHFGAGABCADRCBA.SCCDhAAAbDEDKEAA.FDFBAAEAJEHBhAAAUFGA..gECHhAIADEEB.........hACA......hDEA...,1,-4,-14,10
cHWGKMEeZPbXCBQLgYdDSRAINaJTfFVUO,aAAATAAA..FADAOACAHAFBGBCA.EAHBeAFAZDGBXEEBhAIAQCCA.LCFAhAAA.dEFARFDBABBBhBAAIEHAfGHAcDBCMECBbGAA.BGHAhAGA.....hCAA...,2,-5,-4,1
dAaLgeZHDfBCIMSWGNEcVUYJKTXPRbOQF,aAAAeAAAHACBBADAMAEAGAEA..EAHFUBGAKBEC...TCCAhAAARCEAQEEBAAGAZEEACEHB.hABASBBD.hAIAcEGDVGEA.YHEA....hBAA......hCAA...,1,-16,-19,3
fQdEHMPWBUTSJKRCeLNXaZYVcIbDOFAgG,GAAAdAAAHADAMADABAGBUBFASAHH.RCAALCFBhACAaAHDZCDBVEGB..bDGDFDCBhAAAADEA.QGEChACAEFAAPFEBJHAA..CHHA........hAHA......hBAA...,2,-8,-6,2
TWLDHZdcRUbEVOGeQFBgPMKXfaCINAYSJ,SAAATAAA.LADAHACBdAEBRAGFECCAGAGA.eBEHQCEDhAAABCADMDGBfDHAhABAaDHDCFEAAAIB.YEAAhAEADGHB.ZFEA........hAFA......hAIA...,2,-15,-11,4
RPESKAHBcdDQXICfVYaONUFGeLJWZgTbM,HAAAdAAAQADACADB..fAFAaAFEOAHDFAHBGCABhACAeCAALDDAZDEB.hADAbDGDRDGBEGAAACEBBFAAXGCDhAGAIFDA.YFFFUGGB.gGCGhAAA.MCIBhACA...,2,-16,9,25
FHDBSNTJVAUgYEcaPRMKbOIWZQGeCfLXd,UAAAEAAA..aACDRADAMAHBKAEA...OCBEZAGBeCBB.LDDBhAAAdCFAHEAASCHHhAEATEGAAADA...gFEHhAGAPEEBbGAAIGHA..QGGBhAGAfGCEDAIBhBAABDFD.,1,-1,-27,26
CQRNcHfEVgYPdAKeXDWUZFIOBaMSbLGTJ,eAAADAAAZABEOADCBAFA...aAFAMAHBLCCAGCCA.CCFA.RCFFHECAhAAA.EDHFVEFAhADAgFGAdFAA.AAIBKHCAhABA..WFCD.FFEH...SGHHhAFA...hCAA...,1,-8,-26,18
MeTaYSbgLWJDFdICcBPXZHNEQfRKUOGVA,eAAAaAAA...SADALADADAHBdAGACCCABBBDZCEA.HCDAEEAA.hAAARDFAODCBAAIB.MAIBhAEAbEEB...gFADhAFAFEHDIFCAXFFAfGBE.hBAAKGGD.....hCAA...,1,-14,-21,7
cNYHdObZaQAKVIgfXeGTBEJUMCPSFRDWL,KAAAVAAA....fACBeADEGAGAEAEE.MBEB.SCFDhAAARAGFLCCANCDAHFFAhAGAbDFAZECA.AFHBXGAAhAAATGDABHHAUGGB.FGDBDDIB....hAIA......hBIA...,1,-2,-7,5
SWKdXGZFMBOCDcLeHVfIYAEURTbagJQPN,RAAAaAAAQADC..SACHdAFAZAGBMBIBCAEALAGBhAEAHDDAVEGBfBFAhAIA.ABBBECDFUFDBbDFA.hAAA..JEEFNCCA.XGFD.BHHB.hABADIBA.....hCAA...,1,-5,-11,6
SZcfJYKbGCdBeQPWIgVXNEaMHTLUODRAF,ZAAAJAAA.KADCGADAdAGABBEA..eAFA.QCFA.hABAIDAAXCAAECCBhADAHDDALDHBDAIBACAASDFEhACAfEFEbFAACEHA.PHFAVFFBaGBAhBGAMIBA....hAFA...,2,-24,-8,16
fbQPLFJCSNgEcZaUBReTGOHXMIKDYAVdW,dAAA..bAAALADACAEA.SAGHEAGAaBGE.RCAAeBHHGCAAhAAAHCEBMCFBDEABACABfCCEhABAQECCFEHDhACAgDGAZFABTGDAXECAKGGD.YFHBhACA.PHDAhAEA.cGAC.,1,13,6,7
MLQVOJDXPbZKGRgTUcadWECeYNBIHSfFA,MAAALAAA.QAEAOACEDAFAXAGAZBBARBFA..UDDBhAIAdCAAECCA.eCGFBDGAhBAAHEACFEHDAFGBPDEBhABAGGBBTFGA.aHAACHHA.IHEA.hBGA......hBIA...,2,-25,15,40
DPYZNXVHGcLCUOETIJbQfgFSKdABRWaeM,RAAAeAAAMADADAEA.ZAEE..XAFAHBCBGCEALCCAOAHDhAAAECGB.TEGAJEBAQEEChAAAFGCAdGGDAIEA.aDHD.hABA..NIAB..CBDAbGEA......hABA......hAIA...,2,-10,-5,5
NITbOeVcRZFLDHEGWMgQCfPYXdBASKJUa,KAAAaAAA...TADAeACHRAEAZAFBLAHBHCAAEAHFGCFA.MBBBhAEAQDGACCED.hAFAfDEEXFGDADDBhBAASFAANEEA.bFCD.OFGB.hCAA......hCHA...,1,1,-13,14
LCMEZgFIePSRDQabTANJBHfXOVUWcdGYK,BAAAHAAAOACAUACAdAFAGAFALAHBEAHBZCCA.FDHBeCBBRECADFBBhAAAaDDA..AECAJFGFXDFDhAAA....hBCA...cFBC.CEHBMEEB.gGGAhBEA.SHBGhBFA,1,-14,-20,6
LaAKScdHIfTJXQZUgEbCVDWNFROGMBPeY,SAAAHAAATAEAQADAZAGBUCABEDDACAFA..DAHBFDHDRCCBGCEBhAAAMEFBBEAA.eEGDhAAAaDABAAIBdGAAJEFFXGCAhACA..........hADA......hAEA...,2,-25,1,26
LWFKdMDZbOXgSRVCafNeQAYEJcGPTUHIB,EAAAGAAAUADAHADALAGBKAGCdCDD.ZCFBOBCHSBHH.hAAAREGF.aCHDeDADAAIBJDEB.hAAA.PFEBBBFBMDBBhBDADGIB...bFGB...XGEAhCAA......hCBA...,2,-23,-1,22
JKfWFBIdCLQDEOAZcTUPMeVHGRSYbgXaN,ZAAATAAAMACA.HAECRACF..SAEB..bCCAaAGAKBHBhABAFBGBdDGALDEAhAAAEECAAAHAUGEAeCAB.GECAhACAYEHBXFFA.NCIA.....hCEA......hDCA...,2,-9,-4,5
CQAHDOKcPdgMGFaNbITYBJeSWEVLRUXfZ,HAAAKAAAdACAGADAFAEA.aAFA...bBFDTBGA.BAHBeAHHhAAA.ECABRBDFUDGBZEFEACCBODDHhACA.gFBDhADAMDFBIGGASGGALHFA.hBFA......hDFA...,1,7,-32,39
VHXgLeCIdOPQbWBMaSEUATcfGDZKYNJRF,TAAAGAAAZADA.KAGCJACARCDA.HAFBLCHBeAHBdCCA.QDFBhAAAbEAA.MEEBhAFAEEFAAAABDEIBFFEH.XGGAhACACFFDOFHHBHDD.......hAIA......hCAA...,2,-11,-8,3
GgZPHaNYKAcXJRTbEdeVMQfCDSWBLIFOU,XAAARAAAEADE.dADAeAFE..MAFAQBFDDBFABBHALCCBhAAAOCDEGDBAhAAAZEDBHFFAaDGDKHEA.ACEBcDGChABAbEEB..CGGASGCHIHHA..hABA......hBDA...,2,-22,2,24
gPSJXTKBaMWNEVYIRFeAZcOLQUbCdHfDG,ZAAALAAAQAEACAEAHAFBGBGA.SAHBTCAAaAHFMCABhABAECCE...IDDAhACARDEBADHAOEABdEFADCCBhADAgECBXEADBEHANEIAFFDBeGEA..hABA......hACA...,1,4,-8,12
WeURGLfaDMdCAPJOEFNKBYTHcQSbXIVZg,OAAAEAAAKACA.BADAHAEB..QAFASAGA..bBBCXCCChAAAZCFA.eCGFhAEARDDBGGEBaCHDdEEAAAIBFFAAhAFATGAAIHBA..gGGAhAGA......hAHA...,1,-10,-11,1
BSaYPdAJHUZeVGECRbQgWfcNLFIMKXOTD,HAAAeAAAEADARADFQAFC..fAFALAHBMCABhAAAOAGDTDEASCCAhAAAaCCHdEHAAAIBZDCEGGDBhACAbDFD.WDAHFDHDKGHBBHCD......hADA......hCHA...,1,9,-10,19
HOTPMcSefYERJNUBAFLgQWIVbDCXKGaZd,LAAAQAAAVAEACACAGADA.dAFBHCAA.TCGAMAIBeBFHhAAAECEBREAA.UEGAAAHAFEEHhABAIHCADEIBKGFAaHGEhACAZGFAODDH........hCAA......hCHA...,1,-1,-8,7
cFbXDdNEJaRIPHYfZSVBegQGWOCMUKALT,TAAAFAAADADA..dAGAEACE..RBCAHDBAZAEBBAGA.eAHHGDFAhAIACCCAMCGBABFALDHBhBAA.XFDCaDHDIEAAhAAA..fHEBSECA.QFEDhAEA.OHEChCAA.,2,-22,-16,6
WLfdDPXKZcQeNTHBECUMAaYVgORbSFIGJ,aAAAVAAA..RACFFAEAGADA.LAFAdAHADBBB.KCFAZCDB..eCHHhAAAHCFAEDAAMEHBAAGAODDHhADASFEA.hCAAJHBAfFEA.XGFA.hBAA......hBHA...,2,-25,-4,21
JMBESICcTHZdFKWRPaLYfegXDAGNQbOUV,GAAAQAAAOADAUADAMAHBBAFAEBFFCAHA..HCECdCDAKDFARDBALCHBhAAAeDBH.DEFBAAABVFFAhACA..SGFAhAHA.........hAIA......hBCA...,1,-19,-21,2
OKCHTXfJVFdNcLQZeYRbMABaPUSDGgEWI,aAAASAAAGACA.EADAOAEA.HBEBTAFA..fAHAhBAAFBHDdCCALDABhAAAeBBDRDGBACIBBCFDDEBBgEEGhBEAKEDAXEGAVGCAQGEA.hCAAYHAA..hABA...,1,14,-21,35
BFcgLTAMXPeOdNbYIEJfKRHaVQCDGSZWU,MAAAeAAAdAEA....bABAEAGA.KBCBHAFAaBGE.QCCChAFAGDEAZDGBBCFDFEBALGAAhAAAAAHAOCGDIEEAhBAAfGHARGFADCIBSGDH...hCAA......hCBA...,2,-16,-4,12
GRCBHUaQbYOfNVADXLWIedZPcJFTgEMKS,LAAAeAAAZADB.JAEAFAFD..EBDFMAHBGCAARDBBHDEA.aDHDbCFAhABA....fFGEhAAAAAHAXDECdGDATEGAhACASGHHBFCAQGGB.hABAOGCEDAIB...hBDA...,1,-1,-11,10
UDOMHaGcKQNPbLSZYdgFWCBJRIeAVXEfT,EAAATAAADADA..HAECGACAKBCA.QAEA..bCBCZAGBhAAAdAHAFCAHBCFDREAAABIBfDHAhACAMDHB.aEDDhAEAPEEBLFFASFHH...hBGA......hDCA...,2,-25,1,26
LCaecEAfgFITHURMSXBKGZDbNJYPOVdWQ,FAAAHAAARACF.MACABAEBZAEE.DAIB..JAGBOCCB.dCGALCEBhAGAeDEBADFA...fCHAhAIATFCAXGAChAAAGGEB..NEDA.PEHDQEGBaGFD.hAGA......hCAA...,2,-28,-10,18
DQObVdLIXGCcTMBgNPJYaUKESRAHZWfeF,HAAAZAAAeACEQADCOAFA.dAFALCCAGBGATDDAMBGBBBHAhABAPCAB.aAHFEDHBhCAAACCBFFDHbECA..XGFAhCBACFFANEIA..........hCEA......hDAA...,1,8,-16,24
VNTQWXFZeJDEBRAGgLSaKCMUcfOIPdbHY,GAAALAAAaADAMAEAUAGA..OAHDdCDAHDBB..VBDAhABATDGAQCAAhACAFEFHeFDFEDDBAAABKFHBCDFAfDHEhBGA.bFFB...NHBB....hACA......hBCA...,2,-12,-2,10
GdEBOXIUfYaJTZAVMFSRCgeDcWHNbQLPK,MAAARAAAeADEDAEAHAGB.QBDDLAHBGBBAEDEBBDGDXBEAhBAAUFGA..aCCHZDEAhBBAAAAASGAAhAGACFBD..gFDANIAB.bGFA.KHBA.hAIA......hBIA...,2,-11,-5,6
DHbUKXaNJYRWBPQdGOTcZFeIAVSEfLMgC,EAAAMAAADADAHACC.KAFCaAEE..JAHBRAGFBBCAdCCAGCFA.OBBHhBAAZCBAeCFB.ACIBSECBhAAALFCACEDA.hCAAXEGDNDIA.PFEB....hAIA......hBCA...,2,-29,-10,19
DZNEBWIfAeLSFKgOaHbPdYXURMCVcQJGT,eAAALAAAKADA.aADDHAFB.dBHAUAFARCCA.MAIBCEEA..QEGAhAAAGCAAZCCAEFAABDGAhABA.fEEEhACAAAHAFGEA.bFBD.XEGA...cGDAhBFADIFA.IGGAhBHA..,2,-23,3,26
NIVTgOKGQBZWXRJAPEbFLSdMUeafHCDcY,EAAALAAAdADA.eADHHAFADAFA..NBCA.TBFAKCGA..GDDAhAAAZCABRDEBAAIBFFAB.MEIBhAFAaCHDCEDD...IFHAhABAOFGBBHAA..XFBD.hAHAbGECSGEHhAIA...,2,-17,-11,6
FCALdQVOcJabfMIPeYRNKGDEgSTHUXZWB,dAAAQAAAOADA.aACEMAHB..eAEHRBDBGCBAEAGA.SCHHhACAHCFAZDAAFEEBAAIBLEFBhBAAcFGAbGAAfGBEhBCA.IGDAPHEA.KBFBDGAA.hBDA......hDAA...,2,-16,10,26
GDHZAeMBPLJSbcIVCFREfUXONgTYQdaKW,eAAAMAAALAEA..bADAVBBARBGFECCAUCFA..OCEDhAAATEDAdEAA.aDHDGGABhAFAHEFBAAHABFGASEDDhABACGFD.........hAGA......hAIA...,1,-4,-23,19
PMDBUeCfZLIWHVQTgSOXYdAGFNRKbcJEa,GAAARAAAKADC.JADAEAFA..MAHBBAHAUCDA..eCCAZDBBLDFBhAAAHCFATEEAOCHDhACAdEHAAAAAFFHH..NHCB.hCAAaGACCHHA...........hCCA......hCDA...,1,-16,-23,7
FUASYCPaGJDgedbEMBWNOTHRcVKLfIZXQ,CAAAGAAADACA.eADAdAFA.EAGABAHA..OBHDHBCBRCFAKCDALCBDhAAAZCFBQEABhAAA.AADASEEDhACAaEEBbFFA.MEHB.WFCHcFBD.fHEBhAHA...hBAA...,2,-26,-11,15
eJGATONQICERfbVgFcPDdKXaLWSZUYBMH,TAAAQAAA.EACARACF....bAEBFAED.DAGAdAHAaBFDLBGDhAAAZBGBBCDDHCDBeDHHhAAAACABODHDCEEA.fFFAhACAgGFBKGHD.SHDGhDBAMICA......hDCA...,1,-6,-15,9
ZHSDBfgRdCIQMLaKAVJOcWYbTNeFUPXGE,OAAA..cAAA..bADAeACEFAHBUCCAGAFAHDFAhAEABAHARFAAdFDAQCDChAFAaBBH.ACIBVEGBJFFF.hAFAYDBB.PFEB.EHAADFIB.hAHACCHA......hBAA...,1,-6,-12,6
REPHIKYbVLBMUfagQASeDCWcXOZFdNJTG,eAAACAAA..XACAZADBdAGAJCFFRAFA.HDBAKCAA....bCCDLDHBhAAA.MFBBhABAaCEDAACADAIBOCGDFFFH.hBDAGGABIHHABFAA.fFFAhAAASHEGNDIAEHGE...hBFA...,2,-17,-10,7
AcORPgVeQdGHCMBZINaJUDXSFfKEbLYWT,RAAAVAAAeADE.GAGAHADBMAFAZCCA..aDFDDBFA.FBHDEEBALDAAhAAA..TFCAhAAAACGBODFBQFGAhABAdEHABGFAIGAANEEA......hAGA......hAIA...,1,-9,-14,5
EVRLDBWfFMHKCNASZXQGTcYUePaJdIOgb,ZAAAGAAA..TAEAUADAeAFA.aBGEdAGA.OBHDEDDARDFALFFAhAAABCAAFCCHHDFBhABACGAAAGDA.QEAChACA.PEDDIHFA.....hADA......hAEA...,2,-18,-14,4
ZRKObUaLBgTIFAJDNYPGXMSCceHEQfdWV,DAAA..PAAAGABBMAEACAFBHAGB.ECCBdBDAZCEFRBFAOCCHhAIA.aDFCLEABhAEA.TFGAABFANDIASEEDhBAAeEDFQGECfFFB.KHDABEHBhAIAFHFA.....hBIA...,1,3,-19,22
bSDeUTGCHWaBZNQAMPYcLVFOgJdfIKXER,MAAA..PAAALAEAOADCdBBAKBHBRAGFDCCAeCEB.GDCAhAFAHCDCaCHDZEGBACGBVEFBhAFAFGAA...JGAAXGEBhAGASFHHCHDA.NEEA.......hAGA......hAIA...,1,-11,-14,3
YbQZJCRNeFMLdWDEKaGAHTUIVScPgXBfO,HAAATAAAVAEA..SACB..gCAAhAAAfAEAbCEAZAFBRDCBeDHHhACAMAIBdDDAEEEEGGEBhADAABHBIEAAPHAAOCCH.QDGDhAAA.CFEALHFAhAEADAIB.aGGG.,1,23,-9,32
UGRZSFTdNDOEYLaVgbfICPBHeWQKMAXcJ,XAAAUAAARADAZAGBFADA..dCDDDAGA..EDAAaBCD...VBFAhAAA..bDFA.CEEDHEAChADAeCEBQEGAhABA.AEEBGGEBTFGAOGAC..hAEA......hAGA...,1,-14,-16,2
GZMBSdCURNIOKVaXQHLgEPTJYebcDWFfA,ZAAAMAAAdAEARACA.OAGBKAFC....aAHDHCAALCCAEBHFTDEAhABAeCFH..DBBBfDHAhACAADHAGECACEHAIGFAhADAQGFA..gEBA.hBAAPHAA...hBHA...,1,-4,-21,17
cgUBbeAWDGOEaZfIHPNLMRFQXTdVSCJYK,GAAAEAAAZACBHAEALADARCEA.QBGAdAHACCBC.KCDAUECAeDCBhAAAADIBDEHBaEAC..fEEAhACA.IEHAhAEAMFFBTGAASFGD.cGDDhAFABGGD.OHAA..hAHA...,1,-6,-18,12
FANVYcMWRaHgCITSfDbPXQdOZBeUJKLGE,VAAAMAAARACA..HADBCAFB...TAFADAHB..XCCAhAIAdAHAZDAAeDGBKBBDGCFAhBAAADHANEEA....cFAAhAAAaBHDSEHH.bFCAQGFChADABHFA.....hCAA...,1,3,-28,31
SRYcgOfQCWTZaXGJHLBbMFKDdEPANeUIV,eAAAVAAA.RADA.......gADBQAGCCAFBZAGBGCCAhAAAHDCAbCFAMBIBDEABEEFAhABAAEGAUFFA.SFDHhAAAOFCHTFGAaGCB.JFEF....hAEA......hAIA...,1,-5,-8,3
QORGFMHSPDZbNfIKEAeXgTJVUBaCcYLWd,eAAATAAAUAEA.BAGAaACA...CBCALCHBdAFARBGFGCCAHDDAhAAADDBBZEBF..bEFAIFFAhABAAAHA.XGDDhAIAgFEG.JFBB......hAAA......hBDA...,2,-19,-17,2
YJeRQHVOTBWNdfXaECbDLFcIUKPMSAGZg,ZAAAJAAA.RAEAHCAA.OAHDTAEA.BAGBdCED..aDFEEBHFDACALCCBhADA.FCEHIFAAhABAKDGDMDIBAEEB.GEAAhAEAeEHF.QFFBNHABCFFA...cGCBhAIASGHH.hBAA...,1,-11,-18,7
OQDdBEaIRYUFbVfLJWHNMKXCgcPGSeZTA,QAAAdAAAEADA.RACAFAFAVAFA..LCEAHCACMCFBCDAA..hACA.PCHDeCHHAAIBBECAhADAaDDCUFCAJEGFKGDAXFFChAAA.........hAIA......hBAA...,1,-15,-18,3
LXbYZOHWNDMIUgPFCcTRQKdfGAaEBSeVJ,EAAAeAAALADA..bADAZAGBHBGBDBCBMBIBICCA.UEAAhAAAFCEBTEAARDEBdFCAAAHAaEHDhABASDDD.hAEAXEGCOGEENIBBCFEAQGCC.hAFAfGHA.hBIABHEA.,2,-23,12,35
HdXZaIQMVeYGOcPCKSJRbEBgNLfDTUFAW,HAAAZAAAaACAMACA.eAEAGAEA.OAGFCAHASCCARDDB.hABAECFABCCDLDHBhAAATFGAACCAdEEAQGAAhAGAcFCBKGFAbGDCNAIADICA...WHFA..hCAA......hCFA...,2,-9,-2,7
fCbDdALYeFOXUWNTMEcPaRGBSgHQKJVZI,eAAAXAAAUAEA....TADAEAGAaBCDRAFFGCGABBHAHDEAhAAAQDAAKEBAZFGBCDHBdDDAhAAALGDAOFABMFFBhABA.SGGA.....hABA......hBEA...,2,-18,2,20
VWNODBXPJeKfUMZIHFbGaEYSQdTcAgLRC,RAAACAAA...VAEAOACABAHB..XAFAeCCB.KBCAMCEBHCDChAAAGCGAECBB.QDAChAAAdDHAAAIBLEGDhAGADFFBfGDAZGCAFEEHaHGESGFH.hBCA......hCAA...,2,-12,-7,5
XAUWHPTcaSZFVQCIYLfdbNJMOEeBgRGKD,HAAATAAAaACA.ZAEBQACC.CAEBLAGBbAGDMCCBEDDBhAAAeBFFREGB.GDDA.hAIAXDGAABGBPFEDFFGBhAAA.IHHA.dECC.NIAB....hBIA......hCAA...,2,-11,10,21
XDMAKeGPTZVQEJgNHfIcSaBFCUbWOdLYR,eAAAGAAAZADBEADA..JAFBHAFA.fCDASAHBaCEDCBCA.hAAAUDGA..bBGDdGEAhAAALEEBXGGAAFIBKGGAhABAPHAA.........hCAA......hCBA...,2,-31,4,35
ZCIKBDdSPaeJTWLRYfFVcXGQEHUANbMgO,MAAAZAAAKADCdAEA..aAFDeAGB..JAHBTBBA.LDBAhAHARCAAFCEH.XCFDhAIAEDGBHFBAABIB...bFFACEHADFDAhBAA.SFGD..YHAAhABA.....hBBA...,2,-24,-18,6
QVEScHCXFGTOWbfKUPegIRdMJaNBAZDYL,ZAAALAAAEADEHAFBFAEAGAGAOAHF.....bBDDKCAAeCAAhABARDDAdEHAMDGBaECHADDAQFCAhACASFABXFGDhAIATGFA..fHDB...hBIA......hCAA...,1,-4,-10,6
EdgIZVROfeJNPFXcAMUSKLDCBTWQYGbaH,MAAAKAAALACBBADA.QAEAGAEAHAGDEAGA.dBBAZCEARDCBeCHHhAGAJEAA.FFFBABIBDDIBCGDA.hAIA....TEEAhAAA...bGEAaGHBIHCA..hAEA......hCAA...,1,-14,-22,8
SYPZLNGTWCbdRVHFEafgcOeQUDJBIKXAM,MAAASAAAZABEGAEACADA..RAEFHAGBEAGA..aBHD..fCCAhAAAOCCBeDEDhAGAQDEBDDGBBEHAXDADhABAAGGALHCATEGA.dGAAFGHDgGGAhADA...hBAA...,2,-12,-3,9
gBfaMIACEFcYNUDGVeLOWdZbPQHSJTRKX,EAAAFAAA.....NADA.GACALAEAdAEBbAGDHCEA..TEDAhAIARECAXBGA.fCBAhAAAaBEDABIBCEHAUGFAhBAAeEGBOGCCZFAFSEHB...hCAA......hCBA...,1,3,-18,21
QSJdDegNEfcLYUVAaMRCTBObZHXIGWFPK,RAAATAAAOADA.HAGBGACA.FAEAQBDDdAHAeCABECEALEDAhAAAUDGA.AAIBaDHDMEEBhAAABGBAZFFA..XEBDhACAIGDAKHBADCCBNIEB.fGGA.hBEA......hBHA...,2,-14,6,20
gXfOFHNWUEZRKQbcDdLITPaCAMGYJVBeS,GAAAVAAA.eADA.SAGAXADBFAFDHCDAUDCARCGFbEAAdAHAhAAA.LDGB.hAAATGEAaEFHAADAMEIBhACABEEBOHBCEGCBKHAADGHBCHHA......hAHA......hBAA...,1,6,-13,19
dWRcNGaHIYUegbKXBOVJDfTLCPSQZMFAE,EAAARAAAGADAHACAUAFAeAFA.KAHBBBHA.OCCBDCCBLDDAhAAA.SDGHhAEAZDAFAAAAdDFANDHAaEHD...gFDAhCAAbGAA.XGGCfFEE.hCBA......hCEA...,2,-15,-13,2
ZMGXLJCQTRHOPBSEfbeYDKdWaVFNgUcIA,GAAALAAAQADAHADBBAFAEAFAeAGHKAHBdCGAaBHD.FCDHUCAAhABAAAABZEFAMDDB.CEEAREGBSDADhACA.bFDChADADFAA.NIAB..gGEBIHGA...hBCA......hDCA...,2,-8,-4,4
eRaTHCYXUKZdfEGIFMbOLQWVgDJANBcPS,BAAASAAARACAHAFBCADA.UCAAZAEB..EAGAGCDA.MAIBbCCB.hAAALEHB.QFAAhAAAgBGAAAHBPFFBhACAeDABaDGE.TEEAYFDFdFHA..hADA......hAFA...,1,-4,-8,4
IJECKSOcNGRWMAdaPVZbHUgDTfQYFXLBe,aAAAZAAAHAEA.DACATADAQCCB.FBHDLAFBBCFAeEEAhABAEAHBSBBDhADA.OCCDGGABhAGARCGFAEEAdFHAbFCA.fGGA...hAHA......hAIA...,1,-9,-14,5
eWOTYCLMANZRBKgXGHFEIPDSJfbdaVQUc,RAAAKAAAGADAHACBEAEADAFA....SAGAbAGD.dCGAaCABQDAAhAAAeBFF.TFDAhABALEDAACIBZFFBXEAAhAAAFFHD.IEHA.fGGAhACA....hAEA...,1,-8,-18,10
BfgecPTJXWUVYNCHKLQEdbAZIDGMFSaOR,ZAAAGAAAMACAaADARAEA.BAGA..eAHHTCDAJCCF...XBGAhAAAVEEA..CCFALEHBhABAEDCBADGAFEFAfFCEhACA.gFFGPHAA.WFHHhAGANIDB......hAIA...,1,-16,-24,8
XQKBaOFedWUDGPgHCYVNMLSERbTAZcJfI,ZAAAJAAA...XADBQADCBAFAFAFAeAGH.dCAADAIBGCEAhABAHCDCCCGB..VEGBhACAMCCBECCBREEA..ADIB.fHDBhAIAaFHD.OBHDPHEC...hDAA......hDEA...,1,-8,-24,16
MeSKNIgaDRTYXJHEfZQUPWGVCFdBOLAbc,MAAAeAAAKADA..IAEAaAFA.RAFF.TBFA..XBBAhAHAHCCAECHFZCGBQECBhAAAPCEBGGEBhAIAFEGHOFEDABBA.SGHHDDIB...hBAA......hBIA...,2,-23,-5,18
TWEaKMOPcHQbdXZCFIfYLASReNgGBDVUJ,RAAAeAAAGADADAEAUBDA..TAFA.EBHFaAGDKCCDMAIBODABhAAAHDEC.dCCCZDEBFEHDhAAAfDHAAFCA.hABASFAHBFFDVGBAPFHD.cGEDhABA.....hBGA...,1,1,-19,20
fVcBDYgQSeTJCIaGUNPLKHXFdWMAERbOZ,RAAAZAAA..VAEADACAQAEA.eAHBTCCA.CAHBGCGAhAAAPCCB.HDABdDFAACHBhABAEEEBOEDDBDFCSFHHhABAaFGD.NICB.XGBC.MEIBhAIA.....hADA...,2,-14,-13,1
dQZFgfEWMTHXOGKJBVUNAPSDbcYRLeCaI,DAAA..bAAARABAeAEECAEA..dAGAZBFAFCAAECDB..MAIBHDEBGCEAhAAABAHBUEGAACEBSDDDhABALECBaDGDIHHAhBAAQEAAfHDFTGDAKGGA.hCAA......hCBA...,2,-18,-3,15
bKWUCdaTPGQeYJHBcSAgDENXORLIFZVMf,EAAAOAAARACA.LAEAZAFB.MAIBKAHBCCCDdBBD...aCDDGCGAhAAAeCFBHEGBSCEDhADAAAFADEFB.XFAAhAFAFGCA...bFCDWHCATGFA....hCAA......hCBA...,2,-16,-13,3
KJNZQDdTcBgCEePbOMFWLXVARfGYIaSUH,RAAAGAAA.aADAHADBKAGA.ZAFA.dCGATCDABCCDEDAB.eDEFhAAAbCFB.FEHDLDHBhAAA.ADCB.fFFAhABASEBAUGAAQFECDGDBCHHA.MGAA.hADAWHEA....hACA...,1,-4,-14,10
DBXVUaZbISTEgHcNQKGCFYLAOMdWRPfJe,dAAARAAA.JADAeADE.BAGBUAGAZBEA...SCCBEBDBHCACQDEAhACAGDFAFEDDAAAAhAIAMDHB..fFHAhBIAXFCAaFHDIHEA..gGEHhBAA...hCAA...,1,-13,-30,17
MEIHbaSGFOZAKDcBQNeTVUfXWJRCgYPdL,DAAAQAAAeABAUAFA..XACARBDB.CAFA...gCGAhAIAdAHAECDBHCFAaCCH.hBAAGDAAZEFA.ADABBEFDhAAATFBAfEHA.YFCBhADAMIBASGGBKGGD.hAFA...,2,-18,-8,10
BQaeCDMITUAPKXGcSOZJbYERgLHFNdVfW,XAAAGAAAOADAZACB...JAGBEAEARCDBHDBBdAHA..fBFAhAAAQDGAeCEDhABAMFFBTDGAAAABKGGA.bGDAhBHA............hCAA......hCBA...,2,-17,-16,1
PQHGOLUZMTcFdXfVDSWbJIABRYgKaCENe,RAAAKAAAEADEeACE.HAFBGAFALAHBZCCAMAIBFBCDdDEA..fDHEhAAASECBJECAhABAAEGABEHA.aFAACFAAQFGChAFATGFA.......hAAA......hAFA...,1,-10,-19,9
IYDBdbZcWCQaGRSefKXNFULEJHTVMAPgO,OAAADAAAdADAZAEB..CADAGAEARAGB.eAGBXBBBFBBHEDCAHCFBhAIA..MAIBADDB.hBAA.IFHAbDFD.hAHA.WEEDaEEHKGGDNEIA.......hBAA......hCAA...,1,-20,-26,6
YGJWEPZRdNfKVFLHgOAUCMBbcaIDQXeTS,MAAABAAAaACADAEA...eAEHSAFAGAGAEBCBRBBA..dCFAKDBAhAAALCHBHDFBAAGBbFDDhAIAQDDA.TEBAhAIAYFHBJFGFPHDC....hBAA......hBBA...,2,-19,-5,14
cCVPUTbJeWFSOMgAKYfdDaEHLRNXBZQIG,KAAAdAAAEADAHACBLAGBRAEABAHBZCAFGCAB.CBEA.UCGA..bDEDhACAeDEB.FFAHMAIBhADAAAEA.DEHB.aFHDQGDChAAAIGBA.PHFC.....hBAA......hBCA...,1,-15,-17,2
dHLTRcCFJEWAbSVMZOeBINXGQgKDPafYU,SAAAZAAAeACEBAFB..XACDGAGAQCCBhABADAEA.aCEDfAGAhAAAdEGDHGDA.RCDAFBHDEGGEAAIBbEBBhABA.MEFA.OFFA.gGGAhAIA.....hCAA...,1,-6,-11,5
VJfaTQPCILUDAEgcNeMdZbKRGXHYBWSFO,EAAA..gAAAeACAZAFBRCCBHADABAHAFAGA.OCCBJCHB.aCGAhAAAQDACCDAA.hABALEFBADEAMDGBbEEDhADAXFBDSDHDfHGFTFAA.IHHAhAFA.DEEB.hAAA...,2,-23,7,30
SVQTKJMIXRegNYOFaUBWEDcZHCLAGbdPf,dAAASAAAQADAKADA.MAGBRAFF.eAHB..NAIA.FCBDaCCABDDAhACA.EDFBZDAAHEGBhADAAAAAGDGA.bEEBfFBAhAIA.JHCAXFAA.OFDDhADADFFB.CHAA...hAFA...,1,-2,-17,15
NLCYVMJaQOSPegDTBfcdKARXWGZFbUHIE,RAAAGAAAZADBFAFDHADA.EAGELAHBCCDD.MCCBaCEDQCGAhAAA.SDADhACAeDABTDEAfEFAhADAdEHAAAAAXGDAbFAAIFHA.NIAB.YHBAhADA...hAFA...,2,-15,0,15
RJSYeNdQOVWEaDIfXPAcMLBCKUHgTbGZF,MAAALAAAKADAHAFBTAEAZBBA..RAGF.SAHBeCAAdDDAQDGBhABAODDB.EEAAhACAaDHBDFFBXEFDhAFAAFIBCGAA.bFDDFGGB.NIAB.IHBA.fGHAhBAA...hAEA...,1,-6,-8,2
UHZMfAeDbPQYCcINaWLEgXRTVSJdBGOKF,eAAADAAAQACACADA..IAFAaAEEEAHB.RAGF...TCEAhAFASCCAdCGAOBBBhAIAFCFHHEFCZEEAADDBYEEFhAAANDIA...gGGA..hABA......hAIA...,2,-27,-13,14
XQVTJNRDHUbSBAEcgeOIMLCGdaZWFfPKY,EAAAeAAA.MAEAGACAZAFE.FAEAKBCAQBGA.JCBFRCEAHEBAhAAASDFBACHAODHDhABALEEBaEGB.fFCAhAAAYFFF.TGGA.DEIBBDDDIHAAhAHACHHA....hAIA...,2,-14,-8,6
WeBZVPOLXGaYDKCFTgbcQUSdNfJHEMRAI,eAAAZAAAOACAGADADAGAFAFA...TCFA..bBEAQDBAhAAAdDDAJDGF.HEFChABARFBBABFABFEALFBA.hABAaAHDCGGD.gGGASCCD...NBIA.hCAA......hCBA...,1,9,-28,37
GBMaYQdbXLSNJIHgFEPVACWKfORTcZDUe,KAAARAAAZADBeACEGAFABAFB..aAHFdAHALCCD..SBCHhAAAIDAAHDEBhAAAECEAADGACDHAODHB.DFBBhABAMECAQGGBXEFDJHBEFGHD.PHBAhBHA.....hADA...,2,-27,1,28
fHSGbUcFWCDNgRLYMIBOdaQXKVAZJETPe,EAAAeAAAHACAGADAUAFAFAFADAIBRCFA..MCCBOCCB..aDDHQDEAhAAAKEGA.ADHAZEAFhAEATFEASECHhBHA.bEGBCFBDNIAB........hAAA......hABA...,1,-3,-22,19
KBFRfeUHQGZdAPDVJOIcWaSXTMLCNbEYg,DAAAOAAA..IADAaADD..TAFAMAFALBBBhBAA.CBFA.EBBBKBHBRCEBeAHHhAFAHDCBZEEBADBBPDDBhAHAVEGB.JDHBSFBD.NIEB.bGDA.BHHAhBAA.....hBFA...,2,-21,-4,17
PacTIEVXGSDHFULQdJWfeCbYBOAZKNgMR,ZAAAKAAAMACARAEA..aAHD..TAFAECAAGCDAHBCALAHBhAAA.dDEAfCGEhABAeDGBbEBBBGFAAACAgEAAhAEAIHHASDHHFHCE.QFFChAFA.CHAAOFDHhAHA.,2,-15,2,17
BMHfXEWecOQKbAVDYSZFCdgaJLPNUTIGR,DAAAZAAAdAEA..aABELAGBUAEA.GCAARAGBHCCAECCB.eCHHhABAQDFDAACA.SEBBhAIACDFDJEDB.TGFAhBAAMFFBXGBDOEEH.KGGA...hBEA......hBIA...,2,-21,-8,13
ECFTdGaOWMUcbPLKeXgBJVIAQYNfZRSHD,QAAA..fAAARACAHAFBEAHBTADAaCDD.MAFAhAAAbDAB.LBGB.hAAAeBCBBDFDICFAhACAADHAZEFECGGAFHECGDAAOFAHcEDB.XEGAhADA.gFFGhBIA.,1,5,-19,24
WUcQETRFfNZCXOBVAbLPgYDSJKdGHeMaI,LAAA..gAAASADHdADAHAFAeAFAaCAAICFAhAAAUCFBEDDB.RFAAFEGHhABAZCGBOCCBAAHA.bEDBhABADCIBKFAAMFFBQGGAfGHAXGEDhAFA.....hACA...,2,-11,1,12
aUJWOegNPGQbcVBCXAKEIZDFLfdHMYRST,EAAAZAAALADBHACARAFF.aAFAUCCB.OAHDeAHH....gCAAhABAGDEAbDGDBBFAhACAAAEADGEBdDFA.MDIBhBFASHAATGGANEEA.......hAAA......hAHA...,2,-14,-7,7
bNFHgLTGMcIdfRSYVOXBCEPJAeWKaZDQU,eAAAaAAAZACBQADA.UAGAbAEAHCEALCCBGECAMDGBhAAAdEEDREDF.SCHHhAFAODHBCFBDEGHFAAIBDBBBNIBB.TFGAhAGA..........hBAA......hCAA...,1,-3,-6,3
FQNcXUIOPaDYEZJMgHABeKdLbCRVfWGTS,eAAAdAAALADARADA..VBGBGAGAFCCB.QCBA.hAAAXDDBOCFHaAGAhABAEDFFZEAAMDEBHFGBAEAAKEHBhAEACGFC...TGFANIAB......hCAA......hCBA...,2,-20,2,22
dUSfDOLCEMAbZTWHKXFIeGRPBYVagNcJQ,ZAAAHAAAFADAeACERAFF.BAFB.aAGD..NAIA.QCCA.hABAdDFAfCAAhACALDHBEFCAACCB..bCGDKGGDhAAAGDDA.PHAA...gGEHhAHA...hAIA...,2,-16,-16,0
LIfYbWEVTHNCZDeMPUXRBaAQJFgSdcOKG,QAAAFAAAdADAKAFA.GACBLAHB..fAGB.hAFAbCDAECCBHDAAZCEBeDBBhBAAMCHBXEEChAAAREGBADGBSGGDOEHDIHCAYFAF.WFCBhADA......hAFA...,1,-2,-22,20
YDAfELdPHVROCUaWeSGBNFcQgKXTZJbMI,EAAAdAAAHADARACA.CAGBUCDBeAFEGBEB.FCCHQCGAhACAKDABZDFA.MCCBDEEBADHALDABhADAOFFB.aEECBGHAhAAAgFGA.TGCA....hAFA......hAIA...,2,-19,-12,7
PdCRSTWKaIXJebgAQFDUYBHZLEGVcfMON,QAAADAAABACAHADBEACAGAEA..fAFBMAHBOCDBhAAAdAHARCFBTEFAKBBDaDDChBAAXEBD.eEEDhAGAADHAFEHDYEHBZFBAcFFCCHED....hBFA......hCAA...,1,10,-22,32
LJFSaQDGEBgePRUXZOTIdVbfAWcYNMHCK,......cAAAMAAAHACC.LAFBSACBaAHBGCCAhBAAEAEAeAGFREFAZGEAhBBATCDA.dCHA.bEAAhAEAABIBYFCFKEFAQGGADGIB.BFED.hCAAPHDC...hCBA...,1,1,-12,13
WfRNMSOUZgGFXECKbPTAJQHaecYLDdIBV,HAAAeAAALAEAdADABAFA..VBGBRBCBMAIBUCABGCEA.ECGBhAAAKDDA..TFAAhABAAAHAaEFDDEIBfECEhAFA.OEHDZFAAXFDBCGFAPHCCJHFA..hAAA......hACA...,2,-19,13,32
UPHVWgMZSKeABCdNERDOXIbFTGfYLacQJ,dAAARAAAOADA..bABDGAGALADAaBDD.QBGA.hAAAUDEAHCEB.gEGAhABAZEAAeEGHAAHACCCCEGBAhAIAXGEDTGDA.fGHA..hBGA......hBIA...,1,-10,-11,1
bIDSNETaUXPGAWfFcgMKRVBLCHZOeJYQd,FAAAMAAARACFLAEBHACCeAFE..QAGAbBFD.DCGBEBBBaDGDhAGAXDCA.ACFBfCHEhAIAKECACEEBOEHDhBAAdFFASGGDNICB......hBIA......hCAA...,2,-25,2,27
SELIMJGAgTCVHFDcQNWXebKRUYOafdPZB,TAAAHAAADACA.QAEA..XACBeAHBRCCAOCGDhAAAdAFAZAGBECCBMEEBABEACCEDFFFBhAIA..NBIA.KGBAaEEABGHAhBGALHEA........hAAA......hCAA...,2,-25,-9,16
eaDJKHINOBMSXLWcQdPCTVgEUGAbYZRfF,ZAAARAAAeADEaACA..KAFAHAGB.OBDDMAIBLCCAQDFCdCGAhABATFCAEECA.AAAA..hAFAbFGDFEFH.DEIBIGAAhAGASFHD.XGDCWCCF.CHAA..hAIA......hBIA...,2,-15,-9,6
gYBAaURXCWNHLZGQSKfOTFeJdPMVcEDIb,RAAACAAAHACAGADAKAFCOAFA..eAHFdBFAMBIBECAADCEA...hAAA.bCGDBDDA.ACIBaDFBhAAAXDAALEABhACAZFEASGHHTEGAFGEA......hABA......hADA...,1,-14,-15,1
gaHZWOEKJbXGAUSVCITRLBeNcdMPDQfFY,SAAACAAARACA.eACHdAFAMAHB.DAIBQAEA.hAAAFAGEaCAAHCFCZDAAEDDEhACAbDDCAAAA.VEABLEGBhADABEHAPFFB.fHGFgFDAhCEA.WFHH...hAEA...,1,-8,-22,14
AKcVEdbOPLZSDBQaNUeXgYRFTfJIGCHMW,KAAAEAAAdADAOACAZAEBBAGA..aAFDeAHH..XBCDhAAARCBBFDFD.TCGA.IAHAhBFAHEGBABCAbGCALECAhCAADDIB.QEGB.gGGAhCBA....hCCA...,2,-21,-19,2
BXPERHcMFJWCbVSTeDaGLgZIYdNfKQAOU,BAAAEAAAHACAMACAFAFA..CAFA.SAHHDAHBGBCAZCCA.dDGAKCEChAAAACEAOEAAUDGAREBB.JEEFhAAA....bEEBeEHHhAEA.aGCB..gGGANIDB..hAIA......hBCA...,2,-33,2,35
MNfTCIcQYKGBXgOWDRJAEFVZPHSUabedL,EAAAZAAAHAEAUADA.eAHHdAGALBCDMCAB..TCDACCHA.QDFDhABAGDDAXDGChAAAOCCHRGAAAAIBFFBBSEAHhACAaFGD.bGFA.NIDB.cGBDBFGD.DFIBhBFA......hBGA...,2,-19,19,38
MOfFNWdTQSRUALcEGBZJHbPVDagCYeXKI,EAAAZAAAHAEA.VCAAaACDCAEA...eAFHKBHBMCGBFAHB.dDEATDDAhAAARECBLEHB.hAEABEADbDFDDCBB..hBCAXGAAfCHAWHDASECDhCAA.AEIBJHFA...hABA...,1,-8,-14,6
GXIdOfBCTgYRVecJPNHEQSaUMFAbWLKDZ,LAAAZAAAGAEAdAEABADBCAGA...TAGARCAAeAHH..JCAAHCFBhABA.EEBAaCGEMDIBhACAADEBKEFADEEB..OEHDhABAfFFE.gGAAcGAAPHEAhACASFDD.FHGEhAGA...,1,-12,-20,8
LKTcWOPdaEFAeYRMDIBgQHGVZNfbCUJSX,RAAAMAAABADBHACCZAEB.....bAFBCAGAUCCAXBBCLCGBhAAATDDA..OEFHhABAaAHDACFBeDGFDAIB.gFGHhBAA.........hCAA......hDAA...,2,-44,1,45
QLfXYCWUcPdDRTFGaeBKSEZVNJHIAOgMb,MAAALAAA.XADDCADAUAFA..dBBARAFAGCAABAHA.ECCBZCEAhBAA..VCGBHDCAAAFAODFHhABAbEFA.QGGAhACAfFBAYEDBPGEA.DIAA..hAIA......hCAA...,2,-20,-2,18
MeQRGcAXPZfKLNSTbCFEBHJaDUVYWgdIO,ZAAALAAASACETAEAFAFA..HAGBaAHD.DCAA.UDCAVBEBhABA....gDGAhABAdDHAMCCBREFBAAIBfEAAhACAKDDDCHEABHHA.YEEB.OGAChAEA.QGGAhAGA..,2,-23,2,25
COaYLVHPITKZEgRcAFfUbXQJNeSBWDdMG,FAAAUAAAQADAeADABAGAdAGAGCBB..aBHDLCFBhADAHCCATDAAEBHFREAAADIBbDFD.hAEA.XEGD.hADASEEDMEEBOFBD.PHECIHHAhAIA.....hAIA...,2,-9,-5,4
cbALaVWMPEZYOeSDgJfKNQURdCITBHXGF,aAAAMAAAZACB..eACADAFA...JAFBKAHBQCCARBEA.dAHAhBAATDFAHDFAFFFHABBBLDHBhBAA.VEBAhBEAEHBASHFA.NBBACHDAXGGChBFA......hCAA...,2,-26,-7,19
cMXeZJPRWgdHDLIfOENGTFaSCKVUbQYAB,MAAAeAAAZADBRACA.dAGAHAFBLBFDOAHFEBCFGCDA.aBBHKCHBhAAAUFAAQEGDhABA.AAIBXGDAhCAAPDGDDEIBfGHEFFFHCHHAYFDFBEED...hCBA......hDAA...,1,4,-12,16
RYJMCDUdAfbBgQXTKWIZaSHGeFOPNVELc,BAAAQAAAKACAZAEBHACAGAGAeAEE.OAHD..PCAAhAAAECDARCFBMEEB.DEIBhAAAAAIB.bFEDTEAA.hAHAaDDCFGGCLFFA.JGBE.dHFB..hACA......hAEA...,2,-20,8,28
FEILNAVMQfUJgadcZTYHOBGXCbSeWKDRP,MAAAQAAAUAEA.aACEZAGB.HBBBGAEACDEA.eAGBDBIBREBAECDB.hBAALDABABBB.fDGEhAAAdEGA.TFFAhADABFFCbGBAKHAAIHHA...hBDA......hBEA...,2,-23,7,30
ZOISAUPgNVCLKWFHBQRdJEGDTcaMXYefb,UAAA..gAAACADALAFAFADAHCBCRAFFEBDBGCEA.DCGAhADAaAHD.MCCBeDGHZDDAhAAASECDADHA.hABAPFHDKEHBQFDAdGAATGDAXGGChAHA.....hAGA...,2,-10,-1,9
RgdCaObNZEPTBVMWfFceQDSJULXYKHIAG,RAAAdAAAOADAZABBEADABAGA..MAGBFBDD.eAHBDAIB...SBEHhAIALCFBKCHDHCGBhBAAAAAA.GDCA.aEEDhCDAbFDCTGFA..fDEA.hCEAJEHB.....hDAA...,2,-35,-2,33
RSfCUVHBgOLDTQYaFEbGdZIMJXKWceNAP,RAAACAAAHACAOADALAFB.QCAAaAGDEBDFGCEAZBGBMCIBhAAAKCHB.eCDFAAAA.fEAEhACABEDDTEGAbEECdGGAhAEAXGBA.cGGCSFCD.hAIA......hBGA...,2,-24,16,40
RgKaBMWFTDSHNVOCXUGcQLIbfJAePZYdE,eAAAZAAAEADERADA..KAGCaAFABBHA..MAIBFCCB.DBGBHCFA.ODEBhAAAXCAAGEAAhABALDDB.bCGDAEABdEHAhAEA.TGFASCFDCFCB.QGGAhABA.fECAhACA.,1,-4,-24,20
dgUKFYHfNBRWLDGZMJXceQbaOCEVPISAT,dAAAKAAAHACBBADARAEFLAEAZABB.MAIB..XAGBeCABaCEDhAAAECGB..VDGBSDCAhBAAAAFAUGCAfFFEhACADBIBGEFA.........hCDA......hDAA...,2,-32,-3,29
IHfeFTQPacgZJNbCGdLVKOYURWSEAMBDX,MAAAXAAAHACCFADAQAFC.aAHDZAFB.bBCDdCCALBHBhAAAOBBHRDFAEEFBADFADEEBhAHAeFCB..TFGAhBAAgFGHNIDB.CGEA........hCAA......hDAA...,1,-4,-9,5
FRNaWUEeOTDPfbAJYdSGIBQZKVMXgHcCL,dAAAGAAAQADAZADAMAEAHAFALBHBRCAAaCFE.ECDA..eCHHhACATDEADDEB..bFEDAAABSDCDhACAKGGA.hADAXFGACHAA.FGDA.WHCG...hAHA......hAIA...,2,-9,-2,7
UPVbCcFdENaKDIQTGYXZHMAJeLBRSWgOf,eAAARAAA..SADBOADCUAGA..bAEDFCCAdAGAECFBaBHDDDHBhAAA..QDCChAAAGEEAZFAAHEFAADIBBGHAhABAfFEECHGD.KGBA.IGHA.hAFA......hBIA...,2,-20,-2,18
OgaFKcGWQNPZBbXMYIEfRUVLeJTHDCSAd,dAAAaAAA.KADAGACA.QAEAZABBXAFBMAHB..EAHFRDFBLEABhAEAeCEBHDCBSBBDhAIAACIBFDHH.cFDAhBAAPFGBBDHAIGEAfGHA.hBAA......hCDA...,2,-20,2,22
aCgLcYESAOHZBXTDUKWPGVbMdIJRfFNeQ,HAAAZAAABADBTAEAKAFAGCAAMAHB..dCADRCCA.FCEH.eCGDaAHDLCFBhABAEDCFAAIB.DDHBhACAPEAB.bFFAfFEEhAFACHHD..cGADOEHD.WHAAhAHA.....hAAA...,1,-5,-19,14
YAEXcgBUWbPVQZRCGaLefHdSKDINJFTOM,EAAAXAAABACAUAEA....bACDQAGARAEAGCFAeAHHhAAAHCCAdDGADDIBIEAAhABAFEBBMDIBAEEA..gECAhAEAPFFBCHGA.aFFH.LHAA.hAAAKHGA.....hBEA...,2,-21,10,31
bPYdXLEWaBMFROQAeSKITGZUcNVHJCDfg,eAAAKAAAGACAZADBUAGA..VAEAHCEBDAIB..bDBDdCAAEDHBaCFEhAAABBCA..REAAADIBTFGAhAAA..JEEAfGDAhABA..gFGA.hBFAPHAA.YHEAhACA.,1,-3,-29,26
UDefMWJYgHOVRcCIZLbdFKaTGSQAEBPXN,EAAAXAAADADA..eAEAMADA..JAHBHAFC.RBCFCCEAZBCAdCGDaCFDhAAAGEBA.AAAABEEAhAIAPDBAUEGA.fGFEhBEAgEEG.ODHDIHHALHEAhBDA....hCAA...,2,-24,-1,23
OTJAdWVgcbUaNMGeRQSLKHYfBDFIEPCXZ,dAAAVAAA....bABDaADAGADA.RAFALCHBHAFBBAHAFDAHhADAEBDF.XDEChAAAZDEBTGAAACIB..gEGAhAHAcGED.MFDBSHGAfGHAhCAA.DFFBCDGA....hDAA...,1,3,-22,25
VXZTFOALeSRaBfNcCPUdHIGMEbYJQWgDK,eAAARAAABADB....fADACAFAdAHAHCCAGAEA.EAGAbCFDhAAAQCGA.hABADCCBXECAZDDFTGAAhAAAACEAaDHFPFFAMFABJHBAKGHB.OHEANIDB.hABA......hAGA...,1,-1,-14,13
fONCIecVYXbKSABFTZWHQJEULPDaGgMRd,TAAAHAAAEADE.LAFBaACA.GCABRAEFdAGAOBDHCAHAeCGHVECAhAAA..bDFAACIBZFGBhACAQFFAJHAA.DAIBhAAA.MCCB.fGDA...hAHA......hCAA...,2,-7,2,9
dfABULGPMHKYSNOIeEgXZcCTFbJWVRaDQ,LAAAGAAAHADASADHOAFAEBHFZAEBCAGAFCDH...bCEDVCAAhABA.RCFF.QDGBhAAAAAIBBCHBUFFBMDAB.hACAKFHB.IGCA......hACA......hADA...,2,-25,-1,24
ZLcCWbTQOBURHgIKVdMYSaXAeEGDFPNJf,EAAAGAAAFACD.JADAZADBLAGB..CAFA..TBGAQCDAhAAABAHBHCEBKDCDdEGAMDIBhAAAaFDAAAIBeEGFDCIB.fGDAhCAA..bGCC.....hCBA......hDAA...,2,-21,-17,4
SVMIEaZcDRXKHebfdQJOYATgNLFUWBPCG,TAAALAAA.FAEABACBGAGAMAEAEBDFZAFE.RBDB.HCAB.eCFBhABAdCGAQFEAhAAAODEBAAIBUFFBCCCDSDHHhCAAaGHDDDIB.KGDD.fGGB..hCIA......hDAA...,2,-18,0,18
TFPZaYEVIGWJBKNbcgHQUAOfSdeLCXDMR,SAAAeAAALAEADADA.RBCBFBHDZADEEAHBGCEA.BECDKCCD..hAAA..bCFBHEGBAAAAdDEAhAIAMFAB.aGCAIDHAhCAANIEB.QECA.fFGAhCBA.CHHA...hCEA...,2,-23,-5,18
cVQTYGfMCIEaKFNbLOSBZWHUDXPRAegJd,eAAAdAAAQADAGADAMAFAEAFA..aAHDFBFA.LDBBBCBAHCEChACAXDEDADAB.gDGBhAAAcDDCTEGAhADACGEAKGGA.OHBA.SGGAWDDDDBIB.hABA......hBDA...,2,-13,-3,10
ZAVWQUYBJTcGNIOLeHfDFEKRSCaPbdMgX,QAAABAAAJACA.GACB.OAFAHAFBFAHFRCDA.aBCCdCGA.hAAAMBIBZDDAADHAUDAA.hAFATFEAIEHAeHFAhAAAEFDA...CGGA........hADA......hCAA...,1,-5,-35,30
GAcKedNRBJWCDTUMQbHVfLOYFZXIgSaPE,eAAARAAABADBCADA.DAFAUAFA..MAIBHCCALBFBFCHDZECA...hAAA.XEGCSCCAhAAAEFBBAAIBdEHA.JEEFTGDAhABA..bFCDfGHAOHFC..hBFA......hBHA...,1,-16,-28,12
LDBdCSNRXKUgeWIOVGAPEMFHcJbfTYZQa,EAAAHAAA.JADA..bACA..TBGAZAFBaAHDLCAA.dCEAhAAASCCARDFFKEDDeDHHhACAODABAAGAFGHD.fDGAhAAADIAA.CEEAXFGA.WHBAhADA.IHFA.hAIA...,2,-16,-11,5
XUBKVGLCTcEdMFJHIYONSZbPaRWAQeDfg,eAAADAAA..XABAKADAGAFALAEATCCAEBHF..dBHAMCCBhAFAHECCOCGHZFAAaEHBhAAAADDAQFCAhAGAUGGBCHAA.FFFH.IHHA.NIAB....hABA......hAFA...,1,-6,-9,3
cMCbNFVWSGDXYKPaEJATOeUQfRLgHIZdB,eAAAQAAARADAHAGBdADAMCCBCAFA..FAHBSDDAGCDBDCIBKDGDhAAA.EEABADBAUEEBLFFAhABAZFAABEHDbFCD..hAAAWHFA...XGACaGHB...hAFA......hBCA...,1,12,-23,35
RIdcYMgHJNTGPKEZBfOUWXAVLaDebQFSC,aAAAeAAA.QADACADA.RAFA.dAFAMCCBHBGB.TCCAGCGAhAAAEDABZDCBBAHBOEEBhABAXECAACIBLGFAhAGAbFED..FEHD.SGGG...hAIA......hCAA...,2,-11,-3,8
gcJBDOAfaCedXTIGRUVNELMFbYPWZSKQH,aAAAeAAA.dAEA..TADARAGBUDBA..EAFEMCGBFBBH....hAAAbBFAPDEBZDAAQDGChADAHFGBJGAADDIBAAHAXDDBhBAA.GGEBNIAB....WBAAhABA.....hCAA...,1,-8,-11,3
UTINRBdeZCFMHbWOSaAgVfcKJQGXYDLPE,VAAAKAAAGACA.DAEAEADE.UAFA..TAGARCDBdBHAeDCBhAAAZBEFMCABHEGB.OFFHhAIAACGB..fCHAhAAA.QEDD.LFHBhACA.IGGAhAIACGDA...,1,-11,-23,12
KHBCfQRWcTIADZYLJeONEGXVUaPbFSdgM,ZAAALAAAeACEEAFEGADA.UAGA.aCAAbBFA..dDFAMCCBhABAHEGBCDDA.RFAA...TDFAhAHAAAFBDDDBOFEBhABA..XFDA.FEHDSDHBhACABGGDfHDB.hBGA...,2,-11,-10,1
gWLKXRTPMZGcVYbUNQJEOFfIDeSdBaCAH,HAAALAAARADFMAFAGADA..VBFAbAFA.QCAB.hABAEDDBfCAAhACADDFBeDHFdGEAaCCHAAFAKGGDTCFAhAHA.ZEFA.cGGA.NHCB....hAAA......hACA...,2,-5,0,5
GFWHJTDbcUaEegMPXIORQKALBZSCdYVfN,ZAAAdAAA..VADAGAEAHAGBTAGA.DACAbABDUDGA.ECCBeDABhADA.MDEB.XDFChAGAREBBAEEBLGEAhABACEHAfFGEFGAB.cGDC...aGHDhAIA......hBAA...,2,-11,-7,4
KUDBcFaXIGERZYAPCTNdSLbfOHJWVgQeM,TAAAdAAALADA.OAGDHACBVAEAeCAA.MAIBDAIBFCEBaCACGCGAhAAAZDFE.ADEACEAASDDDhACA.bEABhAEAfEEA.gGDAQFGAhAFABGGDXGDAEHAA.hACA...,2,-8,-4,4
EYLBDSQVMbTGaOHZcNFURWXgAKfdCePIJ,dAAAeAAAJADAEADA.LAGBDAGA..QBGAMAIBGCCAHCAChACAZEFAFCFHRFBB..XGEAhAAAADEBCECA..IEHAhBAASBEA..bFFC.....hABA......hBFA...,2,-30,-9,21
DGJRCfHILFTYNeEOWcXBKSdgUMAaQVPbZ,aAAAQAAA..bACDGACB.RAGFHCDCLAEATDAAhAAAeAHHEDHFOBBB.hADAXCEBSEEAhAFAdDGDMEEBAFIBZGAACGGAFFAA.YFFA.cGAChAFA.KHFA..hAGA...,2,-12,9,21
TDbGLRdBYPOfEIMQCFeKZcaAXgJHVNUWS,XAAAHAAAUADA.SAFADADAGAEBRCAABBHAOBCD.ECEBMCGBhAAAFCGD.ZDEF.ADHA.gEEGhAAAJEHB.VFCBhABATGAAdFHAfHABCHEA...hACA......hAGA...,1,-2,-18,16
JgCLUDIaZPObNcMSdBAFWTYKfGXeQHVRE,TAAAKAAAGACA.eAEAHACB.EAEACAHALCABDAHBZCEBOBHDhAAA..bCEAMCABdEEAAAEAhAAAFDGH.fFHAhACAQFCAREAFgGBHaFHBcGED.BEDC.hACA......hCFA...,1,13,-13,26
eNSEdJDPTcbUIZaMCBgLWFKYGVHQfAROX,RAAAeAAAEADE.dAEA.DAGA..TAGAUBGAZBAEaCCA.BDDALCFAhAAA.KDDDGEBAHEFAAAFAhABAXDFCSFEDhAIAJEHB.cGCC.IGHAMFGB...hAAA......hABA...,1,1,-27,28
bIKBdVJZYEFcWfXPNOCTUQSGgDRMLAHea,HAAAeAAA.aACAKADAdAFAZAFBFAHB....fAHAXCCAOCHDhAAACCCA.UDFAGDGAhAAARFBAACCABGGAVECAEFABhABA.....cGEB....hAFA......hCAA...,1,-16,-23,7
GALDfaIUcMQCHJgKdOTSEYXeFPBNZVWbR,LAAAaAAA.UAEAMADAHAGDKAGAdBBDTCAA..EBEBeCCGhABABCGAZDFE..bDDCAEEBfEBAhACA.hAIAQFGACDHAOFBBXFFAFGDANIAB.RGCADFIBhBAA.....hAIA...,1,-1,-17,16
dFIgJEaABRCQYLbXKMeZcVGSDNTOfHWUP,RAAAQAAALADBKAFAeACAZBFEGAFA.DAIBTDFAHCDBPDAAhAAAdCCCFEEH..JEHBAAHBCDHAhADA.XFBA.hAAAMFFASFAAOHDCfGGBhBFAIHAAEHDA.aGGH...hCAA...,2,-13,1,14
KJCLeVHIXGdMbOUYPaWEgNBRZASDcFQfT,DAAAQAAAKACALAEBHACAGAFA.bCDDOAGB.UCCAhAHAaAHFEDHBBBHAAAEAFFGBhAAATDGAeHBA.IHHAhBHAdFEAMBBB.........hCAA......hDAA...,2,-36,3,39
PVERdBHLGgOfFeMbAZDTIQCNUKaJScYXW,ZAAATAAAQAEA.CAGA.KACC.aAEDSAHH.XCAAhABAPAGBRCCBHDDAhACAGDGAODFAeEBBAEAADEIBhADAIFEAUFFA.cGED...YHAAhAAA...hAEA...,2,-15,-11,4
NMPDAEIGagZUfFKRbTCVHXWSBLJOdecYQ,EAAAaAAAZACBFACD..RAEA.CAEA.HCDA..SAFHLAHBdEAAeAHBhAIAQEFA.hBAAMEIBABBBGCGAUGCAKHFAhAAAbDEBTECA.XGFD.BHHBhCAA.....hAEA...,1,-8,-10,2
HTOIXcZUPbDJdNfeSAMFKVGQRaLCEBgWY,MAAAKAAAGACARACA.LAEAEAFEBAHB....gBGAhAAAHCCCTCGAXCAChACAZEFAbFCBdEEA.eDHFABBBQGEAhBAAaFAACCEAOFHDIHHAcGAADGCBfGFAhAFA..hAGA...,1,-1,-8,7
HafNJbIDQBTFVRYWGgAdSPMceLXUOEZKC,dAAAMAAAeADALAEAOAGDEBBA..ZABBHCDA.aAHDJCEBDDCBQDGBhAEAFDGDRFAB.GECAhAIAAAFASEFDhBAA.XFCACFFAfFHAIGHABGBD.hBBA......hCAA...,2,-13,-11,2
HMfeYZKaWRVQNCJOTDXgLBbFSdEPUAIGc,GAAAHAAAeACEZADAaAFARAFFQCCA.CAHB.TCDADCHBLEFAhAAAbCGD.dFAAEDCBACIBMFDBhAFAKEAD..VFEBhAAAOGEABFCD.SHGAIHHA...hCAA......hCCA...,2,-5,-5,0
bZdCaKIXNVOLBgSPGYERUAJDFHTeQfWcM,FAAAHAAAeACHQADC..fAEAMAFAdBGAaCACKAGAXCEAhAEAOCEDLDDDhAAASCHBGEFAREEBADDBTEGAhAGAbGCCCHHANBIA.BFCA.YHDA.hACAEGHF.DIAA...hCCA...,2,-3,8,11
TYcEASZDGObNRFedLBHQVJWPKIaXgUMCf,ZAAAGAAAOACARADAeAGHdAGAHBEB.QDGAVDCA.JCCFKCHBhAAA.aDAHUGBA.MEEBhABATEGA.EFCBAAIBbFFChBGAFFFHBGAA.IHHACHHA...hCAA......hCBA...,2,-6,-6,0
NdbUICQFgLVPaBSTOfGHReMXDZYJEKAcW,...NAAA.bAAA.CAEA.QAFALAGB.aBBASBEA.hABATCAAGBDAHDDAhAAARDAFeBHHMAIBZFCAEEABACCBdGGAhACAFEGDgFDABDFAfHBBDEIB.KEHBhADA......hAEA...,1,6,-6,12
AKBJXUdVDLIFObGaMWeRENZcPQfYCgTHS,BAAAXAAAdACALAEAFADA.GCDAaAFD.eAHHEAHBZCDAQDFChAAACCHDHDBAAAAAKCBDUEFBhAIADDIB..OFAAhAFAMEIB.RFGB...cGGCfGAA.TGCAhAGA....hBCA...,1,-9,-12,3
PBDLCaNgEZObRYSfKHeQMXJAdIVGcFWTU,dAAAGAAAFADAUAGADADALAGB.aBFBEBDB.ZCFARCDB..SCHHhAAAHCACeEEAMDCBhACAAEEA..VFGB..hACATFFACGBA.OFHD.fGCAhAIA.KGED...hBAA...,2,-22,-6,16
MJGbgYUPRZQEeBKIWTafDLFdNACHVScOX,HAAASAAAXADBGACA..bAFAUAFARCAA.ECHFKCEATEAAhAAAaCGDLEEB.hABAdGAAAAEBCAHAODHDMDFBgEGAhBFA.ZGDAQGCAhAAABEDAIHHADGGB...hACA...,1,1,-1,2
HUSgNeQMLWIcFBbVDAPJXORKYdCEaTZGf,XAAARAAAdADA..EAFAZACBHBFCUAFASCCDeBEDLBHBhAAA..IDFAhAAABDGCbEECAAIBODDDKFBAaFGE.hABATFAA.fDHANIAB.MFFBhABA.FGGA....hAFA...,1,-9,-15,6
QJWBRMUYFeOdgDfSbNGcLCXPETKIHaAZV,ZAAAQAAABADBRAEF.MADAFAGA...eAFAdCAADCCBSBDBhAAA.GCEALCGBhABAXBGAEDDBKFEAHDCBhBCAACIB.VEGB.WHDAOEHD...bGDChACACGDA......hDAA...,2,-31,10,41
FEQWcJPXNbHDKLfagTdMVSBYGZeUARCIO,RAAAOAAAEADE..QAFCJADB..XAFAHCCALAHBhAAAaBBH.dECDMAIBBDGDhABAZCEBAEIBFFED.PHFChCAAbDFDKDHD..fHCBTFAASEDDhAFA.eFHH.hCCA...,1,-9,-12,3
OdWBSNfMLXJVPeQGKRbHYZFCagADIETUc,EAAATAAAUADA..dACABAFA..fAEAMAHBLBCDhAAAXAFDJCFB..eCHHhAIAGDDAREDB.HDGBZGFE.hBIAaAHFADDA.DEAA.OHBC.SGGAhAAA.....hCAA...,2,-21,-2,19
GFRbKAMCZVXeWOYIfacSQNLHgBUDEJTdP,ZAAAeAAAOACA..fADAaAFD.QAFAHBGBBAHBhABAECCBdCCDGCEARDEBAEIBMFBAhBFAXCGA.IFAAhAAASFHDLFHBDGEB.TGFAhABA.FECH.CAHA...hAFA...,2,-19,-1,18
bJaNRDdVEgSOAeCLcXWHZGBfQFPKYTUIM,eAAALAAA.XADDHADAGAGA.QCCCKAFATCAAhABAMCFBaAHD.REFFdFAAECFFODDBhACAAAAACFHA.ZEFBFGDBhAFAPEHDIHHAbFABDIDA.....hAGA......hAIA...,2,-4,3,7
LBdUTNKCHeQADRJWSMZPbFIVfgaEXOcGY,RAAASAAAZADBFAFD...VADAaAHB.EAGE..OBHDGCCALCCDhAAAdCGATFEACDAAHDEAhABAAAAADCIB.MDABbFGB.hADAfGHA..XGDABHFANIAB.hADA......hAIA...,1,-9,-12,3
APEGIaXdCFfbHcLNMgOTeSVBDZQRWUJKY,EAAAaAAA.dADAFADAHAFALAGBMBCB..OCFBeBBBBBDDZCGBREDBUFAAhAAAKDDAAAIB..GEFAhBAACDDC....fFHAhAFAbFCB.cGEDNCIASGBBDIAA.hAHA......hAIA...,1,-7,-17,10
cPUIQfgJeOTdWEDMFKHNYbVBLARGSXCaZ,RAAAGAAACADB.ZADAUAFAQCDA.JAHBeBHH.dCCAEDCBMDFBhAAAHEFA...bFABhAAALFBAAAEA.aEHDhABAIGDAOGEEDHBAKGHBNIDB.....hAIA......hBFA...,2,-29,2,31
JTbRXVKeAfEFZPLIHBDNUSCOWGacYMQgd,EAAAZAAALADBHACADAEAUBGAOAFA.GBFAaCCC...MBIBhABAdCEATEFARCABKEEBACCBFEHHhACABEHB.CGCA....hBFAYHAAQFCC.gGGGhCAA......hCFA...,2,-21,-7,14
LQHdFBbcDAgVeUGMKSYfNJXTCZaERPIWO,eAAAGAAAMAEASADA..fAHAXAFDZCDARBCA.hAAAIAHALBFBHDGBhAAAdDBAbDGDAADAUECAKEDANICBhABACFEBEGGB..WGFG......hBDA......hCAA...,2,-13,-3,10
fUXSKLJDCaPHNQMTWVGeOdgEBZYcAIFRb,RAAAUAAAKADCLAGBCADA.HBDCMAFA..TDDAGBDBeCHHhAAAdBHAEDAAZFFA.ADDAFDFDbGBA.hABA....SEEDhADADCCB.aEHB.QGBA.hAIAOFHDBHHD...hBGA...,1,-7,-17,10
RbGBINDHcWUSMOVTZCAFYXfdKJEePQLga,XAAAdAAAEADA..eAFALADARCAA.GAGABBHADCEAHCDAUDEAhACAMDCB.TEFAhAAAADHAFEGAKGAAPEAB.aEHDhABA.bFCDIGGA..cFEC.hADA......hAGA...,1,18,-33,51
CNbAEZTMHSJGdYWXIRFQPBVKUegcOfaLD,EAAAZAAAHAEAGACAdAHA..XAEARCAAQCEBBAHAKCBDeDGFOCEChAAAaDHDLEAAhABADCIBCEADAEEA.MEEB.SFFDhACAJEFB.IGAAFEHHPHAA..hAEA......hAFA...,2,-21,10,31
fUFCWANIPEYbRQVdgOGZSeaMcXTJKLDHB,..IAAAEAAARACAdAFAGACAZAGB..eCCBaAEA..MAHB.TCAAhACALDAB.HEDBhAAAfBFECCEDABIBPDHDhADAbDFAQEBDOFFD.XEEChAIA.DFHBBHHA..hCAA...,1,3,-10,13
fUecOCbFWGTKDVEaRSMZAYPHBJILdQXgN,HAAABAAALACAdADAQAFA.XCAAfAGA.eAHHhAAACAHAFCFHGCCADCIBEDDBhAAARDABZEFAADHB.JGDEgFAAhACAUGABOHEEbFFAKHFA.....hADA......hAEA...,1,0,-7,7
fAOeaUHVcNdFBDJRIbCKZMWXPLgSQGTYE,eAAAHAAAVAEAdAEADAGARCAA...CBCA.ZCEA.MAIB..XBFDhAAALEAAQDDChABAGEEAEEHFABHAaCHD.UEBAhBEAFGHDBHAAJEGFKHCA.....WFFDhCAASHCA..hAAA...,2,-14,-4,10
FIKeGDPLXZEUHWOBNVRMQcdYaSfgbJCTA,KAAAeAAAGACALAEAEAEA.HBCABAGARCEAMAIBdCAA...aEECfBHAhAAAJEHB.ACFADDFBhACAZFAAOHCE.hAEA.QDGBSGEEbEDD.TGGAhAIA......hDAA...,2,-21,-3,18
KfWYdagCJZEXATGUSFDLRHQPBMINObeVc,GAAAFAAARACFHAEBQADABAGA.MAGBOAHDeAHB.KCDD..hAAAfDEEdDFDaDAHCEEDEEHFhACAADGAUEAALGFAhADAIEGAbFBD.....cFGD.WGAAhAEA.....hAIA...,1,5,-23,28
bRZIKNWSQTHFOUJMPfXVCeaBAdgDGLYcE,dAAAGAAALADAEADARAFAZCDAKAHB...SCHBHCACOCFBMDABhAAAXCGD.eEABhACAACEADDHB.bEEDIEDAhAEAQGAATFGAFGGA.PGCA.CHAD.hAFA......hAHA...,2,-12,-1,11
UbRZGBSIHOAQcKEDWXNgfJLYFPedTaVMC,QAAAEAAADADA...XACA..fAFAhAAALAFAFCDHeAGHaCFAMAIBhBCAbDABRDFBGBCABDHAHFDBhAAAABEBKDGAgEEBPHACdGHA.CFDASFHBhCAA.IHGAhCBA..,1,3,-12,15
YEZJLKSWVTAIRgFNdUecHMabBXfGPDOCQ,RAAAFAAAdADAeACHHAFA.MCCBaAEA..BAHAGCGADBEB.QDDAhAAAZBFALDDASFABhABA.TFCAADHBgEGAhAHAcFEDfGHACFDAEGHF.WHAGhAFA......hAHA...,1,-3,-28,25
COIMeSKJNaPAXTVHQUgYLBGFDcWfbEZRd,TAAAHAAAQADC.UAFALACBGCABDAEA.fAGAhAAAECHFRDEBdFHAOGDChAAAeAHHKBEBaHBCADEBXDFDhBEA...gFEGBAHA.FHGEhCAA.WDHH.CHED.MIEAhACA..,2,-26,9,35
JMCfgDAReVcTXHYNEZGdOQFSWaIPbKBUL,RAAAeAAA..TAEAHADAEAGEdAGAFCCA..aCCB..IDAAhAAAbCFABDDALDFAhABAMEFBfEGAAAIBXEAAhADAZFAAGGDBSFCEKEED.CGHADIAA..hAAA......hABA...,1,-6,-8,2
CBHRLFVTIDGdEWafQUXJKNOSZPbYeMgAc,BAAAHAAARADFLACAFAFA..TCFAGAFAECABaAHF.QCCAhAAAXDDC.KDAASAHHhAAAbDGD.eDHFhACAAADACEFDDDIBdFCDfFFAJFDB....hADA......hCCA...,2,-14,-6,8
DcOPeUdZSXEfNgKLRYQMCATWJBIVbaFGH,TAAABAAA..IACAaACA..HAEBOADDeAGBZAFAECCB.hAAA..fDBEhAAAKCCDRCFAMEEBAAHAVDFBFFCBDAGAhCAAPEDDdFFA.SFHHNEIA...hCBA......hCFA...,1,4,-28,32
BOSNAdcGCaKUMDgZYPbRVEXJFQILWHfTe,GAAAaAAA.MADAZACB....bAEAEAGAFCEALBFAHDFCeDEDhAFASCDBAAIB.dDFAhAAAKBBDDDDBgGAAhAGAREBBXEGDQGFAfFEEBHHBOHDChACA.CDHB.....hBAA...,2,-8,3,11
BYPXZTgVAHIObQESGCKeadcFfMUWJRLDN,HAAAOAAAEADEGADAeAFEdCADFAFA..MAIBUCEA.RCGBLDDDhAAABBBDXCFAZFFATGBAhACAADBAQEFCCHHD.hAIAaDBE...fFBADIDA.PFHDhBAA.gGCAhBDA..,1,0,-8,8
VQFgZCUETcNPfHKWaXBGdSOARLIbMYeDJ,RAAALAAAMADA.eADHDAHB.QAFAZBDBUCGB.ECAA...TCEAhABA..PEFBhAAAHDGBaBHFBCCAdFAAAAIB.hABAbGECVFCBCEED.....fGHAhBGA.....hACA...,2,-28,-1,27
KOPceLZTXMSAFCVYNBdRHbWJQGaIUEfDg,CAAAVAAABACA.HADB..JADAaAFAUAGADAIB...OCDBeBFHZCAAhAAA.MCHBACEAFDGAdEEDhACAREEA.QFBAhBFA.EFHFKFHB.cGGC.....hCBA......hCCA...,1,-12,-37,25
abgITOQZEDJHAUNCPdWSfRcMBLYeVXFKG,CAAAdAAA.SADARACABAFBLAHB..eAFHFCAAGCEAhAAAbABDTCGAZDAA..EBGFHDCChADA.AAHAPEABhAEA.fEGEMEHBXGFDaFFHOHBAhBAADEIB.NEIA.....hBHA...,2,-22,0,22
SfJFYPAWIQZGUgaeEBKHRbNcCXTVDMOLd,QAAAGAAAaADABAGAHACARAFF...bCDDCBHA..TCDADAIBMCHBhAAAdCFA..SDBHhAAAFEAAADDBZFAAeEGDEDHBKFFAhACANDIA.XGAAOHAC.LHFA..hAGA......hAIA...,1,11,-13,24
dQBTbNPAeJVZKDGSWfFXYMagRCIEcUHLO,eAAAZAAAGAEA.SACEFADDMAFARBEFEAGAHBGB.dEEDTCGAhABA..bFGDABIBKCCDhAGAfCCEaDEH.CGBA.hAAAIFGA.cGEA....hCAA......hCBA...,1,-13,-23,10
EcHZLQaATXGegFDMfSRCPUNYdWKJbIVOB,GAAAeAAADAEAMADARAFA.CAGA.UCCA..dCDAKCFDJBFF...VEBBhAAAECHBHEFA.ZEBAhAAAaAHDABDA...TEGAhACAFGHBSHEA..PFEB.hABA......hAIA...,1,-19,-20,1
VbDeIFTWYdAcOEKMJNSZHfBRUaXCGQgPL,EAAAMAAA..SACAHACCRAFFUDCACAFAGAGAQDGALCCAhAAADAIBFFABTDAA.dEEAhADAABBBKFEAZFAAaEHD.XGEAhAFAgGFA.PHAC...hAIA......hBIA...,1,-2,-11,9
AFMNgWeCVcTfLUQEGJKXIBdDHOYbaPZSR,MAAA..gAAAeACACAFA...TADALAHBEAFEGCCAhAAAXBBCdAHAHCDAhBAAbCFCZDABABHBFEFA.VFCAhCAAfEFAQGGAKEHBDDAB.aGCC.SGGBhABA..hADA...,2,-5,0,5
RFOcbTPYXABMdECaHKZVfDLIeUWQGNgSJ,dAAAEAAAHACAZABBDAEAeAEE.UCCBGAGA.SBEBRCFAOEFBTFCAhAAA.XGGAhAHAAAIBMCEBaDBE.fDFAhBAAIEHANIABFEHD...bGBA.BGFAhBDA.CHHA....hAIA...,2,-12,-6,6
LVISNeOAXBMRFEWKUgdZQcGaCfJTHYbDP,MAAAEAAAKACAdAEA.ZAFBGAEA..aAHDCAGA..JBHBHBBB.bDEAhBAALCCB.SDGDhAAAeEBBABBBRFFBFEDHhBDAgEAD.QGGA.fEEEhAEADDIB..hAGA...,1,-5,-31,26
JaGcOdRWKfEDgHUZMQeAbXYFVNCSLBIPT,XAAAFAAACADA.LADABAFA...TBGAGAGA.dCCARCDAKDCDhAAAECFBHDABZDFEeEABhABAAAIB.VFGBSDHHhADA.IEEAaGFHOHAEDFGB....hAEA......hAFA...,1,-2,-29,27
AXMYEcbWLUHDfIBKegPCNFGQVadSTRZJO,MAAAEAAA....bACALAEA.HBBAfAGAKBHBeCEFhAFACBHAGCCAaCFDdDBDRDGFZDABhAAAAFFB.XEFA.hAGAcFECDFIBBGGDgGAANIAB.FHDC.hAIA......hBAA...,2,-13,2,15
ScGfEQZHDeCXKOFdMgTRIPAYLbNaUJVBW,LAAAaAAA.VAEASACH.GAEAEBHFHCAAeAGBKCEDhABAdDDAMDGBREABAAEBbEGBUEABhACA.BDHA.fFEAhAEAZFFFXGDAFFHBIHAANIAB..hAHAWAHB.DBBB..hBAA...,1,0,-7,7
gRTWBGNFIbZCASLOQUeJcEHdaKfVXPDMY,LAAAQAAAeADHEACAHAEAdAFAKAHBXBGADCAA..MCHBhABARCDBTDGAGDEAFDCHZFBAhACAAAGAOFDEUGGAaHAAfFHAhAAA........hAIA......hCAA...,2,-12,-4,8
OHQLUSXgDCRfFAdbZcWTYNMPIeVJEBaGK,ZAAATAAAMACA..eACEEAFAGBDAHAFBLAHBUCFA.XCCAhAAACAHARFFA.ABDBbDED.hABA.YCCF.hAFAIHDABEHAaGFEOCHFSHBA.hCAADGIB.....hCBA...,2,-17,1,18
CZDHdWcIAUGOQMKPbXYBNLfREFgVaeSJT,GAAAMAAAKADA..bADABAFB.LAHBEAHBFCDA...aBBBeCGFhAAA.TFAAZBEEHCCBhBAAdEEAIEHAhACAACCBQEFAXGGAfFDA....hCAA......hDAA...,1,-1,-25,24
JgNTQYZLFIADCBMPbWROXUSHKcaefEVGd,BAAAMAAA.....bACARACAXAFBHAGBaCAA.EAHFGDAA.hBAAdDDAgCCAhBBAQDGBZCFALFFAhAAAAEEACEFAOEGDSGAD......hACA......hADA...,1,-7,-19,12
NJDWTSgbEHYMGLVZfQFcPURABXeKOIdCa,eAAAOAAAdAEA.CAGA.aADD..DAIB..TAFASBCH.hAFAECFAHCDC.GCGAhAHAZDEAQEBAhAAAFBBHPEEBADHAKFFAIHHAWEHH....bGACMAIBhBAA.fGFAhBDA..,2,-30,-5,25
RDZVLEUbgJYOGIKMXaBceWCTQFASNHPfd,HAAAdAAARADAZABBEADEUAFA..JAHBGCAB.MAIBaCEDBDCAhAEAeDEATECA.AEHASFFAhAAAfDGELFFAhAGAbGFAOHBAXGCA.CHAA..hACA......hBHA...,1,5,-30,35
ZgPIUcTXBQOCWJLVKDfFbGHSYdMNRAaEe,EAAAeAAAZACB..IAEAUAFA..TDEAQAGA.CBCALCEBhAAADAIBFDGAHEBAhAAAdDGARGAAABCBaBEB..gFGAhABAXFGAOHBAWDDDKGEB..fGFEhBHA..hCAA...,2,-20,-9,11
FJfcEHTdWeYUNGKMQPCBDaVOXALbISZRg,LAAASAAARADFFAFA..JADAEBHFHAGBdCAA.eBCFUDDBGDDAhAAAKDGD.MDGB.QGAAhABABEHAaFCCXGGAhABAAAIBZFGBfHEF..WGCA.hAGANIAB.DCFB....hCAA...,2,-17,-3,14
DbdHKGBXJPIEMUgLQAcFCYfaONRSWVTZe,CAAAaAAARACA.....SACHTAGAZCAAeAEA.dBHAHCEAGCDAhAEAXDGAJDGFEFAAMECBhAAALGCAAAFAFEEHOFHBhACANEIADBBB.BGFA.......hAFA......hAIA...,1,-12,-15,3
MUNVbYOgJBIRaSWLAEePfGcFTZKDHCQXd,EAAAeAAAGACAFADDZAEBHAEA.QCFAdAHAMBGB.VEAA.OBHDhAAABCCDRDGF.aEEBLEEBhAEAAAAA.fGAEhAGAKFFDCGHA.XGFDNIDB....hAHAYHBE..hBHA...,1,18,-32,50
fcHKDbZCdSVeYNFEXIagLAGPJBOTRQUMW,GAAABAAARACAUAFAMADA......fAGAHCAADAIBZCEAhAAAdCDAeAHHFEEA.ECFBaDHDhACAAAABODBD.TEGAhACAQGGAKFEASGHHNHBB..hBCA......hBDA...,1,-14,-24,10
RAPZdECMKDcNHBQFYafVLgeUSTIJbGWXO,dAAAEAAAKACADADAHAEC.QCBAaAEALAHBeAHHUCCA.SBEHhAAATDFAbDDBGCFAhBHA.OEHDhCAAADIBZFCFMFFBBHCAfHFBgGGAIHAAhACA....hAHA...,1,-7,-11,4
ZDcdBLaYRCWJKfAHPeNbMgQSEOFIUTXVG,HAAAeAAAMAEAQADC.EAFEFAHDTCEAGBCAZCAAdBEBaAHDRCEFCDGAhAAAKDGAADIB...bEECOFGBhABAUGGA.DFIBLGCAhAAA...YHAA...hCAA......hCBA...,1,22,-25,47
ACFOXKDGbeUJBadWEVMHZTPgISNYLcRQf,OAAADAAAeABABADAdAFA...EAFAHBDBZBBA.TCGA..gBFAhAFASAHBLDHBhAIAREFBACCAXFBAhBAAbDDCaEFEMEIB.IHBAcGGC.CFED...hBFA......hBHA...,2,-17,-14,3
ODIVdNBXYgHbcAMWSaPCTJZGREKFfULQe,MAAAaAAA..CADAZAEBEADAFAFD..LAHBeAHBDBBBdCCA.XCFDhADAHCBBACHB..SDDBhAIATFFAGGBBhBAARDFBfFDEOBBHIHHABFHA..YFFFhBAA...hBGA...,1,-13,-19,6
cdBVJeWYRZGNTFLfAQPXaIbHCEDKOUMgS,QAAAaAAAHACBEAEAOACC..MAHBSAEEdCFABDECeAGHhAAAREAAGEGATCDALFFDhAEAAAIBXDFAbGBADAIBhBAAKDCDgFCA.cFFA.hBBAWFHH.NICB...hCAA...,2,-17,8,25
XQMINZAULBfTbDKgcRWedJaEYVSPFCHOG,LAAATAAA.KAEARACFdAEAEAGE...SAGACCAAHCCAGCFAhABAMCABZCEEACEABCHA.DEAAhACAgDGAeEEBaEHD.hAEAPFEBOHCCQGAAIHHA.fGGAhAAA...hAIA...,2,-11,-6,5
JLaBTUKGCecOdNbQVFPAIfEDZRgMXHSYW,EAAARAAAMADAHACA.SAEE.JAHBaAFE.TBDAGCCBeAHHhAAAdEFAQFCAhAAAFCCHACGBDDFBZEFB..YFHBhAHABEHACHGAOEEH......hABA......hCAA...,1,-3,-21,18
NZeXDOgEAWMUBCVIYPfLHTFaSJQdGcbRK,MAAACAAA..VACA..IAEA..fAFBhAAAHAFBaAHFQBBAhBAAGCAARCDAZCGBeCEBOEFHADHABEGAhBBALHAATGEASEHHdGGAKHBADEEB.hACA......hAHA...,1,-2,-18,16
adHGCJOBbIXDFSRfYVLeTENPQKZcMgAUW,aAAAHAAAGACAOACABAEA..bAFADAGARCCA...VBFAeCFEEDFBhAEAQDFD.hBAAZGAAMBBBACCAdFGDCDHAXEDDhBIASEEDLFHBNIEB.KGGD..hCAA......hDAA...,2,-16,9,25
eJBXbHGPfUYRIKTMQaSdWFgDLZCEOcNVA,eAAAXAAAHADAGADAUAGARCCB..TAFAaCFC..dEFAFBHDLEHBhAAAEDAAODDHVFAAhABAAAAABEGA.bFABfHFBhAFAKFEA.MIBASEHH.hBIA......hCAA...,1,-1,-8,7
KTPDOGEcgIUJQWFbaeNXAHZSBfMRVCdLY,HAAAZAAABADBRADFdAFALAFAKAHB.DCAAECAB.....gCFAhAAAICEAQCGAhABAFCCHeDHF.AAGAMDDBhACACEEDTGFAGEEAJHAA.aGCC.SGHBhCGA.....hACA...,1,-12,-20,8
aBCGXdNRbcTMIHJfFDPAVgEeSUKOLQZYW,EAAAeAAAKACALAEA.ZBAEaAEAGCDAdAHARBDA.TCFAHDDCFDGAhAAAAAAA..SAHHhAFAQFGABDHACCCDNHBB.bFCDhAGA.MFFA.fGGADIGA...hBHA......hCAA...,2,-16,4,20
cNbOHXaRCWYMJADfEPeFLBUKZQIGgdVST,EAAAeAAALADAKADAZAFBGCCAdAHA..TCBA..bBGDHCFAhAAARFAB.CDEDMEABAAAADAIBFEFHhAFAQECD.hCAAgFFASFHBOHBAaGHH.WHEAhAEA......hAFA...,1,-9,-12,3
daSJYBKNbgHVPFQfLcWXCAIGDTEMeOZUR,GAAAEAAA.eADAZACBRAEAaAGD..SAHBBCDAKCFD...bCEAhAAAHDGBFECA.LEAAhAAAXEGAAADATGBAhACA.MAIBdFAAYFEBgGEAQGGChAFAfEEECCBCDGCA.hBAA...,2,-12,1,13
UHJTDEPaNBZOfIgCScbeAFVRdQKLYXGWM,RAAAdAAALADBGADAMAFAHAFADCCB.ECFBaBFA.ZABB..fCHAhAAACCFA.SEEBhABAeBHHADDBQEFChBAAXEGAUFAAPFHDOHCC.gGGBhAFA...hBDA...,1,3,-21,24
FRDMdTNGJOUZYLgaKPbBXWCASIeQHVcEf,eAAAHAAAEADERADA.dAFAGAGAOAHBZCCALCAAaDFD.KCEDBEAAhAAACDFA.AAIBQFCAhABA.VFGBFDHDMFFBhAAATGAAUGGA........hACA......hAIA...,1,-2,-16,14
DQcUdKXaIgHNZCWEeLfMAOJPYFGSTVbBR,OAAAJAAA.FADDGADA..TAFABAFARAGFQCEDhAFAdDAAKCCD.aAHDHDEBZDGBEBBBhAHAeCHHMDDBADGB.SFEBhBAADFIB..XFAAIHHACGGA..hCAA......hDAA...,1,-14,-23,9
FJTXBIQMgRLKZVNdCUDPcSaGEeYfOHWbA,TAAABAAAMACA.RAEA.ZACB.dAFADAIBSAHBGBCA.ECABeCBDhAAA.OCGBHBGBACEBhAAAFDHDXDED.hAHAQEBALEEBKGGACEHAcGEAaHCCfFDAhBCA...hACA...,2,-14,-12,2
HdUCVPQIgcREXFbTKDLAWYOSfNeZGJBaM,OAAASAAA.eACHGADABAEAHAFAdAGAUDDACBBDQCGAhAFA.IDBAhAHARDGBEEAAFFCHbDEDDAIB.AAAA.fFHAhAIAZGFAaGBHMIDA......hAEA......hBGA...,1,-5,-14,9
ENDFaOLYWQdUGAJVHCfRZTMIXSeKgBPbc,HAAARAAAZADB.MACA.SAEAeAFABBHA....bAGDECFBFCCAhAAAaCCBLCFD.hAAAQEGCGDAAADABCDHAhABAfGHATEEAKFHB.PGCCDAIBOEEHhCAA..WHDA.hDAA...,1,-7,-12,5
dGWBfFZREaHMLJQCYKbTVANXIOUSPcgDe,XAAAOAAAUAEA..SADA..gBBAhAHAeAFHGBGABAHAZCDFECGAhBAAHDAAMDDBLGEAhAAAQEEAKHAA.bEBDAADANEIAIEHA.DEBBhBBA.dGHA....hBEA...,1,1,-20,21
FgKUWSVCcTXNLeAbaQHfYdDPROZGEMBIJ,aAAAHAAA.dADARACFGAEAEAFABAHA..FAGAKCADUDGA..SCCDhAAACEAA.TCFAhACALEDBACHA.bFFCQDDChAFADBBB.ZEGBMICAgFCGhCFA.WFFDcGBB.hDIA...,2,-19,-16,3
OQZHbcAEaMTWFgYNKSLIPeDdVJRXfCBGU,EAAAaAAA...MADATADAFAGD.....NAGA.LBCA.hADAeBHHdAHARCCBCDBAGDDAhAAAQEFBHFGBABBBgFAAhAFASGDDDGFBXFDD.BCEAhBAA.OHBC.cFGDhBHA.,1,-11,-23,12
VZOWbRcfLCXDQIdAGMFPTHEYeKgSUNBJa,GAAAMAAAFADDHADA.EAGEeAFAKCDDSCEHBBBA.aCGAZBFEhAFA.bDDARDFFLFAAhAAA.DEIBdDHAADABPHDAhACATGAAgFFG....hAGA......hBAA...,1,4,-26,30
PYXWdQVRfZTUJDHOIgcMLFBGCEAabNKeS,aAAAKAAAeACE..SACH.XAEAdAFARBCBZAGBTCDAhAEADBIBHECC.OEHBhAAAgBGHMFGBBGEAhCAAEDHFAAHAbEFD.PFAA...YBBFhAFA.WFED.hCBA...,1,-5,-26,21
bFcSNBIdWGJPOYTaHMUXLVegZCRAKfQED,QAAAEAAAFACD.SACABAEAdAGAGCDAOAED..aAGAHDFBhAAAMBGBLDHBhAEA.eFCBZCGBACDBDAIBbDABhAAAIHEAPDEBTGGA....hADA......hBHA...,2,-14,-13,1
HYWbMAGJdNXVPRCZfaITOSDQFEegcKUBL,dAAAXAAARADAZABB...aADAOAGD.DAIBEAGA.eBCHKCEALEAAhAEAHCFAbBDDAAAAGEEAhAGAVEGB...CDHA.TFCAhAGAFGHB..........hBIA......hCAA...,2,-24,-7,17
gEfBJeXZIYACFSQLRPOTDbKHWGVMNdcUa,SAAARAAAOADA.DADAHAGBGAEBMBEBdCCAUDGB..ECFBBCCAhAAAeCHBZFCAAAAAQEDAhAHATGGAKGBD.VGFAhAIAaDED............hBDA......hCAA...,2,-17,-13,4
SVQPGXWDHTcdAaUBgLINZYMfKCbeFRJEO,aAAABAAALADAZACAMADAKAHB...eBBBRAGBECCA..SCFAhAEAQDEAGDCAhAFADDIBHEGBdEEAADIBUGCAgGEAhAHA.IHHA....hBAA......hCAA...,1,-16,-24,8
LCUSVcdPIaRTBfMKAQgDJWOFZHGYbXENe,QAAADAAAOABEHAEBGACB..XAGAEAGEeCDA.LCHBhAAASCCBdDAAaDCChADARCGBTEAAMDGBADHBgEDAhAEAFFEBbFAA.CFGDUGAB.....hAFA......hAIA...,1,4,-6,10
JCfeZPMGLTODdFAXIcHYbSNBVRUQgKWEa,XAAAHAAASACEBADA.RAEFUAGAQAFAKCCA.ECDAaDEECAHAeCHFhAAAZDGB.GDAAhABALFFDTDEADEIBAHHAIGDAhADA.bGFA.......hAAA......hBIA...,1,4,-19,23
JBYGXeTgVbZDHafFICWRKUOdMLSANEPcQ,EAAAQAAABACAGADAeACA...TAFAbAFAHCDA.aCFAFBHDhAAACDAA.RDEFOCCBLEFAhAAAAAHA.PDCBJEGBXFAChAFAZGAAfGEA.KGGAdGDA.MFIBhCAA......hCBA...,2,-9,18,27
SKgXCEdIOYFVfBaMcURJeLPNHDTGWZQbA,KAAACAAAdACAOACA..FAEABAFAMAHBRAGFLCCAHBDBGCFAZDBA.hAAAAAIB...SCHHhAIAECBB..IFCAhAAAfDFAaDHD.cFGAeFFDDICA..hBCA......hCAA...,2,-29,-20,9
eQECRPXDIYScdMNALbGBUHZWVTOJFfagK,GAAAHAAAZADB.TAFAFADAaAFD..eAHHEAHBRCDBDCAB..SCFAhAAAdCCCACFBLEEAhAAABDCDVEGBfFHAhACAQGECXDAD.IGDAMIAA.NIDB.hADA......hAHA...,2,-8,-7,1
LVCHMGEZJbdNaXQReKUPfYSIWgcOTADFB,BAAALAAAHACAEAEAZAFBdAHAaAHD..RBFBeCAAKCAAUEAA..fCEEhABASDDBIEAAhACA.gEEGhAEATDGAAFCAFFEDMDDBJHBAbEGDQGGAhAAA..PHBAhBHA...,1,-9,-10,1
aUHKeGQYOgJAdTRLVFMCWXSNEIbBcZfPD,RAAALAAAMADA.XADDEAGA..BBDAZAFADAGAHBEBGCAAhABAQCGCOCFCAAAAdFFAhBIATDDACCCD..SEEDhCAAbEGB.fEHAaFFBeHCE...hACA......hCAA...,2,-16,-8,8
OLRBFgeTJQMbYUANDWacVKfIXEHZGSPCd,DAAAaAAA.KACA..XACDHAEBGBGA.CAGCLCCBRAEAFBHDeBBDhAEAQEAAMCGBUDDAhAFAAAIB....cEDDhAEAfEHAZGEESBBDdGGDBHAA...hAHA......hAIA...,1,-10,-19,9
XUJAfQHGRWObDCPaIVgeMKTSYZBFcNLdE,HAAARAAAOADACADB..aAED..VAGBeAGBKBDASAHB.hAAAZCAAFCCHLDFAhAAAEDFBXEDDACCAGEDADDIB.hABAgFFBMEHB.BFHBNIAB....hACA......hCGA...,1,-6,-21,15
gHcWMXVCEYQeZPFOJBLRGISUKNADfTbda,TAAAaAAAHACB.MAEACACB..EAEA.eAGFZAFEOBBHLCCARCEAGEBAhBAASAHHKDHBAEEBhBEAbDEAdFFA..gEAAhAAAWFGH.XECD.QFFChAEA....hCAA...,2,-10,-1,9
XKMaDRJcIZBQFHVdENCLYSbTfAWGOPgeU,GAAAOAAA.eADAKADADAFARAGB..JCDAZBBAFDDHHBFA.dDDDEDHFLDHBhAIA.SEFAhBAAbFEDAAAB..gEAAhACAMHBAaGEABHHAQGCBNIBB.TGGAhADA....hAEA...,2,-11,-11,0
ZDgTcMSHYKXFdANfOaLeIPbGJBUCQEVRW,OAAAeAAA..IAEAGADABAFA.QBGARAFFZBAETCDAhAAAMBBBHCGBKCCDdDFAhAFAAAHAaEFHLEHB.hABAbFECCFHA.EHAADBIBSHFG...hDBA......hDCA...,1,-2,-19,17
QIJGFSKZedAXRNbUYaCBgVHTELMODPWcf,RAAAUAAACADB.BADAHAEBLAFAMAHB.DCDA....PCCBhAAA..fCFAhADAQDFDGCGAKEDBeEHHhABAAAGAbDDDaGAA.gGFDEGFF...hBAA......hBCA...,1,-5,-35,30
PcRZNaKdABHOFeEfJYLTGgIVWbSMUQCDX,HAAAeAAAEADAJADALAGBGAFA..IAHAVCCA..SCADhAAAMCCBQDDAhAAAXDGARDGFaFBC.ACIBFGGHhABATFCA.bFEBDFIB..cGGA.hBFANIAB......hCAA...,1,-2,-4,2
RFaBAZDeCgWKQHcfMLdIJXYGSENPbOVUT,eAAACAAAKACA.HADA.MAFAdAEA..JAGBGBGA.ECCB.bCEDOBHDhAAA.UCAARGCAaFGEhAAAACDB.DIEA..QDEChACA.LFGBIHHA..SGAAhAGA.NIAB.hAIA...,1,2,-41,43
MUVeJFdEGISHKaLWXNcPgQfbROBTZADYC,CAAAMAAAUACA..eACAdAFAGBGAHAFAaBBCLDDB..XCDAhAHA.PCGDhAIAQEBBRECABFGDAAHADEIBhAAAYFHBFFFBECBB.KGHDNICB.....hBAA......hCAA...,2,-22,-11,11
QbJKXgfICNZeEBcLYAUaHSTVDFPRMGdOW,HAAATAAAFADA.RAFFdAHAQACC.KAECfCAECAGA.hAAAeCCBEBHFLCEBhAIAACEBaDGD.DCGBGEEAhAAAbEGD............hACA......hCDA...,1,-17,-22,5
IQVUgfREKBPWTANYFZXLdOcCeGbaJSDHM,FAAAZAAAdAEACADA.eAGBGAEA..aAHFDAGAHCAA.MCGBQBGChADAUEDAREBF.ECCBBDHAhABATEDAAACA..XGGAhBEALEHB.OFGB.....hCAA......hCCA...,2,-22,-9,13
WREPUIJMGagbNKeOFDBXTfHYcdVLAZQSC,ZAAAQAAACADB.EACAUAFA.MAIBaAED......bAFDhAAAeCABDAHBBCDDTCDAhABAHEBAdDGAACCBREEFIEHAhAIAGFBBKFHBXGGAfGGE...hBEAYHBA..hACA...,2,-26,-2,24
eEcIBTDZYRCVKMFSNPGJdHaXQLgfOWbUA,EAAABAAAZACBRACAKAFC..MAFAFAHD...SBEAGCAAHCCChAAAaBGDLCBDOCFDUFCAhACAABIBeDEB.TEGAhAAACFFD..PFHBdFDAQGGB.hADA.fHEFhCAA...,1,-3,-23,20
TNMeZWSPUAFgLDYEHIXbBJRVGQcOdCKfa,LAAAEAAAHACA.XADDBAFBRAGFGCCB.QEAAhAAAdAFBfBGEaCHD.MAIBhABAeEFBZCAASFCBhAEAADFADEEAbEFA.cGECKGGA.NIAB.WHEG...hAIA......hCAA...,2,-14,4,18
UFTeVRdXPDEJBbNKAaIfZOgWGLcQCHSMY,aAAAZAAAOACAGACALAEA.QCEAHAFAMCCBFBHDeCGFhABAREFAdFAADCIBBGDAbDDBAAHAhCAA..fGHAhAFA..gFFAWBBD.SECHhCBA....hCEA...,1,-5,-21,16
dDJKFcGRMaXIVbYEOUfHTgPSLZQAWNCBe,CAAAeAAAdACA.KADAGAEARAFF..MAIBaAGA....XBGDhAAAICCA..VEAAECEBfDGAhAAAHEDBTGFAhAEASEED.ZFAAACBBBDDCFEHDcGGChABAOFFAPHAC.hBCA...,2,-10,-6,4
QKcDORYbaAXJGNCWIHMFULPZBVTEefdgS,GAAACAAAHACAFAFALADAZBFE.TBGA.ECDAeCAB.dCCDQDEAhAAADDGAREEA.aDCHhACAAEABXGGANDIA.hAEAMIAABAHB.fFAAKHEA.OEGDhAFA.....hAAA...,1,4,-22,26
fZQRPdMKFNOHXgcVEAbDSTWJBYeULaGCI,SAAATAAA.BADAeACELAFAGAFACAHAZCCARCCA.dCGAMCIBhAAAFDABHECA.XEGAhAAAgEEB.EDBBhAFAAAGAbGDADDHBJHAA.aGHBIHHA..hABA......hADA...,2,-15,1,16
QZaHGRJXeLYMbUcWdEFfDOIgPTSKABNVC,BAAACAAAZACAHAGBRACA..eAFEMADAUCAAdCCAFDFBDBGB...ODHDhAAA..gCDAhAAATGBA.ACHAQDGAhACAGEDAXGFAbECA..EGFA.IHHAhADA....hAIA...,2,-29,-9,20
NSbTBeDXZLIJafPEGCOAgVMQYdUHRKWcF,MAAAdAAAHADARACA.KAGCFAFA..SBGABBBDeAHHZABBLCEBhBAAaCED.EDDFGDCAhAFAACGB.QEGAhBAAUEGANIDB.bGEC.DIFA........hCDA......hDAA...,2,-24,-5,19
JLYDcXGSCHNKeZWabRdOEfFIUBTAgVQMP,QAAAMAAALAEADADAGAEBHBBAeAHHaBDC.RCEBdDBD.EDHFFCGDhAAABFAAAAHA..gDDAhBCAPFGB.JEHBXGAAhAFACFFA.KGDA.......hCAA......hCIA...,2,-27,3,30
TMbfGSFVZRQgaOAcKeNCEHIBXUWdJYPDL,eAAAEAAAHACABADAUAFAdAFA...JCCFDAHBLBHBMAIBGCCAhAAAFEABREDF.QEFAhABA.aFBBAFGAKFHB.CGGDXGEDhAAAPFEBfGHA...hAEA......hAIA...,1,-15,-16,1
WNdRSTOCLZeFBaJgVXbEAcQHDKUYfGIMP,HAAAKAAAUACAGADA.MAFA..PAECdBFARCAATDGA.hAAALFEBeAHHaCDEgGGAhAAA..hACAbCFDABHADHCAfFEE.IGGAhAHA.SEHBhCAA...,1,5,-43,48
ACQPXceZYSKMEHJOVgfBbaTNUWRLDFIdG,QAAAXAAAZACBKACAHAEA..OAEAVCFABAHBaAHDUCDAhAAARECALFGBFCGH.GGABhAAAADIBCFBA..eFDAhBFAMEIBEFHB...fGGE.NHBB.hBHA......hCAA...,2,-21,0,21
PBbgfAYEXCKGUNOZMeDcRIVWSHTdLQaFJ,EAAAKAAAGACAUADAZAFBeAEA..RCBB.VBGBHCGB.dDDALCABhAAAaBHF.FCEDBFBDbEFA.hACAABCACFEA..MGEADFIB.hAAAIHHASGFA......hAIA......hBFA...,2,-21,-6,15
XZNCgJASEMPBbfYURQKHLcDWdGeFIOaVT,EAAAMAAABACA....bABAUAEA.RAGBHCCALAFADDGBGEBAhAAAeCCBOCEC.hAIAaCGATFEAZEEACEHBAAGAfDHAhBEAQGEAKGHB......hBIA......hCAA...,2,-16,-11,5
VNQZDHRbgcfYUWITFKXBEOMAJSedaLGPC,eAAAaAAAGACACADA..QAFAHAEARCEA..bEAB..fCCAhAAAUEEB.TDEAhABAXFGDECHFAAIBdAHALFAAhAFANIDBDBBB.gEGA.cGDBhBHA.IHHAhCAABDHA...,2,-25,4,29
gCEdTHbaVJRXUMILBNfScKAZQWOeYFGDP,ZAAAQAAAeACEGAFADADA..CAFAEAHBHCCC.aAHFRBDB.UEFBMCGBhAAALFAABCHDSDBAhAIAADHAOFHDFHBAdEHATFCAhBCA.bFED.......hABA......hAFA...,1,-6,-11,5
IAfTJEQWZGPSVRdMUYXcFNBaKgHbeOLDC,TAAAEAAAZACBGAEA..SACBRAGBdCBCMDEBXAEAhAAA.FAHBaDFDHCCCeDHFhAAALDGBCGAAAAIB.QEAAhAEA.PFCAUGGB.cGFChAFA.BHHB...hAGA...,1,6,-12,18
EPDLVORJYbSGdXIZHUKNacfgACBQTWMFe,QAAAMAAAFADD.EACALAFA.RBBB.bAEAdCFAZCDAHDGBKCHBaECAhAAA..fEDAhAGAAAFATEGA.eFFBDFCBOFEDhAIASCHBXGCDIHAAUGGB.hAHA......hBAA...,1,6,-15,21
TMXQREFHeWcSODadUGBYNgKAfJCVLIZPb,CAAALAAAZACA.TAEAMADA..RAGBHCCAeAGH..SBHHhABADCGBdECDGEGABCAAgCCAhACAAAIB.fDFEhAEAJFEB.IEHA.bFFC.hAAAEGAA.....hCAA...,2,-27,-5,22
LVbUCdOMScZEJBWGNQfageRXHDPTYAFIK,KAAALAAAUACA.dAEA.MAGBZAEBEAGABAHAGCFA..QCAAhABAaBHD.RCGFHDCBhACATEBAAEEAFFFB.IGHAhAHAbFGDOEEB.SHCG.hBEA......hCAA...,1,-14,-18,4
ISLfdRKMUHEXGeVPBFOTNcbgWAJZCaYQD,ZAAAaAAA.QAEADADALAGBRAGB..MCABHBBCGCCBeBEHBDHAhAIATEFA..bEBBAAIBCDHAhABASEFBdGHAKFEDXEADhACAFFHBOFFH.gGCH.hADA......hAEA...,2,-6,-4,2
bDRXCOIUdLPgTHEfYeAJQMNZKSFGBcVaW,MAAAZAAAFADAGACBBAGA...aAFADAIBRCCB..OAHDdCAALCCAhABA..TCEAhBAAHCFBECHBeDGFAECAQFFBhACASEHHcGCAVGAA.WBBDCHHA.IHFAhCAA...hAGA...,1,-4,-19,15
CcVJBGYIfOAdXeUWFKSRLQbNTgaEDZHPM,eAAAFAAARACFLAEBQADA...bAFATAGA..ECCBHCFBhAGAMCGBCCHA.JCHFGECAhAIAfEDAAECBdFFD.XFEDhAAAKGHB.SGAA.aGGADIEAhBAA......hCAA...,1,-1,-12,11
LCAOFeZBPGHfVXIgUYbNTSaQdcWKEJDMR,eAAAZAAAGAEAHADAXAGBUBGA....bCABTCCA.hABAaBHDdDDAKCFBEEGAMEEBhAAARGAAAADABFFDfFAAhABAIGHAgFFA.SFCBhAFAcGECDAGACHHA.....hCAA...,1,-5,-9,4
QcbeANgEHGZTBFdXaMYUWKDPCSJLRVOfI,EAAAHAAAZACBTAEABAEA.dAGA..aAFDMAIBUDEADACA..SAHBhAAARCCAODFCQFFAhAAAeBHDABCB.NEEA.GECAhCAA.XFGAKFHB.CGEA....hCAA......hCCA...,2,-14,-11,3
HLWEUAcTDMKadeBOQVNJRXSGCZfFgYIbP,TAAAMAAAdAEA.BAGAQACC.VAFARBBBGCFA.ZEBAhAGAFCDD.IDFAhAAAHFGBEBHFAAEAKCHB.eEGFhAIANIAB.SFCACBDC.fFHAhCAA......hCFA...,2,-18,-17,1
SUQRPYDCgANEIcMaOZdGVbLWKeXHBJfTF,EAAAMAAAZACBGACBLAFAeAFEHCEABBBDTEBAFCDH..QCFAhAIAREEADCBBAAGA.IFCAhBAAaCHDdGGA..VGCAhAAAbEFAKFED...fGGA.SHDAhCAA..hCFA...,1,4,-18,22
PBgdXHNOTcMQWFDCJSZGfIKYLbaeUVERA,BAAAdAAAHADAOACAMAFAFAFDDBHB..CAHA.ZABBGBCAKCEALEEAhBAA.eDCFECGAABCBXFGAhBIATEEAQEGChAAASGCA.fGHA.IHAAhAHAaGED....hCAA...,2,-36,-6,30
LJVUINAOPHefQbBgRcGDTWESFZMCKaXdY,HAAAeAAAQADABADBRAEFGAGADAGAEBFEZCAAMDGB..aBHDdEEAhAAALCCBUGAAACCAODHDhACAbEDD..TFFAhAAAFGHH.KHBA.YHFG....hABA......hBHA...,1,-5,-13,8
WFQJTMCYdXRfaeKgLPIUBHNESGDVZbAOc,OAAAFAAAQADA..MAEAdAGARCCBeAHFLDABUBBBHBEBhBAAECHFGEFAZEBAABGBJDHBhBEATGBACFFA...fFDFhADAaGHD.KEHB.IHHANICBDECA.hCAA......hCEA...,2,-14,3,17
QTNUfKSOXHFaDYIZPJBRECVegAcMWdbGL,MAAAdAAAGADALAEAQAFAUBBAKBHBOAHFHCEA..aECADCCBhACAZEGBBDAA.EDFAeFAAhAFAAADB...bGAATEGAhAFASFFFFFDAIHHA...hAGA......hAIA...,1,-9,-15,6
MTcgdUEbaHGWJeINRfQOPALCSFBKDYXZV,LAAAFAAADADAZADEMAEA....TBGAdBEAEAHF.HCAAGCCBhAHAeBGDREFA.QECAhABAAAIBBFCAKFEDXEFChACA.gGEAaGHB.IHHAhCAA.NCIA.....hCCA...,1,-1,-33,32
LYTWAUXbGCgcENBDRdOMSQJaZFKPVHIef,XAAAGAAACADA..EAFADADA.RAEA.dBHAMAIBQCDA.ZCFBhAAAKBDDHEGBeCEALFAAhACATDGAAAAAbFDDNEEA.BDCDhADA..SFFB.aFHD.FHAAhAHA......hCAA...,2,-23,7,30
YAbOGeCXNMdTVQRcDaPUJgEWZLHBSIKfF,GAAAeAAACADA.MADAdAFA.QAGARBGF.aBFHUCCA.EDFBZCDFhAAAHFBASDBHhACAKEHBFFFH.ADDBbDFA.XFGChBAANIAB.TGCA......hBCA......hBDA...,1,-1,-23,22
HBLgZJWbKEIVYUNMDQdRTOcCAGSPfXeFa,GAAASAAA..XADAeACHHAEALAGBZCEAJDDFbCDDEEAAhAAA....IDCAhAAAUFFAMAIBdEGARGBATGAAhABACEADAADAFGFHaEHDBHHAKHCA.NAIA.....hACA......hBAA...,2,-7,4,11
LHBCFdSaVQZfEMNWUPbJXGeIcRAYKDgTO,DAAATAAAHABC.FAEAaACAZAGB...ECCBMAFA.UBDBJCEBGEGAhBAAeBGBRDFBABHA.KEDALFFDhBIAdGHA.QGCAhCAANCCA.........hAAA......hCAA...,1,-10,-22,12
OXgVLdAGMfPDBQFHcbCUYINeRKJWZSaET,GAAAMAAADAEAQADAHAFC.CAFAUCGAIBBARDCA..KFDAZBDAhAIAEFFETDDA.XDGAhBAALFHBAEBABFDDhBEAFHAAYDAFeFFBSFHD.aHDAhCAA......hCIA...,1,-6,-14,8
fDHMeZOgaBSQVdAJCXEWUFIPcGNLTYKRb,XAAAEAAAFACD.....IADAGAEATAGARAEFDAGAHBGBhAAAeCHFZDCAaDDBQEGBhABAAAEBCEEDUFGB.PGCAhBIALGAAKGGDMICABGEA.......hAAA......hAGA...,1,4,-15,19
HIbQDNefUXMgSTZFaEGPBAVJLRKOCdWcY,LAAARAAACADB.dAEA......cAEDHAGBbCAA.QDFChABAeAGHUDCAMDIBhACATDGAaEBBEEDAGEEAhAAAAAGBKFGBOFAB.IGHADIAA..hABA......hAFA...,1,-2,-27,25
SJGYAZaQHCDLOMFBKIXURfTEdgVebNPcW,aAAAHAAALADAMACAKAFAUCCARBDB..EBHFdAHA.eCFB..bCFDhAAA..PDHBSCCDhAHAGEAAADIBZFCAQFEChAEAOHEEBGGBfGCA...hAIA......hCAA...,1,-6,-9,3
LPVYKIEZQSNbDBTCadAeGfWUgROFJHXcM,eAAAGAAAUAEARADAFAGAHAGD..MCDBLBDD.VDFBKCEAECGEhAAAZFDF.QEABhACASFHHDEEACHGDAAAAfEGAhADA.OEHD.....hAIA......hCAA...,2,-17,-12,5
DaSRNFLcMfQZJHXKOVgWdPUEIYCAGbTBe,GAAATAAA.eADADACA.RAGBLCDA.MDABZADEHAGB.hAAAOCCBgDGAhACAdDEAEDGBCECAAAIBaECDFEEBQFGBhAAAKFHB.PFAB.....hADA......hAEA...,2,-11,-7,4
CcaHRbYWSPGDgfEIMeONVKFXLUZBJdAQT,TAAAaAAAHACB.RAEA.....bACBSAHBGAEADAGAECFAeBGHhAAAOBBHKDHBLEBAhBEAZDEAdEADADHAQFFChAEACFFAcGBA..PFHBIHHA...hBGA......hBIA...,2,-10,-1,9
aJDKUYdRWQEPGNVCefAIFSgcTOLXMbHZB,SAAATAAA.LADAMACAHAECaAGD.KBDDdCCARCEB..EBHFGDFAhAAACDHA.AAEAFCHDOCCHhAAAZCDBDFIBUFGA.QGDAhAHANIAB........hAIA......hCAA...,2,-17,-7,10
EHXGPgULSAMDIeBNJTOfYbWQRdFcZVaKC,MAAAeAAABADA..TADAOAED..bAFBRAGBdCCA.ZDFEaAHDhBAAEEDFHBBBGGABgDEBhBBALFGBADHADEEBhBHA.IEHA.fFCA.hAAAQGGA.hABA...,1,2,-19,21
RGTJPANfBVXQLSYWCIOHUbKcaMEgDFZde,BAAAQAAALACASACACAGAHCCAKBHBaAED...ECFEFAGAeDABhAAARBFFGDAA.TDCAhAAAAECBfEEAhADA.XFGAIDHAbGAAMEFBDGFB.dGGA.hAEA......hAGA...,2,-17,0,17
GBRQAeNXTYMZLPacVdCSKEUFgfJbDHIWO,eAAATAAAZADB.LAGBaACA.dCCCKAFAEBFFFBDH...fBHAhAAAbDFA.HCEBhAFAODBHREGBAAHA.XEEChAAAMCCBPGCACFGASGHH....hABA......hAIA...,2,-14,-9,5
UdOfFRPSYMZgXaAVcbNBTCJeLGHKIEDWQ,VAAA..bAAABADBCAEALAGBHAEBEAGAQCAA.dCFChAAAFBHDRDDB.SCDDhAAAZEAAaCHDAAIB.TDFA.hABAeEHFKFGADGBBOFFBfGFEMGAA..hACA......hAEA...,1,-8,-9,1
KDGWZFdJVYLTcAfbEaSOHQCXPNBURMIeg,EAAAaAAAHACB.QAEAXACABAFARAGB.eAGHDBBBZDEAdCCAVDGBhAAATEAA.AAIBSEHHhAEACDAAUFAA.MFDAhBAAKEDAFGGHLGDA......hCAA......hDAA...,2,-18,-1,17
OWTHCJMNEaDYAfeSKQFUgGLPRXZIcVdBb,eAAAQAAAFADDGAFARACAZAFB...VDDBdBHAOCDD.HDABhAAAMAIBEEGAaDGDADABKFCAhADALFAB.XFGAhAAABFFDbGEACCCDDIEASHCG...hABA......hAFA...,2,-16,2,18
ZPFaJWRedNUETCBfDMgHGVQISOcAYXKbL,KAAAZAAAaACARACF..eAEEdAFAUCCB..EBEFBAHAMAIBHCFCGCAAhAAAQEFC.hACAOEHDACGAbDEALFDAhAHAFFBAJHAA.NEIACHGA........hCAA......hDAA...,1,-11,-15,4
dMUEIaYCQNcXZfFALRgGPDbTOKSeWVJBH,RAAAGAAADADA.OADAeAEA...VAGBHBFCdCDAECCA..aCFHQDEAhAAA.XDGAhABAZDBBAAABLEHBhACAbFGDSEDDBFFAMIAA.IGDAhAIANIAB.FHFC....hBCA...,1,-3,-9,6
eEUCBIFHfOLYcRJTXWPdDgbASQNZKaGMV,QAAAZAAAGAEAeAGBEACABAEAHCAALAGBRDFF..TEBAhABAXCDAdEDAbFGDAAIBKDCDhAAA.aCHDMAIB.CHAA.hACAfEEEOEAH.cEGC.PGBAhBGADEIB.SGGDhCAA..,2,-8,7,15
YUZJAbfROQMgHaSdKEFTVNPDGcBLCXeWI,RAAAMAAAHADBdAEAEAFAFAGA....TBGAVBBB.DCCBGBFALDABhAAAeCHHIDFAhABAZEBAADEB.bEEAQGGAhBAA.aFEDKDDD.cGGCCHCA....hADA......hAFA...,2,-7,-5,2
TVQUcEGdFAeLMIaKXYDHJSWBRbZgfPNCO,eAAAMAAAKADADAEAHAFC..SAFBRBCAZCFE...fAHAhAHACDBATEDAQFGAhAAAEBBBdCEAACIBLDDDhBAAaGCBXGEDJDHFbEFD.......hABA......hAIA...,1,-15,-16,1
LAaGcdBeERXKNWTFYDMJCfOSbIQHgUPZV,GAAAdAAAEADA.RADAKAGC..TAFADBIB.MAIBCCDD..OCEDhAAAbABD.HCGBUCFBZEAAACEBaDAChADAeFGB..XEEAhAHAFGCH.JEHB........hBAA......hCDA...,2,-17,-15,2
JcaUNAZSebOgXCTKDfQdIPBLVYFMWERHG,eAAAOAAACADA.DAEAdAFABAGALAHB.FCCAEBBB.HBDAGDEAhAAAaAHD.ABHBZEGB.SFBAhABAbDBC.XGDDhBFATDFAQFBA.IFHAhBAA.PFDC.hCAAMIDA.,1,-11,-24,13
IdWVRMYZBLHQgKfbeJPaGcCESUXTODNAF,dAAARAAAZADBHADAKAFA.eAFE..aAHDGCAB.ECFAXCEDhAAADCIBADHBFEEA..VDAAMFCBhACALDGBQFGAhADAbGCA............hAIA......hBAA...,1,-10,-20,10
PZTDBcdQNMECHbLKaAegUSGIVXJROFYfW,eAAASAAAGADA..XACDRAFAFCCH....fCGAhAAAZAEATCEABDHAdDHAMAFAhAAAHFAAbEFCaDDHABIBgGGAhABAIFFAOGCCYFDBDGHB..hABA......hCAA...,1,8,-21,29
TSAMceFKBPCgOVQZHWdRaJXINEYDbfUGL,eAAABAAACACAOADCZADB.HAGBRAFA...aCCAJCAB..XCEDhAAA.EDHFbCEDGFABhABALCCDAAFAMFFBKCGA.hAAAgGGAQEGC.dGAANIABDDDB..hAIAfGHA.hBIA...,1,4,-25,29
HNEcPMGWZCJFSQAIaedDgUKbXRYTVBOLf,eAAAdAAADADAKADARAEA.....TAGAOAHDHCCAEBDB.MCGBZDDAFCBDhACAAAAAaCHD..UFDAhAHAbECA....XFAChAFABCFAfFGAPFHBCHDA.....hAGA......hAIA...,1,-10,-28,18
JEVTaOQeBFIdRgGACfKNSZbPDcXULHMWY,KAAAZAAADACAUACAHAEA.MAIBJAEE...ECCB..aAHDeCEAFCED.hAAARDFAAAGA..CCGD.SECAhABA.bFFAXDGAhBHA.LFFBYHFAODDHhCAA.BFHD.IHHAhCBA.,2,-44,-6,38
JVNGCdXgBQIUTfcELOKWbYSHaeAPRMZDF,RAAAZAAAFADAJADAGAFA..dAGABAHAQCAAUCCA...TCDAhABAECHFLEFAhAAA.KFDAbDFA.HFCAhACAAGGAMHAADAIBCFFB.IGHAfGHAOHDChCAA......hCFA...,2,-22,-14,8
XWYQANgMcSFZJDeBLaEbUHIRTdKPVOCGf,MAAAFAAAZACBDAEALAFA..EAGAHCEARBBAdBEAKDHB.OEBAhAGAGCFA.XFGDhBAAQEFDABBA.NHABSGGAhAHAeCHBaDDH.........hBIA......hCAA...,2,-23,-12,11
NJIKLgPdYWEOeCaMcAFZVBHGSDURTbQfX,ZAAAHAAAGAEADACARAEA.QAGA..XBGAICAALCCBhAAAdDDAEDGAeEAAhABAaCECAAHABDGATFFAbEECfGAAhACAKFAA.gGDBPFHD..hADA......hAEA...,1,-4,-15,11
SHDCNBXFMWOJYeEcaKIGVfRZLdbTgUQPA,HAAACAAABACAMACA.OAEEeADH..EAFAaAHDGBGARCCA.dCAAbCFDhAAAUEDA..ACCADDIBhAHAFFAA.JFCAKFHB..fGGAhCAAZFFF........hCFA......hDAA...,1,-15,-26,11
KHZQIRMONbSGJdgYEcPAeUFLaCXVfBDTW,eAAALAAACADA.XADDBAFADAHB..TAFAHCCAZCFF.RECA.hAAAMAIBOBHDSCAAhABAdFAA.ECGFAFIBaGGBhABAfDDA.QEFBIHEA.GFABhACA.YEHBhAFA..,2,-27,4,31
fFAMKXBJESGcOUbReTZVDdHLgPaNWICQY,MAAABAAAEACAGACBUAFARAGFZCCA..dBECHDFBLBHBaCHD..hAAAIFAAQCAAhACAFFCAABBBXDCD.hAFASDGDOFHD.eEEHDIAA.gGGAhAIA....hCAA...,1,-5,-20,15
MINAbBJPZEUWdRYQLfSDFaKGVOHcXCTeg,BAAAZAAAEADEdACA.RAEALAHBDAFAKAHB.GCDAHBECCCAA..eCBBhAAAMCCBAAEA...JDDAUFFAhBCA.QGCChCAAFDHBaFFB....cGGA....hABA......hACA...,1,-16,-32,16
HDAeWYQTXbcVFgECaZUJdMBORfLNPSKIG,eAAAQAAA..bADAFACE.EAFAZAGBdBHAMBIBRCDALECAhAAA.SEGAhAFAGCCAHEABACDA.TEFAhAAAXGCAcFECCGGA.aHEC.BHHA...hAIA......hCAA...,1,4,-17,21
OcdAZLFTbaMCPHJNDRGeEgQWXIKfYBSUV,ZAAATAAAaACA...MACAHAEB.DAGARAEAEBDBQBGC.XCCChABAfBHASDGAhBIAOCCBAAHAbEECCDEAPDGBhAAA.GGCBeFHF.IHHAhCAA......hCGA...,1,-5,-16,11
RfdGQaPVHcMJCSYEWFDZUbIAeTgBXNLKO,eAAATAAABADA.LAFARACFGAEAaCCAHAGD.MCABCCFAECHBDCIBhAAA.ZEABUEEAADEBXDFDhACAODDH.dGGAQGAAhAAA.cGFDSHEC..hAEAWFHB....hABA...,2,-29,5,34
KNHUZYcVfADJPdLQaMTIFSWORBgeXECGb,DAAAdAAAaADAMADA..FAGAOAFEBBDA...eBBAEBFFGCABhACAKCDAHCFBZCGB..VFCAhAIAADGBLEEBQGGAhBAATGGASCHB......hBBA......hBCA...,1,-19,-20,1
OECVNeLPTUXWbHFcGaQfYMDAgIRSKZBdJ,RAAAZAAAdADAEADE..CAFA.eAFELAHBUCAA....XBFDhABAHCDCGEEBaCDD.QFAAhAAAMCIBAEFA.SCCDhABABEGAOFCAPGCATGGAFGHBfHEFhAFADHCA...hACA...,1,-2,-19,17
QdGZUCYBPfDIbcgTLaOXVWKNFJeAERMHS,RAAAHAAAdADAZAEBCADBBAFA.DAHB..IAHA..bCAATCGAhAAAaBHD...XDDChABAKCEAFECHAEEA.EEFAMCCBhBGAGGCBPEFDfFAALFHBOFGFhAAAVGCA.....hCAA...,2,-13,-13,0
MPUHOLKZWSfFGIbVTERNeYAcadgJBCQXD,dAAABAAAQADAMACAHAECLAGBZBCA.SCAAGCGAbDBAhAAAEDCA.REEA.eFEFAAIBaCHDhACACAHBDDBAUFBAKGFAFFHD.hBDA............hCAA......hCBA...,1,-7,-14,7
IBfJGKMNaXRDHEOTSCULgcPYdbQFAZeWV,eAAAVAAA.BADAGADAMAFA..aAFARBDAHBGBEBFE...TDEAhAAACCHALDAA.gDFBhAAAPCCBbFGBAAIBZFEAhADA..fGBANEIA.DGGB..hABA......hBGA...,2,-16,-3,13
BPFNgGMRDUJIQTfdZeYKCOVaSAcbXWHEL,XAAAHAAAEADELAFBFADA.GCABRAFFDAIBUDBAQDGAhAAAdDEAZDGBeECA.CAHAaFFBhACAAAAA....bGECBGGAhAHA.PHCCMFIBIHAA..hAHA......hBDA...,2,-27,11,38
WBUacKGJIeLDVdPQEOMCRfXTHASFbZgYN,FAAAZAAA....NACB.BADA.aAEDGAGAeAGBLCCBdBEAECCBMDGBhABARDAF...TGBAhAIAHEDBAAHA.SCGDhADAbECA.gFFBYEHB..WHFGhBGA......hBIA...,1,-17,-20,3
XGIAUSLDOQfFeKJbaBPRZEYHcCTgNdWVM,LAAAQAAAeADHKACA...aAFARAEFEAGEHBEB.CBGD..TCAAhABAdCGAMCDBGDGAACIBDEAAhAAAFEEHBEEA.ZFGBgGEAhACAVGDA........hAIA......hBIA...,1,-7,-17,10
XHIWcReNKMgAVfOUYdEPBaJSDZGFQCTLb,OAAAdAAAEADABAFA..aADDDAHBGAFAFCBD.TDBALCFAhACAHDDB...IAHAhAFARDCFeDADMEFAABBBfCHAhBAAUFFA.PEHDSGCAQGFChBDA.XFBChBFANIAB...,1,-10,-17,7
aTEIACMYfDONVQUJHRBcFKWZbdSLegGPX,MAAADAAAOABE..QADAHAEBRAGBFCCBZAFB.dBBAeDEBGCGAhAIAaDGC.EDCA.ABHAfEEAhBAAUGAABEAAKFHBhAEAbFBBLGFAXGFD.......hAGA......hAIA...,1,2,-16,18
KcfPOEDFdVMIJYRABaLTHbNZUXCgeQWGS,aAAAHAAAZACBCADB..eAEHGAEAKAGA.....fAGBhAIAECABdCCAMCGBICHAREEBACHALDHBhAAAbDFD.XGAAhACAQEBA.SEHBOFDBFHFEYHFAhBAA.TEDAhBBA.gGBG,1,3,-6,9
ESCMDPdcBJfNHWQKbOXIYVZFegaGAURTL,RAAAEAAAMADAdADABAFA..JAGBHAGB.QCBCOBDD.XDEAhAAAIDHAZEGBeCCDhAAAGFABAAIB..TEFAhABACEDDDFFB...fFBANIAB.bFDDhBFA.FFHD....hCAA...,2,-27,-3,24
ERDFcXOMKPSfBZJTQNYUadHLIgeAWbCVG,CAAAEAAARACA.FACD..OAFAMAEA...KBFASAGAZCAA.TBEAhAAAQDFA.hBEAUECBHCGBLEHBhAAAeDDBACIBbFEDDBIBXFFCBGDD....hACA......hADA...,2,-27,-10,17
PXMbNdIWLZQGTYgJfOEDVBHRSaKeCcAFU,FAAAXAAAMADA.dADALAHBGAFA...TBCAJCHB.EBEEBAHAhAAAHDEARDBAaDFH.eFABhABAABGAbFGB..IGGAhAFAZGDA..........hAHA......hBDA...,1,-11,-20,9
CgKGAVJXHEUNDZdQFYPTLebSOIfcRBaWM,XAAAHAAAEADEDAFAdADA.FAHD....TAFAeBFFOCABhAAA..fBHAhAAARCCBaDGAMECBKCEAAEGAUFFAhACAZDBAQEGA.LFAASHGAhCCABFEA.CGGD....hCEA...,2,-12,-8,4
WTHRBcXPIUdEVegLJFMbSZQDAYOCGfNKa,CAAAGAAAKACA.aADAHAEBRAFF.BAGA..XCDCUCAAdCHAEBHF.hAAAeDBHLDCB.hAAAMEEBZDFEAAHA.fFGAhACATFFA.IHHAgGAB..hACA......hAEA...,2,-31,-8,23
deYSQCbRcZUMNIVPGgBOafLXJATWFHDKE,TAAAHAAAEADE.eAFEQACCRBEA.ZAEBMCAB..IAHAhAAAGCCAOCHDhAAAaBGCLDDAACCBDEFBdGEDCDHAbEABhAEANIAB.VFFABHGAfHDB...hACA......hAIA...,1,4,-3,7
YTAJFPRbIfZHBKdeEVLOQacDGSNWgMUXC,FAAARAAA....bADBZACB.HAEAdAGAECCBLAHB.aCECGCEAhAAASEEA..hAGAgDGBMEHBCGCAACGA.hBAAIFBA.KGFA.eGBA...hCAA......hCBA...,2,-29,-12,17
CEAeHSYOdMURKWIQZTVbBJLfGgFaPcDNX,HAAAOAAAdADARADA.KAFA.QCABZAGB..bCCALAHBhAAAGEAAaBBCDCFACDDA.ADFAeEFAhACAMCIBUEEB.TGCAhAEABFAAfFEEFFHHPHEC.XGGAhAFA.....hAGA...,2,-7,-2,5
bcWdOCZQDGYFAgLTIHKUXSNRPfBJEMVea,TAAAHAAAXADB.RAFABCADEACEeAEE.aAHD..bCCAdCCAhAAAZCGBGBEAACCALFFAhAAAKDGASECAhAHA.fFGAMEEBcGAACGCADFIB...hACA......hAGA...,1,-4,-14,10
ONCBYFgPDAIZaMeVWLXQSRUJTEbKfdHGc,aAAAeAAALADAQADARAGF.UAGA.ECCBbBBC..dDFAHCDChAEAGEDAOCHDBDHAFEEHhAFADFBAAFHBZGFEMFHB.XGBChAAA.........hAIA......hBAA...,2,-11,-7,4
eTbHPcgdBGNCKZafVJRWUISLAYOXFDMQE,XAAAMAAA..EADAeADAHAFA..PAGDdBBAGCEA.hAAAKCGAaCDAfDCAhAHARDAAIEEAAEHAFFHBQDGBhABA.bGFABGFACFGD......hAIA......hBAA...,1,-4,-18,14
UPcCLedFNTKEVMIBQOYaWJHbDXSAgGRZf,RAAAZAAAUADACADBLAFA..eAFAdCAAFCCHTCFA..ECFAMBIBhAAABCHA..QDDChABAaECEHEGBXFEDhABAACCBGEGAfGAA.PHCAhAGAKGAA......hCAA...,1,-14,-19,5
QFUYcMBWLTeGIKPJAVEOgCbNXfSRDZdHa,EAAACAAA....XACARACAdAFAHBGB.aAHFQAFAFCCH.hAAAUCAAMDABLBHBhAAAeDFBGEDAKCDDACFBODFDhACA.bFAASFHBZFGBBEEC.IHGAhADAJHDE....hCAA...,2,-12,-4,8
PbYafSeQgGRBDVUZXCcdWNHITOMAELJKF,EAAALAAAFACD...bADDaAEA..eAFAGAGARCABBBHADBEBZDDAhAAACCCC.dFBAHCFBODHDhAIAAAFAKEED...fEHAhABAQFDAgFCDXGGCNIBBMIDAhACA......hCAA...,1,-8,-14,6
JIbdKTBQXVOLDSEefMaCNFZRUHGPgcYWA,JAAAdAAABADA.QAFAOADALAHBDAIB.EBDFeCAAMBGBhBAAaCEB..FCEDRDEFHDGBhACAGEGA..gFAAhADAYCCFABHBbGDAKGFD......hCAA......hCBA...,2,-24,-8,16
CUNWAOgYEVJebfGTISRDPZXBFadLQKcHM,OAAAEAAA..eACAGADASAFARAFAZCFEFBBHdCCALEGBhAFAQCFAHGAAMAIBCFFA.hAGAUDAAADDB.gEDAhAAAYHCG.bFGB.TGAADGIB.BHDA.hAIA......hBAA...,2,-9,11,20
aZTeIQHUEgXMWVKPDbYCSAfJdGBOLNRcF,dAAAGAAALADARADAFAGAZCDAeAGH.HCACECGE.MAIB.KDEADDABCDHD.hACAAAABBEEA.OEGDhACAaEABTECA.QFFAhAEAXFCC.WFAH.....hADA......hAEA...,1,-1,-31,30
BCeITacSWbQYROELHgPAXNfMVFdDUGJZK,XAAAMAAAdAEAGAGAZACBBAEA..eBBAaAFD...SDDAhAGAQCGAREFBEGBAHDEBhAAAAAIB.fECAhABADDIBKGDACHHA.TGGA.cGEC...YHAAhAHA...hBAA...,1,-4,-22,18
FOJDSWCcIafAQeHZMERKNXgLdbYVBGTPU,HAAAEAAARACA.XADBLAFBdAGA..VDAAGBEA.TDCAhAAAFAHBDCIBCCADaBHDADDAZEEAMEGBhACAKFCA....NHDB.bFGDhAIA.BCCC.OGBA.SEHBhBGA.....hAAA...,1,18,-28,46
XLQfAMYcJSGZEWdKaeDOPBVUNbTCHFRIg,MAAAJAAAZADBdAEA.KAGADAGA..BBBAUBFA....TCFAhAGAHDAAREEA..XDBAhAIALEHBABDASCHBhBAAEFCBeHCA.OEDD.PFFA..hBBA......hCAA...,2,-31,-26,5
DMSCTeAEHcQPfdRWXJBLgOYVGFIbZaUKN,HAAAQAAAdADARAFA.JACELCCA.OCABGAFAFCGDZCDFKEEAhAAAMAIB.TEGAhAAAEEHF...fFBAhAHABFAAgGAAIHDAaGGCDDDB.CGGDAGIB.hACA......hAFA...,2,-14,-7,7
WCEeLdTNAgaMGZXUfKbYRVIcQPSDHOBFJ,aAAAZAAAUAEA.KAGARACF..VAFA..QCAADBBBHCDBFCHDhAEACCGALDDBdDFAAFAAGFABhAFA..bDFAIFHAhAIASEBABGGDEFFA...NIAB...hABA......hACA...,1,-9,-27,18
ZUEVJSDaKXgLCHGBORcQdNbfFTAPMeWYI,eAAA..IAAAEADA.SACAaAFDXBGDLAFAhACAHCCAGECBRCCAdCFAbCGDTFGAhAAAAAGA.MFBBZDAFUGGAhADADAIBCEHBBGEAOEEB......hCAA......hCBA...,1,1,-8,9
KfAJBbZcYWXdgeaCVMNSPIEGRQOUFTDHL,BAAAZAAA......cADAXACAeAFEaAFA.MAIBSBFHhABAEBFBGCAARCAAQDGAhACAFCCCHCGBLEEBhAAAACEBbEEDdGGACHCA........hAIA......hCAA...,1,-12,-13,1
MVKbaeOYIXHNUQSJdZgPLERFWCDGcATfB,TAAAMAAAKADA..eACEOAFA..XAFBHBBAQBFDhBAAdBHAZCCALECBhAAARDDBCDFADBIBAEHABBDD.aEECIFGAhBBASEGB.gGDHEGHF.hCAAFGGH.....hDAA...,1,-1,-21,20
IMTAeXWBHDENGbCUPdKcZfgJORaQLYVFS,eAAABAAAHACAEADAGAFACAFBdAHAZCAA..fAHEOCEBRCFF.aCCAhAAALEABFDDH.MDIBhAAAADHADEHB.UGGBKFCAJFFFhACAQFBC.SFEHIHHA.hAEA.WHBANIAB...hABA...,2,-9,-8,1
NTVedFQcYMSRfgOGUPIZLXCAJHaEWbKDB,HAAAEAAAKACABADB.TAFAeAEEdAHA.QBEDMAIBRCAAOCEBhAAAGCCAUEGAZEFALGEAhAAAACHB.aHDCbFAAhACA.DFAA.FFED.SHAA..hAFA......hAHA...,2,-9,-8,1
JVZbHSYPCOFdRfDcIQTMLaNBgGUAWeKXE,eAAAEAAAZACBHADA.SAFECAEAdAGA.RCCBDAIBQCECLCFBhAAAaBHDBCHDGEFAAEHAXFDDhABAVGBA.bFGDOCBHhAAA...fEDE.IHHAhAIA...hCAA...,2,-14,-5,9
YIRSGUeVgBFMDKQHcNOELdbTZJXfCPaAW,..IAAARAAAGADAUACAeAFA.BBHAMAFAQCFDHBEBOBGFhBCAECCBdDAAZEBAXFFAhBEACEFAAAAA..SDHHhADAFGBADBIB.KGAANEIA.TGGA...hBGA......hCAA...,2,-15,-7,8
ERbOcKDeZaLJSXNPQGCgYBWFTAHUVdIMf,HAAAdAAAMADARADFOAFADAHB.ZBFELBDA..XCAAhAAAQCBDGDEBCCHABDFAhACATFGAAAIBUFBAIGBAhACAEEEBKEGAeDDD.aFFHSGGANIDB.hADA......hBGA...,1,5,-22,27
fBcbIYEMWTZdVXQHeACSFJOKUNaLRPGgD,FAAAKAAAUACALADAGAEBDAHBBCCA....bCEAECEAMCIBhAAAZDEEdEAA..QEEAhAFAHECBAAIBSEHHhAEAODDBRGFA..fHABIFFAYHFAhAFA....hBAA...,2,-29,-12,17
VQAbPFXNTSfeUJBCKIEZMDaRdgHWYOLGc,FAAATAAAeACH.BAEAKACCZAEB..aAFDRAGBHCCB.OCFDhAAAGBGAQFFBhAIAAAHA.PEBBSCEDhAEAfHEBCEFAEFDBdGGA......hBAA......hBIA...,2,-34,0,34
eSGCPNfTcRVIOLaAEHXMJWDZbBYgQFdKU,HAAAMAAADAEAZADBBAFA.QBGAdAHAeBBAGBEACCAD..hBAAfCFERDGBODDBABBAhBGAEDCBJHBA..bEEAFGFBhBHASFHH.PHAA.NIEB..hCAA......hCEA...,1,-5,-20,15
PJfVGKZUadeMNTAQILgFOCRSYHWDcbXBE,LAAAOAAARADAHAGBDAEA..XAFAEBBB..JCEBGBCBhABAZEAAdEGAeBHHMDIBACAAQDDBhACAFGAA.SDFHhAIAcGDBBDCAfEHA.KGGDhDAA......hDBA...,2,-19,-9,10
aOcZCPbMTUNVQDJFXWgRSEHeLGKdBYAfI,aAAAZAAACADB..MADAUAFA..QAGAFCAA.XBBAhBAARDDAHDGBeECBGBEAdGGDABEBODGDhBBA.bGCANAIADFBBhABAgGGA..SGDHhACA......hBFA...,1,0,-24,24
WOVfEecQPIJARFGDdBHMSYNCbgZKXUaTL,RAAAGAAAdADAHAFAMADA..SCCDCAGAZBFAKCDA.aCFCLDGBhAAA.ODBDEDDEeCHHhAAAQEEBIFAAAAIBBGHAhACAbEFD..........hBAA......hBCA...,1,-8,-21,13
VYNcKWRJGBFTeCfMALPdgaDXHISZUbEOQ,dAAAaAAAHACBZABBEADAQAEA..VAFA..NAHAKDEARCEBGDCAhAIATEAAeCHFMAIBhAEAAEIBLGFADBBB.hBAASGDHbEDCOEHD.cGDB.BGBAhBGA.fGGEhCAA..,2,-14,13,27
eIfdOTUJAVcGFYBCWbPLQKagMSRDZHXNE,GAAABAAACACA...bADALAEA.aAHDMAHB.RCDAHEAChAAAECAA.eCHHdCDATCFAhAAAAADAFEFBPFHD..hACAQEFBSGGDZFAANIAB.OEHD.hAFA......hAIA...,1,2,-22,24
OVSZFPAbKaUgJDBGMRHTXIfdNQeELWYcC,aAAAUAAA.DADAGACAHAEC...TAEAXBDCdAGAeBBD.hAHAECHFLCHB.hAEAcDEAODFBZFFAAAIBbEDDhBAAKGDABDGBMEIBfGGANIAB..hCAA......hDAA...,1,-6,-17,11
EXYPJZgWDHRLeAfGOSFTQdNaMIVUcbKCB,GAAAFAAAdADA.aADAMAFAUAGA..KBFAECDA....XCCChBAAPDCBZDGBDBIBHDEAhBDAREEFAAAB.SEGAhBFAQGBBIGDA...cGGABGHA.hACAYHBA..hBHA...,1,-7,-33,26
CLaTDOdeZEUPMSKfIBcXARbgGWFVNQYJH,RAAAGAAAFADA.QADAHAFBLAHBaAFEOAHDeCCBZEDB.EFFAhAAAMCDB.KCFABCEDhABAAAABbEDD...gFFBhACANEIACHBADGHB.dGAASHEA..hBHA......hCAA...,2,-12,0,12
UIMGDKNQXeYSTZVAOaJgHfCdcWFBPRbEL,aAAAHAAA.dADAFADARAFAECABLAGB.MAIBGCDB.KDHBQBBBhBAAeCCDSEEAhAAAZCEBACEBODDBJFAACFGABGADhACAbEGB.DGIB.NHCB.TGBA.fGFAhBGA....hCAA...,2,-17,3,20
ZRPebXcdgDFJYIOHENSCTaMVWfBAUKQLG,QAAAZAAARAEA.eACAXBGAdAGAFBED..JCAAOBHDHDEAEDABhABACDAA..aCDHMECBhACAVDFBBEDD.AAHALFGBhADAbGBADFIB.IGDASGHD..hAAAfFAE.hADA...,2,-14,-9,5
gCSXYTNFJOfHIbdKZUDGWEAcVBLRQPeMa,BAAARAAAeADEaACA..SAGB..TAFAFBDDOBHDhAAAHBCAdAHAZCEBGEGAhABAACBBLDEAMCCBXEGAhAAAYGDAfFAA.bFDBDIAAEGGB.hAIA......hCAA...,1,-9,-11,2
HEQOWVBXKgTRYNLIZaSPJUMdDecAGbCFf,GAAAFAAAHACBEADAQAEAOAFC.BAGAKCDARCFFLCHBZEGB.hAAAaDEASDADhACAUEAAdEEAeGFAAAHACCHB.fHDBhAEAXDCCTFCA.....hAIA......hBAA...,2,-9,-9,0
OFXDdZQJcgNPfLbeEWMVTaHGRKAIYBCSU,BAAASAAAFACAdAFAZACB..QCBAJAEB....gAGAhAAAfAHAeCHFhABAECHFMDDAaDEDHGAAhAGARECAAEGBCEHAXFGA.DDGBPFBB..hAAA......hAHA...,2,-29,-11,18
IafJPHegRWcMDNFCVZOGXLTQdKUSBAYbE,EAAAaAAA...JACBHACB.RAEAMAIBFAEAZAGBGCFALCEBdDECSBBDhAEAABIB.bFAAhAFAfDDA.hAHAeDHFgFGHDEBBCGCAXGEAKHDA.BHHAhAAA.....hBAA...,2,-24,-1,23
eVJPUXDTdfSNHBFARKLaCZOMYWgEcQGbI,RAAAaAAAZADB..MADA....gAFAEAGAGBBBeAHHPBHDhBAADCCBdDAA.SDEAhAAAHCFBABEALDEDhBBAODHD.cFFDbFDAIGAA...hCAA......hDAA...,1,-12,-13,1
GdeCVHQbTXcUFPLOSNAafEYIBRDJZKgWM,EAAABAAARACA.ZACA.KAFCMAFAGBGA..eBEAHCCAQCGAhAAA.TDAAXDAChAAAFDDALFFAhADASECAACCBaGECfFEADIBAWHFAdGCA.bGFA.hBIA......hCAA...,1,-6,-13,7
FVIMfLDPgdHUSKcTEWaRZbQeXGNYCJOAB,FAAAMAAALADADAEA.dAHAHAFCKCCA.EBBARCEF.ZCDA..eDGFGDGAhAIACEAA.ABEBBEEA.hAEAfFCAgECBhAFASGGD.cGCDaDHDbGCA..hBAA......hBHA...,2,-23,-14,9
AdIYVLRaGFOeCMZgXWBEPSTHJbKcfNQUD,dAAAVAAARADAGAGA.FCBDeADE.ZAGB.XBDDECFB.SCHHhAAAHDCBbEEDKEADhACA..fDCEhAGAQGAAACFALEEBaDHDCGGB.MEGB.BHGAhBIA.....hADA...,1,-4,-7,3
cKWOGdYfJTQAbReVXELHBFDUaMPNCgZSI,RAAAeAAAEADE.HADABAFBDAFA.MAIBCAHA.ZCCA..SCCAhAAAKBGBGDFAdCFAJFCAACCA..XDGDhABALEHBaCHF.hAAA....gFDA.IGGAhAHA....hCAA...,2,-39,-13,26
eBXQbJEGIgSZTYfUNMCDaKHOdFcAVRWLP,RAAALAAAeADEBAGBQAEA.EAGAGBDA.SAHHhAAAZCAATCGAUDGAMCEBhABAaCCBHEAAdFCAAFFBPEGBhACAXGEAbFEDIHHA....hAEA......hBIA...,2,-17,-1,16
bUSDacKEJXQYOTVZLCWdeGPNFRfIMABgH,HAAASAAAaACAEAFAQADA.OAFCZBEELCCBhAAA.dDGAeCCBGEEAhAFAFCFDRDABMAIBAAAAbCGDDEIBKEEDhADA.XGGA.YHAACGHD..hAHA......hAIA...,1,-5,-9,4
DLWFegPIMNBEQaAUZcGdJKOfbSTVXRHYC,ZAAAdAAAOADASACE..TAGARAEFHAGBDBDBLDDA.hACAeDHFgBEGhAIAMCCBEFFBACCBGDGAKGAA.hABAbEDBYFHBFFFHNICB.......hBAA......hBCA...,1,1,-16,17
XAfaUDQWIFMHcJZBNRgSCePELGOTbVdKY,aAAAQAAA.FACEHACBZAEBBAGARAEACAHBECFAGCFA.OAHDhAAAbDEA..dEAAXDCChCAAABBBDCIBMEDB.JFFBhAEASEHH.eFFD....hCDA......hCEA...,1,-15,-19,4
McfLZKYRJeWBQISadAVOCgUEDbGTNPHFX,CAAAEAAAGACA..TACAHAEAMAIBLAEBZCAFRCEAeAGBBEEDQDFDhAAA.aAHFhCAAAAGAOEAHDCCB.bEGBhAAAFDDH.fFGEKGFBYHCAIGCAhCBA.SGHHhCEA...,1,-5,-15,10
DIAKcTLHNCMbGRdUJFEYfZOgVeBQSPWXa,TAAAHAAAMACA.RAEAdAHAFACAEAFAZCCA.OAHDeCGBBECA.QEEBhAAASCCAXGGAhCAAaCEDACCALDGBhAAANIDB.GFAB.YFFF..hAFA......hBHA...,2,-17,-1,16
VgbDYIUQRZEFBSTfeAKcPXOHWadLCGMNJ,KAAAXAAAHACBdAEBGADAMAHB..VAFADAIBUDEAZCFE.BBFDhAAATDAA..ACAAODHDhACAaDDHLEGB.hDAACFADNEIAbGEA..IFFA....hAAA......hABA...,2,-26,-11,15
fDLWGRcBSUMdEITOeZYXgQbHCJKNVaFAP,DAAAGAAARABABAEBMADA.EAGA..OAFDeBFBZCDF..XCDChAHAbCGDHDBB.KGGAaAHDhBAAAAAB.LDHB.hACASECA.dFFA.IHBAhBHA.YHFG.hBCACEGB.NIBB..,2,-23,-10,13
LYCdgRFcQIWNXUEZMeBObaPKSTJAHDVGf,HAAAGAAALADBdADARAFAFCEDQAFA.IDFAXCGAhAAAECABeDBHOAHFaDDHKEGAhACATEGA.ACCAfEEEhAAACFFD.gFAAcGACNHCB.MHDAhACABHGA....hAFA...,1,11,-19,30
OHbLdVPfYQCeRZNFcaUGXJSMAIEDBTWKg,EAAATAAAKACA..HAEBdACA....fAEAQAGARAFFZCGBhAAAFCCBaDECGDDA.SEAAhAEAADGABDHAOEABhAAALHAAPFFAeFHFcGADXGEDIHHAhAEA....hAGA...,2,-23,7,30
YGQVLDXMUPHCJNEbTOZKSRBaWAcIgdfeF,..IAAAdAAAeADAGACALAHB.MBGBHAEACCBA.EBHFOCEBhACAZCAFRDFBaEAH.AAHA.fDAEhADAQEDDXEGAhAEAPFHDbGCCTFCASHEABDCAgFFGhBAA.FHBChBCA.YHEA.,1,16,0,16
BWRIHEfDQPTLMeXZJdObaFVcASGUCNKYg,GAAACAAAKACA.BADARAEF.HAEBDAGA.QAGALBHB.eCDBZCAA.hAAAdDGA.aDAHFCGBAAABSEHHhACAUEAA.gGAAhADAEEDA.TFEAMFFAXGGAhACA.....hAGA...,1,-3,-28,25
HJYdDUaRFLINgKbAOeCGQcEfVPBWSMTXZ,eAAAGAAAEADA..fADABAFAMAHBZAEBHCCAdAHADBGBRDFBLEHBhAAA..gDDGhAAAAAIBQECBPDGDhACASFFDXGGAUGCBaDAHFECH.KHBAhADA......hBAA...,1,2,-9,11
HJZSDdQEGLCcAIgFXBVTePRYNKaMObUfW,FAAABAAAeACHRACAKAFC..aAEA..MAIBOAGDUCAAHBDB.ZDFEhAIAdCFAEFBAGDDALFGBhBAAABHB.XGDAhBFA..TFGA.PHEC...hBIA......hCAA...,1,-7,-31,24
JYCZgFLIAcMfeHaOEQdPVGKUBRWXDNbTS,MAAAHAAAEADEdAEAGAGABAFBRAGF..DCABTBBA..SCCAhAAACDBDZDDALFDBACCAeCEHhACAaDHDQDGBhAIAKFFDXGAAbFFA..........hAGA......hAIA...,2,-17,-8,9
QTNfcMGHaCUVBJPIdAWZYXFbRgDKeEOSL,ZAAAFAAARACFKADC..EAEELAGB.QCAATBGA...hAGA.fCEAhAHAGCDAHFBBaDFDCDHABBFAIECAhAIAAAIBXDGA.bFFBeFEB.SGGAhBAA.MIBAhBIA...,1,-11,-27,16
FcUIQdeMESOKXYZbBADfGTHWVgJPCRLaN,GAAAHAAAVAEAJADA.RCAA.LAGB.FCDAICHA.eCEBhAAAEDDBKDHBZEAAAACATFEAhAAA..gEFHhAEAaDBD.NEEA.QGCCdGHAMHAA.OHFChACA.....hAHA...,2,-12,-2,10
CRbPWXNKLHGVUFSQagJMYBeDfTIEOZcdA,RAAA..bAAAXADB.LAGBHAEAGCAAFBFB.aAGAMAIBhAAAeCCBDCCBTCFA.hABAEDHFZDCBAAAACEEAPEEAhCAAKFGDSFHHQFGAYHCA..hACA......hAEA...,2,-10,-1,9
MfcLCZbVTaPSEQGHUYKDgReWJOBNAdXIF,dAAAFAAAMADALADAZAEE...TBGA.aCAEEBCF.HCEAKCEARDCBhACAeCHH.ODDBhAIAAAEAfDHAbEFD.SEEBhAHAQGCBGGEBDFIB....hAIA......hBAA...,2,-17,-4,13
PXJFbgETBOAWUfQZdYCGVKMIDSeLaRHcN,UAAAZAAAdAEAGADAMAGB.DAFALAHBHBFB....PAHDhADAFCAAEDABODBBABHB.QEFBhBAACDDAKDFDeEBHRFBFNEIAhBCAXEGA.JHEA......hABA......hACA...,1,0,-20,20
FaBNKCIGYZTHDQASdePJEWfXVbUMLOcgR,eAAAEAAA...XADAbACA.LAGBOAGBRCCAaCCABAHBCDDDGEAAhAAAZCGBHDAB.AADAdEEAhAAAPDFBJFHB.fDHAhABAMIDA.FFHD.KGCA.....hCAA......hCBA...,1,-2,-9,7
OPTUDQWGSaRZBKHMceLJfdCEbVAIgFNXY,FAAAXAAAOACDUADA..QAEAGAGARDBAZDFFHAGDeFBAhAAALDEBdFHA.EDGBAAGB.hABAgEAA.hAIAPFHDDFFB.aECDMIBAfGFA.hBDA......hBFA...,1,0,-12,12
dfHWFaZUNGCSgBOKIPEJRcbeTXQMALVYD,LAAADAAAHABCaAEAZADBGAFA.SAHBOAGDKBEBECAARDDBeCHHhAIA..TEEAhABAMCCBADGBdDHAFFGHCDCDBFBAhACA.IGGA.cFDC..hBFA......hBHA...,1,-15,-24,9
BKHIFTWVdCGfOUPcQXYSEAJZeDgNRabML,eAAADAAARABA.MAEALAEBHBCAFAHD..TAGAdBFAGDGA.hAGAODEBPCGBQEBAhAAASCDDADIBgGEAhABAbECAKEHB..IGGA..hAIA......hBAA...,1,4,-30,34
KeZTNcfdUYCORLgHJQVbGSWFIXBDAMEPa,EAAAaAAAZACB..TACA..fAEAdAEACAGARCEA.HAFBQEEBhAAAGDEAFAHFBBHAhAGAABBBMDHBeCCBcEGDhAIAOEDHgGGA..JHEA..hCAA......hCBA...,2,-16,-3,13
IYBQcWXKPaJTDeMfSCHNGEAgLRVdFOUZb,RAAAdAAAOADAZABB....bADABAGA.QBDDXBGDaAHFhAEATCGA..eCEBhAFAMCCBCDCAHEFBEDEBAAAALFGBhAIAFEHFIFCAcGCAWEEDKGEC.DFIB.hBAA......hCDA...,2,-12,-11,1
QRgIVOcDYHKESJXWGLBTZMFCNbeUdPfaA,RAAAVAAADADAHAEC.KBHBEADE...XAFBGCCALEFAhAAAZBGBMCDB.CCFDeGEAdCEAaDHDhAAAAAHA...QFFChAIAIHHA...cGDBSHDGBHHA.hCAA......hCIA...,2,-17,-15,2
FdeJUYENacWBKOLHASQZMIbgGPCVfXDTR,ZAAAMAAA..IAEAGACBCAGB..XAFDRCCBeAHH..UDGBhAFAEAHBaCAABBBD.LFCAhBAAHDAAADDAQDFAhABA.bFDBgGGAfFHA.DGGBhACA......hADA...,1,-13,-20,7
SOPJYfdbHgDRBUZcAFXKaIQeENWLTVGCM,KAAAaAAA.eACE..EADALAFBGAFAMAIBOAHB..PBBBhADAfBCAHDCARDGFZDDAhAAAAAHBFFBBQFCAhAIA.TFGASFDAYFFFdGGDDIFABCEChCAA......hCBA...,2,-16,5,21
NBTVSGQZDgHIUOPWFMXKCfbecJdRaEYLA,TAAAGAAAZADA.HBGBOACAFCDAMAEACAFA..eAGHdEEAEEHFhAAAAAIBBBDD.QDDAhAAADAIBIHHAPCHDhCAAKGFB.bFCC...RGEAaHGENDDA.....hACA......hBAA...,1,-2,-13,11
FYXWELIfNaGUMBHPDZVAgedQbTROKcSCJ,eAAAdAAAQADARADA.KAFACAGBFBHD..XBGAECCBLCFBhAAA..fCBAhACAGEAAMEEBHDCAZFGBhABAAAHAbDGD.TFDA.SDADhADAWFDD.IHHA.hAEA...,2,-19,-1,18
cTVFfNCOHQAULGBPgXMKaJYISREeDWbdZ,GAAABAAA..XACAaADA..IAGAEAFADAIB.dCDAZCAATCFAhAAAFBGD..CCEAHEEAhAAAAAIBLCHBMDIBKFAAhACASDBHRGEA.eEFB.bFCD.fHEBhACA...hADA...,1,-5,-23,18
TLBWaXNPJHCGYUVASdgeEFcKQDZOIfRMb,dAAAEAAAKACAZABBOADC..RAEFMAHBLAGBBCCAaCEB..XCFDhAAAJDCBHEFAGEAAhAEAVFDB.AAIB..eDEDhAGAFFABDAIBIFHA.TGFA...hAFA......hBAA...,2,-13,-13,0
GIXgRfOPJNFMYeaVHKSBWCAEcUQLTZdbD,EAAAQAAAZACB.dADAGAEA.XAGARAFAOCDE.PCHBhAAAFCGDeCBD.HEDAhAAABDBAAAGALFHBhBCAbEEBDFAA.fGGAMFIBaGAASGFHhAFA......hAGA...,1,2,-18,20
BJeMWZQNgTOYFKAVRDEIcPfSaCXHGbdLU,RAAAEAAA....IAEAfACA.aADDHAFB.dBHALAFAhAAABCCAeCEBZCDEQDGAhAGATDAAFEGAAAAADEEBhAHASEEDXFCDbFEDMHAAgGGBhCAAKGFA.....hADA...,2,-21,4,25
FKXbWSTEVIfLJBgGCRDdUOHAMNYQPeacZ,MAAAQAAA.eACAZABEXAED.SAGAhAGAEAFAfAHALCCBBCDAhAAAGCGARCEFdDAAHDGBhADAACIBPEEBaDCHKGCAbGFAWHAAIHHA.CGEBDCIBhCAA......hCDA...,2,-4,-3,1
gBVJIONcAQFWUGYaEKHPXbRdfCZTMLeSD,QAAAFAAAGACAEAEAHACA...bAFBRAGBdCFAZBGBLCEBhAAAeDHFDEAABEDAIDDAOFDEhAEAACIBUEAA.aEGEKGHBhAIAfGGAMIBA.......hBAA......hBIA...,1,7,-17,24
aOBPgKHGJILEbXZNWVTCDYFdQAMSceRUf,MAAAeAAARADAUAEA..aAGABAGA.KBBAHBFCGCGALCCBhAAA.EDGBZDBAVEEBTFEAhAIADDIBdEAAABIB.fGHAhABAODDA.........hBAA......hBBA...,2,-34,1,35
WaUPJZdQYHAEKRMbVXBcIDLGNgCFTOSfe,RAAAMAAA..XADBBADADAFAGAFA.CAHAFCCBTBBA.SAGAhBAAeCHFaDEBUFBAhAAAZBFAdDDAHFEAEDGBbDEDhBBAIHHA..LECD.OEHDhCAAWHAG.PHDC.hABA...,2,-11,-4,7
JfTWIbGBSZeCaRdVcMKXQHUDLEgNYAOFP,FAAAJAAA...TADA..bADBGAFAZAFB.eAHBRCCBdBHAMCCBhADAQEFAHDDBLEHBhAFAEFBB.gGFDhAIAAEIBfFEEBHDAaGHD.KHCA....hAIA......hBAA...,1,5,-20,25
cQSDEeANHZBGICMVLWgJUROXbaPKfFTYd,HAAAGAAAMACALADAJAFB.RAGFOCDB..aAHBKCFDTCCAhAAAdEADQEEBhAAAECHFABEBZEEACDFA..gEGHhACAXGGA.fGHA....hAEA......hAFA...,2,-16,-9,7
UQLFOPeYNIgCZdBTGbfaASRHcWDXVMEKJ,HAAADAAAMADAEADEKAFC.UCABLAHB.OBBAeAHFICFAhAAAZBEBdCCDGDFA.hACAaEHDRDCFXEFAhCDA.QGEAFGCAYHBACGHA.BBGA.hCEA......hCIA...,1,-8,-15,7
OLBIaNJDfPbcAWZHEKUMCRTdgeGYVSFXQ,HAAAEAAAKACAMACA.RAEAdAHAeAEEGCCA..SAHBhAAAQCFDLCCAaDHDDEGBfGHAhAAAbCFDACHBZECBTGGAhBFA..YFFFXFEC.BHEAhCAA......hCBA...,1,3,-15,18
KVNLYEXPfTdWcBJMRegFOASZbHCUaQGID,ZAAAHAAAaACAGADA.KAFALAFAEBHF.XCCATDAAdDFAhAAABCFAREGFeCCBOCGDAACACFADhAFAQFCADFEB.hAHAVFEANIAB...fGAA..hABA......hAGA...,2,-24,6,30
STJRecHKPXAgNfEYOZGDMbBCFaLIUWQdV,...fAAAEAAAZACBGAEAMADACAGAaAGALBCAUDGA.dCGATEBAhAAARCABHDDB.XFGAhAAAABCB..gEDBhBEAOGDEBHHDFGBHQGGA.hACA......hAIA...,1,-5,-11,6
GaUYcBbAXCfKSDLQEVPZNWHMgJOdTRFeI,CAAASAAALACA.EADAZAFB.HCCB.MAIBOAFC.RCCAeCFEhAAAaCGDUDAABDAAAEFBKEHBhAAAQDFD.PFGBhABAgFCAdHAB.TGFA...hADA......hAHA...,1,-11,-18,7
HCUceFNPdGIDgSOaZQYXKWbMVARTBEfLJ,RAAAEAAALADBHACACAFB.eAFAFAHB...dCCCGCCBDBIB.OCHDhAAAZCFBQFAAKEAAMEFBAEGBhAEATFCABFCAfGGAhCAAUGGA...cGCDIEHA.hCBAaHDE.....hCCA...,1,-7,-15,8
FSfEgNUKJCcILZbRVeDHTWYQAaBdMGXOP,dAAAGAAAOADASADA.EAGAgAGAKBHB.CBDALCCAhACARCDAeDADHDFCTDFAhAHAQECC.hBAAAAABaFFBMCIBFGAHfDBEUGGAcGCDbFFCDEEBhBCA.BHDA.PHFChBDA.,2,-23,20,43
gREaIXZHDTKSNFVULOGdCJQfBAYbeMPWc,eAAAMAAA.....PADCgACAEAGE.aAEDZCCA.HCGBhAAATAGASCEEhABAFCFDLDDBdFFACHGA.QFFAhAGAACIB.YBBF.WDHB.hAIAIHEADEEB..hAIA...,1,-11,-25,14
gaDXTdKEWLAcSCfRUQZOYNbJeVPFIGMBH,CAAARAAAZADB..OACA..bAFAeAFAFCFAGDAAHBCAaBGEDCCBdDEAhAAA.ECBBAAAA..SDEHhADAQDGAJDHBIGAAhAGABGEA.TGDALHAAfFGEhBCAUGGB.....hAGA...,1,-1,-11,10
WMBKPcLdXHSgRGIYQfaNCTJDZAUbFeVOE,FAAAeAAAEADAMAEA.KAHBLAGB.HBDCRBCAGBFAQDAAhADAaDBBCDED.TDDAZEGBAAAA.hBDAbEGBOFBCBFFAdGBAhAIASHCA........hBFA......hCAA...,1,0,-18,18
BFeaHfUYXOWGbTNMAZSDCcPRVJQLdgIEK,ZAAACAAARACA.QAEALAFB.dAHA..EAHBFCAAHCAAUDDA.ODABhABAbCGD...MDGBhACAAACADCEB.VFCAJDHBKGBAhADAaGGA.....fGHA.YHDGhAEA...hAAA...,1,-11,-21,10
fCbNScaJgOReUWMBGQYIEALVTXZDPdKHF,TAAAZAAAdAEAHAGB.CCAA.SACB.aAEAOCCBRAGFeBDHhAAAMDEBGCEAQDFChABAEDHFACCBLFBAhAIADDIBFFGDbGAAcGFB........hBFA......hCAA...,1,-4,-14,10
LEMJaVZPSXeQUcIFOCKgfGBdTbHDRANYW,...NAAA.LAAA.EAEAaAFAZAGBXBBAeBFFQCAAhABA.ICDAhACACBEAfBGEdEEDHEGBAAIBMCIBhABAPEABSDAH.FDEA.KEED.hAEAGEBA.bFGDDBIBhCAA...,1,-2,-16,14
aeEHAVgGcFOZNUJYISXdBQbTDCRLWKfPM,GAAAOAAAZADBUADA..JAFBSAFA.dCGAbAGDTDDAhAAARDBBLEEA.KBBDhAIAMAIB.EEHFHGEAhBAAADFAgFFDNEIA.XDBDDIBA.fGAAhACA..hAGA...,2,-20,-10,10
QAXCKVeHISJgFNMRbWGLfEaZTDBUdYOcP,KAAAHAAA.SACEFACARAEFGAGAEAFAZBEEBCCAdCCA.OBHD.hAAAQDFCAAIBCDED.hAGAeEEDIFFANIABbFAA.hAAALFHB.aGDBTGGADIEA...hCAA......hCBA...,2,-37,19,56
CQIFTELObBPKAGYMeNWVXDaUfcdgZHRJS,GAAAeAAA..VADAaADAUAGA.dCDAHAGBRDFA.CCCAQDEAhAAAFEBDLFDBBDHAAAAB.hACAMEDB.XFGAhABAfFFEZGEASGAAEFHB...hBCA......hBDA...,2,-21,-3,18
CBeVRdLGSXAOPfZbJTaQcHDNYWFIEUMKg,OAAAZAAAJADA...aADDHAGB.DCAA..NAFA.FCDDUAGAKCFDBDHAhABARDBAGDFA.ABBB..hACA...bEFDTGBAhBAAQGAA..YEHB.EHDAhBDAMFIB....hAGA...,1,-15,-31,16
DINdJRCYBHcAagZKQLTXPOMfEFeSbGUVW,ZAAALAAA.TAEAOACA.EAFAeAGHGBGAUCAADAIBdCDARCCABEEAhABAHDFCAAIB.aFDAQFCChCAAMFIB.SEHHhCBAbGAA.IGFACGFA...hABA......hACA...,2,-16,-7,9
DMJAdFaScYbZOQUWXgHKGLeNREPfBITCV,aAAASAAA..bACDZACB.QAEAXAEA.HAGDGBGAhAEAeCEBEDEFBDGDTFAAhAFADCIBAAAAdFCAFFGAOBBBhAHAgGGGLFFANEEA.fGEEhAIA.CHHAMIBA..hBAA...,1,3,-7,10
GdHVAJabCDRcMfZWFQILYUeOXSBTNEgPK,aAAADAAARABA..MADAZAEBFAGDLAHB.eBBASBHHBBEAEBGFhBAAKDCAHDDA.AEHACFDD.hAEA.fDFAhAIAQFFAUFGATGBANIEB.......hBAA......hCAA...,1,-3,-37,34
IDeQSNJbHaGRLKTPdUBYWXECFVZOcAgMf,MAAADAAAeABA..QADASAEAJAFEHAGBRBBB.LCCAhAFATCFA.dDGDBBHAXECAhAIAEDEBFDHDZFEBAFGB.fGGAhBAA..IGHA..hBAA......hBBA...,2,-31,-6,25
cgDRQCaTAWIFeSKOZfMNVJGdXHBLEPYbU,FAAAeAAAOACDZADBMAGB..JAEAdAHAHCDBEBCF.....bBFAhAHAgDFA.hAIARFBAaDHDADFASDGHhBAA.fEBA.GGEBLHBAhAAA.UGGADEIB..hABA...,2,-13,-9,4
AIBENSeOaKgVYWZDdLXUMHCFGPfRJcbTQ,EAAAeAAAKACA..VADAZAEBdAHALAGB.MAIBHCCB.GCFAhAAARCCBJEFA.bEAD.ACCBBDHBhAEAOFDC.aGCCgFGHhBGADGHB.........hAAA......hABA...,1,-7,-22,15
YOgeTGIfCLJNXERPQbVZDWAcFUaMKBSHd,FAAAaAAABADAHACBdAEB.OAGDeAEHGAGA.CBBD.LDEBhAIAJDAA.EDGBRDFBQFDAhADAZFBBABFBMDIBSGFAhBAATGAA..fGHA..hAGA......hAIA...,1,-13,-24,11
NWSHabDcGYgAFXVTKBJPLdZEeMIfCOQUR,XAAATAAA.BADALACBZAEB.EAEAeAGFMAHB..CBHAQDAAhAAARCEBSCHHHDCAhABAbEAAGGCBADHAKEFAdEHAhADAOFGFNIAB.aGBBDGGB......hAIA......hCAA...,2,-10,6,16
PLUFVQMcJXHWSBdOGgZETYfKeINADRabC,RAAAaAAACADB.LADA.FAHBMAFA.JBEBHCCA.BBBDGBGAhAAAECFE..TEAAKCCBeEFBhABAAAEADCIBUGBA..hBGAQEEAXGEDSEHHdFHAOHEC.hBAA......hCAA...,2,-20,-11,9
gbLYfAFNMPZUHJKRIEcTVeGdOaSCQBWXD,MAAAZAAAHAEARACA.EBHF..TAGAeCABdCCDOBBBaCFD..QEGAhABAXCDAbCFDLFDBhACA.AAGAFFFHPCHDhAFA.KECAIHHAGGABBGGADEAB..hAGA......hAIA...,2,-11,7,18
eBESMZGXVTDIAQcHaFPKWRLfYbOgUNCJd,HAAAaAAA.KADCRACFLAEB..bAFAOAGBUCAB..CCFAeCGHhAAAEBHFZDFEGDCA.hAHATFEAABBBQECAhAIAFEHD.fFGAgGAA.NIDBBHHBhACAMFIBDGFB....hBAA...,1,10,-20,30
EFNdKaAJcYXQCUWSHDgfVLMBPOIRGebZT,JAAAXAAA.UADAHADB.DAFA..VAFAMAIBBCHAOBFDhADARDBAGDFAeCCBZEEAEFDB.hAAAdFBAADBA.QGGBhBAA.SHBAfFHAIHEAhBFA......hBHA...,1,-14,-18,4
EYOHKVFLUTPdaZRGCSXfeJgAIDWcMBQNb,DAAAMAAAQACA..EADAHAEAFAFDTBBAaAGARCEAGEEBhBAAXBGDeBBB.ACHAIGHAhCAABAHBbDDBKECB.hDAALEHBdHEBCDDD.fFFA..hBAA......hBBA...,1,4,-25,29
EDgZcHbIXTASCFOeQaYGVLMBPJdfWURNK,FAAAeAAAQADAGADAMAFABAFA.dAHAUBFARCCB.ECCBZDAFHEFAhAAA..XCEAhADAABIBODBBaDGDLHCAhABA.fGHAKFEADDIB......hBDA......hCAA...,2,-23,-4,19
JXTbcOUgZGaBSHQCYDFWRLKdEIeANMVfP,MAAAVAAA...JADB..TAEAOAFAZAGBGBEABCDAHDAAhAAAQBGBDBIBREEAdEHAEBBBADIBhBAA....fFDEhADAbEFD.gGAAaEEHCEHD.FGGH.hBCA......hCAA...,2,-22,-2,20
ecXMHLYDOVPSKBdgAbINZQJUWTGfFaREC,..IAAAZAAAQAEAUACA.GBGAaAEE.ECAA.eCDFMAHBhAFAHEABLCFBOEEBhABASCBDdFGDAACANIAB.hAEATDDA.REGFXFDC.DAIB.hAHA......hAIA...,2,-15,2,17
BbPDLcAfVgQGKOXdTeEUYJCWRIHMNFaZS,VAAAGAAA.OADAdADA.EAGAUAFA.CAHA.RCDAHCGB.MDCBhAAAaCGEZDDABEFD.bECDLEHBhAAAABIB.QFBAhBFATGGA.eFFB.....WFDHhCAA.....hACA...,2,-15,-11,4
KQbcEMJXDZgCPOdTYaLfFHBUVSAeGNIWR,eAAAGAAA..IAEARADAQAGC.ECDBMAGBDCFBZDFBCAHAdCCAhAAA.aCFHLEAAhAAA.FDHDHDGBBGHASCHBhABAAADANIAB.bCDD.XGGA.hACAODBH.fHABhAHA,1,-7,-17,10
HQTSdCVFEgYDeKIBOAfMNaGXRcbUZJLWP,MAAAGAAARACA.UADAZAFBLBHBHAFAQCGAdCCD.FDDAEEEADEGBhAAAeFAABFHA.AAHAaDBDhACAbFGB....PHCAhAFACHFA...........hBAA......hBCA...,1,-10,-19,9
IAbgDQZOYCRUcaVKEFTSMBXWHNGPeLJfd,DAAAZAAACADBRABA..UAEA..aAEDKAGAFAGA...MBGBBCDDHCAAhABAGCGALCHBdDFCACIB.hAIAQEDA.hBAAOFFD..cGGCEHDE...SEEDhCAA..hCBA...,2,-47,-13,34
UXIWHLKDZNFCTYGSAfdcgRaQEeMVBbPOJ,dAAARAAAEADEeADA.MAHBBAFB.OAGDUCCA....XCFDhACAHCCALECAZDABCEHAGFCBhADAAAAAfDGEhAIA.aEHDbGFA..IGFADAIBNIDB...hAEA......hBAA...,1,-8,-21,13
XaPOCMQRNEZcATHIdVULDBgWKfFebJGSY,HAAAdAAALADABADBKAFAeAGHGCAB.SAHBaBHDCCBA.RCFAZECBhAAAAAEA..TDCAhACAIEHADCFB..fEFAhAIAbFAB.XEGDMEFBEGGA...hBAA......hBCA...,1,-2,-32,30
CKXWFZSeLDUAQBaHYTONbREgIfPVGcJdM,aAAAHAAA.TAEAOACDRAGF...EAEAfCAEGAGAdCEAMCCBhAAAXDFDZDCBLEEAhACAAAIBQEAABEADbGAChADAgFGAIGEAcEDCKGGA...SBBDhAEADCIB.NIDB.hBAA...,2,-15,17,32
adPIFUCWSfXbGYTeOQZBJRNcKAgHDMLVE,HAAAMAAALAEAEADEdAFAFAHBCBBA...SCAAXBDCGCEBhAFAeCEBZDFBREEB.KDCAAAIBDEHBhAGAaCHD....IFHAhAAAfGHA.YHCA...hACA......hCAA...,1,-16,-18,2
LGgUSMAWFQHIEfCKYVBdXRTeOZabcDPNJ,QAAAHAAAEADEKAFCBACARBFA.eADHZCAA.aAFADCCA...JDFFGBEAhAAA.SAHHhBGAAAIBFDHBCEDA.dDHAOFHDhAAAbEFDPGCA........hCAA......hCGA...,1,-11,-26,15
JKcMLgIAEaGHYXUQBZPNVdDWCeFfSObRT,EAAAHAAAUADAZADBVAFA..dAGADCABeBCDFCFH.OBHD.RDFB.hAAATEGAKDBD.MCCBhAAALFDBACIB.aFBDXGGAhACABFHA.PEEBCHHASFFD.hADA......hAIA...,1,-14,-19,5
ROKdUPGDgCZYXEbHQNaBcfVTSFeILMJWA,RAAAdAAAGADACADAZABB.EAFAHAEB..QBGAaAGA.BCCDVCGBhBAATDAA.eDEHhAAAMDDBADGBKEHBDEEBXFEDhBGAbFAA..fFGEFGGAIHBAWHEGhABA......hADA...,1,-10,-16,6
OIgPcbAFHJNKfMSWaRQTdXEULVeGCZBDY,HAAAKAAAMACAaACARAEF..dAGAEAGELBDB.eBFDZCCFDCGAOBHDhAAAgDGA.hAIA.bEFCADGAFFED.fGGAhAAAQGBA.TGGA...hAIA......hCAA...,2,-18,-12,6
EQDZaNAXbRGcKVTLHegMfUBYJCPSIFdWO,RAAAGAAAKADCLAGBHADAeAFE.MCDBBBEACCEA.SCCBhAAAdCGAEEEBZGDAAAIB...XEGAhAAAbDFA..TEDAhABAfGGBUGBAPFGBWDADDIAA...hBGA......hCAA...,2,-25,6,31
cDVUOCdANgSZPYMWaEbeQLBIJGFHTXRfK,SAAAZAAAMACA.EADAeAEA.LBHBBAFAGAGAHCCCRCFFKCCAhAAADFCAOCEDAFFB.gDABhABAPFHBaHCAbDFDhADA.....IHFA...hABA......hAIA...,1,-13,-16,3
WGcfdeNDgRQLJHTXFbaMKEIBSPAUZCOVY,ZAAAOAAA..VAEAGADAdAHA.eAFADACA.RCFALDBBHCCCFDFD.hABAaDDHEDHBBBBD.AAFACEGAhBAA....cGGAhCAAfFEA.QGGA.XGCDhBDAMIDA...hCBA...,2,-29,-3,26
PEHCXRONfMLBQAIDYJTKWgGabVSedZcUF,DAAATAAAKACAGAEA..bACBeAGBZAEBFAGDHCCB.REABOCHDhAEAMAIBLDGBBAHBABBB.hBAAIEBA.YECBhAAAgFFAaEEASFFDdGDA.hCAA......hCCA...,2,-13,-4,9
fWQRKgObSEGFTYAUIBcaCPNDdZeHXLMJV,BAAAaAAA.CACA.DADAZADBHAECLAGB..MAIB.VBCBQCAAhAAARCEFKDGA.bDEDEFGAhAHA.FGFHAAIB..IBFAhACANBBA..dHCBeCHH.fFHAhCAA.....hBAA...,2,-25,-13,12
WgUKfESZPRGIdHbYDNOMeQaXCAJcBVFLT,BAAALAAA.TAEAUACAEAEA.ZAGBRAGFdCAAHCEBDCCA.MCIBhABAeCBB.aCHDADDAVDEAhACAFEDHKFGA...SGBBhAAAGEABbFGD.OGACCGFD....hAEA......hAGA...,2,-18,-4,14
CQHPKfGDXTSaZNAVMWgIOYLFbEBUedRcJ,MAAA..gAAAOACELAFBEADAeAFARCCB.CBHA.HCGBKCCAGCEAhAAATFEAaAHFACGBIDAAhABAFFCHBBBDdDHA.hBAAQECCDFIBSGHDZGAAVGFAWHBA.hADA......hAGA...,2,-2,7,9
ICAHTfbBdMVecDQKYGZXWONJEaUgLPSRF,HAAATAAABADB.dAFAeACEQCABGAFAZCCAOAHBEAHBaDBChAAALDDARDGF.CCEDACIBbFAAhAFAMEHBDEEB..XGGAhAIAJFBA..gGFD...hBDA......hCAA...,2,-13,3,16
XPBGVcLJfSRETNOMHCeZdAIgYUFaKDQWb,..IAAAUAAAaADADACA..QAGA..bACABBDAhAGAGAGALCFBSCCAhAGAEDBATFDAMDFBHGBAhAIAeDHBADEAFEGHXGGC....hBAA......hBCA...,1,-15,-22,7
ZdSVXEBLRUATbJYHWFPGMgQcaCIKOeDfN,TAAAJAAAHADB.FAFAGACA.MAEAQCFAaAGE.KCCDeBEGhAAADAIBZDAFdDFAXCAChACAEEEB.REDBACIBbGFAPDHBhDEA.CGGD.fEHA.SHDGhADA...hEBA...,1,-3,-15,12
EaOXUHgeTQJPYCBVRGWcFIKNSbALfDZdM,LAAAZAAAEADE.aADDOAFAHAFA..eCABTBFAQCEDhABA.JCCFCCAARCCAGDGAhACAFCHDKEEAbFACAFHAdGEA.XGGAhABAgFEB.BCHB.WHAA.hACANIEB.DIBA....hBIA...,1,24,-19,43
AdOcSJYVRGMKXeLEbfNIWQTBFagZHCDUP,dAAASAAAJADA.RACFGAEAMAHB.eAGBEBDB.....bDFDhAAAfCBA.hABA.IEAATDEAaCHDhACAHEDDDDDBAAHAOCHDcFCC.KGHBLFGBhAGANIBBBHFB.....hAEA...,2,-21,-4,17
gfbeYWJAQXKZPOUEcCGDRHVFMdLaBSTNI,QAAAZAAAOACAUAGAEACAGAEA.HAGDMBFBaCDHBCCDTEBAhAAA..IDGAhABAbEFAeGAGJECAACIBKGDCCEHA.hBGADGGBRGFA...........hBIA......hCAA...,1,15,-34,49
dLIAbTYJKDGFMEHXfQSPNCcVZBgeRUaWO,TAAAKAAAGACA.EAEAHACB.QAEASAGACAGAZCEEeCABhAAAREAAaCACdCFAACHA.JDHBMAIBhAAA.fEFAhACA.cEGDBEDAgFDAOFEHIHHAhAEAbGFAFHAA...hEAA...,1,2,-10,12
UMObcLYXCHPSDGQZNRIgaEdWFeKBfATJV,TAAAUAAAMADA..OACALAHBCAFAHAGBDBDAZBDERCCA..aDBHhAAAEDEAdDGDFEDHBEEAABHB.hBAAVFCB..bFFAXFGAhAIA.SGFDNIEB...hBCA......hDAA...,1,-1,-28,27
NTReKbWGfVEMOFYXLBIHSQZUPcdCADgaJ,aAAATAAA..RACFeAEEKACCGAEA.EAGAMAIB.FBEDLCCBhAAAHCFBZFFAPBHDhAGAdHABABBBDEEBNDGA..bEDDfHDBhAHAOEBHBHGASHFE..hBAA......hCAA...,2,-15,2,17
MDXJHgOYZaETBUIRVdLSAbPCeGNcfKQWF,CAAAeAAAGACA..fADAQAEAMAFADAHBHCAB.OBHDhAAAaBEDEBGABDFARDEAdDHAhAAAAACB.bECD..cEEChAEAFFGH...XGBA.gGFAhAIA....hBGA...,2,-20,-8,12
RbPQGYdCKZeaOEVIUHWFLcMgNASDBTfJX,BAAATAAAJACA..RACF..QAECdAFAZAGB.eAGHEBCBUECAhAAAHDEALDHB.hBIAMCABACIBDEFAbGAA.PHFAhAAACEHAOFFB.....IGHAhCAAcEDC.....hACA...,2,-40,1,41
aORHgCQJPUDKebEfWANVTMSFZBcGIdLXY,TAAAMAAAZABE.GAEAdACALAEA.aAHDHAGD.QCCChAGAPCDC.KDGDEDGAhAAAACIBSEEDhAIABEEAXEGAOEHDRFAACGGA.DGGBeGCA....hAFA......hAGA...,2,-10,-10,0
CZWGYJLcgSaOIQAXdNTVFDEKebMHRfBUP,dAAATAAADADAKAFA..eACEHBDARAFFBAHBCAHB.GCCALCHBhACASCGHaCBD.QFAAhAAAADDB.XEFChAFAFDFAEEEBbGFAMCIB.fGGAhBDA......hCAA...,2,-26,-12,14
WGMefcPSgTALEdDXKNCUJbaFYQVORZHIB,EAAAdAAAKADAUADA..aAFAQAFA.RCBBHDDBBBFAGCABhACAeBHH...fBHAhADASDGDADFALEEAhAIAXFGACHBAbECD.FFHD.....hAAA......hAIA...,1,-16,-24,8
IXGAcFWDJgMHRUfQNEdZaPbKLOCBSVYTe,FAAADAAAMADAHACBRAEA.UCGAQAGA.EBBAaDEB.KEAALBEBhBAABAHB.SCDFhBBATFEA.eCGBIGHAhAEAADIBcFFA.gGEBfGDE.hBIA......hCAA...,2,-25,-21,4
IWfFAERSXYOLQCgcNHGMDTPJUadVKeBbZ,RAAAXAAALADB.QAFACADA..gAEHHCEBGDGAhAAAMAHBTFAAUDAAdDDAhAAAeCCDZDEBfGDAhABAEDHFOFHDDAIBaGCBBHBA.....hABA......hADA...,1,11,-17,28
JbCfVAETHBORDIXScLQYaKNdgUWGZFePM,HAAARAAADADA.SACELAGB.aAEDdBEAUAGAZCCBFDHD..eCCBhAAAMEEBbDGB..CFFA.AEEAEEFFhBGABGBAOFDD.hAAAXGGA........hBIA......hCAA...,1,-4,-42,38
FYOfEbTSPUQMRLZBJeIadGDVgcWHXKCAN,FAAAOAAAEADA...TADASAFA.QCCARAFFZCCAeAHHhAFAdCFAGEEBDAIBVDABhADA..WBBDHDGBCDHAAGHAhAHAfFDA.PFFB.UGABhAGABHHAIHHA.hBAA...,1,9,-21,30
AObNKEQYGfDMRedVSIZBTXCacJFLWPgHU,OAAAKAAAEACE.GADADAEA.RAFA.dAHA..SBBDZBCEBBGCCDDAaCFEhAFA.FDHDLDFAhAAA..gDBAhAGAHFFAADGA.bEFD.YFEDeHFA....hAIA......hBAA...,1,-15,-29,14
UVSTKcYeWQBZLHOAEgbXfPDdICMRJGFaN,EAAAXAAADADA.dADAMAGBGAFA.FAHFaAHB..UDBA.SDEBhAAATBCAKCBDeDGHhABAQDECZFAAOEEHhAFAABFBbDGD..fFHACEBANBIA..cGFChAAA.BHHB.hBDA...,2,-16,-10,6
NLeCUEBZbMWgFXHRAGTODfdVScIaJKQYP,GAAATAAA.DADAdACA..SAEAaAEAQBEC..PAHBhAAAeAHBECGFZCDAbDBDhACAMDDB.FEEBHEEAAECBfEHAhAAAIGGAKDHBLGFA.BHEDhAIAXGCA...hCAA...,1,-4,-6,2
XSOMLgTdKPAfRNBCIZWGFceDYUVEbQHaJ,RAAACAAAZACAGADA.eAFADADAUAGA..EBHFHCCAaCCH..SCFHhAAAMDGBLDHBhAAAdDAAADIBBEGAFECH.VFDAhABAbEED.QGAA..OHFEKGHB.hADAfGBE.hAFA...,1,0,-20,20
APBJCQXRHDcaWSGMgZfKINYdTUeOELFbV,BAAAQAAAHACAaAEAGACBZAGB.KAGC...ICFAdCAAeCCAhAAAEBHFLDFAFCDHADAACDHA.hAAARFFADEEB.SGCBhACAMEFBfEGE.TFAA.UGGBhADA.....hBIA...,2,-17,0,17
XQYUDVMFOdKNWHCSTPZacBRbJfAgIeGEL,eAAAEAAALADAQADADAHB.MAGBdCBAKCFAHCCA.SAHBhAAAZDCBaCHD.RCGFJEEBAAEAGEEAhAAAXFBA.VGFAhABAFGHBNIABCHBA...........hBFA......hBHA...,1,5,-18,23
PDSNREaLMCUYecAVBOXGgWFIQZKTbdfHJ,OAAAGAAAFADAZADBKAFAdAGAHCDA.DAIBRCEFEBBBLDHB.MDCBhAAACAHBeCGH.ABDBBEHAhBAAXEFB.gFCHhACAQGCAfHFBSGGAaGBH.hCAA......hCGA...,2,-31,-1,30
fQHLeGUbDgJSBITKNMVAROFXdCZaWcPEY,RAAAXAAAZADB..aAFD....PADAEAHBQCGDhAAAHAGBeBCHGDAADCFBSDEDhAAATEEAMEHBAAIBdDGDhABACCCC.cFGA.LGBA...hABA......hADA...,2,-17,-5,12
aWDGPIcZVYHQFTdLeOfCSbBNKUgJMRAXE,EAAAaAAAGACA..IADAZAEAHCEATAFAeBBDCAHB.BDHAhAFAKBCDUCFBMEEBAFFADAIB.hAGAVECAQFGAhBAALFABSGCBbFGBgGEAXGED.hAAA......hAFA...,2,-16,7,23
DRHSKaWTcMdGJXOPFegUCYBNEfQbVLIZA,HAAAaAAA.TAEAdADAGAFAOAGDFAHFeCAAUDBABCED.EDDBQEDChAFALEABAACARFGBKDHBhBAAMAIB.JDFBPHDAhBBACEHA..fGGA.IHEAhAAA.....hBDA...,1,7,-16,23
fUHJXCKTdaFcMLZbYAVOBeSIgWRPGEQDN,BAAAeAAA.SACA..gADARAEFEAGE.QAGAhAAAfCAAHCDCCCCAdCGAhAAAaCCHFDEHMDHB.bEAChABAAACAODHDIFFAGGDBDDIBUGCA.KGAAhAEA......hAGA...,2,-17,3,20
QFCNOMJWdYGPeILUHaTRDAgbXfVSKZEcB,XAAASAAAZACBEADABAEA..QAFACAGA.MAIBhAAAdCEAGCGAeCCALDABhABAHFFBRGAAAAAAbDCAKEDDFDGBhADA.OEHD.YHBA.IHFAhBHAaGDDDAIB....hCAA...,2,-17,-4,13
WJBEHRdYgPfXLGcOeZNCSQAVUTFMKDbaI,TAAAMAAADAEA..aACA..JAGBHAEBRBBA.dAGB...gCCBhAAAXCEDGDGAhAIAeBGHZDBFSDDDhBAAACIBFEFHbEGD.BEBA.EFFB......hBBA......hBCA...,1,4,-34,38
ENKLMWYdFRbTgGceJQAOUVDXaIBHPSfCZ,OAAADAAA..aABEHADA.SAFEZADBEAFALBHBMAIBdCCAhBAARCEF.TCFAGEFAeEDFhBBAACCAUGCAXEGAhCAABFHBCHHAKFEA.FGHH........hCBA......hCFA...,1,-3,-22,19
edJKXMVLbfSEQNcIPHFOUAaYGDBWCZTRg,GAAABAAAZACARADAeAGHdAGAKCCA..MAIBLDAB..bCEDECHFhAAAQDCB.hADAIEHAHDEBOECBhAEAAAABaDAHDGAATGDAXGEASGGA.hACA......hADA...,1,-11,-20,9
NISfRZgOKXLYDUdPTMQJEbCBVaGFeHAWc,...NAAA.fAAAZAFA.KADALBBADAFAdBGA.MCFBEBCBBCAAhAAAGCGAHCDBAAGAIDBAhABAREGBXDAA.PFCDhACATGCA.bGFAaFFHeDDBSGEDhADA......hAIA...,2,-10,-10,0
WaNBJRUbYFcCZMPSXHAKQfDVgTEOLdGIe,QAAADAAA..TACAEACAdAFAeAEEaAHBBBDARBEB.UDDAhAAAbCGB.FCHDZDDF.MBBBhAHAXEGCHFFBAAIBfFBAhBFAOCCH.GGDBNDIA.....hBAA......hCAA...,1,-6,-10,4
ObHDVBSKJFZPQYgTGXUEcNWMCdaLIfReA,HAAABAAAKACAZADBQAFA.TDAAGAEA.EAGANAIA.MBIBhAAA.aCAALDFBhAAARDCBACHB.bEGDDEABSEEFhACAFEGB.gFCDXGAAcFGDhACACCCCfHBB..hADA...,1,-6,-26,20
NOYcMTVeWZGPBUgSdIJKCfRHQXLaADbFE,FAAAEAAA.OACDMADA..eAFAGAEABBCASAGAdCEAKBHBRDFFHEBAhAAALCHB.AAEBDDEBhAGAbCBC....cFGDhBCATFFA..ZGCEgGDB.CHAA.hAHA......hBAA...,2,-29,3,32
dXgSTYVbGBMNWcPfLHRQOZAaIeECUFDKJ,eAAAEAAAFACDKADA.dAFA..SAEA..TCCAVBGBGCDAhAAAMAHB.NEAA.PDFBhAAAHFCBRFFAZEGBACFBCHHADAIBhABA.XECA.gGDG.hAEA......hAFA...,2,-15,-11,4
bYVeOdNEBCLfIXSTPQDagHUJFcGMRWAKZ,ZAAAVAAAeACE.dAFAEADELAHB..XAFBTCDAQDFDhABAaAHDHCDAFDCHMCCBhBHAADHAKEFAOEHDCEHBSFCAhAAADFGBJHCA.cGGA...WHBAhBHA......hCAA...,1,-3,-22,19
YUFEDPIbRHJMeVXdZCNLBaWSOgfTcKAGQ,GAAAQAAAFADAEAGADADA....bADAHCDA.eBHFdAHAZCBEhAAALEFAaCED.ODBDhAAATDGAAGAAPGCChACARFFBMFIBCGDABGGA..SHBG..hBCA......hBHA...,1,-3,-13,10
CFHgVZSJcafBXTMPOGRNYIedAULKQWbED,LAAAQAAAEAEAFACEHAGBZAEB..SAGAaCAABCEAMDDBhABAGCFAREAB...ICHAhAAAAAIBKDHBDEEACCDCgFGHhAHAVFFA.fEEETGDA.NIEB..hACA......hAEA...,2,-10,-10,0
OUTQPXeVAKcRDgWJEBaYFMLbZSHfNCIGd,RAAADAAA..JADAEACABAGBFAEDLAGB.ZCCAHCCA.CBHAdCFAhAAATEFAQECBhABA.eDHBAAIBKDHB.gGBAhBAAaFFAMIAASGGDfGHANBBA.hAIAOEEH...hCAA...,2,-22,-18,4
dNEJIKSgRAFUCBbaVQDeHMXPWGYLZcOTf,CAAAaAAADACAHACB.MAEA..XADAGBEAZBGBOAGBdEBAEEHFhAIAKBCD.RGBAABBBBAHB.QDDAhAAAeEED..hCAA.PCHB.LGEAfGGEJECF.hCBA......hCEA...,2,-32,3,35
PBRCgLQODdIaHJKFGTVNXfWSeZMUcbYEA,RAAALAAAQADCdAEAHAGBFAFA.GCAA.TCCAXBGAhAAASDFBeCCBZDGFMDIBhABAbCEDAEIBCEEADEHB.aGAChACAKGEA.NIAB.fGGE....hAGA......hAIA...,2,-8,-4,4
XbSMLRUVcGYIPBfANgHdZaEKWeQJOTDCF,HAAAaAAA.EADEeACHQAFCOAEACAHAXCAA..bBDDMAIBhAAALCFARCGBUDDAGEFAhBAAIGEABEHAAFIBdGGAhACAZFBAKHCAJHAA.DBBB.......hAHA......hCAA...,1,4,-6,10
BOWgTdHNDFMYXKPCbGERQceZILfJUaVAS,OAAATAAA.HADAFACA.MAFAKAFA..CAHB.EBBB.RBFA.eCCAZDCBLDHBhBAAUCGAACCA.BEEAhBIAdDFCDEEBXGEA.hAAA.bFAA...QFGAIEGA..hAFA......hCAA...,1,-5,-24,19
fQHONVdILYPKUJXGDFMZCEeaASgRWbBcT,RAAABAAA..TAEAHACAOAEAdAGALCCBKAHBUCAAGDGAMCFBhAAAECEB.AAAA..SDAAhADAbCGD.QGDAhAEAIDDAPGCADAIBCEEDaGGH..gGGAhACA...hCAA...,1,-6,-20,14
DQSeEAMROUPXCcHTBfLadIYgZWbVNFKGJ,RAAAOAAAUADA...CADAHAEBBAFALAHBdAGB..ICCAhBAAZCCAVEFAKBHD.GDEBhBBAQGCAEEDBAFFBMFHBhCAA...........hAAA......hABA...,2,-35,-16,19
YBPbgMXGfaUVLTIQRSJWDOdZEcHFKeCNA,BAAA..bAAAMACAGAEAUAGALAGB.TCAARBCASCBDhAAADAAAZDDFHEAChAEAeDEAABFAgDGAhAIA.aFHDQEGAOGBEdGGCEEDB.KFFDNIBB.hBEA......hBGA...,2,-30,19,49
DYLKPfZIRBEaTCQJMOgeWNSAdHXVFGcUb,HAAAFAAAGACAUADADAGALAEAKBFC.ZBFERCAABBHAEDFA..aDHDQDEAhAAA.MDHBhACAeEDF.SFAAhAFAADIBdGEA.XFFCcGGC.YHEGhAGA......hAIA...,2,-21,-14,7
cGbUSJONAdTMVfQKPBRFXCEZagWYDIeHL,dAAAMAAAQADABADARAEF.CAFA.ZAGB..aAGD....gBBBhAGADAIBHCACGDEAhACASCHHODGFADEBTEFAhBAAKGDBXGGA..EFEB.IGCAhBIAcDCD....hCAA...,1,-10,-36,26
cVfMEATdRPbYeQSNIgWKGaBOFZUCLXJDH,RAAA..bAAAeADE.QAGCSAEA..ICCAKAHBaCAAFCEAhAAAZCEALEBAhAAADCHBHDDAVEAAEEGBACIBdGGDPEHDhABAYFEB..gFFD.hABABHAA....hACA...,1,-1,-11,10
FcDPfURHdCaKMNVXLgOJIEAbTSGeBYQZW,TAAAeAAAQADA.ZAFBFACADAIBfAFAHCCBdDHAaEFBhAAAMAHB...XCCAhAAALFBAOCFDhAFAEGFAABHBSHEGGEGABFDA.YFFFhAIA......hBIA...,2,-22,0,22
QfgeDKXbPWETIGHBRNYSZcdMAOaUVFJLC,aAAAFAAALADA.QBGAeACHXAEA..bCCAEAHBhAEAGDFAHCEARECASEAAhAEAdEGAABBBOFABJFHBfHABhAFAKGFD.WECHBHCA.NEIA.YEEFhAHA...hAFA...,2,-12,-1,11
QFDUXgPLcIBTAfVeHKEadCJYZOMGNRSbW,eAAAHAAAEADEdAEACAGAZAFB.GCABRBCB.SAHHQCFADDHBUFEAhAAA..XECAhAAALDHBBFAAAAIBKEBAaEHDhACAOGAAbFEDFHBA.gGGGIHHA..hAFA......hBHA...,2,-18,4,22
fCYZSPaLODBeXgKHAUGQWbNVMcTEFIdRJ,GAAAQAAA..bADAMADA.EAGAdAHARBDA.CCDAZCFA.aDAHLCHBhAAABDCD.eDBBhBCAKEEAHEGBADDBUEEANHBB.cGDChBDA.FGHB........hBEA......hBIA...,2,-15,-8,7
SGVZReaDANYTLWcEPCbfIQXHUKBJFdOMg,TAAALAAA.EAEACACB.....bAGDQAEAHCAABBFAdAHAhAAAMCEBGCCAREAAeEGBhABAABGAYDHB.PEABhAEAXFDA..KEFBOHEESFDHhCAAaEHFDAIBWHDA.IHHAhCCA,1,-6,-9,3
BVPRWIbaFLYSJMXNeCGfDOcdUEKAHQgZT,HAAAZAAABADBRADF..IAGAaAEDLAGB..SAHHhAAAMAIBeCABGCEADCCBdDDAhABAECABABGB.TEGA.hACAPCCBbDEDFEHBXFACfGHAOGCChACA.KGGD....hADA...,1,-2,-14,12
MGXeIdDWUECfLSHbZOYJTAgKQNVcaFRPB,QAAAVAAA.aACERADFMAFA.GBFAeAEHdAGA.DAIBEBHBhAAALDAAHDAAZEEFODFAhAAATFCAAEEAKEFAFEHBBHHAhADAXFGA.IGBA.CHHD..hBIA......hCAA...,2,-12,0,12
KCAQXBOPJMaGSUZbVeWRgDcTdfILFYNHE,QAAAOAAA.MADAGADAZAEEeAHHRAFADBBBdCHALCDAFCCHHDFBhAFAEDBBADIBBFDA.aFHDhAGAbEEA...gGEAhAAAfHDBIHHA.KFCACHGD..hBCA......hBDA...,1,-7,-14,7
TSXAVUCNQaLGIWZdPKEJfDbMRcYOFgHeB,CAAAaAAAGACAZACB.dAEBEAEA..DAHBRAGB..OBBBHBEBeBHH.hAIATCAAACEAUDEALFFAhAAAIEHAKGCAJGCAMHFAhACA..FGGABEGD......hAIA......hBCA...,1,-11,-23,12
OPAfCSDMZEWVagQIUFbRdBcNTJeKGXLHY,SAAAZAAAEADE..aAFAQADA.FAFERBEAdCAABBHATDDAhABAeCCBGCEBhAAAHDFBOBHDADAADEEBMEHBhABAWCCD.gFEH..IGHAhACA......hAIA...,1,-12,-18,6
dSLPJfAUeYagIVXQDWKbCGHcBMEOZTFNR,eAAAaAAA...IAEAQADA.KAFAGAFAHCCAMAIBhADAEAHBZBAETDFARCDBdDHALFDAhAAAfEEEAGHAYHEAhABAXGCADBBBCHHB.OFHB.SHAGhAHA...hAIA...,2,-8,-1,7
VURALdQeXPagGfCTcNIMDFOBWKbHEZJSY,dAAAeAAAaADAGADA.CAFA.TAGA..IAHAMBDBOBEBhACAKCCDHCFAECBFZCFESDBDhAAAUEGAAFFALGAAhAGAQEFB.XFAC.fFHAhABADIAABHHA.JHCA..hAFA...,1,-5,-14,9
ARIGTBXObEPcdZKfYSVLJNagDCUeMQFHW,RAAAGAAABADB.OADAEAFA.dAHAZBEEKBFB..SBHHLCDBaDBDhAAACCCA.UEGA.eFDAhACAMDFBFHBAHEGBADDB.hBAATFAA.bGDC.......hBCA......hBDA...,2,-20,-12,8
UCEfTdVWGADIgZaPXQeKNRBFMHJbYcLOS,DAAAZAAAaACAQACA.KAEARAEFMAHB.HCFBJAHB...bDDDhABALCCA.SCFHhAGAECCBdFHAGGABhAGAABBBgEEG.eDHFBGGCFGHD.OHAAhAHA....hBAA...,2,-26,0,26
McCDVFGQgBHIfAbRNEWPJdLTeZKSXYaOU,RAAAEAAA..JADAdADALAGBeAFAZBFE.KCBA..XCCAODEBMDGBhAAADAIBGDEA.hAFAQEGCHFGBABCAbGAAhAGAPFCBSEHBaGHD......hCAA......hCBA...,2,-17,-9,8
YRZTXJBaVSdgHMPLIAOENQDfcFCbKWGeU,EAAAQAAADADA.FACEKAFAGAEAUBCAZBFEJAHB..BAGC..hAAAaDEEdDCAHDGBMDGBLECBhAAAADIBOEDDfFFEhAHACFHA..eFFD.....hAIA......hCAA...,2,-27,-16,11
AIOCfSeMZgWFREbaYKBTQcGDXNVUHPdLJ,CAAAeAAAZACA.FADDRAGB...EAFA..aCCABAHA.QCEAhAAAGCFAXDAAUDGAHFAAhABAdFAAAADAfCCEhAFA.MEEBbFDBKFHBTGGADHFA.NICB....hAAA......hAFA...,2,-24,3,27
NOCEPMAbaZQJHdIcFGSXWfLKRBUgVYTDe,ZAAAHAAAdAEAFADAGAGASAFH..fCAARBGFBAHBVCCAhAAATDDA..eCABhACACCCDEEBBADIBQEFChCCA.IGHAXDFD.LGAAhABA.KFHB....hACA...,2,-17,-6,11
YOPDdFLgACMHbeIcXRfEZNaSBQKTWJUGV,HAAAeAAA.XADBEADAZAFB...aAFDQCCATCCA.UEFAhAAAGBGAOAHDdEEALFBBhAAAABFBMEIB.bEFDIHBAhABAfCAEBHDAWFDDYHFADAIBCHAC.hACA......hAHA...,1,5,-9,14
LcOaKTeZJCHdMgENFWfGUPDRVBSIQAbXY,XAAALAAAaADDKADA.ZAEBHAFB.dBHAEAGAFCDBGCAA.DBIBhABARDABSDFDhAAAACAB.bEGBOCFD.hABAeCCBMEEBgEGHfHABPEEBhACA.BGHA.IHCAhCHA.,1,-6,-14,8
DESbPAecTIRZYNOVFfCBKGQMHLUWJgXda,eAAATAAARADAZAGB..OACAFCCBBCFCGAFAHEAALAHBhAAA.UCCAgDEGhAAAaDBBEEFBSEHBhBDAABIB.IFDAVFGBKDHBMFHBXGAAhABAbFBD......hAEA...,2,-12,8,20
FNJQVEAgGHPDTcdfMLBCYbOUZIaXKReWS,HAAATAAAdADA.MAFALACBBBFACBHAOAEA.ZBDBaCACRBFAeDFAhAAAFDDA..QDGAhAAAAAIBGFDBDEIB.fHFFhCAAbFBAXFFC.SGHHhACA.JHBA....hBFA...,2,-12,-4,8
XgKEaDZPQVeCbLFcIHYNdRWMSJTOUfBAG,GAAAKAAAEACE.ZADA.QCDAeAEELAHBFAGAHCFCdCCARBEBMDCBhAAASEDHOEABBEFAhACAACGA.aEHDDEHBCGGD.bFFDhAAA............hCAA......hCBA...,1,-4,-23,19
WCcEYQJIUBHadNZSVKAfPMLGOgDeXbTFR,MAAAGAAADAEAeADA...TAGARAFACBBA.ECDAQBDChAIAUCGBHDEBdCHAZEAAKDCDAAABLFHBhACAODFB..bGDAhBAAFGGB...........hBBA......hCAA...,2,-32,8,40
SFZARQMNVLaCGKHgYUBcfIdXeETJODbPW,RAAAMAAALADBGACBHAFAUAGABCCC..ICCAeCEHECGAOCEChAFADDIB..bEGDSDGAhBAAZFAA.ABBBQEEChBIAaFFBKHAA.gGGA.hAAA......hABA...,1,-10,-13,3
ARaYWJcDTZBNCKfLGFEeSdQVIOXbgHMPU,RAAAaAAA..JADADADAZAGBBAFA..KCCAGAGA.EBBBeCEHdBDA.hAIAQEGAOCED.hBAA.XEFDHECBMFFBhAAAADIB...cGAATGDACGGD.FGHD..hBIA......hCAA...,1,-20,-24,4
AegfVWYZXdIDPRbLGaUOJTESBNHFMcCKQ,eAAAVAAA.ZADB.dAGADADARCEF.GAEB.OCDBEBCFBCHA.HEFBhAAAMCFBKEHBAAHA...hAAAfFBAXCGAbEFDhCAAaHEC...JEHF.SECDcGBDCHHA.hABAWHCG....hCEA...,1,-7,-24,17
AZfaPUdeHMRIEcKSFDOXYTNJLgVWbQCBG,aAAAdAAAHADA.RAGFECBASACH.OAEATCEALBEAhAIAVEFA.QDDAhBAAGFABAAFAZDAAfCHAhBBA.eDGDMIAAKFBADGIBXGGA.hACANIBB......hADA...,2,-2,-1,1
CPSYILDAUWeTcdKZaBMVNRFbGQfEgHJXO,eAAAdAAAaADAMAEA.RBCA.GAFA.EAHBHBFB.OAHDSBDBhACALDBAACCATEEAhAIAZEFABFBAFDHBQGGAhBAAfGGAJHBACDDDPFDB....hBCA......hDAA...,1,-8,-11,3
GgOUaAQBMPDZEdCJbVIcKRHYWFfXSLeNT,MAAAZAAAEADEdAEA..CAFB.JAGB....bAGDVBBB..KCAAHDEAhAGAFCEB.SBHHhAIAeDDDGGEBOEBBAAIBBFFChABADEDBRFGB..fGCA...hBAA......hBBA...,2,-20,-20,0
ceaUCXNGKDTdfFHIPZLYgWJVEROBSMbAQ,eAAAaAAA.CADA.GACADAFA.dAEBHBDCZAGBLCFD..gBGBhAAAVFBARFGBSBBDhBAAAAIBQDDCXGEDhBFATEGA.FFFH.IGDAWBHH.OCCHhABA.MIEA.hCAA...,1,-8,-9,1
AfFYHbISOWNEKJRGadCXTLVQUMBPZDcge,FAAAHAAA.SACEOACDEAEARAEFdAGA.CCCALDEAQAGAMAIBhAAAZCDBDCGB.eDGHhAEAAEIBbFFB..IGHAhBAAKGDA.aFDE.........hCAA......hCCA...,2,-20,-15,5
OJdBKAeCfUbRFGHYZLcaSVETIgDNMPQXW,eAAACAAAUACARADAHAGB.ZCCAaAEE..EDGB..TBGADDIBMEAAhAAAQCEDOEEBdFCAhABAAAHAFCBHLGFA.hAAASGABgEFA.XFAA.hAEABFHA....hAFA...,1,5,-35,40
WBIaTFPMJXDOHRVecEfGKALQgNYdUCbSZ,LAAAQAAA..NAEA.dADA.CAFAZAGBBAFA.aAGDTDBA.hABAMBIBDAIBHCAA.hAAARDEFeDGHEDDEGEFAhAFAACCAgFAAbFCDSFHBFFHDXFCD.hBCA......hBDA...,2,-7,-7,0
MaTGXICYOWcLKBEDgNZARUHSVFbPfJdeQ,HAAAFAAA...bADBfADA.eAEHaAFDGBGA.hADACAHBOCABLAGBECCBhAAADAIBZEEBRDDASDHHhBAAVFBAdGGAMEIBTFFA.XGBA.hACAIHEA.WCCDhBGA.BHHA,1,6,-12,18
YFUHfbSGgEQNVKaPORdCWXeLAIDJZBcMT,DAAAZAAAMACAFACDHAEA..SAEAEBHFQCDDKAHB.aBBHRCCAdCFAhABA.CCHD.eCGDAEEBBEGAhAHATEAAUGGAGGABhAEA.gEEG.PFHDOFFHhCAA......hCBA...,1,12,-27,39
WQEITaOdDXFMPfCKALGUcJegYbZNBHSRV,GAAAUAAAeADA..bADAZAGBHBGBRCBA.QCDAEBFF.aAHFhAAAdEAAFDCHMBIB.CECAAADAhBAALFAB.gEGAhACABEEASEGBIGEATGFAhBCADADAfGHA.hCEA...,1,12,-22,34
JfBISUWRHYZLDbVKeFQGgTAENCcPaOdMX,EAAACAAA..aACAdADA.MAFA..XAEDBBCCSBEHhAAARAGBHBCBZDFALBGBDCBBbEEC.hAAAeDDBGGABABIBPEHDhCAAfGGAUGDB..WFFB....hCBA......hCGA...,2,-20,-3,17
UVaJfCDOHKXBSgIAENFYWZQGeTLRcPbdM,EAAAFAAAZACBGACALAFARAEA....bCEAdCEA.MCGBUEAAaCHBhAGACAHBHEEABEBA.SEHHhAAAADIB.WGEGhAEAeEDB.TFGA.PHAAfGCAhAFAOFFH.....hBCA...,1,-10,-15,5
GdfYQZPJNcAFHEBUCXWODLgTSKeaVbMRI,HAAAEAAABACAXADBDAEA.LAGB.TCCAeAFAbBDDREEAdEHAhAAA.QFBAhACAZBFEJDGBACCA.CBFA...OEHDhAAAKGGDMAIBGGDB.......hBFA......hCAA...,1,2,-23,25
WLXBNMKJTEGPZOYUbDARfQcIdFgHCVSae,RAAAQAAAdADAHAFACCCDaACE..LCFABAFAMAHBKDED..EEGAZCDAhAAA.OCHDUFAAAAAAfDAAhADAFFFH.SECAhAFA.eFEANIAB.TGCA.hAFA......hAHA...,2,-21,-7,14
EIVMdWAFUPfOGSNDZbXHgRTQcCYLKJBea,FAAAUAAAOACDGADA.DAFAZAEAHBFBRCDF.QDAACAHB.LBHBhADABCFBECHFMDDBhAIAAAFA.SEFDhBAA.bGFATFEAKHCA.eEHF.aGHD..hBAA......hCAA...,2,-35,7,42
EYRdUNOICXGKSVBTMAQHbDaLeZWfFgPJc,HAAAaAAAZACBFADA.JAGBEAEA..RCAA.dAHAUDFBOBBB..CCECGGABhAAASBFH.TDGAhBAAAAIBQFGBhACALCEDeEEDfFGE.PHBANIDB.hAGA......hCAA...,2,-10,-8,2
BAWcFHLYKENQaUJbPOgeXVRDGTMdCZfIS,FAAAHAAALADAEADEaAFA.UCCA..bBDAOAGD..eAHHhAAARDFBGEAAdCADZDDASCHHhAEAADIB..cFDAhACAKFCCJFHBXGGADFFB.CEHD....hAFA......hAIA...,2,-20,3,23
TKSRJZYWQVLAONBUCFgEeHDfbPMGIXdca,BAAAFAAAEADAHACA.DAEA....bAFAGAGAdCCA.aCAATCFAhADARCEBZECBQFGAhAAALEEAAAGAOEHDCGBC.hACAeFCBMIAA.cGFCSGGD..hBAA......hCAA...,1,-7,-20,13
GaQOLfgYZHcSRVMKbFTAPUXWedBIEDNCJ,XAAAeAAAdAEAEAGADADA....CAFAGAGAaBCDLCGB..hAAAfBDAZDEBHEBARGAEhABAMCFBbGEAABIBUEGB.hAGABDBANDIA.QGDA....hAAA......hABA...,2,-30,9,39
ZSKdNYJDTeHMULOGfWRgIVPFCBcEAXbQa,QAAAZAAAdAEA.JACEeAGB.HCAAMAGBLDEBGCDARCGFgDGAhABA.IGCAhACAFAHFBDCCAAHAaEBEhADAKFBADBFBUGGAfFFA.WEHH.hBEACHGD......hBIA...,2,-17,-6,11
aTZVANCORGcUQWPfeXHISLbdKEMFDBJYg,OAAARAAAGADAUAEAQAFA..fAGFHDAALBHBhAAAdBBDEBHFMDFB.BCCDhABAgDDAZFAAAEGBCFHAPHDChADAeDGBSEBB.bFFDDIAAaFHDhBAA......hBEA...,2,-21,10,31
bdTRBICgULGfVWPEcSQYOaZMHDNXeAFKJ,KAAAdAAARADACACB.LAGBGADA....VAFAECBAQCEAhACA.aCHDHDEB.XCGAhAAAAADAbEEC.TFAAhAFABFHAgGGGfCCEcEGA.hAIASGGB.hBAA...,1,-13,-17,4
AJgXSNTEaRcdWPbMHfLBYIZGKCOeFUDQV,XAAATAAA.RADA.dACA....bAGBHAEA.LAHBhAAABCDDZCEBGCDAOCHDeCGDhAEADDAAAAAASEHHhAGAEEAAaDGH.PFFBMIBAfGGAKHCACHHA.hCAA......hCHA...,2,-13,-2,11
PCFSBWeNHOJdgALZDKEMRVGUaIcXQYbTf,ZAAAEAAARACAGAEA.aACAXAFB.QCCBbAGB.TCGAhAAACCCDBDGD.eDEDhABAHCEBdFHAAAIBLDABhADAMBIBIGBAfEHASGFHOFGH.hBGADHBA.....hCAA...,2,-18,8,26
JbgfYNdKVBFcQaPIZEULWSXMARCTGDHeO,RAAAGAAAHADBeAFAOADA..JBHB..bAGD..fCCEhAAAdCDABBFAQEBDhAAAaCFDZDAFEEEBLFHBhABAXEFAAAIBTGFADEIBgFEGKFDDFGAH.IHHAhACA....hBAA...,1,18,-20,38
JcMQOLUYgZVbHPGRANfCBDWedITSKFXaE,CAAADAAAdACA..TACAFAEA..EAHBMAEALCBAUBFAZCDB.HEGBhAIARCEFACGABDGAeBBBKBHBhBAA.aFEDQEBAhAAA.ODHD.gGFA.hCAA......hDAA...,2,-24,-17,7
CQIgUTaMcDAePNFfGWYHZLSEbJOBXVRKd,eAAAFAAAGACAHADAZAGBEAEA.OCCBBAGARCEAdDEA.QEGAhAAAUEAA.aFABMAIB.AEEB.hAEAfFCALEGBbFCDhBAAXGAD.CGEAgGGGDFFB.hCAA......hCBA...,1,9,-15,24
QBMgKEJSRGcPYaHbCeTWXFfAVUNDOdIZL,UAAAOAAAZADALAEABAGB.MAIBEBHF.RBBAGCEA..PCDBhAEAHDGBeDDD.hAFATFAAFCFHADIBDECBdGGDQGCDhAFAKEGA..SFFDhAIA.aGGA.CHHD...hBAA...,2,-36,15,51
RUWBOCdPIeLVSMQcNFafYKAEZbDXGTJHg,EAAAZAAADACAGACAHAEARAEABAHBdAHA..eCCBLCGBMCEBQCFDhABAFCBHaDFB.KEGDAAEATGEAhAAAUGAA.CEDA.IGHAhAGASGGBNIDB.......hCAA......hCBA...,2,-14,-10,4
EMWHbTLdDJOfXYaIgCeKPNSQRAcBGUZVF,GAAAZAAAEADEHAFBLADAdBHADCAAOAGD.XCDAaCDD.CDCDKDGDhAAASDFD.hACAAAHABEGBFEAHbFFATFAAhABAfHFB.gECAeEHH.NAIA.hAEA......hAFA...,1,-10,-15,5
PNWYKAUgCTHeSQfbIBOaEGJDdRLFVXZcM,CAAAHAAA.eACEQACA..bAFBOAECEAHFGCCAdAHARCAALCFBhAAAXEFAZGEAhAAAMDEBNCIA.KDHBACCB.TFGAhACASCFDBGAAaFDH......hAGA......hCAA...,2,-17,8,25
DVBGZCFMKOfJbTNWcAULYEaQdHgeISXRP,LAAAEAAAdADAHAFAeADH..XCBCRAFADCAAGCEAZCEEMCIBOCGFhABAJEFB...bFAATFAAhAAA..cGFBhACAAAHAaEHHQFCC.IHHAhAFA......hBCA...,2,-15,-2,13
GbVUFcDHWXfPCSMKZgLeYARIaJENQdOTB,RAAAaAAAEADE..dADABAFBGAFAUCCADAIBHAGB..XCCChAFACCFDKDHB.ZDGBLEFBhAAAAAHBJDEB.OHFE..hABAbFBB.FGFH...WEHH....hBAA......hBBA...,2,-26,-20,6
MeULDGWTbYFHBKfcdJCQZXVNaRgSEAIOP,OAAAeAAALAEAGADA...TBCAbAFAHCFAKBHBdCFA.QEDChAAAZDBBXEFAhAFAaDHHRFABEFEBAAFA.MBBBDFGBFHGEhABAfGAE.CGGDNEIA.SHCAhAGA.....hAIA...,1,17,-9,26
FVRMAWEBgPeabIdTNcSCUYKHDfJXLQZGO,EAAABAAA.eACAaACDdAEA..TAFA.SAHBCAGAKBHBHCEChAAADCAAXCBCZCAEGCEAhAAAFEBDREEBACEB..gDGBhACAbEGD.IGGAcGAC...fHCBhADA..hCHA...,1,-8,-26,18
SJIPGCXTBYdDRcUfbMNEHLZVOgQeaWAKF,SAAAJAAAGADA.CADA.BAFA..dAFARAGFUDAAMAHBHCCA.hADAZDAFOCHDeCHHAAAAFDFBhAFAXECADDDB.bFEDhADAEFGB.LHFAQGGA.KGDD..hAIA......hBFA...,1,-3,-22,19
EBRVDJQeTWFbaYLGNCgMOUSdAPZKHfcIX,ZAAAHAAA..IAEAEADERAFFDAIB..eAFHTCCAFAHB..aCAAGCGAhAAA.CCADMDFBhACASCEDAECBKFAAXGFDhAFABCHAQDAC.bDFDLHAAhAHAODDHdFHA.fHEBhABA.,2,-23,5,28
dDYGWeJCSfALTaXPHgEKBQZMNIRbUcFOV,aAAAHAAA.EADEQADAZAFBMAIB.RAFAUDAAOCABdCCAGCCA.hADAeCGHSCGAhAGAACCBTFAAXDFCKEHBBFEAhAAAbEDDFGGBDEIBJHBELFGB.NIAB...hAIA......hBAA...,2,-4,14,18
OQDPaYKGNgRWITSLAUcdXZHCBFEMbefJV,dAAAHAAAFADAEADE.eAFEJAGB...QBFDDAIB.aCACGCABhACARCCFTEEAACFBUEEAZEGBMFIBhAAA..VGAAhAGA...ODGDKGDANIAB.....IHHAhBAA...hACA...,2,-32,7,39
CDNSTQRAWcaZgXJVIGYebfPBEKFLOMdUH,aAAAZAAAJADAGACA..eAGH..bAEABCAAFCED.MAIBHDFBDCCBhABATEAA.AAEA..hACA.gDDAhAGAXGAAIDHA.fFHAEDGFLFCAhCAA.dFHA.CGGCNIEBSBBDhAGA,1,0,-27,27
MbRISaGVecOTFNAEJQCHgfdBKYWZDPULX,EAAAQAAAHACAdAFAKACAZAGBDAEALDDB.MBIBRAFAaCDAeCCDhAAAOCGDFEAB..AEHBCFFABDDAhAAA...PEFBhAIAbGEA.SEHH...cGDChCAA.....hAEA...,1,-8,-25,17
eUaNFKICODLYQSEcGBdTWfMgXJPVHbZRA,eAAAaAAA.KADAOACDLAFB..QAEAEAHBGCCAdAHATEFAhAAAMBBBJCEF.HDGBhAEA.RGBAABGAFCHHDGEASFCDhABABGHA.fFEE..hAIA......hCAA...,2,-21,-13,8
QHFPLAOVJBSdDUXRNbZWGIfeEaTcCgMYK,OAAABAAAdACADAEARAEAZCBAGAGA..eAHHEBBB....aBDATDFAhAAACCED..MDDBhAIAQEAAHEEALGBAhBAAAAEASDHHXGGAbECD....fFFEhAHA..hBCA...,1,-10,-29,19
ZPdMfWIFHBaSCcADLQRYgNOeUEGKVJbXT,LAAARAAA..gADBeADHEAFAGBGAKAFC.JCABbBGDZCEBhABA.dEDC..MAIBhAAAfFAAFCCBHDEBaEHDhACACEDCACGBQGEAOFHB......hAFA......hAIA...,1,-3,-15,12
JFCGEHQKgNAWZaVOeBdRScPXMfIDLUTbY,aAAAeAAABADARADA..SAGB..XAEDMAIBDCCBTAGAhADAJCFB.GCCAhAGAHDCBQEGAhAAAKBBDACIBZEFAdGEAfEAAIGGA.LHDA.hAIA......hBAA...,2,-24,-5,19
KJcMRTCPNFVbXZLfIdBAagQDHeOSGEWYU,aAAAQAAAHACBeAEAGACB.EAGEUCFAKCDD.MAIBRCEF.TEAAhAEACCGBFDAA...bEDCZEFBhAAALFHBdFAAACIBOEHDhADASBBD.YHBA...hAFA......hAIA...,1,7,-8,15
GLIEceDHKbVMJXOfgYRSWATFNBZaPCQUd,TAAABAAAaACA..QACCGAEAEAGAeAEEHBCBKBEA.MAIBhAAAOBHD..fCGAhAHARDFFABCBZFGBCGAAdHCBLDDBhCAADEEB.bFED.XGGA.SEHFhDAA...hAAA...,1,5,-13,18
IHCMZdNgTLBbJGcfKWFaERSQXeVDYAUPO,OAAAHAAAZADBdAEATAFALAGB.BBBDGCEAKCDD.aAHDRDBB.QCABhAAA.eDGHhACADAIBABDAIGDAhADAMDIB.NDIAJHAAfEEAEHGE.XFGDhBAA.UGBB.CGEA..hAHA...,2,-20,10,30
ZBMJLcbRaCHFQDXdAEUOKeYWVSGgIfTPN,EAAAKAAAeACE..VACAGAFA..fAFBTBCAZDEFMAIBhAAALAHBRCDA.HEGDhAAAQDGDdFAAAEEBOHBChAFASCCD.gFEB.hBHAIGCA.BHAAhAHA..,2,-10,-6,4
MRQVJDZbfXAUPcEYdKTaWHNCFeSOILGgB,UAAAEAAAdADAKADA..aAFAHAFB.FAHFeAHH.OBCHGCBBMBFBhAAARDFAQECBhADA.DFABbCFDAFFB.cEDChBDATGGA..CDHASFHH.gGBAhBGABFHB..hCAA...,1,-12,-22,10
VfHSFRLWKYOQgJCBGceUZDMXTbadNAIEP,EAAAVAAAHACA.RAFFLAHBKADC.QCCBCAFAGAGAeCDBhAAAZDFAMEAB..bDEDdFFAhAAAAAIB.fHCBhAEA.FHGEODHD.BECADEEB.aGDC.IHGAhCAAWFAH...hAFA...,1,3,-21,24
WOXNREVUJAMHBPIDYgLTCGcfZdKbQSFae,HAAABAAADACALADBGADBZAFA.dCADQCBAaCED.eAHHhAAAXCGCRCFB.EEGAUFFBhAGAAAGAMFFB.IGGAhAAAgECA.CHAA.KHCASGHHhAHA......hBCA...,1,-7,-23,16
OcAGLCWdBPgeaXFIVZNbfKUHYTMDREJQS,GAAALAAAdADABAEAeAFAaAFDFBHD.ZCDE....bAGDKEEAHCAAhABAMEHBECEB.QEABhACAODBDAAABCFADgEEAhAEA.XGGAIGEAfEHAhAIAYFCBDEIBSHEGhBIA.,2,-20,-10,10
efSLaDcGHKNTFMJQYIWOXgPCUVEBAbdRZ,RAAAeAAALADBDAEAHAFCKAFA.FBCD..MAIBQCEA..hAAAICFAXCGACCCCEDGFhAAAABEBZEEA.aFHDGEEAhABAJHEA.OEHD.gFAA.hABA......hAIA...,2,-17,-15,2
IHXGQUYEBKgSMZbDeLdfJNaWRcFTACPVO,CAAAOAAAHACAGAFAUAEABAGAKAHB..MCABZBCBDAIBLDDB.hBAAdDHAJCGB..aCCHREDBFBBHhCAAADFB..VFABQGGAhDAAEFFB..SHEG..hAAA......hACA...,1,-7,-32,25
WIHEDAGRNMeJVQOKXdUPZbaSFBgYcLfTC,RAAAeAAAQADCKADAdAFAZAGB..aAFABCCA....gBGAhAAALDEBTECAhAAACCCDHCEBADIBGGEBMEDBOEGDhABAPDHD.FGBB.fGFE.hABA......hBIA...,1,-3,-24,21
LZRXeaPcdEfSgJHNKCGQYDMBWAUTFbVOI,TAAAFAAAOACD.ZAEARACFeAEE.aAHDdCEA.ECGB..SBEHhAAAHEFACAHBGFABhAFAQDFAMICAAEDBbECB.hAGALEHB.XCACfGHANIDBDFFBhACA.BGGC...hBAA...,1,8,-19,27
FVZYHRQbgEdaGXDMJSKIcTeUWCNfBALPO,LAAAFAAAZACBHAEARADFQAFCEBHF.GCAAMCEBKCFB..hAGATCGAeDHFCFEABAHBhABAAAHAOFHDbDDCdFFAaGFDDEIBhACA.SFDH.IHHA.hBAA......hCAA...,1,5,-20,25
dGDPCYQJgFAEWKBfVOZcUaXReHISLbMNT,EAAABAAA.OACAZACBaAEDRAFA..HBCALAGBMCBB.dCBCGCGAhAAACDEAQEFAFDEBACIBKFFBVGBAhAAAUGAA..eFHHhAIASFHH.TGDADBIB....hAGA......hAIA...,1,-7,-9,2
AfXWNcBULTOEVPSMgKbIYCDHedQFGZJRa,XAAA..cAAALADA.EAHBSACBMCDAKCGA.hAAAbADDCDDAHEAA.eEFAhABAdAFAGBGARFDBAAEAfGGAhAIABAHBTEEA.OEHD.gFBAhBAADFIB.ZGEAhBFA...,1,3,-17,20
MdENIVcBCfAbKTPULWHYJGDFgRSaZQeOX,TAAALAAA.HADBGACAFAFARCAAZAEAeAHHMAFA.dCFAECFFVEDBhAAACDHA..ACAA.KCADUEEBhABAJCHB.SFBAhACA.aFGDQGFA.NIBBBHHB.hBFA......hEAA...,1,1,-9,10
QPadYMHJDSgEeRAXcKGFVObBLUfTZNCIW,KAAAGAAAOACALADA.TBGAZAFBCAHA.QCDAdBDDHCGBSCCDhAAAEDCBAAABFDGHbFABhACABDDB.UFEAfFDAhAEA.IGGAaGGAMICADDIB..hAFA......hAHA...,2,-21,-3,18
FHCdUaAgMcKQOWfRTDGSYIPXZeLENBbJV,MAAAQAAA.OACCRACAGAFA.SAHBIAGAZBFEhAAAEBBBBCEDVDCAHDGBhAEAdDHAADDBKEEATFAADFAAXGGAhAFAeFFBNIAB.FHBAaGDC....WHEGhBAA......hBHA...,2,-19,11,30
BJbHMeCIdWLcERKGUSPZAYTgQONFfVXaD,TAAAQAAA.FACEXACBBAFAHAGBeAEAdCDALBHBhAAARDFBGFABSCCAhAFAAAIB.OCEDfFHAhAAAaCGBbFGBMFFBCHDA........hAFA......hCAA...,1,-3,-14,11
NQGecLZSVWPJBHdMKgIOATUfCREDFaXYb,TAAACAAARACA..EAFEaACA....XBGAbAED..GAGAhAAAeCABZCCASCCBhAGAVDGB.PDBBHECAdGGDhAAAMDIBKGDAOEEBAAHA.DFGB.FGBD.YFHFhAIA...hACA...,1,8,-12,20
DRNOXSBCTefAVYgLZbdEIUGKPQHFMcJWa,VAAALAAA.dAEAEADEGAGA.QCAAHAFBMAIBJCDFaCDBhAAARDFB.ODFBBFDDeEHHhABAAAHBZEGBUFAAFGAADFFBSEDHhAFA.fHDB..hCAA......hDAA...,1,-9,-11,2
eUgbdSEDPLMHBXIaNGFcTQJfROCKWAZVY,ZAAAeAAAUAEAdAEAEAGALAHB.HCAAXBCD..aDEAGCFAhAAATEBAQEBAhABAREEBKEGA.ABIBgFDBhAGAbGBADGHB.MDIBBBGBFGHH.fHCBhBEA.CHFA...hCAA...,2,-6,-5,1
ZGBEdATRVXUQMaKLeFCcJfINgbSWDPYHO,RAAAXAAAMADA.LADAeAFA..CBDA.JAHB....fBHAhAAAgCDAbCCADCGBhAAA.HEAAGDFAEDHFAAEAhABATGCAQFEAaEEHFFHDIHAANIEB.hABASGGB.hCAA...,2,-11,-6,5
cUIfeBdYQWHaSGbZJgMLTEONFAVXCPDRK,CAAARAAAKADCUACA..eAFAdAFA...QCCAHBGBGDDAZBFEMDGBhAAAECBBFEBHADHA..XEDAhABADAIB..fFGAhAAABEHAaGAASGHBJHAA.LHEAhAGAOFHD....hCAA...,2,-17,-14,3
SQgVHLIRTXOBZPWKGfcEUdeCbMAaFNJDY,aAAAFAAADADA..QADAHAECRBCB.TAFABAHBZCEF.KCGAGCCAhADA.EBBBeEEDhBAAbCFAAAHAJEHB..SEFAhBAA.LGEAOHEE.fHCBhBIA....hCAA...,1,-10,-31,21
CBIZgOWabUSfeTcNYVPEFdXLMQGKHJRDA,BAAAZAAAOACAaACA.UAGAeAEH...TAGA..cBDDhABAVCBB..FCGHdDFAMCIBhAAAGEGAHEEARGBAACCBCBCBIGAAhAGA.gGGASEEDfFDEhAIAYHDG..hCAA...,1,-15,-20,5
PCSedLDcIQUZaFBWHGKgVJOXTRANYbMfE,...bAAAEAAA.SACAeAEAdBHALCABDAFAQBEAZCCAaCEAhAAABAHAHEECGCCAhAAAKFHBJHCATEFAAAEA.MCIBhADACHHD.IGHA.FFEH.WHCG.hABA......hACA...,2,-7,-6,1
OCcLQSNbKgIGPUJWDTfFaREMYBVdZAeHX,HAAACAAALACAQADC.SAFBKAGAGCCAUCABDCFAFCHDhAAAEAHBMCFBBDAAZEFAACHBeDDBhAAA.ODGB.hADAbFGDgGAA.IGEA.hACA......hAIA...,1,-1,-31,30
SJBVDACadbYLZEXPIfUFHKRQWMOTNegGc,dAAALAAAEADA.XADD..fAFAHAFARCAAMCHBTBGAhACAeDEBGCBA.hABASDADBDFBAAHAbFAAhACAZDDBIGGAKDFAQFFANCIA.JHAADFAAhAFAaEHD.....hCAA...,1,1,-6,7
SFBNdefJGDgEWAKQMUObaLHRcXICVZYPT,MAAAOAAALAEAHADARAGF...XBBACBBDZCDA..TEEAhAFABBHAeCDHGEGAECFBACIBQFCChAGAaDGDVFAASEFDhAFANIAB.dGHA.DDIB....hAGA......hAIA...,2,-11,0,11
JDaIXHKgLRGQWBMPbNfYZFEScTdAUOeCV,eAAACAAADACA...aADDHADCLAFARAGFGCBAQCEABDDBMCIBhAAA..bCGD.fCCEhAAAZDFFEFEB.TGAAhABAACBBOGACIGDAKGHB.gFFGhAGANIAB.SDBDhAHA...,2,-13,-11,2
ANHdfSMVFPQIYcBTEOeDaLXJZWKUCbRgG,HAAAdAAAMADAFADAQAGA..IAHABCADECCAeBDAhACAaCEDLDGBZCCAKCGACDBDREBAhBAAADIBSEDDhAAA.PGACTEGAXGEDUGEA...hBCA......hBDA...,1,-3,-21,18
HcYdMJBTbLOUDKfNEegVQXGRZICAWFPSa,FAAAaAAAHACBdADABAFALAEA.DAIBKAHBECEAeCCB..QCGDhAFARCEAZEEA.ABBBSEEBhAGAMDBB.bEGDhBAAfFCE.VGEA...IHAAhAFA.CHCD..hCAA...,2,-25,-17,8
AVNMcDEHZSTRGBPLIXQFfJOUaWgKCeYdb,MAAAEAAAHACAZABERAEFGAFA.LAHBQAGCFCCHODFHhAAAaCCBKCHB.eEABdDDAADGBcECDhAEASEGH.BFEAhAIAXEGD.fHBFWFHH.CHHA.hAFA......hBHA...,2,-20,2,22
OTdFJBUWDcaAEHIbVKSNeLXCGRZQfPMYg,HAAAVAAA.SACELADBGAFARAEFZAGBQCCCMAIB.OCHDhAAAdEEABDCDDEEAAFFAEDHBhAAAKFGAeFAACGAA.fFHEhAFAgGCATGFA.FHAA...hAGA......hBIA...,2,-11,5,16
ASDgEaXbNJdeVPBYIGKUFCHQMRcfLZWOT,DAAAEAAA...aABEXACA..bADDdAFA.eAHBBAFAGCCAhAAAFAHBHCFBRCGBLDABhADAZFAATFGAACCBSEFBhAIAJEEF.PFHDKCHBCCCCMIFAcFDD.OFBDhBFA....hCAA...,2,-14,2,16
AMbdUfXeGCVTaJKWRPBFLSQNgcZYDIEOH,dAAAXAAAeADAGAGA..TADAaCAEKCEARAFFFBHD.LDAAhAAAQDCD.gEADhACAZDFADEEBEFAAHFEAhADAAAHAbFFBCEHA..........hABA......hADA...,1,-6,-15,9
KAaWSPELbeDfFJCIGOdXRUgNVQHcZMYTB,aAAASAAALADAeACHFAHB...CAEAGAFAdCCARCFBUFAA..hAEAgDDAQEDAhAFAHDGBMBBBTEAAhAAAACIBEEHFDGGBfAHE.OFFB.NIAB.hABA......hAEA...,2,-11,-9,2
NePTKWZAMHDSRcGbUVaJELYBIFQXfdgCO,HAAARAAAGADAVAEAEAFALAHB.BCADQBGAdCCA.OCCBhAAAeDFBTEAAhAAAZDAFADFAMEFASEDHhACAUFFAaFAHIEHA.fGHANIAB.hABAKHCADFIB....hADA...,1,3,-4,7
cMYBRaNXZSQPWGOgKFdefTHVLEbAICUJD,CAAADAAA.MADARACA..aAFAZAEE...QBBAGBEBKCAAeAHHhBAAHDDAECEAAACAUFDB.hBBA.JDFBBEHASDHHhCAAOHDCdGGBTGGA......hCDA......hDAA...,2,-22,-22,0
ECGVASLUKJRFZTdbMaBWefIHcXPNgYOQD,LAAAKAAARACFZAEB.dAEA.aAGAeAGF.HCABXBFD..gCGHhAAAQCAAEECAhACAGDCAAAIB.SCHBhABAFEFHMEIBfHFBIEGAPFEDhACA.OHBC.CGGA.hBEA...,2,-15,-8,7
SZHJNYGbdfMIDTPQaeAWRFCVgBOXKUEcL,RAAACAAABACAKADC..EAFALAEA.HCAAJAHBGCCAdCEA.MCFBhAAATCGA.aEDCACCBFDHDhABA..OEGBhAAAXEFDSEHHZGCA.bFABDGIBeGCA.hCAA......hCEA...,2,-22,-10,12
aLJReVGHbEBQPFNUYSfgOIdXCMZDcAWKT,TAAAaAAALADA.RAGF.eACEHCCAEAFEQDFDFBDHUCFASAHBhAAAOBBBdEADMCIBhAEAZEEAACCBKFDDGFCBBGGDhCAAYGFG..fHDF.hAFA......hAIA...,2,-13,5,18
aFPUGVeNbWXfRBJYLQOTCSgEKDdHAZMIc,ZAAAMAAAaACAFADD.GAFAeAEH......bAFDfAHEhAFABAHALCHBTCBASCCDhABAEDEBdDHAHFBAhAIAAEEAIFFAPFGB.NHAB......WHEAhAHA.....hBAA...,2,-16,-10,6
TDXecSWEPGKOUJLHVABZMICbQYaNRdgFf,ZAAAMAAACADB...QADAaAED.RAFAdBBAFAGADBGB..eCFAhAGASCAAEDCAGEEAhAIAOCGDLEHB.hABAAEEBBHGDbDDB..gFEH.fGHAhACA..hCAA...,2,-45,-5,40
dRJGgVeWDEQUfXcFNaLOCHSbZTMKPYAIB,dAAARAAAGADAeADAEAGAQAFA.UDAAXBGA.FCBDaBHDhAAALDDAHDEBZEGBMDABhACAKGDAADDBBDHD.gFCAhADADFIBfHBBOFFA.SGGAhAEA....hBAA...,2,-16,-1,15
QEVgZFcTCRDLBOaXKWAUMISfPHeJYNdbG,MAAASAAAHACCeAFE..NADAGAEAEBBBZCEBFCGD.TDCAhAIARAGBLEAB.aDFDhAAAKEHBAAIBUGGAfFGEhBAAPEDDdGBA.........hABA......hAEA...,1,1,-18,19
NKYFVRaBbCJEgTHfWSUPeAGMdLXQcDOZI,dAAALAAAQADAOADDZABBKAFAFAFERCAA.BBHA..CAHBECFAHCEChAIA.SDCHhBAAUEEAACAAGDGAMDIBDEEB.hABAIFFAVFAAaGHDJHEA......hCDA......hDAA...,2,-15,-11,4
VXTZQJSUHMCEWNDFaRfBdePbgcKOALYGI,GAAAXAAAZADA.QCDASADAHBGBEAGA.DAEARCDAdCGAeDCBhAAA....bDABKEFAhACAAAAALECAIGGAJHAAhAHAMBIBNEIA.aFGA.BGAD.gGGBhADAOFDD.....hAIA...,2,-2,2,4
TNMefUFaPVSbgBIEXLDdGcHKJYCWORAZQ,ZAAATAAAeACE.FAFAaACA....SAHHbAED.BCCDhABAEAGALCCBGCEAHDGBhCAAKBHBCDBARECBACEBMDHBfGGEhCBAPEEBgGAADGCB.dGGD.hCGA......hDAA...,2,-12,-1,11
ASXHBCaEZRIGJQUTDNbdLWPgMcKeFfVOY,HAAAaAAAZACBRADFGAFA.QCABTAEADAGAdBHALBHBhBAA..gDDAhAAAMBBBeCEAfEGAhACAOECAAEGBBFFDEFAAIGHANHDB.PHAAhADA......hAFA...,1,2,-16,18
PeJXLARbVBOWHSZICGUdDQagNEFMcKYTf,RAAABAAAHADBZACAGAGAdAGADADAaCCH...EDABMAIBKDFB..TFBAhAAAeCCBLDGBhAAA.ACEB.bFDBOEEBhBGASDHHCGFD.QGGANEIA.FGAH.hCAA......hCBA...,1,14,-34,48
NDJVBLMSXgFEfTaYdGHbRQIKOcCUAeZPW,eAAAZAAA....PADADAEABAGALAHBMAIB..SBCAhAAAFBFDECAA.aBEDGCDAhABAHCFBRDBAQFFAhACAOEHDCFFDACHBJHBA.........hABA......hBDA...,2,-25,-12,13
EGBeYZFQgaNASJIXcUWROKTCbDfLVdMHP,SAAAXAAAUADARACF..KAEC.CAGA.DAGALCEAdBFAHCGBEDHFhAAAeDBA.ZEEFQEEAhABAaBHFAAAA.IFCAhAIA.OFHDfGGBMIBABHGDhBIA......hCAA...,2,-20,-20,0
BGKIYCeTWgAURVOLZfMPJESXaFbQDHcNd,RAAALAAAZADB.MAEAEAFA...aAGEQBGAHBCCdCAAGCFAhABAKCFDCCCC.eCHB.TFBAhACAAAAAODABJDDFFFHHhBFAbEEA.DFFBBGEA.IHHA...hCIA......hDAA...,2,-27,6,33
aTYDeWRVEXNCMJFdbUKQALPOHSIZgcGBf,LAAAHAAAZADBGAFAaADD.DAIBRAFAECAACCAD..MCCBdCFDKDDAAAHB.hAAAOCHD.SEFHhABAgDGHBFAAhACATFDAeFHB.XGAAFFBHQGGAhACA......hADA...,1,-11,-14,3
YGFSEcZLadBfbTgORCDVXHJWNMPKUIQeA,GAAAEAAAZACBLAFAdADABAFA...TCEARAGFDCFBHDBB.JDGFhAAAMCBB.KCGCQEDChACAAAGASDGAaFAH.hAFAbEBDCGGD...XEECNCIA.IFHAhAAA.FGGH...hAIA...,2,-17,-4,13
ETZbYPgcHLIFDdJaeQfGUWMNBSVORCAXK,EAAAZAAA....bADBPACC..HAFALAFBDCAAaCEDeAHBhAAAGCGAMCCABFFAOCGDhAIAAAHATGDA..hABAgDDBFGHD.dFGD.....hACA......hCIA...,1,-14,-16,2
KTgWEbXeBfISVAYQPDdaRLHMOGJCUZFcN,QAAAdAAARADAHAGBGCABCACAZADB.FCFHKAFA....TEAAhACAEBHFeCEHBDHA.SEEDhADAAAHADCGBaDCHMDIBhAAAOFFAUFFANIAB..gGGA.WGAAhAEA.....hCAA...,2,-26,5,31
KfLMPBFJAQbYdGaCWTHONgZRISVeEDcUX,QAAAdAAAaADA.CACAHADBOAFDZAFARBDB...SCFAhAAAEAHBDCCBUEFAKDDDMDIB.hACAFEFAACHB.GGAB.hAIATGGAIHFA.eDBD....hBAA......hBCA...,1,0,-30,30
OIUDZQHXEdMLbAaJSNCVWRPFTBeKGfYcg,aAAASAAA.CADA.RACFTAFABAFAGAGA..fBHAhAEA..gCCAhAAAOBBHDCEBHDABhABAECFBdEFDbDFDAAIBVFAAFEEBeFCFKFHBcGGCIHFAhADA.....hAFA...,2,-15,-7,8
ZDPYRWIEUgLMBKJQNOadXGfSHVbTAFecC,eAAAZAAADACARADA..EAGELAFA.MBEBKCCAQCFAhAAA.aDHDGCFAHEAAbEEDhABAAAGACCCDPEHD.hAEA.IHHABCHAOFCA.dHCBSFCAhAIA...hABA...,1,2,-31,33
KdWeQBUIFVDTaXHRLgJbSNPZMGAYEOfcC,EAAAOAAA..CACAdAEAeADABAGAFAGDDAIB..aAHDHCCALCCBhAAAJDFB..SDHBhAEAZDGBACGB..fEEAhAGAKBBDQECBIHHATGGA..hBAAXGED..hBEA...,2,-40,-13,27
YbaLPUcHGOZSeXQCWJAgFMdBNDKERfVTI,MAAAdAAADADARACA.....TAFAIAGA..aAHDLCCAhAFAUCCAHDFAZCFBeBHHhAIAQFCACECAABBBBEECEFFBfFHAhACAbFGD.PHAC.ODBHhAHA.SHFGhBAA..,2,-27,2,29
THRgfbDGLZYcPaFUXdVEeOQWBNAMSJKCI,MAAAKAAACACB.HACC.RAFF.....bADDGCCAZAFA.PBBBhAFAaCCB.XCGDdCFAECHB.hAAAeEFB.OFDDhAHAQEGDBFHAAAIBSEEDIHHA.TGAAhAGA.DGHB...hBAA...,1,-5,-23,18
IUFKDXgPBHaVeWdcbGZYEQTLSCMNJAROf,RAAAOAAAUADA.DAEA....XAFABAGAHBBCeBHHdBEAGDDAhAAAEBHFLEEAMCCBACGBFFGAhABAKFHBaCFD..VGAAhAGA..cGGC......hAIA......hBAA...,1,-10,-30,20
gPKROHIaUQAdeMcDJFfGCbZVXYNSTELBW,eAAAMAAADAEAFADDGAFAZAEE...XCCCSAHH.EBBAhBAALAHBBCDD.gEEBhAAARCEFHDGBaGCAAAFBdEHAhABA.fFDACGGD.YHBAhBHANIDB.PHFA..hCAA...,1,-11,-21,10
bYaWKFUCfIgMOVEBJTHNPLedZAQcDRXSG,QAAARAAAGADA.aACEFAFA.CBHA...fAFAMCCB.EAHBhAAATDFAHCDALCGBhADAeDABAAAA.XFAAhAFAbFDB.KFEAUGGAOEHDBDHBNIAB.dGCAcDCChAIA.....hADA...,1,13,-13,26
eIcZEQaGTKJWgDXUMSCdPRAfVNFYOLHBb,VAAAFAAALADA.HAGBeADEZCCAEAGEGDFAKBDA..JCFBDDIBhAEAUFGAMECB.dFAAACHA.hAAA..fHEBhAFAODDBBDHAbFCDIHHAaHDA....hAIA......hBAA...,2,-27,-4,23
PFVAMXBUNYefKSaDIQZORcLdJCWEHgbTG,MAAABAAAUACA..eACASAEAaAFDQCCARAGF.dAHAhBAACCBDHCEBTDFAGEGAhAAAFEHDABBB.XFAAhAFA..fFBADCIBZGDAcEDCLFDBhBFA.EFFB....hBHA...,2,-12,-9,3
QHfNGAYRCLadgKWDbBZXcJFMUIPEOeTVS,RAAAaAAAdADA.KAFADADA.ZADE..JBHBMAHB.UCCBECCB...eCFBhAIASCEAHEGBGGCBhBAAAAAALEEB.hBBA....bFAABFEBFEGHOHAC.hBIA......hCAA...,2,-25,-17,8
dAfITZYFDEMSCWeJGVQRcOPagKUbHXNBL,TAAAZAAADACA..EAEAMACA..CAGA.eAEAGCCBRBFA..OBDBhAAAaAHD.KDFDHDFCBDHAhAIAACFA.fEDAhBIAFFFBSGHBVFGBPHDC.....hABA......hCAA...,1,-4,-31,27
VbHUAgYWQTNMJGdKLScFBePXDZCfEaORI,....gAAAQAAAMADAdADALAFAFAGDBBDAeBEHhAAADCFAZCFEECCBRDBAIEGAhAAA.HGAAAAIBTDFAhABAJFFFSEHHXFFAaDBH.OCHFhBDA......hDAA...,2,-17,-6,11
KVIRfaPONDJeXECZYcgbLdFMGQATSBHUW,TAAAHAAAKADC.RAFA.aACAOCAB.DCCAeAEH.EAGAZCEE..hAAAgBGAdEFAGGABhACAABDBBCCD.VDEBhAAAfFCBPDHDXGAACFHAYHEGcGGAhAGA.....hAGA...,1,-1,-18,17
GKEDXMRJYHgcVaQTSNCIUfbZABdFWeOPL,dAAAeAAALADAEADADAGA.RAGFHCAC..VBEAaCFH..QEAChACATCCA.CDHAfEDAhAEAAAAAFCHDOEEBGGDBhAFAMFGBJFHB..YFFCSGEHNIAB.hAIAIHBA..hBHA...,1,13,-26,39
CTNecEPFdKJafgLWbGMUOBIYZAVSDRHQX,DAAAHAAAQACATAEAeAGH..EAEAdCADaAGDLDDB.hAIAGEAAMBBBBCCDhBAAZDFAAAIBRFFACCEAPCHDKHDA.hAAAfDFA.bFGDIECA.hBGA.SEEDhBIA...,2,-28,9,37
dYTCcWLfUQIEGebKVaRNJFMSgBXHOPADZ,dAAATAAACADALAFA..QACCECBAGCEAeAEE.bBEDhAAAaCGARCGBFECBMDABBAHBhCAAHDGBACIBZFFA.cGCBhCEAfECA.KGAA.NIEBSGDFhACA.....hCGA...,1,-1,-7,6
OVGUKcaYHCbAFTXSMfRBLDNPIdZegEJQW,TAAAMAAARACA..LAFBDACA..IAFAeAHBEBBB.QDDChAIAOAGDGBDAhAAAKDGAaECBHDBB.AAIBSCHHhBDABFFAdFHAJHCAUFFACHGD.XGDBhCAA......hCCA...,2,-16,-3,13
fXUAcEWeDQOGLRVKCFYPJZbNSITBMaHdg,EAAAeAAADADAGADA.RAFAKCCDFAFD..JAHBZCFE...SDBDhAAATBCABCBDHEFAdDEAhAAAXFACADGB.WHCAhABALEBB.CDHAbFGBIGHA..hAFAaHAC.....hAGA...,2,-28,-9,19
LHDPJSRKQAdTXcGYBaOICfEFVWMebUNgZ,dAAATAAAGADA.aAFACACBFAEA..MAIBeAGHUDAAZCCAHDGBhAAADBGB.SEBAhAIARDEF.ABEB.XDGDhACABEEDfGEAEGGA..WDDDgGGAhBIALHCA....hADA...,2,-18,-8,10
FeHfUcRZbIVPYgENdGTSQAWJOCaBKDLXM,OAAAaAAABADALAEA.MAIBHAEBUBBBRAGBZCCF.VDAB.hAFA.gCDHhAGAEDGBGEEATDFAAAIBCGADDDIBeEHFhBAA.bGCAIGHA.....hCAA......hCGA...,2,-13,-8,5
cFHLKIVTgOYCUbQdeRSfDMNBXWaPAGJZE,ZAAAEAAAHACALADBKAFC...TAFAOAHDCAHB.QCCBhAAARCAB.DCFBMCFBXDFDhAEAaCGDACCBGFABFFHDgGCAhBHAbFGB.SGGDNICB.BHEAhCAAWGDA.....hCBA...,1,-5,-9,4
OKYJMUNLXBFQDHVcIWTdgCPReZfEAaSbG,aAAAGAAA.KADAMADALAFBFAGD.HCDB..IBDAhAIAdAHACDCCRDGBeDADEBBBABFBOBHDhBAAUGGBBFCADDDAVDFBhCAA..WFFF..PFHDSHBAhAAAYEEF....hDAA...,2,-29,-1,28
dEQKIGcUPSRJDWgHfYLOFBACNaVMZTbXe,aAAAZAAA..TAEAeACHEAEAKAGC..GCAAUBGARCEBDACAHEAALCGBhABABDDDAAHACCCD..MBIBhCAAdEHAQGCAhAEA.IGFASDEAWHFAfECAhCEA.FFDD.bFFA.hBAA...,2,-10,-4,6
AIMBNcQdGTgROWaKUYFVSJfCZLPeXDEHb,MAAABAAAQACAGACBRAGF.OAECKBBDFCDH..SAGEhAAACCFDZDFELFAAeCABECCBhACAHFGBACFA..ICHAhCBAdGFC.TDFA.aEDD.VFGB..hDEA......hDFA...,2,-12,-10,2
YJTUfPGVHQEgDAZCSOXBcRNWIaeFLKbdM,ZAAAOAAABADBRADA.....IAFAeAGHLCCAdAHA.MAIBhAEATCAAUEEAGCEAhABAHDGBEGAAACEBCCGDXEGAhACAWBBD..aGHDKGGA.JHBA...fHEBhBHA..hCAA...,2,-27,-6,21
ZeBAFHdGNQgDXMWCbLVYKcROaEfUPJTIS,HAAAGAAAQADCDADAMAGB.CAFBLAHB.KCADRCDBEAHBfBGAhAAAUEGAJDCFTDDAhACAZGFAAAAB.dEGA.XFCChCCA..WFBDbGFA.....YHDAhACA...hCFA...,1,-3,-23,20
UFDbfEORcBdZVeAGYWIKTaMXJCLSNPHgQ,GAAA..IAAAaADAMAGBCACALAEA..SAHBhAAAHCAAQCEAhACADBHBECDARDBFdCHAeDFBAAFAKECAhAIAXFGDPFFAFGDAODHFBGHAYEEFhACAWHDA.....hBIA...,1,-3,-21,18
OLQRXUMcfKSVWIDAGCdNbHPEgZeJFaTBY,dAAAHAAAEADAeACE.aAFATAFABBFALCCBRCAA.UDGAMAIBhACAKCEDSCEBhADA.IDGAAAIBGGEBhAAAbEDC.ZFGBFHCCOHAA.....hCAA......hCHA...,1,-4,-13,9
cDLbGKEUaRHIYgJOFCXZeMVPSQNBTAfWd,dAAALAAAGADAEAEARAFAHCAC..gAGAFCGDZEFAeFAAMCAAhABASFDHBCDAACFB.hACA.fCHAhAEADCIBKGGA.aDEE.JEHB.XGFD.PHAAhAHANIAB.....hACA...,2,-11,-7,4
SHJfIGFYWaBgCMTAcNdURVEKeDZbQXPLO,dAAARAAAEADEeADA.ZABBQAFCLAHBHBECJBHB.GDCAFCCA.hAAAaEABCDEAAAHAUEEA.DEHBhAEAXDFDOFHDSHBGhBAAIGGA....WFHHMIEA.hABA......hCAA...,1,14,-35,49
MfaCVdcIRKTWDXBJSLOYgPHZFQEeGNUAb,MAAAaAAA.dAEARACFKAECDAGA..BBBALAHB.OBBH..hBAAgBFHHBFDZDEFEECAhBHAeBDD.GDGAhBAAAEHAbGFA.CEBAIFEA.XGEA.hCAA......hCEA...,2,-27,-12,15
bcgAWHEGQCedORUSPJNIfXZBMVaFLYDKT,HAAAEAAAGACAeACERAFFUAFA..SAHBJCBF.ICCAhAAAZDFAMAIBaCEHLFBAhAAAKCHDbEFA.AAEBQFFAhBCA.dHBBOFAA.fFDAhAFA.BGEA.FGGBhCAADGIB..,2,-3,-3,0
TVQGOWCXMELHfNZDaKeFYIdbRcUPJSBgA,TAAAGAAACADA..EACEHAEBZAEB.aAGAeAGFFBHH.dCCARDCA..UEGAhAAASAHHACDB.QDGAhAAAXGBAMDABhACALEABDFFBIHHAbECAPGFC...hADA......hBAA...,1,5,-12,17
cYJVFDaGLWTMeZQPBOEXNfAbSUIRdCKHg,SAAARAAAdADAHAFA......gCCGcACD.VCGBhAAAaAEDGAGA.TDAAhAAAeDFDZFAAQDDAhABAOFHDEHAAfEGEAAHA.bGAACHGD.KGGDhADA......hAGA...,2,-13,1,14
aNGcYJdFUDAECKIePHBMLTVXRSQOWfZbg,EAAAKAAAeACEHACAMAEALAFB..TBFARBCBQDGA.hAAAOECBZCCAaBHDGEEAhAAAcECAdAHADEHBAEEBCGHABFFAhAIASHBAfGHA.NHBB....hBHA......hCAA...,1,-1,-10,9
HPKRELeJfVcOgMYCBFQbNSADaGXUdTIZW,GAAAdAAAZABBHADARADAEAGE.eAFE..VCEAOCEC.MCIBBCHBhAAAQDCDSCDDhACAACGAaEGBTEGA.IHHAhADAKFEBfGHAgEAACHFANIAB.DFFB.hAIA......hBAA...,2,-8,-5,3
LVFHOYXECacgDMPRWATeZdGINSBQUJKbf,eAAAGAAA.SADAQADAKAGALAGBHCDAOCFAECCBaCHDhAAADDABREDA.AAABdEFABBFBUGAAhACAbFGD.FDCH.CDHAMFHBhADATGEA...NIAB.......hABA......hAIA...,2,-8,-3,5
NHTZfcQAWMOVXSbRLdaeGDKFICJEgPBUY,MAAAXAAARACA.dADAeAFEGAFA.FAHFCBBDEBFFBDBA..UDEBhAIAHDDBZDGBQFAAhAAAACHAOECB.bDGD.aGFCKGHBhBAA............hCAA......hCEA...,2,-25,-3,22
aeERJWAVMKQFcZNgLbCOXGUdHBDfTSYIP,MAAAQAAAZABELAFAOACCGAFAHCCADCEASAHBhAAA.ICDAeCGFREEBAAGAhBAAFDEDNCIA.CDHAdEAABGHDTFGAhAEAaHEC.EGFB.WHBA.....hCAA......hCCA...,2,-16,4,20
WJAVMSPCBOcaXNgUZTRDdKLbFfHGeEIYQ,MAAACAAABACA..aACE..XADDUAFARCCA.dAFBLBHB.hAAAFDFDHBFBGFBBECAAQDDChACAABBB.hAIASAHHOFHB.gEGADGGBfHDFhBAAeFFDIHHAhCAA..,2,-22,-14,8
MPNcDgWSLYdBKbEXAGVRFUaZeJfCHITOQ,RAAAaAAAeADE..CADAHAEBOAGD..MAHB..PBDDDAIBSBBDhADAdDFAKDHBEFCAAAGBGCCAhBAAFFGDZGAA.fDHAhCAA.TFEA...cGFDhCCA.....hAAA...,2,-25,-14,11
PUHXGWYFOdgRfEDIMKQZeTNSLBaJcAbCV,CAAAUAAAHACAGADAFAFA.dAFBRCAA.DAIBKBHBZCFB..eCEB..TDAAhADALDGBBDHAaEAChAAAADDB...VFCAXFDChBAAOFHD..EFHBMIAASGBBhBCA.cGGC.PHDChBDA.,1,-7,-26,19
bQMSIfZKFTYedGBUJgXREWcOHDAaCVLPN,aAAALAAA...bADDMADA.fAGAZAFATCAAeAHHhBAAGCFABBBDUFCAXBDAhBDAEFHBOFFHHDDAADIBhBEACGAANIABQEGD.KGDA.dHGB..hCAA......hDAA...,2,-9,2,11
FDBQOLgJYceZVSaTdMbRWEXGHPUfIKANC,FAAAQAAALADAJACEeAGH.ZCCAaAFDdDHA..RBGF.EEAAHCDBhAAAUEEBKEGD.AAHADDCBOECDhAEA....gFBAhBFAYHEASGHBMDIB..hAFAWFFD....hBIA...,1,-10,-26,16
RBDEUSZfKaCGdFTMJNXOYHgPbALIVceQW,LAAAVAAA.eADHRADFDAFAEAFA..ZBFBaAHDdCHA..MCABJDAA.hAAAOCCHHFCA.bDFAAAIB.hADA.QFFChCAABCGDfEDACHDA.TFAA.XFFAhABAYHFGPHBC.hCFA...,1,4,-20,24
aMXQVAIESNPbLcBOdgfJGFeUZKCTHDRWY,EAAASAAA..bACALADABAGAdCCAfAHAGCFAeAHHhAAAZCCATDGAHDABREDBaDHDhADAMEAAQGABhAEAAAAAIFAA...cECD.OFFBhAEAFGHB.CCFBDGHB.YHAAhAFA.,1,19,-23,42
RZVGAFYHTSgdLfJCDBcQKEPIbaeUXNMWO,HAAATAAAdADA.LAFACACBBAEA.QCABEAGA..bBFAeCEAhAAA.XDDChACAMCCBRDDAGDGAAAGASCHHhCFAfEAADEGBKFHBaFFHWFFDZGAE....hDHA......hEAA...,2,-7,-4,3
FJPCOfVeWGXDKTSbMgIHcYZRLEdQaABUN,BAAAFAAACADA.OACA..eAEHGAFAKAGA.TBCAMCCBHCGBhADAZDEFEAHBdDDD..ACBBUFBAhAAAJFFB...fEGFhAIAXGAASGDBIGHA..YHDGhBCA...hAGA...,1,-11,-34,23
FbRKPTHSLAIaDMCOUGZdJYVWgXBNQfceE,aAAAMAAA.UAEAdADA..JAFA..VBBB..XBEDQAGAhBAAeBBBEDEARCGFKDDDHDGBhBBAADBB.CEBDZGEA..gFEAhAIABEDDNIBB.FGCB......hBAA......hBDA...,2,-27,-5,22
fAadeTRWUQMbgIJFNYKHZXScGPBCLDEVO,eAAARAAAQADCMAEA....IBDAFAFAKBHBHCDCZAFESCCDhAAAGDGACEEDEGCAfCFAhABAAAAA.dCHATGEAhAIAbDDD..gFFBYCCF.PHDChCAADGIB.....hCAA...,1,-1,-12,11
gLODWAPdRUZeIacGJHBQfNTXVCYSEKbFM,RAAAeAAA..aADAGADAHAFBQCCATAFACAHB.EAHBFCCHMDFBhAAALCHBDDHB.AAAAdDFAhAFAZEBAIGGABFEDXGGAhBDA.SHDA....hCAA......hCBA...,1,-10,-14,4
ReWVEGUBdPNCJfAFaMYSZKHbOgILXTQcD,aAAAMAAAZACBHACC.OAFALAFA.TCEAQBFD.hAGARCCBeCHHECGEGEBAhAHAdEFACBBDAFIBSEEAhBAAKGDAIHGADBBBUGGA.BEHANIBB.FHEG..hBEA......hCAA...,2,-3,-3,0
FTGHdDQAeVPMZXIWNJLCYEOSgcRfbUaBK,eAAAMAAAZABE..XADA..IAFAJAGBLCCBhAAAEAHBSCCARDGBUEAAaEDDhABAFCFAHFEBdEEAACCA.PDHDhAIACHHA...OFDH.fGFAhBAA.KHGADAIB.hCAA...,1,-8,-24,16
XdeTSOEQVFCDIgLAWJYRGcNbPfHaZMBKU,JAAARAAAGADA....bADBHAFA.ZCFEMAGBKCCDdDAA.eEFAhAAATDCAEFHFQGEAhABACAHADBFBLCHBAAHA.hADA..cEFBfHCBaFEHXGGAhAHAOFAE......hBAA...,2,-32,13,45
QNRWLEbgaDZCFXfTJIcOYAUPVMHGedKSB,VAAAHAAAeACE.dAFABADBRBGFLCCBEAFA.aCEHZBEE.XCGAhAAATEFA..IGHAhAAAOCDHAAIB.MEFBhAFASFDHQEGCWHAGbFDDDIEAFGHD..hCAA......hDAA...,2,-15,0,15
SAMUOaQLbEGPIfTNCVYJBRdKgXHDFceWZ,MAAAaAAALADAGACB....IAHATBGACAHBJBBF.RCFAdDDAhAFAXBBCHEGBFFCHeCDFhAEAZFEBACFBQDGBhAFAEGAB.fEEA.VGFA..hBAA......hCAA...,1,0,-13,13
DbVaCFgUXQGLWTBAYEPcMIOKfeRSdZJNH,EAAAMAAAKACARACA..ZAFBHAEB.DAGAaAHDFBGAUCCBGCCA.LDHBhAAATDGA.ACCB...hAEAPEFBOEFBeFAAhAFAdHED.JHBA...NBBA.CEGB......hBAA......hBHA...,1,-13,-15,2
ADBbcHWIeNdTSLMgQEGUaRfJZVCXPKFYO,BAAAHAAAeACEdACALAEAMAFA..EBFAaAHDRCCAZCGB..XCBChAAAFEEBACCADDIB..bCEBhAFAIGGA.SGDAhAAAGDGAfEDA.CGAAKGDAhAGA......hBCA...,2,-27,-10,17
NBGDPFTZACSgMYbXJcKfOIQVUaEHLWedR,SAAAMAAA..bABAXACD.KAEAOAFA.QBFChBAAaAGAHBFCeDDAhAAARCCBGDGAFDHDADDACEFCgFCAhBIAcEAA..fEFA.hCAAIGGA..hABA...,2,-27,-8,19
MbfcTKeBdSYEZQNLHRaUFXIVJGDOAgCPW,CAAAMAAA....bACATADA.eAFEdAGAECAAZBBFLCFAhAIAHCDARDAAaBHDXDDDhBAA.IEGAGEFAAACAhAAAgFGAfEHEBBGDQGBAhAEANIEB......hAIA...,2,-8,-2,6
fWNFHbGMRXeCZOIJPYVLKDSAgBETUadcQ,EAAAaAAA.dADA..QADA..fAFAFAFEHCCAGCFAhADARAGFeBCDZDFAOAHDhBAAIFAAPEEBLFFBhAAASFHBACIBTGDAWBBDMIEACDBD..hCAA......hCCA...,2,-11,-9,2
POXWGUDVcETHBRLJdAICaNMgbefKSZYFQ,aAAAMAAA..eACHSACAZADBFAFD.QAFAOAHB.GCCAhAFADBBBEDEAHEFA.RFDFdBHAhAIAACIBCEFA.NBBA..fGHAhBAAKEHBXGGCWFCD......hCAA......hCCA...,2,-28,-3,25
gTaJSFNIceZWCEMPXRdDOVYHBbAUfLGQK,LAAAGAAAQADATAEA.aAFEFAGA..ICGAeCAAZCEAhABAECDBMCIBRDEF.dEAAOCHDhAAAHEEAACAAKFHDSGCAhACAcGAACGFADDABBDDD.fGGAhAEA......hCGA...,2,-7,0,7
FJOSYXEIRZTBANCgcPKVeLMHWQDUaGfdb,CAAA..PAAAeACAHAFADAEA.GCAAdAHAFBCDSCCA.hBAAECFBRBEBZDGBAACA.gEBAhBEAKCHBMEEBQFFAhAAAaEDD.fHABbGCA.OFHFhAHAIHHABHCB..hAIA...,1,-7,-19,12
aOKSfgZBGTXAIeENFMYQWLcJPbdUHRCVD,EAAAMAAA..QACALAEAJBBAdAFAHBGBRCDA.DAIBKBHBfCCEhAAAZEFAGFABABEAeDFBhAHAFGED...cFGDhCAA...bEDDCDHDaGGB.....hCBA......hDAA...,1,-9,-23,14
RIYOdDCPNMTVFZfBEHKWcJUXLQSAebGga,eAAAGAAARADA.OADAdAGADAIBCAGA...MCCBTCDA..ZDCBEBHFhAAAHEEAKDCD.JEABLEFAhACAAAAA.aCGHIDHAhAEAPFCCFGGABFHA.UGEB....hCAA......hCBA...,2,-16,-7,9
EaMFLVNHTcbSDGWKgXdQIBPCRAYJfeUOZ,JAAAeAAAZADBEADA.FAFDLAGB.HCEBbAGD.GDAA.KDHBhADAdCCABCCCRECAAAAAfEGAhAIAaFGB.MEIBhBIATGCADGEB..........hAIA......hBAA...,2,-22,-16,6
OFAceJERbaQVXHYBIGfdNTCLMUWPZDSgK,eAAARAAAQADCHADABAGBGAFAdCCATCFAMAIB..UDDAZEDBSAHHhAAAOCCHAAAAEDHBhAFAaFAA...XFFAhABAfFGACHEA.LHAADDIB...hAFA......hCAA...,2,-12,-3,9
AVgIdODWPKETRaUcHXFfSBYebNGQJLZCM,VAAAdAAADADA.KAFARADF..UAFAHBDA.FBHDBAHA..eCBFGDAAhAAALDDAZDDAACIBODHBhADAEEGA..aFDAXFDAhCAASFHH.NHAB.QGGBhDAAMIAA......hDCA...,2,-15,-14,1
AYTDLGHZdCeVfFBgPRIEXUNWKaJbOSMQc,TAAAGAAAHADA.dAGAeACEFCDHBCFDRAFFEBDBUDDBKCHB.aAHDODAHhAAA.MEFBACCBLDHBhAAAZEGF.fEGAhAFA.gGEBXGFDNIABJHAA.hACA......hADA...,1,0,-15,15
OQEgBUSWPNGHRFMVIcDdaCfKYLbJAeZTX,eAAAZAAAOACAEADABAFAUAGA....SAGH.PCCAhAAAHBEBRDGB.MCCBhABAIDFAdFFAaDDHKCHBbGBAhBGAAAIBTEGA.QGGB.NEEA.hABA......hCAA...,2,-25,-14,11
FHMNTdVAJDgSIRBeYcPfCKbUGaQEWXOLZ,DAAASAAARABABAEB.eACH.....PAEAKAGAGCDAhAGAEAHFOBDDZCFAHFFAMCFBhAAAdDCCACGB.IGCAhAIA..fCHACEHDaHCE.QEGBhABA.XGGAhCAA...,1,-22,-24,2
VYBEbgPaJdFDUHATNZGeSKCXLfWOQIMRc,ZAAAeAAACADBLAFAOADC..MAFARCAA...VBGBECEA...hABAbCCAaCGD.dECADCCAHEEAhACAAAAAGEEBXGAChAGAfGHAQGDD.IGGA.hBIA......hCAA...,1,0,-21,21
eKVYdAGDHTWFaNLXOESbURJIBCZMQcfgP,HAAATAAAaACA.LAFAEACE.UCCARAEFBAGBZCFA.MAIBQEFAhAAA..fCCAhAAAeFEBKGAAdGCAACGAGDEBhAEAFGHD.OEDB.bFFA.CHDAPHFChCAA.....hAGA...,2,-2,-1,1
WDEVHUOLdMFPGCbXeSfcBNRgTQYZAaKIJ,aAAAKAAA..JACAEADA.HAFALAFBdCCAMBBBGCCA..bCDDeAHBhAAA..SCFAhADABDHDREFB.TEGAhAHAYFCFACIBDFCB.OGECCFED.....hAIA......hCAA...,1,1,-32,33
aPETgAQWHIbLXFUGZOfMBKVcdYeNRJCDS,HAAALAAAFADAZAFBMAEAKAHBdBEA..eCAARBGBDAIB..aCEBECAAACHB.hAAA..QDCChABA.IEFAhACAbDFAXFFAGGBBODDHBFGA.....hBGA......hCAA...,2,-16,-16,0
cXPWSAVKIQUYRHJGeMEDgNabTFZOdLCfB,KAAAQAAARACFHAEBGBGAEACA..DAFAaAGATBDAZCAF.dBFALEDAhAAABAHA.XFGAhACASCGHAEABIGBAhAEAUFEAeDHH.MDDBNICB.....hBGA......hCIA...,1,-5,-15,10
UEKNCSYRMbXVeZLGcFWJDPBAgIdOaTHfQ,dAAAaAAAHACBQADAEAEA.CAFA.RAGB..MBBBXAGDZCEB.GCABhACAFDGHDDIBAAIB..ODEChADATGGAKEHB.SFFBhBAAbEAA.eHDE......hBCA......hCDA...,2,-18,-7,11
MHNeGTYaXCPcEZdBDWgKULOVfSFRJAQIb,QAAAMAAAHACCeAFEGACB..aBBCCAGBEBHFdCFADCHBKCDDLCFBhAAAODDB..SDHHhAIARDABADFBIEHAbFDD.hBAATGGAXFFC.......hADA......hAFA...,2,-16,-4,12
OcRHbGYTPQJVULAfIDSZBdEgaMKXNCeFW,DAAAZAAAEADEMADA..KAFCCAGA.FAHD..OAHDHCAAGCEA.hBAATECAQBBAhBBAUGCBACEBSBDAhBEABFHAaGFD.eCFF.RDGBbEDD.....YFGFhCAA...hABA...,2,-18,-15,3
QKUNVcbYDJdFHSIPLCRgMEZATWBfGXeOa,TAAABAAAGACA.eAEAaACAKAFAUCFA..VCCA..bCADhAAADAIBdBHAHCFB.SDBDhAAALFDACEEDRFCAECHBhAFAAACBfEHAQGGANIAB.YHAAhAHAFGHD......hBDA...,1,-4,-6,2
JKVEPcIUeCODZYTBRSLaAGNQbHFgdXWMf,GAAAQAAAHADAdADAMAFAKAFA.EBGA..ICFAeCDBDCFBZCGBhAAATDGARDBALEFDhAFAAAABbFFA.XGGB.hACAfHAB.......hADA......hBCA...,2,-10,-10,0
GAFSZdNBMLWCgDEXHTeVRQKJUabYPfcIO,ZAAAdAAAMADALADB.CAFA.EAGAHAGB.eCABRBDAQCBDhACAKCFDUEEB.aBHD..bFAAfDFAhBAA.OEBChBCAAAIBSCCDBEGADEIBXFGDTGGAYHCAhBDAIHEA..hBEA...,1,-9,-15,6
ZCJKVYXdRbNGOHfDEWMSgBPITUQAcaeFL,eAAAZAAAKADC..XADARAFAGCAAHAGBDCFB.ECCA..MCHBBDEAhAAA.TEAAACABFCDDLFFAhABACDGDVFFAdGADOGAEhACASEDD..gGDB.hABAIHHA..hAGA...,1,0,-25,25
MEfBReSGcgAZNTObYUXaQHKDVIPCdFLJW,ZAAATAAAOACA.UAGAaACAHAEB.DAGAVCDACBGB..dCCALDHBhABAMBIBBDBCREFFeCCDhBFAGDFAAGBA.bEDDXGBAhBGAKHGA.FHEC.......hAAA......hBDA...,1,-7,-13,6
YcWTGeQaSZDbMdEAOIHKUCLRFXJgNBfPV,HAAACAAARACA.XADB..NAGA.BAFA.fAHAVCAA.hAAA....cCAChAAAGDEAeCCBaAHBZDGBhACAbCFAEEEAABIBKECBLFGBFFAB.gFCGhACAWEHH.SHAAhAHA.MFIB,1,18,-27,45
CUaQXbJNREgHDWSFfOPTKMdYGVBZLecIA,aAAAQAAA.JACEEADA.HAFADAGAFBEDOBBB.KCDAdBGAGCGAhADAZDCAeCHHAAHAXDCChBAARGCA..SEFHhAAATFCAMEFBBGHAIHHACHGD.NICB.hCAA......hCDA...,1,-9,-21,12
aEUFCWcMbgQDYOAKIBHVRdPTXeNJGZSfL,BAAAHAAARADFdACA..TAGAeAEAGBGAZCAALCFAECBB.CEEAMEGBhAAAQDDA.OEABhAAAAAFAKEHBVGCAXFCChAEASHGAaEHDFGEDcGGCDIAA...hACA......hADA...,1,-1,-5,4
bEAfeRMUBYGPJcIdKFZNWTXDHVLagCOSQ,RAAAMAAABADBGACB..JAFAdAGAZBFATCCAHCCALDGBhAAA..aBHDOECBhABAbCEDABBBeDGBUFEA.PFAAhAFAIHHAFGGHNEIADEEA.......hAIA......hBAA...,2,-20,-7,13
eaOcREDGbZSXYJCUNMTBHKLdWIQfgVAPF,eAAAaAAA.RADAGAGAZACB..XAEACCCAMCFB.HBGBLEAAhAAAdCEAQEFD.hABAfEDEAAIBODGHEFHFhAEAbFABSAHBUGAANEEA.KBBD.gGGAhAFA...hAGA...,2,-9,7,16
OLMVSWGNbecDfaIgFHUQdJTKRPZABECYX,EAAAXAAALADA.MAHBSADA.GAFAeBCBfCEAhAAAaAHFFCDBHDABdDGDhAEATEEARFAAAAIBCEFDOFGDhAFANDHADDIB..IHBAgGCAJFDF...hAAA......hABA...,1,-3,-6,3
fMVNXZdPYTOHIRUEScDGBageQbFKJWLAC,MAAAXAAAdAEA....TAGAHADARAGFEBBADCDB.aCED.eCHHhAAAbCDA.KDAALDHBhAGA.ADCBCEBDfEFAhABAZEEE.OFAASGGDBFHAQGAChADA.FGDB..hAFA...,2,-12,-4,8
ZPWeIVBROAGTXKQYHMgLaSdDfbCcENFUJ,GAAATAAA.QADAHACBMAEAaAFEdBEADAIBCAHA...ECDBFBGHZCFBhAAAeCABBDHAACIBKEEALFDBhACASEGBbFGDUGAAhADA..WEHH.......hAGA......hBAA...,1,2,-14,16
fgbOERSHWBDTKMZYXNACGVcIdJQaPeLFU,GAAAVAAA.dADAQADCeAFALCFAFAFA.UEDA..bBFAhAAARFABHFFBDDDA.MEIBhAAAZDEEXEGAAAFACHCA.hACAIGDA.aFFC......hAIA......hCAA...,1,-5,-21,16
ZNeDEYgRMBWHPGQAKILdUXVaJfSCObTFc,LAAAdAAAUADA.aADD..SAFAOAFAFBFBZCCA.DAIBEBHFRCGB.hACAMCABHEFB.GGABhAGAACCBXDDC.fDGEhABAbDBC.TFFAeFHH.BHHA.hBAA......hBCA...,2,-16,-6,10
RVGELTHcaKSNMFQfPCgWeDAUIBbJYZdOX,BAAAJAAAZADBdACA.RAEAGCDALAGB.HCEBKBHB...MAIBQDFChAAACBFB.eCBBhAEAACCAIDAAOEHDEFABhAFAaEGD.FGCB..fGFEPHDC.DEIB.hAHA......hAIA...,1,-11,-28,17
aLXVJONYQeDfdHSgUbEZcTIAWMBKRFCPG,MAAARAAACADB.GACBLAFA..XAGBOCCA.QCCChAFAeCFAdEEAHGAASBBDhBAAbEFD.ECFB.ZDGBIEHAhAAAABIBKEEAaFHDNIDBDDDBfGCA..hCAA......hCGA...,1,-6,-7,1
PfdWVZBKLNHAQTIReGaUYJEgSObDcMXCF,TAAARAAAeADEGAGA.UCCAEACEOAEADCFB.MAIBFEBHdEGDhAAAZBEELCCBHGDAAAIBQGGChABAaDGBJEEBSFBDhAAAXGAC.fFHA.BHEAhBFA......hCAA...,2,-16,2,18
VQAIPbLGUfCHJZWTdEeKcgYaXDSBRMONF,..IAAAbAAA.GACACAEAHAFBZAEAdBHAECABeCAB.KCCD..hAAAgCEAaDEBDEABRECBMEHBhABAFCHDAAFALFCAhACA.fFHATGEAYHAABAHBOHFChBCANEIA....hCBA...,2,-12,8,20
WPYbDfdGBUACIQgTMOJNZKeLHcXaVERFS,QAAAMAAA.OACCZABEeAEHHAFBaAGARCDBFAHF..SBFHhBAAPDCB.bBGDdDHAhAAAGCCAAAEACEGC.TFEAhCAAKFFD...cGFDEGHB.DICA...hCAA......hCDA...,2,-9,-5,4
fCWVOGTNZPJaUMHdebLBKgYIEQRASDcXF,DAAAFAAACADAOABE.GAEAZAEB..aAGDHAGD.eCCBLCCBhADAKDGD..IEAAhAEARDGBAAIBXEECVFGBTGAAhAGAJGBA.MCIBdGGD.bEDD.....hBAA......hBGA...,1,9,-31,40
QUPbADYMHJCSZBGNOFfLeRVcETWaXIKdg,MAAAHAAASACEGACBFAGALCCARAEF.ECGAaAGA.KBGAdEEAhAFAQCCCUGGAABBBDDIBhBAACDFAZDGBOGCCeEEB.hCAA............hCDA......hCGA...,2,-14,-12,2
VNCOZGMFUBDJIcgWAKfPYeaLbHSTXREdQ,KAAA..fAAAeACEaAFA.HADA.TBGAEBCFdBGDQCAAhAAACCEAGDEB.MAFABECAhAAADCDBJFFFgDFBhACA.ADIBLEEBSHDGRFCF....hAIA......hCAA...,2,-29,14,43
cfHbeEAUPIdMOgLYDJCQSRWGKZaBTVFXN,UAAAdAAAMADALADADAHB.QBGARBDA.GCBBaBHDBCBAhACATDFAFDDH...XEAAhAEA.fEEEhAFAHEBBEEGAAEBBOEHDgFFGCGGDKHAA.NIAB.hAIA.....cGEChBAA.,1,1,-33,34
AcUCSGQPJVfFgRedXNLZbEOaHDYBTKIWM,CAAAGAAA.QADAVACA.FAFERAFFeAHHdCGALDCAZCAA.hAAAEEHFHEDABFFATFAAhACAKGDAMAIBADIB.SDADhAAAfEHE.XGEA.OHAEhAFAaGHD.IHHAhAHA...,2,-16,-5,11
RHBAUSYCMeQZNLbIKFafEDVcdXgWGOPJT,SAAAMAAAZABELAFAKADA..aAFAECCADAIBdCFA..XBEAhAAAGDGAODEHhAGA.PHAARCCBHCGBADIB.hAHACDAAeEFB.bFDD.fFHA.hBAA......hCAA...,1,-12,-17,5
eIULNBARPSDWEYZCfFHTgbcGOVMXKJQda,RAAADAAAEADEZABE.FAFAHAFB...TCCA..bBEDGDGAhAAAMAIB.KAHBdCCAeECALCGBhADAADIBSFABhABACFFD.fFFEOEHDXGDCaGEH..hBAA......hCAA...,1,7,-31,38
IQSGOYXWPNFbedDZLHJCBKTgafUVAERcM,RAAAMAAAQADCGACBOAFA..XAFB.PAHDhAAAbBFAeBBBZCCAHDFBhABABDDATDFAaEEH.fEHAhBAAADHBEFCBSEHHYFDA.FGHD.hCAAdHDB.....hCFA...,2,-7,3,10
WTISecDaKHYJONbLGQgZdfEFABCPVUXRM,CAAAUAAARACA.MADA..TAGAeAFADBDBHCAA..OBEBLCEBhAAAGCFAZDFBEDHFABIBBCHDhBAAXFAA.SEDDhACAaEHDKFDAYHFANIAB....hBCA......hDAA...,1,-5,-28,23
DJbLPOTdEZaXNKYAIGCfUSHVQegMRcWBF,GAAACAAAUACA.HADA.eAFERAEABAHBDCDBLCFA.TEDAhAAAECBBaCFDKEHB.ACGASDADhACAQDDAMCHBhAAAFFGH...bFAAOHECZGFA..NCIA..hADA......hAIA...,1,-4,-22,18
IENegKVBJADcHQGPXdaFLYSbZOMTCWUfR,HAAAGAAAdADAaADALAFA.SCAAZAFBMAIBTDCAhAAACCEAUCGAREEBEDGF..eGAAhAAAKCDCBEHAAAGADDDB.QFEChACAFGDDOHFCfGHA.IHBAhBAA....hBCA...,1,-3,-17,14
BdFeNJRZTbMQHAgYDOWEGaXVIUfCcKSPL,DAAAEAAAGACA..aABEXAEAUAEACAGA.SAHBLCCBdCHAhAIAeBGH.REAAbEDDHEDBhBAAAAEA.OEBH.IFHAhBEAKCBDFFFANDIAZFFF.MIBAYHEG.hBIA......hCAA...,2,-18,9,27
YSTbdBUCGcEWHgAKIOFXeZLMaJVNDPRQf,OAAAeAAAZADBLAEAMAGB...aAHDVDBBDBBB..RCCAQCFChAFASAHBdDHACDHAGGABhAGAEEEAHGFA.AAAAFHBAhBDAXEEC.PFGD....hBAA......hBDA...,2,-14,-8,6
LTUfSABNWKHcbaPVRgIZMXOEYDQeFGJdC,BAAAKAAAHACBaACA.RAEAZCAF..MAFAEBHFDCGBeBCB.GBEAdDEALEHBhAAATBGASDBBhAAAAAEA.cDGDhBDAPHAA..gFGAOFGB.QGBAhBGA.CGEA..hACA...,1,-2,-19,17
WLBXVATQJgZIDbEcYUFONePKaRdGHSCMf,TAAAQAAA.ZACBDACAEAEAUAFA.OAHFeAGFaAHD.RCEBHDGBhAAAMBDBLBEDhAAABECAADIBIHHAbDFBFEHBKGHBhCAASEED..WCCD...hBCA......hCAA...,2,-14,-7,7
VHSEUPODWbdYTNJfIRBMLAFQKceGCaXgZ,QAAAeAAAGADAaACEZAFA.HCFAUAFADAGAdBHA..TDBAhAAAfCDAREFAMFEBADAAKDFAhAAACGHA.....XDAAhADASHGGEEEBOEHD.bFBC.hABAYHFAIHCA.hAIA...,2,-19,1,20
PWYQXMUKASZaGNcFdEeLDHbIVROBfgTJC,aAAAGAAA.FADAEADAeAFHHAFA..VCGBRCCABBBD..TDCAhAAACCGA..PDABhADAQFEAMCIBAAHASAHBhACAZEEAdFCALHEADFIBOHBAfGEBhBAA.....hBAA...,1,3,-17,20
cVDJGINORgPdFXLHUCKZaSEbBWfYMeTQA,DAAAGAAAOABERADAdAGALAEBHCDCKCHBZAGB..EDCBBCCA..hAGAfEAEeCHHABGBVECAhBAAIEGA.gFFGhAAAXFGAaGEDWEED...MFIBhACA......hADA...,2,-23,-11,12
PVOdZFGbRXLfSUcEaIQgDMKYTBACNJHeW,CAAAHAAA.eACEVACAZAFBGAFARCCBLBHBUCAA.EEFB..aAHFQFAAhAAA.MFHBhAFATDDAACEAJHCEODGDhAAA.bFAA.SFFD.IHBAhACADFIB.BHHA.hAIA...,2,-11,-1,10
BOfCUEJXeWPKMbFTZdYgSQNRcDVHALaIG,aAAAGAAABADACADAUAFA..EAFA.eAHFKAHBMCDBFBBH.dDGASCEAhADA.RDCBDCIBhAFAHEDBAEEA.LFBBhAAAOEGB.XGGA.WDADPFHD.hACA......hADA...,2,-22,-22,0
SJLGNFUgTdCKQYfMRDeObVZEIPAXWHacB,HAAAaAAABADALADBGAEAFAFA.UCABdAGBQCCCMAIB.hAAARBGFDBBBeBFB.bCGDEDABhADAADFB...XEEAhBAASEEDNDIA.TGGAKHFA.....hCAA......hDCA...,1,-7,-12,5
VFZRBKXCJbNDdcGWYIfSEMPAHeaTLQOgU,HAAAeAAALAEAQADCOAHDVAGBRCAAKBCA..CCEA.JCEBDDGBGDFAhAAA..IEEAhAAAEDHBAAFA.aDHDTGCAhABAFFAAZGAABHGAXGGA.....hCAA......hCBA...,1,3,-19,22
dRbHGQcLPBCTSEWIJZMYfNDeUVFKXaOAg,RAAAHAAAGADALADBCAFA.EAFA..IAHAZBFEMCAB.fDCEhAAAeCCBFCFDaCHBACCAdDGAhACA.QEEAhAFABDAATFAASEHH.YHBADDIBKFFAOHFAhAAA...hAIA...,2,-16,-3,13
DCTGgINaHFVLfXMEUAKJcedBYWPOQbSZR,KAAAeAAAdACABADA....PAEAbAEDRAGB.DAIBGCCA..hAAAICEAHEFALGCAhABAMBHB.AAIBcGAChAGAOCFDZEBACGHA.TFGAaHEE.....hCAA......hCBA...,2,-35,-3,32
gJefdFNGYKRBcILDMQAWHPZXTUaEVOCbS,HAAAZAAAUAEAEADECAFB..SAGAeAGHdCADGCEARCAA.BCHAhAAALCHBMDDBAAIBXDEAhABAaEGD.OEBChACAbGFA.JFFF.FHAANECA.KHDADIEA.....hADA......hAHA...,1,2,-16,18
ZfWQISUcNabYgdFXRLKTBOHCAJEVeGDMP,EAAAeAAAGACAMAEAZAFEQAEA.SAGAUCCAaCFD..hAAA.bCEAdCHA.RFDALDBDhAAATEAAHEEAAFDADFHBhABAfCBE.IGGAYHDGFGEHhAEA.BHAA...hBDA...,1,19,-18,37
INEFVHJMAbLPUWTCBGQDedZaYXcKSfOgR,LAAAUAAACADA.GADADAFA.eAFAZAFE.aBGE....XCBAhADASCAA.ODDHhABARCEAEDHFHECCAAFAbEGBTFEAhACAdFGDKGEAIHCAFHDC....hBAA......hBCA...,1,-1,-26,25
gSMbWafDAVEKBeINHTGdLFQXJZcRPCOYU,EAAAeAAAHACAdAEALAGBQAFCZBAERCCAOAHDUDDA..MAIBhAAAaDFDADHBBEBA..TEAAhAAAGEGAXFEChAEAPGBA.CFHASHAA.fHFBhAHAKGEA....hCAA...,1,-2,-12,10
AHUVSQaWdBTEZIKgFRDbOLNGfcCYJMeXP,HAAASAAAaACAdAFAEADAZAGB..KAFARCCAOCHDGCCA..CAHBMCFAhAAAeEEBACCA..QDAAhABATFBAFEGHbEFA.hAAALGEAfGHA......hBFA......hBIA...,1,-8,-9,1
HAIbOWMJTKfCXFEVYaDgBPURSGQdLeNcZ,OAAAMAAAKADA..XADAEAFE..aAHDBAGA.RCCAGCFAhAEAdBBAeCEBZFGBHDCBAAIB.hAGAbEGBJEEF.CBBDFCHFDFGBgGCAhAHA.SCGG.hBAA......hCAA...,2,-23,-5,18
XWFOEAQfGeRcbZaITLHYCKSPdVJNUMgDB,GAAARAAAZADB.aADALAGBHAFBKAHBdCCC..VCDBUEEA.MAIBhAAABDGA.FEBDABFAeDABhABAbFFA....IHAAhAAATGCACCFCSHFAJFHB.DFFA..hACA......hAHA...,1,-10,-16,6
ZXMdSgLVCWFKceYPHBNAfbEaGUTRJDQIO,EAAAGAAARACA.QADAZAFBdBHALCEDCAFAKAHB..eCDBHDAAAAABaCFDhACATEGA.DFABXDGDhADAMHCA.SFDAhAHAgGGAFGGA.PHCABCCDNIAB..hAAA......hADA...,2,-6,-3,3
caTdIbYBfVgGLAUPFEeCQRXZJDMWNHOKS,FAAAEAAA.eACHRACAZAFBDAEA..MAIBHAFCKCCDaBDD..dDAA..bCEDhAIABDED..fCGEhBAAGCGAAFCACFFAQFGAhCAAXFCAJHBANICBSGEG..hCBAIHHA..hAAA...,1,-3,-25,22
eObgIYBHCPRJQVDKWZfdMNGaLcTXUFAES,EAAAeAAA.OADC..bACA..gAGBBAGAHCCARCCAQCFChAAAKBHBZDAFdDGAGEEAhAAAaDHDLFAATGCAhADAFEEHAEABSECACGFA.....hABA......hAFA...,1,1,-13,14
BPcVRTJQeZHdMGCAbLgfEUYDWNXSIOaKF,LAAAEAAADADA.XADDOAEE..FBCBBAFA...PAHBhABARCEATECA.eCHHhAAAHCAAGGEBACGBbDECfEHAhACA.UFAAYHAASFDAhAFA.aGFDcEEDhAHA...,1,0,-28,28
WORfDVMSeXFQdAZKLUTIbYHcPEaNCgJBG,ZAAALAAAUAEA.TAEA..bAGDHAGB.ECAAaCAA.CDAABDDAhABAGCDA.RDFFDDCBMDFBhACAeDHHFEBD.AAIBKEAB.hADAIHHAPEGBNEIAgGAA.OFDHhABASGBA.hACA...,2,-19,2,21
AfbQTEGYZDeXVFWSgOcPJLdKBCIMUHNaR,QAAAEAAAZACB.eACAFAED..SAGAOAFCJCDAdCBCCCGB.MCGBhAAAHDAAREDB.AAHATEEAhAAADCHB..XGAAhAGAgEGBLFHBBGGDNICBaDEF.fGGAhAHA....hBCA...,1,-6,-12,6
NMdTWRCEAHKcgaUeBGQSbDPYLVXfOIZFJ,HAAAKAAA.aACAeACEGAEAQAFCDAGALBGB..fBCAhAAAZCCFFEHDMFFBdAHARDDAhCAAABIB.UDGASGDBhAAAbFFC..PECBXGGCIHHA.hCAA......hDAA...,2,-9,-2,7
WDUCecTEXYPRNaVgfFBKLJMAIGQSdbHZO,GAAAdAAAHADAZADADAFAeAFEEAHF...XCDARCAA..aCEDfCGAhAAAKCGDMCIBAEDBQEABhACA.bECDhAEAOEGDCEED.cGFCTEGA.NIABFGGH.hACA......hADA...,1,13,-29,42
BcVPZRSIGEONfbTHeAXWKLgCdaYDMFUQJ,KAAALAAAdACADAEAMAEA.FAHDQAGA.BBEAPBDChABARCEAGEBAECAA.ODHDhAAAbDDAHEGB.ADDAXFDAhACACDDDaEFD.YGBAJHEA....hBGA......hCAA...,2,-22,-13,9
PYDfaWXMVZFGNJKLTUIOgRQHbEeBdCScA,DAAAaAAA.MADAZACBGAEA..KAGATAGAOBBA.RBEBHCGBhAIAECHFeDEDdDDA..SCCDhBAAABBBfEBAXFFChCAAFEGHLGAA.IHHAQGCAhCBA.CGHA....hAGA...,1,-11,-13,2
YHDXAIMNBKURLVgFZdSPQbaGWCcOJfEeT,MAAAKAAARACFLAEBFADDZAEB..dAHAQAGAGBBA.CCAAOCFDhAAAECGB..eDHHHECAhACAABBBBEEAVFGBSDHBhAGAaFGHJGBA.fHEBDGIBXGED.hBIA......hCAA...,2,-12,-11,1
gZWYAEFJDGeINMBTHabXdKSOCVcfLPQUR,EAAADAAAeABA..MADAHAEAaAFEdAHAOAHDCCCA..VCFBLBCBhAAAQECARCFBZCDBACCBhBEAGGABBEHAbFEDSFFAhAGA.fGHAgGGB..hCAA......hCBA...,2,-14,-6,8
ZPUOaHQRWMGSBATfXLIdEVJgYDcCNKbFe,TAAALAAA.EAEAJACADAHB...CBFA.KAFCFCAAeAHF.ZCCAOBHDhABAHDFBRECBGDCAhACAACEA.XCECdEHA.hAAAVEGB...gEADNICB.bFEDhAEA......hAIA...,2,-15,-13,2
UAVdcbCXOLYQNJZMPDeTGFRSHafIKEgWB,dAAACAAALACAQADAZAFB.MAGBDAIBGCCARCAAHCGB...aBHHKAHBhACA.EDEBBDAAAFBAVFDBhADA..bEFAOHAChAHAJFEF.TGGAFGGBSFCD...hBAA......hBCA...,1,3,-21,24
BLGMSNTUaHCFgKQVDYIcOJRPebAXZEdWf,EAAAdAAABADAGACAMAFA..TAEAHBDCFBGAQAGCDCCB.hACAIDFAODABRDDBeCBBhAAAADGAZFGBLDHBhAEA.SEDHaDGEKGFD.cFFB..hAIA......hBCA...,1,-7,-20,13
GMCHKBPXRFIWceYdJVSZTEOUgLQAbNaDf,aAAAGAAAHACBBADARAEA.FAFA....ICGAeAHHdCDASAHBhAEAEBFBODAHLDEBhAFAAAABDDFB.MBBBKDHB.hACAXDGA.cGFBVFGB....hBAA......hCAA...,1,-20,-21,1
OJMWNCUZIKfLHPEXQdBGRYbaFeDATSgcV,TAAASAAA..VADAMADA.CAGAZBAEKAGCHCAC.EBHFdBEAhAAARCFB.aAHDeDEBACGBODDBhABANDIA.UEFA.LFHBhCEAXGGDBDHB......hDBA......hDCA...,1,-5,-19,14
VYLQBPMFAfZHEDXeKCRTdNUWJGSIbacgO,HAAAEAAADADAeACE.RAFFdAHAUAGAGCCA.SDHBaBCAOBEDhAAALEFBQDCChBGAMEHBACCAZDGBCFAA.TGDAhBIAWFDH...IHHA....hCAA......hCBA...,1,-1,-25,24
fFUCYMLHOEJAgIVQWDZbcGSdPBKRNeTaX,VAAAQAAA.ZACBGADAdAFAKAHBRAFAeCFA..aBEBFDAACCGALDFAhAAAHEFAEFAAAAFA.hAHA.IFFADDDBSFEDhAAABFHA.NIAB.fHFB.MEEBhBCA.....hADA...,1,-10,-17,7
fMXNAbSOZWIgGPeBCRTLdDHcFVQYKaJUE,OAAAZAAA..IAEAGADAeAFABAGARCAAdCGA.HDBBFBHD.QFDAhAFAKCEA.aDHDhAGAEECAMBBBAACA.SFGDhBAAPEFA..TGAADGIB...cFFChABA...JGCAhAGA...,1,4,-35,39
OTJEIYLeBgGcHFPXZafVbUNMASDWCKdQR,DAAAKAAARACFOABE..EAEELAEBBAGBGCAAHAGBFCCBZCDB.aDEEhAGA..VCFAUFFAAAIB.hAAACDHAdGBA..TFEAhACA...IGHA....hCAA......hCIA...,2,-26,-26,0
APGZeWHJgbUYFfEdKTDBIMSCLXaOQRNcV,ZAAAHAAAJADAUADA.FAFEEAGEdCAD..DCAAMAIBLCEA..hABAaCEEREEA...VDGBhAAAACFAeEHH..bEEDKDDDhACABDDDCHEA...OHCC...cGGDhACA....hCHA...,2,-33,-18,15
MVSQbadCcBKOGZIADLgYHTUJRfFWNXEeP,LAAAHAAATAEARADFFAFA..XAGBEBHF.eBHHMCABQCABhAAAdCFABCCDGEGAhABAACEBDCGBgDDAhACAUFDA.fEAENIAB.SEGAhADA.aFFC.KGHB..hAEA...,2,-14,1,15
YfRBOIGePFDgJCTVQKSALWHbEXNMUadZc,HAAAEAAA.MACAdADAZAEB..fAFARAGBOBCHGCFAeAGHDAIBhAAACEED.TCCA.QDFBhBEAAAIBLFHBbECChCAANDBA.aDHDBHGCFGGA........hAAA......hBDA...,1,13,-21,34
PZSYGBCNAdDOEFKeXMLWTRbJIfHcgVaQU,dAAAEAAAKACAeADA.MAHBLAEB.RAGB.ICCAHCCB..gDGAhAAAaBEEUDEAZDAAhACAGGABCDHA.AAIBFFECTFGAhADAfFHAQGEC.....hAGA......hCAA...,2,-10,-10,0
ATYgMfNSFEGOPQXUWJVDbKaBCdHZILRec,TAAAMAAA..SACAEACEGAEAQAFAUBGA.VCCAhAFAbCCDBEAAHDFAZFCAREGBAAGA.hAAAfGGAOFFB.hAEAPHBA.WAHHDCCB.CBBD.....hBAA......hBHA...,1,-7,-9,2
FcVTdSHXEGQJLRaNBWZAbfKPMeIgYUCDO,KAAAeAAA...IAEAUACAOAEC.FBHDTAGAHCDCEEEBhAAAGBCA.LCEBhAAAREGBaGAA.BCGDAAHA.bEGBhABAMIEACGAADFGBdGED.SGCH..hAGA......hCAA...,2,-17,-14,3
AJGPDMgYVdQHICNfWFEXTKecRZaSLBUbO,GAAAMAAA..VADAHADA.CAGB..fBHAEAGEKBBA.RCDAZDFEhAAAaCEELCHBBDCDODAHhACAADDBDEEAdFGA.QGCAhADAIFFAFGHB.eHDAcFAD..hAFA......hAIA...,1,-2,-21,19
fdAETNWBRXLgFbaGIYCHVeJSUKQPDOMZc,EAAATAAABACA.RADF.LACB.FAEAGAFACAHAHCEAeAHBSCGEhAAAQDDBOEBAhAHAZEGBdFAAAEGA.WCCDhAAAbEFAaGGB..IFFA.JHDA..hAFA......hAIA...,2,-12,-7,5
VHAQWCESPLIYDBTJZGRMeUdfFKgcXObNa,QAAAEAAALADADADABAHAZADEGAGARCBAUCFA.dCEA.KEDDXEAChAAAODHD..aEGHHECBhAEA.ABCBSEEGhAFA.IFHATGDAMIAAeHAEFGGHhAHA......hCAA...,2,-16,-4,12
eUbWLMcBHTVfEKFOCAYZGXaISDgRNdQJP,GAAAaAAA.DADARACFdAEAQAFA.eBHHbAFDLBHBhAHABCDAHCEB..TEDAhAIAEDCBOEHDABBBZFGBSGEAhBAAgGDAPHFCWHCG.....hCAA......hCHA...,1,-3,-16,13
dbgVDcWFZMAeBOHCQPYKGXfEaNILTSRJU,eAAAHAAAQADCKADAGAFA.EAFE.aAHDLAHBRCAA.dCCAbCEDhAAADDFBFCGHAAAACEDA..XFGAhACA.fHABhAHATEGASFAAJHFA.gGGAhAFAWEDD.MHBA.hCAA...,2,-16,2,18
RgKHTBEVeAGSDXbfFPJNcLYIOQMZdWaCU,GAAAXAAAFADA..JADALAGB.OCDAZAGBaBCDRDBFHDDBhAAAECEAAAAA.DAIB..bDFAhAGAfDHA.hBIAPFGBcECAQGBBdFFACHGA.KGEB.hCAA......hCBA...,1,4,-24,28
WgeRYJBEfVZOQdPGcMaLHCIbDSAXUFKNT,FAAATAAAeACH.RAEA.BACB.EAEAZCEAdAHAGEAA.MAIBHBFBhAAACDDD.bCCB.ADIBKEAA.hAEA.gEFBhAFAJEEBOFHBQGCAaGFDDHBA.SFFDhAHA......hBAA...,2,-14,-7,7
SGQEdTWMbNRJHXafPcBUIDeKFYVLgAZCO,ZAAASAAAEADE.dADAMAFARAFA.HBECaCCC...fCAAhABABCFDDCHBeDBBFCCHLBHBhACAAAAAGEEATEDAhCAAbFAD.XFGA.cGFCKEHB...hAFA......hAGA...,1,7,-22,29
aOZSLYBfMcgEUdJbPCGXHTWAINRKDFVQe,RAAAFAAAeADEZACBLAFABAGB..MAIBEBEBdCGA..JBDBCDEDHFFAhAGAAAAAKCFA.DCIB.QGDChAHAaEEA.SHFAhBAAfEHA.UFCA...PFFBhCAA.....hCAA...,2,-28,-19,9
BbOGcdWETHCLgQXDSZAJfPUeaRKYIMFNV,JAAAUAAA.RADA.KADC..MAHBFAFDBAHAGCBB.dCFA..ECCAHEAAhADALCHBQEGAhAEADDEA.AAIBeEEB.hAHAaGACIEEA.VGEAcGGC..hAGACDGA......hBAA...,2,-43,-3,40
PVEXUYadeONBKRfMHIQGLFJACDTgbZScW,TAAAZAAASACE..PACAEAFAUCCBdAGAeBDABAHARCFAHDDAhAAAGEGALDGBhAIAACFADEFB.bGFA..VFAAhABAaFDCKCCDMICA.........hBIA......hCAA...,1,-2,-10,8
TLYAbBXDFWeSaJgGcCOKPEfMHQVURZIdN,XAAAFAAAeACH...aADAGAEA.OAGFEAGAHBCBQDGBhAEARCEFdCGATEBAAAIBbDDDBEBAhAGASDHH.hBAAgFGGKFHBMICAZFFFLGAADDDB..hAAA......hABA...,2,-4,3,7
adEGLMWebfVNSDQYORUJZgPXCBFATcIHK,TAAAHAAAdADA.EAFAGACALBHBeAEA.VBGBDCABQCEAhAAA.RFAAZEEAXCAChAAAFCCHACHBKGDAaCEDbEADhACASGGAOEFCgGGA..hAEA......hAFA...,2,-5,2,7
BegFMNbGRaXEUWQJKfdcPIVYTZCSOHDAL,eAAAMAAAGACBRADA.EAGEQAGC.KCCAdCCA.ICFAhAFATDEAZDGBOBBHhAIAHEAAACHALDHBhBAAFGDAaGHD.XEDA.UGEB....hCAA......hDAA...,2,-10,-10,0
IXSVRKPJHQOfTaBDNcEYdgMALbZCeWFGU,ZAAAeAAAGAEAUAEA.SACERAGB.KAGAHBCB.QDFChAAATCGADCCBEEBBdDDAAAIBbFEAhABAFEGH....XGAAhABA.........hBEA......hCAA...,2,-21,-16,5
KadULWPOTFCVNIRYJQgEfXecSMBZbHDAG,aAAAdAAALADA.OAGDTADACCBA.IAGA.RCCBQCEAhADAECEBeCHHMDDBhACAbCGD.HEABGFABKEEDPFGBhAEAFFFHNAIA.gGDAfHGF..hAFA......hBAA...,2,-7,-4,3
BbUKCMGVXEHZJPOLScDRaAgQFIdfTYWeN,QAAAdAAA..TADAeACAbAFACAFBGAGA..ECDAHCAChACAZCFBODABLDEBhADADDCBAAIBFEHDfDEAhAAAYFCBBDHAKGFA.MFHB.XGAAhADA.SHDAhAGA...,1,-9,-11,2
aUFBdHfeAYOZVLRMGgITKDCbSXQNJWcEP,ZAAARAAAGADA..TAEACAFA..XAGDQAGC.JCAAhABAECCBaCECBDAA.HDFAhAAAAADAOCHDMFAAKFDAhABAbEEB.SFHB.cGGCFGGAeHDGhACAYHDA...hAIA...,2,-18,-7,11
eAUDYdCJTQOVWZHPfSabEGIMgFLKcRBXN,DAAAdAAACADAQACA..OAEDZAEBHAGBSAGAEBBBGDEBhAIAMCCBLEBBhBAA.RFFABHHAeCGBAAGAYDDFhBEATDDAPDAB.aCHF.bFFA.hBGAFGEH.....hBIA...,1,1,-19,20
MOPVfQDHTYcKgAbXLIBWSGaRNZEdUFeJC,LAAABAAAGACARADFEAFEdAEB.eAGH.MAIBOAHD.fCAAhABAHCABTDGAKCCDACFAhACAbEDD...XFGAhAAASDEAZFBB.FDHHCFFC.QFDAhAHA.DFGB....hCAA...,2,-21,7,28
EPQBIJcGCWFaXUYdHDTReSZNOLAVKMbgf,MAAA..bAAAEADAQAEABAFA.JAHBGAGA.FBBBaCAAhAAAXCDAdDDAHEABRECAeDHHhAIAZDEBLEHBhABAACDAKGDA.fGFAIHHACGFBYHAGDIBA.hBAA......hBIA...,2,-16,9,25
SOQJRXZdgKUTGEHYfPIFMBAaLDeNcWVCb,aAAAeAAA.....NAEA.VADA.SAGBQAFARCCBdCGDhADAKAHBGDBAHEFAfFDAhAIAFDGAAAAALEFBhAFADBBBCGHAOHECZFDB........hBAA......hBIA...,2,-15,-15,0
WeZVOHXagTNLQGCJUFKSDPdRbcAfIEMBY,EAAAMAAABACA..eACAZADBHAFAaAFD.TCGALAHB.GCCAhBAACCCCFDEDDEGBREFAABBBfFBAhBFA.IGEAhBHAVFCBXFGDNIEB.....hCAA......hCCA...,2,-19,-14,5
NAdZISOFTGLWcVJRgYCUPQXHBEMebKafD,ZAAAOAAAGAEALAEA..VCAARBBACBHAUDDAQAGA.hAFAHDFBECFEeDHFaACADDEBhABAAEGBdGAAFDHF..TGAAhAGA..cGGC......hAGA......hAIA...,1,0,-23,23
FgCXVQWRUBIPTSZdfaeAYDKbEHJGNLOMc,KAAAHAAAGACALADBMAEAFAFA.CBFDQCABRBEFBAHA..TCAAhAAAdCHAeDEA.AAIBDFDAhAAAECGAODHD.hACAXEBDUFGA.SEEA.aGGBhACA.bGBA....hBEA...,2,-17,-12,5
eMYCZXIEWJSVGBcdURDHLTNaOPfFKbAQg,eAAAMAAAZABEEADA...SAEHGAFAdBHARAGBHCCATCCAaCFDODFHhAAA.FECHAAIBQEGAhAGACEHA.XGGChBAAIGGAJEEFBHAADIDA.NEEA....hCAA......hCCA...,1,-8,-9,1
YJBHASGgdeIQXCLfKVOMWRNZTPcaUbFED,GAAAeAAAQADALADAKAHBMAGBRCDAZCGF..TCCAaDCHFEAHhAAAEAHB.DCHBBEFAHEEAhAAAADIBdGGACFBAOEHD.hACAPFDB.cGEDYFEF.SHAAhAEA...hABA...,2,-10,-6,4
EQLPOeSRZgGWdXICbKNUJfaYBcFAVHMTD,HAAAMAAADAEAEADELAFB.eAHBRAFAGBBAdCADCCEC.KBEDUEEAhAAAaCGDBDEAACHB.QFFAhAIASDCH.ZGFEhACAXGDCIEHANCIA.......hBAA......hBBA...,1,-2,-29,27
GcaIUDMLgAHJdBbfWKPFVOXQNeTYSZRCE,HAAAdAAABADA..bADBKAFAFAFDOAHD..QCABhAAAeCAA.TCGAZCEAEDDBaAHFhACADEGBMDDBACFA.fEEAhBHAVFAA.XFGASEHHRGEE.CFEAIHFAhACA.LHAAhADA,1,-7,-18,11
SDNEWcTKQMbdALHCGJOfPZUBIRYVageFX,HAAAGAAAOACAZADABAGBRAFA..aCCAeAHHFCFH.DCDA..ECHBTDDAhAAAMDDB..AEEBLFFAhAAAfDFBIGAAhAGAVFAA.SHEAcEGDKGFD...hAIA......hCAA...,1,-12,-15,3
McTUdIZBCFSHegKYXONbPDfLWRaGJQEAV,MAAATAAAdAEA.ZAFBFACAHBBBKAFA..OAHD..bBGDDCCALEBAhAIARCDAGDGAEFEAAEFAUFAAhAAACFHAeHFA..XGCBhAFA.fFFE...hBAA......hBBA...,2,-13,-13,0
BNJUKTZWYPRVcFGbQaOIdDfLgSeHCEXMA,BAAAUAAAZADA..PACARBGFFCDA..GEAAaAFD..dAHALEEBhAEAeBCBHDFA.EECBhAAAAAFAKEGD..TFGAhBFA..YDDFbEDDOHBCDDIBSGHBhAHAMIFA...hBHA...,1,-14,-21,7
CHDaPUMOIGKcZFASBVQLWXgNbfETeRdJY,BAAALAAA.XADDbACA..EAGARAFAdCAA..CBHAHCAAhAAAaCCCMCHBGCEB.ZEAAhACAAAFAQDEAhABAgEEBTGAAeEHHDGEAOEHB....hADA......hAEA...,1,-8,-14,6
VDJBXTEfZYePQIcKNLbHRMOgdUaGWSAFC,CAAADAAABACAEACA.ZADB..eAEA..QAFAKAHBLCCAHCABhAAARCFFMBBBdBHAGDEAhACAADIBFECA.XEGB.hAFATFCAfEHEIHHAcFFC.OHCAhBAA.aHGE..hCAA...,1,-11,-22,11
XIKTUNaGEcDLOSVJZABHbQPYCRFdfeMWg,HAAAQAAACADBRAEF.dADAeAGHMAFA..XCAATBFAaBHDECHFLDDBhAAA.SEHHhACAZDBAADDAbDFCFFBAhAAAfFFAgFGAKGAANIABDGFBOHFCBHBA.hBCA......hBDA...,1,7,-6,13
JXFRNZeQMOEDCTSVAcLPdbYgBafGWHKUI,LAAAdAAA..bABDBAEAGADAHAFBKAFAIAHA.FCAAhABARCFAeDABMCEBECHFTEGAhADAADDB...PFEBhAFAaDFHfEAAUGGBJHAA.ZFGBDAIBSGEAhACA....hAEA...,2,-17,4,21
HTYKDMGJPXZSIaELCNgcdFeWfUVbBORAQ,HAAATAAADACA.GAEAJACA.ZAGB.aCCBEAFE.LAHB.hAAACCCA.gDDDhAGAdCEAeCGDUFGBbEGBBEBDAEDBKHCAhAAAMFGB.SGBA.NIBBWFHHhBEA......hBGA...,1,-7,-21,14
EGSVCDJPKcOFdMgBIZLQAaeTYNUfHXRbW,eAAATAAAUAEA.HAGDRACFEAEEGBCA.CDGD.DAGAKEBBFBGDdEEAMBIBhAAABEHAZCDB.ACABaEGBhACA..fGFAhAAA..bFEDSHGA...hDBA......hDCA...,1,-16,-21,5
GFaXWgOVScfdJURbYTLNPIDMEHZQBKeAC,GAAAaAAA..XACDOADASAGA.dCDARAEAbCDAhAEATCFALAHB.hAAAIEEAEDHFHDBBZEGBhAFAQFEAeBBDAFGBFHCAgGGB.hBAAfHAB.hCAAJHCA..,1,8,-11,19
KIaFOCdTbSZeHgJNfDLXBRPEcUMWAYGVQ,GAAAQAAAaADAFAGAdADA..SAFAHBFAJCDB.DAIBLDHBhAAARCDAECGE.MDCBAAFAKDBACEFA.hACAZEFAeFDF.fGGEhBAABGEAcGGA.......hBCA......hBDA...,1,-6,-18,12
WMPATUReZXdBVYHKGOcgQJDbLfENaCFIS,RAAAeAAAdADABAFAHADAGAGA.OCCBQBGADDEALEEBhAAAECCB.aDHDFCEDSEGDhABAMDGBAAAAZEGBXFAChAFAKFAA.gFCHfHABCGHA...hAGAWFFD....hAFA...,2,-36,15,51
FLWZGMgNVJaXSDTCBIPOfAceQYbdEURHK,eAAAQAAAdAEARAGBHBCBLADAGCFAMAHB..VEBBaCBEDAIBhAAABEEDOCEBAAAA.bCFDhAEAEEHF.FGAHZFAANIDB.SEHBhAFA.TGGACGHA....hBCA......hCAA...,1,0,-8,8
eTQSPFBJVfcLdbMWaREgOIKUYDNHCZAXG,eAAATAAAQADA.FAFEBACBJBHB.fAEALCCBdEEAhAAAbAFD.MCGB.aEHDhABAEAHB.OCCBKGGDDIAAhAIAHEABAHFB.GEDA.SDHHhAAA.cFFA..hAEA...,1,-9,-17,8
MFBRLHdcWJgZTKeYNAaUCPEDOGVISXfQb,aAAACAAADACAGACA..SADAQAEAFAGARAGBHDFA.dEAAhAEAJBCFZFDAKBFAeBBDACEB.hAAAEFHB..OCHDhCAA...XDFBMIAABEEDLEEBhCBA.gGGAhDAA...,1,13,-42,55
eaADMUXGQIbNgLcTVSYdJBKRfZFWCEPHO,MAAAGAAA.QADA..bABALAGBTAFASAHBhAFAdDCAKDHBREDFZFGFCCCAHCEAhBAAeDADAAABXDGAhCAA.gEEGcGCC.YFHF.hACAfHCB.hADA...,1,-2,-9,7
bfdJERKLPHOVAXNSTBcIQMCWZYUFaGegD,SAAATAAA.BADAQACC.MAEAZAEBFAGDeAHFbCCBhAAAdBFA.RCDBLEGBhAAAHDABAAIBXCGAIFCAhCAACEEAUFGAaFFBDCIBEGEA.......hCFA......hDAA...,2,-11,-5,6
PBKTSLIHZDEQWRaAgfcCbVGMXUNOYdJFe,...fAAAbAAAGAEAMADAUBGAOAFEdCAAFCCHBBCA.TCAAhAAALEEA.HGAAhAAAECEARCGBAAGACFHAXDDChACAJGEA.eEBF.SEFHDICA.aFHDhAIA......hBCA...,1,-5,-10,5
JSFEfdOaWRINGXCegYLZAKBVMHUTQcPbD,BAAAHAAATAEAQACA...bAEASAGB.ECABhAAAdCAAaBHDRCDAGDGAhAAAeCCBLEEAAAFAMAIBPFEBhACAFCFDOEAB.IGGACGCAYCCF.hACA......hADA...,1,-4,-7,3
gdSADBMZQfKTJWUXCeEbGLRaIYOHNVFPc,MAAAZAAAQAEAKADA..TAGAUBGAeCABEBBB.GCDAhABARCEAaCHD.OCCBHDCBFEGHhAFAgFFAACEABGAAfGHAhAGAJHAACEHB..IHHAYFFF.hACANIAB......hADA...,1,0,-9,9
TRWUdQZODNFaABGJcLSfIbHKeVMPYgECX,GAAALAAASADA..bADDHAFBeAFAMAIB.gCDBhAAAEBHFTCAARDGBdEADhACAZCFFDDIBaDDHAADABEEAhABAfFFAKFAAPHEACGHAWHAA....hAHA......hBAA...,1,0,-10,10
dGXReaHNDAKZQLOEFfPgMcJBTUIbYCWSV,ZAAALAAAEADE.FAEA....fAFBMAHBBBDATCAAhABAICAACAHB..SCEAhACAGCEAREGBHGCAhABAACEAQDGAOCCB.gDDG.cFGChCAA.JHCA..hCCA...,2,-21,-18,3
VJQcgKYFWedfCDTOSaMINPZbEBAXULGHR,LAAAHAAARADFQAFCKAEAFAGA.eAHHdCAADCCATDAA.aDDCMCFAhABA...IDDAhACAZDFFEDHFAACA..GDFAhAEAJHAAYFFFCDHASFDB.PFHDhDAABHHA.....hAAA...,2,-23,5,28
eGJRaPdbOSFAUKXQVTEgCYNfZMHcLIDBW,XAAATAAA..EACECADA.....fAEBHAEBLAGBhAAABAGBeAHHRDAAdDDAbEGBhABAFCCAACFAQFEAhADAVDEAgFGAZGBAMAIBDIDA......hAAA......hCAA...,1,8,-21,29
OVILcFNHSPTbEJBXMeAGRQCadKUZYfWgD,RAAAaAAAdADAZACB......fAFADAFAOAHDLAHBhAAAFBEAHDEATDDAEECBBBBDhBAAeBGFAEIBGGDBQEGAhABAKHBA.UFAA.gFDA.IHHAhAFASGGE.hCAA...,1,-10,-17,7
IYETFMGVSPWLfbeJXHgdKQcANZUBaORCD,ZAAAaAAA.RAEADACA..EADAFBHDGAFA.SAHBLDDAeECBhABAHCCAdDAAKEGAAAHABBBDhADA.CDHATEEAMFAB.hAFAPECB.fFHAbFDDXFFC.hBAA......hBFA...,2,-23,-11,12
YeKPOEcFGNJaDQXARHVbIBUMZWSdfTLCg,HAAAVAAA.BADBZADB.dAFALAGBCAHA.eBFFOCAB.ECCAGDAAhAAA.aCHDQCGAhAAAREEAUGGAMIAAfDEAhACA.TFBA.KEGD.FFHD.hADADFFBADCB.IHAAhAHA...,2,-23,1,24
OIcTDVJBYQMEXgaSHWAfLeGPRNCKbZdFU,eAAARAAAKADCZAFBdAEAOAGB..TCCADAIBBBCA..MAIBhAAAECHB.aCGDHDDA.AAAAGEBAhAHACBEAFEEBUFGAIFFAhBEAJHBA...YEHF...hABA......hBHA...,1,-14,-25,11
VWMIdUfTFJePAKEDOGZNBCRQaYSXbLHgc,EAAAGAAAZACBBAEARADAQAGC..aAFDXCDAHBGBVDEBhAAAMCIB.dDGAUGGATGEAhAAAeCBDAADA.OECDhAHACDCDSGGB........hACA......hAIA...,1,-11,-14,3
aRJEIMdVYDLGfNCAHgWbXUQcPKOSTZeBF,HAAA..bAAAQADCKAEA.TAGAeAGHaBHDECABdCFADAAAGCDAhAEACCCDAAFA.XFCDhAGAPCHDZEDARFFAMCCBhAIALHFA.NIAB.WHEA.....hAAA......hACA...,1,-4,-7,3
PNFIfGDTRcaLOYZXWMKVgSebBUAJECHQd,EAAAHAAAdADAFADAGAFARAFFLAHBZCBA.MCABKAHB..SDEHhAAABCCAACEB.QEGAhAFA.IFBAhAHATDEAaEGDXGGCgGFG.eHCE.hBCA......hBDA...,2,-13,-10,3
cGgUFaCVPQIDWXbJETSHLfMYOKAeNZRdB,eAAARAAAdADAGAFAFADD..aAFACAHA..QDDADAIB..bBEDhAAAECHFHCGDLFAAhAAAMCCBKEDDACCBZFEEBFFA.hABAUGCBIHAAJFHB.fGHA.hABA......hBGA...,2,-15,-7,8
LeQWYVKFPAcSINZgfCHEDGMUaJTXRObdB,SAAAZAAACADBHAEBGBGAMADA..aAFETCAA..RBCAdCGAhAAAeDDBQDBChABA.VEDAFFFBAAGAIFHAhAIAfGBAEGDBDBIB.XGGCBGHA.hABA......hACA...,1,1,-21,22
YEFQDcZXJCGARdBUbWHIaVNgPfeTOMLSK,RAAAdAAABADBUADAHAEB..aAFEVCCB....PBHDeAGBMAIBhAAALDBAKDGDEEHFhABAQDFCZFEF.CCCDAFEBhACAIHAA.fGGETFGASGAAhAGA.DIAA.hAHA...,1,-14,-20,6
TfKZBGHLJcVagAFDbPWEdXUONMRQYCSIe,DAAA..bAAAEACAdAEAOAECRAGB..QCAASAGEeCFFhAAAKBBDGCDAHEBCLEGBhABAVCFA.AAIBFGAAXFCDhBAAMDIBCDDB..TFFABGFC.aDCB.WFHBhCAA...NICB..hACA...,2,-7,1,8
OUKNXdbCBYPVaFZGcJRgDETHWLASeQfMI,eAAAMAAAUAEAKADAdAFABAGA....PAHBaAHDGBBA.hAAARDEA.ECCAHFDAADEAQDFDhABAODHD.bGFACGHD.hBAA...YEBF.....hAIA......hCAA...,2,-31,-12,19
NVRTQgFSHbDUXEAGJWCYIMdKLPcaBOfZe,GAAACAAA.MADAdACALAEA.aAHDfAGAZCBA.hAAAeAHHRCFBQECChAFASBFDHFEAbCDDXDGAhAAAADHAJHFE.IDCAKEHBBGAAOFEEhACA......hBAA...,2,-18,-8,10
gOHITACDVaMWdSRLZQKYXGEbJUcFPBfNe,DAAAaAAA.dADARACF.ZAEBKAECGAGA..EAGAUBBAFBHD.BDFA..hAIAeBBDHFFAACFAMDEBhBAALGBA..QDFChCAA.bECD.JFGB.....hBAA......hBGA...,2,-30,-15,15
TLAbUDZQCJSYERcdefIBFgXaKWOMGVNPH,DAAAZAAAQAEACACA..SADHRAGBeCABBCCDFAFAaAHDOCEBhABA.GDFA.hBAA.PBBBLEHBhACAABFBUDDAYEAFECGBdEGD.IGGA.hADA......hAEA...,2,-32,-9,23
YMSDCNALUZXGKbVEHOJTaRgBdIPcWeFfQ,ZAAAGAAAKADC.EADAHAFAOAFC..aCAARCDAdCGA..ICEAhABAPDCB.eCGF.QFEChACAMCIBCEFDAAABLHAAhACAbEGDJHAA.TFGABDDD...WDADhADA......hAHA...,1,-7,-12,5
RSGcVgIPebafJODYKCZBFAXdELTQHWNUM,EAAATAAAHACA.UAFARACFGAEA..gCCAeAGBaAHFOCABhAAAKAHBZDFAADGAdDGDLEABhAAAQEDCMEEBSEAHhACAIFFAfFHEDFGABGGA..hAEA......hCAA...,2,-12,5,17
TgGZPCAXWVabSYHROIQJMEDBFNUfecdLK,XAAAaAAA..SACHHADARAGFQCDBEAEAFAGD.fDAAhAAAeBBDdDDATDGAhAEAZDFEAFGAVFAAOCFBMFIBhABABFGD.NIAB.cGDBKGHB.....hAIA......hBAA...,1,8,-18,26
IWgZMLVdAeNKJQRbDFYUSPEacHCXOTGfB,eAAAKAAARACF.FADDUAEA..EAFAHAGD.OCABGBGA.BCCDhAAA.gCEFhABAZDEAMCIBdFDAAAIBQFAAhAFADFFBSGFHaEFDCFHA........hAAA......hACA...,1,-11,-26,15
bfWDMeAVXgYSEcFTHKZIJaRONCBPdQGLU,XAAASAAAFADAHACB.ZAEA.aAGARAFFCAHBBCEAdCDAGCGAhAAA.LDBBbCFDDCIBAAAAhAFAVFDAEFEB..TGGAhCAAKGHB.OHDCNICB.......hABA......hBDA...,2,-12,-5,7
fHDdVcTaUPgIYJEMFKXZONCeQBRAGSLbW,GAAALAAA..bADAHADB.dAFBTCDAaAHDUCAA..gBGHhAAAIDFAEDDBhABAMDABKDHBZDFE.CDCDeFAHhACARFFAABGBSHDADFCAPFGB.....hACA......hDAA...,1,4,-13,17
cFKXIAVDPeZdbNHJBgQLfMWGCRSaOETUY,DAAAeAAAdADAHADABAFALAGB.MAIBGAGARCCB.aBBBECEAUDDAhAFAFEFAKFAA.AAAAZFFAhAFAJDBB..QEGBhAIACHHD.OGDA.......hCAA......hCBA...,2,-29,-9,20
XMZWScfVQeICGPJDgaYBNTFLEHUKdbARO,RAAAMAAAZADB...SACAVAFA.eAEHGCEADAGA..aBBCBCCChAAA.TDAAEBGAHDDChBAAdDGAACIBXCGAhBGA.fEGAQGGACFHA.....hCAA......hDAA...,1,-18,-20,2
EgJUAWFCGdfYHVRZQeBcOITNKDbLaSMPX,CAAAdAAAHACARADAZABBBAFB..OAGD..TBGADAIBLDDAhAEAaCAAMCEBEDHF.UFCAhAGAAAHAGDFA.fEAAhAAAQFFCeEHHIHHAbFCC..SHEGhACA..hAEA...,2,-19,-17,2
TCWEBDOLGJZXKVaQRFcPeIbAdHYNgSMUf,HAAA..gAAAMACATAFAEADAOAFCGBDAZCGBKCCAaCEAhAAARFCBFFFH..eCGHAAHAdCCChAAASDABCHGADEIB.hBIALEEB.XGGA.cEGDhABA.IFDAhADA.YHAA.,2,-3,0,3
XVKIFNDeSaEHYCPLARJMcQGgZUdOBWTbf,RAAAMAAAGADAZABEdAFABAFA....TCCAbAGD...XBGDhAHAKCCDFDABeDEH.hAIAEEHBHECC.CEHAABIBQFAAhAAAOFBBfFGEIGFASGCBhABAaGED...hBAA...,1,-9,-24,15
eEbJacfCGNHQYPIKdUWMAXLOSFVTBRDgZ,LAAAFAAABADARAEFZADB.EAFA..aAGACAHAHCAB..QBGDhADAICFA.dCCAMCHBhABAADHBSEDADCIB.hACAeEGBbEEB..fGGANEIA...hBAA......hCAA...,1,-14,-32,18
OdNRTIDKFPaUJWGbEABCMQLSVfegXHcZY,MAAALAAA.SADHeACAHAFAZAEBdCCARAGB.TCGAKCAAFDDHaBBHhAHA.UEEAGCFAACFBCEHA.hAIA..fEHAhABA..XGFAOFFHDGIB...hBAA......hCAA...,2,-14,-12,2
aFBSWEgGQdJDPKAINLYCcbRHZeMfUOTVX,LAAACAAARACA.HADBeAFEMAFAUCAATBGA..aBFDSCAAhABAECDA.GDDBhACAdCHADEEAABFAIFGAhBIA.cGDAZFFAOHDAFGHD.BHHD.hCAA......hCBA...,1,-5,-27,22
GTALeDCXBZdSJPMbHRWYNIfaEgVUcKOFQ,eAAAXAAAdAEA..SAGAMADAHAFCRBCB...NBDA.aCFDEBEBUFDAhAAAOCFDGDGAAAAALDHBhAIABCHBJEBBbEDD.hABA..IHHA.fFFEhCAA......hCBA...,2,-15,-10,5
PKafIOeZdgGNBJAEULCQDHXYWTScVMFRb,EAAALAAADADA.HADB.XAFATAFASAHBMAIB.hABARBCAKCBDaCAAOCFDhACAZCEEGEFABDDDADIBCEHDQFAAhAFA.cEGD.bFDBIHHAhAAA.eFED..hBCA...,2,-18,3,21
VbKFYIEfXCNAcgTZMJGPeOaWSRdLUHBQD,TAAAZAAAGAEA.eAGBaACA.RCAA.dAFAHDFBQCCADACA.KAHBhAAAFEBDECGFCAHBACIB.MDEBhABAODBB.LEFAhAHABEHB.bFBDfGHAXFDCgGGAhBDA....hBFA...,1,-3,-10,7
BCNdaJSbfURVAWHXKZPcQLGTeOIEFYDMg,HAAAZAAAQAEAGADAeAFAEAGA.DBIBMBIBCCADdCGA...aCCHbCABhABARFAA.AADA...KEFDLCEAhACATGDAFGGABDDDhDAA.SEFA.fFEEhDCA.UGGA...hAAA...,2,-11,2,13
UcIYAPKTZDLJMHaeQVfSFgXEdWRbOCGNB,TAAAZAAALADB.HAFAeACEQCAASAFBXCFAhABAEAHBRCCACCGA.GEEABDBDIEEAhAAAAAHADCIBaFAAFGHBhACAdEGAbFCCOFCD..NDIA......hAFA......hCAA...,2,-6,6,12
JDPXSVHAcRKZbIFgCeYBOWULEQMTGdNfa,RAAAZAAAFADAeACEBAGAOAFA..LCCAEBFF.MAIBdCCDaBHDhABADCGB...SDEAhCAAHDGBAAAAKECAIEHAhCBACEEBUGAA.TFFA.fHCBXGGA.hAGA......hCAA...,2,-28,-9,19
WafcGVgZSeURODQNKEAMPFCLBJXIdHYbT,MAAACAAALACABADA...JAGBdAFA.HBBA.TCGAaBHDGCCAhAAAZDDAeEHFRDAB.QFBAhAHAEEFAAADA.XFDAhAIAbFDD..fFGA.gGAAhAGASGGDDGIBNIBB.hBAA...,2,-14,-14,0
JFdUMIBNGafPAVLRWbXOQKgEZSCDYceHT,RAAAXAAAQADCKADA.ZAFB..DAFAeAHFHBECFCCHdBHA.MCDBhAAABDHAGDAAaEDDAAAALFABhAFAOEDDEFFACFCC..hABATFFAIGHANICB.fHEF.hCAA.WFHB...hADA...,1,-4,-16,12
YDdEaWIgASJLXbMORTfeCBUGNHPcQFKVZ,LAAAMAAARACA.eADHBAFBGAFAHAGBQCCBKAHBZCABdDEAEDHBhABAaCED....gDGAhAIAACABXFAAbFFATFGAhACA.CGFDNIDBFGDB.DBBB..SHAGhAFA....hAHA...,1,-3,-6,3
CDIXFfaSRBYUKOPbQcWVHZeGgJANMTELd,MAAAEAAAdADADAEA..FAFA..aAFERBEFBBCCKBBA..OAHDQCGAhAAA..cBDAhBAAHEECeFHF..hAIAGCFAADDBNIBB.TEDA.LFHBhBBA.CDDCfHDBhCAA..,1,-18,-23,5
BJLSNFVUIKYRCfdDGeMAOgWcEPTQXaZHb,OAAA..gAAAEADA.TADAaAFDHBGB.bBBCLAFBhAAA.FAHBIDDAhAHARCCBdDAAeCHFAAIBPDFBhBAAZEFFSEHHUFBACEHADGGAMFCB.WFFDhABA.....hBFA...,2,-16,2,18
FNUgQeSYcRdDBGbCPOXaTAWfMELKZVHIJ,MAAAEAAAZACBHACC.FAFAUAFA.eBEDSAHHRDFFBAHAGFBBhAAAbCCA..OBBBhBAAaCBBACIB.LDGB.hBCAKEEDIFHAgGCBYHDGDFIBXGFChCAA....hCDA...,1,-10,-12,2
PcWITgFSXYAVeDMKJZHUBLGEaROfCNdbQ,eAAAMAAAZABEHADALAFAEAGERCCB..CCEAdCGAQCCA..hAGAPEFBICFATFAAhAAASCGHACIB.hABAKEFDBEHAaDHDfGGAcGDCFGHB.YHAAhAHADIAA....hBAA...,1,1,-29,30
IeCSBLMOcPTQdWXAVEKRDHgaFYUGbNZJf,EAAARAAAHADBFACD.GAGAZADB.JCCFeAFA.BBHAMDAB..OCEDhAAATEEAdDGAAAAADDIBaEHD.hAGAUGBA..bGCAfFHEhADA.SGEAcGGC..hAFA......hAGA...,2,-19,-13,6
HBFTeVKUdcQXbCLaOEgfDWGIPSJNRAYMZ,ZAAAHAAAFADAeACEKAGA.dAFA.QCCACCAA.aAHBECCB.DCEAGDFAhAAA.SBHHhCAARCFAAEEABEGA.TFDAhCCAUGAA....XFFCOFHD....hABA.fGHAhACA...,2,-46,11,57
IRKEYXaMOQDJPAGgBULTeSHdFfWcbZVCN,GAAABAAALACAeADAHAGBdAGAFCCA..fCDA.hAAAbCEDZCFA.CDAAREAAEDGBaEEAhADAMDABDAIB.AAABTGBAhACA.SDCDVFGBKGBA.OEHD.hAEA......hBGA...,1,15,-25,40
JUIaXSPECfTDNFKWBVGRZHbLMAOceQdYg,eAAAdAAAJADAUAEA...aAGESAGB.EBDBTCCAhAAAFCBDBCFARCFAHEBA.bEEDhABAAAIBQDGAhACA.IEEACEGADEIBKHAAVFCB.ZGFA.MIEAhBAAcGGA...hBCA...,1,-5,-20,15
PYLcBDFegUWHECGNRQVTJfKIdSZOMaXbA,LAAADAAAeABAUAFAHADBEAFA.GBGARBDB.TCAAKAHBdDGAZDDAhABAMCCBaEHD..AAIBPFAAhACABEFCFFBH.CFHA.QFDAhAFA.fGGEODDHXGGChBAA....hBFA...,1,21,-33,54
NcSUeJaTMAHRWFfLQVbDPYCIgOXZEdKBG,HAAARAAAFADALAGBQADC.DAFACBFA.OAHDZCCA.EBFAdECAGCABhAAA.SDEAhACAeCHHaEECAAAAfDHEhCAA.bFDAIGEAKFHD.BGGA.NIAB.hAIA......hBIA...,1,13,-29,42
ReMbPZJWDOfXVCATNSKFcHadUIgEQBYLG,TAAAKAAAHACB.dAEBUACAEAHB.BAEAGBEARAFF.eCABMAIBZCGFDCHBhAAAOEEH.XGFAhAAAADDAFDEDaEGC.QGGAhAHA.........hACA......hAIA...,2,-25,-9,16
dUWTIVEZXQOGaLCSJNBYHKfcMgReFDbAP,dAAATAAAEADAZABB..QACCGAFAaAHFLAEB.SAGAhAAABCEDHDCAfCGAhAGAMDHBRFBBeFFBhBAAbECAACIB.PEGDIHHAOGCC.CDDDYHAAhAHA...hBFA...,2,-8,5,13
HfDUEJgNAPZSeQLYXWVbTdIFcGBMaRCOK,ZAAAeAAALADB..XADAVAFAdCAAFAGAGCEAaBFDRCCBKCHBhAAAHDGB.DCCBEEAAJFAAAEFAQEGDhABA.hABA.bGDAIHCAMIAACHHA.fGHEhAEA......hCAA...,1,3,-19,22
HDaefBSUCNYLKAQZREWbFgIMJTXcdOPGV,RAAAEAAAFADA..MADA..TAGAdAHAGBCAHCCAeCEESBEAhAAACDHALEEBABCBZDGBbEBDhBEAIGAA.XEGChAAAOEEBDDGBBGHAYFHB...hABA......hAGA...,2,-17,-4,13
URHDZABeSCJdIQcYTbEMGVNKFgOLWXfaP,eAAACAAAdACA.QADA..TAEAEAFAGBGAKAGCOBHDhAAALCCB.fEEAhAAAaCBCRCFBHEAAAAIBSEHHhABAIEEA.bGCAMFHBFGGH...WHCAhAEA......hBCA...,1,8,-28,36
eAScFOCJVbRDdNBfMLaXYHgEQZGWUKIPT,FAAACAAA..JACARACFdAEA.BAGAMAFALCGB..aBCCHDEDhAGAEBFAGCGAKEDD..hAAATGDAABIBODDADAIB.hBAAXEECQGGAUGGB.....hCAA......hCBA...,1,-22,-25,3
FZMeCPJIGVUfYQgHbETSacANKOXRBLdWD,OAAARAAAdADAFAFAZADB...eAFACBFD.JBBFGCGA.UDDAQCFAhAGAHGDA.EEEBaCCHhAAAABIBKEHBBHHA.DAIBMFCBhBAA...IGGA...fHDBhBDA..hCAA...,2,-30,-27,3
QKbWELUMHeSJcYdADVPBfGNZXgTICRFaO,DAAABAAAGABBZACA..TAGARAFFOAHDKCCA...ECCBMADAHDFChAEAeCFFSECAhAFA.JFFBdDHAACEB.fECAhAAANHAB.XEFDCHGA.aGHD.WEEDhAIA.....hAHA...,1,-16,-22,6
ODAeEIFPTCbKaURJgSNZLBdXHGcMfWQYV,EAAAFAAACADAKACA..RAEF...SAEBZAGBdCCAHDABGAGA.MCCBhAAAQEDAODDAAAGBhAIAeCHHTEFAUGABgECHhBIALFFBBFHAfFHA..hCAA......hCBA...,2,-20,-9,11
DEWZaCTfPLMIYRQgbKdUcXANOJSFeHBGV,OAAAFAAAHACBGADAEAEAZAGBCAFA....TBGALCFD.MBIBhAEARDBBQDGBhAFAKEDBdFHAXGBAAAHASDEHhBAAeGEA.DBBB.aFGC.IHHA..hBDA......hBIA...,2,-18,-7,11
QESfRgMOAaVKecBCFdXLGIWZYNHDJPUTb,aAAAeAAABADAdAEAGAGAZAEB.HBCBDAHBUCCATEBA..ECGBREEAMDIBhAAA.AAGBKGDAFDABLEFAhADA.IGBAhAIANIAB.JGEAQGGC..hABASHGA.hAIA...,2,-28,-1,27
YfXDHdObWaALcIERQTeFgJUMSBZGVPNCK,LAAAEAAARACA.eADHFAFAUCCBMAFAZBEBGCFA..VBGBCBHA.hAAAKCAA..XDADhADAHEFAdGHAODHDaEDHAIBA.hABAQFCA.......hACA......hBIA...,1,-10,-15,5
MgVXUYdQGecBRFaPATKOEHCWJNbDfSZIL,TAAAEAAAHACA.CAFB.JACADAHB..ZAFBMAIB..XCCAhAAAdCCDeCEHRCGFFEFHACGB.OEHDhAFAbDGD...SFCAhAIALEAAgGEBYHBA...hBHA......hBIA...,2,-22,-12,10
AfdWRCFaMeQcKVOSNDGIYHJXEPbUZTBgL,dAAARAAAFADAeADA.QAGAKAGA.OCAEDCCAGCDB.HEEChAAAECEAUDGAZGAABEHBhABAAEAACECAMEEBSCGEhAGAIGGA...XGED...hAIA......hCAA...,1,-15,-28,13
HFJKVaRBdcUNOZPMIAeCYDbfTQWGXESLg,eAAADAAA..TACAGADA.EAFALAEBHBGBKCCDRAGBdDGDUEGBZECAhAGAMDBBAAIBCBBD...bFDBhAAAQGCA.hABASDDGFGCBaFAHBGHDOFHB...hAFA......hAIA...,1,1,-14,15
FSHTZDXKEYQNVALbdJURGMCBOWcafeIPg,dAAARAAAGADAMADABAGAOAFA...aBFDeAHH...gBDAhACAHCGBZDAAKEFDECBF.hBAAQFBCACGBLDFAhBCAUGGACEBA..fEEE.FFHBDBIBhAAAXGFD..hBDA...,2,-25,-3,22
SVKLgIHDFEYfMBUGXcbJPCNTRWdQeOAaZ,ZAAAKAAALACBHAEAEBHF.MAEAGCAA.XCCAJAHB.CCFAREFAdBEAhAAA.eCFHAACA.aDHDSFEDhABA.gGAAhAEAFECABFGDbGBANIDB......hBGA......hCAA...,1,4,-28,32
AeFKXEYaZTQLcOCfRISWGHVbgMPJUNDdB,eAAAXAAAEADAZAFBLADA..CAHARCCBSAGHHCGB.bCDBhAAAMECB.UFEAdDFAAAEAhABAKGGCaBHD.QFGAhAIAfBEAIHEA.WDDD..hCAA......hCBA...,2,-14,-14,0
UWXBHZeTbCPALFEIMGdgNRSfDJVcQYaOK,EAAAGAAAdADA.RADADAGA..VAFAQBGAOBCH.KCDD.UEABhAAABCFDHDFAeCHFTFDAhACAbEDA..ADBBLFABhAAAMFHB.SEHH....hAFA......hAIA...,2,-20,-7,13
WfTJNgMXGHPLUaAeIBVFDdRCSKOQYbZEc,eAAABAAADACARADA.KAEAQAGC.ZCCAEAGE....fCHAhAAATBCAJCBFMDGBhABAHCGBLEAAhAEAACGBFDEBdFFAOEEB.bFGDNIAB....XFCDhAAA....hAIA...,1,0,-34,34
NUWSCdTgPDEQFZfIeGRYLKJXMVabOAcBH,HAAAUAAACADAdADA.TAFADAFA..FAHDZCAA.eAHHRBDA.LDFAhAAAKDAA.MEEB.bFAAhACAADDBBDFA..SFFAhAFAEDHB.fGHAGFDBXGBChADAaHAA.OHFChBAA...,1,13,-43,56
PTbgQFSKRfEHNaDZdXWGVLAMJIeYCcOUB,MAAAeAAACADAUAEA.BAGA..bAEDQBBAKAGA.EBHFHCCBhAAA.aCGAdDEAGDGAhABAADGBJDHB.IFEAhAGA.cGEDTEBA.SFGD.hAIANIABDGIB....hAIA...,2,-31,-5,26
TNHFXQPbIdBSEcVUZKARfDJLgWOGCeYMa,RAAADAAALADBOABEGAEAeAFA..aBGEHAGD.QCCChAEA.IEGAhAGAdCCCECFBcDGDZFFAACIBfGDAhAIAgEEDCHHD.MFAA.TGAA.hBAAFFHD.PHDA.hCAA...,1,1,-13,14
BWGCbdRfFYPSAQHTgJecKLDVaOMEXUIZN,HAAATAAAeACE.LAFBaACA.EAHBXAEDZCCBBCHDGBGAhAAAdEEARGEA.FCCBSHGAhAAAAAGAQDEC.gFGAhAIA.KGBADCCBMDBBNIAB...hAIA......hCAA...,2,-6,-3,3
JKQXeTAdcSYgVZUPDHabfMEGIFRBNCOWL,dAAASAAA..gADAZACBDAFAHBEAaAFD.MAIBGBGAhACARDEACEBA.LDAA.hAAAQEDAeEDBABGAcFGAhABAUGGAfHAB..EGGBBCBAhADAOHDE...hAEA...,2,-13,-8,5
WPQcJbKeaLUDCfTgAXZOSMBIHFRdVYGNE,ZAAAMAAAHAEARACA.dAHAGAFAECAA..QCDDJBBFKAHB.eCGBhABAaDDA.LEAB.hAFACEEDTGEAADHASECAhAHAFGGA.VEGB.NIEB.......hBAA......hCAA...,1,2,-23,25
PTWLaQcMNdVbERSgXJOZAUBGfFeYCHKID,GAAAeAAAHADADADA.TBGAaAEE..MAHBdCCAECFB.REDAXFAAhAAAZCDAAAABBDHA.FECAKDHBhABA.IGGALFCAhACANIAB.bGFASHFG.....hAIA......hBCA...,2,-26,10,36
MRcSVULIPBGTNHbQYgFWfCAXZKEOJdaeD,ZAAAEAAAdADAeACE.RAFF.SAFALAHBBCCDGCBAHDEA.QECChABAFBHDCDDBAAFAODFBhAAAaEGEMFABUGGATGGAhAFA..bFCDYHCAfEGF..hAIA......hBCA...,1,8,-19,27
XCDIMGdWAEBPQFNYeaSTOUVJHfLbgcZKR,EAAAQAAAFACD.eACAaAEA...TAFAOAGDUCDAHBDBLAHBhAAA.bDABZDFEhAAARDFF.DAIB.GFBBhBFAAEIBBFDAPFHBSFGHfGFAKHCA..hCAA......hCBA...,2,-15,3,18
GTQSODMfUVHdKgLXAWENRBcJYPZbIeFCa,EAAARAAABADB..JACBZAEB.eAGFaAEAGAGA..TDCAhAAAQCECDAIBMCHBfEBAhAAAHEFBdFECLDDDhAIAACCA.NDIAPEFDIHHASHFAhBEA.....hABA...,1,-2,-25,23
eWaCKERcLFDQYGPbZfAdXVgNOJBHITUMS,dAAAXAAA..gADAOADAHAGBUAGAeBCH.aBEHECBFhACARDEALFCBQCEDhADAPEHDZDGBADDBVGBAhAEABGBAMFGBCEFDFGHDDIEA.......hAAA......hABA...,1,-4,-6,2
adEXeRHUgLCONZcQYDMJTKFVGPBIWSfAb,dAAAEAAARACAHADA.LAGBOAFAZBFEQCBADCCB.MAIBTDDAhAAAFDAHGDDA.hADABCFCSDFHhBGAAEIBaFAEeFGBCDHANHDB..........hACA......hADA...,1,-3,-26,23
TOXDMYSCGacFfLVAgHKEUWeRZQPBbdJIN,HAAAEAAAUADARADFZAFBBAFAdBHA....IDAATBGA..DBCBMCCBhAAA..CAHBaDBCfDDEhACALDDBAEGAKEHBhADAeDFBQFAC.bFCDODHD.hAFASFFDFFEDgGFHhAIAWHEA,1,-2,-40,38
bBSLQTCaHFcKfdXZVEGNOJIAgPUReWYDM,UAAARAAAeADEDADABAGBLAGB..TBDAHBDAKDBA.dEEAZCFBhAAAGGBBOBHDAAIB.PCCBhABAMCIB..QGGAhBAAaEEBFEHH.fFBFEGGBNIAB...hAIA......hCAA...,1,-12,-14,2
CDSHYaZKBWTAfFIbdMgLRJEQcGNeVUPXO,FAAAdAAAMADARACF..EAEEGAGA.eBDAUAGAOCAESCDHhBAAHDEBZDBEBCFDAAIBIFHAhACALDHBQEFBhBIANIDB.XGECCGDAaGGC....hCAA......hCBA...,2,-28,0,28
UHNABCObGVDWYFfScPEdMIZeRKgXaLTQJ,OAAAGAAADADAFADD...SAEAEAFAdBHAZCCARAGFKCDA..aCFFhAFATDFAUFFAABBBCDCD..hAIA..VFCA..hAAAfHCBMCIBeFHB......hACA......hAIA...,2,-30,-18,12
BGETgXHSbAWcDKNadUQPReVYFLMIJfZOC,DAAAaAAA.dADAUADARAFA...eAFAFBBBLCFAMBBB..ICGAhAGAZDBBBDED.EEFATDDAhBAA.HDBBAAFAKEHBhAIAQEGA.PFFBYHCA.hBDA..fGGAhBAACHHA..,2,-32,-15,17
fSaXUeREbAJDdcQGNBHCLMVOWgYKZPITF,dAAAGAAAHADAMADAOAFA....gAFAZABBTCEASAHHhAAAaBGEUEEBEDCFhBAAACDADDDA.QDFAhACACDHALFHBVEBAKHDA.FFFH.eEHH...hCDA......hDAA...,2,-5,0,5
ZLeEJPSBOXTdCbRgMaVAUfFWIGKDNcYHQ,FAAAGAAADADA...NADA.HAECZAEA.EBCF..SAGEXCECdAHAhBAARCEAMCIBADDB.UECBhAAAfDGAKFAB.QFCAhCAAeEHDBFFATFEACHHD.aGHB..hCBA......hCFA...,2,-18,-10,8
QcYKHgJTBfIdNLWFVSPUEGCMbaXDeRZOA,QAAAKAAAHACBJAEABACA.dAEALAHBFAGA.SCABhAAAEBGBGDCAMCFBaCHDeEBDhAAAREBAADGB...gEEBhBEATEGAIHCAWFHB.UGGBCGEDDGHB.hACA......hBEA...,1,-4,-13,9
ODfEgGBeMFcAIYaUJTVNZKCSRdQXPbLWH,aAAATAAAZACB..KAEARACFdAEA..QAGCXAGA.LCEBhAIAHCECDCABECHFGEEAhAAAeDGDMBBBAAGAIEHAhACAUGGBNEDASGHB......hCHA......hDBA...,1,-5,-12,7
DXASeBNTdQCEOHgMYWVbIPGJFcRKZLfaU,eAAATAAAdAEA.EAGAHACB.MAEA.VBFAbBAAGCEB.hAAAFEBARDEBZEBALEEAhAAAaCACXDGAABIBBFHAQGAAhABAOFHB.gGGG.YHCChAGA...hACA...,1,9,-7,16
UbJOZHfCRKdLVFAXQMPWBSDIEaTGcegNY,MAAABAAADACA..EADAGADBeAFA....NBBA.bCBAZCCAHCFAhAAARCGBdECALEFA.hAGAAAGAQGGAhAIASEEAaFGE.gGCAYHCA....hBAA......hBCA...,2,-16,-15,1
VDNLJTCWaAdMgFeQPYZfSERUbHKXGcIBO,dAAAMAAAeADA.QAGAZABEEAFARBFAHCCAGCABBDGADCFBLDGBhACACECD.ADIBFEABfEEAhAFASECAbFGB.hAIAXGCA.OFFHNIBB....hADA......hAEA...,1,-10,-14,4
OefBgMbCEaFLZIUScDVPAHTWJRdNKYXGQ,HAAATAAARADFdAFA.KAHBGACA.eAEABCADMAIBECCBaCFEZCEBSBGHhAAA.hAAADCABADIBNEEAQEAAhACA.fEGAbFFALHAAIGEAhAEA......hAFA...,2,-16,-10,6
MbAgdCRZEBVTFeDUfXGIHOLaNcJKSQYWP,dAAARAAAEADEBADA.FAFAeAFE.DBGBUCCAGCCAHBEBLCHBhAAA.aCFHJBHB.QDAAhACAPFFB.AEGBZFFAhADAfHGF.IHDAOGCCKHFA.hABA......hAIA...,2,-21,-17,4
UNbZGdHcJOTBeKIPLfMDEYaFXgSWAQRVC,RAAACAAAUACAZADBHAFA.OCCHeAEA..KAHBLCHB.MDABhAAAECBBaCFAFDFA..SEEBhABAADDAQDEAbFCD.hADAdEGA.JFAABGFA.fHAFDDIB.hAAA......hAFA...,1,1,-32,33
CdUcYGJMFXLDQZPbIAeOEfWHTKVNBSRag,EAAAHAAAKACABADB.RAEFCAGBdAEA.UAGAGCABFCCB.LCGBZDEA.hAAA..bEEBADFAeEHHhBGAOEHD...fGDAhAAA..WFFB.NIBB.aGGH..hACA......hAIA...,2,-34,-13,21
PcTGFaIXKYVeLEgfJMRHNZBAdOCUDSQbW,dAAACAAADACAQADA....bACAPAFCGAGAFCBD.aCFDhACAKCCA.eDEFLCHBhADAEECB.fDDAhAIARFFAHGAABHHAADHBSFDA.TGFAhBAA......hBCA...,1,-15,-20,5
LFVIZRKESNgadPOfUJWQbYecDBAXCMGHT,MAAAHAAATAEALAEAFAGAZBBA.RCEFKBHBECAB..SCCAhAAA.aCFDdDBA.fDGAhAFAUEABQEGAhACAeDDDBEHAACCACCHAIFDAgGAAOFFBhADA......hAEA...,2,-19,-2,17
VbFUJfILCBRPAHMaNeOWTKQXSEZgDYcGd,HAAAaAAA.eACEOACDTAGAKAEA..QAGCECCAZCEBDCIBGCDAhAEAdDGAFFAAUDFA.IFCAhAIALEDDBDHAhBAAAFIBMGEAXFGASGADYBBF..hCAA......hCFA...,1,3,-16,19
OYecfIHZagRSNWBbVKAPUJMDFCQXTGdLE,UAAAMAAAFADDQADAGAFA.dAGALAHBECDB.eBBB..hAFAfCHAHDDBaEHBRFBBhBAASDAABGFA.hBCAbDEDADDBDFIBTFBA.OEHD.IHFAhADA.NIAB...hAIA...,2,-18,-2,16
aYDEMgVGNbQUJXfAFHIBdZOKLPcWSRTeC,HAAAdAAAZABBLADB..PADCSAFARAGF.eAHHaCEBDCIBhAGAECABMCCB.GDEAhAAAbDCD.QDGBhACAXEFAAEFABFAAKGGD.TFCA.CGGA.gGDAhAIA..hBAA...,1,14,-27,41
dUMeEGNBIAHCgfOFXLYcWbPZaQDTSVJKR,HAAACAAA.OACALACA....cAEDbAFDZCCB.aAHBTBGAhAAA..SCHHhAAAKCCARDEAdFDAeFGBhAHAEDAAGEDABFHBAAIBFFFA.YFHB..hADA......hAEA...,1,-8,-19,11
JXMLTVfPKbNHGagZDERYQdFUOIWCBASec,eAAAXAAAMAEALADA..TBCAVBGB.KAHBHCDBaBEAZCEEhAAAREAAdEGD.OFDEhAAACDHAAEFA.SGHBhABAJFCA.fHABbFFB......hAEA......hAFA...,2,-21,-5,16
dTZREHYPBbSLCDGAVIJUcaQfFNWKOegMX,VAAAUAAAQADA.FAFEKADC.eAFAMAIBdCDAZCDAHCFAhAAABCGBLEFAGDAAADABhADAIFCA.aGABhAGAfEEAOHCATGGAEEHBbGFCDIBA..hBIA......hCAA...,2,-11,-8,3
CUFZPYGEcTaARdNMgHJXIWeQKSLDfVObB,RAAAdAAAMADAHADA.XAGBeAFA..QBDDLCCAfCGEhACAOBHDCCGC.ZDAAGEDAhAAAEEEAaDHDACCBgFFBhABAIFAAKFGDDFIBBHHA.....hCAA......hDAA...,2,-18,0,18
JfDMGOdACRZIEVTeYKHBXQWLagNFPSUbc,RAAAEAAAeADEHACABAGBQAFCLCCAaAHDFBHD..UCCB.JDFAhAAAMCGBdEAAZEFA.TGGAhAEAXEBA.gEEDhAAASHAAbEGDDIDAABEB.....hABA......hAIA...,2,-26,8,34
DMeAENPSTfXFZdRVCUJLbKBGYWcIHgQaO,EAAASAAA..TACAFADARAFFCAHBLAEB.BAGAGBCAhAAA..cBGDhAAAHCGBaECHMCCBACIBfEEAhABAdEEAUGAAbECDKFGDIFHAOFHD.eHEAhAGA......hAIA...,1,-10,-13,3
MTZcQDXGPVYFOdJWaNHCIKfbLeBgAEURS,RAAAMAAAZADBDAGAGACB...VBGBOBFAdCCA...aCCBHEDAhAFAKCFALDABeEHFAAGAEFCBhAIAUEEATGEA..hBAAQFCA.XGFA.YCHBhAAA...hBBA...,2,-17,-7,10
MbPZfIDgeSaFdXcAJTQHYWLNUCOBGKEVR,TAAAHAAALADB.CAFAGAGAEACERAEFMAHBZDCADCAB.eCFBhAAAaCCBdDDAAAIB.QDGBhAAANDIA.BEAAbFAA.hACAfFEASFGHXGAA.cGFBhAEA....hAGA...,2,-19,-1,18
XFMfAJaBNGHgDbYCOWUQecdPESKIVZRTL,aAAAGAAAHACBDADACAEA.OAEE..QAGAeAHHdCDAECFBKCEAZDEEhAEALEFAMBBBADIBBGCAhAAA..bFFAUGGAhACASGAAIHAA.......hAGA......hBAA...,2,-19,-13,6
YQJDCfeGXKIZBPMHTgEFcOSaLRdANWbVU,...bAAAUAAA.QADACAEAGAFAKAHBZAFBMAIBHCAAECEBOCBEhADALDHB.AAAA.hACAVDGBDEABeEEBBEEATFBAhBAAFGGHaHAA.dGGD...YHBGhBCA......hBFA...,2,-15,4,19
bAUXgVMZcGeRfJTLDKBIONHQSPCdEaFYW,XAAAMAAAGACBRADA...TBGALAGBBAHBOCDBHCCAQDFDhAFACCFCEDAA.hAAAaEEHFDHDbFCDAADAgEEAhABAZGFEfGAAKGGANIAB......hAIA......hBIA...,2,-18,13,31
UgcKObZGfCVLEWdPRFBHQXAeDSIMTaYNJ,eAAASAAAMAEA...aACDJAHB.UBDAKAEAZAGBGCFACCDAEDEFdCCChAAA.RFCA.HEAA.AAAATEGAhAEANDIA.OFFBhAGAfGBE...WFHDBGCA.DBIBhCAA.IHHA.hABA...,2,-21,-9,12
SWAYfVgFcXJOREMTUaNGIDBQLPKeZHCbd,VAAAFAAA..XACDRADF..EAFEMAEAaAHD.GBEABCFALDAAhAAAeAHFHEBAdDHAABGBfDHAhBAAJEEB.hADATGEAIFCAQGGCZGFESHAAhAHA.....hBEA...,1,-7,-10,3
JEHPIYLXQdfVTFgeOMZbWGCaDABUSRcKN,SAAARAAAKADC.EADAHAFA..IAGALCCA.dCHATBEAhAAAeDEAZECAGCCAhABAaFHBAAAABBHA.cDABhADAPHAAQEFAFGFD.MDIB.CFEDDHDAhAIA.JHFE...hAHA...,1,6,-16,22
bATCUcPVMSZaYHFDKLWQIegRJdNEXBGOf,TAAACAAAUACA.....VADAZAEBHAGBKAGCLCAAQDFDhAAAeBHFREBAdFGDECFFGEDAhAAAOGBE.ADIBMFFA.hAIAaGGADCBB.IHHA.NIBB.BHHD.hBCA......hBEA...,1,0,-15,15
XeYcfgLZQdAHBSIaCUGOJNbVKMDEPFRWT,HAAASAAAaACAGAEAOACD..bAGBMAEA.DAIBECCBRBEA.TEDAhAAAeDEA..fDHAhAAAZFGBABIBCDGDUGBAVEBAhABAFGFB..XFFC.YHBAhBEA......hBFA...,1,11,-17,28
ZRJPLOVKdbYgXMeCDIUWHaFEcBGNTfAQS,ZAAARAAALADBKADCdAGA.....bAFAXBEDeCCD..DAFAUCAAhABAHCFAECHFGEEAhAAA.fEHAhABAAAIBQECASFCDOEFBgGBBhACACGHAaHCE.BEHA.TGGAhBGA..,2,-13,-3,10
eDSHGCJFRBbgfNTYcMIVdLAKZWQPEOXaU,ZAAAQAAAEADE.aACEeAFE.HBECGAEAFCAARDDABAGA.bCGDhAAAfCHA.hADATFFAMAIBdDCAADDAKEHBhABAOEDDDIAACHHA.gFFG.cGAAhAGA.....hACA...,2,-10,-4,6
TEeSUGZNRYfKBIDQWVMPbLHcCgOAXJFad,FAAAdAAAEADAeACHGAFARAEA.KAHBDAIB..QCBAMCEBLCGBhAEAHDDBCDADADDB..aDFBTFBAhACAZFAA...fDHAhADABFHAIGEAPFGB..gGGGhAFAOHACSHDEhAHAYHAA,2,-32,-7,25
PRFOZNBGIHTKDXQdYLMEWSacUbJAgCefV,eAAAVAAA.RADAZAGBGADAHCCADAFA..dEAAMAIBEDHF...aBFAbEEBhAAAACGB....fDAAhAAAOFCBBGGATDGAhADA.KEFD.QGGA.LFDBhCAA....hDAA...,1,-11,-14,3
IVeRUJEfMYTNWbgaFKACXZLOQScPHdGDB,ZAAALAAAQAEASADHHAGDGCAABAFAeAGHRCCAEDFFMAIBhABATEGA..bCABaEEHhABAACFB.XGGA.hACA.ODDB.dEFADACAIEHA.hAIAUFAB.fGHAhAFANICB,1,1,-20,21
FfCDJRYZGBPKLdbHOTUWSeAcaEgQMNXVI,EAAAMAAA...XACAFACDDAEARAFA.GBDAKAFAdAHAHCGBUCDBeFCBhAAAABBB...aFEDQDGAhAFA.IFFAhBAACGGA.ZGCA.BGHA....hCAA......hCCA...,1,-21,-27,6
SBHKXCROATUJbDZIQVNcgdLFEeGPfaMWY,TAAAUAAADADA.ZADEQACC.VAFA..gAGHhBAAdCEAECHFeDDDGCDAhBCAaDGHMEABSCFGhCIAKFFDCGHAAEIBbFFA..NIAB.LHEA.fDHAhDAABHGD...hAAA...,1,-5,-13,8
XLBRZdUNPQFaYGcfMJWAeCITSHgbEVKOD,eAAATAAAHADA.EAGEOACALCCARAFAdCCAUCGA.QEEChAAAaCFCGECBMFAAACHASDBFhAAAbGDADFIBBHHDhABAZFGBFGAA...fGEA.CDHA.hAGA......hAIA...,1,8,-10,18
OVHXQZGUbPWFSecEJgYNfRTBKMDdACaLI,aAAALAAA.OADDHACBZAEAGAFAbCED.FAHF..eBBDECAAJDDFhABA..gCGAhAFA.fEHAhAGARDGFTFAAMFFBAAHACEDCXGCAQGGBUGGBhBAA......hBIA...,1,0,-5,5
VIUcTdFegZSfRaDOLXEBbMWGKCNAHPJQY,HAAAQAAAVAEAUCABdADAeAFA.ZBFERCFAODCDEDBA.MEEBhAAAGDEB.CEDDAAFAPEADhACAIFHA.FFFHfFFAhADAaHDC.LHAABHHA.KGHB.hAAA......hBCA...,1,4,-10,14
HKOAcedGPRUVMbWLYXgCfFNEQSJBaDIZT,eAAAGAAARADA.MADALAGB..XAFACCCAFCED.ECDAQEAAhAAABCFAaBHDZDCAHEFAhABAAAABdEGAVGCA..bGFAhACA..WBHH.fGHANIABDIFA..hAEA......hAIA...,2,-12,-4,8
XcaJRUECPgHdKSWOGTMFbfYDLVIeABZNQ,ZAAAQAAAaACA.RACAUAFAEAFA..CAHAHCCCdBHAKCDA..OCFAhABAGDAAMDGBFDFD..hAFA.bEGDDEEBLFEBhCAAeEHBADABXGGD......hAAA......hADA...,1,-8,-16,8
RIcLTQaWeXdZgJMBDVKUFNfOEPGSYHbCA,RAAALAAAQADCeADHZAFBMAFABAHAKBFAFCCH..OBHDGCGAhAAAHCABACIB..TEDAhABAaDEAdEEADFAAUGGAEGFB.hAFASFBACHHA.IHBA..hABA......hACA...,2,-12,-12,0
RIQFbcWBXVNZHEMgYAdGTfOCKaJUeSPDL,GAAATAAA.CADAKAFAUACA...eAEADAIBRCDAQBGA.hAAAFCEDbCGDBDGD.XEGAhAAAZECAHFAAEFAAMIDAhACAADDBdGGAaGCESFFDIGGA....hAFA......hAIA...,2,-12,-12,0
YIBFeCEbKPOSfMXAGVULNRcdQDgZTHWaJ,GAAALAAARADAdAGAQAEAZCDAHDGBaAGE..JEAFBCAA.eCCBhABAEEEBKFCASCEDhACAMAIB.ACHAUDGADGGB.hAAATEAAIHHAbFDDfFFE.hACA......hADA...,2,-12,-2,10
dWHVIAbETSfCDKJacGBQXPMeNURFZOYgL,EAAATAAA..CACAKAEAaACA.GAGABAFAQBGA.MBDBhAAAeCCARCEB.ZDCEOECBhAFALEABHEGBAAIBbDFDhAAADEEBXGDA.NIAB.FGHD....hAEA......hAGA...,2,-21,2,23
WBTEHDKAOXdZQUJNVgSMLPaCIefFGYbcR,dAAAZAAAQAEAUADA..VAFAMAHBLDBAaCAA.eCHFhACAGDAA.bDDAREFBTFDAhAIAHEGBAADAXFDAhABA.NAIA.SFHHCCED....hBAA......hBCA...,2,-22,10,32
NgJBUQLDReMKIAGCYaWOFdfTXPcHbZSEV,GAAAaAAA.FADAdADA..TAGAXAFAHCDAZCCAECHF.VEFBhAAAgCFB.BDBDhAFALFCBRFFAeGAAMEIBhACAAAIBCEED.OFEH.fGAA.hAGA......hBAA...,1,9,-23,32
SdONETFMCKYeaPDALIUGBRJHWQbgZXVcf,LAAAGAAARADAHAGBQAEAZCDA.XAGAVEEB..SDADhAAAdCAAECCAMCHBKDHBeFCBhACAaDEAADIBBEEA.hADAbEAAfGAA.OHFCTGFA.hAEACHAADFIB....hABA...,2,-11,9,20
DGCaHReMAUVcQEBfLKZWbJOPNdFIXTgSY,VAAAEAAALADA.ZAGBJADA..OBCBdAGAFCDA..TDDAhAAASBHHGEAAHDEChAAAREGBAAEAQFCChBIAKEHB.PFFBXFFCDCIB.eDDD.MIAAhAIA.BHHA..hCAA...,2,-21,8,29
TAdHGUOaSDPFJEZcCKbeMYBVgNQLRfIXW,HAAAGAAAaACADADAFAFAEAFAZBFA..KAHBeCCBBCDA...VCFAhAAAQDGC.REDFXFGAhAAAADCBdEEASEBAhACAcCEC.MEIBNIAB.fGFA.hAIA......hBIA...,1,-7,-23,16
XGDYQIPCgWAELZJBaHKTbVFceSNOfRUMd,EAAAZAAAaACAHACA.KAFC..TAFAFAHDeCCAOAHDRCFB..dDHAGCCBhABAQEAACDGAAEFBLFAAhAFABEEA.bFGBSGGAhAAA..fHAB.hAEA......hCAA...,2,-15,-9,6
XTfbFcLVAKIQNUdMEHYaDROPWCGeSZJgB,QAAAdAAAHADAaAFARACA..OAFACBHA.eBFFZABBBCEA.TDCAhAIAbCDDLCHBhAAA.ADAAKDGDIDGAhBAAMHDAEGGEDDIBGFEBSDAAXGCC.hADA......hBIA...,1,-6,-11,5
SFeLCABIaYHRXVMZKTbPUDcWQOdGNfEJg,aAAAHAAA.RADFMAFAZACBKAEA....bBFADAGA.QBGAhBAAGDAAECCBSCEBhBBAeDFBAACABDGBXDFD.hAAATGGAcFGDdEDAfEEEFHEC.LHFAhBGA.CHBA..hCAA...,2,-23,16,39
RBIZUAeOPJHdbEFVaWGSYTDfgLQKMXCcN,eAAAOAAAHADAdAEAFAGAaAFAGCCA.SAHHTCCADBBBLCFBhAAAKBGD.MDHBhABACCHAREBBZDFAACCBbFDD.EGGBVFFAhBAA.......WEED..hBDA......hBEA...,1,11,-24,35
dRWJETASUBKafGbQZgFcDCNVHMPLIXOeY,BAAAaAAAGACAZACAFAFADAEA..CBHA.HAFCLCCBOBBH.eCEFhAIARCEA.ECGBAADA..KDHBbEBDhBAA..QEEBhAAA..gEGANIAB.MFFBXGGAhAIA....hCAA...,2,-37,6,43
TBFgWfJXYRMbPIEOHeaQLKGScDANUVCdZ,VAAAZAAAFADA......fADBXAFDRCAAMAFA.IBGAhAAAHDEAeAHBaBHDLCDBhCAAGECADEIBACFBCDGDhDAAdFGATFEA.BEHA.....hABA......hACA...,1,-12,-17,5
FHIUPSdXTCMGRebaEBLgfQcKJOZAYNDVW,DAAAFAAAHACBUADA.dAEB.CAHA.RAFA..eBBBEBFBLCHB.QDEChAHAKCGAZDDAADBBVFDAhAGA..IGFAhBAASGHB.MIAAaHDCfHGFhCAA..OHEE.hCBA...,2,-26,-21,5
KafFTDbNeXQMHCYALZPJScIUdWGEROVgB,ZAAASAAAUAEAGBGARACF..OAEABAHBKCAAaAHD..TBEAhAAADDDA..eEBAMDEBhABAHEFBADGALEHBhBHAJGBA.dFFA..WFHH......hABA......hACA...,2,-29,-14,15
EfDFQdYbJUSaIAKBVROWLgXGPHTCMcNZe,BAAARAAALADBGACAHAFAMAEAZCFA.EDCBFAHD.dBEA..bEEASBGDhAAA.AACBODHDhCAAXFAATEEAhCBACGEAeHAG.QGGBUGEBIHHA.hAAA......hABA...,2,-15,-4,11
aYWVcIBEdLJMNHRDgPQbXUCSTeFfAOGKZ,GAAAaAAA..VADABADA.EAFAdAGAMAIBHCCARCDA.DAIB.QDAChADAXCGDSDADhAAAeDFAABBBZEEA...hBAAcDCCLGDAgFAA.bFEACHHA.hCAATGCA...hCCA...,2,-6,-5,1
PNYeUWGJFdbOfXIAcRBQLCgMKTDHEVZSa,RAAALAAAMADA.TAEAHAFCEBDF.ZCEBaAGA....PCHDhAAAeBGFGCAAdEDCOFGBhABAXCCAACCBBGEAQEFBhABACHHADIAA.SDHB.YFDBhACA...hAIA...,2,-13,-5,8
SNTfgHBLDYcZMeRbUEGKIOVFQCaWXJdAP,SAAATAAA.HACBLACBDAEAZAFERAEAEBHFGCEBKCEDOCFDhAAAQEBA.aEEBXEAAhAEAAAAA.fDHAhAFABEHAMFFBeFFBIGGACFHAdHAB.PHAAhAHA.....hAHA...,1,-3,-9,6
QfIHVbFedUAcaNCJLZPSGXYWREgBDOMTK,aAAACAAAZACAGACA..XAFBRAEABAHBMBBBKAHB...QCFAhAEAHCCAFCGDeDABhAAAACIBJEDBLFABSDHHhADAEEHFOECB.TEEAfFFAIGGAhAEA.....hAFA...,2,-18,-11,7
GEDAIdCUYHcaKTMOSNJLgVRfQXPFZbBWe,dAAACAAAHACAaADA.KAFC..MAGBOAHD..SAHBLCABRCCAhAAAQBDCFCGHZEEABFCAhACAeBHDEGGBACCAIEEAhACA.UFGAYHBAcFDC...hAEA......hBHA...,2,-17,-16,1
HgdZeDAFBCEXOWJbVaIfGYQLSPRTKMUNc,CAAAEAAA..OACAJACB...aAFDGAEALAHBRAGBMDDB.UEAAhAAAHBCBZEEAABCBXDFChAAA..bGDAfECEhBFASEGETFGANIAB.dHBB.eEEDhBHABHHA....hAEA...,1,-7,-14,7
CNBAEOMUKRSVbaPZGfeTDLIdcXQgHFYWJ,EAAAMAAARACA...SACAaAFA.GAEAeAHHLCCAhAAAdAGBQCCCHCFBFDABJBHFBDGDhBAAADIBKECAVFGBZEEADBBBhCAAXGBA.WFFDOFHD...hADA......hBGA...,1,-3,-12,9
KQIBNSJOWCUTZHgaGXYeRLDcfFdEMbVPA,QAAABAAASACAOACCUAFAHAFBGCAAeAHBRCDBLBHBhAAADDCBFDGDdEAAECCAMDEAhACA..bFDCAEEAKEFAIGHAhAAAJFHB..WFBH......hADA......hAIA...,1,1,-19,20
NBPdRLJVbIOEWXCYfTAeUMKHaFZgcSGDQ,eAAAMAAAHACCZADB.SAFBGAFAQDBCBAHARCCBLCFAhAHAbDGD.EEFACAHATEEAhAAAABBBaEHDFFEH..DCIBPHFChBAAdHABIHHA.XFBAfHCBhCAA.....hABA...,2,-8,5,13
ALHVXKJUbgBWZcEOINRMSTYfdDFQGaePC,HAAAKAAAUACABADBZAEBEAFA...OAHDRAGB.MCABTDFAdCCAQCFChAAAGEBAeDDBhAAAAEEBLEHB.hAIAXFAAbFFA.gFDAIHFA.SGFHhACA..hAFA...,1,-11,-15,4
RZQATOJIBWdHLGCePEMaUFYgVbcfKDNSX,TAAAOAAABADA.HAEBGACA.eAEAEAGAaBBCFAHDgCAGhAAA.bCFCKBHBhAGA.SDDBhBAAREDB.ADGAIEGAdFAALFFBMEIBYFHBhACAfFEAXGCDhAEA...,1,4,-26,30
bULHMQDYZPgRCIEJSaeXdTOVGBAFfKcWN,KAAA..NAAALAFAHACBMAEADBBAZAFERBCA.ECAB....aCEEeCEAhAAAdCHA.TDGAGDAAhABAACIBFEBD..fEEAhACAbEEDQGGCgFGA.CGEASGADhADA..hAEA...,1,2,-24,26
CegWDZLFaETHGKOcbRBQUNfSYMJIXdPAV,eAAADAAAZABELAEAFAFA.EBCFHBDCGCEAOAHDRCGBBDDC.QFAAhAAAUDAASDDBhADAMAIBXGCBhABAADGACEGA.aFHDTFEAKGFB.NEIA......hAFA......hAGA...,1,3,-22,25
cKENMZFJXOPYSWVfLCGUIgTDAebRHdQBa,RAAAHAAAdADABAFAaACAEAFAZAGB..FAHD.OCCASCCD..hAAAfCFAGDDAIFAAhABATDGAADDBeCFDhAFAbFAAQFFCKDHB.MEEBXFGDhBIA......hCAA...,2,-23,4,27
PDGbaBRNOgYfeTZcEXIJUQKCMFWVdLASH,HAAAGAAAaACARADAOAGD..fAFAeCDBZDEB.EAHBXDGAhAAAICCA.QCEBhAAAMDABFFCBdGGAACHBDDIBhAFABGAAgEEA.TGGA..hAIA......hCAA...,2,-12,-9,3
IeNVGYKFHLZScbPWBfROJAaXEgTCDdUQM,EAAATAAAdADA..MAFAeACE.GAFAFBFAHCBAZCCASAHBhAAA..bCFABBDDhAFAREEAABCAaFCBCDHAQFFAhBHA.IHDAYFHBKEED....hCAA......hDAA...,2,-12,-9,3
DeRbHLXWcCfUagFIOEPKGdTYVABZNSJQM,ZAAASAAAMACARAEA.HACBLAHB..XAEACCCD.aAHBhAAAFCEHECEFGDFAdDGATEAAhABAACGABEHBQFEChAEADGIB.WDHH.......hABA......hCAA...,2,-33,2,35
CEgSGVcTMbYWaFOHNZBPfeUKAIJRdLQXD,RAAAdAAALADBQADACAFA.EAFAGAGA..TBGAMCCB.bABDhADAaDED.HFAAZDCEfDGEhAIAeDHHAAAA.XFFChBAASFGD.cGDBFGHDNIBB...hBIA......hCDA...,2,-7,-1,6
fYbgBUIPedDHQWNCMOGKaRTVXLFJEScAZ,ZAAA..bAAABADBUAEAeAEHHAGDQAGACCAAGDDA.RCAA.TFGAhAAALDFA.EEEBACCBfEBAhABA.hABA.gGAAdDGDDGFBMIAAaFHBFGDB.SGFHhACA..hAGA...,2,-15,3,18
MabXKRAVGTBcegQYHZDOdFIPSUNCLWJEf,GAAATAAA.eADAQACCHAGBZCDAdAEAFDHD.SDADhAAACAGALCGBEECAaDDAKEFDAAIBBEEDhAAA..gFCAhACAOEHDIGAAUGGANIAB.fGDAhAGA.XGED.hADAcGGC.,1,18,-10,28
HcLEQPaIfZVKBFRbWDCMNSUdJGeATgXOY,TAAAOAAAHADA.EAGEaACAZCCABAFARCGB.DAHBMBBBUCCAGEFAhAFAAAIB...XFCAhAIALCFA.QEFAhAAAIHHA.KEHB.bFAA.CDBC..SFEDhAFA...hBAA...,2,-18,-10,8
MdUgOZTNKfQDGFHbScCYBWAaLPReEXIJV,aAAARAAAEADE....XACDVAGB.dAEBOCCAZAGBKBFD.QDDChBAAGDDBHFAASBBDhBIACEHABFGDAAAAeCHHhCAAMIAATFFADGIBFGDEcGEC....hDAA......hEAA...,2,-15,-8,7
DAFcIKTXGLONBWRUZebSHaEJPCQgMfdVY,FAAAKAAAGACALADABAEARAGFZCCA..eAFHHDFBEAHBCDHA..MEAAhAEAdCAADCHB.ADGB.TFAAhAFAODHD..UFCAhAIAaEAEQEDA.fFFBhAAAcFGDNICB......hACA...,1,-4,-26,22
bYCDLXEgeWfTUVKdGBIRMHASJNZPcaQFO,SAAAZAAAaACA.QADAOAEDCAGA.LAGB.ECCBeAHHhABATDAAKCCDGCFAhAGAREDAHFBBAAAAJEDB..cFGBhADAbFGD.XGED.....hCAA......hCBA...,1,8,-24,32
SHXRZdUDVYEcPBLebJIAFNOMCTfWgaKGQ,OAAAMAAA..TADA..fADAaAFAGBBAHAEBRBFBdCHAhAIADAGA.EBBBBDEAeBGHhBAAbEDCABIBCDDA.KDHBQFGAhBAAZFEAVGBAYHFA....hBGA......hCAA...,2,-8,-5,3
ScIGHKJaMdLYZWPAFVQDBNXOgfbTEeRCU,QAAABAAAOACA....bACAEAFARAGBCCDASAHH.hAAAGBCAHCFBaDAAdCBCZCFAhAAAAAIBDDIBXEEAhBCATEAAeEEBIFHAMFDBLGCAPHFCFGAHhADA......hAEA...,1,3,-9,12
KXcHPVEafTYBNQJbMIOARUFDCdgGWSeLZ,RAAADAAAdADAGABB.eAEEZAEBXAGAHCCCEBHF...aCCHTDFAhAHABCGA.QFCAhAIAMDIBAAAAFEEACFFDSFHBhBAA.KHGAPFGD.fGCAhAHA.....hCAA...,2,-24,-5,19
YHDCfcUbNSXVZPGAORMEaQdIeLgWFJBTK,RAAAEAAAdADALADAFAFA.BAHAKBFDHCGBDBCB..CCEA.UEDA..hAAAbCFDXCCC.hAAAZFFFAAEAaCHB.eDCFhAHA.JFEFfFHA.NIAB.SGGAhCAA....hCBA...,1,-17,-30,13
RSTOKJYQHZfACGaUNcDXVIeMbFgBPELdW,aAAAUAAA.DADA..XACDeAEA.MAEAFAHDBBDDLBEBRCDA.hBAATBGAKDGA.QDGBhAIAHFEAAFIB.GGBBhBAA.cEDCIGCAbFFD.EHFASBBDhBGA....hBIA...,1,-5,-31,26
LAQcPFHERCMBSXbOgZeKNJVYDGUTadIfW,QAAAFAAAHACBRAEABAHBSACA.OAEDeCEAKCHB.JEAAhAEADAGA.GBGAUEEAdFHAhAFAfCDE.hBAAABGBEDAACHEA.bEFD.NEIA....YFEDhAAAaHGC.....hCAA...,1,0,-21,21
bPBLaJXAGVWdQROFcEUNHDICKTeZfgYMS,GAAAdAAARADAFAGAEADA.HAFADCCB.KCDAZCFA....fCGAhAAAMDAB.bDCCLDDBhACAaCHDAAHA.QFFAhADAODAHcFCBIHCAeFFASHEGhAEABGHA......hBAA...,1,14,-29,43
fWZEHNbeTRcCQgIVDGOUMBXdFSKaPYLJA,ZAAAHAAAeACERADFQAFC..gAFBDAIBGCGAMAIBhABAdCADKDDD.aEFHLCCAhAHAAFIBEFDF.bDEACHAAIHHAhAAAOECBXFFC.SGDBhCAA.....hACA...,1,-5,-8,3
GeIWYCPENBLZXdVaTKfSDQOURAJHcbFMg,HAAAFAAAGACAeACE..IAGACAEA.EBHFLAGBZCCA.dCFChAEAaCEATEDASDGAhAAAQFGARFAAAEEBbFFAMAIBhBAA...gGBAPHFCNIAB.BGFDhBGA......hCAA...,1,13,-20,33
GLDFKMVJHWNfcZdSCAaPXUOIbQBERTgeY,aAAAXAAA.UADAOACD.QAEARAFAeCFAGDBALAHBhAEAKDDA.MBBBHEFAfCEEhBAAdGAAAAAA.bDFDhBGAEGHB.YHEAFEHFWEED.....hAGA......hAIA...,2,-6,-3,3
GQESUeDIVHaWdPLMAgcBfTJKFbYXRZNCO,BAAATAAAFACA....XACBRAEFZAGBOBCBEAEAUBGA.eCCAhAAADBIBHDDAdEEAMEHBhAHAAEHA...fGCAhAIAbFFA.CGFA.GGAB.SHFAhAAA.....hCAA...,2,-21,-16,5
YUfGPcQNIKOCRDbXMgaLFdEBTZeSVWAHJ,HAAAUAAAGADAQADCKAFA.RAFFDAIB.MCABaAHDdDAABCCDeCFFhADASCGH.ADEAJEEBhAAAfDGA.hACAPEHDIFHAbDBDLHAAEFAATGFA.hAFAWHAAcGGC..hAHA...,1,-3,-16,13
fJedQcFAgNBVGRLHYESDKPOXICMZbUWTa,BAAARAAAHADBEACAKAFA..OAECCAHBZCFB.UCAA..aCCHeAHHdDAAFCHDhAAAAAGA....gCDAhAAAGFABLFHBhABADCGBXEFAIGGAMDIB...WFEDhACA...fGGEhCDA,2,-24,-18,6
LKTQJSfCEUgbMcHPaNXDVdOFZRIBAeGYW,eAAAGAAALAEAQADASAHHEAFAUCGAMBDBHDCAaCEADDABhAAAdDFDZFDBBEDAAAIBKFGATFAAhAAACGFD...bFFAhABA.....PHFC....hAFA......hAGA...,2,-11,-9,2
MOYNXReDTPVdGEKZaIQJfAcHbSULBgWFC,HAAASAAALADBBADAFAFA.MAIBOAED..XBFChAAARAGBeCCBDCGBTDFAdDAAEDHFhAAAaCACQFFBhACAAAIB..bEDDWEEDCFFAPGAA.KGHBIHHAhCCA...hABA...,1,2,-20,22
baYIUDBKHcWAXRVQCZSgeEPOJNMLFdfTG,RAAAQAAAZADB.eACAEAFAOAHD..MAGBdCCCGCFAhAAAaAHBICDABDAAHFCAhABAABFBCCHA.SEHHhADAJDAALEEAfHBBbFDCDEIBKGHDWHFA..hBHA......hCAA...,2,-10,-10,0
CdcZPBRIUVMKDfTHSWFEbQaOXANGLYeJg,GAAAeAAACADA.ZADARAEF.UCDA.KAGCDAGAHCFCFBGD...EEABaCCBAAABLFFAhACA.JHFAhAEAdDDA.BDHA.MEGBhAAASGED..bFED....hABA......hBIA...,1,-9,-39,30
PDHbFBRdKCVLIEaYQONgUfcTJXMeSZGWA,HAAABAAARACAdADAKAFCLAFA.ECABaAHDQCEA.OCCBhAAAgCAAUDGATGAAhACAMCEBZCFAAAGAbFFChCHACEGA....IGCANEEA.JFEB.SGGAhAAA..hACA...,1,15,-41,56
OgdcQBDbCGPfReZaTXLKYHESVFWANJUMI,UAAAMAAA.OADAdAEAQAGABAGA.CBBA.GBDA.RCFFeCHHhAIAaBDBLDEAHDBBEFFBhBAAFEHDABDB.IFDAhAGA.DFFBfFHAXGCCSGFHhBAANIBB.....hBCA...,1,-13,-14,1
TPCXgcBFaYREDNKbdGMWQOAJSeVLZUfHI,eAAAZAAAHAEA.TCAAXADA.BAGAaAGARCEAEBHF..KDDDGCCAhAAAMCIB.QEAChABAAACASEAALEFAhAEAfEFACGCDFGEADGIBdGGAOHCA..hABA......hAEA...,1,-5,-9,4
AcOMgfaIbKEJZCDRSPeGFWNLTQUHVBYXd,MAAAaAAA.KADAEADAZAFBRAFA....eBBBGBBAFCFHLCHBhADAQDGAHDCBBAHAdFFAABBBODEBhAFAfGAAbECD.hBAADGIB.SHDG..PFFBhCAA......hCDA...,2,-20,2,22
AdgCTGaYSfJUNZKcIODPWeQFLBVRMEbXH,dAAATAAAaADA...SACBUAGAZBDFKCBAOAEA..DDFAeAHFhAAALEGBRBDFECFFHEFAhBFAADIBGFCBfGHAhCAA.NCCA..IHEAWFHHBGBD.MIBAhACA.....hCIA...,2,-24,-6,18
UILHEdafRYBMFSAWcOVDPQgTKJCZbNGXe,OAAADAAAQACAKADAZAFB.GAEB.eBBBLBHBHCFCEDDBhAFAaBBCRCDBMEGB.AAHAVFCBhBAATFAA..bFEDXEGChAFA.dFCABHHASFFD.hCAA......hCFA...,2,-17,5,22
dBXVQHPDJebFYUISfLAEOCgTcKMaRWNZG,EAAACAAA....TACAMADARAFAZAEBdBCABAGAQCECHCAADAIBeCGHhAAAFCGB.UEBA.SDHHhAIAADIBOEABKECAhAAAaFFC.GEEA.PEHB....hACA......hAEA...,1,-11,-19,8
LfSBcFZQCYaVAbDRXgdMETeGUIHOPJKWN,RAAAdAAAEADEeADA.GAGAHAFBOAHFKCBALCEBBCCAZDEA.QECChAAAaDACAAIB.bFABhABAXEGA.MEDBhACATFFAIGBAPHDCNIDB....SGEAhADACHHA..hAEA...,1,6,-19,25
RBgFdUTDeIPYfcSENMALCZObQKHaJXWVG,ZAAAQAAAHAEAaAGAJACE....XCAAGAFARCDBFCFDdBHADACAhABAeDCB..ICHAhCAAfEGAEDDBAEHALFBBhAAAOFFAKGGDBFHA......hAHA......hAIA...,1,-14,-15,1
JbIZMNdTfLSKgFPWQcAeOCHEaVRBGYUXD,eAAAHAAAEADERADAGAGAUAFADAIB..bCCAZCAA.dDFALEAAhAAAKDHBFECH.QEEBhABA.AAIBaDHDBEECXGAAhAEAMFHBfHBBSGDB.gGGAhAGAPHDA....hCAA...,1,5,-17,22
YFaTIeACKHgGBNbMZUXLVPREDWfJdOQSc,HAAAGAAABADBMADAZAEBLAHBRAGBDCAB.JBFBdCCA..QDCAhAAASCFHFEGAaDHDeFBBhACA.ABHBKFFA..hBAAbFFC...XECAEGHF.OHEEhAAA......hACA...,2,-23,-5,18
MUgHbKPGLRYJODVBCdFWfaZeQcXAITSNE,TAAAEAAAUADA.HAFAKACCGAEALBCDRAGB.OCFEBCCAdDGDFEDD.hAAAaDEHeEHB.QFFChAHAAAIBSEBAMIAAhAIAbFGB...PGAADIEACHHD.....hCAA......hCBA...,2,-11,-1,10
XabPRBEZHKGYVgFLIDOcTQfCJAMdeNWUS,eAAAUAAA..aADARADAEAGEHAFBGCCA..VCDBLCFADAIBODBBhAHATEAA.QEFAhAAACDGAADIB.dFHASFFAhBAAbGCA.ZGFE.KHBA....hBCA......hBDA...,1,6,-18,24
YFKELIQPOcNXbeJgTGVRSAaDWZUHCfMdB,aAAAZAAAHAEA.MAIBdADAFAFALCABQCEAOCCB.XCGDhABAeAHHTDBA.hACAREFAABBBDDEACFBD.BEEAEGDA.hBAAIFGA.cGAANIDB.JGCA..hADA......hAEA...,1,-11,-15,4
eXTWBKICUfYcZPSLAdNJFMbEgQOGaDRVH,dAAAFAAAEADAQADA.GAGARAFAHCCAeCAATCGAKDDACAFAUECBhADA....fEFAhACAZFEBLGAAAAIBMDIBhADAOEHDaFDBXGDDBGGD.IGGAhBAA.....hAGA...,1,-3,-10,7
IERCbBNFLJVPcUTWYXaQMOfAdGHZKSDeg,HAAAZAAADACAeACE.EAFERAEABAHBLAHB.VCCAUCCB..TDFAhAAAXCFA..hABAaEHDMCIBACFAdHCBGEFAhAFASFFDCFEC..bGCC.....hCAA......hCCA...,1,-3,-26,23
ALNPOMUCQYbZTSBfIEGWJHaFRKecDXgdV,LAAAOAAAUAEAQAEAZAGB.TAGABBBDECDB.GDBAhBAAHCAARDCA.eCHFXDEDhBDAdFFAACCAMEAB.hBEAbFDDfDHAIHHA.aFGE.KGEADIAANIBBCHHAhBGA......hBIA...,1,13,-16,29
bTRVJWUYHFKIPNSBZXACcMaLQEODdefgG,MAAAaAAALADA..EADAdAHAeAFAGCCARBBBJBHBUEFA.HEABhAEAKCFB...ICFAhAFASDEDBBBDAEIBQFCChAGAfGHA.bFGDWHBAFGFB...hBAA......hBBA...,2,-19,-8,11
KVSDTCMGOYBQJHAgNPdUEWaebLcZfXFRI,...PAAAEAAAeACALAEAZAFBFAHDRBCBKBHBDCCA....MDAAhAAAGCEABDEDHDGBABFBdDHAhADAaECC.bFAC.XGCAhAFASEFHCGGD.OHEA....hCAA......hCBA...,2,-31,4,35
QIKWEBOGdXJMHSNAZYCDVPUgeTaFLfbcR,ZAAADAAAUADAeACEFAFALAGB....bBFARBBBQDEChAIA.KDHBECCBGFBBhBAAdDFAMCEBHGFAADHBCEHA.hBBAgGGAaDBH.......hBDA......hBFA...,2,-22,-12,10
FNRCgOKVaULJGDdIcQeXAbMPWEfTBSZHY,MAAAEAAABACAHACCFAEARAFF..OAHDKAHB.UDCAGBCB.dDDDQDGDhAFAACHB.bEEDhAHAfDGE.hBAAZFFACBBDaGGALHAA.DIEA....hAAA......hAHA...,1,-4,-28,24
WQZIdKgHCPBEGDRMXbJTVAeYNFSaLfUOc,eAAAFAAALADAOADC.QBGAdAGAHCCABCHAECCA.RDFBMECBhAAAXCED..bFADTEAAhAEAAEEB.SEDDhAFAaEHD.fEHAWFFDIHHACFFADGIBYHAAhAHA..hAIA...,1,-7,-18,11
fWceaPHTLYOUKSXgRFCZBEMQVdNDbIGJA,...fAAAeAAAHADALADAOAFASBGARAGFZBCAECAFMCIBhAAAdCCAbCFCGDDAAAAAaEDDhCAATEAA.KDGDFEHBhCBAQFGDDFFBIHHA.....hACA......hAEA...,2,-3,3,6
dTWFcfLUDPbAYJegCNVHXMOKEIaRGQSZB,eAAACAAAHACAMAEAKAFC...EAHFRBFAGCAAZBAEdBEAFCGHLDDB.hAAADDFBACIBJDDF..gFGAhAAAXFEDaECHhABABDHA...WHDGfGBE.UGGAhBGA.....hACA...,1,-4,-26,22
UCFeBWTMNfGLPJHZEaXRSgQIVYKOAcbdD,dAAACAAABACAMADAGADALAHBHAFAZBDAECAARCAA....QDEChACAICHA.KEBAAAHADDDBhAAAeEGF..TEFAhACAfFHAaEHD.SGBAgFAAOHCEhBAAbFDD.....hAFA...,1,-3,-20,17
XOWQCHgfILFcMEKeVTYbNAGUZRPdaJBSD,ZAAARAAAdADAaACABAFA..DAFAOAGD..QBEAHCDC.hAAAfAHALEEAMAIBhABAECCBeCHFTFAAhAFAbEDAAEEAGGEB..PFHDSCCDhCAACGCA......hDAA...,2,-13,-12,1
RaXcYSgDNJfKBECVIGZTQOAFdUeLMPWbH,dAAAeAAAMADA..bADAHAFC.RBDBaCAEXBGD..SCFBhACADAIBJCCABEAAECHFCEFDhAIAGEEAZFGB.QFCAhAAAADDB.FGHB.PHAC...hBAA......hBCA...,2,-20,-7,13
aXBRNSQDVPYeGbWIdFLJMTUKOgfcZAECH,HAAAaAAABADARADFQAFC.DAIBPAFAeCABGCGA.hADAIEEAdCCALBFAhBAAMCCBKFDDfDFAhBBAADDBEGFBCHAA.SDGH.bEDD.FGGA.hAAA......hACA...,1,-2,-20,18
fcJGHbBWPgCVOIKReUAEZDLTdYNSMFXaQ,EAAAZAAALADBdADA.SAFAMAFAaBCB.QCAA.hAAAJBHBHBEBBCFAgBGBhBIAOEEBRFAAAAFATEFAhCAAFFGA.fDDE.bGCACGGD.KGHBDIAAhABA.XGED.hCBA...,2,-16,-7,9
OULYBZfJQAGNTeXdSPIcEMWFHKDaCVbgR,GAAAeAAAdAEASADA..IAGAEAGAMBIBHBCBaCDACCGAhAAAbCFA..RDDBLFGBhACAZEBAQFFAAADATGAAhAGAXGCC.WFHHDFIBgGCBhBAAOEEG.....hAAA...,1,6,-14,20
cCFOPXeBLdRVMUAJgZTYDNHQfEbKaSGWI,ZAAATAAADACAHAEA.EBHFaACA.GAEA..IDDAhABAFAGAXCCCeCFFdEGARCGBMDBBhAAAAAGAJECF..gEEAhBDANDIA.QGBAKGFD.SFHHhBGACHHD.BGGChCAA...,2,-14,-8,6
PZLOIKXNFHedSgTbBRQADJMEfWYUVcGaC,MAAAEAAA....fACAUAEAGBBAaADD.ZAGBLAFAhAAAKDEAFDHDHFFAeCDAdCHATGBAhBAARDFBAAGADEEB.YFFFhCAACEDDIHHA........hBBA......hBDA...,2,-17,-8,9
VLAUGRcWSNETJZBKOaCPbgQYXfFMHeDId,RAAASAAAEADE.ZACBOAFA.aBEEbAEA...QCEAhAAAfBHAHDGBeCCBhAAAdECAADGBGEDAcEECTGAAhABAKDHBCFFB..PFHBXGDD.MAIBhAFA.DGIB...hABA...,2,-19,15,34
LWFCQZMPUbcSNgDeJfABTXKIadVYEROHG,TAAAKAAAdACA..EAEAHACB.GAEBLAHBCCADZCEEMBGBUEAASCDAhAAADCIBeEFBAAHAXEAAhAEAaEGF.REEBFEGEhBHAbFCB............hCAA......hCBA...,1,1,-22,23
fDaOEJeKUMSdILcGYNVCTHWAQbRPZFXgB,RAAAZAAAFADABADB.DAFAEAGA..eAHFMBIBdBFALCCAGCAA..hAAA.VDFBHCDBACGAQECAhABAbEGB.XGAAhAGAaFCBKFFB.SFHH.IHDAhCAANICBCCCDWFHH...hCDA...,2,-17,-10,7
TUVMaLDQfCYFOXNdEZbHAcWIPKeBgRJSG,..IAAAeAAARADAGAGAUACA.MCCBaAEE.LDDA.QFCAhAAACAHAOCBBdCFAhAFAEEABHFFAACHA.cGAChABAKDDBBDHASHFATFFAfFDEhAHA...YFHBhBCA.,2,-42,14,56
UdfaTQSCMJEVcLebBOZDGgWKYPRFAXINH,XAAAHAAAdADAaAFA..TADAQBFCMAFA.ECABLBGBhAAAeBHHOCCBGDAAKDEDhAAARCDAABIBIFFAfDCEhABACEHAVFCBbEFAZFEADGHB.gGCB.hACA......hAIA...,1,19,2,17
SVPBMWLNagUROHQTKXGAYdbZcDECIFfJe,dAAAZAAAEADEFADA..eAFHSAFBBAHALCCB..aAHBRCGBHEDBhACATCAAKDBDABIB..hAHAbCECCFFB...fDHAhABAPFHD.MDDBNICB.OEFB.QGGAhACA.YFCFhCAA,2,-25,-3,22
UGSWLRFDeOcBbagdCfXANPJVTZIKYHMQE,JAAAZAAAKADCHADB..EAFAGAGALBHBRDAAeDFBBCAA..aDHDdCCDhABA.CCFA.AAFA..PEEBhADATEEA..MIAAhAIAQFCCSFBADFHBOHCE..hACA......hAIA...,1,-6,-27,21
ObIFVaCNUHPXdSGRDYLfMQBcJKAgETeWZ,EAAAeAAAZACBOADC.FAGAaAED.UAGAHCCAdCBCRCFFLCHBhAAA.MECBQDEAhAAABEEDKFABADHATFGAhBCA.bGBACGGA...XEBADGIBfHEBhABA.....hBEA...,2,-18,-8,10
LYcVGKCWOSgXdJPbEZDRBfNHUQeaAITFM,TAAAMAAALAEA..VADAGBBACAGB.SAHHhAFAdCADJBHB.ECGBRDCABCFAHDEBeDHHhAGAAEGBFEHD.KFCAOFFBhAAAXGEA.........hACA......hADA...,2,-28,1,29
FTReaYIdXbHEMfVNQCAgBPWSGKJcLDZOU,BAAASAAAGACAKADALAEAZAFB.FBHDRCCBeAHF.aCHDdCAAhAAA.HCEB.EEGAMDABhAAAfFAAQEFChABAAAFA.gFAHPFHDcGCAOFHD.hACA......hAIA...,2,-16,-6,10
RGPZCaBJLIUdFMYfWKegNDbEHVAXTScOQ,TAAAOAAARADA.ZAGBaACA..LCCAdAFAMAHB...fBDEhAAAeCHHDBBBHEAAhAEAAAIBSCCDGEEABGADhAGAIDFAFGCBKGHBbEEAEFBA.XGGAhBFA......hCAA...,2,-22,-3,19
VMILPSHGKfAaOdZEUTgXYCbWDNFeJcQRB,dAAAEAAAUADA..TADA..XAFAbABD.DAIBeAFEhADAQCBCRBFBMCIBLDEBhAIAHCFAGEDAAEEBZGFEhBAACFFBFFHBBHCAIGAA.....hCDA......hCHA...,1,-10,-11,1
cCRYHVDQdKNBeUAbfFPJTZaXLSEIgGOWM,FAAATAAAZACBLAFA..EACEGCEAMAEARBDAHCGDQBGChAAAdEBABEDDAAIBbDDCfFHAhAGA.aGCDSDHHhCAA.OFDCCGFADHAANIEBeGFA.hAHA......hBAA...,2,-11,-1,10
XEVILWRGBcTAfMedPUOaNgFKJHDYbCSQZ,eAAAdAAAOADA..aADDFAGDHAFADAIB.bCCA..QBDChACAZCGBEDBBLFAARCBBGDFAhBAATGDAADFBMDIBPHAChAAA.UGGAKHDACHGA.SEED.hABA......hAFA...,1,7,-14,21
fcaMFKQHVLWRPAdTZYgSCBNGDJEOUbXeI,ZAAASAAABADBGAEAEADA.UBGA..eAFA.ICCAhAAAaCAAMDDBQCEAhABA.HCGDLEEAhABARDABABIBdECATGAACEEDDEIBbGACfFHAKFGD.hADA......hAGA...,2,-25,5,30
FeHgSDNYcMTBVQaPOAZWCELGUXJRKdbIf,ZAAAEAAAGACAUAEARAGB.dAEB.....bAGDFCAAHCEBDDAB...hABANCBA.MDDABEGAaDGEAAIBLGCAhAAA.KGGAhBCAeEBA.SEFD...cGFDhACA....hADA...,2,-40,-4,36
gAVQCHWBLPNITDSdOJGMXYfeRcbZKaUFE,QAAAHAAALADB.IAFATACAdAEAGAGAMAGBfCAEhAAARCGFZDDBaAHFEFFBAAIBCCCCBCFDhACADDDB.ODHDhEAAYEHBeEEB.KGGAFHBA......hAAA......hBHA...,2,-6,3,9
JfRVDFaIWQKHgNGZcdOTMbBCYXUSePLAE,EAAARAAAFADA..aACDQAGAHAEAGCDAdCCA.MAIBBCFA.CDGA.XCBChAAA.eCGBhAEAAAAAVEDADEIBKFFAZGAAOEHDhAGAbGAA...SGGD..hBIA......hCAA...,1,5,-26,31
FcCLSgfbMDUOYKAZJQaRHBWGeEXVIPNdT,ZAAAaAAAHACBGAEAEAEA..XAGA..IAHAdCAATCGAhABACBFALCHB.hACAfDEAbDDDMCCBOEHDhADAABBBRDFFeEAAPGACFGHBSHDAhAEADDDBKFFCBHHD....hAEA...,2,-3,2,5
dZFRKSALMeQHWUEJCPNXaVgBfIGcbODTY,eAAAHAAAEADECADA...XAFBaAEDBAGAGBGA.OCABhAAATCCAZCCARCFA.AAIBMECBhACAQEECUEEBPFHDhCDAgGAA.fEHAbFCD.dGGD.hCEASGCH.hCFAWHEG.,2,-36,22,58
TVEJYWfaZHBdAIPRMGFKXLCQgSUeDbNOc,RAAAGAAAKADCLAGBQADA.SAFAeBDADAIB.OAHDhAAA.TCFAECCBJDFFfCDEhACAHEDBAAAAMDIBhCAACEFDbEGD.VGAAaFHHBGCD...PHEChCGA.....hADA...,2,-9,-2,7
QAbGKNIceSJWdLPDHXRTYVMaOgEUZFfCB,GAAAKAAA..IADAeADASAGA.dCDALAFAhAAAHCFAREAATEGAMCAAaCDDhACAEFEBZCEBCGGDAAAB.NHAB.cCGBhAGA...PDHDDGIB.XGFAhAHA.....hACA...,1,-4,-21,17
NYSbOaCIcRQLMJfgAWXEUFBVZKHPGTDde,EAAABAAAZACBHACAGAEAdAFAeAHB.SCAAaAGACBGB.RCGBLDDBhAAAMCBBJCHBADEBXEAAhACAFEFD..KFHBTFFAhAEADGDB...YFHBOEBD...hAAA......hBCA...,2,-23,0,23
GSXAKcRLIaEDCgFJOYBMNQHbWeUfTZVdP,RAAAaAAAEADE..CADA.FAFA..OAEDMAIBHCCAeAGB.UCFAZCCFdDAAhADAGECBAAHALEEBhBAADEIBJFGB.BDGD.QGCAhBBAfHDBTGGA.....hAAA......hABA...,2,-16,-13,3
HPGKceVRFDUXadgLZYEAISNOCJQTBMbWf,SAAACAAA.QADAMACA..bADAHAFAGBGAeCCBhAAARCBADAIBaCFEdDAAZECBABCBOCHDhABABEFA.fEEAhADAKFEDFFHD.XFGC.LHAAhAHAEHAENIEB.WHFA...hAAA...,1,17,-21,38
EGOAdSLaRWcPMDbZQgFCXTNfJVUYBHIeK,dAAAaAAA.RADA.....PADAbABD.ZAGBQAGCFBBH.TCEAhADAfBFA.hAEAUECAHDGBeCHHEEEBACIBhAIALEFBMIEACGEDXGGANIBB...hBAA......hBDA...,1,3,-20,23
SPFbZIgQGHedaXYMBAOfcRTJWLEKCDNVU,OAAARAAA..TAEALAEAKAGCDBIBUBBB.FBHDZCCA.QDAChAAAHCDBeCFBaCGBMEHBhAFA.AEIB..fFFEhAGAcECB.EGCACDHDSFFA.hAIAbGFA.....hBAA...,2,-18,-18,0
SZHJBOFXcGEDbAPMRUfVYKdLQNgeWTaIC,RAAAVAAAdADALAFA..QADCeCCBaCED.SAFBhAAAHCGBOFFBXBGDhAHAEGAAAAAA.MCFB.fDDAhAIAKGCA.gEFHIGHA.CFHABHHAhBIA.....hAGA...,2,-17,-11,6
WYBLaEQfUXDcMJdTeVGAObIZSHNCRPgKF,OAAAZAAAHAEARADA.KBHBFAGABCAA.LDDAEBBB.QEAAhABAUCFADCIB.MDHBdDDAeEAAhAEAAACASFDA.hBAACGAD.gFDAaFHDXGFDTGFA..hCAA......hCDA...,2,-23,-7,16
QBZCgDTPWJYEbeAfUXLOcdNRFMaHIGKSV,XAAALAAAdAEARADA.aAGAHAGB.GCEASBFHQDAAhAAAZCAADBHBTEGA.hABAPEDBYCHBEGAAAADAhABAOEBBFGGHMIAAKEDACFGD...gGEBhACA....hBEA...,1,21,-23,44
HMEBXPATDdbcJLgGeUNWRFCfYOQZaKISV,dAAAJAAAGADAeADAUBGA..RAFAFCCHCCBA..OCEBZCFEKDAB..hADASDADHEFAEFABBGHAhAFAAAHADDDB.LHCAhAGA..gEGA.fFCEhACAaHGC.MFFB.hAIA...,2,-29,-10,19
CSPbRNfKXFaTDVWYLdQMUZHEGAJgeIOBc,eAAABAAASACARADA.KAFAaAGADAIBVBGB.LCCAhAAAdCAAMCCAHEAAGCEBAEEAIFFAhABACDDD.bGEAXEFAhAAA.TFAA.QGGBhACA.EFEB.OHAEhADANEIA..,2,-13,-9,4
AYTKcgVaEQdZeJfXWBSMFPUDHIRNLbGCO,TAAAKAAA..VADAEACEZAEB..eAGHXAGABCAAMAIBhAAAFCCBDCGBHCCA.RDFALFFAhACAGDGAADIBgEABhAAAdGAAJHFA.SEEB.IHAAhAEANEEA.bECD..hAHA...,2,-16,-6,10
dAGSBXeLECJUTVKFHfRPMbgYOZIQDaWcN,GAAAXAAAEADAUADAKAFAHCDA.RCGF.MAGB...bBGDODAHhAAAZDBA.QFCAhACAaAHF.cFFAhADAAAAAeDFDCAHB.TFBA.fFHA.hBAAYHFADDCBNEIA..hBDA...,1,7,-25,32
bDFZAReHUIYVaXQLPWBNKETJcSMdgfCGO,HAAAUAAA.VAEAaADALAGBBAHB.KBDAECAB...TCCAhAAASCHHdCHACDFAGEABhACADDBAAAIBRDEB.eFDA.XGGAhADAQGBAPHDCJFHB..gGEAhBAA.fEDEhBCA.,1,12,-28,40
gdZRLOYIBHcMaAXQFVSNKeJEPWTbDCGUf,QAAASAAAeACHEACA...TAEAbAEAGCDA.UCGBhAAAdAGARDDALDCDhAFAOBHDBEAAHFFAaGABAAAAFECHhAEAKHEAPEGDCEHD.fGDA.YFFFhAIAIHHA..hAGA...,1,3,-6,9
NDSOgWcHJAYVITPKGXUEaMRZFfbQdBLeC,VAAATAAA..GADAEACE.RAFA.ZAEBFCGDQAGALDAAeDFDhAAADCCAOCFD.gEAAhAAAHFAAAAFAIFHAhADAXEGDMIAAdHDBCDDDNIEB......hAEA......hBIA...,1,4,-13,17
DcALOZeBVEYGUKIWMJfFRbPSTaNCgHXQd,ZAAAeAAAEADEGADA.KAFAMAFAFBHDRCFBSBEA.aBGDCCCDHFAAhAAA.dFEAABIBLCABhABABDBDUGGAIDDAhACA.fDFE.bEGDNIAB..hCCA......hDAA...,2,-26,-12,14
ScaLDEXAdIBOMQKRFNbVHYUTePCfJGgZW,dAAAOAAAMADARADA.FAGD....VBGBHBDBUCDBeBHH.CCBAGDFAhACAZEAASAGEhAEALFBAEBBBAEIBBHGA.hBAANIAB.bEEC...TGEA.fGGBhCAA....hDAA...,1,-12,-14,2
HNKQBbacRdgAFJMPWVXCGLUTYfSOZEDIe,MAAAVAAA.GACBLADBUAGA..TAFASBBDZCFAEDCBeCCGhAFAHEEAQDFAhBAABAHBaFAARGEAADIBFEEH.PFCBhBIACHCA.OFHDDGIB.KHEA....hCAA......hCFA...,2,-2,-2,0
EcJbXRNYdQWCfeALMFBGTaDZVHSPgUIKO,MAAAGAAADAEAHADA.SAFEUBBAOAFEEBHF..JCDFRCEAdCHAhAIAQDFC.fEHAhAAAABEBLFCATFCAhACAZGEE...gGGA..hADA......hAIA...,2,-33,-5,28
XMWGHFQfJRbLIKADTSegcCPOVZaEUdYNB,TAAAeAAACADA...OACAaAED..EAGAdAGABBHAMAIB.HBEBhAAAQCCCRCCBLEGBhBDAAAAASCFHgGBAhBGAPDHB.ZFDAYFFDXGAA..hAGA......hCAA...,1,3,-26,29
ZTGKaHVCMeRgSWODNAFJbPIfcUYQdEBXL,FAAAJAAA.....bACDIAEA.UAGAdAEAEAGA.LCGBhAGAGCCAHDABMBIBRDEFhBAASDHBDEBAAFIB.hBEAfEFAQGDCZGBEaGGBeFHB.OHEChADA....hBAA...,1,-8,-17,9
LFcDHYOXBVTJbKZRNAPMfWCUQSaIgdGEe,MAAACAAAUACA..aACEdAFAGAEALAHBDAGAHBGB..XCBChAAATCCAKBBDZDEAABHB.hBAA.fEEEhBGAQEBASEGAEFDEeEHHFGFDOGEE..hBIA......hCAA...,2,-14,-14,0
eTAKDFRbXNVYLBQCUSWIEfcOMHJPgdaZG,FAAARAAA..XADBVADALAGBBAFAQBGAUDAA.SCCBhAAAECCE.OCEDhABAHDEAgEGAhADAZEFBeEHFAAHADGDAbGCACGHA........hAIA......hBAA...,1,-13,-15,2
BTfMYXRQWCHFOeDAZVLNcgJESUPaIKdbG,ZAAALAAA..gADBEAEASAGAUAGA.aCAAdCAAGCEAhABABCCDMDEARCGB.QEEAhABAHDCBeEABADIBVFAAhACAcGCC.IGGAbEGD....hACA......hAEA...,2,-8,-4,4
WHDPfYGcTVbFMZgCJdXLANQaOUBEIKSRe,aAAABAAA.EACAKADARAEA.HAFB.DAIB..fBHAGCCATEFAhADAFCAAZDCB..CBBDdEHAhAFAAAHAQEEAOFDDSHAAhAHAeDHF..PFAB.cGCDhAAA.bGFA...hBAA...,2,-19,-9,10
cMZDgVHTANWIaRBSeOYCUEbXGQPKFfdLJ,..IAAARAAAeADECAGBUACA..EBDFGAEBQCEAFCBHdCFDLCHBhAAAMCIB.ZFFADDDBhAFAHGDAAAHA.aCCHOEDDhBCA.XFFA.fHEFhCAA......hDAA...,2,-24,-7,17
SPgGFIDaVBRHTKZWeECNUQbfJcYdLOAMX,MAAASAAAGACBDADABAGBHAECZBFEEBCFCBBD...QCEChAAA.JBHBdDCAAAHAXEDChABAFDGAaEDDRFABTFFAhAFAeEGBNEIA...........hCAA......hCBA...,2,-22,-13,9
COFGEYJcNfaTUgLVKdDHQSRAeWMIbZBPX,eAAAMAAAZABEBADA.CAFA.GAEA.EAGAJAHB....fBHAhAGAaCCAUDDBLEGBhAAAdCCAHDFBREDBACFA.IGHAhBAA..bFABOHECFGDA..NDIA..hCAA......hDAA...,2,-30,-6,24
CSPQYFgMINRJVAafHTEXLZKUbGceDOdBW,HAAAEAAAZACBKADCGAEAeAFAdCADBAGA.CBHA.QCEA.FBHDhAAAMCBBRDCBAEHA.aDEHTFFAhACALDGB.bEBDOFHDhAGA.SGDHgGEB.IHHAhAAA.NIAB...hAGA...,1,1,-21,22
RSKMBfLEbIOFXVcQNJDAPYeagGUTWCdZH,eAAAGAAAUAEACADAHAEBRAGB.KAGABBCA.LDDAECDB.ODHDhAAAXCGA.QEFAhAAADEBBAAIB.aDAHTFDAhABAZGAAMFEB.fGHAbEBDFGFD..hACA......hADA...,2,-17,-10,7
TIGUfgHNYDbcMLCJRBOFAaeXVPSZWEdQK,eAAAXAAA..SADAEADA.dAGATAFAGCCAfBHAhAAAHEABDAIBbCFCMCDBhABALEGBRCEBFDAAAAHAaDHDhADA.ZGDAKFFD..gFGGNEIA..hCAA......hCBA...,1,-3,-6,3
NfZQAbdMKSIETUReOaYPBXJDcGHFVWCgL,dAAAMAAASADA..EADARAFFeAHHaAFDBAHADCCA.HBBAFDAA.hACACCGALDDBZDDAADIBKEAD.hADATFFAUFDAOFGDhAEAXDFC.JFBB........hAHA......hBAA...,1,-16,-22,6
YXTeWbOPBacQMEFKDdJZULGHfSVgRANIC,CAAATAAA..eACAOACAaAFD..MAHBEAFADAIB.ZBDAGCAAhAAAHCGBSCCDhAAARCCAAACA.IEEAhBHAXDFDbFDABDHAFFHD.dEEC.UGGA...hCAA......hDAA...,2,-15,-8,7
KZCdBTEWHfQUbOLePASXVIYJRNFaDGgMc,XAAAVAAA..JADARADAFAGA..GAGAMCDBZCEBdCDAECFBHCGBhAAA.QDAAhABAODHDeEFBAADASFGAhCAA.IGDAaGAADIAAKHGABGFD...hAAA......hAGA...,1,-1,-21,20
FPaONZMJgeDcUSRBYHCILfGbQEdWXTAVK,FAAAaAAAZACBMADA..eAEADAHB..UBDARBFAHDEALCCDGECA.hAIAEEHFdCGD..TGFAhAFAAEEAKEFAOEHD.hAIA.NBBA.JGBA.SGGD.CHEA..hBAA......hBIA...,2,-29,-5,24
CNJeFafcKWLEOdVgPYARXIGTQMUBZbDHS,RAAAGAAAMADA.ZADAHAFCCAGB..eAHHaBDDKCFAECDA...dCCCVDEAhAAA..gDGAhAAAAAEATFGA.QFCAhABABDCDDDIB.SEEB.FFHD...hACA......hBAA...,1,-1,-23,22
MERgHeJFDWABSNbadZcPLVfTQKXGIYOCU,SAAAaAAAZACB.LADA.TBGAQAEA.GBGAhAHAOCCAMBBBRDDAHEAAhAAAeCEBDDIBAAIBbEFDdFFAPHAAhABAKGBA.XGDB.CHGA...hAEA......hAFA...,1,-5,-16,11
SRAZGUcITOHEBVfaDLXbgPMQKWYdeNJCF,GAAAUAAA..TADAHADAEAGE.fCDEaAFALCDAXCFAhAAA..bCGDMCIBhACAQDAAKEFAdFAAeFCBhADACEEARFCBAAIB.ZFEAOGEADGIB.....hAFA......hAIA...,1,7,-12,19
bDKNSYOLFQfcHMJEVRUWaCZAIegGdPXTB,eAAAdAAA..TADADAEASAFALAFBQCBAHBCAEBHFRCFBUEBAhAAAaAHBABIBGDDAhACABEDAKEHBODABFFEDMIAAhABAVDGBCGGA.IHHA.PFCB..hADA......hBAA...,2,-6,1,7
HUGRLYdOWEDPXSeKBNTcCgQMfVbaIFAZJ,HAAARAAAdADA.EADEDAFASAFBBAHA...TCCACBFA.MAHBhAAAVCGBaCAH..AAAAZCCAhBFAGCEA.LEHBhACAOEEB.XECCKFGD.gGDBhAIA......hBIA...,1,3,-45,48
CbaTZGdBgARIJXHEOecQNYPWDULSKfVFM,RAAAXAAAHADBEAFA..eADAQBGA..PAGDDCCBLDABhAAAfCDAMDDBhABAaCEDGEEAdDAAAAAAOCHDhADAYEHBSDCD.FEFD.bGDChAEA.BHGA...hADA...,2,-7,2,9
JcGFRQCTdSfMEXPaLIBgHWODeKAUNYZVb,UAAAZAAAJADAGADA.RAFA.QAGCdCHA.MCABEDAAaDDHLCCAhABABDGC.HDECDFAAAADBhAFAVECB.FEHDTFEAhAGAXGGC..IGHA.OHFChAIAKHDA.....hACA...,2,-15,-8,7
YcaTbPXGCFKfHLNWBOVZEdDSRIMJAUQge,QAAAeAAA.aACEbADA.GBGAKAFAHCDALCCABAHBZCGBhAAAEEAAdEEARDAAMDIBAAAAgFAAhAEATFCA.CFHAFGFDhAFAfFAEOHAE.SEFDIHHA..hADA......hAFA...,2,-10,11,21
MdCcbeFGgZIYPQDLESKaNRfTJUHWBAVOX,XAAAdAAACADA..eAEHGADAZABB.IAFAQAGA.ECFFhAGAaAGD.RDAA..TDFAhAAAHDCBADHAMAIBFEGAgFFBhBAADEIBLFDBNIBB.fFFE.hBIAWFHD....hABA...,2,-18,-5,13
fIOLcFPdGMgHUeSDYZKJAbVBaETXRCQWN,BAAAEAAARACA.QACA..fAFBLAFAFCAAGCCBhAAAHCEAeAHHDCGAZEBAACFAaDABhADATFFACDHA.IEHAhAAAOEFBdGGAMGAASGEDKHAA.JHAAhAHA......hCAA...,2,-8,-6,2
YGLfcZFeTOQRbSEANBgCWVKJIMdDHPXUa,BAAACAAAKACA.MACAHAEBUAGAGBGA.LCAAZBCAeDBA.QDFAhAAAREAAEDEBAAGA...hAAA.gFGAhACAVFBAdEHAXGGCaGBD.fEEEFGEB.hAEA......hAIA...,2,-12,-7,5
aUdECeHQNKVgYIcMZBFSTORDPbAGJWfLX,GAAAJAAALADBaADAdAGA..EAFAHCDAKAHB.VDGB..ICFAhAFAZEBBSEFDhAAA..RCGFbDCCAAIBfGHAhACACFFAeEHH.NICB........hBAA......hCAA...,1,0,-28,28
MHAIWEXDYSBgeQUOFLCaNbGZPJVRdKcfT,EAAADAAABACA..eACAQAEAFAFDaAHBGCCAZAGB.JCHBRCCAdEAAhAEA.KBBD..TFEAhAAAHEEAABIB.XDGAhBAASDABUGGACEFBNIBBVGBA..fGHAhADA...hBGA...,2,-13,-10,3
aeIHZPRCJgYdSDbNUTVFXfcMLWKQOBGEA,eAAAHAAARADFCADA...JAFAdAFADCABUCCA.FAHB..XCEDhAAA.MCCBLDFAhAAAQCGAGFBBADDBZFFAhACAgFFBSDAHNICB.TGCA.fHFBhADAWFHB..hAIA...,2,-22,-16,6
GYJSKaLICZgODfcQbTNedFUEVWRXBPAHM,HAAAGAAASACEaADALAGBZAEBDAHBQCDA.TEBAhAAAeBGDdCCA.EEEAREFABFDAhACAAAIBMCIBKGBDCFGAfGFEhAAAbGEA..NAIA......hCAA......hCEA...,2,-20,4,24
SRPHOAUdEcDbaLFVJeGKNXZCTYQfBgIWM,EAAADAAALADAFACD.eAGHGAEA.XAGAZBBATDEAQCGDhAAABCHA.gDDDhAEAMDDBREABHEGBAAGAdEBAhBEAaGFHKEGA.CGGA.........hCAA......hCBA...,2,-13,-12,1
WbTPVZNagUSfFICRGdBcOKMHJEeXYLDAQ,QAAATAAA.ZACBaACAUAFA.FCEHRAEFdAGABAHAKCCA.HDEChAAAECHF.eDBBLEBBhAAAAAIB..bFFAPEFDhBCANHDB.SEHHCCHA.OHFEMIEA.XGDChBEA...hBDA...,1,-3,-8,5
cRSLUMODAfZHWNEgIGQJXYPKbFCTeaBdV,HAAAEAAAGACAQADC.XAFBKAEAbAGB.TCEABCBDdCFAhAAARCAALBHBMBIBAEAAZEEAhAEAgEEA.IFHAhAAAPFDBeFHHaGGCSHCADGGB.hBCA......hCAA...,1,16,-8,24
VMESNgPDQZOLdXIaTFGYWAKbfUcRCBHeJ,KAAAUAAARACFHAEBeADA..MAHBEAGA..SBHH..gBEAhADAQCACZDCAhAEAdDEDaCHDGEABAAIBbDFD.hBAACEGABFFD.NEIAOGACLFHBIHGAhAAA.YHCGhACA...,1,-4,-12,8
UbReGXDdfQEFWNYLHIgSOTKJBMcZCaPAV,UAAARAAAeADEGADA.dAFBEAGEFBGH..NBEA.HDAA..SCCBhAAATEFABDHAZCFAaEGBhABAAADB..XFDChAIAQGCA.LFHBOFHDMIBACHGC.hAIA......hCAA...,1,-9,-15,6
TgZUJDGKEcaBAXVRYeSIbOCMdFWHLfQNP,RAAAeAAA..SADBOADCdAGAHAFALCCAQCCC.hAAATCGAZDEEDAIBEDFBaDHDhABAAAAAXFAAIECAMFABhAFAfEEE.gGGAGGDBBFFBhCAAbFCDCEHA....hAFA...,2,-7,-6,1
ZfUPMFNbTDWgRCQLYKOcASBJEVedHIXGa,BAAAEAAAdADAHACAGAFAZAFBUCAAFAHF...TDDADBCBRDBALDHBhAAAOAHD.AAFBSDFDhBDAeDGFaEHD.MHEAhCAAbFAA....CHBAKHFA......hAAA......hACA...,1,-13,-17,4
EDdKTRgWCLSYcFUNGOXaBQHJAPVZMebIf,ZAAAeAAA..IAEAEADAdAGARBEB..CAGALCABSBHHFBHDGCCAhAAAOCCBBEFAHDEAhABAACCBMEHBDEDBKEHBTGBAhABA..gGAAWFHH.UGFA.hAIAaGDD.....hBGA...,1,-5,-17,12
RHVbaTODcCXKMGYANJSEWeQgBdfZILFUP,SAAAEAAA.eACHQACABAEAZAFBLAFAFAHD.RCDAHCGBhAAAaCEBDDDBXEBAhAGAGDGAAAAAWEFD.dGCDhAHAfEAAIHHA.PFEB...hBEA......hCAA...,2,-19,-7,12
ATSXVLPNZUFIRWHMCdDebKYJQEfGBaOcg,TAAAXAAA.LADAZACBFAED..RAGBHCFBdAHAeCDAKCADQEDChAAAEDCBGDGAaEABODHDhACAAAAA..SEEBhAEAPGAC.IGDAMIAADGGBbFAD...hAGA......hAIA...,2,-4,3,7
dfHVETADQYFWPJIZbLKGRUaOeNCXMgScB,QAAAFAAA.JACEbACD.GAEARAFAUCDAeAGB..XCFAhAAAMAIBSDFHhAEA.dEBAHEFAEEHBAEEBhAHADCIB.PGAAIGGAKGHBNIAB.CHGD...hAGA......hAIA...,2,-14,-8,6
SeNCBIZMHYEgVOWKcDJGLQTXaUFPbfAdR,RAAAeAAABADBZADBHAEBEAFA.OAGF.KCCADAIB.GBGALEEAhAAATDBAaEHD.FDFH..hAAAbGAAABDBdGCA.CFHAMEEBhABAgGEA..cGGC...hABA......hAGA...,2,-20,-8,12
ZKXSaPbBdVfFWYeCQHEgRGMOAUNJLTDIc,UAAALAAADADAZADESADH.aAFABAHA.dCEAFBFBeCGBhAHAHCAA.RCGBGEDAhABAACHA.TGFAKEDDXFFChBAA..........hBCA......hDAA...,2,-47,-8,39
AVNYUQIgJMeLCPbDBcHTfWXaZFEGdORSK,VAAAUAAAQADA..gADBeAFALCDACAFBDAHBHCEChAAATDAA.XCGDhADAZDCAEDHFdFGDREEBABIBIGAAhAGAMIAABHHAfGHA...hAIA......hBIA...,2,-16,-3,13
CGYDAgUNWQBTIMESFeRdKLcOVPbHaZfXJ,UAAAQAAABADA.MADAEAFA...eAFARBFAdCDALBDB.hADAOBHDbDFA.HCFBhAAAZFAAJFDAGFCB.ACDBWFHBhBCASFHDKHCA.PHDC...hCAA......hCFA...,2,-21,-4,17
MYCWARQNBDLeZTIPadGFgUcbXEJOfVSHK,RAAAQAAADADAZAEE...TACAaAHDGCCAFAEAUCEA.XBGDhAAAECFB..fDHAhAAAHEFCMDDBCEFDACCBLHAAhAHA.IHHAdGAAbGCA....hAIA......hBIA...,2,-18,-9,9
gITBeXaUOCLYbcGEfDQdHNKMAJFVRPSWZ,FAAARAAA..SADBZACB..TAEAeAFAaBGECAGBLCEAhAIA..bCCAEDHFQDGAhAAAHEEBMFIBAAFAPEEBhABAgGCBXGFA.....hBAA......hBIA...,2,-21,-8,13
UgOSGPCZHaBAbKQReJWfXVYDLIFcNEdTM,QAAARAAAeADE.JACEXAGB.DBEBLAGB.FBEDhAAAECCBdDCAMBIBOCHDhAIAGCEAZEEAHGBAAAAAbDGDKGCAhCAAfGEB.IHHA..hBGA......hBIA...,1,-12,-14,2
OPfJKWIXSUGHRYNedVaTFDZLMcEgQACBb,BAAAOAAAJACAKADA.....XAFBGAFAHCBARBGF.eAHBhAAAaBBCDCEBZECBMEFBhAFAEDFBAAIB.CEGA...bFCAfGGAhAIA..SDDDNEIA.hBCAdGGA.....hCAA...,2,-22,-22,0
gFMYWeaKXJLTQPUbGODfEZARdCcNSVBHI,RAAAdAAACADB.SADAHAEBFAGA...MAGBeCCBaAHBKCGA..LCCAhACAQEEAUEAAGGBBhAAAfCHAAEIB.hABAVECABEGA.IGHAgFGA.XGEDhADA...hBGA...,2,-20,-4,16
NOBHSFeVTZPbaYQfcLUDdRICKJAWGMEgX,GAAAEAAA..XACABADAHAEB.eAGBZAEBaAGDQDCAhAAALCCBdDGDRDAFKCHBAAHAMDABhACAODGBFFEDTGGAhADAbEED....fGBADIBA.CHGA.hAAA......hADA...,1,0,-16,16
ERCTDcJMXeZUSBNYVKLFQadOWHGIgPfbA,RAAATAAADADA..MAGBeACE.ZAFBBAHA..VCCBLBEBhAAAaAHDdDHAHCCDGEFAgCGHhABA..bFABhAAAEEHFCFEC.XFFD.SECDhAHA......hCAA...,2,-25,-3,22
XVgLcKRSbGHQMPBdaDTJZFOECNIAWUYfe,UAAAeAAA...XADALAEA.RBCBGCEAHAGBMCDBdCGBaDGDhAAATDAAZFAAFFHD.CECD.hABAAADAfDGEhAGA.gEDHSGGDbGBC.QFGBhAIADIAA....hBAA...,2,-13,-7,6
XdAcTDSYNPaBRGKOLeZHMfWVEQJbICgFU,TAAASAAA....PACARACFGAEALAGBHAGDMCIBhAAAfBEAEDGBbEAACCCAFDEDhAAAdFFAAEAADAIB.aDGEOEEHhABAeFGBZGBAQGAAIHFA...hAEA......hAGA...,2,-3,5,8
KXgEQSDBCJcaMIAeRWUOVPHNTZGdYbfFL,RAAAOAAAHADBZAFAdAEA.....bCFDLAGBKCCD.EBBBQFDChAAABBDCCDDA.aCHHAAIBeCHHhBAAUGAA..PFHDhABAGEFAFDABSFDBDGGB.MFIB.hADAIGBA..hBGA...,1,9,-29,38
CPRWTXUafZcOIBEGHLNVbSeKMFQYDJgdA,RAAATAAAUADAZAFB..OACABAHAHCGBLAGB..VDDBhAAAeBDA.MAIBFFBBDCCBhABAdDBAADDA.CDEAXEFAhAAA.aFHDfFGEEGCANIEBKGEA....hBFA......hCAA...,2,-28,1,29
DaGPbUBZcEJRdANMOeLQFVSKHXYCIfTgW,MAAAeAAALAEAFADD.KBCAHAFA.CBBA.TCEADCFBGCGAhAFAUCGAZEEAEDDBRFFBAAAAQFAAhAFASGDBIHAAhAHAfGGE.WDDD......hAGA......hAIA...,1,-15,-20,5
cVZHRgBfTIFXSdQNMEWbGeaYPLKCOAUDJ,DAAAVAAAHABC.RAEFBAGB..TAEAFBHDdDDAMAHB.ECDBGCFAhAEAeCFF.aCCHLDABhAAAOEHD.AAIBcDGDhADA.ZECFfHFBSFGANIAB...hAIA......hBAA...,2,-20,-4,16
EYOQPDTIRaGSeALXBWcZbKNMUVCJgdHfF,LAAABAAAZACAKAFCMAEA.UBEACAHA.dBHAHCCA.FCGAECAA.QDCChABADDAB.REFAGGCBhACAADGB..XEADhAAA.bECA.....VEGBhADAfHGF..hAIA...,1,-18,-31,13
IVREAebOgXDYdNWGKaLcBSZFfMTJPCHQU,eAAAOAAADAEAdAEAGAGALAGBBBCAZBCBFBEB..MAIB.JDFFhBAAHDDC.QFGAhAAAIEHA.EGBAABBB.XGDAhABA.NIAB.aEDD.fGBAhBGA.CGHA.....hCAA...,1,-8,-32,24
ELbKZDAFWXURQMfeGIOcdHYCVTBSaJPNg,XAAARAAAMADA.GADAOAFEHAFA.CCGABDAAaBDD..JCFAPDFBhAAA..EDCBbDBDhABAZEEA.AAAAFGEAQGGAhADA.eCHHIHHAdFACYHAGhAFASEHB.NIAB...hAIA...,1,21,-31,52
dVPgSCfIRTBaFeQWGZAUJNcYXODKHEMbL,UAAAJAAA.....NADA.XADB.KAFAHAEA.EBHFbBFAhAHAdCED.VEAA.SDGAhAEAfCCAREEBaGAChAGAeDEA.GEGAAFIBOHFCMEDB.LFFDhAIA....hBAA...,1,-5,-24,19
HSfBdOKLJGRINXCQFeYMEWbVAaZPUgTDc,ZAAAUAAADACAHADABAEAdAGALAGBRCBA..XCFCQCCBhABAeCHHEBFF..bEFDAAIBaCHDhCAA...TEEAhCBAfDAEKFHBIHFAFEEHMFAB...hDAA......hDBA...,2,-27,-5,22
eAbVWMOGcFHLIBKfREJNPYXTSgCdQZUaD,VAAAMAAAGACB.HAGBLADBKBBDECDBPAFA..TDFAhAFACBFDZCFEDDCBAAIBbFCAOEEBhAAA..FEHDfFGAhBIARGAENIDB.SFHH..hCAA......hCDA...,2,-29,6,35
gSRYDLfUJMabABdNFQETKXOePWVHCGIcZ,dAAAQAAAEADA.KACAeAFA..PAEAHCACGCFA.hAAAZECBRBFALCDBhAIAfBHAMDHBACFBFEHDTFEAhBIAOFFHCGHA.gGADDDIB....hACA......hADA...,1,-2,-17,15
CNTMWGbHOYaJUFfPEZLXIDRBSAVedcQgK,eAAAdAAAQADACADA.MAGBGAEAHCACaAGAFAHBEBGEZDEALCCBhAAADCIBRFBA.ADGAVEFAhABAKFFA....WFHHhACAbEDD...OHDA......hADA......hBAA...,2,-11,-10,1
WRfaGDMXBJVbFTKHEQIPNgdCUcLYSZeOA,RAAAGAAAMADA.BADA.JAFAFAGD.HBDBEBFB.QDFA.hAAAIFBAgCDBhACAdCCCCDHALCHBZFCBAAAAaFFChAIAXEFD........hADA......hAIA...,1,-8,-34,26
FSdEWeJHZaORYTLAVKBCgPUQNbMfIXcGD,BAAACAAAUACAQACA.MAFAXAEAGBEAFAHBdBGBECBBeCABhAAA.HCGBZCFARDDBTGFAhACAAEHB.KCCDPFAAhAAANEEA...bGEAcEBD.DFIB..hBEA......hCBA...,1,1,-23,24
LRWKYFeUTVDgJbHPCfIQSZGNAMaOcBXEd,aAAABAAA.EACARACFKAECFAED...UBGADAGA....JBGBHCDB.hAAAfEGAQCAAhACAGGCBABIBMCDBOBBHhAHAdEEALEHB.eGBE...gGFFhBGACCFCSHGAhAIA...,2,-23,-18,5
QANVPCIHSeYLMBDcOJagZGdRFfUXWKTEb,VAAACAAAHACA..eADEMAEABAGBDAIB..OBEEaAHD..GBDAhAAARCAAFDEA.UDGAKDHBEEEBhAAAACFA..IGEAhCAALHBAJDCFdGGA..XGGA...hACA......hBHA...,1,-15,-17,2
LZWbDdIfSFKXcUgAQCOaJGeBYMRTVHPEN,QAAAaAAAGACABAEARACAHAFB..EAGAZDAADBBBdBHA.SDDBhAAAXBGA.UEGAACFBODFChAEAeFABMFFB.hAGA.TEDA.PFGB.LFHBhBAAIHHAKHDA...hADA...,2,-8,-5,3
fAgaNTBVJHGZPFDSUdIKcLCORQXeMEWYb,aAAATAAABADA.HAEBZACBDAFA..dAGBKAHBLCCBRBEA.eBBDhADAECAB...bBGDADEBgDFAhAAAJEEB.hBAAGEBASFHBIFHACGFA.QGDAhACAMICA.fGGEhBEA.,1,-8,-21,13
PVbdBRaXIQDfOgMYcFEeTASHJCGKNWLUZ,HAAAGAAAKADCLADAZAFB.VBGBdBHARCAA.aCEBQCDAhAAA.ODCBMEFAFFBAhAAAEEABAAHACFFA.UEGBBFHADFDAhACA.fGHE..YHCAhACA.eHFE...hAEA...,2,-13,-7,6
XLQHaeUDPMGSTZKNBgfWAcOJVdIECbYRF,OAAAdAAAEADA..CAFA.RADALAGBHAGB.eBBBDCCAGCEAZDCBBCFChAEA..fDAAhACAAAIBVEEA.bEGDFFHDaDDBMICAhBAAKGDA....NIAB.......hADA......hAIA...,2,-16,-12,4
HLKQXbaRCUDAMEJeOBNVIGTgZfPWdFYcS,EAAAeAAABACA..IAEAGADAZAFA..fAGAhAAAdCGAFCCHSDFDHBCALCHBhABAQFGAaDEAREEBDGAAhAGAAAGAMIAAOHDCTGDA.....hAIA......hBIA...,2,-14,-11,3
GOBEZfWIJedbMSgHQCFYNLTRPXKUcaDAV,GAAAEAAAZACB...fADAJAEB.eAEHdAGAMAIBHAGBQDDBhAAAFDEDLCBDRDFFKEHBhACAaDGB.AAGBBGHD.hAAAWDADbEGD..CGBA.NIAB.......hADA......hAIA...,1,-2,-21,19
BedIPJagNbcQOETfGXKMYAVCRFUSLDHWZ,RAAASAAAHADBZAFAeCCBdADA..JAFAaCFD.....bCGDQCEAhAAA.ECCBhABAGDAAMCHBACIBFEEHLFBAhAIABGGA.gFFBOHAE.XGDAhBDA....hBFA...,1,-3,-26,23
ZXMLCRYQOEgDPVFScHAfeJBKWUTNGaIbd,eAAAKAAAUACAGADA.aAFAdAFA.ZAGBMAIBRDDA...QBFChAAAEDHF.DCCBFEBBHDFChABAABIBBFFATFFA.hAAAIHHA........hBDA......hCAA...,1,-8,-46,38
fWPZbJMFNHKRYLBcXGQeECdOUIgSTAaVD,aAAADAAA......fACAZACBbAEAMAIBHADB.RAFALCHBhAFAXCEAGDGAhAFAEDDBdDFAOBBHIECATGAAhAGAABBBPEEBFGGAKHDABGAA.....hAIA......hBAA...,2,-8,-5,3
aKbScGeBDdgTRQCPLUWAZNXEMYVIHJFOf,ZAAAEAAA.MACA..IADAHAECOAHDaAED.SCCAhABAGAGAeBCBdDFAREGFQEDAhAAALEEDAFCAXFFBhAGAYHAAFFHD.bGBCDGIB......hAHA......hCAA...,2,-9,1,10
APIbXEZHSCKdDLQJFVaBRgcNeUGfTYMWO,..IAAAEAAAHACAKACAdAFA.LAHBFAEABAHARCCA....gDGGhAAAeCAAGCEAhACATEAAMCHBABHBbEEDZECFDCIBhAHAQGGCaFHD..cGFB..hCAA......hCBA...,2,-24,8,32
FNYCIBHdSKfVGRcJaTbgWELAeZDMXUPQO,eAAAZAAAMACAUAEA..QAFAFAGE.CAHAHBDBdBDCKCGAGDFAhABARDEB.aCCHTGGAhAAA..bFCBEEGEACIBDEIBhCAAOCCHIHEA.fHGF.hABA......hCAA...,2,-27,5,32
ZKScaMJbNEUeVXGQRdTFOYWIPBLHCAgfD,DAAAZAAASACEMADA..JAGBEAFAUBBAeAHF.GCCBRCEB.hAIAdEFAOBHD..hBAAIEHALEBAHFAAhABAAECAKEGAaFCA.NICB.QGGAFGHB..hBEA......hBFA...,2,-31,6,37
dLIARESGZODPWFVQCXYBTebHacfJKUMNg,EAAAZAAADACAFACD...QAEACAEABAGA.eAHBHCDA..aCCCfBHAhAAAKCGB.MDIBhAEAdECAAEEAREFB.GEFAhABAOFCB..WEHHYFEFbFDD....hAGA......hAIA...,2,-27,-12,15
TOKYLdWFBEZXUAbJefGgIaCMSPcHDVNRQ,eAAAGAAA.aADAMAEA..SAFHHBCADAIBRBFFTCDAKDEDdDHAhAAABAHAEEBAZFFAAAABbCGDJHBAhABA....fDCEhACACHEB.cFEA.QGDChAHAOFBE.....hBEA...,2,-9,-5,4
DFNIAGacWVeZJfdUQRbTPSLHCgEXKYOBM,aAAAVAAAZACB..dADARAEA.....bAEDTCFA.LCHBhAFAHAGBEDDBKBBDBDHAMCEBhAHAFEGHAAIBGFEBeFEFfGAAhAAA........hAGA......hAIA...,1,-17,-18,1
gUBWfGDPONbFaECIQRMdcLXSYJeKHTAZV,ZAAAUAAABADBGADAOAEDFAFA...EAGAQCFA.RDAAdDHAhADALCAB.SBGAhABAeEFBHFBAACCBgDDBhACADAIB.bDFDaHGE..MDIBhAGA.YHDA.hBAA...,2,-19,-10,9
WLScdTfENgUKJbRCDAOHBFXGVYaIMZPeQ,HAAAXAAAGADA.aAFAZACB.eAEALBFBdBHAECEAUCABKDFARECAhAAAAAIBFCHB..IFAAhABAMDDBQFFAhAAA.SEHHTFGAfGFEhAFA.JHCAbFDDDIAA..hAIA...,1,6,-10,16
cFfXdZOVHaWQIBUMJKSgGRCADPeYNLEbT,eAAALAAAEADA.TAEAFAFD..dAHAZAGBHCCAaCAA.QDFAhAAABCEDMBIBSECAhABAGDCAAEAADEEAPFFBbEGD.hABAfHBB.ODHFIFFAKHGA.hBHACGAA......hCAA...,1,0,-8,8
XWQEcPHJUFSOeYKIZgRLVMbNDTdGBCafA,QAAAEAAAHACAFAFAeACAKBHB.ZAFBLCCAMAIB.DCGBGCDAhAAAaDGD.ABFBXCGDhADA.PFFASEAAhAAAODCHgECH.RFEBNEIAdHBBCGGB.fGHAhBHA..hCAA...,1,-3,-4,1
LZKVdYaJHGeBUMcTEOQNCFfSPADRXbgIW,RAAAXAAA..bADB..IADAZAFBdBHA.aAEDHCCB.eEFAhAAAMAGBEFBBQDCAhAAAFFEHSGGAAAHADBHBLEEBhABAKHCA.VEGB.....hABA......hAIA...,1,-8,-13,5
aYLEOTXBZIKFCUeGHNbJcQMSfWgARPdDV,RAAAdAAADADAaADALAGB..EAGAOBDCTBDAZCCA..FBHDeCHHhAAAHCAC.JCFBMEEBhABASEED.fEHAhACAAAIBPFBBXFFCKGAACGFA...hAGA......hBAA...,2,-20,-17,3
ZVAGgYeCUWbFQBcTaSXDHJKILdRPENfMO,GAAAeAAACADA.UADAFAFA.QAFABBEA..aAHDDAIB.HDBBhAAAKCCAdDFAEDDAMDGBZDGBAAAA.hCAA..gFEDhACA..bGCASDHBIHHA.LHBAhBAA....hBCA...,1,-4,-34,30
RfQbCecHMODPIUNKWAXJFVGBYZTgdEaSL,FAAAGAAAZACBdAFAEADALAGB.RCDBQEGAeAHBHCGBMBEBhAIADAIBUFBAKEFDADFAXFDAhAAABFBA..TGGAhBAAaGGC...........hACA......hADA...,2,-26,-10,16
dNaAPTURKDXLceEOWbZFQSJHCMYfgIBGV,TAAARAAADADALAGB..EACEOBDCZAEBQAGAHDDAMAIBhAAAfCCABCCDdEHAABFAhABAKCGD.eDHFFFDHCFFAgEABhAAA.GEEAaHFA....hAEA......hBIA...,1,-7,-16,9
dFRUVLeHCSQaJgcGPNIXEDKOTWBYAMZbf,ZAAAdAAARADALADBHAGBQCBAaAFA..JBFBGDDA.IEAAhACAEBHFOCABTFGAhADABDHAAAIB.MCCBbGAAFCFHhAEAeEEB.SEGDPHECDGAAKFBD.fGHAhABA.CHFANIABhACA...,2,-21,18,39
JRNAfPbCSWOYKZMDaHUEXLdVFcIeGBgTQ,...bAAASAAA.OACDZADBaAFDHAEAEAHBdCAAFBHDeCDHhAAAGCGATEAARDEBAAAACFBAKGDAhACAMCGB.XEGDhABA.LFEBIHHAQGABhAEANIAB......hAGA...,1,-1,-5,4
AWKEPXfbSTOQgeJGMCYHcLUdRFaVINZBD,EAAAXAAA..bACAOADA.eAGFGAGA.MCCBHBCBhAAALDABRCGFaCEDIEBAhABAZDCBAAIBKEEA.SDHHhAAATFFA.QGDACHHA.cGGAhADA.....hAIA...,1,-1,-18,17
bNUPCYfHRADVdIXEFeWSTKLQJMaBZGcgO,dAAAEAAAFACDeADA...TAGALAEAMCCAZBFE.GCDA.hACAODFDbCDAUDAACDHAHFAAhAAAACIBDDHBXFGDhAFAKEEAaEHDBGGDNIAB.........hAGA......hAIA...,2,-16,-7,9
gCHLQZNUGOFeVARKSXdaTEWBYJDMIPcbf,RAAAXAAAdADA..EAFABADADAIB.MAFA....ICFAhAAAbBDACBHA.HCGBZDAAGDGAhAAAeCCBAEEAaFAATFBAhABAJFFB.fDDBLHBA.QGEAhADA.OHBEKHGA.SGHHhBFA,2,-20,7,27
EOGCAJSHUgdZMLYRIXTfFDecVNBbKWPaQ,HAAAdAAAZABBMACARADA...TAFADAGAeBFAVBDBBCHA..bCGDhAAAKDCA...aDFBEDFFhAHA.CGGAAAIBUEGA.LEABhAEAYCCF..XGFC..hBAA......hCDA...,1,-4,-27,23
cRBaTFANXZYLWfgECMJDbQeGVHOIKdPSU,ZAAALAAA..fADBEAEAMAHBDAIBeAFEHCAAKBFAdCAASBFHhABARCCABCHAaDFDACCAXDEChACA.gEAAhAEAbEGD.GECAOEEHIEHAhCAA.cFFANIAB..hCEA...,2,-14,-10,4
CFEOTHXaSMUWdBeVRIGAQDPKbYJcNZLfg,QAAAKAAA.JACEZACB.LAFA.CBEDECAAHAFA.aCDAhAAAMCGBdCHAeDDBREDBAAGA.hAAAbDFD...YFHBhAHAfCHAFHDA.TGGA.SDEBhACA.BFHB.hAIAIHCA.,1,-1,-23,22
JeOEbXAFKCSdcgRDQUIMBGWZfYaPLTHVN,CAAAdAAARACA.QADA.MAGBGAFAZABB.aAHFLAHBHCAAVECAhAAAeDCA.EEFAAACASDHBhAFADEIBBFBAfFEEhBAATFGA.OHBAFGFHKHBAgGGBhBFA.....hBHA...,2,-12,4,16
NMLObAeEcCZgdXUaQIYTGfJVFBRHWDSKP,EAAAZAAAdAEAUADAQAGA..TAFAGCAA.VCFBRCBBHCGBhAAASCCGKDDCMAIBhAHALFFAABCAeEFBCFHAaGAChABA.fHFBBGDA.DEEB.NIBB...hACA......hADA...,2,-14,-2,12
bNKQcaGJXeAWECDdBRgYOSITLVZHUfPFM,EAAAdAAARADA..OACCSAGBLAFBHCACUCCAFCFB.MAHBKCHB.hACAaCHDGEAA.eDEDhADAAAIBDEABBEGA.gGEAhAEATEFAZFCAfHGFbEAD..hAIA......hBAA...,2,-10,-9,1
MHIOPQCKZUfBDTAVgJNcbdRXGSaeWFELY,VAAAJAAA......bADBRADFGAFA.eAHBEAFAMAIBhBAAHDAAODFHQCFAhBHAZEGBBFADACCA.NEEA.dEEAhCAA.aDDH.LFHB.IGGAhCBA.KFCDDFIB...hCFA...,1,-6,-16,10
VYOWRFgZDbBSfKULCeTNMPHXEJIacdAQG,GAAAOAAARADAZADABAGBKAGCLCDB.eBHFMAIBHFAAEBBB.hAEAaCFHACFA..QDCAhBAAVFFAFGDD.DCHB.bEEBhCAA...UGGA.CEHA......hAAA......hACA...,1,-7,-17,10
bSTGPLQDXYZWEdaAKONIMCBFgUVRHJcef,OAAAMAAAFADDUAEAHAFA..eAHB..bBBDGBCALCFAhAFAQDGCXDDDZEBFhAIAEEGAABBBKEEBCFHABGEARGEA.hBAAfGGESGBDDBBB.dHABaHGE..hBEA......hBGA...,2,-6,2,8
fGeJROTBdUDcFgCbXVYLZPSaANMHWQIEK,HAAAQAAAEADEGAFARACABAFBdBHA.DCABFAHBCCCA...XCDAhAAALDEBZDAAaECAACGBMCIBhADAKEHBeFAA.TGFAhAAAgEEA.bDGDPHAA...hCAA......hCEA...,1,6,-19,25
gRPYUXFeQScMVCfZNOATDLBdJbWHIEKGa,TAAALAAA.dAEAJACAHAGB.ECAAaAFARDCAUDGB..eAHHhAAAQFDAMBGBfCCAhCAAZGAAAAIBBEBDbDEDKFGAhABA....gECA.XGFAhCCA.SDHHhCEACHHA,2,-27,-11,16
GQTSeIDPKRdXECZAfbFLOMcYgWBNaVHJU,FAAAMAAA......gACHBADAaAEDHAGBGAEATBBAhAGAeAGBDAIBRDDA.EDDBAAIBLEHBhBAAODFD.cFFBhBBAYDHB.NHABJHEEQGBA.hAHASHGG.hBAAKGDB..,2,-19,-3,16
JNQBTYXVAMcOSZDRFfgPKaUELeGdIWbHC,MAAASAAARACA.FADA....fAFBKAGAEBCFGCEAhAAAdAHA..bCCAHCGDCBBDQDGAhBAATECAXGAAhABAACGBZECADGGAaEHD........hAGA......hAIA...,2,-17,-15,2
fJKMeSVZHLUARNgQcBaTCPFGEIXODbWYd,RAAAQAAABADB.aACETAFA.FBHDEAFA.OAHDDCCA..hAAA.bCDAdDDA.KCFDeDABhADAZEGBHFAAACDA.NIAB.hAAACDHDGEEA.XFCBfFFAMFABhAFA.LHBA.hABA...,2,-28,12,40
CNFKHXUPBEISgVRbdJOAZQceDWGLMTfaY,ZAAAeAAAGAEAMAEA.aACACAHA...KAGAHBCAUDGAEBFE..SCCDhABARDEAdDHAAAAAQEBAhBEADEEBLGAATGFAhCAA.fFDBFFFHBHGA......hCBA......hCIA...,2,-21,-5,16
egfQdJMSBLAOVbFaHRWKXNECIDPUYGTZc,OAAAFAAAHACBRADA.KAEA..EAGEDAGA.UCFAGCCAZEAA.eCFA.hAEAQEACdBHAMDEBLFFAhBAAABBBaDHD..hCAAXEFBCHFA.IGHA.YFFFhAEA.gGCAhAIA.,1,-17,-22,5
KMPafJXQILUOABEcZFWdNVHbTGeSRDYCg,EAAAZAAAdAEAHACAGAGARAFFDAIB.CCAA...MCCBaCCC...JCHFQDEAhABALDDBAAEAFEBA.hAAA.VFFAeDHHSHAAhAHAKGAAXGEA.IHHABDFD.NIAB.hACA......hADA...,1,-10,-14,4
eOCAHNBfYLISDgcRTVaEPQJGZMdFXbWUK,HAAABAAALACADACARAEA.aAFDEBHF.QCCAZAGBdCCAFDABXCEAhAAAUEEA..eCHHhAAAAAHA..fDHAhAFASFDDTFEAJFHBMIBAKGHBCHGD....hCAA......hCCA...,1,-13,-15,2
LPBfXTZEFRYMUbIWHNgeJcOSKVCQdaADG,GAAALAAABADATAEAEAFA..RBFAUDCA..bAGBHDGBeCAAhABAODAHKCEDQDFDhACAAAABDEEA.XEAAhAEAFFFHMIAAIGFA.gGCAhBIA.SDDDhCAACHHA.aHGE.,2,-13,-7,6
LUVYQPGeCTHgFXBbZJDOWIcdaMKAfERSN,RAAALAAAUADA.QAEAeAFAHCECXAGAZEEADBIB..OCCBhAAAICAA.aCCAAEHAEGAAhABASCFA.hAGAVEAAPHCAGEEACGGD.FDHD.BDDD.hCAAWHAAMFIBfGHAhABA.,1,-4,-13,9
PWSQCaIdfDbcKgHANXeFMVJZBUYTLROEG,eAAAMAAAZABEBADAUAFALAFA.ECCAGCCA.SBHBhAIAaCEDdCGADCIBKDHDHFFAhAAAACCBFEFBVGAA.JEDFRFBBOFHDhBAA..WHFACGGCbFDD....hBFA......hCAA...,2,-9,-9,0
RNQEFgdULBfTHcSeZMKDIaWVGCAPbYJXO,...bAAAXAAA.RADAEAGEdAEALAGBBCDDHCEBeCABZCGBMDABhAAADAAAaCCCGGCBhABAAAIBJDEB.QGGChADAFDHDUGBA..TGEA.KGGCWEAH...hBEA......hBGA...,1,6,-10,16
EabQTWUgFDdfGcYCZBJNMIRPLXOHVSKAe,EAAAaAAA...QACATADA.UAFADAFAGBFACAHAZCCABCHAMAIBhADARDFFLEBAHCCBKBBDABHBhBAAeEHF..bEGD.hAAAFFCH.dFEA.........hBEA......hBFA...,2,-18,-2,16
ZPdYJLOQDVGXeARBCSUNaIcWEKTMFHgbf,RAAASAAAUADA..aAFE..IADAEBHF.MAFAHCFBbBCAhAAAZDDB.dFFDLBGBhABAQGAAGDDAAAAACCCD.hAGAcFGAKGHB.FGCB.fGGE.hAIA......hCAA...,2,-14,-3,11
CJMHcBEKXUFDWdAZRVbISGLeONaYgfQPT,RAAAVAAA..SADBeADE.aAFA..fAGBTBFAMAIBhAAAHBDABCCAECGAXDDAhAAADDEBADFBZEGBGFBBhABALEGBOHDCNDIA.......hAIA......hCAA...,1,-8,-14,6
dKSHAJebNTcFXgYOGBVDPRQMUaWEIZfLC,eAAATAAAFADD....XACBOAFAGBEADAFARBDF.MBIBhAAAaAGEECFAZCGFLGBAhABA.dGFAHDFCACCB.hBGAbFBA.gFFBBDDD.....hCAA......hCBA...,2,-14,-6,8
EURNGCWIJQDgXSPaBALfcbZYKdOFeMVTH,LAAA..bAAAZADBdAEAeAFAMAGBHCABRCAAGCGACBHA.JDEBhAAAQCFC.hABAXEECaAHFACAAfEBAhACAKDHBFFGDEGAAUGGBWFDDDEDB.SHBAhBEABCCC....hBHA...,1,-2,-8,6
BVgDTdLWCNXJYMSAKaPfIQUZFcbOHEGRe,aAAA..fAAAQADAZADAFAFEOAFAHCCARCFFeBCBBBBDDBIBhAAAdCHALCEACDAA.hADAXCADMEEBAAIBKFFDhBAAIEEA.bEGBEGHBgFCB.hCAAWFGD....hACA...,1,-6,-19,13
ADTcEHXMNSLKdgVWRFBQfPIYbJGeaOCZU,TAAAHAAAMACA.LAGBdACA.VBDARAEAQCDD.hAAAfBHAIEEAbEGBhAIAeCGDaCCHZEAAABIBEGBAhBGASEEDKGFB.FFHD.BFFB.PHAAhAAA.....hCAA...,1,1,-8,9
MCBQUEZRFSHDgYVAIGWNceOdfXJLaKTPb,GAAA..cAAAeADAdAHA.XBFDaACAKAFA..TCDAhAFAbCDB..BDHAEBHFRDBBhAHAHEACDDGB.VFEAABDBIEHAhAIAOHBA.LFEBMFIB.QGGAhBAA.FGCDSHFAhAAA,1,6,-18,24
MWdLNIUFgEHZYeBSRPGCbVTDJKcOXaQAf,MAAAdAAALADAUAEA.EAHBHAGDZCAEBCEARBBBGDEA..CCGA.bEGBhAIADDIB.KEAA..XEBAhBAAAECA.fGDAhBBAIEEAFEGB.eGCASGGDhBDA......hBEA...,1,-9,-32,23
IaPdDRXEgQZVLSMUbFcANWHGfJCYKeTBO,HAAAGAAACADBKAFAeADABAHBaAGD...dCADRCDAECHFZCEALCHBhAAA.UEEAbEAAAAAB.fEFAhACAJDCB.TGBAhADAOFABDEIBQGCDMFEBFGGB...hAEAcGFD...hAIA...,2,-14,0,14
UBTbLPJFOVDQHCdWGeafRYgEKMIcZAXSN,SAAABAAALACAFADA.DAGAHAFBdBGAGCCAeAHBRBCB..EDFBMBIBhAAAZECAAAAAUDAA..hADAbDGDOEFB.QEGChAEACHHA.aFDD...fGHAhCAA....hCBA...,1,-10,-18,8
bMHcAJRGaLKSYeNIfCPTXWdQDgOZFBVEU,RAAAaAAALADB.KAFAeACH...fAEATCFAdAHAQAGAhAEAOCCHZEEABCEAhAGAEFAB.bCFDHFCAABBBSDDDhBAAIHEAXGGADDIBFGGAMHDA.hAAA......hABA...,2,-10,-8,2
QRCZbXMGFPYIVcaAKgEeOUDWBSfNJdHLT,EAAAeAAADADABADA..SAEAJAFAHBDCLCHBRAGFZBCA.MCCBhAAAGDBAFDDB.IDDAhAAAaDGB.ACIBODGBhAIAfFEAdFEACGHAXGGA....hABA......hAIA...,1,-15,-23,8
CgcXIMdHLZaFYfeQGKBSNJROVTbEDWUAP,CAAAXAAAdACAHAEAZACBFBHD..eAEAGCDASAHHRCFB.TCEAhAAAECBBDAGA.AEAA.gDGAhABAMEIB.aECAhAFAQFFBBFFDOFHD.bGCC.WHDAhBHA......hCAA...,2,-15,-9,6
LPHgWYQZabVJeDSfGMCNTUEAcRFBXdOIK,RAAAXAAAdADAKAFA.HADA.....gAGBQCEAbCDAhAAAeAHH.SCCDhAAAGDAAMDHBTEGAhABAADABBDCDLFAAPEEBZGDEaFCDDEEBCGFANDIAEHAA.hABA......hADA...,2,-5,0,5
bEYeDFUKTRCAWaJZNXGcgBfHIQPSOLVdM,aAAAZAAAGAEABADAHAEBQAGA.OCABdAGBEBBB.eBGHhADAFCCHTDGAACIB.JEBFhABAXDCA.fEGAhBAASEDHMEIBbFFADGABRFEBCHGA.NIBB..hCAA......hCDA...,2,-15,0,15
RJaLDEMfbBKUSOYZeQINXCcAPVWGdTFHg,VAAAdAAAHADA.RAGFLCCAEADE.MCIBbAFB.BDAA.KDFAOAHDhAAAZEEA.eCDBQFAAhACAXDFAAAFA.GECAhBHAFGGH.aEHDDIAASFFB.IHHAhCAA.CCEB..hADA...,1,3,-12,15
JbeHUAZVSQFCgKXfNBYROIcMadEPTGLDW,ZAAAQAAACADB.KACAXAEDBAEBRAFF...OAGFMAIBECDBhAAAGCAALECADAIBJDDAhABAHCGB.AFGBFFHDfDHAhACAIHAAdFFA.....WGAAhAGA......hCAA...,2,-31,-10,21
LCgdMXOUEHFJSWYcGbQaPRIDeTAVKBfZN,BAAAZAAALADBdACAMAEAOAFA.HBFASAGA..hAAAcCAAGBDAaDEDRCFFeCBBhBCAADHA.KDHBCEGAXFBAhABAEFBBFFFH.YEHBbFCD..IHHAhBFATGEA....hCAA...,2,-15,-8,7
CQSdODHTXeBYbcUWIJMgNGVFaEfRPZLAK,QAAAdAAAHADAeAFEBACA...bADDUCDB.ICGAhACAMAFAGBGAaCBD.REEBZFBAhAAAACIBSDADDDCB.hBFATEFAcGFDJFHBNEIA.EHEA.....hBGA......hBIA...,2,-10,-6,4
SdZafLbJKPMWAgUeBCDIYQGHXEOFTRVcN,eAAADAAAQACAHADAEAGEFCCBRAEA...VCFASAHB.hAAAaBBHbEDBKCFA.MDDBhAFAAEIBBFAA.CFCAIFFAhABAGEEAODHD..NIABdGHAfGHEhBAA.....hAFA...,1,-7,-13,6
dSYNgXVQRcMeLZEUIJaKDAOCFBPHfGbTW,FAAAHAAAGACATAEAdAEB..SAGB..gAGHhBAAQCABRCEBeCHFhBFAECEBIDGAaEEHAEIBBGDDhCAAbDCDYDHBXGFA.MEAB.ZFFF..hAAA......hACA...,2,-11,-2,9
cHCbedZLSQIDWgKNUGOBJFEPVTYAMaXfR,aAAARAAAHADB.eAFAZACBLAFAQCFADBBBKCCDGCEABCHAEDABhAAATCGAAAFA..MEEBhABAfEBACFFA.dFHAhAGASFHBIGCAgGFFNIBB.hADAOHACFHGC...hBIA...,1,-3,-4,1
UdDgQeNZTJfaRbYMCFOABKHPXcGLWSVEI,HAAAXAAAGADALADASAFA.EBHFdAHAQCABhAAAeCDAZDCATDGAaCFDREFAbFAAhACAMEABFGHB.AAAAKFGDWFDHhADAIGDA.DFIB.NIDB.....hAEA......hAFA...,1,20,-14,34
OAQBXUdKaTHfDPNbEWMJZgLeFSGCVcRIY,QAAAXAAAdADAaACEHAFA..DAFA..bCEAEAHF.MBFBhAAAZDBAeDHHGDAACFAARFCBOCDBhADAAAAAKFEA.TDGAhBGAfGHAPEEB.JFHBFHAASGCBhCAA......hCEA...,2,-4,4,8
DJAGNYVUPbgdKTaZOBWeIMcSFQELXCHfR,GAAAVAAA.UADA....bADBdAGAaAFDZCFE.BDDA.eDBHhAAAMAHBFEFDEDCBLEHBhACAHEEARFBBAAIB.PFHDhAAATGBAOHEC..IHFASDGAhBFA.CGDB....hAIA...,2,-21,8,29
AVHPJGULdIOBDERfSbKWecgCXTFZaMYNQ,HAAAGAAAdADABADARAFA.SAEHKCADeCCBCCEAFAGA.ZCDA.MCHBhAAAQCGA.AAFAVEEAhAAAPEEB.UGBAhACAOFHDEFHF..fGFA...hACA......hAIA...,2,-16,-12,4
YBcfTZaONPAKUeMDJXSQgHVLIEbFdWGRC,eAAAMAAADAEA..SADAHAFCLBBAEAGAdCCARCDABCHA.hAAATDBAaBGEOCFBhABAAEFAKEGA.XDGA.hAIAQEACgFFGbEDDFGCACFGAfGHAhAEANIEB....hAGA...,2,-14,-8,6
beGXBDCTVPHQSENdLFMOaJcAIKRYWgUZf,RAAA....gAAAZADBeAFAGCEADADATAFAHCGD.EDAAdAHAhAAAMEIBaBDBACCBKGAAUDEAhABAXGCBCDGA.QGFAhAAALECBOEHD.IHFAhCEA......hCFA...,1,4,-19,23
BCIdOLeHADbGXfMQUPNFRgJZSEcaVYWTK,GAAAMAAAUAEAFADARAFFZAGB..EBHF..aBBA..VCDB..hAAATDDACDHAdFFAeDBHhACAHEBBABIBDFIBXEGAhBAA.QGEAPHAA......hBEA......hBGA...,1,-11,-21,10
FVOHZgBTYMdXIUcCSWRJDaeNfEQbKALPG,GAAAOAAAHADAZADABAGBMAFAdCDA.UCFBSBBD.RBFAaCCDhBAAeDHH.EEABbDFAAAABLFFBhACAFEDD..hAEATFFAIGEACHDADGIBNIAB......hBIA......hCAA...,2,-13,-8,5
GeAWUBSLQdEJNgcVRZaHTFXYOPDbfKICM,BAAALAAAEACA.JAEA....NAFA.VBDBRAGBHCAA..TCAAhABAXDCA.OCGHhAAAbCFD.KEHBMAIBAAIBSFFDhACAdEHA.ZGAAaFECFHGEDHAA.CHCA..hAGA......hBEA...,1,-10,-17,7
YGLfZSPDeCWNcaHgAEMBROQUTFIJVdKXb,EAAARAAAQADCFACD..VAEAdAFAXBGDGCDAZCGB.DDIBeCCBhAAA.CAHB..NEEA.HEAAhAAA.AAHAMFFBOFFAhABATGGAKGGD.........hCAA......hCIA...,1,-10,-21,11
MSaOHTFcdLXYNDPQIUZKEfJgBWbeCVRAG,GAAAaAAAHACBFADAdAEBLAGB..XAGDDAIBQCDAhAAAZCFAEDEBJEGBBDCDeBBDhAIAREFAABGBMFDBOFBATGEAhACANIBB...IHHA....hBAA......hBCA...,2,-18,-4,14
OJEDZAdeKSGHLNgFQPbCTBUVWRcaXfMIY,eAAAGAAAHADALADAFAGAQCCCCAHABCDAUCFARCFA..aEEBMCIBhAAAOEHBDDCBAAEAdFAA.hACASFCB.hAHAgGFDbEECTGGA.....WFDDhBAA.....hAAA...,1,-6,-18,12
ULKMPYQGfVeNFTdXABaHWDZIJROCEbcgS,HAAAZAAARAEA.EADE....bCABSAFB.LAHBhAAAMAIBQCDDGCABeCFBhACATDGAABHBaECDDADAOEEBhCAACCGCUFGBKFGAfEEEFHEEBHHA.IHAAhABA....hACA...,1,11,-23,34
PJMCRFHNDSKeLYbcdfgGTUBaIZAOEWVXQ,EAAAXAAA..QACAMADA.RAEAHCECSAFAeCCBbEEAhAAAdBDAGCEABAHBZFAAhAFAAAAAOAHD.PDCBhCAAFGGHDCIBLDGBYHCGfGCAhCBA.....hCAA...,1,-1,-6,5
ALTKBfUcFaMVDPOJdGNZICSRYbgHeQEWX,TAAABAAAUACA.FAEEaACA..DAHBOAED.GAGAZCBACCFA.hAAARCCB....bEFAHDFChAIAEDBBAAGBLFCAhBCA.KFHBMFEB........hAAA......hAIA...,1,-18,-39,21
WcMIZgEUJQTACDbFSfBaeRKXGNPYVOLdH,DAAASAAABACARADF.GACA...PAEAOAFA.HBFAhBAAMAIBZDDAEBGFQFDAhBBAAAAAFCEDeDGFXFGAhBIAVEBBdFHAIDHA......hCAA......hCBA...,2,-26,-3,23
QfMLCUgNSYEdTRacXDFPHBWAVZebIJGKO,eAAAJAAAGADAQADALAFACAFA.UCGASAGH.ECCBhAAARDAAaDFBDAIBHDFABFGAAAGAhADAbEDD..OFHDhBAAMFIBgFFG.NIDB.....hABA......hCAA...,1,-4,-25,21
YNOUfEacGXCIQWPBHZSbTJDMgReVdKALF,LAAAFAAAOACDEAEAGAEA..CAGAQCAABAGAHCGBZEAAhAEATCDAMAIB.RFFBeGAEhAGAdCFAAAIBUFFA.aCHBhABAXGDD.WEBEbEAADDIBKFHB...hBAA......hBEA...,2,-10,-2,8
egSBFZLARYDPVEdTCJUQMIWGaONXfKcHb,RAAADAAAEADEdADA..CAFB.QAFA.MAIBGAGA.aCCAXBBBhAFAKCFDHEECeCEFhBAABDDDZDFBAAAA..PFHDhAIAJEHBIHBA.OHECNIBB...hBIA......hCAA...,2,-23,-15,8
PMEKbSgFcTDaVNIJXCRdUZGQHWOLBYAef,eAAAMAAAKADA..bADAFAFA..DAHBaAHD..VCCA.JCHBRBBBZCFAhBAA.HECALEABhAAAAEEAEEGB.SDFHhABA.TFCAXGCAdGGA.QGGBhBBA.....hAEA...,2,-16,-11,5
dfATgHPEVbRSNUWcIKXMYGDeQLJBFOaZC,HAAAEAAARACA.SACE.UAFAIAGAMAIBGCCAeAHHLCCAhAAAFDHHZEFFdFBAACGBTDAAhADA..gFDHhAAAbDFA..cECB.XFFAhAFADGIB.....hBFA...,2,-7,-6,1
PNGWdOMBLIKXVbFZcJgHDTYUQfRACSeEa,eAAAEAAA..aACDGADAdAEABAGALAFAKBHB.bCFAZCBA..JCCFhAAAHCFBDDBB.TEBAhAAAQEFAAEIBCFDA.SFEDhABAPFFB.OGAAMIAAIGAAhAGAFGHDYHAAfHGFhAIA...,1,4,-18,22
NBGTfPdWgIFJOVZcSRLDaKYXCEAUQHebM,HAAAeAAAMAEAGADA.TAFAdBDA..IBFAOAHDZCAARBGFLCCDhAAAaDFAKEFACFAAAAIBQDEDhABABFED.fEHAhCAAgGGAFFFHJHAA.....hCBA......hDAA...,1,0,-14,14
EWePRNZbcgSXTdOJBDUFafCMVLIYGAHQK,HAAAEAAA.eACERACAZAFB..bAFBSAHH.dCCDBAHAFDABCDGAhAAAMCCA.LCHBhAAAGEEAADIBQDDAhCAAKFAA.PFGB.......hADA......hAFA...,1,-5,-25,20
TRKMaIHNGcOBAQSLdYUVeXgPWJFDbfEZC,LAAAdAAAUADA.eADH..XAFA..gAFAhABAJCBBDAIB.EBHFZDDARCABaDEAhACAHEGBGEEABCFAADHAQFABhAFASFFDPDHDFGAA.CGHDMIAAhAGANIEB......hAIA...,1,2,-22,24
BLKeFCQbHgOJNMUdPWVafYITAESZDXcGR,EAAAZAAADACAGACARAEA.LAEAFBHD.QCEAHCCCOCFDMAIBhAAAdEHA..VEGBaFAA.hABAfCBE.hAFATFAAAAHAXGGCKEEDeHCA....hAFA......hAGA...,1,2,-25,27
EZUCSfQDIAYONbaMWFHRedTcLJXGBKPgV,OAAAaAAA.FADDHACB.RAEAeAHHdAFALAHBGCFAKEAA.VEDBhAEAEBBBZDDA.SEGHhBAADBBBADEA.bFBAMDIBhAFA...WFHDJHBABGHAPHAA..hAHA......hBAA...,2,-19,-4,15
UdTLOGMeVHgDPaECSRXANKQJfYIcBZbWF,QAAAJAAA..IAEAZACBFAEDdAGALAGBGDEAeBFFhADAHDGDDAIBEGBA.SGDHhAAAACCAKCDB.fGGEhAIABDHAbEFD....WHFA...hBCA......hBGA...,1,-9,-36,27
JAGPfQBMEOFNKWVHScCIgRaTdbLXDeZUY,GAAAQAAAEADAFAFDKACAHAEB.CAGARCGBdAHA.LCDBDAIBeCDBhAAAZDEB.UGGAAEAABFEAhAEAMDABOFHD.VGAAhAGASDGA.IHBAaGEE..hAAA......hACA...,2,-19,-4,15
JbQEPULOWIXdHDfYASRCKaFTgNeMBGVZc,RAAAaAAAFADA....TADAeAFHGBGAZAFB.JCCBEAHF.LCCBhADAOEDC.XDGAhAFAHGEADAIBABBBKEEAMEIBBFGAhBAA...........hAAA......hABA...,2,-23,-20,3
feWFPQZEUJcKOHVCXTDdRMbBNGAaYSgIL,aAAASAAALADAeACHFAHB.ZADB.EAFAUCCA.KCFAHBFCCDHA.hAEATDEAREDA.bEGDGGEBhAFAAAAA..gGDAhAIAfFCE........hBAA......hBBA...,2,-26,-1,25
BFfCdPDMVYXWeGKHOURIAScbEQTZJgNLa,SAAAEAAAZACB..JAEBLADABAGA.CAHAdCCAMAIB..XCFAhAAAeCBDHCGBREABAAEAQEDAhABATEEAaFDHFFHDhAAADCIBVGFA...YHAGKGAA.hAGA......hBCA...,1,-6,-15,9
GfSNJMKZcWRTPLFbBEUXCQDaeYgIHVOdA,GAAASAAAMADAZACBRAFALCDBBAEAEAGA.CCFD...QCEAhAAAeCGH..gDBHhAAAHCGDdECAABIBfEHAhACAKEEDTGAAbFEDDEIBaGGCIGFA.hAIA......hBAA...,2,-11,-8,3
QXDJSBReabPTCOIZFYVUcLfdMWGENKAHg,HAAAQAAADACABAEARACA.eAFHaAFA...TCCAOAHDZAGBFBFDhAAAUECBLDAA.hAAAdEEAGGEBEDGFAEIBXGGAhADASCHHCHFD.YFFC...hCAA......hCEA...,1,-8,-11,3
IJTNBfaUdPKeFGbXHRQVYZLWSCAcDEMgO,EAAAMAAA..OACCTADABAFB.aAGDdAFA.eAHBGCCAHBBBhAIAREABQEFAhAAAZDEALFDACCFDAAIBDEIB.IHCAhBAAfFEEKGHD.FGHD......hAEA......hCAA...,2,-17,-6,11
VPXSRYTNDbWFGcZOEUKHeMCfJgLaIQAdB,dAAABAAA..XADARACA..TAGAbABD.GCAAZAFBEAHFHCCChAAA.eCFGMCEBfEFAhACALDHBaDAChADAAAFASEGHDEGBFFEDOHEECGHA....hAEA......hBAA...,1,-9,-11,2
aTGLfSAOVZPbJXKMYNUgRcDBCeHEFIdQW,ZAAAJAAA.MACAUADARAEA..BAHBHAFA.ECCBdCCD...aCFDGCGAhAHALCHBACIBODFHhAIA..bFDAKEDB.gGDGhBAACEEDeHDEIHHAQGGB..hCAA......hCBA...,2,-18,-14,4
TDYEFQRIUHSVZBaOCedKGLNMJAXfbWPcg,XAAA..bAAA....cADATAEA.EAGERAGBHBCBhAAAZCAAaCECeCFFGCGAhAAAMDIBACIB.fECEhABAPEABDEEBQFACSFEHOEEHdGCAKGGDhABALHFA.NIAB.hAFA...,2,0,7,7
RQaFNXKgcCMUVLfTJYIEOdGHWAPDbSZBe,DAAAZAAARAEAQACAFBHD.KAEACCAA..UCCBLAGB.TDDAhAIAJCFB...EBBBGEAAhABAHEGBABIB.bFCAeEGFhACA.aEHD..NIDB.......hBAA......hCAA...,1,-17,-30,13
DJZGLYUfWbSQFgRTcOAEIdBMCXNVePKHa,EAAAdAAAMADA..XACAeAFAHBDAaAFAZBEBGCBA.LCHBhACAfBHAbDFBFEEBhBAARCCFTEFAAGHACHEA.PDABhAAADIBA.UGCA.SEHB..hADA......hAIA...,2,-11,2,13
gaUVGWLCBJdEbPZeTOcHQNSADXfRYIKFM,XAAARAAAKADC.FADAaAFD..GAFALAHBBAHAECCAZCDFeDEBhAAATDBAHEGB.QFBAhABAAAAADCIB.fGDBhBFAMDHBgFDGWHBG.dGGD.OHAAhAHA.....hBHA...,1,-6,-13,7
FDcMPROHGNBgVdCQIJXTbKSAYaZLWeEfU,ZAAAeAAAEADEFADD.DAFAMAFA..RBEFHBGBGBEBBCCDdCAAQDDAhABA.XDFAhACAbEECAAAA.LGFAhBHAfFHA.PGBCOCCB.NIBB.gGEHhAIA...hBIA...,1,-6,-21,15
CNSJWBIYQAfUHgKGeTMaDdFOXPbRcLVZE,HAAAGAAAeACEaADAdAGAXAFB.RBGFLCCAECDASBHHhAAABECAQEEAhAAAADCBUEEATGBAMDIB.OFHHhAIAbGFA...........hACA......hAIA...,1,1,-18,19
HSdTVKXbFACEWOMDBYfIQgeaUPNZJLRcG,EAAAMAAABACA..IAEAeADHUAFAZAFBRBBAHDEA.dBHATDDAhAIAKEDDFEHD..ABBAOBHBhBAADCCBQGDAhAAA.aFBBPEGB.LFCASGGDhAIA......hBFA...,1,-13,-18,5
dDNgWGKUCXQfSIYZTMFVELPRBcaebJHOA,dAAADAAA.....gADAGABBCAFBQBGA.SCCAhAEAZABBMAGBEAHBhAEARCEFaEFDeCEF.HCGBhAIAAAHAKEHBfFEA.TGFALHEAhBAA......hCAA...,1,-9,-28,19
EHcYORbCZSfPFgDdAIMWeTaQNBUGXVLKJ,MAAAeAAAQADABADAGAEALAGB.ECCBHAGDOCHDhAAARBBBZEDASDFDhABAFDHDdGAAADGBIGHAaEDDXFBBhAIA.KFGA.........hAGA......hAIA...,2,-21,2,23
cSFYfXHgMTPdEICOJGeRZBQNDKbVULaWA,FAAAXAAAHACBMAEAdADA..EAFAOAHDeAHFZCDEQBEChBAA.KDFAbDBDLFFAhBGAAAAASCHHfHBBhBHATEEACHDBJHFARGEADDBB.aFAH.....hCAA......hCBA...,2,-8,2,10
YDceLWRTfXOFGQPHKEVJNbdISBMagZUCA,DAAAeAAARABA...TADAOAEAGAFAHBDCEAHFJCCB...dDDABAHAhAAAaCGE.ZDGB.ADFBLFAAhABAXEGAQFEDhBAAKEEDbGFA.SHGAMHAA.CHEA..hAFA......hAHA...,2,-11,-8,3
EgATaWIBZJdbCQSMDRecNPFHLGYXKVUfO,aAAABAAAZACBdACA.QAEAMAFA.RAGB.eBEA...PBHDhBAAHCDAGEAA.hBBAKDHBfDEAhBEAECBBAAIBTEFAIEGACFEDDGHB.FFBA.LFFAhBFA.XGDD.hAAA...,1,-7,-17,10
HTgQVIJAGdeZfDKOPBCUFWcaEbNYXRSLM,eAAAZAAAKADCBADAFAFD...aAEDEAHB....bAFDXCAAhABA.RCFALDDBhACAHCCBTEFAQFFAhAIAIAHAAEHA.dCHAOFHFCFEDWFHH.....hCAA......hCBA...,2,-16,-16,0
BWaLDNIObfGZKYMXAgHcUTREVdFSPCeQJ,HAAATAAAEADE.dAFASACBeAHBBCADaAEALCCB.DCEBhAAAOAGDGCGAZBDBMEFBhACAAAIBgDFBhAAAUGGBFFDD.QFCANIAB.bFED.KCCD.XGGAhCAA...hAIA...,1,4,2,2
JSbVOPYgTMRKGBaFfWCQIUNLZEcHeXDdA,SAAAOAAA....gADARACFGAEAaAGAFAGACBBDQBGChAAAUCFAZDDBHEAAhAEAeDEDdEAAACIB.VEGBTFFAhBAAMIDABEHA.fGBA.IHDAhBGA...hABA...,2,-9,-7,2
ZXdTcIUgLSfYPBAHOMbQNReFWEDCJKGVa,HAAAMAAA.QADCRACAFAFA.EAFECBBDGCDAZBFEdCAD..TDDAhAAAUCGALFCBSDFHhACA.fDHAhAHABFFAAAIBOFHBeFHFDGGB.KHDA.....hBAA......hCAA...,1,18,-30,48
CcNFgYSAHRMdTVGPWKbJQDLEZaOUXIfeB,HAAARAAAdADAGAFAKADCQAFALAHBECABZCCA.UFAA..fCCAhAAAeEEBBEGACAHAFCFHhACASEHHACIBMDEBTFFAhCCA.PECDWHBADGGBaEHFOHDChCEAIHHA....hAAA...,1,10,-19,29
QBdLUCbFeKPTOVHEaDIJYWXcGMZNSRfgA,dAAALAAACADA.eADHKAFA.OAFAHCACEBHFDBFB....ICAAhABAJCFB..XECAhACAGCFAZEDFRFABAAHAQFGAhADAbFGDTGBA.aGFHWCCD...MBIBhACA.....hAFA...,2,-24,0,24
aRceZdIPKUYOLBDXJNCMfEAGSHFQVgWbT,HAAAQAAAVAEA.....bACARCAAeAHHdAGAKCDAOCEBLDABhAAAXDFDCCHAEDCBAAIBFEAHhAAA.TGGAZEEAIGDAhADAPHAABEHBDEIBJHEEMIDASGBHhAEA......hBGA...,1,9,-5,14
FNeCUcGdSMgDVXaOTfALEbPBYKHWIJZRQ,EAAABAAAHACAJACA.RAFFFBHD..eAFEUCCBdCBA..MDFBDBGB.aEABhAAAOCFH.ACHALDDBhAAAbEFD.KDHBZFABhAEA.CEHASHEG..XFGChAIA.fECAhBCA.PHDC,1,-8,-31,23
fLVIOEKNPgQSGdaeTMbJABZCRFHDUcYWX,ZAAARAAAHADBDACAUAFA....cAFA..XBDDhABALAHBOAHFECCBKCFB.hBFAgDABGDEBeCCDhCAAbEEAAAAAFFFH.fHDBIHHA...hADA......hBFA...,2,-22,-13,9
eHZXNfKFYEABUQgPcbCRTSaOWGLIMVDJd,QAAA..gAAA.bADARACAaAFA.GBEBhAAAMAHBDADAeDAAHCCAhAAAZDEAfFDAhADAFDFDAAIBBDHAcECCTFFAOFHDLFHB.IGGAhABA....hCCA...,1,-1,-22,21
TPNQfWDXBAKLMSbUCceFHEIRVdgGYZOaJ,MAAASAAAUAEA.eACHHAGD.RBBBdDEAGAEAZEGB.aAGA.TCGAhAAAQEBB.DDGBhAIAAAEBbDDDCBDC.EEHF.gGBBhABA.OFFDNICBWFHHBHHA.hBAA......hBBA...,2,-17,7,24
IAbSaDQKCRNMXFTefZUJOgEcVLPHGYdBW,aAAAQAAA.RACA.MADAFAFA.eAFAZBFEOCDDEBBBLBDBhBAAHDABdDGABBHAADABDDIBCCFATDGAhCAAUGEA...gFCAhCDA.PFFB....hCFA......hDAA...,2,-18,-15,3
VdbPDOGHLgMcfYWEUSIXNaKQCFAJeBTZR,eAAAZAAARAEAdAHADAEAHAFCLCAB..MBDB....fCCEhABAEBEBSCFHhAAAXCEAaCHDQEDDhABA.ACCBTGFAbDGDGECB...hAIA......hCAA...,2,-19,-19,0
JGWfadYMSXgbZQULPCFcKTeBHVIERADON,OAAAGAAAaADAdAEA..MAGBSAFH..bBCDZAGBLAHBhBAAFCDBTEBAHEDCEDHFhAAAABBBDEBBJEEB..fFHAhACAXEGBQGGBCGFA.eHBAhBEA......hBHA...,2,-10,-6,4
IKTZFPJARGaUeWBNDgHVbSCcMXQOfdLYE,RAAAaAAAeADEBADA..DAGAHAEB..SBDHMAHBQCCChADAdBHAECFA.TDFAZDCAFEGAhAAAAAGBUFFB.NAIA.bFCBhABA.CFGD.OBBH..fGHAhCAA......hCCA...,2,-21,-10,11
SLQOINVeTWYaMdBUcGAFPDEbRXgZfHJKC,DAAARAAAZADBHABCKAFA.LAEB.QAGAOAHD..ICFAhAAAeCCBTDGA.hABAaECHdCCCBEEAGDAAhADAAFGBEFHFbDGDfGAA.SGCAhAGAWEEBMIEA....hAHA...,1,3,-26,29
UTSNdDKGWMHgLFQIbcEYAXZCaPJVfeRBO,ZAAAaAAA.JADA..eACHRAGF.OAEAUCAA...TBEAdDDAGEGAhABAHBGBLDDBhAIA.QEBBhBAAbFCAECFB.ABBBCEHA.fFFASGABKGHBMCIBhACA......hAGA...,2,-23,4,27
RJfaETYHCMWDKeAOXLIQgPSBFNZbcdUGV,LAAAQAAASADHFACEZAEB.dAFAGAGARBGF.aCDBECAAHDFBhAAAMDDBKFED.AAIBXGBAhBGAgEEABFHAhCAAbFBD..UGGA........hABA......hACA...,2,-16,-5,11
FZVbXJOaHPcLIfSWBUAEgYCDeGNTQdRKM,EAAACAAAGACA..TACARAEAFBHD.ZAEB...XAGAaCABHCFBhAAALCGBSEAAhACABCCDAAHADEEBeDFFdFFDMDIBhAAA.bEAAOFDHIGGAfGHAhAEA..WEED.YHAAhAEA,1,-3,-21,18
HSWbORgEaBDJNYVcdMLfICXFGTPZAQeKU,eAAAHAAASACEOADCRAGF.EAFADCCAJAHB....VCEBdCCAMCFBhAAALEHBCDGDGEDAhAFAZFAAAAAAQGFAhAFAKFHBWHFG.aDDHBGCDNIAB.......hAGA......hAIA...,2,-9,-7,2
GHASYUbXfDNEWdCQRZKgJOPMcaLTeBFVI,SAAAUAAA..bADADADA.EAFAdAHARBCAZBGBKCDA...ODBBhAAAMDABLDGBhADABCFAFDEH.IEEAHFGBACIB.hABAXFADNIAB.QGEC.gFCDhAEA..hAFA...,1,-15,-25,10
CfJHLYPBOKaGZUNQbXWREdVeTgAMDcIFS,MAAADAAAFACD..CADAHAEBLAEABAGAKBHBZBBF.UDGAQCDAhAFA..bDDDRCFBEEHFhAGAeGAEABBB...SAHHhAGAfFFEYGEGaHDA..NIAB..hBAA......hCAA...,1,-22,-23,1
STbOREBWgdeVPGUZNDLMcCQFJfKYaIHXA,TAAARAAAEADE..BAFBdACAeAEAGAGAZBEELCCAMAIB.QECAhAAAFDDHKDGA.aDHDHEABhAAAAAIB.bFDAOEFBhABA..WFHBgGGA....hCAA......hCDA...,1,-3,-13,10
RfaCZNJLBbKeGcVTPIMSYAQEXUdHgDFWO,EAAAdAAAHADAFACD.RAGFCCBAZADB.LAGBKCEAGDCA..TDEAhAAAMCIB.AAIBQEGAhBFAUEEADDAB.OFCB.hACAaGGCBFAA.eEHD.cGAD..hADA......hAFA...,1,-14,-16,2
gRMOVXAEDeCYcKUBTIJZafGQLdHPNbSWF,EAAAeAAA.CADA.KACABAFA..TAFAZAGBGCCAdAHAHCCA.bDFAhAAAFDHD.REFBMFAB.hAEAOFCHACEADEEBcFAAhAFAJFEF.aFFA.LGDA....hCAA......hCBA...,1,-9,-24,15
UbQWDYIXCgVaZGeONKEHTSBMRfJFcLAdP,dAAAUAAAQADADADA..XAEACAFAaAGD.GBGA.eBDBhAHAKCBAHDCCBDFDRFCAFCHDhACAAAIB.bDFD..IGGAhBAA..........hBCA......hCFA...,1,-25,-32,7
cfTZAOQdRVIDFUgHGSPNWbaEKeXLMCJYB,dAAARAAADADAFADAHAECGAFA..SAHB..PBDBhACAbCCAKCGAeAHB.MCCBhAIACECABEEDTEEAAAAAQEGAhCAAIEHAgGGAaGEA.EFDB.hCCA......hCDA...,1,-8,-24,16
UCNZVXBcAaJdgLYPIQESOFDGMTRbKWefH,dAAALAAA..IADAEAEAFAGDGCAARAEFKAGC.eBHHHCACCCCAZDEBhABABBHA.ACGBaDECJECB.hACA....gDGHhACAQGFADFFBMEIBTGGA...hAEA......hAIA...,2,-24,-11,13
XZSdEQBbPCDUNVYLMgOWfJFeaKGcRATIH,HAAAZAAAEADEQADCBAFB.CAFBDAHBUCAA..VCEAMAHBOCABhAAAJCDB..FCFBeCCBhACAGEFAAAIB..TEGAhCIASCHHdGGDPEEBLFHB...hDIA......hEBA...,1,-4,-22,18
AIJKGYUeTQZNLfOEPVaFWMBgRbCHcDSdX,KAAAGAAAeACEZADALAFBEAGE..aCDAMAHBRCGB.HBCADDDBdEADhAAAAAIBJDEFUEEA..TEGAhAAA..fFHAhACAOGEE.........hCAA......hCBA...,2,-24,-19,5
gXRZQaefFCdODKYbILNBUMESPATHWVJcG,HAAAVAAA.GADA.RAFAaCACeADE.CAGBdCDAKCGA....bDAALCFAhAAABEFA.EEBBAAFATFDAhAAAJEFA.XGGAhACAZFFAQGCAOHECDIAA....hADA......hAIA...,1,-2,-17,15
gVSNOfQCKbaYXDUBRLZHPMdEIcGFeWJAT,TAAASAAA.OACDQACC.KAECaAEADAHBRAGFHBEBhAAAdCEAECGBGEBAFEDHeDHHhAAAABEBgEEA.hAIAfDHAbFFDXGBCBFHA....hABA......hAIA...,1,-5,-13,8
MDbagCEPIUNeQRFAWBLGKdJYHTZVcXfSO,LAAAdAAAHADAZABBXADDOAFA.MBIBaAFA....EBFEICFAhBAAeBHHRCAAACAAGDCAhCDAKDEA.TEGAVFFASEDDhABAbEEB..CGGD.NIAB.WHCG.hACA......hAIA...,2,-11,4,15
NVLcMKfZREPWObHJBTFaICXUASDdeGQYg,dAAAeAAAGADAQADA..gAFBLAGBMAIBZABBECHFhAHAOCCBHDEBTFBAhAIAaDEBXEGAADDBDEIBNIBBKFBDhAAA.RFEB...bGDAFGCDCHHA.SGGBhABA......hBFA...,1,11,-4,15
gDFcOMILHWRdNYGJTZbKABaESVeQXCfUP,EAAAeAAA.QADACACAUAEA.DAGAFAGEMBFAHCCA..RCCBdCGAGCGAhAAAZEFAAAAAaEBB.SEEBhBEAfFDA..hCAAgGDBIGGANICB......hCBA......hCCA...,1,-14,-17,3
FXLJHQIcVCgDGefYNabMBPURZWTdEAOKS,SAAALAAAHADBQADAVAFADCAAeAFA...fBHAhAAAaCGEMDDBBEEAhABARCCBZDAFdDGDAEGAFEHDXEFChABAIFAACFDAgGAG.YFHBhADAbGFC.....hACA...,1,15,-23,38
cEOJfTFaLbgZVMQIWGBDUPeRYAHdSCKXN,HAAAdAAAKADAXADB.EAFAfAFB.FBHDbBFAZABBMCABhAAAQCEAGCCADDHBhACAeDCFACCBCEFAOEEBhAHAaEHDLHBAIFGABFEDPHECSGGDhAIA.....hAIA...,1,16,-22,38
bYBeSUKETJafLVcNPFDRMOZGCIQAgWXdH,XAAAHAAABADBUADAEAFA....aAHDLAGB.VDBAhAAAPCABREFAZFBAGCCAhAAACGHA.ACCBdCFA.eDHBhACASGEHTFAAfFFANAIA.MIDAhAFA.IHHAhBHA...,2,-17,-9,8
GTEODWUfVaAgHeICZSdQFNbRXLKBPMcYJ,HAAAeAAAZADBdADAQAFAFAFD.RCAALBHBBAHAMCCBJCEBECGAhAAADDGBUEEA..aFAAhAAAABDBCDHA..SFFAhACAXGFA.KGHB.PHDA..YFDFhABA....hAHA...,1,0,-35,35
UZBLFaPRVGNXWIAdTMCJgHbKfESDYOeQc,dAAAMAAACADAHAEBKADA..EAFEDAGA..eAHHQBGCZBBALCFBhAHAaCAE.REGF.GDCAhACAXDDCADIBTEGA.hBAAbEEBSFDH..cGGC.hBCA......hCAA...,1,-5,-20,15
OMcYGHLIRegXSFdCAJDKfBPabWNQVEUTZ,KAAABAAA.aACA..bACBQAFA.EBCBZAEB.MAHBGCDAhAAAHCFBRDBBeBHHSCCDhAAAdFAAADGBDEIBfEBEhAIAPFFB.VFGBOHBCLGBAIHHAhAFA......hAIA...,1,-3,-5,2
dQCNcRPgFbVUEOJBfKYXeSAaDHMTZILGW,HAAAZAAAGAEAdADAQAFACADB.RCAAFCEDbAGB...ECHFBCAAhABAKEFA.eCCBAAIB.aCHDMEIBhAAALFFA.NEEA.hACAgFAAUGBAfHFBSGDA.hBGADGGB.....hBIA...,1,-5,-11,6
PBLfOXSVEIMGbQeDCYJZAHTagKFdUcWNR,HAAAaAAA.FADAdADAUAGA....NAFARAGBLCAA.XCEChAAAEBBBGDDAeDFACDBDZFGBhAGAAEIBKFCA...PFFBhACAOCGH..SGBDMIAA.DGIBhBGA......hBIA...,1,-17,-19,2
MRDWCXdPAIBUgEZNGQJHbVeaLOScKfYFT,BAAAEAAAGACAHACAeAEELAEAOAHDKBHBFCBHRCAA..CCEAdDGAAAFAUDFAhAAAZECA...QEDAhAIAbGCC.aEHDfGGAhAAAMFCBDGGB........hACA......hAHA...,2,-16,-9,7
ZIPbeGSDOCTgWLfJNFXcMKHQYRUBdVAEa,EAAAZAAA....bADBeACA.GAFAOAFCTCCALCABfAHEhAAAFCCHMCFAHDABhADARDFAdFDAADFBaDGD.SEEDhAIACFFDJFHB.XGGAKHAA....hBFA......hCAA...,1,-5,-10,5
RXYgUZeFCABPGbQTJNKIWaDVdLOcMSfHE,GAAATAAA.KADA..aACAdAFALAFAMAHBHCDARCCA..XCFBhAAAgDGAeCHFAAABBDCDhACAbEED.QFEChADAIGAADDBB.OHAEfGHAEGGE.hAGA......hAHA...,2,-9,-5,4
gZRbPeFOaEULBdfSIQWKANVCHJDGXcMYT,CAAAHAAAGACAMACA...TAFARAEAeAHHaAHDECABLCCABCFAdEADhAAASDEA.hACAQEBAADIBVEDAXGEAhAEAgEFAPHAAOEHD.fHABhAAAIHHA.KHDA.hAFA...,2,-16,10,26
NfYPVKGROUHcMgAbDJadBeCLTSEXWZQIF,DAAAdAAAeADALADAEAGA.ZAGB.FBBB..fBHA.VCBAhACARCDBHEAA.MBIBhAEAAADAaCFBTEGA.XFDAhAFAQDGBIHHAPEEBKGCDOFHDhBAA.gGFFhBCABDCD..,2,-19,-1,18
TUGFVaSKWfdHICEYZBNQebcMAOgRLXPJD,RAAALAAA.XADDDADAGAEB.aCCAKAFAdCFDHCAA.EBHFhABAZDDAQDEAhACAeCHHMFFBAAHAODHD.hAAAgFAATGGAFHAASEDD.hABAfGEA.hAHACGGA...,2,-19,1,20
FXQIABbJSNDPOdUHGafKCMYZVcgRWLEeT,BAAASAAADACAdAFAHACBGBCAKAEAMAHBZAGB....VEEAhAAARCEBEDHF.eEAAFEBB.QFGBhAAAABCB.bGAAhABAPFHDaEEH.CDHA........hAEA......hAGA...,2,-33,-3,30
FBZQcLORHeMGbPIEVTWCUDJaANdXYSKgf,dAAASAAAKADAFAFA.ZACBLCCAHAEAeAHHGCFA..bCFDEBHFhACA..TECACDAADDIB.hADAAAAAXFGA.hAIAfCEEQECARGAAMHEAIGHA.hAGAWFFD....hBAA...,2,-31,12,43
TUEHSWIKMeOAGCNYFJcDgRZbQPdfVXaLB,GAAACAAAFACA.DADARAEF.ZADE..QAGCdAHA..XCDAhAAAaBCHLDEATDGAHFFAhAAASECAKGDAeHFAhAIAACGBJFFB..........hACA......hBAA...,2,-28,-17,11
KHVTUIDGXYEgAfCbORBFcdQWMJSeaPLZN,CAAARAAAFADAdACA...MAGBeAEA.LBHBZBGBHCCAUCEAGECBECBB.hAAAAAAA..ODHDQEAChAEASGGBaDDBKFFAhAFAIHAAXGDC.fGHA.hAHABCGA....hAIA...,2,-14,-13,1
aFPOAMbdKVZEcCQUgNeTGWDBYJSLXHIfR,dAAAZAAAEADEQADA.UAGAeAFEGCABBBFASCAAhABAHDEARFBAaDHD.OCEB.hACAACAAMCHBbGDA.KDFBCHHANIBBhADATGGA.DCIB.......hBAA......hBCA...,1,2,-22,24
ILdCfVXSGaQNbeJPHcEADUZKgWYBMORFT,ZAAAKAAA.....gADBBACBRADFTAGAdAGA..CCAA..XCCChABAaCCH.QDEAhACAeCFBHEEBAAIBDCIBhAFAUFAAMDHBFDHBfGCBGGBB.NIAB..hBGA......hCAA...,1,-18,-19,1
ZELJOKNcXPFAfYaUCMVIHSTWQGdegbBDR,aAAAMAAAHACB..TADAGAEB.eBBDBAFBRCFAEDEBLAHBhBAAKEAA.XBBCAAEAUFGACFCAhAHASBFA.hAIAdDDADICAZDEB.OEHB.cGEDfHEBhBAA....hCAA...,1,-6,-12,6
ReQSWAMOUTbFCgDKJdHVGLPacXYNIfEBZ,MAAATAAAFADD..DACAdAFAHADCGBBAaAGA...XBGDhAHA..ICCAhAAAEDEBREFFeEHHQBGDhCAAAAIBbFBA.KCED.LEFA.cGEANICB.hBAABDGA.SGGBhDAA.,1,0,-21,21
PJCAMRSdOgKYEeGQFVZBNcWXUbDITLfHa,RAAAdAAAKADCEADAGAFA..QAFAZCCABAHA...NAIAXCAAhACADCIBLECB.HEFChAAAaCFCCDDAAEEBMFBB.hADAOHDCeEFBFEHH.cGEC.WHBGhBAAIHHA...hBCA...,1,-16,-21,5
WHEAScONLMRTfgXIPKQFabedGCJBDUVYZ,OAAAMAAARACA...TADA..XAFBKAFCQBGAhAIAaAHDeBBBGCCABCFDDDDBhBAAVEFAZDGBHFDBAEEASFFDhBHANBBA..fGHAIHHA..hBAA......hCAA...,1,-9,-23,14
KbJPCZBHeXTgAFVIaQONDdMfLREcGYWSU,FAAAaAAA.QADADADA.dAGAMAGBLCCBEAHBGBBB.SCGHhAIAbDABCCHA.HDEBhBAAeDGBTEBAAAIBOEDDhADAfEHARFFB.cGGCWFHHKGBA.hBBA......hBEA...,1,-3,-16,13
GJMcQAVPbWeKXdONEaZYFDHISUgTCBfRL,VAAA..bAAAeADEdAEAEAGAZAGB..DBEBHCAA.SBGAhAAAUDDBCDHABEGDRDEAGEBAhABA.MDIBABIBKFCDOFDDhACAaFGE.FFGB.IHHAfGAA..hAAA...cGCDhAGA...,2,-39,16,55
DgVIXBNHCbJcfOAGLeEZPSMRUYKdFQWaT,eAAAEAAAZACBMAEA.RBCA.KAEA.dAGAQBFC.aBHDTCEAhAAADDBB.VDGBBDEDHECAhAIAbDBD...fGGEhBCAAAAAGEFALEHB.SHBAhAIA....hBDA...,1,-6,-18,12
PFdBTEDfgaIARQYJGHKLCVMbXcNZeOUWS,RAAAQAAAGADAHAFALADAMCCB.XAGDZCGBeDAB.ODDHhAAASCBAdGEAEGGAfCEAhAAA.aDFDhAEAAAHAYFAFCDHAbECDcFAB.UGGA..hAFA......hAIA...,1,7,-11,18
fGRBZIcTMdPKDCOeNWASXEQJVUYHFbaLg,EAAAQAAAUADAHAFAaACE.LBCDGAEARAGBZCFE...TEDAhAAAdDAADCDB.eDFHAAHAXFGAhCAAVGAAFEDDfGEAhCBABEHAMHEACHCAOHFCSGGE..hAAA......hADA...,1,2,-2,4
IgFRKQTfJCPeGNdVBbLEOaAMXUcDYWSZH,MAAAXAAADAEA...SADAHAFCFBBARBDFQAGA.hAIATCDACCFAeCHFdCFAbEFDhBAAEDAA.AAAAUFFA.hCAAcEADYFEDZGAEKHDA.....hCBA......hDAA...,2,-23,4,27
HFKXOVSJBdETQWNGYgZPfUecbLAMCaDRI,aAAARAAAHADB.KAFAOACD..SAHBdAEAEAGA.TCFAhAAAQCFAGDAAZEBAfCCEhABAeBBDLDHBhAGAADABMDIBDEDAXEECBFFAYHFAgGGBhADA.PHCA.hBAA...,2,-17,14,31
DNQOTJRgPeWaHfbXSUGBCIZAFMcYLdVKE,MAAALAAAdAEAKAGAEAEADAHB..QBBAOBFD.RCEAeCHHhAGAHCAAXDCAGEBACEEDAEBBhAIAFCHD.VFCB.TFFAhABAgFGA.aGEBSEADhACA.BFHB.IHHAhAEA.,1,-6,-14,8
ZaFHYeLBWKAQXgCDfbINMRPEcUOSVJdTG,QAAACAAADACA...IADARADAEAGEUCBASAEH.hAAAdAGAZCFAHCBCeDDGLDFAhAAAKEGAACGA.fEEEhAIAMFFB.OFHBTGGAaGBA.BGFAhBCA.XGDDNIAB.hAIA...,1,5,-32,37
aFYVJeZTDfKQELUOgRcbNWIPMSACdHBXG,HAAAGAAAaACAFADA..VAFAeAFH.ZAGBTCCAKCDBLEFAhAAA.ODBDRCEFbDGDIFAAhAAAMGEAABIB.dGEABGHAhACAXECCDHEA........hAFA......hAIA...,1,-4,-16,12
XEINAWHLfKTGZeRBdUPcOJSYFCDgbQMaV,HAAALAAATAEAeADHRAGFBCADdAFAUCAAOCCB..SAHBhABACDEADCIB.QCGDhACAaDFDEEAB.ADEAKEEAZFGBPEDBhAAAcFBAFEHHMIAAXGGCIHEAfHBBhBFA..hBHA...,1,1,-14,15
LfYQaKVeAdcUITPBXSDMGJWOCENgFbHZR,dAAAUAAA..TADAXADAMAFA.GBFAOAGB..EBHBFBHDhADAHCACRCBALEAAhAEAQEDAaEEA.eEHBAAHA.hBAAIGGASEGHDFCB.CFDANEIA....hBCA......hCEA...,1,4,-20,24
KEPSJNZfBdWMbAOUGgRCIDceHFLQVTXaY,GAAARAAADADAHAECLADA.TBGAaAHDECCASCDAZCFA.hAAAdDGDbDECAAABODCBhACA.CAHBeEABQFFAhABAXEECKFHBPHAAfFGA.MFIBhAEA......hAFA...,2,-6,-3,3
WHBDZcSYMaFVgQdTNCELJbAfKeIUXOGPR,eAAAXAAAGADARADA.HAFAZAGB.SCCDaCDC.FCGDQDAAhAAAdFAATFDAEDHFbFFBhAAAAADAKEEA.UGAAOFHDhABABFHADCIB.MIAAgGEA.CGCA.hABA......hAGA...,1,16,-15,31
McbUPLegNaKdACRSXVIBFQJZHYfTWOEGD,RAAAXAAABADBFAFAZACB.HAEA..TBEAEBHFGCFA.MCEBhAAAUDCAeDHHaAHDAAAASFDAhABA.QGAAhAGAfDGADGIBbEED...gGGBhCAA.dGDC.hAHA...,2,-25,2,27
TMQSKVUaENFfecZgCbOWLRXGIYdPBJHAD,MAAAQAAAKADA.aACEEAFE..FAFAeAHHZBFA..CCDA.OBBBhAHARDAAGDFAdCDABCFAHFDBAAIBhAAATEFASHGAhADAUFCA..fFHA.....hCAA......hCDA...,2,-18,-8,10
cNVJKXEWOfDgFdUPbMICYaSAGeHRZLBTQ,HAAARAAAZADBLAGBTAEAQAGC.VCCAXCED.hAAAEDAAfCAEhACAFDHDdFBAUGFAbDFAMEABCHHBaGCD.hAAAADGAeFFB.BFHD.NIAB.....hADA......hAEA...,1,10,-16,26
XHVSfCOIMbYDeRaFQNcZWTdBgULEGKPAJ,HAAASAAAOACAMADADAGARBDA..aAFEQBGCZBAE.dDDDhAAABBEDLEGBEBHFGCFAhAAAACCB.XDDBhABACFFA.bFGD.........hBIA......hCAA...,2,-24,-10,14
dAfYXcODKaeUJVFgSLNZPCBHEGQITMRbW,XAAADAAAeABAUAFAFADA..LAGBZBDBBAHAHBCBGDFATEEAhAAARFDB.dEGAACCA.fBFAhABAOCHD.aECH.hBAA............hCAA......hCBA...,1,-10,-32,22
XdHeRWUFANVOSKfCQbEgGacDJPIYTZBML,OAAAKAAAQACC..EADAaAEADAGA.JBBF..IAHAhAAAZBEBMBHBdCEAHDCBRCGBFEDHhBFAABIB.SFFBhCAACEGDGGCB.PFHDBFFD.LGCA...hBAA......hCAA...,2,-24,-4,20
JLaTeMSFCdYUfXEGWQBPcZRHVKDOIbAgN,JAAAaAAA...eADEMADAFAGAdAHA..UCCAEBBBGBDABCFAZCGBHCFBhBAA.DBFAOEBBhBAAABDBLDHB.TFCAhCAACEFCXFCA.QGGAcFFC..hBEA......hCAA...,2,-31,-3,28
KRAQDHVfNMaBTYICOceGEWLFSUZJXgdPb,HAAAVAAA.MACABADB..TAFACAFA.eAHHEAHBLCDAhAAAFBDDZDEBXDGAdDHAKECAACEAQFCAhAAA.fFHEhAHAaEEAOFABcGGCSFFD.hCAAgGGB.hCCAPHCC.,1,14,-22,36
eJBZaRFMQOTUGVELbCWAXSKHdPgfDINcY,KAAAHAAAdACA..fADBDAEA..IAHANAGA..eAHBhAAAZBDBRBFBMCAB.TCCAhACAGEGAEDHBbFDBACEASDFDhAFA.gGGA.hAAAYEEFaCHFFGFH.OHCChAIA.,2,-25,-11,14
BPbJQWFNGIODUCHZEYTeRfMdcAXaVSKgL,aAAAKAAALACBBADA..JAFAQAEA.FAGEGBDBhADADCEBHCFCEBBBeCHFREAAdEFAAEAAhAAASDDB.hAEAbDFDIFHA.CHHA.YFHBMICA.hCAA......hCBA...,2,-22,-14,8
DIeTVCMQcdFABXbOafHPUGZLKWgSNJERY,XAAAaAAAHACBGAEBZACBLAFAKCEA..SBBDEBEBRCFFDCIB.hAAAeCGHCEDA.MCIBdFFDAAGAhABAbEAAOFHD..hCAAfEEAPHCA.gGGA.hCBAYHAA..hAEA...,1,-7,-10,3
XFRMPcdfIBJZgCEVOSWUbNTALGYQDKaeH,GAAAQAAAaADAHAFBRACA..MAFAdBHABCDAZBEEECHFSDBHhAAAUDAA.TDEAhACAADDBLDFBKEGAeHAAFEEBfEHAhAAAgGGA.OGBC.NIBBDGIBhADA......hBGA...,1,4,-4,8
JdTWRDHfOUMGNLFZVcQeAESBKbCXaYgIP,EAAAKAAACACB..aACD....IAEAdAEARAGBHCFBUAGAGDDAhAAALCCAZEBBQFGAhAGA.AAIBBCBDhBCAbDEAXECC.gFFB.TGDAhAAADEBBMIDAFGBH..hBEA...,1,0,-25,25
BGMQTWXSEdOAKHCaeYcVNbLDgIJfRPZUF,HAAAeAAA.VAEALAEADACA.JBCBRCCAZCGBBBHAGEEA.MDIBhAAATCFA..SGDDhAHAEDEBAAAAaDHD..NFAB.hAFAIHGA..fFGE.hAIAFGAA.WHEG..hAGA...,1,-6,-30,24
cfEYRIOXJgULaAHKWdMVTNFZDBQCPeSGb,HAAAdAAAMADATAEAZAEEBBHAQAGC.eCAAGCAB..hACAbCECECFBREAAOCHDhAAAXDGDgEFBhACAaEEBADIBKFFD.NIABCGHASGCB.fGHAhAIAYFFF.....hADA...,1,13,-12,25
fZJVYRQCWSgIacLNUdTHBEMGPDObFKeXA,ZAAAVAAARAEA..QCAACADB..SAEHaAHDLDDAdAGAHDCAhAAAEDHBGFABOBHDhAIAbFFBeDGB.AFFAfFDAhBGAYHAAIHHAcGGC....hABA......hACA...,1,-4,-13,9
XFOfLebDZRQCBHGESgJKPWNcdAVMaIYUT,aAAAUAAA.FADALADA.eAGHZAFBRCBAQCCAHCGBEECA.SBHHhAEAKAHB.PDFBhAFANEFA.ABBBMEHBhAIATGGAfFCA.DEIB....hBAA......hCAA...,1,-15,-25,10
GbMJXTeZYPFfaCKVWHdUBSIcLQENAODRg,RAAAGAAAMADA.JADA..eAFAZAGBFCDA..aBDDKDDDHCEBBDHASBGAhAAALEFB.EDCBhABAAAAB.DDGA..XGAAhACATEGAfGGE..CHGA..hCAA......hCCA...,1,-15,-34,19
WGEOYPUBHLRefdKCDXIJaSTZMgbAVQNFc,QAAAFAAAGACAEAEAOACC..UBGAHAFBRCEB.eAHBdEAADEEBhAEAXCDC.aDFEZFGBhAHAbEABAEHA...cECDhAAA..YGCALFFACGFB.SHFAhAEAMIAA.NIAB...hAFA...,1,1,-13,14
cEFbVYWdPJZTLGRANKHDaeCXMgBfUQSOI,HAAAeAAAMAEABADBQAFA.OAHFEAHFbBAA.VBEBhAAAdCADZCEAGDGAADDBDEEAaEBAhABAXEGAUGBASEEDhBEAFFAA..PFFB....hAAA......hACA...,2,-18,5,23
YQgCKAZbDRMOfXTcaGUIdLWeHPVBNFESJ,ZAAARAAAMADAOACA....TAGAGAFAdBEAeAHBHCCBBCCDhABAECGBSDHHhAAAQECAKDHDACCBDEFBXFEBhAIAaEGHIHHAPFBBNIAB.FGGA.....hABA......hAIA...,1,-4,-12,8
HPFfgMXbSdLTERJBcaUNDKeCYQIOVAWGZ,ZAAAHAAAFADAMACA.SAEAdAGAECAARCDA.BAHA.UCCAKCHBeECBhABAQCFA.OCHFhAAAAAIBGEFA.fEHEhACAbFCATGGAaFEBCHAA.....IGBAhBGA...hAHA...,2,-13,-13,0
eNRUZJbMfLEWODKYHSgCcIVTdPFBQAaGX,GAAAeAAARADAZAGBMADALCCAEAGA.DBIBHCDA.CBFD..ICHAhAAAdEAABEEAADCBaEBEXEGAhAAAUEFA..fGHAhACAKGCASGEB.gGGBhABA......hAEA...,1,-9,-24,15
UZEYVbXaFWITBeAOJcGDSRNdMgHLKQCfP,OAAAGAAARADAdAEAHAGBLAGBQCDBCBBD.UDGBECDB.VFEBhAAAaCHD...FEAHTDBAhAIAAADADGIB..MIAAfDFEhBAA.ZFFAYGAGbGBA..IHFAhBDABHGA...hACA...,2,-8,0,8
YZDMJIaFAOWHNEBePRGQTgXcLdVCbfKUS,HAAAEAAABACARADFGAFA.QCABTAEA.XDDAdAGAbCCB.hAAAKAHBUDGAZDGBMEIBhAAAaEAA.AFAAOFAEeEDHgFFGhAEALHAAfGFEDAIB..hACA......hADA...,1,10,-9,19
KBfeDUcFPRVgLaTEbSQOHZCYGJdNIXAMW,MAAABAAAeACADAEA.FAFDRAFALBBA..EAHBQCEDhAIAHCAAZCEAGEEAdCHAXDBAhBAAAACAfEHAhAAAUFEA....cGGA.....hAIA......hCAA...,1,-16,-23,7
EQDbYgNLdBVKHJUPXfRAIcZOTeaCFWGSM,ZAAAeAAAaACAFADD.GAFAEAFA..DAIB..bCCC....gBFAhABAdBHAKEEAHEGBhAAAPCCBRFAAAAFBOHAEhABA..TDGA.SEDAMIEA.hAHAQFAC.hAIALGFA.,2,-14,6,20
GWRbeHMLIYJCBfASVNKdZaOQFcXTPDgUE,SAAAKAAAZACB.QADAXAEADAHBEAFAGBGA.RCCBHDABhAAAMAIBLCABhAAAJEFBfFDAACEAdDEAaDGBhACAFGHB...TFGA.gFAAhAFA.WHEG...hABA...,1,-4,-16,12
QBEXgSWHILVbOFfNDaAJPKcdMUTeGCRYZ,KAAAdAAAMADAeACERAFFZAEE.BBHA..EBCF..SBDDhACAHCGBLDDBOCBDfECAhAAAaCGC.AAHAPFABhAFATDEAGEGA.QFCAhAIAXFEDgGGBhBIA...,2,-18,-12,6
NTgUEIWJSMdZAPbaKYVcGDeOHFCBXLfRQ,aAAAKAAA....VADAGACA.eAEAHAGBBAHALCAARCEATEAAhAEAEDEAJDHB.dFFAABBBbEEAhAFADEDB..FGAAfFCAhBAA.QGEANIABIHHAMCIBhCAA......hCFA...,1,-9,-17,8
cHNUYFJaLIMfQPVCWXedEBOKZRDgAGTbS,GAAATAAA.SADAHACBUAFAFAGAaBHDMBGB..QDEAhAAACCDAeCEHdCHAECABKDCDREAAAAEBhACA...bEGBcEAChAAAYHBALFFA.fHDBhACAWFHH.OHFADGGB..hADA...,2,-12,17,29
FWUBeONVAKLIaZcCJfEHYPDQXGgbTdMRS,LAAAZAAACADB.EAEAHAEBDAHB.GBGA.TCAARBFBFCAABCEDhABAeDDB.OCHDAAGA.aDCDhACAfFFA.hAEAQGBAbEECdGGAMIAASEHH.hAIA......hBIA...,2,-18,-7,11
RGDZAVdgNCFWPLUJTHKcQOYBbfaeMSEIX,dAAACAAAFACALADA.UCCAHAEBKAHBQAGABCFA.aBCHeCGHhACA..EDEBREABZFCBhAEAADGAVEGB..gFFAhAFAPGAA..TGEA....hAAA......hAGA...,2,-22,-22,0
RHdGMZDgKfbSWECQLFXJPBIeUOacANYTV,TAAAHAAAGADA.ZAFAKACCSCAAEAEALAHBXCFAhAAABBFAeCCBaDDHAACAVFEAhAGAREDFdFGAMECBDDIB..fGCAhAHACHBD........hAIA......hCAA...,2,-19,-2,17
CcSbIeLHWJKBZAPMXTYdgOFRaGNDVEUfQ,MAAATAAAdAEA.FAGARACFGAEA.DAGAEBBAUBGAQCFAhBAA.SCDDhBBAeCABHEDAKCHBAEABXFGAhAAAOEBBaEDEfGEACFGAbGFA.....hBEA......hBGA...,2,-17,-3,14
QgHdFLCfBYJIGREbWKDZUXPTaeONAMVcS,MAAASAAAHACCdAFALADABAHAJBBFRAGFECCA..KCGAZDEAUDDAhAHATEAA..eEGBhBAAAAAAQFCACEHB.hCAAfFFA.IGHA..hAEA......hAFA...,2,-29,-19,10
aODUHeLKCTJdFIWMSGcbBYXfAZRNQVgPE,RAAAQAAA..gADBEACADAFAHBDAeAFELBGBhAAAKBGDCCCA.dDDDFCHDMAIBGDEAhAAAbEFABFBA.fGDAhBFAADEBNIABaGGAOHFCTGGA....hCAA......hDAA...,2,-14,-3,11
ELHWURNYKPgZVMeXfIFOaCJABdGSbcTDQ,GAAASAAA..bADATADA.EAFEHBGB.RCDBKDCDZBFEeCCBhAAAfEAEODABhABAaAHFAAHAdDGAQEGBhAAALEEBUFDBNDIAgGGDXGGA...hACA......hADA...,2,3,3,0
MGbNQAYVFZRKgLHWCOPETfeDIacUXSdBJ,FAAARAAALADBHACBOAEAEAFA...eAHFaAHDUDFAdBEABDFAGFABhAAAQEGAACCA.hABAZGCAKDHBCEED.TGGAhAFADGGBIHHASHBA......hBHA......hCAA...,2,-15,-13,2
ZaLbJeUgDCHKPBfAVYFMNSOIEWRQdXTGc,FAAAMAAAOACD..EADARAEA.dAGAGCDAaBBBLBFDeAHHDCGBHCCBhAIABDHAABIB..VEGBhBAASEAAQGDAhCAATFFA.ZFAE.JHAE.CFHB.....hAEA......hAFA...,2,-14,-5,9
NXaJbIeHgVACScTOZWUQFdLRfGDEPKYBM,SAAATAAA.ZACBQACCdAFALAHBRAEFGAGAECEBKDGDMDDBhAAA.aDHDJEBAeEABhAEAHFFCAAIBOEEBFFBHDIEABHCAhAAAbGFA..........hABA......hBEA...,2,-14,9,23
dfGLKYaJCgTMZPINOEebSQBADRWFUVXHc,RAAAFAAAUADAHACB.dAEBGAGALAHBKCCD.aBED..CAFA..MDEBhAAAZCFBIEHA.hABAEFEBeDFB.bFGDQGGAhBAAAAIB.DHBAXGDA..hCAA......hDAA...,2,-27,-9,18
cAPSQBGeEUgbZdCfRaFXIMLNTWYOHVKJD,QAAAeAAAEADAUAGAZACBdAFA.RBGFFCEHMBFB.LCCB.hAAATDGAODHDHEDBhAAAKEBADEGBACEBBFFB.gGBBhABAbFBAaFFHIHAAYFHB...hAHA......hAIA...,2,-20,3,23
KSEGWLIUcgQBDAbPXdNCaVRZYTfJOHMFe,XAAAdAAAaADA.RADA.ZAFB....TBGAOAHDHCDCeBDBEDAAhAAAGCBALEEAIEFAhACAgEAADDHBAEIB.hBAAbGAACGGA.VGEA..fHBBMEIB.hABA......hADA...,1,7,-20,27
SONUPVWDBZdbfKLYEQXeHAICMGaFTcgRJ,MAAAaAAA.FADD..TADARAFA..OBBBUAFA..VCCBBCEAhAFAdBHAKCGAEDABeDDBHEFAhADAAEHAGGABJFDB.SFFAhAGAPHECDBBBbGFA......hAIA......hBAA...,2,-22,-3,19
SUgGFBeHYMVZcIKWNPEaAfXQRLCDdbTJO,QAAARAAALADBdAFAJACE.UDFAGAFABAHAHCDB.MAIBZFBAKDCDhAAA..PDHBhAAAACCA.CDCCTFBASCHBhABAeFFB...YHAAIGGA.EHAAhAHA......hBFA...,1,8,-31,39
BHTCVObKSIaQGPcZDEYJFMgeRdXfNUAWL,LAAAHAAATAEAOADDKAGC...aAFAGCABZBEB.EBHFFBHDeCFFhAAARCAAdEGAXDGAhACA.fEAAhADAACAACFFCbGCC.QECADEIB.MFGB...hABA......hACA...,2,-24,18,42
XgEbeadUVYPGSDRAfMBZFWHcLKCTIQNOJ,MAAAZAAAHAEALAEATCAAQBBA.OAHDXBGAhABAECEAeDEAdDDAVDGBGECAhAFARFDAAACAFEAHKEHBCFFAIHAAhAEAgGAB.aGHH......hAGA......hBAA...,2,-1,0,1
MYLeINXRJEOcPdQgKAUBVbHfWSTGCaDZF,BAAAHAAASACEGACAaAEA.ZAEB.MAHBeAGH..XCCBhAAAECABOBHDdDGDQEEChAIAABFBVEBB.bGBCTEEAhAAAFFHB.LEGBNICB.....hBGA......hBIA...,2,-9,0,9
gGJNWAFeYPDEXZKSHBbICUdRLaOcQfMTV,eAAADAAAEACAZADB.HAFABAEACBCA.RAFF.LCFA.OEEAQCCAhAHAMEIB.TDGAhAIA.GFDBWFFDAAAAFGHDhBAA.PHCCSGGB.IHAAhAHA.aHCA....hAIA...,2,-18,-14,4
AZVYadJIFOBTULDMPGcWNSQfbRKHgeXEC,ZAAAaAAA.dAEAFADABAGALAGBDAIB..GCAA..NAIAQBBBhBAARCFAHDDB.eBFFhCAAECCBAACAJDDB..TFGAhABAMECB...PHECSEGBKGADCEHB.IFFAhCEA.OFHDhDAA..,2,-19,-10,9
VZbFYaQCeSRWdIDPfGMgXAcBOEJNKLHUT,OAAAEAAAKACA.HADAUAEAZAGB.FBBH.QCEAeAHBRCCB.dEHADCHBhAAAGDCAMDGBAEFBBFAAhAFALFHBTGFA..hAGAVFDBaFFG...SGBB..hAIA......hBGA...,1,3,-22,25
YeLHATSOMZGaWEQPKgXfIcJUbBCNRFdDV,TAAAMAAAGACB.EAGEQACC.KAECfBBEhAFAJAGBBCDARDEBdCFADAIBeCHBhAIAHDGDADDAZEEAaFCA.gFDGhBAAXGGA.IHHA....hCAA......hCDA...,2,-14,-11,3
VKJBFIeERTDYgCHPbLQMGNSfdAUZcWXOa,ZAAAXAAAaACA.KADAFAFA...EBEFRAFFDAIB..CBHAHCFALCDBhAAAGEEASCGHhABAACCB.UDAAODDBhABABEHAeEHBTFEA.PHAAMIAAfHGBhAIAdGHA...hADA...,1,-6,-18,12
YSfHWAgJDNUGLQIXZPRBcaeMbdVFKTEOC,DAAAGAAALADAQADAZAGBRBBB.aAFE.eAHHdCFCKDHB..ECDBhAAACEAA.fCFAhACAHECAAAEA.gDGAhADAUGFA.XFFCBHHBMIBAbGAAFGHD...hBAA......hBBA...,2,-24,21,45
UDNOXSZIbYHWMKgBRaVJFQefcTCPGdAEL,EAAALAAADADA.XADDZADE..IAHAHAFAMCAB.BCCDhABARCBBaCGAFCGD.eDEBhACATDFAGFAB.AAHAODHDhAFAbDDBKEHBgFFGQGFACHHBdHDB.hCBA......hCIA...,2,-13,2,15
UcNBQYPCOSfDEIgLKaeMHdGJFAbVXRZWT,XAAARAAAZADBUAGABADA..QDAACAFA..fAHAhAAAEDEALDHBeCDAHEFDhAAAGDAAACCA.bDEATFCAhABANCIA.OHECDFFBKGDBaGBHdECA.FGGB.hADAWHAG....hABA...,2,-13,5,18
MHdePgIZJESbLOFVQGRfTUABKXWcNDYCa,XAAA..cAAADADA..aAEEHADAdAHA.eAFE.gCABhACAZBDAEDDAbDFALCFAhADA.FDDBQFFAhAAAREFATGCAACGAKHBANIEBCFED.IGHAhAIASHDE....hABA...,2,-25,12,37
GfXcHCRYNUaQLMBJEeTFPVKZOdgDWIAbS,GAAAXAAAHADARADA.UAGALAGBMCDBECEFeCDA.FDAAKDGAdEEAhAAADDABAAIB...bEFCfDHAhABA.CEADaFHDhADAQFAABGFA.TGDA...hAEA......hCAA...,1,-2,-16,14
NJaXELMUGWSRfOKZTcQHgPIdVAYbeCFDB,eAAADAAABACA..aADDEAEAMAFAGAGARBEF.KBBDZBGB..QCDAhAEAHDBAIFFAhAAAAAIBCDCD.FEHD.XGBAhABALDFB.SDHH.TGBAhBAA......hBGA...,1,-8,-31,23
CDSbINFfYRdUXOQWVBgAaHELJZKGcTPMe,HAAAEAAAZACBGADA.TAFAeAEASAHH.ICEAhAAAfBHA.RCAAdDFAhAAAOCBHQFAAhACABCGDADIBaEEALEHBKEHDMFABbFECFHFCXGGAhAFAWHAA.JHBA.CFFD..hADA...,1,8,-5,13
VKLgMJIeDEYFURBfGAbTONScXadPWZHCQ,TAAASAAA..aACAdADAZAEBHAFAQAGALCCAMBDBhAAAeCGFDCCBEDBB.FDHDRCFFGEGAhBIAAAAAbEED.OECEhCAAXFAC.CGGBKHAA......hAFA......hAHA...,1,-3,-4,1
aUdYEZVMTRgKQDJeAbGWOBHCNIcFLSfXP,GAAABAAAHACACADA...IAGALAFASAHHXCDAaCGAhAAAdCAAECCBZDFBMDABhACARCEAQECBeDCBAEEBOEHBhADAFDHDfFAA.PFFBVGAA.KHGAhAAADGIB.....hACA...,1,5,-7,12
aFBQNVbXHPdGMOeKfZRLTAUcYDWISJgCE,UAAADAAA..SABACADAFAFA.QAEA..bBEDHAGDhAEAGDAAeCCBZCGBREDFACEBhAIA.cFGA..hBAAICDAEGGBaCHD.BFFDXGEDdGCAMEIBhADA.fHGBhAIA...,2,-35,5,40
QeAHFdNSaWMXbgUDTJYZPKfCLVBOIREcG,HAAAdAAAaADAMACA...XAEAUAGATBDAZAGBKCCA.LCEBhAAAOCAERDEAEDHFGGBBhACAABIBSEGD.hBAAWFHHbFGBDGGB........hBCA......hBDA...,1,-9,-17,8
UDMJQEVBdHRaCKbXFcGIeSNZTPfgYLOAW,DAAAMAAAEACAdAEA.HAGBRAEA.KBBAFBBH.GCEBeDBAZDFA..TDCAhAFA..fEEEhAGALEFAAAHAUGBAhAIAQGGAaFHHXGFDSHCA..hBAA......hBIA...,2,-23,-7,16
CZHfXgNWdEJPQISKLMUaGBODTFYcVRAeb,eAAAZAAAHAEA.XBGANAEA..EAFAQCAAKAHBLCCBhAAAaCDDGDFADCGBFCHH.VFDBhABAADBACEFD...fEAEhACAdFAAIFHAMFIBOFCEcGACgGGGhABA...hADA...,2,-16,-1,15
DLVFaJTRAUXEQGSfecNHZMgOICdPWBYKb,EAAAGAAA.eADAHACAZAGBMAEAOCDAdBGABCCDKDDALEGBhAAAaCEBRDEFAAIB.QEABhACA.fFFAhADAgEGACGBA.PGCC.YHEGDBIB..hAAA......hCAA...,2,-18,0,18
TRNYcKDFWEILOHaBZMfdbUSQGACgJVeXP,CAAAVAAA..eACA..TAEARAFA..NCAA.KAGCFCCAEBHFLCFAhAAAHCDAZDAA.dEFASEEAhACAADIBXGCAPEHBhADADFHB..WFHHaGADMHCA...hAAA......hADA...,2,-19,-15,4
EcMIYHTKbXOGNBCWJgARZUFLaDdPSefVQ,RAAAZAAALADBdAEAeAGBQAFA.ECFBMAIB.HCAAbDCC.hAAAGCFABAHACCHAgEBAhABAACCA.aEDDSEFAhABAfEHAIFAAKGHBOFFHJFHBDGGBhAFAPHAA...hCAA...,2,-17,9,26
fIGSbJOdCHEXLKZNFeVQDYgcaWPUMABTR,RAAAGAAA.SADAbADB.dAGAHAFAECDALDCAZCCFeCFAQEEChAAADAIB.hAAAgGEAaDAHPDGBhACAAAHAfDHAOEHDKGBAFHDEYFCF.hADA......hAEA...,1,5,-5,10
ODeFQUGfWVaMTKZJXdPYHbNcgABCLRIES,LAAAEAAADADA.eADHQAFAGAFAVCABMAIB..ZBCAdBHAHDBAhAAA..bDEDgDFAhBDAAAFBRGFAOEDBfEHAhBEAaEHFKHAA.XGDA.YHBAhBHA.BGGD..hCAA...,1,6,-11,17
OfXZTCWEcMYDRFebaIVJUPSGLBKdgHNQA,XAAAZAAACADB..EAFAMADA..RBFAeCABaAFE..JBDBSCCAhABAGCEALCGBhAAAdDFDHFACAAIBTGDAhABA..cEECFDBBIGGAPEHDBHHDhACANCIA......hAFA...,1,-5,-18,13
LVZGeJSQMBcgRdCTDYNUHEWPaXAKFfbOI,FAAAOAAALADAGADAeAGHQAFABCCARCEB.dBHA.DBBBUEAAhAEAHDBBECHFaDED.ADDBKDGDhAFA..bECDZFGBMEIBhAFA.CFGA.NIAB...XGFC...hAIA......hBAA...,2,-10,-5,5
gUFKSaeJMRGbQCYIBNTXcVEZODLPdWHAf,UAAASAAAeADARAGBGACA..QCDACAEABAGA.TDAAhADAXBGA.ECEFZDFFhAEALDGBdFHAHGCAAAAAFEAAhAEAaHEE.bFEB.IGAA...NEIA.hAGA......hAIA...,1,-2,-18,16
BSQdYfAcPUZOVLWGgDKIaCHbeJFXTEMRN,UAAAZAAALADBGADAKAFAaAFA.HCFA.eDAAXBFC.ECAAhABAREFASAHBhADAdDGA.AFAAOFAEgEEDhACACFEDFGHBMAIBBHCAQGBA.fFHAhBGA.cGEChCAA.,1,-4,-22,18
cBeJVTaPOZfWMDKXIgSLUNRCHdEGAbFQY,QAAABAAAeACA.JACEaAFD..ZAFBMAHBKAHB....XCDBhAAASCAALDHBhBFARDCAHEFAEEFAAACAbFBAFFEH.hCAA....YHEGcGGC....hAAA......hAIA...,1,-15,-26,11
FZPKELMdGBNVXgCODTSUAJaQfbHReIWYc,aAAAQAAAHACBRAEA.eACA...IAGA..cBGDhAEAZBFAECDBdDEAGDAAhAAABDHAXEGCODEDTDGAhADAAAHAbFAAFGHBLECBMBBB.gGFAhAIADFAA.SGDHhBIA..,2,-17,18,35
ILRAMKSDECgUeHcQfXTNWPaYZFGBbdJVO,MAAADAAAEACAUAEA.HAGDQAEA..TBBA.PDBBhAIAZAGBGCCA.hBAAdEFAOCHDRGBEABBBCFHAeHEAhBAAXDDA.aDGH.BGGA....hBBA......hBDA...,2,-19,-17,2
LWZTgYXJNeGPHAVQSBfMUEOaKCIFbcdDR,QAAABAAAMACAUAGAEACA..KAEAFBCAdAGALBFDZCDA..hAAATECA.XEEDhAAAeCCBHDGBAAIBfCHAhCAAaEDDbGDA.RGFA........hBIA......hCAA...,1,-8,-24,16
VFSRZWAgJTaQdbPeHLKYEUIDMXNOfGCcB,TAAAdAAAeADA.HAGBLACBECBA.DAEAMCEBOAFEGDFABBEDhAAASDADRCEAACHA.hAIAaEHDbEEAKFCA.IHEAhACAfGEACGBD.FGGH......hCAA......hCCA...,2,-23,0,23
gZHeDKaIEbOVYXGPTcWNLAFSMfQRJdUBC,MAAARAAAdADABAFAZABEHAEB.KAGAEAHB..OCCB..XCCChAAAGCGATEDAhAGA..cCFALGDAhAIAADFBSDHH.QEEBhABACHHADICA.bFAA.YHCGhAFA..,1,-14,-20,6
AQaJgKGYTbfOVdPXBeDWZUHSMCEcNIFLR,aAAAKAAAGACA..bACDOAEA.dBEABAEAeAHFZAFBHCABhAAAMAIBEDFF..IEAAhAEAREGBACABQGCAhACAJDGBTECA...fFEA.PFHDhBAADCIBSGGDhCGACBBDFHBA..,2,-26,5,31
PXDJKaOBbHLMSYdFUAGWVEfTZgRCQINec,GAAAEAAAZACB.RADAQAGCeAEA..XBFAKCDDBCFDHDEAhAAAMCIBdCBCAAAB.VECBTEEAhACACEHA...IGGAhADAPFABaFGCLHFA.FEAH...hAFA......hAIA...,2,-7,-7,0
ZCTYcObdPgANIESURMDFBQafeHLKXJVGW,EAAARAAAMADABACA..QAGAeADHHAFALBEBXCEDGDCAhAAAZCGBCEDD.TEGA.hAAAOFFBdFAAACCBSEHHhAFAFGHDaCCAKCGD.VGDA......hAHA......hAIA...,2,-11,2,13
JcBdXaQKWTPIbEDVUNYRSgFfMZCLHeAOG,GAAABAAAaACAQADA.KAFATAFA..bCDAEBCBDAIBhAAAUCFBRDGFFDCHZDBAHEEBhACAAAHAODHDdHAB.XFAAhAAAIHHA.YDAFfFFAMIDACGHD.hAFA......hBDA...,1,14,-31,45
YMRdAJZOeCaEPUIbGfQHKWNTFgVLSXDBc,ZAAAeAAAEADEUAEAGAFAHAGDKAHB..TCCAFCAALDDB.hAAADDFBBDBD.MCIBhABAADHACECA.aDFB.IEGAhAIAbFAD.QGGA.NEEA.SEHBhABA.XFGDhACA..,1,-14,-16,2
GJADOfCIBaYQeNPXEKSRVZMgWdcTbHULF,OAAACAAABACA...aADDeADH..XAFAEAFARBFA.ZCCAMCABhAAAdCGD....bDBCHDEAhACALEGBGFABAAFAfFCAhAIAQFGAKGFDSFFF.hAFA......hAIA...,1,-14,-17,3
LTIfGPAJZNaERXcMgBKeDbQOdFHCYUWSV,ZAAAEAAARACAMACA.KAFAeAFE.DBGBQCCBdCCDHCEB.CAHBUCFAhABASCHBLDHBTDAAhAAAGEBA.AEBBaEEChBEAXDGDBGGD.FGGA..WHFA...hADA......hAIA...,1,-8,-14,6
aCYeGPKRQUVgZMTLADSHWOdEcJbNBXfIF,HAAAdAAAEADAJADABAFA..XAGBFAHB.CCAD.eCAAGCCARCEAQECAhACAUCGBZEFAMFCBhAAAACEADCIB...OFDDhACAbEFD.IGGA..aEHH...hBIA......hCCA...,1,-10,-20,10
bCKATSMDGHNdaLfOJEUFXRYQIZPgecBWV,MAAAHAAAaACALAEAOAEDEBBA..XAGARCDAQCGC.hAAAZECAeCCBBEHAbCFDAAFATGFAhAIAGEDAdGAA.hBAAfCHE.FFHD.....hBBA......hBIA...,2,-18,10,28
BPbLJIQOVHFUYAZSTaDXgEGedNCRcfWKM,ZAAAaAAA.DACA..EADAeAEAdAGA.RBFA.....fBBEhADAMCCBBDDALBFDQDFBhABAHDCBFEHDAAIBTEGAhBAAXFACGGDB.CCHA.KFFD....hAFA......hAIA...,2,-28,-4,24
SUMYHeARgbaWZDFBEILKcOXfNTGQVdPJC,RAAAaAAAZADBBADALAGB.KBFDXAED..TDAAGBGAhADAdEEACAGCMBBBHGBAAAAAbCCChAIAFFHB.EGFF..OEEBhBAANAIA.QFGB....hBIA......hCAA...,1,-9,-19,10
XfHeGOcKIaEJCdYQNAgLbRSDBPUWFMVZT,LAAARAAABADBUAFAMAEA.ZAFE...TCAAHCCAeBHH.hABAGDFAKCCCECFAdECDQDGAhACAAAAASEHHhAIADDEBFEBDXFBCOFECaHBECGHANICB....hBEA......hCAA...,1,-9,-10,1
adYPLJQFTXcWDIOKSbCGAUMZfgRENVHeB,ZAAARAAAEADEHAEA.eAHHdAFALAHBQCAAFCCA..TCDAhABAXDEADACAKDFA.bEFAhAGAAAAAMEHB.fFDAhBHAgGCABFFDaGGB...YHCGhCAA.....hAHA...,1,-3,-17,14
cHAZKVdICfgGMbBUXEPRFeWLNSQYOJDaT,ZAAAdAAACADAGAEABAFA.EAGA..RAGF.eBHFLCCAQCAA.hACAODDBaCHDHDAAAACAKEADhABAVEEA..fEFAhAEAMFAB.bGDAXGDCFGADNDIA.SGHBhADA.DIFA.hAGA...,1,-2,-15,13
OTcZWKGXDRCJELPMFaAIegdSHbNfVYBQU,eAAAdAAAHADA..bADAfAGB.BCBAQCCAhAAAOCECZDAAGBGAREEAEFAAMCFBhABAACGA.SAHBhAEA.VFAATGGAKFGDCGEA.....hACA......hADA...,1,0,-17,17
VdGbISZPRHENBJYeOUfQFTgcMADLXWKCa,LAAAKAAACACB.dAEAGADASAGARAFAHCFCECAABCCD..eCDBhABAOEFBQCFAhACAFEHD.TEBAMFAAAGAAhAAAXEGAaGAE.bFEDIHHAZGAA.NIAB.hAFA......hAGA...,1,9,-21,30
KJCNPSZfRBLTHOXaIedADWbEFQVGMUYgc,DAAAEAAAFACDGABB.MAEAUAEA......gAGAhBAAKAGACCGASCHHRCCALDGBhCAAHDDAaEEAeEBBACIBbFCAhCBAQFDB.cGFBNEIA...hCCA......hCFA...,1,-11,-21,10
CTWJZSPUMHgALVEGbfaFXRDIcKdBYQOeN,EAAAGAAA.aADARACADAFAKAGA.dBGABCDA..QCCBeCEHTCGAhAAAZCEBSCHHhAAA.MDABHDBBAAIBLFGBhADAbFFAXGACIGEAOHFC.CEGD.hACA......hAGA...,2,-13,-9,4
HORIYLegfAFcSEXNJZQbUVCMdWKTaBPDG,SAAAEAAA..XACAZACBQAEAVAFA.dAHATCCAhAAAaCECDDHBHCEBREEBLGBAhAAAeCHFADAAFFAA.cFGChADANDIA...bGDCCHGA.MIEA...hABA......hBGA...,2,-17,10,27
ZfDAPKJFOdXLTMQNCgbWUHIcReSBVYEaG,KAAAOAAAdACALAEA..MAEAQCDACAHA..bBBAhBAAHCFARBFBBCHBEEGAZFAAhAAAADBAFDDHTGGA.WFFDhAFAIEHA.eFBBSAHHaFDEDGGA.hBBA......hBDA...,1,-4,-30,26
SGPYJXaQONMfdRIgWVHCFUcETeZKBAbLD,LAAAGAAAJADAaADD..QAGCMAFARBEF....gBGBhABAHCDAFCHDEDCBeCABhACAZEFAACCBDDDBSFCAhAAAXDGCfGEAdFFDIHHACGGA...hACA......hAIA...,1,-9,-11,2
FKNgIdVLUJXAGSEQceYfCbBRDZTPMWaOH,EAAAeAAA.CADA.RACAZAFB..MAFAaAHDHCDBKBEA....gBGBhAAAdDAALDHBXCCChABAACCBGFAB.QFFAhAAAfDEABHBDTEGAOHECFFFHIGDAhBIA..hCAA...,1,7,-34,41
MdHAaBKLeJVYgTEGcDfFPORXCUSNWQbIZ,aAAALAAA.eADHVADA..TAFAEAGEGCCADAIBFCAARCFACBBDSCEHhABA.QCGDhACAZDABHEFCADABKEDDhAFAgFEGfEGAXGCCWFFDMHAAhAHABHHA.....hDAA...,1,2,-15,17
DZLOWNfFYXKHEBJPaRACSGUTdQVbMIcge,GAAAdAAAQADAMADA....gAFAeAFAZABBLCGBhAGAOAHD.fDCAhBAAXCDCHDBBEDFFBEDAhBIAaDGBAAABSEHHTFEAIEHADGGB.hCDAFGHB.....hCIA...,1,2,-13,15
EFNMRIQTVBKdJbPegGYASXaOZLUCcWfHD,aAAAZAAALADB.CAFA.fADAHAGBECAA.MAFARCEF.TBEAhADAKDHBdFAA..bBGBeEFHhABAGDDAAAIBOHFChACAcBBC.FFGA.IHHA....hBAA......hCAA...,2,-18,-8,10
AGMWVOFYIdNSUQPBagTRebJLKDCfEXZHc,GAAAMAAA.OADAFADDdAFAUBGABAHA..aCDARBBB..eCFALDDBhAAACDED.EEBAHEFAhAHAAAHAVFFA..IFBAhBAASGCD..PHEA...hACA......hBAA...,1,-18,-25,7
XJLEWRAgeTfCQDIcGaMZYUSKOFdPNbBVH,eAAATAAAQADA.DAGAGACAZBFBUDCAOAEA.dBEAhAAAbCGDHBGB.LEEBhACARFDAAAAACFBD.aEGCMBIBhBFAKGCBFGGABGHA.........hAIA......hBIA...,2,-12,-8,4
ZeYaJMVcOfBXRFgLIAQTDGEbWUdSPHKNC,TAAAEAAAUADA..dACAHAFACAEA.eBCDaAFD.MCHB..OAHBhAAAXEDARCDBLDFBhAEAAAHAGGEBSCHHhAIAKDBDNCIA.JFHB.........hAAA......hBDA...,2,-17,-12,5
cOLRZMBYdaUCQgSfPTIKHDVbJFXENAWGe,eAAALAAARADAZAGBMAEABCCAdBEA..CCEA.QBGA.SCAAhABATEAAHEEAhAAAbDCD.XDGAACAA.hACAGGABOEEAaGGAfEHA.KFFDhAIA.DGBB.FGHD.NICB.hBGA...,2,-11,-11,0
WIaFHKNRGOLDEeSUPcVJYTZBXMgbCfQdA,aAAAHAAA.RADFGAFALADAEAHBeAGH.SBBDPCABVEEBhAAATDCA.ZDGBMCCBhACAbEAD.QFADhADA.ADDBFDHBOCCADFDB.cFDBBGHACHGDfGEAhAEA.IHHAhAFANIAB,2,-21,9,30
FHUbNdTSXGCagIEKLOPVDZefcMRQWJBAY,HAAAUAAAdADATAEAGAFACAGB...aAHFEBHF.LCAA.hAFAOCEBDDBAeDEBMCGBhAAARDGFQFBAhBAABDHAAEAAbEAAXFEDKFDB.......hBCA......hBDA...,1,-2,-21,19
RBdgEIMUHJXKPYfSDAZNQaLVOFTebCWGc,ZAAAaAAALADAFADA..eAFHCAHAGCCARBGFdCAA.EBBBMCCB.HDDAhABAKCFA...fEHAhACAAAEAQEFATGFAhAHAcFECBFFCIHAA.JHCA..hAHA......hBAA...,1,-9,-22,13
DRVegTPJbNWdXfYZCGSBOMLcUHAKFIEQa,FAAAEAAADADARACF..eAEE..TAFA.JBCAbBED..dAHAXBGAhAHAZCCAGDFAODGDhAIAMDIBLECBhBAA.UGGBADHBKHGAaGDD.......hAAA......hCAA...,1,-8,-26,18
XEFBUGNKCHRWcTIADVPQafLgMYZObdeJS,DAAAQAAALADAMADAZAGBdBBA..eAFASCEBEBDBBBHAhAAAGDCACCFAHDFCREAB.TEBAhBCAAAEA.aEECfEGAhBAAOFHD.bGEA.......hBEA......hCAA...,2,-16,-10,6
TaXDQLfPIKgbWEUSMRZeHNcdVJFBCOYGA,aAAAQAAALADA..IADAKAHB..bBBCEAFA.MAIBhAAARCDAHCGBdCDAFBGDOEAAhAEAACFBTEFAfEFEhAFAgFAASFHHeEHHcFECBGCACHAA..hAFA......hBCA...,1,0,-14,14
YDPIbKOBZCRUQSWgENaJMHdcLeFXATVGf,GAAADAAA..IADAbADA..BAHARAEFUAGAQCDAhAAA.SCFAhACAEBBBaDCDHDGBdEADeCHHADGBTFEAhBAAfEFA.KFHBCEECNIBBMHAAFGHD..hADA......hAEA...,1,-10,-16,6
EgQGUWNLIdTYOZKefVSaMHXFbJBCcADRP,RAAAEAAAGADAUADALAGBdAFB..TCFAZCBAeCHH.SDEHhAAAHDAAbEFACBHAAAIBDEGBhBCAQGBA.IGGAhAAAKFBAaFHDXGCABCCDPFEB..hABA......hADA...,1,-3,-15,12
IfOXceLKUgERQBZVNJDWSHAbdPTGCYMFa,dAAAGAAAMADAaADA..OAFEeAFHLAHBKBDA.ECDBRCAAZCEEhACAVDFBDCIBHDBBAEFA.PFHDhAAACEGA..FFFHfHBBhACAUGCABHGA.......hBAA......hBCA...,2,-29,3,32
MEFOTXJLGbgfdBCPDRYeZAQKHUVacIWNS,HAAAaAAA...IAEASACHFAGAOBEETAEA..LAGBhAEAGCAB..bCFAdDDAhAIACEEA.REGBeBBDAACA.QFEDhBAAKEGAVGEA.cGCC.MBIB.hAAA......hCAA...,2,-15,1,16
IaHOUWbKYPFBELTJGNCZDAgdcMeRXQfSV,dAAAeAAARADA.QADA..SAGBaAFEHCCAOAHDhAAAbABDKCEAFCHDECGBLEEBhABA.TGAAGEAAhADACEGDAEIBMEEBfGGAIFFA.YFHBhAEA.BGCA..hAIA...,2,-22,12,34
PIVTXLKFgOGBZeYQWRSUNacJfECbDdHAM,MAAAVAAA.LAEA.FBBAGADAZBFE.eAFAQDDChAFARCFASDAAaDGA.fEFEhAAAEEGBDECBHGAAAAFATGCAhADAKFFDBGHA.WHEGcFGD.CHEA..hAGA......hAIA...,2,-9,-8,1
gPBXEAONJDbfaWdMTSCGcYULFKQZeHIRV,OAAADAAA..aABEdAEA.MAGBCAEAGAFAUBBBLAHBKAHB.hAEAeDEBHCCA.RDGFPECBhAHAEEBAABHB..bEFDTFEAhBAA..SEHBFGHD.ZFDF.hCAA......hCBA...,1,-9,-17,8
UOHLEMYZWVQfKDGNIRABXJeCgbFcadSTP,XAAAeAAACADA.FADAdAFA...SAHBTAGA.OBGDhAAAHBCBECEEZCCAQECAhABADCIBGDGAREEBADIBBEFAhBFAbGAAaGEHLFHB.......hAAA......hABA...,1,-6,-14,8
bJFPWNaQIVMgcUHCXeELARYZSBODTdGKf,RAAAZAAAOADAdAEAGAGA.KCAAJAGB.FBDD....PDDAhABAaBHD.QEBAhACAMCCBUEEAHEFA.eGAGhADAAAAABEHAfGHA.NIAB.gFCFhAIA.XGFAhCAA...,2,-37,5,42
PKWLEUMbGBQZfHAVOYTJCNFSIRcadeDgX,OAAATAAA..CACB.SADA.RAFFdAHAeADH.XAFAhAAAKBBDECDB.bCEDGDEAhAEAZDGBHFAAADHAJECBFGDDaEGADAIBhAFA.WCCDUGGAMFIB......hAGA......hCAA...,2,-10,-5,5
gaKJDVNUGPbRfHLdYBCMZOIEATXeSWQFc,eAAAQAAAFADD.aACEDAFA.UBFAGAEA.RAGBHDAAdCHACCCDZEDAhAAAECDBAAIB...TEFAhAAASFCD..hABAgGAAKFHBJHFA.PFHD.bGDC.hAIA......hBIA...,2,-33,16,49
BRgAEOGMWPJTDKVbNFQHaUdZeLYcfXSIC,EAAAGAAA.MADAJACBKAEA..VAGBFAGAHCEAdCDAeBFDLCHBhAAA..fDHAhAAASDDDBEBAAEAAOECHhAEATFEADEGBNIABaGHB..YFFFhCAA.IHHA.hACA...,2,-16,-14,2
aAKIdEeFQXYOCPJfBHGZDcbRTgSVMWULN,dAAAEAAAFACDQADA.OAFCCAEA..fAGAHCACZCFBbDGDhACARCDA..SAHHhAAAMCIBLDEDADHAeEAAhAEAPHAAGEFA.TGAA.WEHB.hADAaFEBIHHA.hAGA...,1,7,-20,27
RNGIZKADSFHYTdOgXBeWcUfbaCMLPEVQJ,FAAAHAAAdADAXADBBAFA.eAFAUCFAaBGELAHB..ECABhAAAQDBARCCBGDGAZFCAhACAADEA.SGABhAGAOEEB.WCEH..bFACMIDAVFGB.IHBAhAFA.DGFB.hCCA...,2,-18,9,27
RJVgIQcFdbLXWCONfTGAaYHBSUeMEKZDP,HAAASAAAeACEEAFEZACBRAEA..JBHB..ICGAQCCAhAAAdDEALECBCCEAOCFDTFGAhAHAAAAAaAHFBEGAMFFBhAIADDIB...gFAA.bGEA.hCAA......hCCA...,1,-10,-14,4
SMQUeNOfcJZKXWDITbLFaVdHRGPBYgCAE,EAAAMAAAUADA..eACAOAFCJAFBZAGBKCBA...DBBB..bCEAhAAAaCCA.HEEAREEAGGCBhAHABDDDCDHAABCA..QGGChAIAfFHA.XGEA...hCAA......hCBA...,1,-16,-23,7
SKAaCcYTbgPINWUZQfMJHOEFVLDRGdeBX,aAAACAAA....TACA..bACD.IAEAUAEAZAGBMAGBhAHAHCAAFAHDLDEBhAAA.RGBAeFHBSCEBhBAAABIB.gDGAPHEC.QGGAhBBA.OEEBDDIB.hACAdHDD..,1,-4,-13,9
bZLAYFJNDeWETPMQHCBIOgaGUScXVKdfR,FAAADAAAEACAMADA.HAFCBAEA..OBCCGAFAUCGBSAHBhBAA..XDDAhAIAdCCARDGFZECEADDANEBAeFHHTEGAhBAACHBAaBBH..KGGD.......hBHA......hCAA...,1,-13,-18,5
OLWARHJcGMbIKfTBSgZQCaXYeENFdPVUD,HAAAGAAAMACAKADABAFBZAEEQCCC.aAHDeAGH.ECDAhAAAdCFAUDFBLDHBhAAARGFAJDCF.bEEC.TGAAhAGASDADXGGCNAIA.......hACA......hADA...,1,17,-25,42
GdOeZTUKWLQYaBgNCHDRFbESXJIPAVcfM,VAAAMAAAdAEA.ZAFBKADCLBBB..aAFDBAHACAHAHCDARCGFEDDBhBAASCGH.hBDAXEFCIFFAACIB.hAAAfFHAeDCBTGGA...WFBBhAHA......hBFA...,2,-25,-25,0
eBJROVQdacXSNEGCDKHMgfWAIFUYPZTbL,FAAAUAAAZACBLADABAEA.RAGF.QAGAdCDA..aCFHSCEAhAGAEDHFGEAAKDGAHFFAhAEAMECA..fGDAhAFAAFCAIFFA.PFHB....hBAA......hBIA...,2,-38,-6,32
ZNFMPcgIYUDXCeSATfHKJVRbaBWOGdLQE,HAAAKAAARACFBAEBGADA.dAFBLAGBEBGBZCAAMAIB..PCABhAAAIDFA.DEHBeBFFhACAAEIB.JDHBaFFBQECAhAIAFGGH...gFFD.hAAA......hACA...,1,-11,-22,11
MPHSNTWRYQOJDFEcZdgKLUVCaABIGXbef,GAAAeAAAMAEAHADA.TBGARBCA.QCDBDAIBEBFEdDBALEFAhAAACDEABDGA.bFAASDHHhAAANGEB.OEDBhABAFHAA.ZFFAKHEAaGDDAAFAIHHA..hACA......hADA...,1,7,-14,21
WQAegVGTPZNHdJYfRcFOBSXIKDLaECbUM,eAAAGAAAZADBHADAdAGA.JAHBRCEF.FCDHBBCA..XCFDDAIBEDGA.hAAACEHA..UFAAMEIBAAAB.hACA..TFBA.hADA.PFCCfFGASFFB.KHGAhAFAaGFHWHAA...hABA...,2,-28,-6,22
TbJYMROFWAfZPEKDeCLdHIQNBcUSXVgaG,ZAAAEAAADADAeACE.dAFAHAEC.QBCCBAHASCCA.hAAA.XCEDaCFEGEEAhABAbCGDMAIBFDHDAEEBKGHBhAHALGDA.IHAA.cEDChAHA......hCAA...,2,-23,-14,9
ReZbgJKFPSBAfOXVMdNGYEULITacQWHCD,XAAAdAAAGADAUADALAFA.aCAEQAFAHCFA.RDBAeBHHhAAAbDAA.KDFBSEFAhACAADBAOEHDMFDBhABAEFEBTGAACFFD.DEIBJHFABGGA.fHCFhADA....hAGA...,2,-9,-2,7
EVRQWJKHITYCDZbMAaLFSNPGdfOBeXUgc,aAAALAAA.SADHGACAdAEBBAFAeAGHUCAAECEFRDFAQBGAhABAKFBAHFFC.TDDAhACADAIBMBBB.AHIB.FDGHhAFANIDB.OEHD.XFCC.cFFChAHA.....hBAA...,2,-9,-9,0
JAMLdFOIHXgBCcbeaNTRUEQSDfGWYKZVP,dAAAOAAAHADABADACAGB..eAHHaAEDRAGBECBA..DBBBGCEA.hAGAKDADZCCAJDHBAAIBMCGBhBAALDDDFDHD...XFAAhACA.bGDATGGA.SEEDhCAA....hCDA...,1,2,-35,37
GMaROYfVUFgNZQBWJLEAdKTbICDePSXcH,dAAATAAACADA..eAEHSACBHAGBGCBARAEA..OAHDhAAAfDFAFCCHZDFAQEGAhACABCGDLEABhAEAAAGBbFDCDDABXECA.aFFA.UGGBNIAB.WHAAhAFA.....hADA...,2,-12,5,17
cbWQgRAKGFeIfMZJNCHDYLOXdVaUTEPSB,GAAAeAAAMAEAZADACAGBHBCALCDBdBFAaAHDUCFB..EDEBBEADhAAA..bDGDQEGBhACAAAAAFEBAJHBA.DAIBXGFChBEAPFFB..SFAA...hBHA......hCAA...,2,-16,-4,12
DMQcfGdBTESFgWPVbeUIKXaRLAYHOJCZN,HAAACAAAZACA.MACA.QAFAGAGAdCCAEBDFFDAB....gCFGhAAAPDFBeDHHhAAAKAHBREDALGAAACCBODHDhCAADEEBBGGA..SGGA..hADA......hAEA...,1,-2,-25,23
MBXLVNGcPYJHZQSFCdIDKAgeafUETOWbR,eAAAaAAA.EADAOACDRAFA.BAEALCCAGAFA..PCGDhAAAHCDBZDGBQECAhABACAHAdEAAKFDDACIBfEFEhAGA.WEHHbGFAMICANIAB.....hAIA......hCAA...,1,-8,-10,2
TNBZbJCAVdeOUYMQWSLXfDgGaHIFEPRKc,eAAAOAAAMAEA..QADALBDADAIBaAFEHCCAECCBRCFAKEBAhAAATCGAZEDB..CFFAABEAdEEAhAGA.UGGA.SGCBhAIAfFHA.IHBA.FHEENBBABEHAhBAA....hBIA...,2,-10,-10,0
gFZXaYRWPUSefONEAbGLJTBIKDMdCQHVc,GAAATAAA.KADAdACAHAFB..VAEAFAHFaCDBRCDB..UDFAeDADhAAAOAHDADFBLDHBhACABEAAMEIBQEDDhADA.ZGEAXGGD.PHAA.fHEFhAAA..hAEA...,1,2,-19,21
cYOQAaPeSDgZENfUdXGKHWJLbCVFTIMBR,eAAADAAAEACAUAEA.GBCAHAEALAHB.CBBDFCDBMAHBRCFB.hAGAOCHDAEEA.aDGHSEHHhBAAZEBFdEEAKGGAJFFFhCAA............hCHA......hDAA...,1,-19,-23,4
gKERNGedACSaFVOcBJHWTbfLYQDUIXMZP,aAAAOAAABADAHADA...TBGALAFAQCCCDBBBXCCAhADAZDFAKEEDRCFAeEFAhAGAAAFAFFCBVFGB..cFCAhAHAWHAA...fFHA..hBAA......hCAA...,2,-34,-2,32
McZYaJgCIdNRTUeVXAbHfPFOLGEQWBKDS,HAAAFAAAGACAEADEQAFCKAEA.MAIBZAGBaCED..CCADdCCAhAAAREAAeCHHACHB..bCDDOEFDhAEALEGBDFIBSGAAhAGAcFED..YHAAgGCHhBAANEIA......hBIA...,1,8,-17,25
BdbaANKLPTScEeGIQZHMXfUWYgDVFORCJ,LAAATAAA.EAEAeACEGAGAZAFBHCCBMCAA.UEFA..gCDAhABAFAHDRFAABDBCaDFDhACAADHAKEHBSDHHhAEA.QGBA.fFEEhAIA.DGGACHHA....hBGA...,1,-10,-14,4
KAXDaUcTYHLSEQVJRfWGBFeCOMIZNbgdP,aAAATAAAHACB.EAEAQACC.RAEFGAGAeAGFMAIBZDDA.hAAAbCEDdEAAABBB.DDIBUEAAhAEALGDASCHDhBAAfHGFFFGDOEDHgGAAXGED.hAEA......hAGA...,1,13,-5,18
VAEbROFaCTMHYGDQXKNIZWgfJcUeLPdBS,RAAAaAAAMADAHACB.GAEBQAGAKCEAZCGB....fBDAhAAAUEAAeEEBdCFASBBDhAEAEDHBbEDC.CGGADDIBhAFAXFBDIHAAgGGA...hAHA......hAIA...,1,-4,-9,5
cELDAaPRWeQKYSCIgUVJNFbMfdGHTZOXB,RAAAeAAAQADCKADA..CAFBUCCAJAFAFCCH..MAHBGCFAHCFBhAAAZFCABEHAECHBAAAAaFCA.hAIA....PFFBhABASGHB..IHHANICB..hAIA......hBIA...,1,-14,-31,17
dJSKFGcbeaDZWUYEMBATLgHfCPIVQXRNO,TAAAHAAACADB....IAFAQACCRAGF.dAEAKCADGAGAhAAAeCCAZDCEUDDA.EEGBACCALEGBhAAAfGAAXGDAhACAOFHDFGDA.aGBDDCIBMIDABFFB.hAGA......hAIA...,1,0,-10,10
cFIebGKXDCELMAVgHQYTfRdUWSNZOaBPJ,HAAATAAARADFdAFA.UCABSACBZAGBBDDDJAEA..FDFHeAHHhAAAGEGADBEBECCB.ACFAQDFChAHA.hAAAfEHANBIA.aEEB.IHHAhCAA......hDAA...,2,-21,-21,0
VCMHBOfLYXKadGSEcAPNUgFJQIWbZDTRe,UAAAFAAAQADA..bADAZAFBRBGF.eAHFMCDBHCCB.fDAAhADALCEBKDAAhADAGEFAEEGBAAHA.PFABhAEAgFBB.IEHADDIBCGGD.OFEHhBAA.....hAFA...,2,-22,9,31
RGXdABJMeHDYcWKFOLgPQEfNaIVbTCSUZ,MAAAHAAADACA......cACDFAEDLAGBQAFAhAFAECCBaCHDbCBA.CDFDZEEARDEFdBHAhAIAAAIBBGBAeEGFKFCAOFHDhAAAfFHA.NIEB......hBGA......hCAA...,1,5,-27,32
MHNEFSBTbUXDKVYLeZcIfgPJOQGdRWACa,aAAAHAAA.EADEBADAUAFAKAFALBHBZBBA...ICCAhAAA..fBHAhADAPCABQDEAhACARCEFAAHAMDDBSDHHbECDDECBeFGFgFAAhAFAOFHDdGEACEGCTGGA.hAIAXGCA.,2,-22,26,48
JOXVYRIPeNHDZQLMTFAdgWUbfCcBEKGSa,dAAAUAAACADABAFAEADAGAFA..aAGDOAHF..XCAAhACARCBAeDABHDEBZCFAMDDBhADAADHB..bECDKEEASFHBhADAVFAB.IGGADAIBTFGAFHAC.fGEAhAFA..hBAA...,2,-30,10,40
CSGcRBLQFKTfOHUeWAgZaYVIPdDXNJbEM,aAAAVAAA..dADADADA..XAFA..bAEAEBBB.MAIBhAFAGCDARCEALEEAhAGAQCGBTFCAHFCBeEHHhBAAAAIBZFFAPDBBCDCCBGAAfGEAOHFC.hAAA......hAGA...,1,8,-9,17
YNTSIMXOaQEFHGdWVKRDfgCPJebUAcBZL,ZAAALAAA.TAEAMACAaAEE.EAHBHAGB.dCAAKCCDRCCAfDFAhABACCFA.eDHFhACAACHBBDEDSEAAhAEAODHDGECADEEBgGAAbEFD.cGFAhAGA.....hABA...,2,-33,10,43
bLNBFAePISEWYDUVHgdMXOZJcaKRTQCGf,eAAASAAAEADADAGAHACB.dAEBMBFAZAGBaBEDRCCA..QCFChAAAGEEALEHBhAAAFDHDACCAIFFA..hABA...YHCAgGCB...hCAA......hCBA...,2,-20,-10,10
NbTEYCBVMfOeDFLJUWHIQSZRcdXPGgAKa,aAAATAAA..EADABACB.MAEAeAFALBEAUCCAHCFAQCCChAAARDABdEFDGFCBhADAAAIBbCFA.CBHAOFHD.hBFAFGAHIEEA.ZEGF.XGBAhBGA.KGFB....hCAA...,1,5,-12,17
KcJbLFDWSNgAXTQdRCfBOaIMGVPEUYZeH,TAAARAAABADB..OAEDaACA..GAEAEAGA.ZAGBHCCBKCCAJDBFhAAALCGBDBIB.SEFDhAAAAAGBdEEDCEHA.MBIBhABAUGGAeFHFFHEG.gGAA.QGDChAGA...hBDA...,2,-13,-1,12
WUQFHdLMIaYORJbANeVgEKCPfSXBZcDGT,eAAAEAAAKACACADA....SAEHZAEBGAGAUAGAHCCBLCCBhAAAaDGHREABAAIB...gDGAhABAXFECDDIBTFDAhBGAFGHB.dGGA.MFIB......hBIA......hCAA...,2,-19,-10,9
FCOPYbJWHeTRESaDfUBLdMQNKIGZgVAXc,FAAAOAAA....bACDHADA.RAGFEBBBaAEADAHBBCEA.dDGDMAIBhBAAQDCDKBEAZDEBADHBhBEACFAAJFEB..eEHFhCAATGGASGEA......hCBA......hCCA...,2,-29,-15,14
TUWEcaDdZANGSOYIQBPMFXeRCfgJHKbLV,GAAAOAAA.QADAMAEA.eAFARBBACAHA.JBHBHBEBLCDAhAAATDGAEEEA.DDABABGBSDDDhBAABEHAXFGChACAKEBBUFGBaGAA.dHCB.......hADA......hAGA...,1,-6,-11,5
TfWEVPQUbSLcIRNFMgAYKXdZeBHJGOCaD,XAAAeAAAHADAGADAaAFA..DAIBTAFAECCB..QCEAhAAAbCFALDAARCGBMEEBhABAAAAAdEFAZFFAOEHBCHHD.hCAAfFAA.PHAC.SGHHhADA...hCBA...,1,7,-6,13
GXOUaeHTPfcINCbQdZDBJEKWVAgYFSLRM,FAAARAAAGADAOACDeAFAHAEA...TCFAfBHA..hAAAIEAAbCFD.ZECAhAEABCCDEDHFKFHBAAFASDABhABAMGAAaAHDcGGCQFDC.dGGADEDAhAGA.WHAA...hADA...,1,0,-14,14
WJbGQEKTRaPAMIDfHCcegVSOYXNFULBdZ,MAAADAAAHABC.eAEESACA.XAEDFBEDLAHBhBAAZAGBJBBFGCFA.ECCBhCAARDCFAAGBCEED.VEFAOEHDhCBA.YHCABFED.......hBAA......hBIA...,2,-28,-4,24
CQgTIPaEJfFLHNBZVWGUAcbSYdeRKDMOX,SAAAeAAARADA.MADACAGB..QCCCTAGA.aAHDEBCAFCFBhAAAHBEBZDGBGEAAhABAAAAAbDGDdECAOEEB.XGEDhAEAgEEAIHHA....hCAA......hCBA...,2,-8,-3,5
PQXdHOLgSIVfANbEecUGJFMDBTWZCYRKa,EAAAeAAAGACAMAEABAHAZAEARCEA...aBCDQEEBHBEALDEAhAAASAGEVEBAACIBbEGDhAAAUFFA.DEIBTFAAhAFACGBDKGDB.dFCA.........hABA......hBEA...,1,4,-8,12
CMfFeGDcJAdLEOgRHZQXVNKPYaBSbWITU,EAAARAAAHADBZACB.QAFA..XAEAKAHBaCCHBDAASAHBhAAA.ICEAhAFATDFAMDIBeBGHGEEAhBCADEEBAAAAdFAALEHBOFDHgFFAhADA.....hCAA...,2,-18,2,20
JXYLaAeCWIMTGDVQKRHEPFUfZbcSdgNOB,eAAACAAA.MAEAGACADAIB.QAEAHBCAEBFE.FAGEZDEA.SDGEhAAAdCAAOCFEXEBAhABAaEAEAEEA..TEFAhAAARFDFfFFB..cFGDBGHA.YHEAhACAIHBA..hBEA...,1,-10,-14,4
HXgTfINOCMGVZecDdBALaSEKRWJFUPYQb,aAAAEAAARACA..FADAUAFA..QAGAHCCCTDAA..fBBEhAGAOAHFGDFAhAAAeBDBdCFAADHBKFEDPDHBhBAA.bFDAIHHAMIBA.....hBIA......hCAA...,2,-18,-7,11
bLADCKIVcPOHTaJYUZfReBNMQdgWFXGSE,KAAAVAAAOACA.HAFAaADA..UAGARBCBeCEGBBDA..MCIBhAAAdDDAFCFHGEEA.EGHBhAHAADHACEGA..IHCAhAIATGBAZFFA.....NIEB....hCAA......hCBA...,1,-11,-27,16
gZEWeJARBXCIYQNUfOcPMDaVGHSLdbFTK,RAAACAAA.QADCUACA..OAECMAFAaBFDHCDC.dAHAFBHBKCBDECCBhAAA..eDGFADIBXEDAhABA..IFHAhAAAfEGADEEBGGABbGEA....hAGA......hBCA...,1,-9,-26,17
TJXZBgfIGUANRQKDSFCELMcWeVaPYOdbH,RAAAQAAADADA.CACALAEAMAGB.eAHHaAHB..OBDDhAAAHCDATEFAZDFABCCCfDCEhAAAGFBBABFBSBHHhABAEFAAVGCAdGHAbFFB......hCAA......hDAA...,2,-24,11,35
ZRPJXAHTKEdGWcFDSgYVBNfUaCMLIOebQ,HAAAEAAAGACAFADASAFH..gAEBBAHAUCABaAGAhAAAMCHBLCHB.hAAAeCBBZDCBREEBXDFBhBCAACIBdGHADGEBVEDBCHAA.OEBH.QGGAhBEA.PHBChBHA...,2,-15,8,23
aUZdFECeIRXBJAPLDgKTGYSMfWONcQHVb,LAAAKAAAGACAMAEAOAEA..QBDAHBEBaAHDdCAAEAHFeBGDhABARDGBBEBAACAADCCB.hAAATEEAfEEEhACANCIA.bGCCZFCF.CDDDXGEAgGGA..hBEA......hBHA...,1,-3,-5,2
NTQdJDZgLGAUIOVECfBSRXbMHaPeFWcYK,OAAAEAAABACARADA...MAEAHAGB.eBBBFAHD.....cCFChAEAKBDATCFA.hAGAdDDAZDCBGEGAAAIBIEEAhBAAfFBAbFGB.aCCH.PFED.hCAA......hCDA...,1,-15,-17,2
WNQYPSLEdMZGRKaXCJcUHFgBTADOfeIbV,OAAAeAAA..IAEAVADA..QAGCSAFHEBBBZAGBhAAARDCA.aBCD..CCHAUEGAhAIAHDEABECAAFFA.bFGBhABA.NIBB.PFDD.MIFA....hBAA......hCAA...,2,-18,-11,7
GEJAXYSNMaWCLfHTUDVZROBbgIKedcPQF,SAAAaAAALADAHACBDAHB.RAEABAHB..bBBCKCFA.eCHHhAAAdCFAQDDAhAEAEDEB.AAIBXDGDhAFAMEAAfFAATGGA.ZGEA.OHCC..hABA......hAEA...,1,-12,-13,1
WRDEHJIQFVXBTKNUcgCZPYSbfdeOaMLAG,RAAAHAAAQADCXADBKAFCUAGA.CBFCZCAASAHH.dCFAhAAAeDFAaCCC.ACCAGEDAhAAAEDHBFEEHBFHDTGFA.hABA.gGGGYFFC.OFDH..hBHA......hCAA...,2,-14,0,14
DYQNSVgJAUIWPEKeOFfZBCRdTaHGXbMcL,UAAA..IAAAEADAKAFA.eACA.FAFDZBFERBGFdCAAHCBCGCCAhACAMDABLDGBhADAQEFCSECAhAHAJFHBAAHAOFDDCFEAaFHD.........hADA......hBIA...,2,-15,-12,3
fEJMaeTNPgKACHZORSDcQFbWBXIUdVGYL,HAAARAAADADA.QADCFAFD.BAFBUCCAGAGALAHBECABaCCChAAA.eCEHTDFAgEGAhACAAAAAZEBA.SFFDhAIA.cGDCbFFAIHBA.hBIAdHFB.....hDGA...,1,0,-23,23
BRPaJSTNMfLgVdXbEHeQUAOFZKWCIGDcY,ZAAACAAAGACADACABAEARAEA....aAHDTAGA..MCABLCCAhABAdDFAECBBHCFBeDHBhAAAACIBKECA..IGCAhACAPEHD.SEAHfFFEXFEChAEAbGAA.OFHH.hAGAFHAC..,2,-32,4,36
UBIZPXdeJRNAYSEDcLGOHgCbfWTFVKMaQ,EAAALAAAHACACAFB..bADD..TBGAKAFAMAIBaCCC..QCEChAAABCAAZCFBdCCCREAAAAHADDIBhAEAGEGAOEFDfFAAhABAFFHHIHEAeEEDYFCB.hBIA......hCAA...,2,-3,-2,1
gFKDHYceREILCUJGPVfZOaWXASdbBQNTM,dAAAQAAAMADAKAGAHACA.eAEEEBDALCCACAHBGCDAfCFBhAAAaCFD.ACHABDHAhCAATEGADFDB.RFFAIHHAhDAAPDBBOEEB.SCHBhACA.gGGAhAIA...,2,-26,3,29
gZaBdNJMIAefDSFPQbKLWGVHEUTRcCYOX,eAAASAAAQADALADAGAGAHAGBECCBRCCACDFAODFB.hAAAZFBAdEAAMDIBAAIBFDHDbGAChAAAKEED.UGFA..hABATGFAXFCDBAFA.NIBB.....hABA......hAIA...,1,7,-8,15
cfaIeKVYbCQTSFBJEULDWgRNPHXZGAdMO,dAAAMAAAOADA..aACEeAGFKAFA...VBDBCAHBQCCAhAFA.FCEEEBHFLCHBhBAADCCBREFAHGEAGEFAhBBAADBB.fHDB.IHHA.hACA......hAIA...,2,-24,-13,11
XVIATHKBQDURgNdSOeYPcZbfGaLECWFMJ,HAAAQAAARADFdAFAeAHB..PACCZCAAGCGAEAFEFBHDMDFBhAAAXCDAAEEBBGDADCGBUGGBhACASDCD.hADAOEEB.bFGB.aHAA.CHEA....hAIA......hCCA...,2,-7,-5,2
WIEJGPObVSAKCaTHXYRLgdQZefNMcUDBF,aAAAHAAA.RADFdAFAeACHMAHBDAEABAGA.FBEBECAB.GDDB.hAIAOCCBbCFA.AAIBTFGAhAAALEEAZGDAfFHAhBAA.cGCA...WBBDhBIA......hCAA...,2,-36,-2,34
RXNaDSCdGOWgQFAYUEfTcBJZLPKebHMIV,EAAATAAABACA.ZADBLACB.eAEAHAFAMAIBRCEFaCCBCBGAGCEAhAAAOCGD..QFGBhAAAAAEAfDGBPHAAhAHAbECD....XGFADIDA...hAIA......hCAA...,2,-15,-3,12
DZLXSJGOcAUBKQbgMRaYVEdfHNCWePTIF,KAAAQAAAMACA.RACA...aAEEEAFEHAGBCAHB.eBCF.TDDAhAAADCEAZCEE.LDAAhAAASDFBGEFAAAIBbEGDhCAAYCHBdFCA.WFED...IHHAhADA....hCAA...,1,-7,-18,11
SeJfTERNWGLQXDUaFbVIAOBMZgYPKCdHc,MAAAZAAA....gADBKADAHAFBeAHB.TBBARAGBGCAAhABALDDBQDDAhACADDFBaDHHbDFAAECABFAAhAFACCCDdFGASFADEFGBXGEDFGCA....hAFA......hAGA...,2,-4,-3,1
UXDNLRHMBTQeEKbVWAZScgJdCIaPGYFfO,ZAAASAAAJADA.dADACAGB...aAFAGCAAFBFB.UCFADAIBRCGBHCCChABABCCD..eDHHhACAEDBBKDED..bFFDAAAA.hBDA.IFFA..fHDFhAIAXGECMFIB...hBIA...,2,-23,-22,1
CUeXaGcREWPKgfTdFMHBONZSVADbQJLYI,QAAALAAACAEAUAGAeACAGAFA.EAHBKCAA..TCDAhAAAdCCAHDFAODABZEAAADHAhABAbDGDJEEF..XFBAhADARGBE.gFEDMFIBSGGBhACADDCBIHHA...hAEA...,1,17,-18,35
DHVKNEOcWBMCgZFbdYSAUGXeaILJTQRfP,GAAAeAAALAEAQADARBCBDAIBHAFAKCEC.ECDB.OCFEBCGAMDIBhAAAZEFAdGEA.AAABaDAHhACATEEA..fGGAhADAPFAA.NHAB.CEGBbGAA...SGGBhABA...hAHA...,1,2,-13,15
aFbdXISLZUKDRgWVcfGMHeQPETJYBNCOA,aAAAdAAASADAZACB.DAGARAEA..VCFAGBEBHECAeCAAEEHF.hAFATDDABAHBOBBBhBAAABHAFDGD...bGFALEABhACA.KFDD.gFFG.hCAAWFHHMICA...hADA...,1,-4,-18,14
HQbWgLONeJRAMcVBfGICZKXaDYSUEFdTP,MAAABAAAGACAZABEKAFA.aAEA..DAIBSAGHFCCA.dBEAHCEBhAFAQCAC.hAHA.bCGDLDGBhAAAeGCAACGB.fEEAXGGA.EGEF....hACA......hAIA...,1,-21,-22,1
DAFXWIBQbMJLVETKRaOUSgfPNdcZCeYHG,XAAABAAAMACALADA..EAFARAGFaCDASAHH.hAAA.fDDAhABAdBCAZCEAeDHHHEABACFAFEBAQDGBhAEAbEEB.TFEAOHBA.gGGAhAAAcGFD....hBEA...,1,-1,-20,19
ZHIFMDBTeEdUJWAPVaYNKLcCGXfbSRQgO,aAAAKAAALACBGACA...XAEASAEARBGF.QBGAhAEAZCEFHEAAMDEBTCEAhAFAEEHFdEEDUGGBAAHAPEHBhBAANHAB...........hAAA......hAEA...,1,-8,-9,1
aEfIQBWMROJNGKLHXePCgdUTFYcADVZSb,ZAAAaAAA.EADE..QADAMAFA.RAFAOBBBGBEBHCAA.hADAeDEBCCDDdCHATDGAhABAFDEDADGASEGDhAGAbFDDBFHA.JHFAKGFA.........hAIA......hBAA...,1,4,-24,28
MSEWAfQBXVFZcYKbNgITGCdORLHJPaDUe,QAAAXAAAZACBKACA....bAEAgAEB.GBGAhAAAdCEARDFFHFAAaAGAeCDBhCAAEEDBAAAABDFDFEHDYHDAhAFATFFALECBDAIB.MEIB..hCEA......hCIA...,2,-6,-1,5
QcAJOFLaEZVUIXGNHWTebMBPCYDKgSdRf,FAAAEAAAZACBUADAGAEAHAFA...eAGBMCCBCAHBKDGDdCHA..RDDA.QEBAhAAAAAHALFFAaCBBhBCA..XGDChBAATEDAbFGDBHFA.DDBB.......hBEA......hCAA...,2,-18,-5,13
LcefdBJKONEFVXgZTDWMPGQUaRSHbCAIY,LAAAeAAAdAEAKAGAEAEAFAGD....XBCDZCAATCEAMCGBhAAAGDGAUEBAREEBHEAAhABAACHA.IGEA.hABA.fDHABEEDNAIADCCAWGAGaGGH.CGHA..hACA......hAEA...,1,-3,-22,19
ZJRCFUaWPGbgEdXLAfcIeSTYNKMHDVBOQ,..IAAAeAAATADAKACA.HAFBBAEBZCCARAFF.FAHFUCAA..hACAaDGDGCDAEEEBdFAAAAHASBHHhCDAMDIBOGEEhAAAQFFA.CEHB..PHCA.hABA......hAFA...,2,-17,-5,12
LIgAHJQaXfUVDeBPCFSERMGdOYcZWbTKN,HAAAaAAA.XADBUADADAGAeAFA.CBHAFCAHRBFFdBHA...OBBBhBAAZCCAbCFD..TDDAhBDALDHB.AEEBQFCChAAABEGAEFBAMEIBcGABKFFD.gGGGhACAfHGBSHEGhAGA.,1,2,-23,25
NbJVacZWRUFQKMSXHBgfdYGPDOLCAeEIT,EAAATAAA..JACBaACAZADB..RAEFQAGCMAGBHCEBBAHAhAAAdCCAGDFAOCHBACIBeDBDhAAA..bFBAcEDBhAIAFFGHSHAA..fDHEhBDADEIB.CHGA....hAHA...,2,-19,4,23
CQIbBEGaZAefWHNFDTUMPVgORcXYSJdKL,eAAAHAAADACAMAEA..VAEARBCA..XAGASAHB.dCCAhAAALCGBQCGDhCAAbDBAEDFFZECEAEHB.fFGEhCEAFFBATGGA........hAAA......hABA...,2,-15,-11,4
GgdeNWZJILPDcHKYfESRbTVUQCMaBXFAO,GAAAeAAAZADBLADADAGAHBFAKAHB.ECDARDBB....TDEAhAAAQCFAaDGDBBCAAAABdDHAhACAJFHBIEEA.hABAPDCBfHBBbFADCFGD..FGHD...hBFA......hBHA...,1,1,-16,17
cTCIVAMKaWBQdgeJbSHZFGLUXPRNfEDYO,aAAAQAAA.eACAbACD.HAFAGAEALCDBUBGAREAAECFBOBBBhAEATDAA.CCHAAAHAMEEBhAGABEGAdFFASEHHhAAAZFGBFHAA.XFED.fHCBhADA.....hAHA...,2,-2,11,13
fFONAcYbBMDWLaPUHJeKICQgSZXVEdRTG,...bAAAMAAA.LAEAaAEAHAGBeAHHCBEA.QBBAhAFAZCAAEDFBREBBGEGAOCEBACFABEDAhAAADDGBUFFBKGDA.SEHBhAGA........hBAA......hBBA...,2,-24,-4,20
FMWZfaeYdRDHOIULNKEJBCcSQXVgTPbAG,GAAAMAAAZABEeADARAEF.HAGBUAGALCDB.ECFBCCCAQDEBhBAAXEAA..TEGAhAAAADHAFEGD.aFEDDEIBIHHAhACA.KGBDBHHA.....hADA......hAEA...,1,3,-36,39
JLGaRFHgcACZVUKfBDWSPIdQeYEbNMTXO,ZAAAKAAADACASACE.dAFAeADA.EAGAMAHB.OCCBhABAGCCARDEAHECBABIBCCFAUEFAhAAABEHA.IGFAhAIA..YFCFNIBB.JHFAaFBH.FHGE.hCAA......hCBA...,1,1,-34,35
bXCKQPOcgMYSAaWZINHVGJRLBFEefdDTU,ZAAAHAAAGAEARADFLAFBEAGA.eAHBdCAADBIBTDAAUEEB..bCGDhAAAKCCD...QGAAhABAODDBMEFBAADAaCHHhACAIGGA.NIAB.BFHA.XEBAhAGA.CHFAgGDAhBEASFCD,2,-13,-5,8
cWQBFMTPGebaHADRgdKVOZSCLXYUfNJEI,RAAAdAAAOADAZABBLAEA.UCEAJAGBEBDF....ICHAhAFAQDECFDCDMEHBhAGAGDGA.eCCDHGDAhAIAAAAAKFCDCFFA..........hAIA......hBIA...,2,-26,-21,5
RWeSZLPHJMVUYXOTKFfGNAcCgBEIQdDab,CAAAEAAAdACADADA..RAEA.eAEAZCBAHCFA..MAIBUEAAOBCBhAAAFEFH.GCFAAAHABBHAaDBHhBDA.SDDBhBHALEHB.PEHD.VFCBTECA.fHFBhAAA...hCAA...,2,-21,-12,9
WLYbOXeZIRcaFNGJTSVUPQdBKMgDfACHE,HAAAEAAALADAOACAeAFARAGF.FBHDGCBA.TDFASCCAhAAAUDDAdFAAMCFBfEHAhAAAACCACDGD..hAEAbFGBXGGAZGAAaEEH.NIAB......hAGA......hCAA...,2,-11,6,17
fdEBWMSVgNKGXQIAaTbJUYFZLcDORPCeH,aAAATAAA..UADAZACBLAFAOAFCRCEA.eBEBHDBAECABMCIBhAHASCGA.gEDBhAAAGEFAIHCAhAIAAAGAbGCC..FGGADBBBCHFA.BHEA...hACA......hCCA...,2,-13,-4,9
WQYCNeaLEcUVGOSgZKIBJPMfbdHATRFDX,RAAAXAAAQADC..CADA.eAFEEAFAUCDAGBFA.SCCDhAAAZBGBBCFAMCIBdCHAHDDBhABAAAAADDAAYFCFhAIALFAAOFGDKFFAIHFA....hADA......hAFA...,1,13,-28,41
PBWgJOGSaIXCfARKecDMTdbLEVYNFQZHU,RAAAeAAAMADAdAEA.EAGA..VAGBFBCDHCECBBDA...JDHBGBEAhAAA.aCCHCBHAAAAADDIBTEBAhAGALEGB.NEEA.hABAZEEF...........hAIA......hCAA...,2,-23,-19,4
bPXOVSEBJQHcWRDeATICfadZMFLKGUYNg,TAAACAAAdACAZADB..MACALAGBGAEBUEEA..NBDA...hAAA.bCEAOCBB.hAHAEDHFQEEAhAIAHFBBRGFAAAIB.aDHD.KFCD.gGFA..hCAA......hCCA...,1,-8,-22,14
IMRDCFSPTYAJKgGVeBcNdfQUOZEXHWLab,KAAAGAAAeACEBADAdAFA.QAFAZAGBHBCBLDFAaBHD.MECBhAAARCDAFDCH.SDADhAAATFFAABIB.VEFANEEA.hCAAOFEB.EGHFWFHBDHBA.....hACA......hADA...,2,-7,-7,0
ScabdPUWeXEJTHNBCQOFZRIMgVLGDfYAK,SAAAaAAA.dADAPADAUAFA.eAGFECCB.HBBCBAHAQDEChAIAZCFEREDB.MBIBhBAALFBBGDGAfFFBhAAAAFCAKHCA...WFHB...JHEEhABA.CDBD.....hBDA...,2,-17,-3,14
CVGdIJcBfXeFEHTMbaRUDSgYZLNWKQAOP,CAAAdAAA.JADABACA.eADHHAGB.MBDBRAFADCAA..SCAAhACAZCEELEFAKCEAAAIBOFAAhAAAGECB...fDHAhAGAEGABaGEA.gFGANICB..hBAA......hBCA...,2,-27,-23,4
DSCBHFKXeVTROWgGfIAPZUNMYbEcQdJLa,ZAAAMAAAEADEdAEALAFBDAGA.BAHAHBBBKCAAeBFH.RCGFODEHhBAAGCGAACEA.UEDAbGFA.hBBAQGFD.hBDAaHAAFEBH..........hBEA......hBHA...,2,-18,-15,3
WAZMVSPTNLgIBGJQecCbOXDEfHYdKFaUR,ZAAAMAAASACE..TADALAFABAFBGCCBeAGHbBBDhAIADCFAHDFC.dFFAhABAaBHDRGAAAAGAPDFBIHHAhCAAQFCA.OEGD...hCBA......hCCA...,1,-8,-10,2
cBeKZRGIPAUHDXSONCabTVMELfJQgWYFd,HAAASAAACADB..aAEDTADA.EAFELAGB.QCABhAAAgBGAFDCDhACAdCCAeCHHRDABGEDAhAAAAAIBXEDDbDFAMFHBfFFBYFFBKGBAIHAAhABADFIB...hBGA...,2,-17,13,30
SUeXcCWRANBHOdfZJIGDabFVMYLPgQEKT,HAAAdAAAZABBGADADAEA.aAFAFAGD..MAIBLBEBQBFChAAAECHF.TDAAUEGB.eCCBhACACDCA.ADHBOEFBhADA.fEHAbGDC......hCAA......hDAA...,1,3,-36,39
GVELIPSfAZcUYBCRTgdeOFMXKJaHNQWDb,ZAAAUAAACADB.RADA.dAFAFAGA..MAHBKCDD.HCAA..QCFAhADADAIBGDEAEEAALECBhABA.SEGBhACAACIBBEEAeEHFXGDDaFCB.WFBDIGFAhAEAfGGE..YHDAhBAA,2,-24,-24,0
FGAQRVaMUKeLcOJdYEgWZBNfbXTIDSHCP,RAAAaAAAMADA..eACHLAHBOAEAdBEAEAHFZBFB.BCCA..hAAAbBDDTECADBBBHCFAhBAAFEGDAEIBQEGAhBFA.KFCAYFFFgGGGfHCBhABA.IHHA.hCAA...,2,-14,-8,6
ZeDTcRQfIYWdXSFgVaMHEKAOPBGCULbNJ,BAAAGAAALACAJADAZAGB.eAFH.DAHBRCDBQEGA.hAAA.fCCAhADA.IDGAdFCAFFFHaGABhAAAHEAAABIBCDCDbEDBNIDB.TFFA...YFHBhAEA...hACA...,1,-12,-20,8
EDGbSONMVZJIUHfeQLBFgATRWYaKXPdcC,RAAAaAAAKADC..dADAEAFAGAFA..OAHDMAIBZCCAUCCAHDGBhAFA.eDBBLCFBhAAAFEEHAAHB.TFDAXGGAhBAACDHDSFHB.JHBA...fGGAhABA...hBBA...,2,-19,-10,9
dQIBYOGZbXVRCJSgFETcHLNKaAWfMePDU,MAAAeAAADAEAdAEABAGAGAGAZBBB..XBCARCFA..SDCHhAGAECFBHDBALEFAhAAAaEDD.AAIBfFBEhABAQFFAOEHDCGGA.FGCHNIDB.KHEA.hBDA......hBFA...,2,-20,-11,9
RYbTScCJVPMFZLNagDAOGIWUdKeQEfBHX,GAAAUAAAeADAEADAHAFARAGB...bCDBTCDA..CCGAPDFBhAAAZCFFaDAA..AAIBODHFhADAdEHAfGGEhACABEAASEFDJHAAMDABNDDADGHB.....hADA......hAHA...,1,4,-19,23
VCKbTeILGFMESRDNPWcAUOfdgaQZXHJYB,OAAAdAAAaADA.ZADBHAFBBAFAKAHB..eAGHGBDAFBBH.ECBARDEB.DDHBhACA....PCHDhAIAADIBfFEA.hBAAQGFAXFCAYFHFCHAA..hBDA......hBIA...,2,-31,-11,20
UXZLQDMfPgHcBNIYAROdKJGFeCbWaEVST,RAAAdAAAGADAeADACAGA..aAFA..EBHFTCFAZABBLCEB.hAAAMCGBfCCEhABAHDCDBDHAIDAAAEAAKFGA.hAEAbEFA.SAHH.QFBAhADADIAA.gFEGhBFA.NIDB,1,-11,-20,9
RCXZOADHQEagdLKWJbcSMNIYeTUGVPBFf,HAAAEAAAdADALADB.KAFAbAEDMAIB..IAGAeCAAGCEAhAAABBCCRCGFZCGFAAIBaDDChAAAgFAA.cGDAhACASEHH.TGCAUGGA.FFFB.hAFACHHA.OHAE..hAHA...,1,9,-13,22
JcELbMZQBOAgINSYGXdCDRHTaFKPWUeVf,..IAAASAAAGACAdADARAFAHAEAaCCC.KBHB.UDFAeCEHVCABhACAJCGBLFAAhAAA.ZFFAQEDAhAEAACIBNIAB.CEHBTGAAFDBHfHFBEGCEBGGA.hABA......hAFA...,1,8,-11,19
ZJUegLMKEIcTQfGROSbNXDaWAYVHCdBPF,HAAAdAAAFADAZADBUAGAeAFA.MBIBKBDD.ECAB....TCEAhACAGCEARCBB.bCGD.DCCBADHACEEDhBAABGAA.JGCALEGBhBCAQGGASGBA.aGFB..hBGA......hBIA...,1,7,-27,34
JAQcESfLTYZaDCdUbKIMBVONeRgWHGPXF,EAAALAAAZACB.aADDdAFA.KAHBMAFABBECOBED..RCFAHEDAhAAAGBGAFEHBABGBQCAAhABASCBD.TFFAhACACGGD.IHHAeHAA.PDDB.cGEChBIADGIB....hCAA...,2,-17,-16,1
fHOWAQagYFbSceNUPZEVIRTMBJKXdCLDG,aAAAFAAA..SACHeACHUAEAZADB.EAFARAGBMBBB..KAHBdDDAhAIALCFBGEBAHEGBhBAAACHBQFDCbFED.hBEAPFHB.........hBIA......hCAA...,1,-1,-24,23
CDRAVMbHdGEIaNLcYOPfFKZgQeXWUBJST,MAAAHAAAEADE.aAFALAEA.OAHDFBFDZCAAeBBBXCGDhAAABBDDTCFARECAAAIBdFGA.hACAGDDA.IFAAhAFANICB...PFCB.KFGAWFHHhCCASGFD.CHHA.hAGA...,2,-18,-5,13
NRAgEUeDOIXGWfFcKLYCMdSTZaPQBJHbV,EAAAeAAADADAOADC.GAGAFAFDLAHBMCCA.dBCAZDDAaBEHQFAAhAAAHDEC.bFDBhABARFFAABHBUGGA..IHHAhAAA.........hAFA......hAGA...,2,-23,-7,16
OHaNKcZAXPUgQdbJGFWYIfSMEBVDCLReT,XAAAUAAAdADAGAFAFADA....IAGAMAIBEDBADAIBRDEB.hAFAeBCHHEGB.aEDHKCFAhAAAAAHB.QECAhABA.bEFAYFBBBGEACGGAOHCCNIEB..hCAA......hCBA...,2,-21,-4,17
NOGKbfSaCYPWgQRDdUMXIJFBAHVELTecZ,HAAAEAAALADAeACEZAFBGAGAKAHB.SBCDaCCA.CCEA.PCHBhAAAQEAAREEBdFAAMDDBhAFAXDEA.FEHDhAAAAEGB.TECAOFCHfFFE..hAEA......hAFA...,1,-2,-11,9
AdOMLXFWTbSRfQDcNPVHJGaZeCEIYBgUK,dAAAMAAALADAFADD...TBGARAFAQCBCDCCA..PCEDhACAHCFCaDECZEAAEDHFhAEABEHAKFGDAAFAXFCAhAIA.bFFCfGDANICB....hAFA......hAHA...,2,-24,-7,17
JUfCVYdbDMaRBXHGTOgKNWLSPIeZFQAcE,EAAAUAAA.CADA.dADA.MAFARAEFHAGBGBEA.OBCHKCDDLDABhADASBGAeDFFZDGBAAIB.hAGAJGBA..VEGBbGFABHBDhAAA..........hBDA......hBGA...,1,-13,-21,8
cBUCWXNeHVKFZPbLdaOMGgSTfAIDQYJER,QAAAEAAARACA.BACACAFB...XADDHAGBFCCHZAFAbDADaCEEhAAA.GCGA.TEEAhAGAAAIBDCFBJDGF.UGGBhAAAeFHHKEDAdHAB.MDDB.....hADA......hCAA...,1,1,-21,22
JVHZYagcFGBMUCKDSXRfTPLEAdIbWQOeN,dAAA..bAAAQADAeAEA.VAFAHBFCZABBaCAAFCHDGDDAhAAAMDDA.KDGD.XEAAhABAREEATGGAEFGA.AAEAIHHAhACANIAB.........hAIA......hBAA...,2,-15,7,22
gVbLNJKdPUGZDOQcaRCTBHYAIfXeSFMWE,XAAAeAAAMAEA..EADA..VBCALAGBKAHBdBFAGCDAhAAAZDEEQFFARDABTFFAHFCBhABAAAAA.SFHBhADAFHCA.WBHH.......hCAA......hCBA...,1,9,-23,32
PJaLNcHBKUZVYGTMSgRIQOfEDWedAbCFX,FAAAXAAA..aACDLADAHAEAKBHBZAGBGCDAMBIBRCDBQDFChAEAEDCB.eEHFhAGAAAAAbEADCGCA...PEGBhAEANIAB.BCFC.YFHBSGGDIHEAhAFA....hCAA...,1,-10,-13,3
bdRHWCfVEeGKJTUDLSQIXgNMOAFYBcPaZ,BAAAaAAAZACBRACAHAFB.CAHA.EAEAGCAAKAGAUCEALDDB.QDFBhAAAXCGAMBBBhAIAAACAFEHD...PEDBhBAAdHABfECA.eFFBTFFADIDAIHHAhAFAOFHDYHCGhCAA.,1,8,-28,36
dOMFYNPQKVJEXAHcaTBDeRCGWSLgfZUbI,HAAAaAAABADARADFGAFALAFAZCAAUEFB.dBHAMBBBFFAA...hAAAPCCAQGGBhACAKCFAEDHFAAHADEEB.eFDDhADASDAD.bEEB.OGAA.YHAAhADA...hAFA...,1,1,-17,18
CIHTJcMYaVbeWNAZOfPSDFQgBXRELKGUd,ZAAAOAAASACEFADDBAFARAEF..LAGBGAGAdDDAHDDA.TEGAhABAMBBB..aCCHeFFBhAIAAAIB.DBIB.QGCAhCAAECFBCEHA.IHHAcFAA..bFEDNCCA.hCBA....fGGBhAFA,1,-6,-24,18
ESOQZBFcLaGKXURDTgWMAJNYPdVICbeHf,JAAA..PAAAdADA.CADA.HAFA.ECCBQAFAZCEEBDHALEFBhAFAGCCAXCFChAFARFCADFIB.TEFA.hAHAMAIBAFCANIAB.IGHA.eHBAOHFEhAIAaHEE......hBAA...,2,-15,-3,12
PeGaEgRDNSfdBcXUHQZCJFLTYIVbMWKOA,eAAAEAAARACA.DAEA..SAFBdAHABBCAUBEAHBGBZCCA.FDABTDGAhAAA..IECAhAAAMDDBKEEAAAHAaEEC.hABA.fFHAQFGALGCA.hADA......hBIA...,2,-26,-17,9
bUEPQOeAdLFIZfCVYTWDMNXKgHJSBRacG,dAAALAAAZABBCADA.TAEA..MAFAKAGCHCAABBEARBFFGCEBhABA.EEABQDCAhBAAABIBfECAVEGBDCCA.hBHAXEECSBHHbFGDOHCAeEEH..hACA......hAEA...,2,-19,0,19
IKFGNYZBJeQHScgRUAWEMXdDVTbOLCaPf,EAAAdAAADADA..TACALAGB.aBDAfAEB.FAGAhAAAGCABZCCAeCEEHDEAhACASCHBRECBAAIBMCIBbFGDhBAACEEDKEGABGBAQGEA....hCAA......hCBA...,2,-14,-9,5
ASWPfKbQRIdgHeZXDYTMcGBLUOJFaECNV,SAAA..fAAAQADARADAdAGAHAFAeBCBZCCADCHBhAAAMAIBGDAALDABhAAAODFDaCEDEDGBCEHAAAHAKGHBhABAbFFA....IHDAYEEFBHHDhACA......hADA...,1,-2,-14,12
WKeTHRfINVQaEbGBCDFOXcLAdUgSJMYPZ,dAAASAAAMADAZAEEeACHHCAC..RAEA...fBHAhACAICGAQDDAhAAAECFBGEDADDIBXDGAAEDBgFFBhAIAPEABTFGAaGCHCHFD.OECB.hBAAcGFC...hBCA...,2,-4,-4,0
PLDeWCYHbdAQJKIOVMTaBfENXGcRFZUSg,QAAAKAAAOACA.MADABAFA..EAGAGAGARBDAZCFE.UCCASDBAhAAALDBDeEEAhBCACCFDHEDCABDA..IFHAhBIAaDHD.XGGCFGEHDGGA.YHCAhCAA......hCHA...,1,-10,-19,9
LAeHUaJWQCTDXBKGNEIgcVPdOZRbfSYMF,HAAAaAAA.QADCDADAKAFA.EAFE.ICFAVBCA..dAHARCAASAHBhAAAMBBB.hBAAACHBeDEBUDFACDHATEGAhACAGGCBgGEA..cGGAhCAA......hCGA...,1,10,-30,40
QNJGLVDUFPCaZIdbefHYWRBMXKOgTEASc,QAAAGAAALADADADAFAFDaAGD.dCDAeAHBHDFARBDB.MAIBOCGDhAAAEEABAAAB..SDBAhAIAJFCAUGGACHDAbFEB.hACA....fGDABHFC.KGGA.hAEA......hAFA...,2,-14,-1,13
MFAIWgcQeCfZNTXDVUSLPKdbBEYRaJGHO,..IAAA..gAAAeACAZAFB.TADADAIBUCAALAFBhAAAdCDAECHBRCCBGCGAhABAHEFAMFBAAAHAQDAChADAfGHAXFCASHBAbFEDaBHFFHEA.hACACGGD......hADA...,2,-10,11,21
aRVOUCGWDXQBJTdeNcLZbFfgAKMPSYIHE,MAAASAAAHACCRAFFOACDGCCA.DAIBQAEABBBD.dAHAhAAAeCGHLDEAZFABbFDDhAFAfEAA.hAHAABGAKECAIFHAEEHFaFDECFFD.XGFD.hBAA......hCAA...,2,-6,-6,0
gAMWESITXJDUCNdKHbeZfVOPRGYBFQaLc,EAAATAAADADA..UAGAdACAHAEA.eAHHZBCAODBARCDBGDFAFDFDhAAAaEAALDHBAAGA.hAAAMEBBSEHBhAEA.XFDCCGGDKHEAbFBDfHGF.hBDA......hBEA...,2,-23,9,32
eUVENbRYJPdMLfagKZAHOSWBFIXCcQDTG,HAAASAAAFADACAGA.QADAGCABeAHHEAFA..RBGB..JCCBdCFAhAAALDABaDHDZECBAFFABDFAhAAA.XEDDhABATGGAUGAAbFFB..MEIBKHEA.....hACA......hAGA...,2,-1,0,1
MKQLNUCGVgDAfRcZBaEYHJOITePWFdbSX,RAAAZAAAEADEHAEA.OAHDeAFEFBFDdCAA..SCCAMCCBLCHBhAAACCFAGDGADDDBADHBBEEAhABAaEDD.JGAA..TFFAhABAbEAA..KGEANIAB........hACA......hADA...,2,-14,-9,5
LUDAVMOINQZJecSRXfHKdYWTbCPgGFaEB,MAAAOAAA..QADAeADARAGBHCCAdAGA..TBBACBBDGCFAhAEAECHFLDDAAAIB.hBAAIFBAZECASDHHhCAAKEHBbFDAFHGEaGHB.DFDA.NIAB.....hAIA......hBAA...,2,-5,-5,0
TWBdSGIcRQELAfgJUeKPCFXODNHMabVZY,JAAAeAAA.CADA.OADAHAEB..MAHB..bAGDZCCF..TBDAhAIAdDGDGEEA.RGAAEGHBhAAAABGBfCCEhBAA.KDFD.XEGADAIB.aEEH.YHEAhBIA.SGGGhCAA.,2,-32,-9,23
eJUSXZAWcKRGdQCOfPTgLVaHDbMFNEBYI,KAAARAAAdADAQACC..fAFA..TAFAhAAALAHBHCDAbCCCMAIBhAEAEBGFBEEAeCGHSEFDhAFAAAAAGEGAOFAAgFCAaGEB.FEHD.hAFAIHAA..hAHA...,2,-19,-4,15
SYMZDVXPRLdCTfFeAUBKWHaQbNGIEOgcJ,KAAAHAAAQACCGADAEAFA.OAHDJAEA.MCABZBFEDCEB..hAAAXCFDRDFAdFFDCGDA.TFAAhAAAFGHD.ACCBBEHAhACAaDDH.bFDA..IHAASDDD.PHBChADA.fHGFhAFA.,2,-27,-1,26
JROdPDBAULICMWKFeSXHcbGYfaNVQgETZ,LAAAMAAAFADD.eADHHAFAGAFA.aAHFQCBC.hABAECFBZCABRDGFdEDABDEAAAHACCHBhAFASDGH.hBAAbFAAfFFEgFFGOFHDDCABIHBAhACA.WFHH.hBBA...,1,-2,-16,14
TOUdJMcfCYPDgZHVKLbWNXGaSRABIFQEe,FAAAEAAA.eACHOACCdAEA...MAEACAGADAIBHBEC.LBHBhAAA.bCCCXCEAhAGAGEEAaGHBACHBQEBAhBAA.TEEA.UGGA.fDHAhBEA....hCAA...,2,-28,-2,26
WTJBUCZQYgIOdDeARKMcPSafLGENVXFHb,RAAAMAAA..SADBaACEGAEAEAFA..XAGAHBFCbCCCTCCAhAGABDFAZEEA.QFAAhAAAgDFHdGGDhABAABBBKEHBfHEBLHAANIAB.FGGB.WEEDhAHACDHA......hBAA...,1,12,-12,24
EQVgSZPAIJGTDUdFeCRfcbXYBWaKMLONH,GAAATAAA.dADAeACERAFA....bCEABAFB.aAGDMCIBLCCAhAAAHDBBEDDBQDFAhAIASEGDABDBDBIBCFADXFEDhAAAKECAOEHDNIAB.......hACA......hAFA...,1,-3,-16,13
ALSGNKHWefURJOBgDMadTVPFYIZEQbcXC,GAAAHAAAeACERADABAGBMAFAdCDD..TBFAFBHDZEAA..ECCAQEEAhAAAXDECABHALEHBhACAKCHBUFDBOGCEhADAaEHH...........hAAA......hCAA...,2,-14,-12,2
HEBCXZLcbTfVGJOaeMYQSUPdRAKWgDINF,KAAADAAAFACDHACBBAEAZAEALAHB..TAGAGCAAOBBHhAEAeCFBMDEB.QFFBhAAASCEAdGADhACAACEAIDHAEHEEXGCDbDDC....fFFAhAGA.aGHBhAIA...,1,15,-51,66
FLXJUMRfCKbdEcOPBSeWGgTYDQVAZHIaN,HAAAaAAALADAXADBUCCARAFA..KCADEAHBOCCBBCFAeCGHhAEAGCGA...TEDAhAAAQFAAACIBZGAAFGFBhACAMBBBCDEB.dFEA.SDHH.gGGAhAFADGIB.NIAB..hAGA...,1,-1,-5,4
GXMCALWDEcFOJIeRdUaSgNQBHZYTbVKPf,LAAAEAAAFACD.OADDeAEA.RAFA.dBHAUCAA..aCDD.SCFBhAAAQCFBHEAAhAEAZEEAbFAAKEFDGEGAhAFA.MHCAAAFADCIB.IHEABFDA...hAIA......hCAA...,2,-17,-6,11
KBeRAXLfWINHJOVQgYMZDPbSaTCFcGEdU,LAAA..fAAAIAEAHAFBOADAQCAAhABAMAHBZBCADAIBbCDDaAHFTCAAhAAAFDGD.EDDBdGGABDFAhACAACDBNDIA.VEBB.gEGASHBACGHAcGCDhBDA.KHEA..hBEA...,1,5,-15,20
RNJBCLWTfPDIOVdecaEUQAYXMFbKgSZGH,MAAAKAAAZACBHACCRAEA.BAFBLAHB..TBGADCAA.OBBBhAHAeCEAEECAAAIBFCDH.SCFDhBAAGEFACEHA.fDHAhCAAIFAAdFECaFFBQGGAhDAA.XGDD.hAAA...,1,-1,-23,22
ZTReMcWXCQIGYdEVPUFLSKABHfNOgbJDa,HAAAOAAAJADAZADBRAGF...eAFAMCAB..XBBCQCCAhAAAGCEAECFBUEFBLCGBhAGAACIBBGAAfDBAhBAANEIA.bGDAaGGH........hACA......hAGA...,2,-13,-4,9
ZNeSHLPTRDaXOYdfQFJcEMUABKWGbVgIC,KAAAGAAA..VADACADAeAEHHAGBLAGBRCAA.aCDHODCEhAAAdEFAQFDAFDGHEFDAAACABFHAhAGA..gGBBhAAAIHHANIABSDAD.DAIB.hAIAfGHA.hBIA...,2,-20,-7,13
UBYEZRPMFgNSDJQXVeaCKTWILGdfHAcOb,OAAABAAAEACARADA.FAED..SAGBDAGA.QCCChAEAeBFHaBHB.TCFALCAAhAAAdEEAHFCBACIBUEEBZGFEMEDBhACANAIA...XFGD.KHEA..hCBA......hCCA...,1,-1,-24,23
MBSeNOdGRDXFKTAQLZJVaHIfPbECUWYgc,ZAAAaAAAHACB..fADBEAEAUBGA.....gAFBhABAMBBBeCEFdCAAREAAFEGAhAEAAAHALCCAIFFAbDEAhACACGCA...cECASGHBGGDBKHAA.hBIA......hCEA...,2,-13,-2,11
ZXPYcICGHQdgLJOMKBfAVERbNUFDaSeTW,RAAAUAAADADA.eADAZAEE.....XAGA..cBGDhAAAGCBBHCCAdCFALDHBhADAMDIBBEEAAEAAEECBbEGDFFCBhABAaEECSGGD.PHAACGAAQGEAhAGA...hAEA...,1,-11,-13,2
dTUQONFaYWScLDEGPJMCefIXRVBgAbZHK,HAAAdAAAQADAFADAaAFD...SAFALAHBECABGCABhACAMCCBeAHH.XCFDhADARDDABEGAABHBZEEATGDAhAAAOFDB.YFHBDFIBCFFDfHGBhACAgGAA.....hCDA...,2,-15,11,26
MeWbOFgCJfDKUZcVPHSaLQNTXIYGAdREB,EAAAeAAA.OADCCACADAEA.ZAGB...VCCAHAFC.aBCELEFAhAAATCEA.XFAAhABAGDGARGCAMGEAFDDHfFFEhAAAKGHBPHECSGCHNIEBACIB...hAIA......hCAA...,2,-12,-1,11
XVGPIMSYOeRQZTKacJDfEdANHWgLbFBCU,HAAALAAABADBXADDGAEAMAHB.OCABRAFAZCAAaCFEDAIBECCBhAAAAAFA...NDGA.bDFAhABA.FEDDCDHA..PEDDhACASFFA..eFHBKGHB.fGAAhAGA.WFFD.hACA...,1,1,-22,23
ZTGISKNADfXgQeLbOBVEHRMcYUJWdPCFa,XAAAeAAALAEABADAHAEBRBCB.MAHBUCEA.dCHAFCDHZFAAGDAAhAAAKFFAAAAA.DAIB.QDFDhABAOFHDEHDAcFGChADA..........hAGA......hBGA...,1,-15,-21,6
TdSZOUQeDEMVHGKfRWgJPNYcCLabFAIXB,BAAAdAAAZABBQACAEADAHAFAGCEARAEA..JBHB..PCHBhAHANCAA.CDCA.LDDAhAAAaFHDAGDA.TFDA.hAIAOFADDGGBMICAfFFB.YFHBhACA.FGCH.IHFAhAFA,1,-10,-18,8
cHUSWLYDeRZfIgMJNKGEOdTVPQXbCFaAB,HAAASAAALADBeACHRAFAZCFA..fAEAMCABKDCDEEEAhAAAdAGATCEA.QDGAhAAAbEGDaFADACCABGFChACAcDDC.UEAADHCA.gFGGNIAB.hAFAGGBB...hAGA...,2,-2,11,13
dFNTGVPXIWZSRCYEUBabDgHLAfKQJMOec,QAAAMAAA.eACAdAEATAGAGAFAXCDCZBBBRCFB.EAHBhAAAaDCDDDAAHEDBLDHBhADAABBBKCHBOFHBFECHPEEBhAIASGAACGFABHHA.......hBFA......hCAA...,1,2,-9,11
OcNCIQbadJWDEGBRAFVUeMKTSHZYgfLXP,FAAAeAAAMADAKADAHAFBZAEE.....fAHELCCAOAHDhBAACCCAQDECdDGADDBBhBDAEDHBREEBAEIBUECA.TFGAhAAASGCAXFAB.cGFCIGHAhCAA.....hABA...,2,-22,-9,13
BTPDZLHJAfSVOYMcaGdNRKgQWbUFCXEeI,SAAAOAAA.MADAGADA.RAFAQCGAUBDACAGA.EBBBhAFAeAHHBDBDTDFAhAAAZEFAHFDAACCA.VGAAaDHDdFCAhABAKGHD.bFFC.IHHADDDB....hCAA......hCBA...,2,-19,6,25
TPWASRfCaOUcFEeGIZYXBDbJgLQHMdKNV,RAAAaAAAOADA..FADAEAGAeAFH.ZAGBBBDADBBB.JBHBLCCBhBAAHCDCdEEDKDHB.TEEAhBDAAAAACEHAGGCB..hCAAXGEAQGGCMIBANCCA.....hCGA......hDAA...,1,-11,-18,7
LPIZRGcVKDYAOEFNaCTbWBUgSdMXefJQH,EAAAaAAA...CACA.TADABAEAUAGA..dAFAeCCAQCCChADAHDEALDHBZAGBREEAcFDChBAADEAAACCAFGBA..hAAAWBHHMFGB.XGDDfGGA..hBBAIHHA..hAEA...,2,-24,-8,16
YJGBOcNQWMbAafZKVIRUXLTeSEFgPdHDC,ZAAAKAAARACFLADB.eAFAEAEEFAGAdCAAHCEBDCAB.CBHA.GCDAhAAAOCCHQCFAhACA.MCIBAAFAaCGCIFCAhCBATEGASGGA..gFFAhCFA.YHDAhDBA.,1,-10,-29,19
HOEgMKQafUeALIRcPbWFVTSCNDdJYZGBX,RAAA..bAAAFADA..SAEADAGAdBGAZCCAGAGAHECA.ECAAMBIBhAAAaCDDUEAA.AAAALDFBhACAIEGA.PEHDhAEATGGACFCB..YFEFOGCE....hAFA......hAIA...,2,-23,-3,20
MOHRIdCGZJAEWgTUbKPYaeNDXFBcQSLfV,EAAATAAAKACA...aACAeAEE.DAIBBAFA.QBGAhAAALCCAMCGBHCCARDFBdDHAZECAhAFAAECAUFBAPFHDXEEDhAAASHAA.OHECCGHAJHEA.WDBD.hAHA......hBFA...,2,-20,7,27
UZKWCfEFYDVLQTPbXJMeIBNcGRHSaAOdg,dAAAZAAACADBEADA..DAFALAGB.TBEAXAGA.eBEFhABABCBAGCAAHDCAAAIBOCFChACAKDADFDHD.QFFChACAbEFA.MGBAIGEANICB.SDDDhCAA.aGGB.hADAWHCG.,1,-3,-34,31
LSNXfIPKaJBZdWTOCYUEecHRQVAgGbFMD,GAAAMAAALAEASADA..fBBAKAGAaCDAZCFBdCDATDDAhAAACBHAUDFA.EDBAHEAChACARFAA.AADAFCHDDDIBXFEChAFAIFHABGAAOHECcGGC..hAGA......hAIA...,1,-7,-9,2
NHYGMUQXSPBKegRTOIEJDACLbcaWVfZFd,LAAAaAAA.VAEAZACBdAFA.HBGBGCAAMBBBQCCAhABA.SAHBhACAKCEDREBATFEAECGFADFBCAHB.bEFAhAEAfEHAFGGB.NICB......hCAA......hCCA...,1,-5,-13,8
LaFKACbgSBXGYETHPNRDVfcJWZeIUdOQM,CAAASAAAGACA.EADAHAEA.RCABDAGAVAFA..JBHBeCCAdDFA.hAAAMCIBLEEDKDAAAAAABDEAhADA..TFGAhACAfDGA.ZFFAOEAHaGDBFHFAXGCDhAEA....hBCA...,2,-13,-6,7
ScXFOULTMINZgfCBHaWAVQGdDYeEJRPbK,GAAAdAAAeADARADAKAGC..XAGAOBHDLCDAMCCAZCDECCHDHEAChAAA.AADADEEAEDAAJEEAhACASEFAFFHD.TGGAhACAgEAABHCA.aGGH...WHAAhADA......hAEA...,1,-8,-16,8
IFNGEQRecUaLJSOMfdCXgAYVHPKBZTWDb,HAAABAAAZACATAEADADA.FAGAGAGA.RCCA.eCAA.aCECLEEBhAAAOCGDdEAACEGDAAGB.PDDBhAAAKGGA...bFEDhACA.EGCB...QGGA..hADA......hAEA...,1,8,-44,52
BSLTKVOHWZPeQabcJdFEADfUCGYgRNIXM,DAAACAAAGACARABA....XAEBMAEALBEBKAGAHCDAZBGBeCGHhAIAaCAB...bFEAdFFAhAAA.ABGBUGDA.NCIABHGAhACATGCA.ODCB.WFHH..hBAA......hCAA...,2,-21,-15,6
FXfVBWPDUSLQJGOIZMHNcgdCKTbAaEYRe,EAAARAAAeADEFACD.....XAGBBAEADAGALCCAGBEBZDDAhAAAHCFB.NBIA.dDHATEBAhAAAABHAaEAA...fEEEhABAPFDB.QGGAOFFB.IHDAhBEA....hCAA...,2,-25,-9,16
aICXAfSdTOEVUZYWeQPHLBKMGcbFRDJgN,dAAAEAAAZACBeADAHAEALAHBMAIB.GCABFCEHRCGB.DBGB..JEFBaCFHhACA.CEAA.AAGA..TGCAhAAAOECC.UFGA.hBCA....YHBA....hADA......hAEA...,2,-20,-18,2
ZfCcKMPFLOAaUdeDSVIgYXHJTWbQEGBNR,dAAAeAAASADA..gADAHAFBTCBAQAGAhAAAEAHBGDEARCDAZDFECDADMDHBhACALEAAADEBDDIBIFGAhABAXECDbGAAfGGEKGHB...hAEA......hAGA...,1,1,-6,7
RPNCJWeSUcTdFaXBMLbHIDVQYAZEKfOGg,EAAAOAAARACA..CAFB.eADA.UBGAdAHAaCCCMBBB..HCEBDCCAQCEAhAEAACGBZDAAGDGAhAAA..PDDBJHBASGGDhADATEGABFFD.LHAA.hBHAIHHA..hAHA...,1,-6,-21,15
AeFVGNZaXIPLcDQEYJSWRTBOMKCUgHdbf,eAAAGAAAZADBaADA..XAFALAGBQCFCEBFF.SCCDhAAARCDBTEBAMAIBhAAACDHAHFDAbEGBAAIBFFHBIFFAhACADDBBJGAA..WFHH.....hABA......hAGA...,2,-10,3,13
LSMYJHUWeGOCDFdXQTVNEKbAcIaRPBfZg,aAAARAAABADBZACB.LAFA..MAFAHCCAeBEAGCFADBBBdCHAhBAATFCAEDEA.AAAA.IEBAhBEA..fCHEhAGASEDDYFFFUFFACHDA.FHAA..hAHA......hCAA...,1,-16,-19,3
egUXFELWMDKQOYAHTBfVGPJSbNRZCdcIa,HAAATAAABADB.GAEASACBRAGBdCAD.aAEAeDCF.XDFDhAAAEAHBMBEB.QCFAhAAAAAIB.fCCEhAIAPEDDbGACZEFACFHAIHHAFFBALHDAhBFAKHEA......hCAA...,1,5,-7,12
ZYXKAbPCTQeNHGRDMfgcEIdBFaLWSOUJV,CAAAeAAAHACARADA.DAEAMAHB....fAGAECCBdCFAFDHDaAHDLEABhAAA.OEDChABAVCAAZCFAKGGAAAIBbDEC.hAEAQFFA.GECA...hAGA......hCAA...,1,-2,-19,17
DLRXYFbCVaZNGfdPIJgAcSWBOHMTEUeKQ,SAAAOAAAHADAEADAeAFE.DBBBRAFAFCCACCCA.ZCFAGCEA.hAAAdCGBIDAAADHBBEDDMEIBhAIATEEAKGFALEGBhABA.bGAA........hADA......hAGA...,1,-15,-18,3
dTVcFPSNHBDIGgWMURJLXAbeaQCEOZKfY,eAAAaAAA.EADAZACBKAFAdAFA....TCCAFAHBSBEDhBAAHCEBDAIBGDGAMBBBRDEALDHBhBFAAAAAbGCA.QGFChCAAfECE.YHAA...hCCA......hCIA...,1,1,-18,19
MQVGBgOJCESWdPKIRYUeaLXcNTFHZbDfA,MAAAGAAABADAOADA.EAGAdAFA.KAHBRCDAeBHFLBBB..hAHAXDBDTCGAHDCBhBAAbEFAAAAB.QEEChBFA.gGEASFEDIHHAhCAAaGCBFGGBDIDA....hACA...,1,-6,-7,1
HIdYKZOVbTfAXWNQgcaLeSBFDERUMJPGC,XAAAQAAA.aACEeADA.FAGDRAEFMAHBGCDAHCFBdDAAZCFAhAAAOCDB..bFFAAAIBgDAAhAAALDCDDAIBhABAEEEBPHEACEHAKGAATGGA.NICB...hADA......hAGA...,1,4,1,3
dVDJgSbEULBXYFHcZMaAeKROGfNICPQWT,RAAAGAAA..fADBCADAQAFAdAFADAHBSBHB.hAAAECDALCCBBDCDFDFAhAAAHDGBZEEAADABeCEBOFAAhACAIGDA..WEHH....hADA......hAFA...,2,-24,-18,6
QJMUKbdfGCZRPEDLOYIXVNgWaHABTceFS,TAAAeAAAQADA.MAGBbACBGAEARCCBDAHB.LAGBhAAAOBHD.XDGAhAIA.gEBAhBEAHEFAAAAAFFBBSEDHKFDAdGHACHEA.EFFA.IGHAhBGA.NIBB....hAIA...,1,15,-10,25
RDKLUVYGPgIOAHCXTNJQZSMdEfWacBFeb,HAAATAAAQADC.ZAFBdACAEAHFaAEAFCAHRAGFLBEBhAAAUEDAGGEBIECAACCBXFAAhAAASCHH.hACAMDGBfDHABCDAeFFDDICA....hAIA......hCAA...,1,8,-19,27
bHTABCaUKVMGRZgQFcSNWDfJeXLYEdPIO,aAAAKAAAGACAZACB.QAEASAEADAHBeAGHLCAB.hAFAECHFdCEA.OBBBhAIAHDFBAAIBCCHAMEDBREDBFFHDNIEBfEFAhBAA.XEGDIGBABHHAhBIA......hCAA...,2,-20,0,20
EAQWIcZeGaCXbLfSFKHPBRUYJVgDMdTNO,QAAA..IAAAeACAaAFDbACALAHB.FCDBhAAAHAGBRDABUEEAVCAAMEHBhADAdDEATEGAEGDBABHB.hBFAZEAA.GGAB.fGEBSGHHhCAABHHA....hACA...,1,4,-10,14
DALdfJCbUWRcSKBXEZYTVMFNeOaIPHGgQ,dAAACAAAUACARADAKAGC..BAEAZABB.....TAGAMBIBeCEAhAEA..aCBCHDCAGCEAhAAAQEFAACGBLDHBhAGAbFCC.SEDDEGHFFHDA.OGFC.hBAA......hCDA...,1,-6,-26,20
ZNAdMcSEDeCUHPFGaTfRXgVJWQOLBKbYI,dAAAMAAAEADADAEA..eAFAHAFCGCAB.aBGERBBAXCEAhAIA.VEBAQDEAhACALDHBbDGDZEEFADIBCECA.hBAAFGAAfEGA..gGEBhADA.....hBBA...,1,2,-14,16
UEdLIGgFeAJTYXMHKCNVcfSbRDBWZPOaQ,TAAAMAAAHACC.CAFB.VADA..SAGHRAGFBCADZCCAaBBCEDGBhAAAdDDAGGABFCFHAAIB.XEEChACAKCHB.fFHAhADAbEGDDFFB.........hBAA......hCAA...,1,-2,-26,24
eJOMdLfHEBTWcaCbUNFGZIPYXgVDQKSRA,eAAAMAAAdAEAHADABAGATBGA..aAHDCAHBUCDBGBBAZEEA..hAAA.IFAAXCGChAGADCCBQEDAhBAARGAAADGBLEHBEEHBbFFD.NEBA.......hBBA......hBDA...,1,-2,-15,13
WgdJXPVRZGQIUYTNaLbEDcBCHeAFOSMfK,SAAAMAAAKADA.dADA..XAFBRAFAGCDBQBBChAIAUEEB.TCEAaCCHEDHFBBHAhBAAHFAAADDBODGDhBHA.fECEJFHBPHCAZGEA.NDIA.DIAACEED.hCAA......hCBA...,1,-2,-12,10
EcTDSLeWgGAJBfMYXONbCIHPKaZdVQRUF,BAAAMAAA.OACACADAHAEBKAFAZAGB..dAHARBBBFDEH..EBCBDBIBeCDHhAAAGEGAACFA.JGAAXDGAhBDA..IGEAhAGAaEFCQFDD.TGGA.hBAA......hBBA...,1,-19,-22,3
EDPSNQHbMRAUcVZJLYKaeCGFIXfBgWdOT,VAAAZAAALADB.aAFAeADE.GAGAXBFCBBDAdCAAECEFhAAADAIBSDDDhAGAHDECRFFAACCBUGBAJEGFKFEBFHDA.hAIA.fGDE......hBIA......hCAA...,2,-20,-7,13
JTabCOWLYVHMKNIEAScQdRPgDBFGUfeZX,QAAARAAADADAGAEBeACAZCCA...TAFAaCGD...bCDBODHDhAAALAHBHECAMDAAhAAAKFGDEGDAADFAdEGABHAAhABAfFEACHHA.YFHBNICB.SHCGhADA...hAHA...,1,6,-13,19
fgHaYeNCBZWdVMbPFJKXRDSGELOATQUcI,TAAAQAAA.UADA..fACBHAFAeCFABAEBdDBAbDDChAAAFAGAXBEAhAAA.RCCBGCGAEDHFAAHAgFFBhBCAaEFHCFDAZGFE.MFIB.....hCAA......hCCA...,2,-10,4,14
PEbCHSRFUVNBegMKLWQdZDfaTOGcXIJYA,EAAAHAAARACA.FADA.UAGABAFB.eAGHMCABLCCAdCCAZCDBDDGAaBHDGDAAhAAA.XECBhADAIEGA.AEIBCFEASEFAhAIA.gFEGQGBAOEHDhCAAcGGA...hCBA...,1,-8,-22,14
HZBYDdARKgTeFLUCGINSMOXaQfEWJVcPb,RAAATAAAeADELAGB.GBDASACBMAIB.aAEAEDCBVBEBhAAA...bBGDHEGBhAAAZEBADAIBACCAFFCHCCCDOFFAhAHAQFEA..fGGE.hABA......hCAA...,1,-2,-7,5
BOWebXdUKHIZTDPQAcSJEMYgGRNaCfVFL,SAAAEAAA.MADAGACA.RAEAaAHDCAGAFBCDLDFABBEAeAHHhAAAdEAAHEDAZDEADDIBACBBJFGBhAAA...gGCBhAEAfEBAWFHHbFDAKGCD..IHAAhAFA....hAHA...,2,-24,-6,18
MREUfYdDWQBTCgZNIKLVAOFbJGHXPcSae,FAAAGAAAHACB..XADASAEAeAGBEAHBUCEBdCFAQEAAhAEATEGA.ZDGBKDCBhAAAADEAOEEBbFED..hAFAcEACaFHDMIAAfGGEDGFB.CAHB..hAIA......hBAA...,2,-4,-3,1
XBUcOCbNEgHDVYKJeZaPSWARQGFdTMfLI,RAAAGAAAdADA.MADALAFABAGAUCDACCCD..ECEAHCFA.DAIBhAAAKCGAeDBHaEEA.SEFAhACAAAAAFEHB.TGGAhBAAXGAAOHCA..gGGAhAGA......hAHA...,2,-33,-5,28
BdJeELXGMDcNRUCVWbSFOAQYaKPfIZgTH,aAAAKAAA....IADAZACBHAEA.dAHAEAFAGCEB.MBBBhAGADAIBRBGBCECA...bCAAOEEBhBAAACAA.QFGAhCAAfCEABGFDeDFF.LFAANIEB.hCCAVGFA.SEGAhAAA.,1,2,-28,30
RVHgADLQbSNcECYJZXMTIOKaUfdBGFePW,LAAAQAAASADHEACA.CAFAZAGBMAFA.TBDAKCAAUDDAhABAdBFAGCGA.hACAeDDBREGBHFAAABHAbFEDcGCDhAFAXGGA..aGED.....hAAA......hCAA...,2,-9,-5,4
PcfbdgFEaGVSHCOeMKNYUTXZJLWIRAQBD,QAAADAAA..fACAdADAEAFAGBGAHADBeAFAMCFBKDBAhAAAUCGAZDDFLDFDhAFARFAAAAIBBFHAbGAAFGFDaBBHCHHA.hAFAOFHB.NEEA........hBCA......hBDA...,2,-5,-1,4
OWgYXbKNIAdaMVHTLSDQeUPCBJcGEZFfR,aAAAHAAALADAQADCUCCABAFB.GAGAEAHBZCFARCAAOCEDhAAA..gEABhAEAbDFDKEDDAAIB.dEFAMDIBhACATGCAeHFACFHAFHEE.YFAF.IHHAhAFA.DBBB.hCAA...,1,3,0,3
WVIaLMeUfcDbRYTHBPSFNXdGAQOKCZEJg,QAAACAAAZACA.EACAJAFA....gAEAVCCA.aAGDhAAAeCFHUDCADCHBRDGBHEEBhAFABDAA.FGDHdFGAAAIBKGHBhCAA....WFHH.....MIAAhAAA...cEADhADA..,1,-5,-40,35
YLGMEXIRAaJQTUeWKSbPBVdcCHDNZgFOf,aAAATAAA..eACHSACBBAEAdAGAHAEAZCEAFDDHOAHDLEABhAEAECCBRCEAAAGA.QEAAhAAAKEGD.bEEAcFCChAIADEIB..fGEAMBIBIGHAhBAA...WFEHCGGD.hAEA...,2,-17,-5,12
DaZLbWMeFPJTQCSVNGgcHBRIdfUXEAYKO,OAAAZAAALADB.MAFAeADA.FAGDTBFAQCCA.hABASBHHGCAAHDEAhACARCEBdEAAXEGAhBFAABBBDEHBbGDAPHBA.CGGA.NEIA......hBHA......hBIA...,2,-11,-6,5
NLcQUfJBDdOEPIKZAbHXWCgFRYTaGSVMe,HAAACAAARACA.aACAGAFAMAFA.LAHB.QCAAfBEAhAAADDDAEBGAKECAACCAbCFA.hAAA.XEEDFDDHTEGAhBGAeEHBUGEAdFAAOHBCIHHAgGFAhACA....hADA...,1,5,-5,10
CHRdaWKFObTeIVQGfUJSPcLNZMAgBYDXE,BAAAXAAAHACARADA.aAEA..FAGAOAGDeCDA.QCAAhAAAGCGAUDAASCDAhACALEEBZDFEAAAADFIBEECAdFGAhAIAKGGD.TGDA........hBIA......hCAA...,1,-4,-15,11
aIefbHFLAXTVPYNKcZCUBWGMJQgDORdSE,TAAAVAAA......PADAKACCZAEBBAGAGAGA.MCCBhAAAQCDAODDBREFBhAIAEBHFeEBDHDFBADIBXGDAhBEAcDCCCDHAUGCA.JFHBDGIB...hAAA......hAIA...,1,-3,-13,10
bPCVgKQeaNcLdDRSOWEHXGFTUfIBJMAZY,ZAAA..bAAACADBKAFAeAEA....aAHDLBHB.RCAAOCEAhAAAHCAAGCEATDEAhABAfCGEBEADACAAPEDBhACAQECCdFGASFAAEEHFFFABIHHAhABAMFIB.YHAGhACANIAB.DGGB,2,-7,-4,3
DKfSRVIJWYaLOBbHdGPZFQCecTNEUgXMA,KAAARAAA..VAEAJACA....aAFALAHBBBFA.HCCAGCCAhAAAZDAFQDFDhAAAeAHH.TGFAEDHFXEFDhCAAAEABSECA.IHCAOFDD..hABA......hADA...,2,-29,-9,20
EfIDOJWgXLGYNVCRbAeMcHPdUTSBaFKQZ,eAAAHAAAdADAUAEATAFABAGA..KBCBEBHF.DCABOAHD..hAAAgCCGGDEAVEBBhABARDFBAAHAMDIB.SFAAhAAAaDHHQGGAZFCBfGHEhACA.IHEAXGDDhBEA...,2,-20,7,27
cQVaGHdUAfBMgYOTCeDWISbXELKPNFRZJ,MAAAOAAA..eACADAEA..SAFAEAFALBHBKBBDFBEHRCCAZCFBhAIA.QFCAhBAAGCFAHDBAABBBBFGA.YFHBhCAACBHAbFGD..PHDA.NDIA...hAIA......hBAA...,1,-5,-19,14
AbMHWPKdGZgeSIDJNVQCXLOTacfUBFEYR,HAAAKAAAZACBeACEDAFA.VAGB..QBEALCCAaDEEUCAAEDHFhAAAAAIB...MECBdCGAGEBBhAAASFABIFGAhACACFFAOFHD..fGHABHGD.hAFAFHBA.....hAGA...,1,-3,-20,17
JIWKQaMPEeNBROUgVXAHTZLfCFYcDGSbd,HAAAZAAALADBFADADAGAGBEBdAFA..IAHAQCABaCAA.hABAEDCABCGARDFA.OCHDhACAgFDA.ABHATGGAhAAACDEASEFH.bFBA.KFHDMIDAhACA......hCDA...,1,-5,-19,14
bRKDLWCZGAeEdcFfNPQgMTIYJXaVUHSOB,EAAAdAAAFADA....fACAQAGAMAEATCBA.JCFBhACAaAGE.HBDABDHARCFALEEAhAAAZECBAFCB.eEHHhBFAPFGB.gGAD...hCAA......hCBA...,1,-14,-21,7
fNQPKOACdWXYFDbEaVIgLBHTUGZeSJRMc,dAAAXAAADADA..EAFAaADA...VAGBLBDB.HBFChACAGBCAeCBFRCEFMDIBhAAAfDFAQGAAhABAODHDABEBCEGAFFDBbGEABFGD......hAIA......hBAA...,2,-23,1,24
geJGWLDbKZdfQAUETacIBOFXMVHRPNSCY,EAAAaAAABADAFACD..MAEAHAEB.RAGB.SAGACBBD.eBDHhAAAGDAALCFAbDCBdEEAhADAACGATEEAODHDXGEAhAGAPEHB.NIAB.gFBA.DGEBhBFA......hCAA...,2,-19,-1,18
XIFMeRYQcWZLJGAdVTKgOSEBfbaHPCNUD,dAAATAAAOADA.BAGAaACAHAEB.CAGADAIBFBDBRCBB..QCCChAAAZBFEGDFAACHBKDFAhAGAEDHB...bEECPEDDhACAXFGA.eDBD......hBDA......hCAA...,2,-25,-9,16
FLGTfUMBHaceKCSPNEDWJgQIbOYZAXdVR,dAAARAAAGADAUADAHAFAeAFA.KCBA..SBGAECGA.DCCBJDEBhACAQDFA.hAHAbDADZFGB.ADIBFGEDTFDAhAAAMEDBaFHD.CDHA........hAIA......hBAA...,2,-25,-3,22
DARNXWFJfHSMcCEUYOdBeITGVQbLKgZPa,RAAAXAAAFADAHAFB..MADAEAHB..OCCBeAFAGBCA.hAAAbBFALDEAZDGFaEBBAAAAhBEAJEHB.SECHhABACEEAdGEABGGDIFFA......hAIA......hCAA...,2,-20,-3,17
KYBGHCeDTOUZFVAcbEIMJdaLSRgPWQXNf,EAAAMAAAdADALAEA.RBBA.PAFA.QCBCfBHAhAFABBFDHCEBeBHFTEGAhAGAZDEBADEBbGCAaDHDSDDDhAIAXGEA.KGGDCHHA.DGCA.....hAAA......hBCA...,2,-17,4,21
aLeXKdSJOTPHGIAVgYUbCMDfBFWcQZRNE,VAAAUAAAMADA.BAGAFADAQAGA.RCDA.EBDAeDCBhAAAdCFAOAHDHEFAADHA..hBAAbGACfDBAhBCA.ZDDBaFEHLEHBSGHBTFFA.hAGAIHDAYHEGDDDBhBDA.WHFG.,1,4,-12,16
ECYZBDQUKLTdFAWRPIHVOcbfNeXGgJMaS,RAAAHAAAOADA..bADBeAGFGAFA.MAIBEBDFZCGBDCABQDCChAAALDEBdFCAAAHBIEHAhACAfFHAXFBChBFAaCCH.CEFDBGGA.KHDA....hCCA......hCDA...,2,-16,-2,14
LfEdeJXgTNZcIOCPVRaBHDASbMYKFQGUW,MAAAFAAAGACALAEAEAEA.eAHH.JBBATAGA.ZCEBOCDEhAFACCHA.REEAHGAAADGBSEAAhAEAKFHB.QEGAhAIAfGGEXGGC....hBAA......hCAA...,1,-13,-20,7
LUANdWEHDeMJGFQVRObPYfgZSBKTaXcCI,dAAAHAAAeADAGADAQAGARAFAOCAB....bABDfCCEhAAAZCEAKDAD.aCFECEEALFCBhADAACIBEEFAMEIBFEGHPFAChACASFHHBFEDXGGD..hADA......hAFA...,2,-7,3,10
CEcVOMZbWDeNgfFdLGKJaRBHITXPUASQY,QAAAEAAA.OACCbACA..eAGB..fAFBhAAAdCCAGCFAaAHDHDABTCDAhAEAXEDDACFACDCDMDGBhAHADAIBFEHDLDHBKHAABHHAIFEA.SHEAhCAA..hCDA...,2,-19,0,19
QXEBCDbefJRgVYGIaKNUAOPTHWFdcLMSZ,TAAAHAAAdADA.MAFAZACBEAEADBFA..eBHFRAGB..VCEBGCABhAAAaCAH.KCFB.ADIBOEEBhACAFDHDLECBQFGAhCAACFGDfGHAJFCB.......hCFA......hEAA...,2,-7,-5,2
CPMRSQEBaGgNIFfZcAVHDJebLYOKUdTXW,HAAAeAAALAEAKADCdAGA..TCCACBCARCDAEBHFGCEA.IDHAhAAAZDFEAAAADECB.JFABbFBAhACA..OFGBUGGA.hAIA..XGCAMIBABECDaFHD....hBFA......hBGA...,1,-3,-15,12
UOadVFKLWERPJbfSNQeAcGMYZICgHXTBD,GAAAZAAACADBHAEBBADADAGAaAED..dBGAKAGALCABRCEA..JDCBhAAASCCD.hACAeCHHACHAMDAB.gDGAhADATEDAOFGBFEEHEFHFfGEAhABA..QGADhAGAIHHA,1,-20,-27,7
CbYZWIfSVRaXKMHdEBJDUcPTFgAeLQNOG,eAAALAAAQADAGADACAFAZAFB...fAHARAGFaCAAMCIBhABAHCCBBDFADCIBUFAAhACATEFAADDB.OFBBhAAA.YFEFSEFAKGHB.EFDB.cGGAhAFA.....hABA...,1,-5,-12,7
RPYLBdNGUIcbKCZSXOADWHaMeQfFVTgJE,HAAAeAAAQADAFADA..TAGAEAFARBGBLCCBdCADGCEAhAAAIEEAbDCDZGAAOEHBhACAAAAAaDGH.MIEAfFHAhAIA.........hAGA......hAIA...,1,-2,-11,9
GXKJEPdbcfUSANHgeOFZaYCWLMRTQDIVB,HAAAeAAAZADBaACACAFAMAGB..RAGF.DAHBBCCAGCEAKCEA..EDHFdCCChAAA...bDGDfECAhAAAAAIBODBH.FEEA.hABALFABIHHAXFGAcFBDNICB..hBDA......hBFA...,2,-15,-13,2
SRCQFEfKWVbGMIcaBeLNPOUXYDHTAJdgZ,dAAAZAAARAEAQADAFBHD.EAFAKCAA..VBGBGCFA.MACAhABAaCAEeDCALDDBOEFBhACA.UGGADECBHFGBhAHAAAIBSGED..WFFD...hADA......hBAA...,1,-11,-18,7
SGBAcIPMQKYOaCXHNRWdgLZbTVeEDUJFf,..IAAAMAAAQADAKACA.aAFEHAEB.RAGBdCAAZBBFbCFAhAGAeCCB.EDGBDEEAFEEBGEGAhAIAAAIB..PFGBhACACFFCXGCA..gEAA.hBAA......hBIA...,1,-8,-17,9
YESgTZFNDKWQJHcGALfXbIVePaOBCMdRU,LAAAXAAA.VAEAeADA...aAGDCAHBRCAAUCDA..ECEBTDAAhAAAZCGBDDIB.QEABhABAHDFBAADAbFDDOEEBhACAdGBASBHHFGGA.KFHB....hABA......hAIA...,2,-12,-3,9
dQcUYbBeDSPOAZXMaLgFGfJVIWTERCHNK,ZAAAaAAALADAGAEAJAHB....IAHAECAAHDACdCCAQDGBhABAUCFABCHAeDDHhACASBBDAAGAMFFBfGBAhADATEAAREDBKFFCcGGADEIB....hAEA......hBEA...,1,-4,-17,13
gXLcJdAaQIbOSeZPRHWBTVMDYUKENFfCG,aAAAQAAA.OACCeACHRAEAHAFBTCFAMAIB.DCDBKBHBECEBhAAAFDDBGDGALEABhAEAdEAAAAHBSECDhAFA.ZEFABEED.UGEACGGA.....hAHA......hAIA...,2,-15,1,16
BLSUfbWAOJTIaPZRGKdeFcHYMVCXQNgED,TAAAaAAAZACB..RAEA.dACA.eAEAHCECMAIBXECA.QFAChAFAEBGFLCEBfDHAhAHAAAEAODDBIFFAhAIAGEGAFGEB..YFHB.CBBDDHCAhBAA.....hAAA...,2,-14,4,18
ELFOAJBbVUWdgIKGTHPCNaeMXDYQSRfcZ,BAAAUAAAdADAKACAHAEB..CAFAeAGHMAHBDAIB..QDBAhAFARCAAZDEALEAAAAIBVDEBhBAA..IFFAhAAAGEGAPHDAaEHD..SGAA.hBCAEGDBOCHF..hBDA...,2,-15,-15,0
JeafETNDdKVYgMFbXCSRUWOQZPLcAGIHB,HAAAeAAAEADATAEAdAGA.KAGC...VCCAMAIB.XBDAhAAARCFFOBHFZDDALDABhAAAACCBGEGABEHDaFFHDGBAFFFHSHGAhACA..WGBA...hADA......hAEA...,1,-5,-10,5
WUAcXgRVMGBQbZOYIfeLKJdPHFSDaTENC,XAAARAAAGADAQAFAZACB.OAHFfAEA.eAFHhAAALDAAdAHAHDEChABADDFAEEFACDHBAEDB.VFAAbFFAKHBAhBHAFEHDaFEC..WHFG.....hAAA......hABA...,1,-2,-6,4
cAGYDXTbJLKdRVgWHfMOFaEQBZIePNUSC,GAAAXAAAJADAdADA..RAGF...VAFAHCDA.MCIBaCDEECHFhAAAZEFBeDBH.UGABhAAACDBAADGBTEEALFEDKEHBhABAfHGFQFAA.BGGA.NIAB..hACA......hAGA...,1,-2,-7,5
LMTXcFDUZbORHEIgAWaPfSYJQVdCBeNKG,aAAASAAA.QADAdADAeAFAGCDBMAGB.TDBAhAFAFAHBZCCAREEAHGAAECHFAAAA.fFHAhAGAVDABBEEDKBBDhBAALFGBDCGAOHECgGEA..hADA......hBFA...,1,11,-11,22
XVWSBNeOFRYTMEPJIbAKdaDUCgQfHZLGc,aAAACAAA..QACAHACBGAEB.XCEDSAEABCGAeAGHhAAAREAAMBBBECAAIDDAhACAAAEAdEHADFFA.UDFBfGGEhAHAZFAALGFA......hAFA......hAIA...,1,-6,-16,10
dcNVCKRIQWTAbSBEGPOHaXMZfLJgYeFDU,BAAAEAAAGACAHACAaAEAZAEALAHB.JCBFeAGH.DAIBdDFAhAAAVCAAREDBQFAChAFAACFBSDEDXGCDhAGAMDHB.fFHAFECDcFEDKHFA..IHHAhAAA....hACA...,2,-28,13,41
dKcNFXbTOAgQPUVYfBEIZeLaCRSHMGJWD,QAAAVAAA.BACAEADEZAFBeADHLBHBRAFAHCEAGEEBhAAADCDAdDDAKEGDFFAA..bGAAACHBUFAAhAAA..fGHAhAFAaFED.SHEAMFIB...hAFA......hAIA...,1,7,-20,27
dHXMECQIabSNUKALgZYPeBFRDfWGcTJVO,ZAAAeAAARAEADACAGADA.JAFAdAHA.HCCCECCB.QDFA.hAAA.bCFASEHBhABAKDBDACGALEFB.gFBAhABABFAAfFFEWEHD.TGCAhAFA......hCAA...,2,-22,-8,14
ZAWGEIdOUKfcbHXRCgJLDNPaeVTYSMQBF,EAAAdAAAKADA....bACAHAFB.RCAACAHALAGBDCEB.aCCAeCHFhACATDAA.MAIBhAAAQFAAZDDAAADAGEGAhBGAODEDfFDAXGEANEIAYFFFhCAA.SGCDhCBABHAD...,1,-4,-15,11
ZbJXOPNIYGHUSLacFedWQRVKABETMCDfg,EAAAMAAADADAZABE...JAFAOAEE...IBCAHBDCLCHBhAIAaAHD.eCCBhBAAdCEARDFFADGATEEACDDC.hAAAbGEAXFGD.PGCA.YHAAhAHA....hCAA...,2,-31,-13,18
UVXCgQSPNHAfIdecGYBZKObMFTaLJWRDE,dAAAeAAAGADAZADBOAFCMAFA..FBFAaCCBLDAA.RDFADBIBhACAECFAXDFA.hADAQFCASFDAhBAAHFFAACCBfFHAIHAABHHAbGDA..hAAA......hABA...,1,-8,-15,7
UQNIJKFWZcSXBHTdGfgPCEDVMbeALRYaO,RAAAaAAAQADC..IADAFAFAZBFE.XAEDHDDAGDGAhAAA..fAGBhAIACCCDEFFBMIAAABBBLCCBhBAA.OCGDNIEBKGDA.SEDHhBGA.dFFA.DCIB..hCAA...,1,0,-27,27
AEdfQOHXFgIcRGBUCYNbPVeKaZSJMLDWT,EAAAdAAAQADAHACAFAFA....gBGARAFAGCABCCGA..hACAbCCAeCHH.ZEEBMDIBhAAALFDDTEAAAFIBXGAAhADABECBUEEB.PHEAaGFD.DIAA.hAGA......hAIA...,1,6,-5,11
YIGgcQMPKHXZeLDWEOCNUSTbBAaVJdFRf,aAAAdAAARADA....IADAGAGAQCBAMAFA.HDDBhACAeBBBLEABEBEACBGASBHHhBAAbFGBAADA.FDDAhCAAfCFEgDGG.KFFADGGB.NIAB.BGHAhCDA.....hAGA...,2,-13,-8,5
SOaJFGVXPQZBYHNMcfDEUegRALCbIdKTW,LAAACAAAdACA.TAEAOAEA..aAGAGBDA..XBGDhABAZBFAHDFAMCAADCBBEFFBhAAAeCDFAAIBKFHBSEAAhACAFHBA.QEEABHFD.cGCAhAEA.fEGFhCGA...,2,-19,-19,0
UdDCMHgRPJYEGBQZNWKSIfbOcAaTXeVFL,aAAAeAAALADAdAEAMAGBHAGB.RCCA.JAHBEDFFGBCAZEAA.KDHBSBBGhAEA.bEGDhAFAAAAATEEA.FEBBhAHACGFC...gGEA.BHGANEEA.hAIA......hBAA...,1,-6,-15,9
THaIRXNFYBfcGDAgSQVLKJUCPZEWOdbMe,QAAALAAAKAEACACAZADBEAGE...dAGAeCAAHCEBRCEA.FCHDBCHBhABAGFBBACAA..SDDDhACAUGGA.OEABhAEAMIAA.aECH.XEGA...fFFEhAIADDCB..hCEA...,1,-11,-25,14
HYcBPIAUMbafXZTNFVOJCWEGegQKDdSLR,MAAAaAAAZACBFADD..OAECCAFA..EAHBeAHH.KBBDdBBARCEBHECBhAGABCEAACGA.UDGAbFGB.hAHA....TFAAhAFA...VFEB.....WDDGhAIA.....hBAA...,2,-31,-21,10
IVeUWXCBYgHZScMTKfdNALJbGFEQDOPaR,LAAAGAAAEADAQAEAOAFC.RAGBeCAAXCDABCEDHCGBhAAAZDDAMDIBTECAdEAAAAHAFFFBhACAaEGD.UGCB.CGHASDADhADAfGDA.......hABA......hACA...,2,-15,9,24
HbULgYNWScTRCXeJPEfBIDOdZVGKFAaMQ,aAAAHAAALADA..gADB.NAGA.SAGHhAEA.RCCAeBHHEAHBBCADhAAAOBBBZCCAGDGAhACAADGBbEECUFAAcEECTGGAXFAA.fHCFhAFADEIBKFCBMIAAhAFA...,2,-9,-1,8
UOCVLWecDTPKHEdFaZMbNAIRgXJBQSGYf,RAAAXAAAQADCGADAUAFA..CAFALAHBeBHHDCCBKDDAHCFBhAAA.EDAAdDFAZFAAMEIBhAAAAADBIFHABFGASHBAhABAOFFB..WFDB.....hAIA......hBHA...,2,-24,-1,23
ZgIcYHdeUbTMOfPGBaLNQJAVWDXFKCESR,DAAAKAAAEACERABAZAEB......IAFAHAGBeCDDUCCAMDGBhAEAOAGDGGBBLDFAhAAAJHFEAAIB.XEAChAEA.SFCA.gFFAhAIA......hBIA...,1,-24,-27,3
GdOgcJKCDVHfWSRINZFLbMXEePTQYaUAB,dAAAOAAAJADA.DAEAHAGB..SAFARCAAZCEFLEDBMAIBEBBBhBAA..eDGBQBDChCAAaFHDAAIB.GCFAhCDAKGAA.fEEE.IFHANIDB.hACAFFDH.....hAGA...,2,-17,-7,10
eaATKUfWDJEPXLcCGbMYVRHSIZBdNOFQg,TAAAKAAAUACA..DACAEAEALAFA.GBDAMAHBRCDAHCFBhAAAZDFEdFGAFCHFeCCD.hAAAAAGAfFCEhBDAPGBA.CFFD....YFHB.IHFAhCAANIAB....hCDA...,1,-8,-29,21
NSVHgBKLWdRfMIUFCPTZeADbJXYaGcQOE,DAAAXAAAGABB.QAFCEADA..SAFAHCCCKBHBdDGAhAEARCDAMAIBFFEBTGGAhAHAAAAAbCGD....aDAAhADANIAB.BECA.LEFD.fGAAhAGA.CGCA...hCAA...,1,-11,-17,6
KZBeYSAMbXGULaHgWNTQDfJFdIOcVCRPE,MAAAGAAALAEAHADA..gAGBTBBAQCEAhAFADCDBFCEDdDGAOAHDCFAARGCAEFFBZDBAhAGABHGAeDGH.AEIBbGDChBAA.aHGENEIA..........hBBA......hBDA...,1,0,-4,4
IcLVaTgUGCNeJHEDQdYAKWMXbPBOSZRfF,MAAAXAAABADAZACBRAEF...FAEDLAGB.aBBBTAGAhAAAGCCAeCFFHEFAECHFdGCDhAIAADEBKEGD..PHEChBAAfFHA.IGAA...hBIA......hCAA...,1,-13,-20,7
SOTdBDXEANPFCZIVUcHKQYbRfMeLJWGag,FAAAZAAAUAEAHACBQAEARAGB.eAHBLCABGCGAaCCCODEBhAEAdDFABDHAEFFBADFA.hABACGBA...IFHAhACA.KFEDYFHBMIAA....gEBHhADADIAA.XGGChAIA,1,-13,-17,4
VQWFBHbdLPJITgaGOKAYZMDReScUCXENf,ZAAARAAAeADESACE.UAFAEAGEVBDBFCCH.HCFBdBHALDFBhABAJEHB..ICHAhAAAaECEKEHB.ACCBMFFBhABACFBD....fGHE.BHEAhAIA......hBFA...,2,-28,-15,13
BRbgfAPWVeYCZODTGUMNcaXKdHEIQSJLF,VAAAeAAAZADB.DAGAGADA.MAFAaBFAdCCCHBFB.EBHBQCFChAAALDAAREFA.bFBAhAAAABIB..PDHDCGHA.hADATFDANIBB.KGFASHGG..hBFA......hBIA...,1,8,-21,29
CBcOTPKJbaAHRGLNZEXegWSVUDYQIMdFf,HAAARAAAGADAZADBEAFAeAFA..SAHHDBIBQCFAdCADCCFAODFEhAAAKCCD..aDABAEEBLFCAhACAXEFCVFAAhAAAIFHAFFHDBHDATGFA.PHBA.hABA......hADA...,1,1,-7,8
UAKMOBNPZbDEYfgWTJLXGRaICFceHVQdS,MAAABAAAZACADAEA.EAFE......fAGATCCALAHBhAAARBBAaAHD.FCFDHBEBhBAAdDAAAECBODDB.bEBDhBBAgEEGJEFB.IEHAeEHBSGHDhBCAKGHBPHCAWHDAhBEACHGD...,2,-17,-15,2
cIXUebQCVFKYSELHfPMDGWgRNZTaABJdO,dAAAOAAA..XADAeADAQAGAFAGAKBGD.EBBBHCACMCEBhAEAGDEARCFBZFCAADDBBCHAhACAJEHB.IEAA.hBAAbECDCHDASGGD..LEGBhADA.DEIB...hBIA...,1,-5,-12,7
PdgeBCHIOKZVQLXNRTGUcEMbDaWSYFfJA,dAAAeAAAHADAKADAZAFBLAGB.RCAAGCEAEAHFMCCADAIB.aDHDSCHHhAAA.FDDBhABAAEDBBFAAOEFBQGCAhACATFAAUGGAbGFA.fHDB.hADA......hAFA...,2,-10,-8,2
FLEMRNKXTgafYPIBAHDVJecOCQSZbUdGW,HAAADAAAeABACADBZAEBdAFAGAGALAHB.RBDB.XCAA.aDCDhAAAfCCE.hACAIEFAAAIBcEEAQFBAhBAAbFGD.FEHBEGBAMGDATGDAYHCGhBFA.BGHA.hBGA...,2,-8,-7,1
UEHMFDATRLeCZJWVOKaPcfBgIYGdQSXNb,RAAAeAAAZADB...VADAaAFD.....fAGBBAHAICHAhAAAdCCAQCFAhAAA.XEDAbDABHDEAhABAMCIBACCATFGALHDACGDAOFBDKFHD.cGFChADA....hAHA...,2,-22,-4,18
SdOcNRXKJCYIAHFUbTDMfZQGVgBaLWePE,HAAAFAAAUADATAEA.MAHBZAFBGCGA.BAHAaCACeCCEhAAAECCB.dDGD.ODDBhACAREDAKDBD.CEAAAAIBDFIBQFEAhADA.gGAAPFBDSGGDhBAAXGGB.....hAEA...,1,4,-24,28
aScCDMTNXZIAVQbdgBPUJFORHKWGEfeLY,QAAAdAAABADAUAFAOACCHCACGAFA.EAHBeBHHLCDBhAAAaDEA.CDHAMEAA.hACATFAAZECBAEFBbFGBgFDAhAEAFFBB.RGFA.WHBA.....hAFA......hAIA...,1,3,-17,20
KDOJXRAMTbFBLNeHCGEPIYQcSZVWgUdfa,MAAATAAABADA.LAFAHACBEAEA.IAHAQBBCZCEBVCGBhAAAUCEAaCGE.ODDHhAGAREAAACABFFGH.eGBAhACAGEGA.PHAA.SFFDhAHAWFHH......hBAA...,2,-15,9,24
UPaBQcDbMZfALdSEGTONKVCgRYFeIHWJX,dAAAEAAAGACAOADAKAGACAEA..RAFF.FBDBHCGB..JCBBXEAAhAAA.aAHFQCFAhACAbEDD.ZEDAACBBTFFAhAEAgFCG.eFGHIHHA..hBCAWFHH.BCHAMIDAhCAA...,2,-22,-2,20
YDegIRWTHECSaOFZMGfLdJbBPAcXNKVQU,XAAAKAAAQACCDADA...eAEERAEAHBCBEBEF.aAHDZCFBGCFAhAAAdDDDBAHBADHA.VFGBhAAAgECA.IFHAhABACCHAFHEC.MFFB.LHAA.hCAA......hCBA...,1,2,-17,19
NEIcTBJReSHCDOAaPYGUZMWKVfLFbdgQX,aAAAGAAAZACB.MADAKAEA.LAHB.dBFAQAGCECDA.hAAATCEARDBFHEEAOBBBhAIAABHBPFHDUECAfGEEhACAbEFA..XGEA.IHHAhBAA.BCHASGGDhBAA,2,-25,5,30
AbLJGCTZgEYfMPaQWDKXdVcIeFOHSUNRB,LAAAGAAAZADAEAEAMAEA..aAGDQCDAKCAAdCCA.IBHAhAAAeBHHHDFB.SEABhABARDFFADCBCDHB.TFCAhACAfFDADCFBcFGDOFGD.NIAB..hAEA......hAIA...,2,-12,-10,2
YUfSTFXBLCEMbdePIaDcZHQOKRWGAJVgN,VAAA..gAAAUADA.SADATAFA.BAGAEBHFdDDAhAAAeAHH.aCCAZDEBHCEBhAAAQGFARDAAAADAYDHBhABAXDGAMFGBIHAAOGAAKGDA.hAHA......hAIA...,2,-19,9,28
EMXfAGdFUBYKWNRJHZPVTDaIQCcOegSLb,dAAABAAAKADARACAHAFBZABB...TCAAaAFA.QDDAOAHDeBFFhBAALAHB.EECBhAAAMCEBAACAGEGAFDCDUEGAhCDAYFABJGDADIFACGEA.......hAFA......hBHA...,2,-19,-1,18
XEaZRgBeTVQPcSAMFHLOGWJUfDbYNKCId,HAAAGAAAUADADADA.....bAFAKAFAdCADEBHFRCEABDDDeCDATDFAhAAAQEFA.SDHHhAAAAAHAMDCBLFFAhACAOGAAJHCEfHFBCGHAIHAAZECB..hACA......hAGA...,1,-4,-7,3
VHdDJPULXEIbcKYFABaORZNGCWTMgQefS,aAAARAAAGADA.CAFA.MADA.eAFASAGHHBBCdCFADAIBPBHDhBAALDAA.EDFAbEBAhBBAKDHBADEA.ZFAA.TFFAhAAAQFFA.fHEB..hBEA......hCAA...,1,-11,-15,4
HRSXaWBQfAVYDcPLegFUJdEZNCbIKGTMO,DAAALAAAeABAFAEDdAEAEAGA.ZCAACAGA.KBHBGCCA..MCGBhABAHCFAREBB.aAHDBDHDACCB.hAGA.VEGB..PEEBhACAJFEB...IFHA.SGABhAGA.XGGChBEA.,1,-19,-27,8
PYfcJVARLIWbTZaHXgeEUFMNQKBdSOGCD,RAAALAAA..bADBaADDHAFAeAFAECCBMBIB..QCFBhAAAdCAAGCDBDCIBfEEEhABAcEEA.AAFATEGAhACAZFGB.UGCAKHAASHECCGGD.hCCA......hCGA...,1,0,-7,7
CLHAVXFMGdDabfZTURBcOWNIKESPeYQgJ,FAAAdAAAaADAZACBRAEA..OAFD..ICGAEAHB..eBDBhACAQDECCCBAHCGBADDBMAIBhAFAGEBADECATEGAhAHABEFDNIDBKFHB.SFDBgGGA..hBAA......hCAA...,2,-32,-4,28
bFAXEWUcfgZTVLQDeKRPNSJCOaIHYdMGB,EAAAUAAA....fACAZADATCDALAEAeAFE.RCDASAHHhAAAOCGDHEAAdDHAhAFAGFCBbECA.ACIBXGFAhAEAgGAADEIBKGEDNIABCDCDaGCD.IGGAhAGA.BDCD..hCAA...,2,-5,1,6
PWbEAJDMTZUadILORFGceXYQNgCBVKfHS,MAAAZAAAdAEALAEARAGBGCAAeAHH.QBBACCCDBCFA.KCEAHEDAhABASDGA.hACAbECAAAIBTFGA.hAFAaDGEFFHB.XGAAgGAAfGFAhAGA.....hADA...,1,1,-21,22
CBMabfHJdTASQKUeFcWRZXEPgDOVGYINL,QAAAeAAAFADDRAFA.EACA..DCCBGAEA.IAGALCFAhAAAMAIBbDDC.HCGBdEHAAAFAhABAKCDDUFFAZEBAXFFChAAAOHCC..........hBEA......hCAA...,1,-5,-17,12
fIFSTCLdNGeKMUPaBJZcYQRXDEgHAVOWb,OAAA..bAAAFADDCAEA.dAFAGAFAKAHB.MAIBUDDA.BBBDhAHAZCAAQEAAhAAA.RDGFEEDAHCGBAAHBfFFEhABATFBAeFGBaFHD..cGDB.hACADFIB.....hAEA...,2,-23,-7,16
YCTFcQNfaLOBeAbXWEZPURISJDMHKdGgV,XAAAEAAAZACB.RADA.SAEA.MAHBHAGB.GCEAhAAAVCEB.TDAAFDHDQECChAAAaDCDLEHBeFABhAFAAADAbGAAPFGBIHFADAIBgGCAhBCA......hCAA...,1,5,-6,11
JcBFXLRZaSIUDWTPVNOKGCYeHbgAQfEdM,EAAAdAAAMADABACALAEARAFA.ZBFEaBDBUCCADCCB....TCGAhACAVDFA..KFAAGDEAhAIAeFFB.HECBAAFAJFHBhAAAXGGA........hBAA......hBCA...,2,-21,-18,3
NfgREeVXaBMWDOQFcZITHGAUJYKbLSdCP,UAAAKAAALACBdADA.CAEA...fAFAEAGA.eAGHaBGEMCEBhAAAOBHD.QDBAhAFAZCFAHEAAAEGAbDECSFEAhAEA.gGAARFDABFHAFHFAIFHAhAGA...hAIA...,2,-13,-13,0
AURVPJMIDWESXFLBNCfdQKaHZOeTgYGcb,RAAAVAAAMADA..DADAEAGA..FAFDLBEBBAHA.CBHA.dCDAaCCAHCFChAAAZDFB.eEBB..hAHATGCAGEFAAAAAPFHBhCAAIHHA.SFEDfHEF..hCGA......hDAA...,2,-21,-17,4
GFDXQHUSCMPLWAJOVBKeaTYNEZRgIcfdb,OAAAKAAAeACE..aADD..TAGAEAFARBFA...ICCAhAAAdDBAGDDAXCEAHDGBCBBDhAFAMCIB.LECAhAFAAAIBBGGDNIDBZFGF.fGAA.DDBB.hBAASHDA.hBDA...,2,-15,-7,8
UJFYCKIaQGTeSXWDOgNBVMfcZRLAdEPbH,EAAAHAAAFACDKADC.aAFDGAEA..eAHBXAGAOCABBCGAhAAAMCCBZDDFACHB.dEAAUDDAhAAACDHAQFFCSDGDhACADFIBNEIA...fHABLHEAbFBC.hAEA......hAGA...,2,-20,2,22
MEdKZSfOILXbQagUeRJWcTYACVDPFHGBN,DAAAHAAAGABBMACAEAFAZAFB..OAHDLBEA.QCCChAAAaCCCeDGFREAAJCHB.TEEAhAIAAAEACEEA.FFDHdFHAfFHAhBIAIHBA.........hBAA......hBHA...,2,-23,3,26
ZVgMXRDSKENdTacCAGbLfOHYUQIPFeBJW,GAAALAAAHADAQAEAFAGAeCDABAGAZCGBMDABRCAAKBHBECEBdEEAaDCHhAAA..ACAAODFDhABAIGGA..PDHBhACAWFAH...XEAASGDD..hACANEEACGHA.....hADA...,1,-6,-12,6
LPQKMZFEDNWebIUYXaTGfHVgORCAJcSdB,SAAAdAAALADAQADAZAGBECBADBIBeAFA.UCGA.aCCBhAAAGCEAHDABODDAhABAAAEABDDCMECBFEEHbGAAXEGAhACA.TGGAfFHA..hADAgGCHCGFA.hAGA...,1,0,-14,14
PAURfLCWGSHJNTEbgOKFVQBZMYcIDXdae,RAAALAAAGADAHAFATAEAECCB..OAGDFCGDQDAChAAAZCAAMAIB...IFDAhABAdDFAeEABAAHACEHASCCEhABAbFEDKGGA.BEECcFADaEGDfGHAhACA.....hADA...,1,-1,-5,4
WNVMRFPfEAOadCGDBJXcHgYKITbZeSUQL,dAAAGAAABADAJADAHAEB.KAGA..bAGBeCAA.UDEBLCDAhAAA.VECAREGFFCHFEDHFhACAADDB.CFGD.DFFB..XGEDhBAA..gGAAIHHA.SGHHhACA..hADA...,2,-30,-9,21
YZCFfKTRcSWQeBPgVObDGdJaENHALIMUX,MAAAXAAAZABEFAFAKADA...RBDA...SAFBeAHHBCCDPAHBhAAAODEC.GGDBhBAAaCDAHDAAADIB.LDDBhABA.IEHACFFB.TFFA.hCAA......hDAA...,2,-28,-10,18
NbDaUGHWLEROKCMAQFdJBPcTXISfgYVZe,dAAABAAA..TADASACA..fAFBVAFAZCAAeCCEhAAAbABD..DAIBGDFAhACAHCEAEDABRFAACCHAAEEAQEEBhADAFFHD.cEGDIHEAgGCAhAHA.aGHD...hADA...,1,8,-20,28
dKPEBYLfHZAUJSeWVCFIaRDgXTbMONQGc,SAAAeAAACADA.FADARAEFDAGA..TAGAMBHB...QBCDhAAAdCCAEDFFLFGBhAAAHCEBACGBUFGAJEDB.IDHAhABAaGCH.bGAANBIA.......hABA......hCAA...,1,-10,-24,14
AdaFKCTfBZVRYWJHUgDSbeNMXELIPGOcQ,aAAACAAABACAZACB..RAEA...JAEAHCEC.DAIBeAHHMBBBLCAAhAAAGECA.QCEAhACAAECBdEFDKFAB...TEBAhAHAfFHAVEGBUGDASGGD..hAFA......hAHA...,1,-15,-18,3
dURMXGgBLVaZKHTQFIeNJbDPfYAcWSEOC,SAAAEAAAdADA.RACFGAEALAFAZAGBHCBAFDHD.eCFA.bDFAhAAAfEAA.hAGAAAAAODEHMEEBBFCAhAHAaFGCQGAAIFFADFHB.....hAEA......hAGA...,2,-15,-6,9
cNfEKORAJdGTZCFMLBYDSbgUHQWXIPaVe,GAAAZAAAMACALADADAGA.SAGHUBEAHBGDQCDAhAAA.XCGAhACAaCCHeDHHfDCEhAEAEEEARGFEAIBA.dEGA.TFAA.BFDA.bGFA.hABA......hBIA...,1,13,-23,36
HDNRYZfFJgWGbKTPcEMIaOXAUVdBSLeCQ,dAAALAAAeADAHAGBRADFZAFBFAHD..gCAAGCAAKDDDTCEAhACA..EDGAaDCDACABBEFDhABAQEEBDEIB.hACAfDHAJFCF.bGBAMFABXGGAhADASFGH...hAEA...,1,-4,-14,10
SaGHfdBFDIXLAeEZTNgOJKPcMYVQbWUCR,EAAAZAAA..TAEAOACCKAGCMAEA.QBFAUCAARCDBGCGAhABAHCCAdCHADBIBLFDAhACAAAIBeECAJEGF..cGCChADAYFFF..WFHH...CCFA..hAAA......hCAA...,2,-12,-5,7
QFYfKeXTAZWcNERgLSPIMDdaUHbGVOBJC,ZAAA..NAAA.RAEALAHB..SAFAMACAdCCDHCFBhABAGBBABEEDQCGAhABAFEHDKFDD.eBEBAGGB.EEAFhACAIHHAaDEHbFGBOGACCHCD.XGEAhADA.....hCAA...,2,-23,1,24
YHPdFeTEKULORZWJMQgXSafADbNIGcCBV,DAAA..bAAAGABBBAEAHAFBdAFAeAHBEAHBLCABRCCAZDFB.MCCBhAAAQEAA.hABASEEFADDAIDHAhACACEHA.PDEDKGHBOHCAgEGG.aECDhAEA.fGGEhAIA...,1,-11,-12,1
fcGdIgaNbEJWLRMCOKVHBeQSAZDUYPFXT,ZAAADAAAUADAFADA....TAGAGAGAdCAAaBBB..ECCBLDDAhAGARCEA.MCCBKDHBHECChABAeDHHAAIBXFGChACAIFDAbGAA.CGEABHHAQGBC.SFFBhBAA..hBDA...,1,1,-26,27
SeQOEKFRTHDPUJgbaCGMIAYdBXZVcNLfW,dAAAZAAA..VAEALADA.SAGHeAHHECAARCDBHCAC.DAIBhACAUDGBbCFC.GEAAhABAAAEAXECAfFDEhACAQFFAFFFH.........hADA......hAEA...,2,-11,-6,5
cfQNIGRSYdJMLTPbWBeKCAVDgFHEOUaZX,DAAAHAAAEACAaACA.ZAEB..XAEAQAGAGBGARCCBdDGAMBBBhAFATFEA..bCCAeECDhAAAAAHAFECAOEHD.hBAA.fFFANIBB.SEHHhBIA......hCAA...,2,-24,8,32
MaYcLAJSDUENBGbQCeHdFgZOIXVTKWRfP,DAAAEAAAGACAQACAHAEAdAFAZCEE.XDGATCGA..RDDAMBBBhAHAaAGALEAB.hAIAACBBSEFDhAAABBHBeEBFOEHDKFHDfGCAcFFB....hAEA......hBCA...,2,-15,-1,14
beUNYVRBfLQgOdFSITGEXMWaDcKPHCAJZ,ZAAAeAAAUAEA..VADARAGBLCAB..QAGChAAAdDDASCCDGCCAEDGBMCIBhABA.aEFAKFEAHFDBhAIAAAIB.bFFDBFHA........hABA......hACA...,2,-32,2,34
cFRgCKGfHZSJXPYEBMTIDabVUNAOQLeWd,LAAAeAAAdAEARAGBKAEAHBCBZAGB...XCFDECAAMBIB.DCDAaDHDhAAA.UFDAADDA.QGAAhABAFDEDGEAASFGDhAGAPEGB.BEBAbGCA......hAIA......hBEA...,2,-16,-5,11
gGVFZPBKCWOANfHDUdTaIMeJQRXbYELcS,HAAAdAAAaADAeACE.RAFF...XAFDEBHFLCCBSAHBhACAGEDAZBDFKDHBOCBDhBAAAAHADFABTGFAMDDBbEFA.hAAA.cCECFGDDCGGA.WFAH.....hBCA......hBHA...,1,7,-16,23
BaJOYcDFWRVPfAMKUCgGZQbedXEILTSHN,MAAACAAAZACA...eACAEAFELAHBHAFAaBBC..OCDCDCCARCFB.VDGBhAHAAADA..KDDAGEEAhAIAdFFD.XFCBhBAASFHHBCHBJHCAFGHD.......hAAA......hCAA...,1,8,-32,40
aEXJKAPYOUReTdNbDVSQGcHBCgFWMfIZL,OAAARAAAeADE.dAEADAGA..QAGAHBDACBHAFCCHMBBB.ZCCAEDFAhAAAKCGDADIB.UFFA..hAGAbEEAGEBA.BDHAhBAAfFDEaEEH.XGGA.PHBChABA....hBHA...,1,-9,-20,11
VCfXdPAabIZcNYBgEGFUQKRDTeMSLJOWH,aAAAZAAA....NACB.BADAGAGAQAFARBDF.eBBBMCCBLBHBhADAODEDHFBChABAfCFEdFHAAAIB.bDCD.hBFA.cGEDEEEBKFAB.TGFA.SHDGhAFA...hBGA...,1,-3,-14,11
FJaZgVGBKbeNcQPAHWMRIUOXELYTSfDCd,HAAARAAAOADAEADELAFB..TAGADAHBdCADFBDDZDCBGCEAhAAAbEEA.eCCD.QCGBhABAAAIBMCIBXGEAhAAAfEHAaHDCBHHAKGFANIAB.....hAIA......hCAA...,1,-1,-11,10
fAeGUTDWJgHYcdOKaCIPZQVSbBFXRLNME,eAAAGAAADAEAJADAHAFC.dBDAaAGA..CCCCZCEBQBGD.hAAASCDAbDFDBCHAFEHFhABARDBFMDHBAHHA.TEEAhAAA...gGEA...hAIA......hCAA...,2,-26,-9,17
fHLZQdDaVCUOgReEMAWXKbGPcJBNSFIYT,KAAAGAAA.JADASACB.FAEATBGAHAGBZCCAdCDAaAGAhAAACBED..ODFDRDFBEFCAACFBhACA..XFGDhAAA..cFGDBDHAYEEFfHEBDIAAhAIA......hBIA...,2,-28,-16,12
STEGAZKJHMgfQYICbDLXPNWFRVOdUecaB,ZAAAHAAAMACAQADC.CAFBLAHBXAEA...PCABhAAAFAHBRCCAdDGAeBGFaEEBTDDAhACAACIBKFCB.JEGB.fFCAhCCAbFFA.DEIBNIEB.WFFD...hABA......hCAA...,2,-22,10,32
DBUVWbRIOAYPQSCeNELHGgJfTaXdZMKFc,QAAAeAAAEADAHAFAGACB..fCCAaAFAZBFEMCDBFCFHBCHAhAAAVDAB.RECAAAHASDGAhAAALEHBgGFDhABATEEAdFHADGDBWHCG......hCAA......hCBA...,1,3,-8,11
gJeCDUaXbcBfdYERMKANTVOQGIPZHFSWL,TAAAQAAA.GACBZACBHAEAFAGALCDAeAHHDCABaCECbCGD.hAAABDHA.dEEARDAAACIBOFHBhAAASEEB.hACAgFAACGAAXGCCfGEEEGFF.hAGAKGGA.....hAHA...,2,-6,6,12
YgELBfUWOdQJFeZcKHDbNVRTMCXaASGIP,GAAA..IAAAPADA.EACALAHBBAEAUAGAdCDAQCFAhAAAeCAAZCEAHEEAhACAbDBDRFEAMDDB.aEHDAEFBSGHHhACA.fHBBOFCHFGEHhBGADIEA.....hBIA...,1,5,-13,18
MKVcQXNbZIBgSODFaCHfAYUeRJGWTLEdP,eAAARAAAGADALAEAEAFA.dCCAKAHBQCFA..bCFDZCDBhAAABCCDOBHDFCHHHDAAhAAAAAFAUFFAJFAF.TFDAhABAMDBB...XGGANIABSHGADIFA.hADA......hAFA...,2,-4,-4,0
dXbfNWFBcKLMSeHaIUDCJYRVEOGAZQTPg,ZAAATAAAdAEA....XAGA..bACB..fCAAhABAFAEDKAGAMCCBHCECaCGAhAAADCCBCDEARDFFEDDBGGABhAGAAACAQEGAPFHB.gEBGBEDDSHDAhAIAeFEFIGAAhAGA.YHAG.,2,2,3,1
cQgBNZFIeYEGSUCTRAHWLadKOMXVfJbDP,HAAAaAAA.dADAMADAXAFA..fAGADAIBQCABhAAABBBDZBDBeCEFEBHFGCFAhACACCFDABDBLEFAODHDbFAAhAFAgGEAFGHHSFFD...hAIA......hBAA...,1,16,-29,45
GWgCJALfbVaZODPcBSHIMdeEXUNYTQRFK,LAAAVAAA.ZADBDADABAFAHAECdAHAEBHFUCAA....TCDAhAAARCFBGEEACDCDAAHAaDFDhCAAODHD..SDHHhCDAeFCB.XFCA.QGGAhCFAKGHD....hDAA...,2,-17,-17,0
AMaEZdJOLFGRcQegPbWITVDKHBYSfNCUX,EAAAdAAALADARACA.eAGH..bAFBTCBAKAHBHCCCBCHASCGHhAAACDEA.ADAAZEFAhADAFEABGECAQFCAhCAAgEFAIGGADEIBNIDB.....hCBA......hCCA...,1,-5,-18,13
UCTOXVeKPYaDJcNWEfZgFIdHASbQRLMBG,QAAARAAAMADA.GACBCAGA.OAFAeAHHKBDAaBGE..DCDBJCCFhAAA....cCFChAAAECFFZEEAFDAAHFBAADHAbEDDhADALEHB.TGEAXFFA..hCAA......hDEA...,2,-14,-10,4
YQdMRZbSLTDaPKJBAfCeIXFGcHNWEVgUO,eAAAFAAAHACBEADAUAGAQAEA.RAGBZDEALBFD.aCCAKEAAhAEAAAAA.CFDAGGDB.hBIA.cDDCNDIA.gDGBhCAA.dGFAMIAA....hAIA......hBAA...,2,-15,-11,4
HQONPfAEYadGBcMSJLXDZFICRWTUKVbeg,EAAAdAAAGADABACA.MAFALAEAZABBFBFARCCAUCFA..KCHBeDHHhAAAHDEBQFAAhAFAOEGD..fGDAhBAAAAIBaEECSGGADDDBWFHH.....hAGA......hCAA...,2,-20,-9,11
dEebBJOMIYGNcDUSaAKFWVQXTCgPfLRZH,FAAAQAAACADA.....fACFRAEFHAGBECCBeAEABDAAhADAMAIBGDFADBHBaCDAhAAAAAIBKDHBXCFD.hAGATEDALEEDbFABOEHDIHHAcGFAhAFA.....hBAA...,2,-27,5,32
XfVMcNgKTYOIbUHCWLeQGSPFaRDJZdABE,EAAAXAAA..MADA..NADAKAEATAGA.OBCAUAGAHCEAhAAALCCAeDHFGCFAhAAAFEAARFFBDEEBdDHAAEEB.hABAfGHA.......hAEA......hBIA...,1,-14,-18,4
GRgFCKbUIHANedDYQJOcTfZXWVSEMPaBL,eAAAdAAAQADAOADC...TAFAZAGBXCCASAHBhACAEDFBMBIBaCBDGCGAhADAREGFCFAA.bDCDHFCAAEEADFFB.hAAA..cGGC.......hABA......hAFA...,2,-15,4,19
TIGbDefWcPXENMaLQYBFSCHVARKZdJgUO,RAAAdAAAUADAOADAGAGADAHB...eCCB..fBDAhACA..PEEBEBFFaBHDhAIALFBBQDBChBAAFFHBCAFAHDFAAAAAKGFBZFFA.JEDB.IHFAhBCA......hBDA...,2,-18,-9,9
ILVRXdMOZDgfeaBYbTCSGHFcKPWENAQJU,QAAAUAAALADARACAdAFAZAGB.DBIBeAHBBCDA..TCDAhAAAGCEAHCGBKDCD.EDAAAAEA.hBAAIFEA.MFIBhADAfEGAbGDA.FFHD...PGCChBCANIAB.....hAIA...,1,3,-25,28
bYNBKCHFLPZTEXUQSMOfcAedJIgGRWaVD,eAAAdAAAJADAGADA.RAFA.aAGADCCB.....bCFABBDDHEFAhAAALCCAZFAAEFEB.QBGDhACAMIAAOHEEhABAADHBIEEA.VFGB.KGEBCHHB...hAFA......hAGA...,1,5,-31,36
TaCPIEVYGgZfbMRFBLJNHXeUDKcOWAQdS,dAAAaAAA.CADA...EADAGAEAZAFB.MAHBRCCBLBHBHCACUDGBKBBDODABhADAAAGB.QEFChAIATEDA.IFBAhBAAgGGA..FFHDBFGANHCB.DAIB.hBFA......hCAA...,2,-17,-9,8
DeFEOZGXaPcgRITAWLSUNbdYKVfCQBJHM,LAAASAAAUAEAdADAKAFACAGA..QCAAHCDCeAHHEBHFGDBAhAAA.aDGEgCDGhABARFFAADBB.bDFDfFAEhABA.MEEBODHDXGCDhAFAIHEA....hACA...,2,-30,8,38
INQJSaCGXfLPbgWdDVcMEKBROHZYAUFTe,TAAAeAAAQADA..aACAGAGALAFAbCCCdEEADBDBMCCBhAAAEEHFRFBB.HCGBAAAAFGAHhAGAIDEASGEAhAIAfFCA.gFFB.cGAChAGABHHA....hAHA...,2,-26,10,36
TUISeNRHgbDJZfAPXdMcLaBQGYEOKCFWV,dAAAMAAAaADAGACB.EAGECAGAFBDB..TCCAUCFA..eCBFhACAHCEB.bCGBZEDAABBBXFAAhAFALDHBQGAAhAGAKFGDIGDASHFANDIADIAA...hAIA......hBAA...,2,-19,0,19
HYeAdVCLbDSXPKaIJTcGEMZBWUgRFNQfO,dAAALAAASADAKAEA..aAGAJAGBGBGAZABBBCEAUCAARDCB.QCDAhABAHEAB.AEGBCFDAhACAbEEB..DEIBXEGAhAEATGGA..EGCBMAIB.FGGBOFFBhAEA......hCDA...,1,-6,-11,5
CWQBUJKXNeaEFSLIRVYPgcTOAHfGMbDZd,HAAAGAAAMACAZADAdAHAQAFABCDAKCFDeBDF.ECEFLDHBhAAARDFA.VFAAgFFAhAAAOEEB.AAIBDCCBCDCD.hACAJHBAaFGBIHHA......hBHA......hCAA...,1,-1,-17,16
UCKQZgLHAaOSJDMcYGWPVBXTedINRbfEF,aAAASAAA.MADAGACA.PAEAXAFA.eBCFhAAAdBHARCEBEBEBCCGCZEBAHCFBABBBDEHBhAIA..cDDChABA.VFGBTGFAIHDANEIA....hAIA......hBIA...,2,-15,-10,5
FcDAJROIYWMNaTHVLXUeEfZgbSPdBGKCQ,RAAAOAAA..IAEAMAEA..aAGEHAFBLBBAeAHBECCAhAAAZBFASDBAhBAAdDAAGDEAQEGChABADDFAADBAJEDB.YEDFTFFA.......hBDA......hCAA...,1,3,-26,29
VbEKIFHAaYRJZCcTdBXMQGSDfWPULgNOe,RAAAZAAACADB.dAEABAFAMAGB.GCAADAHB.......fAHAhABAPCCALDFAhAAAOCHDeCCBEEEBFFAAHEDBhACAAAIB.aFFA.cGEDTGCASHAAhADAUGGA.....hABA...,2,-36,5,41
SbCZFAUNeOLdJHfaYcQPGEBRMVKXITDWg,eAAAdAAAHADA.aAFAQADAGCABRCFA.MAGBKEEA...TCCAhAAADAIBSEGHhACAZBGBAAHAODFHLFCBJEHBfFBAhABAYFHB........hBFA......hCAA...,2,-21,-5,16
VdOgBERTcfXAMUFLZKGSNebWHaQDYIPCJ,MAAALAAAGACBeADHHAGBQAFADBBB..ICCAhAFACAHAdCAABCEARCEB.TDFAhABAXEGAACCBZFAASEEDhAGAbFFA.aGDCPHDCOHEE.EGGE..hAIA......hBAA...,2,-5,-3,2
ZPeACbWRQXUfaOSFIgDGYEHcLBMTdKJVN,CAAARAAAQADCUACA..aAEEFAFA.DAIBEAHBHCDC.LCGBhAAAMCBBdCFAKEED.VGEAhABAZDDBACHB...bFFAWCCDhCAA..OFAB.SHEAhAAA......hAFA...,2,-31,-9,22
CGKZFUEJONAWgQfBTYaXcSbIPHMReDdVL,QAAATAAA.aACESACB..bAEDHAEARAGBeCDDhAAAdAHALDDAGDAAZDFEhADAEDHBOFGBACCBfEAAhAAAXGCAIFDAMFIBDGABKFFA.FGAD.hAGANECABGHA.YHFAhAEA.,1,17,-9,26
UaBcSWZePXKIQLJdbGNYRECTgDVMFfOAH,HAAAaAAABADASACEZAEB.eAEHKAGALCCBdAGAGCCARCGB.ECHFhAAA.TEFADBBBMDABhADAOEHD.AAIBcFEChBGAXEEA...QGCA.JFHBhAIA......hBAA...,1,9,-26,35
SfVIPAXCOTeWdGDKZLMEBFYgcRUHbJaNQ,OAAAeAAAGADAZADBLAGBEAFABAHAFBBH......gCFAhAAARDEBHEGBaFBAQDBAhABASGBBfDHAhAFA.IFFAAAIBCGED.dGCAMIDAhBAAYFHB..hBDA...,1,-15,-19,4
YNBbAHFdOCGMKLWVRcPQSDXTJZgfeaUEI,HAAAdAAAGADAMACALAGBRAFA.QBDAXCAAZCFEeCCBhAAAEEFAIEEABEHAAAFACGGAhACAKDHB.VFGB.SFCDhAIADDDBJHCA.aGBH......hBGA......hBIA...,1,-1,-23,22
BRdAFgISLPHODWUTYEcQfNeJZVaKXCbGM,FAAASAAAHACBDAEAUADA..EAGAQAFAeBEGZCFEaDEHCAHAGDBAhAAA.RDDAACIBLEGBhBAAODGD..TGDAhABA...fFFENEIA...hBIA......hCAA...,2,-23,-10,13
UeRTWIbMHgQaNDPSfcZOAdBKLXYFVGCEJ,dAAALAAAFADAGAFAEAEAUBGARCAA....TECAICAAHEEBhACAaCCADAIB..fDDEhABAODHBAAHBKCEDXDFChACACGHA.eEABMIDAQFCC.hBAASEHH.hBCAZGFA.BHAD,2,-13,4,17
SEMKOVRdLCfUaZJQXYbTBcAPIDNgGHWeF,DAAAGAAAHABCeADAEAEE.MAHBKAGC..RCCALCFBCBFAUDCAZEEBQFGAhBAA..bEGDhAAABBHAAADA.IDHAhCAANAIA.FFEHSGDD....hACA......hBAA...,1,-13,-19,6
YNPFDVBLfGacKJTAUebRdSQZMIHCXEgOW,eAAARAAAdADAZAEBHADA.EAGEOAGD..NCCADCHBLDDA.aCHDhAAAKDDA.AAAASDFBhAFA.MCIBXFFAhABAgFCHPGBABFFD.fFHEhAIA....hCAA...,1,-20,-26,6
eSGLfIKdOBWHEJaQTZPMYRcFCDbNVgUXA,eAAAGAAALAEAKADAdAFABAHAHBCAEBHF.aCEEZCDA.MCHBREEACDHADFAAhAAA..VECAXGAAhABAAAAB..fFGEhACAOFHD.JHAA.......hAFA......hAGA...,1,-10,-25,15
gOCMGbILKfPUEHTVYcDNJZdWQFXRSBAae,eAAACAAAGACALAEAKAEA.UCCAHAGB..TCFAVCABDCFBZEFAdCHAhAAAFDGH.RFAABDBC.hAAAAAFA.aEDDMIAA..hABAbFFAfGGAEGAANIAB......hAIA......hBDA...,2,-10,-8,2
EaSgDJVTZNWcfORBXAPLGbYFHKQCdIUMe,GAAAFAAAHACBQADAdAEBMAHB.EAFA.aAHDDAIB...TCEAhBAAZCDANDAA...fDHAhBFARDGFAAABbEED.CEEDeEGDhCAASGCB..gGCA.hACAWFHHBHBA...hCBA...,1,5,-25,30
XeAEGBFCZINbYLgaWfdJSQUKOHVcMDRPT,EAAAGAAAFACD.ZADA...IAHA..bADDLCDBhAAAaAFAdBGDQDFAhAAAOCFBHCGBMDIBRFAATGFAhACAABFBCEED..gGGB.fHEBhAIA.....hAEA...,1,-10,-11,1
EUQcOMgBaFKIbCXZDfHSWdNGJRYAVeLTP,eAAATAAAEADA.UAGAQACC.MAEAaBDEKCCD.CDEAZDFBhAAAHBEA.dBHAGGBBhABARDDBADGBLEHBOHEEBEDDhBGAbGBCfFGA.SGFDhAAA......hAIA...,2,-14,-3,11
VZRXOdPfEMSbKWHFLIaUegTJCYNABQcGD,QAAAGAAAZADARBGFdADA.EAFAMAEA.KCDAHBFCLEEBaDBAeDFBhAAA.TEDACDCDAAABDDIBhACAODHD.SFAAhAFAbFCBFEGH.gGDA...hAIA......hBCA...,1,9,-19,28
HgQdXZYTKbSLBICVEURaMGPJFfeNcAODW,DAAAHAAAdADAZADBKAFALAGB.CBFAECABRBBBGCFA.FBHDeCCDhAAA.AAIBOCHDQEDChAFATEEABEHAIFBAhACAaDBH..MHAAfFHE.cGEChADA....hBFA...,2,-30,-16,14
NWTAQGUCcILYgKHJVSadBbZDOMfXeRPFE,GAAACAAALACAKADAHAFB..SAFHdBHAZCDFMDABeAHBREGBEFDBhAAATCCA.AADAQDFAhAAAIHAA.gECAhAIAaGEDDGGB.XFFC.FGHD.hACAWHCG....hCAA...,1,-3,-21,18
QWBRUYFSdXfLDZJeOMaEHgTCAIKVbcNPG,KAAAVAAA....bACB..PADAGAEAQAGARAGBFDGHdEBALEDBhAAAZCDAeDGHaECAhAAAEFFB.HFCACFHA.ACFAIGHAhBIANIAB..BGAD.....hCAA......hCEA...,2,-10,-9,1
DNdLBVHYEgCPaAcOXMQUfTSIGZJFeWRbK,XAAAMAAAUAEA..SADAZAGBFBBA.RAFFDAIBdDDALEBBhBAA.HEGBECDBCCHDABIBQFEAhBEATDAAGDEAhAAA.eECF.bEGBNIDB.BHAA...hBGA......hCAA...,1,-4,-14,10
QRCPIfaDZSNKXMeBcgTVbUELFYOGJAdWH,HAAARAAACADB...fADBZAEBKAGA.eAFEBCCA..TBFAhAAAUCGALECAOCABACCAdDDAhACA.QDGAhAIAaFGADGDA.XFDAMIAA.gGFHhCEAEGGB......hCIA...,1,-1,-36,35
CbPYFULIMWSXeZfNRGQOaJgTKdEHVDAcB,CAAA..bAAAFACA.LAFAMAEA..XAGAeBCBZCDB.RCFAGEGAhAAAaBDDJBFF..TCAAhAAAEFEAHGAAACHB..BDHAhABA.PEEB.IFHA.fGFAhACANICB..hCAA...,1,-9,-26,17
ZVUEJXSTKcGLIQbdMRNAWFefBDaYgOHCP,eAAADAAA..aABEOADCHADBZAFAEAGE..SCCATCFAGEEAhAGALCFA.bEEAdEHAhAHARFAA.ACCBfDDEhAIABGEACGGD...........hAAA......hABA...,2,-23,-11,12
QZWGEXIDKdURHeJMcCaSAOPBLVNFbgTfY,BAAALAAAFACA.TAEAQAFA.GCBAEAGEDCAA.dCDAHDDBhAAAeCFAMAIBCDHAAEAAOEAEhABAPDGB..bFADfEFAhACA.ZGCAIGHAKGGA.JHDAhAFA......hBCA...,2,-13,-7,6
daGPDYfSeLQbWcXBJHZCMgAFKOUIEVNRT,OAAAEAAARACA.dAEAGAFADAGA...SAHBeBBALBGBhBAAQCCB.bDADXDDAhBBAHDGBZEEFMBIBhCAAADABKFDBIFGA.TGCAaHBA.fGHAhCGABHHA...hAAA...,2,-21,0,21
NRQdFOHDaZeYEUJXLAPGKSMCcVTgbWIBf,GAAAMAAA.CADA.TADA..bAEDBAFBRAGB.dAHAHDCAZBBFECFBhBAAXDGAADDA.SDADhAAAVEEB.gFFAhACAfDHAQGAADFIBeHBA...hBHA......hCAA...,1,3,-22,25
FPIVLbSMCeRGKWgTNdJBEaAYUXfQDHOcZ,XAAAQAAAHADAZACBFAED..IAHALAGB.bDECMCDBhAAA.RCEAGDAAhABAKEHBTFFAdCHAEEEB.ADABfEGEhADAOFDB.cGGCSGBBhAAA.CHHA.....hAIA...,1,8,-19,27
VEcBZASFNgTQCeDKILdObYXRGMHPJWfaU,FAAATAAAeACH.KAEAdACA.OAEA..bAGBRBDFHBGB.PDFBhAAAfCEA.hAIAaCFDEEHFZEAAABIBSFBAhBFAQEGADBIBIHHAXGGCGGCBhCAAMFFB.....hCGA...,2,-11,-2,9
EVCRbDIQdUJeNSOgWYXZfFPTGBcAKaMLH,aAAAHAAA.EADERACFDAEAdAFAeAHB..OAFE..gCAAhAAAXCDDZCFAFCEHGCGAhACAABBBLEGBbDCDQGFChAIAUGCASFFFWFHH.....hCAA......hCDA...,2,-24,8,32
AWBJdRgfbVTHaFePDSUNLYXcQOKGMCZEI,BAAARAAA....bADBHACA.eAEESAFALAHBXBGAhAAAQCAAGCCAhABAZCDBACGAdEFAfDGEhAAAaCFCDEHBUGAAcFDDMEIBEFHF.....hAGA......hAIA...,1,-8,-9,1
AFDLaRZfVHedWONYKBEUSPMJTQICXbcGg,LAAARAAAZADBHAFAeADHdCCC.OAFAKCFDBCHAEBFB...UEEBMBIBhABA.QCAAhACACDAA.bCGD.GEDAhBGAAAAAaEHB.fDEB..NHABSFHHhADATGGA....hAHA...,1,15,-30,45
NPXAEWHSeLgYBFTVJcIGMDRKCdaOZfUbQ,HAAAeAAALAEABADBTAFAJBCB..GCFARCAAdAHAZCEAUFAAQEEAhAAA.XEGAhACAEEDBSDHBhAAA.FFHHIFAAMFFBCHCA.aFCB.fGHEhAFA.NIDB.AAIB..hCAA...,1,-6,-11,5
aFOSCKYfMbUVGWLNeIDTHRdgcZJXAPEQB,EAAAaAAA.FACD..CADAKAFAMAEA..UCCAGBDALAHBeAHFTDFAhAAAHCFBRDAB..dFDAZFBAhBFAABBBBFFDSDHHhBGA.bFFCNEIA.DICA........hCAA......hCBA...,1,-6,-25,19
YbPHgTOIALJBSNXKGZcDMRVedUWafEQCF,LAAASAAAKAEAZACBMAHBRAEA..eAHHdCAAUCCA..aCEChAAAECFBQEEAhABAFDHD.bEGDHEDC.TGAAhABAADIBBFAAXGCBDGCAfHABCGGA.hACA......hAEA...,2,-14,-9,5
XHVFbQcWYGeTaUJAfKDdRLONIEMgCBPSZ,DAAARAAALADBOABE.EAFA..MAEABAHAZAFEHCEBFCCA.QCGAhAAA..cCEDhBAAGFAB.eCCDaCGDACIBhCAAdFGA.NIDB.CEHAXFFC....hCBA......hDAA...,2,-40,5,45
WOJABIeXHPNTaVMCUgLbYQSEdZFRKfDcG,eAAAHAAATAEAMAEAUBDALAGB.QCABEAHFZCFFREEBDCCBhAAAGDCA.OCHDhAAAACIBXGBAaCEHCEADbFFBdEHA.hABAfGEA.......hBGA......hCAA...,2,-20,17,37
gBeIPOTbCHRMEdfAVNULacWYDXJSZGKFQ,UAAAaAAA........cACDDADASAEAGAEAQAGAhADAeAGHOBDBhAIAbDDDHDFBECEFABIBLDHBhBAAXGAAKDHBBEFAIGHACFEDdHEB.fHDBhAGA.WBBDhBAA...,2,-27,-14,13
PTJEcZbBRYfQWaUDKHNdXFCIVeAgMOSGL,MAAAGAAALAEAJADAZAGB.RBBA...QCDAaAHDKCEA.HDBBhAAAdDHACDDDeCHH.AEGBSFDAhACAEEFABFAAfFEEhAFADFIBFGAB.IGCAgGGD..hAGATGGA...hBAA...,2,-20,-7,13
IcFEaNDJMBCfOWUdLQeKPgRSXGAYTHVbZ,HAAAZAAAFADAEADEDAGAMAFA.BBFAOBEEdBHALCAA.eCEBhAAAKCAARDDAGEFAABHA.hABATGDAIDHA.hACA..aFFACHCD.UGDA.QGGBhACA......hCAA...,1,1,-32,33
YNaIFTQSDCPOMWdAXgJRLHbZEcGeBKfVU,XAAARAAAHADBEAFAGADAKAHB..UDAAaAFAFBGH..TCGAhAAAQDAACDDD.MAIBhAAAADFBLFFAZDFAeDDDfGCAhABAVFFA.IHFA.DGEB.hABA......hADA...,1,-5,-7,2
TLSfCQgAeIYaJBOKZNdXbMHEUVcGFDWRP,eAAAaAAABADAZADBdAGA..MAFAHCEBEBBBVDBB.GDGADBFARCEALCHBhADACBCA.ACEA.hBAAIGDAODCDXEEAhBIAcGBC.FGHB.......hAAA......hABA...,1,-15,-19,4
THBOELeRNCPgIYFSdcQGXWMDbAZKVJafU,ZAAAKAAA.aACAUACA.HAEAEAFALBHBRCEA.CCCD.IEGAhAAA.FDDHdCEAGGABhAGAMCGBACHBJFFFTFAA.hAHAeEDBNAIA...gFFA..hABA......hAFA...,2,-22,-15,7
ZbUJMVeEKPDNHgOLaFXGRYcfCSWTAQBdI,dAAAZAAAUAEAMADA..EAGADAHB.HCAALBDBFCHDGDEARCAA..hABAfBFESEBAhACAABIBQDFBhACABGBAIGDAbFFAeHCA.KHFAgGGAhADA......hAIA...,1,1,-23,24
eOdJcXFBVYKMWDNfAbLQUZSGRPgHCaTIE,LAAAZAAARAEAHCAAaADDEBHF..eAFAdCED.JBHBFDHD.BEADKCAAMCFBhABADACA..AAHAQEEAhABAGEDACDDC.OFAEhAFAXFAA.VGFA..YGFGhCAA......hCCA...,1,-11,-14,3
cDKfXRIOHJdbUCBNSVEFWQLeZPagGYAMT,MAAATAAAKADA..RACFHAEBdAFAUCBABAGA.SAHHEAHB.hAIAQDEBeCGFaDDAGEGAhBAAACABfDHAhAAAOECEbEAA.CFGDFGAA.LHDA..hACA......hAEA...,2,-20,1,21
FcURCEKHZdGgAYNDaXQMfbOLTWPIBJeVS,DAAAaAAA.MADA..OACDLAHB..TAEAIBBAeAGHhAEAFBDARCDFECHFHCFBGFEBhAGAABGAXCDC.bFFAhBAABEHA.SBBDCEEDdHCB.NIAB.fHFBhCAA...hAIA...,1,-9,-16,7
EHNLAeGcQDWRgOJBfMZYCbFKdVTUaSXIP,eAAAGAAAQADARADAOAGD.BAFAZCDA.CAHAKCCAdEADUEFB..hAAAaCFDSFCAhACA..XDGDhAAAEGABNAIA.ACHADEEB.gFFGMFIBFGGH.IHAAhABA....hAHA...,2,-38,-2,36
VAIWfKRgPTbFZHcSCGedMBaYQENODXULJ,..IAAAKAAARACF..TAFAZACAHAGB.CAFBeCCBdAHAaCABECEBDCEBhAAALDAB.AAIB.hADAfCFE.hAEAbDGDSDGAGEAAMEFBQFFAhCAA.XGDC.hACA...,1,-2,-24,22
MUdfQGRLgJWFODEKbICASVPBZYaXNceHT,SAAABAAAaACA...XACDeAEHHAGBMAEAdBCAGBEAhAAARDEALFDAJAHBFDDHEEHFKDHBhABACGAAAAGBZEBF..NIAB.TFGAhBEA.QGEC....hBGA......hCAA...,1,-3,-17,14
ASbcdLDZJPVCFKgETUHXNaYIfWGMOQBRe,SAAAdAAAZABB..VADAKADAEAFEHAGB..aAHD..fDCAhAGAGCCAMCFBQDFChAIARDABAAAALDHBhADADDIBCEDATFGAXGCANIBB.IGFA.BHAAhAHA.eCGD..hCAA...,2,-7,-7,0
BKFCAPZHRIGNQXTfSaJcUbVLYWdMeEgDO,HAAARAAAGADAQADC.TAGAaAFAUBGBLCCAdDAAECCBOCABhAAAFDFH.ACGBZDEEXEGDhAAASDHH.hABAbFAAVFBAMFFBeHDABGGACHHA.NIAB....hADA......hAIA...,1,18,-4,22
PXfETGNBAMbdWeQZDIaLKFRYSHJUOCcVg,dAAAeAAAZABBDAEALAEARAFA.HCEAOBCCCBHA...VCGBXDBAhAFAEDDA.GEEBhAGAAAAAMEBBbGCA..QFEAhAIAaGHB.FGGA.......hAIA......hBAA...,1,-9,-17,8
AbCFcgVXKGUBdMHWQETLRfeJSDYPONaIZ,FAAAVAAAGACA.dAEBHADB.EAFARAGFeBEHDAIBOBGD.aDAAhAAAACIBCDFA...XEFAhAIABDDDMDFB.TFAAhADAfGGESDHHNEIA.bEFD.KGCAhAFA......hCAA...,2,-25,-7,18
YEGLTgPZXBJNSHARObKFDcVeQIfWCaUMd,RAAAKAAADADAeACE..QAFA..fAFBaBDD.hAAAdAHAECFBGBCATEEAhABAZCEBBAHASDGAhAAAHEGBACCAFHDAIFGACCHA.MECB.LHDAhCAA....hCBA...,1,-15,-19,4
bFJXRQSAHcVOTYWaGMZCedLKDBIgPNEfU,HAAAOAAATAEA..aADDZAGBeAFAdCADLDDBBBBD.gDFGhAAAEBHFUDBAbDEBhAFAXEAA.RGAEABIBcDGDhAGA..YEHBGGCBMFIBDFFBNIDB.hACA......hADA...,1,2,-7,9
RNfAWUEMSDcLBFaJHQdZYKPbeGOIVgCTX,EAAAMAAADADALAEA.FBBAHAECZBFEKCDBeAHH.GBCA.hAFAOCBHgDFAhAGATEEARFGBADIBSDGAhAAABGDA.aFCC.dFHA.bGDA.CHAA.NIAB...hAIA......hBAA...,1,9,-25,34
KIUBRcJbMFECZSeaLVWPHQYdNfGXOTDAg,KAAABAAARACF.JACAFAEA..ZAFB..eAGHLBHB..PCABhAAAHCBAdEEAGCDATECAhAAAAAIBUFFA.MCIBhACAEFABaFHB....WFCBYHCA.hCBAXGEADGIB..hAFA...,1,-17,-26,9
XLeFaVSKQWAGMTOfCDdYIJPcNEBRZbUgH,GAAAMAAA.OADADAEAdAHA..JAGB..PBBAECDARDBFZDFAUBFAhBAAHFFALCEDFHDAaBHDhAAAKDHB.ADDB..TFGAhCAACEEDIHHA..BGEA....hCBA......hDAA...,1,-3,-31,28
CJXIMRSUEWfAYGKeagcFbHBPQdNDZLOVT,GAAAeAAA.aADAFADDHAFBQAFAdBHAZCDFLEGBOAHFTCEAhAAAXDBD.MEIBhAAARDGBECCBAAHA.KEED.bFAABGFChACADFAA....CGFAIHHA..hABA......hAFA...,1,-3,-9,6
KdIgeJOfCNbDGTWQYMALRcSaEVUBPHFXZ,RAAAaAAAEADEBADA.HAEBZAFBdBHA..eAGBOCCACAHB.DDDBGCCAhADA.TEFAQEEAhAAAABBBLEHBSEGAhABAPFEBKFAA.IGHA.fHCBhAFA...hBAA...,2,-18,-17,1
abNMPfTZXVcLdGgWRABUOYFJKHIDeSEQC,OAAAFAAAHACBDAEAEAEA..QAGACAGA..bBFAMBBB.hAEATCCAZDEAXFDAhAIALCEBdGGAGDGAhBAA.REBBADIBBHDAUGEA.......hBAA......hCAA...,1,-3,-19,16
DePfCUaZAREbdJgNLYGSQXKWFOBHMIVTc,EAAAdAAAJADALADA.GAGAQAGCKBCDOCEBHCACMCFBhACA..TEAAeCHFCECAhAIAZFCERGDA.bGDA.NDIA.XGGBhBAABDFA.........hAAA......hAEA...,1,-9,-12,3
cCPKBZFXfNIOgHADGMTLUReVSaJYbdWQE,GAAAMAAALAEARADAeAGH...aAHDJCDFdBBA.ECEACCHABDFD.hAFAZEAAfDCAhAGA.ODFCHEGBAAABTFFAhBAASFFD.bGACcECD.FHDAhBDANIBB.DGIB....hCAA...,1,-11,-12,1
QLGOCaUBcTHAVMYIDPERZbgSWdFJNfXeK,MAAADAAARABAZAEB..SACAdAHA.FAFAJCGF..XBBChAIAeCDDLEABGBEAaBGEhBAABECDHDGB.ADDBIGEAhCAAEFEA.gECAfFHAQGGBhCEACHBA..hDAA...,1,-9,-33,24
KDVcOdWNMFCfZBgQPRHEeJLIGYXaAUTSb,TAAAKAAADACA...OACAdAFAMAHB..fAFAZBCBBDFA.hAAAQBGAHECCEDHFLGFAhAIAGCCAaDBBABIB.hBFAbEFA.VGDA.cGGA.FHAA..hAAA......hAHA...,1,-2,-29,27
SfCGJAaPUbWdYReMIVXOKEgHFcDLBQNTZ,aAAAUAAA.dADARACF..eAEEMAFA..XBEDEBFAHCFC.DDBALAHBhBAABDED.TECAhBBAZEFECFBAABIB..bEEB.hBAAIEHAKGEDFGGA.QGCB.fGGAhCAA..hCBA...,1,-17,-24,7
EAYSRdFQGbXWLTNegacOHVfIUCDBMJPZK,RAAAdAAAGADA..bABDLAFA.eCCBaADAHAFB.fAHEhAIACCFAMCHBZDAFABEBFDEBhBAAQFEA.hBDAXGACTDGAgFFBOEHD..hCDA......hDAA...,1,-5,-20,15
bJNgfGKOYZXdHRAUaMBIWQVeCEPLcDFST,aAAAMAAABADA..QADAeAEH.EAFALAGBFAHD.bCCDhADAgBBBGEEAOBBBhAIAZDEAHFDAABGBIEHAhBAACCFADDIBSGFA.....hBIA......hCAA...,2,-21,-9,12
bZKULGXDVEHgTYdORMAWNePIJBfcCFSaQ,eAAAJAAABADBCADA..FAFA..aAEDZBCELAGBGCEBDAIB.HEEAhAAATCCAdEHAMDDBhABAAAIB....PDFBhBAAfGGEQGBAKHCA.XEGDhBGA......hCAA...,1,-11,-38,27
MDeYbQFPLJVcaGKOWCTSUHZdEIXRBNAgf,MAAAeAAAQADALAEA..VBBAGAGAOAHDTCCAHCEAhAFAEDFBREEAAEHADDIB.bFBAFFHDhAGA.JGCAaFFC.CAFASGHHhAAA........hABA......hAIA...,2,-11,-6,5
UNWCZIPXOcdJHVQADGBMbESYaRTgfKeLF,GAAAMAAA.EADAaACERAFA.....TAFAKCDAeCGFLAHBhAFAFDCHUFFBCBBDZCDA.XECAhBAAdGAA.HFEBAAABBDHAhACASGGBgFCAfHCBNICB.hADA......hAGA...,2,-11,-6,5
fPdLcCHJaUYeKFEQbDWRgISTGZVOABMXN,MAAAXAAA....fADAdADALAFAHAEBaCDEeAGBhAHAECGAQDBChAAAbBBD.REEASEHBhABAZDDFAAIBBDFAcDGDCGAAUGCAFGGBDBBBgGGAhBAA.....hAGA...,1,1,-3,4
WFXLgYISQaeJGKbCONUcEVARTZdBMHfPD,RAAAdAAAHADBDADAFAFDLAFA...gCFASAHBeCCBhAAAGBDACDAA.OBGDhACAUFFAEGAAABDBZFEBMCIB.hBAAfGCAXCBDQGGAaEEH.hABA......hADA...,1,-1,-22,21
IRQBAaMFYXGJfLWUODEPScbKeTZNHdVCg,aAAAMAAA.FADDGACALAFAOAEA.EAHFSBBB.hBAAKCEAeBBDZCGBHEEBhAGAdBEACCGDREEAADDBJHAAfFHAhCAADEIB.PHEC..cGCA..hAHA......hBAA...,1,-2,-23,21
RJTDgLGFfBUKceaNbMdCOWPSVHIEQXZYA,RAAATAAALADB.GAFABACBKAEA.eAGHbDCA.dCCA.OBHDhAAASAHBHEAAEEEAhAEAZDGBAAAADEHBFFAA.fGFEhAFAaFGHMFIBCGADPHBA...IHHAhBFA....hBHA...,2,-13,-8,5
FRLDXfNABgZeKPCMUOJaVIcTGdEHbQSYW,ZAAAeAAACADB.MAEAUAFA..aAGE...VBCATCAA.ECEBHCFAhAAA.bEEAQDGAhABASFBAFDDHLHCAhABAfFBAAEEAKGGDOFFB.IGDAhACA.dGHA...hBFA...,2,-12,-6,6
VBDNIYCGSKQHWZcRgdOFfEAabLJTMeUXP,aAAALAAA.MAEAeACHUBEA..XAEABAHADCAAIAHAhAEAGCGAKDCAHCEAZECEhABARECAdCHAFGCD.ABBBbFAD.hACAJEGFTGFA........hCDA......hCEA...,1,-6,-21,15
SVFGfbdUgYBPeJLAaIRDOZHTCcKXNQWME,RAAAZAAAHADBCADB.KAFAQAFA..EBHFFCAAGCFAdBHAUDDAhABABCCD.eDABACEADDGBTFDAhAAA..XEGDhACAMDIBfGHE.YFAFhABALFABaHFCIHHAhAFA...,1,4,-33,37
GZAUVRYWbgaSQTJDOHePCMXFfcNILdBEK,RAAA..bAAAaADA..QAEADAGAHBDAeBGHMAHBFCAA..fCCEhAAAIDDAdDFAhAAAEDHFZEEFAAIBVEAA.gEGHhABATGBAOFDFXGBAcGGABFEDhACA.KGHB....hAEA...,1,-1,-3,2
JOAVCaGSFEdZPQcNLfTDgUYXBeIHRKWMb,aAAAGAAA.EADAZACBQAFALAFATCEADAIBUCDA.BDFBhAAAHCGBRDGF.MBBB.bEBAhAGAADABSFFDhACAdFFA.PHBAfGCA.....hADA......hBAA...,1,-3,-16,13
KDUWAMLIZfGTcCFXdSHBVJQgeREOPbNaY,MAAAZAAAGAEA.CADB.dAEAHAGDBAGAQCAARBBBEBHF.OCHDhABA..bCFDaDDBDDBBhAGAADGBLFFBTFDAXGGAhAIASEED.gGAANIDBKDHBIDEAhBAAFFHH....hBBA...,2,-23,8,31
SDQGBYNWVPgECTcAIKFUJHMfXLZeROdba,FAAAHAAAMADALADBZAEE.RAFAdCAD.aCEDQCCCGCGABFAAhAAA..NAIA.VGDAECFACDBChBAAAAFA...KDGB.UFCAhBDA.JFFB...fHGF.hACA......hAIA...,2,-16,-13,3
LCBdWeXGDYQaVcgbMAfTJIFOKNHZESUPR,TAAAFAAAKADAHAFB.ZCCAEACE.UAEARDABLAHBdAHAeCCBGECAhADAQDGA.aEDDhAAAgEEGABGA.hCAAfEHAOFEDSGGABGHADFABYHEAhAFA...hCDA...,2,-17,1,18
TLEbCUcKVfFNBYJQWGMAZPgSOaIRdHXDe,ZAAASAAAaACA.RACFHAEBeAEHLAGB.ECCBbAGBCDFDKDHBhABAFDEHBDGD.QEAAhAAAGGBBAAIBOFFChBGAdFGADBIBcGBDfHFFNEIA.....hABA......hAEA...,2,-8,-8,0
OPYLbTcGeUVagFWfSEBIMNJZKdXDQACRH,HAAAOAAALADB.TAFAeADAaAGDFBHD.SBBDhAEAECABMCCBZDEBdCCAQDFAhAIARFAB.bEDDGGEBhAAAgFFGBFCA.IFCA.KGBDAAHA.hACA......hAFA...,1,2,-2,4
gMHaPQAVfRTGXJeSICUNFKYdcBZbDOLEW,RAAAGAAAeADE.CADAFAFAdAGAZCCA..OAHDECHF..MDGBHCDAQEBAhAAAAAABTDGASDADhACA.IFCAhADAKBDABEEDbFEBLFHBaGCE..fGGAhBCA..hBFA...,1,-14,-17,3
dJgTXEMBGVPUNIQLaeRHDfSFbAYcOCKWZ,OAAAKAAAdACA...TADAEAEAGAGA.UDDAQAFChAHALEABRCCBHCFCDDGBFEHDAAIBCBBDhBAAZFCAXEFCBGGD.hAAAPFHD.aGEC.......hAEA......hAIA...,1,-3,-22,19
EGdJVIDZaQWgbOHRXSTFUefKYMNcALBPC,LAAACAAAdACA.VAEAZADBQAFA..bCAAHCEBRCFASAHBhABATEGAeCBBhAAAKEAAMCEBAAIBEGDAIHBAhBCAaEGDOFED.FGHDfGGE..hBHA......hCAA...,1,-5,-15,10
GIRaBPEfdMLSXeTUOcZKAYWDFCgVQbJHN,DAAACAAA.QACAHACAGAFARAEA.aAHFEBBBdCAALAHB.eCEAhAFATCDAUEEAZDGBADDBFEHBhBAAbEAA...IHHAhCAAfFEA.MEIB.OHBC.hDAA......hDBA...,2,-15,3,18
ZgWEdFGXPVHKeCcYORbMDSQaLTIfUBAJN,ZAAAEAAAGACA..XADBHAEAeAHHCAFAOAGDRCFBMCBBQCAAhABAaDHDLEEBTDDAhACAfGAA.hAIAAAGAgGGAdDFAFDHDKFCAcGGADEAB..hBIA......hCAA...,2,-20,16,36
cMAHWdKVGRbaFIDEYOTSPQLgNfCUXZBJe,HAAAdAAAGADARADFFAFADAIBEAFA....TBGAQCABLDAAhACA..fCFAhAAAXDFCZFAAeCGHAAIBKEHBhADAaDDHODHDSFGDgFCGCCBA.BFFDhACAMIDA....hAFA...,1,-3,-7,4
BXfOGaZKAegSLFHUVbDCMcPJYQWdRNTEI,eAAALAAAHADAVAEACAGB..MAIB.JCCBQCAA.hAAARCDBEBHFXCGDGDFAhABAZEDBAAHAFEAHbFACDFFAPFDBhACAdGGA...IHHA.BFHA.hABA......hAFA...,2,-13,2,15
eMdTXAgbUcZDSPIVOLGBQaEfNHWJYCKRF,UAAAZAAASACE..IADALAFAGAEAaCCCECEEHAGDhAGA.JCDFKCGCRDFFeDHHhAIAdEEAAAGA..bEFDDGIBODHDhABA.BHEDNICB.......hBAA......hBCA...,2,-18,-11,7
bRTcMgaCGfUOWQJKVINBSeLDPXYAEHFdZ,HAAAZAAARAEA.MACACAHB.GAEBUCAA.QCCA.KCEAICGAhABASCGHLDDBhACAXEFCEDFBdEHATGGAhAAA.aHAAOFAA.JFFF.BHHADDIBAIAAhAHA......hAIA...,1,-4,-20,16
gOPaIVCWUfNdLSTJRZBceGAQMHYbFDEKX,HAAAFAAAEADAXADB.OAFCaAFDCAHA.UCABdCCALCHBhADA..TCFARDFFZEDBeFBBhAHAAAHAMCIBDGHBKDDA.hBAAgEFA.IFCAWHDA.SGHBhAAA.BHCAhACA..,1,-2,-22,20
QeZTWSKdVfOBDFULaARJCPXYgMGHcIENb,RAAACAAA...XADBMACAHAEC.EBCBbAFAeAHH.ZCDB.SDBBhAAAdCCAOCFBFDGHaCGDhAAAADIB.JEDB..gFDAhAHAIFGATGAAKFHBBGGDDDIB...hBDA......hCAA...,2,-15,-11,4
VENJDSRPTGXZgIWHdYBOKacLbeFCQUMfA,EAAADAAARABAGACAZAEB.....IAEAHAGBdCDCOAFDaDFDLEABhAEAeAHBQDFBhAAAMDIBAAIB.VEDBSEGHhBAATGGAWCBDKFED.FHCCCHHA....hAIA......hBCA...,1,-2,-16,14
gfcZMNVLWDUTbFKaQYIPdeGEXSAOJHRCB,HAAARAAABADB..fADBZAEBMAHBLCCBDAFAUBGA..TCCAhAAAKDGD..aDHDQECBhACA.IEGAhAIAeEEBEGBAAEIBCFEAgGGAcGCC.NIAB..hCAA......hCCA...,1,-21,-22,1
dKbFOXNWMQJSCIUPHaERcVDgGTZBeYfLA,dAAAFAAAOACD..XADAMAEA.QAGACAHA.ICCAhACAHBEARDEADCIBGCEBhADAZEBAeFGBLEAAhAEAAFHAKGBAbEEAJHDESFHH.aGAA..hAGA......hBAA...,1,-12,-18,6
YgQJRDIFZaOTfWbEGHAcVdNMCeLPBUXKS,dAAAMAAAeADALAEABAGAKBHB..SAHHQCBARBBAFCEDhAFAZCFF.aCGCODAB.hAGA.TEFA.fFHAhBAAEDDEHFDAADHBNDDACHEAPFHD...hBBA......hBCA...,1,-14,-20,6
ANEKfbWaLPeOFDYXcURgIZCJBHGdVTMQS,EAAAKAAA.....bACAaACA.eAEHDAGA...XAGARBFFZCCBBBHBhAAAHCCBdDAAMCGBACCB.hADAfCHELDHBFEEBhAEAcFDBgGFBCDBCVFGBQGAAhAAA.SHEGhAGA..,2,-18,6,24
DQHLPeNbISRZAUTGXgcMBKfJWdYEFCaOV,GAAAXAAAMADAKADA...JAGBdAFAECDAaAHB..DAIBHCDAeDBHhAAAIDAAZDEE.AAAAUEFAhADATFFABCHAfFDEhACAFDCHOEHFLFHBNIBB....hBAA......hBCA...,2,-13,-9,4
MSHPcgDeFdJIbECOLfYWGUTaRBVNAZQXK,ZAAAQAAAMACAHAEC..PACCDAIBeCCAdAFA..JAHBECGFLCDBhAAA.fDGEhAHAGDEAaDHDRFDABFHAhCAAAGGASGHH.FHAACHHA.....hDAA......hDBA...,1,-10,-17,7
WaUZBEAMIYPbGLdQOCDeKNVSTgFXcfRHJ,MAAA..IAAA..bABAdACAQAFADAEAeAFAKBEDhBCASBHBTCFAXDDChBIARCCBHCEAaEFDZEFEAEHAGFABhAFALHCACFHANIABFGGAfHFB.hCAA......hCBA...,1,10,-17,27
AKDMLYEHFbdIPaVTfcWZSGRJNOBUXeQgC,MAAAEAAAHACAdAEA.aAEA..TAGA..fAHAZBBBRCFBOCHFhAGAXCCA.eCFBhAAAQDDCACIBLEHBhAHAbFFCIHHAcFEASGCANIABBHFA.hAIACHFD.DBBB....hBAA...,2,-10,4,14
fMNZJQaUPbFeKEIYWgDGAOBdXcLHCRSTV,dAAALAAAHADARAGFTAEAMCCB..ZDAFaAGAUDDA..FBGDEDGBICAAhABA..gFEAhACAACCAXCDDSFADhADAfDHANCIA.QEAA.hAFAeEFFKGHDDIAABFDA.hAGACGGA...,1,-5,-8,3
edJSDfMcYGHKLaFZWBQCAXVIEgTPbORNU,XAAAEAAA..TACAOADARAEFeAGHdAHADBDB..MAIBGBFAhAAAHDDAaCDDZEAAQEBChABAACCBgEGAbEGD.hBEAUGAASEFDfGHAKHBA.LHDAhAAA.....hBHA...,2,-13,20,33
KMELIGTecBPJYOSFfaWRHCVgXQUdZNAbD,KAAAEAAAGACAeACEBAFB..JAEAOAGDFBHD..aCBHHBCACCFA.hAAAXDEAdEEAZEFBAAHAbEGDhAAALFCB..hBCATFDA..PEHD....hBEA......hCAA...,2,-21,-15,6
UTLMZdXSECAYgRGFcJIBHOPKaNQbfVeWD,RAAAGAAAFADA.JADAHAFB.KAHBaAGA..QCCA..hAAAbBGDeDFADCDATDDAhAAAZEFEdFDAEGGAACGB..gFDAhACABHAA.ODBD...fFHAhBAA.WHFAhBCA..,2,-18,-17,1
AaEgHTMfBVZOGXUdSNJCcYeQWRDbILKFP,EAAAHAAA.MACABACAZAEEGADAdCCA.SAFACBHAeCFB.RCFADAIBhAAALDHB.FEDDAAFAaCCHhCAATGAAOEFBXFEDhAAAUGCAJEHB..YHFG..hAGA......hAIA...,2,-15,-8,7
WXTEbaBCLSOAdFDMYJZcUKIVfQgeGPRHN,dAAAMAAAZABBKADA..VADAQAFC.eAHHRAGFHDCA.XDGAhAGAEBBBaCECLEEAhAHAAFFADFHB.JDCBIGDAhAIAGGEB..WDHH......hBAA......hBCA...,2,-23,-13,10
egAIJVadZTbHCLUKWRNOXBDQPcFMEYSGf,VAAAZAAAHAEA.LAHBKADCRAFA.OCABDCDA.QCCBhABAFCGD.ECFAGDDAeEAHAEEAhACAaDHDdEGACFGD..UGAAhAAAXGFCBGHA.MEIB......hADA......hAEA...,2,-29,3,32
XaIBGbKANLSQEcdCFURMTHfOZVeWPYDgJ,LAAAEAAAdADA.FAEARAFAHCBAZAGB..eBDF..PCFBDBIBXCAAhABAaCHBGFABACAA.hACAQFGACCFC.hDEAMIAATEEAfGFEOEGD..WFHHhEAA...gGEGhEBA.,2,-28,5,33
CSAaYZLJPbUcTEOWgRMHeDVXQGFIBKfNd,ZAAALAAAJADA.UAEA.EAGAOAGD.RCAAHCEBeBHFXCAAhABAGECABEHAKDDAdDFAhACAAAIB.aDHD..bGFATGGAhBEA..gGAB.DGFA.hCAA......hCBA...,1,-15,-17,2
DLKXgbAdJUTGQMCZBfPaVHRIWSEFYOecN,dAAATAAAGADA.MAFAZACBBAEA.aAFDHBFB.RCAASBHBhACAEAHBOCABeCEBhAAADEFBLEHBKCGA.bFBAhADAAEEBQEGACGFA.fGEAhACAIHCA.FGGH....hAIA...,1,-1,-17,16
GeXLYJObVfSBKMaZRcQHDCdNIWAgUPETF,UAAAEAAAGACAeADALAHBOAEA..VBGBBBFA.aCBERCEBHEBAhAAAdDEA...IFGAhAIAAADATEGAFGHDXECBhBAA...bGDAKCBD.MIBA..hBCA......hBEA...,2,-18,-3,15
bODYWLENgeKAZVTdcaURfCXJBQGMPFSIH,ZAAAdAAAaADARAEA..CAHBBCAAGAFA.FAHFHCCCDBDB.LCGB.hACAEDFFeBED.ACCBTEGAhBAAUEAAJFHB.MACAhABASEED.OHDANICB....hBCA......hDAA...,1,-16,-27,11
PGDERZHdVOSIUbYWcJLfeXKBCgTQNaAFM,MAAAGAAARACA.HADAdAFA.SAFEUCCB...bBFA...hAHA.cBGDLDCAhAAAeDEHBDGACDHA.TFFAhACAaFGAABBB.DDABZGEEOEHFIHBA...hADA......hAIA...,2,-21,-9,12
gbQcBTFEDVfSGNKLMaPWOdYCIHZAUeXJR,eAAARAAAQADCBADAEAFADAFA...SAGAGBGALCCAhAAAaCCC.OECAdCFACCHAHEFChAAAAAIBXFAAJFDB.hABAbFFAFGGH..fGEE...hCAA......hCHA...,1,-11,-16,5
SLPDMBFCXAObfZYQKdWaIEgVGTcJeNURH,OAAAZAAAQAEAdAEA..aAGAEAGAGBCATCAA..eBFHhBAARCFAHDDBLCHBMEABCECChABAABBBbEBDKEHB..gGFAhACAVFFB..NEEA.......hBEA......hBHA...,2,-9,4,13
gfUWPBYZabQKDIGJSHECReVOXTcFLAMdN,dAAA..fAAAUADABAFAaADAQBGADAGAGBCAHCACRBEAeBHHhAAAXDEAFCADADGBMEEBhACA..gEDGhACAPEBDZFEBKEHBSGGAEGGBOHAA..hAHA......hAIA...,2,-15,6,21
aHdXQAeEMUFNcKSVCDgWOILJYTZRPGfBb,EAAAMAAAFACDKADA..CAEA.DAFA..OAFDLBBB..TCDAhAAARBFAGDCABAHAHEEBhAIAdCHAAEAAeEHBUFEASGBBhBAA.WHDAIHAA.ZEAE.hBGAfGGB.hBIAaHDC..,2,-23,-19,4
MgGPAKYCbDcQNUVBEfXLdeRSHWZOaIFJT,CAAADAAA.QACAUACABAEA..EAEALAGBRAGBHCDCZEEA.aBBHhAIAFCBH.MAIBGGCBhBAAABGB..KDDAcGGDhBIA..fEFAXDGA.eEGH.OFCBhAAA.IHHAhBCA..,2,-34,0,34
ISVENKFXbYZfDTGRgaHMPcWOeQBAJULdC,LAAAdAAASADAEAEAFAGD....bABDZCAA.TCEARAFFHCGBhADAMAIB..cDCDhAEAeDGFACCACAHB..IFEAhBAAKEAAfEEEDFIBaGFD.OEHDBHHD.JHFAhABA......hACA...,2,-13,-7,6
fcBGXPNZCTeMdJVYbSAQHOWgEaURKDFIL,HAAAOAAAEADERADA.FAFALAGBBBHAGCAB..XBBChAEAZCFAeECAdCFCVEGBSCHHhAIAAFFBQGCAaDDBDEEBhBAA.fFFA.PHFC..hBIA......hCAA...,1,-1,-18,17
faECGIFAbZcJOWdBXTUYeLgHSDVPMRNKQ,ZAAAOAAAdAEABAGAUAEALAHBHCAADAIB...MBBBRCEAKDHBaCCBGEBAhABA..ABGAJDDAhBAA..TEFAeEFASEBAhBDA.PFHDfGAEhACAEGDACHCD.FGHB.WEED.hBEA...,1,-13,-20,7
McTDWUBNCJVOPIgXEbRGHQLYaAZfedSFK,eAAAdAAAKADAMAEADAFA.BAHA..CAHA.OBCC..ICCAhACAEBFERDDAHDGBLCEAhADAAAAAZEBFFFFH..TEEAhBAANICB.VFCB.XGGA...hBEA......hCAA...,1,-15,-33,18
DKdXPFOAcSYWZJGfHIRVgUeMBCTNbQaLE,SAAAZAAAGAEAHAGDRACF.UCAAeAEEMCIBTBEA.QCGAhAAAEDDBdEGAFGAAAAHA..hABA..cDECJGDAIHHAhACABFGAbGECDIAA.......hABA......hBIA...,2,-18,-3,15
WQVaFIGOEDcYLBNegbKJAMXUfCTRSHdPZ,MAAAXAAAUAEA..CADA.RAGBHBBBZAEBQAGAFDEAGEBBECGBDDIBhAIALCDDBEGA.eDABhAAAKGGAABBBSDHHhABA.dEEA.PGFC.....hBAA......hBDA...,2,-25,-1,24
ZFPNbOdSDEJQVTagUKXIRfcBeHYMGLAWC,ZAAAFAAA.....bADBdADA.EAFAQAFAaAHD.KAHBRCDABDBAhAFAHCAAGCEAADHA.hBAACDGBODHDDEFATFFAhBDAXGFA..fGCA.eFHHhBHA.....hABA...,1,-13,-27,14
eOaPcFZHLEJbWCSGVfNQBYKITgMdURAXD,eAAAaAAA.FADDHACBLAFAEAEA..bAGDSCCD.GCFAhAAAfBFAQEDDhABAKDEDTEAAdDHAAAGAOFCHhCAAZEGBCFFABGEDIGHAMFIB....hCBA......hCFA...,2,-11,-1,10
MSWVJAbNRTLgCYFEHPDXIGKfOdcaZUBeQ,RAAATAAALADB.CAFA.EACEHAGBDAEAGAGAOCCH.dBFCZDFAeCCBhAAAMEEB..SCEDhAIAVFAB.ADIBbEFDgFFAhAAA.........hBIA......hCAA...,1,-9,-18,9
dEWgZfKITYLRcSVCHGPeDMONJbFXUBaQA,EAAAZAAAKADC..TACARAFA..SCAAHAEBeAGBMCEBOCCBhAAA.JDEFXCFAhABAaAHFADGBdEAA..fEGEhACALEHBCGFAGGABDIDA.bFED.BFCBhAGA.QGGBhAIA...,1,-1,-16,15
RDQaAPBFbIYUCeGcgEMOJZLKTVfSHdXWN,FAAA..bAAAUADAeAEAGAGA.ECCBMAIB.ZBEELDFBhAGATCAA.SDBDhAIAHDDCdDGAXEAAhAAAREDFaDHDAGBABGHACFHAgGGG.....hBAA......hBDA...,2,-19,7,26
QGcJKSCXgFMHfBNAWbZPVeTRODYLIEdUa,ZAAAeAAARAEADACALAEA.EBCFaAHDGCEA.KBHBXCCAhABAFDHHHECBBCFAAAAA..bFABhAFATDGA.OEFBhAFAdGGA.QGGA.SHAAhAHA.MIDA..hCAA...,2,-25,1,26
KHQXSdCMVbcEZNeWLTfFOaDUAJRYgGIPB,RAAAGAAABADBHAEBQADAdAGB.MAGBVCCBEAHB.ZDCA.eCGHhAAATCGAODAH.aDHDhACAAAAAJEFB..gFBAhADAKEHBCGHD.bFDDWFEDFGGADDDA..IHBAhBHA...hAIA...,2,-21,12,33
FaDLEZAQTJXOfeKCBWPVdbHgUMINYRScG,TAAAOAAAKADA.BAFBVADA..HAGBMAHB...ICCAhAAARCCAGDFADAIBEFCAAACAQDEAhAGAXBBCeEHHhAIACDHAdFHA.UGCASHEGaGEE...hCAA......hCGA...,2,-14,-13,1
fKUZSCVbWOFGgEXYPQBLaTNdcAeHRDIMJ,HAAARAAAMADAKADC.ZAFBCAGA...VCCBOAHDGCGA..EBDAXFBChAAAQCEAaCAHdFEAhACAAAAAeCCB.DDHBfGGEhAIASEEDFHBEgFFB.hBFABGDD.NEIA...hCAA...,1,6,-26,32
RGTQfbVUaOMEDIBFcYSZgKJPdHAXeWLCN,eAAALAAARADAGAGATAEA..QCCCVBGB.aCFHECAABEAAhAAAFCDB.SDHHhABAZEAAKEEAdFHAHFFAAAGACGEA.bGAAhAEAMIAADEEBIHHA.....hABA......hACA...,1,15,-16,31
MfKXIFCZGeBdWAaYVLbQESDRNTgUcJOPH,aAAALAAA.EAEARACF..TAFAUBGAOCAAHCDBMAIB.XCFAhAEACCEAeDDBdEAAABBBVFAAhAFAQFFA.hAHADECBgEGAJHAAKFHBFHECZGEA....hBAA......hCAA...,1,1,-8,9
GXfDZJgNbUBdEaVLFIWRcQTKPSAHeYMOC,HAAAeAAAMAEAGADADAIBZAFA.JCAF....bBAAdCGA.ECCBaBEAhAAALDFDFCEB.RGAA.hAAATCGASEGAhACAAEFACEHAXFFCfGHA......hADA......hAGA...,1,-3,-22,19
TWCPREZMOSFdXYLIJHGBeaQAUDgKVfbcN,DAAAKAAA...VACA..bACB..TAGACAEAEAGA.ZCCA.MBBBhAFAFBHDdCEA.LEDAhAAAHDFBeDHBACCBUGAAfFCAhAGA.cGCDPEHB.RGCASGGDhAGAIHGA...hAIA...,2,-25,-12,13
BYgJPCLFAVGQaIObcdXZWEMeNRDKTHUSf,GAAAaAAA.OADAdADAZAEBEAGAeAGF.RCGF.TCDAHDBASEFDhAIABBHAJCGFLFCAhAAAABBB.QGFAhACAbGFA.cDCCMIBADIFA.....hBAA......hBCA...,2,-11,-5,6
PMWXaVCGEbLRHgKBYUZNQJTOeDFASfcdI,SAAAdAAAMADA..aAFEGACA.EAEARBDBHCACBAGAZBFEQCFChACATDFAeDHHhAAAAAIBfDHA.IFFAhBAAXEAACFHALHCAKEDAUGGBNIAB.DHDAhABA......hAEA...,2,-5,-5,0
CcKaMdDNUZeRgbFLXOPQEAfISWJYHBGTV,SAAAJAAAHADBGAGACADA..KAFAdDAADAIBZDDA.RFAA.FCCALFDBhADAOCED.EFFBAAAA..hAFA.IFHABCGATDAAhADA...aDGE.MFAB.eFGBhAFA.bGCA....hAHA...,2,-34,-6,28
OLGcPfRUeEHFYIZdANVBDbWJMaCQSTKXg,BAAADAAA.JACAaABE...QAEAKAFC.OAGFGBGA.hAEA.fCCAhAIARCBAEDEFHECBFDEAZFFAABIBbECDMIAAhAAACEED....TEGA.XGGAhBAA......hCAA...,2,-27,-22,5
LZOAKCSHfTUXVgIBFeWYGJNMDPbcEdaQR,SAAAHAAATAEAUADA..XAGBVAFA.BCADFCCHeCHFhAAAGCCA.MBIBbDFD.hABAECFF.aDHHREDFODBHhAIAACCBfEAA.gFFBIHHA..hAAA......hACA...,2,-9,-8,1
eaMNbGYLUfWJQcBAHFdIZCVRDTPOKSgXE,HAAAdAAAZABBRADFDAFAOADCKAHB....SBFHEAGEeCEAaCHDMCABhAAA..GDCALDHBhACAUEEAJCCFQFAChAFAAEEACEFA.PFHBXFCAYHDG.hADA.fGGEhCFA.BHCA.,2,-13,8,21
ZUTFfdgYcWKCXENaVIBQAeODPJLHRGSMb,eAAADAAALADAHADARAGFGCCAMAHB.ZEFAFBBBdFAA...gGDAhAAA..cCDAhAEACCFDEGGB.aCFF.BDDDhAFAACCB.OCHDSCHHbFFB....hABA......hAFA...,1,-1,-31,30
afAMWZRNHXDGBSdgTOUYFLKJPecCVIEbQ,ZAAAHAAAGAEAdADATAFAOAGF..FBHDLCABKCAD.eCCBhABACCCDECEFaCHD..AAHARDFBDDGBhACABEHBSEBHhADAUFAA.PEEBIGHAbGAAMFHB..WFFDhAAA.....hAEA...,1,-6,-12,6
eNCcZJbVKXSLaFOBIWDTMAUYGRHgEfdPQ,GAAAHAAAEADEdADAeAFECAFAZAGB..JBFBKCEBLCAA.aCGDBDDDhAAADCEB.ABIBREFA..fEHAhAAAQFAAbFFDhACASGCB.OGEC...hAIA......hCCA...,2,-25,-14,11
HFaJCKQXPLWeETIYfNOBURGZMdDVcSAgb,HAAAaAAA.KADCQADALAGBEBEA..TAFA.fBBEhADABCADRCCBZEFAdAHADAIBhAAASDCAADIBbFDDCGCA.hACAXDFA.eEHHIGGAOFDA.hCCAMIDA....hBAA...,1,-10,-15,5
fZdLMATeNKDGHPJWSFBbVCXEUORcaYIQg,eAAADAAAHABC.JAEAFADD.BAFA.CAHAUCFARCCAaAHD...QDDAhAAAZCFFdEEAADHAKFHBGFABhABA..SGGDhAHAbFGB..EHAE.OHDAIHEA.hAFA......hAHA...,1,-20,-26,6
EDNXZVGdPbUOKITCYHBJcfeMLaAFgSRWQ,SAAARAAAEADE.DADAZAFBGAEBdBHAUCCAKBCA...CEFAHEGBhAAABCEAJCGB..eFAAhABAaDDCAAAAFFEH..QFFBhAHANIAB.........hAFA......hAIA...,2,-36,-16,20
IFefOVYgHBdCPKbMTQcXARZDUGaESLWNJ,RAAAZAAAGADAEADELAFB..JAFAeAHBOCCB..gCAAhABAHCGBdDAAKEFDbCGD.hACAMFDB.QGGAhAAAACEAaDDBSEEB.IGGA.hABAfGEE.hADA...,2,-16,-6,10
LgDdNMVXOZYbQeafAUCEJKWTSBcFGHIRP,EAAAKAAA..SACBFACDHAEARCDBLAEA.dCCDMAIBOAHDhAAAbCFD.eCEHAAGA.CCGDJEGBhAFATEAA.BDHDGGABhAGAgFDGDEIBXGEDQGGA.hCAAaHCC.....hCBA...,1,1,-12,13
HcgbWPQBfRaDNLFeJAGTSZVUIXdCYOEKM,GAAAZAAAUAEAdADA.OAFAEAGAHCAA....bBFAQCGAhABARDBFDDDALDGBeDEBAACAhBEATEEASEGDhBIAXGBAKFDBMFIB..gGEGhAAABHFA.NEIA.....hACA...,2,-8,-3,5
eHUPdBARTIQMJGCLFaDVgNKbSOXWcYZfE,RAAATAAAMADA..GAGALACB.aAEADBEA...VCCAKAHBbBDDhAAAODFD.XFCAhAAAcBFC..ZEFBEFHBhABAHFDD.dHABAAIB.IHHACHHD...hCAA......hCCA...,2,-21,2,23
FISOgVYKMQfePbRTdcNCAaBDZUHWEXJLG,aAAAZAAAHAEA.EBHFLADAGCAASCCAOAGD.VDEAhABAMAIB.eBBBRFGBdGADCCFDAAEAhBAADACAXDCD.hAGAFEEAgGCHQFGA.fHEBhCAA.....hAHA...,2,-12,1,13
JZMgFdPTNQaAEVKWbeRLDfHYGCXOBcUIS,EAAAKAAAeACERACA.LAFBHAFBGCDA.OAHFBAHAICCAhAAAZDABMDHBdFFA.PHAAhAAATDGA.aCEBADAB.hADAVFEADEIBCHHA..XDBC.SHAAhAHA...hAFA...,1,-1,-20,19
EGUTegMdcKPLSRBYVCfFNZWQXDOJbaAIH,HAAAEAAAGACAeACEdAFAKAEALAGBRBGFBAHBCCCA.FCBHZDEF..QEDAhAAAODHD.aCHDAECA.hAAAUFFAMEEB.SGFAhCAAfEAE.XGCC.DFIB.hCCA......hCEA...,2,-19,-2,17
QEUBaXZSVAOLKTWFNgRHPIfMcbDdCGeJY,LAAATAAA.FAEARACFHAEB..fAHAbAGB.dCAAeCABhAAAQCCAEDEBaCHDZFGBhACAACFAKCHB..gGBAhAEAMDFBCDGDGEBAYEFBXGFASGDHhBGA....hBIA...,2,-13,7,20
LeCdYTAOQFRGISPZKBfVMWgHEXDNJacbU,QAAARAAAGADA.SACAZAFABCCDMCGBHAEBEAGA.DBIBaCHHhAAAUDAALDABeCGFdDDAhAAAAAHAFFDAKEHB.fFEAhADA.gGAAXGAAcGGAhABACGGAOHECIHFAhADA...,1,15,-27,42
EaUXbAJTKNPVgMLBYDSCQedORIfZFWHGc,TAAAKAAA..VADAMACALAGBBAFADAHB..QCAAhAAAeBDBRCFBZEBAHDCB.EDHFhACAaBHDbEEBACCB..PEHDhAAASGCA.dGGAfFFE.hADA......hAIA...,2,-18,-7,11
HfLACDGYcZUbaRFgVEPMNBJOQKeWSIXdT,GAAAZAAAaACA.RADAFAGA..EAFAMCDBBAHA.QCCBeCEASCHHhAAAdCFAHDGBAADADEEAhACAUFAA.VFDAJFCFKFFAhBAAIHHA..fGHACHCA..hBCA......hCFA...,2,-21,-3,18
McgQUINAaeSFZWKCdbDEPYOBTVGJXHLfR,eAAAZAAACADB.dAEADAFAEAGA....OAHDTCCAGBEAHCFAREBBMCABhABAQEEC.hACAIEHAABGAaCCHFDGDKGABhAAA.PHCCBFHAXECAfGGAgGCBhCBA.SGGDhCEA,1,-10,-22,12
HEdaYOJMcAbeKQRIWFNPTCgVGDZXfBLUS,eAAARAAAFADA...TADACAGAGCCAZAFBBAHALCFAHCCB.ECHBaEFAhAAAOEFB.MEHBhAAAAAIBQFFC.hABAIGAAPFABDFCBfGCESGEDhAFA......hCAA...,1,-10,-24,14
cAVFJOQTIaNKGgYfHPLeSdbMWRCEZDUXB,FAAAQAAA.aACEGACA.fAEBHAEBeAGBdAGAbDAAhAAARCEBZDGBDAIBBDGD.hAIAADAAODHDTEBAKGDAhBAAgEDH.LHAAMEIBCHHD.EFGB.hBEA......hBIA...,2,-18,9,27
KGXUcbfEgSeaMDVPNFLQYCJOZIWHBRdTA,GAAAXAAAUADA....bACDEAFAeAEAaAHD.DAIB.VCFAhAAAFCFDLDDB.hABAQFFACEAAZECAHGFAhAEARDBFAAABfEHAMDIBPHBAYHBAOHEChACA......hBCA...,2,-5,4,9
IPZRKFSOLdfeXVcaTNYMBbQDHJEAWCUgG,CAAAGAAAZACA.RADAFAGALAFB.dAHAeCDA..XCCAhAAAaCGDTEEAMDAB.QDGAhADAHEACAAABUGGAIFEAhAEASDHH.fGDAcGFBBHBAhBHA.DGIB...hACA...,2,-15,-13,2
QcDfSLFCMGTNIdeHAgJZREPXabKWUVOBY,ZAAAEAAA.aACAKACA.UAEABAFA...QBGADAHBLCCBMCCBhABAGDGA.TFDAhAAAdDDAHEGB.AAHARFABXGBChAIAbFCA.........hAFA......hCAA...,1,-17,-26,9
JKgaSRHGOEIVBZUPfXDeLFWMTdYNAcbQC,QAAAKAAA.aACEHACB.EAEABAFAZAGBUEAAXAGDeCFDhAAALCDBMBIBdEDAAAIBbCFChAAACCAA...SDAAhADARFFAOHEC.IEGA.fFAAhAFA.FFFH.YEHBhCAA,1,-4,-17,13
HDOdTBgYbaNJcPRSLCXEWGZeVFfUIQKMA,HAAAdAAABADA..bADBaAED..JAFBRAGBLCCBEAHB.ZDABeCAAhAAAFDGH.IDGAhACA.MDDBAAIBTFDAhACAgEEB.YDHBPFHDXGAAhADA..WHCA.hAGA...,1,-3,-26,23
NYFgJPMdcKTQZSUaCOAbDHGIEBeLVfXWR,HAAAEAAALADAXADBRAGF.FAFD..JBCFdAHAKCEAZCAA.aDFAAAEAGECBhAAAeDHH..fEDAhAAA.YFEBhACAMCIBTFGA.QGEDCGGDDGIBBHBAhBHA......hCCA...,1,-5,-16,11
FVebJNYWICfGSgRcMBHOUKEPaLdAQZTDX,ZAAATAAAFADA..eAFHJACA......NAGA.IAHAGCCAREFAhAAAMCABHFABKCCDEFEBaCGDhABAAAIBDCFB..bECACDHBSGHBhAFABEHA.OHCCLGDA.hAHA......hBHA...,2,-22,-7,15
VNTXQBYZJAWbcdOCMLISGfUEKDRePHagF,...bAAAdAAA.MADALAEAGAGAEBHFRBDBHCACFCAA..TCEAhAAAQEFCZECAAAFAODHDhABASEHHKGCAeEGDhACAaFBAgGBB..NIABBDDD.hACA......hAIA...,2,-14,4,18
PWKQSXdIBfbcUHTNAMVFGEZaJCLgDeYRO,MAAAGAAAZABEaADALAFADAGA..RBFAOCDBKCCAQCEChAGA.dCGAfDGAhAAAUFFA.HEBBACIBEHAACEEAeDHHhACA..........hBAA......hBCA...,2,-23,-17,6
ZAESIbFPQVgXWYRafLTMBDNdKeOJUHCcG,EAAASAAAFACD.QADA..XAEARAFAaCCBTCGAhAAAMAHBDAIB.dCEAeDABhABAODDHHDDAGEAAhAAAAEIBbFDAgGAAfDHALFFAhAEAKFHD.CGDAIHHAhAFA...,2,-22,16,38
PeWNLAVCIJHESQTcGXYRUBMgaZbOFKfdD,CAAAHAAA.EADETACAGAFARAEF.MAIBZAGBFCAAdCADeCEB.LEHBhAAAABIBJDDB.QDCDhACA.XFAChAFABDHAbEABfFGADEGB.PHACWFEHIGHAhAAASGFD.hACA.cGCD.,2,-29,31,60
daHJLcCRSgbBIMUTGDNYOKfPEQXWAVFZe,ZAAAeAAAHAEALAEARCAA.SAHHBAHBMCEBGBCADACAOCFChABAfCEB.EDGAhAAAQEGAAAFAdEEAaEHDCGCAhABAbFEDTGFAKGAA........hCAA......hCBA...,2,-16,-4,12
bgOdUIXeGDVCKLJRWSYTQBFEcfAZNMHaP,ZAAAHAAAaACA..bADBdAFA.UCCBeAFAGBGACBHALCAA.RCEFSDGAhAAATFBAQFDChABAEFGAAGAA.MEIBhAHAOGAEDAIBKGFAJHDEBHHA.....hBFA......hCAA...,2,-14,6,20
eUOAdITYKZgMECRJWQXDBHGLaVNScPbFf,dAAATAAAZABBEADA..RACFQAECBAFAHAGBGCEAaAGA.SDCHhAIAbBGD.eDHFhBAAACABKDEBMFIBCEDDXFGAhAAALGDAVGCANIBB.FHFE.....hBIA......hCDA...,2,-2,2,4
DfbYGVAgMPaTWeNHFCRZEBKXdSOJUQIcL,MAAAaAAA..eACHHACCRAEAZCEAEAFEKBBD.dAHAOAHDUCDBQDGAhBAALEAADBBB..hAEAbFFCGEEA.AEEBTGCAhAFAFGCABHHASGHB.IHAAhAHA....hBAA...,1,-7,-12,5
gaXSILDEfAPVCcUQdRWFTGKJBMNeYOZbH,CAAAQAAARACA.FACEGAFABAFAeAGHZCAAHDGB.aAHFSBHHhAAALECAEFABACDAVDDAhAFAdGGDKHBA.MIEAhAAAOEGD.bFCC........hAIA......hCAA...,1,-3,-23,20
PbKNCeBXWfMROJQAGVTHZFEIYdcDSUagL,GAAAHAAAEADEdADASAFBaAFA.LAHBKBFAeBHHBCADXDBDhAAAMCCARDDA.QEGAhAAAADDAZDEBFEHDIHHAhACADFFBgGDD..NIABCGFAfGGEhACA.....hAIA...,2,-16,5,21
GZQMgBALFUTVPYCHbeKaOEfIJWdNDRScX,LAAATAAA.VAEACACBHADB..eAHHaAFA.ECAA..fBFBhAAAICDAdDFARDDAXCGAhAIAZEAAMDIBACCBFEGDhBIAPFEBKGHBOFFH..WHAA.SGGBhABA..hACA...,2,-15,-1,14
SFcVPWLBAGTJCMNbXZgKYdHfDRQOUEeIa,GAAATAAA.MADA..XACBZAEEKBHBHCDCRAEAQCCBhAAAEDCBeDGFaAHDFEEH..PCFDhAFALFHBADHACEEDbEGDhAHAdGCADIEA..........hAAA......hACA...,1,-2,-4,2
BPCHaTUDXVfYSARLecWgNEbIMFGOKdQZJ,RAAAeAAA....gADBEADAMAGBGCCAdAGAZCCABCHAHCGBaAHFhAAADDGB.XFBDhABA.fBEAhBHAAAAALEHBcEFCbFAAOEEBKGHB.....hCAA......hCBA...,2,-24,0,24
OXNTFHagcPKfQEMbGJeWCVZdUSIARYLBD,RAAALAAAOADA.TAEAHAGB...aAGAPBDD..QBGDhABAECFBGEGAeCAAhACACEFDdGBASCEDhAEAAAAADCCB.FDGD.KFDAMIDAWEHH.....hAIA......hBGA...,2,-14,-11,3
OXLEBagIKWUeGNdZAMPDFRTSQCJYcbHfV,MAAAFAAARACF...TADAQAEC.CAGB.JAFA...bBBDHCEChAIA.OBHFECFAaCHDhAIAKEEAeDDGdFHAAGGASFCAhBAAfHEBLFFA.BHDA.hBAAIHFA..hBBA...,1,-19,-21,2
AIeKgXHUMVdPJBSbROaTYGWDfCFNQLZEc,eAAAXAAAHADAUADAdAGABCCA.RCEBOBHDaAFEGCEB.DAIBhAAAFEGDLDBBEFAAAAAAKGDAhAFAMDDB.JEEBSGHHhAIATGFA..fGAE.CHCANEIAhABA......hAGA...,2,-14,-13,1
KRcaJEHWFLDYGbZOPSQVfUXAeCMNTdBIg,eAAAMAAAdAEABADAKAGARAEF....aAGAHBBBLCCBGCFAZCGBSCHBhAGAQEEAfEBEhAIAAAAACFHA.TEDAhBAAgGCAEFHBDHDA......hBBA......hBDA...,2,-19,-14,5
dSbFWOYGaDCKIegfNBQTPXVZHEJRcMAUL,dAAAFAAAOACDaADA..KAGAeAEA....fBDAhACAQBGATCEAXCDDhAEAHCBBRDFFACFBLCGBhAGASEHHbFFA.GFABCEEDgGEGBHFA..hAIA......hBAA...,2,-14,-9,5
NXBVGMWQfSbaHZRYIKAPCJcFLOgdUDETe,CAAAFAAALACAdADADAFA...EAGAeAHFBBHAGBEA..MCCAhAAAQDBASCEAhADAHEFBRDFAKDDDABGB.PEABhAEAOCHD..TFGANEEA..WHFAaFFH.hAGA......hCAA...,2,-24,-15,9
eMPOJWHTDZcfVgARFEQNabCBGIXKYSdLU,EAAAaAAABADAGACA.KAEAdAFALAGBUCCA.eCBBMAHB..OCHDhAAAHDABZDFA.VFFAhADAREABQEDAhAEA.bFFBXGDCSGCH....hAIA......hBCA...,1,0,-19,19
QfFIaZHDKALEcWUMbJeNgYRSTBVdGCXPO,EAAAUAAA.MADAeACA.....gAFARAFATBDAdCHAGCCAhAAACDBA.OAHDFDDHZFDEhAIAHDABAFHA.LEFAhADA.bFDDYHDGBGADXGGA.hBAA......hBCA...,1,13,-27,40
JYObdLGITDgcKSUPQaHCMVBZWXNefRAFE,EAAAOAAAdADAGAFADAEA.KAHBSAFA.QBBBhAIAHCBAMDFBZBEAXDGDhAAAeCHHADDAFDEDbFAATGGAhAFAgFGA.cGDAaHAA.....hAHA......hBCA...,1,-4,-16,12
UGDeSVFdbRWZHNJLQfMIBOPEacKCYXAgT,TAAAGAAAeADA.FAGDRACFHAEBLCDBMAHBOBHDECABaCHDCCFDAAABhACADDEB..dEADZEAAQEGChADABEGDKFEAXGAAhAAASFEHWFHHfGHA..hAEA......hAIA...,1,-2,-13,11
LBVFbTRWAJKaOPNGEXDUdfSYZQgICHeMc,aAAAOAAAGACADAEA.dAEB..SAFAZAGBQCEACBBD.HEFChBAAeAHHMBBBLBDBhBAAFFBA.RCFBACDBKGGDEEHF.hBFAXFCAYEEFgGGA.BFFDhCAA.....hBIA...,1,-4,-13,9
ESFXeJCKQVZgTPOUdHIaNGLWfMBbDRAcY,EAAAXAAA..eACAKADAZAFBTAFAOAHDHCCA.aAHDGCDAhAAALDABMDAAbDFAADHBSEHHhABACECD.hAAAQFAAgEEGdFFAIGDAWFCHBHHAhADADFHBYHAAhADA...,2,-6,-2,4
DTEIcQWSNPbZMYVJdACGLagOXBReFfHKU,GAAAaAAA.OADARACFeAEEHAGB.DCDAEBEFQDDA.hAHASDBHbCFAZEEAMBBBhAIAVEGBACGALHEAhBAABDFAKGBA...........hAAA......hACA...,2,-14,-12,2
gcIYOAXFUZQJDPfNbGMVHTLWKaBeRSCEd,FAAAZAAAQAEADADA....fAFAGBGAHCAALAHBhBAAaAHFRDEBEEABdBDAIDFAhBHAAACAXECCUFFAhCAAPFHDMCCB.TGCABGEDSGBAhABA.....hCBA...,2,-34,12,46
XQcPMNLCEASdIgOeaYJTHfVDZWBGRbFKU,dAAAOAAAeADA..aADDTAGAHAFADBBBZABBGCEARCDA.KCHBQDBDhAFAMDDB.LCHBhAHAACEBSEAAhAEAgEFDfEGABGHAFHDAXGCA.hAIAPFHD...hBAA...,1,0,-12,12
bNdHFgLBWGRJQEacXeCTVUPMKfYASIOZD,OAAAZAAADACAdAFAHADALAHBGAGARCCB.ECFB..aBDDeDHHCDEA.hABATFAAUEGAKFBAAAFASEFDhAIA.bGFAhBAAFGDDBBBD..WFFD.....hBIA......hCAA...,1,5,-37,42
YgXdEfMZOHUeIGQcbADVJBRNaFKSPWLCT,DAAABAAARABA.aACAKAEC....SAEHLAHBCBFA..TAGAhAAA..XCDChBAAEBCBZCFEHDBAeDFFGEGAhBHAbEDAAEHAVGAAFECHPHCAgFGH..hAGA......hAIA...,2,-21,-10,11
JVZXdOCEYeNWHFMgAKcfDLbTURGPaISQB,KAAADAAALADAUACAGAEB..aAGDQCEDBBBAZCDAdDHAECHB.hAAAeEAAHEFC.MDDBhAFAAAEA....bEEDPFEBhAHASFCAXGGACGGB....NIAB.hAIA......hBAA...,1,-3,-29,26
RSDVYOMLTgdCfJPNEFbacAUKGIQBeXWZH,GAAAQAAAeADAZACBHAGBRAEA.DCDAOAHDMDABLDDAhAAAdCEDCDGA.JDHBEEEBFFDAaEGEAAIBKGBAhACABFAA..SGFHhADATGGA..fHAB..hAAA......hAFA...,1,-2,-22,20
KIJYgRXeWVLEATCNBZdQGFHMOfScPUaDb,TAAABAAAdACA.GAEAHACBMAEA.SAGAPAHBDCBBbBEDhAAA..KDDB.JDGFRCGBeCABhACA.LFFAhBEAAAEBZGAAQGGBfEDE.aGCB.IHHAhCGA....hCIA...,1,5,-30,35
QPMHgNFZKLECUBDbSWTYaIRefXGJdcVOA,MAAAHAAAFADAZABELAFAEAGABBHA..DCABSCCA.TCFAhAGAaCCARCEFeDDD.hAHAGDGAdCHAOEEBhBAAADIBQGAAgFGACGCA.bFCD...WHFAhCAAfGEA.hCCA...,2,-15,-8,7
gFYXBQHcGMVdEKfOIaJUWPRSZCeDLbATN,TAAAFAAABADA.HAEBGACAdAGB.EAEAOBGDaAGD..UDFARCCBZDAFhADAeCABLEFAAAIBNCIA.hAAA..XGEAhBAAMEABfEDA.IGBA.PHEAhACADICA....hAEA...,1,-8,-16,8
XSEgKBGMQPFYeDOcTfJbZdARNWLCUVHIa,RAAALAAACADB.HADBaAED.EAFABAGAGBGA.MCABQCCChAAAFCCHeDFBOAHD.hABATCFAbFAAAAIBWEEDhACAIEEA..SGHBKEGADGAA..fGGAhABA.ZGAEhAGANICB...,2,-29,12,41
IaCHSGDXeVMFbNcQRfOWLYAPZJUdTgEBK,ZAAAdAAAEADAKADC..CAFA.HAFAGAGAeCAA.MCEBFCAA...bCFAQCEChABA.REFBODDHhACALEGBAAIB.PFCBhACA.TFEABEHAIHHADDDB.hADA......hAHA...,2,-24,-6,18
UbQJYGcMBCTdaOgPDeRFXZWIfKVEALNSH,LAAAHAAAQADCGADAMAFATAGAaBFAOCAB.DCCBRCAAZCFEhABAICFAKEFAACAASEHBhACAbDDC.JGCAhBIABCHAdGGA.eEFA.XFAA.fFHAhAAA.NIAB.hACA...,1,-3,-7,4
eXZJTKIaCOVPdbNEFBQLWRgAMcfUYHGSD,MAAAUAAAHADAGACBeAFEZAGBKBBD..aCBEOCDBdCFA.EDHFQEDChADALCFDRFAAACHAfDHAhAIADEEB.hAFATGFACFHAPGECFHDC.......hBAA......hBCA...,1,-7,-10,3
fPZCLAMNDIUYRgcSdXKQaJOGBHVeWFETb,MAAADAAAUADARACA....SAFBdAGAQBBAaAHB.GDEAhAIAHCCCeBHHFCHDEFBAbDFDhBAA.ZFCBABFA...IHFAhBBA..gGDDKEHBBHHA.TGGAhBAA....hBBA...,1,2,-31,33
UPSVLEKDMXNJbeAcTWOgFQHGYdBCIZfRa,TAAAOAAAFADD.HAFAdACACAEAZCCA.RCGB.aAFD..UEEB..hAFASAHBEFCBDBBBMFIBhAHAXBGD.bCDDhAAAACIB.....gEAA.GEGAhAEABHGA.fGEAhCAA.,2,-28,-17,11
WBTVXDCabdGJIKOUHEZfgNPcASYQMFLeR,QAAAMAAALAEARACABAFB..TBBADAHBCCDA.dCEAGCEAhAAAKBHBHDFBECGB.ZFAA.fDBEhAFAPDABAAIBFEHDhADAeDDD...WEHBaGFDIHHAOHDC.hAGA......hAIA...,2,-13,-7,6
UeIBgcGdbHfRZKSCXJTWPMOaYFANDQVEL,QAAAEAAALADAeACABAHAGAFAHCBARCFAZCDFCEAA.JCHB..TECAhAAAMDAAOFBBhAAA.aFDCAAEADEHBUGGAgEEBhAHA.bGCC.SGHHhBCA......hCAA...,1,-3,-13,10
aSCWENJYDAIPXVKURFBOfGLTQHdbeZgcM,XAAAKAAARACFBAEBGADA.LAFAHAFBeAHBZCFBMCIBCCAA.hAAAEDAAJCEFAAAA..IFDAhADAUEGAOHDA.hAGA.TFGA.dHAB.cDBD.aHDAhAHANIAB......hBDA...,1,-2,-29,27
IZJMLKFNVQSPDacfgTRWdGOEYXCbHUeAB,ZAAAMAAALADBFADD.QAFADAFA.aBHDfAHAhBAA.RBBBGBEAECAACCFDHEEAhABAABGBBCHAKFAASEGEhACAgEFHdGHAXGGA.eHBANEEA.hBBA......hCAA...,1,1,-25,26
dAPOEZXUJfGLTQMBKScaDIRVCbYHgWeNF,EAAAZAAAUAEAGACALAHBMAEA.BBGBSAGA.aBEDRCAACDEAhABAHCFB..eDFHhACAdDHAACBBOEBCfEBAhAAAQGGADEEBbFFC.YHCA..hBCA......hBEA...,1,-4,-26,22
ACIMcDKZYdXTWFSaLJUVOebEBgRPfNGHQ,MAAAKAAAdACA..TADASAEA.LAHBVAGB.eBGFhAAAEBBBRCEB...fDCAhAFAHCDBAAEACEGADEIBZEGBXGAAhAGAaFCBOFDEBGDA.NIDB.IHGAhCAA.....hAIA...,1,-15,-16,1
gAcBYaLSWPCGMFXQRJINbeOVdDHKEZfTU,BAAAaAAALADASACA..CAHAGCCAMAFAQBEAhAAARCFA.JBHBbEAD.eEFAhAEAdCAAHCCBEBBBZFEATEFAhACAACFA...cFECWFHH.XGCChADANICB.DEIB.fHGFhBHA.,2,-19,2,21
BYRUcENIQMDWXKOaALbgePVCFGSfHJdTZ,LAAAeAAACADA.GADAHAEBdAGBZAFARCAAEBHBQCFA.MDIBhABAXCCC.aDEEhAAAAAGAbFEAVEGB.fHDBhABABEFD..YHDA...hCAA......hCBA...,1,-5,-18,13
CRXEaBNSLWeFKTAOQPGdYcfMVIHgUbJZD,QAAAdAAA..fADAMADAHAFCUAFAZBDARDDAECBFaCHDSBHBhACAeEBB.TDDAhADAADDAOFFAGDFAhAIAcGGCgFBADHDA.BDHDNIAB.FFHD.hAAA......hAIA...,2,-4,0,4
ICJQGFLMNeXgfbUPAYBWZHaTcdSVEKDOR,BAAAHAAAaACAdACAEAEAOAED..RAGB.CAGAGCCAMCBB..eCDAhAAAfBHAUDGBAAIBZECAhAEATEFA..SFHDhBCADDIBQGAA.LHEA.hCAA......hCEA...,2,-26,0,26
TLAIdKYaRHcPNGEgMXBbeVUfDCJWOQZSF,dAAAaAAAHACB..PADAEAEA..MAHBBAGAeBBDUCCACBFAOCHDhAEAZBFEFDFDLDBDhACA.ADHA.KDEAREGF.GGDBhAIA.bEDCDGIB.......hBAA......hBIA...,2,-28,-6,22
CFRgASdTEDJQaBcfUMPHKeLNGbVOWXYIZ,dAAAEAAADADAaADA..BAGAUAGAHBDALBCAGCBA..ODBAhAAAXDFAZDFAREBBAAIBTFDAhACAQFFA.MEEBhBDAeFFG.bGAC.WHCACHDDSGBD.hAGA......hBAA...,2,-11,-10,1
bSUMLaWIDgcCJFTBdYEOZKNeAGXHQPfRV,HAAAQAAARADF.SACAMAFAaBFDDBHBCAFA..FAHBdCADECDAZDAEhAAAKCFAABIBGEEA.hAAAXDGAfDAAhADAUFCALEEA.gFAA.hACATGEABGHA.NCIAeDCBhAFA..,2,-5,-1,4
RFCUILdQBgJOMaVXSGWPbHEefAcZKDYTN,ZAAADAAA...TAEARABACAEBLAGBdAGABCAA.OBHDMAIB...hBAAaCCCSBEAhCAAGDEA..bEAAHDCAEEGEAACAhABAKEFAFGDDQFDD.gGGAhCBAXGGA.....hAEA...,1,-8,-16,8
UWDbRPJMcaYTEeZHLfONGgSQKCBFVXdIA,DAAARAAAMADA..aABEEAGAHADB.LAFAOBDCGCGAQCFAhAGABCCDXDDChAHAAAAAUDEA.bEFAJFBA..TGGAhBAAeFHH.fHDBNIBB....hCAA......hCBA...,1,-8,-15,7
fTgdSJGADecKLPRFZMCQUbHYVWENIBaXO,eAAALAAARADAZAGBMAEA.UBEAHCCA.VEAAEAHFBCAA.OCCBhABATEEA.dEGAGDGAhACAAAAAKGADCGCAQEEAhCAA.bECDYFHBNICBaGHD....hAEA......hAGA...,2,-12,5,17
fKNYcPWHRFUbAgCLDGdXZMBaOJQEeTVSI,LAAAdAAAZABBMAEAaADD...QBEAEAFAeAHF...TBGAhAIASCAAKDCA.cCEBhABAHEDCREGF.FEBHACAADCIBhACABGEDODDH.IEGANIBB.PFABhAFA.bFED.CGDAXGGAhDGA,1,3,-14,17
DMQgbIcZHOYCLAVSWEdPTBRafKFeNXGUJ,SAAAEAAAdADABAFARACF..KAECeAGH.GCBADAHBMAIB.QCEAhAAAbDDBZDFEHFABhAAACDGBAECA.VFGB.PHDChAFAaECEFEHD.UGBA.IFFA..hABA......hBGA...,2,-25,10,35
SaGZCUJXDKVLMOABYgePENIQHcdfTWbFR,BAAAeAAAEADAQACAHAFAdCCA..TAEAFCFHRDGFGEDAZAGBCCAAUDDAhAAADFIBLHAAhAAA.ACHA.gDGAhACA.IGAAfGGEbGCAaCCH.KGGAhAGA.MIBA...hABA...,1,0,-6,6
MfNUcgRbEdKATeWaGQVIFSYOHDJPXBLCZ,eAAAGAAAQADAFADAOAFDHAFA.DCCBXCDCLCHBZBGBhAAAMDDAUECBREEBEDGFAAHA.hACAaGHBSDHHhBAA.PFFBfHAB.....hBCA......hBDA...,1,2,-18,20
PfUKObBETZFgAHQCeDJILRdNaMWXVcSYG,HAAAeAAADAEALADBRAFA.aAFAMBDB..XBFCSBEDhAAAGDEBUDGAbFFAEEEAZGBAhAAAACCB.QCABhACA.CHFA.dFCAWAHHcGGA...YHCGhABA....hAIA...,1,16,-30,46
ZJHeOLXGSdBITfPANFWUcCQKYRgbMEaDV,FAAAUAAAQADARADA..MAHBEAFAaAHDZCDAHDAA.eCHHhADALCCBGEEAdDAATGAAhAEAACGBNDHA..CEEAKGEAhADAbFCBDGHBOHBC........hBAA......hBHA...,2,-19,3,22
WSdIRBEbPVTeFKCYLXDfOHMQcaUNGAZJg,ZAAAJAAA.SACERADF.BAFAEAFE...VBGBeAHH.CCCDLCFBhADADCCBHDDAMEIBhABAaDHD.GFABADFB.dFFAhAFAIGGAbFGD.FHAAKHAA..fHEBhAHA....hBAA...,1,2,-33,35
cUPAKGRVOWfeDCTXMFBNbLQZYHdgISJaE,RAAAOAAAeADE.DAEACAGB...MAHBBBDALBBAZBFEHDDA.dDGASBEHhAIAEFFB.PDBBhBAAAAAAKCCD...GDEBhBDAfFHATFGANIAB.bGBA...YFFFhBGA...hAIA...,2,-25,-4,21
PBOedDFMENLWIcYJASCaQVZTfUKbHgGXR,aAAAZAAAUAEAHACBGAEBRAGB.BCEAeCABdCHAMCCBEDFA..LEAAhAEA..IDDAhABAcEEC.AAIBQDFChACAfFHAKHAAbFEA.......hADA......hBEA...,1,-3,-28,25
VJCAdUEFPBZTcLaeRgNQSYbIXOKWMDfGH,EAAABAAAZACBLACA.RAFF.QAEA.bAGDOAHDhAAAMCBBGDEAHCCACDAAAADAdECAhAAAFDGDTGGAeECASEHHhAHAXGBCDAIBfFFE..hCAA......hCBA...,1,6,-26,32
bHgFXCNeVLdYSTBAPJKfURDOGWZMaIQEc,KAAARAAAGADAZACB.MAFAaAED....EAGAHBFB.XDAAhAAAeBHFdCAATEGAACGB.fBHEhABAODEBQEBAhAAAbFBACFFD.LFFABGHA.PHFAhACADDDB.IGAA.hADA...,2,-11,-4,7
OTDaXeQcEWHCKYMbFgIfJPdGLZSUNVARB,RAAATAAADADA..eAEAEACEHAEB.KAGAMAIBFCCB...fBGAhAAAdCHAZDFBSDEDhAAAVCCA.AEAAaFHBQDGDhABACGAA.bFCA.IGGA..hCAA......hCCA...,2,-27,-10,17
FJWAOBVTZHRGeaCKYDIPLMQdgXUNEcbfS,BAAAZAAAHAEARACAGAFAeAHHKCAADAIB.LDDAdCAA.UEAAECCB..hABA...bEFAFCEHAACAOFDBhAEAaDGDCFAA.IGGAhAGAMDIBQGGC...NHABSFFDhAAAWHEG..hACA...,2,-24,-1,23
OMfPcgHdCZSWQXeFUGIJbDLaNKYRTBVAE,EAAAMAAA....fACAPADCHAGBZADBQAFAhAAAeBBBGDCAIDFADDIBaEEAKFFDhAGARDGFTFCAAAIB.OAHFhCAAdGHASGDHFFFH.....hCBA......hCDA...,2,-9,-4,5
cRCdSJeGZfVBIDULOaKbEPHWMgXTQFYAN,RAAAdAAAeADEZABBBADA.DAFALAGB.aBDDEAHFHCEB.MAIBhAAATBEAQEGAhABAACIB.CCCCGGCBhCAAIDDA.KDFA.bEFA.....gGBAhBAA.FGGB.hCGA...,1,-4,-28,24
EFbRGPLgKaBfYHUJeNIAVTCWZXdMDOScQ,TAAAZAAAdAEAMAGB..SACBEAHBRCAA.GAEALDEAhABAaAGABBGBHEBAeDHHhACAAAEBCCCDDCIBQGFChADAFDGBbEDD.KHCAUGGA........hAAA......hCAA...,2,-19,4,23
bdXAKIPOJeDMUYHLSNRBZGWaTfVQCgFcE,KAAAOAAAeACEDAEAUAFAHAFC.LBBARBCBGDFA..aCDE.TDBAhAIAQECB.hBAAFCHDECGBdHBBACIBIEEAhBDAMFIB.SEGABAHA.ZGEA..hCAA......hDAA...,2,-16,-10,6
PgJHSafFdTRWCDANUGEYOZLceVKXbMQBI,GAAAEAAAZACBLAFAeADAKAGA..MCDAQCEABCGA.ICHAhAAAPDDB.HEBAaCHDdEADhAAAREGBDCBB.AAGAUGDAhBCAOEGB...cFDD.....hBEA......hCAA...,2,-15,-6,9
MNQPRLYDfeKdVCXaHGBFJcUEIAZWgTOSb,ZAAATAAASACE..bACBMAFAQAEARBEALBHBfAGFhAAAeCCBdDGCXCDDhBIAHEDBFFBBUDFAAFIBgGGBhABAOCHDPHCA.KGGA...hBFA......hCAA...,2,-2,5,7
SFcBUVJAMEGZDbPOeLdRWaXYQIfHgCTKN,EAAAZAAADACA..OACCeAEARBFA..aAEAQCCBHAGBCCCAKCEAFDFHhABABDHA..VFAAhAFAAAIBGECALDHBdEEBXFFAhAAAIHEAfGGE..hAIA......hBIA...,1,-16,-18,2
OgDNKPFYQTXGUeJWcdIbALCEMaVHRZfSB,EAAAaAAAHACBRACA.ZAEABAFBDAFA.KAHB.FCCHTCEA..GCFAhAAAeBBDJCHBdDAAACFBMEEBhAIA..SDHBhADAOFFBgGCD..PEDD.hBAAXFGD.WFFDhAHAIGHACHCA,2,-33,-3,30
dJPXEZGWKYTARSHMNFcUbgaeQCBIOLfVD,HAAAMAAAFADDUADA.aAFEeAFA.BBBALCGBDBIB.dCADJCEBEDDAhAAA.GGABKCGBAAFA.RFEBSGGBhACA.hBAANAIA.bFFA.QGCACDFA.OHFChBBA......hCAA...,1,6,-33,39
HVfGTPLAWDXedSIERCZUKaQJYFgOcBNbM,XAAAeAAAdAEAEAGARADA..ZAGBKBCB..aCDCQCFA.hAAAFDEHOCHDBCHAMEBBhAAAHDAAGEEALFGBhABAAADASFCB.CGAA.....hABA......hAGA...,1,-16,-21,5
YDZbASfeKFcVNMJCdOHWRIBXEPgUQTGLa,eAAAFAAA..VADAMAEA.dBDAHAGBRBFABCCCECCBUDGBGDEALDABhADADDHBZFBA.AAIBKEDA.hAAA.NDIA.OFGD.hABAXGAAgGGD......hAIA......hBFA...,2,-18,-10,8
IbKHePVLMXQOdDBTfUEGSFcgAZWJYRCaN,ZAAAJAAA.RAEA..CAHB.aADA......bCABHAFB.eAHBLCEAhABAMBEBQDFBhAIAdEEATGCA.ECCBFFAHAEIBYFFFhBAAKFHB.XGGBBGFA...hACA......hADA...,2,-25,-9,16
MdIgLXEbJTWOHSAReNZBUCYaVQcKPfFDG,RAAAeAAAZADBBAFACADA..aAEDQBGA.KCFDFAGA.GBFAhAAAdCCCLDABECCBbEDD.hABATEFAHFFCACHA.NIDB.hCAA....YEEF...PHAAhAAA.MEIB.hCBAIHGA.,2,-14,-6,8
VQgCHZUJDSGYXTeMNcdPfbIFOaKABWRLE,RAAAEAAAQADCHACAZAFBDAIBGAFA..TDDAeAHBMCCB.hAAAdDDAbBGDODGDAAEALFCAhCAACFAASFDAhAAAXGFANEIA....fGGE..hABA......hAFA...,2,-7,-7,0
IZPLMHKgeGcQdRNEFJWAVTafDbUXCSYOB,aAAADAAAUADA..SACHBAFAZAGBLBBBHAEAeAHHGDDAhBAAdCEDEDDB.FDHDABIB.TEAAhAEA..bFGBCFEAOGAEhAGA.IGGAMIDAKGCD...hAHA......hBAA...,1,-10,-31,21
FOaCKeMBPgfTRYQDIcWAEJSZXNdVGHLbU,EAAAZAAAdAEAHACALAGBFAFA.CCAA.eAHHBCCD..fCCEhAAARDEBDAIB.ICEAhAEAAACA.XCFDGEBAbEGBhABAaDHDMEEB.TFFA....hCAA......hCBA...,1,-8,-30,22
IaDebLXVZNSPYMFdWREBQUHOCKJTAcfgG,...fAAAGAAAaADAeADALAGBZAGBSBCDMAIBdCDAEBFFhAAAQCEAHDBBKEFAhACAAADAgECAhAAAbFEC.XCADPHEC.FDHDBHHBCFFAcGBChACA.DGHB....hBGA...,1,10,-7,17
KTFcVCGWARaLbYSQDOJfUHMgZdEIXBNeP,RAAAaAAALADB..bACDQAFA.OAHFfAEAhAEAHCEBZDGFEAGABBBDhAGAeCCDTFAAFBHDCCFAAEEADEGAhBAAMFGBdFCAIHHAXFFA.....hAAA......hABA...,1,-3,-15,12
bOdTHgZGIXfQJWBNKVRMPLUFCDAeScYaE,eAAASAAA..aADDEADAdAFAHAFAGBGAXCCAQDBAhAAABCFDKCHBRDEBMEIBLDABhAAACAHBAFBB.bEFBOGEEhABAZFGBfHABNICB.PHCA..hABA......hADA...,2,-3,-2,1
RPJbVKTdFcAZXagNUeMOWEQCYLGSfDHBI,aAAAUAAA.eADAMADA..EAGAQAGALCDAGCGADBBBHBEBhBAARDAAJEEBbCCB..TDGAhBDAdFCAAADAZGFE..XEBDhBEA.OEEB.CFGDfGHAhBIA....hCAA...,1,-6,-8,2
WOGCQAKFMTHbIEgSVRNZcLDdXPBYfUJea,MAAAHAAAEADE.SAFBRACAZAFBLBHBdAHABCADUCCB.eEFBhAFAaCCAGCEAABBB.TEGAhAAAbFCB..IFHAhAIAgGDB.cGGCXGEDfHBBhACA....hBHA...,2,-12,-10,2
CXHebZEfJOSLBRTIDGcKMAgVdPQUFWaYN,dAAAQAAAFADA.aACECAGAHCAC.eAHHEAFAOAHDLCFBRCDADDAAhAAAGECAKDGAAECAVFGBhACAUFAA...NEFA.XGAChAGA.fHEBBGCBTGGA.hBAA......hBCA...,1,-10,-11,1
LSCMDFGTcYEWKXQgeAbdaBVIHNZRPOfJU,aAAABAAAHACBRACA.OAEAUAFALBHB..MAIBGCAAhAAATCEAECCBKDFBQDGDhBAAAACA.dEBAIFDAhAIAZFFAfGCA.CHFADBBBFFFHYHDAhCAAWEED....hCEA...,1,3,-27,30
WcDfRZCHgUSdVFJAINaEKQeYMOBXPbLGT,aAAAEAAAKACA..eACHMAEABAEA..XAGALAGBGBDBhAAATDDADCCBREAAHEGBhAEASDDBdFFCFGBDADGAQEGAhCAA.OFED....hCBA......hDAA...,1,-14,-24,10
WJcVEHGCfUdSFTAXYZOBQNLKMPRaeDgIb,ZAAAQAAALADBMADARAFADCAA..IAHA..bCEDJBDAhAAA.ECDBHCGB.GFABhABAfCGAdGGASGDAhACAACIBODEDKEGA.eGBA.gGGAhBCA...hAFA...,2,-14,-9,5
dagcIAFUMVDKJZPBLYWTfeSNbHQGECOXR,MAAAKAAAZACBLAEA..TAEAeAHHSBBAHAGBECAAXCEChAAARCDAaDGE.IEFAhACAAAFAFECBDEFB.BFHAhBAAfDHAQGCAGGABdHFB.gFGAhAGA....hAIA...,1,-5,-11,6
KDHRdWEZebTSPNVFAICfOLBcgXMGYQUJa,CAAALAAABACA.XADDGADAUAGA..aAFAHCAARBFFECAAeDEHhAAA..TDDAhABASDGAPCHDFFAAAAIBOFBBhACAMFGBQGDBDFFAdGGA....hACA......hAFA...,2,-19,-1,18
KNOLJgGRTfdCZWFeMXBIbAcUaPVHYQESD,aAAAHAAA.EADEKADALAFBGAFA.RCAAdAHAZBBAeAHBMCEB.BDAAADHAUEGAhAAA..VEEBQFCChACADDDBODHBgGFGhBHATFAACGHA........hADA......hAFA...,2,-18,4,22
QKVHORLfdFCSGbZeaEIPgDcYTMAJUNXBW,UAAABAAAQACAHADARAGFdCDD.CAEA.GDAAeAFH.EDFF..IAHAhAAADCIB..TEGAhADAACAAXCAAKGGDOEEHhAFALCHBSGADaDDBgEEA.hAGAMHDA.WHEA.hAIA...,1,-5,-18,13
YHGCDUIbBFMNPRgJSOXfdeTQZLVAWaEKc,EAAAKAAAHACBGACADAEAUAFABAGA..MAIBRBEF..SAHHhAAAOCBBdDFAeCABZEDBAAEBaDFDhACACFBAFFGD..gEBHhBEA.fDHA.TGGAhCBA.....hAAA...,2,-24,-12,12
VCeafBdUJGATLEWYIFSbHMXPNcZDQRgOK,EAAA..IAAASACAHACAMAFAXAFB..cBDDhAAAZBGBRCAAKCEA.eDHHhACAaBFDdBHAGEABACCATDAAhADALEEBFEEAbEGDDGGB.OHCACHHA...hAEA......hAIA...,2,-3,-1,2
JGBKPSDYVAeCgNbUTIfMXZERQFLHWOdac,eAAACAAA....bACATADA.MAFAEAGARCAALBGBHCECdCHAhAAAaCCBGEABKCFDDBIBAACAUFFAhAEAXDDDZGAA.QFGAhAAA.OGCA....hABA......hCAA...,2,-16,-3,13
NTDIcFJOMPEAWgCSdZXVLfeYHKRBbaGUQ,CAAAZAAALACAeACEHAFBRAFF.BAHAGCCAQCCBDAIB.FCHDMCHBhAAAADFB...SDABhADAdEEDfFAAhABAbEFD.aFGD..NDIAIFEAOHACWFHH.hAEA......hAHA...,2,-27,-4,23
dgfKFWXJEeCPLcIQAUMZYVGDRHbNSBTaO,ZAAAGAAAHAEASADAaAGA.dAGAKCAAXCDAECEB.eBHHhAAALCGBQEABhACAAACAMCIBDDGBREAABDDDTFGAhADAfFFEFEEHCGBA.IGDA..hABA......hAEA...,2,-19,4,23
NOcgebXfYTEdWIPVDJRUHALKBFGQCSMZa,LAAAFAAAGACAQAEAMAEA.aAGEOAHD..eCAAhABAbBEB.fCEEhACA.ECGAdDGA.IGCAhBAADDDBREABHEECAEEBCFFDZGEAcFGD.YHAGhAEAWHBG.....hBHA...,1,12,-26,38
RTMOBAbDVJfZgLScWHYXIEdeUGPNaCQFK,DAAAVAAAZABE.LAFA..SADBHCCAXCFBEAFAeAHFhAAAGDAAaCDCQDFDhAFARDGFMEEBAAGA.bFCBfFFEhADA.WFHHdFGDNIEB....hCAA......hCFA...,1,-4,-12,8
bMQTSBCFeDOVcLfAHWNIgXRYPJKaUEZdG,HAAA..IAAARADFJAFAKCADEACA.GAEAMCCB.QAGAhACABCGAFDDH.eCCB.ODGBhAGALEGBADHAgEBDhBEAXFDAaGCCdFHAbEDD.CHGDDIBA..hBIA......hCAA...,2,-26,1,27
QPaORXLAJgKNZeIBFDUVGHMTECcdfWYSb,KAAAeAAAFACADAEAGAEAHAFC..EBCAdAGB....fCDAhAAASBGHQCFChABAaCCBRDDBACIB.gEEGhAIAZFGBBGEA.MCIB.CFDDYEHF..hCAA......hCBA...,2,-28,-8,20
MUPXegCGJdLQBRAEKSTNDFZIbHcaWfYVO,EAAATAAAFACD..ZADBHACB.aAEA..fAFAOAGDMAIBhAAAUCGAeBEHGDEAdEBALEFAhACAQGGAADGBSGGAhBEADGDBIAHAWHEG....hCAA......hDAA...,2,-17,-4,13
RJOFSNWAcCfHZMgEGKVedIDQYTLXUPabB,CAAAHAAAZACA.EADEGAGAeAFEdCADDADA...TBFALCCB.XCEChAAAaCEHRDCBFCHDSDHHhAGAAEGBMFFBKGGAQFEAhAIA.PGBC.BGGBNIAB..hBGA......hBIA...,2,-21,1,22
OEfLYeQbGHXUSTDBcACFWgRadMJKVZNPI,FAAARAAAdADAMADAKAFA.ZAEE......ICFAEBCFLCFAhAIAeAHHGDDAHDDASEGAhBAABCCDAAAA.CFFDaGCAhBIAVFAAOHCC.fGHAbFGB..hCAAXGED..hAFA...,1,-5,-27,22
DQbBLKaFAMJNZTHVYPUOdfXWgSeGCEIcR,MAAAZAAAHAEA.VCAAUAEA.dAHA..XBGASBBAeDEAhABAEDDARECB.DDGABEADaEBB.hBAAAACAJEHB..TEFAhBBAOFFB..fFEEgGAACEHBQGBAhBCA.KGHBhBEA...,2,-26,-2,24
JLYDMSOgbKeFNGHfdQCAPIVRTcEaXZBUW,VAAARAAAEADE..ZAFBBADB.UAFALBHB.MCCAOAHFKDDAeEFFhAAAGCDAHFAAdDCCADGAhAAATGGA.aHCAXFBChBFA.YEHBDIAA...bFFBhCAA.FGED....hCDA...,2,-19,0,19
YPQMgCWbJSHITAFaeDOdGZRBUNKcLfEVX,eAAAdAAARADABAGBKADALAFB..EBHFXCCAQCBAMAHBhAAACCFA....JDAFHEFAhABAADDA.aCHDGEEAhACAZFCANIAB...fDHA.PFCBhADA......hAEA...,1,-10,-26,16
bKeRBgSFZMQdafYGXVEWNOLAHPDIJcUTC,HAAADAAA.JADATACAKAGC.RAEF.BBHA.FCAHZAGB.dDDA.aBBHGCCAhAAA.ECFBOCHDhAEAACCB.IFFAhAGACDHAeEFBMFHBQGCAXGCAWFHD...hACA......hCEA...,2,-22,-17,5
BTNHAREZKXPGgSODIQebWJFadMYVfULcC,EAAAZAAAKADCGACA.OAEAQAFA.eBHHbBED.FCAAdBHAMCEBhABAVEBB..LDFBhACABCBDHEFCRFCBPFHBhAIADGGBIHHA.aGDD.....hBHA......hCFA...,1,3,-15,18
RJEHKeLAcWZTfObaNVSDPFCYXIGMdQUBg,ZAAATAAAOACA..aACASAFA.FBHDXAEDhAAAGCCBdEFAQAGAhAGABEHARFCBEGABHCCA.eDBBhBDAACFA.fDFA.bDGDDGHBCGFDMEEBhBIA......hCAA...,2,-18,-7,11
RNAdFcgLKZVWMJGQaHEDTbYIUeXOSCfBP,dAAAFAAALADAZABBMAEAGBEAHAGBECCADAIB..TCEA..hAEAbBGDIEGA.hBAAeEEBSDBAhBDABFAANDIAAAIBKFGA.VGBA.WEBAaGGB...XGFChBEACHHD...hAFA...,1,-6,-12,6
EIOPcTfeWMQFLNbVZYgBDAKUSHCJXRdGa,SAAAHAAAXADBRACFGAEAEAFA.OAGFTBGA..eCHHhAAAMCABLEAAVCCBZEFAhAAABEEDAAIBCCFDdGEAaEGHIGAAhABAfGGAQGDA.FGHD.hACA......hCCA...,1,4,0,4
eXVSEbIHGYNBWZDLaCfRQgFMPOdUJKcAT,eAAASAAAEADAHAFAGACABCCAZAEAaCEBRCEAFDHD..MCHBdEEDKFAAhAAAAAAA..TFDAhAHAbFCD.IDFA.hABAYFFBDAFAfGGA....hAIA......hBIA...,1,-9,-15,6
EQJSMDIYZbPNgFKXcAHOTfdBaULReVCWG,HAAATAAAdADA.aAFARACF..eAEECBFA.EBEFQCAB.MAIBhAAADAIBZCFB.bDGDgCFAhACAXCACADFBBDDAhBFALHAAGEGASEEDYFFF.NIEB.hAAA......hACA...,1,-2,-9,7
IXdAcGaUKVNEeJQHYbFWgZCOSRLTDfPBM,aAAAKAAAEACE..eACHHAEBFAEAZAGB.SCCBRAGFLCEBDBIBBDDAhAIA.MBBBdEAAAEEAGEBAhBAAVEFA.QEGAhBEAbGAA.CGDAfGGEIHHA.XGEDhCAA....hCIA...,1,-8,-13,5
FeRKGcdOZEIAgLMUJNCWfTHDaYVBPQXSb,MAAAUAAACADA..TADAHAEBDAGA..aAFABBGB..QBBChAIASBHHeBFFhBAARCBAGDEBdCHAEDDBADABLFFAhADAWDFH.fHFBPFHBFHDA..hBIA......hCAA...,1,-14,-22,8
DaWZgQOLBSPUIbRefXNGcMHVTCdFYAKJE,EAAAaAAAZACB..QACALAFASBEDIAFA.RCFF.eAGHhAAA.XCCChAIAGEGAHFCATDEAdGAAABIBDDHBhBEAOBBBBFCA.bGFANICB.MIDACCHB...hAGA......hAHA...,1,-3,-4,1
dQXBTWeMPbaYDJSUZOHNLIVCGKFAEfRgc,RAAAdAAAQADCBADAeAEH..MAFA.aBFDDAGA.SBFHhACAZBGBHDDBLFGBhAAACBHAGCBAADAAECCB.fFCEhABAXDFA..TFFA...PHBAhADA...YFHBhBAA.,1,3,-38,41
GdHXYOJcKRUTVebfSIZPBagAWQLEDFMCN,LAAAEAAAFACD.MAEAGAEAHBCC.OAHDKAGARCGBUEAA..hAAAeBFHSDDBhAEAZCAAaDGDAEEBQFFChAGACFBAdGEAXGGA.YHBE....hABA......hACA...,1,-9,-18,9
aUcRZXDCBFbWJVMTeSKGPgHYOALEfQdIN,EAAAdAAAaADARACA..ZAFBCAGA.FAHD....JBDBMCCB..eAHHhACAGDDAHCEBADAALDHBhAAAQEGA.IDBAhAGAcFAABFGC..bGCA..WHEAhADASGGD..hBAA...,1,-17,-29,12
VWIgULXJcbRQTDCBadSZFAYEKeHPGNfMO,EAAAHAAAGACAMACAOAEE..IAEALAHBJAGBRCCATDFAhAAABCBDdDFDZFCAAAIBeDHHhAAAfEHA.gGGAhCAAXEDDbFFDCEEDaHCAFGAA....hAGA......hBCA...,2,-18,11,29
ZcbJCeFTVEHPGIMDgYWSdQBXUafRLKNOA,ZAAAJAAA.eACEFADA.EAFEHAFB.GCCAMAIBDCCB....gEFAhAHASCFAdBHAhAIAQDDCXFDDaGHBhBAAREGBLFCA.OHAAACCB.cGEDhABA.....hCAA...,1,-6,-19,13
EFZGKMTgNYCcfRdOBSeaAWLXQbJUPHIVD,LAAAQAAAUAEAHACADAHBEAFEGCAAMAIB....TCDAhAAAgCCBCCFBRDFAdEAASBHHhABAAFFB.bDFChACAIFHAZFGB.KGGDcGBBBHAAeHCAhAEAaGDD......hAHA...,2,-4,-1,3
bScONPgJIaEDKHVCXGfMLWAYBUZeQRFdT,BAAAeAAARADAdACA..SAGBOAEA....PAHDICCAhAAAEBEB.HCEA.XDGAhABAGCFAMCBBhAAAAAIBZEAATFFAbDDD.gGCAaEHDKFBBfHDBhBCALHFA.YHFChBFA.,2,-29,7,36
gDLZCWRdEbSHVMYcOXQPaGAUfINFTJKBe,UAAA..fAAAFADAKAGABBDDeADA.LAHBZCDE.RBEAEBCBhAAAHCGBMDABOEEBhAGAQDEB.GEGAhACAACIBTGFADGFBdHBBbFCD......hADA......hAEA...,2,-29,2,31
HAYRVECeUZXPgNQDdFafWIBcTbSOJKMLG,RAAAEAAAeADEZACB....XAEA..gAGBQCEChAAAdCCAaAHBfBEEhAAABCBCbDGD.OCFDKEDDMBIBhAFAHEDBAEGBCHHAPDHBDFFB.FGGH....hABA......hAIA...,2,-12,-8,4
cNUKJWDMFOGHefPIEYAZXbgRVQTBLaSCd,ZAAAXAAARAEA..TCAAaADA..dAGAUCEBKBDADAIBFBHDHEAChABAeDBA....fDFAhAAAEEFBAACA.bDGDgFGHhAEABFDA.LHAACGBANIDB.MIEAhAFA......hAHA...,1,-9,-20,11
TAcHXOYgUEdVeRNbBIDSPaJFWKMGQCZfL,HAAAOAAAUADAdAEARAGBBAFA.DAHB..aBBCFCAHKCFBGCEB.hAGAZEEATDBAAAIB.XDDDhAIAECCB.eDHFhBAAIHEASFEA...WFHHQGGBhAAA...hBDA...,1,-19,-26,7
KLJDTbBVaEOfAQeIUHdCPYFWNRZXGMSgc,eAAAHAAAdADACADA.FAFARAEFGAGAMAIB..SBEHKCCALEEBhAAADCABBCCDEEGB.ACGAQDFAhAAAIGAAUGGBhABA..PEEBNIAB.XGGA..hACA......hDBA...,1,-10,-23,13
RQaNZCDHUPbESKeXFVfWLJBIdgMcGYTOA,RAAAaAAAZADBHACBUAGAEAEA..KCFDFAGD...VCEBLCCD.hAEABDAAdDHAMBBBGDGAhAAATGFAABFA.CHEDDAIBhBAASEED.XGEA...hCAA......hDAA...,2,-28,-13,15
PKIHNSLdUQECMZRcWeBTJGaOFgVAbXfYD,XAAADAAAKACAHAEBLADAdAGB..EBBBZAGB.RCDBeCHHBBHDGDCAhAEAaDCH.FEEAAAAAbEADhAEA..fEHAhBAA.IHEASEGDQGGBhCAAMFFBcGCA...hCDA...,1,-5,-19,14
XLSFfQZJGgOHNIeYCAKPMbcBDWaRUETVd,MAAABAAAaACARACA..EAFEdAFA.LAHBFBBHZBFEGDDAHBCBeCBDhAAAAAHA.KDFA..bDGBDEEBhBCA.TFFA.SFBAhBFAQGFCOEHFYECFCHBA.WFHHhBAA.....hBHA...,1,-8,-14,6
QfeFGEbDSLZNBTJVRIUacXYPdKWMAOCHg,HAAAQAAAeACEEAFESACAZBFEBCCAJAFARDEA..UFGA..hAAAaBDEXECCdCGAMCIBhAAAAAHACDHBFDAA.GDDAhADADIGA.TFGA.cGFC....hAIA......hCAA...,2,-13,-12,1
HOgcXEWUZVQNdMGKfSeCJITaPRDALFBbY,LAAABAAAHACAOADDXAFBUAFAZBGB..QCAAhABAdCAAGCCBSBHBhACAeDHHCEFDTFCARDDAADGAFEGD.bFBBhAIAgEAA.EGGBNEIAMFFB..hBFA......hCAA...,2,-6,3,9
CSZTfNcHQaURKFeLIDJXBVdbOWPgAYEGM,EAAAGAAA.MADAZACBTAEA..fAGAHAGBaCBBRDEAeAHHhAAALECBDBFBBCDAhACAbFDD.ODBD.gDEAhBAAAAIBSFGAQEGAFGABIHHAhAAAXGGC...hAGA...,1,0,-7,7
OTGJWLZPBDISVeQCURbMKcAgYadENFXHf,aAAAEAAAFACDHACB.OAEAGAEA.LAGBZBEFDAIB.SCHHhAAAeBBDQDGCRDDBMEABAAIBhAEAdEDA.fFFEhBAATEBAPFGBBBGACFHAbGBC......hBEA......hBGA...,2,-3,-1,2
JYMKZUHIgPGWSDLQBFTEOdcAXeNRaCbfV,eAAARAAACADB...VADAMAFAZAGBHBDC....ICCAhAAAGBGADCCBLDEBQDDChAAATGAAEFFBdEHAABIBaEHDhABAbEFD.JGBA.........hABA......hAGA...,2,-17,-8,9
FMJbWLaGgcIeOQfBRCZNSUYEdKVAXHTPD,HAAATAAAFADA.MAGBJACA.LAHBGAFA....IAHAhAAAeCAAQDDAhAAARCCAZDGBSEEBEECBdEGAABHBDEIBhAFAaFHD...cGFCBHHANICB....hCAA......hCCA...,1,-1,-17,16
ZQbVCMBLaDEeYdfAOHNKRTGgIXUFWPJcS,HAAARAAAGADAXADBFAFA...JAFBZCFBQCABCCCDLDABEAHBhAAAeBHHdDDAACHB.KDGDTFDAhAAAUFFB...PFHBhABASGHH.MIAAaFBDDGGB..hADA......hAIA...,1,-2,-10,8
fSXGPDMFeVWKCdbIZcULaAYgEQOJHNTRB,EAAAQAAAHACARAFFBAHBSACAGCDAMAFAeCGH..KBEAbEABhAAAZBGB.LDAAhAAAACCBODHDTEDA.XFGAhADAFFFHCHGA.dGBA.IHFAaFDH..hBGA......hCAA...,1,5,-11,16
cUSDIRTBJKdOYZbNfXMVgLWaPHeQECAFG,GAAASAAARADABAGBdADAZAEB....bBFAXAGA.hAAAMCCBLDCA.hAAAaDAHHCGBEDGBADDAFDDHDEIBhACATFEAOFFBfGCA.WDBDhABA......hAHA...,1,-17,-24,7
BdMbEIaeFWJYCLHRTVPDgUNZcSOGfKAQX,QAAAdAAAEADA.eACAFAFD..JAHBLAGBHCAC.RBDATDAAhAAADDEAUEEAZDDA.OCHDhADAKDHBAFHBBECAMFDBaFFChAIA.CGBA...PHAA.....hBGA......hBIA...,1,-3,-32,29
DaFWdRHfGIEgcLQJYTKAbOXBVCSNZUePM,XAAACAAAZACA.UADAeAEE.DAIBFAFE.RCEA.HCCAGDBAECGBLDABhAAAQEEBTEEAhADAAAAABBHA..SDHHhAHAMDIBdGGAfHEFgGEAcECChCAA.KHGA...hAIA...,2,-19,-2,17
CcTXBeIWSHRUfbPQKaGLgONZYEFJDVMdA,TAAAeAAA..SADAHACBRAEAUCGA..bAFDQDEAhAAAGCCALBHBOCABZEABhACAEEABDEFBdFHAAAIBXEGChAAABEDDWHAAKGHBaFCH.YHAA.hAEA......hAFA...,2,-1,4,5
fMCBNZXHRVTPJIUQFGWgKLYESecDbaAOd,dAAAMAAABADAZABEHAEBRAEF....TBGAIAGA.QCCChAIAGCABKDFAEBHFeDHHhACADDGBADIBCAHB..XEEChADAPEEBFFHBLGAASGGDaGGC..hBAA......hCAA...,1,-13,-17,4
OcZALaQBHPDUVfgCKSFdTIRJMGYeXNEbW,aAAAHAAA.DACAUADA..fAEAKAFAdAHARCEA.GAFA.eAHBhAAAEBBBODBBACCALDDBhAIAQEEBBDHDgFEHhCAAFDHD.IGHAMDDBXGGAhBAA.....hDAA...,1,-14,-15,1
MXOVJbHfGPIEZYNRLUDdQACKSacgTBWeF,SAAAaAAA..TADAeACHMAEAOAFA..VBEAHBFAhADAGDDAEBBBZDCBRDGBLEBBhAAAdDHAAEEAKEFBBGHAhBAAXGFCbFDD..........hABA......hAIA...,2,-12,-4,8
eFKQSAIdgbJVLMWCGcNPHDZREUOXYTafB,dAAAJAAALADBMADAGAGA....PAFAHBDBRCBB.EDFFXBFChBAAaDHDBBFCeBHHhCAAQGFAACCA..hACAbDFDCHHBDIAAOEEB.fGHA.hAIA......hBAA...,1,-10,-19,9
YONPFBbZVQaTDEgCRMdWIcUXKLGeHfSJA,OAAAFAAAZACB..QAEAaADD.DAHBEAFA.RBFAdDBA..IDEAhAIAXDDAGDFAhBAAHDGBSFADhAFAABIB.PGECbECD.......hBGA......hCAA...,1,-11,-33,22
LCBbKZQSWXIGdafOgFcDNMYTJEUPHVeRA,LAAABAAAZACAQAGAXADD.dCCAaAFA..OCFCFBGHDAIBhABAMADA..TCAAhACAEEDAHEGBRDDAADDAbEGDSFFDhAAA..GFBB....hBFA......hCAA...,1,-14,-19,5
ZDegXKfUCOQPYAEIcFLNWGTMdJRSHaBbV,EAAAFAAALADAGACAdAEBRAGFHCCABAHAZBFAeCHHKCBD..CDFAQEAAhAEAADFA..IEEAhAAANEEA.MDHBhAHAaFCDDFFBXGEAUGGA.......hAFA......hAIA...,2,-26,-6,20
VZHGeQBfUDJbWKLYIRXSFdCNOaTcgAEMP,EAAAMAAAZACBHACCGAEAeAFEBAGADBBB..JBFBKBHB.LCBDhAAARCCBFCHB.dDGAOEFCaDEH.hAGA.TGEAAGGA.QGGChAIAfGHA.......hBCA......hBEA...,1,-8,-22,14
CKFMZAGObIaYTdQfEgNXRVcUJWePDLSHB,GAAAOAAA.aADAdAEA.EAGA..XAFDRBCBUCGA.eAHBLDFDhAGAHCDAKDCDZEBAABBBbDGD.hBAATGEA..fFHAhBEANIAB........hBIA......hCAA...,1,2,-23,25
UgXKPTMCSFdZeVOcfLaIARNDEBGbQYJWH,RAAAEAAAGADA.QAFAJACBHAEAXBGAKAHB..MCCBhAAAFCEHeDDDODABLDGBhAAAADDBBDFA..bDGDUEAAhAEA.TGEAdFDAZGFAfHABaFADDDIB.hABA......hADA...,2,-3,-1,2
bdEGTBRQKWIfZCaNJOMVceUgFAYPHSDLX,HAAALAAAdADAEAFAGADARBFA.QAFAKCAD..IDDAhAAAZCAAaBHDODFBMCCBeDFAhACAFEGDAEIBSEGAhAFAXFAAbGDCTFDABHBDCGGANIAB.....hABA......hACA...,1,4,-4,8
agHEAJKYZfTXcdbSUNFWDCBVGMeQOIRPL,KAAAZAAA..TAEAdACASAEAFAGA.DAHBBCAA.GCCBhABAeBHHQCDAhAAARCGFaEAAHFEAAACAJEAA..XGCChAEAbEFA..UGCACGHAMIEAOFAB.IGGAhAEA...hCAA...,2,-14,-8,6
YNOMWBEJHLdTXSGbPRfUeCDIKFZVQgacA,OAAAMAAABADAHADAdAFASAFEGBBARBGF.eAHH.DBBBFDEBZCCAhBAAQEGBaCFF.hCAAAAHA.YDHBEFBBJFFF.hBAATGFA.XEEC....hCDA......hDAA...,1,-8,-20,12
dAPWaVGZUIJRFfbMLECYHBTQKXSNDcOge,aAAAZAAAUAEA.RAGB.FADA.MAGBECAAHDACQBBB.SAHBhBAADDDAODFCeBHDhCAAAACA..VFFAGCEAhCEA.fEDECEED.TGFANIAB..hDAA......hDBA...,1,-16,-18,2
DOfMBSTGbCLaVEKXFeUNdAHQPIYZJgRWc,HAAAQAAA..IAEAZACBRAEADAIBMAGBBCEDGCABLCGBhAAAEAHBFCHHeDFFdEEAADIBJFAAhAFAgFCD.hAHAOFHBTGGAaGFD.......hBCA......hCAA...,1,-1,-18,17
eUMCXcdEGODbTYNPKBJfLgWIQVHZSFARa,RAAAeAAAMADACADA..dAFAEAGAGBGA.DAIBTBDA...PBHDhAAABCCALDEBhAAA.gECAhABAQDDBHGECZEGFACCBaFBHXFBA.bFFDhABANEIA......hBFA...,2,-16,-9,7
JdPDTNOECaKGIRQVZBMXbcFAegYfLSWHU,eAAA..fAAALAEAHBCAdADATAFAEBHFaCEEGCAAhAAAREEAZFAAMDIBbCCA.AAAASGGBhAFAUDGADAIBCEEDQGEAhACABHEA.FGHB.YFAF.hAGA......hAIA...,2,-6,11,17
VfRTQbCOGAXgUHEYNBSPIKZJMFceadDWL,XAAAHAAAEADEBAFB..SADAKAHBZCAAMCCAeAFHdCGALAHBhAAAREDA.bCDDGGDBhAAAAADAUEGAPHAChACAFDCBaGDADEIB..fHBB.CHHA..hAHA......hDEA...,1,-5,-6,1
FIaTAUNPQMOegWVHfcYCEXBLDJKSbGZdR,UAAAQAAAeADA...VACAHAGB.fCDACAFBEAHB.LDABhADAKCEAGCGARCEFaDCHhAEAADDBMEEBODHDgFFDhAAA.cGCCBEGCSGBAhAIA.dGGA...hAIA...,1,7,-22,29
dPNEWgOaYLBUSfcIQHCVFZMDRATebXJGK,eAAAXAAAGADAdADA.EAFA..OAFAaAHDLDBBSBEHhAAAIDFAHCFBFBHDZDGBRGCAhAAAADBAbFFAKGHB..WFADhABABDDD.fGBA.CHFA.MDDB.hABADIEA.....hBDA...,1,8,-16,24
GcQMVdKBeaDfICRUFJgWPAObXHSTENYZL,XAAAHAAAEADEZAFBGADAMAIB..dAFBeCAAaAHD.DBHB.CCECREEAFCFDhAAA.JDAA..gFAAhAAAADHASEFATGGAhACALGBA.QGGABDDDfHEBhAFA....hCAA...,2,-11,-7,4
aAgNYMVKBXdCbZfWRDIJGPLSOTEFUcHeQ,...NAAA.MAAABAFAdAEAZAGBRAGBDBBA.GCCALBBA.TDBAhABAECFFFDHD.HEFBeCHHhACAAAIB...VEDACEBDbGAChAGAfFAA.IGCA.SFHHhADA.cGEDhAEA.,1,-13,-31,18
QOWGVTNcePZIgdCFSERUbHfJMDYLABKaX,aAAAQAAAGACA...TACAeAEAZBFEdAEASAGAhAAARDFAHEAAMEEBLCGBAAEAKFFDOHBChAIAVDDAPFHDhAGA.CGDAEHAAfGHADCIB.BHFA..hBAA......hBBA...,2,-2,4,6
daYCWSJARTQbLIUVfZPBDXOeEFMcKNHgG,RAAATAAALADB.UAFAZACBDAFA.eAHFECHFFDCHKBEA..HDEAhAAAdEEACAHASCADhACA.ACIBQEBAhBEAbEFD.fEHAXFBCMEIBgGBGhBGA.aFGH...hAAA...,2,-26,7,33
dWPeFBCLJbGgDOZMUVSfIcKQXTYaHRAEN,EAAAdAAAeADABACALAEAGAGADCCAZBFEUDAA..SCCAhAAA..fCEAhACAKDFATFAAHDFBAAFAPEEBhAIACFEDbGBCMDDB.IGHAQGFAhCAA.aDHDNIDB....hCBA...,2,-21,0,21
deEQUMGHTWOACbIFZRScNDafBXPYKJVLg,CAAAFAAARACA...SACHDAFABAHA...XAEAKBFALCABhAAAeAHBECDA..MCCBhACAHCGB.TEAAACIBZDDA.hADAaDED.fFGEJDHFdFDAQGGChCEAUGDAWFHHOFFH..hDAA...,2,-24,0,24
ZQSJGbMcYLAUPOWEaCeRKDTgNBfdIXHVF,OAAAEAAA..eACARADADAGA..TAFABBBDdBHAHCCAZCDAQCGAhAAAGEAA.bDADMEEBhAEALECAACFA.PEGBhADAaFFAKGGDfHAB.IHHAhAHAFHCC.....hBAA...,2,-25,18,43
aTIODBNbVRSXZFQLecdGgKHYCUfJWPEMA,aAAATAAA..DADABACB..VAFARADFZAFBLBBAeAHFGEEAhAAAHCDCCCHAUFAA.JCCFhAFAEDBBACIB.OEEB.hCAAbFGBFEHB..cGEDKGHB.....hCFA......hDAA...,2,-13,-7,6
fBEOYRWgKUDcVZMILXGdFTbPHQeAJCaSN,aAAASAAABADA.EADARAEF..KAGCDAGAZCCFMBFA..LCGBhADAdCCATCFAHEEBAAAACCHBOBBHhBAA..gDADhADAcGDC.XEDAFGHB.bEGD..hCAA......hCBA...,1,-15,-26,11
PONEaWAYCRGgMDQFBIZJLUXVeHTSdcKbf,RAAAGAAAMADA.QADABAGAZBDB.LAGBUCFA.eCDBHFDAdEGAhAAAKCCDbFBB..OBHDhAAAEFEAAAIBCGHAFFHB...hACA............hADA......hBAA...,2,-28,-7,21
RMJZdeSbaVKUBOYDLIfHCFTXgEGWNQAPc,RAAAZAAAeADEaACA..KAFAOAGD.LCCAHCCCTCGAEDFFGEBAhAAAQEFCAAIB.MEIBhABAdEHAbGFCBAHBDEEBCFAAXFCAhAFA.NICB.......hCAA......hCBA...,1,-6,-13,7
DLFEdVOIAWaSNcHBgUZfRQGMbCKXJeTYP,aAAASAAAHACBBAEAZACBRAEAGAFA.MAIBKBHBeCEB.TDGAhAAADBBBEDEB.dEAAOEEHhABAAAHB..cEFDhAEAfFAACFDA.XGCDPFHDLHDAhBAAFFHD....hCAA...,1,-9,-10,1
PXJVTaBFDSbGNRCLUIZHAEWeQYOdfcMKg,EAAAeAAA.QADAdADAMAFA.KAFA..XBEDTCCAaAHDDBCBGCGAhAAARCFB.LEEBhBDAZEEFAAAAODHD.hBGAfGGBgGCDPHAABBHBSDDDhCAACHDA.IHHAhCBA.,2,-24,1,25
KeWbSEJgdXTONABVfFHLYMIPZQacRCGDU,BAAAFAAAHACBMACAZAEA.QCEARAEAGBCAKBHBeBHH..SCBDhAAAEEEBdFAAOEHDhAFAAAHALDGBIGDAaEEADEIBhBCA..WHFGbFDD.......hCAA......hCCA...,2,-23,-1,22
MfDbALKdVcWaCEIOTFNYBQXRJGUeZPHgS,dAAAVAAAaADA..EADEOAFD..TAGAFAHBBBDA.RCAAGDEAhACAeCDAHDEC.MCIBhAAADCIBADEBLECBhAFAKDGBCGGA.IGAA.QFFB.hBAA......hBCA...,2,-32,1,33
RPgYWAIcKGVXfNCHSQDbeJULEBMdaZTOF,KAAAGAAA..XACBCADAHAEBQAGA.eCDBLAFAhAAAEDFAdEHAZBEATGAAhAAARDDAgEGAADAB.hACAIGAAfFFADCCBbGDCBHFA..aHAEhAGA......hAHA...,2,-27,5,32
VFNSWagcZJdfPRLDKYbGeEUCTMOAHXIBQ,HAAABAAAQACAFADASAFH..aAEEZAGBdAHARCAALDEBhAAAKCAAGCEAEDHFCCGDMDDBhAAAABIBXECB.IGGAhACAVEGB..gFAA.fHBFhACADFIB...hCAA...,1,-12,-13,1
LRKUYbEaDWBTeSNPHOQGZcFCIJfXVAdMg,dAAAMAAARADAKAGCUAEA...EAGAaBGE.BCBAeBBA...SBHHhBAAHCEAGDCAZDDACEHAhBBAfDAEADFALHCAhBCADDIBTGGAOEGB.FHEC.IHHAhACA......hADA...,2,-20,-13,7
gMCceUWQPEZXNdBHLTRYFOAKGIJbDVafS,GAAAJAAA.DADAaADA..SAEA.MAHBeAFHQCDAhAAAEAHBZCCBdDGAHDBBhACAREDFOEBHAAIBKDGDbFDD.hAIA.fFHACFFD..WCHHXGEDhBAABGCA.....hBAA...,1,-15,-17,2
dZXTcSMICAEDgWaORJGNFLVHbQKPeBUYf,EAAADAAA..aABERACAGAFALAEAHCCC.QDACeAHHBCCAfAHEhAAAZCEB.TEGAhADAMDGBAAFAOEFHhAFAFDHDbECBKGHB...YHDAdGHA...hBAA......hCAA...,1,16,-25,41
FHeBPGCSZVYLWEJaNMQdRKIUAOfbDXTgc,OAAADAAA..TACAFADDHAFABAEBGCDBZAFBLBHBEBBBaCHD.hAFAMBBBREEA..KFHBACCB.hAIA.XDDCeHAASGGDhAHAVEFB..YECF.WFHHhBAA.....hAIA...,1,-9,-19,10
fRdQTIPGJEgFbLMAZcHKNYBCVDWSXeOaU,HAAAKAAABACBDACASAEA.eAGHaADDRAFA.dCFDQCCAhAAA.TDGAhAFAGDDAEEFBbFABAAIBZFCA.hAAANICBCCEAXDGA.fCCEIGHA.hCAAgFGB.hCCAMICA.,1,9,-39,48
DHFXUNgCTGZAYaPOLJcVRMSeKQdfWEBIb,aAAALAAA.VAEARACFeAEE.dAHAEBHFBBEADCAA.HCEC.XEEChBAAUDCACDGDZEABABBBODHDhCAAMDIB..QEEChABAfGGAIGGA...NIAB.hACA......hAEA...,1,-14,-20,6
cLAPNZSUHBTYgCEfFXaIdQOKMebRDJGWV,ZAAAHAAABADBTAEACAFA.EAGEFAHB..aCACdCAAKCCC..eCCARCEAGEAAhAAA..VCFBhABAACHASDGAUFAA.hACAfEEEQFFBbGFADCIB...WEEDhAFA.....hACA...,2,-24,-4,20
DXEHabAVZGSJWPLIFQcMCfBdYeTUgKONR,GAAASAAAJADALAGBQADA.MAGBBCDA.eCEHTCCAhAAAKDCDREGBEAHB.HCGBhABAAAABZGCAIDAA.hACACEEAdFBA.gFDGDAIBaGEA....hADA......hAIA...,2,-20,-5,15
DbRXAWLKHdJZCBFcPMOeTNGYaQVfIgUES,LAAAHAAAZADBFAFDMAEAeAHBGBCB.aAGEQCAB.hABAfCGAgCABhACAEDEFbCFAAEHAdFFABDDDOHFEhAAATEFA.VFBA.SFHHhBFADIAA.WHCA.CHGD..hACA...,1,11,-9,20
geXcGfUVRPbIFOEMYTCANQLdaWHSZDBJK,LAAAaAAAHACBZAEABAEAKCEAeAFH.GBGAVDGB.RCAA...IEEAhAFAEDEBMEABTGAAhAGAAAIBdECADEGB.JFHBXGCBhAHA.fGGEPHAC.OBBHhAIA.....hABA...,2,-15,-2,13
afRcQZWgIHbXOGMdUTSFCPEJKYLVDeBNA,RAAAZAAA...IAEAHADBbAFAGAFA.dBHATCFACCAA.ECCBhAAAKCCDLDABeDEBAACAaECDhABAQEEC.hAHAXGAAMEHBFGFDPDHDYFDBBGGA.hAIA......hCAA...,1,9,-15,24
FfNLBXRYGPbdEKUQTAgWMcSCHOVeDZaIJ,MAAACAAAHACA..eACAaAEA.FAFDLAHBBAHARCCA.GCAA.dCCDhAAAECGAQCFAhACAABBB.gEEBhBHASDGADEIBZEEAfFCAXGGAPHAAhAHAKGHD......hBAA...,2,-29,10,39
HOCMFYdNTKLeEIDBfScAGbXVZaJRWUgQP,GAAAXAAAaADARADA.UAGA..QAGCHCDAMDCBdCDDTDGAhAAAeCHFEDAA.BDFAhAAASEFDAADAZFFAWEEDhABAOFCD.FFHDNIAB........hACA......hBAA...,2,-11,-5,6
UHbSNCeKTABRJPIWMgcEdVXLGaZQDFOfY,RAAAJAAA....IAEAMADA..EAGAdAGALBEBZCCAQDAChAAAOBHD.UDGAHCCDhBAASECAeCGDAECBBFFAhCAAgFFG.XGBAaFHDfHCBhCBANIEBCGED....hCCA...,1,-8,-23,15
JXdNDBHCAaQZFOWbgRPUVIeSTLEKcYGMf,ZAAAOAAA..bADBRADAUAGA..eAFALCCAEBHF.KDFAGCAAhABAMBBB.XCFDhACAdDHABEADHFCAAEEBQFFChAEAFEHDgGAG.IHHA.hBAASEEG.hBIA...,1,12,-28,40
SfGOdDgBNZFcLHQTEMeYWVAXaCJRKUPbI,aAAARAAAKADC..UADA..IAGAGAGAdDBABBEAZDDALCCBhAAAHFBCEEHFeAHH.VEEAhABAAAGBCBBDJFFF..bGCChCAA...OHEEDIAA.NDIA.....hCGA......hDAA...,2,-16,-16,0
IeVbQJcHLSFgCUTGYdDRZfEAXPBMWaNKO,BAAAaAAA.OACAeACHQAEAHAFALBCBFAGEUDDAGCGAdCHAhAEARECAEGDAABBB..MDGBhBAAKGFAIHAAJFHB.hCAA.SECD.CHDA.DFIB...hCEA......hDAA...,1,-12,-14,2
VLegYEaHONQMZURDITSWbcCGfXAKdPBFJ,dAAAFAAALADAeADAEAGA.HAGB.QCCAZABBRCEADBIB.SCFDhAEA..bDCDGEGAhAFAACEABEAAgGDAhAIAaEEC..MEHB.TGEA.CHCA.hAEA......hBAA...,2,-21,-2,19
aTdFDVSYHXKWIfBZJEeMgCPcLNAUORQGb,RAAAGAAA.aADAdADADAGASAFA.HCDCKBFAICDAhAAAZCGBEEEBeCCDMBIBCFAALGEAhAAAADFAQEBAbGAA.hABATEEA.FEHH.XGEA.BHBAhACA.....hAFA...,1,-8,-9,1
TCFSJOQMPBNHEAWaZIGLXDYbfceVRKdgU,ZAAAGAAALADBDADA....bADAeAFARBGF.dCAAUCDATCFAhABASDHHQEEChACAMEGBBBHAHFDBAAFAaCCHhCFAIHAAfDHAKHGA.FFHD....hDAA......hFAA...,2,-10,-7,3
eCLdfSVgRQGIUXcWFBZDHMaKPYTbNEAJO,eAAAdAAASADARADAGAGAUCDB..XAFDFEAAZEEAHGAAhAAAaAHFKCBA..TGEAhABAECEBAADACDGA...LFFAhACA.fGDA....hBAA......hBCA...,1,-7,-32,25
GfFRcNMDAIKgSQTbVJdeLYCEPaBWUOHZX,KAAAQAAA..bACBdADALAFAEAFAaAHDBCEAOBEBHCFBhAAAGCFARDBA.MCCBADBASDHBhAFATFDAeCHBhAAACFFDPFHBZGAAFFHHDHBA.......hAGA......hAHA...,1,-3,-4,1
ISVULKRXQPYAHECZgGJdNFcTBfbMOeWDa,HAAAEAAAZACBGADA.dAFBFAEDTCFABAGAMAIBeCABDAIB.aCCHhAAASCBDLEFARGBAhACAQCFAAGBACGGA.hADAgEDANIDB.bFGB.OGAC.hBGAWHDA....hAAA...,1,16,-30,46
QUPKFcAEISBNJLVTCRgZGMbWYOdfeaHDX,EAAABAAALADACACAZADB.GAGA.MBCB..bAFAOCFBhAAAeCAAHCEBQEAChAEAKCGAAAGA.SDDBhAFA.VFGBREGBgGCAdGEAaECDDDIB...hAAA......hACA...,1,14,-28,42
KGcRTZPQMBXSOVECbJHfUWFdeLNgaDYIA,GAAARAAAZADB.MADASAFAEAGA..CBFDHCDAUCFAdCCCeBHFLDABhAAAaDBDDDIBAAABTFDAhABAQEFC.BGHAhACAOBHD.bFFB.JFHB.....hBCA......hBDA...,2,-11,-7,4
VHEgSdKMAQFZPRNXGTBLUeWcaIOfDCJYb,ZAAARAAAGADALADBeAFAaAFA..OBHDCBFA..JBHBVDAAHCABhABAEDFBdDFA..AAAAQFFBhADAFEHD.XFAChAFATFBABEECcGCBDGGB..YFHBhAGA.SHEGhCAAMIAA,2,-25,-7,18
JgPDZMYQWBUGHCKSFfaIONVeLbXAdRETc,EAAATAAA..JACBDACAZADB..MAFAQAFABBDAHBEBSBHBhAAAaBGAOCCBeCEHhAIALCGBADGA.RGEA.hAAAgEGAWDBDCEED.fGEANDIA.hBDA......hCAA...,2,-21,-11,10
dXGeDMcJgIPFOCRZYWbLfEBTQaHSVUKAN,dAAAeAAAMADA..JADB..IAHAOAFARBEFZBDA...bABDhBAAEBHF.TEFAHCGBSDEBhBEAKDHBAAAAGGBBhBGADEEB.gFBACGHAYCCFLGFAhBFABHGDaEEHNICB.....hBGA...,2,-7,-7,0
NAXORcLfWIJVEUFeaTCZMdgHDPKGYQbSB,RAAALAAA..fADBIAEAEAGAeAFE..CBHAdCAAHBEChAAAKCCAGCCA.bEFAhABABCEBACCBOFDDJCGFFEEBhABAaGGBZGAAMIAADEIBQGFA..hACA......hAGA...,1,4,-20,24
ROdCbNDEZJaSKMgfeVYFIcBAGPLHQTUXW,GAAAHAAATAEAUADARAFAdAGA..CCGA.bCAADCIB..ZCEA.aDHDMDDBhAAA..eEABFEEABEHDhACAAACALEEBQGAAhAGAOEGHEGGA.SDBH..hAIA......hBAA...,2,-22,4,26
OcKbYXeHgRPJaZWSCFfLVTIMAQGDUdNEB,GAAAdAAAEADABAFAKADA..XAFBHAGBRCAA..aCEBZBGB.CCDALDCAhAAATDFA.ACIBQFCAhACADDIBOFDBbFFChACAeDAD.JFFAFHFEIHHA.MIAA.hADA......hAIA...,1,-2,-11,9
cOSTGWDKdZbLgNXaBPUFRCfJVeQHMAIYE,EAAASAAAGACAKAEAZACBLAFA..XAGBaBECBCGAhAAAFCBHRDEBCDHAVCFB.HEDBhAAAAAGA.IFHAhAEAOEDBTGGAdFCCNIBBfGGE...hABA......hCAA...,1,6,-27,33
QaZdRLOJcMIXCWGUFeDANKESgBfHYTVbP,EAAABAAAHACA..TACAVAGB..QCCBdAEARAGBLCABhAAAOCEDMCCBCDGDGEAAhAAAeCGDAAIBSDHHhAEA.fFGEbDDBZFEBIGAA.XGGAhACA...hAFA...,2,-7,-6,1
BgPSGZUbWIHOCXFTfVNLEKDJRaQcYdAMe,eAAABAAASACAZADBUAGA...IAFAHCEBXDBChAAA.TEGAfAHAhAAALGBAECAADCDAaDGAQGGBhABAdCGDAACAMDDBGEEA.OEHBhAHACBCANIBB.....hBFA...,1,-1,-17,16
VFRWBbJQSZGdOUfDACIMHYPNKeTcELgXa,MAAAHAAA....PADAeACAEAFALAHBaAHD.RBEABCADQCCAhBAAGCCAdCFAfEFAhAAAABBBCDHAIFDAKEHBTGDAhACAXFFAFGGBJHBASHBG.hBHA......hCAA...,2,-17,8,25
dSLUeXAFJEcWCGPHTZgMKObRNfYBVaDQI,EAAACAAAHACAZACB.KAFCRAEA......fBHABAHAaCAAQCEAhAAAdCBCLDEBeCHBhACAAAHAFDGHJDDF..cECBhAAAGEAA.TFFAMDIBbFADNICB...DFABhAFASGDGXGGC.hBCA...,2,-12,-5,7
OcSVJXBYTMCAbQfREIgDFNHaGeZWKLUPd,QAAAEAAADADA.HACAeAEAZAFBLBCBdBHASCDHJAHBBCFAhAAAMEABACCB.REFAFFCAGECBhCAAKGEAOHCC.hCBA.XDGACHGA.bFGD.....hAAA......hAEA...,1,-5,-17,12
CVeOYNMXLAQEfgJDSTBbZRWUHPIdGaFcK,EAAAJAAA.DADABADB.ZAEBRAEAHBCB.dAHAaAGDKCFA...eCBDhAAAOBHDMDIBACCA.QEEAhBCA.SFHDhCAAbDDAUFFBIGBAFHEA...CECD.hAIA......hBAA...,1,-3,-46,43
TCGNYSXFaUDLBOgEJVWcIfQdZMRebKHPA,GAAASAAAaADALAGBOACD.EBFFVAEA...ICHAhAAAdCDAREBBeDHF.HFEBhAAAAAHATDEACEFBNIAB.FEAAhABABHHAgEGA.cEDC.ZGDAhAEA.MIBA...hACA...,2,-3,-1,2
YHNKFfXeQcBCAWbMIOTDRPaEUVZdgSLGJ,MAAATAAARACA...EACEZAFB.dBHALAEBGCDAHFAAFAGAeBGBhAAAQFFACCCAACIB.IHCAhAFADDGBaECAgFFAhCAASBBDYHEANEIA....hAIA......hBAA...,1,-9,-12,3
UZPfFKNBDMWROaTQSAEHegGILCbcYXVdJ,HAAAeAAAGADALADBCAFA...bAFAXAGDdCADZCEBFCGDBCCDMDIBhAAARDEF..aDBCTFAAhACAAAAAEDGE...gFGDhAFAIFAAcGFBYHAG....hAGA......hAHA...,1,1,-18,19
WUIRACcEZDLGVdFYfNKPeBaJTMHSObXQg,EAAAZAAAGAEAdADA.FAGA..fAFAKCAAeCGFBDDAaAGDMAIBhAAAHEAA..OBCHhAFAbEGD.QDEAhBDA.gEGBWFFDRGBAAACADDIBLHDA.hABA......hAEA...,1,-2,-12,10
FSfEMHdXGZAOVYbUPQBNRDIgceaTWKCLJ,OAAAVAAA.UAEAQADCBAGA.RAFF.DAIB....gCGHhAAAeBBAaCFEKDDALDDBhAFA.SDFDhAHAEDHFHEFB.dFHA........hAIA......hBIA...,2,-36,-17,19
gBfNOFZVEaeYUCMLAbSXGRWQdcPHIJKTD,XAAARAAAdADAHAFAKADADCCB.BCFD..OAFAZCGB.EBFFeDDBhAAACBHAAAAA.GGEB.QFAAhABAICDATDAAhADANIAB.aDEE.MDHB.LFFBhCAAWDHH......hCBA...,2,-29,-5,24
gaeWGIJdAUfLKFRDQNETMVCXOPZcbYSBH,LAAARAAAQADCEAEA..MAHBCAFB.OBFDZAGB....bCCAhAAABCAAHEECeCCAGGCBhABAdEAAAAIBKHGADCIBNBIA.TEEAhABA.XEGD.....hCAA......hCCA...,2,-16,-9,7
BQHFEWYZAeSRDGKXbdgcPCNOfVUIaJLMT,RAAAGAAAKADC.dADA....PAFCOAFAUCCAaBFBMBIB.hAAAQDDCHCFAEEFBZEGBhABAAAABeCGBXFCAhAIAbDBDCFFA...fHCBIGHALHCAhACA.....hCAA...,2,-18,3,21
UZOTCegWJaYdHMIbENBVDAcKQfPRGSXFL,QAAARAAAGADAFAFAZACB.CAEA.eAHH..JAGBdDAAHCEBMCCBECHFhAAABDFAAAIB.KDHBSECBhAGALFDAOFHBhAAATFGA.aGCC.........hBCA......hCAA...,2,-24,-10,14
ZDObUASJCgELfPRIWQTKXeaHVMdNcGBYF,CAAAEAAALACARACA..QAFCKAGA.eAHHHCCAdCCDGCFAhAAAFDABZDEBbDADADIBSEHDhAAAJEEF.fGFAhADAICHAXFCDaHAA.MEIBBHHAhAHAOHFC...hCAA...,1,-8,-10,2
KYbAEGNZOfLVUHcDTMdXWBQaeSJgIPRFC,EAAAZAAALADBHACADAEAdAHABAFA.eAGHSBEA.JCCFgCAAhABA.RDEBKCHBhACAADGAGEDAOEGDfDHAhAAAUFAAMFIBQFFCaFCE.FHBAhBHA.CHHA.NIAB....hCAA...,2,-13,0,13
EDMRGJKQPaLWTUcVeXNdOSgFfZYbAIBHC,HAAAEAAARACA.GADA.QAFAaAFALCCATDAAUBGBeBHHhAAAdDAASDFAhAAAFDFBZFAAAACACCCDMEIBKECA.cGFAhAFAXEGA.OFFBfHBBIHGAhADABHFDDIAA....hAIA...,1,20,-15,35
VKSDPOFUYRcTGLgAfNXeZEQCJdMIaBWbH,XAAAEAAA..QACAdADAMAFABBFAHAEASAGEhAAADBHBFDBA.RCEAGEEBhCAAAAAAeCHHZDFFCCCDaCHD.WHCAhCBAbEDD.KGHB..OFBB.....hCHA......hDAA...,2,-22,-4,18
DNTWdeQSZfPaHKRIgOLCEYAFbcGXVUBMJ,FAAAGAAAUADAMADA.DAHB..TAFAeBFBZCDF..aAHDHDBBhAAARDBA.OBHDEDFAACCB.hAHAbEGD..XEFAhBAABGBDWFDAdFDAQGGB...hACA......hAIA...,2,-15,-12,3
SQfWVLgBYIAHGREJFDTaCeZUOPKMcdbNX,HAAAEAAADADAaACA.eAEHZADEUCCB..KAGAdAHAXCCD.hAAAQCFAfCFAhBCALDHBBDGAADIBRFCATFEAhAAAOFFAMGAA.NIABSHFAhAGAgGGAIHBA.hAIA...,1,-3,-21,18
DYCPgULEFKQMTXSNbefJWaIGHZOdVBRcA,CAAAUAAALACAEADA.KAGAMAGB..SCCAeAHB..fBEAhADAaCEDHCGBdDAAhAAARDCBACHBDEEA..gFFBhADATEGA.bGAAIHHA.OFFBhAIA.....hAEA...,2,-27,-15,12
GDcaMEYHOULBFbITKJSCPgdZNeVQfWRAX,GAAAaAAA.EADAHACBLAGBFAEA.TCDASAGH.CCEAdDGAhAIAeCHHQEBAhBAAREFBAAABDDABMDCBOBBHbFCDKFEDhACAgEED.ZGEA.NBIA.WFHH.hBEA......hCAA...,1,5,-6,11
KEZRCTGcHfXPMgOIWbdFYSLQBeDaVUJNA,EAAARAAAGADAHACA..XAFBMAFA.OAHDIBGA.dDAASCCAhAAALDFAeCCBhAAAaCEDUEAAABIBZFBETDGAhAEAfFFAgFFBFGHBBHDADFIBNHBBCHFA..hBHA......hCAA...,2,-4,2,6
KGCRdTHXYcLbDfgJNQZaSAVPEWUIeOMBF,EAAAUAAA.eADAMADAKAGARAFAHBCA..XCBALCHBDCEAfCBEhAAA.gDEAhAIAQCGAaEBChBCAAADAPDFBOFGBFHDAdFHA..YEDBhAIA......hBAA...,1,9,-32,41
YXLNVTOaSbDKgUQHMFGeZdBfWAREJcIPC,EAAAJAAA.....IADACADBLAFA..TAFAaCCADCFAKBCDhAAA.QCEChAFAHDDCGDGAeAHHdGAAfDHAhAHARGDA.PEDB.XFFChCAA......hCBA...,1,-21,-26,5
DBFCMcRUeZKIGENSgWdYHPfXOTaQLJVbA,FAAAMAAARACFZAEBGACB.EAGE..SAGAdCCAHCFA..XEDAhAFAaCFDLCHBJEGBABBBCFCDhAIAeEAA.KEEDIHCAhBAANHAB..gFGGYFHB.OHDEhAEA.....hCAA...,1,-12,-13,1
eLFRBYNQUfWSXCaJEcdbGTKPMgOAVIZHD,ZAAAHAAAeACERADFBAFBQAFCUCAB..SAGHaAHD.ECFBhAAAbCCC.GDEBKCHBMDDBhACAADHADFFBLEEAhADAFECDfGGACFHA.dHABgGGG.hABA......hAHA...,1,-7,-8,1
THZRcFPIMCNWXbgBUDLeVKdSEaOJQGAfY,TAAAHAAARADFFAFA..MACACBHA...XAEABCADLCFBhAAAeAHBdCCAECCBaCFCQFDChACAADBAZECE.IFHAhADAbEGBDFGBSHCA..OHDEhAIA.fGGEhDFA..,2,-18,-11,7
TWXNKdYSbgEGQHMfZFVOJaReLcBCIADPU,DAAATAAA..XABAdACA..bADDEAEAHAFAZAGB..OCCBhAEARCGBeEEBLDEBhBAACFAAAAHAUGGAKDHB.SBEAhBIAQFCCMFHB.FGFD.....hAAA......hAFA...,2,-16,-7,9
XSMagbLYWZcHGJKFEUBfPNOACDQedTVRI,QAAAeAAAdAEARAGB.SACA.aAEDbBAA.LDEBhAAAZAFBHCGBGEBAFCDHEDAAfDHAhABAOAHFAEFBTGFAhAAAXGEAMFIB.......hAGA......hAIA...,1,4,-14,18
KWGcdNZSHfVDQaeMXCOLJRAUEBFTgIYbP,EAAATAAA..IADA..bACBKAFAGAEAdAHAZBCAHAGDhAAADCGB.eCCDMDDBOCHDhAGAREEBADHA.FEBH.gEEAhAIAPEHB.cGDCfFAAaFHH..hAAA......hAFA...,2,-32,14,46
JKcTeZSLQgWAEIbfVMHNOdPDFURCYXBaG,EAAA..bAAAMADAHAEAdAHAFBHDRBCA..CBFB.BCAAGDBAKCCDeCFFhAAAZDEALDHBQEAChABAABCA.fEDAhACAOFDC.DEGA.XFGAaHBC.cGAD.hAAASGFDIHHA.hBHA...,2,-16,5,21
TEaHYWZOSbPfUgNCRQFIBeAcMVLDKXJGd,MAAALAAAKADAGAFAEAEAHAGB.ZCAASAHB..bCEDhABAUCBACDGDREAA.QDDChAFABEHAAAIBDCCAdDHAaGBDOFDEhBAA.fGHAFGGA.eHBA.hACA......hAEA...,1,-3,-10,7
LJWBbeVOTQdNZRHcDXaAYKGPgUFIMSEfC,GAAAUAAAMADAEADALAGBBAGA.eBFFOAHDdCDAREFAHBDADAIBAAABhACAKDBA.FDFA..fFBAhADACEEA.bGEAhBCATFBA.ZFGB.aGFB.....hBFA......hDAA...,1,-8,-21,13
FTJZCPLNdUeAKgVcWaRIbDEGfBMXSHOQY,KAAAVAAA..aACARADF.DAFAGAFA.MAIBHBCA.QBFChAAAFDAAZEEALEHBdBHAADEB.hAIA.gEFAhCAAIFAAEFDBXGECOHAA...YHDGhAAACHGA.....hCBA...,2,-25,4,29
GEHVLAgXaJecfQdWZKICFNBRSDUOTMbYP,aAAAeAAA.QADAZACBCAEA.BAFARAFFDAIBTBGA..MBBBhAHAbCCC.GCGAHDECAAAAJCEFhBAAdFFD.KGHBFGFBSHAAhAHA.........hCAA......hCCA...,2,-32,-2,30
FMUXceETOCKdZbNGBaJPYWRQVfAHDLgIS,HAAALAAASACEMAEAUBEAeAEH.EAGACAHAZCAAGCCA.aBGEhAAAJCHB....PDHBhAGARECAQFGBhABAACCBDEFBFGDDTGEAdGGD.BGCD.....hCAA......hDAA...,1,2,-18,20
UHXdWFIaVSOQgNbcZCTAYERBPfJGMeDKL,RAAABAAA.JACAeADE.LAGBHAFBdBHAFBDD.aCCHOBCB.hAAAQDDAbDFA.hABAZEGBAAIBEEEBGFABMFCBhCAAKGEBXGFAIHAASFDD.hAAA......hAFA...,1,-4,-19,15
CNLOaIcgQXUBJePGdZAbDFYRVKHfMETWS,FAAARAAAHADBEADA...TAFACAFALAHB..aAHD..gBFAhADAQDAABCCAhBAAeDDAdECAAAAAbDGDDEEAKEGAhCAAMFABSFFDOFFHIHHAXGGB.hADA......hAFA...,2,-21,-6,15
VacYAXECfFBZSURKNHQgeGLTJWMPIDdbO,EAAAFAAAZACBRACA.HAEAeAFEGCEBLCCAJECA.MBGB..DAGAdCHAhAAAOEGDaDAB.ABIB.fECAhADABGFDKHCA.QEEChAIA.TGGA.IHDAhCAA.....hBAA...,1,7,-32,39
DHSKXEGCeLAWIbZRJOFgVPBQfcTNdMUaY,..IAAARAAAFADA..VAGBQACA.TAEAdCCAaCFHHAGBhACAKDHB.ECCBGECBhAAAeDFBAAIBZGAAODHDBFGA.hABAfEDA.MFFBDGIB.CGAA...hAGA......hCAA...,1,-7,-22,15
cMOXFLHIWRAUaYQSgVTbeBCDJGZfEPdNK,aAAAQAAA.SACATADAeAFEDAFAZAFEEBBB..dCFAKCDAhAAAMCHBFCGAHDAARDABACIBUDDAhADAgDGGBFGDGGBBhAIAfEEA.cFGC...hBAA......hBGA...,1,-5,-6,1
OSFCgZTNGKJHQIXcAYUaeBVEbdLRfPDWM,aAAAeAAABADAEADAdAGALAFA..RBEBDAIBMBBBFCCBZCCAGDGAhAAAHCGBQECAhADA.XFFCADEBVGBAfFFEhABAOGACCGHANICB.......hAGA......hAHA...,1,-10,-13,3
aFfWXUedJCYBELZgKQIcPMOSVDRAHGbNT,HAAAGAAATAEAaADAFAGA..XAGBdCDACBFA.ECABZCFEKCCAQEBDhAAAIDFAMBIBhAAASEFAREAAADHB..bEEChACAfFHAeFHFBGCALHCA..hACA......hBAA...,1,15,-17,32
dNHJRULBDEWVXgPZQcKfIaMACSTbeFYGO,TAAAeAAAGADA.dAFBHACBRBFFLDBBEAEAXAGAZDGBQFEAhAAAfCAEaDDHACFAbCEAhAAA...ODHDhACANEIA.BEADDAIB.gEEA.KGGAhAEA.MHAA...hABA...,1,13,-7,20
BSIbMXcRDWVfgTGHEFJKYPQLUOCeZAaNd,dAAASAAAMADARAFA.DADA....VBDBTAFAHCBBFBCDKCGAQCEChAAALEFACGEAAAHAaBHDhABABGGA..bEBB.hACA..XEFA.fGEAhBEA.EGGB....hCAA...,2,-24,-22,2
PZAWefTbRdgUCMEIaNBQXLVFYOHcDSJKG,eAAATAAARADA..dAGACACB...ECCBaADDQCEDLAFAFCCHHDGBhAAASCFAGEAAAAIBbFEDhABAMCIB.BEDAXGGAhAEAOEGBDCIBKFCD.PFED.fGAAhAAA.IHHAhAGA.,1,14,-29,43
HZIcaSgGECeLYfbXVdNAQTMPDURJKWBOF,MAAADAAARABA.KADABAEBHAFBZAFB....aAHFGCDAEBBB.eAHFhBAALDDB.bDFAdDCChCAAAECA.TFFAUFAAOFFBhAFAFDHD.SGHBCHHA.YHBGhBAA.....hCBA...,1,5,-28,33
OQLIBeGadPfATZVCRXcbUFYgMHJNKDSEW,ZAAARAAA..XADBUAEAFAGE..MAGBHCAAKAHBECGA..QCCChAAALDEBeDHFhABAdDFDABFBTFFACEBA..hABAbEFDYFHB.NEEADHAA...WHAAhAHA.BHFD..hCAA...,2,-17,-16,1
MfLFgRNOabJSIHTcdVEeDUWZCBAGPXYQK,GAAAXAAAQADAKADA.MAGBLAFBRCGFOCDBaAHBSBHHhAAAHEEBdFBAEAHBeCDBhABADDAB.ZDAAAAABfGHAhACAFEGAbFCA..TGGA....hADA......hCAA...,1,6,-11,17
RDXYNHQbfLGgEJAdVaZPcTWeBUCSOIKMF,aAAAZAAA..TAEAeACHCAEA..OAGDKAGARCEA.DACA...XCCAhABAHEAAbEEAGDEAhAGAEGABABBB.dDGD..PGEChAEABGGA...SCHBMFIBNIAB...hAIA......hBIA...,1,-10,-18,8
WgZGSNTIHcCOXPYUFaMDLJdRBQbAEKVfe,EAAAKAAAeACEZACBGAEA..TAGAHAGDOCBH.XDFDhAAAPBCDFCEAMCIBLDHBhAAAREDBQGAAhAGAAAFAfEDASGGAIEGACHEA.aFED.hAIADGGB.BHHA..hAIA...,1,18,-29,47
TEYgReZdJXIPGSQLUcVNWDCAbMaBKFfOH,aAAAFAAAHACB.EAEARACFeAEEZAGB.dAHAJCEB..XBEDGEAALEGBhAEAUECA.VGCAhBAADBBBADHABFFAOEFAhBAA.TFFA.IHHA...hBGA......hBIA...,2,-16,-9,7
HfGgFPIOaXLMYZNWJEbQRUSBDKecdVCAT,HAAAGAAAFADAOADAaAFD.MAHBZAGB..JCAFEBFF.RCDB.BCCAeCHHhAAAdDEAAAIB...TEGAhAAAfDCE.gFFBhACAXECBYGEAWFHHQGDAhBAADBIB.....hACA...,2,-25,5,30
ZYNcVgWCOLaHEMbBXSFdDUfTRAGPJQKeI,GAAAQAAAeADAZACB....cAFDgAEA.OAGDhAAAHCDAEBHFMAIBbDFAhAAASDEAdEADDFFATGGAhACAADEAKEGAIFAANIAB.CFFDaGHB..hAFA......hBCA...,1,10,-20,30
MAKcFXTHNBIDVeJadZQCEbGUfRPgYWLOS,FAAAHAAABADADACAeAEAdAFAZAGB..EAHFGCCARCCA....gCFBhAAALDABMBIBhADAACCAXEEC.TFAAhAFAIEFAaDHDQGGAbEGD..hCAA......hCIA...,2,-29,-6,23
PGaLUOVJbMNgBYdXZcIKEAHWeSfTFRDCQ,HAAAeAAA.TAEARADAQAGCGAGAaCACLCCAUCCA..ODFBhAAAbDEA.MDIBBEAAdEAAhACAZFFAKGDAAAAASGDBhAEADGGBCHHA..........hAIA......hCAA...,1,4,-17,21
OJBSHbgKUZFdfDTaNXLEVGWQAYCPeMRcI,CAAAeAAARACA.OADCBAFBHAGBKAGC.ZCAAdCCA.DBIB..aCEBLCFBhAAAEDFB.GEDAhABAAAIBMDIBIFAA.hAAASCHDbEGDFGDA.TGGA...hACA......hADA...,2,-23,-14,9
AUMIOLgfcGKEJabCFRNXPTDZVdHBWeSYQ,MAAALAAA...fAEAGACBEAGEaAFDFBBH.RCEAXDCDhAFATCAAZAGB.HCCBhABAeCHHQEFAhACAAEGBOFFBKGHBbFDDCEADDHCAdFHABHGD.....hAEA......hBIA...,2,-10,3,13
RFVYPHNCDETGgAZIcWJOSULbedMXKQfBa,ZAAA..IAAAJADAUAGAeACA.dAGAMCABQBEA.hABAaBHDRCCAFDFD..PCAAhACAHEGBDDIBEDABGDDAhADAAEEBOFCBbFGBKHDABHEA.....hACA......hBIA...,2,-26,5,31
QKXBDdFOUcgfSPVHbYAZCTWENReMLGIaJ,ZAAATAAAEADE..RAFFLAHBaACA.KCAADAFA.dBDDFCEHOAHDhAAAUEGA...fCCEhBGASDDDHCECAFAACFFC.hABAeEEBGFABQEGABHCA.gGGGhBHA....hCAA...,2,-13,-9,4
eFGEcaQYPHKNBTDMAJdbVRgLfSCZWOXIU,dAAARAAALADBCADAZABB.OAFAUAFA..GDCAEBFB..QDEDhAAAHEEBBAHAMBIBACEB.hBAAbDGD...fDCEhABAXCGAeEHBaFFHKGBADFBB....hBFA......hCDA...,2,-25,-1,24
dWDTYfKOEgJAcbPNVFXeRQMBUSaICHZLG,...bAAAPAAA.FADDRAEAMAIBBAFAUCFAaCAA..HCECGDDAhAFAdEAATECAKAHBECCB.hAHAAAAAVEGB.eEEHhACAQFGACHAALHCADGFB......hAEA......hAFA...,2,-24,11,35
NMgXLZcbYRUWKOVASHafDeITQdCBGJFEP,HAAAaAAA.eACEQADAdAFAGBGAEAFAMAIBLCCBZCCA.bEDDRCGBKDAAhADAAAHA.DEEB.TFFAhBAABCEDFFFC.NEIA.XGCChBBA.YFHB....hBHA......hCAA...,1,-5,-6,1
KCUHNPSOJTWLAVXEMadQIZDgBFRGcbYef,EAAAdAAAZABBBACARADAGAGA..bADDeCEFCAFA.HDFB.SDCHhAEATBGAAAHAMCCBhAAAaEHD.QDFDhAFADGAA.FFCD...fFGENIAB.OEEHhBIAWGAA....hCAA...,2,-25,-7,18
XEFLQaDMSgeTUONVWHKZRfIbYPCGJdBcA,EAAALAAADADA.MAEAeAEAUBEA..OAHD..VCAAhABAHBCARBGB.bCFDCECAdEEAACBBQEDAhAAA.aEHDhBCATGFAKGGD.fEHAIHBA...hBHA......hCAA...,1,-14,-23,9
HPbCZJFgYDLUOeMcTNVfWRKdSBIAXaEQG,EAAAHAAA.CADBZAEBFACDDAEALAHB.eBGFMAHB...TBEAhAAAfCAERDDB.dCCAhAAABDFAAEEAaEFEGEBAhAIAbGBA.gFGAUGGA.OHEC..hBEA......hBGA...,2,-23,1,24
ZOXKJAGBULfINSCMEYgcFHDPedWQRTbVa,GAAALAAA..fADASADHEAFA..gAFAhABAHBFCeCDFdCAAREEAbFABZCCAKBHBhACAAAABBDHAIDGAhAFAMFIBFGDBDEEBQFFAaGGB.XGAAhAGA.NEIA....hACA...,1,3,2,1
cRYbLZEgBWVONFSdfDaHKMTAUIeQCPGJX,eAAAQAAAGADAJACERAFALCHB.ECCBBAFA.OAGDhAAASDBDdCDAaCFHHDFDhAAAMAIBAAFACFDA.PHDAhABAXEFA.bGDA.......hAIA......hBDA...,1,-5,-26,21
FcBGZadgHPNeMVKARLTQYUDCJESfWXIbO,RAAATAAAQADC.DAFAEACE..SAGAXAEBbAGDFCCHGCFAhAAAZCCA.dDHAHECAhAAAeEDFMEGBACFBLHCAhABACEHAfGBAIGHABHEA.aHGE..hAIA......hBGA...,1,-2,-7,5
RFOTDedGXSfVPHLgUYJaBKQbZEWACIMcN,MAAARAAAOADADAEAGAGA..SAGA.VBDBHBBAhAIALCGBgDBAhBAAUGDAaBDAQGGAhAAAEDFBADIBCEDAIFHAFHAAeCCDdGBA.fFFEhBBA.....hABA...,1,-3,-11,8
AaRcDQWCPGMYLHNZEbBIUdgFSXTKVJOfe,RAAAQAAACADB.GACBMAFAHBDCEAGEBCDDdBGAFCCH..TCFAhAAAKDHBOEDCACHAaDAADDIBhADA...PEEBhAFALGEAZFCFbGFA.......hAAA......hABA...,2,-31,3,34
MFdZHDLeABEbNOYSUXCVPRWgfTaGcQJKI,EAAAOAAAUADA..CADARAEF....fAFFGAGAQCCChAGAKAHBMBCB.ZEEAHCFAhAAAeFHHADBBBDDA.bEFAhBDASBBD.XGDAPFEBTGGAhCAA....hCBA...,2,-20,-15,5
aZSdBXEUKFGfIQbgOVCcJMYARTWPLHDNe,RAAATAAALADB.HAFAeACEZCFAdAFAEDCBFAHBGEEAQCCAhAAAOEHBCCHA..MDBBAAAADFAAhAFAaDFBBHAAKEGAbGEA.hAHA............hAIA......hCAA...,2,-12,-8,4
cIebJgLFZURPfVQBdaAKEGYTDNWOMXCHS,EAAAGAAADADA.OADA.MAHBHAEC.SAHBeBFF.bBCChAAALCDBZCEE.RDBFfDGEhAAAQDBBaDGEhBDAAAIBTFFAXEFCCHHA.IGGA.hACA......hBAA...,1,-3,-14,11
RMcOEILeaYTfWNSJdbQZUCBPDAgVGXFKH,GAAAKAAAHACBRADAMAHBEAEALAHB.eBFFaCDC...TCAAhAAAfDFA.SCHHhAAAbDFDZEAABEDBhACAAADAXFCAOEHFIHBAYFGBNIABdHEBCGAADFIBhACA.....hAEA...,2,-10,3,13
RTJgcYOUWDBSdKAXHFGNPaMLebfCIQEVZ,HAAAGAAAaACAeADACAFA.EAGARAGF...TCDAJCCA...gBGAhAAAOCHDDDGBdEADAEEAFFAAhAAAMDIBLHFAhAFA..bEFBQFFBZFCBYFHF.WFFDhACASFCH.hADANIAB...,2,-9,0,9
BYJRIAQNSETcOCKebXaHFZDMfPVgWUdGL,QAAAEAAA.OACCeACAaAFDHAFBZAGBMAIB..fCCAhAAAgCDBdDAAGDGAhAAALDEBBEAARECFABIBhADATGEAKEHBbGEADDDB.PHAA...hBFA......hCAA...,1,6,-6,12
KZgALEVRNYTGBSPJCWeIHfQOFbdDMcXaU,EAAARAAA..TAEAGACABAGBSAEA.CAHA.eAHHHCEAQCCAhAAAbEAB.dDAAhABAMCIBaCEEZDFEACBBLEEAhAAAVFGB.PGCA.IGGA.hADAOHAEDGFB...hAEA...,1,10,-10,20
UYNPTaKHfIcAJVFGbBZWDeEXSRQCdMgLO,FAAAGAAAZACBDAFAEADARAFA..dBEAMCDBLBGBOCEB..UECAhAIA..PCGDaDHDHFEBhBAAfFCEABIB.hCAAbFEDBGGBeDAD.QGGA.CGAD.hAAA......hACA...,2,-26,-2,24
HYIWeUTQfDgcNRdLPOJFVbKXBaAGMZSEC,ZAAAEAAAHACA..IAEAeAEEQCCBDAGA..gBEAhABARCEFdAHALDHBhAAAOBGDFEGBKCAAaGCAAACAGEEAhBIACHHA...YDHB...hCAA......hCBA...,2,-28,-1,27
LMNfBOGQFdHZXVScIJCDPWEKbRTaUYeAg,MAAABAAAGACAdAEAHAGBZAEA..SBBAICAA.DDDAECEARDEAaDHDhAGA..eBHHAAIBLEBBhBAAODFDQFAAhAAAXFGC.cFECCHHA.KEHB...hBBA......hBCA...,2,-15,-14,1
MSYGLBAXNRKZaPeWTVDgHUJQOCfdbIFcE,RAAAaAAAeADE..TADADAGAHBDA.QCGACAFBdAHAFBBHECEAMCCBhAAA.GDEAADAB.KDDDhABAZDDA.VFGBUGGAOHBAhADAfHBB..cDGASGEDhBHA.....hBAA...,1,8,-23,31
UOceKTRZSMAgbEIPFBdCJLDfWXHaQVGYN,EAAAFAAAdADALADADAFA...XAGDHBEBaAGEGCBA.UDDAhAAAeCCBRDGBZFAFACGAIDHAhBAACGDA..fGFAhAEAQEEB.YDBF.OFHBhBDA.....hAFA...,1,-12,-18,6
aIMbUfBFNJRKWdOZeTPSYCDcGVgXAQHLE,HAAAEAAA.aACAMADAUAFAFAGD..RCCAdBHAeBCA..SDFHhAAADAIBGCDB.XDBChAAAACCALEEDIEGAhBCAbFBBBFGAKEEDOEHD......hBDA......hCAA...,1,-11,-18,7
CVOcKFQSeRZHMdEfWJgIaTYGLXBbDPNUA,OAAAFAAAeACHHADAdAEA.EAGE..JAGBaBBCGDDALCFA.BDDAhAFADAIBUEBAACGACEFAKEHBRFGBZGAAhAGAMFEB...fGGAhAIA........hBAA......hCAA...,1,-20,-24,4
JLbHGdVgTOCNFUPSeWaZQMBRDAYIEcXKf,EAAAKAAALACBHACAdAFA...TAEACAHAFCCHUDFAeAGHZDEABCHBAAIB.hAAA....IEAAhAAAfEAAGEDAhAEAOCHFSFHHaECBRFDADGHB.XGADhAEAJHAA......hAGA...,1,-11,-12,1
dUZQMCcVNXPHaALBGIgbSeJFDWOEfYRTK,GAAA..bAAAeADADAAA.EAGARAEAdAHAZBFEMCDB..CCCD.VDGBhAAAXCEAHEDBAADALDHBhAEABGGD.SECAhAFAWECD.fEGA.KFEB.hACA......hBAA...,1,-10,-24,14
SYeHEJGKUfRaZBLNDcgbOXVFMTAdCQPIW,dAAAQAAA..IADASACAHAEBEAFAGBGAKAHBRCDAZCGFhAAALCCBDDAA.bEDDhACAXECCMEIBAAGACFFAPFABhADA.eEGDfGBAaFEDNIDB...hAFA......hCAA...,2,-11,-2,9
UFNYgWbGMZCfROeLdESKBPDcAIHXJVQTa,HAAAXAAAQADCUADA.FAFA...gBGAGAGAZDBAhAAARCAAeCEFEDFBBAFADDIBAEGAhAAAIFHATFEAaGHBhACANIAB....bGDAMIAACHHA.....hABA......hAIA...,1,9,-21,30
SeFGUbHWKNXLCQDRdOYIAMcEJfVTaZgBP,EAAAVAAAZACB.BAEAeADEGAFAHAGBKBDALAHBDDDA..RDEAdFGAhAAAOCBHAAIB.MDEBJGAA.hAGAaDFH...SECHhAAA.bFGDNDIA.CEHB....IHBAhBCA....hBHA...,1,-16,-19,3
cWHYFIOCdXGDbTREgULKBaSPJNfeMAZQV,ZAAAQAAA..VAEAHACAFBHDCAFBGAGADACA.RCDAEEAALDDAhABAaDHD.SECDhAHAPECD.JEGBeEFBhAAAACCB...cGECIHHA.dFDA..hAIA......hCAA...,2,-31,8,39
aUeQRLXfZIdgKPCYJNcHbSAMWEBDOTVGF,EAAAOAAAGACAFADD.eAEARAFA.LBHBZCCAdCHA.KCBD..CDGC.NCFAHEAChAAAAAFABEED..TGCAhAEAUFGA.QGFAhAFA..fFCA...hAIA......hBCA...,1,3,-43,46
MTSAIYfGXcObWLUCJQVZPKaBFHeRgNEDd,..IAAAGAAAOADALACACAGAQCDAZAFBKAHBBCCAHCFAhAAARCGF.EDCBdCEC.MDABhADAAAIBXEFA.cGGChACAbEADUFGB..PHCA...hAEA......hCAA...,2,-18,-2,16
JENgAVQBDLWcZMFOGISCPbfKRaTXedHYU,QAAALAAAZADBMADAGAFA.CAHA.bAEARCAB....aCHDeBDBhAAAHDEBUCGB.EEFBhAIAACCADFHBFEHHSDDDhBCAKFBAdHABJHDA.gFCG.BHHA.hABA......hACA...,1,4,-10,14
DMaEPRQAFJKdUgINeBcTfSWVGbXCHYLZO,KAAAdAAAUADA..IADAeAFABBHA..TAFASCAAhACAGCAACCFA.HCCAZDBEMDHBhAGAEBHFRDFBAAHA.FEEHJEFBhBAAgFCD.fFHAWEHH.hBCA......hBDA...,1,-4,-31,27
ZFCVfKIQcAWNJTEPOGaYSBebLdDgHMURX,JAAAEAAAGACA..aADABAEALAGBdAGAHCEARBCAZDEACCBDKDHB.hAIAQEAAABGB.hBAATEFAOEHDeEEDhAAAbFDAMIBAFGHB.........hAEA......hAIA...,2,-26,-5,21
FGHTDYOBfeXcbWgIVZAQMSLEPCJNRUKad,MAAAEAAA..CACARADFaACE.GAEAHAFBDAIBBAGA..eCCB.XDGAhAAAbCCD..gCGAhAGAZEEAAAHBLFABhAFAPBBBUGGBdFFAFEHD.OHCCfHDBhCAAIHHA...hCBA...,1,-5,-6,1
DYNaGTcIZLbegVMXWRQAUEKPJHfOdSBCF,EAAAKAAAHACBdADABAFADAEA....aAFEGAGA.TCBAZBFEeCABhAAAMCFBRDEAADHA.UFGAhACAfEDACEDD.FEGHhAAANIAB.LFAB.gGDAXEBD.hAIA......hBEA...,1,-9,-16,7
UROdYfeAXSMWIZGKPCHBDcgJLQTNbVaEF,MAAAZAAAGAEAKADAHAFBDACA....JAHBTBBA..bDDDEAHBhAFA.RDDAdDHA.eECBhAIAAAGASCCD.hBAAIEHABFFALHEAQFFCaGHF.OEBBhABA.XGBDhBEA.CHHA,1,-9,-29,20
acYKOFBfdWPEbJSXQTCLVIRMZGHUAgeND,eAAAaAAA.KADABADAdAFA.EAFA..SAHBQBGALCCBhAAARCCAGDAAHBGBABBBDDGBOCEBhABAFEEB.fEGEhCAAbFCD.TFEACEHAMHEA.....hCBA......hDAA...,2,-12,-12,0
EGXBSOFTNMgJYQAVICdHaeUbRKLZDWfPc,CAAAHAAAUACARADFZAFB.DAIB....fAEFECABGCGABAGAhAAAFCCHMEEB.JFAAAAIBdCFAhBCA.eCHBLFFBhAAAPDDBSFHH.OHBCTFFAhCAA.YHEA.hACA...,2,-32,-2,30
SEAbZXTcLfVgRWPUOaDIdMFQBHeYKCGNJ,ZAAATAAALADB..VADARAFAUCAAaAGA.dCFD.FDHDHBGB.hABAeCAACEEAGFABSDDAhAAAAAFA.bEDAXFGChACAfEHA.gGCA..hACA......hADA...,2,-19,-7,12
IEbMANRDJVWBKUFagLcXQfdZGPeTOCSYH,RAAADAAA..VAEAKACAFAEALAHB..QBGAZCCAeDABCDGDHCCAhAHA.EDFFAAAAJECABBBDhAIA.aECC..XEGAhADAGEGA.OHCASGFDIGGA.hBAA......hCAA...,1,-14,-26,12
VdeJHGUgMXNWATEIZKSbFaRQDOfCPYcBL,EAAAZAAASACEFACD.RAEF.QAEA.OAGFCAGBPBHDhABABCDALDDAhAIAeCHHHDEBGEGAMEAAXGCAhCAAAAIBTGDAKGFDaGGADCCB.....hAAA......hAEA...,2,-15,-9,6
IBJTWRGZVHFPdSKgULaYbMcOQCEfDeXAN,BAAATAAARACAZAFB.HCAAdACAKAEALBHBaAGA...MCEBQBGDhAAAEEGB.eCDFhAEAAACAIFAAGCEAFDHHhCAASFCBgGFAbFEDCGGD...DIAA.hDAA......hDBA...,1,-8,-11,3
TGSeYAQMHWXbaDNRVEBIFgfPLcJUZOdKC,HAAAXAAAaACARAEFBADA..FAGA..fAFALCCBUCGAhAAAdAHACCDAGCFAeEDHAFFAMFHBhCAADDAAEEEB.gFAAhAAAcGDD.ODHD.SFDDhABA.YHDGhADA...,1,-7,-22,15
XOLKEPVQGJDebcdZCNaBRFUgAfMWHIYTS,MAAAHAAATAEA.OAGDEADAQAFAGCABeCHHdBBAZCEAhAIAaDEDREABFDCD.ABHAfEEAhBAAIGDASFGAhAAALFGBKGEA........hCAA......hCBA...,2,-17,6,23
YVOSTKRLNbUCXZdFHaPIQJEWMDBgefcAG,GAAAOAAAKADARADALAGB.UCDBZAFBHCCB.aAHDQEABhAAAEBBBDDHB.eCHHhACAADIBSEFBbEFD.hADAdFAAFEEHJFCFMFIBfFHAcGCA...hAEAYFFF..hAFA...,1,9,-25,34
DHRbaJTPUCESdOWgKILXYNFcfQeABMVGZ,MAAAZAAAHAEARACA.aAGA..TAGACCAA.EBBBdCCD.OCFCKCEALDHBhAFA.XDDChAGAFEAAQEEAhABAAECBGGCBbEGD.JHCASEFA.IHHAhAIA....hBAA...,2,-17,-10,7
QRLaPXDSJHYdVEgNIbGKeMFOcWZUCTBfA,RAAAaAAADADAHACB.dAEBEAFA....gAGHIBHAGBDAhAAAeBBDMBFBFCGHOCCHhABAZDFBTEDABEHAACIBLEHBhBAASFCHYHFAbFED..KGGA.hCAA......hDAA...,2,-17,-1,16
VeYSEQFbPRcZOIWgaHUCdNBXKLfDGMJTA,eAAAEAAAFACDRADAZAGB..OAEA..gCCBHBDBdBFDXCGAhAAALCFDGEAAhAAAMEFBAAIB.SCHHhABAQEGCbFGDIHHAaGEA.....hAEA......hAGA...,1,-7,-12,5
CeKBdTbQUYWgERfFLAOIZSNXaDcGVHPJM,ZAAAXAAAaACA.GADAHAEBMAHB.eCCBdAFBbBFD.QDAAhAAAUDGB.gEGAhABAREDFLHFAAADBSAHHhCAADAIBPGACKFGATFDA.EGHF.OHDEhCBA....hDAA...,2,-1,1,2
JHVCSNKDOeFbgUXRZaAQMBcEYWLfdIPGT,MAAAEAAALADAdAEAGAGAHAGB.CBCDKCDAeBBA.FDDAUDGBZEFEAAGBQEAAhAAABGDA..hAEA...cEEChAFAfGGAIGHA.......hAIA......hBAA...,2,-35,-8,27
VHceEgCMISOUNfDRGKWBTLYbJPXZdAaQF,aAAAQAAAHACBEAEAMADA..OAGDUBDADAHBRCEBGEAABBFALDGBhAAAJDHBZGDAAAIB.FDCHhAIAeBBDCEEA..SFHHhBCA.KGEA.......hAEA......hBAA...,1,-5,-24,19
gIePLNRHQJDSaKECZMAXUfWGFcObBVdYT,XAAAUAAAGADAFADA.OAFABAGAdCDA..TCFAeAHHLCFBhAAAHDAAQEFBhADASDBBEFBAZGBEADFBfDHAhABAcFGD.bGAA.....gFGAhAGANICB..hBDA...,2,-25,10,35
BcDaZAGdIRUXOQEYJWKeCfNMPSLHbTFVg,dAAARAAAOADAEADA..JAFBeAGF..CAHA.MAIBLCCBHBDBTDGAhAAAFCGDBDAA.DCEBACCAGFCBhABA.XGFAhCAAQFEAKHCA.fEHA.SHAAhACA..hADA...,2,-43,1,44
cLKZgeVFGTaNWOfSEDBbJUQAdYPXRIMCH,dAAAXAAARADA..MAHBHADALCCAZAGBeCDAGCFAaCHDODABhAAAEDABBEEDUEEAAAIB.IFHAhABAKEHBFGAA.TGAAhADA..fGHEDDCB....hACA......hADA...,2,-23,3,26
gYOFIaZCeRbfJUWTPcGABHELMKDVNXQdS,HAAAEAAALADAMACADAGA..XAGDdBEASBGAOBCBaCFChAAAeCCBRDDB...bDGBfDHAhAEAUEEA.TFAAhAFAGGBBAAIBKFGDNEIA.YFHB.FGEDhCAA......hCBA...,2,-3,-3,0
TRACGVXMDZLfBJPEdcNFebQKgHSOaIWUY,GAAAMAAAZABELADABAFA.EAHBdAHAFCDAeCCAQCGCHCFAaEEBhAFAUEAB.REEBAAABXFFAhBAADDDB..fEHAhACAPHBA.cGDCKHEASGHHhBHA..IHHAhAEA...,2,-13,-6,7
YNfebOXFdAKUSgVcHIQJBTLaMPDGWCRZE,SAAAVAAA.HACBQADCBAEAaAFDMAFAGBGARBFAEDDA.hAAA.fDEAhABAeDFAbEFA.FEAA.AAHAKFFAgGBAhAAAIHHATGGADEDBCGEDNIBB....hAEA......hBIA...,2,-10,2,12
JKbCZTAIQVOUDSfFGLaHeNBPEYXgMdRWc,QAAAOAAADAEA.FACEGAGAHAEBeAGBBBBD.ECDB..XBDAhAIAdDGDRFEAJHAAKDBACGHAAAIBUEEAhBAA.LFHBhBDA.aGBA...NIBB.......hBEA......hBGA...,1,-13,-22,9
SJMCRIZgFfGVPdXaLeWEKOcNTQYbBAUHD,HAAASAAAMACARAEAZACBFBHDGAEA.dAGBaCCAeBGHKCFBODDBhAAATEBA...QEFBhAHAbEDDAAAA.DEIBCFFAfGHAhBEA.......hAIA......hCAA...,2,-22,-5,17
OJSGCDXUMEgQfeTBRNFYWILVAcaHPbZKd,HAAAZAAAdAEASACEGAGADCAAMAFA.EBEAQDAA.hAAAeDDARBGBFCCB.IDEAhBIAAAGBaDHDKEFBCEFAXFGAhCAA.fGDABGHANIAB.YHFAhCIA.....hABA...,1,3,-26,29
fVKYGOXNSHQDaIEPJcTbAdZLCRUMegBFW,ZAAARAAAeADEFADA....VAGBGAGA.XBDDHCAAaCEBEDCB.hABA.JDFBTEEA.hACAAAAAdFHALEHBMFCBBGAAhAGAKFDBOGACQGDCDGGB....hAIA......hBIA...,2,-14,-5,9
ACeZMGfQgdEDXVKORLcPNJBbIYTHUFaWS,eAAAGAAAQADAEADADAGA.KAFARBFALCDB..PBHDhAAABDGAIFBAhAAAHCCAaCFDAAHAZFDEMEEBdFHA.OFFAhABANDAA.JHEE........hCAA......hCBA...,1,-11,-15,4
CDMPbOFZIGWcQYNedSAgXTaJHRVEKfUBL,TAAAHAAAEADE.KAFCBACBLBHBMAEAOAHDZCAAGCEA.QGCAhAAAeBDAACCBaCEERGFA.hACAUEBADCCA.FDHHICGAhAIA..cEEA.dGEA.SGHBhAAA.JHBE.hDEA...,2,-7,-1,6
gLHdGNCFefYOZETVIXSbRAJDacBKPMQUW,aAAAKAAAMACA..QADAUAGALBDBHAFAGCCAFCCB.hAAAeCFAOBFHEBBBTEFAhADAXDGASEHBhAHAAFFADFHBBGBAPFEBdHDB.fGHEhAIA......hBAA...,1,1,-27,28
DQBVAGMOaEeZUTXfHRgSNYdLKCWJbFPcI,GAAAaAAAZACB.UADA..TAEAHAFARCFA.SDBHdAGALDEAhAIACDDA.bECCFEFHIFGAhBAABEHAAAABEGHB.eHAAhACAfGDA.YFHBKHEA..hBBA......hBIA...,1,-5,-19,14
FHDeYcWfAJREdGXZabLgUQPKCBVOSITMN,EAAAGAAAZACBLAFAQADAKBEDBAFA.SAGHMCBBHCFAhAAAeBHH..cEEAhAGAAAABRDCAaDAH.UEGBCEHAOHAAhAHATFDADGHBfGHEdHEB...hBCA......hCAA...,2,-10,-1,9
HBacLgVNYFICGdZEQWXfbDKSAeMJTPURO,eAAAMAAA...TADARACAHAFBBAFBaAHFLDDB.VFABhAFAFAHBGCCAZDFA.ECFBhAAAQFFAfCHAhABAKBBDACCBPEFBOHDC.gGCAIECA.hBAAdGHA.....hBHA...,2,-4,1,5
cXFfHDMKRPJgVdbEQNISWaeGULAOBTZCY,TAAAZAAACADB....XAEDHACBMAEARAGB.JAHBdCAA.ECCBQBEChAAA.SCADhACAeDFBGEDAhABAADGBBDHAFDHDKGAAgEEB.bGBAIGHAhACAaFHB....hAGA...,1,0,-19,19
aJZRCNPBgfTEcdLHWMXGIeVQSbAFKDYOU,DAAAOAAAUADAZADB.RAFA.CAFA.BBBD....TBGAECFBdCHAHBBBhAHAMDBBGDEA.hAGAeDGBQEEChAIAAAIBKGGDaEDBPDCB.fFHA.LHDAhBAA...hBAA...,2,-28,-7,21
PUYQOIKDCVXLMaGNcBWJbHfeERSZAdFTg,dAAATAAAUADA..QACCKAFADAIB.XAEBLCGBGAGAhAAABCBA.JCDBHDBCEEFBRFDBhAIAADGBFFDD..gFGHhBGAOFFB..CGHA..aHAA....hACA......hAHA...,2,-32,2,34
UcEXNOYVeMAIRCbaKPHQLZdSDBgGWJfFT,RAAAaAAAHADBZACB.dAFBBAEAGBFA..JAGBTDAA..ECEBOAHDhAAAeBHH.ACCBbEEDQEEBhAGA.LFCBhAIADDDBfGGBFEHDXGGCNIEB.MBBBhBAA......hCAA...,1,1,-19,20
TVZPFYJBOdLcMeNDKHGgUWbERXfCIaASQ,TAAAZAAAFADABAGA.LCABeACEKAFCHCCCGBGA.gBDGhAAAUCFAEEHFRFFBCCCDAAIB.hABA.QGAAhACA..PEEB.OFHDdHDBMAIBDGCBXGFDhCAA..hCGA...,2,-19,-1,18
ZVSdbEDJcWFOXgMKeTRaHYGIPLfQNUBCA,ZAAAdAAAEADADACA...JAFBFAED.OAGB..MAHBeAHHRCAAHDCChACAGDDALEGBhADA.QGDAhAIABCCDADIBbFGBWFHHKHAAaGED.......hBAA......hBCA...,2,-26,-15,11
TaGQEVAbKUPNcIZWFODYCRLSfXdeHgMBJ,KAAAUAAA....PACAIADA.ZAEBOAFCDAHB.RCCALCFBhAAASBGDdCHAHDCAhAIAMEEBBDHA.aEFDhBAAEFGAABIB.NIAB.FFHBfGHA...hBCA......hCDA...,1,-19,-31,12
ZBEIPeAfMFKXdLJbSWGcDQUNgHOTVaYCR,MAAAXAAAdAEALAGB..bACDGBBAQAEAUEDAHFFBhAIATAGAaCHDRDEAEEAAhAAAeEBDACIBKECA.SEGAhABADFIBNIBB.OHDA.CGGB....hBAA......hBBA...,2,-8,1,9
ZVfXUCYcNbARHKWSGJePQETdMgBaDOFIL,HAAASAAAeACEEAFEdADABAFADAIB.FAHBZCCA...XCFBhAAACCCD..NCFARDGBGDGAhAHA.QECAhCAAMDBBaEDBOFAH.IHHAfFFEhCDAUGCB.....hCEA...,1,-7,-22,15
DAYJQFRUCIgPBaEVLMXdWSGHKTcfNebZO,QAAARAAACADB...IADABAFAEAHBMAFAdCCAGCFAhAAAHBDCTCGA.fDDAhAAAeCHBZCDBAFAAFEFBPFHBhABAaBGALFHB.SGGFhBCAcFADOFFH.DIAA.hCAA...,1,-6,-13,7
JYGHgWIXTNLORaSBCfKFdVMZQcEUDPeAb,JAAAHAAA...gADBXADBLAGBRAGBBCAD..KCCAdCCAhAIAZDEBEBFFDDIBABIBGEDAhBAATFAA.ODHD.hAAAaFBBfFHEFGFD.MHEA...hBFA......hCAA...,2,-18,-13,5
WUZTNLbVKAXcOGaEdgDeHQPSCJYRMfFIB,OAAAEAAAdADA.DAEAHAFA.QCBCCAGA.RCFAFDEHBBBDZEGBTBDAhAIALFAAKBHBACGB.hAAAGDBAeHAASGFDhAFAMDHB..fDDE.IFFAhBAA.NEIAbGEChBDA...,2,-43,7,50
DGLUOgRNaMSFZefTVBXcdCAYWKbEPJHQI,KAAAEAAAHACAQACCGAFALAEBOAHFRCCAaAGAFDHH..eBGBhAAATEAABDDD.dEFAAAEAbEEDhAAAIFHA.DCIBhBHAgGGBMECBZGDA.fHAB.hCAA......hCBA...,2,-13,12,25
SADFLcQEJYVNeTPHgMIbOdfBZKWUCRXaG,LAAAEAAA.VAEAeACA.HAFA.MCCAbCAA.dCHAZCEAKDAACAHB.hABARDDAGGDBACAA.FFFAhAAAQEAAJHAA.hADATEEA.gGEA.fHGFhACA.BCHBhAEA...,2,-21,-2,19
FPaXgVZWHNGYBARTELeMJDSCQKIObdcUf,EAAAeAAADADAQADA.OAFCdAGAfBCAaCCB..hAAAXCFAZBDBHDFAGDDAhAAAAAIBRFCAMCBBCFGAbGFAFFHBhBCAgGCDNICB.BHAA....hABA......hAHA...,2,-10,-6,4
EYDURPZBCedOMSJFcALgVaIKNTfbXHQGW,LAAAaAAA.KAEATADA..bAGBHAFBGCAAEAHBDBBBRCCAZCFFhABAeCCB.dDHAMBIBhACAFDAHAEEAVFEB.IHHAhAEAXEFD.QFDA.YHEGhADABEEC.SFAAhAFA.,1,-1,-13,12
CGWDaUeMJKFBbPfQVgATNEHLYRdSZOXIc,EAAAHAAARACA.ZADB.XAFACAFBGAGA.DCCBeBHH.MCABFCFHBDAAhAAA..bCEDQECAhADAACCATFGALGAAhAAAdFFAODHDIGEAaHGE.....hAIA......hBIA...,2,-21,4,25
MLDUCWgKdbIVeQZESFRTGAfXOaNYPBHJc,OAAAaAAA....PADAHADAMAFALAHBCBBDKBGAdBBD.VCDAhBAAeCDB.ECFBREFAABGAXDGDhBAABGCADGEBgFFGhBIA..IGHA...hCAA......hDAA...,2,-23,-23,0
cDdUHCWbfaLOZXYFTVGBQERINSgKAJeMP,eAAAMAAADAEAHADA.CAGB.....bAEAaAHDZBBAFCCB.GCFAhAAAECFBRDBA.SDEDhABA.ACFBJEHBdDHAfEFEhAIALFAAOHDATGCA.BGHA..hBAA......hBCA...,1,-1,-28,27
SRAQfdgTYBFcKUPLHEJVZWDONXGIMCabe,dAAATAAAFADAKAGA..LACBHCACECFAZAEA.OBHDGDGAMAFAhAAAaDEC.eCEB.ACFAQEGChCAAfECABFFDhACAPGDC..WGAADGIB...NIAB..hCCA......hDAA...,2,-15,-11,4
BDHUZMPKaTOSVEdQNFLeWIgXfYCRJAcGb,GAAADAAAHABCZADAMAEAaAFA...OAHDEBHFdCDAQBEAhBAALDFAeEAB.IFCAhAAAfCCE.RDFAAEEBhBHAbFFABFFDKGDASHFAFFHBXGCA..hCAA......hCBA...,1,2,-15,17
MRTGOdaZDLJHYAPbBXfUSKeNgCWIEVFcQ,BAAAXAAASACAKADA..eAFECAFAEAHBFBFD...MCDBhAAARCAAGCEAaCEH.ZCGFLCHBhABAHECBAACAbFABfDAAhADAUGGA.gEFF.IGHAhAIA....hCAA...,1,-6,-26,20
eIEZRQOVDWJKfPgGHcFbYXMABLTdSaNCU,TAAAaAAA..CADAUAFAEACEZAEB..RCCA.QAGADAIB.KCCBhAAA..fDAAhADAGCFAHEAAFDFDXEGDhBAAADHAdFHAeEEB..OEEH.VFBB.hAEA..WHDA..hBBA...,1,6,-31,37
PWOdNAMRQHZBSIbDKEXcCYeaTJLFVGUgf,RAAAHAAAZADBBAFASACE.DAFAEAHBCAHA.eCCD..aBDETCFAhAAALCGB.GDDAhAAAfDAAOCCBADIBMEEBhABAQGBAKFCDXFFAcFGD.FHEE.hBGA......hCAA...,1,-11,-14,3
CTIMLcNeDUdORafXBGYAKSJWZPFQbEgVH,SAAAZAAAQAEAEADA.HAGD.TCAAMAGBLAHBhAAA.eBEFdDDAREGBaCCBBEADhABAABHBKDABPFEDFDFHbEGDhABACECCNIABDDDB..........hADA......hCAA...,2,-15,-3,12
WBGAdPgIbKQDCZSEUcJTORMaNFfLeYHVX,dAAA..gAAAKADAQAFCZADAEAGEUCCA..TCCAhAAARCFAMDABaCED.FCGDeEFAhACAHEAA.XEGAhABABAHBAFEBIGGACFFDSGHD.....hADA......hBAA...,2,-31,5,36
McaGZeRIPDQFdEHCTgLJBUNYKWAbOXSVf,XAAASAAA.MADAGADA.RAFADCHBdAHAHBCA.TCFAhAAALDAABDEDUEGBhAAAKDHBABEAbFAAOFFB.hABAfGBAZFDBIHGAFGHB.....hABA......hBGA...,1,-6,-19,13
fcUIBEWHPLANZRKCSaYOQdVMgbeJDFXGT,RAAASAAAOADA.dADAMAHB..eAFAFBDDGCEATCEAUCGAhAAAEDHFHGBAAAFAZDBAaCCHQFFAhABA..hBDAbGFADFIB..........hBIA......hCAA...,1,-9,-18,9
HRUGVafOcZWEJbSDdCKMIeQPgXYNFBATL,HAAARAAAGADAaACAOAEDZAFA..ECCBSAGAdCGAMDABeDFDhAAAQCCC.XCFDhAAAFEHDAAHATGAALCHBhAGAVGDAfEEE.cGFB.hABAJHAACHHA.IHHAhAHA...,2,-10,6,16
LFXTdPEJNfWcGOeaKQgDRAYbMZHSCBIUV,MAAAHAAABADBUAEALAHBTAFA.dBBAEBHF...JCAFfDCAhBAAGCCAeCFBaDFB.hBDAQFABREDB.hBEAAAHAZEGBCBGBFFHBXFECPHEC.WFHH..hAAA......hACA...,2,-13,0,13
JUPRLDdYECbacNMHSAXWOBQgFZfKIGVeT,OAAAQAAAZADBKAFAGACB.eAFEUCFARCDAdCGA..EBBBaDAAhAAAMAIBHFEA.ACIBBEHAhADAFDBH.fGHAhAIATFDALFFB.CFHA......hCAA......hCDA...,2,-24,-1,23
HBCWQUYecKLMfXRJgOEFAVNZIDdGTPabS,ZAAAdAAAGADAaACA.HAFACAFA.QCBDeAGHLCCAMCHBREFBOBHDhABAAADB..IFAAhACATECA.SFDBhAFABEEBUFGAKHAAXFAC.EGEANDIADGDBhAHA......hAIA...,2,-11,-2,9
gHZFdbYTaLNWJRQBSKVXceOfPDIUCEAMG,GAAAHAAAdADA.TAFAaADALAGB.JCDBRCAAQCEDhAAABBFAKDHB.XDGDhACAeDBHOEFBDAIBCFAAADIBMIAAhAAAZFEAFHAA..YHFGSGHH..hAFAfFDA.hAHA...,2,-16,-2,14
ALPIWXNCgQObTRGfEBHJMSUZFcdKYeDaV,LAAA..IAAAXADDCACAQAEATAFA.RAGBECAAhACAHCAA.MAIBZCDAdEAAhAEAeCGFaDHDADEAPEEBhABANECA.bFAAGEEABFHASGGDhACAFGHB.KHAA.DFAA..hAFA...,1,-1,-2,1
FVaMYRgNCPeZTAcQLdUGSWHXEDIBfKJOb,LAAAGAAAHADAEAEABAGAKAGCOBHD.FCDHaAHDRCFB.CCAAeCCAhABAAAABdFAA..UFCA..hACAXCFDDFFB.fEAAhACAJHFE.bEEC.MDIB.gGGBhAEA.PHDAhCAA..,1,-8,-15,7
KeBMFQXPAHbUGDNYTIWgVcJCadLZROfSE,HAAAGAAADACA..TADAIAFA..gAFBVBDBCAHALCGBhAAARCDASAHBhAAAEDFFBFHAMDAB.QDGAhACAACCBNHAB.cDCCaGGC.ZFEB.KGGA.hAHA......hCAA...,2,-23,9,32
WeCJgVXKFaMIPSLZQbDARBTfHEdGYcONU,RAAATAAAHADBEAFA.GBGAOACA.UAGAeCCBCBDD.JDAB..XBEDhAAAaEEA.MCCBhBGASEHHZDDADDHBADIBdGCAhAAA.cFFC..gFFG.hABA......hADA...,1,-4,-21,17
QZgATdUYLSKXDBGRfVbCEINMPaeWFJHOc,dAAALAAAKADABAFBRADF..VAGBEAHB...MCABeCAA.FCEAHCEBhABA.QEGAhACAACHBTDDA.SCCDhAFAGEGACFFC.IGAA.aGDA....hAGA......hAIA...,2,-34,-9,25
FXgTDWbCfMRNceSdQHYPVGIEBLKAOJaZU,aAAAZAAAFADA..TADADAGA..CBFA.RAFFeAHHdBHAHCAA..PBBBhADAGDEABDCAACEBOEGDhABAXDFC.bEDDhAFAMEIB..SFGA.YHAAhAHAEGDB.KHFA..hBAA...,1,-16,-25,9
LRNEMZUJPAKbVHgTfCBYaFDXWeSQGcdIO,KAAAHAAA.TAEABACBaADDDACA...eAFAGAGA.dCCALCCAhAAAEDFBZFFAUGAAAAFAVCGBhBIACEDAXGDC.hCAASHFAQEEC.OFHD.RGCE.hCBA......hCGA...,2,-22,3,25
EKaAdYTVIHCULPRfBSQeWFcZgDNbMGJOX,dAAATAAAHADA.LAGBRACFBAEB.eCAAFAGAZCDBDAIBMCFBGBFAODDBhACAECAB..ACHA.IEGAhADACDHAUFFBSGHHhAAAQFAAgFGA.NIDB..hACA......hDCA...,1,1,-17,18
eYGaLXgZMBRICSAdVJfFKDTOPHNUcbWEQ,dAAAVAAAFADA.DAGAOADA..HBECUBEB..bABDEAHBeBHHhBAAaCDH.LDEBZDFARFFA.hAAASEHHACHB.hAIAKGFANIDB...WHBA......hBDA......hBHA...,2,-21,-20,1
EPGICMcdLDSXKAbUYFBZHOQWTaJfNeRgV,UAAABAAAHACAQADAaAEA...JAFEeAGHRCBA.ECAAGCFAhADAMAIBdCEALCHBDDDBKDGAhAAAAEEBFFDHZFFA.OFFHhBAAfHFB.........hBCA......hBIA...,2,-14,-13,1
eZOTARYBabFKCcNGHLUQfVPSXEJWdMgDI,RAAAaAAAKADC..CADAGAEAHAFALCCA.QCGAfAGBhADASECAEBBBdCHAMDDBhAIADEGBeFEFZEEAAFIBbGBAhBAAFFHB.....cGGC....hBGA......hCAA...,2,-15,-12,3
AOUgXRQIFPTaCLBEWHVfSdKZGcbMJDNYe,OAAAXAAARADA.FADA..aAGALAGB.EBDBHBFC.SBBDhAEAZCEBbEGBMAIBhAAADDDAeDFFADDB.QEGAhBAATGBABGFAfGGE...hABA......hBGA...,1,-16,-17,1
WNRZcaCYGFOeBLEMIQdfKSXPVUJAbgTDH,TAAAHAAARADFZAFB.CAHA.GACA.eAEAECABMCCBdBHASCADhAAA.XCEAhACAPCHBUEEAAEEAbEFADFAAhAEANDDA.aFCDOFABLHEAfFHA.hAFA......hAIA...,1,4,-10,14
fIgWHdcESJCXLNRUMBTGZAeVOabQYFDPK,eAAAaAAA.QADADADAKAFA...fAFF.IBHAhAAAHBBCEBHF.CCEALEBAhAHARCCBMCGBGEGAhABAACGBbEGBFFEDgFDA.WHDASGFHhAIA.....hAIA...,1,-11,-24,13
gVHIWbFOUEJfKNTQcZMSGCeXAdPRaBYDL,RAAAaAAADADALADAHAEC....ICCAbAGD.OAHDEBBBKCEBhAEAQCECZECAGEGAhAFAeDGFAAIBdGCABEDDgGEGhBAAFEHDfHAB.....hCAA......hCDA...,2,-12,-5,7
PVGeJNDbOESAFIKUMdcTHRaCWXfgQLZBY,KAAAdAAAHADARACF.aAFACAEB.....fBHALAGBZCAFBCBAhACAVDEBeCEF.DCGBEDHFhAAAADABFDCD.UFFAMEDBhACA...TGGAWDHH.XGBD.hADA......hAIA...,1,-20,-22,2
HbVJDFCRGcBTXWfESOZgPANQMUaeKYLdI,MAAAeAAALAEAHACCJAFA.CBCAGCDABBBD...TCFAXCDAhAIAEDHFZFAAACGAQDGAhBAAaAHDdFFA.IFFAhCAADFIB.RGDE..fDCE.SHGAhCDA...hAAA...,1,-7,-13,6
VgWaABSCELTOdDNHKJMQcZYFUGRbXPIfe,CAAAEAAALACAdADAHAFAKAGAMBCB..ZCCAFCFHRCGB...XDDDhAAA..fDAAhAAAeCHBgFAAhAFAAADATECADDBBQFFCUGFA.bGAC.IHHAhAGAaHAEBEGASGEDhAIA.,2,-28,7,35
HZOcELRFSYDAeGfTCdaVgKQPUIBNXbMJW,eAAAGAAACADA.aADAKAFAUAGA..BAHB..bCDBMCCA.HCEChAAAZDBBEDFAREEBFDHDDDIBACHA.hABAdFDD.QGFAhAAA.NIBB.XFAA.ODDB.hACASGHB.hBAA...,2,-22,-6,16
JDFgBaCfQSdLGHNXbPYIZEcRAKWMUVTeO,MAAATAAA..eACADACABAEACAFA.QAGAdAHAHCCAbCFD.hAAA.ICCAZFCAEDHBABBBhBAAKCEA.VDGBFGGAaHBAhBHALECA.GGAB.XGGAhAGA......hBDA...,1,-6,-16,10
YJGgHNCdfFKPTQSXVBRaIWMUecEZLADbO,OAAAGAAAHADAdAEAKAGATBGA.QCDBXBBARCEAaAGA.hAGAMDABeCHHZDFEAEBADEEBhAIAbFAD....gFGAhAAAfFFASGDABGHAIHCAhBAAWHFA.cEBD..hBBA...,2,-35,21,56
AEQCbGVWMPXKBZHTILcYRSJFeDONaUgdf,EAAAQAAAGACAMAEAKACAHAEB.TAGALBEB.RBGBFCBHhAAAeCDBODFDaCGEdEAAAAIBCEHAhBCAbEGB...PFEDhAAAZGBAIGHASGAA.DGGB.NIAB..hBGA......hCAA...,2,-10,15,25
HDOdULeXBaEZYKWfVcgJCRAQPbGFNTMIS,QAAAGAAAFADAMAGBHACAdAFA.eAHBaAHBZCDBKCDA..fCGAhAAAVDGB.JEAAAAAB.hACA...bDBDTEEAhAEADBIBOFEDLEHBEGGB.YHFA.hBCA......hBDA...,1,5,-12,17
HTPDXAEcZdBMeLKfJIbVFRgYQGCUSaWNO,EAAAdAAAeADALADAKAGA...JAHB..bABDRCBAQDEAhAAA.GEAASCEAhADAaDGEOECFHCGBTEAAhAEAXFGAACEAZEEFfHFBFGGA...hAIA......hBAA...,1,-1,-14,13
VLUfZEbQSOCNYHXTDMRJBAdPKIGFecaWg,dAAAKAAAGACAeADA..aAGDVAEALCCAZCAF.ECHFQCGAhAAA.CAHBHEDATDAAhACARFGBAEABFDFD.gECAhADAfGEAbFGD.SGBD..hAEA......hAIA...,2,-8,-4,4
ebadKBUYcgZGVDORHNSMfITAPFQXCWJLE,QAAACAAALACA.EACAeAFH..dAFABAHAUDCA..gCCAhAAAGBGAOEBHhAAAHCGBMDABTFEAACCAXEEChADAWEHH.aFGEYHAGZGDADHAA.SAHBhBEAIHHA...hAEA...,1,-4,-16,12
EaSgbXTKGCYPNUMDWJFeHQOdfBZAcIVRL,VAAAEAAA..aACD..SADB..bADDTAFAGAFAhAAACAHB.PCBBMCDBDCFBhAAAFAHFHDGBdCHAZEEAAAFBREEBLFABhAFAKGHBNIDB.UGDA.eFHH...hBCA......hCAA...,2,1,1,0
HBAcMCbdUfaWgKGQeVRNIXEZPDLOSFJYT,MAAAdAAAaADAKADA.GAFAeAFH..RBGF...XBBCEBDBZDDALEBBhACAFAHF.TFGAhAHAHCDBADHA.bEGDWFFDhAIAQFAA.IFFADDIB.SFDDhAFABCBA...hBAA...,1,-6,-14,8
EeZbBcfaVNgXTGCKUSHWDdPJYLAOMRIFQ,RAAAQAAAEADE.eACAZAFBBAHA.aCCAgAFA.hAAAGCDAKCHBHEEAdCHAPDAAhAAALFAAAAIBMDGBhADAbGEA.fFHA.XGAAhAGACDDDSHCGDFDBOFFHhCAA...,2,-16,0,16
IWYGSBZdefEcVbMAaNCXOTDKLRJUHFPQg,aAAAXAAA.DADARACFHAEB.QAGAIAGA.GDEBhAEAZBCBeAHHEEDBVFGBAAAAOBEDhCAATGAALEEAhCBAFHDAWBBDBFHA.dGCA.bGEC.....hAGA......hBAA...,1,7,-11,18
WgNJRELAbHcZFXdVfMOCDQISGaKYUTBPe,HAAAZAAAdAEAMACADAGA.QAFAGBFAKBHBTBDA..eCABhABAgCGARDDBLEHBhACAAAIBbDEDFHBA..fCCEhAAACCCD.aEHDBFGAPHBA.JHFAXEBDhADA...hBHA...,1,0,-13,13
TSgGNAYXBCPJWOLUDIFbdEfHQVeaRcMKZ,BAAACAAA.JACALACA.DAGAFAFAEBFAHCBA.eAHHRCCAMBIBhAAAZCFF....TECAhAAAGDAAADIB.XDFAhADAOEEDUGGAdFFAQGDA.aHGE.hBCA......hCAA...,2,-25,-10,15
baYXePQdVDSMOICGLcKETJAWNZgfBRFHU,ZAAABAAAHAEAaACA.eAHHdAFA.DACA..MAHBCCCDGCFALBCBEECA.hABAAAIB....gDFBhAAARFDBbFGD.XECAhBFAQGAA..OEHD.KFFD.hAGA......hAHA...,1,-5,-26,21
WDBcFEOVPdLCRUGQKJHeYaNbfZTXMAgIS,SAAABAAAEACA.OACDdAFARBDBGBGA.KCAAHAEA.eAHHhAAAaAHF.bCDDZEFFMCGBhABAADDB.IEAADEIBFFBA.hAAALEHB.QGAA.YHFAhAEA...hACA...,1,7,-27,34
KDYHCVGWQAZgBFNJXOcIEaPLbefTMURdS,ZAAAFAAA.JADAOACD..EAGEaAEALCAB..eAGHMCCBhABARCDFdDHADCGAHDDAGEBAhAIAADFABDHAXFEAIFFAhACAfHEB..TFCA.KFHBhAIACBEB.WHDA...hBAA...,1,-13,-20,7
VcLUfaFRXEeBSbNYZTHQdKOPgGDIWCAMJ,MAAAVAAA.LAEA.UBBAaADARAFFEBHFeAHH.BBDA..hAAAbCEBZDDAHEDBdEHAOFDBhAHAgFAADFFBCGGDAAFAfDHAhAIA.SFHH.hCAA......hDAA...,1,-2,-23,21
cPXTVRMAgLfNGICZOEDHQKYbBSedFJUaW,LAAAGAAAZADAEAEAHBGBKAGA.BAHB.eCDBdCAAFCCAUEABaCED.hAAA...PDFBhACATCGARFCFAEIB..fEFAhABACFHDDGGB.bEAASGAHJEHB..hAEAXGCA.MIAAhACAIHHA.,2,-9,0,9
JHgMEPIGRSZfFAVQKOCecWbDTXaLUBNdY,QAAACAAA.eACAbACA.DAGA..aAGALBFABBGAdCAAHCDAhAAAECCA.GDAAZCFEAADAKEDAhAAAODFE.TFFAhADAXEGAYFHBMGBARGEAFHBE.cDCChBGA......hBHA...,1,4,-18,22
UBQVGJcOaSfLXPYTHdbMeZIgFKCRDAWNE,EAAAQAAAGACAOAEAaACE..LAFAXBEDTCDAhAAAHBGDdEBAeCFEZEEAFDAARGEAAAIBhAAAUEFABCBDVGAA.hBCASFHB.fGDB.hBEA......hCAA...,2,-5,6,11
PGbLYeJZCRHUEgNIdcOTKFAVSBWMafQDX,BAAAaAAA.QACADADAGAEBLAFA.eCABZBBAHCEBhAHAECCB.gDBAhAIAdCFATEDAACHASDGBhBAAMCHBXEBDbGFACFGDRGFAIHAA...hBDA......hCAA...,1,-1,-13,12
ERAMTOJfPZeWdgQbUKYXVGSLNcaBDFICH,MAAATAAA..OACEJACA.ZAFBdAFAQCCAKAHB..XCCAhAAAGCGALFAAhAFAaCFEFDHD.HFEBACCAeEFBhAHAWBBD..gGEDYHBA...hAIA......hBAA...,1,-12,-22,10
DFGaJgVdWeObSNPCXIEURLBYHQcZfKTAM,MAAAGAAA.aADAVADAdAGA....eBHHSAGBCCDA.EBBBhAIARCEFLFGBHCECZEEAKDCBhBAAAAABFDCHJHEAOGBAhACANBIA............hAIA......hBCA...,1,-12,-18,6
AYNZVPTgdEIOCDGRQJUeKXbSaFfHBLMcW,ZAAATAAAEADE..CAFB.RACFUAEA..eAGHKAGA.SBHHhABAFCAHHCFCMDEBACAA..VCDBhACAdFFADEIBGEGA.hAAAQFCCbFGD.aFFB.....hACA......hAIA...,1,-9,-15,6
IYcPWTUFLKOGAZgCbBXMfeDEQSdNJRHVa,ZAAACAAABACAMACA.DAGAEAEA..dBEARAGBHCAA..aBGA..ICEAhAAA..PCCBhABATDFALCGBhCAAGEABAAIBbEEBeDHHQGGASFFD.hCBA......hCEA...,2,-26,-15,11
OKebBIVTgCEDMAcSYXLfUPZNHaGQdWFRJ,SAAALAAAUAEAZACBHAEAGBGAdAHARCAAKDEAeCEB.BCGD.hABATEGAEEBAAAHAXFFChACA..fGAAhAAAaGBAFGHD.bGEC.......hBEA......hBGA...,1,-10,-17,7
YfPBKcGAaTIgVONJMUWREQCLHDebXSdFZ,aAAATAAA..VADAOACA..MAHBRAFAEBDBLCCBHCEBeCCBhAAASBBDZCGBfFHAhAGAKDADAAIB.gGDAhAIAUDGBQFDADGGB.dGAA.FFGD.hCAABGCD....hADA...,2,-12,11,23
OHNGJWYMceTESBCDfbIURAQdPLXZgFaKV,dAAALAAAZABBFADDaADD..OAFAHAFAGCAA.JCFFMBFBhBAAeCCBEBGBCCHA..DEEBIDDAhBIAAAHA.QDGBhCIAXFFAKHCAVFFBYFAF.SEHBhABA..hACA...,2,-19,-13,6
KTXCLeRgUbHSOFGIAPEBcdaYWQJVDfZNM,EAAAdAAAaADA..QACADAGAZBDA.MAFAKBGC.CBEB.RCAA..UDFBhACAHBFB.FBHFACIBBEBAhBAAcCCC...YEFFhAAAVGFA...TEGAeEDB....hCAA......hCBA...,1,-22,-26,4
bBAMGTfHZUDgdCVNIcPOXKLWYFEJaQSeR,GAAAHAAAZADBDADAdAGACAFA...IDAAOAGDLCDBFCFH.hAAAECFBaBHD.eCCDRDBFAAABMAIBhACATEGA.fEEEhACAVEGB.PFBBKFEB.....hBCA......hBDA...,2,-17,-3,14
fCYAJdETNKZPXGMIFSDcURWeLBgaQHObV,EAAATAAAZACBGAEA.FAGADACA.RADAeAGHLCBDBCCAaCGDHCEBhAAA.OBHDVEDBCFHAhAAAAEDBdFGAKGBA.MFIBSGFHhBCAUGAA..WHEG.....hBEA......hBGA...,2,-12,-7,5
CIOdUYMXTVPHKaFSNEfWGQAbRJcDZgBLe,RAAADAAAZADBLADA.eAGHOAFC.dCCCMAIB..TCFAhAAAHBBAaCEDFDABEDHFGDGAhAEA.ADDAJFAABEEACFFD.hAFAIFCAXGECKFGD.SFHHhABA.fHABhADA.WHCE.,2,-20,-7,13
ZVHLcNJRGKDWeMdPSBfgQFETXCUAYOIab,OAAAaAAAZACB.HADALAFAJAHB.GCEADAFA.eCGBdCCABCFAhBAAQEBAEDHF.TGAAhAGACEDAABBB...bGFAVFEAhCAA..NICBKBBDMFCB......hCFA......hDAA...,2,-26,8,34
NdMBDYCKRISPHbQZUETagVLfAFXWeOJGc,XAAAeAAAGADAdADABAFACAFA..RAGFSCCDHAGBZDBAECFBaCHDhAAALEHB.AAAAOFAAhAFAcDFCMDBBhABAKFEAIHFAQGDA.TGGA..hAFA......hAIA...,1,-11,-12,1
IJRLUGENMcWAQKCPDXBdTbVYgHOeFZSaf,QAAACAAADACA.dADA..TAEAVAFAHCDCeAGHZBCF..hAAAaCHDJCHBRDBBGEEBhAAA.EFABMCCBAGHAKHDABDFDhAGA.bFFA.........hAFA......hAIA...,1,-1,-32,31
OYFZPcVfHBRbXUESaLWDdQgJeGNIKMATC,TAAAOAAAZADB..VADAHAFA.RCEFUEGAEAGELCAAdBBD.hAHAQCFAeHCAICHAhAIAACIBFDEH..fEHAhAAABHHA.bGFA.aHDC.DIAA...hBAA......hCAA...,1,1,-19,20
JICGdRXBMTUDEgONVPQYAeLHFSWKZafcb,HAAASAAAZADBaAFD....bACDCAHARCFAMAEADCAB...EAHFOCCHhAAAVCFB..QEBAhAAAAEEAeDAHLEHBhACAKBECfEEEIFFAdFHABHAA...hABA......hCAA...,1,-12,-13,1
UQDFdXgMSPYVeATLJfRHOKCNZabWIBcGE,TAAALAAA.RADFHAFBCACBZADB...bCABBAFA.EAHBQDDBhABAdCCCMCFB.SAHBhACAVCGB.ADHAOEGBhAFAaEEH.IHBAUGGAXGCCPFHDeHEGhBHA.....hAAA...,2,-20,16,36
NDLSEIQPCTMOFRfXYcJKegaHAUBdWbVGZ,dAAAVAAAZABB.LAEAEADE.QCEACAFB.MAIBRAGFXCDAhAAAJDCB.KDCDeCHDhAFAHDFBAEEBBFFA.bGAAhAGADCIB.SEED.IGHAhAIAOFHB.fHEBhCAA...,1,-5,-30,25
ALFWCaUKfHJMBgbDNeZQVGYEcTSORdPIX,LAAACAAAKACA.HADBMAEABAFA.DAHBeAHFZCAAGCFA.hAAAEEEBTBEARFAA.dCAAhACAIFHAACCAaCHDUDEBhBGAfHDBJFFF.NAIA.......hABA......hACA...,1,-13,-27,14
PUGHDXIEJfZQSMNACVYOBbLcWRFKdaeTg,CAAAOAAALACARADA.dAGAeAGH..TCCAUCDBHDGB.XEAAhAEAECEEZDAFMAIBhAAAAAIBBBBD...bGAAFDGDhADAKEEDaEEBGGEBDEABfFFE.SEHHhAEA..hBGA...,2,-24,0,24
IFUMcVHZbTLYONCeEadJQBfAXGKSgRDPW,GAAASAAARADADAGA....IADAMBHBHCDCZAEBbAGDTEFAhAAALCCB.OEEAhAAAeDADEDCBdFFDQGBAhABAABIBKFHBgGCAFGHD.....hAIA......hBGA...,1,-2,-10,8
ecXIZKUYLSJHPdgBGNMQDAVWFObaCERfT,FAAAaAAA.RACF...eACH..XAEBZADBKAFALAHBHAGBdDEAGECAhAIAMBBBACFAODEChBAAEEHBTGEAUFFASGBDhBAAJHCA.BGGBDGDA......hBGA......hBIA...,1,-10,-18,8
YSEBAbFKOLacINVTZGJDRgMXdHUCWfPQe,KAAAaAAA.....IADATADAGAFARAEF.MAIBHAGBCBBD.hADAfCAAeCDBEDHBAAHBhAFAbCCDLFDA.hAAA.cDGC.ZEEFDFHBdGAA.UGGA.hBAA......hCAA...,1,-1,-17,16
DWaTXLgIfCNFMdOcUbeQGAJPEYVBHKRSZ,EAAABAAAHACARACAZAFBaAEALBHB..fAHAFCAA.dCCDhAAAOCEHUCGBeCEHhAHAACHB.PEGDKDADDDDBWFFDhCAA..TFAA.XEGC.hCBACGHAMFFB...hDAA...,1,-8,-27,19
FgNIKXMYbeUEPWRfdaCLDQVHTBSGZOcAJ,FAAA..gAAAKADAMAFA.eADA.EAGARBEAdBHALCCADCCBHDABhADATCGAGDDAZDAAAAAAhADA.IEEAXDGChBAAbFGBUGGA..fGCACHFC.QGEAhAEA..hBIA...,2,-11,-3,8
FEXdNLRJBbePcQOUZTgHGCKfDYISWAVaM,aAAAEAAAdADALADABAFA...eAGHQBGAZBBAHCEBGCBAhAAAfCHADDDASDFHhAFAAAEAMDDBFEHDREGFbFCDOFGHhAIA...........hAHA......hAIA...,1,-4,-17,13
GcVUZTDKdNLCIJefOMSaHgBARbQYXWEFP,RAAAQAAA..XADBEACAGAEAUAGAZAGBKCCAdDCALBFDhAAACDHAeEBDMEEBHDGBADIBhABA..bFFAFEEHPHFChAAA..cGDCDFFA.IHHAfGAEhAGA.....hBIA...,2,-25,14,39
MgPGFNXORAZeIaCVEWdHKQfJTLcDUBYbS,eAAAaAAA.EADAHACBKAFA.QAEA.TAGALAHBDBBBBCHAhAEAbCCAMCGBGDEAhAIAXECAADEBZEGBCGDAdEHA.hBAAfFFE.JHCA.....hCAA......hDAA...,2,-8,-8,0
HFaWfNbeUPKCDTRQdGBLIAEgZOVYSXMJc,EAAAZAAAOACA..SACAMAGBHCCCaAED...fAGAhAAAeAHBKDGATFBAhABARCCBGCGALFEAhAIAAAIBgDABYFHBXFDAFHCE.bGAC.CGGDDFIBhADA.....hBFA...,1,1,-10,11
JQRbFXTNOUEWGVDePYMfgKcdAHaSLBZIC,HAAAaAAALADAZADBCAFARAGF.FAHB....TDAAOBBB.ECDAGDEAhAAAeCFF.MCIBKCHBAAEAhBAABCCCQEGChCAAXEGDNDCA.VFCB.DIAAfGFE.hACA......hADA...,1,-5,-10,5
baRPgGMeQTEOYCBVLdfXcZAISJWDFNKUH,SAAADAAAKACAHAEBRACFGAEA.eAGBEAGACBBDLEAAdCHA.hAEAXDGAACDBJDEFFEGHbEDDhAAA....aFHDMFGBhABA.OHACBGAAfGDAIHHA.hAEA......hAHA...,1,-2,-34,32
LNcRWbZTOCUaBEHXgSYVDeMdFAQIfJPGK,QAAAJAAAGADALAFARACAZAFB..TDAACCCDBCFAHCDB.hADASAHHDCHBeDHHdEFAhAGAADHAfEGAhAAAKGHB.cFACOHAAEFCB.XGEC.hAHA......hBAA...,1,9,-28,37
DTNMPQHOfALUaBgGVSKZEbRYIXdCWFecJ,aAAAGAAA.KADAEADARAFF.....XAFAdAHAFCDBeDADDAIBMBBBhADAHDFCACCA.LFDAhAAABCDASCEHhAGA.bCFDCEEDJFHB..TGGA.PHDChBAA.fDHEhCAA..,1,-15,-16,1
PQBLfcIJbRFeYSKAXTEHWNZUVCaGdDgMO,EAAAHAAAZACBCADBdAFA.DAHBMAFA..QCABLBEAfCHAhAAAJCEF.RDEBeCBDhBCAKCHBAAIB..TEGAhAAAUFBBGGEBODCDBFBD.bGDA...hBFA......hBGA...,1,-7,-16,9
OBEFdTLZIXCQPNaJWVGHfKeADbSYRUMcg,SAAARAAAMADA.OACDEAGA..dBEAZAEACBHA.QCEAhAAA.aAGAVDCBHDGBeCGBhAAAACIBbECBUFGB.BCCChABATFAAXGEDPFFB.....hCAA......hCEA...,1,4,-20,24
XJZEYPGaCeFHAgOScTKQLDRBNWIMUbVfd,SAAATAAA.LADARACFBAEB...IAHAbAFD.dCCAhAAAZCDBECFAGEGA.hABAeAHBHDFCACABOFEDhAAAQEACDIAA.MEEBfHCBXFFC.hACAPFCD.aGHD.hAIA...,1,1,-14,15
PJEKDdZLYgBRNOCXFAVMeUbWQcHaGTIfS,eAAAUAAAQADAHADAGAGA..TAFASCCB.ECEFhAAAdAHAZEFALDAAhADABFAARGAACGDBADFAbDFAaGEDfGGAhABAKEDADFGB..YFHF.OHDChBAA.....hAFA...,1,-3,-5,2
aOFESGcWDTRZQCfBIdHXPgYJKMVLbeANU,aAAAEAAAGACA.DAEARACFZAEB.QAGABAGAHBEB.XBGAhAAAgCGGKCBDMDHBhAIAbEAA.AEEB.UEEASEBHhBCA.TGEAfFHAIHHAhBEAYBBF.LHFAhAEA.,2,-18,-6,12
gbHCJfFWOcZNUXLPERdIQTeMADGKYSBVa,GAAASAAAaADAHAFBCADA.FAHFOAEDZCDFUEGALAGB.hAAARCCBdDAATEBAAAAAKDHBBGFDhACA..VEFB.hBAAJGBAfHDB..NIAB....hBCA......hBDA...,1,-11,-17,6
SfAUVJXODFdQgNRGHBCaeKTbEMZYIcPWL,VAAAOAAA.dAEAQADCRAGB.HAFBaBBCKCFBEAHB..ZDDA.hAGA.IDBAPDHBLFAAhAAAAAIBUEDADDIBFFFHhAFA.NIABCHHAeEHD.bFFD......hBAA......hBDA...,1,9,-26,35
adALbIDXNfPROBgKMTWZEQFcCYeVUSGJH,LAAADAAA.XADDfACA.RADFBAFBMAFAZBFB.EBHFhABAQBGACCAA.hACAeBBDSCCDhBFAHDDCAAHAbEGDIEHAOFCBTEDAFGDD.cFGChCAA.....hBAA...,1,-14,-17,3
YADfUKaWXSFNeGQdCMVBbPcJTIgERLZHO,DAAAKAAA..aACASABA.eADHdAFAMAHBBAFA..bAGDPBCDhAAA..TDEAhAFAECEBRDFFHFBAAAIBUFCAFEHDhAIAGEGACHHA.........hBFA......hBIA...,2,-20,-20,0
fGBECZbWSUTRDaVJcQYNIKHFMXALdPeOg,dAAAeAAAOADAGADABAGAEAFAZBGB..SAHHRDBBDCIB.aBDBhACAVFDA..QCEAhBAAIFAAFGHBACCBLDGBhBCA.fECACHFA.bGFA.hAAA......hABA...,2,-22,-15,7
eKfEbdRGFBHIDJWLUYZaTgNSPCMAOXcVQ,XAAAQAAAKADAEACA..RAFF.GAEAHCDBDAIBLAGBZDAB.hAAAaCDHTDGASCHHhAAAMFDBADABOEBB.hABAeEFFdFFABHAAIGGA.WHFA.gGBHhAIACHGA..hBEA...,2,-10,-7,3
aIcUfCPAXeVHTRJKBEbZLQYFNDWMdgGOS,eAAAHAAARADFBADAEAFEZBFELAFA.QCCAFCAHDCCBdDGAGCEBhAAAaDDC.UEFB.CFCAAAGAhABATGEAKGGD.NDIA.MEIBhCAA.SHCA..fHABhAAA.XGGDhACA..,2,-17,-4,13
NZFbWCMHaTfXgSLIdRVDEYKBGQcAJeUOP,eAAAOAAAZADBFADDCAFA.HAFA..aAGDTCEA..XCEDhAAALCHBRDBBECHFBBBDGGDBhABAAAHAPDDB.bFABhAFAMEIB.SFFEdEGCDFFBKGHB...hAIA......hBDA...,2,-13,-2,11
YJAOVaHRMXCfLUdFIGgWeTBPKZEcDSNbQ,aAAAHAAA.RADFMAFACADALAFAdBGAGCEA.eCABTCCABCCDZCEBhADAEDHFSCGAhAGA.QEGAhAHAABIBXGCAFECHgGFAKBBDDGEAYHCA.hAAA......hACA...,2,-6,-5,1
OcBKGbRfLYFdPZJNCQAHMVWIDeaSTXEUg,HAAAMAAA.VAEADAEA..eAFAaAHD..SCAAEBBAUCDAOBHDhBAAKCEDRDCBLDHB.hBBAdEAAZCFBCEGAAACATEBAhBEAXFEDBEHD.bFDDFHAA......hAAA......hAEA...,1,-3,-13,10
QfMbVIaWecRNGFYZPXLJASTBHdCEDUOgK,TAAAHAAAEADE.OAFAQACC.MAEAbBDA...aAGEeBHFhAAARBEBGCGAZCAALEEBhACAACIBdDDADFFBKEGDfGCAhAAAIFDANDIAFGGH.......hCCA......hDEA...,1,0,-4,4
LFfONaTHcgXeIEPbMCYBdSQAGJZWKRUVD,ZAAARAAADADALADB.OAFAaAEEHAGB..XBFCECCAMCFBhAAABCAAdDGDAAIBGDEBhABAKEDBFFGATFGA.eCCDhACAIHHAbGBASFFD...hABA......hCAA...,1,1,-26,27
NgIDeZdCPEbOQAfVGLBKFMTRSUXcaHYJW,GAAALAAAFADARADFUAFA..aAFDHCAAJAHB.....gCGAhABAeCDBdDFAEDHFhAAAbDED.AECABFHA.MHAAhACAXGFA.YHBAIHHACAHAOEHFhACA....hCAA...,2,-22,-13,9
WaHSGLIACgNEUPOMBfQFKXRbDVJdTecZY,CAAAEAAAUACA..MADABAEAQAGA.KBCARAFFDAIBdBEAeCBBhAAAZCBA..aCGDHDEChBCAGDEAADDBgFFAhBIA.OHDCXGGA.JHAAcGCBhCAASDHHIHHA.hAAA...,2,-38,8,46
ESFKZMHbAdeJBVDINURWTgLGQYfOaPCXc,eAAABAAADACAUAEARADA.....TAGAGAGAQBCAhAAAOBCBCCFD.ECHF.KDEAHDDAhAAAAEIBdFFAVFFA..IGDAhABA.WFGHLGAA...hAIA......hCAA...,1,-21,-25,4
cJQIebXMWUOYNGAZLgFTdPCBHDEfSRKVa,ZAAALAAAFADAdAGABAEAHCAAEAGA..RCEBKCHBaBGE....QCAAhABAeECBMEEBOCDBhACA.GDGAAAIBTFGAhABADCFBSEAD.cEECIGBAhACAbGAAXGEChAEA...,1,-16,-17,1
RWUCacKPLFdeQHgEXAOJMDfTZGSYNVBbI,MAAATAAAGACB..SACBVBGBBAHBRAEACAHBKBBDLCEAhAAAeCDBHFAAECCBAAEADCFBZDFEhCAA...bFGBIFFAhAFAaEEHFGCB.dFHA.XGEC...hCGA......hCIA...,2,-5,-5,0
fLIJOMdSNWVYceQFDUgPBabZRXHCTEGKA,LAAAOAAAdAEASADH..VAGBeAFAQBBBhAGADBIBUCAABCFAZDDAHEBAhAIAEDDBAAFAfDHAhBAA.MFFBYCGBFGDBaGGARFCBTFEA.hBEAKGHB.....hCAA...,2,-12,-4,8
UKZJLgPSfWYDBeCNIEHcGMaVdXAFTbQOR,TAAAQAAA.RACAZAFBLACB.SAEAfAHADAHBhAAAeCDFCCEAECGBHDABGEAAhAEAaCHDdEEAAAIBODHDhAFAKFHBgGEAPECABFFA.IHGAhCAA.MICA...hAAA...,1,3,-5,8
cgeQSaCEXFfGLNBKOdRYIWZHMAUVbTPDJ,VAAATAAA..DADAJACA..eAEA.QBGAaAFAEBFFFBHDGCDAhAAALCCBKDGDRFCBIEEAhAAAHFFCACDB.bEGB.hAIA....gGDA.XGFDhAIANIEB....hCAA...,1,-4,-22,18
RDAbdfMVJPFSKEOBZLaWcCTIYUegXNGQH,dAAAMAAAJADAFADD..KAGCEAFA..ZBDAaAHD..CBHA...TCBAhAFAUDDA...eCFBhBAA.XEDAGCBAHDGBhACAABBAbDGD.fGEASGCABGGDWHBGhBHA.IHHA.hBAA...,2,-33,-10,23
aUWKcVdNSLFXDAgMITbQGBfPeJROEZCHY,MAAATAAAGACB.BAGBeACERCCBZBFEHAFB.aAHFKBBDdCCALDGBhAFADDBBADFB..bCDDQFEAhAIA..hBAAfDGA.ODHDCHHA.UFABhAAA.cGGA.SHBAhAFA,2,-27,5,32
dgMDTILENcKRBWXUaVZSJFAOfGYQHPeCb,GAAAHAAAeACEdADAMAFATAGALBFA.EDDAKCCA.RCEFXDGAhAAAaDBDZDFB.FECBAAABODHDhACAQFGCbGBADGBAhBCAIFAA.BGCA.....hBDA......hBGA...,2,-7,-2,5
ZBFUSRQTIYAEaGbDgMJNCLOPeXWcdfKVH,EAAAGAAADADA.MADA.CAGA.LAGB.eBCAXBFCdCFCKCBDhAAAHCDBZDDFFDHDRDFFTEBAhAAAAAIB.aBHDJGBAOEHDhACA..PGFCfHFB...hBCA......hBDA...,2,-22,-2,20
TQcNGfJdbYUHeWBgXMRZSOEVaFKDALCIP,LAAACAAA.TAEAQACA.GAEBdAGAUCAAHCAAeBHHhABABCEAMCDBRCGBZEEBEEEAhACAaFAADEIBAAHA..IGGAhAAAcFGC..fGDA.YHFAhAEA....hAIA...,2,-20,-16,4
dDgHTMAPXBeJFCcLSIfWOKQNEZGUaVRYb,BAAAeAAACADALACA.SAFHIAFAOAGDQCCAhAAAECCAGCEAaAHB.REGBdGDAhAAAHDABAAIB.XCGAhADA.FDFH.fEHE.KGGA.hABANIBB......hCAA...,1,-2,-25,23
SJTQWKMaNDEVCLbgcdFePHUYfOBGRZXAI,SAAATAAA.QADAMACADAGAEBDALAGB.bCCCdBGAhAAA.eCCBHDABfCEAhBDAGEEARGBAAAAAIEFAhBIAKGHBNAIACHGD.FDHD.PGCA.UGGA.hADA......hBFA...,1,3,-2,5
JBbQYNAaZcFPRXKVSWTEIOLefUdgCMGHD,ZAAAFAAARACFKADC...SAFAEAEELAGBUCAAdCEA..MAIBhABAHEFABCDAQGCAhAIAACFA.aGHBXCFAhACAWBHH.TEEA.eEHFCEDD.GGABhAGA.DGGB....hDAA...,2,-18,-11,7
VSINPHdTJcKfZRGebWOaDgBMYFCQEUXAL,LAAASAAA..IAEAHACBdAEBJAGBfAHA.hABARBEFeCHFbCAA.aDFDBCEAhACAMEEBCCHAEECBAAAAPFHDhAHATEEA.ZEGB.GGABDGGB....hAGA......hAIA...,2,-15,0,15
DeVcOXCPBQFZMJTGRafWKUNdSHgALbYEI,LAAAEAAADADA.eADHOAEECAFA..QBGAZBCAMAIBGCFAhAAARCAB..aCFHKDBAdEDAhABAHDDBAAHA.IFHAhAHAXFAAFHCATFFA.fEHEhACA.NICB.....hAFA...,2,-15,-11,4
VNebFUcTKWBAHMEQGYIZOfJSRXgLCaDdP,HAAAEAAAGACAZADBOAFC..SAEARCEFLCCDaAGDdCGAPCBBhAAAeCABFEHD.TGFAhAAABCFDAAEA.MAIBhBCAIHAAXDFADICA.bEDD.KFFA...hACA......hADA...,2,-5,-4,1
XZUMfQDEeGIYgaSVCAOKLFNBHRPdcWbTJ,LAAABAAAHACARADFdAFA..bAFBJAHBZBGB.MCABQCAAhABA.EDDBeCCA.GDEAhAAAIDFAaDHDCGGAADIBFEGDhACAcEAD..WFFD.....hACA......hAEA...,2,-20,-10,10
fecbPIYBRCOUdQTAVSNGHEKDXaMgJLZFW,SAAAHAAAEADEDAFAMADALBGB.ZCAAfAGAeCCE.hAAA.bEECIBDAhAAABCFBOEHDdCFDAAIBGDDAhABAaGGH.FCCH.PDHD.RFBBQGFAhBFANIAB....hCAA...,2,-7,1,8
GbWVQJIOUBMZXNTAFLScPdKgCEDReHYfa,LAAASAAAdAEACADA.RAGBHCAA.aCEEbAED....QEBAhABAOAGDMAIBZDFETFGAhACAAAAAFCCBKDABEGABeECAhADAfGFEGEGAVGAA.IGEAhAGA.....hAGA...,2,-4,-1,3
OfaCVLTFJNHUQdBecgGAbRZPXKMDWIESY,RAAAZAAAKADCMACA.DAGAEAFA...OAHDaBDDLBFAFCCA.HDEAhABAdCFAeDGHGGBBAAAA.hBHAbFGB..XFDAhCAASCCDCGHA.........hDAA......hDBA...,2,-30,-9,21
WAKeOZaSEHVMQFdbCXBgUIPcTYDRJfGNL,eAAAaAAAHACBMAEAdAEB..CAHABBCAUBFB....IEDAhAHATBEARCGBGEGALDDBhAAAAAIBZFEBEEBAFGDB..bFEDhABA.XGBC.gGGBYBBFDCIBhBAA.....hBEA...,2,-13,-5,8
YZLfJcaQMOCgFWVbdASGXETBHPKRDeIUN,GAAAEAAAHACARADAeAGHUAFAZCCALDCA..fCHAhAAAaBHDMDAB.CAHAFEAA.VEFBhAEAAAABTEFA.KFCADEEBhCAAIGHANEIA.YHEAcGDC.QGADhACA...hCBA...,1,3,-9,12
WJMKYCISRNgTfVAabUEOLPBGcFHQeZXdD,aAAAEAAALADAGACAHAEAeAGHdAHA.DBBBMAIBKCFA.CBCD..RCDB.TEAAhAEAAAEAUEGABDHAQFCChAAAZEDBJFFASGAAhAGAfGFE.........hCAA......hCBA...,1,-5,-18,13
ZSLQCFMAWGBJIfKXbTEdgHcPRUeYDVOaN,GAAABAAAJACAKADA...TAGAEAFEHCBARCDA.UCFAeCHFDAIBaDAHhAAA.ZECALDHBhAAA.QECAhAHAMEGBACDAfFHAdFFA.gGAAYHFG.hBCANIEBSGCHhACA...,1,-11,-14,3
BVdbAORCeLKZQMNTHJYScPEXFGUWfagDI,RAAAeAAAZADB.MAEAHAFA.SCCDEAHFGBCAUCFBaBEA..DCFBBDAAhAAAdDGAAAAALFFAhABA.KGEDTGEAJHAA.hADAcGGAFHFE.WECD......hCAA......hCBA...,1,-9,-19,10
dBWTEXfcgQSHKRDAaZOUJeCNbILGMYVPF,ZAAAOAAAeACE.CAFB...bADAGAGA.MCCBPAHBBDDAEBBBhAEA..XDFDhABA..fCEAhAFAQFCAHDCBDDIBAAIBaDHDUGGAIFFA.hCAALGEA..hAIA...,1,-10,-19,9
CGaVXAWKfRLNEQDdgYTeFScBIHJPUbZOM,KAAARAAAEADEdACA....TAGAeAEASAHHBCCAHCEAUECAhAAAZCDBMCGBaCHD..AAFALFFAhABAQEAADHFAFDHBhAAA.IGGA.bFED...CHBA..hAIA......hCAA...,1,-14,-16,2
JHZENDWagXcRVdICBMSOGFQAKTLfeUbYP,TAAAeAAAUAEA....bACBJAHBHAEAEBCA.DAGA..aDDAXBGAhAAA.RCDFdDGAhCAABDGDMCCBGGBBAEIBLGEAhDAAfEEE.PHFC...hDBA......hEAA...,1,-2,-27,25
QCRDSHfMNEdFWaIVbXPOLGgAYTJeZcUKB,TAAAeAAAZADB.KAFAQACC.RAEFHAGBMAIBEBCFdDDAaDGChAAAVCFB..XEAAhAEALFCAAAIBJFEBBEHASGABhAGAFGGAIHAAOHFC..YHCAhAAACGGB....hABA...,1,13,-24,37
WHTKNMSFDIPJZXfRgVQGCecLOEdBYaUbA,HAAATAAAMACA.DAGAJACAZBDB..RAFFQCCAeBFALCCDhAAAEBHFBDFDaCGEAEFAKEGAFDHD.hAAA..XFDAhBGAVFAACFFAdGHAUGGA..NIAB.......hAFA......hAHA...,1,-3,-11,8
MeKXfOHLWgQBNZbCaPYGIAJdVDFETSURc,dAAAFAAAEADASADA.RAFF.eAFA.XBGAHCACLAHBhACAQCCAZDEAaEABGDAAhADAAEIBDFDATCEAMFGBOHCAhADABDGAbEFACHHA.IGGA...hAEA......hBAA...,2,-8,-1,7
ZfOeaHSBEWTIcLgVPNdDMbUGKFRAXJQCY,QAAAZAAAeACEHAFBEACA...TCDALAFA.VBDBdBHAbEFAhABAGCFARFAA.AAGACCHAOFEBhAFAaEHDBHCAIGGAhAHAPHFAMIAA........hAIA......hCAA...,2,-8,4,12
GPgLMZbCKABRFWeYUOSXEVfJDIQTHadNc,RAAAeAAAOADAEADA....VAFADAHBQBDDHCCAdDGAGEEAhAAALDEAZFCBKGHBAAAAFEHD.hABAUGBA...fFFAhAIA.IHHA.aCCH.hAIA......hCAA...,2,-20,-8,12
HKXFGMTPYAJNDIBZfWVeEbgaOcSCURdLQ,DAAAZAAA..VAEAEACA..aAEDOAHD..CAGARCCBdCAAHCECFCCHGDFAhABAMAIB..TEGAhAGAAADAJEDBBEHB.eHAEhACAbEBDSEFD.....hAHA......hCEA...,1,-15,-18,3
gYJXcVLCNHSGBIUOdbDRZfPTFaWKMQAeE,EAAAJAAA.....XACALADBHAFAGAFABCCAOAHFhAFAbCEAZDAATEEA.aCCBhAHAMCIB.AAHAeEEBhAAAgEGHcEGCCFBASFDDdFAAfFCEhADAFGHDWHDAKGGD...hAFA...,1,-3,-11,8
AaFYPLUQHbDXTgJReCKWNVdZEcMOBfIGS,aAAAFAAALADAHACBDAEA...TBGARAFAeBBDKCCA...VDEAhAEAECFBMCHBBAHBGECAhAFAACIBUEBBQEEChAIA.XGGACEHAdGGA......hBAA......hBEA...,1,-8,-19,11
RHPcQODZVYIgCSMGXTbaAEUKeFWfJNdBL,EAAAeAAAFACD..JADBdAEARAFA.HAGB.QDDAZCEE.VEBBhAAAgDGA.MCCBhAAAGEGA.TGDAhAGAAAFAKFCA..fFEB.BFHA.hAIA......hBEA...,1,-9,-27,18
ENRAIHYeMJCVBgZdLQFKaWOUGTPDbfSXc,HAAAeAAAMAEACADBBAFAdBDALAHB.QCABaAGEOBFBGCEAhAAATCGADDDBSCCDhAAAEBGFACEB.IFFAhABAVEGBZFAAKEHB.WEED.....hACA......hAFA...,1,-6,-16,10
USbATVCEKXOIQZRPMWfJGeacBNHDdLYFg,TAAAEAAAKACA...OACAZAEBRAGB..MCCBJAFBGBGA.eBDBhAAAaCGHBDDDHEFBdFEChAHALEABFCCH.SDHHhAAAAAIBCHHA.QFEA.fGGBhAEADEIB...hCAA...,1,-9,-20,11
MADRFfOgYSKUIedbCcPBWQXaLNEGTZHJV,RAAAOAAA..SADBKADAeAFEdCCACAFABAHA..QBFDhAIAaCCBLCFAEDFFZEGBhBAAHDDAMBBBAAAAFEGDfEDAhCAAUFAA..IHHA.PGCAhAFANICB.....hCEA...,1,-17,-18,1
KDSNfgOBXRUHIMTQcaWCGdPLbEYFeVAZJ,ZAAADAAA.SACE..fACABAFARAGFHCCCMAEATDFAhABAaAGEGBDALFAAhAFAEBFBeBBDACIBKEHBOFFBhAIAXCGD.QFEACGHD.dGGA..hBAA......hCAA...,1,-7,-16,9
VTXDgcUWfdFRKPJEeLCONHBYZSbAaIGQM,GAAAMAAA..TADADADAUAGA.dBFCRAFFKBBAECDB.LAHBhAFA.ODDBHDBBZDGBhAAAAEFAaEFEQFEAhACA..XFDDWEHH.FGGA....hBAA......hBBA...,1,-12,-22,10
TWDNLGEVCFOfgdURQZecAPSaIKHYMbJXB,aAAAHAAA.MACA.JAFBTADA.DAFAGBGAEAHF.FBDDOBBBhADAdEEARGEAeCCDABGB.SAHBhAAAKCDDbCEDBCHAhBAANEIA.LEGB.fGDA.hCAA......hDAA...,2,-17,-8,9
EOMgfRZQNJGHWLdbSFcaDKTUCYIVBeAXP,EAAAMAAARACA.ZABE..QAFCGAEAHAGDdAHAFCCHaCCB..TEDAhAGACDAA..IDFAhAAAeCHHADDAOFGB.hADAfGDEWDGHbEDDDDIBYFHBBFFC..hAIA......hBAA...,2,-18,-6,12
gRaKVYOZQFPTcHASWeGDUIbMfdNCJXELB,eAAAGAAADAEAUADA.MAGBdAHACBCA..EAHBLBEBBCHDRDBF.aBGBhAAAKDDC..ODDHhABAZEFAQGEAFDHB.hCAA.TFFAAAABSGHDIHHANIAB...hACA......hAIA...,2,-25,-13,12
cCEATIGdJKeZDRBWMSXNOVULbFPfgaQYH,GAAAdAAAeADARADAMAHB..XAGA.OCAELCDAhAAAFCEA.fDHAhACAaCGDHDCCEEABAADATEEAKEHBZFFFhACABFCASHAAUGEBbGAC.....hADA......hAEA...,1,-5,-6,1
EFOUDQXPLdNceGVbZSIBAWMgaJfRHKCYT,MAAAaAAA.RACA.HACBKAFC.TAEA.EAGEOAHD.QCCBhBAALCGBdDEAeCEHbEAAhAEAZDFBBFHAABBBJEHBCGDAFGGHhAIAXGCA.........hBAA......hBBA...,2,-16,-7,9
JONXcQCBMIAbDSRTgLafZVFYEHdKUGPeW,SAAARAAALADBZAFAFADAHAFBdCCCGCFAeAHB..OBCD.hAAAXDFAQFCAhABAMCEBAAGAbFGDDEIBaFDCfCHEhAIAEFFE.........hAAA......hABA...,2,-16,-5,11
PCAIFfXWLRcVZeGdEDONbKgSYaMQBHTJU,FAAAXAAARACFZAEB.dADA..EAGAOAFA.KBFASBGAhAEA.aDEEMBIB.HDBAhAAATECAPDFBADHAIEHAhBAALDGBeFFBDFBB......hCAA......hCBA...,2,-26,-17,9
JUSXWeFYdBGcRHZLDVgPfCAOITQEKbaNM,TAAAEAAAKACA...aACAMAEA..SAEHeAHFdBFAGCCAhAAAHAGBZCCALEFAhCAADDBBgDGACGEAACCBQGGAhCBAbFFAUGAA.FGDBYFCFBEED...hAAA......hAGA...,2,-4,-4,0
EgGQFXBCDOUIAVYKRWJbdTcSfaNLMPHeZ,KAAARAAA..JADAdACA.SAEA..aAGAMAHBHBFCECDAGCCAhAAA.QEFAhABABCFAOCHDACCBVGDAhCAAbEAA....TEEANDIA.eFHB.ZGEAhAAA......hAEA...,2,-23,-10,13
JOeIZQFagLbMCHDYRdAfXKSBTVcWGNEPU,KAAATAAA..VADAGACA.EAEAUAGAeAGFZCAAFBHDLDFAhAAAMCABHCEBREDB.AEHASEAHhAAABFFB.cFGAhACAPFHB.OHDEaGGH.....hAEA......hAIA...,2,-25,0,25
RFYWAUHZTcLVQOGDIMbXPBeaSfKdJgNEC,HAAAZAAALADBQADCGAFAMAFAXCAAeBFAaCAC.KCHBdBHAhABAJDDAEDEF.REGBFFAAAEHBTFFAhAAAOFFB.DHAAbGBAhACA.SFHH..NIAB....hBGA......hCCA...,1,0,-1,1
XNRZgKAGBefVbOIFPCULDaJMSdEcWTQHY,eAAAVAAA.OADC.FAGACADBLAFA.aCDAMCCA.ECFAhAAATCGAHDDAXDGDhABARDDBZFGBAAGABGCA..hAAAbFAAIGFADCIBdGGA.......hAFA......hCAA...,1,-11,-21,10
QWbLXDVZgKGTJcSUBARIONCYMHePdEfFa,RAAAOAAACADB.HADAeAEHEAGE..FAGAaBBC..QCFAhAAALCFADDDBZCCFGEEAhABATEEASEGBhAFAACIB.IGCAMEIBdGBAfGGE.hBGAWHCA....hAIA...,1,-13,-21,8
TUYeRaZOAEPSVNgHfWdLbGXMKcDFIQBCJ,EAAASAAA..gACAHACBdAEBGAGAMAFA.DBFBQBEAhAAACDEDTEFAeEHHhAAARBGBZDAAABIB.PEEBhADAfGDAbGFA.........hCAA......hCBA...,1,-9,-12,3
bUOaVHdEKXDcfNRZFTSWGJeBIALMCPQYg,MAAAQAAA..bABAaACE.HAEBEAFADAIB..fAGBhAAARBGBZCCAFEEH.TCGAhADAGGEBeCDBADGBLFAAhAFACEGDgFFG.OGBA....hAIA......hBGA...,2,-10,-6,4
FYHGBJKPeMNOCdLVEQSWUZgTRAbIfDXac,..IAAAXAAAFACAHADA.GAGAKAFAeAHHMCDB.CCEAdDAAhAAAEBCBQCEAhAFASDGDZEEFRECAADIBDEHBaEHDBGAAhABAJGDE.NIAB.OHAC......hAHA......hCAA...,2,-20,4,24
JKERZYDaCXONdLSgVbWTABePIGUQFcHMf,eAAAGAAAQADAHADAMAFAKAFARBFAZDCAaAHD.ODAHLCCBSDGAhAAAVDGB.TFDAhACAAAAABEEA.UGCAfFHAhADAEGGBCHAA.dHDD.......hAHA......hCAA...,2,-12,11,23
OQSdLaVUBGPXcTbHKNCJMDYfgAIeZEFWR,eAAAEAAARACA.QADALAFBUCCBGAGA.XCCC.bDEDhAAAHCGB.CAHAMDABhAAAfEHAACIBZFCAOHAAhADAaFBABAFATGGAKGHBDIAA......hABA......hAIA...,2,-6,-5,1
WJEQUKNgXaBGVODHbeFLSPMdITAfRCcYZ,RAAACAAAZACAEADE...QAGAKAFC..XBFAGCCADADAHCCAhAAAeCFFLECA.hAAAMAIBdDHAACCB.fFGEhAGAcDGCJFGFgGEB...hABA......hCAA...,2,-21,-19,2
cOQBIRXFdDESYKgeHbfNULTPaAVJWCZMG,VAAACAAAGACA..QADCRAEAdAHA.EAFEKCAAHCDC..bCFDhAAAfBHA.hACALEEAaDHFAAEAZEDBMDIBhAAABGGAFGCADGIBSGEH.eHAEhAHA.TGGA..hAIA...,1,0,-24,24
eJTKOEYGcWCAbVNDHBaFIfQMRZdPULSXg,VAAAHAAAaACA.FAFAQADCZBFA.dAFALCCB.XCEChAAAeAHBTDDAhAAAEDGF.GCGACEHAAAIBbFECBFDDhAIA.MFFB.UGGBSGHH.hCAA......hDAA...,2,-7,-7,0
JEYAMICcOXdaNZBFbPWKeTUQHSLfGRgVD,MAAACAAA..XACAaACEZAEB.FAFA....bAGDKBFD.eAHHhAAATDCAHCAALEFAhAIARDCADDGBEDHFABBBOGBAhBAABFFD.PGEC..WFHHSCCChBGA......hBIA...,1,-15,-22,7
CFdABLVegcZfaPDQWGKbTMOYNRUJHXESI,LAAAeAAAZADB.aADDQAFAGAFAKAHBMAIB..OCABhABARCEFHDBBECCBCBCAAAAABDHAVDGBhBHA..fEDAhACADGGB.bFAD.TFEA...YHDAhAFA....hAHA...,2,-14,-9,5
XWNKVcRAIMUGFOSdLaQHTgBPJfbYCEDZe,MAAAGAAAFADDdADALAFAHAFABCEA.JCGB..bBBDEDDBeCFAhAGA..XDBDhAAAKDHBRDDFABBBOFCBaDHD.TFFAhAHAfFAE.DFFBWHFAcGGA.hBAASHAA.hCAA...,2,-14,-7,7
ReAfFPBgNVZWHcXUQGCMLaTYJOEDIdSbK,FAAABAAA..VADAHACA.XAFBGAGAMCCBaAHD..TCAAhAAAODAB.EDDAdCEAKDFBhADAADDA..fDGAhACA.gEAAZFFAcGABQFFBhAEACEHA.LHBAhBHADIBA.SFHH.,2,-13,9,22
WScMIXTEgCaQPUNJYdfAFZeGHODLVbBRK,eAAAHAAALADBBADARAEF.SAFAMAHB.TCFAECCBaCFDQCABhAAA.PDHDhACAUFFAJEDBdEEAAAFAFGAAhAAAZFCBDAIBKGFA..WEHB.....hAIA......hBIA...,2,-23,2,25
PMLbZUfHEWRBFVADCQeJNYKXSdGTIagcO,QAAAeAAA.JACEKADA.dAFAGAFAaAHB.OAHFMBIBZCCAhAAAHCDBRDFFBECAACDBCDHDXFBAhAAA..SEEDhABATFFA.IFHAPHACLFHBhAHA..fHDBhCAA.,1,7,-36,43
eSIVORMcNJEADWfZgYQHaCXPFBTGUdKbL,DAAAZAAAQAEAHABCaAEA.CAGA.FAHBGCAAdCCDLCFAeAHHSCCAhABAOEEA.RDEAMDIBhACAJEHBAFBA...fFDAhADAXFBABFFDTGFA.....hBAA......hBFA...,2,-25,3,28
eFICGSHQAgWZBOTPREaXKDUNMVdcfYLJb,ZAAATAAAEADE..KAFCDACA.UAFAMAIBdBDA.....fCHAhAAALCABeBGFhABACAHAHDEBACCBBCEARFBA.aDDChACAXDCCVEGBJECFbGDAFHDE..IHHAhBFA.....hCEA...,2,-15,-5,10
QILGRcgeUdKHaZVTFYObXWNEJSCMBPAfD,QAAAGAAARADAeAGHdADAHAFAZDCA.TCEAOBHD..bCGDXEAChAAA.EEGBCDBAMDDBhAAAAADA.DCIBLFDBhACAgFAAaFHDFGADYEEF.NIABBGGAhAFA.....hAGA...,1,8,-5,13
JLKgCaPbEAFWcHGfBDNXQZVUMIOTRedSY,FAAAHAAAGACADACAQAEAZAEAUCGB.MAHB..TEDARCCAeCHHhAAAdFAA..SDFHhAIALFGBCCEAbFECAAGA.fGBAhBGABHEA........hBIA......hCAA...,2,-24,-9,15
HRZFJLKWcDNaGAEOXfCPTBIgMQeVdSYbU,EAAAXAAA..CACABAEAMADA.eAFHdAHASBCHUCCAHBGBREABhAAAZBDBLEFAKBFBDDFBGDGAhAAAAAHAOGEATGEAhABA..IHHA.....hBHA......hCAA...,1,-13,-20,7
PKSBHXbRgMOAVdFefEYQDWNIJTZcaLCGU,dAAAeAAAEADAQADA.DAGAIAGAZBFBLCCBGBDBKBHBhAAAHCACRDGF.MAIBAEEBFFBHhABAfDEE.hBFAYDGBJFFF.aFHDCHHA.SGDAhACA......hADA...,2,-17,-11,6
IJEcHTGRBQKOfDdMLgVUAFbCaPYZWeNSX,CAAAaAAAZACA..eACH..XAFBEAEAHAGBRBGFBCCAQCEChAEAKCED.DBBBdDAAMDDBLEFAhAAAgEFAAAIBFGEA.hADAbGBA...PFHDNIDB.....hAEA......hCAA...,2,-29,8,37
VYATIDXHFJPcWNBLGbgdUeRKSaEOQZMCf,TAAAXAAA.HADAFACA...JAHBPAFA..NCDAGCEAhAAAdCCARBEBKBHBEDAAZEDEMDIBhABACDHD...VFABAFHADGCBhAAABEGA.bGDAgGGA...hADA......hAFA...,2,-21,0,21
bZOMEAHGILSNVBFDTdXUCWcRKgfaYQeJP,HAAAGAAALADBSADABAFADAGAdAHACBFA.RCEFKCAD..aBGDeCCDhAAAJCDB.ZDGB.EFAAAAABVEFAhACAFGCA..XGEDhACAUEAB..cFECfGHA..hAFA......hBHA...,1,-5,-22,17
AfBVFGbKDYgNdULTPJOWeEQCMHIZcRXSa,BAAAGAAADACA..NADA.dAFALAEA..TBCAOAHDEAHBhAAAMCEBHCFCZCFFREBAaCBHhAIAAAABFFAA.KFDDUEEAJFFF.hACAeEHFCEHB..XGACSGHH..hBCA......hBEA...,2,-17,-8,9
DIBCTUdPReVJQMZgaFYXfSKONHAbGLWEc,GAAAEAAADADA.CADAdAFARAEA...eAHBQBCCZCDAFDHH...fBHAhAAAODAHHECAhAAAAAHALDEB.IEHAhCAATGFAPHCCMCGBaGGA....hCBA......hCCA...,1,-8,-26,18
OFDYECSRUTQWLIfJZeagdVBXPNbMGHcAK,FAAAEAAARACAQADA.LAGBfAFBeCCBdAHABBFBXCCAhAAA..bDADHCFAhADAAAIBDCIBSEFAhCAAUEEAIFHAaEHDgFCAPHEA...hADA......hBAA...,2,-19,-4,15
bFNaJWREdBHOADIeSXTUPgfCVMKQcYGLZ,eAAATAAAUAEA....fACBMAHBQBCAGAEAbAGBhAAAaCHDRDEBECCB.HDFBhAEAAAAASFHBXEDDCDHAhBGAKGBAYFHBZGEANIAB.......hAIA......hBGA...,2,-15,15,30
WDXeVITdSOEPHABgNLYZCaJMfbQUGcFRK,BAAALAAAZACACAFBaADD...MAFAQBGAGBEARBGBDCCAeCABhABA..TDAAdEGDECCBhACAHDDAABIB..gGBAhBGAYEGBfFDEcGGA.KHAAWEEDhCBA.....hAAA...,2,-36,7,43
EKMRTGeYbNOfZHJCFaDQgXScLIPWBdUVA,EAAARAAAeADE....bACAOAGDHAGBFCCAaBDD.QDAAhAAA.SDEAhADALCCDIEEABDHAdFDAAAGBhAEAMAIBTFFAGEGAYFHBZGAADDGB..hAAA......hABA...,1,8,-17,25
dgAYbVDKJCeXTLOQBaHEISWUNFcMGRfZP,VAAAKAAAeACE.LAFBQADCHBCAEAFESAHB.hAAAUEDAFBHDGCEAhAHARCGFZFFFdHBBACGBbEGDCFHA.ODDHhAIABHHB...........hAAA......hBHA...,2,-10,-7,3
WEgfAbYCZKeTLMaVcSINHGdPRDXFUJQOB,CAAAeAAALACAMAEA...aAFDSAGA.HBCAdAHARCCAFCFDhAAAQDACBCHAEEBAABEAhABAZDFBTEDAIEEAhAAAPEHBDDIBJFHFOHCAfHBB.KHEAhADA......hAEA...,2,-18,-1,17
XYHEQGNcZCbPSafTJAKIBVOgDWMdUeLRF,BAAAOAAADACAdAEALAFARAGB..XBBAHBCAECBB.GCFAhAAAZDEACCFA...bEBAaEBAhAGA..JEHBAAIBKFFAICHAhAGA..WEHHeFFD.FHAA..NIDB.hBAA......hBBA...,1,-3,-34,31
ZFQKSJUMNDWXcBOGagRIYCeHfPLEAbdTV,dAAAZAAAQAEASADAUAGAMAHBDACA..XCAAOCCBaCHDhABARDCF..CDHAHEABhACALDEBAEAB.TGBAhAIAKEFANHDBBFEDGGEB........hBGA......hBIA...,2,-18,-11,7
VDPORFSdCeaBENWUTgAXZcKILGbMYfJQH,ZAAAKAAAGACAMACA..JAFBHAEA.DAGARBGFdCCDeBHFBAHBECABUEABhAAA.ADFA.XEBAhABALEEB..bEEBQEGBhACA..ODHDCGCAaGGCNIDBTGGAhBEA.....hAEA...,2,-22,-2,20
gQWTSMFRUDJdKGAZfLBOaXINPEHcCVbeY,ZAAALAAAaACA.XADD..IAFAEAFAHBGBCAHAeCCAhABAQCAA.TDDAhABAMCGBREEBDAIBdCHAAEGBOEHDhACAPFDB.bFAA.YFFFSGHB.hAFAFHAA.KHFABHHD.hAHA...,2,-20,14,34
JebIOfTXaWFNYCcAdHDEVKBPGRLZgMUQS,HAAAEAAABACARADFZAFBUAEAQCAB.eAHFOAGF.TCCAhAAAaCHDFDDH..CDFAAAIBdFAAhAAA.KEGDGEBAMFCBbFEDhACAXEEC.NDIADEHB.....hADA......hAFA...,1,5,-24,29
MBeDYbJWGPVRLgEcFaIdZAQKXHfUSCNOT,QAAAHAAASACEOACCMAFABAFBeBDADAHB...bBGDGCDAhAAARDDBLFGBECFBaBHDhAEAZGCAACDBKEHBfCFAhAAACFFA..TGCAWCCD.PHEC..hAIA......hCAA...,2,-17,12,29
ECgMZPJaKNOXHVYcfdbLAIGSQTWDeFBRU,GAAATAAA.eADARACF.EAGAMAEAZBFE..aCDBOAHD.HBEBhAAAVDFA..fCAEhACAbEACAAAB.QDGDhBGAFEEHCFHA.gECAKGGD.XFFAhBHA.cGCD.hACA...,2,-9,11,20
bKOWJLfBQUTPIeNXSYdGCZMHgFDEaRcAV,KAAAOAAALACBBADAUAFA..TAEAeBBB...SAGBhAAAGDCAZEEBHCEChAEADAIBREGBAAIBbECA.fDHAhCAAIHBANIDBdGGA.MFIB....hCBA......hCCA...,1,-16,-24,8
AMNXWGbKYdJQDaFBHOIZfUPTRVgSecECL,MAAAXAAAGACBKADA.dAGA.DAIBBAFBHCCAZAGBUDGARCDB..SCHHhAAAEEEAABBB..hABAbFAAQDAAhADA.aEGCFGGAOFCC.fGGAhBIA......hCAA...,1,-12,-24,12
TQUcLbCJKZHdPVYgNWXDRIeFaOBSEAMfG,GAAATAAA.QADALACB.CAFAZAGBHAEAdDCAVCFA..gDGAhAAAXEAAREDAeDADhACAaAGASEHHhAAAABIBUGCAbEED.KGGD.........hADA......hBAA...,2,-2,2,4
JXMFSLgAcQOEKHITDWfPaGYRCVdZNeBbU,QAAAEAAAHACADAEA....fACFGAGARCCAdEEAeAEAbEFDhAAAXBFA.MAIBhAAALFCBACDAKDDATEFAhAFAaEHDCGBA.ZFDF.BFHA.....hAIA......hBGA...,1,-4,-8,4
FJceRaNWDTOZBXKdGfMAYEPLVCUQgbHIS,EAAALAAAUADA.QAEAHAFAFCBB.eAHBRCFA...aCAADDDBZCEAhABAKEEAGDCAAAHA.PEABhACACEHA..gGGAhAAAbEEBSEGA.cGGA.WHCGhAEABHEA....hBCA...,2,-32,15,47
DZIXNObYVCWeMgARTQaUSLGcBPfKFEdJH,RAAAaAAALADBGACABAEAKAFA..EBHFHAFBZCEB.XDFA.hAAAOAHFbDFD.CEAAeBBDhAEAAAHATFAAQEDDhAHASCCDfFHAdFHADHEANIDB....hABA......hAFA...,2,-13,2,15
GSCMPBAIOeVEFUaXQDbTKRYdfcZJgNHLW,eAAAEAAAFACDUAEA..aAEAQAGA.DBDBbAGDRDEAdDHAZBDBJDFFhAAAHEBA.LGFAhAAAGGCBMFIBACCB.IFCAhAIA.........hABA......hBEA...,2,-16,-14,2
ZLTSGPKUVWIEOBJMbHCAYXaQeDNdcgRfF,aAAAeAAA.dAEARACFZAEBLAGBGAGAKBCBUEAA..VDEB.EDHFhAAABDFA.MDIBHEBBhABAAAIBQECAhAEADAIB..gGGATFFASBBDhBAA.IHHA.hBEA...,1,-7,-18,11
bHUEeWCgTGZABQNVORLKfYcXMPFDdJISa,QAAAOAAARADALAGBKACA..fAEB.XAGBhAAAMAIBDBBB.dCCASBHHhCAAHEAAEEEAeEGFhAEACCDAGCEAAEIBBGCAVEGB.PDCBFHGE.aGCDhCDA......hCGA...,2,-13,-10,3
gIBQCGLKEfVPSNcJMUDXbHdaYWeFARZTO,RAAAZAAAOADABADBGAEALAHBKAGA..EBDF..VCAA..hABASBFAJCGB.hACAMCCBXEDCHDEAaEDHhAAAeDHHAEIBTFGAQGAAfGBAhABA.cGDDDGGB..hBGA...,2,-17,-15,2
UOXdBPbHYRZFCLNecaGDgITQAMWVfJKES,MAAAVAAA.KADA..EADEOAFABAFBHAGBRBBB.ZCDALCFAhBAA.eDEBGECADEGATECAhBBAAAIBfEEBhAAASFHBdEHAPHFAbGBACBGD....aGFD.hCAA......hCEA...,1,-7,-11,4
CZAUEFIVOHYdcNXeLMPaRBWgGfQSbJKDT,EAAAFAAAOACDHACAdAFA...XBGDeAEAMAIBRCCABAHBGCDAhAEAQEAASBFAhAFAbEEA.DDFAZGEAAEHAIFFAhBAA...YFHBNEIA...hAAA......hAEA...,1,-4,-18,14
HAIXKcTdPVUNfDaCLOFbEeYSZRMgQWGJB,KAAAdAAAUADADACALAFAFAFE..EBHFeBCFZCCA.RBDF...MCGBhACAQCFAGEGABDBDhAIAHFEAAAGA...IHDAhAAA.........hBAA......hBCA...,1,-25,-33,8
XRYCQfdIJBOKUZTcEeMHGSPgFaDLWNVbA,RAAAQAAAdADABAFA.KACAZAGB..EAEEHCEBGAGA..SCCDhAAAFCDAaDDCLFFAhAAAVEGB.AAIBCEGD.fGAAhAGAOFAATGCAeGDGMIDADBIB..NIEB.hABA......hAFA...,2,-19,1,20
EDQIVSUdaPgKLcTGRHWABNfZYOJFbXMeC,BAAAZAAAOACAFACA..MAFAEAFA..QBGASBCDaCCCKBEAhAAALCEBGBGAHDCChBGAADGB..fEGAhABAbFDAeEHHDIBAIGHA.....hBIA......hCAA...,2,-20,-17,3
cVBFJXaODSHdYMRIKWQGZLUgENPTbfeCA,BAAAXAAAaACA.DADAHAEB.dAGBRAEAKBDDGBCAZCEE.LCBDhAAA.EBHBTEFA.hBCAeEHHADGAFEEASAHBhAAAMEHB.QGCANEIA.fHEBhABA....hCAA...,1,-7,-23,16
MDOQFWTIZJUPKEACYBdVSNRgXfaGHbLec,BAAAdAAASADARACA..fAFBHAFBeAHBMAIBQCBAhACAFCAA.TDGAhADAZCEAPDABADDACEAAVEEBXDDChAAAaFDH.GEFA.bGCCDFIB.IHGAhAEA....hAIA...,2,-7,-2,5
LJaWPERSdUgXeTFBCKANIZQHfDcVbOYGM,ZAAAHAAADACAVAEA..OAECGCABMAIBaAHD..EDEARCCAdCFAXDGAhAAA..eCHDhABATEAACEEDAAGA.QFFAhACA.bECDLFGBWHAGSHGAhADA.....hCAA...,2,-36,27,63
KHDAaJWBgGNfQXCEVTYZbFecPISRMLdOU,aAAABAAAGACAQACA.EAEATAEAZAGBFCAAeAGH.IDHAhAEARCEBdEHAKDDDHEDAABGB.hAAAgFGA.hACAXGAACFGC.YBBF...hBIA......hCIA...,1,7,-28,35
BWGOIUYeEXQfALHaPbcSNDJCKgZVMTFRd,HAAAaAAA...bADBSACH.DAEAKAFAZAEEMAIBRCDAdCGAGCCAhAAAUFEA.ECABQGGChAIAACCBLCFB.cEGDhACANBBA.CFED.........hAHA......hCHA...,1,-11,-22,11
VLDBHIQOSZFgYMNePRUfabAGEdTJCXWKc,EAAAdAAACADAKACALAFA.HCACQAECZCFAFDEH.MAHB.eCCBhAAARECBaEHHAAIBGCFAhAGA.TFDAXGAAhACAWCHHDFGBBGHASGEH....hADA......hAGA...,1,-11,-15,4
KTMeNQWaIRSDZAdXFbcfVgGHPLJEYOBCU,dAAAFAAA.....bABDfADAGADAHAFALAFAECGABDADhADAKCCDeCFAQEFAhAFAaDABRECAZEGBAAHAXFDChBAA..gFEAPHFA.OGACCEHA.hBDAMFIB.NIDB...hADA...,1,12,-13,25
KSJDOFQBUdGIMZVRXaECbLNcgHWPTAfeY,eAAASAAAOADCQADAdAGAGCCAZAFBREFA.EAHFLCFAhAAA..gCCBhAAAHFABTGEAACIBKDAAFHGEBDGAhABA.MEFB.aEGE.bFBA...cGGAhADA....hBFA...,1,2,-13,15
GHeFANPdaDcMSQOEVCWTKLBZbXRYIgfUJ,dAAAaAAA.MADA..QADAEAGA.CAFAKAHBZBDARCAA..ICCAhADAfBHA.GDEAhACAHCECABBBDDIBODHDhAHATEBAbEED.XGGDgGGAeHCG.hBAA......hBCA...,2,-18,-8,10
OBEGYcZHFdVWQATbDPeSRXLgJUNafCIKM,TAAADAAAeABA.RAEA.LACB.UAEAaAHDCCCAMAHB.EDEAGCEBhAFAZEBAHFFAdECAQEEChAHAAAIBSCHHXGGAhBAAgGBAfEHAOHFE.BHEAhCAA......hCBA...,1,5,-20,25
cJZUdQLGVTbRPgXADNSCMfBIOWHKeaYEF,SAAAMAAABADA.OACDHAEBeAGB.EBBBFAEAZDCBdAHAGEEAhAHAbBDD..RCFBXFCAhAAAAAIBCDHA..fGHAhBAAKFFDaDHD..YHBA...hBCA......hCAA...,1,-12,-18,6
VHfFZTPcabWAJeCISLKEQORgUXBYNDGMd,eAAASAAAEADARAFA.UADABCCA..DAGAdCEAHBFBZCGB..TGAAhAAAaBHFAAAA..CCCDLDBAhBDAQGDAOEFBhBFAXEDCGEGAMDIBFHCAcGGA...hCAA......hCBA...,1,-4,-12,8
RbTXEcBFASHCDGaYdLPgQKOUWMZfJINeV,HAAAGAAAdADALADAQAFAOAGDMAIBZCDA.JDHBeCABREAA.hAAAbCCAEEEB..FDGBAAEADAIBhACAaEEH...gGGAhBAAKEHBfFAE.IGGA.hBCA......hCEA...,1,3,-12,15
ADGcORCBeMUJZXbLNFIdYQEVSTWKHfPga,GAAARAAAeADE.MADAZAGBLCCAFAGD.dEBAECDA.SBHHhAAAKDHBHEEA...fDCEhACAaGACAAAAOGEEBDGDhAIAXGCDbEEC..IFBA.QGGAhBAA..hBCA...,2,-19,-8,11
NcWXDGPILQdKgHVUFJOAZEBTaeRCfYSMb,EAAAaAAA.RACA...CADA.SAFBMAFA....bBBCNAHA..XCCAhAAAGBEALBGBhADAdDAAHDEBFEHDABIBZFGBeFCBhADAfDDE.cGCADAIBQGEBhCAAKGFD....hCBA...,1,-4,-10,6
JZOPbdEMGRTFXDKecUSWfgYaIVCQNBLHA,ZAAAOAAAdAEAEAGARADA..FAGAKBHB..eBBBSCAA..hABAfCFAaCEE.hACACCHAQEAChAEALEBAHDGBADDAJEEFbFEDMEHBGGABDEIB.cGGChADAWFCH......hAGA...,1,-5,-20,15
NUEdVQKOCIfJPHDgXFBaWGLSAMTZYRbec,ZAAARAAAeADEUAEA.dAHAQAGC.CBDA.fCAAHCDCXDGAhAAABCCDGDEAhABALFFBAACAMDHB.TEBAhBEAYCCF.NEEAEFHBOGBE.IHHAhBGADIAA....hBHA...,2,-25,4,29
deMTbIKaBHWPRZgDSfGOJVUcLFNCEXQAY,eAAAMAAA...TADAKADAHAFB.RBBBZDEASAFBGECAOAHFhAFAUCDBLAHBhAAAFFFBEGHB.ABHBbDFDBHAAPHEAhABADEIB...........hAHA......hBAA...,2,-13,-11,2
AMWKEOYLCTUbHGBfaFdPReSQNXVIgcJDZ,MAAAEAAALADAUAEAHAGDGAGABBBAaBCCdBDC..RCDA.eCHHQEAAhAAA.XEFChAEAgDEADDIBAAIBOFDBhAIATGGAbGFAFGEH.......hBAA......hBBA...,2,-19,5,24
aQKXACGZfPgFJODeMISHWRVYdUcbENTLB,ZAAA..fAAAFADADAGA.eADAMBGBHAGBRCAA.dCBAUECAECFBTDDAhAAALBHBaDABKEFDhABAAAIBGEGA.gGBAhACAOFHBSHCAYFFF...hADA......hAEA...,2,-30,5,35
FRfTNEDJIPZAdUaMBQXGOHYbScLCKeWgV,aAAAMAAABADAGACBHAEB..SAFELAGBeBBBVCCBRCFATDDAhADAEEFB.DAIBIEHAhAIAADIBdEGAQGBAhBAA.OFFHbFCCKBBD.FGHB.NIBB...hBAA......hBIA...,2,-1,-1,0
SZGKJcXVWTLFbUQDHaNfMBdACgIPOEeYR,CAAA..IAAAEACARAEA.GACAKBHB.XAEA..TCAAhAAAbAGD.QCCChACAHCABaCFHMEEBAAHAOCFDhAFAeFAAZEGBcFFALFDBDAIBBFHB.PHEChACA....hAEA...,2,-15,-1,14
ceETXbOLAIaKFCQJSNZdMGRVPgBHfYWUD,aAAACAAA..QACA..SACHdAFARBGF.gAEAhAEAHCAAfDEAhAAAUCGAeBBDEEBATFFAhACAbDDBAAHAFFAANDIA.GGDBBAHBDGEBOFFA.KHBA.hBEA......hBFA...,1,4,-11,15
EIeQbBdSHTFYJOPZCUaDGfLgWAMNXcVRK,MAAAXAAARACA.KADAEAFE....eAFEQCCBdCDAHBFATCFAhAHAFDAAODFBZEEAaAHDhBAAGDGALEHBAAAANIAB.hADAIFCASGGD......hAIA......hCAA...,1,-7,-9,2
HDdXaLcUbNRIVCWfTQFePOgBYZSAGEMKJ,EAAAMAAAHACAdAEALAGBUAFARCCA..CAHA.TBBAFCHD..eDFFhAAAOCHDBEAAZDBAAEEBKFHBhAEAXFDA.bGBCIHFAhCAA..fDFE.QGGAhAIA..hBAA...,2,-19,-18,1
AVIYaeFKJQGCDBcTgWSEUbHXPLMfdONZR,VAAAaAAA..eACHKADCGAFABAEA..TAGASAHB.hAEAECDBHCEALDHBhAAAdECAZEEAADFBFECBQGAChAGADFBB.gGEAbFFBPHBCMBBB.ODHFhAIAIHHACHHA..hBFA...,2,-14,10,24
VCcNgGBWJfYTEbeSMFaQXKPUDOZILHAdR,RAAACAAA.....NADB.GACABAHA.JAEA...TCAAEBDAeBFFhAAAMAIBQCGAhABA.KCCDDCFAZEDAHDFAhAAAAFHAdGEAgFDA.fEBAhACASGHBaFHB.PHAChAHA...,1,-18,-27,9
eSEXfNGCTYPbaRABDLWgdIQZUKHMVcFOJ,LAAAdAAAZABBHADAMAEAFAGA..eAHFECEA.XBCAGCGATDCAhAFA..bBEDACIBDEFBhBAAgCABQGDChCDAKDHBODDHfGGECFFAaFHH.RGBE...hABA......hACA...,2,-8,4,12
DcTdPfaSQeKGIRUEFZXMbCNAHVOBYgLJW,HAAABAAALACADACAdAFA.aAFDeAHB.GBDARBGFECCA.ZDFBMDABhAAACCCCAEHA...ODEBhADAJFBA.TFFASFHBhAAAKEHBFHAA..NHCB.YFDF...hAIA......hBFA...,2,-18,-10,8
SZGLOXYCJUabRWIAdMDgHeFVEPBfcNQTK,dAAAMAAAHADAFADD.EAGEBAFA....fCBAQBGATCEAhACAZBBFGDDALCGBhADAXDGCCDCAaEEHRFAAAAHAeFABhAFAPFHDKFCDSGEAOFGD...hBAA......hCAA...,1,8,-17,25
gfaCLVXEZeKBFYMJRTbcDNUSOAIdPHWQG,dAAAHAAAGADAaACALAFAEAFAZABB.BCCAMAIBRCEA....bECBDBHBhAFA.SCFHhBAAAAGA.IEHAQEFAhAAACFDAeFFBFGHDYHCGcDBD....hCAA......hCCA...,1,-11,-14,3
VDUfZTNWLbeJAgESRYKMIOcBFHQdPCaXG,EAAARAAAMADA..OACCFAGDHBDBdAFAaAHBGDFA.DAIBZCCA.TDGAhAAALCCD.eDHBhAAAABIBSEAAhAEAKFBDBFEDCHGAXECD.fEEE.hABAbGDA.....hBFA...,1,-11,-13,2
XSJQHREYUdDGAPCVITWBNcKbgfLFMZOae,CAAATAAABACA..KAEA....bACBLAGBZAEBeAGF.SAHHhAAAHCAAECEAdEADABEBIDHAhCAA.cEEAhCCAFDHDaECD.QEEARFGFDGEB....hAAA......hACA...,2,-32,-2,30
VONXCLHPFUKTaEBfWbYIDdAeZMRQGJScg,eAAARAAAGADA..SADAVAFA.XAFDHDAAFCHDTCCAhAAAEDFBBCCD..bCFAhABADFABAAHAZEAAMFFBQEEAhAEAgGGACEGALHBAKGDB.aFHD.hAAA......hABA...,1,6,-10,16
CTFAgcZYabdeULBNRXSfHGQMVODKJIEWP,ZAAAaAAA.eACELADARAFF..SAHBHAGBGCCAMCCBDBBBKCHDhABAECFB.CDHAAAEA..gDDAhAFAbEFCBGGANIABQEGBhCAA.OFFB.IHHAhCBA.....hAIA...,1,-4,-17,13
BgAfIbNVXdUHZDOeaGTYJRcMSEWLCKQPF,..IAAAbAAA..XAEAHACAZAFBeAHBGCAA.TDDAhACARCAAMCEBEAHFLDFBhAAAQDGABDHDACCBfFCAhAEAdEADOFCDaFHBcFFASGHHhABA..WFAD..hAFA...,2,-10,3,13
WaUeRVcOYgIXBLQMTKNFJHbGfEDSdPZAC,aAAARAAAOADA..IADALAHBMAFAKBDAFBGB..HBDChBAAGDDAEBBBdBGAAAAACCCD.eCHHhBIA.VDDB.gFGAhCAAQFGA.NIEB.fGEAhDAA......hDBA...,1,-8,-25,17
HBaTdCQgEVUJRMbONAIWfFKPeGXDZcSLY,..IAAAFAAAeACHGACAZADBLAGBHAEAaAGAdCFC.QEGAhAIAECABUCGAREAAMEEBbEDD.hACAABFAKFFD.DBIBSFFAhAEABHHA.CGHA........hBAA......hCAA...,1,6,-20,26
AbSdOJXKfcgReHTDaIUVZQGBCMWYLNFPE,dAAAXAAAKADA......fAFBRADAHAGBaCDCUCCAZDAAGEEAhAAAMAIBLCFBhACAFDGHAAIBbGAAOCHH.hABAgDADeEHHDGAA.QFDC.hADACFHAYHAA.hAEAEGGB..,2,-7,2,9
JEZMeGaWYHTASXULICFdbOgDVQNfcRBKP,XAAALAAAFAEAdADA.OAGDDAFA..QBFA..hAAAfBDARDBAKBHBEDFBeEGHhABAaCAAHCEBADBASFBAhAIACDHAbFGB.NEIA.BEDD.ZGDAMFFB.hABA......hACA...,1,-6,-20,14
eLUWZSYBCfIAOdbNEPMFJTHagGRcQKXVD,dAAAEAAAFACDHADA.GAGARAEA.QCBAKBHBDCEBLDFBZDDBBDADhACA.fDFAhADAAAEA.bFABMDDB.aDHHhAAAXFGAeFEDSGCDCGFDOHFE...hAFA......hAGA...,1,5,-29,34
bQHeXKPRYfMVAGDaSFTLgJBdUWCENZIOc,aAAATAAALADA.BAHAdACACAEAZBBAOAFD..QCFAhAEAHCDBeAHBKCHBRDGBMEABhAAAADDBGEEAFFDHgFFDhAEAUFAAEFCAIGHA.....hAIA......hCAA...,1,-8,-10,2
GgALCKbUIaQTOBSMXNZfRJDeVPcWYFHEd,LAAAKAAAUACA.aADD..QAEABAFAMAHBZAGB.RDDADBIBeCABhABA...VCEB.hAAA.PEGD..hBGAcDGD.FCCH.HFAC.EFHF..hACA......hAFA...,1,-16,-37,21
QSNJXOfLYeFHDKZMdCabWVRGUgATBIcPE,TAAABAAA..IACAEACE..QAECSADHXAGBhAAALAFAeBHHHCDChAAAZCCAdCGAbCFDRFFAGGABhAGAAEEBPFHDOCCH.......hCAA......hCDA...,1,-9,-11,2
SFYVgbPeaMEUKOdfIZALCDJRWcXNGTBHQ,LAAADAAARABA.XADDGAEAHAGD.QDCAFAFAVCAA.hABA..bEADeAHHEDGBOEHDhAEAdDEAZEGBACGBCFFA.cFBAhACABHHD...SGEB..hBFA......hCAA...,2,-15,-5,10
DRJBOWfAKHcTMCEZUQFagXPVYGSNLebId,HAAAMAAAZABEQADCFAFA.aAFA.XBFDVBEBGCCA.hAAALCHBeCABdCHAREFBOHDChAIAAAIBTDDACHHA.EEGBhACA.gFCB.SFFDhCCA.IHHA.hBAA...,1,17,-18,35
gVYCMFdJZeRLQPcHKAWbEfSBUGIaODTNX,EAAABAAAGACAaACA.DAEA..TAFA..XAFAVBCBMAIBhAAAdCFAeBHHLDFBhAFAQEBCHFCBACBBbEGDhAHASEDH.OEHDNIEBCEEA.ZFFB..hAAA......hAIA...,2,-13,0,13
AIbfdOPGVJDEQYKcNaXWUeMSRLHTFBgCZ,..IAAAdAAAGADADACA.EAFA.QBGAKAEA.aCAEXAGBhBCAeDDDRFAAHFEBBBCAZCDBhBIAAEIB.OCFC.hACAPEGB.JFEBcGGA.NIAB.MFIBhCAA......hCBA...,2,-34,8,42
daHfLAFeUOJCBTRSYbPcKVMQIGXgDNEZW,eAAAOAAABADARADA...SAEH..bAGBKAGAMBBBhAEAGCCADBIBECCBdCGAHFDBhAAAACFAFDFB.CFFATGAAhABA.PHFCQEGA.XEDDhBAANCIA.aGGC....hCAA...,1,-3,-24,21
KVcHURdYSDbEBXPFWNGQJgCALOZfMIaTe,ZAAAMAAAaACAKADA.HAFBRAEF..dAGADAIBECCBBBBA.FCDBGDFAhABA.QEDAhAIACDFDAAHBLDHBfCHAhBIA.eEHHcEEC.SFAA.hCAAPHEA...hCBA...,1,-8,-31,23
QgScGADYTZIVdaXBfMRKOFNCeLJEPHWbU,TAAAZAAAdAEABAGA.RCAA.FACA.eAEHEBHF.HAGB.UDDBQDEAhABASCCFAACADDIBhAGAIEGA.aEHDhAAAMEDBOGAALEGBPGDCWEBH..hAIA......hBEA...,1,-2,-30,28
IcLdWCMZKgRANabGeSOVXQfJHDTYBFUEP,aAAAeAAA.OADCQADAHAGBDCCABAFAECEF..IAHAhADAdDGDMDDBZCCARFAB.ABBBGCGAhBAAXEFCTGCA.hAAAFEEHcGGACGFA........hABA......hAFA...,2,-12,-12,0
FCODbcTYgIBGRKAeLZEQNfUSPMXaVWHJd,eAAAEAAA.QADAUADAMAGB..aAFEHCBAdCCAOAHDDAHBTDEAhAAA..gDFAhAAAGDGAAAIBZFBASEDHhABA.XFGA.VGAA.FHFAhAGA.CCFA.....hCAA...,1,2,-16,18
CgeYLJIVEXBMRNTHbFPQWaDGfOZUSAdKc,dAAACAAA.eADALACA.JAGBEAGA.MBIBRCCAHDABFCBD..QCFAhACAaBHDGEEAZDCBAADAKEHBhAAA..gEEBhADAIHGA.BEADbFCD.DFHB.OHDA.hAGA......hAIA...,1,-6,-17,11
aYFGSReKWZQgXdJcLVTMOCAEDUfBIHbNP,EAAADAAABACAHACA....bAFBaADD.GAFARCCAeAHFZCCA.QEGAhAFAdEAALEEAMAIBhAHAACIBfFCAhAAA.IGEAPEEBSFBAKGGA.hAEAXGGC.JHBAhBAA...,1,9,-26,35
WNCGBVXQHbLIFTfPYcJRDUZeAEgOdSKMa,EAAAdAAAMADA..aACDCAGAGBDABAEAQAGAHCBBLBFAhACATCDA..fDFAhAIAPCBB.JDHBRCFFZEGBhAAAABDBSFGDKFCA.WHDGXGAC.hBAA......hBCA...,1,-9,-13,4
LHBQaZARCIUSfYNcFVMbXGEOJKgPWTdDe,RAAACAAAUACA..fADB..NAFA.FAFA.MAIBGAGAhAAAECCA.KCBD..gCEAhAAATEBAdEDAeCGHhABAHFFAaEHDAAGB..SDHHcFCAXGGChCAA.....hAIA...,1,-7,-32,25
AcUELORNQKFWVDCBgdGTeIaMYbfPHZJSX,EAAARAAAQADCFACD.DAFABAEA.GAFAeAHFMBGB..hAAAbCDDHDDBZDGBXEAAhAAAACCBLEHB.KFCDCAHAdHABhAEAaFGB...fGFE...hABA......hCAA...,2,-17,-16,1
NcZfdRJWFPAQISYbDTKXgLaOCGVEBUMHe,QAAASAAADADAKACALAEB.aAGAGAEB.EBCFhAAAMBGBHCEAeBHBZECAREGBhABAFDCBAAHAIHCAhCAAbDGDTEEAXGEACHHA.BDDD....hCBA......hCEA...,1,-7,-10,3
dWTAeONDaRCfMJGgBEFQbZUHPXYScKIVL,eAAADAAARABA.MAEAGAEABAHAFAGAZBAE.HBDB..XCGAhAEASBFBKCDDLEEAhBAAdCHAAAAAaEFBCFCAJFHB.EGBAbGFAhCFAUGEA..YHDA....hDBA......hDCA...,1,-12,-13,1
MTBdLEgOaQDXeCPfSGHKVYJWFbIAUcNZR,UAAAZAAARAEABAHBEADA..OAFCQCAADCDA...eCDFCCFA.hADASCFAHCGBKDDAVFFBhAHAJDHBFEAH.AACAMEEBhABA...dFFA.aGCB.....hAIA......hBAA...,2,-33,-10,23
YfOeKVQacgATUBbFRJXMNSdLPZECWGIHD,TAAABAAARACA..MAFAdACAZADB..EBFAGAFAHCAA.DAIBOBHDhAAAeDEFQFBAhAAA.aDGDAACAbDEBXFFChAHALECBCGHAWHBAfEGA.KFHBhCAA.gGEGhCCA...,1,-1,-22,21
LBeKaZGQgEYNMSCAHIfFRVUJOPcWDXbTd,HAAAFAAARACF.UADA.OAFC..PAEADCAB..TCFAhAAAdBHAeCDHZDDFQFFChACAECFAMEFA.AAHAfDHAhCCAVFFA.WHCGXFCABHHA...hCHA......hCIA...,1,-14,-22,8
gGHNZEYaUJMWdVDKSRCTXOeBQFbLcAIfP,..IAAAfAAAGACAHADAZAEAEAGEUCGBMBCB..dCAAKCABhAAAREDACAHBTCFA.eCHHhACAQFAAbDCDAEEAgFADhADAaEHH.VFFBXGGCFHCE..hACA......hAFA...,2,-16,28,44
ZfVFHRMSIbUaCdeOTKJDNAgLPcGXYWEBQ,LAAAGAAA.XADDEADAZAFBFAHD.HCDBRAFAMCAB.SCCDhABAbDGDUFBAdFFCeCFAhACA.TEDADDABAAAB.gDGAhAFA.cFGDBDCC.QGAAhAGAIHHAaGEH..hACA...,1,8,-10,18
YXPdfZMFgEeONJIWDSLGaRbHQCcKBUTVA,XAAAdAAAZABBMAEAFADA...EAHFeAFH.OAHBJBEB.DBDBGCFAhBAARDEAHECBQEBAhBDAKEHBBFGD....hBEA............hBGA......hCDA...,1,-25,-26,1
MLbeFdIPKCYWOVgSEDJGfcRNHZBQXTAaU,aAAAMAAALADAFADD.dAHAKAFA..CBBD.OAHD..SCDAhAEAEBBBGCEARCFFHECAhAFAZDGFQFAAhAFAACDAeDHFIHBAPEDB.YFHBgGGGDGGB.hBAA......hBHA...,2,-16,-9,7
AMTRLDdBfZbOSaPWcCJXVHgeGUNQYKFIE,RAAAdAAAZADBSADA..aAFD..PAGBCAHAJCGB.HCACGDAAhAAAQDEC.hABAFCHDACCAMCIBTEAALEEBhADAfFCAOFDBXFGAeHFA.YHAAhACA.EGFBBGGChAHA..,1,-11,-15,4
PZHVJXcGLBUgFOeCaWKdASYTRQbINDEfM,TAAARAAAQADC..IADAEAFEMAIBHAEB.JAHBGCDBhAAALCAABEEDFDEHeCCDhABAaDGCdFGAACGAbEGBfGAAhAAAPHAA.XGBDgGFDCAGCWFHHhACA......hCCA...,2,-11,7,18
RaOUKYBJCfWTIPAdHbNeZSFcGgEMLXQVD,HAAAeAAAZADBFADAGAFAEAFA.MAIBLBHBQCABRCEFOCCHhAAAKCEDBDCACCGB.TEGAhAAAABDBdFGASGEBhABA..XFECDGIB.aGHD.YHAAhACA....hAHA...,1,-11,-13,2
eaIfFTACEKDdVJQZSMcOWgGRPBYbHNUXL,EAAAdAAAQADAZACB.MAGBOAECGCABRCEABAHBHCGBXDGAhAAAeAHBaDED.FFBAABCBDECAhAGASFGA.hCAAgGFGbFCAUGGAfHCB.hACA......hADA...,2,-16,0,16
EPNUacHSWQBeOITRDJKCMFZALbgVXfdYG,LAAAVAAA.dAEAEADEUAGAHAFB.QCDCeCAAODDARDFAKAHBhAAAMDHBAFAA..bFAAXEBAhABA.GGEBhACAaFFCSFHBBEEDTGBACHAA....hBEA......hBGA...,2,-13,1,14
dbVDQCWIURFfMHTXZgeLNcAEBGKYSaOJP,EAAAGAAAKACA.aADA..OAEAdAGADAIBQBEDCCDA.UDDBhAAARCEFMDCBHCGBZDGBeFGBhAIALGBAABHABCCCSFHHhAAA.........hCAA......hCBA...,2,-22,-19,3
bDdPcFOBIJNfMYaRTEXZKGLeVUQAHWCgS,HAAACAAA.SACEdACAFAEABAHAJAFAMBFB..RBDFECBBZCCBGCGAhAAALCGBeEDHUFDAhAAAACCB..bFFDDCIBOFHDhAIA..IGGA...fHABhAHAaGCH...hCAA...,1,0,-35,35
UEGYXgZPMFSVdANQORIWJbCHBceTLDaKf,QAAARAAA.JACEHADB.eAFATAFAaBGEKCCD.EDABGCDAhAAA.XCFAhAHAZDEBMDHBSDCDhAIAAAAAOFABbEFDBEHADDIBfFFA..hBIA......hCAA...,2,-24,-6,18
FBZaCfKRegMUTJWOXbcDAHIdGNQEPVLSY,HAAAGAAAEADELADAFAFAZBFE.aAGDKCADRCDA..eBHHMCCB.UDEBhAAATECA..ODHBhACAbFADAAAB.dGGD.NDDA.QEGBhACA.SFEH.CGGD.hAEA......hAFA...,2,-12,-3,9
CQTIVaWRAOJUfcDGESNdeLYKHZgbXFBPM,OAAAUAAADADAGADA.EAFAdAGA.eBDALBHBHDBAZDFAbCFDBBBDhAFAMAIB..QFFAhBAATDBA.aGDBACHBfFDAhAIA.SFGA.hBCA......hBDA...,1,-6,-23,17
FGAgeLPHCDEJIfYQBSKaVcOWTMdNbRUZX,eAAAHAAAEADE.JAFAfADA.QAFAKCADaCCAOCEDhAAAMAIBdCCDRCGB.ZDEBGEFAhACAAAAALEHBDDDBBGCAhAIASFAA.cGEDWFHH...hCGA......hCIA...,1,-7,-14,7
WdJfKBMXQLPNFeRVSEbODcYaCHZUATgIG,TAAAGAAAdADA.KAFAMACALAHBFAFDRBDB.ECEADAHB..aDBDHDBBhAAAZDDA.AAIB..gDGAhBDAIEHAfFAEhAAAQFECNICBeFFBSGHBOHCACHHA.hCAA......hCCA...,2,-14,-2,12
gHCJIYUGSBLdMbaPZeAWVFXRNKEOTDQfc,FAAARAAAEADEDADA..QAFC..fAFAHCCACAHBICHAhAAAGAGALBDBhAIA.bDFDZECAACCAXFDBhBAAODGB.........hABA......hCAA...,2,-27,-23,4
VENOBUgQPJCDLTeASXHZbfIacKMYdRWGF,HAAAZAAA..IAEAaACAMAFARAFF.GBDBEBHF.BBHBUCAAQDDChAAACCDA.TDGAhBGAAAHAXDED..hABAbFFAKDHBdGDAFFGDOCCHgGED..hACA......hADA...,1,7,-25,32
GFgDPMVaHXZWdNACIRKfYTOSUEbLecBJQ,RAAAKAAA..TAEASACBUAGA.EAEAeCCBBAGAGDAADAIBMCCBhAAAHDGB.ZEDBdCGAAAAACCED.hAEA.fDDAhCAAOFFB.bEFA...LGDA...hADA......hAEA...,1,-7,-18,11
ZPQFYLOXTcJVbBagGIUWRAdHNCfeDKSME,HAAACAAADACA.MACAZACE.QAFALAGB.TBDA..VCDBhAAAaBHDGDDBUEGAAAIB.dFGAhAAA.eGDAEFCBFGBHOCCBhAIA....XGFC...hBHA......hCAA...,1,3,-31,34
DRZKbGLCYIedWaJAUOcSTBVNHQMFEPgfX,OAAATAAA.BADAHACBFAFAEAEA.....fAGAhAAARBDAZCFEGEEBLCFACBBDeHCAhAIAaCAC.AAIBSDEDhACA.QEAAMDDB.XEGAhAEAKGHB.bGEA.IHCAhCHA.,2,-28,-2,26
LFScATBgOdNbYfGJVeaPZDMWCKREXIUQH,TAAAOAAAdAEA....bACBGAGAeAEAZBEEMBBB.KCCAECHFhAAAXDEAQDEAhAFAHEBALFHBSDHHhAGAAAIBBGEAgFDAfGGAaGBHDGGAWCCDhCAACHHA......hDAA...,2,-9,0,9
ZOUWATdCHQEbMVfKeYFGJILgRPcDSNBXa,dAAAHAAAEADAMACA.KAFAeAFAGBDALCCARCFFDAIB.BBHAZEGBOCCHhAAAACGBTDAA.QDGAhACAVFCB.FECDIHAAhAHAPEEBSGAB.aGFDCFFD.hCAA......hCDA...,1,-4,-5,1
AafbVUXHLGNSEdPDCWMKgJRBcYOeTZIQF,aAAAVAAAHACB.GAEBEADE.dCFDCAFBKAHBREAABDED..OCDAhAAAeCHHZFFAQCGDhAHAAAEA.UEDALHAAhAHASEHDDBBBMIFAgGGG...hAIA......hBAA...,1,-1,-19,18
DUSbdZQeAYEGBIKORcWXMPNJVCgLaTfHF,EAAAGAAAKACA.RADA....XAGBMAEAJAHBCCDDLCFA.hAAAaDAHHBDC.DCCBbEEAhAAAZDDA.ADIBBEHDOFHDhACAPFFBgGCATGBA.FHGESGEHhADAdGDA....hAEA...,2,-12,-9,3
RbBOdYcSFCUGITWaVKHLAfMgXJNPeDQZE,MAAAXAAA..JADBeADAZAEB.RAGBOCDAdAHA..SBBBhBAACDAAGDDA..TFGAhAAAaBGBHDFCAADA.fEEEhCAAPHECDDGBEFHFBDHAFGFD.....hCBA......hDAA...,2,-21,-10,11
CBbGPefLWJRFQASEUTNOZVIYHKDXMcdag,EAAATAAAZACB....VAEAHACB.XAEAdAHACCBC.GBGAhAAAeCEBLDGBRCEBAAEASAHBhACAOEEHKFGDMDIBhAAAaEEHBHHA.........hBCA......hCAA...,2,-22,-2,20
ILPWdFYRVegCHcXAGfZDSTJEbQOBaKMNU,ZAAATAAAEADE..QAFCaACA.MAIBIAFA.LAHBhAAAdCAARCCAeCGFHCCAAEEAGEGAhABASBFAOFFHhACAKDBDPDFDFHAA.gECA.hAHAXFGD.DEIBhBDA.BHEA.,1,6,3,3
DTPMJEOCIbVXQUAYZgdcHWKGaefLBNFSR,ZAAAdAAAHADAGAEAeAFELAGBFCBD.RCAADACAMCFA..EDHFCDDA..hABAVDFAQEBAhAIA.ABIB.gFDAhACAKEDAaEGHBGBDTGGAOFHD.....hADA......hAIA...,1,-4,-17,13
CDBUaPceGJgWRKONTAZLSEMVfIFHXbQdY,ZAAAEAAA.MACA..fACAHAECQCCBdAEADAGABBGAaAHDeCEHhABAGDCAJDGBRGDAOBHDhAAAADIB.LEBDhBEASHAAFEEAbEGDCHGA.cGDD....hBGA......hCAA...,1,0,-11,11
eMJSNATaQGfIFXEgdRDKUCHYWVLBbZOcP,aAAAGAAA.FADAEADARAFF.KAFAHCDB..VCCALAHB.ZDBBhAAAOAHDeEGBMEIBhACASCFBAFDB.TDAAhADAfFFEXDGDdHCB.CBBDBFEA.PHAAhAHA.QGGAhBAA.,2,-22,5,27
gbDaUEMcFNSeCIZfdQOKAHTPBRXJYWVLG,HAAATAAARADF..XAFBJACA..VAGBGBGA.DAIBECCAMCABhAAAFCED.eCCBZEFBdFAAhAAAQEEAADIBBGDA.YEHBhACA.gFCGaHFENIAB...hAFA......hAGA...,1,9,-21,30
UDQXCbgJRGeTZBEVOANFPdcHLWIYMaSfK,FAAAdAAAHADALADA..IAHAaAGDKCCA.QCBA.hAEAbCFARCEFeBHH.ZECFhAFAEDABAEGB.PEDC.hAIAcEGAMEIBfFGAXFAACGGAgGCHhACA...hBAA...,2,-29,7,36
YIcCVTfJabPgMeBGWNSUROdKZHFAXLEQD,EAAAQAAADADA...IADACAFA..TBCAaAEDbAFDMAHBhAAA.eCBBGDCAhAAASCGDREEFdAHAKEHBHDEBhAIAADCBLHBAVFCBfFHAgGGBBHFAhBCA.NEBA....hBCA...,2,-5,-2,3
BWZNIAbECdMLHGeXaQSRFDcKfJgVTYPUO,EAAAdAAAHADAGACAeAFEQAEARCAA.DAHBfCEA.hAAAVCGBTDFA.PCBBhAEABEFDZGCAAAIBbEDDMIAAhACAaFFC.FGGAKCHB.gGBD.OHFChBCA....hBGA...,2,-3,-2,1
RQXOAcVbPIFeTBdCSaGMYUgfWZLJKHDNE,VAAA..bAAAFADAeAEABAGAdBHA.aCAAGCDA.UCGAfCEAhAAAZFCFLFFAhAAAHCFBEEAAQGAAhAGAAAEAIFHASHFAMDDBgGGG.hAIAKHCA.DFFB...hBIA...,2,-14,8,22
XdPGELVcYMTICDNgWQSZaBFbKJOeUARfH,HAAAdAAAEADALADB.VAFAMAGBCCAD.DAHB....gCFGhAAAQCBAaCCBbBEDhACAODHDAAIBRDGF.XEEChACAPDAB..cFFCTFAA.IGGAhAFAWFHH.....hADA...,1,2,-30,32
IVSGRKEUBfgcPWFDYdOATZHNaCLMJQbeX,HAAAaAAALADAMACAQAFA.eBDFXAGD.SBBDhAEARCEBECHFfEHAhAAAgCCBPGDAhAIADCFBdDGAABHANCCACGHAbECC.GGEB.BFAA.hCAAWDHH....hAFA...,1,13,-17,30
dCOEIWJVBLPbHcDZTRgaUQXNFAGKYeSfM,GAAAeAAAMAEAdADAEAFA..JAHBLBHBHBCAZBFFRCDAUFAA.hAAAQEFCFDEBADIBSEBAhABAOFHDIHDAhAAABFFAPFHBDGCA........hBEA......hCAA...,1,-4,-22,18
OPAHTKCVDNSFQIdGYgLWbMefZEBRXcaJU,HAAATAAACADBDAFA..FACAdBFAGAEALBHBMAHBeCAAZCCFREGBaCEBhAAAOFFB.AAGBKGDBhAAASDDD.QFEAhACA.gGGB.fHCBhAIA..hCAA...,2,-21,-19,2
cQBNDbIfEJWSXFKGLgUdeVHRMaOZPCAYT,TAAAQAAA.DADA..bACBEAFASAEAKAHBGBDALAHBhAAAdCFAHDBBRCDFaBFEZDGBABDBhAAABDFAIHCAJEGBFFAAhAFAeFFDMEIBCHHA.........hBCA......hCAA...,1,-2,-3,1
RVFSCOEBJfGdLWYbPgeUZHDMQXKcIaNAT,RAAASAAAEADE.BADAGAFAdAFALAHB..bCCBeCCBhAAAHDGBMCEBQFAAhAAAKDAAaDGC.AAHATFDAhABACFBAOFDEfGGE..PFHBhABA......hADA...,1,0,-24,24
bFGKBENWZOXLdMIfRecJgUCPADHTaQSYV,HAAAaAAA.QADC.SAFBbACDGAEAEAHBZAGBLCCAhAAAdEAAMBIBRCGBeCABhACAgEEACEEAAEGBTGGAhAIAFEHHBBBD.OGAE.fGGEhAEA......hAGA...,1,10,-11,21
LIWDSZbUXQRcFMJaBOGKdgATYfPVCHeEN,TAAA..fAAACACBHADB.EADALAFADAGAZBCAUBGAhAAARCFAMCCBBCAAGEEAdDDAAEGAhACAPDDB.eEHBhAAAIFBAbGAC.QFEAFHGC.aDAE.hAGAKEHB.gGGBhADA.NICB,1,8,-24,32
VRASTGKWLYINDXbdCZfFgeJBMEOPaHUQc,GAAALAAA..IADAXADDdAFAZAFAFAHBeCABBCDAECCBOCHDhAAAHCECQEEChABA.RGAAAAGATDEAhACAKEHBYHCGbFBAfDCEgGGBMFGBhBAA.aFHH....hBCA...,2,-23,19,42
WJGBFYaZeLAbECfTIVUdPXQSHgMOKNRDc,EAAATAAAUADA..dACAQAFAHAEAMAIBKAHBRCDB..DCGBJCBBGDGAhAAAFDDA.ZEAAABCACDGAfFFEhAEA.IGAAhAGAXEGAOHAENGDBBHHA....hAAA......hCAA...,2,-33,10,43
bDWZfKBecdGLXJCTaPARNMHQIEFSOYVgU,RAAAHAAAEADE.OACA..VAGBUAGADCCAZBEBBCEAeCCB.GDGAhAAALDDACFFD.aDHDACEBMIBAhBIAFFAA..SFFBhAAAgGDEbGAA...KHEA...hCAA......hCDA...,2,-17,-10,7
SfFbMeUCOEgQAZYLJBPVWHDKTXRcGIaNd,ZAAALAAABADB.VAEAHAEB.KAGARCAAGCGA..aCAAdDEAFCGDhABAeEAAODDBEGDAAAHAJEFFhACADBIB...TGFAhABAXGAA.IFHA...NIDB.hAGA......hAIA...,2,-28,-7,21
JSFROHCQNfbPEgcDWeAdZYGKTXIMLaVUB,ZAAAGAAAKADC...TADAMAGBLAHBUAFABAHAFBEDHDCAQCAAhABA..bCFAhAAAEDDBDDABABHB.dEGAXEGAhACAaFFBSGHHRFEBCGGB......hACA......hADA...,2,-14,-12,2
TGPDJbgVYIXeHOcaMEQfRBFNCWZUdAKLS,LAAAGAAADADAJAEA..VAFA..XBCAHCDAaCHDEBHFRDBFFEFBhAAA..CCAAZCEBAFHASFCHhACATEGA..hAIAbGDAgGGA..eHAE.MDDBhABABHDA....hBAA...,2,-13,-9,4
LHgCXBDcGRFaKbAeIPEJYZQdSOVTUWNMf,eAAAEAAAZACBdAEA.OAGBUAFA..MAIBHBCB.CAHBBCHAGDEAREBB.hAAAaBEBADFB...IDGAhAAAJEEF..QGGAhABATGGA.fHCFLCBDDEIB.hBEAKHBA.....hCAA...,2,-22,-7,15
LGIZQCbDPHBcNAVaSfgMYXeOJFTdURKEW,aAAASAAA.MADAeACH.FAEAdAHARAGFEBEBGBCA.ZBEBQDDChAIADCGBHDGBBEBAhAAAABBBVEGBfFFEhABA..XGDAOHBA.....hBEA......hBHA...,2,-16,-13,3
SKQVOJIgfdDcFAaWeMYCBPEGLURTZNHbX,eAAAMAAABADAEADAGAFARAEF.ZCCAHAGB.SBBBQECAhAAAODCCgEFAhABAdDGDFFFAAAHAaBHDCGAA.LHBAhBFANIAB.KFHBIHHA....hAGA......hAIA...,1,9,-25,34
TJeXEDPdGagMUOKQVbWcNYBRZFCAIfHLS,HAAATAAAeACE.EAFEdACAGCCAaAEAMAHBKBHBQCFChAAA.VEGBbBDDcCFChAAABHAARFDF...ZEFEAAHA.hCAALFBA.XGGA.DAIB.hCCA......hCEA...,1,3,-4,7
dBcPFfZHGMCWLOTXEVJNQgKUaISbDAeRY,RAAAdAAABADBFADAHAFBGAEAMAIBLAGB.OCCBEBDB..VCBBhACAQEDCKDFDaDGD.hAHAbFGBAEEB...eGBGhAAAPFHDCHEA..WBHHJHBA......hABA......hAIA...,2,-14,-8,6
QGNAaELdRSYgeCOKDHWcbFVZXMUBPJTIf,EAAARAAA..SADBeACAKAFAHCCA..bAEDZCFBUAGABAHBJCCBhAAATDAA.QFCAhAAAADHAdEEACEHADGBAFCHDMHEAhABAfFGA.aFHD.....hBGA......hBIA...,1,0,-27,27
GDbcLBJZQXEUSHgWeNOIfTPdFVRAKYaMC,aAAAGAAA.DADALADAZADE.EAHBHAGBeBBBOCDC.TEEAhAAAdCFARDCFAAEA.MCHBhAIAbEGBBFCAQFFChBAASGGDNDIA.........hCAA......hCDA...,2,-14,-13,1
BZCNaLRKHYfUGEgJVOWPFbedXMQIDcTSA,ZAAAaAAALADAHAEAUCAAGAGAEBHF.JBBFOCDC..FCFHeDHFhABAdDDAMDIBQEEAhACADEAB.TGAAAAIBCFFARFAFKGHDhAEAfGCB.WEAA...bGFAhADAIHFA..hAFA...,1,13,-18,31
VTDMdUaObYNIQAFPXEfJZCLKWHgcSReGB,XAAAEAAAZACBLAFAHADA..SAFERCEAeCBDGECATCEAhAAAdCHAaAHDOEEE.hABA.bDAAIGAAhAAAADAAfDGAKFHB.gFFABGGD.MDIBhADA.UGCA...hAGA...,1,15,-6,21
IYbeOLWPJAVZgCEDTQGKUXfScMHaRNdFB,ZAAAEAAADADAGAEA.KAGAUAGA..SACEHBCARDEAdDHABCCDhABA..bEBBeCGFLFDAhAAAPDHDABFACCBDTEDAhAGA..fGHAaGGBIHHA..hAIA......hCAA...,2,-24,-11,13
NDYQFcbMeGWPRgfIVEaTXCAHKZLUOBSJd,HAAAZAAALADBBADBdAFADAFAQCABFAHD.MAHBeBFBGDCAhAAARCAB..IDHAhABAECEBaCHDCEGDACCBKDEB.SFGAhACAYFBFbFFA..gGBAhBGA.fGFEhCAAXGDD..,1,-8,-15,7
UIEFSBLNcHKOWQXJgYGbMDfPARdZeCTaV,RAAAeAAACADB...aADDUAFAFAFA.LBHBHBEBOAHD.QDBAhAAAXCCAJDFBGDGAhABA.bGCAMFBADEEBAGCAhBDAdFHA...........hCAA......hCBA...,2,-38,-2,36
gbXJGEBHTMNZQaIedVLUScCOYDAFKRPfW,RAAA..fAAA..bADBGADAHAFAMCCBZAFAaBCBeCGFhAAAdCGALDAASCHHhABAODFHAAHAKDDDgFCAhCAAEEHFTGAAQGDCIFHA.cGGChAAADFFBFGGH....hCDA...,2,-9,9,18
XgHJEBSUMOeNVDFKPcWRQdGbfTLIYAZCa,aAAAHAAABADAMACA.eAEADAFA.KAHB....PAHDRCCAGCFAhAAA.bFCATBEALDHBhCAAABBBZCCFCHCAJHFEEDAAODGBhADA.FEHD.QGBA.dEEAhBAA.fHDBhBGA.IHHA.,2,-6,6,12
fePDIHMEJFQaSKgVcTGZYdNWUXbLARCBO,RAAAOAAAeADE.DAEAHAGB.EBDFQAGA.aBBCKCEA.gDGAhAAATBEAZDBAdEEAhABAUDGAbGAA.ADDAfFEAhBAAMCCBSFHHcGED.....hAGA......hAIA...,1,-5,-16,11
FNJAPUEDSVRKTYaXecWfgHCIObdQMZBGL,EAAASAAARACA.KADAaAFA..eAFE..fBFAhAAAHBECOCCBdCCDZCGBGDEAhAAALDABFCHDADAADEDBTFEAhADAXGGA..cGDC.CDFAIGHAhAIAMIAA...hABA...,1,-7,-16,9
RgZaJLOSGCIHKBFMQNXbVTUAfeYdEWPcD,eAAAEAAA....PACCRADAaAGALCCA.GBGAHAFBFAHFhAAAMEAAQCCAhAFA.bDFATEEAhAAAAFDAdFFADGIBZGCASGGAKHDABHGA....hABA......hAEA...,2,-11,-5,6
cZCOXLTHgDUeVPdKbAaFENJQSBRGMfYWI,EAAAQAAARACA.GACBMAFA...fAGBIBGAZCCAhAAAXCDAHDAADBIBeCGBhAAAdDGAACHAaDAAFEEHSEHHhADABEEDcFAALFCBTGEAgGGBhADA....hAFA...,1,-4,-9,5
FPXYMZLAQBWeDVURcCTKEgNSfJOadIGHb,QAAAeAAADAEARAFA.CACA..KAEAEBCA..SAGBOCDCdCHAHCDAhAAAFEEA...XDFAhAEAZFCAAAAABGGAUFCA.hAIATFFAfHDBaFHD......hCAA......hCBA...,1,-13,-27,14
UYfJMQDLGSbZNWBRHOVKcAPgdCeIEaXTF,dAAAeAAAEADA..aADDFAFDUAFA..JAHBMAIBLCCBGDBAZDABhACABDDAHEDBKDGAACEBCDHATFDAhAAA..QFFChADAbFFB..WFHHOHAA...hABA......hBDA...,1,-12,-20,8
RGAfDXCQPNgEBdKeLVJWbZSFMIYHaOcTU,XAAAQAAA.....gADAEADAdAGAeBDALAGBhAAAVDAA.bCEDZDDBMAIBhADAHDFAaDDBTFGAREABAEGACEHABGCAhAEAKHDASBHHFGGA.....hBCA......hBGA...,1,1,0,1
fGdaJOQRbFMBNTDXgWeAVEKcUCHSYLZPI,EAAAKAAACACBHACA.LAFBZADB...fAHAaAFDQCGAhAAARCDBMCCBBAHADCIBXDGDhAAAeCCDAEEA.cEAChAEASEFH.IFBAdGEAOFCDbFDDFFHBhAHATGGA...hBFA...,1,15,-33,48
EHaFBAgceUfTPIQGCRKMYJZbWSVNDOXLd,eAAATAAAQADA.RAFA.MACAZCCASCGADAGALBDAhAAAHEECaBGDABEAUGAAfCCEhBIAIGHAGEDAhCAAKHCC.bDFANIEB.dFFA.EHGA.....hAAA......hABA...,2,-4,2,6
aJLgZQSXdHKTcVBOYDfGCMbANUFEWRIeP,FAAARAAAeADE..aACDLAGBZADB.QBDDdAGAHCEBTEGAhAIABDEDDAIBGFBBMCCBAAAAhCAAEGGB...PHDChBAASDGAKCHB.OFFA.CGCAUGGBhCGA......hDAA...,1,-3,-17,14
efdDXPHBMUJSQbFCRTNaIVYgZKAWLGEcO,GAAAEAAA.eADAdADAXAFAHAGBMCDBUCGBQCEC.hAAAbEFARCBBaDDA.IFAAhAFAgEAAZEEAAAIBLGEAhAAAOFCCDFIBBGBAFGGHNIAB.....hACA......hADA...,1,9,-7,16
TWFdROXaIUDAQJNKLfBEeSYPgGVCMcZbH,QAAAKAAALACBEACAeAEA..SAEA.gAGHhAAAGBGAMCEBbCDBHDFAhAFATEAA.dFDDRFDAaFHBhCAADAIBAAEANICBBCHAPFHD.CGCD....cGEDhAAA....hCAA...,1,12,-23,35
LMdgPaNXBCJASQbFIWROcfUYTEDHKVeGZ,QAAAFAAARACF.OACCUAEAEAGAHAFB.eAHBZCEEdEFA..hBAAaCDBBDHAAAEASDFAhAAA.bEDDIFHAhBIAfFFBDICA.KGHB......hAIA......hCAA...,1,-8,-40,32
YEXbMBLHNfJdRUVWCcQaPOFITAGgSDeKZ,GAAADAAAeABAZADA.EAGEMAFAHCDA.JCHBRBCAUBFA..CDCDaEAChAAAFDEHABIB..KEFBXDGAhBAALHCA.dGHAVFGBhCAAQFCA..OHCA..hCBA......hCHA...,1,2,-24,26
FeOdAEYPGCIfVBTcSUQLNDXWZHRMgJabK,EAAAGAAA.CADA.IADABAFA..TBGASAEH.LAGBhAAAXCDAHCBAhAIARDFFMDABaCHDbDEDFDCHeDHHhAAAABGBfFHA.......hACA......hADA...,1,-9,-26,17
HUXMeBVKZSTNLEIGJCDgbcPQFdORAWYaf,aAAAHAAA.MACAeACHKAFAZADB..SAHBTAFALAHBhBAAEBDFGCEADBBB..bCEDQDGChAAAdEGA.ACCBfEDEhCAABGDAIHHACFHAgGCBhCGA.FGGHWHCA..hCAA...,2,-20,10,30
cLgfIDKBNdXUGbWRCVPeJEOSZMFaAHYQT,HAAATAAALADB.IAFABACBdAEAGAGARAGBCCCA.eCAAhAAAECFFZEBAaCEDAAIB.QEFDhACAfDHAKGDAXFFChAAAUGGB.bGAA.......hCAA......hDGA...,1,2,-18,20
gYGdIHQNcTFZCWVRKSAUeLfabBDMEXJPO,eAAAaAAABADAEADA....XAFAOAEDGAGAHCCAQCFChAAATCCAZDAFCDHARECAAAGBLEEBhADAbFGBMIAAPGAChABAdEGDIGGA.NIAB.......hAIA......hBAA...,1,15,-17,32
gJfCMUKOdEIPBTbGZLHaQeNFWDVcAYXSR,SAAARAAA..fADBMADAOAFEEAFEBAHBGBCAHCCAhAAAeBEBFCFADCGAACIBXECAhABACDGAdFFA.TFFAhCAAZFGBaEEH.NIAB.WEHB......hCCA......hCEA...,1,-9,-22,13
gBAERZfcDCHWLVUGJKeaFYNdXPIbSQTMO,RAAAZAAADADAHAEALAGBGCAA.eAHHFBDDdCFCXCCA..IEHAhAAAbCFD.QFBAhABAMDIBBFDAEEEBCGADWHAAhABAUGGA..aCCHPHEA....hACA......hADA...,2,-18,-2,16
ORANZVfKHQUJacbXLgeWSFdPTIMEGDBCY,ZAAAKAAAHACBQAEAaAEA...XAGAeAGHFCABdCAA.TCDAhABAECEFGDGABCGAOCCHhACAAAIBVEBA.UEFAbFED.hAAALFHB.SHAA.MIDAhADADCIB.....hACA...,1,5,-8,13
dRSUCIcFXeOWBEfYgMZKNJPQVbTAGDaHL,aAAAHAAALADARADFCAFB.FAHBeAGH.BCADEBBB....fCEAhAEAMAIBZDAEKDFDPCGBhAFAQEGA.hBAAbFCBACIBdECA.SEFDIHHA.OEHDhCAA.YHFAhCDA...,2,-23,-12,11
aWfCMUHgbEcDAXSRLBeFTGNQKYJOPdVIZ,RAAAeAAAGADAQADAKAFA.OAFCdAHAZDAAaCCBCCCD..HCFAECFAAAAAhAHALEFAFCHD.TFAAhAAAJDDBVFEA.IHHAhAIAMHEA.........hABA......hADA...,2,-11,-5,6
gaSKdLDbEeIRZVXMAOYBQJfGWPCUTHFNc,BAAAQAAAGACACACAHADBFAEA....NAHA.aAFA.dBFALCABhAAAEBHFREEA.ZCEBMDDBhAAAAAIBODGHJFHB..fHEBhAIAPFHD........hCAA......hDAA...,2,-28,-12,16
bfJWGIEXLaROFZDCVTgYHPcKMAdUeQBSN,eAAAQAAABADA.SACA..bAEDJAFAGAGA.hAAAECCAaBDEREEAZGAACCFATDAAhADA.HCGBKFHBAAAAdDDAhAIAfGGEXFEAFFHDDGBA.....hAGA......hAIA...,2,-19,-1,18
GbABRdMcDUSTEHCeOWXILKVNZQYJaPfFg,RAAAdAAAMADADADAUAGA..EAGAHBDB.eCAAXBDALDGBhACAKBHBZDDAQFBAhBAA.aEFBFDHH.bEBCABFASFHHhBCATGCAOFFB.IGHAhAAANIBB......hABA...,2,-19,-4,15
TNEIXZLOSMPVRDBHAUFedgYGWfcaKbJCQ,eAAAdAAAGADA..fADAaAFAKBGD.CAFA.QCBDhACAEAHBZCCALCFBMAIBRDFAHFBAhADAAAAAFCHH...gFFAhBAAcECAJFAAIHHASFGADFDA.BHFAhAFA.....hBCA...,2,-9,-6,3
EFIMHLfgaKWUZABbRPDSVcYeNdJGCTQOX,RAAASAAA..VAEAeACHdAHAGAEAQCCAEAGAMBIBhAAAHDABLDDBaDFAKEFAZFEAhAAAAAEBbCGDDDIB..cFFChABA...YGAA...hABA......hADA...,2,-17,3,20
AJeNUMZRHGBcSXELYbFCPfaQTDOVdKIgW,eAAAMAAAHACCGADASAFBEAFALBHBFAHB.CCCD...aBBCTCFAhAAAOCDEdFAAKCHBgDBGhABAAEEAUFFABGEChBAAXEFC.PFHDDFIB.IHCAhAFA......hAIA...,1,-2,-18,16
dBFRGYMNDAWSELKQICeVPfJXOHaTgUcbZ,EAAALAAAKACA.QAEAeAEE.VCAAJBEBHCFB.aAHDTAGAhABA.UDEAZCCFdDHAhAAARDGBGECAMFFBAGGASEADhACACGHA.XGGAOHAA...hAHA......hCAA...,2,-14,6,20
EbKacOfLRFTAGYCVdUHQWPgNXJIZSDBMe,GAAACAAAdACAHAEAQADA..gBGAXAFAZCDABCBDhAAAECHFKCEDaDAH.fEEAhAAAREAAAAGAUEFA.PEHDhACAIHFAMFGB.eGAAODHD...hADA......hAGA...,1,1,-20,21
ZPKCOHMJLbRWUIfVYeNTEdDcQGaAgBXSF,XAAAZAAACADBHAEBLADARAGB..UCAAIAHA.VCDAhAAAeDDB.EDFFdCGAQFGAhABAAAEASDCDKGAAMIAAhACAbEFA..fGGAYHEA.DICA.hAGA......hAIA...,2,-12,-10,2
fXAYVTMEbSHcDdLFCgBIGaQJWNZPeRKOU,TAAAEAAAHACA.dAFALACBCAHA.BAEAaCCC.QAGAhAAA.NCEA.eCFA.REAAODHDhAAAXCFCAEAAMEEAhAEAbEAADDIBFFFBGGABWHAAKGHDfFFAhAEA.SGHBhAGA...,2,-13,-4,9
FOVKGTeHDdBfLCNUaIMXbYcgJAQRPESWZ,RAAAEAAAZADBFACDKAFA..eAEAHCEBBAHALAHBUCEA.MCCB..hAAAXCGA..hAAAbDAD..gEAAhAEAADABQEGASDDDOGCC.GEGAhAFADGGBCHHA.aFFB.IHCAhCAA..,2,-14,-6,8
YGIOCXPSDgRadebcfBFJAWVLENKTMZUQH,LAAAEAAAKACA.ZADBHAEBGAFACAGA.SAHBRCCBdCHA.eCAAhABA..bEABBDEAAAIB.hAAAVEGBMDGBQFBAhACAOFEBDFHBaFFH........hBFA......hBHA...,1,-8,-19,11
dLTbBPgRfJeWFXUGOIaEYSQNAHcDZKMVC,HAAAZAAAMACAdADATAFABAFA..RAGF.eAHHFBEHGDEBOCABECCBhAAA..QFFBhABAACFBKDFALFFA.bEDDhACAfCCEXFAAaHACSFHHDIDACHHA.hAFA......hAHA...,1,8,-23,31
WCONKefADLHYUMaBbPZEQJcGRIXTgFSVd,HAAAMAAABADAZADBEAFA..QAFAGBGARDAA..TEEASBBBhAFAdFCAOEHDeBHHACEAhAIADAIBLDDAaGEC.hAAAbEFA.PFDB.IGGA..hBAA......hBHA...,1,2,-20,22
RcCSUXDbWKHJTFNeQZfMaEGIBOYPVdAgL,RAAASAAADADA.KADAHAEC.TCCAeAFEZBDEMAIBECGAGCEAhAAAOCCH..PDHBhABAAAAALDABCECD.bDFAhADAFGDBQEDDaGFDBHAA.dGGA....hAIA......hCAA...,1,-4,-8,4
GFBUdeTYfEHPOLIDVCARXbJWgaNKQMScZ,RAAAXAAA..bADBJADA...aAGAQAFA.MAIBhAAAZBDAGCGABCCAeCEHhABATDDAEDGBHFFAhBHALFDADHDAAEIBNHBBSGHH...hCAA......hCCA...,1,-14,-16,2
KRLcCgaYFfIMBJSWOHNZGVTDdQEPUAXeb,eAAARAAALADBCADA..aAEDFAFA.MAIBSAGAHCEBGDGAhAAADCCBdCGAEDCB.ACCAKFBA.hAAA.gDCHhABA.fEFEBGDAWHCAZFGB.TFDAhAGA.PHAA..hAHA...,2,-23,-11,12
ZDHKQIAeCYBEWRJMNFVbaULSOdTcXGfPg,eAAABAAARACAMAEAFAFA...aAGELCAB.dCCDTBCAGCEAhAAAfBEBZCGBHGCAQGGAhACAAAAAECGAJDEBbFGBhCAA...SDGA....hCBA......hDAA...,2,-17,-9,8
HGTSQeJaZAKILYPfcOUCdNDXgVBRFMbWE,LAAA..fAAAOADDdAFAXADABAHARCAAMCHBhABAEAGAHCAAGDEAQCEBhAAAeEHHZFBAABIBKCHDIHAAhACAcEAC.CEEDDEGB.FEHD.bGAASGGDhAHA...hACA...,1,-5,-11,6
IFAcLKdVNBObHMfJRTgUDZPeWCYaEXQGS,LAAAdAAABADAHAEBMAEARBCAUBGA.ZABBeAHF.CBFB.EDCAGCAAhABAFEEA.ACAB.KEHBOCHDhACA..bGAATDEAhDCADAGA...PEDBaGGB.QFGChDEAIHEA.cGDD.hBAA...,1,3,-23,26
aOSfBYLMIdQKPHFJNbGCDETRZgUcWeVXA,aAAASAAABADALAFAdADAKAFA..HCDCFBBH...JBHBGCEAhADAEDBBZEEAUDGA.eDCFhAGAAAAAOFABMHAAQGGAhAHAbGCA.DICAgGGA.hBAA......hCAA...,2,-15,-10,5
HEaKLTcFAQJCBUXbedRWOZINYSMfgVPGD,QAAABAAAUACA.eACARAEAZCBA..IAGA..SAHBhAAAMAIBVBEBGCFAhAFAHCGBEDAAaDHDLFDBhBCATDCAAFFAXFGAdGHAOFFH....hCAA......hCHA...,1,3,-18,21
LdgTGAEUbXKacFZCPDJIMBefWYSHOVRQN,EAAAXAAAKACA.FADAZAEB.DAHB..MAGBeBGD....fAHAhAAASCCBHBCBhABAREAALEEBdCEAGDGAhAHAAAIBaDHDCFFD...IGGABGED...hCAA......hCBA...,2,-25,-19,6
PZeKCULAgJbfaVTDYBXIdcRQEFSMGWHON,JAAAaAAA..DADABADB.dAFARAEAFBBHGBGAHCEC..OCCBZECAeCHHhAHAKDEA.LHCAhAIA.ADDB.bECD.TFFAhAHAXGGA..IHHA...hBAA......hBDA...,2,-31,-18,13
DeGdAQMBOYVcZfCNSFWgXLKIUbPJaERHT,MAAAOAAA..VADAZADBCAFA..FAGA..XAGDLBBBKBBDhAIAICGAUDFA.JDDAhBAARDBBDDIBGEGA.ACIBBFFChCAAfFEE.SGGA.hCBAWHEG....hBAA...,1,-20,-38,18
KMGTCOZadSDfYgAXBVUbFEeJNRWcLPHQI,BAAAUAAAEADAeACA.RAFALCAAHAFAQCDAKCEA.GCGAhADATDGAZFDA.dHABDECAYFHBhAHAACHA..bECAhAAA.FFHD...NGAB.......hACA......hADA...,2,-25,1,26
cJbHaGWBeKIUNYXVdMLFTPOAfgERCZSDQ,EAAARAAAZADBDADA..QAFA..bADAHCEBGBGAeBHHKBCDhAAAIDAAUDDAXFCChAHAdCCCMEIBLGFAhAIATGDAAAAA.CFGASHBG...hBIA......hCAA...,2,-21,0,21
GXIADJUbNHOagKFPMEYBeLSRZfWTQcVCd,DAAAUAAAHABCOADAaAEA...FAGDEAHBBBDAeBEFLCFAZCFB.hAIA.TFDAQDBAhAIACCCDdDHA.GEDAADFBJHEE.hBAAbFFB.KFHB.........hCAA......hCBA...,1,-12,-16,4
aMEIBOgdTRGPebFAVcZKJWCXSNHQLfUYD,ZAAAKAAACACBSACE.HAEBLAEAUBGADAGAEBHFOCCAhAAA.dDDDRDDBeEHBAAFA.hAIAVGEAJDGF..XGCAhCAANCCA...QGGB..hCBA......hCGA...,1,-12,-31,19
DHbKgNUJIMPBfZWLeEXVFTcQSdOaAGCYR,GAAARAAAHADBKAFAUADA.MAGBBAHB.ZCFBeAHBECCB.FDDA.QDGDhAAAdDAAAAAADCIB...hADAbDBDJEHF..fFFEhACALEEDXFAA....hAFA.cGGCaFHHCHCA..hCAA...,1,-4,-21,17
LGaARcWCMDJPZeIbTVgOFUBEHXKdYQSfN,RAAACAAADACAZADB..eAFA..TAEAOBHDBAGBHCEB.dCCCQBCChAAASDABLCGBhAIAAAAAMEHB.JDEBbGAAFFHDhBIA.EGDBKGFB.........hCAA......hCBA...,1,-5,-33,28
VEKdDcGPZNeLYRTIQFAJBfOXbHWagSMCU,BAAAXAAAHACA.aAEAMADA..CAHAECAAdAHAGBCA.ZBEBhAAAeCDARDGBTGCAQCGAhAAAABEBOFFBbECASEGDhACAKGHB.DECA.PHAA.LFHBhAHA...hABA...,1,6,-13,19
CYUZJQVEfIXSbWPLBcgGaFeMRTADNOHKd,OAAAHAAAdADAUAEAZAEBQAGA.ECABXAGA.hAAAbBCDLDDA.hAHABDHAGCGAeFFAREDAABBBhBAAKGCACEBD.YHDGfGDEIHHASFHHhBEAWCCD....hCAA...,2,-21,2,23
UPQdOVgEGbHFMZaKBWDJTAecfSIXYNRLC,eAAASAAA..XADARACFLAEBCAGAQCCAdAGAOBHDhAAAEBHFHDECZDFAaEAABECAhABADFFAAFFBfFHAhAIA.IGBAUGAAgGDAFHFC.hBGAKGGA.....hCAA...,1,-8,-10,2
LFJCZBeXRSYbHgcQdAGDfOWEaNUPTKMIV,GAAAOAAA.EADAaADDUAGA..KAFAMBFBLAHBFCDB.ZCCAeDADhAAARDFF..SDBDhAFAHDFBQGBAhACAABBBfEHAPFHDTFCAIDHACGHABHCDYEEFhADA....hBAA...,1,-4,-16,12
NSgKETILbJRdUPYBMVOcCFaDXWZGAHQfe,HAAAeAAA.SACEEADALAGBRAEFdAGAUCCABCCAMAIBOBHDFBFBDEFAhAAAZDEAAFFA..QFFAhABAfFHAKFHBbGDAhAAA............hAIA......hCAA...,1,-15,-17,2
BXOgGUAFRDLcHdNCMbeYWEISKfaJVPZQT,RAAALAAAHADBdAFBMAEAeAHH..EAHFKCCDaBCE..VDEAZBEBTCAAhABAODAB..GGBBhAAAACGBDCIBCDDC..bFGDIEGAhACA.fFFE.PFHDhCAA.BHDA..hDHA...,1,-2,-22,20
AGTDaPQHfOFcRJBLeZIMVdSYgXCKEWNbU,GAAAaAAAHACBFADARAEALAHBeAFHZAGB.MBBBdCDA....SCHHhAAAXCEAEEABbDBD.hACAAEEADEHB..QEFChBAAOFFBBGHAIGHA....hBCA......hBDA...,2,-15,-11,4
ILSbYENCPAZBaRgGFdcKJWXTUOMDQefHV,aAAARAAAGADA.dAFBKADA.JAFA..TCFAMBBB.DAIB.eCCBhAAAHCCALDABSCEEhADAEDHF.CCHAAEEAZFEAFEFDXGBAhABAOEHBfHCB...hADA......hBGA...,2,-27,-6,21
CTXFURJZEYVgcGBALSOMIDKQbafHWNdeP,LAAAMAAAKADA.aADDHAFB.dBBAeAFACAHA.TCAAFCEH.RCEAEDDBhABA..VDGBGEGAhACAACIBODCDQFAAhAFA.bFCAfFAAPHCC.XGGAhAFA.JHAE....hAHA...,1,21,-21,42
CfXVEAaODWNPGcZQdSJLFKYIBbUTMHgRe,aAAADAAA......PACCZACBdAFALAFBKAHBBBBDUCCAHCFChAHARCGF.eCED.XEBAhBAAAAHAOBBHGEFAhBEAQFCASFHBFFEEIGHA.MIBAhBAACHHD.....hBFA...,1,-14,-19,5
MHQLaPAGTZVYUdbDIOcCXJNSWRKgBFfeE,ZAAAUAAAdAEADADAOAGB..XAEA..SAHBhABARBGFBAHBeBDBHCAAaCFHAACAGCGAhBEA.TEDAhCAAbEFA.CDEB..WFGDFGGBMDDB...hCCA......hDIA...,1,-20,-26,6
gdIKMLQTPFJSXBWHNGODYCafZbAEUVRce,EAAARAAAeADEdADA..MAFALAGB.TBDAFBFASBCDhAAA.BCEAHDDCGDEBhBDADAIBaDHDZFFAAAAAcFGChCAAKHDAJHFA...XGCA.OCCBhCGACCHA......hDAA...,2,-16,-14,2
MGcJEePUDdYgOAQXTSHLaNCBKbRfZFVIW,TAAAHAAAaACA.BAFARACFZAEBFAHB..VAGBMCCA.GCEB.hAAAEDDBeCAB.DDGBdEHAhAAAODHDAFAAQFEAhAFALECACHHA.fGGA.IHEAhACA.WEAD..hAEA...,2,-18,-6,12
RNOLWMCdYaFgSfKPXbAIEGHZTcJDQeBVU,EAAAHAAAZACBTAEA.DACAeAEABAGBRBFALCBDMAIB.dDEAaCCAhAAASDGAKCFA.hCAAXECBADDBGEEAQFGAhAAANEHACHCA.FFAH.fGFEhAFA.IHDA.hCHA...,1,5,-21,26
bHGVUXMSRTQcYfLPFAaZeINCgWJOEKdDB,eAAACAAA..JACAEADA.dAGABAFBHBEBGAGAXCCB.RDGBQGBAhAAA.fEEEhABALCBAAAIBZGFEhAIAgDEA.KEHBDBIBbFCC.MIDAhAAA.SGFAhBCA...,1,10,-44,54
bFEcCaSINgTDeAKHBJPLMWdZVQOYRfXGU,HAAABAAALACAdADAZAEBQAGARAFFGCCAFBHDECAB...aDABSCCDhAAA.gCGGhACAeEAHACCBKEFAMEEBhBIAOEHDXFFAbFDDCGGD......hDDA......hEAA...,1,-7,-14,7
UQLTEBFdCRegcfXYSWVIMbDHKJZGOaANP,UAAATAAAEADA.BAFAdACARAEA...eAHH..fAHAhADASCDHVCDAMCGBHDGBhAHAZEAAaDHDACIBQGCAhBAALFEBCGGAXGEAIHAAKDCD...hAAA......hAEA...,1,-5,-13,8
AIOVFXTELRHMKNbPQGDeaWJgZSCcfBdYU,OAAAXAAALAEAHADAKAGC..bBBCGCDB.eCHHaAHDJCEBhAFAZDAACEED.BFAAdDGAADDBhAGAFFGHRDBB.MFIBQGCAhBAADGCASGEHfFFEIHCAEFHF.hBDA......hCAA...,2,-5,0,5
QMBYSPOHeZLaWGAXNKEgfTJVRFUcdCIDb,KAAAEAAA...TADARACAFAFAdCCDDAFA..MAIBSAHH.HCEBhAAAeBFFZDAAaBGDACGB.XCAAhAAA.fDDAhACAUFGACDHAIHDAbEFAQGEA.hADABGHD....hADA...,2,-23,-13,10
gDSQOTBdFEXUAcWMHIfJaZLPGYCNbVKeR,MAAAHAAAJADAZABEGAEA..CAGBVCCARAGBDCCB....QDGBhAGATCGABCADEDDBAAIBhBAA..IEFAhAAAaFFB.LFCB.PEHD...hCAA......hCDA...,2,-24,-22,2
VEODPaWIZUQSdLcNJeBTHMYKRfAXCGbgF,GAAAFAAAEADA.DADA..aAFDZADE.QBGAdAHALCCBJCDBeCFBhAAAHDADMDGB.REDFADHAhADAbEGDOFGD.IHBAhBAASEFDBHEAKHAA.....hBFA......hBHA...,2,-14,-9,5
BeRUcFaOdCEYMQINAGVDHSJbTWgKfLPXZ,GAAAHAAASACEJADA..TBGAKAFALAHBZCDARDBFFDHDdCCAhAAA.ECFAMEEBQEDAhAFAAAABDAGA.bFFB.fFCEhCAABFFAeFCHaEHDCGHA.IHEA.hACA......hBCA...,2,-17,12,29
BGMLZRaWVFOeDXQNTcHUJYgEKPbfICdSA,GAAAZAAARAEA.aADAFBHDDAGA..QCAA..TBFAhAAAHCDAUEFAgCDBhACAEEABKEHBbDBDCGCA..AACAMIAAhABALBHB.OEFC.eDDD.XGGAhBAA.JHDA.hAEA...,1,11,-18,29
ZedFbWGaUIAKBYHRPfXTcSMJCNQDOgLEV,BAAAHAAARADF..XACATAGA..MCABCAFADAHBLCFA.hAAAECCBeBHHdEEAbDADaCAAACFAhACA.KDAA..fEHAhAAASDCHQGCDODGHZEDBFGFDWFABhADAIHHA..hACAcFGD.,2,-32,18,50
fZJWEKNRVFcBdPLQHUCIDMTYGgbeSOaXA,ZAAAEAAARACAFADA.dAGALAFBHCAA.UCCBDAIB..MCEBGCGA.hABAeAHBaCFC.ADAAJEFFKDHB.hACA...VFEABFCAhAAAQGBACHHA.IHHA..hBGA......hCAA...,1,-16,-20,4
RMOgKYFJHBDNEdWQLIeCcbZfVAGSTUPaX,GAAATAAA.aADARACF...MAGBKAECFAGDHCDBDAIBEAHB..dCEALDCDhAAAeCAB.bEGBZDFBhAAAACHBSFFBhACAXEDCODHD.JHEAWFHHCHHB.....hACA......hDCA...,1,2,-13,15
QNDICFUaYKeLEOHgWMXdcAVJSGfBZRbPT,SAAAGAAAZADARBGF..TADAQCDADAFAFAHDaAGA.eDCBhAAAEBFFHCCB.MDABhAAAdEGDAAEAVDGBBFFDbFEDIGHAhACA.YFDBKGDDgGGGhABA......hADA...,2,-5,-4,1
fbXIFGOAJMUWSZELcaBVDHTgCQNeRYKPd,MAAASAAAZABELAFABADAHAEB.TAGAQCCA.hAAARCEAKDHBdCCAbDABFEFDAAGAUDGAhABAEFCA.aEDD.DFFBCFHDeHCAhBAAfGAE.XGGAIHHA.hADA......hAGA...,2,-9,-7,2
DEdfMBFeGCagPVcbHZOLNTYJKURIASQXW,QAAADAAAEACA.dADAMAFAeAFAGBCBaBGE...VCGBHCDChAAAZEEFLDBB.hBAATDGAKFBAIHBAhBBAAAFAXEECBFDBCFHAgGGGcGGA..hBCA......hBDA...,1,-6,-17,11
XbYEAQdHIcZfVWFJMBLaUTPgKGNCSOReD,HAAAZAAA.VAEAFADAMAGBLAHB.aCACTCAA..KCCCGCEAhABASDEARDGFeAHBhACAbEAAACEBdGGD.IHCAhAIAfEGA.BFHA.gFDHhAAAODDHDIFA....hCAA...,1,-1,-10,9
CEWJYVfMgTSOadBIRXPKcQDLeGFAZNUHb,ZAAAHAAAEADEJADA....VAGBMAHB.TCCAaCAABCEA.RDEA.hABAKCADDDDBeCEH.AAIBUDGBhAAACEHA..fFAAhACAOECBdFFDXFGCcGAC....hAFA......hAGA...,2,-31,-9,22
eDfbZgVUNRFALcHaSQIBOTPEYWJKMXdCG,HAAAaAAA.QADCOACD.EAFEJAEAMAIBdAHAGCDAeCABbCCAZCFAhBAA.UFFARCGB.ABBBLEBBhBEASEEABHEDhCAATGCA.PFHD.KHAADGIB...hAAA......hACA...,1,10,-12,22
XVJHENbDCdcPIGSLBWRYOKUAeQFaZgMfT,eAAAaAAAZACBMAEA....TAEAXAGAHAGBEBCADBBBdCEAIDEAhAGAGCGALDDDhAAARDFFKECAAAIB.QGFChABAfEHAJFBBCGHA........hBFA......hCAA...,1,-3,-15,12
AGZCWKEVOIadXRNfFYBcLTHSDJeQbPgUM,ZAAAKAAAEACEOACA.dAGARAEFFAGABBEA.LDDAHCCBDCGA.eDGBhAAAQEGA..hABAbEADPFDBUFEAACCBCCHA.hAIA...IGBAaDHF.fFFEhBGAcGGD.....hAEA...,2,-18,-17,1
VKHaEXeTFCAcWJDUfRQGbNLMBIPgSdOZY,JAAADAAARABAGADALAEBBAFA....IAGASAGHZCFBKCHBhAIAHDAA.ECHFeCDDhBAATEFAAECB..UGGAhBIAbFAAMEIB.gGDH...hCAA......hCBA...,1,-7,-29,22
EZXPCOgFMVTbDaWRGKSAfNdLYUBJecQIH,dAAALAAABADAeAEHQAEAHAGBECBAZAGBCCAA..FDAHMBIB.hACA.TDEAaCCARDDAGEAAhABAAAGB..fDHAhADAUFFA.IGDA.OFGBhAIA......hBAA...,2,-23,-8,15
KadGNZcQgHVSJXUYOfWbCPRATLIEBeMFD,TAAAEAAABACA.FAEAaACA..GAGAZAEBQAGAHBCC.SCCBhAAAXDDAODGHhAAAbCFDRDBB.AAIBeEHHhCAAMDIBdEECNIDB...gGGB.JHDAhBDA......hBIA...,1,1,-11,12
eGIMSdDCgQFJWXaRPAOULcTYVbNBKfZEH,LAAATAAA.VAEABACB.ZADBHCAAeAFAGCGA.MAIBhABAdCCCCBHAQDEAhACAFCFBXDGAREAAACCAOFHDhAEA.YHAAbEECfGAASGGDDGGAWHDAhAAA....hAGA...,1,20,-28,48
JFgGbScdTLOaNQYXCPfeRMAVEIWUZDHBK,EAAAUAAAHACAKADA.FAFAGAFA..bBFAdBHALDDAOCBE.aDGDhAAAQECA.hAEACDAD.eECBAAHA.IGGAhAIAZEFABFAA.SGGBNEIA...hCAA......hCBA...,1,-11,-24,13
ZOeXGbdPTFBYfMDUNWJALIERSQHgaVCKc,EAAARAAAHADB..aACDKAFAZADBeAHHGAFAdDAAFCCHBAHA..MCGBhAAADCBBUEFB.JFBAADFBLEHBhABA.QFFBhADACCHAXGGAbFAAPHAA..fHABhAFA.WEEDhAHA..,2,-28,3,31
NVGcBXDMPaYIKJEHTZeSFRdLCAOWUfQbg,OAAAUAAAQADA..bADAVAFAGBGABCDDMBBB.hADAaAHFKCHBHCCAeDEFREAAdEEAhAEAADGB...fFHAhAFAgFFAXGEADFIB....hBAA......hCAA...,1,-1,-27,26
NXdRbfVCEaePABSQKUIWLDcYgOTFJGZHM,QAAAKAAAUACALAFADADA....gAEATCEAGCGAhAAAHAGBMBDBdEBARFFB.hAGAbDFACDDD.EEDF.eFFBhAAAACIBSGCAIHHA...YHAAhAHAFGDD......hBEA...,1,4,-18,22
UfaYLJbTZAgBOXCSGEPMdWNFKDeIcRHQV,OAAASAAAGADAEADA.dAFB.FBBHeAFARBFF.HCCAUEFBaBGELHDAhAIATDAAAAAABCHAhBAACDFAMDHB...KEEDhADADDDBQGAA.fGFAhAGAYFHB.ZFCF....hCAA...,2,-17,1,18
LCZIANTEUFaQbGWVgMdKfeXHPRSOcYBDJ,EAAAaAAAGACA..gACAdAEBeAGHHCEBRAEF.OBBHhAIABAGBLCGBZDGBABIBTFBAhBAAQDAA.hBFAbDDCMEIBXFFCSGFDDAIBCGDAIHHAhAAA....hADA...,2,-20,8,28
TGdHYUEWZXMFILgRAfJVeBQObCKSDNPca,VAAAeAAAQADA.CAFA.DADA.PAFCaAGDdCCA.HDFAhAAAEBDFZCEBMAIBLCHBhAAAAEEBBFDDKFFDSDGFhAIA.TGGAYHDAWEDDFGHB...hCAA......hDAA...,2,-24,-4,20
GgHDLXTMVdACQPFJNWfYabBZecEROKSUI,QAAAFAAA.JACEfADA.aAEDZAFB.EAHFRAGBSCCDhADAGCDAHDGBLDDBhAGAMDCBABFBCFFDPCFDhAIANICB...bFFABGHAeHEA....hBAA......hBIA...,1,-10,-17,7
LRFDNXQYKIcSGPZCaJAeBHfWbdgTOMEUV,HAAA..bAAAdADAOAEAEAFALBHB.RCAADCFAQBEChAAAKDEA.SAHHhABAZEDAaFAAADGABFHAfCAAhACA.TDFAMHFA.FCCHNIAB.XECAhBHA.IFHA.hAAAPFFB.,2,-7,-2,5
SbWYHfQgOLGRUICVDTAMeJENFZcaXPBdK,eAAAEAAAZACB..aADDBAEAdAFA.KAGA..SAHB..hAAAbCEAHBGBQECAhAAALDBAREFBCCBCTEFAhABAACEAMCIBFFBA.XFDDPGAC.fGHAhBDAOHFE.....hAGA...,1,0,-22,22
YTMCIbJRZQaXfeBNFKWHDdScUVgAPGEOL,EAAALAAA.MAEAbACA.RBCA.ZAFB.QCCAaAGE.eAHFhAAAFCABHCECdDAAUEFAACHAGEEAhABAODHDTFBAhACACHHA.IEHA.fGHANICB.hADA......hAEA...,2,-8,-1,7
ZdIEHUQfecBLYXOGPKRVAFNTbCgDJaMWS,TAAACAAADACA...aACAMAFA.ZBCAEAFAHBGBQBGA.hAAAeBDBLDBAOCCBhAAAGEFARDEFAEHAFFABbFBAgGDBhAFASFHBdGGA......hAIA......hCAA...,1,1,-20,21
fUWbRTMgJVKISAYFdXLGaEPCQHDZNcOeB,dAAAGAAAEADA.QADAHAFAZABB.OAFCeCEBBCGAUCGARDCAMCIBhAHAVFDAKDCA..AAABFGHBhACAaEFDDEHB..fHABhADAbFCB.........hAIA......hBAA...,2,-15,-4,11
aUFDTCZPGAVBEMLYbJOQSWRcKgfXHeNId,EAAAMAAALADA..bABAQBGA.RCBAKCFDXAFAhAFAHEAAeEEAdCCAaBHDDEIBhAAAZCFFAAEABFGAOEDDSHAAhAHAgFFGIHHATGAACHEA..hAGA......hAIA...,1,-1,-17,16
PYSCOBTRAXgVdcZKUJFDMHaLbWfEGIQeN,XAAAdAAAZABBKADAFADAHAFB.LAHB..bAFDECEBGBCAhAAAeDCF...PAHDhABACEEDTEGAACEA.VGEAhAFAcEEADHBA.MEHB.aGEB.fHABhAHA.....hBAA...,1,-7,-9,2
UEBCOcTFbaWegRQMALXDIGSdKYNVPJfHZ,LAAADAAAGABBdAEAKAFC..VAGB..fAHAHCAAEDEAODHDhABAFCCH.aEBDeCFBhAEAREFB.ACIBSDHDhBAA.PEDDZGAACEDD.bFEDWHEAQGGAhCAA....hCBA...,1,0,-18,18
PAYOcbZJeSDEFCVITWMGQaRLBfgXNKdHU,OAAAZAAAeACEDAEAEAFE..CAGA...TCDAGBBB.RCEALCHBhAIAfBHA.XCFDhABAdEBAHEFBAAHAbEFAFHECIHHAhBAA..MCCBBEEDKFCA..hCAA......hCBA...,1,-13,-18,5
dILRODFHGWAgEJSXKeVbYUZaMfNBQCTPc,EAAAXAAAKACA..eAEE..bACDZBCEaAEAMAIB.BCFATBEAhAAAdDDARDGBFAHB.HDEChABAAFFA.SDHBhBEAUGGB.QFFBCHAAIHCADGIB....hCAA......hCBA...,2,-22,-7,15
TRBUceDIaVAWZOFGfgNPLQJbMSXYCHdKE,ZAAAGAAA..fADBPADA.LAFBQAGA.bCDAhAAAMAHB.XCAAhABAHDBBEDHBRDDBBDHAeEEBaGFDhACAAAIBFFCB.gFGA.SGEHhACACHHA....hCAA...,2,-18,7,25
JfgPVEDHNKIWUXFdTAaQGbZLYcCSMBReO,GAAAZAAALADBCADABAFARAFA..eCABOAGD..JCFF..fCDAhAAAVFGBHFACKCFDhACA.UEEBdHDBAAFAbFAASCCDhABA.MCIBEEHBDAIB.IHGAhADAFEEH....hAFA...,2,-28,4,32
OdNCDIAeJURVfBLXaKWZMFYPcTEHgbQGS,eAAARAAABADBLAEAKAFA.ZBAEMAIBFBHD......cCDBhAAAHCCAbCFB.GEEAhAAAdDFADEEBADHBUFAAXFAAhABAaEHD.PEHB.......hABA......hAFA...,1,-14,-20,6
QNKeCIfAEZMSFXJTLUbBHWYaGDcVOdgPR,EAAAZAAAMACAFACD...JAFBTAEA.LAGBBAHAHCDBaCDDGEAAhAAADCCBOCGDdEFARFDBhAEAQFFCeCHHfGHAhAIAACIBSEBD.XGDB.hBIAWHAA....hABA...,1,8,-32,40
WFCbEZLXfTAKSgMUNcGVDdOJYPQaIBeHR,SAAAMAAAUAEAGBBAdADA..OAFAJAHB.QBFChAAABDEAHDFBRDBACCHAEEDBZEDELEHBhAHATFGAACCBKGBA.hABA.NIBB.DEBB.aHGCeHEE.....hBAA......hBBA...,1,-4,-14,10
cUAIEeLSgXfNadTWQRZDYBCPFOMHbGVJK,EAAAeAAALADA..XADAaAGDdCBAQDDARAGBZCCABDGDFEAAhAAAHDFAGECAKEADAAIBSFCBhAAAfEEETGAAhABADFHBCCHAMFIBbGFA.......hAEA......hAGA...,1,-3,-9,6
IcMaZJRBUgKbOEfYWNDdeSVFACLXGTPHQ,LAAAGAAAHADAQAEAMAFAZBFERAGBBCAAKCDDEDFA..fCCAhABA..YDAFhAAADDEAeDHFFDHDAAIBTEAAhACAIFFAaECDJHBAbEEBWEEDdGGD.CGHA..hAEA......hCAA...,2,-8,1,9
QLVIabKWDAeSfRUdCZYOXTBgGHJFEMcPN,eAAARAAAdADAZAEBOADCBAGAHAGB.FCCAEBHFMCFB.....hAAAPDGBLDDAaEEHKFAAhAAAACCBfDHAhABA.CFFA.YEHB..TGCA.hABAJFHBNIAB.....hAFA...,1,-15,-25,10
PNXYRZFcbfMLHDOABECUSKVTeWJGadQIg,EAAASAAAKACA.eACHGAEA.dAGBQAEA.gBGBhAAAXBGDRCCBZDDAhABAbEABMEABHEFAAAIBCCED.hAAATFGAaGHBIHEAPGDCFHAE...hAEA......hCAA...,2,-10,3,13
bZaGMHFDPTSXYJKIfORWUgcedVEBNACQL,LAAAaAAAHACBDAEATAEA..SAFAXAGB.KBHBOBHDhABARCEAUEBAeCAAdEEDEEHBhAIAACAAQCEB.hBAAGEAAMIEAFGGCPDDB.IEGAhACA.fFFEhAEA.WFHH.,1,5,-6,11
HGTQAPUEYXKJCSaOfZNeLVMRIdgBFbWcD,EAAAKAAACACB..aACDZADBLAEA.RCDAdCGAFAFD....bAGDDAIBhAAA.HECAGDEAAAFAPCBBhBCAUEGA..XDCChAAAODHDeFGB..MIAA.BHHAhAIA......hBIA...,1,-2,-30,28
aUdTBWDSZcgbYLVIPFEHMGANJCXQORefK,CAAAQAAARACA.eACAaAFA.dAGABBFASBDAZCAA...hAAAbCFALCEA.hAAAIEEAEDAAHDDAAAIBJDHBhACAfEGA.TGBADEGB.cFGDhADA.....hADA...,2,-43,6,49
YRTFgHBWcUJDQaeIKdGPXNCAbOLMVESfZ,LAAAEAAAZACB.RADFFAFAHAEABBHAUCEB.QEFBeCAB.dAHAhAAAGCEA.XDGBhABAABCBbGAAMEIB.fHGBhAGATGCAgGFA.JCCF.hCAADEIB.....hCBA...,2,-9,-8,1
bGUEdOFSKPHLgANaCMeDIfQJWVTcXZYRB,aAAAeAAA.DAEAQADA..VAGBTAFAZBAERBDFGCCAhADAEDFB.dAHAFDHDKBBDHFBAhAAAADHAMEFA.IFFAhBAAfFFEJFHBXFDDBHGA....hCAA......hDAA...,1,-7,-15,8
FbWeCPGTQRIYEcNXSMdAUVKHLJOZfDagB,KAAAHAAALACBZADBaAFDBAHAFAEA..eAGHGCGARCEB.ECAB..hAAAXDGDdCCCACIBVEEBhACAOEBADFBA...gGGAhAAACGDD..PHAC.IHHAhADANAIA....hAHA...,2,-22,-8,14
XAGaOHFPRgcDCEJNSBWfbLeZTIVMQYdUK,aAAAHAAA.RADFDAFAEADA...SAGABAFA..bAGDeCABZBBATDAAhADAMCCBdCGAXDDAhAIAACIBGDEA.FEHDgEFHhBAACDDDJFCB.fFCAIHHA.YEHBhBIA...hAAA...,1,-5,-9,4
FVOcALCdNfHDaGbePEMQUIJXSYKBWRTgZ,dAAAHAAAGADAeACEEAFEMAFAUCCA..XBFBKBHBRCFBZFCAOBHDhACAAAHALHDA.CEHA.hAAADCCB.bDAD.QEFAhADASEDABFDAgGGBFGHDNHCB..hCAA......hCFA...,1,-3,-6,3
aNGgOcHILZMEPTDUJSfRQdAbKVXWeCFBY,KAAAXAAAeACEBAFB..aADAGAGAOAFDHBCAZBCBEAHBTDEAhAAADCHB.UFGA.SEDDhAIARECAAAAAVFGBFGEBhAIAgGDA........hBIA......hCAA...,1,-14,-15,1
RUdJLXYHETDFABWPCbeIaSOQVcNfMZGKg,BAAACAAA.eACAaACA.QAFA..cAEDMAIBGCAAhAAARAGFdBCALDEBHCCAEDFAhACATFAAAEEB.bEFDOEGDhADA.fFCAKDHB....hBHA......hCAA...,1,-9,-20,11
YfBWIeMAOCJGVEdbaXPNTFRcLDUSgZHKQ,CAAAGAAAdACA.aADA..XAEA..TAGARBGFLCBAhAAASCDAHCEBQEAAhAEABCGDeCHHAAABODHDhAFAEDCBbEEBFFGHDFIB.ZGAAfHABIGGA.hACA......hAGA...,1,-6,-14,8
aPbFZBMVKHECJcWXUIGOfNgSQALTeRYDd,eAAARAAAdADA...aADDFAFAZAEBMAIBHAGB.ECCBCBFD....JCCFXDFDhAAA.GGBBhABAOCGDfDBEhAIA.SEEDAAAATEEADEIBBGGAKGDA.hBDA....cGGAhCAA..,1,-5,-41,36
LeOgQCXSETKdNIDHfVYcPaGAZMJRBUbWF,ZAAARAAABADBUAEAFAFALAHB..eAHHQCAACBEA.EDDAhABAdCCA.DCGBHDFA.hAAAfFFEVEDA.hABAPFHBADIBMEHBbGBA......WFHHhCAA.....hACA...,1,-12,-37,25
HJdPXRSabgOcQBDTEZKVFeMLWCGfAIUYN,UAAAHAAAdADARADA.aAFAOAGDBBFA..EBHFZCDA.FDAALDDAhAAA.GEGAAAIB.IFBAhACAJDHBSEADhADAbFDB.QEECKGFDMIAA.CFCA..fGGEhAEA.NICB..hAIA...,2,-24,-7,17
bURgEBZXMfGLQNYHWVDAFeTJKOcdIaPSC,eAAATAAAOADC.dAGAaACA..CCCARCEBEAFA.ZBDA.MAIBGDGAhAAALDDBQECAhABAHCGBDCCBAAIBKFAAIFAAhAAAbGDA.BFFA.fFHA.hAFAYHBA..hAFA...,1,-8,-17,9
JCeVQREPMITOAKDXLYNcBFfbUWHdSZagG,XAAALAAA....NAEABAFAFADAUAGAHAGBZCDAGCAAeDBBRDGFhAAAECCB..MEEBTDFAhABAAFFBDFIB..fEHAhACAdGBDaGGH.CFCAQGGB.OFAHhAFA.cFDDhAIA...,2,-15,-9,6
RdCMUXKTeZDWfSVGbAPHQJaOFEcgLYIBN,HAAAaAAA.EADELADABAFBRAGF.dAHAUCABTCCAZDCB..DCFBSCEBhAEAGEEB.ABBBQDGAhAFAFGDD.gEEGhBAAIGHA.MHBA.KGHB...hAAA......hACA...,2,-19,-7,12
COFcIeBPdTbHEQVMSDXfUaYGALgJRNKWZ,LAAARAAAKADCZAFB.FAEA.eAGHdBHAHCCB.EBEFMAIB.XBCAhABAaEFA.ACAAJDDFCFFAOEHDhAAABDGA..TFFAhACA...........hABA......hAIA...,1,-27,-29,2
cPdBgTODWYCQANUEIHbfXaGRSJKMLeVFZ,EAAAHAAA.XADBRACAKAFCLBHBeAFAZBFEdCCDBCAD.OCCBhAAADCFACDAA.ADEBUDGA.IFEAhACAaDEDGGDBMGAAhAGAFEGH....gGEA..hCDA......hEAA...,2,-27,-6,21
NFYKBHbcSeDaOJIPLZMRAWQTgGUCEVfdX,TAAAGAAAEADA.dAGAFACABBFCHAEB.SAGAeBHHOCDBhAAAICCAZEEAADABQGDAhACACCGAXDECKDHBDECBaFHDhADALFFB.RGAAWFHD....hAAA......hAGA...,2,-12,-6,6
PZUGMKOYaJHTFfNAQSWIRDbLBeEgcVCXd,QAAASAAARACFLADABAEB.EAHB..VAGBdCDAZCEBGCDAhAAAMCHBODFDaEAAHFAAhAAATGAAFFGHADIBDDIBgGDAhAEAXFGDKFCB.fHEBhABA......hAGA...,1,8,-16,24
LegCQMTGcadBEbZUXOSHDfRYKWAFPNVIJ,FAAAVAAALADA.eAGHQADCGCCAdDHAEAFEZBFEUEFASDDBhAAAHEABDAIB.RDFAKFFDhAHAAAEA..IHHAhBAACGDAMFIBaHFEXFDD......hCAA......hCBA...,1,-7,-8,1
NDJZaVCUgRYHQIKAWSdFcTfEPMBGObeXL,dAAATAAAEADABAFA.GAGAeACELAFBDCCA.aAHBCCEARDAAHCCBhAAA.QDGAhBDAAAIBFDFD.fEFEhBIAMDIBXFGDZFCA........hACA......hADA...,2,-33,5,38
cfLedaPGHMWRQETBVJDbZOAFUSXgICYNK,SAAAXAAA.CADA.KADALAFAdAFAGBGAHCCARCDB.ECFEBAHBhAAADCIBZDAFADAA.FEEAIFFAhABA..cECChAAAeDCBaEHDMEHB.WFHH.....hADA......hCAA...,1,-10,-25,15
JRUcBaIdGfZHQNVWbEYLOAFeSXPDgCKMT,eAAAXAAADAEAKAGA..MADARBCA.BAGAdCGAZDBAHBCB.QCEChAAA.VDGBhABAEEHFLDFDAAIBSCGEhBEACFBA.TFBA.cFFCaGHD...hAAA......hABA...,2,-34,-1,33
OTQBgdYZEAFfWHeKMRNaCVXIGcPJSUbLD,FAAAHAAAeACHRADFCAFB.....XAEAGAGAPCABSAHBhAEALDDATCEAQFCAhAAAdDHAEDDBABHBKECDaEGEIGGAhACAUGEAOFAB.BGHA...hADA......hAIA...,1,-3,-10,7
KOZGEbcgeMIXNJFPRfDYLaVBTHAUdSCWQ,dAAACAAAKACAGADA.EAFA....bAEBeAHF.MCCB.XDEDhACAFAGDRCAADAIBaCGHTDFAhAAAHFAAAADB.SDHHhAFAQECAcGGAgFFA.IHDAhACANICB...hBAA...,1,-7,-30,23
ecSFUVPBXWbEYHaJdIOLMNgGZRTfDQCKA,eAAAFAAAUADABADA...XAEDEAFAHBGBdAGBLDBA.hAAAMDFBGBGARGCADAIBQCCChABAACCB.SDFDhCAAPHFC.bGEAaGGA.....hCBA......hCIA...,2,-23,-15,8
TPeIgHfZUNVaRDEKYAbLBOWdScCQJFMGX,LAAAOAAAdAEACAEAFAGAGAGA...TCCAeBFFHCAA.hAGAZCGBVEBBREAAEEDEAAIBBBBDhBAASCCEQEEAhBDAMDIB.XEGA.IHGAfGDAhABAaGDD.KGGA...hBEA...,1,-2,-13,11
DJgGKPEIQBMLOFfCSAaVTeRWNZHbUcYdX,aAAAeAAA.RADAZAGBHACB.UAFAdCCADBIBGDEA.ECHFQEAChAAALEAAFEHDSDFDhABAAAIB.TFCAWBBD.hAEAbFGDXGDD.KGGDBEHBfHBFhBAACGEA.....hAEA...,1,8,-14,22
ZDHfEcaJTNPXISVAbFUGYWQBeMOKdRLCg,FAAAGAAAQADAeADAMAHBdAGALCCBZCDAHEACEDHF.aEEBTDAAhADA..XFFChAAASBHHAADAbGBCUEEAhAIABGHARGBADEIB.fGHENICB.IHFAhBAA...hACA...,2,-4,2,6
DVWgIdNUSHZMAfaYTQPbRJFKLXGcCOEBe,aAAATAAA..QADARACFKAEC.GAGAOAGDEBBBDAIBVDABhADA..ICEAhAAAdDDASDGDHDECACABfEHAhACAbDEDLGAACFFDeGBANDIAMIAA...hBGA......hDBA...,1,14,-22,36
WZePHBGLDMNdXQfRcKCOgVaTbAYUIEFSJ,UAAAEAAAFACD..SADAZADBHAFAGCEAMAGB.dCHA.QGDChAAARCBACAHA.OHAAhAHAaCFHAADA.JHFEeCHB.hAIALEEADGGA.fECA.KGGAhAHA......hBAA...,2,-31,0,31
FULNWaJDYdAGXEQBgRfIOPZbHSeKMTVCc,EAAAQAAARACA.OACCZAFBHCDB.eAHFMAEACCCD.FAHDLDABhAAAaBEEDCDB.ACIBGEGAhADABDFA..fDHAhAAAbFCA.TEDA.cFGC.WHDAhCAA.....hAFA...,1,-7,-16,9
MOIULGPKeBACYdbVSEWZJNaQXRgHFTDcf,dAAASAAAEADAZABB...aACDRAFAHCEA.DCIBMAEAUECAGBDAhAAAKEFA.AAIBCBFA.bBGDJFHBhAGA..QFBAhABAFHCA.TFEA.OHFC...hAIA......hBAA...,2,-20,-6,14
dQgLUcPHWJZGfDEIeaFbYBCMKVRSAXNOT,OAAAdAAALADAUAEAHAGDZAGBGCAB.EDEFeBBA.bDDACDHAMEABhACA..REGFACIBTFCAhAEAQFDA.hAFA.gFFA......hBAA......hBCA...,2,-16,-15,1
NOMVaIgAbQXPeDRcTUWfHJGSKEBFYLdZC,QAAAeAAARADA.UADAHAGBGAGAECCBFCEDdDBAZEAAODDA.hAAAaDHDAAIBbEFA.DGAATFFAhAAA..fGDAhABAKEEDLGAACGGA.MIAA.IHHAhAGAXGED....hAEA...,1,5,-12,17
ILHVMTcGbCBPQeAYXRDdKZgEfUOSaJWNF,RAAAdAAAZADBEADAUAGA..aAFD..JCFFFAHB.HCAC.MCIBGDAAhAAABDEAeCCDADGADEDBKDHBhABAOEFD.SEHDhACAIGGALHFA..cFBChADACEED.....hADA...,2,-25,-19,6
NVQMCBfZIbgKdHPROLSXGTADJYWEcUaFe,DAAAJAAA.EACAUADA..eAEA..QAFAMAIBBBBDZCCA.hAFA.bBEAdBHA.HDFBhAIARDCALEGBSEEDhBAATFDAAEHA..YFHBWFHH....hCAA......hCBA...,1,-17,-28,11
ZMDTKRSGeCbHUXYIBOEAcQJfPNWdFagLV,QAAAJAAA....fADBPACCdAFAaAFALAHBhAAAZBDEMAIBTCDA.hBAARDFBeDCBHCGBXDEBhCAABEHBABHBWFFDFFGHDCCBSGHB..hCAA......hCDA...,1,-9,-19,10
fBQcRSTVLbMZgFDGaJAOKIdXYeWHUNEPC,KAAAdAAAeADAHACBEAEACAGA.BAGARCAA...SAHHTCEALCGBhACAZCAFDCGBGDEAhAAAAAIBOEABXEGD.hADA.UECAfFCAQGEA...hACA......hAEA...,2,-19,-14,5
cOZMePCRBdAGWDVKTXfEYSgaLHIbQJNUF,GAAADAAAKACA...TADAEAEE..SAGBaAFAHBFAbDCAQCCAhAIA.UCGBhBAAODAHeDFDRDGBAAABXFCAhBBAfGFALFHBIHHAFHEE.MIAAhACA.BCDD...hBIA...,1,7,-19,26
CcEOQgMRWTAaBHNXDUdfZVbIJFKeSPLYG,HAAADAAAdADAZADB.VAFAJAFA...KCADeBBBLCCDGBEAECHF.hAIA.QCGChBAARDEB.ADBBBDDDXFCAhAAAUFGAfFHA.FHFC....hACA......hADA...,1,-7,-30,23
WRFOKbCYAELUGHPcNXTeVMgDZJBafdISQ,EAAAGAAAHACA..PADAXAFB.eAHFMAHBZCCABBFAdDGDQEAAhAAARCDBKDCD.hAAAbECDAAIBLDFBhACAUFFANICB............hBAA......hBCA...,1,15,-31,46
XQcPgfAJVdYbKDGNSOZHTWBIeRaMEFCLU,dAAAKAAAGACAOADAHAGBBAEARAFF..EBDBLAHBQCBD.hAAA.PCABAAIBVDFBDDFBhACAZEBE.TGBAeEDFaEGAhAEAMDIBCFGA..XGFCfGHE..hACA......hBAA...,1,-5,-13,8
PgKQELYNfZCMWdDRObHcJVSaGATIXBFeU,TAAABAAAeACA.UAGAKACCEAEALBFD..fAGAhAAAZCAAMCEBdDGARCCAHCGBJFFF.hAAAaEEB.AAIBFFCB.QFFChCAACHHADDIB........hCCA......hCDA...,1,-8,-29,21
fBcQFUSTLageVRZWGDOCHIYNPAdMKEbXJ,dAAAEAAA.JADABACA.QAEAFAGA.UBGATCBALCCBhAAA.eCEBRCFAGECAhACACEAAHEFBIEEA.hAEA.PHAAACFAMEHBKEHBfGFAaHEC.hAHA......hAIA...,2,-26,-6,20
QZBTNWUSDfMcFPAYGHdXeKOLJCEagRbVI,HAAAeAAALAEAEADERAFF..VCCAZBAETCDAUEFA.DAIBMAIBhAAAFCFAAAAAdFAA.KCADCDHA.aFHDhACA..IEFAhAFABHCASHFG..fFGAhAGA.YFHB.hAFA...,1,-8,-22,14
dKUXOVWZHcfARgJEGPCSBeaMQLFNTbYID,RAAAEAAAGADA.CAFA.eACA.aAFDMAHBLAHBFCCH..TDFAhAAAbCCBDDAA..dDAAXDGChAAAODHDZFAEHEDBhADAAAIBJFFFBFBA.QGGAIHHA.KHBA.hABA.WFDH...hBFA...,2,-7,-7,0
DIWAJaMOefYQGScPgENdBUKZRTbFLCHXV,aAAAeAAA.QADAGACASAEA..gAGAhAAAEAHBdCFAKCHDRCCBbCFALEABhAEAHEFADFBBABBBMEEBfFEEhABAPFFABGHA......hAFA......hAIA...,2,-13,1,14
UGbYXfRTKVCWcAdIEMHJegSPFBDLNQaOZ,EAAAHAAA.eACESACABAFBLAHBQAFAZBEEGCCAhAAAXCCAREFATGDACAHAACCAdDAAMCFBhAAA.JCHBFGHBaEFDhADA.OFAE.YFHB.KGDA.hCAA......hCCA...,1,7,-4,11
JSDUMKQgTZVRLGNBIeWCfAEYdOXFHacbP,EAAAdAAAFADAHACA.aAEA....bABDSAGHMAGB.QCCBhAAAZBGBRDCAGFCBBCFDhAIAeDHHfCHAhBIAAAHA.XEEA.PEHDDGIB...hBAA......hBDA...,1,-4,-19,15
QZbWgEKJCMVUcYBfFXTNeaDIOPSGRHLAd,ZAAA..bAAAEADECAEA.MAFA..UAGABBFAFCAA..TCAAhABAeCEBaDDHOBGD.GDDAhACAHDGBAAAAdECCQEAAhACAKFGA.cGBDXGEDDGEASGHHhAEA...hBIA...,2,-19,-8,11
YZDcVWFbPSEAHfBNJORIQKCgUMeLTXaGd,HAAABAAAOACARADFQAFCKAFA.CAHBMCABeAHHLBCB.hAAA.aCCHdCFAZCFEDDIBcEEChACAFEDD..bFFBEEGAhADA.AFIBJHCA.IHGA....hCHA......hDBA...,1,-2,-35,33
XRZDbTAQNedMGBYFIagUVJEOLWcSKHPfC,eAAAGAAAFADDaADAUAFA..EAGALBHBSBGAHDDACCDARCEFZFBAhAAA.TFFAAAAB.dFHAhABAMDCBBCCDIDHAhACA.gEGGOHDE.KGAA.XGGChAGADDFA....hBCA...,1,-1,-16,15
VMLWZeTaNKRPJHEFODYgSQACBbUGIfXdc,BAAAGAAA..XACAdADAMAFAZAEBeBFA..aAGDRDBFHDDBhAAAECAA.DCIB.SDGBhACAAACAbDCC.IGFAhBAAfCHA.LFFAWGBGKHGAFGBA.OHFAhAAA....hAIA...,2,-26,-1,25
CZEMaIVGJYKfQFTbgASPDNdeRLBcWHXOU,DAAAeAAARABALAEBBADAHAEB.OAGFZAGBEDCBMAIB..aCHDGCCAhAAA.KEFAQEEAhAGAbFEC.ABGBSFHBhBAAdGAAWFHHCHEA.IHGA...hABA......hAGA...,2,-24,-9,15
GQBaJKZVYUXeRFMdETDOICLAHNbfcWgPS,HAAA..bAAAfADB..gAEAGAFAaAHFZAGBhAAAUCABRCAAdDEAEDDATEGAhABAODGDLEAAhACAADIBcFAASGCABFEAKGGDYHBGFGGHMBIB.hAEADFIB.....hAFA...,1,6,-2,8
QHfVDJFCSOGceKMYNBbgXUdLPIATaWERZ,aAAARAAAHADB.DAFACADAGAEAKAHB..MBGBBAGA...bCCDXDAAhAAALCHBACHBEDDBhABAZDABQFFChADA.fGDAFDHDODFHeGAAgFBAhADA.dGGAIHHAhAGA..,1,-3,-19,16
HfTVOEcSeWNKCLDIbgGPUZQdFMXaBAJYR,RAAAHAAA.TAEAEADEeAFEKAGCLCAADBGB..ICCAhAAAGCEBZEAAdCEAMCHBaECAABIBfEGAhAAAOEDBSEGDhABACFEAPFHDFGHDBHCAYFFF..hAIA......hCAA...,2,-20,10,30
OUYQaRfICeHJPVEXGFDMbTSdcAgZNLBWK,ZAAALAAAKADCUAGAaADD..RAFA...CBEAHCAAVCAA.GDEA.hABADDGAbCFA..dEDCAAFABDEDhACAOEHBQEFAhAIAeGBG.EFCAMIBASFHB.NHCB.hCAA......hCFA...,2,-17,-11,6
NYJXfSDWBAcTECOdQgFMGaePIVbHLUZKR,EAAAdAAAQADAFACD.GAGAeAEAIBHAHCACZDEBRFBBJCDBSEDFhACA.BAFAhADAAAEATCFAOEHDaDHDhAAAbEFDLFCA.KGFANIDB.....hAIA......hBAA...,2,-22,8,30
FHCURVLgbWONIaBDXcfJeMZdQYPKSAETG,EAAAGAAAHACARADALAGB..bAFBOCDBaAHDBCCDDAIB.XCEDhAAAJDHBZCEBdEADQEAAhAEAKGEA.ADHATECAhBHACHHA.VEGB.NIEB......hAAA......hACA...,1,12,-23,35
fYCLQXBeAESZRTcINDHaUOgFKWVJbdMGP,EAAARAAA..TAEA..IADAHAGBaCCAOAEDKDAA.VAGBhAAAdDDDGDFA.fFHAhAAALCBBQDDChAGAeGAAAADASHEGZEGBDDGB....hABA......hAGA...,2,-18,-4,14
DcYISaPQKATROdXGEBNgWfHZLJCbeMFVU,RAAAdAAAEADEBADA.....NAFA.fAFBHAGBZABBLDDBhAGACAHBeCCAMCGBFDHDDECBICHAhAAA..aDFDQFDAhABAAAIB.TFGAXGBCWDCA.hBAA......hBGA...,1,-11,-27,16
PIABLFWQgUDMECTVGSadNOebcJKYRXfHZ,LAAAQAAADAEAEACACAGA.GAEA.dAGBeAHH.JBDBRBGFHDCBhAAAZCAB.ADCBFEGHUDGBMDIBhBEA.SFFDhCAAaCEDOFBC.KFFD.....fGHAhABABHHA....hACA...,2,-31,6,37
eVabMJKdGgHZAYCXPcNOULEBDWQSIFRTf,XAAA..cAAAOADALACBEAGABBDAQAEAhAEA.FAGERCDAeBHFhAAAbCEAMCIBdDBAHEFAZECAAEEACEGDhBAAPFEBDGGA.SGCBIHHA.fGHAhABA...hCAA...,1,-5,-16,11
NMBPeFIfEADOKXJTbgUaRLYdHScGVQWCZ,KAAATAAAUACA.LAFAHACBGAEB.QCEDZCDEMCHBeEBBhAAAfCAE.hAGAAAEAXDGDbEEB.hAHARFEBdGGASEHHWHAABCHBFGGHDICA..hBEA......hCAA...,2,-19,13,32
WAacYXbLZKUPDONIEFBgSMJfdTRCeQVGH,aAAAXAAAZACB.KADADAFA...OAHDEAFEBAHB..MBBBhBAAdCDARCFAeBFBGDAAHDEBhBEAAAAA...bDGDLEFAhADAPECB.FFCDSGBDTGGACHEA...hCAA......hCBA...,1,-8,-15,7
TebgaVALfWGEUXRQNSdDBCMcPIFYKHZJO,LAAAGAAAEADARADFQAFCdAGABBFCMAIB..ICAAhABAKCDAHDECZCFEODAHeCCBaEEChACAAAABUFFBSEGBhAHACDCDFHDC.JHCA.gGGA...hACA......hADA...,1,4,-12,16
YWZVSEGefMOQFPTXNRgLdCUIbHJDcAaBK,aAAAKAAAZACB..EADAeAEA..MAGBQBGATCCARCGFdCAACAHA.hADAUDEAHECCDECAABBBBBEAhAHA..VFAAfFGEhBAAFEGA.NEIA.gGGA..hAAA......hACA...,1,-10,-21,11
GKTRNQIaAPUdEMCZXWeOYFcSBLVgDJfbH,dAAAEAAAZACBeADA.FAGDBAEALCCADAGA..JBFBHDAA.GDFAhACARCGF.IDHAhADAABCBMCEB.XECA.hAAAOFHDSEHH.fFFAhBHA......hBIA...,1,-2,-48,46
dZMSGNfXcPEKDWaHbJFBIVQRUeOCYLgTA,ZAAAGAAA..XADBEADADAGAHBFAFAFDBAHAQCDC.hABARDFAeDADCCAALCHBhACAAAABdFFDMFIBfCCEhAHAKHBA.aDFA...bEDA...IGHAhCAA.....hACA...,2,-21,-6,15
RDgdMGcCATZPJVbOIEWfSHBUFXQLKaeNY,ZAAAVAAAOACA..EADESAFAHAFBFAHFLCDBeAHHRCCAdCFAhABAGDGAADIB.TFAAhAAAbEEA...fFEAhAFAXGAAaFHDDGGB.......hCAA......hDAA...,2,-12,-8,4
bVOAEMQTUCWZGdagRfcNFBSHDYJXKeILP,EAAAMAAAUADAZABEdAFA..RAFA.....fAHAFCBBHCFCDDDBhAAAXCCAeEDHLFFAhAGAVDFA.AHFACHHAaFBAhAHA.NICB..BFFD.SFDH.hAIAKFHB.....hBCA...,2,-22,-12,10
OYNEJeVcdWTCXQaUMAbZSHBLKRFfIGPgD,ZAAAHAAALADBRADFFAFAGCEADAFA..OAHDEBHF..eCABdBFATCAAhABAQEGAaDFE.hACAACCBbGCCBEED.KEHBfGGEhAAA..gFCBYDDF.hACAVGFA.CHBA.MIDAhADA...,2,-12,3,15
FdIVODSUbBMWNCGeEKRgLZaYcTfPAXJHQ,HAAAdAAAOADASACEBAGA.MAFA.CBEAGBFAEBDBRCAAZBFEaBHF.hACA...TDFAhAIAACCAQDDCFEBDDDIBUFFBhBAAbEGDeHCALHDA......hBCA......hBEA...,1,0,-11,11
RIVeaJCGBFDZgXAEQOdbLUTPYfNSHcKWM,EAAAdAAALADAUADA...TBGA..fAFFhAAAHCACKCFDREABeAHFaDEHGEGAhACADBCBZDBAACGBQGEChAEAOCHDbFDAYHAG..SDDEhBDA.MFHB..hCAA...,2,-23,12,35
fgOYbHZWUcTKCPGSXDMLFdAeEQINVRaJB,EAAAQAAA..IADARACAaAFABBFAOAEDHCDAZAGBUDAAhAAATCBACBHAGDGA.hAAADEFBMBIBdGEDADIBeDEBhAGA.VEGB.fGBA.gGCHhBCA...hADA...,1,-5,-12,7
NdXMGPbEOgTafQUWceHIADRYFCLSBVZKJ,RAAACAAALACABADBZAEB.KAGAdAHA.GCCA..ECCAOBGHaCEDQCGAhAAAUEFB.eDABhADAAAAAFGGH..SEDDhAEAJHBA.MFFA.bGAC.TGEAhAGA.fGGBhAIA...,2,-28,-18,10
TJEOaHWLGPCdeVfBcYKgbSNFXRADZUIQM,ZAAAQAAAMACA.EACAHAECGAEAdAHAeCCABAGAKBHB.SCDDhAAAXDEAADHADDGBTFDAhABAaDHHLEBBhAGA.CFFD.fFHA.YHFAhCAANIABFGHB......hCBA...,2,-19,-2,17
YLTFKPdXMIDVNUSEOBHZfcWGAgabeJQCR,aAAAeAAA.QADARACFLAEBKAFA.dAHAMAGBDCCB.UECA.EAHBhAIAHCFA.ZDCBfCHEhBAAGEEAAAAAJEHBTEFAhBBA.FFHD.IHEA....hCAA......hCBA...,2,-17,-11,6
QOcgAULINMWEDJGTHeZCYRVdPbKaFfXSB,LAAAMAAADAEAGAGAHADBeAFA.ZCAARBBAdBEAKBHBFCFD.SDGHhABAQEEAOEEBhACAAAIBIFHA.EGBAhBAATFAACDDD.PFHDaGDDBHHA...hAFA......hAGA...,1,-9,-17,8
MSAaTNWXCeFdHcVLEbJRBKDYfUOGQZIPg,aAAATAAA..XACDeACEHAFB.LAHBEAEARAGBBCEADBDBfCEEhAAAGCFAZEAAIFHAhAEAMCCBAEEBCEGAdFAAhAFA.bFFAKEED.OBBHgGEGNIAB.FHBEhBHA......hCAA...,2,-8,7,15
BdWMHEUZTgGLYfRADIcNbOSVCXPFaQeJK,DAAA..IAAA..bABASACAXAFA.aAEDeBHHhADABAGAdCCAHCAAZCFFGEDAhAFALCGBRGAAADFBODCEhACACFHAFGGH.QFDA.KGAA.EGGA.hAGA......hAIA...,2,-9,-9,0
aUOZAWJNSQEcIHdXbLDFYPGeVTgBRfKCM,JAAAQAAA.EACAHADB.dAFBbAEALCGB.FCCHGCDAhAAAeDAB.TCFAhAFAREEBCDFB.aCHDZGBEAAIBSDCDhAGAIGHA.DFFA.PFHD...hADA......hAIA...,2,-21,2,23
QBFPSZKcgXRbMLfUeWJOADNGIVETYdCHa,GAAAEAAAdADAHAFAaADAFAGAZCBA.KCFD..XBFDRCGFLFAAeCDBhAAAOEHDACEA.DFFBIEGAhACA.TEBAhBAACGGDBHAASCHB.bFEDMICAfGGBhBCA...hAAA...,1,-3,-16,13
OSDLGXHgBaARJQPTVdKNfWcUCeYZMIEbF,RAAAQAAA..TAEAdADAKAFA..fAGBUCFAeDBAhAAAZCCAEEEBOCGBLAHBhAFAHDAAaEGEAAAAPDHDhADA..WFDDCEEDMHCAFGGA.DGGB...hBCA......hBDA...,1,-9,-14,5
fUPDObgXNcCVSQMZTHFRaAWEGdKeBJILY,EAAAdAAAeADABACALAEAUBGA..OCAEXBGA.CCCA.QCEAhACAZCEAHEEARFAAAAHAGEAAhADAKFHB.IECAhAEAfGEEDEEBbFFAcGGC..MHEAhBAA......hBCA...,1,-11,-15,4
JaSGMcXZHPYfKRDNLIdEgVFbTWBQOCAeU,eAAAaAAAGACAMAEAZAFEHAEA...fBHARBCBLCGBECFFFDFBhAAA.TEBAQEAAhAEAABEBUGGASBBDhAGA.XDGAYEEFDEEB.dFFA.bFGDhAHA......hAIA...,2,-8,6,14
HUILJPKMECNGeaORWBFZcTYdbDVfAXSgQ,SAAAHAAALADBKADA.EAFAGAFAeAHFRCEFFAHFZEFB..TCCAhAAAbFAA.DDABACAB.QECBhABAIHHAMCCBhAAAaDHBBFAA.dFFAfEHA...hADA......hAFA...,2,-19,6,25
KAIDPcbTeEWZfXCNSMHRgLUGJBQaOdVYF,DAAA..bAAAEACAZADBCAEA...MAGBHAFBRCABLAHBGCCAQEFAhAHAdEEAFEHBAAAA.IHBAhAIATFBA.eFDHXGEAhACASBBD.JHFAaHBC....hBFA......hBHA...,1,-7,-8,1
XgfaNTKZVQJceICWBbMFLORUYGEdHAPDS,SAAAXAAA..aADATADA.ZAFBQAGAeAHFCCCABDAAhAAAbBCDLCFBhAAAREDA.GEGAHFAAACIBDBEBhABAfEHAKFDAcGAAMHEAOHDA..hAGA......hBIA...,2,-8,-4,4
ICbBSVeGfaONYJDKXAWTLRcPFZgUQEHdM,TAAARAAAFADAZAFB..QACCHCCBdBHA.MAEACEFA.BAHA.eBEFhAAAaEGD.OBFD.hAAAJCHBXFCAADDBLFEBhCAA.gGGAEGHFSHCGfHCFhCHA.....hABA...,1,3,-29,32
XTacGHQSgPVBEdJUAFfKMCeNRbOLWIDYZ,KAAAeAAARACFLAEBDAEAZAEE....aAHDHAGB.QCAChAAASBCHPDFDECEAdDGAhAAAAAGBMDIBCEEAOEHDIECAhACATGEA.........hAIA......hBIA...,1,-19,-21,2
RfVUNdgYJCcMTKLHIQbWAFGBXOeEPSZaD,GAAAOAAA.EADAZADBRAFA.UAGAdCDA..JCFFMBBB.LBFDhBAAHEGBQGAAACCABDGBeDBHhBDAaCHFDDAB.fHDBhAAAgEEG.CEHAKGHB.....hACA......hADA...,1,-9,-19,10
LPWCRQAfTHNOMeUBEKaXSYbgIcDZdVFJG,HAAAMAAABADAEADEaAFA..SAEH..bBDA.gCAAhAAADAGAdBBAFBGAGCGAhACALDDACDDAAAIBTFDAhCAAeDGHXFDAIHHAcGCC...hCIA......hDDA...,1,-4,-29,25
cCZNIMHPWADFUdTQKabBEgVXfeLYGJOSR,FAAAdAAAQADAKADABAFB.EAFA...XBGAeAGHGCCAhADASCAAREFAZGEAMAIBhBAAHDCAADGA.TEFA.hCAAbFDD...fFHAYFCF...hCBA......hCCA...,2,-30,0,30
FKEWQJLdcgfDSPOIXRZGeUTVMHNYbBACa,aAAAEAAA..QACAdADA..fAFASAEAOAGDhAFARAGFeCCBTDBAHCEBbEGDhAAAAAIBKBBDLFABDCIBXDDBhBAAUGDAMCIBBDFAFEGD.WFFD..hBDA......hCAA...,2,-22,17,39
WRKQDNeSPfUcJXFTZLdbOVaBYHGEgCMAI,RAAAQAAAeADE.SACAUAGA.JAFATBDA.dDDDbBEDhAAAaDFDHCGD.ECDFMCCBhAAAADAAKFFADDHB.fFHAhABAFGCAOFHD........hADA......hAIA...,2,-22,-11,11
QSCPaOANYTWDGeFMgBcXdEVZULKfJIbHR,TAAAGAAAeADA.MAHBBACB.dAEAEBFFZAFBLCDBKAHBJCCBHCGBhAAAREGBQEABhAAA.CFEAaGDCAEBBNEEADFFB.hACAFGGA...........hADA......hAEA...,2,-24,-7,17
UFCZLaPBbRAgGdfEeNJMSKOHVXITYWcDQ,dAAAEAAA.eADAMADAOAGDHAFC....XBCATCBA...hACAcCBCQDEAhADACCFAaCHDBEEAAAIBGEAAfEGEhAAASCHHKFCAIHDADEDBZFGB..hAIA......hBCA...,1,-6,-20,14
SGeZaKNJWYdgPfFIbcXBARQMECHLTOUVD,RAAAEAAAHADBLADAOAFADAHBGBFAZBCAKCGDJCCF..dDDA..fDAAhAAAFDHD.IEEAhABAbEABBFEAABIBMDIBhADATGFA..SEGHNIAB.gFBBhBFA...hAAA...,1,1,-26,27
ACQUOIGZPdYFRJWbKXLeNTVBMgScHafDE,QAAAOAAAZADBdAGARACA..JAFAKBBDLCEA..eBFDhAIATDAAMBIB.SDBHhBAAHEEAaCHDEFCBADHBCEEAGGBBhBDAFFHDXGEABFGA..fGHAhBGADDDB.....hAAA...,1,-7,-15,8
gXdDPQKAYMEURFSeZNaLIHJCfGVOWTcBb,EAAARAAAeADEZACBLAFAHAGBCBDA.GCEA.OCBHTCEABCGAhAAAbEEA.dEHA.QECDhAGAAAAAMCCBSFHHhAGAaGCDfGFA..cGEADHAA.KDDD.hAHA......hBCA...,2,-4,-4,0
WeVTXOHAfSEgZPFKUaJbQYBMcCLRdINDG,EAAAZAAAKADCUADA..aAFDQAFA.MAIBLAHB.hAAARCAAdDEADBCBeDBATEGAhABAHDFAABHB.SEEDhBDAFECBJGDABHHACFHAIHBA.WFDDOFBHhACAfGGE.hBFA...,1,-7,-19,12
KUXLSIebYgcdPTBWGHCNOEfJAVaZFDRMQ,ZAAARAAAMADAQAEA.KAGALAHB.eBDAbCAB.gCCGhAAAdCHATCDAGCFAhABAHDFBOEAHEEBBABHBaEHDhBEADFEBSFDAIGHAYHDGBHFACHHA.hCAA......hDAA...,1,2,-5,7
aUOGcReHYdBFIDfVCELQXNSMTgZJPbAKW,aAAAGAAA.RADAHAGBdADAFAFADCDB..CBBDLBFAQCED.SDADhAAAMDBAZDEBJDGBhAIAAAIBKDHB.OEFB.hBAAeGAABFHAIGGA.....hBDA......hCAA...,2,-36,-2,34
QgCJEKYaOHVfAZFLMGNSbDeUcTdIXRPWB,ZAAAMAAAGAEA.SACEeACATAFAdAGBRBGFBAHB.QCCAhBAACCCDEEDB.aCFCHFFAhABAABBBLCHBDDIBIHHAhCAAXEDA.gGEA.KHGAhCAA......hCCA...,1,-11,-16,5
DLNBXKWOHYdaMfEcGJPeTgSCVFZbQRIUA,LAAAXAAAKADAHADB.aAFA..EAFEGBFAeAHH.TCAAhABACCDAZCEBRDAAAAIBBCHB.ODDBhACAdDGDMFGBJEHBSEFDhBFAFFHBIHAADHEA......hCAA......hCCA...,1,-6,-15,9
WdaQBTUIRHLEYXKODSeMZJCAGfgFVcbPN,GAAAFAAA..VADAbADA......PAHBdAGAaBHDTCDAhAAARCCBHDABLEAAhACAEDGBKEFDDEIBeDGB.ZFCEADAB.hADAfGFA.NDIABHHDIGGA.hADAOFDDMIAA...hAEA...,1,3,-16,19
BRPXIMTNHFKQEeALWZObSYgDUGCcdaVfJ,ZAAASAAADACAGAEAdADA...aAGAfAFARBGF.XAGDhAAAMCCBHDDB.QFGAhABAAAIBLDBAbGBChBEAgDFACGFD.cEGD.BCCDhABA.TFAANIDB.EFDBhAFA...,1,1,-27,28
cXQDFWBHPOIeGACbgMLdKVEUfYTSaRNJZ,CAAAMAAAdACA.KADAUAEA....TAGARAGBZCBA.QBBChAFAFDFB.HCEAODHDeCHHhAGAAAIB.bECBLEBBhAAAEEFFSFHH.aGCHJFGFDGGBBHEA..hBCA......hBEA...,2,-30,8,38
BIPOZCGUSMgYQfDJFLcbNWXVedTKaERAH,HAAABAAAOACAGADAMAFA.QBFCDAGALBCA..hAAAbCACXBFDeBHHdEFAhAAAaBHFAEIBIGHAhACAZDBASEGAfHBBFFED.WHFGTGGA.hADAEHCE.....hBHA...,1,4,-21,25
bIFKeEPBTDNgaCVcMYUfdLXHJWAZQROGS,RAAAGAAA.SADAbADB.KAGAEAFABCDADAIB...aCEDCBGAMCCBhAAAUCGAdEADHDDCAAABZFFAhACAQDGCFGAAeGDGhADATFCA.gFGA...hAEA......hAGA...,1,-8,-13,5
OLaReHSYgFTMCKZWcABfEdIUQNVbXJGDP,EAAAdAAAQADA..bACAGAGAOAGBRCAAHDCC.SDFBhACAFBHDMCCBZDAFhAAAAAGBfEHAIDDAVEFAhADADFBAaFFHeFDB.YHAACHHA.KGHBhAEA......hAHA...,2,-7,-1,6
MIDcELdFJNYGBHXAfbOQCKUSgZTWaeRVP,OAAAQAAAKADA.SACAZAFB.aAEDRCCBMAIB.DBBBEAGAhAAALEFAdCGAFCDHNBIAGFABhAFAHDABADAB.bFDACCECTGEAhBAA..eFHBIHHAcGACBHBDhBHA.....hADA...,2,-11,-3,8
MFTYZPGVEdSDIRfBOeLWUaJCgbHcNKXAQ,MAAATAAAZABE.GAEAEACE..dAEADAGARAGBOCCBeBGHLCCBhBAAaCGH.CDHAHEDBKDEBAAIBQFGAhAAAFFFA.hBGAPEDBSFHHBGAA......hBIA......hCAA...,2,-11,-9,2
CRdfLKPXgZVHNUbBMWcIDYATeSOQaGFEJ,eAAAQAAAGADAEACARAFAdCHALAFA.KBDAXDBAZCDEHCGBhAAAUFAAMEEB.IFFAhAGAAAAATEFA.aFDDCFHAfHABhAHA..PFHDNIDBBHHBDIAAhAFA.OHDE..hAGA...,2,-8,7,15
VXMaOFKAQeIdJNBbPcRgCWTUfDHYEZSLG,eAAAdAAABADA..bADARAEFCAGB..UCCAHCACEAHBZCFB.GEDAhACAMCFBFCGDAAIB..QGGAhADAIEAAPEHDhAAA..WCHHTGFA.DIAA.SFAAhABA...hBAA...,1,-7,-25,18
HCODLdIFMXRKfbPNSJTGZWEBVAeagQYcU,eAAAaAAA.QADAUADAHAFADAGAdCHAMBFARDBA..KBBD..bCCChAAASDFBGCFAECHBhABAAAHA....gEDAhBAACEEDLFHBXFGANICB.JHDA..hBDA......hCAA...,1,1,-18,19
HYZITOJfReSAPGagQcDbMWdKBCXLNFUVE,aAAAQAAA.DADAbACDdAGA.BBDALAEAFCED.EBHFHDBBhAAAZCEBTEGAOBHDREFAAAFAGECAhAIAMIAA.CBBDXGEAhBAAVGDA.IHHAfHGF..hAIA......hBCA...,1,3,-14,17
XefbEQMIWaSdARZKODLCUVgFTPYcBHGJN,RAAAZAAADADALADB.CAFA.VAFAFAHB.....TBDA.hABA.cCAAHDDCGDGAhAAAXCFCeGDAEDHFMEEBhACAaGHDACCB...OFAA.PFFBhAFA.BGCANIAB.fHGFhCCA,2,-23,-14,9
GcZONTEKUadCMVXLfHYFegbDBRAIQWPSJ,QAAASAAAGACAZACBOAEC.EBHFaAEA.dAHA.MBFBhAAALCEBHDFBeDHBhABAbDFDRGAAAAGAIEBA.hAAAPEDDNDIAKHEACEDCfGCE.FGHHBHHDhAIA.....hBEA...,1,0,-5,5
gJbfADNVLFGQYTBcKRSWdIeEUPCHZOaMX,DAAALAAAGABBTAEAKAFC..RBFAdCCDEAGEUCAAHDEAZEAA..hAEAaCDBMDIB.JFGBACGAFCHDhABA.QEDAhACABHDA.SDGD.eFHF..hAEA......hAIA...,2,-21,-14,7
eWIJFPSYQObUgHEXRGBMVDdLfKTNCacZA,eAAAJAAA.FADD..SADBQAFAOAFAUDDAHDGB.hBAARFAAGGDBMBFBdBGDKAHBhAAATCCAaCCHADIB.IDGAhCAA...bEEC.EFHF....hCBA......hCCA...,1,-2,-32,30
LcOCVIKRENUHfSdTGZAbWXBFQaPMJgDYe,XAAAQAAA.aACEMADA..DAFAeAFALBFACBDA.KCDAhAAAEBHFHDAAdCFAZDBAABGAbDFAhADAFDHD.JFDF..gEEGhAIAOFFBIGHARGDEfHGF.hAAA......hABA...,2,-20,4,24
TVPgBdUbQOLRcaSCKeHWXGMYDZIEfFAJN,TAAAVAAA..BADBdACAQAEARAEF.aAGEKAGC.HCFBhAAAGCDAMBIBZCGBECDBADFAPEABhAAAUFFBLHDAhCAACFFDeEHH....YHAG...hCHA......hDAA...,1,5,-19,24
RHaWNUeODLCXBKZdPSMVbEfYQGgJFAITc,TAAAHAAAaACA.UAFAeACELBHBBAFBdAHAMCCBEBDB..QCFChAAAGDDAFFBHACCBREFAODGHhAAACDDDZFDF.SFHHhAIAfGHA..YHDGIHBA..hBHA......hCAA...,2,-13,4,17
gCcbfGXAEKVNRPdJHFDMWSeYOZTBLUIaQ,EAAAKAAARACFdADAHAEB.DAGAMAFA..eBGHZBEBTBGALCABaBCBhAAAQEDA.hBIACDHA.bDFDGGBBADDAPDHDhCAAFFFASGHHBHHA.....hCBA......hDAA...,2,-18,-3,15
SeEHOCfXZPgTGRQYcJFMKdbVBILDAWaNU,aAAASAAAHACBCAEA.ZACB....TAGARAEAQCEB.hAEAJBHBMBBBdEEDBEHAhAAALCFAAAHAUFAAEDEBXEFDhAGA.GGCBFGGA.....hABA......hAFA...,1,-7,-21,14
NMQdBZLcfWgEKaCUeOJAYFXIGTHPDVbSR,XAAAGAAAHADADADA.SAFE.RCDAMAIBdAGAZBCBLCGBhAAAfBEAEDCBaDAHhACAeBHHAEFAFFFHTEEA.hADAbGBABHGA..gGGA.CDFB.hAAAOEHD...hABA...,2,-24,12,36
bTBUcRPDKQCZJFeYAGVfIaWNdXLMSgEHO,GAAAVAAA.aADAdADALAGB.MAIBEAFAHBFC.bDDATCDAhAAABDHA.RDBFKEFAZFAAeFDEhAAAABGB..fFEEhACAIFHANIABSEHB.OFCDhBAA.cGGADDDACHHA.hAFA...,1,-1,-10,9
SJPCTLWZQdRFgNcDBGbYVKXfMUHaAEeIO,EAAAeAAA.OADCSACA.CAFALAHBZAGBRCCAFDHD...gBFAhAAADEEAGFABbCCBhADAKFFA.MIBAHEDBAAAA.hAFAIFAA.TGFA.WFFE.hAGA......hBIA...,1,1,-24,25
AePaOMJCIbVRWTXDgQYEHLZKFSUdBcfNG,eAAAaAAA.MAEACADA....VAFARBCATBGADBBB...QDBChAAAHCCAZDFBSCHHhADAdDFAfDHAACEAOEEBhAFAbEDD..XFGAEFHB.FGBBBHHDhAIA......hBAA...,1,2,-25,27
aDXVAQJcfMTdISPbBNUGWFgeYOEKZRLHC,QAAAJAAA.MADAdADASAFABAGAGBDAFBHD.eCCBhAFAEBFBRCGFHCEBDAIBABDBTEGAhAGA..bFEDUGCAhAIAgGGBKGGD........hAAA......hBCA...,2,-18,-15,3
AHKdSIbVTZUBMDGXNPOREWcFafJCQgYeL,HAAAdAAASADAVAEAZCAABAHBGAFA...XCAAOCEBECGAhAAAFAHFaDCDCDHA.QEEChACAeEABACCAKEGDbDGDMFFBhACADDIBREAB..fGHA...hADA......hAEA...,2,-8,-6,2
NDTdeBMIXRZHFAVCUWgPLOEaScJGfbQYK,CAAAUAAA....PACAEADAaAFD..SAFAGBGAQCDChADAKBCDDAIB.eEFBhAHAMCEARFBAFFHDADDA..gDEAhAAA.LDHB.OFDBhAGAfGEAbGFC..hAIA...,2,-24,-21,3
gbPLUaGRYHQIAMKZcBSXTWJDOCeEVdfNF,ZAAASAAA..TAEADADAeAEAEAGEdCAAFAHD...bCCCLCCAhAAA.GCFAhABAHCFBAADAMDBBBCHAXECAhBDAOECCfEHAgFGHaHDAQGGBhABA.KHCA.hCAA...,1,-5,-20,15
CbPURWOIEeMQdDTYSLJafXZGVBHKFANgc,...NAAA.CAAAUACA.RAEA.OAFA.EBBAeAHHdBEA.DCBBTCGAhABALDDA.aDHDZDABhACA.GDCAHFAAAFDAbEEBhADA..IFFAMEIBSGBHXGCAKGHBhAAAFGGB.....hAEA...,2,-19,-6,13
bCOMXWQFRIPHYVKNJLZDfEGdBeaUSAgcT,TAAAOAAA..MAEAQACC.RAEFHAGBKAHBLBBAhBAAZDDAEDHFdEAAeBEHUGDAABGBbCGDhBDAXGAA.FFHDhAAAIFEA.YGEG.NDDADGIBhCAA......hDAA...,1,11,-28,39
NCTEXDKFAOJZefSIQbGcVYMPURaWLdHBg,ZAAAeAAASACEQADAGAEA..cAGAMAHBRDDBaBFDdDGDhABAHCCBBCCD.CFGAEGAAhAGAKCHDAAAA.fEFAhAIA.bFBAYFHBPFHB.....hBFA......hCAA...,2,-12,-6,6
ODICTQUEAeHZKLXRGNFYfWJaVPbcSBdMg,HAAAZAAALADBRADFGAFAFAFA....fAHEaAHD.bCAChAAABBFD.dCAAMDFBhACADCCBTDEAEDHBAEEBeFAAhADAXDGBYFHFVGFASGFH.hABA......hACA...,1,16,-28,44
SVHUQROeYNPIdTZacXFCgAGMJDLfKWbEB,GAAAMAAALAEAKADAEAFE.BBBAHCDARCDA.eAHH...PDCBhAAAdCGAaDBB.FECBADABfDHAhACASDHHQFEAhAFAOEFBIGGAZGAACGGBDAIBWHAA..hADA......hAHA...,1,-10,-12,2
TaHbNUdMOZCKfDJVBQgAWYRGIePcFXESL,RAAAeAAAFADA.EADALAGBHAFAUCCAdCCAZCDBKCFD..DCHBBDHA.AAAAGFDBhAIAIFFA.XGEChAAAaGBB.MCIBhABACGHA.JHAA..........hAHA......hAIA...,2,-29,-16,13
UfeSHGcTJENAaRWIOQCLgVXdDKFYMbBZP,RAAAOAAALADB..XADAdAFAFAHBMCCBZAFBUCCA.eAHFhAEAHDEAGEDBTFGAEFHFhBAAAAAA..aCGEQGEBhBBACFBDDGFB..........hCAA......hCBA...,2,-18,-10,8
OHTFJPXIAYcLBQDNgSaMeKfCGVURZbdEW,LAAAQAAADAEASACAeAFA.CAFAGAGARBCAdCAAEBHFHCDAhAAAFCFD.XDAAADEB.hABABEFAaDHDMFFBfEHAhADAUGGA.bFAA.OFEB....hAFA......hAIA...,2,-16,-2,14
NaZXPdObURWEVfcJCITBeAFSgGQHYLMKD,SAAAGAAAHADAMADADAFAZBFE.dDCAOAFERDGB.EBCAfEEAhAAACCDABCFA.ADABQGDBhACALCHBaDFEXGFDhADAbFCAUGGA........hAAA......hABA...,2,-23,0,23
UXAcVJQEWaDNHYGBIbgFOdKMZSRLfPeTC,VAAAEAAADADA..HADBGAEBBAFA..IBCAFAHBdCGDZDAARCDALCHBhAAAeEEAUFAAAAHAQECChCAA.aEGBhCBAbFEAKFEBMEIB..fGHA.hAAACHDA......hADA...,2,-12,-5,7
TeLGafbMRUNBVIWDFZCPAdKHESQXgOJcY,HAAAEAAA.QADCOACC.JAFATAGAeCABGCDBaCCA.MCCBhAAARCEFBCHA.IEAAhAAAFDHDZFFAACGAdEGAXGEChACAgFAA.LGFA.fGCAhAEA.NIEBDDDBhAFACHHD...,1,7,-14,21
KIZJVSFHeAfGRgENMPcBYOWUCQdXaLTbD,RAAAEAAAMADABACA..OAFECAEA..dAGAaBDDLCCA.TDFAhAAAbCED..KCGAZEAAhAEASCCDHFFCAAIBfGBAhBGAGEGAgGCAPHDA...hCAA......hCBA...,1,-17,-18,1
eMVBRGSNZQDPgHOFCXfaUcKJdIbYELWAT,eAAAMAAARACAGADA.ZAFAQAFCDAGAHCFACCCDaAHD..KDBDdCCDhAHA.IDFAEEFBAAAABEHAhBDASDGH.hCAAgFFGFGHBfHCB....hCBA......hCHA...,1,-14,-20,6
afGMUSCAQBVeRKOXbJPDEWZLTNcdFHYIg,QAAAeAAARADA.OACCXAGB..bAFBDBIB.ECCBZBGBLCFBhAAATCDAdEAAHEAAhABAIFCAaDHHGEDAhAEAMCIBCGGAAGIBKEFD.PFHB.NIAB....hCAA......hCBA...,1,3,-2,5
MgcSGYWTCIDVXNBKbPdeFZHOfQREaAUJL,LAAAMAAA.SADHGACBTBGADAFA...XBBChAFAKAHBdBFAeCABHCDCQEEBhAGAECCBACHBUEEAJDHBhABAgEGH.YHAACFCAIHHABGHAhAHA......hAIA...,2,-20,-7,13
XYMFRNSgJAcWKaeGBLQPZbCfHIODdUETV,KAAAeAAAGACALAEAZAEA.CBCAHCDADAFAdCAAEBHF....TCEAhAAAXDGA.MEFBhAAARDGBSEEDAAFAaFCAQGCChABA.fGGAOFFD...hACA......hAIA...,2,-29,0,29
aIQbPGgFHBECZAXMdTeWYLSRUcDVJNKfO,dAAAeAAALADARADA.DAHBVBGBKCBA.OCCB..aBHDQDEChAAAGCEAHEAAEEABAAGAhABAMEHB..TFCAhAEASGCAUFGANIABfGFA..hACA......hAEA...,2,-27,-2,25
IMRTSFEfOHVBLePNJZGDbCcaAKgWXUYdQ,KAAAXAAAdACA..MAEARADAFAGA..EAHFHCDCLBEBeCGHJDAAhAAAGDFADCIB..CEADAEEBgECBhAAA..hBGAUFFBIDHATGCAOFHD.BCDAhCAA.ZGCAaGHD...hCBA...,2,-13,-8,5
aJBXSKGEHcVACOgFMPWYZdNTIfeUDLQbR,OAAAMAAA....PADCZADBdAGA.TDBAeAGHLBBBhAGA.RDCFaBHDXBBChAIAGEFAHDFAAEFBFEHFYEEFhBAAIHHADBFBbFDDSBHH.hAIAEGBA.CGGAWHFA.hBAA...,2,-8,-5,3
eYVWZBPRDgfLQGcSHaMUJEXFKNdAOTCbI,TAAACAAA..eACA..VADAZAFBRCAADAGALBHBGBGAHCAChAAAaCEB.MDEBEEFBKFBAhAAAAACAbFED...IGCAhBIABFHAfGEAQGGASHFAhACA.....hCAA...,1,-5,-20,15
cMdLOIKXNFReBAEgPGHCbVfDSUTWJaYQZ,EAAAGAAAHACACADA...VAGBSAEH.UAGATCDAaCDCZDEEhAAAdDGDLEAAhAAA.KEFDFEHDRGAAACCBbFFDDFHBhAEAJGBA...........hAFA......hAGA...,1,-7,-19,12
OVRPKZBbSQNXUTcHdgAIEWeaLCfFJGYDM,EAAAeAAALADAFADDGAFAMAHB..RDDBZDGBSBCD.QCEAhAAAXFAA.TEAAhAEAdHBDAAAAaAHFCDHAfECBhAFADCCBOFHDKFFABGFDbGDC.....hAIA......hBIA...,2,-12,-11,1
HdTIObPLVYEAQUNWBSaXDfZegCKcFMRJG,QAAAUAAABADA.aACEDAFA.ZAFE..eAEHKCDA.MAGBGCFAhADAHCGB.dDAAOCHFhBAAbDCALGFA.EAHBhAAAADCBSEED.fFHEhBCA.CHCA.....hCDA...,1,3,-40,43
REWNbMLZDeFQCBHgAJPYTKScVdIOUafGX,JAAATAAA..SADBdACAOAEAUAFAGBDA.RBFAEDGA.hAIA.bCCCZFBA.eFFAhAAAQDFABGHAAAIB.KDHBhBAA.IFBA.aEEH.XGGAhBFAMIEA.LHBA.hBFA...,2,-13,-10,3
HZEdIKaGgDcNbfSAQYBTULVJPOMXWFCRe,QAAATAAA.LADAVADA.OAGDMAHBFCAHRCBAHDEAECCB.hAAAdEAAKCFBGECA.hACADAIBbEDDAEIBBFGAUFGAXGAAhADACGFDIHHA.......hAGA......hAIA...,1,0,-11,11
fYGMePbSFKCWgODVUILNREAHdZaTQcJXB,HAAAaAAA.TAEAQADA..XAGBfAFFGCABhAAAeAHFbCFAKBBDCEAAOECChACADCDBIDFAREGBAEEAZGCABDADhADAMIBAFDHD.gEEG.UGCAhBAA.EGHB....hCAA...,1,17,-11,28
gPUXCHcdQWLMREFfTaeSNGIObJVYBADKZ,ZAAAUAAAHAEAdADALAFAEBHFFCAA..aCECeCDA.GCGAODABhABAJDBBBDDD.AAHAKDHBhACAXEECQEFChADARGAASFHHIGCA.......hAGA......hAHA...,1,-10,-19,9
XYIFEWbafBGMAORLcJDCTdNVHKgSeUPQZ,RAAALAAADADA.dAEAHAECSAGAeAHHQCCAZCAA.XDFChAAAFCFDECHBaEBBGFCBhABAAAGA.ODHDCEDATEGAhABAKGHDPHAA..IHHA.hAHAfFFE.hCAAMICA.,1,9,-30,39
gcRKPDQEbTXJLSMeHIACdaGfZYUFNWBVO,aAAAZAAAFADABADA..OAFDRAEF..DAGAEAHB..TBGALCABhABAeBBBHCCC.ACHBGEFAhACAfDAAYEHHhAIAUDEBVFGB.KDHB.bDCDSFEDhCCAMFFB.CHHD...hDAA...,1,-6,-11,5
KaFAJYGEVUPRILbcHDdfeOQXTgCZNMWSB,GAAAEAAAUADARADALAGBHAFA.dCDDeBCDQEAB..hAAATCGAZDFEMEEBBDBDhAAAaFGAAAHAVEDA.bGEAhBDAfGCA.XGGCNEIA..hACA......hADA...,2,-8,-5,3
BbcHESXVFfZPCODRdGLKTWeIJMYgNAQaU,aAAABAAAHACBEACA...XAEAFAEDZAFBOAHDRBGFGCEA.TEAAhAEAeCAA..MDDBgEGAhAFAACAAUEEASDHDhAAAfEDEDBBBdGHALHBAKGHBIHAAhAHA.NIDB.....hAIA...,1,3,-12,15
HfXYLFBOSbeTJUKPMAQIadgGENCZWRDcV,aAAAGAAA.EADAZACBRAFA.DAFAHCDA.XCGDLBEA.OBBBhAIAeDADTFCAKCHBABFAdDEAhBAACDCDVFFAFDGH.SGADhAAAUGGAMIBA........hBIA......hCAA...,2,-24,13,37
HGRZWXLJCdDQSEIfPgaMAVUTcFKYeNBOb,TAAAKAAAeACE.BAFBHACBZAGBLAEA.dCFAQBCDhAAAEBHFfCAEaCEDABIBUEGAhCAAFDHDODEHRGCA.XFAAhAAADDDB.SFDDIHHA.MFGBhACA......hAFA...,1,-3,-22,19
aUFJQcLXONMTICGZRAWgdDbEKPVSYHfeB,dAAAEAAAKACASADA.HAFBeAEEaAHFFBED.QCGAhAAALCCBOCEBMCCBTEEAhAHAGDGAAAIB.DDAAbDCDPEABhACA.fFEABFHAcGEDIHBAhADACHHA.....hCAA...,1,6,-19,25
KAWXJeVaBdUgFIbRGLTMYPEOSNHQCcDZf,XAAAeAAABADAdADAFAFA..RAFAGCDBMAIB.EDBBSBDAhAAA.HCECQEEBhAAADCCBZEEAADDBVFABaEHF.hABAgEGHLHCA.PHCCCGGD.KGHB.hCAA......hCBA...,1,8,-15,23
RaTWHDFAbENYSQMVLUgPBJZOKfGcICeXd,EAAASAAA.MADALADA.gAGHBAGAZBAEfBEAhAAAGCBACCHAeDDEhAAARCFAaDDCHEFC.AAEAbFCDhBCAQEBCUGGBOEEHKEGAXFFC.hCAATGCA.FGHD.hCBA...,1,5,-4,9
VdbKgAXfTCHLEGFOSDPNYJZRBQacIUWMe,TAAAHAAAEADE.GAFASACBDAIB....PCABJAEARBDFaAHDhAAAICCAUDFAeCCDhAHAbDED.ADIB..CFEDLHEAhCAAODGDZECBBFHAcFAB.MDIBdGCA.hCGAKHAA.....hDAA...,2,-5,12,17
SaFIOdNLWcJeYTfAPGUEHRBXMQbDVgZKC,GAAAHAAARADFMAFAQADADBGA.ZAFBSCAAaAHDFCDH.dCFALDHBhAAA.cEFBhACAeCHBTFDA.hADAAACAEFFEbFBAKGGDOHECJHBA......hAAA......hCAA...,1,9,-15,24
gTWOeENAPdQIBLDVHKYMRGCJUFZaXfcSb,dAAAQAAALADAHACAMAHBRAFFGCDA.CAHBFCHBaCAEfCEAhACASEAATFFAhAAAeCFHAAEABDCA.KDHBhAIAYFDFZFGF........hAEA......hAFA...,2,-20,-8,12
CZFeQLSDcHOdUGJfTPgXWbRYMaIABKENV,EAAACAAAZACAFACDLAFB..DAEAHCCBdAHAGBDATDGA.XBFBhAAARDABMAIB..AADAKEFDhAAAeDFA.QFCChCAAOFHDfHABgFFA.WEHHaGGBBHCBhAHA.....hCBA...,2,-20,2,22
KCDLBTQIPMGVfdcFEHNeURaYgZWJAXSOb,OAAACAAALACABADA..QAGAMAFAGBDBdCCAECFBHDDAeDABhAAARDGFaBBHZDGB.AEEASFFDhADAbGBA.TGCAhAEAIHHA.fFFEFGAHNEIA..hBAA......hBGA...,2,-18,4,22
BLVQKOagDbcWIXEHFfNCZRGeSUPMAdTYJ,dAAATAAABADA.LAFAQACCKCBA.aAEADCEA....bAGDhAAA..ICHAhACAHBEDfDDAZDAAREDFeFGBhADASEFAUGAAAEIB.VGEA....hAIA......hBIA...,2,-25,-9,16
TMdBLGCVeWHJaIcUQOSgFPEfRZYKXADNb,DAAATAAAdADAGAFA..eACEHBBBaAFAIAHAQBFDhAAASCHHFBDHEDFFREGBZDEFhAFA.XFBAAAIBMCCB.hCAALFHBWEED.cGFD....hBAA......hBBA...,2,-12,-5,7
UCJVXKLPIHRTSbNecaZGdfYQWFMgOADEB,EAAACAAA..JACAKACA.LAEBHAFBRCBA.SAGA.eCCBhAAAZDEEdFAA.QFDBhAAAMCGBAAGABCHAXGFAhAFATFEANAIA.aECHfHBFFEHBDGIB..PHCChCAA....hCBA...,2,-19,-15,4
CIaMATBKQVdZcfPSNbJgGUDWEYRXHOFeL,TAAAQAAA.ZACB..fACBSAEAJAEAGAGAhAAADAIBECCARCEBHECB.eEHFhAFALCFBaGFBAAIB.KCHDhAAA.dEDA.PEHD.NHAB.....hAHA......hCAA...,2,-18,2,20
DgUSHAZPJbNXQOBKEdMVCFWcIaYRLeTfG,ZAAAJAAA...XADBQADCKAFAEBHFdAFA..MAHBFCAA...hABA.ICFARDDAeCHHGGDBhAIADDDBUEEAACCB..hACA.bGFABFFB..CDHAaHAA....hAHA......hAIA...,1,-20,-24,4
GLZJTdAgFRPMVHDYbXKeBUcQWIaECfNOS,RAAAMAAAHADBDAEA..XAFAeAFABBBAQCFD.aCCHEBDBhBAA.CBHAOCEDGDAAZEEAhAAAdDGAADDBFGEA..PEBBhBBA...bGCA...KGGAWEHHhABA.NIAB.....hADA...,1,-6,-22,16
JAXGBKPYFNfeROIaMdZcWSEbVQDUTLCHg,GAAAKAAAFACA.eADARAEF.aAGDZAGB..SBHHECCB.QCDAhAAATEDA.HDFBhACAABIBBDHAPDCB.fEAEhADAMFGBdFHAbGAADEIBLHEA.hAAACFDA......hAGA...,1,16,-31,47
cAbDIeMYdCKGUJNOaFLBZgHfXSQVREPTW,DAAAeAAAdADAGADAUAFA.OAFALBBBZBFFHDBB..SBHBhAIARFDAEBHF.TDDAhBAAAAAAbGFAMIDA..hBDAKDFCaDHDBEGA.XFBA.QGGAhBDA.WFFDhBFA...,2,-37,11,48
TPcVLaMEYQJAdSZRHfFWbDNOBgKUXIeGC,ZAAAHAAAFADADACABAGAKAEAUAGA..eAHHGCCACCAA...TEFAhAAAVCDA.LDHBhBIAEDHF.QGDAhCAAACCBREFB...WFCDbGAAOFHDIHHA.hABA......hACA...,2,-29,-5,24
XDAfcOHBWZSYKaIbTMeUNCFQPLdgJVGRE,OAAAHAAAZADBKADAaAFD....TAGAeAHBCCADQCCAhAFAdCCCJCGB.RCEAEDHFADFB.BBBDhAGASEED.IFBAhAAAbEFDMFCAFEHD.....gGGGhACA...hAIA...,2,-21,-12,9
ZbSPBVQfLFcNCWHDUAIeGgOdEaXMKYJRT,eAAAGAAAdAEAEADAMAGBKAFA..RCDA.ZBAE..SAHBBAHAQDDAhAAALCGBFCHBCDCDHFEAhAAAAEBAOEGBaDAH.JFHBhABA.....PHAAfGHA.hAHA......hBEA...,2,-19,-8,11
YTEdIDQZfXFCSObNVgeBaKAcGMLPHJRWU,GAAAMAAAHACCRADAUAGAEAFE..dAHAQCDBZCCAFCGH.ODAHhAAAVFCABFFBADGALEFAhACAJFHB.TGEADBBBCHFA.SGGBhADA........hAEA......hBAA...,1,-9,-16,7
gGXAUVdTWPFIKLOfDBEJbcMaRHSQZNCYe,dAAATAAAFADALAGB.DAIBEACE.bAEBMBDBHAGB.ZCCBCBFA.hACAeDGBGECBAAIBVEEBhAAA..IEHAhBAAOGBCBGHAaCBDRGEASHGANIDB...hBGA......hCAA...,2,-18,3,21
eMVBRdcPgYQEKOaWXZAHUfCIDNbLGFJTS,HAAACAAADACA.LADBGADB.TAFA.eAHHMAIBRCEF.dCBAPCABhAAAQCFA.EDDBhAAAaCCBZFEBADIBUFGA.hAGAfFAAIGGAFHAASGEBBEHA.hAHAYHAG..hACA...,1,-2,-15,13
eHVNFPbIaSBgKEAfJRMWTLdXYOUcDGQCZ,RAAAMAAALADBdAEA.OAFADAGAGBBA.ZBFBHBFAFBHD.bDCA.hBAA.aDEBBCCC.EDGAhAAAABBBJEGBTFBA.XEGAhABA.cGGAeEBDNEIA....hBDA......hBEA...,1,0,-24,24
UNZYPABbXdRLOWKeHTMICfVGaFDEQSJcg,XAAARAAALADBKADAHAFA.MCCBCAFBGAGADCHB..EDEAQCDAhAAASDHHgDAAhABAZFAAAAAAdFFAeHAEhAFATEFAIHHA.aGEBFFDB.cFGDhADA.NIAB.....hAIA...,2,-19,7,26
ALgIOENBYPCWZdHUXfaTceMSJFQKRbGVD,LAAAOAAABADACAEAdAGAHAEB.UBGAaBHD...eBBBMCAAFDDBhAGARCDAGEAAAAHA.EECBhABAPEFAZEFA.TGGAhBAASGEA.KHGADFFB.NICB....hACA......hAEA...,1,-13,-14,1
NUGATHYVFPfKJQWLZCSeIMBbgRcDdXOEa,HAAAFAAAKADAQADCZAFB.eAFEMAIBbBFDRCCB...dCADEDABaCHFhAAAGCGAACFB..TEDAhACAVFEB.JFGBCCECBFADhADADFIBNIAB...PHBC.....hAIA......hDDA...,1,3,-16,19
EPTgKSZWaRXDeCAYNLFUfbVQIJdGMOBHc,LAAAFAAAUADA.VAEA..QAFAdAHAGCAAMAIBHCCAECCBhBAATDFA.SDHBhABAaDBHRDFAeEDFACABfEEEhACAbFFA.OFHBBHBAPHFChBDA......hBHA...,1,5,-11,16
JbWDTVZCPageBFfOdEQLNAMXRHYcSGKUI,RAAAHAAA.SACEGADAKAFAUAFAJBHB.DAIBZDAACCCA...aCFDeCEBhAAA.FDGAdFAAEEGBLFFAhAAAAEEB.MHFAhABAXFBA.IHBAbFDD...WFHHhBFA.....hADA...,2,-18,-15,3
GZgYVMXeSacfOWNFUdELHbBCPJAKDTIRQ,TAAARAAAZADB....VAFAeACE.aAFAOCCHFBDH..EBFFHDFAhAAACBHA.ACIBDDABGDEBhAAAMEEBSCCDhAIA.fFFEUFFBbDADBHDDKFHBIHDAhCAA.....hABA...,1,-3,-18,15
OLBKJMeAGITVHXPURDaFcbWEYfCgNQdSZ,GAAATAAA.HADAUACARAGFaCDC..FAEE..bDFAEAHB.CCEAQCGChAAAZEEALFAAKDDDhAIAeGDAAEFB.IHHAhAAAXEGADIAA..cGDA...fGGAhCAA..hDAA...,1,10,-30,40
cFAOBVSKGDPWYeLCUafIXZTRQdEbJgMNH,BAAAKAAAGACADACA.....PAEAeADALAHBCAHA.hAAAaBCCXCACRBFF.hAAAECEAbDDDMCHBHFFBACIBSDFHhACA.UGGAfEHAhBHAZEBA.dFCC....hCAA...,2,-24,-7,17
LVKPIfNTcAFHDEXCQUaMdYOJBZRbSgWGe,HAAAEAAA.QADCaACDdAEA.OAFAZAFBRCGF.SBFHGDDAeCBBhAAALCHBKAHB.fCAEhAAATGFAADDBDEBBhBCACCCDMDEB.BDGA.bFCD.gFEHhACA.....hBEA...,1,10,-12,22
XZRPBMGgSKTIAVQOceWFUJbaDfNEHdLYC,QAAAeAAAFADDUAFAaACE...DAIBEAFAHDDAdBHALCDAhAAA.XDAARDGFMCCBGFBBhAAAKEEAADAAOECDhADAcGGCbEGB..fHBBCFAABHCDSGGDhAFA....hAIA...,1,-4,-12,8
YSJOKgNBCReVLZcWIFAdEGDPHTMbfXaQU,EAAAGAAAHACAMADA..bAFBaAFE.QCDASAHHKBHBBCCDhAAARCFBLFFAZCEFIDHAhAEAAAABdHDBDDCBTFGAhBHA.XEDD.......hACA......hAIA...,1,0,-16,16
cOHFPBJLEGDbYVAQWRMKUadgZNfTCeISX,RAAAMAAAKADC.dAEAZAFB....TAGAeAHFSBDAOBBAHCEChAGABCCDECCBGEEAhAIADCIB..VEDAACIBWEHBhBAAaEHH...fHGBXGEA....hCAA......hCBA...,2,-28,-10,18
eMaSNZWLFGObJARXHQIEDfcCTUdPgVKBY,HAAAEAAADADACADBdAFA....VAFABAHAeBCBaCACZCCBLCEBhAAAGCGAOCHDACIB.RDBBQFGChAIAIEEATGDAhAAAgGDA..MFBB.SFGDhACA...hBDA...,2,-14,-13,1
GONacWKVQXULYIHAZDdMJSeRBFCEbTgPf,dAAAMAAAeADARACA.CAGA.EAFE....TCBA..fBBEhAHAGCFAaAHDKBHBQEAChACALCEBHDGBhAIAAADAZECBSEHHbGCAODDBcGGCWFDH..hBAA......hCAA...,1,-9,-12,3
JLbFgCMNKVTdUZGeYOEacHfWRIPDBAQXS,QAAASAAALADAFACE.MAHBKAFAdAHAGCCAeCDAECFBhAAAHDECREAB.DDCBAAEAbEFAhABACDHBTFAA.ZFFAaFEChAIA.fGHEIHFABHHDJHEA...hBIA......hCAA...,2,-8,-1,7
cSYUAegKHMONDLXBTJWbaRCVIGZfPFdQE,eAAAHAAAMACADAEALAHBBAFA..TBDAJBCB...aAGDRBEACDEDhAAAGDDBZEBA.FEHDEDGBhABASBHHAEIB.hBEAOCCBXFFCbGDAIHHAdHBB..hAAA......hAIA...,2,-18,-12,6
VSQIGKFLUePAadXENfbCDMYHgJBRTOZcW,dAAAEAAA.....bABDMADAHADABAGARAGFZDAAVBCA..QDGBhADAGCFALCHBhAAAeEDHAAFAaFEDfCBEhAIADCFB.gFBATGGA.OEEB.hAIASGHB.hBAA...,1,-3,-6,3
GCPLFZHYQgSeKJVEODNbUIWTdaBXRAcfM,MAAAGAAALAEAHADAQAGCeAHHKBBA.ECDBDCEAUDFA.TFAAhAAAaDBARDFB.ACIBCEHBZFAASFCBhACAOEDFIGHAhAFAdGGABFED..fHEF..hAGA......hBAA...,2,-21,7,28
HgXIaPDOdCMcGVFNQKRBETeWYZUJfASbL,LAAAHAAAXADBaADD.OAFCdAFAMAHBGCAB.FCFAQCAAhABARDEBEDHF.eCHHhACAZGEAfHABhAAAAAIBSDDA.bDFD.gFBADFIB.CGHA..hACA......hAHA...,2,-5,0,5
EdabMAKTWFfUHOQVCYJcSLXRZPDGNgIBe,TAAAFAAAHACB.QAEACACB.JAHBLAEA.RCCAZCFBhAAAGDEAIDHAEDGBbEAAhAEAAAFAKFCAUGGA.OGBChAHAVFGB...........hAIA......hBIA...,2,-27,2,29
MeQPFCRTVfLabgEJAWSDUdIOKHcZXGNYB,DAAAdAAAKADAHABCZABBGAEABAFB.eAGB.QDGBCAHA.RDDB.hAEATCEALGFA.hAHAaAHFECGEACCB.UECA.hBAAOEFC.XGGAMIFA...FHEChBAA......hCDA...,1,1,-32,33
BPGcNQHDfESTZgWXIAbFMeOVRYadUCKJL,MAAAeAAARADAdAEA.KAGALAGB.GCCAQBBAHEABEDHFhAAAZCEEXDGAAAIBOCFHaFGChABACEBABEFD..cGCDhAEAfFGA.TGAAIHHAFGCA.hAGA......hAIA...,2,-27,8,35
ZPcNCRJTMbFGIBYQegAWdLUVfXSKEHDaO,dAAALAAAUADA.XADDEAFA..HBGBaAFAZBFF..PCBDhACACBHARCAA..MDEBGDDAhAIABDHBeFGBACAAfFFAhABADEIBNIBB.JHFE.......hBAA......hBCA...,1,-16,-18,2
CZXMGVBagAKYFebPDcOUIWdQTNLHSfJRE,FAAAeAAADADAOADC.UAGAdAGAQBCA.LBFDhAIAHCCAfDFAhAAAECHFZECAMEIBGDGABGDAACEAbFAAhABAIGGANEEA.SHFG..hBAA......hBIA...,2,-25,-5,20
YJgQafBcMWNTDSHCLVUeAZbXRFKdEPIOG,ZAAARAAAdADAEADE..OAFAGAFA..JBFBaAHF.BCAA.MCCBhABATDGAHDDBLDDBhAAAeDGHADDBFFABKBHBIFBAhABA..YEHBQFFCfHBBhACA....hAFA...,1,-12,-24,12
QMVTZLcNWeIJfdGRSgHFCbBaPODYKXAUE,EAAAMAAAZACBLAEA..NAFA.eAHH.IBBAdAGARDFFHEBAhAAACBDDBCEAaBHD..DBEBXCFDhAFAABCBUGBB.TFFAhAGAJEHB.SDDD.....hAIA......hBGA...,1,-15,-21,6
MdTAbENQeCHBPfWFULGJXcSIYZgVORDaK,EAAAeAAAHACABADA....fAFBFAFAGBDBXBGAhAAASBHHZCCAODFDhAEARDDBaDGCdFGAAAHAbECB.CEHAPHDChCAAWCCD..........hCBA......hCEA...,1,-1,-26,25
AdScUBJZDgXEMIaHVYLTFQfCeNPKRWGbO,dAAASAAABADAZABBDADA..EAFAMAGBHBFCLAHBFCEH.QBCAhAAAeDCFKDGDRFABbBEDhABAAAIB.UFFA.XECChBHAaDHD..TGGACEHBPHCCOFFB.hCAA......hCBA...,1,-9,-12,3
DZaBNLGbYcTJQFUIHMgKVOEeRfACWSPXd,SAAAdAAAaADA.LADAGAFA...bAGDTCBA.QEBBhACAFCCAHCEBMEAAhAAAKAHBEDHBREGBAAIBCEEAXFGChAHAZFAANICB...YHFG...hABA......hAEA...,2,-7,-7,0
bTXHdKgaAENecCOZYJVDWLBSUFMRfIQGP,EAAAeAAA.OADCZACBJAEBDAFA..LAGBSAHHMAIBRCCA.QDEDhAAAGCFAbFCAHEGBhBCA.dGBAKEHBAEIB.CGHD.hAAA..YFFFBHBAfHDB.hBGA......hCAA...,1,-10,-13,3
CabLTAHUdXGBZcVENMYReJDKfFIWOgPSQ,HAAAdAAAGADAZADBEAFAMAFARBFA..DCABFBFA.OBHDSCCDhAAAQCBDaDAD.TDFAhACAAAIBBDFD..VFDAhADAeDGHKGHBfEEE.IGHAhACA......hADA...,2,-19,-7,12
bIgBdZLWNPeaOVfTUFXRcAYKDCEMGHJQS,DAAAEAAAHACAQACASAEE..bAEABAHAZCCA.LCCAhAAA.PCGBeBHHaCFFhAFAfECATFFAXGAAhAGAACHACEEAMDIBIGGAdFHAOEEBFHAA.hAIA......hBAA...,2,-9,-2,7
QRICOMKXHcgJTSLbfNEFVDZPdWaeAUBYG,BAAAGAAARACA.OADAMAFA.HAGB.JCDATBFALEEA..hAAA.bDBDECAA.DBIBdGEAhACAeCDFAAIBQGGAhBAAKDGAXDAA.SEEB.FFDD.hBCAZGFE.aHBC...hBDA...,2,-12,-1,11
QHOIcaDVJFANZLgYWUPCBTGXfSRKedMEb,ZAAALAAA..gADBUAEABAGAGAGASAHHRCAAeDEBhABAECAAHFAA.ODHDhACAaCDCDDGAFGDDAEBA.WDFBhAFATEEA..KGHDbEGB.....cEBDhABA....hACA...,1,7,-36,43
RfELWbYSBdUTOMGKCFVJZDPcQeIXaNAgH,HAAAEAAALADA..bADBBAHAdAGATDCAGCBAFCHBZCFADAIBhAAAQDDCeCAAaEFAAAEARFDAhAAA....fFBAhACASFHBMFFBCHAA......hBFA......hBGA...,1,-8,-18,10
LeTMRNIBFaPJZOWVEKAgDUYQGHbXSCfdc,DAAAQAAAHABCSAEBdADAeAFARCDABAGAFBHD...aAHDZDBFOCCBhAGAEEFAAAFA..UGGAhAAAbDEA.CEHA.LFDAhBAA.MDIBPFEBWGCG.KGHD....hCAA......hCBA...,2,-17,-7,10
QUZaIdAWGBCYSVNDLKcfPJTEbXRFgOMeH,GAAACAAA.SADADACALAFAKAGA....fCDAhAAATBCAECBBRCEFOCGDhACAHCFAZEBAdEADAAGABDEDVGAAPFGBhADAbFFAFHCAeHFE......hAAA......hBCA...,1,3,-15,18
DQMVAgLJXRHeFcfWBYdKOaESPTUCNGIZb,LAAARAAAHADBeAFAFAEA.....fBHABAHAdCAAaCCAECCBSCFHhAAAUCFAGEBAhABAbDADMDIB.ADDB.XEEChABA.cFGBKEEDTGFACDHAZGAEDDABhADA......hAFA...,2,-21,3,24
BgLCAbVdSHZKfWNOIeDaUJTRYMFXEcGPQ,dAAAHAAAZABBKADC....fADAOAFCeCAADAFA.aCEATBEAhAIARCGFMDDB..EBGEGEEAhAAAQDDCLHAAhACAADGAbEGBSEHH.IHHAhAHAYFFB.....hAIA...,2,-13,-3,10
RMYabKJHISgXGFPVCTDOENALZWeBfdcQU,ZAAAeAAAdAEAQADARAGB.MAGBaCAAKCFBHCCA.SAHBhAAAGDAAFDDBCCHDOEEAhABAAAIBLEFAfEHAhBFA.cFFCUGGA.YHBAIHEA..hABA......hACA...,2,-21,10,31
YFZOfHPeLVMbARWXdQNBKJcTESUICaDGg,RAAAdAAAQADCKADA..TAGAEAFESAHBCCBA.GCDBhAAAFCEAZDAAHEECeCHFMCCBhABAAAFA.XGCAhCAABDDBUFEAaFHD.DEIB...gGGBhACA......hADA...,1,8,-30,38
gVJeILCfSTUbAYKWDdQOaNHXRMcBFZEPG,KAAAdAAAaADAHACB.RAEABAHBEAGA.GCAA..gBDBhACAeCFALEDASBGAhAGAbEGD.ACCADDDBQGCAhAAAXDGAMFABZEEAPGDA.IHHAhBAA.CHDD....hACA...,1,-4,-8,4
HJWgDTYBMKFRLZQSaNIGAVCPfcOUdbXeE,CAAA..fAAAOACAdAGAeADAHBCAJAGBDAIBBBCD..MCBBhAAARCABZCDBQDEAhBCA.aDGEGDGA.hBFAAAIBcFDDbFGDEEDBTGBAYEAFFHDESGGDhAAA...hBGA...,1,-7,-10,3
YKPCANMdLIaZFSVeRJUOgQTHXBfGcDbEW,dAAAaAAAZACBSADA.RAFF.OAEC.TCEAHCACfBHAhACAGCGADAGAEECAKDEAAAHAhADAMBBBLEAA.hBAAFDHDeFFBgFFBQGCA.BHHAhBIA......hCAA...,1,-7,-11,4
TWBYSOEKHGMDbgARNeUdJIZPCXcQFfaLV,RAAAeAAAdADAZAEBCADA..QAFAFAGDLDDA..TCCABCHAOEFEhAAAHCEBGDGAhAAADCCB.AAIBUFAA.IGDAhABAXGGAaGGH.......hABA......hAIA...,2,-37,0,37
JXbTRPYEaFOUMBVIcdWKGDfZgQCeSALNH,HAAAXAAARADFEAFEFADAUCAB..MAGBBAHB..VCDBdCFAGDGAhAAAZBGBQFCChAAAeDDBACHAJFFFTFFA.aDBBhABAOFDH..IHAA.KEHB.hACADICA.CHHA....hADA...,2,-7,1,8
TMcDLRaEQBPJZdOYINGfbAXeFHgKWVCUS,eAAAHAAAKADCCADA.SAFAMAFA.LCAAEBEABBGAZBFEdCCAOCEHhAAA..IDFAhAAAGDFAADHAFCHDgGAAhACAUFFADEEBaHGEPFHD..NIBB.fHEBhAGA...hABA...,2,-29,2,31
BEcDUXOKIPfSGWaMdTNFVCQbZLYAHJgeR,HAAAeAAAEADADACAOAECKAFA....fBHAGCCAaAGAdCCAhAAATCFAFCFB.QEFBhAAAZEDEAAHAREGF.BCHBhCAA.cFGD........hCCA......hCEA...,1,-17,-24,7
QORebJaEgSHTMCYDXdFcUVAIKNBWfLZPG,KAAABAAALACBGACARAEAeAEA..aAHDEAHFHCAB..MCEBhAAADCGBdDHAFCFBUEAAAACB.hAAA.IEEAfCHAhAEAZFAAQGFAbFFASGEDCHAA...hAEA......hAFA...,1,-10,-13,3
McKTZSGIVOEgHbJCXWYFafDUQNBRPLAde,eAAAMAAAKADAZADBGAFA..OAFAHDBACAHAXBBCFCHDaDFH.hAAADBGB.UDDAQFBBhABARCGFABIB.dFHATGFAhBAASGGD.EHAEbFCC.....hAHA......hBDA...,1,0,-23,23
SNOAVGMYfCBEcHeIQPZLRgdbDTKXUaJFW,GAAAMAAA.CADABAFAHACCeAFE.QBFDZAGBRCDBdEGADBIBTCCAhAIA.KBBDaDAHFDFD.hAAASCHHACFA.hACAfFGAEDCBIHHA.LFFDhADA.XFAAWEED.hBAA...,1,-15,-18,3
BZbDKSQCVXNYdfGaEFcWRgMLAJIHeTOUP,HAAAeAAAOADCBADBZAEBKAGCQAGA.CCAD.XBGAhAAAdCCAaCFD.ECCA.FCEDRDGFMEEBhAAAADGATEFAUGGBbFAADFFBhACA....SEHBNIBB.fGHEhABA...hBIA...,1,-8,-13,5
RBEPWFCaUOfJKdZgLITSDcXVNQYGbHMeA,EAAAFAAACADAUADA..OAEDKAFAZCBA.LAHB..TAGAhADADCGB...XCCChAGAQEFBGCFAhAIAHFDBACIBRFGFBGHAaEEHdHDBSHGG..hAAA......hBCA...,2,-27,-19,8
HYKTdEIXOJVZaCBcfSbLePGWRFAUQNgMD,QAAAMAAAHACCKAFCEACA...OAHDZAEBaAGDBBBD.SCDAhBAAeBDFGDFARCFFADCBUFFBhBHADAIBdEEC.XGBAhAAACEHB.fFHA....hBGA......hCAA...,1,-10,-23,13
DcYSUGOQMeLBNAZPHdVfXCIgFWTabJEKR,HAAAdAAA.XADBCADAFAFA...aAFDEBEFRBGFDCAB..SAHHhACAGCCAMDIBeCBFLEFBhAAAACGBZDCE.fFBAhACAgDGAbFDDKFFD.....YHDAhADA...hAHA...,1,-4,-25,21
KgHbONSVWdaFLQReXEPZIcGUfJBMDCAYT,TAAAHAAAOACA.SAFAdACAaAEALAHBRCCA.EBEBZCFBhAAAGCFAfCHAhAGAMDDBABHBKEHB.bFCBWEDHhAAAQGGCeFBBXFGD....hBFA......hCAA...,2,-10,3,13
VKUdLeQYXaMSZBPFDHIJAEWGORgCTbNcf,EAAAGAAARACA.CADA...TAGA..bAED..fCCEhAAAKAGAdCDCeCGHQCEAhADAaDAHZFEAFGAAHDGBAAABODHDhACAgECA.cFAC.UGGBXGCDhADAMFFBBGDA.hAGADCIB..,1,15,-14,29
GNaSLUbHYTWdMgAQPfOZJCXFRBDcIEVeK,QAAAOAAAZADB.CACA.RAFABBBDDAEA..EAGAeCEHGBDA.aBFChAAALCHB.HDBBhAGATDFAdEGCABDBfDCEhBIAFGDAIHHAKCHBSFFA.hAIAYFHBWHDA..hCAA...,2,-26,-10,16
XGVEfKcWMIRCHTPDbZFQgBaAYSLOUeJdN,LAAAeAAAdAEAGAGAEAEAKAGA...MBDBRCAAHCEADCCBZDFFQEABhABABEBDAAAA.OCHDhACAUGAA.XECD.hAGAfEEEIEEACEHAbGEAaGHDSHCGhAEA.....hAIA...,1,13,-25,38
GNOYaUSPDfEFAWJKdgIMHQVecBCbZLTXR,KAAAdAAAMADAHACBeAEABAGAZBDALBHB.RCABGDEAOAHDaCAEhACASCFB.fFAEhAAAABEAJDDA.QGGAhACACDHDTFFA.YEDFDFIB.WHCGhAEA......hAFA...,1,-1,-35,34
LWObPENIDfHcaJMFAYZKgSeUCdRTQXBGV,ZAAASAAAeACEdAFARACF...QCCBGAEALAGBOAHBEDFBhABADAIBHEAA.aDEHhAAAMCIBADIBKEGACEEDTFGAhAIABGBAbGEAIGDA.fHEFhCAA......hCBA...,2,-15,-5,10
YADCTfZSUNPgebVcMGELaWIdXQKFBROJH,TAAAZAAASACE.UAFAPACA.eAFAVCDBGCCAhAAAECHF.aBGEdEGDQEFAhAGABAHARFBAHGDCACCBfFEEhCAA.bCFCMCCBIHHAFGGA..hCEA......hDAA...,2,-4,-3,1
PEDRKMONAJbCWQZIXeLVFaScTGgfYdUHB,CAAAZAAA.eACELACAFAFA.aAFD..TCDAGBGA...fCCAhAAAdCFAHDGBEFFBhABARDABMDEBAAIBJHCA..bECDhADAIHHASAHBYCCFBFFAKFHB.hCAANIEB......hCBA...,1,-1,-17,16
EbYHcgOdBaNDePZSKIQfLGUJMVWTCRXAF,EAAAHAAA.OACAaACDDAEAeAFA.ZBFEKAGAQCCAGBDAMCBBhAAATDFARCFF..ACHAFDHDhAIAbFFA....gGAAhAAAdFCABFFDSGHBLHDA...hAGA......hCAA...,2,-18,2,20
CcSgdBaNEOPRIMWTKLUfFHGbAVeJQZDXY,eAAAZAAADACACADA...SAEAdAFABAHAECCARAGF....MCCBhABATCGALDDA.hAAAFDHDHDEBAFAA.QFBAhABAXFCAgFFBaEHDOGEEIHAAhAHA.WHFA.hAFA...,1,-12,-34,22
XPVBHCTYSFAEcWILMebZQNaODJdKGURgf,EAAA..IAAAeACAZAFBaACADAIB.dCCAGAEARCGF..XDABhAAABAGAHBCB.TCGAhAGAFEDDAEIBLFFBhADAbEECQGEAOFBDKGHB......hAIA......hBCA...,1,-10,-13,3
DPEBJNXSIaMOQARCeHdTZGcbUYfLFKWgV,RAAAHAAAZADBGAFAUADALAGBKAHB.VDDAEDAABDEA..XCAAhAAAaDGD.MAIBhACAAAAAeEHHdEHA..bFBBFFBAhADADFGBJFFF..SHFAOHAA...hAHA......hBFA...,2,-15,-1,14
HGIXYKVERPOTZLFWbCSeMgNQJAfadBDUc,dAAADAAAHABCGADA..XAEBKAFARCAAOAHDZAGBLDDB.hACAFDFHbCFDeCCD.MBIBhBAAQFAAABGBBEHDIGGAhCAAEDHBTFDA.SGGA.hCBA......hCEA...,1,-6,-15,9
YHOAZGdQJgLfCWabDecBPNEXFRKISVUTM,dAAAQAAALADACACA.aAGDDAEA..eBHHBAGA.EBDARCAASCEBhACAUCFA.MDEBhAEAHDDBADGBZFAAgFGAhAAA.fHDBbFFAPHFCNAIA....hAFA......hAIA...,1,-9,-17,8
QeGCBdLVYMZNJAUHfTKaRcXgbDWEOFISP,HAAATAAARADF..XAFBDACA..EAEAFAHDSAGAeCABGCEAhAAAdCCALCFAhAAAMCCBZDGBADDBKEDAaFHDbEGBOGDChACAQGCA.BDBCNIEB.fGFAhAHA.....hADA...,1,5,-4,9
KbXTdNQfEZISBPAUOcLHYJWVCgeMFDGRa,OAAAHAAAJADA..CADA.eAGHMAFAGCABRBDA.aBHDKBBD..TDEAhAAAdBGAQDDBhBAAZEGBBECAAFGBLEGBhBIA..VGAADCIB........hACA......hAGA...,2,-28,-6,22
DaHJFfPZIXUKCEdAWGeTbVgYBRMNLcSOQ,eAAATAAA..VADABACB.RADFLAFBOAGDQCCChAAAHCGBfAHEZDFAUFFAECCBhAAAAAIBGGAB..hABAbEEDMIDASFCAaEEH.FGGA...hAGA......hCAA...,2,-3,2,5
DaNLFCgEJZWTMOPHXbGUIeBcQfASVRKdY,RAAAdAAADADAaADALAGB..CAGAEBDBZBDBMAIBHCACGCFA.hAAAeAHHQEFAhABAACFBKEBDFEEHgFCAhBGA.JHFAODHD.bGAABCCASGHDhACA.....hCAA...,2,-24,3,27
FVgRXeGcLUZATEbHPaKNMJQfDYSOWdBIC,EAAAHAAAKACAMACA.QAFADAEA.OAHFdAHACBEAFCCBRBDBeCCBhAAAGBFALDGBZEDBADIB.hAAAbFCA...aGHDfFFEhBHA.SFHBBEFB..hCAA......hCBA...,2,-35,9,44
UPKbVdNBXLDgTcZaGYJMSCIEHFeRAQOfW,QAAAOAAAUAEAKACA.dAEABAGALAGBDAIB...TDCAhAAAaBBCGCGAMAIBCEFAHDBAhBAAREGF.ABDA..fEFEhCAAbFDD.XFDCgGBA..hBGAYFHBSGHHhCAA...,1,-14,-21,7
eVASDgILYZRHaOGMNBQdUCFXPKEcbWTfJ,DAAALAAARABAHAEBGADABAGA.dAFBFBHDKBGD.ECAA....bDCBhAEATDGA.eDDDhABAAEEASEFA.hACAIGAAaFEDMAIBQGDAXGFD.cGGAhAGA....hAIA...,2,-34,-6,28
PTgKAHfcEWZdaYeIXVRBQJNDSMUGCLbOF,HAAAEAAAdADAeACE.XAFBRAFAQCBCDAIBUCCAGCGA.LDEBhAAAbBGD.FFAATFCAhAAAACIB..fGAEhAFAZEFAaGGBIHHABGDDSFHHhAGACCFD......hAIA...,1,5,-12,17
ULREQdZfMWGbDXNTYFOIKPScAVCeaJHgB,eAAAHAAABADBRADA.EAFAZAGB.MBIBGBGADCCB.TCCAFDDAKEAASCADhAAA.AAIBaCEDhACAgEFALFAAhAFAdGAAbEFD..XFCAOEHDcGCDhCCACFHA......hCEA...,2,-22,4,26
PCVUNdcHLKZbaIERfTWFOBSgAYQDMJXeG,QAAAMAAA.eACAGACB.CAGBUCDBdAGAHBEBZCFBaBBHRDAATDGAhAAA.OECEhADASBHHAAIBDFGBXGBAhBGAPEHB..cFAAKFHB.....hCAA......hCDA...,1,-1,-26,25
XEdNBbMSaGATJPVeDcZCIOKUWLQgfHRFY,TAAAVAAA..eADEZACBOAEC.KBHBLAGB.QBDDhAAAHCEARECAXEGAhAAAEDEBdEGAbGCAaCAHAAGADAIBhCAACGCDUGEAfGHAFGHH......hCGA......hDAA...,1,0,-13,13
ATODZMKcFbHLQPSefNBXaUYCERIgGdJWV,TAAAZAAAMACA.FAFDHACB.LAEAQCCBeAHHBAHAaCACCCEAhAAARCFAGEBAdDGD.VEEBhABAAAFAKEEA.bFGDfEHAhAHAXGCA.EGHF.......hACA......hCGA...,2,-4,-3,1
BHYbOGQMPgXRaKLUTFcNSECIVDfdWAJZe,eAAAHAAAOACAGADAMAFA..XAFARBFFaBHD.LCCAhAAATDBA.FCGH.SDHHhAGAEEFBCEHADFBBdGHAAAIBZECAhCAABHBAbGFA.PHEA......hAAA......hABA...,2,-7,-6,1
dUFgGTefMHbPYKROAcLBIXaSDENJZCQVW,LAAAXAAADADAEAEAZAGB..QAFAdCAAFCCAGCEAeBCHHDEAhAAA.bEBCKDHBAAIBBCHAhABAaEAESFHDhABACEHAUGDATGFAMGBA........hBEA......hBHA...,2,-13,-3,10
NdLbYeCRGPAOaJUBVcgDTMFZSWKXHfEIQ,aAAABAAA...VACADADAMAGBZAFB.KAHBHCAA.EAHFQBBBhAHAdDHALEDAeBDHRFAAAEEAhAAAOCED.cDGBhBAATGGA.SHEGfEHA.bFBA.hACACGGD......hAFA...,2,-16,-10,6
UdJacQYVeIFWAZbGSNTfPDEHMKRLCgOBX,GAAATAAA.DADAHACBRAEALAHBOAEABAHAdCDA...aBEDQCFAhAAAeCABFCGAADGBbDBDhACASEBH.hBAAfEEAEEFBMEIBCHFAXFGA.cGFChAAA....hACA...,1,-5,-19,14
dTKfLRCHDaZcPEgeSOIBJMXYAFQGbWVUN,GAAAVAAA.dADAKADCRAFAHCDCZAFB..EAHFeCGH.ODBDBBEAMCDBhAAAAAABQFFBhACA..bDGDNCIATGAAhAFALEEBDEEB.........hCAA......hCIA...,1,7,-32,39
HXIMERCFBAQfKUdJPeaVGYbWDgSTOcZLN,QAAAKAAAdACA.eACAGAEA..bAFADAGA.TCGAZCDAHDAAhAAAMDDBRDGFBEEA.hAAAAAGAfFCAhADAPEABaEBF.YFHBSEEAOHCCLFHBhAEA.IGGA.hCAAEHBA.CBHB,1,0,-22,22
BVOeIfbADJSFHLPgaQCXTcEKNMGYRdZWU,SAAAHAAALADB.aAFAQADA.TAFAEBFBMAIBhAAARCCBZCFEBCADeDABbCGDhACAAAAAFEFDCCCCKDEA.GGBBhBGAdEHAWHAAUGGAOHFA.DHAA...hEAA......hEBA...,1,2,1,1
AZLYJFIWUPcQNCEbKBVSaRGgdXHeMDTOf,ZAAALAAAFADAUAGAQAEA.EAGABCAA.aCCCRCAAdCHAHCEBhABAeCEB.MDGBTECAhACAACAAJEAF..IDHAhBGAPFHB..CHDA.bFGBSEED.hBIA.XGDA.hABADGGB..,2,-15,-12,3
aTZLDMGXHPVNQdWKREcUASbfBgCOYeFIJ,SAAABAAAOACAeACHFAFD...aAEAZAGBLAHBGBCAHEEAhAAAVBEB.dCBCREBAEEGAABIB.hBCA...bGEACFFDIGHAhAAADDIB.MHBA......hABA......hBEA...,1,-15,-17,2
aZOXEUVSIWgHPARMDdeKFGYQfCLcJbNTB,RAAAdAAAeADEGADA.QAFALAGBJBDB..bABDBCFCZCFEEDABhADASCHH.hAFA.gEFAhAIAHEEAAAAAMCCBFFHDCGEDTGGAaHBA......hAIA......hBIA...,2,-24,7,31
fAbPFZTROSdgJXecGWMEaVCUBYKQLINHD,FAAARAAAdADA..XACDeAFAGCDB.EDHFaAEA.CAHABBEBKEEDLFAAhAAAHCECACHAZEEATGEAhABASEHB.hAFAJHAAMCCB.UGGAIHHAfHCBhAGA......hBIA...,2,-25,-3,22
FgENSBfJALVbWHdZaIUGQPCOMTDYeKcRX,LAAAVAAA.HADBaADA.GAGA.QCAAOAFDMAHBhAAATDEAeBDFRFAAFEHDEDFBBDHAhAIAAAFAdGFA.ZFFAIHHAhABACEDAKHFA..........hACA......hAIA...,1,-1,-19,18
fUFRTXEVNZSQCBYOKHDdcbGPWaILAgeMJ,eAAAMAAAUAEARADA..EAGEZAGB..QCCCBBBAKCDDHDBBhBAAdCFAGDGA.aCHFABDAfDHAhBBATEAAXFDAhAAASEEA.OFHDDGGB.bGBA.hABA......hAEA...,1,-8,-20,12
AUMCeEbaQPXcZgGdIOSKWFDLfHTRYVJBN,MAAAEAAA..aACDQADA.XAFAZADBdAGASBFDhAAA.FCBHLBBBhAGAHDFCRFFBVGBABCFAAAIBhBAACEED.eCHF.bDCD.gEEBOFHFDAIBhBCAfFHA.hBGA...,2,-16,-3,13
SXZAHUDLIbKgCQBRWEPMGaVcdNOJfFYeT,HAAALAAAKADCQAFARADFEAFE.GCABaAHDdCAAOAHF.hABAFCFHeCCB.TCFAhACAZECBAEHADFFA.gFGAhAAABDHAMEEB.cFFAfHDFSFCDhAHA.IHFAhCFA..,2,-15,-5,10
GdSXCAEVYWZJRBIPHcgUbNQTKeLFDfOaM,EAAAVAAAZACB.BAEAHADB.UAGAQAGAeDAALDFADCBBaCEA.hAAAdFAA.CEED.ADEAJDGBRFGB.hAAA...IGDAhADAgFEDbFBDKGFDOEHD.GGAB.hAFA......hBFA...,2,-15,3,18
aGdULeDEYJWgQNMFXPVAIRHcTfCbOBSKZ,HAAATAAACADBBAFA.ZAGBdACALCAAEAEAJAGB...QCEAhAAAMAIBFCDD.XECAhACAACFBRDFA...bFACKEAAhAAAaCHDeFFADFFAgFGA.NIBB.IHHAhAEA...hAFA...,1,-8,-19,11
WSNRaBUgfYbdTeEPKOXLJMDZQACGVFHIc,GAAAHAAA..IAEASADARAFFBAHBUAGA...fCDAhAAAdCADECEBOCGDhAAALDFAMCIBZEAAADDBFEEHhACAcEECaGFD...bGBA.eFHB...hADA......hCDA...,1,-3,-17,14
EUPXZgCcASFHReOYMfbKTDVdNQJWGIBLa,HAAARAAAeADEMACA.KAFATBDAdAHA.QAGCGBDALCCDhAAAECCBUDFAZDGB.CFEAACGBOCHDhAAA..bGFADEEBhABA.NIAB..IGGA.....hCAA......hCFA...,2,-13,-4,9
LDVgeSdKcRaPXbNOHFCTEYMGJZAWBfUQI,BAAAQAAALACADADA.eAFHdAGARBDBaAHB....XCGAhAAAbCCB.HDBBCCHAEDAAGEFAhAIAAADA.fEHEhBCAIEEA.SFEDKDGDPEHDFGBHMIBAhAAA......hBIA...,2,-27,6,33
gQCVDUWTdKMJRNaAOLEbcBZSGXYeHfPFI,EAAABAAAGACAeACAHAFAFAEA.QCAADAHBUCGB.dCDAKCBDRCFAAACALEEAhAAAZEFA.SEBHhAIAfFCA.gGGBhAAACFDD.WHAAMFIB.aGGB..hBCA......hBEA...,2,-21,-1,20
CBVgPGTKNSYcRWeDZAaEOdXMFIfbLQUHJ,EAAAdAAAMADAFACD.....IAHAbADDLAFAHBDABCBAhACAVCGBGEEATCGASDBAhBAARFCBDGABACFA.aDFHhBCAfGHAQFBA.CEHAKGEA.cGGAhBDA.....hAAA...,2,-14,-1,13
TBaeUMPcFOSbYQARDfVCJKEGXZgWNIHdL,RAAADAAACADB.EACAZAEB......NAFAHAGBdAHATDCABBBDeBDFhAGAUDGA...MDGBFFEBOHBChAAASDHHQGGAhABAAAIBfEDA.KGBA....hBAA......hBGA...,1,-24,-28,4
DcYJXLdFBgCENaOeAGMRZPTSVHbKIUQWf,RAAAZAAA.SACEHADBKAFAQCFADAFA.JCCFdBFA.BAHAhABAEDAB.aCCCAAAAGEEAhADAMCHB..TECAbFACIGHAhAFAfEEBYHAGLGEA..hCAACEHA.NCIA.....hCBA...,1,7,-27,34
KCRFNISMQBWeLgacXbDGYVfHdTEUZJOPA,RAAAFAAA..SADBMADAQAGAeAFAaBGE..XBCAhBAAGCCAVEFAHCEBECGBZCFAOFABhAAAADBACEHABFBAWFEDhABALGFA.........hAFA......hAGA...,1,-7,-14,7
ULMXETVeIBJaACdDQcGfOHSNbPYFKRZWg,dAAAQAAAGADAHAFASACA..bABDFAFARCFAZDAAUCDAMEFBhADAEBHFeCGDBEGAAAHADDAAhAAAOEHD..PFBAhADAKFAA.LFFA.....hAFA......hBAA...,1,-5,-9,4
YKCQPWVBRgNOUGDFIceLJaAfMSTHbdZXE,MAAAHAAAZADB.EAFACADAQAFA..PAHDBAHARBBBOCABhAAAGDEAFCFBeCHFhAFAaCCBADHBTFCAdEEDKEHBgGGAhBAADGGB..IHHA..hACA......hADA...,1,-11,-15,4
LZIGAPcSROJEDYdQHXCbTfFVWNKegBUMa,SAAARAAAEADE.dADAHAFB.CAHA.bAEDTCCA..FAGAVDGBhAAAKCCDeBGBBECDaEEBhABAZEEAAAAA.ODBHDFABQGGBhAFAfGEANICB.MCIB.IHHAhBDA.....hAHA...,1,-8,-10,2
NQbVIGHMWcCJTUgaEDRAKdXeLZOPYFSfB,dAAAeAAAZABBOADCFADDBAFA..QAGC.ICCAhAAAHAGBMCFBCCEAUDGAEDDBAAIBhAFALECA.SFABhABAbDFD.GGEBJHEAaDHDDIAA..hAFA......hAIA...,2,-24,-9,15
QcAOdSGHYJUZTFBeDXEbgNCMLaIKfWPVR,dAAAHAAAUADAZADBTAFABAFA..eAGHEBHF.....bABDCCADaCCBhAAA.KCFD.fDHAhACAPCHD.REFBAAHAGDEAhAIA.FGGADEEBNEDA.MFIB....hADA......hEAA...,2,-21,-11,10
WHPAaOeJMKQSIGVLCfTcNXZDUFYdRgBEb,eAAAMAAAKADAQADAGAFA.LAGB.TCCAXBBChAFAZDFAFEEHRCDBEAHBHFBBADHAaEGDhAIASFHD.hBAACBFBfGFADEIBdFDDBHHA.....hAAA......hABA...,1,-2,-15,13
YCBIZHKDfJVMGXPRdLUcTNgeSOFWEAQba,aAAABAAAHACBDACA...VAEAGADB.RCBAdAHALAHBUDFA.TDEAhAEA.eBBDFECDABCBhAAAbEGDCDHA.KEDD.MHCAhBAA..XFECNIEB.OFHD.EGABhAGA......hCAA...,1,11,-30,41
ELYHQaOVTIgSZXFGAPbNUcCWDfdKMeBJR,...bAAAUAAA.CADADAFAdAEAeAGBBAHA.ECAAHBDC..aAHFOCGDhADATDDA.SCGDhAAAZDDFGGBBADIBcEBAhABAKGGAMCIB..RFFA.......hACA......hBEA...,2,-29,-11,18
aICHXZAefUOWgRTPSFBJVGQdbYELDKMcN,eAAAOAAARADA...TADAFAGABCCA.GCEAdAFAEAHBLCGBhAAAMBBB.aEAAHCCAACIBUGGAhABAgDFA.hAEASDHHQGDCbGDA.DEEB.NIABCHHA.hCAA......hCBA...,2,-12,1,13
dgNVHDLUFBRaWeKJcXfZQTAbIGEOSMPCY,GAAAEAAA.MADACACAdAEA..VAGBHAGBLCDBBCCARDEAeDHHhAAAKCFDJDHB..XEBAhAGAZDBBAAABOFFBSFDHhAIA.gGBDDGEBaGHD.fGFAhBEA.....hACA...,2,-16,-2,14
KYLWOTPXDCIMfNJUSgcZAVeaEFdRQGbHB,eAAAEAAARACA.GADAHAFBKAHBLAFA.TCFADCCBMDAB.JDDAhAAASCCDZDGB.hADAAAAAaCHDdFFCQECDhAFABEFDODBHCHAAIHHAfFGA.gGAAhAGA.FHCE.hAHAYFHB.,1,1,-2,3
MfLAKabZHeUdDBTVcOSEIJPYGXgQCFRNW,aAAAHAAA.eACEdADABAFATAGA..OAGDECCA..JCEBGCEAhAFAQCGBRDBBMAIBAAFAZFFAhAAADBBB.SEGAhAIA..IEHAXGECFGDB.fGFAhBAA.KHGA.hCAA...,2,-20,-6,14
FTgMHDaELKbNXJWCBURQdGfAePVSOYcIZ,eAAASAAAOADC....IADAZAGBTCCAHAEBEDFBbAGBhAAA..XECAhAAACCCARDEAGGBBAAFAVFGBFFGAMBIBhABAaCHDLGCAKGGD.NIBB.BEDD...hABA......hBIA...,2,-4,3,7
cLSHfTEKegONDCJZXIMYWAGRFUbaPBdVQ,RAAAFAAAUADA..aACDdAGA..QAEALDDAHDGBEAGAeBHFhAEAOFBACCDA.ZGBAMDFBhBAAAAAA.GGEBBFFDSGHHhAIAfEGE........hBFA......hBGA...,2,-22,-14,8
NFOWMcDHLCJSPEKZVTgAbfaIXUdGRBeYQ,aAAAXAAAGACARADA.BAEA..eAGHQAGAOBHDMCDBhAAAHCEALEABCCEA.hABASBBDEDAAZEEATGAAhADAADIBbEEAIGCAdGEAFGGH.DFIB.KGEA.hAEA......hAGA...,1,2,-4,6
TLXfDYeaNZdERPcMGBSICVJbgAOQFKWUH,QAAAKAAAHACBLAEADADA.eAHHZADERAGFMCABGCDABCEACCFD.hAAAJDFBACIBFEHB.UGGBhAIATFAA..fGEAhBCAaDHDEGCA..SGGA.IHEAhAAA...hCAA...,2,-21,-7,14
LFASXYCHEfPbOdTRQeBDJWVGKNMUZaIcg,XAAAHAAAEADE....bAFBdADA.RAFAeCEFDAIBJCAFGCGA.hAAAMDBBaBHH..gCCAhACAAAAACFEAOFAHTEEAhCCAQGFDBEGBKFCANDDA.IGGA.hAFA......hAGA...,2,-13,-2,11
ZWBbVPGdTFQJfADNYeEKHgcSUOXMRLaCI,DAAAeAAAHABC.SAEBXADARAGBLAGBCCCA.ZCCAbCFDGECAhAIA.dEEDTEAAhAAAQFGAAAIB.EGBBhBAAKCED.gFEGOHECMBIBaEHDBGADhABA......hAEA...,1,10,-21,31
gZKVbaRYSeHGNCDTEBdXMJUcQFfIWPLOA,ZAAAKAAA.aACARACF..eAEEHAEBGBEADAGAEBGEdAHA...MCABUDEBhABAQDGAFCCH.hBIA.fDHAhCAAIECALGCAAFFB.gGFHYFHBCGGChCBA.BHDA...hAAA...,1,-11,-16,5
YGIQUJVgDLfTSPaKObXZWCNMeHABREFcd,EAAAdAAAGADAUADA.JAFADAGA.LBCD..TCBAaBFAOBHDhAAAZCFBCCHA..eDABhACAHCFBREGFFFDBIFDAhCAA.QFFB......hCBA......hDAA...,1,-19,-20,1
EcTYJLfgWZHXUQebIDaOMAdGFPRSNCBKV,GAAARAAACADB.KADAEAFA..TAGALBHB....fCDAhAAAZCCAHDFBQECAhAAAeCEHbCFD.aFABAAFAdEHAhACASFHHBCHAcGGCgGCG.hADAWCEE....hABA...,1,-8,-21,13
DYOWNMPbUJQfLCIaceKGSRHBTFdVgAXZE,EAAAOAAA..MADAUAEAQAGALAHBaBBCeBCA.GCDBhAAAHDBATDFAdDBAABCAZEEAhBIADDDANDIA.JEHB.CBGBKFFDhBAARGCAFGGH...........hBDA......hBEA...,1,7,-19,26
MYBaUIObfCFXeJLQVZSHcgDPWGEdRANTK,TAAAMAAABADA.UAFAOACA.CAFAFAHBeBBB.LBHBhAIAZBDAHDDADDDAGDGARDFBAEEB.hBAAKCCD.aFDC..bECDhBCA...JFHBSGGD...hBFA......hCAA...,1,-12,-24,12
JYgbfdMcDIFeRCVOUBQXHNLSKGPZEATWa,aAAAJAAA.......bACDdADA.MAFADAEAeAFARBEF.OBBBhBAAQBGCHCEBLCGBhBEAGEEBECCBABIBTECAhCAA.gFGAfGHAFGDDCDHA..hCEA......hDAA...,1,-2,-30,28
NDgReMQZKAPEBbXOafcYWJISGUTLCFVdH,EAAAXAAA..aACD....fADA..cAEAhAAAYAEBIAHAhAGAGAGATCDALDAAhAAAFCBHHCGBDDGBREEBeDHHZFCAACIBbFFDOGAA.hBCASGHHCHHB.hBEANIAB...,2,-13,2,15
GcfJTCEIOMSebgaDKFBLWNHXRYUdAZVPQ,ZAAAQAAAGAEAJAHBEACA....MAFAeCABaBDDFCCH.LEEAhABAHBFARDEBdDHAAAEB.cDCChAAATGAA.OEHDhACAbFBCKGGABAGC.XGDAYHBG..hBFA......hBHA...,2,-10,0,10
dfYWNeAXBFCMgORVUZEcaSPGTKJbIHLDQ,FAAAMAAARACFZAEB..EADA..aAGDGAFA.TBBAKCHBJDFBHDDBhAHA.LBHBhAIAdEAA.fFBAhBAA.YFGBeECBAAIBCEHD.gGGAhAEA......hBAA...,2,-36,2,38
VTJbFQNYgREDeSBCacWLdPfZKXHAIMOUG,MAAAGAAA.JADAQADA..gAGBEAFAeAHFCBBAaCDAhAAALCDA.dEEAhBAAZDBBHGECADEBODFChACA.TFFAFDHD.RGCABHHA....hAIA......hBAA...,1,-9,-16,7
aWcCNAOZEbUGBTYMVFDPgefHSJKdLXRQI,EAAAGAAABACAMADADAEA.eAFAHAFC.KBDAdCDALDDARCFAQEBDhAAA.aEFCCCHAACCBbGCATEGAhAAA..FGGAfFDAhAIA.XGGA.WFFDhCAA......hCBA...,2,-31,0,31
ZPYcESeBLRNJVWDFIbGTfKdXQaUHACMOg,MAAAZAAA....PADAEADAeAFALAHBRBBB..VCFAFBFDGCAAhABATECAdEEAaCCCHECAhACAABIBOEHD..hAGAgEGASGFHBGEA.WHBG.hBAADEEA.fGHAhBHA..,2,-16,2,18
XcUBdfZHQJbVaYPKCOREgSNLDIWMAFeTG,eAAAGAAAUAEAdADAHAFA.QCEDVCCB.aCHBKAGARDBFEEFBhAAASCFALFHBDCIBhAAAMFABABDAFEFA...hACATGGABHGC.........hAFA......hAHA...,2,-31,4,35
MKZGAcWHLeINJBfdFPRXaUYOQDgbSVECT,HAAAeAAA.JADAdAEARAGF.aAGA..OCABDBDB..SBFHhAAAECCAMCFBGEDAABHBLDEAhABABDHAFEBAUGAAQFFAhBEAbGFA.CFHA.........hCAA......hCBA...,1,-5,-23,18
YKWTJHXUaOGDIEQdSRNeZcAMBbLFPfVgC,MAAALAAAFADD.VAEA..CAFAKAHB..TCAAHBBBaCFAGCCAhABA.EBHFdDEAREFAeEABhACAABBBBDGD..bFDDfEHAhAFA...gGFBhAHA......hBAA...,2,-37,0,37
MSDcadFeOBVTgNXZHQPEAYGbWLUfICRJK,GAAALAAAUADACAEARAFF.MAGB..DAIBdAHAeCAABDDA..TDDAhABAXDBD.HDGBhAAAECHBACAA..bFBAfEAAhACAKFFD.aECHOHBCVEGBgGEBhAEA.NHAB..hACA...,2,-16,-6,10
dADcPCGfXNMYQgSJTbOeEHWLIaKUFVRZB,DAAACAAAGACA..XABAMAEA.QAEASAGATAGAhAEAeBEGHCAB.LDFAhAAAaCCCFCHDRDEBdFFAADGBfECAhAIAgGDDbFGDEFHBKGGD...hACA......hBCA...,2,-12,-6,6
HYBIUNZFEKDARQVeOfbMagJdXGcWSTCLP,RAAAeAAAOADAMAEA...aAGEdAHA.GBDASBCALBGDhAAAHBEBBCCCICHAhAAAZFCAEEHFADBAQEEBhABA.bEGDXGFDTGCA.CHDA....hBDA......hCAA...,2,-16,-8,8
MfKVEgSLIXbcdDBOHAWYNCTUGPZaRJeQF,...NAAA.TAAAGAFAaACARBBA...eAEHMAIBKAGA..EDDALCCBhAAA.bCGBdEBAhABAODBBHDGBAAFBCEEAZFDEhAGAQFECFFHD.fGHA.SHAAhACA..hADA...,1,-5,-16,11
CPXBOWTbMGVJKQLeFDgHfEaSIRZANUdYc,dAAACAAABACAOADA....TAEAGAGAKAGCeBDB.DCCBHCAAhAAAECFB.aBGEREBAAAIBUDEAhACA..PEHDXDGAhAEAMFFBQECALGBAfGGEhACASFGHIHDAhCAA...,1,-2,-26,24
CMgRdefPIbYJOESaQFTXKULZBAGDVNHcW,GAAADAAAHABCCADARAEFeAEE....IAHAbBED..OAHDhAHAECDB.aCCCQCGAhAAATECAKDHDZEFAACGBVFFBhBAAcGAA..MFIBdGEAfGCBhACA......hADA...,2,-19,0,19
aLNHFIJOdfMXUSCGbRWTQcBKPEDgeYZVA,aAAAHAAA.FADAOACDdAGAMAIBUAEA.GBGARCAA..TCEAhAAAQDECKDGADECAeBBDhAHAZFFAAFHALGBA.hACAIGFAXGBACEBD.......hAIA......hBAA...,2,-17,-11,6
cJXORTKbHZBUEDaCgQIeNSYVWFLMAPfdG,dAAAGAAAJADA.RADAKAGCHAGBZBFEBBDD..ECDBCCBA...QDFAhAAAeCEF.SDADhACAVDFBLGAAADIBfFFEhADAOEHD.........hACA......hAGA...,2,-30,-13,17
NecSPaIVFDUEBMOWTGbfLXQRCZgAdHYKJ,HAAAKAAAeACESACE.aAEDFAFAEAGAMAIB.OBCCGCCAhAAALCGBRCFAZEFAABIBdGAAhAGAJDDA.PHEADEIBBFFDhAAA...TGDAfGCECGHD...hCAA......hCBA...,1,11,-29,40
MYBWEcZGaQfObgAHRdKSPeTVDIFCLNJUX,HAAARAAAdADAKAFAeACE.TAGADAIB..FCCHLCCA.UCGBhAAAMCFBBECA.EEEBGCGAhAAAaEGDQFAChAFAOEDDACGB.SFHH..IFAAhABANIAB.XGFChAFA.YHAA.,1,11,-30,41
YAQWLdJUIPXCERGgcFOHVDZBeSMaKNTbf,LAAAdAAAUADA.XADDRAFAGCAB..FAFAHCFCZCAABBHAeEEBaEGChACAKCFA...TGAAhAGAbDFA..AEEBQFBAhABAIGGA.EFFA.......hAIA......hBAA...,2,-19,-11,8
bRaZFQfTDMCgVSPUIeGJNKYXLBWdHOcEA,RAAAZAAAQADCDACA..MAFACAFB.SBDHUCFAeAHBGBFAhABAKCCDLDEDdCHAHEEBhBFAEEHFABHAFFCB..TGFAhAAAPHFC..IHDA...hCAA......hCBA...,1,-13,-19,6
gfAUSXWIbYHQDKGLOBeZMaERTVCNJdcPF,XAAA..bAAAHADAQAEAGAGALDAAeAHBaCAARCGBhAAATEDA.CCFDdFAAhAAAFCEHADDBSDHHhABAIEAAKEFBZGEEMIAAEFHFVGBA.....hADA......hAFA...,1,3,1,2
bDEdcfUGCVAgFBOMJKWQHeZYTRIaSLXNP,BAAAMAAAKADAHACAZAFBRAFF..aAHDLBBB..XCAAhAAA..bBGDEDDAdDDAfDGAhACAGFABAAIBOFEDhAFAQEACTGGASDHHDICA.CFEAFGGAhAEA.eHAA..hAFA...,1,-8,-9,1
aKQDPbFdVCETAYGfUMJNOIXBRSLcZgWeH,GAAAMAAA.OADABADARAEFLAHBZAGB.eBFFHBBBQDCAhAAAbDEC.dEGAEEHFABHBfGDAhACAUGAA.hAGAIHHASFFBWFFDaGCEDEIB...hBAA......hBBA...,1,1,-17,18
bDSTZUVYPCaBNFOXAeRGKEJWHQMIfgdLc,RAAAEAAAHADB.MAFAIADAdBFALBHB.DCCBZAEB.VAGBhAAACDAABDDDOBCBAAAAeEFBhADAGDEB.KECAJFHBQFFBhAIA..fGEA.hCAA......hCBA...,1,-16,-19,3
UFCLPEJQSNbcZOBdMGaVHXgIYKfWADTeR,eAAARAAACADB.EADA..QAFASAFA....bCCAZBFEdBHAhAAAaCCAHDFBXDDChAAAgECAKDGAAFFATFGAhABALEHBPGAANIABBFAAMIAA.VGDA.hABA......hAFA...,1,8,-9,17
UaMDFIOCbNLPBYXRKHEefdGTJSAcgQZVW,QAAAZAAAUAEADAHBOACC..CCAALDDABAFBRAGFHCDA.hABAEDCBeBHHGEAASDAAhACAACIBVEFAaFEHMEIBhADAFGHD....bFDA.....YGBAhAIA.KHGA.hAAA...,1,-2,-20,18
AEHKZSLCMRbcaQUJfWIXFGVTYNeOdPgBD,HAAAZAAALADBRADF.aAFAQAFC.fBHAhAAAXBFCGCAATDAAeCCBhACAdDGABEEAEDGBCEEAbGBAcFGChADAUGGA...IHAA...hABA......hACA...,1,8,-16,24
EAbWLBKJZaRfVFHMSOdeNGXUYcIPCQTDg,LAAAKAAAZACBRAEA.FAEAHCABMAHB..dAHAeBDFGCFAUCAA..hABAIEDAQDFChACADDIBACABbEDD..BFADhAAAaFCBSFGAXFDA.PHFCCGHAEHDE..hAIA......hBIA...,2,-10,-10,0
OZLWEBCAGFRTNScaYIedHKfPbJDVUQMgX,RAAATAAA..SADBaACA.eAFAHAEBKBHBbAGB.DBDBQCCChAAAMBIB.OCFBhABAZDEAEFFBAAFAGDGAhCAAFFHDcGBAdGCAfGEA...hAAA......hBGA...,2,-11,-9,2
dMTgIBSDGXZAVfbUFKOcJNPHEeLaYRCWQ,VAAAUAAAOADA..JADAHAGBLAGBRBDBQDBAdCDAMAIBhAAA..TEFABCFCGEFAhCAAAAIBFFEHKDHBNEIA.EGBAhBAA.aGHBCFEC..IHEA....hDAA......hDBA...,2,-25,-1,24
EaXHFTKUfMcIdVbBACGDRPNQOJeZLYgSW,GAAARAAAQADCeADAZAGBLAFB.SAHBEBFFHCDBTEGAhAAAKCCDMBHBdDCCBDEDhAAAAADADBIBODHDJFFF.gFCAhABAaGEH.FFFB.fGHEhCAAIHHA......hCFA...,1,3,-12,15
SAXNebWDcIYKZQRLOVdPETCgUBHJafMGF,eAAADAAA...IAEAZABERAEFLAGB.dCCAEAGACDAABDHAhADAHBCAaBGE.GDEAhAAAAAIB.bDGB...cGAAhABAQEDAOEDHTGCAgGGAhAGAfFFB.MFIBhBAA.SHFA.,1,12,-29,41
VgeOGDTQAdbKJXIUWLRFaBHMPNSCYEfZc,dAAAKAAA.JADAUACA.RAEA.BAGBHCEC..MAIBSAHB.hACAEDDBZBDA.VCBBeDHFhAAAGCGAQFAAhAFAADFB.bFEDXEDD.LFFBaGGCCHCA.hCAAYFHB..hBAA...,2,-28,3,31
IWAfGYUEQMeVFJXBSDLHZdORCPacTNbgK,GAAAEAAA.eADAFACDBAEALAHBHAFBdCDARCDBCAHAaBFD...TEFAhAAA..bDGDKEADhACAACIBUEAAMEIBXFCAhADAZGEAOHAAPHBC......hAEA......hBAA...,1,-3,-17,14
JfFSVMGgTHdcXAENOWKLDIBQYaZUPbRCe,EAAAOAAALADABADA.QBGAZAEBUBGA.RCBA..eCFBFBBHMDDBhAHAGEAA.HECAdEEAAECBhAIAKEHB.DGGB.IHEAhAAAaEHBCGCD..SFHH...hAEAgGEA.hAFA...,1,0,-30,30
VAOLfZNFbJDeTMIdRUBgEKSHQXacCWPGY,LAAAZAAAFADADAGAeADH.MAFARBEABBHBEBFA..HCAB.aBHDCCAAGDDAhABAACAB..fDEAhABAJDGB.dEGAhACAKCCDQFBA.XGDBPFHD.hACAOFHDNIDB...hCAA...,1,12,-37,49
VQPcXbFHCJLSYMGEBURTKANeZgfaDWOdI,eAAAZAAAaACAOADC.dAGAQAFA.XCCAHCCALDGBhAAAMAIBGDEAhABAEECBREEFAAIBfDGBhAFADCIBIFAAcFCACGHA.SGGA.BHBAhBHA.....hABA...,2,-20,2,22
ZBXCMJgSVcKbLeOETUDYRIdaPGfWHNAFQ,ZAAACAAA.MACASACAKAFA.LAFAEBEBDAIB.RCAAdCEAGCFAHCGBhAAAACCBBCHDJEDF..VFFBhACAeDDB.OEHDhABATGAA..IHAA.aFFH...hADA......hAGA...,2,-18,-13,5
fUTZPKMLgRaXGJFDVCQYHbEONeIAdcSWB,dAAASAAABADAUAFAZACBKAEALBHB..RAGFGCEADCCA.hACAQECCHDAAEDDEeDFHhADAAAAA..fDHAhAGAMFDBaFBDFFHBCFHAbGDA...IHHAhAIA.....hAIA...,2,-20,-9,11
aQTFPWAMJEHNVSIBGYbRLXDOeCdcUgZfK,EAAAHAAA.SACEGACARAEALAHBOAEDeAGBdCGCUEAAZCCFaAHFhAAATEDAFDGH.ACBBMEIBhAAAVFEBBGCA..hCAAbFGDCHGA...fGFA...hCGA......hDAA...,1,3,-7,10
SbFYBKfTZICGLQJgVMAaHdXNDWPUeROcE,HAAAdAAADADAUADARAEA.EAFAFBDHBAHA.KCADZCFB.GCBALCGBhAAA.QDDAhACAVFDBAAHA.aEHD..XGGAhACAPGDAOCCB..SBHHhBAA.....hCIA...,1,-13,-24,11
NEQVUTdPHSWXYJDFICZeaKBMORcfLAgGb,GAAAEAAAUADAdADAHAFASAFA..XCBCDAIBCCEAeCFHhAAAaCFEMCIB.REDALHAAhAAAAAFAbCGD.QFGDhAHATGGA.YHEAFDDH....hAIA......hBCA...,2,-19,-4,15
HEZLGYDOSQXWdUVMaeABJCFPNcKgfRTIb,CAAAFAAA.....PADAKACARAEF..TBGAHAGBEBCF.GCEAhAIAOCAAQECChBAAdDDAMDGB.ADDABDHA.hAAAcGBCfDHAZGFE.LEAB.hBGASAGE.hBIAXFED.,2,-28,3,31
ESBYGIHDbOXaQWfMZLTFeKNRgCPVJUdcA,EAAABAAAGACAHACAOAEAQAEA.MAHBZBEETCAA.hAAAeBHHRDFBCCBDVEAAdDDDADGBSEGAhAAADAIBaEDDLEHBhAEAKFFD.NIDB.........hBCA......hBGA...,1,2,-16,18
fSCPKcTNgGMIbRYEQXLZVBHFeadOAJWUD,UAAASAAAKADA...TADAGAFAMAFARCBAEAHBLBGBhAAA.ZCCAHDEBeDABdDHAhADAABIBDDIBCECA..cFAAhAFAgEEG.bFCDQGGABCFBaFHH.hABA......hADA...,2,-10,-9,1
XJcbTQHMBUdSLAVKgeZaGRWDfONFICPYE,KAAAeAAAGACARADA.DAEAOAGD.FCCBCAGAEBEE..XDEAhAAAJBHB...bEAAHCABhAAAMAIBdDFA.ACABZEDBhACAaEGD...fFGAIGAAcFDDhABABHHA.SFHHhAEA...,1,-18,-24,6
bGSIECLNDZBXJPceWTARYQdFOHUMfaKgV,RAAAdAAAHADBMADAKAFA....VAGBGCFAEBDA.LAHBZCCABDBDhACAXDAA.PDDBhAAAeDFHADIBFEHDfEHEhAIAbFAD.CFCADEEBcFDDTGGA..hBAA......hBCA...,1,4,-22,26
YdIZUgbABVCfQSDMKaJcERLGPNHeOXWTF,CAAAQAAADACA.aACEEAEA.GAGAHAEBeAGB.OCDBhAAATBCAdDAAZDEBUDGBAAIBBCBDhAAASAHBMDIBKEDDhBCAREEBPHFC..XGBC.FGFDhBGA.IHHA.hADA...,2,-17,1,18
TCfgLVdKaAOHQSBEIGXPeFYRbUDWZcJMN,HAAAQAAAEADEGAFAeACARAFADAIB.ZCAAMCDBCCED.LCEAhAAAdDHAAAHBBEEAXDAA.hAAAFDHDbFAAUEEA.cGAAhADATGFA..fGHA..hAGA......hAIA...,2,-10,-6,4
SBUgNOIEKRGeJCfcadALQbXPWTVFHMDZY,LAAAQAAAXADD..TACAHAFAZCAABAEBgCFAhABAOAFDEAHBREDBeCHHhACAfCDAdFAAAFFAPFHDhAFAFCHHMDFB.SEGDNIAB.KGHB.hAHACHFA.aGGHWEED.DIAAhAAA...,1,21,-26,47
RUVCNKJXTgSPIBYacDEQMfOFLeHGZWdbA,RAAACAAAKACA..TAEA..SAEBBAGBaAHDDCCAEAGAMBIBhAAAFCFDHDAAZCAA..dCEDAAAAVEDBhADAJDGB..XFEDhACAIDHA.QGFALGAA...hAGA......hCBA...,1,-12,-27,15
adHUgMEeIYQPVKXZGDACTFcLbROJNfSBW,TAAALAAA.RADFOAFAJACA..SAFBaBFD.HBGBhAAAMBIBECCAeCAB.QEEAhABAKCEBGEEBACCBFEHHhACANHABBGHAdFCAIHHA.PHDChCBA......hCFA...,2,-15,-8,7
bRZgQeDcNGfTdaECXHFVWOJIMSAUBLPYK,LAAAKAAARACFZAEB.eADH.DAFAGAGA.dCAAEAHFHDFBFBFBOCABhABAMDIBAAIB.BCHA.hAAA.bEAAQDEBhACA.fEGAaEEBXGBCJFHBSCCDhCBA...hACA...,2,-13,-13,0
EcRfOdJBFGWIMSZCYPLgbQNVaXAUDKTHe,KAAAHAAAEACERADFdAFA.FAHBGAEA.MAHBZCAACCHALCCB.hAAAQDGBaDFBAEEBDEGA.hACAeEABOFGBBEED.hADASFGA.gGBH.hCCAbGFC.....hEAA...,1,-2,-28,26
DRZeOYCEbQMSWFJLKgUNdaHBVXPIGfAcT,TAAARAAAeADE..CAGB.EACE..MAIBFAEALAHBKBDA.UCCAhAAAaCCCHCFBXCFBGFDBhAAAADFBZEFEOEHFQGGAhBHASHCA.......hCAA......hDAA...,2,-12,-12,0
NAFXTMWVGDREYICOBJPbHLcZefSQUgKad,TAAAMAAAGACB.EAGECACBBAEA.JAGBHCCA.ZCFBeBHHhAAAQFAAKCCA.dDHAhAFAACEAXDEDDBBBRFCAOHEAhAIALEAASGGEaEHDFGAA...VGEAhAEA.....hBAA...,2,-14,3,17
ACQIUdRPfJVEHeFcaKMLgNGBYWDZTOSbX,QAAAdAAARADA.JACEHAGB.eCAAaAFDLAHBGCEABDDChACADCDBZDFATEAA.bEGDhADAABHBCECD.UFFA..hAAAfGAEEFBBKGDB.MDIB.gGDBhAEA....hAGA...,2,-19,-2,17
BPGRWXVFQJUNcdADEKCeHMaZLbTgISYfO,EAAAeAAAHACAZADBLAGB..bAFBTDBASAHH.hAAAOCCBGEEARDEBXDGAhAAAQFBBUGGAhAEAdEHAAAIBCEDDaHBAIHHABHFC.WBAA...hBHA......hCAA...,1,-1,-6,5
VUYCMXcfdIZBHJOaSbKPWDRLGFATgNEQe,TAAAEAAA..eACAUACAMAGB..fAEFZBCEHCGBaAHFhAAAKAGADCFARDABGDDA.hAAAADDBQFGBhADACCHAdDDABDGDSEGAPHBC.FFED.gGGAhAIA....hCAA...,2,-29,15,44
ZBLNaQXVAfIJdHeWROgDCEYcGPMbTUKSF,JAAAHAAA.RADFDAFAEADEGAFA..bBFAKAHBZCAALCCB.hAAAaCEHQDFAhACA.ABGAdEHAeDGHOEEBhADACFAAPFDDMFDBSFFDBGGD.NDIAfHABhAFA..hAHA...,2,-24,-5,19
YbAFNVEWHSUTQJdgaBPCMZXceRGOLDfKI,FAAAEAAAHACAUADA.QAFCdAGABCCD.MAIBZCFE...eCCBREDBLFBBhAIAKCEDIDGAhAAA.AEAAVFEATGFAaEAEhAEACDBD............hAHA......hCAA...,2,-35,-4,31
WfVBUcOTNLKQFJZMEISRaePHCDdAGYgXb,GAAAXAAA..bADA..VADABAHAOAGDLCDB.QCFBhAAAZCDAEDAAREEBeCHHhAAAHEGBdEADAAIB.gFEFhACAfGAA.cGFDKHAAMIDA..hADA......hAEA...,1,-1,-8,7
UVafTFePGKCHJNWSDgOIERLXBQZcYbMdA,aAAATAAA..eACHGACAHAEA.JBHBSAEADAGA.OAGDhAAARDDALEABQCEDhACAZFFAbGCCAAEAfDHAhAIAKHFACECD.gFEA.EGHB.hAEA......hBAA...,2,-9,-6,3
EIdbVUXacfBNTAWPQRZJGeYMLFgDCHOSK,QAAARAAAGADAeAFAMADALCGB.DBIBHAFC.KBDAECCBhAAAbCDAUFAAaCHDBDBAhAAAADAAZFDAFFHDOEEB.dFGAhAIA............hBCA......hBDA...,2,-14,-12,2
bFAfgcSBZDRLQCPNXdWJIHYUEGTKMeOVa,...fAAASAAAZADARACFLAEB.QAGAhAAACAGBXBCCdDGAICHAhAAAHECAEFHFGCAAMIBAeGAEhABAaCFHAAIBBDDADEEA.PEGD.JGDA.hAGAYFAF..hACA...,1,5,-22,27
QMgJNAUDdLEYPKCFZOXaIWRBTHVGfSbec,dAAAEAAAKACAZABBOADC..aAEARAGFHCEBGAGA..SCHHhAFAeBEFMCCBJDCBAAIBLDFBhAAACFGA.FEHDXGAChAGABFEC.TGDA...fGHAhAIA...hCAA...,1,-9,-26,17
bdCTWFOecYNgfDSZMLBGXPRKJaUQEAHVI,HAAAVAAA.dADA.TAFAOADA..eAHH..NAHA.DCABZBDEMCCBhAAAGDEARDDAKDHBaDHDEFABhACAAAIB...CFCAFFFAgEBAhAAALHAAXGDD.UGGAIHHAhAFA....hAHA...,1,-2,-8,6
KQagbBJCPOAGeYXcZWESTIRUVNLDMfFdH,eAAAXAAAZADBEAFA..TADARBFA.UAFALCCDDAIBMCDBhAAAdDHAHDEA.aFGCbDABhABACHHAAAAAGDGA.cEDDhADAWDBD...SGDANIAB.KHBAhBHA......hCAA...,1,-6,-11,5
BaIdDGbHZXLTSCFeAJcQPONMgEfUYVRKW,QAAAOAAA.MADAEADAUAGA.RBEBBBBDdAHAbBDA.HDBAhAAAZDCBLDHBTDGAFEFHhBCAADCB.JFBF..PEEBhBAAfFDAKGBDaGFDDBDA.SFHHhBHACHHA.NIDB.....hCAA...,1,1,-17,18
RMOZGBKCYJLQFWUIgNTXHPSDdbEeAfcaV,aAAARAAAZADBGACAKAFA...CAEALAGBQCFAFCEDUDAA..hAAAIEAATEEAHFCBhABADAIBEDHFAAHA..fFHAhADAMEGBBFHA.YGBAWHFA...hBIA......hCAA...,2,-20,-17,3
IFWVaKbUPEeTADYCdHfRLJSOcQGMZgBNX,CAAAHAAARACA.LADB.OAFAGAFAZBEBBAHAXBGAFCAAaCEHhAAAKCAD.UEGAECHFADABdCCChAAA.SFFDhACAMDDB.gGDDIFAAbEFA...eFDHhACA.TGGA.hDGAfHAB.,2,-13,7,20
UOWDNfZXMbaIeELgVFCKRJGcTQdABYPHS,BAAAHAAAOACADACAZACE.MAGB..aAFDEAHBLAHBFBED.RCDB.hAAAGCCA.TEFAhAAAABHBSDCDNDIA.hAIAXDGCeFEBCHCAKHGAQFFB.YFHBhCAA...hCAA...,2,-27,-4,23
MPLcaNQgVJeSZFEDUBXGdYTKfICAObRHW,RAAAHAAAMADALADB.aAFAQAGA.VBDAeAHHZDDAhAAAEBFBBDGBdCADTDEAhAAAfEHAADIBbEGDPFFBhABAgGBA.SGFDDCCB..hACA......hBGA...,2,-14,-3,11
PFXTYOGLEBDAcUgQJfHdaSVZNCbKIWeRM,UAAAQAAAHADAaAFAZACBCAEA..KBHBeAFHRCBA.FAHB..TCFAhADAGDEBLEEAhAIAEECBACIBJFFFdFCA.SEHHhBAA..........hBCA......hCFA...,1,-12,-23,11
XKgVADdEceCURfMNLQIHYbBSWPFJaOGZT,EAAAeAAARACA.MAEALAFBHBCABAHA.SBEEFAHBaCCCZDAATCGAhAAAKCHBAEEA..dEGACDEAUEGBhABAQFCB.hCAA.IHGAbGFA.PEDB...hAAA......hADA...,2,-12,-6,6
geFGdTXRJaEIAfDSNKVMZYBPcWHCQLbUO,SAAAKAAAZACBBAEA....PADAHAFBLAHBOAGDeBCFhAAAdCAARDEBECFBACEBDEGAMAIBhABA.....cDDAhBGAQGGAbECDFEGD......hCAA......hCBA...,1,-13,-30,17
CbZTQGVOefAHNKaPEMBRgDSFdIWJYLXUc,HAAAaAAA.EADERACFDAEAdAFA..JAHBLAHB.UCEAbCAAZDFAGEGAhBAAeECBABBB..KEDDMEEBhAAABBGBFFFA.IHAAhACAXFBDCGHA.........hAHA......hCAA...,1,-5,-27,22
LXBaQDUReHTfJPIWgGbZYECNKFMASdOVc,dAAAOAAALADABADADAFARAGFHCAC.JCFF..IBFAGEAAZECBhACAEAHF.KEHB.AAEA.SBBDhBAA.XCCBhCAAaFFCeHEATDFA.fEDAhCIA.gFFAhDAA.CDHB,1,-9,-44,35
KeYIRVNDGabAWcCXLTQUEfBgMHPdZSFJO,CAAATAAAUACA..BAEAHACB.ZAEAFAGAKCAD.eBHHRBFB.DAFAGDDAhAAAACFA..XDEAhAAAECBB.MEDBdCHAOFGBhBCAIFHA.aFFH.bFDDLFHB.hACA......hAIA...,2,-26,-9,17
IHOgYZMEAebQNKWGTBLaXFDCUJcfPSdVR,eAAAQAAAKADAGAFALADA.aAGDDAIBUCDAJCCA....hAAA.fCHAhAEAdDHAREEBHFAAODFD.ZFAAhAFAAAAAWHAAXFGDCGHA.SFDB.hAFA......hAHA...,2,-25,-3,22
YebBTAFdQXVIHRENaSfgcGCUWOJDKZLMP,dAAAQAAA..XADAHACAEAFEaAGASAHB.hACAfCDAGBFACBHDOCBChADAKCFAZDFEMEABhAAAeDHFbEAAAEEBFFCBREEB.gFGA.WHCAhAEADEAA......hCAA...,2,-12,-7,5
BcOTaHDSGCXILWPMFdfZUYVQbEKgReJAN,BAAATAAAHACA.GAFAXACBLAHBMAFA.dCAAZBDBVCDBhAAAEBFARCFAACCB...OCCBhAAAaEAECEGA.IEHAhBIAFFFH.fEFE..YEHBhACAKGHB.eHBANICB...hCAA...,1,1,-11,12
YASTdXWcDLQgabIKBCUJFZEfHROPNGMVe,dAAAXAAADADALAGB..aADAKBDACAGAFBDBECBF.HCEA.REEAOAHDhAAAGDDAeCHHhACAAEHA.TFBAQGAAhABAbGFA.BFHA........hAGA......hCAA...,1,-17,-18,1
ZeSgPBXKAaQILbCDEMfYUdWHRTOFVNcGJ,aAAALAAA.DAEAEADAMAHBUAGA.HBEBRBCAFCAB..VDAAGCFAhABAeDGF..SDEDhACABBBDADIBQGBAhADAbFBB.fEEEdFHA.OFHBhBAANAIA......hBGA...,1,-8,-13,5
LcIYbJXTRVDfCNZgQPdeHEFAaWUBKGOMS,aAAABAAAGACAMACALAGB..IAEAJBCA.RAFFDAIBhAHACBFBZCCAQDFBhBAAdEEDHEGBAAIBKEDA.SBBDhCAA.bFGD........hCHA......hDAA...,1,-16,-38,22
HAcXKTLbBCIQMEaDFJUYdfNOeGSVgWPZR,KAAATAAALACB.CAEA.MACA.EAFAaAFDFAHD..UDEAdBDAOCCHhAAAeAHBGCGAhAAASCGD.gEEBhCAAZEAAAECAXGGAbFCDBEHADIAA...fGHAhCDA..hCFA...,1,-17,-21,4
TNKDcLAYXdRCESeWfGJZQFIgUOVbaBHMP,dAAAEAAA.eADAGACAZABBFAGDUAFA..OBHDaBHDHDFA.MCBBhAAATCEADEABLFDBhAEA.AFFBRFBBSDCHhAEAfFHAQEEBIHFA.bEGD.NIAB.hAIA......hBAA...,2,-19,6,25
GHXEWNfKdTPMAeCSDIFcORQZLaVYBgUJb,eAAADAAAFACDRADAZAGBLAEA..aCCBBBHAUDDAGCDAHEABEDHFhAAA..fCFBhAFAdFGDMIBAACFASBBDhAGA.ODHDYGEAbFFD..NIAB...hAIA......hBAA...,1,-2,-25,23
cRKgNUPAECWOZJLQGSXBfbHaYFTdeIDVM,EAAAOAAAZACBLAFAGADABAFAHCEAaAGDTEBA..eBBBhAFADCBBMCIBRDEFKCHBUGGAhAIAAAGACEEDQFGC.hBAAfGCAbGDC.dGEA.....hBDA......hBIA...,1,4,-16,20
YIHJCRFMVKUaLGdgbDXANefEcSBTQZWOP,eAAAEAAABACAZADBOAFC..IAEAHCEBRCGBFDBBMAGBKFGDaAHBhAAALGCAGCCAdDHAhBIADFIBAAAA..fEFAhCAASHAGTGGA.WFCD.YFEFhCBACBCA....hCCA...,1,-12,-20,8
SPGLEYcWRdFTXJHObIMfVUQNaKDZgeBCA,GAAAEAAA......cACBRADAdAGATCEAHAEAOAHDhAAAbDCD.MCDBUFFAaCECDAIBhAAAeDGFAADALDHBhACAFEEBXFGD.fGAA.QGCChAGA.NIEB..hBAA...,2,-18,11,29
MHNKEWAFJBfLSDPUYabRcVOQXICegZdGT,BAAALAAADACAUAFAaADD..RAFA..OCABQBCA.CAHA.hAAAeCCBZCFE.GCEAhABAHECAECBBACHAfDGBhACA.SFAAbEGBXGFDdFHAMIAAhAFAKFBD.FGFD....hAGA...,2,-18,-4,14
EZUCMaWeXKYBDQAIfSdHbJRNOgGFLVTPc,SAAAHAAARADFOAFAGACALCFA..TAEAECABZDDAMAHBhAAAeEGHKCFBDCCBAAIBdEAAhABAbGBA.NCIA....FEDDhAEA.PFFBCBGDaFHDWFFDBHGA.....hAGA......hCAA...,2,-12,5,17
CedJScBOgafTELbWKRMQIAYVZUDGNHXFP,ZAAAGAAAHAEAFADAeAHHdAGA...SCAAOBHD.aCECECDALEAAhABAKDCDRDFB.MDIBhACAAAABUFDAXEEA.hACACGAABGCAfGBAbEGD.IGHA.hADADIFA.....hAEA...,1,-3,-17,14
ABcMgJFGYZHKTQPOVbIWRNfDELeSdUaCX,MAAAFAAAZACBHACCKAEA.QAFC.OAHDbAGB.RCCBDBBBECEALECAhBAAeDGB.dDGDhBIAaEFHAFGABFHAJFDB..hCAAYFHB........hAHA......hBAA...,1,-9,-31,22
ZcFbUHOPADgMaeXYCTQWGSVdLIBKRJfEN,MAAAeAAACADA..TADAGAEA.dAGBLAFBKBHD.RBBBEAHBZCCFFDGHhAAAHCGBADIB.DDEBaFFCQFCChAIA.SFEHhBAABGHA.fGGA..hBBA......hCAA...,1,-11,-33,22
DIfeGYJAQdWNEgPObMFSKRCcaVZLTXUBH,dAAAEAAA.OADAMADAKAGARAGB....aBDBZBCALCEBTCGABDBAhAAAHCBBDCGBeDDBGEGAhACAABDAQFBA.hAIAgFEHFGFH.CGHA......hBAA......hBCA...,2,-15,-12,3
CAONbMKWZVYGEXHIQJdTagLeRFUcSDBfP,OAAAMAAAZABEGADAHAEB.QAFAdAGBaBGD.eBBBRCCB.FCHDSCHHhBAABAHACDFAADBBKFAAhAFAVEFB..EFDAIHHAhCAATFGA..........hCCA......hDAA...,1,-9,-15,6
gWMbGHTFIJVfPDdSUAEXNZcYBCOQKaeLR,EAAAZAAABADB.QAFAeACARAFAMCCAHCAAFCGD..JCEBVDAAhAAADAIB..dDGAACIBXDDBhADA..cECChABAOEHDLFAB.bFFAGGAB.hACATFEA.fHFFhAGA,1,-1,-26,25
GCabEQKWNPDZeFYSBOMdgcJTLXUAIVfHR,VAAAHAAARADF.GAFACADB.EAHBQAFA.KAHBPCABhAAAeCDBFCFHBCCD.dDHAJDHBhAAATEEALECBAFDBaFADhACA.NHEB.ZFAB.OFFBMIAA.....hADA......hAFA...,2,-11,2,13
AJDRMCfPXTHULbOWQdFVSIBacYKEZgeNG,RAAAMAAACADB...XACAHAEBLAGB.OCCBdAFASAHBhBAAaCHD.KBBDEDEBhAAAeBGHAAIBDEGBTDCAhBFAbFGD.QEFBFGBA.BFDA.cFGDhCAA.....hABA...,2,-20,-14,6
eEUTgLHaQMDfVdZRNACWIBbcSFYKJPOXG,CAAABAAA.SACAKACAOAEAGAEA.EAGATBEAHCAAaBHDhAAAMAIBDDEB..dCAARDFFAACAhAGA..bBGDFEHDJCCBeHCAhCAALEEB.QGGA..hAAA......hACA...,2,-25,-2,23
NVaXUJeLbKQCSARdHGIOEMZfWcBDTYPFg,HAAAGAAAEADEZADA....fAFBBAGBTCDAFBHDgCAAhAAAaAHDUDGA.eCEBhACALEAAbDCD.QFEChAAAAAHAREFFdEHAIHHAMIEADHGA....hACA......hAEA...,1,16,-17,33
WbJMAFRONaPXICgYEZSLVQDTUcGHdfKeB,RAAAaAAA..XADBCADA..EAFAZAFBLBHBQCCCDBBBUCCAhADAHCGBdEEAKCFAeEDAhAFAbFBBAAAA..FFHDOFCBhAIANIDB...IFGASBHB...hBAA......hCAA...,1,1,-27,28
SQIBMZEcVRgKDGJaWTOdFCfbYANPHeXLU,HAAAeAAALAEAQADCMAIBEAFERCAADBDBaAHD..OCCHdCFACDEC.hAAA..bCGDADHAXEFAhACASDFFBGGDZFAAgGEAhAAAKHAA..WFHHfHGFhABA.....hAHA...,2,-11,-3,8
dRWMYILXGCDOeFUHPaVSfQAbJZNcEKBgT,ZAAAEAAABACAdAEARAGB...MAEALCABGBCBOCCBeAHFHDDChAAA.aCHDfDEAhABA.AAIB.bFBANCGAKDHBhACATFGA..IGAADFBAFGFH...PFHBhADA.SEDDhAGA.,2,-26,4,30
MdVZGHQPLRAFWCTNDKXgBaYfOESbJcUeI,CAAATAAAKACA..BAEBaACA...OAFDEAFA..SAHHhAAA.bBDCcCAAhAAAeCCDdDGAGCGAHEDBLCCBhACAADIBFFAADFIBXEDDfGGAIAHAhCEA.ZFFFPHBChAFA...,2,-23,-1,22
CIPNBaUdfXEZKDHRVGOJbSQcATLWYgeMF,TAAALAAA.....gADHeACEMAFACAGA.IBGAhAAABBHAdCAAEBDBZCCAHCEBhBIARDFFGGABbDGBQGFChCAAACFAFFHBaEEH.fCCEDIDA....hCIA......hDAA...,1,-2,-9,7
aVQFXdKUCcWeYgEDfHNBPSGRAJMTZbOIL,MAAAZAAAOACALAEA.QBBAdAGACBEA.eAHHECCBHDFAhABABCEAGCFAAAIB.bECBhAFAaEDDFEHDKFFDUGAA.hBGA.YHDADFFBNIDB.SGHB.hAGA......hBAA...,1,1,-20,21
eAYgZVMRIPOcWBTHfEdXDaSNKLFUGCQbJ,ZAAARAAAOADABADBHAEB.EAGAdAHA.aBDDKBHBLBGDGCAAQDDChABAeCCD.ACAB.hACAgEEBMDGBIEHAhAGAPEHD.cFCCfGHA.SFFDhCCANIDB.CHDA.hDCA...,2,-13,-12,1
KTWREJPgQcXGZSCdALYaOFUMNDVIBbeHf,aAAAFAAAMADA..DADABAGAHAECKBCARBBAEBHF..JBFFQCEDhAHAGDDA.ZEFAdCHAADDBLHEAhAIAOEBBUFGAhAIA.....NIBB.......hBAA......hBEA...,1,-13,-30,17
VRETMJCGfPWcbQdIUYLaHSONKABgeXFZD,eAAAZAAARAEA.EADAMACAGAFA....fBHAPCCB..hABAbDGDdCCD.UDGBaAHFHEDAhAAAODEDADIBXFBChABADFHBTGCACHBA.........hBFA......hBHA...,1,-3,-22,19
FPfYEZAUbIOLgQJTXHRCWBMDVSGacdNKe,UAAAOAAALADA.QBGATADAHAFBRCBABCFDMAIBDEABhAEAGCCA.dEFAeECAhAFAfBBEEEGAAAHAIGEAhBAAXFAACGGA.SDHD.aFDDhAFANICB.FGHB.YHAAhAHA..,2,-21,11,32
JDMUTPBVKceOYILNXZHQfFWgAEaGSRCdb,EAAAGAAARACA.dADADAFAMAFA..UBGATBFABCCD.KCEBeBHHhAAA.ODBDLDABhAAAZDDAHFDAQECAhADAFFHBAHBAaHBECEFA..bFGD.......hACA......hBAA...,2,-26,-1,25
DJCSFPcRaBXZIKOfdALUEbMeGVNTWgQHY,EAAAeAAAGACA..TADAQAEAHAFBDAIBSAGAhAAAFCCBRDEBaDGEZCEE.OCBBhAEAAAAALFAAbDFAMFFBWFHBhAFAgGGA.CHAA.BGGA.KHAA.hAHAdHDB.....hBCA...,1,1,0,1
JAUMVDdQXTgZEbNGFPLWBHKCRIcSYOfea,MAAAdAAAQADA..TADAEAFAGBGALAFBHCACRBBBSAHBhBAAfDEAeEDDhACAABHBDDEBZDFEbFFAFGCHhADABFCACHHD.IFGA.OFHD.aHDAhBBA......hCAA...,2,-20,15,35
DBQGAVRHEZceTCdSYgbXWfaLIUPKMJONF,HAAAEAAAZACBeACE.dAFASAEA..bAGDXAGDhAAAaCCALEEAICEAKFDDMEIBhAAAOCBHDAIBGDEBhAFARGEA.TFGA.CHDAYFFF.hCAA......hDAA...,2,-7,-4,3
cPAZKRbgFGXOSCeYLBWJDdfNIUEVQHaTM,RAAAFAAAGADAOACDeAFALAEABBHADCCBdCEA.....IDAAhAAAEBHFHDFB.aEDHMCGBhABAAAFAZGCAKDHB.XFAAhADACGHA...YDDF.fFFEhAFANIAB...hAIA...,1,-17,-23,6
VbTMAKcXRPHSFaQZLYNgUEIOdBDGeWJCf,XAAAHAAAaACAZAEBLADA..gAGAEAHBdCDAGCFAhAAAeCCBCCHAVEAA.bFDDADGBREEBhAAA.FEGE..YDHBhABAIGHADFFBfHAB.MECBhAHA......hCAA...,1,3,-12,15
cHINUYKFAWGaQfegBLXPDZEbCRVTMOSdJ,aAAAeAAALADADAEAZAEE...EAHBRBCBMAIBdCCAHCFA.UEFBFCFAAAAAhCAAGEAA.QFCChAEABDFDXEEChCBACGGDOHCESEHB.IGGA.hAFA......hAIA...,1,-1,-29,28
dSGEWbKMZQHgfTPLJIcVAUOeYFCBaNDXR,eAAACAAABACADAEA.RAFA.GADA..EBCAKAFAZCDBHCAA.TCFAhAAALCHB.IDGAhAAAAAHAOBHFFFEDaEFCdGGAhABA..SFAAMIAA.QGGAhACA.fHEBhAFA..,2,-25,-13,12
TBAKDLEJOGICcRPfgYdMeQaWVNZHbXUFS,LAAAEAAAGACACAEARAFF....fAEBdAHAeCAA.aAGAVDDAhABAHBFC.bDFAFDHBTEBAhAAAACAA.DCBBOEABhACAIFFA.PFDDMECBQFGBhAEAWFHD......hCEA...,2,-16,16,32
TgMGNZSbQWOPUFKJeXECcIVBfYaLdHDAR,RAAAMAAAZADB..QAFAOACEFAFAKAHB..eAHHECFB..CCCC.ICCAhBAABDAA.aCEAHDGBhAAAABBB.GEEA.hCAASGHHbDECUFDBXGFD.fEHAhDAA..hDBA...,1,-11,-26,15
ZKQFJDdNGOWMAgVYbEfBaRecSXTCHIPUL,VAAAEAAABACA.RADF.eADE..SAFBTBDAHAGBUCFBZDDAhAAAQEEBDDIBGEGAhAGAMAIBAAIB..bFDBaCCHhAAA.CEHALHAA.FGGA....hAHA......hBHA...,1,-1,-15,14
GXZadfTeCQKLIOgUJVRMDSWEYFbANcHBP,HAAAGAAAaACAdADAeAEHQAFALAGBOAHFUDDBREFF.MAIBhAAASCDA.EDFAhAAAbGBAAEEBBEGA.ZFAAhACACCCCKFHBgFFGDGBA.WFHH...hBGA......hCAA...,2,-3,-3,0
eWbcSVPCGELXNKaRHMgTAZJQFfUYDIOdB,ZAAAQAAAFADAUAGADADA.dAGABCAA..eBDA...bCFAhAAASCCA.hAIACCFDEDGALDBA.hABAKEFAHEEAMFEBAEIBfGBAOFHD..hACA.cGGA..hBGA...,2,-43,-16,27
HXNELZUWBJVPAfRTFcSCgOeKDdIQaYGMb,RAAATAAAFADA..CAGA.eACE.dAFAaAHDGBGAHCCA.EBDBZCFFBAHBhAAA.JCCFAAAASDHBhAGA.KECDQEEAhCAAMEEB.bGFAXFFCNICB.WHEAhCAA......hCCA...,2,-28,-2,26
WGUBESQfHCZYcMOeIbNdJKDaLFVAXPRgT,RAAATAAAGADA.EAFAQACC.HAEBZBGBMCCBeAGBbDDAhAAAdDAADCIBLEABAAAAXDEDhADAgEGH.hAFABGHACFGAOFHDNIABaFFH.FGCA.....hAEA......hAHA...,2,-9,6,15
JcAKFgfeVGObSZQaMBWdCUPRXYNLITHED,FAAAeAAAGACAOADCZAEA..aAFAMAFAdCCAUCFARCEA..XDGAhBAALDHBHFCAEEDFDAIBhAAAABIBKFFC..fFFAhABASGHBBHFA.CHHA.....hCAA......hCBA...,1,-12,-20,8
WRgcZCEbXTHNMYdQUIeKJVSOAaFGLDBfP,GAAALAAABADA..fAEARAEFZAGBECDB.TAGAHEFAMBIBhAAAdCAAQCCChABAUGAAeFEBKCFA.SCHHhACAADABaGHB.DEEA.gFCACGCA.bFFAhAEA.XGAD.hACAIHFA.,2,0,5,5
JHCGMELKZfSTNXaOIdeBbgVUPQYcDRAFW,FAAAHAAAGACAEADEZAFB..TAEAaAHDdCADeAGHBCEC..bDFAUEEAhAAA.QFAAhACADAIBAEAACEDALFFBSDDDhAFAOFHBgDGHPGAA.YFHBhBHA......hCDA...,2,-6,-2,4
PgMCUJcWKHBbLQGaDFdVAEZfRNXYOIeST,EAAARAAA..XADBOACCeAEE.SAHBTAFAMAIBCCCAUCEAhAAAJCCB..KCGBHCGDhCAALEEBaEDCdFGDAAAAZFCBhAHANIEB.IGGA.......hCBA......hCCA...,1,-11,-15,4
NMJVYKGFOQZdAWUgCELTHPXfSBaecDRIb,UAAAEAAAHACA..XADABAFBeAGHRAGB.ICEAMCDB.VDGBhAAAGCFA.QDAAhADAAAIBCCCDLEAATFDAhAEASEEBaDHDbGAC.NICBKGHBFGHB....hAEA......hCAA...,1,1,-10,11
dXcFaZORISDQBfYLEUWGHKPTCMgNAeJVb,eAAAVAAA.dAEA.FAGAZADB.RAFA.DBDBBCFDLCGBUDAA.HDEDKCHB.hAAACEBA...MEEAAAAAXGBAhBEA.aEHDSFFAhADA.QGAAEEDB.PHCAhAGAgGGG.hAIA...,1,-15,-27,12
gZWEXVTSFJIeMAbPOHKfcdaYUCNDQGBLR,OAAAHAAAKADCdAEAaAFDUAGA..DAHBGBCARCAAZCEA...EDGATEEAhAAAFEBB..eEEBhBAAAAIB....bFBBfEHAhBBACEHABGED.gGBAXGGA.SGDHhBEAMIDA.cGGChBGA.,2,-28,-11,17
XbgfVBCGPUNODMTcedWSEZIAHRQFKaJYL,HAAARAAAQADCaACALAFA..bAFBfCCABAHA.GCFAhAAAPCCBOCHFhAGAMCHBeDFBdDECEECFAAAAKEDAhCAAXFGDCFHADCIB.WHAAIHHA...hAHA......hCAA...,1,-1,-11,10
INXFAbRJOBfCcYMUGgdKEeLHTVDSZWPQa,RAAABAAACADB.MACAGAEAdAGA.KAGALBCA.HDBATCCASBHHhAAAZCGBQGAAhAAAaDDA.XFFChABAABDAbDFDOEHFfGDAUGBAEHEADEIBIHHAhAGA.....hAIA...,1,-4,-10,6
HFTGQDIMdRBWAECLXSbPeaZUJfYcVNOKg,EAAALAAA.SADHeACAZAFBUCCAJAFA....fBFEhABAcCGD.OCABhACAHDABGEDBQDDAhAIAMEIBRCGFACCBXGGDaEHDYFGFKHBA..hCBA......hCIA...,1,-1,-18,17
SdLJBRQPFZOEAbHVCNGgacMfYDXITeUWK,HAAACAAAGACAaACAMAFADAEA....TAGAeBDAKBGA.dDDALBEBhAAARDGBQFEAhAAAZCAFACGBVDGBNCCA..fGDEhBIAXGGAWFFDBHHA.....hCAA......hDAA...,1,-5,-19,14
DMYTRgEfPOZGAdLNBIQUaXWVJKCbSFHce,dAAALAAABADAQAFAaADD..XAFAJCBB.bCABHDCBhACA.eBHHMAIBREEFEEHFhADAOCDEAFAB.IEEAhABAUGGBKHBAFDGD.DEIB.TGAA.fGCBhACA..hAFA...,1,-9,-23,14
KHNETVJeMIGCQLfDdPRgAFUOSBYXcWbaZ,OAAABAAA..XACA..bADAZAEBHBGBEAGA.JBBFeBHFhAAAGDCALCAAdEAAREEFAAHAhAEASCFH.hAFAcEECaEHDKGGDNDIAMFHB.....hBAA......hBIA...,1,-10,-16,6
PgNBJQDeKLVEcMaOFTHZUWdXSIGCfARbY,RAAA..bAAA..PADABAEAQAGA.eCABLAHBhAAAECCBaCEATBFA.hAAAHCCAZDFAdFFASECAhABAGEDAADHAgEGADEABKGAA.MFFBFHGE.hABAWHBA.CGHA...hBHA...,2,-21,13,34
dHQTPRBYIbeOWLMANUCGgSDcKZJVXafFE,CAAAGAAADACA.ZADA.JAHBaADE..FCDAHAFB.QCBAhAAARDEABEAD...IAHAhBCAeDDDLFGBACIBUDDASDGHhCAAKGAA.fFHA.hAAAEGEA.....hACA...,1,-17,-29,12
LCZbRYNQgIeVBEFPWfGTJaKdScXDAHUMO,HAAAMAAALAEAZADBRAFAQCABeAHHEBBAFCFH....fCDAhAFAGDGAaCHFdCFAXGAAhAAAADCBCDHA.YEEFhACAgEEG.BFDD.TGAASGGDhADADFHB....hAGA...,1,-2,-9,7
MVAUaXKEQSFYNDIfBLCJcbRWZeGPHTOgd,aAAAEAAAFACD..DADABAEALAGB.CBBD.bAFDRBDA..ZDBAeAHBhAAAHEGBOCDDdFDDAAIBKGBAhBAAQEAA.SEGAhAEANICB.fFCB.cFFChAIA.PHCAhCAA...,1,-22,-27,5
eUKLgPfGIJcNdEVTQMbYOFCSARZHDXBaW,HAAABAAAeACALADB...fAFAGAFAIAHAhAAAJAHBdCADECFFTCAAMDIBbCCBhACAFEEH.AEHBRFAAZDGBaGEEKEEAhADA.PFBB.NEIA.YHAG.SHGAhAAADICA..hACA...,2,-2,0,2
TUDRFSbVaHYGdJNPeZKOQgMECBWILXcfA,TAAARAAAFADA...SACBaAFDHBGBdCCAJAEA...eDFBZBEAQDDAhAAAEEDFBAHBLFHBhAAAfDGEAFFBDICAhABAbGFA...YHAA.NCCAOFEEhAHACHGC.....hCAA...,1,0,-16,16
ASgEOQLeGdYHDcfPWMCabFBVUKIJXZRTN,EAAALAAAdADAHAFADAEA.....fCBAMAHBaBCEBBFAhABAKCEAXCGDRCABAAIB.ODDBhAAAeCHHGDDAhACA.PFBDbEFCFFAAIGFATGGASHAAhAFA...hBFA...,1,3,-25,28
FWfTgPELGSBXJdaUCDeVRAIbOMKNcZQYH,OAAAMAAAKADAZADBHAFBFAFD.....TBBAEAHBGCGABAHAdDDAhAFAaBBC.DCIBRDBBAEEAIEGAhAHA..bFDAQFEDhBAA.fFHA.LECDhBBASFHH.hCAA...,2,-20,-19,1
DJYPBSXUORacgAWZIEbLeMKFNTCQVdfGH,ZAAAEAAALADAeACEMAFAFAHB...TCBAQBFA.dCCDhABAHCFADBIBJDEBBDEDSEHBhCAAOEABRECBaEFEhAAAAFGA.IGGAKGEACGGBfHCB..hCBA......hCHA...,2,-22,-9,13
WVPaGXZgeTBFULCbDSdNOfMQKHIcARYEJ,EAAAVAAAGACA.ZAEAeADEFCBH.LAGBDAFA.dCDAOBHDhAAAMAIBHEBAACFARDFB.JEGBaEDDhAIATGCABFHACHEAbFED.hBCA............hCAA......hDAA...,2,-21,-2,19
MHGAVcWgIJUSRLEBFZCaXNbdDYTOfQeKP,VAAA..gAAAUADALAGBEADAZAFB.aAHD..bDDBdCCAhAAA.TDGAQFBAhAAAeBEFMDABHFEBAAIBIFEAhABASDGARGFACHBADIDAfGGB.hADA......hBHA...,2,-7,1,8
MVTCSfHdFNUGDILBgaWZcOEYAQJPbeXKR,QAAAJAAA.eACARADFMAFA..TAFASBFAHCDAdAHAhAAAFCCHGDAALDABhADAaCGEZDFE.EDCBADABXDFChADACFCDfFGADEEBBEHAWFHHOHDChCAA..bGFA.NIBB..hCDA...,1,8,-14,22
BFdUGTYWaPHSKbIReLgQcEfAMCJXNDZVO,MAAAXAAAZABEBAFAdADAGAFA..TBGAaAHFHDBA.KDHBhAAARCCAeDFFLFAAQEGAhAFAEEFBADDACFHDDHBAFFCA.hAHA....YHDGSGGDIHHAhABA.....hAIA...,2,-27,5,32
VXcIfPGSJAaCLOEKDHMgZFNdTRYUbWBeQ,aAAALAAA.EAEAHACBZAGB.dAEBRCAAUCEAbAGD..BBFD.eBBDhAIAQEAB.hBAAXEDCfDEAhBIAGEGAAEDBKEGAMBIBFFFHNICBTGBA...hCAA......hCIA...,2,-13,0,13
gBGKFeOcLRbdUMHYZAISTNPVXWJaEQCDf,TAAAVAAA...JACAEADE.DAFABAFBGBEBeAGHLDCAhAAA.RDGBdFFAHCCAAAIB.SBHHhAAA.XECAhAIAaHBACHHA.KEHB.OFED.cGGAhCAA.....hBHA...,1,-16,-22,6
AagOeVERCJcNTGYXIQbMDPZFdBKWULSHf,aAAAeAAA.RADA.CADA...JAHB..TAFAGCCA..XBBChADAbCFD.MAIBZEAFdEHAhAAAKCDALDGBHFDBAAGAgGGGhABAEEEAcFAA.IHAADCFB.BFCBhAFA.SFHHhAHA.OHCC,1,-3,-6,3
YPUFAQBCXcgLHEWdTaJIefDZGNOSKVRbM,QAAAXAAALADAHACAEAFE.dAHAaAGDeCDAZCDAGDGAhAAA.SEAAhABARDEAbEAAMDIBPEEBAEAACFGAgGFGhAAAJFCBDAIB.KHDA.......hAEA......hAFA...,1,14,-11,25
bIYEcGXeZHVUJLNOPTSQBWgFdDKRACaMf,aAAAMAAA....IADAEADAGAFAeAEHHBBA.UDDALAGBhAIAOAHFTDCAhBAAQEGABBBDFDHDdFBAKGGDhAHAABGBbEFD...cFDB....hBIA......hCAA...,2,-23,-5,18
KOHEWQGgbfPAFRZLDdSBMJYaVXCcTUeNI,RAAAZAAAdADAMACA..aAFACAFA..UCCBeAHH.KBFBHAGB.ECFBGDDAhAAA..bEBCACCBLFBBhABABDHA.VFGBhBFATFEA.OHFC.....hCAA......hDAA...,2,-18,-18,0
RfIgGSYUcdCAXeKEJVLHDOQMBaNWZbTPF,eAAAEAAALADAHADAQAGCMAHB.aCCBZBCA.TDDARDDAfCHAhAAAGDFASCHHhAAAUFAAdFFAADDAKEHBDEAABFAAhAEAbFCDFHGEgGCA.CFHA...hAFA......hAIA...,1,18,-8,26
NSXbWJFRMQKGTYLZgBfIeDCAVadOPcEUH,dAAAOAAAEADAHAFA..XADAJCBBRCFA.MAGBGDCALAHBhAEAZEEFBEGAeBBBAAHAaEHDhACAcDCD..NDAA.bEFAhBAA.QFDD.TGGA.fHBBhBHACHHA..hCAA...,1,-7,-13,6
SOPBNKVJcEWGZdDMaQFTbfHCYReALUIgX,LAAAUAAA.XADDOADABAGA.KBDAVAFA.ECAAZCDEhAIAdDDAaBHDFCHD.TFAAhABAHDBBREEA.ADBB.SDGDhACAJFHB.GFDBMHCA.fGHAhAFA.....hBAA...,1,3,-27,30
QZJIcbKUVTXLHFEWaAYNSeBMCDGdOfgRP,SAAAeAAAMAEAGBCAdADA..fAFARBEAZDGB.JAHBbEBDhAAA.KAHBUDBA.TDEAhAAAHEEDEGHF.ABEABGDBhABAODHD.QGCA.IGFAhABA.XFAChAFA.FHGE,2,-6,-4,2
JWYCdecMXBSAKFGEQgabNLPIUZHDfTVRO,GAAAEAAA.aADALADAUAGA.HAGBDCDA.TCBARDBF.OCFBhAAAJDDA.CDHAdEAAeDGHMDEBhAEASEHHAAIBFECDbFGBhAFAIGDA.fGBE.YFFFhAAABGEA...hBCA...,2,-16,-3,13
DYBSGHbgMNZPTRAeLEKCJWdUVOXcfaQIF,EAAACAAAdACAUADA..OAEA..fAFFaAHD.QBGAhAAADBEBSBFDhAAAHCBAbDEDMCBBZGDARDFAADDB.hAIALFFA.KGCA.JHFA....hBCA.WHBG...hBCA...,1,-20,-21,1
JVKZXSBYgFRCeaHEMGPfQcDULdAWNTIOb,TAAAOAAA..JADBZACB.BAEAFAFA.RAFF..eAHHHBEBGDEAhAAAQCGCDCABdECAAAIB..hACAIFFAbEGB.KBBDhBAASGGDCEHA.EHAAMEEB.fGHAhCAA...hAHA...,1,-7,-25,18
fcOYZgJACQLSVHRWIBKbaFdDPMTEGNXUe,LAAAHAAARADFBAFBaADD.dAHADAFA..MCABEAHFGBEAUDDB.eCABhABAOCGBZDGBABGBQFCBhAAASCCDIEHAhACAbGEC...TGGA...fHBBhADA..hBHA...,1,-9,-20,11
OLYgWTKXNfGIJQbaPSeCVEMUFABRZdDcH,RAAAdAAAHADBLADA..gAFBTBGAKCBA..XCGAhAAAGCEAQEAAhACAaCCHeDABEDFBMDIBAAHAZFBBOECFhAEAYEEFfEGAIGGAPHAChAFA.CAHBFGHHDFIB...hABA...,2,-2,11,13
QeHXDMLVIJgATREGPBbUfacYOCZWdKFNS,EAAAGAAABACAUADA..aADDOAFCZAEBdAHAFCFD..QDFAhAAAHDBBMCHBLEHBhBGAIDDAACCBRGCA.fDDEhBHACFFAKFHBeHAADGGB.......hAAA......hACA...,1,-10,-19,9
ZKCBdIRDgTLOMAEbefSQYVcUaXFJHPNGW,EAAAeAAA.QADA..cACBaAFEFBHDHAEAGCCAZCDABAHBhAAARCFBDEFBLFHBhAAAACGAbDGDSECAUGAA.hABAXFED.PGAAKGGD.CHHA...hAGA......hCAA...,2,-14,2,16
SCJHUWgbcQZOdENXLPIeAYBKFGTRfVDaM,KAAAGAAARACF.DADAMAEACAFA..HAGBUBFA....bCDBZCAFEDFBhAAALCED.eCHHhAAAAAIBFDHD.TEBAhACAaEGHSFHHgFFGOHCAdGDA...hBAA......hBCA...,2,-21,-7,14
SPeDEbUGNQJfBLYFWgIaRZVTHdcAMCKOX,MAAAOAAA..SACAeADAEAGAGCCAQAFABBBDLBHBhAFAFBHD..gCFDhAEARCCAZDFBHFCBAEFBXEGAhBAADBBB.........hAIA......hBAA...,2,-18,-18,0
eRUBaDPHdFgSKCGNOXAVTZIbWJEfcMQLY,ZAAA..bAAAEADEMAEALAFB.RCAABAHAaAGEHBDBdCECFCHBKCAAGCFAhAAA.XFBAhABAACAATEFAICHAhACAJFHB.fEHA.YFFFhBFAeHAADIEA.....hCAA...,2,-17,-6,11
eaAVIFbKHLGDfPCZTgSYEcRMUXWQBOdNJ,FAAAHAAAGACADACACAEAZAFB..TAEA.SAGBEAHFRCCBMCIBhAAAXCEABCECdEFAeBHHhAEAADHB.VEEBKFHD.fEHAhAIA........hBAA......hCAA...,1,-14,-30,16
baAUcXNGDZYKSdECLJOFRMfeHTVgBIPWQ,XAAAGAAAZADAKADAEAGE.LCDBFAFARCDA.eCFAHCGB.TDAAhAAABDHAIFAAhAAA.QFEAhACAAAIBUFEADFIBdGGAOECDMFCB.......hAEA......hAFA...,2,-17,-5,12
CIEZOBUXMgHVPGRfaFSQdDeLYKTbWNAcJ,CAAAEAAAZACABACA.UAEAMADA.HAGBGBGARCCA.FCCBdDGDLDEBhAAAKEEA..TFGAhAAAbEBC.AAIB...IGGAhAHAXGBA..gGBA..hAIA......hBEA...,1,-22,-23,1
YbRdDeBZSXVECKHTLAaGIfgUWNcOPMFQJ,GAAA..fAAAUADA..NAGA.OADAMAHBQDDAhAAAbAGDRBCA.eCHHhACAZDBAXDFCEFBA.hAIAHFGBAFGBaFHDgGBA....hAAA......hACA...,1,-13,-18,5
RaPFYAbNTQMGeJHIELcZfOCWgVUDdXSKB,TAAAGAAAHADA.EAGEZACBCCDD.VAEAdCFAKCHBRCFA..FCAHAAABQEGDhACAeCEDLEHBhAAAODAHUGFADEEBBAHBhACAaFDH....YFFF.MIAA.hCCAIHHA.cFADhADA.,1,-5,-14,9
WdMOZDVfKUIJeCNPcGSQYLAHXbFgaTBRE,HAAAFAAA.aACARACFEAEEdAFAZAGB..DAGAKCCAUCEAeCHH..CBHA..hAAA.PDEDGDGAQFBAhBFAADIB.bGEAhBIATGDAMFIB.fFFE.IHBAhBAA....hBHA...,1,6,-41,47
EgWcGKLRTOAeIHVUMdYPBJfFZDCaXbSQN,HAAAMAAAdAEABADBFAGAZAEB.aAGD..SBBAECAB..gCCDhAAAGBFARDDBABBAeBHHhACAUGGAJDFBCCHBQEBChBAANECA.KHECTGGA....hAIA......hBGA...,1,-13,-15,2
gZfJMcHQPadSNTYeRCBAbGDFXWIKEOVLU,GAAAXAAAKADA.EAFELADA.ZAGBMAIBHCDBaCDAdDCCSCFHhAAATEGAREABAAAAFDDBhACAOFDEUFFAfDHEhADA.JHAA.......hAEA......hAFA...,1,-9,-13,4
ZWLfRdQMUTPABcENHJeYDGaCVXIOgFbSK,EAAAHAAA.eACEGACAaAFA.XAEA.OAHBbBDAZCCALDFAhAAARCGFdFFAMEEBTEAAhAEAAAIBBHGAJEDBCCBD.gFFAhAFA.........hAAA......hCAA...,1,1,-12,13
DCPHZJcWfRgNXeFBALVKbdGOUYTQMIaES,LAAAKAAAGACAOADDUAFA...TAFAMAIB..ECABCAHBHCAAhABAZDFA.JCFF..fEAEhAAAREGFXFAAeEDFhACAACIBdHDBQFFAaEEHDGIB.PHDC.hACAWEBH....hAEA...,1,-1,-15,14
QGIKUOSLVDYBTNgWcFMHeCAfbEJaPRZdX,EAAAaAAAZACBdADAGAFA.KAHBSAEA.LAHBhAFADBCBTDDAgBFAhBAAFDBHHDGBABBBJDEFRFBAQGGBhAAAOECBBEGA.cGECeFAD...fGGBhCAA..hCCA...,1,4,-26,30
KMfTXbAFVaLgZJUIERHCOGQcSBdPWeNYD,aAAAZAAAUAEA.RAGB.HACBGCAAQAEABCCD.dAHA.eBBDhAEADDEAMDIBTDEAAACA.LDGBhBAA.gGBAhBGAEEEAOEGDSFHH.NIDBfEDEhBHAFGFH..hCAA...,1,-4,-27,23
ALVXSKOaeZBcIGDJPfFEWQNCRHbTMUgdY,LAAASAAAaADDeACHZAEB.BAEAGAGADAGA...JCAAFBFDEDFFhABAQDDC.hACARCGFHEABbFGBMEEBdFFAAAAAhAEAKGBAOEHD.PHBCNIAB.CECC...hBHA......hBIA...,1,-5,-7,2
PSOgGBcQHFfLXDZRdEeIbJCTANKWVUMaY,KAAAUAAAMACA..aADA..SAEAGAFAQCDChAHAHAGBLCCAZDBBECHFeDBBhAAAbEFA.TDFA.AAIBVFGBhBDAOFEBBEEDfGGADDIB.dHBB.hCAACAHA.WECH...hBAA...,1,-2,-8,6
VDQGWcJZUBRYOTfPMFaeENbHSKdLgACIX,XAAAQAAAGADAJACE.ZAFARAFA.OCFC..TCDAhAAAMDAAeEFAECGAHEFAdGAAAAAAhADACDCDDFCAUGEABDHAfGHAhAGAaGAASGHBKHCC.....hAHA......hAIA...,1,-5,-9,4
SBOeUPGFRQDAbaZIgEHCTVNcfdJLXWKMY,ZAAAEAAAHACACADB...TAGAVAFA...fCCEdCAALCCAhABAKCEAMCIBBCHAeDFFhACAGEAARECBAEEBaDFE.gECGhAAAJEHB.XFFASFAB.hAEAOHEC...hAFA...,2,-16,-2,14
OWgbFRCLYePDGfQNHcXJdKIMBAZESTUVa,EAAATAAAUADA..aACAOAFC..bAEDRCBBLCGB.hAAAeDDEGAGA.QCCAhAGAHGDAXFGAhAAAdEFAMDBBAAHA.ZGBE.SFHB.hBCA......hBDA...,2,-16,0,16
IaVSORPeNMTQCGZWJEUdXFfDYBKbgcLHA,aAAAOAAA.RADA.eACH.MAEATBGAGBDAZCCA..EDGBdBFBFEAAhAEADAIBKEED..bCFDLGAAhAGAABBB.SEHHhAHAQGGACGFA.JHDA......hBAA......hCAA...,2,-19,-12,7
bKOHCMadfEUSgLBcRNFGXVDITAWYPZQJe,...PAAAZAAAeACEKADA.HAFB.aAHFEAFEUCCBLAHBBDFDRDGFhABAGCCA.DCFAAFAAQGGBhAFAbEFA.hBAAMFFBdGEASGGB....hCAA......hCBA...,1,-12,-19,7
XPGFHcNVQDEIWdAKBYZCLgeMUSbafTROJ,BAAAZAAALADBeACAMAGBSAFA..aAHBRCABOAHDhABA.JCFBGCAA.hACAHCCAVEGBECHFdFADAACACEEAhAAAbFCDTFCA.FEHD.QGEAhBFADEEB.IHHA.hAFA...,1,0,-10,10
XaLTGePYVCAHUIfNEbRMOZBgSFJDcWKQd,HAAAUAAA...fADBEADARAFAZCBEBCFDFAFADAIB..KCHBdCADLEEAhADAeCEA..PDCDhAAACFHA.ADHAbEEAMGAAhAGA.OGECSFHH.cGEA.hAIA.WHCG...hACA...,1,-18,-26,8
fMcBWXEdTgPJaOKSAHIGCLVDNeYbRFQZU,HAAAGAAALADBDADAeAEARAFAZCFA.MCABBAHA.ECDAdCCCTCFAhAAAJEEAKFAA..ACHACDCD.hAAA.NHCB.FDHD.QEEChACAfGGBXGGA....hBAA......hBCA...,1,-11,-22,11
GJTLaIEVPFHSKYcXAfRNZQBDgWdCebUOM,RAAAZAAAQADCDACAdAFA..eAHBOAFAGBDALCCA.EBGBhAAAFCGDHDECKEHBXFBAhABAABIBBEHACFFDMIDA.hAIAaGHBIFFA.SCCD.hABAfGHE.hCAA...,1,-11,-23,12
EFOcYbMBAXVCSDWdLZfQgIHGeRPaJNKUT,CAAADAAAdACAZABE..QAEAHAEBRAGB..aCCBKAGA.UDDAEDABODDBhADA..bCGDAAIBSDHHhAGALEABIGDAhAAAeEFB.NECA.TGDA.FHGEMIDAhAEA.XGGA.hBAA...,2,-17,-12,5
AKgdNaETcOCMJfHSURZWVbGBFePXYIQLD,dAAAEAAA.OADAMADAHAFCRAGB.ZBCA..VBDBGCFABCBAeDBAhAAA.XFGDQDFDhACAABDAKCHBaEHDCEED.SFGDhAIA.bGCA.......hAIA......hCAA...,2,-18,-11,7
FJQaEdZeMVGYRANKDIPWgBCXSTOUHLcfb,DAAA..IAAA..gABAXACATAFAHADBLAFAhAGA.bCFAQCAAhACAEDDBeEGBGGCBhAHAAAHAKBHBBCDDCFFD.OCFB.fDGAhADA.aEEHMFIBhBAARFAAPEHD.,1,3,-8,11
FARgaTEXcJLDNVMeIGBHfOPbCdKUSZWQY,RAAAaAAAEADE....XACDLAFBDAEAMAHBGAGAHCCBOBBHhAIAbEFA.dBFCKFCDZDDAQGEAhAAAADIB..hABATEBANIABIHHAfFFE.CFHASHFAhBAA..hBEA...,1,3,-23,26
OUWESDNeLdaBFAVHfKCbQTMGJXPIRYcZg,HAAACAAA.TAEAGACA.XAEARAGFZCAAOCEBEAHB.DCIBeCABhAAAaDFD.AAEAKCEA.MCHBhACAIEAA.gFGAhAAASEEAdGAAFFHDfHEB.hAIA......hBCA...,1,1,-24,25
SFLdeIEAKOXUBMgWTDGPYQNHVcCbJaRfZ,XAAAMAAA..TADAGADA.QAFAHAFBCAHA.aBHDRBBBZDEAhAFALDAAeEHHACIBODFBhAAABFDADFFBPEGDhABANHAB.bFAASGFHFHBC.....hADA......hAFA...,1,-1,-10,9
gHTdOEIKeDRYZbXVPaCcSNJBWUAGLMfQF,GAAAMAAAFADDHADA.dAGAEAFAeBHH.RCDAZEFAXBBD.aAHDhAFASDADBCEAABBBLDGBhBAAQGEATEEAhBHAKDCDbFAACGCA.NIAB.WEHHfGHE.hCAA.gGEGhCGA...,1,17,-26,43
dCTONbefALMXVEQBSIZcgPWRJHKUYDaFG,MAAAEAAABACAZABE......PAFARADFHAFBKBEADAIBGCCAhBAAdDDDTDGAOBHDeFAAhAAAACCBLEFBQFFChAFASEHDIHAAgFDH.WHCGhCAA.....hAHA...,1,-8,-19,11
NfJgPYQEUZCcXBADFTLeSIVGaRWbOMKHd,TAAAeAAA..SADAGACARAEAOAHDHAFBdBHA.JCCAPCABhAAAEEAAZEEA..XCEAhACAAAAALEHB.aGEAhAEAbDGDMHAAfEEA.QFAAhAEA.CGFDDIEA.IHHAhAFA,1,12,-15,27
OMNUYSgHfFQAdPCRebcITWVXLBKEZaGJD,dAAARAAAeADE..bABD..TBDA..XADALAGBEAGAhADAGDDBOBHDMAIBhAAAUCEBSEGAhABAHEAAQEFBACCBCGCAIGGABFHAaGACDGIB.YHCGhAEA....hAGA...,2,-10,-7,3
IHKFAfGZOLUVdgBTSPJEeDbCQRcaXMWYN,ZAAALAAAdAEABAGATAEA..SAHHEAGEDCAA.QCAAhABARCDBaCFE.MCGBNCIAHEAAhABAAACAGDDA.ODHBhAGAgFFAeFHH.CDCDXGCA.hBEAIHHA..hACA...,1,-10,-14,4
cSaEKWCIeRfHMQLUBFDXJZYAOPbTVgNGd,OAAATAAA...VADAGACA.dAEBaAGAEAHB.CBFD.RBGBHCCAhBAAMCABLDFAFDFDDBBBZFGBhCAAACHB....bEDDNEEA.hCCAKFFA.eHFA........hAAA......hACA...,2,-14,-10,4
cKCUNLEaGHDQdPOFWBSYVXTeRJZgbMIfA,CAAALAAAGACAHAEAdAEAFAGABAHB..SBFHXCACRCEAZCAAhABA.MCHBACHAKDHBEEBBaEADhAAADCIB...QEDAhACAOEEBVFGBeFFGbGAAIHHA.hACA......hAEA...,1,-6,-11,5
XMPALGVCEYIBeHDcfZQFUgWaSJTbNKRdO,GAAAEAAABACAHADADAEA.ZAGB.QCDBFAGDUCCA.aCHD.TEFAhAAAKCFDRDGB.dFAA.MFEBhACAAAIBLFBACFHA.eFFBhAAAfGCA.......hBEA......hBFA...,1,9,-37,46
WcbSKTIVdXDHCMUePZARfLaNYBOFGgJQE,RAAAaAAABADBGACA..QAFAEAEA..bAGDTCCA.hAEAdBHAHCEBMCFBeBBDhAIAAAAALEGBOEGDFGBAhBAAgECAcGFC.KFAB.XGDADEIB.hBGA......hBIA...,2,-12,0,12
HKBLVbcORMJWSZGfCEFNAXYIeadQPTUDg,XAAAeAAAdAEAQAGAUADA.HBCBLAGB.bDBARCFBMDIBhAAA.SEBBhABAGEGAEDFBAEEAaFFCTFBAhAAAKGAABHDAOFFHWHFACBFBNAIA.....hABA......hBDA...,2,-10,-1,9
JGRgPVWZHAXYSLIdOTUcEaQBFCDbKeNfM,SAAAdAAAOADAUBEBEADA..BAFADAHB.eAGH..MAIBhACARCCAVDABHCBB.ABDBLEEAhBAATDGAQEEChAAAbFDC.fFCAJFHB.gGGAhABAPHDC....hADA...,1,-12,-13,1
UNRDXSTKdgOGAEWLVQefPbaHcCJYBZIMF,EAAALAAA.eADHbACA.HAFA.CCAABCEAZAFBMAIBFCGDREEBSCCAhAAA.dDAAGFABhABAABHBQDGDhADAaCCHcGFDIEEA.DFHBKEHB.OHAChACA......hAFA...,2,-13,-5,8
YIXPbCfUGHKNJdaeOFSQATWLgZREVBMcD,TAAALAAA.RADFEAFEMACA..DAIBXAEA..bCABfAHAhAAAHCEBKCGAdEHAhABAeBDBSDDDhACAACCBZCFABEFAIGCACEHDUGGAJFEFaFGBFHACWHAA..hAHA......hCAA...,2,-12,2,14
JSVMbTQdfZWLKRUGBEYgAaCIOFNceDHPX,aAAAOAAA.FADDeACHHAFA..XAEASBBDMAHBTCEAhAFAdCEAZEAA.LEGBhAEARCGFBDDDEFFBAAIBCDDCIFFAhAFADEIBPHAA.........hBAA......hBBA...,2,-20,-12,8
FNMIBKVHOJSCTPfWdEgaXbYeGUQDZLRcA,MAAAKAAAHACB.SAEATADA....fAFBhAHAEAHBaCAB.bBBDeCEA.GDGAhAAAQCFAZEABREEBADIBhACAFEDDBFCAOBHD.CFFAdFHA.YFCFhAIADGEB.....hAEA...,1,0,-4,4
XETCeFRVbBDKSPNGYcQIOaWMAZdLgUfHJ,dAAALAAAUADAHAFAEAEA..eAGFRCAABCGASAHHGDEAQEGChACAaCAAACEA..hAHAZDCB.fDHAhABA.TEAAFGHDDCIBKEEAYEDFOFHDMGEAhACA.JHDA..hAEA...,2,-11,-4,7
HKdCbNBOQAgJGTIYUDFcRPEeXSaLWMfZV,GAAATAAA.UADAFACA.RAFA...EAFAeCFAaAHD.MDDBZCCAHDFBhAAAdEEA.CDHABECAAAAB.JFABhAFADDIB.XGAAhACALGCAVGFAKGHB.........hBHA......hCAA...,2,-13,-9,4
aTHJVZXIYGeSOAbCFdEWDcBPULgfNRMQK,FAAAEAAADADABADA.LAFA..fAFARCCAKCFC.HAGBhAAAZDAF.XBCAGDGAeEEBhADAAAIBdDBA..PDDBhBCAgGAGMDIBaEGB.TGDA.IHGAhBDASGED.hCAA...,2,-21,-19,2
GHKFJBDCIaPfONbTeYRAdZMLQcgSUEWVX,ZAAAMAAALADB.QAFASACAECAAXAEDHCEBFCHDhABADAGAaFAAOBBB.hACAbBGBeFGB.AAIBdGDAhAFAgCDGWFHBKHBCCEFAfEHA.hBHATGDA.cGGChBAA..,1,4,-19,23
NILedgEODYUfaSGPCBQTJXWFbAHcKZRVM,HAAAZAAARAEA.MACALAHBeAEAdBHAECAADACAUCCA...aCFBGCDAhABABDGDQFFAhAAATFAAXDFDFHCAAFIB.KFHBhAFA...IHCA.OHEASHGAhAIA....hCAA...,2,-12,-1,11
OBfLRCTGQEJFgDbKHaWNIUZeAVPdSXcYM,dAAAXAAAMADABAGARADA.GBDAEAGEFCDHDAIBHCFA..aBFCIDAAhAAAZCBB.ACHASEAAhABAODFCLFFAhACATEGAJHDAKFCA.UGGB.eFEH..hADA......hAEA...,2,-21,0,21
XWdFeZNbVSACYaHRUEfGBgcPQTKLOIJDM,aAAAHAAA.EADEGACABAFB....gAGHQAEATCCAhAAALAHB.OBBHhAEADCABMCFBdDFAeEDFhBAAbDFDACIBCDHDREGFfGBA..KECD.IHFAhACAWHCA.NEEA.SGHHhBGA,1,2,-22,24
IFReOgbaBZcGPANEVQSKLMJUDTHWdCYfX,EAAAQAAALADAMADADAHBHCBA.dCFAfAGAFCHD.hAAARBDBeAHHbEAAZEEAGDBAhAAAAAEA.SDGAhBCAKGGD.TFEAWFHH.CGDDIGHA.hAIAOHFC...hBCA...,2,-13,8,21
GIZSRdePYUfbOXQVTFNgaJLCHWEcBKAMD,GAAAZAAARAEAdAHAeADA.UBGAOCAB..QCDAFCCH.hABAaDAHLDFAHEFAEDCBhAAAKEDAAAHAMGCASEAHhACAfGHAXFGANICB.CCGDBGFDDHEA..hADA......hAEA...,1,9,-25,34
HZPNMQYeJUadGEfDKIBWbVTgLFRcXSOAC,HAAAZAAAMACAeACEUAGAGAFA.EAHBKBEBBCCA..VDDBTECAhAAALDGBREEF.SEBBhABAACEBCDHAQFAChAFAaFHD.dGGADGBBIHDA....hAIA......hCAA...,1,3,-26,29
SbRUTPIKAcCYeZGOBVaNMWDdQEHFLgJfX,CAAAeAAAGACABADA..aAEAMAFA.dBFAHAGBLBHBJCABSBFDhAAARCCBUFCB.TEBAhACAKFFAAAAA...ZEDBOFHDhCAAVFFADDIBEHFE........hAIA......hBCA...,1,-9,-19,10
GVCcbOMBSTPgZYQLdaeFWIfUDEJRKXHAN,GAAACAAA.OADAMACABAFA..TAGAZAGBLBCBhAAAeCDAFCHD..fBEEhBIAEDCBREEAHGDAACCBVEDAhCAASGGB..gGCB.dFHAhCBA.aCHD....hCGA...,1,-4,-25,21
ELKPOaHdZQRcCgFNbVeJTAXDGSYMWBIUf,GAAAMAAABADAUADALAFAOAFCHCECZBBARCEF...CCHBFDDHVDGBhAGA..eDBHACGADDDBSEGAhAAA.IGGAhACAEGGBaHAA.dHAB.......hAHA......hBAA...,1,-7,-29,22
BecgRUPOGbYaMHNfQSCVDZTAEJdWIXFLK,EAAAdAAA..XADALADABAGAeAGHRCAA.OBCBGCEB.aAHDHDDAhAAA.QEAChAEACEADZECAAEEA.IDHAhAFAKEGAUGAAbFCAMIEASGFHDGGA....hAIA......hBIA...,1,-4,-11,7
MQNaEBDKgAJdSeLRTFOCZUVXWPGHbYfIc,dAAAeAAARADAFAGAZADBUAGA....XCAAGCEAHDBB.hACAbDGBfCFAhADA.MCHBaFHDEGBBKDDBACIBhAEASGFHLFCATGFACBCA...hAAA......hABA...,2,-20,-9,11
eTSVAPCERZMQUKIXOHFgBbcNWdaDLJYfG,EAAARAAAZADBUADAKAFA...OAFCHCEBBAHB....bCBCNCCA.hAAAdCGALCHB.hAAAJDABGDEA.eDHHhAHATGCAAGDAMIAAQGFAFGGH...hAIA......hBCA...,1,-14,-17,3
XPETAQMdUDHNaKBFGJZeSRLIWOgbcYVfC,dAAAHAAAaADAFADA.ZAFBRAFFLAHBOAHD......bCAAcBDChACA..fDGAhAAAXCBDEEEAACEAMEEBhACADEHBBGFAeFFASGHHIHCAWEHHhBAAYHBA...hBCA...,2,-31,-8,23
ZSTgVKGbPXCFBdNHYWOLIEMQDUfJcaReA,ZAAATAAAKADCGAFA..bACBCAHAdCAAHAEA.OAHDECCBDCEBfCEEhAAA.aCCHhAGAACIBSDFDhABAVDGBFEEHBGCA..YDHFIHAAMFBAQGGBhAHAJHAA..cGGChACA.,2,-35,17,52
RTeEbBZNSVOFQaGMJXHKLdfWgUcPAYCDI,DAAARAAAEADEZABE...SAEHFAFAGCCA.MAIBHAGBLCFBhAAAdCCA..fDAAhADAgEGHPDFBhAGAACCBCFEDeHCAbEDDBGBA.OHEEaGHD.KGGC.hABA......hCAA...,1,-5,-12,7
MGPBLgRDFQdeWCaTJKUZSNHIEYfOAbXcV,XAAAMAAAGACBLADARAGF..QCCCeAGHaBHDTCDAhAAAKCFDZEEAHFAA.EGEAhAFAODCBABBB.bEAD.hAGAPEFADCIBFGHDdGGA.WFCH....hABA......hAEA...,2,-9,0,9
GXKODJfZPgILNcAdBEbQHWYTVSCMeUFaR,EAAAHAAA.TAEACACAUAEARAGFGCAB.OCHDDAHBZCCA..gDEAhAAALDGBAAIBbEAAhACAQEBA.hADA.VFGBeEEBaGAAKGBD.fGHAhAAANIAB......hBEA...,2,-32,26,58
NXROCLbMgBDdJaUSGQYIKeEFVHATWfcZP,TAAA..fAAAZACB.XADARAEALAHB.bCFDhAAAMAGBDCAB.aAHBGECAhACAQCAAKCEDEFAAHCDBhAAAAEHA.PCHDCFHABGGDdFDD.SEADhACA.eFHB.FGFDhADA...,1,-3,-6,3
LgNfOGBHPeaJXFUKbVWETICQRADdYcSMZ,dAAASAAAZABBLAEA..fADAGCEAHCGDeAEHaDBEhAFAFAGAKFHBbBFD.ECCBTGAAhAGAQDACAAIBDGCAMICAhBAAOCHFBGFAXEEC.VFGBCHHD.hBDAYFDF..hAAA...,1,3,-5,8
MAZPDNJCfHdQLcRWETXSgaVIYGOeUbKFB,ZAAADAAACACAHAEA.dAHALAEARCAA.EBBBTCFA..SAHHhAFAaCEH.ICEAhAGAGEABeDHF.hBAAbFFDBCGDAACA.PDCDfGAAQEEAhCAA.XEGAhCDA.YHEAOFHD,1,8,-25,33
RLMBHJgDeEFXfUQWObGaNIAVdKZCPcSYT,dAAAZAAACADBSADA.RAFF.MAFAHCACDBFAEBHFFBHD..fDEAhACAQCAAbEAAaCDDhABA..AAHA.KCFBcEGAhADALEFA.BFCAeFFBXGGA.hAEAOHECIHHA.hACA...,1,5,-31,36
EDTPLQXAeKVBRYHUfIZMWcOaJgdbNCFGS,eAAABAAAHACAUAEAZAGBMAEA..OBCDaAGEdCAA..CDFDGEBAhAAAECCBDCEALCHBhAAAABIB.RDFF.fDHAhABA.IFFAcEDBJHDAbEDDFGHBSGHBhACA....hDAA...,1,-9,-13,4
UaEDeCJAcIdFZRQSWHLTOPKVbXBgGfYNM,dAAARAAAQADCHADATBGAKAFC...XCAAGBGA..fCCEhAAAMAFAECFBeDCHhACAAAIBFCEDZFFALEEA.hABAOEHDbGCCBHHDNIBBaGGHDIEA.....hADA......hBAA...,1,0,-6,6
gXfbLIPKaFSWVMYUZQBGOcCeEdATNJRDH,TAAARAAAHADB..XAFALACB.KAEAaBHDSAGB.hAAAMAIBZDAAGCFAhABA.CCCDEEEBACEADCGBbFABFDEBhAAA.VEAA.QEGAOEHDeHFEdHDBgGGGhAEA.hADA...,2,-2,2,4
OcdSABGNUZRDIQFbHTKYXCMVWLfaPJEeg,GAAAZAAARAEADACAQADA.HAFATCDAXCDC.MCHBhAAALAHBaDAHEDFFeCCDhABAOEEHdCGCAEFBBFHAhACAIFAAKGFACHAA.fEHA.gGFBhAFANICB...hADA...,1,4,-22,26
GScBeVIEOJPCHdMYLAgXUKFQWNRfZbTaD,XAAAFAAAQADARADA.ZAFB..aAGAGCCABBGA.eAHFECDBOCFBhAAACDAAHEFAdFBAMCIBhABAACCBKFED..fDAAhADADCIBSGHBIEGAPHECLHDAhAEA.gGGBhCAA..,2,-8,-6,2
OfGNRWAYKJPVCIBedLEXcSFbTaQgZDUMH,KAAAVAAABACB.dAEAEADE....SAGAbAFB.QCCChAAAZBGBMCDBHEDBhAAAGCFARFFFACEA..PEBBhAGACHHA.eCHB.LFDB.FFHHaDHDhAIADFFB.....hCAA...,1,-11,-14,3
IDEMeXPgAUHJBaOVKcGCbYNLQSfTWRFdZ,HAAAaAAA.KADCGACACAFA....bAGDLAEA.QCEAhAFATCCARECAZEGBEBHFeBBDhAGAXCEBADIBBEEDhAIAOCABcFGASGEBFGDADGGB.MIAA.hBAA......hCAA...,1,-4,-11,7
GWTEZOHUDNBeFYcfLSQMdCAXIJPRKbgVa,XAAAJAAA.RADA.KADC...VAFAGAGA.ECDBHCCADCFBeDABhAAAFCHD..fDFAhAIALFFAMHFAhABAACEA.bGAAaEEH.ZGFENIEBBEGD....hADA......hAEA...,1,-6,-28,22
YWDCBFcKgabVEAXOHIRUGTNSLeMdfQJPZ,HAAARAAAGADATAEALAFAeAGH.dCGAQCABZDAADCIB.FCEHKEFDhAAAbDCDAAGA...OBHDhAAAUGGA.MEABJFDB.PEFChACACCCD.BGGA.aGAD.....hABA......hADA...,1,19,-20,39
SBZcTKgPCQVYONbRWEIaFLdDXGUMJAHfe,HAAAeAAAZADBTAEAKAFA.CAGB...QCFAOAHDRCAA.EBCFaCECdDHAhAAAGDGAMEEBAAHABEADhAAA..PFCBVFEB.hACAbFEDFGCB.DEEAXGGA....hABA......hBIA...,1,4,-10,14
NeZPKcOYdETGJFWAfDHaULVSXQMICRgBb,HAAAaAAALADAXADB.MAGBRAGFBBBDeAHBZCDAKCAD..OCHDhAEAECCBGCEAFECAAFAADFCBhAFASCHD.QFBAhAAACFEA.bGFAcGFB...hACA......hAIA...,1,2,-29,31
SbYFLcVUgfWRIATBeEMPaHQDZCNKOXGdJ,eAAAEAAA.MAEAHACAZAFEKAFCGBCAdBHASCCAFCFDLCHBUCFAhAAA....fEBAhAAAREAAAEAATFDAaEECQFFChAEACGGAOHDC........hAIA......hCAA...,1,-7,-11,4
WGSYCdgAXcDKEaZBfQPTORMLNeIVUFJHb,DAAAEAAAZACBQACA..TAEARAEAMAIBeAGH.UDFBHCEChAFAGECACBBDADDBKEEAaCBBBEHAhAHAOEHDLHCAhBAAIGAAFGGA...WFGD.....hCAA......hCHA...,2,-18,-7,11
RXEMQSPUKWZcTYgGbLNVHCaBfADIJeOFd,DAAAeAAAdADAEADA..MAFAQAFA.SBHBKBBBZBEBTBGAhBAAGCCA.bEFALDDDhBBAHFDBaCFCADBBODHDhBDAXGGCUGFA.......hAAA......hABA...,2,-25,0,25
eWPfAIFEUOMGBScRNYdbLZaCKQgTHJDXV,EAAAMAAAGACABADARAEFdAEB.ZAGBKAGC..TEDAHBBBDBIB.eCFHhBAAfCBE.hBBAABFBFDHDSCHDhCAA.cDCDbGCAaGGAQFGA..hCBA......hCDA...,1,-7,-25,18
ELcAdGMBSNObTHReQCUaFWKfYXZIVgPDJ,GAAAMAAABADAOADAHAEBRAGB...eAGBQCDAaAHF.KCFBhAAAXBBCZEBB.gDDBhBAADDIBEEGFAAIBdGHAhACAbDFD..CDHA.WFFDfGHA.IHFAhBCA....hCAA...,1,-8,-21,13
gAfcGVNaeJIZBUDKHXFbOMdSCPWLEQYRT,GAAAaAAA.eADAZACBDAFAHAGBFAHDMCDB.dCEACBBDLBEBhBAAEDGBRFFBAAAB....fEAEhACAVDGB.JGBEBECAhBGAKFHB.bGCA.SGGA...hADA......hAEA...,1,-1,-27,26
NEaVBfgKCQdAIMXbWYLcSFJZURDPGHOTe,MAAAXAAA....bABALADA.FAHBZAEBRCDAGDGAhAAAHAGBeCCBEDCBaEABfDGEhAIACEFC.ADIBIEEAhBAAcFAD.SFGADCIBTGCABGBAhBGA.KGFD....hBIA...,2,-18,-5,13
GBZESAHFcUdDfPbeINCWKQOVYRaMLXJTg,HAAAFAAAdADADACA.....bAEAeAFACCCA.QCEAOBHDRCEBLECBhAAATCGAGDBAhAFAEEGFAAFA.UFFA.fDDEhAGAIGHAWEED.....hBAA......hBDA...,1,-13,-20,7
ZcORTECVMIbWPdAHFfUQLJDeaNSgBKGXY,HAAAFAAAQADALADBeAFA.aBGESAFAKCADGCEAZCCAhADARDGFEDCBMAIB.bCFDdFAAhAAAACHB.fGDAhACA.DFIBBEHB.XGAAcGGC.TGGAhAGA.....hAFA...,1,6,-17,23
aEQgURZVCdSDMFLHYceObNXIABTfWPKGJ,TAAA..fAAAKACCGAEAEADAQAGARAFAZBCA.dCCAhAAAMCHBHDFBeCAFbEBA.hAGAXDDCADHABEHB.PEFDhAAAaGHB.UGAA.SEHHDIBA.hBEAFGDB.....hBIA...,2,-3,2,5
bVMCARQIDJcXWLUeaGFdfZEYSKgPBNTHO,RAAAQAAADADA.JACEXAEA.LAHBeAFAGCDAhAAAdCCAECFBKBHB.BCFAHECChAAAbDGDMEHBACDB.IGFAhABAUGAAaFCDFHBAZGFA.......hBHA......hCAA...,2,-17,-3,14
SOeDUFGgJCLWbZEKAaVcdXTPBMRHYINQf,aAAAdAAA..TADAMADAHAFC..IAGAQBBB.OBDDhAIAeAHHFCBDGCFAhBAACCFAbDCDEEHF.ACFB.XEEAhACABCHAYFFFSDAD.DDIB.JFHFhADA.WHEG...hCAA...,2,-10,-8,2
MfILWKEOBPGgcRJNAHQYbDSZVFUaTdeCX,HAAAQAAADACAZAEBFACEUBGAdAFA..eAHBMCCBLCDB.hAAAECGFBBDAGEGAREEAAAHASDDGhCAAaFBBCFEA.hAAAXGCA.IGGA...hAIAWFHH....hCGA...,2,-30,-8,22
WDBXEAHaUJFYZTCbSNKgOVPGeQcfIRdML,HAAAaAAA.FADAZACBCAGA...SAEAKBHBOCABGAGA.eCEBhAFAQCCA.hAIAfCEFREFFdFCAMBBBhBAALDGBBFHAADIB.UFEA.TGAANEEA.hBIA......hCAA...,2,-13,-11,2
EXCRMYHOKQWGbeVNBgIFJSfUPdAZcaTDL,aAAATAAALADA..EACERAGFHCCAQAECGDFAeAGHBBBDhAEAFCCBfECEhAFAdDEAAAIBZDGBXGAAMCIBKFEDWHEAhAIAbGEC..........hBAA......hCAA...,2,-6,1,7
gJBdXYLFZKaSGTVMebOECfDcHAUQINRPW,QAAARAAA..gADBdADALAFAZAFBKAHBGCDBMCCBhAAAeCHH.EDBBDCHBHEFBhAAAADDAUEEAIGAAhAGA.PGCCBEHAFFAB.aGFE....hABA......hAFA...,1,8,-27,35
SXCaWHZRPDAYTecdVBEGLOUJIQgMNFbKf,eAAAdAAAEADAGADALAGBOAFAUCCAQBFC.MBIBhAAAbDABKDFD..XDBAhABAaCHDHFBBRDGBACCBTFGAhACABEFDgGGAFGFH.....hADA......hAIA...,1,0,-9,9
EcWgPHMJYdUeRaGFZXbCTBONfAKLVISDQ,LAAASAAAEAEA.....gAGAHACBMAEAdCAARBEFGBGAhAAAZCCACCHA.TEBAhABAODFDAAIBKEEDDECAQFCAhABAPFGBUGBBeFGHaGED.FHAA.BHEAhACA......hAEA...,2,-8,4,12
BQaTENGFgeAIWcdHOKJPVZCUSfDRMXbYL,..IAAAdAAAHADAKACAPAHB.ZABBSAEBRCEB.MAGBhACAbDCDLEHBhAFAQCCAEFGFGCGAeGAGAEEBhAGAOAHF.CEFDDFDB.BGGDaGFHNIABFHAA.hAIAWFDH....hAHA...,2,-24,17,41
URCSTHWMIELBaZDFfXeOAgNcGbYKVdPQJ,...NAAA.bAAA.KAEAdAFA.QBBARAGF.CAHA.HCAA.MCEBhAAAEBDAaCFEZDEBfDHAhABAeCHHADEBGDAAPEABhACASEFB.IGHALFCBDFFBhABAOFHDYHAG.hAEA...,2,-8,-7,1
fZJHTdgXaEcLDNGFCQOUePbBYWIKMAVRS,RAAAZAAAHADBdAEA..aAGAEAFA.LBHBGBFAQCAAeCCBBCFAIDAAhAAAAACA.SEEAhABATDDAXEGDhABADFAACFGAOFHDPHBAYHCAMFFB..hADA......hAFA...,2,-9,-8,1
GNHfEVbFcJIDOeRSALQYTaCdPMgUKBXZW,LAAATAAA.dAEAMACAKAGAZCAAGAEBHCECEBDBFDHD..ICHAhAAAeEBBACCA..aEEBCCCDgDEAhAHA.hABAXEGAfFFAbFCCDGGBSGABhACA.PHCCBHEA..hAGA...,2,-18,1,19
FESKBdPXYALbOeWTHafQZRgMUIJGVNDCc,LAAAeAAAHADAaADDZAGB.RCCBUEFAGAFADBIBFAHF.ECAABCEAdDDA.hABA..XFAAhAAAAAFBbDED.OEHF..hABAfDHAgGCHMFIB.IHDAhACA.....hAFA...,1,-6,-14,8
MgUZbOEBCAVGFNQPWfcLXTYedRKJSDaIH,GAAAQAAA..fADALADATBGAeAEHRAGBSCFHhAAAaCBEHCEBMDIBZEEAEFDBhACAAAEAFECB..PGAChADAXFGDdGGDDDIBgGDAOHEC.CAHB..hAGA......hAIA...,1,3,1,2
VKdFHEGRSJPAYNITaBWecgMbQOCDfULZX,..IAAAaAAAeACH.MAEAQACA.DAFALBEAhAIAZAFEKCAAHCECRDDASBHHhBAAACHATEBABEGA.gFBAhBBAbEEACDDDUGGBdGGA.EGDA....hBFA......hBGA...,1,-6,-13,7
TbGOgRaPDAZQUFICeJBWdXEcLHMNfKSYV,ZAAAQAAAFADA.eACABAGAdAGAEBHFHBEB.MAIBKCAASCEAhABATDAAGDCARECA.hACAaEGAACEA.CFFA..XGBDhAAALEGB.fGAAYFHF...hADA......hBGA...,2,-34,4,38
GTVDIWZPcdONQFKBRebfACLYESgJHaUMX,LAAAEAAA.SADHHACAaAEAMAHBGAFADAIBZCAA.dBHAQCCBhAAABEDAREGBeFABhABAACFACDFAJDHB..TFEAhACAIFDA.cFFCNIEB.....hAFA......hAHA...,1,-9,-18,9
gJXZbVefFYdAUCSTEDIaQHWNPRMOcBLGK,SAAAEAAADADA.QADAHAEC..PBCBRAFAMCCBBAHBhAAAGCGAKCFD.XDDAhAAAbCGD.eDABFECDACIBTGDAhABAaEEH.OFGHgGEA...hADA......hAGA...,1,-3,-17,14
EYVafWAgDIJTOCdRMBGUQFPSLZcXKbeHN,DAAATAAAdADARAFA..GACAFBBB.LAEAZCEE.KBHBHDBBECABaCEDhAAAAAFA..JDHBMCGBhACABEFAQFAAhAFA.SDHDXFEC.eFFBNIAB...hAIA.fGHAhBAAIHHA...,2,-36,8,44
ZKgANVSaEXYdfILHJGTFDBCReObQUWMPc,SAAAEAAAdADALAFAHACBGAEBDBCBRCEA.eCEF.QCGAhAAAMCIBZDBAAAGAaEAA.fEGEhABATFCACFFAOEHHhAAAbFAAPFED.KGGD.NIAB.YHCGhBDA......hCAA...,1,26,-19,45
UJNfLYODeGHPRMVTXFIKbSgEBZQaAcWdC,dAAACAAAUACAJADA..LAGBDAFA..HBEBRCAA.MAIB..TDEAhACAFBGFKCBD..bECDhAIAEDDB.ZEGBABIB...hBAA.NDIA.OEBD.eFFFPEGD..hBCA......hBDA...,2,-27,-24,3
eVWJHKXGYUbcgZEFMTQODPCadAILSfNBR,LAAASAAABAEARACF.eAFH.JAHBHAEB.GBGAUCAA.hABAbEAAZCDFEEEAMDDBTGAAhAAAQEGADAGAaEHDAEAAhABA..fGDA..WFGDXGEDhACA.gGGGhAEA.,2,-22,4,26
YBHSaNVREXKJZdFGTbIPMcUWCDAfeOQgL,eAAAQAAALAEAHACAaAHDRAFFKBHB.dDDAGBCA.bCEBMDHBhAAAUDGADEAA.AAHAOFABhAEABFAASEEDhAAAEFEAXGEAZGAETGGAIHHA....hAFA......hCAA...,1,3,-11,14
BYdfeFVbPGHIJNUEZDOKLTRAMXWagQSCc,MAAAaAAA..QADACADABAFA.dAGAeAGHFBBH....bCFAHBBAhAFA.IDDAhAIAUEDAEDABZDFAKEHDRFCAABIBXFBDhADASFFB.fFHEGGEBDIAAOHDChBAA....hBBA...,2,-23,1,24
QYXPGKJeIVNSTRdBfUcDWZLMagHFOEbAC,QAAAXAAAGADAeACA...IAFASAFA.RCDAdCGAhAAAfAHADAIBZDAAaDHDhADAHCFAEEFBAAAACDAAKGAAVEGBhADABGHA..cDBD.MEFB.OHAAhAHA....hBDA...,1,-6,-11,5
UZWSOYbPgdLXcDNKATBaMRGIeFHQVCfEJ,aAAARAAAeADEHACB.QAEACAGB.EAGAZBEA.OCCB..hAAAbCEAdDEALEAAhAEADAIBADGBMDIBGEEA.FEHDhBAAfEGAWBBD.SGHD.hBIA......hCAA...,1,2,-30,32
cMdHgIZABfFVRUNLaOWSYCbPTGQDEeJKX,FAAARAAALADBOACD...SAFACAEA..bAFDGCEAhAAAEAHB.eAHHKDEDMDIBhAEAHEGBZFAABECAfDCEhABAUFFA.aGDDPHCCDIFA.....hAFA......hAGA...,2,-27,-1,26
IKMBcWSYGEPeDROULZTadVNbQXCgfFJHA,MAAABAAASACAGACBEAGE.DAFA.RBDA.LCCAZBGB.dCGAVCAAhAAAbEEC...QDEAhACACFAAFFHDHGDCACIBKEHBhADAWBBDeGBA.TGGANIAB.....hAFA......hAIA...,1,-4,-12,8
UAEGJIOcaLdHBeQCWZKbVNgMPYTFfDRSX,EAAAGAAA.OADAaACDHAEAeAGF.QCDAZCBAKBHB.VDGBhAAAMCGB.TEAADAIBRDBFXFDAhACAAAGAJDHFLECBhAAAdGGDCHCA.bFDD.gFFG...hBAA......hBCA...,1,7,-1,8
UagCZYRMSAOBPIEDFWJXQcTLGVKNefbdH,BAAAEAAAFACDJACA..QAEALAFBGCBAKAGA..eCDFhAAAdAHAHDDBaCFEZEABRDGBACBBOCHDhAEADFGB...XEEAhAIA.........hAAA......hBCA...,2,-32,-13,19
fONCSKcLgPDMdRZXYEIQUBHTAJGWFeVab,GAAAeAAA.aADAOADC.CAGB.KAGALCCADCDARCEAZDBB.EDHFQCGAhAAA.HECAhABAAAABFEEHbFADSFHHhACAgEGGdGGCXGCAIHCABGGD.hAGA......hAIA...,2,-19,0,19
LYHgIMcCDQFbKPedOTNJUBGVSXZWREaAf,LAAAHAAAMACADAEAQAFAKAGA.eBDFdBEATCAAUDFAGEDAhAAA.XGGAhAIARCFFACCA.fHBBhBHAgECACDHA.bEGDNCCA.BCHB.....hBIA......hCAA...,2,-25,6,31
RWGLVfIQYZbANEKMaSJOUeCdgFDTHXBPc,EAAAaAAA...OACCeACHdAEADAEAHAGBBAGARCEAGCCALCHBfCFEhAAAQEBAbEFA.hAIAAAIBMBBB.SEEAhAGACFEDTGBAXGGCcGGA.IHEAhBGAYHEA....hBAA...,1,7,-23,30
AHMKBNZdSGCPOTWDEbVcLFRgfeJIUaQYX,HAAAMAAABADAdADAGAFA.OAHFTAFAECAB..VBBBLDDBhAAARCFAeDEBIEHAhACAaAHF.QFAAhAFAAEHAZFAACECADFHBbFEDFGFDfGGB...hAFA......hBAA...,1,14,-15,29
cBCeQNVLIdgAPTbXJFZMGUDOWRfEKaHYS,TAAAXAAA.ZACBGACA.OAEARAEAEBHFHCFBSAHHhAAACCEDeDHHQBEChACALFAAdGGDADGAbDFAMEEBDEEBKFFAhBHAaHAA.BGHA.IHFA...hAAA......hABA...,1,1,-2,3
CPfDRNXMBUeabSGTJWZEdFYVgOHKIQLcA,CAAADAAARACA.MADABAFB..eAFA..aAGDGBBA.JBEFECAAdCGAhBAAFCDD...VDFAhAAAHFFA.QGDChBBAAACA.NBIA.bFCASHFATGGA...hAIA......hBIA...,2,-37,-8,29
eCBYJVdNWUaEcPHRDLKbSIQTgZfXMOGAF,eAAABAAAJACAdAEAUAGA..EAFEHBCBRCBA.LDFAKBHB.bEBAhAAAQCFC.hABAZECBMFFAAAHA.CGBAYGDGhBEAVEGB.aHGEDFFB......hAAA......hBCA...,1,0,-34,34
XKANIfGTDZabYVBHQLOdeRgMEcWFPCJSU,..IAAAGAAAZADA.aAFAVACAHCDALAFBeAHHREAAEDHFFAHBCCAAhACAUFEA..ACCBTDDAhCAADFIBBGGB..dDHAhCFA.MEGB.WFFD......hCIA......hDDA...,2,-24,-7,17
dBEPTHLGUIJeAcVDWbfFMgRSYNKXCQOZa,DAAA..bAAAMADARAEA...SAFAKBHBQCAAaAHDEBBAHCDAhAAAGBDAIEFAhABAACFA.VFAAFDCHgDGAhBAAXEGDOHDAdGDATGGA...hACA......hAEA...,2,-11,-5,6
OAHeJgTFQKcNURaVPEDbSIMYWCfLBXZdG,HAAAeAAA.TAEAQADAKAGC.UAGARCAAaBGEECCB.DDFA.SDGAhAAAMCEBCDFALDHBhAAAZEDBdFBAAFFAFEAH.cFDChACAPFGD..bFFB...IHHAhADA......hAEA...,1,-3,-10,7
UcPaeVNIEGQgODCYSTBAdbFJMZLWHRKfX,dAAAFAAAZACBHADARAEA.XAGB..UCEBaBHD.eAHH..ICCAhACAEDHFGFABQCEAhADADEFB.SEEDhAFAAFAAMFIBLHAAfEHA.PHEAhBAAgGFACFFB..hAFA...,1,-7,-19,12
eVLRJFgMTDaKScHZUQXAEOGdYBWNfCPbI,EAAAdAAABADA..fACACAFA..bABDeADH.RAFAFCEDhAAAMAHBaCGDKCEAHFAAZDAAUEEAhADAAAFAGGDB.YFFChAIA..PDHD.LFABhAFA.TGCADCIB.hCAASGFA.,1,9,-19,28
dUDaNgCeHPEGAYORfFBMXQSITZVcWLbKJ,RAAABAAAMADAQACA..TAGAZAEBVAGBLBEB.hAAAbCCBdCAA.aCCHCCGDHEFAhAAAEDFFADIB.OHEAFEGDSEEDhACA.IHHA...hABA......hAIA...,2,-18,-14,4
CaMcRXJVeAfOLQPZUbDHFIWKEYGdNBSTg,LAAAZAAADACAHAEAFAEAKAHBEBHF.GBCBBCCD...SCABhABATDEAaDHDRCFA..XDDChACAeECBAAGAQGFAhABAUFFAIHAA.dEHACHEDMIAA...hAHA......hDAA...,2,-11,-6,5
NZHadFGIECPeRgbSQJKfcDMYOVALWBUTX,LAAABAAAUACATAEAZAEBHAGB.dDGDGAGA.ECAAeCBBhAAARCDBSDCDQEEChAIAfEAAMDDBOEBHhBCAAAIBXEGAaFHB.CFFDbGAA.KGEDDGGB.hABA......hACA...,1,-4,-6,2
PYcfOHFAKdTWRgCEDLJZUeXVGbIMNBSaQ,dAAARAAAEADELADA.ZAGBeAFEGCABMBGBSCFDQCCAhAAA...PCHBhABAfDHAHEDCACFBTEAAhACACFHADGGB.XECDIHHAaEEC.OFHDhAEA.WGCA...hAIA...,1,-1,-12,11
IgOCNJLfAbWTSdDUPEFBXGRaVZYMceQKH,TAAAdAAADADAUAGA..EACEBBDARAEFZAGB.MBIBeBEH.HCAChACAOCCB.CDEDLEABhAAAADGASDGAFEFDaEHHhAEAVFEAQGCA.IHHAgGBAhBAA.....hAGA...,1,-5,-25,20
GLDUdaETZFeOcWfNYPXVbHBRSgMKCQAJI,GAAALAAAdADAEAEAZAEBFAGDeAGF.OAHD..fCAAhABA.PCCAhACAbDBDHDFCRDEAMAIBQFFChAAAAEIBDFDBaEAD.TFGANEEA...YHDGhAEABHHA....hCAA...,1,2,-15,17
UOdEKZNbTRGDfBPILgacSYCMXeJVHAQFW,QAAAFAAAOACD.EACAZAEA....bAEARCDFGCFABCDALCFAhAAAaAGA.SDCDhAFAMCIBeFAAHEEAAFAAdGHAhAFATGAADFFB.fFHAIHDA.gGCBhAGACHFA...hBAA...,1,6,-16,22
bQCAGKFaZMDSNXRIWefTgYcdOEHVUJBPL,GAAAaAAAZACB.MADADAFA...XAFARBEA.eBHHTDFA.hAAA.gCDAhACAdBHAHEBAUFFBBDFAbDBDABBBSGHHhAIAIFFAfEHA.OGCEhAIA.EGHF..hBAA...,1,-9,-19,10
HSIWGTNAdVFcOgaEYQDJKMfLXPRBUCbeZ,dAAAFAAAOACDEADA..QAFAKAEALAGBRCAACAHA.ZCDBHCEA.hAEASCHHGEGAAAIBVGCAhBAAaECADEGB.MFFBhACA...fGHABFFC....hADA......hBAA...,1,-13,-24,11
TYUPDHGLdXCFeMZARQbgEIVNJaKfcBOWS,RAAAQAAAEADE..VAGBaACEKAFA.BAHBSCCAUCDAHCFAhAAAdDFAFDHDeDAAAAAA.IEHAhADAJFAA.OFAAhAFATGGADFFBLEEDMICA.bGACfGGAhCAA....hCHA...,1,-7,-10,3
BIQGcVTFXRaWAHEfOdKgMNPZCYDbUJSLe,HAAAEAAAdADAMACAZAEB.DAGAUBGALBEA.eBHHQCBChAAAGCCATEFAREEAAAHA.KFBBhAAAPFHDCFED.JGCABFHAhBFA.IHHA......hBGA......hCAA...,1,-7,-21,14
GceCHEJULIKFVaSMgDPRBTYdfQXbOWAZN,GAAAeAAAHADAEADALAGBFAGA.aBFBMCCB.DCGARCDBTEGAhAAAdDDAQDGA.hACAbDEDAAIBZGCA.CDCDIHHAhADASFABBFFDXGDC.NIEB..hBAA......hBCA...,2,-9,-4,5
MIdbfFZBGAJVLKNecTRagQOUXSPDCHEWY,LAAAeAAARADA.aADDQAGC.OCCBSAFA.hAAACBHAHCAAECHFMDEBbCEDZDGBhABAADFAKEAB.TFFAhABAXFAADEIBIHHAdEDCBGEA.JFCBNEIA...hACA......hAFA...,2,-11,-2,9
IJPABUFLWVdSCKGagQbfTHZReMXENODYc,FAAALAAAdADAKAFAaADD...QAFA..bBFAHCAAhABARDBAeDFBECEFDAIB.IDGAhACAAAHABDGBVFABhAFAGFAB.TFFAZFGBMFFBODHD.YHBGhAFA....hBHA...,2,-19,-4,15
gYOIDFQENKCXWAZdLRHbfVMUBGJecPaTS,dAAAHAAA.VAEAMADAGCABeAFA..aBDBTCGA..SBGAhACAODEDFEABECBFCAHBAACAhAAARCEBUDGABECAPEGBhAEAgECADEIBNICBXGGA....hBAA......hBCA...,2,-18,3,21
JVYBcRMTQZfGKSAEWICPDbgNadLOFXUeH,EAAACAAADACA....bACAaADE..dAGALAGBFCCAUDAAHCBA.hAAAVDEBBCHA.RDEAMEIBhADAZEGBGECAAAIB..hAAAIFDA.gGBB.XGFAhAEA...hAIA...,1,-10,-26,16
gNFXCfTPUeLcHdWEaROBZAGMQVKbSDJYI,GAAAMAAAKADADADA...JAFB..gAFBFAHB.CAHB.TDCAhAAAUCBA.LDGBhACAHDDBECFBRFEBBCDBABBAQFGAhBAA.SCHHIHHANCIAfGFEhCAA...hBAA...,2,-31,-16,15
HefODKXSLRYUTIJVFgNPCAWBEMGZQabdc,EAAAZAAAaACAdADAHAFA.eBCDDAFAKAHBLCFARBEA.UEEA.TFAAhAAAIDDA.FDFDhABAgGFA.hBFACDBDAAHAMCCB.bDGDOEHF.SHCAhAFA....hBDA...,1,1,-35,36
KGBXMLdZeVYFSNHIUAOfTWEbaCDcPQgRJ,TAAAEAAA..aACDDACA..QAEARADAGAGAMCCBZAGBeCBBhAAAFDDAHDFBABIBODDBbFCD.hAAACDHA....gEADhAEABFHAdGAA.SEFBIHHA.fFHAhBCA.cFDDhBGA.KHFA,2,-11,-5,6
CGOYXIcMTKUWNFRLQSBbEPeAfJZaVgDHd,ZAAAaAAA.DACAHACBGAEAOAEA..XAGAMAIBKBFD.UDEBhBAAFCCHRCGBLEBBBEBDEEDFhABAABBBVFGB.dHDBCFFAIGAAhAGA.....cGEChAHA......hBEA...,2,-26,-7,19
cTUdDNGPKAXbgIZVaeSWRYMOLCFfEHQBJ,XAAA..bAAAZACBeAEARAEA.MAIBLAHBFBGD.HCFBhAAAQCAABCEDTFAAhABAdDDAGEGAAEEB.gEAGhAAAaEHDSFFDOFEDEHCA...hABA......hACA...,1,-4,-11,7
SaKODWPFUdMTebLRNCAHGQEIBcVJZfgYX,HAAAEAAABACAVAEAZADB......fBHAXAFAaBHDhAAADACAFCCAdCCC.eDEFRCFBAEEAGFCBhAGAQDGBIFHAhAIAgFFB.KHAA.WFHHMIEA.hAAA......hAHA...,2,-14,-12,2
CSZEVJPOULdNcBKAQXIFHYWMfRabGTDeg,QAAAFAAAHACBMAEARACAGAFA.eAHBSAGAZDAA.EBEEhBAAPDHBLCHBdEEABCDAhAAAADEAXDEA.hADAIGGAfFAAaHDADGIBCGFA....hCAA......hCBA...,1,-1,-20,19
McOWaRJEbBeZCXUdYDNGIFfTASHLQPVKg,HAAALAAAQADCKAEAMAHBOAFA.RBFBECABeCAAZCCAXCEAhABAdCHADEEB.GEAAhACAfFFAAAIBSCHHhAEAPHFC.gDDG.aFCD.bFGB.hAAA......hACA...,2,-5,1,6
ABYVDNKQIgERJbMceaTXSLCdZFfOHPGUW,BAAADAAAQACAEACARAEA..MAIBeAEA.aAHDSCAAhAAALCCAZDEEOCEBHFAAGCFAhACAABBBVFFAKDCBgGCAhAFAbFAB..XFGD.dHCB.hBAA......hBHA...,2,-4,-3,1
STDCEVXafZLdJBYPGOgRUeFbWMKINQcAH,HAAATAAAEADE.aAFAZACB.dAFABBFAGBGARCAAFBHDMBEB.KCADQDEAhAAAAAHA.CECAXEGBhACALEFBPFBAhAAAOFHD.eEHH.......hAIA......hCAA...,2,-14,-7,7
gEPNLBCdFDKOVMbHYafQIRASWZUcGXJeT,ZAAAGAAAeACEEADALAFBdAGAKCDA..MAIBHCDB.aAHB.QDGAhABAAAABSDADUGFAhBIAXDCCTFCA.gDFAhACABCCDDICA.bFBA.....fFGAhADA.IHHAhBCA,2,-11,-8,3
aHgNJMAPIRKXcdSYUEWVZTbOQDeCGfBLF,RAAAXAAAdADAUAFA..EADAZCCA..TAFAQDGA.DAIBhAAAeAHH.GCDAhAAALFBAHDABJFFBACDBKDGDhABA.SDHH.YFCBWHBA.hABAbFFCfHGFhBFABHAA...,2,-33,10,43
YQNaEcXfOTgedVMFSGRKIbALWDPJZHCBU,LAAADAAAZABEHAEBBAEAQAGAEAGA..fBHAhABATCCAeDABdCAAMCCAGDFAhADARCFBKDDAADHAPFEBCEHAUGAAhACAaGACOEAEFHGE.bFFC......hAEA......hAGA...,2,-7,11,18
cWfaASYXQRPBeFZVgbMNIEHdTGDLJOCKU,XAAARAAAeADEZAGB....VADAMBEBEAGEHDCBGCEBLEGBhAAACDAAKDCA.UGAA.fFEAhABAAAAAQEFBhADABCCCFFHDNDIA.dHCB........hAIA......hCAA...,2,-13,-2,11
CJcaeEQFdYWUOfRDTZGNKbLPgMHSAVXBI,BAAACAAA.aACAEACA.dAFAUAFARBDB.ZBCFGBGA.KCAALBHBhAAA.MCCBHEFBADFA.hAIAXFBAJEFB.eFEDhAAAQFBBFHAA.OHDCDAIBNEIA...hACA......hAHA...,2,-24,-9,15
YGZSTWPICORLJVbQdHgEeAXDUcMaNFBfK,DAAAMAAAFACDKADAZADB....TAGA..IAGARBBBLCFAhAFAJBFF.QECAhAGAHDGBEEEB.AEFAXEFAhAIAUGGBaAHD.fGCE.SFHHhBAAWBBD.....hBAA...,2,-35,-5,30
RbGaeNfPMYDZSdAEXFIQWHUcTgCJBOLVK,EAAAFAAAQADAHACAUAFA....TCDACAFAOAGDLBHBhAAARCCBGDAAeCCD.fEAAhAEAMAIBZEFAADABXEFChAIAIGDA.gGEHBDGCKFHBaGGH.hADA......hBAA...,1,8,-19,27
UCQeYARcfWPFgMdIJSLHXBTKNVDZEObGa,RAAA..fAAAFADAdAGA..SBHHHADATBGAKCCADCFBEBCBGCAAhAAA.aAGAQECAhAAAACFBPDEBMDGBhACALEHBBDHAZFFBbFGDeGBGYFAF.hABA......hAIA...,2,-23,20,43
TBgGJHCINAXdESLefZQMOFWVPbDRcYaKU,EAAAeAAAZACBMAEA.FAHDVAEA..DBDARCFA...aBEETECAhAAAGCCAHEEBCDHA.AAHAdCBChBCALEFBOEHBbFDD.hBIAKHGA...........hCAA......hCEA...,1,-9,-19,10
ZHdefOQaTFIJVDbLUSNPcKBMCWEGXYAgR,RAAAHAAAeADEQADC.aAFATBDAFBFD.IAHADAIBbCAC.hAAALCGB.SCCDhAAAcDECMCHBhACAEDFFGGABADIBdGEAfGGAOFDCJFHB..hABA......hAGA...,2,-7,1,8
YeQcISXUdEDOLJBKATHFGRCZPfaVMWgbN,HAAARAAAZADB.aACAMAGB....bAEDeAHBQAGASCCDhAAAdCCAEDGALDABKEEAAEIBGGABhAAAfDFEgGGAhAGANCHA..IFCA.DEEBBFGAhBIACFFDWEHH...hCAA...,1,4,-13,17
KUOJFWGXAHVfYDRPCBTcdMQbLENgZeaIS,HAAAVAAA.DACA.RAEABAHBdADAMAFALCCB..EBFAZCEAeBHFhAAAaCGA.KDDAUEEAFEFD..hAAAXFBAAEIB..hBFAfFAACEHA...cGFDbFDDIGHAhCAA...hAFA...,2,-26,-11,15
FbWGeaXJNDOCEcdVHTBILRfAQSYgKMZPU,QAAASAAAKADAZACBFAEDGAFA.eAHBaAGA...XCCAhAAADBGBEBHBdDEAHDAATDGAhAAALEFA.ACCAMFABhABAbGFA.NHDBCFDABFGD......hBCA......hCAA...,2,-20,2,22
CfQcdGHbDLgBZROXeATWEYNaPJIVKSFMU,EAAAaAAA...JACBKADA.MAFACAEA..QAGAGBEBHCCALCEBhAAAZDAFRDFAeEEBACGB.hAEATGGANDDA.IHBAhADAFEGAUGAA.dGFADIDABHDA....hAGA......hBIA...,2,-21,2,23
WJfCXFNBYEURMPASQObVdeZaHKgDTGcIL,QAAAOAAAdAEAZAFBHACA.DAEAGBCALAHBJAHB.CBFAFCDDBBBDhBAAEDFBREBB...ABHBSEGHhAAAeDHFKEEA.TGDAhCAAIGEA.XGGA...hDAA......hDBA...,2,-18,-15,3
FYDbQJHcBAUeRPXOGadgZIWEVfTMCLNKS,RAAAOAAAdADAZAEB..EADA..TAGAMAGBLAHBKCCD.FBBHhBAADCGBQDCAhBFAHDGBAAAAeEEBGEEA.aEHBhBHAgGGAIHCAfGHANIAB.hAIA......hCAA...,2,-20,-2,18
SMDHYVKZGdfOJQeBaULgPINWcAREbTXFC,EAAATAAAFACD...MACAHAEA.KBHBdAGAOCDCeBDABCCDLEAAhAAAIDEA..hAAAcEEARDFFCCHADDBBZEGBGEBAhAIAQGAAaEHDPHFAAAGAbGCA....hBDA......hBEA...,1,1,-9,10
DMJeZARfcYXOHTLFdKWaCUQgBPNEGbVSI,RAAA..fAAAXADBHAFALADAdCCAaCFCQBGA.hAAABBCDEDHFGEDAhABAbCADSCDAMFIBeFFHhAHAAAEAODEE.TFFA.KEHBCHCA.gECBhAAA.PHAAhACA.IHHA,2,-5,6,11
WXadcTGJgQMCLRfDAOZEbSHVUPFKYNeBI,EAAAHAAAUADAKADCeAFABAFA.....XBGAdAHAGCBAQCABhAAAMDDARDFAABCAbCEC.hAAA.SEEDhBHAFDCDIEFAaFHB.TFGACGCADGGB.ZGAA.PHEChACA......hAGA...,2,-18,0,18
YLGdfMEOKQRWJeaHCISXbFAVUgDZNPTBc,UAAAZAAA..TAEABADALAFAdAGA.ECDAQCAAhABA.RCDBeBHHHCFASDAAhADAbDFDAACA.DEEBhAGAcEACfEHAMEIBKFDDaFEDXGFDhAHAFHFANIAB.....hAEA...,2,-20,0,20
TWCYbeVDJKBPILUcGFSNafgEORAMZdXQH,dAAAHAAACADA.eACEDAFA.BAFBLBFAGAGA.SCCA.hACAaCEDECBAAAIBZEFETDDAhADA..bGDAKDFCIHHAhAAAFDHDfECE.RFFBMHBA..hAIA......hBAA...,2,-27,-3,24
aILcMbeQdgFEHSRZYDAKVWPGUBOJXfTCN,KAAAVAAAGACA.OAEAXADB.CAFA.aAHDLAHB.hAAAMCDBeBEH.dCAAEBGFhAAAHCFBRCEBZEGBADHAPEBDhACABGFC.TFGANEEA.......hCAA......hDAA...,1,-7,-16,9
HWXGCJSVaDfOTcZNIQgeFLBUMARbPYEdK,RAAA..bAAAEADE.HAFBGAEACAHA..SCCAaAGAOBGDZDCEQCAAhAAAeCHFLFAAhAAAMCIBAAEBdFFAXDDDhABADEIBfHABTFGAIGBABGEC..hACA......hBGA...,1,0,-9,9
FMZIKGEfQVeXdCBRPaAHDWLTbSgUJONYc,HAAALAAATAEASADHUAGA.OAFA..cCAChAAAZBEBGCAAECCAQDEAhACAeBHFdDDCRFFAADHAbEAAgGCAhABANEHAFGEA.MCGB.IHHA.hADA......hAEA...,2,2,5,3
XSdPEgWReFYLNZCBUGVDaJMKcTfAbHIQO,HAAAQAAASACEEACA.RAEFFAGALAFAZCCFBCGAGBDAaCHD.hAAAMCFA.TDFAhAAAAEEAOEGBdDHAgFFGhAGAeFHFCGCADFFB.KDCD.fHAB..hAHA......hCAA...,2,-11,0,11
KZbacJCeRFVXgISHBMdEWGPQfOLUYTNDA,ZAAAaAAA.CADB.RACF.FAFA....XAEBSAHHHAGBdCAAECEBGCCBhABAQDGBLDHBhACATFFAABFBKEFAbGBAeFEBhCCAIHHABGCA.MBBBfGGE.hAIA......hBAA...,2,-13,-7,6
fdXIGZUTOAYcgeCDMPFVWHQLKBaRJENbS,....gAAAeAAAMAEAFADAHBCALAGBaAGEECFA.SCHHhAAAdCCAGECBZEBATFGAhAAAADEBCFFADFHBPGBChABA..WFHHBBFAJHDAfHEF.hABA......hBEA...,1,-6,-13,7
DRYfKXIPCWeHAFgbNSZMGTOBQdUcEVLJa,FAAA..bAAAZACBGAEABAEAdAGAUBGA.ECAALCEB.aBHDhAIARDDBKEAA.XFGAhAAACDGDHFGBADEBSGAAhABA.MHEATGBA......hBAA......hBGA...,2,-33,-4,29
SVDfdcaKCbIBQZFRNHTPeLUMGOAWXgJEY,XAAAEAAA..SACADADAdAGAKBDACAFABAHAZCFE.RCCAHCFBhAAAeDBALEEAGDAAACCAJEEFhADAVFBA..aCHFbGEAhAAAQGGA.FFCDNEIA.....hABA......hAIA...,2,-15,-1,14
WdfICcZFTGEURSXBNAVeOKbQgLPHJaMDY,eAAAKAAAQACCLAEAHBCA.aAHDMAEADCGB.dBFA.CAHAZCDBhAAAGDEARCGFBFEAAAAAbDGD.hCAA.JFHB..fFAAhAFAFGFD.........hCBA......hCIA...,1,-9,-25,16
MSWKEBDaRJVTANIQbXLGfOFecZUPYgCdH,QAAALAAAGADAFACEZAEBUAGA....gAGAhAAAHCAAMDFAKCHBEEFAaCDBRFAATFGAhABAADGB.NIBB.bEEAhAHA.OFHD..cFEC.CAFD.SGGDhCAA..hDAA...,2,-21,5,26
gGfKUVbWORIBYPdDQJTEcHNMAZaXCLSeF,aAAALAAA.eADHGACAKAFA.VAEAOAHDRCFABAHB.dEAAQCAAhABA.ECFBhACAHEDAADEBZEFASBBDhAEAfFAAbFGDIGCADEIB.TGGAhAFAMICA.FHDE....hAHA...,1,-1,-12,11
OYXCLAGZJBKfVUedaPQINRFDgETcSHWbM,ZAAAKAAAUACAeACEdAFA..aAEEQCCB.RBGFDDFBEAHBTCEAhAAAHEFBMDIB.OHAAhABACCGBADDBGEEBBHFD.hAHAfFAAIHHANEEAFGHB.SHEAhAFA.....hAIA...,1,-5,-20,15
NceHAaXLVbJKGMYWdgTUZISBQCEfPRODF,aAAALAAA.VAEAKADAGAFA.MAIBdAHATCAAZBBABDAAhADAECCERDEB.FDED.eDGBhABAHEGBADHA.bFAA.JHAAgEAAhACA.SECH.QGFChAEA..hCAA...,1,-8,-10,2
cVaLHMIZbWYBTXFRJeGPOQfEdNKgCAUSD,DAAAaAAAHACBZABE.....bAEABAFAFCEDRDFFeAGH.GCCAhADAQEAAECHFdEFAKCHBAAIBUFAAhAFASBBDLFHBhBAAMFHB..YFDBTGCA....hCAA......hCCA...,2,-18,-1,17
VJSGPIZXEbOaBQgHNTKdYAMFCfWLceDRU,MAAACAAALACADAEA.RAFF.UBBA..SAHBGAGAZBEBECCAaDFDhAIABCHD..HEBAhBAATDAAdFHAABEB..fDEAhAAA.eEDD.PFFA.hBIAXGED..hADA...,1,-21,-29,8
TPVFeCDdBGSgQbOHZWIMNURYLAaEXJcKf,EAAAXAAAKACA....TAFAFADAeAFHdAHAGCCAQCGAhAAAHEABZCDFMCFBRDBBAAHAaEGChABAfDHA.CFGDSFHHhAAAOHBAIGGAYHDA..hAEA......hAFA...,1,-10,-11,1
FBgbHdJIAZNDPTVMaXOYfCGUcWKQLRESe,ZAAADAAA...TAEAaABE.OAGDCAEAGAFAUCAAKAHBLDDAhABA.EDHFeCCBBFDAHDGBhAEAdFFAAADAPCEB.hACAMFFBfGAAQGGBFHGE.JHAANIBB..hAHA......hBAA...,1,-3,-14,11
WHUgDSAFGZCeMLNYOBfbdJPERVQITKXca,ZAAAeAAAMACALAEA.OAHDBAFAdAHAEBCF.RBDFQCFDhABAKCEAaDDC.HEFADDHBAAAACGHA.hBHA...NCCA.bECC.hCAAVGCA...TGGA.XGADhAFA.....hCBA...,2,-23,-1,22
XHOcTJDCEQWGYVANMaSBKbePZLfgUdIRF,aAAAKAAAeACEZACB.LAFBUAFA..RDEAHEBATBCADAIB..EAHBhAAAQFGAGCGAADEBMEFBhAIABBBD..fGFEhBAAdFCAXGFDOHBACHHB.....hCAA......hCBA...,2,-16,-10,6
cZXDKbSOUYafJEdPHATLgVFMCeRNWGQBI,TAAALAAA.FAEAeACERAGFGBDABAFBZAGBKCAA.OBDB.aCEDhAAAEDFF.HEGBABIBMCCBhCAACFCA..NIAB.QEFAhCGA.IHFADGFB.SDHHhDAA.....hABA...,1,-5,-22,17
LIgfAZNJCbdcEOHWTUDPBVQGKFXeYMRaS,ZAAACAAAdACAEADEHAEA.UCEBBAFB.GAGAFBHD.eCABREAALEFAhAAAICEAAAGA...bDDAhABAOHEA.DCBBQFFBhACA.KCCDMIAAaFHD.SGGEhAEANIAB....hAIA...,1,-2,-21,19
OfcIVbUedEXgJPNCWZTHDKGAQLaBRMYSF,aAAARAAAMADA..FADAOAFE..fAGA.VBCBhAGAeBDF.ECEA.XCGAhAAAgCFAJEEACFHAZEEAhAIADCCBABBBLEHBBGGDSHCAbFCC..hABA......hAIA...,1,-11,-30,19
UJPLcfBTEYIONQRbXKgDSVaeCZdFMGHWA,UAAALAAABADAEAEA..OAEDRAGBKCAADCCA..aAGAZCEBdBGAGEAAhABAHCBCACIB..PDGBhACATEEA..IDDAhAEAbEGB.SEHHeDABMFIB.cGCAhADANIDB....hBAA...,2,-22,-9,13
YaDeJGMIbQTPXNUASBVKOHFWCRfLdgcEZ,BAAAOAAAHACAFADD.RAFFdAHA..EAFAaCAAeAHFGDDA.MDHBhAAAbCCA....TEFAhAFAXEAAABBBKDHBfGFAhACALGCA.........hBAA......hCAA...,1,-14,-25,11
CfdIKEBXAVHNTGecRPaODZLbJWQYSMFUg,HAAAGAAARADFOAFAZADALAGB.JCDBQBFD.MBIBhAAAFDHDCEADdCADEEFBADDBTDFAhACAeFCB..aGEBbFFAhADASGHB..fHFBhEAA.BEED...hAAA...,1,4,-24,28
NbGHcFaWdLSMRDPYXOJgATfQUeIKVZECB,TAAAQAAA.eACAKACCEAEABAFAGAGAHAGBaCDAdCCAMCFBhAAARDAADDGB....XDDDhAAAODGHAAIBUGGAZGBACEDAhBGANIABFDHDSFHH......hCAA......hCEA...,2,-14,1,15
ZRMbHEXeVKULFfOCQTWABPSGDIdgcaYNJ,SAAAGAAAdADAaAFA..JADARBFBHDBBEAGE..eBCFKBHBLDDBhAAAOCFA.TFFAhACAAAAADDDA..IEEAhAIAYEHHZEGB.bECD.XGEB..hCAA......hCBA...,2,-23,-4,19
QGEJcVLbAMIZXefNOFKTBdWPSaCURgHDY,ZAAAeAAAOACAKADAdAFA..SAFACAHA.RCCAHCFBQCCAhAAAEBHF.VCGBADIBMEEBhABAXEDAFFCBBFFDaFHDDGGBhABAJFHB...LHAAfGAA..hAGA......hAIA...,1,-13,-15,2
NBPESJbcZTCUedfXHGKgDIAOLFaRQWVYM,LAAARAAAQADCVAEA..MAFABAHBEBFA..SCAAhABA.JCEFZCCATCGAhACAeBHFdEED.HFGBhAAAGDCADDIBAGDAaEAB.YEGF.NEIA.cGDDhABACHFD....hCAA...,1,-7,-14,7
BFZbaKETHDQcgNWOdLJYSfeIVRMAPGCXU,GAAAXAAAFADAZACBKAGAHAEA..QCDA..gBGAhAAAOCFCdEGALDEBhABASDBHeDHFhAGARGAAAAABCECAbEFDEGFBDEIBWHAA......hAHA......hAIA...,2,-16,-11,5
AWQUeEJYcXCBbDRSPGOMdHLZVKTNIgfaF,QAAAEAAA.JACEXACA.BAFARAFAGCDAdAHAHCCAhAAAZCFATFFAIDAAaDCBhAAAACFAeDFA.CEEDbFAAhADASFHB.MGAALFGBKHCAfHEBhAGAFHBC...hAFA...,1,-3,-9,6
IaYXQCLJNeAZWFTMKfUEORGgSDHPdbBcV,ZAAATAAAMACA.KAFAEACE.GAEADAIBHBDBdAGBBBHD.ICCAhAAAaCCHQCFChABA.LEHBeDEDADGAfDHAhAEARFFFSHAAbGEA.....hAHA......hCAA...,2,-16,-8,8
eGBgNXCYQZPIEdcKRWOfaHJAMSLUTDbFV,MAAALAAADAEA.FAEAGAGABAHA...XBBAQBDDZBDBECFBhAIAdCAARCFF.OCCHhABAHFEAABBASCHBhACATGBAeHFACEDA..IFHAKEHB.aFFH.JHAAhAHA......hDAA...,1,-1,-17,16
cZDEXQTCUSeOIbFBPVdKgNYHLGRJWfMAa,ZAAAEAAA.QAEACACA.eAHBOADDFCAABCEDdAFAKAHB...hABA.gDAGhACAHCFCREEAfCCEACHBaDDCXDFDhADATFBAUGBASEHHIGGA..hAEA......hAIA...,1,-11,-21,10
SBHKgdcXWVbRLZPOYUENFJGTQDMfaICeA,HAAAdAAA.XADBVADARAGF.ZAFB..OCAEEAHFFCAHGDCBDCCBaCHDhAAAeCHH.BFDDKDDA.hACA...gEGGhBFAbFFA.LFCAPGACNIABJHDA...hACA......hADA...,1,6,-15,21
HgELdMeXUWCIZJaBRYKNfFGVbcOAQPSTD,QAAATAAA.HACAEACEdAEAeAEEUAGACAHBZCDBBCCARCFA.KDEAFEGDhAAAGDGA.VGBAhAAAbFEDADDB.DGCA..MFFBhBGAIHHAaGGHfEDE...hCAA......hCGA...,2,-9,-4,5
fTRdSVQaGbOXgHCNUJEcKMYeLIWFPDBAZ,ZAAARAAAdADAQAEAGAFA.OAGFHDDBCAHAUCAAECCB...MAIBhABAeCHFLDDAFFAABFGDhAAAAADATEGAaFHD.bFDBhACANHAB...KGGD........hCEA......hDAA...,2,-9,-7,2
BTfRVOPNGYgFLcWMUXJECeZDbaAKHSIdQ,HAAAdAAAQADATAEARAGF.OAFCGCABFCBDLDFA.MEABhAAAXCFAEECAeFFAhACAbDCDAAHASGAHhADA.fGDAPEECgFGAWGFA.hAEA......hAGA...,1,11,-17,28
dgCTFWPMJBYKLfQeZVGNIHSEUbDOXaAcR,RAAAdAAACADB.FADA..MAFABAGA.LCCA.eAHHGBDBHCFBhACAECCBDDBBaBGA.AAAA.TECAhAGAJDFB..fDHAhCAAZFFAIHFAbEDD......XGGAhDAA...hBAA...,1,-19,-23,4
GICdSBULXQKegYfVMDaJOWZbTAcHRPNFE,HAAARAAAFADAGAFAdADABAFALAHBQBGAKCCA.eCAB...hAAAfCCEMDFBaECAOEGDhABAbCED.AEIB.PEHBhAAAEHBA.SFAA.XGDAhACA.YHAAhAFADGIB...,1,-9,-16,7
YeMQCaLfKEgdTHDZGVJRIFAWPSXcUbONB,SAAAXAAAUADAOACD..BAFAeAEAMAHBQBGAhAAAaCEE.LCEBhABAEDBAdEEAHGECGEAAJDHBREGBAAEAhAIA.cGDANIAB.CEDC.......hCAA......hCBA...,1,-4,-16,12
WNLQTHbJAcOfDPZYdEMIGKCSgUVBReXFa,OAAADAAAZABEdAFA..EADAGBGACAFA.UCCARAGFeBBB.aCFHLDABhADA.HEDChAHAACIBfDDAMEIBSFBHhAIABEGAFFFHQGEB...hAIA......hBAA...,2,-35,-6,29
OKLANcBfITeRYQUJEMDGdaWXCVSHFPZbg,BAAATAAARACAUAFA..EACEGCAAdAEAaAGA..CAHAHCCCZBFBOCCBhAAAAACA...fCHAhCAAeCHFQFEAhAAAMDEBXFFAFGDHgGGBLHCA.hCAA......hCCA...,2,-15,-3,12
PVKgEBAFaNUYcbJZSGLDWfXeQOTIRHCMd,aAAAUAAA.....bADAZACB.GAEALAHBfAGBhAIAeCBATCEAHCGBdEBAKDADEEEBhADAABBBFEDB.NICBJFGFDEGAQFAAhAEA.RGFACHCA.....hBAA......hBEA...,2,-11,2,13
dKIXHOQAagZFCNWDVJUBLTSEYGMPRefcb,ZAAACAAADACAUAEA.LAHBEAEA.GCAARAGB..eBCB..hAAAbDDAdCEAKEHBHDBBAACAFFDAhABAVEFA.BGCATGBAhBEAMIAA..fGGAIHHA...hAIA......hBDA...,1,-12,-24,12
BCUTWFaeOdcbSKAJYPMZGEXIRHfLQNgVD,JAAAMAAAGADA..EADARAFAHCFCLAGBQDAAVBBBCBEAUEDAhAIAFEFB..eDDDdEHASFFBhBAAAAFA.hADAZGBAfEHADBIBBHFD.aGGC....hAIA......hBAA...,2,-11,-10,1
YASRTDLcXMNbeCPVQEZFaUdfKWBJgIOGH,RAAATAAALADB.MAFAeACE.CAFBQBGAEBFAZCFE.aBDCdCCChAAA.KEEDBCCD.gDEAhAAAGGEBHFBBhABAAAHADEDB.XEGA.PHEAFFGA..hCAA......hCIA...,1,-3,-20,17
gLdHICTKSUfOGMANERWePBFZDXabJYQVc,RAAAeAAAFADAZAFBDAEA....aAFEJAHB..QBCA.VCFAhAAALCCBHECATFGAhABASCED.ODHDhAAAAAIBEGFB.BEFA.XFCA..hABA.cGGA..hCAA...,2,-41,-9,32
aDcHBUYETOPIAdbfLNKXCgRQWeMFVZSJG,dAAALAAAKADA.CAEARAFFeAFE.FBFDZCAAGCABDAIBHCGB.BCEDhABAECHB..OECCACCA.hACA.bEABXEGChACA..QEECMHEASHGAaFHDYHAGhAEA....hAHA...,1,-18,-19,1
YDRMOfVUGKNeAbIHJBgWPXLCETdcFSQaZ,HAAABAAA...gADBXACAEAFAdAGAFCAH..aAHDZCCARCAA.hAAAMAIBOCECUEEBGEEAhACAeDHBAFAAJDHBLHFAhAAATFAA.QGBAfGCA.KGHB.hACA......hAFA...,1,3,-8,11
UHRKYcCZOAeMVbfGBXLFWTPJgQDNISEad,eAAAMAAA...VADAGACBLAGBTBGA.JBBFQCCChAAA.DAIBSAGEhAFAEDFBdEHAHGCARDCFKDHBCEEDAGGBhABAbEFDBHHAFFEBWHFA......hBAA......hCAA...,1,-3,-15,12
MBJXINGYgbOWCTAZVEeaLQdHfcSFDKPUR,EAAAeAAALADAHADASAFEKAHB.RCCBMAIBXBCC.GCEAhAAAbCEA.CCGAAAEAaEFBdDDChAHAFEHDDDIBBFCD.IHHAhAAAgGCAOGCEZGFE.....hCAA......hCBA...,2,-14,3,17
AIFaZUWQfedYCBHTJMLODKgEcNXGbVRPS,aAAAZAAAQAEA.eAHBdADABAFAHCAAMCEBLAHBKCGBEDFBhABAXCCCGGBBRCFBABBBhAFAFEAHUFCA..fFFEhACATFEADDBBNEIA.PHFCSHFAhADA..WHBG..hBAA...,2,-28,20,48
DLZKEQGNFbUVfYPCJdeOcMaAgBSRIXTHW,SAAARAAA..TAEAHACBLAEAEAGEGCCAbBFAVCFAhAAA..fDEAhAAACDAAeEFBMEIBAAFABDGA.hABAXEGADFHB.ZGDANIAB......hABA......hAIA...,2,-14,-8,6
MZLKAVPaCXFINWcdbJEGDgeHBOQTRSfYU,aAAAFAAA....IADA..cACDdAFAEAHBGAEA.hAIAeAGBHCCAQDAAhADARCGBfECEMAIBZEEBhBAAABBBCDDAXGFDbDFDDEIBOHAASFBDLHEAhAHA....hBAA...,1,-5,-9,4
PLfXEOQNdYHAeCRbGJSITBFUZMWacgVKD,RAAAGAAA.SADATAEAFAGAZAFB.aAHD..VCCADCDALDDBhAAAECGA.QEABhACAdDAAHEFAAAAAeDFAhADAbGCABGHAMEIBgFFA.fHBBhAEA...hADA...,2,-19,6,25
UMbZXSfAFIDWLYaJOgEBRcPdHNKCTeVGQ,DAAALAAA.aADDOABEBAFA.RAEFdAGAHAGBKCCAeCAB.GCEAhABAMAIBZDEESCCDhACAAEAA.FDHD.IGDAhAFAJEHBEFFB...PGFCTGDA...hAIA......hBIA...,2,-33,-8,25
DOGcYEReAQVZWdNaUCJgTHFMPLKfSIbBX,ZAAAdAAAaADACADB....TAFAHAFBMAIBLAHBSBDBhACABCAAOCCBGCBAEDEAAAHBQDFBhBAA.hABAVFGBUEGAFEEHfEDE.bFACDIEAhBCAcGFC.eHCEhACA...,2,-27,7,34
MWJVXLOaGFgKfQeTAPdZCcHUDSRNYIbBE,ZAAAHAAASACERADF..IAGAEAFAMAIBVCFALCCAhABAGDAAKBGBeCCBADGBdECACEEADAIBhAAA..bEEABEHAhACAXFABaFGC.fGGE...hADA......hAFA...,1,-7,-11,4
gRMcaQUIZFHbEDeVCTKLPXfYASBdWONJG,dAAAOAAAGADARADA.aAFAQAGC.ZCCAHBFBDBBBeCHFhAEATCBALFCAXEFAhACAAEEBBFHAJDAFMAIBIHHAhAIAEFEBKGGD.fHCBSGEA..hBAA......hCAA...,1,2,-20,22
gaZNEXcORKVBeDGIMFWJfYUCdPbLAQHST,HAAATAAAZADB.EAFAOACARBFA.BAFAeCAAGAGAMDFBFDGDJBDFUEGBhAAAdGGA...LFCAhAIAAACA.SCCDhBIANDIA.KGHDDEEB......hAAA......hAIA...,2,-16,-14,2
GCMLHATDIgUVceaBXOZNbRFKSQPYfWJEd,TAAADAAAUADA..eACEBAFAZAFBRAGF.SAHH.QCCAhAAAfBBAEDBBGDBAhAIAMDHBHEDCACIB.hBAAgFABaDDAODGBbGECKEED...PEHDhBBA....hBDA...,1,14,-33,47
QOGLWPAcNXdJYHRISFfZgeEBUaMbCTKVD,XAAAdAAAHADARAGFFADAZABB...ECEFaAFDMCIB..TCDAhAAADDDBGEFALAHBAAFA.hAIAcDBA.JDGFSFEDhBAAeEFDBHBACHHA.......hCDA......hDAA...,2,-14,-14,0
ZRWVGaNcTHBXeJCObQYUKdFDLEgfSMAPI,ZAAARAAAGADAaACA...TAFAHAEBeAGBOAHDQDDChABA.KDGDdDAALFFAhAHAECCBSDFAAAIBIHFAhCAAVFDABHHACGHAYHAADCCB.MIEA.hCBA......hCIA...,2,-9,-2,7
fJBgXQVWAeNdUZbRKMSLHFYGIacEPCTDO,eAAAdAAAZABBRADA.MAEAHAGBGBEA..aCCBEAHFTDDA.ODFDhAAABCHAQDCDhBAAAAIBUGAASDHHhABALEGBFEACIGBACFDDfGHAXGCD.hAEAWFHHKHEA....hBDA...,1,9,-19,28
EUNMFaIgVOBHPQGSfRZKbYAWCDJLXTedc,DAAALAAAeABAdAFAEAEAUBGA..MAHBaCAA...VCCAHCEBhABAGDFARDCBZEAFbEGDAAIBCDHA.hBAA...JEBBcGCDhACAFFEH....IHHABGFC...hAEA......hAHA...,2,-22,-6,16
TAVQdZEYXeHFfPJLUMCGgRBKINaDWObSc,dAAAEAAA.eADAHACAFAGDJAFALCCA.UDGAGCCB.RCGFKEAAhAAAaDAB.OEFB.bFCDhAEATECA.AAIBZEABhACAfGGAMFFBBGGADFIB......hADA......hAEA...,2,-18,-4,14
DCSgNeUMaJFYWLRTKPOQbBHAcfEZGIdVX,EAAAGAAAdADA.DADACAFA...SAEAeAGHMAIBaAGD..FCBBLCDBhAAARCEB.TDGAhACAODDBQFEAhAIAHEGBAEIBZFABXGGB.gDBHhBAAJHDA.KGDD....hBCA...,1,-8,-11,3
WNUPGCMVaZQRABODLXcSTHbYIdEJKegfF,DAAALAAA.SADHHABCbAEBdAHAEAFA.KCCD..eAHFFCGHUEDAhBAAGCAA.MCFBhABAZFFBABGAXDGA.hCAATFGAIHHAfCCEWDHH.CEDAaFAHhACA.RGCA.....hAFA...,2,-18,-3,15
XfGHBedgWYDCAUNTSLKbOJQFRMcZIaPEV,TAAALAAA.OADDQACCRAFA.ZAEBaCAAEAGA..XCEDhABAHCFBeCHB.dEAAhAAAgDGBDDDBABIBSECDhAEAbFAAFFFBMIAAIGGAfGHAhACABEEDCHFD......hAFA...,1,6,-18,24
cGRAUSPKLfMBYbDaCEQWJeHXNgVZdIOTF,SAAALAAAMAEABADADAIB..EAFAQBDAeAHFHCCAXBFAhABAVDABZDFEdCAATFCAhAAAGDEB.ACCBKFFDhACAbFGB.aDDH.CGBANIDB.......IGHAhBGAcGDD...hABA...,2,-11,-2,9
fIaQdCORWGEVPbNJYBSTHDLecXAFKgUMZ,KAAAMAAAZACB..aACEdAFA.RBGFGCAAEAFA..VBGB..bDEDhAAAJBBF.BDDAHECDeCFDhAFAAAHAFEHDUFFB..hAIAIHHA........hACA......hBEA...,1,-17,-26,9
XDMSgUcGRObdBPQFJAaZKCEeINTHVLfWY,ZAAAEAAA.eACE..TACAHAFBLAHB.fCCEhABAXAEBMAHBSCEDhAFAgCCAGEFARCFBdEEAhAAAQFDAAAIBaDHDCGBAIGGAWHBGDFIB..hBGA......hCAA...,1,10,-19,29
CFTSVRDeQPgcXbEBKNOfAMaJIUGdLWHYZ,aAAAUAAAGACAdADAHAFAZAEA.FCED..TCEARCGB..eDBBQDGAhAFA.gEEGhAGAbEFDEFABBHADOBBHhAHAACIBMDDBIGCA......hAIA......hBAA...,2,-14,-14,0
cHLaYJCbIOVWNDUGQABEZXgedfSKFRPTM,EAAAZAAAeACEdADA.KAFCRAFA..MBCBHBFCLCFAaCCC..CDEAODFDhABAVDDB..DDBBGECAhAIAAAFABEHAXFGDhBIASFGDFHEC.PHCA.....hCAA......hCBA...,2,-21,-8,13
eFSRLbNVHKOCJgWBPdGZDMUITfYcAEQXa,EAAAaAAA.FACDRACF..LAEB..bADDHAGBKAFA.CDFA..JDHBBAHBhAAAGECAZCFBMCIBhAFATGAA...fEEEhAGAADHBeEEDSFCBOBBH.gGGAhCAAdGGD....hCBA...,2,-27,2,29
fCWDMXKaFSTNVdbGQRLIHJZgBePUYAEcO,EAAAOAAA..CACAMAEAaADD..FAFASAGA..TCEAhAIAdBEAGCCARCGFHDBAhBAAZCFBeEHHPCHDABBBfFBEhBDAXFECKFHDbFFD......hAAA......hCAA...,2,-20,-7,13
VFcYKZHJWOdAEDRQXeSbGBgUMPTLfCaNI,RAAAeAAAGADABADAMAFALAFA.aCCAIBGA.FCCHKCFAhAAAHDABOCHDAAAAECHFQEEAhABA.bFCDhAGAgDFD.TGGACDDDcGFD.hADA......hBFA...,2,-17,-15,2
AFbUSINCaQXTDgERMcVWfPGZBOeLKdHYJ,FAAASAAACADA.QADADAFARBDA.MAGB..VCGBfAHAhAAAZDAABAHAeCCBhABALEEBHDABACIBUGBAhADAaDGDTFDA.EFHF.PHAAKGGA..hADA......hAHA...,2,-33,-3,30
bgaLYeRJMEfFNQCWISBcKAOdZDHGPXVUT,ZAAAHAAAGAEAXADBUBGA..TAFAaACALDDBRCAAEBHFFCEDQFFAhABACDGD.SCCDhAGAKEHBAAHAdFFADIDAhAAAPHAA..........hAHA......hAIA...,2,-16,-8,8
WNITPfUCgSeLRdObQaFcKZMVXJAGHYEDB,HAAAEAAABACA..IAEA.TAGAfAEA.CAGAeAHHhAAARCAAbCEB.FCCBZDFBMCFBhAEAXDCAACGB.GGABhAAADDEBPDHDSFHBdGAAaEGHKHEA..hACA......hADA...,1,1,-20,21
CEgBIceXOKMQLbdHNZSFVYATJPURGaDWf,TAAAUAAARADAGAGA..aACADCDBCAFAEAHBBCEA...eDABhADAKBDDMCCBLEEBHCGBhAAAZGAAFDEBAAIB.JFAB.fFCAhAFAIGGAXEGAbFFA..SGDHhAIA..hCAA...,1,-13,-18,5
GLFDebCEgNZIABQOaRTHVfYSUMJdcKWXP,QAAARAAAHADB..fAFBSACAMAIBdAFAKAHB.XCDChAAAGCFALDAAhAAAeCGFEDAAZECAACCBaEEHTGGAhADAUFBAWEHHDDIBbFBCCHADIHFAOHAE.hAHA......hBFA...,2,1,5,4
gGISEUZQJfYObWcTNaACLFVBPeHKRDMXd,LAAABAAAHACARADFMAFAdAFAGBGA.ECAAZBFB.QCAAhABAJCDBOEAB..bCGDTFDAhAAAABIBFDDH..eFCBhACAXFFDSFFDfHAFcGGAaHGE.hCAA......hCFA...,2,-9,-6,3
eOUAJIdGDTHgBKQYLFMWVfbSCacRNXPEZ,dAAAGAAAHADAKADALAGBMAFA...fCBACBFARBGF.XCEDhACAECDBeDADAAIBDCIBhADATECAQDCAhAFA.FEGDbFEAaFFHNDIA........hBAA......hBCA...,1,-10,-14,4
WXPVYGMEFdZHUCgSIQbJAOLfTecRaBKND,LAAAeAAARADABAGBDAEA....XAFAVCCBGCFAEBDFZCABHEABhAAACCEA...SAHHhABAbCFDAAIB.TFDAhAEAaCHDKFED..PFHBMFIBdGGA...hCAA......hCBA...,2,-14,-10,4
STZOfdEDFCYHLNBPeUcGIKMWAgbQVaRXJ,QAAARAAA.SACAZADBdAGAECFBCAFAHAGBLCCDBCDAeBHHhAAAGCEAMDABAAIBbDABhAAAaEEB....TFFAhABADDIBFEGD..PFBBIGDAKEHB.WFADhADA......hAFA...,2,-15,-6,9
VcQgEeCUGOJARKPFLHfZYIMDBbNWTdXaS,RAAAFAAAHADBZACB.MAFABAEA....bBFBTAGA..aBHDSCEAhAGAQDAAECHFhAIAeDDBGECAAAAALEHBhADAfEEBDDFBdGFAXFGA...hCAA......hCCA...,1,0,-23,23
PUbWNERJMVXLCSedYgAKGBFIQZfcHaODT,GAAAFAAAZACBHAEAaADADAGAUCEB....bBFAEBHF.REFAMFEBhAGALCDB.eDBHdGHAAAHAhBAABDGA.QFEAhAAA.OEHD.TGBA..hACA......hBAA...,1,-10,-23,13
SRYXWETLaNfKObCBUGAQMZcdPDVHegIJF,ZAAAdAAADADAHAEA.eAHHJAFB.RCAA....XCEAEAHBLBDBhACAaDHD.KCBACEAD.GCGAhAIAAACAMECA..VFEBFFFBSGAAhABA.YHEG.WHAAhAEA.....hBAA...,1,0,-33,33
TONBDFRgaMJdQcGWZHIVKbUeLXCEYAPfS,SAAATAAA.BADARACFMAEAdAFAGBGAHBEAKAHBUCCALDEAhAAAEDAA.ACABODHDhACAFDFHaAHF.QFFChBGAZFBA.IGDAeFHF.CHHA......hAAA......hABA...,2,-17,3,20
XTDeFHZRWNAScVEMfPIaCOKYJLBgbQdGU,SAAAEAAA.MADAfACA.aADDKAGALAFAhAAABBCAbBDDGCDB.TEFAhAGAeBFBHDGBRGCAACGAcFGDhAHAIFDA.OFFB....hAAA......hABA...,2,-29,-1,28
RZOCHgTYXBdPALKQMaeVUJDSNFfEWbcIG,LAAAMAAA.eADHUAEADAFAFAGE.EBBA..bAFAGCGA.hABARDCAZFDBHCAB.TCFAhACABEBDACDBaDEH.SDHHhCAAfGFAIFCACHHA.XFEAhCCA.dHCB.KHGA.hBAA...,1,10,-27,37
IbWgEQVPHdeCfcDUFXNTYZMRABJLaKSOG,LAAAaAAA.OADDGACA..IAFAbAEA..ECEAQBGAhABAHDFAeBBDfCAAhACADAEAXFFAhAIATDEAMEEBAAHAKCCDSBHHgEGA.hBAAdFCA.CGHAFHEA..hCAA...,2,-15,2,17
ZEWcKbGFCHMYNAgBQadLPRXDfIVSUTeOJ,QAAAdAAARADADAGA...IADASBFAeAEHZABB.ECHFKAGAhAAA.GCFAHDCAMDGBhAEAACDBaCHFLFDBhAGA.fFHATFDAOFHBWFFD...hAIA......hBCA...,2,-16,-15,1
HMOYPKQRJbEGTNeAfBcXZDWLSIVFadCUg,BAAAZAAALADBSACAFAFAdCAAUAFAHCEB..MAIBOAHDhABAKCAARCCFECGBGDGA.hACAeEEBACCBXEGAhBFADFBB.IGGAaGDBCHBA.......hAAA......hACA...,2,-23,-10,13
PEVdgFJGDCfRZHcXWQKeSBAaTUYMbNILO,aAAATAAA..MADA..bACBLAHBEAEA.dBBDFAGDGBDAhBAAfCEAHBFDXEGAhBFAQDFAeFEFhBHAAAIBUGGAIGGAOCCH......hAAA......hCAA...,1,-2,-15,13
UYgNAfLbZCaSTDGJQKMOHIReXPBcVWEFd,LAAAZAAAaACA.TAEAGAEA.KAGAHAGBRCGB.eCAABCCDVDDAhABAEEDB.dEAA.UFGA.hABA.gFFBhAGAAAIBCDHADECBMGDAXGED.......hACA......hAEA...,1,-5,-18,13
VJRFbHKSNZaAELIGYOTdQXDMWgPCBeUfc,EAAAGAAA.OADAdADAQAFAMAHB...PCBBeBFFfCDAhAAAVDDA.hAAARDFFHDBBSBHBhAFAaDHDAAIBIGHATEGADFCBWEEDBGDA.cGGChAIA.....hACA...,1,-8,-11,3
eHdYfaUFbgTINQVAcLDRSMWZJKEPBXCGO,LAAARAAAMADA.ZADBEAGABAFA.GAGAHBDAdCHAaCAA.FCCH.TEEAhAAAQDEA.hABAAAIBSDHHhABAKDFCCFBAeFHBfGGEbFCB.NIBB.DGEA.WGEAhACA......hCDA...,2,-20,0,20
eDFAPBHbGQUEIVTfLaZKNRSdMXOWJgCcY,HAAAGAAAEADE..TADAaAFAZBDERAFFdAHAMAIB..OCDB.hAAAJDGBCCADeCCD.ACHBbEDDhACAQFAAUFGA.hDEAfEEANIEB.SEHH.hDFA......hDGA...,1,-3,-13,10
NKMFUJDQERAaZXBLHdYgGIPceTfVWSOCb,ZAAALAAAHAEAdAHAGADA..ICAAeAFATCAA.VCFAhABAOCCB.bDEAMDDBhACAFEABDDEARFABAAFAaEFCBFFAhABA..gFGAfFHA.CGAAKGCA.hBIA......hCAA...,2,-10,-2,8
ebgNBfUROJPLWEXITVcaKMCQdSAFHZGYD,HAAAGAAAeACE..bADABAFB.RAGFOCCALAHBEDDBTCDAhAAAaCHD.MDABdDFAAFHAZEFAhACADGGAfDCEhADA.PFCBIHHAKGEAQGGChAEA.SFAHhAFA...,2,-18,3,21
eVPcOIBgYJdXKCbDUTfHMNWSEARGaZLFQ,RAAAZAAALADBeACE..VAGBOAFA.BBFAJCCF.dCCCKCFDDBIBUEEBhABAHCGB..MDIBhAFASDFDGGABaFGDhAGAQFBA.IGGA.XGDBhAAACHEA....hABA...,2,-25,-11,14
DVagGHFBPNSTOKfXAIYJLdMeZWEcUQCRb,JAAAdAAAeADAZADB.EAGAUAGA..RCAADBIB..aBFBHCEABCCCSEAAhACA.TEFAhADAfDAAACGALEHBhAEAMDGB...cECDbEED....hBAA......hBCA...,2,-44,-10,34
SLOERGATgXVcMIQDBbZfaUFHdeKNPYWCJ,TAAAXAAA..MACAQADABAFAZAGBaAFEHBDA.eCCBhAAAKBHBPCDBCDBDLEEAhBDARCFBAAAA.VGEADDAAbFEA.hBIAFGAANCIA...YHDA...SGHHhADA..hAGA...,1,2,-15,17
TfYCZdBMDPgUceJRLAGKOSWIHVNEbQFaX,GAAASAAAHADAEADAQAGC.aCDCTAFACCHA.dAHAhAAAMDABDCCAUDAAeDFFREGBhAAAADDAOCEDIFCAbDFDhABAXFAD..fDHA.hACABGHA.PHDAhADA...,1,9,-21,30
MCFDeVOJAaUGLNgREQYfHcKbdZBTPXSIW,GAAALAAARADAEAGEQAEA.HAGDbCDA.ZCAABCHA..hAAATDFASDADhACAMCEBDCIBeDCBOEABhABAAEEAaEFEUGGAgFDAfHCBdFHA...hACA......hAEA...,1,-3,-4,1
DFAabVZcQgUCSRXOPHJWTEGdYILKMBNfe,aAAAZAAAQAEA.CAGA.RACFOAEAHCAAJBHBEAHF.dCEALDEBhABAMBBBBCGDeDGDACIB.hBAAbEAA..VEFAgGGAhACAXFBA........hBFA......hCAA...,2,-26,1,27
KNgFUbAXcTGfWYEBHdOLZQIeVJDCaRPMS,TAAAGAAA....fADAEACEHAEBdAGBZAEBeAGFDBHBRCCBMCIBhAAAKBHBFDDHADGB..XEAAhAEAcEGA.BEFDLFFBhAAAQFGDIHDACHEA.aDAH.SECDhACA...hCAA...,2,-9,1,10
eOHWPFBNUARLTKcZCfJdDVQIYGXEbgSMa,RAAATAAAZADB..CAFA.dACADAHBQAEA.GBGAECFBSBHHhAAAeCDFHEABFDAABAHBhAAA.AEABLEEBhAEAKEEAJEHB.IGGA..bGCAMEIBaGGH.hABA......hADA...,2,-34,11,45
DUCKFPVBfdJENSIcAGWOeHLgRMaXQTbYZ,GAAAeAAAHADARADAMAHBaAFA....TCCAZCDACDHAFEAHBBHAdEEAECFBhAAA...SDGHhABAAAABLFCBQFEChAIAbGFA.DDIB.KGCB.fGHAhCAA......hCBA...,2,-20,-7,13
gDFXKGPJTSafHeWBdOUCRYVMcIbALENQZ,EAAAZAAAFADAGACA..TAGAaAEAHAGBBCAAdBEA.CCBD.RCCAMCGBhABAIEEA..ACIBLEEBhACAQDGBXEGDhAGAKFGDSFHH..eFCB..hAIA......hCAA...,1,-6,-23,17
HMdEPVRIOSaKfYGcQUDAgWFBbZXeTCNJL,FAAAZAAAeACECADA.LAFBHAEBEAGARCDB..OAHBaBHD..KCCAGEGAhABAQDACACCBBFCAhAIATDFAMCIBdFFCIFHAhADASGED..fEEEhAGA.cGGC.DHCAhBAA.WHCA.,2,-11,-6,5
DOISMWLfEBZTaQUXbAJHGFPCdNVgYRceK,HAAAGAAACADBdAFA..gADARBGFKCAD.OAFDMCCBLDDBhAAAEAHBZDDA..aCHHQFFAhACAXEAAAAABFFBHhAHAPFDBNDIA.cFFCDDFB...SFHBhACA...hAIA...,2,-15,0,15
UAIBGWPeLSFKVCNgEYDdTOcaZMHbQJXRf,GAAAeAAALAEAKADACAFB.EBCFdAHA..TCEAaCDA.HCGBQDDChAAARECAAAAABFAASCGDhACAFFGH.VFFAhADAgGAADDIB.cGCDMHBA....hAFA......hAGA...,2,-16,-9,7
gFPMVJNOCUbGREeLZBTAHKXWYQSadfDcI,HAAAXAAAQADCdADA.DAFA.IBGAFAFAMAIB.VCEAhAAAOBHD.CCADGCEAhAAAEDBAeEEBZGDAAEHAKFBASCCDhACAaGFD.fEGA...hABA......hBDA...,1,-4,-23,19
GSRVdOWFKYZIHDcXENTaCPfgUQMebABLJ,LAAAGAAARADAdAGAFAEAZAGBHCDCDBEB..ECHF..aCAACDCD...hAAA.fEAEhACAQDCDeEEBABIBSDFDhABAOEGBKHGAIEHANIAB.TFCA.hADAgGEA.hAEA...,2,-21,-4,17
NXKHZeQWGTIRLMfgJEBcVPaUObdYSADFC,CAAAKAAAHACAeACEGAFARAFF.MAIB..fBCAECAABCDAVEAAhAAAaAHD..UDDAdEEAAAEAhACAFDGDZGFEQFAAhAAA.TGGALHAA.....hAFA......hAHA...,1,1,-20,21
KHVEGNFZBecDJLbdQCTRAIOWfaXSUgPYM,OAAAaAAA.UAEA..gACHMAHBHBCBEAFAGDFAZBEEeBBDhAFADAIBLEBAhBAAdDDDTDGAABBB..IGBAhBEAXFFCSEHBKGDBFGHD.BHGA..hBGA......hCAA...,2,-13,-3,10
ObHPBfSQWUcACVJNLMGFTDYIZaRKdgeEX,CAAAVAAALACA.GAFATAEA.DAGAZCCA.RDABdBHAEBGAOCDBhAAAHECBBEED.QFGAhAAAUDAAACIBMDGBFGFHaHAAhADAeDHB.XFDA.fGHEhADA.....hAEA...,1,-4,-7,3
QROYCgTKbdZBIJSUaWGAFeNEPfLVMXcDH,eAAAEAAALADAMAEADAIBHAGB.RCBACCFDTBCA..dEAAZBEBBDHAhAAASBGHaECDAAIBFEEAhAEAfDHA.hAFAXEBAQFGAOEFD.KFHB.bGCChAAA......hABA...,2,-19,-8,11
IMLcYgNVEHBCKPATQFWGDfZXdOSRUbaeJ,TAAAQAAA.GACBZACBdAFARAGFaCDCeAHB.MBEBLDABhAAA..gCFAhAAAEDFFHEGBKFCAACABDEHBfGFEhADASFBA.bFFD......hACA......hAIA...,2,-20,3,23
ASXeaONIBMfHZQCbLEdDTGVKWYcRJUPFg,eAAAaAAA.OADCBADAHAEBZAGB.QAGALCCAEDHFdCCAGDAAhADAKECA..cEEAhAAARDFAPEDD.ABBBXFFAhAGAMFABbGCADGCAWFHH......hBAA......hBIA...,2,-10,-5,5
GZHNSaTAMdfIJPOWUQeRKEVgLcXFDBYbC,dAAAJAAA.OADAUADA.RAGB...EAFALBDB.FCBDBAHACCFAHEFAhACAaCCCACGA..MFCBhAIA..fCHAhBAA..IGHAQDEAeFEBKEHB.hBAAgGEA.hBCA...,1,-19,-38,19
ASPfWgURIZMTDBXaQEYOVdKHeLCFcGNbJ,SAAA..fAAAUADARAFAZCCAMADABCGAaAFEEDBBOAHDhAAA.dBCAHEEChAAAeBEBLEHBFCADGDFAhACAbGAAACIBgEDDDGAA.QGCChCCA.KFHBCHGD.NIEB..hABA...,2,-13,10,23
TXRBSVGfNHeDWQUCPgFIZMcdaLJbAEOKY,EAAAKAAA....TADARACASAFBGAFAHCAAeAHBDCCBQEDAhAAACCFD.FAHFZDAFdDHAhACAaCHHbFABADDA..XECAhAAAfFFBUFFAIHEAMFIB...hADA......hAIA...,2,-17,7,24
McLPIeFGHEXDAQZKBfWaTCgYSbdVJRNOU,ZAAABAAAaACACACA....SADHdAFARBGFOCCBUAFA..MDEBhABALBHB.eCABhAAAHFEBECCBAAHAQFBBhBFA.fGGBTEDAbFBD.VFGBhACA.cGDC..hAIA...,1,-11,-27,16
DFTWJHZfRQUNVOCdESeILgYKabGABMPcX,MAAAXAAAFADD...JADAHAFA.RBBBQCFBVBGB.dEDAhAFAEBDBeCHHLEEBhAAAKFFAaFHDAAGABEGD.DDDBhABAWHAAfFCE.UGGA.NIAB..hAHA......hAIA...,1,-13,-15,2
YCXIJFfODNHAbBUSdWPeRMVTagQKLcEZG,BAAAdAAAeADARACA.MAHBaAFA...KBFBEBFFGCAB..XCAAhAAAFDEDDAIBHEAAAACASAHHhCAAVEGB.TDDAhCBAQGECZDFBCDHAJFHB......hCEA......hDDA...,2,-25,-6,19
TgLaESDXHNbRAdGQUMPWcOeVZCfJIKYFB,GAAAMAAA...PADAOACE.eAFEZAGBCBFAJBBF..KCDABBFAhAIALEEAECGAXDCDhBAAHDBBRGEAAAAB..dEEAhCAAWDHHfDHA.FFHD.aGEEDIBA.hCDA......hCEA...,1,-11,-19,8
KFDPcNVbWOXBUYCdTfaSIAGHLMQJZEgRe,HAAAMAAAZABERADFeAFEDAFA.....PBFDVBEA...bCACXCCChAIABCHA.CBHBdDHAhBAAaEEBAEHAGEEALFFAhAAAEGHB.FHCA...WHFA.....hCAA......hCDA...,1,-1,-24,23
JRPAcgHOFXQIKGLbZYdSfNDTEBMWUaVeC,HAAAXAAAQADCGADAZAFAdAFAfAHADAGABCFA.MCABhAAAaCGD.eCCBRDAA.ACIBODGBhACAKEFDLFHBSEDHhAHAEGGF.WEHH.CHDA......hAAA......hABA...,1,7,-20,27
OUSgXcRPGKCVbJdeMfZWTAYaILNFQDEBH,aAAALAAA.QAEAEADAHAFASBBDXAGA.RCCFGCGAhADACCAAJCCA.eEEBZDEEADIBhABAIGDADEAABFFAOHAChAHA.gGGAKFHBdGDAMHAA.fHFBhACA.WEAAhAEA..,1,-4,-12,8
NDAUZJECLQGBHIKWgMfdOTRPXbcYeFVaS,ZAAAEAAALADAGAEAHAGDKAHB.MCABdCBARCFA..XCCC.hAAA.bDCDeCHHFEAHaEEChAEADDGBAEBB.CEEDQGAAhABABEHAIGGAfFHAOHAA....hACA......hADA...,1,-6,-12,6
XZWVCcHESOTMbgdBeKaLGFRIfAYUJDNPQ,UAAADAAAQACAZADA..CAGBHCBCEAEAOAGDMAIB..dCEAeBBBhAIALDGBRDDAABIBJDHBXEAAhAEA..cFCAhBAAbGEC.KFFB.aGBBIHCA.fEFAhAFA..hBAA...,2,-21,-12,9
KSVOYEMCWbTZdRQPILeBaUNfJGcDFHXAg,SAAAOAAA.EADAMAEA.CAHA.TAFARBBA..QBEChBAALAHBeCCAaCGDUFEAhBBAfDAAJGBEDCIBFGGAhBGAHDEA.AAAAKEHB.VGDA....hADA......hCAA...,1,-9,-17,8
TSRdLANEYcUHJZaKOMBPXCbDVIQfWgFGe,EAAAUAAAHACAZADAKAGCMAEA.BAHA.CBFA.DBIB.QCDAhAEA..fCCEhAAAFCGDeDCBRFABACEBNCHA.JDFBaEGEhAFAXFDD.IHHAgFDH.hCAATGGA...hCBA...,2,-28,-16,12
MTIKVCHBJaXQULZeGWFdcNbOYEARPfgDS,RAAA..fAAASADBMADAKAFAHCCAaAFE.QCFChAAAZBCAeAHHGCAAdAHA.bCFDhAAAEDHFADDA.DEEB.TFAAhABACDHAXFECLFFAFFHD......hAFA......hCAA...,2,-8,4,12
HMaGKCISVRfdNWEUJLDegYPbFXBZQOATc,HAAAGAAACADB.SADARAEFdAGA.EAGALCAAeBHF..gCDAhAAAbDEABEDDZFFAAADAMCGBhACAKGDA...fECEhAGANAIA.UFFBDIFA......hBAA......hBCA...,2,-17,-10,7
baNUZVcdWFPCfKXgODBETSQJALMYeHIGR,MAAAHAAARADF..aACEZAFB.dBHAFAFACCADKCCDOAHD..EEEATBEAhBAA..QEGAhAAAABBBeCCBGDGAbFAA.hACAVFEB..cGGC...WHCAhADA......hAFA...,2,-15,-15,0
UINaGCgdKeBSfWZPbVLJTXFMQEOcHAYDR,RAAAUAAA..aADAGADAdAGABBDASAFAZCCA...bCFALDGBhAAA.TFCAhABAMDAAEEFAHGEAAAFADFEBhADACEEDKGBDeFGF.fGCA.WFHHhAIA......hBAA...,1,-19,-25,6
UMBaAHDcFXEQIZeLgVYPdCGSRWTKNbOJf,HAAAFAAAEADAZADB.eAFALAGB..gBGAVCCA.dCADhAAAGDAARDEBKDHBOFCBhACAfDHAMFHBAAIBXEFDhADAQGEBIGCACGAA.SFEDhBAA.NICB...hBFA...,1,7,-21,28
RgHYVebMOWUEQSCPLZdGAJFNTIfBDcaXK,FAAATAAABADA.DAFAaACA..RBDA.HAEB.eAGBMAIBOBDHhAAAUDAA.EDFF.QEGAhAHACBGBZDDA.AAIBIHHAhCAA..XEGDYEEFVFDBWCCDhCIA......hDAA...,2,-39,-6,33
UHZMKLDORceCJbQEGVXgBfdINAWSYTPFa,SAAATAAA.FADAHACBZAFB.MAEALBHBRBEFeAHF.bDFDEBCFhAAA.GDDA.XFGAhABAfCAEdECCACHBhAIAPDHDaGED.DEEBCHHD.QEBA.hCAABGBD.IHHAhAAA.NICB,2,-11,-2,9
NaeMXcKfBQHORVEUgISPbFDWATJLGZYCd,TAAAGAAAZADA.dAHAeACEMCDBKAFCBCEAHBFC.RCCAUDGB.hAAASDBDbDGBDAEAAECBLEEBhACACEEA.aGFDhBAAfFGA..OHBC..hBCA......hBHA...,2,-15,-15,0
OBSdKVcMGgJeDFNXZPULWIYaQRCHEbAfT,TAAASAAA.dADAKACC.MAFAGAFAeBDAFAHFZBGBLDBAhAAA.IDHAhABAaCCCRDEBHEBAAAFBBCCDgGCAhAAADDFBXFGAPFHBYHFA..hBDA......hCAA...,1,5,-21,26
OWIHSLbGeYFVRdCcXNQaADUEJZBMTfKgP,EAAAZAAAMACAKACA..OAEAHAECLAHB.eCCAFAHDRBDAdDFAhABAXDDAaEEBAEHADFHBBCCDhAAA..fHCBhCAAgDGA.IGDASGGD..hCBAYFHB.CGGC.hCAA...,2,-39,-3,36
DIFWdMLgZRcYbJOaQSHVPNTEUXKfCAeGB,eAAAGAAADAEAFADAdAHAMAGBZBAE...RCDB.....bBDDaAHBHBFBhAAAVDGB..TEGAhABAEDCBKFCDABFBBFFD.hAAALHBAgGGA.cFDD..hACA......hBAA...,1,-12,-18,6
NTCYHZMGgFWIfDXBOabEPLScRAVJdeUKQ,dAAAeAAAQADACADA.HAFAGAEAFCBD.fAGBBCGAbDCD.hACAECCBLEEARCGB.hAAAAAHAUGGATEDAMCIBhADAgFGA.DGBAaGEDSGEHhABA......hAIA...,1,1,-18,19
NBWJVecTXFbQZgESCDPAaOIGHRUYKMdfL,aAAAGAAAHACBRADAKAGCdAEBLAHBBBHA.JBFFeCDA..TEDAhBAAFDCHZDGB.EEABDBBBAAAB.hACAOEHBUFEAMEIBhADAfGFA.WHBA......hBHA......hCAA...,2,-21,-15,6
IafcVFHgBMXKYeUZELDdSPGCJAOTbNQWR,TAAAQAAA.RACA.aACA..VAGBHAEBMCEBKAGAeBDD.hAAAECGAdDAAGEFAACFBbDFA.hADAIEHAFFFABGAAXGAAhAAAZGDADDDBCHHAOCCH.WFED..hAGA......hAIA...,2,-4,-3,1
QXVZFLJPTcYSHBKIMDafAUEdbCWeRGONg,EAAAdAAACADARACA.GAEA..OAFAQAGAZBFELDAA.hACATDFASCBAhADAHECCKEHBMDEBaGBAADGAbFFAhAGAeHDA.XGGDFHEAcDGD.BHHD.hAAADIBA.....hADA...,1,-2,-8,6
YgBUFRZMWCEXcDJNLSHaPAeIfKQObdVGT,eAAAKAAAQACCdAEAGAGA...TCCABAEBRAFFZDFFMAIBEDBB.hAAADCEBLEEBHCGBADDBODFHhAAAbGAA..YHFGhABAFFHDCHAA.........hAHA......hCAA...,1,5,-25,30
fIXMGAUgLHdPQTbBWOKZcDERCSFaeNJYV,LAAAHAAAdADATAFABAEAKAGA.ZCAAEBHFRCEA.FCAH..eCHHJCCF.hAAA..VEAAXDGAhACAACCA.UFAAQEEBhABAbEDDOFFCCFHAaGACfHFFMIAA..hAFAgGGG.hAHA...,2,-7,-2,5
dfZHQaOgYCUFWRLPBETMAIXJcVGNDSbKe,XAAAVAAA.GADASADB.eAFAZAFAHCFA.aDAAhAAAOBHDCEFDFEHBRGAALCDAhAAAEGGBAAGA.IEEAhAFA.cEGADDDB.dFCA.QGAAhAGAYHCG.PFGB.hABA...,2,-8,1,9
GJBCWFUHXQENYfbTIKOcLMeaSARgZdDPV,RAAAdAAADADAGADABAFA.FAFAHAGB..EBHF....fBDAhAAAbABDKCFB.LDEBhABAeDABADIBZEFAPDGBCGGA.hADAXFCB.YEHBOFBDaHECSCCDhAIA...hAIA...,1,-13,-16,3
FVGHZCOdNgWYXADRSPcKfTBJUMQEeaLbI,RAAASAAAKADCBAFA.MADA..EAHBeAFALCCAFBCDHCEAZCFBdDHAhAAA..gDGAhAAAXECA.ABEBDCGA.hABAfEEETGGA.QGGAaHEC.hAIA......hCAA...,2,-25,-7,18
XKEPAZMBVHDdTcRUJYgFeWSQGfLOICbaN,ZAAAMAAAHAEAdAEARAGBUCAA...JBHBFBBA.eCFFQCDDhABAGEBALEDBCEED.hACAaFGAKEGDAAIBBGADTGAAhADA...gGCBfGGAOFHDhAEA......hAGA...,1,-12,-17,5
JTFIdBMCNYVUKQbDPgcWfZeXOERaGALSH,HAAATAAAdADA.MAFACACB....VAEAQBFADAIB.gCAAhAAA.fDDAhACAeCCBECEBRCGBABIBLEFAhBFAFEAABEEDUFGBbFDDcGGAXGEDhAAA.aHAA....hAEA...,1,5,-17,22
HOgPfbSMeGdJYUCaWVRXDZNIBcFKLETQA,HAAAOAAA..fADBMAEAdBBDUBEAaAFA..RBEAZCAABAHAKCHBhAAAECGEAAIB....bDFDhACAeDDB.GGEBhBAACEDA.WECDDFIBIHEALFFC....hCCA......hCDA...,2,-17,-15,2
aGJCDHBOTdURXLMbeNgFZIQVPYEAcSfWK,SAAAKAAAGACADAEAHACBBAGAdAEBRAGFLBEBeBEH..FDFDZCAFhAAAQFGA.hACAPHECAAIBfCGAhCGAaCHD.OCHD.TFFAMIAA...hAAA......hABA...,1,-7,-25,18
AOdBWUNcYRICTGEbFJLMPXeZfSHQDgaVK,dAAABAAAUADA..NACA.RAFA..CCBA.EADA.FAFDMCHB..eAHBhAAAZDBEHEFBQDDAhADAaDFB.ACHBODFC.hACA.cGAATFGA.......hAGA......hAIA...,2,-30,-27,3
VCGfJAZLFQUYDXEMaIHeNSWgBTbcPKORd,ZAAALAAAQAEADAEAEAGAMAHB.HCAAeBCA..SCEDhABABBHAbCAC.KDGDRCEAdEEDhABAGEABADIB.FEHDXEGDhACAaFDEIHHA.gGBGTFCA.hCBA......hCFA...,1,8,-17,25
HBRGMUZNIPOLKVSJDdTgEQWCXeAfYaFcb,aAAAFAAAHACBGACAZAEA....IAEALAHBSAFHhAHAdCFAEEDBQFAAhAFAXBGDAAIBfEHAhAGAbDFCREDBMBBBPFFBKFHBDGGB.......hBAA......hCAA...,1,-1,-11,10
APXfWbcaVJFBIgdeQYHTOCGNZSDRLKUEM,XAAA..bAAAaADAFAEA.BAHAdAGAeBCHHBDBCCAAZCFARCFFLCHBhAAAEDEBAAAA..fEBEhAIAVFCA.gEFHhBEATGGAOCCHGGBBDHAAMFIB.hABA......hACA...,1,3,-11,14
YTdGJaFfMNgAEKVPWDQZBOURLbecIXCHS,EAAAKAAA....VADADADAZADEBAGBRAGFeBCD..XBGAhAAAHCEBTEGAGCAAaECCMCDBhACAACIB.QDGChADALGDAIHHASEDH.dGGA.fGEAhAIANIAB...hAAA...,2,-12,-11,1
cVGJdHQDBabULOXNCWfgMeASTZEIKFPYR,ZAAAEAAAFACDRAEAGCAA.HCCCQAEABAHBUCGALAHB.hABAXCDDCEFD.fDFBhAAAeFADAACATFGAhAEAKEAAPEHD.cFFCdGDADIFAOGBAhAEA.WHBA...hAFA...,2,-9,-3,6
eaTbFOHKBXGWVJYPZQcLRgMUSCAfEDdNI,EAAAdAAAeADA..bACAHAGB.XCAAGAGAVCCAJCFFZDCBLDABhAAAREAF.MDGBhADACDHAAAIBDEEBaDHDOFEBhAEABFFD..PFHBQGBA....hAGA......hAIA...,1,1,-10,11
THGLUFJNKXDPgZRcVQYBEbOIdASMCafeW,MAAAaAAA..eACHHACCGAEALAFBFAGAKCGADAHBZCCF.RDGBQEEChAIAEDDBOEABABBBfFCEhBAAUEGA.XGGAhBBAgEBB.cGBC.BFFChAEA.IHHA.hBIA...,2,-12,-4,8
KFWdQAOREUeYDSZJfGbXMPVBITcNgaLCH,EAAAeAAADADAZADB.GAFAMAGB.BAHA..TBCA..gDBBhAAAaAHBHCEBFCBHhAAAdDHAACCARDGFSEBAhBCAJEEBXFBCIHHALHAAWFBAQGFAhABA.....hBEA...,2,-18,-1,17
ScbGfCKAVOeIBWJXNTEYRDgLPadHMZQFU,eAAABAAAJACA..TADARAFF.LAFBdAHAHCBAZBGBFDEDSCCBhAAAGDGA.KEDAADIB.hAAAODHD.XFCChABAEECFDFABaGEAMFGB.......hAFA......hBCA...,1,-10,-26,16
NSODCGbeWRHYcfVFUJZEgXaLMTKPAQBdI,dAAASAAACADAGAEAeACHHAGD....fAEAFCBDZDCBEDHFhACAaAFDMDABKAHBAAAAQEEBhADABCGAODDBbGDA.hAGAREABVEFA.JFEF.LHAAIHHADGIBhAEA......hAHA...,1,5,-5,10
JMeZXGFTUfELHAYBNbIRdSKgOaCcWQDPV,BAAA..bAAARACAdAFAKAEA.OAHBCAGB..QCAADCAA.hAAAVCDAeCDFGCGAhAAATDAAEEABHEEAAAIBIFFAhABAaCHD..PFHDZGCAFGHDLGDAhACA.NIAB.....hADA...,2,-16,2,18
DaHTPXCALfENMWeOKVJUcGIZRYdSgFbQB,EAAAMAAA..eACAKADAUAFAGAFAZBBARCCAdBHA.FDABQDDBhAIABEEAHEGB..TDGAhBAACFBAAAHA.LFFAhBCA.fGDANIEB......hBHA......hBIA...,1,-13,-25,12
ZLcQHTdFfXUEAKeNBbOGWPMVSJgIDYCaR,eAAABAAAGACAMAEA.SAEAJAHB.DAHBaBCDZCAFLBEBhAAAHCEAdEEDXDFDhABAAAEAKDHB.ODHF.PECBhBGAgGCACGGA.RFGB.cGCD..hCAA......hCBA...,2,-18,-13,5
aWVYbGAcTMEUQfXKdOJgDeBRLZHCPNFIS,MAAAEAAAUADA..QADAKAFA.dAGAOAHDDAIBRBBBHDEAhBAACBCCFCFD.aDGA..VEDBhAAAGFBB.ABFATGFAhBBAXGFA...eDHB.LHAAhAHA......hCAA...,1,-5,-25,20
DgOcGHMIRCLeBPEXfUZVSaQdFYWTbKJNA,OAAAHAAARADFeAFEBADA.EBFFUAFA.ZBBAaCAC.dCHAFCHD..TEEAhAAAKDDDAAIB.DDDBGEFAhBAAMFHBLGDAhACA..fFBA.QFDAhBFA.....hADA...,2,-27,-6,21
aRETVQZgFPWfMeBYLDOGXSCKHAIcUNdbJ,UAAAdAAAaADAEADA..QAGAZAFBFAHD.....fBDAhACAeBEFLDAAGCBAhAGACDGAHFEAADFAIDHAhBAANDIA.REDATFGA..PHFCMIBADIFAhBCA.OGCC..hBDA...,2,-16,-2,14
KeBMIYQUSfFXGVObEgPNAcTJLadZDHWCR,TAAAaAAAZACB..HAEARACFBAEB..MAIBQAGASCEAhAGAXCACGCGAbCEBEECAhAHA.PEFBADEB..hBAALDGBDBBBKGHB.eFHH.IGAAhAAA.fGEAhACA...,2,-21,0,21
fCTRJBSIXHFONLMeDgAPQYdEUcabKGWVZ,QAAAEAAAUADA.aACEGAGA.ZCBATAFARDEFBAFA..XCDAhAAAHGDAOHFEhAAAMAIBeCGFAAIB.dDAA.hBCAbECB.KEHB.fFFESGGEFHAADDIBhBDAYHEA..hADA...,1,-8,-9,1
TEXKCZWMcJDYUQaBFPLefdSGbVgAINHOR,HAAARAAAEADE.CADBZAEB..MAFADAHBUCABBBFALBHB.eCCBhAAAdCGDbDCDACEB.OEEAhAAATEEA.KFHBJEHBaCFEhABAFFFH..SGEA..gGBGhACA...hCAA...,1,-14,-23,9
gTJZBYDHKVdXcQMPFeUaNCbIfWARELSGO,EAAAGAAA.OADATACAZAGBBAEBHCDBdAGAQEBDFCCH.hAAAeCHHaBHDCCFD..bFFAhAAAIEEAACDBRGBE.LEGBhAIA.SGBA...hACA......hBAA...,2,-25,0,25
JAfFCaSOEcTGLBeZNVRQMKYIgHdbXUWPD,CAAAaAAA..EACAGACALAFAeAEAZBEARBFAMBBBKCAA...IDHAhAEAHCCBdDGD.bEFCXEDAhAFA.PEGBhAIAAAGASFDHOFHD.TGGANIBB...hBAA......hBIA...,2,-14,-7,7
FJbXQVAOeDNTGBdcKRgIPEUSZYWMafHLC,eAAATAAAdAEA.RAGB...IADAEBCAZCDE.MAFAHEEALBFAhAAAFFHDJGAA.QCABhACA.ABGADCEBBGEDKDCBhCDA.gDGASDGAaEFH.bFDD.OFHDhDFANIAB....hDGA...,2,-14,-5,9
QdcMBUZEFSVCfbLeWJIgTYKNGRPaDAOHX,HAAAdAAAMADAZADBEAFAFAGD...CAHALCCDeBDB..IDFAhACATCGAKCADRCBBDAIBAEEAQEFDhAAABBEBUFFASDHBhBAAbFDD..gGGA.hBCA......hDAA...,1,1,-27,28
MXOZCVEcegIbaDYAfKSFHLJTBGNWRUdPQ,SAAAHAAATAEAGACARAGF.dAEBMCABZAGBECEAeCCB.bDADaCHDhAAA.AEEA.FCEHLFBAhABABDGDUFFAQFFAhBFAOEHD.CFHA..........hAAA......hACA...,2,-3,-3,0
PHZDRYUFTBWbQKCXMLNIgAdVGaOcfJEeS,GAAAaAAA.OADAJADA.EAGAeAGH.HBBCRCDAFBHDBCEA.QDGAhAGAXDBDMEFAhAAALEEB.gGFHhAIAAFFAdFHAfGCA.SGGDhACADIBA.....hBAA...,1,-6,-22,16
QYfHRCFKOgNcDWJTEAedbGBVSXZLMPUaI,eAAAGAAABADASADAZAEBLAHBMAGBaAHBQCCA.hAAAHCFBRCDBKCHBOEHDhAAAgEAADFFBTGBAhABAAADAbEGD.PHFCUFDB........hBGA......hBHA...,2,-5,-2,3
MLWXCcQfaTbKJFHSPYNGUeZABDERVgIdO,EAAARAAA..VAEAdADAMAFALAHB..CBCCQBFAaCCA.hAAAKBHBHDAA.SDFBhABAPDDBGEGAhAAAeEEBAADADFBBOEGDXFEDfHCBbFBD.hBFA......hCAA...,2,-14,-7,7
ISfOCBZgMDbRKdFJGNEXQLPecaYHUTWVA,SAAACAAAZACA.MADARAGBdCCA.GCFAEAGALBDB.eBFBhAAAaDABHEABUEFB.TEDAhAAAABIBOCCBDDIBFFHHhADAXFDD.QGGB...hAEA......hAFA...,1,-7,-16,9
ABKMcbLYDWGRgOfdNFCSXPeQETZVUHIJa,MAAALAAADAEAGAGARADFOAFA..dBBACBFA...XBEBhAIAeBHFECAAZDBEHDDC.aDHDhABAADGBKEFD..bGDAgGGAhBAA.fEHA.NIBB.hBDA......hBIA...,2,-25,-11,14
ZTAWFMCUIgLbKXHOdSEeQGfNBDaJRVPYc,MAAACAAAUACALAEA.KBBAHAEA.dAHAEBHFeCBBGCDABCGDhAAAaCFFRDDA...PDBBhAFAZEGBADDAFFFB..bFFAhAGASGAA..fDHAhAIADFIB.YFDF.hAGA...,1,-5,-23,18
QFGNMaKScEYbeRfDOATWIPCXJLdVUHBZg,TAAA..IAAACACBLAEAdACAHAEAZBFEFCCAGCDA.hAAAaAGASDEAhAFAECBBeCFAREABODGDADIB.XGAAhAGAUFFAQGCDMDIBKFFD....hAEA......hBCA...,2,-13,-1,12
BGEPYWROcMeTgVLKfUdFNSDZAHXaQJCIb,HAAAaAAA.QADCCADABAFA.EAFE...PBHDRAGFMBBBeCABhAAA.TCEALCCAhADAfCCEdDGDSECAhAFAAAHAXEEAbFEA.GGCBWFHH.OHFEhACA......hCGA...,1,11,-26,37
CKbLTBGARMJODNHfgISWZQYXePcUVaFEd,RAAAMAAADADAHAEC..fADASAHBZAEBQCCAhAAAeAGFUECAaCFCEBBB.dCHAbDFAhABATEFAAFFA.OFHDhAIAgGGAIHDAYHCA...hBAA......hBCA...,1,-2,-11,9
GYZDAFPIfUCMHXLKTRQBNEOebcJdgSaVW,FAAA..fAAAMADAHAFCLADARBCAQCFDEAHBeBCBJDBB.hAIAdCEA.aCADGEDAhBAAZCFBADHAIEHAXFFBBFHAhBDAbFAA..SEAA...hCAA......hCBA...,2,-9,1,10
deFMDJQPKfGOaUVgLRZCbWAYcBSXETNHI,BAAAEAAAHACAeACAMAEAQAFA.KAHBGBEB.aCCCgCAAhAAARDEBZDGBCAHAAEIBSGEDhAAATCEA.IHHAhCAAdDHADDDBfEEE.OECHhACA.LEGDhADA...,2,-20,-2,18
BPAQDdeLNbSXMGVIKEaFRZYJfHcWUOTgC,dAAAeAAALADA.SAGHGADAKAFAECBARCFAZDBB.fEFEhAAAHCEAUEAATGCAhABABDDDAAIB.QEFAhACAbEGD.MCIBaAHFYFAFWHFA..hAFA......hBDA...,1,-7,-11,4
MXVQNIZeTSBfcAbHGDEKJYadLFOCWgRUP,HAAAEAAAKACAaACA.dAFALAEBFAHB.CAGA.RCCAMCIB..QCCAhAAAZDFBeEEFTFBAhAAAfBHA.ACGBGEFAhAGADFHBOHEC..WEHB....hAIA......hCAA...,1,-2,-33,31
TVefINGDbCZdgEOLSHWRJPUXBKQFYMAac,aAAATAAA..eACH..fACBGAEAbAGBdAEA.EAGALDDBhAEAHCCARCFFPDHDhAAABDHAQEBBhBAAMEEBABIBIGAACFFAZGBASFHBJFFFKHCA.FHGC.hAGA......hCAA...,1,6,1,5
XVUbDYcJCHBfdTOZIGQKNagWLFeMPRESA,XAAAUAAADADA...JADAHAEC.dAHAZAGBGCBBQCDAhAAAaDFDLDHBeCHHRDBBABDB.hBAA.VFCA..bEFDhABACGGDBHEATFDA.KGAA.NIBB.....hAGA......hBIA...,1,-7,-14,7
eZXQVOEdRIABGJUKcMPLgCDfHNSWbYFTa,GAAAKAAAMACALADA.DAHBHAECSBHHbBCD.TCDAhAAAeAHHZDFA.QFCAhAAAEDCBREFAAAEABCFBcFFAhAHACFED..fGHAYHFA....hACA......hAIA...,2,-20,-4,16
QIGLTVHJYZKbMaXUdRgWPECfeAcSFBODN,FAAADAAAQACAGACALAEAHAEAZCCAMAIBaAGA..dCFARCGB..hAFA.PDHBEEEBeEGDhBAAAEEBBFDDOGCC.NBBA.hCAATGAA.YFFB.KHCA..hAGA......hBAA...,2,-20,0,20
DeFQLAPEWKSVJONcRagdYITMBUCbGfXZH,EAAASAAA.OACDRACAdAFATCDA.MAHBCAEAGAFAhAAAZDAAHEFAeAHBLHEAhAAAACEBKDEBVEAANAIA.aDGD.hADA..IGGABFED......hABA......hAEA...,1,-1,-23,22
QLaODgfRPXCKHNTVMBYIGeWFcUSdEZbAJ,LAAAaAAA.DAEARACFCAEBHAFC..TAGAMBEBBCAA.GCFAhABAeBBDFCFBSCCBhACAECHFADEB.QFCAhAIAfECAKCHBVEFBIFHA.WFFDhCAAdGAA......hCFA...,2,-16,-16,0
XfQUSbJRWVELKONCBFaIMGAgTdHePcYZD,dAAAHAAAeADA..PADAZABBDAHB.QCEAbAGD.RDCB.EBFFhAAALDHBOCABBCCAhACAaEABGGDBAAIBTECAhCCAXGBDSCED.VEGBCEGA.MFFBhCIA......hEBA...,2,-3,-3,0
dAcHCfTOWaMgQLSbPJIBEUDYZGeNXFVKR,HAAATAAAaACA.MAFALACB.SAEAbBDA.IAHAhAAAEBHBDCCBGDDAhAAA.eDGFFCEARCGFADDBfFBAhBFAODEBQEAABFHAYHFAhBIAZFFANICB......hCAA...,2,-3,-2,1
TQVCYDJcXfgLAaBRNFUHWKMPeIbOSdGZE,RAAAFAAAHADBMADAeAFA.OBHDGAGAECCBTBCA..QCFAhAAACBEBDDEA.XDAChABALEEBAEEAaFADBEGDhAIAUFFAKGBAIGGASHGA....hADA......hAFA...,1,1,-27,28
LfIUJeRcYOGHgSQPDdFbVKXaAMZNBECTW,ZAAAEAAA.CADBLAFAUADARAFA...OCABHCBAQCGAhAAAdCCD.FDEDbCEDKEGDAAGAMCHBhABATGAA..fFHAhACAeFHF.GGCB.....hAGA......hAIA...,2,-14,-13,1
VOIJZaQSPEcMKLDebNYCUgRTGXBFWfdAH,HAAAOAAAZADB.aAFDQADA.EAFAMAHBLBHBeCAAbDEDhAAACBBDRCEAGDCABDGDFEHDhACAdFFAAAIB...IHHAhAIASFBA........hADA......hBFA...,2,-17,-10,7
aRHIdEUKMNSfFYQGOZCeAgBDXPJWLbcVT,DAAAXAAA..PACCLADA.VBGBRAFFHCCA.EBHFMCDBhAAA.SCEBhABAFDHDGECBZEABAAHABBBDhAFAbEDDaFFAdGGAKGGDfGEAOHAE....hBAA......hCAA...,2,-17,1,18
DLRbQYXFcMTVSUdCWfHGEBKgOIZPaJAeN,eAAALAAARADA.QAEAFAGA.MAHBTCCAUCAAdCFACCDAHDEAhABAECHBBEAA.OEEBhAAAZEAEaDHD.AAIBbGBAXFGAhABA..SFGDfGFE..hAEA......hCAA...,2,-25,-1,24
HDKGTOfUMABagXRNWcEQSFCVdJeIbYLPZ,aAAARAAA....NADB.EADA.QAFACAHA.dBHAeBDA.ICGAhAAAbBBCLDAAhADAHDDAGEBATDFAfEDAhAIAACCBXEGASFFDFEHDYFCFDIDAhABAOFFBBGGB...hBEA...,1,10,-22,32
NBUKWZVcYQgdIAeOJbGCFSDPLTaMXREHf,eAAAOAAAGADAFADD.DAFALAFA.aBBHRBFFHDBB.BAHAhAAAKCEAZCGBVEGBQEEAhAGAdFEAACIBCHDD.TGCAhAHA.EFHF.NIEB........hABA......hBDA...,2,-18,-12,6
CdBYbHZIcEaVJWUgOAPTSfLeQNMRGDKFX,TAAALAAA.eADHMACARAFAGCAA.FCFHdAGABCHAHBDBZEDAhABAECHF.aCCBJEHBgEFBhAAAAAFA.fFBAhAIADHCACHEA.bFCD.IHHA.WFFDhBDA.....hACA...,1,4,-22,26
SNHMJgZAdFaBTWOILcGReKCbPVQfUYEDX,aAAATAAA..OACDLACBRAEA.eAEACAHB...VBGBQCEBhAEAUEAAEDEBSBBDhAFAHECDMEGBZCGBAAIBdFHAhAAABEED.IGEA.KGGA...hAEA......hAFA...,2,-24,0,24
XdICNHRfWESeKLAaBVZcGTJUgMQYPObFD,aAAAZAAAGAEA.UBGAMADA.QAGAOCABDAGAdBBD.CBEAHCEChBAARDDB.EDDBeEAHhABAADIBBEBATFGAJEGBPFEDhBEAXGED.NCCA........hBIA......hCAA...,2,-14,-11,3
IcGKSCTDdPfQEMJYXNLRbWaBZUAHVegFO,HAAAeAAAOADCGADACAFAdAGAQBGA.ECABMAIB.XCCAhAAARDEFaCCHZEGBACCAFCFHhABAKFAATGDADDHB.fHABhAAAYEHBbFAA.BFFA...hACA......hADA...,1,5,-17,22
PENQeMYKZcJGRUfLXBdIHSDaACbTOVWFg,TAAAOAAAFADD..EACEeAFAKAECZAGBGCDBRCCA.LCHBhAFAdEEAHFCBaBBHABGB..bEFDgEEAhAGA.QGCChBAAMBIB.cGGA...fHEFhBIA..hCAA...,1,-10,-13,3
KAZNEXTVbMYceLRBIFgHWPfCJGOUSaDQd,EAAATAAA..MADAeACERAFABBCAFAFAHCCA....fBEEhAAAGCFASAHHhAAAaCBCdCHAADEB.ZECAXDFDhAIAYDHBLHDAIHDAgGGBhBCACHHA.....hBDA...,2,-12,-11,1
JXbeHDCFYVMRfLWgcTKEPNABISZGOdQaU,SAAAGAAAdADAaAFAUADA...XAFAHBFAFDDA.MDHBhAAARCEALDBB.gDGAhAAATFBAEEFFAAIBZFFAhABAQGGBeDDBCGAD.......hAGA......hBDA...,2,-12,-8,4
ISMGFfgEaOQbLcPeCUHTNYWKRJXBZVADd,dAAAMAAAGADAFADD.EAFAQAFALBHBeCBFHBBB..TDEAhAFANCGA.KAHBRFAABFDBhACAABBBSDGBaFED.bFCBhBAACGHA.UFGB..YHCA...hCAA......hCFA...,1,-6,-9,3
YbRVdfDWUeZSLMTgNcGAPHBCOQJKEFXaI,HAAAOAAAQADCKADA.EAFEaAFAICFARBEA..dCCADAIBhAAAeBHHZCAAMCHB.hAIATEDAgEDAhBAAGGEBABBBCEHAFHAA..bGDAWDHH....hACA......hAHA...,1,2,-22,24
VHbDIGgeYBEFLRWcOSdaQTCXAKNfMZPUJ,KAAAMAAAZACBUAEAHAEA.DAGAGBBA.eAHBEBHFRCAB..OCGDhAIAaCFD.QDEAhBAACDECADIB.fEDEhBBAVECB.bGBCIFFABFHAFGGHLFHBhAAA.SHEAhACA...,2,-18,4,22
EGXdIUYNAbMeLBQWfDRgKcFHVZSOPTCaJ,eAAALAAAQADADAEARAFA.KAFAHBCCZCCAOAHDTCAAaCFEECGBGEEBhAAA.dGHAIEEAhABA.UEGAhACAAHAA.bGFCWHAA........hABA......hAHA...,2,-12,-7,5
fAFLeRBHTSDKECQGJOWcVYdIbaZXPNgMU,eAAAHAAATAEAKADA.EAGEGAFA.OAHFVCCAdCGA.aCAHhAAAZCCA.XDGDhAAA.gECAhABAMCIBAEFBREAADFGBQGGAcGDAbFGDPFABNIAB..hAFA......hAHA...,2,-12,17,29
PXIVeSQfDOYALBFUJcCKZEdMWbaGNRHgT,LAAAFAAAUADA.CAEAZAFBdAGA...MAIBaBHD.RCAA.HDBA..TDGAhABAXDFC.eEHFhAIAQEABDFBBADDABGDAhBAAKDEDEFCF.bFFAgGFD..hBDAPHCCSGBHhBFA...,1,-6,-24,18
OULYEWKcIJTCQDMXfRNPGdAZgBVSbeFaH,ZAAABAAASACEeACAHAFALAFAECAAKCDA.JCCF..QCGAhAAAMCFARDGB.GDABhACAAAGA.bEFCaEDDOFCDhADAUGGB.cGECCFFCDIDA.fGGB..hAHA......hAIA...,2,-21,3,24
JdgNWUOaCDSQPZIFRBEATHeLbcKYGXVMf,HAAAeAAALAEAKADCGAFAMAIBdBHA....NCAA.OBCC.hAAAaCEESCCAhACAZDDAREGFAAAATFAAbDCA..XEGAhAHAfHCBgFBAWFFD.DGGB.hAFAIHEA.BHHAhAIA..,1,2,-18,20
ZUNAKSVfBaObGMYDHFTQgdeLPJCIWERcX,SAAABAAAaACAGAEAMADA..HAFCQAGAeBCFLCFAhAAACBCA.EDDBRDDBZDFBABEBfEGAhABAbGAA.FFEDhAIAdEHAIGCAXCBCKGHBOHFADIEA..hAAA......hAGA...,1,7,-9,16
ZUPcCQTeWMbaAVRFBSNGEKLJfXgOIDYdH,RAAASAAAEADE.LADAXAFBOAGDDAIBHBGBZCCAUDGBhAAACCCA.eEAAMCEBAAEABEEDhABAGFDBKFCAJHFEIGGAhAIAdFCC..........hBIA......hCAA...,1,-12,-21,9
LPfKdbMNRIaBeWQDZAgHcEXOSCFJUYVGT,HAAAEAAA.SACEFACDUAEAGBGALAFAKDDAbCCA..REBBBAHBhAAAeCGBQECAhAAAZFDBAFGB.XEFDhAGACFHA.YFHB.PHAA.MIDAhAHAaGBH.DCCA....hCAA...,1,9,-27,36
LdFYZQWfPeMcOEHKUTAbRBJgVXSICaNGD,RAAABAAA.JACAXADB.CAFA.GAFAdAHAZCCAQCBAhAAA..fCFBhAAAeAHBMDFBEDHFHDGBTFFAhABAADDAbFAASFHH.aGEHDEEBFHBA.hAFA......hAIA...,1,-8,-19,11
QMGDeORYScFEbUdHBaATCJXVKWgPLINfZ,TAAAXAAA.KADA....gACBLAFB..fAHAhAAAZAEBGAGAeCDBhABARDFBSCCDECHFdDAAHECBhADAAAIBCEAAVGBAIFFAMEIBOEHDFEEHBHGAhAAAaHAAPHFC..hAHA...,1,8,-6,14
WgLJSPfHETRUVIMBYOdNQKbCeZaXFADcG,GAAALAAASADAHADBRAFAUCAAMAGBOCFEdAHAQCDAhAAA.CDCDeDADaDDCAAFADEGAhABAgDGAJFFA.hACAEFDAIHHABFHAKGGD......hACA......hADA...,1,-3,-18,15
MCEOabLFJfAQPWTDdgUVKHXeNcRSIZBGY,QAAATAAA.dADAVADAHAFA.eCEFRAGFZCAAGCGA.MDBBhAAAEDFBaCHDLFFBhAFAfEDAAAHADDDBKGDAXFFAhAAA...SGAABHHA.OGDChACA....hADA...,1,2,-15,17
PYCeaZGAbIdDFWJULRXgNQMfVKHTSBEcO,dAAAFAAAUADARADA..XAGBQAFA..MBIBKAHBHDBAhBAATCBAEDFA..OCFBhACACDHAeFDAGDGAADDADFHB.hBDALEAA.fGCASGGDBGEAhADA.....hCAA...,1,-8,-25,17
FNeUCELTfDSGRZBOQHWKdPMVXacbIYgAJ,FAAAeAAAEADALAEA.DAIBRAFAZCCABBCAHCGBdCEA.MDAB.aECAhADAbCFD...IDHAhAAAACIBUFGBCFCA.TGAAhAGAGFAB.QGGAKGDA.PHCChABA......hAFA...,1,-6,-17,11
WHIRbBaPgZeOLQKMCGUDVdTfEAFcJSYNX,FAAASAAA..XACDHACBRAEAaAHDZAEAeBHHLDEAMAFAhBAAGEAADCFB.dFDAEDDBhCAAAAAAJFFA..YDFBhCBAIHHABEHA.OGCCCCFA...hAEA......hAFA...,2,-20,-9,11
VOgZWaGMHXAeERYFUSPDbLITKBcNdCfJQ,RAAAFAAAUADADADALAGB..TAFABBCAdBEACAHB..QCGAhAAAOCHDZDDAGDDAhABAHFFCAAIBECCB.SFGAhCAAIGBA.KGFD..fECEhBAA......hBGA...,1,-14,-35,21
XgeBLHSKFIAMTQfZWYGCPDEaOJNdRbcVU,MAAATAAAZABE.GAEADACA..EAEAaAGAOAGD..dBGARCCAVDFBhAAAXCCC.eCHHhBAAHFCAFEEHAAIBfDBEhBDACFHA.PFHD.NICB.cGEDhCAABGBD......hCDA...,2,-20,1,21
HXKNFBeaJWIYfREDCSZAcVTQUdLgGMObP,TAAAdAAAGADA.MAFAOACAHBFBKAFABBHAeAHH..aCAEICCAhAAAREFADDDB.ZCEBADIBQFBChACALDBAbDFDhAHAPFEBFDHD.........hBDA......hCAA...,2,-14,-6,8
eDASOWCJbFMZBLNVdfPIEGRgYXQTKaUcH,OAAACAAAFACA.ZADBLAFAdAGA....fBBEEBCBRCDF.hAAA.XCFBTDEAaBHDhAIAHDGBABDB.SFEHhAGAbEGDBBFC.PHAAgGDAQGGBhAHA......hCAA...,2,-17,-15,2
LYVgONKBfIASDQPZCdeEGFXHRTaUMJcWb,QAAAZAAAeACEEAFEGACB.HAGBRCCAaAHDMCDB.JCEB..hAAAbCFDLDAB.hABAgDGAKDHBfFCAhAHAAAFADFFBdGDATGGAcGGAYEEF.hADA......hAIA...,1,-1,-4,3
adgDcJTPNCXZFRKAIbLGYWfSVUQOEeBHM,LAAAGAAA..fADASADHQAFAEAFAHBFCdCAAhABADAIBTCDACCCDZDEARFAAAAIBbDFAhAAA..VFFBeDADaFDDhACAgFCA.PFFBNDIA.KHGA.hAFAWHBA....hACA...,1,9,-5,14
YOKCZFPdIDWJANgRHQbcXEaTeBULfMVGS,RAAAHAAAQADCXADB.EAFAeAFE.LCCAMAIBGCABhAAAOBGBZCFBdDHADCFBAAAAbEEDhAIAaDHHTGGA.fHBBhACASGGBYEEF...hCAA......hCIA...,2,-16,14,30
NcHIVWXDdEBAOGZRKYSebaMLfgTQUFPCJ,ZAAARAAAKADCeACE.MAFALAGB..TBFAQCCA.hABAFBFBCBHBJCCFHEDCIDHAhCAAXDGA.EFHBAEEAGEFAhCBASGGDaFDD.......hCEA......hDAA...,2,-21,-16,5
MfBUXePNQKHGLTWFOIEYdVaRbZDJCcgSA,MAAABAAAeACA.QAFAHACCGAFALBHBTCCAOCAAhAAAEAHBdDHARCEBZDAACBBDSDFDhAFAADGAUFGA.XGGAhAIANEEA.FHEC........hBAA......hCAA...,1,-7,-11,4
MDfUWBTRHNEIQFKaVcJASZPXgLeCdGbYO,ZAAAXAAAeACEGAFA..bACDMAIBDAEAUBFABCCDHDEBhABAEDHF.QECAhAFAKEBAaAHD.JDHFAAAA.SGGBhAHALEEBdGGAfHBBWHAA....hBHA......hCAA...,1,-4,-15,11
AEFTCfHeZGDIVUcJSBPRKObLdgWaXYQMN,EAAATAAAHACA.eAEEGACADAIB.UAFASCCARDFAKAHB.LCFBhAAAdEAAaCAC.QFDChAHAADFACEDA.ZDGBIFHAhAAA...cFFCBDEAOFHDhCAA.WHCAMIDA..hACA...,1,4,-21,25
cfAMDdZgSeGEaJNPBHXYRUCVbIWFLQKOT,dAAAZAAAeACEEADA..aAFDJAFA.BCCDHBGB.RCAACAHB..VCEA.hACA.bDCAFDHDLFBAhADAQECATFGAACHAMFFBhABASGEH..NIAB....XGGAhAIA...hBAA...,1,-8,-19,11
NPSMOgRbCAVLGaBFDKdWTYJfcEUIXeQZH,GAAAaAAABADAKADA.dAFA..TAFAJAHB.EBBBUDCA..eAHHhADAHEEBSCEBhAFAMDABODHDRDCBADIBLEGBhAHADDGB.fFFAIHAA.XGDDhBAA.....hAAA...,2,-29,-2,27
defTSHYJXAaWNbUROMGVQZgCKBIEFPcDL,aAAA..bAAARACFGAEAZADBKAFA.BAGA.FBHDDAAA.eAHH.TDEAhAHAHDFBXEAAhAEA.ABBB.UFCAMDEBhAGAQEGACEHBEGHB.cGGC...hAIA......hBAA...,2,-16,-16,0
eVdPUaZfFBTARSWgGLNCIYcHMQJbOXKED,RAAASAAAGADALAFACADA..IAFAHCFAMCCB.bDADhAAAKAHB.ECCADDABeCEAhAAAdEFDaDDHZDAABDGA.hABAADIBNEEAQGGA.OHAAXFFAhABA.PFCB..hADA...,1,14,-29,43
ETMFJKcfGbDZHYCVRgBSWULdeXINQOAPa,EAAAMAAAKACAGACB.ZAGBHAEB.CAGARCCBSBBDLCHBeDGFhAAAXCCD.QEFAhAFAAAIBaEAAFFEBJGAAbFCBDBIBhAGA...YFHBBGHA....hBAA......hCAA...,1,-12,-16,4
MZSOTgCeAQbGLdNaRFDPcXVEJIUBHfWKY,GAAAdAAARADADAGA..XADA.EAGAIBHAHCDAKBHBZABBTDGAhAAA..eCEFhAEAAADAbFEBaCFD.FDCDcGAAhACAUFFABDHA..fDCEMFIBOHDChBAAQGGA.hCDA...,1,10,-23,33
AeSGTbNWRUHKFPQOMBcJYLVXgIECafZdD,eAAAGAAA..TADAbADA..RBGFHCDBFAFAQCCCMDABBAHBhAAAJBHBLDCD.hAAAXEGAECFBaEEBdFFAhABAAFFBSFAHWEHHKGCA.OGEE...hAIA......hCAA...,2,-15,6,21
NEQaRfWACHSFTcMVJbdDBPKXLeYgZUOIG,HAAATAAAMACA.JAFBdACA.BAEAKAHBLCCBeAFHZAGBOCDDhAAAGCGAEEEBREAA.ABEBFGDBhAAAVEGB..DFIBXFEDhAEA..........hBIA......hCAA...,2,-17,-16,1
MWaVNLcSgUHDABZPCeKEGbYfFTORdQIXJ,ZAAAeAAAEADEGADA....bAFBFAFARCAAdBHAQCFA.hABAXDBAMCEBaCFHLDHBhAAASEGAHFBAhABAACAACFFDfEFEOHCAIGHAWHFANIAB..hACA......hAIA...,2,-17,5,22
cdMfQYLSVXOBDRKWZFPNHTJIEUaeAGgCb,GAAACAAAdACA.MADAQAEALAHB.XBFBDAHBRCDB.ZCDBFCBHhAAAHEBB.JEGBECHFeFEFhAAAAAIB....bDFDhAEAYFHB..OEHFBDCB.KFDD.hACA......hBAA...,1,-1,-25,24
HTdIUJZSOcXgWGAeaVQRDEFMfLPNbKBCY,eAAAaAAA.RADA.EADAMAHBLAGB....bCCACBBDHBDC.hAAAdDAAIEAAZDDAOCHDhADAXDFDGGBBAAIBQGAAhABAfFFEKHGATGCA.SEEDhAEA.gGGAhAGA,1,-5,-12,7
VbDcfHPITMNYdOLUKFXgEWGBaQeRCAZJS,ZAAASAAADACAHAEA..TADAMAIBdCCDLAFBFCFD.EAHBGDGAhABAaCCB.RGAAAAGAbCGD.hCAA...fEEEhCBAIDAAODDB.XFECWHCA.hCHAeFCD.CGHA...hAAA...,1,-6,-15,9
BRTLEeCQIDYWdGNVFKJPaXHcZSMUbfAgO,BAAARAAAEADE.eACA.QAFADAFAdBGAGCCAFCAA.KDHB..aBHDhAAAHEFBZCEFMDABUGCBAAAAhAIATDCALHFACDGD.hACA.IFHA.NHBB......hBIA......hCAA...,1,-11,-17,6
ROHKJNFYcMUVPaDfILdZWEgbXSeQBGTCA,HAAAKAAAFACAMACA.UAGAaAED.DBEALAGBZCCA..EDGAXCCChAAAeECBBEEDGDEAhAIAAEIBRFGB.OCHD.NIBB.hBGAcGDD..fGCB.dGGAhBIA......hCAA...,1,-14,-19,5
ZDOaMWGNYVJAFKfRHePLcETCQdbgSUIBX,KAAAHAAAeACELADB.EAFATAGAdBHASCAABBCAZCDBaCFDhAAAGCEA.VEGBAAFARDGFCFFDhAIAbFAA....IHHAhCAAOHCE.MICA......hCBA......hCIA...,2,-26,8,34
FIcGAHYQUELbKBCWfDSaRMTXedgOVNJPZ,HAAAQAAAEADELAFBBACACAEA.DAHBRAFF.MAIB..eAHHdCADOCEHhAAAVCDB.PDCDhACAZEAAFDHDGEGAADCBUGEAhAAAKGEASGHBaHDC......hAEA......hAHA...,1,6,-14,20
RLCMeUAQbYJfOVHKEgZWBdNFPSTDcGXaI,QAAAJAAA.OACCHADBEAFAZAFBdBHAFAHD..SCCDhADADCDAGDDAaCFDREABMEIBhAAAADHA....bEEAfFGAhAEAKFAABFDDNEIA.......hAFA......hAIA...,1,-17,-19,2
ebdGFgOWXYHIKQJPTLUcRZNMVAfDSBaEC,SAAAEAAA.eACHGACA.OAEAXAEAHBEBQCEChAAATBGALEBAhAAARCGFZEAAMEIBAAIBBCBDbFFDdHABhABAFDHDgFFB.IGEAhBCA......hBEA...,1,1,-9,10
VREdeCTJNQFfIGWHOMZXacYDALUSKbPgB,LAAAKAAA..bACBBAEA.EAGAeAEATCAAQBGAhAAA.FCEBGCCAHDFAZFAAhAFAaBGEDCFBACCBSFFAhAIAgEAG.REFAdGEACGHANICB.fGAEhABA.IGHA.hCAA...,1,-4,-8,4
EKCYSWcARDXaLUgdMfTIHbNQBeFPOVZGJ,RAAAaAAALADB.dAFAMADA..TCGAHAFCbBBABAHAeCEHhAIAOCCHGDBA.EDGAhBAACDFDSEEDhAAAADBBXEGAfFFEQFBBFEHD.ZFFFKGDAYHAAhABADICAIHHAhBBA...,2,-4,-1,3
QFXMCWaNfBGgVHKJOSbITAZPeUYcERLdD,eAAAUAAAEADARADALAGB.dCCAQAFAMAIB.aBHDBCFChAAAGCBBHEAAODABhADAbEDDAEIB.ZECA.PDGBhAIADFFACGGA.fFHA.KHBA....hBAA......hBCA...,2,-13,-4,9
dPUaYXZRFONVgKBDJGCeLIWATQMEbcSfH,MAAAEAAA..SACAHACCdAFAaAHBZAEBRAGBOBBB..gCCDhAAADBIBGDCAeCFHhADALEEBAAIBQEGAhCAAbEGB.fECE.....hBAA......hCAA...,2,-15,-5,10
DKARbWJeacMZTgXPGEQYSFICdBOfHVLNU,RAAAJAAAeADE..aADAZAGB...TBDAXAFDECCB..QEEAhAAAFAHFdCCABDFAHEGDhABALDHBDBIBAFDBbGACMBEBhBAA...gEFA.PFDBhCAASGHHCHHA..hAGA...,1,-6,-24,18
PDIbgZMHRVLAFfBXSJdGCTEKUWONeQYac,BAAASAAAGACAEADAKAEA.UAGA..OAFCeCABQCEDhAAAaCCADCFA..bCFAhAAAZDGBHDAARFEBAEAB.XEEAhABACHHA.NEHAPHAAMIBA.....hACA......hAEA...,2,-18,-5,13
QKPWLDBbZGSeTgJHMFANVfCcOdXEYaRIU,VAAACAAAdACA...EADERAEAUCEB..QAFCKBHB.LAHBhAAABCBDGDGAeCDBTDFAhCAAHEAAAAEA.fECAhCEAOEFH.aEHDIHAADFFBSGGDhCHAMIEA.....hAAA...,1,1,-32,33
WHAKUMFZgReVYQObcPLJaSfBNGEDTCIdX,MAAAZAAARAEA..eAHHQADA.OAFCbCABLDDA.hAHAaDHDBBBA.ECDBTFDAhABAdCGAHDEBAADAFFAHgGDBhAIAVGFA.cGGASGCDNCIA.hBAACCED......hBBA...,2,-19,4,23
VJXSfKFOYdHILMNWCGAPTRDUebZgBcEaQ,RAAAeAAAZADBBAFAEADA..aAFDQBGA..XBGDhAAAKCFDOCCHHCCALDABhAAAMECBCAHBAEEADEEBbEFAVFFAhABAfGEA.dGGAIHAAWFBD..hADA......hAHA...,2,-23,3,26
WUOYMXBTcPSZgRHbDFKVIEdLCeGJNaAQf,QAAAUAAAMADABAGA..TACA.SAEBhAAARBDAHCFCbDBBKAGA.ECDFdEEAeCFAhAGAGGEBaDGEAEEA.OFFAhAIA.XGCA.cGGC.hAIA......hBAA...,1,3,-23,26
ZFJeNUQgAScIEHBVWOYXDCKdbRTMLGfPa,SAAAEAAAHACABAFBOACDDAHB..dCCDRAEAMAIBGCEA.aBHDZCEAhAAA.eEAAQEAAhAAAAAEAIEEAVEGBXEGAhABAbGDC.LGCA.FGGBNIEB...hAEA......hAIA...,2,-3,0,3
IUGaEBWAJZgDTXOFHcSPQbYCLfeRMNKdV,ZAAATAAAFADAHAFB..SACBQCAACAEAeAFHRCDBMAIBdAHAhAAAUEGAECCBACEBDFDBODFChAEA..bGFCLFFAhBHAKHAA.IHDABHDA.JHFA...hABA......hACA...,2,-7,-5,2
YSAfbIPNTdKXFEaOQWeUJGRVcBCDHZMgL,..IAAATAAAdACAFACA.EAEA..aAEDQAGA.eCDAhAAAGAGARDEABDHBHCBAhAGAZEAAMDFBLFGBhAEAAAIBbEFDKEHB.OGBA......hBCA......hBGA...,2,-19,-4,15
ICTXbAOWYSgfFGKRPNJZVQcMUHadBeELD,OAAASAAAFADDGAFARACF..PAEAZCCAQEGAhAFA.MAIBHBFCdFBAECEBhAAALHAACDGDbEECAAIBgFGAhABAKEED.NIDB.cGGC...hCAA......hCBA...,1,-6,-15,9
DaGWZRYeANUTJfCXBKPFEOVQcHgMSbdLI,TAAACAAAKACA..FAEAEACE...QAECHAGBMCAAdAGALCEBhAAAaBHDZCCARDFFAAIBUDGBhACAXFGDBDDAOEEHhAAA..VFGB........hDAA......hDBA...,1,-2,-28,26
QIYVDFJLBdfSWPTNcAbUaOCMGHRKeZXgE,aAAAMAAAHACBRACA.eAEAZAFB..EAHFQBGA.VCEBFBBHLCEDhAFAdEAASBBDhAEATDGAAEHAbFGBCFGDKGHB.hAFA............hAIA......hBAA...,1,0,-27,27
ScJHKVUFdaREOLAXGPeDBfQIbWTNMZCYg,GAAAeAAABADAQADA..bAEDTAFAZAGF.CAHBSCDDhAAAHCCBKEFAFFEHRCFAEEFBhACAAAAADAIB..IEHAhADAMEIB....gGBA.cGGChBGA....hCAA...,1,-8,-27,19
LNGQUeSFRBKXVYIfcTEdMWAPHJbaCgZDO,HAAAaAAAZACBLADB.GAFAeAEARBFAXCAA.IAHAhAAATDEAEDHBdDHAAAFBbECDhAFADDFB.QGFAhACAFFGBKBBD...........hAIA......hBAA...,1,-4,-19,15
caQgAZHKOdCFfNGMPWbLDRIXSEeVYTJUB,HAAAdAAAFADAGADA.MAFA..bABDRBFFSBHB.hAGAECABeAGF.TDEAhAIABCCDaDGDABIBZDGBCFBAfFEAhAAAPECBLGFAXGGA...hBAA......hBDA...,1,-2,-24,22
HPWCTUVKXLDOYcQBIAFgSNbREJadZMfGe,SAAARAAAEADE.dADAZAFBGAFAHCCBCAHAUDBAKCHBLEFBhAAADAIBODEBQFAAhABA.ACCBFEHHbDGDaFACeFCAhAFA..PHAA...WFFD..hAAA......hABA...,2,-21,-1,20
EDWOYbLPeIZgKVBRaXTCQHUJcfSANdMFG,dAAAGAAAEADA.OADALAGBeAGFZABBKBHBRBEF...aCDACDCAHECChAIAUEDA...JDHBSDBHhAAAABIBFGBA.DDHB.hBAAbFFDgGEABFHA......hBGA......hCDA...,1,-12,-14,2
QSZWLAfeVdgYGOBUDNJcEHKRPITXFbaCM,eAAAdAAAGADABADADAFAJAFA.HBDC.RBGF.TCBAFCCH..aDHDMCGBhACA.ZDGBAAAA.VFBAhADAOEDC.UGBAEGHF.hAIAKGEAXFED..QGGChAIA......hBGA...,2,-18,-7,11
PBWCcLgMXRJaYGbKHZEOQdSDNfIAeUFVT,eAAAFAAA..TADABADACAFALAFB.MAHBRAGFaCCAGCCAhADAHCEBEDHFdEFADAIB.fDHAhBAAAAAAVFAA.PFHDhCAAgFGA.XGDAYFCF.hAFA......hAIA...,2,-21,0,21
ZFaGMJWSXYTDAedHEBNCVLUOKfcPRQgIb,HAAAEAAABACACADBLAFAKAEA...fCAERAGFQCCA.hAAA.bCCAaCFHGCGAhACAMCIB.SECAhAGA.TGCAAEAAeEGFdFFAUGAA.OEAEhAAA.gGDAhAEAFHAC...,1,13,-23,36
AdfUPJIQHXETWDSKcLCBaNbGOgZFYMRVe,dAAAUAAAJADAHADA.EAGEDAGA..KCDDLBHBBCFA..aCGDGCABhACAZDAB.MCFBREEBACIB.hADA..ICGAhBAATFCASEHHCECA.OHFCFEGHeEEDhBCA.fGHAhBDA...,2,-32,-8,24
GfWMXecZLPbVgBECFJHNaORIQdDYTKUSA,GAAAMAAA.eADAZABELAFA.VCCAEAGAFBHD.HCDAhAAAaCFARDFBdEAD.TEFAhACASCHHAADAXFCAhBAAbGAABFHACFHAOHEC..DFFB....hAGA......hAHA...,1,5,-20,25
GNDaJEOQdUIZgTWLXFReCVHPMbcBKAYSf,SAAAGAAAaADA.EADAdAGA.ZCDA..TAFALDHBRCCAeAHHhAAAHDBBMDABbEECKGBDACCA.hABA.fDFAhADADAIBOHEAQEGA.gFCAhAHA.FGGH....hCAA...,2,-5,-3,2
PITLYOSdMNBZKGERbQUVAFecXDWCgaHJf,eAAADAAACACA.HADA.JAHB..IAEALCCA.SCFHhAAAdAGAMAIBZBBAEDHFRFAAQDDBhBAAAAFAXEECaDFDTGGAhABA.OHAEKDHDbFCC.FFHD...hAHA......hCAA...,1,1,-23,24
MVQDcLXYaZWfABFgOETJPReHINdCGbUSK,FAAAEAAA...TADARACAHAFBdAFAGCDA.SAHBMAHBQCCChADALDABaCHDZDGBhAAAAAIBODFBeFDDCCCDbGFAhADAKFHBDEEB...XGDCfHBBBGGDhBAA......hCAA...,2,-22,15,37
egCPKNADdMHVUSbZFLRXQEJGcWIYOTafB,dAAAHAAASADAZADBRAFAECAB.GAFA..ICHATCBAaAHFhACAeCCD.CCFD.KDADAEEAMEGBhAAAbDEDLDHB.hACAJECBcGAAOHBEBEHAPHEADFFBFHGE.hADA......hAEA...,1,0,-3,3
UWgdQaEJcOBbDPVGYHRKXFLSACZIfMNTe,ZAAAMAAAeACEUAEAdAFA..EAGAOAHB.DCCBGBBAHDDAREGBFBHDhBAAACIB.CDEA...IGDAhABATEFAQGDAhBBA.aEBHBFFDPFHD.KEDD..hBDA......hBEA...,2,-24,-11,13
OafRTCBHWMLFeGYXdNPZcIQbUgKADVSJE,SAAAEAAA.OACDRACATAGA.HCCCMAEAeCFGGBEAhAAAdDAAZEFAQBGAhABAUGAAAEGADGGBaEBABEGA.hAAALGBA.XFGA.NIAB.IHHAhADA...hAIA...,2,-15,-5,10
NbXUGeYdAQRScVTIaECDMZBPKHfLFWJOg,RAAASAAA..TAEAEADADAGAZAGBKBEAHCCALBGBFDABOCHDhAAA..bCCCGECBhABAeDABAAAAQFGDhADAIEEA.aGAAMBIBfGEAgFGAhADA.XGDA.hAEA...,1,-5,-11,6
MgOPKFTGAYEXULDfdCZHWeaRVQBbcJNIS,EAAALAAAdADAHAFAeADHRCBBBCGA..bAEDJDDA..SAGAhABAMCIB.OCABhACAFEGDAAHA.XCGBDFABZFCBaFFHhAAAQEEA.IFHA.KGAAhAGA.YCCFCHHAWFAH.hAFANIDB...,2,-18,2,20
TZQBWCNfUdePYHRDAbgMJcLKGISOaFXVE,MAAALAAAGACBOADDFAGA...EAFAZCCAQBGACCFBUEEBdCHAhAFAeCABHFGBACCBbCEDJHDA.hBAA..KDDD.aDGC.hBBA..TFGA.BFAD.NIAB...hABA......hACA...,2,-15,-9,6
VfKYWdDBTFZHaAbGQNCMRIgXJPOUcSLeE,GAAAQAAAMADARACA...XAFAOAFASBEAhAAAECDA.KBHBdCGDBDAAZDCAHEFBhAAAADDACDEA.gFDDhACAPDGBLHDAeHFA.fFHAhADADEIB......hCAA...,1,9,-25,34
BgfASNFJULQEOVDdGebIXMPTCaYZWKRcH,FAAALAAAEADA.DAEAeAFA..XAFAMBIB.CBDAZCAARCCAHCFBhADABCEAACCA..SEEDhAGAUCGBQEEChABAdFCAIFHAaEHHKGGDfGGENIAB.OHCEhBAA.....hACA...,1,-2,-25,23
XMZUWDPIHGLCFfRNBATcaESdVKQbegYJO,aAAAEAAAdADA..QADAeAFA.JAFEMBCBZCCA.DBIBHCGBGCFAhAAALDABFDDBRFAAAAFATFFAhADA.SFHHhBAAbFDDOFGDXGCA.....hBDA......hCAA...,1,0,-14,14
UFSDBJcCaeAVYEfMQPNLdXbRIKgTGZWHO,EAAAMAAA..QACALAEAdBBARAEAKBHBGCEAHCECFCCHBBHACEEAAAHAhAAAVECB..fEGAhAFAXFADbGFAIGHAhCAA..........hCBA......hDAA...,1,-18,-19,1
HPBgcSIYQGdaFfeTJCUbEVZMLNDRAXKOW,OAAAHAAABADB.SAEHQADAaAGAeAFA.CBBDEBHFZBFBMCABhAAALCDARCCBACHAKDHBhACAPDHD..gFDAhCCAIEEAdGAATGFAbGEADEGB...hDBA......hDEA...,1,-4,-14,10
dgHWRLebaVGSQZBCKMDENfXOJIAPTcUYF,TAAAUAAAdADA.HAFARACFLAEB.eAGBaCDEGCGAZDFEKCADEECAhAAAXDBC.OEEBhAFAAAHAPFGBFGFB.bGCAhACASGDD.CHAADGIB....hAHA......hAIA...,1,-1,-13,12
bOKFQJEYdIRHcWNCUPeSfDBVgGMTAZXLa,ZAAAaAAA.KADCFADA..EAFAdAGAHBFC....NAIA.CCAAeCCBDBBBBCCAhBAAGEDA.AAIBLFFBhABAQCECIFHAhACARDGBUGBA.SCEGfEDE.MFFBhBDA.XGGA.hCAA...,1,-15,-20,5
gDVSeLCAQaRbfOEGTMNKZFdUYWBPIJXcH,RAAAOAAAEADE.GADAMAFA.ZAFA.dCGAUBGABBBD..JCCAHDBBhAGADEEA.eDEHAAAA.bFGB.hCAA.TEGAFGDH..hCFA.PFFBIHAAXGCA...hAHA......hAIA...,2,-25,-9,16
ZDKLQHTJEfBPbOIFGNaeUWRdVSYMgCcAX,ZAAALAAAHAEAEBHFBAEA.OAFDGCAAeAHBRCCAdDGD..SCAAhABAMEEBCFFAAACAKFHBTDCAhACA..JHAAbCGDFHFAhABAaEAB...VFDA......hAEA......hAIA...,1,-4,-19,15
ecVQFCAIJSZDHaBYLKOEGfPTXbWdgNUMR,SAAAHAAAaACALAFAEADA.GCCATAFAXCFA.hAAAdEFAgCCAhABAMCIBRGAAeFHBQCFBhADAAAGA.ZEEA.BAHB.OCHD.fGGEhCAA...hAAA...,2,-7,-2,5
CTaFJNfMGUecRWSVEbdHKDOAQILXZPBYg,LAAAZAAABADBCAFAaADD..FAHB..fAFAGCAA.eAGHhABARCCA..SCFBhABAECAAHDDAOBHDACAB.hACAQEGDXDGDgEEDTFAAMFDBhACA.WFFDdGHADCIBIHHAhAFAYFAF,1,-12,-20,8
NRfIVCFbTHAOKaWdcXBSGDQePLgYEZJMU,aAAAdAAABADAGACAeAEHLAEA.EBHFZABB.MAGBRCEB..fDHAhAFACAHAFCHBHDCAABBBKFGDhAGA..XEFDhAHAQGCAPFDDYFHBJHFA....hAIA......hBAA...,1,-12,-14,2
HRZbVLUXMdDYAFBgTefOKcNaGSIWCJEQP,BAAAeAAAKADAaACAGAEA..SAFBCAGA.EAHBHBCBhAAARCCAZDFBbCGDLEEDhAAA.MDIBdCBCAAIBFFCBTGAAhAGAOHCCIGDA.QGGAhBCA.....hABA...,1,-5,-16,11
XYfZUdgMJFcebBKHDGEINCWAQSRaOVTPL,RAAAaAAAOADA..TADALAHB..fAFBdBEDMCCBFDDAhAAAeAHHKDGDHCCAEEHF.hABACBBDACFA.QDAChADASFFDXDFD.ZFEAJHBABDHADGIB.hBHAIHAA.WFHHhAHA..,2,-20,5,25
XgPcWBSCIaKGHfALUZVedDNRYFEOJMbTQ,ZAAAeAAAdAEARADA.EAGAMAHB..QCAA..XCCChAAAgBGAPCFBBDDAhABACDHAaEABHEFALFGBhABADFDBFFEHOHEEbGAAWEEDKGAA.AACA....hAEA......hAGA...,1,-3,-15,12
CMHXgaSLFBUZdPfRIcKeAQJWYGDVOTbNE,QAAAJAAAGADA.OACC..bAFAEAFE.HCDA.aAHDLCGBhADABDCDdDHARDEFKCCDhAFAACFADEABTGAAMEFBSEGDhAAAZGDAfGGBeHAA.YHEGhAEA......hAHA...,2,-7,-7,0
RDVafZdPFbMHITCUegSOBAEXYWNLQKcGJ,EAAAXAAA..NADA.LADA.QBGAGAEARAGBaCBBhAAAdCDAbCEDHDFB.TEBAhAEAeDGBOEABAAIBKDHBDEEBhAGAfGGEFGHB.MEIB.CHAA...hAAA......hABA...,1,-4,-11,7
CfVIZdWYDPeHJcUGNBMLXQaOFKEAgRbST,RAAATAAACADB....VAFAdACADAEA.HAFCUCCAGBDABCFDLDHBhAAAaCFDKCHBAEHBSFCBhAAAZEDE.PFFBhAIAeFABNHEB.MICA......hABA......hAFA...,2,-25,-10,15
UgVKWMOYdbXGDZTfHaIcLPBJFNCQSEeRA,VAAAMAAAdAEA.GAGAZADBHAFA.aCEDLBBBBCGA.FDDAQDAAhAAAEEFFAAGB.KDHBhADAODHDXEFDTGDAhAIAfGHA.IHAAcEBD.NICB.hAHASGGB.hAIA...,1,-13,-14,1
PbfYVGMKcLHCZJgXBWNDQUFIeOSAaTRdE,RAAAEAAA....bADBfACA.GADAMAGBLAHBhAAAHAFAZCFEXEFAhAAABCCADBFBQEEAhABAFFAAeDDDAAHAdGGDPEHBKGEBCHCAWHBA.....hAFA......hCAA...,2,-21,6,27
SdfJQVReXMBEUONaCWZYIbcLHFDKgGAPT,TAAAdAAAQADA.RAFA.eACEBCBAEAFEOCFEaAHDZBDA..hAAA.bCCCHDCA.KDADhACAADHAfEEAhAHAXEFAMEIBCEHAIGFALGAADGIBgGEAhADASHEG....hCAA...,2,-14,1,15
cKSLECPGFYDdJeHgTVOfWNUBARMIbQXaZ,RAAAMAAAQADCZABEKAFA.LAFB.EAHBGCCA.DAIBeCCBhAAAHCFATDGAOEFBhAFAfEEAUGGAACCBIEHAhAHAaFCHCFGDFGHDdHCB.......hABA......hAIA...,1,-8,-12,4
JYMQNDHeWRXGBKSbLVaFETUZPCfdcOAIg,JAAAMAAA.DAEAHADB.RAFAGCGASAFALDAAFBBA.EEEBZBEAhAIA.CDDAdDFAAAFA..gGDBhADAQFGA.hAIAeFEBBDFC.KGGDaCHD......hBAA......hBIA...,1,-8,-28,20
RPAIDgbJTBSHFGLCaeMdcVUKZYQEXWfON,DAAAJAAABADBHABCGAEA.LAGBeAEHdAGAUEAAZCCFECHFXDDDhAEA..ODGHhAIAREGBAAIB..IGEAhBAAbEED.SGBAaGBAMEIBKHGA...hBGA......hCAA...,1,-11,-22,11
MJDYPgOEdLVUCRKNQfFaXeBIcGZWSbHAT,MAAADAAA....PACCEADAdAGA.LBBBCAFB.RDCFQEFAhAIAaAGDeBBBBCFDGGDBhBAAZDCB.SBDAhBGAHEEAAAIBTGGA.JHDAOBHDKCHB...hBAA......hCAA...,1,-4,-23,19
MScCTdJPQZIbKEUARVaYWgLHfDOGeFXNB,RAAAaAAA......gADBHACBOAEAeAFEXBEDhAIABBGDMCCBCBGAdDHA.QEBAhBAAbDCDKCHB.ABBBVEEBhBEALEEADGHBNIBBTGEA.....hBIA......hCAA...,2,-17,-10,7
XKadBNcJfHIUeFSDOgLMAQTRGZVWCbEYP,RAAAZAAACADB.EADE....XAEDdAFABAHA.JCAAHAGD.eCCBhAAADCEBLCHBACIBGEDAbFFBhABAKDFA...aFHDfFDAhABAFGAA.OFFBMIAA....hACA......hAHA...,1,0,-38,38
XbQCNWaUAgfYRFPIeMGcSEJdBTZOHVKLD,...fAAARAAAFADAeAFHGADA.EAFAdAHAZBGBHCCBLBCDhAAAbDGB.QFAAhACACEFAaFEC.ACGBgEFGhADA.IFDAMEIBSHBAhAAABGHA......hABA...,2,-25,9,34
AEYSLgKXWDdNJCRTVIQOZPBabeGUfHFcM,EAAALAAAKACA.DAEAdAEACAGA.RAGB.....TBDAQCCChAAAZCAABBHAeCFFGCFAhABAHEFBMDIBADHA.SGAAhAGAXFBAJEEFOHECaEHD....fHFFhACA..hAIA...,1,-7,-28,21
IEAKgMYWbQfJBOHXDZVCaRcLFGdTUNPeS,MAAA..bAAAQADABAEAHAFBZAFBaAHFRBBBLBHBdCAA.hAAATEDAPCCBeFBBhAIAEDFBADHAKFGA..gEGHhABAfGEAXEDDCHHA.FGHD.NHBB.hACA......hAEA...,1,-5,-6,1
NEJQeICDURZFgXMATWSBHdVbLGKYcPOfa,TAAABAAAHACA.dAFALACBGBGAKCAAPAEAOCEB..hAAAaAHDEEAAeBEBDAIBRFEAZDFBhAAAFGHDMDEB.ADIBSEHDhBHA.bGCCfHAB.hCAANDDA.IHHA.hACA...,1,2,-17,19
PLGZEdfCVFQIRbWTAJSUcXMgYBKaHONDe,SAAAXAAA.MADABADA.HAEBDAHBeBCAGBGAZCDEECDBdDBAhAAACAGCQDAAhAAARDFA.bEFDAAIBUFFB.hABAgFCAaEHDOFEBNICB......hADA......hAIA...,2,-12,-3,9
AXbBOegKRdGEYfVNCTMaZIcHLFUPQJDSW,BAAAeAAARADAEACA....VBGBTAEAZCCAHEAALAGBFEEHQGABhAAASCAAAAIBOEHDhABAdDDAGEGA.hAEAfFEACGFAaHFE.IGCA..hAAA......hACA...,2,-27,3,30
CDFafgHYVGEXdKZbOQLeIJASWNUcRPMBT,SAAAUAAARADABAGBDADA..FBHD..aAEEHCBCGAGAdCFAZEAAhADAQBCDLEEAeCEHhAAAAEIB.NDDA..MDIBhABATGGACEGD..fFFE...hAEA......hAIA...,1,-13,-23,10
DbRGSZMOIfWJdcXLeBgVaFETHCYNAUPQK,QAAADAAARABAZAEB.MADA..OAGDIAHA..fDCAhAEAdBDALBFBeCHHhAIABCHA.aDCCEDFFHEFChAAACFGDACDAKGBAGFCBSEEDWHCA...hBCA......hCAA...,1,-11,-28,17
HZeBdMaVLWTCJYKXAGcbODFQERNfSUgIP,GAAAOAAAFADDRADA..SAGBUAFA...ICFAhAAAHDDAeBBBdDCAaBHDLBHBhAIATEEACFBAKFDD.AFFAbFGDhBAAEEABfEGB.gGGAhACABHDA.MIAA..hADA...,1,-12,-14,2
SUPbfCIGTLMBREJKYNWaQgcZVFAdHeDXO,HAAAeAAAOADCSACEUAGA..bAEDCCCAGCEALAHBRDGF.EAGBhAAAKECA....YCCBhCAAaFABQGDChAAAZEEAACCBdGCAXGGAfGEA.MFIB.hABABGGD....hCEA...,1,3,-6,9
VQKcIBSAOZPJfHELNWTCXeMFRYGDUgabd,ZAAAJAAAHADBEADELAFB..TAFAeAHBRCAAGCGADCEBUEFAhABAbDAA..dEEAQFCAhACAKFAABAHBACCBOFHDhAIAfGDECHCDMIEAFGFD.......hCAA......hCBA...,1,-3,-5,2
aVKBYMGTQLINgCPSbFHZXDWfUAcOERJed,EAAARAAAeADEdADA..KAFAMAHBGCBALCCA..ICHAhAAACBDASCFHHDDBZFAFDAIBUFFAhAAAAAHAODGB.aEHDhAFABDHATGCAQGAAPHFA....hABA......hAGA...,1,6,-23,29
AfbPOTaSFXUWEZGJMYDIgRKLQdecHNBVC,...bAAATAAA.aACAXAEA.EAHBGAEA.MAHBhAAADAAARCCALCCBhAGAeCGFHEAABDBAAAEAODHDhAIAFDGHZFFAIGBAQFECNAIACHHDSGHDhCAA..WEDH.hCBA...,2,-5,-5,0
VTDaXJeFWUYZbBCdPMEHQNLGKRcAfOSgI,SAAAVAAA.DADAaADA..eAEAFAGAUBEBZBAECAHA..dCEAECHBhAAAHCGBLDCARFFBAAAAODDHhCGATEFA.JFHB.hCIA...WFHHBHEAQGDD.hCAA......hCDA...,1,-4,-23,19
dYCcaeNEHBOLfZIFXPSVUWbJQgDRGKTAM,dAAACAAA.eADAHACALAHBZAFBFAHD..SCAAUCCAJBFBDDAARDDBGDGAhAAA..ABHBMEABhACAaEAABFAA.OFCDhACAXEFA.PGEC.....hAEA......hAFA...,2,-27,-16,11
ZdgQUENOfCGceKFTADLYWPJaMIXBbVHSR,LAAA..PAAAaADDMAFABADAHBEBRAEFdAGAQBGAhABAUDCA.ECAAOBHDhAIAGEEBeDGBTGBAACCADFFBhBAAYHEA.IGHAXGFD..hCAA......hCBA...,1,12,-31,43
aYgLeWUdHcAPRZBKNMVGObFDfQXICSJET,RAAAZAAAKADCMACAGAFAFAFD...QCCACAHA.EAHBaBDDLDHBhAAAeCCDdCHAHEDCADGABEEAhABAOFBB.fGGEhABASEGD.JHAA.....YFHBhAHA...hAIA...,1,-7,-27,20
FcgBDdfCAJYEGVHeLUbKTZaNQRSWXMPOI,EAAAHAAALADAKADCaAFD.RAGF....XBCCMAHBOCAB.hAAAFCCABCEAdDFAAAIBGDEBhAEAeCHHUFBAZFAAQFFBhAFASEEDIHHADFIBCGGA....hAIA......hCAA...,2,-15,-10,5
McVNZISaPFCKDXbHUgLWOdTYRfeBQGEJA,MAAAVAAA.ZABE..aADACAFA..DAHBHAFBLCCAdBHARBDBBEFA.hAFAEEHBAAIB...IGGAhAAAFCGHbECA..UGGAhBAAODDH...fHAB..hAHA......hAIA...,2,-34,-20,14
dRFeAaEYNWVGCQBPOIbgXLHfUDJTScMZK,EAAA..NAAAGAFAQACABAHAOAEC..bBBALAHBhAAAHDABDBBATCEA.hABAMCCBdDDDRDGFACGAaDDHYFFFhACACEGAgFFG.fGAAhAGASHAAKGED....hCAA...,2,-10,-6,4
UCYcIDNSdGgfOWTLRbeFVKXaAPHJZEQMB,HAAAEAAABACACADB....IAFASADHGAGAOAFATCCAhAAARBEFeBHFKCADAAIBZEEAMCFBhACAUGBA.DCCBdECDfGDFhAAAbFGBFGDA.aFHD......hBGA......hCAA...,1,-2,-18,16
IdUcJOVYNLKESTRMGfHeAFXbBCgQDZaPW,XAAACAAADACA.ZACB..aADE..IAFAdAGAUCBA..OAGDhAAA..VDFAhAAALCEBEEDF.REBBGEGAhABAHGBAAAIBBFFDQGDAPFHD...hAIA......hBEA...,1,-15,-28,13
AZeEcUYCSGbFIdPQVBNKfJOMWgRHTLXaD,EAAAUAAA.CADA.GACA.FAEAdAFAQBGABAHAKCDA.OCBBhAAA.MCFBRCGBHDAATEGAhAHAaEEAZFBBeEBH.SEDHhAIA.bGDAIGGA.NIDB.hADA......hAHA...,1,11,-35,46
NeTafgQKUXBWJHYCdcEMRFPGbDZAOVISL,OAAASAAALAEAeACH...aAHDQAEAKBBDBCDAHCEBhAFAdAHAECEBRDBBGDGAhAGAZDFBAAAAIEAATGCA.fDDEhAEA.XGBA.YEHBhBGAMIEA.FHEA..hBHA...,1,-4,-14,10
UcSQWKDdGMNOZTbHfLRCIVgYEBaPJAXFe,eAAASAAAQADADADAGAEBMAGBZBGBHBCARCCB.CCGA..VDEBhAAAEEFBaDHD..AAHAFDHDhABA.UGGAKFBAdGHAOEDHhCAAbFDDfHAB.....hCBA......hCIA...,1,5,-11,16
YgbSKfPGcFXWVAEIQdBOeHCMURJTaNLZD,EAAAdAAAeADAHACAMAEARAGB..aCAEZBEEDCEA..bCFAKDCA.GDFAhACAXDDC.AAIBQEFAhAAACDHAJEAB.TGBAhBGALFDBSFHBfFHA..hADA......hAEA...,1,7,-23,30
XSZIbfMAFDeNaVdUCHKcBLRTPEYQJOWGg,eAAAaAAA.dAEAHACBBAGARAEAEBHF..QBCAOBBHGCFAhAEASAHHZEDF.bCFDAAHADDIBhAFA..UGAAKGHB.hBAATFDA.PFHDWFDD...IDHAhAAA....hABA...,2,-25,-4,21
SdDfbBVWQUHePTMROCFJYEXAKNIGZaLgc,KAAAGAAAZACBLAFASADAdCAADAGABCEAQBFAHCFBeCHBhAAAMBIB.RCDB.FEBDEDCBAAGA.hACAaDAH...fEGAhAAAbECDUFFB.TGEA.CHCA....hBEA......hCCA...,2,-11,-1,10
YTcKfZDNWRXGEAgOPCHdaFLSQUBMJbVIe,OAAAHAAAaACALAEAQAFAMAIBJCCA..VBCB.eCEHhAFATDFAKCGB.ZFAADBBBRFFAEHBEhAAAAEGB.CAHA.dFFDSFCEhAFAbGAA.IHHAfGHA..hAGA......hBAA...,2,-17,4,21
IFCfKYOSZUaEdgNTAWGRJVbePMLcBQDXH,RAAAVAAAeADE.LAGBQADCHBDACAFB.KCCD.OCHDZAGBECEAdEEAhAAA...TGFAhABAABIBGEEA.PDDBhAAAMFDBDIAAFDHDSGHB....hCAA......hDAA...,1,-3,-14,11
bfaHEFODYTVIZecXLGSUWJCKPBgQMdNAR,RAAAaAAAHADB.EAFADADA...TAFAZBGBeCCBLAHBGDAASBBAhBAAUFEACGCABGGBhAAAMBEBACGB.FCFH.ODDHhBBA.IEHAWHFA.KFFA.PHCAhCAA......hCHA...,1,-7,-20,13
MPIHGEWafSURLAJFdVceZbXKgDTQNOBCY,dAAAeAAAZABBKADADAEA..QAFCBAGA.MAIBHBEAGCCAhAAAECHF.aCFESDBAhAIALEFAACCBFDFDVGEAbEBA.hBAA.....TFGACHAA....hBDA......hBEA...,2,-26,-4,22
PUDeGdTaAQgZIbHRSNCFKfMBcEVXOWYLJ,ZAAAHAAARAEA.CADBKAFAMACABAHB..EBHFOCABLDDA.UFDAhABAeCCAdFGAACCA..QCFAhAAAIHAASECDhAHAfEEAXFAA...YDHBhACADDIB.aFGH.hAIANICB...,2,-22,-17,5
IadJeSWVUXTNYQRKABgGDEFfCZOPLMbHc,GAAAEAAAFACD.ZADALAEAHBGBaAGA.eCDBSAHH.UCEAhAAATFAAQDGChAFAAAABDCFBOECFMDDBbFFAhAGAdEGDWFFD.XGGANIDB....hACA......hAEA...,1,-4,-7,3
fdAWSPGKVRLBEgaZMeFbIcDQOUJXCNTHY,SAAAGAAARADAEAGEZACB.FAED..ICFAQAGA.OCEEhAAAXCGD.TDCAhAAAHEEAdEHAAADAKEFDLGAAhABAaFHBMIAAbGECDGGB......hACA......hAIA...,1,-3,-18,15
VcZPCIWENDAMYQKLOaGXTJfSHRdbUFgeB,MAAAQAAALAEAGACB..TBBASAFEHCEARDBAbBFAhAAAFDHDBCDDZFAACBHAEDAAAEGBOFFBhAFAaDED..fDGAhADAdGHA.eEHF.PGDANIAB.hAGADGIB.....hAIA...,2,-2,6,8
KPLOeTcNbVfGIUYASWBQaMdgZHXFJCRDE,BAAAaAAA.dACAHACBFAEA.RAEAEBHFLAHB..eBBD.TDEAhAEAbBDDGDFAUFAAACGBQFCAhAAAZEGBCEDDDFIB.OCBBhBCANIAB...fFHASGFDMIEAhBHA.....hAFA...,2,-11,-3,8
NUIJWbKfMaedRSADgBCEYTQcVZHXLFOGP,BAAAEAAA.QACAZACBHAEALAHBGAEBUCAAIDEA.hAAAJDGFbCFA.MDDBeCBDhAAAREEAAAHACFFD...TFAAhACAXECDOFHDPHCAKHCAdGGCDFIBgGADhAGA...hAFA...,2,1,2,1
fNFVHcZKMOaECUYBPeQgJXWdDRGbALSIT,LAAATAAA.FAEAHACBZAGBKBDAaAEAEAHB..CCAABCCDeBEGQDEAhAAA.XCAChACAdDEAREGBABIBSGCAhABAfDGFcEDCMIDA.OEHD.hACAPHFC...hCAA...,2,-37,16,53
cPgKUXCZIFSLfNMbHYQDGREeAdBOJaVTW,dAAAOAAAaADA...TADA..PAGBKAFCCAHA.ZBDF.SAHBhACALCCAMBBBhBAAHCBBQDGAhBAARCFFACHABDHAVFGBgFCA.XFFCfEEEhCAANIEB.....hBCA...,1,-14,-18,4
XBbRedgTUJcNfQOZVDFSGaECYWKMHILPA,BAAARAAAeADEdACA.UAEAJAHB.......fAGFhAAAZCCAFDGHaBECEBHF..CEEDKFHBhAAAHDDALGAAACBB.hBCA.bEBD.TEGAcGGCQFDBhBEA.DGGB....hCAA...,1,-19,-28,9
agAMeKJPdFHZTVRLSUDOQEBXGbWfCIYcN,eAAAKAAAdACAHADAZADB.RAGFLCCADAGA.EDFFGBFA..bEGDhAAACBHA....IEEAhAAAcFAA..aEEHABFBMDIBhBHAFGAH...TGGA...SHEGhCAA..hCBA...,1,1,-42,43
dcWDRbEOFYUGPfXKCLNgeSaABMQTVZHIJ,MAAATAAAHACC.dAFADACAEAHBFAED.GAGAXBBCLCCBhAAAeCGFADDAQEEAhAGAZEEFIEHAJEHBRGBA.ODBBhAIAPFDB.CGGB.NIDB........hAIA......hBAA...,2,-11,0,11
fHAVRXMWLcYGUEZeOCSKFTbaBQINDdJPg,RAAAMAAALADBGACBEAFAeAFE..SAHHTCCABBBDQCFChAAADCFAdDFAPCHDhAIAHEFCACCAXFAAhABA.cFDAZFEAKHFAaGGC.NIDB.....hAFA......hBHA...,1,-6,-10,4
YHWRbLdSNfVMZCEDgFKJUBQaPIAeOGXcT,eAAAGAAA..TADAHADARAGFLAFBdCDDSCHH.VEEAhAAAZBGBECCB.FEDDKFAAhACABEHAaFHDAAFAXFEDhAAA.cGGAbGDC.MFCBDDAB....hABA......hAHA...,2,-16,2,18
TdAFcKIOUXCaDPRfQJNHYVgSLMEWbBeZG,KAAAOAAACACB.DAEARADF...QAGAHAFB..VDEBLBBAhBAAEAHBBCCDeBEHGEGAhAAAACGBFDBAIDHAhBDAUFAAaDHF.fEFA.YFEFMIAA.hAFA......hAIA...,1,-13,-16,3
USAWdeVXQMbFNDIJHgPGZBfKcRTLEOaCY,eAAAQAAAMAEAFAHDDADAHAEC.GCBBZBAEKBEARCGBLECAhAAAEDDACDFA.SAHBhBCAAAAAdDHA.bGEAIEBAhBEA.JFFB.BGBA...fHGFhBGA....hDBA...,2,-24,1,25
SPVTEHFbGQDNAKLfWaMeJBcURYZCgdIOX,LAAAaAAA.eADHBADARAFAZCABdAFAXBBC..SCEHhABATCDA.HCGBhACAGBGAQFFChAFAAAHAfDAEMEDBcGAACEFAOEHD.EFBADFIBKFEDhADA......hBAA...,1,-2,-25,23
JHQLMEYdgAGZVaIOfReDCXKUFPWBNSbTc,ZAAAaAAA.OACARACF.DAGAKAEC.FAGDBBEA..SBBDhAIA..bBFDTCEAhBAAHDDBMBIBECHFdECAABHBIFGAhABAeEEBXEGAPCCBNIBB..QGGChBIALHDAYFHBhCAA..,2,-15,-10,5
OYWKEfJPAdaVFTeCIHZQGDSLXcgMbRNBU,aAAATAAA..eACHHACBGAEALAEAXAGAMAIBRCEABCGAhAEAOCABKDDB.EEEBfDHAhAGAAEGAdFCACEHAZGFEQEBChAHASFAHbFFA.......hAAA......hACA...,2,-7,1,8
MIgeJNGfLCRYZOUQTPXESaBAVWDKHcbFd,DAAAHAAAFACDdADA.MAFAeAEAGBEALBHBRBGBZCAAUCEA..TFGAhAAAEEAABCGAABIBKGBA.hAEA...bEDCgGEBhACAJFGB..NIAB.......hAFA......hAIA...,2,-26,-2,24
PGTXBKMbWRdHgfEcFaSQLADJeOUVCNYIZ,eAAAOAAACADA.....IAEAGAEATAGAKAGA.MCCBhAAARBBAHCEAECHF.aCGALDDBhABAADDBDEEBUFFAVFFAZGAAhAGABGAAdEHA..........hAGA......hAIA...,2,-14,-13,1
SfJHMFZQICRGNbTaUVABPLdgXDeKcYOEW,LAAAdAAADADAKAFAOADD..EBDBSAFAHCACZBFEQDFAhACARCAAGCEA..bCGBhABAaEBCAAFABFHA.XGDChACAeEEB.cGGCfGGA.MDIBhAHA.CHED....hAIA...,2,-20,-10,10
aLZKNPReTVYdDFUMbQBSOXIHGcJCgAfEW,EAAAaAAAZACBKACA..RAEF.eAEA...TBGAdAGAFCCB.MAIBQCEChAFAODEBHDFBhAAAGEFACDHD.AAIBLEHBhBAA.PEDBDEABbEADBBBDSFHHhAEA......hCAA...,2,-20,0,20
JfNGBQWFMLeUZaSKPHOcTCDIVRAYEXdgb,EAAAdAAAJADAGACA.QAEAMAHB.eAHBaBDC.KCBDHCACTDFAhAAADAIBRCFB..ACHBXEAAhAEA.bEDDBDEDhACALFFAZFFAOGAACGBDIHHAYHFAhAGANIAB......hBAA...,1,19,-24,43
BfTOSXGVMIgCbaQRUHJFeZANdDWKLPYEc,dAAAKAAALACBEADABAFA.OAEAGAGA.MCCACAHA..QBEChAAAHDAAeDDEACHADDGAPEEBhACA..fECAhCAATGFASDHHXEEAgFGHhCBAaGDH.....hADA...,1,-9,-21,12
VZPEdTKQcDGCbWRBHeaSUIOJgXLFMNfYA,ZAAAEAAAdADAQAEAGAFA.CAGA.RCBBHDDB.eAHBaAHDUCAA.hAAAOCDCXDGDMDHBhABAfFAAAADA.hACATGGADDIBbEEB.SGFH.IHHAhDAA...hAFA...,2,-13,-6,7
LgUSEKRQePJICVHFabXMOBGYDZfWTcdAN,LAAASAAARADFeAFE..IADAHBFAaCAAMAFAGDDBhABAZBCETBGAADHAUFGA.EDDAhAAA.QDFDhABA.CFGDbGBA.BGHADIAA......hBGA......hBIA...,1,-12,-13,1
BCeEOJbULQRVagKfYPTGdMASXWDcIHZFN,XAAADAAAHABCZAEBBADAEAGA..OAEDUCGAREAA..aAGAKEEA.hAAA.fBGAhABA.TDAAdFHAACCBSGDAhAEAIDDACCHAeEFA.bFEC.QGBAhADA.YFHBhBGAMIBA,1,-21,-30,9
AZREQDMVWdgYBXUfHPceKLISbCJaTGOFN,EAAAMAAAdADABADA.UAFAHAFA.eBCDLBBBSCEH.hAIAbCGDaBHD.GDCAhBAAFDBHAAHARGDAQEEChBFADCIBgFAGfEHAKGGC.CGGDOHBC.hAAA......hAFA...,1,-3,-12,9
HSNbPDAOMfaEcUQdZTReWKGYFJICBLXVg,MAAAEAAAUADAZABERAEF..eAFAGAGA.FCCBCBCCLCGB.hAGAXDDAHDFBbEDBABIBOEHDhAAAaFHD.dGAA.hAIATGDA.KGGD.......hBAA......hBIA...,2,-16,-12,4
FPfcWZaVRbYeEHUgCNMdOIQSLJKXTABDG,GAAAFAAA...fADAZACBRAEAeAHHHAEBCCED.dAGBQDFDhAFALCHBXDDChAAAADIBDEEB.cEFBaFGC.hAHAbGDAEGCB..NDAAOHBCIHHA...hACA......hADA...,1,3,-24,27
AdYHcGIDJbUBSFeKQRZXCEVMgOWNfLaPT,HAAAGAAADACAUADAFAEDKAGARAFAZCEE..ECCBMCIB..OCEEhAAA..fEFAhAAAaCHDAEEAdFFA.IGAAhACABGAAeHCEQGGACHGA.gDBHhAGA.NIAB.....hAIA...,2,-23,-14,9
GEReDVXQHcBMbTZIYPNJKfgUdOaCFAWSL,LAAARAAAeADE.XADDHAGBMBEB.ZCCFIAFA..hABAPCFBKAHBUCAAaDHDAAAAhAGAGCFAEFGB.QDDAhACABHEA.bFGD.YHAA.fCHEhAHA..hDAA...,2,-17,-12,5
KeaQDSBHcRFZMTUNLCAYEdJPWfOGgbIXV,EAAAdAAAJADA....fACAGAGA..ICCAKAEAeAGHhAAAQCECBCDAHCEBhAEAREFBZGAAMAIB.TEGAhAGALFHBADCBPHDAODBB.....hCAA......hCBA...,2,-18,-14,4
QbARGaNIOCPJeKFcUYdLSZXgEHDWfTMVB,RAAAaAAAOADA..CADAeAEHFAGD..UCCAdAGAZCCF.ECHFHDFAhAAADBBB.TFCABDADAAIB.hABAGEEAIFHAKEHB.hADA....cFFCSGBA..hBAAWAHHfGHEhBGAMEBB...,1,-19,-28,9
BKIVdYPfcbZHDagNGUSCTAREeMXOJWFQL,EAAAeAAA.MAEAOACCFAHD.LAFBBBCAKBEAdAHA...fCCAhAAAZDDAHEBAaDGAGDGAhAEACEHD.RECAXGEAhBHAQGBB.IGGA.....hCAA......hCBA...,1,-13,-16,3
XgOdCKTYfPaZbAGEJHMUILNeWRcSBDVQF,EAAAHAAAUADALADB.eAFARAFABBCCQCABFCGD.OBHDhAAAdDDAKEHBTDEA.hAAAfEGAZFDEACIBMIAAhAGAIFAA.cFCADGHB.XGAAhACA.CFHA....hAIA...,2,-34,13,47
bVGUXgecHNDOWLfREQMPSaAKYdZTCIJBF,dAAAZAAACADBBADA.FAFAGAEA.UBGAeAHHHCAAOBDELEDAhABARCAA.EEHBMDEBaGAA.hACAADFA.KGGA..TFFAhACAIHAA..bDFA......hADA......hBAA...,2,-33,-9,24
JWAfKQdFPZISGgcXYbeORVBELNTUDaHCM,QAAAdAAAZABBGADA..XACAeAFARCFAEEFBTAFA.aAHDhAAAHFAAMCDBAAFAFEHBSCEHhADA.gDGAhAFAbGCABGHA.LFFADDDB.CGDAfHABhAHA.IHHAhCAA.,2,-17,-1,16
fbJdZcCDFGLSEIBWPTeRMKNgHQYAOXUVa,XAAAaAAA..JADAZACBDAGAGAEA.EAGABBBD.TBGAhBAARCGBMDEB.KEBAHCDAhBDAAAAAOFFBVEFAdFCAFGAASGHBhAGA..IHHA.hBEAeFEB....hBIA...,1,-4,-29,25
MPQVXFWdUHIfECZTNbRGJOgABeaDLSYcK,eAAAaAAALADA..SADAKAHBMBBB.QAGAhAAAFCCAdCFAHDGBECCAZCEB.bDFDhABAREAAOEEBADEBDDHBPEAAhAEAXGGAUGAACHAANIDB.......hAGA......hBIA...,2,-8,-5,3
CYVDgEaOAbKGTBLfHPURFcNJeWMIZSXdQ,GAAATAAA.LADAHACBRAEA.FAHB.JCDAeAHH.MCABZDDAdDHAhAAAQDEACEAD.DDIBhAAAEFFBAEDBbEADBGCAfFGAhACA.cGCAIHEASGEBhAEA.....hACA...,2,-30,15,45
JbgHXFeUPVcYaIBNRSKfWLDdACGOZEMQT,GAAAEAAA.MADATACA..JAGBHAEBeBHHVCGB.aAGABCDAhAAARDDB.fDCEhACALEABACCBZEEAQFGBhAAAbFBCFGEDUGGBcGBD......hAEA......hBGA...,2,-3,0,3
SMZOIRfEYdAKUCDQLBTHPbNJGVeFcXgWa,CAAALAAAHACA...bADDGAFA.eAHBXAFAaCAAZDDBRCABECFEhABAAAEADDDBBCCC.TEEAhACAPDHB.JFFBFDHDhAFA.gGAAMECBIHHAdGEDKHGANIAB..hAGA......hAIA...,2,-4,0,4
ZbFEAHCWPDVgNQXGMIBUeYKdTRfacLJOS,HAAACAAADACA.VAEA..QAEAGCABMAIBBAGAeCGFdBCARCFAaDEDhAAALECA.OEGDhAAAbEAAAACA..gEGHhAEA.IHAAKGFD.fGHAhAHA....hCAA...,1,-1,-37,36
CUeBKGMQPWbZgNDcYSAFTHRJVfXIadLEO,HAAARAAA.VAEAXADBdAHALCAAEAFACAHA.eCEBGCCA.MCFAhAAAQDGA.hABAbEAAZEFADEAASFDHhCAAAEEBTGDA.fGGAaFGCBHHA....hCCA......hDAA...,1,11,-17,28
IgQTHbaVcPNLOREAXUZBSefWGFdJDMYKC,ZAAAeAAAGAEAdAEAMAGBCADB..QAGAHBCBaAHB...PCABhABALDFA.EEBBACCBBDDAhACAfEEEFDGADEGBhAGAKFHBIFHATGFA.......hAAA......hABA...,2,-21,-12,9
PRdSUBAKJbNeWIZaHQOXMVGfETYFDLgCc,KAAAJAAA.eACEZADBHAFA..QAFCMCCBGCGAEBCFTCGAhAAADDABLDFD.CFCA.hADARDDAdFFABGHAAAHAbFGDIHAAhAHAaECH..........hAIA......hBAA...,1,-8,-22,14
RANWcIgfBTLKFdEVZObXPHSYeCMUJGQDa,...NAAA.IAAABAFALAHBdACAEAEAZAGB..XBBAhABAHCDBeCBBMBEBGEAAhAEAaBFEABBA.gDGAhBCA.TGCAFDFBbDADSFFDCEGAQGGAhACADFIB......hADA...,1,12,-26,38
STOZWJAHBPFIdaRVMCEgcNeXQYUbKGLfD,HAAAFAAAdADARADFMAFA..EAFA..gBFAeAHFQCEAhAFAUCABGDGALDBBhBAASDDDZEEAACIBBEHBhBDAaEEDCGBAXGDA.KGGDDBIBWDDD..hCAA......hCBA...,1,-5,-12,7
GDaSKPWbeCEIRBMTXcVUFNAHZYLOJfdgQ,HAAAZAAALADBOACAdAGAGAFADAIBKBEB..bCABECCBBAHAMDGBhAAA..TEEA.hBGAXEGDcEDBFDHBhCAAAAFBfFDEaFFH.SDHB.hCDAeHAACHGA.IHHAhABA..,2,-19,1,20
cPfRITWYaNEGFCAgJbOBXDeSHKVUdMZLQ,JAAABAAA.eACAHADBKAFAdAFBZBFELCGB.QDAAhADA..fCAAhAAARDDATGBAaEHDECCAGDEBhACAAAIBOFFBSEDD.MFFBIHHAhBAAYHAACGDB.XGGAhADA.,1,2,-34,36
JWCDfeHFUISVbZGTOMEYgBAXcaQLPKdRN,aAAALAAA.dAEARACFJAEADAGAHBFB.FBHFSAHBZCAAGEBAhABAMBBBEEDA.BCEAACCAQEGAhACAKCGA.CFFD.hBEAeECA.IEGA.bFFA.TGCAhBAA.....hCBA...,2,-22,-6,16
YZEWLJKDfSdRcUOPIMbGVBHNagCTXeQAF,ZAAAEAAALADADACAdAFA.RAGF.OAHB..MBCBGBDAHDCBaCCHhABATEGA.eEABhAAAACIBFDFDJFEBKEHBSGGAhAEAUFBA..IGGA.BHEA.hAFA......hAIA...,2,-24,-8,16
JCdMOQPNZFaSXUgVDWeGYHALREcKTBbIf,EAAATAAABACA....IADACAEAdAGAMAIBQAFA.hAAAZCAAaCCAXCEChAAAUDDBDDGBeBHHHEABREFBbFAAhACAODHBFFEHSHBG.WHFAAEABKGGDhAEA......hBGA...,2,-27,15,42
DcWKXJLFaGgMYbPfVIBeAERQTONSdHZCU,RAAATAAAOADA..dACAHAGBZADBDAGAKBDALDDAGBFA.MCCBhAAA..bEED.fBHEhAAABDHAEFDAQFGAhABACFBAUGGA.XGBCaFCD....hAIA......hBGA...,2,-16,-8,8
ZDEeOINHMFdCJbRAKgGLQUWVTPaYSfBXc,GAAALAAAQADAVAEA.aAFESAHBBBHAZCDAEDHBeCAAhABAODAHHCFCdDDACEEARFGB.hAAAACAAKEAAUGCA.TGAAhACAfEGE.DEIB.MFFBFGFH.gGGGhACA...hADA...,1,6,-1,7
XIgCOfBFcQSDJKAUTPaVbMREGZNHWYLde,TAAAaAAA..MADAEACEZAEBHAFC.LBBAeAGF..XCCBhAAACCEABCGDQDBAhAIADAIBACHBVEAAGEEAhAEANCIAdEEAOFHHFDHDSGHBKGFB....hCAA......hDAA...,1,-2,-7,5
DOBHKaXTEeNJQdWGICgYMfALSbZVRUcPF,LAAAZAAARAEAUCAAFAEA.BAHAHCDAKBDA..aAHDECAA..eDFAhABAQCFAGFABCEHAMCIBhABAAADA...bDDDPFFBhACADDDB..TGFA.dHABIHAAhAFAfHDBSHGAhAHA..,2,-28,0,28
KdHVCIWfAUDYRgSQMEcLOTGeNZXbBJPFa,DAAARAAAQADCEACA.LAFBGAEAeAGBZBGBBCCDFBBHdDDAHEDAhAAACAHB...fEHAhABAACIBUEBA.SFCDhAHAMEGBTGDAXGGA..bFGD..hBAA......hBEA...,2,-17,1,18
OgHGWVEBeaYDKcMdNCSIXUFRQPJfALZbT,ZAAATAAAHAEA.GCAAEACEBAEBeAHHDAGAMCGB.dCCDSBEAhAAAXEED.RBGFQCCChBIAfDHAAACAbEEBOFDHhABA..gEGAaFHDKGADCHGD.FFDB.hAEA......hAGA...,1,4,-8,12
ILDUKQbWaRVXTgZPeOJGBYfSACcEdMHFN,EAAAHAAAFACDLADB.KAFAQAEAaAHDRCEF.TAGAZDGBeCAAhAAAGCDABFAASCGAhAAAAEGBdGCAMEIBDEAA.hACAbFFA...WFDD......hAEA......hAIA...,2,-20,-7,13
PSQIZAcUYOgGCVBHMKXLdEDTJWFfabReN,UAAAOAAAGADABADAHAEBMAFA.LAGBEBFE.DAIB.TCCAhBAAFCHDaDAA.RDEFeFHBhADASDGAZGDA.ABBBgEEBhBGAKHBA.dFHA......hCAA......hCCA...,1,-9,-21,12
LNXCMUEHBDRaYJGbQOdTWAfSIVZKcPgFe,SAAAZAAAKADC....PAFCeACHLAEA.CBHAECEAhAAAHCAARDEA.aCEAGECAhABAbCGDdDEAAAFAIFGAhAIA..gGEAFGHD.MIAADIEA.hCAA......hCBA...,1,-11,-16,5
MbRBANTfHYFWegPQUEaDdSGVIZXCKJOLc,TAAAHAAAFADA.eAFHQACCUCABDAHBGAEA.ZAGBKCHBLDDBhAAAMDDBBEEAAAGBfDHAhAEA.gFFBhBIAEEGBdGGDSGDAXGED...hCAA......hCIA...,1,-7,-24,17
HWPbKSfAcNQZRJTFYXOEBDIeUMLgCVdGa,QAAARAAAFADA.OACCEAGADBIB..eAEEMCCALAHBhAAA.CCDAGCEAHCECbEEAhAAAfDCEADDBZGAA.hABATEGABGGD.gGCA.aGGCWFHHhAGA.....hCAA...,1,-12,-20,8
GQaEAIVdNeMYPJRCUZTKbSXcLgfDHWOBF,dAAAeAAAMADA..PADCRAFAZBDF..KCBAXAGBLCFADBIBHEFAhACABCCAFGHBGCEAhAAAEHCA.ACEBVEGB.JGCAhABACHEA............hCAA......hCBA...,1,-18,-20,2
MeLbWYFTgBNKSARJZEDcaQUIOVdPGXfHC,RAAAEAAADADA..aACDQAFAUAEA..OAGFdBHAGBDAHDDAeCBBhAAALCCD.bEGBhAAAFDHDBFEASEBDhAIAAFIBZGDA.IFFA.XGDCMIAA.hABA......hAIA...,2,-11,-6,5
EeVFDGWdSbfYgNcCQLZaKTMOUXBJHIPRA,EAAAeAAADADAdAEA...SAGA..bADA..fBCAhAAAgBCGCCFAZCGBhABAaAHBMBIBXDDCHCEBhAAAREBBAAGAGDGA.YGDAQGEA.hCAAKGHB.....hCBA...,2,-19,-8,11
BMRAOIdXaNZCGVYPeFLEbKcDWQHSfJTgU,dAAAaAAAZACBGADA...VAFAeAEAECBFKAHB.DBBBHDEB.SCGAhACATCEABCGBhAFAAADBXEGBCDHAFECALFFAhBAAbFAA..QGGBfGEE..hCAA......hCCA...,1,6,-29,35
TLOIbQXHeJgZYWacVMFNdAKPESCUGDfBR,EAAACAAAGACABACARADFLAEA..OAFAQCACHBFAeCCBhAAAZBFEaDFDMDHB.dEEAhBIAAAFASDHBhAAADDIB.TFGAbEFD.XEDD.YHEAhACA....hAIA...,1,-12,-18,6
fKWDIeRgAGBLZbPUMEHdOVTacFSNCXJYQ,GAAAZAAAUAEAHADAdAHA.TBGAFCAA.CAHB...JDAFQCDBhAAA.KDFADDDARFAAAAFALDGBhABAbEFA.EEEAaDAHhACA.SGGB..XGBAhACA.fGFEhADA.IHHA.,1,11,-33,44
MFeJTAUDGXfgbQIBELOcKCZNRdHaPYSWV,GAAAXAAA..bADAQADA.EAFALAHBKAHBZCDARDAAhAAAHCDA.aDAHSCGBhABAMDCBeEFAADAAfEEAhADABFEDCFHAdHBB.PEHD...YFGFhCAAFGGH...hAAA...,2,-4,-1,3
ceOIZLFRPGSgCTJHAWKVBDdXbfaUMYENQ,KAAADAAAdADA..XACBaAFA..MAIBEAEA..QAGAhAAAeBBBZBEBRCGBGCCB.hBAACDGAHFCAADBBBDDCbEFAfEFAhBCANIBB.OFHDFGGB.SGCAhBDA....hCAA...,1,-1,-28,27
NYMFPcZCTdeHSULbEXRDgfOGBIVaKQJAW,...NAAA.MAAA.FADDZAFAdAFAHBBALAHBECEARCGB.DBBB.OCBDhBAAGDAABDDAaDDCQFFChABAABHB.YHAGhACACDFAeEFAbFBA.....fFHAhBCAIHHA...hADA...,2,-27,-9,18
YVETWbMdIBcQNLfHASJaFXROKPGZUDCge,aAAARAAAKADCZACB..CAFA.eAEA..EAHBTBGA..MCCAdCEABBBDhAFAQCFALEDAhAIAHDDBADIBFEHHODHDhAAAGGDBDFGB..YHDA....hABA......hAIA...,1,-11,-28,17
SgUFTBGKLRVPWcHYaDOXAdEbQfNZCIeMJ,EAAAQAAAZACB.eACAMAFA..SAFAFBEAGBGARCDAVDAAhAAA..cCEChAAAHCGBaEFHXEECAAIBbGAACFHAhADAgFGABHHA.LCBD..hBCA......hBIA...,2,-15,6,21
BfaGRSEZXTKMNJdOFbCLeIHYcDVWgPQAU,BAAAGAAAEACAZADAKAEAMAEA..dAGAFAHDLCAAHCDADDCB..hAAAVCEB..gDFAhACAAAIBaCHD.RFCATGGAhBAAOECBeFGB.IHDA.WFHBhAAA.....hBCA...,2,-22,-13,9
aGSOcBPbFgWKLAQYdDeMNCJfITERHVUZX,dAAAeAAAMADACADA...JAGBTAFA.HCCAZBDBGDBAOAHDBDFAhAAAFDGDKFDAACEAQEGAhABADAIB.fEEEhAFAEFHF.........hACA......hBAA...,2,-36,-16,20
ZDOMGBVdQYcbUIXEWFfRJgTCaNKAHePSL,HAAAeAAALAEAZADBMAGBGCEAdCCAQCFA..bCGDXECAhAAAEAHBFCAHRFBATFAAhABAaCCB.AAFADAIBBGGAcFEDhBDA...IGHA.WHDAhCAA......hCBA...,1,-2,-17,15
NSVLeIEcgFfbPdHOBMKWCaRUQGYADJZXT,ZAAATAAASACE.LAFAEACEFAEA....bAGDHCCChABAMCCACCFBRCGFGDDAAAGAXFEAhCAAeFGBIGCAhAAA.fHEFOEHDBHHD...hAIA......hBIA...,2,-15,-12,3
cdLWDOUINTMEQKVJCHaFbAfYRPZeGgBSX,RAAAeAAAGADABADA..XAFAdAFALAHBOBHDUCCA.TDFAhAAAECCBQDAChAAA.KCFBCEHAHFBAhABAbEFCAGAA.fFFEZGAESGGADGIB.IHEAhABA....hADA...,1,-5,-17,12
JedPYbSZBUGXHAOCRKVWMcgQEaLNDFITf,RAAAKAAAMADAQACC.LAEBFAGDTBDAeAGB.dDGD..hAAAbCFAZECA.GGCBhAHAHEEAAAAACDDD.VFBAgGGBhAIAECCBaFHD.DIBAfHEB...hBIA......hCAA...,1,-3,-4,1
BdCQgRUVOAYFEJGeWbNZKIHTMXLPcafSD,EAAAeAAA....bACAZADB.HAFA.MCCBLAGBaCGDDCIBdCCAhAAAQDEARDABOCHDAADAhAIAFFCDGEDAKFGAIHAAhAAATGBAXFFB.fHGFhBGACHHA.....hABA...,1,7,-17,24
QecALSPCWBUKbGEZROXNJIafDgMdVFYTH,LAAACAAABACA.KAEAEAEARAGF....XCAAJAGB..aBHDDCFBhABA.dDDAFCAAHEABeCEBhAAAACAASCHHhACA.UFFAZEAAOEEHfGDAMEIB.TGFAhACA....hAEA...,1,-12,-36,24
NeVUWZMadXTACJDOEIHFcfSYbRBgQLKGP,DAAAEAAAHACAFACD.SAEERAEABAHB.LAHBGCDA.eBGFUCGAhAEAZCCA.dECAABBB.OEEBhAAA.fFGAhCAAbFAAQFFAKHEA...NIDB.....hAFA......hBAA...,2,-31,7,38
FOZESbXcWBgTRLDaQGedKANVHUPMICYfJ,HAAAMAAA.CADB..JAFAZABE.EAFA..XBDABAHARCCALCFBhAFA.aCHBeCABACCAUGGAhBAAICGA.FCCHhAAASDHHbDFA.cFECTEDA.QFGChACA..hAIA...,2,-22,-16,6
HFCXdOIZbTQefDYPEKMgANcUVBJGaWLRS,UAAABAAAaACARADAHAGB.FCDHdAFA.ZAGBQDAAeBCB.DDFBECEBhAAA.MBIBAADA..VEGBhAGAGDBA.LEEAhBDAXFCAbGEA........hBFA......hCAA...,2,-19,-12,7
TQKgcbUEWCMGRHNXDZVaJeBPAOISfFdLY,SAAAdAAALADAQADAKAHB..bABDEAFA.MAIBHCEAhAEADBHBaDGEeCCBBECAAAAAfCFAhADATFAAUFFAhAFAGEDAXGCAZFFBPFHD...hAHA......hBAA...,1,5,-10,15
gRWdOVJYFCZASKQcUBGLITDfbHMePXEaN,QAAABAAAGACALADADAEAHAFCeAGHECAB.aBHDRCEA..dEEDOCBEhAAA.JDEBCDHAAFCAKEAAhAEAUGGA..TFGAhAFAMIAA.XFCD.NIAB.....hAIA......hBCA...,1,-9,-21,12
GWSfOeZUaMYFQTKVdgbcRDINPLAEBHXCJ,HAAACAAAGACASACE.eAEHaAEAMAHBQAGAKBFDdCAAbCCDhAAARDFB.DCCB..IGHAhAAALDGB.EEEEXEBDhACAfGAAOCHDZGCAFGHDTEDA.hAGA......hBIA...,1,9,-13,22
ZFSTcDHBWOGeCLQXYPNaRJEAdgVIMbfKU,dAAAVAAAMADA.KAGAZADB.FAFD..TBDAHBGBODAB.hACAeDCBLCGB.hAAAQCBDXEEAPEHDhADAREEBACIBbFBBSEHHBAHBCHHDNICB.EGDB.hCAAIHHA..hAIA...,2,-21,-1,20
TRdAYQFUcZfECgXKMIODLNSGWPbBeVHJa,QAAAFAAAZACB.EACAXAEA.KAHBMAFA.DBEALCEAhAFAGBGAbCDBeDHFHFDChAAAaEEARFCAABIB..cGCChCAACGGDOHACSEHH.BDFD..hCGA......hDAA...,1,-6,-19,13
GCOWMLARfcHgNXFKZdaUETeSYJQbIVDPB,RAAAHAAA.XADBZADBaAFD.EAFA..eAHBSAHHQDAAhAAAbCAA.DCHBGCEA.hABAODGDMDFBACCAfGCAhAAAgEGAKGGDdGDA......hADA......hAIA...,2,-21,6,27
FcXQYMIGgOVPANbfHUdDESCJZWTRLBKae,...bAAAHAAA.dADAEAEACAFAZAGBRAGB.LCCAaCAA.eCABXCEAhAAAMBIBGEEAhAAAODDBAAIBUFABSDHHhABAJEHFBHHDFEAA.QFEA.gGGBhACA...hACA...,2,-5,1,6
eRBNJPYGbKTUOQCFSfgcVAILXaEdDWMHZ,LAAAEAAAdADA.MAEAHAFARBCA.BBCC.JCEBGBFA.bCADTCGAhAAA.UEGBQEDAhABASFAAfAHAhACA.gGGAAAHAaFFHDDDB.eCHHhBFANICB......hCAA...,1,-12,-16,4
WaeQXYEKZAPbVcBHNTDOJFgMfRUdIGSCL,VAAAHAAATAEA.OAGDFADAMAGBRCAAdDEAGCDALEAAeAHBhAAAQDGBEDGF.hAIAAACAbGAABDCC.DEIBfFGEhAAASFCBaGHDKFFD.PHFC.hAEA......hAGA...,2,-10,6,16
cJfCKaeOWZAHSNbUPLTGDBXEQMVdgIYRF,HAAASAAAUADALAGBGACABAEAECAB.MAGBdDDA..IEGAhAAARCEBFAHB..fCHAhAAAaCCHeEHHZFBAAEAAbFGBhABADAIB....XEAA...hACA......hBFA...,1,-11,-13,2
abfTCGRIdBUcNVWMYOLEJHPSFKDAZeXQg,eAAAQAAA.aACEbADA...TCCARAEFdAGABCDD.UDAAhAAAcBGD.VEAAhAAAMAIBLEEAHDECFEHDhADAAAEAZGEAfFFECAHCNDIA.OHDC..hCAA......hDHA...,1,1,-8,9
MGCFXDadPAKRYfQBHWEJNZIgeSLbOUVTc,RAAAQAAAHADBEAFAZBGBeACALDAAUAGA..TCDAGEEAXDAAhAAAdFAAAAAAKEHBBBFChADANIAB.SDFAhBIA.bEFA.OGDA.MIDADFDBaGHHfGHEhCAA...hADA...,2,-6,8,14
ZWMJecRgSAdCNPfFBTIXaUbHQVLDGOKEY,dAAACAAA.....fADATACAaAEAHAEBLAHBGBGAEBEFhAAAZABB.MDDBeBGFREEBAAGAhAIAFCAAXGBCQDDBhACAOEHDKEGAYFFF...cGGAhDAASGED.hEAABHHD.,2,-8,-4,4
eCbNVXMLSRUYGBIFJdPgTKfaAcWDQZEOH,DAAAEAAAHACAeABA.CAFB...VAEAMAHBRCCA.GCCBBAHB.FDHDdCHATEAAhAAAKDFB..ACCA.QFCAhAEAZFFA.bFEDhAIALHDASEGD.IHHA.hBAA......hCAA...,2,-30,12,42
CIRPEDSdUBMQFLOZaWYTeJXbAGfNgKHVc,GAAA..fAAAKADAHAFBCAHARADAEAGEdCDAMCIBLCBBZEFB.hAAAaCGA..TFAAhACAeDAFbDCDADAB..gFDAhADAIEEASDHDBHADOHFEYFGFhAAA.XGDAhACA.NIAB,1,-10,-19,9
VGfKEdaDSAPFNCJUWOZgLRIHTBQeXcYMb,FAAACAAAUACAZACBRAEA..HAEABAHB..eAHH..XCEAhAFAMCBBGCFAECHB.aDDBAECA.hBAAJEEFOECE.LFGBhCAATGAAYDHBfHEF...hAAA......hAGA...,2,-26,-19,7
EfQJcBYRMWLTOHZDIFGASCUKNVdegaPXb,CAAAKAAAdACAeACE..aAEA..XAFB.EAHFQBEChAAABBCARCDALDHBHBGBZDDAhAHAFECBAAIBSCBDhBCAUFEANICB.gFFA.....hAAA......hCAA...,2,-19,-19,0
TgBSLPbYJQAfKcWMDRCXIZdFNGeVHaEOU,KAAAMAAARACF...XACAdAEAGAGA.HCABEAFAOAHDUDEABEHAhAAALCCA.bCFDhAFAQGAAABBB.hBAAfGEADEEBCDHDFFHDeHBAaGGA.SGGDhBHA....hCAA...,2,-13,-13,0
MFILSeNDdPCZfJQVTBgYHAGbEWaORUXKc,EAAAaAAA.RACA.KADA..MAFALAFB.eAHBdBGAZCCA.QDAChAAATCCABBBDHECAhADAACEAGCGAbEGB.ODABhADAXGCAFEEBSFGDDBIBfGFAhCAA......hCBA...,1,-6,-14,8
ecGXdSRLKVMBbCJfQAPDFWaYZOEHTUNIg,FAAAaAAAZACBHACB.UAFA..IAFAeBHHGDEAdAHARCEALEBAhBAAMEAACEHA..QFBAhAEAABBBDDIBOEGBEGGA.hAIA..NHBB.XGDDKHGA.BHBD..hBAA......hBEA...,1,-4,-20,16
IDPNSXBMOGUWCFLcQRTaHZgdVKbAfYeJE,eAAAEAAADADA..SADAMAGB.GAFACAHALBCARCCAHDGBdCHAhAAAbEABABDA...fAHEhAAAIDDAXEFChAHAOEEBFGGH..TGGA.ZFDF..hCAA......hCBA...,1,5,-28,33
WHPgYdMfFXLBVSDbNaOEGAZKeCIRTUJQc,eAAARAAAUADAQADAHAFA...gAGAdCHAMCCBXDDAhAAALCCBSCGAhAAA.bEDDaDGBEFBBhABAAAHAZFGBCFFAIGHA.cGAC..hAGA......hAHA...,1,-6,-22,16
cDOKPZGTfANEbYRIULXMFWaHQVdJSeCBg,EAAARAAALADBFACD.HAFAdAEAeAGBBCCCDCFBKCFBGDDAAAAA..hAAA..bCGDIEBAhAHAMEEB.aCHDQFAAhAFASFGACFFD.OHFA.....hAHA......hAIA...,1,-14,-23,9
OXAfNVRCPMGFSgITELHbDYWZQKedUaJBc,VAAARAAAMADA..GADAFAGD...SAFATBDAHDDCDAIBZCFBhAAAeBHHdDAAUFBAaDDHBDHAhADAXEGA.AAAACCCDhAIAgFAAEGDE.bFEAQGGChBFAKHDA......hCAA...,2,-4,-3,1
HgPDcJKOGBYLTVNAaMQWfUZXeCSdIRbFE,aAAAMAAA..QADAUAEAeAHBdAGARBBB.EBBBHCGBDAIB.KDEBGDAAhADALGBA.TGFAhAIAADDAZDEBSDGAhBAA.bGFAgEBGcGBDBHDA..hBFA......hBGA...,2,-7,-7,0
RegPDYAEBFMQfXTcCUNVdOZIKabJLGWSH,EAAAMAAA..QACATADA.CAEAUAGAdAFAZAGBKCCD..bBBDGDEAhAAAHDDB.RDGBeEDDhBGADBBBABIBFDHD..XGGAhBIAcFED.OFCHaGHB......hCAA......hCBA...,1,-6,-8,2
VDcGLHgKYMPNeWaBFQCdTfEJZROXUSbIA,DAAAGAAAHABCKADAMAEAeAFEBAHA.FBEDdCDA.EBFFRCFF.UDGA.hBAA.SCCDhBGAAAABLEFD..gEGHhCAAPHCCaDAHCCHBfEEE...hACA......hADA...,2,-22,-19,3
BQaNeXFTKJYfEOSdCPbULRVHDGgMcIZWA,aAAAeAAA.FADDKADA..JAFAEAFE..dCFACAHBUCCARDDB..HDGBhAAAGCFAMCCBZDABACHABFBDhABAQFCA.XFGDhADAfGGESCHB...hAIA......hBFA...,1,-16,-28,12
XLNaeEPJVTMDRGfBOgbFYIQKUSZCcAdHW,HAAALAAAeACEEAEAVAGBDAHB..GBFAOCCAFCAA..QDDBhAAASCEDZEGBAAIBdEAAhABAXFAAaCHDTFCAhACAMDGB.BDCA.bFFA...KHFA..hAEA......hCDA...,1,-4,-7,3
FUEOPfQWgbIKHCaNXZJAYLBdDVeSGcTMR,LAAAdAAAeADAGAGAMAEARBCA.FCBD.UDDAEAHF..OBFD.hACAQCACbFCCHGECaDAHhADAZDGBADEBDDIBSFBAhABA.PFEB.fGHAhACA......hBFA...,2,-12,-8,4
fTVWFaLUZRCHMNQBDgdEXYPOAJGeIKcSb,eAAAKAAA..SACBTADA.FAEAaAFAZAGBHBFA..MBEBhAAAQCCCDBIBdCFCECCBhCAAXDFA.OEEBhAAAAEHAIFFAbGFAWFDDLFHBCFGD.BHGChCBA......hDAA...,1,2,-27,29
KUGBWDcHTVbFMgYXSZJQRdALaNOPEefIC,aAAAOAAA..EADAeADA.CAGA.GAFADAIBHCCAbBBC..MAIBhADAXCFBZDDBRFBBAAHBLDHBhAEA..fEHAhBAAKBBDBECDTEEAFFFBSGHHdHEBIHHAhBAAWHDA....hCAA...,1,1,-20,21
PIQDLXcKgJFVYUWTfSRbBaMEdHNOZeCGA,QAAALAAAKAEAFACEUAGA..TAFARCAABCEA..EBHFHDEChABAZCDAeDHFACAADDIB.XECAhAAA.gFABhAFAVECB.fFFAaEAHdFFDCGHAPHDChACAIHHA....hAHA...,2,-19,-12,7
KQNeXVRCMcFIUBLHPZAJafSdbWYETDOgG,aAAAdAAA....bABDEADA.OAFCGADAQCCAeAFARCFAMDABhADAFCEEBBBDHEFCABIBSCGHhADATGAA.KEFDXFEChAFACEHAUGGALHAA....hAHA......hAIA...,2,-17,7,24
ZeUFJEYTHROaBXbcPKACgQVMISNdLfWGD,QAAAMAAA.SACAdAEALAGBGAEAeBBAFAGAEDDAHCGBhAAAREFABFEDXDAAhADA.bDCDKGBAACIBCEEDIGHAhAIAfFGEDBIB.ZGBA......hBGA......hCAA...,1,6,-27,33
TSgMPIZBERAfVKYNOebHDGXQWUadFLCcJ,KAAAOAAAHACBGADAQAEAUAGAdDBALAHB.CBGBJCABTDFAhAFA.MDDBZDEARFDAABBB.hBAA...VFGBeFHFhAAAbFDDDIEA..aDHFcEADSGBB.hACA......hAEA...,2,-11,1,12
WMIRUAVTGHPEKNXCbQLceDdYaFSfJZOgB,GAAAHAAAEADEKADACAFBLAHBeAFE.dCADaBFDFCEA..SCDBhAAAZDCBBEEAMEGBRCGFADABTFCAhACA..PEHBhAAAbFEBQGGADHBA..YHCGhACA......hBHA...,1,-1,-13,12
AVEfTOIPJCGeMYZbBSDUdXWHKLcFQaNgR,EAAATAAA..OACCJACA.eAEEZAFBBAHADAIBdCCAHCCBLCFBhAAAQDGAaCHHREDBAFHAfEFEhAAA.CFAAMFCBhAFASGGA.WHAAFGHB....hAHA......hCAA...,2,-23,-9,14
FKDMNYPVXTcgJZOHLeIARUGQfBdECaWbS,RAAAGAAAQADCdADAEAFA..aAFA..bBFAKBFA.MAIB..hAAAPDDATDDAgEFAhAAAZDFBLEHBAEIBBFAAhACASFDDDGEB.YHFA..hABA......hCAA...,1,-13,-16,3
HROLUDgPCKWZcVXGfFETAeISJNaBQbMdY,eAAASAAA..aADDQADAdAFAHBGBRDBALAGBDAIBCDFDZEFEhAAAXCCC.GDAAhAAAEFBBACCB.IEEAhABABGGA.bEGBOHACgFDG.KGCD.hABA......hAHA...,2,-17,3,20
abLPGHYUBRQTAeWDJMFOZdNCXfIgcVSEK,eAAADAAAMADAZADBdAGA..CAGA...fBCA..gBBAhAIASBFDEBEBhBAAbDEAGCFAHFFABGBAhAAARDDBABBAFBHDNAIA..IHHAKEHBaFBA....hABA......hBGA...,1,-17,-22,5
NKcPGTQCgBSaXdMLDUEfJAVeORYWbZFHI,eAAARAAA....bADBHADA.KAGCGAFATCCAQDCChAAABBHAaCEDdDGAMAIBLFAAhAAAEDHBAAHBOEFBZFFAFGEHhABAIGGA.PFBBCHHD.SFDHhABADDIB....hBFA...,1,-3,-11,8
HWBYSRINPacdVMFeUXbKTLJZCgOAQEfGD,EAAAGAAAHACABADARAFF...IAFAaAHDdCCDMDFBeAGHXCDAhAAATDGA..ZEAAOBHDhACAAEEBQGFAhAAADDABSDCDPHAA.FEEH.bGEA....hADA......hAIA...,1,8,-20,28
SBDLTVKeXRNGCJafQUFZgWAdYMHcEPbIO,dAAAHAAAEADA..bADBSAFALAGBKBFDRCAAGCEA.aAHDQCABhAAA.ZDDAhACAACEBMDHBIEHADDIBeGAAhACACFFDfGBAFGDDgGGA..hADA......hAGA...,2,-11,-5,6
HJXCTcaKWgINUdeGOZSYQfMEBPLDbRFAV,HAAACAAA.aACAKACA....IAFAdAEAeAGBZAGBQCAAhAAAECCALCFDRCFBAAHA.XDGAhAAA.TFGAhBIAgDCBGEDASDHH.MFFBhACA.DGGA....hBIA...,1,7,-36,43
XFRUYIDKNeAEWCcQfdaGOTMPSJZbBVLHg,EAAACAAA..QACAaACDGAEAMAFA..SAGAZBEBBBGAHCAAhAAAFCBHRCGBUEEBDBIBeDFHhACAAAEB..fFHAhAAAdEHATEBAbGAALHDA....hBEA......hCAA...,1,-4,-9,5
RCfdeGWAEQKPTVbYZLHXUBIMODNgcJaFS,EAAAQAAAKACA...TACAVAFAZCCAHAEBBCHAMAHBDDGBgDDBhAAA.aCHDhAEAREAAdEHAeDGDAAEA.bGAALHFAhAAAXGGAOEEB...NIAB..hAGA......hAIA...,2,-20,3,23
LUWXdPMGARVKTNQBHSgCZObIYEfDFJcae,RAAATAAAQADC.HAFBCACBZADB.OAFCbCCC...ECFAFAHFhAAA.aDFEeCCDLFAAhABAXDGAdFFAMDIBhAFAAAHAKEEASFCDIHHADEEBcGGA.PHDChAAA....hCAA...,1,12,-24,36
MQTFOaNBEZUeHgYPDfLRCJcGWAIKVXSbd,KAAASAAAdACA.MADATAEA.FAGAaAFE.BBCAZCDEHCGBhAAA..gBEGhAAADEAARECACFGD.GCGAACIB.hAEAXDDCOFHD.EFFB.eFHH...hCAA......hCBA...,2,-22,-13,9
cGKCHTQBePESDZAFXOMbJNLYRIgWdUVfa,OAAAMAAA..JADBLAEA.RBBA.IAFAdCFAUDDAaAGDGDGAhAFA.HGAATCEAhAIAeHCAEBBBDAIBABIBXDGAhBAA.bEEC.....gGGAhBCA.fHDBhCAA,1,-19,-21,2
DeNQBFOfCYLEcXIAWUJZbVMTRKHagSdPG,UAAAZAAAMACARADAHAGB..aAEEdCDDGAGAeDABBDFAOCCBCDHA.EDEAhABA....XEEChADAAAIBbECD.KFGASEFHhCAADGAB.FFHB.......hAEA......hAGA...,2,-28,-8,20
LcbGYWTOgRKXNVSJUDEdBFZAfCHeIMQaP,HAAAeAAAMAEAaACALAFAGBCA..TBEARCCAXCFB.SCHHhAAADAIBECGFdEBAZEEAhAGAAAAACDHAQGGBhAHA.PHDCbEECOFHD.KHBA...hCAA......hCCA...,1,1,-5,6
NfecPIFDKSYRBTVUJbEOCHMLgdaWZXGAQ,QAAAeAAA..IAEAKACARAEFBAGBTAGAUCGA.ECDBHBCAhAAA.MCGBdEAAZEFAhAAAACIBfDEAFGDADGGB.hAEASDHD.VGAA.bFFCCHHA.aEDHhABA......hAGA...,2,-20,-9,11
ZWXIebCGAcNQdVTEYBJHfLPSFKURODMag,QAAAdAAAEADABAFAHACALAHBFAFARCDAMAIBZABB...XCGDhAAAeBGFGDCA.hAEAACEAVEGBTECAJFEBSFEAhCAA.OFHB.aGCC..hCEA......hCGA...,1,-5,-14,9
NgdbYCOPTWSeRLKAcXJIDZBUMFafQVGEH,XAAADAAAZABEBAFAFADA...QBGAEAGAHBCBdCEA.CBHAOCGBhAAATCCA..eCEHhADAREGFADIB.JDGFMFFB.aGAAhABAGFAB.gGGA.YHAAhAFASGHHKFFD..hAGA...,2,-14,-12,2
QLNfEVdeXGOUJHcPIBZDgYRKWSbMCAFTa,aAAALAAA.EAEAeACHGAGAOAEAHCAA..IBEAhAIAZCEFDDEBREAASBGAhBAAMDIBAAIBTGBAQDDAhBBAfFGAdDGAXFGAcGDA.BGEA.KHBAhBHACHHA.NIEB.....hCAA...,2,-13,9,22
dLGOHZBSVbXTNaMeJYAfIWUQgKEPRCFcD,..IAAAQAAAKACA.RACAFAFA.dCEAGAEAHCGBZDAASAGAhACAXFFCaCCBMAIBhAAAeCGFACGB.UFFB.EDDBhAEACGHADIFALGAA.BEHB....hAGA......hAHA...,2,-13,-10,3
CXWQYZOBEeJALfGgaIHcNRbSDPKVFdMTU,GAAAaAAAHACBRADADAGAKAEA..dAGAMBHB.UCDBXCED.QDGChAEAZEAAEEEBAAABLFHBhACAfEDEIGGAhADAbFFA..SBBDFGCHCGED...hAEA......hBCA...,2,-12,-8,4
BKWJCRMZQGXdOaUAbfTScegEHVFYNIDPL,TAAAeAAAHADA.FAGA..IADALCCAKAFACCGAREEAZBFEGFABhAAAdCADaCEHACIB..SEHBhABAEDCFVDGBDFABBGGAhAFAMFFB...QGGB.OHAChAAA.fGDEhACA.,2,-11,-9,2
cLUDYQeMXdEZNfAPRgFVTSCaWBbHGOJKI,RAAAFAAA..TAEAaACDBAEAHAGBGAFAKCCALDABDAIB.eDEFhAAAdDDAEDHBZECFAAIB.VFFAhABACEAAOECH.JFEBcGADhADA..QGGAMIDA.fHABhAEA...hAEA...,1,2,-22,24
MLaOUeQFRHgNVYbGKdTXEJPcIBACfSZDW,SAAAZAAAMACALAGBOACD..eAEARBDFHDEB..gBFAhAAAVFBAGGEBdDHAEDEBhABA.JEAA.IGEAhAEAAAIBDCCB.UGGANCIA.bFAC.....hABA......hBFA...,1,1,-11,12
TJAMLgeNXbdQKFZECRISUPcYOWaBfGDVH,MAAAeAAA...XACAdAEAQAGA.ZBAERAFASBBDhAFAUDDA.PCEDhAGAOCFDaCCDGEBAHCGBACIBhAIALDHBbGDA.EGABCHHA.IHEA.hBAAcGGC...hCAA...,2,-10,-3,7
egVUaANfCRcWJHBIPTOXZDYKdbGSQELMF,CAAARAAA..JADAHACA.BAFB..TBGAZAGBKCAAGCCAECEAMBIBhAAAeCFB.UFFBADDB..hAAA.fGAAhABAIEAAXECAdHEDSAGELFFA.FHEAhACA......hAEA...,2,-23,-9,14
gBNObGHQDUKfcPYdSeAWLTZCRXJIFEVaM,TAAARAAA..XADBFACA..EAFAaAFDMAIBBAHA.OCCBhAAAHCCAQCFChAAA.KECDfCGAhABAPEEBdFAAACIBZDEFCFHAIHCAgFBANIEBDHFAhAFAcGFD.eEHBhAHA.WEED.,1,5,-19,24
QFdVbKEeHXcUaGOWPJASBZfIgDMYTCRNL,ZAAA..fAAADACAMAFA.CADALAFAdBEAKBGA.HCAAUDGAGCEAhAAA.OCGFhACAJCCFAEEA.BECA.gGAAhADARGBAQGECbGFAXGCD.aCCAhAGASGGB.hAHA...,2,-34,-1,33
RCTQeOWPJHDLZKIGFdVfbXEYUBgcSNAMa,RAAATAAAeADE..OAGDJACA..HAFBZCCAGDFAdBHA.VEBAhAAAbCCBEEEA..BBDAhABASEGAAAIBaCHDQGAChAGADFAALHAAFFHD.XGGA.YHEAhAAA...hCAA...,2,-4,0,4
EAfObUReQNVaXKdTYSPMFWGcHICDBgZLJ,OAAARAAAeADE..QAGCaADD.dCCATAFA..SBEDhAAAMAIBGCDBHDFAhABADBBBZFCAEDBFACIBfGGAhAIAbEEAVGEA.KHDAFFAH.IHCABEED.hCAA......hCFA...,1,-2,-8,6
HRPcFOANWJQZKdSECbDfGgLXUBMeaYIVT,JAAAZAAAdAEA.EAGADADAGCAALAGB.BBDAeBHF..aBEDIDDAhABA.HDFBhACAREEAFCCHACCBQFDChADACDHA.fFHAXGBAMFIB..hAIA......hBAA...,2,-44,3,47
ceSEIHQAPaWGRgMNKdYBXZfVLTUObCDFJ,aAAARAAAMADA..dADABAGAZAEBLAHBUCCA.CBBD.FBFH.eAHHhAAAEBGFHDBA.AEFAGEGAhBAAKDHBXEBC.hBDA.TGBADEFBSEGD.IHFAhABAWFFD....hBEA...,1,-8,-38,30
HYdGNQeKZCTUfADVLOBbISgRWPJXFMaEc,LAAABAAASACARADF..PAFAFAFAEBEFHCAAGCAAeBHFhABAZCCFTDEAAACA.ODHDhACAbCFA..gEEBhAAAXFCAaFGHdFHAQGCACCFB.hCAADHEA.....hCCA...,2,-4,-1,3
aLBIQGAYfVPObZDSXKCNeTMREcgJdWUFH,VAAAOAAA.ZADBDADAKAFA..eAEARCEF.EAHF..JBBFdCDAFBHDHCFAhAAA.aEFCLEGBhAHAQFCAAEIB.fFHAhCAASGCACHEA.MIAA.....hCFA......hCIA...,1,-13,-32,19
dJefgbOIaUPFYACNVWXRTLcBHKGDSQEMZ,CAAAVAAARACA..LAFBHADBGAGADAHB.EDAAdCAA..eDDA.hAAAbEFAaBHD.FCCHAAFAXFBAhAAABEDAQEGAhACAZGEA.JFCF.OFED...IHHAhADA....hAIA...,2,-27,6,33
GXFRLDAaMUQONVIbgKCZeJPEdYWSHcTfB,aAAAMAAA.UAEAQADA.OAFCIAHAKBBDZCDA.eCHBhADAEBBAdCHA.SCDDhBAAHEEATGCAGDFAhBBAFGGADIAAADFBVEBBCHEA.PFHD.YHDAhBEA....hBGA...,1,0,-19,19
PCLENbSROWGBVQdZIAFeaDJYHKgMXTUfc,eAAAaAAA.DAEAHACBKAGA.MAEA.UBEA..fBCAhAAACAHALCGBEBEBSBBDhBAARCFFGDDAQFBChABAZEEBACIBFGGA.gFGA.....hCAA......hDAA...,1,-9,-16,7
VMZeBTDNEUgIHbLdXJSYFKAaWRPCGcfQO,RAAAGAAAQADCMADAeAFADAFA..EAHFICDAHBFBLDDBhAAAdCFASBHHKDHBACCBaFCBhABACEBAOEEBZFEBBGGATFGAhAAA...NIEB.......hACA......hBAA...,1,-6,-16,10
CdgEDLAUSZFRNOeTXHfPcMWaIKBGYbVQJ,ZAAARAAAeADEHAEA...fBHAMAHBaBDDBCCCGCAA.bCDAQDEAhAAA.dEGAhABAEDHFAAIBFFCATECAXGAAhAGAcEEAKGHBYFHB.CGADDACA.hCAASHAANIDB.hCFA...,1,12,-14,26
UZPWIfJFSDgBTXLKNdEOMCHQGAbecYRVa,eAAARAAAUADAZADB.....IAGAFAFEDAIBBCCDLBFAdCGA.hAAAEBCF.MDFAHDEBAAAA.hAIA..bGDAVEEA.hABAaEHD...fHEBSEDD..hCAA......hDAA...,1,-12,-35,23
GJIOgAaKMTPCRYWVcZNbeQDFfBXUdEHSL,aAAAMAAA..CADA.RACA....VAGBZAEBeAGFQCCBFBBHBBHAhADAdDFAHEGBGDCAOEEHhAFAADIBKEEC.TGAA.hAIA.PEGDYFCH.NBBADIEAfHDFhBAA.....hAGA...,2,-23,-3,20
PWRaTYASBdfFgNCUEDJKQZVIMbOXGHecL,dAAAFAAACADAEADA..KAFAZABB.MAGB..XBGAHCEBeAHBLCCAhADARDCBaCHH..AFBABFGAhAIA..fDFAhAFAgGFGDDHB.QECA.bGFAhAHA......hAIA...,1,-6,-41,35
ZGbSeVNdBJCAXQOfHREIcTDgUFPMKaWYL,QAAAHAAAEADE..TAGADADAFAFDMCABaAHB.LCCAGBDAeBHHhAAAdCGDCECAAEEA.fEFAhAAARDBBIFFAgEGHhACAKEHBZGDA.bFAD.SGHHBHHA.hBCA......hBDA...,2,-10,12,22
YNaETRZgLVQdecUfKIBbHPWMCDOSGJAFX,XAAAaAAA.RADA.ZACBLAGBdAFAeAHBUCDBKBBDBBECHDABMAIBhAAAOCGDGEEB.hAIAAADAFGCAEDEA..TFFAhBAA...........hABA......hCAA...,1,-9,-28,19
XeaPdJBTODKAMfLNWHIcESGQYVZCbUgFR,MAAALAAAHACCEAEAGAFA.QCCCZAGBbCAA.FAHFRCEBeCHHhABAdDHATEEAKEAAABGB.fFAAhAFA.IGGAhBAASEEDCFDD.XGFAaBBHBHEADCAAhACA.NIBB.....hAEA...,1,15,-14,29
PLdTWZOSCKAFJGYgURMeVDaQcNEBXIfHb,GAAAUAAARADA.eADADAGA.aAGD..QBGAECDABCHA..XDCChAAAHCBCLDFBhADA.dEAAZDFACEEAAEHAFEAHJFCBhAEAMFFB.cGBBfFHATGGASHFGhBAAKGDB...hACA...,1,-7,-10,3
AgdeYIZUaPRQfJMBTLObcXDKHSFVWGECN,eAAAZAAAaACARADA..QAGCMAFA.LCCAOBEC..XCCChABAHDECFEAAGDEAhBGAEEHFAAAAdGGDIDGA.hAEAfEHABCHA.cGGCDFFB.SBHBhCAA...hAIA...,2,-11,-10,1
WgBDTXJRGKMLNHPafZVeOUcdQSYAbICEF,CAAAEAAAFACABACA.DAEA..TAFARAFA.GCBAMBEBHCFC.hAAAaCCBZDDB.eAHHODDHhAAAdEHAQFFAhAFAAEGB.IHAAXFED.KGGCNIDBfDFAhAHA...hAIA...,1,-6,-29,23
ZEGcRLTVUOHDeKBdbJSNMCPAQgfFXIWYa,QAAAFAAA..XACDIADAaAEAEAFAGAGALBHBhAAAUDDAHCBCKEBBdEGDbCEBSDGDhAFAMGDA.hAIAACHBfFHA.YEEF.hBAA......hBEA...,1,7,-30,37
bPCLSZaBVWNdJTeGXIDFUOgQfYRHcMAKE,EAAACAAAZACABACA....VAGBdAEAeAGBGCCADAIB.FCCBODABhAAA..QDEAhAAAREFAHFABACCBKFEDbEBCLEGBhAHAaGHB.JGCA.......hADA......hAEA...,1,-15,-18,3
bfLCFZKJWgcPUTQIGNSeAXBMRdOaDVEHY,MAAARAAAdADADAFAHACC.....bAFBLBFAZBGBKBBD.JCCF..hAAAgCDAUDGAQEEAhABAGFEBeDCDhAIAABGABGHAaDHD..........hBAA......hCAA...,1,-3,-38,35
BUKFCHSIJQVEdAYRcfTeZXDLPgNMOGbaW,RAAATAAAeADEZAGB.LCCA..gACBMBIBGEBAhAAAaAEABAHAFEEAHEGBSBEHhAAA.QCGAhAHAEGABABEB.fCCEDIFA.OEEBhCAA.bFGB.KGCB.hABA...,1,-5,-11,6
XYAeIOPHLCJKZGMcDWgUVBbQNfFTdSREa,eAAAOAAAHADALAEAKAGCGCCAMAIBDBBBUCFABCCAQFAAhAAAFCEA.dDHAEDEBaFDDAAFACDGAhBAAZFFA....gEGAhBDANIBB.SGHH.YHCAhCAA...hABA...,1,0,-22,22
TEUZLNYMQeGSaOVXDRcJFCfBAdbgWKHPI,dAAA..bAAAKADAHAEA..TAGAEBHFZCAALCCAMCEBeCFFhAAAaCFD.XDGARDAB.hACAFEAABCHAAAGA.gECBhADAIFGANIABGGABSGHHDEIBCFFAfGHEhAFA.PHEChAGA.,2,-20,9,29
IYbgWKQRUBCdFfAGVecDOTJLMXHNEPZSa,eAAAOAAALAEAHADAEAGEZBAE..aBBCbBFAKCEA..RCDBCDFBdCGA.hAAAACIBGEEADDHB.MDDBhAFAXFAASEHHhAIAgFFB.WFHHBHHA....hBAA......hCAA...,2,-11,-11,0
RYZTANJfHUXLIacFBVgQEGOSbPKDMdWCe,JAAAHAAALADBaACABAFA..QAFAEAHBGCCAOAHF.hAAASCCDbCFBDDHBdFAAhAFAeCFBRFDFTGGAADHBfEEAhAFA.XFGA.FHFA..hBAA......hCAA...,2,-21,2,23
IfMPcQRJgEKOLGTaNVACdFbWXeYHBZUSD,dAAAFAAA...XADAHACBZAEADAGAMAFAQBGARCEA.ECBALEEAhBAAGDDAaDACABIBbFCChCAA..eDGBBFHASFGDhACAfGGEcGBA....hADA......hAEA...,2,-16,-14,2
CKAOcFLgVGDUEQXIMbZPeTfWJdSRNYHaB,FAAALAAAGACAEAEAQAEA.MAHBZAGBeBFF.TCAAhABAfDFAdCCARECAHEGBhACAaCHDKEAAABIBOEABhAEAgFDBDDIBXGECIGBAPHFChAEA.SGGEhAIA...,2,-20,8,28
RKTUEBJDIMGaXcHOCPfFgedbSLNQYWVAZ,RAAATAAAEADE..DAFAGACA..aAGEHAEA.CAHBFCAHeCCAbCEAhAAALCGB.QEEAhAAAVEEAACIBZGAABFDDhABAMEIBOEHDfHGB.SEAAhACANICB....hAEA...,2,-18,3,21
NSOKgfDFJQBeUPRZWCYbITVLXGAaHdcME,HAAAdAAAEADAOACA.KAFADAGAFBHDQBEABCCA.eBHBRCEBZECBhAAACCBA....bDAATEGAhAHALEEAACGBaGGCMFIBhACA.SGCA.fGGAhADA.....hAIA...,2,-26,-6,20
PGaRNSJDfOMZTQKBIVXHbLeFEAYUgdcWC,UAAAdAAACADAGAEARADA..SAGBDAGA.MAIBZABBTCGAhBAAQCDBBBHBXCFDhADAHDCBeEGB.AEIB.hBGAgEAA.PEHDaFFH.fFFAhAEA.KHDA.hCDA...,1,-12,-22,10
KfLdeBAWTgHIPSNYEZJQXaUCORcFDbVMG,TAAAHAAASACE.EAFAZACBQBGAaAEDOAGBRCCADDGBhAAAMAIBGEEALDEAhAAAeEHBACABIEBAhACAPFAANIAB.XEGACHGA.bFDB.KGGA.dHAB.hAFA......hAIA...,2,3,7,4
cTLRSYXaOJPeEMBfdIVbDKFUgNZHGCAWQ,QAAATAAA.RACA.XACBOAFAeBFFEAEABAGA.dCCDbCDDhAAAFBHD.UEEAZCGBHDAAhADAACFALEHBaEHDMGDAhBIAfGDEDIDA.KHFA......hAAA......hAIA...,1,8,-18,26
IZLYHWCdBJTUAfDVNREQFObXMgSaKPGec,DAAARAAAEADEQACA.FAEEbAFB.MAIBaAGD..GCDB.hAAAeBBBZCCAHCGBdEEDTFGAhAIAACEAfEEEhABA.OFHDSCHHKGFBIHBA.hBAA......hBIA...,2,-19,-2,17
XdEDeTgLSMCFAbGaBVOQHJWNRYfPKIZUc,aAAAOAAAHACB..JADBRAEA....fBHAKAFAZBFEUDEBdDEAEDGBhAEADBBB...eBBDhAFALDHBMDIBAAHAGFABhAFAQGCA.YFGFIHAA.XGGChAHA.SCCDhAIA,1,-13,-25,12
cGFRTEONKJSeDQbdUVXBIgHWLAaMCYZPf,aAAAMAAAZACB....fADAGAEARAGBEDGBKAFA..eAHHQEBAhAGAdBBAXCEAhAFABBBDHEDAACEACDDD.cFGDhAIATEGA.OEFHNIBB.DGIB....hAHA......hBAA...,1,0,-23,23
GUMJWcdbgNOIZAHFEfSTBCXKeYaDQVRPL,HAAAEAAA.TAEACACAKAEA.eAGH..aAGAQCAB.RDCAGDGAhAAAMBHBJCCAdGAA.hAAAbFDDOCFDACIBSEAGhACAXEAADFFBLFFA...cFCDhAEA.IHFAhCAA..,1,10,-29,39
TPfAXBMCEGRIYHbQVdWeLFNZcgDUOSKJa,MAAAEAAARACA.HACC.QAFCdAFAeAHBLCEAZCCADAIBUDGAKCCDaDABhAAA..TGEAhAHAAEEACEFAGEGAIHCA.hADA............hAIA......hCAA...,1,-14,-19,5
BReWVgZcSGACKEQHFYOPXbfJMNUDITaLd,EAAAHAAAFACDOACA..XAEAJAFBMAHBDAHB...aBHDdCCAhAAARCDA.eCHH.gECAhAIAZEAAGEFAAEGBQFEDhBIAYEHH.fFHANIAB..hCAA......hCEA...,1,-14,-15,1
KUNcfBeVCZaPRHbMGLDSETgJYIWQFOAdX,dAAAKAAAUACA..fADAeAEAZBFE.RAEFHAGBGDDALDAAhACAEDGA.TDFA.hAAAgFFAIFAAQFGAhAFAAAIBXGAABCBAaGDH.MDIBSGFDhAIAYEDB..hADA...,1,-8,-13,5
VbNfYFacKdgLHMURJZBCDQXSIWTAEOePG,EAAAeAAAGACA..bADA..fAEBaAHBdCCAHDFARAGFZDFADBIBhAAAQEBCSEABhABATFFAACFBOECENEEAFGAHhAAAKFGALHFAMFABBHDACCBD.IHHAhAEA......hAFA...,1,15,-7,22
gEPdcaVFCWSBQOITGfYbKJAZLReHXUMND,RAAAHAAAMADADACA.EAEAdAHA...aBDDCAGABBHA.QCCAhAAATCFAGEEA.bFBBhAAAACFAeDFA.XEGAhAIANDIA.gFDA.cGGAhCAAFHGCSCCD.hCCA...,1,-8,-24,16
ecfdTQGADMZVCSEWHbIBRJLNKXgaYPUOF,ZAAASAAAHAEABAHBRACFLAEBKCAA..aCECUAGAFCGA.eDEAhAAAdEAAGEEAADIBDECBMEHBhABAEDDB....bGAAIFFAhBGA.NIBB.YEHB...hBIA......hCAA...,1,-9,-24,15
KcHWBTEZbOUDRCfMYLFXeNPJdgAIaGVSQ,GAAAQAAAHADABACAEAGEZCDAOADDRDGFMCFALAFA.eCEHhAAAPEEBdCGAAAGAaDAHKEHBhCAA...TFFAhCIAbFAACGGD.FGDB..NIAB.IHHA...hAAA......hACA...,1,1,-8,9
BJKNWeObMEgIALCcXfZQHPFSdDVUTaYRG,LAAAXAAAZACBHADB.SAFAdAFADAHBUDEAaAHDGCAAhABA.KCFAeBHHMDDBEEBAhAAAAAFACDHAQFGAhABAFEEATFGARFBABBEC.NIAB.......hAIA......hCAA...,1,-1,-11,10
IBLcADQVOPUgFERTHWaCdYbfGJZKNMXSe,QAAAOAAAUAEAEACAHAGD..aAEDdBBD....bAFDGDDAhAIAZDCAMAIBeCHHLEGBhAAAADDBDDGBPEBBhBAAFEBHWFHHCFHA..fGGEKHAASGFDhAHA.BHCB...hBEA...,1,5,-17,22
GbEQSYgKCUWPXBLATFHRZDcfNOJdaeMVI,HAAARAAAZADBDAGA..fADB.OAFAaBFAeBHHMBGBGCEAhAAAEBHFQCABhAAA.SCEBhACAKDAACCCCPEHDLDDBACGBTGFAFDHDcFFAhCDA......hEAA...,1,-3,-23,20
WfTJNGPMVUbRCIXaFODeZYgAQBHELdScK,HAAAEAAAdADAKADC...TAFAGAFAMAIBbCBC...RCAAXCEChAAAaAHFDDFBZDGB.AAFBLGFAhAAASCGHfHBBhBCAPEFBCEHAOFCB.....hBDA......hBHA...,1,-8,-15,7
UNIWYRJTLcdaOEBeSDACQZKHPgFMfGXVb,ZAAAHAAAFADAGADA.XAFAUAGA..ICAARCAATCFAdCCDhABAEDHFBCFDeEFBADHA.QFAAhAAA.KFHBhACAMEEA.VFFANIAB.JGBA.....hADA......hAFA...,2,-33,10,43
CafPQNWAdRKObHTDUIXgMFJEVecZBYGSL,RAAAOAAAHADBDAFAUAEA....XAGAMAHBEBBBeCCB.ZCFBhAAAGDBBLDABaCHDQEFDhAIAADHAbEGD.hABATGBAFFDD.cGDASFBHCBDC.NIEB.hADAdGGD.....hBFA...,1,-1,-4,3
CRPUeTWJBKGdbcaLMfYEQDOVZAHISFgXN,HAAAFAAA.XADBRACFeAEE...TAFABAHBdCEAaAHDLCAAhAAAMCGB.ECEFQFBAhBAAODFCADHASFFAhACACEHAPFFB.JHAAKHGAbGFA......hAHA......hCCA...,1,6,-26,32
FATEeIHUNaCdLSfDQBbJZORYXMVgKPGcW,EAAAHAAAUADAaACAdAFALAGBDAHB..QCCABBCCZDDAREGFMAIBhAAAKFBA.GDFA.FFBAhBFAAAIBeFDHCDHD.SFFDhAAAbFDDOFHD........hCAA......hCCA...,2,-26,-2,24
CPMabGfAJQDIBVXHSUcNeYOEKLZTRgWFd,QAAABAAAHACASAEEUADA.eAGHEAFAZBGBRCAA.FDBAdCEAhAAAMCIBGDGAACGBDDFBXEDChACA.cGEAhAIAOEDD.TFGA.CGFD.....hAAA......hAIA...,2,-24,-3,21
HeWVNCASJROZQIBFcdaEYUPDMLfTKGXgb,RAAAZAAAQADCFADAdAGA..ECAAUAFA.MAIBLCEB.TDGAhABAGDDA.bDGDHGBAhACAeHBEVGFAAAAAOCCBhBHABDDA.aGFCDAIB........hBGA......hCAA...,1,-2,-13,11
IRdWMgQbJCFDNPBfAVGXSLZceHEYUaTKO,GAAALAAAeADAHADBEAGAaAFA..TCDAOAHD.RCAAdBFAMBIBhAAAQDGDCCFBDCHBBDCDhACAACAASEEBhABAZEAAUFEAKGGCgGGA......hACA......hEAA...,1,-6,-8,2
BRFgYKNITAWbDXECGPeVfLZcaOJdSHQUM,DAAAEAAAGACAeABALAFAZAEA..aAGAdCCAHCEAMBEBREEAFCBHKCFA.hAGA..TFAAACHAXDGAhAHACDHA..fFHAhAAAOEFBQFCABGCANICB.IGGAhBAA.WHFA..hCAA...,2,-26,6,32
KRdcXPNZfYOICGgbJaHBULTVeFSWDQMAE,RAAAdAAA..XADBZABBOADCGAFA.JCCBHAGB.LCEBhAFAeAHBSDFDhAAAQDGBEDHBKDCA.PFGBhAGAfEDA.CFBDaFGD.....hAIA......hBAA...,1,-9,-20,11
ZBbLEXfFdMVTOgSGaQDKPAHceCYRWJIUN,HAAAeAAARADAJADA.UAGAZAGBLCCA.EDHFFCAH.dCCAMEAAhAAATDFAOEEB.SFGAhABAaDHDKEDAACFB.CGAA.hAEA.IGCABGGAfHDBgGFGDGIBhAAA......hACA...,2,-29,-3,26
VOXJafWHNRLEIUQAgCBZTdSKYDeGFPcMb,BAAAdAAAKADAeACAGAFAFAFD...MAIBOAHB..aCAEHCAAhAAARDCAEDHBQDEAhACA.ACCAZECFTFAADCIBbEGDhADAXFDA.fGGANIAB.LHAAhACA...hAIA...,2,-15,-5,10
KRHSFUdMZCGfaBADJXEgQIbTNWPOVLcYe,XAAAEAAA..QACA.bAEATADA.PAFAhAAALCCAeBHFHCFBhAAAFCDHdCFAZFAAfEEEhAFAADAADDIBgDAAIFHAOFDAcGGCKFHDSGGDhABAMAIBaHDE.hAGA...,2,-5,-5,0
ELATOUDVSMcPbFYefHaQXNWGZRdJICBgK,TAAADAAAMADA......bACBeAFAHAEAaBBAQCEBhAAA.XCGDhAGAGBDARCFFdFFACBHAKDHBAAHAOCCHhBIASCCDFHGENEEA.ZFCA.BGGA...hCAA......hCIA...,1,3,-23,26
eWUNJFLdfQTHgYBCcGbIXPZDEAMSVORKa,MAAAOAAARACA.KADA..eAFEUAFAFBBHdBHA..QBFDhAIAHCCABBBDGDDA.bFGBhBAAXDFDDCIB.AECBaEEBhAIANECA.LEHB..fHEFhCAA.....hBAA...,1,-2,-30,28
DRNZfeLcFgEMQBJGKTXCVIPAUOHbYSaWd,HAAASAAAdADARAFAZCAAeACHLCFA.FEDDEAEABEHAGAGAhAAAKFAA.TCEA.CDDDIEAAhABAAAFAOFEDaGGAhAAADDIBfECE.MEGB.QGBChAEA.JFHF.hACA...,2,-21,6,27
eEDYUIQGSWbBJXVadFAgMOPKcLNHTRfZC,MAAAKAAALACBHACCRAFFZCCAEAEA...DAIBUBGAGCGA.SEEDhAFAbCEBBEAAJEDBaFFDABBBhAHA....OEHBhAAANIDBCHHB.eHAE.QGEA..hAEA......hAHA...,1,-9,-20,11
CgMaNbHAFDQBOWJZdIPXLcERTfVKYUSGe,QAAAOAAAZADBdAGA..XACAEBBBRCEF.TAFAKCHBUFBAhAIAeAHH.MCDB.bCEDhAAAHEFBADAABDGDIHEAhBAALFAB.fEHASDBGCGGDaDAEhADADGIB......hAFA...,1,-7,-12,5
gPCRNJMYIVdKGHLTWfDZObXFAecESUaQB,EAAAaAAABADA..CACARADFMAFA..IAGAdBFAHCCB.TDGAhADADAIBZCEB..bFCAACCBeCGFhAAA.UFAAQGGAhBAA.PBBBYDHBKBHBLHBAhBHAODDBFGGH...hCAA...,2,-20,-7,13
MELRDcCHYXfUJZGBPNeFOKAWSVgaTQbdI,SAAAaAAA.QADAdADAEAFARBFACBBDHAFA...fCCAhAAAZDBAGDGABCGAhABAeDDEKDABAAIB.gDEBhADAbFAA.MCIBDFAAYFFFXEGDPHAAhAHA.OEEHhAIA...,1,-7,-10,3
OZSGcHQBgCEeLWJTfIdFKYRVbUPXNMDAa,ZAAAGAAAHAEAQADACAHBLCABJAFE..TCDAdCGAKCDDRCFFUFFBhABAXEEC.MBIBhAAAAADAaCCH..SDADhACABCHBEGAA.eFDDWEHBFFGD.....hACA......hAGA...,2,-11,-2,9
VHKeJCPWfUGAbQEcZLaXdSMgNDOIRTYBF,EAAAZAAAaACAdADA..MAFADAFA..RBEA.BBCCHDDAeBEH..CAHA..hAAA.fBGAhBGAACCBQDGCLDHBSFBAhABAODDHTGGAFEGBKFEBWFFD...hBIA......hCAA...,2,-21,-17,4
AQdWYfZOJFbHVGNSKCMUXeEBcPIgDTLRa,dAAA..fAAAZABBFADDHAFAGADAKCEAUEEAEAFABAHA.ICBAhAAADCHBRFAA.AADBQCFAhACAODHD.bEFAhAFASDDDMDDBeFEB.gGGBhBCAaGFE..YHAGhAFA...,2,-26,10,36
aZbHTUDCOSXRPdfKEWLeJYNVBcQFGAIMg,MAAAZAAAHAEADAEA.SAGERAFA.dCAAEBBAeCCB..NBEABCFDhAIAQCEB.AADAaCGDhABAbCGD.CEED..XEGAhACAKDCBLGEA.......hCIA......hDAA...,2,-33,-13,20
UfcLDbRdagMAZOeYEFJPKNGQHBSWXVTIC,eAAAEAAAFACDKADA.GAFAHAEABAHB.SCDHXCCATEGAhAAACCFA..fCHAhAAALAHBRFAAaEAAACCAZFDBhABAOEFB.PEHDQGGB..hAFAIGAA.DGEBhAEA...,1,3,-30,33
AgSUNLbRPCZHMQOafWFIKeEYBJcVTXdDG,SAAALAAARADFZAFBHACB.MAEAaAHDFCAAeAHF.BBEB.VDEAhAAAdDHAADDB.UEEAbFGD.hABAQFAAOEDBfGBAhBGAKFCBEGHBJHEA.......hCAA......hCBA...,2,-8,-8,0
CDVSJGMNbTfLPHUXRgeAdBOFQZaWIYcEK,dAAAFAAAZACBaADA.....IAFAEAGADBDB..SBEDhACAGAGAMBEB..bBFATEFAhAIALDGBHFCARCBBAEEAhAGAOEHDQGEC.WEHHKCFDCHHD.NIBB.hBAA......hBIA...,1,-9,-14,5
VTbFUDZOYaCPNXBcefMIJQSgWdGLAEHRK,HAAARAAAKADC.TAEAFAFD.ZAGB..aAHBCCAD..XCCAeBHHMCCBhAAAQEAA.SCHHhAAAdDDAADGBEEHFUGGBhABAODED.PEGBBFEA.fGAEhACA.gGCAhADA.WFHH.,1,10,-24,34
STKUHQGPCFceNdXAMVYaZLIObWEfBRDgJ,MAAAaAAAZACBLAEA.OAHDEAEARAGBDBBB..SBBAhAFAKCEAHECAGEGAFCDDeCFBhAGAdGCDABBAIEHAhBAA.bFECBGFD..gGCD.hAIA......hBAA...,1,-7,-20,13
RgCHFbdIePVAMJXQSLOUBTWNKaGfZcEDY,MAAAQAAALAEABACA..TBBAKAEAGAGAZBFEEDBBRCDAHEAAhAAAdDDAeDGBAAIB.SDHBhAFAODHDUFEAaFEDDGAAhAGACDCDFGAHIHHA......hAIA......hBAA...,1,-7,-9,2
NVUJcPLgKXRHSfaCEdeMZBWYIADQTbOGF,TAAAGAAAFADA.UAGAJACALAFB.KAHBHCDA.aDBDhAAAECCAeDFAZDEABCHDhAAAIFFAAEIBQFCAhAHA.bFFCOEHD.cFCB.PHFChACA....hBAA...,1,-12,-19,7
PXUBJaAWMIZYbQSFOdHgfGeTDcCNLEKVR,MAAAZAAAQAEAFADDHAFAGBBAeAHBDACACCGA.LCEA.ECCBhABARDEBXDGABEEAAEGA.hAIAIFAASEGAhBGAdGGATFCAKGGA.PHAC....hAFA......hAHA...,1,-8,-16,8
OadVQIPJbDUTfFKLCWRHcZAYXgEGNSMBe,XAAAEAAAGACA.MAEAeADA.dAHAQBECJBFB.bBGBTDAAhAAA.KCDBLEEBhAAARDGBHFFBAADAgEGAhAIABHBA.aCBH.IHHADIDA...hABA......hBHA...,2,-16,5,21
dICEYDOUZBgXRebcGKAfQFSMaJPHNWLTV,QAAAMAAA.aACEHACC.LAFBdAFAEAHBDCDBZBGBXBBChAHARCFA.eDDBGDAAhAAAACIBSEHHhAIAPEDCTFGACFCAOFEDBEHBgGGG.hADA......hAIA...,2,-13,-1,12
gaGEcNbJFCMDTdRXWeZPYBIVALQfOUSKH,LAAAQAAAOADDKACAHAEBGAFAEAGA.....bCABCBHAMCDBhAAAdBHARDEB.eDGBZEGBBFADhABAADHASEAAhAEAaDDHJHAADFIBTEEA.XGAA.YFHBhAGA....hCAA...,1,-2,-12,10
HILGaQZdRWfEgBUYFbTeSVXAKCDPcNMJO,DAAA..PAAAMADAHAFCGADAZBBARAFAECCBBCFA.FCHD.eDBBhAIAXCFA.AAFACDBDJDDFhBAALEFAdFFA.fGEAhAIA.gGGAbFGD..hBAA......hBDA...,2,-20,-17,3
RKVSZeWNCOdHaPGLBAgbMDfQFXYTcUJIE,MAAAQAAAFADD...TACAUAFAEBBBRAEFKAGCZCFE..eBHFhAAACAHAHDDBGDDALEHBhBAAACGBbEAB.DFBB.XGEAhBCAcFGA..........hBFA......hCAA...,2,-19,-3,16
NfPbEVCRLaHAFMQWJceUBGDSZKXIYdTgO,MAAAQAAA.JACEeACA.GAFAZAFBKAHBXBBCdCDAOCGDhAAAfAHE.hBFAECDFRFCAHFFBADFBFDHBcEEChAIADDIB...SFBA.IGHAhBAA...hCAA...,1,-4,-22,18
dBQHVeMgDfPFYNCcaWKAULbGJRXISTEZO,LAAAGAAARADA.SADHEAGEZCDA.dAFAHDGBeAHBMCFA.DDABhAAAFCAACEEA.aCFE.ADDAUEEAhABAXGGAOEHB.hACAQFBA.......hADA......hAEA...,1,-11,-17,6
XKgWdIQCHBMLNOSGTRVeDYEbFAcZfUJPa,ZAAAUAAAaACAKADA..dAFAQAFCHBGBMCCBLAHB.SCBAhADARDDAeEHFEFBBACEB.hBAAJFFB..XDEAhBCAIHAABEHA.GFDBDGIB.FGHD.fHCBhCHA..hDAA...,1,-10,-19,9
GBMUDFcdVOAPeKgHYTCJafXENSWIbRLZQ,eAAAHAAATAEACADA..aAEDEAGE.SCAA.bCEARAGBZCCAhAAAGDCAMCGBFEABdEHAhABAAACAKEECgGAAhAGA.fEEEXEGAIGGALHFABGGDhAIADGCB....hBIA...,2,-15,10,25
JWVDBeYOMKUPdTQRIgAHLZXFGNcfbSCaE,HAAAZAAAGAEA..fADBCADBEAGA.VAGBeBHF.MCABhABAKCADdCCARDDB.AAFALDFAhAAAFEHD.bCDDaFGHDFCBhACAOCCBTFGAQGAAXGDANIABSGDAhACA...hAIA...,2,-3,-1,2
aSPBcANFWGRbdfICDQLZKJgEHUOTeYMVX,FAAARAAAdADACADA.LAFAZAEB.KCCDEAGA.HCCBOCFA..eBHFhADAMDEBaCFDBDFA.AAAAGGABhAGAbEFA.DDIBQGGChBAAUFFA........hCAA......hCBA...,1,-18,-21,3
SKAMOUBdCafHTVGZYgbNPeJLQIFcEWXRD,MAAABAAAaACAHACCGAEAZAFB....bBGDeAGBLCCBQCBAhAAAFEEBEFABRDFFKEDBAAIBdFGAhAFAfEHA.hBAA.YBBFPHAAIHHAWFHHDICA..hAHA......hAIA...,1,5,-17,22
YHMQJUPDbXcgCZVIFWOeTSKEBfGLAdRNa,RAAAaAAAHADB.MAFAQADAUBFA.DAGA..XDAACBBDZBFBFBHDhADAeCHHKCDD.EDDBGEGAhBAAAAAAdFFA..JHCAbFBA.hADA............hBIA......hCAA...,1,-10,-22,12
AWDJfFHVGPIBbTeZMRgLKQdOSaENYUCXc,DAAAFAAAHACBGABBBAEAeAEERAFFLAHB.dDEAaAHD.ECCBUEAAhAEAXCEAAEGA.JDHBhAHAVFGB..bECAMHCAhBAAQGFD.......hCAA......hCBA...,1,-11,-16,5
VFcZAeLXKdDECPORfHMNIaUbQJSBGWTYg,eAAALAAAdAEAEAGAOADD.HAFAMBDBaCAAQCFABCFDGCGAhABATEBA.VEEBhAAAZEEFAAHADBIBRFAAIHHAhACA..bGAASDDDYEHB...hABA......hAGA...,2,-8,-1,7
aAONKdHfJMecVYXGRDQTPEgULCWbIBFSZ,KAAAHAAAMACAeACE.VAGBGAEB.RBCBDCFBTCCA..ECGALCEBhAAA.bDFDFDHDhAAAaDHDAAHAdECD.fFFAhCAAcFAA..YHEA...hCBA......hCEA...,2,-30,7,37
gUOSdBNfEePCbQMcYaFTVILAWXGDRHJKZ,GAAAHAAAZADBOADAdAGABBFCEAGA.eBHHCBHA.MCAB..aCDATDEAhAAALDDA.AAABDDHBhACARFGBKDCDSDBHhBCA.fFFAbDADQGDAFGCAIGHAhBDA....hBEA...,2,-21,2,23
XUCSTbEGWadfNRIKQZLAOegFcMPYVDHJB,eAAAFAAAMADA..PADCDAHBHBCA.BBFBCAGB..TCCAhAAAECHFGDEAdCEARCGBQFFChABAAAIBOEBA.gGCAhAIA..cEGD....hBAA......hBEA...,1,-11,-33,22
TGbYOSIAKQUaRPZLBVCNfFgXWMJEceHDd,QAAARAAAZADBLAGBCACA.FBFB..XADDMAIB..EDAAHAFAhAAA.dCHAGEEAhAAAbDDASFAAACCAaEHBBGHAhABAfFDA.gFFA.hADAJHAA.DDDA...hCAA...,1,0,-20,20
GFPeIUfHMYaCXWRBDVNZSgLAEOcbJTKdQ,EAAAOAAA..JACBdAEAGAEAeAGBUBBBHAGDMCIB.aDDBXCEAhAHA.REBADAIBhBAAZEABLEEAADIB.hBEAbGDATEGA.QFEDIHHA.CHHA.hCAA......hDAA...,1,-2,-18,16
UKJCORYFAcXdbLZVDSWgEIGHBfaTQNPMe,dAAAZAAASACEEADAHAFABCBA..aAEDTCEAQAGA.hACAMCCBeCGHKCGDODABhADARDDBADFB.bDCDLEHBhABADCIBgFFAGGABfFGAPHAACEED.hAHA......hAIA...,2,-3,-1,2
LZQbfaDNYSOdTWJEFGKPRegVIMABXUcCH,XAAACAAAHACAZAFB..QADAaAHD.DAGASCAAhAAAdBFATDAAEDDBGCGARDFAeEABhACAIDDAACEABFFDLFHBhAEAbFEB.fHBFOHBAFGGH..hAAA......hABA...,2,-9,-2,7
CGBJORWTeVZKQfAUSDFYIMgXHEaNcPbLd,DAAAFAAAMADAHABCEAEE..aAFE..PAHBdBDAGCEA.OAHDhBAARCCAeCFHZDGFQEGAhAGAACCAUGCA.SEEDhAIAIHHA.XFCD.cGGChBAACGFA......hCAA...,1,-15,-17,2
bZLEWOdBTAJKQSGeRMaDVcXCHNFfPUIYg,QAAAeAAARADA.aACEDAGA...XBFAHAEBfAGBhAAA.ICHAhADAbCCCEDFFdEAAACDBSDEAhAIAGEGAMBIBCEDDFEGDYEEFZGBAOFFH.BHHAhBGA.....hAAA...,1,10,-19,29
MHAIWRgbJaVBQTKdLEYFZXDCGPNefSOcU,RAAAJAAABADB.KAFAEADE.ZAFBDAIB..GCCA..eCCAOAHDhAFAMCGBHEFAAAAA.IGHAhBAA..bDCAhAFAaFCHQFGAdHEB.LHAA.hBHAFCHHCFED.....hCAA...,2,-27,-16,11
aLPcWObVMCNUZIYefgAdGDTHQXFKESBRJ,GAAAHAAAQADCKADAEAFE.RAFFLAHB..cBGDhAAAbCACMDEBCCDAZCEB.eDADhACAADFBdEHADDCBTFAAFDHDBFGDhADAaFFBOHCC..NHABIHHAhAHAfGGESGEBhAIA...,2,-15,17,32
gQVUSJGfMWbDIZKaeRHYFNdECPOTcLXAB,QAAASAAAGACAMADA.DAEAZAEEeAFAHCBC.FBHDEBHFOCEDhAAALCFBACGBBEGAhAIAgEBBUGEAfGHAhBCAbEDDKFGA..aHEE......hAAA......hABA...,1,-8,-12,4
ADZVOCfSIKRMeaUEBTLFQXbWJGNPdgcYH,ZAAACAAA.SACERACA..eAFEEAFALBHBQBFDbCCAGCAAhAAA.dCCDgECAhABAHDECAACAODHDhAIAKEGDaFABTGGAXGCANICB.cFGDDFFB..hAFA......hAIA...,2,-14,2,16
PKcRFIAbDTaEVWCLOMGeUNSJYgBfHXQdZ,TAAAEAAA..CACAMAEAeACEUAFA..SAGAJBDFBAHAHDEBhAAAdBEAZCCBKCHBRCGBACCBaCCHhCAALEEBGEGA.gGCDhAAAQGDCFGGA.DIFA....hCAA......hCBA...,1,0,-16,16
JLKPGIbgaXUFCAOHdMQYNTDBZecESfVRW,HAAAdAAAMADAQADC.TAGAZAEEEBHFSCAARCAALCFBhACAGCEA.bDGBaDCEhAIAFEDHADFBODHDDEIBeFABhAAAfGGAWGCGKGGD.IHEA..hBAA......hBCA...,1,20,-22,42
dCWNbPGIULFeYOAQMcgSERVBTaXfHZJDK,MAAASAAARACA.BADAaAFA.HAEBZBFEKBBDdAGBCBHD.....hAIAbCCDGCDALDABhAAAeDFHACCBQDGAhABAEDHBTGBAXGGADFFBNIEBIGDA.FGGA.hBAA......hBGA...,2,-15,1,16
AWGKUabeZTHXIEFNVYfJPgQOCMcBLRDSd,GAAAaAAAZACB.HADA.EAGEFAED..VCEAJAGB.QDCChAAAMAIBLDEAREFAdFAAACHAKBBD.hACAUFDA...eFGBhAGAIGHA.NIAB.......hADA......hAFA...,1,0,-27,27
WMOYcHgFIdTCBaKfPVNeZLbXRUDASGEQJ,EAAAQAAA.MADAOACCHAFCFAFAdBDATCCAaCED.KBHBfCGEhAAA.PDCBhAIAeCEEbDFC.REAAAEAAhAAAGEFAJFGB.YFHB....hBCA......hCAA...,2,-15,-4,11
SRLPOKZFVaDXegWbTHYEUMCAcBGNdQJfI,GAAAdAAAQADAJADA..SAGBRAFALCCBKCDAZCEEaBHDeCHHhACA...bDABHCFBhAAAEEFB.MDCB.AEEBBEHAhACAfFHAOFCDDGABXFFCTGEA.hADACGHA......hAGA...,2,-11,-4,7
OSHJaDbYVcIEKPALTFQfgRdNZBeUGCXMW,TAAAQAAA.RACAZAFBeACEGCDAMAFASBDDHCGBDAIBVDABhAAAEBFAABIB.LDFAhAAAfFCAdECABEEDhCAAXFFCOFGB.aFHDYHBGKGDA.FGHDhADA......hAFA...,2,1,6,5
BCAPdDEfZIQUXebOHFSTLJcNMGVWYKaRg,dAAAEAAAZACBQADA.eAFAHAEASBGATCFALCBDhAAAJCBB.MAIBGDCAhACAVEDAKEECRGAACEHAADABfEGAhADAXGGAFHECcFGD...NIDBaGAAhAGA......hBAA...,2,-12,10,22
CLKaETUAIJMXdGBOZeNQgcbfYDRPVSHWF,MAAAGAAAZABEeADA.QAGA..bAEDDCDARAGBSCCBhAGAHCECCDDDaDAHEDHFAAIBXDGAhBAAdFEABGGAOECBhCAANIBB...fEEA.PFGBhCEA.....hAAA...,2,-13,-10,3
FBUIQASTPHYZWNaJbeMdCKcgDGROEfLVX,TAAAHAAAZADB.aAFDeACE.dAFAKAHBDAHBRCFA..ECABLCCBhAAA.FCEHBCCCQDGAhAIAAEEASEFAPFFBhBDANEIA.MIBACFBA.........hAAA......hACA...,1,-6,-28,22
fAKdUBIJTQWeSYMXZHPObLDVCaRGgENcF,dAAABAAAJADAQACA.eAEAMAHBHBFCOBDBLCABhAAACCBA.RDDAEDHFFCEDAAIBKCCD.hACATFFA.SFAAhACAZEFBbFGD.aFHDGGABgGDB.hAGA.NDIA.....hBAA...,2,-27,16,43
MATFfZOERQUaCKIYHSWNXGgcLePVdDBJb,TAAAZAAARAEAUCAA..aACAKBHBHAEB.SAGA.XCCChAAAGCDALDFBhABAeCGFdEEABDHAbFAAAADAOEHBhACAEFHBQGAACHAA....YHDGhAFA...hAGA...,1,-6,-15,9
MDKaNbWYTSAcGXCLHeFEUfOIZJRgdBPQV,GAAALAAAHADAEAEAUBGAOAFA.ZBFERCAAdCEAQDCA.hABAMDABaEAC..bEDATDGAhAAA.AEEACFFAeEHBhACAfFHAgGCABGDADGHBNIDB....hAEA......hAHA...,1,7,-13,20
gdAHYRTMQDIbKWPZVBGXNCaUeELfFJScO,HAAARAAAMADAQADC.DAFAbAEAKAHBZCCAGBFA.CCADeCCBhAAAECFELECBFDHDSEDHhACAOEEBAAAATGGAhCFAIFGA.PHECBFFDaHCA...hAIA......hBIA...,1,6,-21,27
EIACJRPegGUDNaKOLFcTdXWVMZfBYHbSQ,RAAAeAAAGADADAEAKAGALAFA.FCCHdBDA...XBFChAAAMCGBZDAFBCCCHEGBQDFAhABAAAAACCHAJFDB.gFFGhAIAaFFH.OCHDcGAC..WEEDhCAA......hCBA...,1,-4,-33,29
CBcTXYZKAdeObMSJLfIHGNaUDQFWgEVPR,eAAAMAAALAEAHADAaAFA.QBBAFBHDECCB.RCEABBHA.TECAhAFAZCEBAAAAbDFD.SEHBhAIAfDHAIHFAhCAAGGABDEGB.WFFD....hAGA......hAIA...,1,-4,-14,10
fIPObRHaNKFUQBedMJEYXZTVGLCAcDSgW,SAAA..fAAAOACDHAEAaADAFAGAQCEBhAAAeBCBdBEDEBHFZCEEGEAAhABAACIBDDBB.gDGAhAEA.IGGAREFAKFEDMIEAYEEF.hAAA......hACA...,1,9,-25,34
OaIcYCZVHdMeJLFGBAWEQbfTgURSDPXNK,EAAAQAAA..bACATACA.RAEFDAGAXAGA.OCCBhAAAaBGD..IDDAhAAACCGAHDEAeDABLEABhAEAGECAABIBfDHASEHHKEFBZGFAdGCAhCAAFGAHBFED.WFHHhCGA...,1,10,-15,25
JXRBFfWdGacQLVAENKZbgSOeICYUMHDTP,EAAAZAAASACE..eACACAFAMAHBHAFA.TCCA.hABAXCEDRCCAfDFAhAFAGDAAaCHDLCHBhAAAAAIBbFCB.OFFBUFGADGCBBDGB.dGHA..hADA......hAHA...,1,0,-12,12
AJFZTSeOUcGBDIgdPELKYCWXaQNHfbMVR,ZAAAeAAAOACAGADADAGAdAFB.EBGBLBFACCCD..aCHDHCCChABAMDBBABGATDFA.hAAASDHBBDFAgFDAhABAKFFD.XGFAfGHA..hCAA......hCBA...,2,-27,-13,14
RCPDKQAafJVZYBcSGWLXHEbUFedNgTMIO,aAAAVAAAZACB..BADBGAEALAFAHAGDEDGBFCDA.dEBA.TEDAhAGAMCGBREEB..DBBBAAGAJCHBhAAASEHH.hCAAbGFCeHCE.IGHA.CDDD...hCHA......hDAA...,1,3,-26,29
gaWZEPRKLTcVeXICYSBdAUbDGHFONMQJf,DAAAHAAAOABEMACAQAFA.JBDBaAEAZCFARAGFLCCAhAIA.TDFAeEEACAHAhAAABECAACCBbFEAFEEHNICB.fEHAhBAA.EFBB.KGGD....hBFA......hCAA...,2,-23,-6,17
XQCFHTWUcNKPBRfEZAeagbMOLISDJdVYG,eAAAaAAA.MAEALADADAIB.dAHAGBCAQCCAHBEATDGAhAAAUDFAKBBDREBBZEEFAAEAODHFhBAASGBD..hABAVFCACGDAFGGA.NIDB.fGGA.EHBEhBHA......hCAA...,1,12,-16,28
EJXegYdCPFSVUNDGfaIRLcZHWBAMKQbOT,MAAAQAAA.OACCEADAeAFA.dBBAFAFASBGAhAGAUCDAGCGAaCEBLDFAhBAAHEAAAAIBbFDATFFA.hAAAXDCDCGCDNICB.fGDAIHHA..hCAA......hCBA...,2,-14,0,14
PFISedONJTWQKbZEDfUXRMcACaGHBYgLV,GAAAHAAABADBLADAFAFAeAHHdAHAOCDA..TBEAhAAAQDDCZCAAEDFFfDGAhAAAREDBACCAaDHD.gEAAhACAIGGA.SDHH.WFFDhAEADGIB.MHBACHEA...hACA...,1,-4,-11,7
SLFTOEDIWgXYJNQAfdebcUPRZGCMKaBHV,eAAAUAAARADAGADA.MAFAaAGAHBFCLBFBOCBEEBHBDCCB.hADA.IDFAXDGDhAAAJDHBADBBdFDA.bFFCZEAAhAEABHHAFEEHTGFA......hBAA......hBCA...,1,-1,-10,9
baORBdYWAPFIVGEcJgZNTKQfSCHXLDUeM,FAAAGAAAEADA.JADAZAFB..KAGCQCCA.CAHA.HCDALCHBhADAeBHFaDBDREDAdFBAAAABIEFAhACA.VFCAhBCAgGEA.fHGFDDIBMFHB.hBDABDGA....hBAA...,2,-19,-8,11
fSHbQLVDKPNdEcAGFeUaMXOJZIgRYWTCB,eAAAaAAA.MAEAOACDZAFE.RAEA...TBCABAHBHCDBLCGBhAAAKCFAdCHAACIBGEBAFEAAXEGChAEAgDEACFAD.hAFASEHH.......hBAA......hBBA...,1,-5,-23,18
cebLFATIMCYEKUNJHVgXaGSWfZPROdQBD,MAAAEAAAKACAUAEA.HAGD..XAEBGBBASCHHhAIAZAGBRCCAdEEAQGBAhAAADDEAeEBDLEEBABGBCDHA.hBIAYEGFVGFA.WHFA.....hCAA......hCBA...,1,-2,-16,14
aSdDOPeHLTCXbBgRYfcAMVEQFZIWJKUNG,EAAAZAAAJADAKACA..GAEAdAGA..OBHDHAGDTCCA.XDFDhAAAbCAB.REAA..hABA.fCDAhACAACIBMEEBQGABFCFHUFFAaEEHDEIBeHEABHED..hAEA......hAGA...,1,4,-20,24
NGJHBcPgFWdSbLOXKAfZCIEaTDUVRYQeM,ZAAAEAAADADARAEA..eAHHGAEBHCAABBCA..PCEBFCBHdCFDLEAAhABAKDDAAAHA.CDGDaDHDhACAUEGA..QFFChADAMFFB.JGCE.WHAG.....hAAA......hBCA...,1,8,-38,46
OVKdLIePSJAFEDTNaGZYWMUfXBHCgbRcQ,EAAATAAAGACA.ZAEAMACAUCGBBAFAHEDACAHA.RFAA...QBDChAAAKCBDdFHAeHAASCCDhAHAAAFADGGB.aCFD.hAAAfCHA.bEEC.OEHDIHEAhAHAFGGHYFDFhCAA...,1,1,-23,24
ZOGRDXaVJCIQWYSdebUFPNHKEMgLfcATB,ZAAARAAADADAaACA..CAFA.QAFA..SAGHeBHHbCCA.hABAFBDDHDFBECFBMAIBhAAALECB.AEEBTFAAhAFAGDGAXEEDIGHAWHBA..YCCFhABA...hAIA...,1,-3,-29,26
eMcVJfgSRBdaCPQZEXYTIHOGbADLNKUWF,LAAAKAAAFACA.eADHMAFA..VAFA..JBEBSCAAhABARBGBBCCA.aCED.QDGAhACAEDFF.TFAAhAFAHFGBbGBAAEDBDFFB.UGGA.fGDAhAIAdGFC.....hAAA...,1,6,-32,38
KWaReSVDJbGMNUXFAYHBOPgQCLfITcdEZ,HAAAOAAAQADCLAEA.TAGAEBBBZBDAaCACRCGF...eCEFhAAADAIBGDDAMCGBXEGDhACAAAFABFGDCGHAfFAAhAFA.dHDB.KCHB.WDDD...hBAA......hCAA...,1,20,-27,47
gBcIeLDYMTHUOCfNGXQAaJSKdPbZFVERW,aAAAKAAAdACAZACB.FAEARAEA..BAHB..eAGHLCEAMAIBHBDBhAAACBBDGEEAADHB..SEFBhCAAVFAA.EEHF.hAFA...WDHHgFCADICA.YFFFhCBA....hCFA...,1,-21,-30,9
bDGfKSBYaZVTNAOHXREPdLeJQIcFWMgUC,HAAAEAAAdADAeACE.QAFCFAFAMAIBUCFADAIBGCCA.SCFAhAAAaBCBZDDB.TEFAhAHAADDBRFBBLFFAhAAAIGHA.cFECCHDAKHFABHHBNIDB....hBFA......hCAA...,1,10,-13,23
gZGNBbUKYEMVIJHLeFOPafXWAQcRSdDTC,RAAAdAAACADB.GADABAFA.KAFA..EAHBMAIB..JCCAHCAC.eCFFhACAOCFDaCGDXEGAhADAAAAA..QFAAhAFADFAAZFAE.bDGDYHAG.IGGAhAFAFEEHfHCFhAIA...,2,-43,4,47
DAUOLZMVcIbXYJCTFRQaNSfKgBGHdPEWe,LAAAZAAAMACA.VAEA..IAGA..bCAAXBDDhABACAHBRCFA.aAHDSCEDhABAKCGDGEEAHEAAEDHFeCCDhBFAACAAOEFEJFCFFGHBQGGA.NICB.hACA......hAEA...,2,-6,1,7
ENBWRYHZbPIAVXfgDKGQdMOcUSCeaLJTF,XAAADAAAGABBdADAMAEA..OAFASAGAeBEHaBGCLCCAhBAAFDBA.ECGABDFAhAAARECAHEGBZDGB..bGFAADIBfGCEhCAA.QGECCFFCNIBB.hABA......hBDA...,2,-16,3,19
GDEdIJNWUHSCQPLXbeZfYVKcagMTOBARF,RAAAGAAAEADE.dADA.JAFAUAFA.HCCAQCEALBHBeCHBhAAAZDFB..fECEhAAAKDDDaDBD.MEEBBEGAAFHADGHBhABAIGDA.SFFD.XGGBhACA...hAIA...,1,-14,-15,1
LEDNcSUKIeTHbdVfQMAPFYaOgXGJRZWBC,FAAAaAAA.OACDGACAZAEACAEA..LAGBDAFA..SBHHhAIAKCEBeBBDHEAAdCEAQEFAhBAAAAIBPDHDXEEAhAEARGCAEGHF.UGCA.IHGA..hBAA......hBGA...,2,-23,-3,20
EBLdUGYKQMbSVWNAXCJDFReZgHacTfIOP,CAAAFAAARACA.eACHHAFB..aAEA..TCAAOAGDEAHBLBEBhAIAGDDAQDGAhAAAMBIBSDDDVFAAAACADDGBZGFAhAFAfEHE.BFFD.dHGB.YECFhBAA...hAIA...,1,3,-10,13
MBXHPFLJaefcgbIRVTYSQKOAdDEZNUGWC,EAAAZAAAGAEA.MAHBHACALCABeAEEfBHA.hABAbCCARDDBTFGA.hAAAQGAAAAHAdDGDDECAUFFAhCAABADBFGDHaGCA.cGFC....hACA......hAGA...,1,-2,-10,8
fCOGJgBRcWTAZXNDMYHdEVLPQKeabIUFS,ZAAADAAAHABCEADELAFBQAECKAHB.eAGH..aCAAUDDASCEDhABAOBHDGEGAhAGABCHDREFA.TGEAADDBMFCBhACA.dGEA..........hAHA......hCFA...,2,-19,-8,11
VBPGeZRYNLbSWdDaJfQMOCUcFTgHXEKIA,BAAAeAAARADALACA.SAFHdAGAaBHDQCCCMAHBCCCA.hAAAFCFHHDAAKEAAAAAAGDFAhADAZEEA.bEDDDEIBOCHDhAEA....cGGC....hAEA......hAIA...,1,-7,-25,18
IQXEOMJCVWAaFSKfHLRPTdBYebZUgcGND,aAAAKAAAHACBLADARAEAdAHABAHA..eCABZBBAUCFAGCEBDCIBQEEChAAA.EEHBhACAMDDBCFAD.AAEAfEEEhAHATGGA.bGFA.......hAEA......hAFA...,2,-30,-5,25
IDcLZUBfdFHEYPGWVgReCSJNOaMXKQATb,TAAADAAAZABEBAFA..dACAHAGBEAEAGAGA..gCCAhADARCDAeDHHSEAAhAAAOCFBMDIBQFEAhAEAAAIB.bECDLEGB.FFAA.YEEFhAFA...hAIA...,1,-3,-20,17
CRDGdOLPbNVHJZUgaWFfAeTIMSEXBcQKY,eAAAMAAA.EADABADAKAFA.RAEFGAGALAHB.....bCCAHBBBhAGAZCFBUECAaDECfEHAhAIAAAAA.TGDAhBAAXFGAQGFCDCCAdHEB.....hCAA......hCBA...,2,-13,-6,7
WXMLZfFdIPSEDHJBbVgcAKYCaRTUQGeNO,CAAARAAAQADCGACA..eAEAOAFAMAIBZBFEdCAA..SCCDhAAAHCEABBGAbDDDgEAAhAAAADHA.aEEChACATDFAUEGA.XGBC.LFHBhABAIHHAEGGF...hAEA...,2,-14,3,17
RbHSEdXYAafCUcIDJGZNOTPMFKgVLBQWe,aAAACAAAUACA..DADAZAEBOAEE..MAHBKBBDLAHBhBAABCBD.eCDAHCFBEDBFdEBAhAAAADGB.IFHAGECATEEAhBDAFDDH.QGGARGBAXGGCfHEBhCAANAIA...hBCA...,1,-4,-23,19
XVecCDBQGFbEMJgOTaRfLIZHNKWYUdSAP,XAAAeAAADAEAGAGAFADA..EAGAMBDAOBCDRCCA..LEEBhAAAHCEAKBHBUEGBAAAAPECBhAGACFCABGHD..bEEAhCAA...JGEA........hCBA......hCEA...,1,-13,-26,13
RCVbQBgSWcTEMYZPLNUIGdFDHeaJKOAfX,RAAACAAA.QADCBACA..SADH..TAGAEAFAZBFEhAAALCCAUCAAdDDAHCFBhAAAeDGBaDHDKFAAAAFAXFFChABA..bFEDWHDAMDIB.PHBAhACAIHHA.DEEBfGGEhAFA,2,-24,-13,11
JZNRXBbaeAcTGdQLUHPDIWKgEYOSfCMVF,GAAAdAAALADAHADADAFAKAHB.EAHFOCAECCDD.FCEAZCEB.RDGBBGDAhAAAeCGHAAEAQGFChACA..IEDAhACAYDAFMDIB.VFEB.JHAA...hADA......hBAA...,1,-10,-17,7
MIeEfLPAWHJBaTFRDVUbQGCZYdcXgSKNO,HAAAaAAA.RADFDAFAUADAGBFAZAFB..dBHAXCAAKBBD.MAIBhAAAEDBALEDA.hACAAEEABEHATFCAFFBBbEEDhADA.QGGCCGGA.YHBASHCAhAIA.....hBHA...,1,-4,-26,22
WFNBRaCKILXfMGEgZcPVOHdQUYASTbJDe,TAAADAAAeABA.FAEDRACFKAEC..LAGBMAHBGCDAECCBZDFA.hAAA.VFFAHEDAdDGDQFGDhAIAAAIB.bGBChBAANCAAaFCBCHHD...fBFA..hACA......hCIA...,2,-14,-4,10
VeNBFPUJGLCaSTRdYZDKfWOXgEQcAIMbH,MAAAHAAAeACEFADD.UAFAGAFALBHBaAHF.RCCAZDFBKBBBODDBhAFAEEEFACCA...IDHAhBAANIABBFHA..CHFA.dFBAhBBA.fEFE.XFDD.hAAAgFGH.hAIA...,1,-11,-12,1
RATbHdcZLKaCIWUNMGXgQfSPDVEeFJOYB,HAAAZAAAaACACADBUAFA.GCABQAFA.SBHBhABADAIBEDEAeDGFOCCBBECAADEAdDGAhAFALFBAKEEBIGGAhAIAMDIBXFGD.fHBBhAAAFFCD......hACA...,1,-13,-15,2
acANFEUeKMYgOXPWLQRBZdGDHVICSTJfb,EAAAeAAAKACAMAEA..OAEA..XAGALBFARBCAdCGAhAAAHCCACDBA.TDFAJDEBaDHDhABAADHAFECH.UFFBgFBAhBDAPHBA.QGFA.BHHBhBFADEEBSGHHhAAA...,2,-16,-5,11
fDdGMQXaYTWcKPLZIJOSeCVNFHEgRUBbA,dAAAGAAAMADAaADA....TAGAKAGAZCDAOBDBeCFECEBAFBFHHECBhAAARDFABCBAAEEA.QEBChACAXEFA...hACA.cGAALFFASFHHEHFAbEDDDIAAhAIA......hBAA...,2,-7,-6,1
QPEKOLDZMRVBHFYIaWeTXdbgSNAJcGCUf,GAAACAAAUACA.QADA.EAFALAFAZBGBRDCAHFDAFCBHaCFAhAAAeDAD.dFHA.SGCDhAAAAAGAJDDA...hBCA.fDHA.OEBEMIEABCFAhACAIFFA.TGDAhBEA..,1,7,-36,43
MPIgGFALTdeHBVJDcOCUWaRbfKXZEQNSY,dAAAHAAABADADACACAEAUAFA..RAFFKBHBECBA...QCCAhAAASBHBMDFB..gCEGhACAAAHAeDGFJEHBODABhADA.aDDH.bDGD.ZFBA...YFFFhAIA.IHHAhBAA.,2,-25,-25,0
EMOeKYdfAVXPWgJFaCSTcRBUZGDLQNHbI,XAAA..gAAAaADA.TADARAFFZBCBGCGAhAAALAFBHECCEAHBeCCBhAAAdGFAAAHA.PCHBWFHH.CDAABEEAhABADBIB.bFCC.MFIB.KGFA...hABA......hCAA...,2,-12,4,16
bTRGHeWPLYDFAcIQJXMZENdaOUSBfKgCV,QAAAMAAAZABEdAFAaACE..OAHBBAFAKAHB..CCCA.bCDARDEAHECBhAIA.eEHFLDABhAAAFGFBACEB.IDHAhADA.EDCBSFBDfEEA.TFGAhAFA.PFCBDGIB.hBAAcGFC.,1,-8,-10,2
XBbWJZRMCNeEVDFIUgAdaTOLGSHYfQKPc,aAAATAAAGACA.HAEAQACCKBHB.XAEBBCFAbDGDZAGBhAAA.RCDBMBIBeBBDEEABhAEAFEGBIGBAAAGAdEEA.hAIASFDA.fFHA.hBAA......hCAA...,2,-10,-1,9
QKbXRSGILdMFEaYNPZBVHeWUcAfCTDJOg,TAAAOAAAKADA..RACFGAEAdAFAFAHB.EAGA..aBBC..PBHDhAAAZCEAHEEAeCABUGEBhBAAADEBDDGB.QFFBhACA.bGAAIHHAMFIBBHEAWDHH.hAEACDDD......hAGA...,1,4,-23,27
GAJeSFcDYCaMNbHVKLdWBUZEQgOPfRITX,eAAAFAAADADACADA...MAGBHAEB.LAGBdAHABBCAECCB.QEDAhAAAOBDD.RFFFTGBAhABAABFB..SDEHhBAAaDGE.bDGD.KGEA.....hAIAWHBG....hBHA...,1,0,-52,52
HCWLFTYbRaADMNPIJKUQZgVdGOEecSXBf,MAAA..IAAAKADAZAFBdBBAEACAeAEA..XCGDhAFAHBFCLCAAFDCD.bDEBhACAAAIBDEEBPDHDQFFAhBAAGECASFABCFHA.TGFAhAFAaHBA......hAIA...,2,-27,2,29
SfdCVcYgTPFHWDEaeBKZLbUAQNJRGOIMX,QAAARAAAGADAMAFASACA.dAFACBFB..VCGB..hAAAgBGHTDAAHDEBhABAECDBeDABKFHBLHBAhADAAAHAODEDfCCEPDHDDECBaGGHbECD.hBHANEGAIHHA.hBIA...,2,1,1,0
aFRecALEQfOSHWJVYgUMBPDdCZbTKNIGX,EAAAQAAA.SACAHACAVAGBUAFAMCCBDAIBZDDAKCDAGEAAhAAAFDAA.REGFAAEALDGBhAAAOFCD.JEEBYFFFhAGABFBAdHBB.bGFA.......hAIA......hCAA...,1,-1,-11,10
ZLAHIeUDTSbYNGadCBEgXMFRJKWQPcVfO,HAAAeAAADAEATAEA..SAFA..bAGBGBCAhAAAdCADECEBMAIBRDCBKDHBQCEChABAcEAA.OCGDhBEAABIBIFFAUFGBaGCABFHD.FGDDWFFD.hAAA......hACA...,1,-4,-7,3
cYZbDKUOeCJNdaMVBGPXgRTESWAFIfHQL,FAAAHAAALADAZADBKAFAeAHHCAHA..dCCAaCACMCFAGCEA..hAAAXDFAREGBEGCAACCA.QEAChAEA.bCDDhAFAOHAC.NIEB.BFGD.TGDA.hACASGHH.hADAfHAB.,2,-14,2,16
DKfBOTIGXLcgMPWaQVUbFZRSAECJYHNed,EAAACAAAHACAdADA.KAFCOAFAGBGA..LBCDMCAB..aCCCQBFChAAAUCEA.ZDDFhBIAAAIBJFFBeCHFBHGATGFAhCAA.XFCD..gEAHhAAA.....hCBA...,1,-13,-19,6
RTUEfOKaYebQVCINXcJBGAPZgLMFWDSdH,ZAAAMAAADACAHACCRAEA.EAFEKBHB..eAHH.QCCCCCCD.hABAXCFDBCEDAAHALDGBhAFASBBDdEEATFCAhAHAOFHDbEFA.IGGA.NIDB.cGCAhCAA....hCBA...,2,-46,15,61
YgNeRXEIDKdUWZFJSTAcaLBCPQGfHbVOM,aAAALAAABADA.QAEAHAEB.OAGFMAHB...gCAAhABARCCBEDABKBBDdDGDZDCBSCHHhACAAAGBCEFD.hADAGEEAbFGD.NIABIGHADAIB...hBAA......hCAA...,2,-21,-2,19
DWUecEJGfCLQTKaVPbROZYAHIFgSBNdXM,HAAAFAAABADAdADAMAFADAFA.UBFA..EAHFGCABLBFBTEEAhAAAKCCA...aCHDVDABhADARFCB.ZDGBAFHASGGAhACA..XECD.eEEBhBAA.fGHAhCAA...,1,-4,-35,31
FJKUCWYPDIcNRLfQBVZeOdbaSXgMETAGH,HAAAKAAACACB...PADADAEA...IAHARAFALCCA.QCGAhAAAZBDEeCABbCEAhAAA.aCCHXEBAhAIA.EEEAACIBGEEAFFGA.WEHHcGGCBHGDhACA......hEAA...,1,-6,-27,21
SYcCFWfdeQZBDXMVIaAORUPKJLTgENbGH,RAAAKAAALADBEACE.GAFAHAEBSAGA.CCCAFCGDdBHAeCCDhAAAZEAADCIBMEEBaDEH.hAAAAAFBOFFA.PHAAhABATFGA.bGACcGGC..fGFEhAEABHEA...hAHA...,2,-17,-8,9
CLKbPMGaefcFAYdTJXSEgRVBHZDNQOUWI,dAAATAAASADA.RAFF.HACBZABBDAIBQAEA.OAGFhAAAIDDALDEBhACAKCHDMDFBeCHHFEAAAAIBXEAAhAEAEEGB.BFHAUGGBbEFDaHAAfGDEhCAA...hAEA...,2,-20,9,29
GEgIBQNJeOMUVcdTFCKSLAfbZDYHXaPRW,ZAAAHAAAaACARADFEAFE.BAHBQAFA.eBHHMCABUCCBdCFATEGAhAAAKCFDAEGB.bDADXFAAhABA.PEHDhAFAgFDA.ICHAOFFB.FCCHLHBAhAIADGGB...hACA...,1,0,-9,9
NZPfBFCVeERULbYgXJQWSKdDOcAaGTIHM,GAAAHAAAZADBBADACAFA.EAFARAGFLCCD..bBFAXDEAhAAAQCDCKCADdEHAODAHhAAAACIB.aDFDMFFBfDHEhACAeFDF.gFEGSGGDDGIB.hACAIHBA..hADA...,2,-20,-2,18
PLXeEYOgaFHfTAMBRcGICQUKWJbDVSdZN,RAAAGAAAQADCKADA..JAFADAFA.dBGAZCDALCCAECGE.OCHDhAAAaDAHHECAAAIBMEEBhABABEGA.CFHA.UFFA.hAAA............hACA......hADA...,1,-22,-29,7
caGfUNIEKdZFOYAVSTPBQLgWbXJCeDHRM,TAAAQAAA.LADA..bACBCAHAHCBCRAEAMAIBGCEAhAAAUCEBEDHBZCGBOEABhAEAACCBSEFDBECDXGCAhAFAeFAAaFHHfHABKFHBFGGH.PHCAhAAA.....hAHA...,1,3,0,3
YOIgJNGMSHPBUCTWAefcRZKVDXbaQEdLF,eAAARAAAZADBDAGA..aADDdBFALAFA.OCCBIBHAJCGBGEDAhAAAHDAABCCCTGAAhABAAAAAKDGA..XGGAhAGAEEEBFFCB....NIDB.MCIB.SDEBhAHACFHA..WHFEhADA..,1,-14,-23,9
MWTIceXEbOGQaDALHVKBPUFJNfRCZSdgY,HAAABAAAFACAJADARAGFZAEB..dCADMAHB..TCEAeBCBEDFFGDCAhAAA.DCIBAAIBLEHBhAAAKEGAUGAA.CECDSEEDhBGA..gFFGIGCAXGFDhCAA...hACA...,1,-16,-23,7
HBRZYQPFIWKUCXMEgbSNDfceTLAaOVGJd,aAAAGAAAHACBRADAZAGBQAEAFCDH.KAGACCFC...ECGASCHHhAAADBBBeDEBADIBODAHhACAdEAABEGA..IEFAhADAXFDDMFHBgGGAbGAA.NIAB..hAEA......hAGA...,1,0,-19,19
PSVYeHTcCXfGFMALbgQaJOURWKDNZdEIB,LAAAQAAAaADDOACC..RAFADCAAdAFAEAHBBCEA.SCGAhABAeCDBHCFCCDDDGEFAhACAAEAAbEAAUEGB.KFEBhAAAZFAAIHGA..YEHH.hAEA......hAIA...,2,-21,-2,19
gaOXPFMRDeCWZfdbTcSUNIKHJQVLBYEAG,aAAAXAAA.FADARACFeAEE.ZBFAdAGA.TCDASBBDhAHAUDGAKDBAHDEA.QECChAIALEFDEFCAAEIBGGDBhBAA..gGBGMIBADGGA.fGGBhAAA.NIEB..hBIA...,1,-3,-14,11
XJaFWRBSPKdNUcTHAVGMLfQECgZebODYI,GAAAMAAALAEAEADAZAFB.eAHHDAIB...XBBAaBHHRCDBBDCDhAAAKCEAdECAUEGAHEEAABFB.hACAQFAACFFC.hADAbGEAIHHA.......hAFA......hAGA...,2,-20,-8,12
TAIdBReJHZUYbKfCLNFSgDXMcVQEPWaOG,dAAARAAAHADBZABBUAEAKAFALAHB.FCCHDAHB.MAIBQCFAhAAA.EDABaDBEGEEAhABAADFAeDGFJEHB.bFAACEDA.hBAA.SEHH.XFED.hADAPGBA.OHFEhBDA..,2,-22,1,23
IgSPFcRHfWZTNDKAYeVLMEGCdQbOUJaXB,eAAAMAAAGACBdAEAQAGAOAFAUCDB..aBCDBBBDSCEAhAAAFBHDHDFBZDEETGCAhBAAKEBAADIBLFFAhABA.EGAACFHAJHEEIHFA....hAGA......hBEA...,2,-13,-11,2
QKCEbIFaUHSVLfMYDeXNJPRBgAZTGOWcd,GAAAOAAAdAEAQADAKAGA.EAFAFBBHHBGBLCGBMCDBeDADhAAA.XEDDhACAPDCCRFDAAAIBZFFB.cGCChADAbEBCUGABSEHH..fFHAhAGA.DIDABHHAhBAA...,1,13,-12,25
OQYRFMGWeZUgaKVJLXcATfDbSHPBNICdE,TAAADAAAHABC.BAEBCACB.EAGAQAEA.RAGBGCCAhAAAeBHFZCCAaDHDKECALEABhAEAACEAbFFA.SEFBhAIA.IGHAdGAAFGCAMIDAgFDHhBIA......hCAA...,1,-4,-14,10
fdEaUBICbKYGAPWNRJOXeHVcSFgZQDMTL,...PAAARAAAXADBHADA...SAFAZAGBMBIBTCCAhAFAdCCAEBHFBCFACCFC.bDFAhAAAGEEA.AEEBJEHFhAGAeEDF.FFFA.QGAA.fGHAhABA...hBAA...,1,-5,-16,11
FXDWKUbJgTNCSaGRedPZEAIcQLVMfOBHY,QAAAMAAABADAHAEBFACEDAFAKAGA.UCBAJAHB....TBEAhAAASCGA.RDDFeEHBhAGAZDCAADDALEGBhBGA.OGDAXFFC.WHCGNDIA.CHHD.hAIA......hBAA...,1,-19,-23,4
KFfBANecYWTdHbPJQGMZISCDLUaVgREXO,eAAA....cAAATADAHADAJAFAGCCAZAGBCCAALCFDhACAaCFA.RDAAEDHFKDHBBEFAhAAAAAFA..NEEAdGGAbFDDMFHBhABADFIB..........hAIA......hCAA...,2,-21,-6,15
RHXVTcKJaZODFYWESCGQLPBdMgUfNbIeA,HAAATAAAKADC.ZAFBFACAEAHFGAEA.LAGBdCADMCEBfCCAhAAA.bEDAABFBRDFAhAAA.XFFA.hAIAJDCBaCHDDFIBSFGH.QGBAhBGA....hBIA...,2,-16,-9,7
IUDSROgXdTbaYKEeMAVPCNfQcGFLHJZBW,CAAAQAAAGACAHAEAZACBBAEAUCGARCABOAFD..dDFCaAHBEEDFhAAAABIB....PCEBhAAAfFGA.LHAAhACAIDHASAGETFFAKGEDeEADhAEAMFIB.....hBCA...,1,-5,-20,15
eLNBUKJMDdGaXQRFgVEcYOfWbTSCZAIHP,HAAAeAAALAEABADBKAFAMAIBGBCA.aAHDRCAAFCEA..ECEEOCGDhAAA..bDGDTEDAhACAZEEBAAAA..IFAAhAFAPFAB.UGCAdFGD.......hAFA......hAHA...,2,-19,-1,18
SaJXcIORLAFGTeUYQMHgKDbNdfVBCWPEZ,GAAAeAAAQADAHADADAFAdBHABAFACCDD.EAHBZCEB..aCCBXDGChAAAOCFCAAAA.TDDAhAIAMDABKFGA.fHCBhACAPEGBSEHBIHHA.LHCAhCAA.....hADA...,2,-20,1,21
JQeZcCWKbTGDIUXSgHMaPLRYAOdEfVFBN,EAAAFAAABADA..QACAeAEHZAFB.CAEAKAGAGCCADCCBUCFAhAAASAHHHDDBaDHDRDABACCB.hADA..dGAA.fFGEhAGAVEFAJFEF...WHDAIHBA.hAIA......hCAA...,2,-20,-15,5
bGPMXCERZYBgQDdWcLAKNTeIfVUaJSOHF,TAAAeAAA..IAEAUACA..aAEEOAFDHAGBGCEAhAAA.MDDBEAHBRBCBZEGBBCHDhAAAQFAAdECDLEGBhABAAAIBfGDASFDA....hAIA......hCAA...,1,5,-25,30
AJdHPOKBcUWLQVEXeFgZIRMaGNCbSYTfD,HAAAKAAABACBUADALAEAEAFA..eAHFZBFERCCBGCAB.bCFDhAAATDGA.AAFAdFEAhAAAOCHD.QFDChACAFGGAMECB.aGGASGDD.DIAA.hCAA......hDFA...,1,1,-25,26
eUEPYGcIRbDOKJZQXSVWTfHNdBMFgaACL,eAAAEAAAGACARADA.OAEAZAGBQCCC.SCFDhAAATBGAHBEBdEAAMBIBhABAaCBHAAIBLEEAUFFAcGADhAEAbGEADDIB..XGCD...hAAA......hBCA...,1,2,-8,10
YagIXbVKDcSNHEBJdGefPOQMWCAULTZRF,TAAARAAAFADA...aACAXAFD.KAHBSAEH.hAAAHAGBECCAdDEAeBDDODGBhABAMCCBAAGBZFGBgDEHhAAAIHAADHDABDHA.fFGAhAIA.WFHH...hAHA...,1,-8,-30,22
fXPROUBEZeGFbdYAWMCTIcLSKNJQgDHVa,MAAATAAALAEA.KBBAQACCHCDAaAHD.XAEBhAAA.RAGBBCDAEDBBeDFAhAFAbCFDAAIBCEHASFCAhAGA.gFFBfDEA.ODHFhCAAZGCE.dGGA....hDAA...,1,4,-14,18
eLHEdcWIVNgaXFRUGCBADfTJMbZOSYQPK,TAAAMAAAZABE..SACBQAFAeAEAHCCAdBHA.ICEAhAAAgCGA.aECChAFARDEAGEAAAAIBDEIBbEEDOCCBhAEAKHBA.EEHFcGGAVGCAFGGH...hBAA......hBHA...,1,15,-11,26
CEAFGZOUNYacKXHfMPeWDIBbVQTdRJSgL,ZAAAOAAAUAEA..aADDKAGAHAFA.MBBBeCAB.DCCBBCCD.hABAQCEDRCFA.hACASCHBLDDBAEHAhADAGDGANIAB.XFAAfFFAIFEAhAFA.....hAIA...,2,-36,-7,29
aQXVbfJFPAIZNYLOWgUMTBHRSEDeCdGKc,ZAAALAAAOACAUAEABAFAHAGD.ECAAeAGHGDCAKCCDQDEChABAXEEB..bEGDhABAFCHD.AAIB..IFCAhCAAYEBF.MCIBRFGBCGFD.aGDD....hACA......hAIA...,2,-23,-1,22
HeJUWFVZRDGafYSLKICBTEbMgANPcQXdO,...PAAAQAAAdAEAHAGBeACAUDBAFAFDRBGFGDEAaCDBSDAAhAAALEGBCBCAEDFBMDIBhAGAAAHA...XGBAhAIAODHDVEDB.fGGA.hBAA......hBEA...,1,-2,-8,6
XVgKQBWcOUbEPITJdCSeaNZDLfAMRHGYF,HAAAGAAAXADBKADAQAFCBAFAOAGDEBHF...TCCAhAAAdCDAeDADZDFALFCAhACAAAABRDFBFFDA.VGFAWDHHhACA............hADA......hAHA...,1,-6,-16,10
NcEUPbaQdDGLeKMTZJfACXWRYSFVIgOHB,XAAARAAAFADA....IAGAHADABAGB.EBHFUCCAaCDCdCFAhAAAGCFAeDABMAIBhAAAZEEAADIBCEHA.SFADhABA.OFHDPFCADGGBLHCA.hADAKGHB.....hAFA...,1,-6,-19,13
KDfMaXcVgWFCbSNRJTGQIBeOHAdEUZLPY,EAAAZAAALADBKACA.MAFAaAEA...XBFAVBEB.FCAASAHBhAAARDEA.GCCAhBHAQFBAeCGHHFFChCAAABFAdFGA..........hCBA......hCCA...,1,-15,-20,5
DPBTXVWGLSQNJCHREOdIAfFZUYMKceagb,ZAAAMAAAeACE..aACEDAFABAFA..TBFAXAGDGCDAhABALCCAQDGAhAIACDFAHDGBEFFBdECAABHAFHGEKEEDbFABhAFA..WCCDSGGA.NIDB..hCAA......hCBA...,2,-15,-7,8
AcdfXRQIPTNHKOCJbMeaSELBgWVDZUYFG,dAAARAAAQADC..TADAHAFBCAHAbABDeCCB..EAFELDHBhAAABAHB.gEDHhABADCFAZCFEFDAHAEHBXFAAhAFAIEDAKEGAMFGBaFFCSGEHhAHA..WGEG..hADA...,2,-29,8,37
fDEHbPGNcFJCUYRZLMXeKSVQdITgWAOaB,aAAADAAAHABCGACAFAEAUAFARAGF..ZCCAMAIBKDGD...QDFAhAEAdECA.TEBAhBAAACIBBEEDEEEB..bFGDcGGAhBBA.CEHBLHBA....hBEA......hBFA...,1,-3,-35,32
XRJLcUMSCYGIgEQFVDTKNdBWbeafHZAPO,XAAARAAALADBUADAMAFA...CBFAGBGAEAFAQBGAhAAA.DDBATDEAdDEAbDFDhABAeCCD.HFBAAEHAOFHDhAIASEHH.gGFBKHFA.hBDANIBB......hCAA...,2,-15,2,17
fNHJaPbIXTKCBZRcULGMDSQWeAOVEYgFd,EAAAFAAAdADAHACA.aAEA..IAFAKAHBZCCARCGBLAHB.GCEAhBAAMECBQEEBhAAAABHBOCCB.gGCHhAHAfEDEPFHDbGCCCGGA......hCAA......hCBA...,1,-1,-21,20
WScHKTAMURfCIgdGFENLOBPVQebZYaJDX,RAAACAAAdACAEADE.LAEABAFB..QBGAeAHHZCBA...aCCAXCEBhAAASCEHHDFBhAFAAAAAMDDBIGAAGEFAhAHAODHF.........hAIA......hCAA...,2,-26,-14,12
KHfSgEDXIFMUYNbLQGZVRPOaAWcTdCeJB,TAAAeAAAKADA.HAFBSACBDAIB.FAEAMCCBUCCB..bDCDhAAAGAGA.RDEFaDHDhAAAAAHBdDHABEBDEEEAXFADhABAIGDA.LGFAZGFE.....hAIA......hBEA...,2,-12,-5,7
NbBXARGOMZdQfSUCJWVFEcTLaIDYKPegH,RAAAGAAAZADBdAGAQADA.SAFACBFCJCHB.FBHDEDAATDCAhAAA.LEFAhACAaDED.DCGBKFGDeDADhADA.HFDABGDAAGABMIAA.fGHAhAGAWFHH.....hAAA...,2,-49,22,71
UKIEZHOQXGWJCRgMFAScBYTVDLdaNbPef,BAAATAAALACA.aAFDbACB.eAEAKAHBZCCAHBFC.QDEAhAAAGCGACDAAREAAMCCBhAFAAADA.SDGAhAIA.cEDCDEEBdFFAfFHAEGDBOHACWHFAhBIA.....hAAA...,2,-20,13,33
PZVNKREdISbTLfeYcWQOBaHUCMDgAJFXG,XAAAZAAAKADCRAFA.dADA....SCAAbAED.LCEAhABAeAGB...cDDChACAQDBA.aAHFhAAAHEGBMDIBACIBGGABPEEAEFGFfFCBhAGAOGCACHHADGFB...hABA...,2,-16,-6,10
TZbCeOWMUGBKSADJNLPcVYIEQgRHXdFaf,DAAALAAA.VAEAEACARAEA.HCCAdAHAFCAAaAHD.ZCEA..eCFHhAFAMDDBGDGABEAAADIBPECBhAHA..IEEAhABA...QFGA.fGEAhACACBBDOEEH..hAEA...,1,-8,-30,22
gNXUeBYVTaPMbJEfKZdCOARDIGQWSLcFH,RAAAGAAAQADCLADAHAFBXAGDBAHA..TDDAaCDAbDDAhAAAECHF.ZFAAdDHAAAAADCCBhAFASEAAFEGH.gFFGhACAeFFDPHACMIAA.KHEACHHA.WFAAhAEA......hAFA...,1,9,-4,13
dZCKNXDOMfAELHbQBWgaUYJPFSeGIRVTc,HAAAQAAABADBaAEDUADA...JAFESAGAGCEBRDBA.TCCAhAAAZEFAKGGADCABMHCAhAAAECFALDHB.hBCAbEEB...gGAA.FGGH.hBDA......hBIA...,1,-2,-20,18
deTGFZHNUDbXESMLCfOPRYVacIKAJgQBW,QAAAdAAAeADAGAGAHACADAEA.EAGAMCCALCEAODAAREEAaCHDhAAAKDEAAAIB.BEAATFCAhBIAZEDAUGBA.SDHHhACAfFHAPGDC....hADA......hAEA...,1,-2,-12,10
gSNARaTQXEODJMZdBWCVIGPKcbUFfYHLe,RAAAaAAAQADC..EADADAFAZAFBdBGACAHAGCCAKCCD.UDAAhADAFDEBHEGBeCGHSDHHhBAAAAAATFCA.OEFHhBBAMAIBBFFC..IGHA..hBFA......hCAA...,2,-20,-17,3
ReZQUEWaJVgSDOcIPXbBALCYHTdGNKMFf,LAAAHAAAGADAMAEARAFAeCABZAFE.ECCBaBCE..JCGB.SDHHhAAAOCAB.IFDAhACAbCDAACHA..TEEAhABAdFADFFFHQGGA.WHDGDGIB..hACA......hCBA...,2,-22,6,28
LbHUEXQaTFGPgZdKCBJcfVeAYRISMNWDO,RAAAMAAADADALAGBHACCEAFE...QBDAaAHDGCCAZDDAdCFABBFAhAAAJDHB...fDHAhABAABBBSFDHOFFBhAIAbFFD...........hAHA......hBAA...,2,-25,-12,13
LDefOKQUAFcXPVHBRTJGCIZYNbEWMSagd,XAAAHAAARADFGAFAZACB....bAEAEAHB.MCAB.aCCHdCEAhAAAeDFDKCGDAAFAFDHBPDHDhABATFAA..CEDDIFFAhAIAYEEFSGHBDGHB...hBIA......hCAA...,2,-27,9,36
PDBFfZTKGcbLAEXMVCeNWgYRIHUdJOSQa,EAAAMAAA..eACA..gACARAFAHCCAdCHASAEHhAGAaDABBDFAZECAGAGALFHBhAAAAAIBCDDANBBA.IGAAhADA.OHDAQEFCDIAA.TGBA.hAGAbFDB.WFHH..hBAA...,1,9,-21,30
NCGTBFWLMJEcRYUaDAgfXIOPVZHKebSdQ,XAAAOAAAZADBHADAKAFA...eAFEdAHAQBBBGCDBTDAAhAAAFCFBLDHBhBAAEDHFREFBaEEHACGA..IEGAhCAA...PEEBSFHHBGGD.MIAAhABA.....hDAA...,1,11,-24,35
ZQabJeHMNUKRVFdTBCWEYPIfcLDASgGOX,GAAAZAAAaACA.eADAHAEBMAHBKAGA..RCGB.dCDABCCDEBFF..IEFAhAAALEDA.ACIBOFHDhABAbEACUGDAFGAATGGAhACACGGC...PDHDDIAA.....hAGA......hAIA...,1,6,-20,26
BGXQUNTVPZLbCHJIMRgOFDAeaEdKcfYWS,EAAAdAAAKADA....fACASAFBGADAQCBAhACATAFAZAGBLAHBhAAAHDDBMBIBRDEFFEGDACFBeDABhADAaFAAcGDABEHDXFGCNEIA....hBAA......hBCA...,1,4,-15,19
ZBASOcTHCIDYKEQFMePbUWdNVJLGRaXfg,OAAAHAAADACAKADAEAEA..MAFAeAGFUBGAdCCA..JBHBRCCA...hBAAaCFHXBBCZEEAAEIB.hAAASEEACGGD.hAIAQFCC.bFGD...WEHBhCAA......hCFA...,2,-26,-23,3
CMGLKcafDTeQAdEPYHJFWbgOZVXSIUNRB,EAAAHAAAFACD..bADBZADB...SAFAIAGARCAAMAIBGCEAhAAALCFBaAHDTEGAhACAACHBdEECJEHB.OFDHhAAAXFBABGAAKGGDDGGB......hAGA......hCAA...,2,-18,3,21
SgFeAZCHKNYDTcMRPOBJbLWQVIGXEfdaU,HAAAKAAADACAMACA.RAEABAHBLAFA.QBCAGCCAECFAaCEAhAAASCHH.hAGAeEFBACHAZDEECFHA.TFFAhAHAOHDCJFDF...WFHBIHHA.hCAA......hCBA...,1,-7,-30,23
HKAMCgYVFUWdGXZNeBPfITcObaDSRJLQE,MAAACAAA..VACAFADDdAFAZAFB.BAHA....fAHAhAAATCBAOCFEaCAARDDBLDHBhACAHEDAABBAUGGAGGEBhAFAeFBBIFCADHEA......hCFA......hCIA...,2,-19,-14,5
FLeAcMWYRVIfHbSKZUgdDTPNJQGCBEXOa,MAAARAAA..IAEAHACCKAFCZAFBdBHADAIB..TCCA.JCFBhAIAGCCABBBDEEGAaBHHeDABhAAA.ACCB.cFCAhBAAVEFASFCD.PFEBQGGAhCAACGHA.FHCC..hCFA...,2,-14,-7,7
SPRaZcBdDeMGgNLCWEUQIKHFbYfXVJOAT,TAAARAAAZADBdAGA..eACEGCEALAFBECHF.QCCAhAAAHDAAFEHD.bBGD..XFBAhAAAODBBAAHAaGDDDBIB.hABAMEFBCCCC.IFCAfGFASGFHhBDABHHA.....hADA...,1,4,-9,13
DVdYeXTMbBASaKHULCJIGRQWNEcfgOFZP,aAAAHAAALADACADBGAEARAGF.QAGA.ECABfBBEhAEA.FCEBZCCFDCIBdDGAhAAAeDCFMDIBADGBKEFDIGAAhACANEHA.OFFBPFAB.....hAGA......hBIA...,2,-15,-4,11
UMOTCGdNADRZBcKPaYeWbgfLQFJIEHXVS,RAAAZAAAKADCaACA..eAFA....bAEDLCCAFAGA.EBHFHCGBhABASCFHMCCBTEEAhBGAdECAAAAABDHA.hCAA.PFHDgEEGQGCAXGAChAGA.OFHBCDDDDGGB..hCAA...,2,-23,1,24
eLRacPYTQXSbKAUJfGMVZDCgdFOBIWHEN,UAAAGAAAZADACADAdAFABAGBHBGB..EBHFeCDBLCDBRECB..hAEAaAHF...PEHDhAAATEGA.QFAAhAFAbFEDADAB.MFFBDFBB.FGDB.IHHAhAIAcGGC......hBAA...,2,-24,1,25
gaWBCYLMVIHAOKTUNfSFdZeDbPGEJXQcR,TAAAUAAA..SADAZACBeAEADAIBGAFA..EBGFQCDChADARCEBaCAH.CAHAMCIBhAEAHDGBADIBKEFDFECAbDGDXFAAhAAA.gGGABHAA...hAHA......hBAA...,1,4,-25,29
HVTWdKYeJbGPDEcARLCBIFXaZSgOQNfMU,RAAALAAABADBFAFAZADB.OAFC.QCAAMAIBHBDC.TDDAhAAAdCFAeCHB.GEGAhABAECGFACCB.XEEChACAaEGDSFFDfHAB.WFDD..hAHA......hAIA...,2,-26,-6,20
KdFbUgMLXaZfRBQEWNAYcCVPJGISHDTeO,CAAAVAAAGACA.HAEAeADEdAHAFAGA.UCDAMCAB.LDFAhAAAZCFBREBBBDHAECBBACGB...hAAAPEDDSFDBhBEATFFAKFGA..bEADaHDC....WFHBhACA......hAEA...,1,-6,-18,12
RDVBHGNPSOaXLITCMdfUKJeQEWYbcFZgA,RAAABAAAHADBGACA.SAEAaAFALBFBCAHA.dCHAKCAAeCCBhAAAECEA...bDADZCGBAAIBDDABhABAVEAAOEEB.hAAATFGAMDIBfEEA.QGDBhACAcGFC.FGGB.hADAPHAC.,1,8,-3,11
bTcOHPgUMKeCQBLZYDSGXIVRWdfEaNJFA,TAAAHAAAUADA.eAFAQACCZCAADBIBGCFAXAEBREDB.dAHAhAAA.ECDFaFHBFCFDACHB.bDGDhBGAOGAA.MIEAhAAABEED.LHBA.SGFDhBHA.IHHA.hACA...,1,6,-8,14
BUQKOgDGFYaNJZdAHbMCWfSLTIVeERcPX,HAAAMAAA.CADB..SAEHTADA.eAGBRAFF..XBBChAFAQCABOAHDGCFAhAAAaDDAZEEAAAHAbDCDLEHBhAHAEEEBBEHAKGEAFGHB.NIBB.WHDG....hBAA......hBCA...,1,10,-13,23
HQFabRCOXANegBUPfcdITGLWKMJYSDZEV,eAAABAAAUACA..fADAdAFAGBGALAFAMCBB.SCCAhAAAEDDAHEBBaAHFhAAARCEFXCGB.AAGAgEGAhABAIEFATGGAKGEADGIB...hBCA......hBEA...,1,-8,-21,13
LHbVEAUSTPdXDWfeIFgaJCGKROZYNcQMB,TAAAdAAADADA..eAEAFACA....aAEDGBGARAGBZCCA...NBDA.hACAMCGBHCEBEDHFAAIBSCBHhBAAXFFCfGAAhAAAIGCACFGDKGHBOFHD....hBCA......hCEA...,1,-12,-23,11
AZgLfFRdNVKIGWUbBMSJCXcEOeTPaQHYD,ZAAALAAARAEAdAHA.KAEAGCAAUAGABCAA..MACACCCA.ECCBeCEBhABA..aCFDHDGBhACAADHAFEDDVEAA..bFFAhABAXGDA..OHEAQGGBhAEADFFA......hBIA...,1,-8,-18,10
ecfBECFSLJTIHWYQMdAbOgVXNZGRPKDUa,OAAAXAAAGADARADA.DAFAeAGHBAHAECDBFBBHLDAB.hBAATDGAHBFBQEFBhBDAAAAAVFCA.ZFBAKFHBhADAaCHFCFFB.SDDD.IGHAhBFAMAIB......hCAA...,2,-15,-1,14
WUSVXKGOCYcLQeagdMbEDNAPJBFITRHZf,BAAATAAAHACA.ZAFBUACASAHHKAEAGAGACCAA.LDDAhAAAeCCAdDHAEEHFAAEAFEEARFCA.hAGA.fGFAhAIA..XGGA.OHBA..hAAA......hACA...,2,-24,-9,15
EZBUXQcaOTWJLPDHFIRMAbGfeCgdKNVYS,GAAAeAAAdAEAKADA..VAGBEAFEZBFE.BCDAQBCA.hAAAaDEDTDFALEGBhAAAHFFCRGAAADIBCDCD..YDAFhACAXGDB.WFHHDDIBMEEB.fHABhADA.SHDAhAHA,1,-6,-22,16
QVCXZUTBOPgbMcaJfYHFENSeADLGWdRKI,GAAARAAAQADCCADAZAEBBAGA..OAFA..bCFDaBFD.hAAAJBHBHDCAFCCHEEDAeAHHhACALFCAdEHAKGGD.XGEAhAAA.........hADA......hBAA...,2,-18,-15,3
BSZNXGMRYFgDQWOJHUdabACfLETcVKPIe,LAAAEAAA.TAEAKACAeAEE.ZBCEGAGARCEAFDDH.QCAAhABAOAHD.HCDAaEGA.hAAAAAIBfEAEhACA.PEFBSFFAMDIBDGABJHAAbGFACGHD.hAEA......hAGA...,1,-1,-14,13
XVbNSgZTIdcMKEWJCRHeLaAQPYDBOUGfF,QAAADAAAOABEGAEAFACE..bAEDSAGA.ZCCFhAEAdAGAMCHBECHFCCDCHFFAhAGAeEEBACIBBGDAXEGAhAAANIEB.TGBAKHAA........hAIA......hBGA...,2,-18,-13,5
SaHdWGAKDMNbRCLOUZgcBVQfPJYeEIXFT,MAAARAAALADBZABEBAFAQAFA..fAHAJCFF.hAAAECCAFCHD.aCCBHCEAhAFAGFABACIBDEEBCAHAOFFBhABAgFFA.PHAAIGHASEHBhAHA.....hAFA...,1,-15,-18,3
OaMVHCDFcULeNEJIdWGPTRZBfAXbYKQgS,XAAAKAAAQACC..OADAaAEAHAGBFAGDLBDBhAAAEBEFdDDDGDFARDFAZFCAAAIB..hABAYEHBMFIBDFDAeHEGhAAAIGGA........hCAA......hCBA...,2,-23,2,25
XPFVRUQTNbDLgKGHdaZJecSWfMEAYCOBI,OAAAXAAAFADDRADA...QAFA..bAGBLBHBhAFAGCEAHDAAZCCAeDFHhAIASCHHMBBBAEEBBFCAhBAAIFHAPFHBTGCADGGBdHDBaGFD...hAAA......hABA...,1,-1,-15,14
LgSBXDPWGTQaKZbHNYVRACUEIOecFMJdf,EAAAeAAAFACDdAEA.LAGBBAEADAGAGBCA.aCHDZBEE.HDDChAAAVEEAABIBCDGB..OEBBhAAAMDIB.JFHB.SGBHhABAXEAATGFA.KGBD...hAIA......hBEA...,2,-27,-10,17
VTANEaLBbMFSRGcCPIgYQJUHXeZOKWDfd,EAAAaAAALADABACAFAEA.RAGF.GAGA..CBBD...ICCAhAAAQCDAHCEBeCHHhAEAZEBAKEHBfDCEhAFAdGDDAAIBMIDASEFH.gFDFhAIA.YFHB.hBEA...,2,-17,-10,7
ZWXaBJHfQeCFYEVbMRTNDGULIAOcPSKdg,OAAASAAAdAEAZAFB..aACDHBCBeAEAFAHDEAHFMBBB.RDFA.hBAATCDAGEBALCFBhAAAAEEBKFFD.XEAAhABAfGHAQFGACHFA.YFEFhAEA......hAFA...,1,-4,-13,9
VTcRJZUCQaGDdEPNHKAXfSBbeOWMILgFY,SAAAeAAAMAEALBDAFADA..TAGARBGFZCCAQEBAhAAAGBCAECEEHDGBAAIBBEEDhABAbEEBODHD.gGEAhBEAcGAACGCBdGGDKHGA......hAAA......hABA...,2,-6,1,7
PXZTYVCWGBFQgKLbfIRDaMcANOUJedHSE,OAAAeAAAHADA.EAGEZADB.TAFACCCAGCEAQBBBLCGBhAAA.bFAARCEFaAHD.ADHAUEGAhAHAdGGAXGDDhABA..WGFG........hBAA......hCAA...,2,-20,6,26
UEXJLDdfAPHCYQKZNRIOSWaVeMBcFTGbg,HAAAQAAAZADBRAFAOCABaACE..eAEHMCCBFAGAGCGAUCGAEDAAhAAALDFD.dGAAhAAAADDBCDFCKFCASEEDhADABGHA.bFFB.XGBADICA...fFHAhBGA..hCAA...,1,-3,-15,12
GgIaHLPfdRUCeYJbWNFBcQDASMOZTVKEX,MAAAZAAAKADCGACB..aAFDHAGBLAHBdCCARDFBeEDF.bFABhAFAFCAA.QDDAhABAAAIBOBBHEFHFXDGChACAIHEAfECE.CFBDJFGB.BHBAhBFADGAB......hBHA...,1,11,-21,32
EVFHYJIcfXabeGdDRgAQOTBCMUZKSPLNW,TAAAMAAAZABE.KAFALACB.EAEAHCCA.ICGAhAFAXAGAeCHHdCEARCGBAAHAQECBhBAACEAASEDDPFEChBIAVFFBFGCH..YFHB..hCAA......hCCA...,1,-3,-16,13
FGEbKfJULZQeWRNOdAXVgITDMBcCHSaYP,XAAAVAAA....TAEAMADACAGAHAGB.aCDBFBDAEDAAbCDAhAAAKDFA..UEFBZEEAeFDBhAAA.RGAAdGGDAAIBDCIBhABASEAAPDCBfGGE.LHCAhCAA...hADA...,2,-14,3,17
aETHbeXdcgSUKWMLINJPFDZQCfRBYGOAV,EAAAHAAA.eACEdADASAFAKAFCMAIBLCCA..ICBAhAAAPBGDZECAQCEAhAFARGEABEGD.GDGAhAGAAEEAaHGE.bGDA.XDBA.....hAAA......hCAA...,1,-8,-9,1
DQKHaEcgLXABRdVJOTUfCNPISGZeWYFMb,RAAAdAAAOADAUADA..CAFA.....IAHAZAGBeCBFFBDDMBIBhACAQBFD.HDEChAAAEDDALEFBhBAAACCBBEHATGGAfEHENICB.SGCAhBCA......hBDA...,1,-18,-29,11
TKMICOcHRbNaVEXJQUGFPeZDYLgBSdAWf,TAAAMAAA..OACEHACBRAEA..aAFAEBHF.QDEAhAAAGBEBeBBBZEAALEGBhACASDCHAAHAKGCDCDGAbEDDNDIA.hAEAXFFA........hAIA......hBAA...,1,6,-23,29
aBDTfLZRJPYFHXVGUgcAbNEeMCKdIQWSO,EAAAeAAAKACAdAEA.QAGAOAEA.DBDBLBFAZDEA.RCCAJDFBhAAAFEBAHFDA.XGAAhAAAGEGA...gGFAhABAACCAMEEBCDHBSHBAaDHF..hAIA......hBHA...,2,-24,-3,21
JXBcdFKOVDLeASURWHgYINGPfbETMQaZC,RAAAHAAA..IAEAGADAbAFA.ECABMAGBZCFB.CAHABCCA.hAAAdCEAOCCBLCHBhAAAAAFASDHBUGEA.hABAgFDBPDABfDGAaGGAJHAAFHFEDEDBhADA.eHAA...hACA...,2,-11,5,16
FEcTfAUZHKCPMRQWODIYVdNSbBeGgXLJa,HAAACAAARACA.QADCDAFA.VAGBdBGA.SCAAeCABGCDAhAAALDDAFDHD.EDHFTFFAhACAAAFAZFCAMFDA.hADAIGGAbFCDBCCD.......hAAA......hACA...,1,-3,-20,17
bFWOHUYVSgLBXfcdCQTJPAGRDaeIMENKZ,RAAAeAAAEADE.ZADB.FAFDHAFB.UCCASAHBLAHBBBCAXDFChAAAdDFAQFGAhAAA.JFEFAEIBaFAAMBHBhABAbFGD.OHBA.......hCAA......hCBA...,1,-5,-24,19
dSBFcTKXVDMCbUNfOJeZEAIPLQWHgRYGa,LAAAHAAARADFGAFAdAEAFAGAKAHBDBGB..MCABCCAA.UDDB.ODGDhAAAeCCBACHA.QDGAhABA..gFAAhACAaEBBBEEATGFAXGGA.NIDB..hACA......hBEA...,2,-34,-4,30
NIHPZFXAOdJbTcKWBCLMYUEfSQgRGVeDa,dAAATAAAKADABAFB.LAHBMACAEAFA.QBDCRCAAGCEADECBhACAaAHDHCFA.ZDCAhAAAABHBOEDBbEGD.CEGA.hADAfHBB.SGFDeEHH.hBAA......hBCA...,2,-28,10,38
BgUECbHdfTaVXSFLINcWPQYRZDMGKeOAJ,BAAAEAAAHACAdACA.aAEASAEA.LAHBIAHA.NCCA.hAAA..PCBBRDDAZDGBGGCBhCAAeBGFAAEAgDDAhAAACFFC.bEGD.....fFCEhBCA...hCBA...,2,-20,-13,7
JFSQOHIcAMdbCfUNLTRDYBWEVZXgPGKae,dAAACAAAUACALADA.RAGFBCBAEAEAZAGB....XCEChACAGCEAeCBBSCHHhAEAHEGBABGBMDDB.bEFCfEDEhAAA.DBIBVFAB.KGED.aGGAhAFA......hAIA...,1,-13,-20,7
fMWDQRHKXVAFaEeTcLUgNJObSBZPCYdIG,EAAAeAAALADAUAEA..JAHBSAGH.ZBCACBCAdDDAGDDAhAAAMDGBQDGAhAEAHEBBKDHBAAAAaFAA.TGFAhAFA.NIAB.bFED.BGHA.IHAAhAHA......hBEA...,1,4,-26,30
MdBcDeNgGERWbILQYSTAUJafFHPXKOZVC,aAAAHAAA.KADCZACBMAGBdAFADAHB..eAHBGDEARCAA..bCEDLDGBhAIA.QEBAhBAATDGAACEBfFBAhAAAFGHDOBBB.BFHANBIA.EGGB.IHCAhACASGED...hAIA...,1,-10,-14,4
EMWJYPRcBVNSfbHdXUIKQTFACGLeaZgDO,GAAAeAAAZADBOADAEAFA.MAHB..JAHBRCDABDCD.SCHHhAAAHCEBdCCCXEGAhAAAKEFAQGBAACGBaDBHDGGBhABAPFEB.cGGA.....hBDA......hCAA...,1,-10,-22,12
KXRTbHFUeGPdBaLWCVMAYfEZINcQgDSJO,EAAAZAAA....IAEAQACA.SAEAKAGARCAAHCEAeAGHhAAAdCHAaECALCCAhAFACEGD.AAIBfCHAhCAA.gEEAOFFBbGAAFEHD...hABA......hACA...,1,-5,-24,19
ATWQRgMebKaIJPVOZYFSHfXGNDUBcdCLE,TAAARAAAeADE..KAGCaACA....ICCAPAFA..ZBDASBEDhAAAHCGBGDDAhAAADBIBBCFBdFBAECCBACHBQEEAhABAbGFA.OEGF....hCAA......hDAA...,1,7,-35,42
RTfHbcaOPdWKMeEXDJgLQNACBIYGVFZUS,BAAAGAAAZACARADAHAGB..aAEAdCDDMAHBEDFFDDABLCCB.hAAAAAIB.CDHAVFGBFCEHUDGBhAAASEED.TGAAhACAbDAB..OFFB.KGCA...hADA......hAEA...,2,-22,-9,13
YCTeIOSPMBNfEKcJZRaHAdXDGgUWFbVQL,dAAAGAAAUADAFADA.QAGALAGBCBFBeCDA..SCAAhACAMDCBBDFAEDDAKDHBZDFEhAIAHFFAABIB.DEEBbFGBTGAAhAAA.OHDC......hACA......hAGA...,2,-26,-7,19
LWGMfUIOTbBeXdCNEDQRaVJZHKYPcgSFA,GAAAMAAAUAEAOADABAGAeAGF.dCDAEBBARCGF....aDBDZCDAhAIAHFCAKBHB..PDHBhBAASEHH.AAABLFFBhACAfEBAIHHAbEED.NIAB.DEEBhBBA......hBEA...,1,6,-32,38
JNbIRXPadAZcMGQSDegKOVFWHLCBTYUEf,ZAAAGAAAQAEAeADAOAGDFAGEHCAALCDBBCEDUDGAECFBJDHBhAAA..IEEAhABARFEBaDAHAAIB.MEAB.DACAKGBAhACACGEA....TGGA.fHCBhCAA.....hADA...,1,-5,-12,7
gZKXDLaeUCcJVIFOfYNSBRPdMbWGTAEQH,HAAAZAAADACAeACEUAFACAFB....VBGBOAHF....fCCAhAAASBDHRDEBdFCAhAHAMCCBGGEBADFAEDGF.hABA.KEEB...aEHD...JFBF.FGGHhBFANIAB......hCAA...,1,-3,-29,26
IHgFUdCcGfQDYOATMbLRNaEXZeBVWJSPK,MAAARAAAEADE.ZABEBAFB..VAFA..SAGHKCCAHCEBFCHDhAFAdCCAGDFAQECChAIAOBHDAFGA.TFCAhAAAbGDA.aFHD.eHEG.......hBAA......hCAA...,2,-15,-11,4
GbQKDIRTCJdBZLEcMUeWPgXSfOFHVYaAN,GAAAQAAADADARAEACACABAEAZCDA..EBHFMAGB..eDBH.hAAA.gCDAhAEASDHHFAHBHECBaCHDACDAbEEDhAAATEFAdGGA.LHDAWHAG.fFEEhCAA....hDAA...,1,3,-24,27
PFgGIWbVTKCHUaNORMZSXdfeYQBLJEADc,DAAAFAAAGACA..bABATAEAHAFAaCCBRAGFZDFA..dCFDeEABhAEAQDDCLFFBAAHA.hADAPEDDIEGAKFHD.hAGACFAAOEHDMIAA.fFFE.BHHDhAFA.....hAIA...,2,-8,-4,4
JWCTYXUVcQgfIaRELAMZbdKNHDeSBFGPO,ZAAAdAAAHADAeACEFAFAGAGA.OCAECBHA..TCDAXCEDhACAUDGAQFAAhADA.fEDEhAFARFCAACCBbGEADGIBBEHA.PFFB.....hABA......hAIA...,2,-28,3,31
RaNWOLDHTSdFBGZcfbQeJXUIVKgPAMCYE,MAAAEAAARACA...aACEOAFAHAEB..dAGBGBEBZCCF..bBGDeCCBhAAA.XDAChADAUFFAKGDBADHACEEA..YBBFhBAALEGBDFIBSGFD...hCAA......hCIA...,2,-14,-12,2
VDgeRKMUTPBQcELNXWSZAafCOJYbIGdFH,aAAAOAAA..JADA..bADAdAGA.HBBCDAHBRCCAMAIB.UDEAhBAATDFABDGA.EEHFLDHBhAEA.XBBChAFAZFCAAGGBCHHA.GFCB.FHFA....hAIA......hBAA...,2,-22,-13,9
VIEUBRbTAYdHJfGZNCcQagPDOXWKMSLFe,HAAAGAAAZADBCADA.aAFDDAFA..OAHBKAHBLBFBeCAA.ECDARDEAAACAhAAA.dFBA..fCHEhAAAQFDCXDCChACAMCIBFFHH..IFDABGFA.bFFA.hAIAJHEA...NDAA..hBFA...,1,-2,-15,13
HPZGVEdRNLaAQKICDOMSbgJWcBFYeTXfU,QAAACAAADACA.MADASADA..bAEAJAGBBBDDFBCH.hAAAeBHH..TDEAhAGAfCEAHDGBGECAhAIAEDFFRFGBaDDHABIBKGGDOGCA.....hCAA......hCBA...,1,-5,-28,23
IeNaUEAHGLFWbCXRVYMKcgDZOfTBSdQJP,HAAAGAAALADBFADACAGA.RAFAMCABKBHB.DCCBZCDA..OCFBhAAATECAdCHA.QFAAhACAJDHF.eEEDaEEDAAABhACAXGFD..cGAABHDA.SGFAhAGA...hAFA...,1,-2,-28,26
EDJNKLPAfTXBOaVRYQSHWgFdZCeGbUIcM,TAAAOAAARADA..QACCHAGBFBBHZDCBeAEEGCEAUCEAMAIBhAAAEDHF.DCHBKEAAADDABEHAhAHAaFHD.SFBAhBFAdGAAbGDA.IFFA......hCAA......hDAA...,2,-20,3,23
MgILSPfBdVeYNJATaXQRKbFOWCDGcZHUE,aAAARAAAFADA..CADAGAEAHAFBEAHB..MAHBLCCB.SCEDhAAABBBDeCDBJDGBAAGBTDAAhADAQFDAbDFD.hAIADDIB...........hBAA......hBIA...,2,-30,-15,15
DEcTQabIdCNKFBHOWPLAeRXMgZYVfUSJG,RAAAMAAAZADB...VADASAFA.GCEAEAGEQBBChAIA.aCEEdCCCKCHBHCGDhAAAODDBLDABhABAAEFAeEGFXGAA.fFHADFFB.hBAA......hCAA...,1,-8,-21,13
gWUCKedFaJTBfZMPQEXVINOAbRHSYGDcL,HAAAGAAALADBUADAeAFAaAFABBFAZCDE.MAIBEBHF..XDBDhAAAIDFA.ACABRDGFDDIBhACA....gDCGhAAAKEEAdEGATGAAQFBC.OFFBhACASGHH..hAGA...,1,-3,-13,10
aPGEFJMeXUZYDWTObAgCRNIQSfBHLVdKc,RAAAQAAABADBHAEBdADAKAGA..aAFAECCBMAIB..eCGFZBEBDCGBhAAATEDAACHB.CDHA.SDBAhBCALFHBPGAAhAAAGEGAFGFH........hBDA......hCAA...,1,-12,-18,6
eNbgZBSWEITJDGLQVdMfOUPFKHARYcaCX,RAAAaAAAeADE....bACDZAGB.SBDHEAEA.JDCFGAGAhAEALEEAdCEAMBBBhAIAOEHDFEFDHGAAADIBCFHAXGBAhBAABGEA.IHFADGGB....hBGA......hBIA...,1,-14,-16,2
dbRJGAPQMaZDXVLWTSBCOUgHYfNeKEIcF,MAAAZAAADACALAEA..TAEACBBAOAHDHAGB...fCCEhABAeBDBECFBFDHHhAFARDFBAAIBaECCXFEA.hAGASDDDBDHAgFDAKGAAdGCA.JFHB.hAGA......hBAA...,2,-17,-11,6
aTIAMeZDNWJSbOCgXEfdKYcFHPRBGQUVL,eAAAZAAADACA..JADBOAEC..XAFAEBHF.dCFAKCCDFCHDhAAAHCFBREDB.GECAhABAQFAALFFAaCCHAAFAhABAMHFA.SGABbFFBCFHA....hAGA......hAHA...,1,-13,-18,5
FMOXEIdVGLWUNYbaHeATSZRCPKcJQBgDf,ZAAARAAAKADCQAEABAFA.DACAMAHB..EAGAdCCAGCCBLCFBhAAAUEFA..bEDDeCHBhABA.ABIBCGHA..PFGDhABA..........hAIA......hBIA...,1,-22,-36,14
XULDbIYRCgKWFJEHTcSZBOMPNdQAeVGfa,eAAAGAAA.aADALAEADAGA...bBAARBFAKCDAFBHD.HDBBTCEAhAAAZDEEMDIB.dFFAhAAAAAFAXECAUGBBCHGA.hACAgFFA.EGCB.BEHB..hABA......hAIA...,2,-18,-5,13
RAIPaHLWgCfSFEZbMBOdeUKGJcXDYNTQV,aAAAHAAALADACADBFAFAZBFABAHA..eCAAGCCA.JCFADCEB.hAEATDFAREFAABBB..IFAAhAFA..gFDAhAAAEFEBMHAAdGHAKFHBcGGCNICB..hACA......hAIA...,1,-8,-28,20
KacTFUeWQALOBGCVIbZMfYHXNEJPDdgSR,LAAAGAAACADA.VAEAZAEB..MAHBHCAA.EBHFDAIBdDEARDCBKDHBaDGC.hABA.FEAHUEEA..hAAAeECBABGBBFHDIFGAhACA.fGHANDAA.PHAC.hACA......hADA...,1,10,-30,40
YeBHQPUXGNLVMSbTJgfRCOAZEFIcWadDK,EAAAFAAA....IADAaACDdAEAKAGA.BCBDHAEB.QAGAhAGAXCEA.GCCAhBAALCHBMDHBSDDDhAAAbEFDgGDFREBBADHBZEEFDFIB.....hAGA......hAIA...,2,-21,-3,18
AdcQHOFUYaGXTNLPSRIKEBJVDeCgbMWZf,dAAAHAAAFADAaACAGAFA..TAFALAHBRCCAEBHFBBDD.DCCBhACAeDFFCDDA.bEGDZEFAAAHAQFAAhAAAOFDB.hBAAXFCASGGB.KHEA....hBCA......hBHA...,2,-24,11,35
HVTFQeIRCDSWJaBGYPXfNdbKALOMcZgUE,MAAAZAAAEADEHACC.FAFAeAFERCCB.DBGBSAHH.aCEEGCAAhABA.XCCAhACAdDHAABBBLEFBOCFHgDGHhAIAUFCB.TGGACHGA.BHCAhCAA......hCCA...,1,-10,-16,6
MFGOBfgSbHZLECTRaPYIDKeNVXcUWJdQA,GAAABAAASACAHADAEAGERCDA..aAEDICHAKAGA.eDADhAAAXCAAUEFAdFHAAACAMCGBhAAAODCB.fGCAhACAZDCBTFEADIEAcGAA...JDHBhAGA.FGHD.LHDAhAIA.CEEC,1,0,-15,15
gXfZWHQcdUDPbVCAYEFaTBMRNeJIGOKLS,EAAAaAAABADARACA..eAFEGAEALCCASAGA..fBGEhAAAHCCBdCHADBBBhADAbDACACIBTEFA.MFIBhAGAIEEAKGDA.ZEGBWHAGQGDAhADA......hAIA...,2,-13,-10,3
ITZMfXaUegROdPLJEGAKDHVWFYCNQBbcS,HAAAFAAACADA.QADCBAFA.SAFBZAGB.MAHBaCCAeCEHhADARCAAdDEALEGBhAAAGEGAABIB.DAIB.VFCBNDDA.hAFA.....IGEA...hACA......hCAA...,1,-2,-36,34
BeROQDANUIEZVPKTSCgGLcfMHWYXadJFb,UAAAEAAAZACBKADA..CAEAGAFALAFB.MAHBHDEB...XECBhAAAdCDAFDAAeCHHhADAREGFDAIBAAHB..VFCASCBFhBCA.fHDBaFFDBHGANIAB..hAIA......hBAA...,2,-22,-10,12
FEZNgBRDHaKTMPXAbceOUJdSCYLGVQIfW,eAAAOAAAdAEA.CAGA.GADA.QAFAICCA.FBBHEBHFZCFEhAFABCFAHEFA.aDBEMDBBhAAAAAIB.UEDASGHBhBAALEHBfHBBgFFHKHEAXGAAhABA....hAGA...,2,-28,5,33
FAYIDXBMOTSRJLCeGfUEbNgWKQVZcaPdH,DAAAMAAAOABERACA.LAEBeAFEGBEBUAGA.EBBB...bDDBhAIANCCA...KDGAZDDAaFEDhBAAHEGBAFIB.XGBAhBAATGGA.SFFD.....hCAA......hDAA...,2,-18,-10,8
bCBaMIVDELeSXNfPGHZTdKYWQUgJROFcA,BAAAaAAA.MACADADALAGB.eBBAXAEA.fAHAhAAAHBEDdDDAKDHBQBCChAHAgFFARCEBFCHDhCAAAAIBCGBAEFGA.SEEDNICB.ZGDA..hCBA......hCCA...,1,-16,-18,2
UcbVKEPFBDXGJMAfgSLQYaITONeHRWdCZ,SAAALAAAaADDOACDHAFA..RCAAdCFDZAEAUCEA.VEGBhAAAEDEBBDHA.GEFAhABAAAFAQGDATFAAeFHHhACACAHBKCHBDEDBMIAA.......hABA......hCAA...,2,-24,9,33
FObGeQECNDMKBLTYSgaZPIAcdWRfHXJUV,dAAARAAAHADBUADAOAFAGAGA..EBFEDCCBMBIBLDDA..hACATDAASDBDhAGAZDDAAAAAfEHEhADAXEGAFFDAeFDBQGBAKFFDBGHDaGGB.IHHAhAIA....hBAA...,2,-17,5,22
gGdbLQUAJZHaXfVScWYMINREFTCePBKDO,HAAAaAAA.XADB..SACH..cAFBhAAAMAEARBDFEAHFTBGAeCAAKCFAhACAOBBHdDDAbEGBLDFAhAIAACIBZFEB.fFBA.VFFA.hCAAIGDA.NIBB.hBAA...,1,7,-21,28
BNAZVFaWHYEIXfPObgTcedMGSKRQLUCJD,ZAAAaAAAHACBEADE...XAEAOAFATBFAeAHBGCEA.hABARCGBLEAACCAABCCDABIBFCEHhACAIGGA..hAEAbDGD.dFFCMBBBSGED...hAFA......hAIA...,2,-20,-2,18
gfaGQeAXEDJbSPdCIcOMRYKZFLHWTBNUV,EAAADAAA..SABAdADACAFA..OAGDRADFZAFBHCGBBBCCUDDAhAAAVEEB...aCHDeCCBhAFAAAIB.JFCF..bFABIGHAhAIA.MIFAFEGHTGDA.fGHAhAFA..hCAA...,2,-32,-8,24
fMEKLXeWPYGDZaCbcTQRBHVAdOIFSNJUg,dAAAFAAA.SADAUADA..MAGBEAGALCCAeAHB.PBHDhACAGCGA.aCCCbCFDTEEAhAIABDAA..HEAChADAADBBOFBBIGAAgGGAXFECDFDBCFHA.hAEA......hAGA...,1,-9,-14,5
GWaCfcdKTFUYHXOAIRbLDMBSVPQNJgeZE,RAAALAAAMADA.SADHQAGAJAFAeBDF.GBEACBFDdCAAFCCHhABAHDGB.AAAAbGCABCGAhACA...VEDAgGGAhBIAEDHF.WCCDaFHD....cGEDhAIA.....hCAA...,1,-5,-19,14
WQUIdGSLZaEJVcDBgACebOfNTXHYFMKRP,eAAAOAAA..TADAHADAMAFA.RBFAQCCCdAFAGBGAZCCAhAAAEDFB.VFFBBDHAAAHACEEDhABAbFFA...fHDBhBAANEIA.FHFA.KEED.....hBIA......hCAA...,2,-17,4,21
EKBHCOIQaZRXMSfFWDbcgAeYGUdTJNVPL,eAAAGAAAdAEAJADA..VAGBEAGE..HCDAOBCDQCGChAAAZDFAREBB.MDCBFEEHDFHBbEFA.hACAAAAA.....TGGAhAIANIAB.KFEDCGAAaGFDSFCH..hBAA......hBCA...,2,-17,-1,16
ZPYNdKVXFTIDEWgUfeBMJGHOQbARcaCSL,RAAAaAAALADBZACB.....PAFAdAFAXBGDFBFH.TDEAhAHAEBHFUEEABBBDMCCBhAAAHEBAODHDAAIBSBEFhBAAKGHDDHEA.fEGA.eEHHhCAA......hCIA...,1,-16,-21,5
fPAGDBWETIcNaeJXYUCgLZbRQOdHMFKSV,GAAABAAAEACA..TADA..IAFAaAFAeAHH.XCDAhAAACAHAZBEARCAAdDEAHDFBMCIBhAAASDAD.hACAfDCEADGBDEHBcGFAYEEF.gGBAhACALHAA.OHEEhADA.,1,-7,-25,18
EIDZOBRaAGKPfgdbCTXWcHNJQYSMVeULF,GAAAKAAA...fADAbACB.CAFA.TAEA.XAGBhAAAHAGBQCDAhAAA.MDABeBHHLDFBhACAECEBZEEARGCAAAIBdEHAcGGCYFABSCCDhCAAFHFADIDA...hCBA...,1,8,-18,26
gHbJWTKcMDVAQUXPSLEIRBaYdZeCFGNfO,QAAAXAAALADARACABAFB..dAHAeAGHGCDAOBHDHCFAhAAAJCDBTDAAKEAAMEFBhAAAAEHASFCB.hABAEFFAaEGBCFHAFHBCfFDA.WHFA.hADADIAA.....hBHA...,1,-1,-11,10
IUVBTJXMfYNdREAOSCbDQcWaLKGHZFPeg,CAAAQAAA.aACEGACA.HAEAZAEBeAGFgBGAhAAAICHABCAA.TEAAhACAMCDBfDAAhAAAdEEAAAGAbEFD.DECBLFDDFEEAPEHBJEHF.NIAB..hAEA......hAIA...,2,-5,-5,0
XNPSMOWeJBGQIKdTfHbcCFZYgaURELVAD,XAAASAAA.MADAeADA.GAGAQAGAdCDAHDABbBAA.hAAAFDFBZBDBaDHD.EFCAACFADDFAhABAOFGBBDHAIHHAhAAATEFACFED.YFHB....hBIA......hDAA...,1,4,-20,24
LdNRbXCEWTYcVKUPBGHZaQJFSeIfDMAgO,LAAARAAACADB.EAEA..TAFA..cAFDKBHBBCCAHCAAhABAaCEBQCGAhACA.SCCEhAEAeDEHDDGBAAAAdEEAbDGDXGEAVFAA.....hAFA......hAHA...,1,-2,-31,29
EXCfHDcGaAYPZbISLJUQNKWMdegFTRBOV,ZAAASAAALADBQADAKAFAdAHAFCAARAFABCCA..ECFBfCGAhAAAHDGBGEEAhABAACIB..bDACIFAAhACAUEFBMEEBTGCAXGAADGIB.aFHD..hABA......hADA...,1,-2,-13,11
TDSbBXCFIQMLKecNRYWAHfaJgPEUZOGdV,HAAAaAAA.JADAEADAZAGBdAGA..DBIBBBBDFCAH.MAIBLCCA.hADAKECAeBDA.RDDAADDA.hAAA.fEEBhACAgDGBOEGDTFFAbGAACHHA...QGEChAGA....hCDA...,1,-14,-16,2
BUcPeOHbQIGEXRTaNDdCZSLJMFfYgVKWA,BAAAUAAAeADAHACAQAFCGAGA.RCAA.aCBEdAHAZCEFLDEAhAAAMDAB.FEAH.fECAhACAgEDDKEHBAAIBODHDhADAEFDA.TGBACFGDSGDA.hAEA.YGEG.hAEA...,2,-8,-3,5
XAVKIadMPZBDEHfcJNWCUegTOLRbQGYFS,KAAAdAAAZABBEACE.HADA.JAHBCAEBUAGA..eCEFOCCARDFBGFABhAFAFDDH.ADDB..aEHDMDGBhAAA.DDHB..fHABhAGA.NHEB.TGBA.bFED.hAHASEHH.hBAAIHHA.,2,-34,0,34
UTVcXfDKSIgRedJLNObHQAPMaZWEFBGYC,aAAAEAAAGACA.CAEA.TADA.XAFBKAGASCBDhAAA.RCFAeEABdBHALCCAhADAOEDCHEGBABBBZEEABDFAhAIAVGCADGABgGGA.JHCA..hBAA......hCAA...,2,-18,2,20
KWbTRXUeaQDPfELNFGSdcYIHAMCJZgBVO,MAAAZAAABADBKADA...TAFARAFFUCBA..eAHHQDDChAFADCAAECDA.LAHBGDEAdDGDhABAIEGAHFAAAFIBCFFD.hBAAgGGBOEHD..WHCAaHAC...hACA......hAFA...,2,-19,-6,13
aUVPGfdIeZKQCAHFJLDNWSgTcEXRbMBOY,HAAALAAADACASAEATAEA.EAHBRAGFMCAA.BCDAaCCAUCFAhAAAGDEAdDHAeCHHhABAZFAAQFFChAFAADGBFEAANGAB...WFDBXGGA....hACA......hAEA...,1,-5,-12,7
bSdQKIWFacTPOZNXHGgLVEMBYCARUJfDe,RAAAUAAADADA.eADAdAGA.KAGAFBDD....aCBE..TDEAZCEAHEAAhADAGDGALCHBhAEAEFBABBFCAEEAJEFB.SFCAhAIAQGDAIGHA....hBAA......hBCA...,2,-29,-15,14
AFRSEDfXdZeJgaVBNGLYTcPOCHbMKUIQW,RAAAEAAADADAdADAZAEE..eAFA..aAHDBBCCGCCATCEA.OBHDhAAAHCFAMEFB.hAFAKEGAQEEBhAGAAAAAFGAAXGGAgGCA.LFHB.hAGA......hCAA...,2,-19,-8,11
fJQMFKPTNGWcIdBUAXSLaDVHeRCEOZYbg,LAAAaAAAHACBRAEAEAEAZCEE....bAGDJDHB.FEAAKCAA.TDCAhABAGGCB..IEAAhACAdEFAAAHADBBB.eFABhAEAOCCA.fEFA.MEHB.hAFAPFDD.cGBChAEABHHA.SGGD,1,-4,-10,6
bMQGLcdaEJgSXYUCOVNAFePTfZDRIKWBH,eAAATAAAZADB.RAFA.KACCHCEB..bAEAGDBA.dDGAECCASEHHhAAAXCEACCHAOHCChABAAAFAFEEB.DGABBEHAhAAA.MFCBcGGCaFGCJHEA.....hAGA......hAIA...,1,-6,-13,7
UOIgWbLCfZTHDMcXEPGSKFVAeNJaYdRQB,eAAAaAAA.RADABAGBOACD....ICCAbAEALCEB.hAAAZDFBHCEAMAIBEDHFGEAAhAEAFEAAAAIBJEEFdEDC.QGCChABAWEHBCHFADBBBXGFD...hAFA......hAGA...,2,-11,-8,3
VJCIGYMaePEOdZLXWTDbKAHgNRfFBUSQc,HAAARAAABADBQADC.VAGBCAFAGAGAaCAC.ECCAZDDALDEBhAAATFAA.KEHBAAFAfDHAhAAAFFAA.SFCBhACAIGGAeFCHdGGADFFB.bFDDNIDB..hAIA......hCCA...,1,10,-24,34
ALRSgDCUXZMaFNOVbYQcfWPdGJBTHeKEI,RAAADAAACADB.ZABE.FAFAOAED....VBEBQAGA.hADA.fBHAhAIAdCCAGCFABCCAHEDBEDHFAAAALDHBhAGASEEA.XFGAaHFANIBB..hBAA......hCAA...,1,-7,-40,33
KDWJYROZbgIUSfLcAEaTCFeHXBPGNMQVd,EAAAaAAA.FACDHACB.BAEAGAEAMAGBdAGBDAHBJBHF..RCEBZDGB.hAAA.bDDDUEAA.LGFAhAEAAAEBeEHBXFFDhCAANEEA..........hCBA......hDAA...,2,-22,-15,7
gGKZcWeaOILRQMdNSEAVTXHDYfPbUFJCB,TAAAHAAADACA.....fAEAbACBFAEDBAGAGAFAZCEEeCCDhAAAaAHFLCCBhAAAREFAdGAAEFEBADHAXEDDhBHA.PEHBCGCAKGHB.OFFDMICA....hCAA......hDAA...,1,-1,-8,7
HdUZCRLGAgQeOSMPXTWBcYKFNJVDbIaEf,eAAAMAAA...TADABADAKAFA.FBBBVAGBDAIB...aCCBHCDAhAFAZDDAREGFACFA..QDGAhAHASFAAXFEAhBAAcFCD..YFFFJDCFEHCA..fHGFhCAA...hAAA...,2,-22,-21,1
UBCSGEbTVDHeZIMYAXFQPdKgafNWcJRLO,QAAAdAAAaADA.....fACFNAGA.JAEBRBDBLAHBhACABAGAGCFAECBFTEGAhBAAHDCBeAHHZFCAMHBAhBCAADCBFEHDKGAA.cFDDCGGDSDDDhBDADIDAIHHA...hBHA...,1,2,-16,18
OVbRPTBJQDFWIUfLNacZSGXAeHdYKCMEg,HAAAdAAACADA.EADE.OAFARAEFBAGB..QBFDFBHD.ICCAhAAALCCB.aCGHZDEAhACAGEDAABIBeECBMDABhACAbFFA.....TGFADIDA...WFFEhADA.....hCAA...,1,-9,-27,18
SLXKRJgGTFYDVZACBOcdWaNUMEQbPeHIf,OAAAdAAAaADA.UAEA..EAGAQAGA.eBBAHBDASDDAhBAALCHBRCAAGDFAhBBATDEADDIBADGABFGDhACANIBB.bGAAfHGFKGHBFHEA....hBIA......hCAA...,2,-17,-1,16
BFGSODKfJZHNcMAaCEYRTbULIeVPdgQXW,EAAARAAAUADALADA.eAGHdAGAQDDABBCDGCDADAIBKCHBZDFBhAAAHEAA.MEHBABFAaDHDhABATGEA..IGHAhCAA.PHEC.....hAAAWCCD....hDAA...,1,-6,-30,24
gTcBGYIZWLXOaKFCNQEDdRPHAJVSeMbUf,SAAAeAAAMAEAUBDA..TADAGBGAZAFBLCCDhAAAaAHDCCCAEDABREEBHGBA.AAIB.hABAbDEAfGHAhBGABEDDIFFA.OEHD.FFAHDIEAPFCBhAAA.....hCAA...,1,-3,-5,2
dfRaeDPGgWSNcJYHbCKULOXQBTEMFAZVI,ZAAAdAAARADAeACEGAGA..SAFBJCBBHDCB.KAHBLEEBhACAQCCBEEGB.ACFBfCGAhABAaEAHDDIB.gEEBhAHANIAB.bEGDOGAE.BGGDMDIBhCAA......hCBA...,2,-19,-1,18
CKLfNOYSIVRDZQTMBacePFWXbJgHEAGUd,dAAALAAAOADASADHRAGB.ZAEBMBDBBAGAeBEBFBHD..hACA.XDFDJCAAHCFBhABAAAIBGEDAKEED.fCBAhBAAIFHADGGBaFHD......hACA......hAIA...,1,-12,-28,16
HeVGFNZMfgaIcABbKOdUJQSCPLRDYWETX,KAAAdAAAQADACACB.RAFA.DAEA.EAGAHCACGBCBZCFEMDEBhACA.aEHBABIBOCFEhAAA.SDDDhBFALFFBTGAAeEEEFFFHfGEAIHHABEHBhCAA.....hADA...,2,-26,-10,16
DNOQgcMISATXFdRUBWPZJCVbGLEYeKfaH,TAAAdAAARADABAGB.ZABBCACBGADA.EAFAeAHH.KCEAHBGBhAAADDDB.QEFChAFA.MCCBADIBFEAAPFDBhAIAVEEA.YFHB..aFHD.OGCChAEA.....hBIA...,1,-7,-28,21
GeYUSIDFPaWKLQRcZXBACgNbEOVdMHTJf,CAAA..bAAAEACA.dAFAHAEA.JBHBeAHBUCAADBEB.FCAA..aCDDhAAALDDARDFBZFDBAAGAOFHDhABAMCHBGFBB.hACASEHHIGCA.KGFA.....hAEA......hAIA...,2,-19,-9,10
YdcFIeHKQRbOEUNTSWgJPfaDBXCZLAGVM,GAAAMAAAdAEAFADAHAGBRAFF..EBHFUBBA.SDCAJCDB.hAAAaDFBXDGA.hAGAZFDBAAIBVEGB.IGBAhBAAeDBHbFGDTGEAPHAABEBDCGFA..hBEA......hBGA...,1,-2,-15,13
WTXVEDLfKQBdNUFaeGYRIZOAgCJHMScbP,CAAAHAAA.MACASACA..bAEATAFAECCALCFAhAAAKBHBdCAAFCCAeDEBGCEAhAAAREGBZGAAAAIBJDHF..cGEChAGAXFAA.fGDA.QGFAhACA.BHAAhADA...,2,-19,7,26
DeJLYCTANRfXFbgWSEOMHVBZGUKPIadQc,RAAAFAAA....bADBSACH.EAEAHAFAZAGBGCDAhAEAKCCBaCEDdCHAQFFAhBAAeDFHLFHBTGBAABGBfGGAhAAAXDGA.OHAABFCB....hABA......hAHA...,2,-11,-8,3
fGIELHeSXVJKMaWDdgcYURTOCPBANbQZF,QAAAZAAAGAEAEAGAHACA.eAEE.XBGAKBHBaACAdDDA.hAAA.gCDAhAHAUEGARGAACFFCACCBbDFD.FDHH.LECAhAIASGDB.MIFADGIB....hABA......hAGA...,1,14,-17,31
SfWFLKdPNRVDbIQYgBOGTHaeCEAZJUcMX,ZAAAUAAAMACA..SADAFAFDdAHARCCA.DAGA..QDFAhABABBFAGBGAHEBAeCBAhADAADIBXFFCLDEBKGHBhBEAPEAA.bEFDIHBA.OHEEhBHAaEHD.....hAEA...,1,-1,-26,25
caASPbZfQIOgYLBJeXTdNHMVKGECWFURD,SAAAZAAAQAEAOACDLAHB.eCABdAEAHAGBMCCBGDDAhABAEDEAFDHDREBAaDGCAAAA.hAGA.bFFCfFGAhACA.gGBABGBD.....hAIA......hBEA...,2,-16,7,23
SGIQaPMdJbOcRXHgTLZVKNFeWYBfUCADE,EAAAGAAA.aADAdADA.OAFARAFFHCDBLBCDZCGBKEBAFFFHeBEHBAHBhAAACBGDABIB.DDIB..QDFAhAAA.MDIBhCAA.JFFF.........hACA......hBAA...,1,-17,-24,7
DHNXBdMAPeJVaUgKCRIZGcTEFLQYWbSfO,eAAAaAAA.KADARACFGAEA..EAFELAGBQCCA.bBFAhAAAOBBH.HEAChAEABDFAAAIBPDHDUFDACFGAIHAAhABAZEDFTFFAFGHDSGBADIEA.hAHANICB......hAIA...,2,-18,9,27
bSZWdEHRDcNGgeYXUMBaOVPfFAKCJIQTL,CAAAQAAALACAZAFBEACAHAEA.RCDBDAGAGCCA.eAHFXBGAhAAAMCIBODABhAAA.VEFBFDCHADGAKHEATEGAhCAASFCDdGEAgGGABHHA..hCDA......hDAA...,2,-6,-6,0
McPOaXdeEfVUJYCgRKGZQWISHTDLNFAbB,MAAAOAAAdAEA..EADAUAGA..CAFARAGFZBBB.QDDAhBAASBBDHDFALCCBhAIAABBBBFGAaCEBeFHHJDGFKFDAhBAAGGBB..IHHA.DCIB..hCAA......hDAA...,1,-8,-25,17
PHGAENdQTbROLcDVIFZefYKaWUMgXJBCS,EAAAdAAAQADARACA.LAGBDAFAFAHDeBFFKCBAUEDA.MAIBhACAXCCABBFBSDADhADAHDAAADGA.TGFAhBAAbEFAOGEA.IHEAfEHAhBCA......hCDA...,1,-15,-20,5
IcgLWJDNeGbdaRFVOYSHPKfZCXAQMTBEU,MAAAEAAAUADA..IAEALAGBDAGAeBCDGBBAdEEARFBBOBEEhBAAHGECKDBDZDEAABBBBFDChAAA....gFDAhBDANAIA.aBHD.FFHD.SGFHhBHA.....hBDA...,1,-12,-16,4
SNBbYaPHAMFVXUZDTeQIWGfJLgKECdcRO,MAAAXAAAZABEDAFA..eADA.QAGAGBDBLBHBhAIAECDAdDAARCFBSCCDhBAABDCDaDHDHEEBADDAFDFDTFGAhBGAfGHAKHDA.OHDC....hAAA......hABA...,2,-17,-4,13
eREaAYfXPNdQCSFLVObWBDcKZGTMHIUJg,XAAAdAAAQADAFADA.LAGB.OCAEbAFDDAHBZDCEGBCAhAAAHEFAUFBBeCHHEEEAhABAAAIB..fGHAhACACFCDSFGABHEAKGFD.MIAA.IHHAhAIA....hBIA...,2,-14,-4,10
YNSbOgREJWPXGZDIBUAKcVfLHMaTQCFde,KAAAVAAAHACB.aAEAQADC.dAFAeAGH.SBEBhAAAbAGDRDDA.ECABPEGDhAAAZDEABCHA.AAIBLFFAhACAMEIB.CHHA.YFFF.NIAB..hCBA......hDCA...,2,-15,-8,7
QUfEJNLXMWGYZcCORKegTVIFSHDAaPdbB,dAAAQAAAEADALAGBMADAGAGAZABBOBEDRBDBKDBA..eCHHhAIATEFAFDCDHEFB.hAAAABGBaFHDbFBABBFC.hBAAfFHANEEA.......hBIA......hCDA...,1,-5,-6,1
ZPHMRYgeQBWSEcNOCdJKVbLXDGTAUIFaf,FAAAZAAAHAEARACF.eAHHQAECBCAAECCBOAGD..dCEDKDEAhAGAbDFALEHB.hABADAIBAACAaEAAMEDBgEEGhAEASFFACFHDXGAA...hBAA......hCAA...,2,-31,0,31
XUTZLDeKBaSFJYOHdfACPWbgVEcRQMIGN,CAAA..bAAAEACA.RAEA.MAEAGCAA.UCGAZAFEeBDH.aCAAFCCAhAAAOCFCHDEBAAHAPEEAhAAA..gGDBhACAQFGAXGGALHCADFAB...hABA......hACA...,1,-6,-10,4
IPbaNfECBRGDMXFHVKgALTUYSWJOeQdcZ,TAAASAAA.OACDeACEdAFA.ZAGBIAEAaBDH.EAGAhAAARDEBGECADBIB.MBIBhAAAHCDBKEHDACFALDFBhABAUGGB.YCHF.QGAAhAGA.....hCAA...,2,-6,-6,0
fLeSXTRCBZNdIGEFMKPYAQWJgcDaVUbHO,QAAAJAAA.DADAaADAUAGAHAFBLBDBeAHB..TCCAhAIARDFAZFBAdDCCGDGAEFFBKFHBhAAAABEB....gEEDhBAA.cFDCOHFESGHHhCAA....hCBA...,1,-14,-18,4
NTQCZJHbYRBgDcSKfaUFPVXIGLOMeWdAE,EAAATAAAZACBHAEA.RCEABAHBDACAKAEAUECAFAGA....XBDChAAAGEFAMCBBdCGAACCBQDEAhCAACCHB.hAAAJEDFbGAC..gFGAfEHEaHFCIHHAhAGA...hCIA...,1,0,-28,28
RWNdSaBTGUgEOYAKIPJFXfDCLQMebVcHZ,KAAAJAAA.FACADADALAFA..eAEA..bCCAHBFC.RCCAdDGDhAIAaCGAGDFAEEEBACCA.hBAAXECAQGFAhBIAMEIB.ZGAA.SHEGBHHB...hCAA......hCBA...,1,-10,-22,12
SLaZMPDeHKACYQXTRcfVgUNIWOdJEFbBG,QAAARAAA..fADBUADAIAGAdAFAEAHB.BCCAhAAAGCEBaCEC.ZDBAMCHBhABAeEGFHEEBAAIBXFBAhAAAcGFD.NEIA..OFED.....hAIA......hCAA...,1,-4,-23,19
AbPOZCcRdXaVLQISKTFEgYDefNHGBWUJM,OAAAZAAARAEAdAHA..aADDLCAB.QCCBKAFAEBBBDAIBeCFFhABAHCEAGDGABDBDUEEBhAFAAADACGEA.XFGDhAHASFAATGCA.......hACA......hAFA...,2,-17,-15,2
THZLJVbOgGCNADQEMSfcBYKXdURIPaeFW,EAAAMAAA..SACABADAKAFAdAHARAEFaAGAFBBB..HBGBZCDALDHBhAFAbCCD.GECAhBAAACCBQDAC.hCAAfEEBXEFCIHEAeEHFTGCAhAAA......hADA...,1,-3,-22,19
LPYgECKfeJAUTNHOSQVaMdGFZbDIWcBXR,TAAAHAAAQADC.aAFAGACAZBFEDCABIAEABCCDRDEALDHBhAAAgAFHEEDBhACAfBHAAFGAUGBASGGDhAIAdDFAbEDDXCACCHHB.eFGF.hBGANDIAMIAA...hDBA...,1,9,6,3
LQMaAWgTfbVRPZCcDIHEUBJdNXOGSYFeK,TAAAVAAA..RADFZAFBDACAHADC.EAGEBAHAdCCA.OCGDGCFAhAAAFDAAeCHBLEEBhAAAaECEAFFB....fFHEhAIAbFAACGGA.........hADA......hAFA...,1,-3,-26,23
RUQMPXSBcbIgCKEZYFLJdAeNGVHDaWfTO,eAAAGAAAHADAaADA.TBGARAFF..MAIBSAGEBCDA.bCCAhAAACDCDEDFBZEEA.LEHBhAAAACCADDIBOFAAQFFBhACAXGDAIHAAKGGD.FHCA....hAHA......hBAA...,1,6,-10,16
SLXQJfVgBaNUCAIYDeGEZTHWORbMcKPdF,DAAAEAAAHACARABA.MAEAKAECdAHALBGB.QCCBVCDABBGChBAAaCED.CEHA.ADCB.eFFBhAAAZDGB.TGCA..hAIAbGEC...........hBIA......hCAA...,2,-42,-5,37
DTOHeKASfFLEPWagBQCIGJMdYbUXcZVRN,FAAAEAAA...aACDQACAGAEA.dAFAUBGAZAGBRDDADAGAHEBBAAEBLDDBhBAA..gEGAhAAACEHA.MFFBhBEAbFFC...........hCAA......hCBA...,2,-33,-9,24
YaDPSTGfRbFKNUBIeJHCgMXAcdOEVLZWQ,dAAAEAAAZACBQADA.DAGATAEAGBFARAGFKCEDBBHA.eCAAhACAHDFAMDDBABCBOFFBhAAALEEBaGAA.SDHHhADAFGHBNIAB.IFBA.CGGA....hAGA......hAIA...,1,-6,-11,5
MUROSFCGdPXEcIeAaVNbBZHDQJTYfLKWg,aAAAVAAABADA.HAEBQADC.JAFATAGA.LCCBhADAKCEAMCHBRDGBFEEBdEEAEFHFhAAAeBBDACIB.ZGAADDDBfGFAhAGA..gGCB.hAIASGFHCHHA.hBAA...,1,-6,-21,15
WRaDbJPVZCEHfALQSTGUKMgceOYBdFIXN,LAAATAAA.GADAMACA.eAFABAFAdCAAFAHB..XBGAhABARBDBaCCH.DCCB.bDEDPCGBhAAAZDGFHFAAACIBQFCAhBDASDDDKFEA.OFHBIHHA.hCAA......hCFA...,1,11,-19,30
IYARZgBDFGCbQePaMVNWUJLSfdETKcHXO,RAAAZAAADADAGAEA.QAGAeAEAMAIB..VCAAUCCALDGBhABAdCFAEDHB.KEADHFDAhAAAODEHABHBFFHHCGAAaACA.hABA....WEHH.SGEHhAGA......hBIA...,2,-20,-10,10
QHYdCEgLbJUAfFOZcRGXTBSMKDPNIWVae,OAAARAAAGADABADAMAFADAFA....IBGAaAGEHBDCdDAAEBBBhBAALDFA.bFBAhAAAACHAZDDA.TFGAhCAAKCCDPFFAVGDA.eHDACDGB......hABA......hADA...,2,-15,-8,7
PDJMKXedUFAaSVLbGYgCOERIQBWZcHTNf,aAAALAAAGACACAEARAFFBAEA.ZAFBHCAA.TDEA..fAHAhAEADAIBMCHBeEAAhABAdDHAABBBSEDAhBAA.bFCCOEHDEGFAIHHAQGFChACANICB.KHAA....hAEA...,1,-7,-10,3
BACeMFDJHVUNWOTPgfQabcILGYKXZSdRE,eAAAMAAADAEAHADA.UAGAOAFE..TCCA..fBBAhAIAbCEDLDGBGCDAhBAAXFAAdCFBEDBAAAAAFGEBhAFAVFFANDIA...gGDG.aCHDhBBA......hBDA...,1,4,-21,25
JcMHfAbZTYOGFRgCXDEeWPBQKdVaINSLU,ZAAATAAAGAEA.RAGB.XACBECAA.eAEABDDAdBHAaACASCCAhAAALEGBUGAAhABAMCFBHEFBADIB.bFAAFFFBhAGADEEB...WEHBKGDB.NIAB.....hAFA......hAIA...,2,-10,-7,3
OHFbIREKAfQWTaeGDSBYNPJXCLUMgVZcd,QAAAaAAAGACABAEA..PACCCAGALCFAMAFAZBDEdEAAHEDAhAEAFBHBRDEAADEA.TFGAhAAAeBBDSEHBhAGA.YFGBNIDB.XGCC.hCAA......hDAA...,2,-18,1,19
WTbJGaCVNgYdeBXFOfScIDMRQPUELKZHA,TAAAGAAAaADA..CACB...VAGBNAEA.dCDABAFAOCFBSAGHhAAADDIBREBB.QDFAhAFAEEGBLHEAHDCBhAIAAAAB.bFFA..gGADeHEA...hBIA......hCAA...,2,-19,-4,15
gORPVIMZTBEFSNWGLAQJfHbcUDCYdeXaK,QAAAHAAAUADACAFAeACA.KAFARAGF...VCDAZCAAEDFB.SCHHhAAAGCGAAAHAbDABhAAADEEBdFFD..aFFBOFHDhACAMFIBTGCAFGDH......hADA......hBIA...,1,-7,-11,4
DfGIVQHAFadMgOSTJUKeRNXWYbZCcBPEL,dAAAMAAASADAUAEA.RAFF...XAGA..bABDZBBBhAHABAHBECGFLDDBhBAAGCGAQEAAhADAHFEBABBBaDHDTECAKGGC.eEEH.YFHBhAEAcEBD.fGFAhBAA...,2,-14,-6,8
PMUICFfWHJdNBZKagEYVTDQXLebRSGcAO,MAAACAAAFACA.HACC.dAFAZAEBKAHBEAGA..TCCAQCBA.hAHAeBHFRCFAGEEA.hAAAABBBOEHBIEEA.hBAAfEGE.NDIAaGCA....hBCA......hCAA...,1,-12,-30,18
NYKIfUXRWOgAJMQPCDVBEcLGdFZTeaHSb,MAAAQAAADAEABAGAEACAGAEA.ZAGBeAHHHDCBSBBAhBAAbEGB.KBEAfFFAhAAARDDAODHDABBACEBCLGBAhAGAdEBAFFFB.aGHDIGDA...hBEAWHEA....hBEA...,2,-32,18,50
bCMOHUAcNSFRKEXGJWLZVBITDeaPQYdfg,SAAARAAAEADE.GACALAFBZAEABAHBTCCAeCEF.aCFDhAAAQDGA.hABAdAHAbDGDMECBHFAAAAAAFEEBhBHAXGFCVGFA.DCIB......hAFA......hAGA...,2,-6,-4,2
gKMTXdSYBRNJfbCeFEaOGDcQPVAULHZIW,HAAAZAAA..IAEAKADCMAGBdAGABAHARCAA.JBEBCCEA...ECABGDEBhABA.QECChACAACCALCHBTFGAhADASDDDfGBEeDGFaFEDDAIBPHDAhBGA..WHAA..hAAA...,2,-32,3,35
XcGgOLFeCPIbdYTMaVAKNSUQDBHEWJfZR,SAAAQAAAHACAEADA.JAFARAFAGCCALCEAFCFH.eCHBhAAACDDD..bDFAdDAAMEABhAAAACCBKEGBDFCABFFDZFCEXGFAhAEAOGAC..IHHA...hAIA......hCAA...,2,-9,-6,3
cYSNULgBeIFWfRACbEaVZTQHdJMOPGXKD,EAAAZAAAHAEAdADA.MAIBGAFADACA...SAHBLCEAeCCBhABAFCBBRDDBAAFBaEEA.TFGAhAGAQFGA.OFDHhAAAKGCAYFFFNIEBBGFDIHBACHAA.hAHA......hCAA...,1,-7,-10,3
LNPROMAbBQGJWDcVEXKfUHTFedIgYSCaZ,QAAAGAAADADAEAFAKACAHAEB.eAGBdBHA..ICDAhAAASAHBZCEBLEGBhACARDCAACDBbEADBDGDJEBB.VFFAhAAAfGDA........hAIA......hBAA...,1,1,-22,23
HWRSgGNFAcXKMVfPOLdIeZTbaJQUCYBED,KAAAMAAA..VADAOACELAGBdAFAeAHBZCAA....aCHDQCCAhAIAUEEA.BBBDhBAAHGCARCGBGEFAhCAAAAIBfGHAIFDA.......hAAA......hACA...,2,-25,-12,13
IVeUYDEOKgfdHXSCZMQPBGNTbaLFARJWc,RAAAJAAA....IAEAeADEDAGA.KBDAdAGA.HCCA.CCHAZDAFhAAAMBHBQDFDhABAGDDATFGAaECCLGFAhADAABIB...cGBD.....hBAA......hCAA...,1,-4,-46,42
KPLDRIHAdaJVGZUcSYXfeCQFMONgBEbTW,aAAAGAAAZACB.SADA..fAEAeAFHQCGAhAAAMAGBOAHBBAHAECDBhACATDEAKEADLECAhADA.RFGBAEGBdEHAJHAAcEDC.CBBDFFCH.hAEAgGGG.hAHA...,2,-16,1,17
GJaLSIcAFNRbYQETVHdUWZOBgXKPfMCeD,RAAAQAAAEADE.HACAdAFAZAGBBAFBKCCAMAHBDBIB.GCDALECAhAAASCFBAEGA.hABAbEABTFGAUFFAOCHDhAAA..........hAEA......hAIA...,2,-32,-5,27
KdJCQPOfRaBHIENXGUeTWYDLgZSVcMAFb,KAAAdAAAQADAOACA.RAFAHCACEAFAGBCAeCFA...TBGAhAAADDEBZDFE.SFGAhACAMCFBAAIBFDGHbGAACFHAaECHhCAABGFD.IHHA..XGGChCBA.YEEF.hADA...,2,-11,-4,7
ZIfKHGRCDQEaBLgNUdTeJFASXWYMbOPcV,XAAAMAAA..OACE..cADAZAFBKAHB.HCCBRAGBQCDChAAAEBBBaCGDLEFAhAFAgDBDdFCDTGGAhBAAeCGDAAFASEFD.bGFA..hABA......hAIA...,2,-17,-5,12
ZgEALJIYQKSMfBWCaePVRTGOdcDbHUNFX,LAAAJAAA.QAEAMADABAGAaAGE..eAHHRCAAGCGAhABAdBEADCCAHDCC.FEAHZDDAhBAAACAAKFDDSDHHhCAACFFAPHACTGCA.OFFB....hCBA......hCGA...,1,3,-33,36
PQeTOGMYAgVHUafNFCEDbRKScXWJIZdLB,HAAAaAAA.FADAEADARAFFKBHB..XAFA.JBBFdCAD.LDDBhAAAQCFCeDFBGDCAhADAAAHA.gEGAhAGAfDHEDAIBbFGDSFFD.IHHAhBAABECAOFFHhACAMIDA...,2,-19,-1,18
dfcMDOFXARIYWTECLaPHeBSZQVJKgUbGN,RAAA..IAAATAEALAGBHACAeAEEZCCAQCAAKDAA.hAAAbBFAdEED.MAIBFCDDAAHAhACAEECFaDFASEGHhABA.gGCAGEFANEIADFEBOFHD.hCAA......hDCA...,1,2,1,1
NVEGdXLPSefZTbDMgJUWCAFaKOQHBYRcI,aAAAQAAAHACBRAEA...IADAEBHFdDEALEAAeAEHZAFBTDCAhAAAMBBBUDGB.AAHAOFGDhAEABAHAcCGDhBCAVGCA.GFEB.SHCADGIB.WHFAhCAA.....hAFA...,2,1,1,0
GLOASbaMecHPVfDBZQdIRFXENYCTWgKUJ,aAAAeAAAHACB..fADAZAEAdCFARDGFEEDBCAFA....TBGAhAAAKFAAUGGBGCCBAAFAMAIBhAHAPDHD.BAHBhABA.QFAA.XEFDYBBFhBAAJFCE.....hCAA...,2,-15,-1,14
bcNOWQJKZCGVgDMBLSXTdARaUPYIEFefH,RAAAaAAAUADA....IADAEAFAFAHDHCEC..bAEDOCCBhAAAQAGAZEEACDHA.GCCAhAGADFIB.MBBBSGGDhABAdDHAACCBeEFB.fGCE.hCAAcGEC...hDAA...,2,-23,-2,21
FeRKEcNgHVLQCYOBMfJSIdTPaXZbADUWG,DAAAGAAARABA.EADA....NAEB.HAFALBFAQCDA.hBAAOCFEMCDBSCEDhBGAdEGAaDAHbGFAAAABFDGAeDCBhACAKEFA..VFDBBFFCIGGAPHAA..hBHA......hCAA...,2,-30,17,47
ZSDIOXVgKNYQbLfWFeCEdAcPGBJRUHMaT,GAAARAAAHADBMAFAZADADAEA..OBFA..XBGDKCCDQCFDhAAAbCDB.LDABhABAFDFHEEHBAAABBEEDaAHF.hACATFGASGGBgGEBNDDA...hBCA......hDAA...,2,-19,-3,16
FHWNZEQIOGdDVYCeXJUfKcAaBgMTLSRbP,aAAAMAAALADARACA.FAHBHAFB.ZCCAEBBBQDGAGCEAdCGDhAEADAIBCDCA.eECBUFAAKEEDhAFAAEHABFHATGFASGFHhAFAPHAC.IHHA....hBAA......hCAA...,2,-17,-2,15
fYdCOUaeBFRSXgEGIDZJMAPLcNKbQWTHV,LAAAKAAAQACCHADBVAFAdAEA.OCABeAGBRCFB..XCGAhABAEDDBDAIBZFEE.ADIB.hAAAcCCC.bEFBfGHAhAHAUFDA..aFAD.SHFAhACA.....hCAA...,1,10,-25,35
RBQKgTPZDHOYECFNUIaScAXGMVWebdfJL,GAAAMAAA.eADAdAEALAGBRAGBKCDA.TBBAZCFFHEAC.EEEBhAAAFDBHUGGAaCHDAAIB..hBAA.XDDA.hACAbEFDBDHA..QGBADIAA..hBBA......hBDA...,1,-8,-18,10
bGZXdKFcfCNeOPSRWIUQBHVaYLgADMTEJ,MAAAEAAAGACAdAEAFAGACAEA....eAFHSBBARBGFUEAAHEDAhAAAaBFD.LFHBABBA.hBAATGEAZCGBKDDAfHABhAEAOEBBIGEABCBD...gGGAhBEA.DDIB.hAHA...,2,-24,1,25
daWKcICZLRVAXeNGQFMbODBPSHfYgETUJ,eAAAGAAAMAEADADABAFAHBCA....fAHAEAHBUCDAaCFEhAAAKCFACDED.REBA.ADIBQEBDhACAbEGB.SEFAhAIAgGBAdGCDIFFA...hBAA......hBCA...,1,-5,-26,21
RefdYGVaUQKTZPDgOJcHCIEAMXSNWBFbL,MAAASAAABADALAFARACF.eBBBdAEAGAGA.aDEAhAAAQCFAZEEADDIBOGAAhABAHDCBEEEEAAIBXGGAhAGAFEHDbGAC..fGGE...hBGA......hCAA...,1,-7,-18,11
PCTUDWJgdNBVcARSMfXGZeLYIKHOFQaEb,RAAAMAAAGADAZABELAFAKAFAHCFA..QDAAECCA.CAHBDDDBhAAAgCEA.dCHAhAGABEFDAEGBSFCAhAHAeEGHOFABbFFAPHDAWEHHJHCA....hABA......hADA...,2,-10,-6,4
YFBPEGCaHZgANMJTcXdeVWQSIUKbfODRL,MAAATAAAdAEA..eACEQAGAUAFAKAHBOBBALCCBBCCDhAGAECEBaCEEHDGB.ADBAJEEFhAAAXDFA.SEEDhBAAfGDERFFF.FGGHCHHANIBB....hBIA......hCAA...,2,-18,0,18
RgfUBPSVOaZMQeXCYdDLKINTWGcAbEFHJ,EAAAHAAARACA.UADABAFBSAFA.OAHDZAGBeCCA.CDAAdEEAhAAALDDAKDHB.TEGAhAAAGGEBACABbFDBFGCB.hADAJGAA...fGGE...hBIA......hCAA...,2,-23,-6,17
dGcYHBeAPWTVEKQMONfSJaDLIRUXgFCbZ,TAAAEAAAKACA...MACAOAEA..SAEAaAHDLCCAhAAARAGFXBDCCCGDZDFEGECAhBFAHDEAACCB.VFGBQFGAhBHAfEDEDGFB.gGDA.hCAA......hCBA...,1,0,-15,15
EPcQeSDUWfKaOIYbgdVZTXJMABFHNGLRC,HAAAGAAARADFEAFEQADADAIB.UAGAKCADOCCB..bCDChAAAdCGAZDFEJDEBABFAFFGALFGBhAAACGGDeDAD.fHDBhACAaFCD..IHAA...hADA......hBAA...,2,-14,-8,6
PCeHNJRGAIQSZYcOKXBbfUVFdEWgLaMTD,QAAAZAAAOACABAFAUADAdAGA.ECHFLAHB.aBFEMDBAhAAADCCB.eDEFHDDARFBBAAIBhBCASEGAKEHB.hBDAbFDCFFFB..WHEA......hABA......hCAA...,1,-12,-28,16
JCGMVASKLPIcTYBXZfUeHRbENDgQWdOFa,LAAA..IAAATAEAXAGBZACAeAEEHCCA.hABAEBHFDBIBQDAChADAdCAAaCCAGCFAAAHAKDFAcECDhCAAfDDERFFAgGCAFEHDMFDBSEAAhACABHHA...hCBA...,1,-4,-7,3
dBYEacZADFfGHbCMTSPXONIJUKgQWVLeR,FAAAHAAAMADATAEA..SAFAOAGDICCAKBCA.QDAChAAALCFARDDBdDEAhACAEEBBZECBAAIBGGEBhBAAbEGBXGAB.NICB........hBEA......hCAA...,2,-26,16,42
KHJaNRDQBUdMFAPLTZXSOVWIYfbgGECce,TAAAZAAAOACA..VADA..IAGA..bAGBEBEFhABAeCAAHCFAaCEEREEBQEGAhAIAdEEAAACALEHBhAAASCCDfGFACBHA......hBIA......hCAA...,2,-15,-14,1
IGQeMFBRXCOKTcDPVALUWgNHbESafZdYJ,LAAAUAAA...NAEA.HADA.EAGEaAFAdCDD.JCGBGBFAhABAeDABBEEARCAAOAHDKEHB.hADATFBADFAB.ABFBbEGDhACAZGCAQGGC.MIAACFEA...hCAA......hCBA...,2,-13,-9,4
SfCIYROEBFcdUDMGXaJeVAbQZLWKTgNHP,ZAAALAAAKADC.TAEAHAFASCAA.CCEA.RAGFECAAFCGDdECAhABAMCDBGEEAaCECeCHHhABAAAHA.QEAAhACA.gEEAfEHAOFHDBGHADICAhACAXGAC..hAEA...,2,-14,-5,9
RPGgHBAKVdCfMbDLJITacWEQOZYSNFeXU,dAAAMAAALADA.JAHBaACE.EAFAZCAESAHHFCEA.eBBBhAFAREAAGEDAHCFAADDACDHA.hACAbECADFFA..TEGAhBAAQGGAOHBA.XGGAPHAA..hBHA......hCAA...,2,-13,-5,8
DJGfMbBAXCHecFWdUaNYVTISPLZKEQROg,HAAAeAAAFADDdADAaAFA..VAFA..TBFASCCDZCAAECHFhAAARDDFDCIBGEDA.bFBBhACAAAAACCFD.UFAA..hAFAIFHALFFAQGFDOHDAfDGAhAIA.BHHAhCAA...,1,10,-18,28
dDGYTFOVeBZWAUcSQXKJfHMgNIaRPCbLE,SAAAQAAAKACAHACB.MAEA..gAEBaAGERBEFCCGALEBAhAAAEAGEGCDATEGAhABAOCFEBFFDACDBXFFAhAAAfGEEIHEA....hAIA......hCAA...,1,-5,-23,18
KUIXMHcBSYVOZWLFDCbJQGaRTgEdfPNeA,KAAAXAAAHACBSAEA.OAGDZACBLAFA.hAAACBEDbCEAGCAAREEAEFHFdDEAhACA.fDGEhAEAeGAAAAAAMICABFCA.VGFADGGB.aFAH....hAFA......hAIA...,1,-9,-11,2
IbLRBEDSdXVKHNMGUTeacZJQPFYfAWCgO,CAAAOAAALACARADABAGBDAGA...dCCAKBFAHCFAGCCAUEFBeBHHhAAAZEAA...QDAAhADAFGGHAAIB..IHCAhAEAEEFBXFDD.MEIBaBBH.PHFChAEAWEED.SHBGhBHA..NEIA,1,-16,-26,10
bAJdaXNIGPRYKScHFgCTeQLMBVUOEZfWD,aAAAXAAAGACARADA.KAEAHAGB..CAGB.eCDBMAIBBCFD.ODABhAAAECEAZDFBDDIBABBBdEAAhAEAIEGA.SFEHhABAFEEB.TGAALEHBfGGAhADAJHCA.....hBAA...,2,-15,-5,10
NBOWJHUTIFfVdgDXbMGYZLCaAPcSEQKRe,SAAAEAAARACA.eACHOAFAHAEAUBGBTCFAFCCH..dDAAXDDChAAAGDGAZECEaAGAACEBhABAQGEABCHBIEAAhAEA.fEGA.DEIB.MFFBhCAA.CGHD....hAAA...,1,7,-17,24
KdgTJfZDWcBRMIabPAFXONeHGQSUVCYEL,OAAAHAAAGADAUAEA.CAFAEAHBdAHA...TCFAZBCBDBBB.BDFAhBAARCAAaDHDABGA...XFAAhAAAeDGH.QFEAhACASEDHLHEAKFHB.....hCAA......hCCA...,2,-41,14,55
aEVgFZMJPIAeURYbKdXONBQLHTWfCcGDS,RAAAKAAAdADAOACABAFAHAGB..TAFACCCDGCEADAIB..EBCFFDHDhAAAZCEA..MEDBIEEAhAAAAAIBUFAA..bFCChAHAQGFALFHBfGFAaGDD.hABA......hAFA...,1,-12,-15,3
gEPDacXWFVNRfdHObSTQYMLKJBAZICGUe,ZAAAGAAAeACEEADADAFA..aAFD..XAGAFAHBRCDBHDFB.SCHHhAAATCDAMCCBhABALFBBBCGAADIBCDCDgFDGhACAPEFB.WDADfEGBdGHA.hADAbFCD.KGHB...hBAA...,2,-16,5,21
EIJLZfAPbRQBNYXWHaOVTdUFDgeCMKSGc,RAAAQAAABADB..XAEDHACAaAEA.TBGAdAGBDBHBeCDFhAAAMCCBGCEA.EDHFhAHALDDAAAIB.bEFAhAAAYFHBOFDBFGGBKGDASGFHhCAA..IHEAhABA...,2,-30,16,46
WIaZADgbUeQcRFBXMfPSdVJGKCYHETONL,DAAAUAAAeABARADABAGB..MAFA.SBCAdCDDGCFACBFAHBGBhBAAEBHF..ODABhADALDDB.aDFHADIBbFGDhAEAQFBA.XFGAfEEEPHFChBFA.....hAIA...,1,-5,-30,25
BADCJQFESRZcVUPLTWXdKIfGaONebMHYg,CAAAQAAAFACA.RACAZAFBUAFALBHB..TCBAdCECfDAAhAAAaBHD.eDDDhADAHDEABFAAAEDBEEHFSFFAhAFAVFBB.PHCAKGFA.IHHAhAIA.....hAAA...,2,-31,5,36
IZFcWMCEJGXOdHDgVKSbTPQeBLAUNRaYf,RAAAaAAA....fADBZACBFAEDMAGBEAFE.GCGA.dDEAHCCAhAAADAIB.KBHB.bCFDTGFAhAHAeDHBAAHA.UECBhABAIHBACGGA.OBBB.....hCAA......hCCA...,1,-13,-19,6
IUGdMJXNSKRcYEPebFAZQOVCfaTgDWLBH,ZAAAQAAACADB.aACETAFA.DAIBLAFA.HCDAhAAAGCAAdCGAMCIBXCCAhABAKDAARFCAECFBeFFEACABfCHEhACABGAAIHHAUEFBSFADhAFA.cGGC.hADAYHAG.,2,-9,4,13
gHFaGQIRDWfSOMJPZeATNVYCcXdEUbLKB,TAAAVAAA..CADB.dACA.EAEALAFA.BCDAHAGBGCEAhAAARCDAfDHAMCHBZGAAhAGAAAIBNEAA..XGFAhAHAbECAFFHD.aDCHQGBADCIBSGCE.hAAA......hAEA...,1,-2,-9,7
eAFEcHbLDYXIfCUZOSWBPNgGQKVMJTdRa,EAAAHAAALADAXADBCAHA.ZAFB..SBCDBAHA..gCAAhAAAGCEAQCGAhAAAMCHBdDDARFBBAAEAbECDhAHADDIBfFEAOFHB.PGFCKGFB..hACA......hBFA...,1,-8,-9,1
BOJPYMVcRfNKLQTUCgaHbZISFeXADdWEG,dAAAEAAAGACAOADA...JAEAMAHB.RBDBKBFBTCEA.CAHBHCGBhAAAZDBBFDHDACBB.BEFAVEBBhBCA....fFEEhACALFFA.QGGA...hBEA......hCAA...,2,-27,-12,15
HXgIFDWQaPNMZdEOcGBVCSJTAefUKYRbL,eAAAKAAARACFHAEB..XADAFAGADCAB.aAGA..MCHBEBGBGCCAhAAACDED.TEAAhABAACIBUFGBbEFALGBAhAAA..gFEGQEADPHBANIEB.hACA......hAEA...,1,7,-18,25
OTNcQRSgZYBIWCDGFJHEVfKeabMAXLUPd,LAAAdAAAOADATAEA..QAGARAGFZCAABCEDCBDAGCABhACAHDFAEEAAKCFA.eDHFhBAAbFFA.AEEAUFCA..hBCAcGAASFFBIHFADFIB....hABA......hACA...,2,-13,-11,2
MKWHDFcVIOZETeGUYLbRCJSaXQPfBgANd,dAAAMAAAHADAFADD.VBGBZAEB....EAGAeCAAGBBALDDBhACARCGB.SAGEhADAaEEAQGCABDFDAEIBKFFDDFAAhAFAIGHATFFAYHFG...hBAA......hBBA...,1,-2,-18,16
dGXPYTQHFMOIBACcNJegSRKVULZfbEDaW,CAAAJAAA..eACARADF.KAFALAFBZBFE.EAHBaCAA..GCGAhADA..XDAChAAATEEAHFCBMDDBBDHAhACAACCBgGGASEEA.fFGAhADADIAA.dHAB.QGDAhAHA.,2,-26,-7,19
OEgJadGVILefFYBScbQMUPHRANTDZXWKC,TAAAZAAAKADC..EAFAaACA..GBGALAFAeCABFBDHBCCDbCED.hAAAMCEBHCGB.AAGAXFGAhCAAOCFHdFGDfGCAhCCASGCAcGDD.....hABA......hACA...,1,4,-24,28
LAPVfGeYXSdORUaFIbNBJTZgWECHcMKQD,VAAAeAAA..SADARADF.FAGAbAFBBBFA.ZCCAEAHFHCGBhAAAMCFBQEAAhABALDAAACIBGECBdEGAaEEHIGGAhAEAJHDA.gGDACGHA.DFIB.hAAA......hADA...,2,-13,7,20
GMQJRPegHVFZbAfdICNOcaLTSBXEWYDUK,dAAACAAA.OADAaACALAFABAGA..EBDBDBCBGCBA.MAIBhACARCEAeCHH.HDBCZDFAACHBhBAAfEFA.hBCAIGAATFFAXFCDUFCBQGGAhAAA.....hBEA...,2,-25,-5,20
JfMBUYTOAKgeaHRGZEWdVXcbSFNIDQLPC,eAAAHAAARADFEADAdAFA...XBGDSAFAFCAH.DAIBLEEAhAAACCCAMCEABDEATGEAAAAAaDFDhAGA...ZDGBcGGAhACAIHHAPCCBfEDEOFDBKHAAhADA......hAHA...,2,-22,0,22
DWbXeKFUHdREYgTOAcZfBJNaIQPMVGLCS,ZAAABAAAaACAQACA.MAFAGAEALBEBDAGAXBGBhABAeBGBFCAAHDDBREFBEEDBTFGAhCAAABHA.JHEAIHHAhAAACCCDSCHHKEHBdGDD......hACA......hCIA...,1,-7,-10,3
ZISUPTDXGKLFAQRENeCfJHdaVgcBYbOMW,EAAAeAAA.CADA.HACAdAFA.aAEA...VBGBBAHA.OCCBZCCASECAhAAATCGAGDEAhAAALFFAADEB.NHABfHFBhAHAgFBA....cEGDMIAA.hAIAIHHA.DGEBhABA...,1,5,-33,38
MaGVYJLISFfRcdEZOWBQeUPNHCKbATgDX,TAAAXAAA.GADAJACA.LAFAFAFARCCA.ECFAZCFBBCHAeBHHhAAAUDAAHFCAKEFAACCAMEIBhAIAaDDH...IGGAhCAAfFHA.dGAAWHFGPHEC..hAAACEEC......hABA...,1,-5,-10,5
eCZKVMbGRXNUPEfOJaFgBATDYdHQSIWLc,TAAAdAAAHADA.QAGCSACBLCCAeAEAZBEEMCIBRDDAUDGAhAAAEDABODEEFEAAAAIBDFABhAEAIFFA.CFADKFHDhACAbFFC...NIAB........hAFA......hCAA...,2,-12,0,12
IRDdbOJLNGBfWgYQSHcKXTAaeVMPEZCFU,eAAAMAAAZABEFADDRAFAdAFA...OAHBLCCAGCCABCGA..hAAA.fDHAhABAgEFAQEEAhAFAHFBBXGDDAFIBaGAAEGHBCFHAIHHADIAA...hAGA......hAIA...,2,-18,-7,11
OSMbDENZYQgTGLceBCXWKVaHAPFfURJdI,FAAARAAAdADAOACD..MAFAEAEA.ZBEBQAGAGBGALDDDhAAAeCDHBCFACEFA.KDGAaEHDhABAHEABABIB.UFEASGCDhCAADFIB.gGGGXGGD...hAEA......hBAA...,2,-15,-11,4
BWMdKcaCbTNGFYVLSfRHQXIDZPOeAJgEU,EAAABAAAdADAaACA..CAFA...TAFAGAGAFBCBLBCD.hAAARDDFHFAAQCEChAFADDIBZFFAeAHHAAIBJHFAgDGAhAHA.MDDB.bFFA....hCAA......hCBA...,1,-11,-22,11
RVDCNMgYXfadKGWeAZJFHQEOTScLUBbPI,ZAAAHAAAEADETAEALAFBBAGB..IAHARCAACBHA..MCEBhAAAXCAAdDFAGEGAhACAACAAQDDCSDHBhADAbCGDDCIBgEAA.aGCAeFCB.OFFBhABA....hACA...,2,-14,5,19
VQDRYHNUEebXMISgfCPOWdJFcGTALZBKa,ZAAAaAAA.QAEARACF.HAGDEAEEeAGHMCAB..SCCAhABACCEAOBBHdDHAFDEDGEAAhACAAAIBLECAKDGDDCIBUGAAhAGAbFGDXFGC.fGEA.hADA......hAEA...,1,-1,-8,7
GDgcEUHeLMIXOVTPfYRZbQCAaFWKBNSdJ,aAAAKAAABACB.dAEAGACA.DAEAEAGAHAFCLCCBMBBBOCEChAIA..TCGAhAAAfDHAREDFZFGBQGAAhAGAAEEAFEBDSEFHgGEHeFHFXGCAhBAA...hBEA...,1,-1,-25,24
YJDLBCQXVbAKdIUEfgPaHWcSNeRGZFTMO,dAAAEAAA.....fADAaACDHAEASAGERAEFZABB.MCBBhAAAOAGDDCEBLCGBhAEAQDDCbDEDAAIBKDGDhAGAgGDGPEHDNICBFGHB......hBCA......hCAA...,2,-17,-8,9
TOcKSLbZUVDRfQAPFgWeEJGIXaCMYBdNH,FAAAeAAAEADAGADA.aAFAMAGB.dAHAHBFBOBEDSAHHhAAAZCCBDCCB.RDBBADDB.gEFAhABAIDAACDGABFHAhBDA.NIDB.TFFA.LFHB..hADA......hBAA...,2,-26,3,29
KLMVgUNbXOaCFZeWDRdGBAPYScTQfIHJE,SAAATAAA.QADAHACBEAEAMAHBUAGA...bBFDaCCBhAAAZEAAeDABRFDF.GDDAhABAAAIBPFFAfDGAhADAKGHB.LFHBgCAGOFBDCDECDCIBBGGAhBFA.....hAAA...,1,9,4,5
FMagUEcNTfbCSYLRDQdGBKeXIVAZJOWPH,ZAAAOAAAHAEAFADDaAGA..EAFA..TCAACAHALCCARCEA.dCGAhAFAGEABKEEA.eCHHhABAXFGAAACAPFFBMBBBhBAA.UGDAfHCBSHFEDGIBBDDDhAEA......hCAA...,1,-1,-16,15
RBKVGgFZMYTQbJWPdNEDXOICUAfeaHSLc,eAAAHAAALADBRADABAGBGCCAZAFAMCAB.TCFAQCFAhAAAJDCF.dDHAEDHFOEABhABACEEAAAGA.aEFHKFGDFGHB..hAEA..YFHBWFCDDAIBIHCA.hCAA......hCBA...,2,-8,-3,5
NOXEAbRJBVZLKQUCfYWegTScMHIPFdaGD,RAAABAAAZADBLAGBQACAUDAACAEA......fAGAhAAAeCEHTEGAMAIBHFBChAAAFCAAGCEAOFFBAAIBhABAbCGDKGHB..gGAA.SDDDhACA.IGDAhAGA.,1,-7,-27,20
XFWOKCHgQZJVeGARMcBYNfEPLTbdUDSIa,RAAAMAAABADB....fADAEAFALBHBdAFADAHBaCCAFCFAKBBBHDDAhAIAZDDA.eBHHAAAA.hAFANECA.TFDA.SFHBhAIAXEGACFDDgGGDQGGC.hCAA......hDAA...,2,-22,-7,15
TFMcHeKBGfaSXIdOJQPbRUYZWECAgDNVL,DAAALAAAMADAHAFCeADHGAFA.aAHFXBBA.dCEAhAIAQCAARDFFZEBAEEHFABBAhBAAgDED.hBEATFAAKGCASGHHODHBPHBCYHDGhCAACGGD.....hABA...,1,-2,-11,9
BJSLHAcfICFeMONKGXVZRYWaDgPbUdQET,..IAAAeAAAMAEAKACA.GBCAZAEBRAGB.aAGE..DCAA..bBEDhAAAdCDC.EDFFBCGALEABhACAHEBBABEBCDHAOFGBhAEAXEFA..VGCAgGGA..hABA......hCAA...,2,-14,-14,0
VeUEaBgQMKFfOJNXWGdbRScAYIPLHCZDT,..IAAAHAAAZADBDACAeAFA.EBHFaADEQCAB.MCFBhAAAfAGAOCGHXFGAhACAdCBARCFAAAIBLDDBhAGATGAABHFAFEHBWFCDSEED.hBCA.PFFBCHHD..hCAA...,2,-30,12,42
SbeZaEKAGYDMOCBPXFUWgNVQTdLRIHfcJ,GAAAMAAABADAFADAUAGA....gAEHQCDAdAHAhBAARDBFHDFBJBBB.eDHBhAAAECFFADDAOFDB.CGBD.hACAXDGA.VFFAIHGASHBAhBBA.....hBAA...,1,-10,-23,13
cLUXJCZHbAISVDNOQFeEYRdKMGPfTBaWg,SAAADAAAQACAEADA.RAEA...dAGAGCEBTCCAaAHD..hAFA..gCEBhAAALEEAXFGAhAHAZDAFHDGBAAIBNBBAeCCBMEEBBFFD.cGBDCHHD.hBAAIHHA..hABA...,2,-14,-2,12
MUDSFBaeXHGWLRVQTJZPKcACNdgbEIYfO,dAAAEAAA...IADAOACCMAEADAFABAHAeAHFHBDCGCCARCAA.hACATEFAZCGBKDEDABGBCCFD.hBAA...bFFAfFEEhAAAFGBAaGDD.LEHB....hCAA......hCBA...,1,-11,-17,6
gSXVGAJIPEFODNQBLeRWdUfaHKcMYTZbC,JAAAEAAADADABADB..RAEA.dAFAUCBAHBGB.KCCAMAIB..ZECACCFA.hAAA..XEGAhAHAACHBFEDD.QGEBhAIAeEHBaFED.....cFBCYHAA..hAHA.gGFHhBCASHGA..,1,-23,-33,10
ALcPaJgdXNOBKbfQTCDVWRFSHZeMUYGEI,LAAAaAAA.dAEAOACDKAGA.QAEATCAA.DAHBRCCFHCFAhABAeBBDMAIBGEEAADEAJDFBhAEAXGAABDHDCECAFEHBhACAZGBAEGHF..IFHA...gGGGhBAA..hBGA...,1,3,-21,24
XGOEUBNFDMcdReaCWIZLAYHKVbTSQJPfg,HAAAKAAA.TAEAQACC.JAEAfAGBGCDA.ECABBAHBhAAADCCAdCGARCFAeEHBaDDACEADhAAAZFCFACIB...bFFDSEEDhACA.XFFB.OEHDhADA.FGDH...hCAA...,1,6,-18,24
XbVTZANHeKOBUYFJLgWEGPDfCMIRScQda,HAAAeAAABADAFADALAGBEAFA.GCABDAIBMBHBRDEBQECDhAAA.aBEEbCCAZGEEAAAAODFDhAFA.UECAhCAAYCHBJEHB..WGCA.....hACA......hAIA...,1,-1,-20,19
FBAPIXNGdUKOJQTcgbDCeHSYMZaWRfELV,XAAAdAAAOADA..QADA.TAFAbABDeAGFHCFChAAAMAIBaAHFRDAAEBEBLDDBhABABDEDACHB.IFFAhADAGEFAKEHBJEHB.........hCAA......hCBA...,1,2,-19,21
PMERNBFDKJCfabeYZVOHLdUAQIgWTSXGc,QAAA..gAAATACAGAEAMADARAFAFAGAKBDAfCGAhAAAeCCBZCEEHEFAhAAAdDDAACIBSEAAhAEA.XEGAEDBBDCIBaFEHbGBAOFFBhBGAIGHA.....hCAA...,1,0,-7,7
QBHUPFCedGJELVRXAWOTDbNaIYcfZMKSg,TAAADAAA..aABE..IADA..fAEAhAEAZAEBMAHBSCAAhAAAQAGAHCCAFDCDeCGDGCFAhAGAEEEBRGBAADHAbFCANAIAKFHBBEHACGFA.dGHA...hACA......hBGA...,1,-6,-9,3
IeDfXKZAOBTCUYGHbEJacFSPWRLVgQMNd,TAAACAAAGACA.HAEAEACE...aAGASAEBRCABLCGBQAGAhAAAdEEAeEADXGDChAAAACCABCDAbCFD.FDHF.hACAPFDBgGGAIGAADCIB.KGGA..hAGA......hBIA...,2,-17,9,26
KdSLbaPUZICNHfTgXecFGVJYBMOEWRAQD,QAAAdAAALADAaACEZAGB.CCBA.HAEB.TAGAeCEBGDCAhACAVDAABCHAEEAAAAEASDDBhAAAUEGA.fDFAhADAXGFC.FEGDMIBARGAAKGHB....hAGA......hAIA...,1,4,-10,14
XQLDIFENKOeAUTGSHdbPYgBMVRJfaZcWC,GAAAHAAAdADA..bADAPAFA.BBFDRBGFaCDAZCAA..CAHBLDDBhAAAFBHDEDFB.ODAHhACAAEEBTFGASDHHhADAMFFB.fFFA.cFAD.hAAA......hACA...,1,-1,-22,21
ePREJaYHISbKUQZcfgdWAMCGNLVFBXDOT,GAAALAAABADAOADDeAEHRAFA..ECAAaAGA.HBFB.SCDDhAAAbCED.QEFBhACAZDGBfFAAhABAdGHAABHBMCIBCDDDFGDADEIB.......hADA......hBAA...,1,-11,-13,2
HSNQPWOCXaAGZMgfLFebcDYETIVKRUJBd,ZAAAMAAALADBFADD.eAFADAFA..EAHFTCAA..KBBBRCEFBBHAhABAHBEBQDGAhBAAODGDaFAAADIBGGBBhBBA.bFFDIGAAJDDF.dGEA.SGCHhACA....hAFA...,2,-13,-6,7
UbWXFEPcMKHISafABYLZNgQVReCOJTDGd,LAAAZAAAQAEARADFeAFEOAGF.DACAdCAA.UCFA.XEEChABAECCBMAIBHFGBhACAaCECAEEABCCD.gGBAhAIACEFAGEGA.FHDE.......hABA......hCAA...,1,-1,-25,24
HfXQRIdYMBSeALFbVEGaWgTZCDPNUJcKO,LAAAFAAAEADA.aADD..TAFAZAEBDAHBUCCAKCAA.HCFC.QDAAhADARCFFdEHAMAIBeEDAhAHAADDBGGBBCEHA.JHFEhABAfFGE.......hACA......hBGA...,2,-18,-6,12
XMQBRgKGcTCbLDYEfdHJFAIWeaUPOVZSN,eAAAaAAA.OADCZACB..XAEAMAFARBFAGCCACAHA.LDHBhAAAECEBHCGBACCBIEFAhABAPEEB..SFAAhAFABGGDKHEA.bFCDDIBAdGGA.FHAG.WBBDhAHA......hBAA...,2,-11,-10,1
cUfDHNAJILPEeTGYbXdgWOSaCMVBKRZQF,LAAAEAAAGACAXADDdAEB..OAGDaAFA.MAIBKBGDRCAAZDFAhAAAQDECFCBHUFBAHEDBhBCAAAIBJCHB.eFFEbFBB.hABASGGDBFGDDFIB.......hACA......hBFA...,2,-17,10,27
WCYfOEDQTAIcJadXGUZPKNVbRHeFMLgBS,JAAAdAAAGADAZADB.KAFA..VAFAHCAC.eAHHMCCBLDFAhACABCHA.CFAAOFFAhADAEDABQDEAACGBaGGC.XEGBhADAPHAA.RFCASFHH..hAIA......hBAA...,2,-23,-1,22
CXMbIVPOERZGLHaSgQTdKWBDUJcfAYNeF,eAAAXAAAMAEA....IADAOAHDRBCAGAEAHBFBaDBBhAAAQAGAdEDABEHADCDBhAAAUGFAfDGAhABAAFFAFFBDCHEC.bEDD.EFFBSHBATGAAKHGA..hAGA......hBIA...,1,-2,-9,7
LeTJbdYIFQWcHUCEfAGZVXSPORKgDMNaB,ZAAASAAARAEADACA.MADABAHB.LCEAeAFA..TBCAhAAAdEEAFCCHQCEAhABAHFAAEDHF.ABIBGDGA.hABAXEBAKFHBaGEE.bGDA.WHCGCHHD.fEEEhBEA...hAFA...,2,-21,6,27
cdQKAHRfWOLZYDaTEVNXbeSGgBUMCJPIF,HAAARAAAOADAZADBaAFD..EAGA..XBGDeBDFGCEABAHBMCABhAAACBHA..IDHAhAAAdCCCADFBLEEAhACADCCBTGCAbDADSEHHUGGA.FGEA..hADA......hBFA...,1,-4,-13,9
WTOJQeCIcaPEBdXNAHbZLUYgMKGDSfRVF,HAAAZAAALADBUADAMAGBGAFA.SAHBRCAAFAHB.TCAAhABAQDEC.eCHFhAAACDEAaDGDEFBAdFAAAEIBbGFAhACAKFFDfGHA.OHBC..hACA......hAFA...,1,-3,-11,8
IJXVeOBPEZfbcHNLDAdRgCMUTYSFQaKWG,RAAAMAAAUADA..TADAFAFE..QCFAaAFAGBBA.XBFDhAIAeCCBBCHA.EEEBhAAAbDECHGFALCHBhBAAAAIBCEHA.KFCA.IFFA.....hABA......hCAA...,2,-23,-2,21
VdSJUXaEeHfFNRDIKQLgcCYAbGTMBOWPZ,GAAAMAAABADAOADAZAEB.dAHAUBGA..EBFAHBBAFCDBRDFAKDDDLFDBhAAACEFA.AFFB.TFGAhAHA..PEBDhACASFEDaFHB.fGCADGGB..hAIA......hBAA...,1,-8,-34,26
VEZPcIAUgKObWaeLDdTCfSXRFHNQMGBJY,KAAAOAAA..aACAeADAdAFA.CAGA...XBCDHCCAMAIBGBGAhAAABBBD.VDFAEDEFZECFhAHA..IEAAhAEAAAIBbFBDLFFATFCASFFDNIEB.hBFAQGGC.hCAA...,2,-12,-7,5
OPQKFBNfHedTEVWGIZYUSJMDLRgCbaAcX,OAAAQAAABADAHACAdAFA.EAFEGBGAZBFESCDHMBBBRCCA.hAHACDFAAAHA..XEEAhAIAFDHBeEABTFBAVFFB.hAAAIGHA........hBAA......hBFA...,2,-22,0,22
UfbQYcAFZBIEJDedPROaNSgCLXWKHVGTM,ZAAAEAAADADAeACE.RAFF.OAEE..aAHDSAHBLDDBKDFDhABAHBCA.GCEBMCCBUFGAhAFAbEEA..QGGBhAAAADHABHAAIHEAdHCBPCBB...hAHA......hCAA...,2,-20,3,23
ZgdVMSPIELOXTWHCBfeKQaGFbDNURAYcJ,JAAAdAAAMADA..SADBEAGALBDBOAFA..TCBAhACAHBEBBBGDeBFBaBHDhBAAbCCD.DDFBRDGB.AEHAZFGBPFFBhBAAIGFA.CHCA.......hBCA......hCDA...,2,-24,-13,11
YRZPgLWdVQOSKGeIDNHFaCBJAXfETbMcU,EAAAMAAAUADARACA.ZAFBLAFB.dAHAQCBCKBBDGCDAeAHFhAAADDHBHFCBaCHDBDEDhBCAAEIB..TFFA.hBDA.bEFD.PFBA.WHFA...hBAA......hBHA...,1,-7,-17,10
VPCSMcKBfaOWbZQNDYgUFEIRHXTLdJAGe,eAAACAAA.MAEABACA.aADDOAHD.ZBAEQAFADBEA.hAAAUCAAECDAHCFBLBHBhAAAAEEBGFDBSCDAhACAfGHAbDFDgFAAFHBA.IEEAhAFA....hAIA...,1,-3,-31,28
bQKFPLaOETNfeGdWIYAMXDScRHJVBCgUZ,MAAASAAAHACCBAFBCADA.ZAGBQAFAFBBHLCFDECCATCEAhAAAeCHHdDDA..IDAAhABAAFIBDGEA.RDGBgEEGhADAbGEA.aBHFNIBB.GFAB..hAFA......hAIA...,2,-8,-6,2
LKZWMfFQDSARVUcHbdgCeBGTYENIXaJPO,RAAAUAAAHADBdADAeAFAGAFAEBHF....XCFDaAHF.OCCBhAAAZDBAMDFBQFAChABAAAFB.bEECBDHATGGAhADAIFHA.LHBAWFDD.DGGB.hAFA......hAGA...,1,6,-26,32
GSPTFUDOQeLgKAHWERVYXMBbdfCIaJNZc,HAAARAAA.XADBMADAdAHACAFA...aBDDZAGBGBFATCCADCCBeCABhAAALEEBABIB.EDHFhAAABCFC.bDFAfFBAhABAIFFANEEASFCHFFHH.QGGAhBFA...hACA...,2,-7,-6,1
USEfQaIHVPYRAMBOGgbJdcKLDTZXNeWFC,MAAAGAAA.JADAdAEALAGBZAFBeAHFFCDACBBA...UEEAECDBQDBChBAAHDBB.VEFAhBBARGCEAAABOHFC.hBDA.cFECDAIBNDIA........hBEA......hCAA...,2,-16,-11,5
GCVaDcKXZOUfJTAPYSLMbREHQdgWNFIBe,SAAAMAAARACA.HACBdAFA...gAEBFAHBeBBBGDDAhBAAaAGAKBHD.ZCFE.OFGBhCAAfDEAADDBLFHBhCEAEDGBQEBA.IFFACHEA.hDAADDIB.....hDBA...,1,-7,-9,2
QGJBYaTRPHdUcObNCKIAMfDEZVLgXSWFe,MAAAEAAAZACBLAEA..SAEAeAHHGBBABAHAaCGHRCEAHECAhAAAdDEAODHDCCBCACEADCIBhAFAXECDQEGChAHATGAA.UGFAbGFAKHCA.....hAFA......hAGA...,1,-4,-6,2
LKNGDfEVJeQdgHTXWASPZYOFRIaCbUMcB,ZAAAFAAARACFaACA..CAEB.MAFALAGB.GCDAEBEAeBGF.dDDAhABAHFCB.TFFAhAIAABIBSCCDOFHD.bDGDhCAABBFADDIB..fFEA...hBAA......hBIA...,1,-15,-20,5
WRdNOcaJHZUKGAbgLeFQMfXYCVBDSTEIP,LAAAeAAAMAEAXADD..CAHADBDAEAFA...ICCAhAAARBGBdCAAOCCBaBEEHCFChABAZDEBGGEBADEBFEFBQGGAhCAAfEDABEHATFAANICB....hABA......hACA...,1,-9,-11,2
dDUeVfBHcXNbKRPTOQgGCJLFZISYWMAaE,EAAAdAAAeADABACAHADB..XAGAKAFARCFA.TCBAQEEChAAAGCFALEHBhAFAZEAASDEDMCCBAAHAaDDHhBIADDIBfFHE.NHABOHDECGCAFHFC.hCAA......hCBA...,2,-7,0,7
CUTNADcbKJeBYaRWQISOdZgEMLPHVfXFG,DAAAKAAAeACEBACARADF..QAFC.OAHDZAFBEAHFMBDBhAAAHDFC.XEEChAFAGDFATFDAABBB.JFHBhAHAaCCHSCEDdFCAgFGA...hCAA......hCBA...,2,-22,-14,8
SYCHWgZDPVfKNGMTRAFUIeXcBOLdaQJbE,FAAAeAAABADAdAEAQAGA.EBCACAFAHAGB.ZCCADCGBVDABhADAKDDAGDGA.hAFARFDAAAAAXDFDOGACaGHDhAGAbECD....SEED.gGGAhAIANIBB.MIBAhBAA..,2,-15,-12,3
NDRIUdPJbeYCMQgcEAWfXBVZGOaFSHKLT,XAAAZAAAaACA.HADALAFADAFA.RCCAdCFAJAHB...eCHBMCDBhAAAQFFAECEA.hABAAAGABEEDGDAASHEGhABATEEAIEHA.bGDA.CHHA..hCAA......hCBA...,1,-1,-20,19
QOZDCFPYJcGSeAHgIbEBVRaUdMNfXTLKW,HAAA..bAAAEADERAEAdAHAMAFA..XCAATBFALBHBhAAA.QCABhACAZDDAFDGAPEABcCECeFDBhAAAADDBBEEDaFFCfGCEOFGBCFHB.YFHBhABASHDAIHFAhACA..,2,-9,2,11
dbUHZPCIVOWFJSGLRaKBDTNAefEYMgXcQ,EAAAMAAA...XACAdADAHAFA.ZCBACAFA.OCFBFAHBGCCAhAFARCGFaEHDBFAADBBBACCBeCFBhBAA..fGFAhAAA..gEGH.bFEDIHAAhAFA....hAHA...,2,-23,-17,6
ZLIgAVYMdBHbWPNQDUfeXROEGJTFSKcaC,MAAAHAAA....bADBPADCDAGA.eAGHRBFAECABGBBA.TDEAhAGAKCCBaDFC.ZEEALDHBhAIAABFAdGGDBDHBQFCAhBAA.XGFC....hBBA......hBIA...,1,-10,-15,5
WKVbFYMHTRBNcPgXOCaSLeEIAZdQGfUDJ,dAAAGAAADADAKAFAFADAHAFB.RCDBBAHA..PBDBOCHDCAHB.hACAaDBDLCFA.hAAAECBFAEGBZFDA.fFHEhACAUEEAVEBBMHAA..NEHA....hAHA......hBAA...,2,-26,-13,13
SIbLKcWYaZeCHgQJNXERUDGAdPFfBTMVO,dAAAFAAABADAMADA..OAFESAEH.LAGBKBDA..hADA..cCADaCCBeCHHhAIAHCECQDDAhBAAXDDCREFAGFEBACHAfGHATGBAIHHAhBGA....hBIA...,1,-19,-20,1
FNTeKCWXYHQGOPEgSJabIfUMRVdLZBcDA,TAAAeAAACADA.....XACBHAEBGBGAEAEA.SAGChAAAbAGDUCCB.RCCBdEFAZDFADAIBhAAAABIBKFHBQFCAhBGA.OFFB.......hABA......hCAA...,1,0,-22,22
XFcQRCIfVZPDYLHgTaBOAWbEGKSNdUMJe,EAAAGAAAKACA.dADAUAEAeAFA.FBHDRAGB...CCEA...ICCAhAAAZDBBDDGBHEEB.aEHBhAAAAAIBbDEB..MFABhACAXDGAQGCDfFHE...hAFA......hAGA...,2,-31,-8,23
XAcBfNZCPMUIYKVQHGOdTLbDEFWgRJeSa,BAAAZAAAMACAUACAKAFAHAEA.dAHALAHBDCBB.EBEBFCFDRDDB..hAAAeCGDaDDB..ADHA.fFGEhABA.CCCD.hCAAIEHA.QFFCOHCA.bGAAhAGA......hBCA...,2,-34,-14,20
cVaDXCROYbeINfdBPFHJSUMGZKWLAgTEQ,EAAAQAAA.aACECACARADF.OAFA..eAEH.fAGAhAAAdBGDFCCHHDFASAHHhADAGFCBKFHBACDBTDEAhAGADHFA.bDGBBHDDUGGB.....hAAA......hCAA...,2,-21,-4,17
SRHPCfFOKJLIZaXedBTbMQgWNAUGEDVcY,EAAADAAA....VACASACAHAFBCAHA.OAEDLDDBZAGBeCCBhAAAdDFDBBBDMBIBQFAAhAFANDAA.ACIBUFFAhAHAGEDA.RFFFFGBB.IHHAaEHD..hADA......hAGA...,1,-7,-13,6
BaYLENPefKMIQRCOUDHAGdXgJTFZWbScV,dAAAXAAAJADA.ZACB..SAGBBAEAaAFD.LCCA.hAAAECGBeAHB.MCEBhABARECAODBBHCGBADFAGFEBhACATFEA.FGHBWCHH......hAIA......hBAA...,2,-25,-14,11
IMKgeaAUPLZDGSEFJBHOQCYWTbXdRcfVN,LAAAGAAAEADABAEAHAFAQAGACCDA..TCGAdCAARCCAVDFAhABAMCFBeDAD.hACAAAABZFGBFEEHOEAEhAEA.bGAAfDCEKFHBaGGHDGAASEEDhACA.YHAAhADA.cGED.,2,4,7,3
QWTBdagJcPINYUEbRLfDHVFZSOXGKMeAC,QAAATAAA.aACEJACA....IAFAUAFARCCALBHBhAAAHAGBZCDAXDAAhAAAGDFAeEEDAAIBBDHA.hAIAdEEA.gFCF.PFHBEHDEDGIBhCAASGFH.hCCA...,1,5,-15,20
OaQWFcSPfMXNAGgETDCYKLRHbeBJVIdUZ,EAAATAAADADA..KAFAHACB.eAEABAHBIBHAZBCA.aCACQCGAhAAAFCED.SDBAhBDAMCGBAAEAGEGAhAAACEDARFEA.JHDAdGCA.OHFC....hBEA......hCAA...,2,-27,-1,26
AUILVORNBCEZPFQJYgdWaMcXTDefSHGbK,LAAARAAACADB.EAEAZAEBFAGDQAGA..gCAAhABAaCCBMCGB.TCEA.hAAAeBHHHECAGDCAhACAADHAIEHAOEGBBGGAPFHD....hAEA......hAIA...,1,-7,-24,17
XGbIfAQSeEDFYPZOLTHadNgVURKCMcJWB,eAAAEAAAFACDZADB.LAGBHAEAdAHA..VDBBRCDBMCGB.JDHBXDGAhAAA.bEECAEAAQFDBhAAA.hABADGAAOGBEaEAEgGGACBCABGGA...hAIA......hBFA...,2,-17,-7,10
WacPCDgfdSTFUJGYZRELKeOHAQVXINbBM,QAAAXAAA...IADABADAaAEDCAFA.DAGAdAHA.TCDAhAAAFBGAGCEB.RDAAEEEBhAAAeCFGHEGBADCBbEFAMIEAhABA..PFAA.SFEDhAFA.YHBA.hADAKGGA..,1,-2,-17,15
XVRSCOHaTfcEJbNLQZdIFeMKUABDGPgYW,GAAA..gAAAXADARAGBOADAHCDA..aDAHTAGAhAAAEDCB..JDHBbBDCLEFBhAAAdDEAeCCDMGAAhACAACIBDDGB...PDHB.YEBFhABASGCAfGGEhAIANIABIHHA.,2,-7,-6,1
OHDaPBdYcCXVKFReWLIfJTMbUEASNQgZG,QAAAGAAAHADAaACEdAGA.CCDDKCFDRAEFeAGHLDHB.JEEFbDAAhAAA.AAIB...SDADhAAAZDGBDDAABEEAXFAAhACAFGAAfGEAMIAAEGGB.....hADA......hAFA...,1,-8,-10,2
JTYVCLgBIeEGMXHASUZNWKcPFQaRObfdD,ZAAAKAAAFACARAEA..OAHDdAFADAHB..JCAA....TCCAhAAACCEDLDGBBCHAEDFBGEAAhABAHECCAADA..SEEAhACAUGDB..cGGAaFHD..bGCAfFBEhAIA..hBFA...,1,-18,-36,18
fYbXAUTHZFGScgEBJWPRQCODaILeNMVdK,HAAAGAAASACEEADABAFA.JAFARAGFQCDADBFBLCCBeCHHhAAAMCEBdDFA..fCGAhAAAXFGAADABZEGBFDCHhACAgFEACHHD.aGCBNIAB.....hADA......hAIA...,2,-5,-5,0
WPEdCZBQXJTabVYcHOReUFMgDLKSNIAfG,GAAAEAAAZACBBAEAQADA.JAFEaAFD..VCFAHBGBRDCAFEHDhAAAMCBB.LDEBhAAAKFFBSDADAAHA..hACAfECA.dFHACHHA.XGEAhBCA......hBIA...,1,-11,-20,9
eVYfTPQRJUbIBFNdEMKLaGcHCXZDAgSOW,OAAAeAAA..VADATADA..RAGFUDCABAFBdAHAKDGDGEEAhAAAHCCAZCFF.ABBBSDHBhBAA.fEEAhBHAQGAAIGGAEEHFaGHD.CHEADGIB.hABA......hAGA...,1,-15,-17,2
eHORgMbXAFYCZSfdNDELTaKWGPQBIJUcV,CAAAZAAAdACAEADELAEA..aAFAGCDAQBFDBBHAUDFAhAAAeCABHCDBRFAA.bDFDAAFASCBDhAIADAIB.hABAKDHBIEHA..cGGAOCCB.hBCAMIDA.FGHD..hACA...,2,-19,-3,16
YdHDBPLUJZQONaXIecTWCRVMEbFfGgKAS,dAAAHAAABADALADBZABB.QAFAaAED.eBHHTAGARCEFECABhAAAFCFDGEFA.ACCADEIBhACAPCHDOFAAXDCAhAGAIHBA.CHHA.bFFB.....hAFA......hAIA...,2,-25,8,33
OAeKFdJETaMRDCXHQVGbcWBZYgPSLIUNf,eAAAdAAAEADAMAEA.RBCA.XAFAHBFBGDBA..bABDBAHAhAAAZCEA.gEDBhABALEEBIFCAfDHAhBDAAAIBFDAHaFHDQGFA..cEGChADAPHCCSGABhAGA.NICB,1,3,-21,24
XGCSMeLdRBOHINcaZQEVTUDfAgWFYPbJK,FAAA..bAAAXACDGAEA..MAHBeAEARCAAHDFB.IEDAhAAAaAHDECEAUDGA.hABAAAEA.gEAAhACA.PFHDCDDDdEFCOHBAZGAE....hBAA......hBHA...,2,-29,15,44
cKAbdDPGRENHCaUYTXWOBfLIQZgFVMeJS,dAAAGAAAEADAHAFAaADAUAGA..TCBAOCDBLCFAZCEFFDGA.hAAAeDAB.SDEDhACAAEEBDFHBREBB.CECAXEGAhADAfGEAQGEAMFIB.KGHD.PHAAhAHA....hAIA...,1,7,-15,22
McfJETaKDSUdOGBFNIbYHeLgWACPZQXVR,ZAAAQAAARAEA.MADAJBHB..ECAAaAFE.DAIBdCED.GDABhABAFBDB..ICFAhAAAHEFAeFABLDEAAACACFED.hAEAXEGAfGHATGGA.SHCAhBCA.BFFD.hAFA...,2,-13,-11,2
BEfdTXRZMOeNLbHPAGISaQDKCWcFgUJYV,GAAAaAAA.QADACADAFAFA.UAGAJBBF.BCDD.EDEAdCFARDGBZFBAhAAAeAHHLFFBhACAHDCBADABDDIB...KEGBhADA.....gGGA.fFBEhBAAMDAB.OFFBhBFA.,1,-6,-32,26
YRKNTQbAJeFaWXGBLdZOVScHEgCUIDPfM,eAAAaAAAGACAdAEAZAFB..SAEAHBCBEAHFCCHADAHB..MEBBhAAARCEATEAAAEEA.FDHDBEFAhABALFFBOEGDgFCAhAEA.IHHA.fGEAhAFANEIA...hBEA...,2,-23,-2,21
BGPaUCIFDZcbgKNOSYLXAEfQdVTMHWJRe,EAAAdAAAMADAHACARAFFGAGAUCCB...FBDAZCGB....bABDKDFDhAAA.SEABhAEALDEBAAIBQGGAhAFATGBAeDGDaHAADDIB..gGGA.hAHA......hAIA...,2,-10,-8,2
AZaEdgGJBROXfUMNKHDTSCQFeIbVLWPYc,EAAAGAAARACA.OADAUAFA.MAHBHCCCDAIBCAHA..FCHDeBFF.VDCBhAAALDAB.PDFDhAAAACDAdEGABFFC.hADAfGDAKFHBSHFAIHHA..hACA......hBAA...,1,-12,-21,9
CKPVNWHBTbQYfcJMLeRdEaOFDGXgSUZAI,KAAAVAAAHACB.BAEAQADC..fAGAMAFARBFAEDDAhAAAaAHDDDHBGCAA.hBGASCFDADIBCEFA.hBIAPDHBTGGAbEDCYFEFJGDEdGADFGHD.hCAA......hDAA...,1,4,-22,26
TbBRLeCXEdWHgOJQYDGMVNfISUKAPcZFa,ZAAAaAAABADARAEALAHB..eAEHECAAHCDAOAGBQEAAhABAGCCAMAIBVEFAfBBEhADASFEDACHBFEFAhAHACGCA.dGGA...gFDHDACAIHHAhAFA......hCAA...,1,-3,-9,6
KDNbFXHZgcQTVEIRUaBMPAYdfSGOJCeWL,dAAAGAAACADALAFADADAFAFDHBGBZABB.QCDCECEA.REBBBAHBhAAAAAGASCGA.hACAeDCFKEFAbFEC..hBAAXEEA.gFGH..hBAA......hCDA...,2,-32,-10,22
MdIfQbGYOJgXVETBDFNZaCecKLSUWPHRA,dAAAQAAAGADAOAFAJACE..XAFAEBFEDBIB..ZABBeBHHhAAALDFBSCDAhAGA.PDCBADDBMDHBhBAAbEEB..YFEFTGCAFGGAaGHD.KHFA.hBDA......hDAA...,2,-18,1,19
HdEZJgGeONCRAVbSUcfPaWKFDBMXYILQT,SAAAUAAA..fADAaACD.FAFAMAEA.XAGAhAAALBFAHBDBECDFZDABhADAGCFAeDFACCHDABFBbEEChAIAPEHDDEIBBGDDYFFFTGGA...hABA......hCAA...,2,-18,-5,13
OBMeLXbaHGAZVIEUYCJcQNTSDWgKPdfRF,ZAAAEAAAUADACADB..QAFA..TAFADAIBKCAAdAHARCEBBDDDhABAeBCDLDFAhAAA.aDBHHDGBADGAIFFAhBDAcECCSFABPEDDOFHBbGDA.hACA......hAFA...,2,-29,-8,21
BCGeUEPNHdVacRWSTMYDFAgZLKJbOfXIQ,ZAAALAAAKADC.OADD..XAFAQAFAGCAAECAAHCEBhABAaBHDRCCA.SBHBhACAMCGBFEEB.ADDBbDGDBEHAhABAeFAAUGABdGDA.cGFCTGGADIAAfHEBhACACHHB...hAFA...,2,-6,1,7
DTGWBJfNgERLUVcXIZeQOdAKCPHFbSMaY,CAAAHAAAFACA.MACA.aAEEDAFA.GBDBBAHAJCCA....fCBAhAAAECFEREEALEHBhAAAVDDB.IHAAhAHAZDGBeFHHdGGCAAIB.KHCAbGBC.....SGEHhBCA...hCAA...,2,-17,-11,6
WPFdLVKOUSNMBfJEZIRTAYGgDcbXeaCQH,GAAADAAA..XABAeADAaAGDHAEAFCDAdDGALAHB.OCCBhAEASDADMCGBfDEAhAGAEDDBRFEBAAABgGBAhACAbECD.QGGCPFFBKHGANAIA..hBAA......hCAA...,1,3,-13,16
LCYOGAfSZQWUFJdcRKVMDXaTEIHeBNgPb,ZAAAQAAAFADAdAGA.RACAKAFCDAIB...aAHDECAA..HCDABCDA.hAAA.gDAAhADALDFAOEEBACFASDFAhBHAUFGA.cEGDMFCB.XGFC..hCAA......hDAA...,2,-33,-11,22
DSCfNUEKXecdZLPVMFIGbBRYaAWQTJOgH,TAAAOAAAHADA.CAGB.UACAKBBD.eAEAZBFELDCBMAIBGCDBhAAAREEAADHA.QEEBhAFA.DEHBfFAAhAFAEGCAdGGD.FFHDBBGAaGDD......hCAA......hDAA...,1,-8,-13,5
bdfGDIXcFgATUBZVRQHaSLOeNEPWYJKCM,TAAAZAAARAEAHCAA.LAHBeACEEAFE....PCEBJBDFMAIBhAAAdCGCGFABXCFAhAHAFEHDACCBBEFAaFFBSGGDhABAOEHDNGCBKHFACEADDACA......hAFA......hCAA...,2,-11,3,14
SLCJXWHARPeaTDZKEdYcVUBQNFGOMgbfI,RAAAeAAADADAZAEEEADAdAGA....VCCBQBEAGCFA.MAIBhAAA...bCCDSAHHhAAALEEBXDGDhABAHFCCACFBaDHDTGGAKGAA..YHDGhABA.BHHA...hCAA...,1,-8,-10,2
FYSEIXGLJBAdZPgeKMfTONDHVRUcCWbaQ,ZAAAeAAAMACAOADCHAECRAGF.UCCB..CCCA.aAHDQCEChAAA.SCHHhABAECFBGDGALEDAADIBdFEAKHAAhABATFAADGGB.cFGB.....hAHA......hCAA...,2,-12,-11,1
JcFeVDbXUONQdCHaBRTWSEZAGIfYgPKLM,GAAA..fAAAPADA.MADAFAGDeBHHDAHB.XCDAhAAAOBCAdCCA.HBFBhAAARDBFTEFAECAFAAIBgEDAhACAKFHBJGDA.bFGBNIABCHHDaCHD...SFCDhCFA..hDCA...,1,0,-17,17
TKEZGOIYgJQXLSDRFMbfUBaCeVHcPWdNA,EAAAGAAA.OADAIADA..gAGAQAFALCDBhAAARCBAMAIBUDFAaCFCeCHHhACAHECB..PEBDhAHAdEHAABCBZFABXFEAFGGHBEECCFHA....hAAA......hAFA...,2,-1,0,1
TRYAQBVLWPSCcUgZJEeGdDaXObMHNKfIF,QAAALAAASADHCACA.UAFAZADBEAFAdBHA.aAHDOCABhABAHCEBKDCDFCCHRDFBACGBBDHAhAAA..VEDBcFGAhBHAeFBB.DEIBMHDAfGHE..hACA......hAIA...,2,-14,-11,3
ZRMPWOdGXbJTEVgAFQLKDUIfNcYSeaBHC,LAAADAAAUADA...fAEA..cAGAeAFHHBGBhABARBBB.MCAAOBFDhAIAGDDAXDGDbEABEFGAhACAADBBQEDAKGFDIHHASFBBhBAAaAHF.CGGAPHCC.hAEA...,1,4,-21,25
KBIbZLFcJAfCNeVEWXUOgaGMRHSQYTPdD,CAAAeAAA.EADAXACAUAGA...aAFARBEBHCCB.QDGAhAAATBFAdCAABFFAZCCALDHBhAAAFGBAACCB.fEEEhACANIBB.OEGB.MFBBSGHBhABADAIBKHEAIHHAhADA.,2,-20,-6,14
RCgXeYDVAaOIEdZLBcbWfTPGHFQUMSKNJ,aAAAEAAAZACBLADABAEA.....bAGDTAGAHCCA.FCEAMBBBhAEAKCHB.RECA..CEGAeEHHhAFADCBBADEBdEFA..fGCEhAIAGGABSFHBgGEA..YHEGhAAA...hBAA...,1,-8,-22,14
BALUgSIZOTeXdMCDYVENKfQFbGRHcWPJa,LAAASAAAZADBeACHdAGAMAIB.DBFBEAEA.KAGAFCAARCEAHEAAhAAA...PDHDhABAaDEEADHBUFFAOEEBTGBAhABACFGDNIAB..........hACA......hBGA...,2,-29,-6,23
XCBPdEaZHfSGJVUQKIbRMADeTLYgFOWcN,eAAATAAALAEA.FBCDOACA.NAGA.BBHA.ECEAHCCAhAAAGDEBUECBQECChAAAbDGDAAHADBIB.gFADhABAXFEDdHBBZFFASHDA.hBDA......hBFA...,1,-3,-14,11
HMeRKUXEdVBLcWAIDbZPSfgFJNOQYGaTC,DAAAZAAASACEFACD..OAEAGAEAaAHDHAGD.RDDBXDGAhABAEBEBdDDALDGBhBAAACCBbFGD...fFBAhBBAgGAAQFEACGDDMICA.eHBAhBFA......hBHA...,2,-28,8,36
dWQFREIJXPHeVgLcGBTUCNaAbfYSOMZKD,...bAAASAAA.ZACBdAEAQAEAEAGAXBGAHAGDhAAAeCABLDEBGDDAhAAATECACCCDADGAOEBDhABAMCIBDEHBRFGB.IHHA.....hACA......hAGA...,2,-9,-7,2
SUIRfDagOZXQJYeAHCcTWGMBPKEVbdNFL,HAAATAAAGADA.MAFAKACCEAEAdBFALBHBSAGARCAAaEFBhAAAZCCAQCGAhAAA.eECBAACACFHABGFAhCAAbEECFFHDfHCBOHACXGEAYHFG.hAHA......hCAA...,1,1,-2,3
AESeFODbPdZaVXMWHGTUJLQCgKRfIBNYc,EAAAeAAADADAdAEA.ZAFB..aAEEMAIBHAGBGBCAUCBALDDBhAAA.QDFChAIAKDGAREBBBEEANDIA.AAAAOFGBhBEAbFGD.PHCC..WFCDCFHB..IHHAhBHA...hBCA...,2,-11,-9,2
LTEfIVGdCYMJNbFPaOHUKWDcZQSRAegXB,eAAABAAAEACA..fADAGAEAdAGBMAFAJBHF...bBEAaCAAhAAAHDDA..KDCADBIBhAAAZEBAREGBABFALFFAhACATGDACCCDFDGH..........hBEA......hCDA...,1,-5,-19,14
VeaRJFgWLcCPZfHBAIDSTXOYGKNEQMbUd,SAAATAAA.OACDGACA.EAEAMAEAdAHAeBFFRBEA.FCAHhAAALBHBCDGAZEEAHEAChACAAAAAXDEAKGDAQGGBhAEAbEBBaFFC..WFBDfHBBBFHBDHDA.hBHA......hDCA...,2,-12,11,23
HFGCLXMQZadeIBYEUcPNfKgDbVTWOJARS,HAAAGAAALADBMADAZAEEeAFABBHAEBHFUCDB..PCABhAAAKCGDDDIBTDEA.OCCHhACAREGBCEED.aDHD.dGAAhAFA.IGCAYDBBfFGE.hAAAgGDH.hACA...,1,21,-31,52
VXUDPaICRLQTSNgcJKZbEOAdBWMGFefHY,dAAAMAAAeADAHACC..XAGADAFAaAGERCCBLCCA.TCGAhACASCEA.gCGHhBAAKDAAEECAAADAGEFAhAHAfEFEUGCACBBDQFCB.hBAAcFGD...hBCA...,1,-7,-9,2
SCWGNPLdgUaBMFZVeORHKfXYETADbJIQc,DAAAJAAA.QACA..CADBGAEALAFAdAGBaBBHMBHBZCEBeCGFhAGAHCCBKEFA..hBAAXEBAEFHFACCB.bEGDhAHASGDA.NICB......hBAA......hBEA...,1,-19,-22,3
BbNSOKLfHUaRgTDCeEXdVZYIFMQJcWPGA,BAAASAAALACAHACBRAFFDAIBEAEAdAHAZCCA.FBFD..MCHBQDGAhAAA.cDEChABAGDAA.AADAbECBKEAAaGGAhAEA.CHBA.eEFF.XGGA..hAAA......hAHA...,2,-22,-3,19
TGSdOBAZcUXKegEbNFMaJPCRLYfDVQWHI,ZAAAXAAAeACEEAFEFADA....MAGBaAHD.CAHA.RCCALCFBhABA.DDHBQCDAhAAA.HCGBTGGAhAHAdDBAACIBKFEDbFDA.PFHD.fHABhABA.....hCAA...,2,-23,-5,18
MFSfZbEaCXeULcKBJTIYQVWAHDNdGPORg,HAAAdAAAGADARADFMAFASAFAZBFB.EBHFaBHD.eCABLDAAhACABCCDJEEFTDFAQGGAhAAAAAFADDIBOFDBhADAfFCAbFFC.CEHA........hAIA......hBAA...,1,-4,-10,6
HWaJbCeIEUYSPDNFgRAZKMLGQTdBVXcfO,ZAAAMAAAGAEAdAEABAGA..XAGAOAHDHBBBaACA.CCFA.ECCBhABAUEBBSCGHhAGA.DDIBFDHHAEEBLFFBhAHATEEA.fFHEbGACeGEA.IGDAhCAA.....hAGA...,1,-2,-21,19
edcGSXEIHWVfDUaNRBKgCPQYFJALbMZOT,MAAAZAAAeACEGACBEAFE.HAGB..VCDADBBBaCCBBAHBKCFDCCGB.QEDChAFA.FDHDhAGAACCBbEFAdGFA...XGEAhABAIHHA........hAIA......hBAA...,1,-11,-27,16
PYdZLIRVaCKUNEMAHSfgQbTGXcJOWFBeD,HAAASAAAQADCGACAXAFB.OAHDBAEAeAFHhAAADCABdDDAZAGBRDGBaCCHKDHBEEAAhABAACFB.bEDATFEAhAAAJFHF.FGDH..........hACA......hBHA...,1,0,-14,14
fUNVJbCQOFKXaTLIMPWASEdgcYZBDRHeG,EAAAdAAA......gADAZACBRAEAHCECeAFHGECAUDAAVFFAhAAACAHA.QFAAhAFAKCGAaDDBLEEAMAIBABCBSHAGhAHABFHADGEAfHABNIEB..hACA......hADA...,1,12,-28,40
WcPUCdDYFOKRMLNQTSGfgeEABZbJaVXIH,ZAAAaAAA...XADBHACB..PAEAdAGAFCAARBFALDEAhAIAQCEDGEBAeBHHABFAbEFAhBAAIFEA.UGGAhABADBBBKGGAMDDBSFDB...hACA......hAIA...,2,-16,5,21
CFWIYcPfbXUDHBLQVaGTJEdKgOeSMZRAN,FAAA..IAAA..PADAXACAHAGBLAFAhACAaBCDGCEAECCBdCFAODHDhAIAeCHBZECFAAGACDAA.cEEChADAfGBA.DGGBBEGA....hCAA......hCBA...,1,-12,-24,12
GgWUJdCFRacQeEITADNXZLVMfbSYPKOBH,XAAAZAAAMACA...SADAKAFAHBDBGCFAUAGAdCDARFCAaAHDhABAeCFB.EDAAACCBLFHBhAHAVFEB..fDHAhAAAPHDC.BGBA.gEAAhABA.CHDDFHGE...hCAA...,1,5,-11,16
aGVHJKSULZABCRWEMfXNIQgODYTceFbdP,RAAAEAAAMADA..XACAQAGA.DBEBTAFA.eAHHhAAAdCCAGCFAHCCASDABhADAZFBAAAAACDHB.fDFAhAFAgFGHODHD.FFCAaFDAKFGD.hBFALHAANIBB.IHEAhAHA,2,-21,11,32
GVWEdRMHJCQUfKBcDLXYIaTNAeOZFPbgS,eAAAZAAAFADA....bADAGAFA.EAHBRBGFHCCAQCAAhABAKEAADDIBLDDBXEEAhAAAaDFHAAEAOFCCSDHBhACAdGHAMHAACECABFGAIHFAPHEA...hAIA......hCAA...,1,-1,-10,9
cbdCeJHgLXPMKDVOfYNaSEQBWGARTZUIF,RAAAZAAAFADAdAEA.eAGBHAFBLCABMAIBDCCAOCCB....hABAfDDAaAHFEDEAQEFAhACAGDGAAAAATFDAhAHAIGCACHBA.JHFA.......hBHA......hCAA...,2,-24,-5,19
JVEYNMCZbHLISKTGWfXPUQaBDARcgFOde,RAAAFAAAeADEEADA...MAHBZAFBHCCBLCCAKAHBGCGA.XDABhADAQDFDaEFHBFBAhBAAAAAAOEBA.dFGDhAGA.VGCACGHA.IHHA....hAIA......hBEA...,2,-15,-13,2
PHfGWCZcNUIEdBTLSOYJaVKFXMAegRDQb,RAAAQAAAHADBGAGAZACBUAFAECCBBAFALBEDODAB.aDFBFCHDhAAA.AAIBeDFHDDIB..hBCAbEFDfFDAhBHA.CFHA.cFADdHFB.SEED.hCAA......hDAA...,1,-1,-13,12
aHPXCKfZAFDcYJUMONSETBIGQegRWLVbd,DAAAJAAA.MADA..SADBEAGA.BAFAGBBA.eBEBhBAARAGFLCCAdCGAHEDACDFAZEEAhAFAABBBFEHDUGGBOFBBhBDA.IHHA.QGDB.hAIA......hBAA...,1,2,-39,41
fgcSAMKWIZNLOYTRJVHPCXdDbBFQEGaUe,MAAAKAAAZACBLAEA.OAHDRAEAHCABCBBA.dAHABBDDECFFaDEHeCDAhAFA....fDGAhAAASDEAACAB.IEHAhAGATFGAPECDbFFCFHDC.....hBAA......hBBA...,2,-27,-11,16
VLMEUWgCNRSHQBcJeaFbYXPfIDZdGOATK,TAAALAAA.EAEAUACA..CAGARCAAHAEABBHAeAHH.bCDAXCEAhABA..fDHAhAAAZDGBGEABAAGAMEEBhCAAgFEFQFFCaGHD....hDAA......hDBA...,1,-10,-13,3
VERPLCHMdZWJeFgNKXOfBcaUDTQSGYbAI,EAAARAAALADBHACAZAFBeAFAFAHD..KCCDOBHDBDED.UCFADDHB.QFAAhAAAGEAAAAEA.VFDAhABAMDIB..dCCCJEFBhAAA...XFCBaGHB.SGHDhCAA.....hAFA...,1,-6,-10,4
geCMOKTYSDPXRQIJHEFZGULAabBfWNVdc,aAAABAAA.....fACAVADAdAGAeBBBMAEA.KCHBTBDAhAAADDAB..RDCFQEFAhADAHBFBEAHFGCAAhACAAAIB.bEEA.NCIACDDDSFDHXFBDFGGHLFHBhBAA....hCAA...,2,-20,10,30
IGgFLePWSTAVYcCRKXQJBODUHMEdbfZaN,VAAACAAARACA..KAFCQADC.OAFAHBFCECAA.dDDAZBFEhAAAaDAEGDDA.LDGBhBGAeDGBSFDAhAAAADDBXGEDDDIBMDIBbGFA.IHHA.hACA......hADA...,1,-2,-22,20
SNRBTaUcEPIALXgYbCdeZGQMVODWKHfJF,LAAAXAAA...bADDeADA.GAGAMAFADBFAHCDAFBHDRDAAaDHDhAAAECAA.AADA..CEFAZFCAhABAQDFD.ODCBhABAfGBESEEDTGGAPFHDhACA.YFCB.hAIA...,2,-4,-4,0
BZdDSegIGVOCLNbAfHUFPcRaWXMTYJQKE,HAAAFAAARACF.aACA.MAFAJAEA...KBEAEBHFdBGA.DBIB..eCDHhAHAGCCACCFA.LEFAhAAAADIBUEFA.PGEA.hAIA.XFCA.....YFHBhBAABHED....hCAA...,1,-10,-39,29
aWfAUOPMEDBINbTeYVSJgZHLdRXGcCKQF,OAAAEAAABACA....bADAeADH.SAFAZAGBHCCAREAAGCEAhAAAKBBDaCHDAAFAMAIBhCAADEEA.TEGAVFFA.LGDAhCBAXFCACCGAWCCD.....hAEA......hAFA...,1,-9,-10,1
bgGBdMRJKSFAaUHYEVeWXQZONITCDfLPc,HAAAEAAA.eACEQACAZAFBOAHD..TAEADCCALDDBhAAAbAGBGCFAdEHARFABSCCDhAAAAFCAaFED.VEDBhBIAXGFDCFHAfHFB.....hAFA......hBHA...,2,-7,7,14
GZVIXQTCELBSYbJHfcdeWFRUNaMKgAODP,DAAAZAAA..XADBTACALAEBBAFA.SAGAJAHBHCAAdCFAhABAeBBBREDBUFFAMCGBAAGAhBAAODHFGECA.QFEChCAAEHAA.fCHA.FGHBhCEAaHGE.....hCHA...,2,-8,-7,1
TaAVOWRSLgfENIJMPGXQdKbHeFYBUCDZc,OAAARAAALADB.EAFAIAEA.MAGBGBGA.dCCCHBBChAHAeCFDBAHADAIBZFAAhAAAaCEDACHASEEDhABA.fFHAPDGDQGGB.hAFAFEDH.....hCAA...,2,-19,-11,8
LCESbFBdfNgcQKWVYTZUGAHDOeRJaXPIM,HAAAeAAARADAaACA...XAEDMAHBECCBFAGAdCFA....fCCAhAAAgEAAQCGAhBGAKDHB.VDEBhCAAZEEAAAAAOEDHIHHALFHBbFDCcGADhAEA.....hCCA...,1,-4,-6,2
EAOXbTBZJMUCGaIDfWFSeKYRdHPLcQgNV,XAAATAAA.ZACBMACAGAEA.DAGAFAFD.eAHBRBGFHEBALBDBhAAAQEGBVDFAACCAhAIAbGBABFDA.CFFDaFHDhCAAfFFEKHCA........hAAA......hABA...,1,-6,-10,4
gSXDEUcFfOTIKdCYBPNMaZRbeJAGLWQVH,GAAALAAAQADAHADBXAFAEAFAFAHDOBHDKCDD.dCAABCFAhAAAMCCBRDFAeDADAAFAVDEAhABADEEB.UFFB..hACATFGA.CGCANIABaGHD......hADA......hBAA...,2,-5,1,6
bJRDUagSYBdVfHTPEcQKWCNIFOMGeXAZL,ZAAALAAARAEADACA.aADD....SAHBdAFAHBGBECAAQCCBhABACAHBFDDAGEFAACGAUDFAhAFABEHA.TFBAhABAKDHBIGGAMICA.eEED.....hACA......hBFA...,2,-22,-7,15
OZfMeTLIHdgVEJFRKUXNBGYADaPSQcbWC,aAAAQAAA..bACDOACC.ZAFBeAEATDCAHBFCdBHAhAAAEDEAREABKCDCXDGAhAEAGEFAAAIBSECBhAFACEHALFEDIHCAgFFA.....hAEA......hAFA...,2,-2,0,2
bTYDSKfQcXZJCOHdVWFBPeMGLaEINgARU,RAAATAAADADA..KAFAQACCZBEA.OAEAHCCAdDGDFAHDeBEFhAAAGEEAECFF.IDHAhCAAAAAA..YHAAhAHAfEFA.XGGACGHABHGD.MDDBhDAA.aHFC....hDBA...,2,-26,-11,15
RdWMTFXDZaVPYKSHNCAUOJbIQGfcEgLBe,OAAAJAAA..QADCGADAEAFALAFBRBGBdDBA..MDDBhAFATDDADAIBZEFA.aFDDhBAAPAHB.SDGAhAIACBBDAGGA.bFCAIHHAfGGA.hBDABCCD....hBAA...,1,-10,-32,22
bAeFGfCJVHYMOdcUWaPISRXBNgQKDEZTL,eAAAGAAACADA.HADA.MAFAdAFAUCCA..aBFESAHBhAAARDCABCHAQEFAhAAAECGFZEFALFBAACDBfFDAhACAJHBAOHEAPHFA.NDAADEIB....hADA......hBAA...,2,-16,-1,15
MCHJKSZUYRdXcENQgeTIVbWAGPBfOLDaF,GAAABAAALACAaADAFAGA.HAFB.SAHBZCDARBFEdECAEDHFQCCAhAAA.eDABhADATEEAbDFA.AAABOFHDhACAMFDAKFGA...YHBA.NHDB..hBCA......hBDA...,2,-17,4,21
gGVfMbDQYCJZeNXTHKdEcFIWURPLaASBO,OAAAGAAAMADADAEA.QAGACAGA.eBFBTBCAHCDBEBEEhAIAFDHB.IFFAhAAARCFAaBBHBDEDfEBAhACA.YFDFZEFEKGGAWHEGPFHDABIB...hBAA......hCAA...,2,-31,17,48
OLNKIMVFaDeTfEScgJdRWBXZHPGYbUQAC,LAAAKAAAMACA.aADDDAGA..eAFA.EBHFSBCA.hABAJBFARCAAXCEAhACAHCDCGDBAbEEAAAFAODGDhAAAIFCATGEA.cGGDdGGD...BEEDhBDA.....hCAA...,2,-14,-12,2
YaIQFXSTNPKZEOCJMGgWDcUBLVHAfRdeb,RAAAeAAA..aADAQADAFAGA.TAFAKBDAEBGB..CAHBGCCAhAAADCCBBDDAHCFCAAAAdDFAhCAAbEFA...XFEChABASCHHNICB.ZFEA.MFIB...hCAA......hCBA...,2,-30,-2,28
WXYSIBQELdGVeTDfgMUOCFbaRNZPJHAcK,KAAAXAAA..SACBQADAEAEAGAGA.eCDBhAAATAGAfDAAhABAMCCBCCGDaCHDRDFBZFBA.PFHDhADAHDDAAEAA..cGACIFFA.dFHADFFBhAGAOFCDNIDB...hAIA...,2,-17,5,22
eFObUBNTLIQCVDgYAPfKacXJdGRMZWESH,KAAAaAAA...XACBGACARAEAZAEB.EAGAHCEC.eBBDOBHDhAAAbEACBAHBLCGDQEEChAEADCCBABEB.fDHAhAFAdEEAMDDBFFHDTGGACHEA.YHCAhBAA......hCAA...,2,-15,2,17
GBTONFEVPcDLWZaedHRXAfgbJSQKYUCMI,...bAAAQAAA.KACACAEAGAFATAFAFBHDEAHBPCABhAAALCDB.ZDEBeCCBhABAHEABACEBJDHBSEHBhAAAMEEBOFFBcGEDaGHDdHAD.fHGFhAEA.....hACA...,1,8,-12,20
QdaFCLPIVGNDgfKUXeOAcbRHSMWETBZYJ,RAAAHAAAMADAEADE.ZAFBQAGAdBHAFCAHLCCB..IBEAhAAAGEDADFABKCCAeCFFhABAACEASFFBTDGABFGDhBIAaFHBCHCA.NEEAfGHA...hAAA......hACA...,2,-13,-9,4
VWRDTcGMYPNfKHdXLFIeObSABEQaJZgCU,EAAAaAAAZACBUADA..RAEA.DAGAGCEB.MBBB..PBFAhAAAKECAHEEBdBCCLDEAhCAAeEHBSAHBACIBQFDAhCBACFAA.TFGAcGFDNIEB.FHCA...hDAA......hDBA...,2,-19,2,21
TLYPWVBZMQdOFNKEARgeCGIaJXfSDbHUc,RAAAeAAAGADA..aADDXAFADAFAHBEBUCGBLBGB.PCCBhAAABCCDZDAA.dEFDhAAAFEEHEFAAAAIBCEHAJFDBbGCCTGGAhABA..........hADA......hAFA...,1,-10,-13,3
MfOJdSUXbPKaQZHBADTLNIceEGCYVWFgR,TAAALAAA...IAEAEACEGAEACAGA.VCCBFBHDRCAAMAHBhAAA.OCHDdCEAXDFDhABAbEAD.KEDDZFFAHGAAhACAAAGBDDGBeEHH.YHEAfHFB.hAGA......hAIA...,1,6,-13,19
KeLQBMUSTfNEXWFYJDaHbCcgRZGdAIVOP,OAAAeAAALAEABADAUAFASAHH..TCCAEBCFFCEAhAAADAIBHDDA.bDGDCBBDRDFAhBAAdFAAADFA...IHHAhABAKECDMEEBfGFEXFFA..JHBA.hAFAaGHD.....hAGA...,2,-24,-4,20
LFCXSBDAQRZcJgNOHTPKGMaeIYdbWUVEf,RAAAZAAA.JADAOADA.HAGBKAGCGCAAeBDFdDFAUCFAEDHFLEEDhAAA.CFCABGBDhABAABIBQCCB..hABAgFGATFDAaDHD...IGGAhACA...WHDGhCAA...,1,-6,-34,28
dNPFacMJeBLZWSTRAgHQGIfKYObCVUXDE,HAAAGAAAKADCOADACAFA.UBGAEAHBdCADFCDA...aCEAMDDBeCGHhAAAZEEA...TGEAhAAAADDAQFDA.hACAfFGAbEBDDEGAcGGDBDEA...SHAGhAHAIHHA..hAIA...,2,-16,-15,1
AcMJVCZSQPNgBYXRIHDLadTUFGWEOKebf,MAAACAAAZACA...QADA..gAFBXAFAHBBBhAGAaAHF.dCGDFCCAEDEBeDABhAAAAAIBVEGB.SFDBhBAABDEARDFFLDHB.....hBBA......hCAA...,1,-13,-27,14
bDTFIcJaAVOMLGZPfBRHgYQKNSWdECXeU,MAAAZAAABADBHACCQAFASAFBdBHAEAHB..eCABDBBBTCCAhAIAFCCH..IDFAhABAaCEDACHBLEGBhBAAGECBRFGBKFFDCEHB.XGDDbFAC.....hACA......hAFA...,1,-1,-11,10
DgOGLPdRIcWTSYafNJVZUMKeCEBAXFQbH,QAAAHAAAOACAGACBdAGARBEB...IAHATCCAaBHDfCDEhAAA.VCFAhADAZEEAMEIBeEFBEEHFAEGAbGBAhAAALFAA..cGGC...hAFA......hAGA...,2,-7,0,7
RCUKZeFYLMaNbJXcVPdBAWTEgIDHSOGfQ,EAAADAAAHABCGACARAEFKAGCeAEA.LBHB.aCBHbCFD.JBHBXCFBhAAA.PEABhAEAACCBTDDA.SEAAhAEAQEDACFHAFGGHMFFA.cGGA.hBAAdHDB.....hCAA...,1,17,-24,41
LfaSTQAOZFNHWJYXEGeBMIgdRcKCVbDUP,ZAAAHAAAJADAEADE.eAFEBAGB..MBGBdCAARCCACCADDCCA..LCFBhABAaCDE..TEEAhAAAAAIBFCHB...YCHBhACAXFEC..gGGAKFHB..hAIA......hCHA...,2,-38,-18,20
ZeHfXOMLdJEGPBDYgNVaICRQAUbWKFTSc,UAAAKAAAFACA..TADAZAEBHAGB.OCCBdAFAEAHB.GCBBhADADDGB....gECHhAAAaCGDREEBADIBSGDBhAIAeDHFMFFBPHFCBGBD..NIAB..CGGD..hBAA......hBCA...,1,-13,-17,4
dbCUARLNYfODWTaHQGKZFXPIVJSgcBEMe,RAAALAAA..fADBDAEAaAFEHBCCGAFAZCAAFBHD..hABAXCCAVDFBSEEDhACABAHAECHFeDEHhAAAdGCACFHAAHHAOEHD.TFAA.QGFChABA....hAFA...,2,-14,-10,4
YTMcKFNPXWadbeEIHCSfLVURGQOBZDJAg,TAAAMAAAFADD....XACBdAFAEAHBHBBBSAEALDEAhAIARAGFGCCBQFBAhBAAZDFEAFAAgFAAhAAAKEHBPFDCaGFEeFCH.fFGAOHCE.DFIBhAFA......hAIA...,2,-4,3,7
BdXYSHMbGIUWECOATaFcgKDJeNVRLfPQZ,aAAAFAAAKADA..eACHRAFFLAHBQAEAZCCA.dAHA..SDABhADAHDDAGDGAUECAhAFAEEAA.ABBBTGBAhAEADEHBJEFB.fFDEBGHAMIEAWFFD..CHCA.hBAA......hCAA...,1,8,-23,31
BQNbeXfUPFGdcDVSWOMCJELTRaIZHKAYg,BAAAQAAAeACAUAGAGACB.dAGADBFBSBHH.MCDBhAAAECAARCDBZDABHDACACFB.hADANDGA.bEDD..fDHAhAAAFDGH.VGBACFFD...JFHBaGHB.hACA......hADA...,2,-16,0,16
CKRMBOLIbXAWGTcZdFfYeDQHSVaEJgUNP,GAAAZAAAdAEAFAGAeADAHBFBaAGD...ECAAUCDA.CCHA.RDAAMCIBhABALDFB..bDDDAAABTGBAhACA.fEAEhADAQFFCSEHBJHCA.PHFAhAEABHHA.....hACA...,1,-5,-10,5
ZdJMDcLgWGRPaBYOUbVNAKeHXCSTFQEfI,HAAASAAATAEAEADAZAGB.dCADDAGALDDBGBDBRDAABDFDOBHDhAAAVEAA..ABGAeDDGhABAFDHDQFFChAAAJEGBMFFB.gGAGaGDB......hACA......hADA...,1,2,-8,10
MWXRQOCZTHPJDgUNGdISAFBLYbcKEVfae,LAAA..bAAAEAEAaAEAeAGF.MAIBRAGFQCAAhAAAZCAAHCEBDCCAUDDAdEAAABFBBDGDhABAKDHDVGFAXEGAhACACHCA.TGGA........hAIA......hBEA...,1,-4,-18,14
BVRFEgTUIMaKbSQcHOGfWZeJLYDNAPCdX,dAAABAAARADAFAGAEACAUAFA..aCAEKAHB..QCEAHBDBGCAAhAAAZCGBLEAAhACADDGAACABCCCC.XFFC.hACA.TEFAMDIBSGDBfFEEeEHHhBFA.....hADA...,2,-20,-15,5
aWZSJIGVDPbETdFKNYceUHfAXgCBLMORQ,CAAAMAAARACA...aACEZAFB...SAHHGAEADAGAECAAdBGAKCDBhAAA..NBBA.eDFAHCCBhBAAAACABEHALEGBQFAAhAFAIFFAbFCA.FGGA...YHBGhBHA....hCAA...,1,-17,-18,1
CGbJHNPIOVZUgBLScfAKQdWaeXMFTRDYE,dAAAeAAAMADARADA.DAHBEAGE.GCCAHBDA....IDBAhACAZCFABEAALDDAfEFAhAAAAAIBQEGAhBAAaEGDFGCHCGHA.bFBA.JFFFOFEH.....hBCA......hBDA...,2,-15,-6,9
bVYOEXIFJRaAdSUceKNTZDLBGgHMQCWfP,dAAASAAAeADAKAGAZACBLCCAGAEAHAGD.MCIBQCGAhACACDGD.fDAAhADAbEBAOFFBEECAFGAAREFBAFEBhAEANIABBGHAgGCB.WFHB...hAAA......hABA...,1,2,-6,8
JZBSQYaeKTIfHEPOCdUFVRgDWXMcLGNbA,ZAAAQAAAeACEKAFC..TACAHBFCECCBCAEBdAGAFCEH..RCDADAIBhAAAMDGBGDGAAAIB.SECBhBGAaDHD.fFEAhCAAOFFH........hCEA......hDAA...,2,-21,-17,4
ZDNCPdaWbgFcYAKQGOEUTeISJRXMfVLHB,GAAAEAAAUADAeADA.SAGARAFA.MCDALBCDHCFCZDDAhAAACCGAaCHD..bEACFDDAhAAAAADAQFFBhACATEFAXGAABHAADEIBdGHA.......hAGA......hAIA...,1,11,-21,32
gCEdIQLTePOVXNZHRFaKBJSMWbUfcAGYD,GAAADAAAEACA.dADALAFAeAFA..OBHDXBBCHCDCRCDAKCGChAGASDBH.bEEAhAAAfDHAAAFA.hACACEBATFEAPGCA.NHABFGHBaFHDBHCD..hBAA......hBCA...,1,-4,-15,11
cQXUOIgKGReYfZFBNJEbPVMdTACaWSHLD,aAAAHAAALADAQADCUCCAOAFA.KBFARAGFeCFBZCAABCHAhAAAEDHF.VDFBdEAAABBBSEDHhACADEFB.IGHAhBIAgGGA........hAEA......hAFA...,2,-23,-6,17
OAbcZaYdRHfTMJGPXCVDIULFKQgNEBSeW,ZAAAdAAAHADAMACAGAEBCAGBDAIB.LCCAKCBA.QCGAhABAECEAeCGF.AAHA..aECAREEBTFAAhACAXEGC.IGHAhCAAFDHDBDADOFED......hCBA......hCEA...,1,-9,-20,11
DCWcXgJKOAQNaGMBURfdLIEFHTSPebVYZ,aAAAGAAABADARADAdAGALAFAFCDH..HDFASBBDeDAD..hADAVFCAZCCBCCEA.XCGAhAGAKFHBAAABMAIB..hACAfEEAEGGB.bFGB.DGCB.gGEAhAHAOHDE...hADA...,2,-16,-2,14
ZKdRegBUQMVOYLAfNPbDcSaTIEFXCGWHJ,...fAAAbAAADAAA...aADAEAEACAGAHBCAZAGBRCCABBFAUCGAMCBBhAAAOCHDAAIB..PDEBhACATEAA.XEEAhAEAGEBAKFGAdGHA.gGDA..hAGA......hBCA...,2,-14,-6,8
SBALPbGQcYKaJUHEdWNCeVOFTRDXIZgfM,LAAAGAAAQADAKAEAUAGAHCAAEAFAdBHACCEA.eCDB.FCFDRDEADCCAhABAZEGBMDABADHA.PHCAhAAA..bEAA.hACAaEGE...NIBB......TGGAhACAIFFA...hAEA...,2,-21,4,25
fMCIVcaSZRNEALbBdFPKeQWDTGXUgJOYH,LAAAdAAAKADA.eADHQAFCDAFAGBEAUCCAOAHDHCFCMDABhACACBGC...IEFAhADAaCAARDGBAEEBFGFB..hABATFGA.JHAA.......hACA......hDAA...,2,-22,-15,7
bGYTMgQVZcJNPDLFaefRWdAIHKOBESXCU,HAAABAAAEACACADBGAEA.MAHBQAEAZCAA.JAHBDAIBaCAARDFFAAGBhAAA.KEDBOCEB.hACAXDFDbFGD.TGBAhAAA...gFGANDIA.FDCDhACA.eHEG...hCCA...,2,-14,-5,9
AeKdDYaWgMSNEBOCLfHRZJUFTXIQVGbPc,eAAAdAAAaADAMAEA..EAGACAHAHBCAZBDAFBHD..TCFA.QEBAhAAAbABD.ABEADCIBhABAgDEBBEDALFFAhBGAREBAXEGDIHCA.PHEAhCAAKGAA......hCBA...,1,-8,-11,3
bHEFfKTWZLCNBIDJaQARUMegdScGVOXPY,RAAAeAAAdADAGAFAOADC....XAGBbCCC.HCCAEAHBKDHBhAAAZCFFLDHBBEEADFAAQFGChABAAAAAMECBSEEBhAFA.PHEAfHDB.WFAAhAFA.....hBIA...,1,-11,-12,1
EYVZRFSLQJgMBcNfbTXIaCHKGeDdUWOPA,EAAAZAAARAEALADA.QBGAMACABAHB....fBCEhAAAbCCC.TCEAhAEAaCFDHDGBeECBdGGDOEEBhAFAACHAFECDSEEDgFGAXGEDhAHA.....hABA...,1,7,-24,31
WMRXcVdDLSIPKFBATgaHZQObNUeYJGCEf,aAAAHAAAZACBQADC.OAFAbAEAeBHHGBFA.ECABMBBBhAFARDDBXFCDdCEALEDAhAGASFGAKEHBACGBTGGAhAIANCCAJHEECBHA.........hAAA......hACA...,2,-7,6,13
TFDgZdBHQfNXRVPJebUMAcLYSKIEaWOCG,LAAAKAAAEACE.aADDCAEB.GAFA.DAIBdAGAHCAAQCCAhAAA.XCFCRDEBPDHBhABAeCHHbFAA.AAIBSEFHhBGAOHACFGGH.BFHA......hCAA......hCBA...,1,6,-32,38
IbdAZMEHRDeQFXULVcgBGCNPYJSfTOWaK,EAAAHAAARACA.eACE.QAFCXAFBLBHBVCCABAHBGCCBhAAACCGA...PDABhADASCHHTEFAaEFBhAAAbFCBAFHAZGFEFFHD.........hAIA......hCAA...,1,-4,-8,4
QDAcGfBWNMZXCLJFbUaeKPTRHgOIYdSEV,GAAABAAAMACAZADALAGBFAFD.aCDAeAHB.KBCARDDBHEAChAAAOCBBdEHA.EGEAQDDAhAAAAAEA.fCGAhAIANIABCHFA.bEBD...UFGA..hBCA......hBEA...,1,-3,-25,22
PfcCSUEJbGgTXHFaBIONAeLKRMQdVWDZY,eAAARAAAdADADAFAZADB......fAFASAGAEAHBGBEAhAAATCFAHCGBBBCAOCCBhABAAAAAMDIBQFGBhCAAVEEB.PGCACGHDJHCA......hCGA......hCIA...,1,-9,-14,5
NEOXMAGTcfIaVKLdHbUZRJQBYFCWgeSDP,GAAATAAA...fADAaACALAFAHAEBZBDARAGBBDDACCCDeCGHhAAADDAB.EDFFMCIBAAABVEGBhACAbDED...QGAAhADAFEDBSFHDNIDB.XGAA.hAGA......hAIA...,2,-2,2,4
YWVPEOKFfeTJQBdDbIaSRMAUCLGcZNHgX,LAAAZAAAHAEAXBGAVAEA..EBHFFCAA.eCEBQCAAhABAdDGADAGA.aCDBREAAAADAGDFAhACA.NDIA..gEAGhAEAPFHDKGEATFDABDDD.SHAAhAHAMIEA.CHEA....hABA...,1,14,-10,24
bJcIeQWVdNGRHKgLFUMZPAXSEOBaCfYTD,EAAAaAAA...CACA.TADADAEA...JAFAeAFA.QBDDhAAAdCCARCFAHDABLCGBhBIAMEEBABBBOFCDfDEEhCAAbFED.IGDA.NCCAKFHBFGGA....hCBA......hCIA...,2,-25,-5,20
LCIRdaSHAgMYQecWVEXUKNFZJOfBDGbPT,MAAAeAAA...VADAEADAKAFA.ZBFEOAGDDCCAGDDA..hAAAbBBDTDGALDDBhAGARGFAdHABHDFAADDB.QFFBhAIA.WFHH.NIBB.....hBAA......hBBA...,1,-12,-16,4
EIADUYZWMBeGVdLXbgHCSJKaPOFcNRQTf,DAAAZAAAMACAeABAdAFALAGB..XBCAHBDBSCCDhABA.aCHDFAHBREFBTFBAhAIAECHFADDBUEEABBFAbFBBhBAACFED...KEHBOFHD.NIBB.fGDEhBFA.IHGAhCAA..,2,-17,-6,11
APcSLWTUgRbHJZeQfYdIBVGMCaKFXNDEO,SAAATAAA.RACFHAEBeACEQAFC.dAHABAGAhAAAGCCAaAHDXDEAhABAEDHBACCBLEFBgEAAhAEAZFDBfHGFIDHAMEDB.FFFHODBHhAAAcGAD.WHFAhAGA...,2,-20,13,33
YXCadeMQLNJZKSTUPVfWGEgBARODbcIHF,RAAADAAA....bADBHABC.XAEBdAGAeBFDMAHBLCCBhAAAZCCATECAVEEB.GEGAhAIAECHFAAIB.OFFHFEHDaGBAhABAQGBC.......hBGA......hCAA...,2,-9,-3,6
gDWYPXCHfMdceOQZENUJFASIKRTGbVBaL,KAAARAAAGADABACBLAEADAFA....PAHDHCCAdCFAeBFHhAAAZCGBUDAAAAFASECAhAAA..bDGDaEHDhAIA..gFBAXGGCMFFBQGEChABA.....hBIA...,2,-25,-6,19
cRQNIAdMHFfOBUDZCTPLEbGSJYgXaeWKV,HAAAOAAADACAZADBCAEALAGBGAFA..SAHBJCCA.XBBChBAAeCHHKEEARDBBQEEChBDAAAIBdFCAFFHDBBFAhAAATGGA.EDHBgGEAaFBH..WHBAhBFA.....hCAA...,2,-27,8,35
YQDMVdXeTLaBEcfNPRIUObFKGJZASgCHW,CAAAHAAA.QADCMACAdAGA.eAFELBCAEBFF...fCHAhAAARCAAOCGDbEDBGDBAhAIAACIBSFFBhAAA.YFHBXDDAaGDHBEGD.PFHDhBDA.FGDA...hACA...,2,-16,1,17
KUDJPAWReSVgMfXIdLBCETaFYcHGOQNZb,RAAAeAAA..SADBMAEA..XAGAdAFALAHBEBCAaBEDhAAAFCCBHCFBGDEAQECAhABAbEGBDEDBAAAAgFFAhCAABFBACGDA.YHCAOHBC....hCBA......hCEA...,2,-12,-10,2
HBGDXZFcfTIRgAEOQSUeMWCbdPVJKLNaY,EAAAQAAAUADA.eACAMAGB..bAFAdAHA...VCBBLCDAhAAA.aCGDHDFChAAAGDAAZFBAfEEEhBCARECFAAGASEEBCFHAKGFABEHAFHBA.TGFA.hBDA......hBFA...,2,-6,8,14
fKeCNOWBITgcUPHJEDQRFLdaVSXAMYZbG,ZAAAGAAAeACEOADABAFB...TAGAUCCBHAGBECDA.RDEFdEHAhABAaCFDSCHHhAAAAAIB.bDBDCFCAIHFAhCAA..gEEG.PFHBhACA.DHDAFGDD...hAIA...,2,-18,-7,11
AOScPNTWUQFJgaRHDdGLCbEKeIBfXMVZY,SAAA..PAAATADAQADAFAFA.aAFEHCCAhAAAGCCAbBFAEDABeAHHhAGAfDFAMCGBZEGBACCBhBAAODGDNEFA.UGGB......hABA......hADA...,1,-8,-10,2
RWZEQYMHCaFJKODUfLXVSIedNbGAcPTBg,TAAARAAAEADE..MAFAHACB.aAEAKBFADAHBLBHB.SCCAhAAAeBEHbCFDAAIBBDEAhABAZEBAQGGAhAAAFEFD.OCABXGDCdHDB......hCAA......hCCA...,1,9,-30,39
UDIATLEGKJacNgVBQSYbPZOFCWXdeMHfR,EAAAGAAAKACA.aADA......gAEBQAGASAGBhAAAbCDAZDCACDHAdFCAHCCAhAIARFGBDGAAABIBTDFA.hAAALDHBNIBBBGFD.OECB.XGGChCAA.eEEB..hCBA...,2,-11,-4,7
ISHKVUXaZEDNLTAQdgFCBGWbROePMcfJY,dAAACAAAGACARADA..eAGHMAEA..JCBBSAGAHDCBKCHBUEEAhACAZBEFECAB.LCGBhAAAAADAFEHH.BEDA.bFFAhACAOGAC..fGDAIHHA..hBCA......hCBA...,2,-21,-19,2
GZWMDECIBHRdPXSNcaQAeJKfTYLbVFgOU,eAAAKAAA..TADALAEAFAFA.OAHDZBFEDCAAEBCF.BCEAHDAAhAAARCFFdECASDCEhACA.aDFDAAAAfEEEhAFA.bEGDgEGHWGAG.MFEBhADA.CGHA.....hAIA...,1,-10,-22,12
eJcDBQVSKHWFYAZILCPOTUNGfgMdabERX,ZAAALAAAOACATAEAGAFA..MAHBaAHF.RCAA...eCCBhABADAIBQCEBhABAKCEDHDGBFFBBACAACDHAUGGB.fFEAhBFAbEAAEEEBXEGCBHBA.SGAAhACA.IGHAhAEA..,2,-8,1,9
OFZAbeBgKEVSIPXcUdRMHTGYaDNCQLWfJ,eAAAKAAAEACE..SADA.XAFDdAEAHAGB.GCCAhAAAaAHFCCCA.LEFAhAGA.fGBAhAIAFCEHAAAAbDFDBDHAgGDAIEAAcGGAMFIB.hBGADHBA.WHBA..hAEA...,2,-33,-5,28
XTMeRIBdNZQKcgUFWGAJSbOfYDVPCHLEa,SAAAOAAADAEA.CADA.HAFCLAFA.ECCAaBBC.MBEBRCEAdCHAhAAAZCEBQDAChABAKCHBUDBAGEGAAAGAJEEF.bGDChAIAfFCA.PHFC...hBAA......hBDA...,1,-6,-10,4
SKDcLHVTRbPeUXZaCGOMAQfJEgIWBFNdY,QAAAEAAA..gACABACAdAEAKAGALAFAHCECRDCBeCDAhAAAZEEFGEGAAAGAJCGBFDAAhADASCHBDCIB.hCAATGAAbECAXGGACEBD.....hAAA......hAGA...,2,-7,-6,1
AfgaGLcMDETHVJZSIUQeFNCdPXBWORYKb,aAAAGAAALADAMADAEAGAHAGB.ZBBASBFDQDDBeBHFhAAACDGDdEAABCDARFCB.bDBDAAIB.hAEA...fFFAhAFADDIBTEEAIGHAFFHHXGCAOHFC.hACA......hBAA...,1,9,-10,19
BJGDEcYKOeLRVWXAFINHMUaTPZgdQCSfb,FAAAHAAAMADAaACAZAEB.dAHAQAGA.SBCAhBAAbBFDGCCAEBFBKEHBLDBAhBDARFFB.XDFAhBIAACCBIHBATFDACHDA.BFFB.DDIB...hAAA......hBHA...,1,-6,-10,4
GRfHbJSaXYEPKNegQFcCAVIdOUTWMZDBL,dAAATAAAZABBLAEA.RCEAHDBCbACBaAEDEDHF..KAGAeEFFhAFAQCFACBHA.ACCBOCHFhAAAMFCBBGAAGEBAhAGASGGAXEDA.PFHB.FGFDhAIA......hBEA...,2,-7,-1,6
aFNEHIdTRbXMUPVOLWQCKAeYSDcfGBgZJ,eAAADAAAGABBZADBFAFDHAFB.dBHARBGFMCCBUCCB..ODEDLEEBhAAAQEACAAHA.hABASEGABEGDaFDBEGGAhBDAbGEA....PHAA....hAEA......hAFA...,2,-22,-8,14
eWLbYZNUXIOKdgfBVRaQGADPSFMcHCTEJ,SAAAMAAAHACCEAFEeACHLAHBZADBUAGAOBBB.dCDDBBFChAAARDEAGGCBADFAFDGDTFEAhABAbFGB...NDIA.hBIA.KHGA..........hCAA......hCBA...,2,-24,4,28
VUTNCLYfSGWKbReMdXQFEDZIcOAHJBPga,HAAABAAAaACATAEALAFA..SAGBGBCAKCECRCAAeBHHhAAAdCBCQCGAhAAAECEBZEAAOEEBAAGA.gFGAhACAUEEACFHA.fGCEMHFADIDA...hBCA......hCAA...,1,9,-17,26
MRLeFBTPUDXZJOQYHfAKaEcVCIgGNdWbS,EAAACAAAGACAdADA..SAFARAEALAHBeAHHBCAA.UEAAZCBAQDFChAAAHCFBAACBKEDA.hAAAaDHD.VFAA.gFEGhAFAbFGDMEIBFHCADGIB......hAEA......hAFA...,1,1,-8,9
eZBATIPDQHRSbNXVOUfCWYLEKJFagMcdG,TAAADAAAHABC.RAEF.SACB..bAGBXAEAOCCBCDEDhAEALAHB.ECCBhAAAFDGHaCEBMBIBGDFAhAEAeFFBABHBQFAAUGCAfFHAKFDAJFHB.hBAA......hCAA...,1,10,-15,25
geWfaMbOIZAUNYJcHFdCLXDPBGTQVKRSE,UAAAJAAAHADBdADALAFADAFA.GCDBTBGAKDBA..ECCBeCHHhAGA..aDABbEFDZDFAhADA.AAIB...NEEAFGCBhAHAXEEC.QFBASHGAfFGAhBAA.MIDAhBFA.IHHA.,2,-9,-8,1
YVdDaEbIcgZAJUXPNfWGeCHLBOKFRSMQT,XAAA..fAAAeADAHAGBLADAKCDARDAA.MAHBhAAATDFAdCBAECFB.bDCDhACAgFCAAAEA.hAIAPEHDWBHHBEEASFFDQFGAhBCADGBB.aGFH....hCDA...,1,-2,-18,16
aVbeMPQgGOdHUCKYBRIWcJLSFEXfZTDNA,aAAAeAAA.MAEAQADAGBCAHBEAKAFARCCB...IDGAhAAAJBHBLDABEEBBZEEATEFAhADAAAIBbGBA...OEHDhAHAdGGD.CBBDBCFA.SFED.hABA......hBEA...,2,-11,1,12
YBWAPLdXHNOSUacEKRTgFbZIDeJGfMQCV,dAAAHAAASADAaACAEAFA.RAFF.FAHDZABBeCCAGCGA..MCGBhAAAQDCACDEABDHAACCALEABhAEAOFAAKFFDbEEDDAIBhAHAJHFE...........hAFA......hCAA...,1,-4,-16,12
IGMXeKQBcRdESYFJZHVALaODPUWNTbgfC,aAAADAAAUADA..TADA..bAFACAFBGAGA.eBBBhADAQBBARDCFdEFAEEHFFCFDhAGAHFDBACHBLEDBhAHA.OFFA.PHEC....hBAA......hBBA...,1,-7,-30,23
KfUQPYMGJbHAdWIcVEDZeCXFNSROaTgLB,dAAA..IAAAEADAeAFAFACARCAA..OBHDaAEDLAGB.hACAKBCDQCEAhADAMAIBGDDAHECAABGBVFGBhCAAZFGBXGAA.TGDABHEA....hAGA......hBAA...,1,-3,-18,15
JOgEbBGcdPQFfCMRSaUYLDWeVITNKXZHA,OAAAEAAAGACAdAEAFAGAMAEA..RBCB.aAGELCGB.eBBDhBAATCEA.XCGBhAAAHEEBACIBJEBFbEBABCBDhBCA.QFFASEHHDDIBIHHAhBEA.KGDD....hBGA...,2,-15,2,17
BDMKECLOWfGVaPTFXUQZJdbeRINcgYASH,HAAAMAAAKADAEADELAFB.OAHBGAFAaCACTBBA.hAAAXDDAZCCBbEDDRFFAIAHAhAFA.gDGHhBAAACIBDIAACHHA.fECE.FFHD.hACA......hAIA...,1,-4,-15,11
UAMWOQZGNgCEVFbaJXYLfPHcRBDdISeKT,MAAAQAAAGACBCACA.EAGEFAEA..aBBCJAHBLCFA.HDDAhAFARBDBdCFAeEGFKDHBADDBZGCAhAIA.NEIA...bFFB.hBAA....fHABBHGA.IHHAhAAA....hAHA...,1,8,-38,46
dTeHcNRGKBEXDZVCaWSfQUIOAYMgPLFJb,MAAALAAAFADD.dAEAHAFARAGBGCAABBBAECEFZCCA..CDGD...aCGDhAFASDHHQFEAhAHAOEEBACIB.PFGBhABAJEHB...eGAAKGDDDDDB....hAIA......hBAA...,2,-21,-8,13
GaIKROPcbMfBSCWQJLZEgHeAXVNTUdFYD,XAAATAAA.dADADACAGAFAKAEA.RDBA.OAGD..bDGDMAIBhAAABAHACBDD..QCEDhAGAZFAAHEDCAAAAUEFBhCAAaHAAIHHA..fCCEhDAA.SFHHhDBA...,1,-1,-33,32
QCUVEZPFeWYTbcRaHKMILdJXDAfNBSGgO,BAAAGAAAQACACADAUAFA.EAEAZCDAeAGF..TECARCAAHCEBhAAAMAIBdCHADEDB.AAIBSFGAhACAODAHFDHHbEEDhAAAaGFCKHDA..IHBA.XGGBhACA....hADA...,1,-2,-17,15
aYWOLNeGEQfUSHPcARFdgMITCBZXDJbKV,RAAAdAAAMADACADAZABB..DAHBKAFA....aBDDOAHDLBFBGCEAhAFAECHF..UFCAHDCBhAHAAAAAFFFATEGA.XGCAhBAA.........hAIA......hBIA...,2,-36,-18,18
UYOcJBLIXEFDQCdHRaWgGSNMPKfeAbZTV,ZAAATAAAUAEA..OACABAGALCAB.EBHFQAFAhAAAHDDAREBF.aBDCGEGAhABAMAIBfCCEhBHAACCB.bDFBcFDDXEDADDIB.dEHA.SHFAhCAANIAB..hDAA...,1,-5,-15,10
VJGRcIAaNSFZCHDEULKQXTBbeYgPMOdWf,aAAAFAAAHACB.EAEALADA.QBGATAGAeCEFgBBGhAEAMCGBdDHAfCEAhAFAGEAARFEBAEABZECADGGAhAEAXDGCBHHA.PFHB.OHAAhAHA......hAIA...,2,-14,3,17
YKIVFGPDdBLeOTgXJQNAEaWSCbHcRUfZM,EAAAaAAA...CACAHADBRACFZAEBKAGAFAFA..GCFAdCGALEAA.hAAAeBBDTFBA.XFDBhAIAQEECABIBbFGDhBFAfEHAMDIB.IHHADCCBOHCChCAAgGDG..hAEA...,1,6,-25,31
EHVcTWPDGYIgeOdJRNMKLSAFQaZUXfBbC,aAAAZAAAUAEABADA...EAGAHAEB.TAGADBIBGCAA..hABAgBBGeCCBdDGAREDFhACAMCIBLHCAADAAQDEBhADAfGGAbDGDCGAA...cGFChAGA......hAIA...,2,-18,-8,10
CAeFEVNMOSRcbUHWGDgBZLXQTYIaJdfPK,EAAAMAAARACA.UAEAHAFBGBBABAHAZCCA.LDABTAGAaCGEdDHAKECAhAAA.AEGA.eDEBFFFB.hADAOEBH.bEFDDGHBhAFA............hAHA......hCAA...,2,-15,-14,1
KCYHNLMeEcfagODQXAWPZBVJSFUGbRdIT,ZAAABAAASACEGACARAEAdAHAKAFA.HCABMAIBECFF...aDGDDCCBhABA.ACFA...PEDDhAAAFCGDbDDB..TGGAhACACECALFABeFAB.fEHAOFFB.QGFChAFA..hAHA...,2,-27,6,33
dMIGFZfNTVeSUcAJQagKYLEBORCWDbHXP,aAAAKAAAEACEBADA..RAEF.DAFAHAGB.dCCAGBDBZDFE..TEAAhAAAeBBBSAGAhADA.ACIBQDDChBAALFGBCEDAbGAAMDGB.fDHE.hAEA......hAGA...,2,-24,-11,13
BXPcEFWZGASCHYafLOQbTgJVNdKIeMRDU,HAAAaAAALADAQADC.TAGAVBGBdCCAeCABREAB.BCCD.hAEAXCEAEDFBZCDBAAHACCHAOEEBhAAAJEHB.KFADMFFBhAFADEIBcFGC.FFCBSBBDhBAAfHEF.....hBIA...,1,14,-11,25
ADXVYKIUGLSFREZcWPTMQfHNbJCaedOBg,XAAAKAAAGACALADARAEAZCAF.....PAHBMAIBHCEChAAAJCDA.eEADdEAABDDDhAAAAEEADEHB.IEFAhABAFFFBEGHF.TFGA.QGCAfHCBCEHB.hAEAaHAC.....hAFA...,2,-19,-3,16
YJAaKbGHIWRcPQDVMEgFdOUXZefSBTNCL,aAAAGAAAHACBRADAQAGCMAEA.ECDBdBEA.XAGAZCFAeDADhAAABCGACEFA.LEEAhBAAAEHBKFED.bGCA.IGGAhBBAPFHDDGGB........hACA......hADA...,1,-8,-12,4
KIdfEGaDAZRBJWMCYOgUceSHNLTPFQVXb,RAAABAAAMADAOACA.UAGAeAFA.HBDALBCATCGAQDBAhAAAXDDAbEFDdDEAEDGAhBDA.GGBBAAAAWCCDhBIACFGA............hCAA......hCIA...,1,-15,-18,3
gaNdXHYOKMQULPDfFWGEbSBJVAeCRcTIZ,RAAATAAAZADB..aAFDdACA.HAEAKAHB.MAIBLCCDDCEB.FCGDECFAhAAABDAAAAGA..eDDDhAEACDEA.IEHA.hAAAXFEDQFFAfGGBbFBASHAAhABA....hADA...,2,-28,-7,21
IcdKONMQDJXVSPYRBZFLUHeWbEfaGgCTA,dAAAOAAAMADADAEA..JAGB..SAFARBDBZDBB.LBBAhAIAHDFCeFCHEBHFGCEAhBAATFFA.ACGBKDBA.QEGAhBDA.XGGCYFHB..hACA......hAIA...,2,-24,-12,12
VBMUDWCHQeZTJfRGEdgPANILOaSXbYFKc,LAAAaAAA.XADDFADAKAGABBBD.DBDBHAFA.eCABhABAZCDB.TCGARCFAdEHAAFFAOCCBhACA.bDEDVGAAhAGAMEDB.CEHAJFAF.EGHBPHFANICB...hAFA......hAHA...,1,7,-32,39
CUMRZLSXVgabJfeYPONcKABFdTWHIEDGQ,dAAAHAAAEADAGADA.QAFAMAGBRCAAZBGBLBHB.XCAAhAAAaCEBJEFFeDHHhACAODDHKFBAAACATFAAhAFA.DEGBSFDBbFEDfGDAPHAABGHAhAIAIHHA..hADA...,2,-22,21,43
ZWNXSeTFHOPcgEKRLVUIQdbYJDBCMafAG,ZAAAXAAAeACEHAFB.OAHF..gADARCCALEEAhABAIAGAdFAAJFHBCGEAaAHDhAAAAGGB.GCDB.SDAAhABA.TEFA.FFHD.EGCAhADA.KHEA....hAEA...,1,-13,-16,3
TNGVKSZgfRDLbOCcYEBMJXaHPAdQIUFeW,dAAAQAAAFADA.eACATAGAGAFAKBDD.ZCDF.RDAALAHBhAAACCBA.EEGAMCFBaFBDADAAhADAIDGAUGGA.VFGBhACAfFDE.OHBEBEDAHGAAhAGA.NICBDGCA...hBFA...,2,-18,11,29
TBdJZYgNUbAGSDEPQeLWFRfCVIcXaMHOK,GAAAEAAA.eADALADARAGB.CAHA.ICDAaBCCHCDC.TDGAhAAAdCFAZEAA..gEAAhAEAbEEAAAABDDIBQGGBhACAfEEEXGCAMIAA.BFHA.hADAYHAA.SCGEhAFA,2,-13,0,13
WfFeaGAXICYRgPZSHKENdTJQUBMDLbOVc,CAAARAAAZADBHACAKAFAdAFA...QCAAMAIBLCCDOAHB.VCDBhAAA..fCGAhAAAeCHHADGB.XDEDhABAgEAGEDABTFGABFFADFIBbGCAFHGCaHAC.hACA......hAEA...,2,-7,-5,2
WGDaHBNSULgXCAQJFEPIKVfZTYebOcMdR,QAAAEAAAKACA.ZACBeAEEOAECdAHARBDAGCEAHDDCBCCDUDGALECBhAAACDGB.AAGAFGGAhAIAIFGA.fGHAhAAAYHCG.MIDAaBGE.....hBCA......hCAA...,1,-7,-18,11
CDAFUSTfZQaVXRKbLOPGIWgEYecNBMJHd,SAAAZAAAaACA.RACFLAEBGAEA..IAGAEAGA.eAHHhABABBHAHDDBdDGAAAAATFGAhCAAQECAKCCDbGDChCBAOEFH.gGAANIEB.MDIBhAGA.DGHB....hCAA...,2,-20,7,27
eRaTEQAPZSIdKbDCJfBHMcNUOGVLWXYFg,ZAAAdAAADADACADBBAFAHAEC.MAIBUCAA..GCABLAHB..hABAXCFAFCDDRCFB.EECAhACAABHB.SEFBhAHAKEHB.bFCAJFAA..fEHAOEFH..hBAA......hBCA...,2,-35,-14,21
SdNTDaJfbFLXZOQCPcVKBeGMREWgHIAUY,SAAAdAAADADA..aAEEJADA..FAHBZAGB.QBCDhAAACBDD.VDEBeCBFREGFEFCBhABAHCEA.ACIBUEEB.hAGATGCA.LFHB....hACA......hBAA...,1,-19,-27,8
YTLfBKcSDCJPFHeMVQUWRAdOaGgEZbINX,aAAAEAAAZACB....bACDXAEA.LAHBKAEADAGACBBDFCEBhAAAHBFCeCBDMDFBQDFDhAFAREAAADGBGEGAgFGAhBCANEEA.fHBB.SGFDhBHA...hAEA...,2,-19,0,19
GRNJVWfIHMBLeYZcDSXKQTPabdFCgEUAO,RAAAVAAA..IAEAHADBMAFALAGBeBFEZDAASBEAhAAA.QCCChABAaCFDdDHACEEDEFGBAAIBGDAA.hAAAWCHHBHEADDFB.TGEA.FGGA..hADA......hCAA...,1,-9,-10,1
BGfaZQDbMSNcgeXLUVIETRAJdCYPWKFHO,dAAACAAA.....PADAFACAHAEBGAGAZAGBQCBAhAAAMBDBSCAA..gDDBhAGAeCEBLFCBhACAIEGAREFFAAIBYEHBOEHDaGBADEEBcGGChBCA.....hBAA...,1,-13,-16,3
ZHXJRaWbAeLEVMKYSIPBcQNCDUfgGTFOd,EAAAMAAAKACA..SACABAEB.QAFADAGAUBGAGCCAhAAATCCA.dCFCHCEBREFA.hCAAbDGBACCB.eECB.LFABhAFAIGHAcGFA.CAHA....hCBA......hCEA...,2,-35,8,43
PHUFAKfdVcNaMQGBSJXCeRDWOTEbLZIYg,dAAAVAAAaADA..GADABAGA...XAFARBDBOAHD.ECBFZCFEhAAA.IDAA.hACA.gCFBhAGAHEFAAAFAfGCAMDDBQFEACGHAeDDDDHEAWEHHhBAA......hBCA...,2,-31,-2,29
RcTALCQeJKXBHINGUZdMagfPFWSbDOVEY,LAAAeAAAKADAHAFBGADAdBHAaAFA....fCCAhAAAFBGHbCAB.ODEBEDFBREGFAAIBQFAAhABABFBA.IEHAhAFANDDAMFFB.gFFBSGHHDFDB.hABA......hACA...,2,-11,-4,7
fAOGNBeDSPcRJTdQIaMFXKgZLVUYbCHWE,GAAAeAAADAEASADARAFA.dAGAaBCDMAIBKBED.ZCDALCHBhAAAUEABCDHD.HDEA.EFGBhABAAAABBEEAJGDA.TFGAhACA.QGBB.FGFH...hAIA......hCAA...,1,-3,-22,19
OcbGIeVEYdRKNAXaPgUJFLDZCMHBfSQTW,aAAAUAAALADAZADAHBGBBAHA..QCDATCCA.ODCBhAEAGCEAeEFFECGAREAAAAFA.hAHAXEGAJEHB.CBBDMHAAhAEASFDB..cGGA.IHEAhAFA...hAIA...,1,0,-21,21
NfDbFYHMCUVKOWEXPeJRBAcGdIgSLQaTZ,dAAASAAAaADA.ZACBDAGAFAEDHBDA.MBHBCAGAKBHB..ECBFeCFFhAAARDDABEHAADEB.GGBBhACALEGBQGFChBAATGAA....fHDB..hABA......hAGA...,1,-7,-35,28
YfJIdBNaDLZbCPFAUTGegSXVcOQMWHEKR,GAAAeAAA.SADAXADA.OAFDMAGBHCCARCDB.fAHAhAAAdAHAaDAHZDGBbDFAFDCHhAAA.AEGB.UEAA.TFFAhABAgFDA.......hAEA......hAHA...,1,-7,-10,3
eJRbPWdZLKMUOfHQNaIAXGESgCFTYVcBD,EAAACAAAFACA....TACA..VAFADAEARAFA...bCCAdCBAhAAAZCGBMCFB.OCHDhAFAHECAaEHDADDAGECAhAIASGDA.gGGGBFGA...hBCA......hCAA...,1,-6,-36,30
FIfKSeVGdMRgDYXLPQaUBEJbTcOHWNZAC,FAAAKAAAeACEdADARAFA.DAFALCCA..aAGEECGA..JBCB..hAAATEEAHCFAZECBAAFACDBD.hAIASEFAGEGAMIDAhBAAXFEC.PFHDBGED....hCAA......hCBA...,1,-16,-26,10
SbOGcHgNUVeMQZAKaXIWfBRDFCTPdLEJY,aAAAXAAA..IADABADARAEFCAGBdAFA.LAHB.EBBBhBAASAHHGDCAHEEBhBFAgCGGNEHA.hBHAeCDBMEIBAAAAfDAADCEB.TFEAhADA.PHFC.hCAA...,1,-9,-24,15
PLOcbENYRBTCMfAQXFVIKaUHZDSdGgWeJ,QAAAFAAAKADAHAFBZACBdBHAGAEA.eAGBLCCBOCHDECEBhADAREBACAHBAAHA...XFFAhAAAaEECSEGBhAFA..gGDB..WEHH.hBCA......hBEA...,1,-9,-24,15
dXZePIGfDCNELQHcWFTVOAbYgMSaBRUKJ,...bAAAMAAA.aACERAEAKBHBdAFAZAGB..eCABGCCACCCDECEBHEFAhBAA.FBBHOCGBhAAAABIBSFBBBEEDXEGDhABAfFEELFAAWHEA.YHAAhACA......hAEA...,1,-9,-16,7
aVGDdTSNFgceICQJKbZEHYXABWPRMLfOU,BAAARAAAMADALACA.OAFDaAFEGBDAdAHA..SCCAhAAAFBHDeCCDQEGAhAAAKDAAEDEFHDGBACFAfFEAhABADFFBNIDB.gGGGCGGDZEAE..YHBEhADA...hAIA...,1,-5,-18,13
SEVKcAPbLICQXZGdOTeJBHRUDWagMYFfN,LAAAQAAAGADAdADAeAFAHAFARCDADBIBaCAAMCHB.FDFBSCGBhAAAEFAA.KDBAhAFAAAHAbGFAXEFC.hABAZGAAODDHTGGABFGD.....hAGA......hBCA...,1,3,-12,15
eQTZLHOFAdJSfDRcXgKIGEPaBCWNVUbYM,dAAASAAARADA..XAGBKADAEAFEBAHBCCBA...VCCAhAAAbCED...eCFEZDAAHDGDhACAADAADDGB.IGCAhADAaEFH.UGGBMEHB.......hAEA......hBAA...,1,-16,-29,13
FHMeBdOQDNEVXRGJbWPfTCZUKLYAcIgSa,..IAAAaAAAHACBBACAdAEBQBFB.ECHFRADFbAFBfDEAhAHAZBGBLCABhACAAAIBSBBDeCCBDCFBXEGAhBAAJEEF.TGEAKEHBgGFHhAIAMEDB......hCIA...,2,-17,7,24
USfIcVbMGgYQCHLFKPdDJaXRTBOWAeEZN,EAAAZAAASACE..fACA.IAEAhAAAbAEDGAGAQAGAhAGAHECALFGBKCDAdCFAaDCChBIARGAATGEAODGDAAGBNDIAcFFC.MDIBCCCDDEEAhABA......hAIA...,2,-7,0,7
bcYfNXCdMEGPIWUVQJBHOLaeZDgKAFRTS,RAAATAAA..bADB....fACBCAFAEAHB.GAEAhAAAICCAVCCB.QAGAhAEAHCEBaCGCeEGFhAAAZDGBKGAAAEIBSHCAcGDANEIAMIBA...hABA......hAIA...,2,-23,12,35
MFVXIaYcHbPBAgeJdWZQLRKOETGCUNSDf,eAAAdAAAZABBRADA.EADAGAGA.UCDBDAGAMBFAFEAA...XCEAhBAAaDFDHFGB.BGAAhAAAACEAJCHB...LEEBhCDAOEEHNIABSDDD.fGGAhCHA....hDAA...,1,-9,-29,20
AdHFROeNETGYUQPSMKJZBLVDIfbCcaWgX,HAAARAAAeADEEADEGAGAQAFC.MAIBZCCALEBADCAB.hAAAbFCAaCCA.XCFAhACAAAAAdGAAODHDTEEA.hAGAPEHDKBDABGGAfGEE.CDDDcGGChAHA....hDBA...,2,-7,-2,5
dcWbLUfPBGYKgTNXQVaeZFDMSHIJCOAER,RAAAdAAA....bADBLADA.fAHAGAFAKAHBTCBAhACAQDCC.eDGHhAAAZCFAMDEBHFDBCFBDEEABhAEAcFGDPECDBHAAgFEH.NICBaGHBhAFA.SHAChAHA..,2,-14,3,17
HAOJRCUEZIbNVBgLafSMDFQGYcKdPWTeX,RAAAEAAAZADB....bACABAFA.aAGDMAGBFCFH.GCCA.KAHBhAAAdCCCTEAAHDABAAAACCHDUEFAhADAVEGB.LFHBhAEADAIB...YFDBPEEBeHDA.hAHA......hCAA...,2,-15,-5,10
SLUHaVFGKdQEJTOIXMcPNgbCZDWYAfRBe,RAAAeAAALADBHADAaAFAGAFA.dBHAEBHFOCCHMCCB..PDDAhAAA..bEEAZEFBDEIBhAAAADIBSFCAhABAFFABKFDD............hAIA......hCAA...,2,-17,-14,3
dGSgPYWXIHaRJTFZMNVUQAKLBbEcDefCO,LAAAEAAADADA.eADHOAEEGAFA.SAHB..hABAgBCBPCABXDEDhACAHCEBRCGBTGCAhAAAZDGBMCCBUFGBADEBbFAACAHBYCCFaFHDFHBCNIEB..hCAA......hCBA...,1,20,-20,40
TREFXAVHDNCbZMQePdIJBWKcfGSOLYgUa,HAAACAAAZACA.eACEdAGABCCAKAFCGBGA.LCCAUDEARDAB.EECA.hAAAAAIBDEFBMAIB..QGCAhAAA.IGGAhCAAcEGAOECD...aFAH.hCDAFGGB.....hCEA...,1,-10,-32,22
LGAdHCBPFQYeONEZDTMgfRUWJIVSKacbX,HAAABAAAQACAeACEEAFEZBFEMAFA.RBEF.UCCA.JDFBSBGBhAAAaDHB.bCABLHAAhAAAABIB.dGGAFDDHhACANEIA.TEGA.fFFE.IGDAhBEA...hAHA...,1,-8,-12,4
AHLcNUCWZOSYfGFMVTgQaJeBdREbXKPDI,HAAALAAAUADAZADBSAFAGAFAMAIB..TCFAaCAAeDEFhABARCAAEDEBKDHD.DFBAAAIBCCHBhAAAOFFBFEGD..QGAAhACAdGHAPHAAIHHA...hACA......hAHA...,1,-3,-7,4
GVcFBSfTCKZLQbYgHaWAXeIdOMJRNEPUD,eAAAdAAAMADARADA..EAGEDAHBGCCAFBDABCBA..TCFAZCFELDDBhACAQEAC.hAIAbEFAHFFAAAAA.OGBChBAAPFEB...cGGACHEA....hAEA......hAIA...,1,-6,-26,20
LVafRYQMIZBAWcHNEJPSUOGebCTgDXFdK,HAAAEAAA.SACEGACAeAEACAFA.TBGAXAGD.dCCALDFAhAAAaCFC.REAAMEEBhAEAZDFEAAIBNEEAPFFA.hAAA.bFAAFGHDKFGA.fGFE.IHHAhAFABCBD...hAFA...,1,2,-3,5
bfegGdBYAZQLRHIJMSDPWOcXKCVTaNFEU,ZAAARAAAHADBMACADAFA..OAEEKAHB.CAHB.aBFD..ECCBUDAAeCEAhABAdDHABCHAAAAA.LECAhCAASDDD..hADAcEGATFEAbGFCfGHA..hBFA.YHCA.hCBA...,2,-25,-17,8
JTOQUgLdEDecSCbPZKVAaNWXBHIGfRFMY,aAAAXAAAHACBGAEBRADA.FCEDMAHB.JCDFTCGA.QEAAhAEALCFBEDAAhAAAeEFFCDHAZFDAAAHABEHAfFHAhABAUGGADBBBbGAC.......hAFA......hBAA...,1,-1,-10,9
AODHVIXBeNWURaKPJGcEfTQSYMgFZCLbd,HAAAXAAAeACEUADARAFFKBHB.GCCA.EDHBTAFA.QCGAhAAAMEFBZFABbFDDhAAAAAHADDBABGGAaDEBPEGBhABA...fFEA.SFHHhBDA...hAFA...,1,-4,-16,12
dBfLEYAVWcMQRSgGZXaJNFCPeUIKTHDOb,VAAAMAAARACA..GADAZAFB..aAHDFAFA.eAHHKBBDHCDBDCGBdDAAhAAALDHBADDB.QFAAhAFAXEFACFBAIEGAhBAAOFDBfGGEEFFBYHBG..hBHA......hCAA...,2,-17,-8,9
DGVIdZbfTPYMLAJEKWRSXFQUgeNCHcOBa,EAAARAAAFADAUADA..eAFHHAFABAHAGCBAdCCAZCGBTDFA.MCIBhAAAAAAAKEDA..XDDBhAHAQGDACFFDaFHHDDIBhAHAIHCA..fGGA.hAIA......hBCA...,1,-7,-32,25
BdULeGWbcRHfPDEJYZOQACTKSgIXNMVFa,TAAASAAA..XACBMADAaAFEdAFALBDBeAHBGBDAhAAA..bBFAHCGBhAIADCCBEDFAZFBAACCBKEGAgFFBhBFAIFDAFFFHWFHHfHGF.hCAA......hDAA...,1,-1,-12,11
NUWLDVGdaEPgQKFBMfXAOTCJIZcYSeHRb,TAAACAAAZACA...SACBHAGBRCCAUDGBLAEAGDAAEBHFQFEChAAABCCDMCEBAADA.hAFAOCFB.IEGAhAAAeHFANIAB.DDIB.aFAA.KGAA.XGCDhAFA.cGGA.hAGA...,1,-3,-12,9
JHNObQfSUDCaEMPIZgTYGKceFVLWAdBXR,dAAARAAAHADBOADAQAFAUBEB.CAHAECCBMAHB..ZCFE.TDAAhAAAGCBA.eCHHLEEAhABAAAIBXEEAbFAADEIBhADAaFDCIGEAKFHB.FGGBBHHD...hAFA......hCAA...,2,-18,13,31
NbKdGBAZOUEHcFYMCgeRIWLaJDQPSXTfV,ZAAAEAAAHACAFADA.MAEAeAFH.RBGF.LBGBDCAA.QCCBhAAA.XEEChAIATDDAfECEhABAbFCDdFHAABIB.ODHD.cFFACCFA...gGEBhACAaGGB.SHAAhAHA,2,-19,-5,14
ObXUgaZIPDLYCVNcfFSQATJKMREdWBeGH,TAAAMAAARACA..dAFAeACEHBGB..bAFBXCCA.aAHFZBGBhAAA.DBDBLEFAhBAACCEAVECA.fFDAhBBAQFGAAGGAEGEFBGFD........hAIA......hCAA...,2,-17,-4,13
EIWcGFNAMKQSfgVRPXZJbLOCTYBeHDaUd,MAAAQAAA.SACAfADARAEFZAGBLAFA.TCBAhAGAeCDBHDAADCFAdDEAhAHAEDHFIDGAGFEBABIBhAAAKECBgGAAXEGA......hADA......hAGA...,2,-16,2,18
PFRUZJgYAHWIaNKTDLXcGQOVebMdBCSfE,HAAAaAAA.TAEALADAGAGAQBGAeCAAdDDASBBDhAEAEEAARFDAZGAA.JCCAAACAIFHAhAAADDGBOEEB.bFAAMIEAhAEACFGA..FGHD.YHAA.KHEA.hAGA......hAIA...,1,9,0,9
BaTIeLWYXVNPGQMSZADbgcOUCFHJRdEfK,DAAA..bAAAOABEFAEAHAGBRAEF..EAGEBBED.aCAAeCCBLDDAhAAAXCFD.VEABhAEAGEGA.MFDAhABAACHAUFFA.CDHB.........hAIA......hBAA...,2,-23,-13,10
JTCVBWMSgaEAdeXNfRUcHbDYQKLOPIFZG,eAAAXAAARADAHAGBDADA.QCCCLAGBOBCDFCFHGEAACBEABDFDhAAAMDIB..aCHDAAAAdFFAhAEAUFFAbFGD..KEBAhABA.ZGBA..........hAIA......hBEA...,1,9,-25,34
PLaIZQHKNYVMSAOFEUCGeBbJcgTRdXDWf,EAAAGAAABACAJADA....TAEARAGFdCDADCFB..fAGBhAAAaCHD.ZCCAHDBBhAAAKCGAVEAAADGBFFFAeFHHhACAbEEA..XGCALGAAQGGBhAEAMIAA......hAIA...,2,-11,-5,6
BCTNMKHSJfXAUQWFGbYZRPeDEOIcdgVLa,QAAAGAAAZADARBGFeACADAEA...EAFAOCDBdBHALCDAhAAABAHB.TDAAMCFBHEFBhAAAfECAADIB.FEEAhADA.bEGDIHHA..cFCDaECHCFHBNEEAhACASHCA.hBAA...,1,11,-18,29
HVIGEPWMgJbOdXLfYTaKAFScZUeQBCRDN,SAAAZAAAeACEQAFCRACFHAEBGBGAEBHF.MDEB.JEAAdCCDhABALFFATDEAAAHAFGAAhAAABDHADAIB.IFGAhCAAWHAA.bGDC.........hABA......hAEA...,2,-8,-7,1
YQbagfGFMRecKSWPDLZJVCUXEHdNITABO,OAAAQAAA.aACEGADA.RAFAeBBBSAEHDCHBZDEBCAGAEBHFhAAAHFAAdDAA.TDCAhADAAAFAbEFD.FCFD.MDIBhAGAKEHB.LFFB.......hAIA......hBAA...,2,-13,-4,9
ZeLTdMfgFIBRDGAVacEYbXCWQNKUJPSHO,aAAAEAAA....XACAQADA.KAFAPAFAHCCAeAHHhADAdCCAMBFBFDFDREGFGCGAhAAAABBBVGCAbDAB..CHAA.UGCAhADASGHHZFFF.......hBIA......hCAA...,2,-4,-2,2
VDBRWbIMSTadELfQZAOFGHNJKgUcXCPeY,GAAAHAAAKADCUADACAFA.eAFADAHBBCAD..RCEA..IEGAhAAAMAIB.aCHFECCALFFAhACAZCEBADEBFDGBJDDF.XGAAhAGAVFGB.SDBH...hAAA......hACA...,1,-1,-32,31
NAVIGTLYMJDgUPBQdWKFXEcfRaCZeObHS,GAAATAAA.MADADACA.UBFABAEA.dAGAFCDB.EDHFRCCAZDFB.eCHHhAAAHDBB.AAABLEEBhACAJDBF.QGGAhAHAXFCDaEEBOHCCSFHH.NIAB.hAIA......hBDA...,1,1,-21,22
HSJAKdOWeNUGgaIbcXRBVECfLPYMDFTQZ,dAAAeAAAGADA.aAFAbADA..RBFFBCBAEAHBLCCA.MCHBhAAATEGAHEAAAADBOBHDhACAUEEAgGDGhABA.IGHAXFBA.fFEAhAIADDIB.QGGBhBAA..,2,-11,-5,6
bIaMNSGDFOeAfWKcRQLUJTdXPZgYHBECV,KAAARAAALADBUACA.dAFAZAEBHBGBBAGAEDCB..CBHA...bEEBMCGBhAAA..SAHBhAAAGEBAFDDHACCAfEHAhABA.QFBCTFEA.XGFDhBFAPDHB.YFDBhCAAaGHDDIDA..,2,-39,11,50
dRWPBCXZJaEeFVHYbLKDfGQgNOTASMIUc,MAAAUAAARADABADAZAGB...EAFAeCDAHBBALDABDAIBGBGAQEEAhADAOCEDADDASCHHhAEAdFAACFGD.aDCCFGCAhAFA....bGAAfGHA..hBAAgGFA.hBBA...,2,-19,-5,14
OWNJKYfGdHUDCgZPQTISALMVcbRXEaeBF,MAAAVAAA.RACA...EADEeAFEBAFBFBBH..OAGDJBFB.KCDAGCGAhAIAHDECDAIBZDDFTGFAhBAAADCBLFCA.XGGAhAAAaECB.NIDB......fEHAhCAA...hCAA...,2,-19,-13,6
LGAWORTXCUQdFDVfSNBYIaeJgKEHZPbMc,RAAATAAACADB..dAFADACA..SAHBBAEAaAFD...eBGHhAAAKAHBHCCAZCCAMDIBGCGAhAAAAECA.XECAhAHAQFBAfFFAIFFAEGDBbEGDWDBD.hABAFGHDNEEA.....hBFA...,2,-18,-3,15
HSOGUBDLNFZIJdVPXbgEKMTfcQaCYeRWA,HAAAGAAADACALADAZAEBdAHA.XAGDEBDFKCGD.MCDB.TCEAhAAAQEEC.aCCHhAAAeDGFABGA.ODHDhACABDHAFFHBIFAA.PEEB.fGHEhAEA.YECFhAFASGGD,2,-19,-14,5
ZXEYPJgCWHBOISQfdGDeabNLMRcUKTFVA,EAAAJAAA...CACAHADBOADA..QAFAGAGAeBDFaBHDLDDAhAAARCEBKEHB.TEGAhAFAAAIBZGBA.XFDAhAIA.gGGABFGDSEEDdHBBDCCB.MCCBhBAA.....hBHA...,1,1,-24,25
QYCLKaDdTIOUPEgWRFfBbNeSZAcMVJHGX,MAAAHAAAGADA.QAFALAEAaAHDdBHATDAAOBBBECDAhAFARDEFBCCDeCFFAACAVEGBhAAAXDBDKFADDGDBIDHAhAGA.UFGA.gGED.hAFA......hAIA...,2,-5,2,7
ZdXYeTNJASLIVREUKFQWcgBfOCHPbGaMD,LAAARAAAEADE.FAEAQAFC..gAGHOAHDHCCAhAAAGBDAaDFDZEGBdCAAeCCDhABAJECFAEEA.SCGAhACAIHAAKHDABEGA.CFCDbFEDDGIB.TGGAhCDA......hCFA...,2,-9,-2,7
OLXFJCGbBMUPETDdVaZWIcYgRQfKSHAeN,eAAALAAAFADDGAFAMAEAUBEA..EAHBdBHAZCCA..ICAAhABA..gDGHhAAARCCBQEFASEEDhABAHGCAACGAOHFCCFAAbFBDTGGADECB..hAFA......hAIA...,2,-16,-8,8
gCYMaKRbfNSQZVdeEBDLPAOTGHUXIJcFW,GAAAHAAAXADBJADA.FAFDCAGB..MAIBRBGF....bCAASCDAhAAAZEDBeFFAEGHFhAAALCGBAAHA.TECAhACA.UEEA.IGHA...hACA......hBIA...,2,-23,-11,12
eZHCJYMBDgIFfWKNXPLSGbQVdaATUEORc,EAAARAAAeADEHACA.CAFB.MAHBDAHB...FBDDKCCD..XCEDhAAALCFAGEGAbDECdEAAAAIBTGAAhABAOECDZFFABFFChAGAIHFAfGCBNIAB.SCCDhCAA..aEGE...hCGA...,1,0,-14,14
TWaeOfBUgVYNScXELdKJbFCAPHQRGZDMI,HAAARAAAZADBDAGAMACA...TAFAeBFABCCCVBDB...SCGAhAAAEBHFdDGDKEFDFDABAAHAQGGAhAAAGDEAaEGA.hABAOCCHUFBA....gGGAhADA......hBFA...,1,0,-18,18
SRAWOcdIHLDeUQGfVXKPCbJEZBTNgFYMa,OAAAdAAAHADALAEAeAFEGCAB.XCFACBBDEBDBZBFETEEAhACAFDDHMDGB.RFAAAAFAIFCAhADA.QGEBhAIAKDHBbFED.BHGA.YDHBaGHB.hAIA......hBAA...,2,-16,10,26
WDASGBMLNIRCcVKJbEdeUHOTgXfaYFPQZ,GAAAMAAALAEARADACAGB.KBBAEBHF.dCDDHCDA.TDBA.hAAAXBGAaCFDFDHDZEAAhACAAAFABDGAIFFAJEFFeEHFhAIA.OFCDfGHA....hADA......hAEA...,2,-21,-4,17
fUTHJVbCDANLPBSgYXdGFOaReMEWcKIZQ,LAAASAAAXADDGACAFAEA.RAGF.EAFAKCEAZBGB.QCAAhABATEBA.HDDBhACAbEEA.ACGBBEHA.dFAAhAFAeFHHMFGBIGEA.....hAIA......hCAA...,1,-8,-12,4
ACHSEIKgQaMFbVDUZYfJPBLeWGcTRdONX,HAAAEAAAKACAaACA.MAFAFAEA..DAHBZBDE.JBHBLCCA.eBHHhAAAGDEARDFB.dEDCXECAhAIAACCBSEHHhAAAQGCCbFBD..YHFGBFHAWFFD.hBFA......hBHA...,1,-8,-17,9
MJLPfDSFOIGaTVRdHYBCQEZAgbUWecKXN,UAAAeAAAKADAMADALAFB..DAHBOAHBaBDA.RCCBHEFAhAAACCDAZCFE.ACEA.....hABAbEEAcFEC.NIAB.hAIAfDCE.FGBAIHHAGGEB.hAIA......hBAA...,2,-29,-11,18
fcISaRdUDOXBVYKMeWZgPTJLFGAEbNQCH,EAAAQAAAHACA..IAGARACAdAFAOAHBBBHAKCCD.eCFBhAAAZDAATCDALDHBACIBCDGDhAAASDEDDEFB.hADAXEACMEIBgGFAFGCANIABaGGC...hAEA......hAFA...,1,-7,-13,6
MeLEAVSIUgBaXWKOYQRHcbTZNDFCfGJdP,SAAAUAAABADA...aACDKAFA.QCDAHAEATCDAZCFB.hADAFBHDGEGAdEAAeCFHhAAAAAHA.gEGAhABAOBHDRFAA.bGAACDCD...fGHA..hAEA......hAGA...,1,-4,-26,22
LNMZCHAOKQaGDSdYVfcRWBFeEIJPUTgXb,QAAAGAAAdADA..VAFARACAFAFA.EBHFJCEB..UCEA..hAAATDGAXDAALFAAhAAAZEDAHFGBACIBaDBDSEHBhADA.fGDABFFAeFHF.hAIA......hCAA...,1,-8,-14,6
DdTaFQHYbLXeJSBGOANfKRECcIZgUVPMW,KAAAEAAA.CACB.ZACB.UAFAMAEA..dBECFAHDHDECLBEBeCBDBAHAhAAAABGB.RFFA...ICCAhAAAPHDCDCIBaDFD.hCAA...QECC.bEGD.SDHBhCBA..hCEA...,2,-37,-13,24
HUPQgWfaVONYeKSRcTMCELXIFZdBADJbG,DAAAGAAAHABCQADA..fAEBaAFEOAHDeAGHhAGARCEAMCDBECCBLCEBhAIAFEEHdEHAAAABUGAAgDGAhBAA.NHDBSFGATGFA....hBIA......hCAA...,2,-15,3,18
WQCAEeOFHcYTGZaJKSPURNXdDIVLfbBMg,EAAAeAAAHACA..TADAaAEAKAHBUAFARCCA.dBHADCFALCCBhAAABDFAMDHBQEEAhABA.AEHAFFHB.cGDAhAIAZFFFSEED.PHAA.NDIA.hAAA......hAHA...,2,-19,-8,11
afAgcbJOTXQdHELZMeYWDCBSFNPIGVURK,...bAAATAAA.dACAHAEAEAEAZAGBeAHHDBIBSCAAhAAA.FCEHICEAhAAAGDFAREAAaDDCAAGAgGCAhABAOEABLEGBMEIBCHEABFFA.PGBAhAEAKHGA......hBGA...,2,-18,18,36
UKGVbQYCRPScJNaEIWZDLMAfXgHTdFBeO,XAAAHAAAdADAeAFAKADA.GCAB.QCFARAFFSAHBhAAANBIA.ECDBZEEAMCHBAAFATFCAhAAAODAB.bDEDCGGDPHDChACA..aECB.DDIB.fGHAhABA....hADA...,2,-22,12,34
aAUgdFScCEZWHYbePMDRNIXJKQVTLOGBf,dAAASAAAEADAHAFAeACHMCCA..RAEA.XCFAQCEBTDAAhACAGCGA.aAHFAAHAFDDBhADAZEAAbFFDDCIBIEFAhBAAKEEDOFHDBFGA.fGHA.hAAA......hABA...,2,-4,-1,3
PCWDVKLgNeabMAZYdXSQfIRcHJUGTFOBE,dAAAQAAARADAHAGBGCABOACCBAFB.EAHBCCFDDDIB.LEAAhACAeCDAaCGDAAIBZEEASDCDhAAA.fEAAhAEAIGAAcGEATEEAFEHD.WGDAhAIA......hCAA...,1,-15,-20,5
IRJScFCHfYLDBKEdMOVbQAGZeXTUPgaNW,eAAATAAAUAEA..aACA..IAHARAEFSAGBCBCA.HCCBhAAALCHBKCGDEDHFdDDAhAAAMDBBbDEDGEBAhABAZFEA.XGFANIAB.WHDG....hBEA......hBGA...,2,-13,-3,10
QGHMFLfVOIYTcKdReCNPABJbWDUgaEXSZ,BAAAJAAA.DACAUADA..EAEAZAFBHAGBLBHBOBCB...hAIATDDAdDDARFBBeEGBhBAACCFDAAIB....bEGBaCCHhBFAQGBAMFFB.fFFA.hCAA......hCBA...,1,-20,-24,4
UIMTGPLfNVEQSXZaCFgJAKeDbYdOWBRcH,eAAADAAAdADABADAHAFAMAFAGBBA.LCHBVBEA.EDEAQCCChAAAZEDAFFAB.ABHAKCHBhABAbGEA.OEEA.RFFA.hCAA...IHHAfHAF.SHDGhAFA.CDGA..hCBA...,2,-22,1,23
OBKIPTXQVNYDMRGWEZgcHLAaCeFUbSdfJ,eAAAFAAAUADAdAEAOAGBBAFA..KAHB..TCCA.QDFBhAAAVCFA.DAIBRDBAEEFBhAHAZEBAHFFC.ABDAaHAAhABASEHH.IHFANIDB..hBAA......hBDA...,1,-1,-44,43
WHPcNROIMaJbTUVGQDFXKCASgLdZBEfeY,LAAAZAAAEADE.eADHHAFB...PCABRAFAMCAB.aCCHbCCCUCFBhABA.GEDAQDGAhABAXFAAAAHAdEEAfFFBhACAcFABOECDIHFATGFADCIBCHHAhAFABBHB....hACA...,1,5,-1,6
TeRdaFQONbVSIHCLDGXMWPKJYBfcEUZAg,eAAARAAAdADAFAFAQADA.OAFCVCEAHEFCLCCBGFBBhAAAMCGBKBHBBCHA.EEEBhAAAACCBaGGCbEGD..CHAADEIBhABA...PHCAfDDE...hAHA......hAIA...,1,-5,-16,11
QAPWTFcHfURBKISLMYVCdXbNOGgeJaEZD,TAAAHAAARADFKAFC.LBHBMACA.CCAD.bADAGCEA.eCCBhAAAEAHBZCCA.ACEAFCGDfFHAhACABEEDSDHHhAAAdGCAOHFCaFGC.DIAA......hAIA......hCAA...,2,-19,-2,17
BbVOWgMcKDCaTPfXZeNRHAEYGUIFLSJdQ,EAAAGAAAFACD.LADAdAEABAGAOAGD.MAIBDAIBCCFA..aCDAhAAA..TDDAXDDChACAeCGHHEFA.AAEAIGDAhBAAQEBCWHEAKEHBZGAA.YFFFhAAASGHB..hBCA...,2,-21,-13,8
RAHTSUfJeXIQgZBPONYdMaDbWcCKGVLFE,HAAATAAASACE.UAFAeACEQCCAZAFBOAHDdBHAhAAAaBDCDDFB..bDDCCDGDGFBBhAIALEHBRGFAAEIBXFAAhAAA.BFFA.PHDA..hAFA......hBHA...,1,-5,-11,6
OFZBVNJYeGKUHCAdLEIQaWXRPcSfgDbTM,EAAAaAAA.RACA...SACHDAFA.MAEAZBEEBCCD.VDABhAAAJAHBeBBDGDEAHBEBhBAAAAIBLDGBQEBBhBEA.XDGAfGBAbEECTGCAFGHDNICB.hADAKGGA.....hBGA...,2,-15,6,21
YOaPTUKcQbSgVBHeDJLfEGRNCIAFZWMdX,ZAAAdAAAOADAaACA.UBEBQAFA.SBHBBAHAHCAChACAeCCALCHBEDEARDGBCFAAhABAADFBMEEB.XFFChAHATGFA.KGHB........hBAA......hBCA...,1,-11,-26,15
ZROQGBKAUSLgMHFfaNbeVCETWYdIcXPDJ,LAAAHAAAaACAeAEHEAEA....TAGAdAGAXCCDDCAARCDAGDGAhABAAAIBSCGAhAAAFDCH.bDFCCEAA..IFEAhACAPFGBZGBAQGCCBFHB....hAEA......hAIA...,2,-15,5,20
HJZRDMbGFTEKVSIYNgALfOBPQeXcaUWdC,LAAABAAAeACAaADDdAGAHAFARBEB..MAIBGCAA.ECCBSCAAhAAAICHAgDFBhABAAACAODCD.QEDAhACAXEEA.cFCCCDHDZFGBFGBBTGGA.hBGAKHAA.....hCAA...,1,17,-21,38
eQaDOCPZTUFHcWLGJKbgRdNVSfAMYBIXE,MAAABAAAEACA..eACAaAED.CAFAZAGB.FBBHHAGB.LCAAhAAAGCEAKDCBRDEAdEBASCHHhBAAAAGBXEGAQGCAhBIAOEDBTGGAcGFB.....hACA......hAIA...,2,-16,-12,4
CeGOWDTRbJSEgVZdQaBKXNLUHcFMAfIYP,..IAAACAAAeACAGAFADACA.RCAA.SADAEAHB.ZAFBaCEHhAAAKAHBLDHBHCBAMCHBhBCAAACA..fEGAhAIAOECCbGEAgFBA....hBFA......hCAA...,2,-20,-15,5
cFCVQKITNSREJDHgObPMeaWUXdLGBfZYA,CAAAQAAAKACA...TACARAEFEAGEHCAAOAEA..MCGBhAAAeAHFUEABdCEAGDFAhAAAZDGBACCA.FEDH.IFBAhBFASDEDDCIBbGCAaFHDLHCAfHGFhCAA......hCGA...,2,-13,-5,8
YQJMCUdWReLKODbZfXBIHPaGcVgEFTSNA,QAAAMAAAdAEARAGB.eACALBBBDAGAZBDEBBDCHBGBGCFA.hAAA.gDAAhADAEDDATGAAABIBCDEA.KEDDbFGDXEGAhBFA.aFFC.FGEHSFFDhAGA.NDIA.....hAIA...,1,5,-14,19
TWNIbEfDCLRMGeHPBacFJKOUgSQXAYdZV,ZAAATAAA..IAEAEACE..CAEBRAFFeAFHHCCABAHAFBHDOECBhAAASCAA.AACAdCHAhABAVEEA..bDDALEHBhAHAMECB.aHGCKFFD......hAHA......hCAA...,2,-32,0,32
XGAdbUJVWCQFMOISaTgERePBYNZfDHKLc,dAAAUAAAJADACADA...FAGAMAFA..OBDB..aBDEECBFRBFFeBHHhADA.BDDAZCEBHCGBhACALEFAGGDBhBAAAGGA....WHBASGGE..hBCA......hCIA...,1,-24,-35,11
ZPCGETDLNQcaJgUdObHVXKSBAYIReMWfF,RAAAeAAAMADAFADD.ZAEBGAGA.DBEALAHB.QDFDhAAAaCCAUDDBdEGDHGBAKFCDhAAAABGAIGFA.hABAfCCEEGDATGGANEIA......hAIA......hBIA...,2,-20,-8,12
YFMAgJUNBVEGDfOSKbLRdPIXTWcHCZaQe,UAAABAAAEACAGADADAFA.OAFA.KBGDRBCAdBFA...XCAChAAATDAAHDEBZBGBeDEBhACAMBIB.AADBgEGBhBAAVGFA.bFBD.....IHHAhBCACEHA.aHDA..hBFA...,1,-11,-23,12
WcXRKPFeJfQBZIaAVMSTOLgYDbGdHCUEN,MAAATAAALAEA.DAIBdACAHBBAEAEA....NAHAXBEAhAAARCEAFDBHeDDB.QFFAhAFAZDDAAAIBODHDbFCDCEHBhAGAUEAA.KFDA.fGGAaHGE..hAEA......hCAA...,1,2,-17,19
XbeWMOATZafYGFKgQBScRVHdCLIUJDENP,aAAAGAAA.KADAQADABAFBRAGF.HAFAdCDALDFAUDAAECCE.hADA.XCGAeDADMFCAhAAAAAHAZEEAFFGASDFGhBAACGDADGGB.PHCA......hBBA......hCAA...,1,-5,-21,16
abJQLcDCOFYdHWMZGRPAKgBNEIUTSfVXe,BAAAEAAAUADASACA..XAFAeAEHaAGAQCBChAAA.LDEAhAGACBGAFCAAHDCAZEFERFDBACIBKDADgGGAhAIATDGAbFDADBIB.dGBA.MFIB..hAAA......hACA...,2,-15,-2,13
aTPBDfMAcKWGQLOebJURdYXHgEZFNCSIV,KAAAGAAALACBeADAUBGARAEA.dCDAHCECEDFB.ZEAA.CAHB.SDADhAAAaCHD.TFCAhACADECAAEFBQFGAhAAA.OHCAbFFAYHAA.FHEA.hAEA......hAFA...,2,-19,2,21
YLXVQcWDagfeETBKGHOFdCbZIRANSMPJU,MAAAUAAALADA.QBGADAEAaAFEeAHHECDA.KBBAHDEAhAEAdBDAZCEBAAHA..SDCDhAFAJDGF.XEGAhBAA.VGDAgGGABGGB...hBCA......hCDA...,2,-37,-6,31
NbLaHEKIOGdQSYBgFTeXZfVcUWADPCJMR,CAAARAAALADBHACAKAFCGBGAdAFA..QCGABCAAFCCHeCFDhAAAZDCAVFBA..UGCAhACAAAAADFGAMEAB.aECEEGEAhAHA.SGHB..TGGA.hAIA......hBFA...,1,-11,-19,8
WKVEgTPGSabcNCdIBAUJORFeMQHYfDXZL,OAAARAAAeADEHAGBDAEAZAEELCCA.KDFAEBBB..TEBAhAAAGCEAaDHD..bCGBCBDAdFFAhABAAAIBFDBHMEEB.QGAChAGAXGDCgGFHSHGA.NEIABDDChBAA....hBDA...,2,-23,15,38
BYDIEAVSPWfMgUNJcQTRXGOKdLbZeFCaH,SAAA..fAAAMADAUBDAJADAQAGAhAAARAGFGBCAdCBCZCFFeCCDaCFHHEFChAAADDIBADHBVGAA.PGDAhACAgEED.NIBB......hAGA......hAIA...,2,-12,-5,7
KGXFSRbfIUNZYgeQAaBLHcVTMPdEDCWOJ,aAAAHAAA.TAEAdADAEAFACAGB....OAHDGBGAFCAHRCEBIDBAhAFAZCCAeCGBAECA.LFFAhAAAMDDBDAIBKGEDbGCA.hACA..UGGAgECABBBD....hADA......hAEA...,2,-8,-5,3
fLWSGPTQMRDAcJOXdaNbeVBZEUYIKgFHC,OAAAaAAA..eACHZADBEAFAUAEA.KAGAHBFCLCHBGDBAQDDAhAIARDEAAAIBJEHBdBBDVEBBhBAABFDA..gFEAhBBAfGFASGHB...hBAA......hCAA...,2,-12,-6,6
LbCWJfDIcgHAPYGZdQEeTMNUSVRBXOFKa,GAAAdAAAEADA.eADAMAGBSAGA.RCDABCGBFAHBaBDELEAAhAAACCBA.JDHBDCIB.hACAIDDAHFEBAADAPHAAhAHAZEFATFDA.NDAA......XGGChACA...hBAA...,1,-6,-20,14
QOCWBKaLbcHMgfAeSJINPdZUTVDRXGYEF,eAAASAAA..IAEAdADAZAEBTAGARAFFGBCA.EBHFQCGBhAAACDHA.KCCDhABAbEEBHEEAMECBADBBPFHDhAIADFIBFFDDBGGAaGEC.......hBDA......hCAA...,2,-11,-9,2
RYNWOBACZgFadSTHDKVMfPJLeGEQIXcbU,ZAAAaAAA.dAEAHACBKAGA.MAEA..JCAAeAHFGCEBEBEE..QDEAhBAA.XDGAhBBAbDACREEB...YEDFhBGAOEGFACHAFFGDTGAADGIB....hABA......hACA...,2,-28,5,33
ZDRCOKbIdPaAfUXFEYJeSHWQBMgGNLVTc,XAAAEAAA..eACAHADAQAFAMAFAGBGALBHBhAAATDAAZCCARDCFKEFBdDAAACEAFFEHhAAASDFHBGCDNEIADGHBhABAbFGD.aEEH.fHDB...hADA......hBIA...,2,-2,1,3
dPWOCfIGSRMXZVegNLFbUJHEcQATaKDYB,aAAADAAAdADA..OACDCAFAGAGARAEA.ZBBBeAHH.LDEBhAEAFCFHUFAAHECD.EEHBAAIBKDDBhAFABFAA...fGFAhAFAMDIB..XFFA..hBAA......hBBA...,1,-12,-34,22
JWAYVBMSeLDFXGKfHNQUZCRdcOPabIETg,BAAAeAAALAEAFACAGAEAHBCA.QCFAZAGBRCBAdEED.OBHDhAAA.aDEHEDHFTFAAhABAJFHBAAGB.MFGB.DFHBhAFA............hAGA......hAIA...,2,-38,-5,33
CABMbcOQLNGYaEXZRKDJPISfeUWgHTVFd,MAAAOAAALAEAGADAEAFARBBA..DAIBJAHB..SCEAhAFAeBBBUDGBHCGBFFAAADBBbEEDhAGAQFDA.hBAAaFGDZFCB.KGGC........hBBA......hBCA...,2,-12,-10,2
EKMYZTDJLeNIAPRCOBFWUgSVGfXHdQcab,RAAABAAAFADA.UACA..SAFHGAEBHCDCdAHA.aCBHECCAMCHBhAAAZDEADDFA..eEEBhAFAAAAAOEHD..gGFHhAHAXFFD........hAIA......hBCA...,2,-30,-22,8
YGRQNSbAKeUFDMcdVTXJfHgBLWZEPCOIa,eAAADAAAdADA..TADAJAFA.HAFBLBBBEAHB..OCCBhAAAaBFCGDDARDEBQDGAhABA.bFAAACIBFDGBMIAAhAFAXFGABGGA.PHFC....hAIA......hBAA...,1,15,-34,49
EMWeJRNLAObSGCDFVYPfUaHcQdXIZTKBg,SAAAGAAAFADA...VADA..fAGAHAGBdCCAZDABhAAATCDABDFA.EDHFeAHHhAAAREDBAAIBCFFBDDCB.PDFDhACAaFHD.QFCAXGAA.KFHB.MIDAhAGA......hBAA...,1,-2,-16,14
NKLUdbRWcfFQDPXagOETMeJIAVYSHZBCG,SAAAHAAAZADBGAFALADAdBHARDAA..fAHAQEEChAAAXCCAaEHB.ECFBhAAAeFBAAAEABCHAKGGDWFHHhACADEFBOEGD.MEIBIHAACGCA..hADA......hAHA...,2,-17,0,17
OBFINcPaegACbKUEfdYHZGTJRXDLWVMQS,KAAAEAAAdADAHACBGAFARAEALAHB.MCABQCBC.BAHAhAAAFCFDIEDAhAAAPCHDeDEBAEHACFAA.UFAAZFFAJHCAhACADFDBSFHD.....hAEA......hAFA...,2,-15,-6,9
eQBdCJOESYDXUHcLANbIWFMfTRVPKGagZ,..IAAAMAAARACAKAFCGACAZBEE.BAEAdDDD.OAFD.EAHBDAIBhBAAHCABABBB...bCGDhACAfDGA.hAEATFGAaEDDeFEHQGDASGGA.hCAA......hCCA...,1,0,-36,36
YKVOMfQJBaICGDLNFcEbXZHUeSRgdTWPA,KAAAMAAAQACCBADA..aAEDGAEALAGBFAGAECGAZBBFHDDBhAIAeDDBREAAdEHA.TGBAhBAAADIBOEHB.fFFAhAAACFGCDBIB.cGBBXGED..SGHHhAEA..hBGA...,2,-12,-12,0
fJQZTcMBAaUDRNHdEWFGIegbYKXOVLSPC,aAAARAAAHADB.EAFAGACA.eAEA..bBGDXBFALDAAhAAACDFAQEAAhAEAZEEAMAIBACCBDFAAdEHAFEDDIGCAhABAKFFBSBBDfGGE.cGDDBHFDNIABhAFA......hAIA...,2,-8,8,16
TXdBgKYQcPDGbeWJIVFCMOfZSaRNEULAH,HAAAdAAAKADAQADCDAFA.eAFEJAHB.FBFD.MCABZABBRCEBECCB.hBAAACHABDGA...hBGAgEDAPDCDGEGAhCDAbFGB...VGDA.....hAAA......hACA...,1,-9,-26,17
KDEGadAbUCLVBQcPYTOMfHIXRJSNFWgZe,CAAALAAABACA.QAEA..PAEATAGA.MCAAhABAHBCCRCDB.SAHHhAAAFCHDZDFFeEAAECABdDDDAEAA.hACAbCFD.UGGAYFFFfDHEIHHAhAEANHBB......hAIA...,2,-15,-5,10
ZXTRDKPLSQbEFVGBafNWeOJHdYCgAMUcI,MAAAUAAAZADARACA.KAGCLAFB.QCCBEBHFGCBBaAHB.hAEA...fDFAhAFAeBHHHEEAdECDCFCAABBBXEGAhBAATGGASGEDFGGBBHEA...hBCA......hCEA...,1,-5,-18,13
gadQZebLKENOAcTXCPSBUGJVRDMfFHYWI,TAAACAAABACAGADA..RACFMAEAHAFA..ICAAdBFAeAHFhAAALCHBECABACEAXDEChACASCCDUFFADDFAhAAA.FEFB..WDHHaFAAQGGAhACA.KHAANICB....hAFA...,1,-8,-13,5
NgSKFVMLZCDHRQPIGAabYeTcEWJXdBOfU,aAAAeAAA.EADA..XACDdAGAOBEDUAFA..SBHHhAAAFCHDMBBBZDDAHCCBREAAQFDAhAEAGEFAACCBbGBATFGAhAIA..WFHBfHBB..hBAA......hBEA...,2,-14,-2,12
dVQBZNYcMePCIDObaFfTGXAKSRgHLWJUE,RAAAHAAALADBUADAEAFAdAFABAHAZBGB......NCAAMCCBhAAAeCCDCCGA.OCHDFDDAGGCBhACAAAAAKEEA.SFFAhAIAJFBB..QFGD...hCGAcGECDCIB...hDBA...,2,-27,-8,19
BDNgJMXKVQaZUPbfIYCLcFTSeOHGAdWRE,RAAAEAAADADA..JACBMAGB..KAEA.QAGCZBDBUDFB...hAAA..bCECfAHAhABACDHALEAATFCAhAHAeEFBHFCCACCAdFGDBHHANIAB......hCAA......hCFA...,2,-28,-10,18
fgdOUNbLQaTJGIXESFRKWCZYHADcPMeBV,DAAAMAAAeABABADA....VAEAdAFAOAHBUCCALAHBhBAAQBBC.aCECGDFAhCAAEDDBREGB.CEHBHFDB.hAIAADFBfHGFbFBBJFEBSGGD..hBAA......hBFA...,1,-8,-16,8
LHSVPbceNEYgdGaQFUZKMTJDBAXfRICOW,RAAAOAAAHADB..SAFAVADA....bAGBeAHH.ECCBhAAAdCCAaCFDQDFChBAAZDAFMDIBTFDABEDAABBBfEHAhBIACFFBLHFAcGACgGCA.hABAFGGH.....hADA...,1,2,-10,12
JfYDIMANKZOSaERLeVFWCHgBPUQTXbdcG,ZAAAaAAALADAeACEFAFAHCCCBAHA..QCCATCGA.dCFAGEFAhABAJCHB.DAIBAAEAOBBBhAHARFCBCFEC...gFDAhBAA.XGFA...hCAA......hCBA...,1,-15,-17,2
YFIAEfCNdUXeWQcJaMTOPHKBSZLGgbVDR,EAAACAAAdACAUADA..eAEAQAFA..aAHDMAIBOCBBhAAAHCBASCEAhAEAGDEAbDGDRDFAFDDHABCA.XFAAhAFAcGDC...TFGABHBA.LHBAhBCA.DFFBIHHAhAAA..,1,2,-15,17
BVJNYRWMcfZbHSEFXGPgKOAdCQeTaUDIL,dAAAeAAAaADADAEA.LAHBBAGA..VBDBJBCB..RBEA..MDEBhAAAZCFBHCBB.ECHFGDFAhABAKEHBAAIB.TFBAhBEAIGAANEIA....YHBGfFEEhACA.FGGB....hAGA...,2,-23,-8,15
NIZeLKYcWdVgCGbQATSOXERMUJFafPBDH,TAAAXAAA.RADA.MACA..FAGAaAEEBCDDHAGBZCEBLCCAhAAAKCGA...cDBChAIAdDAACEGAGGEBADGBEDHFfEEAhBDADEIB.eFGB.....hAAA......hABA...,1,4,-31,35
NVESbDAPGRgfOYIFXHUBaKWCJQLcTZdMe,RAAAOAAAFADAHAFBBADAKAHB..CAFALAHBZCCAdDHA..eECBEBBBDCEAhAFAAAAAGEFA..hAHAfDCA.hCAAXDFCWEED.QFGA.MEEBhBAA.SGDDhBHA..,1,-20,-24,4
XZMWObHLRYSPJFQANdUgVacDKGTCfIBEe,dAAAVAAAaADA..KADCGAFA..TAFACAHABBDA..EBHFeCBFhACAZCDA.MCIBODHDhAAAHDDBRECA.SDGHhAHAFFGHAAHA.gGGAfHEB....hCAA......hCEA...,1,-10,-21,11
WOeAYfTdQZgPNRcJMBLaXDGUCKVbSIHEF,TAAAZAAA..PADARACF..MAEAaAGD.GBEA.KAHBbCABhABAHCGB.ECABOBHDhACAABGBdECAQFGBhAAA.NEEA.BCDA.LDFB.DEEBhAIA.CEHDSFCBhBGA.FGHB,1,-3,-15,12
ITeXUKGDESabWRcQfPVNMgCYHZJFdOABL,LAAAeAAAKADAGAFAEAEA..aAGDRCCAQEEC..hAAAfCAAVFAAMAIBhABACCCAHCEAFDHH.AAIBTEAAhABADGGASHAGbECBPEFC.NICBgGGBhACA...hAFA...,1,2,-11,13
LSfdFGIMZODKabWeAgCcJUBYPXQVHRENT,CAAAUAAABACA..XADAHADBEAFA.LBHBdAGAGCBBZCAAKCFAhAAAaBHD...eEEBAADAJDFBhAIAQFAAREGF.hBAATGGAFECHMEEBDEGB.gGBGPHCC.hACASGHH.hAFA...,2,-9,-7,2
GSXeTMLRbOYZdUIVfaQPHgBDcKFWCNJEA,GAAAeAAAMAEARADAOAGDdBDA..UBFA..fCDEhAAAaAHDHEEADCCBFCFHCDHA.EEABAAAATFCAhCAALFFAZGEEQGABhACA.BHFA.....hCBA......hCDA...,1,-6,-17,11
ETISfeXYRBZNVLQbMAHGWdgDKCPFOUJac,HAAAdAAAKADAFADAUAFAaAFD....EAHBSBHBeCAA.RCAA.ZCEAhAAALDEAbDDC.ADFAGECAhACADDIBOFFBJEHB.hADAIGHA.fHCBBFFA..hACA......hAIA...,1,-11,-24,13
QCJcfFXEUTLNagRHIMGWbBKdZAYSVPeDO,SAAAeAAAQADACADA...fAFFEAFALBHBaAHDHCCAhAAAGCCABCGDZCFBAAAAhADAPDHDOFABFEEATFGAhAFAgGGBRFDFMFCBKHBA.....hAIA......hCAA...,2,-9,5,14
RPDXLBGJWNUOCbedacZYSKQIFEHVATgMf,MAAARAAADADALAGBGACB..JAHBUCCACBBD.dBEAZCDA..KDHBQEEChAFAFEFB.HFCBhAGAAAAA.TGGA.hAIAfHABBFHDOGBA.aGGC...hAHA......hBAA...,1,-14,-36,22
UTVeZQKIOSNfMgBcHEYGCdPJaFRbXLWDA,TAAAeAAAZADB.QAFAOACA..SAFAMAIBBBCAHCCAhAAAECFBGDGAdCFAaAHDRDGFhAGAbEEDXECA.hAAADDBBAEEBKHBAfFFE.YFHBhBDA......hCAA...,2,-7,-7,0
MPgUIGCNYLEDRcZJHfBSKdXVTeAWFQabO,QAAAaAAA.MADAPADA.UBBBGAGA.CBDALBFDhAAARAGBZCDBHCFBSDBAhAIAdFFD.TEDAhBCAAAIBFGHD.bFGB.OGDE.NIBBDGIB...hBAA......hCAA...,1,9,-21,30
daQcBgURLPSGACWNTYfbZJXKOIDMeFEHV,CAAATAAA....bACAZACB.KAEADACAeAGHHAGBdCEAQCCAhAAABCADRDGBLFFBhAAAGDFAAAGB.NDIA.fEDEhACAOFDBFHECEGAA........hAGA......hAIA...,1,-10,-14,4
YZGEeDTOXAJSVRaPbQWgHMNdfFBUcICLK,SAAARAAA..bADBQADAHAFAdCCABCFDIAGALCHBhAAAZCCAEBHFeDGFTDAAhAAAAAHAaEEB..gDGAhABAMFFBFGHB.CEEDGFBB.XGGAhADA.....hABA...,1,7,-11,18
VOJBGMFQAbaIUfKPHEXgRYdZTcCSLNeDW,aAAAUAAA.KADAHACB.EAEARAFFZCBE..TAGACAHB.LCFAhAEAeCGH.DBBBODAHhADAGEDAFDEDAEDBbFFB.fFHAhAIAXFGAdHFBSGCD..hBAA......hCAA...,1,-2,-28,26
DXAfSaWUJRQNBMLedTPKCIVOEGFHbZYgc,aAAAUAAA.RADABAGBeACHdAEA.KAGACBHA...OCEEECDB.HEBAhAGAZCEB.....gDGAhAIAXDAAAADASDDGhBAAQDGAMBBBTGDAIGGAhBEAFFGH.YHCADGIB.hAIAWFHH.,2,-24,-24,0
XGMUKPLecWZBHNVCEbYDIAaSJQTgRdFOf,aAAAQAAA.RACAdAFAfADAGBGAMCEBKAFALAHBhADA.eBBBZDAAHFDChAAACCFAEDDBDEGAAAHASEHHhADA..TFAA.OFCD.XFEAhAFA.PFHBhBAABHHANIBB.,1,-6,-9,3
SCPUVMWXDTFIKGNfadEHeYcZBQJAObgLR,OAAALAAARADA.CAEAUAGA..MAHBDCAA.TCCAKCDA.GCEAhAEA..aDCCHEGBhAGAeDFAZGCAQEAChABAAAIB.SEGAWBBD.FFCD.fFFEhACA.EHGA.hBAA...,1,-17,-20,3
dbVAKHgOYIZecQREaJFBfDMCXTPUGSLWN,HAAAOAAAZADB.eAFARADAEAGEFBHD.BCADMBBB..CCCC...TCCAhAEAGCEALCFAhAIAdEHAACGBKGAAgEEAhBAA.IEHAaGFD.DGCB.XGGAhCAA.....hAAA...,2,-24,-4,20
HWabXVOfCDTMEgPGFSReZdULIANBJYcKQ,BAAAJAAA.KACAHADB.aAFAXAEB..fBFBhADADAHBECAAGBFARDDAeBHHdCDALFFAhAIAAAIB.cGDAhBAAbEGD.CCCD.MCIB.FFEB.....hCAA......hCBA...,2,-25,-14,11
EHaQZJNIbMCKUGBeRVSFgTDYcdPAXfLOW,LAAAEAAAHACAZAFBJAEA.....bBGDMAIBKCCD.GBCBBDEDREABhAAAFCABDAIBdDDD.ACHBODFDhABAaFCA..QFFAhAEACEHAeHAA.SHGA..YHEAhACA...hAFA...,2,-18,-13,5
gAdfeKZPBQTUFYLSWINHOJbMDaCGcVXRE,eAAAZAAAQAEAFADDLAFA..SAGA.ICAAhABAHCDCbCGBDCCBGEFAhAAAXCFAEGAAAAGAdDDAKEEDhABATEAAYCCFODHDaFHD.CFEARGEA.fHABhACA...hCAA...,2,-5,-3,2
MeFUfCGZaPNEILADHKWTVXcSYRdgJOBQb,HAAATAAAXADB..SACBRAFAdCADOCECbADDeAFAhAAAFDCDCCHBZEEAaBGE..EDFAAEGAKGAAhAAAVEGB..gGGAhACAQFAAMIAAfEEE.NIDBDCCBhAFA.....hAGA...,2,-8,11,19
LFcXEZIBfeDdKaAUYQRSTJCHbVPONgGMW,QAAARAAA.SACATAEAHAGB.VCCAOAEDGDAAhAAAMAGBLEFAhABAXCGDEGDAZDAABDGDeAHBhAAAdGGAACDBUFEA.CGGBNIAB...WHFA.hADA......hAEA...,1,1,-3,4
HADBNJbRMVfOedZcQTGYXSKCUPLEaWIFg,BAAAJAAA.RACA.MADAOAFAZAEE...QBFDGCCA..SAHHhBAACCAALDDAECFBhCAAaCHDFDHBHFFAACCBDEFBbECChAAAeFHF..dHFD..cGCC..hCBA......hCGA...,1,-10,-23,13
eEcWLKIJbXMfDHYVRAGdQUFOSgPCZTNBa,dAAAQAAAOADA.SACACAGA.ZAEBTBDABAGAEBHFLCGBhACAKDAA..bCFDMAIBhBAAHDCBRCBBADFA.GEEAhBCAFFHDPHECeEHH........hAAA......hADA...,2,-11,-10,1
PMaZCNEVfTLJIDBRgGFUWQKcAYbSOdXHe,SAAAdAAAHADAeAFEMADAZABB..EAGATCEALBDB.DBFBhAAARCGFGDCAFBHDUEFAQFFChAIAACCAOEHFaGCAhABACHHANICB............hCAA......hCBA...,2,-23,5,28
XFWGaOLPCRVNSHbgMJZYAfecKUEdBQIDT,eAAAKAAAEACEdAEA.QAGADAEA.FBCDaAFELDEARCCA.SDHHhAAAHCFBMAIBZEBAhABAACCAUFCATFFAXFFAhAAAGGABCHHA..NEIA.......hCAA......hCBA...,1,4,-24,28
cCfGPXNYUdBWOAeZVDEFSMJKLTRQaHbgI,eAAAZAAAEADEMAEALAFBRBCA.HCAA..bAFAIAHA.hAAACCECGCGAXCEAUFEAhABAdDBAOCHBACIBDFIB.hACASEEB.TGFA.aEHD.hCAA......hCCA...,1,-7,-10,3
cOLREHbFBNYTaWAKfZCPQGSdDIMVXgUeJ,ZAAAQAAAdAEAMAGB..XACAeAHBOCABEAFAHBFC.bCDChAAABCCD.TDEAhABAAAIBCDAAGEEADCHB.gDGAhADAcEBA.RFAAFGHBaEGEKGGA....hACA......hADA...,2,-24,20,44
KTGdUJEHMDOCAFfSQYNXgBZVLRWIbaecP,SAAAQAAA..XACAZACBRAEA..ICGAeAFAKBHBdDEAhAAAECDBHECBMCFBCAHBACIBfCGEhAAA.gDAAhADALEHBaFABTFGAUGFAOFAEhAFA.FGEB....hAGA...,2,-8,-4,4
EFbORcHQJVWZNGUdATDPBaXLKSgYfMeCI,TAAABAAAaACA.LAFASACB....fBCAhAAAeAEAEAHFbCCARCEAHECAQCGBhAAAVEGBZGAAGEAAhAEAACBBXGECKECAMEGB.FEHD....hAFA......hCAA...,1,1,-4,5
cfAagODUIbCJGSdNYPETZeRLWXBKVFQMH,aAAADAAAUADA..CADAGAEAdAGA....PBBBEAGAeBBBhADARDDA.LCHBBCHAFEGDhAIAHDCB.ADHBOEGHhAGAIFBASGDA.NIBB.ZGBE.KGHBhBAA.MFFB...hBAA...,1,-13,-28,15
DfCGOUVReSdFLEgaKZQcPXYJMBAbWIHNT,..IAAAHAAATAEADACA.GAGAUAFARBCBeCAA.dDDAECBBaDGHhAAAZCFEQEAAhACA.XFDAMEBBAAIBbEEAhBCAfGAE.OEHDFGEAKHBAcGGChADA.....hBEA...,2,-25,21,46
MKOBPGNEdLHQYRDTaXbJcSIegWfUZAFCV,CAAAMAAABACAGACB.EAGEHADB.RAFAaCAAXBBC.JCEBSCFAhAAA.eCHHhACAfCGAAAFAKDDDOEFBhAIAdEHALFAADFIB.bFFBgGGDhDAAZGCE.....hAFA...,2,-16,-9,7
LdGcPZEWMVgfbDaXJAQKCYONFHIeTRSBU,QAAACAAA.OACCHACAeAEE.RCAABAHBdAFAGBGAhAAAZCEAEEEAMCDB.fCEEhAEAaCGAACAAKEHBFFCBTFFAhAHAUGFA..cGEC.....hAAA......hACA...,1,-11,-17,6
fWXdBVNRSYAQDagMJKUFTPHeZGEOILCcb,aAAAMAAA.KADAFADAHAFBGAFA..EAHBLAHBCBBA.bBBCXCDChAFA.dDHABDBAhBAARECAAEGADFGBgDDAhBDA.TEGA.eFFBIHHAfHBBhBHANIAB....hCAA...,1,-13,-20,7
ZfJTUGgNMLBYROVFXKWcbASQHeDCdIPEa,HAAAeAAAdAEAEADEZAFB..TAGAGCABMBDBLBHBBCFARDFAFECDhAAAKEBAbEEB..AAAAQFFBhAGACFAAaGFD..hAIAfHCB.......hBEA......hCAA...,1,4,-27,31
GRMLPVEQHKWfUeSJgYCZcAFaOdDbNITBX,aAAAdAAADADA....bACDTAFA.GBDARAEAMAIBLAHBhACAECFAHDFCKCBBUEAAeDFFhBAASECAJEGB.hBCACBBDAFFAOFCBBFHAXGGC.PHAAhAEAWEHH.....hBDA...,1,3,-22,25
UMECJYfKFQAacgHWBXPVRSbZNeOTdIDGL,aAAAHAAABADAXADB.RAFAZCAAeAEHdCFDGAGALEEAEBBBCDAAJFHBhAAAKDCA..ACCA...hACAgDFDPGAASGEAhAGAbFFA.NIAB.TGAA.DIDA.hAIA......hCIA...,2,-13,-1,12
SVNYKLdeAfXIWMFJgGHUbacPCEBDOZRQT,XAAAMAAAFADDGAFAHADAUAGA..aAHFCCDDDCFBZBBF..RDDF.TDAAhAAA..SDGHhAFAVDGBKEEDeFAAhABAADIBfFBA.IGGAgGDAPHBChBAAEGGB.....hADA...,1,-11,-15,4
MKEDGCQRITWbNeaBZFHXPAOUgVSYLfcdJ,OAAAVAAA.LAEAdADAKAFA.EBBBGCDBRCEA....TDCAhAFAbEEA.eCHHZFAAHGEAhAAAAAIBSBDG.hAFAfEFAMAIBCHAA.QGAANEIAaHCC.hAHAXGGA.PHCAhAGA.,2,-15,3,18
PaCUKgbFAYMDEZRSIOeGLVNfBHTWcXQJd,MAAAEAAARACA...OACEeAFEGBEBLAFB..VDAABAHAHDDBhAAATCCAXDGAhADAdCHAaECCKFGAFEEAAGFBDIAAZFGBSHAAhAHAfHDB.WHDC....hBAA......hBBA...,2,-20,7,27
SXCfRIaQgAeJBWEDcGdVLKFYPZNHMbOUT,eAAABAAAEACAGADAdAFALAHBFAFAZCFBHDBB.MAIBOBDDSDHDhAAACCAARDEF.aFDDABHBDCCBhAAAKGGA...PEGDhACANIEB...bFBB.....TGDAhBFA.....hABA...,1,-10,-16,6
OKZeDAbJWUVSPFgNRTdXICLYMHGaQfcBE,JAAAVAAA..FADARADF..dAFACAGA.LAHBHCCAGCFA.QECBhAGABDAAEDDBZDFAAAIB.hBAAUFFASCHBhCAA..gGDDXFGDMFFBaHBC..hCBA......hCCA...,2,-20,-13,7
BRaHGQYdcKFZUIVEAMDgfTXNJbPWSeLCO,MAAADAAA..TACAXACA..bAEBSAFA.eAHHhAFALAHBBBBDHCDChAGAGCDAdEEDFBBHZEGBIBGAhBAAADCBfGCAPDGBWFHHOEHD.hBAAaFFH.....hCAA...,2,-16,-10,6
cRdHgLKFXNPaVYWISJUCOEeMbTfQABDZG,ZAAARAAAHADBLADBFAFA...XAFAaAHD..VCFBICAAhABASCCDCCFA.EDABhAAAeBHHMDIBbEEBTFBAhABAAAFADCCBdFCAKEEDPFGDYEHB....hACA......hAIA...,2,-18,3,21
NTUBOWQPGSdfKLEYcaVIgMCDJXFbAZReH,RAAAHAAAUADAOACA.QAFAGAGAdDDALBHBEEGB.aCCAhAAAIFBAMCFBDDDBFFEDhAAAADGAeEEDBAFASCCDhABAKGGA.....cGGC.hAIA......hCAA...,2,-20,-12,8
TVWbFHGLRQeOdJXBaAcIZPEMKCfDUNgSY,ZAAAEAAAKACADACAUAFA..SAEB..TCDAVAGBFCCAhAAAHDFARDEA.eCCDdFDABFGAhAGAAAIB..IFBAhABAMDIBfGFE.NIAB.gFFAhBEA.YHBAhBFA..,1,-21,-23,2
cOMNSWLGCVIJeYfDTbRUHZXgPKaBAEQdF,EAAAdAAAOADA..MADASAGAGAGACBCA.JBEBeBDBDCBB.hAAARCAAHCFAZEBB.XEBAhACAKDFBAAIBFEHD..cEFChAHA.LEHBIHHAfHCBhBAA.....hBCA...,2,-34,3,37
QGFIBWAVSCabMDJXdHNOfPRgLcZUYEeTK,CAAAaAAADACA..dADAHADCOAFARAGF..LCBAZBEBEBBB.KDEAGCGAhBAABDHA.ABIB..SDBAhBDAMFFA.XFFDhCAAfGAA.gGDAcGCA.UGGAhAAA.....hCGA...,2,-23,-23,0
eObIJCVFZDgHXdKRWcTPQGfANYaMUSBLE,aAAAMAAABADALAEA.EBBAeAEH.OAGBICDA.CBHAZCEBhAFAHCCB.dAHARDGBTGAAhAGAGDAAABBB.UEFAhADAbGDA.FFDDDGDAKGHB.WHDA.....hAIA......hBAA...,1,-7,-14,7
aXdVDgYcITHGCANBPZWSfLbOUKReFMQEJ,BAAAZAAASACELACAOAFDRAEF.eAHBMAHB.ECCBaCCAdDGDhABADCHB....gEDAhAGAIDAAHDDChAAAAAIBPFGBbFGB.FGCHXEAA...hCAA......hCBA...,1,-15,-17,2
WBKCbFfZHUIGASEDPTXMRLdeQJONcgYaV,EAAATAAARACA..eAFEQACC.OAEAgBEA.hAAAaCCHBAHA.bBEDZCGBhAAAHCGDGDAAACEBDDDBMDIBhADAdFFAcGCAVFEBCDFAfHGFSHGA.hCAA......hCGA...,1,8,-13,21
YeJgIcOKDSFBVCTEdZNWaQGAPMHRXfUbL,HAAARAAAUADALADB.eAFAIAGAKBHBFCAHBBHACCCC.ECCBZCEBhAAA.aDGBAAAA..MCGBhAIAXEGD.bFAAgEDAhBFA.DDHB.TGGANIEB..hCAA......hDAA...,1,-1,-37,36
GcDQZFJgINYVMPBWCbaRAUKOLXTdSefHE,OAAATAAA.dAEAeACEHAGBGAFADBBBZCCAFAHF...JBDFIEBAhAGA..VEGBhAAAMDGBBDHBCDHA.RFAAACCBLFHBhAIAfFDBEEEBQGBA.hAFA......hCAA...,1,-10,-14,4
bHUDGFgMBLEZeSIRcYafOdCVTKPXQWNJA,HAAAGAAAMACAEADAeAFARAEA..aAHDdCDACCCA.TCFAKCED.QEFBhAAAJCGF.ABIBbFCBhACAFEFHLHAA.hADASEHHIGAAfFHA.hAAA......hAHA...,2,-24,5,29
SDCFEPbgQZRJAGMLKfIBUeHdYXNOcTWaV,GAAAMAAALAEAKADABAFBHBBAdAHA.XBGAOCDA...TCEAhAFAaDAH.DDBBEDDBbDGDhAGAZDFB.AAAB...fDDEhAIAeDHF.cGEASFHHCHHA.hBAAFHBA.....hBBA...,2,-18,-11,7
ZCQLBbTWHKIJPdEVeMNUSgFfGAOYacRDX,aAAARAAAZADBLADABAFA....TBGAHAGBKBBD.ICDAhAEAdCCCECFBeDABMCFBSDGAhAFAFDHDAAAA.OEEHhAIADEEBQFFCbGFA.PHAANIBB.hBAA......hBIA...,1,-11,-13,2
TDBUcdAFZCHJeRaLEbKgYGSWNVOfPMQIX,ZAAAHAAARAEALAHBEADEKAFCGBGA.SCAAVCAA.OCEBhAAAMACAQCFAhABA.TECABDCAdFCAhACAAEEACEHAeFFBbFEDgGGB...hCAA......hCEA...,2,-13,-1,12
SXBCGWLeQIcMdDKETUVYNJAHfOZFaPRgb,HAAAZAAAaACARADF..SAFBCAFA.GBGAeAGHQCCBhABAMCABdDDDEEFFTDGA.hAAAVEEBYEHB.hAFAAAHAFFCAbFCDBGHA..WDAH...hAIA......hBIA...,1,2,-16,18
fFDGOKVTBLaZNbCRQHIEgYWUJeMXdScAP,FAAAGAAAKADABAFBZADACAGBHCDA..EAHB....gCGHhAAAUCCAeCFBdEADACGADDAAhADATFCA.aEFCREGF.QGGAhACA..IFEA.YHDAhAIAMIAA.SGHHhBAA,2,-38,-11,27
gPOYbLBdHCVIQKNGTfEDeAMXFaWScZJUR,MAAAaAAA...SACAZACBRAEAOAHDLAFAHCEC.CBBDQCDAhAGAGECAEEEBABBBFCFEJEHBhAFAUEGA..PHEChAHAbGFCdHAB.KDCD........hAHA......hBAA...,2,-15,-4,11
NYLBadceVJQCAIWFGSRDKHOUZPfTgXMEb,FAAARAAAHADBZACB...TAFAMAFA..EBEA..bCFALBHBhBAABAHBdDAAeCEAQEEAhAAAAEBAGEBBKCCDOEGBhBEAfEHE.XFAAaFHDJHDA.CGHDSHCAhABA...hCAA...,2,-13,6,19
CSAXaEUGbWOPHVgZMNFTIYRLKdeQJcfBD,EAAAGAAA.OADAHACAZAFBMAHBTDDARCDALECAeAHFQEAAhAAAJDHB.BCCDhAEASFGDACIBaEGAbFCDPGBAhAAAVFFA.FGED........hACA......hAIA...,1,15,-16,31
NUePTHMAdbYRJOBcGXKQLgSWDFIZVECaf,dAAARAAABADBGADAKAFA.LAFA.SCAAFBHDZCCAEDGBaCFD.hAAA.UECAeCHBHFABhABAAAGAJEGB..OEHDhAFAQFDADFFB.CHHANICB.......hAHA......hAIA...,1,-9,-25,16
cYVHdgFRUQISNKBCfJTOXALZGaMDeEPWb,GAAAaAAA.eADAEADA.....bAGDVAFAHCDBdCCAREAAQEGAhAAASBBDBCFDhADAfFFETDGAAADAZGBEhACAMEEBDAIB..cFFA.....hBAA......hBCA...,1,4,-24,28
THRLBceXbYQGJCKUDAFdIgWVSfNZEOaMP,dAAA..gAAASADAZADAEAGAaAFAMBIBHCCALCCAhACABBHAeDFAXCFDQEAAhAAAGDAAKEEDAADAFECAhAGAIFGAfFFAOFCDPHCC..hBAA......hBCA...,2,-7,0,7
TOfZHLDecGSARXVUIWEaFBPYQNMdgCJbK,RAAAXAAAUADA..EAFAaADA..BAHAQAGAdCGA.CBDAKCEAhAAATDDAZDBAHDFC.hAAAeFFBGFDBAFIBIGAAhABAFGHDNCCA.MIBA.JGCA.....hABA......hCAA...,2,-27,3,30
VKLaWPEIeHOcUdNABXZRSJQCTFfYMGDbg,ZAAARAAAQADCFADA..MAGBGAFADAHB.VDDBLCAB.hAAAaBHDEAHB.HDGBOCCBhABAdFAAACCBBDEASGGAhABATEFA..bECD...KFHB.PHEChACA.....hAFA...,2,-15,-5,10
WfYOVXAgaLTJPQcDGEdCMNHSUKRBFebIZ,aAAATAAA..QADAGACAEAEAdAGAMAHBHCCA.KBBDRCEBeCABhAAAZDFB..fDAEhADAOCHDAAIBLFGBhACAPDHDCEEASFBAFGBAWEADXGDD.hAIA......hBAA...,2,-12,11,23
bQHIYFcCMULRPBAJOWSXGdZNKVefgTDEa,OAAAXAAAZADBKADA..eAFA..TAGAEBBBQCFAhAGAHCDAFCHDMDABREEBABDBSBHHhBAAdEFAfDCEhAAAaEGE.bFADIFCA.CGHA.LFHBhABABHGD.GGCB..hADA...,2,-6,3,9
TCeLPMYHGIDdXaEbgSWUOKQcRJBVFNAfZ,ZAAAeAAAMACAHADAGAEBdAGAECCB..SCCAOBHDQCEDhAAARCEFBCHAFEGAAEFBTEGAhABALGFA..IFAAhAFAaHAA.gGGA....hAIA......hCAA...,2,-21,-4,17
MUaEeJOPgHWKCSNYVXQITFRcfDLBAGbZd,ZAAAdAAAaADAEADE..eAFEOAFDHBEC.CCAA.SAHB..hACAVDDAQCBAhBAATEGAFGGHRCGFDBEBACCBMIAAhABAPEEBKCHB..XGFA.fHBBhBCA....hBDA...,1,-5,-24,19
HMFgNKcEZdOJafTUDSGCLXeRBWIVQYPAb,HAAAMAAAFADDKADCEAFAZAEB...dBHAOAGDaCAC.UDGBGCCALBBBhAIARCFBBEHA.IFEAhAAAQFEC.ABIB.hBAAgGGAJGBEDDDBCGHA.eFCD....hACA......hAIA...,1,-8,-18,10
GKSUFYdBIPRfeWDOVNgQEHbMJTLaCcZXA,GAAASAAAFADAdAGABADARCDA...eAEHOBHD..gAGAhAAAHDBBMEFBTDAAhABAaEGBZGBAAAGA..KCCBIGHAhAAAfCHADIAA.QEEA.hACAEEHF.bGDCCHFA...hAIA...,1,-8,-10,2
DNaSfObWdAReCHFLUIVZPKcJMXBTQEYgG,RAAAHAAALADBVAEAZCAAKAFA...MAIBTCFAECEB..GCGAhAAAaAHD.OEABdCCCAAAAeDHFhAFAFEEHIHHA.hAHAPHACXEECBGDDQGGBDGGB.hACAfFCA.hADA...,2,-13,6,19
SCVQFfOcZgPLJKeWdUNHRDYbGXMIAEBaT,EAAAaAAA...CACAFAEAOACD.ZAEALAHBeBBD.dCCAHCFARCFBDBEBhAAAGECA.MAFAhBAAABHBTFCAQEFBhBIA.fFHAgEED.KEHBNIEB...hCAA......hCEA...,2,-24,-3,21
TMdFJVfeGPaXOEIbWLRAYNcgUQSHDKBZC,...NAAA.gAAA.QADAHAFABBBAZAFBMBDBdBHAFCCBhAAAfBEEeDABaDEChABAECGAIEHALEEAhABAAFFAUGGAKEAATGEAJHCA.PHAA.XGGBhACA.WFAAhADA...,1,7,-21,28
IaAHGXJTFSOPdNKeYDcERBVgWQMUZLfCb,HAAAGAAATAEAOADAdAGAeAGFDACARCCABBHA...VCDBQDFAhAAAZDGBLFCAhAAAbFFAAAIBFHEASFHHhACA.NIAB.KEED.........hAIA......hBAA...,1,-8,-10,2
NbTPeDfOHXFQRaZcLgdBWUIMSGCAKJEYV,EAAAVAAA....bACAeADE.OAGDHAGBQCCAhAAARBDBZDFELFCBdDAABDFAUFGASGAAhAAAAAGBKDHBNFDBTGGAhADADAIB...........hAGA......hCAA...,1,-6,-15,9
BVRKbDgAcEaWLfJSZCMUGYHPOXQNeTFdI,EAAAaAAALADA..SACAZAGBMBBBGCCAHAEBXAGAhAAAeCFDdEHABCCARFABDFFBhAEAAAGAfCGAhADACGGD.PDEBNICB.TFGA.FGFH.KDHBhCAA......hCBA...,2,-17,-5,12
TGfCYFRAHJDIQUNSgMPZeBbVXcWOdEKaL,HAAADAAAQACASACE.MAFAeAEABBEAXBFAOBFDEBBBhAFAaBHBGDDA.CDGDRFGBhAIAACCAIDDA.hBAAgEFA.PFHD...hBIA......hCAA...,1,-15,-17,2
BeCMFAZVGXLNbPHDdYaQWfOJUKRSgEIcT,GAAALAAA..bADAHADB.dAFBaAHBQBGB.OCABhABAKCDARDEAEDCBTDEAhACAeDADMCCBAAABZFCAXEGAhAIADBIBfEHASDDDgGGAhACABGDAFGGB.....hADA...,2,-9,9,18
eKFOTSEZLcJHQgUBAdNGbWMVICXPYfaRD,GAAAMAAA.CADA.XACA..fAFARAFAeBBB.OAGDhAAAECFBZCGBLCDBhACAHDCBQFACBDGDAAIBbDEDhADAIGGAaDHD.FFEDTFAA.SGFAhAFA...hAFA...,2,-10,-8,2
UTPcaFVEONQLSKXGgDBeYIRCbdZMJWHAf,TAAAaAAA..EADAQACCLAGBKBBDGAEABBEAeAGBRDAAdDDAhADAZDDF.MAIBHEGBADGBfEAAhAAAPFEDFGBA.hAIAOEHB.XGFDDBIB.CHAA...hAEA......hAHA...,1,-3,-8,5
EXIZMbgQTRcCOdaJVLAHDGfKBUYWFPeSN,HAAAGAAABADBUADAFAFAeAFAEBEF.ZCDEMAIB..QDGAhAAARCAAOCFD.aDBDLEHBhAAAABIBKEEA...PEEBhACAXGAA.gGGACGGCdHDD...hCAA......hCDA...,2,-10,-8,2
WAMEHVPeDLcUIOZCGbagYdBXRNJKFSQfT,HAAAeAAALAEAUADAZAFBGCABaAHD.dBHARBCBKCECQEEAhAAA..TDFAAEHAEFBADFHBhACAODHDCHCA.bFAA.hAIABEED.XGGC.FHDESGHHhBFA....hCAA...,2,-8,-4,4
AeDaFLYZcEOSKWUNCQJXPIMbfRgHVGTdB,eAAAaAAALADAZADBEAFA.KAHB..UCFAQCCA.XCEAhAEAMAIBRDBBHFDA.hAFA.GDGAdFHAAAAAFHBAhBDAOBBBSHGGCFCAIFEA.fHABhAHA....hBAA...,1,-7,-21,14
OUPRKSfbTVAZYeQCIgXEJHFDdBMNLcaGW,eAAAQAAACADA...XACAHAEBdAGBMAFALCCBGBEAhAAAOBGDRBGBSCDDhADAbEDDAAAAZFFAgEGAhBGA.EGEBDCIBBGHAaHFE......hBIA......hCAA...,2,-12,-4,8
IMgNYBPWEOcDFKfVZCHGAXQJSebURTadL,QAAAeAAARADA.dADAMAHB..gAFABCCAECEADAIBKBHBZDBAhAAAHDECAAFA..SDDEhAIAbEAAUFFBaGAALDGBhBCA.IGEANDIA.....hAAA......hABA...,2,-14,-14,0
XgfBELSAYINZGRHTJCedQDbaVcFKWPMUO,..IAAAGAAAHADA.TBGAeACAdAGAQCDBaBDEFCAAKCHBhACAMAFAUDDAXDFDhAAABDADEDGBADABZFEARFEADFIBhADA.....bGBCWEHB....hACA......hADA...,1,-7,-8,1
fZKDQHeFgNLECbWUcXVIBaMJYdOPGASRT,RAAAZAAAQADCHAEAeAHHFAFALCAB.ECCBbBFAUCEB..hABAXCCCBDHAaEFCMDFBhAAAdGAAOFHDADGA.hABASGGDTEGADEEB.CGGD.....hAIA......hCAA...,2,-20,1,21
YCdeRNgAJGcFIWETOPSKXaVHBbMZfDQLU,GAAAFAAAEADA.OADAKAFA...aAGDHCCAMAIBZCFB.QDAChADALCDBCCFDREGFAAHAIEGAhAAATFCA..SBHHhBAABEBAbFEDDGBA.dGGBNIEB.....hCAA......hCBA...,2,-10,-10,0
HPYbICSOaRTMQKgEdZXFWfeLVBNJDAcUG,GAAAHAAA..bADBSADA.RAFFMAIBQAFA.hAAAECABZCDFFCCBeCGHLBHBhAAABEADDDDBACFBPDFDhACACEHAaGGAKHAAdFHAfHDB...hACA......hADA...,2,-19,1,20
BNPEbQVLcdGReYZMTXCOgJfUIHKFAWSaD,aAAABAAA.EACAQADALAFAGBCBRAFAeBBBZCFEMCAB.CCGA.ODABhADA.JDDBfDDEhAAAHEGBAEGBDFFBbDFAdHCBhAGA..TFFA.XGAA.IHHAhACA.FFDH.hAIA...,2,-4,-1,3
JUVDKaSLXBcIFdgeObMYEANTCHfPGQWRZ,TAAAHAAAGADA.RAFAZCAAVADAKCGAaAGALEFA.BFAAhAAAFBGDeCAAMFDBAAFAfDDAhAAAQGEAUEFAhACASGHBXFDD.IHHA..hADA......hCAA...,2,-18,-1,17
YRUcNPICaJQfOdbBMLEVGFHKADWegSTXZ,eAAATAAAZADB.RAFA.UACA....PCFBaAEEQBGAhAAA.dDDAbCGDMCFBhAFAEBCFGGABHEGBAAHADDGBhCAASEED.XGGANICB...hCIA......hDAA...,1,-8,-13,5
dXfVZbaOPYMASFGCUNDIeHWKLTREBQJgc,GAAACAAADACA.HADALAFAEAGEQCDB.JCGBdBCAXFAAhAAAZBEAaCHDODEBhAAA.MDGBACIBFEHDUGAAhAGAeEFDKFHBBHHA.gGCHfHFB.hACA......hADA...,1,-1,-25,24
JLFBaOAHWQUeVKMGEbfNDgCIZYcXSRdTP,HAAAQAAAeACEMAFAEACA...bBDADAFA.CAHAZBDB.XBFDhAAARCGFdDDATFEA.hCAALHBAaCHDACDBVEFBhCFAfGHA.NCCA.IHCA.SFEDhCHA..hDAA...,1,7,-24,31
CIGXdgANYcRfQTOeMPKUaFSVWELDbZHBJ,...NAAA.RAAATAEA.eAGHMAFAKCCAaBBAFCHD..SBDHhABAEDABLECAZBEBHBGBhACACEGDGGABdEGDABIBfFHAhAAAQEAA.OFFB....hADA......hAEA...,1,-7,-16,9
AdZUEVDPYHeSRgfKCNaLQBFObcWMIXTGJ,ZAAAEAAADADAHAEA.RCAAKBHBCAFA.LDEAFAHB..OBCB..hAAAbEAAMBEB.TCFAhBDAAACAdFFAPEHD.hCAAeFDHfDHAaGAABHAAIFCA.hABAGFEB...hAEA...,1,-4,-26,22
XEHgaAJOPeIbfNQLWDURBKcFTZMCGYVSd,OAAAeAAA..IAEA..bADAQAGALAHBDBBBhAEARBCBKCECTCCAZDFBGGABhAAASCEBEEEFaFHBABHBfDGEhAFA.UFGBFHEE.MEEB.hABACHHD......hAGA...,2,-11,-7,4
SXPWFDEMaTeQKRVcZfgCOdJNLAbIHGYBU,HAAAGAAABADBSADAXAEDFAGAEAGAaBFD....eBHFhAAARCDBZCGBCCADdCCALEAAhAAAADFA.bFCAIEEAhACAUGGADDIBMDIB.TGAA.QGEAhAGA.KGHD...hACA...,1,2,-5,7
VDcPSgfTaebHNFYXEOdGQBWZJURIAKLCM,LAAAMAAADAEA.SADH..TAGAeAFAHCAAFBBAEBEBhAIAGCEABCGDZDDARCGBAAFACEDDhABA.PFHDaCHDbFBAXGCAhACA..dFFD.WFHH...hBIA......hCAA...,1,-4,-20,16
YcOfJXKgWLMUIHeVCDAdEFRTaPNQSGbZB,EAAARAAA..aADAQACAGAFAZCCABAEA.OAFDXDGDKAHBLDDBhAAAMAIBHEBAeCCDhAHADFFBAAAAdDHAFGGATFFAhCAASHAA..YHCA..hCBA......hCHA...,2,-13,-6,7
YHZUOCKMNLdSXfGFIWVcaTbJQEARBPDge,RAAADAAAeADEHABCZAGBCAEB..KAGAMBEB.dCCASCCAGEFAFDHD.hAGA.VCFA.aEEBbFCBhAAA...EGAAAEIBBFCAhAIA...gFFA...hABA......hAGA...,1,-13,-31,18
fdBRXcFaQbOZGMIPUNDWeYKTSCLJEAHgV,HAAAVAAA.dADABADBRAFAFCAH..QAFAZCCAGCGAMAIBUFAADCDAhAAA..eEEBKDDATDGAhAFACFCA.LFDAhBHAACIBXGDDaFHD.IHHA....hAAA......hACA...,1,-9,-17,8
YRLabIcMJZeVHgDSKXEFCPNUfBGTQOdAW,RAAAaAAA....bADBMADA.eAFAHAFASBBAECCBCCFD.UCEAhBAAGCGAQCGAhBBAAAAALEEBIEBAhBEAcGGCZEDADFIBFFHBfHAB...hBIA......hCAA...,1,-6,-12,6
aWDYHOgVNGFZLTeSPMdAfUIKEcBRJCXbQ,UAAAEAAARACA.CADA...QAFCDAFAHBDC.OAHD..gBGBhADAGCCBZDAAeDDBhAIAMDHBADGB.KEFBBEHAJFEFaGHDhAAAVFFBLHAA......hADA......hAHA...,2,-29,0,29
gQHTUOIaKFNJeLCPAXdSVfYGcbWRBDEZM,dAAASAAA..fADAGACAbAEARAEFEAGE..ZCEBMCCBhACAHDGBOCGBaEAAFFABhAAAeCHHLGDAADAAXDDChADAcGADDFFB.TGGAIHHAKHCA.NICB.hABA......hAEA...,2,-6,1,7
TNFILPcHYWCdeDAfXVKgUBJZaObQRSMGE,XAAAKAAABACBZADB..aADAQAFA.RCEF.GAFAhAAAECHF.TCDAFDCHLFGBhAAAHDBBCAHAeCHFAAIB.hBHAfEFE..gGEAhCAAOEHDMHAA....hABA...,1,-14,-21,7
dPfAeHFVITaZOUQXSBGMJLYDWECNgRKcb,HAAAFAAA.TAEAZACBQAEABAGBGCABMAHBLCGB.hAIADACAECEBCDEARECBKDGDdGGAABIBeDHHhBAAaFFH.OEEBhBGA.SGGA......hCAA......hCBA...,1,-8,-22,14
HfPgQZVBYDORdIWKMTGNXUACJcaFSeLEb,CAAAaAAAFACALADA.HAGB..fAFAQCCAZAGBBBBDhAEAOBCBRCEBdEHAKDDAGFABhAFAUEGA.AAIBSFGDhBAAEFAA.gGDADBIBMFDATGCAhAAA.....hCAA...,2,-28,-2,26
SAgeUGXPQWBVacLRYNCETOHDbfFKMZIdJ,eAAAGAAAQADABADAaAED.RAFA..CCCA.EAGAHCFCDBIB.FDEHZCDAdEGDhAAAAAAB.UGAA.XGGAhABAPDHB..VEEBhACA.LGAA.......hAGA......hAIA...,1,-9,-17,8
efPaSVWEDUZCLRGNFIOJMAbcQTgdXHKBY,QAAAdAAAHADABAGBeACAaAHD..SAFAECBAZCEB.RCDAGCGAhAAAFDAHODDBAAIBbDAB.hACA.TEGAKECAfFEAhADAPGDC.DFIBCHHA.LGAA.NICB.hAGAMIDAcGGCXFAAhADA..,2,-3,1,4
cVHSKJeUbCIYEOLTMZWDNQgFXfBPAGRda,RAAAaAAAHADB.KAFAeACHUCGACAEA...ECCBTAGA..ZDAFDBBBhAEAQEECFCEABCHAADDAhAGAdFDC.SFADhAAAJEEA.IFHALEHBMIAANIAB.fGGEhABA...hAIA...,1,0,-32,32
AGNDIQLZdWOcPgYVSFREHUCMKXTJBefba,GAAADAAALADAdADAOAFA..gAGHSBFBEBBBHCEBhAAA.MBIBKCEATDCAhAEAeDBHaDDBACIBQDGDhAFAZFGBPHCA.FFEBCGFB.BFHD.fGGEhBAA....hBCA...,1,6,-25,31
dgSZNBLGXWAMbHCaUPIeRYTQVOcKfEDFJ,HAAAaAAA.UADAeACHRAFA.QAEAOCABKCCDEAGA..FCGDdCHAZDEFhAAALDDAGGABADIBbEABhAEA.CFDA...IFHAhACATFFAfHDBDEEB.SFHBhBAABHHA....hBBA...,2,-9,-6,3
ZUGdNODPaYBWSAeEFfLQKVMgICbcXHTRJ,EAAALAAAKACA.MAEACAEB....XAFDHBCCRBFFZCAA.dBHAhABADAIBaEEBBCCAAEHAeFBBhACAQDEA.gECBhAAAbFFAJHFA.GGEB.ODHBhAHA.PHBC..hBHA...,2,-29,2,31
aPSLWZGfMXAEVFQCBJcdKbNeTUDRIHgOY,EAAAQAAABACAdAEAKACA..eAGBDAEAHAFCOCCBaCDA.LDDAhAAAGDEAMAIBACIBCDHD.hAIAJEHB..bFFATGCAhAAARGCA...IHAAPHFC.SCGDhAHA....hBEA...,2,-21,-4,17
YbBgLRTXPVDFIfaeZOUQSWcCMKdGEHAJN,JAAA..bAAALADBRAEA..TCAAXAFADAAAFBHD.aCEChAEAeBHH.ZCEBQEEAhAFASCCDCDDDdEHAhAHAHFAAAGCABHFAgEGAIHHAOGDCcGCDhAIAMIAA....hAFA...,2,-19,-3,16
gFfDEdeWVCKJRcZBOGbYXQPMIaASNLTHU,LAAAHAAAFADAEAGAeADH.CAFA.RCAAZBFEGAGA..XDCAhAAAMCABAAIBSCCDhABAUDGADFFBdGAAKCFDBGGAODHDhACA.bEDA...QFAAaGEH..hAFA......hCBA...,1,-9,-10,1
PVaDZOQbNMLdKGXgJYTRcUeASBEIHfWCF,EAAAHAAA.CADBFAFAaACDZADB..QBEDMAGBdAHAGCEAJBHBRCAA.hAAAeCBBADFBBEED..hACAfDHAVFGBDGEB.hAIAbFBA.LHDA.XGGB.hCAA......hCDA...,1,9,-21,30
UHRAJWLTPFgVZOIXKbGEYNSCfDadBecMQ,LAAATAAA.FAEAZACBOAGDKAEAGAGA.ECABSBCAhABA.DAIBdCEAeCABhACAMDGBHCDCAAIBPEDBhAAAgDGAXFGDbFFACEEDaGAABHHD...hACA......hAGA...,1,-7,-11,4
cCbTGELaYPNKSUIDXOMJZFHRdWgBQVfAe,eAAACAAAGACAEADALAGB..aAEA..PBEDSAGHhAAADAIBMCCBZBEFHCABhACAREEAdEHABDDDQDGChAIAAAAAbGBA.TEDA.KFHBXGGCFGGH..hBGA......hCAA...,2,-10,-2,8
VgWeLfMbQYcXSEPFUGHRZaOABTNCJKdID,TAAACAAAdACA..DAEA..VADAeAFAMAHB..QCDAhAAA.XBGAhBCAECABFCCBHCFBRDFFZEBAAEIBBDEChAAAKFHD.gFFALHDA.bGAA....hACA......hADA...,2,-16,-14,2
NDMQZfRPKcUJGeITFdbEWgVXaYLHABOSC,SAAADAAAZABERAEF.KADAUAGAGAFA.eAHBFCCB..dDAAECCA.hADA..VDABaDECHDGBhBAAAAAACDEA..MDHBQGDAhBIAfEDE.cFFCIHHAWFHHhADA......hAFA...,2,-21,-20,1
ZDNbXcHFRfLVJBGPEYKdMCWIQTSaeAOUg,OAAAZAAADACA...XADAHAEARCCALAHBBAGAGCCAEDFFdEHAhABAMAIB..CFGCQGAAhAGAaBBHACGAUEFAbEADFGCE.hCAA....fGDA.PHFAhAEA.....hCBA...,1,-11,-14,3
fDHNbYOCAWJZcTPQXagKLFVUIGEdMSeRB,ZAAATAAAQAEA..aACALAHBFAFAUBDBECAAdCGAeCDFhABAREDADAIBHEAB.bEEACEHAACCBhAAAJGDA...PHBChACAKGDDIGGAMFIB.......hADA......hAEA...,1,6,-28,34
XBEYgSHULMcIeTAKaCFbVfQDJRNPOZdGW,aAAAFAAA....VADAQADA.RAFAOBBBGAGABCCAhADAECDB.SDEAhAGAHCFCMDABeDHHAEFACEHAbFFCDEDBPFFBhAIAZGAE...WFDH....hBAA......hBIA...,1,-1,-30,29
YESOBbefDXPKANaZIUcGLRJFdQVWHgMCT,ZAAAUAAAGAEARADA.dAGBQAGCHBGBMCABCCDD...ECCBBCFDhADAeEAHDCIBKEDAADHB.aEGCLEAAhAEAFGGA.VEEAhAIA..WEBH....YFHBhBAA......hBCA...,1,-1,-29,28
WdbXPBSIgDfQHAOUcaRCYENKTeLJVZMFG,OAAAaAAA.RADA.EADAKAGCLAGB.ZBBAGCCAdCFC.bBFABDAAhADA.SCHHhAIADBBBHEABACCBCDDD..TFBAhBAAeDHBMEFBXFFAgGFH.fGDAhAEA..hBAA...,2,-18,-15,3
DSIebUYTXHLaCdFVQNORWGEZAJPgBfMcK,JAAABAAA.MACADADA...eAEAUAGA..TBCAHBCCaDDCdBHAQCEAhAAA.hBAAREFAECBBABFAfDFBhBIAKGDASGHBIFFA.....YDHBhCAACHCD.FHDA.hAIA...,2,-32,-18,14
PaIYgfCXDJGAMREWKbcHULQBSFTdNVZOe,EAAAKAAAHACBLADAQAEAFAHB.dAHAZBCAeCABaCFD...IDEAhAAAfCHADDGAABGAhACARDDB....bEABBEFAhAEATFGAOEGD.......hAAA......hAEA...,2,-18,-17,1
ZLFSAIabREBJYVKeNdGOWQCcPHfUTgMDX,aAAAEAAABACA..VADAeADHGAGA.QCCCCAFAHAGBTCEAhAAAMBBBZDFFLEEAhAFAAAIBRFEBKEHBdGEA.OCCHhAIAPGAAfGGADDAB.....hADA......hAGA...,1,-6,-7,1
DMLFOGfbXEdAKVQaRBYNTWeJHSUgcCIPZ,QAAARAAABADB..TAFAeACAHAFAUCCA.CCDAZCFALAHBhAAAGDAA.XEEAhAAAACFBaDFD.NEHA.SEGHhABA.IFAAMFIBfDCEEFEBdHCBKGHBhAFAYHAG..hADA...,1,-8,-10,2
YZJRFbgINEUSfAcMTVaQBLKHDPdCWOeXG,MAAAaAAALADAHACCdAFA.OAHBeAGHGCCAZCCARDFF.FBBH.IDHAhAEAEEHFSEEDhAIAAAIB..TEFAhAFABGHADBBBCFED..YFCF.JFHBNICB..hBAA......hCAA...,1,-10,-12,2
EBcGMfWCgJQKVNIXTDSPAbdYRUeHOLFaZ,dAAARAAAHADBLADAZAFAECCBGAGA.MCCACCFAQDACKDDA.hACA.IEAATDGASEEBhAAAAAIBUEGBeFAAhAEAaFHDBFDAfGAAgGDANHCBDAGA..hABA......hADA...,2,-11,-5,6
cEedHBUGKJRCTbWgfAVNXPISZQaFOMLYD,XAAASAAAZACBQADA.aAFEMAFA.LBEAhAAADAIBECCBHCECGDEARDABbEEAhAAAfCHA.hABAABFAPEHDOFHDeGAAdEDCKGGDCHCA....hABA......hBIA...,2,-14,9,23
cdRJECYeOUIaHDWLGfNQXTSAPKVMFgZBb,KAAAMAAAZACBBADAdAFA.RAEF...EAHBeAGHUCAAHBBB.LDEAhAGAGCGAQDEAhAAATFFAAAIB.FECD...hBAAgGGA.......hBBA......hCAA...,1,-16,-25,9
QBAOFUNXaIgMfGeLKDdSVPJCYWbEHcRTZ,FAAAXAAA..aACDMADAeAEALAHBdBHA.SBCHhAAAVCDACEAA...bBDDHEFAhAEARBFFZEFEACGAOFAEhAFAUFBAgGGAKGHBDHEA.......hAIA......hBAA...,2,-20,2,22
VHIEAeCUJGBRWOQdPYbgLDKFNMXTacSZf,eAAACAAAGACARADA..QAGCdAEB..bAGDLCCA.hAAAFCHDMBFBaDEEZEAAHCABhACAAAAABFFAOEDCPFHBhAEADAIBXEGB.TGCA.fGGEhBCA...hAIA...,2,-18,-6,12
EFXTZUbaQdCAPgVKcWGYJBHDRISfNOMeL,VAAAKAAAGACA.BAEAHADBRAFF.SAFA.OAHDhAAAeAHHECABTCFAZDFAaEAChAAAdDAAADDB...gEEBhADAcEEC.YEHBDFHBfHABhACAMGAAFHEA.....hAEA...,1,6,-26,32
RWcUdSFfEQVPHLDCabIZMNOKGTYBJgXAe,RAAAUAAAdADAFAFAEADA....QAFAHBEBLCGBaBHD.ZFFAMCDBhADAKCCD.GCEABGED.hAAAXEGAAAIB.eECDhAIA.SGDH.fGGAhBAADCIBCHHD.IHBAhBCA...,2,-30,-11,19
eaWANHIGRQTBdDMKOVPUXEcCgYFZfLJbS,HAAARAAAQADCdADAMAFAKAFC..OBEDUCFA.EBGACAHA..FCCHZCAAhAAALDHBSCGAhACAeEDFAEEBGEGABFFADHFAhAAAXGBA.gGEB..hBGA......hCCA...,1,-4,-25,21
IXONeTYacZdCSgUMBQEJLGWbVKDAHPRfF,HAAARAAAFADA.OACA.eAFAaAFDdAHA..SBGAMCCBEDDA.hAAAGCCA.bCFCDDGAhABAACCB.IEFATEFAZGAAhAAACEHABGGALEHBKHBA....fHEBhBHA...hAGA...,1,2,-30,32
gSBNKYVIEWcdHaJAPUbeQFDfOXTGCZRLM,UAAAeAAAQADADADA.OAFCGAEBRCCBLCGBMBDBBCEAhAHAKFDA..ICHAhAIAEFHFdHABaGEEADGBFECH..hBAA.TEEA.ZEGBNIDB.....WFHHhBCA.....hAAA...,2,-22,-12,10
CTaQMRKHFIgWUAcEeXZbLBNPJVdDYGfSO,EAAAeAAAZACBLAEABAEA.JBCBdAGA.GCEAOAHD..aBHDRCFBHECAhAAAFECB...gFABhABAABCBXEGAbFEAhAFA..PHEADEIBSGADQGBBMHDAhAGA.....hAAA...,2,-23,7,30
ZVQYNXHWUSGJadODcbMLKTfECBRFAPIeg,eAAAZAAAQAEA..XADAHAGDSCAAaAGAdBGADCCAhAAAbDAAMCIBLEEAhABATDDAEFHFREAA.AACAgGDAhAEAVFFA..YGCA...hAIA......hCAA...,2,-8,-4,4
IgbdZJGEBYSTFROPMNLXVDHQaecAWUfCK,UAAAKAAA....bACBZADA.EAGEBAEASCBARAFF.MCEBhAEALAHB.DCCBHCFChAFAeDEBAEGBCEHAdEGAJFCBGECAhAAAFFED.OFHDXGGA....hAIA......hBAA...,2,-20,-17,3
dePNAFEIOgfVGSHCZbBJaDLcKWYTQRUXM,EAAAOAAA..VACAHADAZAFBBAGB.aAHDLBHBKBBD.TDDAhAAARCDAMDCBdFAAeDFAhAFAACCBFEGH...fFCAhAFAGGCBbEFADFFBcGGA..YHDAhAIA....hCAA...,2,-19,-2,17
OEQaGdDcRJZBXNgMKPIYWCfVTbUSALFeH,eAAAHAAAEADEGADAdAFARBGFZAFABAHB..XCFAMCAB.KCCDICCAhAAACEFA.TDEAhACAbFEAAAAALGAAhAGA.ODBHaDHDDECBNDIA.gFGG.hAHAPEDB...hAIA...,2,-10,-3,7
SKfIJWFMGCLRVDBaPUYNcdgQbAOTEHeZX,EAAAHAAAZACBKADC.JAFBMAFA.GBEARBGFBAHBUCGA....hAAANCAA.dCBC.bEBAACCAeCDFhAAASFGA.fGBAhBCAFEEALFHBaGFC......hACA......hDBA...,1,-1,-29,28
CBAaKELcFYRQWSXMPgOfDHZUdVJINeGbT,EAAALAAAFACD.RADFQAFC..XAEAMAIBOCABhABAHBGBdCEA.IEAAhAAAeCCBbCGDTEFAhAEAADGBaEEBKFFD..cEDCSGHBfFHAhAFADHAA.....hACA...,2,-17,-11,6
IDGTaVUPMWfLAJYHbEdScQNeOgZCRXFKB,HAAAEAAAdADAQADC.eAFEZAEBRAGBKBFADBCBaCACUDBB.MCGBhAAALDDA.ACIBbDGDhAAASDHHOFDACHHAhACABEEA.TGGA......hAIA......hBDA...,1,1,-30,31
caUPAGKTEdfIeXJBWOCYSbDFgRHNLMVQZ,GAAAEAAAdADA.eADABAFACAGA...SAGHFBHDHCDAMDABZCBAaBHDhAAAAAABKDCD..TDFAhAFAXEFAOEHDbFCD.hACARFCA....NIAB.QGEAPHFC.fGHAhADA..hAEA...,2,-11,-8,3
bBOgCdXNQFcHJTKeDYGZAREUVISWLfPaM,EAAAVAAA..SACALADB..aAFAbAEDBBFA..CAGAdCCAhAAAQCGAHCGBTEEAhADAeDCBGEEARGAAUGGA.hAGAfFBAMAIB.......hCAA......hCBA...,1,0,-16,16
bQaKJdICfETBVALNFMXRYcHDZeOGWSUgP,LAAAMAAARACA.HADBeAFEGAGA.SCAAPBBBaBFDdDDDhABA.fEFAhACABCECACHAFDDHXFAADDHBZFEBOEHDhAIAgGDBKGGD.CAFAEGGA....hAFA......hAIA...,1,-2,-15,13
LWBKROUPFMJdCQbIZVSXaHTEYAfcDeNgG,DAAAeAAAGABBLAEAKAFC.RBCBUCEAFAHD.dCHAQCCBZFAA.hAAA.XFFAHCEBECGBhAEAAAIB...fEHAhBAA.gGFBOHDC....hCAA......hCBA...,1,-18,-20,2
PECWgVRKMJLGBNHfZQSTDAXebYUcdaFIO,eAAAUAAAdADAFADD..OAFAEAFA..CAHA...VBFBRCDAKCGCMBIBhAAAGDBAHDDB.ZFBFQEFAhAFATFGAACCB..hBAA....YHEAaDHDIHHA.hABAPFEB...hBFA...,1,-13,-17,4
EGYVdCNUFAIXcWgRJKPaLZDTfbSOHBMeQ,XAAA..gAAARADAKAGC.aADAZBFEDAGA..bDAAHBDAhAAABDGAeBGH.ECCBhABAGEDAdEEACDBDFDHDAAAAIFHAhADAJGBA.TGFAOGFC.MIBA.hAEA......hCAA...,2,-24,-1,23
bQYXMJULRKHceEBgPNCdAFDTafZOGSVIW,TAAAZAAAGAEA.SACEVADA..IAHAQAGAhABAMCABLDDBHCCAECGAhAAABDHA.gFFAhAGACDHAAEEAaEFDOFHBYCCFXGAA..hACA......hADA...,2,-12,-6,6
NUfLESDdICAgPGRacKZOMYVHQeTFbXBJW,GAAARAAAKADCZAFBMADA.HAFCeAHFFCDABBEAJCGF...UDCAEDDBdFFAhAAAAAAA...aDBDOCHDhCAA..YEHBhACATFEA......WHFANIAB.SEEEhCCA.CGHC.hCDA...,1,-5,-36,31
PCIbaBEGMTSADeVOdQXgHJFRNYWfZKLUc,eAAAdAAAQADAHADARAGF....NCCA.fAFFZDDALEHBhAAAPAHDCFAA..aFCDECBAhACAMFFBACGBODAB.hABAXDDA.FDGDWFDHKFHBcGGChADABGGC......hBAA...,1,-7,-16,9
TWBSgPZDUHQdEeOcAMNGFXVKJIRCLafbY,GAAAXAAAKADARADA.LAFB.aAHBbAGB....TDCAhAAASCDAZDGBHFCChACAEDAAeCFHABIBMDABFDHDIHHAhADAfFGEBCDBDEEB.....hBAA......hBCA...,1,-8,-17,9
eFYNEcTCVbRLXAGKWOHgdDBUSfaQJPZIM,GAAAOAAAHADAdADABAFASAFEQBGAZBFEeBBBFCEDEDGBTDDAhAIA..bDBDRDFFADHAhBAAKFFADEIB.aFGDIHAAhAAA...MEIB.NICB..CFAC..hCAA......hCDA...,1,-7,-8,1
eKOfXGJgNEDHMSUdCFcZWRPLAYabVQBTI,aAAAQAAABADA.eACAOAEDGAFA.JCDBEAGAHDABUCGAdBHAhAAAFBBHZEFA.RFDBAAHAVDCAhADATGGA..fFFAhAGA.XGDD.DGHB..hBAA......hBIA...,2,-29,8,37
FZeJQHVbSYTPWNRMIGfgXdCBcKOADUaEL,aAAAEAAAZACB..eACHHAEA.SAGETAEA...PCEBhAAARAGFGDDA.XDGAhAEAdCBCBCGAOECHhAGAACIBLEGBQFGCbGCANEIA.MBBB...hBCA......hCAA...,1,-1,-10,9
NPBgRVOdUeMWSATEHIZQcDXKYJLFbfaCG,HAAAZAAAQAEAXADBKAFALAHB.FCAAaAHDGDDABCADRCCBhAAAdEAAeCFBMDGBADHAEEHBhACADECBJFHBCFEA..gGCBhAHAOHBC.SGGBIHFA...hABA......hACA...,1,-2,-10,8
CgdFSEXbBZVOJNHDYfLeRPTGKcWQIAMaU,aAAACAAAdACA..EADABAEAZAFB...OAFDHCCBDAIBLAHBRCGFGDAAhADAKCBD.QFEAhBAAABHBUDDA.SEHHhBBA..bEGBJHBEfEAE.eECDhAAA...cFEDhAEAIHHAMFIB,1,4,-26,30
dXLWKSGYOfHRBMTbJZEIAVeUDNPcgQFaC,eAAADAAA....PACCQADA.aAFEdAFALCCBhAAASAHBGCEBOBBBhBAAHEEARCDBMBHBbGAAEFHFADCBUEGBhCAANIEB.FFDH.CGHD......WFFDhCDA.....hABA...,1,-2,-16,14
gVfDdGRZYEIKcNXOCPbFJAaLBMHTUWSeQ,aAAAMAAAHACBUAEAeAEA..QAGA..fAHAhAEAGBBARDEAEEDBKCEAXDFAhAFACDHBFFGAABBBBGGDTFFAhBAASEBDDBBBZGCAIHHANIBB..hCAA......hCGA...,2,-12,-10,2
XSYFceICHELgKPZbJOTWaGBVMAUNDdfRQ,DAAARAAAQADC..SABAFAFAeAHHHCDCEAEALAHBhAEAKDHBZEEAOCCHaBEEGCCAhBAAMGCAABHBdEFA.XFDDhCAAIHHACGHA.gGEA..hAAA......hABA...,2,-19,-7,12
FWdSQGIYTfUAPDMBRECZeacXVKObNJHgL,MAAAEAAAZACB..eACAaAED...XAFAOAGB.JBBFHCGBLCFAhAGAdCBCGDEA.hAIATGGAADDABECACAHB.KEEAhBAAgEBASEGB.QGCAhBIA.fGGEhCAADICA...,2,-26,0,26
COebFVYDZgdJXKaNcfRAMTQPUHGWSIBEL,MAAATAAAUAEA.HAGDGACA.SAEAEBBALDCAeAGHhAAAFDGHDAIBdGGAKCADaEBCfCEAhACAACIB.QDGAhAEA.IFAAOFFH.bFEB.hAIA......hBAA...,2,-20,-2,18
WHfeXDVRbSIOKcTFJQdLEMaZPCUgBAGYN,GAAA..YAAAHADAeAFE.DCDBRADFSAFBhACAKCEAFCGAdEEAEEHBZAGBCCCDBGFAABIB.hADA...fDEAhCAA.bEGBODAHTFCA.LFFBhCBAaHGE.....hAAA...,2,-21,-5,16
CFZUSHGAMWadNOLbXVIgBJTcERDPYfeQK,aAAAdAAALADA..bACDXAGD..gAEAhAEATCBARDEADDIBfAHAhAFAeEABQECDhACAFCFDZDGBSEEDHFGBAAIBWHDGOBBBBGFCEGHF.hAEAKHAA.....hAFA...,1,-2,-4,2
eGZNVaLcXFJADRbSQBYdOfHKUgMICWEPT,RAAAQAAAdADAHAFAKCCDMADA..CCFD.EAGA.eBDBZCGB..aDECLBFAhAAA.FDFAAAAASEHHhAFAODDHfEBAhBCAIHAATFEA.NDIA.XGGChAHADGHBBHFA....hBEA...,2,-23,-10,13
BSdIEAagcLCKFQPGRVOXfUNZbMTDJYHWe,aAAALAAA.FAEAGACARAGF.XAEAUCAAZCDAMAHBDCIBHEBChABAeBBDdDFA.AAEACDHAQEEChACAOEDDbFGDTGGAhAIA..YFCFSHEG..hBEA......hCEA...,1,-5,-12,7
DVFNdfcBLPeCKGQHgXWAYJMUTaRZObEIS,MAAAaAAAZACB..EADADAFAFAFD..dBEABAHAeAHFGBBAHCFB.XCGAhAHAABBBUECARFFAODEBhBAA..SGBDhBAAfEHE.LFFBCHHA.KHCA..hBBA......hCAA...,2,-21,-16,5
bSJDIYdVZWLQPCRaBFENfOeAGTgHcKXMU,GAAAHAAAXADBMADAUBFA..bAFADAIBdCADZCDBLCFBhAAA.QDCAhACARDBFaDGEEFEAOFHBAAGATFGAKHAAhAAASCHD..YHCC.hCDA......hDFA...,2,-10,-3,7
DaANefJBgcKSXCbMVEFWTHYUPQdRLZGOI,eAAABAAAKACACADA..MAFAEAEE..FAGAHBDC.UBGAdCAARCCAGDDAhAAADCFA.ACCB..fFGAhABAJCHB.SFHHhCAAXEEA..VGDA.....hCBA......hCIA...,1,-21,-38,17
NYCdSPAIQMDVcgfZWaEKFLHeBTRbJOUGX,MAAADAAA..VACA..fADAZAFBEAHF.LAFAHDDAeBBBhAFARBBBbCFAOCHD.hAGAXFCCCDEDdEGAACFAQECDhAHA.gGFGaFFABGGDJHDAhBAA......hCAA...,1,-5,-10,5
WAOBdJaDGFTLKfNPSIHeYVEUXMbQcZRgC,dAAAaAAAGACALADAKAEA....fAHASAGBHCAChACAeBBDECFBMAIBQEAChAEARCFBCEAAAEEA.BCHAFEHDTFCAhAEAIEDA.UFFAXGGCcGCA.hBAAWHAGDFFB....hAFA...,2,-15,-1,14
PbBXaWADYQegZNLdCOHFVKMRcIfTGESJU,QAAAeAAAZADBdAGAHACAKCFD.RAFF..ICHAGDBAEDGA.UFFAhAAAbCDDBAHB.aEAAhAAAAAIBDEEB..gEGAhAEACBCAOEHDMICATFAA.SGEBhAFA.....hABA...,1,5,-20,25
GbCeZTVFIcMLdUONSQKEgBaXYDfHRWPAJ,GAAAeAAAZADBFADAMAGBdAGAUCDA..SAHBECHF.aBHHhAAADDGBHCEBRFDAAAAB.bDBDCFHA.hACA....TEGAhABAIGBA.LHFAQGGB.BBCAhBFAXDBD..hAIA...,2,-26,3,29
dCWZGeRagFXNbEUVfDAPIHQSOLYcTKBJM,HAAAQAAALADB.TAFABACAdAEAZCFAREEAaAGAFCAH..bBFDhAAAEDCB.UFAADBHBACDBSFHHhAAAODEHKEBAMIAAhACACEHA.eHEE..XFGC.NICB.hBEA......hCAA...,1,15,-27,42
DPECbeSKfZHcTOANMFRGaUBLJVQWIdXgY,MAAARAAAGADABADALAFA..QAFAdCGAXDAADAIBEBBBhAFAeDDDKCEAHFEBTDCAhBAAAAAAaDHD.UGAAVDGBhBCAIHHA..gFEB.hADACHBA.SGDDhAGA...,2,-21,0,21
CTHAMGKIfLePYJXcQZdRNSaFWUEbBgDVO,GAAAKAAALACBeADAJAGBQAEA.RAGB.aBHDFCEHECDABDGDhAAADDAB..CDCD.HEAAAAABMDFBhACAfEHA.hADAXFFDdEGASFHH.WEED.hAEA......hAIA...,1,-15,-20,5
BFWVGKZAHUNfIORadbPLJXMYEQegCcDST,HAAAUAAA...fADBRADAdAGALCFAMAFA.ECDBeBEA.CBHASCAAhAAATDAAFEFA.hADAGDCAAAIB.OEEAhACAbFFA.XFFA.YHDG.hAEA......hBAA...,1,5,-25,30
QCUBRLdfIVgbOSYaJEFHTXWeAKGNMDcPZ,GAAAMAAADAEAZADA.QCDABAGARBBALBEBdAHA..fDCEhAAA.gDGAhACAbCFDSAHHhBAAaEACEFDATGGA.eDDDAFIBKGAAPHDCCGGAIHDAhAEAODHF...hAFA...,1,-10,-15,5
cTAgKDWUdXFbHNPGaISEfOQLBJReCZYMV,DAAAdAAAFADAHABCGAFAaAEA...EAHBQBEDLCCBRDGFeAHBhAIAZEDB.MCCB.TDEAhBAAACEBKDBDXGGAhACA..bCGDNIAB.SDDDBFFD.CGGA..hAIA......hBAA...,1,-6,-9,3
cTFKVBaeDQbLGdgHNfAYUEZORSJWICXPM,EAAARAAA..SADBJACB.CAFA.MAEAFAHBBCCAeAHFDBEA.LCEBhAAAdCFAHDGBACGBZEGBhCAAODEH..XGEBhCBATFAAaFDH.QGGB..hAAA......hABA...,2,-26,-21,5
FTEXDKcOBZdefIUMLWGbSQPgCRJHNAVYa,aAAAEAAAKACABADA.ZAEBeAEE..UBGAMAIBGCCA.QDAAhADACBEAHCCAACGAFDFDDEFAdFFAhAHALEHB.SEEDhAAAgGCANHAB...YHFGhAIA......hBAA...,2,-20,-18,2
FDGNKASPYQcMJRCbBVEHOedaZLfUIWgXT,SAAAQAAAMADARACFBAEBHAFC.eBDBZAFBLBHBhAAAUCGBIEBAXCDDTEGAhAAAGEFAADDB.cFCAhABAbFCAEGGB..aFHD.fHCB.hAIA......hBCA...,2,-8,-3,5
FDNVXKYdcAaWTfBRUeIHGCMLQJPbgZSOE,aAAATAAABADA..RACFUAEAHAEBGBGA.MBBBLAHBhAAAQCCCbDEBZEFBEEEADCABhACAXFGAdGBAABHBeEHFhBGACAGC..gGFG.ODAHNEEA.hDBA......hDCA...,1,3,-4,7
NeHQRfbTIWGAPBacXMVCDdSKEJOYUZLFg,aAAAMAAA.DAEAdADA.EAFAOAFE.ZBBALBHB.FBBHeCEHhAIAHCEARCGB.TEFAhAFAGDBAACGABDDDXFFChBAASFHHKGHB........hAIA......hBAA...,2,-22,-19,3
VLNYfUBXZGDdPgHbaETeCOQSRMAKWIJFc,KAAAJAAA.FACALADB....fAFAXAFAGCEAhAFAdAHAHCCAECGBeCFHQGAAhAGARDGFAECB.IFHAhAIAcECD..NHBBBFAADCCBgGGGhBAA..aGGC...hBIA...,1,-16,-21,5
RLWEDMAdgOeNGIJBKUSZVPCYTfcFaHbXQ,dAAAeAAAGADABADAKAFAZABBCAFA....TCCAFAHBHCFA.QEFBhAFARCEFEBHFAAAAODHDhAFAIGHA.SDBAhBAAPECB..fFGE.aGEBhAHA......hAIA...,1,-14,-31,17
fKScWAQIOCgXLNaeTRMPHYDFdUVZGbEJB,QAAACAAALACA.eACARAFFHCCAFAFDdAHAZCGBGDAA.EEEAfCDAhAAA.SDAAhADAAADAOEHDNIABaDFAhBHA.MDIBDGGB.bEEBBAHBKGGA.....hCAA......hCDA...,2,-14,-8,6
YQDAXeRCIHBPWcUZMbVGLdFfNTJOEKSga,RAAAHAAABADB..PADAUAFAZCCA..bAGDGDFA.dBHAfBFAhAAA.TCCAhACAEECASEHBhAAAaECCQEECAFBBCHGA.IEHAMIAA.FGGA.hABANIAB......hAIA...,2,-28,7,35
gSWDRBCcXNYAfZHQaGMKUVeILETJdbOFP,HAAAGAAAMACAKADAeAFEEAFA..dBHAFBFDSBDHRCDBBCHA.XCEDhAAAAAABZEGB.aCCBUGEAhACALEHB.bFFBhAIAODAH.PDCBDGCACHCA.....hCAA......hCGA...,1,-4,-17,13
LBeUAJHTDCRNOQEKPGabYWcVfgSZFMdXI,HAAATAAARADFQAFC.EBHFGACAaCAC.bAEA...hAAAcCACfDDEhACAZCFAdEEALDFAeEABAAIBCEHDhAAAKFFAPGFCYFHBgGCBMHAABGDBhADADGAB.NIAB.....hAHA...,2,5,11,6
cWgDdOZSBFVeRJULfEKQHPYAaGMINTbXC,GAAAMAAA..TADAbADA...CAFB...gBGHhAAAdAHAZBBFFCFBRCDBLEAAhACAEDGAHDDBAEIBaDGE.XFDAhADADFGBBFHDeHAAfHBBQGGAIHHAhBAA.....hAEA...,1,2,-12,14
WPFHKAGZOEVMLIdYJRDgfBXQCTSbUNace,ZAAAEAAALADAdAEARAGB.DAHBBCAA.QDDATCBA.UDGBhABAaBHDeCFB.FDEHHEBBhACAAAEAGECAMFHB.IEHAhAAA.gGGACCCDSGAD.hAIAcGCD...hBCA...,2,-18,-15,3
HSWReVUBQdgfFGcZJbEDYLCNOPXAKaMTI,aAAAMAAAHACBRACA.eAEABAFB.dAHAFAHDZCCAECEALCFB..hBAAOBBHABBBKDHB.TDFAhAEA.SDHBhAFAUECAQFGDfEEEJHBA.DFHBCHHD...hBHA......hCAA...,1,-5,-19,14
ZILNERJbeCGYQFPBWMTdSVXDAfOgUHcaK,OAAAHAAAaACAZADBLAFARAFA..eBBBGCCAQCFBhAGABCFAMCHBdEEA.XEFDhAAAABDBUGGAKDHBEGAACFEC.FGHDhAGA...WHAA.......hAIA......hBAA...,2,-23,2,25
OAcCYMeaBfKDJRWdPHgUZbVNSFIXELGTQ,CAAAeAAABACADAEA.RAFA.dAEAHBCAZAFB...VCGBFAHD..ECAAGDEAhAAA.QEBAhABAACDBMDEB.aGGAKDGA..hAAA.JEBB.....PFFA..hACA......hBEA...,2,-42,-6,36
YADUSeJOXTMaPbGNWHgcCdFEIfKVLBQZR,SAAAeAAAOADCMADA..aAFAGAGAHCCACBHAEBCA.KBEBLCFBhAAAZDDAAAAA.DDHBXFFAhAIAbFEC.gGBAhBGAFECHfGHA......hABA......hAIA...,1,-14,-15,1
BKRLcCDEdUNXFbWGagASMHVIPYQJfeTZO,HAAAVAAA...IAEAQADC.eAFEZAFBKAHBRBFB.LCAAhAAADCIBEDDA.dCECXEFAhAAAbCGDGGEBAFEBMFIBhAIA.JHCA...fGGE..hCAA......hCHA...,1,-12,-13,1
EGcdfaFRDUQXYLOPBTAMgIeVHJbZSNWCK,MAAAeAAAHADAZABE.SAFECAFAGAGAdCCAaAHD..RCCB.QEDAhAFALCFBBDHAAAIBIFHAhBAAbFDDKFGA..ECFBhCAA.FGFD..........hCEA......hDAA...,2,-18,-9,9
AJbOIXUHMFefPgBdDSLEWQNKTZYVaCGRc,OAAAXAAAHADAFADA.eAFE...fBBEBAGAdCDALCFAhAAAECEAQCGAhAIATEFAZDDAaDBBRFFAAHHAbGAAMIDAhBAA..DEIB.SFED.KGHDhABA......hAGA...,1,8,-25,33
WKGQBCJUIHAbaRdSOgEYfZNFLMPceVXTD,RAAAdAAAOADAEADAZABBLAHB..MAGBeBDF..TDCAhAHAKBFAGDFAQDGAhAIACEDAJFHB.HFBAAAAA.aBEDSHBAhBHAfEFEFHECPHCC...hCAA......hCCA...,2,-18,1,19
YbDXegTLBMAFKHPZCdQVJSGfNIUWOcEaR,HAAAZAAAdAEAQADC.SAFBGAGAfCAAhABAIAHAOCABECCBRDFBDDIBeCCBhAAALEBAACFBKCGACEEAVGAAhACAUEGAaFDEbGFC........hACA......hCIA...,1,0,-2,2
bZBAPLJOdcIXYRNKWCgUEHfVSFaeTQDMG,LAAAdAAA.XADDRADAKAGCCBHA..UCDBHAFA.SCAAhABAFCBD.eCFAQDGAhACAGDDAZFAAAADAOEEBhBAAIFGA.YFHB.WHAGEFGBaGCBhBCADIEA.MIEA..hCGA...,1,7,-30,37
MPBWKIgUQRNCdTcFDZEVHLbOJAYafeGSX,aAAAeAAAGACAMAEABAHAKAEA..UAGARBCAdBFAFCEDZCGB.HDBALDGBhAEAOEFHABBBSFFDhBAA..WDHHhAAAIHHA.NIBB.CHHADGEB....hABA......hBDA...,2,-21,-19,2
PfFVAYLSbWGUKRCENHIeBXTaJOZMQgDdc,LAAASAAAGADARACF.EAFAHAEBeAHFTAGA.aCGEZCAAhABAMDEBQDFChACA.dFAAfEAAhAAAACIBbFEAKGCA.CEHABFFA.OGACDEIB.FGHB.hAFA......hCBA...,1,-1,-3,2
CZJfeTEQLKDUYFSVbBgWRMINAHOPdcGaX,HAAAdAAAaADAZADB.eAFAEAGA.LCCD.DBIBFBDB.SBGAhACAbCGDBCAD.RCBBMDFAhAGAACGBODEDGEDA.CFFBfFHAhBAATGAAQGEBKHFA...hBCA......hCFA...,1,-4,-14,10
cPfVWXRdUgJKeTEFAaILOHMZQBCYNGDbS,aAAALAAAHACBZAEAQAEABAHB.CAGAGCAASBBD..hAFAfBHAXCEARDGFhAGAdCCBUFCAKDDDEDGBACIBMFFBhBAADDIBbFDA..cGGC....hCAA......hCFA...,2,-11,-8,3
cgPFZYDMSBVQNLHOUKRbCWATfEIadGJeX,EAAAdAAAeADA..XACA..gAGAZAEBMAHBBCCAhAAAQCBAHCFBKDAAhADARDDFbCFAAAIBTFGA.hACAaEEHGEAAJGBA.FEHHDCIBSFFBhADA......hAEA...,1,-7,-10,3
MbVedTEKOFYPGgSLXIBCRZNQWHfJAcUDa,DAAAaAAA.MADA..eACHEAGA.FAEAGBBALAHBBBEARBDFZCFBQCGAhBAAHEGBABBB.bDEDdFDAhBAA.OHBC..hBHAgGCB.XGFA.CEDAWEBDhBBA....hBDA...,2,-23,-8,15
GNbJgcUCDTQeOXWSLRVFfAKPBaZMIdEHY,BAAAZAAAdAEAHACAGAGAJAFA.UCAADCAA...eDDAOCDC..hAAASDHHRCGFFEAAAEEA.hACAaEFDEFCA..bGAACFFA.hAEA...XGCA...WFHHhAIAfGHA..hABA...,1,-23,-29,6
MWORDKGJaXNCHbPVeAQgSYFILZEBfcdUT,QAAASAAAFADAZACBEAEABAGA.dCCAMAHB.RCEB.GCFAhAAAaCHD.CBHAHECC.bFGDhABAeECB.AAIBgFGAhAAALDBDfGAEcGBC.WDHBDEEB.hBCA......hBGA...,2,-16,-3,13
fTBNGPRVSWEKeaUcOMIFQLDZCJAbgXYdH,XAAAHAAATAEAGADARAGF...SAFAECABeCCBaCECOAHDhAAAMCIBQCFDhABAZEEAAEAB.bDAAdGAABEFAhADAPGECKEHBIFAADGIB.CGGAgGAAhAFA....hAGA...,2,-6,8,14
aUFfLcHERMVSZNBJQdgXKDAIGYWTOPebC,GAAATAAA.eADACACB.aAGDFAEA..LCDBHAGBRBDB.MAIBZDFEBCCDhAAAdDGAKEADAAIB.IGBAhAAAOFCBUFGA.hACAEGDASCFD.QGGAhADADIGA.WFFD...hCAA...,1,0,-16,16
KbfSIZQJaDMUHgWNPYdLFeBRCXOGETVAc,KAAASAAAZACB.QADAaAED.MAGBHAGB..gCCBhAAAPCABdDEAeAHBhABAREBBODHDEDAAACHBbDFCIGAAhAAADFBAUFGA.NIAB.LEGD.CGDA.hACA......hAGA...,2,-15,6,21
bACONPUBcGTKVEgDZeSFfHMaYLRJIWdQX,OAAAUAAAGADAKADA.EAFAZAFB.FAHDHBGB.aDAARCCB..JDGBdEFAhADA.QFAAhAFAABBB.CEHABFDATFAADAIBhBAAeEHHfGHALFEB.....hBCA......hBDA...,2,-27,-6,21
JcUaAbdSNDWGVEeKTLRMYHfICFOPQXZBg,dAAADAAAGABBEADA.eAEETAFALAHBRCAAHCEACCCD...OAHDhACAQCEAZECABEGAhADAgECAUGEBAFIBSHAAhAHAVEGBMFFBfGDAIHHA..hBAA......hCAA...,1,2,-15,17
fYZRUWJdEaKPMTHQebLVINBCSOAFcDgXG,DAAAGAAAZABERAEFUADA.dAGAEAGEKCHB..MCCBHDBB.eDDALCGBhADA..IEGAhAAACDDAACIBFFEB.XFFChACA.fGBEYFHBaGDH...hAIA......hBAA...,2,-27,-17,10
fJXQDYTVIeRcgZKEBSHLbPOFWMCGUAaNd,dAAAXAAAQADADADA...TAFAeAEARBCFZABBBAHAHCFCLCFAhAAAbDCD.FEDDMEFBhAHAGGEBAAIBaEHDfFGBhABAYHFG.IHCA....hCAA......hCBA...,1,7,-22,29
YAfCaRHMTLEDBGJUKSVgQZcWFNOeIPdXb,aAAAHAAALADAEADEGAFAKAHB...SAHBQCCAZCAAFCEEhAEAeCCEdDHA.XDGDhAAAABBBREFBMFAATFAABFEDJHAAhAFAgEED.NIDBIGHAYHEACHHBhAHA......hBAA...,2,-12,18,30
YaZegQIcXFEHLBPbNdCTGVUDMJSKWROfA,ZAAAeAAAQAEA..XADAHAGDLCABbAFD.dCCDhABAGCCADCIBMDFBKAHBREABhAAAAADAaDGHgEFAhABAFFHDEHEA.BFHA.CGED........hACA......hAIA...,2,-8,-8,0
FTRBHXgWNVdfYJAcEeMDKbZGPLSUCIOaQ,EAAAeAAAKACAGADA.LAFACAEB.aCCHTAGAHCFAXEFAhAAA..gCCAhAAAVGAAdGGDfFEEhABAACCAMCFBZDFBSCHH.OFHBhAGA.RGCA.NIEB...hAGA...,2,-20,3,23
WHeDFgKMSbAZPROQEXLJUBcYCIaTdVNGf,RAAAEAAALADBBACA.CAFA.aADD..dAHAGAFAHCEBeCCDFAHFMCCBhAAAAAAAZDGB..QDDAhAFAXFAA.UFBBIGDAhAFATEGA.fGGEDEIBSGFDhBHAOHDC.....hCAA...,2,-16,-4,12
MaDKPYFZNbJQTdgGLOBIeRfSWEVcUCHXA,aAAAKAAAFACAZACB....JAEBdAFA.GBGALAGBBAHBRDEB.SCCAhAAAEDHF.UEEAhBFAHGBA.AAIBMBBBDEIB.hCAAPFHD..YFDF...hBAA......hBGA...,1,-20,-35,15
fMOSQNHGbBdeZXFKTCRUIDAEWLcJgYPaV,EAAALAAA.JAEAPACC..aAHDMAFA..QBDDhABAHBECbCCCBBHBeCABZDEAhACAKDGAREEBDCCBAFIB.gFFBhAHAfGHESCGGNIDB...hAAA......hCAA...,2,-16,-15,1
bRaTXUVdCDLfPgGFWIHMeKOQEYZJAScBN,BAAARAAA.aACATAEA.UAGAdAFALAHB..fCCAhAAAGBCAFDGHHDABhABAeCBDQDEAhADAEEEBZFBAABHBSFHHbDGDCEDDDDIBgGEBMIEA.hAAA......hBCA...,2,-16,1,17
AGFSHEJbXfOPgaMIBRQcYDdUVZWCTeKNL,GAAAHAAAEADEJADA..XAFBOAGD.aAHDMAIBBCAD.RCCAQDFAhAAADCDAdDDAZDEBCEHAeEEBhACALGAAACCAFFCBfGGAhBHA..gGEA.hCFAIHHA.YDBBhAAA,2,-19,-6,13
JYWFKfIUNVLaEHDRPAOGgZeTMcCQBbdSX,GAAAeAAAMAEAQADAdBDA.SAFAXAGA.JBHBFBFHKCDDhAAAUEEALDFBHDGBDCCBhAAAADABZGAACGHABHCA.hACA.YEED.fFHANIEB.hABAEHFE.....hCAA...,1,3,-18,21
RDKIXYTMVSQCPaceFOWBELUHJfGbAZgNd,ZAAAdAAARADAKADC....XAGBMAGBQCAACCBA.aAHBeBHHhACA.OCEDECDAHDEAhABAGDCAABIBDDIBTFGAhADASFBAFEABBGEALFGB.fHDBhACANIEB...hAEA...,1,-10,-18,8
cUHfDVGCRPZXBgJbQAWFMNYaTSdLEeOIK,MAAAaAAA.dAEAEADA..eAGBKAFAHCCADAIBGBBARCFFZDAFBAHB.hAHAJDHBABBBFDEA.TEGAhBAALFCB.OEEBhADAIGCAUGGBCEEDXGGA...hBAA......hBBA...,2,-20,-7,13
KOZUNTWPIEebDSFgBQYXaCRMLGdVcAJfH,HAAAZAAAUAEATAEA....IAHAEAGEeCAADCAAFCEHQCGAhABAaCGARDFFGEAAdDAAADDAhACAKEHB.ODDH.hADAPHDAbDEDBFHACHGA.MHFA.VGBA.hAAA......hACA...,1,9,-13,22
BEgVbSaFRKZQdCfXLUDIONMAGJTcHWYeP,GAAATAAA.HADAeACEEAGE...bCDAaAFA.RBEAZCCFdCHAXDCChAAALDBBDAIB.ODGBhAAAADABcEFC.PFABhACABDHBSEEBQFCAfGHAhADAIFHA....hAFA...,1,5,-10,15
QfOFCecHKYBAIXVdMSDWLaPUENJgTGRbZ,XAAAdAAAMADADAHBLADA..aBDAEAHB...JCDAGBFAhACARCGFZEAA.QCBAhAIAFEEBeEHHKGCDABIBSDDBhBAA.PDHDgGFDbFEDCGGA...hBCA......hCEA...,1,-11,-18,7
JAIgbQFNKMfLVdUDWXcEaOGePSHYTZBRC,..IAAAbAAA.FACAMAEA.LBEAdAFADAHB.XCAAhAAAEBCBGCDAeBHHHDFBZDDARFBAhABAAAIBQFBAhBFAfEHAUGGBaEHDSHDA.BHHAgGDAhACA...hCAA...,2,-13,13,26
ANeMLSEPBRXYIHcQKGFCTJdUgbWVODafZ,eAAAMAAALAEAEADARAFA...XBBAHCCAQCGAhAAAGCDATCFAdECDbFCAOAHDhAFAaGABAFIB.SEHBhAGABGGA.IFCA.FFFA.CHHA...hBAA......hBBA...,1,-2,-9,7
NBRbGUETQaVYPJdHKIcMOeLDWXgZAFCfS,CAAASAAARACA.GACAEAFE..aAHDPAEAHCAA..KCEAMAIBhAAAeDFALCFBhABA.XEBCAACAfECAhAAAbDGDTFDAQFFAYHBAdHABOEEBhAHADIFA.WFHH.hBEA...,1,-3,-9,6
DgMZYWUcAEXaISeHbKOCVPRLNTBfQFdGJ,EAAAaAAA...eACAHACBOAFCCAEARAFF.LCCABAHBQDEChAEAGCFADCIBZCGBUECAABBBSEHHhBAAbFGD.KGGDhCAAPDAB.fHAB.dHDB.hDAA......hDBA...,1,6,-21,27
MTDVAaLPZeGXUgbRHOSfEcFJYdBQNKCWI,aAAAZAAAeACEGACAUAFARAEA.HCCC.OAHFEBHFFCFD.dEAAQDFAhABACDHA.MEIBhCAATEDAAFFBLHEAhCBA..XFGA.SBBDhAEA.fGFEhAFA.YHAABGGC,2,-11,-2,9
QNJYdRGbXeUFDKgaCWVHOfTPELZIMScAB,QAAAJAAA.RACAGAFAeADEDAGAaAHFCBDA..HBFC.OCCBhBAATCDA.EDAAZDEAMDHBhAAAADFABFFAdFAAbFEBFFHD.hBIAKGGD...WHBA......hADA......hAFA...,1,-1,-34,33
AUKOMegSGIEBXcYVCRDZNPHdTbJaQFfLW,OAAAeAAAGADABADA...XAFAVAFARCCA.ZCFEHDFAdDBAbEFAhAAAaBBC...FFAHLFAAhAFAAAIBMDDB.SEEDhAIAEGCBCGEADGGB.TGGA.fHDBhBAA......hCAA...,2,-14,2,16
JGFgXDQSEcPYLKRTCZfWOeAUMBNdIVHba,MAAAdAAAHADA.aAFAGACB.XAGBQCBAEBBB.PBHDhACALCFA.RDCAZEFBhAFAOCFBAEIBBGCAIEGAhADAbFGD.FEDDDIBASFGA.KGCD.hBAACHHA......hBIA...,2,-7,-4,3
DWcXfQJYTNZabSGERACUIdOgVLFHKPeBM,CAAAdAAA.OADALACAHAGBeAFHDBDB...XBGDQCEChACATCCAaCBDGEBBhAIA.ADIBUFGAgDABhAAAKGBAMIBAfEEA.YEAFhADA.bFGBEGEAIHEAhAEA..,2,-7,-6,1
JHegBLXFdQVUScMNGaZbTACOfKYDRPEIW,OAAAKAAARACF..EAEEJADB.HAFABAGBLCFAdCAA.UEDAMAIBhAAAGGEBZCDB.AAHACBBDDCGBhACA....IFAAhAFAeCHDFFED.QGGASFFE.aHCChBAA......hCAA...,1,-20,-24,4
GeYHbMEAXPFRZaBVKfTILgdScQNUDOJCW,FAAARAAAZADBBADAKAFA.....TAFALAHBdAHA.QCFAhAAADCCACCEA.eCCDHDAAEDABhABAADGAaDGE..fEEAhADASEEBcFCCOFAB.JFHBYFGBhCAA.MEIB.hADA...,2,-33,-5,28
DaNPZFfXVTgMAeEGLOJbQYBSRWCIUdHcK,EAAAGAAALADAOADAQBGABAGARCDA.CBCD.dCGAHCDADAIB.aEAAhAAAZEBBFEFA..XEFChAAATFAAAAHA.eEHHhAEAJFHB.bFCD...SFFD..hAFA......hCAA...,1,4,-27,31
IYZDObWCEScKdMNPFHReVLUaAfgQJXTGB,QAAATAAA.GACBBACBZADBOAFACAFA.EBHFKAHB.dCCCMCDBhAAAFCFAHEEARCEBeDABLEHBhAAAACGBJDHB.XGEAhAHADEEBbGFA...WFDD.....hADA......hCAA...,1,-1,-14,13
cGAdYQHEVTRFgCPNMKIeZaWLJBXUOSDbf,dAAAHAAAEADARADFCAFB..MAGBeAGHZABBLDAABAHA.OBHDDBFB.hAHA...bCGDGEEAhAAAACEB.QFCAhACATDCAFFEBNIABaGHB..XGGA..hBAA......hCDA...,2,-26,5,31
JKTRfQOCSANYVdEXcDBFgPbZUeaGMHWIL,VAAAEAAADADA..FADA....bADAeAFHGBGAHBGBLCBAhAAATDCAREFBQDEDhAHA.SEHHhAIAAAHAdFHABCDBZFCAaFEHMIBA.IHHA.hAAA......hBIA...,2,-18,4,22
DWIGOFJbfQcZdSRUVLNaTKCYPEgBAeMXH,eAAAHAAADACAGADAFAED.JAFAQAGA.dCCARCFALDBBhAAA.aDDHTCFAhAAACEGAEFEFAEIBMDIB.XEDAhAGAIGGAbEGDfGCA...hBIA......hCAA...,1,-14,-16,2
FbSZMVRTPELQdUKCXWeHBYOGagINJADcf,DAAAFAAAZACBRABA..EAEEdAFA.CAHA...eAGHHCFCOBHDGEBA.hAGAaBEB..ICDAhAIAAEEA..bEFAMCFBhBAATGEALEGB..QGGChAHA......hBAA...,2,-29,-14,15
IDdFfJgLQMHUZaSeGVCbKBAYcOXWENRTP,OAAAEAAARACA...TADADAFAdBGA.FCCHJAFALCFDHCCAaCFAGDAAhAAA..bDFAAAIB.hADA.XDGA.hAIA.PEEBfEDAMBBBZGFEeFGF.CHHA.hCAA......hCBA...,1,-7,-14,7
OfBcJMdCGZHPVDLIYgeKEWSQFbXTNARUa,RAAAaAAABADB..MADAGAEAHAFCDAGALBBA..gBGBhAAAECEAQDBAhAIAFCCB.bDEA..TEDAhABAACIBfFFAdEHAZGDAIHHAeEHHSGDBhBAANIBB....hBDA...,2,-16,-6,10
PJMeEBYUOSCGacWNTILFXQADbVRHKZfdg,DAAARAAAHADBZABEdAFA..PAFAeAHBBCCAOBHDGCGA..hADAaCCH...cCFBhAAATECALDABhABAQEECAEEBbEGDfFBEMFFB.EGGBSFBHhADACCEDNIAB...hAIA...,2,-20,5,25
NRcMYVbEfFDZHXgPJTKWBUGOeISLQACda,aAAARAAAMADA..VADAEAGA...DAGAHBDA.XCFAJBBFKBGABDADhADAGEEA.eCCBhAAALDDAABIBdFBAYDHBhABAFDHBZFDA..PFHD.....hBFA......hCAA...,2,-28,-4,24
CJWMGZQUXYFAeOSDBaNfHIEbTPgLcVRdK,eAAADAAABACA..aADDHADBEAFA...bAFATBGA.LCCAhAAARCFAdEEACBBD.MDBBZFAAQGFAhAFAXDEAAAIBSDHHhABAIEHAPHACgFFG.hAGAKHEA.WFAD..hAFA...,2,-16,-10,6
COMRgHBAGPTbVfeIXWaQSLJZFDcUKEdYN,GAAATAAA...bADAeACE..XBGDaAFALBDAZCDBDADAhAAAKBHBEDCFdDDA.CDGARFDAHEGBhACAACCB.fFEAhAHA..IFHA.....hAIA......hBAA...,1,-10,-22,12
MWLTJKRVaEXOSIQfdAeYPZDUFbBcCNGgH,eAAAZAAAFADABADA.CAFA.GAFAHAGBMCCATCAA..RDDAEDHFSAHBhABA.QDDAhACAAAAADFAAUFGBbDGDNIAB.hAFALHBA.KECDaGDAXGFC.hAIA......hBIA...,2,-20,1,21
cGPFEXJfDKINVaeLBOSCTYARMQZUdWHgb,RAAAZAAAdADAHAEA...bCABGAFA.EAHBfBHAKCCD.hAAAIDDAaDEBeDGHLDFAhABASEHHTFFAhACAAAFBMFFBQGAA.gECGhADA.....hABA...,2,-27,11,38
aNcFJbAYUBVLgfQdKISPZCEMHRWXODTeG,BAAALAAAQACAdAEASAGAZAEBEAGAHCAARCAA..OCEEhABAeBHFaCFDFDHDAAGAVEBAhAAAKEBA..CEEA.MDIBDEGB.hACATFFA..NHCB.......hBEA......hCAA...,1,4,-28,32
VWTXPJFfIDQaNBHUCLSKReZcAGEdMgbYO,EAAAdAAAMADA..bACAOAFE..TAGAXBDCFCCADCGBhAAAaCAE.HDAALCGBhACARDGFeEEBACIBGEBAVGAA.hADAPDEBfFDEQGEABGGD.SGHBhAIA...hAEA...,1,0,-2,2
KRgFNDJMUVTeXHdPSYGIQCOWbfBLaZcAE,RAAAFAAADADAMADA..UAGAeAFAHBDB.dCCCSBCAGDFAQFBAhAAAOBHDbCDALEHBhABAZDBA.EFEBKEGAhBAA.gFCBNIBB.TGGA..hBDA......hCAA...,1,-1,-17,16
LPATNecVWMIDBJaUYdHFECgRQZbKGXOfS,eAAAVAAA.MAEABADBUBDAHAEB..EAHFRAGBZDCAGCFA.OCCHhAAALEGB.AAIBTGAAhAAANCIA..IGBAhABAaGDA.dHDB.CEEDbFGD.....hAGA......hCAA...,1,-1,-21,20
ZcCAdHKGBDOLRFXSJefaQVTNIEYbPMWUg,HAAAGAAAOACARADAFAGA.SAFA.eAHHaCDCTCGAhAAA.EEABbCCA.MCGBhAAAgEEAZECAACCAdEHADEIBhACALGAAXFCDfGGEQGGC.hAGA......hCAA...,2,-2,-2,0
MKaUQIBSVHPfONFTAGDYLWbcRdJXECgZe,GAAALAAA..bADARADFdAFA.EAHBZAGBeCABaCDA..UEABQCGDhABASCHHHDEBhACAODDBTGGAAAABDADAhACAcCCCCEFAMFEBBEHDfFGANIAB.YFHBhBCA...hAIA...,1,0,-2,2
FdIcSRMgeHEXWAbDUGQCLVTPJYKaBOZNf,DAAAGAAALADA..TADAJAHBKBBAaAFA.ZBFEFCDDdDCA.SDADhAAARCFB.eDGBhACAHEAAEEEBAAEAbFCAQGBAhADA.CDHBYFHBODHDIGGAhAHA.....hAIA...,2,-25,-3,22
dXfBNCSDWgUZQJIVcKYaTbOMLHAFREGeP,EAAAeAAAdADABADA.CAFA.DAFA.UBFAZAGBQCCA..hAAAICBAKCEB.aAHDhAAAbEFAMDDBHFAAREEA.GGCBhABA.fGGBSEHB.gGGBhBCA...hAFA...,2,-30,-14,16
LBXSMJYRKHabTWANPQEZIFCDGcOUfVdeg,QAAAEAAAZACB.CACAGADAOAECUCEAdAFBLCGBBAHBMCBBhAAARDEFHGBA..aCGETGGAhAAAAEDB..IEHAhAGADAIB...fFFA.eHCEhBCA.SGHBhCAA..,1,-13,-19,6
XbKOAJeQCFLWDNcIYUBdHaVfPGgMSTZER,eAAAQAAALAEADADA...ICCABAFAHAGBaAHDVCEAhAAAGBDA.MDBBZDBAREGBbDFAhAAAAAFAFFFH..cFCAhAIA.dFFA.fHGF...hABA......hBDA...,2,-15,-4,11
dHDFRQacXSUEeGOITPfVBAgJNWLKCbZYM,JAAALAAA.CAEAZAFBdADAHAFA.RCDAQDGAaAHD..hAFASCAAEEFB.hAHAeCEDOCCHTDGAhABAfGHAACAANDDA.KHCAbEAB.MFCB.FFGHhACA......hAEA...,1,-16,-17,1
JMDLUYKIRNFVXGCbESBgecZPHdaOQAWTf,TAAAMAAALAEA.KBBARACFFAEAGCDAEAHBBCADeAHHZCFFHCDBhAAAaDBBACFA...fFAEhAFADCHBIFFAXFFChAGAbGDC..SHFA...hBAA......hBBA...,2,-16,-13,3
gbAIQNYUHSdWcaEZRPfKLXMTDGOJBeVFC,QAAAUAAAHADAdAGAaACE.RCBA..KCFDMAFAGDGABBEA.eBFHhAAACDAD.ABHA...IFAAhADASCDD.ECHBhADAfEEETEFAOFHDFGEH.NICB...hCAA......hCIA...,2,-20,-17,3
bfMQWdLgcaFGIPROTUCeKBNJAVSHDEXZY,HAAAEAAAZACB..bADBMAFA..dAGALBEAaBFBGCCARDEATFBAhAAAeBHHBCAD.ACCBDEFBhAAAfEDEQEGBhACAgFGAFGDDIHHAOBHD.CCBC..hAIA......hDGA...,1,0,-8,8
bBGFKSDLZeXdTcgVWfEQJCAIPMYONHUaR,MAAAOAAAHACCRADAGAGASAFB.ZAGBeBBBdCCA..TEDAhBAAgDCH.fEAAhAEAEDHFQFGBhBBAAAIBIEFAPFCBUGDAaGED.FFHB.DGGB.hBIAXGAA..hAGA...,1,9,-11,20
dWGfIPBNVYObKDEZgaRJCeFHSMTQcULAX,dAAAGAAA..fADABADAVAFAOAEDDCDAZCFE..RAGBeCBFhACAHDDBMDAB.TFGAhAAAQDDC.hACALEGBADDBXFADIFFAPHECbGAA.hADA......hAFA...,2,-13,-10,3
WFDBagSdREfYeTcGVLHbNCAPKJQUXIMZO,KAAAQAAAUACA.MADAZAEBFAGDBAGA...aAHDdDGA.EDDBeBDBhAAA.GCFAHEBBCFEAhAAAABEAXFCA.hAIAODHDDBIBRGEA.fGHE.YFFFhBCA....hCAA...,2,-28,-21,7
aDACbSVRJdGTcKMeXUIOfPEgFQLZYHWNB,SAAARAAAGADAKAFAeACH..UCGAOAEAECCB.QBEChAAAZDAFHFDABAHBAAIBCBHDbDDAdDFChAAA.MFAB..fDHAhABAFFHB.LFFANIDB.aECC.hABADHDA.....hADA...,2,-6,-3,3
eEMPSaGABfCcNUWODIHJTZdgRVFQKYXLb,CAAAUAAADACA.HADAZACE.RAGFFCDH..QAGAKCFDLDABECDAMCGBhAAA..aCHDADCBBDEAhAGA..fEFAhADANDHA.OFHBJFFF.gGAAhAFA......hAGA...,2,-35,-18,17
JQFYdTLgcbGSBCOIaeURNZfEAWXPMKHDV,XAAAMAAAHACCDADAQAFC.dAHATAFALCCBbBCD.hAAAGDGABAHBOCFBhABAeBBDREDFNIDBECHBAGGB.KEBD.hBAAFEGB...cFGD.....hCAA......hDAA...,2,-17,3,20
TKUNWAZgPQfbVBaCcGXJHELFODIdeMSYR,ZAAAQAAA..bADBaACEGAFAHAEBEAGALAHBDBIBeCDBhAAAMCABRCGBKDAAUDDBAEGB.fEGAhABACFEA.XFBChACAOFHDdGAASEHH.YHBGhBFA....hBHA...,2,-12,-1,11
QWTBYbUeJHaICSXARVOMGPFdDcEKNgLZf,RAAAMAAAGADAdAEADAGAEAFA...KBBALBHBZBFB.QDAAhAAABBHAUDBAHDEB.aCGBhABASDEDADDBOFABFFHBhADA..NDHA.fHDB..WFDAhBAA.....hAFA...,1,2,-43,45
EIGNFVQPaHfTgKYDJCcXSbUOdeRAMLZBW,ZAAAEAAAGACAFADA.QAEAHAFBTCAAKAGADCBBCAHA..SCEDhABAOCFEREAAAEEAMCIBhACALEGBBDGAIFDAhAHANEIA..aFFBfFFA.YHFGhCAA...hAAA...,1,-14,-15,1
CEYWVMSaAXgeOGQZBTPHJNIFcKfRLDbUd,eAAAGAAAZADBBADAHAFAJAFAFCFH..KBFDRDBBLCHB.DEEBhAAAdCDAEFFBVCGB.aDAHhAAAAAHAOHDC..hABATFEAIHHAfGHACBCA.MIAAhACA......hADA...,1,-5,-33,28
YdNZBQReMaDcSFLUEPCITgXVOHJfWKGbA,dAAAZAAARAEAeADADACA.FAGDLAHB..ECBACCCD...TCEAhACA.XDACHCFBfECAhABAGDGAAAIBBDDDhADAaEDDSEHHIGEA.OFAB.KFFDhAFANICB......hCAA...,1,-10,-25,15
AGYdRVbTSOHZXPfQJLBMaWEFCgIcUDKeN,dAAARAAA..TAEAHADAZABB.XAGBQAGCLCFAaCCAECHFhAAACDCA...IDAAhABADEEAeEFAADDBGDFAhADAbFAAOFHDfFDAMIBA.FFHD.gEAAhAEA....hAIA...,2,-1,-1,0
XIDYGATJZKWfUadOFScHRLeMBPgQbNEVC,ZAAAKAAAUACAdAEAFAGAHAEALCABBAHB...QCFAECFA.hAAACCCD.DCIBGEBAADDATEEAhAGAJDEF...aDHHSDHBhABARGEA.eFHB.....hCAA......hCBA...,1,-12,-31,19
LNQMSOaFZfXcYTKRWEIeDCVBJGgdPAbUH,HAAALAAAMACAaADDZAEE...XBGATAFARCAAECCB.eCEFhAAACAHBBCEAGDFAdCHAACAAbGAAhAGAQDFAFFHD.hAIA.fHEBKEEDDFAAgFGA.hCAA......hCDA...,1,9,-17,26
IObdFYMAHfJSgBLeaRQKCNTDEPVcGWXUZ,HAAASAAALADBRACF.QAFACAEB.TDEAEAGAPBHDhAAAGDGA.XCAAhAAAZCDBOCFDdFAAMAIBhACAAEHBfFFEBFCAeGDAaFHDDGAA...WGAAhABA.....hAFA...,1,7,-17,24
HaCcVfdAUZKYOWRDgJNBTIMeQXSEGFLbP,ZAAAOAAARAEADACA..JADBBAHB..MAFAeCCB..QBFAhBAAECEBGCGALCHBhBBAHFAACEED.fDEAhBFA.ACCBKFFAgGCAIHEAFGFBaEDH.hABA......hAFA...,1,-18,-20,2
IEGZXCcNgfRLeOQPTJdMUFKSBVabWADYH,HAAAEAAAZACBCADB......gAEHRAEAeAHHQCEBhAAAJAHBdCADMCGBKDHBBCBC.hAAAbEECADDADDFB.GEGAhACAXFAAfHABLHAAOEEHTGEAhAFA.SGGBhAHA...,2,-8,-8,0
CUBfWPGSDHcQILbOXZaRKMeNdFgJTAYEV,EAAACAAABACA....fACAGADAHAFAQAEALCABhAAAbAGDZCFE.REFAeCCBhACAdCDAFDFHTGEAAAIBUEAASFAAhAFADEHBOFHDaHAAMICA....hAAA......hAEA...,2,-11,2,13
FeRBOgLcEQYVCXKIaDMbGAHZTfNUJWdSP,HAAAZAAA.TAEAUAEAdAHAFAGABCADLCABECCA.QDDAhABA.CCCD.KCFA.aCHDMDGBhACAADEBfEAAhAAA.JEFBSDHBeHCE.REBFOEHHhADA.YHBGIGHAhACA...,2,-19,-9,10
ZXMJgceAPESIGNUBWbfRDCQYVTaOFKLHd,EAAAGAAABACA..bADARADFDAFA..QCDA.TCGAhAAAaAGEKCCDHEACZCFAMEEAhAAAgEGAACGA.SAHBhACAIFFA.WFDHCFHAOHFAFGHD..hCAA......hCBA...,2,-38,10,48
cFXCDMZIaTbESRBAJUOeQgHGLPKWYVfNd,OAAAeAAAHADAGADALAGBKAFA.VCCBdAHAFBBHDAIB.ZDEBaCFBEDGAhAFABDHA..ADDBQGCChBAAPEFD..hBDAfFAAXGFAMEIBIFHA..hAAA......hABA...,1,-6,-19,13
DYEUPaTgHKcfGMXFSOVIQLdABCeZWJRNb,eAAAZAAARAEADACAEADAUAGA..aAHDHBEB.KCCBGCCBMDHBSECAhAAAODFE.QGBAhABAAFAACFFA.NEGA.hBGAbFAA...PFHB.....hBIA......hCAA...,1,-10,-28,18
CKGNEPORMVYAFBLHfQSXgUDeJWTacbZdI,LAAAHAAAQADCXADDDAFA.eAHFTAFAaBFD..ZCAAdAHAhABAKDHBECAAREDA.MDDAAFCBBFGAhAAASDFA.hACAgEEG.UFAA.WDHHIHHAhCCACHFA.NICB...hCFA...,1,0,-13,13
AfaBZWdCMHOPDNTGQEFJIVUeKLcbRXSgY,aAAAZAAAdAEAHACBDAGAGAEB.FCEDVBGBeBBDLCAB.RDDA.hABASCGA.hACAAAEABEFAMCCBOEHDhADATFGAEHAAIFFAKHCA.XGBAfHEBhAHACHFA.....hBEA...,1,-1,-22,21
LfYTUZdbDPcNMWaCBegQEAJGRXOIKVSFH,RAAAOAAAKADC.FADDHAFALAFA..TCCAdCFADBBB..PCFBhAAAMCCB..aCHBeCHBhABA.EECBAAGAGDDAhBAAXEGDSDHH.fFGEhCAAZGFANEEABHAA....hAHA...,1,-10,-20,10
UYdMSBTafIeWPDKJALGZQOVHFcEbgRCXN,ZAAAQAAAHAEAEBHFRACA..CAFB.UCAA.dDDAMAHBBCFA.aDGEeCDAhAAA.DAIBAADAGFEBhABAFDAA..bDFAXGAAhACASECA.TFFAIHHAKGDAOHFEhADA....hCAA...,1,-10,-15,5
KWHeOgbCENBaIAZVYJfTDFUXRcdQSMLGP,ZAAAVAAAJADA..DADAFAGA..RAEA.dCAAMAIBGCCB..KCDAHCGBhABAeCFHOEFB.hAAACFCA.EDCBBGGAACHBTEGAhAHA.UGGBXGCASEED..hCAA......hCDA...,2,-22,-22,0
BVSbeaQAZOWJXTUMIEKHgPCLcfGYRdNFD,ZAAAOAAAJADA.UAEA..EAGEHAGD.CBBDLBDDGCAARCCAdCFAhABADCIBBDFA.SEFAhAIAeCHBACABTFFAhACAMFDBKFHB.....cGGCfHEBhAIA.....hBAA...,1,-14,-30,16
gKZPLYSUeBCaNIFQTOcHdMbRAWfJEGVDX,JAAAEAAAGACA.DAEAKADCZAFELAGB.SBDAhAIAeCBBaCGAFDFAQDDAhBAA.TEGAHEDAbFGDhAAAABGBVGEAPHAA..BCCD....hBIA......hCAA...,2,-28,-1,27
VTfXSRdLDgaFEOJNCZKHQBGcPeYbMWAIU,VAAATAAA...SACBRADFdAFALAHBaAEA.EDAA.ODDBhAAACAHAHBDB.GCFAhAAAeEFAMFEBABFBfCHEhAHADFIBFGGB.ZFGBBHBAYCCF....hCAA......hCIA...,1,-9,-10,1
YMJTFIXadAGCQOWBgUecZHEPRLVfSDbNK,GAAAQAAABADAeACAHAEBRAFA.LAGBSCDADAIBbDCBKCGAMDABhAAA..TEEAhAAAXDCCADAB.OEFAhADAgEGBZFFAEGAAfGBANIAB.FGGHhACA......hADA...,2,-12,4,16
dRaXMBKVgbeFTHSDONJPAQUCWIGELfYcZ,QAAACAAAGACALAEA..fACFZBFERCAB.aAEDMDGBhAAAKAGA...bEDDeCDBhAAAHFACOCFC.hACAPEBBAAFAIGHAEEGAdGEABHFAFGGADGABNIAB.hAIA......hBCA...,1,-5,-7,2
LSNgJMaZIRUOFVYBTCEQPbeXGfcKHWADd,dAAALAAASADAJAEAZBEARAFF...FCAABAHB.ECBAQDCAhABAeCEBGCGAKDGDHEEBhACAAADADDDB.MAIBUGGBOEHDhAHA..YEEFCHFA....hACA......hBAA...,2,-21,-11,10
PLFbdUceCJZXTBIKfGOYHSAVDRgMWQEaN,RAAAMAAAEADE...aACELAFB.dAHAeAEHZCCBBDGAKAGAGCCAhAGAHEDBAAAADBBB.QCFAhAIAFFFA.bEFACGHAJHBAhBHA..TGGA.OFEB..hBAA......hCAA...,2,-19,-15,4
BGHPSZcYQTbeMCIaJLRWANEVODUfgdXFK,EAAADAAAUADAdADA..KAFAHAFAZBFE.QBBAeBCD.MCHBaDBHRDFAhAAAAAHA..ODEB.hAFAXFFCGEDASFHBhAHA.cGGCYFDF.CGHA.hBAA......hBBA...,1,-12,-27,15
aUFTANRCcZLXeQVBMPOKYJdSIHfbGgEDW,RAAAZAAAeADEQAEABAGB.MAHBKBDAdCGAHCAAGDDAECEB.DAIBaCHDhABA.FEAHAAAA..CCCD.LFFAhACA.XGBAhADAODHDSFGDbGECWHFA....hCAA......hDAA...,2,-36,15,51
CJIBPgVUNbLYEdFcADXHaKefTWOSGRZMQ,HAAAeAAA.TAEASADARAGFZCAA.MAGBQDFCCAHABCCA.VEAAhAAAUDFBLEEDEEAAdEDAAAAAhAEAaCCAKFGDODHD.hAHAIGGAPHCANCIAbGAA......hACA......hADA...,1,15,-12,27
cNdUIeKJWPGTHARQEgZBMYDXLFCfVbSaO,EAAAZAAAMACADADA.LAGBCAFA..VBCAaBDD....OBFBhABAdAHAeCBBKDHBJEEFGDEAhAAAHGBARDGBQGCAhBCABGGA.FGGHSCCD...hBHA......hCAA...,1,-12,-20,8
WBDeFRQJVCfaXISPLUcGOMTZgKENAdYHb,HAAABAAAeACARADFQAFCCAFA..aAGDSAHBLCAAGCEAhAAAMCABZDABKCHBACHBbDDAhAAAFECB...JDHBXEGDhACAIFDA.cFFCTGDA....hADA......hAIA...,1,5,-25,30
dBbRCGeHIAKETNgSVYMJQPZDWLcXUOFaf,EAAATAAA..SACAMACA.QAFAZADELAHBXCCAhAAAFCCHdCFARDABeBHHhADAHECCABHBKDFBgFGAhAAA..VFCAYHEADEIBcFFD.hCAAaFAH.BHBA.CHHA.hAFA...,2,-7,-2,5
KOEIeHJYgRbABTUScMWFZXCGdDQLfNaPV,TAAASAAA.MADAZACBGAEA.dAGBLAHBaBGDKCADEDHFhAAAHBCA.gBFHhAAAADEBBEBAUFGBFDEHDEBAhABAfGEAPEGBOFBB.eFHH.hACA......hBEA...,2,-14,1,15
UDWAfRTKJBHQXegVEFObSCNMaIPcZLYGd,RAAATAAABADBHAEB.eAGBEACEOAEA.CAHA.aAHF.ICCAhAAAZBFAGCCA.dEFAhAAADDEBACCBKDHDQDFDhABAXFDDFFGHSGHBMDIB....hCAA......hCEA...,1,-14,-15,1
TUQWcNEZDKeYSMJRIFHPBaGCdLfOAVbgX,VAAAXAAA.UADAQADC..NAGA.EAFEZCGBeAHHMDBAhAAARCDAHEFA.aFEHdEEAhABALHAAAAHATFBADGHBhAAASEHH.FGGHBGCCCHBD...hBDA......hBFA...,1,2,-19,21
WaOIQNUDbdTgEGAJRFXHfSZMcBPYeVCLK,RAAAHAAAZADBBAFAeACELAFB.aAHBQBGADBIB.dCCChAAAECCAAAHAFCFHSDEDhAAAMDAB.PDGD.hABACFCAOFHDIEHA.bFFC.....hCAA......hCCA...,2,-28,-13,15
AeFNHfQPCKRUWXcLOaSYdJTgZbEMGBDIV,eAAAHAAAQADCKADARAFF.XAFBLAHBaAHDdCCA.TEDAhAAAbCACGCEABEHADFAAhABAADGAfDHAUGFAOHCAhAFASEDD.gGFA.hCAAEHBA.....hCBA...,2,-19,19,38
HbXVCRWNafPKgTGMLBSZOEeQAIUcJdFYD,UAAAdAAADADAHADA..XAEARAGFaCBEKCEAGBGA.LCCAhACAZDAAEDHFAAFAJDBF.FEEAVEEBhADA..CAHB..fFHAhBAA........hBCA......hBDA...,1,-20,-29,9
KJfOdQFYCMPWHDSTegZbNXGRcUEVaALIB,LAAAKAAAOACAdAEA.QAGACAFA.MCAAHAGB.TBCAhAAAeCFFZDDF.bDGDGCEAhAIAREBB.EDHFADIBBGAAhABAFEDHPFHDDIBA.SGFH..hBIA......hCAA...,1,-5,-19,14
TcQGNWDLHabdAIKgRZSPJUYXCeBFVOfEM,KAAARAAAZADB..SACBUAGA.CAEAFAGAOBFH..EBFFMCCBhAAAQCCBGDGADDABhABAHCGBdGBAACIB..gEAAhAAAJEEF.eEEB.fGDAhAEANIDB.aGFD.IHHAhCAA..,1,-3,-25,22
TaNCJGKgWXRbILUBcPODEZFYMAHefQSdV,HAAAeAAAQADAdADAaAFA.CAFA.GBEAKAHB.XBGARCCBLCGBhAAABCADOEFHECCBZEFBhAAAMDIBAEEBSEHHhACA.TGBAgGDDIHHAPHAChABA.FGHH....hAHA...,1,7,-8,15
OgLaCTcbfMXVSFGHYIKUEeAdNBZJQDWPR,dAAAZAAAQAEADADARAEA.LAHBaAHD.TCAA..bABDhAHAMCEB.SDFBhABAHCECKDHBEECAAACABBGBhAEAPEFBCEHAXFED.FGGAIGHAhBAANDDA.OHFC..hBDA...,2,-23,1,24
KXMBSEFZgDVGfCOdJTcWeHbNPURYLIAaQ,aAAAQAAA.MADAEADAZAFB.DAIBGAGAOBBBdBDA.TDEAhAAAeBHDHCDB.hAIAbEGDPDCB.RFGBLGBAhBCAABFBBDCCFFFBfGFE.CBFC.hBIAWDAD....hADA...,2,-20,7,27
fIHZCMWSBcDNaFgYLVRUEKJbPTOQedXAG,GAAAHAAAZADBMADABAFADAHBaAGD..FBFBLCCDRCDB.ECABbDBDhAAAOBHD.eDEFhAAAAAIBCCHA..SDFHhACA..gFFAUGGAKHEC....hACA......hADA...,1,-15,-18,3
dKFMNOPSgDCfIAaJGeXUVTZLHbcWQEYRB,GAAAeAAAUAEAZADAHBGB...bCDBQAGA.RBCBdDFAhAAAMAEAODHBSDFDhAAACEBAAEEA.aEHDXGGAhABATGEAWDDD.BHHANIBB.DAIB..hACA......hBAA...,1,-7,-19,12
caGbWARVSXUJZIgYfBNHKdLMPQTCeDEFO,RAAAXAAAZADB....IAGA..fADAhAAAHCEBdCCCMAIBTAFAeCGBhAAAEBHFOCDCGDAAADABSDAAhABAgFGABDHALHCAQEEAhADA.FFAA.bFCD.hABAWFHB.,1,6,-26,32
FVYPDaKfNJZEcSQMUGWegdXbBIROATHLC,HAAALAAAFADA.VAEADAGAKBFA..JBHBECAB..QCAAhABAGCCAeBHHdCDAbDFDREFBACCBCEHAhAAA....aEACfFEEhACAZFDBMFIBWHACBHBAIHHAhBHA......hCEA...,2,-15,-4,11
SAPeKIEJMGRbZHUOXWQcVCgDFaNYdBTLf,eAAAEAAAGACARADAHAGBOAEAQCCC.CCFD.FAHD.aBEDdEAATDFAhAAALEEA.AAAAKFHBhAEAMCBBZGAEXEBDhBCAcGEA.DDIBBHHDSEED.IGGAhBEA.JHDA..hCAA...,1,3,-11,14
ATgaDFHGREMZUfbLQVdNSOPBYeCKcXWJI,aAAAHAAAGACAEADEZAFBUAFALBHB.dCADOAHFBCECeDCFhAAAKDFA..XEAAhAEAIEEAABBBDEEBRFABMEGBbFFA.hBAA.....NHDB.SFHB.hBEACHCA......hBFA...,2,-22,2,24
JNQBUCaegAcIXMOSLEFHDZKPfYVbdGTRW,XAAAMAAALAEAHADAZAGBKBBA.....fCDEhAAAbBFAGCDARDAAJDFFQDBAhAFACDHAeFAAAAFAODGB.hABAEEHFDFHBPGAAVGCA.dHDB.....hADA......hBIA...,2,-3,6,9
QFVbBScDROTAUZLaWJYHXdPGKfCgNEIMe,ZAAAaAAA.JADAHACB.dAEBGAGACAHA.ECAAeBBD.QCFAhAHAFCDDBCFDDDIBREDAABFBLDHBhBAA.XGGChCAAfEFA.gGAAMICA.SFEDhABA.TGGAhACA..,2,-29,-5,24
RMPQWgGaVecASCUHJBOfEZNKbYDXIdLFT,CAAAHAAABACAEADEZADBKAFC.DAIBdAGA.LBFDRBGB..MCABQCAAhAAAGCCAeCFBhAAAAAIBUDGAfEHAhACA.bFEDXFFC.FGHD....hACA......hCAA...,2,-31,0,31
AGDMHNQFaPgIVcREJLZeSUCTYKBObfWdX,GAAAHAAAQADCaADA..IAGARAFFEBHFZCAAeAHHCDFDTEDAhAAABCDAOCED.hACAbDBDdEHAAAAB.MFABFDHDPFGBhACAgGFBcGCD...SGEHhBCA...hAFA...,1,1,-3,4
XIbFNJgceaVKQBWESZYAMOLCDUPRfHdGT,MAAALAAADAEA.RADFHAFBGAGA..TCAAXBBAFAHFJDDFeBEBhAIA.KEDABDGA.EEHFhABAZFBAAFAA.CFGA..fGFEhBAAbFED.NDIA.aFAE.QGGBhACA......hAFA...,2,-18,-5,13
VCMGIYNcOZfXQAHSWbKeDgdEJFRTUaBLP,HAAASAAAKADCeAFAdADAFAFARCAA..aBGELBFA.CCCDGDEAhAAAICEA.NDGA.ZDBEhABA.QDGAhAIAADHA.DGDBEEEBTGGABEHAMGAA.OHEChAAA.....hBDA...,2,-13,-13,0
ecMPICZULOaNfHRAKXEBdVgJWYFDbGTQS,EAAAdAAAJADAFACD..GAEA..TBGAeAGBMAIBCAHB.ZDDFLCCAhACAODFDaEAAHDEChAGA.ABDBBECA.gFFAhBAADEHBSFHHIHHAfHABhAAA.....hBCA...,1,-9,-32,23
cJYgBeIbAKHQRGOVZdDNEafMTWCPLFUSX,HAAARAAAGADAZADBdAGAEAFA.aBFB..MAIBCCADLCCDFBGD.UDGAhAAAXDAA.JDFFBEEAhACAeDDDAAIBQGEAhADA.DGHBTFAA.SEHBhAAA.YFGBhABA...,1,-12,-18,6
LURNJbXMfPEVeFTAGDKQYcZSWOaCgHdIB,GAAAQAAAZADAOAFAaACE.HCDAdAFALAHBRCGF.bCDChAAAMDCB.EEABeDABhADAAAABKEFDSECAhBFACFHABGGD.UEGAXFCDfFEA.FHBADIBAhACA......hAEA...,2,-8,5,13
dSPDYTfgcLZXQANCWKRGabFOIJHEBMVeU,CAAARAAAGADAFACA.OAFAHAEBEAGA.BBCDeBFG.dDAADBIBTDFAhAAA..fCGAhAAALDHBZFDAADDAKEEAaCCHhABAIEHAMIBASHFAPGAA..gGGAhAGA..hCAA...,2,-37,6,43
VTaYedLAPNJUXOZKGQcWEIgfBSDbHFRMC,JAAAOAAAGADA..QADAEAFA.IAGABAHAbCFAHCCAhAIA.RCFFMBBBCCCDaDAB.hADAeCHHLEFBAEEBPFBBhBAAXFAAZFFAKHCAgGCHDIFA.FHGEhAFA......hBAA...,2,-17,9,26
XGVKcOUaWbEgYRAHJFDLdfeMCBTIZQPSN,HAAADAAAdADAeACEBAFAZAFB.QCCA.SAHHhAAAGAGAKBBBODFEaCEDEDBBRFAAAFAAhAFALDDDMFFATGGAhBHA..IFAA.XEFDhAFA......hAIA...,1,9,-40,49
TXZGRVALDYSFJOHKCcaUgNMIdbeBfPQEW,LAAASAAAOADDHACBCAEAUAFA..MAGBdBHAeCABBAHAQDEChAAAECCB.hABATEAAGDFAACHAFDHBhABAKFBAaEEBgFGAIHEAbFCDfHGFhACA.....hAEA...,1,-4,-14,10
JYFZecRCOSHafNGKQBETbPUVIdWXLAgDM,MAAAFAAAeACHRACA..OAFAHAEAaAGA.GCEBQBFDBDDDEEAAhAEATDDAUEFBdDGDLHCAhBAAABBBDCCBZFFASGGAhCAAKHFA.........hBAA......hBIA...,2,-23,2,25
bYVBgSMaKXCWHGfANDJPecFZUITLOERdQ,DAAAeAAAZABEUAEALAFARAGB.dCCAQBCA..bCDDBDEAhAAA.MDGBaCFACDAAHFGBhABAAAGA.NIAB...PDGBhADA...FFHDODHF...hBAA......hCAA...,2,-31,-12,19
ZePJHWgAEdCTYaQGLVXOFNRKSDfcBMIUb,EAAAdAAACADA..aACDGAEALAEA.OAHDRAGBDCCBBDAA.UDGBhACAeCBB.HDDAAAIB.hADATEGAQEDChAGAFFABSFCHMFHB.IHHA.PFFBhAAA....hAFA...,1,-11,-30,19
TYbNEGAPgcKSBOHXDeLJMVafZCUWFIdRQ,...PAAAKAAAOACAHADADAFAeAFAMAIB..aBCDZCCACBHAFCEAhAAARCGBQEEB.hAGATFCAbDEA.EFHFADIBSEDDhCAALHBA.fFFA.hBAAIGHA..hCBA...,2,-39,6,45
FDXebGAPdYSfRBVaUMQCWHcEgNZTKOJIL,dAAASAAARADABAGB.UADA..MAIBQAFAHCACECFAZCCAODEBhACALBHB.XDBChAAAeDGFAEAAfEHAhADAaDFDCFGA.gFCDKGHBFHDADEEB..hABA......hAIA...,1,-12,-14,2
HOgKIDaBQEFYZAGCbdTSVMRNcPefXWJUL,GAAAdAAASADARADA..PAHBeAFHXBGDUCDBHDFBKCBAhACAaDAHEDABZGAA.AAABCEHBbDEChADA...MECBfGHAhACALFFAOEEHDAIBFHAC.YHFAhAEA.....hADA...,2,-8,9,17
TNPJKMXIGaZcYUDfdLRFHBVQOgESWCAeb,eAAATAAA..JADBMACAGAFAZADEUCCBdBHARDEB.HAGBBEDDQDFChAAA.EEHFCEHAAAAAhAFA..bFCBKFBAaGGCDCCBhAHA.LHEA.......hAIA......hBIA...,2,-26,-4,22
SdFgXIGZDaBNVTYKUMCJWfEOceRAHQPbL,HAAAQAAALADBdADAFAFAXAFAZBFABDBATCFA.KCADMDDAhAAACCCC...fDGAhAIAEDHFeEEBAAFAbEEDSFCBhAAA.gGFHDEEBaGGANIBB..hACA......hAIA...,1,-10,-15,5
YaHFEDNMLUbCVeRZAdIcKSgTJBOQGXWfP,dAAAKAAA.SADAJACA.BAGAGAFA..XBGA.hAAA.fAHEhAFAaCAEHCEAEDCFMCCBLEABhACAbDCDeDHBAEEBgEGA.TGEAhADAQFEC.PHFChAIADGIBNIAB..,1,-12,-21,9
VPWDcLHfMdFJBYREUXCNQbeaOAgKGISZT,GAAAZAAA..TAEAPADADACA.HAGBdAHABBFARCCA.ECDBCDFAQEGAhABAeDBH.hAAAAAIBKEEDSDEHhACA.cDGAMGAAFGGHUGEA.bECD.aGHB.hAGA......hCAA...,1,2,-18,20
BeHPJFTVQZdOEcYLWUACgbIGRfaXNKDMS,CAAA..bAAARACA...aAEAKAFC.MAIBBAHAHCAAFBEB..QCAAhAAAdCEAEBGFLEDAhAAAACGAGDDB.XCGAhABASDHDeFGBTGGAOHAA.WFHB..hACA......hAHA...,2,-16,-10,6
UNdZQMBKAcVPTeWLfXSbYFROHgEJaGICD,VAAAeAAALAEA.SAHHbADBRAFAHCEBEBCFGDCA.hAAADCHBdCEAZFGBMCGBACIBTGAAhAAAXEDC.ODHBhABAaGDDCGFA.QFAA.KGGD.WFHHhAFA.....hAGA...,2,-1,3,4
BUSbaTJDMfVLOHZFGAPgEXWcNCQKIRdeY,EAAAXAAA..NADA.QADA.RAFAeCDBBAEAbAFDaCFEDCIBhAAAMAIB..LDABhABAHEAAGEDAAEGAgFEAhADACCBAdFFASHAAfGHAOHFEhAAAZGAE......hAEA...,2,-15,5,20
KIceMNVXJgZAWPbYSBOUQDFRdHCGfLaTE,...bAAABAAA.QACARAEAHCAAGCEBaAEEKAHBeEAA.MEEBhAAAXCAAZFAEAAEAPFFAhABAOCFBFCHH.dDDAhAAALHCAEEGB.IHHAcFAA...hACA......hAFA...,2,-30,17,47
fKOZQgaMRETAUNXWPIYJFcGCVDSBdLeHb,XAAA..IAAAFADAGAFADACAdAFAHBCBKAHBZDGBaBCAEAHBhAAA.ADFBUECB..hABAPCCB.JCGBCFFCBGHAhAIAeDHH..bEDD...QFBBhAHAMIEA.....hCAA...,1,-9,-24,15
FJfRVMGAIPZSEbcTWaYNDCQdgKUOHLeXB,ZAAAEAAA...TAEAaACDDAEAdAGA.KCAAHAFCLDDAeBDHFCBHRDGFGEAAhABAACFA..SCGAhAAAbFDB.cDFChAIAYFHB.CCED.QGGA.OEEBhBCA.BHEA.hACA...,2,-10,-7,3
UHQeSaMGfBWOITLFbKCEADYNJcgPVRXZd,DAAAJAAA.....PACCRADFdAFAHBGB.eCCBaAFAGBEBhAIABAHBODABTCCALEEBhADAKBBDADFB..cDFDhBAAXEGA.QGGCMDIBfFGAhBIA.IHHAhCAACFDA.YEEF.,2,-14,-10,4
SZCUFWBJMeYKGRbITAEXHcQVPNODfgadL,HAAAQAAAVAEA.OACCDACA..aAHDdAFAZCCAFAHB.BCDAeDFHhAAAGDEARECB.bDGBADIBEEHBhAHA...XGGChCAAPDCB..fEAASHDACGGD..hCDA......hCEA...,1,-8,-14,6
eGLTRDQJHBcVINMYagSfEbPUFZAWXOCKd,OAAAdAAAeADAGADARAGB.QAFAHCACBCFA.VEABMAIB.hACAaBBHSDEDhADAEDFAbEFA.FDHDADDB.CFGDTGEAhAEADFAAIFDA.gGGB.fHBBhAFA..hBAA...,2,-14,-7,7
VfPQEBLHMNeOKCGabDdFAJcRYgTWXSUZI,RAAATAAA..SADBZACB.VAFAQAEA.EAGAhAAAHCCAeBHFCCHAbDFDdDEAACABhACA.JECB..gFAAhAAAXEGAfGDALEEDMEIBKGGAaGEDhCCAFHFEYFCBhABA...,2,-14,1,15
AYdTKgWbNfHESGFcLUJOZBVePaCIMDQRX,dAAATAAAKADA......bABDHACBGAFALAEA.OAHDhAAAZDAAeAHBaCACMCFBhACARDGFAEEA.gDGBhAFAfFAAEEDBFFDDcFGCBFFDCGHAQGAAhAGA.XGEDhCGANIAB...,2,-4,-2,2
UYFHEJKONWSfIbQaLPTAgVCRBGZXedDcM,CAAARAAAZADBdACA.DAGAUAEA..HBFAKAGA.OCCH..SCBDhAAA..bDADaCFEhAIATDGAACIBBDDAeDFDhAAAMEFAEFHF..JFFAfHBB..hABAIHHA..hBCA...,2,-48,-9,39
HeMKaNPJGZEXgVDcAOQRYSUIbWCdFBLfT,RAAASAAAUADA....IAGAbACDdAEALAGBHCECeCCBhAAAaCHD..JDHBEDEFXEEChABADEBAAAAAQFFAhAIACBHABFBA.MFIBKGGDNIABZGBA.....hAIA......hBFA...,2,-17,0,17
TGYJLNRIeUXVBfEaSKFgADPQMbOdWCcZH,QAAAMAAAdAEA.CACAHADBGAGALAFARBBBeDBD.UCGABDEAEDDBhAAAaDFDFFDH..AAGBDDIBhAIAbFED...OEDBhBAAcGAATFGA.NIBB.XGGA..hAGA......hAHA...,1,-6,-9,3
KFSQMfeJXLUTEIdCWVYBabGcHPAOgDRZN,DAAARAAAZADBFACD..MAGBeAEALAHB.UDAAEAHFdCEA.CCGD.hAEAVDEBBDDC.GEFAhAFAHEGBAAAAOBBHKFCASHBAhADA..fDHA.hBFA......hBHA...,2,-32,-15,17
cHYBIGgCQXaZAObVTDeKSdFNJMEPWfLRU,OAAATAAA.KADAdACA.FAEAMAFA..EAHB....fBBEhBAARBDFHCFABEFDGBEBhBHAQFGAZDCBADHAbEEAhBIAeHCA..SFHH.NIEB..hAAA......hAIA...,1,-16,-18,2
HNGLSgCRbDcYOJMfFKBaAQZdPXEUTIeWV,dAAAEAAAUADAeADAHAGBGAGALCCA.CDAARDEAbCBC..DDIBODEDhAAAMECB.KEGDAADAZFGFhACATFBA...IGHAhAGANIAB.SGDH...hAIA......hBAA...,2,-15,-12,3
BFYADHILSCZNUVMORaTceGdfJXEWgQKPb,HAAALAAAZADBVAFARADF..aAFA.eAHHdCADXCED.hABAECHFQCAAhACA.bBFDFEHDACFBSDDDhCAACFFAMIAATGDAfEHA.gFFDhDCABHHA.DGIB.hAAANIDB...,2,-13,-2,11
ZYXUQWEFBNHMVaKJfLRIcGSDbeCOgTAPd,ZAAAXAAAQAEAFADA.HAGD.aCAAfAGARDAB.GBCAhAAAbDDA.eAHHOCHDhABAACEAdDGDUFDAEEEBMFHBhABAKFGAIHHADFIBTGAA.....hACA......hADA...,1,-2,-3,1
dFTAZWQebHfgYLcCGOXRUMJBaIESNVKPD,ZAAAeAAAHAEA..fADALAHBGCAARAEFUAGA.MCGBaCCC.hAAAECCB.SECAhABAKDFAdDHAAEEBQFFChABAbEGDgFDACHHA.XGAA....hACA......hADA...,1,1,-14,15
TDSCJRPYZWfgFObMdIeBEAHNGUVXcLQKa,HAAAGAAAXADBLADAQAFAaAGDSBHHRCAAZCFAfDEEhAAAOCDBdCEAeDGBhAAAAAIBVEGBTFAA.CFFA.hACAPHBA.gGEBMEIBBHHD.NIAB.hAEA......hAFA...,1,14,-3,17
CaZLKSBURXYOMVfTGdeAWNJDgPFEcIQHb,JAAADAAAFACD..EADEQAEAHAFB..aAHFZAGBLCCBhAFABCDARDEB.OCEBMBBB.TDGAhBAAeCHHAEAB..gFEAhBHAIGBAKFHBSGHBUGEB..hCAA......hCBA...,1,-17,-20,3
XQaLIBHKdSUfegcGARNVbODWJEYPTCFZM,RAAAVAAADADA...EADE..TAFAZAFBMAIBQBDD.aAHDhAAALCDB.HCGBhAAAdDEDfDHAhABAeFABGFEBACCBbFFAOFCBYHAACHHA.FHDA.hAFABHHD....hAHA...,2,-16,4,20
BSgPacNHbCDXMUQVGYdEAIRWfFLeOKJZT,RAAAFAAAeADEKADAZAFBBAGB....SAHHaAHDHBDADCCBUCCAGDDBhAAAdDAA.ADGA...hABAfDGALFGB.hCAATFCA.PEHDNDIA...bFED.hDAACGGD......hDBA...,1,-17,-20,3
LVYPIEgMXdWCeFHSGZKfJabOATNcUQRBD,TAAAUAAARADALAGB..PACAECDB.MAGBdCFCeCHHhADAHCCAZBGBKEAA.aDHDAAIB.QECBhAAADFFB.IFFAhAHAXGFDFFBH.fGHA.hAEA......hBAA...,1,5,-28,33
KTNOPFJdALMQgYDEVZaSGXCHbBeWUIRcf,MAAAQAAADAEAZAEEGACB.HAGBeAHHIDAARBBB.KCDDhAAATDEAOCEDFDHDAAFALEGBhADAEEDB.aGDAhAIACCFBbGFA...BFGD...WDBDhBAA......hBBA...,2,-24,-1,23
dBCPWbeMGXUIHTgNSDEJacKLfYQOFRZAV,dAAACAAA.....bABDeACAGADAXAFAHAFA...TCAAhAAASCFAECCEaBHDLEFAhADAQCECRFAAAAHABGEAhAFAMEGBIEHADGGA.KGAAOHEEhBAAFGCA......hBDA...,1,-5,-8,3
aCKeLYWTIGSNZDJAbVMRfFQHXOPBEgdUc,MAAARAAAQADCHACCOAFABAFB..EAHBdBGD.aBBCeCCBLDDAhBAATCEAGDGA.hAAAZFCAACGAbDGD.FEEH.hCAA............hCFA......hDAA...,1,-10,-15,5
ZbXQHedRTDgSaBEGIMfOAKLJVPNcFCWUY,LAAAVAAA...PAEAFADACAGAUCDAZBEA..QCAAhABAHCFAREFADAIBaBHF.ECDBGGABhAAAMDFBADGBKGHBNEHA..hAGA............hCAA......hCHA...,1,-14,-21,7
IURBWDJPSgaYECHLGMfKVXTZcbdAFNQOe,QAAAeAAARADABAGBDADA...SAEAaAHD.EAHBHCCAhAAAGCBBMCGBKCFCTEAAhABAbDFAAECB.ODHB.hAAAIEEAUFFAWHDGgGGA.CFCA.hAEA......hCAA...,1,-10,-19,9
JPeWYSONZbfFEHKBXAdgMcGRaCTQDIUVL,dAAAMAAARADA..CAGB.TADA..QCBADAFAUBGALBBBhAIAeAHHSCFBZDCBbEEA.hBAAEDABHGCCBDDBACFA.GEGAhACAaGGC.IFDA.....hCAA......hCBA...,2,-15,-10,5
QfUCTdPbWgRZGDLHVOeFAIMEKacXBSJYN,EAAAaAAABADA..SACA.JAFAQAFAUCCAdCFA.hAAAbBBCRDABGDGAHCDCeBHHhADAACHAKFDAXEEAhAFA.fEHA.CGHAPHBA.hADA......hAIA...,2,-26,-4,22
PCORKNZYWaeXFVMTbUfcQDBGdHSIJEgAL,LAAAOAAARADAZAGBaADD..FAFA..MBBBUCAA..QCCChAEAGCDBHEECSCFDhAGAEFBAAAIBKDHBNBIAeEEBhBAATGCA..bEGDDGHBdGCA......hCAA......hCGA...,2,-10,-5,5
QfYLBIAbVFgZCKTDGWENUMeRXOcadHPSJ,FAAAZAAAKADCGACA.EAEAMAGB.RCAA.OAGDdAHAHCEB..SCEHhAEAQECCLEGBhAIAACAA.bGBACDHATFGAhABADBIB.NHBB.eFFF.....hACA......hBFA...,1,-13,-19,6
EHZDNPQeLdRcfbGVKBgOIFAJYUCSMTWaX,UAAAMAAA...aADAHACCZAFB.DAFA.QBFAeAHFRBDF.bCCCGDBAhBAA.BDHAOAHDhBAAABDBCEFA.TEEA.hBCAEEGELFEAdGGA.fGHA.hBBA......hCAA...,2,-17,-14,3
LBGTANIPFMScRfHVJWYgabZdEKeCQXDUO,..IAAAMAAARACAHAFB..VACAJBBF.....gAFBhACAZDDAEAHBeDHBQCEDhAHADFAALFDBhAFAGDGAAFFBFGGBfCCE.aEFH...hAIA......hBAA...,2,-15,-12,3
eWBKaOcEYXQGRIgbUJNCDMVdLfFHTZASP,eAAAKAAAOACAEADA..QAFARAFA..bBCDUCCA.CAHAMCFBhAAAdCFDLEFAhAAAHDGBACIBSGDAhABABGAAaGEA.XGGAIHEA......hAGA......hAIA...,1,-4,-32,28
AOMIbDFdLSaGVgRPWZeTcQBCEHKUJfNYX,MAAADAAAdADALAEAGAFARBBBZBBA..eAHBTCFABDEAHDBAKDHD.hAFAUEFB.JFAB..hAFAfEDEXFCAABIBhAGAODBHFGGHaHCCgFFB.WFHHhAIA......hBAA...,1,4,-31,35
JYSTOHRdeXMBQKVDgcAUEfaZCLbWNPGIF,EAAAZAAALADB..bACA..PAFAGAGAFBFHSCCAhAAAHCABRCGF.eDABMEEBhABAQDEADEIBABIBaFFB.hACACEHAIGEA.TGBAdGGA.KGGA.hCAA......hCCA...,1,-1,-11,10
ZPWHUGXdFQYRJCVaBNDfcMOKbEALgISTe,LAAASAAAeADHZACBHAEAGAFAdAHAQCAARCEA.CAHAaCHDhABADDIBMECB.bEEAhAAAAAFBTEDAUGEAFGABVFGBhACABGHA..fHAB.KHDA.hABA......hAGA...,1,4,-7,11
KWVOEdRaMNBTCQPAfIFGZSgXecHULYDbJ,FAAAZAAASACEeACHHAEALAHBDAFA.KCEDOAHDRDFB.aBEDhABAMDDBBBGCQEAAhAEAACCBGDEB.XGAChAGAUFFBJECBEFHF.dHEBCHDA.......hCAA......hCBA...,1,11,-25,36
LYTAdWgVBDaIQRFcXPbeJKOUfZSCGMHNE,dAAAVAAAaADA..RADF.FAGA....XAFBeBDBOBFCZBGBGDAAhAAAHCACEDFALDFDhADAADIBBEBDQFCAhAIA.bGFAKEGASEGAMFDBTGGADICA.hCAA......hCFA...,2,-15,0,15
DbRXMNYdTIWLcUfSKBVAQaEHCGFePOJZg,EAAAHAAAGACAeACEOAFAZAEADAFA.RBEAMBIBdCFA....TEDAhAAALCCBUFGAKDGBAAIBCCBDhBCAFEEB.gFGAhAAA.XGDAIDHA.....hCAA......hDAA...,2,-22,-5,17
OBNGfPTCXLRSEAeFgVbHIZdWQKDaMcJUY,eAAAFAAA..VADAHADAZAGBdAGA.QCCCDBIB.aBHDMCCBhADAUEEABDDA.GEFAhAGATFAALEHBhBAAEEHBAAAAbFCBKFDB..cGFD.....hCAA......hCBA...,1,7,-26,33
BVEWQTSaLXgUNDMeRHYKAdfPZJOCIcbFG,dAAAZAAACADB..IADAFAFAGBEABAFA.EAHBQCAA.hACA.aCBDLCGBhABAXCFAgECAhACADDDBREDFHFABAAIBJFHBbFGB.TGEASGEH..hAFA......hAIA...,2,-17,-10,7
eUMaJgPdSLKWEXHFZQINbRVGBfCDTOAYc,eAAAaAAA...JADBdADALAFAEAFAHBFCZCEBQDBA.hAAAbDEBRCGBGGAB.hAFACEDCTGFAAAIBcDGDMCCBhABASFHH.XGEA..hBAA......hBBA...,2,-14,-11,3
HQKeXRUbgTdOVYNBMDPJfZScAFLWICEGa,LAAACAAAGACAHAEAeADHRAFAUCGA..TCAAdCAAODFH.hABA.VCEBBAHBMCHBhACADEEBJFHBZFAAACIB.FFGHEGAAhAAA.KGDD..........hACA......hAEA...,1,-11,-19,8
ZTFLacJbUSMQAIKBCGXWPYNfEOdRHegDV,BAAAGAAA..XACAPADA.....fAFAhAAAEAGARCDAHCGBeAGHDBIBZECATCAAhACAaFHDJGCASBHHhADAAAABCGGC.YCCB.dEEA.FEHB.bEFDhAFA.MIAA...hACA...,1,1,-13,14
QMbRgdCNVJFHGZPTLIXAUWaEfBcDKSeOY,aAAAEAAABACA.KAEAeACH.QAEARAGFdCCA.CAGA.JCFFHCFChAEAZEAA.TDDALEHBhAAAAAIBfECEDEEB.hAEAOEGBMFFB.NBBAFFHDGGAB....hAGA......hAIA...,1,0,-20,20
QOLBJHScTdYEWZeRbNaUKAMfDPGVICFXg,MAAADAAAGABB.CAFB.XACA.QAFALAHBHCCChAEATCCAEBGFZCFAREFAaFCAhBAAAAIBVEEAFGEDBGHA.hAFASHGGdGHAeHBANBBA.fHEFhBAA......hBHA...,1,-7,-11,4
BKVgGRbQdYXTWCcOFASILUfEaZNJDMHPe,LAAAEAAAZACB.DAEAHAEAeAFAKBHBGBCBRCEAdCBC...TCAAhABACECAFEEH.ABIBUDDB.aCGDhACAMEHBBEHAVGAAbGDA.hCAA..XGEA......hAAA......hAGA...,1,-6,-13,7
TNJORWKDcHMfAPbZEegBGFUSIQaXLYVdC,ZAAAEAAABACAGAEAFAEASACE.QAGAaAGDLCCAhAAAdDDACDGATDFA.OBHDhAIARFFADCCBHGAAABEBeEEBhCAAgGDBUGGA.IHHA..hABA......hAGA...,1,-7,-16,9
FedWPIZLaBQDEYXcRHMUNbOVGTfgJKASC,FAAAeAAAdADA..IAEAaAFA..QBFCEAGA..XBCDhAAAHDBAMAIBbBFAGDEAhABATDGAfEFEhBAAKDGAAECACGAA.ZFCBDFIBcFGD...hAGA......hCAA...,1,-7,-21,14
AKLZeUQWYEgHBVTIXMfDSOPaGdcbFNRCJ,ZAAAeAAAQAEAEADAHAFABCCA..TAGAMCEBDCFBOCABhABAGCGAdCCDFCHDRFFBAAAALHAAhAHAUEEA.gGDBhAIAXEADSFDD.aFHB.hCAANIAB......hCBA...,2,-5,-4,1
DKAOQLHdMaUPEZJCIFgefYVGRTXNBbcSW,LAAAHAAAaACAEAFAZADBCAFA..FAHDeAGH..VCCARCAB.TDFAhAAABCCCSBHHhABA.KDEAACFAdDHAMEHBhACAPFAAJFCA.fFFEXGFDNEIA..hAIA......hCAA...,2,-19,-7,12
bBWEaGRcSUQVdXLIOFMAJfTPZYNeCDKHg,TAAAZAAAeACE.KAFCHACBBAHAEAEA.RAGBUDEAdCCDLCFA.hAAAFEEAAAIBfCAEhACA.PDHDCEHAbGCA.hABAGGCBQGGAXEAA.IHHAhAEA.....hCAA...,1,14,-28,42
AdaZfYgGVMcXSKRNbJCeWPLDUIBEFTOQH,ZAAA..fAAAGAEAMAHBSADARCAA.JAGBeCHHLCBAhAAADACABEBAECHFTDEAhACAHEDAAAGBaFGE..hABAgDAGXGDANIABbFCDCHHA.PEHD.hAIAFGAA.dGFA...hBEA...,2,-8,13,21
McfOQGLbaZIFYJWCgdBHSRNeEXUVATPKD,TAAADAAAMADA..OACAGAGALAGBZBBAFCFH.JBDF.CBFABDFDhAAAHDBARFBA.EEHFXEFAhAIAAAIBKFFB...QFBAhBFAIHHA.gGGA.SCCDhBIA..hCAA...,2,-24,-16,8
MDOaNABQFJKbcIGSYVgPdZUfXCRTEHWeL,QAAAKAAA..bACBGACB.SAFEVAEAdAHAZCEAhAAAXBGAREEA.HCDChAAAeCCDMDABaEHDAEEAFDCH.hCAAIEGA.gFFGfGGEEHDAhADADIDA.....hAIA...,1,-8,-13,5
aXZdIUbYGAJNTgSeEKHDFPMQRBLfOcWVC,TAAAeAAAHADA.FAGAMACARCCBLCFA.OEFAcAEDCFAAZFFAhAAAdAHAUDBA.GDEAhAAAACGA.gCGGhBDA.EGGADIFABHBA.WHFA..hBEA......hBHA...,1,-9,-17,8
fcYOETGReHJbSCMDadXWZNVFKBQgAILUP,LAAAUAAA...fAEAOADAEAGARAFFHCAA.bCGDMBDBhBAA.dCEAZDCEFBHDQGEAhABAACGB.IGHAhACAcEBAGEFAeEABCAHBDCIBaEHF...hBCA......hBEA...,1,13,-30,43
WFgAScdLMXeTBKbaDGHQCYEVNRUPZIfOJ,dAAAMAAAeADAKADA.DAHBHAFB..QCBAEAHBRBBBZDEA.OBFDhACAFECDADHA.LDDBBFAA.hAFAGEAACFFA.VFFAhADAPFHDfCHA..WFDH..hAIA......hBAA...,1,-3,-23,20
QdFHKSBLAWCYGNZEJfDcUeOaMTgbXPRIV,CAAAGAAAZACA.EADADADAeAFA..aAGAMBIB...TCDAhAAAbBFD.RCFFQFCAhACAHCCABBHDADHANDAA..fFFEhADAOECBXEECIFHAdFHASGAHhAGA.LHCAhBAA..,2,-34,26,60
eIQXBAOLHfWDcJKEgMPUVNRbZTGaFdSCY,HAAADAAAKACAEADE.MAFAUAEA..RBEAZCAAGBGAdBHA..CDFAeEDFhAAAQCCCBEGAACCALEEBhAHA..fFFEhACAcGBA.PFHDNBBA..aEGH.SGHHhAIA.IFDAhBAA,1,-18,-22,4
HFYSNCZMOPDeWdbVcgTLEKfGRUIJBXAaQ,HAAASAAAZADBMAGBDADA.dAHA..VAFATDAALBDB.hAAAECCFGDEA.RDGBIFCAhACAXCFCAAAAaGGChADAQEFAFHBACCCC.eFHH....hAIA......hCAA...,1,6,-26,32
LKaZVTXdBEbNMIAWQFHCYfJUSPcGeDRgO,QAAAHAAACADB.JACESAEH.GAGARAFALCDBhAAAZCAATEDAdCFDEDHFbFGBMEGBhAGA.ADDBFFEDUGAA.hAIAeGDADFIBKHGA........hCAA......hCIA...,2,-15,-1,14
FAUSeCdcRNZGHDTEQYKMVJOXLagBWPbfI,eAAAdAAARADAGAGAHADAEAGEKCBA..MCCBOCEDaCGABDDA..hAAA.bDFBFDAH.AAIBCEDDZEGBhABAQEGBVFABLFEBhAFA.WFCHfGAA.SGDAhACADGIB...hAIA...,1,10,-26,36
QNKTPCUJSEIBgReHMbdOGYLcfVaXFZWAD,QAAATAAA.CACA.SACBBAEARAFFHCDBdAEAGAGALAHBhAAAfCCEaDCB.hAEAZDFFAEGAKEHBPEBBEFDBeFFBhCAAbEDDOHFC..YHCA.hAAA......hAGA...,1,0,-7,7
NYFAOMdCfBXPGZEgTUDSLbRJcIHQVWKea,dAAABAAAGADAEACAUAFALAFA.RCAA.JBDBHCFA.QEFBhACAKAHBeCAB.aEHDFDFAAAGAMHCAhADA.CHHA.XEEChAAA.ZFBBDICASDHH.IGGAhACA...hBAA...,1,-5,-28,23
eGPQgcNLVdBEHTOKFaSDMWICZYAXRbfJU,RAAAJAAAeADEGADA..QAGC..gAFBhADALCCAdDGAHDEBTEBAhAAAFCCHaAHFMCIBCDGAADIBXFBAhBAAbEEBfGGA..cGGABBDA.EHFEhBFA.SGDHhCAADIAA...,1,2,-17,19
LFEZKNfJBPgVCXHTAdDUQOWSMGbYIecaR,dAAAQAAASADAGACB..bABDeAFE.RCDAECGEZAFBKAHBhADAJDAABEFA.VFGBhAAAHCGB.ACEAODCEhAEAMFEB.IFFA.aFHD.NIDB....hADA......hAIA...,2,-9,-9,0
bIcDQSPXUVGCKfgETRAaZeNHYdFBWOMLJ,eAAAHAAAdADABADAMAFALAFA.JCCAbBED..DCFAQBGAhAAA.XCAAhACAGDEBfFFEhAAAEEDBADDAZFFAFGBAOFHBSHEAPGAACEHA.KHDA.hBGA......hCAA...,2,-22,5,27
gMVZbeaHRASJWfGEKDdCBIYUcPLTFQXON,SAAAJAAAGADA.EADAdAFB.BBGDUAGALDAAQBEA.hADAOCCBMAIBZDFAeDABhAAAHFFAADEBKDGACGDA.IFEAhABA..YHFGTGFANIBB...hBAA......hCAA...,1,-6,-21,15
JONDaTVAKdUHXRYZMeWPQGScgLCFIfbEB,dAAAHAAARADAZABBeACE.QAFCGAGA.SAHBLDDAFEAAhAEAbCCBBCGAODHDaDGEAAIBKFCAhAGAUFEA..MFFBhBAAcGGA..CGGA........hAAA......hCAA...,2,-15,-9,6
ZdSGTXeaRQKDcEfAgHMUNCYPWFLIbBOVJ,HAAAMAAAUAEACADB....PAFALAHBBBEAOBBAZCAAGCEBhAAAeCCBREDFQEEChACADEIBEFGB.ABIBgGGAhCCA.YHCAFGBBIHFA.hCDA......hCHA...,1,-12,-21,9
FUYKNJVIZfLMEPbdcATDXQgWeCGSHROBa,TAAAQAAA.eACAGACAHAFARAEAaAHDFCDAKCGA..VCFBhAAAZDAAMEEAECAB.dFFAAAEAXEDDhACACEHABHAANICB.fEHAhAHA........hDCA......hDEA...,2,-11,-9,2
ZQaPJfVSHXdCgYDcOTbEUBWReIKGMLNAF,ZAAAaAAA.JADA..SACHHAGBdCAA.CAEA.DCCB..OAFDECFBBDDAhABARCDBeAHBGEGAMBBBhAEAAAIB.QDGDhAIA.fFDEXFEBgGAAhACATFGAWFFD.KHCA...hAGA...,2,-23,-4,19
DMBZESAOcVJeNbFKgadPYQfHLTXGRCIUW,OAAAVAAA..eADEFADDKAFA..dAGAQCEAHBDBTDFAhAAARCGBUFAAMAIB.EDCBAAIB.hAFAJEHB...bFCAaBBHhAHA.fDDELHDA.CFFADFIB.SGHDhBAA.NICB..hCAA...,2,-18,0,18
SVfLNbITKBXFCacdQJMPeWYgEAZUOHRDG,ZAAAHAAARAEAGCAASACELAHB..bAEDTCDABAGACBHAdCGChABAMCCBeEFB..gDDGhAAAAACADEIB.fDGAhAGAKHGAaFAH.QFGA.PGCAhAIA....hCAA...,1,-6,-16,10
RVMeIEAFGabWKfSXJQgcYZdUHCTBLPDNO,aAAAKAAA..SACBQADA...gAGAZADBHAFATCGAhAAALCCBDCCBRDAFeCHFhADAAAHAGDEAbEDDXFGAhAGAcEGD.dHABBFCANIEB.MICA.EGHF.hAHA......hBAA...,1,5,-7,12
NdAeHDgOVfUcTWYBCbSaRKZQFLXMEPGJI,HAAAOAAAUADA..TADABAFASAGHRAFFZCCALAHBECABGDDAhAAAJEEF.dDGAABBBeEHBhAFADAIB..fCCEhACAcGFD.CFHAaGEDFHCA...XGGChDFA.....hBAA...,1,-4,-18,14
fJdbEZIVCMaQTeAcBLgXGFWHKYDROUSNP,LAAAGAAAHADADAEARAFASAFE..fBDAhABAbBFAECDBZDEBCCAA.MDABQCEDhACAAAABBDGAFEHDKCHBOCCHhAIANIAB.dEFDaGFDeFHF.....hACA......hADA...,2,-13,2,15
NeIcVPOTAWMZKFQJdRfGSbCXDaUYLHEBg,ZAAAQAAARAEAGCAACACA.DACAUAEA.HAGDEBHFBCCD..eCDBhAAA.IDFAhAIAPCFDAAHAMCIBFDHDdEDAbEBBaEGDhBEA...LFFDgFFG..hABA......hAFA...,2,-24,3,27
JLdfMQbZNXWaGIKAPRBVeETcgDCFSYHUO,RAAAeAAAEADE...TADADAFAFAHDHAFB.OAHFdCCAMBGBZCCAXDGDhAAAGDGA.AEEBBFAAhABAVEDB.CFFD..SGEDhAFA.YHAA....hAHA......hCAA...,2,-31,-11,20
YPOeXFADZQfISEVNcWdGgCMaTUHRLJBKb,ZAAAQAAASACEEACA....VAEANAFA.dAHAGAGA.hAAAMCCBaCDBHDFARDDBLFGBhABAKEDAbFGDOGAAhAGAeHDAADHAfGEA......hAIA......hBGA...,2,-14,2,16
WbBDeCQFTaGULMEZHYRVIPgASfdOcXKNJ,dAAAXAAAKADA..JAFABADA.eAEHQCBAaAGA.GCFAhACAMBGBHDAA.RDGFIEEAhAAAACFBOCHFNDAAbFDChABA.FGHDLDDB.EFHBYHBAhADA..PHCA.hBHA...,2,-17,-6,11
fXPgWEdDUaRLNQeBJVFMYHcSAOTCGKIbZ,TAAAGAAAKADA.ZAFBXACB..gCDDEAEAdAHAaBEEhAAARCGFLFAAeCCBBDGAhBHAFFFBHEDBAAAB.CFFBfFHAhCAADAIBNEIA..JHBAMIDA...hACA......hADA...,1,3,-15,18
cWHfbTPZGNBFEJQLgMdKVRASCeXDUOYaI,eAAADAAAOABE..aADD...IAFAHAEBbAGBZAGBGCCAhAEAFCCHEDFBLEFAhBAA.dGBAREDBAAAAXGDAhBGAcFFD.TGGABDHAgGCD.hBIAMDBB....hBDA...,2,-25,4,29
XNTBOEdcRHJUSIYPGegVDQMaFZWbfKCAL,LAAATAAA.EAEARACFHAEBUBGA...SAGA.ICHAhAAAGCAAeCCAhABADCABaDECZDFA.bEECCEAAAAGABGCAhACAdEHAJFFBgGGA.MIAAfGDAhACA....hAEA...,1,-1,-15,14
eLDJHVNIOBPgARYbUFKGaXCQWZcESMfTd,RAAAUAAAGADACADA.ZAFA..EAFAMCCB.dCGAeAHFLDABHCBCICFAhADABDFCAAAAFEHDaCHDhAFA..QGFChADA.SDDDTEEADECBNHAB.OFHBhBAA.gGEAhBCA...,1,-3,-22,19
CXLABDbfPOdUaYQGISNHZTKEFcVMJWRge,DAAA..bAAAOABEdAEAUAGAQAEC.GAGASCAAhAAAHCCAZEEAEDDAFDFDMDIBhAGAREBBeDHBLGDAACAAfFGAhABA.aGBHIHHA.NIAB.hAIA......hBAA...,2,-11,-4,7
IYUQaAcLSHgJPMRfVXbKFWONZCTEDGedB,LAAAHAAAJADARAGFXADD..FCAHOAFAZCCAEDGBGBFAhABAdECABEEDICAA.hAAAQDDCACIBSEHHhACAMBIB.bEGDKGAACFBAeHCAaFGH....hACA......hBFA...,1,-6,-15,9
CQVdGNKXeYOLTZWcSEURgBMDHFJPAIbaf,aAAAQAAAGACAKAEAeACA.LAGBZAGB.SBDAhAAARCEBMBBBHEACFDAAAAIB.bDDBCDHAdFGAhAEA.XGAChAGATFFAEDHF.BGBADEEB.IHHANIBB..hADAWFHH....hBAA...,2,-6,3,9
aFIeKcTWUPEdVHgGQLAOCBJDMSYbZfXNR,BAAAMAAA.SACAZABE..XAEDRAEFaAGA.eAGBKBGA.TCCAhAHAUCAAdDCAHDFAGDGAhAAAAAIBCEEDDFDB.bFGDFEEBhACA.....cGDC....hADA......hCDA...,2,-23,-10,13
WaTNFIdGLDeVScMAbJQCRBOfZEYXPUgKH,QAAARAAAOADAZAGBEACA....XBDDgAEA.HAGBhAAAaCCBFDHDGDCAeEEBhAAASEEBABGB.hABAbEGBBFCAfFAAUGGA.KGFBNIBB...hBIA......hCAA...,1,9,-18,27
cFLDITHQgYAWdPGfeENZJSUBaOMXVCbRK,dAAAGAAAEADAZABBSADABAFA.MAGBCAHA.RCDBFAHBLCEA.hAAADCIBHDGB.QEABhACAACFA.fFCAhADAeDCFUEEAaFFHXGFA.KHAAIHHAhAEA...hAHA...,2,-32,4,36
aKdNGebEfALIUMOHcWQXFCDRZTPBYJSVg,LAAAMAAAHACCQAEACAFBZAGB.TAGABBBDSCDAhBAA.aCHDdCAAeDCBhBIAECCAACIBOEEBXDEAhABARFGB.PDHB.VFDAKGCD.NIAB.fGFEhCAAIHHAcEADhACA...,2,-15,-1,14
bADHWQRJZaLBMeCKFVTOGPNEfcdIgYUSX,HAAARAAAZADBLAGBeACEFAFAOAHDGCEAEDAAdCCA....gCFBhAAASCHHADFBQEDDhCAAaFBAMFHBKGBATGFAhCEA..fGFA...hDAA......hDBA...,1,-10,-12,2
UISKceBgXMPLfaVQYNFOEHbTDZAJdCRGW,dAAARAAAGADAUADAKAFAeAFA.BBHA..MAIBLDAA.aCFDhAAAQCBDFDHB.hABAHCECbFAAZFDBAEEACEGASEHHhACAXFGAfGFENHAB..EFFBhAHADFAAIHHA.hADA...,2,-22,-5,17
PbDWXSHORBJcLIeEVANfGYdFZTKgQMUCa,GAAAdAAAZABBKADAMADA.CAGA...aAFADAIB..SAHHhBAAHCDARCGFBBFDLCEBEDCBAAAB.hACA..fCGEhBGATFEA.QEGB.bDCDOEHDhBCAIHHA....hCDA...,1,-13,-27,14
JbABGMVZgLRfUNYXTdeaSDOPKWEQFHCIc,GAAAZAAARAEAUCAA..XADAdAHA.eAGBaCDD.OCDB.hABAKCFBECFFHEEACDGA.IGGAhAAAJEHB.AADAMAIBhACALFAAfHABNIDB.SECDhAHADADA.WEHBFFFB..hBAA...,1,-12,-19,7
MEgUYAeBaVZWLXOPHCIbGFNScJfDKTdQR,eAAAaAAAZACBLAEA.OAHDHAEAbCEAGBCA.FCEASAGEhBAAJDGB.KBBDdEEAhAAARECAEEGBgFAAhABAACIBBGCDXGGACFHA..IHHA.hCAA......hCEA...,1,-7,-12,5
IBOeNLHMAFJGaPRWEcXTgDKbfYQVZdCSU,GAAARAAAEADE...TADAKAFC...bAFBQBGA.hAAAdCCASAHHhACABCFDeECAHCEBAAAAaEGAcDCBhADADFFA.fDHA.ZGFACGGA.OHBAhBAAMIAA.....hAIA...,1,9,-32,41
TFLRDfIBJOXZWMebAHYgSGdcaKVPNECQU,HAAASAAAdADAaAFAKADA....PBFBEAFEQCCAhAAA.TCEARCAAfBHAhAAABAHBXCGBhABAZEDAeDHFADAAGEFAcGBACGEALFHBDFIB..hADA......hCAA...,1,0,-13,13
MAfgJWKLGTcSDFEOUYPbHIZXBRCQeadNV,JAAALAAAGADATAEA..DAFAEAGEOAHDUCAA....hADAbCDAHBFB.ZEFARDGFeECAhABAdFBAMDDBACDAfFFEhACAKGGAFHEC.IHCA.CHHA.aHBE.hAEA......hAIA...,2,-14,-11,3
LIEMgaAVOCQBFZPfHcKJGWRSNbeTXUdYD,CAAAQAAAZACAHAGBKCCAGACB.RAGFSCDAeDABUDGBdECALDABhAAA.EDCBaEEBAAFABDGDhADAFFFH...fEEAhAIA.cFGANIAB....hCAA......hCDA...,2,-25,-13,12
bEBLQUYCFIAfOGgeZDNVPJXaMHSTcdRWK,GAAAeAAAZADBDADA..VAFAXAEA.HBGBTDBARCDBKDCDECHFhAAALFDAUEEAFEHDAAABOEHDhACA.PHAAhAHAaFCDMIAA..dHFBBBCA.CHHA...hABA......hAIA...,1,2,-12,14
cUPAYSKGgNBITJZRdObafLVXQeMCHDFWE,KAAAGAAABACBJADARADF...dAGAOAFA..aBHDLCFAhAAAQCDAeCCBHDBBFEEAEEHBhBGAPDGB.AAABSEHHhACAIGCATGGAbFDD.....hAIA......hBCA...,2,-24,-11,13
DHTZBMVFJgREIcOSWKULfadYACNQPbeGX,QAAAeAAAGADAHACAZAFAMCCBFAFARCDAEBHFOCGB..KDHBLEHBhAAAdEAAAECA.CFDAbFEDhABATEFA.BFEDgGAAhAGASGCBfHCFaGHB...hAAA......hAEA...,2,-11,4,15
YEOSICQLUfDABJRVZXHKedWgGbFaTPNMc,RAAAZAAAHADBeACEdAFBGAFAFBGH...aAHFTDAA..MCCBhABAECCBOCHDCDDALDHBhAFADDFBAAAABEFD.XFDChBHAKEGD..WEEDgGGG..hCAANIABSGHBhADAIHEA...,2,-24,-7,17
IGKLdfJbBaAFCVPDYMEUQZNRcOWHSXTeg,CAAADAAA.EACAZACA.RAGB.OAECHCCA..SCFHeAHHGCCAdDAA.hAAAJCFBBDHA.AAEAFECHhADAPBBB..MEEBhAGAQEGA.cGAATFFAKGGDLFHBhAIA....hBIA...,2,-16,-14,2
EGBcANRXHeLMUDTKIYJaZPbOfFgCQSWVd,RAAAHAAAeADEMACA.DAGATBDAKBDA..JBFAZAGB.OCCBFCCH.hAAAQDEDSDFAhBIAdEHAEEDFGGABBEHAAFFAhCAALHFAUGGAaGDDfFFE..hAAA......hABA...,1,-3,-16,13
PGBWIUgOeKXSHFYacbLfTJZQAMCVdDREN,MAAAdAAAEADAGACBBAFA.UAGA..eAGHSBBDHCACaBHDLCCBhAFA.TCEAhBAAZDEAACFBDEIBRDGB.PECDhACAgEEGKFFA.FGHD......hBIA......hCAA...,1,-9,-20,11
AIKDPSYLeVMFcGaQXNUEgBRHJbfCWZOTd,DAAASAAAeABAFAEDGACA..aAGAQAEA.XAGAhAAAEBGBRCCBHEFAbCEACEAAhABAZGDA.OHBCADIBKEEALFHBhAEA.MGEA.NHAB.BFED.hAHA......hCAA...,2,-21,-5,16
CKTEeUYdWAaBRDVGgfLcJQPXbFIMHNSZO,RAAAGAAALADBQADA..bAFAMAGBHCEBZBGBKCGAECDBeCCDhAAAdFBAAAABDAFA.VEGBhABAfEFE.PEHDhACAFGCANIEB.CFDA.........hADA......hAHA...,1,-1,-14,13
fYeSXLQKAIZDFUcCPHdBbJWOgaMTVRGEN,ZAAAFAAACADAHAEA.dAHABAFAJCAA...OAGDaCEC...MAIBhADARDFAEDAB....fCCAhAFAeEEBLGAAhABAACFBDDEB.PHFC..bDFD...WECHhBAA.....hACA...,1,-11,-47,36
SIVbXAeaQfYDZcUFELdPOgRHBGCKJMTNW,eAAAaAAA.QADADADAZADE.FAFEEAHBdCCA.OAHDHCCCGCFAhAIAKCFA.MBBBTEDAhAAASDHBIEHAbFCAhBAAAFGB..fGEA..YHCAhCAA.....hABA...,2,-22,-1,21
SMWdXcJeYbKLUNEFTOaZQRDfHPAGVCIgB,GAAACAAABACA.MADAdAEA...XAFAeAGBKCAALCDA.hAAAECHFTDCAZEBBREEAfFHAhAAAHCFBAAHA..hACAgFDASGGDJEBFbFCDFFHB.aGGH.hAIADBIB.....hBAA...,1,0,-18,18
MJQPWOcBHSGYDadETgfAVCLKNeIZbRUXF,LAAAeAAAZADBRAFAFAEA.MAHBQCFB.OCCHHBCCGCAAhABAaCHD.ECFFTEEAhAAAAAIBKDDDbEFAUGAAXGEAhACAPFHB.BHHADDBB.......hABA......hAGA...,1,-1,-8,7
MZRNVYEeDdOUcKPXfQJLIAFbWBaTSCHgG,FAAABAAA.aACATADAHAEBGBCARAFF..VCCBEAGAdCBC.OBHDhAAAKBHBXDADhADA.QDGDhAFALEEAADGBbFDDCFHAZGAA..eFFBDGGB.PFHBhAHAIHHA....hAGA...,1,6,-10,16
NaQTFDHfPRSCdegWcVbAEZKJULBOYIGXM,EAAAZAAAKADCLADABAFA.OAGDGAGAMAIB..aCAAFBCHHCEBhABARCEBdEAAeDDD..gECAhAAAVFGBAAIBUGDBhACAXEGA.TGDADECB.SGGBhAEA.....hCEA...,1,1,-12,13
QGZaFCRNdWBYUHebEPVTfXcISOLJDAgMK,MAAAGAAAZABEaADARAEF.dAGABAGBHCDA.ECHF..TCCA..hAIAXDBDSBGAhBAALEFAADGAQEEAhCAACGBAYGEAeDHF.bGFA......hCCA......hDAA...,2,-17,-7,10
IQKgSfHdbNJUOWELYZFReaTcGXVPAMDCB,MAAABAAAQACAKADA..SAFBHAEAbCAB.UCBAEBHFZCDEhAAARBGFeCFD.aDDDGEEAhACA.XDGAhAGAAAHACEHAIGGAdGHAOHAA..WFFD.hAHA......hAIA...,2,-28,6,34
LIdQHBfZAMaWeJNKVRYEFDPgObScUCGTX,aAAAeAAA.KADARACFFAEADAFA....OAHDSAGHUCCAGBFAhAAALCEB.dDGAHEGBhABAZGEAAAIBMEFB.NIEB.YBBFhBAA..EFCA.PHBA..hBHA......hCAA...,2,-26,-11,15
PVBERMLYAUSJTIfcOQXWGCKgbHNdaZFDe,SAAATAAA....fACBQADAGAEAKAFAHCCAhAAAaAGAZBGFeAHHBCCAhAAARDABMCGBACIBIEAAhAEAXEEDCEDAbFFAdEHADHAAEGDBYHFAJHFAWHAA..hCAA......hCCA...,1,7,-6,13
ZfLDEdOJNRGUKbMSXAVFeWBTYQIPCHagc,eAAATAAAQADA.CAFA.HACBaAGD.ZAEALCCBECABdCFAOBHDhAAARDGBGEDAbEDCMAIBhAAAAAFAFEHHBFFB.IHHAhABAgGGG.DHAA.NIAB....hCAA......hCBA...,2,-9,6,15
WIZAKeFHdPGJXEQBTMSVRNDUOfcbagCLY,eAAAHAAAGADAEADABAFAMAFA.RBFFDBIBOAGD...bCCAaCAChAAALECBIEHAAAAAdEEDhAIAXFBAQFGAhBIATFEASGDH.....hACA......hADA...,1,-8,-16,8
TaMScIFWefGEbNBZHAJYdgDPXVCRKQUOL,dAAADAAA...XADARABAQAECLAGBMAHBSCAAhACA.FCEHeCDBEDCFbEADhADAZDEBHGAA.AAIBgDGAhAGACDHAOEFCaGCAIGGAfGGANICB.hBAA......hCAA...,1,-3,-19,16
OYEBVNGIQKeHaFLfdTZMAPWCgRDUcbJXS,CAAARAAADADAUACA....JAFBOAECBAHA.GCDB..QCCAhAAAHEECaAGALEHBhAAAdCHAZDFBAEBA...gGCAhBCA..cEDDSCGEhCAAEFHB..IHAAhABA...,1,-12,-47,35
GMEPXbgUNDFaYfOSAVQRWIZdJKHCTeBLc,RAAAZAAAdADAHAEA.eAHHLAFAGCAAECCBXCCAUCFA.FCFDaDHDhAAAODHD.AACAQFFChABAIFDACFFABGAAhABAMHAA...PHDA.....hAEA......hAGA...,2,-25,-2,23
UNbcFfVEZJCTSYAWPeGMKgBXdHIQaOLRD,eAAAGAAAMAEABADAHBCAaAED.RBFF..DAIBUAGA...bCDCfDEEhAAA.EDHBhABAZDFETEBAAAABKFGAdGBAhACAQFGCLHDAFHBACHHASDADhADA.YEEF.hBEA...,2,-8,-6,2
CVEOgNXGMDcdQLTbRWeIJSaKPZHBUFAfY,CAAAEAAA..OACA..XACAGAFAMAIBdAFATCCARBCBeCBBhAAASAHB.hAHAaBGDZEEAHDABFFBHADFBfDFEhAAAgGGADDIB.LHEAIHDAhBCAKEED.BFGA..hADA...,2,-9,-9,0
fXZJdDBTacVIEKOHQSMAbFGWegYLCRPNU,GAAAeAAALAEARADAUAGAZCDAdCCABBHA.aCFBVEEB.KDHBHDFBhAAA.MDBBAAABFEAHgECAhABA.CDHA.hAFAfFCADFIB.IGHAEGABSGHDhAGA.YHDAhAIANIBB..,2,-29,6,35
NYKEMaXLAZUHOGRIWeQdFPDBCfJTVcSgb,HAAARAAAeADEdADA.DAFACAGB...TBFASAHH..bCACKBDAhAAAECHFaCCC.ACGBZDEEGDEAhAAAQFDBBAHAfEHAhACAVGFA.gFBAMDIB.XGGAhBFA...hABA...,1,4,-18,22
bLGdfDeZKCBQFWTPOXcERAaIJNHSgVMUY,aAAAJAAAHADB..SACHMAFA.UAEALBFBdAHAeBBDhBAAZCGBBCCDQDDAhBEATDAAXDFARFDAABHA.hADAgFGA.bGBADDIB.FGHB..hBAA......hCAA...,1,-4,-17,13
APcGKMdVIUaCSeDHQJBYWXfNREFLZbgTO,GAAAdAAAUADAaADA..eAFAHAFBBBHAXCDCRCAA.LAHBhAAAZDEA.bDBDTFDAhACAAEEAKEFAMEIBCCFA.DGGBQFFChAGAJHBA...WDHB...hACA......hBAA...,1,0,-22,22
gAHfZVaeGSCTJWKcEYUNDOQPRXFMbILdB,HAAAZAAAeACEGADACAFB.TAFAKAHB.EBHFUCCBDCAB...QCFAhABARDAFMDDBLEFAhAAAdDHAAEFB.aFDD.SGEHhACAJFCA.cGGAOGFCFHAABHAA.hADA......hAFA...,1,8,-27,35
QJPGFXOeTVACdIRWDZYgbfSMEBNLUHcaK,dAAARAAAZADB....bABDMAGBBADALAHBHAEBKAGAQDAAhAAA.GCEAOCGDhADAeEGFACIBCDEDDEIBfFHAhABAEFFBUGAAaFBEFGDB.......hADA......hBFA...,2,-18,-7,11
GWKJNFVZcDbCUBeHfdQPLaEAgTOSYMRXI,TAAASAAA.RACFGAEAKACCFAEDZAFBDAGA.UDCAHBGB.dEAALBHBhAAAAAAAODEHMEGBhAIAXFGA.IHFAhAEAJFEB...cGBBBHCAeHFA.hBGA......hBIA...,2,-18,-14,4
MVCNUQFSfAITGDBYXcWKePHEadbLOgZJR,GAAABAAA..XACAKADAHAFB.EAHBdAFALCDBZAGBRCAAMBIBhAAACDGAQFAA.hACAfEHAADEATEEADEHBhADA..cFDDeFBBbGECOGFC..hAAA......hACA...,1,-11,-16,5
XALdDWJPGIgRbONaUEZfQBSceCVTFMYKH,dAAADAAA.JADAGABB.RAFF.OAGDUCCBZCGBBBDD..eDEHCCBA.hACAFEABMAIBHGEAACFB.LHAAhAEA..IDDAhAGANEIA.EDFF.QEGA.hAFASGGD.hAHA...,2,-41,-7,34
MXVNZOEBeLRfGTaJKDcICWgUPSHbYFQAd,dAAAMAAA..XADAZABEEAFALBHBRAGBGCAB..aCFDDCCACDHA.UDDAhAFAHEAAFCFAAAIBOEEBhACAeEGB...TFGAhADA.KGADWFHHSGFD...hAIA......hBAA...,1,3,-28,31
eBGOAPRUZIDYQLFSJCHdgKEVacNXfTWbM,RAAAZAAADADALADB.SAFAHAECdAHAECCA..aAHDXCEDhAAATCAA..bCEDeDGHhABAGEGAADIBUGDAQFAAhABACEDDKFHB.cGCA.fGEBhACABHHD.....hCAA...,2,-19,7,26
DLAQeZJBNEcFUHVCMGfKdPaORIbgXTYWS,eAAAZAAABADBEADAFAFDHAEB.MAHBGBGAdCAA.aAHFRDDB...ICCAhAAAXDGA..TDEAhABASFGBACEBQFGBhCAANCCA..cGAA.UGDB.hCBA......hDAA...,2,-15,-10,5
bUNRSLZcaKAYHIXgJMOVWdEBPCeFTfDGQ,HAAAXAAAMACA.OAEEdADAEAFABAHBeAHFFCCA..DCFBGCEAhAAAQDBAUDGARGCAZEDFhAAAaGGAACGB..IFAAhABA.gDGA.WFFACHHD..hAFA......hBDA...,1,-12,-15,3
gPLbAYFROSJKdMTVGWIQHNCUEBXZceafD,RAAASAAAdADA.MADAGAFA.QDDAHAFCCBCAEBEBZDGBeCFHhAAAaAHF.DCIBLFAAhAAAADDAODGDKCCD..WEEDhABAIHBABGGD.fGFE..hABA......hAFA...,2,-17,-17,0
MPLeEJIFGRXdVABOCQZKbUTaWHfcgSYDN,CAAAZAAAKACAUAEA...aAGEHAEB...fAGBSCAAhABADCAAMCHBeCDBEDDAFCGDhAAAREBB.dEAAAACA.QFEAhACATFEA..cGFDgGBA.PEHDhAEALHAA..hAHA...,1,-8,-24,16
GfULXWDOMBYgFKJAPEbcIHeaSdVQNZCRT,EAAA..bAAAHACAeAEAdAFA.QCCBZBEERCAAGDEALAHBhAAADAAAMAIBBDFA.FEAAAAEAIDGAhCAAaEECSEGHhAEACEHAUGGAOFDB.KGHB.....hCBA......hEAA...,1,3,-9,12
HbWXUVEecORPZCKADLYTFBNafJMSIgGQd,LAAATAAA.BAEAaACA.MAGB..SAEHGCAAHCCAhABAbAFD.XCGDUDBAEAHBhAAAeAHBREDFZFGBACABFEEBfGFAhAIAgFCD.dFGA.WFHH..hACA......hAEA...,2,-4,-2,2
PVYecJKaZTQGBgMIDFNXdWEfLbOHUSACR,RAAAVAAAeADE..KADCZAGBGAFAMBEBFCCBdBHA....ECDBLCFDhAAAHDEBAAHA.CDHA.PECBhAAAJFGB..aGAATGGAhBFABGEADFIB...NIBB.fEHEhCAA......hCEA...,2,-18,-13,5
cgIKfZeCLXJTWEPHBDFGOMbAYNVRSaQdU,VAAARAAAQADC.dAFAUADA..IAHAZAFBeAHFLCHBhAAATDDA.ECCBHEGBhAAAFDFAGEDAMCIBAEGBSFBAhBFAaFFDKHGA........hCAA......hDAA...,2,-17,-3,14
BOMHVSeECDdWbQIYGJPcAXgKRfZFNTUaL,KAAARAAAZADBFACAUAGALAFA.BCCAHCEB.eCCDECEA.dDAAQCGAhAAAGDGA.JECAAAAAXFBDhADA..hBFAfEGEaGDAMIBASGGDDFIBbGAA.hAGA......hAHA...,2,-32,5,37
FXGNJePYCdHWOBIfSVLaAMEgKcQTUDZRb,EAAAKAAAQACCDADA.RAEF.XAEAGAGAeDDBCAHAHBCABDFAhAAASCBDaDHD.ACHAMDEAhAAATEAAZDFEbFFCFFGAhAHA...NEEA.YGAG....hAEA......hAGA...,2,-13,-10,3
SRdYAFCHZUVXLJQWgbMBeDcEIaTOPNfKG,HAAAZAAAUAEALADB.QAFA.bCEDeAHB.ECAAhABAaBHDTDDAOCABfCGAhACAGEGARFAAACCACEBAJEGBhADAMIAA.DGEBIGBA.KFDD.SFHHhAIA..hBEA...,1,14,-27,41
fZAGWJOKgBeHbNdSDETaQcFLVPRIUYMXC,GAAAOAAABADAHADAdAGADAFA.ECDB.aBHDQBEALDFBRFAAUCGAhAIAMEHB..fBBEhBAAAAAB.KDCAeFEDhACASEDA.TFGA.FGFH.hADAIHBA..hBHA...,1,3,-35,38
RVOMYXWdaLINGJTQAcfbgZPUCDBEKFHeS,...bAAAZAAA.CADBEAFAHAEA.RCAA.MAIBXBGAdCAALCCAhABAGDEATDGAABHB.fEAEhAAAgDEADAGAhABAFDHHeECBOECBaGDDIGGAQGFA.hACAPFAB.BHHBhACA.SGCH.,2,-2,21,23
TWOXGacFYJBCEfMNAZIgDLSeKUPdVHbQR,ZAAADAAAeABAKADCdAGAHAEA.RCCA.OBEDGCFAFCAABAHB.ECHBMAIBhABAACCA.LDGBhACAUGAA...VECAbFGD.hAGAQGBC.TGEAaEEH...hBAA......hCAA...,2,-12,-10,2
SYRbEGPQJCXgeLIUDNOWTBKaAMZVHfdFc,ZAAAHAAAdAEASACERAGBGCAA.QAFA.XCCAhAAAeCCBLEEADAIBOCFBhAFATGCAaDGDACCAMEIBFFHDcGEAhBHAECFFCGADUGEA.BHGB....hABA......hACA...,2,-4,2,6
ZLNAIOHcUEJPdYQfBRbeMFTKGSWXDagCV,HAAAEAAAdADAQADCBAFA.RAFFeAHHMAHBKCBAGCAB.XDEDhAAAaCED.CDHAZFAAAAIBOCGHhAAAUGEAJHAA.fGHAhACAbFAAFEHDSFFD.DFAA.hAFA......hAHA...,1,15,-27,42
GdPRUAOQKSHWCBNZDEcMIgJbXefLTFaYV,QAAAHAAABADBZAEBEACA.MAHB..gAEAXCAAeCFHhAAATBGAFDDH.aCHDGDCAhAAA.REEFAAHASFGAhACACEHADFABIGGAbGBALHFA..hAIA......hBGA...,1,-5,-7,2
QcOVKeIGdASBEPLYRDHCFJMXbgaNZfWTU,EAAALAAARACA.HADBFAFA.MAFA.XBFBaAHDZCCA..TDAAhAAAQCAA.OBHDhABAeCFGdEEDADDBBDFDhACADEHBbECDfEEE.cGFBKGGD.SHCAhCAA.CEGA.hCHANEIA...,1,-7,-15,8
cEJSDbKLQWeRaHXgMIdVFOUBfTCGNYPZA,EAAADAAALADA.eAGHHACA.MAEAdBBAOBHDfAHAhAAAGCEAPBFDAAEASDCHhAIAbCDD.QEGDhBAARDGFaCCHXGGAIHGA....hCAA......hCBA...,1,1,-22,23
WaPgSDBdMReOYfXIQHCUAcbTKEZGNVFLJ,TAAAEAAAGACA.FAEALACB.aAEASAGHdAHARBEBeDEDhAAAfCBE.hBEAQDFAHDGBADIBbGCChBHAZEBA.JFFFgGGAMAIBOEHD..hAAA......hBCA...,1,7,-12,19
eMLVfbOWCPQUEcNgIJTZXGFRADdaHSYBK,aAAAHAAABADAeACELAFAVAGB..OCCACBBD.UDDBECDA..hAAA..NCGA.gDGAhAFATDAA.GGABhAGAAAGAdCHAKDEBMFIB.fGGAbFGD..PHDAhADA....hBAA...,2,-27,9,36
GFZdTgcbIeQNVOCXMHaAWEKSUYBDRLJPf,EAAASAAABACARADF.LADA.JAHBGAFAZCCA.dBHATEAAhAAAbDED...eCGDhABAQFAAOECDMDIBhAEAHGFCAAHAKEEDDCCBFFGHIEHACHAA.aDDH.hAFA......hAHA...,1,-7,-9,2
SIVKQYdGLCHEDJWXFgTPUcABZfabRONeM,ZAAAaAAA.RAEA..eAHHMADA..SCAAKAGAdBBDGBDAHCFBEDDAhABADCFA.JEAAFCHD.TFBAhAIAPEHD..AEGBBFEAhBAAbFAC.OFHB..NIDB.....hACA......hADA...,1,-5,-23,18
QCdDJUeYEBFMWXIcZVLSTNOfAgKGPHbRa,GAAAHAAARADFQAFCdADADAFAUBFAEBHFBBHAMCAB...XDDAhAAAZDBBLEDA.hACATFGAfDGEhADAAAABKDHB.aEHD.eFGD.FHAA.WCCD..hAHA......hAIA...,2,-29,5,34
NHIODfLXcPJbYRVSWFdegACKQGUZTaEBM,QAAAZAAAEADEBAFBHACA.DAEALAHBXAGAJCAA.RCEB.SCDAhAAAdECA.ACGAGDEBhAHAaEEHMEHBOECBhCAA.fFFEbGDA.YFHBhCEAFHBCCBGA.KHDANEIA....hDAA...,1,-7,-8,1
dGgFMbRCSVWLcOABKJUYQDaHNTZIXeEPf,KAAAUAAAQACCHADAZAGBeCDA.EDAAdAEA.GAGAFDHDREEB.SDDAhAAALFAAABIBBEFAhAGADGEB.aDHD.TGBAhAIAIGHAXGDB.fGGAhBGA......hBIA...,2,-20,-10,10
BdfDWJGNSYaRgeQZVPFTIHCbOMLcAUKXE,XAAAEAAAdADA.DADAGAFA..SAEARCBBeAHBZDDBFAHBHFABhAAAOBCDMDHBAAAABCEAhCAAfFFA.NEIA.hAFAaCFD.QECB.TEGA.hAIACCHAcFFC..hCBA...,2,-36,7,43
FXfaYGIWdPQJHDeKRLMZbUCcNTAVEgBSO,EAAASAAAFACD..aAEAGACA.dAEBQBECHAGBeBEHhAAARBGFZDDAbDFA.CAHBTFGAhAAAAAIBBFFAXGDChABA.fGHAYECFWFFD.DDIB.hCAA......hCBA...,2,-12,-7,5
YTIeQcaZAMJFRXbODSdHGPCfWLBgEVUKN,MAAARAAAOADAdAEAHAGBGAGA..CBBALBDDEBDF.KDFATCEAhAAAeDHH.QEEBhABAZFDAAAGB.XGBAhAIADGIB.fEHA.BGGD...hAIA......hBAA...,2,-28,-3,25
UBVWCaMQXHOFeZAGScfTDERINKPgbdYLJ,GAAASAAA..TADARACFKAEC...bAFBdAHALBHBhAAABBFACCEDMDGBHCEBeDADhACAAAAA.DCDBEDHBIFGAhADA.PHCAgFED.JHBA.WHFAhBHAaGHD.....hAIA...,1,2,-28,30
BfNeHKLVIGYMJCTDFPAXRScdOabQUgZEW,RAAAdAAAOADAaADA..QAGAZAGBBBDA.eBDBHCEBLCFBhACAGEGAMBIBTCBAFCCHADFBSDHBhAGAUGBA.hAAAEEBBfGFEKFGAIHEA.CHHADIBA.hABA......hBGA...,2,-12,2,14
gBUTIADGMFbHVCOcdNPKSeYXERfZQaLWJ,GAAAMAAAHACCOADAdAFAKAHBeAGF.EBHFRCCBZDGBLCDB.JDHBhAAABBBD.TFDAhAHAACFBbDBD.CGHA...PFEDhACASHCG..fGGE.hBAA......hCAA...,1,-1,-24,23
JVGBIaYZgERdAKTQOCWHSMPcfFDLUNebX,TAAAQAAA.CACAHADBMACA....fAFALAFAeCFAhAAAbAGD.XDDChAGAGBDAaCCBZEFBEEHFAAIBODBHhAAASGCAFEGADFFBNIDBBHAAgGCAhBDA.dGGA....hCAA...,2,-2,5,7
YRNcgXdTLaBJSPEZHAUVFeGCMfDOIWQbK,FAAAeAAAGACAMAEADAIBOAEA..QBCAKAHBRBEF...hBAAgBFAdDGAaEBBSEEDhBEAEDGAHECAAAAACFHA.hCAAfEHA.bGBAcGEDTGFABHCAhCBA.....hBFA...,2,-16,-13,3
GLeJEQCPfdYBSMcWaOXZNgIVTAFKDRUHb,DAAAHAAAGABBeACEEAFEQAFC.CAHB.dAHABCCDMCCA.aCEEhAAAZCEAIDHAACHAREAALEEBhAEAfDDE.hBAASEGDODHDXGFD...hCAA......hDAA...,1,-14,-19,5
SHOTeNfJGFcKEMDZIXBdVCYLbQAgWRUaP,RAAAaAAAHADB.eAFAJADAGAGAKBHB.DBBBZDAA.BCCDdCCACCFDLDGBhAAA.AAFAUFEAhABAODHD...TEDAhAGAFGCBMEIB..XGEA...hADA......hCAA...,1,-11,-34,23
UQFSYDOJdZBPcgHaMKGRfLbWITEACXNVe,XAAAeAAAQADAFADA.DAGAdAGAZBFBBBDD...PCEDhAAAHCCAaBHD.GEGAhAAARDGBLGBAbFBAIHCAhABAAAIBCGFA..NICBSDDDOFFH..hABA......hBGA...,2,-29,7,36
KYTLXOCISJMPHWAGQFdcVDZRbBaeUfEgN,GAAAdAAADADARAEAaADA.UAGA..EBDBKCDALAHB.CCBA.SDBHhAAA.MDGBhACAHCFBADHAQFCAhBAAFDDHZFFAeHCAfFHA.YFFFhBCAOHFC.....hACA...,1,-10,-21,11
ZWCPceBLMADRFfOSIbgdTUYGaQXEJHNKV,RAAAOAAA..bADBdAEA.UAGAGAFAQBBBEAHBHCCBKDDAZDGBhAAA.CEFD.eDFEMEIBAEBAFEFDhBAASFBB.hBEATFDAaFHBXGBANIAB.....hABA......hAIA...,1,2,-19,21
RQEcSFKOMYXGfWJdHVAUZgCBaPDNTIbLe,ZAAABAAAaACADACA....TAFALAFARCCA.EBCAFBHDMCBBGDFAhABA..JCDBHFAAhAFAAAGACCFA.IHEA.hAAAeFCEQDGAKHGAOHAEfEFEhBCA.dFCD....hCAA...,1,7,-39,46
GBIPfVNYEACdTDFKZRHcUOQgbSWXeMaLJ,dAAATAAAKADAHAFB.OAHFQACC.bAEBXCAAhACA.eDCHaAGDGCDAhAAABDGAfEEAhADAVDGBEFFBAAIBFEHDRGBA...gFADMIDAIHHAhBGAYFGF.CHAD..hCAA...,2,-5,3,8
LRbKHFVACSYBefJNWTIOgQXdaPDcUGZEM,SAAAeAAA..fADAJADA.TAFAOAGDQCCBhAAAaBCDDAIBGCEAhAAAEBHFRCEFHEFBACEBBDHAIEHAhABAdFHAUGAAZFAAbGDAFHAA.CHHA.....hAFA......hAHA...,2,-17,7,24
SbfJZRNHTKaPQIOWBVCceXAEDGUMdLgYF,EAAAGAAAdADALAFAFADA..bAFDZCBAHCDBaCFA.QEGAhAAA.OAHDBDFACDHAhAAAeDBHAAGAMFDASFCHhACARFGBNICB.TGEA.KHAA.IHHAhAHA.....hBCA...,2,-27,21,48
SQHLPFBeXgRdGTfbVYaDcOZEMAWNJUCKI,JAAAKAAAQACCHADBLAFABAEB.eAFHRCFAGDAA.TEEAhADAbAGD...aCCHOCDDhAAAEEHB.AAIBUEGAhCAASGADXFEDdGCAfGGADICAMIFA.hCBA......hCIA...,1,6,-19,25
LXQOVSIUFGdHZaAbBRPETCgeNcfMKDWYJ,RAAAEAAACADB...eACA....fAFAMAGBDAHBJBEBLAHBhAAAQDAASCCAhABAFCHDHEFAABHBbCFDBCCBhAAATFAANIABKFED..XFDCIGHAdEHA.hADAaGGC.....hAIA...,1,-7,-15,8
MNPDCgSAZBaeRGLJKcUYHdQWVXbIFOTEf,aAAARAAAGADALADAKAFA.UCCAHCFA.dAHAQBGA.XDFChAEAbDAAOEFBEEHFMBBBhAFADDAASEGHhAAA.AEIBeFABcFCA.YFGFIHHAhABAfHAB.hADA...,1,-6,-7,1
bZCYQOPJfDgLKWNFMRadUGcEBAeVTXSHI,eAAATAAAHADA.ZAGBQACCOCCBJDEBDAEA.LAHBhAAAKDHBFFAB.RBEAdDDAGGEBEDGBAEIBhBFASFCHCFEA.hBHAfFGBgGFAMIBA....hAAA......hABA...,2,-8,-8,0
OaZPdgNLSEMKbTFYCeIXBAcQJVDHRGUWf,QAAADAAAHABCRAEFGAGAUADA..OAFCZDDAdEAALCGBhAAAEEHFMCCBTDBA.CDDBeDFFhAHABFFDAAIB..cFDChAIAWGAA..aGDDgGGAKGHB..hBCA......hBDA...,2,-15,-7,8
FAbfNYUdEGLJDKeCTOgaMSZQIVBRcPXWH,...bAAAfAAA.UADAEAEAGAGALAGBKCAAeBCDhAAATCEAaCADZDFAQEAAhAAABBFBREDB.XECAhABAHFFBAAIB.dFFADICAODHD.MIAA.SGBAhACA.IHHAhAEA,2,-14,13,27
bBNPVJHWaFMRCXefGKcIdZDYgUSQTEALO,LAAABAAA.VAEAHACA.aAEARCAA.eAGHGCGAKCAA.dDEAZCEFDAIBhABAUEGA..TGDAhACAAAIBODDB..bEAAhAEAPHDAFGGH.CCHA.fHAB..hAHAIHHA..hAAA...,1,1,-27,28
WSdIXRMEQgOAGZBCUPaKfbHLDYcVeJNTF,ZAAACAAAUACAaACA..KAFAHAEA.LAHBDAIB..VCDAeCBB.hABATDDASCCDhAFAdCGCRFDAEFHBQCGChAHA.AEIBBFFAbGAC.YFHFNIEB...hAAA......hAGA...,2,-25,-3,22
YgAMdfaBNQGHbLZXDWTJKEPVFCeIUSRcO,dAAAaAAABADAGADAHAEBZABBDAFA..TAGAEAHF..FCFDeBBBhADAUFBARDCFOCHD.hBAAAEFAMFFBQEGAhBDAbGAC.XGGCKGGACHDA.SHDA.hAGA......hAIA...,2,-14,-9,5
QHZeCUXAYcbSKLGEdFTWBPRJVfaNMIOgD,...bAAALAAA.EAEAdAEATAGABAGARCAAJCAAaAHD.MCGBhAAAOCEB.QCFChABAHEBAeDEBXEAAhACAACAASDHBGEGAFFHHWFFDfGAAhABANIAB.DGGB.CHEA...hACA...,1,4,-9,13
EOQFBMadKZUAbPNRCIDVSfYLTJgXecWHG,...bAAARAAADADA.SAEALAEATCAA..XAGDhAAAeAHHHCEBECCAQCEDhABAMDDBdEHAZFABAAIBCDHAhCAAfGCEJEFF.gGFBWFHBFHDABHGAhCCA....hDAA...,2,-25,9,34
XAQMICZOUNcSFfgDTHYEGePbLRdaVBWKJ,MAAAZAAAOACAUAEA...SAFAFAGEDBBAHCCAEBHF.GCGAhBAAeCCALDFAREBB.hBEAaEECBEEAKFGAACGBQGDAhCAACGAA.fGGE...hABA......hAGA...,1,-12,-26,14
AOVDEZSbRTWUYdNCLeFHBgMXcPfIKQaJG,DAAAEAAAZACBRABA..UAEAdAFALAHBHAGDBCDDMBEB..XDEAhAIA..fDFAhAAAQFDAGEGAhBCAACIBSFGAbFBAYHBAeHEA.FGFH..hBFA......hBHA...,2,-23,-12,11
UBbeTKENFQMHZCYacRVOgDLSAWGXPJdIf,GAAAXAAAdADAUADAeAFA.KBHBFAFEHCDCZCDE...aDBDRCGFODBBhAAALEEA.AAABJFAFhACABEEA.EFGBMEIB.hABACGCA..VGEASGHH....hAIA......hBDA...,1,5,-27,32
bJdNHeMQCIYgGWUTVPABZDfXacSORKLFE,ZAAAXAAAaACA..OAEDRADALAGB.ECDBdAGAHDAAeBHHMAIBhAAAQDDCCCFC.hABAgEGAGEFAWEHBhADATGBAAEFBBHHDfGDB.KGHB.hAEA......hCAA...,2,-9,-5,4
KaYAQbSPOWLBUeJgHdZDCVGcEXfINRMTF,QAAASAAAOACDLADA.eAGHHAEAZCBECAHBGCDAhAAAECHFXCEDICGAREAAMEIBhAAATEAAKFFAAAEAbFFABHFAhAIAUGAB.dHEBDIBAfDHA..hABA......hAEA...,1,3,-1,4
VTKfJAeZXEBgODCcMFQIaSbWGLYUNRHPd,eAAAEAAABACADAEA..MAHBQAEA.aAGEbBAA..GCCAhAAALBEBUEFAHDFBhAAAdDHATEAAfECAhABAACCBZFDBOCHDFGHDSHAAYGBGNIAB..hAIA......hBGA...,2,-15,2,17
ATKDNWJZCFSIVOHRdEYUcBfXLGebPgMaQ,TAAADAAA..JACBZACBFAEA..SAEA.OAGDhAAAHAGBEBEBUDEABDDALECBhACAeDFF.bEGBMBBBhAIAAAIBKFAACDHARGFA..........hBAA......hBIA...,1,-10,-36,26
FWHCBgGaZXQVNLfPcRUYSeEIMdODKTAbJ,FAAAHAAABADAaACAZAEB..QAFALAHB..fBGAhAAARCCASBHBECCAdEEAKDAAACCAhADAbEFD..CDFAGDGAhAFAXGBA.PEHDcEEC...eFCBhAIA.MIEA...hBGA...,2,-16,0,16
eTaZICMdHAXBYPEJVLNQbGcDFOKUSRgfW,BAAAEAAALADAQACAGAGAFAEEKAHBRCBA....fCFEhAAAeCABZCCAMCGBHEAAAAEAhAIAXEGDPEEBVGFAhBCA.NIBB.bFCAODHDSDHB.WHAAhAAA.IHHAhACA...,2,-27,22,49
CfVbOYUeIgaScBALKNZWPMQdTFJHXDERG,LAAAZAAAMACAdAGATAEAHBDB..EAGERDFAGFBB.CBFC.bCAAhABAOCCHeCEAaCHDBFHAhABAACAAKEAA..PHFAhAIAQEEA.XGFADBIB.fHDBhACA...hCAA...,1,-2,-12,10
ZfbHNQVDWIXMOgeKRBJLCFYGTUEAdPSca,dAAASAAAZABBHADAQADADAFA..XBFAMAGBeAHBhAAARDCALEGBFCCBGCGAhABAEFDAAAIBaDAB..NCIA.IDEAhADA.KFBACGFC.TGFA...hBAA......hCDA...,2,-19,1,20
MWTDNcLPCaVKXeRIAfJbOgSFdHUBEGZQY,JAAAOAAA.FADDHADBBAFAEAFA.ZBGBMAHBDCCB..LDABhADA.CCFA.aBBH.XCEAhAFAREEBACIB..fEHAhAFAbEEAdFCAUGGB.......hAIA......hBAA...,1,-26,-28,2
QSGVOaYJEITCdeBbRHDZcULFKNMAfWPgX,...fAAAgAAAQADAGADAaAFAEAFA..TCFAhAAAeAHFRCAAHDAAZDCELEGBhAAAKBHBAADBXEFAhABAOFFBIGBAdGCADEIB.FFEH.MEIB.SGGDhAIA..hBFA...,2,0,5,5
ONgFPeIRYGVAUHaBbTEcQSDKXJCdLfZWM,HAAAaAAABADAEADEQAFC.KBHBCAFAdAHAZCAA.MBBBOCEBhAAAFCCA.eDFFRCEFGDGAhADAAAHAbDGD...TFAAhAFADIEA.XGCA.......hACA......hCCA...,1,-8,-20,12
TSdeIWBbYVEDAQUHgXLFKPJNCcMRfaGOZ,HAAALAAAKADCJAFBCAEARAFF..GCAAZAGBdCAD..eAHHBDCAVCCAhABAABIB..QEDAhAAAUEFAFGHD...PDHDhACAMHAA...aFFD.SHGAIHFA.hACA......hAEA...,2,-20,-13,7
NLFYXKCfQSVAGPRgZDeBJHIEUWOacbdMT,RAAAZAAAeADEHAEA.EBHFOAGD..bCABdCCA.MAIBLDDAhABAFBEHKDFAQEGAhACA.AADAGGABDEEBBEHAhAAAIFDAaFFBTGAAXGGCSGGAhABA......hAGA...,2,-24,9,33
PbCEYVcTZaODfIKAXFBMUHLRGSQNegWdJ,BAAAHAAARADFGACAQAFCeAEAdBHA..bCACECAB..VCGBhAAAZCEBaDGCDAIBKDEBAAEAMFGBhAAALGFA.SHAAhACAWFHB..CHCA.......hACA......hAIA...,2,-24,2,26
IfXYQLPaTANKFVZgJceRGdUMDSBOWHECb,FAAAZAAAJADARACFGAEA..dAGAMAHBBCAAHDFB..ECCBbEAA.hABA.XCECLEHBhAEA.aEEHAAIBKCHB..hACAgGAAeEFBSEGBCHGD.fFCAhCAA.YFHBhCFA.,1,3,-44,47
BfIMUAQFHdCXcSDWPVeRKTgGaLZNJbYOE,HAAAdAAACADA.SACEDAFA...PAFARBDAKAHBGCBAZBFAJCCA.hAAA.ODEEECHBBDAChACAMEIBADFA.QFFAhBIA.FHDAXEEA...cFGDhADA.eGBA.aHEChBAA...,1,-1,-36,35
TeLbYXQGISaKBDUAcNRJHdPFEMfOWgVZC,RAAAHAAAdADAFAFAEADEMAFA..OAHD..gBEAhAAAZCCAeBFBLEEAbBGD.hACAQGGAGCCAaEFChBIADHDAACCBcFGD.JGDE.....hAAA......hABA...,2,-26,11,37
adcfZHTBENPVGFeUJIQYSLgADRWOMCXbK,RAAAMAAACADB.KADAdAFAZAFBHBGB.BAHBEAHF....VBBBeCCBUEDAhAFAQEEALDHBhBAAAAAAOECHaFCB..hBFATGFAPEHD........hCAA......hCDA...,2,-24,-13,11
IZMSTfNeUcAEWCQKDObdJGgFRYXaBLPVH,EAAAQAAADADA.dADAGAEBRAFA.aBCBLCFAHCEAZECAMDBAhAAASCHBTEEAeEGHhAFAAAHAKEGA.OFHD.hAAAbGAAFGEHBGEDIGGA.....hAGA......hAIA...,2,-11,-5,6
EAVefacXJDCHNTBMLUIFKQRbgYGPZSOWd,eAAAaAAA...XADACADAHAEBBAGALAGBFBBHRCGB..bCCBGDCAhADAZEAB.OEEDhAGAEDHFAAAAVEEB.fGCAhAEADAIBMFIBKGGB.......hAIA......hBGA...,1,-13,-17,4
DGRQMSHLFEOYfBUVXaCbAIgeNdPcWJZTK,eAAAdAAA....PADAJADBZAEB.DAHBRAGBMBDBHCFBLDHBhAAA.EEEBfCBAhACABGBA.XCEAhAIAaCCHAAIB.gECANICB.TEGA.hABAQFEDOHFA.hBGA...,2,-17,-11,6
VYIeZEXbdQcJOgAFPDCHKaRBNMGfLSUWT,DAAAHAAARABABAEBGADA.LAFAUAGA.TCFA..ICDAhBAAECABdCHAQFEAhAAA.OCCBhACAACFBCDFAaDGDMFIB.SGAAVGBAeEEB.XGGAhBGA...hADA...,2,-37,3,40
VDKYFRcSfUbXNePMATLEGZgaQOIWHJBCd,EAAAZAAAaACA..QACAOAED.HAEACAGA.dAHAKBHBRCEAfCCEhAAAUDEB.bEEAeCCBhABA.ADHBGGABhAGA.IFHABGAADDIBFFFHXGEAMIEA.hAIA......hCAA...,1,-3,-17,14
MNIdLcPaCEFAeGKDWYbHfgTZOQJUVBRSX,eAAAGAAADAEA..bADAHAFC..TCDAZBAEQCDAhAAA.VDGBRBGFMDABdEBALFDBhABAaDCHEEFBAAABKEHBhACAfFFEOFADBGEA.SFCAhADAIHHACGCAFGHH...hAIA...,2,-7,8,15
WcbZUDBYAedPSIVRaKTMLOGFHXQCEfgJN,eAAAdAAASADARADA.KAGAMAHB.GCCAHCACQCFAhACAECFBJDHB.NCIA.bEADZEAAhADABEFDADEB..IFEAhAEAaGGC.TGAA.LHDA.hAAAOFHH...hABA...,2,-22,8,30
PYGTAFegbUXSINMJfORLQEcBdaCWKVHDZ,eAAAUAAA..SADAMAEAOAHDRAFFLAHBEBCA.BCDAaBEDKCGDhAAAHDAAZECAGEEAhADAABGAFEGD......hAEA............hBAA......hBCA...,2,-29,-23,6
FPQfbCZeNOWYEHXLcJAGKDUMgITdVRaSB,GAAADAAAMADA..TADARAFABBBAFAFA.QCDBCBDA.eAHHhAAAOCDEEDFFHEGBhACALCHBADABKGCAUEEA.hADAdDBAaGFHSGFA...fHDBhAIA...hBAA...,1,-3,-33,30
HbdKOSUECZJaVQRYTDFXNBfcWGeIAgLMP,MAAAHAAAdADAKADA.SAFAUAFA.EBHFZBBA...aBHDRCAATCEAhAAAFDDHBDGD..fDHAhACAGFDBAEIBLHBAhAIAbEFDCEED.JHFEQFAA.XGCBhAFA...hBAA...,2,-24,9,33
OMVDBacedUXTfALHNKYQgSRPGWZIFbECJ,HAAAKAAAQACCRADFGAFAZCAAFAEA.EAHBOAGDMDFB..BDHAeCDFhAAAdFAAUDGB.TFDAhAIAAEEBLFHB.gGFAhAAASCEHIHDACFHDDGGB...hBIA......hCAA...,1,6,-23,29
OgUZJNBdGXMYFcEfSPADQLITWCeaRbHVK,LAAATAAA.eADHRACFHAEBOAFAZAGBBCADGBEAMBIBFBHDECAAhABASDED.AAGBQEAAhAAACEGAbGBA.hACAKEGAgFGAUGEAdGHA......hBGA......hCAA...,2,-12,7,19
JMFXDUOBNgGVTfcIHeECYbPZAWRdSQKaL,RAAAdAAAQADCaADA.LAFBMAGBDAHBBAHAGBDA..TDDAhAAAIDBAHCGBECHFhACAbFCAAAIB.KCCD.XGFDhABAOEGBVFCBeHAACHHBPFHD.WFEHhBAA......hBCA...,1,10,-20,30
DQEHaSCUGFWZKIceJdTNVbAfYgOMXPLBR,...fAAAOAAAMAEALADARBBAEAHF.HAGB.aBCCCBEBGBFAhBAAZDDAKCAAeDHFdDDATFEAhBBAbEABAAIB..XFCAhAAADCIBSEHDFFFHIHHA...hCAA......hDAA...,2,-21,14,35
bVQaPYXDBeCAfdLJWKZFGMSIUHTgcRNEO,dAAALAAAKADAGAFAMAEAUBEAHCAC..TECARBGB..ECAAOAHFhACAQDCC.hADAaEFBXEEDBEHAAAIBJGFEhABAZFAFSDHD.gGFAhAFANICB.....hACA...,1,4,-20,24
NAIFbRdOPSEaLUDJBeYGKTfQgWCXHcVMZ,FAAARAAAdADAOACD..EAFALAEADAIBBBGAeAHHGCDBKCEAQECAhAFA.CDHAHEFAhAGAMCCBAAAA.bEEAaGCChBAAUGEA...TFAAfGHA.hAFA.WEHH...hCAA...,1,-18,-19,1
LRTMISNOGbWZQfCcKUeHYEFaDXVgJABPd,dAAARAAAMADASADA.GAFAZAEEQCCCCAHA.KBHBHCAChACAECFB.aCHDDDHBXDEDhADAJEEB.ADEBLEAAhAEATGFA.OFGDfGCAeHAAFHDE.hAAA......hABA...,1,9,-30,39
NTZQgKaJSCWbAFYcfVGIEUHXdMBDLOPRe,FAAA..fAAAGACAEAEAHADAdAHAMBGBLAGB.RCAAeCEFhAAAZDGBQEAAhAEAaCHDCEGDAAIBVFAAXEDABFEAOFHDhACAPHBANEIA........hBAA......hBHA...,2,-10,5,15
JRSYAIOWDZGgbECVBNXLdUPcMafQKeTFH,OAAAZAAAGAEA.EAGABADALCABdAFAUCCAMBIBQCGAhAHA.eDFBHDDBRFBAAAIBhBAADCCB.bCGDCFHA.XGAAhABAaBBH.TGEASFFDIHHAWHBAhBFA......hBHA...,2,-25,9,34
PdeEHMGUbSOWgRXNKLCQcIfBaYZAJTFDV,TAAADAAAdADAHAFA.GBBASACBOCGDRAEAKBHBLDEBhAFAQCCB.fCFAhAAAaEHDAAHAFFCD.eDGFhAEAEGFF.bFAA...XFGDCHHA.BEEDhAFA.YHAA.hBAA...,1,4,-17,21
ORDeNBbaUTEGAJCLZMPcfFdSVHIYQXgKW,LAAAZAAAMACA...fAEAdAGAHBDBQDFAKAGARCAA.hABAeCCDbCEA.aCHDEEABAAIBCBFChABAFEEA..SFFDhCAAIFCAXFGAgGGBDCIB.BGADhACA.GGCB..hAEA...,2,-7,1,8
SHILeBEAQdfNJFORcbDZVYGTKXUPMCWag,dAAAJAAA.RADADAGAZADBGAFA..TBGAKAHB.UCDBMCCB..hADAaCAEHDEB.eDHBhAHAADGBQEAAFFBHOFHHhBAAVEGB...PEEB....hACA......hADA...,2,-24,-14,10
NbQMCcFXISWTLJaHDRZUgfOKAEPBdYGeV,EAAAdAAAeADA..bACAMAHB.FBFDSAGALCCBHDADhACARCCAZCFBUEAAOCHDAADABCHAhAAAGEDAQFGAhAGAXFFBIHHAJFEFaHAADIGA.....hADA......hAEA...,1,-1,-6,5
DMSHYPgEcKTOJQIRaWFeGbLUCBdXZVNfA,MAAAHAAA....gADBEADAKAFAOAHDQAGA.RCAAaCEEhAAAeBBBGDGALCFBhAHABEEAZDCBfFAAhACAADHBSEEDcGADTGGAIGEA.hBAA......hBCA...,2,-26,12,38
HKYOfDgdecEXUaGLWAJQBCbVPMNFRISZT,QAAACAAA..bACAMADA.RAFAZBDFHAGBOCFEDACAeCCBhAAAEDCB.aCECGEFALEEAhAGAAEHABFCDVGBANIAB.SFGAhAIA..YFHBdGEA..hAAA......hAIA...,2,-13,-2,11
YHKOeaBcFMZVATGXJbfSPgRDUdWNLICQE,GAAAXAAAJADA..SADARAGF.dAGALCDBQCDAhAAAHEGBeBHHaCFHFGAAhAAAZDAAADGBTGDAbEFAfFDAhABADCIB.NIABEGGB......hADA......hAEA...,2,-14,-3,11
HeTBfORZWDCUNXSYPGcLdEFQbIKMaAVgJ,VAAAHAAAeACE.TAGAOADA.RAGBZCDACCCAUCEA..SBEGhAAAGDGAdFAAEDHFbGDAhAAAMEEBACIBBEDD.DGDAhAFAXFFC........hAIA......hBIA...,2,-28,0,28
KgXEJcAUIBfFNbLaedSQMYPCHGODVTWRZ,BAAAFAAALADAeACAdAGAMAHB..CBEAHCAAGCCADAIB..TEAAhAEARDCAZDGBKFDAEDHFAAIB.hAAAUFEA..fGBAhACAaGCHQGGCOFHD.....hAFA......hBAA...,2,-22,-12,10
MZRgIDbNUYcHdWfLaKSVFXTQPeBJGAOEC,EAAAZAAARAEADADAUCAA..HAECdAHALDDAaAHDKBCA..FCBHQEGAhABAeCFBGDDAAADA.hACAMDHB..bFAAcGGChAAA..SFFD...hAHA......hBCA...,1,-16,-21,5
GMLIbfVAcaPWRBeKgNXSOJZQHTCFYUdED,aAAARAAAeADE..KADA..XAGBOAFAZBBAHBDAFBFDdDDDEBHFGDFAhAAA.MBIBbDAA.hADAACCBPFHDBDHASEEAhBAAJHDA.TFGA.....hABA......hCAA...,2,-22,-4,18
RdLYXHTQKZBIDeWSFgfCacGANPMJOUVEb,MAAAOAAAUAEA..EADARAGBLBBBHAFATCCAZDCBBBDC.hAHADDIBeCEG.FDHDCEEAGEGAhAIAABBBPEEB.bGFAhAIAdGEA....YHCA...hBAA......hBIA...,2,-23,1,24
GFOVDSHebNKPfJCaIXETdMBYWUcgLAZQR,RAAAGAAAOADASADAHAGB.eAFHKBDAJCCFaAHB...EDGBdCDAhAAABEEAUDGA.LEFDhACAAAAAZFDEFFHDbEAC.fGGBhADAXGBDMIEA.....hAEA......hBAA...,2,-16,-3,13
SaDNGUdRCcBIOgQXYJEeTKPALFMHWVbfZ,MAAAHAAAVAEAZABEDAFAGCAB..RBDABAHAOAHD.QDEAhAAAXCFA.EDHBeCCBhBAATEAAACIB.LGEAhACAFEEA.fHABaEHDdGBACGGD.....hBGA......hCAA...,2,-27,17,44
XegGaWZKUfDQPFdVATSBcbHRCNOYMELJI,TAAABAAAHACA.RAFFOAHDEACELAEB.XAGAeCABaCCChAAAZCCBKDEADCCB.QCGChAAAdECAAAEASDHDhACAbEECCFHAMGAAIFFAGGDBfGHAhAHAFHAA......hCBA...,1,17,-19,36
FAdDPHgSEOUYNfZTQJBRbKLGWceMVaICX,dAAAHAAAEADAOACA.UAGA..fAFAZBEBTCCAQBGAhACARDFFLDHBGCBAhADAeECBaHFAXDDBhAHAAIBA.DDGB.SEGH.YFEBhAIA.BGHA..hBAA...,2,-19,-2,17
bAgMEYeLSZcUNVKCHBQdfFaIRXOGPJWTD,EAAAeAAAZACBUAEA.KAGAHAEA.dAHAaBCDRCEAGECA.JEFBTCGAhAAAABCB..MEHBhAAALDEB.SEBAhABAcGAA.CEHAQGFA..hAIA......hBEA...,1,-10,-29,19
ULRNbKGSfOVZMeEHgCQIFcPXaJDdTYBWA,RAAAKAAAGADAOACAZAFA..EAFAHCFA.QDAAFAHD.XEFAhAAAaBCDdCEATDGAhAAABFEDAAGALHCAhABA.SGGAMEDBeFFB.CFHAIHHAhCAA.....hADA...,1,-6,-22,16
SVZQgEaNYGMTFKWcbRUHedLJXIDBAfPCO,CAAASAAAZACA.EADAaAEA.GAGAFAFDKAHB....bCCBHCCAhAAALDABXCGDhABABEEAADAAOECBQEGBhAAAgEEBMGDA.TGDA.WHAGhADA......hAHA...,1,-16,-20,4
efGFCUNTaZWdKPgcJbQHEOBSVXMDARLIY,RAAALAAAeADEGAGACAEAUAGA..aBDDdCAAKCFD....PCCAhABAgDCG.JEGFhAAAHDEABGAAXEAAhACAAAIB.fEHANDIA.ZGBAWFFDbGFA.hAEA......hBGA...,1,-13,-15,2
FNgMGIdVYQREWHDOcLeBbATZSKXfJUPaC,ZAAAXAAAUAEA..CAGA.FADA..MAIBdAGAQCDA.hABAECHFHCAAODBBeCGFhACAAAAAKEFAfDEAhADA.aEBDGGBB.IGGAREGFDEDB.BFDBhAIASFFDNEIA.hBDA...,1,-14,-18,4
cGbDdWHNFUPLXMKeYaIORSVfQTJCBZgEA,GAAAdAAAHADAFADALAGBMAGB.eCAAaAHB.RCEB..SCHHhACAQCDATFAABCHAEDCBhAAAAAIBDDDBUEGAKFGAOEEHhADAfFDACGCA.ZGFA......hACA......hBAA...,2,-13,2,15
WcPOFDbVdeCJHAKGfXREYgNTaZQMLSIBU,GAAARAAAEADE...NADA.ZAFBLAEABAHAUCCA....PBHDhAAADCHBdEFAeCEBHFAAhAAAAAFAXEFD.hABATFCAaDHDMFCASFHBIGHAOHEAhACA.....hAFA...,1,-5,-26,21
DeHZPGNdQcCFITfKUSgREBMYXLVJOAWba,aAAAHAAAGACAdADAQAFAFAEA.TCEAKAHBSBBDhAHA.ECEAMAIBLDGBhBAAOCABADIBDEBBeCCBZEEBhBEAcEECfGHARDGBXFAA.WGFAhAAA.NIEBCHBDIHCAhCAA...,2,-16,13,29
EHeVPDKOQBAMcULFZWRdCJfgTGYaXSbNI,MAAALAAAZABERAEFdAEA.CAGA...JAHBTCAAGCCA..aAHDSCFHhAGA..hAHAbCCDEDHFHCECeFFBDDIBhABAOFHDAEEAFEGDfGAA.YFFFhACA...IHHAhAGA,2,-25,-9,16
MSYIAVZWUaHRTLCXQBgNdDFPKEfeOJGbc,ZAAAaAAAHACBRAEALAHBQAEABCAAdCCDFAGEKCGA..ECFAeBBDhAEAGEAAMDEB.SDFDhBAAAACAUEEACEHA.XFGAhCAADGHB.OGEC......hCIA......hDAA...,2,-23,-6,17
aMABTDbNFecJCORVfKGIgHYLUPSWXZEdQ,TAAADAAAFACD...eACECAEA.RAFF.KAGAGCCAHCDALCGBhAEAUEFASAHBZFCA.ECHBhAAAaBBHACCBBFAA.bFDDhAFANCIA..OGAC..fGHAhBDAIGGA......hCAA...,1,-7,-27,20
GIWMaATbHUeLRPOVgCYXfdJZFBNcKSDQE,HAAAeAAARADAOACA.CAFA.XAGBdAHAZCCABCFBKCCADBIBGDGAhAAAMCFB.ADIB..UECALDGBhAAA.VEAAfFFEhBHAFGCDSEED.EGHF...hCAA......hCDA...,2,-20,-7,13
KPcaFgMNXTBQRVSZbdGDAOYWCIHJUfeEL,OAAACAAAHACAUAFA..EADALBHBKAFAaAHD.MCAB..TCCAhAHARCCAZDFBGEAAhAAAABBB.IEEAeCEEFDFHhBAA.XEGDBFHASHFADDIBYEEFhCAA......hCCA...,2,-26,-4,22
fGAdZPbJaFWBUIXVKQEYcgOCLSRDMNTeH,ZAAAJAAA.aACABADB..UAFA..XAEDQCCB.ECHFhABA..gAGBhAIALDFBRFBAMCCBeEHFHDDAhBAAAAIBdHBDbDGBIEEAKFDDOFFBDGIB.fGBAhBGA.FGHD.hBFA...,1,-8,-12,4
ZSYGQAfMXLPIBTWUcFJODgbHNdRaEVeCK,MAAALAAABADATAEAUAFA...FAGADAIBHCAARBBB.ECEBeDEAhBAAZCFBGEAB.ACCAXEGDhABAIEHAJECBhBBAOCHF..bFDD.dFFACHHA...SHGAhBFA...hACA...,2,-23,-2,21
HcJDKdVgCNSMOXPGabLQRWefBZIETFYUA,HAAADAAAdADACADB..MAFAOAFAGBDBLBBBRCAA..eBHHZBFAEDDAhBAATEDAFDFDADHBKEHB.hBDAVGBA..SEHHhBGAaFGH.WHFA...BGGD.hAAA......hACA...,1,-5,-28,23
bPQfTJYaZUHVKOcFLWeIANgDGMSXBCERd,DAAAGAAAMADABADA.RAEFdAGAQAGA.JBBAZDCA.HDGBhAAAOBEDLGDA.hBAAeDADACGBSDDDhBEACHHA.EDGA.bFFA.fHFB.hACA......hADA...,2,-24,-19,5
LEaRYJWDHKbgNOVdZIFBSMCTQGAXUcPef,XAAAUAAAeADALADARAGB..JCDAHAGB.KCDA.bDCCODAAhADAZEAF.BDHAMDGBhAAATEAAAAIB..fDHAhABAEEEA.aFCEDFGA.gGCAhAEAdGHASFFDQGGAhAIA..,1,-9,-15,6
FRJGKZXYaMfAWecVNLISDBPdEgQUHbOCT,eAAAVAAA.LAEA.DAIBdADA.EAFAQBCDHBFCCDDARDFBGFABhAAAZCEBaCGDAAAA..NDIA.hAFABDDD.UFAAOFFHhAIATFGAKHGAMIBAfGDA.cGFChAFA.....hBIA...,2,-10,-5,5
IXRFYMJUKOHbWcQAGPDNTBELVSgdaeZCf,GAAADAAABACAEADALAEA..SAFAaAHD.eAHHhAAAZBBACCFAXCDARDFA.hAFAMCGBKDDDHFCCbECBQFFBhACAAFHATGAAdGGAFGAAYFHB.hAGA......hBAA...,1,8,-22,30
fSWGZDcFbOYHEJPMVeBNagKUXRTdQLACI,CAAASAAAZACA.FADAOAEAHAFBEAHBMAIBBBCA..aBGDKCDAhAAA.RDFAdFFDACCA..IDAAhAAAfGHAGCDAhADADEEB...bFFA.JHEA.....hABA......hAIA...,2,-25,-23,2
CfbgGLPeQNZTJOaAYIMdBVKXDFRSEWUHc,MAAAdAAAKADAFADDRAFF...EAFAHCAC.CAHB...bBBDGCGA.hAFAeDEBZBFETDFAhAIAOECDACIBBDDBDFAASFHHhACAcEGDLHBA......hBAA......hBBA...,2,-20,-18,2
HVebWcPIMYCRGZBFQOSKTdLfDaNgAEUJX,EAAAXAAAHACAeAEE....bACDPBHDMAEA.RCCAZCFFQBEAhAAAKEEBdGGALHAAhAAAaAHDADHAUEBA.VEEAhABAIHEAGGCB.FHGE.SHBGhBEA......hBHA...,2,1,2,1
TSZNVegUfXWLdMGYabACQPDKcJHFBORIE,QAAAKAAAHACBOAEAEACAZAEB..eAHFUBGA..XBEDhAAAdCDCGEBAaCABACIBDEFAFEBAhACARFFAIHAA.hBEA.TEEANIEB.fEGB.MIEAhCGA.CGGA....hAAA...,2,-14,-3,11
UOACYIgeBLaDWZHbfMGdTVEPFQRSXJKNc,CAAA..IAAAeACALAGBDACAHADCMAIBdAGAEBCB..QCAAhAAARCDFSBHHKBFDUDCAhACAADGBBEGAZEEBbFEDGEGAhADA.TGBAFGGA......hBGA......hCAA...,1,-5,-14,9
bdEOIHSaJVPCYRcNDBgLXWKefUTAGMZQF,ZAAAQAAAdAEAEAGAHCAAaACE...VCFACAFARAGFDCDA..LEDBhABAKDAAeCHHTEBAhACAADDAGDEAMEIBFFAAbFEDSGDBhAAA........hADA......hAFA...,1,3,-20,23
fBVFGKZTedYgXDcUAPQOJbHCaRLMSNIEW,QAAAOAAAHADARACALAFBMAFA.SAHBEBBBBBGAGCEAhBAAZCDBeBHDdDDCXDAAhAAADBIBADGAJEGBCEGAaFEDIHHAhCAA..fGGA...hCDA......hDAA...,1,-4,-16,12
FZYTCHVXfSMRQUBgPLeWbONKIcAaGJDdE,GAAAdAAAEADAZABBCADAHAEB....fAFARAGBQDCABAHAhAHALEEBeCEAOCHDhBAAKDGDAAABaDAHFDCDTEEAhCDASDHHUGEBgGAA...hCEA......hDAA...,1,-4,-14,10
bTHULACEIWZFeJfVSRPaYdNKgGDcXQBMO,EAAAZAAAeACE..fACARAFF.aADDdAHA.KCCDGAFAhAAAXDECMAIB.bDDBHDGBhABAAAFB.CECAFFABSDGHhAHA.PFFBgFDADEIBBHBAUGGBhAFAIHHA..hBHA...,2,-14,-7,7
cAXBLYNgCefFSbKZWMEUPHaOVTJQGIRdD,LAAA..gAAAeADHSAFAZADAEAGEHCCAaAHDTCAAhABAGCGA.REAAdEEAhAAAAAFABCEACGDDFGFDbCFDMIAAhABAODHF.QGGCIHHA.DEEB.YHDEhACA...hAEA...,1,3,-3,6
ZKfRNYSaIOJGcTBAXLUegbHPVCMDWFdQE,LAAAeAAAHADACAEADAGAdAGAECCB.ZCFARBEA...SEDAhAAAaBHDOCAAGEGA.TFAAhABAADDAXDEA.hAFAUEAAgGEB..bEGDMIAAFHBAKFFDhABA.NIEB....hAIA...,2,-13,3,16
dKIZLRQCPDNeYfbGMTgABVcXOEWJSaHUF,BAAAXAAAEACA...SADAHAEAdAHAZCAARAFF.QCEBhAAADAIBeCDB...bDGDGCGAhAAAMEEBACCAODABhABAaFFBKGAALECB.CFEAYFHB.hACAfGFA.hAGA...,2,-12,-5,7
MgdCeKLfBAHabcQWDXTVOPEYJIUFGNRZS,HAAAaAAA.QADCDADA.TAGAOAEEECABJBBFFCCHGCFAhAHARCFBZEDBMCIBdDDAKBHBLFAAhAAAACFB..bFGDXFFAhACA.YHDGIHDA.SFFDhAIA...hAFA...,1,11,-26,37
FKHfSDEUGaVYeLPJNdTIBXRWCQOMZgcAb,KAAAHAAADACAEADEGADBaAFA...eAHHLCAA.JBFBdCCATDGAhAAAXCFD.RECAQFGAhAAAZECAAAIBbGFASHCAhACAVGAA..NIDBBGFDCCHB...hCCA......hCEA...,2,-5,-4,1
NPEVCYHTLaJRMUDebXGSQcIOZAgKdFBWf,dAAABAAA....fADAEACACAEAHAFBaAEDRCAADAIB..eAGBhACAGDCBQCBDhADAODGDAAHBFCFD.PDHDhAHA.TEDAMDIBbFDCSFGDIHHA.hAIA......hBAA...,1,-17,-18,1
XAPfWQLVaDbTGSOKZcYHNMdICgUBJEFeR,...fAAALAAAaADDDADAGAEBKAFAZBFEHCAAdBCACCAABCEAhAAAEDEBRDGB.AAHA...QFAAhABAbCGD.TGDAhACAOECA.NGDBMICAgGFBFGHD...hACA......hCCA...,1,1,-18,19
NHMQGgWKECIRdAFOTPLDJcXZUbfaBSYeV,TAAALAAA.DAEAJACAZAEE.UCAA..aAFABBHAeAHHHCDChABAGCCAKDGA.EBFFRFFAAEEBODHDhAAA..XGCAhACAbEFBSGDA......hCAA......hCCA...,1,-15,-26,11
KCZgXFDBVGJecHQNbUTLIdRMSAOWEYPfa,EAAA..fAAAaACDZADB.FADABAFAGAFAeAGHHBCB.bCADhAAATDEAdBHA.RDGFAAIBODFHhACA.PEHBhAHACCBDDFCA.cECDQGGBNIAB.....hAIA......hBCA...,2,-20,5,25
FKBYNLOTeDaSRbMWZAfCPQXHGcVdJIEgU,CAAAQAAAHACAGAFAdADAEAFAFAHFBCAA.LDDBeAHFaCDEREAA.hAAAMCGBAAEA..XFEDhACAcDBA..IEEAhAAAKDHBOHFESCHH.ZFAA.fFGAhAFA..hBCA...,1,-10,-16,6
gYEVIQeRSUbPXWGDTfFNOJCaZMABcKHdL,KAAAHAAAdACALADB.EAFAQAEARBFASCAAUBGAXDEDhAAAGCDATEAAhAAA.FEHBODGFCFFAaFDH.hAEAAAIBBFAA.gGGAIHAA...hAHA......hAIA...,2,-21,-7,14
OCfEGgWZYDVJKRQeLBFUINSdTbMcAHaPX,HAAAaAAA.OACAEADAGAFAZAFBDAIB.KCCARCCAeAHBLDHBFDABUEFBhADA..SECAhAAAbFBA.ABFBCEGAfGGEhAIAgGEAWHDG......hBAA......hBBA...,2,-21,-9,12
RFMPgQfIadTDWHAVGCNLSEJbOZcBYKeUX,GAAALAAAEADAOADDZAFBBAHAKAFAUCAARCDB..MCHB.QFBAhAAAaAHDdCFATEGAhABAHFFAABFB.CDCDSDADhACAbFAA.cGECeDDBFFFH.fHABhACADCIB.NIDB..hADA...,2,-6,-6,0
FTQKJIdNaPbEYMDUXWLVRfBHCgZGcAeSO,eAAAFAAAQADAKADAdAFA...aAFEEAHBMAIBDCCA..UDDALCCBhADARCGB.HCECZGEAAAAAhAIATEEA.IEHAhAGA.PHCAXFGAfGGAhBAA......hCAA...,2,-31,-10,21
GEFHRZdUXIVObcgCMBNDJYKTLfPeQaAWS,GAAAHAAARADFdAFAUADA..XBGDOAFC....bCDACAHBMCABhAAADCHBKEEALEEAhACA.eCCBAAABEEHFZGEAIHAAhACA.gGGANEIA.YDBBhAHA....hAIA...,2,-27,-4,23
JZIYbMCUFHdBWQPTaGKfVeRONScDALXgE,LAAAEAAAZACB...bADDMAFA.FBEAHAFAdBHABCBCQCAAhABA.aCGDGDEAhAAAfEEARECBSEHBhBCAAAHAXFAAgGGBIFGACHCD.UGDB.hCAA......hCEA...,1,4,-15,19
GWHFMKbAXIVOCgYefPDcBJUQNTSdEaZRL,XAAAOAAA..CADA.eADADAFABAHAUBGAQCDA.hBAATDAAEBBBRBDAGCGAhBGAHEFAMFDBACIB.IGHAhAAAgDDAfHABJFFBdGDA.aHEA..hABA......hADA...,1,-6,-26,20
QbJXdFTcADLPKUWNSgYaZEVHCORMfBeIG,LAAAKAAAUACA.SADH.aAFAEAEA.HAGBRBEF.MCFBhAAAeAHHGEDAQCAAhABAbGFA.dDGDFDHDADDBDEEBhACA.PFFAgGBBZGBACGHA.BDDC..hAIA......hBGA...,1,3,-15,18
DYJIaKSfGMRdPLOBXNcTAgCeEZVWQHUbF,eAAAEAAAZACBQADAHAEAFBHD.DAGA.JBFAaCBB.KCEDGCCA.hAAAREFAdGEALEFABDHB.hAAAXGAA.TGDAhAGAACCBCGHA.UGGA.......hABA......hBIA...,2,-23,-2,21
JaSOFYdAbVTMBKgNGeQHIZcfULDEXCRWP,TAAAMAAAKADA.GAFAHACBZAEA.UCGBEAHBRBBBJCAF..aDEBFCEDhAAA.AAFABAHBeDGHQFAAhAFA.fFEAhAIALFFACEGASECH.dGHAhBAA......hBBA...,2,-21,-8,13
fdUbZTCYPXWVcaNHGKgMFQSLDRAJIOBEe,OAAAEAAAdADAZAEB..TADACAGA...XAFBVCBB.aAHDhBAAHCGBGCCAMAIBQEFAhBBALEEBABCABCFDhBHAfGCAYFEF.WDHBKGGA...hAAA......hCAA...,1,-5,-18,13
gYGdWTLPNDeMXOQRBKbUAZFaIEfHcVCJS,aAAAEAAAHACA.CAFB.SACHGAGAdCCDTAEALDFB.DDIBhAAAeAGHMEAAQCDDhAEARFCBKEEDAAIB.ZDGBfFHEhAEAcEEDgGAA.YBBFhAGA.NEIA.BHHD.hAIA...,2,-14,2,16
cHUOXWAECReSPBQFbZVIJDLMgGaKNYfdT,RAAAeAAABADBQADAZAEB..VAGBDAGAMBFAGCCAKCCA..hAAA.fCFAhABAdEFAHGDAOHFEACHAEDGASEEDhCAA.bFFB.IHHA..hCBA......hCCA...,2,-23,-19,4
AVfSZEeHRITPgQWJaDbGUNOdcMCFYKXLB,SAAAEAAAHACARAFF...TADAQCCBaAFA.GCGAUBGBdCCAhAAAMAIBFDABXEAAhAAAACFBZEDBeDGFgEEBhAEADEIBOFFHCFDALHAAfHGFIHHAhAFA......hAHA...,2,-5,11,16
FCPJQKXDaHfRSGNcITMZVdUWgbLEBOYeA,CAAAQAAADACA.HACARADAGAGA..IAGAZCBAdDFAUFCAhAAAbBFAECDFBFGA..hAGAeDFBAAIB.FDHHKGHBaEAAhAAA.SEED.TFAAMIDA.gGDGhAEA..hAFA...,2,-33,-4,29
CDaMQARfKOGUdINXWbBSHVTEYcLgPJFeZ,RAAAOAAAdADA...XADABAFAHAGBEAGA.LCCA.PDFDhAAAeBBBZCFB.aBHDhAEAAAIBGFABIDDAbFGDhABATFDA.gGAACDHADFIB.MEIBhAGA.KGGB....hBAA...,1,-9,-17,8
ZNHJCVbUFWEGfSOAaYBIXPceDMgdKRLTQ,aAAABAAA...XACAeACHMAEA.dBEARAFALCAAZBFBHDGBCBHAhAIAUCFBEDDB.GEDAhAAAOECBAAFA..IFHAhACADBBBKFFDNIDB..bFFD.......hBAA......hCAA...,1,-9,-19,10
YHeEbGJPOVQgCfKRIMDLTFBXUWaSdNcAZ,HAAAEAAAGACAOACAQAEACAFA.RAGBDCBBTBGA.XCCAhAAAaDFBdEADAAIBZDEBeDHFhAAAbEFD...VGEAKDHBMFCBhAHABEDA.SHGA....hAIA......hBIA...,2,-11,-1,10
FCPBKTfDUANHeVYdaGJbgcSEMWIZRLQOX,HAAAeAAAdAEAGADA.JAFA..bAFDSCAAEAHB.MCGBhAAAZBAERDDBLCHBQEBChAAAFFBABFEATFGADGGAhACAADIBYHCAaHDA.cGFCIHHA.hABA......hAIA...,2,-7,-4,3
GbBEJdNYTXeISgWAKROZQfUaPVHcMLDFC,RAAAZAAAQADCaACA.HAFBMAFALAHBCBEAGBFAECCB.dEEATDDAhABAeEHBSFAAhAAA.AFAAfGFAhABAPDHDDCCBBBHAYFDFXFFCIHBAhAFAKHBA.....hBHA...,1,18,-26,44
eNgDQYEFOWCcAZGVKHUBLbMXfaJIPRTSd,GAAAHAAALADBMADA.aAFAJAGBRBFBdCADeBHHDAIB..ECDAODEDhAAACDCDZEBE.KDHBBEGD.hACA.bFBBXFDAhAAA.fGGATGFA.NEIA.....hACA......hAIA...,2,-17,-4,13
faQWIRObdKNVPLcUMFZSXCTeYADJgEBGH,DAAAEAAAHACAQACARAFFdAHA.KAEA..VCDBLAGB.MAIBhBAAZDGBCEAAeBBBAAEABFFCaCFB.hCAAOFHD..bDDDhDAANCCA.UFFA.SEHBXGEC...hAAA......hCAA...,1,-8,-13,5
JHARaYLdIUbPDeGZKfXCVTNQMgcEOSWBF,RAAAaAAAdADA.UAFADADAZADE..KAHBCAHA.....TDDAMBBBECCBhAHA..SDFBhAAAFCEAHCGBACIBLDHBhABAbEDD.eFBB.XGGCQFGBOCCBhBFA.BHEA..hCAA...,2,-19,-19,0
ZMTPULSQbKeVWJBRHDcXNYAFEGadCgfIO,EAAAdAAACADA....fACAZABBMAFAUBFALAEA.bBFAeCEDhBAA..JCDBHDCBhBIAXDGCACHAaDHDOEGHhCDATFAAQFDA.KFGABHEADDCBNIABhAAA......hAFA...,1,-10,-19,9
QfaOHKYdbSgMFCeDEUTIXWLcJBGPVRAZN,ZAAAQAAAaACA.HACAdAFA.SAEEMAHBeCCBEAHB.TCDAhAAAXCECLCFBhAIABDHAGEFAREGFACHBOFEBhCAAbFBACFHBDGIB..IHHA....hABA......hAIA...,2,-18,9,27
eZMVNETPHfgLWYOCKRFaXABcGUDSbdQIJ,GAAASAAAdADAQAFAeACHZADBMAGBECEFHDBB.LBHBhAAAOAHBRDEBaDGBAAAABDHAhAIADEFBIFHAVFBATGGAhBFAfFAE.gGGGCFHB.hCAA......hCBA...,1,11,-13,24
DFgCBYfUeNHPXTQRaVGLKcbEIJMAOSdWZ,dAAAZAAAFADABADAUAGAHAEB...TAGARCAAGCEALCCB.hABAKCHBEDGEMDABACAAOECBhACADDGBCEEA...eFHBhBGAXEGDQGFDaGAD......hBIA......hCEA...,2,-19,-14,5
XNSRGVYTWPJIFfeLBbHUQZMDOcdEKaCgA,SAAARAAAGADA..TAFAJADA.FBHDeAGHLDAAHBCAZDEAhAAAMDFBOBHD.EFDAhABAaDGCAFGB.XFAAhAAA.VGFAPFHDBHAAbGAC.....hABA......hADA...,1,-5,-6,1
PIAQEVbUJROBgYNMHLdXCaFfZeKScDGWT,EAAAUAAARACA.BADA....NAGA.HAEBdAHA.aAGAZCCAeBGHKDAADDHBhAAAGDAA..TECAhADAACDBbEDB...OEHDhAFAMCIBLFFBFFFBSHBAPFHB..hADA......hBAA...,2,-17,-10,7
fCQMWPeGISdZOYRVXBEHNUbAgaJKLTFDc,aAAALAAA.TAEADADACAFA...MAHBeAGHGCAAdBBDZCDBRCCABDFAhABAHDGBUEBAAAIBKDHBFEEHhACAQFED.hAEAIHHAOFHBXGAANAIA...hBAA......hBEA...,2,-19,-6,13
UKAYCLGXOWdPHBfaDZeFIVQMTRNbcJEgS,LAAAGAAAOADAdAEAHAGBBAGAaCAAeAHHFDCD...QCDAhAAAREDF..bFGBEDCBhACASEBDACGBXDGAhBAAfGAEZFDBMFGB.cGEDJFHF...hBCA......hBDA...,2,-7,-3,4
GTNcEAQSRdbDeZHMFUfaKOCXWJBYIgPLV,RAAAdAAAeADEHADA.MAFAFAGAUCCAKBGA..CCBA...XCFAhAAABCEA..IDGAhACALEFAGDCATFCAEDABhADAACFAbGEAZEEFaEGE..OEBB...hBAA......hBCA...,1,-9,-16,7
NHOWGUXPDZCBMceYITgLSREJFdQKAVfba,VAAAaAAAHACB.GAEBUADADAGAZCEEMBBB..eBFE.TCFAhAAALEAA.EDHFhAEAdDDAAAHAbEFDODHDXFCAhAFABFEAIGGASHGAFHEC...hBAA......hCAA...,2,-21,3,24
DJSEUOMIYXfeCbTKNAZHWLQFBGRaVdcgP,HAAALAAAQADCGADARAFAdAFA.PAHBSCAA.ECGAhABAMCAB.XCCChAAAeDDDbFABTDEAACAAZFEBBDHAhACAaDHDgFGGDGABUGGA.OGDC.hAFA......hAGA...,1,12,3,9
RPcZYFDWAeESXgadGKHJNIfbMCVULTOQB,EAAAXAAAdADAHAFA..JADA..fCBAMAHBUCDATCEAhAAAQDBARCGF.ZEFBhAAADDDBAAIB.eEEB.aEHDhAFAGGABKGGDIHAAbFGDCFDA.....hABA......hAGA...,1,2,-16,18
OKHPYaVfbIXUAMCEGQZWRDeBFNJLScgdT,EAAAZAAARAEABACAFBHD.LAEA..SCAAdCCAKBHBHCFBaCEC.hABAVEDB..bDAAXFAAhAAA.AAFAMEIBhAIAGEEADFHBeEHB.cFAAOHDEfHABhACA.CHGA..hCAA...,2,-13,-13,0
ISUOcFGCLEaXVRDQbAZfgdBJTYeNKHWMP,ZAAAdAAABADAJADA.eAEHHAGB..MAGBSCAAUDAA.FCEBGCCAhACALEFAEAHBaCGDhADARGAAQGDC.hAIAAAIB.TFEAKGGA.IGHA.CEHADIDAhBAA......hBCA...,1,-15,-16,1
SNROZLaWgFDMPAbIVBeUXHcJTEfQKGCYd,VAAAeAAAHADA.TBGAEADEKAFC.GBGAdCCARDFBZFAALCDBhAAAaEEHFFHDMCFB.AAIBBFGDhCAA.UGCAJHAACHEASFHHhCGA........hCIA......hDAA...,2,-15,-8,7
KaEbGMgYOXZPBVIfHLecQdWDTAJSFRCUN,FAAARAAACADB.KADA..EAFAGAFA..MAIBOAHFZBEEBCCA.hADA.fCCAhAFAHDEAeEHFdDEATFAAADHBSECHhAHAaGDA.bFGBXGFD.IHDAhAAA....hABA...,2,-25,-21,4
cNGXTDaOZJPdVAQUbfSEHKILCYBFeMgRW,QAAAUAAA.SACAHADALAGBBAFAeAGHRCBA..hAAAcDACGCDATDEAhADAaBHDZDAB.dEHAAAIBEDHFhAFACFCAMFFB.gGGGXFCAOFGBhBAA......hBCA...,1,3,-14,17
GcADXeCLIdQEPMVbaSJKUYTZfHOFBNWgR,eAAALAAAdAEAEAGAMAEA...aAGEKBCBUCAAZCEEHEBABBFD..hAAA.gDGAhABARCDBACHACDFB.QFEDhAGAVEGBSEBAYFHBOFFHFGCD....hABA......hACA...,1,7,-25,32
ebBVaQLIROWKFcNgPTdUYJGfSZMADECHX,EAAAHAAA.eACEBACAaAFALAEA.RCCAKBHBFBFDNAIA..TDFAhAAAdCCAUEEA.GDGAhAAAZFAAACCACEED...bFGDhAFAIHCA........hCAA......hCEA...,2,-23,-14,9
KZPNBbTFdILEWUMRAaDHGSQYecCOXfJVg,HAAAGAAAQADCeADAOAGDXAFBJCDA.KAHBZDDABCADFDHDdEADhAAAECCBMCFB.ACHBaDGChAAASFFD.hACACGBA.fEDA.gFGAhDEANIABIHHALHFA.hACA...,1,10,-20,30
ZGCLBKaUdfbOJRAPMeNSgWTFVXHIDcYEQ,eAAASAAA..TADAXACDHAFBDAEAEAHBGAGALCCBhAAAaBEDdEBAbDGDREDFAAAAMDDBhAIANIAB.FEEA.IFHAhBEAQFACZGBEKGGDfGFE..hABA......hAFA...,1,3,-3,6
HDEGNLPfACRbdKVgYQcIWeZMaUOXTJFSB,RAAAdAAAKADC..VADAQAFA..IAHAeBHHZCCAaCAEODFDhAAA..TCFAhACASECAHDCAEDHFhADALFHBACHACFFA.YHBAMFIBXGAAhAGABHGC.DGHB....hBAA...,1,-14,-17,3
TbgUWBRdLPDKfJCcVHEGXMIOYZQANFaeS,aAAAeAAA...TADAUADARAFALAFBKBBD.CAHAHCCBECGAGDBAhAGAMCHBOEFBZDDAADIBFEHHhAIASEHH.hBAAgFCABFDADFFBfGGEcGGCIHAAhAAA.NICB...hABA...,2,-16,-11,5
LacZXgCWQAfYbKNBMFJPOdeVRHTIEUSGD,...bAAABAAA.MACAFAEAOAGDeAEAHBCAEBEB.GBGALCABhAAAZDEFCCBDAAIBKCCD.JDEFhABAdGCAREGB.IGHAhAAA.DAIBaGDBXGECgGEA...hBCA......hCAA...,2,-15,-6,9
LEcVTCgaKPBdGRWIFUMAQDZYfbXSONHJe,ZAAA..bAAAOACAHAEAeAHHEAFA.TCAAaAHDBCCD.RCEA.FCEHhAAAACEA.QDGBhABA.fEAEhACASDGALFFACEEDKFGAdHBBGGABIHHAMDDBhAEADGFB.....hAGA...,2,-25,14,39
GWKJeEYHTXaMSARfNUZbQCPOIcVBgFLDd,RAAAUAAAZADB.QADAOAFC...IAGABCCCLCFAhAAA.GDAAKBHBECDBHEEAhABAaCFDADAAbGCC.CGGA.cDADhADA...FDHHDEGAdFDA.eFBF.hADATFFAMFIB...hAHA...,2,-9,-7,2
UeNYKMEGIXAaPcCQTJfbZBDFROVgWHLdS,aAAACAAA..QACA..TADAbAEA.ZAFBFCAARCCBOAHDhADA.VDGBHCEAdFAAhAFAeCHHKBBDGFCBhBAAAAFAcDDCBGHADEGBLGCASHBANIABEGHB.hBHA......hCAA...,2,-3,-3,0
bgGWNXcPSZALBdFHERaQIKMfCUVTODYJe,dAAAHAAARADA.aACAQAGCMAFA.UCDBTBEADCCB...eBGHhAAAGDAAXCCCSCGAhACAABIBLEEAEEEBfEGAhADAOEHDbGBAgGEGcGGC.BHHAhAEA.....hBGA...,1,-1,-6,5
cIFKQBgeWETSCUHYVbNOLGPdXfDAMaRZJ,RAAAZAAA.JADAFADA.QAGABAGB..eAHHECCA...TCAAhABACCEAHCFB..VCEBhACAbFFALGAA.hCAAdHFBDDDBAAAAMEEBaDHDKFGD.SECDhCCA.YGCG.hAGA...,1,-12,-22,10
NSYFegBKXROAPEadCWVbGJLZDcUIQHfMT,EAAAdAAACADA....bACAGAEA.ZABBDAGAUBGAHBFB.MBIBhAAATDCASCCAhADA.eEAAKEFARGAAABHBaEEBhAEAJFHB.LFFA.IHEAfHEBhAGA......hAHA...,1,-1,-27,26
XbHSPCATOKFYJENcaLfUBgZdRGDIeMWVQ,TAAAFAAAEADA...aACALAGB.BBEAdAFARBGFGCCAeBDBMCCBhAAAQDAAHDEBCAHBhBFAAAIBKDHBNDDA.UFEAZGEADDIBhCAAIGBA.XGGBSGGE.hADA......hBAA...,1,6,-20,26
OVNeJWZEXcKLYHbRSfCQUdBAIGaPTgDFM,aAAATAAA..FADAMACAOAFD..eAEAZBBAEAHBKAHBHCCAhAAARCGF.CCFBdDHAADBAGDBBhAIADDBBVEEBJFDB..XFFChBAALHEA.SECDfGHABGHBhBDA.IHCA.hBDA...,2,-18,1,19
PfaOCXKeSNWAMBZDIHbTYdEVJQgFRUcGL,ZAAAHAAA.TAEAEADEQAFCRAGFGCABLDFAaAHD.XEAChAAAeCABSCCAhABAAACAMEEBDFFAbDEAdGGAgFDAhACAFGAD.PFHDOECDKGFB.BHAAhAHA......hCBA...,2,-5,15,20
KdIgWGXDZHAbYcFNCRLeBQSaUJfPVTMOE,...bAAAFAAA.RACFeAEEQAEAUCEA.JAHB....fBHAhAHATCAAECEBdEHAgDGAhAAAGFBBZFFBHEAChABAAFBA.cDDCCHHA.LGBA.aFGEhACAMIAAIHHA.hAIAWHAG.,2,-13,-4,9
HAXIdZJNYVRWCEQDBFTGgaefLSPOUKbMc,dAAAZAAAJADA..VADARAGF...EAGEQCAAFCBDGCFAeCDFhABALCHB.ODAHhACAbEEAHGAAADDA.XGDBhACAIFDA.NHDB.CCFDBGGD..aHGE.hAGA......hAIA...,1,-11,-14,3
YFEefNRXWGMbgHQVKIZBJLASdcTOaPUDC,dAAATAAAaADA..DAGAFACA...EAFAeBDBRBFAGCCAMBGBHCAChACAQEFAKBHBZEBALFABhAAAADHB.ODHDhAFACEHAfFFAXFDD.WHDA....hAIA......hBIA...,2,-23,-3,20
DTBbOVINFHEGafgSUKdJYMeZWAcPLXCQR,LAAAQAAARADFBAFBOACC..VBGBFAFAHCDA.EBHFaCAAhABASDCDdDDD.hACAMDIBeEFFAEAAXEFAhAAATFCA.IGCAfEHAKFED.YHAAhAHAcGEDDIAA..hAEA...,2,-16,-14,2
ZCTDULFOfaINHXbQMSGcPgAJKWYEdRBeV,KAAAEAAARACAeACE.ZAFBDAFALBHBFAHD..aBEEHBCA.bEDAMCCBhAAA.GDDA.hAAA.gFAAhAFAADAAJDGBdGHA.CDEDOFGD.fHCB.hADA......hCAA...,1,-2,-28,26
TWcbIZXYVaHEAfBCNdQMOGReJSFLgKPDU,CAAAdAAA.MADARACA..eAFEFAGDLBDBKBFA.DAIBTCAA.hACA.bCBDZCEA.XDDChAAAaDGAHEFAAACABEFAhAIAQFDDODHDSGHB..gGGBhCAAWHEA..hCCA...,2,-30,-10,20
LGOYISUbfeRBPZWCHQNFJVEdcagADMKTX,MAAATAAAGACB.OAFASACBUCDB.eAEARCGB.ZBEEHEFBhBAAQDDBFBBHEGCAaFHDhBIAAAEAXCGA.hCAALEGB.IFFABEED.WCCDhAAANICB......hAIA...,1,2,-21,23
aUfJAKMYNLcZeTSdHWbCRQBDPVEXGFOIg,MAAALAAAZABE.eADHdAFAHBGBCAFA.RCCADAIBEAHBGCAA.OCFBhABAaEEAUFBAACABKCHD.hAHA...NEIASFFAhBAAbEDDQFGA.BGCC....hACA......hAFA...,2,-15,-14,1
RWHQdMfJeINagLAOSTZcVDBbKPEYUCFXG,TAAAZAAADACAKAEA..EACEUAGAFAEARAGF.HCCAdCCD...MCIBhAAAeCEHaDFDADGA...SECAhAIABDHA.bEGDhCAACEGD..XFFC......hABA......hBIA...,1,-2,-49,47
SYHOENBWKaXAIdJVRefPCbZFUcDgQLMTG,dAAARAAAeADECADAZABB..FAGADAFALCCA.GCFAHBEAECHFBBDAhAAAKDCAACHA...VEFBhAIAbFGD...UGBA.hABA............hCAA......hDAA...,2,-31,-27,4
aVILbEfNAdHWUFDXPTMRQecGJZBOCSgKY,HAAAFAAADADATAEA.RAGF.eAEAGCABZBDACAHAKDEA...aCHDLCHBhBAAEEABAACA.dDDAXECDhAAAMCCB.QFFAhAEABDGASFDAgGAGIGGAhCAA......hCBA...,1,13,-37,50
NTecDbSLFXWJGRYZPEAUgIQCBdVfaMKOH,UAAAQAAAdADA.aACEMAFA.HBEBeAEHDBGALAGB.hBAAXDAAGCGARDBAZDDAhAAAACIBCFFAfDHAhADAOFHD.TFDASGCAFFHD.....hAIA......hBGA...,2,-16,-7,9
fCGcHXPVJWgeBUNAEIYLTFRKOSdQDabZM,EAAALAAARACA.SADHdAFAQCCBaAFA.ZAGB..MAIBhABAGDAAHBEBXDFChAAAPCABJCCFeDHHBBGDhACAABIBTGFAODGDDEEBbGEC.CEED.....hCBA......hEGA...,1,3,-10,13
MFTWHJVdSKQfNGEXBYeOCPDIRbZAagLUc,aAAALAAA.MAEATADAHBCC.dBFAQAFCGCAAEAHFBAHBhADAeCHFCBBDDCDBREEBACAB.UDFAhBAAFGHB.JEDBKDDDXFGAhCAA...OHCE....hCHA......hCIA...,2,-23,1,24
HPOeZFcLgQUSfRCDEKWTBaIVMXJdGYNAb,HAAAeAAAZADBLADBQAFASAFARCEF.EBHFKAHBBCADaCCB.hAAAMCCBdDHAGEFAhABAAAFAbDED.ODBHFDGHgFCFhAAACHEA.DDIBIHHA...hACA......hAIA...,2,-11,-2,9
McLBaAIDebEHFUSQXgRNKGdOVJZfTPWCY,eAAAHAAASACEQADARAFAGAEA.dAGBOCCBZCCFTCGAhAAACCGAMCIBLFFAhBHAAAAADDEBEDFBXGEC.hAGA.KFFD.fGHAYHFG.aHEC..hAIA......hCAA...,2,-18,8,26
DULVcBKbANXZTeJQFEgWIRCfYdOGSHaPM,ZAAAeAAAQAEAEADA..IAGARAGBCCAAdCCDGDEAHBDCaAHDMDIBhABALDDA.BDHAhAAAAACATEAAFFFAfGHAhABASEGBDCCBcGDCKHDA...XGGChAEA...hCAA...,1,-1,-13,12
HadSUIWFZLXPNcQKCTMVJeBfObARgYGED,RAAAGAAAHADBdAFBSADAUBGB.FAGAZDAALCDA.XCGDhAAAPDGD..QFDAhAAATECAMDAB.hABAeEEGfGGEACEAEFHFaGBBNEIACCCD....hADA......hAIA...,2,-14,2,16
EbRKdeaZGMNULVAIFgQDHWcCXOYJTfSBP,FAAAQAAAHACBCAEA.OACC..TAGABAFBEAHBRCEA.eCDAhAAAGEAAMCHBLEEAhAEAACDADDGB.XFCDhAGAJEAASEEBKFHBaGEANICBIGGA.WFHHhAEA......hAIA...,1,2,-29,31
ACScLaQXeYGJOWKgUNTFPdEVbHMIBfRZD,SAAAaAAA.eACHGACA.OAEAKAEAUAGATBGAdCEAEDGAhAAAHBEBBDDCREBBAAIBLEEAhBAAQEAAXFGAhBBAJEHB.gGEBFFFB....hBEA......hCAA...,2,-17,-2,15
QdXbUATcPNRVLBOeYMHGJIDgfSaZWKCFE,TAAA..PAAARACFLAEBeADAHAGBGAGADCCA.SCDAhAEAZECACCADEEGBdGAAbDFA.hAIAADIB....cGDAhAAABEEDMFGB.gGBAaGGC.FFHHhBAA.XGDD.hACA...,2,-11,-2,9
AeMPRTWUVNFIgaHZEbGYDCLdSBcXOfQKJ,eAAARAAAUADAFADD...aAFAHAFA.ECCBGBEACCGA.dBGDBDFDhAAAOCCBQEDDhABAAAAAMDHB.TEGA..hAHAVGEAgGGA......hAIA......hCAA...,2,-22,-19,3
aQNXbOVcMLCFRUKPGgEIAfZDYBJHWdTSe,ZAAABAAAHAEAdACAeAEAaAGA..QCAA..bBEAOCDChABAMAIBLDDAhAAARCGFKEADGEEAECBBAAEADACAJEGBTGCAhCAASFDA.NEIA......hCGA......hCIA...,1,-2,-17,15
PFZYUIWfDXQBTEHeAgaCNKVJLdbGOMRcS,aAAAKAAALACBGACARAEA...SAEAZCEEUEAA...fAHAhAAAQEFAECEAHGCAhAEAAAEACCHA.JHFE..bDFDhAHAMAIBFECA.IHAADEIBBHEA....hCAA......hCBA...,1,0,-28,28
dGDFLeOAfTNYQcPHIBaZgKWCUXRMJVbES,TAAAQAAA.HACAaACAZAEBKAFCCAHARAGB...MCEAJCCBEDFFGDDAhAAA.LDGBhAEAAAIB.fGFEhCAANDBA..PDHDBHHA.gGCA.hCIAXGFA..hAAA...,2,-25,-4,21
ATQGNBHcSLRgCPdIbWOFXDeKMaJVEYZUf,GAAAHAAALADBRADACAGB.dAFA..ICFAbAGDFCAH..eCCDhAAAaAHD.EEEAZDCA.AAABQDGAhACABEGASEHHhACA.gFBBODAHKFGDMIAA..hAIA......hBFA...,2,-20,-1,19
WLIMfUYFXHAbZaPRJVOCTNBKgecDdGEQS,aAAARAAAOADA..TADAKAGA..eBDFdAFAEAHB..QCEAhAAALCCBMBBBhADAfCGFFCGDHEDBACCBZEEAhABAPFFACDHABGGDDGIB..WFHH...hAIA......hBAA...,1,-13,-21,8
ZSRfcUOLAaWPCMeYQdJIFgXKHDEBGbNVT,aAAACAAA..eACAdADAFAFAKAFAHCAABBBDGBEA..bBFA.TDEAhAAARCGFUDBA.AAIB.MDHBhACAQFGBJECBXGDAhADAEGCA..NICB.SCCE.OHAChAHA....hAIA...,2,-18,-10,8
gSIMcYBTWdEaCGJXFRbNOQHfePZVADULK,LAAASAAAMAEABADAdBEA..EAFAGBGAFAHD.RCAAOECAhABAHCCAeCEEZFFAAAIBKDAA.hACAIEEATGBAaGEChBGAXDGA.bFAANIEB.QFGC.hCAA......hCBA...,1,-5,-7,2
RBXCFPagIJMKYbUVNGOQLTdDeEZHScfAW,RAAACAAAFACA..aADA..JAFAMAGB.KAHBUCBAGBDALCFAhAAAdCCCECHBHDDB..fEGAhAAAACGABEHA.XFCChABAIFBAbFEDOFGBDGHB..eHAGhAHASGEH..hAIA...,1,4,-41,45
SdOVgDUJKFNaGCeLTXIfZQWYMPBREbAHc,HAAAdAAAOADADACAKAEAFAGDGAGA.eCCATBDA..fDEAhAAAZCFEQCBDhACAMDGBRFGFAAIBSEEAhBAA.UGGAaGAA.CEHAIHEAWFFD..hBCA......hBDA...,1,-11,-19,8
aBcZIOXWfMNbFLRSETHQCVgKYGUJDAePd,eAAAaAAAZACBOADC..XAEAMAFAFBGDRBGF...ECCAHCEBhAFAQDECCAHBKBBDGECAhBAADBIBAAAAdEHABEHAIFCAhCAAfFGELFGDSGHH..hCAA......hCEA...,1,-10,-14,4
WAJbQCDSXVYIeEHgKaLfUdZNRMFBcTOGP,QAAASAAA...XACAIADAHAFAaAED.LCFAhAAAdAGARCCBMAIBBCDDTDGAhAAAGDAA.AAHAbEEADEFBeFDFhABAEGEAfGHAZGFEFGBB.OHCC.hBGA......hCAA...,1,12,-7,19
PASDTbgGKeNYQaJfOVMIFXEWZcCURLHdB,TAAAGAAAeADA.QAGAaACA.OCDAMAFAXBDAhAAAEDDBZDFBCDHA.RBGBHDBAhBDAdEADAAABDFHBbDFDKEHB.JGBAhBGA...IHHAWFHH.....hACA......hADA...,1,3,-15,18
BXZVUegNTYbLJfScFaKERDWOPCGdQHIMA,ZAAAeAAA..TAEALAEA.SAHHaAGARBGBDACA.OBCChAAAGCCBHCECAEFABEHAXDDChABAUGFA.gEFAhAFA.bGAA.fFHA..hAGA......hCAA...,2,-29,-6,23
OLFYfZIBWHCGEdVTAeDRPMUacSgQNbJKX,RAAAMAAAUADA..aACE..SAFAQAFA.JBBFOAHDhAAALBHBFCCHZDFABCFDHEDAhABAEDDBdFAAACGBeFGFDEGBPFEDhAFA.NIAB.bGAAKGHB.....hAGA......hCAA...,2,-13,-7,6
LOAGDWBHScIfKMFdUeQgTJbRVYaPNCXEZ,GAAABAAAHACASADA..fAFBMAGBdAHAeCDBhAAATCAARDFAaDAHCAHB.EECBZCEAhAAAAFFB.DCFA..IFHAhACAFDDHQEABJHBA.bFEA....hACA......hAEA...,1,-2,-21,19
OfXFURMTeKSdCHWELAcaYgDJNZPVQBbGI,aAAADAAAZABE..QADAGAEAOAGFFAFERCCB...eCCBdCGAHDABhADAEDABAAIB...gEFGhAIAPDGBBEEDhADAbFDD.XGAAMBIBSFHHCFHA..hBAA......hBBA...,1,-8,-18,10
LaHZdKTGPBVcIeWFYgNOMQCAEDJSfURXb,EAAASAAARACA.LADAHAFBdBHAGAGABCCDVDABeCCAFDEDhAAA...NDGAMDIBhABAAAHAfDEAUEAAaFHHZEGBhAAA.KFFD..........hADA......hAFA...,2,-19,-6,13
PFfdQYDUECBSeGZIXbaHOgNKcVJTLWAMR,RAAAFAAAdADAQADADAFA.UAGAEAHFBBFAGCCAZCCA..XDABhADAHDFBOCHD.hBAAKFBAcEFA.TGBAhBFAAAAAMEEB.fGHASEHBeHDAhBFAaFFHNIDB.....hCAA...,2,-23,-2,21
WUKCXQRTLYFJAeVHbDNMIcaGBZSPgEfOd,HAAADAAAMADAaACAZAEB..SAFAEAGAdCCAKBHBQBBAhAIALDGBFEEAABEBeBHF.bCEDhBAAIGCA.BGHAhAAAfEHA.OEDH.CGEAXGGAhBBA...hCAA...,2,-19,-10,9
YQacCOTGREMZHNKLfbPXVASgDJBFeUdWI,DAAAFAAAeACHdADA....IAFAaAEAOAGDRAGF.ZBDBHBBBLDFAhAIA..bDEBXFCAhBAAABBB.SFFAhBIABDHAUFCAYFHBQGFA.CEGD.hAIA......hBAA...,2,-25,-15,10
YJUEGPbfOXeFCHVAWScgIRQMZadDNBKLT,SAAA..gAAARACFZAEBdAHABBGCTADAUDGAEAFEGCCAhAAA.bBFAXEAAhAAAeDABHEFAAEAAIEEAhABAaFDDKGHBYHAAJGEA.OHEChABA......hADA...,2,-26,5,31
AbQHaYZMIdOeVXcDBSCRJGUfNPKWgTELF,HAAAZAAAdAEAeACE.XAFBBAGARCAAGCEBUCCA....fAHAhAAAKEBATEEAECFBhCAAAACA.aCHD.MEFBOEGDhABADFIBCGGAJGAA..WHDG.....hAGA......hAIA...,1,-1,-29,28
HOFfJBXbSATRDZIWMaPEKdVLGeQCgcYNU,RAAAZAAAMADAEADE..dAFAGAGA..eAHBQBDACCAA..hAAAgCCANCCAHDFBfDDEhABAXCFAAEEADDIBhAIAaEFDKGBDLFHB......hABA......hACA...,1,-5,-25,20
ZKFQHUEDAeafSJdTLRPNXGVIYBCgbMOWc,eAAAaAAA...SADAdADARAFA.XAFDGCDBIDBAhAFA.CBBD.bCCBMCIBhAGAOAHFZEEAFGEAHDGBEHCAhAIAAAAATEAA.LEEB.PHAAhAEA.NIEBBFDAWHEA.hBAA...,1,7,-19,26
cHXJKMeEaPgALCFfOQWdbYSDUNIZTBGRV,LAAAFAAAQADAdAEASAGADAGA.UCAAZBFBGCCAhADA.REFAHFBBKCDDECFAaGHBhBAAAAGAOCHD.bEBAhABAYHDG..TFFA.BHDAhACA......hBEA...,2,-22,-6,16
gEMTWaKQPbAGeZBYUdICVHcJOLFfNDRXS,eAAAZAAABADBdAEACAGAHAEB.OAGFLBDDFCAA.DAIB.RCEA.SCHHhABAEDHF.MDDBhACAaEFDQGAAhAAAAAIB..GEEAIGHAcGAAfHCBhABA.....hAGA...,1,-14,-27,13
CAaJMYceIUWFLTdEGfNVXRKSgQODBPZHb,aAAAMAAA..eACHUAEALAEAEAGA.GCEAVBBB.RCGBSDDDhAFAQCGABDEAhBAAHGAAAAIBJEBFIGGAhAGA..TEFANBBA.KEDDDECBPFHD.hBAA......hCAA...,1,-3,-13,10
YXIDVAHQdSbGWfcBZEKMRgOTFeaLJNCPU,HAAAdAAAGADA..fADBZABBEAFARBGB.TAGAeDDDaDGHLCAAhAAA.CCEAPCGBhACAXFAADCIBAAIBbFEDBECAhAFA.MEEBFGGA.UFFB.IGAA.hAFASGHH.hBAA...,1,3,-7,10
JMadcWXFRBONIKETLHGPCfVbZAgDQSeUY,QAAAeAAAUAEA.MADAdAHA...XAFARBCBODFA.KEBAEBDBhAAAHEEAGCEA.fCGEhAIAZGBAAAAASFHHhBEAaDDHFEBBBEHA.TGFACGGC...hBGA......hBHA...,1,0,-16,16
eKaOFcLNRgXTQHVUCAMSbDZfGYPdIWEJB,MAAADAAAGABBdAEA.EAFEeAGB.KBBAaAHDFCFDLCCA.RCFF.hAEATDBAHECACDHAAAHAZDDFhBAA..fFGAhAHA.IHHABDHAOFFA.gGGAhBBA...hBAA...,2,-24,-15,9
PgdLTaVIAbKBfYRNDCQZHOcFXJWGMSUEe,BAAARAAACADB.HACAFAFA.XAFBGBDB.MAIBUDEB...ECCBeBGHhAAA.dCAALDHBhAAAaCCCACEAKDEB..fFFEhABADEHBZEAEOFGH.WFHHSHEGhAIA.....hACA...,1,-14,-23,9
NfVAGUdXQRPMLEWKeBFagHOSTJDZIcYbC,dAAARAAAMADAEADA..eAFAFAGDHBDB.OBHDTCBA.ZBFE..hACAIEFAbDEA.CCCC.hAAAfDAEABFBGEGAQGDAhABALFFABECA.aGAA.SGDBhADADIAA...hAIA...,1,0,-15,15
QWbaSfJHFYBDcIGZLKTEMPACOXVdgeNUR,XAAAdAAAeADARAGB..QADA.aAFEfCBAhACAHCECBBHADCEAGDAAZDCBTEEAhADAEDCBAAAAODHDhADA.gEEBUEGASEAAFGHHIHEAhAGAMIAACGDA....hAEA...,1,15,-21,36
KURIGYXQbLMZBgAOeDHVNETadWCJFSPcf,eAAAHAAAEADEdAEACAGASAFB..fBCARBGFGCABQDEDhAAAMAIBZCEEAAAADDDBhAGATFCA.aEHDFEBBKFFDhACAIEFAYHAAbEGDBHFA..OGCAhBEA.NIEB....hAHA...,2,-12,5,17
WYDgSCaJbcQKdefMATXBUFNPOGLREIZVH,TAAABAAAFACA..OACARAEFZAGBHCBA.DBIBCAFAaAGD.JBDFQEEAhAAA.eEHBhAGAAAIBXCFCUGCA.hBCAGEFAEHGE.IEHA.YCCFhAAA.....hCAA...,2,-22,-16,6
QBgVdJSIYZAPDeaHGRTEXMULCNcFbOKWf,eAAAHAAARADFEADAMAFALAGB..CBFAFBHBKBEAQCCChAAABCADdDDD.SCHHhABAZEFBACCBaDHD.GEEA.TGBAhAIAXGDB........hAAA......hACA...,1,-4,-26,22
JEdOQYfWGNPVgXbHcBDILZKMeTUSCFaAR,EAAAdAAAQADA..fACAGAGAPCBCXADDhAAAHDEBDAFAZDAAeAHFTFBAhACACBFBACIBRDDAODHD.hCAAYGEGVEGBbGDCBAFA.....hCBA......hDAA...,2,-16,12,28
NOIFefVaMRXgCTJZdPQWEUGBYSDcLbKHA,OAAAeAAA..aADDRADACAGBZAEB..dCCAQAGAUCFA.GCFAhAAASBBDLDBBhABAHEAAADDBFEEHMAIB.TFDAhAEAPEHD.EHDADEIB.bFFB...IHHAhBAA...hBDA...,2,-9,-9,0
QFfPJOKXYecREdAWSLCDIaTgNGMHVbUBZ,LAAADAAA.aADDTACAGAFAHAEBUCAAZAGB.QDDChAEAFAHFJDDB.XDGAhAGA.eBBBEDHBAAFBCFFAgGBAhBAAMFFBBGGA.OFHB....hBGA......hBIA...,2,-24,-5,19
MCaYGQbVFEeBXgOPJNHDLdAURZKTScfWI,RAAAZAAAKADCSACE..fAFAMAFAaBED.GAGA.hABAQCCAbBFDFBHBECCBhCAAeDFBBECDODHDhAAAPEEBHGDAdFHAADIB...cGFBCHGA..hCBA......hCEA...,1,-6,-12,6
LbaFZeUSNdMPJVfIcHgYROTXAEBGKDWQC,EAAAGAAADADA.QADALAGB.aAFEeBCASAHHdCFC.MCDBhAAAPCBB.VEDBhAAAfCFA.HDGBhACARGFATGBAADABKEEDbGAA.FGEDNAIA.IHHAhADA.....hBCA...,2,-14,17,31
LbQKHFSZIOWYXUDBEAdCGcTgPJaVNRMef,GAAATAAA.JADA..aACARAGF...eAEHLCDBQAGAhAAAHEGBZDBBOCCBXFDAhAAABCGDABDBCGAD.gDFGhAGANIAB.bFFA.KEED......hBIA......hCAA...,2,-12,-11,1
UMdbIFcEXCHKWAeBOYZVgRDfLNQGaPJTS,eAAAOAAAZADBRADALAGBGAFA..aAHFJBBFUEFB..dCFCFDBBhAAAEDDBHFBA.ACCABDHBhABAVEABDAIBQGGBhBDASDHH.MFFB.....IGGAhAEACHBD...hBFA...,1,-6,-18,12
MJcWLeHRIAODFbTXPGKUYNSEVZdaCgBfQ,FAAATAAAGACA.KAEAUACA..SAGBEAEAdAHACBFABDDAhAAAMAIB...JDFALCFBhAEAHFEAAFIB.bDGD.XEDDhBAAPHBA.NIEB.aHFE......hBHA......hCAA...,1,-15,-22,7
EXGgTfcMbOLDKNYFeUPVdWBJHQaCAIZSR,ZAAAEAAAGACA..TAEAMAEALBEBKAGCFBHDUCAAdBGABCBDhAAAHCDA.aCHDAADAREFAfEFAhAIA.bGCCDFEBhABA.NIEB.eHFA........hBCA......hBIA...,2,-24,-8,16
aAKEZLCWbfQITeYdJcRPOVGBXHDMNSUFg,EAAAZAAALADB.CAFA.bACA..QBGAeAGBdCCARCFBOCABhABAGDAAHCEBMAIBSCCDhACAFEDDAADAKEHBfFFEhAAATEGAJFABPGDABHAD.DGIB.NICB.hAFAaHGE.....hAHA...,1,4,-6,10
EbgIaYJUMAeZGFWTKdDBRLXcOQfNPCSHV,eAAAGAAAFADDKADAdAFARAFFLAHB..OAHBQCDChAAAfCCECEFAHEGBEDFBbFAAhACA..aCHD.UFBAhAAAADAB.ZFFADFAABGDBcFECSHFA.hADA......hAFA...,2,-13,-7,6
McFJXLKTdWebSfAYOVgCGHUDBZQaPNEIR,OAAACAAAHACABAFBZADB..aAFDEAHB.RCAA.MAHBFCEA.LCCDhAIA.dDGDeCGH.bEAAhAAAABBBgEEBhBAAGEEADDIB.PFBBIGHAXFDD.KGHB.hACA......hAEA...,1,-7,-14,7
KgDWROUFPMQSLdaVAYIfecEBTZXCHbNJG,..IAAAeAAAEADAZACAHAFA..JAFAGCCADCCA.RCFAFEFHMCGBhADALEHB.aFCHhAAAACHAfDDAhAEABHAACHFA.KDHB.OEFH.PFDD.dGHAhAIA......hCAA...,2,-30,-6,24
CMYVgGaeZNLEWBXURPSTAIJHKbFDdOcfQ,HAAAFAAAdADAOACA.QAFAMAFA.VCCAaBEDeBGB.hAAAZDBAECHFBBHBRDFBTFCAhAIAACCBKDFB.DEIB.CGHD..hBAA.gFFALHBAWFFD...hBDA......hCAA...,1,10,-35,45
TURZEJGeBPgLSVQCdfAFDMaOKHXbINWcY,MAAAaAAAHACB..XACA..bAEAIAFA..hAHAcCDDTBGARCFFEDHFhAEAeBBBBFAALDDAhAIAQGGAdEHAACFBOFFBKFFDYBBF.ZGAEhAFA......hAGA...,2,-14,-3,11
LWGaVKBAIdMDNObPFeYCTfEZQRgUHJcXS,dAAAMAAAOADAFADD..eAFACAGA..EBDBRBBBHCFA..XBGAhACALEDBGCBAhAIAaFAABBHAADFADDHB.bEEBTFFAhAFA.QGACgFCH.cGFDhBAASFHB.KHEAhAGANEIA...,2,-14,-10,4
XdSJZAPUgTFWefcIHGaNVOMLKQEDBRYCb,UAAATAAAeADA....fACBHAGBaCBEOCEBMAEALBFAhAAAEDABRDFB.bCCBdEHAhADAZDGBAAIBFFCBIEEAhAIANIDB.QGBABHHB.XGDASFFDhAEA.....hBGA...,1,3,-9,12
eEJVcSHZUgPIKYFMAdLTXGRbWfQDOaBNC,dAAATAAARADA......bABDQACCOAGD.aAEACCEA.EAHBhAAA.VBEBHDECZDGBgDAGhADAKDDDMEIBAEGBGGABhAEADFFBeHCESFFA.IHHAhAGA.....hAIA...,1,-1,-8,7
feKPIdDJRHaAYMbZTXQFCNSGEcgLBUOWV,MAAAZAAAQAEAFADD.CAGA.GAFA.EAHBLCABOBBB.hAFAfBHAeDDBKDHBdFBAhAIARCCAHDFAADFB.bFFATFFAhBAASHFABHDAWHFA....hBCA......hBFA...,2,-13,-6,7
NWLEUZaDgSeAfQVRHbcBTdXGPICMYOFKJ,QAAAHAAABADBdAFAGACBCAHA.MAFAFCAHKCCAJBGB..LDAAhAAAECGA.aCHDDDFBeDFDhADAADIB.REDB...bECB.hBIA....TEGAIFHAOFBBWFCDhCAAZGEA.....hCDA...,1,-8,-20,12
aDIfbGNUJSYLBceOZTAVERXCFWHgPdQKM,RAAAFAAAHADBdADAKAFAMAFA.DBFA....ICFAGCFAUDAAhAAA.SBHHhABALAHBeCCBZFDBADDBEFHBCDBDPEEAhAFA...aEHD.....fGGEhBAA.JHCAhBDABHCC.,1,-13,-25,12
ZEXJcIdSGRbHQOUDYCNaKeWVBFMfLAgPT,TAAAEAAA..XACAJACA..dAFARAFAHCCAQCCADCHBCDAAKDFBhAAAeAHBBEEDMCHBAAFAZFCAhADASDFB.hAIAbFECODHD.NICBaGGCFGHD.....hAAA......hAIA...,2,-18,-8,10
LTUdaeBEgDPCIWKSQXVZMYRJGbOHNAFcf,FAAALAAAdADABAFAEAEADAHB..CAHA.KBFB..QCEAhAFAZCAARDFAGEAAHCGDAAIB.TDBAhAHAeCCE...gEEGhBAAIFHAXGGCMEIB.JEEFNICBfHGBhBDA..hCAA...,2,-28,-11,17
SIGRJMPBQNOYXUaHVcCWFgTZELAbedKDf,eAAAdAAADADA..SADARAEA.MAGBQCBA.OAHDhACAXCCAHCFBCAHAFCHBhAAAZDDBAEIBbCEDKFFDGEAAhABABGHA.UGEAaHAA.WEHHEHDE.....hAHA......hBAA...,1,-5,-18,13
PUCGSXNdgfQBIcOWaFATKRDVeHZJEMbLY,RAAAeAAAHADBEADAMAFALAGBUBFA.GCCA.SBEAhAAAdCHAQDAABDHAOEFBhABAaDDCAAAADEGBZFBF.YHFGhAIAXFGD.NIBB........hBFA......hBIA...,2,-12,-8,4
MZXNQPKDcYfBSGJeWFAOEgbTCLIUdaVHR,EAAATAAALADA.dAHAHACBRCBA.ZAEAQCFCDAFA..hAAAfCAEGEAAeDHFhAEAAAIBbCEDCECAaEECMCIBXGGAhAFAKCGDBEDC.SEGH.FGHDhAAA......hACA...,1,4,-15,19
YRPDTULHKOGfVgFIXWeANabECQBMSJcZd,aAAAEAAABACA..MADASADHZAEERBCBDAIBLAFA.HCDChAAAGCEAVDGBFCGCXGAAhAGAABBBCEGA.QGGBhAHAdGGA.PEEB.....hBAA......hCAA...,2,-32,0,32
ETdZfLRAXMgeOFGCWSBIUKcHQNPYVbDJa,MAAAeAAAGADA.SAFABADAKAFAHBBAQCFA.hAFAPCCBbBFAaDDAEEFBZDFBhAHARFABAAAAOEEB.CFHA.hAIAIFHA.NAIADHDAdHFB.....hBAA......hBBA...,2,-19,2,21
GQNAgZTEIMSXCKcPYJeLdWHDfOVaFBRbU,ZAAAEAAA.MACACACA.KAFA....PAEAeAHHdCCDHBCCDCFBOAHDhAAAFDGH.RCFBGEEAhBHAADIB.IGHAXEBAhABA.JEEFfDDEBGCDQGGA.hCAA......hCBA...,2,-23,-14,9
PcCWaFgSRdBVYbGfMKUAeTJDOQNZXIELH,eAAATAAAOADC.ZAGBEACEHCCACAEBFAGARECAdEGABBFA..VFABhAAAGCCA.MCHBAAFADCEAhABAQFEA.hBIAXGGBLGFA.......hAAA......hCAA...,1,-3,-26,23
TVeLgMDGWcRSdUZQXEKJaOAFICYfNbHPB,CAAA..fAAAHACATAGAeADA.MAHBGCAARCAA.dCCDZCEBECFBhAAAaCHDAAFAFCHD..IECAhAAAbEEC.BEADhACALGCADDGBSFGAQGGAKGBA.OHFAhADANIAB....hAEA...,1,10,-12,22
AWJFKNLafMZOGgERXBSUPcTDbeHCQdYIV,FAAALAAAMADAGAGARADFBAFBUCAA..TBCAeAGHHDDChABAdBEA..IEEAhAIAAAIBKCHBaEGDZFGB.EGBASFCAhACADEGBQGDA..YFHBhCFA......hDAA...,1,-7,-20,13
MQPFOGbSEfUAKcJYCLgVaBTRHDdNZIWXe,KAAAJAAALADB..aACARAFAHCEBdAFAZAGB..XCGAhAFAeBCFMBIBQEGDhAGAODDBGEFAEDCBACCACGHDBHCAhAIADFBBIHEA.....WFBHhAAA......hBFA...,2,-29,-9,20
KcSPYGREZJNUHFBeAXQgbCWTMaOVIDLfd,QAAACAAA.MADAaACAOAED.DAGAdAHA.SBDAhAAAGBCAEBGAZBFBUDGAhAAAHDBAeCBDABDAbDGDTFEAhBCALFDB.KGFDPGBC....hBGA......hCAA...,1,-1,-22,21
RJSBVdgECIcaMKfQbXLeGWZDHATYUPFNO,TAAAUAAAFADA..RACFBAEBdAGA..EBDBCAGA....aAHDMAIBhBAAQCEALDDAeCABhAAAZEFEHFCBADGA.PHEChBCAODHD.SECA.gFFBhACAKGGC.bGAA.hBGAWHEG.,2,-31,-10,21
VFgbZRMOYCTUQPcafeDdKNGXJLSHIEBAW,FAAAZAAARAEAMADA..CAHBUCAAQAGA..aCDDeBCA.dCFAhBAAGCFALDBAHFAAhABAEDHBAADA.VFDAOCHFhACAPHFCDFDAKFHD.JHCA......hAFA......hCHA...,1,-5,-13,8
QGSMeWHEDNAOXKRLfFJVCZdcYbPaIUgBT,KAAARAAALADBFACA.CAFA.dAFA.....bAGDaAGD.UDFABCCAhAAAGFABeCEBHEFBhAIAEDCBAAAA.OEHF.XFBAhBFAfFHA.JHEA.....hBIA......hCAA...,2,-25,-23,2
EeWPJVcLFBGbHUINRgdTMCKXQZOASaDYf,aAAADAAAEACA..eACH..JAEBLAEAGAGAHCCBICEAhAFAREFBdFHAMAIBKBBDZGAAABBBfCGAhAGA.PDDBhBAAFFEH.BEGANIEB.TFEA.XGCChCAA.SGHBhCGA.,2,-20,-12,8
RHYEgAODeVXZIUQSNPJCdLTMKFWaGbBcf,eAAAZAAAQAEA..SADAJAHBdCAALDDAMAGBFAHBhAAAGEABbCCABCHAREGBHFDChABAEEAAACCADDIB.XGBChACAIEGA.PECC.TGGA.hADA......hAEA...,2,-14,0,14
MBgHQeIdGKOPASRNJYbTCcXVaUEfFDLZW,RAAAJAAA..TAEACADB....XAEDaAGAEBGF.DAGAZCCABBGBhBAAHDAA.eCHFGCCAhBIAOECEACCB.SEGDhAAAbCFA..cEFAfGHA..hABALHEA..hCAA...,1,2,-40,42
CZSGMLQIBbOFJEAVRDTfcdaNXUWKPgeHY,RAAATAAAdADA..aAFAUACA.KAEAeAHHHAGBZBEBGCEALDDDhAAAQEGABDHAFEFDAAIBDDDBhAAA..fFHAhABAXGAA..gGDBSGCDIHHAhAGAOHFC....hCAA...,1,-12,-14,2
cBKNIXJeHOSGdEVLUgPFQfCWDTAabZMYR,ZAAARAAAKADC..XADBHAFAGCCAEAFALBHBUCFBFEFD..QCAAhABACEHA.TCFAhACAAAAAaGHB.MDDBBHAAhAHAIEEA.eFCD.dFGA...hAIA......hCAA...,1,4,-28,32
IPJeLfXaTOdECRAVQNFHcUYMSGbKBDgWZ,QAAAHAAAUADAMAGBGACBBAHADAFAZBFE..JCAFeCDBLCHBhAAAaDAAdDGARDDAACCBFFED.hACASGGAKFBA.hAHAIHBAXFFC.EGHFNIDB...YHDAhBFA....hDDA...,1,-4,-16,12
IDObdWFKAXLNfEMHURgQSVPJcBYTeGaZC,LAAAEAAAHACARAFFQAEA.SAGAPBHDBCCDeCAAhABAZDEADCEBdEAAKCGAAAHAXECChAAAMDDBUEAAVFFBhAEAJEFA..TGGA.aFDD.OFFB.hAFAFHAA.....hCAA...,1,9,-9,18
eIBYSLXVJfEDTOZAQaPWMbGcKURCdNHFg,aAAAMAAAGACAKADA.RAEA.dAFAHCECFAHB.eBBDBBBALCHB.hBAAXEACfCDAhBBAEEEBTGFAACIB.PHAAhAEAbDFBCEEA..IEHA...SDCDhCAA.DGHBhCDA...,1,18,-43,61
CHSWcFfANIGLOgQTdMaBEPJYRDUXbVZKe,GAAALAAAQADAdAEAaAGA.EAFAJBGBRBGBDAIB..UCAAbCDC.hAAAZDCB.KDHBHEEA.hABASDADFEEBAFGA.hACAOEHDMICABGBDXGEACGGA....hACA......hADA...,1,1,-23,24
STHeBMVDRUQafZNJOLbcACFYgGPKdWXIE,FAAAGAAAdADA...XADAEAFAHBFCeAGBMCCBRCDB..UDGBaDDAZEEAhAFAODAHLEHBhAIAAAABCAHB...PGDAhBAAKDCDSFDA.TGGADDBBNIBB.bGCC.hBDA......hBIA...,2,-6,-4,2
gDBXZaUCOAWKNfJeLbcHREGQYTSVIMFPd,KAAAJAAALADBHACBEAEAGAGA.QCACTAFA.SCEHhAAAMAIBdCCCBCFDhAFAaDFDODHDACHB.fEDEhACAeEEARFGBIHAAFGBADGGB.....hAEA......hAIA...,1,-2,-25,23
GIYOMKDFgEPCXJBdZfURWTeVSALbHcNQa,HAAAQAAAGADAOACCMAFAFBFA.ECABXAFBBCCDZCFERBGFeCDBhAAAAEGALFFA.hAEA.bDEDaHFAKECBDIBACEHAdGHAhAIA...........hAAA......hACA...,2,-12,-6,6
DENbLJCPSaRXYVcHKMZBdTOfGFeAWQgIU,QAAAUAAAEADALAGBCACA..aADDRBDA...XAFAhAAAVDAAHEEAZCDEdDHAOCHDhADAGEEAAAIB.IFAAhAFAbGBA.SFCBKGGA.MIAA.fGHAhAGA..hAIA...,2,-16,-3,13
POKScWABDdRefTJFbYNHUCVLaEXIMGZQg,dAAARAAAeADEJADA...FAGA....bABDHBDA.CCCDaCFEEAGEMCEAhAIAZDFE..QFGAhAAAOCHDKDEASEEDhABAADGADEDB..TFFANICB.LHFAhBAA......hBDA...,2,-28,-7,21
KPYZDHMJLCUEabVXfGdQSgWFTeOIBcRAN,KAAAZAAAHAEAMACALAGBEBHF..bCAB..XBCAdCEDQEEAhABASBFFFDHDeEADhACABDBAAAIB.PDDBhAAADDDBCGHAaHACGEGA.TGEA.cGCChBDA.....hADA...,2,-13,-4,9
NUcFOCSdTAKPJReVZYWLbQIXMfEBHGgDa,KAAARAAAeADEZACBLAFA..bAGBQCAAMBEBBCCAHCFAhAAAGCFAaDEH.UFCAOECDhACAdFHAAAAAJEGB..YFFFhBIAXGAC........hAGA......hAHA...,2,-15,-8,7
fJaWcNdBTVOGHLMQbUEgCeFZPIXDKYSRA,aAAA..NAAABAFAOACDHAGBLAEA.MAIBbBBA..ECFBeBBDhAFAZDAB.XCFAhAGAKDDDREFAAAIB.fDEEhBAA.cEGCdGHA.GECA.gGGGhCAAFFEHDBBA....hCEA...,1,-6,-10,4
eVBdHOEfSPICWMaGKXcQYTJbUZADFLgNR,LAAARAAAeADEBAGBHADB.EAFA..SAHHCAHAaCAA.GBDAhAAAXCFAQCFChABATEEAUFAAACCAFDHDgFFBhCAAdFHAfGCB......hABA......hACA...,1,-12,-14,2
cZEbWRNKDHGYSFUgefBJMLCIAXOQadPVT,QAAAdAAA..TADAEACARAEADAIBHAFBGCDAFAHFeCAABCFAhAAAMDDBLDCDADHAaEEA.hACAPCHBZEGB.bFADKFAAhADA.SFDHUFGBfGEACFFD..hAFA......hAHA...,1,-3,-5,2
AXeUbfJSgQaGPIVNCcWTMBOZDFEKRLYdH,eAAAUAAA..JADAQADA.GAGAIAHACAFA..TCCAhAAAMBDBZCDBEDFBRFFAdCGAhAGAAAIB....fGDAhABAaDHDVFEA.NIEBBEEDFGDH.....hBAA......hBCA...,1,-3,-30,27
agOMAbBPRIDSQYJXGNUWKTcfeVdHZELFC,BAAARAAADADA.QACA..XAEAGAEBUCAATCCAeCFAhAAAHBGBEDDBLCEBhAAAaDGEMFAAAAHAbFGB.SGEAhABAYFEBWHAA...fGGAhACA...hBIA...,1,-5,-20,15
AIMRXFSUHQaPBVZTJObWeYGCgLEDKdfcN,RAAASAAAHADBQAFABADAZAEBOAHFeAGFGCCALDAAEBHFhAAAdDFA.fDHEhAAAACCBMDABFDHDaEEB.TFAAhABAbEFD.CFGAKGHB..IFEA..hABA......hADA...,1,14,-17,31
aJQYVgWIKDFLXNfHEAeZGdOBcMSPUTbRC,eAAAdAAABADAMAEAUAFARBCA...CAHA.aAGE..QCBAhACA..gCEAhAAAKCHBLDDBfCHAhABAHDFBADABZFBBGDBASFHHbEFAVGEADFBB.hBDAFHEA.....hBFA...,1,-8,-15,7
QdYCaURZXeGPcBgJFfAMDSKVTLINEWHOb,MAAAKAAALACB.EAEAHACC.bAFBdAHACAHA.RBFBZDEFGCCABDHAhAAAFBBHAEAA.DCFB.TEFAhBAA..IECAhAEAOCHDaGHBeFHBPHCAJHBA.....hBHA......hCAA...,1,0,-22,22
aKQLCGDYIRTBAZdWNXeJEOcMHFbSVUgPf,dAAAXAAAEADA..MAGBHADA.SAFEUCCA..fAHAhACAaAHDLCDAGDAAhADADDAARDFAACIBZDFAeEEBOFCChAHAbFCDgGGAQFFC.CHDAIHHAhBAA....hBCA...,2,-10,7,17
VURCDYHgMBQEJWbKXLefIAFSZGNcPTOad,ZAAAGAAA..PADAaADAdAGA.RCDADAIBHAGB.MCABBDCDECCB.hAAA.JDGBKCEALFEBhACAeDHFAAIBFECH.SEEAhABATGBAOEHDCGBDQGGB..hACA......hBGA...,1,-11,-18,7
DFeAXHBNEQTPRKCOYaLgGfVZScdUWJbMI,HAAAEAAA.TAEARACAOAFALAGB.GCABZBFEdCCDUEEAJDAB.hAAAbEAAMDGB.FDHBAACABDHAhAAA.PFHBhAEACEEAaFHD.fGCE..SGBAhADA.....hAIA...,1,1,-20,21
CAdJNWKUYTIRVfLbHScPQZFEBGXeMgOaD,dAAAJAAA.KADAUADA..TAGARAFA.LCCAHCFC..SCCDhAGAQCGBEDDEGDAAhACA.eECEMEGBhAIAaEGCAEIB.NIAB.IHHAfGGA...hBAA......hCAA...,1,-6,-34,28
KdELWRcZgVfBHADYUTGMXaPCQJeSFbNIO,DAAATAAAGABB.MAEAaACA...QBFAeAEHFAGAbBFDOAHDhBAA.dCCDECCBRDEBZEGBhCAAfCHEAFIB.XEEChAAACGED.SDBD.KFGA.hCBAWFDD....hBDA...,1,-14,-19,5
QYgONURSBFdLPEKGWIHCVZbDfJMATXeac,eAAAaAAA.QADAOACDRAEA.FAFELAHBEBHFGCCAHCDBZEFAbCFDhAEADCGB...MHEAhAAAABBBTFAA.XFDChAFA...gGGASHGAdHCDhBAA......hCAA...,2,-13,1,14
TSbLMYFVJPIRGeUcQfWagODNAECKZdBXH,EAAAZAAAdAEAHACA.SAEEMAGBFAHB.JAHBRCAA..GDEAUCCBQDFChAAA.aDHDhAHADCIBACFABFEDbDGDLEDDhABA...PEBDIGGA..hCAA......hCBA...,2,-19,-13,6
bJTUDVPKRAEGFYXIZeHcgQWONLaBfCMSd,EAAAGAAAFACD...XADAeAEAHBFCQAGAOCDCaDGECCDAdDFAhAAA..JEAATFGAhACADEEBKFADAADAZGAA.gDCGhAGALFFAMHFASGCE...hAAA......hAEA...,2,-15,-1,14
JFQTMeUIfBgCLcAdKRVYWbOGSENHDaPZX,RAAAVAAA....bADBGADA.EAFAHAFADAIBZCFBFCCBMCFBhAAAeDAA.UDGABDHALGEAhABAADAAdFAAKFDAOHAAhAHAaFHB....PHBC.....hAIA......hCAA...,2,-15,-11,4
gPWXfIEZJFALTDQUcBRGYeNHMbCOVSKad,TAAAQAAA.BACARACFeAEEHADBMAIBOAFA.KBGDdCEA.hAAAPCABfCHAhBFAECGBZEDAADDBLEEBhBIADEIB.cEGCYFBACFDAaGGCXFGD.hCAAFGEDNIEB.SHAAhAAA..,1,10,-12,22
VeBbXGSYKQaRETPfZgdJLCcHFNOAMDWUI,MAAADAAAUADA..eACABAFAGAFAKAHB.RCCAEAHB..TCBAhAHAZDGBdEEA.LFBBhAIAHCFAODEBABBBIHHAhBAAXFFA.SBBC.aEHF.hBFA..fHCBhBAA..,1,-10,-31,21
ZCOdYLeBIXAfUJbRGFHgDaVTKQEMWcSPN,UAAARAAAHADBDADA..aAFAKAFA..EBFEMAIBSBHH.ZDAAhAAAdBDAeDGBXCEDhAHAACCBJEEBFGFD..TEGAhBAA.QGCA.PDCBCHHA.hABAOFFB.BGHAhBCA...,2,-32,-5,27
OgGXTfKFYVaRENbLdAMJCSDQIPeHWUcZB,MAAASAAADAEA.QADAeAFAHBBAUAGAZBFEODBBGCCATEFAhAAAFDDB.aDABEDGAhBAALDHBAEFBCEHA.IFBAhABAPFGBBGDAfFEE.YHEGhADA....hBFA...,2,-12,-11,1
BERANGcQOWVMgTfUHCSaYDXKPJbZIeLFd,GAAAQAAAOADAMADA..TAGAHAFCaBDBDCDAKCFA.JDDBhAAAZCDB.eCFFdEGARFEBACIBcEGAhAAA.gGFAhAIACEBA.........hACA......hAIA...,2,-26,-2,24
DYbNXfZRJVMIOBcKLTFeGdUHQSEWCagPA,DAAA..bAAAXABARAEA..MAIBBAEALCABeAFHdAHAHCCChAAAECCB.aCFDACEB.fDHEhABAZDFBVEAAODHDhAEATFFAGFAB.SHAGCEEAPHBAYHEGhBAAIHHA..hBHA...,2,-18,13,31
AVKWPEdOYNfQXSIaZFgJMbLBecHCGRUDT,KAAAEAAAdADAOACA....fAFAQAFASAGHhAAAZCCAFCHDMDBBLBCDhAFAeDFHHECBRDDFTDGAAAIBPFHBhAAAXFFC.aGDH......hAIA......hBIA...,1,-10,-14,4
ULIWdCcQTFABOHReEYDMJGXSVfbaPZNgK,HAAAEAAADADAGADA.SAFAVAFA.aAHDZBCAKCADLDBAhAAAdDFAQFAAACIBRDFAeFFAhAIAMDDB.XEGDhAAAbGDC.PFEB.......hBDA......hBEA...,1,9,-20,29
XYcFbLMHRTDeAEGJSKNPOWgdIZVCaUQBf,EAAAGAAAKACA.OADAdAEAZAFBCAGA...QCCCXBGAFCDAMAIBhAAAHDBB.RDEAeEHFhAAAABHBSDFA.PEEBhCAAgGFD.aHDCfFHAhCBA.YHFA.hACA...,2,-16,-10,6
HCaAdEROPecQNMFKSVGTXLBfUZWIJgYbD,RAAAeAAAQADCMAEAKAHBGAFA.LAHBBBCAZBDB.ICFAhAAAgCCG.bEFAhAAAHCGB.AEFBEFGBOFAAhABAPGBAFFDDTGGA.fHBBhAFAWFHHDIDA.CHEA....hABA...,1,17,-26,43
edSGRNZWVYDIFbEgJTQMacKXBCOHLAfUP,UAAAeAAAGADARADAZAGB...VAFADBIBFCDHECCB....TDFAhAAAaCFB.KCHBBDAAHFAAhABAAADA.dFDA.SFFAhAFA.YFHBbEFAQGAAMIAACDBD.hAIALGEA..hAGA...,2,-37,24,61
XFEaeHVKYLbZSDdfMWOgATPBCGUQcNIRJ,TAAACAAAGACA.UAFAQACC..ICAARAEFFAGAECGAHDFAhAAAKDDALEABhAAAZEAAdBHAMEEBODHDABEABFFDhACAcEFBJFHB...eGCE.....hAEA......hAIA...,1,0,-15,15
UbILVGZOfTgcKNBaHMWPDJAEXYFRdeCSQ,EAAAFAAARACFdADA..eAEEQAFA.UDBAbBED.LBHBhAAAZCGBOECBTDEA.KFADhAFAaEHDHFCCMFFBDFHBAAHACGDAhBAASGFH..IHHA.hAIA......hBCA...,1,-7,-19,12
VXFEWRLKaZNCAQTYHSDIeBGcdbgPOfUJM,TAAAHAAADACA.eAEAGACAdBHA...bAEAOCCA.UDDBhAAAMAIBFDGHRCEAaCACZFAAAEIBQEAAhAAA.SEEAhACABGGA.gEGH.fFCBhAEA.XGAChAFA,1,11,-32,43
DMCZIFAcYgNEHRfGdPQbXaSOTWUeLVJBK,....gAAAHAAARADFdAFAQADAaAHBTDAAeAFA.LCCBhAAABCCDMBIBZCEEABIBhABANDFAGDGAbDABODHDhADA.VFEADEEBFGDHEGABXGCCSGGDWHEAhAGA.....hAAA...,1,28,-10,38
YIUWMSZHNRGKBbTAeQELCdPDFOJcXfVag,EAAAdAAAFADA..OACCJAGB...fAFBaBDC...hACAICCAMAIBHCBAhAGARCEAGEAABDEAADHBeCHHhAAALFFADECAXEFDgGEGUFCA.SFHHhAEA..hAHA...,1,-11,-30,19
cUPINJZVTaXCefBALRODHEYKFSdgWQbGM,RAAAHAAAEADE.FADA.dAGAQAFCGCABMAIBUCCA...ICHAhAAAZDEBaDGDeECFBAHBADFAhABADEIBKEFASGBDhAAA.bGEAPFEB......hCAA......hDAA...,2,-30,4,34
gPDRCeQTXdVANcLIJOBZGSKFHYWbUMEfa,LAAAOAAAGADAFAEAHAGB..bAFAEBDF.aCAADAFA.RCFAeBBBhBAATCEA..dEFDAAIBIEGAhABAZGCAKGGA.UGGAhACAMDBBfEEE.....hBDA......hCAA...,1,-6,-10,4
HbDIdBCMWLeEUPcNRXafZOTVFYQgKGJSA,HAAADAAAdADAMACALAFAEAFA.UBBA..PAHDRCEA.aBDDZEEAhAGAOCCHFFCB.QDFAhAAAGGEBACIBBHAAhAHAeEEBXFCD.TGGA...hBAA......hCAA...,1,7,-25,32
PHebMaWcNURTFZGdLBCgfJAEDKOQYIVXS,EAAAOAAA..QACAVADA.SAEAHAGBeBBBaAGDNDDA.hAGARCDAZDFEGEEA.dEHAhAIALFAACHHA.fFGAhAAAAEEBDIBA.KHDA.IHHA.hBAA......hBIA...,1,-8,-12,4
dNXAQJUTbFaKMHLWDcSYeGCBRIPgfZEOV,QAAATAAA.aACEHACB.LAEADAFASAGAeAHHGCEAhAAARBDA.gCAGhACAECGAdDAAADDBUEEAbEGDMDIBhAFA.cGAABDHAfFHAOEDBXGDDhAGAKHFACFDC....hCGA...,2,-13,17,30
BcbAKZWYgSNILPUVdeEaRJfQFHODCXGTM,ZAAA..gAAASACELADAUAFAeBHHRAGFQCCAhAAAHCCCCDFAGFBBMCFBbDFDhABAAEIBKFFC...YHBAhABAIEAA.dFHAEGHBaCHD.....hAIA......hBFA...,2,-9,3,12
UNFGQVIbfTZcARDPOgHKYLadBJEeWXCSM,RAAAOAAAHADBLAFAdAEABAGA.ECCB.eCFACBBDUCGAGDAA.QEEAhAAA.bEGDhABAZDBAAAGA.DDCAKGCAaDFB.hADAXFGAMDIB.FGAA.....fGFEhAGA..hAIA...,1,22,-44,66
gCcPNDXaIGUTQMSRLYZbBdJWAEfOKFeHV,EAAAKAAAHACB.CAEA.PACCDAGA...aAFAGBFA.TCAAhAAAMAIBRBEAZEAAdCCAABHAFDEHhACAeDFF.VEGB.NEEA.hAAAXEGD.IHCA...hCAA......hCBA...,1,-16,-18,2
BgWSdLJQFNTYIMHGfEVeDaOUCKAbZcPXR,ZAAAXAAARAEABAHB..SADAdCAALCEAQAGAFCCH.hABATCDAMCIBHEEAhACAECFEeDABOFAAKDCDAAAA.hADAbDFA..gGCANIBBIFFAfGGAhAEAaFHHCGAD....hAFA...,2,-14,6,20
VeJQaNfATMZgbHDCYXLRPWUOdcSBKEGIF,ZAAAHAAACADBLAFARADFUAFAdBHABCAAGDAA.FCCHeCCA.aCFDAACAMDFBhAAA..bCGDXDGChAIA.OFHBhCAAKEEDEGAA...IGGA...hDAA......hEAA...,2,-29,-9,20
QGOXaFHVRLIDdNeEWSAMPcKYgfCJBUZbT,MAAAKAAA....fACBBADAZAEBTAGAGAEA..aAGAHBBAhAIARBGFLCCBdCGDEDDBAEGAhBAA..PEAB.hBBAgEEACEHAbFEDQGGAFEHDDGGB...hAAA......hAEA...,1,-8,-15,7
ZRMCYTaLEBFfGNeUgbDKHVWJdPXcAISOQ,OAAARAAAMADA...TADAEAGABBDA.GBEAeAFEUCDB.hAAADBBBHCGBJBGFdEEDXFGAhABAACCB.QGCAhBIAZFGB.aCCH.fGFENIAB..hCAA......hCGA...,2,-24,-10,14
IQVBSHcDdZNTLGMeUfRYEKXJAObWgPFCa,OAAA..bAAA..PADCaAEAQBECBAGBHCCAdAHAZCFBhAIATCAAGEGAeDDBhAAARFCAEHDAXDFAABBB.hBAAFECHCCHA.SEHH.DFFB.MHBAhABA.fGGEhACA...,1,-9,-10,1
aWGgZSJHXMIFdBeVfAEKcUDOTCPLYbRQN,EAAAKAAADACA..TACALAFA.RBCA.aAEAGCEBZAGBHBEDMDBBhAAAdDDA.eCHHAAGAOEEBhBDACFFAbGEA...QFGAhCAANCCA.SGFD.IHCAhCBA....hCHA...,1,-2,-27,25
AWTISZRcDOQVGCMfEaYgNFeLKdJXPbBUH,TAAAZAAARAEADACA..QACCGCCB.MAEAEBHF...aAGE.hABA.gDGAhAFAeBEFdCGAXDEDBFEAHGCAhAHAACIBSEHH.OGDAfGGAhAIAFHFE.....hAAA...,1,-13,-14,1
ZdYPBDHGOCaeMQWKJNfUcXISALFTbVREg,TAAARAAAEADE..dAFABACBHBGBGADA.aAFAeCCB.MCEBhAAAQBFCKEGDJFEB.fCCEhAAA.XDFAhAIAAAHAFGHB.bFFA.......hABA......hBIA...,1,-11,-21,10
eQDKYHUPXdVLIGaTcJBACfEbSgRNZWMOF,EAAASAAARACA.ZACBMAFAFAED.DBGAHAGBUCCBdDEA.LEGBhAAAaCFA.TGAABDAAACIBhAAACGDA.....bDEDhADAWFHHeDGB.KGHB.......hABA......hAGA...,2,-23,-20,3
OfgLdZGKFUCBMTRHDXNWcYaIJQPeEASbV,SAAAOAAALAEAGACAFBBHBAEARCEAHDBCDAGA...XDGAhAFANBGA....hAGAcEAAaAHDQFCBhBAAEBHBAAAA.bFFBfCEA.ZEGBCHHA.hBDAMEFB.YHDAhAEA..,2,-18,-4,14
WfEYSQMCZNDGacIVJUeAdBPXKgLORTbHF,dAAAXAAALADARADA.HAGBFAGA.ECBAQCDBZCEFGEAAaCFDIDDAhACA.UEGAhAEAAAAAKCHBOGDCTDAA.hAFAbEGD...fFFAMIDACHHA.DHCA.hAIA......hBAA...,1,5,-13,18
YHefDORKBIPcQgaFACNUMWEdSGTbJZLXV,CAAAMAAAdACAGAEA..bABAZAGBLAFA..XCBChAAAHCCAeCFEOCHDRDFBBEEDhAGAIEDAcFGDaEAChAEAAEHANHABEEGB...TGAA.JFFF..hAGA......hBCA...,2,-15,-3,12
FPeHDWIVZCLJbdUTgORXEKaGNfBcQMASY,FAAAHAAADADAVAEAZADE.LAHB.dCADTBGARDCA..EDGBGCCBhAHABEAAMEIBAAIBSDGAhBAAeFDACGGAJHCAUFCAhCAA.OFEC.aFHD.....fHFBhCBA..hCCA...,2,-27,-2,25
cUHbYWTDfVNRKLEIOGBZSCdPQMegXJAaF,aAAAFAAAHACB....bACDTAEA.DAGAfAEAhAEARBGBLDEBEAGAGEAAZBFEdDGAhAGAMDGBeEEBJEHBABBBcGGAhBAA..........hCAA......hCCA...,2,-16,-11,5
UZScPJeCHBOMaVGWNIQbdYDgLRETKFAfX,XAAAZAAASACE..JADAHAEBMAHBGBGA.IDDAhABAdCDADAIBRCFBEEFBTFCAhAAAAAGAUGBA.eEHHODBBhABAaGEB.VFGB.NEFA.......hAGA......hBDA...,2,-19,0,19
XbOYfISAJBWeCUEPVNZcLdMHTaQRgDFKG,BAAAeAAAEADA..PACAZAFBdBHA.HCCBaAFD.REFAFFBBGBGAOFEBhAAA..fBCEhAAAACCBCBEA.VDEB.hABALECBMIAA.TGGADGHB.KFBD..hAHA......hAIA...,2,-19,-7,12
SDTfedLJKZUBMXcaIgHbCPVENFYRAQOWG,QAAAGAAADADAeAEAdADALAFAZBFEBCDAMCFA..aDBDHDBAhAAA.bDFACDFAEDHBFFDAAAGAhBCA.SFHDhBDAJEEFKGGA.XGDC..IHBA.hCAA......hDAA...,1,-2,-29,27
MHgbXfVcGDBLZCJdWAQPOaKFNSIUYTReE,QAAAaAAA.FACESACHUAFARCDB.EAEAHDFB.XFBAhAAAfAGA.GCDAhAEALBHBZCFAdFFAhAIAADCBKFHBIHCAeHDA.bFGDDIAACBHA..WBBDhBAA......hCAA...,1,-2,-16,14
RfEKMUAZONbFPgCTQaXHWYdGVIDBLecSJ,ZAAAOAAAFADA..CAGA.aADDHCAA..dAFAGCEADAHBeBBB.SBHHhAIARCGBEECBMAIBADBB.hBAA....bGACTDDAhBDAQGFAXDFD.VFBABHHBLEHBhBFA...hABA...,2,-11,-6,5
HRXMNILOFcQADaEPJdCgbKZBUfeTSWVYG,EAAAdAAACADAKACAZABB..BAEBUAFA..eAFH..TDCASAHBhAAA.VCCBHDGBhAIARCGBMEFBLEFDFGGAAEGBhBHAaBHF.PFBB.bFDD.....hCAA......hCBA...,2,-24,-11,13
gASZXYBTbLaPDNWRUJVHfIKEdFMGeCQOc,ZAAABAAALADBaACA.DAFARAEFUAGAHBFAKCAA.dDFDGBCA.hABAeCBDQFBAhACAODGBADHAXEEC.hAAAbFGDPEEB.JFHB.IHFAMDIBCAHA.hBFA......hCAA...,1,-9,-16,7
UbYGICcWTAgfSMBNZXROKVJDFELeHdPaQ,SAAAMAAAZABERAEF.KADA..DAGAEAFEHBGBdAHA..QCCAhAAAUDCAGEEACCEA.TGCAhBAAACGBBDAA.ODFEhABAFGHB.eFFA.bGFA.......hBIA......hCAA...,1,-14,-16,2
JGPRVgDHQIFfCUBNSKETZYbOcWMdLeAXa,aAAAGAAA.RADADAGAHACB.QAEAFBGDUCDB.SAGAhAEA.ECGAZEAAOBBHhAHAMBIBeEEAADEAXDGAhBAAVFGB.fEEA.BFGA.KGFD.hAAA......hACA...,1,3,-23,26
cBWEKdRSaPDLGNCbQIHfUTAMFegYOJVZX,eAAAOAAAZADBBADAEAFA.RAEF....aAGALBHB.GCEAhAAAbBGD.HDBBUDCAABDBMFHBhABAFFED.gGCAhAIAJHFE..XBBCKGFB.dGCADFIB.hBAA......hCAA...,1,6,-26,32
VNRGXCFZcOeMPdUAILEHYbBfDTWJaQSKg,EAAAHAAABACATAEA..aADDQAGC.KCADgAFAhAAARCCAGDFAFCHDZCCAeAHHhAFAdEECACCAIHHAhAAAbDFDDDIBSGAAXEAACFHAMEEB.LHFAhAGA.....hACA...,2,-1,4,5
XBMGgbPANaQVecEKTZSLHWIYRDJOCFfdU,aAAAeAAA.EADAZACBHAFA..IAFARCCAOCGDFAHBdEEABBBDMCIBhAAAGCEA..bFCBhABAABEBQCGBhBAAKGFA.TGFASHAAYEDFDGIB...hAHA......hAIA...,2,-17,-4,13
ANBdKZIeUcHRQaODFYECJVPgfMXSLbWTG,dAAAZAAAeACEHADARAGFQAFCDCCB.EBHFCCFD..JDAB..gCCAhABAMCIB.LDFAhAHATDDA.AEEBKFFAUFFAhACAaFHDFGAD..YGDA....hAIA......hCAA...,2,-24,-13,11
QUaOECZePRcDVWHKYbFfAMgGNdTJLSBXI,GAAAdAAALADABADAQAFAaAGD.ECDAeBHH.RCAADCEBhACAHDEAKCFDbFAAAAEAMEGBhAIATFGA...XGDDhAAAOEHDCHFD..cGFC.WAHH.hBAA......hBCA...,1,4,-26,30
OZbDdaFYLTPQCAXcSJWBNHVgfIKURMEeG,SAAABAAAHACAVAGB..fADAKCAARCEB.EAFAeDDBhAAAZBEEdDAAFDHDLEABhACATDEAQDGChAAAAAFA.XFAAcFGCNECAgFGA.hAEAMAIBbGDCDIGAaCCH..hAIA...,1,8,-6,14
HdAIVKROFGXDMSCYbZQEULeagNcJWfTPB,KAAARAAAGADAMACA.CAFA.ZADE..EAHBeAGH..aCCH..gCCAhAAAJCFB.TDGAhAIAHDABAAAA.OCHBhADADBIBbEEDLGFA.NIAB.fFCAhCAA.dGGA....hCBA...,2,-21,-9,12
EcWJKTZSgLbeOMYDHCafAVRUNGdBXFIQP,RAAAGAAAdADAFAFAQADA.EAFAJBFFZBGBLCHBeCDBMCIBhAAAHDDBaDAHAAAA..UGFAhAIAXFDA.IGGAhACAPCCB.KGCDSHDC...hADA......hAIA...,2,-23,-2,21
cXfJQEgTNZSBPeHWLKFYORaCMUdbDGIAV,XAAAQAAA.EACA..TADAZAEBBAGAHAFBLCDDhAAAFAHFRDAAaDDAMAIBdDHAGEFAhAAAACGAfDGAJFAFNEEA.eEBBhBEA.KEHBCHHA.bEED.DGDB...IHHAhCAA....hDAA...,1,7,-10,17
OZGVULAcKCPTRJdQIBgDWYHNefbFaSEMX,CAAARAAAdADABACADAFAHADB..eAHFFAFAEBHF..MBFBZCAAGCFAhAAALDDBADIB.KDHBJEEFQFFAhAAA.IGBAhABAgFBANICB.aGHB..OCCHhBGA......hCAA...,1,-18,-21,3
GYQJCgMeZNPIWFDSAcfBUdaTRLXOKHEbV,BAAAaAAALADAKACAHAEB..EAHBGBGAQCCACAGC.eCEAhAEAZCAAIEAADBBBADHAUEFAhAFAREDA.OEHF.bFCBhAIAVGEA..........hAAA......hACA...,2,-25,-2,23
VPCMKAgIbQSHTNDGLceWFYEafXRJBUZdO,..IAAAbAAA.HACATAEAGAFAeAGHFAHF.ECAAaBHDRCDBBDHAhACAdCAAOCCB.CDEAAAAAhACAQEAADEDBLEGBhAEAcFDCfFFAXFFAZGAAMFIB.hAGASHDGNEIA.hAIA...,1,8,2,6
eMEIKAVRBUZLFTQYGgSJPbaNCOHWcXdDf,RAAAZAAALADBQAEAGAFA..SAGAJCHB.aCAAOCCHhAAAHCFC.XEEChABAdDAAeCEDEFABADDBBEGDhABATGGAgFGA.PHAACAHADFDB.MIEAhACA.....hAFA...,2,-18,6,24
LKdBJXaWVOGARTECIDQcMebZUNfHSYgPF,EAAADAAAMADAZACB..UAFAHAFC..SBEDPBBA.LBHBhAAAdCEAXCGA.hAIAaDDBOCBHREFA.TEEAhBCAQGCAeFBFbGDAfGHA.hBFA......hCAA...,2,-16,-9,7
BbCXHSTLKONYZDWdEVMIPAFQGRegUfacJ,GAAARAAAeADE.UADA..aAGABAFA.XAGDHBDATCGAhAAALDDAOCCBZDGBdFDAhAAAEDEFMEGBAAIBFGFH.fEHAhABA.JHBAbDBDCHHA.NEIA.DFFB...hACA......hBAA...,2,-14,5,19
WKUBQDafXAGcFVYeCRSTLNPZEHMOdgbJI,GAAAFAAAeACHRADALAGBZADBHAFA.dCDDJCFFKDHB.BEADDCHB...hAHAaEEAACIB...VFGBhAAASEED.TGGAhAIAEGCAMFFB........hACA......hADA...,1,-17,-28,11
JKYaVQcNbGBCAOfXdDWFETHPLSgZUMIeR,XAAAdAAAFADAHAFBLADAZCAEUDFB..eAGHRECB.KCDAaAHFQDGAhAAA.bDCChABACFGDACEBDAIBEGHF..TFAAhAEASHBGMFFBIGGA.YFCBhAFA...hACA...,1,3,-25,28
DYaSXFWeJQBCHPMcVbIRAOKNEdLGgTUZf,KAAAEAAAGACAUACAZAEBDAEA....aAGDFAGD.eBEHBCHAHDFAhAAA.MAIBVDFBREBBACBBdEBAhAAALFFA.fHDBhBCAXGBAJDDFCHFB.....cFGDhAIAIHHA..hBEANIEB...,2,-27,-6,21
UdYCOIRFWTbNHQKcPGZEDMaBSVAfegLJX,eAAALAAAUAEAdAEA.OAGBRAGBFBCD...TCAAHDEAQEBAhAAAKBHBGCCAEDHBaDHDBFGDhABAAAHA..fEFAhABAXGDACGHAbFDDNIAB...PFHB.hAIADGGB.....hBEA...,2,-12,-1,11
XAPaVWgKGMFdfIReEcHSZYNOQCTJUDBLb,aAAAVAAA..KADAGADAdAFA.RAFA.EAHBHCFCZBBA.ODAA.QEFChAAATCGADDAAbFAAhADAADDB....gEEAhADAMEIBfHGBeEHFSFDDhAIANIAB......hBAA...,2,-29,15,44
UDJZGQcaSRbPMYHgLKdOENCBXVFAfTIeW,TAAAeAAADAEA.GAGAaACA..RAEFMAHBHBCALDEB.hAAAdEBAECCBBEHAFDBHAAIBfGDEhAAAIEEAUDGBhAGAZGFE.QFGD.bGCA...hABA......hAIA...,1,-1,-16,15
gbKfZXJWAVIeSCOFTaUNMRPdGBQHEYLDc,eAAAOAAAFADDUAEARAFA.GBCAHCDCECHBLAHB..DCCB.hBAA.bEBDZEEA.XFAAhAAAABBBSDGDaFHDMIAAhABAdEEAQGGA.YHCGhBEAKGEA......hBGA...,1,-6,-12,6
MBKfHaNSJEdXOTeUYDVCLGPRIFAcWZbgQ,ZAAAQAAAMACAKAFAHACA.aAEA.SAGHEBEBdAHA.TCDAhAAAeCCBDCGBLDGBhAIARDGFAEEA.bFCABFFD..hABAfGHANIDB..OFHD..hCAA......hCBA...,2,-26,5,31
NgQUTKfFaYPMXHCdVEOIbcSAeBLWRZDJG,eAAALAAARADAZAGBGADA.QAFATCCAFDFHaBHD.MCABhABAHEAAdDFAEDHF.bGAAACCBDDDBhACA.JEHBUGGAfFAAhAFA.XFECOEEH.SHBAhAIA.BHEA.hAAA...,2,-4,7,11
KUGHIBARELdDFZVCSNJefYMcgaTXWQbPO,EAAAdAAAZABB.CADA.SACA.eAEHMAFA.aBEDTAGAhAAA.QCFDhADAOBGBGDCAHCCBACCBREEFLBHBhBAAFEFDVGAAfEHAgGGA...hCDA......hCEA...,1,5,-22,27
WMRaLFKcICXHZOSVgNPBGUJQTdbDfeEAY,MAAARAAALADBKADA.CAFA.HAFBZAGB.OAHF..SCCDhAAAVBBB..PDEBhAFAGEEAQDGDhAHAbFAAeCHHACFAaECDFGHBXFGD.....hABA......hAFA...,1,-2,-16,14
fZFRWTVIgMHPYdUQEAKJLbDOcGCSaNeXB,LAAAOAAAGADAaADD.eAFABAFAZCFBRAGF...TDBAVCAAMCFBhABAHEGBdFAA.EFDBhAFAACIBKDGDDBBBSDHBhAGA.NIBB.FEDB.gFAA.hBAAPEHD...hBDA...,2,-20,6,26
fKCdaMcLQWEgbRPZGNFTIABUDVSYHJXeO,DAAASAAAHABCeAEEKADA.dAHA..aAFAMBFBLCCA.EBGBhAAARDDBGDGAFDAB.ACCBBECDhBAAVDFB.XGCChCAACECA..cFGDgGEH...hABA......hADA...,1,-7,-28,21
WEXeDPOVfCbUTHMdRaLJYNQIZcGABKSgF,SAAAFAAAEADA.eACHOAFC.CCCA.bADDHCEA..RAFAaCGDhAAALCHB.NDAAZECAhADAAAFAKEEA.XFCChABADEGBVGCATFGA.MCIBdGHA.....hAHA......hAIA...,1,-8,-9,1
WagGOfRINQUJbcHAPSeTYLFVZKXBEDCdM,eAAATAAALAEA.ZBAEBACBEBHFdCEAaADDGAFARDFF.QDDAhAAAbFAA.HDGBhAFAAAAASEHHhAFAFAHFXFBAMHFAOCCBNIAB.cGGC..hBFA......hCAA...,1,-2,-9,7
ePGgZBTYLaNWUODCfVHMARFbdJcEKSXQI,RAAAdAAAEADESADA..QAFCeAFHGBGAZCCATCGAhAAAaAHFUCCACAHBHECAAADAFEFB.hACAbFGBKFHB..XGEAhABA..........hCAA......hCDA...,1,-7,-22,15
fUJDYBAWgMRFQOSTKeaHZXVbdLNECIGcP,MAAARAAAQADC..TADAeAFEHBFAZAFBXBBCdDDAEDGAGFDBhAAA.fGHAhABADAIBABHBFDDBKDGAaCCH.hAIAbEFCCEHA...IFAA.PFCBhAFA.UGGA...hCAA...,2,-8,1,9
CRFBGOVZTcJgfIMESePHYAXdKULWQDbNa,dAAALAAAQADADAEA..aAFERAFAGCABZBEA.JCGB..fCAAhABAEDEF.eCCBhACAHFFCAAIBKDGDbGAANIEBBEEAhCAA.TFGA.......hACA......hADA...,1,-8,-23,15
VDGOFMRNYEHWZUKAIgcPbedQaXBLfJSTC,..IAAAPAAAdAEA..aACALAGBSAEHTCCADAGAGBCAhBCAMAIBREBBEDFBHBFBhBHAZEGBABIB..bEEAeEEBhBAAQGGB.fHCB..hCAA......hCBA...,2,-14,-4,10
LXCfEWOUZYGbNMBAFVRPcDdJQSeKTaHIg,RAAADAAAdADAQACAKAFA.HAEALAHBCAHB.ECCBOBBBZCEBGEGAhAAAMCGBACHA.FDDAVFAAhABAJDHB...eHCAhAFAaFFH..XGAA.fHDBhAGA......hBAA...,1,-8,-21,13
QEPTdSGBReZOIWKYaNFJDcHbVfACXgMUL,XAAAMAAALAEA.EBBAdADA.GAFARCDAeAHHZDBA.OAHFhAAAKDCDaDGEFDHH.DDDAHFAAhAFAVFAAAEFBCFGA.gGCAhAGAQFEASFHHBGGBWHAA..hABA......hAFA...,2,-12,1,13
SMZgQJFCdfVPXWLIADGbEUOHYBTRcNaeK,GAAAEAAAHACABADARAFF.aAEDeAHH.MCCBZAFBQDCAhAAAFDDA.dBHAfDHAhAAA.XEADhAEALEEBAEGBbECDODAHTGGAKEGASGGAhACACFFD.WHCGIHAAhAFA..,2,-21,14,35
fBARgZcKCQPXeMVdSTbOJIEDaWGFYLNHU,RAAAZAAACADB.QAEA.eAHBdAFATCCAOCAB...EAHBaCCChABAGCGALDFBHECChAAABDHDAFBBKGDDMECASFGDhABAbEADDFHBFHCE.......hAIA......hBFA...,2,-22,-1,21
TRdDGEBHfPLacCYgOFWIZUSMbKeJQANXV,XAAARAAAGADAHAFALADACCCD..OCFEFAHBZCDA.MCIBeDABhAAAAAAA...TEFAhABAEEAABECAaEHD..cFEChADAgEEB.IGCASFADbEGDKHDAhAEANIAB.DIGA...hAFA...,2,-9,-7,2
SRVDbTHUALOGdgWECZaXKYeJfMBIQPNcF,GAAAdAAAEADAZABBaADAKAGA..eAFA.MBIBQCDA.hAGAPCFCFCEARDCAbCGDHDBBhAAALGEAOEFCCGAA.hBAAXGGA.fHEBBFFD.NIAB.hACA......hAGA...,2,-10,-9,1
WSUaAZKITEBeCcRYQdfXbNGDOVgMFLJPH,ZAAATAAAEADEBAFB..eACERAGF.dAFA.XBGDGCAAOCCEhABAMBDBLECAhAAAHDECSDHHAAHACEGAQGEAhBIAbFCADFCAFGHB........hCAA......hCCA...,1,-9,-11,2
fNELYXMdGQDFgCHPUZceabKOBWSAJITVR,TAAARAAAEADE..LAFBMACAGAEBFAHBHCCBZCCAeCGFKCHBBEFAhAAAAAHAJDBF...fDHAhAAAXEGDdFCDQGGAhBDACHHA.cEEC.aFCD...hABA......hCAA...,1,5,-22,27
HRTgZLbUBNMEaWFXfeIJcKPCYADVSdGQO,SAAAGAAAHADARACFZAEBLAGB.bCEDBAGA.EBHFaCDHXCFDhAAAeCHH.JEAAKFAAhAAA.CFHAAAIBdFFATGCAhACANDIA.FGEA.IHHA.....hABA......hAEA...,2,-28,15,43
RfcgOUFNeXLKVBDTEHQMGdZaAPWCbJYIS,CAAAJAAA..SACARADF....fAFBOAEDFAGAeAHHhADALCAABCCDECFBhAHAHCFBGEEAaCHFADEBbFFAhAAAIEHAUGBAKHDCTGCA.dGHAPHFChACA......hADA...,1,-10,-15,5
HKVgDdcLaPEUOAGYJQRTSfMNIeCbBFWZX,GAAAQAAARADA.SACAMAHB.eAEHbCDA.FAGAZDCAHBFBhAAAKDHBDAIBdCHAaCDH.EDAAhADAAAABTFCA.IFGAhACABEFDXFGAgGABPHFC.hADA......hAEA...,2,-17,8,25
LGgfWRJYOdbHeQCFPTEacMNXAZIDUKSBV,ZAAADAAAKACABADBGAEA..fAFARAGB.OAGDHCCBeDGBhAEAQCAAFBBHEFFBhAGAaCDDMDIBAAIB.IHHAhAIASCHH.LDFB.gFAAhABA.YFEFhACA.,2,-35,-12,23
gACdaJKEPeTQIGLWcXVSYMRbNOBDUHfFZ,aAAAEAAA..eACAQADAGAFALAHB.XCCAhAAASAFARDABODEDDAIBHCCAhADAZEGBACCAdCGAKHBATEEAhAGAWFHH.cEGD.MBBB.bGDC.BHHAhBAA.....hADA...,1,2,-2,4
YaIFRSEXUcfPJNDAVHZCdbgOQeTMKLBWG,HAAAdAAAOADAeACEMAFALAHBGBEB.aCCBRBDBEBFA.UDBAhACAfDDA.PDGDhAAADDGBAEFBZEGBCFDAbFED.hBAAQGGBBHCAWFHHFHBA.....hBCA......hBDA...,1,20,-24,44
QHYSLWKRDBMCENfZbeOTFPaUIdJcGAXVg,XAAAQAAAHADALADARAGF.MAHBECDBZDAAeCBAFCFHaCEDdEHAhAAAGDFAAAFA.gEAAhAAASFFBDAIBCHFDNIABhABAbGCA...........hADA......hAIA...,2,-11,3,14
IWXTQgaVPfeALEFOGbJMRYHDcdKBNZUCS,EAAAGAAA.MADAHACAdAHABAFBZBFBCCDASAGH.XCCAhAAATEBAQEGAhAAA.aEEHfCFEhAEAADHAFGGH.bDGD.RFEBDAIB....hCAA......hCBA...,2,-26,-13,13
DMCWALSbIFUYcGXBNTfEOdagKPRHJeZVQ,LAAASAAAFAEAUADAGAGABAFA..TBDAEAHB.aCAAKCCDhAAAHDDCeCFFZFGBQDGAhABAMGDAAAIB.bEDD.hABA....IGGA...YDBFhAIA.NIEB..hACA...,2,-15,-13,2
BdWSEfVYePTFgaDIbZAMUNLOGcQJHXKRC,MAAALAAAGACBQAEAHAGBRCCBdDGDEAGA...VFAAeBHFFEFHhAFAaCAADBBBZDCB.ADIBOEABhABAXFDDBEEAfGHAhAGATFGAgGDA...hAIA......hBAA...,2,-4,-2,2
XcDbLOSHTYWVgfeZEBJQMKAUNGaFRdPIC,GAAARAAAdADA.CADADAFALAFA.HCDCTBFAVDGB..eBHHhAAAEEEBBCHBMCDBACEBaCCHFEEAhACA....XGAAhAAAbFBAODAHSGGAgFGA.fHBBhADA..hAIA...,2,-22,-8,14
EgHVQCTSDYNOceZFfdUWPMARbXaLJBKGI,RAAAaAAALADBBADAGAEAEAFA..HBFCQAGATDEADCCBOBBBhADAeDHFZDCB.dDHAPFAAhAAAADCB..bEFDKGDAhABA.gGFBSEEDNIAB.fGAAhAGAMFIB.....hAFA...,1,3,-6,9
cFTdUbEWgSVNMCKGQfRBZIPYaeODLXAHJ,HAAAFAAAdADAEADE.SAFBMAFAGBEARBGFZCAA....IBGAhBAAaCCAeCEHLDBBhBDAAAHATFFAUEGA.bGFChBIAWEHH..NDDACCHAfGEE..hAAA......hACA...,2,-12,-10,2
SFXbLUOTAHEDdQZRYVGfBePJcCWMgINKa,HAAAEAAAdADARADFGAFABAFA.eAHB.JCAFCAHAMBCB..gDDAhAAAKCFAFDDBLCHBhAAATEGA.ADBBZEFB..hAFAfFAE.cFFCIFEAaHDA.hACASFCD.hADA...,1,-7,-31,24
CaNHWFVEYdSOUQPgeGTBLXRbJIZKDAfcM,MAAAaAAAHACBFADD.EAEAdAFA..UBGAQCBCeBBDGDEALAHBhBAAREAB.IDEAhBBAZEGBAAHACEDC.VEFASGCAhAEAOFBATGDA.BGHA....hBCA......hBFA...,2,-11,4,15
UgLQNTSBeCHKXZRDEdcPOaGbJWIFAMfYV,MAAAVAAA.LAEA.QBBATAEAeAGHHCEAZCDFEDHFdDAAhAAAOECBGDGAbEFDIGAAhADAAAFA.fFDEhAEAgGCHSGEHCBHA...hAIA......hBAA...,2,-8,-3,5
aAWQZRBLVCNJcYXMGHgUESKfbOFITeDdP,ZAAARAAALADBCADB..JAFAXAFAHBEAUCAAECFB...KCHBbDCChAAA..FDDB..eBHHhABAdEFAAEHBQFAChAFABFHA.cEGDMIAA.GGCBSGDBhABAIHHA.DIAA..hAGA...,2,-29,-1,28
MOUEJPIXLWGZbYDHNSedFABCVRKgafQTc,CAAARAAAKADC..aACAQAFA..MAFAECCA.IBCAhAAALBHBZBEBDCFBHBGBeDEDhAAAABIBBCDAVGFA.TEFAhCAA.OEHD.PGCAXGDD.hCBA......hCGA...,2,-24,-16,8
DGbcAdRUTCSBKHYVgaXPIWELMQfJOeFNZ,RAAATAAABADBHAEB..VADAaAGA...XAGBICCAECABhAAAMBHBQCCChACA.OBHDeDEBZGBAhAAAbCFDADFBdEGDSEEDKGGA.gGGAhADA.....hABA...,2,-19,8,27
IJRYdOcBaEMeCfWLAXPZSTHbDGFgVKUNQ,ZAAAHAAAGAEAFADAKAGAQAGARCAA.dCAABCEAECCB.eCFHCADBLDGBhABAACHA.SEDHhACAbDGDDDIB.gGAAhAGAUECA.IHHAOGACaGFCMDIB.hAAAXGED..hBIA...,1,-5,-15,10
IgLAQMbedTDaGFWfYVUJNBCRPXOHKZSEc,MAAAeAAAdAEADAEAGAGAFAGA....fBCAUBBABBEARBFF.hAAAODCEHDDBZDGBEEBB.hAIAIEBAADFA.bGFAhABAaDHD.VFFB.CGBD.......hBAA......hBEA...,2,-26,-6,20
PYeRXWZNVGIUOHMfaJKgELdASbDQcFBCT,DAAAQAAABACA.CACA...TAEAeADHRAFAZAGBGCEAUCCAHEAAhAEAaCGEKEDDLEFAhAGA.ABBB.bEGDFFDDXFAAhAAA..NIBBIGGAMIAA...hAFA......hAGA...,2,-19,-10,9
HMCRDSIagVJKZdGfcNbPTYFUeAOLQWBEX,LAAAQAAAEAEAHACARAGB.SAEE.aAGDgCAAhABAKCDAGDEBfCEAhACAbFCA.TDFAhAEAFGGAAAIBBCHAMDDBDDIB.IGGA.ZGCAhAIA......hBIA...,2,-10,-2,8
aUdgTOcIJeCDQREXYVBNbPSHAGKLZFfWM,GAAAZAAAFADA.MADAdAGA.OAFE..ICAAeCDAQCGAhAAAECCB.XDBDhACABCEA.bEEBHDFAAFIBfGGAhAIAaBHDTFGA.CECDRGBA...YFFFhABA....hACA...,1,4,-24,28
GbdVACWEKXgacBTDSUeZMRfJLNOPFQHIY,EAAAXAAA..aACDBADADAEA.eAEHRAFALCBAOAGBQDAAhAAAHCEBGDGAdAHAACHAKEBAhAAATDCAZGDAMIAAhAIAfDGA.PEHD.FFDD.bFED.hBCACGGD......hBEA...,2,-7,3,10
KENWLYXDFfAbcOgUJZdMCHVRTIQPSeBaG,OAAAUAAAdADAHADARAFA.QAGC.eBBBGCDBECFBLDDBhAFADCIBAAFA.bFEDgDBBhAIAMCIB.CEED.hBAATGGA..SEGBBHDC.aFGHhBCA.KHCA...WFHHhBDA..,1,-1,-26,25
ZYbBUEJRLFAWdcDONIeaMPVQHKGTSfCXg,dAAAOAAAeADA.MAHBQADA.HAFAGCABTCCACBFAZDEBhACABBBDEDHFREABAAHADCHBaECE.hADAKDFB.XFDAhBAA.gGGAbGEA......hCAA......hCIA...,1,-6,-19,13
JTOGUVNRCMDFBcAfZdbPKIeQHaXLgWYSE,dAAAKAAAeACEHADAaAFALAFB....gBGASAHBhAAAECBATBCAGCEAVDGBhBHAREGBMDABBDEDADDA.bFCAhCAA...QGGB.YHCAhCBA.....hACA...,2,-16,4,20
cTbeWJXLEBMDGNAHdgQZRfaCPKUVIYFSO,HAAAdAAAZABBRADFCAFBKADA..UCAB..IAGASAGH.OBHDhAAATCEA.eAHHhAFAXDDALECBEDGBMFCBhACAGEEB.ADIBfGHAaFGC..hBAA......hCDA...,1,-13,-26,13
HdNJRabFcgVYADSKBPZCXMEWLITeQOGUf,KAAAZAAAMACAEACE.LAGBeAEEGBDBHBDBdEFARDDB.FDHD..gCGAhAAAAAIBBBFAXFBAhABATFGA..OCCBhAHAfGHAaGFH........hBFA......hCAA...,1,-5,-23,18
JdNDSQGWcBUORHEagbYLeXAVfCMFTKZPI,CAAAMAAAKACA.ZABE...JAFAdAEA.SAGAGBDBBCCDRCAAHCEChAAAECHF...aCHD..hACAbDFDeEEB.AAGAFGGAhCAATEDA..IHCADEIBWHFAOHFChCBA......hCDA...,1,-18,-24,6
QKOfdSeUbaWTRXAGMcHICPgJYFBZDLVNE,GAAAHAAACADB.JADABAFAZAGB.LAHB.EBGFQCDAhAAA.fDCEhACAeCAAaCEBRDEFABIBMDIBIEHAhAAAgEFADDDBKFAAdGGAbFDD....TGAAhAGA.....hACA...,1,-3,-15,12
ZUCfBWTLNHAKQXEaeORDSGVIbJgcFYdPM,QAAAEAAA.eACARACAGAFA.bCCCgAFA.hAAAFBHDdBHAZCDAfDAAhADATDAAHECAAAHAaECDSEGAhAAAIEEAcEGBMHEABGAA.NIAB.hADAOFADDGGA.YFHBhAFA.,1,12,-19,31
PHVBRYfeSTcKWaCEJGFLZMDXdAUIQONgb,QAAAOAAA....bADAHACARBGF.eAEESBBDhAEATCDAKBHBaCCA.ECFEGCEAhAFAZEFAMGEAdFHAAAHAIHAAhAAAgGFFBHEAYDDF...hAHA......hAIA...,2,-8,-2,6
QSdXCHNLbeOJcgWVGTPYMRZfUABaFEDKI,aAAAEAAAKACA..QADAdAEAHAGBLCCBeAFAOBBB.JBHBhADAgDGAGDCATFEAhAGAMEEBRGAA.ZFFAACGBDEEAhBAA.SEHHCHHD.....hAAA......hAGA...,1,-5,-12,7
TQFdZcSNEYfIDbeGHLBaAOCgMVUKWPRJX,CAAAMAAAKACA.RACA....JAFATAFA.dAHAZCCA.SCEEhAIAECAA..fCDAhAAAbCGDHGEABEEDAAEAOCEDhACA.UDGA.XGEA...hBAA......hBBA...,1,-24,-29,5
HOTAIEaLbXYRSFfVeMPgWJKGBcDNUZQdC,EAAAaAAALADA..bACARAGFFBBH..eAGBMCEB..gCCAhAAAKCFDGEAADAIBhADAZEGBdDFAODCDACCAXEAChAEAfFFAPDHD.BEECNICB.QGCAhAHA.TGGAhCAA..,1,4,-16,20
IFBUKAYTaJWGOEHCSLDdZPXQMVcNRgbef,aAAAGAAAHACBLADAZAEA.QBGAMAFAVCEARCDAeDCB.hBAAFEAHKDHBAAAB.TFFAhBBAOEFASHFAhBIAdFFAPHAANEEA...fHGF...hCAA......hCBA...,2,-10,4,14
cGaDENRJOFHZMYTPfCSKdWXgLAUbIQeVB,UAAAQAAAeADABAGAaACE..DAFARCBAFBHDHBDC.ZBGB.MCIBhAAATDEACDAA..dDDAXEAChADAAFFA.VEGBhAEAEFGFOGBA..fFCA.hADAKGDA.....hAIA...,2,-17,-16,1
TfUNAOgbCXaEHKWVdZDecIMSBJRPFYGQL,OAAACAAA..EACAHADAKAEA.dAGAZAGBeBBB.MAIBBCAARDCFFDHHhAFAGCCALEFBUEFAABIBhAAAXGDD.aHGEhBAADDIB.SFCD.PHFA.hCAA......hCDA...,1,-5,-34,29
MAEXadWPIFCbOgKceUNHYQJBZGLTRSfVD,EAAAdAAA....IADAbACA..KAGAeAEHHCCAQAGAhACAZCFBGDAARCBB.SCHHhAAADCGBADFBaDGD.FFEHOEEBhAGAgGGAUGGANIBBBHDD.....hBAA......hBCA...,1,1,-16,17
cWDePJTaSNMAHgOdRFXVKIfCUbBYELZGQ,HAAAdAAARADAFAGAKADCCAFA.BAHALCCA.GCFAQCAB.hACADCEAeCHB.TDAAhADAaCFEMCIBAEEB.XDCAhAAAfFHEUFFA.EHAAWFFDSGEDhACA.....hAEA...,1,-14,-24,10
GEPIQSVUeTOXAJKRcYCZFfWDgHadBLNMb,RAAACAAAZACAFADA..DAGAHAGB.dCCALBGB.MBIBEDAAQDFChAAAUCCA.eDHHhADATFCAAAFAKEDB.fGBAhAEAaCFBBFFA.........hAAA......hABA...,2,-38,-16,22
NZKObTRBCdcIaeDgHSWJMVLQEXYAUfPFG,UAAAFAAAZACBOADARAEA.BAGAdAHA....aCECeAHHHDFCSBDBhBAAMEEB.LCFBhBCAEFAAAFFA.GDCAhCDAKFHBCGCADGGBgEGH......hDAA......hDBA...,2,-24,-23,1
bHfXANPOVEJCBMaKLGSQWedITcgFDYUZR,OAAAEAAABACAKADAGADA..QAFCeAFAdCGA.TCCAhAHAFCCHDBIBZCFEHFAAAAIBPECBhBAACDFCMEIB..aEECLFFBhAAASEGBWFHDgGGA.hAFAYHCG..hBBA...,2,-22,-5,17
UePAbFNQKdLBHDMYCVGafXSERJOTWgcIZ,FAAAQAAAdADAHAFAMADACCCD.GAGA.aBDASCEHhAFA.RCGBODBBTCDAgEFBhAAAZEDAeFHFAAHAKGEAhBAALGBADICA.fDCE.EGHFhAIA.WFFD...hBDA...,2,-15,3,18
aeMAVSNDKZfTdOGIgPYRCFcWbEQBULXHJ,SAAAKAAAZACBdAFAGBGA..gACHRCAB.FAFAbDEDhAAAEBEF.BBHALEDDhACAHCFAeDDBAAHADEIBOFBDhBEAIEHA.CFFA...cGFD..hBFA......hBIA...,2,-21,-15,6
KUQdObaegBEDXFNRPHMfCIcAYLGSWZTJV,GAAAZAAAJADA.KADA.dAFAOAGD..eAHBECAA.FCDB.RCGBHEEBhAAAMAIB.CFDC.ACEALDDAhABASDAD..TEGAhACA.QFDAaGHBDIAA.XGAAhAGA.fGGEhCAA..,2,-21,-13,8
AMIfDbWZHNPJgESadTGKYCLBQORFUVecX,MAAADAAAZABEHACC.JAFAEAFA.dBHAGCCAKCCA.LCFABCEBRDAB.hADAFBBH.eEFAACGA.bFEChAIA....PDFDhAFAaFHDCGCD...OEEH.....hBAA......hCAA...,1,-4,-40,36
WBOcHQVSKGEUXFNCeTdIADPZaMYJRbfLg,ZAAAaAAA.MACARACF.LAGBBAEBHAFB.QDECKBEAECCBFDFHeAHBhAIAdEBA.ABBB.DAIBPDHBhBAA..bEDDfECAhCAAOFGD.SFGD...hABA......hBEA...,2,-24,-8,16
PEfBHMGOCJZFLVAdDRWcUSIeYKbNaQTgX,RAAAUAAAeADEKADA..aAGAQAFC..TBDA.XBGDhAAAEBHFHCBCGDDBhABACDADZDFALFFBhADAACCBdFGADEIBSGCAIGDAYFHFNICB.fHABhAHA.MECBhAIA..,2,-16,-5,11
LRKHdYJUIbPaGSgMOECcNWTeXfQAVBDZF,DAAAZAAARAEAHABCdAHA.UAEA....bCABGBGA.MCCBECDFCCFAhABA..NDDA..eEEBhAHAQDGAAAIBFGBBKGGAIEEAhACA.aEAHSGEDOFGB..hBAA......hBGA...,2,-19,-18,1
JgNTLKYGXBIEOfHDZUQMaFWcVbSPRAeCd,eAAAdAAAJADA..TADALAGBGAFABBDDEAHBHCACZCCAMDHBhAAAFDEB....VEGBhACAbFAARFFBAAIB.CEED..NDIA.XFCChBAA.OFFHDFAA.....hABA......hAFA...,1,-1,-21,20
ALGOPJfBcIYDaQRMVZSWgHbTdEKXUFNeC,GAAAOAAA.JADABADA....IAHAaAEDRAGBZCCA..SCDAhAAAHDFBdEHAEGAAhAGAXCFDFGCD.eCHBhACAAAIB.LECB.fEEEDBBBMEEB.hBAAgGAD.hCAAbGFA..,1,-13,-19,6
CMgZBIPeaHTfRASUFYcNGVDLdOXJbEKWQ,FAAA..NAAAGAFALADAdBBAXAGD.ECCAQDCAhABA.MAIBZCFABDEDhAEAeDGHHEABREFAAAIBSFAAhAFAcFDDOFHDbGEA.CHAD.....hACA......hADA...,2,-17,-8,9
DTGMeYaKQNSgdCZAROPfJXHcWIbBUFLVE,RAAAOAAA..fADBHADA..IAHABAFBLAHBhAAAEBBBGCEAeBGFaCGAQCCAhABASDCHdEFDhCAAAAFAXDGDbFCBFFHDDGGBMIEA.KGDACCEA..hBAA......hCAA...,1,-3,-16,13
NSbgfYJZREIeaLFUCdATPcXWDMQGVKBOH,TAAAXAAA.DADAGACA.BAEAHAECSAFH.hAAA.bBCDfAHAhAAAZCFAEEFAeFEBaCACLDFAhACACAHBACHA.cEAAQGGAOEDC.gFGAhAEA.YHAAhAHA,1,2,-25,27
UYTQWcbBOGCJXdPAHKLFSREegDIafMVZN,HAAALAAARADFEAFEeADHDAIB...aAFAMCABZBEBUCAA.QCGAhABAbCEDGCGAXEDChACAACCBSFHH.hAIAfGCAVFGBYGCGcGDD.CDDD..hBIA......hCGA...,1,-1,-7,6
gLHeCUBFcfDRVQdOXEWbPaNIYGJAKSZTM,ZAAAMAAAHAEAUAEAFBHD.DACARAGB..dBBAECCB.....bCFDaDBEhAIA...IDFAhBAAGEDAAAGATEDAeFHFBCEDhABAVFGB..........hAIA......hCAA...,1,-18,-24,6
HeTUEZAXRKgMYNBPIcCfJQODVSLdabWFG,RAAAMAAABADB....IAEACAFAQBGADAGALBBBdCCA.hAAAaBDCFCFHHBFBeEDFEBHBhBAAAAHAKEGA..gDDBhBIA.PEGDfFAA.OFFBhABASGHH.hAFA...,2,-36,-11,25
BTPCaQfWJNRDgVOAIZMSEYbGLeUdXKHcF,ZAAAEAAAGACAeACEdAFAHAEABAHACAHB..aCBHQCCB.JCGBhABARCFADEAB.OEDChAAAACIBMDFBbEGDLFHBhAHA.KGGDTGAA.fGCBNEEA.hCAA......hCBA...,2,-20,2,22
FdQXeMOPYaUcfADNgKSECWRTJHGVILZbB,DAAAKAAAEACERABAHAEB.GBGALAEBZDCAFEABdAGAeBHH.MCCBhAAAOEFD..aDDCfFHAhAEAADGB.SAHBhAGATFFAIGBAbGBA.BEHA.hBAA......hBGA...,1,-12,-23,11
FRGJeUKPVIbaXcHEMZDOgNTfYQALSWdBC,LAAAdAAAFADARAFF.eADH.KAFA..ICCAaAHDHCAB.ECFBZCGBhACADDEBOCEB..hAHATEGAQFEDhAIAACABBDHBCDBDJFHBPFAB.bFEDMIBA..fGCAhABA.SGGAhACA,1,2,-31,33
POgMSJHNTbXLWeFZKECAaIUfVcRGBYDQd,aAAAUAAA...VADARACFGAEA.DAGAdAGAOBBHMAIBHCBChADA..bBGBLDFBhBAAeDEDZEAAEDHBACIBIFHAhAEABEEAPFHB..SGDH.hBCATGFA...hDAA...,1,-4,-17,13
cAbOQZeDWdERSMFVaUXJHNTBGCYPgLfKI,QAAAeAAAdAEARAGB.MADAFBCD...aAFEUDEAHBDABDHAGCGAhAAA.CDBA...gEBAhAAALDFDKDDDAAIBZFGBhABAEGHF....XGACNIAB.TGEAhAGA.....hAIA...,1,-9,-17,8
faQgVLJCPRdGbKIecDZHUXSANYWFTMEOB,...NAAA.FAAA.EADABAFAQAFALAHBCAHA.RBBAGCEA.hADAKEAAeCCAZEGBHGCAhABASCGAABBA.TDEAhBAAMFIBaDDBgEGA.PHEA.hACA......hADA...,2,-17,-13,4
JEXKAdQBORFCHZIbfDYVeSgNWcGaMTLPU,dAAAQAAARADAHAGBZABB..bACADCFBeAGB..SDCAhAEA..gCDBhAAAcDGC.aAHFMFFBhAGATDAAUGGAEDGBAAIB.FFFB.fGCAhADA.YEHB.hBAANIDB...,2,-22,7,29
WZYCdUSFGIHJbLNTaPgDBEKfRMAVeQXcO,eAAAQAAAOADCZACBdAGAFAEDHCCALAGBaBHD.DAIBKDFARDEBABGB.hAAA.XECA.hAAA.cEGACEHASFABhABAIGGAbFFCPEDBBHHAMIAA..hAFA......hAIA...,1,-5,-17,12
gYISFLPfQDUbHGeMARKcETCBZVXNaWOJd,RAAAEAAABADBZACB....XAEAaAED.OAHBdAGA..gCCBhAAASCBDLDFAhABAQDEADAIBHFFAhBGAeCHHAEDBTGDACFAAVGEA.JFCFIHHAhCAA......hDAA...,2,-23,-5,18
LBdWQZONPHDYEAfCceMFTRUKabSXJIVgG,CAAAeAAAFACA.RADA..KAGC..aAED..XBGAJAGB...ICCAhAAAGCBAdDDAZDEAOEAAhABAHDGBEFEFADFAMEIBhAEAbGAA...SFCAgGGALFFBhCAA.BHDANAIA.hAAA...,2,-24,-8,16
YBecGIbgXWEVUaZCTLKMRDPQJdANFSfOH,SAAAHAAAeACEGAFA..bACDXCCAEAEA.aAHFZAGBhAAATEGAMBIBRDEBQFAAhAAAABGBFEAAOECDBDHBhAFAgEGBUFDAKGGD.DGGB.....hBHA......hCAA...,2,-6,5,11
HKfLIMPGAdQNYbcgXOSTBDEFaUCJVWZRe,dAAAQAAA..bABDXACA.TAFAEADAaAFDCAHB.VCGBhADARCDAHCGBLDEBhAHAMDABACIB..NECAgGFAhAIABDCDFEFHWFAH.eFHF....hAAA......hADA...,2,-10,-5,5
MWUYIAgOeVCTcFRJGfZaDEKHSXPBbQdLN,eAAATAAARADAGAGA.ZCCAEACEHDFBXAEBBEAAdFCALAHBhAAAMDIBUGAAABGAOCCBhCAACGHD.FDEA.aECDSEEDhAAAbEEAQGGB.YGCG.hABA......hAEA...,2,-4,8,12
fUGOFDLZWBAdEcPMYbJQRgCNSXTIKVaeH,EAAAMAAA..JACBRACACAFB....XAEATBGA.KAHB.eCEBhAAAHCCCGCGADBBBZDFEAAEAdFCAhAHAPFCBQGFChCAASFGAaGDDfDDEFGFHBAHB...hBAA......hCAA...,1,-3,-21,18
ZTJCdMQfVegYISBUAXcOGDWKNRaLbPHEF,OAAAGAAAKADARADALAGBHAFBEAHB.ZCDFCBBD.dDFD..MAIBQFAAhAAAeCDA.gEGAhACASDCDADABDDDBhADAaEABFEEA.JEHBfGHAIHEA...hAEA......hBAA...,2,-24,3,27
MIDZKVCbXHQJOBSARagFLUPeTfEYNdWGc,RAAAaAAALADB.eAFAEADAdAGAGCEAMAIBZCGBKBBD..bFAAHBEBhADA.QDCChBAABCCCAAAAFFHDTDGA.hAFAfFFANIBB.IGBADGGB.CGHA.hBGA......hCAA...,1,-7,-15,8
AMeEFPSTYgfaBJLRGXKNOHDZUcIbdCQVW,EAAASAAA..TACA..fADAaAEALAHBhAAARAEFGAGAKBEAHDDAZDAAIEEAhAAAdEHAQFDBhBHAAAIBeDGDFGFDgGAABCCD.XGGAhABA.DDIB...hCAA...,2,-9,0,9
IASDcJUdCWNLFYKHabRfeTQEPVgOBMGXZ,DAAAUAAAdADACADA.LAFA.KBBBHAEB.RAGBeCDBECEA.VDAAhADABCGA.GDBBZDFEAAIB.hAGASCHH.hBAAJEFBFFGA.bGDATGAA...PHFChAGA.....hBCA...,2,-21,-12,9
RWQYdVNeCHOKagMTPLJUSFfEADbGXZIcB,GAAAZAAABADBRADAQAGCdAFA.eCDBHBGB.aAHFMCFBTCAAhABALDGB.SDADhAAAECEBADDBDEEBXFBAhACAIGEA...cFFA.YHFAhBFACGHA...KEHBhCAA...,1,-8,-23,15
ZFMRaDNYTScfECXUdVPWbGBLOAHQKIeJg,HAAAQAAAeACEZAFBRACADAFA..TCCASAGAEAHFUECBdCEA.hAAAVDGB..bCFDLFABhAAAACHAKDAA.gGGAhAFAaDDB.YFEBCDHAXFGA.PHDAhADA.BHHD.hCAA...,1,6,-10,16
XaJYBVTgAUIOSREcWLeCbdKGfQNMDPFHZ,OAAAEAAALADA.eAGHdAEAGAGA.QBBBhAGAMAIBFBCHHCEBaDDABEBATEAAhAAAAAIBSDFHhBAARDGFCECBfGGEDDIBZGBA.XFGD...hAEA......hAFA...,2,-11,-10,1
bTdOVWIAMYCLXRSgZUPcJGaNDBFfeHEKQ,MAAALAAARACA.ZADBUAFAJAFB.GCCB.DAIBFAHB.HCABEDGA.hBAAQDFAdFEA.hBBAOCHDIGGAACABXFFChABASEGA.PHBCaGHDBCCC.hBHA......hCAA...,2,-22,-11,11
DCZPGEeQHWBJIUgcTVSXbRMAafdNYFKLO,dAAAFAAALADACADAGAEA.EAHBHAGD.BCBAUCCA..TDCAhACAXCFAREFAACIB..aDAHfEAAhAEA.KEFAhAFAZGAAeEHHQGECIFCA...gFEGhAIASHGAMIDAhBAA..,2,-12,-10,2
BZaeQHAbNOWUGVSLXgdIPfMERDFJKCcYT,OAAAGAAALADAdAEA..IAGAMAHBRCDAFDCHCBBD.TEFAhAAAaAHDHCEC.ABDA.bFAChACAUEFB..XGCAhAEAfDCAEFHFDAIBKGGD......hAFA......hBAA...,2,-26,-5,21
CPafebMGdKFWUgZBHSIRJVDQYTNLAXcOE,OAAAEAAA..aACDeADAGAEAdAHAFBBHUBGAZBFBHDDB.REABDAGAhAAATDCAAAEB..CCBD.bDGDhAEAMEHB..KFCDBGEAhBCASFDH.IHHA..hBAA......hCAA...,2,-23,-13,10
TZeCQKWUDNRHbYEBIGPLFJVdaOMgcXSfA,eAAAQAAAKADADAFAHACA.EAFEGBEBLAHBFCCBdDEAaCDDMCFBhAAA..XDGAhAAAACGAZEAACEGAUGEARFGBBAHAIGHAhAEAPHDA.........hABA......hCAA...,2,-23,5,28
OBKREeIdYLVXAPNCQHJZGSTcMWaDbfgFU,CAAAHAAAGACATAEA.MAHBaAEA..DAHB..bCAAFBFHBCEDECAB.hAAAeCFHdDHALEEBhACAAACAQEAASEBHhAIAfDHAOEGHRGFA.IHHAXGACNIBB.hBCA......hBEA...,2,-17,9,26
FbNZPdfCOQMDeUVTEKBXcJgHaLAIWRSYG,RAAAGAAAFADAZAFBdADA.OAFADAIB..UCCAEBFBBBHA.JDDAHCGBhAAA.AEFB..SFCAhABAbDBD..fDHAhAAAMFGB.eFFBKFHB.....hBHA......hCAA...,2,-32,-20,12
LOadcNBeDZYVGJXFbSIREKMfTQUAPWHCg,HAAALAAAdADABAFAeADHZAEBGAGAFAGD.SCAAECAA.MCFBhAAATDFAAAIB.CCHAaEEHhABADDDBVFAA.XEFDhACAIFHA.fGGEQGDD..hAFA......hCAA...,1,-10,-18,8
JaWPYdQOLRfDICHeZVEKbUBXTScgGNAFM,MAAAaAAA.....PADCdADALAFARAGF.DBBBHBBAeCCBhAGAECEFKCEABDFASCGBhAHAGEGAACIBFEEAYDDFhAGAQFGAOFFH......hAIA......hBAA...,1,-14,-24,10
AWZeBVNRUMCHcaPDTLFbQJfKEdgOIYGXS,eAAABAAARACAMAEAHAFB..aAGETCAA.LAHBbBAA.QDDAhAAAKBEAECGAdDEAOECBhACAGEBAAEGAZFAFUEGAhAAACEHADFGBfGFE.IHHASHGAhADA.....hABA...,2,-8,2,10
bMWOZFNeXYLaRKBDIECUPAGgfVHSQTJcd,GAAAVAAA.HADAQADCTBGAdCDDMAFAZDFE.eDADLBGBhAAARFGBDAGA.ECEACGDAAAABSDDDhBIA.bEEDFGFHhACAXEGA.aGDB.BGGB...hADA......hAFA...,2,-3,1,4
MeVACaNcIYTPOFXDWLHJfSZgQbGUKEBdR,aAAA..IAAA..TADAFACADAFAHAFBSAGAhBCAZCCAbDACGDGAEBEFBCCARFAAeAHBhADAACGACCHA..NDFA.PEEBhAFA..XDGC.JHFE..hCAA......hCBA...,1,11,-40,51
PeGXMBHUWgLaTFORbJANdZSCYfKcVDEQI,ZAAACAAAKACADACA...EAEAQAEC.eAGHGAGABCAAHCCChABAUDCALEFAhAIA.aFCATDGARGBAAGBAdGGAhBGAfEEB.IGAA.MAIBhAAA.FFHD...hBIA...,1,-13,-23,10
KdPHCLgXMUTYbAIFNRVSBQafOZceEDJWG,FAAARAAABADBQADA..aAEDZAFBEAGADAIBGCCAdCCAHCGBLCGBhAAAMDABUFBA.hABA.bFDDAEEA..IFFAhADASFFDOFHDeGAE.KGGCCHGD...hBAA......hBFA...,2,-13,-10,3
aRDfXYGbeCSVLMNZQETOAcPdIWKBgFHJU,dAAAKAAAFACAHADA.aAFARAEF..DAGA..XBGAGBGA..eCCBhAAASCAALEEBZDAEhACAEGCAACFBIDGAhADA.BEDAgGFHfEHA.bFEDMEIBhBIAQGGB.hCAA...,1,-4,-25,21
fBEKbaMWQVJgNFLCXGHcUDAPeZRIdSOTY,eAAARAAAdADA.OADC..TAFABAGBEBHFaAHD...MCCAQCEDhAAAVDDA.gDGHhABALEHBGFABhAAAHFAADCCBAFAAZGDESDDD.KFEA.JFHBhAFACFGB......hAHA...,1,-5,-7,2
DbWKGBeQcNJFaCOMSYUTdIPLRXEgZAHfV,HAAADAAAKACAeACE.QAFCJAEA.aAHDMAIBUCCA.dDFALCCAhAHAEDHBZFEAAGIBVDFAhBAA...GECAhBBABHAAFHFCSFFD.IHHA.hAAA......hAHA...,1,-4,-29,25
APEFZVaKRXQWBLONDbHSfYegUTdIJGcCM,EAAAZAAAaACARACA..QAFCLAFADCCBHCCC..SCFAhABAeAHHTDAAdDDAGEGAhAGAMDGBADIBFEHHXFCChAHAOFEBbFEDfHAB.....hCAA......hCBA...,1,5,-14,19
LGeQIPJDRfYAMVbdcXHUaZETBWSNFOCKg,MAAAdAAAHADAZABEBAFASAFE.OAHDKAHBGCCA.eCFBhAFAQCBA.hAHAICFADCHBRFEBACCB.bDDDhACAXGCCEDAB.NDIA.CDHDLFFB.hBAAfFHA.hCAA...,2,-25,-1,24
JHXbWPREAFYVMUIaeNQCdKgBLGODcTZSf,FAAAMAAAUADA..eACAQAFAdAGABBBDGDBADAIBZBEBSBHBhAIAHDCB.XDDAhBAAbEGBRGDA..ACDA.IDGAhBDACFFB.LFGB....hCAA......hCBA...,2,-21,-20,1
VcOZKTgGYbUQHedAMSDaPXJEIWFLRNCfB,MAAAaAAA...XACAEADAFAFDLAHB.RCCA.fAFAhAFABBBDODABZAGBTCCAhBAAGDFA.bDFA.HFDAhBBAABHBDEEBIGHACEHBKHGA.YHFA.hADA......hBAA...,1,2,-21,23
OcZdgVYRbSPTBUFIfXKGLQDJWaHEeACMN,MAAAOAAAdAEA..VADARAGB..SBBABAGBFBBH...XCEAhAGAGCEBLEEAhAIAQEBADDDBaDHDEFHFhBAAAAIBCEEA.ZGFA..YHCA...hBAA......hBBA...,2,-23,-23,0
dDHLfWECabMAYGONgcFRJUVSIBPKZQTXe,GAAAOAAA...NADA.FADD.RAFAUCFB..SAEAhAAABBBDZDDF.TBGAeDHHHFAAhAFALCEBEGFFCHHAbDFD.hAGAAAEA....YEHH.JHAA..hACA......hAHA...,2,-23,-18,5
MWVcfLRDXPYbUTJCOdAQgBaGEHeKNSFIZ,QAAAaAAAHACBeAEASACAZBFE.MAFAVDFALBFAhAAA.RCDBDDAAXEAAhAEAbDFB.TEDAODHDABBBBFHAhAFAEGBAFGHHIHBAfHEB...hAIA......hBAA...,1,4,-10,14
BUgQADPEeCaWTXGSJOdNVcIRLZYFbfKHM,EAAAeAAA.CADA.aACD....TAFAGAEAOAHDdAGBVCGBRCCAZDFBhAAAFCBHKEEDHDDB.MEABhAAABEHAQFGBhAEAACCADFAAXFCDSHBAJHEE....IHAAhABA...hBCA...,1,0,-15,15
fYCPDEaZXBQGMROcKAgSLeWJdTNHbVFIU,LAAAeAAAdAEAHAGBFAEAUCAACBCA..EDDAZAGBBDFAGCDA.RFCBKFFAhABAAAAASDHHhAGA.TEBANBIA.bFFChAIAfGHA..DGBBaHEE...hBEA......hBGA...,1,-15,-19,4
bfONCdHXGMLRPeIQESTaADFUJKWZBYVcg,FAAAKAAAZACBBADA....VAEA..bAEDOAHDdAGAHCCBGCAAhAAARDAB..eBHHEDEAaDGDhACAACCBDEFB.UEGBJECB.hAHA....cGBBfFFE.CFHAMIEAhCAAIHGA..hADA...,2,-26,-11,15
FWRLCHPBAaScZbTUJXNGVIOYMEdKgQfeD,aAAAZAAAUAEA..XACDGBGAOCABEAEA..dAHAQDDAhABAeBBDFBFDRDDBHEBBhACAADHASEABTGEANEIA.hADAIEHAKHAA.DFGBCAHBBCCDJHBA...hAEA......hBAA...,2,-18,1,19
FPZfEVSOWLJYgRQAUHeTBdcDCKbXGINMa,HAAAeAAAdAEACADBKAFAGAGA..MAIBaBCDZDEBECAB...ODHDhAAALCCA.gCFHhAAAAAGBTEBADDEBbECB.hACAXGEAFEGD..fFAA.hABASFFD.hAIAWEHH.,2,-26,-11,15
PXGFLSJfOeENUCTaBQRcdgAHZbDIMKVYW,HAAAZAAADACAMACAKAEA...VAFA....PAHBGBDALCCAhABAfCHAEDFFUECAhAGAaCCBRDFBdFCA.AEIBIGHAhAAAXFGASGFDeFFDNIAB.BDHAhAIA.....hAIA...,1,3,-25,28
LTIKPOJdBaEbDRYXZUHeCcfgNAQVMGSFW,MAAAGAAAFADDLADA.TBGAKAFAOAHDdCDAECFBRBBBZCFFHEAChAAA.eDHFCDEA.fEFEhACAADHB.SFHHhAEAIFAABEDDaHAA.DEIB...XFFChAFA...hAFA...,2,-37,4,41
AVHaSEXJbFDLgPOWYdIeZcRMUCTKGfQBN,HAAAEAAA.XADBFACDLAEAOAFCdCEAeCAARCGB.UCFAKEDDGGABhAAAQDDAAAFA.aDHDhAAASEGDDFGB.hACA.PHAAIHHA.MAIBfHDFhAHA.BHGA..hAIA...,1,-3,-16,13
BSXJUHYCNIRLdKTeObFMcEfVDZAgaGWPQ,GAAAQAAASADAUADAHAFACAGARCDALCGBdCHAeDBAFDFBEDCB.hAAADEEBAADA...aFGABEFChACAJHAA.IGAAhAGA.TGGAMHDAfGGB..hAAA......hAHA...,1,-12,-13,1
XHNcUbgQLeZDEaGOBYdICWSVPAKMFJfTR,MAAAFAAA..TADAHACCUAFA.QCCCeAFEEBFFGCCAhADABAHAdDFACCGA.SBBDhBAAACCBfDHAREGFcFEChCAAbEFDLFED.aHGEOHDC..hCIA......hDAA...,2,-11,-1,10
gZVOeGbdHRUIMaQNSfFYAEBTLWXKCPJcD,EAAATAAALADA.KAHBCACB..JAEADBCBZBEAeCEAGCCAHDCAREFA.hAAAMDHB..aAHFQEAChAAASFDHFEFDhAEAACCBBGHAXFCA.PHAA...hCAA......hDAA...,1,3,-26,29
QMAKbfSPGCdgBJLHIcReWYXDUOEaNZFTV,KAAASAAAGACAdAEBBADAHAGBRAEF.eBEH..XAGBhAAAOCABEDFFZCCFTDAAhABA.MBIBAAIBbEGDCCGDLEEBhADA.IEGA...cGGAhCAADDIBaGFB...hCBA...,1,-7,-21,14
cXWfNRaYZgPHTdDBUAILFGOVJbMKSEQCe,LAAAGAAAOADAVAEA.MAHB.EBFFeAHH...XCAAhABAfCDARDCFZEAFHDBBhAAAdEFABDHAAAIBFDGHbEEDhACAQGDDCGGB..NCIA.aGHB....hACA......hAEA...,2,-9,2,11
AdJLIPEagcHQWMVXRZDKbFONGYeCTBfSU,dAAALAAAEADA.aADDHAFA.MCCARAFAZCAAKCGAOCECGDAAeCHHhABATDDABEEA.SEGDhACAAAHAIEGA.gFDAhACAQFAAXGGAFGHDCHCA...hAFA......hAGA...,1,1,-12,13
OIYNXgfQTVLJSbHAZcFGEDBKMeRdCaUWP,ZAAAGAAAEADEBAFBeADARAGB.dCDACAHA..UCAAOCFB...IEGAhAAAXCDAQEABhACALCGBbECDHGCAhADA.AAIBDEIBKEEDaFGE.....YHAAhABAfGGA..hAEA...,2,-22,-11,11
bOHXgVcWdDNKLMAYeCUIQEPJGfZSaFTRB,eAAACAAAUACAEADA.GAFAZAEB..FAGDRCCAOAHFHDEC...XDGDhAAAVEBA.dEEAKCBDhAAAACCAQFBAhABA.fGGAaBHDbFFA.WHAGDHFAMIAAhAIA......hBCA...,1,5,-24,29
bIaMRFSXdBZENPKGWHDCLVOcQAJTeUfYg,eAAAUAAA.....fADAbADA.aAEDRBGFXCBAhADAZAFBEAHFKCCDHCEB.LEABhAEAOCHDAAAATFGAhAFAgDEGMECBSGFDdGGABHDA.NIAB..hCAA......hCBA...,2,-19,4,23
AUfbODcHeFTMKgXLBVIYSaJdECGNZWPRQ,UAAAOAAAHADAFADD.MAFAKAFA.LBHBBAHB...VCEASBBDhAFAdDAAEDCBCEEDZCEBRFGB.hADAACHADDDB..eHCAhBAATDGA...XFGA.aGDA.hBCA..NIDB....hCDA...,1,-1,-33,32
ZIfDSWHgLYBdNRCTXOJcMeVFaGPAbKEQU,EAAAZAAADACAHACALAFAdAFARBGF..CAHB.TCDAOCCB..MCCBhABAeDEBFCGAGEAA.hAGAADIBQGEBhAAAfDFASEBD.gEGAhAHABFDC.XFCD.hAEAJHEEaHGE.,1,-6,-10,4
PQAfGCgaRDFbBcYeHOJVZELKUINTdSWMX,GAAAaAAA.RADAFAGABADA.eAEHHCDCOAGBZCGBEDCBLAHBhADA.KBBDIGCAhAAAdDCAMEEAQGEAhACAAEIB.CEADDDIBbFDAYFHF...JHCAhBAA......hCAA...,1,-5,-18,13
bHEQYBcDFdWAMTfUKLZNIVGeXPaRJSOCg,MAAATAAAKADA.ZAFB..IADAGBBAeAHFaAED..RAGBOCABhAAACDEDHECBEEFABCCAFEHDhAFAAAIBLDEB.hBAAXDGASGGDbGAAQGFAhACADICA......hAGA...,1,-7,-13,6
PRSGgIACcLKZUeMbNEXWQFdYaVHOTBDfJ,LAAAZAAAeACEMAFAEAEA..QAGAdBGA.aCAAHCCCTCEAhABAfDHA.hACAREFBSFCAhABAGDCAADIBKEABbGCAXEGC.FGHB.OFFHhAEADGIB......hBIA...,1,-2,-3,1
COcgRAKWYJGFBHdUXeMfVaNSTbQDPLIEZ,KAAAJAAAGADAHACBdAEB.eAGHMAFA..aBEDSBFB.hAAAQDAALCABECHFhACAZBGBODDHREEAAAIBFFHD.hDAAXEGANIEB.bFED.DGHB....hADA......hBAA...,1,-5,-15,10
OdVKRDJQNSZcbgBECaGUeAYfITMPFWXHL,..IAAAMAAAFADDHACAdAFARBBBDAEA.QAGAZAGB..bDEChBAAECAA.GCDAABIB.hBBATCFAXEGALEHBhACAKFBASFFDBFCAaFFA.....hBIA......hCAA...,1,-7,-22,15
IXVfUbSLKgPJFZEBCWDAeTGQHNRcMaOYd,eAAAGAAAHADARADAMAHBaAFA..dCCA..XCDAUCFALDHBhAAAKDCD.PEDDZEEAEEABhAAACFFAAAIBTGCA.QGEChACAOHFA.IHHA.fGAEhADA.SCGDhAEA,2,-20,2,22
VLYKECMaRQFUNAdZbDfcHGXOSeJPIgTBW,ZAAADAAAHABCGAEASAEBeAGB..ICAATAGABCCDhAGALDDBECEB.aAHFRDFFQGCAhAIAFDHDAAEBdFFAfHGFhABAOEHDPHFCgDAA...hBAA......hCAA...,1,-3,-10,7
JHZdFXGUgDTcNWYfeORPKQVbALCaEIMBS,aAAAEAAABACAHACBdAEBGADADAHB...TAFA..NAIA...hBAAfBHARBEFQEEBhBBAAAHALDFAMDHBZGDAhCAAXFAA.gFFA.cGDChAAA.eCCB.hCBA...,2,-16,-7,9
gWGKNJCBLdPaMHSOAZTXDFVfEReUbcQIY,ZAAATAAAFADA..EAGARACFUAEA..QCAA..gBGBhAAAGCDAKBHBCAHBdDEAhACAaCFCHFFAADGBDEHBeFGDhCAAbGAA....IEHANEIA.BHHAhABA......hACA...,1,-12,-19,7
MRcTVYCXOaHAKSILbWdJFgGfeQBPUZNDE,SAAALAAAdAEAFADAGAGA.eCAAQAGABDDAZDFFEBCFhAAAREBB.TCEACEHA.aDDHhABAHFEBADHA.KGABbEGB.hABAJFFB...fGAA.UGCAhAGADGIB......hBIA...,2,-11,-9,2
LBAZEPdaYHIDNfUgOWXbKcJQSFMeTVCRG,EAAAaAAAHACBDADA.UAFAOAEE..XCGAKBCA..QCEAhAAAMBBBeDEBTCGAhAHAREAAGEGAAAIBZEEAdHBBIHHAhBCAfGEE..WDDD...hAEA......hAIA...,2,-25,-3,22
BFCaTAbHWOMgLUIfGYKJDVQXZRcdSNPEe,HAAAMAAALAEAUADAGAGAKBBA.DCABQCDARDDA.dCGASCCGhAAAEDBBBEHAaFABhAFAAAGBODHD.fFBAhACAVFDAXGADZFFFNIAB.FGHB..CGDA..hAGA......hAIA...,1,-3,-10,7
MDHefURcLaFOVgJIKbdECNWSYBTQPGAZX,ZAAAMAAAHAEAUAEARCAALAHB.aCECOAGF.VBBBIEEAhABAdDEA..EDGBCEADSEGAhACABEBDQFGBhAIAACGAeGAA.FGEA.KHGANIBB.....hBAA......hBBA...,1,-2,-26,24
SDUCYFHAKZfMBJIacTORQPXVEegdNGLbW,ZAAAMAAABADB..aACETAFARAEF..QAGC.XBBChAIAEBHFeCABdDDAGCCBhABALDGBbDFADFABhACACFEAFGHDHFCAACIB.fFFB.IHFAhAFA.OHAChAHA...,1,-11,-16,5
KBHOcZgCbLUfTJWQAdFGaSNDVRYePMXIE,GAAAaAAA.DADARACFeAEEMAGB...EBEFHCDBZCFB.CAHALCHBhAAAUGGA.TEBAQFDChAHAACDBdEGCFGHDSBBDhAIANHAB.PCHDXFDABDEA...hACA......hAHA...,2,-8,-5,3
TBOgYQIDHNRXbPZdALGESCUVfFeWJcMaK,EAAACAAAUACAFACD....eAEAJAEE...aAHDBAHA..OCDChAAAQCEAHDFCREAA.hAAAbFCAdCHALHBAhAEAGGDBSCBDfGGAMFIBKDDD..YFFChBCA...hAFA...,1,-2,-32,30
XFIURSdbTgYfOKEDALNHcQWaZCMeVJPGB,HAAAQAAAZADBeAFAJACE.GCEABAFAFAHBRCGBdCAD...bGAATCDAhAAA..fFHAhAAAECFEACIBLEFAhCAA.NDCA.aGFD..MGEA.PHEA.hACA......hADA...,1,-4,-14,10
XfbZVBaGHRWLKPEQTegYUCMdDONFcJAIS,XAAAZAAAaACA.HADARAEFLAGBKAGC..EBHFeCCBUCDBdEEAOCGHhAAAFDHDAAIB..SGCBhABAbDABBEEDPEHDhABATGFA...CGGDMFAB.DIDA...hCAA......hCBA...,1,0,-20,20
SWUcaZJMGVBCQNDLHXdgPfKOFbReIYETA,SAAAUAAAZADAGBGACADA..QAFALCDBHEABdBHAfCCAhAAAFFEDeCFDEGGAhAEAACFBaDABMAFABDEDDIBAXDFDhABA.KECA.RFABTGGA..hADA......hAFA...,2,-14,-4,10
RMbANQGaWVIELgOBJYCFXePcdHUKSZTDf,GAAAaAAA..VADAEADALAGB.BBFACAGBeAHHdCDAHEFAhAAASBBDZFBAfGHAhACARCCFACGBQEEAhADAWBHH.ODHD.FGHH......hBAA......hCAA...,1,-9,-20,11
VIMJcOSZFDHKPLNTgWGUaQebEdCXBfARY,RAAAVAAAMADA..OADAZAEEHCCA.LCFBTAGA.GEGAhAAAaBDD.eAHHECFBdDHABEEChABAADCB..JEEB.FGCBDDIBhCAAKGFA...........hCCA......hDAA...,1,-10,-20,10
FBTGWSUHdRCJYKAQDfeLNbMOEZIPacgVX,QAAAeAAALAEAMADAEBCFZAEE..aAHDVCEABCEA.GCFAhAAASAHHHECARFABCDBAKDDDhAAAAAFADDIB..bEFAOFGDhABA.IHDAgGGB.FHEA.hCAA......hCBA...,2,-7,-1,6
ZHIUNAJReXEQfDMBcaFSdVWgCGLTPYOKb,RAAAEAAAQADCDADA.BAFBaAEE..dAHAVBGBCBCA..GCDAhAAATDDAOCBB.ZCFAhBCAHFCAUFFAAAAAeEHFhAHAMFIBFGCBSFFB..WHEG..hBHA......hCAA...,1,-12,-13,1
GFNaDBScQIYKRLgXPTWOeCZHAfUJEVdMb,UAAAEAAAdADAGADA.FAFAaAFABBHA..QBFCKCFALDAAhADAXCBC.TDGAhAAAeDHFHFBAAAIBfDEEhBCAMEFBDFIBSFCAcGGC.RGFA..hAIA......hBAA...,2,-18,-10,8
DAYGeZbWLNTOPQURXMHBcEKgIJSafdCVF,eAAAZAAALADBOADCUAGARAFAHCAB.ECFBKCCA...JCFFaCHBdDHAhAAAFEEB.AAFA.GECAhABA..bFGBTGGAhAFA............hBIA......hCAA...,2,-22,-16,6
OMFDQcICdgYAefZSBHNWRXbaTUJPGVEKL,eAAAZAAAHAEARADA.aAGAUAGAGCAAKCCALDFAMCGB..QCCBhABACEAA.dCHAAAAABEEDhAEAXEEDTFCAhBIAPFHBEFGA.DACAIHHAfHDB..hCAASGFD.hDAA...,2,-23,-2,21
JOSEWPAGfLKBgdbHNXRMIUFcVCaQZeYTD,GAAALAAABADAdAEAHAGBRAEFUAGAFCAA.CDCAZDFAeCDB..DEBBSDADhAAA.EDFAhACAAAGBKEDA..bEGDMFGBhABA.IGDAaFFB.....YFHFhACA...hADA...,1,-22,-23,1
TNPKDBeXIgaSObMZGLUVdcWQEFYCARJHf,HAAATAAAKADC.eAFA..XACBaBGEOCABZAEBGAGAhAAA.LDDAdCCAQDFAhAAAEEBBCEHARFFBfGBEhAIADDIBBEDASFCD.bFFC..hACA......hAGA...,2,-15,-2,13
LYOWfUXTDEeJGVHSaFNgBcdPRbIQAMZKC,ZAAALAAAOACAUAEADAGA.EAGAGBEA.HBGDaBHDFCAABCCDdDDAhABARECB..QFGAhABAADGBMEBBKEGACGBA..fGEAhBGAeFEFSGGA.....hBIA......hCAA...,1,-14,-18,4
GgKCOFbHIJZdfSQRBLYEPVWXUaNecADMT,MAAAGAAAKADAFADAHAFBZAFBdBHA..QBBCRCDBLEGBEAHB.hAAA.VFCBXDDAhAFA.aDGDeDBHACEBTGEAhAIAOFFB..IHHA....hBAA......hCAA...,2,-19,-9,10
XMdCRFOKbZfBIacJQGNPSHVTULAeEDYWg,EAAADAAA......gABAdADARAFAKCBAZCEEBAEAaCHD..QAGAhAEAGEFASFAAhAAAHCDATDGAAAFAeFCHhAIAXFCAMFEBOFHDbFEDfDCEhAGA.IGGA.hBCA...,2,-12,-12,0
eAfRdVDUWOTCZHMKXIFYEBGPQNLacSJgb,RAAAdAAADADAOADAZAEE.HAGBKBHB.FBDBBCCAGCBA..QCEAhAAAaDFB..SDGAhACAJDHF.eEDFhAIAAEEBUGAATFGAMFFB...XGGChABAEGBB......hAGA...,2,-33,-2,31
YaDRCGAWXSUeBZKENFdQVTHJbMfcOgPIL,SAAAeAAAZADBEAFAdADA...QAFAHBFCMCCBOAHFhAAAIDFAaCCCRCEFGEGAhAAAADBBXDGDKEEDFGFHTFAAhABA...bGEA.......hABA......hAIA...,1,-2,-13,11
aJLDEFPHbVRAdGZWTONQIfMSXUgCBKeYc,ZAAATAAAQAEA.MAHBXACBCCAA.eAEA.aAHDLDDAhABAECCBHCEAREAAAACAGECBhAAAOCHDfDHAhAFASFDABFHAKFHD.cGCAFGBD...hAEA......hAIA...,2,-18,10,28
XFGWMIBAgUENYdbHQDKCLaRSfPJcZeTVO,EAAAdAAAHADAKACA.aAFARAEF....SAGBfBHA.JCBBeBHHhAAA.TCCAOCFBhACAGDFAMDABADDAgEAAhAEAUEGAbGCACHHALEED.cGCChAIA......hCAA...,2,-10,-6,4
KMAZWDGRXYPJaBFLSgIUfHeTEbNOdcVCQ,ZAAAGAAARAEA...XADAJBHBFCAA.LAGB.SCDBhAAAIDDA.HDEBECFF.hABAbEAA.dEGACDADMECBhACAAADADAIBaFHD.BGBAfEFANIDB.OEHDhADA...cGGChAEA.KFAB,2,-29,-4,25
ZRWfgOKCTdJGQVcIPLXbMAeBYHaDNFSEU,eAAAHAAAaACAFADDUAFARAEF....fAGBKAHBdDDAGDGAhAAAQCCC.ICGAhAAALFBBMCIBACCBDFFBhABAEEEA.ZFGFgGDDCHEA....hBFA......hCAA...,2,-23,-1,22
PYKZcQTdJaLfXWSNEOHFARVGbUgMDBIeC,RAAAGAAAUADA.MADABAFAeAFA..CAHA.KBHBZCCAQCDAhAAA.dDFAaCGALEHBhACA.XDBDhBAASDFHEFGFHGCAAAAAbDGDDEEB...IHAAhAHA....hCAA...,2,-48,14,62
YfSgXWIZQODRTKVCLEHJedFBcAGPNUbMa,GAAAUAAAMADAaADA....SAFHXAFAZBDAQCDChAAARDDAKCHBLEBBHBGBeDBHhACAdFFABEHDAAHAbEFAfFEEhBAAIHHADIAATGGA....hBCA......hBDA...,1,3,-18,21
OdQJBCfeRDXcSLTANPYEbFIZMKgaVGUHW,...PAAAEAAAFACDZADBMAEA..aAFDGBDAHBGBdCCCQBFAhAAACAHBREEA.XDGAhAIALFBBABIB..bFBBKFDDhBAAUFFAOEHD.fGGEDGIB..hBDA......hBFA...,1,-4,-11,7
eNFGCEdYAHDLUTZWOQXRgVBMfPaIbJKcS,HAAALAAAZADBQAFARADFBAFB.MAIBaAGD...JCAFSBHHhABAeCCDGDGAECAAACFBhACATFDA.OCFBhAAAXDDCfHBBbEFAKGDAFGGB.CDGDDIAAhAIA......hCAA...,1,10,-21,31
dYCWLTbSFfNQHUPVEMeaBGXDIOJcKAgRZ,RAAAdAAACADB.LADA.SAGHFAFAQBEDHCACUDEAEBHFeCCBhAAAGEAA.DAIBODHDhABAKDGAAAEAZECBTEEAhAIAbFGD.fGEE......hCAA......hCDA...,2,-22,-1,21
ZIKcSLHYFDbTdXgfQGJCaEeNPWVURABOM,MAAAZAAAKADCLAEAHAFADCAAdBBA...XBGAQCDAGCEAhAFAaCFE.EDCAeCHHPDHBhAGAUFGB.AAHABGEAhABAOGDC.IHHA......hAIA......hBAA...,1,-14,-21,7
gLNMYaEUSfXbJedHBGPDCQIKOWAVcRTFZ,RAAAZAAALADBMACA.EAFASAEA..bBFAeAGHHDEAGCDAhABACCCCQFAAhAAAOBHDACCBTFGAFEHHgFCDhAIAaGDAfHDBdFFABHHADIAA....hCAA......hCBA...,1,9,-10,19
SCRKOUAdHMFeLIYabNgVZJGEBTWXcQDPf,HAAAeAAALAEAaACA..bAEDVBCBGAGAEBHFBCFA..hAAATDCAXDGAQEFChAAAfEEARGAAOEHDhAGAAAFAdFCAMFGB.FFHHNIDB.....hAIA......hBGA...,1,3,-3,6
FfOEYeHdbDUGgWRSQKaXCMNAPTJZIVBcL,TAAAZAAABADB.LAFAOACA..EAFAHCAAdBHA.DCEAGCCAhAAARCFAQEDAaCFB.MEHBhABAACCBIEGA.hACAFFFHeFFH.bGAAWDBD.XGDDhAIANEIA......hBDA...,2,-17,-3,14
SPVFTMWdRODUfeBcJaNbCGLHIXAZgYQKE,ZAAAQAAAEADE.SACAFAFAMAIBRCAADAFA.UBFABCEAaAHDCCGA.hABA.HECAACDA.KEGATDAAhAAAdGCD...eDDBhADANIEB.GGEB.LFCBIGGAYFFChCAA...hACA...,2,-22,2,24
EFSdbAHUcJIZYNeBGTCWMVagRQLXKfODP,HAAAUAAA.JADAZADA.eAFEGAGA.TCCAMCDB...aCAHRCEBLCHBhAEAKCFD.DECBhAIAEECBdGDAAAIB..IFFAhAAABFGDCGHA.VGAA.XGEC.OHFEhACA....hAGA...,1,-6,-26,20
ABgTPEOJZYFWXeNLGCMbafdUDcHKSQIVR,TAAAEAAAZACB..FAEDeACEGAGA..bAFBdCBC.DDEAHCCAQEEAhAAARCGFAAIBBDBDODHDhAGAYECG.XFGAhAAALGBAaGFCfGHEKHBA...hBDA......hBHA...,1,-4,-10,6
XdCKMRfOUHaTebgZBALcNWYEGSIFVQDPJ,LAAA..cAAANAEA..EAFAGADAFAHD.QAFAhACADCAA.XCGAhADAdCFAMCDBRDBBODEDhAFAHDGBeFABZEGFAAIBSFDAIHBA....hABA......hACA...,2,-23,-3,20
WSQbCYDeMKFGNATadPcUXBLgfVIJHZORE,dAAAUAAALADA..fADAIAHAHCACRAEF.ECFAQAGChADACCHA.eCHFhAIAMDEBGDDAAAEAaECDXFEDhACABFGD.gGGB..hBAA......hBCA...,1,-20,-22,2
acZIODUegNbXGJfdHYMTWFQCVRBASKLPE,LAAAEAAAZACB.DAEAeAEA....bAEAGBGAdCAAHCCAMCBBhAAATDFAQCEAhAFARECAAAIBKCHBaECA.OEHDhAIAgFGAXFFDfGCE.WHFAhABA......hACA...,2,-16,-2,14
KcDBeVFRNHOPfdMXQIgaJZWUYEAGLbCST,GAAALAAASADATAEA.DAGAeAGHRBFAHCDBOBHDdDCCMDABhAAAQCAA.aCDBhABAZDGBUEEAAEGBbGBAKEADBGHAhACAFEHHfGAA.IHHAhACAWFFD.CFDC.....hAEA...,1,4,-5,9
fMTKUPENSgDAYOWdQVFHaXRbCeBGIZcLJ,OAAAdAAAQADAHADARAGF.eAFAGCCAZABBLCGBMBBBKCFDEDHFhAFASDCA.ABIBVFDAhAGAaEFDbGACBDFAIGHAhAGAfGHA.......hAIA......hBAA...,1,-4,-6,2
GAUaDHJfcMIbXRdWeBNLCEFVZQKYSOgPT,aAAAHAAA.JADAMADA..XAGBRAFAdBBDeBDHLCAA.ECEAhAAAZCFAQDFAhACASEEAOCHDTFGAAECAfEEEhBIAIHCABHEAFGGA.....hCCA......hCEA...,2,-17,-7,10
CVHcfWURagKPbINBMSJEAXZTOLeGYdFQD,ZAAATAAAeACE.dAFAQACCDAHB.HAEB..fCCEhABARAGBaDDBKDGD..bEABBCEDhAIAMDIBECHF.ADGBLEEBhBIAGEEACGHD.cEGD.....hAAA......hAEA...,2,-24,-1,23
UaedTFXHBcgEMRZISWGPDCVKQbAfLJYNO,LAAAJAAA.OADDeADEdAGAFAFAHCAABBDA..ECCBRCEFZCGB.hAIASEHHGCEACCHAQEGAhBAAAAIB.hABA.fFBANIBB.aGCDXGGChBIAgGEAIGDA.hACA...,2,-17,-17,0
CXKeBdNSZPbHMaUELQTfWYOIGAVgFDJRc,FAAARAAACADB.eACHBAFAdAEA.ZAFBHAGB.MCCAEAHFLDDB.hAAAQEBBTDDAfDFBhABAOCHDAFFADFHBhBAAXEGASGEAaFAA...WHDGIGGAhAFA....hAIA...,1,-8,-33,25
DePbOTFBNSdacXYCgLQRUIVZKEHfAGMWJ,GAAAMAAADAEAeADA.OAGDBAGAdBBAaCDA...XBEChAIACDDALEFARCFA.UEABZEEAHFBAhBAAAAABJGDA...PHEAhBDAFGBHSGGB.....hBFA......hBIA...,1,-10,-24,14
gfWCOdJVacUZMTAPDBHLGEXbeKIFSQNRY,BAAAHAAAEADEeACAFAFAQAFARCAA..fBHAOAHFdCAAhAAAaCEAZCCA.ACEALDGBhACAbDCAKDHB.SEEAhADAgFGBCGHA.cGEAMIEA.DIAA...hCDA......hDAA...,2,-15,-1,14
BWMLZFIagTNGQRbeHJKCYdcSPOfAXVUDE,XAAADAAAEACA.BADAMAFAZAEB..aBBC..TAGAGBDARCFFHDAAhAAACBFAdBHA..SDFHhBAAfDHAAEHAUFBAhBFALFFAFFGD.gECA.NIAB.eHCAhCAA.....hABA...,2,-15,-9,6
adVZCFMSRGgKBcAYQLDPOXEbIHJWeNUTf,LAAAOAAA.EAEAHADA.eAFETAGAdCCAZCFAMCAAREDAGGEBhAIABCDAACFAQDEAhABADBBBXGCDbDGD.IEAAhACA...NIABaGEC.CHHA....hBAA......hCAA...,1,0,-11,11
UPLdEHMKaZVCgAFYWOSRcQGBXJTIeDbNf,FAAAOAAARACFGAEABADA....TAFAeAGBDAIB..bBBCUDGBhAEAdAHAHCDCaDEHCFGA.ADHASEEAhAFA.hAHAQFGAIHHA.fHEB.hBAA......hCAA...,2,-31,-10,21
gVdDPXJKLHOEFcYebNGAfUWTSBRMQIZaC,UAAATAAARADA...MACAZAGBCCDD..dAGADBIBXBDA.LDBAhAAAHCEBEDAAFCHDeEAAhADAGDFAAEHA.SFEDhAIAQFGAaGBAPGAAKHGA....hAEA.cGCDNIBBBCCD.hAGA...,2,-23,3,26
GOTBgeCRWPEbdAUZLNSXJMHFcIaQDKfVY,ZAAALAAASACEMAEAHBCCFAFA.aAGEQBED.KBHBhABAfCAAGDDBTFGAhAIAeCFAREEA.EFBAACCBNIEBhCAAXGCA.IGGADHDA...hCBA......hDAA...,2,-16,-3,13
PQYKSEIMZVWAeOGfHNJTdbCBLXFcRDUga,eAAAGAAAHADAJADA.dAGABAGBLCCA.FCHDRCDADAIBaDEEQFAAhAAAKCHD.EFFAZECAhAAAAAIB.OEGB.TGCAhACACFHA..........hBAA......hBCA...,1,-8,-34,26
TaUfGHgOMPELcCXWVRNFIKDdSbYQAJZeB,eAAAaAAAGACAHADAMAFALAEA.CBHA.XBFARCEA.FCCBDBBBhAFAdDEASDGAhAGAQDGBAEEBZFCATGFAfFFBhAIA.OHFC.....hAAA......hABA...,2,-15,-9,6
ROLFPgbJDKGXdfMcEVWINSUQBAYTZHCea,ZAAAHAAAeACERADFLAFBFAFA...bBGDKBHBGDAAdCCDMCFBECCB.hAAA..VDGB..hABAIEEASEEDhAIAQFCDACGBCGGD.aAHF.OFGB..hACA......hADA...,2,-26,2,28
NcIMZHaBdKeWFLJOgXPEbfYSADQCGURTV,QAAAGAAARADA..TBGAVACA....IAGAHCDCdEADhAAAeAHHLEEAOCDEhAAAXFGAEDHF.bGAAhACASEEAAADACGEA.cFAAaAGABHHDFFHDgGCHhAFA.hBAA...,2,-3,1,4
ZabQdGHCBXLSOcJfgFNIYKAVRDWMETUPe,RAAAMAAAEADE.UAEAZAFB...QAGAHCCBXCGDLBBBOAHFhAAAJDDAFDGA..IFAAhABAABDADFFA.TFEAhAFAeFHF.dGHA.BFCD.fHFFhCAANIBB......hCCA...,1,-8,-23,15
QEdNFXScOBbLWGJeIVRTAPaCHUKYDMfZg,aAAAHAAA.KADCMADAZAFBEAHFdAHA..FBBHSBDABBEALBGDhBAAGCABeDBARDFA.ADFBCDHBDEEBhAAA.QFFBhACA.NICBOFHDbEBAIFFA...PFHBhBDA....hBEA...,2,-26,6,32
bGLKOAWHSZEcNUVBDYfgIRMFeJXTQCdaP,HAAAEAAAUADADACA....fAEARAFAeBCD.JAGBTCGA.hAAAdEEAbCCAGGABLDHBhAGAADBBZGFEVGEABFDCIEGAhAIA.MIBA......hBIA......hCAA...,1,-11,-12,1
gXbIEMHNROCdeVGcSABaYPUWKTfQFLZDJ,aAAAUAAA.KADAQADAZAFB.DAGAJAHB..XBBC.hADAEBFEHCBCRDAA.dECDeBHHhADAGEGAADDABDFAPFABhAFATFDALFFDbFFBMEIB.CHBA...hBAA......hBHA...,1,-7,-17,10
bTefcNGUDJCXRgAHdBPVKWOIYZSQMELaF,HAAAdAAABADAKADCOAFCZABB..MAFAECABLCCAFBED.eCFHhAAA..fBGAhBAAGDGADCIBXDCDhBGAAAHAPECBIDHASEEDbEEB..TGGAhBIA.NICB.CHCA...hACA...,1,-10,-18,8
FZHbIdMCceKgWaPLXBTUJNfREDOGQVASY,FAAAHAAAdADAMACA.eAEAKAFA..aAHDLBHBBCCD.TCCAhAAAUDEA.fCEBhAIARDGB.EEEAGFABACGAZFGBCGFAhCAA..gGGA.XDBChAFA.DIDA....hAHA...,2,-29,5,34
EBDYgLOWVfHbNCcRUTeIJPFAMXSZdaQGK,MAAAZAAAaACAGACB.EAGEDAFA.LBFAOBBB...fCCEhABAHCDCbCGBCDCDRDFAeECBhAIAIFAAFEEHABGAdEEDQGGAhCAABFHA..gGGG.hCBANIAB......hCEA...,1,5,-17,22
GIUgNKHeXPZfRcWBSJTQaEMFLVDYCbAdO,GAAAUAAAKADAHADA.eAFEZAFBRCBABCDD.TCFAEAHFLDHBhADADCIBCEEA.AEEA.dFCAOECChAFAIFGA.NDAA.XGEAhBAA..fGHA.SHCAhAAA..hACA...,1,-18,-27,9
dZMRAKOQUHXEeJVfILaYGcgPTCSWDBbNF,QAAAHAAAEADEeAFEJACE....VAFALCAA.GBEBhAAAPCDBTDEA.hAAASDGHBCEBbDGBdEFAhAIAMDIBAEIBKGHBXGGC.aEDH...hCAA......hCIA...,2,-24,9,33
PXbCdUMWLecYgFOaAfQHVDZEIKJTBSNRG,HAAAZAAAEADEKADCBAFBRAFAGCAB..XAGDdCFDMCIBLCABhABAeECA...gCCAhACAaEGBAFFBQGAAhAAADCFBTDGASFHDbFFACEED....cGDAhAIA....hBIA...,1,0,-24,24
eJFRYWGPfINODECdSaMBHbLVTKZUQAgcX,XAAAeAAARADAGAGA..IADADCCBECFB.dAFA.MAHBHDCBhAAALCDBTFEAZEAFhABAAAAAgDGAFEHD.hAEAPFBBNIABCHHA.aFDE.bGDA.....hAGA......hAIA...,2,-8,2,10
cVBSCOfRdGeQMAWPJaDLHFTXIUbYKEgZN,JAAAaAAAHACB.FAEATAEA..XAGDUAGAKCCAZCFA.VEBAhAIACDAA..RDEAeDHHhADAABBBDEEALFFA.hAEAIHEAEECBNHDB.BEGA.....hBAA......hBIA...,2,-32,-9,23
OQLNHAXgZMJDBCTfRUYSEcGPbFdVKaWIe,ZAAAMAAABADB.CAFA.RACASAFBGAGA.FAHBdCAA.KCCDaBBH.hABA.eCFBLCEBhBAAHECAAAIBXCGADDIBUGGAhACAEDDF.bEGD.IGEAQFAC..hAFA......hCEA...,2,-15,-11,4
GFfMbWHXeNYVPILOTJgRUdSEQaZBCKcAD,GAAAMAAAHACCeADA..VAGBLAHBOBBBTBFA.RCDBdEADhAAAECDBZDEBKEGAAADAfDHAhAFAXFDAPHBAhACAgFCD.QGACaGGACHHDDIEA.bEFD.hBAA......hBCA...,2,3,7,4
cYNCLRUeTOaJHQKfMEXZDgVFGPbWdIASB,BAAA..NAAARAFAeACA.aAFDHBBA.QCEDMAHBZCAADAIBhAAAFCHBGDAA.bEFAhABAdDFAADDB.SCCEhACA.CDHATFBAKFEDEGGB.XFEC.hACAPFHB...hADA...,2,-18,-8,10
DBMdASIHNLcRTWZCfbYeOJPEKFaVUQXGg,HAAALAAARADFZAFBCAEA.....bBGDeAFHOCABEAHBFCAA.aCEHhABAQEEC.hACAXFAAGCGABDCAhAEAAAIBSCCDIFFATGGAfGDAhAIA.YFHB.hAAA...,1,-11,-15,4
GMXEdJgHTSKfYaZCDRIWPeQbALVFUBcNO,LAAAFAAABADA.OADDGAEA..EAFAdAGBHBFCKBHD..aCCBZCAAhABA.RDFBIFAAhACA.eEEBADAAUDGBMDIBhAFAXDDDJFDFSGHDCFGADGIB....hAIA......hBIA...,1,2,-38,40
UbGVeESPWgKTMHOILaXJcfdFADBRCNZYQ,RAAAZAAAQADCGAEAEAGA..SAFB..gCAAhABAMAHBHCDCLCHBhACAaCCHXDGAfDDAhADAAAAACEEDUGFAeDGF.KEBB.TGAA.OFFHhAEA.IGDAhAGA..,2,-18,11,29
PFUNGAHSdKOLcEWYefCaZJMQIXgDVRBbT,HAAAdAAALADAEADEeAFEaAGDZBDE..MAIBQCAB.XCFAhAAADCCARCDATDGAhACAFDEHGGEBAAEAOEFBcEGChACA..fGGA....hBAA......hBCA...,1,9,-27,36
NQcBdaPWFSGTIULEYbAeHgOXRKZJVCDMf,HAAAXAAARADFZAFB.CAHA.MADA..QCABdAHAaBCD.FCHBGBEAhAAAUEEALFAAhAAAEDGAABEBeEEDKEHBDEIB.fGBAhABABGHD.SGCH.TGGAhBGA....hBHA...,2,-14,-14,0
DKbdJEBVfYSPTaCLXHOMRUNeGcIFWQAgZ,ZAAAKAAAdACAEADEBAFB..VAEA..SAGHaAHD.LCABhABAHCDARDFAeEAAhAAAGCCBFFFHAAIBDCIB.bDGDhACAfHAB.YHFGTFCAOEFBhCCA.MIFA.hAEA...,1,-7,-22,15
CFeOcXdSYVbAGJZTaKQMENBPgRUWfHLDI,ZAAAaAAA.MACABADARAEA.UAFAHCCC.LAHBCAHA.eCFHOBBBhADAdEHASFGDhABA..bCDCAHCA.GDGAhBAA.TFBA.EEEA.NICB.WHCA.hBFA......hCAA...,1,-9,-26,17
SaTHAMIRCPcebEYNGQVKUDWBgJZdFXOLf,RAAACAAA.eADEEACA.GAGAKAEA.DBEBBAGB.ZBFEdCCA.OCFBLCAAhAAAaDHD.HDEC.ACEBMDIBhACAIGAA.bEFDhAAAQFFB.WHDG....hAIA......hCBA...,1,-16,-26,10
IPQMVgKYGELAbBWXdCNHUTeJSDcOaFRZf,BAAAdAAAHADAeACADAFAOAFCRBFAZABB.....ICAAMDDBKDHBhAIAECCAAEEA...bCEACEFAUGGAhBAA..TEEAhAAASFDHaDHDfFCA.QGEBhACA.YHAAhADA.,2,-31,-24,7
XKHGfcLUWeTFadgYBCRNAbOMVIQEDZSJP,MAAAQAAAZABE.SACAJAFA.KAFAHBDCGCDALCHBhAIAeAHHaCFFdDDABDGAhBAARDABACDBODHDEFEAXGDChCAAfFFAUGGAFGHH.CHAA.NCCA.....hDAA......hDBA...,2,-6,3,9
GKWQAcCVeRZgOXbUHMFBEPLafNIdDYTJS,CAAARAAAZADB..XACAHAFAMCCBBAFAECGALAHB.aBFEfDAAhAAA.dEEAhABATCAAGGEBQCCChAAAAAHAeDHFbFCDFDFB.IEHA.DEEBhACA.SFAAhADA.KFGD.,2,-29,10,39
KGgTXfZPaeBSOEbQUIHdYDWVNJCMRcLFA,GAAATAAA.ZADAeACEOAFA..EAFEQCDAHCCAdAHADCEAhAAAVCGBCDBDRDFALEAAhAAA.ABIBKFDAfEEEhBDAaFFDSHGAbGDAIHHA....hCAA......hCCA...,1,-4,-7,3
GDBcKFXIWabLSgQfCAYUZTeMVJONRdHEP,ZAAAeAAAMACAOADCRAEA.HAGBGCCBBCCAFBHD..XCEChAAA.aDGEbEFALFAAhABAQGCAAAIBTFEAhAFAVGEA.dGHAEHAE.DEFA.......hAGA......hCAA...,1,-3,-6,3
UBIegNHLcAGMYbKVWQFOaPJSZdCfDXRET,GAAAMAAAKADAQADA.aAFESAFBdCGADAIB.EAHBTDCAhAAABBBAeCDBHFDAADABhACAVCGBODHDZCEFXFGAhAIARGAAgGFA.......hBAA......hBBA...,1,14,-28,42
gWUGHdQNMYaScBDZIAFXfTCJeEPKbRLVO,XAAATAAA..eACEEADA.KAFCRAFALCDBOAHD.UCFBHCCAhAAAdDAAMCGB.aDBHBEGDhAAAZEEFACEACFFDJFHB.VGAAhABAGEGA.YHBADIDA....hBDA......hBHA...,2,-9,-5,4
KXgVRePJWMbSZHOcBQIaELGUTDdFAfNCY,CAAAXAAARACA..eAFEJADA...MBGBZAGBHBCBBCAAQCCBhAAAEDFBGEGATFCAhAAAdCHAAACA...fEEEhABAKEEAPFCBSGABOFGD..aHDEhAIADCEA.NICB....hCAA...,2,-26,1,27
HQCRUPJgXGMIaVbcYLNADWETSedFZfBKO,EAAAeAAAZACBKADAHAEARAFF.UCEB..JBHBGDGA.aAGAbCCBLCBDhAAA.ACHATFEAhBCAdEEABEHA.QFAAhAAA.CGFA........hCAA......hDAA...,1,-7,-32,25
CLHZfDYWGXdJePKTgOcIBQbUMESVANRFa,RAAAaAAAHADBZACB.DAFAGAEAdBFA..eAHFTAGAOCCB.BDAAhAAAbDFD.UEEA.EDHFABBBCCHAhAGA.LEBA.hABAfEHEXGFA.......hADA......hCAA...,2,-17,-14,3
HdQbPOJTZFXLADMWIEagBNRcCYSUKVefG,MAAAEAAABACARACA..CAFB.SADH.KAFAeAGHHCDCbCCAOAHDhAAAZDGB.LEEAhAFAAAIBDBBB.aCCH.gFGAhAHAcECA.VGCAdFFC......hCAA......hCBA...,2,-28,-9,19
XROBeIFHQbEKJVTUaDPcfMGWgSYCdZANL,LAAARAAAeADEHAGBEAEAKAGA..TBDAaCAA.DCCB..fCEAhABAGDDBSDHHhAAAdCGAACIBODCDFFGHbGAAhABAUEAA.MEFB.gEGA.CGDANIABhACA.BGHA...hAGA...,1,-2,-6,4
egVAFELJQMadOGPcRKWHCbNBUSTXYfDZI,EAAALAAA.MAEAdADAGAFARBCA.HCBACAHABBFBTEEA.hABAfAHEZCAFeCGFACIBhACAQFAAaDEB.hDAAODHBKEHBbFEDSFDDDGHB.gGGAhAAA...hDCA...,1,6,-20,26
fQVBecZIAXMGOdJHbDPRTKWSYgEUCaFNL,GAAAdAAAHADADADARAGFKCBA..SAEAECEFUDGB.aAGDLFAAhACAQCDAeEFDZDFBADABMFHBhADAbDBD..PDHDhAAA...YFDB.FGHHNIAB..hACA......hAIA...,2,-11,-6,5
NWIegZfXEcPGAVTdRLJFCMHDYQSBaUOKb,dAAARAAALADBCADAHAEBDAGAQAFA.BAHAaBGAKCBA..bCEDhAAA..IDGAhACAeCCDZDGBEDABGFAB.hADAAEIBTGEAMDEBSDHH.OFEDhBAA.gGGAhBCA.fHCB,2,-16,-8,8
FGYcKeADEdfITaObVUJQHRLNMZWXSBCgP,EAAAdAAA..TADAaACD..OAEAUAFAHCACRBDFLBHBZCFESDEDhACACCBDFCFD.GEGAhADAKFBAACHBDFFAIGEAhAIAJFHB.MIBA.........hAAA......hAIA...,2,-28,-1,27
fTSdUNALPIbFCeXVOGJZQHcMEKBgYRWaD,LAAA..bAAAeADHOAEAZAEBHAGBEAHFBBEARCABaDEEDAAASDHHhABAdCGD.AAIBFFFBhACAXCCC.GDEAhBEAQGBAMEHB.KGHB.WHEG..hBGA......hCAA...,1,-1,-22,21
dIKYMbNAgSVRWcJTfUZCPBHEGXOLeaQFD,SAAARAAA..JADATADAZAGBBCCAHAFBECEAGCCA.hAAALAHBeCHHaECAQDAAhAAA.dEFAhABAKFEAbEGDAFIBVGAAfFAECGHD.OFDDhADA.DIFA....hAFA...,1,11,-29,40
JfVEgLbdQASCTPOaMHcNDKBeIZYFUXRWG,TAAAaAAAHACB.DAEAeACEZAFE.FAFA.RCCAGCFAVCFA..EDEBLCHBhAAAdEBA.AAIBCDBDMEIBhAHAKEEDBFCAUGFA.JHDAhBDA.....fGHA..hCAA......hCCA...,1,-11,-15,4
ABDQFWdabVeLJKPfSRXUOMZCEGcTIgHNY,QAAAdAAAaADA.eACALAGBKAFA.SBDBRCDAOAHDZDAAhAAAEBFFGCBA.TEEAhACAHDGBACDAFDHDbFED.hAIAPHAAXGEACGGD.IHHA.NIBB.hBAADFEB.....hBCA...,1,3,-10,13
GUJcIVFBDeRZHMWYKTgLAEXfaPQSONCdb,EAAAaAAA...QACAOACDdAEAGAEBUAGA.ICHABDEARDFFHEBAhBAAMCCBKDDALDHBhBBAAAHAfDFBSGBAhBEAbEFA.JHFAFFABDIBAeFCF.....hBGA......hBIA...,1,5,-9,14
JFPDEKceBLaTbAOfWYVQIGUCSXHdZgNRM,OAAA..fAAAVADA.GADASAGBHAFAZCABhAAARCCBMAIBFCGDEEFB.eDDDhACAaCEEABBB..YDHBhADAQDGDCHAAXFAAdFEAgGGAhBAANICB......hCAA...,2,-22,9,31
VMFeBGLfcaENbJOKHAUWTZCRPIgdXYDSQ,TAAARAAA..IAEAdACADAEA..QAGAMAGBBAHAGBDAhAAALCCAaCFDEDHBbCGD.hAAAKFBAHDAA.ACIBZECEhABACFFAPFHBXGEA.SHAA.hBFA......hBIA...,2,-17,-6,11
CJQUaLTFPODIXABgZWbVcRfEGKYNMdSeH,ZAAAVAAARAEAGCAA.KBHBMADA.eAFAHCCCQBDDhAAAaCFDLEHBTCGAFFFADACAhABAABIBBDED...bEFAhCAAEHAAdGCACHDA.UGEA.IHHA..hCGA......hDAA...,2,-8,-6,2
BRfaZKLHeTJNYOgEcMPDdVAGSWUIXCbFQ,GAAASAAAUADACADA.QAFABAFARAGF.ZCFEHCCA.eCHHhAAATEDA..YDABhABAEEHBMFGB.dHBBACEAXEEAhADAbDBDFGED.aFHD.KGDA...NIAB.hAFA......hAIA...,1,3,-16,19
DeJgRGcVBYXIbPTCMQZSUfadFENHOKWAL,eAAARAAAGADABADA..XAFA..bAEDTCFAMAHBZCCBhAAASCCDaCHD.EDABhAAAHEEAKDHBAAFALGAAhABADAIBJEFF.gGEA..YFHFhABACHGA.....hAGA...,2,-13,-5,8
HZdSbRDGAYEcLPMeOINFCQVgXTWfKJUBa,EAAALAAA.eADHOACCFAFA.QAFC.XCCAhAAATCAAKBFDBAHBHCGBhABAdCHARDEFAAIBPDEBMEAACFHAgGDBhAEAfFGEaGDCSGGDDFIB.hACA......hCAA...,1,-3,-19,16
EfUKNeVaWRbgSGYPTFdCIcADJQBHLOMXZ,QAAAHAAAMACAEAFAKACA..eAEE.aAHDRBDBbBFA..GBEAhAAATDFAdCDC.CDGAADIBBCCDhAAALFGBZFFAfHBBhAIAVGCASHAGFHDA.DFIB...hBHA......hCAA...,1,1,-4,5
KbacRVXUQeMPZWLdNEHSJFfOGTDIgCYBA,aAAARAAAUADA..eACHZAFBdBHAHAEA.FBHDGDDADAGA..CCEDABBBKCCDhAAA...VFBBMCGBhAEALFGBEDDB.SGEHhABAOEGD........hAIA......hBFA...,2,-28,-17,11
AKQDUVBRETSMbFXWGZNdCOJfaIHcPgLYe,QAAADAAABACARADF.EACA..MAFAFAEDGAGAZBFB.dDCAOBBBhBAAaDGHHEDB.gGAAhAAAeBHFACFBKDDDTGGAhAGA..bEFA.XGGC...hAIA......hBGA...,1,-2,-29,27
GAIHNFaKMUTRfDeCWPdcbLXESYVJQBgZO,HAAAaAAA.MACARACFDAEAeAEA..CAGA.dBHALBFAECCA..SCEAhAAAVDEA.QEEAhAIAZECFABBBFFGD.TEGAhCAA.fFCAWFHH.PHCChCCA......hCFA...,1,-5,-34,29
PIOdJcYaLRGCHQBKSEWfDMAVXeUNFgbTZ,eAAAFAAA..TADAZADBOAFCdAFA.JCFAaAHB.GCCAHDBAQEFAhAAASBHHEDAAhADADEIBAAHAUEFA.bFDDIFDAhABALFHBBBCA.fHFBhCAA.MICA...hBAA...,2,-9,-6,3
QOJDBNdeXcCHUVgTKFSPIGMLbEAfRaYWZ,RAAAaAAAZADB..QADADAGAdBFA.eAFACBHA.HCCAUDAATCGAhADA.SEEAhAGAGDGAMEEBEEHFABBB.fGCAhBAAOFCDBFFDXGGA....hBIA......hCAA...,2,-35,-2,33
ZEdATLIYKMgVFNXbRDaQSJHePBCfWGOcU,TAAALAAA.KAEAMACAFAGA...XAEARCAAQCEAHBGBeBDBhAAACCGA.GDEAhAHAOCHDZFCFACAA.gGGAhAIAVECA.DCCBaEAH.SFGBBEHA.hBIA......hCAA...,1,5,-21,26
TaIJGScKZYFXdHPEVRDeWfCLAMNbQUOBg,MAAAQAAABADA.aACEGAEA.KAGAZAEBFBBBHAGB.EDAARCGBeCDBhAGACDCAAAIBUDGB.TFEAhAAASEGD.hADA.XGBA.dGHADFFBfHFFhBGANIAB.....hAIA...,2,-32,9,41
YZSKTPXNLBAFMgDObfRdIWJaHeEcGUCQV,MAAAOAAARACA.dAEA..JAFAHAGB.EBBBGCCBQDBBZCGBKBBDhAIATDFA.XEDDhAGALEFDAAIBDDIBbFCB.hBAAfFHEaEHD.eGBGCHHA.SGGDhBAA....hBDA...,2,-15,-6,9
gJfPbQDEHVWXKTSIAaOZNdLFcGeRMBCYU,ZAAAdAAALADAGAEARAGBBADBCAHA..UCCAJCAA.....bCFAhACAEDGBHEAA.XEFAhAEATEDAAAIB.aEHDFFEHhAFA.eHAAMFGBfGGEQGAADFIB.hABA......hACA...,2,-23,-4,19
fMDYVGcLZUOHaBeWTENPbdRAXCISQFJgK,CAAAQAAAFACA.KACAMAFADAEA.GBDBZAFEHCDABBHB.eBCDhAAAECGE....bEFAADGASDGAhBGAJDCF.hAAAfEDAcFECLHAAaFED.WHEAhAHATGGA....hCAA...,2,-36,-2,34
IGXbgNSFPQfUOZJHMWcKDBLadCTVARYeE,RAAAEAAAGADA..bACASAFA.QCFAOAGBHCCAhAAAMAIBKBHBLDAAhAAAdDAATDGAAAFAeEFBXECAhADAFEHDfHDBZFEBcGGABHHAaHAA..hABA......hADA...,2,-6,5,11
WgTaOANBCeZEJLVYRMXHfPUbIGScQDdKF,CAAAEAAALACARACA.HAFBUAFAGCCAQCCBdBHAFDAB..TDAAhAAAAAHAeEFAZCFEVGEAhAAAMEEB...fFFAhADA.IGHA.DHBA.KHFAhAIA......hBHA...,1,-13,-14,1
AUZPgVNMXOSEGRDYWJafFeBLcIQdHKCTb,ZAAAVAAAMACA..SADBRAEADAIB..JCCFaAFA..eCFFhABALBFA.QDCAhAAAHCGBTGFAADGAgDGAhAIAOEDDEHAAGEEA.fGBAhBGA.BGHA.hAHA...,2,-22,-4,18
BJLMZadYWDEIFRUcKXCGfAQVPTgHSeObN,QAAATAAA.HACAeACEOAEABAFBMAHBdBHADCEAFBDHRDDAKEGAhAAAGCEAADDA..VGDAhAIASCCD.bEGDhAAA.JGCAaGGA.........hAIA......hBIA...,1,-9,-19,10
OdMbFXeEBLJDUVIgNTCPSfYcQZWRHaGKA,dAAAMAAAFADA..EADALAGBDAGA.UCCAVBBB....IEFAhACATBEASBGBhBAA.fDEEhBBAQFCAREFFaCHDAAIBbEGDeFHFBBFAgGDBhBIACDBC...hBAA...,2,-38,-5,33
YUBEIXOSgAQKMaPJCbVGecWRDLHTFdfNZ,MAAAaAAA..CADAGAEAeACARAFAHCCA.dCHAZAGBBBBDEBBBOCHDhADAACEAQDFAKDCAJEFBVGAAhAGA..DGAATGGAhAIAFGHB...fEEEYGBG...hAGA......hBAA...,1,1,-24,25
YcHTJNRCOdQSGBVDLAKWMUfbeZEgaPXFI,MAAAUAAAeADAZABE..EAFAaAGD..FAHD..ICDAHCCATDFAhAFARCEFdDAAGDGAhADADCEAADHAKEED..bGBAXFGAhBAA.JHFANAIA........hCAA......hCCA...,2,-17,-9,8
aFKXTUGWDbRQJVfSYPOgLdIEBeNcHZCAM,aAAAXAAAGACADADARAEA....QCFAVAFA.SAHBhAEAOBCDdCEAEEDAeCHFhAAAHFAAADGBMEBBTFFAUFGBhABAJHDAYBBF......hAFA......hBAA...,1,6,-22,28
ZaVETeKUJGdHRLcDQSBYCOFbPWNgAXIfM,XAAAMAAAZABE..EAFAeADA.KAGAGBGAHCDARCGFLCCAhAFA.QECAhAIABDAAODCBbEFD.PEFBhAAAgGCGAADAaEHDTGCA.....hBAA......hBIA...,1,-7,-10,3
KBHQgORWZCDXSEATafJUFIeNMYVGdLPcb,aAAAUAAA.eADAMADAGAGAdAHALBBA..bCBAHBEBQEAAhADARDBAZDGBXGBAhBAAAAIBTEFAFGEB.IHHAhBDAVFDBKCFDBBGC.......hAEA......hBAA...,1,2,-8,10
aeYFfXLcIMGUKAVSZgQdOHDbNPBTEJCWR,ZAAAdAAAHADADACA...bABDBAEA.EAGACAGBRCEA..eBHFFDAHLCHBhADAMCCBGDDAAAIBSEEAhAFAQFGAOFCBhBAATGAAaGGAXGCDIHEAKGFD..hABA......hAGA...,2,-21,0,21
QfgHdNXGaILWPDFOcCbAUVEKYTZBRJeMS,EAAATAAARACA..eAFEMACA..QBFDHAECdAHAGCCAhAAAaCCCLDABDCFBODBHhBDAbDFAAECA.KDHBZEEASEFHhCAAfGDAXGDDIHHAFFHH...hAAA......hADA...,2,-7,7,14
TYDPdIRAGNEFXCQHSVefJKZaMUBcgWbOL,EAAACAAAHACA..eACAKAFCZBEEaAFD.BCAA....gBGHhAAAbCFA.TCCAhADADCCBdEAAAAHAGECBFDDHQEGChAAAfDHAMFFBcFBC.OFHDhBFA.....hACA...,1,1,-26,27
BHcdeQIbDWCLZKEJNAafFTVOgGURXMSPY,aAAATAAA..OACDGACARAEA.MAEA.SAGABAHBHCDBhAEAeBEGbCFA.CCADZCFEEEGBABBBhAFAFEDD.UFFA..hAAAXGCA.cFFCdEHA.DFIB..hBAA......hCAA...,2,-21,0,21
eIgGFDKPaJQEWMSYLORNAHfTXZbVBcdUC,HAAATAAAZADB.BAFAdACAeAEAGAGAKAHBaCAC..ECDAMCFBLCGBhAAAREFFAAIB..XGDChAAAbDEDUEAA.CFHAFGDHhAEADEEB............hAFA......hCAA...,2,-16,-9,7
abdgFKUNSTOEeILCRQAVYMDcZPHfWBXGJ,MAAAZAAAHAEABADAGCAA.aAGAdAFAKCDASAHB.EBBBhBAAeCFHLCEARDGFAACADEEBhABA..fDCAhBCAXGGAJHCAbDFAFEEH.TGFA.CFBDYHBAhBFA...hAEA...,1,-6,-10,4
aJecWdfZTYAOSGNQIFUVBRbDXHgKELMCP,GAAAQAAAFADABAGARACADAFA.HCDA.EBHFMAIB.CBFA.aDBDeBGHhAAAdEFAZEGBACEB.SFCAhAAAIDAAVEEBhADAbGAC...KDDD.LEHB...hACA......hAGA...,1,-11,-13,2
FXZaVMUGRSYLTANdBEQgKDeObWHCJPIcf,dAAAEAAAKACAeADA.OAGDHAEBCAGA..JCBB..ICCAFCFHZDCB.hACAaAHDUFFA..RDEALDHBhAAAAADABDHADAIBbEAAhAEA.....cGAAXGBCMFGBSEEDhBAA..hBCA...,2,-30,-5,25
AMORGcSTaECIULVbFYQHefBJZdXWKPgND,RAAAGAAA.SADAEADECAFBLAHBFAGAHBFABBGAdCDA.KDFD.hAAA.PCCADDABAAABMDHBhACAODECaFGH..IFFAhABA.bGDC...eHFA..hCAA......hDAA...,2,-26,-18,8
eAaVDgKLdBFMCNEWGUIZfcPTSOQRXJHbY,aAAADAAALADABADA.MAHBEAFAGBGA.ZBBAfBBAhAEA.TCDAQDAAhADARDFBHFAAeCEHAAIBKDCDhAFAdFFACDHA.UGCAIGHASEHHXGCAhBAAYFAF...hBBA...,1,-4,-12,8
JbGTcYDQFdMOagCWABKXIfZUReVHNPSEL,XAAAZAAARAEAHCAA..SADAEBHFLDEBGAFA.TCDAhAAADACAdDGDMAIBaECACFAAAADAKDCDhABAUGGAeDGH.PFEBhAHAbGCC..........hBHA......hCAA...,2,-13,-4,9
KSQAFTPLYeXHDZNVCWacBOEgGIRfJdUbM,TAAALAAA.eADHHACBZAEBCAEA..aAFDOAGDGBGARCABdDGDMCABhAAAQEECAAHA.hACAFFHBXDECDAIBVGBAhABABFDD.EFFB.fFHA.bEADhAEASGGDNIBB.hBIA...,2,-6,-2,4
TgAICZfVSNBaDJMbQLGOYRPUKedcWEXHF,ZAAASAAAaACA.MADALAFA.GCCBRAFAKBCAeCEFdCGAEEFBhABAHCGBFEHD.AAAAfEBAhAIABFCADGAB.bFED.hAGA..QGGA.....hAHA......hCAA...,2,-25,-3,22
eGYQRFPAUSXOCMLNKJTadfVbWEDIBgHcZ,XAAAMAAALAEAKADA...aAHDdAFA.VCDBEBBABCDA.hAAAHCEBeAHBGDGAhAFARCGBADAAODCHCDCDTGAAbFFA.hABADGCA.gGDAZGEA.....hADA......hAIA...,2,-11,1,12
ENOMcCYRbfIVdTgWZaDHQBUJeAXFSPLKG,SAAALAAAEAEAMADA..CAGARCAA..bAEA..ICEAhABAdCCATCFAZCFBHEAChACAQEDABCHAeEEDhAEAAAAAFDHDKFCDOEHBfFFB.WDBFaGGHDIAAhAIA.....hAIA...,2,-20,-1,19
fNMIGTSYFKcgbHRPLAXeCDZQEWJBUVadO,eAAAZAAAEADEBADA.UAFAdAFAOAHB.MCABGCCA.TEFAhAAAFCCHKDFA..bCFAhABAHECCRFBB.ACIBDEIBJFEFaGHBhAIAfFGA.SGFD.hBFA......hBHA...,1,-14,-18,4
aNgLEYcMbdRXIFHZVDWeBKTOCAJSPQfUG,SAAAQAAAGACB..aACDLAGBEAEAMAHBRCEBFDAAhAAAHCDAZEGBDAIBeDCHTEAAhAAAAAIBfFAAhADAUEFAgFCAbGCA.dFHA......hABA......hAEA...,2,-12,8,20
BeOEgYdNJcXICaLDFMRGZQfWTbSKPAVUH,HAAAeAAAEADAdADAJAFA..XAFACBFD.aBHDLCHB.hAAAMCABRCCAZCFFQDDAhAAATFEAbGAAKCCDACCABEEChABAODFF..YEHBIGHADGAAfHDBhACASHEA..hAGA...,2,-16,-7,9
LSNaJFbfGCZdWMPeXHgRcEVKIUADOTQBY,TAAAQAAA.LADAaACA.FAHBGAEAdCDAMCFBeAGBHDGBhAAARCCBEDBBKEAAAAHABDGDhAAASGCAbEFA.ZFAEXGGChBDAgGEH.IHHADBIB..hAEA......hAFA...,1,1,-5,6
MfKIdYLXEbOacVTAeRNCZJHUDSPBWGgFQ,RAAAZAAAHADBSACEBAFAGAGAFAFA.MCCBKBEAdCHALDAB.hABAEDDBaCCC..TFEAhAAAAAIBeDEACDFA.DFDAPEHDhABAQFGA.fGFEYFDF..hCAA......hCBA...,1,5,-30,35
OJaTLgIeZWYFNHCQdVGfBMDXRUSAcEbKP,EAAAKAAAOACA..aACDLAGBeAEAZBEEFBCDHDDCdCEAGEFAhAAAMAIBRDGFAAEA..bFBATGDAhAAA..IHHAhAIAYCBFCBFBfDHAXGGA...hBCA......hCAA...,1,-7,-18,11
QYeBbAcFGHORZNUfgaWXKSICMDTEJLdVP,GAAAHAAARADFZAFBUADA..aAHDKAFA.CAHB.MCABDCGA...ECCBdDDAhAAAQDGAeDBHADGA.hACAOEEB.fFAAhAAAXDGATFEALFCB.PFGBhACABGHA......hADA...,2,-29,-2,27
FCePTUObdBWfRgIASGHEcMXaNZJVYQKDL,HAAAEAAA.MACAaACDZADBJAFB...QAFALAHBeBDFUDFAdEEChAAABDFARFCBAAIBGEDAhAAAXGGAVGFA.DCCBCCBDOCHDhBCAfHBBIHBA....hBHA......hCAA...,1,-3,-7,4
IWKALEaZDgJVdSRUfHGeTNMXCOBYPcbQF,EAAAZAAADACA..VACARAEAHCCCGAFA.eAHBMAIB.OCFDhABABCCD..PDEBQFAAhAFAFDHHKFAAADHBaEHDdGFASFDDhAAA..fFFEhAHANIABCHHA.YHCG.hAFAIHHA.,1,2,-13,15
MZNELUTYRceGKbHdXQgIACaOWVfFJDPSB,aAAAOAAA..VADAFADDDAFA.BAHAZAGBEBBBLBFB.UDDAhBAARDABeCHH.bDCAHDGBhBBA.dGGDQFGBhADAACCBCCHB.fGAESFCDMGCANIEB.hCAA......hCBA...,1,2,-27,29
BONWCRGZbeEQaIKTXYAMdLcJUVFfgSHDP,dAAALAAAUADAFAFESADH.HAFABBHAOCABCCBAZDBE.ECCBhABA.QCEDhACAKCFA.TEGAADIBMEFBcFABhAFA..VEGBDCIBPFEB.WHAAhAHA.....hACA...,2,-47,12,59
OdHYGFREDUCaITBXJZKfLcbeWPNAMSgQV,MAAAQAAAdAEAHAGBGACBRBBB.EAGECBDC.aCDCBDEA.ZEDALCFBhAAA.eCHBPDHDhAGAADAASDAAhADA.OEEHDGBATGDAKFAAfFHEhAFA.cGGC.NIAB.hAIA...,2,-25,-4,21
CDTVgYHKPLfFOMBAEIGcXQbNaJdZReSWU,EAAAGAAA.QADAaACDZADB.RAFAeCDBSAFACCGA.TCFAhAAAVEGBHFEB.LGAAhAAAOAHDACBB.XEEChAGANIAB.dEHADDABKFCB.FGGHBDFD.hBCA......hCAA...,2,-16,10,26
cKCZLRGdPJgVMeNADETFYXOafWQbSHUIB,EAAATAAAFACD...OACAaAEA..QBECHAFABBDDCAHARCGBdCFDhAAA.gCCGhAHA.eCHHACIBXDDChAAAbEFDSFEFIFFA.ZGEA.LHAAhAHA.....hAIA...,1,-10,-13,3
ZELaROHDKCeGTgFXMbPNIVSJUYdBcQAWf,ZAAAEAAARACAHAEA.CAHBGCAAFAFA..MAIB..bCDA..ICEAhAAASCHBUDAAhADAdEEAQDFAhCAAAACALFHBaDDHKECAeEHHTGFAXGCA.PFFBhCBA....hCCA...,1,-1,-14,13
VNQFEDRgIZALbeHcCWdKXMTGSfPUaJYBO,eAAAHAAACADBdAEAKAFAMAGBGCAB..SAHBUCFA.aBCDBAHBhAAA.OCHFQDEChAAAEECARFABZFDBABHBbDGD.hACAXEBATFGAfGFE..hAFA......hCAA...,2,-16,-6,10
SFTBQMYcRDVXgfPNHACKJIEbZGLUaOWde,KAAAEAAAGACALACBOAEAeAEA..FAHDTBGABCEA..MCGBhAAARCEBXEBC.fCBEhAAAHEAAAAEACDHAbEEDhCAAaDHDdGDA.QGFADECAgGGB.hAIA......hBCA...,2,-15,-1,14
OFPSNMTUAQYGcCBWLJabVZdRXHfEDgKIe,GAAABAAALACAaADAZAFB.RAFFHCCADAIBKCDBeAHH.FDAB..SBHDhAAAMDIBAECBQEEAhAAACDCDJEFA.dHABEFCAhACAOEGF..TGGA....hBAA......hBCA...,2,-28,-5,23
GPdTJbcDHfYQOEgIFWZeXKASaUCMLRBNV,aAAAMAAALADARACA.BAHAGAFA.dBHATCCAJBBF.DBBBHDDBhAFAQCECEEHBFFGHeHAAhAHAAAEACCGB..PDHDhAHA...bEFD.......hAIA......hBAA...,2,-21,-12,9
KOcLaNCfYMPFJgZbVWdSHeXIDUEABTQGR,TAAARAAAOADA.LAHBaACA..CAFAMAHBFBDDZBFB..VCCAhAAAdEHAHFCA.eFFHhAAADAIBACFABEEDGDFA.hABAKDBD.fFAE.PFEB.hCAA......hCCA...,1,-13,-17,4
WfgYXcSebaPGANZUHTdQBVDCIMKOEJLRF,ZAAAHAAAdAEAQADCDAGA.MAFAEBGARCAAFBFD.....fBHAhAAAXCGAeDEBhABAaCACADDATEEACEBA.hACAODHDLEGBgGEASFDB.hACA......hBHA...,2,-24,-12,12
eSYabHWBAVQMCdZFEGOXKNRPTgfULIJDc,MAAAZAAAEADEGACB.KAGCRAFF..TCAAUCDBLCGBDAIB.hABAeBBBaCEHHCGBABIBQFAAhAFAdFAAXFDAhACAgFFGfGGAIGDASDDDhAFA.YHAGWFHH.hBAA...,2,-20,5,25
ScILFKPOXdVJRaTfBNeGbZQCEDUgAMWYH,MAAAHAAASACELAEAKBBAOAED.dAGARCDAaAHDBCCAeDBBhAFAZDEAEFFBDDHB.AAIB...hAAA...cGBAhBGAFEFBXGACJFHB.TGGAfGDB.hAGA......hBAA...,2,-25,-6,19
LdQfGZgJTRCKOUSAFHPbYBWeNEVcXaDMI,HAAA..bAAABADBeAEAEAFA..XBFAaAHDMCABdCAAGCCAhAAAZCCATECARCFBKEHBSEFDhACAAAAAFDHD.PFADhAFAYEGF.VFABDFCBLHDAhBHAQGDA.....hCCA...,2,0,9,9
afRELGZeIHMOcKFVTYNgCSUdXAQBbDPJW,QAAADAAA.JACEaABE.EAEAZAFBHAGBMAIBKCCA..TDCAhAAA..gCEBhAEASBDAdEHAABHBbDGDhCAAfEEELEFDeGBAIHHAFGFDNIABCHHA.hDAA......hDBA...,2,-18,-9,9
XSGfNgOcWDQILebdUPJZHCMAYKEBFRaTV,EAAARAAA..aADA..TACASAFHGAEA...fAGBhAAAOAHBDBEBLCHBhAEAeCCBdDGDPCCBHEEAAAAAhAIABDGAXGGAgEEG.QGBAhAIA.IGHAhBGA..,1,11,-26,37
KMUFbZdLOgVcSafAGCXTNYRWIQJDeHEPB,GAAATAAA.RADAQAGCeACEHAFBEAHBKCDD.FBDHdDFA.LDHBhAAAOCCH..VDGBaDAHAEEAhACAXEED.YFAAhAAAIFCADGIBMHEA.....hAFA......hAIA...,2,-12,-2,10
AgJPBKGdceUYWVIMbXfSLENDTaQZOHRFC,JAAAKAAAdACA.UAEA..VAEA.MAIBXAGA.LDDAhAAAECCADCHB..aDABZDGBhAHAHDEBREBBAEIBBFDBGEAAhADAeFFDIFHA.bGDASHCAhBEA......hCAA...,1,-11,-23,12
aFcfbLAHeKCMOGPIBTVdRUXDNZYgSWEQJ,HAAAeAAAMAEAGADABAHAdAFBRBFF.DAIBZBAE.SBDHECAB.hAAAaBFBfCCEhACA.ADHAOEFBTCGAXEEAhAAAgEGHQGCAFGHD.bFGDhABA......hCGA...,1,2,-21,23
gRVHITZKPFJUEWNQSOaDcCYbBGAeLMXfd,eAAAMAAAdAEARADAHAGBZAFB.FCCBUBBA..ECFBQDGAODEBaDHDhAAACAHA..BDEDAAIBLEAAhABA..fEBAhBAAgFFBTFFAKGAAWHEGDGIBYHCAhBEA....hCAA...,1,4,-34,38
IPGFdVbTREBUDcYWZOMSHgLXAJNKefQaC,KAAAeAAAQACCCADA.GAEAdAFATCCAEAGABBHA.DDDB.hAAA...cBGDhABAZDGBMEABHECCLFFDhAAAAAHAfDHAaEDDFGHDRGEAYFBFSGAH.hBFA......hBHA...,1,-3,-21,18
IDGRKabMLUEBQeZYNPFdfcSWJgOAHTXCV,HAAATAAACADBDAFA.GBDBRACFKAEC..aAGDMAIB.LDDAhAAAECABeBHHZEFE..PCEBhAAAdCADSGBAhACA.gGGAADGBXEGAIHEAbFCAQGGChACA.FGBH.hBGA...,2,-12,4,16
IVeMXbENJPUBGLgQHOAcadCZWfKTSDRFY,dAAAZAAAKADCDADARAEAFAFD......ICCAeAHBMCAB.ECCBhABAJBHB.BCEDGCGAhACALEEBHECCACEBaDBCfGDEhAIA.TGFASDGD.hCBAXGCB.NEIA.hACA...,2,-47,-3,44
LMfZRVUOeSCdbYQFTgWNIJKEBAaPDGHXc,aAAAGAAAHACBLADAZAEARCEA.OAGD.eCDBdEEDbEGDQDFChAAAFFAA.TFAAhACAgGAGIECA.hAFAEEHFAAIBDBBBMAIB.fGGE..hAEA......hAFA...,2,-9,-2,7
eJXgaPRWZTIAVGHbUOcCKYBdMQNEfFDSL,HAAAOAAAKADCdAEAMAGB..EAGADAHBeBBA..XBDAhAAAaBGERDDAZDGBAAIBGCAB.hAGAbDEACFFCQGDChBAA.FGHDLFFA.....hBBA......hCAA...,2,-15,-13,2
cWZYODCfdVgAePNRIaSKMUGEJQbBHTLXF,eAAARAAA..aADAMAEAEAGA.QBCAHBDALCHBFAHDZBEBDCCBdDGAhAAAAAAA...IECAhABAKDDDGEFABFFDTGAAhAGAXGCA.YFHBfFDA..hBIA......hCAA...,1,-10,-14,4
gLbRcKVYIPfOAWdJZESHXCeQaTGDFMNBU,dAAAEAAAHACAeADAQAGAGAFAMAIBBCBALDDBRCEA.KDHDIEAAhACAOCCHAAEAZECACFFAaFHDhAAAFDHDUGEB..hADA............hAEA......hBAA...,2,-18,-9,9
BJHXSNWIOZaAdgeMLKGFQbVCYfEcTUDPR,eAAAMAAAGACBQADACAGB.EAFAUCDBRBGBHCCA..SAHHhAFAIEEAZFGBABBBdDGALGDAhAAAFEEH..bGCChBAA.....fGGADAIB..hCAA......hCCA...,1,0,-25,25
TQLeIAKYFNdWcXPaJbCUDBgEVGfSHOMZR,FAAAdAAA..XADAaACD..CAEABAGAEAGAGCABHCDAZCGBRCFATEAAhACAeEAA..AAIBKFCANEEA.hADA....PFFBhAEAbFFADFFA..fGAAOECD.MDIBhAGA.IHHAcGAC.hAEA...,2,-20,-10,10
LJHYWQGVCTIMDNbOScUeEgaXAKFBfPRdZ,BAAARAAAZADBHAFAQACAGCEACAEA..MAGBDCCBOCGF.SDABhAAAeAHBECAAaCDEhAAAAAHAFFHDdEEA.LEHBhACA.JHCA.WEFH......hAIA......hCAA...,1,-18,-20,2
fEcMbSQFPNHILeCDWOZYdGRVXgBUTJaKA,EAAAMAAA..QACAFADDHAFAeBBBDAFAZAFEGCGARCEA.XDDAhAFABCCDTEBAKFCAAAHA.hBAAbEEASFGDhBCA.NICB.LHCA.CGEC.WFHHdGGD..hCAA......hCFA...,1,-4,-9,5
VKOIGSPLMgfadAECDJeXcRNbWYTUQFZHB,EAAADAAAeABARACA......bAFBTAEAQCCBHAGBKCCAhAGAGCEALDFAMAIBaCHHhAAAAAIBXECA.hADAcFFAYFHBZGDA.OHBA.SGFHhBHA...hBAA...,1,6,-20,26
aAPIFfOKGYLWdgNREZVJHXTQCDMbUBcSe,FAAAKAAAGACALADAdAEBRAGFZCCAHAGB.QCACMCIB.BCEAhAAAeDFHAAIB...fEAAhAEAODFC..gEEGhACAEECAXEGDTFBADIAA..cFCDhAFAaFHB.IHHAhAIANIDB...,2,-24,-1,23
RPgEDJQbAGIdZaVLHSKBfMYXWCceNFOTU,dAAAaAAAHACBBADAMAFA..XAEA.CAHAeBBDOBDERCFAEDEBhAEAQBGCGEGAZFAAhAFALDAAKGFDfHABhAHAcDFCFEDD.TGGA....hACA......hADA...,2,-35,14,49
JOQgZMVYWEeIGKSLRDcfFXPAaCbUNTdHB,aAAACAAAUACA..dADAHAEAOAFAZCBA.MBBB..VCFA.EEFBhAAAeBFB.GDBAhBAALFHBRDDBfBHAhBDAXGAAAAGAbFGBBHGC.......hBGA......hCAA...,1,-13,-17,4
HdEWMYQBPLfIRDGXKAFOgTUbCecSJVaNZ,OAAATAAA.UAEAeACE....SAGAaAFAHBECECCBMBBBhAHAQDFBLCCBRCGBhBAAGEDAACIBFEEACFDAcDBChAAA.NAIAdFHABFHA.fGGEDGGB.hBDA......hCAA...,2,-23,6,29
gdbUMDLRcZePXIaYNTAJFHOWSVQEKGBfC,HAAASAAAEADEGAFACADA.dBHAMAFARCAAeCEB..XBDAhAAAaEEH.TBGAAAHAOEHBhAAAQDAABFAAfGFAhACAbDDALEHB.ZGBA.IHFAhABA.....hAFA...,2,-7,1,8
ZgaUWJGRANTcHSdMKeQOXfEFYPCVbBDLI,TAAAHAAAdADA.eAFAQACCOBHDECABFAEACAHA..BCCDLCEAhAAAZCEBaDGHUEEAGFABhAAAACFASCHHhAHAMFIBfGGAPFHBDDDBIHEA...hCAA......hDAA...,2,-19,7,26
OVHcLbGCNYMfSdDAeQRTBJaEXUWKgZIFP,RAAATAAABADB..EAFAUACA.KAEAZBEEFAGAOBHD..HCDChAAALCCBGCGACDGDMEEBhAAAdFFAACIBeGCA..hCAAaFAB...XFFAIHHA...hABA......hAFA...,2,-32,-11,21
OFdNBSYcUJVKaLXbCfGMWHZETgRQDIAPe,eAAAdAAASADAUAEAKAGA.LAGB.CBFAGCABHBCBECGARDEBDAIBhACAAAAAFDFH.BDHAJDHB.hADAaEBB..XEAChAEAMEEBZFGBQGEB.OECDNIAB.hAIA......hBEA...,2,-19,1,20
DZONEdBeCUVfRGcIaWFMQTHYSPbgALJXK,LAAAKAAAZACB.EAEAeAEAUBGARBFA..GCAAaCAA..FCEBMDEBhAAAHDCB..SDFAhACAbEABAAHA.DDIBdEGACECAVFFAhAFAfFEA.IHHA..hABA......hACA...,2,-16,-13,3
dNOeQHgLBbcfIDCPKZSAMWGVEFJUaTRXY,GAAAEAAAFACD.aADARAEA.dAGA..eAHHHCDALDDABCHA..bDBDhAAAfDHACEFA.hACAZEAAAAIBMEHBVFFBUGCBhAAAXFEC.NEIA........hAEA......hAFA...,1,-7,-9,2
TKRQbAdBeOfYCUPgZMDaESWHIcGJNVXLF,eAAAOAAACADA.UAEAZAEB..DAHBEAGA.HBCBGCCA..VCGBhBAALDHBKBBD.REFFAAAAdEBAhBEABFEC..fEEAhBIAgGBBaFDHSHEGIGFANICB.hAIA......hBGA...,2,-28,-6,22
CaUKMWVcOdfXFJLEBATeNZGRHDYSPgQbI,eAAAGAAAHADASADAQAGCCAGAKBHBMCCB...cCGDhAAAdCDAFCFB.EDGFADDAZDEBhABAREAADEIBPEHD.bFAAhAFAaFFC.UGAB.OHFAXGFD..hAIA......hCAA...,1,3,-10,13
MECcOIFVbKWaPGfJNZeAHXBdgDSLQYRUT,HAAAdAAASADALADBRAFAUAGAECABOCCHFCBD..KCFDaCGDGDCAhACA..fEEAhAAAZEGBAADABFFAQFAChACAMFIBCGBA.IFGA.bFCDPHDChBAAeFHH.....hAFA...,1,-3,-18,15
BgAPdWQEOfKRLVICMNDabGTYHXJFSceUZ,dAAAEAAAKACARADALAGB..CAEBMAGBaCAEGCEAHCCAFAHB.eCHFhAAAZDAEAAIB.QEGAhACAfECEIGCAhADAbEEB.XGGC..SEHHhCAA.BGGD..hCBA...,1,-3,-22,19
QfeCPaYNdWcbLFXBMETHIGVKRASDJgZUO,DAAAZAAAQAEAeABA.CAGA.aAED.dAGA..bCABLCCBhAIA.BCHAEBHFHCDAhABAGEDAREFAAADASEBDhBAAJFEF.OFFAfGHA.NIAB.FGGH.hACA......hAIA...,2,-17,-9,8
dPRKgIFaTXecEBMQWLJCbGVSNAHDYZOfU,HAAAZAAAOACAdADARAFAKCADFAFD....aAHBeCCB.ECEFMBIBLCHBhAAACCCD.GEFAhACASCEDAAFADFEB.fDFBhABA.gFFAIHHA...hAIA......hDGA...,1,-11,-33,22
ScWMTbRCLUgKeDOFJQIBENafAGYXHdPVZ,GAAAHAAAdADAZADASAFAMAEA.RCAALCFAKAHBeCDBFCFHQEDAhAAAECHB.aEHBAAABXECDhACA.VFFAhBCATFAA.bFFDCHEA.DHCA.OFHD.hCEA......hDAA...,2,-11,7,18
TCfdcAgEHGbDQNFOeRZLPBKVWYaXMUIJS,HAAAGAAAQADCOADARAGBZCDALAFBKDHB.VDDB.aAHBMECAhAAAUCABSFCAhACA.TFFAdDHAABIBEFCBhAAADGIB.eFGBBHFDXGED...hAIA......hBAA...,1,13,-19,32
LGYMcAfCaHbeKJBNTgUIERXdFZWQOPDSV,aAAAHAAA.eACEBADATAGAUAFA..RCCA.dCCAZDAFQCFChAAA.DCIBLBHBhADAGECBMEHBABBBbDFDKEEDgFABhAFA..EGHFWFHHSHDAhAIA......hBAA...,2,-26,10,36
MQKEcNAUdLBYXeTZGIHaRCgWJVODPSbFf,dAAALAAABADAeAEHGADAHAGBRAFA.CCBA.JCAA.DCHB..bDAAMCIBhABA..EDGBAAFAUFDAhACATEEAZFGF..aEHDhACA.VGAA.SGGD...hAIA......hDAA...,1,-4,-24,20
fbWDHQCYEePXGcFNBAZUdVOLSgMJIRTaK,dAAALAAAMADARAFAaADD..KBDA..bAEDHCAC.QCGAhACAEAGAeBHFGCAAFDEBAEGBZFFAhAIAODDB.SDHHhABAIHFA.TFEA.DGABCHHD.XGCChACA.BEFB.hBAA...,2,-18,7,25
SXPJZfEWKaMUgcADGYVQNIdHbCOeTRBLF,GAAAQAAAdADAHAFAOACCRCDALCHB.SDBHhAAAXAFBZBGBEDGFaEFHMCDBhAAA.gEAAhAEAAAHADFAB.VEEBIGHAeDHHFGDH.fGHAhAIA....hCAA...,1,-1,-6,5
DSNFWbHMaJgOUGYVcATKXQeRZILCfdBPE,TAAAQAAA.RACAZAFBLACB.dAEAEAHFSAGAhAAAFCDDHDABaCHDOCEEGEFAhAAAcDGDADABeFCA.fHDBhADADEBAbEBAMFFB.gGAAhAGAYFHB.XGGA.hAFABHCA.,2,-15,19,34
CLJDKMVGgOFTBRAfZQeUNXPHYbWdESIca,ZAAAeAAAUAEA..XADAHAGD..bCABEAGA.SBGAhAAA.aCCALDDAhABAKDDDGDGAFDHDREBFADGBQEAAhABAPFDCdGHA.CFDAMFFB.gGAGhAEA....hAGA...,2,-7,-7,0
QeBLHXcEKWTURDaSCYbVMgAGIFZfNdOPJ,GAAAZAAAdAEAOAGBQADALAHBHAFAECDBKCAA.TCGA.hABARDEFaDAHCDDA..bDFCMEIBhAAA.AAHAFGFD..hACAfEBA.PFGBBHHD.WFHBhACADICA...SHCAhADA.,1,16,-34,50
FJKWCaMNHGXOcEPbdUSLTIAeBgfZQVRYD,eAAABAAAZACARADA.FAFAKAGC..CBHA.aBGEHCCAGCCA..OCFDhAAAECFBdDHALDABhADAAAAAQEACDDHB.MEFBhAEAXECA.bFFATGGA....hCAA......hCBA...,1,-12,-25,13
AYSeIOZWbFcDGCRJadHUEKQBMfNPLTVgX,eAAAZAAAFADAGADARAFF.dAFBHCAAEBGBQDBAMAIB..fCEEhABALEFATFDAhAAAXCGDAAIBSGGAhABAOEEB..bFGBCHEA.aHAA....hACA......hAHA...,1,-1,-16,15
eRcEUSDFKOYJMabAIgVCPdZGQTBWXLNHf,VAAAdAAAGADA.QAFATAEABAGBLBHBHCDARCGFECBFDAIBhAAAODAH.MDDBhACAAADACDCDZFEA..XEFChADAeGCGSGHHKFHBaFDD.....hAFA......hAIA...,2,-12,-8,4
ePAEQTSOFbaIBdHNWCJfXYGMcVURDZLKg,EAAATAAAFACD...aACAdAEA.HAGB.CDDA.XAEDGDFAMDIBhAAAUBGARCCBZEBALEFAhAAAeGAAAAGB.QFDDhAGA.ODBBBHEA.JHAAfHGFhAIAcGGA.DIBA....hBEA...,2,-11,4,15
TaBUFJZgDdRNLWPIVQcXCbKASMfOHYEGe,MAAAHAAAEADEGACBeAFEBAGBFBFD.ZBFEdCADRCCBLDGB..hAFAICHAQFEAhAIACDCAAEEAOEFC.aGGAhAAA.JHEADBBB.WEHH......hBAA......hCAA...,2,-22,-14,8
WfSHDdCUKFXbVgJNLaZBPQTYMGecREOIA,SAAAHAAAdADAKAFAFADA..XBGA..bAFDVCEBNAIA.hAAAZCAABBCAQEGAhAAAMCEBeEGBEFAAAAHADAHBCGGDJHDAhACAaFCB....TFEA....hABA......hCAA...,2,-28,1,29
ZEfOMVFgdaHCJPceQYWBGRSUTbIADNKXL,KAAAZAAAEADEMACA..FAFAdAGAHCAA.CBHA.JBCB..eCEBQBEAhAAABCFBRDGBUGGB.hAIA.bDEAADIBDEEBLFFAhBEA.OEDB.......hABA......hACA...,1,-22,-23,1
MRUdJAPNBfQIeSTLaDYZGHXCFWbgVOKEc,BAAAQAAAeACALAGBaACE.ZBCEHAEBFCAB.bAGB.OCDBhAAAEDDAREFA.dDAAAAIB.fDGEhADASFEDTEEAhBGADCIB.XGGACGBA......hBIA......hCAA...,2,-28,-2,26
AGFUSTQebNZROXMDEYLWBIafcJHCgdVPK,GAAASAAAeADAZACBRAGB..MCDAEAEALAHBBDDA.aBEEfDFAhAAAHDEAdFGAKEDDhAAAAADATEGAQGDAhABAbFDC....NIABDGIBIHBA...hACA......hAIA...,2,-14,-1,13
DOKJTEIGfVZLQYMBHARcSaXUWeFbgdPCN,RAAAaAAAUADA..eACHFAFE.dAEA..CBHA.OAGBKCCD.EBHFGCFAhAAAZDDALEBB.hABAMDIBHEDBAAHAXFDAhBAA..WDHBgGGBDFHB..hBBA......hBEA...,2,-36,-15,21
YFIHcDBGEAXbNULgZCKPfSVMeTQOJadRW,XAAAUAAAZADAKAGC..SADA.eAFHTCDAQCGAhAAAaBHD.RCDBFDAAhABAHDFABAHAAAEALFCAhBAACEADfEGEMFHBdHCBIHAADFIBEDCBgGGAhADA.OFFBhAEA..,1,0,-18,18
LefVXNGKgZRQMSPBJaUWOFECTAbYdcDHI,dAAAHAAAeADAXADBGAGAZAFBRCAA..MCEBBAHA.aCACUEABFCHBECCEhAAAAAIB...bEEBDDFBhACALFBAVFGBKGBDQGGAhACA..SGDA.hBFA......hCFA...,2,-13,-1,12
WdXYcbfQIUELHRDMeVAJPNCSKgFBZOGaT,JAAACAAAKACABADB..GAEA..aAEDdAGB...XBGDhAAAbAFD.QCAAhACAEAHBHCCBREFAeCDBACCBSFEDhAIAZEAATEGA.cFFCfGHA.hAEAIHCADGEB..hBAA...,2,-37,-4,33
RMECYADFITHeJSPGNacUVfgWQOZBKLXdb,FAAAHAAAeACHSACEGAEA.aAEDUBGA..fAGAhAAAQEAAZCCALDDBhAEAdCHAREEAEFHFAAGATFFAPGAANIABhAGA............hAIA......hBIA...,2,-15,2,17
YdMKWICNDXJLbRAeFEZfVgUTQPGaHcSBO,EAAAZAAA..VAEAUADA.QAFAGCAAHCCCBAHAdAHAKCBACDFADACAhABALDEA.ABCAeDHHhAAAfDHA.TFFAhCAAaFDAOGDC.MICAIHDA.hCAA......hCBA...,2,-20,-8,12
NEQWcYIdRTMBKXOFJCPbZDGHVAeUgSfaL,eAAASAAALAEAEADA.QBCD..cAEDdCFARDGFMAIBhAAAXAGDFDDHCFAAZCCAhAAAHFDCAAIBUDGAaGAE.YDAAhABABGHAOHCCbFFCDEEB.....hABA......hAFA...,1,3,-5,8
aICOGVTPYQcLNAgMXSKbWBeURfJDZFEdH,MAAAKAAABACBRACA.DAEAEAFE..HAFC.CBDA.GCCB.TDGAhAHAQCEALFCAhAIAACCBSCGAeFHFfGFAhBAAZEEAaEHFIHHAOBBB....hAAA......hAIA...,1,-3,-40,37
aEDRTWHGMXPLIdcZNgQVCYKOAfJBbeSUF,BAAAeAAAFADDEACARAEAHAFA.GCDBMAIBLCAAdCHAZEEA.QCEBhAAACFAAOCCHAAAAJDGBUGEAhAFADEEB....TFAAhACAPHAA.IHHAcFGD..NIEB..hAHA....YHAGhAFA.,2,-26,3,29
RMcGPgJKHOLSfCbXVNEUTeFBYQDWAZIad,aAAARAAAGADA..JADAHAFALAGBCCCD..bCFAXBBAhAIA.ECEAeDABBDHAQEFAhAAAABIBdECA.MFABhABAgEEASFEDfFHA.hADA......hAFA...,2,-24,-8,16
OcWSAGPHXKaNRDTfEICJbUgFdVLQMZeBY,HAAAaAAA.RADFDAFAEADA..CAFA.UBGA.dCADLAHBZCEBBDDDOBBBhADA.SBFAhBAAAEGA.GCDAKEHBTGFAhAAAfDFB.bFFA.FHFAMIAAeDCDhCAA......hCDA...,2,-27,-10,17
ecYNDaPOKMHdQTIWXZCBEFVbSJGfURAgL,eAAA..NAAADAFAaADDKAFAHBBA..dAHATBFA..XCCChAAAZDBAECHFFDFHSCFBhABAGFBBUGGAADBBLDHBhAFA.PDEDMIAA.QGFDhBDACAHABEHA......hCAA...,2,-20,-3,17
dKcTYVEDARgZfbJNeaBILPSQXWUFOGMHC,RAAAZAAA.JADAeADE.aAGALAGB.QCAAXBDDFBGDhAAAGCDAHEEAdEHATFCAhABAEFCBAAIB...bGEABFFAhABASCCDOHFAMICA....hACA......hCAA...,1,-4,-15,11
OXAQUPFLBDacdYgZVMSHTfRbNEJKWICGe,QAAAFAAALADAaACEdAHA.ZCCA..MAFAHDFBRBDA.EDHBKBGCCEAAGECAhAEAeCHFADAABDDDhAAADCEA.....gDAAhADASGHBbDFD.JFDBIHBAhAFAOFHD......hBAA...,1,-2,-16,14
GTWbDXFcPKNaOVCgIMELAUBZdHQeRJSYf,ZAAAHAAARAEA.SACEGCAA..TCDAbAEDFAGAKBHB..aBGCCCGDMACAhABAACCABDDD.eDFAhAAAJEFA....fFFEhAHAXECCPEHDNIAB.OFFBIHHAhAIA.....hCAA...,1,-10,-14,4
HeOPUZBdEMDaWcgYbALSfGKFQRIXJTVNC,LAAAGAAAQADARADF.JAFETAGACBHA.HCAAeCDBOCEDhABAZDEBEDGAaCGC..hACAgGCBAAFAKEGAXGEAhAIAPFHBBHHAMDABDICA.....hAAA......hACA...,2,-9,-8,1
ATgabMSFDfOXJGKcWHBNPYIQdeRZELVUC,aAAAMAAA.DAEAOACDGAGAKAEA..HBBABAGB...PBHDhAEAQCED.REBAEEHFhAIALCEBCDBDAFFAbGBAfDGEhAIA.XFGAcGGC.YBBFhBAA.eEDD.hBAA...,2,-22,-15,7
BLOUVDXTISaecJdCPQGHYfgbMFNWZKRAE,EAAALAAAUADA.XADD..TAFAaAFA.eAHHdBFAQCAAhABAHCBA.fBHAhACAbDEDMDIBFDGHhAAAZDDAADIBOHAADEHBSFFDCGHD...hAHA......hBCA...,1,-10,-12,2
WFLGIfJDcRQgCeHAaMYPUBXEZNKTObVdS,aAAAMAAA.UAEAEADAZAFB..KAGAOAHDdBBAFCGDGCCA.IDAAhADADCIBRDBA.QEFAhBAAeDFDHFGBABBBBEHAhBFA.NHBB..........hAIA......hBAA...,1,-8,-32,24
aFZVAXbJMEgWYTPURcDSINHBfCGLeQKOd,XAAAMAAA..EADA....gADATAFARBBBSAHBhBAAHAFBCAHAeCHFQCFBhBBAdDAAZDDAAAAAbFDBYDEFhCAAUGGADHAABDHA.LFHB.aECDhCDA.FGFDWHAA..hADA...,2,-9,3,12
MKRAEGBTeLbNQWIaUCgSdFPVXfcZYJOHD,EAAAGAAABACAeADALAEAQAGA.aCDACBHAdCCA.FCFBXCFDhAAAZDGB.ODAHhACAHECCMEIBADDATFFAhADAbFAC.IHDA.SFHBfGEAhAAA......hAFA...,2,-22,3,25
XbdBAHIVgYeLfDPMQRSCOZWTFaKNUEJcG,HAAAVAAA.eACELADBDAFAMAIBRAFA.OBEEZCFAFDCH..aCCBKEEAhAAAUDDAEEGE..GGABhAFAdDGAAEIB...gGGAhAGAfGEA.QGGA.CHBA.hAAA......hBHA...,2,-14,-5,9
cYfABeVZFbdaJRTQIUXWDGgESONKPMCLH,eAAAZAAAdAEARADA.QAGAUAGA.DCAAECCB..OCEEKCEAMDHBhAAAHDAA...fDHAhABAADIBFEAAaEEAJFFFTEEAhACA.XGAA.GGEBNIBBCHHA..hADA......hAGA...,2,-21,-6,15
KROQJgLTcBCFaPNbdfWZHIYESXGADVeUM,eAAAMAAARACAQADA.LAGBTAGACBBDaCCB..bCDAdDDAhAAA.ZEGBHDGBEFBBXFDAhABAAAFADCIBKECAOEEDhAIA...gGGA...hAIA......hBFA...,2,-12,-12,0
UDTBaZNYfcSKEGPMOJbLeAFCQIXdVWHRg,QAAAdAAAHADARAGFDCCBaACE.ZDAF....fAFAKCFDEDDBGEGAhACAMAHBOCDBhAAALFFDAAIBCCFA..XGAChADAgDAA.TEEA.BDHA.hAFAcFAD.SFHBhADA,1,-12,-15,3
ZYPdJUDQBCebGTcKERgVAOLHSIWFMXafN,HAAASAAAFADAaAFDZACB.dAFADAHBBAHA..eBHHGCGATCCAhAAAECEBREBA..ACABLDFBhACAMFFB.fECEhAIAPHAAQGGBCEEAKEHB....hAAA......hABA...,1,-12,-15,3
aCdZLfMGeIHScNTAYQBVEgKOUXRbJPDWF,QAAAEAAAKACA.OACCRAEF..JAHBDAEAFCCBdAHA.ZBDEMCGBhAAAeDEA.HEFC.SEDDhAAATEAAAAGABDEDhAEAgGGAUFFB.PHBAaEHF....hBHA......hCAA...,1,-10,-27,17
cDSGAQXOCNTbgWVRFBJEdLIaKPZYMfUHe,QAAACAAA..bACAVACABAGAEAFEdCAALAHB.aCDEhAAAZCCA.MAIBHCFBeCGBhAAASEEDAADAOECBhACATGGAREFBFGABKHCAfHCBDEEB...hAGA......hCDA...,1,2,-15,17
VIbdTJXLCGUZFDcgQaNSPeORMfKWHEYAB,BAAAVAAA.dACA..JADALAEA.GCDAZAGBDBIBQCFAhAAAaCDA.SBHHhAFAeDDBRFEFKGAAHFCBAEIB.hAAAbFFACGCB.FCBH.gGAD.OHFChAGAfGHA..hAGA...,1,11,-38,49
bKOBdQPCVeLRWZfJcEgSHXDMGNFUIYTaA,OAAAdAAAQADA.CAFA.eADALAHBRAGBZBBAJCFBEBGFHCAChACAMDDB.GDEA.FEGAhADAIEAAaEDBAGGABGHAhBAAPDHD...fFGE.SEEDhAEA.DFCBhAIA.NIBB..,2,-30,2,32
dXNGMbPCgDcHLIQAKeZBWEOYJVRFUaSfT,eAAAZAAAEADEOADC..VAGBRAGFFCCAUCAA..aCED.SCHHhAAAdDDAGEGAMDGBhABAbFAB...CFAADFFBHFEBhABA..IGHAADGB.BHFA.YGAGhAFA....hAGA...,2,-27,-7,20
EUcYPXHOJZMKSITefDNVGdQbWACRBaFgL,RAAAaAAALADB.EAFAUADA...PAFCHBFCZDCA.MDGBhAAASBBDeDHFDFAAhABAGCEBbFAA.ACHAFDDHhAIA.gEGAYFHB.OFED.KGHBhBAA......hBDA...,1,3,-23,26
DCSAOWaLGMNePHXKVIgdJRFYbQETZcfBU,aAAAGAAA.eADAHACBKAGAVAEAdCDARCFAFBHD..QEABhAAAEDEAZEAABEFACEFD.AAHALEHBhAEAMEHB..XFCAhACAIHFA.YBBF....hBAA......hCAA...,2,-15,-14,1
ZgdXKLMQaCOSETPFeHAVfBNRDIUcWJGYb,BAAARAAADADA.UACA..JAFBGAEBZAGB.dCFDLCCBMCBB..hAAAaCHDSCEDhABA.EDHFTDDA.hBEAeEGBHEFBAAHAfFAEIHHA.YFFFhAAA....hAFA...,2,-33,-25,8
ECeGPLfYKHIUNWTXZADQgOFacMBJdVRbS,QAAAFAAAMADABAGAdADARAFA...ECEFeAHHGCGALBDBhBAAKDBAHFAAUDGB.TFBAhBFAAAFAOEFB.aGDDVFEBhCAACGGD...fCCA.IHHAhCBA....hCCA...,1,-5,-25,20
fBceQRTWOPMCFVgANaYHdXbDESLGKZUJI,aAAAHAAA.dADADADAEAFAGAEBZBFE..UCABJBBFBCFDeDDBRDFA..hAAAOCGDMFAAFFFHAAHA.hBAA...XDCDhBDALHBAKFEAfHGF..cGFDhCAA.WFHH..hCDA...,2,-42,4,46
TPLJcbFXHZGgWdAMVCDafIYUBEeRNOKSQ,MAAADAAA..aABE..fADAUAEAEAGA.RAEFKAGC..TCCAhBAALBBB.bCFDHCFChBEAGEDAdEEAABIBCBHABDDChBAAeEHFSGEAQGGA.....hCAA......hCBA...,1,-12,-18,6
DGgQOWNFfBKdUJTCSYIAbXaZMPLceVHRE,aAAAZAAAMACALADA..eAEAHAGBEAHFGCCA.QEAChAEAOCCBFCGHKBBDdDEATEFAhAFASDHHAAIBbFDDPFHDhBAARFCBDFGB.........hABA......hCAA...,1,14,-23,37
LZDMVSdBceaCQINYFGgAPRXTHEKJOUWbf,RAAAHAAAEADE.OACA.UAGA..bAFBZBEBMAIBdCCAeDFH.hAAAaDHBQCCAhABA.IEFAFFHDAGGB.hAAATFCA.KEHB.fGGADIBA.hBIABCEANIEB.YHBAhBHA..,1,-7,-18,11
KALUDMfOXCdYJaTeWVbGFINSBgcRHZQEP,LAAAMAAA.XADDdAEAaAGA..eBBAVAFAGBFA.FDDBhBAASCAABBHDREGFHFEBhBBAECHFACAADGIBCDDATEFAhABA...bFAA.gGDH.hBCA......hCAA...,1,-10,-13,3
DQYXWfEadeUMKFATJHbGSPVgBNIZOCRcL,HAAAGAAASACE..gADABAFAZAGBRCCALAGBhAAAQEEAXCDAhACAEDHFeFAAMAIBABIBbGFAPEABhADA.IEGACGCADIFA.fEEEhAEA.dGCA.FFHD..hBAA...,1,-1,-7,6
ODLRUKFCSTXJecZfIagNQBPGbAEMHVYWd,HAAAVAAA.dADALADBRAFAFCAH..CCCD.TAFA..eCEFZCFAaAHDhAAAQCGAGEEAEDCBhAFAMEGBOEHBKFAASFEHhAAAJHAA.fHGF.NIAB.hACA......hAFA...,2,-16,1,17
JaALBTHOEDFcIZKCGdYVSPXURfQeMbNgW,TAAAHAAAEADE.FAFAZACBGCABdAFA.SAHHXBGDRDEBeCFBhAAAMCAB...bEBBgECAhACA.aDHBhCAAAAHALEGBDEIBKFEACGHD.......hCDA......hCEA...,2,-14,-2,12
ZEaPSbfgJeMQUNGOXdcWHBTYCLIDARVKF,RAAAFAAAEADE..aACD..SAFB..bADDJAHBeAFAMCCAhAAAQCFCGDDAdDGDhABAHEFCTFGALFAAhAFAADDBKGFD.fGGE.NEEAOBHFhAGAWHAA......hBAA...,2,-10,-8,2
fUNCOKgBJVSTYWeIPcHMbEDAZGQRXdLFa,GAAARAAAdADALAFAaADAUAGA..OCCBBCDA..SCEHhAAATCGAeDEB.IFDAhAAAHDBBEDGAZGAAQFFAhACAfEHAKFHBgGEAYGBG..hABA......hAGA...,1,-5,-14,9
WGJbaQKMOeUXPgLHSFRTfdcCVDNIABEZY,EAAAZAAAGAEA.aACAMADA.eAFAXAGALBCB.HCFAhAAARCGBdDDACBEDDEEBAAGABFFAhABAJEHBKFFBOCCH.PFHDhCAAFHCA...fGEE..hCBA......hDAA...,2,-19,-16,3
OgRIYVNeDcGJLKBAPbfHFUZCdSQMXTEWa,...bAAAHAAA.ZADBdAEAMAGBEAGAaBGERCGFVDAA..eCABGEEAhAAALDDAAACAFAHFSEHHhBFATEGAOEBDhAAAIHHADFDAKGADfFCAQGGB.WHDGhABA.....hCAA...,2,-10,7,17
dSUWTZLcCYKGQNJbaBARMEXHePgfVOFDI,EAAAHAAA.eACE..fACAFAFAdCCASAHHTAEAZAGBLCFBhAAACCDAGDEAQEDAhCAAbEAABDHARGAAMDHBhCEAXGGAgGGADEAA......hDAA......hDBA...,1,2,-8,10
RUFHVaTDGAXeKNgQfYIEdWcJCPSBMbOLZ,eAAAKAAAQACC..fADAEAEEdAGA.JAFASBHHhAAAbBED.ZCDBRCGBHECAhAAAaDGCGFDBACCBXFGAhABAYHFGcGCC.BGFDMIAA...hAIA......hCAA...,2,-11,-3,8
PKfFSaLDJVIgBTYdHNCMcXAOeEQURWZbG,EAAARAAAZADBGACAKAFA.FAEALAHB.DCCBIAHA.TCEAhAAAHCFBMDAB.hBCAAAAAeEEBQCGChBEAUGGA.bEECSFCBaEHDgGGGdHCD.NICB.hCAA......hCBA...,1,-9,-10,1
KODeQCWHMBNfTGSgXcJbFLAZPYaEIdURV,ZAAAaAAA.EADEdADA.RAFA.OAFA..eBBBQBFDHCFCMDBBhAFABCAA.TDDAGDDAhAGAXDFDbFGBADDBPFCBhAIAIGGA.KCCDDGGBCDHANIBBSGEHhBAA......hBDA...,2,-14,1,15
fEQgXeFKCBUWaAHJYSRZLPcTONGbIMdVD,HAAASAAARADFZAFBLBHB..TADAGDAAMAFAdEEAfCCEhAAAEBFAQCCChAAAeFCFCBHABDAAaFHBAACAJHDAhAFAcDFA.bEED.DDIB.FGGA.WHDGhABA......hADA...,1,10,-20,30
IFQgRPfMVOKeXTDHbYLWGSacANZdUCEJB,dAAAEAAABACAQADARADF.MAGBKAFC.eAHBDAIBHBGBLCCBGCEAhAAAaCGD.ACCB.ZDABCEHA.FEEBhACA...fEHAhADAXGCA.bGFASDDDNIAB.IGGAhCAA....hCBA...,1,12,-32,44
fPJZMFeSGXLRAWIDcaTUYEVbBCdKNOQHg,DAAAaAAA.UADA..EADABAFAdAGAKBBD..QBBAHBEBfCHAhADAZAGBeCHHGDCAhAIARDEBAEDB...IFFAhBAATGCA.bGEAOFHDgGBD.MEIBhBGASGGD.hBIA...,2,-27,-7,20
BdKEaHORbJfTgMFGXYDAZNcQCSIULePWV,ZAAAQAAASACELADA.eAGHPAFABCDA.ECHFHBEAhABARDEB.bDDAJDCFTFGAhBIAMEABGGEBDCCBACIBCDHD.hCAA..WFAH........hAAA......hAEA...,2,-12,-11,1
IOANFKagTJUCZRHDGLXPEYVQBfWMbdeSc,KAAAaAAA...TADACADAHAEBGAFALAGBEAHB.QCCChADABCAAMCCBeCHH.SBBDhAIAODDBAACAFDHBgEEAhBAAZFAFRFDFXFFDPFHDfGBAhBGA.....hAAA...,2,-10,5,15
WScDgLOEZTYQAUBPNJKVGRFefCadIHbMX,BAAAJAAAGADARACAFAFA...eAFACBHA.dCGAHCAA..MBIBSCEAhAAADCCBLDABhADAEDGAZECATFDA.AAFAUFFAhBAAKEHBaGFD.IHHA....hACA......hADA...,2,-31,-12,19
BfJUWLZdYHCQEOgaMIDAcFKPXSGTRNVbe,KAAASAAARACF..VAFAeACH.BAEAUDEAZAFBHCABEAHFaCEBhAAAMCIB..ACIBFDGDGECAhAAA..bEAAfFAEhACALFEBdGGAQFGD.OHEChAEADEAA.....hABA...,1,-1,-12,11
BVANDRICOHXcdbEJZYMfFSgeKUGLTQPWa,RAAAOAAAHADBdAFB.EBGBZADB.MAGBFCCH.eAHBGDAALCCDhAIATDFAQDEDhBAA.aCHHAAAADAIBCFBDbFFAfEEEhADA.KEHBPHFCBFDDIGGAhCAA....hDAA...,2,-12,-2,10
HCegFUEYXcDOKRAdJIMSNQPaLfZbBGTVW,dAAAMAAAQADALAEAZBBAGAGA.TCBAHCEBeAHH.hACAFDBAEDABXEGAhAFAODEBAAGBSGAAhAGAaDFDbFBDBEHACGDAgGGBUGGADFDB.KHEA...hADA......hAIA...,2,1,5,4
TfAPEHRMBUaOQeCFLKZIbJXWdNDYgScGV,HAAARAAAMADAaACA.eAEHLAHBZAFB.JBDBdBHA.DCCB..SBFAhAAAGDCATEGAhAAAABFAEDFBBEEDQFEDhAIAKEHB.IHHAXGDAWHCANCCA..gGGBhABA...hCAA...,1,-2,-18,16
aJcAKWGSYbHQRUIPOBXLTMeNgEZfCFdVD,GAAASAAAHADARACF.IAHABAEBLAGBeCDA..ECGAZCDBhAAAFDCHdEGAaDAHAAIBKFEBbEEA.hAAAQGBA.hACA.OFHDMEIB.fGAACHHD.DEEAhADA......hAFA...,1,0,-20,20
WfAVcGQXNFZTaOSdeRbEUCBYgJHLPIDKM,GAAAQAAAFADAZAFBaACE.dBHA..RAEFEAGEBCDA...JDCFHCFBhAAALEEADCDBMCIBhADAAAAB.XEDDOEHDeGEEhACACFHDgGGG.KHCAfHCBhAIA.....hAIA...,2,-18,-10,8
CgfaPNFXBMbGZHEVSIRTdJeKLWYAODcUQ,DAAAQAAACACA.aACEFAEA.BAHAGAEAHBCCEAGA..SBBDhAHARCGBdDAAeCDBLCGBhBAAABIBOEGHUDDBfGAAhAAA.NIDB.bGDA.IHHA.hADA......hAGA...,2,-30,-4,26
FHDTBbEcWLeZMGUfKdIPYOagNAQJSRXCV,QAAARAAACADB.HACATAFAEAFELAHBZCCAGCGAKCDAdECAIEAAhAAA.OCFDhAEAaAHFAAAASEEDhAFAFEEHbFCDeEHBMFIB.fGFAgGGD.hCAA......hCDA...,1,16,-23,39
fBGZQWERJYCUTXMacbAdNDSHIKgeLOVFP,dAAASAAAHADAKAGCeACHLCCA.FBHDBAEAZDAA.EAGAREEA.CBHATCEAhAAAMEIB.aDDHACGBDFAAhACA..ODGDhABA.fEAAWHEA.UGCA.XGEAhAEA....hAGA...,2,-19,-19,0
BRZYANEFQbWKIgCOcVfSPLdJXHMeUaGTD,EAAAQAAAKACA.CACA.OAEA..fAEALBFAdCCAhAAAHAFBeDFAGDCATEDAhAIAREABAAHAbEEB.gEGAhAAASEHH.XGDAaGHDBCHAYHBAhBHAWHBA.IHHAhCAA..,2,-11,-8,3
eGSQTRXPbWDHVCUcIaAEMZYdJNOfKBLFg,EAAAZAAAdAEA.OAGBBACALAEA.eAHHGCAAQCCAhAAARCGFbDDB.HCEDCAHBUFGBhABAaDGEAAFA.MFGBNICB.hACAFFHB.TGCA.......hADA......hBEA...,1,0,-17,17
KgePJBdEGQUFSIDfMLYZXbARcaCWVOHTN,RAAAaAAACADB...OACDHAEBKAGA..eAEABCCAEAHFGCGAFCEADBBBhAEAMDEBZDEA..ACIB.VGAAhAAATFAA..gFEHhABAdFFASEHHfGHAYHDAhAFA......hBAA...,1,-15,-17,2
gTHAEZUVOQYWLCDGfXcaBdSIFNPbJKReM,EAAAZAAAOACA..QACALAGBGCDAXAEAaBFBdAHAhAAAFDHDbCCA..RFFBeGCGhABAMDGBHFAAAAIB.YDHBhAFADCCB.BEED.SHBAhBHA.IHEA.hCAA...,1,6,-19,25
GdHFSfIMabRcQUJKYCOVZeAPXgBNTLEWD,XAAABAAALACADADA.HAFBFAFD.SAHBMAHB.RCCAQDAChAAAKBDBOCHDeDBBhAAAACCA..gDFAhADAEDDBdDFAaFGDbFGD.JHBA...YEEFhAEA.....hABA...,2,-30,9,39
BFXcQdKUGRbMfgDVAPWLJOZEYeSINTHaC,LAAAZAAAEADE.eADHSAFB..TAFAHBGBaAHFFBHDQCAAhABAdCAAGCDARFCBhABAbDEBMCCBDEEBAAHAPFFAhACAOEHB..IHHABFAAKFCB.fGFAhACA...hCFA...,2,-6,-1,5
NLQIfdBPAMgWUXRcbOJYTEVGZaSCKHFDe,MAAAUAAARADA..OACE..TBGAEAFEZBBAaAGAKBHB.HCEBhAHAeCDBLDGBQDAAhADAdGCAADDBXDFChAEA.bFCDYFHB.SGFDhAIADFGAfGGA...hBAA...,2,-16,-6,10
ENYGeOZdBJLMTDRSgAIUbQHFCPKaVcXWf,UAAAHAAACADBKADA..aAED..XAFBEAGAGCABZBGBBCDALCGBhAAADCFB.RDEFABIB.bGAAQDAAhADA.FEEHhAIAcGGA..fEHA.NICBOGFChBAAMIEA...hACA...,2,-24,-7,17
cMQFUGCdVIgSEBTLNDJYPWeOfbXKHAaRZ,RAAAZAAAMADAQAEA.GBGAdAHAIBEAECAALDDB.hAAADACAPCCBeDFBbGBChABAHBFB.ADIBFEDDCAHBSECFhBGATFFA.YFFFfEHE.aHBAhABA......hBHA...,2,-22,10,32
OLIaeBZVSDCEcUYFdRbPfTWJgHNAKMGXQ,GAAAQAAALADAeACAZAFBDAHBECDAUCDAdCGDRCGF.....hAAAbDCATDAA.gFBAhADAHEFBAAABMEABhACAOEHDaEHFSHFACAHAFFFB.WFAHNICB.hBFA......hCAA...,1,1,-1,2
FRKfPbUdSAEDNXCGQgZTLOWaceJYVMHBI,EAAAXAAAGACAZACBLAEA.aAHDeAEA.VBGBHCEAFCEBhAAAREEAfCBEhAAAUEGBAAIBCFAA.TFAA.ODHFhAFAcFEC.........hAGA......hBCA...,1,1,-22,23
EMBfKDFIHePYSAacbTGRVZCOQXgJdUWNL,aAAATAAAGACA.RAEA.ZACB.QAEA.XAGAhAAAdAHAUDFALCEAEEAAMDIBhAEAKCADFEDDHEEAeHEASDGAhACAABBB.cGGAbGCC.OHAAhAHA......hCCA...,2,-6,-3,3
FbZNWafBXGTKcUgQEMYDdPOeJLCASRHVI,HAAAFAAAZACBaACABAEAGAEA.KAGAUAGAECCB.DCEB..dCHA.eDFHhAAALDFAAEEBRGAA..hBAAIFHA..hAGAbFCAfGGETGGA....gGBGhBGA...hAIA...,1,-7,-36,29
EBafLUWdRFVHTMKZIXYQbGgCAPJcNSeOD,JAAASAAA.eACHEADEBAFBLAEAdAHARCCAHCEA.MAIBhAAAZCFF.XECAQFEChBAAGGABACCA.cFFAhABADDIBaGHBfHEF..FHBA..hBHA......hCAA...,2,-29,8,37
dRXPZCWbVGMNBSODcIEJLgUHeYFafATQK,TAAAdAAARADAZABB..CACB...VBGBGADABAHBDAFA.EAHFLDDBhAEAHBFBeCCBFDFHAEIBQEFBhAAA.XFBChBFAbFGD.MCIBOFCHIGHA.hAGA......hBAA...,1,5,-25,30
NHabICOTAPdgfcDeGULYQJKVFMZESRXBW,dAAA..fAAAeADAGAGALADAQCBAKAHBMBCBECFBRDDFhACABCAAHEABaCFAbFFAODCDhAAA.AAEAgEEAhACADDABYHFAFDHD.ZGDE.SHAAhAHANIAB.CHGA....hADA...,1,4,1,3
OLUgCNPMdaeIRFSJGTYXfAWbVQHBZKEDc,VAAAHAAAZADB.EAFAOADALBHB.CCAD.MAHBdCCC.eBDFRCFFFEEHhAAAGCEA.TEGAhAAAfFCAAAIB.QGGAhACADBGBgGGAaHCE.....hADA......hAIA...,2,-14,-4,10
WAGXRISPUZEQYgVLCceFOHabJDdMTfBNK,RAAASAAAZADB.EADAQAFA.VDAALAGB.hAAAeBDAHDFAbCCCdBHAMAIBhAAATFCABDAAKFFDAEEAGEFAhABAIGHAPGCC.....hABA......hADA...,2,-13,-4,9
WgLeTOHNdBMYSDEZPfAUaKRGIFbJcCVXQ,aAAARAAAGADA.FAFAJADA..CBHA.QAGCLDAA.eBBBHCFAhAAAdDDAMEFBDCFBECHFZEGBACCBhABAKEGD...bGDCXFBAhADA..WDBD.....hAIA......hBFA...,2,-21,-12,9
CcVaORbfYGPMDHAELdFUKQZBWNeXIgTJS,EAAAdAAAKADAZACBBAEA..eAFE.XBEATAGA..CCBC.aCAEhACARCEA....bECBGCGAhADA.MDDBHEFAhAAAACIBLEEBQGAAIHHASCHHhAGA......hAIA...,2,-19,-19,0
HMLXPQRAgCbSEFfKUcDeWNBTdZIVOGYJa,CAAAEAAAKACADADA...eAEABAEBZBCAOAFDGBGA...aDBAHCAAhAAALEEBQDEChACAAAIBSEGDfAHAhAHAUGCANCIA..dECAIHHAVGFA...hCAA......hCCA...,2,-21,-11,10
CVXJQegMRBfbaOWESTGYLKdZFIcUPHAND,CAAAXAAA..eACARADABAGBaAFDEAHBGCDB.LCHBhAAAZCAAFCEHUDGAHDAAAADADFBAQEEBhABA.MHEAhAIAbFBASFFDKGCB.dGGA.IHCAhAAA....hACA...,2,-24,-1,23
gHeYILBRTQaOAZcCDEbUMdPNVWKXJGFfS,ZAAADAAAEACAMACA.dAGA..VAEAKBEBGDDAFBBH...SBHHhABAHCFCeCEDLEBBhAIARDCBaAHFAEGB.CCCDUFGAhBEAPEHD..XGEDfGGE...hBGA......hCAA...,2,-15,-12,3
XKfYRaEbVHJOdeTPCQNBGgULSFDcWIAZM,ZAAAMAAAKADCRACA...EAFAHAFB.dBHAeAHFTCDAQCAAhABA.GCDALEFAhAFADCGBIEHAAAHAfBBEhBAAbFCD.OGEA.CHEABHHASFFBhACA.FHGE....hCAA...,2,-12,-7,5
PRMASfHKXIgFCeZUNbLcQDGTBdJWaEOYV,HAAAXAAAFADAeAFHZACB.UCABLAFADAHB.GCEAdDDA.aCGAhAAAECHFODGD.PEBBhABAAAIBKEGDCFEA..bECDhAGA.QGGBBFHAWGDG.....hAHA......hBEA...,2,-28,0,28
DYPecdHCJaGQLVOTZUXgBbfWNKFMRSIAE,EAAADAAAeABAHACAaAEAGAEA.LAGBOAGDZCCAUDCABDGD.hAIA.bEGBfECAhAAA.KEEDRGBAABIBcFGAhAIAdEBCCFFA...........hBAA......hBEA...,1,-13,-14,1
NTGYKSaRfJdcOQVeZgPEIACFLBMXDWHbU,LAAAMAAADAEAHAFCUAEAGBGA.SAHBRBBAdCFAQDDAhAIAeCAAZDDAECHFACAABEBAhABAbEBD...TFDAhACAaEGEfGGAOFHDgGBB.hBAACGGC......hBBA...,1,1,-12,13
NADacLFCSEPbVTUOQIRfgYJMdXHWeGZBK,aAAALAAA.SADHEADA..bAFATAFAUCCAQCFAhADARCAA.fEFEhAGAgCFAMBBBhAHAHEDAeDHHZFAAKEHBAFCAFGHDCAHBOHEAIHDA.hABA......hACA...,1,0,-11,11
VDWXagQJcHFSTPLfCBIAebEdNUMZGKORY,EAAAdAAAMADAGACARAFA.DAEA....aBDBQAGAHCBBFCGD.TCEAhAAALEEBBCBDACIBeFCFhACAbDGDZEBAOHFChAIA..YFFFXEGAgGCBhBCA......hBEA...,2,-11,-3,8
JVdPEHFOTLBaRCNeGZcIMSYbgfUXKWDAQ,QAAAdAAAHADATBGAaACE..RAEFeAGHZABBMAFA..bDAAfCEAhBAA.KDCBhBIAAAIBPCHDEDGBLFEBhCDACEEAGGABSEHHgFGBXGGChDAADDAAFGEA.....hDIA...,1,5,0,5
ILcYNHGfXZUDgaQVWeTCPKESRBOFJbMAd,dAAALAAA..NADAHAEAGADAZCEADAFA.aAGEQEAAhACA.eDHHTCAAKEEARGCAhAEAFCFD.bCGDAAGAIHHAhAIAfFBA.XFFC....hABA......hACA...,1,-8,-25,17
BAPVFCDGXZSgKOYWLIQHTcdaebENRMJfU,FAAAGAAAZACBKAEAOADA.LAHBHAGBdCEAeBFFEDGB.RDBFMDGBhAAAUFGBBEDDABHB..CDDBSEHBhACA.hAGA.WFFDIHFA......hBAA......hBCA...,2,-33,-17,16
XcARTQOCEFNMBZDYeIGUWVKafgdbPHSLJ,RAAATAAAQADC..EACEMAFAZAEBeAGFGBFAUCCAKBHBaCCChAAAdCHAHEAALEEBXEFChAAAAEIBFFCADGGA.IHBAhABAfFHAPHFCSGEA.hBHA......hCAA...,2,-6,1,7
cFUZQIfGWLaVTXACdbDEBOJSPNgKMeRYH,dAAAEAAABACASADA....gADHeAFHHBGBFAGAZABBhAEAQBFDGDCAaAHFhBAATDDAACEBbEEBOEHDhCDAPDGBKCCD.MCIBcGGCfGHAhAAA.WFFD...hDAA...,1,-1,-14,13
GIcTdUCOMZJXAHNeWLfgFQRYKBDbSVEPa,HAAAeAAALAEAFADARAFFBAHBSAHH.EBCFGCAB.hAAATDEAdCEAOCGBhABAZCGBADIB.fDHAhAFAQECDDDDBPFHDaFFCIGAA.CGHAMIFAhAGA.....hAAA...,2,-15,0,15
CaUZBDEAcJdbVKSXfOTNPIFWHMLegRQYG,dAAAKAAA.SADAOACA....TAFAIAGAHBCAeAHHhACARCFAGEDAaCBD.ZFFBECFBhADAAAHAJFHBXDCD.hAAAfDHA.FEAH.MFFB.QGCAhAEA.CGGADGIBhBAA..,1,4,-21,25
WaEHIBOGCgTAMdYQZKeVUcJNRbfSFDPLX,dAAAZAAAeACEUADA...JAFARAFA..SCAADCCBLCFA..hABAaCFEHDDAOCHDGEGAhAIACDDA.ACGAMFFBQEFChACA.KGAA.NIABFGHB.....hCAA......hCBA...,1,-16,-21,5
CRbEdVXQeAfZNHcWSMDOgUPIYJGKFBLTa,ZAAAHAAASACEMACAOAEEUAFA..ICCAGCCBBAHAhABAaAHD.RDFAEFBAdCEAQDGAhAAAACIB.fEDEhAHAcFFCDFIBgFFB.YGCAhCAA....hCGA...,2,-21,-18,3
NPKEWgJFATfYMQIDaZOXGHRceBSbCLVdU,TAAAMAAADAEA.ZAEEGACA.HAEARBBBeAHHbCEA.LCFBhBAA.dEDAPCABKDHBEFGFhBBAgEEA.hBDAAAGAQGCCIHHA.aFHB.cEADhAAA.SGGDhACA...,1,0,-18,18
SUYPZdBFGAJaDLWXgfeRcObKIEQHCVTNM,aAAALAAA.XADDeACHRAEA..OAHDKAFAEBHFHCEC.TEAAhAEAMCABSCCDhABA.PCFDhACAdECAGEEAAAHADDIBfEDAIEHACGHANHABZFABBHGDhAFAFFFHWEHD..hAFA...,1,3,-16,19
gBcWQHJafYGXKMCDOVFNERUZeSTIbPAdL,dAAALAAABADAQAFAHADBaAFAGBFAKAHB.MAIBDCCAFCEDRCAAeEEBhABA...TFBAhACAbDAA.AEHA..gGGAhBFAJDGB.fHCFCFAAOEHDEGDA.hCAA......hCBA...,2,-32,5,37
fVcFRNAbBIMSQTCGDZKEPdgOYeLHWUaJX,BAAAMAAA.QACAGACBZAGBEAEAdCCAOAGDeCFDHEDB.aBBHhAFAfCAAFDHD.hAGAAAIBSCCDhAAATGGAKGCD.gDDB.LDFB.hBAAUGBA.JDHB..hACA...,2,-14,4,18
BgFKObAPTUEZLICdGXQceHfWRYNMDaJSV,TAAAEAAAZACBLAFA.dCBCGACAQCFAHAEARCEAMCIBhAAAaAGASCADhAAABDEDKECAAAGA.IEGA.hBCAXEAAeFFBfFHEYEEFDCIB.hBEAgGGAFHDA.hCAAOHCC.,1,8,-2,10
fcENYOCPQeXIabDFRWgMSUAVdBTZHJGKL,dAAAZAAAHAEAGADALAHBEAFA.OCABQBGAeCCBaCECbABD.hADAREAF...MDFBACGATEEAhABAfDGE.hACAcFAACEGBXGGAFFHDSGFH.hADA......hAEA...,1,2,-3,5
eGDEKACXSIVBUgQMacPORWLZFTNYfbHdJ,SAAABAAAQACAMADA...aAEEOAFERAGFZCAA.FBCD.TCEAhAAA..fCEAhAAAHCGBeEBAEDFFABEBXFFChABAIEHAgFAAcGCA.LGFAhACA.NIAB..hAIA...,2,-19,-10,9
NSKeHZLTdgRDCbJGcQIafPWYBFMAUVOEX,OAAAEAAA..SACAHADAZAGBdCCARAEFCAGB.GEDA.QFAAhAFAaAHD.fDFEhAGAPCCBBCGDABBBXGGAhBAAeDABTEDADBIB.bFGB...IHEAhAAA...hCAA...,1,-10,-16,6
LcfZdPVONERUFgSDMCeTBQHGIabKWYXJA,LAAAZAAAdAEAOAGBRADFFAFA..DAIBeAHHBCAAHCAA.GDEAhABAaCCH.KDHB..XCFAhABAAACAfEBA.hACAPHAAEEEASDHHTGGA.bFCC.YGFGhCAA...hAHA...,2,-21,-8,13
fbgPQZMERaGTWdNVXOUcFYHCJIKLDSBeA,...bAAAQAAA.EACARAEAGCAAdAFAXBDDOAHDFAHBhAAAHCCCCCHA.KCGDLEEAhBFABEFDAAAAfEHAhACAZGDAaDCHNEIA.UGGB.YFAFDGEA..hAEA......hAFA...,1,-5,-7,2
YKBJICaeNZVdbXMAfLDTPRQGcEgOFWHSU,LAAATAAA.RADFGAFAEACE.FAHFHAEBUCAABAGA.CBHAeCCBhAAAZDGBdDDDMDGBAEIBDFAAQEAAhAEA.ODHBhAGASFFDKEEBaFHDbFAA.....hAIA......hCAA...,2,-14,-7,7
RUfJXWPgEdGNbOBQeMVKYLcSCZFaIHDTA,RAAAUAAA..XADB..gADAEAFAGBGAOAFDhADAeCCBMCFBKAHBLDDBhAEACFGDaEDDHGEAACHBJDFF.dEHAhAHABGCD..YHFA....hBAA......hBCA...,1,-7,-26,19
RMdDUKcbJISQXLNaABVECgYPZWFTfGHeO,EAAACAAA.....PACCZACATAGA.HCCARAFFdAHAKCGDbCCBSCHHhAAA.LDABhADAADHABEEAgEGAhAAAFECHeEEBMFIBDFAAcGEAIGGA.NIAB.hAEA......hAFA...,2,-22,-11,11
CTcBXRPHGaeEVJIZSfgdQOUNKbFALDWMY,LAAAMAAA.TAEAXACA.HAFAeAGHEBBBJCAAZCEESBHHhABAdEFAQFAAhAFAOCEBKDCBAEAA.DCIBCEGAREAAaEHHhAHA.IHHAUGABbFED.FGGA....hACA......hAEA...,2,-4,1,5
HQTUMDGLNaBZObJPgIWSFfEYeXcRCKAdV,HAAATAAAMACA.GAEBaACAZAEBOCCA.JCGBIAHAhAAA.FBGHEDDBeCCBRFDAAAHAdFHAhAAAQEEADCIBBHGDhCAAbEGD...PDBB.....hDAA......hDBA...,2,-9,-5,4
WOdLeGBVcfKgQZCFIATbUPDYRaMNXJEHS,TAAAUAAADADA..RACF.MAGB..XAEBHBDBOAHBeAGFGCDAhAAABDBA.fBHAhACAQEFAZFFAFFBAhAIAADIBPHEAaDHDEFEBSGHHWFDD..hBAA......hBCA...,1,1,-23,24
cNbAEdUDRGBeCfVILKFOSQWTHJPZXMaYg,EAAAdAAARADAGACABAGB.eAEA..CBHA.IBHALCCA.OCFDhACAQCEA.HDGBhAAAZDAAaDHBgEAAhAEA.bGDAAEEBfFFEFEEH.SEHHhADA...hAFA...,1,1,-35,36
BDOPCgFWTXEAMYHIeGaVKSbLcRfUdNZJQ,HAAAeAAAGADAaACAKAFALAHBRAFAdCHAZDBBBDFAOCCA..CFACFFDAhAAATDEA..ADBBMFHBhABAIEHA.bFAA.hAFAUGFAJHDADIAA........hAGA......hAIA...,1,-7,-15,8
OGQNFZeMXacPDbVEYCUdKBLWIRSfTgAJH,HAAAGAAAQADCZADAeAFE.aAFADCDAEBFFCCGA.dCADLDDB.hAAAREAA.TCGAAAAB.ODDBhACAMCIB.XEFChAIAbFED.UGEBBGGAIHHA...hACA......hAEA...,1,11,-20,31
FRHNZLMabVGQTgPcYdCOKADefWUXBJESI,eAAAUAAABADAEADAFAFDHAEB.ZAGBMAHB..aCBEGCCA.hADATEFAPDEBdEHAKDHBhAGAAAAADAIB..XFGChBAASFDHRGBALHFA....hBCA......hBGA...,2,-17,-13,4
FYGUIdBgLKQcEWOTJHZfPDXVSMARaeCbN,RAAAeAAACADB.FADDGAEAdAFALAHBKAGA..ECCBOCCBHCGBZFFAhAAADDEA...SEDHhABAAAAAaEEA..bEGDUGAAhAGABFBD..........hBFA......hBHA...,1,-11,-33,22
fBMQOFPAXdYKIGLaVTRcWEgSCNeJUDHbZ,dAAAKAAAGACAaADA.RAEA.EAGA..CAHB.eBDBDCABHCECZBFEBCBAMCIBhAAAQDFA.hACAFEBAAEEAXEAAhAEALEHBTGAA.WFFDSEFA.hACAUGGA.OHCAhAFA...,1,-6,-17,11
CZRIMTGYdBXDKWLObNeAfSJgEHUacFVQP,SAAAEAAAHACAaAEAFADA...QAGAZAGBRCCAMBIBGBCAhAAAdEEADEHBLCEB.hAAAbDGBACFAfGFAhCAAUGAAPGCCCHHA...IHHA.BGFBhABA......hAGA...,1,-6,-11,5
aFPNMfBCcTSLgZbVXHEJYUKDIGeOAWRdQ,RAAAaAAAFADA..MADACAGA...SAFAZBFE..bCCBHBBChAIA.EBHFUDGADCFBeCGDhBAAAAAAdEEA.QEBAhBBA.fEEETGAAgGEAhAGAXGFA.KHGA....hAIA...,2,-28,0,28
NYSXLARdegaPMTQfDbGUIHBcWCZVOJFKE,RAAAeAAA..aADAMAEAQAGADAIBGBCAHBDABBEACCCD.ZBFBODEChAAAKCHD.EEHFSEBBhAAAADGAdFFA.TFDAhABAbGAA.UFFAIHHA.....hBEA......hCAA...,1,-3,-20,17
KPYJXIMSDBVRfdgbFZNHaQTGLCWOEeAUc,KAAAJAAA.MACABADB..RAEA.dAFAFBCDHBGB.QCCAGCEBLECAhAAAODFBAAHAPEGDhAHA..XEGAhBAADAIB.fFBA.gGGBhBFANEIAaHCA.....hCAA...,2,-26,-17,9
PEcKCZLbROXVfYaSFNUHITWMBdGJeDgQA,EAAACAAAZACARACA...OAEA..fAFB.aAHDFAHDHCCChAAATCCAMCGBGCFAhAAAeDABQFCAhADAADAAKECDLDHBbEGDYHAASEEDNIEB.IHFAhADABFEA....hCAA...,1,19,-33,52
FDBSOWEACJbeUZQcfKgPXYRLdVMGNaIHT,CAAAeAAAZACA.QADAKAFC...XAFARBGBdCCAGDAA.hAAA.aBHDHDFBTCCAhABABEDAOCFDAADAJFHB.bEGDhAGA.fEEE.PFDB..hAIA......hCAA...,2,-33,-8,25
NfYRKUPADLbaScTMdFJEBgeVHWOIQXZGC,LAAAaAAA.TAEAdADAEAFA.BAHAeAGHHCDCOBHDQCGChAFAGCAACCCA.fDEAhABARDBBKBBDAEEBSEGAhBAAMEDBFEGBJFHBgFFGWFFD..XGAAhACANICB....hAEA...,2,-7,0,7
XPDAZBTEGcHaVCRKSIJgLOFbNdeQMYUWf,ZAAAEAAAHACAaACA.RAFFKBHB..SAEH.JAGBLDDBhAAAFCCHdDFD.eCCD.MDHBhAEAUFFAXFAAhAFAAAIBGEDACFFAOFHDQGAAfHABDDIB.hABA......hAGA...,2,-18,-1,17
HACQNeBGRYSZPUaTcFLIJKEXDWVgdOfMb,QAAAeAAARADAZAGB.aACEFCCB..LAFAKDEA.ECDADBIBVCFAhAAAdEAA..MEDBHDAAAAAA.hAEABEEAGEGASEGAhADA.TGAAcGADXGGA.hAGA.OFFH..hCAA...,1,9,-22,31
bBegJUNHIEfcQPZLKVXFAORCMGaDWTdSY,RAAAGAAADADA.dADA.SAFABAFAeAGHUCFAHBDB.ECHFQDDAhAAAZEFALCCDXDBDhACAAAAAMGEA..aBHDhAFA.TFGA.bGAANIABIHHA.hAGA.fGFEhAIA...,2,-15,-12,3
UZdcPfQVBTGFeDLAXNEaIKCYJRMOHbSWg,EAAAaAAA.KACA..CADARAEFHAEB...bAGBSAGB.UCGBhADAdCCAfDFAhAAAQCCCTEEAeCHHAEAAXEDDhAEAIFHAMBBBOFHD.ZGBAPHEAhAIABGFADIBA...hBAA...,1,8,-27,35
TAGBKCUSfbEIODZLcQYJNXWgMVaFedHPR,GAAACAAAUACA.SADA.EAGADAFAZBFELBEBQDCAhAAAJAHB.XDGA.hAAAMDABaCBCeCGDHEEBRGAAhACAADIBKEDDfGHA.OHDC..hADAcFFA.YGBAhBCA.,1,28,-54,82
LTfcFEAVYWZDUeJgBIKCGQHMXPNSOdRba,VAAAZAAAeACE.BAFBCADBHAEB..MAHBXAGA.SCDDhAAARCCAaCFDLEEAhABATCGAFFCB.AAIBDCIBgEDAhAGAKFHB.GGEB.PHAA.hCAA......hCBA...,1,0,-27,27
GMNcFOSWVRZDeJaHdLYEXIPTQKgUBbCfA,GAAAMAAAFADDSADA.RAFFeAHHHAFAdBBALCDBECEFXCGAhAFATEGAQEABhAAAKEFABFEDCFHAAAHAOFDEhACA.WHAADDDBaGGCIHHAPHCA..hBAA......hCAA...,1,9,-22,31
bXaMZGHDeARYSJPFELTOUVfKBCWNcIQgd,RAAASAAAFADALAGBOACD..VCCABAEA.CAGA....hAAANAIA.QEFAhABA.bFCBaCDD.GCFAhAAAeFHHAAIBPEABEGBB.TFCA.KFHBIHFAhBGAdHCDMFFB..hABA...,1,-7,-22,15
TVYdWbHCEQOFAGRJZgNIPcDMaBUXeKSLf,RAAAZAAA...IAEADADAaAEEBAHAUAGAKCAALCCA..TCEAhABAdCGAHECA.EEHFhAAAQDGAACIBGGDBJHAAhABAgECA.cFFA.MIBAhACA.SGBGhADA...,1,-13,-30,17
WACDVYHfIULMeOFdGJSTaEgQBcRbXPZNK,DAAAHAAAUADAeACE.dAFAGAGASAHBEBBA.QCCAhAAARDDA.bBGDZFBA.KFFAADFACEFDhCAA.VFGBfGAEhAGAMIDA.FGHD.aDHD.......hCCA......hDAA...,2,-21,0,21
AJCIEdOMXcGPQFNZYgBeVTSWbKaUfDLRH,CAAAEAAAdACA..MADAGAEAQAGAZAGBBCBDeBCA..TEAAhAAAbCBCKCFA..aCHDDDIBhAAAHDDBAEEAOEFD.hAEAXFCAFFGAgGAASFHDfGEAhAGA....hBCA...,2,-17,-6,11
RcKHEYOZQJfUCDLBdNagXSeFTGWbAMIVP,MAAAVAAA.RACA.HADB.EAFAZAFB.QCCBUCGALDAAdBHAaEEAhAFASDFDFEHB.hAIAGFABABBBIFCAhBAAKFGAOGDECFFDBGHANIAB.eHCA.....hAAA......hADA...,2,-9,-2,7
ReEODCGTVcYWPLHQXJBKSFdIMAZUgfbaN,ZAAAUAAA....bADBRADAEAGE.DCDBGAFA.TCAAVCEA.hADA....cDDChABAPDHDHDGB.QFBAhACABEAAFEEHdGGAAAHAaBHFeHCACGGD...hBFA......hCAA...,1,-6,-22,16
IPdJaXDVbKcSeUGZMHEQBfgCTLOFAYRNW,RAAA..IAAAdADAaAFA.DACA..KBFAeADAZCCAHDFBEAGA.QFBAhAAABBCDCBHALCEBhCAAAAIB...YCGFhCBAPFHDJHDE..XFGA..hDAA......hDBA...,1,-16,-37,21
FNUPLSMCDfAWbaHgVYEQKedRGBTXOcZJI,aAAAHAAA.VAEAEADAKAFARCAA..GCGABAHBOBBBZDCEFEAHUGDAhAAALCDA..MAIBhACAfCHAAFFA.bECAhADAQGGB.eHAAdEGDTGGAhBAA.JHCA....hCAA...,2,-18,12,30
JEBRATWSaCdeIYNcXZFgMfQGHVLKUOPDb,TAAAaAAA..eACH..IADA..cAEAZAEBMAHBhAAAGBDAHCACLAGBhAIAOCFDbECDEDHFABBBCEEDdFHAhACAXFCCfHEFQFFC..hBAA......hBIA...,1,1,-18,19
BAQdESXPYWOfKgTVUHJRZMIcLNDbGeFaC,EAAAXAAA..PACCOADA.KAGATAGAHBCBRCEF.ZCGBMCCAhAAALEBBDCGBeCHFhAFAaEHDAAAAdDDA.SEHHhAGAfGEAgFDA....hAIA......hCAA...,2,-18,-10,8
EGaJVXdLcRCQbYAFTSfNgPZeWDUHBIKMO,TAAASAAA....fACBPADAeAGFDAEAHAFChAAAKBCAEBHFaCCA.JCFBdDDARDGFQFCAhAIAAAAAFDHDZFCABFFBhAIAMFIB..........hCAA......hCFA...,1,-10,-19,9
DCdfJLIbKGTNBMFPOYeRZHEUgWcVASXQa,QAAAaAAA.dADALADAKAFAGCDBTBGAMAIBOBBBhAEARDBBHEECECDA.UDGBgFADhAAAVFAA.AEHADFIBhAFAfDCEJHCE.bEEDFHGCeHFA.WHAAhAFA......hAHA...,1,10,-8,18
WYgJSNUCKGFXTDOZHARMePQIfVLdaBEcb,RAAAeAAAQADC..fADAdAFAEAHB...bAEDgCCGhAAASAGACCGAGEFAhABATDGAZECAHFDBAAAAMFIBhAGAIHHAaCGABCCD.cGFB.hAIAYHAA..hAHA...,1,0,-16,16
GFaISVBfANHODcREbTCeXJWPYUMdLKQZg,HAAADAAAEACATAEA.eAGHXAEA..PCABMAHBdCCAhAFALCCBZCDBGEGAhAIAaBHDSCEDfFEAhBAAAEGAOEHD.RFDAbGAC.CHFA....hBBA......hBIA...,1,16,-23,39
eHTYaURDKPWIdQbVJcXEOSGAMBgfNZCFL,MAAABAAA....fACAZABELAFAHADBaCCARAFA.KCFAICAAhAAAdCHAQEEAhAGA.VFCBXCFAhACAEFHB.GEEAADDBCHAA.eDHH.TFAADIFA.hAHAPDDB...hBAA...,2,-12,-2,10
UEIcJKYgaCSbPROBTMVGeLNWFdfDHZXAQ,EAAAJAAA.KACA..aADACAEB.....SAFHRAFFBAHBMCCBeAHBhAIALCHBFBDD.dDDAhAAAHCGBADHB.QDEAhBAAIFFA.gFGA.OCCHhCAA......hCBA...,2,-39,-20,19
HSNZDLfUIWACXKTJBMeGacREbPQYOFdgV,KAAATAAAMACA.GAEBRACF..EAEEQBCDFAGAdCEAHCGBZCFALEEAhAAAIFFAACABXFGAhAHAeEDB.bGECOFHDhAAA.SGCBDDDB....hACA......hCGA...,1,-7,-8,1
bLUcVMZDXROIKAWJaTfNFYPgSBeEGCdHQ,aAAATAAA..FADA....gACBeAFHEAHBdBBDHAFALDDAhAIAcCCCZCFARDGFKECDhBAAAAEAfEFAhAAA.PEHBBFFDCGHA.......hAHA......hAIA...,2,-25,-13,12
fEHcPeXTVCLJQYMBKUSAOabZDRNFgWGdI,aAAAZAAARAEA.FBHDGACA.dAEBECAAHAGB.eBBDTCDALDFAhAIAQDFDMEEBKFBAhBAAAACADEAAgFFAhBFA.IHHAfFAA.XFGAhABA.CGCABGFD.OHAChAEANIBB,1,-2,-23,21
cIaHMFPQYBeTEfgKAZNLUCWSGbVdDORJX,ZAAALAAACADBGAEAdAEARAGB...JCAAXAGA..aCEEHCAAhABAMDIBQCGDhACA.eDEDEEBAKEEAhABAAAGAUGGAbEGD.DHEAOGAA.FGEBBEGA.hACA......hAGA...,1,-3,-18,15
ZVUdJKbgOFNLCGePMXRfSQaYAHTDcEWBI,HAAATAAAEADE.BAFBZACBdAFAKAHB..OCABLAHBGCCAeBEDhAAAMCFBRDFFQFBAhACA.ABHBDEEBICGAhAAAJEHB.bEFD.FDHD.CHAA......hBFA......hCAA...,1,-6,-11,5
XcbGNgOeKEJLPDVCFHSdWIQBARaZYTfMU,RAAAZAAA..TAEAMACAUAGA..bAGBGBDA.OCCHhABAECCALDABDDGAFEGAHFBChBFAdDEAQDGBhAAAAFFA.aFGCXGGAgGCA....hABA......hADA...,1,-9,-14,5
MgHJBAebSQLcZaXWUKDdPYOfTCFVIRENG,eAAAQAAAZADB.aACEXAFA.KCFAdAFA.OAHBCBCAFDHD.hAAARCDBEDAAGEEAHDFBAAIBLFCBhABAUFBADCIBfFHAhAAATGAA.IHEA.MIAAhADABGHA.SHGGhAGA..,2,-7,-7,0
SRYEALQFWUBaJIZcgOKGebdHTVPDCfMXN,LAAAQAAAFAEABACA..aAGDZADBOBCEeAFAHCEB.hABATCGADAIBMCABSDCDhAAAEDDAADGAUEFAIFGAhAGAKEHB.dGCACHHA.fGHA..hBIA......hCAA...,2,-27,-13,14
ISOfUcPgJXZdATWaRBFbNMKEHLCGDeYVQ,aAAARAAAFADA..MADAHAFBGAGAeAHBQCCAOBBB.UDFBhAAAgCDAZGFA.AAIBTEBAhBAA.bEFANIAB.hABALGBADGGA.IGGA.SGEHhBDA...hAIA...,1,3,-16,19
JREHGQDNSaMZKfLdUTPCYceVXABFbgOIW,FAAAOAAA..IADARADAHAGBGCCA.QEAChAEASAEHZEFALAGBhAIAdGEATGGACCCAeCHHAAIBBBBDhAGAbDEDJFHB...EEDF.aGBB....hBAA......hBGA...,2,-26,2,28
fBKNcLTZEeDWFRUGIJSYbMaVgCXHAOdQP,dAAAQAAABADAKAFALADAZABB.EAHBeAHHFCDAGCFA.hAFASDDDbCEB.hAHAaDHDCDCAHEDBAAEA.fDHAhBAANHCBDGIB.RGFA.......hCDA......hDAA...,2,-21,-11,10
NLWXOdEACDRMgIFaPZSHVcbeTUfQBKYGJ,RAAAMAAAFADAZAFBHACC...VAGBeAHFUCDBQCCAKBBD.GEDBhAAALEEA.OEHDhAFAACIBDEGAaFCCSGAAhAGATGGA.BGDA.NIAB......hABA......hCAA...,2,-18,-7,11
RbGfCDVYSQdILKWJFBXcaNOZEMgeHUTPA,RAAAGAAADADA.SADAdAGALBEBKAGAFCDABCCA..aCFDZDFBECHBhAAAeCHHHEAC.TEGAhACAAAAACECA...QGAChADAIGBAJFHBXGGA.OEEBhAEAMIAA......hAGA...,2,-32,3,35
fNYSDgaTPeFcHUdREOCZbKQVWAGBXIMLJ,GAAAXAAAMADALADA..fAGASAGHaAHDeBHHhAAAHCDARCDAEDCBZDFEbDBDhAAAQEACABFB.BEFAhABAIFGAYEHBDFIBPHDAFFEH..hACA......hBAA...,2,-7,3,10
JaSTcFVfBIXHALGPYRQNCdUWKbeEZOMDg,GAAARAAAQADCdADAKAFA..EAFEZBFEMAIBDDDB....aDBDTCEAhAAAFDGA.BCCDHEDBhAAAACGALEEA.hACAPFHDCFADbFFBeFHFOHAASHAAhAFAfGEA.....hAHA...,2,-12,-6,6
PGQZAHKfNgdIaOecYVCTDRLXSBMbWFJUE,HAAAKAAA...fADBdACAaAEA.eAFEVBEBDBGB.LCAAhAAABAHAMCHBFCEBECHBGEBAhAAAAEFA..IFFAhACAOEEBCFGD...XGEDbEGD...hAIA......hCCA...,1,-13,-27,14
HbNDYZWGCcVQELJXfFRdKIBUOSaMegTPA,HAAADAAAZABEGADA.CAFAQBGAEAFALBHBJCAFFCCA.RCEFdDAAhADABCCD.SDEHhAAAeEFH.TEGAACGAbFAA.hAFAYFAF.cGDAfGHA.hACAKHDAIHHA.hAIA...,1,1,-18,19
KGOcTRIefbHWYZaDJPdUNABLgFSEXVCMQ,LAAASAAAEAEACADA.KAGAGAEA.OAGFRCAAeCEA.HDFChABAZCCFaCHDDEABdECA.ACAAFEEHhACAMDAB.TFFAhAAAbGFA.JGAE..NIAB.XGDD...hAEA......hAIA...,1,-6,-10,4
CfgEURTGFYQSIKWMNdPbaLeOZJHADXVcB,XAAABAAACACA..EAEARADAGAGA.QCDBKAGAMCAAdCEAhAAAaDAALEAAZCFBHEAAACIBhACADDGB.VFEB.fGAAhAAATFGASHDAIHHAWDHHhABA......hADA...,1,-7,-27,20
KLBSIbACZGFWMHROgQDENUePXYJVcfaTd,GAAAMAAAHACCRADAQAGCEAFE.eCDBXBBC.VCEAhAHAaCFCdEADLCHBSCHHhAAAAAIBZFFAODDBhBAADEGBPFEDYHEA..fGHAhACA......hADA...,2,-13,7,20
EZWHRMPXeAJFfOgdDVbBLcUYaTKSIQCNG,FAAAOAAAdADADAFABADA.LAFAUBFA...aBBCSAHHhBAA..QCDAhAGAGDBAEDDBHCFAREGBMFFBhBDAeEFA.ACHAfFHA...hCAA......hCBA...,2,-29,-22,7
GLJAZaMKcSIXfTDRgOWQEeUYNdPHCbFBV,aAAAMAAA.KADA..SACH.XAEATAGARBBBOAHBhAEAECFBeCHFUDDAdEDAHEGBhAFAFFAABFFALECDhAIAAEIBZGAAfGDBDGHB......hBAA......hBBA...,1,-17,-18,1
TXcCFUdLAIBDgQJMVeNEZSfPWGKbROYHa,DAAAQAAAMADA.eACAEAGA.ZAFB.SAHH..fBBAhBAAGCDARDABHDGBhAAAaBEBTCFACDCCdGGDADIBBBHAhBBAJFCB.PDBCKGEB.bEFA.XFCAhBDA.FGGB....hCAA...,2,-24,11,35
PISNOADefGZYLHTWFBKUbVRMEgadcCQJX,eAAAZAAAHAEAFADDKAFAVCAA..RCDA...EBHFdAHAQDEAhABA.XDGASCCDhAAAAACAGECATDGABEADhAEAbFAA.aFGDCEFDIGGADAGA....hABA......hAFA...,2,-31,7,38
dGCDJTLKfHBRNVeWQXOFaMYEcPgZIUSAb,GAAADAAALADAHADARAGFeAGHQCDB.FDFDaBBBEDHFPCCAhAEAZFAASFGAhAAA.ADABCHHATDEA.hACABCHANIAB.XEGA.MFAA.gGGBhAFA.IHEAhAIA,1,-4,-17,13
ebTZFQUgaBPKRdHWNVSDcJEfOMALYCGIX,LAAAGAAAeADAZADBQAFAaAGD.KAHBHCDA.VDGBhAAADCAAECFBMAIBADCBCDHAbEAAFEEBhABABFEA.RGBEdGGDSFGAhACA.fGFE.IHDAhCDA....hDAA...,2,-30,9,39
NJWdRgXKbZfQGSMDHLVTPacAYeUFIEBCO,eAAAFAAAEADAOADC..JAFBRAGFKCCAZAGBGCCADCFB..HDFBhAAALDABTECAaCHDAAFA.hABAUFEACDHA..dGHAXGGBhADA.........hAIA......hCAA...,2,-23,-17,6
HSVdQXeARITMgCJNcPYaFLBfbOGDWKUZE,RAAAMAAACADB...JADB....PAFAaAFALBBBBBEAOBHDhAAAGBFA.KBHBECCBHEDBhAIAdCGC.eFBBADFBTEDAhABAgGGA..cFGA.fGGEhCAA...hBAA...,2,-28,-18,10
EWcBPdTgUVJGMfQSYDNIbOLeRKAXZHCaF,HAAAaAAA.EADEBADAdAFAUCABGAEA.MAHBQCGA.DDDAhAAAbCCDeECAAAGB.ZFFAFBBHhADA..PHAATEGAhAIAgGEGfFFE.SGDBhBAA.IHHA.hACA...,1,-5,-14,9
OGEBTDacbHFgCLIePVNfdYWZRQXKSAUJM,MAAAEAAADADA..aACEHAEC.CAHB.eAEH.VAGBdBCAZCEA.REEAQFCChAAASBBDACCAhAGAOEHDGDDBBGGDhCAAbFGBLGDA.NIAB.YHCG.hAIA......hBAA...,1,-10,-11,1
XfVQHBZGTUCYgSMecdPNRaWJAbIKEDFOL,KAAAEAAAFACDLACB..XAEAQAEAHBGBGBGACAHBSCDAhAAAeCEBdEAAREAAaEEAhAEAAAHAbEFD..DEIBfGBAhAAABFFD.........hAFA......hCAA...,1,-9,-22,13
ESUZfJabMcGBPCeNXFIHdYVTRLDKQAWOg,OAAAEAAAZACB...aADDMAFAGAFABBEAeAHBFBGAHCEC.dCBChAAATDBAREBALEEBhBCAQDDCADIB.SDGHhAFAfEGAbFBCCGHA.XFFC.IHHAhAIADIFA.KBBD.hBEA...,1,3,-11,14
YMGUSfPDELBHcVCaJZRbNdOgWXQTAeIFK,eAAAKAAAGACAUAEA...SAEADAHBEBCAHDDACAHAZCAF.RCEA.dDGAhAAA.OEHD.XFDAhABAAAEAFDHDMEEBfGBAhAIALFFBBGGDaFCD.NICB...WHAGhAAA.IHHA.hBGA...,2,-16,-15,1
GARNSHPKaOYTfbcDEBLZUMVWCQeIdJgFX,RAAAHAAAKADC.aACA.OAED..TAFA..bAGBEBHFZCCFMCCAhAAACDGDeDHHdDDAFDGHABGBSEEBhAAA.fGFAhBIABFEALHAA.UGGA..hABA......hAHA...,2,-22,-5,17
YHdGbaBKERPWVSNOJTLcMFUDQZAICfegX,CAAAeAAA..XACAHADAGAGABAFARAGFPCCB..SCAAhAAAODFBTFAAhAAAMCFBDCIBAAFAIFHAhABA.fEDAdDDAaDGHEFAANIAB.LHEAhACAFGFD......hADA...,2,-30,11,41
NbGCPFYQVKDfeMUJAaXTHWdRBEISLOcgZ,aAAAHAAA.RADFEAFELADA.OAGDZBFEGDAAFBBH.QDFAhAAADAIBeCEBMDDBAACATGGAhAHAdEAASDHHhAEA.NEEA.CCCDPEEBKFGD.....hAFA......hBAA...,2,-18,2,20
YABcNgQLSIRKdUVaZFGefCTbJMDHEWOXP,BAAA..gAAALACARAFFdADAaAHDGAFA.eAHBTCCAhAAAbCCC..DDBBHDABhADAEDHBOEEBXDFAAAAAQFABhAFAKEEDZGFACHAAMDIBPFGB.NIAB.SFDDhAEA..hAHA...,2,-14,14,28
XCUYdGWKFIgHEJOecQDLMZTbAVNRSPBaf,RAAABAAA.aACACADBdAFAGAEAFAHB..HCCAEAGA...eCHFQCBAhAAAMDGBZECAABCASBHHhAGA.XDDDhCAAYEHBKDGDgFBGOEHDLHCAhCBA.....hAAA...,2,-26,-3,23
CVAJWPabXYOfGZdcBeUETIgDQSFLMKHNR,JAAAaAAA....XACDOADAZAGB.dBEDeAEA.EAHFTCCAhBAADBBBQCEAhAEA.LDGBHEEARGEAABIBhCAAbFAA.fDDEBDHA.gGFGhAFAMFDB.NCIA....hCBA...,2,-27,6,33
KZMOeUJIRECSbQTFNaDGBdgcXAVfHWPLY,HAAALAAAZADBeAFAUAEARAGBEBHF..SCAATDAA.FDCDaCFBhAAAGEDAdDGD..XEEChACAAAIB.fFGAhADAPDHDMEBBOFHDCFFB.bGAADGHBBCCChAGA......hCAA...,1,6,-18,24
GeIcLSBdZUEgYPbHJTDWfaMCKRVFNOAXQ,GAAAeAAALAEAdADAEAFA.....gBDGbBFAHDBBTDDAhAAAfBHA.aCCHhAAAMDGBRDFBFEEHADHBXFDAhACAQFAASEHHBDHAYFHBDFABKHBAhAFANIAB.OHFC..hAIA...,1,5,4,1
OdcQYXZWGLPESBDaNUfFTeAIHJCbVMRgK,HAAACAAA.MACARACAOAFAdAGAQBDA.ZDDAGBEBECHFDCCBhAAAaCAAUFCAFDABADDAIFHAhAIA..bDEAKFFDhBGA..XFDA...WDHH.hBIASGFHBHHA.hCAA...,1,-4,-27,23
HBbMcZTWLRSQKANaPXGfVJEUDdgeOFICY,aAAAGAAA.JADAEADA.dAGAeAGH.FCDACBBDHBEBBCHA.MAIBZDBBLEEAhAAARDAAKDGA.AAIB.hACAXECAUGEAOEHDhAGAbFFA....TGBA.SHFAhADA....hBAA...,1,-12,-15,3
EQFNDRVCKcGdXITJgPZMaAfSUbOBHLeYW,SAAAOAAAHADAeACHEAGE..FBBHRAEAKBHBdCFA....TDCAhAFAgCEAZCGBADIBUGGAhAIAbDGD.BFDALEAAhAAA.QGECDFFB.CEFA....hBAA......hCAA...,1,-7,-12,5
XCRHOLEKdUPISGNeMWATFfVZQBgcJaDYb,TAAAFAAAZACBBAEA..JACADAGA..XAFBHBECECHFdBHAUEDAhBAASCCA.hBHAeCEHAEIBQFFChBIAaDFDbEGD.OHFELHCA.....hCAA......hCBA...,1,-10,-25,15
OJNTKVcbMGPaFYBAQgefDZULCHXRdWIES,eAAAZAAALADBHADARAGFdCCAEAFA...OCFBTBGAKDHB..bCABhABAGEDA.aFAABCFDhACAAAAAQGAChAFADDIBXEEASFHDNEHAMFAB.FGFD....hAGA......hAIA...,1,2,-12,14
fKUNaGMDIXQAPLJcECRWFgHYOVbTedSBZ,LAAAEAAARACA.FAEAHAFBOAGD..bCCCeBDFdBHAZDAFKCAAUDGBhABAGECB.MEHBXEDAhACAAAHA..cGEBhAAACCEA..gGGAYFAFSGHHhADANIAB....hAFA...,2,-16,0,16
VQXFMSLaJBNYZeWIbHEfdGKcUARTCDOgP,RAAATAAAOADA....VADAQAGAMAHBLCAAaBDDBCCChAAAZDEAeCEH.bCFDHFDAhAAA.EFHFdEHAKGAAADHADGGBhABA...........hACA......hADA...,2,-15,-14,1
bHFMcaDBeAfNRJgGXVCOZLdTESQPWYKIU,RAAAGAAACADB.ZADAdAFAEAGE..QCCA..PCDBhAAAKAHBUDFAHCFCMDIBaEACeEFBhACAAAAA.fEHAhAEAJFBA.XFCALHAASGEHhAFAIGGAFHECBHHA..hAIA...,2,-21,0,21
LKXCPdIfSBeZWFTEJUMRaHYgAcQVGNbDO,QAAAGAAADADALAGBCACA.dCDASADHeBFFZDBBFDHDhAAAEAFAMAIBHEFBAAIBVCEAhAAA.ODDB.XEFAhAFAIHHABGGD.JHBA....hBHA......hCAA...,2,-18,-13,5
AZQDfESeNWcUHbFCIBGgPYKdJOVRaLMXT,ZAAAQAAAEADE.eACA..NAGAUCAAHAFAbCDB..CAHAGCDAhABAgCFAKCHBdFAAhACAOCHDRFCB.aDAAMFFAhAFAAAHASFFAFGGA.BGHAPHEC..hAHA......hCFA...,2,-5,3,8
ZMUgBTPGbDHLIXVYWOASJFaCfQdNeRKcE,FAAAaAAA.QADAdADARAFA.KAFAEBBB.ZCEEMAIBBDBDGCCA.hAFAHCFBLEFA.hADAXFCAVFGBOFDDhAHAACIBCGAAeHEA.........hBAA......hCAA...,1,-13,-19,6
JDKFTNYICEXBZRGPOaMeLAWVSbQgHcfdU,SAAAQAAAHACAdADADAFAFAFA.TCDA..IBFAhAAAEBHFZCFFREAAGBGA.hAAAaCCCeEFDAAIB.WDHHhAEAbDBC...fHEBKDFDCFGDBGHAMIAA.hABA......hBDA...,2,-29,13,42
YSPDJWXcAKRIEVCBdfeNTHbgZQUFMLOGa,RAAAEAAABADBdADA..eAFAHAEBZBFEQAGA.MCCBGCBAhAAAaDDB.SDDBhAFADDGAXEEAABCAKDFA.CDHBTFFAhAGAbEGDFGAA.LFHB.....hAAA......hABA...,2,-17,-5,12
gXIRVQGdZDFTYMEHfKScWLCNOBaJAPUbe,UAAAeAAA...XADARADAGAGA.ZCCAFAGAMDGBHBFBKEAASCBAhADALFHBOEEBhAAAaCEHACHA...bFCDgEAAhAEAQGABdEHA.TGFA..hBAA......hBCA...,2,-19,2,21
AHQWMFUbXeDSdGRCLNBZOgfaIPTEYcVJK,HAAAMAAAFADDXADB.eAFAdAFARBBBLCAAZAGB.OBHDhAAAaCHD.TCEAEDEB.cEEChACAKEGDAFBA..QFDChBAAbEGDGGABBFHA.IHHA.hAGA......hCCA...,1,9,-22,31
XWPgOIYLCFScaUMfRKBHNGeJAbZDdVQET,ZAAAdAAAEADA..TAEA..XAFA..gAGBhABAOBHDLCCAhACASCAAaCFDMDABRCEAHEAAhACAeECBADDBbEEAQEGDIGEAFGGHfEEEhADANDIADIAA....hAGA...,1,4,-18,22
SBGOaReWbQXHENDVJKgcPfAIYLCMUZTdF,LAAAMAAAZABEdAFABAEAGBGARAFF..eAHHQCCAHCAAECEBhABADAIBKDHB..gEDAhAHAfEAEAEIBCFBATEFAhACAOFGB.aGEDWEED.....hBAA......hBFA...,1,-11,-17,6
XfWTdBFVHMgLecQDRSGNOUAaJZIKCbEYP,ZAAACAAA.EADE..XACA..TAGAdAFAFAHBHCAALCAAhAAAeCEBQCGBhABARDEAGFBBOCHFAAFAaEEHKEHBhACAbGFA.fFCA.BGFA.MIAAhAIA......hCAA...,1,-6,-15,9
QIPAXWRCGLDHNaTKgZFUVSJecfBdEYbOM,RAAAGAAAHADB.aADATAFAZAFB..FAHDSAHBeCDBBDGAECCBODBDhAAAMCHB..QDAChAAAADIBCFEALFHBKDFBgFAAhABA.VFDAfGFAhACAdGHA.bECD....hBAA...,1,18,-17,35
aKVYObTWDILNAeBMdZJFSgEPGfCQUcHRX,eAAAdAAAZABBFADDEADAGAFA..QAFAHDDBRDGFKAHBOAHFhBAA.TCEADCCBLFABhAAAADDBMDHB.SFHHhABAfECE.CEEDXGEAaGGH...hAFA......hAHA...,2,-12,-9,3
dNebUCEHDcGfXBIZMLPQSTWAaFOKRVJYg,aAAAKAAARACF....VADAJAEA..dAHAeAGH.CBBD.HCABGDAAhADABCFAZDCAMDEBLDHBhAGAQDGATFDAACABFECDhAAAOGFC.NIAB.EFFBDDDA....fHGFhACA..hCEA...,1,3,-28,31
JSPKLBWQFXETAGMfdNYDURZbOVHagcIeC,GAAAdAAADADARAEAZADA.OAFAHCAC..aAHD..ICDA.hACAeBHFSCFHhAHALDFBQECAhBAAEEABAAABMDIBfDHAUFCA.bFFA....hBCA......hBDA...,1,-8,-23,15
GMIDQEUVRePCaKNJWFALXTOfBbdgZHSYc,TAAABAAAdACA.HAEASACBGCDAMAIBQAEA.EAGAhAAARCFBeCBBaBHD.KEABWCCDhAEAAAGALFFA.hCAAfHCBZDDAIEHADHFA.PFDC.hAAACGHAFHCA....hCEA...,2,-8,-5,3
ReQOAZHLEGMDYJdKTaSfVIUBWgNPbXCcF,HAAAEAAAGACAMACADAGAdAEBKAHB..aBDDSBEH..hAAAfBFAICGABCBDhAHAgBGH.hBCAbDCCCDHAREEAeDHFAEEAYFHBTGEAUFBB.hCAA......hDAA...,1,-2,-22,20
XNgSbdCaZIEfJUMAQHPeLOFVRcYBGTDWK,HAAAeAAALAEAFADARAFFBAHBGBCA.TCFAKCAD..XCCAhAAASAHHdCHAZEFAhACAEDHFfEEAhAAAMFDBACCA.QFAAOGEA.cFGC.DIFAhABA......hAFA...,2,-18,-8,10
dgWQNEGDIXKMHFBZfbcSTJUAOaVCeYLPR,aAAAeAAALADARADA.dAHAQAGCGCCADBBBKCCAHCFAZCFA..hAEAbEAATEGA.ACCBCFAAhAFAgEEAEFEB.hBAAMEHBfGGESGGDOFCH..hBHA......hCAA...,1,-1,-9,8
HVNPSCYQKEZDJObaMGWdBRIeTUAfLFcXg,LAAAXAAAHADAVAEA...SAFEQCAAEBHFZCDAOCDBhAAAaAHDGDGAdCFARDABeDHFhABAADIBFEAH.NEEACFFADEEBMFIBhADABECA.IHAA.fFFEhABA.....hAIA...,2,-2,2,4
VTXZMcdGRLePfBYQSgNbDFCHAEUWJIaKO,EAAAUAAA..JACBaADA..OAEA..TAGAZBDBdBHARBDBeCFGhAGABCFAQEFAhAAA.SFCAhAIAbDBBCEFAHEGBAEIBKGHBMFEBLHCA...hAIA......hBAA...,1,-16,-19,3
XUHKVfebBdLWTIRCSJFEZAOGcgaDNPQMY,GAAAaAAA.DADAQADAMAGB.XAFAHCDBKAHB.eCGHhAAAdCCATCFAREBB.SBBDhADAEEHFACDBOFFBhACAgEDA.PDHDYHAAfFGEhAGABGHA....hAIA...,1,-5,-23,18
QJSNWBaDPFACVeUGHOEcIRXbLMdfgZYKT,eAAAHAAAEADERADALAGBdAFAZAGBKCAD..TCCAQCCA.hAAASCHHBCFCaCHDFEAAhABAADFBCEFAUGGAGEEA.hAAAIGHAMIBA........hAEA......hAIA...,2,-18,-7,11
aVDWGUgNOHbXJSIQKCdABLRYPEMZFcfeT,RAAAEAAAZADBFACD..eAFA..aAEADBIBGAGAUCFA.OBDDHDAAJEEFhAAAQEFC.hABAdFBAACCALGAAhADAMDIBTGDA..gGFH.NEIA.SFDChAAACHDA.BGHDhAIA..,2,-17,-4,13
BRXfHYCWJINZGUDMQSgLbadFOKeATVEPc,EAAABAAARACA.HACA.CAFB.JAFAZAGBGCCBDBIB..MCABQCGChAAALCCAdDAA.KEFDAECA.hAAATFCAVEEA.XGGAhADA..fFHA.IGCAhACASHFGaEADeHEEhAEA..,2,-18,-15,3
RINXeFJcadfMYEBPVgZLDUTOWbSAHCKGQ,HAAAGAAARADF..XAFBeADAFAGD.aBHDdBHA.MCABECDABDCDhAAAVDEA.ZDFALFCBhAAADDABOEEBSCCDhACA.AEIBQFGDIFGANIAB....fGHAhACA..hADA...,1,5,-22,27
AbGRTXCPMIVaHSFKfcJgBUDdWOYLNEZeQ,RAAATAAACADB..MAFAaACA..HAEBKBEA.JAHBBBGB..dCCAOBHDhAAALDBDZCCAADGBGDFAhAAA.XEDDhAGAIFFAFFHD.fHAB...hABA......hCAA...,2,-52,5,57
dVSgGPIUaNRTeZBcYKFDfQJWbXLOAHMCE,HAAAEAAAdADASACEGAFAUDBARAEFZAGBBAHAKCCADBIB..QEDChAAAJEEA.bFGBLEHBhAAA.AGAAMGCAhAGACBCCgFAGaGGB.eHDA....hAFA......hAHA...,1,-12,-13,1
SeHbcTLdFAWJCEXaUgMIVfBGYRNZQKDOP,CAAAEAAAUACA..MADA..VAEAGAGA.RBCAZDBAQCGAhAAAODFBeDHHHDDAbFDAhAHATFBALFHBAAIBXGDDhAAAaCBC...fGGENIAB.DGIBhBCA......hBDA...,1,-6,-8,2
HOcPabKWMeISfGYEXDAFVdQUgTZLCJNBR,dAAAQAAAUADAZAFBLADA.CAHABCDAHCACOAHD.hAAAaDECbCED.MCHBeDGHhACASDCDGFBBEFHFhBAAAAEAFFHD.TGCANIEB.cGEAKHBA.fHABhAHA.DCGBhBCA...,1,-1,-21,20
ITQGKEXZOHbgCVWeFcYDdJUfLPSRMANBa,aAAATAAAGACA.KAEAEACE.ZAEBHAGBCAGA.eBBDFBHD.DCFBdCCAUDGBhAEALEABREDB.ACGBBEEAhAAAQGAAOEGBhAEAgGGA..WEHB...hAGA......hAIA...,1,-3,-20,17
fEZHKJYFgDSPVMeRXdbcAOGTUCWBNQLaI,GAAATAAA.CADABAFALACB..aAGDEAEAHCDAKAGAFCEA.SCGHhAAAMAIBRDFAdFAAACIBODEBhAEAUFCAQFFBhAAAZFFAJHFADIAAeFHH.......hAIA......hCAA...,1,0,-15,15
bHGCJFUKefZATEWYgXRPOIdaLVBMQScND,EAAA..gAAARACAOAFA.dADALCCAMAFA.QBGBhAAASBEHDDABHBGBGDEBhADAFCCHeDBDAECATFGAhCAAXEEAaFFH.BEHANIDB.bGBA.CGHA...hAAA......hABA...,1,4,-8,12
NAIbRdEWQeTcZGLBFDPfUJYOMXKagSVCH,RAAAEAAAeADEZACBGAEALAGBDAGAUCCA..OBGDMAIBaCFBSCBDhAAA.HEBChBCAAAAAdEGATFFAFEBHfGFEhBEAXGBCKEHBCHHA.IHHA..hBEA......hBGA...,2,-15,-8,7
SQPZUFNJWCgcVRdIfLDYOHGEKXTAabMeB,aAAAeAAABADAQADAZAEB.FAFE.JBHBCAGA....VCGBRCCBdEFAhAAALCCBOEHDHFDBhABAEDAAKEEAACGBMIAA.hADASHFAPFHDUGCA.....hAIA......hCAA...,2,-21,-5,16
CIGLMFEDBgbNWeHcTZPVSXUdfJAKRaQYO,RAAAaAAAQADC..CADAGAEAMAFAEBFABAGA..bCCCeAHHhADAHCGBZCCF.SBBDhAGAdEEAAAAAOFHDLEGBhBAADBIBgGDGNDIATGDA.....hCAA......hDAA...,1,4,-21,25
HcadfZEIONPBJYRgDSWLQTeMVbCGFXAKU,HAAAdAAAEADAOACABAFA.RAFADCCALAHB.eBGFMCFB.CCGAGEDAhAAAACCAKCDAUDAA..hACAaCHDZEEA..IFHAhAGAPFCD..gGGAQGFD..hAIA......hCAA...,2,-18,-16,2
ZQaECWgKFGcfOeRHLdJDSNBYITXPAVUbM,UAAAZAAAEADECADA...KAFCGAEA.OAGFHBFCdCAA.SCCAhABABCDD.TDEAhACAAAIBbDAB.MDIB.aEGDhAIAFDGHeGDERGAALFFADIBAIHHA..hBIA......hCCA...,2,-25,-10,15
BRAFNcGDdVWLMeKXIaPfCgYEZQbUOHTSJ,FAAAGAAAdADALAFAeADAKAGA...aCCCCCDAECFAZCEB...QDGAhAAAOCGDHGAATEEAhACABDBDAADA.DCIBMDCBhAIAXFGAIGGAfGDBbFCD...hBAA......hBCA...,2,-18,-12,6
JPVOafFBcHNDEbIeZYQdLWUCARSGKXMTg,RAAAGAAAMADA.JADA..OAFEFAGAHCDAEBDF.eCFEZCEB..dCHALEFAhAAACDGC.ADCBXGEAhACATFGA...hAAA............hABA......hAIA...,2,-34,-18,16
QDOfBIWbUPMeJVEYTCcNSZHgadFGKRXLA,QAAAOAAABADA..IADAUAFAeBBBEAFA...TDDAhAIACAHASCBA.hBAAHCEAdBHAGDFAhBFARECAACGAfDHAPFDBMEIBVFABcFGC.hCAAgGEBKHEA.hCDADICA..,1,5,-16,21
gEPObJGIAQLfHUTcdYNMWVeRFCZKXDBaS,LAAAHAAATAEAdAEAMAGBeAGH..RCAAZDCEDAHBBCAA.aBHDECHFhAAA.bEDAGCCA.hACAACCBQEFAhABAfEAEcFGD.YGAGWEBDCEHASFDHhACA...hADA...,2,-20,1,21
bDBEKFHaeYTfScPOUgLAdQXNIRVMZGWCJ,dAAAQAAA..XADARACAZAFBGCDACAGADAIBBCBAEAHFHDABhAAA.eCHFTCFASEHHhADAOCEHLDAAhACAAFFAIHHAMDIBbFCDaGEEfEGA.hAFAPGAA...hCAA...,2,-27,9,36
AGZbKRTNUMDESJBdefaHFOXWcLVCQYgIP,ZAAARAAAUADAEADEBAFB..eAFAHAGBOBHDXCAALCGDhAAAQDDA.IEGAhABAACCBbDDB..TGAAhABAMDIBSFCBdGGAaFED.FGGB.cGDDhACA.....hAGA...,1,-4,-18,14
cLNTFRaeGUXQYHIDOCBVdSJZPKMbfgWAE,EAAALAAAFACD.RADFeAFEGAEA.UBGAQBFDHDDBDAGABCAAhABAdEAAZEBBMCCB.bDDA.hAAA.fEHAhAEAACIB.TGEAaEGDIHHACHHA.SFFDhACA....hAIA...,1,-1,-20,19
RVNUPXYFHJaOKLWEgTeQCZASDfIcMGBdb,DAAA..fAAAMADAdAHARBBAUADA.XAFAHBEBaDDHLBCDhAAAEDGA.eBHHZEBFABBAhBAASCAH.hBEAGDDAbFFAPHFCFCFDKFGA.TGAACBGC.hCAABGFD.NIEB...hACA...,2,-3,-2,1
VdcMGHTWNDXBKIFSgQaOEZCbUYRLAPfeJ,eAAAdAAAGADAHADATBGADAFAKAHB..FBGHQCCC.ECFBhAAAbABDREEBAAFA..JDAFMDIBhABA.NEHABAHBSDEHhADA.aDGE.ZFBB.CFGALGFAhBAA......hBDA...,1,1,-14,15
JgGNRMDELcWCbIHTZYfPdUOXBVSFQAeaK,eAAAaAAA.KADAGACARAFF.EAEALAHB.CCCAHDEAZAGBfBFAhAEAdECAOEHDBDHAhBAAFFABAAAAgEDAhBBA.MFGBDFGBWHCAIFHA....hBIA......hCAA...,1,-17,-21,4
YcAEbTROGIHfaNZdQLBCXWPKeDVgUJSMF,EAAARAAAGADAHACAaAEAdAFBLCGB.CCCD.XAGD.KCCDhAAAeDABDCFBUDGAMAIBFDFBhAAAAAIBTECAOEHDfFFEhCAAZGBEBGGD........hCBA......hCEA...,2,-19,-8,11
OQIBFJUaZYCdfNScTXDKVWePHELGgRbAM,MAAAQAAAFADD.aACEZAEB.dAHA..SAEH.TAGAhAAAKBBBeBGDHCECEDDBhBAAGDAARFEAADIBBGHAUEFBhADACHBA.fDCB.XGGADIFA.hBBA......hBHA...,2,-30,7,37
MSYFcPUGadDbKIRTQXVACOBWgNJEHfeLZ,BAAA..gAAAEACAHAEAeAHHZADAMAEAFCAAUCEBdBHAKCCARDCB.hAAAQCECAAGA.hACAOEFCJDHBLFFBhCDASGGA.PHCA.DIAAIHHAhDAA.....hAAA...,1,-8,-22,14
HLIfdKPMUQFCJEOYbRVDeZcGSTAaNgXBW,aAAAXAAAHACBLAEAdADA.KBHBMAFAQCEACBFA.EDGEhAFAbBGDRFFA...eDBAhAAAGGABABIBBDFCIHHAhAGAfEEE.FFBAOBBHDFHBSGFHhABA....hBDA...,1,9,-27,36
gdXFbaLZEBCITKYeDHRUfMOAWGNVQPJSc,GAAAQAAASADAdADAFAFALBFAEAGACBHA.KDBAeCDAHDDBhAAARDEAMDABADGA.VECBhAAAPDHD..gFGAhACAaFGHBGEA.TGAADIAA.OHDC.hAIA......hBCA...,1,12,-17,29
dUZKaYXRNWfHETPFAIJcDQbMVCBOGgLeS,JAAAQAAA.MADABADBGAGAeAEHdAGAZBDBKCFD.aCBERCCB.hAIA...fCHAhBAAHEFAEGBAFGHBADGBDEFB.hAAACEHALGBA.SGFA.hAIA......hBCA...,2,-31,-9,22
ITdKOaUfWADMRJCSQEYcHLBgbXVZNGePF,RAAASAAAEADE.HACBLAFBBAEAXAFDZBGBeCCAFEEBdBHAaDEAhAAAUFGA.AAAAMHAAhAHAQEAA.gEEBhABANIAB.IEHA.OHAAhAEADIGA.CGHA.....hAHA...,2,-15,-13,2
QSXKebJIWNUCMcdOGFafEPAZDgHBRTLYV,ZAAAHAAARAEALAHBQADCKCAAeAFE.bBFDJCEF....ICHAhAAAUEAAMACAdCADGDDAhACAFDGH.EFCBADDBBFHAhABATFGA.SGFDXGCACGGD..hCAA......hCCA...,2,-26,19,45
XfIBgQJACKHVMUWLYaGZPDbFcdSNTOeER,HAAAMAAALAEAGADAZAFADAIBFCAH.dCGATBBAECCB..RFDA.XCEAhAFABDFCQGAAhAAAACEAKCHDUDBBaDHDbEECSGFAhACA..eEHH.fGAAhAGA....hBAA...,1,7,-19,26
EGXSDgPdIQRNaUMFKVZOBeWJALfTYHbCc,TAAAHAAACADBGAEA.DAGAdACA.RAEAaAHDMBHBKCDAZCAA.eDFHhAAAAAEALDGB..hAAAbEDDEEEASGBBhACA.gGGAQGCANBIA.FGFH.BHAAhAHA.WEHH..hCAA...,2,-19,5,24
BZDSHOGYALFaXUefbMRECQPdIKTNcJgVW,aAAAeAAA.MAEAEADA..QAFAdBDAKAHB..TBFAJBBFVDDAhADAZDCAHDGBGDGAAAAALFBAhBFAXFCCbGDARGEA.hCAA..CAHA..........hCBA......hCCA...,1,-2,-7,5
aTEIXBJYHPOdWZLSfKFbcUNAVDMCGRegQ,MAAARAAAeADE..aACEEAGEBAFAHBDA.dCHAZAGBLDDAKBBD.FFDAhAAAUCDAACCBDFHBGEFAhAFA.TGCAXGFDhABA....YFHB...WBHHhBAAfHDF.hCAA...,2,-31,-9,22
SYXRTgbGaOfINLBcKUQdCVEPAMDFZWeHJ,MAAAZAAAHAEA.SAGERACA..bAFBaCAAOAHD..hBAAfCEELCCAKDGAhBBAdCGAEDABAECAFEEBeDDBhABAXFGAGGDBBGFD......hBHA......hCAA...,2,-24,-2,22
ICXKeVFBLQfZgTcbMOADUYWaSGEdHPJRN,DAAAUAAA..aABEEADAHADBRAFA...CAFAeAGHBCDALCFAhADAZDDA.TEEAbDGDAAIB.SDCDhAGAdFAA.JEHBhAIAXFDAFGEH........hAFA......hBAA...,2,-24,-21,3
EYZUfSWDNAMdGaeFbcHVCJTLKgBXIQPOR,GAAAeAAAFADDHADA.CAGBLCDABAFAQBGARCGFEEEB.ZCCASDADhAAADDGBAAAA.aEHDhACAVFAAKFCA..XGFDhADAOEEBUGGA.fHEFMIAA.hAFA......hAIA...,1,0,-20,20
SBMJACZEXRVgIOQLPeUYHcadTGFbWfNKD,EAAARAAA..VAEAOACCLAHBeAEEHCCAdCCAGDAAFBHD..bCFDhAAA..fDFAhAAADECBMEEBAAHAZEGB.XEDDhABAQGGA.YFCBaHCAWFHHKHEA.hADA......hAEA...,1,3,-7,10
HXNWLgDMScEFdOQIbRYKVZPaeGCfTJABU,HAAAXAAALADBDADA.MAFA.EBFAdAGAQCABRBCFKBECZCFEeEDFhAAAGCGA.TEEAhAAAAAIBBEGAUFBA.gGDBhACAFFFHOEHDIHHA...hABA......hCAA...,1,18,-27,45
TEWSIYbZcFHCXaARfDLOgPMGUNKeQVBJd,RAAALAAAOADA.MAEAGAGAKAHB..eBCAQBDDBBFAdCAAEDEBhAAA..SCFAhABA..bDFDZDDAHGBAhABAaDHDAFFBDCCBUGGAJHFA.IHEA..hACA......hDAA...,1,-2,-19,17
HBEXGZUSDCfJaVLAIRcPFdTKgbWOeQMYN,RAAAFAAAdADAKADA......bAEDeAFEMAHBHBEC.ECCBZDDADCIBhADACDHA.aDFCAAAA...IFFAhAIATFGAOFFHhAGA.QGBABEDA.....hBAA......hCAA...,1,-17,-35,18
cCaKgDQWEObTBPNMVSdRJGLFAZXYefIHU,ZAAAeAAAHAEACADA.aAGADAFA..ECAAOAHDBCDA..MCGBdBFARCCBGDABhABAAAAA..XDGDhBHAfCHA.IFDAhACAKFCDQFECbFEDTGGANIEB.SHCChADA...hCAA...,1,9,-32,41
ZYBdLIUHeDRFgNWbJOXaTPMECcQGAfVSK,SAAAZAAAdAEALAGBHACBRAEAFCAA....gBGAhAAA..bDAAXDEChABAaCHDMEEBEDHF.QEAAhAEAAAIBKFFABFHBeFDADGBA.JFHB.OHAAhAFACHHA......hAHA...,1,4,-27,31
WFgXSICHRAPLeKZJQTEVDUGYcaBdMNbfO,eAAAZAAAQAEAEADADAGA.GBGA.aAHFdBFA.bBGDOCABhABAFCCA.SCCAhACAHEEAAAAALFCBTDEAUFGBhADABFHAfGGEXEADRGBA.....hAEA......hBGA...,2,-10,7,17
IZNSUQKFcYbLPBMHWEAeVXOfTJdDCgaGR,eAAAOAAA..TADAdAEACAGAGBCAZAFBUDCAFBHD....bBGDhAAALEBBBEEBHFAAhABAABBBXDGCDAIBRFGBSGFDhAFAQFDA.KFGA......hAGA......hAIA...,1,-1,-26,25
QNYAUKPZSCbGgDBVIWHTdJLEXRMfOFeac,KAAAZAAACADBGACABAFA...VAEAHAGBdAHAECAA..RCAB.MCEBFDFA.hAAAeCFBQEDAhACA.ADIBUFFAbEGDDDDB.hAEATFAA.JFEB.......hCAA......hDCA...,2,-14,-14,0
SaNOXTEVdLBfAIQbWZCRgKUPDHYceMGJF,QAAAZAAARAEAKBHB.DADAHCAA..eAEAGCFASAHHhAAAaDEBOEABEBDBdCFA.LDHBhBCAAACA.bEECCECAgFGHhABAPHBAMDDBFHAEXGGCBHDAWFFDhAEA.....hBHA...,2,-8,-5,3
YDNXEHAIbOWgLZBGTPQRfJVMFcdaUKeSC,OAAALAAAGADATAEARAFA...VBGBMBBB.dCHAKCAAeCCBhAFACAHB.DDGBECCEHFDAADFB.hABAIFHA.bGAChAGAZEAA.QEEB.FEHDaHDESGAAhACA.XGGChAEABHHA,1,-4,-17,13
YgXDLfUMNOCZbeGBKcQPdEaFVRTWASIHJ,HAAAJAAA.XADBLADBMAGBCAFA.eAHBGAGAKCAD..QCCChAAAECFBFDCH.RDFAABFBSDHHhAFAIFDADFFBhACAfEEAOHCCBGGAdGFA.....hAIA......hBAA...,1,5,-31,36
ADHRFdISfLMUXJOZKYGVBeCNPTcEagWQb,HAAARAAAdADA.SACEMAFA.UAFAOBEDZCCAGDFAeBGBCBHB.TECAhAAA..ECCBaBHDhAIAQEEBAEHAFFBHfFHAhBFALFHB.KGDAYHBGBGGA..hBHA......hCAA...,1,0,-15,15
DCeYLdFNVOfPZRWJKHTQXIEUGSgMAcbBa,BAAAaAAA.eACAdADAFAFAOAFCZBFA..RDBA.KCAAHDFA..TCEAhAAAQFDA.EBBBhAIAGCCAMFIBAGGAbCGBCHDD.hBAALFFA.fGEE.PHAAhACA....hADA...,2,-24,-9,15
FBPJVTXQYLMfcOZACNDGgRKSedbaHWIEU,DAAARAAAeADEdADAHAFA.EBBABAGB.VBDBTCEA..QCGAhAAAMCHBODDBAAIBGEFAhABASEFHaCCHIGCAhCAAFFAAPFHD.YHAALFED.hAFA......hAHA...,2,-15,-7,8
aHZPLFMXDcBdTUOQJIKRAWfeEYVgNCGbS,eAAAEAAA...VADACACAGADA.aAFAHAGBZBFF.LCCBhAAA.MDGBDAIBdDHATFDAhABAQFDAKDHBAAIBfFHEhAGAgFGG.SCCD.hCAAFHCCBEEB...hAAA...,1,-4,-22,18
eNdSFHbEfTaIAZQVcLYWODCGPJMKgUXRB,ZAAAQAAALADBOACCGAFA.MAIBKAFCUCDARCAB.eAHFhAAAdEEAHDGBEDFE.aFACACIBVEAAhAEA..cGGChABADEIBCFFA.JHAABGCASFDDfGHE.hACAIHFA..hCAA...,1,6,-20,26
gPMfdZISOEHFCWDRNTaGVKYeQUBJXALcb,LAAA..bAAAMAEAZADBOAFCHBCCCAHARBFF..aCAAGCAAhABAKCFAeCHHQEEChACABEEAAAAA.gFBHhBFAdFCAEFGBDFIBTGGA.YDHHXGEC.hCAAfHAB.hCIA...,1,2,-15,17
CLFEaJHdVZcBUbNIMQWeASDfYGXOgKTRP,DAAAGAAAOABEKADARAFFLAEB.FAGAEBHF.HCDBZCCBBBGDhBAAbEGB...MCIBeDADhAAAACCB.fFDEhACA.XGFDTEEAaDGFdHAB.UGEB.IHHAhCAASDCF.hCBA...,2,-29,9,38
EYgeIPUVLHNRKJZSfXDQaFOMGcWBCATdb,dAAAEAAA.eADAUADAHAGBRAFA.ZABB..XCBCaCEBFDCD..GEAAhAEABCGAACIB..bEFAIDEAhAAALGDAKEFAfHGFhAIAQGAA.MEIBCFED...gGGDhAGA..hAIA...,1,10,-32,42
YcAGSeaHPIObMVEJUZWTFKNdDCfBXRQgL,eAAAHAAAOACAMAEA.EAFAZAFE.FBCDdBHACCED.XCCA.RCFBLFCAhAAAAAAAaCFD.IFHAhAIAbCGD.JHCATEBAhBEADGGBBHHAQGGA.cEEChCAA......hCBA...,2,-22,0,22
SXbZGdQIJAFfecVEWTDHPYNRBOagLCUMK,eAAAEAAADADAHADA...PAHBRAEAaAHDLBCBMCCB.SCFHhAAAZDCBdEEAQGAChAAAACCBFDHB.fDHAhABAVEDB.TGFABFHACGFA.KHAA...hAFA......hAGA...,1,-1,-19,18
SZcNRIAGMbPEDLfJKXCHBFYWedUVaQOgT,GAAAMAAA.EADALAEAKAFAHCDAFBBAeAHHdCEAUCGA.QFAAhAFATEFAZFCARFFAAAIBDDABhAAA.fDCEhACA.CDHABGHAYDDFaHAASHGGhADAIHHA......hAHA...,1,1,-18,19
TgILJMPVcDOYRXSdGKACHEbFWNaeZUBQf,HAAAEAAAFACDaACA.eAEHZADBBAFA..TAGALAHBMCCBVDEAhAAAOCGB.REEBdEHAhAAAABHBCEHA.bDCDUFCA.QGGAhCAAfGAA.IHHA..hAGA......hAIA...,1,1,-21,22
LNJfYSaITAHZRGMbQgXEOPUDVcKdCWFeB,HAAARAAAGADAMACAQAFAEAFA.OAHFDAIBKBDA.dCGAFCCHeCCBhAAALDABJEEBSDHHhBHAaDFAAAAAZEFAbGEAXGFAhCAA..........hDAA......hDBA...,2,-17,-2,15
fDJTMNAeYQUFPaVGRCHXBcIOLKSZEdgWb,eAAAQAAAFADD.aACERAFAHCDC.BCHAOAEDLEEAZAGBECDBhAAAdFAA...bGEADAGBhADA.MBIBAAAA.PEFBhCAACHCA.IGHASCCDfEGBhDAANEIA......hDBA...,1,-9,-22,13
HcTLQFEdIKNeVAWPSMRDYGfCXgbaBJOUZ,SAAARAAAGADACAFA...XACD.aAEAOAGD.HDAAhAAATBGALDFAhABAECEFdDGDKFADeDDDAAIBMFFAhADAfEBAbGDABCCDZFEB.QGGAhAAAIHHA.WHAADGDA...hAFA...,1,3,-11,14
BbcIDJdLTWVOZRCAFfaNSePYQUXHEGMKg,aAAAeAAA.QADAHACBEAEAGAGAMAGBBAHA..bCEDDCCBdEAAhAEATDDAODHDRCGFAAAAfGBAhAIASEHHPGDAhBAAXFBAKGHD.gFFD.IHAAhAHA...hBBA...,1,4,-6,10
aABeGZPJHIONcQFDgMVCTSLKEfWRbXYdU,eAAAZAAAHAEAOADCQCAADAFA.MAIBTBGALCGB.hAAAECDFRCCAXDFDhABAdEEAAACAGGABIFCAFEAHCDFBfFHAhABAbFEC.aGGHBDHA.NIAB..hAEA......hAGA...,2,-12,9,21
KaWbLASfcYRJMEUePCIOGgTFBVQHZdDXN,SAAA..fAAARACFEAEEeAGHCADAGAEA.TAGAhAAABCEAHDFCdCBAXCGAhACAaECAbFFAAAAAcDCDhADAMAIBIGAA..FEFD.ZGAA.hAGAKEHD.....hCAA...,2,-15,-4,11
BZceOFaILJSUMYfNCQHKbXGEdTVPDARWg,RAAABAAAeADEaACALAGB.UCCAMAFA...fBCAhAAAQEFAHBEAbEBCEGCAhAAAdBHATDDADAIB.ACBBZEGBhBCAFGHDIHFASDFHCEHA.GGBB.hABA......hBEA...,2,-6,0,6
VbANJUDBRWFGXOLCfgcQHKSZEMadTIePY,UAAARAAAGADALADACAFA.....fAHAQBGAHCBChAEAZDAAEDGBdCEAeCGBhAFAPEFBbEFD..AAAADEIBhADAFHAAOEHDKFAAMHAA.aGHH.....hAHA......hBAA...,1,-8,-9,1
HeMZbJDXQdOVBFUCIgTESaKLAPGfYRWcN,GAAARAAA..NADB.HADAZAFE.bAGB.DBIBdCCABCDDCCFA...TDEAhAAAECHBKEBDACFA..fEGAhACA..hADAcECDeEHHMFAAQEGCFGDA.gFEFhAAA.aGHD.hAFA...,1,-6,-28,22
JNfQWcBTESFAIYPaeGKbHdOXDURMLgCVZ,..IAAAaAAAeACHGACAHAEAdAHA.DBBBRAEAMAIBLDDACCAAZCEEhACAJDHB..QEAAhAEABCEDEEAAAFFAKEFAbGAAXFEChAFA..gGGAfFHA.hAEAWHAA.SHEAhAHA.,2,-17,-3,14
dDfFEBCKWMAgcYTLJGNRVSaUZIHPbXOeQ,....gAAATAAAGACARADA.aAEAZAGBHAGBXCCChAAAeBEHdDGDFDABEDEFKCADAAIBLEGBhABAVEBBUFEAbFCAQGAChADABGGBMFIB.......hAAA......hACA...,1,7,5,2
PWDGFNIRQTcbCeYEKXaLASHJVOBUMgdfZ,HAAAOAAAMACAdAEAZAFBDAGAGBDA.FBFARBCBTDGA.CAHA.hBAAECHF.aCCBABBBSEBBhBEABDFAfEHAhAAA.PFCBIEEAbFFD.eFGB.KHCA.hBIA......hCAA...,1,-10,-20,10
RZIBXCGLSQKAgHMNDPaUcJEeWFYdfTObV,HAAAMAAADAEAaACAUAFA..EAGAeBHHFBBAdBEAOCCB.RDEBZFBAhAAAXBGALFHBQDFAhBAAAEDB.gECAhCAAcGED.JFFFfHBB..hAIA......hBFA...,1,-6,-22,16
BNgELVeRWbHaPKFAYTcSMOQdCJZIfXUGD,TAAAMAAAdAEA.ZAFB..XACBGBBABAHAEAEALAHBhAAARCGFHEDAKFHBABGASCCAhCAA.QCFAhCCACGGD.fEEADEBBNICB.eEHF.aFCBhCFA.FGFB....hDAA...,1,-3,-21,18
JCbgUfMBHPTOFEKaeDIVYcGQdAZRNWLXS,RAAALAAA.SADHbADB.UAFAMAGBHCAAOAHBECHFeDEBhABADBFB..ICCAhAAAVFBAGGEBACIBZEEAXGEAhABACAHA.BHHA.....hACA......hBFA...,2,-24,-4,20
GECKeTfBJbLOaUYPHVFSADRZNIWcQXMdg,RAAAZAAA...IAEAQADCdAGAECAAeAFE.BBFALCEBhABAaCCCUDFAHDAC.SBHHhACAAAAADCIB.cDGChADAMEEBCFHAKFGD.TGBAfGGE.OHCChAIA....hCAA...,2,-31,-2,29
TLWXHgKEGFBAbCJPRfeUIaDdOZcVQMNSY,CAAARAAAeADEUACA...aAGAdAFA.ZAGB..QBDDMBIB.SBGHhAAALDDBHEBDhAAAEDEBGEFAABEA.bGCChABAfEHEOCCHNDIA.TFFA...hCAA......hCGA...,2,-25,-4,21
CHaQLVcJNRfPTGIOZgbWdeBYFXASMUKED,MAAAEAAAHACALAEAJAFA.RBBA...TCDAGCEAZCFB..bCGBhAFAeCCDFEDH.ACIBKDHDaEHDQGAAhAGAVEAB.hAAAfGFAOFEBdGGABHHA....hAIA......hBAA...,2,-7,1,8
YFebQcGTAHJUdXCBNKRIMVWZagOfDPESL,HAAAdAAABADARADFMAFAZABB..OAEDDBGAECABLAGB.FDCDeCCBhAAA.bCEDGEDAhAIAACGAUEGACDHAKFFC..IGDAhACAaFHD..fGBASCGA.hBAA......hBGA...,1,-5,-27,22
OaMLQgCHPYIXbZecGBFWNTDSJfEURKVdA,aAAAMAAALADA..QADAHAGBICCAZAFBeAHFGCEAhAEAFBBBTDCASDHHhAFAEDHFREFBdECAAFBACFEDXGDDhAIABHHADICAfGFF....hBAA......hBBA...,1,-7,-10,3
ONWSgQEVfLHKRGaFIMcbXCBZPeUdYJATD,TAAAOAAA..SADAEACELAEBHAFBRAGBGCCAFAHF.MCGBhAAAbBBCBDDAeDHFdFEAhAGAADFBDDHBNIAB...QEAAhAEAKGGD.aEFD.IGHA..hBAA......hCAA...,1,6,-23,29
GLVafUMWZDNYOPFXRcEIBgTJeKACbHdQS,HAAAdAAAGADAaACAMAFAZABBDAFA..OBDEFAHDRCFB.EBGEBDHBTDDAhAAA..eDDDACCBbDFBhBIALFBB.UFFBhBAAYDHB.PHEA....hCAA......hDAA...,1,-9,-18,9
GMHKWAYQREbcSIVDTBLXCfJeOgaZPFNdU,RAAAEAAA..SADBDADALAGBCAFA.eBCAaAGD.ZCBA..FCCBdCFChAAAGDEAHEFCAAIBbDGBIGBAhBCA.BGGDhBDAfFAA.OEDHNICB.MEIB.hBGAKGGD.WFCD..hAAA...,2,-23,-10,13
fGBXcQZMDLNEIRdSCJKFVHYAaWeOTUbgP,eAAATAAAUAEA....bACB..fAGFGAEAXAGAhAAAZBAEMBIBLDGBhAGAECGFRDDBdEBACEBAFEDBHFGBACCBaFFBhAHAOFDHBGHADGFBSGED..hBEA......hCAA...,1,-1,-7,6
fIRdBUSQbaGYXLMATOJCVEDPFcZNKWeHg,TAAACAAADACA..FAEDZACB.KAEAHAGB..IAHARBCBdDFABCBDhAAAQCEAGEGALEEDhAGAACABOCGFEECA.hAIA.NIBB.eEHH.fFFASGBAaGAAhAAA.MICA...hBCA...,1,-7,-22,15
QeAKHfWSdcGTDPXBOFZUVaNIgRYLJCEbM,HAAASAAAGADADADABAFAZADE.aAGD...IDAARAGFLCCAhAAAECCB.bDFAeBHHAECAKEEDhABAdDFA.TFAAOFGBhAIAFEHDUGDBgFEGCHHA.MIAA..hAAA......hACA...,1,4,-10,14
OWNKJZgLAEUPeXbIRVdcTfYHFGaQSMCBD,EAAAeAAA...XADARACAdAFA..TCDAHAGBaCCA.MDDBhAAADAHBOBHDKDHBZEABAAGBbDABhAAAVEEA..fDFAhADAFGDDSGHBBEGAJFHB....hAIA......hCAA...,2,-24,0,24
eUEfQJOgaNWAcbPILMBGdYVCXZFSKTHRD,...bAAALAAA.GADAdAEACAGAZCAAKAFAHCAARCEADAAAUEEBhAGAEBHFQDFC.hAIAODHDaCHDAEBA.IFAAhABAMFHBBHCAXFEC.SGCBhACA.fGHEhAFA..,1,4,-30,34
ObCQNdYHBgZUWGfcReIMSVJPTLFAEXDKa,EAAAKAAAOACA..bACAQAFA.dBHAHAGBZCCAGDFAhAAARCCAeDABMDGB.hAIASDHHPDBBTFCAhBDAAAGBaEEBCGHABEHBWFFDfHGF.hAAA......hADA...,2,-17,-6,11
SMOYCbPUXcEADVWRNLQfdJIeBTgKGaZHF,DAAARAAALADBdADA.eAFATAFAGCEAHBBBMBIB..CAHBUCFBhAFAECGBAAAA...VEDBhBAAQFAA.fDCEhAFABFHAaGFD.ZGFE.SHCAhAGA......hCAA...,2,-26,-5,21
VFdGfJZYgAPMNHWbSCUQeETcXDRaKBILO,MAAAHAAASACEUAEA.EAFATAGADAIBRBGBBCCALBBBFCEBGDFAhAAAZCFEABDA..PDDBhAIAbFAA..eEHHhAFAaEGAOFFBfFEE......hCAA......hCCA...,2,-18,0,18
aFVADULGgbdZKYWJMRPXTBOfecISHCENQ,LAAAGAAAdADAZADBKAFAJAFBRCDA.....TCAAOAHDeAHBhABASDBHHCGBEEEBaDFEhAAAACCA..DFIBUFFA.hACA.bGDAMEIBBHHDfFAE.CGCA.hACANIAB......hAFA...,1,-1,-22,21
aPEYdeFUONTIAZbSMGcXHJCRBWfVKgDLQ,ZAAAMAAAGAEAHACCRAFFBADB..VCCBDAGAaBGAEBHF...eCABhABAOBBB..TCGAhACAAAHAbEFA...XCCChCBACFAAKFDALHEAQEEB.dFHA.NIEB.hEAA......hEDA...,2,-13,-1,12
ObTJSUWDLZMKEBNfXAHgaecIYPFGRdVCQ,HAAAeAAA...IAEAFADDRAFAdCFD.QDDCbAFD..TCCAhAAASCCDDAHBZDAFhACAEDHFfDHAhADAAAAA.aECCPFABGEEAOEGH.WFFDhAFAMIAABHHA...hAIA...,1,-5,-12,7
FNDEMLfRdOIJYceGgPUXWHVCBAKSZTbQa,ZAAATAAAaACA..DAFAEACE.LAEBRBEA.dAGAOAHF.JCCFhABAeBHH.GCCAhAAAUEEAHDGBBEFAACCBSFBBhBFAbFEAQGBCMIEA......hAIA......hBGA...,2,-19,-7,12
WgRCaBbdfXKVJQZAeIYEDPOULNMHScTGF,eAAAEAAADADAOADC.LAGBHAECTBCAGCCAFBHDREFAaCFBdDEAKCBDhAAA..QFAAhAAAAAHA.IGEAhABAPDGBMEIBSGHBgFCB.BHGAhBCA.....hAFA...,1,-9,-12,3
YCSNOEJHgAQTLXIVDfRWMBeFUacGdbPKZ,TAAALAAA.XADDDACARADA..MAHBeAFA.FBHDUCDBGCAAhABAdDGDKEEDZCCASCGDhACAEFGAHGAA.AAFAQFFAhCAAfGFEBHHAaEHD.....hDAA......hEDA...,2,-14,-7,7
CVbDZaLTfMHXgePFKJWERUNQGOAdYSBcI,dAAABAAACADA.DACAZABBLAFA..MAFAHBCAeBEAKCBDECFARCFA.hBAA.QDCAhBFAAAGA.SEEBhBIAIDHAaDECTEGA.XGGAFEBDUFFANICB..hAAA......hBCA...,1,-8,-31,23
eCgEGYUZLaVDTNbKXWMIJQPcdOfSRHFAB,eAAAEAAAGACAZADBLAGBDAEA..TAGAKBFDMAIB.QDBChAAAdBEASCBDhAAAHEEAACCACCGDUEEAaEGAbGBAXGFAhAIA.IEHAcGGA....hBCA......hCAA...,1,1,-21,22
KDEaPVdOXNAFLJHMIGZBefbRUSWQcgYTC,LAAAHAAAGADAeADHRAFASCAAQAFA....gCAAhABATCGADDDBECEFaEFBhAAAdBHAXEGAACAAMDGBZEGBhACAbFAB.UFAA.YFEBKFDB...hACA......hADA...,1,10,-4,14
GcRSLQBegHOVFdbKMfZUNYAWEXTaJCPID,EAAAaAAA...CACADAEARACFLAEB.eAGBHAFCFDFDdCCA.bCDDMAIBhAHA.ZECBUCGBABBB.hBAATEGAJEHB.IHHAhAAASGGD.BHEAOEBB...hCAA......hCEA...,1,-17,-19,2
dJFbLUEZQNgePfXTRIOMcaYKGASDCWVBH,CAAABAAAHACAdACAFAFALAEAZBFE..QCAAeAHH..XCBChAAARCDBMDGBaDHBGCEAhAFA.ACEBDDIBJEAFEFHFhAAAPEGD...TGAAOFFHKGCC.SGHHhAGA..hBCA...,1,-7,-22,15
fNXAOIUedJBDYTQSKVGMgREHPLaFWZCbc,OAAAeAAAdAEADAEAQAGA.KBCBGAGA.RBBAHBEBhAIAaCEEZDEEbEBA..fEBAhAAAADDBUFFABGBATFFAhABAMDIBEGAB.LFHB....hAGA......hBEA...,2,-15,-12,3
cGCaFYLgfAWIPREeMUVZBTKJDXOHbSQdN,..IAAAEAAAeACAUACAZAFBKAHB.DCCAHAEA.QCFAhAGAdDAAGCGAaAHFLDDBhAAAACBBRDDBMDIBTGFA.hBCAOFBDbFGDSGFFCFFC....hCAA......hDAA...,2,-9,-7,2
TLQNbfSPAXHJREcMYaWCUVOBeIDFgKZdG,HAAAEAAA.MACAaACDUAEABAFAeAGH.FBDDZAGBGCEATDDALDHBhAAAQEBCfEGAhAIAABIBREGB.YCCFhBIACCBDOFDE.DDIB.......hCAA......hCIA...,1,-9,-12,3
NfPAdZFKgSXQIMcOGDYCBUERbHLeVWaTJ,ZAAAKAAA.SACEQACC.MAEAGAEACAHA.EAGAHBEAeBHFaCGEhAAATEDA.fCCEhABAADDAdEEAXGBAhBGAODGHBEHARGAA.bEFDWEHH.NIDB....hCAA......hCBA...,1,9,-16,25
EUfVWOcQeTBLbMGdZHPIXFJRCDAgaNYSK,aAAASAAA.EADAfADA.OAEDeAFATCCAhAAALAGBGCEAHDAAXDDDhADARCGBABIBgDABhABAKDHBVFGBQGAAbGBAMIAAZGFE.FGCEDGBAhAIA......hBAA...,2,-3,16,19
eSNWgEfVBZOIKdYHAPXRaTQMFUJDGLcCb,RAAAaAAAMADA..FADADAHBGAFALBEBCAHA..eBBBSBGDhAAA..gDCHhAHAECCABDHAZEDAKCHBHEFChBAAAAIBTGEAQFDD.cGGC.hABAWDBDfHGFhCAA...,2,-31,-2,29
gBQIOAfcWSFZeLRTPEbGMVKCUDYHdJNXa,...fAAASAAAeADARACFEAEEGAGAMAHB.CBCD.DAIBHCAAhAAAdCEA.XCECaCGHQFFAhAAAAAIBFEAHZEFATGAAhABAbFCBKGBBJEDFBGEAOFHFcGGA...hAGA......hCAA...,2,-11,16,27
CJbPTNGgMZXRFKdWAYSHQcEDaIULBfeVO,HAAAEAAADADAaACA.LAFAeAEA..CAHA.bCCA..TBCAGCGAhAAAZCEBRECAdGAAACBB.QGCBhAGAICHAfDGEhAAAOFGH.PFGBMFIB.....hAHA......hCAA...,1,10,-27,37
gQZUFSRBLOVfPJbWHITANaYcMDdECKeGX,aAAAMAAA.dAEAEADAKAGAGAFA..QBBAZBBASAHBhADARCEALCHBODDBVEBAhAGAfDHA.bFBDhBAAHFFAAEFB.cGECeFGBXFDD.hAIA......hBAA...,1,6,-14,20
ObdMaGIQSBeKPRHTYgJAUVLZEfXFCDcWN,LAAAEAAAFACD.DAEA....NAEAdAFAGAGA.QBDAhABAeAHBRCGBHDEBTCAAJFBAADDBhAAAZDDA.CEHAOFCAhACAMFIBaGEEBGBA.KGDD.gGGA.hAIA......hBFA...,1,-5,-14,9
OVBIGTSPUQfZKMAWRYFECbceHNadLgJDX,RAAAEAAACADB...eACAHAEBdAGALAGBDAIBOBEDBCCA.GEDAhAAATDAASCHHhABA.QFFChAIAZCCBACCBFDGAbEECaGBB.JFHBIHHAfGBA.KGEAhAAA......hADA...,1,-6,-12,6
baVedZLREPTfJCGKDcOWYISFMANBQUHXg,QAAAHAAAXADBaACE.eAFAZAEBEAGATCCA..CBHAGCFAhAAADBIBOCAB.ICFAhAAAMCDBADAABDHBUEEAbCGDhACAdFHAPEEBKGAA.cDADSGHBhAGA......hCCA...,2,-4,0,4
RIdXLOPACFQGNUfYeaTDMBZKVESWbJgHc,QAAAGAAAUADAeACADAGAZBFBKAFAEBHF..SBHHhAAA..bCDAHDBBRDAAdEEAhAAALDDBAAHAFDHDfFCAhADAaEHBMFFBBGGDVGFA......hACA......hBAA...,1,4,-16,20
UGeMVcIOZFaHRbQPLJNETWDKgCSBAdfXY,dAAAXAAAGADA.eAFAMADA..ICGAZAEEHBCB.RCEFbCGBhAAALDAA.EDFBTGEAhABAKDHBSFAAhACAAAIBfGGBVFGB........hADA......hAFA...,2,-15,-4,11
MLHRPGUeNJfQXFICaOZDgAEWbcYBdKTSV,EAAA..bAAABACAdAEAKAGASADH.MAFAHCAA.RCEAGEBAhAAAeBEHJBGBQEEBhABAFCCHCDHA.ZEGBABIB.WFHHhACATFEA.PGBCfGAE..hAGAaGHBDIDA....hAIA...,2,-21,1,22
XcUEBAVHRGdCKFTWLMOgaIbDJYPfZNSeQ,HAAARAAAdADAFAFATAEA.MAHBOAHD..aCACDBFB..PCEBhAAAZDDAeCGBQDGBhACAUGGA.AAIBGEAAhADA.KDCBWCCDLFFA.gGCAhAEA.IHHAhAGA...,1,10,-35,45
WeSUgFLPGOIXJRDTMbBAKaCHVfcZYNQEd,aAAAHAAA.VAEAZACBQAEAdAHA.eAHBSCAA.hAIAFCEHGCGAXDCDhAAARDEBMBBBAACACDGA.fECAhBAANDIAUEAA.LGBAOFFBDGDBBGGDKHGA.hBGA......hCAA...,2,-3,0,3
FBOYEdcATfGDUJZNQSPHIbRLXVgaMeWKC,GAAADAAAZABE.QADAHAEBRAGBLCCB..XAFAhAAAaDAAeDGBCCDDOBHD.hADAECFFAAIBTEEAfEEEhACAUGAASDADIHHA.bEGDMDIBFGAABGEDhADA....hAGA...,2,-6,0,6
bQcAWSUBGLTHYCKFIDVEegNPZafROJMXd,SAAAGAAAHADAKADADAFA.EAHFeAFE..PCDBaBEERCCBMCHBhAAAdCFAQEGAhAAA.ACIBBFDATDAAFFFHhACAgEFDfHDBXFDDWDAD..hABA......hADA...,2,-25,5,30
GJFeAZKfNaVSWgOYHPRbTMcBEUIdXCQLD,ZAAAKAAA.aACASACB..OAEDHAEARCCAMAGBEBHFdDGDQDDChABAGEAAeEEBhAAAAAHAVDGB..gGCAhAEAPFFB.TGGABBHAIHBA.hAGACHHADCCB....hBHA...,2,-24,11,35
UTVdeGAJaEPQBISLCbXgMfKYWDcNFZROH,EAAAQAAABACALAEACACA..bADDMAIB.KCCADAFAFCEARBFAHDFChAAA.UFBAdEEAAAFAhAAAaDCCSCGHhCAA.XGFAfFFA.....hCBA......hCCA...,2,-33,-13,20
IVUOSJBYFNgCKcMAHQfTPdeabEGDRLWXZ,HAAATAAAeACE.EAFERACFLAEBZBFE.UAGASCCAhAAABCADFDFDCDFAMDHBADHA.QGFChAHAdECAGEGAXEEChAIAOEEHNIBB........hAAA......hACA...,1,-3,-14,11
AaHgDWGOePSERbJMLdKTfCNYQBVUcXZFI,HAAADAAAGABBeACEEAFERAFF..MAIBdAHATCCA..CCCDQDEChAEABCEBUDGAZEEBhAAAACHBaECBgGCDhCAA..OEGDSGGAbFADKGFD.NEIA..hCCA......hCGA...,1,-3,-14,11
RcgefKAOHNTWDdaFMCbLIPEVQYSJZBGXU,HAAATAAAdADA.aAFAMACALBFA.ECABQAFA.hAAASBDBZCCAGDFAhACARCCBeBHHADHAOEEHDCFBbEFAhAAAIGBAPGDAYFHBBGHD...hAIA......hBHA...,1,3,-12,15
OHUDaeTgVdbfcRKPSBMJACZXINGELWYFQ,ZAAAXAAAGAEALADAFAGAHCAA.aACAeAGH...TCDAhAAAdCHAbDFDRDFAKDCD.BEAAhABAADEBCFHBEGBAQFCAhAEADHDA.fFFE.SFHBhAFAIHHAWHDA..hABA...,2,-15,0,15
ZWKcfRXVSYdMFCLUPQIGHbaEJADTNeOBg,TAAAeAAABADA.ZAEBKACCRAGB...SAEAdCCAMCGBLEEBhAAAQBGAHEGBECCAAAHAhAAADDIBOCED.gDGGhAFA.fEDE.XFGChCAA...hABA...,1,-13,-26,13
ZEHLgaPJXUNSMGQIfOVAcWTdbFeDCYKBR,TAAAdAAAeADA.CAGA.BACBZABB.HADBLCEAaAFA..JBGFXDCDhAEASCCDGEEAhAIAQEEAOCHDAGCAbFBBhAAADGHBRGFA...........hAIA......hBFA...,1,-13,-16,3
RZNBMgGdJTOWXKHEaUcDAeQIPCSbYFfVL,eAAAQAAACADA.SACAFAFALBFARAEFZAGBMCCBGDAAdDDA.hAAATDCAODGBKDHBHFEBhABAEEFBUGCAADHA.bFGDhAAAfHGFBGEA.......hADA......hAGA...,2,-17,7,24
NacJPMeHTQYWgBUFXfOGLDACdZKSbVIER,ZAAASAAA..bADBEADARAFA...aAFDJCAAeAHBHCEBTCCAhAAAQCGA..hABAgCFAFFGAOGAAhACAGDAAAGGBCHHA.dEHA.KEEDNIAB.MFGB.BHHAhABA.....hAGA...,2,-10,5,15
acbPZBJfSCOXMWGNdUEVYHgQLFDKReTAI,aAAA..bAAAZACBBAEA..SAEAOAFDMAHBGAGAdCAAECCBhAAAHCEBLDFAhABAKBBDRECBAAIBIFAAJECF.hACAXFGAUFFA.gGFGDAIB..hAFA......hBAA...,2,-12,-10,2
ADPVOGXHcQfTESYFgNedKWLMIaZJbCBUR,DAAAOAAAHABC.QAECEADAFAFD.eAGHdAHALCCB.hAGAaBBHbCCCBCEDAAIBGDGAhBAA.fEEAhCAATDGASEEBgGEAKFHB.MHBA.hCBA......hCIA...,1,-7,-19,12
aPcJGdeSTLWCZbBFXHIEQYKNgRDOAfUVM,VAAAaAAA....JADAeADELAGBZAGBFBDDHBBC.ECEAQDEDhAAAKDHBREEA.ABIBMDIBhAGA.GGCBdGGA.hAIASFFA.CFCABHHA...hBAA......hBBA...,1,-8,-26,18
dAGTXIHfNMLVZbOcQYDSWFUaBEPeCJRgK,GAAATAAA.HADAMACAZAGB.OCDB.QEEASAEAhAAAFDHDaAGDEFAAeBDBRGAAdGHAhAAAAAIBfCCEhCAA.LCFA.bEFADDABBFED.CGGAKHEAhDAANICB.....hACA...,1,2,0,2
KEbWfMBGXZJUPSHgCFeLDTQYacNAOIVdR,OAAAdAAAEADA.....bADAMAGB.GCABZAGBUCCAHCGBFDFHhAEAeAHBLEHBTECAhACAaBBHABFBREEFKFAABGGAXFCBhAFA...SGGDDFIB..hBAA......hBIA...,2,-16,-3,13
DMWbaKdSJPFXAefZEgTRNYCLQHIcVOBUG,eAAAEAAARACA.CADA.HAFB..VAFABAHAGCCAMCCB..aCHDdDHASDABhAAAFCFHAAAAZFAB.TDDAhADALFFB.IHHAhAFAOEGBDFAB.KFDD.PFHD.hAIAfHAF.hCAA...,2,-18,1,19
FIeSCWBdAYQTUELfMDVKNacXOPZRgGHbJ,TAAAEAAALADA.MAHBKACCaAED.OAGBRCBAHCFB.bEAAFBHDhAAA.eCCBCEED.dEBAAAEAQFGAhAAADEEA.hAHANAIA.XEFA.gGGA.hBCAJFDB.....hCAA...,2,-10,-9,1
MBbCROHAeYcENFVTdIXgZDPJSKfWULaGQ,eAAAEAAAFACDdAEA...XAGAZADBDAGA..SBFAKBCBUDEAGCGAhAAAMBIB.bEBBRDEAHFBAhAAA.ABFANHDBIGAAhABA..gFGEfGGE.aGCDhAGA......hAHA...,2,-18,-16,2
RFIKBgDaVCEJdSPANXLeUMYOZHGfTbWcQ,LAAAeAAAMAEAZADBHBCAGAFA.TCAAbAFA..QCFAhAAARDEBKAHBDDHB.aDEHEFBAdDHAhABAACCA.XEBA.hABAOFEEfFHAFGHD.BHAA...hBEA......hCAA...,2,-13,6,19
fDQAcbMRFHYPJKdWGOEaNZVBXLegITSUC,MAAAHAAAJADAdAEAGAGA..EAGEZBBBXCAAeDCH.TCFAhAAACEEAQEGB.hACAAAGBRGDAFDDB.KDHB.aEFChAIABHHALHCA.SFCADBBB.hAIAcGGA...hBAA...,2,-19,-4,15
eEGANDFQHSRadgOYXCZMWJbUcBTKVIPLf,FAAAHAAARACF.dADA.OAFACAEBZAFB...MBFB..JAHBUBGBBCEChBAATDGA.KCADVEEAhCAALDDB.EFFBhAAAADIBDFIBaCCH..YFHB..WHEAhCBA......hDAA...,2,-49,-1,48
SfRFXOBHTYdUEaKWAbJZcNgPMeLCDVGQI,ZAAA..gAAAeACELAFBDADAGAEBQCCB.fAHAhABARCCAOCGDHEEBhAAAdDHAEEEAaDBHAFCAbGFAcFCBhABA.MCIBCFGDSHAABGHAYHAAhAHAWHEG......hAIA...,1,-1,-7,6
fJTPCXLKcGDFSNHYgIRVdEOBUQaMAbWZe,ZAAAeAAAJADACADA..LAFAGAGA..FCAAHCCA...gCFBhAAARCEBEDDBBECDaCHFAAIB.hABA....bECATFGAhACAKFHBSGAA.IHFAhABAdGAAQGDAWHAA..hAGA...,2,-23,-6,17
HBWQOTgdfYFAcEXPbLJVGaIZDURCNSeKM,EAAAXAAALADAGADAZAGBRCBA..SAFAeCFDHEAAQCFAhAAATFGA.dDAAFEEHhAAAAAIBbDBDaCHDDGCB..hAEACCHAMEFB.OEHD.fGAEhABA.PHFC.hAFA...,2,-5,6,11
NPCOYIKFURaEGcJQZVTbSMBLWXeAHdDgf,HAAAdAAADADA..fADBCAFA.OAFAKAHBRBDBGCBA.hAAA.QBFDhACAZDFB.bCCBMDIBLEEAhBIAeFCHAEFBgFGA.NICBIGDAhCAAaFHHEHEA.....hACA...,1,8,-32,40
PLDfZRTEJNdWGYbHBIFMgQVXCeOAKcSaU,SAAAaAAALADAZACBRAGF...EAEAdCCAGAGAHDFAFEABMCEBQEDDhAEACCFDAAAA.KFHBhAFAPEGBDBBB.TGBAhAIAWFCD.BFEA.IHHA...hAIA......hBAA...,1,-13,-14,1
ObVUKDMCJgcXdZBHWLTNPGSYaIFAeREQf,EAAAQAAA.OACCbACA..KAGAMAEACCCA...gAGAhAAAdCEDHCGBTDAAhAAAGCDAaCFCAADAREEBfGAAhAGADCIBXFFABGHALDCDSHGGhAIAFHEA......hCAA...,2,-15,1,16
DPcWbLGRCJUXHEYaOZFQVTdfKeMNBgISA,DAAA..PAAA..bABARADACAGBUAFAHCCA..ECCBaAHDZCFEQCFChAEAdDAAKEDAeEGBhADAMDIBBAHASEEDhBAAAEHA.LFFBXFBDOFHH..hCAA......hCBA...,2,-21,-7,14
IASdNVZHFfWKOaYUDJBMcTCgEGRPLeQbX,dAAAZAAAHAEAFADAKAGAaAGA..DBDBMCAB.CCCD.ECBFGCEB.REAFLECBhABAeCEAQDGAhACAXEECACEASEEBhAGAfEHAOHCEUGGA.BGGD..hACA......hADA...,2,-29,1,30
feWSDUcYHJCZNMOKPBIAQdVgXabRLEGTF,dAAAXAAARADAGAGAFADA...eCAADAGAUBGAHCEBZDAE.MDIBhACAKBDDBCEAAAIB.QEEAhAAAaFGBEGAA.TEGAhABASGDA..cGCACHGA...hADA......hAEA...,1,-3,-32,29
KdMQDPCUYBcbGSWaEAOIgTVfHFXLeZJRN,OAAATAAA.HADALACBeAFERCCBdAEAMBBBQAGA.CCFABDEDhAAAGCEB.aEFCADHAIEBAhAGAfFCEZEFBhBEAKFHBDEIBPHEA..YHFGSHCGhAIA.....hBIA...,1,8,-21,29
ZEJbgBPTHcUeVaGIfLCWAOFQYdRKNMDSX,QAAARAAAMADA.SACAEAGA.JAFAbBDD..BBEAHCFAhAAAeCDBGEGALCGBhAAAABFBFCCBdFFCDCIBZDAAPHCChABATFEA.cGDC.aGHBCBHA...hCAA......hDAA...,2,-6,-2,4
WHTNIeKJLbCBMaAXPUSQGcfDdVZROEFgY,XAAASAAAGADADADAZADE..EAFAFAHB....gBGAhAAAHCCCTDFAeDAAhABALDHBbDEDBDHAAAAAQFCAhCAAdFAARGFAOHBCYFFF.IHHAhCBA...hADA...,1,-1,-9,8
JWBKCDeZfALGMIFYPObcHTRQdXNaSEVgU,GAAAMAAAFADDOADAHAFA.RAGB.dBBA..aCDAECEFUDEBBCGADDDBeCHHhAFAZEGB.AAHA.LGCAhAAA..IEFAhBAA.PFHD.......hACA......hAIA...,2,-23,-19,4
JNGSLcAdYbeQWPKgHORIfBMDCZUVTEXFa,dAAAeAAAQADAKADAHAFBRCCABAFA.MAHBZDFEUFAA.EFGAaCAEhACA.GCFALGFAhAAAAAIB..bDAA.gFDAhADAfHDBCFHA........hABA......hAFA...,1,-12,-16,4
YHbFUMGTdBcLePVWCOaENgQfDSXJRKAZI,ZAAAHAAAFADAGADAdAGALCABeAFA..PBHDCCCD..ECEBQCABhAAA.SCFHhACARDFFAAIB.bEGDhADAMCIBTFAABFCAcFDAOEEH.aFHH.hAFAfGBEDIFA.hAGA...,2,-28,3,31
NPEeQRWIADXSbGJUfYTaBOVcZdMLCKHgF,SAAAGAAAUADA..TADAaAFEOAHDZAFBdBHA.LCCBhAAAHCECFDDHEDAAREGBAAABbEDD.hACA.JFEBBFAA.MEIBhABAKGAA.gFFB.NIAB....hAGA......hBCA...,1,7,-15,22
agFKPXEdeWNCIVJBAHfMTORSDYbcZLGUQ,HAAAMAAARACADACA.....bAEAZAFBGCCAaAHDKBBDECFB.eBHHhAAACCDA..JDGBAAFATFEAhAIA.SEHHhCAALEEBQFAAFGCHPHFC.dGHA.WFCHhAFA......hBAA...,1,11,-28,39
AZbfQFKUOHcePMaRSYNgLGTdCVIEBJWDX,ZAAAQAAAKADCHAFAeACAMCABRAFA..SCDA..gCCAhABAGCGAdDAACCFDECHBhACABDCDDEEAACIBbECAFEGDOFFHhAHAaFHDLGAAIHHAXGDD.hAIA......hCBA...,2,-19,9,28
fLDdBUSITXJWaGVAecCNKZRYbHEPOMFQg,eAAACAAAZACA.RADAHAGB.ECCBMADA.QAGALDFAdEAASCCAhAAATEDAXFGAhAAAaCFDGDGAAAIBKFCDbFDB.hBIAFGFH..DGGBBHHD......hABA......hAEA...,1,1,-18,19
QDUeYNXIKPGRBFcVAdCMJbWgSOHETLZfa,dAAAMAAAJADA....bABASAGB.HCACEAFAZBFEaBHD.hACAQCCCDCFB.hAIAeDFAXDFDKEEDRFAAFEHDhAFAADEBCECAOEHDTGFAfHBFUGCA.hBAA.YHEC.hAIA...,2,-13,-7,6
daLTSPfWMJZQBKcIbEeXHDGYNgOCRVUAF,aAAATAAA..SACH..fACBMAEAZAFEQCDDhBAAKAECbAGD.ECGAhBBAHCCAGEBAgECAhAAAREEAADIBdGGA.LEGB.PFEDBHEA.hBEAcGBC...hCAA...,2,-6,-2,4
JTQaWIVEPDXOALNSBUYGHcbeKdFRZfCMg,LAAABAAAGACAHADBeAEAdAFBRBFFZBFEMAIB..TCAAQCAAhABAaDFD.VEEBEDHBXEAAhAAAADDBSDHDhACAUGGA...bEDDfGHACHBA..hCAA......hDCA...,2,-7,1,8
CYAEgGKXDHIVWQPSRUabeJTLOfcMdZBNF,EAAAGAAADADA.HADA.IAHAQAFARCDAUCGAeBCB.TCEAhAAALFAA.fEFEhAAAdBHAZDBFFEEHADABXFGDhACAPEHBaGEE........hAIA......hBDA...,2,-13,-2,11
KFdQLWcZRaXeUTbEAMgCOBJGISHNDYPfV,MAAAOAAAGACBHADADAFA....fAGBFAHDdCCALCFBhBAAZCCARCGBeEEBTFDAhBBAABBBBFAASDHBhCAA.PFHBQFCCaHEE.XGFDhAFA......hAIA...,2,-17,-6,11
OBQDTJbaFgHVIUGPdWAENLcRKXSCYZeMf,EAAALAAARACA.SADHZAFBeAHFMCCBBAFAQBGAhABA.TCAAaCHDHDDAhAAAIDDAPDABAAHAKCFDhACACFCAOFFADEGAFFAAgGGAUFFA...hAFA......hCAA...,1,-1,-16,15
BfQMHFcICANRadbTPZXSYVLWOKGUeDgEJ,RAAAdAAA..TAEAZABBSADALAGBKCCAeAFHDAIB..EAHBBDAAhAAAMCEBHDEA.FECBhABACCGAADDBaDHD..bDFAXFGChADA.VGCAGEAA.gFFAhAEA....hAIA...,1,-1,-20,19
VRIZSHBcTbUEONeGaJCFKdDgQALMXYfWP,MAAAXAAA....fADAVADARAGFZCDAHAEBBDAAbAGBEDHFhAAAeBBB.GDDAhBAAaEEBFFFBdDGD.QFGAhBCAAFIBLGAA.........hBGA......hBIA...,1,-1,-15,14
aCAcYQfUDNRMHKLbJGEBVPegZWOXTIFdS,QAAADAAARABAHAEBLAGBGACBEAGEBCDDeCDAZDFE..XCGAhAAATEAA.dDAAaEEHADCBfEEAhADA.hAEAMEHBbGFAVGBAgFAA.OHCAhAFA.SGFBhAIA...,1,1,-5,6
BGIELMVXRHQgUJZbeOCdFAYNaPKWcfTSD,aAAAKAAA......fACBTADABAFBEAEELAGBhAAAMAHBRCCBHCEDQCCAhAIAUEGAbDADeCFD.dEHAAAIBPGCChADASFFDDICAIHHAXGCA..hBAA......hBBA...,2,-10,-10,0
VDPcAXbCIMNdRYGUSJEFLQWgKZOTeBfHa,CAAAMAAARACA.GACBUAFA.EAGELBHB..QCCChAFAKCAAZDAE.eCFAHDFBaBBHDEEBhAAAACFAbDFAdGHA..SFDDhACAFEEHOFHB.fGFA..hAIA......hBAA...,2,-23,-6,17
EdXSOcafPFQLRTHCGZAUbDgeNIJMWBYVK,DAAAeAAA..JACBMAEABAEAKAHB..dAGAOBCC..aBHDFBGHhAAALCEBHDDAZEBFABBB.hAEAbEGD...gFDGhABAIDDAVEGB.....EGBAhAIA.SGDAhBAA...,2,-46,-9,37
ZSKPJbdfOCIQgaWEBTNeVUHGRMDFLAXcY,XAAAZAAAKADC..JAFBdADA.CAFA..QBGAaAHB.ECEFTCAAhABA..eDBBhAAAHDDARDFBMDDBLDGBhACAAAHASEHBbGFA.OFABWECDBFFChBIANICB......hCAA...,1,-6,-24,18
LXVOFAKfQGeIRJdNHbWBPgDYUESCTMacZ,QAAAeAAARADA.dADAHAGBBAFADCCBEAHBTDDA..aCDEZDFFhAAALCGBODHDAAIBGDBAhAAAJEAB.bEEBgFCBhABASEHHMFFBXGDD.KFADIHHAhAEA...hAFA...,2,-10,0,10
MKeTLZNJGXEFcSIaUfVRHgABbODQPCdWY,OAAAQAAAdAEA.MADAeAGBZAEEGBCAEBHF.FCFD..SBDDhAAAaAHFUFFAREBBHCEBhAIAABBB.bEGDDDIBCGCA...hBCA....WHEG......hBAA......hBEA...,2,-20,-9,11
CAGMXNJfYQWRFKHbSPZVIdLcOBeTaUEgD,GAAAMAAA.JADAQADA.RAFAHBBBbAGBZCDAdCHA.LDEBhAGABDHAeDBHaDGBEFHBhAIACEEAAAAB....fFCAhACAFGGH.SFGA.IHFAhBCA...cGCDhBDA.,2,-36,-4,32
JHUXMVaAPdTgKYRLFOfNCBEZScQWeGbID,dAAATAAAKADARAFF..LACBFBHD.OAEACCBA.EAHFZDAAQBEChAAAGEDA.bDEADDDAhACAHECAUFAA..MCIBhCAAAFFA.gFGG.fGDAhCCASFHB...cGGChADA.,2,-40,17,57
ZCcXOQKNaGEJUBLFPSfbgAdHRTDIeWVYM,HAAARAAADADA.eACE.VAGBZAEECBHA..OCCAQCCCKDDDGEFAhAAAUDFA.LEHBhAFA.SFDHhAGAbFCBAAAAdEHA....TGAA...IHHAhAGAMIAA....hAIA...,1,3,-32,35
LUYSDOGeXBfFJAKWbcHNMZTaEVCRgdIPQ,KAAA..bAAAHACBZADB.EAEARAFA.dAHA.QBFALCABSCCDhAAAGCAAeDEBfCFEhABAACAB.cDGDhACAMDIBaEGB.CFDAIHFAPEEBDFIBBHHAhAAAFGAANIAB.gGGDhAGA..,2,-10,7,17
MOfPRLGEUVNFJQXCbeHadgDIYcBAWTZSK,ZAAAMAAAOACARACA.GAFAEAFE..VCDAFAHFQCCBhABA.CDHAHEEAdAHADBBBIFBAhBFABDGAACCBTFFAhBAAfFDELFHBUGGA.XGCAeHDA.hCAA......hCBA...,1,1,-19,20
UFbKLBZIHWMNgGACYQaVOPJSfdXcRDeET,QAAAaAAA.OACCSACH.dAEARAFFEBHFTAGAbCDD.hAAALDDAZEAB.HDGBhAGAMDIBGEBAAAEACDCBPEGBhAHAXFDB.DBBBeHEGKGGD.BHHB.hAIANIAB......hBAA...,1,8,-8,16
NePLHfAJUBQTEDOGCKaRXcgZIVbSFYWdM,BAAAEAAAGACAaACA.RAEA...XAEDZCEEVEAAFAGA..dEFAeBCBhAAAHGCAACHAUDFADAIBKGHBhAAA..IDBAhBDASHAGMDIB.LEED.QGBAhBGACCBD.gGGBhCAA.,2,-19,-1,18
USOaXRKGEeVYFNPcICBDdLJgWQHfAZbTM,ZAAAMAAAOACARACA.GAFAEAFE..eAHHFAHF....PCCBhABACBBDdCEALDDDhAHA.gEFAhBAAHDGBADFBbEDDSEHHaFBCKGGD.NIDBBGCDDIDA..hCAA......hCGA...,1,-7,-17,10
dRgFGIHXOLKEZaUQWVTePNSCfBAJDMcYb,MAAA..bAAARACAGAFAHAEALAHBZCCAQECATCAAeCEAhAAASAHBBDDDAEABDBBBhAFAdEFAFDHBOECBKFFAEGHFhBAAaEHB.WFHH..PHBAfGAAhABA......hACA...,1,-1,-2,1
RcZdFfMGJPIODbLQNeKBUTAgaESXYHVCW,EAAAXAAAHACACAFBRADA.ZAGB..dAGAFCCHGCDB..IEAAhAAAbDABLEEAeCFDBDHAhAEAAAAAaEHD.SECAhBIA.VFGBfGEAMFFB....hADA......hAEA...,1,-2,-19,17
gIKMDOHFeYECfWPNZdTUVRSQJGcBaAXbL,LAAAKAAAMACAHAECeADHEAFA..CAHB...fAHAhABA..PBCDdCAATCEAhACARCEBQCGAhAAAGDGAaCCHAECBbFGBDCIBOEEHFEEHYFAA.hCAA......hCBA...,1,7,-21,28
AEHacYQgOfBFNMGSVbWUZPTCeILdXJRDK,HAAAaAAA.QADCOACDFAEAGAFA.bCACZAGB.TDEAhBAAeAHBdDEAREBAABBB.EDHB.gFAAhAAABBEDMBIBSFGBhACAUFGACGCAIHEA....hCAA......hCGA...,1,19,-20,39
OAbMDNHZVLYUfKEFCRJXBPcdWGSQaTegI,MAAAHAAAZADBLAEAUAGAECABRBBABBHA.dCFAGCEA.aCCBeDDBhAFAODGDABBADDHBVFBAhAAAKFFAFGAA..XGGAhACA..WEHH...SFDDhAGA....hAIA...,2,-31,1,32
MZQKBFPUROVCSgfWGDYdcJeIXTLaHEANb,MAAAZAAAQAEAFADD.RAGB.CAFA..SAGH..fCAAhABAGBBAdDEAeCCBhACATDGAHEABAAIBKFAAhAFABCEDOFCDgDGADFGBJFHBLEEBhADA.EGGA.NIAB...hAEA...,2,-18,-4,14
RgXCKVPULDYQJHAMWFeNGOBSEfTbcdaZI,MAAAeAAAGADABADA.EAFA..TAFAdBHAZCFBRBBB.CCCD.KBHBUFAAhAAALDEAQFDChABAHECAAAHAFFHBSEGAhAFA.bGDAaDBCIHHA....hBAA......hBBA...,2,-18,-3,15
TeGYCHAUDIWKVbdZLPSBOaNQJEFfgRXcM,DAAAKAAAdACAZABELAFABAEA..aAFDQCCA.ECEAfAHAhAAARCGB.MCEBhAEAeDABGDFAHEFBAAGAhADAIDHAWFED.PFDBOFHDFFHD..hAHA......hCAA...,1,-5,-32,27
GcIOdbaHJAMgUCWNePYSLfQTVFBDXREZK,MAAACAAA..eACASACALAGBQAFATBEA.BAHAhAFARCAAEDEBGCCA.OBBBhBAAaCHDHEFBACFBgCGAhCAAUGBAWFHBPEFB.fEHAhCEA.DGIB...hAAA...,1,-5,-14,9
aMCOEcWFSNbBAPgLJQefKUTdYRIHDXGZV,LAAAeAAAKADAdAFARADFHAFBGBGAZCAAaAHF..MCCB.EDDAFDFHhABA.SDHBhACABAHBAAAAJEFBQFAAhAFA.TFGADEIBCGHDWFEDPHEC....hBHA......hCBA...,1,-2,-28,26
AbFNBUJeTaSMPRKOZgDGYEXcLdfHCIWQV,FAAABAAAeACHaACA...MAEARAEFZAGBGBDA.EAHFLBCBhAAA.HEDACBFAQDFAhBAAABIBbFGD.UFBATGAAhAGAKFFDDCIB.YHEGdGCAfGEAhCAA......hCBA...,1,-7,-14,7
SgaBFJVKWefZNEPbYQOGTXALDRCcMHIUd,RAAAMAAAHADBdAEA..aAFAFAGAKBGD..eBBAZDAAECHF..bBFDQEEAhAAAGDDAABBALCHBhBAACCCD.IGFAhCAASEGABHDDVFBBfHGF.hABA......hADA...,2,-13,-11,2
PSeZGTMNbFXJKQLdRCHADWfEUVOgYcIBa,DAAAEAAAUADAOABE......gAGAIAFAaAGDeBCDhAAAGCCA.MAIBhAEAbCFAFDBHKCFD.dEEAHEFAhBAAAAGAVGFABDHD.SGHB...hBDA......hBFA...,2,-22,-17,5
IZDbPMdUCWHOQGcgVLJYFREfBNeKXSTAa,ZAAADAAAMADAdAEACAGA.HAFCGCAA..VBBALCGB.FDDAECEAhAIABFFDeCHF.SDEAhBAAAACA.bEBBPFHDhABAOEHDQGABgFFDRGDENAIA..hAGA......hBEA...,2,-16,-2,14
faTdRGAEZNgSFeKLQMPVODXcUHYIBJCWb,EAAAZAAASACEKACA.LAFAMAEAOAHDDCCBUCFAHBDCBCHAhABACCCD...bDDBaDEChAAA.RDGFABGAFECDeFFBQFFAhAGAXGDCIHAA...WFHHhAHA.....hCAA...,2,-20,-12,8
dMaORCAJfgYDNHUcZXTQEWPVFeIKGbSLB,JAAA..fAAADADAHAECZCCAQADA.EAFAVCGBeAHFhAAAGECAbCAA.LFFAhAHAdDFAaCHDREDBAAIB.gGCDhACA.UGGA......hADA......hBCA...,2,-26,9,35
VQbNBfaCLPMdJSTFEWZgAcGKIYOeUDXRH,GAAAKAAAOACAeADA.DAHBHAFA.QBCDbBFD.BCFDhAAAaBHDLCDBdCHASDDDhAHAEEABZFCAAEEAIFFAhAIAXFFBNEIACFHAMHDA......hCAA......hCBA...,1,-2,-22,20
EPcNfQYOdLKTSWHgRVUAZeXaMCDGbBJFI,eAAAaAAA.MAEAGACABAHAFAEA..EBCA..PAHB..hAIAfBEAQCEAhBAAdCGATEBAHDEBRGBAABBBZEEAhBEADDDBIFHAcGDAODHFSGGDhAAAgGGG...hABA...,2,-21,6,27
BeFfYIEDLHgdMXSKWbVAUNJQaTPZcGORC,UAAAQAAA.aACEZADA.GBGARAEFeAGHFCDA...fDDEhAEAECDBHDAAdDHAMAFAhBAAKEFB.bGAAABIBTFEAhBCAOFEBBGHA.DAIB......hAAA......hADA...,2,-27,1,28
bCQDIAKLZPORXVaNHUYBEGWSfFcTgJdeM,ZAAARAAA.aACAHADB.BAFAEAFAGBGASAGHFCCH...TDAAhAAAdCFCeEDFMAIBbFABQDDBhABA.ACCBLDGBhADAXFFCNEIAUFAB.fGEAhAFA.....hABA...,2,-14,5,19
ISRVaMdQZOUFACfWgbcJNGDEPBYXLHKeT,CAAA..fAAA..bACAJADAGAGAEAGEBBCALCAAhAAAHCAAeCEATDEARDFAaECAhAAAdEAAZECFFFCB.AAIBgEGAhACADFFBXGGASGAAMIAA...hACA......hAIA...,2,-6,-6,0
IPLMNOGEAZfRDJCBKgcdFHTXYQVWbaSeU,RAAACAAAKACAdADAHAFA...TCEAQAEC.VBGBaCCHeCGHhAAAUCAALDCBhAAAMCIBGFABAAGAZEDBDFFBBFFAhACAFGGAYHAASFHB.IHGAOHFC.hABA......hAFA...,1,6,-18,24
KJgUAafSCFdYWDNOELGcVBPbZHXeRMQTI,aAAACAAAdACA..DADAEAEAGAEB.BBBDZAGBHCDBRCDA.MBIBTDBAhAHAKCBDUEAB.ABGB.hAAAFCHB...YEFAhAIAOEGBLHEA..cGGAhBAA......hBDA...,2,-33,-17,16
dQYSVOKICMcTDNegPGaUAWbEFZHRJXBLf,EAAAHAAARACA.BADBLAFBdAFAQCAB.SAHBhAAAKAHBMCCBTDDAeBGHGDCAhACAACHBFDABZEGBfCEEhBFAOFCCCFFBDDIB.gFFAaHAA.WHEAhCDA......hEAA...,2,-13,-7,6
ZIgHUWBRFdCcPNGQefAYbEKTaSDOLVMJX,EAAAaAAA.DADALADA.MAHBZADEHAGBBBBDRCDAdCBA.CCFD...hAAAPDCBGDDAeCHHhAEAAAIBbFGBKEFB..SDGAhBCAOFABXGCA.IGHAhAFA......hAIA...,1,-17,-18,1
KQEVJWGdMeLPYSTcRDICfgNOAUbHFZaBX,HAAAaAAABADAQADC.EAFEVAFAGCABeBBBLAHBhAAA.SCFBhACARDABCCHAfDDAODEDADGBFEFHhADAZEGBKHCAdEHA.MFIBPFDD...YFAFhAFA...DHFAhAIA...,1,16,-22,38
SMabcUfLKERBQHGTADJOIdPgXCNYeZFWV,OAAAdAAA..XADACADA..eAEHZABBFAGASAGAhAGAMBGB.aBBCUDDALCGBhAHARDGFHEABACIBDDDBJHCA.gEEDhBAA.NEIA.YFHB..hAEAbGDC.....hBAA...,1,-15,-17,2
FYQgGbRPAfOSHNIZVJecMWBXTLCdEKaUD,SAAAHAAAZADBeAFAMADABBHA.LCCDEAGAKBCA.DCABQBEChAAAGDEARDGBACGBOBHDhABA.IEEAhCAAVGAA.JDGFXGGAdGGDaHCA......hAAA......hACA...,2,-10,-5,5
gRWbZaDeHEMQfXJKSINAdOTLBUGcCFVPY,dAAATAAALADA.GAGAFACA.VCBAgAEH.RAGFZCCAhAAAeCFBHDFBEEABMDIBhACAfFHAKEEBSFHDhAEAACIBBHEA.........hAIA......hCAA...,1,-9,-18,9
PADHXQFMUNfWcKaeTRCYbVgZSdJGIEOBL,HAAAQAAAMACAUAGA..fACFKBDAeCCBRDGBCAEAbAFDZEDBdFBAhAAAGCDA.EAHBLFFBhBFAACDBFDHD..cFCChAAA...aFFB.TGGA..hAIA......hCAA...,2,-10,-7,3
aADQMOSbZXWcIEFRTCPYKNfUGBVLdeHgJ,MAAASAAAZABE...XACDIAFARAEA.CAHA.KBHB.UDDAhAAAGCCALDGBHCFAaEFChAHAAAEAQGCAhABAOEHDcGGCEGFBFHACPHCA.....hAHA......hAIA...,1,-7,-12,5
XWRaYDUTISKcNOeLCbMPgHFQEJfGVBAZd,dAAARAAADADAUADA..SAEAKAFA..OAHDeAGHLCCAhAAAMCCBHDDAECHFGDGAhACAAAIBZECA..aEEATGCAhAHAIFHACFFD.gGGG...hBAA......hBCA...,2,-25,-15,10
EVGdQBUMIefgPNZFCKYbLWSORDJaAXTHc,HAAAEAAAdADAQADCBAFA.MAFAeAGH..fBFAhAAA.gBGHhACAZCBAKCHBbCEDLDDBOEGDRFAAhAAAaCCHAAIB.TFFA..cGEA..hAFA......hBCA...,1,7,-24,31
UcASFIHZBPXRDaQgEfNeWJYVMdTbGOCLK,FAAAHAAAZACBXADBRAEA.QAFAEBHF.eBHHJCEFMCGBhAFAbCAAGCEA.LFHBhAAAKDHBAAHABFGAaGDBfGFAhACA........hAIA......hBHA...,2,-46,11,57
EYIXCAPQZFgbDfcNUWTBaHdJeOGLMKSRV,ZAAAFAAADADA..fADBUAGABBCAHAFB.eAHBGBDAMCABhABARDFA.ECCB..XFBAhBAAACEBQDFB.hBFAbFAANIBB.aEEH.dFHALFFASGGDIHHAhBGA.CHFB...hBIA...,1,13,-32,45
ebJQCALOHZKaTIERNWVcGUYfXPDMdSgBF,HAAAaAAA.EADERACF...VAGBGAEA.UBGAXCAAMBBBdEADhAEABCFDeDEDQDDChAAAAAGAZEGBKGEDTEGA.hAIAIFAA.cFFC.fGEEhACADFIB.SGAAhAFA.,2,-14,-11,3
MXbLZTKVgRBdeFCIPAfYcGQWHJESNaODU,...fAAAGAAAHADAEADA.aAFADAGAMAIBLBCAZCDATEEAhAAAKBGARCABeDDAFDHHCFCAACFAQDGAhAAA.SFFBhACAODAHXGGAbGBABHGAdHCB..hACA......hADA...,2,-3,2,5
OBSNRUceAKTXDaLIYHEWMQdCFZgbfVJPG,TAAAaAAALADA.HAGBEACEMAEAdCCAZCDB....bAFAfDGEhAEAVCCA.GFABhAFASCFBRFEF.hAIAeCHBABBBDDIBIFEA.QGFAhAAAFGHB.....hBAA...,2,-2,0,2
TLEbNBMfOHIJKXeYWDUgVPCZcdAFSQaGR,QAAARAAAEADE.BACAMAFAHADBKBFA.eAFADBIB.UCGA.VEEBhAAAZCCAAAAA.aDFDGGABhAFALECBfGHAhAGAOEEH..JFHB.......YHDGhBHA...hBIA...,1,-7,-20,13
CfUcYGQbSIPEMDeWHJOdRLBZAaNXFVKTg,aAAAFAAAKADA..TADACAFB..UCCAGAFA.QCCChADASAGHEAHBDAIBHDGBhAFAdDAALDFAABBBXEEDhAIA.fGHA.YFDFbFCAMFIBhADA.eHDG...hBAA...,1,-5,-29,24
dSWIGgYBTLCOJHKRQMXNbFDAfZcPeEaVU,ZAAAeAAAEADEUAEA.dAHASAFBGBCABDGALAHB.OCABhABAHEBBREEBMCCBXEGAhAAAbDDA.AEBB.fEHAhACAaGDD.IFDA.gGGAhBHACGHD.KFFD.FHCAhCBA.DDDA.,1,-6,-10,4
QTOdYDNSaMELgJBCUZcXbFfKeAHWIVGPR,HAAAVAAA.RADFQAFC.dAHADADAaCACEAFALDDABAHAZBEAhAAAXDGDFCDHeCHHADIBGFDBhAAAODFBSFHHhCAA...gGDBCGHA.hACA......hADA...,1,-1,-22,21
KUYHTdDVFbAcQMBCaRGgXLJZOENWfeISP,MAAAaAAAGACALAEAZAEA.EBBA....fCEAeAHHSCDAhAFAKCGDHEFCdDGDFFAAhAFAACDAQEEChAGACAHBXFECOBBHIFHA.YGCADCIBbGAABGHAhAGAgGGG..hBAA...,2,-20,11,31
HeCENQYcMdLfZXIODgBbSGTPRFUAaVWJK,aAAAVAAA..KADAHADB.EAFAQAFC.MAIBdBHAZCFBhAAAOBBBBDAAGCDAhADAREGFADDBeEEDCCGA..cFFAhAHALFAA..XGEDDGIB.SDCDhBAA.FEHF.hADA...,1,-7,-11,4
NHLfeVCKMUXZFcAJQDPEWRYbGTgBSOIad,QAAAEAAARACA.GACBTAGABAGBOCCBdCDDHCFB.eAHHhAAAKCGDMCIBZDAAADIBDEEBhADAPDAB..bFABSDEBhAAAaFFCLFHBCEGAFFCD.cGGA.hAFAYEEF.NIAB.hADA...,1,15,-21,36
LEZHGdUMfSWRYPKTeNIaJAOFBVcDgCQbX,BAAADAAAQACALACAHAFBdAFA.MAIBSAHBRCCA.KBBDhBAAeDAB.aDFEABEAFCGDhBHAVFFACDDAEEFB.ZFDFfHABhAAA.WEEDPFHB..NIEB.hADA......hAEA...,1,-13,-21,8
CYPSRZbFQETGWgcOBIKDAUaVJNLMdeHXf,aAAAVAAALADA.dAHAHADB.CAFASAGHRCCAZCFFQEAAhAEAECHFGDAA..hAAAgEEDBDDDDDFBAAIBhADANDIAeHBAfEGEPHECbGDA....hAFA......hCAA...,1,1,-15,16
GMfNYRbUPQDOFcXLdKeSBVTgCIaWEZHAJ,GAAAMAAA...fADARACAUAFAQCCBFAFALBFAeBHHhAIABCDA.TDEAhAAACDFAaEECZFDAHDGB.ADABYGDAhACADBBBOEHDcGGDdHBBSHFAhBAA......hBHA...,1,0,-12,12
bVcODgWBfSReLGXKNZAYFMaEdQIJUHPTC,MAAAEAAAdADA..QADAUAFAHCBATAFACAHA...bBBDOCHDhAAA.DDFABAHBhBAAREEAeFBBGCGAKGGAABCAaDDAhBBA.IFFA.......hBFA......hCAA...,1,-13,-21,8
bZNHEadJYVMOXAeCLUTKIgSFQcfWPRBGD,eAAALAAAKADA.SADHQAFC....fAFAhABARCCAGCGAZEEFHAGBEGDBdCAAhACAJHAAMCCBAAAA.TDDAhAFAIHHAFDGHPFDBDAIB.aFFC.OFHDhAIA.....hAHA...,2,-18,10,28
LGXKTecJZRSWdUQbaOHFgPYVNIMDCEfBA,GAAATAAA.eADAZACBRAEAdAHA.QBFA.aCDBHCECFDFH.hAAAgECA.hACAPCABVFGBMDABhADAEDHFAAHALFFAKDHBSEDHbFADOHCA.hAEAIHHA..hAAA...,1,6,-4,10
eAfSHMbQYWLTPVJEDgRXdOcIUaGCNKBZF,HAAAMAAA.QADCLAEA.TAGAVBBAEBHFRCAAdCFA..OCEDhAFAIDHAGEFAKEDAZFAAhAAAACGBSDHHhAGAbFGB.PEDBDGGB........hAIA......hBAA...,1,7,-13,20
bFKfSELgJMYAPBRVdNZIXOTecUDHWGQCa,RAAAdAAAZADBOADA..eAFADAHBHBDAGCEAaBHDKBHB.ECGBLDBBhACAMCCB.ADDBBDFAhAIAIDAATEGA.UFDAhBAAQGAAFGGH.SEGA.hBCAgGGA.hBDA...,1,-8,-13,5
GOaUNJeTPIKBVCYLFADdcSfEbZgRMHWQX,dAAASAAAEADAZABB.RACFHAEB..QAFAGBGAaAGAUDDAhAIAeDEBTDGAKEAACFHALGBAhAAAABHADECB.bEFDMFGBhBAA.OFHDNICB.IGDA..hCDA......hCEA...,2,-20,10,30
DBEgGYXeQHSLVNWIdTcMRPJfCaKOAFZUb,ZAAADAAAEACAGAEA.eAGBHAEALCAB..VCCAIDDAhABAdAHAMBBBRDFF.fCGEhAGAaAHFAADAFEHDbEBDBEFAhBAA.XFEC.SDHHNIDB.hACA......hBEA...,1,-4,-15,11
VAFWMRScGHLbQTOIBYXNDegUCdfPJZKaE,MAAARAAAGADAHACCLAFAQAFC.TCCABCCDXCFAhAAA.eDABCAHBdCHAfEFAhABAZDFBEEEFABBBSFDDhBAAbGAA.OFHBIFHA.DCIBhADA.gGGGhAGA...,1,0,-14,14
NCAEFPLgJGIaeWHZSRDQTVBOUfKMdbXYc,EAAALAAAGACAeADHHAEARAFA.QCFABCAAOCCHKCBDbEAC.hABA.XCGA.hAAA.cEDDAAFAFDFHgFCAhACAaAHFZFGBTGAAfEHEdHDBCGFB.IGGAhAIA.SHCAhCAA,1,9,-13,22
SLEcZaCUTDFJGdXKAfHNbBRQgYIPeVMWO,HAAABAAARACAQADC..gAFBIAGAeAHHMAIBSCAAhAAAECABaCCCTDEAhAAAFCEBdDGAACFA.bDAAPDHDhACA.OFAAZFEADEIBGGDBfHABhACA.....hAFA...,1,6,-9,15
PbdVJAYGfaZXKSFCcOQLgNMBeUHDEIRTW,GAAAZAAASACECADA..QAFALAFAMCCBeBHHHCDAhAAAECGARDDA.TEFA.hABAbFAAdEHAADAB.aFCDFFEHOFFBhAGABDCDDEIBIHAAWHBG.....hACA......hADA...,1,-4,-8,4
IXJMCYRQFTfZABNDLcWUebgSGEdVPHaKO,DAAALAAAUADA.eADH..SAFAEAFAdBHAHCABOAHDXCFBhABAMBBB.RDEBTGGAhACAACCBBCFA...cFAChAFAbDDCGDGA.aFFHKEDDCGAA.FEHF.NIAB..hAGA......hBAA...,2,-32,18,50
dRKNFXYTAcaPHgBDVJUbZefEQOMGWSCLI,aAAAHAAABADADACAUAFAZAEB...EBDAMAHBGDDA..CBBDdCDChADARDGBFCCH..TDFAhAIAAAIB..gGFBhAAAVFGBeGBAOHBC..WFFD...hBHA......hCAA...,2,-22,-14,8
ebNJHODAVFPcKZGXaUMTCLYEWBfRdQSIg,FAAAKAAAGACAUADA.MAEALAGB.ECCBBAHA.RBEFdCAAQEDAhAIASCGAeCHHhBAAJEBBHFBB.ABFAPFHDhBDAZEEAaEGA..CGGD.fGFAIHCA..hBIA......hCAA...,1,-14,-18,4
OYXdGCUWaEbBAHJgLQSReFIPcTDNVKMfZ,HAAALAAARADFeAFEFAEA....IAHATBFADCABKBDAZCAAXDADhAAAGCEB.CEEAUFGAhABAECCBACIBQDFBhACA.SEEDPHCA.cFFD.hACAMEIB....hADA...,1,-7,-18,11
RTXAUDCEfGaIWNdSMZbPcKeOBVQHJLYFg,CAAAEAAAGACA..aACD..IAEAdAEAZAFB....bBGDKAGAhAAAeCBBBCAAHDDBLCFAhACAFFGA.REDAACGAfGGEhAAASEHBMAIBOFGD.QGAAhAGAYEBF.XGEDhAIA..,1,-11,-16,5
agQBUKFXfEJdVMZeRPcYONbAIDHWTLSGC,HAAATAAAGADA.aAFAQACCKBGDFCAH.EAEEdDFDZAGBRFBA.PCDDhAAAOCCB.AAIBDCIBhAAALCFD.CDHABFGAhAGAfFFAMFIBeGEG.NIBB.IGHAhACA.....hBIA...,2,-6,-6,0
bKZUEYQTgfLVJRdBXIOCSWNMDPGaeHFcA,ZAAAEAAA.QAEA..TACALAHBRAEFdAGAXCAAhABACCCDSBHHMDDAGEAAhACAHDECAEAAKEDDgEEAhADAfEHABECAOFFBDEHBeFHHFGHDcEADhAAAYHCA....hAEA...,1,-3,-5,2
PaOHBJMUVRCFNQceEAdGfIKWDTbZXYgLS,GAAAKAAADACAZADE..XADALAHBaAGAHCCCBBGAUCFARCDBFCHDhAAA..QFAAhAAAEDCBAADAdFFA...fEHAhAFATGBA.bFFDSGDBOHBE.MFIBhACACHHB.....hBHA...,1,-6,-16,10
CAedYGNMUBScTabRLJOFPQEfDZXKHVIWg,eAAAGAAAMAEASADA..aAGERAFFLAHBFBCDEBEBZCFBHCDBhAAA.IEGAhACACCHAAAAAdEDAUFBATGGAOEHBhBFAQEABDGGB.KFDD.WFFD...hCAA......hCBA...,2,-17,9,26
aXcgdFABOZMQLJDHeUSRCbNGTYEIPKfVW,ZAAAMAAALADBHACCeAFERAFA..CCAAGCEAEBBBKBFA...VEGBhABAaCGEXDCA.hACAdEGAAAFAQGDChAIADDFBbGFA.NCCA..ICHA....hCAA......hDGA...,2,-15,-8,7
XcNeJFdLZVPgGEfCSQAWUBaRDIbHYOMTK,BAAARAAADADAHAECMACAKAFA..XCCA.eAHHdAHAZBCAVDFBhAAAGCFA.EDBASEHHhABAABDA.aFCAhAHAbEDD.OFGDNIDB.......hCAA......hCCA...,2,-29,-13,16
AMcWIKZOSTDCHbREQNdLBUaGYgVfXFJeP,MAAA..IAAAZABESAEHTACAHAEBEAGA.dAGBLCCBhAGAaBGDGCAAVCGBFDDBhACAeEDHACCBKDHBCFFA.REFBBFEDhAEA..YFHB.....hCAA......hCIA...,2,-11,-4,7
OXTDNHUSLbYcGQeVEKMRdJIBgaWZCAFfP,FAAAOAAADADAHAECLAEA...bBBCGBCA.eAHHEBHFRCDAhAFAdCEABDBAaDGCZFFAADIBXEFAhAGA.TGCAhAIASHAA.YHFAQGEC.hAHA......hBAA...,2,-20,-5,15
CWGDVcaKMbXgYRdQSeILfJEUTHPZBOANF,CAAAGAAADACA.aADAKAEA..MAGB..XAGBRCDBdAHAeDBHLBCBhAAAEDGAHFCAZCDBABIBFEHDhAAA....VCFBhCAAbFFD.QFFBfHBB.....hCBA......hCCA...,2,-36,13,49
XGCJEDLBQNZFRYMdOPUfAaWgcTIHbeVKS,aAAA..gAAA..TADAHADAeAFESAFBhADAGCCAEAHBLCFAhAAAQCCCZDABREFAdCFDOFEBhABAfDHAACGAIGHAbEEBXGFDDDAB.hADABHHB.NBBAMIAAhAIA...,2,-16,15,31
FJTALKGYcEBMDRWIZXCNQUOPdHeaSVfgb,GAAAEAAADADA.RADAZAGB..CAFAUBCAdCDDHEAC.eCHHaAGD.SEEAhAAA.VGCAhACAbCEDFCHD.AAIBLECBhAAAKGABBGGAMFIB..XFGA.hADAQGEC.hAEA...,1,2,-25,27
DSHTMEJAUZdGeIRKNQWPLOVcXYbfgaFCB,dAAAeAAARADAKAGCQADA.LAGBOBHD.XCCC.hACAbDEDaCBD.BCFAHFBBhAAAEDDBAAIBZGEEGEGAWHFAhABAPEAB.VFCBcDGD..fGFEhADACBFB...hCAA...,2,-16,1,17
LdFQcfGBUbAKEDZegTOaYCRHMSVPWJNIX,EAAAeAAA.OADCaACDRAEA.HAGB..MAIBSCCA.PCFBhAAANCBALCEA.hABAdEEAQEGAhAFAGGEBBGCAAAIBZGAAYFAFCGGDWEED.....hAGA......hCAA...,2,-11,-10,1
YEUZAeaVdTgFDPBHIXbcGWJNKQSCfMROL,eAAAdAAAFADABADAHAFB..XAEDGCABJCHBQAGA.hACACCCARDEALEEB.hAAAEECFADEAaDHDTGGADFGBbGAAhABANIAB...fHGFMHAA...hAHA......hAIA...,2,-15,-11,4
WEcXFCfgZUHNabJLQSeMKATPYDdIVOGBR,TAAADAAAdADA..OAFARACF..EAEEFBBBCAGBZBFEHBEB..aCACLCGBhBAA.eDBFhBDAACEBIDGAGGBBBDDDhBGAXEECfFFEgFGANBIA...hCAA......hDAA...,2,-23,-12,11
HaBgEQCOYWTDMVUSRLGFZPeKdcXJIbfNA,HAAAaAAABADAEADEQAFC.OAHDTAFADCABMAIBSCCAhAAARCCAGCGAZDCEeDABhADAdDGAXFFChACAJEEBbFCD.ACCACGHA..YFAFWHAA.UGGB.hAHA......hDBA...,2,-5,1,6
CedOGAEFYVfJbLWZHcNUDISPaQKBXMgRT,EAAAFAAA....VADAbACA.ZAGBHAGB.UCCASCCBQDAAhAAABDAAMDFBREDAeCHHhADAGEGA.AADAfGAAhAGALGAANIBBDGGAaGBDXGDCCGEA..hAIA......hBGA...,1,4,-18,22
aAbcYZEQPBTWgXHNOMSfVKCdeJIFGRDUL,...bAAAZAAA.EADEQAEABAFB.TAGAXAGD.HCAAhABAMCABSCEBhACAKCCDeCHFFDEARDFFLDHBhAIAAAAAPECCgEDDOEADCFGDIHHAhACADHFA......hAEA...,1,-5,-9,4
UVCbGdOTBKWMIQFacRPeXfLHgZADYSNJE,SAAAEAAAUADA.CADA.dAGABAFAKCBA...MAHBQDEAhAAA.aBHDRCCAeCFH.hAIALDABHEGBABCADEDBhBFAYCHBNIEB.bFCBTGBAFFGH....hBGA......hCAA...,2,-20,-16,4
aXTLNeJYfVFPMBbCEOHKUgGSQdcZAIRWD,RAAAaAAALADB.eAFAfADA.FAFAMBIBBBBDECFAHBEAhADAKDCDGDGAdDDAAAIBDCIBhBAATFAAJDGB.PEEBhAAAbFED..CGDA.OFCDSGHBcGED.hCAA......hDAA...,1,3,-20,23
BLNQaXMWJUTEIVcgODKbCAFZHfPRGdeSY,HAAARAAAeADEBADBLAGBaAED..MAGBUCCAEAHB..IEFAhAAAVCCB.OCHDKCADACHBZEFAhAAAGFCBdGEASDGAhACAYFHF.QGGCXEBC...hABA......hAIA...,1,0,-14,14
bUWLBIKZECPOJFXAegHNVcGMRYfSTQDad,HAAAVAAA.GADA.RAFASCAATAEAaAGA.dCHA.UDFALCDAhAAAKFAAEFEBOBHBhADAXGGAADIBeEAA.gEEAhAEAMDDB.QGGADIAA.BHFDhCAA.....hAAA...,2,-5,0,5
OAcSIPNdQeFHfJKgRMTVWXBLZEYbGaUDC,SAAA..IAAAdADAeAFAHACAKBHBRCDAMAEA.TBFAhACAXDBCZCCAECHFhAIAGDGAaECADEGBAAAAPFABhAFAFEHDJHBA..gFEBBHHAYFFFhBHACGCANIEB......hBIA...,1,-4,-11,7
aPGDBSHbJZMIAVdRfKNEXOUFLcegYQWTC,RAAAKAAAEADEOACA.LAGBeAFEQBFD.CCCAGDEBhAAASBCHHECAZBEBACEBdFHAhABAXDGA.FECBhAAA.gFFA.TGCAaGGBDIAABHHAhAIA.....hAIA...,1,-6,-16,10
OTLYEaCJSQBceZAFHPMKWVGXNdDbIUfRg,HAAAMAAAKADAGADA.dAFBDAFAUBGBRBBB.TDAAEAHF..aBEESDDDhAAA.QDGDhACAeCHFADEAFDFDPFEDhADAXFGAIGGAOEEH.CHHD...hBAA......hBBA...,1,6,-31,37
JSTQDaOcfERLVYAbWXIZBCdFgKHMGUPNe,XAAAZAAAdAEAKAGAHADAGCAAUAGA.eCDB..TCFAQDAAhAAAaCCC.ODFAhABAEDHFREEBLGAAAEGBbFAABEHAhADAFGHBMFFB..NIAB.DGGA.....hABA......hACA...,1,8,-9,17
bIUVeWJcLKTSEMNHOYFfRDBCPXgdaAQGZ,ZAAAUAAAeACE..JADALAFBKAGC.EAHBHCBCFCCH.RCEFBBHAhBAAXCGD..aDGDAEEAGFCBhABA.bGFAIGCAhBCA.VGEA......hBDA......hCEA...,1,-11,-33,22
LXWZKBITFbCHUEYcOAaSPJQNgRGVMdfeD,aAAASAAA.QADARACFGAEAdAGBeAFALCHBZCCABBHAhAAATEAACCGDHDAAEDGFODHDhABAABBB.JEEFgEDBhAEAMGAAXGFDKGDDFGGA.....hADA......hAGA...,1,-3,-4,1
aLUAPfMGDgNWJBCEVOSXZFIcQHTbKeYdR,MAAAGAAADAEA..NADA.BAGA..EAEASAHHZAGBFCEBQEABhAAAHBBAKBFDeDBAhBAAREFALGCAABDA.fGHAhACAgDFA.CEHAXGDA.TGGAhBBA....hCAA...,2,-31,-5,26
PRgAYXfeQFdbLTMOZSCWBKUJIVNaDcHEG,XAAAeAAAdAEALAGB..MADAZBAECDDAKAGAUEFAVBDADAIBhAAAHCGB.EDBAREBBABGBQEEChAAA.bGDAhABASDHHBHHANIAB.aFDD.....hAIA......hBDA...,1,-7,-24,17
UMQaBAgTFLbNZSIEReHJPfOdVYDXWCKcG,TAAALAAA.ZADBEACEHAFA.JCABOAEAdCCC.DAIBCCFDGCGAhABAMBFBQCCAhAAABEEAAAHA.bBGD..SFGDhACARFFAeGCE.........hCAA......hCCA...,1,-13,-20,7
YeHMWcGPNIRQVSKJOgCbUXTALZFBDEdfa,ZAAADAAAEACAaACA..HAEBMAFAGBGA..IBEARDDBQFGBhABAKBBD.OCCBCBGAXCDChBAAAAGABGBA.fGEAhAIAeBHH..PDFD.SEEDhBGA.JEHB..hCAA...,1,-1,-33,32
eCJYHNUGOMLSfBZcIAEKDgRPFWQbXdaVT,EAAADAAARABAFACD..QAECdAEA..aAGAeAGHCBGA.HDCAGDDAhAAAMAIBLDGBhBEABDGAZEFEACIBKGBA..gGAAhAGAbGFA.TGGA.JFDB..hBAA......hCAA...,2,-21,-9,12
aCeAMWKFbdXLNJZgORfEPQTHSGYIDUBVc,MAAAFAAAdADALAEAZAEB.RBBA.EAGA..TCEAHCFBGDBAhBAA.DBIBBBHAaEEHADBBbDGDhAFA.XEECJEHBOHCChBDAQGAA.SGEH.hCAAIHHA..hAGA...,2,-24,-9,15
IMHSQWJTeYVaAgDbLFfCcKGNRBZXOUEdP,DAAALAAACACA.GADARADFZAFB.OAFA.EBFEdBHA.MBBBHCAAhABA.QDFAhACAJCCF.eEHHaEEAAEHAbFDB.hAFA.FFCH...KFFD.BGHA...hBIA......hCAA...,2,-38,-3,35
HJLEfMcAQaGTBKORebVIPZUdSDWNgCYXF,GAAATAAA.OADARACF.eAGF..bAEBICDAZAGB.dCHAhAAADBIB...gCAGhAAAXCEDHDBBhACAEDEBMEGBAAIBaFFAKECAPHDASEHBCHHA.FGBAhACA.LHFA.hBAA...,2,-10,4,14
cDHXeMJIaKFZBWgPSdfVCRNbLAGTYQEOU,GAAATAAA.EADAOACADAGAHBFA.eCDBMAGB..aDAHZBGBBDFDhAAAgBDAdDHACECARFFBLHBAhACAAAHAQDBChAAA.XEEC.KEHB.FGGB.SFDDhBDA...hADA...,2,-4,-2,2
KAZJcIHECUgWdaYXFfNSeVBPOTbGLRMQD,ZAAAJAAAHADBEADE.UAGAdAFA..aAHBFCCH..SBHHeDABBAFDhADAOCABGDFARCCAMDGBhABAQFDC.ADIBCFHAhBAAgFED.YEHBNIBB..hACA......hCBA...,2,-20,-11,9
UgZCETYKcVBbXFSLHPRAfWeNdMJQGOIDa,eAAAdAAAMADAGADADAHB.aAFAZBDA..EBFEKCBABCCD..FCHDHDEBhAAAAAIB.fCHAhABA.JDBFQDEChACAOEHDgGDBTEBAcFGA.bGBAhBAASGGD.hBCA...,1,7,-35,42
GXdKHCBEYZfNAFUWTOSDaMLeJRPIQbVcg,FAAATAAADADALAGB..RACFQAEC.bAGBgBCAhAIAdDEAHEGBECABhAAAZBEBABIBOGCAaDBCeDHFhBAA.JEFB...IGCA...hACA......hBIA...,2,-26,-10,16
CgeGbNQEdAWVcSMPYLUfBKIFHaOTJXRDZ,VAAAMAAALAEA.BBBAFADAHAFBaAHD.TCDARCDA.ZDFEhAAAeDBB.GDGAhAFAbFGBEAHBACDASEFDhAGA.PGCCfDCE.OHDAhAIADGIBNIDB......hCAA...,2,-13,-4,9
TPXZBaWdDEORHMefAQCVIKgJFcNYLUbSG,QAAACAAAKACA.FACE....NAEBLBFAbAEDGAGA.TDCAhAAAZCAABCED.dDGAhAAAEEFBHEEBeDHHABGA.gGAAhAGA.cGEASEHH.hAIA......hBGA...,1,-6,-37,31
bIQFfRTGNHZLVeXdUgKDaPSOWMACBJcEY,BAAAEAAA...IACAQACA.RAEAGCEBHADBZAFAeCCBhAAAdCGAKCCDaAHD.ODEDhAAAAEEACEGAJFAA..bGAATGGAhAFALFHB.........hAHA......hCAA...,2,-19,-12,7
OAfFZLXHRbgPBUTdSDEVYWKaGIQJCcNMe,ZAAAHAAARAEA...bADBBAHB.dCAAEAFA.VBGBKCCDGCFA.hAAAQECACCADMCCBAAIBLEEBhACA.XEGAhCDAgFABTFCADADAaDHDIGGAhCFANHDB......hDDA...,2,-21,-5,16
NUBVQIgbOHaTRFZeDKMYGdALCXEWSJPfc,LAAAEAAA.SADHfACAUAFAQAEA.bAGDhAAAHCAA.RDEAeDHHhABAMCDBdEAAAAIBXFBAhACAPCEBBEGAgGFBaEHDZGBEKHBACFFD....hBFA......hBHA...,2,-10,4,14
KUgJfAdEaDWZSCVIeBXYHcbTNFGPLRQMO,EAAAaAAAZACB..CACAeADHBAEAHAFB..bAEDTDEA.GDGAhAHARAGBMCCBKAHBgDGAhAAAABBBdECASGGDhBAAXEED...cGAA.FFHD..hAGA......hAIA...,2,-19,-11,8
fKedbHBWLSXUJOCcPTQaNIAMDVEgYFGZR,MAAAEAAAFACDRACA..KAFCeAEA.HBFCLBHBSCDHUCCBCCFATDFAhAAA..aEFBAAEADDIBhAIA.VFDA..hBIAgFCAYHFG.ZGFE.....hCAA......hCBA...,2,-29,-8,21
RFTgINVPMXQaHJSdYBLWeZUfAEcODGKbC,EAAADAAAGABBKACA.RAFF.FAEA...TBGAICHA..VCCAhAAAMCCB.QDDAhAEAHDFAdFCALFFAhAHAeEGBZFAAAAHAOHFACEHBNIBBaGGH......hAFA......hBAA...,1,-10,-13,3
SeBGVdAWaJLKPXDUbTCZRfHNYcMIFQgEO,aAAALAAA.XADDDADAUAGA.CBBD.RAFAHCAA...NCHA.hABAMBDAQDEAhACAECDAeDCBGFABADHA.KGEAhAFAbEEA.ZGDEcGGDIHHA....hBAA......hBIA...,2,-34,7,41
eXVFdBWHCQITRbfUASGaJYgPDEKNZLOMc,aAAAJAAA.......gACHEADEZAFBMAIBeAEHFCCAdAGAHCGBhAFAQDDBREEB.hBAAbDFDAFCASGHBhBHAGGBBDAIBKGHB.OBBH.....hCAA......hCBA...,1,2,-26,28
TINKXJgFAOQWVeUPGcBbEMCfdRaYDSZHL,QAAAeAAAGADABACAEAFA.MAEAdBHARCFBDAIBHDBBLBEA.hAAA.TFEAKCDDXDFAhAAAFEHDADBBOFABUFBAbFDAhBFAaHCA...SEHHIHHA.NIDB..hABA......hAFA...,2,-10,3,13
OLMAZIBdDCceEWFNaQRKVHPGgUfSYTXJb,ZAAAdAAACADAEADE..FAFAaAFA..RBDAHCACGBEBUDFASCAAhABA.TDDAXFEChACAbDGD.MAIBBFDDeFHFhADAQGEDKHCA........hACA......hAIA...,1,-11,-18,7
PFBaWMeKUINATVDEfLJcOSbQCXgGHdYZR,TAAAEAAALADA.OAGDQACCCBCD.GAEAHCDAZDFEhAAARAGBBDDAaEAA.eDFHKFAAIFGAhAEAAAIBfDHAhAAASFCHbEABdGGA.FGHDMFIBNIAB.DGAB..hAEA......hAGA...,2,1,1,0
FDRQAdePNTXCOMEVIUfWaGKJSBZHYcgbL,eAAATAAAOADC..EACEUAGA.aCCAGAEA.SAGAhAAAHCEB.gCCBhAEAbDGBLFAARCGBAAGAdFFAhCAAXGFCMFIB........hAAA......hABA...,2,-19,-6,13
VYEMdaLPKNUbDIOSFAQHGTWfeRBgCcXJZ,HAAAGAAATAEAeADARAGBCAGB...JCDAZCAA.EBHFaDAHLDFAhAAA.KEAAbDDCOEDChACAAAABQEGABFGAXGCAhADAMFFBdGCA.........hAEA......hAIA...,2,-9,-6,3
KMTQcEDRfVBeCSGPUdYJgWFbOXHLAaZNI,ZAAAKAAAMACAQAEA.EAGARAEABAHB.eBCFGCAA.dCCDhABAJCFBFBHD.bDEDHDGBhAAAAACAaDGCTECA.DCIBhCAACFHASHFAUGGB..YHCAhCBA......hCEA...,1,-1,-19,18
McQYgCZHJXOaRWfeUADTBPSVINbELFGdK,TAAASAAA..VADA..bACDEAGEGAEAdCAD.MAHBhAAAQCFACDGDHEAAODHDhABARDCAeDHHAFFABEEDIHDAhAAALGAAKGGD.gGFA..hAEA......hAGA...,1,-6,-8,2
UGFZPaRCcMdfWXLNJIeHOQbKTSDBEAVgY,VAAAUAAAZADA.RBGF.MADA..dCDAXAFALEAB..ICDAhAAAHEFAQFCAhAEATCFABDHAAAFA.GEBAhAIAaGHB.fEEANIAB.eFGB.hAHA......hAIA...,1,-9,-16,7
GOHMKAEgDUbfWSBLYJQVXTeCIaPFZdcRN,EAAADAAAUADA..bACA..SAFALAGBQCCAhAAA.TDAAeAHHaBBBhAGAZDFARFFAGCFAHGBAAADAhAIAfCCEBHHA.VEDB.CFHAFHFA.hBGA......hBIA...,1,4,-19,23
BVgAOQEaSNTbeXfGIdWKcJLMYCRFZPUHD,EAAAaAAA...SACATADA.eAEHGAFAdAGAKCCBLAHBhADAMAIBRDABZCCAHDFABEEDAEEBQFDBhAAAbEGD.hAFAfFHAIHBAWBBDYHDGCGFC.FGBDhADADEIB.....hBGA...,1,4,-7,11
KfRYLESJUACQOBeZWTbdIVPaMXFgGcNDH,QAAAeAAAZADB..TAFAdADAVAFAMAIBFCED.GDBADCCBHCGBhAAARDGBLFFBEDEASDBDhABAACIBBFADIGDAhAAAaFCDXFFC..NIAB.fGHAhAHA......hBDA...,1,-2,-10,8
NKOZWCdEXBacIgLMbVRFfTeGYUDAHSQPJ,HAAAQAAAJADAKAGCZACB.dAFABBHA..aAHB..ICCAhAAAMBEBRDEFFCHDeCABUFBAhAAAACEA..SCEAhACAOFHBEGDEXDFA.LFFA.hBCA......hBFA...,2,-22,-12,10
KfZYeaGdcbFCVNESTXHAPLOUBWIQRDJgM,LAAABAAAQACARADFDAFA.MAFAZBFBeAHHdBEAFBGA..CCAA.ECAAhAAA..TEGAHCFBADDBhACAOCCBIFHAKEEDaFCDhABA..cEECNIDB.SHDAhCAA..XGGAhACA...,2,-21,-8,13
dIVZKgLNUCFAYabSBJfGMHEWXOQRDcTPe,aAAABAAAGACAHACAEAFE..OAEARCAADAIB.TBGAeCEAdDHAZBEFLEEAhAIACEAD.ABBBbGDAhBAAfECA.hBIAMEEA.QFFCIHHA.KHAA..hAAA......hACA...,1,-5,-16,11
MgTcfNIOXbHCKWFRJeEGYZVaABSPdQLUD,SAAAdAAALADAMADA..TBGA..fAGAhAAAOCAEHCEBKBCARCDAEDHFZCGBhABAAAEAQECChACADDIBNEBAbFEC.FFGH.eHAA.......hAIA......hBEA...,2,-22,-1,21
KgEQbMXTJBVRLUWYDdSaZCHGeANPOcFfI,OAAAFAAAKADA...EADAMAFA..TAFABBFARBGFLAHBhBAA.UCCADCCAaDAAHDFAhBBAADDA.PFCA.fFGAhCAAQDEDJHCAVFGBYFHB.hADA......hBAA...,1,6,-43,49
SYHXAIBJeUREgcadMQTbLDOZFCPfGWVKN,BAAAeAAAEADAaACA.dAGA..MAFAQBEALBCAZCCFFBGAfCHAhAAAGCEBKDBASEEBhABAHEEAAEHAUGGARGEAgEGGhAIA........hBIA......hCAA...,2,-19,-6,13
cVFZMBXWUPeNSgEYJOafTLdQRbAGDHIKC,HAAACAAAFACA.ZADBBAFAXAFA..UCBAeBHH..SAGHhAAAECABOCCH.aDFBTDFAhAFAdEGDRFCAAGAAGDDAhAIAKGGAMIAA..PFCB...gFGAhBCA...hAAA...,1,-4,-29,25
GDSgLfMPJIAcZROHBQCaXVbEWNFKeTYUd,RAAAHAAAQADCaACA..XAEDEAFEFBHDKCCDeAGB.UDCAGCFAhAAASAHBLDEDhABAMDGBIFCAACCAZEEFCDHAhAAA..WEHHYHFGdHABfHFBhAHA......hAIA...,2,-8,2,10
BPAQNKSTeagVFfDcLOUZYEGJCWHMXRbId,QAAASAAAeACHaACE..FAFADAEALBFAZAEEEBHFGCEAhAAACCDAHDAARDFAdDDCBEEDACGBTEGAhABAVFGB..OFDBhAAAUGGB...........hAIA......hCAA...,1,-4,-11,7
PYTFOWAbKIGEgcdfNXHSCZVMJDBQRLUea,KAAAEAAAdADA..XACBHAFAZCBA.MCFBBAEARCGB.eAFH.aAHBhAAATFAA.OEFDhAAAABIBGCDA.fDGAhCAACFHADIAA.LFFA.PHFAhCBA.FGDHIHHAhAFANCCA...,1,-8,-20,12
JEbHfVOGeDdPBIMTRcXZAaYSWNLCgFKUQ,aAAASAAALADAFADAKAHB..QAGAEBBBHCEA.OBCChAAAeDCFdEAABCFAMDIBRDDBZDGBhABAAEEB.NEIA.CEGAUGEA.hAGAJHAAfGEADGHB......hBIA......hCAA...,1,-2,-19,17
UPGYFbAVDOcNTHKMJdeIXfQWZaLgSREBC,OAAATAAA.HADAMACAeAFE..XAEAQCCCZAGBaBDChAAALCFA.REEAEFHFhAIACCCDGDEAbGCCABBBDGGBKDHBdEDChBIA.fGGA.....hBAA......hCAA...,1,-3,-6,3
aOUYQREdHCeAZFbNGMTcSPLXWfDKIVgBJ,ZAAAFAAAGACAMACA..SAEALAEAXBGADAHB.KCEAhAFAgCCABDGAaEEBUFFAhAGARCFBHEEB.AAIBbFCBhABANEIA.....PEHD....hCAA......hCBA...,1,-16,-20,4
DMZeRGNCAQgYVadXWKTcfBPFIOJbHELSU,QAAAVAAA.dADAKADC..TAFABAFAFAHBOAHDHCDAECEFhAAALDHBDDBAZDFBRFAAGFCBhAAAAEFB.aDCHWEGHhAFAfHEF.IHHASHAA.hCAAMEIB....hAHA...,2,-12,-12,0
JDcaTWOZEXRLUegdBCIPbKSVFGMQfAHNY,HAAAJAAA.aACAOADAEAFA.LAHBUCCAeAHFdBEDBCCA..hBAACCFAIEFAKDEAFEDHGGDBhBHAMCIBAEHB.DFAA.hCAATFCA.XGGAPFFASHCGhCBA....hCCA...,1,-7,-26,19
VWCARfQgaTKMZIYXUeHEGJLPFDBcbOSNd,RAAAQAAA.aACEMADA.ZAEEXAEDHCCAEBHFGBGAhAAALCFBDAGABCDDODHDhAAAdDAACEECAGGATDEAKHEA.hABAIGBA.eEHH.FGFB...hAIA......hCAA...,2,-20,0,20
OWJUXbQAZPNfTcVKdDEGHgLYMFICeRSaB,ZAAA..fAAATAEAKAGCEADAHCAALAGBMBIB.CBCDRBEFaCECOCAChAAAUEAB..QEEAhABAAAIBPDHDVECAhACAGDGAFFGHeHCABGBA.XGED..hADA......hBGA...,1,8,-4,12
dagYAbRIPJQTUMCEDHfOKNZXVFceSLWBG,RAAAJAAAQADC.UAFAEADEHAFB.KAHBZCCAFCCAeBHHLDFAhAFAGDFAdFFAaEEHAEEB.hAHA..IHBAhAAAMFIBfHDBOEHD.......hABA......hAIA...,1,-11,-22,11
HfNXAaZOTKRCMgJLceDdWPVEBUbFYGQIS,ZAAATAAARAEA..MACALACB.eAEAdAHAVCDBEAHFBCEAFCGH.hABAGCFA.QEAAhAAAHFFANCCA.AAEAaDHDhCAACEHA.JEEFDIDA..WECH.....hCAA......hCBA...,2,-22,1,23
SLPBedTEcGXMFHCAgaJUWVRKZNbYIfDOQ,aAAAUAAA.RADAZAGB..bACD....IDAAOAEALBEAhAIABCDD.eBHHEDEFGEGAhADAMBBBHDEBABIBJFCBhAEAKEHB.fFBADDIBQGECdGDATGGAhBAAFGAB.....hAGA...,1,7,-19,26
dJVDbcRLPYWNFagGMTXAQHZEKfCBSeOUI,HAAAEAAAKACABADB.eAEHOAEAdAGADAIBRBDALBHB..PCABhAAA..YCCFhAAAFCCBGDEA.MDHBhACAACHBZEEASGBAIGDA.....hAIA......hCAA...,1,-13,-31,18
fLHcITQbYaPCBRDEgAKVWGOFNSJeZUXMd,KAAAGAAAFACA.SADAZAEB.MAGBdAHAHCCB..TCDAhAAAbBFD.aAHBBDHBECHFAADAhACAOFFAeDCBfEFAhBAALHBAQGGBCEHADFCBgGGAhBCA.NIBB.....hBIA...,2,-16,-5,11
PGbNETgADUBCSHdceILFRXZKJOWVaYMfQ,BAAAHAAAeACELACARAFFZCCAOAFD..aAHDMAHBQDGAhAAAGCCAEDAAAECACEEDdFAAFDHDKEFBhAAAVGFA..fFEEhADA.NIABDGHBSHAA..hAFA......hAHA...,2,-15,-4,11
NDEBCPgcHLXSfIVRZdYbUTaOeMJAWFGKQ,GAAAQAAAEADACAFA....gADAHAGBLCDBSAFHhAAAfCFERBGFdDAAbDDBhADAaDAHeDHFAAHAKEHBBFFAhAEAXFEAZGEE.YFHB....hAAA......hACA...,2,-10,2,12
deYHZOfcSUIQEBJGMaFNXVKCDTRbAPWLg,LAAAeAAAHADAZADBOAFASAFAUCDBEBHFGCAA.aAHDXDFDhAAAKCFA.TGCAhABAACAB..gDGAhABAdGGAfHEFQFCAMCCB.FFFH.CCCCDFIBhACA.....hCAA...,1,1,-7,8
GSKABVdcHgONeWMYJQRXbFfLEICZUTaDP,dAAAHAAAOADAeACEMAFA..QAGARBEAFCCBECHF.ZBDAaDECGCABhACA.ADFBBDGAhBAAgEGANDIA.YFFFhAAAbEBALFFB.CHHDDIBAKGDB....hBCA......hBEA...,2,-8,-1,7
GTAabNJLYWIRMUBPFZgEcCHKSdOVQXefD,aAAAJAAALADB..IADARAFABCCCZCFAEAFAHBFC.dCCAhAFAQEEAeDFBGEDAhAIAAAFA.NBBA.MEHBFDHDCGHAhBAAOHCA.........hBIA......hCAA...,1,-6,-33,27
EIRGeWDNSBbMaTKCXJLOVcUPFYZdfQgHA,RAAAeAAADADABAFAMAEAKAHB..CAHA.LBDA.OCCBUCCAFCFAhAAAdDEAQCGDhAAAHEDCEDHF.GEGA.hABASEBDaEBHJFHB....PHAAhAHAfGFEAGEB...hBEA...,2,-29,-6,23
aVRXHYbEIeMTUgFNWOCSfcJdGBQAZKDPL,ZAAADAAALADARAEAHCAAEBHFeAGH..MACATBBAFCEH..OCGHhABASBHH.fCEAhAEAdFFDBGHAAAHAaDDHhAFA.XEGA.bFED.IGGAhAIANIDB.WECD...hCAA...,2,-20,-6,14
fYVPcbMLeJZEOFWUIaKTHSDANdCgBQXRG,dAAABAAARADAGAGA..fACA.VAEAbABDeCEFhADAEBHF.FDFDUDCAKEAAHFGBhAEAAAHACCAA.QGAAhAGA..XDGA.cEABMDIB.hAIAZEEF.OHFE.hBAAaGDB.DGGA,1,1,-15,16
YdRFbPDBTWXEGVcfULgIMSHZQaJeAOKCN,CAAAdAAARACA.FADA.DAGABAFB....TBFAEAHBGCAA..hAAAVCBAUCFALBHBhACAMDDBHFDBaDFHAEEBKFFA.hBAA..NDIA.bFGD.XGEBfHFFIHDAhBCA....hBDA...,1,-19,-26,7
FNSOMVEPIULZRCTDcAGHJfWXaKbgBQdeY,HAAAJAAA.XADBKADCBAFAeAFA.FBHDOAGDECAB..ICCAhAAAZCCARDFF..DAIBACFAGDEAhACA.aDGCbECBhBAAdEDC.SGAA.MFIBPEHDhCAACGGA......hCBA...,1,15,-44,59
GZKcOdIQARWBVfJLabUCDYPMFESTeNHgX,RAAABAAA.JACAaADA.CAGA.DAFA..MAIBFAHD...EBDFeBCBHCEAhAAAGBFAZEEAOCCHhABAdCECADIB.VGAALFFAhAAAUGEASEHB..NHEB....hAGA......hCAA...,1,-2,-35,33
KUgcdABNZfRVMeaIGQXEbFJDTSWCHOPYL,ZAAARAAAeADEGAEA.EAGAFAGA.DBEB..TCAACCCAHCEB.OCGFhAAALCHB.KDDBUFGBhABAdEADAACABGCAfDGAhABAMICA.aFFC.QGAA.bGDChAEA......hAGA...,1,-3,-25,22
THVgQJbZXfWPaDFGOREULNMSYCBKIcdAe,HAAAQAAAZADBXAFA..fACFaBHDGCEAEAEALCCDhAAAMAHBCBFAKCDAdDAAAACAhAGAeCHHTEGA.gGCAhAIAbDCCDDGBOFFBUGGB.SGHBhAAA.....hCAA...,1,10,-9,19
SgPLDYObHAdUMTCXZRBIWfQNcVGJeKaEF,dAAAMAAACADAZABBRACA..BAFB....fAFAQBGA.hAFAVCDAeAGHKBBDECEBSEFAhAHALDHBODCDhAIAHGEAAEIB.TEFA.IHEANIAB.hAIA......hBAA...,1,-17,-23,6
gVPNZAEfXFTSWUQaCOLBRHeKJMcDIdbYG,EAAAFAAA..SACHQACA.aAEELAEAHAGBeCCBMAIBDCFBhAAAdCEAGEDAVDGBZFAAhAFAAAIBTFAACDDCBFFDRFFFKDHBhAFA.IHHA..YHCG.hCAA......hCBA...,1,10,-18,28
FZUcSKAeQBYMWRICHTVOJdgGPabNXEDfL,eAAAQAAAMAEARBCAHACA.OAEAdBFAGCGAaAHD..bCDAEDBBhAAALDHBZEDASBHBhABAACEABEEA.IHHAhAIATGFAJHBA.........hBDA......hCAA...,2,-11,-1,10
MIRfJZQHVPULODKBbSYAeNXFGdaECTcWg,eAAAFAAAdADAEADA..CAFA...TAFA..gAGHhAFARCCAZCGBHEEBUDBALFCBhAAAKCHBBDEASEHHhABA.AAHA.GEFA.aFCE.MFIBIHHAhBIA.....hBAA...,1,2,-35,37
ENUVJLRabXQOeYdBCAcMgGfIFWSZKHDPT,MAAAGAAAFADDZADAHAFADAEA..EAHBUCFBLCDBRBBB..aDEHQCFBhAAA.eDHFhACAdEGDAAHA.fFAAhAFASFEATGGANIAB......hBAA......hBBA...,2,-20,-11,9
YTJaXSHBVAKRMUEObDQIFGgcWZeNfCdPL,RAAAEAAADADAFACDGAEB......gAEAZCCAeCGFCDHAdAHAhAAALECBTCFAaDDBhAEAHFFCADIB.MEEB.OHAChAAAbEEAQFAA.IHHAhAFA.WHBA...hABA...,2,-15,-7,8
SdeAPYHIUOJXbfNLFcMGWQERTZVCgBaDK,HAAAOAAAXADB..bADALAGBMAHBGCCAEBFFRCAAZDEAhAAACBBDBCFDaEHDKFBA.eFFBhACAAAEAIEFA.hAIAfDHANIBB.FFHD.....hBFA......hBIA...,1,3,-23,26
DITFWdHVEPYScJebCfKZAULROaGNMBQgX,RAAAGAAAMADA.QADADAHB.FAFEHBDAEBHF.SBHHhAAAeCDBCCFAZDFEABFALDDAhABA.aEFEBFGA.XGFChAAATFDAdGGAYDAF....hACA......hADA...,1,-14,-15,1
YabTdAcBHNUMXVKREGZSQCJLOPgIFeDfW,HAAAMAAAKADAEADEZAFB.QCABLAFBOAHB..gCGHhAAAeBBBDCIBfDDAhAIAaCEBdFAAAAIBBDCAhACAXEFARFEACEHAIHHAFFCHbGEC.....hBAA......hBCA...,1,7,-25,32
cWaYeAVgTGCDNKfBdXLQSUJHERbZIOFMP,TAAAGAAADADA.KAFAdACALAHBQAEAUCDAHAGD.RCDBZDFFhAAAFDGHMEIBPDHD.hAAAaEAAACGACEBABHHA.SFFDhAEAEFDA..IGGA..hACA......hBAA...,1,7,-31,38
PfYGXUBaHZEeNDRbIWFgATCcOdMJLQSKV,TAAAOAAAdAEA.LAGBQACCKBBD.VAFA..fCDEhAIAGCDABCFDHDBBhBAAECHFeCHHREAAbFFAFEFBAAEAMIAAhAAASFDH.XGGAaHFADFFA..hBDA......hBEA...,1,12,-16,28
aUGSQLBDMKgXbCePNcZdWRFEYfAVTIHJO,TAAAHAAAaACA.GAEALACBDAGAMBHBXAEA..eCCBhAAAPAHBZEEARGBA.EGEEAAEAICEAhAAA.ODEEhAIA.QFFABHHA.KFHB..hCAA......hCCA...,2,-19,-6,13
WJfIEGXObceaKDTLYQFCSRPMZAUBNVdHg,BAAAdAAAHADAJACA.EAGEGAFA..bABDeAHB..aCEDTCBAhAAALCGB.QFAAhADASDEBRGDAMCIBhAFAADHBVECBfEDE.XGGBhAIAKEHBFFABZGFA.NIAB...hAFA...,2,-15,17,32
cPgUEaDLZSNQAeKGdBYHCTMRWbIOXfVFJ,eAAAdAAAHADAMAEARAGF....ICCAXAGAFCEDJBCB...hACAPBEBEDABaCHDZCFBQEFDhADAAAAAGEGACDHBbFAAhAFAOFBA..fGGE..hAGA......hAIA...,2,-11,-9,2
dZgcHCSFbaWRPQTEDILUYfeJAVGXKNMBO,GAAAKAAAMACAdADAZADEHAFA.FCED.aCGDRAGFQCCB.hAAAECFBLFAA.hAAAfEHAACIBXEEChAIAOFFBCEHASGGAPHAADGIBIHEAhCAA......hCBA...,1,-7,-26,19
bCBZXLFVTDUQacWAJEYKfNdHRSOMgPGeI,EAAAKAAAdACAHACARAEA.MAEAGCDA..eAHFCAHB.ZCCALCGBhAAAFDGHTECAQEAAhAEA.aEHDABGBfFFEhAAA.OEHDgGDA.IHHAhAFABHHDDICA...hCAA...,1,0,-25,25
TLYVXNHeUSQbdWOEKMaFZgIBDCJGPRfAc,TAAALAAA.XADDHACBeAEA.QBGAdAFBEBGBaCAAZDEAhAAABDDACCADGEAA.hABARFCFAAEAcDFAVFFBNEIAbFEBhACA...KGGA.MAIB.....hACA......hAIA...,1,13,-11,24
KBYLCOXFMTePQbZIDNgGfHJWdcSVERaUA,BAAALAAAOACAMAEA..eAFAQBDAZBCADBIBGCFAhAAAHBFAdCAA.SCCDhABARDBAACHBCEHA.TDGA.hAGAbEEDIGHAfGGBWFFDEHBA...hBDA......hCAA...,2,-30,10,40
LZQcTSfFIGUWaYeEXKJbPBCMgDHNVAdRO,RAAAZAAAQADCSACEFAFAGAEA.aAGAEBHF.KCCD.JCFBbBGDhABA.BCCD.MDEBhBGAHEDBACIBLFFAhCAATGFAfDHAIHFA.YFCF..hAAA......hABA...,2,-19,-6,13
KUPeQYBRgIHXMbTJLNadGDFWAcSfCEZVO,SAAAEAAAZACB.KADAeAEABAFBRBFAHDEA.MCBBTBGALDHBhAAAdCCAGDAAFECBAAIBCFADhAFAODFB.QEGAhAAAgGFBbEDD.aGGC.DIAA.fFCAhABA...hBCA...,1,-5,-8,3
LfeXNIQCRPFaGZbBVTDHOcEYgMUAWSdKJ,dAAALAAAeADA.XADDQAGA.RCAAFCEAZAFABCAA.TCFAhABAHDCCEDGA.MEABhACAAAGAKCCDJEHBIEDAhACAaFFB.bEGDDGGBOFED.....hADA......hAEA...,1,-6,-16,10
HUSGRbBYXcagKPdNCMIEVfDQOeLAJFWTZ,FAAAZAAAHAEAGACARCAABAHB..XAEAaCEC.KAHBdCGAMCFBhAEAEEABDACAeCGF.ADIBJEDBhAFATEEA..bFGD.hABA.gGAACHAA.fEHAhAGA.QGGBhCAA...,2,-17,-15,2
gaPEAUQCTXVZRKMcBGJNYIdbfODSFWHLe,QAAATAAA.ZACBRACFMAEAGAEA.JAHB..IBFAhAAAdDGDODEHFAHDHCDBLEBBhAAAeCABaFGAADFAXDGAhACAKGGABAGC.bFFB.SHDA..hDCA......hDHA...,2,-8,-6,2
KVOTPRWfbBegJLCcMHFGEdNIUAQXaSYDZ,aAAADAAAZABE.KAFATADA..RCCA...bAFBeAHH.LCFBhADAMAIBHCCAEDHFdEEChAFAIDAAACCA.QDGDhADASFHHOEEBfHABBBBDCFCA.hAHAFFGD.....hBAA...,1,0,-30,30
WaAFgcOdRQETNZCULKfBIbDMXHGSVeJPY,FAAAOAAARACF..EAEEZADB.LAGBBAGBDAIBHCEB.GDBAhAIAeCDH.PDHD.aBBChBAAACFAdDGAQGFAhBDATFDACFHA.KGGD...IHCAMIBA..hBAA......hCAA...,2,-38,7,45
FVUgDOXIWGTKMCAPfESdZbLJHeacNYRBQ,EAAAZAAALADBHACAeAEEaAFA....NAIARCCAQBFC.hAAAFCAAgCFBhAHAXDFAGFCBMEEBAFFASFGAhCAAbGFA.YHCA.BHFBhCBADAIB.IHHA.hABA...,1,4,-16,20
dIWYLVNPAQgCSMHKTOBRXEZcUJFDabfeG,QAAASAAAHACBOACCRAEAZCEE.UEAADAEAaAGD.eBHHhAAAdEFAIEHALCDBPCFBhAIAAAAAMAIBTGCAhAEAEEHFFGBA...fGHAYFGF...hBGA......hCAA...,2,-13,-5,8
bLCdVMNTAIWZXPJKBSeYHRaDFUQcgfGOE,ZAAAXAAAKADCBAFA..eADAHAGBRAGBaCDAFCAAUDDA..QDAAhAAA.fDDAhABAEDGBbFCCdGGAMCGBhADAAAIB.IEHA.PFEB.SGGAhAEADDIB..hAIA...,2,-26,-17,9
WAIbZHVPEfXRFdOcGUYMSLTKeDNQCaBJg,ZAAAHAAAEADERADFdAFAGAFAMAHBLAHB.eCABQCABhAAABCCDJCEFAAIBIDFAhACA.VEGBXEGAhABAODDBcFACSFFDTGGADCIBaHBE..hACA......hAFA...,2,-8,-1,7
YJWdHGXKRQIOfASeVLaBTMFZgPEUCbcDN,eAAAaAAABADAMAEAZAEB..EAHFUBGA..bBAADBBB..JBEBHCCBhADAGCFAREFA.QEBAhAAAOFEBAAHASGCBhBAALDHBFGBHCGHA.YFFF...hCAA......hCCA...,1,7,-28,35
HdeaQKMPDABUTZcXgYSfLIFGOENJbWCVR,TAAAZAAA..XADBSACBLAGBGAEAEBFF.JCAAbAGBhAAA.CCCD.HEDA.eCHHhABAaCHDMDEBAAIBBFBAgEAAhAEAfFHAODFD.VGBAQGEAhACADFHB...hBEA...,2,-4,-3,1
XUOaIdLZQKPfJGcHWEebVFgTYNSBRDAMC,MAAAXAAAUAEA..aADAdAHA.ZBBBQAGAKDDA.fBDAhAAAGDFAHFDBECEAeDBBhABAFGBB...TDFAhAGASHGARFFAADHAOEEB.IHHAhBDA.....hBAA...,2,-26,8,34
UgSERKADHCFeZGMNbcTQIJWLdOBfYXaPV,HAAAeAAAGADAMACA....bAEATAFAQCCAJBHBdDBAfCEFhAAAaDDH.PCHDhAGAgEGARDFBAAIBFGHBhCAAZFAA.IGEAOFFH.BGHA.YHAAhAAA....hABA...,1,14,-14,28
TYZDNMgVfaGXBeRUPQLbEIcHJFCKdOWSA,ZAAAMAAA..VAEAGACBBAHBRAGFUCDBLCAB..EBBBHCCChABACDGDdFAASCGAhACA.AADATEFADCIBfEEEhAFAeEHH.bGFAIHCA.FFEH.hAGAOHEENIAB...hAIA...,1,2,-21,23
PGVOJbfBScQWaMKNDHTgIACYXFLdZeEUR,XAAAdAAAEADA.RADA.GAFA.OAHFbAGB.BCBA.QDCAhACAaCDCMBIBDCGBHDGBhADATDAAAEEAFFBBeFFBhAHAPEEB...fFCA.SFHBhAAA.KGFAIHHAhBAA,2,-29,-3,26
gPOUTGZbJaMeFSYHLBXfDRKCcQVdEINAW,...PAAATAAAZADBaACA..eAFASAEHHCEBLCCDhAGAfAGARCGBCFGDQGCAhBAAEBHFABDBOCCB.bDEBhAAAMDBBBDHAKGHBdFHA.IGAA.gGEAhAGA..hAIA...,2,-18,4,22
IBMEQbZaVTLgJOPUXRAKYfFGCNecSHdWD,KAAAFAAAGACAeACEHAFBdAEBDAHBBAHA.EBCFZCEB...aBHDTDDAhAAALEGB.OFBBhAIAXDGA.AECBCFAASGDAhBAAMFDBQFFA....hAFA......hAHA...,1,-19,-23,4
ACKWgHFSRMaTDBGcNEOeZVLXIdYQbfUPJ,KAAAHAAARACF.aACABAEBGAEA..EAGAeAGBZBFELCABdCCAQDGBhAAAUDEB.AAHACEDAFDHBMFFBhBIA.TGGADECBOFFBhAAA...XGAC.IGHAhACA....hAGA...,2,-27,3,30
AYCPEHfFaUTeRKQWScJIGgMNdDOZBLVXb,CAAAHAAAFACA.aACA.eAEHRAEF..QAGC..SAGAhAAAICBA.GCCAhAGAMCIBdDDAZCFBLDHBhAHA.bFDDADGAEEGBfGGETFEAKGHB.hCAAWHEG....hAAA...,2,-35,8,43
ZBPcQJYIfbeHdLCNaDUAMFRSETGWgOVKX,RAAAEAAAGADA.OAFAXACA.ZAEBBBFBQAGAJBHB.hAAAICCAeCCBHDABhABAdDAALDGBaDGHADABMEFBhADATEEA.gGCAKFDBcGGAfGHAhAAA...hCAA...,2,-12,-4,8
JQHPaGZLBCWRFATXfeEYdUSVcDbKgNOMI,TAAAeAAAEADA.dAGASACB.DAEAbBCAKAGA..OBHDhAAAMBEBQCFAhAAAHDDAGEGAZEFALFFDhABACCCDRFBAABFBXGGCfGBA.....hAIA......hCAA...,2,-17,6,23
YgTPEAKJOcGDbWHUSQdVBfXLaMNIeZCRF,OAAAGAAADADAHADAQAFAdAGABBBDLCFAMAIB.eCDBhAFARCDAFDCH..TEGAhAIAAAABKDGAJEFFbFED..SGGAhBAAfFHA.aHBA......hACA......hBCA...,1,-3,-23,20
GSIOAWdEMfKUHQCbJPZLFTeNYgXcaVDRB,EAAAMAAAKACAHACC.QAFCCAEB.JBBFZAFBLAHBeAHF.hAAA.gCCAhCAAaDCDREDFSFGAACCAdEEAbEFDFGFHhBAA....YCHB...XFCBhCBA.DGIBBHCAhCAA.IHHA,2,-25,2,27
CJPBeZDGSRMUfdOaQXKVgNHWTFbEIcALY,LAAACAAABACAZADBGADA.RAFAUCAAdAGAQCAAKCGA..hAAAVEFAHDEA.TFBAhACAEFAAAAFA...PEHDhAIAeDDDMIAA.aGHDXGDA..hBFA......hBGA...,1,-7,-26,19
gLOKfXTYWCaBJeNHdZEFIPSADcGRMUbQV,GAAARAAAMADA.QADALAHB.KAFA.TCFACBDABBFA.eCCBhAAAHDCAZEDBEDHF.FFFBSDGDhABAAAABDAIB.bFBDhBFAODAH.fGHAXFFCaGHDdHAB.hACA......hADA...,1,-3,-11,8
NYCDOUbaRKXSFfIgTcZPGLVMEdABQWeHJ,QAAAHAAAJADA.CACA.OAGDUAEARAGBKCAD..FCDH..fCCAhAAA.TDEAhACAZDFAGEBA.MFFBhAAAAAIBeCHHDGGAaGDDSECHIHHAgFGAhAGA.cGDBhCCA..,2,-24,-16,8
MXGJZNdYSPcLgUeCfKQEaIWHTAVBDRFOb,DAAARAAAOADAMADAGAGAZAGB..dBEDSBBALCCBeCHHhAAAKBEB..EDDBaEDDHDFBhAIAAFFAFFHDXEBC.hABANDIA...cGEBCGBAfHGB..hBAA......hBBA...,2,-20,-16,4
aRXbDUWOAeZJKCPMFNcHfTSQEGIBLdYgV,eAAAZAAACADB.MAEAFAFA.HBCA..SAHHEAHFGBFALCABhABAdEBAVEDBRCCADCGBUGGAADHA.hACAKDHB....PEEBhBFA...fFCA.TGFAhCCABHFC....hCFA...,1,0,-31,31
BGWFQZVYgeDcMRUSKIbJLOAEdNXTCfHaP,EAAAdAAA..TADAHACAaAEAGAFAFAHBZCCA..VCBAeCEEMAIBhACAREEAKDHB..JDAFAGGACGHABDHDhADA.QEEChAFADICA.SFDD.LFHBhAHA.OHBC.fGGAhBAA,2,-27,12,39
PXGWIeQLfagJVYDUCOMNZBFTbdAKREcSH,EAAAHAAAGACAeACELAFB.aAHBgAEB.VCGBhAAADBIBOCCAZEBATFFAhAGAADDBRDFASEEDhAAA.XGGAIAHA.fCBEhBCA.YFHBhBEACFHC.MICA.,1,2,-8,10
JMVWOEdeZaBUGAKYCPcgRFXSDTfQNbLHI,CAAA..PAAARACAFAFA.DAEA..QCAALAHBHBCA.MBEAhBAAOAHDECFAeDEBhCAAaCDDGCFAAEGAKEHBgGFAhCBATFCA..bFGD.JHDE....hAAA......hACA...,2,-20,-5,15
fOaIRDSTbdYCgJEGBAHNMKPWUcXLFVeQZ,HAAAMAAAKADAUADALAFBeAFAZCAA.OBHDRBBBDAHB...TDFAhAAAdDHACDED...EEDFAAIB.hBAA...PECDhBBAXFFAQEFAaGAASGHH.YHCGhACA...hCAA...,1,1,-33,34
LAVHECOeTcUFgJZMDfGQNPdYIBWaSbKXR,HAAAEAAA.eACEUADAFAFAZAFBMAIBGCBAQCCAdBHABDDBaCEEKEFAhAAALEFA.ACHBOFCBhAAATGGAJFEFfGEAhCAA..YFBFSGGA.hAIA......hBCA...,1,5,-23,28
GQPOEKbLICdTVZfcaUHBWgReMYAXSFNDJ,FAAADAAAGABBQADAEAFE.LAGB.dCCAZBFE.aCCCHDABhADABDFAREDAeCHHAAHA.SFGAhAIAPDHBbEAATGBAhBAA.fGEAcEEC..WGFAhAEA.MIDA...hBFA...,1,-2,-18,16
DRCcSOPTQYagXLeNWUfMIAGBVdFbJEZKH,GAAAdAAAFADA.EADAHAFBRAFA.CAHA.OCDB.QCECaBDHLDFAhACAeCGHUECAMCIBACCBBFFAhAHAbFFC.KFHBSDADhAAA.TGAAYHDA...hACA......hADA...,1,0,-24,24
PMSBZJbfeEYWCFgNIUDATXGVLacOdKHQR,GAAAaAAA.dADAHACBRAFA.MAEAZCEEJDHBeAHF.EBEE..CEFAFFAAhAAAIDEA.ABBBTEFAhBAALGAA.KFEDQGBAhBGABGGD.fFHA.YHEAhCAANIABDDDB...hACA...,2,-24,1,25
bYHGEVSXAOeJDKQLdFgaNMIZfWBTURcCP,eAAAKAAAdACAFADD..aAEAMAFA.ZBEBBAHARBGB.CBEA.....hAAAbDFDHCEC.EDDBXCCChAAAACHADDIBLEBBhAHAIHFA..TFEA...PHFChBEA.....hABA...,2,-31,-24,7
bcFDHJMBXYfNSWEPCVIUQeKdLaTgGZROA,FAAAHAAAMADAXADB....fAGASAFAEBCACBHAICCAhAAAUCFB.eCABhACAdDDAaDHDGCEARFBBAAIBDEGBhBAABCGD.YDHBWFFD.QGAAhAGAKGHB.TGFA.hBFAOEDB.,2,-16,14,30
TWVebfOPdFBACGaENYKSZQJXUgIRDMHcL,aAAAEAAAKACAZACB...QAECUAFARDEAHEBALAGB.TCCAhAAAeDHHOBBB.hAIAdGFAABIBGEEASHBAhAIAXDGAIHHAMFDB.....hBAA......hBEA...,2,-13,-11,2
feFGLJREVaHSZWCTKIPcYOBAdQMUXgDbN,dAAAMAAAUADADAEA.......bABDeAFAGAGARBBAEBHFHDEBhAGAZCEBCDDAKEHB..IEBAhBAAPFBB..OEDHhAIAABBAQDGB.XFGAfGGAhBAAFGFH......hBDA...,2,-17,-16,1
TONWIfKeDBXUFdSVbQGEcCLgYAJaZPHMR,ZAAAHAAARAEA.TAEAOAHD....IAHAeCABBCCDFCAHdCCAhAAASCEAQCFAhACAEDGFLECAACIBaECEMEIBhADAfEHAXFEAbGAACFADJHAA..WFHDhAEADGGB......hAGA...,2,-14,-2,12
GTCBQSZMUAgfJOeLcKdIWEYPDHaRXbVNF,JAAAeAAALADBdAEAEAGA...DAFAHBCBRBFA.XBGA.VDFAhAAAGDEABEBAZDGBAEEBOFDBhABAKDCDIGBAhAIAPFFBaGEH..FGAACGHA.SHGA.hBAA......hBFA...,2,-29,7,36
OeKaRLgNSXVGZCQWHEFPfcAUJMbDYIdBT,MAAADAAAdADABADA..eAFARAEFLAGB..SBBBhAFAGBBAZDEAQCEAhAGAHFFAEGCA.fBHAhBAAAAIB.bDBCIHHATEGAaFFHNICB.CGDA..hBAA......hBBA...,2,-14,-14,0
bYPaKCHROXBAJSVTGDLUWcMfZegINQdEF,SAAAGAAALADAUADA.MAHBZAFBeAHF..gCDAhAAAQDBAEDFFbDECaCHDhACAHFFAREAABFGA.AAEATGCAhAIADCIBfFBEIHHAdHFDFGFH..hBAA......hBCA...,2,0,1,1
USGNXaVgECRTYdJWKQHbcOFfBMeADLPIZ,LAAAZAAAGAEAaADDEAGA..RAFA.dCAAKCAAHCGB.OCCBBCEAAAFAhABADBIBUDGA.SDDDhACAXEDCCADBJFEBbGAChABA..FGGAeFGB..IHCAgGDHhACA.....hAIA...,2,-32,12,44
LgGaNTOSFZKJXdRPAQUWMHEIceYVDCbfB,QAAAMAAAHACCEAFEeACA.DAGACAHBBBBDGBDB..aCDCTDAAhAAAFCFAZDFEKCHB.dDDAAEEBUFGAhBAAIEGA.VFEBhADA...fGBANICB.SGDDhBGA...hCAA...,1,3,-23,26
CGTDVBPfebNLKOSMgQIAZYXWJHFcEaUdR,ZAAAXAAAHAEAEBHFdADAGAFADACA.BAHAeCCBLDBAOCEBMCGBhABAQEFB.hAGAAAAAJFAAaDHDRFEB.CGGBPHAAhAHAbFDDKCHB..SFHH.IHAAhAFA....hAHA...,1,-1,-14,13
XYKDaNVHBUOSZQJGPIeFMdTRbCfLAEcWg,EAAA..gAAAKACADAEA...aADAHAFCOAFDZCCAGDFAhAAAeAHBdBDARECBCCHAAAAAXCGDhAIA..YEHBhAIABCCCQEEC.IFHAhDAAFHEC.MFDB.fGGEhDBA,2,-27,-7,20
IWgedNTOMYcPXUKRaLZGQbFAfHSCJBDEV,HAAACAAADACA.EADE...IAGAeADAdAHAOAHDMBCB...PCABhAAAKBFBRDCFZEFAGCCAhACAFGEA.ACCBSCFBhAFABDHA.gEFA.YEHBhCEA.XFDDaHBA.hAAA...,1,14,-39,53
JIAYTFCgPVbcHeMWQDUdKOLSfEGZaBXNR,TAAACAAA..VACAHACB.eAEAMAFAQBGAdBGALCABhAAAECABaCEDBCCDRDFFAAEAFCED.hAAA.bFGDDBIB.OEFChACAfEDEZGCAXGGANIAB....hCGA......hDAA...,1,16,-23,39
AXWCBPfgFYRbOdGEcZIKaTSDUNVeHJLQM,CAAABAAA....fACAFACARAEFdAGAEBCBZADBKAFA..aBHDTCAAhAAA..DDEBVCFAhACAHDFALEEBhAHAAFFBXGGAgEGA.bFCB....hAIA......hBIA...,1,-17,-37,20
SIGcTMQWLbPZKOJFHEXaCRegBdUVAYDfN,DAAASAAAGABBMAEALADA.ZAGBOAHDHCCAEDHF.aEAAhAAARBFBeCCBdEEA.ACEB.fFAAhABAIEEATEGAhBAAbEFDKFCB.FGGH.CHBA.......hBHA......hCAA...,2,-22,5,27
YKELbNXJGCRWZHMOBcTaSFPDdQAVIfUge,VAAAUAAAeADA.KAGAEADE.LAFB..bCBAXCDBhAAAGCFAREAAHCGBBCHAaAHFhBHAFEHDdFEAAADA.fGGAhCAA.NDDA.CFDAMFFB.....hDAA......hDBA...,1,-5,-20,15
ORgVfbZIGaLPHSTeYUXNJQMAEdBcCWKDF,EAAAdAAACADADADA..RAEF...VAFAZABBGAGALBCBHDCA.eDGDhAGAXCFC.QEDDhAAAAAIBBFFDKGHBOCHDhAIA.bGEA.aEBH......hBEA......hCAA...,1,-17,-25,8
BgcCRIPDUWJbSeVTdaFYAKELZfQMGXONH,EAAAZAAAMACAGACA.OAEAHAECBAHB.CCCDRCEBDAIB.UBFBJCHB.hABAeCBB.dDGDaECAAEBBLEEBhAAA.QGGAhBCAXFGAgGDA..hCAA......hCBA...,1,-7,-29,22
BAGFYNHKSJOUeDXQfIbaEWLcZRgCPdMTV,GAAAFAAAHACBSADAOAEA.eAFHQBEC.IBHAhAIAEAHBLCDB.hBAARCGBCEADdDGAMEGBTFEAhCAAAAABKFEBDDIBfHGFaEEG.....hCBA......hDAA...,1,-6,-17,11
fgWKLFNDEPXAJHTOBGUCacVSRMIQbZYde,HAAATAAAGADA.aAFASACBRBFF.MAEAbCACdDHAeAHFhAAA..fEFEhAAAKBEALDDADAIBEFBAACCBBDHAhBEACGHAIHEAZFDAgGBB.FFHB.hACA......hADA...,1,-2,-7,5
AUCdcTSaFLbMNKfOEgXHZRDWVIGBJQYPe,dAAATAAAaADA..LAGBMACA..KAFAEBDBHBDARCAA.DAIBVDEBhACAGCGA.QDBAhAAAeCHHAAIBCBFA.FDED.bGDAhAHAOEBD.XGGAIHHA...hBAA......hBCA...,2,-16,1,17
MFAGZKRQWEcYgbLTPOVDHBaeUNdIXfCJS,ZAAARAAAEADE....gADBTAGAOCCAHAGBeCAB.dDDAhABAfCFASCCDhACAAAAAGDGAQDGBhAFAcDDCbFDAPFHDBFAAaGAEIGAACGEAMIAA.hAFA......hAGA...,1,14,-16,30
IbLECZADQYcdPaHFUfVRGBXWeKTJSMOgN,QAAAdAAAHADAFAGAUADARCAAGCEABAFAeAGHKCGA...TDBAhAAAMEDBOEGD.hAIA.gDDBhBCAIFAA.ECHFAEIBDGCBPEGBaGHD.XFDC.hACASFHH.hADANIBB...,1,-1,-15,14
RMWcFKJQIDaAETGLfOHVNbdgUYCSBXZPe,EAAAGAAALADAHADAVBGBdAHAUCBA..SAGEZCFARDDFMEABhAAAFCDH.QEFChAAADEHBAFFA.TFAAOFHDhAEAbFCBCGCABGEAeEHH.......WFAHhAFA.....hACA...,2,-13,3,16
gTPaGDdYUASLeJQfMIVZONHKbRWXcEFBC,eAAAQAAAMAEAZAFEHACA.RAFF..XCDDEBCACCDA..TCFAhAAAGCGA.dEAAACHALEEAhABAfFDAOEHDhCAAbFFDFHAABGGDaFHDDAIB......hAAA......hAEA...,2,-18,5,23
DKOJfBWcAFCLGVEMXaUgbHYNZIRdTQSPe,LAAAEAAA.aADDbACAHAFA.ZCAARAGBdCCAQCEDeCFFODABhAAABCHAAAHAGEDA.hABAMDIBXEFA.hADAgFAAIGGATGAADEIBfFEEhACAWHFA.CGGDYHCAhAFA..,1,4,-11,15
MdIHPYSEVDZeUKGAbXaBOgJWfCFRLcNTQ,aAAAOAAA..JADACADARAEFLAGB..TBGAdBBDHCDBSAGEhBAAEDHFZFCAeFFGhAIAGCCAABIBBHHA..hBAAfBBE.FDHD.QFEAhCAA.IHHAhDAA...,1,-15,-27,12
QTUSgNecZBDIXEOaMAVFKbRGfCPJWHLYd,KAAARAAAGADACACB...JAFAHADBLCGBdAFBTCFAUDAA...hAAASAHHeDDDZFFADCIBhABAECCBMDIBADGB.bEEAhAAA.....fGBA..hBGA......hCAA...,2,-26,-21,5
NUWgDZXKIHQACfSBecdYVbMTEOJRLPaGF,SAAAeAAAdAEA..VAGBMADA.EAGARBCBLDFAGBCAFBECUFFAhAAADBIBZDGFKEBAHGAAhABAAAAABEEA...bFDAOEEHhAGA.aHGEWHCA...IHHAhCAA.....hAIA...,2,-13,-4,9
TUGCDVXKHIMRFQOPYEbJgaZLAefNWcBSd,eAAA..fAAA..cACDdADAGAFADAFAKAHBHCAAhAAARBEA.QEDAhACAODDBEDHBbDGD.aAHFAAAABEFAhBFATFAACFEDXGGAMIDA....hCAA......hCBA...,2,-33,8,41
LYZNePWQMIVcdgUSDAROEFJTCBfaKXGHb,EAAATAAABACA.KAEAHACB.LAEAZAGBeCCAQCEAhAAA.MAIBIEAAhAAAdDGASCADRDEBFDHDfGAAhAEAGFABbFFAPGCCWHCA..gGGAhAGAAAFACEED...hACA...,2,-17,3,20
FReJEXSUGABKLaPcTIdOHMVbZfCQDYgWN,LAAAaAAA.TAEAdADAHAFA.bCCAZAGB.QCAAhABADBBB..gCGAhAFAFCDBREEAEEABSCHHhACAAAHAKEEDIFGAMFDBCGHAYHCAeFHFXGAAhAEA......hAGA...,1,0,-14,14
gGVcEWKCQOJbSXRHeTaIdUNLZMDBFAPYf,...fAAAGAAAEADACADA.QAFA.OAHFbAEDRAGBHCAAhAAAeCDBaCEFdECALEEAhACAZDFBMDABFEHBAAIBgFGAhADA.cGAAKGHB.XGEDhAGA.....hAAA...,2,-8,9,17
UALMgKTcYDQNPIaXZFWJROCfGEeBVSHbd,MAAATAAADAEA..QACC..IAHAZAEBFAGDRDEAfBBAhBAAEEAAeDDDSBHHhAAAHBEAdDCAACIBLDGBhBBAKEHBNIAB.aEBBXGFAOEDDBFFChBDA......hBEA...,2,-25,4,29
NMSWLXQRBCDfgPTZeKaHFOYdVcbGJEIUA,MAAALAAARACA.DAEA....fAFBTAGAeBCAHCCCOCABhABAdAHAbCFDGCDBhACAEDHBABBB.SCHHhAIAQFCACEEDZFGBaGGA.FGCA.cGED...hBAA......hCAA...,2,-7,0,7
aOPcZLeGUBYIbVXKfQCHFENJgWTRDdMAS,aAAAOAAAZACB.GADABAEA.....bAFAKAGA.QCEAhAGAHCFAEBBBJDBFTCGAREFAdGAAhAFAABBB.SDDDhAGALECBeEEBIGHAfEHAFHCA.gGGAhAIA.MICAhBAA...,2,-25,13,38
cIWLXYfMSaKHQEFGTUgZJNeRBAdCPDVbO,dAAADAAAOABE..IADALAEBXAEDMAGB.aAGAHCCBhAHA.EAHFGBGAhACATDGAZCBBeEFBADDACDEAbEFDhBAA..YFHBKGBA......hBAA......hCAA...,1,-16,-19,3
fHSMPWYQLUOdVBEIZFaAJKRXebgTcCNDG,RAAAeAAA..TAEACADAGAEAHAGB.MCCB..PAHBQDDAhAAALCCBdDAAEDGBhABAZEEAAAAAXFEAbGAANEIA.hAGASEHHUGEA.BGAA.IHHAhADA.....hAIA...,1,9,-11,20
AbdZgDHUeMfPIXGRQLBKSOTaYVWNJFCEc,ZAAAHAAAeACEMACA...IAGARAFFLAHBSAHHaCCCVDEBhABAJBDB.FBFH.EDGAAECAdEHAhAFADCCB..UFEAXGGChCAAQGGCOHCA......hCBA......hCEA...,2,-10,-8,2
ZcISKgYfEeFCVOGDQAXBRbNJdPaHTULMW,RAAAJAAAdADAHADBLAFAZAFA...SCCDKCCD..fCFAhADAECFAeCHFCDDBGCGAhAGAAAAABEFA..bFFDaEHDhAGAMEEB..IFCAFHAADFFB.XFEChAHA.....hAHA...,1,-15,-18,3
SEfQLVXHAUFbcaBdPTDZKIROMNGCYgJWe,FAAAaAAABADAdADADAFAZAEB..RBEF...MAHBGBGA..CBBDJDAAhADAeCCB.EDBBLEEAhAIAHEFBAAIB.UGBA..hBAAbGBATGDA.KGGAOFHD...hBGA......hBIA...,1,-12,-27,15
YAKJOBQbdTgIGXfaeZSFLUMNPEHVcCWRD,OAAAQAAAdAEA...TACAGAGAaAEAeBBAZAGB.LDDAhAGAMBFBECDFHFDA.CFHADFFAhAIAABIBBDHAIGBAhBAASEEANIBB.cFGB.RGCA....hBBA......hBGA...,2,-10,-8,2
XgMFRcedJBTUHAPCQSGYVZLabWNIOfEDK,QAAAGAAAZADAaAFA..bACA..ICDAEAGAKBHBMCDBhAAARCEFdCHABEADHCECAADASEFHhAAALEEAOECHhAGADFHBFHDA.eEHH........hCAA......hCEA...,1,-2,-20,18
cVHRXgdfKMYACFDGBPSQWJOZbNTUaEeLI,DAAAGAAABACAQADA.OAFCbADD.TCFAEAFAeAHFhAFALCHB.IDCAhAAAHCFBRFCAdCCCMDABABBBFEHDhBAASEDA.ZGFAaGGC....hCAA......hCFA...,2,-19,4,23
IVKafeYAWQGLbFODNMSHBZUcTCdEJgRXP,GAAALAAAOADAMAEAHBCCZAGBUCDATBGAdEGA...ECABREBB.hAAA.XFDBIDFAhABAaFHDeDDB.AAIBbFBBhACADBIBBGFDCDHA..gFFA..hBFA......hBGA...,2,-15,-5,10
HYSQWIfBKGPRbaTEXCUFDeZNLJOdAMVcg,MAAAVAAA.HACC.QAFC..fADBGCCARCFAaAHFhBAAEAFECAHBDBBBeCDAZEFALHEAhCAAdCHAACDA..hCCAgDEA.SFGABGGC.hDAAbGFC.....hDCA...,1,3,-20,23
MPFVabOBdGEAXITcLWCRfUJHZgDKSNQeY,TAAALAAA.RADFUAFAHACBZAEA.KCADQCAAeBHH.MAIBhABAFCEDbCFDdDDDADGAXFAAhAAA..IEGAhACACFHAfGGEDEIBSFFDYHAA.aGGDhBHA......hCAA...,1,5,-25,30
PbWgGadcMSKVCNXLRFOYJIZBHQfAUTDEe,TAAAEAAA..eACA..bACBGAFAdAFAMAHBKAHBCCCA.LDABhAAARCDFOCHDJCEFZEBFHDGBhADAAAIBDDGB..gFBHhAHAaFEDSGGAXGGA....hBFA......hCAA...,1,-8,-9,1
fILWPZeQJVYdHKOcBgNbAFETMCSXaDURG,EAAAMAAA..SACAaACE.RAEFGAGALAFAZCCFeBBBQDAAhAAAVCFAHDCBODGHhADABEEB.bFGBAAIBTGAAhAGADGAAfHABIGHA.PFED.hAGA......hAHA...,1,9,-13,22
DeQcHBPLVASXgMKGYOJUCZEaTbWdNFRfI,XAAAMAAAGACB.OAFACADAZAEBEAGA..aBBC..bCFDdCFAhBAA.RDDBDBIB.eCHDhCAAHDAALFGBAAAAKBHBUGGAhADAWFDDfDHE.cECD.hDAABCDC....hCAA...,2,-17,-5,12
RLDCASZPXUfFJQgWNOEabHYBecVMTIdKG,ZAAAXAAAFADA..QAGA..gADAOCABECCBhABAHAFBBCEAeAHBMCGBhACAdDAARECA.LDDBhAAA.ADFBSDHDfDHANHDBbFFC..cGAAhAGAIHHADFIB..hABA...,1,-11,-17,6
USWOBceRbHaTCYZGPLQgfdKIJXNFDVMAE,EAAASAAABACARADF.HACB.CAEA.GAFALAGBQDDBhAAAdCFCKDHBJEAAFAHFMCCB.hAAAADHAOEGDeDEDaFHHZFAAhAFAfGBA.XGFDDEIBWFFD.hABA......hAEA...,1,-6,-16,10
VaMSLURJPENfBIZFGYXDHgQcdKbAWOTCe,TAAAeAAAMAEA.LBDARACFEAEE.BAHAZAGBGCDADCCBHCFCQFFAhAAAdDDAAAAA.CCADaCHDhACASEBDUGAA.hAGAPEGB.fFEAYFDF...hBIA......hCFA...,1,-2,-16,14
SeJGDLKCTHNaVIPXfBREYAUcMFdgOWQZb,MAAAdAAAOADAZABE..eAEHGAGALAGBTBDAHCCB.aCHDhAIAIDBA.fDDEhACAEEFBABGBFFDDgFGHhBAAbDFDDDFB.NIBB.XGBA.BEHAhAIA.....hBIA...,1,-8,-9,1
TeHRNdULPfFIbMcJCgVGKXSZaWEAOQBYD,QAAADAAAHABCRAEFdAGALADA.FAHBMAIBCCDAGCEAKCCDZDEAECGBhAAAADGA.BDCD.eDHHhAEAUFGB...fEAAhAEAbFAA..gGGA..hAFA......hBCA...,1,-10,-27,17
OUbXPGETcZRKYDNQHdVMgaJBLeCSfFWAI,OAAAXAAAGADA.EAFAZACB.RAEADAIBHBGBdCEDMBBB.aCCHhAFALDHBeDFBfEHAhAIAAAAAbEEB.TGCAhBAAKFAA..NHAB..gGGGCGHASFFDhBDA......hBIA...,1,1,-16,17
XGHeKZdDLTEBQUCbVNSOaRWfgMPIcFJAY,GAAAHAAAeACEdADALAFAEAFEBAHBQCCACCEA.VCEAhAAAOCFD.RDBFfCHAhAAAMCIBIFFAFEEHAAGAhACAKFHDDEIB...TGGANHCB.aHCA..hBAA......hBCA...,2,-16,-3,13
eaUbXLVGWHdPfASIcZETCgBFJDMNKYROQ,SAAAZAAAEADE.CADA.FAFA.MAIBKAFARCCA..eCABUCFALCCAhABAGDAAHFFAdCGAAECATEEAhACABAHBDCIBOEHDhCBAaHDA...bGDA.......hAAA......hABA...,2,-26,-2,24
REXdAbaVZKCLYgcWJHIfSBDNOMeTPFQGU,aAAAZAAALADB..gACHJAFAHCAB.SAEHhAGADCFAMCIB.eAGFFDEDGEGAhABAEBHFABBBKDDA.CDHA..cEGChAIAfFBA.OGDCTFDA..hBAA......hCAA...,2,-24,-13,11
efJOWTQAbEPYVXMUdBgacNLHKCISFRDGZ,EAAAVAAAUADA.BAFAaADA..LAGBHAGBCBCC.FBDDRDDA.ZCEBeDHFhAAAOCHD..TGDAhAIAAAIB..bFGDXGFDhBIAdGBA..gGEA...hCAA......hCBA...,2,-21,-11,10
KbCPUDMfVHLeWTAdBXZNaSEcYQGFJgORI,dAAAZAAAaACAEADA..QAFAGAEAFAGAOAHFRCGB..KCCDCCBADCEBhACAMDEBHDCB.eDABhADAACIBBFFASDHDhBAA.JFEBbGBCUGGAfFHA...hBCA......hCDA...,1,-3,-22,19
TAdLSDfVXJNaQcFOYHEKgPeWURBMICbGZ,dAAALAAADADA.XADDaAEE..QBGAOAFAHBFBEBDB.hACAKBHB.eCABRCBBMDFBhAHAbDDDZFBBADGB..fEGAhAIAVGFA.NEEAFFCD.....PFHDhBAABCCDCEHA...hBCA...,2,-21,6,27
TWeDYUHMSOVabAcIEPZNgKdfLXRQFGJCB,EAAAZAAAKADCdADALAFARAFA.GCBABCAAeCCADCHBHDDB.MCIBhAAAOCFE.aEEAAAGAIFGAhBCA.gGDAhBDAQFFBCGHA.TGAA.YFHBhABA.SHEGhACA.,1,-1,-38,37
KUcfaPXIEMVLYOFSGbAdWJNeHBRQCZTDg,dAAAJAAAHADBRADAZABB.DAFAKAGC..UBFA..aBGE..XDAAhADAECEFLDGBFDDHGEGAhAIAADDB.eFEFQEAAhAEACBHA.TGEA......hBAA......hCDA...,2,-24,-19,5
WPRCaceYKOdHQDISfJZbBAXMULGETNFgV,MAAAGAAA.EADATADAFAFD...VAGBRBGFaCDB...eDADhAAAOBBBHEDAQCDBhAFASDHHZDFEAAHAXGEAhACALFGBgGAACHHA.KGDADIBAhADA......hBAA...,2,-5,-5,0
OKUHgBcfWaVJSMGFQLTYEdXebANZIPRDC,ZAAARAAAOADAHAEABAHB....fAGAaCAASCEAhABAGBDALCHBEBHFeCCDhAAAAADAIECACDGDKEHBUGFAhABAgEEA.cGAAJFCF.MHDAhACA.QGGChAGA...,2,-19,-8,11
cOXKTVLJGAaPeHWfdYSUDbCZNMFRIBgEQ,eAAAHAAAdADAUAEACAFAZAGBFAGE.BCAD..EBCAQCEA.hAAAOCCBTCGALEEAhAAAADDAaDED..fEGEhABADBIBbFAA.MEIBgFGAKGGD..hACA......hAFA...,2,-24,-14,10
OLcSedDUMCIbaWGENYQfZKAFPJRVXHTgB,FAAARAAAHADBBADALAFA.eCCBdAFAMAHBCCFA..aCGDECCAQDAChAAAZDAAAAIB.PEEBhABAXDGA.OEDDhADADCIBbGAA.WFHBNICB.KGFA..TFFAhBAA.SFBBhBFA.IHHA,2,-24,-1,23
IYCDNGBMAZdSaRgKUfTOecFPHbJEWVXLQ,dAAARAAAKADCUADA..OAFCeAFAFBHDHCCA.ECFE..XCAAhACALCHBQDDAhAGACECDGEEAAAAAaCFD.TEGAhBAAPHAA..........hAHA......hAIA...,1,-18,-19,1
WPaUNJZcXQEGBVCTRHYMdKLfgFDOASbIe,SAAAeAAA..aADDUADAZAEBQAGAEAFAGBGACCCDHCFBhAAAdDEALGCAFCCHADBBbFFA.hABA..IGGAhAAA.PDBBJHDABEED......hBDA......hBIA...,2,-14,-11,3
ceGbKdTQZAWLJSORVCgaBNUfEIXYDPMFH,LAAAOAAARADA.CAEABAGAUAGA...EBHF..XBBCDCAAMCDAhABAHCDC.eDGFGDDAhACAdEAAZFGBADDB.SEEDhAEAaDGC.NIBB.fEAA.IFGAhAEA.FGAD.hBAAKGHB..,2,-23,-12,11
FQMLVcfCgNZEYUJeKOATHbWRGXDaBPdSI,HAAARAAAGADAaACAdAFAFAFALCGB..fAHACCCDZDAAUGDAhAAAeCCB.ACEBbCFADAIBBEFChABA..SEEAhAAAMFBB.gFBBEFHF.KEHD.hADAOHAC.XGGAhAHA.,2,-16,-15,1
eAdgVNLHXZObCcGUTfRaBPMIJDKQWYSFE,dAAAVAAAHADA.ZABBCADBGAEAUAGARCEBBDCA..MAHBDDGA.QDCAhAAA.SCHHhAGAEEGAAEEBLFAAhAFAbFFA.TGGAaDGHIGBA...hBAA......hBIA...,2,-19,-12,7
PDcJFIHAXTCObNGZLaMWUSYBgdQEVRfeK,TAAAOAAAGADA.ZAFAaACAUDBABAFAdCGAEAHB.RCCAeCFEhAAADAGAFEFHHDFA.ABDBCEEDLFHBhBAAMFAA.SFDHhBBAQFGA........hAFA......hAIA...,1,-11,-20,9
YKVUXLBEdWfRaAFODGeNHcJPZTMSIgbQC,DAAAeAAAHABC.JAEAZADB.MAGB.SAHBICEAQCGAhAHAKCHDUEEALCCDhAAAECCBdEEA.RGFAABFBGGEBhAIA.NIBB.PHBA.......hBAA......hBIA...,2,-18,-13,5
HegEYKMNWXCVQcJLIRUFaTGfbDOAdPSBZ,dAAABAAAHADAEACAKAEAMAFA....XAGBQBGA.LCCAhACARCAAaBHD.GDAAhADADCEAACAAZDCEeDFF.gEGAhBAANDGA.CGHAJHEAFEHB.....hAAA......hACA...,1,8,-33,41
IaSCfcQMdHAWbYOXVTJZREgPLeBUNFDKG,...bAAAXAAA.TADARAEAEBHFLCABeAFEBBFAFCCHGCGAhAAAaCFD.CCDDQDAAhABAHECCAAAAODHDZDEBgGGAhADAPFGBDHAAIHEA..hACA......hAEA...,1,0,-7,7
KVSaWNIQOGCbBEDcHZgARYTXLMfUJedFP,RAAATAAAMADA..UBEAeACE.dAFAKAHBaAHB.....ICCAhAAAGCCAbCGDDBIBHDEAhBDAAAAALEFDFECBSEGAhCAAQGCBBGDAEGGE.gGGAhCEAfHAB.....hDAA...,1,-8,-13,5
FgBKAeMbLORfSVYNQWdUEaHPGJDZCITXc,eAAAMAAALAEARADA..SAGBVBBAQCEAdCCAECFBHDGBhAAAGDGAZEAATFAAhAFAFEEBKGCDAAIBOEEBhAGA.fHCBNAIAaGGCDIGA......hBAA......hBBA...,1,-1,-8,7
NEJfRDIMSGHcBPLZAgWdUbaeOKVXQTYCF,dAAAaAAA.eADAKADA.QAGA.CCBA.EAFE.RCCAMAIBHCEABDADhACAZCFBABBB.UECA.bEFAhADAXDAC.TFCAhADAFGEDfGGADEHBSFHH.PHAChAHA....hBAA...,1,-5,-27,22
ZbGcCaRgWPQSUIEFLDHdVfOKBANYJeXTM,JAAAeAAA.MAEAGADA.CAFA.RBCA....gAGAQBGAhADASCGAECCBLDFBhAFAHDBAdEHAODFBhAAAAAHANICB.TEGA.bFBAaFEBUGGBDHFA...hBAA......hCAA...,2,-19,10,29
EOFUGCXaPYLgKTMbHVRNWAIQBDJfZScde,QAAADAAAZABEdAFA.EACAFAHBGAEA.aAGALCCB.KCEDhADAbBGDHDGBRDCB.ACIBBEFChBAASEBD.eFFAhAAACFBD.XGDD..gGDAhBFA.....hBEA...,1,-6,-30,24
JcaATMWbCRFDgPVIXUKZQSYdOBLGHfeEN,MAAACAAARACA.DAEA....VAGBXAFAZCAA.QBBAhAIAdCEALEGBHBDA.ECHFJFAAhAAAADFATEEAFFFB.gGEAhBAA.IHHASGAD.hBBABGDA....hACA...,1,-4,-32,28
QJSXTYBgdPELNAeHbIRaGfKMcUZWDFOVC,HAAARAAAGADAMACAZAFAFAFD..CCCD.QCCA.XBGDhAAATCFABDAAdEBAEDFBAAAAeDHFhADAaAHFKEHBUFEAOFFBhBEASGAA.......hCAA......hCCA...,1,-5,-23,18
cGRdXTeUODMWVFIKLaAYJfNHQBZECPgSb,JAAAHAAAZADBEADE.CAFB...SAFAGAGARCAAdCEA.eDFHDAIBMCCBhADAFEDHLFHBhAAAACGA.fGGAhACAQDEA.BDGA.bFCD.TFGA..hAGA......hBAA...,2,-37,5,42
ZObPSAcFHKadYfELQNWgVMeDTJUCBIRXG,HAAAdAAAEADALADB.QAFANAGA.VDEAeAHBTFAAhAAACBEARCAAZDCE..bFCBACHBKEGAhACAaCAC...fFFEhADAMAIBDEIBBFGAIHHA....hAIA......hBAA...,1,8,-29,37
OaeWMFbCPTKcBgVfQGLJRUAEdZIYDXSNH,EAAAZAAADACA..SACAHAEAeAHHMAFACCCD.KBEABCED..hABAfBGBGCFARFGFAAGAhCAAdCCA.XDABhAAAaEEH.bDFA...TEDA.gFGBhADA.LGDAhBIA..,1,4,-28,32
KVRdZHFSgIOeWMfEaNGTPXDCcJAQUYbBL,QAAAUAAABADALAFARACAHAFBFAHF..SCBAOCDDeDAAhAAAMCEAEDFB.GEGAhADATDEADDIB.CFAAAFFBbDAChADAdHDBZDGB...gGAA.fGDAhAGA.aFHDhAHA.NIEB..,1,9,-25,34
QKgMVCGHAZENUDObcBJWdFTXSPfaLeIRY,EAAADAAAOABEBACAdAEA..FAEA..TAGASAGH..hAIAaCCBeBHHRCFBKCHBMCCAhBAAGDDAHDDAADDBZFGBbFDA.hCAAJEBF....PEHDfGAE.hCBA......hDAA...,1,-13,-23,10
OIRgfCYZLJFQaBAPHMTSEeVcGdWNDbXUK,HAAAMAAA.EADEeACAGAFAdAGADAIBUCABKBBDRDCF..CAHA.ZBEBLDHBhAAAQDCAAEFB.SDGAhBAAVFAB..cEFDhACAbFFA..OGDCIHHA.YFDBhAFAaHFE....hAHA...,1,-2,-11,9
UPcSROZAEfgWNFLXQYMdGIaHCTJDbVeKB,EAAA..fAAA..gACAFADALAGBQAFAhAAAdBCAaBEEHCABTCDAhADAbDECeBHHBEHAcDEDhAFARFDAAAIBXGFAMEIBCFCADFGB.KHBA.SHFAhAIA...hAAA...,1,2,-9,11
JbVdDgTWaSFHZBefACNRGIQOKXYLUEcMP,RAAAGAAAQADCKADALAFBUAFA.EAHBMAIB..JCDBdDDADCHBhAAATDGA.aCCHHEFAhACAZFDE.eDAD.ADCBCFCDhADAOFHD.YHBAPFEB....hAAA......hABA...,2,-14,-10,4
cQDLNaPWTXSKABCVGJdOUfFebYRIHMZEg,CAAAGAAAdACA.OADAFAEA.eAGFRAGFHBDBEBHF...QDFDhAAALCDBaCFH.TEGAhAAAKCBDACIBBFCAUGGBbDBDhACAMEIB...gGFADFFBNIAB...hAIA......hBAA...,2,-24,4,28
SFZGfITbAWcgOaPUKdBRNHELQXVJCDeYM,....gAAAaAAAKADARAFFHCCAEADALAGBQDAC.XCGDhADACBEAeCCBMAIBhAAAZECE.GDAATFGAADABOEDDhABAdHABBBBDVFFADBIBFGFHfGCEhADA......hBGA...,2,-4,5,9
bNURTPHGSfFKCXJOYLeEBcdAgMDIaQWZV,MAAAaAAAZACB..VADAUAFA..RAGFHBBBGDEAFDEACAHA..OBBBhBAAeCHHEEEB.dGAAACEBDCIBhBEAQGFA.hBFA.bDGD..........hCAA......hDAA...,1,-6,-30,24
bHAOSTLfaNcIKCZWGdXVgRBDQJeEUMFYP,TAAAaAAA....IADAZACBdAFAXBGDRAEFDAGA.eBEDhAAAEBBBMBHBFCAH..bEEAhACAHDCA.ABIBLFFAhBAAfFBAKGCAGGEBBEGD.....hCAA......hCDA...,1,-2,-23,21
WbKEgdPNaHYZRCfQXTJODeBGFASIcUMLV,SAAAUAAAMADALAHB..bACDEBDAdAEA..aBFDHAGBhAAARDBA.QDEAhABA.TEBADEFAeEHFhBAAGEGAABHBIFFAcGAAKGEAgFCAhBCA.....hAGA...,1,-9,-15,6
aGIMFcVUgHCPRSODZbNABELTYXdfeQKJW,EAAATAAAdADA..eAFAQACC.KAECaBCBGAGAMBIBFCEDhAAAUDDAHDFBRFEADDIBbFAAAAIBLECDhAAA.fGHAhBGAIGHA........hCAA......hCEA...,2,-13,-9,4
UFYTCEfXDSagHOLGZJQINKAMBcPeRbWVd,MAAABAAAeACARACA...VAFAdAFAFAHB.CBBD.ECAADCEB..aCDAhAAAHDEBGDABZDGBQGDChBAAKCHBAACA..hCAAbDFD...YFEFfGHASGHHhAIA....hCAA...,2,-22,-20,2
BIOTYAHgbfcRZLQMeEKUCXGadJNSPWVDF,HAAA..bAAARADFZAFBMAEAEAHF.KCADXAGAdDHA..SCCDhAAAPBEB.DEEABCAAhAAAOFAAACCBfCGAhABALFFB.eDDDCHEC.aDHD.WFBBIHHAhACATFFAcFCD.hACA...,1,-5,-22,17
eTIEFXABSNOUMfDPbRYJKHQCdcZaLVWGg,SAAAOAAAUAEAMADA..DAHBRAFAKBCAHBCB.dDFAZCEEaBHDLEBBhAAA.GEFAhABAeEBBEEHBACIBBEHAfFEEhAIAbFCD.QGGCCFEC...hAIA......hBEA...,2,-14,-14,0
KDEbdCRNXZJBIcSFGfMTUePYLHaAOgWVQ,OAAAVAAA.DAEAEADE..dAHARAFF.ZBBABAHB..SBDEhBAAGCDAMCHBeBFHLDCDhAAAHDGBADDBQGEAhBHACFAAXFFC.IHHAfGHA...hCAA......hDAA...,2,-20,-14,6
TUYRgVGWALeKISbOfDHJFNCQcZXadEPMB,eAAASAAAOADCHACBFAGA.QAEAZCCAdCGA.EAGAMCIBTCGAhAAARECAGGDBABIBLDEBhABAKFAA.bEAADGGACEHAaGEEhAEA.BHGA.........hAAA......hABA...,2,-18,13,31
cPEJKVDXbMZOefLACHdNaUGSTWYFgRIBQ,HAAAaAAAGACATAEAFAEARAGFBCAD.QCCAEAHBKCEA.XDFChAAAZCGFeBBD.ADIBdEEAhAIASDHH.gEAAhACAIGGAPEBBDFGBbGAAfHGFhADA....hAEA...,1,-4,-13,9
fBHCZeSIdYGRTPgLbANXWaVEJDQKcOUMF,XAAAaAAA..EADAQADAOAFCMBBBBAFA.HAGBeCCAhADAdDAARCFA.TDCALEEAhAHAAAAAVEFAKFHBFGCAZGDAIHHAhADA........hAIA......hBIA...,1,-6,-16,10
SWMCIEDcFXJeNGYaKRQPdBfgALZOVHbUT,ZAAAHAAAUAEATAEA.MAHBEAGAFBHD..eCAAGCAAaCECREAAdDDAhABABDDDAACALEGBhBEAOCHDbEFDCFEA..DEIBXGAAhAAA.YFEDKGDD....hACA......hADA...,2,-21,2,23
OYHLKDAfXPdVGQUaEWgIMcBReCNSJFTbZ,XAAAdAAAGADAUADAEAFA....IBHAMAGBRCGF..eDBAhAAASCAAFAHFZEEFHFBAhABALDFAADBA.fFAAhACAQGGCaDBE.gFFA.hBDACCGDNIAB.....hBFA...,1,-7,-9,2
YWBSDRgdaAeFHTNJIMQcCEPUXLVfKGbOZ,HAAATAAAJADA..MACAQAGC.ECABXAEALCCAhAAAKAHBGDEBZCCABBDDhAAARECBaFFCACHBeDFHFGHDIHFAhACACDHAPFCB.fFHA.OHFChAHA.WEEDDIAA..hCAA...,1,10,-23,33
CQLdNUfJHVBXbGReOEKSFWcPDIMagTAYZ,ZAAALAAAdAEAUAGAHADBBCAAGAGA.RCAAEDEAFCCH...PEFDhABAMDFA...aDHDAACAQEDAhABAJFAA.hACA.bGACeEBBSHGADEHBTGFANIBB..hBEA......hBGA...,2,-32,16,48
edBAZHRSJILCKPVOfaDMXWEGYQFbUNTcg,HAAARAAA.SACELADBKAFAOAEDaAHD.MAGB..ECFBGCCAhAAAQEECbBGDTFEAhAHAeCCDAAAAJHFECDHAVFAAhAFADAIB...XGGA.FHDA..hAHA......hCAA...,1,3,-10,13
LHERWDFcCGaYBbAMPedTNSQKfgIOUJZVX,eAAAdAAASADAQADAKAGA..fAFFOCAEZCEALBHBhAAAHEAAREEA.FCCBGGABhACAaCFDbEDCADIBMFIB.hABA.TFGAIGGAJHCA......hADA......hAEA...,1,4,-10,14
YdCMJNcUAZWbfEQHSXVTaGOegPKILRDBF,ZAAA..bAAAEADEHAEASAFB..TCAAGBGAeAHHhAAAKCAARCEBFCEHdECAMCGBNEEA.hABAAAGAQEABhABA.aDDHOFGBgEGHLHAABGHACHHA.hACA......hAHA...,2,-10,10,20
SbQIKdHBXJNAPMeaWRcGULYDFgfZCOVET,eAAARAAAGADALAEAFAFAZCFBOAHD.EBCFTDAA.QFBAhAAAdCEAHDFBXFAAhAAAAAIBMCIB.aDDBUGGAhABADEIBCGHDSFEDKHDA.BCCD...hABA......hAFA...,2,-10,-3,7
bPZFVEAYHKNMUCOSIaeQcXJLdfRWgBTGD,HAAAMAAAUAEASACE.eAEHQAGAXAGAdBBARCCBBCFAhAAAGDBBDCHBZDGBEEFBADGBKFDAhBAAODHDaFHD.LGAAhAGA.fGEA....hAHA......hCAA...,1,-2,-20,18
HbSYgTUPEMRGdLOfFVKZDWaeBcJINQCAX,HAAASAAATAEAEADARAGFGCAB.dDFALAGBFDHDZEAAaEEBhAAAeBDA.BCCD.IDAAhAAAQGAAAAIBbDEChABAgGGAMCIBfFDEDACA.cFFAhADA.CGCD..YHFAhCAA.,1,16,-30,46
VKEcGLWdRgDeMIYABXQNOZfbPHTSaJUFC,QAAAZAAA..bADBHACA.aAEAFAFDKAHBEAHBGCDAdCAARCFADCCBhABAeCFB.MCHBADDBBEEAhACAOEHD.TGCAhAAASEGACFFD.LHEAIHAA..hAHA......hCAA...,1,-3,-20,17
GYBLPcaQMCNKAIZVOWgJFRUHXSTbEefDd,ZAAAOAAAJADA.RADAHAGB..TBGAEBBBeCEFdCAAGCCBLEAAhAEA.aDGCMDIB.KEFAhABAAAIBIFFA.hACAgGAAXFCAbGACDFHB.BGGA..hAGA......hAHA...,2,-19,0,19
YcOdBFZVPTRfKWDJNMIUEHgbaLGXACQeS,eAAASAAAOADCdADAZAGB...TCCARAFAKCCDDCFB.MCHBhAAAEDFBHECC.aCHDGEDAhABAAAAAQFAChAFABFAAFFHDfFGA.NIBBIHHAhAGAbFFDXGAACGCA....hAFA...,1,12,-26,38
gaURWMCPEBALeNVcOfdDIXGKJSHQYTFbZ,eAAAVAAA.OADC.dAGAXADBGCCAKCFDHAFA.QCDBhAAATEFAZFABaCGD.RFEAMCIBhAHAECHFAAAA..NEIADFABhAFASGDD.FGHD......hAIA......hCAA...,2,-9,-5,4
HKUOYFeMRcafWBZQEISDgCGNbdALPXVJT,LAAAXAAA.TAEAHADAOAFA.eBHFRAGFaCAABCDDECEBDCIBhABAGCEA.dDAAADDBPDGBhACAKEHBFGCAMIDAhAAAfEAA.ZGAESGFACEED..hABA......hADA...,2,-9,-6,3
OUPWeTJDAZBFKRgbHLCSGfQVdEcINaYMX,ZAAAKAAARACFHAEALAEBGCAA.QCCBEAGA..ICAAhAAAaAGAMCGBOBHDUFDAeCHBhABATDFAAACAFFGDbECB.hACA...SFFA.dGAANICB.YFHBhAGA.WHCAhCEA...,1,7,-17,24
KUXbQcNeaBDTAYICEFJWGdRMVLgZSPfOH,CAAAEAAAFACAGACA.RAEALAHBZAEB..fAGAHCFBXEAAhAAAQCBAeEDFaEHDhAEATCGAACBB.IEEAhAAAdHCDMFFB.SGGDKEGDcFGDBHHBhAFADAIB......hBCA...,2,-27,11,38
VCODgHNJFSAaQEYXdKIbcfMPGeBZRWLTU,EAAAdAAAKADA..IADA..bABDMAFAGAFAZBCARBGBLAHBhADAUDEB.OCEBhAFAHFBAFEHDAEHAQFEAhBAAXGGC.fGGB.eHBA..hBHA......hCDA...,2,-13,-12,1
LJgfDNMCKEABQcGWeRXZTSPdHbUIVYOaF,QAAAGAAARADAZAGBSACAHCEBUDCA..IAFAOCHDaDAHhAAALAHB.fBGAhAAAMFGBEFHBAGAABCDAhADAeGAATDEA.bEGD.FDCHDIBACGFCcFCDhCAA....hCDA...,2,-16,5,21
NIgAGVHSDZYXTUWREfFMOabeKdQCLBcJP,HAAAZAAA.TAEARAEAEBHF.MAHB..aCAAeCAAdCEDLDAAhABABCEDPDDB..gDGAhACAAACAGCFADAIBXEEDhADAfEAAFFAAKFHBQGAACHAA.hAEAcFGD.NIDB..hAFA...,1,8,-12,20
fNgEUWDLYCdQXaJcMPTFHbVKGISRAeBOZ,eAAAZAAA....fADBEADADAGALBFAdAFAQCAAhABAaCCAMDDBTCDAHEEAbGBAhAAAGBGA.REFBAAHAOFHDhABANEIA....WFEDCGGC.....hBGA......hBHA...,2,-12,-4,8
VTKaEFAIBJdMDXcZORLCUPWgbeGfSYNQH,BAAAdAAAMADADACAZACERAFA.LAGBUCCA......gCFAhACAeBFFGDCASCHHhAIAQEGAHFCAhBAATGEAEFFEABDAIHFA....hBCA......hCFA...,2,-29,-21,8
VBZHbAJCLRcfQaFEgSPdUYIXNTMKOeGWD,LAAARAAAQADCEAEA...SAFBdAHAICAA..TCEAhAAAMBGBeCCAGCGAhABADDFBZFFFHDGBAAHACBHBaCCHhCAAFEAAgGGA.PHBAYEEFhDAA......hDBA...,1,-2,-10,8
gLHOGWEDYZKXRdVMTePQACaNIbfJScBUF,aAAA..bAAA..SACHBAEAFAGAHBECGAEAECAAZAGBRDDAdDHAhAAAMBBB.eCHHADDACEAA.fDDAhAEAUGFA.LFFAhAGADICA.XEBD....hBAA......hBEA...,1,-14,-17,3
ILEXDBZcCeWJGMHbaOVKUFAPTSRQdYgfN,TAAARAAAdADA......fAFALACBEAEABAHAZAGBeCCBhAAAGCEAHCECaCHDKDHBhABAABGBQEAAhAAANEEA.DEDBCFAAMFFBbGFA.OHAA.FGGA.hAEA......hBIA...,2,-8,-6,2
cRePYUSVBMKTLIGbZHEFNOfDQXCgAJWad,aAAARAAAeADE..UADABAGBMAGBLCCAGCGAHCFB.EBHFOAHFhAHAQEBACBBDADBAdDDAhBAAPEEB.SDHHhAAATFBAZFEBfGGAXGGA...hBDA......hBFA...,2,-16,-2,14
KRUEHdBSDYLZgIeOFCMQbJAVXPacGNfTW,XAAAaAAAGACA....TADARAEAHCECdAFADAIBZAGBeBBDCCDDMBIBhAAAQEAC.hABAADIBPEEBfDAAhADAKFHBEGFFSDEHLHAAOEGB.FFHDhCAA......hCBA...,2,-17,12,29
UKZbIMXFPCGWQeHRSAcBDdJgOYTaEfNLV,DAAAdAAAOADA..aABEEAGALAEA.KBHBbABDMCCAFBEHGCFAhBAAeCFFHDGBABIBBCHDhBDAJDDB...gFGHhCDATFAAVGEA.......hDAA......hEAA...,1,-12,-22,10
YUGXQgebEJLBPVTMFHRaZCKcNOAWSIfDd,SAAADAAAdADAGAFAQADA.eAFAEAHBLBBBhAFABBHATCCAHDDBZDAFKDHBOCFChAAAADDBfFBAhAIAUEEAbGAAPFGBMEHBaGHDCHDA......hABA......hADA...,1,-1,-9,8
SWKUYAgMZBeRCTEFOGLIVPNcXJfdQbaDH,ZAAARAAAEADEGAEA.LAGBVAGB...PCABXCCAdDDAQEBAhABAaCFHHEFCKFAAhAAAAAIBMCIBeGDAFGHDOEGBhACANIAB...fGBE.SHEGhADA...hABA...,1,1,-9,10
CWVdFMNITHASUZGEKBLgfRbXcJaQYeODP,ZAAAEAAALADARAEA..bCABXAGD.aBCCeAHH.DADAhABACCEAdDGAMCEB.TDFAhACAHEAAAAEAGFDBBDDDfFEAhAAAJHAAODHD.PFHD...hAHA......hCGA...,1,-8,-10,2
EbOBGLVSgafHUYIARPXJWcNFKCZTDedMQ,RAAAXAAA..JADA....cADAKAGCZBFE.eCCBdAGAEBDBhAAABDGAGDDBLEEBhAAASBHHaDHDUGGAhABAAEIBPFAA.FFGBDECBbGBA....hABA......hAFA...,2,-28,-13,15
gDEGXdVBUQONISYfRWFTaLbHcePMAKCJZ,CAAAZAAADACAEADE.GAFAdAFABAHAUCAA...QCDDOBCA.hAAASAHBRCCBFCGDLEFAhAHAHDGBeEEB.hCAAADIBKFAAXFDDIHBA.fGGEhABAaGGA.....hCBA...,2,-40,11,51
EQgAIYRWNcJTGDZKFLfBMVCObaSHdPUeX,RAAA..NAAA.TAEAZAFALBBABAGB..MAIBOCDE.aCGDHCCAhAAA.dCGAeDAHEDABAECBhABAIEEA..hABAcECDGGABFEHDCFGAbGFASFEA.hACA......hADA...,1,-12,-15,3
RJQSIYfPFZDUKNHALCbaOEBMTWGdcXgeV,LAAAaAAABADA.MAEAGAEAdBEA...XAGAeAHFRCAAQDFDhABASBBDIDDAhADAfECA.ZGBAKCGAhAGAHGFAACCAOEFC.EGGA...WHAAhAHA......hBAA...,1,-2,-29,27
KVOHfGWdaSBMJPcQXeIFAZDULRTgbCNEY,ZAAALAAARAEA.TAEACAHB..ECAAKAGCHCDAGCAAdCGAaDAEMBIBhABA...JCCAQFAAhABAeCFHACABDCHBbEFAVFGBhACA..OFEBSEEDBGGA...hACA......hADA...,2,-12,-5,7
agCbANedQJOfTYIKHDUPBLXGcWSMZRFEV,eAAAdAAAQADAOADC...TAFAKAGCHCCADAIBBCBAGCFAhAAASCFARECAEBHFaDHDCFAAhABAADABJDCB..fGHAhAFAIEEALEGB.WFHH.hCAAMHAA....hACA...,1,0,-28,28
AVEUBcCLaFKSdMfTIXeJNbgDGHZPOYRWQ,EAAABAAALADAaACA.KAHBdAFA.MAHBTCBA..eBCBJCFA.hAAA..bCDDGDEAhAEAHEGBZDBFOECDRGDAAAIB.cEGAhAFASFBD..XGGCDCIB.hAAAPHAC...hBDA...,1,-4,-11,7
ZUIROQHVfEXTBgNAGWJFbaKSMCcePLdYD,GAAAFAAAKADA.MADA.eAFAdAFAZAGB.RCCAHDABEBHFBCDA.AAABJCFBhACAaCHD...CDCDLEHBhBCADEEAOFFAQFCAhBDA.XGFBgGGA.NIBB.hADA......hBAA...,1,-7,-28,21
AbfNXOcIRCVgLYSZFPJETQMDHWeBdaUGK,...bAAAXAAA.OADARAEACAHBLCABZAGBFBDB.ECCBMBIBhAAAHCECeBFFaCHDGECBhAAAADEB..fEFAhABAIFHAgGGGSEGH.PHCAhABA......hACA...,2,-20,1,21
DGSKVQgYZfNIJRLMbXCOdAHaTceEWUBFP,HAAAaAAA.eACEEADABAFADAFAGBEB.KCCAQBGAZDEE.hAAAfBBEIFFALFHBhAIAbCED.OFDBhBHAAAHATDAA.cDCD.FEGA.SGDAhADA.gGGAhBAA,2,-18,-7,11
gZXFQOCDUPeKJHNBaVLIRYEWdcTfGMbSA,ZAAAQAAADACAUAFAeACA.HAFABAHAaCDALBEDRCGB..hABAEDAAdDFATDDAGEGAhCAAbFFAACCBFHDA..CGEDKHAAhAAA.NIDB...YDDF...hADA......hAHA...,2,-30,6,36
ZVIWJGRMQgTPdfLCHbDUEOeSXaFYABKNc,KAAAZAAA..VAEAJACAGAFA..RCAAMAIBQCCA..hAAATDEAdBHALEFAhAFAHDGBbEAAEFDB.eHAAhAHAaGDDAACABGGA..IHAA.gGGAhABACHEADGIB...hAIA...,2,-17,-4,13
SEDAbJPdUZFOHaWXKfIGTYCcNVeBRQLgM,JAAAdAAAZABBHADB..aADDKAFAGAFA..TCFACAHA.VDAAhADARDBALDHB.MDFBhAFAEDHFAAHAUFBBOEEBhAFAXGFDfFGE.IHCA.hAHA......hBAA...,2,-16,-15,1
QUaBHYdWNAFPeGTIXZfEKSVLCOcJRbMDg,eAAAGAAA..TADAZADAEAGE.KCDALAFBOCGD.RCCBbBGDMCIBhAAA..DAIBQEABhACAaEFCHFCCdGGAAEEAFFCDIHAAhAAASFFB.CHGAgGDHhAEA......hAFA...,1,1,-11,12
VDBKdcgHIZRCfaQXSeWTFGMYJUEPALbNO,LAAAOAAABADAdAEAHAGBRAEF.aCAAQAGCeDCA.FBBHGDFAhABA.MDIBUDEBhAIAAAGBbEBCDCIBKDCB.IFHAhBAAfHEBSFFD...hACAYHDA..hCAA...,1,5,-36,41
VDWfSQYEZCaIMFGHTbURdXPNAcBOJLegK,OAAAeAAAKADADAEA..SAFBEAGA.ZAGBaBBCFCCAHBDBUEEAhAAARCFFdCHA..XFCBhABAABFBBDBALFFAhBAA.WHFAfEHA.CGHAMIBAhBIA......hCAA...,1,-17,-27,10
QOXcfSeCAKLWVIHFNEZPBTbMRYaJDdgGU,LAAAVAAA.HADBEADEZAFBTAFA.RCAA.aAHDdAHAGCDAUDFAQFAAhABAODCHXDGAhAAASEED.hAFAACAAKDHBFFFABGHA.MHBADGGA....hBHA......hCAA...,1,2,-11,13
EMCfaDTGPOYBIQeVgdWJZSLFRNcAXHKUb,HAAAKAAAEACEMACA.aAEEGAEA.OAGFBAHAeCCAdCCAZEAALCGBhAAAREEA.ACCAbDEDhAHADAIBTGAA.IGGAhAAAgGDGSEHBFGHB.XGDDhAEA....hAGA...,1,-5,-16,11
TBLQESVKJAMNfcFdICRaGPbUeOWXgDHZY,MAAA..fAAAdAEARAGBGBBAUADAeCGDXAFAHDEBZGAAhAGATCAAQGGAhAIA.SEBDhBAAKCFAAAIBFDDBaCHD.bEFC.OGAADEDB.LGEAhAAA.....hBBA...,1,1,-1,2
DBFZOARcbUECXLHTgWNQfeJKdYGSIMPVa,RAAAUAAAEADE.LADAHAFB..TCCA..gAGHhAEAQDFBeCBAdECDSAHBhAAAMCFBaCGEFEDBADIBbFAChABAXEGAfFFEKFAAGGEBIFHA.hAFADHBA.BHHA..hAFA...,1,0,-2,2
VGXQDRbINdTSFcBKWeOaZMJPHfYLEACUg,CAAAVAAAGACA.DAEARADF......bAFBdAHA.TCAAFAHDKDAAhAAAeBFBZDDA..MDHBhADAHDGBLFCAAACBXEBDhAAAQGGBSEDA.BGGD.aHBAhBEA......hBGA...,2,-17,-9,8
IaHgTPBQZMWYFXJSCdNGeVfbcUOADELKR,EAAARAAAHADB..TACAQAFAZAEBMAHBFCCHSBHBhAAA.dDAAeCCB.bBFDhAAAODFBAAIBLEABhAEAaDGDBFHAXEECCGDANIABfGGEDCIBKFGAIHHAhCAAgFAAYECFhCBA..,1,5,-15,20
gFBLZGeWaCJAIKEHTdXbUcRDQPNVfSMOY,EAAAHAAAdADAXADB.UAGARAFAQCBC.VCGBMBFBhAAAODEBFCAHZCCFeFAAhAAAaDGAAEGAKFFATFFADFIB.hAFAfGBA.SFHBBHHDWGAAhAGACHHD......hAIA...,2,-15,-2,13
PbTZYLMWdgKAOQDGCNSfeHcBJaRFVIUXE,QAAAGAAASADAHACABAFBRAFFFBHDIAHAUDCA.ECDATEGAhAAAZCFBLDHBhAAA.dEAAAADACEEBeDEFaGEA.hACAXGGCPHAAMIEA.....hAEA......hCAA...,1,-3,-6,3
JACdbRKGPXZIYBEaHFQLVeUDcWSNfOTMg,dAAARAAAGADAZABBBADAHAFALAFAeCCBDCHB..SCEAhAGAODABMCIBACEA.KEFAXCGDhAHAEFDFFGGA...QDCDhBAA.cFEBfHAB.hCDA.TGGA.CFHB.hCIA...,2,-29,-5,24
AYXPDIfGKBdTgNaEcULMZJOSHWbeFQCVR,XAAADAAAGABBdADA..TAGA..aAFAECCBLBFAhAAAZCEASDHHHDBAeDDEhABAQEAARDGFAFFBIGBAhAIABEEAgFCBUGGB.MFGB..hAEA......hAFA...,1,0,-17,17
dJQgRMIUaPeTKSBZcFYXDWbfLVNACGHOE,HAAAEAAAdADAQADC.RAFFMAIBaAFAeAHHSCAAZBEBFCBBDCGBhAAA..bCGDLDDDhBCAADDAGEEAODHDhBDAgFAAIFFA.PHEABFDCYHAGhAAA.fGHAhACA.,1,-3,-9,6
TQaSOHCJMEfIUPYALZRFNcBGVbdKeWXgD,RAAAFAAABADBGACAdAFA.eAEA..XBGDTBGA...aAHFHCEBhAEA.MDIBECCAIDEAhAAAPEGDAAIBZFAAVEFAhABA...KFBAgGDHSGHH..hBFA......hCAA...,2,-28,1,29
eTDfGBWLYIERVJgAXKHaZONSCbcdFMPUQ,HAAAZAAASACECADBdAFAFAHB.UAFA..eCAADAIBGCCBLDDAhAAAEDGARDGF..JECFAEFBaEGEhABAOFBH..bFBAMFFBhACA.QGGBTGGABHBA..WFDHhBFA.....hBFA...,1,1,-19,20
agfVNTGDXPBSEOeZdFIQKWYLbJHCAUcRM,RAAAaAAA..VAEAGACA.DAEABAHB.ECCAeAFAZCEE.dCFAQDAChAAAKBHBLEBAHEFAhABAABBBMDHB.fFFAhBAANHEB.........hADA......hAEA...,2,-21,-21,0
LHcXUebdGRTCYBVWSIAFKQPZJagODMENf,QAAAZAAAaACA.DADAEAFALAGBHBFCUCCBeBDAGDEARDBACDFDBDHAhAAASDGA.hAIAAAIBKFAAgFFAhBCAMFIBfGDAXGCA.dGGA.....hBDA......hBEA...,2,-21,5,26
IdRPcVQKgUSCaJZOLHEAfBbTXFYWeDGMN,BAAATAAAFACA..eACEGAEA.MAHBdAFARBGF.VCCAQCBAhAAAKDBDUEGBaCHDZFEFHDDBhAGAAAHA.XFGAhAIADGHB.IGBA.gGDA.hAAACHFA......hBDA...,1,-1,-17,16
DJTaKPCIWUYBHLRcAfgVeNMGXESdOZQbF,VAAAeAAAGADA.EAFAdADAZBGBQAFADCCB.aBHDCCFAUFAAhAAAHCDCREEAACIB...fFAAhAAAMDDBOEFBhABAFFHDKHBAIGGABHEA.......hAFA......hAIA...,1,-9,-14,5
TcXPBNVbACWIUeQJKYdHGRgMafESOFDZL,CAAAUAAA.eADAQACAKAGA.HAEARCBA.aAGAECFAFCAAZDEETCFAhAAA..XEAChADABCHBbDDDACIB..IFFAhAEAdEHAMHFA..OECDDDDB.LFHBhAIA.....hACA...,2,-12,-10,2
FcXZQJABONKGfVedagYLIHbPUTCWSRDEM,OAAAGAAAeADAdAEA.aAGDLAGB.HBCBbCDB.TEBAhAIASBHHEDHFFEEAZDEBABBBKFDAhBAAfEAE.hBEAgGBAIGGACGBDRGEAMEIB...hBGA......hBIA...,2,-12,8,20
KOSFHfEVcBLCGbPADeaXJgWZYdNMTQURI,eAAAaAAA...XADAJADAZAGB..dBBDMAGBUCEARCCA..OAHBhAAAHEFCEEDBBDHAGGABhAGAACCADEAA...gGGAhBAAYEEATGEA.QGGChABA.....hBIA...,1,-13,-16,3
gNGAcVdKePOSRUHBWJQITbCDfELMFZXYa,dAAAeAAASADAHADABAGB.QCCC.TCFAbABDfAGAhADAEDHFMEEBZFAAhAAAaAHDGCEAAAIBKFFAOFHDhABARDGFUEAA.IGDALHCAXGGAhAEA.NIDB.....hAGA...,2,-6,15,21
PZFOeYKQUgABWVRIbLJXTcSdEaHNCDMGf,BAAARAAALADBJACA...TAFAdAFAHBGBDAIBGCEAZCBAFDFH.eCCDhAAAKECA.UDGA.AFAA.hABAVFGB..XFAAhAFAEHAA.aGGAMICAOHAC....hAHA......hCAA...,2,-29,-4,25
FIZBEKgTafRHYVcWdXOLQbCAeMJSUNDGP,eAAAMAAAUAEAGADA.FAFAZAGBKBHB..aBBAHCFB..VDDAhBAAdDBALFDB.hBEAbFFAABIBSDHHhBGADHFA.BCCD.EFGB.fHEBhCAA......hCBA...,1,-12,-31,19
XdMSCEbJTFUZHLQfWgPDBKaVIANYcOGeR,...NAAA.OAAAGAFARADAdAGA.MAIBEAHBJBBAFBBH..HCEALDDBhABAQDCD.hACA.fDHAhADAgEADBEAAaEGAAFFAeDFDCFGA.bEBD....hAEA......hAFA...,1,-7,-19,12
LgXZYfAQIbdSNPTFVEDeGWJMUOaRBCcHK,QAAAdAAASADA..TACAEAGAeBHFGAEA.MAHBhAAAaCAERCEBCDDAHDFBLEAAhACAZEAAAAGBbFGBFFHD.DAIBUGAAhADABDHAKGCA.........hAEA......hCAA...,2,-7,1,8
OabQHVTBWMSAYXEPZcfKeCdUgDNRIJFLG,EAAAZAAAKADCdADA.DAGARAFA..FCBBGBEA..aCEDHBGDBCGAMCABhABAAAFA...XECAhACA..fDHAhAAAeDHHCCCDUGBAgEDGIGFAOFHDhAIA.QGFAhBCA...,2,-31,-9,22
XYQfLUGKVHDecdANbMZBOagIRFSCWEJTP,MAAAZAAAaACARACA..FAFACAFA....EAHBTCDA..XCCAhABAQCFCLCFBhAFAGEGAHEGBeBBBACHBbFDDhAIAOAHD.SFFD....hBAA......hCAA...,2,-18,-13,5
PKQYReBagUXMZVEGWNJTCfbAHLScOIdDF,HAAALAAAOACAdAEAFAGAQAFARBFF.eBHHaCAA.UCCAZDCBECHFhABAGDFA.JFCATEEAhACAfFHA.hBEAAHBASHBADEIBKGGABHFDMIEA...hCDA......hDAA...,1,9,-17,26
FRaVMNLHGJZXQCbdYgUfEeTSBcODPKAIW,FAAARAAAMADAHACB.ZAEAQAGAdCFAUFAA.EBDA..eDEDBCCDDAGAhAFAAAAA..aCEDLDHBhBAAGDFACDHA..gGGGhBIATGCAOFHDKFDDIHEA..hCAA......hCBA...,1,-11,-12,1
dYVNQIKCbSJUHFZRPXEDOfMBgWeLTAGac,aAAAdAAA..VADAQADA.CAFA.bABDSAGH.HCCAhADARAGFEDABOBBBMCIBBDEAhADAeBHHADGBGDFAhAGAcEEAIHEAKEHBFGHH.PEDBDIAA.fHGFhAIA...hAIA...,2,-11,-2,9
gMHOVFAPeGNSKJEdDZLTQcWYCbIfXBRaU,eAAAGAAAKADAEADAZAFBLAGB.TCDAQCCA..hAAA..cDCCCAHAbCGD.hABAXDGARFAAUGEA.HFBAhAAAFGHBACIBSDAD.dFFA.DAIB.hAFAIHHAaEDE..hACA...,2,-10,-4,6
gHUVEDSXOTcdaPGJbNfKZeCFMWIYARLBQ,RAAALAAAQADCHADBUAFAEAFADAIB.OBGDdBHAGDDA.hABAJDGFbCABKCCDZDDAeFHHhAAAMDIB...IFDAhACAAGGB.BFAD.SFFA.hABAXGCC..hAFA...,2,-17,-11,6
cOPfFWEeSJdCbZGVIMNHaBYQADRKXLUTg,RAAALAAAUADA.TAEAOAFC..FAGAECCBeCAA..dCGAZCEAhABAGEDAMCIBHEAAhACAaDFBBFHAACGAXEEAhAEA.PFHBSGFHCDDD.IHAAhAAA......hABA...,2,-30,5,35
TPHRUCZMVcGSDXOebYNKIaEfAdgJFQLBW,dAAAFAAALADABADA..TAFAHAGBRCCAZABBMDGBGCEADDIBeEABhAEA..bCGDKEEBEDCAhAFAAAIBQFCChAFAUGGACAHBSGDBOEHH........hBAA......hCDA...,2,-16,-6,10
AKDaTHfYISdNbUCJgQZGLPEVeOWcMFXRB,aAAAHAAA...fADBSACHdAFAUAEACAHA.QAGAhBAAGCABECGAeBBDODEChAAAMDDARECBADIBTDGA.hACAIEEAbFFAJHAA.ZGFAPHFCcEBC..hBEA......hBIA...,2,-14,14,28
UcHCGIALdRZMabFNJBTOVKeDYPfgQXESW,RAAAaAAAFADABADA..OAFDeAEH..DAGA....fAHAhAAAQBGAECCASBBDhADAUDFBHEDBGCCAhBAAACIBZGFEMHAAbEFATGBA.KFED.gGGBhBGA...hABA...,2,-18,-8,10
EYaCOLUSBPcXMDdWVJRAGfQIHZgKeFTbN,GAAAQAAAHADAZACBeAFEFAED...bCDAEAGA.CBHA.LCHBhAAABCFA.XDCChACAdDHAVEDAADABfEFEhADAKGAA.TFCAaGEESHGAMHEADGIB..hAAA......hAGA...,1,20,-24,44
fRWTCPYOeAFIGNcMQLaJZUHKXVdgbDBES,GAAAMAAALAEAZADAHBGBKBBAdCDA.DAEAEBHFREFB...CCDAOCEDhAFAAAABFFCA...IDBAhAGANEIA..aAHFXDGAhAIA.bFGDSHFATGCA..hACA......hBCA...,2,-21,-16,5
BbZKaYDXFfeRUGOVNQHEJgPCLdSMcWTIA,ZAAAaAAA.DACAFADARAEA.GAFA..OAHDQBBBHCCCECGBJCEF.hAHA..CEFALFAAhABAdBHAMDDB..TEGAhAIAAEIBbFEA.XGGA..eHAA...hBAA......hCAA...,1,-12,-16,4
TGCQbKYMNSHfecFERUIaDOAJPZdgBXWVL,ZAAAdAAABADA..XADBLAFAGAFAQCBAKAHBMCABhABAHCFA.eDABECCBRDGFaDDDhACAADFB.JEGB..gFBAhACA.WEDHCFCDbFED.SGADhADAFFFHDFIB.....hAHA...,2,-16,-6,10
fIGEAXQORcCabMZdWFHULJPBeSYgTKDNV,QAAARAAACADB.aACEZAEB.dAHAHAEBLBGDBAGAeAHH.hAAASCDDTDCADCCAhABAfDAAEEFB.hCAAADGBODHDbFGD.MEFBFHDA.PGAA.hDAAKGGANDIA.....hDBA...,1,2,-18,20
cFDaUbWJXNVSBKPAQYMHEITGOCLZfdRge,MAAAHAAAEADEGACBLAFBdAGARCCB.eAHBDAIB.aCACUDGA..bCCBhAAAJFAA....XCGDhACASEFDKEEAAFCBhAIAIGHATFGA.CBBD......fGEEhAFA..hBAA...,2,-32,7,39
PBDQYbIVcKeHTAMZRgXJaSGWNCOfEdULF,RAAAXAAA..aADAGADACAGA.EAFAdCCALBHBBBEDQCFAhAAAbCFD..IDAAhAAAKCHBHEDAACHBZDBBhABASFGAOFAHFFDBDGAA.cFGDeHFAMIAAhABA.WGAA..hAGA...,2,-25,8,33
AVIeRQSNDZXMYUdWECOPbcaJKfBgTHGFL,eAAARAAAQADCDAEAZAEE...MAFAdCCAEBHFOBFC...bCCChAAAaCFB.KDGDBDFAHEDBhAAAGDGAADBA.SEEDhABAXGGA.YHBACFHC....hBHA......hBIA...,2,-23,-16,7
HCYWfAXbSQROMJFaDBPEgcTNdeIKZGUVL,SAAARAAAMADA.FADAaAFEBAGA..EBDF..TBCAeAHHZCEBhAAAGCEALEDDhABAHCGDCEDDfEGAhCAAAAAAQGAADCCBgGEBdGGAKGCA....hDAA......hDBA...,1,-9,-11,2
bXRcKWPITFYDMSULdOVZAECfHGNQaJBge,EAAAHAAAGACAaACABAFAeAEARAGF...KAHB..ICCATCEADCBBhAAAMCEBLCGBhAEAdDFAZEGBACIBfEEEhAFAQFAAbGEA..WFCH......hAAA......hAFA...,1,-1,-18,17
QKSEObZRYeBPCdNXcJMDVFTGIHLgUfAWa,aAAAQAAA.EACAZACB.RAEAeAHHCAEAdAGA...XCEAhAFAMAIBFCDAGECAHDECLFFAhAAAfEEBADDBSGBAhBGAbFGDBBBD.PHDC....hCAA......hDAA...,1,-8,-11,3
CURXZGJBFTdNVeLASMYaEPcfHOKQDIbgW,MAAAEAAA....fACAHACCQAFCDAEA.bCCCCAGARBDAGCGAhAHAFBHDdDDDeEEBADGB.hAAAaGDBOEBBKGGD.IEHAhAIA.gFFB...hAIA......hBAA...,1,-7,-22,15
bAZLVaOdePWSNDQUKGHgRYFMJfTXcIEBC,ZAAAaAAA.eACE..SACHQAFCGAEAHCCCRCGBMAHBTFEAhABAXDDD.EDGBhAEACAHBACIBLEBBdGHA.hCAAPFGB.DAIB.......hCBA......hCCA...,2,-13,-10,3
UEDRWMgGKfCSZNTBQLPAJedOHcbYIXaVF,eAAAHAAA....bADBXADAFAFD.EAGARBGFMCABGCCACAHBZCCFhAAATCFALEEBAAAAdCHAOEABhAEA.IFEAhAGAaDHDDEGBKGHBSFHBBHGD.QGFAhBIA....hCAA...,2,-6,-4,2
fSVgPGFEKYWIQZcLJbDUHeCTdBXMAONRa,RAAAaAAA..SADB..gACHGAFAEAHBKAFAICCAhAAAZBFELDDA.hABAbDGDHDEBeBBDdDHAMFAAhAFAAAFBfGGAFGFHYHAAWEDD...hAHA......hAIA...,1,-8,-12,4
UVWZLYeMEDXNIJPgAGQKafbdROBSTCFcH,GAAAaAAA.dADARACFBAEBCAFAHAGBUAGAZDBBLDEB.eDGBhAAAECEBXDFD.hACAJFCAAAIBQGFDhAFA.bFCDTGBA.FFHD.WBBDDGIB.hBAAIHEA..hBAA...,1,8,-36,44
NfEMAcXPYdbBCRZeTGOHLVJaWIQgUKSFD,XAAAdAAACADAZABB.GADAHAEBLAGB..aAFAQDCAhAIAKBGDDAIBEDAAABIBPDHDhBAAbDEDBDGA..REEFeGBEhBGATFBA.ODHD......hAAA......hABA...,2,-21,-2,19
JLEMZdPINYGKVgbCQOWDHAFTfeRacXUBS,TAAARAAA..aADAUACABAGALAFAZBEAdCCA...ICFAhAAAGDFAKDHBVDDBCEDA.QDGAhAGADAIB.HEBBhAHAAAAAeGAASFGDEHGA.MICA..hBEA......hCAA...,1,-3,-28,25
PZbYDVFJKcEUGMWTNCSfeLRdOHBgQaXIA,ZAAADAAAFACDKADCUAGAGAEA...MAHB..TCAASBBDhAEAeBFDRDDBHDDB.QDGBhAGAaDGDADIB.bEBBhAIAVGBAEFGB..NIBB.fFHA..hABA......hACA...,2,-28,1,29
CAdJcEKDFRXWbHMSfGQeTaNZIVOBUYLPg,dAAAEAAAFACDRADA....XAGBHAEAMAIBGCABeCDF.aCFDZCFAhACA.OEABBDHDLEABhAAACEEAABIBKEGA.bEECQGCAhADATGGAIHCAUGGA....hAEA......hAGA...,1,-7,-11,4
ONJIFSMEPGZBbURLecKaQWDVAgHfTYdXC,HAAATAAAdADA.OAFAJACA.FBFB..EAFEZCAABAHBRCGBLEEBhAAAeCCAKCFAQGGAhACA.DBIBACCAfDHAhAAA.CEEASEGD.MFIBhCAA.PHCA.hCCA...,1,-14,-25,11
HACJUGFgKVfQNBIPYaRTeMEXLbSOZWdDc,CAAAGAAAKACA.QADABAEB...IAGAaAFDRBGF.eAHHhAAAECAA.LCDA.hAAAbDFAZCDFdFBAHFECADABFEEHhACAfHABPFHB.MDDBSGFHhADADDIB......hBAA...,2,-30,3,33
QKLJMGBgdZFSHbOPYEaVfWTNUDXIceARC,RAAAQAAALADBGAFAdADAZAEBHAGB.ODBBEAHBaCCBVDFBhAAATEEA..DDDBXEGDhAAAeEEDAAIBKGBAMFAAhABAFGHBSDHB......hAFA......hAIA...,2,-13,-1,12
NUTgSEMPdDRZAKaeWXFJQbGLYIHBVCcfO,eAAAFAAAQADAGADALAFAHAFACCCA.OCCBUDEA..TDAAhADAECGAdEFA.RFDBAAAAaCGDXGAAhAGA.JDHBbFGDhAHABGHA..........hAHA......hBDA...,1,-6,-14,8
RYTIFXPMBQbdCLaGeNcOgKWUJDVHZfSAE,RAAATAAAFADA..MAGBQACC.dAEAaAHBeAGB.OCFDhAAAKCCAUDFBDAIBHDDBhAHAZECBAAAA.EDHF.XFGAhCAAbGFA.CHHD...NBIA.......hCAA......hCCA...,2,-33,4,37
RVJPaQZOgCINXLBScTWbdYMAeUFKDfEGH,eAAAKAAAEACEHADA.RAGF.JAEAaCCB..ZBFECCFD....XDDChAAALCCBSCHHhABATDGAdEEAAAFADEGB.fFHAhAIAPFHDOHAAIHFABGFA..hAAA......hAHA...,1,-8,-28,20
CKfYGHcEVRIMZFeTUdJgbWQLAPaOSXDNB,aAAAXAAABADA.KADAGAEA.HAGDEAFERCDAZCCF.eBBDdAHAJDAAhAAA..bEGBLDHBhABAACIBSDADCEFA.fFFAhADAcFECIGCAMFIBTGAA.hADAgGDDWHEA.hCAA...,1,13,-28,41
VQNSXbUHLROCMgBAdePTEafDIYcZKGWFJ,eAAAEAAADADA..IAEAZADEGAGA.FCBBQAGA.hAAAXBCDHCEBRECBMDIBhAIAAAAAdCEAaCGCfFGAhBCAKEFAVGAASGFDLEHBCGGCBHHA..hBIA......hCAA...,1,-5,-9,4
EIAZXLgDcCFNePMQSfGWdBTOUVKYbaHRJ,ZAAALAAADACAFAEDeADH.MAFAQAGAGBEAdBGBBCCDTCAAhABAOCEE..KCHDaDGEhABAHEFB..EEEBAEEB.hACAXGAACEHA.SFHB.fGFAhAGA..hBIA...,2,-37,-5,32
HEgUJZNPAGdIcQWfaDXMebOLBKFVTRYCS,dAAAQAAAaADA.MADAeAFHLAHBFAHBRCAA.SBDAhAAAHDCCECHFUEGBZBFBABDAGDDAhBCA.IFGAhCAAfGDADEIBOHCCKGHDYFFFCHHA...hCHA......hDAA...,1,-4,-6,2
fDFKLUNIRdTeSMYBCOPEAbWZGgXcJQHaV,ZAAAGAAA..XADBQADAHAFAaAFEDCAALCDAUCFBRDDBdFGAhABAeAHH.MDABCGEAEHAAhACAAAABbDFA...gEEGhACA.cGAB.JFHF..hADA......hAGA...,2,-21,-1,20
WdBDGPZNOgbAVaCKUfXIJHYREcLFQSMTe,aAAAKAAAUACA..XACDHAEAEBHFLAEAFCFD.MAIBeDDBhAAAdCFAGGABZDDBOBBHhAFAAAGACFFA.JDHF.RFFBQGAAhAGASFHBBHEADDDBPHCA..hBAA......hCAA...,1,1,-18,19
VfgTKMBOaQJELHAZCbPUcYRIXSDGNFdeW,ZAAACAAAUACARAEA..SAHBGAEB.dCAAeCBB...VCGBhAAATCDABDDAQCGChABAEEFB.HEACAAHA.hAFAbEFAPFCCIGDADFIBFHGCfGGAhACAMICA......hADA...,1,-12,-13,1
OeaIWSZCLXJbYPcTDUMVNHQKAgEFRGBdf,EAAARAAAdADA..eACAaAFA.SAFAZBEB.LCCAXBGAbCFDhAAA....cDFDhAAATDAA.MAIBHFGBhABAACHBGECAOCCBCEDDPFHDDEIBUGDAQGAChADA.FHEA.BEEChAGA..,1,26,-16,42
BNCUXJbLRVZfaQGgYEcFADeIMWPSKHOdT,eAAAMAAA...SADAHACCdAFATCCACAGAUCCA...bAGDRCFAZEAAhAAA.QEFBhABAGEEAEEHBAAIBDEIBIHGAhAIAKGAABGHDNBBALFDD.....hAEA......hAGA...,2,-21,9,30
JWaVFNLZReDBAPYfGcdUTOHbKXECQgSIM,...fAAAdAAATADAHADAKAFC.EAGEQBGASBCDMCCBhACAaCADFCEDZDAFRDDAeCGBhAAAADDAGEGAOEFDCFFC.gFAAhACA.IHCAWFCH.NEIABHGAhADA.....hADA...,2,-18,14,32
bDZYPGJROgSNXAQBUIfeVLWcHMFaETdKC,QAAABAAAUACA.eACALAFAHAFAaCDAECBB.dCHA..CCFAZCGBhAAAGDAA.RDDBSDGDhAAAAAGA.fFHAhADAcDDAFEBHKHDADDIB...JGEA.OFCDhBCA....hBEA...,1,10,-31,41
PVDaTBEfUYAeJSZOMXFNcWIKdLCQRgHGb,eAAAZAAAMACAFADD......NAFA.IAGAdAGALDDBRBDFHCFAhABAGDFA.bGBCDAIBhBFA.aCCHBFHAEEFBfEHAhCAAAAAAOCCH.WHCACHEA.....hAIA......hBGA...,2,-18,-16,2
YaTgLZKdeJCfQMUWRVPFNBHEScXGADbIO,DAAAOAAA..aABETADAZADB..eAFACAFB..MAHBRCEFFBHDHCCAhAIA.EDFFXEFDhAGAABBBIEHALCCDhBAAdFCAQGFAVGCABGHASEED.hCAA......hCBA...,2,-18,-8,10
DfYAXbWOEHCLIKFBTdRJegcVaQNGPMSUZ,XAAAOAAAHADALADAFAGAdCCA.RCFA.eAGH..VEDAaBHDGCDAhAAAMBBB.ZEAADEHBhAFAACDBEEHBKFCDBGGDTFFAhABA............hAEA......hAFA...,1,-10,-19,9
CNJASFgbXQfPOGYUKVRMBDdWaLIZEeHcT,FAAAXAAAQADA..OADAGAGAKAGARCCBMDABdBDAaCEDZEFAhADAHCGBCFBA.AAAASDCDhAIAbFDD.fFFAhCAA.UGCADGGBIHHAEGHB.hCBAcGBD...hCDA...,1,-9,-14,5
CDOdfIFMGKEUBQSeaWHTgNYPLAcbRXZVJ,RAAAZAAACADB.dAEA.FAGAGAEA.KAGAEBGBBCCAeCAB.HDDA..hABATCGA..gEGAhACA.PFDBhADAAAAAbEDAXFGDDCCBfGHAMGAA.SFFDhBEANIAB..hCBA...,2,-28,-17,11
AWbEVgIBRZYHaPfNSDTLJOKeQMcXCGUFd,EAAAVAAABACA.RADF.HADB.aAFA..fAFBDAIBLBFBhAAAKBHB.eCHBMCCBCDAAGEGAhADAdDDDAAHA..bDFDZFDBhCAA.NDDASGFDOEHFQFCA.hDAA......hDCA...,2,-18,3,21
gPWBMJFIQAHLKYRefNUGCcSVTXbaDZOEd,HAAALAAARADFeAFEUAEAGBFACAGA.SCAA.TFCAhAAAaAHDZCAA.EDFAdCHA.hABAgDDGBDHAMEBBhACAFFGDACCAKEDANIAB.XFGADFIB...OHFChBEA....hCBA...,1,15,-28,43
GPBJbZFTECSdHNVKLgURMOIXQYDcAWafe,aAAAeAAAGACABADAZAEBFAEA...EAGAdAHAHCCBKCEALDHBhBAARCFF.MBBBXEGDhAAAQEBDDBIBACCBfHCBhABAbEEB.SFFDgGCAIHHAhCAAcGGC....hCBA...,1,-2,-21,19
GcRPEQIeUHAXCZSWadFKLBMgbNTDVOYfJ,ZAAAaAAA.dAEALADAMAGB.....bAGDTCAADAIB.OAHBhABAJBBFRDCF.EDDA.eCHHhACAHEABAEFA.SEFAhAEAKEBABFFA.gFEG.YEHBhAFAfFHA....hADA...,2,-27,-2,25
bAQeaXWMIJHcLgfGVDTPUKCFBZdYOERSN,eAAAaAAA.MAEAHACBLBDAGAEBTCEAKAHBBCCDdCHA.EEAARCFASDEDhAAAAAEA.hAHAQEBAXEEAIFHAhAIAgEGADBBBCGHAFHEAOHDA..hBAA......hCAA...,2,-7,-7,0
fgHaIKdSTVADZePCRUYFOLBWcXNGbQEJM,eAAARAAAFADALAGBBADA..XAEDGCCAEBFFMAHBHEFAaCCB.hAAAdGHA.SCHHhAAAAAGBZDDACDHAOFDB..hABAcFECbFFA..fHFB..hAIA......hBIA...,2,-24,-4,20
bcMEfdeGQVJASTWKgYPCFNUaHIDZBROXL,TAAAKAAA....gACBCACBFAEAUCCAHAFAZAGB.RCDALCHBhAAAMBIB.EDGFeCFDhAAAGEAAQFFBhBEAAAEASCCDPGCCaEFHBHHA.....hAHA......hAIA...,2,-13,-11,2
UfTJPOVaDWKReMAbXYZHBINGLQcECFdSg,XAAAHAAABADBGADALAFA.ECABdAFBUCCATCFA.OAHDhAAAaCFAKDFARDAAAADBZEFEQEFBhABAFFDB.fFHAhBGAPHACDGAAMIEAIGGA..hAAA......hACA...,1,3,-15,18
MCLJAZKHbTIFNVWfSUODdRgYBQEGcPeXa,HAAATAAAFADA...VAGBSACB.DAEARCAABCEAEAGAGBDAhAAAeDFFaDHDMBIBLECBhAAAABFBbCFD.IGAAhACAfFHAdGGA.YCCF.PHCAhCAACHEA.....hAGA...,2,-11,0,11
DHaGbLUfQWTOdXSRCFAINJPgMEceBZVYK,JAAAMAAA..EADEeACAZAFB.KAFAHCCBGCCALBHBQCFAhAHATEFAdDHA.RFEAAAIBIFAAhAFA..PBBBhBAABFCDDFEBaFCHfGHAOFHDCHCA.NICB..hAIA......hBAA...,2,-18,2,20
gBHLaXGJCFQRVfYUcKATOWIENSDbZdeMP,TAAAOAAA..EADADACAZAFBdAFA..eAHFMAHBBBBDHBDBaBDEGDBAhAAA.FDGHRDDBVFGBhBAAfFEA.UGGAhAIAACIBIHEANBIA.......hBDA......hBFA...,1,-7,-20,13
fOSdFNaJVceUCGIXDHRMLPWYTAEKBgQZb,EAAABAAAZACBOACA.dAGAaAED..JBCBeAGB.GCFADAIBHBEBhAAAREBAMAIBLDHBhBCAPEHD..TECAhBGAABCBKHAA.QFFASFDAFGEH....hCAA......hCBA...,1,-6,-18,12
eFIYZXTEdDPKcLMJbUOVRfSAQCGNBHgaW,GAAAHAAAaACAeADAFAFAZBFAEAGA..dCDAKCCAMBIBUDFA..RCFBAAABQECAhAAABEAD..hAIAgFCAIGGA.hBIATFGADEIB.PHDC.....hCAA......hCCA...,1,-4,-20,16
FCEaWOcVAbeHXfdYBJgNPKMDSZUGLRTIQ,HAAAdAAABADAJADA.....PAFAMAHBZCAAGBDBRCEBQECBhAAAECBF.aCHDOBHDhACAAAIBeFGBXDDChADA.fDGEgGAADFFBSFHBhACATGGA.CGDA....hBAA...,1,4,-26,30
ZaGQTcUbBIMKJNOVFLESdARCfPWegYDXH,RAAACAAA.....fADBeACADAGAHBDCGAFAQBGChAAAUCCABAHAMCABKCHBODFHhAAALDDBdFAAACCBgFEHhACAXEGD.aDHD.bDADIHHA.hADA.NIBBEGHBSHAAhABA..,2,-13,-10,3
TbEgYdDPOAXfFQSRJNLcHMeUVCWaBGKZI,FAAARAAALADBHACBeAEACAFA.BAHAZAGB...TCEAEDCBdCFCOCGDhAEAAAAA..QEGAhAFASEEDJEEFMCIBhAFA.VGFAaGGC.KGCA.......hBIA......hCAA...,1,-7,-24,17
ZCUdeVGWRaNELTXDKYQfcOMbBAJFSPgIH,SAAA..gAAAHACBZAEAdCFAeADAGDGARAGBECCALCFBhAAATEDAKFAAQDAChABAOHAAMAFAhAAAAAIBFDEB.CDHAVFGBaGGHDBIB......hABA......hCAA...,2,-4,-2,2
EGbaSdgfQXAMPCFUNKeJRZTWDBIOYVHLc,MAAAFAAAKADARACA.ZAFBDAFA..BAHA..OAHDHCCBECHBGBFAhBAA.aBBHdDAA.QEFAhADAACEACDDAUFFBeHBAhBHAJFCF....IHFA....hAFA......hBAA...,1,-23,-29,6
YXPHKfdZJaVNTSOUgMAGeIERFBbCDQLcW,eAAARAAABADBDAEALAFA....cAFDXCCA.HCFAhAAAdBDAaAHDTEGAOCCHhAAAMEFBADFAGDGAhABAEFCAbGAC.QEEA.PFBBfGGEhABA.....hBFA...,2,-21,-2,19
bBgEaJXCDVHcGTfIQYeFPSMdWAKZLNOUR,ZAAALAAAOACARADFBAFB..EAFAaAGDCAHAHCCCGCAA..TCGAhABAQDDBFEFBMEIBhCAAAAIBKCHBUFCA.JHFAhCBADDGB.fEHE.eFCB.dGGAhABA......hACA...,1,-7,-15,8
TSQBIeWJaAYLgbODNZMXCKPUVGdHcfEFR,LAAAOAAAZADBMAEAKAFA.UBEAGCEAHBGD..EBBBRCAATECAhABAQCGA.eDBBhAHAaDHDAAIB...bEEBXGCAhAIACGGA.dFHA.FGFD.....hACA......hCAA...,2,-14,-2,12
ecSdJGBIbFWEaMOLKAUZXTfQNCPRgVHYD,ZAAATAAAQAEA.CAGA.RACFHAEB.eAGBdCAAGCCBhABABAHBbDECEBHF.aDGEMCABhAAALFEAACIBXEADhACAfGHAgEGADIAASEAAFGDAKGHB.hAEA......hDBA...,2,-6,3,9
DEWcMePbFKdYJBVSCZLafAUgXOTGIHNQR,XAAAGAAAHADARADA.EAGE.MCDBeAGHFCEDdCDDBCGACCHAZDAAaCHDAAAA.hADA.UEEAODAH.hAEATEFAQGAAhAGADFIBPGCAbGFA.KHGA.......hAIA......hBIA...,2,-10,4,14
ZGFQSWBfIVXeUDMbJAHcYdKENLgTCaROP,HAAAdAAAEADALADB.TAFARAFAZABBGCEAQCABBCGAfBHAhAAAXDCDeCHHhAGAMCFBAAHAKFHBCDGDaDHDFGFD.hAIASEED.IFAA.DGGAhACA......hAFA...,1,-7,-13,6
FOTJRZdHYVeXWAbEMcDgBQULIKaCPfSNG,EAAAMAAADADABADA.LAFAaAEE.CBBA.SAGHGCDAOCFAhAGARBCBHCEB.eBHHACDB.hAHAbFGBQDFChBAA.KEHBfCBETGGA.dGDA...hBBA......hCAA...,1,-6,-22,16
FYJNWCVUIegcXQKfZdEMASbGDTaBHOLPR,GAAAaAAAHACBLADARAEA.FAHBJBHBCCDAUCGBeBBD....XDEAhAEAQEABZFAAEEDBhAFAAAABDDFBOEHD.hACAPFFBYEEFNIAB.IGGA.KFCBhAEA.MFIB...hAHA...,2,-12,-2,10
ZQLJaeCSMEPVWNfHDbXcTARIGOKFUgYBd,RAAAGAAAFADA.UADABAGAZAFBLCCA..eAHFMAIBEDDB.hAAAVEGB..fCGAhABAHDBBXFEDhAAAAECAKEEAdEHA.QGAA.aGCE.SGGDhAGANICB..hCAA...,2,-27,-3,24
GPKXFJTQDILBVZESHcMAaCYgOeNWdUbRf,aAAACAAA..OACAeACHdAEARAFA.GAGAKBCA.FDDAQCEDhAAALEBBZEFEHDGBAAGB.NCBA.bGDAhAIA....XFEChAGADBBBBHHAEGHFMIBAYHCA...hBAA......hBEA...,1,-6,-13,7
FKaLVdDREGJQcIeZASYbOCTHMPXNUBWgf,SAAAOAAAHADAMADA..XAGBBAGA...fBBEhAFAaAHDdBDAEBFBGCEAhBAAQDEDeBHHACGBbDGDhAAATGFA.PDCDWCCD.KEHBDDIB..hABA......hCAA...,2,-29,4,33
SAQCgFLNRMdcKPIeEVUBWHXDaOJTbGYfZ,QAAAFAAARACF.dADAKAECeAFAEAGABBHAHCDCaBGE..OCDDhBAAbDBC.GCFAZDGBAAFALFFDhAAAMDIB.IHHAhBCAUFDBDFCB.JHFE......hCAA......hCBA...,1,7,-23,30
agFUVESMZDfHCXYQRONebJPILcAGdWTKB,dAAATAAAaADA..FAGAEACE.ZAEBHBDA.CCBA.QAGARCFA.hACAeCCBbEEA.IDGAhAAAADDBGGBBBEAAUGGBMDIBhAEA.XEEC.OECH.PFGDhBIA....hCAA...,2,-11,-8,3
VENXTRYKbaJCgWdDHcUPBfFSAOMLeGIZQ,MAAAeAAAZADB.EAFATADA..RBFAKDBAaAFA..CBBA.dDFDHBFAhAIAUFFABCDD.SDEHhBAAAAAAOEEH.GDGAhBBA.QGEANDIA.....hAIA......hBDA...,1,-10,-27,17
RZVMODSdPNQgLeUTKYBWXaHCIEfGFAJbc,JAAARAAAZADB..MADASAFA.dCCCQAGALCFAeDABhAAATBDABEEA.aEGAhABAHCFA.ECCBGGABhADAAEEAbEFAOFBADFGBPFHBgGGB.hAGAKHEA.....hAIA...,1,-5,-9,4
dWeNCFMagKDPAcRIJQXfbVZGYTEUOHSLB,RAAAQAAA..bADBGACB.EAGEHAFALCDAdCCAeCFAhAAAFCHBaDAADDIBAAHAIEEAhAAAfEEAZFAATFGAhADASEHDBGEACFCAMFGB.KGEB..hABA......hCAA...,2,-17,2,19
eRSHFaBbUWKdDAEIZXCONfcMTGgVPYLJQ,EAAAZAAAOACA..fACAMAGBGCDAVAEALAHBhABA.eEHBHCDAaFBAbCGDhAAAKCCDAAHACDCD..TFFAhBFAgEABJHBA.RFEBBGGB....hAEA......hBIA...,2,-12,-3,9
PQCDOWSYbEUBMJVgfZTAKRHcFLGNedXIa,HAAALAAAeACEdAEAaAFAQAGA.OCAASAHHhAAAECFFBDDAMBGB.gCCAhCAAZDGBAEBARGAAFGEBGDGAhCCAIHHADCFBYEEF....hCDA......hDAA...,2,-12,-12,0
AXCgHNPGVTILcFaRfKEBUSMZQWDedbOJY,CAAAHAAAGACATAEALAEAFAGA..RCAAECEBSAHHZCFB.QCAChAAAeCHFdEADOEEHhAAAAAFAXCEA.gDGHhACAPFHD.IEEAaGGH.BFCAhBCA.MFIBDACA...hCAA...,2,-7,3,10
WDOLeGSabTXBVfJEIZQdAUgPCNRKcHYMF,UAAACAAARACA.HADAFAFA.OAFAGCAA..aBGE..TCDABCDDVDAAhADAEBHF..ZCFFADFA.hBAA..PFEBKDGAMEEBhBCADDIBSGGAXFFAfFCAhCFA......hDAA...,2,-19,-18,1
fgbaFRVTACQXGZEKUDYSPMLJdOHecNWIB,QAAAZAAAEADE.DADASAFBLAGBdBDAHBGBeBFF..hAAAcCAAIEGAfDDAhABAaDCCRFBA.AAHAGEFAhACAKFFD.PFCBMAIBOEHDBEHAbFDD.hBCA......hBFA...,2,-12,7,19
FWXHUIZSLTDVcaRgGdJbNQEABPOeYKfCM,OAAAeAAAKADA..MAEAFAFAHCCAZAFELBBADAIB..aCEARCEAdCHAhBAA.JDBAQDGAhAAAAEGBBFFD.fEEAhABACFHA.XFGCSHFA...hCAA......hCBA...,2,-27,-23,4
CMcVZTbBGKXAIULPdOgHWfQNDEaFJeRYS,LAAAdAAAHADAQAGCEAEAFAGD.RCAACCEAMAIB.ZCAABCHAGCEAhABAADGBUEFBODGD.hACA.fFAAhADAaCCAeEABSFHH.TGDAXGGAhAFA......hAIA...,1,1,-22,23
KJSPDZcFQWHaMBbVegLfdAGNXOECTIYRU,GAAAOAAA.EADACADA...TAFARAEFKAGC.SAHBZCCF.QCDAhAAAHCFBaBBHMBIBhBAAbCGDeDADLFFAhCAAADCBXFDAIHCAUGGADHFA...WHFAhCHABDFB.....hDAA...,1,15,-21,36
fTQKeDJPBLbVCWXdNGMSIUYAcgZERaHOF,ZAAARAAAHADBFADA.QAFAeAFH.DAIBBAHALDAACCAA.dDFAGCDAhABAMDHBUFAAACCBECGA.hACAaEEB..ODHDhAHAKGGD.JFFB..........hCAA......hDDA...,2,-29,-6,23
gCFZLNVUcWeHdOEYfIXQJARPKaSTGBbMD,RAAAaAAAGADABADA.MAFADAFA...FBFAZAFELDAAUCCA.eBHHhAAAHCFAdDFAEDAA..fEHAhABAQEFBACCBSFEDhADA.gGGACFHANHCB.hADA......hBAA...,1,0,-30,30
RCfegFZTVWXDSMYOBaHdUbKQcJNLEGIAP,RAAAeAAAZADB...TADAXAFA.DAIBMAFA.BBFAHCEBbBGDhAAAQDAA.hABANDHAGGABABIBfCCAhCAAFGFB.SDEB.aEEH.dFHA.hAAAKGDD.cGFB.hABA...,2,-14,-6,8
agFBDTfbdYPVLcKUCJOWRMSGEZQeAHIXN,HAAAXAAAaACABAFADADA....TAFAdAHAPCCALAHBhAAAKCFAUEEAOBCDRFAA.GCEAhABAEDHF.eEBBAFAA.hAAAgEGAbGFA.cGDACHBA...hAFA......hBHA...,2,-9,-4,5
CfeLWUIKOQGVNZFDadPJEYbBRXgHMSTAc,CAAAeAAALACAUAEAKAGAGAFA.ZCCAaBCDdBHA...EDABBCGAhAAARECAHEGBMCIB.ADEA.fGFEhAAAOEBAQEFAhABAFHAA.DFEB.JHFA.....hADA......hAEA...,1,-6,-26,20
VEaHLFGJeAUNQKTMgCDfcBRPIdSbOYWXZ,QAAAMAAADAEABAGARACAdAFA...OAHBXBBAZDAAEDDEHBEAhAIAGEFAABBA.KDHBTDFAhBAACFDA...fEBAhBEAIHHA.bEDD.VFGB.aBHD.hAAA......hADA...,2,-17,-11,6
JeHPMaRFKVBQIOYACfNbDdGXZgTSWLUcE,CAAA..bAAAGACA.ZAEATAEALAHBEAGEHCAAaCAB.RCEAKDHBhAAAQCEAOEABACHADEEBhAAAdECASEHBhACAUEEBeFGHMFAA.BFFA.fGAAhAFANIAB.XGDC.hABAWHFA.,2,-22,17,39
AHeIXPbUDgBZEOYLKCTFWSdQaRVGNJMcf,HAAAeAAA.XADBUAEABAGAEAFA.LBDDTBGA.FBHD.dDFARCAAGCEAhAAA.MDIBhACAAAAAbEGDZGDA.KEGBSFEDhAIA.........hAIA......hBIA...,1,1,-30,31
fWICNcTHQOSKEdBMeFDUXLAJPRZgGYVab,RAAAGAAA.aADAbADB....IAGACAFA..TBGAhAAAHCDAQCGChAAAKCCBECFBdEEAeDHFDAIBLEFAhACAAAHAZGFE.gEBA.fGGAhBAA.cFCD.hABA...,2,-22,3,25
XBCcbfMdOVPHRTQaWGNFELIUeSKgZYJAD,BAAACAAA....bACAdACA.OAEAHAGBRCAAaAHDGDCB.EDHFhAAALBEBeEABKFDDZCBEhAAAAACADFFBfCGEhBCA.MDIBTGGAQEFDNIAB.FGGH.hAEASHBA.hAGA...,2,-17,-4,13
IZaPRVGOWXHUbMgQCEdNJcSKTfDALeBYF,eAAAFAAAZACBRADAGAGA..XAEAHCCAbDFDMAHB.QCEChAFAEEAAdFCAJHFAKDHBDDIBhAAAAAIBLEDABEEAaGAB.hABAOFGD.........hAEA......hAGA...,1,3,-24,27
gPXFWEIUBcRNbQDSJKeTYLGfAZadOMCHV,dAAAMAAAHADA.VBGBXACA.EAFABAHB.RCAAQDEChACASAHHeBBBLFAAhADAACFAaDCDCEHAFFGHUDGA.hAFAbEDDDGIBKFAA.TGGA.fHBBhAFA.....hAGA...,2,-11,1,12
dgUTbWGaFJEfBYLIPeVDKXCSMQAOcNHRZ,OAAAHAAARADFdAFAUAEA..TCGAGBCAFAHFEAGABCADLCHBhBAAeCCB.KBBD..SEEAhAAAADGAZEBF.bFEAaEEAhBEA.fFDF.IGGADEIB.hACAMIBA....hBIA...,2,-15,-9,6
ATCFKBWgSMRVfbIcOGNPLDdUHaeYJEZXQ,TAAAKAAABACB..SACBRADF..bAFBOAEA.GBDAhAAALBHBdBFDHDFAhAIAeCCBEEEAZFFAABIBFFCHMCCBhCAAIFGAPHDAaFHD...JHDECHHD..hAAA......hAIA...,1,8,-25,33
VgEPeIWDLbUcZFMBNJRfTGaQCSdYOKXAH,HAAAEAAA.eACEDADALAGBUAFAZCCAMAIBBBCARBDFGDFA.aECAhAAAQEFA.hBHAdFBAKFHBAAIBVFDBIHDAhCAA....cCBC.FGHD..hAAA......hBCA...,1,-4,-23,19
HBMPZDfRNbXCYISQdgULaEeVWKGFOAJcT,TAAAHAAAMACA.ZAEERACF...XBGACAEBSAFHdCCALDFBhAAAEAHB.eDHBKCADGCDAhAAAAEEABFCAfGAAhAGAbCGDQGDBaFHH.FGGA.....hAIA......hCAA...,1,-5,-8,3
CUaYReZBADGbXWcHNPVdTLgMFEfIJOQSK,GAAAXAAAHADA.VBGBdADALAFA.MCFAECDBfDFEhAAAODBAQDFAhAAACAHBaDAHRFAAZFFAAAGAbFDBNIEB.hACATGGA.........hADA......hAFA...,1,2,-9,11
NeWHGPIAOBLXcTVYJdEfgRDbUKSQaFCZM,LAAATAAA.VAEAdACAEAEA..RCAADAIBKAGAQCDAhAAA.aCFEZCEA.eDHHhABAHEAAGEABACIBXEFAhAEAcEEAfGCA.bGECFGEBMFIBhAIAPHAA.BGHA.hCAA...,2,-6,-1,5
aNgUcdJIbEOXRDHAZeCWQPVKFYSMLTGfB,eAAAQAAAKADAFAFAMADA.GAGABBHA.aBDAUCCA.dCFAbCBAhAAA..EDHBRDEFHGBAhAIAAAAAZFDA.CFHA....PHFAhBCASFFE.......hBGA......hBIA...,2,-37,1,38
SaRVNeFGTMQIHJbYKWAOdgBfUPCZEcDXL,dAAABAAAUADAZACAEAFEDAGA..LBFBRCCA..eAHHGCABMCGBhAAAHDGB.JEEFbDADKBHBhACA..AADA.OFDHhBAAfDHACGGD.SEEBNIEB.TGGAhAHAIHBA...hCAA...,1,-11,-30,19
LMeKOgfTQFbJHVAYXZCNGDBcIdaPSWRUE,ZAAAGAAABADBdADA.aAFASAEH.RAGBLCABeAHHOBFBhAAA.TEDAQDDAhABAbDBD.HCFBADDACDHADFGAhACAIFHAUGGAEGEFMCCB.fGAAhACA.FGGH...hBAA...,1,-4,-6,2
RSOHcIXPgYbeVdGDaZfWMQEUBFNLJTCKA,RAAAHAAA.XADB..gADBeAFAGCABZAFBMAIBhAAAEBHFFCFBLCCBTEFAADIBhAAAOCGDIGAAbEDDdFAAhABAaEEHfFHAQFGBBHBACHEA..hAFA......hBHA...,2,-8,14,22
RPNfOBQCWSJgKVHAYDLTMIbUZEeGXdaFc,LAAAMAAAUAEAEAEAGBBAdAHA..aBEERAGB.....fCAAhABAQDEASCCBhACAKDHBHFGBAAIBTDFAhAEAIGEAeDHH.FEDDNEBACEDDgGGAhBHA.DFFB....hCAA...,2,-13,-12,1
WDSgFfdVPReTYMGHZKaJbBALQCUcIENOX,LAAAQAAACAEAUAGAEACA..OAECDCAA.FBHDdCDARCDAeDCBhAAAMCFB.HEFAZDFBKDHBbGACBFEDhAGA..AEAA.IGHAhAHAXEAASHEA..fFHEhABA..hACA...,2,-42,10,52
DZbLUAVcGBdFYHfPSEeTCIRagXMOKQJNW,GAAAdAAAHADASADAEAGE.eAFHTCBARBGF..aCDBMCFAhACAQEABJDAFDDEAZDEEhADAbEDAAAABBEHA.fFFAhAFACAHBXFGDKGHBNIDB.......hACA......hADA...,1,-4,-9,5
UCbKMRfQTdBLNJgWSOGcEZaPIYHDVeFXA,CAAAMAAARACA...TADAdAFALAHB..gAFBhAHAOCABECCBaBBB..IDFAhAAAHCCAeBHH.ADGBbEEChAIAQECBBFCAWEHHGEGA.PHBAhACADGGB.FGFH...hBAA...,1,-8,-14,6
dJEfCcWTAYHQPZUIRLGFaOKSXBVMNDebg,HAAAZAAARAEAGCAAaACAKAFABAHB..MACAeCCAdAHA.ECCBCCFA..hABATDGAACGBQDFBhCAAUFAALEEBSDHHhCEAXGFDDEEBbFFC.......hAAA......hAFA...,2,-19,-1,18
cPWRJOYCZLUbMIKNBXdaATeQHFfVGESDg,eAAAHAAAFADAGADAEAGA.DAFA....gBGAPAHDRCFBOCCBhAAAZCAALCEB.hABAbEGBMDBBKGAAXGFDhAAAAEFBTFGAQGBA.SHDEhBDA....hBFA...,2,-10,-2,8
PIHKLNCRDUXGbAEQBfMgTVJZWedcaFSYO,EAAAQAAABACA.MADA..TAEAZAEEeAHHaAGA.FCDHOBGDhAAAHCFBLDBBhAAARCCA.XFCDACCAfEAAhAEAgFFAVEEAdGCA.SEHHhCAAIHHA.CHHA.DDIB..hBCA...,2,-4,-4,0
WadNOJVHYISETBgbeACRDQKPFZLcfUGMX,RAAAQAAAFADAZAFB.LADAUCCA.GAGA.MCDBaAHDdDHAhAAAOCEBHEDCSDGDhAAAEFCBBGED.eEABAGGAKGHBhABAfFCE.XFED.NDIA.hAEAYHBA..hBHA...,2,-23,6,29
QFcbHeSUfAEVPONaKYZTCGLgMDBdRWIXJ,EAAAOAAAKACA.ZADBGAEALAGB.MAIBdAGBRBGF...XCCChAAAQBBBFEABHEEChAEAeBFFfEEEhBAAADIB.PEGBaFHDCHGD.BEHB.IFBAhBFA.....hCAA...,2,-15,-7,8
LVfCMONgJcGPWBFIUKdaYHXDbZeQAESTR,EAAARAAALADB.CAFA.MADA.OAFEJAHBGCEABBCAFBEHKDCD.hAAAaCBCHEGB.DDIBeCFHhAAAACCA.TEGA.hABAfCHEgFABcGGCIGDAYEEFhAIA....hBCA...,2,-30,-17,13
eDPRYfNVXdHTZOJgBKCaILSAMUQcGEWFb,MAAAQAAAGACBEACAFAGA..eAEARCCB...fAHAhAAAXCEAHDGBZCDAOCHDhAFABBBDaCHFLECAhCAAAEFBcFAAbFGDDFGB.PGCA....hCEA......hCFA...,2,-13,1,14
GOLPHIUSaZDMeNVcTKbfAFYJRdEWgXBCQ,FAAARAAAEADE..XACDQAFCGAEBLAHBHCDCSCGHhAEAZCCAeDFH.VFAATECAhAAAbEEC.AEHAdFHABFHAOHCAhABAIHHAaGGB.MIAA.....hCAA......hCDA...,1,6,-1,7
DdAHGKXQeYSfIMEWFTUOcNJPZVRBCaLgb,HAAAGAAAQADCeADASAGAMAFAEBFAFCDAOBHD.JCAFhAAAZCFBRDDA.aCHDLFFAhACAbEAAAAAB.XCCChCHA.fGDATFGAcFECPHECCHAADIFAhACA......hADA...,1,22,-12,34
VegTIMUdbGRDLAXfPCNacOSWYBKQFEZJH,XAAACAAA..aACASADABAFAQBCCEAGAHCDAeAGHhAAATDAA.UCGAGCEAhAFARFCAAAAA.fCHAhAIA.PEDBOFFAKEHBFGABVGFAMIBADIBAhBIAcGGC...hCAA...,1,6,-14,20
RAIPdXHaCGJgQZWVOeULDfSNFMBYEbKcT,dAAAHAAAGADAQADCZABBOAFAeAFELCCADBGB.SBGDhAAAMBIBEDFBKEHDREEAACABXGGAhACA.aCHDhAIACFBAgGGAWHCA.fHCBhBAA.BFFD.YDDFhBDA.,2,-28,8,36
JPFQVfeTBNDbSGWOEHaLKZMgUIRCcAXdY,dAAAJAAA.QADA.eAFATAEADBIBGCABEAGEHCCAaCFDZCFBhADA.MCIBUFDAREAAADHBXDGDhACAFFEHBGGASGAAhADA..WHFAKGGA.....hAGA......hBAA...,1,-10,-15,5
GKTVOHaLSCZEQWJcUbAFdYMfeRPXgBDNI,dAAAMAAARADA...XACADAGAGBGA.KCBATAFAHCEBLEAAhACAZCCAEBHF..QDGBhAFAJFGFUGCAAADAfEEEhAHA.eFCB.BFHA.IHHAhAIA.aGFD.WBBDhBAA..,2,-23,-2,21
NQHMAZeSEdLOYBcGbRWJVfCPUXIDgaFTK,eAAAEAAAdADALAEABAFAGAGARBCB..VCFACBCC.UECBDCFBFDDBhAAAKEHBHFABZEFE.OFEDhAAA..bFABfGGAhABAXGDCaGGA.......hAFA......hAGA...,1,-9,-19,10
ZRDKSHaLJTBOMGQgCfUXeIFWNAVYdPcbE,dAAA..bAAARADASAGBHAEALAHBBCBAGCAA.QCCBhAAAfCEAeCFFhABAFCGHAADAPEGBZEFAaDCDOEEHhACA.MEIBCGGA.XGAANAIA..hAEA......hAGA...,2,-30,14,44
OPMGVLcNQAKUCJFBTebZXWIHSfgEDaRYd,CAAABAAA.eACAZACA..XAFBHAFAfCAADAIB.RCCAdCHAhAAAMBHBGDFALCCBhAAAQFCAAADAKCEDFEFBWFHHhACASDHH.EGDBaHAA.OHDEhADAcGGA.....hAHA...,2,-28,0,28
HOCZeIcARabFSTEgGLDPUNXMfKBdWQYJV,RAAAaAAAFADA..EADAGAFALAGBDAIB.UCCA..MCCBBBFAdDDAhAAAQDAA.hABAVEFAHDGBZFBEeFEFhAHAAAIBSGHHgGGANICB.KHBA....hBHA......hCAA...,2,-15,-7,8
VRKPfASNGeMZEFXWgYHIdOLCbJcQUTBaD,GAAAeAAAEADAFADA...XAFD..gAFAhAAAHCDAdBHALEFAbCCBQCGAhABATGEAaEDDRDBFfGGBhAAAAAIBMFFAZGAAIGGACHAA...hACA......hAHA...,2,-5,1,6
KLBOfeTIbaAFcgXRMVSHZNDWPYGEUJdCQ,FAAAXAAARACF..MAEAHADAZAFEDAFA...PAHDECEBdCGAQCDBhAAALFFAOGDChBAAeCFHbDABACIB.gEGAhABASHFAYHDA....hADA......hCAA...,2,-24,-7,17
eHaBOCWdDbETfFMcSPZUgAIRLXVJNQKYG,RAAALAAA.XADDVAEAQCCA.GCGAHAFAaCAAhABACAHBdDAAECGAFEFHMDDBhACASFDBZEDBAAHAIFAAhAFAKGHB.eFFA.OHECDGDB...hAAA......hABA...,2,-18,3,21
YWaUgBXARMJGKIbHeVdfEQSOZCTcDFPLN,RAAAGAAAKADCHAFAeADAdCCAEAGA..QCFBZBFETDCAFDHDLDGBhAAA..YECGhAAAaDAHBCDBAAHAMFGBhABAbFEBSGHHCHHA.DDIB.....hCAA......hCEA...,2,-20,5,25
gMUJROaQYVGcFNTCZWfIDLEbBSPAeKXHd,eAAAHAAAdADAMAEARAFAQCABGBCA.FCEDTBEAZCGB.fAHAhAAALFAAEFFBbDGBBEBAhABAADDBKFHB..XGDDhAAAgEEA.OFHD.aGBA..hBEA......hBGA...,2,-6,-1,5
NadFcGEQPHeRKLIUJDXfgYBWSAZCVObMT,ZAAAOAAAMACA..aADDdAGAGAFAEBEAHDDARDBALAHBUDGADAIB.hAFA.XEDA.hABAfBBEBCCDAEBAbFDChBEATEGAFGHB.QGGB.eFBBhBAA......hBDA...,2,-15,-5,10
SLKeYPNRMdCaTIHJVXGEgWfABObUDZFcQ,OAAADAAAZABEFAFA..QADALBFAKCCAeAFA...PBBBhAGARDABdDFA.CBHAaCEEHECBhADA.JEHBGDCA.hAIAEEEE.fEGBAEEABHDA.cGGASGGDhBAAMIDA....hCAA...,1,0,-23,23
HdVNDEQbWcIMaOCBLfSYeTgAPRKXFUGZJ,RAAAFAAAZADBHACBdAGA.DAEA..ECFBQAGA..bDABICFAhBAAaBHD.BDEDLEEAhAAASDGAeEHHACCAhABAXEBAGGBB.VFFA.NIBB....hADA......hAIA...,1,-8,-14,6
NVdgFEUcIQHOLbKWGZXDMPBaeACfSRTJY,SAAARAAA..TAEAJADA.VBGBdAGAEBCF..ICCAhAAAHCEALECBhAAA.bEEAGDAAZGEAMAIBhABAaAGAAADA.fCEENEIA.FEEH.QGFAhABA.KEHBhCAA...,1,-1,-16,15
bBUOVFSTLgdcIEQMZfPRaYeNJXWDHKACG,GAAABAAAOACASADALAGBdAGAECDAZBCARDBA..eBHHJDHB.hAAADDABHEDCAAABCDCDVEEAhACAFFBH....gGCHhAIAQGBAfGGEaEHD...hADA......hAEA...,1,-11,-13,2
ZWLFBTfaCYDRHVgPKeQIJNSAdOMUXcGbE,dAAAMAAAUADAGACBZAFBLBHBBAGB..aAHDDCCBHCCA.PCGBhAFAeDBDQDDChACA.JEGFABBBXEEDhBAAEHCA.FEHD.CFCA.YFFF.hCAA......hCCA...,1,-16,-19,3
BYNPLCZEcODgdIJXeQKSUFfWAMTGRabHV,GAAARAAAHADBBAFA..PADAZAGBECCBDAHBdDAA..XBFDhAAAeCHHQEEAhAAASCDBFFDHAAIBaCHD.bDBDhACAYFHBLEFB.OHFEgFAAhABA......hADA...,1,-4,-7,3
LIcYPEMQgNRSUAVOKBTDJdFWbCfZGaeXH,KAAATAAAdACAFAEA..CACBGADA.eAFAHAGBLCGBhAAAICEA..PCCBhAFAEDDBMDGBQFDAhAGAREBBAAIBBDHADBIB..bFEDaFGE......hCAA......hDAA...,2,-24,-9,15
LfFaQVMXWRUZETACYdGPJBSIOKHgcNebD,dAAAGAAABADAOADAHAEB....NAHA.eAGFLCCBaAHDMCDBhAAARDAFZEDBACEA..CDGAJEBBKFFA.hACA....bEDDFGAHhADAQFFA..WCHH.EGHF.hACA......hBAA...,1,-16,-18,2
UCBSKDgNGLTRYJWMcbeIQPZEXFfHdOAVa,aAAABAAA.DACAGACARADA.JAEAMAHB..eAHHQCBAhAAAECEAFDFDHEBAAAIB.CDHAKFGAhAHALCFB.TFDAhAGA...cGGAIHHA..PDHDhBCA.fDDBhCAAOBBH,1,-21,-39,18
QXWROFcdNaJMGbVHCKgTBLAYZUPSEeIfD,ZAAASAAAEADE.eACHDAFAQBFA.RCAA.FAEAdCHAaAGDhAAAGDEAHBDBKCHBTGGAhABAAAIBPDFD.XFCAhABAOECBNIABbFGD.CHEA......hACA......hAIA...,2,-11,-7,4
BFcXTGPDIUYLbWZHQVEaNfegKSAdROJCM,RAAACAAAFACA..TAEAGAEADAGA..UBGALBHBZCBAHEFAECCAaCEEhAAAeGAA..SDABhABAAAGAdGHAMHEAXEEAhADA...IFHA.YEAFhAEA.WHCANIAB.hAAA...,1,-13,-20,7
TaKRIANHLXgEBUfdCFPSVMGQZYecDObWJ,HAAALAAAEADEBAFBdAEAFAGA..SAGHGBFAZCAAeBHHOCHDhABAbCAA...TEBAhACARCEBAECBXEGAUFFBCEEC.hBEAMEEB.QGGCDGIBaHCA.NIAB...hAAA......hACA...,1,1,-7,8
VXScJDQfTHGeWdOUaFMRYECgPbIBLKNAZ,ZAAASAAADACA.QADAHAEAeAHHdAGAaCCCRCCB...ECFFCCHA.hAAA...bDADLECBhABAAAIBXDGCfEEEhAGAGFDBOHFCMDIBgGEA.hABABEGA.KHAA..hAHA...,2,-12,-1,11
bYPgMXWVELaTNfGZCUFJBQdAcKHDSReIO,HAAARAAAeADEOACA....bAGBgAFAMBEB.XCCAhAAAECCBaCFB..TEFAhAAAGCGAZGDAFEFHBHHAhABAAAIBDFDBSCHHIGAAYFHB.hBIAWFDH....hAGA...,2,-20,-2,18
YPIcXDdFEMNRbUVBgJeLAQWTOCfZGaKHS,TAAACAAAGACA.HAEASACB..ICAADAEAEAGARBDFbCEAhAAABBHA.eCCDAAGAQEAAhACAfCFAaDHDhAEAKDGAPEEBdFBAMFFAVGFAgGGAhAAA......hBFA...,2,-14,5,19
eWLUYAfDHCEcVTJZIQXNaFbOBSRKgPdGM,HAAAEAAA.TAEAZACBQAEA.aAGEbAGB.SCAAhAAARCFAKDEDdCBCGECAeCEBLEAAhACAAEHACFFA.cDGChADAIFHAFFGHBGCA.MBIB.YEEFhAEADHAA....hCAA...,1,1,-10,11
eYZEAaNCJMUfLgBdVTXHcGbQSIFDKPORW,aAAACAAAUACALADA.dAHA..TAEAHCCAGCFAQAGChAAAFEAAKBBDRDDA.eDHHECBBACIBhAIAMEEBBDGB.XEGAhBCAbFAADFFBOHBC..YFFFhCAA......hDAA...,1,9,-26,35
TfgQZLGePUODSMEIKRCXdBWaJbFHVAYcN,...NAAA.TAAA.QACCGAFAeAHBOAEAMBBAEAHFRCCAdEEAhABAaBED.FDHHHCFBAAFB.hACAfDDEZEABUGGADIAAhADAKCHBBECD.bFFA.YHFA.hAEA......hAIA...,1,7,-7,14
eXOQIUDLCcYWARBPESbTNdJKgHfaMGVZF,RAAAEAAA..TAEAdADAKAFAHAGB..aAHDGCCAZCBA.eDABQCFChAAADDIBLEFBhAAACDHA.cFDDAFAASFAAhAFANIAB.JFDAfHGFMFHBFHAA...hAHA......hBCA...,1,6,-20,26
HEgRFWKUGVSPJYAXLcIOMBbNaTZfdQDCe,LAAAOAAABADAaADDZAEBdAFA..DAHBHAGB.RCAAKDFAGCCA.hABASBBDJEEFAAIB.hACAXCGAMDIBbGBCTEFAhAIA..QGGCEFBBFFEH..WHEAhBAA.....hBGA...,1,-10,-19,9
KOXcfCHbeagQRMTIWLFEUVSGJYPNdZBAD,OAAAXAAA..CADAHAEBeADA..aAGDRAGBMBBB..TCDAhAAALCCBECHFSDAAhABAGEDAPDHDZEAEAADAhAIAKGAAbEFAQFFCFFEHUGBA.....hBGA......hBIA...,2,-3,0,3
SATIJFVbXeBWRLZPgDdYOQfMHUNaKECcG,TAAAFAAA..XACDeACERAFF.ZAEADAIBdCFA..QCCAhAAAHDDBaAGAKCHBECHBGEDBhAFAADDB.IGGAhAHAVFAABEHDPDBBOFGBMFIBCHHA.SGEDhBDA.....hAFA...,1,12,-18,30
LQRVMEXdJecGPZAbDagHTKWCFYfNISOUB,aAAAHAAA.TAEACADA.FAGA....fAFASCAABAHAhADARCEAEDCFdCCAeCHHGCFAhAFAAACAbEADKCHB.YEDBhAHAOEEBLGFA.MIFAXFGDhBAA.....hAAA...,2,-25,5,30
NGgIbeQEfAJZBSWMaKXHcFDOCPUdLTVYR,ZAAASAAAaACA.HACBDAFA.CAEA.dBFALAGB..TDDAhABARCEBGEAA.bEGDEAHFhCAAAAAABGCAMCCBXDGAhCBAOEEH.UFFANAIA.eFCF.fHDBhCEA....hCFA...,2,-20,-4,16
AdgIGOMQVWJHaDUZPERSCTfLFcBXebYKN,dAAAGAAAMADAQADA.JAFEHAFCDBIBZCDARBDBTCBA.hAAALCFBBCGBeDADhACAbDGDKFEDAEEAOEFE.hACAaGGA...........hAIA......hBAA...,2,-19,-17,2
KaGdUeEBSTWQILMfPXFZcNVHOYACgDRJb,DAAARAAAKADCdADA.UAFAEAFA..BAHA..TCBAQCCA.hAIAMCFAXCGA.hAAAZDEAVDFAHFBAAFDACFFDbFFAhBAAeFHF..SBBC.LHBAhBFA....hBHA...,1,-16,-26,10
YFVPDNAMeJaESfQXICKGUgZdBOcTLHbRW,eAAAEAAA.QADACACAGADAZAFAdAGAOBHDLCGBHCCA.RDFBFEEHhAAADAGAACCBMFBB.aFHDhABAXFDAKHEA.BDFAhAAA.TGGA.......hAIA......hBFA...,1,-2,-25,23
VaHLAMPIJFgEKGScDOWTefXZBCNURQbdY,MAAAJAAA.FADDEADEGAFA..DAFAOAHFeAHFZBDEBBBACDEA.RDDB.hAFA.dEHA..aCCHHFBBhAHAACIB.IGFAhBAAKDGDSEHH..WHFAXGGC.hBBA......hBFA...,1,-17,-37,20
IHWJEGQBfdFVbKAOYMDTXecgZNPCRLSUa,MAAATAAA..eACAZACBCAEARAFALCCA.UDGAHAFBEECAGDEAhAAABEFC.dBHAFGAAbECBhACAABBB.DEGA..XGGAhAGAgGGA.SHAAaHCE..hAHA......hAIA...,2,-15,-11,4
TUIXceKdHAObaWJQMPGDLYgBSFNfRCZVE,aAAAQAAAGACALAEABACAFAEARAGFZBFE.EDFAUCDA..XEDDhAFAeCHHHEBAABBBODHDhAGAbFDA.MHEADFIB.hAAASHGACHGA.......hAIA......hBEA...,1,-4,-15,11
CbdNBIaRZfQKXgWUPeLcSHJVYAEDMOFGT,EAAAMAAAGACA.CAEA.dAEABAGARAGBZBBBKBHB..XCFDUDFALEABhAAAHDCBJEHBACBBFEDDhAEA..bFFD.aGAAQGGAhAGA.gGCG..hAIA......hBCA...,2,-19,-14,5
SdFabBKeHIMQGCcLVETYPJUZgDANXOWfR,OAAARAAAdADAFAFABADA.HAEBMAIBGBGALCCAEBBB..TDCAhAGAJCGB.ZEFFAAAA.XGBAhAHA..SEEBhBFAaEHD.eEHF.QGCAhCAA......hCGA...,1,-4,-31,27
dVeCIFTYEcLZXMWKOJRaQSHfDNgBAUPbG,UAAAGAAAeADAFADAEAGAZAGB....MBIBOBHDRCBA.QCDAhAAAHDEADDABBBFAACGAdDFACDCDhACA..TECALFHBhAGAKFGAaEADfGGA..gGFGhADA....hAEA...,2,-13,-8,5
feLFTAZacENSWGgYPBMKUXCDIJdbORHVQ,aAAAEAAA....SACAGACA..gAEBBAFAMAHBXAGBhBAADAIBdCCARCFBHDFAhBBAQDAAeEBBTEDAhBEAADIBZEDB.cFGB.YHDAKFADCFCAbFFA.hBIAfHFB.hCAA...,1,-6,-12,6
TGHMSRBJCXDEWdFYLbOeAgZIUaNQVPKfc,ZAAAaAAA.QAEAKADA..TAGAHAGDRCAACBBD.ECEB.dDGDLCDAhADAeEAAAACAUFFAVDGB.hAFA...fECAhAGAMEEBSHGAXEEDDIAAFGHD...hABA......hAEA...,1,-1,-14,13
HVFgJRZecfNEbXaMUdLCGBIKWPOSDAQYT,TAAAHAAAFADA.RAFFZCAAeACE...fAFBEBHF.aAHDdECDhAAAGCCAKDHBOEGBhACAACCBQCFC.gEFAhAAAcFDDNIAB.bFDD.MDBBCHGA.BFHAhAHA.IHHASCCEhAHA..,1,-7,-9,2
FdPSLNKDIGMWABgaYEcVTHUQfbOJXReZC,aAAAEAAA....TACAHACBQAEA.bAGDXAEBhAAARDEBeBBDZEAAdAHALBGDhCAADAIBGEGAACCBBCEDhCBAgGBBcDDCfGEECDHBSFEA.hAEAKFHB.IHFAhDAA...,1,21,-27,48
TZeQfYWLCDJNPKHGabRVMdBXEAcOISFUg,OAAAFAAAUADAZADB..eAFAQAFA..fBHAhAGALBHBDBBBJCCFKCFBHCEBhAIAGEDARDBBdFGAEGDAADBBSDHHhBAA.TGFAWFHH....hBDA......hCAA...,1,-7,-24,17
OCWbFeIEUNSdMgcDBAPVGYTXKRaLZfHQJ,GAAATAAA.RADAZAGBHACB.QAEACCDD.FAGEEDEFUDEAdEADMBIBhAAADCABACHA..PDHBhAAAXEGC.aFCDfEAAhACAOFFH.eGEESGAB.hAEABHGA....hACA...,2,-18,1,19
bDRYILCKMTHNWdFXSVgAaBfPZGcEQUJeO,aAAABAAAZACBEACA.UAFAeAEA..DAIBRBFALDEA.MBBBhAFAHBDBdECASCAAhAAA.ACAAGDFAhACAQFFAbFBACDHAKFHB.WFDHFFHD.....hBFA......hBHA...,1,-12,-20,8
gbMcXLZfSBdFGNKCUOQWVeIJTRaHDAEYP,EAAA..gAAAMADALAHBZADABAGBGBCACBHA.QBEAhAAAeCCAJDEB.REBBHEEAhBCAAAAA.bGEAXDGAhAEAdHBDNEIA.OFAA.IFGA.aGDC.hBEADGIB.....hBHA...,1,12,-20,32
EeFBRTcVfKZgNGdLbAOSWYDUIHCXJMaPQ,SAAADAAAHABCCAEB.MADA..aAFDEAGAeAHBRBCA...TCDAhAIAfBHAZDFB.GCFAhAAAbEGD.ADBAODEHhABA.UFBAIHCAXFGD...hBAA......hCAA...,1,-5,-24,19
MIAJTCZfHFWaPYcDLbVeSNQEGXgdUOKBR,TAAAZAAAHAEA.aAGA....PACADACALCEAeAFAQCCAhAAAECCBGEEAdCFAKDHBhABARDGFABIBCGCAFGHB..cFDAhAGA.SGGA.NIDB...hCAA......hCCA...,1,-11,-14,3
TVAQgSaWRJHZUYNfFXcBILdOCbDMKEPeG,QAAAaAAA.RACAHAFBZACBUAFA..fAHEXCECBAHAhBAAdDAACCDAMDFBECHFeEBBhBBAGDGAAEFA.SFAAhAAAJEHBFFFB.cGEC.....hBEA......hBFA...,1,3,-25,28
BYeKbaMCXcUQDGPdfAITZRgVWLOENFHJS,ZAAARAAA..VAEALADB.EAFAHCCABAHAeAHHaCAA.MDABCCFA.hABAXDFDQDGAhACADDIBdECDACHA..TEEAhAFAOHAAFFCBSGGAKGGA....hAAA......hABA...,2,-15,-12,3
KIVHCUZWYbaEBeAdfDXGFMRQOJcSNLTgP,dAAAXAAAGADARADA.QAFA.OAHFSAGBLDAAhACATCEAKDFAHFAAhADAZDAAbDGDEEHFAAAA.FFDAMAIBhADAcGGC..gEEAIHDACCBAYGCAhAEA.BHHA.hAFADIEA..,1,1,-5,6
fEQLSBCgbPMJKReaIXZWYDUVFHTdAGNcO,GAAAOAAA.EADALAEACAFA...bBBCMAHB.RCDAeCHHhAAAaAHDZCDEDDABFDBDHECAAAFA.hBAAfFGEQDGAhBDABGCDgEEBKGEA.XFCA.hACA......hADA...,2,-13,-4,9
ZgfNRKaDeICYEJSXQLHcMTGdFUAOBWbVP,BAAAVAAA.ZACA.....fAFBRADFaAFAeAHHCAHB..ECCAXCEDhAAAHCEC.MDAAhADAdCHAAADAODHD.bFFDhBGAgEEB.DFHBIGCASGHHhAAAcGDD...hCAA...,2,-31,-8,23
bMDcPFNACEfJQdOTeWUgVaSKLXYRGZIBH,EAAAQAAAdADA.eACAUAFA..aAFDLBCDRBGFZCDF.HDDBhAAAMDAADAIBFEGHADGACDHAOFBBhAAA..TFBAhBFAgFDGKFGAXGEDIHHABHBD..hBHA......hCAA...,2,-18,-6,12
VecYPFTBOAJfLbZWgdKRGCUDIXaHSQEMN,LAAAZAAAdAEARAGBGCAADAEA..aAFEHCFBEBDF.MDDB.eDHHhABAPBHDBEED.AACA.bCABhABAKGAD..CCEAXCFDhACAQGGB.NIBB.cEEC.FFHB..hAIA......hDAA...,2,-25,-1,24
aVUKAgbfXEIYLNTRMOcQGCBSZdHDPFeWJ,...bAAAEAAA.LADARAEA.MAHBQCAAGCBASCHHhAAAHCDAFBHDeEABaDDAKEADhAEAAAAAXEFA.hAFAIGCATEFACFHAdGEADEEBWEHHUGDB..hAIA......hBCA...,2,-9,1,10
fDbVOdYCJNAGeRaQSKXMZHPITEcUWFBgL,RAAAaAAAQADC.KAFCZACB.HAEA.TCFAEAHFUCGBBAHBhAGALCCAbECA.dEEAhAAACBBDACEBeEHBMCIBIGGAhABAFEGDDGIBOHCA......hBAA......hCAA...,2,-13,-13,0
GaMeDPKHXACQIUEbVBfTFSgdLOJRcNZYW,QAAAEAAABACAFAEAdADA.LAFARAGF.ZCDEGBDAeCGHKDBBhAAAHDFAAAGAUFFBVFCBTFGAhAAAOFCD..NCIA.aCCBhAIA.MFFBDEEB.........hBCA......hBDA...,2,-12,-3,9
XQTBDKdLFVOacEUeMAZGRgbHYIPNfCSJW,RAAAHAAA..IAEAfADB.SAFBXAFDTCCAhAAAKAHBdCADLCEAhAAA.ODCCEAHBeDABhABAADIBGEFAbDFAPECBCEHDQFCAFEEHaFHHMHDAhADAYHAANIAB.BHHAhACADIGA...,1,11,-5,16
HWDTdEZaNeACQBLOPUYbIScXgKRMJfVGF,QAAALAAAOADDUADA...IAFAXAFA.RCEAMAIBhAAAVBGBHCAA.TDEAhABAEDBAaEECAAHABEHAhACAbEGB.SFCAKGAA.fFGEhBIAWFHHDGGB......hCAA...,1,-6,-20,14
NSQLZGWJbIVUgAPfYBEXRMdKeDOTHcCFa,...fAAAEAAARACAdAFAeAHBOADAHCCCFAGD...aCGDQBCAhAAAGDAAJEFFbCAD.hAAAUDFAADABBEHAMAIBTGDAhADACECBLEED.IGGA..hACA......hBCA...,1,-1,-13,12
dSIGYQJUFXLEfMBbKZTecDWPROHCgNVAa,dAAAGAAAQADAFADAEAGA.MAGBBBHAZABB..eCDADAHBRDCAHDBBhAAACCHA.VDGBAAIB.aEEBSEFAhBAA.IFBAhBFAUGDBfGAAbFDD.KGGDTGGAhCDA.....hACA...,2,-10,-5,5
BaUOPeTKNJGMSbIVZYREWfCDFQdXHcgAL,aAAAOAAA..eACHTADAKAEAGAGA.MBBBbAFBZBGBECEB.hAEACBBDFCDHdEEDHFCA.hAIAAAIBLFHBBEFDPEHDhBAASGABIFCA.RFDFDGGB...hAGA......hBAA...,1,-5,-10,5
VgBLGXRISECTfZUKQbAcWNJPDYdaeOMFH,...NAAA.DAAA.aABEeAFAFAEA.HBBABAHAGCEA.RCGBEDBBTBDAhAHAZFAAKFHB.ABIB.JCCFhBAAdDDCMCGB.LCHBhCAASGFHCEEAQGGA...hABAWHDG....hCBA...,2,-38,0,38
VSeXRfQBPJLHAYgcKIDFMbOadWUGEZTCN,....gAAAKAAAFACAMAFAOADAdBFAGCCAEAGAZBDATDDAhAAACBHA..SDHBhAAARCGFQEBCBEFALFFAhABAHEGBACCBIHBADIBA.aFEHNIEB..hBHA......hCAA...,1,6,-28,34
PFXcQDWdCMSJRaTBIGYfHgUEAZOKbeVNL,ZAAAKAAAeACELADBFAFA.QAFA.dBHAMAIBRCABBCFDGBCAhAAAHEEAECEEACCBOEHDhABAbCGD...PFABhACADEEASFFD.aGCAIHEAhAFAfGGB....hCAA...,1,-1,-26,25
NMbZcVBfdDSCOYKHFIGAaTPXLUQRJgEeW,aAAATAAALADA.RAGF.EACE.eAEEMBBBZBFABCCAdCCACAHBKCEAHDFAhAAAGEABAEEBUFDBQEEChAEAJHFE.gGEAhAFA.NCIA........hCAA......hCEA...,1,-7,-12,5
aQFEXfYZMcOgPDAVHTUKLJbdINRWBSeGC,HAAATAAALADB.dAFARACFSAEBeAHBaCACFCGDEAGA.fBHAhAAAZDCEMEIBOFBBhAAADCABACEBKCFBJFFBbEEA.hACA....IGAABHGA.QGGBhACA....hAGA...,1,1,-18,19
JQgRcGIYLVNfSHMedOBKWTUbCZFDPAXaE,EAAAQAAARACA.GACBLAFB.VDAASAFEHCGBeAHBhAAAdCDDKBHBUFEAZDAADFIBhADAACGBaDGDJFCB...gEEDhAAA.IGHAfDDBMIAAhADABGGB....hAIA...,2,-7,-5,2
EJIeKQBXHCRPLYUZScAadfWbNOFVgDMTG,dAAA..bAAAFADADAAAGAFA.EAHBeAEABBDDHBFC.RCCALEABhAEAZCCAADHA.aDFDfEEEhACAODHDMEEBhAFATEGAKGGACHEA..UGGB.....hAIA......hBIA...,2,-21,-6,15
YTfJVOXNWMUZEPdFLRgQCScbIGDBaHeAK,TAAAVAAA..OADA..XACBMAHBZBDEEAEA.dAHARDEAQEBAhAAASBEAbCCChAAADAIBHFDBADGAKDHBfEEAhBHANDIAUGFA.LFGB.CGEA..hBEA......hCAA...,1,-2,-5,3
JOaBFKYAScHZdQWVbgEfXDLUITMeGRCNP,HAAAdAAAQADAVAEA.EAFADACA.LAHBTBGA.eCCBRCAACDEA.hACAJCEFBDGDKDGDAEIBZEDA.hAAA..bFGDXFGDhCAAMDIB.PHCA.......hADA......hAIA...,1,-8,-12,4
PJBZACKcWNFeTXDSLdgVEMfbGUQYRIOaH,KAAA..NAAA.eACEDAFALBBAdAFAEAHB..MBDBGBEA.QBGAhABARCFAaCEHHEFCBDBAhACAACCBCGGD.FDDH.TEGAhADA.SGBA.fGEAhAEA.UGGB..hAIA...,2,-24,-13,11
cIODHCfbAWMZRSLaPgVYXNdEFJKTQGUeB,ZAAARAAALADBaACA...VAFAXAEDdCCC.EAGAKCFDGCGAhABAeCHFBEEDOCCBHFAAhAAAbDEB.AEGB...MEEBhAGASEHHgGGAFGGH......hBIA......hCAA...,1,-9,-11,2
HZOYMcVGUADKLgfBNeTbJXRWEPaQICdFS,LAAABAAAeACATAEA..bAFARAGFECAAQCAA.dCDAhAAAHCDAZCFAMEFBGEAAhABAAACAKEGAfDCEhACA.XDGAaGAAFGGAOHACcEFCDGIB.hAGANICB......hAHA...,1,10,-8,18
YWCDEQKSJLUdBFNZfgbTPIcOeVHGARaMX,RAAAaAAAMADA..XACDCAGA..EBDAQAEAKBHB.LAHBhAEAdCFAFCCHZEEAbDDATFDAhBAA.IFHAhBBAeDHB..........hBGA......hBHA...,2,-37,-22,15
ZWUAVFPBXcILCJQHeNGfSTdbORMEgKYDa,FAAAXAAALADA.QBGAHADAeAFEGCCATCEAdEAARCGFEDAAhAAAKCFDDEGAZFFAADDBBFFAhAEACGCA.JFHB..NEEA.SHAAhAFAMIAA........hAHA......hAIA...,2,-20,2,22
BSMFYCPdbefWDgOaXTVKAQcRJZNEUHLGI,RAAAZAAAEADEHAEA.GCAASAFBMAIBCCCDdAHA..eCFFDCCAaCDEhAAATDGA..ADGAQEEAhABANDEALGAAFFGHhABAbEGD...fECAOHBA....hACA......hADA...,2,-17,2,19
BPXeWDHSgLAREOCNfJdUTGYabVIcZFMKQ,EAAACAAA..JACAdADA.GAFA..aAFAbCBC....ICBAhAAAZDGBMDFBBBFAeFAAhAAAHCFCLHAARDCAOEFChAIAfGHAUGGA.......hBCA......hBIA...,1,-4,-35,31
PdTgLaIXcHEKCWMUfZYSbBFQVONAGRJeD,RAAAeAAAdADALAFA..aADD.XAFAHCDCECGECCCDMAIBhAAAZEEASCCDBCEAQDFAhABAOFHDAAAAGFABhAFADEGATGAAgFFG.KDBD.fHEBhAGA...hAGA...,2,-15,-5,10
NegQYJdOGBMZTFKHPVAICLSaEUfRDcWXb,LAAAEAAARACA.DAEA..XAFBeAFAQBDDdBHAGCCBZCABhABATDAAHCFBABIBSEFAhAAAaDEHUGGAfCHEhACAbFCB..gFGA..hADA......hAIA...,1,-5,-13,8
URWedBbZNVXTCMKPFEIQDGAOgafHLYJcS,aAAAHAAALADAJADAUAGARAGF...dCADZBBA...XCEDhAEAMCEBFCFHEDHFQEGAhAAAADDBOFAA...fDCAhACASFFBeFFBBFHANIBB.TGDA.hBIACHHA.IHHADIAA.hAFA...,2,-16,-7,9
GKCAaYTDbWSIQRHFcNfOZMJVdXUegEPBL,aAAATAAA..DADASACBRAEAHBBCFBHD....fAEAhAAAZDEAMEIBdFDAeAFHEFFBhAHALAHBKHGA.ABHBbDDAhAEA.QFFBNIAB.OCCB.hAIA......hBAA...,2,-17,0,17
bNBZIVJfOKQTSAXcHePULFDMYgCGWERda,HAAAeAAALAEAMACACAFAGAGARBCBdCEA..aAHDBBDA.ZCCAIDGAhAAAVEFB..OFCBhAAATFAAAAIB..XGDDhCAAPEHDDFFB.gGCAWFHH.EGGBhABA......hAFA...,1,-7,-15,8
SbBIROQNPdACHEgKZfcVMYTUeGXFWDJLa,HAAAEAAAZACBVAEA..MAFAUCABGBEAFBHDDDDAaBGA..BDFAhAAARCGFQEBAdEHAAAHAKEAA.hACAfFGE.hADA.TGFAeEED.XECD...hAAAWEEGSCBFhBCA...,2,-16,-11,5
OIAfPVLYgUECJWeFSdNKTbDHXcBZMRGaQ,VAAALAAA.UAEAEADE.CAGA...eAFEdCAAKBHBDBGBHCDBBCCAZDEAhABARCGFaDCB..QEBAhACAAEIB..fFCAhAAA.gFFBFFDATGFA.hAIA......hCAA...,1,-20,-26,6
YfMJZaEgNVRACXOBHWbQLTcGPDeIKUdFS,OAAAHAAAQADCLAEAGBBBeAFEKBFAdCGASCAAhAAAMAIBaDEB.ECHF..gEGAhAFARDDAADDABEHAbFFCTGAAhAGADGDBIHHAFFEDfGHA...hACA......hAIA...,1,0,-3,3
BICQZbOFWDKPALgVdSaeYfNUHcJREMXGT,LAAAdAAAeADA...fAEAHAGBRCAAECEBGAFABDGDQEABhACAbCAA.FEEHKAHBhABAAAIB.SDFDhACAaDHDUGGAJFCBMDHB.TEAA.CEDAOFHDhAEA.DGGB.PHAAhAHA...,2,-7,1,8
BRKFJNLeAUCaQWVGPHbdYDXSgfZcOMITE,aAAAQAAAGACAHAEAdADADAFA..SAGEZAFEMCGBECHBRCEAFDHDhAEALDBAABBBUEEBCGHAVFDAhAAA...PHFChBCAYHCA.........hBDA......hCAA...,1,-8,-14,6
gIdQCFVROEUHTAXZcKeGPYMbDaBSWLNJf,ZAAAeAAAGAEAMAEADAIBaACA..BAGALBDA.JCCFICHAhABAdDGAFEBH.RDDBUFGAHEDBAAAAhBEAKCCD...bGAASFHHhBFA.fHBBQGEACGGC.hBHA......hCAA...,1,-10,-18,8
dCabGVDXIKUgHSZWEPANQMFLfBReTOYcJ,MAAALAAARACA.eADHOAFA..JAFAaBBHGBEA.XCAAhABAKBFAHDDAZCGBECHFACAAQGCAhACABECDTFFAhBAAdGGACEHADGDB.IHHA....hBIA......hCAA...,2,-21,-8,13
XIZBAecUMFYGEdQPRTWgbLDHNKOVCaJSf,eAAAMAAAGACBEADAdAGA.RAGF....TCCAbBCAHDDA.OBHDhAAAaCEDSCHHhAFA.XDFDZFFAAEHBFGBAhABAQGAA.gFGADIAA.hAIAKBBDCHHD.....hBGA...,2,-8,1,9
cWBfdCAQRITJSFYZOPMGLbXVKaDeNEHUg,RAAATAAAFADAZAFB..MACAGCCALAGB..XCGDhAAAaBDAeCCBHFEAUEEA.gGBAhAAABAHACGHAACCB.IEHAhAIASFCDOGFE.....hABA......hCAA...,2,-24,-4,20
TALdMWOHPfbeRIKgcFBSEVYZaQDXJNUCG,dAAAMAAAHADA...bABDRACAKAFC.FAHDEAGEZCCAQCEAhADADBBB.XCGAUDGAGECAhBAAAEEBLFAAOFFBhCAAeEGF.IHCABGHASHGGhCEAaFHD......hCFA...,1,12,-24,36
baAIRgWYZTBdQfFcMCHDUNXKPLOeSGJVE,RAAA....gAAAZADBdAGAQDAAFADAMAGBHCCADAIBUDFAhAAAKAHBLDHB.hABAeDBBGFBBEEEAAAAAIGGAhADATGFAfHABCEECNDIA.OFCDhAHASHEG..hBFA...,2,-22,7,29
APOJVZBMWgbReaQcTXKfFdYNDCESGIUHL,OAAAZAAAMACA....bADARAEAeAHH.aCCCTCCA.fAHAhAEAdDFADDIBEECAGCEAhAFAHEGBAFEBPCHDhAHABGCA.QGDCKHAA.FGGA.CBBDSECGhBAA...hABA...,1,9,-19,28
TcIEHNOCZRdfaMJBFUeGbADYSKWPgLVXQ,SAAAKAAA..gACBLADAQBGA.hAAATCCAEAEEHAGBCCEBRDFBaEAAhAAAMCCBFEEHeDDAAAHADEIBhABAPDHD.XEFDIFAAZFCBdHEBBGAAhAGA.....hAEA...,2,-12,-7,5
eEdCgLGUDPIKFaTRXJHfSZMOQWNAbBYcV,BAAAVAAA.EACA.dAFALADBGBDADAHBKAFAFBHD..RCABHDFAhAAAZCEBMDCBQFBAhACA.AAIB.bDFDeFFACEHA.hAAAPHDCaFAB..JHAESGHHOHEA.hAFA......hAHA...,1,3,-15,18
XNaFdZBKWgIfGDJecCAPELOMYbSQVHTUR,EAAAMAAA..SACAHACCRAFF..aAHDZAEBKBBDIAHAGDCAeEEEhAFAABGBLCCB.hAHAbCGDTGGAUEEAFDAAhAAABEHB.fHDFDCIBCGDD.....hADA......hCAA...,2,-14,-3,11
RIaDMHTLNAgBQefEZSKFVXPWCJOUdYGcb,QAAAEAAAZACB.FACEXAEA.CAHA.OAED.dAGAGCEAhAAARDCAaBHDHEFATCGAhAFAACDBeGBAKECAVGFAPHEAhAAAJHAA...........hAHA......hBCA...,1,-6,-14,8
dKFRPXNWEISAJgLGZHVTYBUMaefcDQbOC,LAAAHAAATAEABAEAMAHBeAFH.DAHBQCAB.bCFDhAAAdCAARDCA.XCCAhABA.ECHFAAIBGGABhACAZEAEUEGBaEACOFEBFFHDPHECIHGA..hACA......hAEA...,2,-20,22,42
cdNPeWBMTYSbJUQXfgOaZKFEAHGDILVRC,HAAAGAAALADBRADAdAGA.eAFAMAIBTCFA..bCDCQCABhAAA.fDHAhACAaDAHZEEAEDHBAAFADEEBhBIACFCAPGECBFCASFEH.XGFDhCDA.KHCA..hCFA...,1,-6,-8,2
WAdNTgFGIDbRCYHPJSQVZcKXMBEUeafOL,dAAATAAAGADA.DAFARACFHAEB.SAGAZABBXAGAECABeCGFhAAAaCFD.LEAAhACAACHBFDHD.bEDDCFBAJFDAQFFBhAEA.KGAABGHA.....hAGA......hAHA...,2,-29,10,39
ZUTPKgRaVbBFENWQJMHcdDeSLfICYAOGX,GAAAZAAAUAEAKADARAGB...aAFABCAA.FCCHEBFF.QCGAhAAAHDFAdFDADEBBeCDBLFFAhABACECAAAIBODAH.TFEAhACA..PHFA.....hADA......hBAA...,1,-16,-24,8
aEdHfCgFDXYNZPVOeARUKBcLTMbJWGQIS,RAAABAAALADBMACA...JAFAGAEB.QBCCaBFCHDEACCCChAAADCFB.XCGAhAAAZFGBOGDAAAHAKEDA.bEGDSCGAhABA..EGEA.fHCBhCAA.....hAIA...,2,-25,-13,12
VfSHRgdYWNEcUIKAJLBOZCDTaQPMbFXeG,LAAAZAAADACA.aADDMAFA..FAFAeBDHGBEA..SBFAhABAHCAARCGFdFGDNBIA.EGCAhABA.IHHAABFABDFATFDAhCAA.bFFB.......hACA......hAIA...,1,-13,-29,16
MUYHEQOIAJcBdbZTReCgKPWNGfLSaDFXV,BAAAZAAARAEA.eACAKBHB.....PAFCGCAALCAAaCCCFCFD.hABAMCEAHDGBECHFQECAhACAADEAdEEACEHA.NHAB.DDGBhAAA.XGGAUGGB.......hADA......hAEA...,2,-19,-7,12
CegOIbZGTdRUXLDWEaANVBHFMcPYfQSJK,BAAAHAAAMACA..PACAQAFAKAFA.eBDFOAHDZCFAdEEAhAAARCBALCFBEEHBAAIBFGFDhBHA....fDEAhAAACHHA.bDGD.GECA...hCAA......hCCA...,2,-20,-9,11
CUEDZNTfbWQYdIScOKegMBJHALRXaFPGV,RAAAaAAAGADA.CAFA.EADAZAGB..TAFA..bDAAQCCAhADAdEFA.SAHBhBAAKDHBeFABMFHBHCEAABBBhCAAFFDDPDHDDDAANICB.fEFA.IGGAhCCA.OHCAhCHA..,2,-15,5,20
JYRCaKZgFWNfBdGTQeSMUDVLAXcPbHIEO,XAAA..bAAAHADAEAEA.OAFARAGBKCAAZCEBFBHD..fCDEhAAAGEAAeDDFMCFBhABADAAAACGB...IEGAhAEACDAAaEFDNEHA.dGGA.TGDA....hAIA......hBIA...,2,-13,-9,4
UDXSfFQdTKLEJVAeHPIYcCZgBMWaGbRNO,HAAA..IAAACADBZAEBMAHBGACARCAA.OAEADAIB.fAHAhACAdDGDLECAEBEEACBBhBCAeFGB..cCGDhCAABFHBbGBAUFDA.FFGA.KGGD....hDAA......hDCA...,1,-12,-15,3
ZbLdEOgTJFXANcSfQGeYVWMBKDCHRaIUP,SAAAGAAAeADA..VADAMAHBDAGAHCDA.REAAaCHDUCGAZEFAhAAAdCCAEGBAODAB.hACATEDAXGEAAAAA.hADANIAB.QFGABHHA.CGDDIHBAhBHA......hBIA...,2,-22,12,34
PQADJYKbUVHeCWONESfdZFRTaGLcIBXgM,DAAAKAAAUACAHABCeAEE..OAECEBEFdAHARCDAGCGALDDABAHBhAAAMCCB.ADHAJEGBVFEBhAGA..CFDA..SFHHhBAAFGCB.aGCCIHHA...hCAA......hCBA...,1,-15,-27,12
ULYaQKOHPSGefIFEJWZNgCTRXDdABcbVM,BAAAVAAA.MACALADB..aAEEQAFAHAGBGBCAeBHHhAAAFCFHECFBZEEA.CCBCXGGAhAAAADCBbEEC.KDHBSEHHhAFA.fGGEWECD.NHBB.hAIA......hBHA...,1,-13,-14,1
HQcRTWFfaJISEGAYbLUXegNODMdVKZBCP,LAAAeAAAOADCdAEAZAFBBAGBHCAA.RCGFFDEHaAHD...SEBAhABAAAAAUCCA.XFGAhACADCFBMCGB.CDHAQFAAhAFA.TFGAfGFEEHDA.hCAAYHBA..hAIA...,2,-21,-18,3
VeIZLKMbOgdEPWXFGDSAYQcRUNBfHaTJC,QAAARAAABADBHAEBaACECAGA....eAHHZAEBMAHB.bBFDdCCAhAAA.EDFF..XDAAhAAAGEDAADIBUFFATGAAhABAJDDF.LFHBOEHD.gGFAhAGA......hCAA...,1,-6,-7,1
gCZXIeUALaVbMSTJcNDORWKFPGYHfBEQd,aAAAMAAA...TADAJADADAGA..RAFFFBBBGBBBHCGBBBGAECDBdFAAhAFAZCFE..eDEDAAIBLFDAhAHASEGAOFHDhBAAKGED....fGGACHGD..hBAA......hBBA...,2,-36,-2,34
AVNfSFXOaPYGLReIZQdJcbCWgBMETHKDU,VAAASAAA.OACDaADAGAFA.RBDBZDGBdAEAJAGB.CCHABDEAhAAAEAHBHFEB.DDDBhAAAAAIBFEBA...XEFAhABA.LGAAIHHAbGECMIAAhAIA......hCAA...,1,-12,-23,11
UXWYIDgFaeRSdNEVfbAMLKCGBcPTQOHZJ,MAAALAAAGACBBAEA..TBGAHAFBZCAAUCDBXDFAhABA.IAHAFBBHRDFFdFAAhAFAEEAAbFGDACCA..CEDAQFFChACAOEEH.WEHHDAGA.....hBAA......hBIA...,1,-7,-9,2
HZXBPVadJSeCUATgGDNFfROKcWYLQMIEb,GAAAFAAARACF.KADA.......cAFALAEB.MAGBhAHAECDAHCFAZBGBBECAhAIAaAHFdEEAeDHHAAABTGFAhACADEEBOFED.QGGBIEHAPDCBhADA.....hBAA...,1,-5,-30,25
DGaefCTZFUYJOKQBgRNHbLWIdPSXVAcME,EAAAaAAA...eACATADAZAFBFAHD.UCCAOAFABDAARBFBHCCAhADALDHBdCHASEEBhBAA.ABBBMFHBhBIAGEDBCGFA.KFBA.QGEB...hCAA......hCCA...,1,-14,-15,1
QLHbZaWFDeTCMXNfPOdgKBUYRIAcGVJSE,GAAASAAAEADAHAFAZACBFAEDeCDB.MCFBXAGA..hAAAfCGAdCGABDEARFFAhABAAAABcDGDQGAAhAGAaDAHTGGACEDD.OECBKGDAIHHAhAHALHAADDIB....hCAA...,1,20,-16,36
FbORDVCQWedKIXGNPJLgZEMfBHSATacYU,aAAAUAAA.OADARACFDAEA...QAGAeAFAdCEAKBHBGBDA.hBAAJCGFZDFB.EEDBMDBBhBAAHGCAADCB...YBBFhCAAbFCACGGA...IGHANDIA...hBCA......hBDA...,1,-10,-19,9
SEUdbQNaFeMfJOPCWGIAKTHZgXcLBRVYD,HAAAZAAA.XADBLADBRAFA.DAFAUCABdBFAQCAAFCFH.hAAAeAHFMCHB.ODCDhACACDHAGEEAACIBTFFAhAGABFCASGHBbEDD..NEIA....hABA......hACA...,1,6,-23,29
TCQUJNGSEBDIYZbMAKgHWXFVRPceadOLf,HAAAFAAARACF.eACEdAEALAGBTAGA..QCCAUEDAGGEBhAIAECEADCIB.ZDFBABGBKDHBhBAAXFAA.PEHBhAAAaFFA.CFEC.NIBB.........hBIA......hCAA...,1,5,-23,28
JAHBCaeMWDLTSRIUGVKYcfPdObXFNQZgE,HAAAaAAA.eACEMADALAFBRAFA.GCCAKBBD...fAHAhAAAdCDAbCEDFCGDZEFAEDBAhAIAACCBCCHA.TGEAUGGA.hBAAcGGA.OFCH.....hBDA......hBEA...,1,10,-22,32
dGNcbQWCZEHXAfUOKDPLRBTaFeJgMSYVI,OAAADAAARABABAEBFADD....eAFAMAGBSBBD..hAFAIAHAGCEAbCGBhAGAQCDAZGDA.HCGBhBAAADDAKGGCTFDA.aDCH.JFHB.YFFBhCAANIBB....hCBA...,1,-11,-30,19
eMbFYEQKRWJgPScAXVZCGHUaNTIdfBLDO,ZAAAHAAAaACATAEA.dAGALAFADACAeBHHMCCB.FCGAECCARDDA.hABAJDEB..SEGAhAGAADGBCEHAUGFA.IGDAhAHABHHB.bFFC...YHEGWEDD..hCAA......hCBA...,2,-15,-14,1
RGLbVTOJPCgXANWBZFcdEYMKQIfaHeSUD,BAAAZAAAdAEAEACAMAGBKAEA...QCAA..aAGAHCGBhABAeBGFDAIBRCAAGDEAhAAALDDBbDGDTFFA.hACAOFHDCCECACIB.FHAAIHHASEBA.hCAA......hCBA...,2,-24,1,25
BOaRVgSWIKQLHZTEdcXAYUebNPfJMGCDF,eAAA..bAAA..fADAGAEAFAGAaAEDRCAASCGAhAAA.KEADHAGBEEDBdEHAhABAAAAAUDDAJFFBDGBAOCCHhAGA.gDGAIHCA.ZGBA.TGGAhAIA.....hACA...,1,-2,-10,8
WYQLGDcINbRUKECSAZgBJdTVFaeMXfOPH,ZAAABAAAdAEAFACAeAGB..MAFAOCABHBDCQDDAGBGADBCBhAAA..IEBAhABARDDBEFGBABIB.TDFA.aAHFhACAfGBA.WFHHLFHB.hBGAbGCACGEA.SGGFhADA..,1,4,-28,32
ICcYJbREQVTaUFOSPAgGXLKNMdZWBHDef,GAAALAAAMADAZADBHAFAeAFA.CCAA.JBHBECFB..QCDAhAAA.aDBDOCCHhABAACGBKEFAdFDADCHBfEEAhACA.IFGAcFGD.YFHBhAHA......hAIA...,1,-12,-24,12
bcTSEVMGZUYIaKPAeOBFfWXdNJDQCgRHL,eAAAFAAA..XACDdAEADAGAQBCARAEA.HBFBbCDATEAAhAEAEBHBGEEA..hAAAZCGBIEHAaEEBAAHAfFFEhAFA.JFHBCGHA......hBAA......hBIA...,1,-11,-14,3
XbTSaAEBJFYGNPZKMLUOCdWIDgRHfcQeV,EAAAFAAAGACAZACBLAFACAEA.dCBCDAGAHCFA.QECAhAAAeBFAXCGATFFAADFBBEAAhAEANEIA..MHAAOEDChBAAIHEAREGF..fGBA.hAGAcGEA...hAHA...,1,-2,-23,21
ebOZcQJDagSVRLIdXNWFUKPYTCHGEABfM,MAAAeAAAZADB.QAFAaACE..SAEHRCEFdBHA.XAGAhAGAFDBBKEGATGEAhAAAHCCAABBBbCFD.ODHFhAHADGGA.LEEDIHHAWHCG...hABA......hAIA...,1,-7,-20,13
KMYFUTAPJcReCGWNXOZISHQLgdEBVabfD,JAAARAAAeADEGADA..XAGBZAFAHCFALCCAECCBBDAAaBHDDAGAhADAKDFA..MEFBFEBAAAAAhBEACEGA.OEEB.QFGAhCAAdGGAfHCB.....hCDA......hCEA...,1,-14,-15,1
KSFObXECUWIefMPgAZBVGTNYHQDRLJcad,ZAAAGAAA..TAEAHADARAGFLAGBaCDCdDGDFEEBOCAB.ECCBhABACFAAUFGA.eFCBhAAAMAIBAAFA.BCED.VEEAhACA.QGCADDAB.KFHB.XEADhADA.fHEBhAEA.,2,-11,-11,0
DLXOSCcBKaWgbTfUQeRYEVdGZAPJFNIHM,FAAAHAAAMADALADB.SAFABAGAaAHD...bBFATBCAhBAAQCAB.RDEAEEHFhAAAGBEAAAFAJFDBDDHBCGFA.hACAKEBA.fFGE.eEED.dGCAhBEA.NEIA.IHHAhAIA...,2,-13,-4,9
VRGeAIOWKZaPDHLEQbcCMfJNBUYgTdXFS,OAAAZAAAaACA.HADALAFAEAGE..QCCCCCCD.MBBBhAFAfCEABCFAgCGHhAIAdCGASDHHhABAREEBAEIBKFCAbECAJHFEUGAA.TGDA.FGGA.hBAA......hCAA...,2,-5,-5,0
eEgGBJRITFUNXCAbcMadYWLQSKHDfPOVZ,MAAAdAAALADAKADAHAFBDAHB..OAHFeBHHECBAGBBA.RDEBFDHHhAFAXCEAABBB.aDDChACAQGEB.hAEAfHABZECABEHATFAACEDD.bGFA.hAHA......hBAA...,2,-11,-10,1
EASWMbeTZdcDFKGaXCgYJHOLPRNVBQUfI,MAAAeAAAdAEAFADDGAFACAGA..JBCBHBBBLCGBRDEBBAHAUEBBhAAAECHF..AAFB..SEDDhAHATFEAZGAAKEHBaEEGhABAXGGC..OEHD...hBAA......hBBA...,1,-16,-17,1
THCZYOBfKDNXWdMgRAaFQbEGVcJeLUPIS,aAAAQAAAGACA.JACEeAEA.LBHBUAGA.SBBDhAEAHBEBZDCFBDHADCFAXDFBhAFAdEEDRFGBAECBEGBBVEDB.hAAAIFHACHDA.fGGE.NIAB.hAIA......hBAA...,1,-6,-12,6
LTXIZcJEfASROdWaQYKNHGMVeBPFgUDbC,RAAAdAAAQADCKADAHAFBGCAB.eAHBFAFADAIBLEEATCEAhAAAZFAAECCBADFB..OEHDhACAaCGDMDIBBECAgEEGhABAbGEC.XGCA.JHFA..hCAA......hCGA...,2,-11,0,11
aJCIBNfGEDgMLFZWKcXTUbYQVdPOHRSAe,eAAAaAAA.CADA.BADAGAEAEAFA...MAHBZBBAKAHB..TCCAhAAAUCFAQDAAhADAdDGDHFFAAAGB.JDDFIHHAhABADDIBLFFB.FFAHWEED....hAIA......hBIA...,2,-20,-17,3
QUfPKRdLANODGTJXZIVWeSMEFHbBYgcaC,DAAAGAAA.JADAZABE.VAFAeAGH.ECDAHCCA.BCHA..hADAgDCGaDFDUECBKEHBhAFARDGBAAABOFDE.hAIATGAAXGGCSGHH.MAIBhACA......hAGA...,2,-24,-15,9
dGWBTCAEKIDfLabFRXOHMNgYPZUcQVJSe,EAAADAAALADAFACD.RAGFHBBAMAEA....NAIA.PCEDZBDBQBFAhAAASCHHeDFBhCAAGEAABEHDAAEAfEGEhAIAaFFHOHCC.gGDA.cGGChBAA....hBBA...,1,-14,-16,2
TYgeAJGVKCEXFNWDZaOdIbMQPLUSRfBHc,GAAACAAAFACA.DADAZAEBdAGA..MAHBLBFD.RDBFHDDBTCBAhAAAeBHHAAIB.KEHBEDFFXGDAhAAA.aGGBbECDhBCA.QEGA.SEEDhBGABHHA.gGGGhCAANIAB...,1,1,-29,30
EbHOIMfTAWSDPdVFYgXQRCBcJeaZLNUGK,DAAAdAAAFADA..XABARAFFBAHB...eAEAZCAELCHBhACAGBGAECCBHDEAMCEBACEB.SCFDhAEA.PFAAhAFAgFGGQFFCCHDA.aGCD.NEIA.hAIA......hBAA...,1,-11,-28,17
YMSRAbZEaIcBgXCdeLWTDfJKOQPUNFVHG,EAAAaAAABADA..CACAeADHLAFADAFAKAHBQCCA.UCFAhADAFBFBHCGBGFDBMCCBhAAAAAGA.ZEDAIHDAhBAAXGDA.dGHAfGHA.OBBBhCAA.....hCAA...,2,-22,-13,9
CQWJZEYLBODUXcegGMTHFSNVRIbfPdKaA,QAAAZAAAEADELAFBDADAUAGA..eAHBGBDAHCAASDBBhAAARDFAbECB.dDGAAFCBCFFDhABAJFBFOFHB..hACAXFEDMIAA.FGGA.NIDB.....hBCA......hBDA...,2,-17,5,22
MPLGZYeaJOCFVgHbRWBQANKEfcdDSUTXI,EAAAdAAASADAUADA..TAFAMAGBGCABeAHH.aAHBCBCCFDDAhAAAHDEARDFF.QEAChACAADIBKFHB.DBIBIHAAhAHAZFCBOEHD.gGFBBHFA..hADA......hAEA...,2,-21,1,22
fabYJdCcAgPGBTQVLNDMSXROFIeWZUHEK,GAAATAAA.LADAMACA.RAGFFCDA.eCHHZADEHAGB.ECCBhAAAaDDCbCEDdEAD.AAABBEFAhACAQDGBDFIBOGDAhAEAIGGAKHGA.fECE...hAFA......hAIA...,2,-11,-2,9
bGfUcZXIYQBVgaMWFLNHAEePdTKJORDSC,EAAAeAAAdADAKADA.RAFF.CAFAGAGA.UDBAZCCAXCGD.hAAAQECABBCCaDEAMDIBhAFALFABHEEAAAAATFFAhAFADGGB.SAHB...hAIA......hBIA...,2,-23,-12,11
JPfCAVBIYgGdMZQeUORXWTNFSbaEDHcLK,BAAA..gAAAdACAZADBeAFARADATBGAFBHD...aAGAHCEBhAAALCCAKCBDJEGBCDAAAAAAhADA...IEEAhAEAGGABMEIBQDGB.XFGAhCDASGDEEGFB....hAGA...,2,-22,3,25
ZEJSQFCXHMOTKLNGBfWcYgaedPARDVUIb,RAAADAAAUADAZABE..EAFAQAFA.FCCHHBFC.MCCBTDFAhAAALDAB.GDDAhADAfEDA.hAFA.cDGCaBHDeEHFAAIBbGFACFFDKHBABFGD..hBAA......hCAA...,2,-16,-14,2
JNGBVdaRDUOKEXcILPWbASefCMgZHFYQT,eAAAMAAAHACCQADAJAFA.GAGAdCCARCFA.OCCBKEDA.EDEA.hAIAXEDCLEHBbFGBhAAAABBBCFCDZGAAFFGB..TGEAhABA.BAFAaGCEDICA.....hAIA......hBIA...,1,7,-19,26
egDQCSGdJLbafUOBcETVRMHYXAKZINWPF,ZAAA..IAAA..PADAeACAQAFAGAGAdCAAbCCAhABAaBHDOCAA.hACAECEBRECAHFGBADAAKDDDFDGHhACACGBASGDALFCABFHA.cGGChADAMDIBNIABDHBA....hAIA...,1,3,-11,14
aIGCQJbKVMcFHZOUgLRBXAPDSeNfEYTdW,SAAAeAAAEADAdAGA..aACDGBEA.QCCAbADD.hAAAMAIBHAFAZEFBOCGDhABALGBAREEBAAHADCIBfHGFhAAATFAACFCB.KGDB.FGHB....hAFA......hCAA...,2,-7,0,7
dXfYLSBRNFQEaDAbVUWCJePcOTKHMgGZI,UAAACAAA.eADAOACAHAGBGAFAdCDA..XDAALAHBRDFBFFCDhADAEBCBACEB...bDBChAAAJFHB....TEGAhBDAMFFB.ZFBB.fFDASGBDQGGBhBFA.aFEDhBHAWFDH.,2,-21,3,24
AYObMGHcJaRLFTDNgUSEIQWKedZfCBXVP,OAAAGAAAHADA.aAFARADATBGADAIBUCDBEBBB..QCGChAAAeCEFZDFEBAHBXEEChACAADDBMEABLFHBhADAFFGASGAHKGDDCGGA.PGDA...hBAA......hBCA...,2,-7,0,7
cIdGXQgBTEDNMKefAYaRHFLJZWPObCVSU,RAAAHAAALADBZADBOAFCCAFA.UCABdAHAGCEA..QCFAhAAATEGA.EEEBMCCBhAAAeDHHACGBFFABJFCBbGFAhACASGGA.IHBABHAAKHDAaHDA.hADA......hAHA...,2,-13,-2,11
MJLVZRdCQBgYefNGSWXbcFAKPaIEDTUHO,aAAAEAAADADAHACB.MAEALAGB.RBCAdDBAQBECBDEA.eAHFhBAAGEFAXDEAhBBAFDHDAAIBKEDDTFGA.OCHDhBGAZGBACHHA.YFFF.....hAAA......hBCA...,1,8,-21,29
KAWbYaBLGFfUDQeNgOJCPVdcMISTHRXEZ,...bAAAaAAA.GACAFAEADAAAeAEA.OAHDCAHAdCCD..MCFAhAHATCEAHDEAEDGFADGABEBAhBEALEABUFGAQFFBhAEA.gGCA...hCAA......hCBA...,1,0,-28,28
SdKMcfNeZAJHEIGVBDPURObWFgTQLCXYa,HAAAEAAAGACADACARAEA.OAEAFBHD..QCCALBEBXBGAhAAAaCEE.dDGAMEFAhAAAfCBEeFAAAAHAIFFAhAFABFFDbGEAWHBGCFHAKHFA......hAIA......hBCA...,1,-11,-13,2
gaDYRfEOCATXQJPNISbLVWZUKGFBHceMd,TAAAQAAA.JACE..IADALAGBZAEBGCDAHAGBeCAAhAAAdDCCaBFBRDEAEECBAAIBXDGAhAAASDHHbFFB.hCAAUGFABGCAMIAADICA.OGBCCHHA...hCDA......hCGA...,1,12,-6,18
bFUcRZeHWLCJEVXGdfgAOSBMaTIPDKNYQ,BAAAaAAA...TACADADAKAFA..QAECFBBHRCEAHDBCLAGBhAAAEDHF.GCAAhACAdAHAAEGBMFCBIDDA.hBAAPDFBbFFA.ZEGBCHHD.XGCA..hAIA......hBIA...,1,-15,-17,2
acRgPdHCFYWbGUJOMfTEDSABZIeQVXLNK,ZAAAeAAAQAEALAEAaAHDRAGB..dCAAHBCAFCCH...bCFDGDFAhABAODEBMDIBEDHBAAAAhAFABEDA.IHEAhACAXGAAKHGAgGGA.YFDFhAGA.....hADA...,2,-17,12,29
MDXNVaEFTIKZLfBOJGeQRUPHgYdWbcACS,MAAAXAAA..aACEEADAFAFA..TAFAZBBALBFABAHBGCDAhAAARDDAHDGBdCFDbGDAACDBDCIBhABA.VDAB.fEHEhADA.eFFB.....hAIA......hBAA...,2,-21,1,22
SURBbEDFLCdJcOegWNIZVXGfKAMQYHTPa,MAAAHAAAaACARACA.EAFALAFB.dAHAOAHDeBBB...gCCAhAAAIDDAZDFEhBAAGCFAAFCAQFGAhBHATFAASEEDBGFDFHDC.CEHAWFCB..hAFA......hBHA...,1,-7,-11,4
eCYQUZDcHaOAEKFBgbIWPSfGLRTMJdXVN,EAAABAAA...IACASACA.GAEARADFMAFAdAGB.XBGDhAAAeBFAQDDBhAAAZCCFHDABADABFCHDbEGBfEGEhBGALFFB.TGDA.NCCACFFDDICAaGHDhCAA......hCBA...,1,6,-20,26
fIUSVbDCLEAeWOQRBFZGPXTMgKYHdJNca,eAAAQAAARADAZAGBGCCA..TACAMBIB.KAECHEABdAHANBGAhAAAaCFB.UFFA.SGEDhAAAbCDDLDHBhBHAACCB.BFCD.XGGC....hCAA......hCFA...,1,-2,-20,18
dfPbHQMKTWYULAFOJNaVXRIGeDgEBZScC,OAAAaAAA.RADAGAGAeACHEAEA..ZCCACAGAdCEA....bDFDhAEAHCGBMBBBTEAAhAEAUFCAAAIBFEDH.VFFBDDIBSGABhAGAfGCE.KGHB.....hAIA......hBAA...,1,-8,-11,3
JFdUSWgNGLPCbEQXVBIfeDMAYcKZaRTHO,KAAARAAAHADBFACA.dAFBUAFA..SAHH..gCCAhAAAGBFALDAAhAAACAHAECHF.QFEChABABDFAeEEBACCBZEGBOEHDNIDB.XFBA.fGGEhBFA..hCAA...,2,-37,3,40
UgDeOfLWIYSNTPGRBcFMdEZHACaJXQVbK,aAAAQAAA.KACADADA.eAEALAEB.IAGAhAAASAHHTCGARBBAFCEDEDCBhAIAHDFBABIB.XGCAhBAAbEEBOEHDfFHA.....hCAA......hCDA...,2,-18,-18,0
dSgTVKIOMZPeBYbXNFDfJcCLAHaGRUEWQ,HAAARAAAEADE.dADA.TAFAKAFC..MAIBeAHHBBGA..bCACFCCAhAAADCFBJCFFLEDAhAAA.ADIBGEGAQFFBhABASFAAIHDAZGDA.PHACYFHBhCAA.....hACA...,1,7,-25,32
aSLEXGORJWYZeVMQgCKHdINDATFUcfBbP,TAAAFAAAUADA.BAFAaACA..LAFAGAGARDBAJBDF..ZDFFeCCDhAAA.MCFACEHAHFEBhAIAdDGADDIBACCB...bFDDhAGA.EFFB...OHAA....hAHA......hCAA...,1,-6,-33,27
LQZNWGMaUVRHKJEBIdeCPgDSYFbOTXfcA,ZAAAGAAAaACA.RADAHAGBKAFA.ECDBdAHA..eCFBCCCD.DDABFCEATFEAhAAA..XDEChABAAAIBLEHBQEGAhAFAMGAA.JFFFBHFAIHDA....hCAA......hCBA...,2,-31,0,31
ONALdPaJeCMQFBcXKRTEVSbWGYIDZUfgH,dAAAaAAA.eADA.MAHBQADA.BAFAKBFBECBASAGHhADAGDDADAIBZCCAfCHAhAIAHEABAADALFGBhACACEEDXEGA.RGDA........hBAA......hBCA...,1,-17,-18,1
LRgAMHJSYfDFNPKUWQeCIaOZXdbGcBTVE,HAAASAAADACAFAEDKADAUAGA..eAFECCCA.aBEEZDEA.dFDAGCCAhAAABFFA.ECGA.RDABACCBhABAMDIBJDHB..fEFAhADA.NIAB.QGBA.IHGAhAAAXFDD.cGGChAIA.,2,-30,-16,14
KWbaGgJZNIMEBXFYQcHOVUTePdRSCDLfA,KAAAaAAAGACAZACB..MAFAEAEABAGAFBEA.QCEAHBGBOCABhAAATCGAdDEARECBDAIBABIB.hACA..bEAB.gEEGhAEAIFGAXGEDYEHB....hCBA......hCCA...,2,-22,1,23
OWQXHDGgAUZbCBdFPTYKeVSNRcJaMEIfL,ZAAABAAAdAEAFACA..TAGAeAEH..SAGARCAA..aCEEhABAEBCBLDHB.hAAAQEBAHCFAGEEAhAGAAACAbEEBCEHAKGHB.NHAB.MIAA.OGAChAGADICA.gGGGhAIA...,1,-10,-18,8
BOCYAJIZLfabQTWNPXMVHKFUGScdeDERg,ZAAAaAAA.QAEA..TADA.PAFAMAHBHCAAhABAFBBHGCEAdDEAEDGBRCGBODABhADAAACALEAA.bGBAhAEAXDCDKFGDSFHHeFHFBGCA.CGFA.hBAA......hBIA...,1,3,-8,11
XCHFERPSADVMadWTIfbKULYBeZcNJgQOG,MAAAdAAA..TADA..bABALAFBeAFAZBFEJAHB.QCBAhACAGCCAHEFARDDFADABaDGEhADAfFAA.hAHAKFEDBFCDcGADOFFAFGHBEHEADGGBIHHAhBAA....hBCA...,1,11,-15,26
LIJPcKSbCMfGWAHageVQBYDOXUNFTZREd,HAAAeAAAQADADACAOAEC.UAGAFBHDRCCAECCB.LDFA.hAAAJEDBKDFA.bEECMFBBhAAAGGABAFFA..aFGDBFCBhAGA.XFGA.NIEB.....hAHA......hAIA...,1,-11,-15,4
JEMLGSgQdRUIVYcWXKeaPAZBNOTFfHbCD,ZAAAOAAAFADAHAFBDAEA.EAHBGAGA.QBBBRCAAUDFB.VCEBhAIA....cECAhABAKEBAeDHHACAATGFAhACAbFBAMFGB.SBEC.IHHAhBAAWDHH....hBIA...,2,-16,-14,2
PXKUfeTMSCIYNZgBOJWGLdAVRbHFQcDaE,RAAAHAAAQADCaACAEAFA.KAFC..eAHFMAIBCCCA....ICEAhAAAZCCAOBGDGCFAhAFAAAAAFEEHDCIBUGGASEEDhCAA.YFHBBEHALFCB.hCCA......hDAA...,2,-16,-9,7
gcZabKDXIYFUSNHLfJTVMBPRdeWGOQCEA,ZAAAaAAA.DACA..XACDFAEDUAGA..HAEALDDATCFABDHAhABARDDBeBBDGFDBQEAChAEAACCB.bFGBKGBAhBGASAHBJHFE.MHCA....hAGA......hBAA...,2,-33,0,33
QNLWdBaUGXcSTJZPRCIVEeHDFbAMYfKgO,MAAAKAAAQACCLAEAdBBABAEBGCEA.SAHHhAFAZAFBRCDBCAHAECHBHDCB.bEGDAEGA.hAAA...fFCAhCAAOGACaCGCXFFA.....hAGA......hBAA...,1,-6,-25,19
aVXZRCNPGWefLFUgSOMdYKJcHbETDAIBQ,QAAAaAAAZACB.RACA.CAEAGAFAeAFELCEAFAHF.UDAAOBBBhBAAdEEAKDHBHDEBEFCAACEBBDHAhCAA..XGBChAAAPFHB.fFHEMHDA.cGEDhADA......hAIA...,1,-8,-14,6
VYeWJdOZHTRUQGEISgDXFACfMLNcPBKba,MAAALAAA...PAEAbABA..aAFAeAHFdBFAHCCBRBCAGCAAhABAEBHF.SCFHhACADDIBACCBCEFA.fDHAhCAABFCDKFED.VEDBJFHFOHECZGFE....hAIA......hBAA...,2,-14,11,25
KASVNDQFLaRBePOYHdfgWEXcUGJZITMCb,SAAADAAALADARACFBAEBeAGH..OBBBHAFBdBHA..fCDAhAEAECEBXEEAhAAAGCEAZEGBMFIBKCHBAAIBQEGDhAFAaHAA.YDCF..hBAA......hBCA...,1,-9,-20,11
SZWBPbgMUVXDcOHAICYKeEdQaNRLGFJTf,CAAAeAAAdACA.QADARAEA.GAGATCDAZCCABAHB..bDFDhAAAMCBBXFBADCGAHDFAhAAAAAGBKEEDEFABaFHDLFFAhAEAfHFBSHDA....hAFA......hBCA...,2,-20,5,25
SAZMXdIYUDERgeOCWFbPVTGKfBNaHQJLc,ZAAAdAAAUADARAEA..eAHHCAFA.FCAA..VBGBGCFA.BCEDhABAHCACLDAAAAHA.hACAMDIBXDECDEEBEFAAhACAOEHD.bFDAKGHD.aFFH.JHAASHFAhBAA...hADA...,1,-7,-23,16
APbCBgJEWYVeRQaFGLHOSNTcUdMZDKIfX,CAAABAAA.EACAVACARAEA..FBHDHAFB.SAHB.TCAAhAAAdCAAZCCA.KDGDXDDAhACAAAHA.bDGDgECAhAAAJFAA.eEHFaGEB.GGCB.hAFALFAB..hACA...,1,-5,-20,15
IKEZRYdCgPWGDNfObQaMLSJXFcBeUTHAV,KAAARAAAdADACACB.......gAFAGADAfAFBhAAAQCGAaAHDMCCB.LDDBhAAAXCFDBDFDhABAeCCBHFABADHAEEHFZFFAPFBBDHFANIDB.SFDAhAHA.FGFD..hBFA...,2,-21,5,26
bRQYaDPEMFSOJfLdHCXWBNeKcUZVTIAGg,GAAARAAAQADCaADADAGA..EAFEFBFDOAHDLBHBHCDCCCDABDCDhAAAeCCDKDGA.ZEEATEEAhACAAAAA..bGCAMFHBhBAAfGGEdGEDWHCG......hBCA......hBDA...,2,-22,6,28
aXgfELCWDGbPQVdSOcZKMUeRJNIAHBYFT,HAAAFAAA.aACAXACDEAFA.LAEADAIBGBGAQCEAhAFAdCCAOCFHZCGBMDDBREDBIFAAhAAAAAIBTGAA.CEED.hAGAbGFASEHHKGCB.eGDA.BHHAhBAA......hCAA...,1,3,-6,9
XfeDGFVBNcTaRQOMWUAHdSZLEJCPgbIYK,HAAAZAAAEADECADB......bAEDKAFCeAGBGBGABAHBTCAAhABARCAAMCIBAAIBdCEA.LDDDhACAgECAXEFDhCAAFEGB.NEIA.aFED..WGCGSGHBhAAA......hACA...,2,-13,-4,9
dYEVUNKHDSOBIZTaWCQXRLGgbFAPfceJM,...fAAAeAAAdAEAEAGAUADAHBCBOAFCZCFBaBHD.QEBChAAARCAAGCEBbEEAAEEAJEHBhABAMEIB..VFDBhAGADGGBBHAA.IHCA.CHHD...hAAA......hACA...,1,3,-17,20
COPGAFNgaYJHRSUeVXQIMbELcDWBKTfZd,FAAAaAAAHACBRACF.eAEAQAEC.MAHBEAHFLCFAhAEA.DBBBKCFBZDEAdEDAOEHDhAFAAAIBNCIA.gFFDhBAASFEHXGCAbGACBGGA....hAGA......hBAA...,2,-30,7,37
RGSAaeWVTdQPZEKLNcFUgODBfCHXIJbMY,eAAATAAAdAEA.ZAFBEACELBDD.FAHDOAEABDGAHEDChAAAXBDA.JAHBMCCBhABARDDBACCB.aDHDQDGBhAAA.KFGDcGGADFIBCGCA......hCAA......hCBA...,2,-16,-13,3
MbfcHUICNZGSTWQgDKBaEFPYeXJLRVdAO,MAAA..bAAAHACCCAEAGAFATAGAQCAAKBBDBCDDECFBFAHFeCDFhAAALDHB.REEBAAFAhAIAfDHAUGCAIHHAhBAAZEEFSEAD.DFIB.aFDD.hCAAXGGD..hABA...,1,-2,-6,4
MLVRWDKBFYTUPJcEXIHNAeOQGZSfbCgad,eAAAGAAAZADBSADACAFA.dAGAMAHBRCDAKCHBFCFB..TECAhAAAUEEB..JDBBEEABHFGBhAAAAADAQEGChACA.bFEDaCHD.WBAABGBA.....hABA......hAIA...,2,-27,2,29
EaSfCGdWePTMYABKDbIJVUNOgLXcHFQZR,DAAAJAAA.UADA..OADALAGBHAGBZBBBEBDF..aCHDCCEAdDGDhAIA..eDDBMCCBAAIBKDFDhBAAVEEB..XFBAhBBAQGBARFGBSGFDfGHA..hBAA......hBGA...,2,-20,-20,0
DFHgLIUGNCTOdcABJZaYVPKRfbWEeQSMX,ZAAAaAAA...VAEARACF....bAEBEBHFeAGFMCAB..FBHDHCCChABALECAGDFATEGAhAIAdEHAAAHABFEDJGEA.hBAAYEAB........hACA......hADA...,1,-13,-14,1
IOMJHVKECTXABRUaQPgSZDbdYFcLeNWGf,RAAAaAAAQADC..SACHZAFBdBHAFCCHeAEAGEDAOAHDhAEAHFABECDACFCCAAAABCFAhAFAUFFADBBB...bDEAhBAA.LFFA.fHBBMFIB.hAFA......hAIA...,1,-6,-14,8
aGVbJQKFeXTDZfUcYdMSIOBREgLACHNWP,HAAA..PAAAGADAJADBQAFA.eBHHTAFAhAFAZCAAfDFAhAAAUCFBdEDAMAIBOEHDEEHFACCBCFAAaFDBhACAKFFBDGIBSFGDBHAA.LHBAhADA.WHFG...hAHA...,1,22,-27,49
CZOLdKcFRHGVPASTBbNJYEDUgWeafIQXM,TAAABAAAJACA..EACEDAFA..UAEA.eAHBaAGE..QCBAhAAAMCCBZDCBdEEAFCFAHDDBhBCAGGEB.ACHBSGBDhAAAbFGB..gGEA.hAIA......hBGA...,1,-11,-28,17
RPaKMUFAeGQgDdLVYBCOfHNbEcISZJXWT,eAAAGAAAQADAdADALAFABAFAOCDEHAGBECCB.SDFBhAAAZCGBXDBDREDBaDHDhABAMDIBAAIBDGGACEEAbGAAIHHAhCAA..TGEAKHEA.FHGE...hCBA......hCDA...,2,-4,-1,3
YKEDZQAJUSCOdgBNeIcRGPVfHLWMTXFab,SAAAdAAABADAeAEHRACFGAEA..VAGBHAGDLCCBhACAMCIBTEAAFDAA.bDFDEDGBhADAZEDFADIB..UFEAOGAEhAAA.IHHAfGAAaHEEDIAAQGGChAGA....hAIA...,1,19,-16,35
JcdfPVAMHBEeKNbIOFQLgaSTDUWYXGZCR,HAAAEAAAKACA..bADBFAEALAGB.aBFBTBGA.DCCAUCABhAAA.XDCDhACAZDDAREGFdFCAfDHAhAIAAAHAeFFD.OEEDSGDH.....hBIA......hCDA...,1,-8,-23,15
TcOJIZfFYRHMASBKgCaeQdUbNDPELGVWX,KAAAaAAA.eACEdADAUAFADAFA..LBDAGDBA...XBGDhAAATDDAOAHFZCCAFEEHHGEChAIAABBBBDGA.QFFAhBAANEIA.EGDB...WFHH..hBDA......hBFA...,1,-17,-20,3
HOLcIZFRPEAaNCUfVgdYXSTbQGeJKWDMB,aAAACAAAUACA..VADAdAFA....SAHBTBGAGCCAhADAKCBD.MBBBHBGBLEFAhAGAZDDAREBBAEIB.fGDAhAHA.XGEDeFDEDFHBBGGA..hAIA......hBAA...,1,-10,-26,16
OIFCWbETZcRKBgSPaDHGQNdefVAUMXYJL,MAAAXAAALAEAFADA.CBBA...EAGAZBDARBCFBBHASAHHhAFADCFBHDFBGDDA.dDHAhAGAeDHBADDBUGFAOEDDhAAA.bGAC.KGHD........hABA......hAGA...,2,-19,-12,7
dMLPeYaKbfUHWTOGJcBRSQNFCEZVgXDIA,dAAAMAAAeADAKADA.UBGAHAFB..OCAEGBBABCEARDEBQDGAhAFACEAA.EAHBZECAXECDhAIAAAHALEGBaGGA.hBAA..bGCC.........hBBA......hCAA...,2,-27,-5,22
WcENVYGbKSBXJDIdfgUaeQHLFATPROCMZ,RAAAMAAAZADB..EAFAVADAGBGA..SAGBBCCCDAIBdCFCUCBAhAIA.eBHHHDAAABBAOCFDhBAACEED..cFGChAAAbDDBKEHB...XFFC.IHHAhCAA....hDAA...,2,-19,-19,0
RgdBAPUOMISQHKENfeXYWZbFLcCGJaTVD,OAAAMAAA..QADAHADAEAGEeBBBXAFAZCFALDDBhAFA.GGEBaBBBTCCAhAGADCGAdFFBAAIBIDFAhBAANIAB.fCHA.bEEC.CFHARGCEhCAA.BGGD...hAIA...,2,-4,0,4
NAKEBLPbISeYgJMFdXVaTfCHWQRUDZOcG,EAAALAAA..bACAeADH.JAFAdAGA.aBHDTCAAHCCARDABZBFAhABAGDFAADEABDFASEEDhAAAMDHB.XGBAhADACEEDQGFCOEHDNEIA.KHEA....hAEA......hAIA...,1,6,-16,22
XbEHJFDgZaNSOTLRcKGUMfdeQBAYVCPIW,CAAA..IAAA..bACAHACADACAZAFBaAEAOAGDLBHBRCAAGCEAhACAMCCB.eCHHhAIAACHB.PECBEDDBFEGHSFHHhBIAKFEB.dGGCBGHA....hAAA......hAIA...,2,-32,11,43
IPQZFMJKOEaeHdbcfVCUTNLYDXgBWSRAG,GAAAQAAAZADAMAEAOACC..EAHFHAFBdCDA...bCDDfCFEhAAACAHAUEAATDGAhAAALDHB.XEFChACABDCBRFEAACIBFGGHaGHD.eHAA....hAEA......hAFA...,2,-8,1,9
OgfEKBIGeZYMNTQWDULbSRcHACXaFJVdP,aAAAFAAAdADA..OACDEAFABAHAGAEAZCCA.MAHB..TCGAhAFAQDGB.DAIBhAEAbDBCREBAHFFA.AAGBCHHAhBAAXEFD.PFCA.KEHBeBBDhBEAWGCG.....hCAA...,1,-7,-21,14
MRZPDVBOFQNTUEJWGdcHKXLIAbagfeSCY,aAAAeAAA.CADA.RACFZAEBDAFA.BAGA..QBEAUCGA.EAHFGEAAhAEAHCCBLDHBhAAAAAIB.bEFBSBBDhBAAMFFB.OECATGCAdFFA.XGDBhCAAIHHAfHGFhCEA..,1,-11,-18,7
UOJSAQIVRdZTfEMDNFWBePHCLcXgYaGbK,QAAARAAAZADB.EACAMAGB.FAHBeAEAHCEBLBHB.hAAAXCDAaCCBGDAAhABAbCFDODCBACIBdEHATGFAhADADEEBBFAACHDA.gFGA.KHCA.hBFA......hCAA...,1,1,-9,10
YPbdJNFVELXKCUaDcMWIQRgZBOAGTfHeS,GAAAHAAAeACESADA..bAFBdAGAFAHDECDALCCAhAAACCHAaDAH.MDHBQDEAhAAARECAZGEAADIB.TFGA.hCAAfDCE.PGBA.NIABKGEAhACADFIB......hADA...,2,-5,-3,2
WZTYeXbNMcaOHfULKICGJPVBRQgdSEFDA,ZAAAeAAA..XADBMAEAOAHDHAFALCABCBCA.GCDBhABAPBEAREEAdCHA.EFHFhACAAAAATCDANCCA.aDFDhCAAKHAAVFGB.BDHDSGGDDFEB..hAHA......hAIA...,1,5,-18,23
SdCRJKTNaIPUYbAQDOXZFMGWEBgLVHecf,QAAAXAAAZACBGACBBAEA.LAGBHAFBeAHBSCDAhAAARDEBKDGA.aCHDUGGAAAIBFDAAhADAEECBVEEA.dFAACHFCNIABhAAAIGCA.PFHD....hAFA......hCAA...,1,2,-7,9
cJVRfEACSTFLDeWBPQYIGZOabUNKgXHMd,TAAALAAA.eADHBACBQAFAGADAaAFAUCAA.KAHBHBFBhAAAdDEA.VEGBEDGAAEIBFCCHhAIADFAAPFBAZFAEOFGBhABAbFED...XGDAMBIB....hACA......hAFA...,1,9,-6,15
FaHVObKDXJfGYSBTCdULAWIcReNQMPZgE,..IAAARAAAeADEMAHBZACA..EAFEHBDAOAHDDAIB..fCCEhAAAGCCABCFAdDFAADIBhABANDAA.QFGAhAGAFDHHbEFD.KFED..YFEDCHEA...WHAAhADA.....hCAA...,1,-9,-14,5
VUcTCXbSfIYKODFdHaPZWBELgAeNRQJMG,RAAAMAAAGADAUAEACAFA.....SAGAIAHA.OBBAhAHAdCGAHDAAZCCAECGAAAAAeDFDhADAQEEB.cEGDhBAAbFAAKEHB.aGDDBGHA.NIDB....hAFA......hCAA...,2,-14,-10,4
TRXCcYHQLGbJZdMPgOVWUSBIKDFAENefa,EAAAeAAA..aACDRADACAGBHAEAGCCAZCBAdAHA.MCGBOAHD.UEFAhAAABDHADEABADFBTEAAhAAA..XFDDhABAQECCbEADPHFCgFFA.SGADhAEAFCFC.fHDBhAGA,1,-1,-17,16
gfSNTAZaVbFGOXYEWILCHJQeKBcDPUdRM,aAAAFAAAGACA.OAEAEADALAGB.HBDCeAHFBBBDhADADBFBdDGDRDDBMAIBSEBBhBAAAEHAbFGB.XEDAhBEAIGBAQGCAKGEA.PFHB.hBAAfGFA.hBGA...,2,-14,-5,9
XZeCDdTQfIaRgJPLSNGEFYOVbUMcBHAKW,XAAAeAAAdAEAQAGA..aADARBCB.PAGBLDFAhAAAGBCAEEBBOEEBhABAUEEAMAIBHFGBAAAAZEBFTGAAhAGAfEHA.IHAASGCHhBEAFGHDYHDG.hBIA...,2,-2,1,3
FdIHXNBMSZEUJPbaKgVCeDWYRcOGQTfAL,dAAAHAAABADAZADBEAFAUAFA..JAHB..aBHDKCAD..CCBA.eCCDhAAADCEB.RCFBGEEA.hACA.TDFAADIBFFCHIGHAhACAMDAB..bDCD.....gFFAhADA.YFBFhAIA,2,-37,-15,22
fRTOFVJcMZLBWGADKEgYeHbQXdPNaISCU,EAAAeAAAHACAQADAdAFA..aAHBCAFARAGFTCDAFCCB..VDEAhAAAMBIBZFGBLDGBhAAA.GEAAACIBKEDD.bFEBhAEANIAB.SCCD.fGHAhCAA......hCBA...,1,5,-16,21
ZCKXaLDeGbMQSYFHAcBTWEfUNVPIORdgJ,TAAAEAAAUADA....VADAOAFCRAGFdCADZCBA.KCFALDDAhAAAeCHHGEFAMCIBQFDAhACAFHAAAEFB.BFGAhADA.fGAAIHHA.CGHAaHEE..hAGA......hAIA...,1,-5,-21,16
TDeafPOAHdcYZUMVRXNJBLQFgIKEbSCWG,HAAAdAAAZABBMACARADA.JAFBLAGB.QCEAFAHBKBDBECCBCDCA.hAEAGDFA.eDHBhAAAaCHDOEEBACIB.UFGAhAIANEEABHGA.........hBAA......hBIA...,1,-14,-20,6
NBDFUeJVHSGKcMaEPYAWOLRTfbgZIXdCQ,LAAARAAA.TAEAbADBZAFB..dAGAQDCCDAIBFCAAeCEBhABAHCGBGDCAMAIBEEFBhAAAADIBOEAB.IEGAhACACFBDBFHAJHBA..KFHB.aGDD...hABA......hBFA...,1,-4,-11,7
UNdMHTAEPLeVZOfBICcDbKFJaYGSgXRWQ,EAAAeAAAZACBBADA.CAFA.DAFA.FAHD..aAGDGBEA.XDGAhAAARCCAQDFA.hBCAdEHAHEBAAAAALFAAhAFAfFGAIHHAbGBA.KEEDSGFDhBEA.....hAIA...,1,-7,-29,22
NBAdGPJgSUECHQXTcRbfLOeKYZIFMVDWa,GAAAJAAA.SADAEADEHAFB.QAGA.TCDAhAAARCCAbDFALFAAeCFGZEAAMEFAhACADAIBaEECAADAdFFAPFGDhAFACDCDfGAA.KHGAFHAANIBB.BHDAhAHA......hBAA...,1,21,-11,32
YOLZIFRNfcaQPMEVKDJeTUdAbHCSWgBXG,HAAASAAABADBGAEALADAZAGBRAGF...fCAEhAAAaCCAMCFBEDDBDBIBeCCB.hAAAdEEDAAEAbDFDCEHA..XGAAhACAOCHDFGHDQGGA.KHEA.hABA......hAIA...,1,5,-16,21
CdEDcNVATFWMPIagKHefSBYROLQXZbUJG,TAAAMAAA..aACEHACB.eAEABAFARBFALDEAZAGBUCCAGEDBhAFAECABDDIB..cEAChAAAABBBFFCH...IFDAhACAfFHAOFFBQGEB..hBAA......hBIA...,1,5,-28,33
fQGbPOFXWKcBDYLAICgMJeTRdSZaHUNVE,CAAAMAAA..eACARACAZAFBHAFAUCCBECAAGCGAOCDB..FEFHKCFDhAAADAIBAACA..JCHBdFAAaECHhAHA..VFCB..hAFAbEFD...PEEBWFHH.BHCA..hAIA......hCAA...,1,-14,-17,3
DIEQgScMFYeKWBRCVOLAZJTPXUfHGNabd,ZAAATAAAUAEA.HAGDaACA.dCAA..EAFAQDDA.SCHHhABAMAIBeBDBBCCDhACARCFBOCCBADGB.XFAChAAAGEBAbFEADBHBgFCH.hADAFEHDWFHHCFFD...hAFA...,1,-3,-13,10
WOTcSKVIXfDZPLNCUbQGMaEgHRYFedAJB,BAAATAAAKACA....XACBZAEBLAHBCAEAUAGAGCAAhAAAECCBHCEARCCBeCFH.ABHB.hACAODHD.SECAhAAAfEGADEGBbGBAaFFHFFHDdGBA.WHEAhBGA......hBIA...,2,-13,-12,1
GEWSYDbeHOKAfcLVCURgMQFadXBJZTPNI,LAAACAAARACA.MAEAaAFA.dBEABBFAZBFB....TCAA.hAAA.ICAAEBHFSCCBhABAbCCC.HECChACAAAIBVCGBQFGA.FGFHXECAhACANIAB.YFEB.hAIADGGA..,1,-2,-31,29
cfeRJGObTQNVZHXPgFKEUSaWdBYDICLMA,eAAARAAAGADAOADCQAFAZAGBHCCA..XCGAFDHDEECBaEEAhAAAdDAADCCBLFABAAAAJDFF.hADATGGA.NICB.gFAAhAFAKFFD.SDDDBGCD.CEHDMIAAhAIA.fGHAhBHA.,1,9,-14,23
VRZMBFKIHNGUeEdYLCQPcfTSDgJAWOXab,XAAAaAAA.RADA.ZACBBAGBKAEAHAGB.GCEAEBHFdCDDLECBhAGAQDAA.fDFAhAAATEGADBBBAADAODHDhABAMIAAFGGHIGCA.eEED.hAIACGGASHEGhAIA...,2,-19,-6,13
eaWGKTZScPNMAXLDIVFQJRCEdbgOBHfYU,LAAADAAAFACD.RADFEAFEdAEA..OAGBHCAAUCFA.eDHHGCGAhAHAZFDASAHBhABA..PDDBhAIAAEEBIHDAQFEACHHA.bEBD.BHHA.hACAaBBH.....hCAA...,1,-7,-22,15
HKARSJDdWFIOVNeCEMgbcUQXBYZaLTPfG,RAAADAAAdADAFACD..OAFAeAEA...EBFBMAIB....bCCChAAAQCDABBHAaDFE.hABATCFAGGBBHEAAhAEAAEEBSEGAIEHACFFAgFFG.hAFA......hBAA...,1,-11,-32,21
CATDMacdSFHNIKXUfOBYJbZVeEWQGLgPR,MAAAdAAAHADAKADA.XAGBUAFA..BAHAJCBBZCFA..EBBBGDCAhACALDDAREEFABIBaEHHhADAFCHD....fECEhBAAOFAB.bFDD...eFFAgGGGhAFACGHA.DGCB..hBAA...,2,-23,-2,21
QKCDJeMGfFAdgTVWaORPIBNHUSLZYXEcb,dAAATAAAaADA..RAFF.BACBHBDBLAEAZCBB.EBHFQDGAhACADCCAeCDAGDEBAAHA.hBAAVFAAOEFB.IGGAhBCASFFAYHCA....hBDA......hBIA...,2,-15,-12,3
DYPMXKAJHQaELUVGdCZcNgWfTFISOeRbB,HAAAEAAALADAGADAZAFA...gCAATBGASBCDhAAARCFADAGA.MCEBAACAaDDHhAAAdDFACEGA.cEAA.hCAAfDHAOEHDeFEFbFCDBAHB.XFGAhAEAKGCB.JFAF.hCGA...,2,-3,8,11
QOdXRGLBNbCYfAeTZScKWHPJgVFDEUIaM,eAAAZAAAKADCHADA.JAHBFAFD.EAHBUCDB.MCCBdCAARCCA.GCGAhABALEEABEEAbFAA.hACA.CGDA.AAAA..TGEAhAFASFGD..PHACDFIB.aGGA.hAIA......hCCA...,1,0,-28,28
KcXHTaZDNRfSgFQYGedbWEJBUOMPACVLI,LAAAKAAAHACBZAEARADF..SAFBQCACeAHBdCFAECHFBCAAhABAMAFAACCBCCFD..VDGBhACAXEDC.aEGEfDDEhAIAFGGA.bFED......hCAA......hCHA...,2,-21,-8,13
FLAPNVdDbSQJKXeHUIECaBTfRcOYgMGZW,VAAAdAAASADA.KAGAHADB.EAFAaCAETBGA.RDAAODFBhAAAMCEAZCFELEHBhADAADDADEAAQEEBhACAeFAACGDAfGFA..gEGHhADA.GGAB.hAFAFGHDNIAB.bEAA,1,-1,-2,1
aRZQUdTfNOMEIVPGKeAcLFbCYHgDXBSWJ,LAAACAAAHACADAEASADH.aAFARAGBZCAA.dCEA.TEFAhAAAOAHD.EBFBVGCAhACAGCAA.ACABbDDB.hAIAXDFABGHA.QFFC.fGBAhABAMIFA.IHHAhACA,1,-1,-28,27
cEQaBgVNTKIFAeObdXDWMULRSGZPJfYHC,eAAAdAAADADAMAEARAEA.ZAFE..JBDFHBCB.ECFAQCFAhACABCHAVEBBKCBB..AAAAXEEAhBEALAHBGFEBhBAAfEHACEHA.aGHD.......hBCA......hDAA...,1,-2,-30,28
cTbLBMXPOSVQaHdDWRGeZCKfIJgYENUFA,TAAALAAA.MAEAOACA..QBDAHAFAdCCARCFAeAHFhABAZCDBKEGAICAAJFEBEGGAhAAAFCCH.ABGBBDFA.hAHASCHHaDBBDIAA.GFCB.fFHAhACA.YHFAhCFA.,1,-3,-25,22
GJTdCLcVPBSUINDXYHKZaOfFAeWMQEbRg,eAAAMAAA.EADARACAGAFAdAGALBFD..PBBBSBHHhAAAUDDADAIBHCCB.aEFEFDHBhAFAACCBQGDAhABAJFGF.TGGACECCBHAA.......hAIA......hCAA...,1,-4,-23,19
VRcSJQAIENDZPbdgWOFGLUeaCXHYMKTBf,EAAAZAAAdAEA.OAGBGACALAHBeAEAaAHDHCAAKCBD.BDEARCEA.hAAASEBAAAEADDIB.hBCA.bEEAFEFD.CEHAMHCAhABATFCA..fGHAcGEB..IHBAhBHA...hACA...,1,-3,-22,19
HMJBeRPXfbVCgDAKIFQTONGaZWLSUdcEY,FAAATAAAGACA.ZAEALACBdCFA.EAEAHDGBMAHBeEDFRCEB.hAAAXFAAVEAADAIBAAFAQGGBhAHAaDHD.hAEA.SEED.cGBD.BGFAhBGA.fHGFhCAA.CHED,2,-16,-12,4
MBRQYKdTXaWZgfPcVIeHbEUDJGNSACOLF,LAAAMAAARACA.QAEAdAFA.aAGEZAGB...fBBEhBAAPCAA.VDDAHCFChABAEDHFDCEB.GEAAhACAABIBFECHKFGDTEFA.WDDDIHHAeEHH..hCAA......hCEA...,1,6,-19,25
ZCJOBWPTQcEVXdFMAKSNYIDabGULHeRfg,SAAA..IAAAaACDGAEAHACARAGBZDDFOAEABDGDhAAATBGAEEAA.dCAAAAEBKEHBhABADCCBbDDAeFFHCDHAJFCAhACAQGAA..XGGAFHGE.MIAAhAIA.....hAGA...,1,-3,-8,5
PgTALWaOeCGIZSYFJcHDVEdQfXbBNKUMR,aAAAeAAAGACAZADBFAFDHAEA.DAGAEAHBdCGAQCGD..hAAAbEABKDBAREDA..TFGAhAEAABDBLEEACGDD.SFDDhABA.cFGD....hAIA......hCAA...,1,-10,-23,13
ZUJNEcQTWLdbVMIaPgBHXCOYeRKAfFDGS,DAAAZAAAUAEAEACA..QAEALAHBdCAAMAHB..aCCCBBBDhAIAHDEAOCDBREBA.ABIBGEEAhBAASEGAcDGChBGAbGBA...IGHAXGGAeECD.hABA......hACA...,1,-11,-13,2
YTSNbHOgALcJPIRGUeBXWDfMaFVKEdZQC,LAAAJAAA.RADFeAFEXADB.DAGAaBFD.KCAAZBEB.QBGAhBAATDGA.SCCBhCAAHEEBACHA.IEGAhCBABDDDMFCB.EGHBdGDANIDB.bFFA...hABA......hACA...,1,-13,-21,8
BVSPIUaAeXgDZLYTGKOQMWcFRHCdfEbNJ,eAAADAAAZABELAEAGAEAKAGAMAIB.FBCDHCCBdCEA.ECGA..bCFDhAAABDAA.SDGAhADAIFAAACHBXFFAhAGATGGA..OEDBWFHH.CEHB.NIAB....hABA......hAFA...,2,-16,-11,5
fQFXUcEJBZLARCMaPKbYOGTVdDNeIgHSW,RAAAaAAAKADC..OACDGAFAdAEADAIB..eAGBHCCA..fCFAhAHAQECBXDGAhAIAEDHBZFEBAAAA.MFBBhAHAbEBATFFA.IHHASGGAWBBDhBAA......hBEA...,1,-11,-24,13
PSFVUAeIJQKZHGMBLCcTXgaRYWfdEDONb,eAAAQAAAHADAGAGAMADALAHBCCCA..TCEAaBDARBFF.hAAAfEEEECDBOECBhBCAbFAAFEFHAAAA.KEHBZGEABGHDhBHA...........hAFA......hAGA...,2,-9,-5,4
ZIQVTdMeHbJWcYGAfNFaUKRgBOLDPECXS,FAAAaAAA.RACFBAEBLADA.EAHBCAGA..ZBFEQCCA.dCFAhAEAHCDBJCHF....hAGAcFAAADGAfDHAhAIAKBBDDFDASFGBTFFAeFHH....hBAA......hCAA...,2,-33,-12,21
IASOaYZKGcRHgeFbEPLWMBfNJXQUVdCDT,aAAAZAAAGAEAHACBeAEAEAGALCABBAHA..JCEBQCGAhABAdCGADBBBAAEA.OCCB.hBAAKEDARFFAFGDBbFGBMGAAhACANIEB.XGEA.CADB......hCAA......hCIA...,2,-22,11,33
BFdZVQDKLHTOIfUEgNMWACXJbcaPGeRYS,XAAAJAAA..aADAeADA.RAGBBCDAZAFBQCCALCFBHDAAhAAAOAHDUGGAEDGF.hBAAMEEBAEBA.CDHA.bFCA.hABA....PEHD.SGGDhBEA.dHBBDFDB..hADA...,2,-15,-11,4
TPNCJOdKDEYabeQFWUGXRMBgLZAIfcVSH,..IAAAfAAA..SACAHADATBGACAFAdAHAEBCBaCAAhACAeCAF.QCEDhAAAFCEAGDAAREFAMFEBhACALDDBAAGAPFACODFEDGHBbFFA...WHBAhADA.BHFA..hAFA...,2,-16,16,32
bScdIHfDMBREYaOgVJGQCeZKUWFXNAPTL,TAAALAAA.SADHdACAHAEAMAIBEAFA.OCDC.VDGBhAAAGBGA.eCABhABAZEAAKEEBFCCHAAIB.bEDAfGAAhAEARFAAaEHD.QGCBCHHAXGCAcGGChAGA....hAHA...,2,-4,3,7
OKZCVcYFaWJAbRULBGENfPMTSXQgDedHI,RAAALAAAEADE...fAEAMAFATBFAQAGA.hAAAeCAAHCCAKCEAZDFECDDDVDGBhABAFECHaEEHACAAbEABBBHBhABAGGCBSFHBDEFBIHHAOHDA..hACA......hAEA...,2,-3,-1,2
OGWgcHMbDaRXCAPJKLTBdEIUQNFZYVfSe,KAAATAAAEACE..UAEAQACC.ZAEBVCCBeAGFGBGAhAAA..gCGHhAAAHEFBbFDDDAIBREAAAAIBLEEBhAEAdGBA.FGGASFHHOHFC...hCAA......hCEA...,2,-5,0,5
JPTRBeFVKYaSWOcCdDLXfUQgNbZMIAEHG,HAAAGAAATAEARADAeAGHKAGC...aBGEOBHDdCADLDDAhAAAUCDBQEAB.hACAbEEAZDGB.ACEBEEAABGADhAAAFFDASFHHCGHADIEA.fGEAhACA.MIAA...hADA...,2,-8,3,11
KXGYeJbQWSDMTEVHZOgPcfNRCFLdUaBAI,XAAAeAAAQADADADA.EAFAHAECZBGBOCCB..gBDGhAAAfDEARCGBLEEBhABAaDHDAAAAGGCBhAIAYDDFWFFG.MAIB.TGGA.PHAAhAHACHHA....hCAA...,2,-13,5,18
MELISRJdZVCHgDFOPXNATfcUbGaeYWKQB,TAAAUAAAGADA.eAFAKACCMAFALCGBRBDAZBGBHDAA.FDFBhADAXDDAAAFA.bEBChAAAaEHD....QFGAhBEAEGGB.SGBA..hBGA......hCAA...,2,-17,-11,6
SeLPMKJDZfTIdRaGCFHBbYcXUAWEOVgNQ,EAAAOAAA..VACAQADALAFBMAGBDAHBZDDA..TCCAhAHAREGFCCHA.HCGBBFCAhAAAbEED...XFBAhAIAAAIBNIEB.eHBG.KBBD.fGGBhBAAaFFH.....hCAA...,2,-28,8,36
XDUALMIaHdZESKfFYGTBcVQbgCRWJOeNP,MAAAHAAAEADEKADA.FAFAGAFABBHA..QCABCAHARBBB.OCEBhAAAeCHF..XDEDhAFAACFAaDCDZDGBSECHhAHA.TGGAbFEDWEHH.....hBAA......hBBA...,2,-23,-7,16
gEQGUBaFHTLDeROISKXbZdcMNfAWCPYVJ,CAAAVAAA..EACAGADABAEAHAFBLAFARCAA.SCFAhAAAKAHBZDCEdDHAMCIBACAA.PDAAhADAJEFB...QEFAhAGAaGHBDHAA.eFEB.XGCC.hAAA......hACA...,2,-27,6,33
KeNFYEIJRbgSWMPGdfOAXLCBDcTHQZaVU,LAAADAAAHABCaAEAKAEAeAGH..FAHBECAARBEB...SBHHhABAMCCBdDDAACIBBCDAQDGDhBAAZDCAUEGAIGCAhCAAbEAC..gFCAPFFB.fGAAhACACHGA.cGFChAEA..,1,-6,-22,16
FVZKbeNYfdAPCREUBGWMTOLSIQHcXJaDg,RAAAEAAAGADA.MAFATACA.LAEBQBFCHAGBXDAAhAAAaCCHFDFDZEGB.eEEDhAAAfCHAAAGB.hAIACEFABEHA.SDDD.IGGAhABADFIB.KHBANIBB..hADA...,2,-23,-2,21
fVgLGKTEcYBUXSdHRMDaWJZeCINQPAbFO,OAAAVAAA.GADAEADE.BAFAUAFAdAHAHCDARCFB.DAIB..aBBHhAFAZDFEeDDDCDCD.QFFBhBAAAFGAFFHDLHBAhAAAKHBA....YFHBSGGDJHDA..hBHA......hCAA...,1,-4,-17,13
BSfCMVDLbeOENKYPAGUZQaJWdRgIXTFHc,ZAAAaAAA.dAEARACF...XAGAHAEBSAGA.MBBBLCABhABAeCGFEDEBKCCDAAGAGEABhAEAQCFAJDHBgGABhAGATEDABDHBCGGDDGIBbFGB....hACA......hADA...,2,-26,14,40
OXMaASHVePCFREdDUGTLcJIWYKbZNBgQf,HAAAeAAAFADDEADEdAFAGAFALAHB.JCAFIAHA.KCCDhAAAZCCABCHAQECAhAAAXDEDABHBSEFAhACA.CFHARGDATFAA.cEGD.hCDAYEDF..hABA...,1,3,-36,39
VCHEgXBAaPIbNLcfRQZTOGJKSeWYFMdDU,aAAA..bAAALADARAEAZCAA.GAGAKBHB.eBBBFCEHdDGADCFBCDDAHEAAhAAAEEAB.BFFD.AAEA.hABAIFFA.fEHAhAEATGCASFHHMIAAgGDBhAFANIEB.....hACA...,1,-6,-16,10
cgHARfPETCKIBLMbGOeSdJWQNFYZVaUDX,RAAAEAAAKADCLADAGAFA.eAGHdBHA..QCCAFBCHZCEFUEAADDFB.hAAA..XDGAhAAAHEGBAAHATFBABEDAbFGDSGFDhABA..NIABaHDA....hAEA......hAFA...,2,-10,-9,1
UMCVDFbgSIJQeKGPXNaZBcRHYEWATdfLO,dAAALAAAMADADAHBFAEA..SAGH.QBDDhABAeBDAGCABXCAAZCFEREBAHEGBhACAECHFAAIB.TGCAhAIAODEBCFFC.bDFD.IHFA.KEHBNIEB.BHHAhACA.....hBAA...,2,-10,0,10
QeABEfgWHCTNSLKPZcUVJYFOIRXMDbadG,EAAA..fAAAHACATAGALADAZCCAUCGBVBGBFEAARCAAMCEBhAAAaECD.GFABAAFABEEDhAAACAHBKDFDJEGB.OEHDhACADFIB.dFGC..........hAEA......hAFA...,2,-12,-1,11
RgJHIbUQcSVNGZAfdaCeOEBYWFDMLXTKP,aAAAeAAABADAFADDLAFA..TAFARCDAHCGBUCCAQFEAhAAASAHBGGABhABAABBBdCFDEGGEDDAAMCCBKDHB.hADA.JEFB...bFAANIDB.....CGHAOHFChAFA...hAGA...,2,-17,3,20
IcMFQVgTXDLZHRBbUfGEJWaYNSeKAPOCd,CAAAdAAA.MADAQACA..TAGALAFAHBDARCAAbCEAGCBAhACA.ECHF.aDFBSDHHhAAAAEEBOEGBFFHDhAIAXEBADFBB.ZEEB.fGAA.hBAA......hBCA...,2,-13,-6,7
cGfTHSROKYCEQBMLbUXeJadFVWZDIPANg,...NAAA.GAAAHAFARBBAKADA.EAFEMCFBLAHBUDGA.eCDAdDDAFEADhABAZDCADDABAAHA.fDGEhAAATGEA.OEHDhACAQGGCBGFAJHCAaHCC......hADA......hBAA...,2,-11,-4,7
KHMVZgUEbJTFYcIQPNdRGBeaCAWOSDfLX,SAAALAAAHADBZACBUAFAEAFA..bBGDFCEH...IDGAhAAAQCAA.dDDDhABAREBAeDHHAAIBDFAAKFFAMFFBhABAgGCAJHBA.YFHBcGGC..hACA......hAFA...,2,-15,-7,8
SWUdbOcKLFNfDeZaGBgVMREJHIPQXAYTC,TAAASAAA.dADAOACALAFAFAFDDAHBeCCBGCCABCEAMCGBhAAAECHFHEFA.QGDAhAAAAAGACCHAUFFBKDBDhABAfGHAaEEB........hAIA......hBDA...,1,-12,-19,7
cbHgCMEJaOIUDQeRAFNBPGXKVfYTdSLZW,BAAAGAAAKACA..fADAdAEAZAFB.....bAEDHCAAhAAAMAHBEAHFaCHDOCHDhACADAGBRECAAAABFDEH..XEGChACATFGALHDA..WDADCGEA.hCAAIGHA..hADA...,1,-16,-21,5
QFWcagLAYeZVfXIdPRSOGNKbMHEDUCJBT,eAAAZAAA..XADBdAEARAGBGBCAKAFAHCAAECFF.CAHB.BDHA.QEEBhAAAFCEDaCGAADGA.VGAAhABA..fEFAhABASFHBbEGDDGGB.......hACA......hCAA...,1,-5,-23,18
ROKbQIJXFUYDTMGeSgEHLfPNdBZWcVCaA,RAAAKAAAQADC..XACBFAFADAIBGCDBeAEAEAHFHEEChAAALCCA.fCGEhAAAdEHAZGCAWCCDCECAACIBOEEBhAFAIHHAUFGA.MIEA...hABA......hCAA...,1,-10,-12,2
AKQPYNSeVJDZaLHGgcMFEBUOIWbRXTCdf,QAAA..PAAASACAeADADAHBaAEDHAGBGBFAhAEAMCDBECCAOCHDhAIA.IEDARDABTEEAhAAAdFFDAAGBKDHBNIBB.ZGDAgFCGBGGB..hBAA......hBIA...,1,2,-17,19
WaYUOMKbQdIGTJRHfXeFADgLPCENSVBcZ,LAAAEAAA.SADHBACAZADBaAFDOAFAKAHB...dBFAGCGAhAAARCAAHCGBeCCDABIBDDEBhABACEEA.VFCB..cFBAhAHAUFGBMFFB..bGFA....hBFA......hCAA...,1,-1,-25,24
CISdHRUYWQPeOMVaLEbZKcBGJAfgTNDXF,TAAAXAAA.FADASACB.HAEARAFFUDBAQCCBhAAAeAHHMDEBaAGAECFAZFEBBDHAhAAAACIBfDGAhAEADGGAdHAB.PEEB.LFHB.KGGD.hABA......hAHA...,1,15,-22,37
eSCFOGXEBJdVKRcPIZYMbWDALNafQHUgT,aAAAHAAA.TAEAeACHFAEAGAGABAHAdCADRBDF...IDDAhAAAZCFBMBBBbDFD..ACIBLEHBhAHAQEAASFDBhBAAXFDBEGABKHFA.PHFA.DDIB.hCAA......hDAA...,2,-22,21,43
aMXBNCdeATDEgRJFHKbIVOZSLUYGPQWfc,EAAARAAAHADBKACA...IAFAZAEBLAHBGAGAQCCAhAAA..fCCEhAAAaBGBMEABBEFAdDAAAAIBTEEAhABADEHBFFEHOHCCSDHHUGGBPFDBhADA.XGGA.hAEA...,2,-11,5,16
VdKYSQcBFgfGTWEeZaOHANDLPRJIUbXMC,LAAARAAAUADA.MAEAdAGAKCCD..QBDAFCHD.GBGAhABAEDEAZEDAHCAA.AAIBDEEAhACAJFBB.bFCA.CBFASEHHhCAABFHA.fGGEeGEG.NICB.hCCA......hCIA...,1,-5,-35,30
VCSePEdYfGZgBJbFHNUWOLcAKXMTRaIQD,MAAARAAAQADCDAEA..SAFAEAFEdAHAGCDBZBBABBHAFDHDHEFBhAAAUDBALDGBhAIAACCBTGCA.aDEDCEED.eFHHhBAA.....fGCA.gGEBhBCA..hBDA...,2,-26,-3,23
BDaCIKeTQXMRgdFYbJZSfVGWEcNLOUPAH,HAAAaAAA.KADCeACHQAFARAEA.dBHAbCEAZCAA...fCEAhAAAGEAAEDDBLECAhACAODHDAAEACDGDTFGAhAIAMEGBFFEDSGFD.....hAHA......hAIA...,1,0,-13,13
LTMGVecFgBZXRAQNbdaPIKEUCDHYJOfWS,QAAAdAAAaADA.KACAEAGADAEAHBDA.OBHDSAFALDBBhACAGCDAeDDAFBHDZEFBhAGAACDB.bFGDICFAhAAA.CEHAJFFBfHCBMIAA.....hAIA......hCAA...,2,-26,9,35
NJXBFHGAUQSdTREDebMfVcWPLgKCYIOaZ,QAAAdAAAEADA.eACAMAGB..fAFAVCBA..PAHBhACALAHB.CBGAOCDBhAAAZDFAXECAhADAHDABADABTFFAREEAbGDA.gFBGIHHA.aHFChAIA.BBEA...hADA...,2,-5,0,5
PWLHfQRFXbaAUeZVEOMKYTSIDgGdNJCBc,eAAAEAAAKACA..TADADAEAGAGA.dBFCCAFBBAHA.PCCBhAAAHCCBREFB.FFEHaCGAAAIB.hAAAZDFAMDIB.SHFAhCAAgEEG.cGDA.LHAAhABA.fGHAhAHA..,1,-9,-21,12
EJOLAePcCbQVHKIYfaNMdDTXSWZGUFRgB,eAAACAAA.QADAHACAKAFC...fAFFaAHDdCAADCCBTBGAhAAA..SCFBhAAAGCCAREFAEFEBLDDBhACAAAIB.bFEDIGHAMDHBZEAE.FGHD.BHBAhAEA.....hABA...,2,-12,-2,10
RKEfNWAOJIVeGXgQYBdZTbMFPUcaHCDLS,OAAAVAAA.GADAQADCdAFBZCFBMAFAFBBH..UGBAHBFALDHBhAIARDDAEDHB..fFFAhAAAADDBeFDG.YHBAhBHABHEA.PHFCCHHA.....hBAA......hBDA...,2,-15,5,20
GTBXPHCEDNbKfcQUdAJFVWYSMORIgaeZL,FAAAVAAA..SACHRADF..aAFAeAEAGBFATBGAXDAAhAAAHCDAEDHF.bEAAhAEAfDDEUFEAAAIB.hAFAJDHBMFIBOFCC.gGGABGGB.hBAADAIB.KHCA...hCAA...,2,-3,-3,0
QVdfERZIXPYGAFKDgNaWOCUJLSbcBMHeT,DAAAaAAA.CACA.LADA..SADHBAHAHCCAeAFATCGAhAEAdCFARDDBZECA.XEGAhAFAGDGAAAFAKBBD.gGCAhAHAOBBBJHCAcGEDMBIB...fHGFhBAA...hBAA...,2,-30,4,34
cWOGYJQFgMdDEeRUICLfPKTXSVbABZHNa,HAAAaAAA.OACAGACAQAFAMAEAEAHF.RCCACAHALBEB.hAAAKCGDTDFASBBDhBAAACCAZFCANCIA..cDGDhBGAJHFE.dGGA.DFFBIHDA...hCAA......hCIA...,1,-3,-14,11
caQRGNSJOKHVILZYfEWTPDBFdUAegbMCX,eAAAMAAA.CADA...aACERAEFGAGA..SAEHKCCAHDFBLEEDhAAAZAFBEAHFTCCAhBAABGAAdGHAABBB..bDFAhCAA.QFFANIAB.OEEB..hCCA......hCIA...,1,-13,-18,5
WKTOMRZUECLVGHeaSXdQBJIPgYDcAFbfN,FAAA..bAAA..fADAKAEAMAHBRCAAEAFALCEB.HEAChAAAeAHFaCHDdCCDQFGAhABABCFAIDAAhADAgGABDCIBAEEATEFAZGDA.CFAASFCAhAFA.PFHDhBAA.YHEA.,2,-13,12,25
VQELGAYXaIMFDgCZeObJBdTSUKRNcHWPf,aAAAMAAA.DAEAZACB.eAEAOAFEBAHAdBBAUCEA..RCEAHDBChAIA..fCGFhAFAEDHFACHAXEFDFDHDbEDCSFCAhBAAKBBD.WFHHQGGA.hBDA......hBEA...,1,-15,-23,8
GNWRQcFBHJPXVEfYALIeSUMdCZagOTKDb,eAAAMAAAZABEOADCDAFA.GAGA.RCCAFDFDHBDC.XAGAhBAA.ECCBAAAALFAAhAFAUDGAaEDD.TFGAKFFD.hCAAWEEDBGHA.PHCC.....hAGA......hAIA...,2,-20,-10,10
WGIUaDFHSTCefQPbLXRYOBVMKdEJNcAZg,ZAAAGAAAaACA.HADA.TBGAeAEHQAGALDCARDFFBAHBhAAAMCCBECGBJEHBAAFA..gDDAhABAIFCADDABhACACEGD..bFFA.OGAA.....hADA......hBAA...,1,-3,-11,8
fKYERGgePcCWaIJVAUSdQBOTMXFbLZDNH,dAAAQAAAOADA.MADAFAGDZBDFHAFC.KBDARCAAGDFAeCFFCCHA..hACAaDBAJFCA..AEEBBEGAhAAA.TGEALDHBhAIAfGGBEHEE.......hBAA......hBCA...,2,-18,-7,11
NPgVXTaIFLCSOZRGUdYfbWJeQMAcHEBKD,HAAAEAAADADA..gADB..TAFAaAFALCAAhAAAOAHDRBCAdBGD..bDBAeDEAhACAABCABDFAKDHBPEDBhAIAXDGDCFFASFHDGFDBfGHAhAAA.JHAA....hAHA...,1,2,-18,20
EdMFOQcPGHeIKRSfgBVWDbYLUTANaXCZJ,aAAAZAAAEADE..dADAMAFAQAFAGBEBHCAAeBBBRDDA.SBHBhAFABDEADDHBbEDALDGBhAIAABHA.CFCAODBHhBAAIGHAKGFD.........hABA......hACA...,1,-6,-22,16
WEZaAOgVbfYHQDeBXFNPIURTcLMJGSdKC,OAAAVAAA.....bADAHADB.eAFAFAHB.ICGAhAAARCCATDFAMBIBGEAAdDAACDDDhADAEEEBADFB...fEHAhAEAQEFAXBBCPGAALFHBhAFAKGGDaFCDDICA....hAFA...,2,-9,4,13
ONQJWdKPcDUZTBGCXAeHagEbfYLIMSVFR,HAAAEAAA...bADBLADA.MAHBFAFDRBGFQCBAhAAAdCADKDCADDFBZCFFGEFAAAEAeDDHhAIAaDHDfFEAhBCA.SCHHOHAA.WFHH...hAAA......hACA...,2,-13,-7,6
UBKbQPFfEeDdOZCNTMHJScaIVRLYAWXgG,XAAAGAAAKADA.QAFCFADA.EBHFeAFH.dAHAZCDATDBAhAAAHECASDADhAAA.aDHDRDDFABDBgFEAhACAbDGBDEIBCFFAMHBAIGHA.LHAAhADA....hAHA...,2,-16,2,18
fXdEYAaLKTSQNWVBFUbeJROgICHMDcZPG,aAAATAAA..QADA.VAFAFACAeAEH.RAGBOCCBhAAACBBDHDAAMCIBZDEBGGABhAGAdDDAADGALEGBhADASDGABFEAbGFA........hAIA......hBAA...,2,-15,-3,12
IcWZaNGbFJYUBHEORVPgdMTDAKSLCfXQe,LAAAXAAA.eADH..IADAZAEBGAGAFAFAUCDAHCABRDFBhABA.PEEBdCGAMAIBhAAAAAIBCFHA.QFBAhABA.aEGENIDB.JFFFEGBAOFDF....hBFA......hCAA...,1,4,-15,19
GAJOQaUIDcNFKTfSPRLXHMWYbZCBeEgdV,QAAAaAAA.DADAFADAKAFATAGA..SAHBhAAARBBAHCEAMCIB..bBDCZEEAhAGAeCGFEGCAdGGDADEAODHDhBCAIHEA..fEBA.LEEBhBEA.XGGChCAA.,2,-27,-6,21
eEcGgIZdRAKUOLFWQYJCSDPVaBMNbTHfX,OAAALAAAFADDQAEA.CAGADAIBaAFAMAIB..bCAAhABAHBEB.eBBBECEBGCGAhACAZCGFADDBKEEDUEAAhAEAJFGFSGBABEEDTGDAXGEDgGFBhCAA.....hBAA...,2,-18,4,22
NbeBfKEDPZFJadIcORCHVSAGTgXYQMWLU,GAAATAAA...XADAMACALAGBUAGAeCDBKBDAECCBZDEBaDAHhAAAdEEAOCHD.hACAHFBBADHAQGBAhADA.bGEADDBB.FFHHIECACFDCSGEAhAAA.....hAEA...,2,-8,-2,6
afAIGWcMRBgUKPZVYJEbNFDLSXdHQTCeO,GAAAMAAARACA.BADAKAFC.ZAEB...VAGBEAHFFBBHLCDD.hBAAdDGDHCEA.TECAhCAAeDADaEEDACIB.IFHAhAAAgEGA.PHEA....hCEA......hCGA...,1,-16,-23,7
ECUAZKLXbFSGaTDMHNRgWOIdYJePVcBQf,ZAAALAAAFADAGAFAaADD.DAIBHAFA.RCAAOCECdCAAeCCBVEEAhABAQEEC.EDHBhABAAAHAbFAA..MECBhACAWCHBIGGA..PHEAfHABhAHA.CHFD....hACA...,1,-4,-11,7
UdbJcAOaCfLTKMNRHQGPDZSeXVBFEYgWI,aAAALAAA.MAEAHACBGBCBZAEAeBBDBAHAECFB..gCABhABAIDHAbEDBABFACCGA.hACA.KDDDRFAA..QFFAhAFASCHH.FEFBYHAGdFHAOFDDhDAA......hDFA...,1,5,-14,19
OAGIHLBTdPeFRZCXJWgVYbEMfDNcKaSQU,HAAATAAAeACE.RAFFZCCAXACB.JAEBgCGH.hAAAVECAEAGAMBIB.hAAADCCBKEHBaCFDQFAChAFAACHBGEGALFDBdGFACHHAYHAGbGACfGFEhAGA...hAHA...,1,5,1,4
efWZdbPaVIBSJgRFDMXEQUNTOAYLGcKCH,GAAACAAAHACA.eADAZAFBdBHAaAGD.BCAA..SBHHRCDBDCCB.hAAAECDAQEAChACATDEAAAABLEAAKEGA.hAEAbEGDIGEAFGBAMIAAXGGANIEB.OFCDhAFA....hAIA...,1,11,-19,30
ZEbgVFGJINXPDSUfMTCORBdAWQLKaeHYc,LAAAeAAAHADAZADBEAGE..VAFAGCCA.ICFAXCAAhABASCGHMCFBTDGAhACARFABAAAAQFEAhAFAKFGDaEEH.cGGAFGDH.NCIA.DFIB.CHHD...hAIA......hCAA...,2,-12,15,27
YbGPWOSUXFEZABdKCLeVfHRaQTcMIDgJN,dAAALAAAeADAHAGBRADFQAFCMCCADDAA..JBHB..bDAAGCAAhABA.ODDBhACAXDGAEEFBAAHACEEAaFGBTGDAhCAA..gGBAPHFC.SGDHhACA.FHGE..hADA...,2,-11,0,11
cBTAIEMVCSefJZYbLHaFgRQUNOXGPWDdK,EAAAMAAA..SACAeACAZAFBLBHBHAEBaAGARBGFQCCAhAIA.OBBBGCCAhAAADEFBdDAABEGDACCBCEFAfEHAhADAbFBAFFHD.gFEG.XGBChBGAKHCA.IHHAhCAA.,2,-8,-4,4
QEDURcFNOJGWZbfaBMIATKSXdgPeCLVHY,TAAAXAAA.dADAeACELAFAHAFBEAHBRCDA.FBDHOCGDGDEAhAAAZDBFaCCHMCIBADHASEGBhAFACEFD.QGGBhAIADGABcGCD........hAAA......hABA...,1,11,-22,33
UgOSHNeMdKDWVXAcLbTQRCJGEIPFfZYaB,LAAATAAA.RADFGAFAEACE.FAHFZAEBBCAAOAGDHDEBeCCBhAAAdDHADCCBXDGA.hABAAAIBQEAAhAEACDDDJFAA.fEEAaGGASHEAMFGBKFHD.hACAcGBD...hAFA...,2,-13,4,17
ZefDFgIcNWKCYdOLGPASbaXJVHTEQMRBU,aAAAXAAAHACBEAEARADA..ZAGBDAHB.FBFD..IDAA.hAEA.cCGDKCDDdCFCGEDAhAIAAAAASCHHhADAVGFAMBBBeEEB.fGAAWFFE.OEAEhAEA.PHFC.hBAA...,2,-12,-10,2
SaIMJNCDYWXAZEcHfdeRbVBGgKOFQTPLU,EAAAHAAAdADARADFBAFBGAFAOAGDFAHF..QCBCLDAAaCFHhAAAMDEB..CDHADAIBXDGDhAAAAACAZEEA.eFAAVGDAhCAATGGA.SFEHIHHA...hCCA......hDBA...,1,-1,-14,13
EGZJNSXdCFgIUcLPWYfAaKMOVTBDeQbHR,aAAAMAAA..OACDTADADAEA..eAFEHAFCEBBBZCDB.SBBDhAIAdCFAFCHBUDDALDGBhBAAPEHD.fGBAhAIAACIBBEBARFEBNEIACGFA.gGCB..hBEA......hCAA...,2,-12,-10,2
UOcSaVEgfDAHTYPMKFQGIbdBXJLeRZWCN,HAAATAAAMACA.QAFAGACAdAEBXBDDeAGHRCEBZDGBCAHAOCCHhAAAaCAC..EFBADCIBhCAAAAIBKGFDbDFD.BHHALEEDhCDA..NEEA.SDHD.fFCAhCFA.FGHDhDAA...,1,-1,-3,2
IKMcBDXWRJZdFPTUYSOgCAeELNaQbGfVH,EAAAaAAAGACAHACAMAEADAEA...RBEAdBHATAGAUDEB..OBBHhAIAACCBeEGHLCFAhBAA.bEBAIHHAhAAABEHAXFEDWDDD.FGCB.SGGBhBEANIAB......hBFA...,1,-8,-9,1
LbDRNJABYaVcEHIdPOUGWZKMXSFeCTgQf,aAAAEAAAHACA.dAFAOACDGBGAZAEAMCCBFCEA..eBBDCAHBTDDAhAAAQDGA.LEDBhAFAREABAEGBBFDDcFFAhAGAIGGA.WFFDSAHB..hBAA......hCAA...,2,-21,-4,17
ETMUKDFWYIAdagNbcQHBXOJGPSVLZeCRf,aAAA..bAAAHACBOAEAGAEB.SBBDZBDBRBFAECAAMDFBhAAADCFBFCGD...IEAAhAEAAAIBdDHANEGA.QEDChAFABHEA.XFGA.PHAA.hABAeHFECHHA....hAHA...,1,-5,-13,8
TcJaVdMBSAbYPeQOIDNHKWCLXfEgFGURZ,...bAAAeAAA.QADADAAAHAEACAHBLAGBECCB.GCCAhAAARCEAZEAAJDHBdEFAMAIBhABAACHA.OEHBKEEDfGAAhAEAFFBBcGCDaFGHSGHH..hBFA......hBGA...,1,-8,-9,1
fVEdIWSeKGTRYUcNXQCHMgLPDBZAbOFaJ,FAAAaAAA...VADAEADAdAGA..SAGBeBBBGBEARCCBUCGBhADAXDADHEFCMFEBhAIALDHBBGGDAAIBbDCD.hBAAOEFD.fGBE.KHEA.hBIA......hCAA...,2,-21,3,24
eHWUaSOfVBAbJMCILZRKTcXPdYFNGQDgE,MAAALAAARACA.TAEA..XAFBdAGAFCAAGDCAQCCBhAIAECEBHEABaBGDfDFEhBAAAAIBCCHAZEGBKFFDPDHDhBBADFIB.eEEBSGDHBFCAIGGAhBIA.NICB.....hCAA...,2,-12,5,17
TKEXLDRWMBbGAQacHZUfVeONdIYgCJSPF,aAAAHAAAZACBVAEA..eAEAdAHA..ICCACAHA..SCEAhAFATDAA.ECHBLDEAhAAARECAMBBBGEGAhBAAAACAQECD.fEHANICB.gFFDhAEAFGEC.DGDBhCAA...,1,-7,-15,8
WNgIQadUDCeFcYZTKBVbPOSMELAJRXHfG,RAAAHAAAGADA..gADBaAFA.dAGACBFBeAHHFCAHZCCATDAAhAAABCHA..VEFAbDED.hABASEEDLEHBACCBhADAfFAAIHFADDDBKGBAMIAAEGDB..hAAA......hACA...,1,4,-10,14
IXfBMQHPaZCLFcUAdJgSDVKWeRETbNOYG,dAAASAAAKADARAFF.EADA....TCBAbAFA...OAHDhACAGCCA.fCFAhAAAMDABHDEAZDABLFGBhADAFCHHADABDEGBeECFIFHABHAAaHDACHAA..hAFA......hAHA...,2,-14,-7,7
EHYaKCSOLUWbVQXcMNZdgJIfBRAGFeTPD,eAAATAAAEADA.HAFAaACA.KCCA..OAEDLCEBUAGAbCGDQCCChAAA.MDBBhBDAdGDAgGGAhAAAJDFBBDHAAEEBGGBBDCIBSHAAXGGA..hBGA......hBIA...,1,-1,-9,8
JMNQYeXFEUPVdWBRfgKGTZCSLcHDbaAOI,OAAAMAAA..QADAeADAEAGAUCCAdAGARBBBKCHBZBFE..LDGBhAEAHDEAaEDHABBBJFEBXFBDhAIA..FGHDPFGBhBAABEFB..........hBBA......hBFA...,2,-21,-14,7
XQLTIeHbcOEJdgPaZBFWRNfGMYKCUSDAV,QAAATAAA.HACAOACAEAFEdAHAaAFDZAGBFCDDRCFB..GCCAhAAAMDIBCEAADBIB.ACCBLEFAhBDAeEFDJFCBBHDAhAAAfFBAKHGA.SFDH.XGEDhBFA.IGGAhCAA..,2,-6,-3,3
HWdSMUZEKXYAFQBDcORPbCaIgLTGeVNfJ,QAAADAAARABA.CACA.aAEALAEAGAGA.eAHH..fBEAhAIAHCDAdEFAMDCBhAAAEDCBKEEAAAFABDHA.OFCDhCAAbFGD.IFHATGDANDIA....hBAA......hBIA...,1,-7,-24,17
PdfcHWEQTeKOSINXVaLJACMUGZDRYBbgF,MAAAZAAARAEABAHBFADD..dAFAHCAA.ECEBeAHB.SBBBhAIA..XCGAhABAaCFEADDAGEEAbEAAfEEEhACAQFBATEGAOEHBIHCAhADA......hAEA...,1,-15,-21,6
aXfTgZbVUJACOQYPDEISGcKWeMNLHFBdR,QAAADAAAEACA.GACBKAEA.eAFEMAHBHCDCdCCA.RCGFaDAA.hAGA.TDFAZFFAbGCCUFCAhAIAAEEB.OBBH.hAAAIFHA.SFFDNIEB.BHHAhBAA.....hADA...,1,2,-23,25
DdgPGfEUYXRVLMNHSWeQZabAcITCOFBKJ,TAAAFAAAKADA..dAFAGACA.EAEAXBGDRAGBLCFB.HEAAhAAAeCCBaCACAAHACCEDBDHAhACA.DEEB..fDAAhADAVFGBMIAASEEA.ZEGB.hAEA......hAIA...,1,8,-37,45
DZYNLdQcATXgbUBVHGMPEJRKIOFWCeSfa,TAAAXAAA.UADAHACB.GAEB.ECABRAFAOCFECCEA.hAAAeDBAaCGDZEAALEEAhAAAdEEAAAHAbGDAMEIB.KGAAhABAIHHASGEADCIB.NIAB.....hAGA......hAIA...,1,8,-15,23
JITOPeCKZBYMUNGcdgbLARWQaXVfDHFSE,RAAAaAAA..XADBDADAHAECFAFD..EBBBJAHBOAHD.eBDBhAHAZCCAMDGBGDEAdEHAbDGDhBAAAAAA.....QFCChCAASEEDIHHACHAABHFA...hAHA......hCAA...,2,-32,5,37
dUKcBJGHaLXQCTWZObISVFMYeAPERfgND,RAAA..fAAADADAdAGAKBDABADA.HAEBLDDAQAGAhAAACCHA.ZCABOEFEbDCBSDHBhACAFFBA.eEEAhADAEGBBUGGAGGABaFDDTFGA...hAAA......hABA...,2,-32,20,52
acZGdKCbSOXPRMIHBVUNDAEFfWQJLeTgY,EAAAFAAAQADALADAeAGH..TAFAaBCCGCEAdAHACCCA.OBHDhAAARDABHDEABDDCUFGAhADAAAEAJEGB..gGDAhBAAYFHB.KEDD.......hAIA......hCAA...,2,-16,-2,14
GDLHJPScAVadXYBFfEgZMUWKTebQNOIRC,dAAABAAAEADAZACA.MADAKAFA..eAHH.QCBAOAGDRCCAGDFAhAAAHCFBSDADhACAAAIB.aDDDFFEHfEHAhADAgGBAUGGB.bFCACHGADDIBLHAAhAHA.....hBGA...,1,21,-31,52
eZEWYHFGATBRQIbPNJVLadgfUKOcSCMXD,RAAAQAAA..bADBJACELAGBdAGAUCDAOBFB.CCCADAIBhAAAECHFHDFB.AAIBTFBAhAAABDHAIFFAhABAPFHD.aFHB.KGBAMIEAXGECeFDH..hBGA......hCAA...,2,-25,-1,24
LfbAZDPHMCgYBNReSQJFWKdaUOTGIXcEV,ZAAAHAAAMACACADBBAFARAEA...eAGHQCCBFCAHdCCA.aAHDOBHDhAAAGCFA..XDFChACAEEEBLDHB.hAFAAFDBDHAAgECASHFAKFGAIHHAhAIA.fGFEhCEA..,2,-14,-9,5
RPKYWfSFZOgBUCJNITHEaDdQeAbVGLcMX,GAAAMAAARACA.KADA.....fAFBZAFBBAHACBBDJBHBTDDAhAFAHCDAEDCB.dEFAACEALCHBhBAAXFCAPFHBhAAASEGDFHAAODAHNHDBDGIB....hACA......hADA...,1,-1,-29,28
bLdPIFRaYXUEBJfKVWHcMDNZCQOgeTAGS,GAAALAAAdADAFAEARAFA...aAGDXCDAEBDF.BCGAKCAAHCEAhABAMCIBZEEAQEEBhACAeDBHAAAB.bEGD..IGEAhACA.UGAB.fGGEhAFA......hAGA...,1,-11,-12,1
ZJCWAGNLbPMQVeDIRXdEfSaYUcTBFOHKg,GAAALAAAMADAeADHRAFA.EAFA..aCDAUCAABCGAHBFCZDBBCDEDAAIB.hABA...bDEBQEFAhAAADDIBdEGASFAAhACA..YFHBFGHD....hACA......hAIA...,2,-28,3,31
PNBCDHWgSAZIJEOdFbceLRYGKTQXMfaVU,ZAAAEAAAdADAFADA..eAFHRAFAGCBA.QDDCMAHB.aCHBPCABhABA.BCCDHFABhAAASCEDAAFAODGHcFDDhAIALEGBKFHBTGDA....hACA......hAIA...,2,-31,5,36
TaUdCAgEJQFBVbLGSRfOYHMIDeWcKNZPX,EAAAQAAABACALAEARACA..OAFAHCCAMAIBeBFFKBHBhAAAZCFBTFAAdDAAACEBFDDHGEGAhAAASDGB.hAFAIFFADEEBWFCBPFHD...aGEChADA......hCAA...,1,-4,-16,12
MbFNKTeYSZIgLRWBDUOPEGadVXHQcfAJC,MAAAFAAAKADA..eACAZAFBLBHBRAFABBBDDCDAUCCA..ECGAdDAAhADAHDDA..QEFChAFAADIBCEGA.TFCAhAIASFDA.gGAAOFHDaHCCXGGAhAGA...hBAA...,1,-21,-23,2
efKaHJbAINCLOMYdPWREQTGVZUBcFgXDS,CAAAMAAAdACA.RACA...EAEAGAFAZAGB.BAHAFCBH.DBBB..eBFFhAAAaCCCHDEBABIBLDDBhAEAOCHD...PECBhAFATFFAUGGA........hAHA......hBAA...,2,-32,-16,16
JaHIGFdMEDSNTKOVZefUYgCcPWLBXAQRb,RAAAaAAAHADBGACAdAFBEBGBDAEA....TAGAOCCB.eCHHUCGBhAIACDAA....PDEDhAAALBEBAAIB.bEGDFFHDhABAMBBBKGDA...fFFA..hBAA......hCAA...,1,-9,-23,14
QTOLSRUNWbVfXFcHMJZKgIGAPYeadCDEB,eAAAdAAAEADAQADALAGBRBDAUAGA....bABDXCCChAAAHDEAZDAAKDEAGGBBhADAABFAaDGABEGATFGASFFDhABANAIA.fGGBMIFA...hBAA......hBGA...,2,-18,12,30
BFODRfZLaYbUdGVWeIPTECKHSXNJQgcAM,MAAAOAAARACA.ZADBLAFB..bAFAGCDA.eAHBTCFAhAGAEBBBHCGB.XFCDhAIAQBBBAFCBDFFBhBAAaDHDdGGAIEEA.KFCA.SFGDhAHA.JHCA..hBAA...,1,6,-22,28
SMVLOBGKWbYdQAcUZeFaNTfCgXEPDIJHR,ZAAAeAAAaACA..TADACAFA..EAHBDAFAHCCCRBFA..MCCBLCFBhABAGDDAKCHDbDGDdFAAhAFAAAAA.FEHD..fGBAhAIAXFECIHHASGEH.BHHAhBGA......hBIA...,1,-11,-18,7
LKXYPITAOeBFEgaRDQGdCHSJWMZcbVNUf,eAAAEAAARACA.GADAHAFB.SAFAMAIBZCCA...VCFAUECALDBBhAAAXDADIFEAhABAAAHBFDHHDFFBdFACCGGA.cGFBhAFA...NDDAKEHB.....hAAA......hADA...,1,6,-16,22
QXTAVGHOgZCSUBMdFbRJEeWPYfLIDcaNK,HAAAZAAASACEMACAdAGARBDB..EAFAeBHH..PAHDLEFAhAAADCCB.aCCHQCFChABAABFAGFCBCGHAFDDB.bEFAhAFA.JFDB...fGGANIAB..hCAA......hCBA...,1,-2,-14,12
AVcaIfZLCTRBeSFGOgHWKEYDbUXPMNQdJ,aAAAZAAALADB.RAFABCAAeACHGAEAHCEBKCGAEAGA.bCGDUFAAhABA..MBBBdEHAACCBhACAIDDACFGC.TEBAhAEA.OFFB.gGABhAGADIAA......hBAA...,1,-11,-24,13
SDbUXYVFaOQcJdWfMZPKGTREeAIHCNLBg,HAAALAAASACEDAEAUBEA..XAEDFAHB.aAGAQCAAhABAdBGAMCCBZDCBGDCAhACAEDHFAEEACCHABEEB.hAAA.bEFDOEGB.JFHBWFDHKHEA...hCAA......hCDA...,1,2,-20,22
UeGWCFaABYdQDOMZSbRKEgNJXTcfVPLHI,dAAAQAAAMADAZAEERACAKAFC..EBHFJAHB..TCBA..hACAfCDALCFBHEDBhAIAeCEHGDAAhAAAFDHDADEADGGAbDFD...XGCA.PHFAhADAIHHA...hCAA...,1,-11,-13,2
FGdaVRWKYcEUZgfJNLQCBMHXOPbIeASTD,TAAAGAAAaADA.RAFF.KACC.EAEAZCDF.JBHBLAHB.QCCAhAAAMDDBHFECOBFDhBHAbEBD.AEFBFEGDdFHA.hAAAVFCA..WHAGYFHB...hACA......hAHA...,1,-5,-8,3
VMQKTJHNSCBIFAXOfRaGgYdDUZcbLWEPe,OAAARAAAGADAdAEAZAFALAGB.EBBBeCCB.MCGBQDBBhAIATDAAHEGBCDFDFDHDABGBhBAAaDHFDEEBUGAA.bFDDhAAAPFFB.KHGASFFD..hABA......hADA...,2,-16,6,22
RgcVHXZMQbeDLWYGaOfCIJBKPSAEdNUFT,EAAAdAAAFADARACA....VAGBHAFB.ZCAEMCCBeAHBLDABhAAAGDEAaDHHCDDABDFAKECBACEBUFDAhADA..TGGAhACAXFGADGEB.OHEE......hAFA......hAGA...,2,-17,-9,8
PLEGbNRgXUKVAfZQDJHTSdCOFaeIBYWMc,ZAAAQAAAHAEAdAHAFACEeCABBAFA.MAHBLDDA.EDHBbCDAhAAARFDAUGAA.ACCBDFHBhABATECA.OCHDhAFAaECC.IFFA.YFHF..hAIA......hBIA...,1,-6,-27,21
ZWSdQRXEMBFbNeAGHPOJKUCTDgLVfYacI,HAAAOAAAKADCUAEADAGALBFA..fAGFaCACZCCBdDGAhAAARBCBEBHFFEEB..eEHHhACAABBBGDFA.CDHATEBAhBAAgGBA..VFDBcGEBSHGAhBEA....hCAA...,1,-6,-14,8
YRNaFCgMHLBeVKfZJOIQPEDWTcdbSGUAX,RAAAaAAACADB.HACBLAFAeAEA..KAHBZCCAOBBHQCGA.EECAhAAATCEA.bCGDGEFAhABAAAEA.XFCAhAGAFEEHMIDAfHABIGCADGGAdFHA...hAHA......hCAA...,2,-6,-2,4
CNERgLHGIPYVdSbZeWcTKUXBMfJOFaADQ,QAAAEAAARACA.HACAGAFA.IAHAPAFAdCEA.ZCFBhAAAeCCBTEAAXDAChAAAMBIBODDHACIBCDHDLEEBhADASDHDbFADKGGAfGGA.hAFA......hCAA...,1,5,-7,12
LgMcbOGAIZTeaSKVXHREPYBNCQWdFJUfD,ZAAAeAAAaACAKADA.HAFBEAFA.BAHA.QCCAdBHAFCCHUCFALDFAhAAAMEEB.OFAAhABAAEIB.TFFAXFAAhABAPHAACFFA..fFHEDFIB...hAFA......hAHA...,2,-24,-10,14
TNbLfMYVAKEWdZUIeRcaPGJDFCSgQBXHO,EAAAZAAAeACERACA..aAFAGAFA.FAHFSAHHQCCBHBFBhAAATEEALCEDhADAMDHBADIBdEHA.IGFAhCAAPFAACGGDBCCD.OHFE....hCBA......hDAA...,2,-12,-9,3
EBgWAZXcfDJHPeVYRNaIUdFLGCMSOTbQK,ZAAAXAAADACAHAEA.eAHHRADA..aAGAdCCDGBGAMCGBODEDhABATDAA..KCDDEDHFBCFChAAAAAGA.JEEB.PFHDhABAYFHB..NICB.......hADA......hAEA...,2,-17,-15,2
feSLOVAGYFKdaUCDNIXJZQRcWgTHBEMbP,GAAAKAAAdACAUAEADADA..XAEAZAGB.RBGF.....gDDAhAAAHCDBEEGBbDBDhAAAeCHHLHAA.hBEAAEIBaFFHCFFAIGBA.JFHBcGGDBGEDMIBAhBGA....hBIA...,1,3,-30,33
cQZWJYOgUaSLINKDdVHTXPERAeFbfMGCB,eAAAFAAAMADAGADABAGAZAFA...JCCFOAHDUDGALEFDhAAAKBCAdBEAHCFB..TGAAhABAEDDBAEIB.CFDAQGGChAGA..gFFAaDBHSHCAhAHADGIB.....hBAA...,1,6,-37,43
BSIHKXQJdeaDMLPgZVRbTYGfOWUAFNcEC,FAAAEAAABACAHACBQAEAdAEA.eAHBaAGAMBGBLDEAZCCARDGFhAAATEAA.GFDBhAEAOEBAADFACEHAKFFDDGIB.hBEAPHCC.........hBHA......hCAA...,1,7,-32,39
SeCMYPQFKOLaVUHTDdgfGRXEcZBNAWJbI,JAAASAAA.eACHMADA.QAGAOAEALBEAhAAAUCCAHBEBdDDAGDGAhABAEDGAZEBAAEIBbDEDCFFA.FFBBaFHHDAIBhBFARGCE.BGDD.NIDB........hBAA......hBEA...,2,-12,4,16
DIHCMTXWFSUGEQOacVZebNdBRfYgJKPAL,LAAAHAAAMACATAEAFAFDGBDA.EAHBaAGAZDFBeBGF.dCAAhABAfDCEJCCA.hACAACCACDHASCHHhAEA.QEECOFHB.cGGANHCB.BFHBhDAA.YHDAhDCA...,2,-15,-5,10
ZKTWLSeADHbGRNEcOPXfYUFCgJQaMBVdI,HAAARAAAEADE.OACA..XAFBUAGACBEAQCCCaAHD.hAAAMDFAdCCAZCDB.TDGAhABALEEAAFFAGGDBhBHAPFHD.FGBA.BGEA.....hCAA......hDAA...,1,-10,-15,5
ZeDMYbTKPWaRUFEdICLJNVScAgfOQBGHX,OAAAGAAAHADAZADBDAGAMAFA...bBFATBFA.KBBDaCDChAAARDBB.EDFA.dEHALBHBhBAANDAA.SDEHhBDAAEEBQFFAeEGBPHBAFHDA....hACA......hADA...,2,-15,2,17
CDLJZcePGOgURFBaEWbSMIfNQTVAKYXdH,XAAAHAAALADBZACB.eAFAGAEAOBHDRAGBBDGDECABSCCDhAAAMDEB.fCFAhACATEBAAAAAdFFADEEBPEHBhAFAFEHDaGABIHHAQGAA.KFFB.hAGACFCBJHCA....hAGA...,2,-5,7,12
ZCIGUANDfbgSeEMdLVTRcXKPJOQBFaWYH,DAAA..bAAAeABAEAEA.dAFALAHBRBDB.KBFAOAHBFCAAaCECHDFAhAIA.ZFBAGEAAhAAAACCB.fDDEhABAMFFBTGGAXEGA.QFED.hBAABHEA.CHGA...hACA...,2,-17,-2,15
GdAQOVEHFWaCbBRNXSMeYcPLJDUTfZKgI,QAAAEAAAHACAaAEABACA.RADF..SAFBeAGH..PCCBhAAALAHBDAIBTDGAhCAAZDDAKEHBGFCBhAAAADFBFEDDbFFA...MIDAYHBA...hCBA......hCEA...,2,-13,-7,6
OIRTgcGPaMZAUXJfLBQHKCeFVDYEdWbSN,XAAALAAAHADBKADA.eAFADAFAdBGASBGA.OCABhABARCDBTDAAGDDBaCHDZFCAhAAAACCBfEHAhACA.QFAAFFFAEGHFNIAB.gGDAhAFA.cGGC..hAGA...,2,-16,-3,13
LIKVQTaXcegHDPCAFYEMONdUfZSWJGbBR,EAAAMAAAdADAZABE..SAFAGAEARAGBLCCBKBHB.TEFAhAGAaBCBeCEF.HCFBhAAACDHAAAIBOEDDfEHAhAFAJFHB.bGAA.BFFD.IHHA..hAGA......hAIA...,2,-14,-13,1
RfaFBYQZDcTAgXKSbPVMIWUdHJGOLECeN,KAAASAAA..bACBMADA.UBDAHAEAGAGAEBHFeCCDhAAARDFBaCCBBCFA.ZEDBTFCAhAAAAAGAXDGA.hABAIFFAdGHAOFFHLHFAfGBEhAIA......hBGA...,1,-6,-11,5
XGCAQeIabYfSVgZcKNJLFPUTHdEMRWBOD,eAAAaAAA.....bADASACHZAGBKCCALCEBFAEATBGAhAHAHEAAEBEBREGBBGEADBBBGDDAhAIAAAAA.QDGBhBAA.fFGE....hBIA......hCAA...,2,-18,-16,2
WINDbdPXTRfcLBGOaCQHMFVYEgUKeJZAS,SAAA..IAAADADAdAGA.TACARBCALDBAGAEAhACAaBHDHAGD.MCCBhAEAFDFBEEGAKDDBeCHHAAAA.hAIAbDFDfFBAOFHDQGAAgFGAhBDA......hBFA...,2,-26,7,33
MYaSfRbUFVIPgTDLHceEJQAZXdOBGWKCN,dAAAGAAACADA.MADA..aAEDRAFAFCDA..IAGATCGAHDBBhAAAEBHF.ADDBZEEABCBAKGEAhACASCEA.hAIAbDAA...PDHDDEIB.eEEB.QGGChACA..hADA...,2,-32,-8,24
LRZJIEcgOPTYBXaCNdVWbSfQeADFGMUKH,GAAAMAAAHACCRADAZAGBEAFE..OCDB..TCCAXCEDhAAAaAHDdCFA.VEGBbEFAQEABhACAABBBFEEHLHAAhAHAIGCA.gGGB.BGADhADANIEB.fHEBhAEA.DBIB,1,8,-6,14
BHWNPTLgReaSADVfGIUbEOFJMKZdCcXQY,DAAAGAAAUADAEADA.FAFDMAGBZAGB..dCDACAHA...QEFAhAAAHBBB..PCHBhAHATFDARDEBeEDBABIB.IFBAhBAAODAHKGHBXGGABHFA...NICB.hBBAaDHD.....hBDA...,2,-21,-4,17
IdMRQObSWeHAJNVaUZgTFBPCEXLDcfKYG,VAAAZAAAFADA.BAGAEADE.LCAB..fAFBGCCBdCGAhABARCDAQCGChAAAODHD.bECAeEFBHGFAAAIBaFCAhACA.UGAAPHAACHGA.DAIB.KEHB..hAHA......hCAA...,1,-1,-9,8
ULDZcJGXESMgaVWHICfNTbFKQBPRAdeYO,eAAAOAAALAEAZADBGAFAEBCF..MAIBaAHFHDBA.CBBD.TCEAhAAAKDHBBEFDAAFAdCGADFBBhBAAXECA.SEHHhABAgFDBIFFAfGGAFHFA.hCAAPHBC...hCBA...,2,-14,-10,4
CPDNHObXJMESZfWBATVQFKcdageRIUGYL,TAAAQAAA.KACAaACARAEF.GAEALAGBDAGAHBGBOCDBbCCDhAAAMAIB.ZEABBDBAhBDAAEABFEEAdEGD.eFFBIEHAhAAACGBANIBB...EGCA.fGGAhAEA......hCAA...,1,6,-13,19
PMdEUeRJICTGLHQXfAYZVcNWBgaDbOKSF,ZAAAVAAA....NACBBAGAaADA..OAFDFBEB.dAHAEBHFRBDB..hABACDGA.GCFAHFEA.QFDAhAIAADDB..hCAAYHBAgFGHKEHB.MCCB...hAAA......hBHA...,1,-18,-24,6
gZeMVQDKWFGfCLTaUIAYNRdHPOSJcbEXB,RAAAHAAAOADASACE.JAFAEAGABBEAeBDF.MBIBQCCChAAAKCEAGDGALCGBhAIAaEEBAAAA.dEEA.bGDAZGCAhCAADCIBfFFECDFB..IHHAhCAA......hDAA...,1,-6,-11,5
YRCSHdIcZJDFPAVWMKfOaGebgETNBLXQU,MAAAOAAAGACB.eAFEEADABAFALCCAQBGARCFFHEGBdHCBhAIAZBBAFCFHABBBKEEDbEEA.hBAA....gGGAhAHA.NDDA........hCAA......hCDA...,1,-9,-17,8
NVIQWZYPFROUTAgcSeMaCEbfdBJHKLGDX,SAAAeAAAMAEA.EADAdBDA.HBFAGAFAXDCCVCCAQDAChAAAZDFAFFBHRFFA.TEGAhABAAAAAaHBE.CAHABCHA.hAIALFEBIHHAPFBC.OHAAhADA.gGGAhAHA...,1,3,-2,5
IbMXLGaPdcKfATONSDWHCgFBYQRVJEUZe,TAAASAAA.HACBFACAQAFARAEA.ECCAeAHHMAIBhAAAGCFAdDEAKDGAAAAADDEBhAEACFAABFCAVFAAZFGBbFGDaGDDhAFA....cFDDfGFANDIA..hBHAWHAG....hAFA...,1,-2,-8,6
ObIeZHPFYKXAEJUQCMfLNSgWdGVcBTaRD,EAAAQAAA.MADALADA.SAGHdAHAGBDABBCDhAAARBFBbDBDeBHHHEGBFCDDhAEAXFEDACFBCDFA.fHBBhAAAgEGA.cFAADDBB.OFFHhAFA.IHHAhAIA...,2,-30,10,40
gOcMERbVDJANPLBdZfCXaGHTYWUFIKQeS,LAAAZAAACADBGAEAHADB.TAFAUBGAKCAAeAHH...OCABhABAEDDBREGB.DCCB.ADDBBDFAhACAdGAAaFFHFDHD.QFAAhAFASGEDMEEB.bFFC....hAHA......hCBA...,1,0,-24,24
IbXOfgcaKECQSRDeWBVNFMTHZLGPdYUJA,XAAAOAAA....fADAaADAEAGA.QAFAhAFARBCFDBIBeCEABAHAFDGDHEBAhAAAGCCBdEEAUEFAAEIBbGAAKBBDhBAA.SDHB.VFCBTGGALHFAhCAA....hCFA...,1,4,-6,10
DCcKTeAMbSgBWNQOYEHXRaPGdZVJFLUIf,MAAASAAABADA.QADAEAFA.HAFARBBBGBGAZCCAFCGDLCFDhAFAIDAACECATGEAhAIAAAAA..bEECgGGBhBAAOEHDaGGH.dHAB.....hBBA......hBIA...,2,-20,2,22
cTLSGCBQdHaDfeAMXKJVRZYPINWbEOFgU,MAAAKAAARACFZAEB..IAEA..bAGDEAGA.FBBAUEAALCEAhAGAGECBQEEAhBAAHFGBaCAC.eCHHAAIB.hAAAXFCC.YFHBWGCA...hACA......hAEA...,1,-9,-18,9
QIZUNeCLcRGVPJADgTEfYOXBSbKFWdaMH,TAAAEAAA..OACCSACBFAFAdCCAHAEAZBFE.eAHHLDGBhAAARCCAGCFAJEABADIBfEAAhAAABEDA.bFGDaFEDhAEAMDIB.QGAAIHHA.CEED...hAEA......hAGA...,1,11,-24,35
HeEfGAKgBVFJMZaXWPDdTIRNScQOYCbLU,BAAAFAAAZACBaACA....XAEADAFAdBCARBEA..SAHBhAFAQDEBCCEALDGBhBAAHDGBEFBAAAIBKECA.gEEHhBHAMHBA.PHCAIHHA.NICB..hCAA......hCBA...,1,-19,-27,8
RYGBcZfVMKTHIdFbWJUPNXeLagQOAECDS,EAAASAAARACA.GACAZAFBMAIBHAEAdCCDFBHD.JCFBUEEA.hAAA.XEAAeCHDaDABhAAAQEGAAFCA.hADADAGABFAAfEDAKFHDIHBA..hAFA......hBHA...,2,-19,-6,13
VeFfJaYIGZCPDbBNOUcLdREKXHgMTAQSW,QAAASAAAeACHFACE..aAEDGAEAZAFBDAIBBAGA.OAHDhAAALDCBEDDBHDFBhABAMBHBADIBfDHEhAEAJEEACFHA.bEBD..cGGCdGACKGHB...hAAA......hCAA...,2,-28,13,41
PDFgGBQEbKCScdOIJYeNTAaHZfRVUXWML,HAAARAAAUADAMACALAGBFAFDGBDABBFB.EAHBKCCD..CCCCdDGAOCHDhAAA..IGEAhAAAeDEBAAIB.aGGAZFDFfHCBhAIA..XGFADIFA...hCAA......hCHA...,1,-11,-28,17
NMACSZQYEGdUbOXFaDLWJBVgRKfeTPcIH,ZAAAEAAAdADAOACA.FAFDaAFA.LBCDBAHARCCA.eAHH.TDFAhAAA..ICHAhABAHDDBABFAQFGAhCAAGDFA.bGCADEEB.JFHB.KHAA.fHEBhAHA....hCAA...,2,-29,7,36
GNcCMJOdeaVYARXUFIWKZLTESDBbPgfQH,RAAAFAAAKADCZACBLAGB..EAEABBEA..bAGD..fCCAhAAAHCEBGECACDEA.hABAMEHBdEGAeEDBaGBHAAIBXGFDhBAAIGBASFFDDEIB..hAIA......hBGA...,2,-35,-4,31
LOCNgbePcEJKMRYaDSFQdHTXVWIGAUZfB,ZAAALAAACADB...bADDeAEH.EAGAMAFARCAA.DBFAFBHDHCABhABA.TCGAXCFDhABAIEEAACAABEEDOEGBhACA.PFCBKEHBaFDCSEHHdGAAVGFA.hACA......hAGA...,2,-14,0,14
aSdMQIKUePDAXFZVcHCGTBJNRLYEgWObf,ZAAAHAAAGAEATAEABADBRAGFLCAAEAGA.OCEBaBHD.dDGDMCABhABAQEAAKCCDeDEDhACAAFFAFFGDCDGD..NEIA.gGAGhAAA.WFHHbGAASGFAhAGA.....hACA...,2,-6,-1,5
MSNFOebHPWdEZLBCAKYQIcgafUJVGTXRD,QAAA..gAAAaACEUAFAGCDARADAMAHBFCCBeBHHhAAAHCFBdDAAEEHFZDAFLDEDhAAAACDBKFBA.IFHAhABAfFFA.JHBAXFCDSGHHhADANAIA......hAIA...,2,-5,-4,1
JDcMGWAKBePUfOCENVdbaYSQFRXTgZLHI,eAAAUAAACADAEADA.dAGA..aAEDQBEA.RCCB.TAGAhADAZDGBHFEBDCDBGCEBhAGAAAAABEFB.OEEBNEIA.bFGBhAIA...FHEE........hBAA......hBCA...,1,-9,-24,15
FLEAeXYKdPJTODVMBcIbaRWGUCZHSNfgQ,eAAAKAAAdACA..TADADAEABAGA..bAFBRBDFGCFA.ZFBAhAAAHCCA.fAHAhAAAFBHDAEIB.XDFAhABAJFHF.MCIB.aEEC.CFCASGGAhCAANIAB.....hAIA...,1,5,-36,41
AGBgPMFHISYDedKLbcaJCZfTEUWNVRXOQ,GAAABAAAMACAHADA.SAFEeAEAdBCALBHBaAHDZCDAEDHBUCEAhAAA..VEEBRFFAQGDChAIAAAABFFCBDDABKGHBhACA............hADA......hBCA...,1,-2,-23,21
IdXDJUCLTHcPMAWeONgaQFVKRYZEfBSGb,eAAAOAAA..aADDQADAKAFA.RAFAEBBBSAHB.hAGAGCDBdCHADDDACDBAHEEChAAAMDGBAEEANDIA.FFHBZFAABHDAhAIAIHEA........hABA......hAFA...,1,-16,-25,9
JQNIUCeBTZdXYALWgRHFDVEMOfPacKbSG,LAAARAAAHADBDAFAEAEA..MAIBOAGD.aCAAKBFC.GCGAhAAAQCECIDAAeCHHhABAZDEBdDDCACCBFDDHVEAB.hABAfFFAbGFA.SGED.hADA......hCAA...,1,0,-9,9
LKDCGPbUYFBSXOaVEdRMQWTZJAHeNfgcI,HAAAeAAA...fADBIAEALAGBCAFBGAGA.UCCABCADhAAAOCFHECCARCEBMDIBhACATEGAAAIB...gGBAhAAADEEBbFGDFGDHaDBB.dGGD.....hCCA......hDGA...,1,-4,-11,7
cDaWedRJgBGXOPKENYCAIMZbHFfUTLQSV,ZAAAHAAAFADATAEALAGBQAGC.SCAADAIBeBFFRCAAhABABCEDGECAOCHDhAAAEEEBCEHAAACAbDCD.fEAAhAEAVGFA.aEEA.dFFD.JHDA...hACA......hCAA...,2,-14,18,32
GaEVIMWHBXPYCAfSRODKJdeQZFNgTLcbU,RAAAKAAAeADEZACBFAED..TBDALAGBUAGAGCAA.EDEBMCCBhAAA.HDDCBDHAXDGBhABACEGDAAIB.OEHDhBIAdFDAQGBAgGFBaFGE...IHHAhAAA...hCAA...,1,-9,-15,6
fIPTDLFHUVdgOEcbXMQeJRYGBNSaZCWKA,..IAAATAAALACBHACAdAFAEAHBXAEA..eCABhACARBGFGCEASCCAhAEAZEAAKEHBACHBDDFBFGFD.gDGAhAIAOHAA.bGDA.MFIB....hCBA......hCCA...,2,-11,-7,4
DTgbANXMLRBIJVHUfKOFacPdESGeCWQYZ,MAAARAAABADB..VADAHAEB.KAGAFAGA..aCCBdBBAGCGAeCEAQDCDhBAAZDDFDFIB.hAAATDGAACIBLFFBhABAIFFAfGAA..OFHDEGDBCHHD.hAGA......hAIA...,2,-13,-10,3
SODAcJIbeCQMXafZGBUWVENYFKHgdPTRL,JAAAeAAA.MAEA..aADAGBCABAGAUCCAEAHFFBEA.HDGBdCFARDGFhAGALEEB.DCIBhAAAAAIB.IHHAQFDAhBAAfFDA..WEBDNECA.KGGD.hABA......hCAA...,2,-36,-4,32
BNMURKQHGZFOTYSbdXIAgeEPCWDaVLcJf,EAAACAAADACALADA..JAEBBAHA.MBCBRAGBHCBBZCFATDDAhAAA..bDFAdEAAAAIB.hAAAeEGB.aFFHfEEEhAGAKGCAFHAC.SBCB.XGCAhCAA.IGGAhCBA.WHFA,1,-16,-29,13
UgNSYMIDbAacJKQLHfEWBVedFCXTROZPG,aAAAKAAAHACB.EAEABADA.eAEHdAHAXBFDRAGBZCCFGCFAUEAAhAAASBBD.hACAMDABbDECADIB.QFCChAEALFHBfGAAFFFAOFHD.gFDAhADA.NIBB..hBHA...,1,-4,-6,2
XTOaWNIfReDCHUJFbQKYAdSPEgcZMVBGL,dAAAEAAAZACBMADAGAEALAHB..TAGAaBDA...IDGAhAAARBFFeCAAHDDBFEBAQFFAhAGAADDBSECDhACA.gFGABCBCOEDDfHBBhBAACFHA......hBCA...,2,-13,-8,5
MBSDEfdRcTaeVUFgAJOGCQPbNZHLKYWIX,GAAAQAAA..bADAHACALAHBKAFCIBHAMCDBDADAECDAhAAARCEB...aCFDeECDhAAAFDHBAEAACEGA.ZEAEXFGAhACAfEEEdHCD.TGFA.....hBAA......hBCA...,2,-5,-2,3
FVBKRTSHMIaNXUGeAQfODEcWgZdCPLbJY,QAAADAAAEACA.....gADAdAFALAHBJAGBFCEDhAAAKBBDRCDBHDAAaDCHUEGAhBAAAADAOBHDZFBA.CEFAbEGDBFFChBEA.MIFA..XGAAeHBE...hBFA......hBHA...,1,-4,-13,9
KEgDSdXUTFBfQHVAWbPICMGZaRLcYeONJ,...bAAACAAAZACA.RAGBLCCBeAEAOAHDKCED.ECAA..SCGDhAAAdCEATDGABDAAhADAHEAAAAFA.IFFAhAAAGFEBaDHDcGCA.YFHBNIAB...hAEA......hAIA...,2,-27,8,35
LWUfOPCIgdNXRJYFGTeHZEMaQSVAKDBbc,BAAALAAAUACAOADD..CAEAdAGARAFAFCAAGCDBHCEBECGA.hAAA.aCBHQEGAhABA.AAFADDDBbEEA.fGGEhACAIGBAXGEA...hAIA......hDAA...,2,-34,-15,19
BMNCUfcWYdeAOKIEgRJbaLVQZFGTDHSXP,KAAAEAAARACA..aACALAFBZAEBGAGAHCDB.XCGDMBDBCDFA.UDAAhAAA...fAHEhADAcECC.dFFAAAIBODHDhAAAIHHAbFFDQFCDDFFBBGBA.NIAB.hAIA......hCAA...,2,-18,0,18
XSfFcVPDHLbEYUORdJaZAKIWeMNGgCTQB,KAAAeAAAGACACADA.QAEASAEHFAGE..VAGBHCABECCBhAAAOCFE.REDAaEHBhAAAADFAMDIB.TEDAhABAfGEADEHBLGAAUGGB.ZGFA.NIAB..hACA......hAEA...,2,-4,-2,2
LDbJIPWUeHFGTgQMYCBVScOaNZKdfEARX,RAAALAAADADA.JAEA..IAGAUCAAHCDAGBDA.QCFChAAAMAIBBCGBSAHHhABAaEBEZEFA.dCCCAEGAXFCAhABAbEGD.eHAATFBACGGA.OFFBhBFANIEB.....hACA...,1,-5,-14,9
aBDRPAHZSYLKNQeICTVEgFXUfGJObcdMW,HAAAZAAALADBQADCeAFATAGA.ECABXBGAGCDBbEEAhAAAdCAAaCCHBFAARDFAAAFAKGCAhACACCFD.FGEA..fEEEhABAOCCHMCIBDFHBSGGDIHHA.hAFA......hAGA...,1,15,-11,26
cDCPeaGXRIFETSYBHVKfdZALWQObMUJNg,LAAAQAAAMAEAUADA..JAHB..gAGACBDA.hABAeCHFGBEARDBAEDFBTCAAhACABFBDHGDAKDDDZEFBhBGAAAGAbFFADDIBaGCA.FHGE......hCAA......hCCA...,2,-15,1,16
WaAbMYeUDdJXPSfZITOVFKNBLQgGcCREH,MAAAeAAAdAEA..XACASAGAZAEBOAGDKBCBLCGBhAAAGCCARDEFHEBBAAIB.bGDAhABADBBB.fDHAhBAA.TFEAFGAHBEDCQGBCCHHA.hAGAEGHB.....hAHA...,2,-5,-5,0
GIcYWFEXKSARgQUfCBNbLeMOHPZTDJdaV,RAAAQAAACADB.BACALAFAeADHHAFAZCCADCEAaCEDGCGAhAAA..ICHAhAAA.cDGCFEEHEGAASEDDhAFAAAGAfGDEbFFCMHAATGFA..hABA......hCAA...,2,-27,1,28
RIMTdLeNYUSZQfJcaFbgWEPOBCHVDAGKX,GAAARAAAMADA.dADALAHBeAFAUCFAZBDB..QCFAJDDB.hAAAaCCBFEHD..bEFAEFAAhACA.BCHAHFCAAAFAXFFDhBAATGGASGBD..cFDDhBCA.....hAAA...,2,-16,-5,11
DbGgBCcRAEFTdUfaPZXIQJHYLeKMNVSWO,EAAAdAAAaADAZACB..QAEAHAFBeAHBMAHBSBDB.DCCBhACAGDEACDDD.AAIBTGBAhAAAfDFEXDGAhBCAIEHAYHFGLHDAKECB.WFFG.hBGA......hCAA...,1,-10,-11,1
ebdaEVNRJgfFTMBOICAXLcQDWYKUPSZHG,LAAAQAAADAEAKACAUBEAZAEBHAGBGAGAeCDDdCAA..ECCARDFBJEAAhAAA.FFHDMDIBOFFHhAEAAAIB..XEEAhABA..cGBAPHFA.....hAIA......hBGA...,2,-17,-5,12
QdGUYXfFPTWcDeNJCOSIELZAMbaRHKVBg,aAAAHAAABADAdADAGAFA.UCABXAEDFAHF...TAGAhADADDDAeDGHCBBD.SEEBhAAAECDBACIBRDEF.KFAAQDGChAGA.fFHAPFHDNIDB..hAIA......hBAA...,2,-31,-9,22
UISgQVaMJNOPKdfeDEbXTLFZcRCHYWGAB,BAAASAAAQACAMADA.OAEC.dAHAeAFADCAAECEAbBAALCEAhAAA.ZDFEhABARDEAHFGBGEBAADDBgGAAhAAAaEEHPFHBfGFAFHDA..hBEA......hBIA...,2,-10,-4,6
TGCHYWQbDRKUFfMSBIPJaEdeXgNZLAOVc,OAAATAAA.HADAQACCRAGFFBBH.MAEABCEA...IEEAhAFAaAGEEBEFeCFA.hAGAXDDCZEGBACIBcGDAhAIAGEFA.CDHAbGCCKDCB.......hBAA......hCAA...,2,-24,5,29
IZOUPHYgeQSXFfaLWRJAVCBKDcEbMGdTN,BAAADAAAEACAGACA.dAEBTAEAZAGBOBEDHAGBeBBB.QDDAhAGAFCABaCHDREEA.AAIBKDFAhBAA.MDIBUGCAgFGDhCAAXGGA........hCDA......hCEA...,2,-18,-10,8
FRePaXMVGCQfOUSYTHLcJBNDgKAIWbEZd,..IAAAEAAAdADARAFA..eACAaBCB.MAGBGCEA..QCAAhACAOCGFSDDDhAAAHCDBLAHBBFAADCIBhAFAABFBZEGBXGAAfFDETGFAJHBAKFFDhADA......hBHA...,1,-6,-8,2
dBFPAMegbERGJHaNKLSQXVTDcIZWfCYOU,eAAAEAAARACA.HADA.aAFALAFB.QCCBTCCADAIBZBGBhAAACCFAOCGDdDAAFEEBAAHAbEEDhAAAJEHB..KFCAXFCDhADAIHHA.WDHHfGFA..hCAA......hCBA...,1,-7,-13,6
fCBeQVLbcNHRMaSPITgUJWXdOFYKAZGED,EAAACAAABACA..eACALAEA..bAFAHCAARCCA.aAHDSCFBhAAA.TDAAhADAgCEAUEFBXGAAhAGAdDHAFECBAAFAGEFAQGGBcFCDMEEBhAHAIHEAOHDE..hAAA...,1,11,-27,38
PBZUYMbOHKNRgJIGDWTSfXcFCVadAeLQE,eAAAEAAAZACBMAEAHAEARBCA...JBHBGBFADAGA.TDBA.XEDAhAAACCBCdCEDAEEALFFAhAAAQGGABEGDbFBCKAHBhABAIHHASDHH.FHCA...hBCA......hCAA...,1,18,-29,47
JfYSCTDbXVOBQFaGEWUHAePZcKdLMRIgN,eAAAZAAAdAEARADA.....IAGAJAHBSCCBDAIB..XCAAhABABCEAaCFDECFAHEAAhAAAAACA.KDHBLDDBhBEAMEEB.fDHATFFAbGAAQFFChCAA.FHDCWHFA.hCBA...,1,-8,-23,15
JDOZBYadPHRTUbGMNAXKIWLgECfFecVQS,KAAALAAAEACE.FAEAeAEEQBDD.DAHBZBCEBCAAdAHAHCEChAAARCFF.bEEAGEDAhABAADDB.XGGAIHHAhCAACDHA............hCBA......hDAA...,1,-21,-22,1
KgRICeAMEVBZabFWNJQdYULcOXHSDfPGT,EAAAZAAAaACAFACD....JAEAdAFA.LAHBOAHD.HCCC.fDFAhABAGBDATDFAhAAAREGBeFBAACFABEHA.hBFA.NHBB.QGGA.YHAAhAHA......hCAA...,2,-29,-5,24
PKLgbHaMNETDGFOUWfSdZBIeJAVYQRXCc,QAAARAAACADB.KACALAFAHAEBaAGAECCAGBGAFCED.OCDBhAAAUCGA...SEAAhAEAZFFAeGAAAAAAXEEAhBGA.PFHDMIDADHFA....hAGA......hAHA...,1,3,-28,31
dAWVMQUgSIaPfHTYRXGFcJeZDCKOBLbEN,MAAAQAAAUAEA.SACA.aAEDHAGD.RBBBGDEAhAIAFAGAeBFHZEGBKCDDLEDDhBAAECHBADAA..gDAAhAAAfEBETEFA...cFGDhADACBDC.BHEANICB..hCAA...,1,-7,-19,12
gDfVXZePOHGBbdRJAMCQNUYSKILTFEWac,MAAAQAAAUAEA.KACALAHBFAEA.EBBAaAGD..DCDBXCDAhAAAeDFBHEBAGDFAhAIAdEHAABGACCHA..SDCDhBIATGDA..WHFAfFHA..hCAA......hCDA...,1,-12,-25,13
BSRJGaTIUAZQHENbLWKcOVDCdYefPXFgM,HAAAEAAALADAKADCOAFCCAHA..dCBAeCAA..XCFAhAAAMCEARDDAaCGETDDA.AAEAZFCAhAHAbEGD...cFFAhBCADEIBfFFA.FHAASDHHhCAA.....hAAA...,2,-14,-11,3
LeGWbEgIZAXPVOKJcMfaYUQDHCdNTRFBS,XAAAOAAAKADA..MADA..aAFAQAGAHBECdCCARDFASBCHhAAAeEDF.bBDDhABAEFFBZCFAAAIB..PFHBhBAAcEFB.UFBADBBBNICBTGGA.BFHBhBFA......hBIA...,1,-8,-9,1
DaBdKCObgJVXLYeGRZSfIUQTWEMPAHcFN,HAAAFAAADADAdADA.OAFA..bADAVBFBLAHBGCABRCCAZEEAhBAASCHH.IEEAhAAATFCAEGEAAFBAaFBEhACACGHA...JFGBeHBG......hBHA......hCAA...,1,-3,-20,17
aLHcXWEZNTbIJPKMYCdgFAeOUSfQBGVRD,eAAASAAAQADAGACARAFALCCBHAEAXBGAECGAZEDBbDFBhAAAJFFA..KEAAMGAAhAAAdEEAAAGAOHECBEHAaGHBhABA.NIAB...........hAEA......hAIA...,2,-4,-2,2
XQHSLfgDCRKaIGTUOBPMVYFZbNJeAWdEc,EAAAQAAAHACALAFBDADARAEA.KAHBGCBBOCCBMAIB.FCGBhAAAbCGD..eECAADEBdEAAhAAASEGACEFC.hAEAaFFCTFCABGHAPHAAYHAAJHEAXGGAhAHA....hCAA...,2,-8,1,9
NagfbRLIHcPXJMBAGYESTZeUKdVQWFOCD,EAAAZAAAeACEdADA.QAFCOAFA.DAIBaBCB....bCCCRBEFHCGBhAAA.XEEChBGAMCHBADGBGECATGGAKGDDhBIAFEECCFHA...fGGE.IHAAhABA...hCAA...,2,-15,-8,7
gACfZFQcHKMedPYbWOTXRGULaJBNVSDIE,ZAAAQAAAHAEAeAHHdADA....bAEDTCAAGAGAaCECBDBAhAAASDDDEDDB.AACAFDHDhABAMDIB.PEGBhAGAOEABRGBA.LEEB.NEGADGCACFEA.KHAA.hAIA......hBCA...,1,7,-5,12
NMKWOgLTBaSUfEdRFDHACXGIbceJYZQPV,GAAA..bAAAeADAZADB.QAGA.VCDAMAGBODAHhAAATCAABDCDaAHBfCHAhAAARDGBHFFBADIBXGCAhACAIEEA.cEGC.JFBA.NIBBKGGDhABA.....hADA...,1,0,-9,9
COeYGUQKDPcWMIgZXLJaAFVbfEdTNRHSB,FAAAVAAAEADA..dADARAFAHCCABAFA..eAGHGCGA.QDAChADADAIB..cCDDhAAAMEEBZFCF.LFFBhAGAADHATEFACHHA.OEHD.KFAA.IHEAhAFA....hCAA...,1,5,-37,42
YUdgZcLMeWJfNbEVTaQAGKDSPOIBFCXHR,GAAASAAAOADAFADAHAFBRAGB.dBHAZCDAMBDBeDBH.JDHB.hAAA.bCDDEEEB.aECDAAHADCCBhABABGFAXEGAhCAA.gGEAcGCD.fHGFhCBA......hDAA...,2,-12,-12,0
ZKGCTMAQgUJOHEebPBSWVfDaRdcYNXFIL,QAAAUAAAHADAEAGEeACABCDD..SAFA.fBHAhAAARCEFdCGANCIAFDAAZCDAhADAGFABMDIBACEAOFGBhADAbEEAVGAADIAA.aGGC.......hAFA......hAIA...,1,4,-11,15
VXFGIRJaeHZcBNCKESfQdLgOADPbWMUTY,DAAA..bAAAMADAUAEA..TAGA..XAGAGBBARBEBhAIAeCABHDGBZCCABEDAhBAAKCGAEEEBQGCAhBBAdEGALHAAACIBPFFBYEBBIHHAaFHDNIEBSEBDhBDA..hBEA...,2,-8,4,12
IRfaOKVYXBAMdgPWELFNDHTbSZUJcCQGe,dAAA..gAAAEADALAGBDADAHAECTBEAZCCA.UDGACCBAeCHHhACARECAODBB.KGEAhAAAXDACAAHA.MDDBhADAFGGASHCGQEEAfFHAhAIA.aGBBBBHA.hBAA...,2,-15,-4,11
OcYPZJeTaSWHCgQKRfDBNVMEGAdULFXIb,dAAALAAAFADA.XADDOAFD.....PAFAeAHBaBDHhACAHCAAQDEDhAIARCEABBHAMDIBACCBUFFB.IECAhBAAbEEAZFBASGEHCDHDKHCADFIB.EGGB.hBCA......hCEA...,2,-20,4,24
PEbBRfgKScaHQYZJDNMVLFeOICWdTGUAX,EAAARAAAKADC..aACDHAFAZADB.DCCA..MAGBLCFAeAHBCCBDdDDAGCEAhAAAAAAA..bEGBfDHEhAIA.SFBAhBCAQFEAYFHFNHAB.OHCAhBFA.....hAHA...,1,1,-28,29
TJPKVWHgBQfGLFCedXRMNaZIDAbOEYcSU,EAAASAAAUADA...TADAKAFAHCBAQAFCGCFALAHBhAAAeAHHRCCBMDABZFDBABCAhCAAbEFAOFGD..hCBAcFEC.PHAA.gGGBhAAABHCC.CDGD....hCHA...,2,-13,13,26
eaSUNWXPLDfHGAEKYFcJbRgMCITQdOZBV,EAAAFAAA..JADARACAMAFA..CAGB...TBFAdCCAZBFEBBHB.hAIAeCCBaDBB.UEEA.hBAAXDACLDGBHDGBhAAAADIBKEDA...bGECIHHA..hADA......hCAA...,1,-15,-37,22
cCPQUTNfDdXKGeESLWAbHMYIaORFgVJBZ,HAAAMAAA.aACARACAFAFA..VAFAZBFE.CCCA.QCCBUDEA..hAIATDGADBBBdDGAGECAhAAAEEEA.LFABhAFAADIBIGGAOFHD.BGGC.....hBAA......hCAA...,1,3,-30,33
LQDYaNARKGdZgTVHbSECPBFUOeJXfIMcW,RAAAdAAAZADB..TADAHAFAECFBBAFB.OAGDeCCD..JCHBXCAAhACAMDAB.LDDAhADAQEECaCHDAAIBKFHBGFCBhBAA...bGFACGGDFHAA....hAAA......hABA...,2,-10,-6,4
PgaFSbHYTDRNMcdKCZXfJWQULVOIAEeGB,EAAAeAAAGACABADA..aAEDSAEA.HAGBTAGARCEBMCBBhAAAdCCAZCFEXEGAhAEAfEDAQFABhAFALEGBOEEHAAAAFFFBDGDBKGAACGGA.....hAIA......hBCA...,1,7,-16,23
KMWfNSLBbRCAdIcPeYGJOaTFDVHgZXQUE,dAAA..IAAAeADAGAGAaACA.TCBADAFAHBCAZDEBQEAChACAEAHFMBGB.fEDAhADALDEBRDGFAAIBPEHDhAEAOCBBFFBD.XGGAKGBASGEAhBAA.CHHD....hBCA...,1,11,-14,25
eZDUfQgXKbVSHMTGWICLAEYJdcBaRPFON,EAAAdAAAaADARACA..OAFAeAFHZAGB.DBDBQBFD.KCCDhAAAbBDDHDABGEFACDEDABIBJDGFhADABCBA.FDHDfFFEhCAA.XECDMIBAIHHAhACA..YFHBhCBA...,2,-17,-14,3
ZXRUEeAHfQdFVCPYObWKTDBMGNcLSJgIa,HAAAdAAACADA.OACAKAFA.BAFAGCABLAHB.SBFAhAAAICFAZCGBRCCAEDFFAAHAQECAhACAFEGD.VFABhADAYEEF..bFEDDEIBMDIB..hAFA.cGGA..hBAA...,1,-9,-17,8
gGVUQKTEZBeJYNMfHCIDWdPabAXcOFRSL,OAAARAAALADBGADAQAFAEAFA.eBHHJAHB..MBBBHCEBhAAADCCBdCCC.aEGEACGBFDFHhAFASFAAUGGAKDHBZGDAhABABHFCfGGB.CHBA.WDDD..hBAA......hBDA...,2,-22,11,33
VcKHQZbEGFPfLINBYOCRXSMWgdAUaTJeD,aAAAeAAA.DAEAKADAHAFCZAFBGCCAFBCD.LBHBBBEDCCFARDFAMBBBhADA..dEDAACCBTEFAhAFAVFGB.....hAAAcFEC.EHCA.IHHANIAB..hAIA......hBAA...,1,-18,-25,7
LcEOZNYaTgJeXKHSRIQbAfdUCWBDMPGFV,dAAACAAADACAGADA.LAFAEAEAZAGB.aCAE..JBCBeCFA.HEFAhACARDEB.QGAAhADAABGBUEGABECAMDDB.FFEHhAGA.OHEE..NCBA....gFCAhAAA...hAHA...,1,4,-42,46
eUWLOVHaQNKfEGBdXPCMIAgJYbTFZScRD,JAAATAAAZADB...RACFDAEAeAFA.LCCDHAFCaCACKBHB.GDEAhADAdCEACCGDACIB....hAAAbDGDSEDDhACA.cEFBOGAAQGGAEGDFBHHA.MIAAhAIA.....hAGA...,2,-19,-4,15
ISRaDUJGACMZYHfNbLOWgdQEPVBTKXcFe,ZAAAHAAA...bADBLADB.OAFAdAGAECABBBFATDCAhAAAXCAAeBFDRDGFaBHDDAIBhACAGDEAACCAMEFB.fGBAhBGAgDGGQGGBKFBAFGGASHCAhABA...hDCA...,2,-12,5,17
KfIeRcXUTSVgBMQCZPFHYLJbGdAEODWNa,EAAADAAA..aABEKACA.eAEERADF..UAFATBEA..SBHBhAIABAHBMCCBZDDAHCGBhAAALDGBGDDAACCBOFDBhBAAfFGE..IHHA..hCAA......hCBA...,1,-13,-30,17
KbLRZQGNaEFIHJBUACMPTgYVSeWdOfXcD,MAAATAAA..VADAeACE.dAFA.OAHBXAGB.KBBARCCAGDFAhAAAECFF.FDBHHDDBhBAABDHAABIBCDGAPFEBhAIASDHHfHGFbGFA......hBDA......hCAA...,2,-16,-8,8
FHZYALXQTWcgdBUMPIKSaVJeDNOGRfbEC,LAAATAAA.....gADHdACAMAEAKAHBaAFDeAHBhABAOBDDRCAA.EBFBHCGBACHBQEFAhAAABDEAIFFAhACASDHHDEDBfFHAbFDDFGBA.XGDDhAIA....hCAA...,2,-11,-10,1
NZBGHcRgQKbeIWXAUdLVDJTSFPaCMEYOf,dAAALAAADADA.TAEAFAFD..aAHBEAGE..OBDBZCAAHCEChABARDFA.QEAAhACAKCBB.eCHHXEBChACAACCAVEEBSEDHMFIBfHCBGGDB..hAEA......hAIA...,2,-26,4,30
VQIDdSaJAcZFPfCXTWMEUgHKbYRBeOLGN,ZAAAFAAACADA..TAEA.EAGEHAEB.bAGBRCAAeCEA.GDGAhABAQCCCdEADaECDABIBfDAAhADAMEEBKFFD.hACAODFCNIABDGIB.SEED.PFFAhBAA.XGBAhBGA...,1,8,-26,34
bQcVdDTfHeEXINCJgRAFGWBZMKaUYPLOS,GAAAZAAAaACA.UADALAFAOAFC..QCCBdCGADCIBHDBBhAAAECFA...XDDAhACACCHAREEAAAGABEHBMFGBKFCASFHBhAHA.cGDATGGA...hAIA......hBAA...,1,-14,-19,5
PHeXLTFSJBKAVNaQfWRUMICEGOcDbYgZd,aAAAQAAA.RACAUAFAMADAEAGA.GBBBDAIB..bCDDZCEEhBAA.HEBALDAAhAAATEGASDGAhADAKFEAABEAfGCACFGAOFHD.gGDA.hBBA......hBIA...,2,-14,-8,6
PeROAGYUEdSBDVcCMaZXfFITbJHQWNLKg,GAAAEAAAdADABAFADADACAFA.ZAGB..FAHB..TCBAHCDAQDGAhAAALCFDKDHBeDBHhACAABCAUFAASEFDhBAA.MICAaEDBfFGAbGFA.NIBB.gFCAhBCA..hBDA...,1,-12,-19,7
eYQaNbLGWdUEIJAKTcOgRBMSXDFHPVfZC,TAAAOAAARADA.BAGBMACA..DAIBHAEC.VCCAZCCAeCFEhAEAaAHDLDGBdEED.EDBBhAAAABBBKEHBSEFFhAHAFGDA.CFCANDIA....WHEA....hBAA......hCAA...,1,4,-37,41
MHJbLaFcTGeVUSQgZERWCfAXIOKBPYNdD,OAAABAAA....PACAdAEAHAGBLAGBaBBCFDBAGCBAhAAAeDFBUGAAQDDChAIAEDHFREDB.fBFAhBCA.ABIBKDHBDFIB.bFFB.......hAGA......hAIA...,2,-16,-11,5
PXVGdaWbeMQZgKROLTJcFIYESBfHDUNCA,XAAAdAAAaADA..eAFHZACBRAEALAHB..TCFAFBDBECBFhACAfDEEHDECDEDBCEHAhBAAAAAAGECAMFFBQGGAhBCAOAHDIEHABHBA.PFAB.hBHAbGFA.....hCHA...,1,1,-4,5
KRXUFfANETeZOBaHIDCVgGcPQbWMYSdLJ,EAAAeAAAZACBBADAHAEACAFA.GCEB.QECAMAHBdCCALCFBhAAAREFAFGAAAAHA.OCHDhABAaCBBDGHB..VFAAPHCChAAA..bEDD.SFGH..hAFA......hAIA...,1,5,-23,28
ZfdYUDWHCLScNMgPbaKGITEeVBORAFXQJ,QAAAZAAAdAEADAGAHBFBLADA.SAGHMBIB.bCBAGCAAhABA.ECCBeBHHhAAAOEDCAAEAXDEDhAIAJEHF.fEHA.UGDACGGDNHBB.aFCB.hACAKGGD.....hADA...,1,7,-16,23
DFUdIAZMHEVONWQgebPLGXCKcYSafRTBJ,HAAAEAAA.OACAQACAeAFALCCAGAEBKCCDSBGAhAAARCFATEDADEHBdDGAADIBZFAAMECAhAGA.VGEAgGFBhAAA.PHAC......hAFA......hAHA...,2,-3,-1,2
cXNICOfPURgaLZDeSWQYHFGTMAKEBVJdb,EAAABAAAdADA..XACACAFA..OAGDUAFARCAALBCDhAAAZCFEDDEB.eCFB.QDDChAFAHEGBGFBBAAIBKDHBhCAA.VFGB.........hAAA......hACA...,1,-13,-30,17
IbcJNZGOYESWgRTQHdKUAXDCePaBMFVLf,CAAAeAAABACAMAEALAEA..IBDAJBHB.GBEAECAA.hAAASAGARCDAHECAdEGDhACAAAAADCCBaFAB.fCGBhCAA.bEFDZGCAODDBgGGAKEHB.hCBAXGAD..hAFA...,2,-15,-2,13
cCafXYIZOBRdNSWeLTQMbVFUEAJgDGKPH,DAAAGAAAHABCaADA..XAEBZAFBRCDBdBHASAGALEGBMDCBhAAAFCCHACGA..KCHBCFFA..hAHA.fDFAhBAAOFCDNEIA.eEDF.bEGD.......hACA......hAIA...,1,-13,-14,1
ERHFbeaXTPfBGcWUISYgMDNLVdKJACOZQ,ZAAARAAAHADBeACE..aAFATAGABBFBGCGAUCCB...SCCDhAAAMCFBLDGBhABAdDAAAAIBQEEChABAEFAAXGAAfGDEIGEADDIBKGGD.CGHA...hAFA......hAGA...,2,-13,-3,10
bLaATUfYIVMPCdEcFSODKNRWGgBQeHZXJ,TAAAUAAA....fADAIADAMAFAdAFAFAHB.DCEBRBDAGBGAhAAABCHA.HCAChACAZDAAJDGFaDEDABIB.PFGBhBGAEFBB.SGEBKFDA.NEIA.QGGBhADA....hBAA...,1,9,-27,36
FbdYMNIDZAUVJfRQGcTSHaXBeCWEOPKLg,VAAARAAAGADA..SADBHAFAaCCHeCFAEAFA.KDABLBHBhAAAFDHDdEFA.MCDBDFABAAAAfCEAhAFA.TEFAhAIACGHAOHAC..bGCA.ICGAhCAA......hDAA...,2,-17,-9,8
GWRMPCVaFgeILNdXEbJABcKODTZHfQSUY,KAAATAAAHACB.QAEASACBGBGARAEA.MCABCAHBaCCCeDEBhAAALCGBdFDAEFHFAAEAODEDhAAAZEAB.fECAhCAA.UGEB.WDHHFGFDNIAB..hACA......hAEA...,1,4,-8,12
gCfSNcXIFAQJdDUBOTLeHVEGaKWMbYRZP,dAAABAAALADAHACAEAFEaAGDKBHB..MAIBRCAAZCEA..CCBA.SEAAhAAA.XEEAhACAAAEAQCEC.hAEADDDBTFCAeDGFWEHHbFGD..PHAChAHAfHFB...hAIA...,2,-32,-9,23
cebVDEHUXCTFQRgNJdGYLPaBIWfKMZASO,OAAAeAAADAEAHADAUBDACAGB..FBBHRAGB...JBHBGCFA.LCCDhAAAaCEDBDCAfEEEhABAZEDEACGB.SDHHhAIAbFAB.EGHBTFGANIBB....hAFA......hAIA...,2,-26,-9,17
LBFScAOTGMWERXHIYfJNZgQeDbCKVdPaU,GAAAEAAAHACA..fADAZAFBeAHFCCCDdAFAUEAALAHBBDEDFDHDhAAAAAABMCEB.RDFBXFBAhACAIFFA.NDAADEIBhADAbECD...KGHDaGHBOFFH...YHBAhBCA...hAEA...,1,8,-15,23
aAbZQGCOBUKPLfFWHISdRJcDEgNeTXMVY,ZAAAGAAABADBKADALAFAFAFAHCDAdCAARCGF.DCCB..EDCB.eDADhAAAMCFA..aEFHAAGAQDDAhABAOEHDUFCB.hACA.fDFF.SDHHhCEA.gFGGhDAANIAB...,2,-38,2,40
TaSCGJebULXdMWNKVfDFEHQBYRAgOIcPZ,OAAA..IAAAZADBaAFD.GACAeAHBLCCDdAEBMAHBKBFDhACADBBBHCGBQDFDhAIARDEBAFBB.PCBBTGDAhAIACEDAUFGBXGGANIBB.......hBCA......hBIA...,1,0,-14,14
WAHIcaQSERBZPFbNJDXefMCGVdLUgOYKT,HAAAaAAA.EADERACFZAEBFAFA....JBHBeAGFMCABGCGA.dEAAhAEALCCAOECATGFAhAIAACGBQECABFFC.hBAAbEFADBBBCGEA..gGGB...hBIA......hCAA...,1,-7,-13,6
FQgdBOfSLZPDXGIEHUeVTRNWJcAMYabKC,aAAACAAAFACA..dADABAFAOAFALAHB.ZBCAXBED.hAAAEBBBHCFBUCGAeDDBhAFARDBA.JEHBAEFBMFGBKFFD.hBHAQGBASHCADFHB.....hCAA......hCBA...,1,-13,-26,13
SPARWZJNaIFUYLOVHDbfcCBTQMKeEdXGg,RAAAZAAA.aACAFADA.LAGBHAEBDAGA....bCCACBGBQDDChABA.eBHHEDHFGECAhAAASCCDAAIBJEFBhABAIFFA.OEHDfGBETGDAhCAAdGHAPHFC..hCBA...,2,-14,-13,1
RGXNVSADQFJKgLaeIPTBbOfYEHcCUdZMW,QAAAKAAALACBeACA..TAEAbAFA.OAGD.ECEBhAAAHCDAUDGBZCGFREAAGGABhAEAXDAA.SEFBhAAAAAIBFEEHaFHH.BFCA.fGAAhADA.CGHAMFFB..hAGA...,2,-10,0,10
dWMOaJDfNGPBKCAIVESFXQeLURcTgZbYH,EAAAXAAALADARADA...TBGAZAGBHCEBdCBAMCFBaCHDDCDBGDCAhAAAKDAA.AAEASEGAhAHAeFGBUGAAbGCAOGEAhAIA.fHEB.BHHA..hBCA......hBIA...,2,-7,-7,0
KATWCNHVeDEULXRBGdQfPIbcOgMaFJZYS,TAAACAAAHACADAEA.LAHBRACFdAEA..QAGA.fCAEhAAAbBFDOCABaCEEhACAZCCEKDGAABHB..VECAhAAAEEEBBFHA.GGABIFGAMHFAFGHD.hAGA......hBIA...,1,-6,-11,5
XYbaLGTfAPDUCSKBIFQdJMHOcNgRVeZEW,DAAASAAABACAFAEAdADA.HAFA.OCCB..gAGHhBAARCGBeDEBEFAB.XFCAhAAAaBBCGBDAAAHACFHAQGFDhABAMCIBVDFBZFCA.....YHDAhCAA...hAFA...,2,-20,-6,14
aLVHKEgMbZYIOGBJRcPDeUQSACFfNXdTW,FAAAXAAAdADA..aAFAHADA.EAGEMAIBZCDAOCFAGBEARDBADDAAhAAA.eDHFQDGDhBAAAEEACFAA.TFGALFFBhABAKGBA.YFHBBBGD......hADA......hAFA...,2,-13,-6,7
YDOJZITeKbdgFPMGANCQcRaVSWfXEBLHU,QAAARAAA.aACESADB.XAFAEAFAHBFCDAIBhAAAZCDAeCCBdDAAFDHDGCEAhABAAAIBCECAVEEBBCGDLEHBhAFA.OGAAIGHAKGFB...hAGA......hCAA...,1,-6,-17,11
LIEUecVBaFHOfPKZSWbMDQAdCYJGXNgTR,dAAACAAAGACA..XADA.TAGARAEAEBHFeCAB.BCFAhAAAHCACODHDKCFAZDEAhACASEADbEAAMCIBAEAAhADANEEALFFBIFFAcGAAaHAA.fGHAhAEA...hACA...,1,0,-19,19
WLOGBNaEDMZATPfFRIHcdCUJbgQKXeYSV,TAAAFAAAHACB.dAEBCACB.UBFB..bADDQDEB.eCHHhAHASAFALGFAhAIAGCFA.aAHDMIBAhBAAAAFARFCAIFHA.JHDE.XDCChAAA.....hBIA...,1,-7,-17,10
ZfaebAPVYKRTJLNFUcWCdMgGDEOQIXBHS,VAAARAAALADB.FAFAUADA.CAFA.dCCCGAGAEBFB..QDFBhAAABDDAHDFBZFFAeEHHhAAAAAIBKHCATFDA.hABA.JHFANIAB.MEEB.......hAIA......hBIA...,2,-18,-12,6
RYKfUeIFHEBPAdNGXLOJZWMVQagDTSbcC,GAAALAAAZADAMAEAaAFA.DAIB..TCDASBCA.CBFA.hABARCGBKDCDUDDAeEABHBGBhACAEEFBAEGBdFBAOFCCVFGBhBFAbGEA...........hCAA......hCBA...,1,-1,-17,16
GXfIFdPbeYAJETBLSZCMOgWUcNVaDHQKR,EAAATAAALADA.ZAGBMACA.OAEEUCBAVEDAHCCARCFFGGEBhAAAXECAFDHDdFAAhAEAeCHHABIBBCFCCAHB..hAFAgFFG.NDBAaHCA.DFIB..hAAA......hBDA...,2,-7,-4,3
CbNROMTIgUdDcHQFEKXWeaGVBLAYPSfZJ,SAAAZAAACADB.RACF.MAFA..TAFAUBFAdCAAHCDBECCBXCFAhAAA.eDHHhABAGECBLEABABIBfDHAhABAbFCAOHAEDFIBQGEAKGGD.hAEAaGHH.BCEC..hACA...,1,13,-25,38
IFDZaUefQKJTWCOYbEMcBANGPgRHdXLVS,GAAARAAAHADBdAFBLADA.SAGHDAIBaBFDUDAAeBHHKCHDTCDAhAAA.ODCBhACAEDDBMEGBAAEA..gEFBhAIAIFHAFFEDZFCBfGHA.hAAAWFFDCHHA....hBAA...,1,-7,-16,9
aNCXYKMWITfGBUHOLDVbdgAcPQFReEJZS,QAAARAAAEADE.ZACBaAFACAEA...KBFAMAGB..TCCAhAAAGCEAHDFALAHBhAAAbECCAAIB.FECB.eEGFSFGAhABAYEHBfHDBOHBA.DHFA.hBCA......hBHA...,2,-10,-9,1
FAcEfQSMJGeZKgOPaVUTWdINRLYDBbHCX,EAAAQAAA.MADAeACAZAEEOAFC.aCCATCEAdCFARDAALCHBhAAABBHAHDBAFEEHhADAABDBSDGAhAAAKGFA.gFFAPHAAWHEGIGCA.hAHADFIB.CHDA....hAIA...,2,-11,-4,7
AWDQOGSFCLNXPgEVfBIJRZdbUHMTKYaec,QAAAGAAACADALAFA..XACAECDABCFARAFAbCDCHCGBhAAA.MDABKCHBeDABhAAAACIBODCBFEEA..gFCAhADAfEEAZFGBdFGDYFAFaGAD.DHEAhAFA......hAGA...,1,-4,-5,1
GYNMBWHUQFbCIZDceVKPgfSdOJTXRaALE,EAAAGAAA.MADAHACAQAGACAFBZAGBeCCAKBFD...fCDAhAAAdEAATDEARDFAADCBLEHBhAAABEEDFFGDbGCADFIBhACA.....cGDA....hBAA......hBCA...,1,-8,-17,9
eYAHZBQFKRXNfdLJCWOUPIcbDSgaVMTGE,HAAAZAAAQAEARADF..fAFBdAHALCABCAHBOCABhAAAIDDADCCB..aCFAMCCBhABAEDDBACIBKDFA.XEGAhACAJDFBUGGA.cFDCbFDBSGBAhADA.TGGA..hAEA...,1,-6,-15,9
UJGPAWdVBHRfOKLXNSMgZCaQTFcDIYbeE,dAAAHAAARADAKAGCLADB.SAFAZABBQCEATCFADBIBbDCChAAA..UEAAGEGAhACAACHB.BBHA.XFAChAFAMDDBaEECFGFH.cFCDeEGHEGDA..hAEA...WFHH.hAGA...,2,-17,2,19
XVfGDeFLCWbUZTEBYagSHAMIRdNcJPKOQ,RAAAdAAA.JADAOADA.QAGA..fAGBhACAeBDFLCFBCBDDUCFAEDHBaCBDhAIAHEDB.AAAAMCCBhBIAIDDAPFHB..XEGADGGB.bFDBhBAA.TGGA.BCHAhBCA..,1,-9,-24,15
BYNZbMgPACQcSOeXKGWVIadLEFJHURDfT,QAAAOAAAKADAGAFA..IADAdBHAEBBB.HAEBRDCADEHBhAFATAGA.BCDDhAAAZFDBMFGBACIBSDEAhAGAeFHH.XDGDaHAA.FFFH.fHGFhAIA....hBCA...,2,-21,-10,11
PKNHXSaMgGAEBYWIZecVJRFbTQUdLfOCD,EAAABAAA...IACAeACAVAFA.RCCA.TAEAdDAALDGBhAAACAGB.KEEAHCCAaFCB.hADAGCFAACCAZGEA.FBHD.hAIAbEAB...fEEEDCIB.PEHDhAAA.NIAB.MFIB.hAEA...,1,-1,-24,23
ZXKTUNLQDgaFfPeSYBOWRHCVMdGJAEIcb,EAAA..bAAAZACBKAEAUAFALAGBDAIB.FCAAeBEDBCEA.REAAHEEAhAAAMCBBGDFA.hABAADHA.XDGAQFBAhAAAaGCASGGAOEEHCFHA.....hBCA......hBFA...,2,-16,-7,9
YHOMafBZWXATLJKUNeQPGIFSCDdERVgbc,TAAALAAA.KAEAeACEGAGAFAFADAIBRCAA....VCEBbBDCHCFChAAAaDHD.ZEDAAAIBUEABhABAQGEC.SEHHhCAAEFGB........hCCA......hDAA...,1,-9,-17,8
DUCWafMNPcOLYIKESZGQVdHBbgTeJRFXA,CAAAaAAA..MACA..PADALAGBKAGAZBBAGBCA.dBEBHCEBhAIABCBCTCGAREEAAAIBDCFBhAAAfDBA.hBCAODDHEFHFSCHHbFGBeGCA....hCAA......hDAA...,2,-26,1,27
FRbgWVCTaLJYGOPKEZQdcSHDfBAUNXeIM,XAAAeAAAMAEARADA......bAGBgAGA.CBCAaBDDhAAALCDA.GDAAhAAAKCFDECHFdEEAHEEChABABDHAAEIBIFBAFFCDTGFA.....hBFA......hCAA...,1,-10,-22,12
QMHFecPSbUACBYGLaNIKdJZgTREDfOWXV,BAAAGAAAaACAKADAZAEBRAFF..DAIB..OAGD..XCDChAAAMAIBHBCDeCGHSCBDhAAAADABLECAdEEATFAAhACAEDGBVGBAQFGAFFHD....hADA......hAFA...,1,-7,-16,9
aYUNegBXcQOVEFZDPJWdHMTLbCSKARfIG,RAAAGAAAUADA.eADABAFAQAGA.ECDAZAGBDCGBJCCFHDEBhAAALEEASDADhACAAAAA.aDCC...gEGHhADAOEHDFGCAdHDBMIBACGHA.KGGD..hBIA......hCAA...,2,-34,16,50
HYLBWFAgcVUTXSKMCQJEPfODZdeNGabIR,VAAATAAA..KADCMACA..QAFAEAFAOAHDdBHAeBDBhAAAaCDARDDBHCFB.LEBBhBEAFDGHAEIBUGGACCCDfEHAhBHADIAA.ZFCB.......hAAA......hAIA...,2,-23,6,29
BAQXZLYcFfHSMWdRVTEDUIPeJCGNgObKa,ZAAALAAAFADAHAFBMAEARCAA...EAHFDAIBUBEAeCEBGCAA.hABAOCCFaDGDAAHBQGEAhACAXDGA..fEEAhABAdGHA.TFGA.IGCAhACA.CGFDNICB...hCAA...,2,-19,3,22
ENJQTgLdZBfWPRCDMKGFVacSHYOAUIXbe,XAAAEAAA..QACALADAZAGBfAEFRCDBMBIBGEAAhAAAaAGDHCDCAAEAIEGAhABAeBHHTEFA.dGBAhAAABCFCCFHADCCBFDCHSEEDOFFB.NIEB..hCAA......hCBA...,2,-9,8,17
SaOJdMKQXEfZIWHVDGAFecRPBTYLUbgNC,eAAARAAABADBLAEAUAFA.....bBAACAHAOCCBdCEAKBHBECGBhAAAZDEA.HEFAGECAAAFAFEDHhABA....TFFAhAAANIABaGHB.MCIB........hABA......hBFA...,1,0,-33,33
CMIRZTPSGWVEDdKeUXNLaHgcBFfQYObAJ,MAAARAAAZADB...TADAGAFA.EAHBdAFAeCCDUCBALDABhAAAHBGBBAHBQEEChABAODDDABBACDHASFBHhADADEIBXFEDaFHBFHGEfHDB...hBAA......hCAA...,2,-20,8,28
BARbLFfHYCSQPMEKdIGceNUWaJTOVZXDg,RAAALAAAHADBCAFA.QAEA.EAGAdAHAGCAAeCCBUDGAhAAAaBHD.TDAAZCCADDGBAEEAFFAHhABASECA.hADAMEHBKFDAIGGANEIAOFFB.XGCChAFABHCA......hBHA...,2,-11,3,14
EZCWUTLdfNbVDMgOYIXJFGAHRPSKQBaec,HAAARAAAKADCBAFAeACEEAFE.ZBFECAHA...TCCAdCCA...bDFAhAAAMCFA.ODFAhAAAXECAGECBAAHAQFFAhCAAaEHD.cGDCLHAA.fGEAhABADGIB.gGGGhAHA,1,-8,-26,18
ZeIRSgOKbDTYWLUEdCAFMPNQfBVJGcHaX,MAAAQAAABADAGAEAHACAZAFB.RCDBOAHDDAGA..TBBAhBAALEAAEBGEADDAFDGD.hBBAfFFEVDGBaEEH.hBIAeEHH.SHBAbGDA....hAAA......hAEA...,2,-15,-3,12
QTLJPeSXBIOEbCYaZcfAWRHNFVGUgdDKM,HAAAFAAAGACAdADAMAFALAEA.eAHHBBFA.EBHBCCEAZDFEACABRDDAUFBAhAAAKFAA..TFGAhAFASCCG.ODGDhACAaEEH..fGCANEIADFFB...hBFA......hBIA...,2,-16,-16,0
DAaPGHOZXEINecdWJRUCKFBSLgQMfVbYT,GAAAHAAAZADBEADAeAFAdAGARCDAKBHB.BCADLDHB.MDABbCED.hAAADAIBACCA...aDCHXDAAhACA.IDGAhADAcEFBUGBAFEHDQGAAfGGETGCAhAGAOFEH...hCGA...,1,-1,-10,9
bFNJGQPWaOYEcKgfUTSMAeHRdCDBZXIVL,HAAARAAAdADABAFAZADBXAFALAHB..FCAHGCEAQCFChAAAaCCC.EDCBKEGAUFFAMFAAhAAAAAIBeFDF.DCIBbGCChABA.....NIEB.WHEG.cGAAhACAfBGA.CGGA..hADA...,1,-6,-14,8
gUGVcJPQEOCZaSNKLIRdAbXYWBeHMTFfD,XAAABAAAHACAFADADAEA.GAGA.JCAAEAGA.ZBDA.aBHDKCEAhAAARDDA.AAIB...bEGDeDHHhACA.MECA.TGBAhBGAfFFA.gGAAcFFC.hCEAOHCCSGEDhDAA...,1,-12,-23,11
UacegEKXTYVHOGfLQbAdJINBWCDFMSZRP,dAAAJAAABADBDADAFAFD..ZAEBRBDB...UBGAeAHB..ECCAKCBA.hAHA...TEEAhAIAHCGBGFEBLEGBAEFBIHHAhACACGCAMEIB.aGDC......hAIA......hBAA...,1,-26,-32,6
MdECFbfQScNKJWVIBTaUHPZLReYgXODGA,EAAAFAAAQADA..SACAKAFAJBHB.IAFAhAAABCCAUDEAHAGBZDAARCCAeDABhADA.XDFDhAIAGGCBAAHAdEECCFGA.bFCD.fFHA..hBIA......hCAA...,1,-6,-30,24
eTJGMQRZfAVgILcXWdKYNPbBUEHDSOaFC,VAAALAAA.XADDdADAKAFA.....PAFAbBFAEDDAHCAAhABA.OBHDCDFAeDGHhAAAGCFARFAA.ADEAgFBAhACAIGHA.cFGDYFFFBEEDSHAAhAFAaHCE..hAHA...,2,-23,6,29
MFKUeCgVfODLXaEPRYTINAdZHJcGbQSWB,HAAAGAAAQADCBADAMAFAKAFC.eAHFCBFA...VCEBDBHBaCDBhAAARCAA..TEGAhAAAABIBZDFAJEDBbGCA..FGGHUFFAhACA.ODAH.EFBF.....hACA......hCAA...,1,3,-20,23
OZTgdIPeNJRaFMXcKULSEHWBDACYbVGQf,CAAAVAAAGACA..QADCZAEAdCAAeBHHRAFFFBHD..MAFAKDDALEGBhAAAHCEBDEIBACGB.hAFA.bFDBTGFA.hAHA............hAIA......hCAA...,1,-18,-21,3
MTAZUCXSKOFHPbacWQfLVYJeRBEGdNIDg,ZAAAXAAAOACAHADA..aAFDQAGCLAHB.VCEBeCCBhABAECHFdEEADCDBMDGBAAAASDAAhADAFEHB.bFAAhAFAfFBARFGBBGFDNIAB.IHCA..hBFA......hBHA...,2,-23,16,39
cHOdFERXLUDYQeAgVWMGbaTCZNIKfPJBS,VAAAGAAA.aADAZADBKAGA..JAFBBCDAHBGBdCFA.RDBF.LDABhAAADCHB.eDCBAAABMCIBhACAbEEB...CEED.fEHAhADASFDDFGGHEFGB..YHAAhAHAQGAC...WHFAhAGA..,1,-7,-17,10
BCHeVRNSPOcYadQZMUgKfDIEWGAbTJLXF,TAAALAAA.BAEAHACBRAFF.SAEAOAHD.aAGDZCAAMAIBhAAAKCEDDDHBECABGCEAhACA.AAEAbDGDFEAAeEFBhABAPEDBdGEA..........hACA......hAEA...,1,14,-28,42
eLBGYSTZRCPDcQfKVHAEMNdIUbaFJOgXW,EAAAdAAAUADAFACD..OAEA..XAFAeAHFGBDA.hACATDFARCBBDAIBQDDChAGAKEHBHFBAABFBMFFBhAAAbDGB.aGGB..gFDABHHA.ZGFE.hCAA......hCBA...,1,-5,-19,14
CKEMaBITFNVDPUdeWcHZJQYSLGbRAfgOX,OAAAKAAAEACE.BADAFAEA.DAFA..dAHAeAHFHCCAZBBAQCFChAAA.LEEAhBHARCEFABFAXDGAaECH.TFGAhBAAPFHD..UGCA.....cGFChCAASGGD.hCGA...,2,-31,-8,23
UQbAMgLZcVRPOdKeEGISJHfBaFDWXCYNT,MAAAZAAARAEAdAHAKADAGAFA..SCAAHBBAaAHF.DACACDDA..hABA.TCFAQEFBhAFAACEBLEEAPFDBEFAAhAFAfFHAFFHD..WDDDNIEB...hBAA......hBBA...,1,-14,-18,4
bfCUREcJGaBDPVTXNLOIWFSMeZYgKdQAH,HAAACAAARACA.EADEGAFAaAFA.DAIB..TBFALCAB.OCCBhAAAFCAHeBHHZDEFKDHBACCAbCDDhAAA.UEGBBFHD.XECDhACAIHGAMHAA.....YHDGhADA...hACA...,1,-11,-14,3
NfGLPYRBZUMDXWJKQFOgHIEbVdTeaCAcS,SAAAGAAALADARACFZAEB.MAHB.XCDAKAGAQCGAhAAAOCGHHEACEEAAdEEAeDHHhAAAAFHA.fEEEhACABECADGCBFGFDgGGAIHHA....hABA......hAEA...,2,-21,11,32
WMgCEUQHYXDPLfcJNISGBedOTZbKFARVa,RAAAaAAAMADA..EADAHAFCDAGA.LCCA.JCGFSBBDhADAGEBAeEEBdBFAZBGBFGGAAAAAhAIAgCCBCBDA.hCAAQFCA.XEGA.fFFEhBAANIDB.BHGAhCAA..,1,-10,-13,3
LFCKIVGSUAOHWcYPbBfQgMeDRNXEZTJad,HAAA....cAAAbADBQAFA.eBHHRADAEAGEZCAAhAAAaCABdDFALCDAhACAKEHBGFCBACHAODADPHBChACAfDGADGHB.TFCA.CEEASEHHhADA.YHFAhAEA,1,2,-13,15
XHFGBbZegfdVMOCAIETYDRKLQNScWUJPa,EAAATAAARACA..LAFBQACC.SAEBUCCBaAHBHDABhAAAGAGAZDFEeCDFdFGAMFIBhADAAAGBDDGBKEEB.cEGDhAAAPFCCBGHAfHDB...hAIA......hBIA...,1,4,-17,21
KYIPGcTQCZAEXFOUaNVegdHMLSfWDBJbR,EAAAOAAAUADA..aADDeAFAHAFALBCDSBBDDBIBBCFAhAAARCEBKCGA....IEHAhAFAGCGATEDAhAGAZGFAAAHAFDDHgGFBMICA......hCAA......hCBA...,2,-19,-9,10
YIcfVBFPdUSHTCOaDgGeQWLERMAXbZKJN,ZAAAKAAA.JADA..IADA..fAGBFAFAdCAAHCCAOCABhABAaAHD..GCFAhAAAeCCALCGBRECAABFB.hACAbDEDcFGDBFHASGDDDHDA..hACAWHFA....hCCA...,2,-22,-19,3
EAUcVHWRNaeISOGKCfFLDYXdbPZJgTQMB,VAAAHAAARADF.eAFEOADAGBFA.CCADLCHBXAGAdCDAZDAEJEEBhAAAQCFA.hACAEEBBACCBUGGA.NIAB.hADAaDHDKFCBDEFB.bFCD.TGFA.BHAAhAAA......hAHA...,2,-15,10,25
IOaJSeAbHVRLGMYDNdPXUWBQgcFZEKTfC,HAAARAAAGADAMACADAFAdAGA.UBEAQBFCFCCBZDEE.ECCB.KAHBTFFAhAAA..CDAAaDFEhAAAeECFADIBLFFAhABA..YFHBPHFA.BHFD...hADA......hCAA...,1,-8,-13,5
NfAWePFLSgOMVJUaTCRcdHDXIbZEBKGQY,eAAALAAAOADCMAEAUAGA..aAGERCCAHDFADBEB..XBFChABAZFAAEEEBKFHBGCAAhACA.QDCChCAAfGGEACCAFCHDSHDAgEFB.TGDAhDAA.CGHA....hAAA...,2,-14,1,15
KDEUfSIVAZNQRbdaGBHYLMgOFecJPXWCT,ZAAARAAAdADAGAEAHAFAMCCBFAGA..eCABJCGB...XCCChABACDDADCIB.ECGAUFDA..hAAASDGAAAHA.hABAbEECaFABBFHA.gGBAOFGD.cEBDhACA....hADA...,1,-15,-24,9
TdPYULCISfANFOZRMDVecWGJaBgHbKXQE,OAAARAAAMADA.DAEA..eAFAGAGABBDAHBBCKBHB.ECEFdCFAUEBAhAIALDDBCDFA.SCCDhAAAABFAZEFE.VFFAhABAcGGA..aHDA.......hBAA......hBBA...,2,-20,-17,3
DYGdHbMEgKWUQLAOXJCVRSacZfeFNTPIB,XAAACAAARACA..aAFAZACB.eAEAFBFD...TBGABBHAGCAAhAAAHCEBEDHFKCDBQECChAAAAACA.OFABhABASDFAfFGEIFFADFIB.dFHAMIBAhAFA.....hAIA...,1,14,-42,56
YJHCGQegXbBNUFWdODKLTacVZPEAISRMf,RAAAMAAA..JADAHACCGAGAeAFE.XBBCBCCAFCEB.dEFAKBFAhAIALFHBaCGEZDDAAEHA.hAAASFDACGAA.hABAQGGAbGDC.......hAGA......hAIA...,2,-29,-6,23
LWPceaQTRVZSfNHGXJCEUFBOgbdIYMDKA,LAAA..cAAAeADHaAFA.RBEFZCABfACBHCGBGGBBhABACAEBEAGA.BEEDbBFA.hAGAdFGD.MAIBACDAQDDAhBAA.TDFA.SEHHhCAA.XGGChCBA.FHDAIHHA,1,3,-21,24
VfAFdPcYBGLORTHJNbSgXDUaECWMeQKIZ,dAAA..PAAABADAGAEARADAHAGBJCCBSAGA.DCCBEDFBhAEA.MDIBeCGFQEDDhAGAZDAFAAGAFDDBLEHBhACATGDA..gGGBaFFCKHFA...hADA......hBAA...,2,-19,-3,16
BTEQYCSXDIUVJWecdfOKgRbHAZNFMGLaP,ZAAAMAAAaACABADA..EAFAQAFA.SBBBhAFADAIBICEAVCEBeBGFdBHAKDCBhAIARDGFHEEBAEHA.FCCHLFGBhBAATFAACGHA........hABA......hAFA...,1,-16,-18,2
fKRQcAgEICOGVHPSUWLadNDeTMYFJbZXB,EAAAOAAAHACAUAEAaAEA...dAHAeAGHMBBBFCCH.ZDFABCCARECAAAIB.hAAACDEA..GDFASFGBhCAALDHBDGGB.TEBAhBAA...bGBAKHDA.....hBDA......hBEA...,1,-6,-22,16
KNDbPQeGAWLYUcfHIgaMOZSVXFTBECdJR,LAAAUAAAHADAaADDZAGB...XCBATAFABAHBECEAdEEARCAADCFBhABAQFAAGCGAACAAhACA....cDGDhADAfEDAMFIBSGEACFAAKFFBNICB..hAFAeFHH....hAFA...,2,-15,2,17
FKMSfIDZeCJbQVBNREcXHWPUGdgTaYOAL,LAAAMAAA.SADHDAEAeAFACBBAQAFABBDA.ECAAHCDChBAAUDDAdCGA.aDBBAAIBfCHAhABAZEEA.hBBAbFABNBIA.RFEA.XGGAPHFC.....hACA......hAFA...,1,-10,-18,8
CSgTEBFNARaUdfDIJVKcLPbOeQHMGWXYZ,RAAAdAAADADAJADA..KAFALAGB..OAHDHCACGDEAhACA.XDGAZCCASBEGhAAAEECAFGCAAAIBaDFDUGGAhBAA..fDHE.IGGAhABA.PHAA.hBCAeEEDMICA,2,-44,0,44
DZWVGBLeEdbJYAQgNcaOMHCSKIFPXfUTR,QAAA..gAAAaACEHAEBKAGAFADAXAFDhAAAUDAARCGBZDCBGCCAeEEBEGABhAAAbCFAAAHAOEGH.MFIBhADASDBD.fEFADICA.hAGABEHD.dGGA.YFEFhABA,1,4,-10,14
dAJWLQTGRNPgaXcKDHeCMIbUFBESOYfZV,LAAAGAAARADA...PAEAaAGAKBGAHBCC.eAHFMCDBICAAhABAFCEDEDGA..ODAHhAAAZDDAACGBQFDAhACA.TFGAXEGACDHA.bGDA.BHHAhACA......hADA...,1,3,-16,19
CfLMVSQGNDXTIEOBcHdgbFAJKZaUYReWP,ZAAAaAAA.RAEA..eAHHCADALAFA.MBBBQCAA.GCDAhABAXCCAEDFEBEADhACAHCFAbEFAADIBKFFAUFCAhADAPHAASGABDFIBOFAEdGGA.FHFAWHCAhAGA......hAHA...,1,3,-13,16
VUOXTbIdfcCgLMQSJDHNeAZEGWBPRaKYF,EAAAGAAABACARADAKAGCFAEA...OBHD..bAGDdCDD.CCGCLEAAhAAAMBEBQEFAhAAADEEAHEFCAAIBZCCF.aCFBhCAAUGGB..IHFA....hCBA......hCIA...,2,-27,-14,13
JKGTaLYZIbcNSBQXRWHCAEFPVDOfMedUg,EAAAFAAADADA..MADAeAEAdAHA.UBCAKAHBGBCALBFBZCEB.hAAA.IDHA.hBAA.bCGDSECAhBHAQGDARFDAHGFCADGBOECH.fGGAhCAA.....hCAA...,2,-17,-13,4
YTMPUdGNVFgZAWDaXRJBSKLQeIcfbECOH,aAAARAAABADBLADA..eAEH..fAHAEAGAHCCBMBIBhAAAdCCAGCFAFCFDACCBDCHBhABASBBDKFFA.QEAChAEAbGAA.OCHFPHFAVEDB.hAGAWFHD.IHAAhAFA..,1,2,-18,20
VSFbOZHBQUGDLIRCeXaYcNfdTEKWMgJPA,FAAAZAAAHAEAQADAGCAALAGBRCCA.eCCBaAGA..NCGA.dDAAhADAKCHBMAIB.gEDHhBAAAACASEEBbFBDBEHAhBFADEHBCGHA...XFGCfHCBEGEF.hBGA......hCAA...,1,-3,-13,10
eIYXHEQTfWaZAUCONbSLJVdMGFKcBPDgR,OAAASAAALAEAdADAGAFAKBBDBBHADAIBRDBA..eCDAXDGDhAAAHDBAEDFA.TEGAhAFAaEDEAAFBUGGA.hAGACHAA.JFFF.MIAA.......hABA......hAHA...,1,-8,-23,15
cQJgUALbHfRaKZSeDdNVWEIGPXOBTMYFC,HAAARAAAZADBDAGAdADAVAFA..EBFAGCAB.OCFBMBIBCCCCQDGAhAAAUDFA.AEEBLFAAhACAaDAB.eFGBhAFAIFBA.BEEC.TGGA.hAIAFHCA.....hCAA...,1,1,-26,27
LMSDOeUcaXIBFgQPYRdKEATNCbWHGfJVZ,TAAACAAAHACAGAFA..fACBZCAAMAIBOCEBeAEEaAHDhAAABDHDQBEDhAHAREAAEFEAAAEA.bCCD.JDGBLFHBhAAADCCBXFDAFGGBPHAAdGHA....hACA......hAHA...,1,9,2,7
bGeLaCOQHITRAVJKPYXEgZdWfSFUDBMNc,KAAAXAAAEACE.dADA..SAEBDAFAMAIB.....bAFDhAAAeBEHaAHB.QDBAhAAAHCCBREFAABIB.PBGBhABAZGEA.FEFH.BEHA.NHBB......hCAA......hCBA...,2,-20,-14,6
OCHcQfaRGFLTJEXMSBDKgAbIYdNUVWeZP,..IAAAdAAAVADAZACA..CAGBHCACQAGARCFAGEDALCCBhADAEFFE.MCEBDAIBAEDBbDGBhAEA.UGAAeFHHOFDEhAFAaGCH.FGHD.........hACA......hADA...,1,1,-11,12
KfIQNDbHULJYPEegFZVcMCBAOXTWSdRaG,TAAAdAAARADAGAGA.KCBAQACC.bAEBHCEB.LEAAhACAPAGDECDFeDHHhADAZDFEMFGBAAIBOEEHhAAASGAAaFHBfGFADGDA....hCAA......hCIA...,1,-6,-9,3
PBLTKVNCFaQAHWEbOdIDXeSZUgGYcJfMR,HAAAEAAAdADAXADBZAEBGAGA..JAFBRCBBLEEBTCCAKAHBCEGD.hAAAQCGDAAIB.hBCAbEEADDIB.eGBASCADhAAAgGGAfGGE.MFIBhACA.BHAA...hBDA...,1,5,-14,19
MdAPCEZfcGOBgSLRTDQFaWXeIYbHJUNKV,EAAAZAAAGAEABACALAEARAGBDACA..QDGBaAHD.eCCBhABAbCCAHDFB.UECAhAAAKEBBdFFAAAFACDHA.OEDDhAGASFHHFHGE.IHDANIAB....hCAA......hCBA...,2,-21,-4,17
dMJHTXaFfLNSUVCBOWKcbQDYgGeIAZREP,EAAAdAAAHADA.aAFALADA.SAGHCBHAOCAEKCEAbBCC.hAAAQDGADAIB.hAEAGEEAADDARDEAMDIBTGCAhACAfFAA.VFDBBGHA..cGFDhAFA....hCAA...,2,-19,-11,8
YUGOfbEMgVBaRcQJSWDAXFPZCLTHdeNIK,FAAAZAAALADBHACBeAEAKAFAGBGA.OCEDEBHFMCABBEAARCEF.hABAQFGB.hACASEDDAAHACDHAdFGAIGCAhAFAfGCEgGEDaGED...hAEAWCCDDAIB....hCBA...,1,1,-28,29
MAYRIBGDaHQJLeCgUfdFZbSEWOVTNKcPX,RAAAGAAAHADBLAFAeADACAGA.UCGAdCDAZBFEECCB.ODAH..hAAATDAAKDFA.XEEChAAAADHABEHAaFFBQFGAhABA.fGAASGGANIDB.MIAAhACADFDB......hADA...,1,11,-24,35
faBEHSgFCMQZAWIDNePbcTXRKJLUGVOdY,DAAAeAAA....bABATADA.RAFFLAHBGAFAdBHAaCCBHCCAhADAFDDA.MEEBAAAA.IFAAhAFAPEFCKFAAVFFAhAHAOHCABHEASFBHQGGA...hAFA......hCAA...,1,-6,-12,6
KgAFIDMTbHPaXeOZYBfREGSJQCdcUVLNW,DAAAMAAAHABC.aAEAeACA.ZAFBBAHAEAHFGCCAQBEDdDHAUEFAhBAALCHBKBBDABFBTDEAhAHA...bGFAhBAA.OCCBfGHASHDG.CFGD.hCAANICB......hCBA...,2,-13,-11,2
dSRUAPeIbNTQFYacWEXfOLKHMZgGCJBDV,eAAA..bAAATADAQAEA.aAGEEAFE.OAHDHCAAZCEAhAAAGCCABCHBdCFAREAAAEEAhABAIEHAFEFD.cFDDhAAAfEHAKGFACHAADGIBSGHH.hABAPHAA...hAHA...,2,-14,8,22
NVYGQXfeHEcbJZaDPMSdBWTIKORUAgLFC,LAAACAAA.VAEAGACA.QAEAeAHHHCAAEAGAbDCAaBHDhAAA.MCABdDGDTFGAhABAOCBBADFAFEAH.NHAB.fEDAhACA.ZEGBSCCEBFEAKHCA.hAEA......hBCA...,1,6,-12,18
BeYScJTKRUHfGbgZQPMaONLdVIDFEWAXC,BAAAeAAA.SACAJADB.RAEF.HAFAGAGAZCEEMCCB.aCHDhAAALCAAdEFA.DDEBhAAAEFABAAIBCDFATFCAKEHBbFFDhACAPFHB.OHAEIGAA...hABA......hAFA...,2,-22,-5,17
KSOcZBgPJHGRFEbfVDWUNLIQAaMdeTCYX,dAAAeAAACADA.KADA..OAEDZAFBBAHA..JAGBHCCBGCABECHB.hAAA.VEFADAIBUEEAhACALFABADHA.MFCB.hADA.TGAASFED..gGFAhAGAFGHD.fEHEhBAA.,2,-36,-4,32
GMIDCWQZJabTeYNBLAfKEPFOXSHVURdcg,EAAAOAAAHACARADA.dAFAGAGAMAHB..CCCDZDEAaBBC....eCEFhAEABEAAAAIBKDFBXECChAAASDHHUFGBgFDAhAEADDDBQGAA.bFFCNAIA.....hCAA......hCBA...,2,-10,-9,1
WFQBYdXUcJfeDZIgCbGaAVHTMPKENOLSR,HAAAMAAAKADAEADELAFB.RCAAQDGAdAFAXBBCUECAhAAAJAHB.eEFBZDDACCEDaAHB.hAHAABIB...TFGAhBAANIEB.SFFD.BDHA.fGDAhBCA.DIFA.hACA...,1,-5,-23,18
IZOaDEFHGdLMWXUAfSBcPYbCQRNKTgVeJ,BAAA..PAAACACARADF.KADA..TAGAeAFEZBDE.aCCHECAAhAAAHCFCdCFALDHBhACA.MDDBXEDAhAIAAAFASEEDbGEANEIA.JHEADEGB....hBAA......hCAA...,2,-24,-14,10
DdfFTeGCIObANYUJLHWQcZREPKgSVaXMB,UAAAHAAAQADCRADA.EAFEKAGCSAHBaBGEBCDD.dCADFCFHhADAeCEA.GDGAhAAAODGDADDBYEEBhACALEAA.ZFCB..gGGAMIEADFCB.CEED..hCFA......hDIA...,2,-35,15,50
PAbXZcDRVeHgSdNCGBKfEaQUJLFYTWOMI,ZAAARAAAHADBdAEAGAGAKAFA.ECAAaAHD.QCFDLDDATEBAhABAMCCB..AAAAXEEAhADADDIBeFDASFHDhACABDDDfEHAFGAB.OFAB.IHHAhAFA....hAHA...,1,-3,-19,16
OHXTFBgWYcbdGSKfZaDIPALECeQJNRUVM,EAAAeAAA.QADARACAMAFA.HAFAFBFDBBHA..gCCBhAAA.cCFDhABAGCDAfDHAhAHAaDAADDHBADIBLFFACFDAUFGB.OHBAWFFD...hAIA......hCAA...,2,-25,-1,24
eKdaBOXVGUWFNQgbCALIYfHZDJRcTSEMP,LAAA..fAAAHADBZAFARCAATADAECFAeDFAdAFAaAHBhAAAXEECGCAAFEHDQDCChACACGAA.ABIBDDGAhADASGGDMEFABFDAOHAEUFFA..hBCA......hCCA...,1,0,-8,8
XGdMfWRFcTYSaHBQJLUKbCegDZIONVEPA,dAAAMAAARADAFAGA..TADA..aCAEHAFBBCEALAHBhAFA.bBBDeCFHZDDBOEHBhBAAECHBADDBGEAA.hBBA.fFFA.YHBAQEGDhACA.KGHDDGIBNEEA..hBHA...,2,-19,-7,12
UaSJCOVdfgQLXMHIFKcYNbTeGARPEDZWB,EAAAZAAABADBUADA...aAEDCAFA..dAHAQAGALBCDHCFAhAAAKCAA....NCGA.eDDHhBHARDDB.DEHB.SFEAhCAAODHBVGAAfGHAMFIB...hABA......hACA...,1,-18,-26,8
AYMXITELQabZNDBeRVgJcOCHFUSdWKGPf,MAAATAAALAEA.QBBAZACBBAEARAFFJBHBCAHBHCGB.hAFASCADdCEAGDFAhAGAACEB.XGCAEDEFbFFA.hAAAeFHF..........hAIA......hBAA...,1,-13,-15,2
KJBgeAUYSVLEGONTIPCWfMacHZdbDFRXQ,SAAAEAAAGACAOAEA..TADACAHA.MAFAHBEBbBFAhAAARCGFQEBChAAA.BCBDABGAVCCBLFFAhBCAIDAAfGCAZDGFdEFAXFDDhABA.....hBEA...,1,-4,-7,3
aKCRWOYAdPUNELZfIDgVHJBQFMbGXTceS,dAAAUAAAEADAZADA.DAEAHAFA.QCBAMAHBGCBBTCGA.hAIAeCFDaCHD.RECAODABhACAACEALEEBIFHAhADAJEGFBGDCXGGC.KHAA.....hBAA......hBCA...,1,17,-29,46
BPcLAdJECXeOYFNVabDgTfHKWGSRIMZQU,EAAAeAAAFACD..aADDDAEA....TAFAHAFCGBDARCDAZCGBQDBChAAABCFBLDHBhAAAAAHAdEFCCFADOEGB.hABAYFEBNDIA........hAIA......hCAA...,2,-24,-12,12
PJZOAMfCQebYIgKdUSGFDLBXHTRWcaVEN,MAAAQAAA.eACAbABA...IAGAdAFAGBGALBFAhAAAHCCAREEBaCDBEFBAPDABhADAOEHDADFA.CAHB.KDGASGEDhBAABEDATFEA.cGFD.NIAB.hAIA......hCAA...,1,0,-10,10
eVgcELBNHXaAIYORbTJFWQGMZPKSCfdUD,OAAARAAA..bADBTADA..FAFDGAFAZAGBKCCBCAHAdCCAeCHHhAAA..VEDAEDFBLFFAhABAHFAAABBBJCHBMEEBhBIASFHH.DGGBBHHAaHAC....hCAA......hCCA...,1,-2,-15,13
UDKgJYWZOCeMEFLRVfcIPBSHdATNXabQG,TAAAaAAAGACA.KAEAJACA.ZAFB..eAGHEAHFLCCBhAAARCEB..fCHAhAEAIDHASCEDhAFAHFGBAAIBbGAADBBBgEGGOEEH.MFFB.FGGHhCAA.cFCD..hCFA...,2,-15,-1,14
gcCbaOQPTNLYDfGEMJeFHXBARSWUZKdVI,RAAASAAAZADBdAGA...VADA..gCFGCAGB.OCCHhAAATCCA.LCGBhAAADAIBEDAB.eDABHEEAhABAAAIBKDFDbGBA.aEEHQGGAPFHDfGDEhABA....hADA...,1,-4,-22,18
UEbDOHCXTaMeBFQGfJdWLARPScKVNZIgY,RAAASAAAKADCZAFB.....IADAUCCAEAHFOAEDHDFCCFBAhAAAaAGA.eBGBFFFB.GCCAhAAAdGHAABFB.PEFBhABA.NCIA....YHBADICA...hABA......hCAA...,2,-26,-5,21
IMRfgZDbSBHQcCVYWaTJUEFLPKAOXNGed,XAAAeAAAdAEARAGBZACB..DBDBBAEAHCFBQAGACDEC.VCEAhAAAaCCHUFFB.EEBBhAAALECB.ADIBGEGAhABAMDIBbGAASEED.cGABhAGA.....hABA...,1,-7,-15,8
IQOLRDfXBUHMdKAFCPVeEaJWbTNYSZgcG,CAAAeAAA.EADAaACA..JAFB..TAFASAHBZBCAGCGAhAAAQCCARDBADAIBBEFDhAFAHBGBdEFAADBAFGDA..PEHDhAAA..WHAA......hAHA......hBDA...,2,-25,-13,12
AUcSILJPNTEdbGBHXgVMKDYZeOQWFafCR,SAAALAAAJAEA..TADAEBDFGCAAHAFB..XCCChAAAMAIBDCFAeAHB.QDEDhABAaDEARDGFACABUGGBhABAIDAAdEEABHAAKDHDZFAA.FFFH.CHGANIAB.hACA......hAHA...,1,17,-11,28
EIdSHfZXCUTFaWecLKJbQOMRgBVNDGPAY,EAAAdAAAHADAZACB.CAGBFBHDeAEA.LBHBKCBA.QCEAhAAARCEBBDADDEEBABCBSECAhAFA.XFFAhAIAaEHBJFAA.bGDCMFGB.....NIAB...hACA.....YFHBhADA,1,-16,-26,10
FAegPaUXZKHGNBRJCVOEQTMYcISdfbWDL,eAAAaAAAZACBHADA.GAGARAEA.CCCAECEFMAIB....IEFAhAAAdCEDbCGDLEEBhAFAAAFAPEHD.KBBDBGDAOHAAhAHA.TGGASGGDDIEA....hABA......hAIA...,2,-19,-6,13
CTIDMaLVZdbPeBYWXJUQGgFfOANcSREHK,SAAAHAAATAEAMADALAGB.dCADeAFABCEDXBCAhAAAQDCDGCEAfDHAhAAAABIBRCGBEDBACFHAaEABbGCChABAPFEC.YFHB...WGCGhACAgGGGNIAB.hADA...,1,2,-6,8
QNcVHAEMFZGPWCeOUafSBIXJgbLYTRKdD,EAAAZAAAGAEA.CADB.eACAUBGAaAFDBCAAXBGD.JCCALDDBhABA.RFFAdGAAhACAQDAA.cEEAhAAAAAHAMCCBFEGAOHECSAHB.bFBAhADA.KGHB....hBFA...,1,-16,-19,3
gXSBDeWTZcAPVaCFELYOJHINdQGbMRfUK,aAAAEAAALADA.OAGDHACBdAEBGCBARAGFKCEA.SBBDhAIAeCHHZDDBAAEACDHAFEEAIFFAhAAAQFBA.hAIAbFGDMFIB.........hBAA......hBFA...,2,-15,-12,3
aODdTGMBUFVCQgZXIfYEeHNLKbAWJcRPS,JAAARAAA..aADAdADAGAFABAFA..FAHBQCCA.ZDGBXCCChAFA..fAHEhAAAECFBHDGBLEEBhBAAADFBPEBBDEIBMICACFFCIHHA.hCAANIAB.KGCC.cGGChCBA...,2,-30,-8,22
EIXYDFLGZVfgKMbUQRdaASCHecBPJTWON,HAAAeAAABADATAEAOAEDEAGE..XCAAFAGAZCCF...fCFAhAAAMBGBQEEChAAARCGFAACACDDAJEAB.IFFAhAEALCHB.gGGAKFHB.dHDB.hAIA......hCAA...,1,-6,-13,7
BaQbFNRUXMHZWKegCPSIdAEGTfJOLVYcD,EAAAGAAA.JADALADA.VBGBDAGAaBFEQCBA.hAAAFDDARCDBMBIBHEAAZEFEhAAAeDBHCAHBSFCAhAEAADFA.TGGAODGD.BFFD.bGEC.hAFA......hBCA...,1,1,-23,24
ePYbcIFfLDGKOAZCSRXEaVBgQHNTWMUJd,ZAAARAAAEADEaACA..BAFBHAEB...TAGAMAHBdCCA.eCFBhAAAbDDAFCHDLEEB.hABAGEGAACCBXFFAhAGAQGCAWFHH.........hAIA......hCAA...,2,-18,-15,3
WLfDYJaOcgdTCVPKZFIUAHEeRSGQBXMNb,HAAARAAAGADAQADCMAFA...bAFBLBFBDAIB.aBHBOBHHhAAAdDAACCCD.KCADZEFEFCCHhACAAAAA.EDFBeFDBXEDDhCFA.fEHAcGGA.gGGAhDEA.....hADA...,1,13,-16,29
NQHVbTXPWEBODMgGeaASRJdfYLUKIFCZc,RAAAdAAALADBKADAFAFA.ZAFA..QCBAHCEBTCGA.XEGAhAAAEBHFDCFBGDDAhACA.ACGB.fDCEhABAUFGACDAD.cGAA.NGCB......hADA......hAIA...,1,0,-29,29
fSQJaKgYXOLGPVIHCTUBReZWMEdcDbNFA,QAAAaAAA.KACAXACDGAEA.VAEAHAGD.TDCAhAAARCFAeBBDZEAF.EDGBdDDAbFFAhAEAAAHASEABhAEA.gEGA.LHEACHHD.hAGABFEAMIAADIBA..hBAA...,1,12,-11,23
YfZbMIScPTOWaVgXRQHLBDAJFCKEeUdNG,CAAAEAAAdACAGACAZADB.MAEA..SAFATBFA.OAHDhAAAaBHD..XDFChAAAHCEBLDGBABEAKCBDeEDFhAIAUGAAfEHAbGCAIHHAcGFA.WHBAhBCA.....hAGA...,2,-19,4,23
LPMeSQacEZBVIRTCUDYfFJAHXKGNOdgbW,HAAAGAAAdADA..bADALAFA.eCABaAHBECDAZCCABCFBhAAARDEACCHA.DCHBFDCHAAGAKEEDODAHhAAA..PEHDhACAMEIBQFDDVGEA.IGGA.hCIA......hDIA...,2,-11,-1,10
aCbWDeOQZNJSRXfGLYcAITKEHMgPBVFUd,TAAAHAAAMACA.BAFAFACAdAFACAHA.DAHBeBDFZCCA...SCEAhAAARDFFGECALFBDhAAAACCBECHB..gEEAhAHAPEHD.aEHHWAHHOFCB...hBFA......hCAA...,2,-17,-15,2
DgKXSLGEYTBHJfUaQFebcCdPVIWNAORMZ,RAAAZAAAKADCLADBGAFA.EAFABAHAHBFCUCCAaCAA...FCHDeDEFhABA.CDGDdFAA.IFFAhACAAAAAMDFBDFBA..hAHASDHHTGFA.fGHA.hBFA......hCAA...,2,-36,-2,34
fKXDLOUBcbaSJICQFZWGHAYdgMPVeTNRE,dAAAMAAAeADARACA.EAGAKAFC.LBHBBBHA..aCAESBBDhAIA.CCEAZCFBHCEAADDB.hBAAgDGA.hCAATDCAXECAOEABbFGDIHDAhCCAQGCA.FFFH...hCEA...,1,-3,-23,20
IZCVEYaOQXMDKJRFeAGHbLfSPgWNUdBTc,HAAALAAASACE..gADHUAFAdBHATCCAhAAAZAFBEAHFaCAAQDFChAIADCIBRDDBADHBGGEBbFBA.fFCAhABAPFGDBECDCFGB......hBFA......hCAA...,2,-4,-4,0
VZLRJBMPKYFAEOecgdIQCTfSHbUGaDXNW,EAAAeAAAdADAQADA.CAFA.TAFAHAGBGCCAaAHDDBCB.XEFAhAAAVCEB.RFDFMDIBhABAKDBDADDBODGD.hAIAIHAASGGDbFAA..UGGB..hAAA......hAFA...,2,-14,5,19
AICOSPFRegJdfTKWHULVNEaDQBZMYGcXb,OAAAFAAARACF..eAEEdAEAKAGAHBEALBDDECHF.QCFAhAGAZEDAGGDB..bEFAAAHASHGAhBAA.hAIA.gFEG.fBBEhBAA.WHDG...hBIA...,1,-16,-19,3
KAScaPMCgBZbRLDEVYFUJedNfHGQTIOXW,aAAAMAAABADARACA.LAFAEAFE..FBBHeBBBdAHAHCEAGCFATECAhBAAXDAD.AAGASCHBhADACDHAZFFADGCB.hCAAUDDAfGEEOFGDKHDA....hBAA......hCAA...,2,-12,-7,5
aHUcNBZPDCMWRJgIKfALXGFESQYTdbVeO,GAAAEAAA.QADAdADAeAFAHCBAUAGABCDDZBFECDFARDGFJDEBKEEDAAABLDGBhACA.SDADhADAbFAAOFHDaFBDhBCA..NIDB.MDIB.gGFG.hAAA......hAFA...,1,-2,-8,6
HQEBIVYCPbNDUTgcZKMGSJeRaLWAFOdfX,dAAAHAAAEADABADB.VAFACAFA....bABDDCAB.UCCA..hAAATBGAZCFAGEDBhACAeCEBREFFaFAAAAHAFDAHOFHDhAFAQFCA.IHHAPHEC.NIBB..hAIA......hCIA...,2,-9,-9,0
OfSIYEWLgNZHMRFKcPUDJAXCaGbVdTeBQ,aAAAGAAA.dADAeACHQAFAOAEA.SBHBEAHFLBEBhBAAZDBBHDEARDFFKCHBUGCAhBBAAAABbFCDBEHA.fFGEhACAIECAgFGHMFAB...hAFA......hAIA...,2,-8,-3,5
XeWHRdEGgCaASFUQZJYVOPcLTKDfbBINM,FAAAZAAAJADAOACD.LAEADAGABBGA..MAIB..eBHHhABAHCDBECAAGCGA.hACAaFAAACEAQDDAhCAAVGCA.TFGAbFFDXGADRGDACDFA...hDCA......hDDA...,1,4,-28,32
dRXbLTSHeGUFcIVCMJZYgKfAEDBNPQaWO,EAAABAAA.QACAaACDdAEA.RAEALAHBHAGBeCBBGCAAFDDAIEGAhAAAMCGBZCCAKFFDACABDEEBhAAA..PGAAhAGAXFFASEHH......hAIA......hBCA...,2,-12,-12,0
LdcMAaOUKVTBZFWHQCPSDIfGJgXYEbReN,aAAAKAAABACBZACB.HADBQAEA.CAGA.DAFAGCGAXAGAhAAAECEB.RCFALEEAhBFAdFFAAAIBOBBBTGCA.FCCHhCAASEEDJFHB.......hCBA......hCGA...,1,-16,-18,2
QPVTcaJOBXZCAdLRbMSFHWeUKgENIDGfY,RAAAMAAAHADBUAEAEAFADAIBGBBA..QCFA.TDAAhAAAaAGEBCGAZEEAACCBbDECFFAHhABAeDHHKGGD..IHDAhADAfFDE.PFFB.JHAACHBA.SEBDhAHAWDDD..hBAA...,1,1,-22,23
PTDIASJeLQUdGXCgYVNcFMaEZRWKOfbHB,eAAALAAAdAEAGAGACAEA..VAGBFBCDEDEARCAA..OCEBhABAHEBATFFAACAA.QGAChAAAXDFDgEAAhACAcGEC.ZGAE.fFHAhAEABHHADDIB.SGGDhAGA...,1,5,-22,27
DdFaLSeAQHVbZCYKNBXMfRgGTJPcUIOEW,HAAAZAAAKADCXADBRAFA.GAFAJCAA.UCAB.EAHBdCEAaDCDeCGFhABAADHA...QFFBhACAbEDDCFBD.BDHAhAGAMEIB.TFFAIHHADIAASHFAhAAA..YEDFhAIA.NICB,1,1,-34,35
cNBPDHLdfQOUAKeVRWYaZFCXEgTGMISbJ,eAAARAAA..aADAZADBCAGA.EAFAGBDA..MAIBSAHHhAAAJBGBBBCAHCFBdEEAQFCAhAAAACCAKEHBVFCBFFFHTGFAhABA..IGAANEIA.....hCAA......hCBA...,2,-20,-7,13
UcPNdDWeQILXgMYZAOHJSBbfRaEGFVKTC,HAAABAAARACAEADEGAFAKAFCUCAB....PCABdBHAeCFBLAHBhAAAMDDBACGAOCCBhACASEEBaDEB.TGGAhAAACEGADEIBQFAD.XFEDhADA.gGGBhAFA...,2,-14,-13,1
RCMbYSHFPcBATeaUJfDQGKgOIXZEdNVLW,eAAAaAAA.UAEADADAGAEBKAGA..OBCDZBBAECFB..dCHALCHBhAHARDFB.bDBBHEBAhAAAFEEB.BFHA.AFFBfHDBhABAQGFAIHDA..hAIA......hBAA...,2,-23,-15,8
IUAHKVZDbaJLBfdNYGgQWFMCePcTOXRSE,HAAAZAAAaACALADB.dAFAGAEAQCABMAHBeCCBTCGAhAAAREDFEDHFAAHADDFBBFGDfEGEhACA.gFBAhBFACGAAOFHDSGBHKGGD...hBHA......hBIA...,1,-6,-13,7
USABOXcEKTdPFLJIVWHbDGZMfQeNgYaRC,XAAAEAAAdADALAFA..IADAHCBAGCFAZAEBMAHBhAAAeCHB.NEEA.aCDBRFGFSFCBhAAAAAIBOCFDTFGAhABAFGAA.VGBADFFB.fEEE..hBGA......hCAA...,2,-20,8,28
TJQAbGUCPHRWNMVIdgKBLZDEFcfSaeYOX,GAAACAAAHACARAFFMADA.dAHABAHBZBFBECDAFCAA....SCEDhAAAeDBHXDGDQDGAhACAAAABUFDA.NIDB.gEAAhAEADGGA.aDDH.TFFA.PHCAhAFA.IHHAhCHA..,2,-16,-2,14
JLYbOdETUWZAacCFHDXQfPGRBKNegVISM,aAAAFAAAHACB.QAEAGACARAEAKBHBeAHB..VCFBMCHBLEABhAEAODEBEEAATEDAhAFAZDFFAEIB.DFFBfEHAhAHABGBAIHHASBBD...hAEA......hAIA...,1,-8,-10,2
EUCgLKOPZINJGRQWYdMABbcfTFHDXeaSV,BAAA..bAAATACAHAEAeAHH.aCAAEAEEUCEBLAGBhAAAODDHZCAA.ICEAhACAGEAAREGBQEEAhAIA.dEHAAAAAFFEDSGCA.CHFA..hACA......hAEA...,2,-12,0,12
KVTFNAECZdGXRUYDWfHaBcQJeOLSIbMPg,EAAAdAAARADADADAHAGB.BCBAQAFA.eBCBLDAA.hAAAbDFAMAIBKEDAFFCHABDAGCEAhBHAUGFA.fDGBhCAAaGAB.OECBSGDHgGFAhCBA......hCEA...,2,-16,-11,5
ATKJdPBHagFMSNceWOIDQYCUZGXRfLVbE,TAAAdAAAHADA.aAFAMACA..SAHHeAEAOAHDQCBAhACACBDDGCDBRCFBLDDBhADAEEEBACCBKEGABGCAFEHDcFFChBAADGEBUGGA..fHDB.hAAA......hBHA...,2,-14,6,20
WZQDHdCJROcgLPAefNVFbYUaSMTIXEKBG,eAAAVAAA.FADD.UAFAaADA....MAGBTDDA..EAHBGDFAhAAAZCDBHCGBdBHARFBAODCBhAAALEHBAEBBbFDA.hABA..SFHHKCCD.....hAIA......hBFA...,2,-12,-7,5
BbfeHCILcZMaPOEXSdDJFYRUgNKQWVTAG,GAAABAAAeACAHADALAGBZAGBaCDCEDHFdCAAFBFB..REEBUFAAhAAAKCCAQECA.hACA.TFCAAAIBCDHAMEFBhAAA...OHFCDFIB......hACA......hADA...,1,-4,-27,23
VdJWSRbEAgcIXNOaYCGTKeDUFfHQMBLPZ,..IAAAOAAAaADDGACA..eAFAFAEAHAGBMBBBLCCAhAFAZCAFdDFASDHHhACAEBHFACGBXDGACEDATGGAhAIADEEBQFFABHEA.PGAA..hAGA......hBAA...,1,-5,-16,11
aBIcfNXAKWZVJSgYQLPEHUOTeFDCdGRMb,ZAAASAAAQAEAEADA.HAGD.TCAAeAFACBHAGDDARCCAaCFD.hAAABDGD..fDAAhABAAACAKEADVFGBgDGHhADALECD.OEEBDCIBMIAAbFCDIGAAhAGA.XFGAhCAA..,2,1,4,3
ZAJaBdUONVcGHEbeYRWfDXQSgTLKIMCFP,aAAAdAAAOADA..VADAHAGB.EBDBeAGHRCAA.DAIBQDEAhACATCCA.LEGBhAIAMBBBFDFHADIBBEBAUGAAGEGAhADAbFCD.fHDBSGBF..hBAA......hBCA...,2,-9,-5,4
bSQNZVdJYLPfAKHOIBReFWGDaXCTcgMEU,HAAABAAARACAeACEGAFAaAFA...CAHA.TBFAMCAB.UCCA.QDFBhAAAZCCAdDHALECBhAAAAAIBODHDFEEHXFFChCAAEFAA.NICB.VGFA.....YHAAhACA...hCIA...,2,-6,-6,0
YGcLNJbZHURBTQMIVCWXfSEPeAODgFadK,DAAAaAAA.dADAGACALAFA..JAEAHBBBRCEABAHBMCFA.CDEA.XDGAhBAAEDGA.ABBBFEBBhBEAKEDD....cEGDhAGAZEEATFCA.QGGBIHAAfGDAhAHAeHCA.OFFHhBAA.,2,-32,-1,31
GJRHNQcALTVdBgfMIODKaZXEbYCPFUeSW,TAAAdAAABADA.MAFADACAZADE..EBEACAHAFCCH..eBGFGCFAhAAAHCACQEDDhAFAABIBLDEB.VGFAfCHEhAHAKDHBaHDC.YFCF...SFHBhCAA..hCEA...,2,-25,-13,12
aSJRBLdXNUOWCPAQHFIMDGbZYgeKEfVcT,HAAAMAAAGACBZADBeAFAEAGE..VCFAaBBC.RDAALEEBdCFA.hAFAUGAACCHAADDAQEGAhAIADEIB.bFDBKFCCfGGEhBAATGGABCAD......hAAA......hACA...,1,-3,-4,1
ZSLcVXaPKMQWOHYBJGdEIeNRfFATUbCgD,TAAACAAAZACALAFB..XACBKAHB.MAFAQCCAhAAAHBDBBBFAdDAAECHBeBGHhAAAREDAAEHBbEFA.SCCDhBFAaFGE.OFEBYHAAIGGA.hADA.FGEDDBIB...hAEA...,1,4,-17,21
PaSbULOXHVITAcMRdegZCGYEJWfFNDBKQ,RAAAeAAAZADBGAFAEADA..JAFBFAHFBAHAQDAA..aCCAhAAASDEHLCHBHDEChABATEGAADDBdGGACDHB.hAAAfHABKGGD.PHDAOFBE..hABA......hADA...,2,-15,-10,5
WVTSGIKQAZdcfFNaLDeBCPYJgUHROMEXb,dAAAFAAALADAeADACAGA...JAHBHCACRCCA.EBHF...bCFDTDFAhAEAGEAAKEEDACFBZECBhACA....fEHAhAFAaEHDBFEDgGGGMFCBXGGASHEGhADAIHAA.NIDB.hAHA...,1,7,-36,43
aKJfAYVLFMWBHOPDbeEZGXQUcRSdTCgNI,LAAAMAAAHACCDAEAEAFEGAGA.QBDARCCBdAHATCEACCAA.hABA..IDHAhBAAaCCHfDFAABBBFEFDOFHBhCAAeDHHZFCAXGCASGBD.KGGD.hCCA......hCGA...,2,-5,-5,0
aFBPDAVLfKbRgcSHCOeTQWNGJdMZXEYIU,LAAAKAAARACF.SADHHAEBeAGBQAFAGCAAdDEDZCAAEDHFhAAAUDFABAHBAAIBVFAAhABA..bFFACDHATGGAhACANICB...MEEB......hAFA......hBHA...,2,-12,-6,6
AOESdDcLWGCXbHQJFgVUTRZMKYIfeBNPa,EAAAdAAALADAGACACAEA.HAGB.QCBAFAGAUCFAREAAZDDBKCBDfDFAhACA.eDHFhAEABCHAaFAAAEEBDEIBXGFChAFAJFFB..TGBAMIAA...IHHAhAAA....hAEA...,2,-28,12,40
ECTBMaULVSOfQcWYKJHFAZNgbDRPdGXeI,ZAAA..bAAARAEAGCAAeAEA.EBHFBAHAUDDALCAB.OCCBhAAAQDGB.hABA.cCGAKFGDHGCAhABAAAEADDEA.dEEACHAAMACAaECDfEHE.hAHAYGEG.NICB.hACA...,1,-6,-21,15
TCGWaYcegNMSAUIBRbQdOZHXVDEFKPJLf,BAAARAAAdADAHAFADACAKAEALCCA.CCGAGEEAaAGA..eBCBhAAAMCIBABHB.UFAA..hAAAbCDDOEHH..hABAZCFA.EDBB.FEGB.fFHAWHAA.hAFAgGCA.hAHA...,2,-30,-10,20
EURJCTHKdWefQSYMGcbBDOaIgNZVAXFPL,FAAAEAAARACACADA..HAEBdAFA..eAHBQAGAMCCB.GCCABCGAaDABhAAAIDAA.ZEFAhADAADDALEEATGAAfGDAhAGASECHcGEDbGEADEIB.NIAB..hBAA......hBIA...,2,-9,-9,0
FXGWQDKOJPSfBaTgMLbUNVdRZAEcIeHCY,EAAAeAAAHACAFADDGAFAQAFC.OAHDSAHBBCCDaCEChAAAMCCBLEAAUDDAdDHAhAAAADHBCEEAXFACKEGDfFHAhAEAbGFA.NHAB........hABA......hAFA...,1,0,-14,14
FXeCaDfMdYbNKVBZTcQEgLJIHPWAGRSUO,RAAAOAAAeADE.DAEAdAGA.....bBDDKAGA.ZBBA.TCFAhAIAECCFLCFAHDBAABDAGEGAhBAAFEFDaEHB.MCIBNIABBGHAhAAAQFBB.gFED.hABAPHCC...hAIA...,2,-17,2,19
fcbdeKFSRIWMaYJBQTPCAGgOZNEUXLDHV,GAAAZAAAEADELAFBHADAVBGB....bBGDeCDB.SAGEhAAARCAAMAIB.aCFHBCEChABATFAAACAAOEEBhACAXEGAfFGAdGGA.FHAA.IHHAhAHA.....hACA...,2,-5,-1,4
HNDCefFBYUJaMLWZEQKbIXPROTgGAdcVS,dAAASAAAHADACAGBFBHDBADA.UAFA..aCAEMAIBZCEBEDCAQCCAhAAA.KDAAbDFDhACA..XDFAhABARFAAOEHFGFBBAFAA.cFFADHEA.eHBG.hADA......hAFA...,2,-13,-9,4
aTHFLgKSeZPAGWOXIVbMEBfdYNDURCJcQ,GAAAXAAA..bADAEADA.BAFAdAHADADARAGF..CCDA.QCDAhAAAHCEBLDABSDCDhACAeCHHAAAAODGBhBAAMDCBfFGEYDHBJFDBaGDA....hADA......hAIA...,1,-2,-14,12
VINBgOAQETZUCafWMebSLFGdXRYHcJDKP,EAAAZAAAaACA..MADAeAEHLAHBGAGARDDAHBCA.DBEAKCCDIDEAhAAABEHAAAGBTFFAhABAfBGA.bEFAdGDAhAIA....XGEA.cCBChBCA......hCAA...,2,-20,-16,4
ePKEVNUSWDTgdAOfCXFBbYRJMGZcIHLQa,CAAABAAARACA.GACAZAFBHCAAaAEA...eAHFEAHBUCFADCEB.dCAAAACA.hAAA.OCHDFEBDJEDBMEFBhAFALFFA.KHDAhAAASEGD.TFCAfHFBhACAYHFG....hCAA...,2,-26,-13,13
ZFLBTQJdOaRWYNcGfKVeCEAIbgMHSDXUP,..IAAAbAAA.HACAXAEAZAFBLBHBQCAAdCAARCDBNAHA.hAAAGFAB.KFFAeCDFhABAACCBMFIBDAIBFCFHBHCAhACATFAAaHFA.cEEC.CEHAEGHB..hACA......hAEA...,1,3,-9,12
ZIKgTOMCYeLGJNbBXSUcHEDQWfAVFRdaP,RAAAaAAAZADB.KAFAOACD..MAIBeAEAGCEAJAHBBCEA.UDGBhAEAHDAA.ECGBQECAhAFAAAAAdFHA.gFEBhBAACCCCLHAAXGCCDGGB...fHGFhBBA..hCAA...,1,-10,-25,15
FNUfADXeWaJYcCRTdMbSPHGZEQIOVLKBg,eAAAaAAA...JADBCADARAEFdAFA..MAHBSAHBHCCBZDABECGFQDGBhADA.OEFBhAGALDEBBBBDFDHDhAAAfGCAACCBXFBAcGGAbGFA..IHBAhABA...hAIA...,1,-16,-17,1
SPYgNEWQGHDbAFKZMcBCaILRfeTUOVXJd,ZAAAMAAACADBLAFARACA..eAFEOCABXBEAdCCD.SBBDhAIA.PCHBhBAAgCEH.ECHBhABAGDDAHEFAAAGAKFGDaGHBIHHAfHEBhACA......hCBA...,2,-23,-12,11
OVRZFfEXJBGScMUKAaLPgHbQNYDTCdIWe,aAAALAAAHACBQAEADAEAdAHA.eAHBRBCAZBFBFCGDECAB.BDEChABAGDEA.MBBBADHA.hACAbEAATEGACEHA.OFBAhBFAXGBC.SGGAKFFDNIEB..hAEA......hAIA...,1,2,-16,18
CEdeRBLTPIAcSNHaXDMYUVKgGOWFQZbfJ,SAAAHAAAaACAMAFAUADA..KBEAGAGAFBGAZCCAJCCF.EEEARDFFLDHBhAAA.IHFAhCAAAAAAXEGADEEB.hCDAgFBB.QGGCCHHA.hDAAdGAA.BAFA.cGDDhAIA.,2,-23,-6,17
ZCOIBYNJHMdaPFbAegRcVfUXTEWKGLQSD,RAAAVAAAUADA..EADEGAGA.LDDAQAFCZEFEOFBAhAAABAHBJCDBHGAAdCHAaDGBhAAAFGGAAAGB..eEFD.hABAfFDA...WFHBDCCB.CHGANDCAhCAAMIDA....hAIA...,2,-9,-7,2
PcTNVdaLZfYXKOABbJUGIFMSECgWHeQRD,BAAAUAAAGADAMACA.EAFACAFAHAGB.RBCA.DAIB...TCFAhADAdDBAZDEA.XFDAhAAAABHBbDBB.FGGA..SDHHhAFA.eEFB.....hAIA......hBCA...,2,-28,-19,9
XOALCPbSKNWEQcTfBdDaUHZgGIYRVeFJM,LAAACAAA.SADHKACAEAEE.QAFATBGA.dBHAaAGAhAAAHCAAGCAARCEBeEEDhABAMCCAAEHA...bDDAcFAAhACADDDAZEGB..gGFH..hAFA......hAIA...,1,-7,-18,11
NdSJTHXPOLFCYMBaQAUKVIeGEWZDfRcbg,KAAAeAAAEACEZADB.RAFA.....bAEBdCCC.TCGAHAGBOCCBhAAALEEBCDEDMDGBQEGBhAAAAAIBUGBAIFCAhABADEHB.fGAANEIASFFDXGGAhAGA......hAIA...,2,-10,-9,1
URaKOWYJPSdMcVTfFeIbQZADgLCGNBEXH,LAAAGAAAEADAHADBRAFA.aAFAOCDB..JBGFdCEAMAIBTCGAhAAAeCAB.QDDBhABAADABCEFABEHAKGAAPEGBhACASGGAfFBA.IHHADIAA.hACA......hADA...,1,4,-19,23
eGCFSXfZKgUbHAMQBcNPLVWDRYTEJOIad,MAAAQAAABADA.....PACCLAFADAFARBEAEBBBOAHFhAAAdCEAeCGBGDCASCHBhAGAZEEBKEGAgGGAhCAAHDCBAEGBNHAB..YFFF.IHHAhAHA....hBAA...,2,-23,-4,19
fIMgeYDPcAdRVBHSULGJZNWEOCFQXTKba,RAAAHAAALADBZADBEAFAFAFA..QBGAKBFD.aCACMAIBeCEHhAAADCCBACCAdEGABCGAGGDBhACAJEEA...NEIA.CEHB.hAAA...TGGA......hABA......hCAA...,2,-39,5,44
HJQGdSUXbMFRKTEcDLIWAeZOPVYNgBfaC,eAAAZAAAOACA..PADC..VAFA..gAGBhAAAaCCCHCEBGDGAhABAdCCAXCFCbECD.RECAEDHFhABADCIB.LGCAAECBNIAB.CGGA.SGGDhAIAMFIB......hCAA...,1,0,-9,9
GUWKVHNIDTPfELegaXBFJSQRMCdYAcZOb,ZAAAGAAAKADCHAFADADA..TAFAECAAeCDF..aAHDFCFHQCDAhAAARDGFdGGDAAHA.bDBD.hABAUDFANEEA..IHCAhACALEHB.BGGCMFFBCHAA.....hACA......hAHA...,1,-6,-11,5
ASdHGOPVUNQRgLYIKaEDTCMbcZfeXFJBW,HAAAGAAAOACAUADARAFALAGB.KBEAECGACCCA.MDDBZDEAeEHHhAAAFDHDBEEAAAIB.dGAAVFDAhBGAQGEA.hCAA..IGHADICA......hAAA......hACA...,1,-12,-20,8
eBZgIcPRXGMECJKOLTNafAFWdbUDHSYQV,dAAADAAAHABCQADAeAEEZBFA..gAGA..IDDAhAHARCAAGDCBEDFAKCHBhACATEGAaEGDAAGAbFBBSECDhAIABFFC.XFDBMFIBOGDCfGGEhBAA....hBIA...,1,5,-25,30
TSXKdLWeDGbfIYAaQPBZVcFgJMOUHECRN,aAAAQAAAZACB.FACEMAFAHAEB.RAGB.TBEAKCDDdDGD.eEEBhAAAGBGA..bGAAfDEEhBAAAAIB.BBBDhBEAgGFHOEFDEFHF.SGBAhBGA.....hAGA...,1,-9,-11,2
CFgYEdcSQURZVLbeINBKGDMAJXOWaPfHT,OAAAaAAAHACBFADDEAEA..dAFA..QAGARBGFZCCALFBAhAHAeBBDBCFAGGEBADEBXDFAhAEA.fFCAhBAACFFCYDHBSEHH.bFFDNIABMBBBhAIA....hBAA...,2,-17,-1,16
PVWABZOJbCMaGYFRQSTcLEgKdfeNDXUIH,ZAAAOAAACADBGAEARADA..QAGC.SBBDhAEATAGAECAAdCCAeCHFDCFBXCGAhAIAHDDBPFGBAEEBbEGDhBAAaGAA.FGDHLFFD.....hABA......hACA...,2,-9,-5,4
KPaZOTbYUAWDBeQJSVMXfdIGNRHCgcLFE,BAAAeAAAQADASACA.MAGBdAFAGBGAHCCACAHALCHBhAAAECAAaAHF.ZEEB.bFBBAACADCDBhAAA.XECAhBFAfGGARFEFFGHB.........hABA......hAHA...,2,-13,-2,11
RFOdADKIYfTaeCLJBVXPZNgMUbHESQGWc,KAAA..fAAAeACELAFBBADAXAEDZBGBMBDBHECChAAAEAGAGCAARFGBdHABACCBDBIB.hAHATCCAaGFH.CCGAPDFBhAAA...gEGH.bGAAhACA.SGHHhADA.WEED.,2,-11,3,14
VDEHBKbUCSWPXQLTaFORfeAYJNcMZgdIG,JAAAMAAAZADBdAEA.GAGADAGA.HBBBKBFA.CDEA....SDFHhAGAXCGA.TFGAhAIAOCCHREBAABBB...cGBChBAAIDAA.EDFB.BEED.bEGD.hBDA..UFBB..hADA.WHBA.,2,-33,1,34
KYZBfAMLVWdTUNCEDOXgIbSGeaHPQcRJF,MAAALAAAdAEAUAGAEAEADAHB...OBFDXBBA..bCAAhABAeDEA.HEBAQEAAhACAREGBKFFDZGBAAAIBTEDAhAEA.CCHASEHB.aFGB.hBAA......hBBA...,2,-17,-12,5
UDESfWHeCPgJLcOdGKYVbXQNZaIBARFMT,RAAAMAAADADA...EADASAEAHAFA..eBBBCAHA.JCFFLCCAhAAAdCHAGDCAKCGAVECAhABAbFFA...QFGAhAHAaHAAAHFA.TGEA...fGCEhCAA...hAHA...,2,-21,-12,9
bPZNLCReMJVXOEQfBKdGSHgaUIFTDcAWY,...bAAAZAAA.LADBRAEA.eAFAMAIBXBGAECAABCDAGCAAhABAHCFBaEAAFCFHTEGAhACAAAAA..PEEBhACACEEDOFAHQFACdGGDSHDAgGGAhAEA.DFDB.WHCAhAFA...,1,2,-11,13
KeDUZQGESJIOgATHFabVBLYPfMdXcCRWN,HAAAaAAABADALADB...fAFAdAFACAHARCCAKBBDeAGHZCGB.hADAECAB.SBHHhAAAOEEBADGB.bDCA.PEGBhACAMDIB.XFAA.NEIADIAAQFBAhAHAIHEATGGA.hAFA...,1,4,-26,30
CaHJOLDYBAWVgURXNTPGFfQecdSKZIMbE,VAAARAAA..TAEAGADAQAGCdAFBZCFB.MCCBECHFHDAAhAAALDABBEHAAAAAgCGAhADAXFDCFGBBeDDBhAEAKGGA.bFED...aEHDDIGA.....hAIA......hCAA...,2,-3,-3,0
BQSfXWRHYgPGKbFVOeUNcDLdIEJCaTAZM,ZAAAMAAAQAEA..XACAHAGDgCAAGAFAbCCChAFAOCEBeAHBUEFBhAIADACAdDGDEFBAaFEDABBBfGGEhBAAYHFG.FHDANDDA.......hABA......hAIA...,2,-8,2,10
DLBUMGfSVIQOFNeYZWdcJPgbAKHXTECaR,HAAAEAAARACA.LADBBAFBGAGASAFA.QCABhAAAFCCHeCFBZDAFdCFAPBHDhACAAAIBKEDA.TEGAaDHDDGGAMEEBhAFA.fFFE.OGAA.hAAANIAB......hADA...,1,20,-25,45
WSAdcFIgXPObLDJYReGaQUZTNKCHBfEMV,dAAAFAAA...XADAOACDLAEADAGARBFFGCABaAHD..ZCDBTEAAhACACCFA..HDGBhAFAECHFMEEBSFEHhAGAABHAIFFAgGGAPFHB...YECBhADA....hAEA...,2,-17,-17,0
PJQTCMgUEAKNcWbIXOVHedRSZDafYGLBF,KAAA..NAAA...bACBOAFA.HBBARAEAZCEAaBDAGEEA.hABALCHBFBGHQDDAhACAMCCBEFABABIBIEGAhADAeHAAdGHA.fEAABAHB.TGGAhAEA......hBBA...,1,-2,-20,18
BKgYSaLQDeXUMHNCVbOIFWZEJTfGRPAdc,dAAAKAAA.SADAaACALAFADAGA..eBEAMBDBHCAC.CBHA.bCDDhAAAFDEA.ZDGB.EEABTCFAhAGA.REGBACCBBEEDhACA.gGFGXFCCNICB.IHAAhAHA......hCAA...,1,-12,-19,7
FMZPWLSDfGXbYHdcBOaIURJATCKEeNQVg,TAAAEAAA..eACAQACCFAFDZAGBLCCBDAEAGAGAXDABhAAAHBEBdECA.ODHDhAAAaCEHREFA.AAIBKEED.gGBGhBGAMBIBSFDHbGEA.BGHA.hCAA......hCEA...,1,1,-7,8
KEPUIRAcGODXMdTSgNWVfQCaYJBebFLHZ,GAAAXAAAdADA.SAFA..gADAVCEAQEGAhAAAaAFDBAHAeDBHhACAbCEAHDAAEDDBUGABAAAADCIBhADAMFFBTEEA.fFHACGGD.FGEHhAEA.LHAA.hAFA...,2,-4,4,8
ZcBECDIXLGVdKAgbORSfFQeNPJUYTMHWa,OAAARAAAFADA..eAFHJADB..UAFAMAHBHDEAZCCBBDGD.DAIBhAAALDHB.dFBAhAIAACCBSDHHhABAQGDAPBBBTEEAaGGAEGGBCEDD.....hCAA......hDAA...,1,-10,-30,20
cFfdPLTSJXWNYGZBeMEbaQVHCIROAKDUg,DAAAUAAAFACDdADALAEA..TAFASAHHJBHB...hAFAXCDA..hAFAYCEBZDFBeBBDEDBAhAHAaDHDHFGBRECAAGAAKGCDfGDAPHEA.WDFHhAIA......hBAA...,1,-9,-33,24
IPRfVUMHQLSBGdOcYEJgDaFXeTCNZbWKA,RAAAUAAAHADBLADAGAGAdDAAOAGDECCBDDFBFCDA...eDGDTDFAhAEAZFAEKGGD.AAAA.fDDEhAFAMDIB.QFFBhAIASEEDBHHA.....hADA......hAFA...,1,-4,-21,17
VTWgPNRDQXCZdHaJfSLMcGBYUIeEFAbOK,KAAATAAA....gACBRACFQAECZAEBHAGBaAGASBGHhAAAMCCBGDEBBCADhACAIEAAEDEBACIBbEFDODDHhAAA.PFFBXFDCdGBAfHGFhAEAYEHH....hAIA...,2,-5,0,5
NCKFPXdagOYAHMWBSQGIRcUZJVeEfDLbT,HAAAMAAABADAGADARAEF.ZAFA.eCABEAGELBBBTCFA.KCGAXEFAhAAAdDDA.aCCHOEGBhAIAAAGAQGGBhACAUGCAJFHBDDIB.CFEDFHCA.......hBAA......hCAA...,1,16,-23,39
CEOSBPNReZFUWVcIfdYAbaXTDKgHQJMLG,aAAATAAA..KADAHACBMAFAGAEB.ECABBBBDRCEBZCGBFBFDVFAAhAAA..fBHAhADAAAEAbGDA.DCDB.QECBhBAACHADSEEDeDHF.cFEBIHHAhACAdGGDYHBAhBHA...,2,-31,20,51
WbfLSaUVYXcCDZIAHJgFNTMBKEeRGdPQO,HAAAFAAAMADAEADERAFFGAGAdAHA..QCABOBCC...bDCAhAAALDDAUEGAXFAAhACADBEAAAIBNDIA.KGFDeFDAhBAA.....fGGA..hCAA......hCBA...,1,3,-29,32
VFURHfGJeZgcWITLaMAKQEBbOXSNYDdCP,EAAAOAAA..SACADAEAdAHA.CAFAFAHBHBBC.GBEAZCCA.hAAA..gDGAhBAAIDAAaCEAABGAQEBAhBBAbDGD.XFGAPEEBRFAAeEED.WHDAhBEAMCIBBHHD..hCAA...,2,-12,-8,4
GYAJWCLMHDBfObSXUeaRFcQVdPIgZKTEN,CAAAHAAABACAOACA.SAFAeADHRAFAFCAAQCCA.hAAAdCFAICHAZCGBEFDAGGABhAAAAAFALDEBMDIBhAGADDGBXGGCUFCAaFHB.....PHEChACA....hAIA...,2,-32,13,45
eREYTNKCfIWZSLHOgPFMBQUVDbGXJAdac,aAAARAAAEADE....TADACAFB..IAHAZAFBHCCB.OAHDhADAFCCAMCFAQDGDhAFADDFAGEEAABBBeEFDKDHBSGHBhAAALHBABFCD.....hABA......hCAA...,1,0,-32,32
BfYTLdaGgcWOKHIbCEQXSFJAPRVNUDeMZ,RAAAUAAAeADEZADABAGB..TCDAdCCAGCFA....gAGBhAEAOAHDHECChAAAbDFA.EBEB.SEHHhABAADCBPFAA.DHDAMFFBfHFFaGDBKGGA..hCAA......hDAA...,2,-14,-14,0
RGeFWMaXQKAHDcVbdJIYSPfTNLOBZgCUE,HAAADAAA.VAEAdADAJAFA..SAHB.TCCALBBBhAIAZDAFCCHDRCFAeDDBFDFBaECChAAAQFBAAACA.hAEAbFEDIEHA.fFGEBBFDEEHB.hBAA......hBDA...,1,-2,-27,25
YLXCPZGIOgcASUfVbQTKHFBEJaWRdeDNM,SAAAVAAA.QADAHADBEAFAaAHDRAFAdCCA..eCFFMCHBhAAALDAACDAAGEDAODGDhAAAACIBUGAAbFAATGFAhABABGEADDIB.XGGAIDFAfHBBhADA....hAFA...,2,-2,0,2
FCaBSgKEZLPURNObQdYVHITcMGeXfADJW,DAAAFAAABADAKACAZAEBLAFA..RAGBOBBBdCCAHCFA.TEDAhADAGCFA..eEHBhAGAAAIBCCDC.aFCH..EEABPFGBhAHA..bFGDYHCG...hAEA......hBAA...,2,-38,-8,30
FDLNTZEHVPCJOcKWaeQfMUYBIXAbgdRSG,dAAARAAAGADALADAZAFAHCFACAHA..OCAEKCCDeDAB.MEFBhAAABCEAAAGA.SCFHhACA.DCHBEEGAPEAAhAEAcGGA..aDHDfHCBUGFA..hABAXEEC.bFAAhAFA.FHAA.,2,-24,-2,22
LWAYQOFgcdeUBHZaMSGNfXVIPKDTJbCRE,QAAAFAAAdADABAFAHACAZAGB.aAEAGCEA..XAGDhAAA.ICEADBIBbDBB.hAFAEDDBAEDB.ODFC.hBAAeFFAMEHBfGHAKGCACGFA.LHDAhAIA.....hBDA...,1,12,-34,46
VEXNSQGUdDLOfbBMWITZKPYJgRaCFeAcH,HAAAEAAA.SACEGACAdAEBLAFAOAGDBCBDMCCATCFAhAAAZDFAKEDA.JDDBRFBBaFGBeCHHhAGA.AFFA...XGDBhAAAQGGADAIBfHGFIHAAPHCAhAHA.....hBCA...,1,8,-17,25
gCBPZYJXIOVMfUKbENcTeWAQDGSdFHaRL,GAAAdAAAHADARADALAGBBAGBZABB..XBGAOCDBMAIB.hAFAKEADECEF..TEEAhAAAADDBQDFAFEGAaFCCCGGAhACAPFFB.IHHA....hAIA......hBAA...,1,-11,-24,13
OZBdWSgQfXDPGcVJIYNbFKEHURTMAeaLC,eAAAaAAALADAZADBdAGA...SAGHQDBCDAIBGDFAhAAAVCCA.IDHA.hAEAbFBAEDFA.HEFC.hABARFAAABBBBBCAfGGEPFHD.....hAIA......hBFA...,2,-11,-7,4
bETKeOaIfXVgULBMFDCHPZNWRYJAGQcdS,GAAAdAAAEADA.eADAOAFCaAGD....XCDAUCCAMCFACCHAHDFBhAAAZDABRDFAAADA..QECAhACASFDAbGBCTGGAhACAKFHB..fHEFLHAADDAB.hAIA......hBAA...,1,-4,-8,4
MODLIPNHfRTbVJBUGFZdWcYgECSAeKXaQ,eAAAaAAA.MAEALADA..IBDAHAGBRCCATDFAJAHBGBEAhAAAdEAA...cCCChABAEEEBAAIBQFCChAEA.DBBBfDHABEHAFGGA.ZGBA.gFGAhBGA.SGEBhCAA,1,-5,-9,4
JTEcYFKBWVOeICdAGafgDQPRMXZSbNULH,aAAADAAARABAZACB....SAEBUAFAHDEAEAGAFEBA.BAHAOBHDhAGAeDHHdCDAGGDBhBAAQCFAMFBB.bEFC.hBBA............hBEA......hBFA...,1,-16,-27,11
TWMHaceLORfEYAKVGDSQXZdBNCbgPJUFI,GAAAQAAAdADACAFA....bACAJAHBFAGA...TCDAhAAAHCDCeDBHRCFFEDAAAADADDIBZEGBhBGABEED..PHCAhCAAIEGAMFIBaFAH.LGCA.fGGAhAAA..hACA...,2,-28,6,34
NFAcdVEKCLHPGOQgXBWfSDZJTUaIbMRYe,dAAAEAAALADAHADAGAGAQBGABCBASCEHZBCAUDEBaEAAhAAAMDAB.RDCB.eEGHAAIBKEGDhACAOFAB.WDDDhAEADDIBTGAA.IGHAYFHBFGDD.hAFA......hAHA...,1,-4,-7,3
ZeJAETQabIDOMCGVNPgKdYSLXUFRBHcfW,EAAAaAAA.DADA..MADAGAEB..PAGDdBCALCEA.hAIAFDHDHBBC.fCEAhBAAeEEBAAHAbFCDCDFAgEBAhBBASEGD.REFABGHA....hBEA......hBFA...,1,-17,-22,5
CbUYZQaSWgRBHMDOJFcKVedNGLTAEIXPf,EAAAXAAA..CACAUAEAZACBQAEA.aAGESAGAhAAARCFAHECAMEHBOCCBhAHAFGFBKHAAeCGF.GEDAhBEAAAAA.fDHA.YFHBhCAA.BDEBDCEB...hAHA...,2,-14,-10,4
EFRAaYGBDVKSeIdcgUCPJLOfWQXbTMHZN,GAAADAAAKACA.eADAdAEA.UBGA..CAGALCCBOCDAQDDChAAA.TEGAhACAHCECEDHFAADAaFFHBBHASGEDhAHAgEEB.JFHB...XGAAhAGAMIAA...NBBA.hAIA...,1,1,-35,36
ELGTSDOXZBcfFgdPMIUYAHVbCNQKJaReW,HAAACAAAKACA.RADFEAFEGAEADAIB.ZAGBBCAD.FCCHdCAA.MBIBUCFAAAGB.hAAA....bEECQCCChACA.eEEAhAEATGGAXFGAfHABIHFAYFDFhAAA....hACA...,2,-26,-15,11
XEPBTAKICOUMWcbgGDQSHZeLaYJFRfNVd,CAAAMAAA....bACAGACB.QAGCHAGBeCAAaBBCFCEHhAAARCDA.VEAAECHFTEFAhAFAAACAODGB..cFEChAIASDHH.ZGAAYEHBfGHAhAEA......hAGA...,2,-13,-4,9
HgCJMGfRYIOAWSKNQLZFTdDEBeUVcPaXb,KAAALAAAZACBdAFAEAEABAHAUBGA.....VCAAaBEBHCABhAAACCFCGECARCFA..OEEBhACAAAHASEADFFGAeHAAhAHAXEEA.bFGDMIEA..fHEFhABA.WEHBhACA...,1,-15,-23,8
FfaKIOUWeJcBZTCSgAVbDQEMXNGLPYHRd,DAAAEAAA.MADAGACALAHBHAEARCEA.dAHAaBBAOCBB.eDHFhAAABBEAZFFFTDDA.hAEASBFHAEEBbGAA.hAGAQEBC.XEGA.PFFBhBAAfGEAKHBAIHHAhBEA,2,-16,-4,12
HPXcMQaSbFUEOdTNGBVCILRJZWgKeYfAD,HAAAXAAAMACA.aAEEFADA.UAGAdAHAGCCABBDD.CCFAREFAZCFAKFEDhAAAeDDB.AAAADEHBPHBChBHA..QGBAhBGAEGHB.TGEA.IHHA.hCAA......hCCA...,1,-9,-19,10
aCQgPHbeRLGOVNZUWBcAFKdfJYTXSMEDI,dAAAJAAA...TADAMADA.EAFEDAHB..aAHDQBDAHCACRCFBGEDAhACAOBFF.ZDGBBDHBhADAAAIB.fFHAhAHA.SFCDCCCDbEED.eHFGNEIA..hBAA......hBCA...,1,5,-34,39
CLbTMGISfYcWeKaVBRgZXENPHDdQOAJFU,FAAALAAAMADAGAGASADH....fBCAhAIA..cAFAeBDHaBFBhBAARBEFZCAAEDFFHDFBdFGAADIBhBIACAHBIDHA.KFHB.BHHDNEEADFIBOEEHhABA....hACA...,1,-7,-18,11
ebGPaYTQEdANWZOFJDKMLfHBISRVCUgXc,ZAAAFAAAKADAMACAHAFBBAFARCCA...CAHA.UEEA..XBDDhABAeAHBGDAA.aDGDTCGAhAHAdGHA.ACCBOEEBhCAADIAA.LFCB.SFGAhCBA.gGFGhCFA...,2,-32,-15,17
aVLKAbUYSEdPZGcDNFMXTIJWCgRQefHBO,UAAAEAAAZACBGADA.DAFAMAFA.TBEAJAHB..CBFB.RBGFeCBDhAAAHDAABDFA.ODHDhADAaDECLFFAhBCA.ADIBbGBAdFDAcFFAFHFA.....hBEA......hBGA...,2,-28,-4,24
dPaXTcMbOLZJIUWYgSFQfRDNECGeABKHV,HAAAdAAAaADATAEA.MAHBLAGB.ZBDEICCAUEBA.hACAgCEAQEDAhAIARDABEDHFeCHHAACAKEFBXFFDhBAAbECDOFHD.......hBCA......hBDA...,1,10,-19,29
MFHVdRESbPeKcNWGACZJOLgYXaQBTUDIf,ZAAALAAA.XADDaACAQAFA.BAHATAFADCCBMCFBhABAHCAARCFA.EDEBbDDDhAFAeEGF.KFAANCIAADDBOEHDhABA.YHAAfGFA.FHGE.hACA......hAFA...,2,-20,-3,17
ZVbGJXaBHDCETAdWKRQSOMefFLYcUgNPI,dAAARAAAQADCMADAFAGD.LAFB.UEDAPBDBZBGB.GCEAhACAaCCCHFFBDAIBECBFAAAASDHHhAHA.eFCDhAIAfDGB.gFBA.hCAAIFHA..hBAA...,2,-35,5,40
VRLaHBcWTCFAKPGNZQEfJUSbYdMIeDXgO,GAAAZAAAEADE.UADA..SAFBdAGAeBHHDDDAOAHBLEEBhAAAHCAABCEA.TDFAhABAABFAKEGD.QECAhACAbDBDMEIB.XFFA.....hACA......hAIA...,2,-22,-6,16
MbQgVBfXKWeFUOREIaJcDSNZHGdPYCATL,MAAAQAAABADAKAFAeACA.FAFDRBBB.EAHB..aAHDDCDB.ZCEAHCFAhAFAdDAA.CDEDLEHBhAHA..bEEBfECAhBAAXEGAOHCCIFFASGGBhAAA.....hBBA...,2,-32,-3,29
WNPEOUcbSHFeZXYTJKCadGQMfIDVLRBgA,...PAAAEAAAOACCUAEA...bAFBHAGD.eBCFZBGBTCCAhAAACDDAGDFA.MCIBhAIADCFBREAAADFB...cEEChAEAXEBCKEHBdHGBfHEB.IHHAhBAA....hBEA...,1,-8,-18,10
ZTQNGJAMUSPWBCFOHdaXEYIKgLDVbecfR,MAAASAAABADAFAFAHACB.dAEB.EAHBKBBALCFBDAIB.eCHBhAAARBEBZCGFQEDAhABAGDDAADDB.PFBB.hBAAOEHHaFGC..XGED.IHHAhBBA....hCAA...,2,-34,7,41
YcUIdFRLSeDaBbVETNZGWAfXPKgMHOQCJ,XAAAKAAAHACBQAEA.CAGA.cADAdCAALCHBhAAA.eDEAaAFAbBCDEEDBZFFAhACAAAAA...fHEBhAEAMAIBOBFD.UEFB.FGGHDIAABHCAhCAA.NEIA....hAIA...,2,-11,-6,5
INRAeWdfJHXYDMGSVZPgBOCFEabUTcQKL,eAAAdAAAHADADAEAGAGAZABBBAGB.FBHDEBCAUDDA..TCDAhAAAQEGALEFARFAA.hAFAAAIBfFBAhABA.XFCDMIAASGCAgGEBaGEDhAIAKGGCIHHA.hBFA...,2,-13,-10,3
fVdNMHXacTSZOQIWBYgePLEKRJCADUFbG,FAAAGAAAdADAHAFAaADA..SAFHZCCAQCGABAHAeCDBhAAAEDBBREEA.ACHADDFA.UEGAhACAbFAA...VEBBMFIBhAFAXFEDOHACIGGAYHAA...hAHA......hBAA...,1,2,-13,15
IYfQKeGJdcZFNLaPbWASOVUBEHRgDMXCT,OAAABAAAHACARADA.MAEACAGB...TBFA..fBBEhAEAeBHHdCAAZCCALCFAhAIAbECB.ACGASDCAhBAAEEFFXGGAQEFAKHBAcEGDaFEH.PHFChBIA....hCAA...,2,-26,6,32
FYfADdNWZMGgXEBSHURLCcbaeJPVTKQOI,dAAAZAAAGAEAEADAHAFARAGBLCABCCBA..aCEBeCCB.VEFAhABATCGA.QEFChACAFGAAAADADEEB.MDABBGDDhACASDCH.bFDDKGHBOFHD.hAGAfHABNIAB.hAIA...,1,3,-7,10
KWAeQGDIOgBXUdZVNFRYTScCbJEafMPLH,eAAAGAAAOADCBADAdAFAZAGB.FAHBRCCA...SCDBCDHA.hAAAECHFaEEA.MFAAHDEBhAAAABIBQFFBhABADDAB.XFCAVFBATGGAbGAC....hACA......hADA...,1,-7,-18,11
MgESFGBIbQWTAXadUfZeNKOCcHPRYDLVJ,dAAAZAAAeACEOADAHAFBRAGB.LAHB.MCCBEBDBGCBAhACABDDAQEFAAAIBaDFBUEGAhBAAKEHBCGCA...PFABhABADEEB.VFDBSGFDIHHA...hBCA......hBEA...,2,-21,6,27
aXbECIOQPKeVcdFDLHgJRAYUWSGZBfTNM,UAAAGAAAZADABADA..TCDAaAEDEAGA..OAFAQCFAhAAAeBHFdEAALDCBhACAHDFBRFCAABIBSDADhADAMDIBCDCDKGHD.FEEB.DDIB.gFGB.hAEAYGAA.fHDFhAGA,2,-13,-1,12
CALaJDHGfeZIbVRdKUSYgEQWOTPNMcBFX,aAAAHAAAGACAeACEZAFB..VAEARCCBdBHAKBHBSECD.hAEAEEFAQDFAhAHA.TEDAMEIBFFABhAAAABBBLEHBfFEE.IGGA.hAIAYHCA..hAFA...,2,-12,-11,1
HRZSgdAFYLaPcDXCbQWOIeBVJfUMKGENT,LAAAaAAA.DAEACADAQAFAOAFEBBDA..VCCAUCAAGDAAhADAECFA.HDFARDDBZDGBhABAdFFDAEIB.FFCD.PHDChAFAXFCD.IHHAfGHA.MAIBhBAAKGFDNIAB....hACA...,2,-23,9,32
AWYFeBdgXRKUHfEQPbGDVMLTNOCZScJaI,FAAAeAAAdADARADAHAGB.ECCBQAFA.GCDBMCFBTEAAhAAACAHAZDBA.SDGAhABAaCHDACCBBEGDKEDBUFAAhAFAbFGBLGAAOFFB.cGDDIGHA.hAEA......hAGA...,2,-14,3,17
GbLEXDaCSQeMfKdIgHZPFVNBTcOAJWUYR,UAAARAAAGADAEADA.DAFA..aAFDQBFC.eBHHMAHBdDAAhAAAHCBCZEFAFCCHBDADTGEAhABAAAIBJDFB..bEGDCGGBKHBAhADA..IFBA.gFDDhADA.NCIA....hAIA...,2,-11,-4,7
ICUgQdbScfNAeJTOVHXLZRPWBMGFKaDEY,eAAATAAAHADA.ZAGBRACFBAEBGCCAaAFDEDHF.CCFC.UDEA.dAHAhAAAbEFD..SCADhACAfFAAADHAOECBhBHALFEDMEHBDGIB.gGEAcGAD..hCEA......hDBA...,1,8,-19,27
gKAaMTeSPOdDZCGJVEFYfcWBRHLXUbNQI,aAAAeAAA.OADCZACBGAEA..EAGEFAGA..fCCAhAAABBBDHCGBLCFAhABAbEBAQFFCKDEDACGAMEGBhAFATGBAdEHACECA.YHFG....hAIA......hCAA...,1,-7,-16,9
GPEZaCRTASWOUVFJbQDLeKgBMcNXHYfId,OAAAFAAAQADALAEAKAFAMAIB..XBGAHBBCfCEAhAFAGCCAEDAAaCFDREFAAAHAhADASCHD.hBAAVFFAbFDDDGHBeGAA.......hCAA......hCBA...,1,0,-13,13
CedTObcJBAIXSVUKWDNgGaLQHMFYEZRfP,SAAAKAAADACAGADBLADAHCCAMAIBEAHBRCCA....CCFBeCGHhAAAdCGATEEA.OECBhAAAbEABBEEAAAGAXGDChCAAUGGANIAB..aDHDQGGA..hCBA......hCCA...,1,-5,-11,6
EZUVgaTSHJMKAdfOWLQFCcBGRINDbPeXY,dAAAOAAALADAFADDBAFARAGFDCCA..eAGHECEF.ZCCA..VDFBhACAaBHD..HEECKEAAAAEAQFAAhAFA.CEHB.hAIAIGHA.NDDA.bFCD.....hAIA......hBAA...,2,-33,-12,21
TKdUeEfGRQIaNPCMFgHBYZbLDXAWOVJcS,OAAAVAAA...SADAdADAEAFARBFA.aAFD..CDDA.FAHBHDFChAAAZBBALDDAAAIB.hAFAJCHBTFDAeEABGFDBhAEAQFFCIHHAMFIB.....hCAA......hDAA...,1,-6,-16,10
JeLUCEdXfAPDIOFQHYcWgZVNBKMbaRSGT,DAAAFAAAHACB......cABDZAEABAHBMAEARCEAGEEBhAFAeAHFLBEBEFCBdGAAACIBhAGAOCDB.QDGBhBAAYHEA.gFFBKGHB.aECH.hBAASGBD.hCAA...,2,-16,-14,2
LUYAJIdcMgaTPZECQBDfRWSOGNHebKXFV,dAAAMAAAaADAZABE..EAGAQAFA.DAIBRBDBOBHDHCCAeDFAhAFAXCAALFCAhBAAACFAJDFBgGFAhBHA.CEHA.fEHE.GGAB.hCAAKGGA.....hCCA...,2,-14,-9,5
RKFZcgJWYQIGXebNVfPDaUdSOLMACEBTH,EAAAHAAARACA.ZADB.JAFBQAFCGBGA.eAHH..bDABfCCEhAAAaAHF.dDAALEEBhAAAACEBTDFAFGGAgFDAhADA.IFHANIEB.DGGB.hACAOHAC.BHHAhAHA...,2,-8,-3,5
MQPEKdHBLRUaWNDbSJFOIgGcCYVTXfeAZ,ZAAAMAAAEADEHACCLAFBRAFFUDCA..aAHBDAIB..SBHHhABAOBBBGCGACCAA.TFAAhAFAeCCAAEEAKFEAdEGABGHAhAHAbGFA...........hACA......hCAA...,2,-19,-9,10
daYRbWXNKOgSPETVeGZQfcHABMDJFCUIL,MAAAFAAACADA.LAEA.dBBARAEF..XAGBOAHD..SCEAhAFAECCB.eDCFhAGAZDAFQDFAhADAHDFCAEEBDFFBIGGAbEDDKGGA.......hBAA......hBIA...,1,-15,-29,14
aXgbEVZcKJHMGLTQCFSBeWdYUPAfONDIR,OAAADAAARABA...aADDXAEB..EAFAZAGBKAHBHCDBGCDBhAFATEGAQDBChBAASDCDeDHFdGBAPEEBhBBAADIBIGEA.gGGAbGFAcGCChBDA......hCAA...,1,-10,-11,1
AJMWGBQENLUZaSdOcYIVKfTgXCHFbPeDR,MAAAGAAABADAEADALAGBZAEB.dCDAOAGD..IBFAhAAAfBBATEFAhACACCDCHDECbFDD.DAIBAAIBJFHBhADAQFFBaCHD.SFHH.cGBAhBAA....hBBA...,2,-34,1,35
MbgTcaYHNWVUKfSGZJBALFEeRdICXOQPD,EAAARAAAdADA..CACA.QAFAMAEA..TBDAaBHDHCDC.VEFAhAAAfAHA.hABAZBFFACCBeEEDOCCBbFAAhAFAgEEB.cFDCYHBAWCHHhAAASGHHBGHALHDAhCAA.,2,-24,6,30
UNeYbFWPMZXDOfcLSCVEIRHQAaBgdGJTK,aAAAdAAAGADA.KAFAeACHFBHD.MAEAZABB.OAHDLDFBCBEAECFFhBAAHFAA.AAHABEHAhAFATDGA.UEBA.bEDDhBBAXDBA.fGHASFFBRGCA.hBAA......hBDA...,1,-10,-11,1
ZgREIFHSAOfDUJGKeTdYPVQNMXBacCWLb,DAAAGAAAeABAdADA...VAFAMAFABCEAaBCE...CCHALDDAhAAAZBEBEBGAHDFBAEHAODBDhACAfCHA.KEDDhBAATFFAPFHDNIAB......cFAChAFA...WFHBhAIA...,1,-11,-28,17
PYHRNdKcXMZVDTJFCbOeESaQLABfgUWIG,BAAAUAAAGADAHACARAFFdAHAKAFA...MCABZCFBDAIBFCCH..ODFBhAAAEDAA..aDDHADHA..hADA...fDHAhAFAgECAIGGAPEGD.NHAB...XFADhACA...hAHA...,1,-18,-29,11
ZLBFHSgKVCDfQAPUdTEaYcMINWJRGXbOe,dAAAEAAA.aADAMADA....IAGAJAGBRBCAGDBAOAHDeBHHhAAAZBDALDDBHDEBKEHBDCBBhAIAACCBTEBA.NDHA.hACAbGEABFFA.SGHH...hBCA......hBDA...,2,-16,-7,9
JPYIXHbdSKOENBWTUFecAGZRLQMVaCgfD,RAAAMAAACADB.DAEA..JAFA....IAHAHBDCdCHAKBBAECCBBBDBhBAA.UCFAeDFFABFAZDDBhBBALFHB.aEDDhAAAfEHA.XFFDOHDANIABFHDChCAA......hCIA...,1,-15,-37,22
NLRZMXTgPBKGVHFeQEDaWIYcACJUSdbfO,CAAASAAAdACA.OACDRAEAZCBA..MAIBTAEA..BCFAhAAAGAGAHCGBeCDHEEAADEFBhAEAaDGHIEAAhAAA.AAIBbFDDLHAAXFFCKECAQGFAhAFA..cGAAhABA.fGHA,2,-19,1,20
TKGcMCbYBNJHRVgDLEQaAeWfPIXdFOZSU,eAAA..fAAAXADA.dADAZAFBTAFAGCCA.MAIBhAAAbCADBAHBHCGBREABDCCBEEFBhABAACHA...IGHAhAEASDDAKHBA.CDGAYDHB.VFCAhAAA.LFFB.hBHA...,1,0,-6,6
GedZTMPBUDHFRWaVSgAYEOKIcbCQNJfLX,EAAAKAAA....IADAbACA..QAGAJAFA.LCCBhAAAeBEFZCAAMCEBBCFAhAAAHDADRCGF.aCGCSEFDhACAAADAOEGBCEHBXGFAdGADPFEDDEIB.FHGEhAGA......hBIA...,1,8,-32,40
GMPVLSDCgWXZYAEKFdONJbHfIeQaTcBRU,EAAAdAAAOADA..bACAHAGB.eBDBaAGABBGARCAAGDEAMCCBhAAALEGBCCHA.XEBAhACAAADAFDDAJDGFQGBChAIATGBA..PFFBDDIB...WEHHhBGA.....hBAA...,2,-18,0,18
JMBUPVNbWDAICFOGcYgZTdSfRLKHQaXeE,FAAAGAAA....gACHdADARAFAHCDCQAFAeCGHEEEBMCIBhAAABAHAUDDA.hACAPCHDbDBDAAFAOFHBhAIAZFAATFGA.fGEA...hBAA......hBCA...,2,-15,-3,12
QNCEOfKUWYFPJGTcAeIDBRHXSMbgadVLZ,eAAABAAAHACAMAEA.aAEAdBDAZAGB..QBFAECAA.KBHBUCEAhAAAFDCHGEEAABIBREFASDDDhACA..gFBGhAAANIDB.fEHA..hABA......hAIA...,2,-22,-18,4
dfGQIgJCBLWeEcFVAHNTMKbOXPaYSRDZU,HAAAMAAAKADAXADB..aAFARAFAZCAAdBBAGBEBQCEDJDCB.hAIALCHB.EEFBhAAAFDGDACCAbGAAOEDDSGHBhACAfFFECHEA.eFHF...NIBB.hBAA......hBIA...,1,13,-21,34
WaZFYXVISHEQMCJNLTcDUBKdfbgROeAGP,GAAAaAAAZACB.FADA...XAFDSAEAHCDAEAHBMAIBCBBDLCEAhAFATDGADDCBKDHBdEEAhAIA..bFEBRFCBACFAPHAAhAAAVGFA.QGGA....hACA......hAHA...,1,1,-9,10
ZIEaVQbcJGfdFeCXYPSTBHULRDMKWgOAN,ZAAAEAAA.aACAQACA..bAEDGAEBdAGAFCCHeCCB.XCEDhAAASBHHHCGDhAFARECAMEGBKFFAOFHDhAHAAEHAIFHA...cGBA.CHHA..hAIA......hCAA...,2,-13,-5,8
ORBaeUCQFcbIHALVJNXEZYPSGfWDMKgdT,LAAAVAAA.XADDEADEZAFB...SAFAGCDADAIBMAIBhABAdDCCRCGFeCABUFGBQCFAhACAFFAB.bDDDhAFAAFFBJHBAPCCB.KEHB.TGAABHHD.aFFDhAGA.CHDAIHHAhCBA...,1,0,-9,9
aJIDRKAgEZSHCXFMBVYWTUNQOeGLfbcPd,EAAAHAAAFACDMACA.BAFA..VAEATBDAQCDDGAGALDDAhAAA.bEFAhAIAdAHAaFDBDDGA.AEAAZEEAhAAAXGGCUGEAOEAE.fGHAhAEA.....hBIA...,2,-11,-8,3
gaZHfAbQLNcBMJOCDUdFYVIEPRTXeKGSW,LAAABAAAMACACAEAdAGAFAFD.....ICAARBCBeAHBGCGAhAAA..SBHHhABAaCBHHECCAFGBbCCAQGDBhAIAJDGFDCCAUEAAEGHF.XGBA.KEEDhACA.gGGAhAEA...,2,-22,-6,16
VgcaYNMZAeBXLCEGDHTISPOQbJUfKdFRW,eAAALAAAEADAHAFATAEA..SCCAQAGCUCFBdCAARCCAhABAgEEAaCGE.hACAMCIBACCACEEAGEGAhAEADFHBOHAAfGEA......hAIA......hDAA...,1,-6,-8,2
ZXAbDTLgWBVOSQMFPEHdUcGRKCYafJNeI,TAAALAAA.BAEASACBMAGBEAHBHAEA.dAHAGCAAhABARCCACCGD.aCCAJDHB.eEABhAAAZDDAACABDEEAVFCAFFFB.PCHBhACAKGHB...fFHA.NIAB.hAEA......hAIA...,1,-7,-8,1
VTcYBHGFKDWXaOfEegdLRNUQMSCAIPJbZ,JAAAZAAA..TAEABADBHAEBGAGADAGAaCAA..EBGEdDAA.RDDAQFFAhABAMCCB.AAIB.hACAbDCDVGAA..FDHBhBAAXGDDeEEBgGFH...hADA......hAEA...,2,-22,1,23
TbCJAUGFWEXadVLMPceNZSBYHgORKQIDf,GAAAEAAAdADALAFAMADAeAFAZCBABBHAHCFARCDA.QEFBhAAADDCB.TFCAbDFAAAABFFFAhACAaEHD....cGAAhAGASECH.OGCEIHHACGHAWHDAhBCA......hBDA...,2,-17,7,24
KOXPGJNZFbCRVLHeAdcWUESgQDBaMIYfT,dAAAUAAAEADAQADABAFA..aAGDMAGB....fCBAhACATDAAXCDChADAGCEAZDCBbBGDREEBHEGBhADAAAHASFBADAIBKGDA.OHFCNIDB...hBAA......hBCA...,2,-14,-3,11
gFfCAOGdLUMeWYPQZcTNKSBbaEHDJRVXI,dAAAMAAAeADA....PADCZABBTAGASAGBBCEAECGBhAEAHBBA.RCEA..XDGAhAIAFDCDACIBGEEALFCAhBAA.UGGAYEHBNIBBaDDH.DIAA...hBBA......hBIA...,2,-14,-4,10
cQgHRIEMZLVSUFDBObCfXdGPYANTJeKWa,TAAAeAAAKADA..aACAQAFC.HCCAEAFAZBDALAHBhAAASAHHDDGBbECAXCCChAAAGEGAAEIBWDEAhAFA.RFDA.MHCAFFHBCHBA.......hABA......hCAA...,2,-10,-6,4
XGNabZdDJfKWFBIHVRTeYMScgQLPCOAEU,EAAAGAAA.aADAdADADAGAKAFA.BAHBHBFARCBB.eCDB.MDFBSCGAhAAAQDGALDDBhAFAODBDABCAXDFChCAAZGFEfHBB..FEHD.TGFAhCBA.gGCGhCFA...,2,-25,4,29
KTSFUHdOMgWGIZPVbRfAXJYLCBacNQDeE,XAAALAAAaADD..QADAEAFAKAHB.TAFAFCAAHCEAhABAdAHAMCDBGEEBZDABbFAAhACAAAAACDGABDDDDDABeDHHhADAOHCEIEEA.RGDA.fGHAhAFAcGGD......hCGA...,1,7,-6,13
TRWAIZLEHcfYdbGgVPaDeUMOBKFXSCQNJ,ZAAAHAAA...fADBbADBGAFAVAGBDAIB..UCAABCADFDDHhABACCCAQCEChAAA.TEFAAAHBEDHBdFBAhACAaEDHeEHHMFFBXGGASFAA.JHEA.hBFA......hDAA...,2,-14,5,19
HFgaLUKSDdMJTCWcfNOIYVXQGBPZEebRA,HAAAaAAALADASACEdAHA.MAFA.TBEACBBD..fCDAhAEAOBGDVCCBGCEAhAFAZEFAEGBARDGFACGBFGGHKGEADBIBhAAAJHBA.NIEB...YDCFBGGB...hBGA......hCAA...,1,4,-10,14
VBHJDFGCfIbLeYNQcaEZgRMSUWTOdXPKA,HAAAFAAAGACACADB..IAFAeAEAQBGAEAHB.RCEBMEABhAEASCAA.TCEAhAAAdEHAKGDAACGABDCAhACAfGFBbDGDLFFDNIAB.aECE...hAFA......hAIA...,1,-7,-14,7
VacSQNbDTRCKZMgIGXEfJUAFYWLBedPHO,FAAALAAAeACHHAEAaADD..QAFADAGARCEAZEAA.MAIBGEEBhAEAECAAUDDAABIBBDDDdDGAOHCAhBAASEHH.hCAAbFABKGHB..XGEA....hABA......hACA...,2,-10,-10,0
BSTEGfRJADPaNHWeLIQgCdVKZYMXFbOcU,aAAAHAAALADAQADCdAHAZBBAMAFAFCFBOBFC.BCADEDDBRDGBhAEAABHADCCB..PFAAhAFAeDDACDGA.KEHBbFFDSFFBhAAA.fHGFWHBA..hACA......hDDA...,1,-9,-20,11
FELPJAQbgGTYDORcZKBadIfXMSHNVCUWe,QAAAGAAADADARAEAZACBBAHBdAFA..XBGDHCDACCGB..eCHHhAAAECEBLEBA.hACAAAHATEGAODBDaEFBhBAAMFFBSFHHUGGB.FGFD....hBCA......hBDA...,1,-5,-16,11
FcXAJBTKgLNRVfdGCbDQUYWOaMIPeEHZS,TAAALAAA.RADFdAFAGACADAHB.QAEAUCAA.OAGFhAAAaBHD.MAIB.eCABhACAHDDCZDFAFEGDAEABKEDAgGDAhABAfFGACGHA.......hACA......hAIA...,1,4,-23,27
NcaFMPfRdBIVXgeWYUALSQDJEGHOKCTZb,LAAAQAAAEAEAHACAKAGA.ZAFB...bBGDaCAA.MCEARCDBdEAAhAAABCHAXFCCeDCAUEFAhABAAAIBDFFAOFHDhAEACEAATGDANICB...FGHD.......hAFA......hCAA...,2,-15,3,18
WNVecHLPZKCfBObGTSFgIXdRUQDAJaEMY,EAAAMAAA....NADA.eACAHAEAZAFBCAHBBCBAGCCA.TEFAhAIAFCEH.XFBDRCGBQEAAhAAAABBBaEHD.VFFBLHEAhBAAKGAD.fBEASGCA...hBHA......hBIA...,2,-8,-8,0
QBXfUDgGPaZHOWbYMITSECVKLeFcJdRAN,QAAAXAAADADAGACB.ZAGBHAECOCDB..bBCDMBIBhAAATCGAEDAAKEEAeCFDhAAAFEHHdFFDAAFABCFC.hABAfGEAPHAAaFHDIHHA..hADA......hCAA...,2,-13,-5,8
FWGMdEcZYKfNOaILbDAUgXBQCRTJeHPSV,XAAAQAAARADA.eACAHAGB..SAFAFCDHGDAAEBHFZDFAhAAAKCDAOFCCLCFBhAAAAADABFFBTDAAJFHF.PDHDhADAMIAA.dEEC.fGAA.aGGBhAGA.IHHA.hABA...,2,-8,9,17
bgXQfASPMecNJBFEULaZCKGTHWRYIDOdV,MAAAeAAA..JADBEADALAFAZAFBGBBAHCEARCGF.DCCBdEDA..VEFAhAAAXFED.AAIBSFBDhBAAPGAABGHAhABAaGGAKHCA...YEEFOHBE...hBBA......hBFA...,2,-11,-11,0
ULCTFdZOYcGgSDJIAPKbVeNfMBWXQREHa,KAAAeAAAMACABADA.QAFAHAECLAHBFCCAZCFAOBCC.hAAAGDDADAIBAEEAVEFAhABAfDGE.RGFAEHCEhAAAaFAACGHA.dHBB.........hCAA......hCBA...,1,-11,-19,8
FaLVREQTJBXbYHPcSeWZDKdOfCIGgANMU,MAAAaAAALADARACA..EAFEQBGABAHB.XBBChAEAHCCCSCFBeCDFZEEAdFAAhAFACBBDGDGAACFBFGDA.TFEAhBAAYHAGPHCCDEIBfGGEhAHA......hAIA...,2,-9,-2,7
NYfeMBPJWAETHKbIZdaOUCLQFgXcSDGVR,HAAAKAAAZACBaACAUAFALAFA.FCCA..XCABDCFARDEA..hAAA..fEHAhAAAeBHHMCEBBCHAJDFBEEBAhACAbFDAdGAA.CHHA.QGGA.SFBAhAIA.NHBB..hAGA...,1,-14,-17,3
CLeTNQfBUEXYHOKMSAPRabDdWJFgcGZVI,RAAAaAAAdADA.FAFAGACA.ZAEACBFDLCHBeBBDQCFCBCCD.hAAAEDHFHDEAMAFAAAIBDEDBhABAJEDB....gFFBhBAAIGFA.NIBB.XGDD.KHGA.hBIA......hCAA...,2,-27,-4,23
DcNLTWOAZdSVagJbBeYQGMfXCFIERPUKH,dAAAaAAA.JADABADA..eAGHGAEA.MAHBCBDDFCBDRCCB..KBBDHDDAhACADAIB.LDHBhAGA.TFCAAAGBZEFBSDADhADA.bFGDQFFA.hBAAfHEBEGDA.hCAA...,1,-18,-23,5
UeYdXZFKBAPHROcGLIfabMVENCgDJTQWS,HAAARAAAGADALADB.aAFAbAFA.ECCBCBFADAIB..QCFAhAAASCAAeDABdDFAZDGBhAAABDHBAEEAOFBAhACAfEFEMEIBgFGHWHCA.XGAAhABA.....hBFA...,2,-17,12,29
PJVNAORZUSWIaHdGCYKeDXFTBQfgbEMcL,RAAAZAAAUADASACE..aAFEHAEBGCEBKAGAeCCBFCCHBBHAhAAAQCGA.bEDDhABAEEEBMFFALEHBhABAPGAAVGAAAGGA.OHFCIHHA...hAGA......hAIA...,2,-14,4,18
BTOaLRPWfHSGAYUMJNEZIgcedCbQVFKXD,MAAAEAAAZACB....IAEAeAEAdBHAQAGAKCEABCBCaECAhAAARBBA....fCEAhAGAHEGBACGAUFAAgCGGhBAAbFED.XEFCDIAA.TGGAhBBA.ODDH..hBCA...,2,-25,-10,15
aOHESCGYMFNLTdIcXAgBfePJRWDZUKVbQ,BAAAeAAARADAZACA.KAFCQAGCHBGB.ECCBGCCA.MDABhAAALCFAdEFA.XEAAhAAAAAIB.fEDAhABAPEHDDGCBbEGBaFDDCFEAFGFD.NIAB....hADA......hAEA...,2,-25,8,33
dCGDecBgKTLZHRIYJXASPbOMaQfFUVEWN,SAAAOAAA.MADAaADDFAFA.UCFAEAGAdBDA.GCEAhAAAeBBBBCHATCGAHDDBhAIARFBAIFHAXFBCABIBQGFDhABAVFGB.CCCC.DGFB....hBAA......hBDA...,1,2,-18,20
FRQWPaSdHOMcKLZNXfGTCeBEbJVIgYUAD,RAAAQAAA.aACEHADB.MAFALAFAZBFBfBHAhAAAGCDAeCFAECCBbDADIDAAhAAA.UFFAADABFDHDhABASDCDdFDAKFFA.TGAABGHA.gGCBhADA.DFIB.hADA...,2,-4,6,10
OVdFSIPRaTZYXCeHbBQKUEgADMNfWLcGJ,MAAA..fAAALAEAGBBAOADAdAHASAHHhAFARBCAZBFBCCAAHDBAbDEA.QEGAhAAAEEDBABBBDDIBcFFAhAGAFFDAaGGC...TGCAeHDE.....hACA......hBCA...,2,-5,0,5
VMPCABROdNWZKHJYbSFTLGfEQIgeaXUDc,RAAAdAAAZADBHADA.JAHBSAFALCCAGCFAEBHF..QDAAhAAAeDABaDHDDAFAMCGBhABAAEEBBGHAOCED.KDHBhADA.bFGD...TGAA....hAGA......hAIA...,1,-12,-19,7
fSeAQBbRUXNGZKJFcTPLgYWOMHaDVIdCE,QAAARAAAUADAGAGAZACBFAED..TDDALAGB...hAAAgDEBOCCBHDFBhABAaCHDDEEBdFBDEFHFeFGFhAAAAAGB.XGBANIAB.......hAIA......hBFA...,2,-11,-9,2
LPFMKGfORSDXUecTBNHCZVQbEgIAdJYWa,dAAAJAAA.aADALADB.FAFAGAFA.RBDBXCAAeAHHTDEAhBAAHDGB.ZFEFQEGAhBFAEAHBADDB.PDCBhCAAMIAAfGGEDGDABGGDNIDB.....hCBA......hCCA...,1,0,-21,21
FgEGVfbdYeITSAaBOMXCNULJKRZQWcHPD,aAAAMAAA..CADALAFARACAZAFB..QCCBHCCAFCFAEDABGCGAhAFA.VEEBdECDeCHHhADASBHBAAGAOEGHhBAAXFCDJFEBKBBDWBBDDFIB.....fGHAhAIA..hBAA...,1,-4,-18,14
HXSfEVTQgbGDLIAMOPcWCaFBdNUKJYZeR,MAAAOAAA....PADCCADAaAEDdAGAKAGCZBBAHCCA..SBGAhBAAECHFQEEAhAIAGCEALFHBADDBFDGABFHAhBCAUGBAeHFARGDE........hCAA......hDAA...,2,-21,-2,19
cedIHJDbaCTOPQVZSLNfFUXYEKAWgMRGB,MAAARAAAGADABADAeAFAHAEB.DAGACBHA..OCCBQBBC.hAAAZBGBLDABFDDBXEFChBAAECGBAAFA..gEFBhABAdGBAbGDA.aFDA.......hBGA......hCAA...,2,-15,-12,3
KSdPbZOIQJXCTeDUcBEfYHgVaRMAWGLFN,GAAALAAAKADAdAEAZAFBQAGA.CCAA.eAHFDCCBBCFAhABAECDAHEEA.aCHDADDAFDGDhACASDADOEBBXEEDhAGATGGA..fDCE.gFAAhAAAMDIBNIBBIHGAhBEAcGEC,1,-22,-30,8
QLeGOYgBHNRZaKWVcJfDdbUTFCSIAMEPX,EAAAQAAAGACAOAEABACAHADB.RAFAaCFEKAHB..VCEAJDDFdEHAhAAAUFBA.FCBHSFAAhAFAADIB.MFFBhAGALEEA.eFHFgGGGWHCADGGB.hAIA......hCAA...,1,-5,-13,8
JHDQXKMYTZPUIaLfREBeNCGFOgWASbcdV,SAAAdAAAHADAQAGCMADA.ZABBIAHAaCED.RBCAEBFEhAAAeCHF.GDCAFCHDODBBhABAAEGBbFAD..cFFChAFADDEAKEEA.TFGA......hBDA......hCAA...,2,-22,8,30
DJSXFKLUcTIfeGbWZQYaANEVMdgHOBRCP,EAAAdAAAHADARACA.DAFASAFBKAHBLCCAUCCB...TCGAhAAAeCFHGDAAZDAFaAHF.hADAACHBMDIBBDFDCEHAXFGDhACAFFCA..fFFAWEED.YHBAhBHA....hCAA...,2,-19,-12,7
UWYPFRfTIcMOBaJeLKEgHQZdCbDVNGXAS,SAAAUAAA..PADARACF..TAFAMAHBBBDDeAHHECEBhAAAHCDCdDGDDAIBGEAAhABAABGBFDHD.fEEEhAEA.OFCDaEECLGEAQGFA.hBAACHHB......hBCA...,1,12,-31,43
YMfDEPReAGZgNaBWKOJTXFQSHLCIbcUdV,ZAAAaAAABADAOACA...JAFBTAFA.QCCAHBGBLDDBhABACAHB.IECAhAHAbCEAdDAA.MEIBEEFBRFAAAAIB.hCAA.NICB.XFGD.SGEBhADAcFED......hAFA...,2,-15,-15,0
OBERQFSgXAIDPaCMGVJeHbNfYZUKcLWTd,DAAAaAAAGACAeABAHAEA....bAEAfBHAZCEB.KCCAhAGALDGBdDFAEDHFRECBQEAAhAEASFGAAAIBCGADhAFAMIAANCIA..cGEA.....hAHA......hAIA...,2,-16,-6,10
RgaLWdJQMCUKEcOYDZHBGVbSIPXNfTAFe,RAAAaAAAdADA..MADAKAFA..EBHFOAFE.ZBBAHCDCGCEAbEEA.hAAASCGA.hABAXDBATFAAAAHAeEGFhAIAgGCALHCAQGGBCGCBYEHBhBAADCCB.....hBDA...,1,-5,-7,2
bFKXUcgMIYLHSCRDJNGZEVAadOQPBTfWe,dAAAQAAABADA..TAFAeACAbAFAKBHB...UCDAMCCALCGBhAAAHDAARDDFDDGBGDAAhADAEDHB.AAGAaEHD.fFDAhCAAXFAAgFFASFFDCDFBNIAB.hACA......hADA...,2,-20,9,29
OQRAVWLMIgafUJYSNBDECbeXKdPTHcGZF,LAAAMAAA.aADDUAEA.SAGADAFAEAHF.eBBAdBFAHCAAhABAZCEEQEFAhAHAACIB.IHFAfDEEhACANCIABFEDbDGDKFCA.TGEA...hBAA......hBBA...,1,-8,-23,15
MTUEPCbeFdAcOQHgXRNBKVLGWIfDJSZYa,QAAAHAAARADFKAFCGBGA..fACFSCAAaAEDMCFBhAAAEAGA..CBHAeCDBhAAAAACAODDBXCFDBFGDLGCAhAIADDIBZEBBTFFA.PFDBFGHD.hBIAdGACNICB.IHHAhAGA...,2,-8,1,9
IOXdAcWZRgUFNaTDHGVLBYJKSCQbPfeEM,ZAAARAAAFADAaACAHAFB.GCCALAFABAHAKCCD.QCFAhABA..bEFAeDEBECHFMFEBhAAAXECDACCB.gGABhAGATGGADHAAVGFA.SDHBhAHA.....hABA...,1,3,-15,18
RbEcDJHdgBFOUZPaQfMNGeXKYSTLCAIWV,VAAAEAAADADA..HADBdAGAFBCAZAFA..aCFDMAIBGDAA.eCHBhAAAKCCD..SBEHhAAALEEAAAGARDEA.bFDCJEHBBGHAhADAOGBA...PHDCNIAB...hAIA......hCAA...,1,6,-23,29
IQaZcFWVNRfCTMOGbHgSeBXLdUYAJKPED,KAAAEAAADADAQACC.ZAEBFAFD.VBCBRAGBCDDD....MCGBhAAAGBGAHEAAeCBDLEHBhAEAdEEAAAHAJFHBaEFHNIABOFDHhAAA..SHFGBGFA...hBCA......hBEA...,1,-4,-20,16
dOfQYFcLEDPUVSAbaMWTRHCKIGNZXegJB,aAAAMAAA.RACA.HACBKAFC.GAEBZBEE.eBBDBBBDdCFD.QEAChAEAFCHDEDDB.DCIBUFDBhAIAAAHAbDEC..CGGA.XFFAhAFA..........hBAA......hCAA...,1,-1,-41,40
adITYMQECLNRbHfceVJOGPAKZUDBXFgWS,ZAAABAAAFADASACAdAGA..TCAAMAFAEBEALCEB.hAAARDGBHGBAeBGFOBHDhACAAAIBDDDB.XCCChADAaFGH.QEECNIDB.fEHEhCAA.cGGA..hCBA...,1,-12,-28,16
dYfILAagHPEbNTSUcGCMVRDOQXJBZFKWe,HAAAEAAA.TAEASACAGAGAMAFARCAAQDEABBEAZBFBKBHBhAAAeDHHdCCA..fEAEhAAAADAAaDGD.bECDcEEChADADACAXGEB.FGAHIGHAhCAA.PFDBCGHA..hCBA...,1,28,-25,53
ABIJUVbcOZFQECGfgeKRWdYLXPTNHSaDM,BAAAUAAA...VACAOADAZAFB.EAGAGCAA..eBDBRCGFdDDAhAAALCFA.TEBAhBAAHFEAaFAHADDBbEFAFFCHhACA.fGHAKFEDXGCDNIAB.DGGB.IHHAhBCA...hAFA...,2,-9,-9,0
cQUCEYPOFWZHMfXAbGTBDNeRdgaSKJLIV,GAAATAAA.DADARACF.dAGA..aAEAKCDALAHB..IDGAhAAAQBEDEDCBODHDhACAZDFAHFFA.MCABhAAAAAIBBBFCeHBASEEB.VGFACEEDYHFGhACA...hBAA...,2,-30,9,39
FeSCWRQDXgaLMTcdGVZHEINKbBUAOYPfJ,OAAA..fAAAeADACAGA.RADAQAGCDAIB.aBCHhAAAMBBBdDAAZCFAHCCAEDEBhACAKCFCBEGAADHAJEAFSFGAhADAXECATFFAcGEA...IEHAhAEANIAB....hBAA...,2,-32,-4,28
MgINJZbHXFBTOERefSQAPacGVUDKYLdCW,aAAAGAAA.DADALADAdAGA.MAHBICDAZBBAHCEB.BDHAhAEAECFBRDBFeDDD.QFAAhAFAAAABVEEBKCHBCFGAgGCBhAIAJEHF.bGFAFGBH....hACA......hAIA...,1,9,-20,29
CKQFGOgfJNeXTbPdWZSERcYUDABVaHILM,aAAAHAAALADAMACAQAFAGAGAOBBBJBDB..eBHHbCDB.hAEAdDFAZDEBRFCAUGGA.hAFAACCBBEHACEHAFGFDNDDA..hAIA............hBAA......hBIA...,2,-11,-10,1
JWOabPfeNGIRUgSEZBcYLQMFDKdXHVCAT,TAAAOAAA..aADD....bACBeAFAGAEARCDAUCGAEAGAZCGBhAAABBBDLEBAFDBBdFADHFEAhAFAACCBPFFB.fGAAhAGAIHHA.SEHH..hBEA......hBIA...,1,-3,-16,13
XISHWRacbPJVGfOTBMdFDUQeZEKCYLNgA,SAAAHAAARADF..bAFBVADA.GAGATDAAdCCA.DDAAeAHFhAAAEDFB.CCCDLDFAhACA.AEEBXFCChADAaDHDPEDDOFFAMFFBQGAAKGGD.hCAAgGGA.hCFA...,2,-3,3,6
XgeMQacZbPIYCTNHGDUAfOVJSEWdKFBLR,OAAASAAAdAEABAGARACF..eAEEaAHD.ZBFA...bCDDICCAhAGA.TCFAhBAAHDGBGGDB.hBBAAAAAfHABEDBBFDEHLEHB.MFGBhBDA......hBEA...,2,-28,-6,22
OGQbfKaPDCVHSeBMgAERLJUWTXIFdNcZY,RAAALAAAUADA.TAEAFAFE..dCGAZAGBGDDAQCAA.hAAAKCDAaCCHCDHAHEEABFGAAAIBhABAEEAB.JFHB.XGAAhABAIHHA..cGEC....hACA......hAEA...,2,-37,-5,32
fLBgOeSGFTKVZXMDcWbNRPUIaAYdHEQJC,HAAAEAAA.QADCCACALAEAOAFAGCCATBFAZBFEDDHBbCACREFB.hAAA.UFAAABIB..dDEAhAAABFEDeDGFSFHHhAFAKEHBMIDA...NIAB.aGHH.....hAGA......hAIA...,1,11,-14,25
JcLMQUCYKGbdIEVTPADWZFOXeSHBgRafN,ZAAAXAAAHAEARCAA..aADAJBHB.LDEBMAGBUCDAKEADdECAEAHB.hAAA....TGAAhABAABDAFCHHeEFFBEHA.fFDAhABAQGFACGGA.......hAIA......hCAA...,1,-11,-25,14
QJcaeSPbKDYCdEAgHFXLIMOfGZVRBWUTN,HAAALAAAMACAGADARAEABAHBUAGA.QCAAaCCA.eDDDhABAbCFADDDBdDGAAAFBXEEAhAAAOEHDZGBA..hACATGCAJFFF.SFGH.KHEACHHD.hBGA......hBIA...,2,-9,-1,8
IGXdLTOKbeaPZRFEYgfUcVSNAWDCQJMBH,CAAAMAAAHACAGACBdAFALAHBKAGC.eCABZBFEEBBB..fCCEhAAAVDCAADGA.QDFChACABDHATFAAaCEHRFGBhAEAFEGH...YFFF....hAFA......hBAA...,1,-4,-18,14
HFfUJXBRKSbELcQNAGCOaVWMIDYdZgTeP,GAAAaAAA.MADADADAZADEeAFAHAGB.FBBHfBHAUDDABDGDhAIARCDASDBHhAAALECDQFGAADIBOECDIEFAhACA.dFHA.PHECKGFD..hBAA......hBCA...,1,-5,-17,12
LUHgRWFQOCJMZTPacNADVIKdfBbXeSYEG,DAAAKAAAdACABACA..eAEAEAEAGAGAHBFCRCDBFDGH..QCCAhAEACEAAZFAE.aCFHAAEA.fEHAhAIASEHHLFFBhBAA.gGBAOFFBMIAAcGDDhBBAIHHA..hAAA...,1,-10,-23,13
RgdFKHNPIUBZfbYWJEeXOMcVSCLDGAaQT,aAAARAAAdADAHACB....IAFAZAEAbCED...JAHBECGBeCCBhAAAMAFA...SBBDhBAALCFBADIBTFGAhBIAKEHDPFDDfGEAXGGAOEDHCHAA.hABADCIB.....hAHA...,1,5,-28,33
SOHLAbJKQgNCTdDaZBFEcVIWGYRXfUMPe,KAAAQAAACACB.dADAZADBEAFA..VAFAGBGA.RCEBXDBAhAAAMCCB..eCHFhAAAHFAAADFA.bGCA.gGGAhAFATEEABFCA.FFHD...cGEChAIA.....hAIA...,2,-32,2,34
OFUcVBDXKARZHgSMJCNbEIPGYefLQaTdW,HAAAMAAA.CADB.EADAGAEA.eAGBLAGBaAHF.dBBAFCAHcBEBhAIADCCBADDA..ZEEASCHHhBAAJGDA.bDCAIHHAhAAA..fEGE.TGCAhBIAODHFBGGD.hACA...,2,-15,-10,5
WYecAgDMXUFdJRTHKIVQPafBZGELbNSOC,MAAAFAAARACFHAEBKADA..QAFCaAGA.ZBBAEBGELAHBhBAA.SDDAhBCACDEDeDFHADHAXEAAdEGATGDAhCAAIEHAfGHABGGA.....hCHA......hDAA...,1,-15,-20,5
DEVfMSGNIdbBUPXWLQAFeaCJYHTOZgRKc,eAAAaAAA.CADA.HACBZAEB.RAEADAIB..EAGAMBBBGCCAdCGABDEAhAEAXBGALFAA.hAAAADIBFFFATEFAKGDA.fDHEhABASGHHIGHAPHAC.QGDAhCAA...hAFA...,1,-7,-15,8
XbWDgMdFCLIJVTBeEAPUaGRHZQNSOfYKc,aAAAHAAAZACBQADC.OAFAKAEAXAGBDBGBdCADLCHBhAAAJCEA.TDDAhACAEDEBABBBGEFARFCBSEGDhBIA.fGHAYCHB.WFFDMIBA.hCFACHHA......hDDA...,2,-21,2,23
ICNaPUVAXBWZSdTKEJRgbYDFeGfHOcQLM,BAAAZAAAdAEAEACARAGB.......bAEAFCAAGCAAHCFBQDDAhABAMAIB.CDADaDHDhACAPCCA.AAFASCFHhAAATEBAKGAA.gEEGDGGA.eDHBhACA.OFDBIHHAhADA.NIAB..,1,-8,-18,10
BWDVSFOEHPJbUCcfKMYIGZXLgANeaQdTR,eAAAdAAARADADAGAFADDHAFA..JBGBCCCDKCEA..MBIBGCGAZABB.hAEALEEB.AAAAaFAAhAFATDCABGGDSEFAhBAAEHAA.UFCB.....fFHAhCDA..hCFA...,1,-14,-36,22
aQYMVLUKJRZBedDcIOTSCPAXFgHGEbWfN,FAAAHAAAEADA..bADB....fAFAaAFDMAHBLCAAhAAAKAHBRCCAeCFHdDFADCHBOCHDhACATDAACEECAAIB.GFBBhBFAQFGAUGGABHFCSEED.PHAAhADA....hAHA...,2,-20,12,32
PLACKNQRYZVTMUJfbGFIdDcgWOeBSEHXa,KAAARAAAZADBMACAUAGA....JAFBGCEAdAHA.DCCB....hAAAgBCAeDABEDGEHFBBhABAaDBC.AFHAQGFAhADATDFAFEDDIFHA...OFFBhAAABHHB.SHBAhBDA.,2,-37,-5,32
PAeVgYEWISDMKLdZQOGcNBbaHTCJRfUFX,eAAAVAAA.EADA..SADBMAGBLAHBZAEBGAGABBEAHCCAhAAATDCAREEAFFHD.ABHB.hABAgEFBIHEADGGBhCAAdGBAQGDA.OFHD.hCBA......hCCA...,2,-10,2,12
AIPOfVdXYSBKQFCUENbMHWDTRJLgZGcea,OAAAdAAASADAKADA.FAGAEAFE.MAIBHBEC.DCCBRCCALCFBhAHAGDAAeCHFABBB.fDDAhACAXEGDBEEChBAAQFDACHCA.UFGBNIEB.....hCAA......hCCA...,2,-27,1,28
cOBURXeAQbKHaPVEINDLYfCGFTSMWgJdZ,QAAAHAAAaACAEAFADADA.LAGB.CBDAGCEATBGAMCCAhAAAJDBB.ZDDABDDCREGFAAIBbFAAhAFAKDHB....IGCAhAAAYFFFSFHDWFDH...hCAA......hDAA...,2,-26,-3,23
TcAQSDBaPUVWNEFJGCZHKbLXgMOfeRIdY,QAAABAAAaACA.UADA..VAFAEAFAGBGAHBCALDEAhAAAMDBAeDEFRFAAdFDATFFAhAAAACBBDCIB...NEIACGCAbFFAhAFA.OHFC........hAIA......hBCA...,1,-8,-9,1
NaXSYRcPDAUKCfgZMWLIJBbEFTGeQOHVd,CAAAZAAALACABADBEAFAGAFA..eAHFHCCAdCAAaAHF.SDABhAAARCCADCGBACIB.fDHAhADAMEEB.IEEAhAEAbFAA.QFGBOFFAXGGAhABAPECBKHDA....hBHA...,1,-6,-19,13
WVCARfgFJNOHdeXPIaYQKGUZBMScLTDEb,RAAAFAAAOADAHACBeAEA..XAGAaAHDQCEAGBDAZCFBhAAAMDHBLCCDDDIBEEAA.hAEAbDGDCEED.ADIB..fHABhABAgFAA.dGDAIHHAKGFABHBA.hAHA......hCAA...,2,-11,5,16
QVdcaJHWOZRMfADTPGXBFgYNbKeLUIESC,TAAAGAAAFADA....NACB.eAFHLAHBEAHBQCGDhAAAdBDAaBFAHCEBZCDFRDBFACCAXEGAhAAABEGA.bGCAKFHBhACA.SGGDCGGA......hAIA......hBAA...,1,-6,-10,4
NOcEeUgfBIbFSHJdWGMDRaLZCKYAXTQPV,TAAAQAAA..VADAOACC.EAFEeAGHUCDABCADFBHDHDFBhAAAdCCAGDGAREAAZGCAKFDAhAEAAAIBXEDA.hAHAcGAAfGHASGEAMIAA.DGIB.hAIA......hCAA...,2,-8,2,10
IdYECMAGeDKHBNVUFSbTQfZLPROXaWcJg,eAAAHAAABADBUAEAFAGETAFA..ZBAERCAAOAHD.aCEBJCGBhAAA.dDDA.EEBAADFAGDGAhAAAKEHB.SEFDhACAQFEDLFAA.XGEChAFA.WHAAIHHAhABA.MICADGIB,2,-21,8,29
NXCQSRKbIdHVeAYfDLgPUFWBaZTJOEcGM,DAAALAAAUADABAFAZADBOAFC.ECAAGAGA.MBBBCCFARCGFKDCDhABAdDDAHFDC.AAIB.hBAAfEEAFEHD.hBCAaEHD...TGFANCCA.SFCHhACAIHHA.eHAG..hAHA...,2,-25,-17,8
IFEHGdOaVKcUWYAXfQTRDJPSCMgbZBLeN,QAAARAAADADA.SACAMAGBZBDBLAHBeAEHFAGAHBFBhAAAdDCC.aCDHKEFA.UGGAhAAAACHATDAA.CDHAbEFChADABEHB.EFDF.OHBCcGGA....hCAA......hDAA...,1,-5,-24,19
gfBGWUXMQRECLJZPTKedVcOaFSDHIYNAb,...bAAABAAA.GACAXAEARAEAEBHFLAHBZCAF.TCAAhAAAeCGDdEEAOCEBaEAHDDIBhAAAHDFA.IFAAhABAAAHA.fFCAMFDBQGFACFFDKFHBFHCEhACA.SHFAhAEA...,2,-12,1,13
FgJPTLIUOXYEcSCAWaGbNMZfBHeRKdVDQ,GAAAMAAAZABEHADARAEF.dAGADAGAQCDB.FCHDPBGDhBAATEFALCCBODAHEFEBhAAACEEAABIB.aGDH.fGHAhACAeDHHKGEA.........hCAA......hDAA...,1,12,-30,42
egfXOUbIVdBWGHKacQYASTFZJCPMDRLEN,TAAAZAAACADB..MAFARACFLAEB.EAGAeBEA..XBGAhAAAbCAB.dDGAGCGAhABAHECAaCACQDDAhACAAEEAFFHDDGAAfFBAIGEA.BGDA.KGFAhBFASGGDNIBB.hBIA...,1,6,-16,22
DbgGOdSFIEJLeAXPNUBHWZRVYcTfCMaKQ,XAAAUAAAHADARADA...VBGB..TBGAMAFAKCDDQCDBhAAADCFBGDAAdDAAFDFDhABAEEEBLFHBAAGABDHAZFGBhADA..fGEE.aGGB...hAEA......hAIA...,2,-17,0,17
JQOeZBWCYRDKEagcfTVLAMGPdUXHbFISN,GAAAdAAAHADAFADASAFEQAGAeAHHZCDABDHA.CECA.RCAAECEAhACA.aDEE.fDHAhADATEEAAAABMFHBhACAXFFC..bGAAIHHA...hAGA......hBCA...,2,-24,-2,22
WGgUVNPDJFbKAIeZCfHTMaORSXEYLBdcQ,eAAAZAAAHAEAMAEARCAAEBHFLBDA.dBHAQCEBGDDAVFBBhAAADACAFDHD.AAGACEEDaCCH.hABAXFGABFGD.gGFGhABANIAB........hAIA......hBEA...,1,-5,-19,14
WAETRDHKfdPJeOSbBFNcQZLYCIXGMagUV,RAAAHAAAdADA.eACEOAFABAFB.FAHBQBFCZCCALCFBCCCDGDGAhAAAaCHD.UEDAAECAEFGADBIBhABAKGHB...fHDBhAAASFCD.cGEDXECA..hCAA......hCDA...,2,-14,-13,1
bcRVUZaeSMQWNCXPgJKLTdGIfEYFDHABO,OAAARAAAZADB..eAFAMAEA..QCFACAHA..XBBAhBAAgDAALBEBhBBAGEEAEBGBDBIBHDFBhCAAAAAAbFCBcECAUGAAaEHDSCHH.PFHDhCEA....hDAA...,2,-23,4,27
eOAcQfdJFUgESVTbIYKPRDCHGZNXMaLWB,QAAAdAAAFADAUAGAEACA....SBDDbAEA.KCBBRCDAHDFChAAA.ZECAMCFBhACAaFABBFHAADGA.fGCAhAFAVECB.TGFAIEHADAIB.GGEBhBAA.NIBB....hAGA...,1,-4,-24,20
APbgSTHLYKcONVIMUFadeCQZDWJBEGfXR,...bAAATAAA.HACBLAEAKAEAOAGDICAAMAIBaAHDhAAAeCABZCCADCEABCEAEDGAhABAGDEBRFAA.AEABSFFAhAAAcEEC.UGAAdFHAQGDDhACAfGHA.....hACA...,2,-7,8,15
QGdHeXgOEYRIMVJTDZFaKBCSAWcLNUfbP,LAAAUAAA...bADDGADA.HAFAeAFAOCFERCABMBIBhABATDAAZCFBKEHDSDDDhADAAAFA.cEGAhAFAfFCA.dEECEFEAIHDADGGBaHAACHHAhAHA......hAIA...,1,-8,-14,6
DCEQLafVbdgOASTBJHZYWPXNRGFUIeKcM,TAAAHAAAZADB...PAFCRACFGAEAFCAH.eAGBKCFA.MAIBEDCBLCHBhAAAaCAC.VEEBhACAdEAAADEB.BDGDJFCF.hADAXEGA.IGGACGHA.fHABhAAAOHEE.WFFDhACA...,2,-21,3,24
EfTDKGBbSVHNJeFdWZXCaMcULYIOAPQgR,QAAAEAAADADA.GACBSAEAHAGBeCDBdAHAZBCAaCFHMCGBhAAALDAB.ODHDhAAAADBARDBATFEAbFFDNIABFGDAhADACDHA....YHBA...IGHAhBDA...hAFA...,1,11,-18,29
PdGeIKCBNFfVJEQcTDAWUbHXRgSMYOZLa,UAAAHAAARADFMADAZAFBLBHB.dCADeAFACDDD.FBDB.VCEAhBAAEEFBQFAAhAAA.TFCAABIBbEEASFHHhBCAaFGD.IHCABGEANIAB...hACA......hADA...,2,-25,-1,24
DTGfQMbILUHXEABdKYeFZcSCVPJRNaWOg,dAAAeAAAZABBCADA...VADARAEF..aAGAOAGDDBHB..GCCAhAAAMAIBLDDAHCFBACCBKEHBhABAFEGDSFFDhCAA..PFDBNICBgGGBTGAAfGHAhAGA...hCBA...,2,-17,-13,4
OGgEeBQdfaJSTAbcIVYPMFRUKHXLNDCZW,..IAAAPAAARADAHACA.LAFBCAGBZBFEGCCAEAHBBCAAdDHA.hAEAaCCC..TFEAhAIAACEAbCGD....cEAAhACAYHEGFEEBXGEADEFA....hAEA......hAIA...,1,-12,-14,2
YGMBIFHACDZPKfENLgbOTcdXeWaRVUQJS,ZAAAKAAAEACELADB.OAFAdAEAeAGBRBFB.QCCC.hABASAHBGCAAMBIBhACAFCFDHEFCACCBDDFBfEGAhBFAgGGA.cFGDaEEH...JHCAhCAA......hCHA...,2,-18,-6,12
ICLAWUEQDPNYZFGTKOgBbcXSJeMRafHdV,EAAAQAAADADA.....PACCZADEGAGATAGAOBCHhAAABCDAXCEDhAAAeCFBRECAHFGBdCGDCDCDAAIB.UFAAhAFA.FEGD.KGHB........hAGA......hAIA...,2,-19,-10,9
JaTcMEdBSYVKCfPLADXHbFgWGReIUOZQN,HAAAFAAAGACARADFeAFEOAEAZCAA..QBFDaAHD.MCIBhAAAEBEEdDFASDFHhACAKDHBCEDALHBAAEEAXEGDhADA..bFEAIHHA.NIAB....hBAA......hBHA...,1,8,-20,28
LaWRXJedVONFDgSYGIPTMHAZKfCEbBQUc,ZAAACAAABACAQAEALAEARAGB...eAHHdCAAOCCBDCAA.SDEAhABAGCDATFAAhAAAHECBAADAKCFBEEHBUFFAhACAaFFB..XGGC.NIAB.YFCBhAFA.MEIB...hACA...,1,-4,-16,12
PGQfWLeKFgBbaRTONAEVIXdUcMYZHJCDS,EAAAXAAAdADA.UADAMAFA.HBEBDAGAGBFAQBGALBHBhAAAeBCDFDBHBDBAREEATGBAhAAAADDAVFBA..IEEAhABAcGGA..YHEAZFGBSHCAhBDA......hBFA...,1,12,-14,26
RTfIeMCOPXHaSEVbUDQJAKgNFcGdWYBLZ,KAAAFAAAdADABACBRAFA.....TAEAeCCBMCFBOAGDHCGBECCA.hAAAUFAA.DEEBAAIB..hAFANCIA.GGDBLDEBhAEA.ZEFBCDBDaGGASGAA....hAGA......hCAA...,2,-29,-9,20
DJbTLGXMZaSKRIWFBAENCPUOeYQcdgfHV,EAAACAAAUACA..eACA.QAFAdAFAHBGBDAIBTCCAGDDAhAAAZCEFaBHDREBB..FFGAADAAOEEHhAAA.gDGGhADAfGGEJHBALHAASGGAKCBD.hAHA......hBCA...,1,5,-18,23
fHAEIbMVXUYKTDPFRWdZaSOCQJNcGLgeB,EAAAMAAAUADAKADA..DAFARAFAZCBA..aAGECCGA....QEFAhAAAJBBBGCEAeFDBHCGDhBAAACIB...IECAhBBAbGAC.XGCA.TGFAFGHD..hCAA......hCDA...,1,-15,-24,9
GBAHaPcUJFVKDXbQTNgIOZSEMdfeWRCYL,HAAAaAAA.UADAFADADAGAQAFA..TBCAIDDAZBFBEBHFhBAAdBHAeCAB.RDFBLEHBhAAAABBBJDHBKEDA.bFDBhACAOFCBMCCBCHGDBCEA.....cGFAhCAA....hDAA...,1,14,-33,47
HOKBcUfWVFJYCdDSZGaMERNXIbeQTgAPL,HAAABAAAUACAVAEAFBHD..CAEAdAGAZCAAGDFA..ECBBREAAXEDDhAAAeBHH..hACATDDAAAHALEHBhADAKEGD....fFCA.YEHBhAAAaCCA...MFFBhAIA..,1,-3,-35,32
geETcUNFIObGQDSXYdCJLPWAHKRMafZVB,HAAARAAAMADAZADB.BAFAEAGA.UCAB.FAHBOBDCGCFAQCGAhAAADCIB.XCCChABAdFCALFHBADFBaEECfFBAhBFAeEEB.TFGA.IGEAhBIA.....hAAA...,2,-18,-1,17
bPMXHeNRTDBKcJFEGUAYWOIdfQaLZSgCV,OAAAdAAAaADA.ZADB..CAGA...VAFAMAIBHCEBRBDB.BBBDKCBAFCFAhACAECHFABDB...IFGAhAIALEFASFHHhBAAbGAA.eGDETGEADIEA...cGGAhAGA....hBAA...,1,-12,-30,18
LJbaIcXZHOUBRYSPNfGdgQCEeMVFKWTAD,LAAAaAAA.XADDHACBBAEA.RAFFSAHB.hABA.fAFBhACAdDEAQDGAEBHFeCCBMBBBhAEAKCFBAFGBDGHBbEDDZFBFOHCAPFFA.NIEBCGHA.hBAA......hCAA...,1,-1,-21,20
LOXHIMKJYTWQPfSeFgRAGZdBDaNbEVUCc,dAAAaAAA.EADAUADALAGBHAFA.KBEA..TCGAQCBA.hAHASCHHeBBBRDDAADBBZFFAhAIADDABVEDAOHFCMFHBhACA.JGBA.........hBAA......hBDA...,1,-10,-13,3
FMfIPXLdOUeSNDEgJGCTQRKbHaVYAcWBZ,BAAAZAAAMACA..fACA..XAEAdAEAeAGBDAHBhABAECABGCCBQDCAhAAARDFAHFCAaAHFAAIBFFHBLEEBhACASGGDgDGA.TGGAhBEA.KGCB....hCBA...,1,-9,-15,6
ZDYXfcEaHMAeKWbSJFUgTIQGVCRNLBOdP,eAAAKAAA..SACBFADDUAFA...TAEAGDDARAGFLDDAhAAAdBHAZFBFXDGChAAAEDHFHEAAACCB.JFDBQFGAhABACCEDOFFBDCCB.fGAE.aGHBhAEA......hAGA...,2,-13,-7,6
bOUdTSJWLfgeQBIPcXGZRaNYMCAVDEHKF,EAAAHAAAFACDOACA.dAGATAEA..SBDALAGBeCDFhAAAQDDABDHAIEAAhAEAXCGAREGBaEEAhAIAMCCBABIBKFDAbGBAUGGA.fGCEhCAA......hCBA...,2,-14,-4,10
QMdZOgVJXDUbAEceGFBfRCHaYWSKNTPIL,EAAAeAAAGACABADARAEFHAEA..aAGASAGEKBGA.TCFAhAAALCCBdCHAZEAAODGBhAAAgEEBXEDDhABADCBBADHAFEHDCFHA..YHFA...hCAA......hCBA...,1,9,-27,36
DQOHfYMEeRCTGFZAWcXdPIabVSgUNKBJL,XAAAdAAAaADA...SADAUAGABBDALAGBQCBDhACAHCDBMCFBRDABGEGAhAAAADGA.PFCDVEGBKEDBhBAAOFFHEGBA.CDCC.TGEA.....hABA......hADA...,1,-5,-14,9
CPeLNfUIZXVbdKSDHBEOTFcAMRgWGaYQJ,RAAAGAAAQADCCADALAFAUAFA.ZCDA..XCCCdCHADCEAHEEAhAAAECHF.FFHDAAAAMDFBhAIAaDAH...JEGFeGAAhACAfGDAIHDA.......hBHA......hBIA...,2,-25,-6,19
JAUKBVScbfMYFQGTEDZdICOXHRNegLPWa,BAAASAAA..bACAMADA.QAGAEAGAdCAA.OBCChAAAHCCARCFFeCFFLCHBhAAAaDDBABEAKDGAfECEhACAFFGADEEBCGGDXFFC.gGAAhADA.WHEA...hABA...,1,2,-24,26
eKBVTELNPdfJZFWcaXIOAHGYbDCQRUSMg,HAAAGAAADACARADAMAHBeAEABAHA.ECCALCDA.dEADZCEBhAAAFDHDaCGDOEEBACIBCEDCUFAAhAFAKFCB..TGAAhAAA..fEHAJFGFXGEDbGDA...hCAA......hCCA...,2,-16,-3,13
CaKILONedYGWfZAMgDTUbcFBERPJVXSHQ,MAAATAAAUAEA..FACARAGB...PAFAXBBA.HDEAhAIAaBDELCGBeDHHGEBAhBAAZCCAABIBDFGBBEEDEEDBSGDAhBBAQGDAKFHBIHHA..hBCA......hBEA...,1,-5,-17,12
dVIfGecPMQXCYSWEFZaKHBARUObTgDLJN,RAAAOAAA..bADBTADA..LAGBdAFA.VDCBGBGAhAHAeBFFMBBB.QCCChAIACCCCSCHHhAAAEDFBaEEHHFFAABIBDEIBIHHAfGGAPFBBhABA......hAIA...,2,-11,-8,3
NSKWOZeFYfDaHPGCALcEVTIJgdQUbXRBM,EAAATAAA..IADAdACAQAEA.UBGARAEFMAHBKCDAZEAAhAAAeBCBFEEADAIBHEGBhAEAGCFAAAHA.LFHBhAAA.cGAA.VEDB....hAGA......hCAA...,1,-10,-12,2
HOdfgTaSbMJUBCDKEAQWLVYePZcXGNFIR,LAAAeAAAZADBGAFAFAEAHAGBdBHA..TBDAaCCB..MDBBhAAABCAAKDEBAAIBQDDBhABA.VEGBcEFDhABAXGDARFBFOEHD......hAHA......hAIA...,1,-10,-13,3
bcCDgYIHEJSfAPeLWVFRdGXOBNTUaQMZK,eAAALAAAFADDRAFAGADA.BAFAUCFBaAGDZDDF.KEHBCCAADAIB.hAAA...IFAAhABAHDEBECCB.SDGAhABAACCBVGFA.dFAAOGAETGDAMIAAgGGAhACA....hAFA...,2,-16,-13,3
DFUYgeMcfINPEHJLBCaSGXZRbAVWKTQOd,KAAATAAAdACAFAEA..UACA.eAEAMAHB..IBHAhAAAEBEBHCFBLCFBCDDA.hAAAGEDARFFAAAIB.QFAAhAFADCIB.gGGA.fDHAhAIA...hCAA...,2,-39,-1,38
HLRZFJfSNDcCOPUKTAVQaWbMYXIBEgedG,aAAAMAAA...XACAEADAeAFA.HCCARAFAZCCAFBHD..SCGAhAFADBBBOCFDKEEDACEAQFFBhADA.hAGAbGAABEHA.GGEBLEHBfFCAhAIANEEA.CHCA....hAGA...,1,-6,-19,13
KSYaGZWEQBMcULbDfTFCOAegPRJdVNHXI,eAAARAAAdADAHAFAKADA..aAFAZCCA.ECGAMAIBLEEA.DDIBTBFAhAAAOFAAACCAJCDB.hAAA.XGEASDGHhABA.GFDBBHAA.......hABA......hAFA...,2,-22,-15,7
HAFILPUebYNSKBcfCWMGRXVOTgQZadEJD,LAAAeAAA..bADASADH.BAFACAHAGCCARAGFOCABhABATCGAZCCAEDGBHEABhAAAACIB.FEFBUFCAKEHBfGGAhABAMEIB.XFDDQFFCdHAD.hAEADIAA.....hAFA...,2,-9,-1,8
QKITVPeacDHSgJCEBOfbMdRUNALYFGZWX,LAAAGAAAZADAQAEAKAGC.TAGAeBHFaCDA.HDDAhAAASCAACEADBEHAOFAEhACAbCECRDCBACAA..FDHDXFFChAEAIEAA.cFEBDGIBEGDFdGGA.NIAB.hABA......hACA...,2,-7,-3,4
PbGICcUZFTeXgHEBRYQDLVSAOKNdMWfaJ,KAAAdAAAMADA..aACAJAGBGAEA.CAGAZCCFeBDB.HCACRCGBDAIBhAAALDFA.AAIBOEBBhACAfDBAbFCAUGGAhBAATFFA.EGAABHDA....YFHBhAGA.SGEDhBDA,2,-17,-17,0
fMLCYHTZOebgFcNWRUIJVSQPXBaEADKdG,dAAAGAAAMADALADAHAFCZBDAeAGH.FCDA..NCCA.RDFAIFAAhAAASCHH.QDDAhACABDDDAAEAKFFDCEGDTGGAhAIAOHFC..........hBAA......hBCA...,2,-19,-18,1
HcFSWNLKOCQYZaeIgETdRPfMbUABJGDVX,GAAAXAAAHADAFADA.SAFELAGBCBDDZBFE.eCDB.EDFAhAAARCEBMAIBADABDDIBVFFAhACANDDA.KHEAQEGAhAAA.aEEH.gGBD...hADA......hAIA...,1,-4,-12,8
cTMBKfeALRONPSVgEGFHZUQDWdXJbaIYC,RAAAOAAA..SADBEADAHAFAZBBAQAFAdCFD.XCCChAAAaCHDCDDD..MEFBhAHAfCFEAEGB.LBHBhABAPHFC.GEEADGGA.bFAA.IGHAhAFA....hAIA...,2,-18,-17,1
FKASHIXBNOZJVdCfYUGTPgQLEDMbaeWRc,HAAABAAAZACAdADACAFAUAGAGAGA...TCEAQCCA.hAAAEDABbCAC..eDFAhAAAREEAKFAAADFA.XGGAhACAOEHDVGBA.fFFA.PHFChADADDIBMIAA..WFADhAEA..,1,-7,-13,6
SdHDcAIXFCJQaOEZMYKWbNGeBPUfRLTVg,FAAAQAAAEADA.ZACBMAGBKAEA.....bBCAeAGH.BCEAhAAAfAHARDFATECAhAGASCHHHFFCAAIB.hBCACDAAaDDB.OEEBNICB.PFGB.LFHBhADA.dHAB.hCAA...,1,1,-14,15
dCbXGJPYVUBaHfDAQgIWMOeNSRLFcEZTK,QAAA..gAAAMADAeAFARADALAGBEBDBZBFEdDGAhAAAbCCAGEBA.PEEBhBCAUEAAHEECADDBOFHDhBEAFFHDTGCACGGC.......hCAA......hDAA...,1,1,-7,8
DZdYgePUaRKVAHMNLOFJECTQWXScBGfIb,HAAAMAAALAEAFADAEAGA.QBBA.SAHHhAFAGCABbBFAdCEAeDEAaCGCREFAAEHAOECChAAATGAAXGEChAGAfFGADEDBZGAA.YFHB..hACA......hAGA...,2,-4,2,6
CRGVKMgbcSBfUTDZLFIQAdXPeEJaYNOWH,dAAAeAAAEADA..aADDOAFCHAFARCDAGCABMCCB....bCGDBCFAhACA.TDGAZFAALEFDhAAAQECAAAHAXGGBhABAPEFBYHAANICB.CCHBKGHB.hAFA......hBDA...,2,-6,1,7
IZWefLVFPNYgUaCMbXTHRODEcdJBSAKQG,GAAAZAAAeACELADAFAFA...PAHBNAIA.UCDAMCCB.hAAA.TEFAHDDAREGBEEABhACAdFDDSEHBhAEAACGAKHDA.QFDC.fGHEhAFA......hAIA...,1,-8,-21,13
AQcKMUDOWSNVFRETJLYbefXGHaBdPCIgZ,QAAAMAAADAEA.SACAFAGD.EAFATBBALBHBeBDHhAIAGCDAHCEBdDGACCFAZDABhAAAABIBKDBDOFCB.VFFAhADARFBAJFHBfHDB.....hBAA......hBBA...,1,11,-17,28
PAgbXCBGWIDQMeYJEZRNKSOcUFHdVLTaf,XAAAGAAADADA.eAEAEADAZAFB.RCDB.SAHHUDAA.HCDAhAAAdBHATEGAaDBDADHACEFABEHAhACAQFCD.hBAAMFFBYFCBKGGD.FFEH.fGGAhBCA.....hAAA...,2,-12,-4,8
FgKObZEMWGJUPRBTaLfeQcISCdDHYAVNX,XAAAKAAAZACB..EAEAGADA.UAGARAGBaCABeDAA.QDFAhAAASCEAdEHAHECAhAAAAADBFFAAODHDMFDBPFFBhABATGEAfGGBCHHA.DEEA.hAFANIAB......hBFA...,1,-3,-9,6
AHZdeRcBIYVLWSGNfgDTKObCXPEaFQJMU,HAAAeAAARADABADB.VAFALAGB.GCCA..fCAEhAAATEAAOCHDhAAAbCCACCHA.EEFB.aFDDQECAhACAMFHBAAIB.dEHA.IFAASGCDhABADCCAXFFB.hAEAFGED..,1,-3,-9,6
FSBNTUKIeYJXDAWCdVfOHRcGbMgEaLPZQ,dAAAOAAAHADARADAGAGAMAFA..EBGAaBBCZABB.QCEDhBAABCEAUEAAeCHF.XDCDhCDAAAIBCDDD..fDFAhAEAbFED.LFGBSEHHNDIA.IHHAhDAA...hAGA...,1,11,-27,38
EIPKgCABfRdNaGbOUMDeWYSJTHFZVXLQc,RAAAaAAAGADA.OAFAMADAeAFA.SBBAHBFBZDAALCHBhAAAEBEBKBHB.ACCBdFBAhABAbCFD.DEFB.JGFETDDAhBAA.XFGA.IHDACHED.hADABHHD....hBBA...,1,-5,-21,16
bfBEYcNdRPJWFOeSGCIZHAXMVLUgDQTaK,MAAALAAADAEA.aADDKAGABAFA..EBBA....NAHARCAAPBDChAIAFCED...eCFAhBAAGDFAZDDAHEGBAAIBXFAAhABA...gGCH..hACA......hAFA...,2,-27,-27,0
PDIBELfTMWgaRAeZNGQXHYKUSbCFcVJdO,eAAAGAAAHADAKADAUAFACAGBFBHD...JCDBdCCA.DCFBBAHALEEAhAAA.MEIBaCGEAAABZFAAhABA.QGEAhAFASDAD...bEFA.OFDCEHGE.fGHEhACA.WHEGhADANIAB...,1,3,-42,45
OadJTZQNXLgbSMYDFGHCAVIecKBERfPUW,eAAABAAARACAUAEA..aAFAdAHAZBFEQBCALCAB...bDEAhAAAMCCB.FDDBHFDAhABAADAB.IGBAEDGA.hAAAfFHAOEFBTGBANIDB.SEHHhACA.DGGB.CGDB.hADA...,1,-3,-20,17
WTeYXZLMgbHJRGacKdPVDOSBEFQfNUCIA,eAAAZAAAMACAHADARAEA.aAFA..dAHADAIBBCCDECCB.FCEH..QCEAhAAAUDGA.ACHBTEGAhABALGCAJEEFKGGA.hCAA............hCBA......hCDA...,1,-16,-36,20
aMCBgQEJKLUHRcdVAYOTXNPZeGfWSbDFI,TAAAXAAA.ZACBeACEGAEA..SAFBFAGAMCHBBEBAhAAAEAHBLCCAHEDARGBAdGGAhABAABDBOCGD.fECAhAAADDIBaGED.QEEC.KFHBhAIA.cGDC..hCAA...,2,-19,0,19
aJdOUbYGFAZSBDVIcCQRXgTfeKLNMEHPW,ZAAADAAA...IAEAQACARAFF.TAEAeAHHLCABhABA.ECCBHAGB.aBBHhAGAdECDbDDAGEGAAAIBBDHAhBAACFEAfHABMFDBPFFB.....hACA......hADA...,1,-11,-13,2
FBZQDVSXgdHTCYcNMLGeOAUPafKRJbWEI,aAAARAAA..JADAEADABAGBZAFB..DAIB..SAHHdCCAHCGBTEDAhADA..CCCA.NBBALGFAhBAAeCEBAAAAUDGAhCAAKFBA..IHBAQFCA.XGEBhCCA.....hBFA...,1,-11,-32,21
beTSRVIHfOEcYUDQgWaZXMGCJdFNPKLAB,eAAARAAAHADBEADAUAGADAGA...QDAA.aDDCZBCEGDFAhAAAdBGAFDDAKDHBAAAAbEFATFDAhABA..SGCAhBIAfFAEOHEC.gGGEhCAAMIBACHGA......hCBA...,2,-23,8,31
RAVBMLTFgSaPcfNWKQDUYGXbJIZdHOCeE,MAAATAAAFADD..aACA....fAFAKAFAQCCAhAAADAHBGBBAbBFA.ZDEAHDFAhAFAeEHHAAHALFDBhBDASBHHcFFCUFDAXFACIFHA.dGFAhAFA......hAIA...,2,-12,4,16
PRMgCHaIbNJSFKAOEcfTUWVZDLYQBGdeX,EAAATAAAUADA.ZAFBLACB.QAEAdBCCeAHFREDAMAHBhAAAHFBBaCEC..bFGDSCHHhAEA.AAIBfEEAhBGADDIBBGEA.GGEB...hAAA......hBFA...,2,-16,-4,12
UJNEQCXGVMPfRBgIZaSDdFcLTWAbHYeOK,HAAAeAAAKADAUADA.EAFAQAFCGBGAMCABRCCABAHB.ZCGBaCCChAAAdEEALEEBAAAA.hCAAOEGHCFHA.XGCBhACAfGDEIHHAFGGH.....hCBA......hCCA...,1,5,-25,30
YLKZgCJRSAUdXbEMVNITOBDfPeHWGFaQc,dAAAEAAA.MADA..IADABAGADAIBeAEHHBDAGAGAFCBD.aBCHhAAAQCGDLDFBZGAAhAGACDDDREFA.AAIB...bFBAhACANEEAfFHA.WHFAKGHB...hBAA......hBCA...,2,-20,-1,19
eTgVGXNDOYQafPdLHEAJCRUWbBZIFcMSK,RAAAUAAABADBZADAFAFA..MAEAKBEA...eAHF..TCCAhAAAGCBBDAIBQDFDhBAA.aECCdDFAHGFAhBCAACHBCDHA..IFHASEHH..XFEChABA....hCAA...,2,-48,-4,44
dcBDGNVJZeKbRLMUHIOWEFPQaYSACTXfg,TAAAXAAA.dADADACAGAFA..VAEAeAHBRCCALAHBhAAAHDBAODFHEDBBQDFDhBDAaDHHAAAACFAA.fFGEhCAABGGANIAB.KHCA.MEEB...WFHHhCCA.....hAFA...,1,1,-14,15
WcERBNYQOZPKILDVHUTFJMXCSbeafAGgd,dAAAEAAARACABADA.QAFAZAFBKAHBLCEDHCACFCFH..MCCBhAAASBHBeCGHADAA.GDGAhACA..gFABhADAcDCDOFABDDDBTFGACFFDaGHD.NIDB..hADA......hAFA...,2,-14,-9,5
UaEcTJeFBKRPGCIOVMXfWbdDSQAHLYZNg,HAAAZAAAUAEAEADEJAFABAGA..RCAA.GCAAOCEAMAIB..XDCAhAAA..bCGDhABAdDFDQDDAhACAACIBLFFANGDB.aHFA.........hADA......hBEA...,1,-10,-26,16
eXKWANEYPTdOcGVaQIbCBFfMRJLDSZgHU,EAAATAAAdADAGAFA..aACAQCBCCAFAFAHB.RDEBLAHBhAAAZBDAHDDAeCHFKEDDAAFBPEHBhBCAOCCBIFAAhAAAfHBBMEIBSGGDXFDA..hAFA......hCAA...,1,4,-13,17
LVMYDCdKXIbaPeZfAJTSFcURGgWEQNOHB,TAAAFAAARACFGAEA..EACEQAGAHAEBLAGBMDEBCDGAdCCAhAAA.XDGA.hAEAaEABeDHHAAIBSEDAhAEAgFFDOFGBBGAADGDBbGBA....hAGA......hBAA...,1,11,-20,31
BfcQgXWYFVISeOGHNaJDbUEMdLPKTACZR,RAAABAAAQADC..XACAFAFASAHHeAFAHCAAaCCC.hAAAbBFA..ECFBdDEALDHBhABATDGAAACAZEEEfFAAhAAAgGCBVGDAIHHA..hCAA......hCGA...,2,-11,-4,7
KHEIRBScQWDgLVNdUYMZCfTJFeAbXOPGa,OAAAaAAAHACBRADABAGBQAEA.DAHBLCCAdDEA.MAIBhAEAZDFBTEAAeCFHABBB.bEGDhAEAGDGA.EHCASBBDhAIA.gGBANIEB..hBAA......hBGA...,2,-20,-5,15
McfdQEIVeLOSaAHFbURDCgKTXYWPZNBGJ,HAAAFAAARACF.CADBKAFA..TAFA..XBGA..PBHDhAEAZCAAGCEAMCEBdDFAhAFAEDGEeECBLFCBhAHAaCCAAAHAbEGDDFAB.gGFA.WFAHhAAA......hACA...,2,-16,-16,0
SRWAFagMcbGHJONIZfTeXQLYPEdUVKCBD,aAAAMAAAGACAHACCOAFAZAEA..eBBDLCCAECFB.dBGDKCHBhAFADBBBREDAAAGAFDFD.bDGDIFHAhAIA.TGCAhBAAYEEF..PHECCHHA.BHHB.hBAA......hCAA...,1,1,-18,19
fCgQMWJPEDYNHZXLASIdcKaURTBGVeOFb,dAAAaAAA.RADAGAGA..eACHFCBDCCFDMAEA.JAHBEDDB.DDABHBDBhBAA.ZBFFAAIB.SDHHhBBAKEGDBFEAOEHDhACAbFCAQGGA..PGAA..hADA.NIDB.....hAEA...,2,-26,-7,19
LOeIHJGVDdQNUARKgZTYBCFbWPcfSMEXa,RAAAZAAABADBFADA......bAFDPAFA..SAHBhABAEBEFaBGELCCBeCABHCDBhACAGDGAdEGAQFCChBHAAAAATFDACEEB.fGFEMIDA.OHCEhCBA.IHHAhCCA...,2,-15,-10,5
DabFTEXKVOZABPdgJeLISMfYHQWcRUGNC,dAAAeAAALADAMAEAHBCAQBGARBFF.GCABDAIBaDEHbDEDEDHBhAAA.KEBAZEAA.AAHABEHAhACAPFGBJHEA..fHBBhABA........hBEA......hBFA...,1,-12,-14,2
QeTcMOKCgAVZBEYINHbDWFadLRXJGfSUP,ZAAAEAAA...IAEAHACADAEAFAGAdAHARBEA.GBFA.SCCAhAAAQCAAeDHFMCIBhABACEEAAFCABDDA.bDFDaFHDhBHALFED.fGHA..hACA......hADA...,2,-22,-14,8
DEYgGcSJbOVaIZFQMLBHXAdNCWRUfTePK,dAAACAAARACA.UADA..eAFEDAGA..EBFEGBEB.SCAAhAAAOBHDaCAEZDAE.MDFBhACAHDBCADHA...fDGEhACATEGAKEDBgFDAcGED.bGFAIHHAhADAFHBC...hBAA...,2,-25,-10,15
LCKTBNHWOcVgMSeadEPGUbYXFfQJADIZR,ZAAARAAALADBKADCBAFAHAFA.OCCH..gAGHhABAeCGFEDHFGEEAUCAA.bFAAhAAAFCDD.QDFAhACAAAHACGHA.TFCA.NCIA....cFFChCFASHGG..hABAaHEC..,2,-17,-5,12
TAePLQDGFKbNgJYOCEcUIBMdVXWZSfHRa,eAAALAAAGADAKAEA.....bAFAgAGBOCCBECGBUCAAhABABDFDdCDA.XCFChACAZEFEHFAA.aGGAADIBQEFAhAEAFHCA.YFHBCHAD.MGCAhAIA.....hAAA...,1,-4,-10,6
UfNaDHBZATdOFQbGIWgKSPJVLeYCRMXEc,dAAAQAAAGADA...IADAKAFASAHBJAFA.eCBFhACARBDAECGAUDFA.aDDHHDDChAAAZFAA.ADIBTEGAhAIA.FGGHgFGA.LHCAhADA......hAFA...,2,-12,-10,2
NYbcdIEJWfCVHLMPeGKSDFRUAaQgBXTOZ,aAAAQAAABADA.OACCZAEB....bAGDdAFA.EAHBJBBFCCDAHCFChAAALEEAeDCBGECAhADADEABREEAAEEA.TGGAhAEAcFGD...fGBEMIAA.SGEHhAIA..hBAA...,2,-27,3,30
GKMDcPgeFONfaZSXdCQLEVHWbJURAIBYT,BAAAGAAAMACADADA......gAEAeAEAOAHDaAGDZCDAhAAAdBCALCEBhAAA.HDGBbDBDREEBACGBTGEAhBHAKCHBFEHH.SEDDCHHA....hCAA......hCBA...,2,-22,-12,10
XfbISEMOGQRPDKecLFgZTAaYWUCBNdJVH,aAAAUAAABADAdADAHAFA..XAED..bCEAEAGAGDBAhAFARCCBKBBDLCHBhADAZDDAAAHACEHA.VFDASFFDhBAAMIBAOGACQGGCDGHB.....hAGA......hBAA...,2,-15,-4,11
dRINeSUQGEfBPDabZcCTXYHgLJFVAWMOK,MAAAdAAARADA..eAGHQADAGCABECHFBAFA.aAGDZEAA.CDEA.TBBAhAIAHEFA.LDDAhBAAFGAAAAIBKGHBSBHHhBBA.fEGADIEA.bFDB.cFGDhCAA.....hACA...,1,-4,-11,7
dYaUCTAEcFMSKGXeLfHOBIWbPJgZQNDVR,EAAAMAAAGACALAEAHAEABBBA..bCEAJBDFZEAADAIB.RCFA.aAGAhAAA.CCBD.AAFA.FEEAKEFDeDHHhAEA.OGCE.hBAAIHHAgEGHNICB.dFCA....hBBA......hCAA...,1,17,-37,54
XaWeIZBDRNSfLdAVEGgbUPOYQKCFJMcHT,EAAAGAAAUADAOADA.QAGAFAFEMAIBHCBAaCDA.eCFFhAAAZDBBRDEA.SDHBhAAAdEGAABCA.bFGDKGFDCEDDTGCAhACAIHCABGFADEEBNEIA......hCAA......hCBA...,2,-19,12,31
NARTVDWZcdLbUQIOMBFagYKJHCfeSGEXP,RAAATAAADADAZAEE..dACALCCAQAEA.MAHBaAHDKCGDHCDAhAAA.eCHHEDHF.XEAAhAEAAAAA.VFEAbEEDUGAAhAGABGBD...FGGA......hCAA......hCDA...,2,-21,5,26
gTZPCbEMOASRIFHXYaVQUeLWNKGJfDBdc,RAAAHAAA.aACAQADCeAEHLAGBKAFCGBGADAIBdCCA.TEEAhAAAZCCAbEFD..EDHFAAAAFEEHhAIAXGBA.UGEBhBGAJFCB.BHHA........hCAA......hCGA...,2,-15,1,16
gPRdaJQTfWLCNAebOBHMXIZUSEcYGKVDF,eAAABAAAHACAMAEAZAFEEAFEGCAA.DAIBFBCDRCCA.aBEH.TCGAhAAALCFB.ACABbDGDhAAAXEEA.SEHHhABAKFEDPHAAdGCA.fHFBCHHA.hACA......hAEA...,2,-11,-7,4
VcNLTACFMSRKfaOXQbBgJZIeYEHGDdWUP,MAAARAAAKADC...aACEQAFABAFA.ZCCAeAGHHDFBdCCAUECAhAAAVDGBLBHB.hAFAAFIBSGHDhABAXECAbFEDIHDAEGGBDAIB.......hBAA......hBBA...,2,-22,-8,14
ZGSRNUJcbgXQdOTeWBEKIDCPAafYMHLFV,aAAAMAAAHACBLAEAZAEARCEA.UBBA..JDHB..bBFAQEEBhAFAdDEAeDGBBECAEFCBDAGAhBAAAAFAFGFBSBBDhBIA.gGGA......hCAA......hCFA...,1,-6,-25,19
DAeJSaOQNBTbUGPdfXZFLEVHRcMWCgIYK,eAAAaAAA.QADABADAUAFAdAGAZBBAECCBHDAARDFA...MAIBhADACEDA..IFBAhAAADDFAAEEAOEFCbFFA.GFBBhBAAXGBALHBAWHFG.KGGA....hBFA......hBHA...,1,-6,-10,4
QcLYHRBCUWGMFfSeTbDAKVaPEdXIgNOJZ,aAAAEAAAdADA..XACD..gAFAOAEAZBEFLBCDhAAAHBGBRDDBCEHAGCGAhAFAMBBBFFGHeDDH.bFEDAAIBKGCAhBAAIGAA.QGGB.BGDAhAGA.....hCAA...,2,-17,4,21
JfgKXQAdeUDbBMIONTYSPFcZaCVELWGRH,eAAADAAAMADAOADC....TAGASAFEFBBAZBDBaAHDECFBhAIAGCCAHDGBJFEBKCFAAAAAhCAAdGCABDHA.IEFAhCBA...PFGDCGGD...WFCDhCCA.....hBAA...,1,-17,-22,5
afOFZLIcUYdeWJgAbPRNKMSBHQGDVCXET,RAAAMAAAHADBGACBCAFA.EAGEaAGD..FBBHZCFELCFAUDAAeDDBhAAAJDCBAEEA....bFAAhABAKEFABEHAQGCAhAFAXFFCTGGA.fHEBOHEE.hADA......hAFA...,2,-8,-6,2
OIgWAXZdSfMRHQKFUGacBeJNEVTLDCYPb,dAAAMAAAHADAFADDGAFAaAFABBHA..eAHBECBALCFBDBBB.hAFACDAD.bCBD..ODDBhACAIDDAADHAZEGBRDGFQFDAhAIAKFED.cGGCNIAB....hBAA......hBCA...,1,-13,-14,1
CKBGZJeDEVWIXMYgNbRQTAUfaSFcOdLHP,aAAAFAAAdADAHACBKAFAZAEA.DAFA..EBHF..ICFAMCCB..hAIA..NCGA.RDFAABBBSDDAhAFALEDBBFFDhBAAeDHF.WFHB..XFCA.YFFFhAHA....hAIA...,1,-21,-39,18
CfVKIdcGgPbTRWSDZXNQMUaABHJEYLOeF,HAAAEAAALADAeACECAFBKAHBdAHAGCBA..bCCARDDFDDGA.ZFAFhAAAQCGCaEHB.hAEAACCABECAOFFBfEEEhAAAIHHA.gEGATGCA.XGDChAHA....hCAA...,2,-22,-1,21
GZYDeVRNLQEcWIgOTadJSfUMKBFbPAHCX,HAAAGAAAZADBeADARAFALCCDEAGA..ICDATCGAdDAASBGAhAAAMEEBBFFAbCEDAADAhACAXGAA.DEIBhAAAQDGA.gGDAaFHH.hACAfGGA.hADA...,2,-8,-3,5
QYfTZSIGBFJUWcHPbdNXROCaMDKgeAELV,EAAALAAA.QAEATACAZAEBGBGAFAGDUDGAHCAAdEAARDCAaAHFhABAKCCD.ACCA..fEAEhACABECAJEEB.PEFDhAEAXGGAMEIBDAIBeFDF.SGBHhBGA.....hAAA...,2,-26,25,51
TcgReVNAZFUHXQGYKbLIPDJfOSadBMEWC,ZAAAHAAAGAEAKADCLAGBDACA.OBDEdAGBEBHBCCAD...TDGAhABARDDAeCHH.AAIBFFFBQEBAhBEA.bEDDIGBAhAAA.fGHAaCCCMFGB.WCCDhACA......hBGA...,1,-7,-24,17
EKWGLTOeZfcVSCYbQRDFNdXUMaBIHPAgJ,EAAAGAAALADAeADAZAGB..VBGBCBFAQCDCRCBAFDED.dEADhAAAMEABaCHD.HECBAADAKEFAhACATFGA.fGEAhAAASFEDbFADXFGA.BHHDhBAA......hBCA...,1,6,-12,18
KDIfgeUHRLcFBXPNbOYVAWaQTSZCGEMJd,aAAATAAAZACB..GAEAEACE..dAEADAGA..fAGAhAAAeBGHHEBARCCBLCHBhAGABBBDXEGAbEFBOFDDhAIAABIBQGBBMFFBKHGAgFFG.FHEChBAA......hBEA...,2,-9,7,16
EVWdMZYDGKgOAUcNaBeCQbTLfSXJIFHPR,UAAAaAAABADAeADA..QAFALAHBXBEAFBBHHCEAEDABhADAdDAAZDCAGDCAKEGAABHBCAHA.hAFA.TEGASFDBhADAIGEA.........hAEA......hBAA...,2,-25,-4,21
URZVKdQBScAHFbfJCXGaNMTWODgPIeEYL,HAAAFAAA.JADAGACA.aAEAMAHB.TCCADAHB..gBEBhAIAeCABECEELEEAhAAARDFAZFFAdHFBBEDAAAIBbGAACFHAhACA.....XGEA...hBAA......hBIA...,1,0,-25,25
OYLEcXTKVdaPGNHbeBZQUFWfADSCJgMIR,CAAAMAAARACA.LAEA.EBBATAGA.dCAAGCDAHCCCeCFGhAAAZBFEQDGAhAFAFEFAAAFASEHHgFFBhAGAOFFBXGDA.aDCBNIABBHHA..hACA......hADA...,2,-16,3,19
GbKTPOJHcgNYDWCILFUXeVaZEdBQRfMSA,GAAATAAA.OADAHACB....gAEBDAHBCBFALCDBhAAAXAGBeBHHZCFEEEBAdEBAhAAARFDAMEIBACABKEDAcEGAhACA..YHFAFFGH.....hBEA......hBIA...,2,-11,-6,5
eUMWgSCYcaXOTJNdHRVBZLPbFEKQIDAGf,eAAAMAAA...SADACADA.aAFDTAFA.dAHAHBGBhAAARBBBZCFAbCCBEDEBKEAAQECDhAFAAAHAGEDAfFFBhABAUFGA.YFHBOHEC....hAEA......hBIA...,2,-12,-12,0
aIEPTRQgJAWNSBCKfYZXbedUVHDOGcLFM,SAAAKAAAZACB.eACHdAFAHBGBGAEALBEDaAGA.ECAARBGFQEAAhAAAAAHABEFACEHA.hAAAXDDDUGGAOFDBhACAMDIBTGEA.gGBA.hBIAJEGF.....hCAA...,1,15,-21,36
WeDZNUaIbEJARgMQYVLXPCKcSOdBHFGfT,RAAAMAAAQADCLAEA.CBBA.SAFBBBDDHCDCGBGA.hAFATDDAeAHHZEEAaAHFEFCBhAAAADIBgGAAhAGA.XGCDKCCDdFFAfHGFDFIBIGEAhBAA......hBBA...,1,1,-15,16
AEbIDZQcTMUVXJRGCYBadFfPeWLNHOKSg,EAAADAAAZABE..TACAMAFA..UBFAXAEBGCCABAGAdCHA.hADAFBHD.eCCBLEFBhBAAHCFBSECDhAAAACCB.bEDDIHHAQFFB...hBIA......hCAA...,1,2,-31,33
dJUXPTcSBCWObMVGFEYHIaANZgfLKeQRD,ZAAALAAAeACERAFFdAEA.UAGA..TCDABCAAOCCB.hABAMDEAGCGA.EEFBhAFAHEEAAAHAfGHAhBIAQGBADCCBXGEA.SEGEhABA.CHHA....hCAA...,2,-22,-10,12
TOZJNVWSbHfXPcEGeYKaUDdAFgCQLIRBM,CAAALAAARACA.MAEAZAFB..JAHB..VBDA..SCAAhAAAHBGBXCAAEDDBeDHFhACAaDDCdEGD.AAIBQGBAhABATFAAOFCDbFFC.fFEAhADA.cGED..hAFA...,2,-31,0,31
MFJWfaAQRCYXTeVgGHEBcUZbNdIOKLDSP,RAAAXAAAeADEGAGAHADABAGBZCCA.dCDDKBDALCGBDDGB.MAIBhAAAFEEHJEHB..aDAAhABAAAAA.QEEAhADACGAA.TFAA.EFHF.bGDCNIABSGGDhAGA....hAIA...,2,-26,11,37
KHOAGgCfRDZBTbPYLSXQIUWVcdEaFeNJM,GAAACAAARACA.ZADABAFB..bAGBLAHBQCDAUCAAVEFAhAAAEBGF...FDCHeCDFhAAAMBIBHEEAAAEA.DEGATFDAhACASFCD.XGGAIHHA.hACA......hADA...,1,3,-24,27
FUYMOKQPfdEgTWGVLaDRbNCZeIHSBAcJX,XAAAFAAAMADA.KADA..QAGAdAFAEAHB...TBCAhBAAGCDAaBEDRCFACDAAZDEEHFFAhAAAACGBUEBAODCH.fHEBhABAgEGA.WFFDDIAA....hBEA......hBIA...,1,-4,-19,15
QITMDNGFUgfSXCRLJaBOWbAPEKHcdZYeV,EAAAHAAAZACBeACE.QAFCMAFAGBEAFBHDUCCASBGAhAAARDFBaEHD.OCBH.ABGAKDGAhBCAdFDAIHAAhAAADEEBfECACHEABHHAbFGB.......hAHA......hAIA...,2,-8,-5,3
UXaMTJgbSZLNPBQGeVRFCWfcAOdDHIYKE,dAAAHAAAKADAEADEUAFAaAFA....MAIBJCBB.SBEAZCFE.hACALCAABAHAeDCHhADARCGBCDEAfEDEhAAA.AFFADFIBXEDDbGEA.QFFChBAA.FEHF....hBCA...,2,-32,5,37
RZYedXGKWaQNTVHMBCcgLPDfEUSIJOFAb,RAAAeAAAGADAKADA.QAFA..TAGAHDAAMAIBCCCALCEBhAAAfDFAECGBSDHHhABAODGDAAAAZFAAhADAdEDCaFAABCCD.gFDBDFGBIGAAFGGHYHBAhAFAXGED..hBHA...,1,6,-14,20
UHYTQPcXVBbNeFdMCWSKOJfGLaIgEARDZ,RAAAZAAAHADBQAEA..XAFABAGAeAHHdCGDMCCBSCAAhABAODABGDDAhACAaDDCEEFAADDBDDGBUGGATEAAhADAPFDBbFGD.CDHA.KGAA......hAAA......hABA...,2,-5,-2,3
TCWVDLaKBYfMbedgXZQUEGHNAIOcFJRPS,OAAAFAAARACF...TADACAEBDAGA..LBGBaAFABBBD.MAIBhBAAeCDH..dCDDZCEBEBGBhCAAHFGBADGB.JGDESEEBhDAA.KEGA.fGGA.hBAA......hBIA...,1,-20,-32,12
HJUTWAaCbKfXPdSIeMQDcVEZORLFYgGBN,aAAAKAAA....XACBdADAeAFA.MBBBQAEADBIB.EAGAhAAARCDALCGBFBHDGCCBhCAAHDBBTEFAAAFAbFECSEHBhCBA.IHGA...hBAA......hBDA...,2,-19,-11,8
OZXUeSaKAWBDRNFdQbYPHTLEIfVMcGJCg,DAAARAAAdADAQACA..bAEDHAEAEAGA.fBBE.hAAAMAIBGCGACCFAZDDAeCCBhABAaCHHAAGABEEA.FGAAhAGATFGALGFA.cGCDOFFH..hBAA......hCAA...,2,-14,-5,9
WcQBUKgGNDYSbFIaMdJLCVEAeTHRfOXZP,HAAARAAAOADAZADB....PAFCQAGAKCADGCEADBEBSCCBhAAAFCGAMCCBdEHALCFBhABAEGDB.ADFBeDHBhBIATGFAXFGD.WEED....hCAA......hDAA...,1,-2,-22,20
XgFQcaWAPKbCDeZJHdfUGYBLORNESVTIM,KAAADAAAeABAHACBdAEBGAEALAHB.RBEF.EAGA.SBHHhAGATCAAMDGBFCCBaDEHABHBCEEDZEGBhAAAUEBB.BEGA.hACAOEHD.IGEA....hBAA......hBEA...,1,-13,-19,6
eRPNGAdIfOJBKaXHbUMSgDWcQCVETLZYF,dAAAOAAAKADAHAFBUAEA.MAIBDAHB...QCBAEBBBZCFEFDBHRDDFGDGAhACA.AAHBJDAFhADAaDDB..SEEAhAIA..gGEACEHATGBAeHEA.hAFA......hBAA...,1,-8,-22,14
XKSPUJIAGFcOQaWMETLbgYBNdZCDRHfVe,GAAAOAAA.aADAEADALAGB..bAFABBFAZBBA.RCDBHDBBhAAAeCEHKCGASCHHhACA.PEGBIEGAhAGAAAIB.QGCAMFFB.TGGA..hAHA......hBAA...,1,-3,-21,18
YAHaUfbPWNgETdcSOBJKFZMLGVReICDQX,HAAAaAAA.UADA..bACD..PAFC..gAEAhAEAECABdCGAOCCBKAHBZCFBGDEAhAAAREGFeDEFDCIBQFAAhAFAADEBfGDANIDBSHAGFGGAMIFA..hAHA......hBAA...,1,3,-8,11
dFHYaeKXJNEUSMICQATZGRVWLOfbPcgBD,GAAARAAALADBOADA....bAFAgAGAdCCCHCFAeEEBhAAAXCDAEEGAMFAAhABAQDGAAAGA.ZEBBfGGAhAFABEEDFFGHaGDAKHCA.NICB.....hAAA......hACA...,2,-11,5,16
ZcNDdRCAMHaGVXWIUESbFBTYfgPQLOJeK,HAAAGAAAXADBUADAEAFAFAFD.BAHA..TBGA..hAAAfCAEQDDAhACALCCBeDBHZEGBDCHBhAAAdGDAACIBaDGHWDFHbEDD.gFFG.hAIAOHAC...hBAA...,1,-4,-7,3
cAXYbEOVCgNULfMeWJIaFKTGHPdZDBQRS,XAAAEAAA..CACAUAEAMADA..eAFAJAHB.FBDBGCCAHCEAZEEAhAAAQEFARGCAABIBOHEEhABA..VGDA.hCAANDIA....fEBEaDGE.KGBD.hCBA......hCGA...,1,-8,-17,9
TAVJfEPGRgYbMeWDHLXCZKUcFOdNaQISB,VAAAEAAARACA.......bADBeAFEHAFALCCAZCFAKDCAFEFAhAAAdCGAaDAB.QECAhAAABFFDAAHAJFHBGGDBhADAMHCADICACEFDcGBC.NEIA......hCAA......hCDA...,2,-16,6,22
DPOcFTJNLKdUVfYIZCaeXSbAQRBgWEHMG,RAAABAAAEADE.HACAGAFAOAEAFAHF...TBGALCCB.dDHAhAAAfCAAZEDBeFABbFFChABAAAIBQCCBhAAA.MCFB.DDGB.cEGD.KGHBYHEGhAFAaEEHSHEAhACA..,2,-7,-4,3
PVMbDUCQIcZBOeEWTRFgaAfHGSYJKXNLd,HAAAGAAASACEKADALAFBdAFAMAHBDAHBUCDAQCCAhAAA.ZDFAeBHHEFBARFFAaDAHhAAAAAIB.JEFBXGDChBFA..PEHDCHHA.BHHD....hACA......hADA...,1,7,-23,30
BcfLZFAPJVNUOSdGgYMETWeDCXRHIKabQ,VAAAOAAA.GADAMADA.EAFA..eAFAXBGAHBDAaBHDQDBAhAFABDDDLDFBhAAAABBBPDGBNEHA..dFECTFDAhAIACHCA.KFHB.fHBB..hBAA......hBDA...,1,-9,-12,3
VcaDISfeRKGQBJAgFULWPbdYNZTEMOXHC,FAAALAAA..bACDdAEA.ZAFB.EAHFMAEAHCAACAHA..aBEASCHHhABA.RDCAGEFAhACAQCECACCAWFHBhBEAPCHB.TFFA.OFHD.hCAAcGECfHDBhDHA...,2,-23,-9,14
FaPeDBQIXUWCdJGHYKTNcbfZMSEORAVgL,LAAAaAAA.eADHQADAUAFAdBHAHAFAKCAA.TCCA.hABAbCFAZDEA.EFBAAAHAFDABhADABFDAXEEACFFA.hACAYEHFfFHAMHCA.....hAIA......hBFA...,2,-26,5,31
AcHISCLOZVRFKPEdGNTDQfYaegWJbUBXM,HAAACAAAZACA.RADFKAFCdAGAGCCADAIB..QCAB.aBFEeBHHhAAA.gDADhADA.JEFBbDDAXFAChAEAADHASEGH.LFDBFEHDEGDF.fGHAhAAA.YFFFhACA,1,-12,-22,10
ATgYfcJeXNFEbPHaLGBIVUMRDSOCZWQdK,TAAA..fAAAeACEFAFAEBDBHADA.GAGABBHAUDDBhAAARCAAOCEDZCFFdEHAAAFAgEGAhAAAJHDA.bGDChACAaGGC....IHHAMCCBDIAACEDD..hAIA......hCAA...,2,-11,-1,10
JUSTHOfbNWXVaLZRFICGYeEcQKAMdPDBg,dAAABAAAUADAHACA.OAEA..bABDXBFALAGBRCAACCEDeCHHhAIA..EDFFQDEChBAAAAIBMCIB.DFBASEEDhAAATGBAfFGEVGFA.aGHD.hACA......hCAA...,1,-11,-18,7
IXGgTVHMUFLSZaPQEKBNDYRcfCOJeWAdb,dAAAXAAAGADA...TAFAHADAMAFALAHBaBFEECDBBCBAhACADBIBRDEFCDAD..eDABhAAAADDB.bDEDIEHAhADA.UFAAZDGF.QGDCNIEB.fGGAhAFA...hABA...,1,-3,-10,7
CXLegZQMNUaVdWJHEFbYcAKfSOPDITGRB,SAAADAAAGABBRAFFCADA.LAHBZAEB..MAHBaCCC.dCCAHDEAhAEAEDAA.FECB..bBFDAEIBOFABhAFA.TFGAhBAAeDHHQGFC.NEEA.WHCA.hAAA......hABA...,2,-21,-4,17
NJBIGKOeXYRFVLUMQgWCETSacAHPfdZDb,HAAAdAAAZABBDACA.JAEBGADA.eAFARAGBLCCBMBIB.QDGBhAAACCFAEDGF.aEEBAAFA.hBAA...bFEABFFAhAGAODDHFFHD..gGCBSGHH.fHCBhBDA..hCHA...,1,-15,-19,4
BNLdJfDTFAGXEbQePKZRcUIVaYMWCSgHO,EAAAeAAAZACBRADA..UAGAaAED...MCCBSAGAHDDABDGBdCBCDCGAhAAAAAAAGEAA.QFDBhAEAKDEAIDHAhAGAVGFACEDDOFFA.LGDA.fHABhAHA..hBCA...,2,-26,-1,25
eHaCEcYFNLVOdDUQKJWBGAgSbTMPRZXfI,SAAAMAAARACA.ZACB..XAFBeAEAHBFCEAHF.FCEHLCCAhBAAdDGDQFAAhAAAKCHBBDFAAAIBbFFATECAfHFBhABAaEGDCFFC..YFHB.NBBA.DFFAhAFA......hCAA...,1,-3,-9,6
GeQAKIdFJYNXLEgcROHCaWbTDVZMPSUfB,dAAAFAAA.JADA..XACDLAGB..EAEARCAAHCEB.aCHDbAGDhAEA.DAIBZECF.MFGBhACASCDABFHA.eEEAhBAAAAIB.KEHBIHHAgGBA.CGGA..hBAA......hBCA...,2,-21,-21,0
LYHAFIMSTBCWNfZGdecURaEQXbKPJDVOg,MAAATAAABADA..CACB....fAEAdAFAeAHBRBBBEAGAQDEAhAIAKBHB.DCHBhBAAOCCBLFBAHDEAhAAAAEDBSEHHZEAFGFCBaFHBXGEA.hAEA......hAGA...,2,-18,-11,7
DQFefPNISTacEZOJAGbCYdXMLVBgKHWRU,GAAACAAAdACALAEABADAHAEB.RAGBQDCAeAHH..fCBEhAAAIEGAaDAHhAAAECFBZDDFAAIB..bEEDMDIBhAFAKGAA.DEHBFGGASECH.TGAAhAGA.OFFD.hACA...,1,-9,-10,1
ALeBVcMGOUQXbICHNKTREWadZPYFgSDJf,eAAABAAAMACAGADAUAGAQAFA.XCGACBCAHBDBTDFAhAAAECCBdEFAZFAA.FDBHhAAADCBBAAIBLFDBhABAODHDbFBAKFHB.aHFAgFFG.SHDAhBCA...hAFA...,1,10,-17,27
QJGBdPXZcCOHFbRgWaAVTeMEYNUILSfDK,eAAAEAAAUADALAEA.DAIBQAFAGBCAdCEAZCBAOCGBhAAAHDEBRDGBaDHDAAIBMHBA.hABA.IFAAKGGD.hAAABFFD.XGAA.FGHB...hBCA......hBDA...,1,-4,-18,14
fPbHEFODLNBRJYcaKGMIZdTVCAUSQXgeW,QAAAeAAA..fADAHACAEAFEDAIBLAFARCDA.JCCFhAAAaCGDGCFAZEAAdFEATFDAhABAADIBXGFD.hAGAPHAAOCHFBHHBKFHDMFCB.CHAA..hAAA......hAEA...,2,-5,-2,3
HScPDTfQbAdCGJXWVOLBaZEYgMIKRNFeU,GAAAXAAAOADALADAZAGB..EBFFMAHBRCDB.eCDAHDBBSCHHhAAADBIBQEGAhAAAAAEAdECACEEAVGEABEGD.hACAaFGE...gGDA.IHHAhABA....hAIA...,1,4,-23,27
fUKQbNITRMHFZYcODeCSWGLVdAXBgJPEa,BAAAJAAA.EACAUADAKAEA...QAFA..bAGBTDDAhAIAHCAAZCEB.OCHDhAAAeBHHSDFBhBAAGECAdFGAACCAXFFAaGED.fHBBhBHA.NCCAMEIB..hCAA...,1,-7,-26,19
CcXPBLAVGbaSEUHfKRdgeJMYDZQONTIWF,GAAAaAAA.EADAHACBRAFA.eAEAMCDBZBFEQCECTDFAFEAAXCGDhAAALDHBACIBSDADhACAKEDAdHBBJHFAOFABhAEAIFFA.CFHABGAA.....hAFA......hAIA...,2,-4,1,5
FOKUZAEGaXTLCVcMIJHgDRbfBWdeNYPQS,EAAAaAAALADA..CACAMAEAHAGBRCCABAHAeDFF..PBDChAAAQEAA.ODHDhAEAZCCAACHAGDFAhBGATGFAcFCAIDHADBBBfFHANIAB.hAFASEED.hAIA...,2,-26,1,27
AMXObTWgRDPIYeGFEQfZdKaBcNUJHLVSC,MAAAOAAA..TADARADADAGA.....IAGAeBBBEBGAZBBFhAFAaCFCBBHA.UDDAhAIAHDCBLDGBCDHAAEAAbEEB.hAEAgFCG.YFHBQGGAhBAAKGFD.NICB.....hCAA...,1,-10,-16,6
FBREWJAXKeMZQTPOcaIbUgdLDNVYfSCHG,eAAAZAAAQAEAOADC..aAFAUBGAdCCALCFADACA.VEDAhAAASCCA.hABAHDEAGGEBRFGBEGFBAAIBKGCBhCAAMHAA..........hABA......hAHA...,1,-9,-21,12
XSQLNFREdbABKUYafZIOcDVTJGWgHPeCM,KAAAaAAAZACBOACA..DAFA..TAFAGBEAHBCAeAHFMAIBhAAAQEBALDEAREFFEFHFhBAAADFABEHA.fFFAhAHAIHEAcGBCWHCGCGHA....SHGGhCAA..hCBA...,2,-24,-10,14
GcTgQbNLVeEdZYHBIWPOSafDCMRKJXAFU,GAAATAAA.QADALACB.EAFAZAEAHBGBBAHB..IDCAhAAAOCEBaCFDCDFDREDBXFFBhACAAAFAFCHDUFFAgGCDhADAVFCB.eFHF......hAIA......hBAA...,1,6,-15,21
BaMNfEVgICJXTFARLYdcUWZQSHGKbDeOP,RAAAdAAAUADAZABBHADAGAGADAFA..eCCBBAHAMDGBECEA...VFBBhAAACCGA..TDCAhBAAAAGBLEEB..cDGDhCDASGHBKFEAbGEAaHFE....NICB.hCIA......hDAA...,1,-7,-19,12
bOMLSNgHQZERfKPdAJIBGFVXYWCaUeDcT,BAAAGAAAFACA..XADACAFA.eAGBTBGAMAIB.LCDAhAAASBCDHEACECEBhAAAREEAKFHB.AADAIHAAhACAVEFAaEEH.DGGBbFAA...OHAC.hAHANIEB......hBAA...,2,-22,-3,19
cEAaFVLdOIHeJXRGgMBYWNUCKSDTbfZPQ,aAAALAAA.dAEAHACBeAGBRAEAGCEBBAHB...NBBAKEEATCAAhABAZEGB.QCCChACAAAEAOHAA.XCFDhBEAMFIB.UFDADAIB.bFGB.......hAHA......hBAA...,2,-13,-5,8
gFWLANSYMKDbCXfZcREaQBUOdJTIPGVeH,SAAAMAAADAEA.CADA.ZAEE.RBBB.EAFABBHAdBHA....TCCAhAAAGCFAHCEBFEDBABDBKDAAhABA.bEGDXFGDhAIA.aDHFQFAA.OGCA.hBAA......hBBA...,1,-2,-33,31
cTaZAQFfLgDUPVCGbYJXeRIKdMBSOENWH,QAAALAAADAEAUADACAGA.GAGA.JDBARBCAdCAA.MAIBhABAODFB.EEHFHCEChACAaFBAZGAAAEEAFEGD..fGFAhAAAgFBA...PHCC.hAGA..YFHBhBFAIHHASFFD.,1,-5,-11,6
RTeJfHGCDPbUcLNSdEaWFYMAIBXQZVOKg,XAAAZAAAKADCRAFA...eADAHCAAGAGADCEBUCFBLCDB.hABAdDAAEEFFaCFHFEHDAAAAQFFAhADA.OEHDhAEATGAACGBAcGDASGGDMIAABHHBhACA......hAGA...,1,9,-25,34
NOFDbQagdBCYWeXVURHIEZKAMLJGfSTcP,MAAAGAAA.SADATADA...PAGBFAFAQBBChAIA.dCFACAHBeCDBhAAAXDDBRDFAHEACEBHFADIBLFFAhACAfEGAOHFAaFFHBHGA..hBAA......hCAA...,2,-20,0,20
NDUJPCMXKbRWOELQcIgSeBaVZfTdAYFHG,HAAAGAAADACAUADACAEA.MAGBKAGA..RCCA.EAHBLCFB.QFGAhAAAgDBHeEEDhAGAaCGDZEDBdCHAACCAFFFA.hAIANDIA............hCAA......hDAA...,2,-19,-13,6
MZfeOUQFKHXSCJBVcdAYIbTgDENWRLPGa,..IAAAbAAA.DACAEAEA.RAGB.GADBZCAAeCEBQCBAhAGAHEAACDGDBEHAdAHAACGBTDGAhBCANEEA.LDDBhCAAaFGCMIAAODFH.KFHB.SGGDhCBA......hCEA...,2,-10,-2,8
RafQAPHSDBXWNLZbGKgIEeVCJFOTdMYUc,HAAABAAA.XADBLACAGAFAKAGAECCAeAHB.CCAD.OCEChAAAdCCAMDFBUEAARDGFaEDDAADADCIBhAGAZFBB...gGGAhAAAIEEAFEGB.TGCA.fFHAhAIA...hACA...,1,6,-26,32
ATdHSaULcbgIVKeDGPYBQCERMOFNWXZJf,HAAAaAAALADA..bADB..gAGHKAFAeAHHGCCAhAAABBBDECDARCFBMCAB.hAEAFEHDXCGAZFEFACCBdHABhACASDCDIHHA.DEEA.QEGDhAFA.OFDD.hAHAWFFD.,1,15,-29,44
bDGBTeYRIQZXJdVcUFLAEHSPWafONgCMK,HAAASAAAaACAOAEDCADA..MAFADAGAGBGAeBDA.RCCBZEFFhAAAdBHAUDAAABGB.EDDA.hBIA.WFFDfDFAhAAA.KEGA.bGCA.TGGA...hCAA......hCCA...,2,-19,-8,11
XagEdHMfBJSANFLTCZRYODVUQecIKGbWP,LAAAZAAARAEADACA.QAEA.eAHBKBHBGCCB..hABAbCAAXDFAECEBHCGBhABAMEIBBEAAAAHAFFAATFFAhACA.OEEBUGFA.IGBAaGCD..hAEA......hAIA...,1,-5,-22,17
VIdBKAfcLYeGaZHQJEWObNURDPgFMCTSX,LAAAeAAAZADBHAFAEAEA.OCCHUBGARCAADCHBFCEB..MCIBSEAAhABA..XDFDhAAAdEFAAAHA.fFCAhABAGGCBaHFEQGGA.bFDD.hACANDBACHAD.....hAEA...,2,-18,1,19
NTKFWBMOJCVEQgdUeHGYIbZDAfaPRXSLc,aAAARAAALADB..TADAFAFAMAIBCAFB..EAHBdCCCHCCAGCFAhAAAICGAZFBAACFB.XDAChADASFFDKBBDODHDhAIA.QEEAeHCGDGIB.fFCAhBAA.cGFDhCAABHGA..,1,-1,-17,16
eXUaQObcBVYRNdZSFDWAKJMCHTPELfgIG,MAAAHAAAEADELAEA..fAFBGBBAeAHHaAHDbCAABDEAhAFA.RDFFZFCBDCEAADFACEHATGAAhAGAIDHA.QEDAhAAA.OFFA.cGED.hBAAYHAAdGHA..hACA...,1,-3,-12,9
SYgQBcXLIfKWAREUVCJGbHdNTePFMDaOZ,EAAACAAAGACAHACAdAFA.eAHBMAEA.aAGEZCCA.SCGHhAAA.QEAAhAEAXBEDLCABKECARFFA.hAIAVDGBNIEBFGDBOEBD.BEEA.fGGEhAAAAFFA.JHCE.hCAA...,1,7,-12,19
cbLQEfRSGODeNCTaAVdgXJKHWMPZUBFIY,dAAAXAAAHADAMAFAZACBBAEAFBGD.....IAGAbABDECEF.hADARCEAGECADBIB.eCHHhAAATEFAAAIB.JFEFKEFBhABA.PFHD........hCAA......hCBA...,1,-16,-17,1
RKgWLYVOMSfIHEAaBFCNJdQDeZUcbXGTP,aAAACAAAdACA..eACHZADBUAGA..bADDGCEARAFA..KCGALDGBhAAAOEEAMBBBhAFASCBDHFCAAEIBFFBAQGAChAGADDIB.TGGAgGBG.hAIA..WGFA..hBCA...,1,6,-31,37
NOecFVZLQIMXHWCbadRBUGJPfgSTEKDAY,OAAAeAAAFADDZADBLAFA..MAGBHCDCCAHAdBBDRCGFGGABhAAA.JEEFfCHAhAHA.TDEAEGGAAAGAYCCFhABAVFBA..QFGA.hCAAWHCA....hBAA...,2,-28,1,29
eUARgaHEPYWMLcSXZVFJKGTICDBdbfQON,RAAAHAAAEADE...PADAMAFALBGB..XAGAhAAAZCCAFECAGGCBTCCADCABhACAbFFA.QCEChAHA.eCGHAAAAaHFEcEGD.SFFDhCCA.KGCABCFB.hCGA...,1,-7,-11,4
NEeATLXJaDbSBdPOKIVYWQMcCGHFZURfg,TAAALAAA.aADDSACBBAFA.dAEAKAHB..VAGBQCAAhABAMCCBGDDAhAAAHCDCZCGFRFGB.fEEEhACAEGAAADDBDDGBODHFIFAA.cGEC.hAGAFGGANIAB.eHAA..hAFA...,1,8,-11,19
ICOdgQXGMJYNTLbZRVBfKEDPAeHWaFSUc,HAAAaAAA.SACEUADA.CAFA.dAGAQBGAGDBAMAIBNCCA.hAAALDDARDDA.fDHEhBAAEEGAAAHAeFABFFDDhBBAOFCDXFFATGGA.....hBDA......hBFA...,1,1,-18,19
aLDUIQNXeHFAbJgfEWGMRPKYBOZTdVSCc,JAAAEAAAGACA.RAEA.KADCBAHBZAFBdBHACCBD.LCCBDCGA.UEEAhAIAQDFA.hBAAeEABHGFCADIBbEDDfBEAhCAA..MFIBOHCCSFFGhAAAaEHF.....hCBA...,2,-25,-11,14
YJFfQcEVCBLNRAOdSDZXPUGeHgMKTIaWb,dAAAZAAAUAEAHADAMAFAKAGA...aBFE....bCABFCBDQCGAhABAECHFBDDARDFBADABDDDAhACAXFDA.eDADhACATEEA..IGHAYEBB.fFHAhADA.CGEDOHFChAIA.,1,-9,-31,22
JXARcOVKNMgTPCWGZFdbLDBIeEHfSUaYQ,RAAAOAAAKADC..MAGBTADA..CAHAZCCAdAFALAHB.hAAABBBDECHBHECASCDDhBAAaBDEQEGChABAABHBcDFA...gGFGGFEBDIEAeHAAhAHA......hCAA...,1,-15,-18,3
gQTRdcCBPfSADaKEGVMWYHLFZOXeUbIJN,aAAAEAAAGACA.MAEAHACB.ZAEAeAHFbCED...JBFBQCGBhAFAREBBdEEDBCBDSAGEhBAAABEAKDHB.VFGBhBBALHFAXGEDIGGANEDA....hAAA......hBCA...,1,4,-14,18
cQHSIDOPEZebGFJBKNMACXdaUYgTWfLRV,dAAAaAAA.UADA..TADALAGB.RCAA.QAFCHDEADAIBEEDBhACAeAHH.GCCAhADABBFBMDIBABBBXEFAhAHA.gFEGfFGA.SGFDhBAAIHHA.....hBAA...,1,-14,-18,4
FGHQgIUJRVTOCDBbLSZPWaefNAMYXdKEc,MAAAdAAAEADAGACBHAFAQCBAUAGA.RCFA.TCCADDABLDDBhACAZCFAaEEA.eEHBABBBKEHDhAFAFFFB.IHAAhADAOFFBBGHASFCD.fHGBhAHA.NICB.....hAIA...,2,-17,6,23
eTdfGbgERJUDFQZSBLXKHNMWcAVaOCIPY,aAAACAAA....IACAeACHdAEA.GAGAEAEA.RDDADBBBZAGBLCCAhAAAHEBBMDIBABGBOCHDhAEATFFA..fGAEhAGAbECAUGEB.QGDDBHHA...hBIA......hCAA...,1,6,-27,33
CWIKGecaFfVLdOTgADSZQMHNXUYPEBbJR,ZAAAHAAAUAEAEADEBAFBRAGB.CAHA.KCAAGCAB.eCFAaDDAFDGHLEEAhAAA.dFCATEBAhABAADIBQGEA.hACA.MDIBYHAAPEEB.....hACA......hAHA...,2,-30,-4,26
TAHQdJGXZSURPCgINOVKfLBMDeYWcEFba,HAAAdAAAGADAZADBRAFACCAD..IAFA.OAGDfCFEhAAAMAIB.eCCD..cCADhACAECHBaEEB.AEHBQFFChACASDDDgDGGKGAADFIB.FFEDhADA.TGGA..hBAA...,1,-2,-23,21
RWLMFdBIeDJQPgHGYCfXcbUVNZaTKEOAS,RAAAMAAAdADABAFADAEA..QAGAHAGBGCEACBBA...XCCChAAAbBDB.UFAAZCEBaDCBhBAAEDHF.ADGALEGBhBBAFFHDeGDG...........hABA......hAFA...,1,-10,-23,13
DPbGWTcVeOAdJFERaIfMHXgYNUCQZBLSK,dAAAEAAARACAaADA..MAFAHAFB...XBDD..gBEAhAAAUEEAZCBBLAHBhACADBHBGDAA.TDFAhADAeEHBADBBFCCHfHBBCEEDQFGAKHGA..hBIA......hCAA...,1,-3,-18,15
GTAQEfOISJWUVcDBCKbYNRXZdgaeHLMFP,EAAAOAAA..SACAUAEADAHBKBBD..bAEDRDBA.ZAGFdDFAeCCBhAAAHEGBMDABGGBBhAIAAAIBQEEA.hBAAfEGF.IGBA.WFHHhADABFEDCHGCXGCDhBGA..,1,4,-29,33
GTbFMKQgWPVNIJYBcdALeOEXUfZSDaRCH,eAAAEAAAUADAZADBDAGA..RAFAHCBAGBFAFCGDMBIBKDEB..QFGAhAAA..gDBBhAAAVGAA.IEEAhABABGFDABCA.LFHB.fFBEhBDA.aGGB.CHBD.hBFA...,2,-22,-14,8
KRGQfAYINLWTXECJBFODgSePbaHdUMZVc,..IAAALAAA.TAEAEACABAEADAGAeBGF..aAFDHCAAhABAdAHAZCAAKCEDRDGFGDFAhACAABIB.NCEA.CEADOEFHhACASDHB.PHBAMFIB.....hAEA......hCAA...,2,-16,-15,1
ZGXdgLePKNEFAVTIRcUQDOHCabBJfSYWM,TAAARAAAQADC.HAFBaACABAFA.SAGHMAIBGDDAhAAAdCCAeBHHKCCDEDGFACFBIEEAhAAADEIBbFABfFGAhABAZFAALFGB.FGEA.....hAFA......hAHA...,2,-8,-3,5
OXPHSAYfdTVbJLgIBacFCUWRQEDNZMeGK,dAAATAAAJADA..LAGBBACBFAEA.CAHA.RCAA..DAIBZBEA.eCCBhAAAGCEAKDGD..ODHDhAHAHECBACEB..fEEAhCAAbGFA.aGGBWHEG.....hCDA......hCIA...,1,-22,-30,8
GEHDRZLOgSbWKecINATaJXMCPUYdFfQBV,aAAAMAAA.UAEAdADAQAFAGBBA.HCDCRAGBZDEALBHBhAFA.SBBDhAIAbFDAeEBD.IFFAAAIB.hBAAXGECCFHA.FHGEBHHA.DFDA..hBBA......hBDA...,1,-3,-17,14
bAdTaWcYVPfUgCQFBJIRZEHeXLONKSGMD,aAAA....cAAAVADA..UAGAQADABBBD.RAFAHCAAhACAeCDBLDABhADAKCGAGDCBMDFAAEHAdFDDTEGAhBAAPFHBCFEA.FGAAIHHAEGFFNIAB.DGGB..hBIA......hCAA...,2,-22,11,33
AfSUNdXJcgZTOFMQeRCYaPLKIWGVEbHBD,SAAAdAAAJADA.ZACBFAGA..eAEARCAA.aAHDLCEA.hAAAKDHBGCEA.ECGBhABAHEEAACEBfEHAhAFAXFCCTGGAMHBAQGFD..hBHA......hCAA...,1,-11,-26,15
FOZDEeCcKTPfgRBGHdWYAXSLQNJabUMVI,LAAAQAAAaADDMADA..FAFAZAEEEBFBeAHH.KCDDTCAAhABA..fCFAhAAARCGFHDDBdFGDADBASDGAhBCANIAB.bEECIHHACFCAgFGAhBDA......hCAA...,1,-9,-17,8
CGYZfERNFAeHaBQWOgcdUJITDbMLKSXPV,HAAAaAAABADAQADC.OAFAdAFAIAHATBFAbCACMBBBhADA..LDEAhAAAKCCASCFAXEGACDHAZECAhBAARFDAABIB...eEEE.gFBGhBFA.cGGADGHB..hCAA...,1,12,-31,43
gRSIKWbQEFCPaGcJDTBMLONYZHVfXeAUd,dAAARAAAKADCQADA.EAFACAFAGAGA.DCCAMAIBLDDAhAAAOBGDZEFEHCAC.hABAXDECAAIBSFCAhCAAbFDAaEHDTGGABGCDYHFG..hACA......hADA...,1,-8,-24,16
KWLVCcQaBfTZUSFMeRgGYIXbNEdJHOPDA,LAAACAAA.aADDTACAZAEB.FAEARAGBGCAA..XAGDhAAAECCBHCFBDCAAAAIBKEEDhABAVCDAQFGAhACABDGASDHHMIDA.eFFB.IHHAhACA.NIAB.....hAIA...,1,7,-35,42
SgATJdbIHeNDfLYCMacBPOUVRWFGXQKEZ,dAAAHAAAeADADACALAFAMAHB.BBDAOBFDRCDAGCGAKCBAEDABZFEBhAAA.AAGA...bECAfGCAhCAA.aCCHhCGAPDHDUGGB.FGFD.SCEF.hCIA......hDAA...,2,-18,-6,12
VYPSBLgGXJWfMcEUOZRdDAeTaIKNCHbQF,eAAAaAAA.KADAHACBFAFA.VAEA..SAHHLAHBGDEAhAEAJCCA.MBBBECFEZDFEhAAAREGFADEBIGDACFGA.hABA.bGFA..........hCAA......hCBA...,2,-30,-4,26
VRUNAQaKYTFMLfXdSHEBZIebPOWGDcJgC,aAAATAAALADA.dAHAHACBZBBA.eAEAOCEDGBGA.DAIBhAAAJCGFCCADRCEBAAEA.QEAAhACAFFGH.MEEBSDDDhBAAEFGBBGCAIHBAWFHH....hBHA......hCAA...,2,-32,11,43
NHZDBEcRgYedIXWUMGFQPfSLACJaVOKbT,aAAAKAAA....TADAHACBZAEABAFBRCEAeBBDdAHA...XDGAhAFAMCAAGCDBQFCAhAGASDAAAAHACFFAOFHBhBAAbEEADDIB.EGCA.....gGEAhAAA.IHHAhACA.,1,-3,-32,29
aJGDbOWKScCgeRNQdUBTIXPVfHMALZYFE,ZAAAEAAAGACAOACAKAFACAEA..RAFF.dAHABAHB..TCDA.hAAA.XCGDVDFAHFCAhABAACBBLEABaCCHDFIBSGGBhCAAeDFDNEEAIFHAMIDA....hAEA......hBCA...,1,-5,-23,18
IYNdgfZeaETRLcKXGUHVAWBMJCFDQPOSb,MAAAFAAAQADA..SACA.bAEDIAGAhADAdAGAZCCBEBBBRCCBLCGBhAIAXDGAHFBAAAIBBEEAhBAADBIBOEFHNGBB.eEHHaFHHKGFB...hBAA......hBFA...,1,-7,-15,8
HBNAYbXLRUSVEeCaGJKfgQPFIZOMWTcDd,XAAARAAAUADA..EAFAeADA.GAGAKAHB.QCDAhAAAFCCHZCFB.MDAB.TEFAhABAdDHAHEDBAAIBLFDBhADACGGA.aFHD.fGBA...hAAA......hABA...,1,8,-32,40
LDRTIAVQMFYbEeNCgSGPOKHJfUBZdXWac,MAAAFAAAEADA..eACACAFA.GAFAKAHBHCCAUCCAZCFBdBHA.aBBHLDABhADA.REGFACEAQEFBhAHA.bFBAhAIASEEDOFHDBHGDWHAADFBA...hAHA......hBAA...,1,0,-26,26
EBOeKFDLZJdSIRPXQVYCMfgNGWbTcUaAH,HAAAEAAABACAeACEDAEAZAFB.dBHARAFA.QCCA.CEFAMEHBhAAAfBDAGFABTCEAhAAAaGGHAEIB..FHCELCHBhAIA.SCCD.XEEAhCAA.YHDAhCBA...,1,4,-37,41
HdaFCKScVIGXLJMPWBTUfAZQORYDgNeEb,ZAAARAAADADAeACEHAECdAFAFBHDKAHB....SCCAVCDB.GCEAhAAALDGBMEHBBFFChABATGDAACCBOFHDhAHA..YHAAEGEBaHCC......hABA......hAHA...,1,-16,-19,3
BCTgKaMUSDFRXELeJYIGfPcHbZdNVOAQW,QAAACAAAKACA.aACEMAEA..DAFARBDALBGBeAHF..hAAAIBFAGCAAfCCEhACAHCDAdDAAOCHDhAAAAAIBBDFCTEFAUFFASEEDEDCBPFEB.hADA......hCAA...,1,-8,-21,13
XAKfFbdJcUgaMHZNQCRSLDGIYTVOBEeWP,FAAAdAAAUADAMADAHAFCZAFB..QCBDRBCALDBAGCGA.hAIA.TCFABAHAEEDAhACAeCHHXFBCAEFBKFGD.hBAAJFFBaFHD..CHHADICA......hBAA......hBCA...,1,-10,-15,5
JWEgTdaIVFXULeCbDKQMPNcSBORHfGAYZ,ZAAAEAAAdADAaACA..FAFALAFA.eBCDDAIBMBFB..cCEBhAAAOCCB.HCGBhABAAAGAJCGBTEDA.XFGAhCAAbFEAKDBDNCIARGCE........hBDA......hCAA...,1,-12,-22,10
fIaXTOYWRJeLMDHbZQdSGBUVgNcCAPFEK,EAAAKAAA..aACAOACC.RAFFLAHBHAEBZAGBdCCAGCCABDBCVEABhAAA..gDGAhAAACEFAAAEAFEHB.XEDAhAGA.TGBAYFDBeFHFDGGB...hBDA......hBGA...,1,-5,-14,9
ZLBPWRgdaNeSCQVMcfEJIDXGbATKHYOFU,HAAAFAAAZACBLADBBAEA.RAFAaCACeAFHQCFB.MCIBhAAAEAHBDCEBGEEAACHBKDFAOEHHhACAUFFA...gFAAhAFASEHH.......hAGA......hAIA...,1,4,-43,47
bECUXLIeagWfBGFZSRVcQYAKPdTNJDHMO,dAAATAAADADAHAEC.MAIBEACECAEB.LAGBeBDB..aCAEfBFAhAAAGCGAZDEBRCCBQEFAhAIAADDBKFCB.hACAPFEBOFHD.XGFDIHHABHAAhAHASDHH.YECFhBIA,2,-11,-4,7
ZGaOPBTKdQUXgbcCYJDERNFMHISAfWLeV,LAAAeAAAGADAaADDBAFAdAFBQBGB.UDBAbAGDCCAADDGBhAAARCEB.MDIBHEGBAEFB.VFAAhABAOEGD.TFDAhABAKCCD..cGCD.EGFBNIAB....hACA......hAFA...,2,-8,0,8
QBaHWRSUcJgPVEXZLAGOKfYTbeDFdNCMI,GAAAKAAA..TADAeADAdAHA.MBGBQAFCHCDBRDGFSDADhAAAUCAAJBHBVDDAhAAAEFCBLHBA.hACAACDBfFFEbFGBFGDACHAA.aFHD....hACA......hADA...,1,3,-15,18
OZTedDUEgVbRHPWKJQaBFCYNIMcfALXSG,LAAAGAAAZADAeADHdAHAECDA..bAEDHDEA.KDCDaAGACDHB..hABA.IBGAMEABAAABOFGBhACATCAADCIBUGDAhAEARDGBPEEB.QGFDFHBGYFHBhAFA......hAGA...,1,1,0,1
QFaTZLBeHcCMdJOYNUfIbSRXGPEKgWAVD,QAAAaAAAZACB.eACAHAEA.MAIBdAGAOBEDUCEB.bDAARDGFGGABhAGA.EFEBKCHBhAAAABBBFGGHTEFA.LGBAhADA.CFHAYHEG...hAHA......hBAA...,1,-1,-9,8
FZESUYabeKTJgBALcQHGWPdIORCMVNXDf,LAAAHAAAGADAdAEARAGBMAFA..XCAAFBFAECABUDFA.hABAaCCHeCFF.TEGAhACABDHAABIBQEBBhAGAIGGACFEDDEEB.SGEA...hAAA......hACA...,1,-12,-17,5
MeHQJSBVbCfFYgWRZGXDIPNUaOTELAKcd,dAAAHAAAQADABADBCAFAFAHB....gAGARCAAGCEADCIBhAAAICCAUFAA.aCGEECGBhACAAAGA..KDAA.eDEBhACASECBVEGBbFBAfFHA..hAFA.YHFA.hADA...,2,-15,-13,2
dYSXANEOQLUBITRJHaeDfbGMKVWCgcPZF,EAAALAAABACARADFHADB.eAFADAFAGBFAMBIBKCAA..CAHA.PCFDhABAdCHA..XDDChAAAAAFAQFFB.hCAAIHCAaFCCVFGBWDDD.....hCBA......hCCA...,2,-25,-9,16
HcYGOMVQDKCWIFfSbXZeLTNJRagAdBUPE,dAAABAAAEADAHACAGAFAMAEADAIBKAHB..CCBA.FBFD..SCEDhACAZCAAeCEDLDHBhAAAJDAFRDCBAAHB.UGEA..hACAPDHB.OFBD.QGFChADAfHCF....hCBA...,1,-7,-21,14
JRZEVNXgYFKLSOQUeWMPbBDTafCdGHAIc,JAAAEAAA....XACAFADALAGB.QCCAeAFAMBIBhAAABBFAaCCBdCFAHEDCAAFARDABhADAZEGB..VEDBNIAB.hAIAKFHB.OHCC.WCGHDFIBCGED..cGGChCAA...SDDChCBA,2,-32,7,39
gVGEfPTdABYFeHKSbaLNZRWcQJDXCIOUM,FAAAHAAAKADAaACAZAFBRAEF....QAGCDAIB.CCCAUDEBMBHBGCCAhADAECHF.TEFAhAFAAEIBeFFB.SFHDhAAA.NIAB.cFEC.IHHAhBAA.OFCH..hCAA...,2,-38,0,38
UOgbEfBHXKASDaPTJVNLcdFReYWQMZCGI,aAAATAAA..VADALACB.dAEARAGFeBBBQAGAZDAFGDCAhADAOCEEEEEEHEBAhAAAACIBDEGAPDHD.cEEAhAGAFFGDMFIB.CGADgGDHbGEA.hBEA......hBIA...,1,3,-3,6
XJNWGCVREKLcTbdODIYAHBaePFfUQgZMS,HAAAeAAAFADDQADCZAEB.MAFASAGAXBFA.NBIA.GCFAhAAA.RFGFECCBLDDAhAAA.bEGDdHABDCABhACAADHAaEEHfFDA.gGBDhBGA.CFFA.....hCCA...,1,0,-13,13
OYMWTXQDPJGLHCbfNUceAFgZRSVIaKEBd,ZAAARAAA.SACEaADABAGA.dAFA..MAIBTCDADBEB..GCCAhAAAHBGBCAHB..bCFBfEFAhABA.cEGDhBFAACCBFDHHIFEA.EGAAOCCHhCAAXGGA....hABA...,1,-10,-28,18
CHSMQDgJeXYbLaKOWRFAdVTGZNcEfBUIP,dAAAGAAAZABBEADABADA.UAFACAFA.HCDAMAHBQDGA.hAIADAIBeCEB.bDCDaDAHhAAAKDHBRFBAADCB..TFGAhBAAfEFE.SGHBXGDA.LHBAhACAWCFB...hBIA...,2,-27,1,28
IQWJgGfHCeRLSaXYPUbKdTMABFNDcEVZO,FAAADAAAEACAZACB..QAEA..gAEAHAGDRDEAaDHDXAGDhAFA.PBBBhAIAbECDdGFA.ACEBBHHAhAIAcDCB...ODFA.IEEAhBAA.GGEB.CEGD.hBIA...,1,-12,-26,14
fXQEYWHRNcJMaOdCZPGLFSgAKDITbBVeU,DAAATAAABACA.UAEAQACC.EAEEHAGDRAGF.JBBFaCDDdDDAhAIAZDFAGEGALFCAhAAAFEBH.ACIBKFHD.bGACeFDAhBAA..XGFDNICB.....hBEA......hCAA...,2,-24,8,32
UAgbPINKEJWRGBaYTQLcXVfOZCFdeHSDM,...bAAAIAAA.EACARAEAaAHD.QCAALAFAXBCAhACAOCDCZDEEdCFAHFAAhAAAMCHBAAEA.PDDBhAGAKEHBGGCBTFFAfFFBeFHHDCIBNHABBHADhABA......hACA...,2,-1,3,4
QWaTEFfGXcPLZOVdDRUNeBASHJYIgMKbC,HAAAJAAA...gADBMADAKAGA.QAGA.aCACEBDAhAIAGCCAXCCCLDHBhAAAZCFAdEEARCFBeEFDhACAACGASEHDbFABCHFD.TGFA....hBAA......hCAA...,1,22,-36,58
JfRHBOIYSVcWZgAPaGXUQKMdLeETNbFDC,GAAAQAAAdADAEAFA..bACACAHARCDAHAGB.OCDB.SDAAhAAAVDGBZFAAAAABaDGChADAKFEAeEEBFGHDDICABGAAhAEA.IGGA.cGBD.WHFAhAGAXDBD...hAIA...,2,-17,-6,11
ALJKeIVTDYESGfPMXagWZdbQRcFNOUHBC,LAAAeAAA.TAEAEADAGAFA.MAIBaAGAZCAAdCCARDGFFBGDOECEhAAAHEAAACCA.KCEDDFBBhABASCHHXGGA.hAHAbEFC...QGEB...hBFA......hBHA...,1,0,-14,14
VWJcTIBeNUKgLfCdAMGDHaZPSEOQYbFXR,GAAAHAAAZADBEADAQAFAFAFD.RCEF.VCDBJCAF...TCGAhAAAeBHHKDCDLFFAhACAdEGDACCAMHBAaAHFODAHhADAXGGAIHBA.BEGDNIAB....hBAA......hBCA...,2,-7,0,7
HbZUecJEMOBXGCfAPRVDgLYKWSaTFQdIN,RAAADAAALADBKACA..aAEATAFA.dAHAHAGBZCFA.eBBBEDCBBEEAhAAAGBEA.AAIBPDDBhBAAVEGB..gFAAhABASDHHQGECbGEA...hCAA......hCDA...,1,0,-23,23
NbVPSKTBQfYdaORMAIXCcHFJZeWEDULGg,CAAAHAAAZACA.EADELAFBGAFA....bCAASAHBBAHAQECBhAAAdCCARCGFAADA.XEGAhACAFEDDeEHHDFAB.gFFGhAFAPFFBKHBAfCHA.aHAEhAHA......hCAA...,2,-20,0,20
DYSRFGIfdLcEObaJePWCZXUBKQNgMHVTA,SAAARAAAGADAdAFBEADA..aAHD..eAFACCCDZDAABBHA.QCCAhAAAMBGBHDGBACFAFDABhABALFEBbDFAPFDAhADAXGGA..KFHD.gGAAhAGA.DGDB....hCAA...,2,-10,-7,3
MGZFQRbUaTNOEYLcdfIDeBgKCXVWAHJPS,HAAASAAAZADBRAFAUCAB..aACDOCFBEAEALAHB.hAAAdCEADCHBeBGFKEGDXGAAhACAAAAAMDDBGEAAhAEAFFHD.bEFA.TGGAYEEFfHEBhBGA......hCAA...,2,-17,-1,16
bLceUgJRMZGBKOPSCNIXTWYfEDHVaQdAF,LAAAeAAAUAEARADFGAFAKAGA..SBCHCAHA..XCAAhABATCGA.fCHAhACAHDEBaEBAAAAAbDEDJEHBhAIAZFAABGED.NICB.IFHA.EDDB.hBEADHAA.....hCAA...,1,-5,-20,15
TcHeXgAGJRdCIKFBYSLEQWbPUDMZVONfa,RAAAdAAAKADCBADALAGBEAFA...QCCA..bABDDAIBhAAAZBEEOBEDaBHDHDEAhADAeDHFAEIBGFABCEFAFGBASFHHhABAPFGBMIAA......hAFA......hAIA...,2,-18,-13,5
bIUSDdETcJKAMWRVBPLXQONfaFgYHeCZG,RAAABAAALADBQACAOAFA..aAEEFBFBHAGBZCGBGEEAhAAAUCAAdDDAEDCBJCFF.AAIB.MDIBhABA..VFAA.hBIAXEGDfGDEeFFDCGHD.IHHAhAAA.DDIB....hACA...,2,-7,-6,1
UHaBeQIZWYXVcFALTGCEfPNDRObMdKSJg,GAAAEAAA...fADADADARAEAMAIBdAFAKBCA..SAHBhAAAUDDAHCFBeBGHZFGB.hAAAXCDDFCBHACHBLHAAhAHATEGACFBA.ODAH.bFDB.aGGC.hBCA......hCAA...,1,5,-14,19
EDacGfBIPeYbAFHOSWMLJgNRdUVTZQXKC,HAAASAAAMACALAGB.JBDBRACFdAEAUEEAZAFB.QDGAhAAACBFADAIB.GEDAhABABDHAeFBAAAIBOFFDhBHA..gGFA.....hCAA......hCBA...,1,-20,-22,2
baRXLeCGcMSQJZNFIAWfYVUHKOgDTBPEd,...fAAAUAAAHADAOADATBGAEAGAaAGALBCB.hADAeBEBGCBBMBIBQDFDhAFAZCABFCGBAEEBVEGBhAAADDIBdFCA.RGFA.........hBAA......hBCA...,2,-6,1,7
CWXGNPgEcKBSQLYHFZTJDVfIRAUdMaObe,dAAAaAAA.eADA.CAGA.GACA...gAEBEBHFBCBALCEBhACAHBGBZEBATFFAhAGADCGBIDDAAAHAMEIBODABhADAWHFG...XEGA.cGGAhAEASBBDFHEA..hBAA...,2,-21,-17,4
YCMWHcZPNSdfTBbEDKQFJIXARUOgGLaeV,RAAAOAAAGADALAEAeAFA.CBBD.HCFAZBDA.SCCDdCHABDDAEDFBhAFAQEFB.hAGAFDABXFFAAAAAaEHDMGAAhADAPHDAfHCBDGIB.IHHAhAFA......hAGA...,1,1,-23,24
KPcYODEfXHbISTVUWQeZRBdFMNCgaALGJ,GAAAKAAA...PADAOACA.EAFAHAGB.SCDAhAAATBCAUCFAeDBHREDBdBHAhAAAMDGBCFFB.AAIBLEEBhACA.cGBBfFHAbEGD.IHFAhAIA.....hBAA...,1,-3,-23,20
BYVCAbRKJdFEQUeOaLfTHDIgcNPSXZWGM,RAAAdAAAEADEeADA.LAHBHAFBDAIB..IBGA..gCCAhAAA.PDFBhABAZABBGCEAMDHBBFAAhAFACDCAAEAAbEGDFGGHQGDCaHAA...hAHA......hBHA...,2,-17,-12,5
EYCGDBPVdNFLgZaTXQUcbKJSRMIOfWeAH,HAAAEAAAGACABADBdAFALAEAaAHB.TCEAQCAB.UDDAhAAAbCGBKCBDRDGB.MDIBhAAAfFBAAAFADEEBPFFBhAIAFGDAXGFD..SHGAhBCA......hBIA...,1,-6,-8,2
NGDVLKWPEeFgTbMcJASUHQIXfYCZaBRdO,HAAAQAAAXADBCACAZADBRAFA..dCADGAFALCFAKAHBEDCBeDCFhAAA.TEDAMDHBADIBSEHBhACAUFEA.fFGAhAGAaFBBOHAEDGFB......hAIA......hCDA...,1,-1,-12,11
XCaBDgTQRVHdSYONGePWUKFELbZJIMcfA,aAAADAAAQACAHACBdAEB..OAGDeAEAUCFAECEFZDFEMAIBAAIBBFBAhBAARDDB..SBBDhAFAGGDB.KEHB.bGFChBAA...JHBA........hBHA......hCAA...,2,-19,-11,8
GWNBUZXFbCeVQaPcKYSgEOHALdRDJMTfI,RAAAMAAA..TAEAGACBBAGBZAGBFBBHeAHHQCEA.hAAAaCHDKCCA.SCFHhABAEDCFHFAAAAFAdDAAfEEEhBAAIECAUFFAbGFA.CDHAPFDD.hBIA......hCAA...,2,-14,-4,10
IcLTKGPORdJfVbFCHgXaQMZNBSWDYAUeE,EAAALAAAGACARADFdAFA..VAEACAHAHCAAaAHD.ZCFEBCBD.DDFAhAAAAEEBeEGB..TEAAhAEAOFFBJDHBFHAAQEDAhAHAMEIB.SFFB..hBCA......hCAA...,2,-14,-14,0
gDdFUNEcGMVJQTHbaIeZWCLSPKBXOYRAf,DAAAdAAAFADAEACA.GAFA..MAFAQCBAHBCCaBBHeAHBZBFBLCHBhBAAKDDCODGDADDBUFBAhBFAVFEB.JEEFIHHAhACASGFH.BHDA.....hAIA......hBAA...,1,-6,-14,8
WGPMadAOYKFbcXeRSNIVCJgLEfZDQBUTH,KAAAFAAA...XACBRACFSAEB..IAFACAGALCEAhAGAEAHBZBEAQEEAhAIABCCDHDEAGGCBaDHDAEDBOHFEhBAAbGDA.NBIA.........hCAA......hCBA...,2,-18,-17,1
WKXMPSQFIfgDJGNHLYcTdaBOERZCUeAbV,VAAAXAAA..MADAQADA.FAFEfAGAhAAADAIBGCEBHBDBLDAAhAAATCGAaEEBEDCBRFFACEHBAAIBbEFAhBFAKHCA.SFCAIHHA.gGEAhCAA......hCDA...,2,-11,-3,8
ZBTEULHRKgSMdIAbGYWNQDaCefcOJVFPX,GAAA..YAAAQADA.aAFEeACEOAHDFAFAZBFEhAIAECDBHCFBRCCBKDGAMECBhCAAAAABbFDB.DEFB..fFGAhACAVGFABGDATGAA.....hCBA......hCCA...,1,6,-19,25
cEATJHGgbOSeFXfCBDWUaYPRKVQdNLMZI,HAAAGAAAOACAeADAFAGDCAFABAHADAIBUCDA..aCCARDFFKEADdCFAMCHBhAAA.ZFDAEEHFACIB.hAHA..TFDAJFHBSEEGhCAA..fGHA.hDAAYHDG..hAAA...,1,-16,-26,10
MJSfCOQNFEgebYDRdXBZAGIUWPaLcTKVH,GAAAUAAA.aADATADAHAFB..MAIBSAFBOCDBQDGDhAAAEAHB.eDBHhACAbCDCRCGFdEEAZDABAAHBIGGAhBAALEEBKFCA.fGGACHFD.NEIA.hADA......hAIA...,1,8,-13,21
FcUSZfOaeLCBQRXDKbTIVGYdNEgPHMAJW,FAAASAAAZACB.OACDeAEALBHB.QCEAhAFARAEAKBHBbCDD.TECAGCFAhAAAdFFAEEAA.HFACACHBcGDBhAIAaEHDBHAA.DHDAIHHAYHFG.hBAA......hCAA...,2,-17,6,23
BbDAVGgTHROMKQdcFaWPCIXEUSfeLJZNY,GAAAHAAARADFMAFAdADAaAFA..CBFA..EBHBSAHHLDAAZDFAhAAABBFAAACA.TDDAKEEDQFGChBIAFDFA.IHDAhCAAfEHA.eDBH.YFFBhAAA.....hCCA...,2,-13,-10,3
UZdODfWKaLXTYGVcQgMAJFEHRNISBPeCb,EAAAHAAARACA.SACEBAFB.eAEHCAHAZCCAdAGA.DAIBKCFCLCCBhAAA.TDGAGDAAhAAAQEECACIBFDGDIGGAhADAbGBCfFHA.aGGHXECBhAHA.....hBGA...,2,-27,2,29
gIPCNdDSAYeRLWUTOZaBfFMGJXcEVKHQb,RAAALAAAUADAZAFBaADD.BAFAFAHD..GDDAJAHB...ECCBHCAAhABA.QCEAhACA.bEEAgDGAhAAACFAAdGDAAFIB.eFBBOHAAMFIBXGGChAFAKGGB......hAHA...,2,-13,-9,4
HWOaUBXZRVFefKTEbYNJPgcCMSQIGDAdL,HAAAaAAABADARADFeAFE.KBFAEAFA....bCACJAHB...PBBBhADACCHAMDFB.QEGAhAAAGCEAACEBdEHALGDAhACAODCD.ZFAF.fGCENIAB.hADASGFHDEEB.hAIA...,1,-4,-15,11
TDRgMQBfUCaOYXdPAHGVNLSZcFbeKIJEW,HAAAGAAALADBZADAFAGAKCDAEAFADAIB.RBGB.MCHBQCABhAAABDCDUEEAaCED..XDFDhACAAAAB..SEADhACAeEHHIFAAJFCB....gGFAhAEA...hAFA...,1,-6,-26,20
DUCVfMGbQcSFgTXeNZKLaRIHOWdYEBJPA,CAAAMAAAGACA..QADAFAEA.TAFAeAGHZCAFLAHBhBAARCEBHDGBdBBAEGGBBDCAhCAAAAIBDCIBfDFAhCBA.bEDDSEEDXFGAaHCC.OHFChCDA.....hAAA...,2,-20,10,30
KOQYRPMAWVEINaGgdbTDcZfXJULHCSBeF,EAAAaAAAGACAdADA.DAEAZAEB.JAGBHAFCBBCCeBBD.OCFBhAIARDFAAAIB.VDGB.IGCAhBAA..bFFAfGGEhBEA........hCAA......hCGA...,2,-47,-8,39
QRdbPOJIGTMDUFZeSHWfCKVABLEgXacYN,EAAAaAAA.....NADA.RACFdAEA.OAGBGAEAMAIBFAGAeCBBhAAAHCGBCDEAAAEBLCHBhBCA.XEDDQFFChAHAbFFD.IHHADGBBSHDCKEDD.BHHBhBGAYBBF..hBAA...,1,-1,-23,22
aXRCSTEOPWDUBNAYedZQGKgMbIJfHVcLF,eAAAZAAAGAEAMAEA.JAHBHBCA.LBFBaACA.RDGFSAHHhAAAECCBODFD.DDEBBAGChABAAEBAdFDDKDHBIHBAhABA.fGGEFEDDCFHD......hBEA......hBHA...,1,-7,-27,20
AGUOHPSdgRJQfFIYEMTNDeKWXaBLVZcbC,GAAAHAAAdADARADAQAGCFAFAEBFB.MCDBTDDA..eCEFhAAAXCAAaCGELEGBhACAZCGBCFDDAAIB.ODAH.hAAASFEAfFFENEIADIAABFHA...hADA......hAEA...,1,-1,-12,11
VYPbXMDAZfaKJOHecCUSQIWBdGEgNTLRF,aAAAOAAAHACB.eAEACADAUAFA..QBGABAHAGCCAECEFTDFAhAEAREFA.FEHDPBBBhBAAbFAA..MBBBhAFAACIBZFBFKFFD..SFDHIHHA.dGHANIAB.hAIA......hBAA...,1,6,-20,26
SGTKLIZAaFcBMbDHUJQdgEPOXYNVRWfeC,aAAABAAA.MACAHACBUAGAdAEBEAHB.OBBH..XBCAhAAAVCEAREFA.eBFDGFBBhAIATDBALHCAABCAbDGD.hBGADGHB..QEEC....hBIA......hCAA...,1,6,-26,32
XECcaFfSURYIJeZTKBGNAbMPDWHOVgQLd,MAAADAAAHABC.OAEAQADALBFAEAFACAHAFCCH..SBBBhBAARDFAJEDB.eCEAhCAAZFFABHBAACIB.PHFChAIAgDDG.dEGA.aFHD.fGFEhCBA.IHDAhCDA..,1,-6,-22,16
dLPWaVIGCZgBUOcHRSbAKXEYQMTNfFJeD,EAAAMAAA...TADAFACDeAEA.dBHALAFBaCDD.GBBAhAHAZCEBBDGDOAHDHEAAhAAARDFAABBBXEGAQEDChBAAfGGADFHBPHBAIHCA..hAEA......hAFA...,2,-18,-3,15
UWbDPOGYRTaZMgKQXBHeFALIJSVNEdcfC,LAAASAAAEAEAdADA..CAGA.UAFADAIBGCAARDBAZDFA.MCCAhABAQFBBHCFAACABJDDBhACAVFFA...fGDAhAAAbEGD.OAHFaFEDKHCA....hAEA......hCHA...,1,-9,-11,2
WDfRYEVSKUBTPgOcIGMLCXAbHZNQedaFJ,HAAAZAAAeACEaACAFAFADAFA..RBEA.EBEF.KBHBBAHA...TDDAhABAOCCBGDFAMCGBLEEBhAAAACCB.bDGDhAIAdEHA.fHDBSFDF....hCAA......hCDA...,1,-12,-23,11
IDBbRQEFVKSWfHaJNXPdYCOZGAgTLceMU,TAAAeAAAMAEA.DAIBRACFEAEE..KBCASAGBHBEB.aBHDhAAAXCGDdCEA.ODDBhAAAACABLEDAIEBAhABAbEGDQGCAFFFAfGBA.NIDBCBGC.hACA......hAIA...,2,-10,-10,0
YbFACHIOWXGNPQfMKdLeJZRDSVEUcgBaT,HAAAOAAAGADA.QAFAMAEAdBBDeAHFRCAASBHBhAAAEBEAUDDABDFA.aDGDbEBBhBAAAACACFAA...XFDAhAFAfDGEKGGA.ZGFADEIBgGCHhBEA......hCAA...,1,2,-15,17
UEJNITaHGBKWXSbFYOZdVgQeALMDcRPCf,MAAARAAACADB.UAEA..EAFA..JAHBTBGAHBBBGDEA.hAAAKDHBSCCAhABAFEBHZGBEdGGAQDEAhAFA.AAIBLEGBDEDB.fFCAhCAA.NDIA.....hCCA...,1,-18,-28,10
WdUYGAMTVXBOJNKgPQLDabcFEeISZfHCR,MAAATAAABADA..OACAKAFA.QAFAaAHD.bCCAEBBBhAFA.eCEBZDBAHDFBhAAARDCBdDHAGGCBAAIBJFHBPHBAhBDADCGBFGGA..fHEFCHAA...hAHA......hBAA...,2,-18,5,23
WRaAMGfPLIJcUVedFZBQYTNEOSDHbKXgC,GAAALAAAJADAVAEA..eAGHZCAAQCGA..hABATCDAECEBDEAAHDBBhAAAXEEACCHAREFAAAIBMFEBhACAfFHAIGAAdHABBHFA....hACA......hAEA...,1,-13,-15,2
QcgDGTbeRISOMCfLUBNWXHAaFKPJYVdZE,aAAAKAAA..JACAdADA.EAFA..QAFCDAIBGBGAeAHH.RCCA.hAAAOBBBMDGBLEEBhAHABCEAXDBDACCAFDHD.hCAAPEEB.ZFAA.TGFASGHBhCBA......hDAA...,1,-11,-22,11
IXaOSBEUHTeQPAfWMLDRVcJZKGbdFCYNg,MAAARAAA..VAEAZABEGAEAdAHA.CAGA...NCCA.XCCChAGA.aAHDBDAA.HDDAhAAAeDFHAADALDGBhABADDHBKFHBFGGHgFDA.SFHHhCAA.....hBAA...,2,-24,-14,10
UTPAKSbLgFMWXEfQJaBCdOVZeNYHGRcDI,SAAALAAAMAEAEADA...QBDAaAFDdAHAZCCAeAHFHDAAhAAARCAADBGBUDGAACAAbDFAFEEHXFBAhABA.BGGAhADAOEEB.VFGBYHBAIFCA.hBFA......hBHA...,2,-5,-2,3
fTYIOAPNMgeLGbERWUSZXJQcFHVCDBKda,MAAAeAAAGADARACA.SAFAZAFBQCCBHCFADAIBdBHAaEEAhAFATDBA..OEGDhAIAAAAAgEFAEFCA.hBAAXFACFHCA.BFHAYFFFIHCAhAFANBBA.WFED...hCAA...,2,-12,3,15
GYXALDcCVSORMKgfQWbIZFTJaBdNPUeEH,LAAACAAA.OADDRACAMAFAKAFA..QBFA..hAAAbBFAZCAATCAAaCEHdCHAhACAUDDBHEFAGDGAhABAAFDADGHB.SFAA.fGDAhACA.FHAANIBB....hAFA...,1,-14,-17,3
IDPVFTNUCJQGSYaKXOedEBgWMHcLAZbRf,RAAADAAAFADAUADA..QAGAGAGA..aBBBOCCA.ECFFhAAABAFA.MCCBHDGBhABAAAIBZDDAbGAA..fDDEhAGAIFDATFGACFFDSGED.KGHBhBIAeFFD....hBAA...,1,1,-35,36
bVgGINWEJBPDHAFUYLaSTQdMZcXRefOKC,FAAALAAA.aADDTADA.dAFAZAEBRBGF.eAGFKCCA.CBHA..VCAAhABAGDAA.IEEAhADAEDGABEEAHFGBAEIBSFGBhACAMDIB..fFDE.hAIAOHAE...hCAA...,1,-8,-25,17
bgfYLUSXFTKdaQMPAGWOeDIRBNJHCVcEZ,GAAAeAAARADABAGBHADACAGB.EBHFZBFE....bCDAfCCAhAAA.LDEAhABAXDCCTEAAaDAHMDIBhAAAADIBDFFAIFEAVGDAgGGBSFCH.hAEAdGGA.....hAIA...,1,5,-13,18
fWdXVSLYCGKZEBJFPQgIcbeAaOUHNMDRT,aAAAHAAA.MACARACF...TAFAdAEASAGALAHBGBDAhAAAECFAFCHD.QDFDhCAA.gFCBhCCAbEDAAAGAOBBHDEIBXGFACDEDZFGB.BDCD.hBAA......hCAA...,2,-22,14,36
NJXFfRGDICOZWQeHUSEdgcTAKVYLaBMbP,KAAALAAAMACA...bADDJAFB..FAFARBCBGBGACBFD.ZEBAeAHHhABAHFEBECAA.dDGD.hAAATEEAAAHAaEEABGGBhBEAXDCCDEIB.OFHB......hACA......hCAA...,2,-18,-14,4
IGAZSaXeCLNBDHKTQVRcJEOFdUYfgWPbM,aAAAeAAALADADAEAHAFCKAHB..QBCARCCA.ECEEdCFAfCHAhAAAgDGHbEEBhABAGEAA.AAEAZFFAhAHACEHATGCAJHCA.FGGA.......hBAA......hBBA...,2,-13,5,18
XWZCbFSKPNGfHMeIYaTdLVEJgUBQORcAD,XAAAZAAAFADAKAGAGADA.HAFAeCABaCFEdCCDLDAA.hABAEDHFgCEHhACAQFAARCGFAEIBCEFASFEDhAAA.fGGAMFFBTGAA.UGGAhAGABHADDICA...hABA...,1,2,-10,12
HAFEIWQebJVNSgPLOCGfUZRKBcdYDMaTX,EAAAQAAA.eACAbACA...VAFASAGALCDBGCCAhAAAZCFARDAABEGAdCGAMCIBhADAaFED.HEABADAAFGGAIFEAhAEA.JFHFNIAB.OHAE.fGFAhAGA...hAAA...,1,8,-9,17
UWTdgZEcMfBbQLCKNGPIOSYRaADeHVFJX,HAAAFAAAUADAdADAEAFA..MAGBBAHALAHBKCADGCDB.OCCHhAAARDBAABHBDDFB..eCHHhACAJEGB.TFAAZFBA.hBAAbEFDCHHA...IHCAaGED....hAFA......hCGA...,1,-6,-30,24
CdcXaTZNPIAVSELBeOgGMJbHFYDKWfQRU,EAAAeAAAGACAMAEAHBCADAEA.KAHBQAGARBFF.dBEAaDEHZDFBhAAA.IEEAAAAALDHBhBEAOCBBbFBBFGFBfDHAhBCACEGA.TGCA.PFHDBHHA.hBFA......hCAA...,1,5,-7,12
BXGIbHNKdEFMgRcOWQTVSACYDLfZJeaPU,DAAAZAAAeACEUADAGAGAHAFBdBHA.FCCHRBBB...ODFBQDEAhAGASECAAAIBLFBAhBAAaEGDBFAAXFGAhBBAIHAAKGEAMIDA..WEHHCHHD...hBDA......hBFA...,1,-13,-14,1
CPGDIgOaHSJMeLRdfKcYEQANZXFWBUVbT,ZAAAFAAABADAUAEA....TAGAGAEADCAAOAGF.HCCBhADAMCIBREFAdGAAKDAAEDDAACCB.hAGA.XGDA.hABA.bDFDCGHA...IHDAaHGC.eHFAhACA......hADA...,2,-30,-16,14
WgMbaBfZOeNPVDCFSYLEQcTHGXRdKUJAI,..IAAAMAAAaACEZACA..eAEH..PAFACAGAFBBHLCGBhAGAEBHF.QDCDhAIAHCCARDABdDGDKDFDAADAbEEChCAAOEHDDFIB.SGDATGCAXGGDhCBA......hCCA...,1,-6,-14,8
ZNLIOeEPdAfRMJgHaDXWYTbFKQGUVcSBC,RAAAMAAAHADBDAEA..XAFA..TAGAKCCDGCFAUBBASBEBhAIAZDAFLDHBhAAAeCEDEEEBAAFAJCGFaFDH.hBAA.bGFAFHFA.........hCAA......hCBA...,1,3,-31,34
VPBfMQJLEbDUGIagYFCcONSXTdeHRAZKW,ZAAAKAAA...VAEABACB.MAEALAHBEAHF.DACAGBCB.hABAaCGEFCCH.ODFBhCAAXDDAeEDFHEFBAEHAfFHAhCBAbFBA.IHFACFHBNIEB.dHCD.hAAA......hBFA...,1,-13,-19,6
SdAUMXYgIaFKcRQJOGNPfVCHZTBDeLEbW,MAAAXAAA..IAEAaADA.KAGARAFFQCDCGBBA.hAGA.fCGAhAIAHCGBZDBBTFEAeCHHEDEBSAHBhAAAABBBgFCAFGHB.OFGB..hBAA......hBDA...,2,-19,-1,18
IbYENaADOTeRfKMGLHXUcFPZWQJCdVgBS,TAAARAAAMADA..HAFCUACAFBDDZAEB.QAGAdCFABCHASCCDhAAA..bCFDhAAAEEEBADDBeDHBGEGALEBAhBEAPFDB.CGGA........hABA......hAIA...,1,-10,-14,4
eUDFTbECZHNWKfVSLdQcYXPABgMRJGIaO,MAAARAAAGADA.OAFAeACAFAFD.EAHBHBFB.KBHBSBBDhAIAdDAAQEFBXCCBhBAAAAAABCCDIDFAhCAAaEHDTFBAZDGBfEDA.LFFDhCHA.....hADA...,1,0,-13,13
VIacEANDRJdTYBMZgQWPUOCSXGLFebKHf,RAAAdAAABADBZABBQADAUAFA..SBHBGAGAeDCAHCCAhAAAfDFA.hABAaDHDADGADECB.TEEAhAIAMFBAgFGGOEGDXGECbGAA..hBFA......hCAA...,2,-31,6,37
cGMdSHeYDEgFRIaXQUCNKOJWVPBLbTZfA,GAAAdAAAHADAeADAEAGERCAAaAGD..UCFAKCDAOBHD.JDCFPEDBhACA.LFABhADAZEEAAAABMDABDCIBFFFAQGBChACACGHA.VGEABHDA.....hADA......hAEA...,1,-6,-9,3
TAYKGCZDSIBWfdgVREJcLMQbPXNaeOUHF,GAAAZAAASACEBADAdAFARAEF.EAHBLAGB.MAIBbCDC..hABAXCGDeCCBHEDBhCAAAAABCECD.DEIB.fFFBhCBAgEEBJHEEPFBBaGCH.FFHB...hCGA......hDAA...,2,-11,0,11
TYaPXOEWSURGgCeJALKfBIbHQZcdDMFVN,LAAABAAAHACAZADBdAFAMAGBFAHB...TCAAaCAA..OCEBhAAAEAHBUDFBRDFAGEAAhACAeEEDABFBKFFD..fGGAhABAIGDA.........hAEA......hCIA...,1,-17,-19,2
bDaSNZAKJRWFEXUITgVBGQHfcMdPOYLCe,RAAAEAAAUADA..TACABAFAHAGB.MCCBdAEAOAGB.hAAALAHBeDDAaDGEZCCAhAAAAAIBKFFAFEEHXGEAhCAA.IHCA......hCBA......hCHA...,2,-33,-18,15
ZcbHDgNELJdTQMFOVRSaKWfGCYIeAPXUB,XAAAZAAAHAEADACA.EBHFdADA.MAFAOCCBRBEFKBGCGDEA.hAAACDGD.eCHFAAGA.BDBAhABA.bDFDLEDDhABA.TGGAFDDHaFHD.......hAIA......hCAA...,1,-15,-17,2
XJDKCRTMeZaBUWOFGLPgYSNVdcfEQAIbH,HAAADAAARABA.eACEZAEBBAGAOAFA.GBEBLCDD..gCCBhAAASAHHdDFDECGBhAEAADIBbFFA..KEECMIBAhBIAaDHD.FHFA..PFGB....hBAA......hCAA...,1,9,-36,45
TCKLaEMQYVOdcFZSXHIWBJUARNfbGDePg,RAAA..bAAAeADE..TAEALAGBEAGE.MAIB.QBDDhAAAOCABdCCDZDEAHCFAhAAABFFAACHAGEAADCCBCFHAaGCAhABAcEEA.XFGDIHHAWHEG.hCAA......hCGA...,2,-18,8,26
PTAMZNLOUeDGYcFfJXKVgRdQBaSWHbCEI,ZAAALAAAeACEGAFAFAEA..XAGDKAHBRCCAdDHAaBCEHEEBECAB.hABA..TFAAAAIBMCFBhACAOHAEDDDB.fGHAhABAgDGASHEAbEDDCGGA...hCBA......hDCA...,1,6,-22,28
fDZBaMWYCTeRLHNQOFJXbKUIPdEAcgVGS,VAAAGAAA.DADAZADBMAGB..CAFARAGFHCDB.QDGAhAAAFCFH.XDBDbDABKDHB.hAAAIAHAdFFA.ACHASFDAhACAaEEH.TGFAeHFANIAB..hADA......hAIA...,2,-18,-4,14
GTEZYbBNfeDJQWIdMOSUAPCaRVgXLFHcK,aAAARAAA..XADBHACBGAEBZAFBBAHAeBBDDCCBQCFBhAEA.dEDAMCHBSCHHhAFAAAAACDDALEFBKFFAEGHFhAHA.NIAB.fFBAIHFA.OEHD.hAIA......hBAA...,1,7,-29,36
XJEGAVNbOCBYZDaHcLIWQRfTPKMeUFgdS,VAAAOAAA.BADAZADBHAFALAFA.QCCARCEFTDAAMCHBhAAAeCEAFCHD.dEFAXEFDhADAEFCA.AAHACGHAaFHBhAGA.IHAA...WBBD..hAHA......hBAA...,1,-12,-19,7
XbGUMJSZHIBPeTAQKOEFYgadDRCcLfVNW,QAAAEAAAFACD.aACERAEALAHB..fAFAhAAAVCDB.XAGDGDFAMEABhAAAZCDAHDAABEHBeDGHhADAACGAKHGAOECE.dGHA.CFADNIABbFAD..hAEA......hAFA...,1,12,-12,24
RUHGVCWSBbZDXeOdIgfLNYQMaAEFPcKTJ,EAAAFAAAKADARACA.HAFBGAFA..CAHABCCAZCCAeAHBdDAA...fDAAhAAALDEAQECChADAADHBTECAVFABhADAbFFA.OEHD.gFFDMHAAaHFA..hAFA......hAIA...,1,0,-17,17
MXIdeROZQNDAcbYaSCWJVUKGTFHgfLEBP,...bAAAaAAA.CADA.JAEAKAFA.GCCAHBDBLAHBBAHB.MCABhAAAdCFARDABZCFBQEGAhADAACCBSEGH.UFCAhABAFFFHEBBBIHHAeFADDHCA....hAFA......hBAA...,2,-15,-3,12
gBXCQHbaeVKEGJZDdNSWRfYcTPALMFUIO,MAAAFAAAOACDBADA..QAFAHAEAeAHHEBBBZDEA.dEAASBHBhAFARECB.fCEAhAIATFFAACGBIHAAhAEACDCAaDFDGEGADDIB.YFEF...hAGA......hAHA...,1,-11,-15,4
LaCceTYRVfdZSQDgUIEJGWAKBPFNObXMH,BAAAFAAAOACDMACAHAECLAEA..aAHDeAHHRBCB.dCEAZCEFQDGBhAFADCBBUEGAEGDAhAAAGGAB.AEDBKFFAPHAChAHA...........hAGA......hBAA...,1,-15,-20,5
NKIfgeFCcdVXDHaTSRZOLUYbEGAMJPBQW,MAAABAAAQACAKADA..IAGAeAEACAHAdCAADAIBHBBAhAFAaCCC.RCEAZEEALCFAhAAAUGEAEFCBACGAJEEA..NDIA.hBAAFFAA.XFGA.OHEA..hACA......hAFA...,1,-14,-16,2
DNPMLHefAOJcVCYWTbUGgdXKQERBFaZIS,OAAAVAAA..CADB.TADAGAEA.dAGBQAFCBBHD.ZCCAhAHADCDBMAIBHDFBABBBJCGBhBAA....cFGDhAAAbFFA...XEDDEHFA.aHDANEEA..hCAA......hDAA...,1,-9,-27,18
GIHVdCUSXOfJYegWBKZPDNARcLFTEQbaM,RAAALAAAEADE.aADDGAFAHAFA.dBHASCAAOCCB.JCEBeDEBhAAABCGAZEGB.DFABAAHATEGAhABAMFDB.CFAAXGEAhACAfHAF.WFHHNDDA.....hAFA......hCAA...,1,-8,-18,10
GJAQaVXYUfCdcNROZHTIEMgWDLFbKePBS,aAAAXAAA.UADAdADARAFA.HCDC.EBBBMAGBDCHB.LAHBhAAAKDBDBEEDGDBA.hAFAABHBQDDAhABAfEGECGAAOEGB.IHEAFGGH...hAGA......hAIA...,2,-25,-12,13
TZLWVODQFcYgaCSINBPHGJKXAdURebfME,RAAAeAAAMADAEADA.ZAFBLAHB.OBDCQCCA.FAHDhAAAgCCGaDFECEHASFBAhABABBGBHDFAKFFAABFBhCAAbFBA.TFGADGIB.YFFFNIDB..hAAA......hABA...,2,-13,-10,3
UKIdeEfTPbDRCOXBcSZFGaAVgMQYWLNHJ,MAAAQAAALAEAHACAKBBAeAEE.EBHFTCDADCEA.RCFFOAHDhAFABDDAZDFA.aFFAADBAVFCAhAGA..gGDAhAAANEIA.IHAAdGGAfHEFhBAACGGD......hBBA...,2,-13,-6,7
JNFGcCRPLbVYEOTXZWdHSUDBMaQKfIAge,eAAAFAAAGACARADALAGB..bAEAECCBOBHDZCEBHEAA.DAIBhAAAaCEDQEGAhABAKDGDAAEAJFFF.CGEA...PGAAhAGA...........hAEA......hCAA...,1,-11,-21,10
ELdbgITXPSeAfGCDacWRNVYOFJZKBQMHU,GAAAaAAA.RADA.VADAFAGAZCDA.BCGBHAGBLEAAdCCA..hAAAbDAB..TEEAhACASDFBAADADCIB.cEDBhADA..YEGBKDHBMFFB.EGAB.XGGAhAGA...hBAA...,2,-24,0,24
AHeWBFKSfEPGRJNOdVaCcTgMIQYULDZbX,HAAAeAAAFADDSACE.EAFARAFAOCCBaAHD.CCGA...TCCAhAAAMCIB.QCEChAFALDEBZEFBADHAKEFAGGABhAAAdEHAgGCAIFAADGIBXGGChBHABHGA......hCAA...,1,-1,-11,10
KDJZWdGMQHebcEXPLTOAfFCVSgRUNYBaI,CAAASAAARACA.UADABAFB.aAGDDAGAZCAAGBFA.HDBAhAAAeBHHEBHBLCEBhAAAADDAFEHB.VFGB..gFBAhABAIGDA.KFEA......hBDA......hBFA...,2,-29,-17,12
NMYSOWGePHRCTdIXZfDabVFgJUcLQKAEB,EAAAMAAA..OACCeACAHAFARAFF.dCCAZCCAaBBHFBHD.UEAALCFAhAHAAAHABECASECAhAIAGEEB.TEGAhBAAIGHADFFBgGGA.JHCAKHEA.hCAA......hCEA...,2,-21,1,22
XHfPdZMQgDRCEeGKFbUJABaVWOIcSTYLN,aAAAOAAA..SACHTADA.LAEAHAFBdBHAZBFEMBBBhAFAQDDCRCCBEEFAeEHFhAHAGDGAFFDD.bFABAGGB.BFFDhAFA.IGDANIAB......hAGA......hAIA...,2,-14,1,15
LCGTHIRKMSENDdegVUaQfAXWbOZPJYcFB,XAAAOAAAZADB..JADAFAFD.LAHBGAGAHBCBRDBB.MCFBhAAAEDEAdBBDeDGDUEGAhBAAaECCAAIB...bGAAcGFChBHACGGD...KHCADEIB.....hCAA......hCHA...,1,-4,-16,12
BDWQCFMeXHcRYKgTaPVIbdOELNJSfAUGZ,ZAAADAAAQACAMACAHAECRCCAKAEA..aAHD..IAHAdDGAEEEALFCBhABASBBDAEIBBGGAhAHAFCEDeCGB.XEFDhAGA.YDDF...PHCAhBAA....hCAA...,1,-14,-30,16
ZESadHeUOYABXPTNMFLJRfCcbgWVQIGDK,XAAATAAA.FADARACF..CAEB.....bAFDVAGBGBCAZCDBECABhAAAdAHAHEEA.eECDhAAAODGBADIBBFHAMDIBhACALHBAfFEAgGGGQGAAhAGA.KGHD....hAIA...,1,7,-11,18
DUbNdWTfARCXBcaeHIVELKQFZGJOMYPgS,RAAABAAAeADEHACA.EAFELAGBFBHD.GBDAMCAB...gDGAhAAADCCBUDDAdCFAhAAATFCAAAHACEGA..aEADKDCDhABA.ZFFAOEHD.SGGDNIAB.hAIA......hBIA...,1,-8,-18,10
IELAMPWcNXHgeOKBdTCUFbZVRfDQGJYSa,MAAA..PAAA..NAEAHAFAeADABAGAdBBACCFD.FBHDZCGBRCCAQDFDhAEAGDCASEHHhAFAEFCAACCA.XFEDhAHAKFGDbGCA.DIAA........hAIA......hBAA...,2,-16,-14,2
QXINBGEbLSgHKTVaMeRJWUDZcCAdOYfFP,dAAAOAAAFADA..QAGAXADABAGAGCABLCCBHCFATECAhACAaAHD..RCEAUEAAhAEAZEEFAEHA...fDHAhAGAIGAAEGGEbEFDKEEDMIBA....hAGA......hBAA...,1,-6,-11,5
egNSMFDKOHLYZcAdGbQTfaURBVPWICEJX,GAAATAAA.aADARACFBAEB..VAGB..IAGAECDAeDBHhAAASAHHMDFBKDGDHGAChACAZCDBACABdDGAQGGAhAGAfFEAWEEDXGCD.FFHDDDIBhAIA......hBAA...,1,6,-17,23
EbaWSYBcNfKTedFgAIUJDPXLOHCQRVGZM,UAAADAAALADAHADARAGFZCDAEAHB...aCHDSBBB.BCEAhAEAfDAAeCFHdDHAhAFAAEEAJFABODCD.QGFAhAIAGFCBbGFAYHCA...hADA......hAFA...,2,-13,-13,0
gEIcLDHSQYZGCNATBPFVWfbUOdJeRXMaK,TAAAFAAA..VADA..bACBdAGARAEA.MAIBKBHB...ECCBLDEAhAAAHDAB.QECChAFAGDFAADABBDHDhADAfEHAOEDDeFFBaFHD.gGCAhAHA.IHHA.hBAA...,1,1,-17,18
JWYfBdTRFKVNCXHgbLPAUMDQZaIOGEeSc,MAAAZAAAaACAGACB.EAGEeAEH.SAGAJBBF..fCFAhAFAdCGARDEBKCCDCEHAHCGBhAIALGAAACIBQEDChBAAIGGAOFCH.cFGC..hCAA......hCDA...,1,-9,-21,12
fAaeBRPHgIQZCSEFLWbNDVGKTOYUXJcMd,eAAARAAAHADBQADAZAFAECCB.LAGB..bCFDDAIBGDAAhAAATCCAODHFXDFChAAAMEEBABFAaDHDBGGAgFGGhABASGADFGCAWFDD....hABA......hADA...,1,0,-4,4
XbSKLDEUHFPCfNIZTAMaJdVQRGYOcBgeW,aAAAdAAARADAGACA..OAGDBAEAeAFH..bABDLAHBhAEAECEFHDFACDFA..fEDAhBAAZDAAAAIBMFFBQEGAhBBAgGAASFFDDGGA.FHBAIHHAhADA...hBHA...,2,-19,-4,15
FcMTGKPCEUDZBSgQWVNbeadYXLfAJIOHR,OAAAHAAARADFMAFAGADAKBFAEAFA..ZCAASAHHQDFAVCFBhAFAeEEB.dEHALDBBhBAAABHAFFDH.TFGAhBBACGGDDICA.BHBA.NDDAaFFH......hBDA......hBHA...,1,-5,-7,2
LKRSgaNGBYbDdeXTMAJZfFVCOUEWHIPcQ,ZAAAFAAAOACDEADEHAFB.....IAHAQAEARCAAaCEHGBGAhAEABCHA.bCDDeEFAhABAMEGBACAA...fFHAhAHACFAAPFDBKFHBSGBA.NIAB.DGGBhACA......hAFA...,1,-10,-13,3
VFTUaLcNKOJERDYZSPbdIHGWXCMfAegQB,eAAAQAAAFADDUAFAaACE..LAFAKAHB.ECDARDDAZDGB..hAAAbCFAHFBAGDAACCCDAEIBBFFChABATEEA.OEGDhAAADGIB.SDCG.dGCA.XGEChADA.MFIB.hBFA...,2,-28,24,52
GIgEXUWdOLTFMBbVZQRaHeSNAKPcCYfJD,KAAACAAA..JACAGACA.EAEAUAFAdAHALBGDFBCH.MCABhAAABAHAZEABRDEAHECB.hACA.eDFDACEB.cFCAhAEADCIB..XFGAODHD.....hCBA......hCFA...,1,-10,-44,34
OVYXMeHTCALgZDNEKbGfcaUBdRPJQISFW,ZAAAEAAAGACAaACA.dAEBRAEF..QAGCFAHBOBED..XCCChABAHDFBACBBLDHBhAAADCIBKDFA.bGCAUFFABHHAhBCAIHDA.SEED..hAIA......hCAA...,2,-24,-4,20
PESdCeHfBXaIFGYcTJKDQNURAZVMWLOgb,ZAAAMAAALADB.OAFAbABA.EBFBdAFA.HBGBBBHAaAHFGCAAhABATCCADDFBQEEAhBAARDGBACAB.gFBAhBFACGBAeEED.XEGAFGGH....hCAA......hCBA...,2,-11,-8,3
UaLZWXdOCbDReBgSEYGHQAKVTPNMJIFfc,TAAAMAAAFADD..UACAZAEBdAHA..bAEARBBBBBGC..ECEAhAAAHDECAAFAKCHB.VDFBhAIAPEHD..IGHAhBIAaFFH..WHDGCDDDDIFA.....hBAA......hBBA...,1,-17,-29,12
BUJNXRAbITWYCSegZfVLEdQMKPFaGcHOD,TAAACAAA..eACAZACBLAFAEAFA.dCEAMAIBFCAHGCGAhAAAHCAABBGAUGAAXCEChAAAAEDB..bFFDIEFAhACASFHHfDHEQGCAaFCADFHBhADA.....hACA...,1,-5,-21,16
SZfTOLcQWBCPDXVRJaKNHIUgEAMYGFebd,GAAAeAAAdAEAZADAOAGBLAGB.QCDACAHBDBDB.REAAaCHDhAAAHCGB.UEBAAAEAMEGBhACAFEDESFGAhAAA..TFDABGFD.PFHB...hABA......hBEA...,1,-1,-28,27
fPHBLOFKSdJMUIDQRaEXVGTYbNACeWgZc,eAAAZAAA....fADBHADALAGBKAFCdBHAMAIB.DCCBhAAARCAAECEAGDCA.bEEBhABAACAACDFA..gEGAhAFABECASEEDIHHAaEHB.TGFAhABA.YHCA.hCAA...,1,-7,-19,12
VFJDXUZTLgdQWKPbcRAaBYSHEMfGOINeC,aAAASAAAHACBEAEAGACA..OAGDeAEAFAHDDAIBZDEATCEAhAAAdEAAQFCAhAEAKDGA.bFFAAAEAMEEBhABANIDB.CFFAXGCD.LFHB.hBAA......hBBA...,2,-6,-6,0
AedbYMTSKJcVZNIBDQgXLWERPFOUGaHCf,eAAAdAAAMADAKADA...JAGBZAFB.BAHAQBDALCCBRCAA.OCEHhAAAGDGAHCGBAAIB.hACATFAASEEBhBAAVFFBDFIBXFCA.......hABA......hAFA...,1,-15,-18,3
AgGFCUfeQXMVcbWHaOIdYJKTNBPESRZLD,GAAACAAAUACA.eADA.MAHB..bAEAHCDA.aCHDdCFAKDCDBCBDhAAAEEABREFBZDDB.AAFAFCHDhAIAQFCA..hAAAXFFAWFHB........hBCA......hBIA...,1,5,-40,45
KCRDcHPXOagfIELbSFJdQZMAGYeBTVWUN,eAAATAAAUAEA.KAGARACFHAEB.OAGFaBCD...fCAEhAAAECGALDEBbDECFEAHhACAdEBAZEFB.AAAABEHAhAIAVFFACGDADGIB..XGAA...hBEA......hCAA...,2,-25,7,32
MJaSZFfXPGNAIdTeVYCQRbgKLBUWEcHDO,dAAAeAAACADA.RADA.KAFALAGB.BCCAEBHFHCACMAIB..aCEDZCFFhACA.XECAGEAAAAAAhAEA..TFAAQEFAhCAAbFED.gGCAcGGA.OFHDhCBASEHBfHFBhCCA...,2,-13,-9,4
cHECaFVBUKOWTZDIgMQfSAGRbdLeJXNPY,RAAAdAAAeADEJADA.....XAGB..PAHBHBDAECCBhAAAaBDCBCBAOBHDZDDADDFBhABA.MDGBQFDAhACAAEEBbEGD...YDHB.FGAA.KGGDhAGA......hAIA...,1,-6,-31,25
RSYBKCNefcMULaGOVJPdFgZTbQIHXWDEA,RAAABAAACADB.eACA.MAGBaAEDGAGA..OAHBJCCBdDFAZBCEhAAA.TDAAQEDAhAAAHDDADCIBAAGBKEHBfEGAhACA.cFDC.....hABA......hAIA...,2,-32,-14,18
fNEGbZLcIUFQVHCaRTdYPOMWAXBKeDSgJ,KAAAeAAADACA..SADA.JAGBEAEAZCCALAHB.hAAAIBGAQDGAhABAHBCAREAAdFFAODEBAAIBBGADhAEAfDFBNEEA.bFFAFHGECHFA....hAGA......hCAA...,2,-26,-12,14
MVbOcLaSfAEdWKNUZPFeTXGDHgCRJYQIB,EAAAdAAAKADAZACB.FAFAeAEA.GBGAHCACRCFAQCEABDED.MCBBhAAAOECCLECBhAFAaEGD.AAIBUFGB.PEEBhBCATGCADICACGFDIHHA...hCAA......hCCA...,1,5,-29,34
RMIPaQFdXONDHceVATKYBJGUCfEbgLSWZ,TAAABAAAGACA.CAEA.EACELAGBZAEBRAGBMCCB..aCABdDGDhAAAOCEDHEABeDDBhAEAAAIBKDHB.UFFA.fGCAhAIAbEAD.SHGAIFGAQGCChAAA.XGEDhACA.,1,11,-32,43
eBHZYcfRAVULaIOKSFGQdMXPNWJTbEgCD,LAAAaAAA.KAEAGACAdAGA.MAEAXCAA..PAHDhBAAJCFF.EBEEDAIBHDFAhBBAZDCB.fEDAhBGAACAAUFFBODHFQFFB.WFHHbEADeHDGhABABHDA......hACA...,2,-18,2,20
gHDQbPFZVILAfNXSJEGTCUcBaKRdOYeMW,XAAAEAAAGACAUADABAEA.RAFF.dAGAeAHHMAIBHEAA.QEEAhAAAFDBAZDFALFBAhAAAACBBSDHHTFFAaGFEhAEAOHDC..YHAA.DGIB.hABA......hBDA...,2,-18,7,25
AbSOKGNDLJEIeXgZUYfTFRBMHdCWPaVQc,OAAAGAAALADA.EAHBeADAZCDAUEABTAGARDGFHEEBhAAAdCCACCFAaBBHQGCDhACA.AEEBKGHBDCIBXDFAhAEA.fEDA.MFCB.hAEAPFFB...hAFA...,2,-18,3,21
QMEKcWTYBOILVePDdaXJFbRUCfNGZgSAH,HAAAEAAAKACATAEA.OAGDLAEBeCAAdAGA.aBHDFCEHRCCBUEFAhAAAfDGE.ZDAEhAAAAECBMEIB..cFFAhACABGBAIGDADAIBbGAANEIA.SHFAhAIA.....hADA...,1,-1,-17,16
TBAaPGUcFWbQgEdIeHYSLZJVRKNCDXOMf,GAAAFAAAQADAEADAeAFAHAFALCDAZCCARCGBKDAADBIB..MCHBhAAATFFAACEAUEEA..hACA.bGAAdHAB.SFHHhADANEIA.OEEBaDAHcGFD..hADA......hAGA...,1,-3,-4,1
EOIFcPZKebGDSHQYCATVWMaXgdRLBNJfU,TAAAMAAA..aACEdACALAFABAEAJAGBEBBB..FCDDZCEAKCHBeDCFhAGA.GEEAHEAAQEFAhAAAACHAXFCDNDIAhAHAOFCE.IHFA...bGAChAEASGHDCHHA.hAGA...,2,-18,-1,17
LKRIDWBPbcQCTgMHNfVUGXAFZJSOdeYaE,ZAAAOAAAeACE.EAFERADADAGA.BBBD..bBFAQBGAhAEA.CCDD.MCCBHCEBfDDAhABAGEGAAEIBSGDAhBAAaDGBLEHB.KFDA.IHAAhAHA.cFFDNICB..hAIA...,2,-20,-16,4
GRYCLUVBTNAgeOcDfEPJHdZKQFIXabMSW,eAAADAAAEACAHADA.ZAGBQAEAFCCB.aAGEbDEC..MBBBhAHAGFABRCCALCHBhBAABEHAAAAAOFFB.fGHAhAFAdEEAXGDC.SGFHhCAA.CHHA.....hCCA...,1,-5,-15,10
CaZFVLdgOUbNQHYMRDIPKeScXJAEfBGWT,EAAAGAAA.CADAZAEBLADA.dAHAOAGDUCBAQCFChAAAHDCAREFADAIBKGBAeDDH.XEAChAEAAAABBGDBaDAHFDHDbFFChAFA..MIDASHBA..fGHAhACA..hADA...,1,3,-23,26
bJTAKVGDLSZIWYMNBFdgcQHXeREOaUPfC,GAAALAAAZADA..IAEAMAEAFAHDdAGAQCDAHCAARCEBECHFhABAaDCHUECA.CEHA.bDGBhAAAAAIB..DCCA.SFGDhACAYEFBBFDAXGBC....hBGA......hCAA...,1,-10,-11,1
OGIKVDBEAWdMCSNbPXReLTYJfUQHagFcZ,dAAAMAAASADA..bABARAFFeAHHTAFA..JCBBQCCChAFAHDCBFDHDZEEBGCGAhAHAKGGABHAAAAIBCCFDXEEChBAA.fGGEaEAH....hCAA......hCBA...,1,-13,-16,3
WTRSPDLUKVfIecMQbHGdNZCaFAXJOgEBY,OAAAEAAABACA..TADARADFDAFA..LBGBKAFC..fAHAhBAAeCCBMAIBHCCAhBBAdEEAZGCAaCFDACIB.XDGDhCAAgGGASEED.PFCBhCBAICFAQGGAhCCA...,1,-15,-20,5
REWaKOUgLXZPcfGICdVeFDMNJBHbTQASY,RAAAEAAAKADCUADALAGBZAFB......fAHAGCCAdCFChAAAeBCDMAIBBCHAHEFChABATEDAABFASGGAhCAAaDBHOEHB.XGEA....hAAA......hBDA...,1,-16,-23,7
eGAfEVSMLFIaPNbKJgYDBZCQWdcTHORUX,EAAAMAAALADAFADD..aAFA..bAGDKBBB..JBCFDAIBZCEBQBFChBAAdEAAHEGBOECBhAAARDDBeDFA.AAIBSGEBhAEAIFCA..gFGA.CHFD.hBBA......hCAA...,1,-4,-28,24
RBQUZaXCMcLWYfENPFeHbVSIJOKGgDdTA,RAAAQAAAZADB.aACEMAGB.LAHB..fAFAhAAAEDAAFDEDHEGBbAGDSCDBhADAOFBBKGEADIEAhAAAAAIBXDEDCFCB.cEGA.YFAAhAFA.eGCAIHCAhABAgGGB.,2,-11,1,12
dXQRUONTPEKVHcWCbDfaIAGYFMBJZeSLg,GAAAMAAAZABEeADALAFAdAHARBFB..OCDBTCCA..EDHFHCEBhAGACEAD.DCGA.aDGAAAABBEEAhACASECDQFGBhADAPEGDKHBAWFHH.....fHABhAHA..hBAA...,1,-11,-20,9
XQgSKJcOYLRAbaIPZEdVfNBFHMWUGeDCT,aAAAZAAAEADE..dADA..VAGBBAFAHCAAMAHBGCEAeBBBCCFATECAhABA..QDDChAFAKDHBOFABREGBAAIBbGDAhACAIGEA.fFCE.NDBA.hBAA......hBDA...,2,-31,5,36
OYVWGNFCSAfQRdHXJDLTcPaUKIgMZEBeb,RAAAHAAADADALAGBTAEA..aAGAKBDAMBHBZCCABBFB..eCAAhAAAOCHDVDDAGEFAhAAACEAAAACAdFGA.XGCAhAEA...........hABA......hAIA...,2,-38,1,39
DVebaNPSYFcQgBZEJUfOAGMITCRHXWKLd,GAAAMAAA.CADAHAEBKADAdAFADAGA..eAHBaBGA...SBBBhAIAFCDHQCGDZCEAEDCFhBAAUEFBAEEAREFBLFHBhCAA..NDAAcGGCBHCA.....hCBA......hCDA...,2,-15,-15,0
gNObcTadJYfZWSLAIXEUDQPKRCFHVMeBG,EAAAQAAARACA.HACAeAFEGAFAOBEEbCDD..aCCCdBHAJCHBhAAAZEABLDABAAEAUFGAKHEAhAAAFDEDMDGB.BFHAhADA...NIAB.YHAG...hAIA......hCAA...,2,-12,6,18
IKNHWOQFAgCaPYXDJLBefbGdMEZVTUScR,aAAAXAAALADABADA..eAGHGAEAEBBBZCEFTAGA.SCDDhAAARDCBKCHBHEABQDAAhABAAAEACEGBDFIBfGGAhAIAdDGAMCIBcFFCNIBB.FGAA...hBAA......hBIA...,2,-5,-1,4
CfgAXYBbUaFMNJeOEHSRDZVWcKPITLQdG,BAAAaAAA.MACAeACHHAECRAEAZCEA..VBCBKBHB....TEAAhAEAdAHAGCEA.fDGBhAAAAAHAbDDC.FFHBhBCAOEHDEGFF.DBBB.PFFB.QGCAhAFA.CHHD..hCAA...,2,-17,-1,16
EYHdDQZLTSeaWFXgJNcbORCUIBGfAKPMV,MAAAEAAAHACAdAEAZAFBLAFB.eAHBaAHDFBBAXCCA.JDGBhAAA..bDDCREAACFEABDHAhBAAAEAAKFHB..VFFADHCA.hAEASEBBNIAB.OHBA...hAIA......hCAA...,2,-18,-3,15
KNAbXcSQZYdGHaECROJMVgPUDeFIWTLfB,XAAAQAAAdADAHACA.EAFERAFAMCFBVCDA...UDBAeAHHhAAAFCGDTEAALEDBhAAAKDHBAEGBSFADhABAGGCBaFFCOFGB........hAFA......hAGA...,2,-19,11,30
EWeFYNDbcaVJOPTMAfUQHSBGKCIZgLRXd,QAAAHAAAGADACACAZADBRAFAECAB..eAFAFCCHDCHB..aBGEODFBhAAAMCFB.AAFASDHHhACAKDCDLDGBdGDAYEEFhAAAbGFA.VGAA......hAGA......hCAA...,2,-14,0,14
YCdcLEDAJNQUPgXTFWOHMSKeaVRIGBfZb,QAAAUAAA..XADATACAOAEAHAGBMCDBKAHBeBEFhAAARDABGEDAZCFBbDGDdFFAECEBhADA.AAGB.JFDBPDHDhAEA...FHGE.......hCAA......hDAA...,2,-16,5,21
UfHbPICBZGKeNaLAJQFgRWMTXVdYcOSED,QAAARAAAMADA...TACAdAHAOBDCEAEEDAGAHDDA.IDHAhAAAZBEEeBHHaFBAADDBFDFBhAAA.XEGAhCAA.cGGAfFFA.bGBA.BCCDhABANEEA.JHFE....hBFA...,1,-1,-17,16
BbfVXMPODTFZGCdYNcSRaJHegKWULAEIQ,EAAAQAAABACA...VACAMAEADAFAZAFEdBGA....cBCDhAAARCEBHEGB.eDDBhAAAKCFALCHBAAIBIGCAhCAAbDECfGFEOFFBFGHB.....hCGA......hCIA...,2,-16,-12,4
SJXgTBDZCHUeFVfaKREONcMQLWPYAGbdI,dAAASAAAJADA...TADAZAGBHCACeAFEFDEB..aBFDEDHFhACAOCCB.MCHBhAAALFCA.PFHDhAGAACIBbDADXDECDGGB.CFFAfFHAhABANIBB.WFCH..hADA...,2,-20,-20,0
QFRBIUfegCHdAPLWYEXObSDNGVJTZaKcM,LAAAEAAA.OADDbACA.DAFAGAGA.TCCAaAGEMBFBhABARDABBDFAUCAAeDHHHCGBhACAAADA..PEEBXEEChCGASGAAJFHBZGDA.QGFD.hCIA......hDAA...,2,-9,8,17
dIFGWLbTKMXHScAQNBYaDUPZgfVJOReEC,QAAABAAAaACA.DADAZAEB...VAGBRAEAEBDB.dAHAGCBAhAAALDDAKBDDHDFAADHAUFDAhAAA..fEEEhAIAeFGBCGCC.FFHB.........hBCA......hCAA...,2,-21,-12,9
GUFRfHOaKCMgcQTIEJPNdWbSLeVYDZXAB,GAAARAAAHADBKAFAMADA.QAGAEBHF.JBFFdDAA.SCCDhAAAeCDBDDHBAAABFCFDaDBDCDHATFFAhABA.IHAAhADAPFEC..bECDLFHB.YFAGhAFABGHA.OEEBhAHANIBB...,2,-6,-6,0
cFLBHCIWAZPVSOgEKTDdUXJMfQbaeRGYN,ZAAASAAAEADE.DADAdAFA.UCAAMAGBQCDDeAHBGBCAhAAA...NBFALEBBhABAHBGBCAHBAEEBOEGBhABATDGAfFGEaEHD.YEEFBHHAWFFDhACA.....hAIA...,1,-12,-15,3
YdTCLbQBKHIJaXfGUgVOEeWZSNMFcRPDA,dAAATAAALADA.QBGAHACBaAEAGAGAUCCA.OBEDhAAAECFBeEABZEBAMCABhACAREDAAAHACEHA.bFFABGGA.KHEAhACAXGDC.fHFF..hAIA......hBEA...,2,-14,0,14
ZWKHBDYgOLbGIeCAMUPfQaXcENJTVSFRd,MAAAUAAAQADA..aACEEAFATAFAFAHDZCDAHCCADDAA.hADAOAHDGDGAeDFFhAFAADIB.XDGDJEEBSGCBhBAARFCBdGGABBBD.......hBCA......hCGA...,1,-3,-18,15
QDHCALSPVXJbZFKNcaWIGgEBMRfYdOeTU,LAAASAAAXADDZACBKAEA...aAFAGAGABBFBRCAAdCEA.hABAeDFHQCGAhACAHGAAAAAAPEHDbDED.FEDHhAGAcGFD.IEDAEGGBMIDA...hAIA......hBIA...,2,-20,5,25
CbdWGABFQYOEZVTLfMDNIHSUePRaJgcXK,QAAAEAAAZACBLAFAMADA.DBEBHAFCUCFARBDBaCFD..JEEFXDBAhAAA.bDGDGGABhAAAACIB.FGGAOFCBhAIA.fGFESCBD....hAGA......hAHA...,1,6,-25,31
VcbZXCWTJUQePKFfBLgEHaGAOYSMRNdDI,SAAARAAAdADADAFA...VADAZAFECCCD..TBGAUCGA.eCCBhAAA.FDABLDEBhAAAHEDBAAGAMDIB.IGGAhABAbGDA...WHFA.....hABA......hCAA...,1,-5,-41,36
WTGeKRSEPQAMHFONbYDJUVfdXCaLBgZIc,HAAAOAAA..bADBDAEA.UBBBdAGAaBFBLAHBZCAA..IDGAhAAATBEA..eDEBhBAAREEBEEHFABGA.MAIBFDGHJEBAhBEAfGHABFHA....gGGGhCAA...WHCAhCHA...,1,0,-27,27
ABgMKLOdIFaTbfXeZRGPYDSUWVNHQJECc,MAAALAAAdAEAFAGAaADD.....TBBAbAED..eAGBRBFFGDBBhBAADAIBSCAAhABAUFFA.VEEANCIA.HGCAhACAEHDEABDAKDDD.fGHA...hBBA......hCAA...,2,-18,0,18
dAZcOUSQgTJYPILHNBDbFCRWKVfGXMaEe,ZAAAOAAAQAEA..TADAJAHB.IAGAHCAADACACBBDRCDAhAFAKCED.GDFA.hAIAaEHDEBHFAFEB.SDCDhBAAPGBC.LEFABHAD.bGCAWHEAXGGAhCAA....hCDA...,1,-9,-18,9
VEeXNKTJaOIDbGdHYfcMFRCLSZBWgUPQA,EAAAeAAAKACA..aADDDAEAdAFAHAFC....fAHAhAAAMCCARCEALEEAZCCABCHAgFGAhAAAQEEBACIBXGEDhAIATFBAOEGD.IHAAhABA......hAHA...,1,-13,-22,9
IcYRXDGaQACfPHZBOWbMVKgSFETLdeNJU,CAAAHAAAZACABAFBOACA.MAGBKAHB...FAHBECCAdCCA.eBEFUDEAhAAA..IDHAhAAARCGFGDAAADFB....fEFAhCAAbGCA.SFHBTGGA.NICBcGGChCIADEIBaHAC...hADA...,2,-25,-6,19
JNaLEAYGdTfIbHQBMSKXWgUcOVRZFPDCe,dAAATAAA..bABDHACB.MAEAKADA.XAGAUAFA.OBEDhAAARDCAZDGBDAIBeCAB.aCGBhACAADABGGDBQEGAhBEASHBGgGGG.FEEHCEFA.JHDANEIA..hDCA......hDHA...,2,-18,13,31
eXYgMHLZBEKGfFTcabRdPVDCAQIOSNWJU,QAAASAAA.JACEeACH..XAFAMAEAHBDB.ZAFEhAAAECDAGCFAFCFDaBHDRFGFdHCBhABADDCB.ADIB...OEEBhAAAWFFD.UFGA.LGAA.KHEAhAGA......hAIA...,2,-13,0,13
KQZbIJWFXGRSPBATYNLgCcfeODaUVHEMd,TAAALAAA.CAEA.eACEDAGA.UAFAHBECEBDBdBHA.ZCAA.JDFFXCGAhAAA.RDDABAHAhCAAACCA..gEAAhABAOCCBaEGDMEEBbGFA.FFHB.SHEAhACA.....hDAA...,2,-13,-12,1
YcebFZgKBMRHSfUJOETaQDPAWdILCXVNG,dAAALAAACADA.XADDGAEAeAGB.ZABBBAFAHDCBfAHAhABAOCHD.ECAAaEGHhAHAQCFDAAIB.hBAAIDDAVGDA.cEGC.FFAA.MCIBhACA.SFFDhAFA.JHAA,2,-14,-3,11
VcSDAKWELJFUNdCIGaXZgPBYMOHRTQebf,EAAALAAAFACD.dAEAGAEAZAFBBAHA.MCAAHAGD.RDDBeCHHhAAA.VEAADCHBACIBKFGDUEBAhABACGAD.aDDD..XGDAhAEA..gEGA.OFEDhACA....hBEA...,1,-1,-33,32
LUeCaIPKGdZQYVFWRfSONJXADBbTcEMgH,BAAATAAAEACA.HAEAeACE..aAGAKAFCZCAAQBGAFCEH.hAAARCCAODBBXCGAACCADDGBhAAAbEFD.MEEB.LFCBhAIACEHDIGCAdFFDYFHB.fHEFhBDASHCA.hCAA...,2,-12,-6,6
ALaNYHdVJIcBDFGgeESCXKbQMTfPWUORZ,aAAAHAAA.dADA.VAFAIADA.DAFAGCAB.ECFBXAGAhBAAQEECMBBBTFAAhAAA..fBFEhCAAPCHDOFHBACCALDDBNIAB.cDFChCEA.FCHH.eFFBhDAA.KFHB.,2,-30,12,42
BTDFXOVULbgJGIMEfASHYcaQNRPWdeZCK,HAAAaAAA.RADFdAFAeACHZAGBBAEAFCAH...OAFDLDFA.JCCFhAAAGCGA.EAHBABIBSEEDhACAQDDAPEABhAEAKFFCDFIB.XFEA....hAIA......hBAA...,1,-17,-22,5
FPQOTgYALEHKcMedNVGWUbXSfDBCaRJIZ,HAAAMAAAdAEAGADAUAGASAFA.BBHARBBBZDEAQCABhAAATFDA.AAFAECFFeDBDhBAAVDGB..bFFDDDDBhACACDHB.aFFH.IHHAOFHD....gGBGhBBA..hBDA...,1,4,-18,22
UBEKODIRPVYZcLAQbTfJCGaXWedMgFSNH,TAAACAAAGACA..aACAeAEA.dBHAMAFAFCABHCEBEBDB.DEHBRBFAVDEBhAAAZEABLGCAhAAA.AEIB.bDGD.XFBAhBFASGFHBCCDIHHA...hBGA......hBIA...,2,-13,-7,6
CdFQBDeXWVROfLAPUaHKZNJMIGEbTcYgS,aAAAHAAAZACBMACA.EAFA..TAEA..gBEGhAAAdAGAQDEAeAHFXCCChCAARDGBLECBACIBKEEAIHHAhAIAbEGBSGGDBBBDDBIB.....hBAA......hCAA...,2,-19,2,21
APLEKMIDbOZYBUWVcQTdCRaJfHGNFXgSe,EAAAMAAADADAZABE.BAFAUAGA....VBGBTBCA.RCEB.aCCAhAFAHDGBGCEAFCBHSEBAhAAAAAHALFHBKGFAhBAAbFBA.ODDH..cGGC...hBIA......hCAA...,1,-10,-20,10
fgeGDdSHCFYUZNaPXATRbKBILVWOcMQJE,RAAABAAALADBOACAMAFA..EAFAeBFAdBCAHBFCFCHD.ZDEAaCCBhAAAAAIBKECA..IDFAhABAVFFB...QFBAhBFAfGDADEEB.CFFAYFHBhBGANEIA......hCAA...,2,-18,-17,1
PGWfdIFaBTURVceNEDbAQXLgOZCMHYKJS,LAAAZAAAHAEAKBHBSADHGCAAdCCDaAFA.BCFA.RDFA.eAHHhABAEEEB.ABFAQCAAhACA.OCDEMFHBPHAAhABAfDHA.TEEA.cGCAhCAADACA.XGGAhCGA...,2,-22,-9,13
cXULMDTeNWGVEgZSQBRYFfKPIOdHaAJbC,CAAAXAAALACADADA..eAFHGAEBEAHBZCCBQCDA.hAAARCFAFDBBKCGAODABhADAHEFCAAAAJHAAbEDD.UGGBMEIBhAEA...TFFA.WHEA...hAHA......hAIA...,1,-5,-7,2
NJSWaVXZDcCdLPHbYeGAQOBgfUTKMIRFE,QAAABAAAUACAKAEARACAFAFA...EBHFSAGB..hAAAaCDDZCBACCFAdDAAHCFAeDHFhAAAAAIBOEFB.TFCAhBCAMEFBIFCA.WEGDDEHBcGGChCAA....hCFA...,1,-15,-33,18
IRfPWdNBADCEQMYVeFXLacbUSGKHOTJZg,EAAAMAAA..eACALAEAaAFD.UBBAGBGAHCEAOCCBZECAREGB.hAFA..fDAAhAAAdGAAACGAQGEBFDEBbECDTFFAhADA.IHAA.NEIACFBD..hAHA......hAIA...,1,-1,-13,12
ULKCBGEeTSbcNVQDFMgPJIdWRHXOAaYZf,ZAAALAAABADBEAFAeADH...TAFASAHH..bCABhABAVCAAQCEDhACA.MAIBgCFBhABAIEHARDEBHECBACHBaEFHfFAECEHAcFABFGGAhACAdGHAOHBCYHAGhAFA...,1,1,-10,11
UMHaVQRWASfgZKFYTPBdecGOLDNJbXICE,SAAAZAAAFADA..TAGAdADAeAFAGCAALCCA.DBIBhAAAbCCACCGAEDBBHDFBaEEARECBACABhABA.KCHBBEHA.OFABhABAXGAAMFFBWFHHfGCA.hACAgGGAPHEA.hAGA...,2,-8,-3,5
eMXURNHIJEcLYfQADKPWCgFOZbTdGSaVB,KAAACAAAFACAZACB.dAFAGAEA..aAHBeAGBUCAAHCBA.EDGBLDEAhAAA.QECDhACAAAHADBIBPEEBODHDhBEATGFABFFAMEIBXGDC.IHGAhBFA....hBIA...,2,-24,-14,10
AIHUKLXDGdbaBRWYJMgfTEONCZFQPecSV,HAAALAAAGADAaADDBAFARAFAJCAF..MCCB..TBGA.hAAAECAACCGAZDFAQCEDhABAeDDDSFADhACAAAHAKDHBdFAAbFEAgFFA.NIAB.....hADA......hAFA...,1,-3,-13,10
fbGWYPIEAecgdKHVLZRUXJTFNBaSDMOCQ,eAAAdAAAHADAZADBRAFAXAGB..TCGABCBAaBHDDCCBMCFBhAAAQCEA.GDCAhACAPEGBADABKEGALGAAhABAFFABOFFBCHHA.fGHAYDBF..hADA......hAFA...,2,-13,-7,6
HfPWTEJKZDXNCGagbcdReQMBVFIUAYLOS,LAAAHAAA..fADBTAEAEAGEZAFBDCAACAHAGCAB.hABAaCGDbCAARECA..eDHHhAAAMCEBFFABACGASCGAhACA.PDFBKGFANICB.dEAA.QGGAhAEA.BEHA.hACAIHEA.,2,4,6,2
VZNHKfBQLAIPCUGWeEXRgJOYbdacMSFTD,CAAAGAAA.EADARACAOAFAdAGA..aBFBMBGBFCDB..DAIBZCAAHDFAhAAABBHAADAB.UECBeEEBhACA.JHFE..bDGD.hADA..SFEH...NIDB..hBAA......hBCA...,2,-32,-14,18
YUaKcTNLdeOfWEZRMAVgFBSHCJbXPQDIG,FAAAHAAACADA.XADB.QAFAGAEAaAGATCCAdBGAeCCBhADAfCAEZEEA.AAIBBCFDhAAASCHHbDFADEEBhACAIGEAKFFALHBAEGGBMFIBJHFA...hBHA......hCCA...,2,-17,11,28
dBHYKVGJcUfaITRSPMLQZXbONCWFAEgeD,EAAAeAAAdADAHADA.KAGCGAFAUCDB.aAHFRCGB..MCCBZCBAODEDhAAACEED.AAFBBDHAJFAB.hAAA..IFHAhBCATGCALGFAQGFD......hBDA......hBHA...,2,-21,-10,11
PVOaTgQBEMZJICLSUDKfebNRXFAHGWcdY,HAAAGAAAdADA.VAFAaADAQAGA.ECDAZCAA.CCEALDGBhAAADCGBeDBHRDEBACIB..hAAA.cEGDOEEBBDHChACAMEIBSGAAfFAANIBBFGHD..hAGA......hBAA...,2,-16,0,16
IXHMdRSFeJTBADLOCKbNWQaEfZPVUcgGY,LAAAKAAA..bACBQAEA.EAGAZAEBUCAAGAGAhAAAXCDCHDFBREBAeBHFhABABFHAADGBCEEAaGBC..fEHAhACA.cGFAIHHA.MIAAhAIA.....hAEA...,2,-22,-12,10
QKVfMPbAeacZUCFNILRXEHgYDBSGOWdJT,eAAAZAAAFADALAEARAFF.HBCADAIBGCAAdCGATEDA.QFAAhAAAKCDAMCHBACABaDHD.hABACDEB....XFGChABAEEEABFGDSGDAOFHDJHAA...hAFA......hAGA...,1,-3,-26,23
AecDXLVGYENCTRWSBKIgHfFMUZOdaQbPJ,eAAAXAAAGADA.EAFATADA.RAFFBAHBKAHBHCFA.MCCBhAAAZCGBaCDCbEFAADBBLDABhAAAVFAB.CEEASEHHhABAfFEEOHCCdGEA.QGGChABAcGGC.DDDB...hADA...,1,24,-16,40
aTKRLBgDNIXUQMCFbVSJZHAWOEcedfPGY,EAAAeAAAdADAGADA.aAFARAFALBCD.DCFBXBFDhAAAMCHBFEDDbDBB..SEHHhAAAHEFAAAIBOFBHhABAfFAAPFEBTGEABDHAIGHAhBDACFFB......hBFA...,2,-19,-2,17
PbILeEZMBGfXUDWaCdKOQSgJRNATYcVFH,TAAAVAAA..HADB..bACBeAFAEAEAZAGBGCFA.XDAAhAAADBIBaBEEdDEAQFAChADASCCDRFDBABIBFGHBhAFALEGBfCHECGFC.KDDD....hAGA......hCAA...,2,-10,11,21
QOCfKDeZSaJEIUNFdTWXLgPMBHVbGYcRA,QAAACAAADACA.eACAaADE...EAFAUAGAdBHA...TCBAhAAALCDA.MDABhAAAHDEAGECARECBADIBKFGAZEEAhADASGBBIHEAFGGHXGFC.BHDAhBCA.....hAIA...,1,-4,-22,18
YJeLIOgFQcRdaUXEMfHCGVNKADTPSWZBb,TAAASAAA.ZACBBACB.JAEAeAEALAHBOAHDQBDDhAAARCEAaECA.EDEBHEGBhAAAGEFAKFAAAEGBDCCBbFCDhABAIEHA.FGCA......hCAA......hCGA...,2,-18,-6,12
gcLVdHWANGTCOeJSKMXQfBaZbEPDRYFUI,GAAATAAA.eADAKACC.MAHB..QAEAaBFDZCDB.EAGAREGBFDCBhAAAUCCA..gGEAhACALCHBHDFDhAAAAADACFEA.SFDA.BGHADAIB.IHDAhBIA....hCAA...,1,-7,-19,12
AcUNVGHKCIdTaRXDEPFBYLOSJQebZfgMW,UAAAGAAAHADACADAdAFARAGFDCDB..EAHBBCEALCDB.SCFAhAAAeCHHZDABMDGBhADAADAB..VEGBKEEBaFHDhAFAFFBBOFED..bGAA.....hACA......hADA...,1,-14,-18,4
gUFPTeXZGLCOWdJAYbBMQDVIfaEKSHRcN,BAAAMAAADAEA..fACAEAGA.HADBRBBA...gAFBhAAAFBFHeBHFGDDAhBAALAHBODHDdCAAADDBbDFChACAQEBAaEEHSFBAcFGC.PFHBhBFAXGEDZGDE...hDAA...,1,-5,-10,5
fObDMZQgVSPKLBceGYFEXACNdWHIRJUTa,dAAAHAAARADAUAGAaACAOAED..MCCBZAGBQCCC.hACASCHHLDABeDDAhADAGEEAEDGAAAGBCGCAIFFAhAEAfGHAbFCDDFHB.....hAAA......hBIA...,2,-17,-12,5
NXVIZGBdWKYbEfHaQDJeUMOLPSgCTAcFR,RAAAXAAAZADBdAGA.KADA..ECFBHAFB.aAHFQDAA.hAAAeBHHMCDBLEEBhAAASCEDTGBAADAAFDGDhABAIGGAGFABBFFDWHFA.fFHAhADADEIB.OHBE.hABA...,2,-15,-3,12
TUPVSgeOAXcJGdaRWEDYQLBMFIKNZfHCb,XAAAGAAARADAEAGEDADA..LAGBFCDHKCFA.ZBCBHEAC.CCHB.bBEDhAAAUEFA..SCHHhABAeFHHAAAB.dFFA.hACAaGBA...YHFGMIAAIHFAhADANIAB......hAEA...,1,-10,-12,2
DeLIMHUYSKZXAWBOfFPTVcJbgadCRQGNE,OAAAFAAA..TADAVADA...JAFAaAGA..RCCBGCEBhADAEBBBeBGFMEFBHDCASEGAhAIAZDGBAEIBBFDA.fGFEhBAAPFCBgGGACHHADICA...hCAA......hCDA...,1,-12,-14,2
NLaTDZQfSHdCEFIOWGBRMPKAXbcUJgVeY,XAAAUAAA..VADAeADALAGBDAHBZBDE..QDAAhAAAHCBCEDABOCHDGDEARDGBhABAMDFBAADA..cGDChAIAgGCAaGGC.TGFA....hADA......hAIA...,1,0,-15,15
RBXfHAeNICVGPgOZJaQcSMWLUETDYKFbd,eAAACAAAGACAOADCZAEA...aAFAQCACMAIB.LAHBhAAAECCADCFAFDEARCEBXEGAhACAHDGBAAAA.IFAAhAFA.gGAASEEDTGDAKGGD.dGGAhAGA......hBCA...,2,-17,5,22
MIeKaBDPLXcZEfGbCAJOTNYUdSWRQFHgV,TAAAUAAAdADA.RAFA.HACB.MAEAeCEFaAGEDCHBLBEBZDBBGDFAhAFAACABOCGB.SCHBhAAAFFHD.gEDGhACAKGAD.XGGA.EHEE.hAGA......hAIA...,1,7,-27,34
XZWdRaAKEICYcegPGbSFLDBUTQHNMfOJV,EAAACAAA..eACAGACAFAFDLAHBBAEATAGAHCAA..MCBBhAAAOCEBJCEB.ZEGBRDFFACIBKDFBhAAA...IHBAhACAgFGH.bGAADFFB....NIEB..hADA......hBHA...,1,-8,-20,12
GZBYDaXCNKbILSRdWQTJMAEeHVcPFfOgU,HAAAVAAA.FADA.OAFDGADAZBGBDAFA.CAHA.KCADLBFBRCCA.hAAAdCHATEEAADAA.EEHFhACAeDAA..fGGEhAHABFDAaFFAXGGANIAB.SHDAhAAA....hADA...,1,-8,-23,15
BcRQebANfUZJMLPIXFKEVdCaGTgYOSHDW,UAAAZAAAMACALADA..XAEAEAHBdCDAGCFA.TEAAhAEAOAHB.HCCChABABCHDRDFBeEHHAEIBJFCBFFHHhAFACFCAaFFH.SHEGDFFB..WFDH.hAIA......hCAA...,1,-9,-16,7
TNBbEWOfUMIQKZPXRVCGJdaSHFcDAeLgY,eAAALAAA.TAEAbADA...EAGEfAHAUCAA.MCCAhAAAQCDCZCFERDDBGEAAhABAaCFDHDGBDEHBAAEAgGGAhABABGEAIHHAKFFDPHCC.CCHB.hACASGFH.hAEA...,1,1,-2,3
PQYFVbeRGSZDTaCEXNdIcgJUHAMOLfWBK,MAAALAAABADAQAEAFAFA.eAHBRBBBZBFADCAA..aDEAECDBhABA.dDFA..IEEAhAIAgEAAHDGBACHBfEHAhACAKECB.PFEB.YECBhAEA....hAIA...,2,-32,-18,14
NPeJWLGgKCBdYIbcaTHUVFDMAORXQZSfE,RAAAZAAAEADEeACE.LAFBGAFACAHAdAHA....ICCAhAAAaCCCHDFCFCEHACEAQFFChABA.fHBBhBHAPCHDgFAABHHA.bFFB...hCAA......hCBA...,2,-17,-10,7
IBRQDNGJFcfeCTKaSLMbUHPXEWgYAZdOV,dAAAOAAABADARADA.QAFAGAGA.FCBDeBBB.KCFDLBHBhACAMDDBHEABECFB...hADAgEEAADDAZECBDEFBJFABhAFACEHAaGGASFHB...PHDChAIA.....hAEA...,1,-11,-14,3
UePfOCEVKLRZcMNXbaSHWDgdBFYIJAGTQ,GAAATAAA.eADAOACAEAGALCDA.RCGFZEAAMAGBXEEChAAAaAHBHCCA.DBIBdGGAhACAFDBH.IEEAhAAAAADA.QDGD.fFCAhBDA.KFGANEIA....hBFA...,1,-1,-16,15
SBFPOCMEIYZGKHadVTANWJDXRfbLUgQec,JAAARAAALADB.QAFAeADEBAGBOAHFEBDFZBFE.HDEChAIAdCCCAAAADCCB..bDFBUFFBhBAA..SEEBhAFACDHBMEDB.IEHA.KFCAaGHD..hCAA......hCBA...,2,-23,-11,12
QdGMfROWPYIaeFHDKXUESgZLcJVBNTCAb,dAAAGAAARADA.OADA..PAHBaAGDHCDAKCBA.ECHFZCEBLEFAhAAA.VEBATEAAhACAAAIBMGEA.fGBEhACAIEGAeEDDDGIB.SFGAhADA.gGAAhAEA.BHHA.,2,-18,9,27
TLARFQBJCYOEcXeSNMIDagHGVbUZfKWdP,RAAAQAAACADB.EACAeAEH.MAGBaAEDHAGBGCCAUDCAZBGBKEFDhAAAdDGDTFEALFHBhABAAAGBBEBCOFDDSGHBhAAADCIB.........hAHA......hAIA...,2,-17,-7,10
gBWEAZLDbKRFJNXUTVGeQOSIMHcYaPfdC,ZAAALAAAKADCRAFA.FAEA...XAGDTCAAGCEAeBDFQCAAhABASCGAHDFAhACAaDDB.dFCABEGAAAIBbFDDUGAAhABAOFFEMEIB.PHCACHHA...EGGBhACA......hAGA...,2,-8,6,14
eJONSgKMbADXWYTCZcULfdGRaQEVBHIFP,XAAATAAA.ZACBLACBGAEARAGBEAEAHDFBFAGD...eEBAhAAAOBHDSEHBhABAMCEBACFBDDGBCGAA.UEAAaGHH.hAGAQFED.BFHA.IHHAhAAANIAB.KHEA...hAIA...,2,-4,-4,0
dVCeWFHJabfSUIMDQcKRNTgXLBGYEAZOP,ZAAAdAAAeADAHAEAaAGA..SAGAMCABQCCBRCAA.TCFAhABALCEA.GEABhACAACHAODHDCDHAFEEAbDADhACAfFGADEEBKFFANHEB.BGCA.EHAE.WFHHhADA.....hADA...,1,-2,-6,4
YZMPaKXeQbSIBDRFCdHTWgcfAUNLOJEVG,LAAAEAAAGACAZADBMAEAaAFD...eAHFQCAA.SAHBhABADBEARCEBdEHAHGCAhAAATCGAgGFBhBCAADFBOEEBVFBB.KFGA.bGFC....hACA......hBFA...,2,-6,-3,3
TFLKIfRbdBEQcPgJSXMDYZaGUCeHAVOWN,OAAATAAA.LAEAKACC.RBBABBHAEAEAQAGA..hAAAgCEAXCCAMCFBhBIAZDGBGFABeCGBHEFBhCAAAAFANEIAFGEDIHHA.....hAIA......hBAA...,2,-18,0,18
aIJcCMdfHGPBDXFTWRELbSAKQZVNYUOge,ZAAAVAAAUAEA..eADEaAGE...IAHACCAA..dCHAHBDAhAAAGDABDCHBTDEAhAGAEDFALFDAACIBKEHBQGDAhCAAOFHB.gGGBMHAA..hDAA......hDBA...,2,-21,-15,6
GeBDZQXVdRJUWKFNYSOfTPbAcMgELaHIC,MAAAEAAAHACAGACBeAEEZAGB..QCCBdCCAREDAUFAAFBHD.SCEHhAAATFGAABBB.LEGBhAHACDHA.XGCAhAIA.WFFDKGEANIBB......hAFA......hAGA...,2,-18,4,22
fBeVPgRScdHNGWCOUIZQMYTLDbaKJEFXA,eAAAVAAA.RADA..dAGAHADBGCCAOAFAZCFA.MBGBLEAB.hAAAaEFAEBHF.ADAABDDDhADASFFBNDFA.CFHAIHHAhAAATEGAKFBA.XGGA...hABA......hAEA...,2,-15,-8,7
RKDCIFOBTLbaUYNGQZgAEJSfVPeMWHdcX,EAAASAAA..fACAeACHHAEAdAEARCEACAHBOAGBLCHBhAAAaAHDUDCAGEAAZDGBhAAAADDBPEEBMEBBXEEBhAHADGGABECD.YHEGNEIA....hABA......hAEA...,2,-6,-4,2
SVZgJQCXUcfLFeKRPGAIOWYNHTEMdaBDb,OAAA..YAAAHADAEAGE.aBBCDACA...SAEAhAFAZCDEQDGAXAGDhAIAfEEAeCCARDEAACCAhBIAIFAATFDAdDHAbFCDgFGGhAFACGFA......hAIA...,2,-13,-13,0
fMFcVZBIEGUDNSeaTPYbQRAdgLWHOCJKX,dAAALAAAHADACAGBXADDFBHD..ZABBEAFAGCEADAIB.eDCFhAFAaBGD....TCAAhABAbEGDAEIB.ODDB.hAIAfDHAcGCB.BEFA.IFAAhACA.SFDHhAFA.QGGA,2,-18,-5,13
QDNZHXCBKUfSaGdgEbVAIcLFOeMJPRYWT,LAAAeAAAMAEARADF....TAGAQBCAZCAAHCEBBAHAfCGEhABAGBEBEDEFAAFAFEHDhACAODGD.PFBBhAAADFGBCHHA.SFFD.aGEH...hAIA......hCBA...,2,-14,-5,9
TFEVKHWBMaUAPegLJCZcYRdGNfISQXODb,eAAALAAAZADBRAFAGADA...fAFBQCFBDAIBbDBChAAAECAAHEFCBCFAaFECACHBJDHBhABACBCA..dGAASDDDhACA.TFBAKGHBMICAPFED.hABAgGGA.hAGAYHAA.,1,6,-7,13
QBVELTgdNHeRGMXDAafPcUZFSKbOIJWCY,aAAA..fAAAUADAZAFB.KADA.OAFAJAHB..CBBDBDBAhBAAEBCBTBFA.dDAAHDDAhBDARCDFGDGAMDIBAEHBFFEDhAAA.SGGD..bFBB.IFFAhBFA....hCAA...,2,-33,-2,31
YIEfDBPgbUMOdWeJVHXTKaZcAQGCRSFNL,GAAARAAAFADALAGBEADABAFA.....bAGDMAIB.dCCAeCDAhAAAHECCTECAZFGBAAAAQGBAhBGASDADIEGAhACADFGB.gFFG.WFHHhADA.....hCAA...,1,-4,-20,16
fbCPOcIGWZBFQDJeTLgSHKXRdMENUaYVA,CAAAOAAAGACAZADBFAEADAGA....eAGHTBFALCAB.hBAAHCEBRDBBECHFaBHDABBB..hAAA.bEBDIEEAhBDABEGAQGGASEGA.dGEAMIAAUGGA.hACAfHBB.hAIA...,1,-4,-13,9
VEWDZfaYbXSBTdeMPQUKLRCNgGAFJIcOH,FAAAJAAA.OACDHADBEAFAZAEA....aAGAXBGA.TDAAhADAeCDHMCFB.QCGBhAFALDDARDGFCEGD.hBAAGFABAEIB.IHHAcGGA.DFDA.YHBGhAFA...hCAA...,2,-32,3,35
VHdbTYaRDPQKWFAIGSMgUNZEJCOLXfBec,GAAAMAAAUAEAEADAOAFCLAHB.BBBAeCDAHDBAdCHATECAhAAARDFBDBDB..KFDAAAHASDADhACAZGBA.XEEBhADAfFHAbGDA.......hBAA......hBCA...,1,-8,-21,13
NfCGKPdFIWHYZBcLEXQRAUOaMVgbDeJST,aAAAMAAA...VADADADAeAEA.SAHHTBBA.CBBDGCDAhBAAdAGAFCHDHDDA.hBDAZFDALCFBEFHB.hAIARFGBACDB.ODHF.JHBANIBB.....hBAA......hBBA...,1,-11,-14,3
ERTMXZLKeAQCgJPcYWHVGBSDfdbOaNUIF,QAAACAAA.JACEPACA......cAEDhAAAHAFAGCBADAHBdCGDaCDChAIAICHAREEA.MDDAhAAALEHBAAHAgEEA.YEHBhBCABGGC.bFCDNIBB.EHEE..hCAA...,1,-15,-24,9
gcLFeZAMaEJRIHUQVWXTKOGNfbDPdYSCB,EAAARAAAHADBUADAQAFA..XAFATDAAGDDBhAAA.bFAAdBCC.CCFABCHAhAAALFGBeDEBAAIBaGDDhABAIEGAKCHB.fFHADFIB.SGAAhAGA...hADA...,2,-33,9,42
VaTIGPfdZSMYNWRAeQbEBDgUCKLHOXcFJ,eAAAEAAADADACADA..HAEBOAEEFAGA...aAHDGCCA.dCHAZBCAhAAAMEFB..YCFBhAHARGBEAAAAQGGAhBGABDBAKDDBXEGCVFGBIDHA...hCAA......hCBA...,1,-6,-24,18
RJaFEfQDYbLHTZcMUVAPegOCdXWGSIKNB,eAAACAAAdACAGAEAKADARAFF..FBHDEAGA.DBIBLCCB.HEDBhAAAZCBAMCHBAAHA.ODFDhAAASFABBEAAaEBDhAEAQFFC.YHFGbGAA.cCEChABAPFHD....hAGA...,1,-11,-21,10
cEZVOGYeLHCJgQFafWAdKTIPMbDXUNSBR,dAAATAAAMADA.DAHBUACA.BAEAEBDAZCCAGAFALCFBHDDBCAHAhAAAQFGAFCHD.hAHAaBHDADDBKFGA.bGFCSDBDhACA.RGBAOHEC...hCAA......hDAA...,1,-6,-17,11
QBIDHdEAJaSOReLXFUCYGNWbZfMPVcgTK,aAAARAAAeADELADA.FAHBCAGBGBDA..bBBCZCFB.MAIBhAAAVCEA..TFCAhABAQEAADCCBHFGBAAEAOCHDhBAA.XEEC.UGGA.NDDA.hCAAfHDF.hDAA...,1,-5,-11,6
TXFeOEKIgUMWLJdRcSZPCaBAQDGNfYVbH,GAAA..fAAAbADA.HADATCDAeAFEKAHBgCAAhAAAMCHBLEAAhAAARCEAZEEAaCHDAADAQFEAhACADDDBVGEAOFCBEGDBIHAA.UGGA.hACA......hADA...,1,9,-1,10
VWPSCbeOBJgaKdGLMNDFIXcHUYTfAZRQE,RAAAEAAA..VAEASACA.eAEHBAHBaAGAGCCALBGBhAAAMCHBFCCB..XDABhAAAHDABTEEAACIBZEFFQGDAhABACEHAbGCC.OEAHKGGADIDA..hADA......hCAA...,2,-11,3,14
fKHGNDMICZecPXQYVABJRETLSFdOaUWbg,RAAAEAAALADBdADA.OAFAaAFA..UBGB..bBEDKCBAHCGDhAAAGCEAMCCBZEGBeEHHhABAXFBAQGBAhBGAABCABHDASFFB..WFHH..hAAA......hAIA...,1,6,-26,32
VfaBNGSdJEbYMFIcKQgTCRDLOZPWUAHXe,HAAAeAAA.aACAGADAdAFA.EAFAMAHBFAHDKCCDQCCA.TDFAhAAARCFBLDHBZFBAPFFBhAIAAAAAfFAAhAFA.SEFDYDHBIHHACHFA.hBDADIBA.....hCAA...,1,10,-15,25
gFfALXGWRMJaSVQYCOIbZdDcTPUNeHBEK,GAAARAAAMADA.aADA..QAGAOAFDZBGBdBEADCDB..TDCAhAAAUECBHFEBECGBFEFBAAABLHAAhACAJEHB.SGGBhAHACCCC........hAIA......hBCA...,1,-11,-20,9
FcgYECWdPAfMBOUVTLZRNaJeISHQXGKDb,MAAAOAAAUAEALAEAZAGB.RBBA..aAHDeBBA.HDDAGCEAhAFADBIBFEGD..gCGGhAGAEFDBdGBAABBABGHAhBAATGFA.JEDFSFFD....hBGA......hCAA...,2,-16,-11,5
NVILXYJKQPcWbafeEACdZOTHSBGDFUgMR,ZAAAHAAAGAEAFADAMAGBRAGB....ICAALAHB.XCAAhAAAKCCDQDGBhABA..cDCDaDEHEEABhACAABHBdEFATGFADEHBgFCAYGAG.WEHHhACA.....hADA...,2,-16,-12,4
TRGZNMISaKEgcJdAYeHPBFCDfLbWUXOVQ,HAAAFAAADADALADB.UAFAOAEETDEARBCBZBFE..MAIBhAAAaDFD.ECAB..JDHBACCAeDGHhACABECD.CFBAbGDC.hAHA.XFEC.......hBFA......hBHA...,1,-8,-41,33
YXfKgGETHNRMFcQbIBeZJCDaUPdSOWAVL,LAAAXAAAKADAEAEAHAGB.RCAAMCEBQAFC.bCDCeCFBhABA.ZEAADAIBaDHDdDAAhAAAOFECACHB.fGBAhACAGECBTFGAFGHDBHEACDHASGEHhABA.YHAAhADA...,1,11,-18,29
GgecOdKCFaSDLPBIQAVMZWRTXUJHbEYfN,ZAAARAAAUADAHAEA.EBHF....fAFFGCAAeCCBdBHAFCCHhAAAaCFDLEEABCFAAEEAMEGBhABATGGA.bGAANEHA.hAIA...OHCA......hCAA......hCHA...,1,4,-28,32
cLVSfbAaPMCWONIEUQdTRBGHYZFgJDXKe,aAAAMAAA..OACDEADAdAGARAEA.HBBAZCEAFEAADAIBKCEA..eDHHhAEALDHB.fDDEhBAAAAHACBHA.IEGAhBBATEEAGGCB.YFAFXFBAhBFASBBDbFED.hBGA...,1,-11,-18,7
PJSCdaRGIgXQUbLEYcOABFTNKDVWfHeZM,TAAADAAA..VACAHACBZAFBMAEA.SAGAaAHD.RBEFGCGAhAAAXCCCbEBAEDGAhAFAOCABABBB.FFFBKEEAhBAAfGDEeEHFCFCAdHBBIHHA..hACA......hBEA...,1,5,-21,26
DBgdWCafScHLPTMARZEYVNXeGIKbOJFQU,EAAAVAAA..eACAGADAKAFA..OAHDQAFABCCAdCEAaBHD.hAAASCGDHDAATDFAhADARDABZEDAXFAAhAFA.bFDBFEHDDFHBCHAALHDAAFIB.IHHAhAAA....hADA...,2,-13,11,24
PCbRWfgMYSFaOIHVGcZeQXNEJDBdKUTAL,LAAACAAARACA...fAEAMAFAFBFD.aAFDHCAA.GCGAhAAAeAHBQCAAhABAEDEBBBHBdECATDDAAACA.hCAAbCGDgGFBOEABIGDA.ZFFAhACA.NIAB.DFIB...hAEA...,1,-1,-11,10
fPNUZIVKOWcdgaQAETLSeBRXJCDMHGbYF,EAAATAAALADA.eAGHRACFCAEBHAFBGCBAFAHF...fCAEhAAAPCHDZDDBKCEDOEABhAAAdDHAQEFAhACAAAIBXFEDMFEB..YHFGIHHA.hAEA......hAFA...,2,-9,-1,8
bDREZgFYSCWGKIABHOPNcdMQeXLUaTJVf,HAAAOAAA..PADAdAEAeAGBLAHBaAHF.JBFB..bBCDECABhAAA.ZCCBFBBH.CCFAGEDBhBAAABHBBEEDMEGB.hBEA.QGEB.XDGA.hACA......hCCA...,2,-22,-5,17
EHGNdcVCOBLbMXDfeJZKWPQTFSIagYRAU,HAAAdAAACADALAFAMACADAGA..eBDAZABBKCEAQBGA.TDDAhAAASCGB.hBEAaDCDRDFFEEHFGEEAcFDChCAABEHA.XGAAfGHA...hAGA......hAHA...,1,5,-30,35
GSQgDATCeRMKHUVaOfJFPZcdLEBNIbXWY,eAAARAAAHADBUAEAOAFAFAGE.ZBFFLBDDBBHA....bDAAXCFAhAAAGEEASDHBhAAAQEFCACCBCGHA.MCIBhABAaHGC...fGHA...hABA......hADA...,2,-21,-11,10
FgZcWSKbTQCNLBdMOPURGIEJHDfaeYVAX,FAAAZAAASACEKADA..TAGAQAFALCCAdBHAMCCBhABAOCFDRDDAEEGAHDAAaFABhAFAeCHFADDA.XECAhADAgFFGbFACBFFDPFCDIGHADFIB.hAIA......hCAA...,1,-2,-5,3
DecHZCdWOGRTFIESbPaXKLNJVUABMYgQf,MAAAQAAADAEAHAFCdADAGAFA.RDBAFAHFEBBASBDHhAIA.aCEDLDHBhAAAVDGBACGBBDCDfEFEhAFAeFFBCHHATFDA.IHFA.PFBBhBCA....hBDA...,2,-15,-11,4
ObQJHATLSfUadFMecCPRGKgVINYEXZBDW,TAAALAAA.SADHaACA.dAFAeAEHCAHA.RAGBGCCAhAAAKCAA.IEFAECGAZDDADDIBhABAbEGDHFDBAEHBFFBAMFFBhACAgGAA..YFDBBCFAODBHhAGAQGGA.fHABhAHA,1,1,-11,12
BZGHdKSEMULRPXQCabNTDfgeAWIJOFVcY,JAAAFAAA....VADABADBHAGBdAFAEAHBMCCB..RCCA...QDDAhADAaCGD.bDFAhAGATEEADFGB.eDHHhAIAAAIBOFHBZFBAKGGDSGDA...hBAA......hBFA...,2,-29,-10,19
dZCYePJSTcKNVEUMIOLFGRWbgBDAafHXQ,HAAAdAAAZABBeACE.SAFBTADAKAFCEAHB.UCCAMAIBLDFAhAAARCEA..bDCDDFCAhAIA.ACHBaFFAQEEBhBAACGDA.PEHBcGGCIHBA..hBHA......hCDA...,1,-3,-17,14
BEORHfMVWdNXaZGLeJITbDKAYScgQPCFU,SAAAQAAAFACEEADA.HAEB.MAHBdAGAaBDEGDCALDAAhAAAeCHHJFEBTDFAKGAAAAGBhAAAgFDAUGGA.hAIAOBHD.fFHA.NIABIGBAhABADEEA.YHFAhADA.,2,-21,2,23
QOdcbJSZVHENTaeFPRfIWUCYXgALMKDBG,MAAABAAAGACAdAEA.JAEAZAFB.HBBBEBHF.aAHD.FDEHRCAB...hAAA.ICFACDGA.hBAA.XEBAAACBLEEAhAHAQFGAbGEANDIA.eHBA.fGFEhBBA....hBDA...,1,-16,-18,2
JLfOVdXFKTISYDPeZcGQWEAHRbNaMBCgU,HAAARAAA.aACAMADACAFA.UBEALAHB.OCCAdAHAKCCBTDEAhAAASDFA.DDIBhAAAeDDDGECBEBGFAEHABFGAhABAfFAAFGCBIHHAZFGB....hBHA......hCAA...,1,1,-26,27
ALRCEZNaUOFbVWSJdgcXGeMfBPDIQYKTH,RAAAEAAAZADBUADAFAFD.....VAFASAHBdBCC..XCGAhAAAeBGHMCCBBDEADDABhAAAQEFAKDEBHEGBADIBhABALFHBaGFH.OEDBbDAD....hAIA......hCAA...,1,-7,-20,13
YHMGSeTaLQOcdfAWgNRFZCPXVbBIUKEDJ,...NAAA.RAAAZADB.XAFABAFAKAHBDAIBHBBA.GCEAeCCDaCFBhAAALCGB.QDBBhABAdDAAADGAFDHDCEEDbFAAhACAEFGBMDIB.TGGAfGAA.gGEBhABAIHAA..hADA...,2,-23,-1,22
fcUDHJTZNXQVOaEbgdAPLGCeBKSMWIYFR,GAAAeAAAKADAMADA....IAGARAFAfCDADAIBHCCAhAAAZCFAQEBDhAAAaCEA.EEEAdDHAACHALFGBhACASEEAFHEGcFAA.TGGA.hAIA......hBAA...,1,-3,-21,18
eIUMTNJQFZYEPBgDHSafOdLcKXAGVbCWR,GAAACAAARACA.eADAMAFAJAGB..ZBEEECDABCAAHDEA..aBHDdDHAhAAA.LEAAKCCDAACA.hAAAbGFAUEEA..NIAB.hACAQGBA.FEHB.....hADA......hAEA...,1,-3,-31,28
OGSDgCXLeZVRMBJIHaKEPbfFdWNAUYTcQ,TAAAQAAA.GACBDACACAEA.eAFERAFFBAHBHCDC.ECGE.bDABhAAAdCCA.ACHAUDFBOEEBhADA.XFGAZGFAMDBBhAAAaGEDKEDB..........hBDA......hCAA...,2,-32,17,49
SYZCJaTOQRHEBgcUAXFPeVLNdIWMKfbGD,FAAAeAAALADAdAEAMAGBKAHB.GCCADAHBZBAE..aCFAQDDAhAAAHEABEDHF.BCHAUFEAhAEAAAIBXEBC.hAFAVEGBIHHA.WHAASGEBhABA......hBEA...,1,-8,-20,12
VFTPZMDRdIYHaLKObGNCEQWXeUgBcSfAJ,FAAAZAAARAEAdADAHCAALAFAOAHDGCDB.EDBBQCEBhABA.eDGFBCHBfEAEhACAAAGATEFAMEEBhBAADEEBaEHDKFHBCHAA..WFFDXGCD...hADA......hAEA...,2,-17,-10,7
XJDbZCMaBFcQeTLOSUgWYfdVAGPKRIHNE,GAAARAAAHADBEAFADADAZADE..aAHDFAHBeCCBLCEBUDGA...hAAA..gCGAhAAAfDAAADDAKEHBXEEBhABACFGDMGCAQFAA.TGGA.hACASFDH.hBAA...,2,-28,13,41
FUYaRLCOZdSJTGHfQgcXNIMBeDEVbAPWK,KAAAFAAAUADARACFLAEBZAFB..dBHA..TAGAHDBAQEFAhAIA..XCAChAAAMEIBeFBAECGBACIBPHCAhBAAaECASEGA.GGABfHFFhBDAgFFG.hBFA...,1,-12,-13,1
gAeaXYbZEHPOCJIcKGRTfUDMSVdWBNFLQ,eAAAaAAA...XADAZACBHAEA.CAHBJCEFKAGARCCA.UCGADBBB.MEABhAAAdCGABEHA.LGAAhAGAACCAEEEBOFHBhABA.IGDATGFASGDHNIAB.hAEA.FGFD....hAGA...,1,-13,-22,9
GEaJVPBMWYgLCceATQKUOHXbDIRSZNfdF,TAAAQAAA.OACCHACBDAEA.RAFAZCEEdAFAEAHB.aCDBPCABhAAAMCHB...gDGAhACALDFBeEABhAAAAEFBXEBAbEDDSGHBFFHD...hAIA......hBEA...,2,-10,-2,8
RSIDeKdVbALcEOHFXfTWaJQMZCBPGNUYg,EAAAHAAAFACDTAEA..aAEAMAHBZAGBBBEAGCAB.UDGBRDDADBIBhAAAeDEF.dEAAADDALEBBhBEAXFFAfECAhAAAQEGACFFDNIABSGHH.KGCAhACAcGCD...hADA...,2,-23,7,30
DGYMITbRAeaJKNUEfQPWVdLgcOBSZFCHX,eAAAaAAA.KADAEADA..QAFC..PAFCdAHALCCBhAAAOBBBZCDAHDGBGDGAhADAMCEBbFEDACEAUGCAhAIAfGDAgEEDSGGACCHBDGIB..hABA......hCAA...,2,-10,-6,4
GSUXCAQbceWLYfMENFgDHRZTVOJIKPaBd,QAAAeAAALAEAMADAEBCF..FAGDHCEARBDBZDBBTECA.hAAAOAHDKCHBaDFDGEGAhAAAXEGDAAFAbGCA..hABA..cFCD.......hCAA......hCBA...,2,-17,1,18
WcCNGfJZVEIdPTBaMOgHeLSbYAKUXDQRF,XAAARAAAFADA..CAGAGCCAZACBEAEAdAHABBHA..aBEE.MDEAhAAAHCFALEEASEFAhAAAADIBDFIBQGAAhABA.NEIA.fGEAIGGAOFEBhAGAgGGD....hABA...,2,-22,-9,13
AHRfaLNGZWMEYbJcPXQIOKDVBTSeUCgFd,HAAARAAALADBZADBEAFA..JAFA..XBFAQCFAKCADBCCChAAAeCCDUFCBFDEDAAIBaCHDhACA..NCIA.GGDBhADAMFBB....bFEDcEGC..IGGAhAAA....hABA...,1,-7,-21,14
RPXcJfYZgHFMOTSAKCbWEDVaGBNeIdULQ,CAAAEAAADACAGACA.eAEAdAFALAHB.RBCB.XBFAhAAA.fCBEhAEAZDFAHEBAMFFBTDFAABEAKCBDhAAAbEDDaFAABGDAUGGAQGGA...hAFA......hAIA...,2,-22,-3,19
FXADeBWgKSaGMcIEQYLRUbTOHCJNfZVdP,eAAABAAAKACAGADA.MAFAEAEELAGB.RCAA.bBFBHCEBhAAACBHAJCCFZECF.dFGAXDGDhAAAAAIBDCIB..SGCDhACAaDBHQFDA.TGGAOHEC.hABA......hBDA...,1,-10,-14,4
dBJDaXRACbOELYTgQSFZPfUHWGcKIeNMV,OAAAEAAALADA..TADAQBGAZAFBUDCAHCBAGCGAhAFAKCFDeEABMAIBdEEDDBBBhBAARECBAAHACEEB.bFGD.SEHBhAAAfGFA.IHBA.BHHAhBHA......hCAA...,2,-21,11,32
ZFUBGRMXCJPNIdHfcbeWTaLDYKgSVOEAQ,ZAAABAAARAEA.MACACAHB...JAFB..ICAAHBCB..bAGDeCCBhABA...aCECLCBDhAAAKCGC.SEEAhAIAEDHFAAEAQEEAGEGANIBBdGHA...hBCA......hBEA...,2,-23,-22,1
LRKEBHGPNMacdgSfUXOZeAFYDCbIWTVJQ,DAAACAAA....IACATACA..QAECRADFBAFBHAGBGAGAhAGAMCCBdDDA.fBBEhAIAODDBAAIBbEFAVFEAhBAA.KEHB.EGDBaFDD.SGEH.hBIAXGGC..hAAA...,1,-5,-32,27
YUagBHLVIMOTFXDQKZSNAEefcPbGCWRdJ,EAAAeAAA....fACAbADAGBGARADFdAFAUCCABAHAHEAALCHBhAAAMEFBFFDDQDDBhAHASAHBADGACEGC.hAAAJFFFaGFD.IHHA.....hCAA......hCBA...,2,-21,6,27
bAGHIEBRQNUCPJcgKMWOZLaTeVSFdXfYD,HAAAEAAARACA.QADC.CAFB.PAFAJAHBKCADMBIB.ZCCAaCCChAAAeCEEFCFB.dDAAXDGAhACADEEBAEHBGGEB.hAHABFFCcEECOHCCLHFA...hAAA......hADA...,1,-6,-8,2
eFdVQGObBLTSXWAPUCNKaJIcZfMYgHDER,CAAAaAAA..JACAZACB.MAFAHAFB.RCBA.eBEAdBHAGDEABBBDLCHBhBAA..TFAAhAAAXDEAAAHAUEGAKEBAfFDAhBEADIFA.EFFBQECAhAFASHDA.....hBCA...,2,-16,-13,3
EQVXPefLgOFNJbKCMDUHaZWBISdRYGAcT,EAAAQAAA..XACAeACALAGBFAFAJBFF.CBEAMAIBhAAAHCCBZCGBBCDDdDAARDAAABGBTFEAhAAA..fDFEhADAOEHD.bEGDDIAAaEEH.....hADA......hAIA...,2,-15,-10,5
HcdQYbaXJSKOMVEIWReCTGNAFBZgfPUDL,ZAAA..fAAADACAHAEAdAHAQADAaCCC.SAFAhAAAMCGBEDEF.RCAAeAHHGECAhABAACGBBDEAUFFB.LEDAhACA.bEGDKGAAOGAAWEHB.NIDB...hADA......hAGA...,2,-9,-2,7
YBLJGPaQFDUfNEedgRbWZSAIVOXCcKTMH,OAAACAAAKACA.HADALAEBGAGA.aBBCQAGADCFB.UCAAhAAAEDDBeDFHRCFF.ZFAAhAFAACDA.XGGAMDDBBDHAhACA.FEEHfEHAdFHA..bGAC.hAGASGGD.hAIA...,1,-6,-13,7
JMPbKRQINfeODYdFHCTXZcaAVSgBLGEUW,SAAALAAAEAEAUADA..MAHBKAFARCEAQCAA.hAAAfBFAeCCBDAIBdEEDhABAHCDBTFGAZEAAAAIBBDHAhABAJDBF.bFFAOHAACEGDaGDD.....hACA......hAEA...,2,-19,-1,18
fCQdWTNJOLPIYADGUXSgMVRHeKEbaFBcZ,GAAASAAAMADAHACBEAGA.FAEAZBFAQBGAdCDA.TCEAhAAAODBDLEBAhABAIDFAAAHAXEGAhBEARDGFeFFBaFHDfFFE.CGEDNICB....hCAA......hCBA...,2,-5,-3,2
XICQJTfdgbFWSaUEZeAHRVPYGDcMNOBKL,HAAARAAA.VAEAGADADACA.MAFABAHBLBFB.CBHAQDAAhAAATCCAdCHAbDFBSDDDhABA.EDHBAECBPEEBhAAA.YFHBOFDEXGFAhADA.fHBBhBHA..,2,-26,-1,25
cTNJRDCSKIBLGAfOaFdMQegEXbVZHWPYU,aAAAdAAAeADA.EAGAXACD.ZAEAHCAC.PBHDUCGBTDDAhAFARCFBCDED.KEGALEAAhACAAAGAFFCB.MFFBhADAbFFC....YBBFcFCDDGGABHHA.hAEA......hBAA...,2,-14,-9,5
GfTQJBZNbWEKYRaAeIOSMUCVLPXdcFHDg,eAAASAAAMAEAUBDALADA.dAHAHBFAGCCATDGAQCFChAAAZDCA.bEADEFGBhAAAREFA.AAIBCHBA..XFDDhABADFIB.fGHANIDB....hAEA......hAFA...,2,-10,-5,5
QeaPNbGXdWICLJKZgAYORVfHDUSFBETcM,RAAAHAAADADA.FADABAFAEAGA...MAHBeBHF.aCAC...bCCBdCCAhAAA.CBEDLDFAhABAZCEBADGBODHDUFFA.TGCAhAIAQGAA.PFGB....hAAA......hACA...,2,-36,-4,32
aTEOLAKcVfSZPHeYURgdIMBQbWNXCJDFG,KAAAVAAAZACB.HAEAeADERCAB..dAHAMAHBBCFAQBDD.hAAA.bDEAXCFDhAAA.DAIBaECDEEDBADIBSFFBhACAPEHDUGAAgGABIFFACHHDFFHDhAGA......hCAA...,2,-15,0,15
fEdeYCDIARKbHXcZJGSMPFaOVTQLWBUNg,RAAAHAAAZADBGAFAMACAaAEE..OAHF.QDAALAHBBBGAhAAAUEFB.fCCAhCAAEFDBeFHHDGGBACFBbDECJHAAhAAAFECD.TFFA.NEIAdHFD.CGDA...hCCA......hCEA...,2,-3,-1,2
ZNDBgUaPfYVAHRQTOKJMCIFLXGbdSceWE,HAAARAAAQADCTAEAKAGC..MAFAFBHDGCABdBGAeCCBECFFZCEBhAAABEAAaCHD..fEGEhABAAACACECALEEASFHHhBIAcFGDDGEA.......hCAA......hDAA...,1,-6,-13,7
LNaFDOCHRGYVJSAUdZeTfWQgEMKbXPcBI,ZAAAeAAA..TAEAQADAEAGE.MAGBXCAABAHALCCBhAAAaCFD.OCGDhABAHDDBRDGFGEDAVEABAACAdFFAhAHAfGGEKFBD.PHCAIHHADFIB.hABA......hAEA...,1,0,-5,5
BEUZOLJeTQPdagFXCDRAYHGMSKfVcNWbI,HAAAGAAAMACAKADA...VAFA..cAFA..bBDDECDAhAAAZCFALAHBeCCFTEFAhAAAdDFAaDAHFFHDDDCBAHEASHEAhAIAfEHAIGCA.OEEHhACA.QGGBhADA.,1,4,-16,20
MKZLXDaVUHRGBNJYbEQgTAOWdeSPcFfIC,dAAAeAAASADAFADD..CAFAZAGBLAGBDBIB.aBEEHCEBRCAAGDCBhACABCCDJEDFEDHFTFFAhADAAAAA..OFABhAFAcEACMEIB.KFGB......hCAA......hCBA...,1,-2,-28,26
abdEVUGJWKBONQcXZSTPLIRFAMCgfYeDH,MAAACAAA....fACAeACAHAFAdAEAEBBBGAGAKCEAOCGDhAHAQCACZECATGFAhAIALDDA.REBBAAGBDCIBhBAAbEFA...........hCAA......hCDA...,2,-16,-13,3
DWCMYAgXUNJHTKORZIaQPecfEbBFVSGLd,XAAAUAAAHADAKADARAGFZCDA..QAFCeCHH.EBHFbDABFCDBhAAA.GDAAdEEACFCAAAFAgDFBhABA.TFEAhADAaFHD..fGFASEHHDIAAMIAAhAHA.....hADA...,1,6,-17,23
HUGSaLETPINWZeJXQfgDFcdBMAKCRVOYb,RAAAOAAAHADBGAGALAEAECCB..TBCAIAFAZBFEeBBDhAFAQDACDDEB.dDFAADGACDHAhAGAbFEAUFFA.aGEBWFHHhAAA...........hAIA......hBAA...,1,5,-21,26
JgdCVANeEZWPIRYbQKHcFLTMOfGaXSUDB,EAAAZAAA....IAEARACAQAFCHAFBLAHBMAIBGCCBhAAAaCAAUDDABDAAdEFAADAAeECDhABAPDHBKEGATGEAhACAfGHA.DHAACGGB.WHAAYHBA.hADA......hAHA...,2,-14,1,15
XZaDKEgVGLNCWeBdfPMYJQcURTAbIOSFH,OAAAHAAAaACAKADAEAFAGAFA..LBHBCAHABBBD.dCCAMCDBhAFAQCFB.RECAAFAAhAAAbDGDFFGAZEDBDGCB.gGGGhAFANECA..eFFD....hAHA......hBAA...,2,-25,3,28
NRfYWTEBHALgFJcZOGbXMeDVPUCSQdIKa,LAAAFAAAZACBGAEAMAEADAIBUBGA..QBDAdEBAKEDA.RBFB.hABA....fEGAhAGATCAAHEEAAAHA.hBAAgGGAOEHDeGEGCDDDaHBA..NICB..hACA......hBHA...,1,-15,-17,2
AOfVbRXCTHSUWcDEgaFLGQJNeBIYMPdKZ,OAAAVAAA.RADA.CADB.HAGB.UCDBDAFAEAHFFBBH..GDFA.hAAAQEAAeBDABCFAhCAAMDIBdDDAACIB.bDGDSEEDhAEA.gGAGaFEDNIEB.IHEAhAGA.KHGA.hDAA...,1,9,-33,42
YPLHISWNfaJFdgceVXUZKBMTDCGEAQbRO,RAAAOAAALADBHADA.SAFE..fAFAhAAAaAHDdCCAeCFBXAGDZDGBMBBBhBAATDEAGEDAAAIBbDGBhABAIHHAJDCF.FGCHgFAB.hCAAcGFA...hCGA...,2,-10,3,13
bFdLVGgeWOYDIRHZQMXJPEBUKaCTcSNAf,FAAAdAAAGADAeACH.OAFADAEAHAFCZABB.MBEB..XBFDhBAAECFBKCHB.aCHD.TEFAhBDASDDD.AEHBbFEDhAIALFBA.WFHHIGCAJHCABHGChBFACGGA......hBIA...,2,-16,-8,8
JFAdKSCZeaXOIWHbQGNgEDcYLUfTBRVMP,dAAACAAAZACAeADA.OAGDHAGBGCCA.EDAADAIBLEFAhAAATCBARDEAMADAFDAHACFBaFDD.hACA..XGBDhAIAIFGAQGGA..gGBAhADA.cEDC.hBGAfGHABHEA,2,-19,8,27
APKJdCYZSIFGODXRWaeBMVNQUTEcHLbfg,KAAAdAAAZABBFACAGAEADAEA..RAFA.eAGBMBEBQCCC.hAIAEDGBHCFCLFFAhAAAbDCDAEFA.CAHB...SEHHhBAAIHHAWEEDaFFBBGGD..NICB..hBDA......hCDA...,1,-9,-26,17
aQVXJTHGNMZbSPBIWYCODcLgEfdURFKeA,aAAAQAAA.JACEHACB.GAEBZAFBSAHHBCEAICHAhAEACBEA.DBBBLDCBhAAAEDFFdEHARFAAeDHBAAHATGFAhAFAbEDD..PFGBOEEHfHBBhBHA.....hBAA...,2,-10,-7,3
bBEOPWIDVXGJYZaeUSHFdTRNACgLfKcQM,LAAAKAAAMACABAFAEAEA..OAGD..IAHAXCAAhABAGBCAZDCBeCFBHCEBhAAAdEAARCGBABEBfDHAhACAQFGBbEEDDGCA........hCAA......hCBA...,1,-1,-24,23
LYVJTCMZEPBNHFIeDUfXdRabWGAKScQgO,SAAAQAAALADA.VBGBTADAZCBE.EAFEBAHBhAAAHCCAeCEHfBHAhAAAREAAaEGC.GCFAAAEAKFFD.hBCAODABCGHAMIEAFEEH.DDIB.dFCA.WFHDhABA.YHAA.hCAA...,1,9,-5,14
ZDILUKWGBFgCdfMRNTbJaAOcQEHVXYPeS,QAAAHAAAXADBeACAZAFBLAGBKAHBGCABFBEDdDAARCGF.TDCAhAAAaEEBABFB..EFFBPDHDhADADEIB.UFEABHGAhAAAfGBA.MICA....hAIA......hBGA...,1,-3,-7,4
PaDfJBVNMgYOHAUQSEceICZbXKGTRdWLF,QAAAEAAA.eACAZACBbAEAGAFARCEALCBDaAHF.DAIBBCDAhAAA.MDABODHDhAAAHDEBAAFASECBhBCACDCDTFBAdDHAFEEHfGGAVGFA.YHBGhADA.....hCAA...,1,17,-8,25
NGbZHVEBScTaJfCMOXUdKQDgFIeAYPRLW,RAAALAAAGADAHAFAEAEABAGA..TCGAaAHD.CCCD.MCAAXDAChAAAdCEAQDGAhABA.FEAAAAHAPDFBhABAbEDCZGCA.SEHH.fFAAhADAKGGADIGA.eHFA..hAFA...,2,-11,-2,9
dbfLFIDMHaCTegZNRBXVPcKQOJGSYWEAU,dAAALAAADADAHAECaADD.eAHHZAEBBAGA..XBDC.hABAVDEAKBHBQCAAhACAGCBASDHHhACAECGBADDBbEEBFGGAMEIBCHAA.gGFH.NIAB.hAIA......hCAA...,1,-3,-17,14
EZCbMVafXGPeWABcgHSRUFKNLJYODdIQT,BAAAHAAARADFKACALAFB.OAHBdAEATAGAECABZDDA.MCCBhAAAaCAAGCEB.eDCFhAAAACIBSEGHhACAFEEBJEHB.DEIBQGACbFCA.XGFDhACA......hAGA...,2,-18,2,20
YHIgMZfDOdRXTCGSPELNaKVeBQAFbWUcJ,FAAAUAAA..JADAHADA.MAFAZAGBOBCCRBFA..TDAAhADAGDDAECDBLFGBhAGAKDFDeDGHABIB...cFGDhBAAgGCD.DFIB......hBAA......hCAA...,2,-34,-9,25
eSAGNCaUQdRJHbPLXBEWgVfKIFMYDZTcO,GAAAaAAA.dADAHACBLAFAEAEA.VCEAKAGAMBBB.ZCEBTEGAhAAAeCGFACIBUGAAREAAJEHBhAEAXDBD.BCHBhACAfHEBFEEHDGGB.......hAGA......hAHA...,2,-8,-7,1
CIMHPVANXEJYBUWbLKDQgeFfdScaGROTZ,EAAABAAAUADALACA.QAGAeAFAdBCCaBGERCCAZCFF.MDABhAAAHDEA.ADGA..XEGAhAAAJEEB..bEADDEDBhAGAFDHFSGGB..cGGA.hCAA......hCBA...,2,-21,-12,9
ODAPENgXIGdFbTQKMaUBWcZRfLSCJVHYe,EAAAXAAAdADA.FADAQAFA.aBCBBAGA.ZBDARCEBLBHBhAAACBHAHDDAeDGHADDBPFAAhAFAIGAA..hAAAbFGBMDIBUGDAfFDE.SFFDhABA...hAIA...,1,-8,-18,10
POefgYFCREIUGbcVHSBZMQDdLTJKANXaW,aAAAOAAA..eACH..fADAFAEAEAHBGBDAVAFAHCCChAFAZCFBMBBBdDGATFCAhAIAADHA.XFEDhBAAgEGHCBBDIHHAbFCCBGHADCIB....hCAA......hCFA...,1,-4,-9,5
JNKdGYPVRMbHFSeLcBEWTXOCgAfQZIaUD,ZAAAaAAA.DACAKADAGAEA..VAGBRAGBHDDBFBBH.eDGBLCEBhADAECCB...TDCAhAFACEBAAAIBQGAAUDGBdGAAMFHBhAGAbGFA..........hAIA......hBAA...,1,-2,-16,14
dbeOQKAfRCNIYDUBSWXcVPTEZGLaMJFgH,RAAACAAA.....IAEADACASADA..XAFDhAAAVAGBEBCBGCCA.aAHFhABAMCEBFDABHEFAeCFBQFEDhAAAACCBfFEEUGAABDHAPDHDhAGALHBA.dGHAKHGA.hADA...,1,-7,-10,3
NaLSDEJVRPZeOcAKBHgTMXbWCIQGUFdfY,HAAAMAAA.XADBCADAGAEAdAGA...fCAEaAGALBBBhBAAECCBRCEBeBGH.ACIBBDDAhBGAbDGBQFBAhAAAFEGDSFFDDAIB.........hACA......hBFA...,1,-5,-22,17
STbMKfFLXYgQeIVHEBDNWUOdZGPacCRAJ,TAAAMAAAFADD.LAFA..XACBQCBCeAEAHCFAhAGAEAHFDCCBUEDAZCFAaEHBhAHARDDBAEHBSFCDhBAAKFAAfFGEgGGABGCAWFHHOHCE..hBBA......hBCA...,2,-13,-4,9
VBWQNYXIUPcLOAJFHdbMfgGZCeTKaRESD,HAAAdAAAMADAGADAZAEE.eAFAKBHB.EBHFDBDBBCAD.QDFChAAA.XDAAhACAICFAcEGDACCBFDEH.bFAAhADACDGARFGBSFED.NIDB.....hAFA......hAGA...,1,13,-44,57
bAUcgITOeaVNRdXQfJFPWCLDMSHGBEZYK,UAAA..gAAATADA.eADAaAFA.RAGBdCCA.QDAAhAAAFBFDCBHALDAAMCGBHEDBhABAEDGAZEDBKDHBAEIBOFFBhADAXGGA..fGHA..hAIA......hBAA...,2,-24,5,29
bfEaMBRVXHDOCUGSTgdZJPKNAeYIWFQLc,eAAA..IAAAQADALACA.bAFDEAFA.aAHDRCCBHDABhADACCCAGCEBTEFAhAEAZEEAKGGDAAHAFBHFMEIBXFCAhCAAOHBASFHH....hCBA......hCCA...,2,-9,-3,6
ZWQKVXEFSTPHeMBOGaYAbDCUfNIdRcgJL,CAAAUAAA....fACAdADARAFAJCEB.ZADB.KAFAECGA..TCAAhAAAHDBBeDHF.hACAMEGBGCEA.AAHAbCGBhBIADFABIHHALGDA.....WFFDhAFA.XGADhAGASHGA.,2,-25,-14,11
BWCPYGQdaeROEUAJHXgVDZbcTFMSIKNLf,HAAAXAAADACAZAEB..TADAMAHBKCCBLAFBBDFACDHAGCGAhAAA.aAHFREBBEEEBACDBgDAAhABA.bEDBhADASFHB.fGFAPFCBdFFAhBHA......hCAA...,2,-30,1,31
PaTMWCcgBbXdIEJRVQfeOHNKFYASLZGUD,ZAAAGAAADACA.aADAMAFA..CAGABBHAdBEA.ECDARBGB..QECAhABAeCFFHDBBFEFBAAABLDHBhACAUGGA.TGAAhAGAgGBBXGEA.IEGA.hBGA......hBIA...,2,-26,1,27
bLXZTdEYIDRVaFGHUAJSOCQefWgBKNPcM,OAAAeAAA....fADABADAKAFA...PAFAbBBCZBFEhAFAEBEFDDDBRCFA..aCCHHDGBhAHAAAAACEEA.QEEAhAIA.gGDBMEHBTGCAIHHAhBAAFGFB......hCAA...,2,-20,-9,11
fRbMEDYFSPeGOCJVHXAWUdcZaQNgTLBIK,dAAAaAAA.QADA..TADALAGBKAFCRBFAECBAFBBHeCHHhACAGDCACBFBHDDAAAIBUEEAhADAZFDABDAD.fFHAhADAbGFAMIDASEHF...hAIA......hBAA...,1,-8,-9,1
RDdeTYZbMXaCUAQBIfKNSPFcOgLWHJVGE,QAAABAAAKACA.SACAFAEA.OAEDLAHBHAGBGCAAhAAARDAAeDDGZCCAbEFAaCFFhACAAAGB....fGDAhAAAPECC.gGGBVEGBEHBADIEA.hADA......hAIA...,1,-5,-16,11
VYAUIRbWCZKfNEOQPdeJagXcTHMSBFDLG,RAAACAAAZACAKADC...EAFEQAFA.eBHHaAHD...XCCAhAAAHCCAMCGBBCFDLDABhAAAGEFAACCAbDGDfHBBhABAOECBdEEA.......hAIA......hBHA...,2,-26,-12,14
bWTJXIKZQMBSdLaGcYCNHPeORAgFfDUVE,FAAADAAAEACA..TADA..XAEAZAFBMAIBdAHAGCCAhADACBBDHCDAeCGHADCBUEFAbFAB.hAFAJFAA..QFEChBAALFHBaHBANEIA........hAFA......hBAA...,1,2,-21,23
AWGTCILaJXDdgENVfFOHUYbRMZceSBKQP,GAAATAAA.LADA.aAGDDACAECDAfAEAHDEA.UAGAhAAAREAAZFGBeBDDKCHBAAABCCFDXDFAhBGAdGDA.gFFBhBIAFGFB.OCCH.MDIB.hACA......hAEA...,1,-1,-8,7
aJSNcLZgfXUGHIBRWFbKMVECPeOTDQAdY,aAAASAAALADAZACB....XAGDHAEARCEAFDHDMBBBEECAhAAAeCCADAGAABIBdDFAJEFBgEAAhAEA.GEGAhAFABGHAKHCACDHBOEEH.....hABA......hCAA...,1,1,-23,24
YSNfbCcOWHFPZadQGRDBIJEAUMXLeVTKg,MAAAeAAAKADA..SACA..bAFBOAEDHCCAZBGBhAAAdAGARCCBBECDECHFAAIBLEEBhABATEFA.gEGAhAIAfFEECGHAcFCDFGBAaEHDDBBB.IHHAhBAA....hBGA...,2,-21,-5,16
YTaMIedFgXUVbRCEBWKZHJcGLONDASQPf,QAAA..fAAAaACE.eADAdAFAXBGDhAAAVAGBRCAAECEBKCDAHDFBGDAAhADALEAADAIBADCBSEEAhAHAPFHDMEEBFEHB.gGGAhBFACDHA......hCAA...,2,-14,3,17
GBLcVUeMJZFaWTfgQIdEbOHCKPNSYDAXR,RAAAGAAALADBUADAeAFAZAFBFAHD..aBGE..TDDAQDEAhAAAEDGA.HDGDKEHBSDBHhAAAAAFABCCCMFCBhABAJFFBfGGE..gFBAhACA.IHHAhBAA...,1,-6,-18,12
IHZKVTGgAOfQELPcYJRaNFdbBSWeCDMXU,QAAAEAAALADA....PACCJAHBRCBAFCFBdAFASAHBhAAA.eBGHMDIBhAAAXCDCHEAAZEEATEEAhCAAAAEAfGEAaDHDBECDDGGBKGGA...hAHA......hBCA...,1,-1,-18,17
OHYNUGEKdfaBbXVcZPJMAQFDTSeLIRgWC,QAAATAAA.eACARACFCAEB.HAFA.UCDAEAGAdCEAaCFEXDAAhAAAZCFBMBIB..ACABSDHDhAAALEGBIFFAhADAOEDB.YHAAKGAABGGA....hACA......hAGA...,1,6,-20,26
MdEbFTRUDPQWVGeAgHSYJLfBcOCKIZaXN,HAAASAAALADBBADACAFAZAGB.aCACMAFA.EBEAFDEDRBGBDCCBhAAAQEGAGDAAABIBJFAAhAAAODDAKGEA.XEEAhABANIBB...bFGD......hADA......hCAA...,1,-12,-18,6
acZeCOgIYQbXKLTFGAJBfdVRSNMWUHPDE,BAAAdAAARADA.MACAHAGBDAGAECBA.ZDAA..eBCAOCFB..gBFAhAAAQEGAKCBDhBCATGAAABIB.fGEAhACASDDBWDDBaDFECEHA...bFFCFGGHhADAVGBA....hBDA...,2,-32,6,38
VHNZdIMcUPbQGCTRFLEAaYfWSeXOgKDJB,aAAA..fAAAeACHOAEADADABAFAHBDBdBFDMAHBUDGAQBCAhAAAGGEBCEFCRCABECFBhACAAAIB...SCHHhAIA.KECANBBA.ZEEF.IGCA.hBAAcGGA...hCAA...,2,-16,-5,11
WQeYbAIPZGSaVMXETDdRCHUNgfBJcFLOK,ZAAAaAAA.MACA..EADAdAGAHAFAUBEA..fBBEBCCDFCHDLECAhABAKCEAeCGHAAHAGGEBhAIAXDACDFGA.RDCFCEHAhADA.JFEB...cGGA....hBAA......hCAA...,2,-28,-8,20
faIdECeVAFBYMUNZODgJHbPSXQRTLWGcK,BAAAMAAAZABEDACAHADC..SAEHRAGFLCBAGAGAKDEA.hAAAaCCBEDHFeDDA.AAGBFEFDhAIAUFGBODHDJGAA.hAGA.XGDB.......hBAA......hBIA...,1,-21,-22,1
dacRgIHJOZXMFBDLSfECUTbWVeGKPNAQY,dAAARAAAHADBZABBMAEADAFALBFB.EAHFTBEA..bDAAeAHFhBAA.GDBBKCHBAAAAaEEChADAgDGA.hCAAOFFBBEHDCGGAVGBA......hBDA......hBEA...,1,-10,-16,6
VdcDNMEeIQHSbOWKRZfGJLXAFCaBPYgUT,aAAABAAA.....gACATADAdAFADAFAEAHB..eAHFhAAAHCCAOBEDRCGBGDAAhADALCABABBBCEEAUFGBcDDChACAMIAA.SGEBbDFDZGBAJHFA.FECH.hAIA......hBAA...,1,0,-5,5
efQAaYKZEWCdbTORHVJNLMDFUBGgPcSIX,aAAAZAAAEADE..dADAOAFAHAFAJBBFLCABFCFH.GCCB.hAFA.gDDDhAHASBGAeCHBADHAKEFAbEGDRFCAMEIBhABABGFC.IGGA.fGBEhACA.YHEAhBGA...,2,-14,-10,4
BOMHCdAWILeXNSEQbUJZTKVRYPfFaDgGc,LAAAeAAA.SADHEADAQAFAUAFAZCAATCCA.RCEF.hAAAfCHAaBHDGEFAhABAODFBMECBdFHAAAIBXEGAhABANIAB.bEDD.KFBA...YHBAhACA.DGGBBHEBhAIACHHA...,2,-3,4,7
ZVOSJKUQTEMbgDNReCHdPYaLfAcWFGIBX,FAAAGAAABADAZADA.SAFEKAFAUCCA.EBHF..MAIBDCDARDDAHCFBhADAdEAD...aEHDAAABIEHAhACA.OFFBhAEATFAA.bFCBNIABCGDALHFA.fFFEhAFA..hAHA...,2,-30,-9,21
CYKGZBNgQLWeaXIPfJbMdAVRcTUESHFDO,RAAATAAAEADE..HAFBOACAKAHBZCCABAFA.QBGAeDGFaDHD.hAAAXBDC.fDEAhAAAbECBAFAA.cDGChAHAFGHBCHAA..YFFFgFFB.WCCDhAIA.....hABA...,2,-11,-11,0
KfdLBJGMESgAVOcbFNWeUZXCRHDTQYIPa,OAAAFAAAeACHZADBRAEA.HAFA.DBBBQCEB..ICHAhAHAaAHDdDHALEAAhAEAGCEAEDBFAEEBVFFB.hAIANHAB.XEGA.TGDA.KGGA.hAFA......hAHA...,1,-9,-11,2
XOPQVeFGYIALgNDfRMJcdSEBTHUZaKWbC,LAAADAAARABA.MAEAdAEAEAGAHBCC.aAGEKBHB..CCAA.OCDBhAGAQCFAFCFD.GEEAhABAADHB.fDDEhACASEEDTFBAZFFB.WDHBPFHD..hBAA......hCAA...,1,4,-31,35
TBeCOLdfgUIQDNEKMAGHXVbRPZYFacWJS,HAAAXAAARADFZAFBFADA..aAHD..JAGBTDAABBDD..eBHHhAAALDHBdDDA.fCCEhAAAIFFAQGAAhABAEEEAAACAGFABbGEAcGFA.CHBD...hAFA......hBHA...,1,-1,-23,22
ReKJbWOMXPVHYaTSLAIDgQECcGFZBUdfN,DAAAEAAAGACAZABEdAFA.RAEA.KAHB..JBHB..OCCBMCBB..XCEAhAAAHCGBaDABTEEAhAEAADEA..QEEChADAFEHDfFAEeECHbGDAWHAA..YHAAhAHASGGD..hAFAIHHACHHB,1,-10,-17,7
KGWFPefZOMdYDERSHUXVIANaBbTCLcQJg,aAAATAAALADA..QACCKAHBGCCAFAEAeCFBZAGBdCEAhAAAEBBBHEABXDGAAAEABCHDhAHAbEDC.CEHA..gFEBhBAAfFGA.MIBADGIBSGCAhCAAIHHA.....hBIA...,1,5,-15,20
LQSEYZWPDgJNMGVXdfUKFHATCeOaRcBbI,eAAARAAABADBLAEA.EBCFZAEB.DAHBJBHBGCCAdCEA.KCGDHDFBhAAAAAAA.TFAA.hAIAaDDBbEFAQGCAhABA.SEHHPFEB..gGBBhBGA....hBIA...,1,7,-35,42
cJTefKXVPQWRGDbMBEYASNIUgCFdHOZaL,SAAAUAAAFADAHAFBZACBLAFA.JBEFeAHB.XCBAhAIAQCGARDFAGEDAhBAAbEECBFHAACEB.IGAAhAAAdFHAaGGB...TGCA.KGGD..hABA......hAGA...,2,-19,-7,12
SJbHNFgOKCAcVPfIDeZMdQBYaRXWELUGT,VAAA..fAAAeADEZAGB.dADAQBDDaAFARBEF.EDEBGCAAhAAA.TCGAhACAbEFDHGAAFDDHKEGDACIBIEHAhAAAMEIBXGBA.WFFDSGCEhAGA.....hAIA...,1,2,-9,11
MbgIBVdeWXKPEHGCcQYJaOfTFAUNSRDLZ,SAAARAAAZADB.MADAIAGA.dCCCeAFA.KBCAHCFAhAAAGCDBQEEChABAaBGETEBAAAIBDDABLEEAhAAAbDADBEHAXFGA.EGEBCFCBcGGAhADA.OHCA..hBFA...,1,-1,-12,11
BFHXIMfZKYDRPdOaWeJAGULNCEcbQTSVg,GAAALAAAEADAQAEA.TAGASAFA.BBHAhAAAHCAAMCDAZCEADCIBhABARDDAdDGAaEACeDADACCACEEAbFGBhACAFFFHfGAEKGEA.OEHD..hACA......hADA...,2,-12,0,12
PSHXONWUKDAYbFCBfMQEGZegRTdVaJILc,FAAABAAAMADAEACAZAEB..RAFAdBDA..aAGDLCCD.SCGAhAIAHCAAOBHDhAAAUEEAACCAbDFDCEHA.GEBAhACAeGFA...........hBAA......hCAA...,2,-28,-17,11
OWLXRVCJfdMacIbUQKNASYTBgDFZeEGHP,TAAADAAAeABA.HAEAOACALAHB.RCCA.CAFAdAHAMCGBaBDC.hAGA.IEEAQCFDhAAAACCABEHAZDDFEEHFPHCAhBAAXFFD.fHBBcGGA..hBHA......hCAA...,2,-21,-9,12
fPIKQgNWVeTDXHLRGUBcYCAdFZbJOaSEM,ZAAAOAAAEADE..MAFA..fADAKBFA.QAFAhAFA.gCCAhAIAVCAAeBHHTDFAHDEBRECBhABAGFCBBEHACGGAABBBdBHAFHBC.aFHB.SGHHhBAA....hCAA...,2,-10,-7,3
YQHeCcNPZXWMORbfDdSBILKAaTJGVUEgF,aAAAGAAA.EADAFADAHAFAeAFHCCDA.....PAHBZCFAMDABhAAARBBADDDBdEEA.BDCDLEEAhAIAAAHATGFAUGDA.hACAQGGA.......hADA......hBAA...,1,-15,-16,1
fTZXSRgENKIYHLOMBbcWCeFQDaAVdUGJP,dAAAGAAAJADA...TADAZAGBRCAA...EAFEKCEBHCDCLECBhACAMAIBBCGB.bEEACEEDeEGBhAGAQGEA.hBAAAAABPDCBSEHBIHAA.ODAHhACA.FGHDaGGH..hBCA...,2,-32,19,51
MTKXYBZfNQebVPdGSgDRAUIcLEOCFWaJH,UAAALAAAEADA.FAEA..aAFDHAGB.MBEBTCDAKCAABCCBhABAZAGBQDAAeCFBVFEBhACAGEFA.DBIBAAIBODHDhCAACEHAXFBAfHGF...hADA......hBAA...,2,-14,-9,5
GQbFeXLCdIODHJWPNBKSfERVAaTUYcgMZ,aAAATAAA..UADA....gACBGAGAbCCCeAEEhAAALEEBdAHADBFBHFBAhAGAPCCBKGGASDHHhAIARDFAACGBMEEBZFFA.FHFA.......hBAA......hBBA...,2,-14,-2,12
ATLgXKfGeIOdJCbYMESBDVcWaUHNRZFQP,TAAALAAA.KAEAeACEdAGA..CCAA.bAFB..ECCADAIB.VCCAhAAAaBHDHCEB.REAAZEGBhABAQDGAAEAA.fDBEhBDAOGDAMFIBBEFD.cFCBNIAB.hACAFGGA.PHCC.hAEA...,1,3,-9,12
HcGDPMJfSWUNRLEBbCTXdVOAaYFIZKQeg,aAAAFAAAZACB.KAEAeACH.HAEAGAGAMAIB..SCEBhAGAUCEBRDGFEEAACEDA.dFEAAAIBQEGBhBAADBBBJGAA..hCAAfGGELGDABHHA....hCBA......hCCA...,1,-5,-25,20
ARITLBcWDdHCaNJPMYUeEOZXFfQGKVgSb,RAAATAAALADB.BAFADACAHADC.aAGAPAHBUCCAEBGFZCEBFDCHhAAAGDGA.KDFDSDGAhABAACIB.IFAAhAFA.dFGANIEB.MFIB.eGDA.hAAA......hCAA...,1,-9,-18,9
cNgIVHAOSYBDTPdEQfKWCXeaUZGJMbFRL,SAAADAAAdADA.EADAQAFA.KAHBXAFAUBBAGCEAhAFAbCCARDAB.LDGBhBAAgCGA.HECBhAAAADIBBEDDTFFAfGHAeFHHaGAC.MIAAhABA......hADA...,1,2,-22,24
OQgJcDPBeFWSHfXTaAMCEdGYUNIZbVRLK,EAAAGAAAUADAZADA.RBGFLCDBQAFA..JEAFDAIBBAHBeBCDhAAAFEGHHDFA.TEDAhBDAAAABMCFBdFHA.IHBAhBHAKGHB.OHDA......hCAA......hCBA...,1,-7,-28,21
SAFMOYPbIDGaLXCRZQeNgcJWfdTBVHKUE,MAAAOAAA....bABAGADA.aAFALAFARBFFZDBBeBHHhAIAgCCB.JCFAhAGAdFEATEFABBBDKGGAhBAAEFDBAEIB.FGHB.IHAAXEGACHEA...hAHA......hBAA...,2,-16,-14,2
fEVDXTNdPgQGLcbMJSeBOCKIZYAWFRUaH,RAAAHAAAEADE.XADB.dAGAQAFCGBEALCAAbCCBMAIBhAAAeBHHBCGAKEGDZEDBAEEBFFHDhAAAaFFADEIBTGBAPHAChABA...gGEH...hACA......hAIA...,1,1,-1,2
aYDdTSFPHVCGXgeLcUMfBROJbQIEAKZWN,ZAAAaAAA.dAEAFADAHAGBGAFAeCAB.LDDAMAIBBBBDREBF.OBDBhAHAbEFA...EDHBAAGBKFDAhABA...YHEAhACATEDASFGB.CHBA.gGGEhADA...hBAA...,1,5,-31,36
TbHSIQULFYPecONXfdMBgKDWREaCZVAGJ,GAAATAAA.HADAQACCLAGBFAEAeCDA.OCHDXAGDhAAAdEEAMDABKCDARDEAEEHFhAIAZFABAAABSFCAhBIAIGGA.PHDAfDCEDGIB.aHFC...hCAA......hCFA...,1,12,-8,20
VKAgBXeNMGcOSJHPbWdDLUIZTCRFaQEYf,XAAAeAAAGADA.SAFAHADAbAGB.dCGALCDAZDBBRFDAaDHDhAAAEDAA...fDHAhAAAAAFABDFCMIAAOEEBhABA.PFAADDBBIGHATGFA...hADA......hAFA...,1,-5,-8,3
ZTgeOHWYfMNBSARGDLKdabCUPQVcEJIFX,RAAAGAAALADBaADAUAGAQAFA.ECFBFCDA.ZDBB.eDEAhAAAHDGB.fDCEhAAAMDIBSEFAAAIBdEEAbFABhABACGGA....cGBDXGGA...hACA......hBAA...,1,6,-21,27
ZMbIXJTQBWaYCKeEOfHLcAgPRNSGdFVUD,RAAAGAAAdADAFAFADADA.ZADE..MAIB..bAGDJBFFBCDA..hAAAaCCCKDEA.EEGAHDGBhAAAAAIB....gFCAhACASEEBIGGAQGGB.CHCA.hABA......hCAA...,2,-29,-25,4
YOTVUZDfJRCFgdeNWLMHBQKcSIXAPEGba,EAAAaAAA...OACCTADAZAFB.DAIBRAFFFBBHdCCA...eAHHLDHBhAAAHDCAQEFAhADASEABABHBbFABUEEAhAEACEHANIDBBFDAKFCB..IHEA...hAFA......hAHA...,2,-19,-1,18
SeVbGZadIRgXBHcYLKJPOCFUQEDWTNMAf,eAAAGAAAdAEARADABAGBHAGBLBDDKBHB.ODFBFCDHECFBTEGAhAAAAAAB...SGAAhABAZEAAaDHH.XGDChAGAJEFFCGCD.QGGBDGIBMIAA....hAIA......hBGA...,1,-5,-23,18
NDYcOLEbMWdXRaAeSgGCFHKTJBUIPQZfV,eAAAGAAAHADAKADABAFBUAGAQCCCZAGB..fCDAhAAADCFBODFDEDFBbEGDdEHAhACARFAA.ABIBCEEDFHDA..TFCAhADA...IHFA...hAAA......hABA...,1,-9,-18,9
HCMFcEVaASPdXIKbeTRUYGZgODBJWQLNf,dAAAKAAAeACERADAGAGAZAFB.DCCBBAHA..QDDALCCBHCGBhAAAMDAB.EDBFAAIBSDGDhACAXEDD.TFCAhADAgFAG.OFFDNDIAFGADaGGBIHHAhAFA.....hAEA...,2,-14,-5,9
PDYfXMcebLQCBVHgUJONRSZKGIEFdTWaA,DAAAXAAAeABALAFABADAHAEB.UBGAOBCERDAA.ZCDEGDDAhAAAECHB.dFGA.aGAAAAGAfEEAhBAAMEIB.hABAbFGBCHAA...gGEASGEH..hADA......hAGA...,2,-15,-8,7
XKfWRSFbaGgeJZHBOPICDLANQMVETdUcY,MAAAEAAAdADAUAEA..XAFAKAGA.RCBB.FBBAGDDAeCFAHDDAhAIAOBHDCDHA.AAFAQFGAhAAA..TEBAhBAAfGCAbFFAaHFA......hBEA......hCAA...,2,-21,-12,9
gMdcOGKeTaCQBNEPIbVAfYZLXJRWDUHSF,ZAAALAAARAEADACA.HADB.FAFAdAHAGCAAeCCB.aAHDBCED..hABAECCB..IDGAhAFAACABXCFDUFEAMDIBhABAKGCB.TFDAQGGCbFBDfFFBhACA.YHFA.hCAA...,2,-30,15,45
SIdPbaEKTZHMUNWJeLXVcGFOfADgBYRQC,BAAARAAAQADCSACAdAFA...aAEDEAHBZAFBHCFC.MCCBhAAAUCAAJDDBeAHF.LDCBhAAAXEGAGEEAhACAfFEAACIBDEHBCGHAIGGA...hADA......hCDA...,2,-18,-5,13
TYGCDaNdgFAZbKEPHQUfIScOLRMJWeXBV,ZAAAEAAAHACAQAEAUAFA...SAGALBHBRCCAMCABeDFFhAAABCCDTEAAGCGAhABAaFHBdHDBACEBbDAD.fDEAhACA.OFFB.WHAA..hADA......hAEA...,2,-11,-3,8
VdQOWbaLMRfeNTJSACEgKZGcFDYHBUXIP,EAAAZAAAGAEADADA.HAGDBAFAUCAA..XAGDIDDAdBCAhAAAQDGBOBEBaDEDhAIARFFBeGAA.NIAB.TDGAhBIAAADAKFHB.FFGH........hCAA......hCBA...,2,-34,5,39
OaJbfcYUQZdPBCRSeXLgKWFDNATGVIEHM,GAAAEAAAHACAaADAJAFA......bAFDfCCEUCDAdAHACDHAhAAARCEAeCHHLFFAKEAADEEBhAAAAEGB..TEBAhACAMFFBOFCD.QGGABHBASHFAhBAA....hBCA...,2,-12,-2,10
cDNfIXQOTBLYCKWSEdVZHUePAaMGbJgRF,GAAAJAAA.RADADAGA..fADBQBGABAFBLDCAhAAAKAHBECCAZEAA.HEFAeCEAhAHAAADAaGDDMDHBFGHBIEEAhBAA...TFCA.CGEAdGGD.hACA......hBAA...,1,-6,-22,16
eOMgKdUIfAEDRHLWaYTCBPcbNZFSXVQGJ,RAAAHAAALADBaACACAFA.BAFA....bAGDZAGB.XCEDhAAAGCCAeCFDMBIBdCCCfEHAhAAAEEGF.DAIBTFAAhABAcFAASFFDQGGBgGCAhAFAKHEAACCB....hCAA...,2,-15,7,22
aCEPJcfeLKbOQSRTFBZNHdMAUVYIGXgWD,VAAAGAAA...XADADADAEAFA.JAGBeAHFLCDB.OBHDhAAARBDBTDFAZEGFHFDChACAACFAUFFB..gEAAhADAaDDH.cGAD.....hAAA......hCAA...,2,-27,2,29
BbdODNeKJQYgMCGLUHcXVWZFASfRTEPIa,RAAAEAAA..aADAdADADAGAeAFA.KBHBQBDD.MBGBGCBAhAAAHDGBXDDBhAFAZEDBAAAASBHBTDFABEHAhAGAOCCHYFCBLHCAcFFCFGGH..hBCA......hBDA...,1,1,-18,19
aDYgUZdXbFOKHRQBAGVLTIEfeSPCWJMcN,GAAATAAA.EADAeACECAFA...MAFAaAGDDAIBUBGA.dCCAFCDAHECChAAARDEABDHBADBALEHBhBDA.SFGFhCAAPFGB.cGCANDAA..YDDF.hCEA......hCFA...,2,-21,-4,17
eCPOQKSIbJcVFZdYHURaLTfMADBNgEGXW,BAAAEAAAGACAeACAOAFCQAEA.SAGAJCAA.FCBHhAAAdCEAHCFCRCGBaDACTEDAhAEAAAHA.DEIB.XFGDhAHACEDDKFFA..bGCCcFED....hBCA......hCAA...,2,-31,-1,30
COINTcHUMAfPdZWDJLaSRKQFXEYVgGBbe,dAAAZAAADACAaADA.RAEA.FAGA..EBHF..VBDBGCCB.BDHAeBGBhACAOEFB..TDBAhBAAHFAAAAHA.fGGAhABAPDFDLFHBSGCA...hBCA......hBDA...,2,-25,-18,7
YQPSWGgeFTDCUaNVKdXRIOZEMLJBcAbfH,HAAAQAAASACEGACBeAEHDAFAaAHDKAGARCCB.ZCFBLCDAhAAABCHAAEHA...bDABfFDAhAAA.PFGDhAGAFDGDTFCA.CEEAUGGANIAB...hAIA......hCAA...,2,-11,-1,10
fSYZRXOLgEdcDICJGUAePMFQVTbKNaBHW,eAAAMAAAFADDQADA..TAFAbAFA.aAHDHCCA.SCFHhAAARBBBLDEAECHBhABAdFAADEEBCCFDUFFAAAGAKEHDBFFAhCAA.fGHAYHAGOEHDhAFA......hAHA...,1,4,-16,20
ZTcdFMWPDCLSJBIOgUVbXYNefHaEQKGRA,ZAAAdAAAMADADACALAFABAGA..OAHDVCDA....XCGBhABAeBDBHCAC.EBEEhACAGEBAADFATDGAFEFDCEHAhAGASEFDIGHA.bGFANIDB.....hAHA......hBEA...,2,-20,-10,10
CcXIdHeAGTFJgMDKZEbPLfBVWRQYNUOaS,GAAATAAA.FADAMACAZAFB..EAHFLAGBBCDA.RBDAQDBAhAAAUEEAOCHDaCHDCDCD.XDEDhAIAHFCB.ABDADFHBhBGAbGFA.fGEA......hBIA......hCAA...,2,-13,-10,3
XTaZQgdJPBVeHKRWOEMSFDYcNIbUAfLGC,GAAATAAA.ZADAdACABAGBHAEARCDA..EBHFMAIB.DCEB..NDCA.hAAAbCFD..AAEALEFAhACAaCHHQEAA.hAIAgFDBPGEA.eHAAWHEAFGGA..hAAA......hAEA...,2,-18,-1,17
LBeGMJVDPTgcWAQXEORFCaZKNfdUYbIHS,EAAARAAACADB.ZACB..KAFAdAFA.UDEA..ICCAHCGBLCBDhAAAGCEA.MAIBDAIB.TGGAhAHA..gCGBhAAAAECAOFBEaHBAfECA.bFAD.hBCAeFHB....hABA...,1,0,-42,42
CJMNFIZGVPLEYaUBRSKHbefXDdQWcAgTO,TAAACAAA..MACAFACAGAEALAGBEAGAaBCABBHA.RCCBHDGBhAAAeBEHDAIBdGAAQGDAhAGAABGBOCCB.IHHAhCAAZDFEPFGB.SFHB..hAAA......hCAA...,1,5,-31,36
gQbeHNTJAKEBacSFIVdUfYWDGRCXZLMOP,EAAAaAAA.FACDdADA.UAFA....fAEADAIBRDBAZDFALFBAhBAAMAGBOAHB.QDDAhAAAHFFAJHBAABBBBDHAhAEA.SEGD.IFCAhAIAYHFGCFHB.....hCAA...,2,-32,-16,16
gbUIaDdAWeTRVKGfOBJEMXQSNCcPHLFZY,eAAARAAAGADABADAEAFAMAFA..QBGACBEAHBFBZCCF..bDAAhAAAaBHFACCB...TEGAhAAAfDGE.XFAAhABASEEBPEFBLHCAFFDD.gGGAhABADEIBdHGB..hCAA...,2,-20,13,33
OeSEZJbBHXRcIgQFGaCfVNLTdKUAYPMDW,MAAAOAAA..EADAZADBBAFAHAFA.RCEF...IAHAQBBBhAHAaBBB.fCHAhAIALCCAdCGAAEGBDEIBeDHHhBAAbFGD.XECAFHCA.GGDB.CFFB..hBAA......hCAA...,2,-9,-9,0
RcaFUGIWNgEAPSeMQbfTCKBDOHdJZLXYV,eAAAMAAA.QADA..bABATAFABAFAHAGBZCCALAHBhAAAXCCCRDFFaEEHGDEAhAFAIFHAgDGGhAIAAHCASHCAKFCAdGGA.......hBAA......hBIA...,1,-1,-9,8
WBAQZRGdCgYMXJHKUITfLbeOFDNPSaEVc,RAAAdAAACADB.MADAHAEBKAGAUBGA....TBDALCCB.eEDHhAAADCCBSCFAhACAEEHBVFFB.BDDDAAGA.GEFAhAIA.XFBA.fEHEhBAA.OFEHNIAB.hABAaDBH..,2,-18,-14,4
LBbYTNaIgQAKVFMDRUZCcfHdGEWPOJSeX,FAAARAAAZADBCADA.HAFAGAEAECFB...OAGFeCCDLCHBBCCA.hADATEEAaCHD.QGGAhAAAAAIBMDEBDDGBfDAAhABAdFFD.PHAAXGAA.YFHBhAGAIHEA...hBAA...,2,-35,13,48
bUSQFRgefPAJOIYCNadLGKZVMcTEBXWHD,OAAACAAAdACAGAEAZADB..MAGBEAGABBHAHCEBDAHB..SCBDhAAARDBBeBHHABBBJEHBIDDAhAEA..aFBHLDGBhAGAKGFB.TGEA.....hAIA......hBAA...,1,-20,-24,4
BMLKTEQfHGgRXFeVJdZNSADWYbPcaUCOI,DAAA..bAAAaABEOAEABAEALAGB.KCCAEAHF.HBDBhAAARDEBFDHDeBFB.dCAAZEAAhAEAACCBPCHDCGBA.MEFBhABATGGAQGGA..fGEEhAIA....hBAA...,2,-34,4,38
bPUfZRTJXFgGVLWcIBYASCNMeQEaHdKDO,CAAAeAAA.EADAHACAdAGA.OAEAUCCARDFATBGA..FFBAGCAAhAAALFFA.IHFAhAAAAAIBMCFBaCCC.bDFDhACAZGBAJECBXBED..WEEDBHHASDHHhCAA.KGHBhCEADAIB..,2,-8,-5,3
OAeKNCIJYfEcRTVdBGQLFPSUHaXDMgWbZ,eAAACAAA..JACAEADA.RAFA.dAFAGCCALAHBSCFAHCBAaDEDhAAAMCIB...bEFBhAAAABHBKDGD..IGAAhABAfECA.TFGABFHD....hBCA......hCAA...,1,-9,-35,26
LUPFWRAMBfGTcVHQSIgCKNaeXEOZYdJbD,MAAAGAAA..TADAHADAQAGC.SCDAhAAACAFBaAGDEBBBZCFAdDGAbDCCLDDBhAIAFFABACIBBFFDVFFAKHEAhBAAeEHH.XGEC.....hBCA......hBIA...,2,-20,10,30
ZJgDfFeVaOdKMWBPIYRQCEAbSGNcHXULT,GAAAHAAALADBZADADAEAFAHBeAFA.aBGEdCDAMCABBCFD..IDFAhAAARDFA.EDCBAAABSFFAhACAXDGDTFAAhACA.JEEFfGHAKGGA...hAFA......hAGA...,2,-36,1,37
CUTRMfJLeNKbYGOVZdIWHADSFXBPQagEc,FAAABAAAQADAEACAUAFA.RAFA...MAIBLCCB.eCGFhADAbBDD.GEDAZCABdDCCHGAAhAGAACAB.XGGAhAIA.aHFCCDGATFDA.fFFBhAAA.KGHB.OHBChACA.IHFADCIB,1,9,-11,20
RSaWJXUINDgCbKEBAYdGVTPOcHMZeLfFQ,GAAATAAA.OADAHACBeAEALAHBQBGARBFF.aCACXCDBhAAAUDEADEAAbDBDEEGEhAAAADDB.dFAA..cEFChACAZFCASGGA..IEHAhBAANIAB.KGHB.BHBA.hACA...,2,-2,8,10
VXDadRMZeObKICYcSNFfEgBQGWULTPAHJ,HAAAXAAAdADARAFAZACBeCAB..KAEACCCD.SAGBFCED.ECEAhAAAQCGAGDEBLECBhABAAAFADEGBaFFHbFFA.hAAA.IHHANIAB..BHFA.WAHHhCAA......hCBA...,2,-17,-11,6
QNIUJHbEBMCgWGDPdZSfcFKOeVRXYLTaA,QAAAUAAAHADAEAGEMADA..CCDDGCEAdAHAZBDASDDAhAAA.FDGDeCGBREBBLFFAhBCAACHAIDAABHBDhBEADDIB.fFAA.OGFC.hBFA......hBGA...,2,-14,-14,0
OaSLRFCDNUJHdIWbBEZXYQfPGcAeTgKVM,eAAATAAAKADA..MACAaAFA.LAGB.RBDADAIBUBGBHDBAhAAAdCCAbCDDEDFBZEGB.QGBAhBDAGDGAAAAAOFCBhAIACFFD.IGEAWFHH.....hBEA......hBGA...,2,-16,-2,14
MBTHgfWQSGcPOIRAbNFXCYEDLKUaJVeZd,FAAACAAADACALADA.KAHBaADE..eCCAdAGAMAIBHCFA...hAEA.fEEAhAFAQCBASEHBhAHAGDDAODGBACCAbFGDYHCAEFCBJFHBBGBD.WHDAhAAAIGFA..hBAA...,1,-19,-21,2
gIXUWNeAKTZSObVaHJMBDFdELcGPQCfYR,ZAAAOAAAaACA.HADABAFAdAGALAHBGCCAQEFA.hABAfBBERCCAXCFBhAFAUFAAeEEBAAIBTGDAhAFAbEGDMHBAEGHF.CHFA........hBHA......hCAA...,2,-21,10,31
ZETADWXeQOUIPcLRdKBaCMVGFfNbHYJgS,XAAAeAAAQADAUADA...IAGALAGBRCCBdCGAaCHDMDBAhAAAGFDB.fFBAhAAAHDEBgFBAhABAEGHFAAIBDCIBOFHB.KGEDCHFA.....hABA......hBFA...,1,-6,-10,4
eGCRKDLSfcZUAFYPVMBbTEONQaXIgWHJd,FAAAVAAAMADA.BAGAEADE....QAFCaAHD.XCDChAAAIBDAHCGBeBEHhBAARECALGFA.hCAAfGDAZDFBACCBbEGDTGCA.NIEB.WAHBhCAA.....hCBA...,2,-32,0,32
DSgaHYKTFBcMObeRNEPAfXVCdULWJQIZG,XAAAdAAALADA.QBGAGADASAFAHCACKCFDTEAAhACABBHAMCGB.eDAAhAAAEEDBAAEACDHAUFAAJEHBZFFFhAHAaDEDFGEDOFGD.NIAB......hAIA......hBAA...,2,-6,0,6
ageSPCWDcXLdTNAQZIFYEJRBMVGUKfbHO,ZAAAFAAAEADARAEABAHB.GCAAKAFAHCCA.aAHDeCCB..CCFBDDABhADALCGB.dEEAADHAQECBhAHAIGGAMACAhABAfEGA.bFEDSGDDhCAA.WFHH...hBAA...,1,-14,-27,13
VXCDQBPcfZdYENOWJSUbeKGgaATHMIFRL,HAAAMAAARACALADB.CAFAQBGABAFB..fAHAhAHAdCADECFBOEEBSBBDhBAAeFAAKFGAaCEAACIBFGFHhAAADDDAPHAAZDEEYEHB.JFFB..hCAA......hCCA...,1,6,-28,34
MPZVBUGLWYQgDHeNabdRKOXcfSEIJCFTA,ZAAABAAAGAEALACAQAGAHAFBeAHBaACA.RCCAKDAA.ODFEhAAAfCCE.EDGAhABACEEDAADAMEEBUFGAgFFAhAGADIAA.NEIA........hAIA......hCAA...,1,-2,-21,19
ECFLcgaZPHORTbVAeNfMQYBXWKGSDIJUd,eAAAMAAABADAKADAGAFADAFA..UBFAEAHBLCCB.aCEHhAAAHBBA.RDDBbDFAADHAQEGAhABA.XFAChAFASAHHIHHAdFCAFFGBZFDB..hAIA......hCAA...,1,-6,-24,18
QLHBKcXPJIfeVgFWARCMOdbTEZNUaGSYD,RAAAMAAAdADA..EAFAZABE.aAEDGBGA.DAIBHAGBKCCD.XCCChAGA.IDFAhAIAeCFDFEDBADIBOEEBbFABTGGAhAAASFGA.LHFABFFDcGCChABAfGBA..hBAA...,1,-6,-19,13
WMYJKOXcHQDFfbCERLPgaNdeTSGUVAZBI,ZAAABAAAMACAKACA..OAEAHAECQCCB.FBHDbBCARCEFLEGBhABA.aGFBhAHAeAHF.GCAAhAAAAEIB.IDDA.YCFB.XEGDhACADGIB.CHHA..hAIA...,1,-12,-27,15
CQMegEKUPTVOJcHLAaBfNRSGXYWFdbIDZ,aAAABAAA.RACAGAFA..XACDFAHFdCAADCCBZAEAMAFA.hAAAECEAKDDAUDGA.TFEAhBAAODGD.HFAAhACAABBBSDDD..bFDBCGHA.eFHH.hBIA......hCAA...,2,-25,-14,11
YcUGBMLHfaFdVRWeZEbDXSCOIKPJAgTNQ,TAAAQAAA.UADAGACALAGBHAEAaAGAdDBARDDAeCABEDHF.hAAAbCEADAIB..CEEAKEGDhAAAABGB...NCIABGCAhACAMFFBFGGA..WEADSFBAIHGA.hBCA......hBDA...,1,9,-18,27
NcCPdZFVYXMIKOURbSLWJfgGaTHEeQABD,DAAACAAAZACAFACD....XAFBMAEAOAHDRBGF..LCCBhAAAJBEB.GEAAHCFBEEBAhBAAAADABCED.PEEBhAIAdFFDIGBAKFHBSGFHfGHA.hBIAaBBH.eHBA..hBEA...,2,-28,-14,14
DLbdNXBQcTSKVFZgfWHeYGaOAPRCEIUMJ,RAAAEAAAMADALADA.dAHABAGA.TBDAKBCDZCEA...fDDEhAAAHCFAeCCBaDHDhAEAAAAACBHAUFAADEEBbFBDQFEAhAFA.SGCBFEHBgFEHhAIA......hBFA...,2,-19,-7,12
TeJOYVZdcHbFBDWIRgGUSXQKCAMLEaNPf,EAAAaAAA.....fACAeACHOAEAZADBHAFABAHADBBBRCEFGCGAhAAAXBECQGFChAHAACHAMDDB.PDCBhAIATEEA...YDHB.dFBA.bGDAhBAAWFHH..IHHAhBFA.,1,9,-29,38
SZgEUabXeODTcVWYRGfJCdMIFNQALPKHB,LAAAHAAAZADBEAFAaADD...eAHFDAFA.TDAAVBFA..RCAAGDEAhABACCCCdCFAMCIB.FEEHhAAAAAIBBDHASEHDhACAbFBB.OFDH.cGGCfGGA.hADA......hCAA...,2,-18,0,18
aOMbcYNgSIAdEKZPeXfJDUBGWTLCVHRQF,EAAAZAAAeACE..fACADAFAGBEBLAEAHDDARDGFaFDCbBFA.hAAA....NCCA.SCDBhAFAAAIB.dDFAhAGAXGGABDHDTFGACHBA.FFEHMIDA.hAIA......hCAA...,2,-17,-6,11
BLGSaCZdOFRIXAbHeNfVTYgDJPKMcWQUE,HAAAeAAA.VAEA..TADADACAKBHBMAFA.QBFAhAAAECCAGDEAaCCBdEDCRDDAABIBfDHEhAAAJDHB.PHAAhAHAcFFC.BHCACGGA.......hAIA......hCAA...,2,-12,-11,1
MaYZcNUOIDJHREBVTSGQWKebXLfAFCgPd,CAAAdAAA.aADAZACA.UAGADAGAHBDABCCA...TCBAGDAAQBGChACAeCEBLDGBhAAAADFBFDHDMEEB.NIBB.OEEHhADA.IHHAEFFBSHGA.hAEA......hAFA...,2,-30,-5,25
VPCFIbgTEQXMYOJWHfKRAGLeUcNSBdDaZ,eAAAUAAA..SADAdAEAZAFBCAHA.FAGA....bBAAEBFFMCHBhAAAOCBE.HCGBREBAACIBGEEAhABALEAABGHAhBEAaEEBIFFA.gGDG.hDAA......hDBA...,2,-17,-10,7
SPHBdaWKQTbCMJfcgFVYRGLeUXIDNZEAO,SAAAHAAAaACAQAFACADA.MAIBfAFA.FAHBhAAARCCAeDFFUCCADCGBEDHBACCAhAAABCHAdFAATFCAhAFA.bGFAgDAD.GEDB.hBHALEHB.XFAChABA,2,-15,2,17
LfXBEDZFbSOCdaJGHgIeKRYTMcUPNAWVQ,QAAALAAABAEAEACAZAEBSAFH.dAHAGAGAHCAAeCCEhABARDCBMDIBUDGAAAIBfEBEhAAAFEAHCEEA.aEEAhBEAgGEAKFFD..cGBC.PHFChBGA....hCAA...,1,-6,-10,4
WPdXQAEUbROVNTZMGDcaJYFISKBgHfLeC,EAAARAAAOADA..TACAGAGADAEAaBDDFAGD..KCFDHBEBeCCDhAAACCCDdDHA.AAIBVECAhAAAZEEAMDIB.JGBASFGDhCAABGEB.fGEA...hABA......hAIA...,1,-14,-18,4
KXTRLQaFZCgNEVAcJBWDIObUSfYePMdHG,BAAADAAAOABESACA..eAEEdAFAHBGBGBDBTCAAhAAARDDBaAHFZDFBCAHB..ECCEACCBJDHBhBAAIECA.bEEBhACAfGHA..MEIB.LFBAhADA.FGGB..hBFA...,1,-6,-19,13
ZDfQcULBaTbAERFIMgSPNWKCGdeXOYHJV,RAAAMAAA..SADB..PADCKAFAdAHAeAGHOCCBhAAAHBBAZDEAQDDAhAGALDHBaFABAAIBECHFFFCDgEGAhBAACFFA.XFCC...hABA......hAFA...,2,-22,-7,15
FSCQDBUGNEYegZOTdcJfVaPXWMAHLbKRI,HAAALAAARADFFAFAQAEABBHAGCEAEAGA..eBHFZCAAdDGAJCAA.hABAaEHD..XCEChACAAGCAKGGD.CEAADDIB.UFEAhAEAgGCAOHFE.......hCDA......hDAA...,2,-13,-9,4
GQdCHMUeEPXNbcDRfaVFTSAKYJgIWLOZB,KAAAJAAA.....IADALADBZAEBGAFAdAHAHCAAeAHBECGBhAAAXDCC..hAFAbECARDGFaEFHFEGHABGAgFBAhAIABGHAMIDA........hACA......hCAA...,2,-20,-14,6
SeVYaJRdTUAKEPOgBbGZWXDMLHfNcQICF,EAAAOAAABACAZADBDAEAHAFA.....fBBEQAGAhAAAFCFHeBCAaCHBRFFAdCFAAAHAKDBDhBAAbDDBGDGA.hBDAMFFBNEEACHHA.SGGD....hBIA......hCAA...,2,-19,-10,9
fNcGHOPUVMLSJZdIBARXWQaKDegCTYEFb,RAAAQAAADADA.eACATAFAFAFD......bAGDfBDAhAAAGCDAHDABOAHDhABAPEHBMCCBLFFBhAAAZDEAdFDAADGAaFDHCFFAEFHFNIAB......hAHA......hCAA...,2,-24,17,41
aHPSNAQKVYUBFdgIbecZDGLWCOTMfXEJR,QAAAKAAAUACABAEAdADA....bAEDeAFHZAGF.GBGALDBBhAAAODDBMDDBEEFBREEAHGCChAIA.SGGAhBCAAAHAFFHD..gGEBDIBA...hBDA......hBGA...,1,4,-30,34
gEaUOHfVQdWbNGAPBFKRSCDILYXJcTMeZ,FAAARAAADADALADA..XAEATBGAeCCAEAHB..aCCAHDEAhAEA.QFAAhAFAdCFDbDDC.AAHAKEHB.CFGDIGDAhBAAcDGDZFFA.......hBIA......hCAA...,1,-12,-22,10
bgCcMIfGUBNXKaFREYTVeOLdZQHSAWPDJ,DAAAJAAA.CACA...MADAGADABAGAKAFA..RBCA.EBBB..TCFAhAIAeAHHdDFA.HEGBhAFAABIB....bEDBgGCAhAHA..fDHANIEBaDDH.hBAAFFBA.OFFB.hCAA...,1,-19,-35,16
XQcEWfHCTgaBbeFKIDGVSLOMRdPNJUYAZ,ZAAAQAAAEADEHAFBCACA...aAHFeADHKCAAGDDALAFARDGBdECChABAPCECUGGB.ADIB.XDGAhAAA.fEEAhAGABFAAFHBADGFBOFGB.MHAA.YHCGhAHA...hACA...,1,0,-5,5
dcfbGVUaPAFMIKNSRBLWQTEXYOgZeCJHD,MAAAKAAARACFLAEB..TADAEAGA.OAFAeBHFHCABhAAAdBBAbBFAGDFA.aECDhACAADDAFDEDSEEDhAGAQDGC.XFGAYEHBZGBADIDAfGEBhBAA...hCAA...,2,-4,-4,0
ZQVNBIMcKPAJEFGYdUTgXHfWSLDaeRObC,EAAAGAAAdADA.UADA..TAFAHAFASCFAaAHD.RDBFCDDBhAAAZCBA.QDFAhAAABDHAMEFBKDHBAAHAFEGHXFAAhAFA.LFDBDFIB.eFFB..hAHA......hBCA...,1,-8,-17,9
bOCQgEYcAVXBZfeKMHDIJWTSRFGdUNLaP,BAAAeAAAHADADACA.JAHBSADAGCCAdCFALAGB.aBCChAAAbEFA.QFAAhAAA.EGGBAAIBZCEBMIDAhABATEGA.RGBAFDDB.UGEA...hAFA......hAGA...,2,-20,0,20
LWNaVgZMdRQFUXOJPESCfYcHbBIKGAeTD,eAAATAAALAEA.aAHDZACB.RAEAQCEBXBCDOCEDhAAAEBHFCCAD...fCGEhABAHEECbFAAKFHBAAFADDIBhCAANIAB.MECBFHEA.PEGB.....hAAA......hACA...,2,-10,-2,8
IBJNgSHfeRbCUADVLOGZWYPXTEdaKcFQM,LAAAZAAA..PADAEAEAaAGD.FCAAMAHBBCEA..NAIA.HDCAhABA.RDGBCEAAABGBOCABhABAGGBB...XCCAhACAdGFA.QDFCIHHA.SFCAhCBA.eFGFDAIB.hACAYFHB.,1,-4,-15,11
DfHFEGOYgdPTCbeBcSQRLUZJVAINXKMaW,XAAAaAAA.DADAHACB.EAEAGAEBOAGDdCDACCEA.eCFASBBDhAEARDBBZEFAAAAAKGEAMAIBhBAAFHAA....gDEAhBGA.bEGDQGGC.hCAA......hDAA...,1,-10,-20,10
DBHdabALKUCfFJOQPGWZReSEgVYMTIcNX,LAAACAAAFACA.QAEAGAEARAGB.EAGA....VCBAMBIBhABA.TCAA.IDDAhACAXDFDHDFBhAEAbGAAAAIBfECE.OFDDPFHDeFHFhCAASEED.hCCAYHEADCHB,1,-3,-23,20
UWbeBYAQVJaCMIOZLXEfRHdKTFNPGcgSD,QAAAaAAA.MADAZACBEAEAHAFCdAHATBDAFBFDGDGA.hAAASCEDDCGBbDBBeCHFhAIAABBBCFFD.LEEBhBCA.fFDAKGED.cGFD..hBDA......hCAA...,1,2,-27,29
EQNbaYKJSRHWcITBLeOGMCgPFUfVDAdZX,ZAAAEAAA.QAEA..aACDKAGARAEAHCDA.ICHAhAAATCAAeCEBGEAAMCHBhABACAHBFEFAfDDEhACAAAEAdGGAbGCA.SEAABCBD.LGDA.hBCA......hCAA...,2,-8,-5,3
DWbTUBYfEeZQVLXgAKONcCPJGHaFRMSId,OAAACAAAGACAHADARAEA.MAFAdAHA..DCABTBGABCBD...EBBBhBAAeCFFZDCBLEEAhBIAADHAKEAA.PFHDFEDD.hAAASCFD.bGDAfEHAhACA.QGEAhAEA...,1,11,-33,44
NTCOSEZIeRagVGJKUYLHWDQcXMBFPfAbd,dAAATAAASADA.ZABBRACFaAEAGAFAKAHBLCEAHDCAQEAChAEAMCABFDHDAAHAbDGDhBAAOEEB..EFDAeFBBhAAAgGFGUGFAWFCBDBIBBHBA..hBHA......hCDA...,1,6,-4,10
HLVWgSMUYFaQfGRCEOdIDBXcKTeAJNPZb,JAAAZAAAHAEALADBVCAA....SAFAMAIBFCFDaCHHGCEAhAFA.EBHFdEDABCCChAGAKEADAACA..bEGDgFFAhABAQGCARGAACHHADIAA......hAIA......hBAA...,2,-21,-3,18
ZcFILDJYNVAXHCKeQUBbaMWOSgEGRdfPT,HAAAeAAAQADABADBaAED.MAGBOAGBEAHBGCCARCAA.dDHAhAAATDEAZEFBFFBBLAHBhAAADEFBJHCA.VEGBACCBKHGAhABA..WEDD.SHCG..hACA......hCAA...,2,-14,6,20
AMKHSUWIPYbeBVFETDdQOLGCJfaNcRXZg,HAAASAAAUADA....IAGAbACDeAEAFBHDDAIBdCADLCEBhAAAGCFACDDAaBGDRFBAZFGBhAAAAAEAMDIB.KEGB.PGCAhABA.BGGD.......hACA......hAIA...,2,-15,-8,7
KNBaIGTUceZRfVOdWLgSJCHDQEXAFPYMb,FAAAMAAAKADABADAGAFAUAFAZCCA..RBBB.OAHFdBHALDEBhAIA..SDABhADAHECDEEHBAFBBbDGD.aECATGFAhBAA..eFAA.fGFEhAFA.WHAA.CHHADHAAhAHA...,2,-19,-16,3
GCXeEYDIfKFURcQVOSTdabWJMLBHAPNZg,ZAAAGAAAeACEEADADAFAKAFA..RBEA.QCDAOAHF.dAHAaCCCbCFDhAAA....MDGBhABAHFDAADHB.PDCBCEEA.hCAAIDHAFEHD........hACA......hADA...,2,-32,-5,27
RIMEFQfOBYbAXCSdWJPLVeUaTZKHGgNDc,SAAAdAAAJADA.LADAeAGH.aAGDZCAEHCCAGCEA.DAIBhACARDFAEEAAFDHB.QFCAhAAABECAACEB.CFFDPFHBhABAUGAAKFHBNIAB.........cGGChAGA....hBAA...,1,5,-27,32
cFRATSgMKPBGLfVHZbeCDdNIEJOWQXUaY,TAAAMAAABADA.GAEALACBHAGDeAEAdBBAEDCAOAHDQDGBhAGAaCEAFDEBAAEAKEEDVDGBhAAAZGFADGGA.NIAB.IHBAhBHA.XGGA....hCAA......hCCA...,2,-14,-2,12
BMcAedaHGVUYZCONSJgQEDTfWPLFbXIKR,eAAAHAAAGADAUAEAZAGBOAFA.SBFBQBCAEBHFTDEAhAAA..fCAEhAAALEHBbGBAKCCDRDEFhACAMFGBADIBaEGD.CGHA........hABA......hBGA...,2,-18,0,18
HGCRgZAdUSIENcBeJFWDXVQLKOMaTPfbY,dAAASAAAEADABAFAeACH..FAHBXAEALCCA.MCGBhACAaAHB..TCEA.hADAbDGDHECAGEAAREGFACIBIHDAhBAAcDDCDCIB.QGEC.hBCA......hCDA...,2,-24,6,30
KUgPZSRAQXYLCbWHDVGeFBaTOdJEcIfNM,QAAALAAACAEAHAFBGACBBAHAOAFAECAA...ICFAhAAAMCDBKCEDUDAAZDGBAEAAbCGDhADADEFBeDDB.aFEDdHABhABA..fGGAgEAA.SFHHhACA.XGEChAEA..,2,-9,-3,6
OTJNdMFWAVYGBIPfLCgEZRKeXDHbUScQa,GAAABAAA..IACALADA.EAHBRADFKAFCeCDA.HCGBSAHHhAAAaDCCOEABJCCF.hBHAdFEA.MFIBACFAVDGBhCAAfGGA.CGDC.ZEEFDIAAbFDD...hAAAcGGD...hACA...,1,0,-21,21
QIKYXgPAfFNBTGaZCHDSVMeObRULWEJdc,FAAATAAAZACBHAEA.DAGAMACA.eAEARCEALCHBEAHF.dECAhBAAQCCAKEED.hBIAXCEAAFGBBGEAaGHBhCAASCHH.bEFC.UFCA.cGGAhAAA.YHDGhBDA...,2,-21,-15,6
AFcWUbENZPSCVfIMQdGXRLKTHeBgJDYaO,FAAAUAAAEADAZADA..CAFA...IAHAdAHARCCALCFBHCBCeCEGhAEABDAADCIB..aDHBAAFA.hBAA...bEEASEEDhADAMFIBQGEAKFHBJHBA....cGGChBAA....hBHA...,2,-31,-9,22
VAgbEJSTKBUHLFPZCGYONWMReXcdIDfaQ,EAAATAAABACA.HADBLACBZAFAGCFAOAEAMCCBRBEB.eCHBhAAAdBHADDEB.aEBAAAGAbFDBhAIAKEGAFFFH..CDDD.NIAB.hAAAXFGD..fGCB.hCAA......hCBA...,1,-5,-13,8
ODfYPVXegFRaKcEGLTICdMQWBSbNAZHJU,HAAAOAAADACA....fADAPAECeAHHRAEFKAGCGCCAhAAALCGBTEFAdDDAMBBBhBAAQGCBSCCDhBIAACCBJFHB.VFEBFCFBEHAECHGA.BHEANCIA...hCAA......hDAA...,1,10,-10,20
TQgeJcVCfHESRUBKMWNYGIPXODALaZdbF,ZAAAdAAAFADAQAEA.eAHBVAGBHCAARCAABCEAMCEB...hACANCHAGGBBXDEAAACAaDFBhABA..TECAhAGAgEAACDHAEFFBKFHBIHHADIAA....hAEA......hAIA...,1,0,-22,22
SMHIRYEFaDfQPbGXeKTWAUVLcgCONJdZB,LAAACAAA.OADDdACAZADBBAFAHAFARAGF.ECBBDCAAQCFBhAAA.GEEAeCEHTEGAhABAAAHA.VFAAhACAcDGDJFFF.SGHBMIAA..IHHAhAFA.aGEH..hAIA...,2,-18,-10,8
WLSIOfNgMaGYRKAQTVBbdJUCceZPFXDHE,TAAABAAAdACA.CAEA.eACEZAFB.FAFAHCDBEBDB.LBHB.OCBBhAAAfBHA.hAEAMCCBGGEBRDDAACGBbEGDhAAAcEGCDDIB..SFCHIFCAaHCCKFFD.hAIA......hCAA...,2,-12,-12,0
LGBecADEFOKQTJRZCdfMUHXPNISgVabYW,EAAAKAAAQACCRACA.dAEAMAFAHAGBXBEA..IDDAhAAASBHBaDFBbEFDhAGALDAA.eCGHhAAAAAIBODHDZEDBfFFEPGBA.NEIA..hBGA......hCAA...,1,-10,-15,5
ODUCKgQTbMaEVRLNXZHdfWSeFBcGPJAIY,OAAACAAAKACA...TADAaAEA..RAGFLCAAZAFBHCCBdBHA.hAAASBBDeBEFBDFAhACAGEFAACIBDEHBQFDAhAIAEEHBXFAAFGGHPHCC.IHHAhAFA.....hCBA...,1,8,-31,39
OTFNgKYCeWGHXbZQcPMAfVEIdDJaRSBUL,EAAAdAAAaADARACA..BAFBLAGBFAHB.KBDAeCCAHCACZCFE..QDEChACAMDAB.AAIBfDHAhBAADEEBSEHBhAAATGBA.gFGACFFAXGCC.PHFAhADA....hCAA...,2,-27,-6,21
JadMWVcYSeNRKPfEbUGFZOHQTBXLIACgD,DAAAdAAAMADA..VACASAFARAFF.KBDAEBBBGCABZCGBHDDAhAFAQCFABAHBLFFAhBAAAAIBCCHA.aFDHcEEAhACA..NIDB.bFGD......hBAA......hBCA...,1,-15,-23,8
YecPXfgTFBSIHJWZVbLCRaGMUDEdAOKQN,QAAAeAAA..XADATACASAEBHAGBZCCAbDFDRAGBGCDAhAAADDIB.AAIBKCFBhAGANEAA.PDHDFECABGBAhAAAIFFAJHEA.........hABA......hAEA...,1,-5,-13,8
SeRgdPQWCJOcTZEMBXDLIHNbAafKVUGYF,aAAAKAAAGACA.FAEARACFdAEA.QAGACAHA.OBBHhAGAZCAFECEAMCGBDCHBHDFBhAAAADEAUFFBeEED..WDHBhBAAJHAABGHA........hACA......hAHA...,2,-21,-21,0
YEOJCAgeaMKLbcUTNdWHIRPFQfXZDVGBS,eAAAaAAALADAUAEAdAHAHAGB.RCCAQDFDZBAEGDDASDGAhAAAEEAA.CEBAABGAMDIBhAEA.bFAA.TGFAhAFAIFGA.fGHADBBB.BHDDhABAOEEH....hAIA...,2,-21,3,24
HWAZaPCRLEIXSDGgOdJNQMeTBbfFVUKYc,aAAARAAAEADE....SACHGAFAdBHAQAEAeCCBBCEDbAGDhAEAFEEB.KEHBHCDBAAAAZFAAhAFALEGB.DAIBhBAAOFGBMBBBTGBAfHABYFDGhBGA.WFHHCHEAIHHAhAHA..,2,-11,-7,4
SBCgZLeTIHfVUFRcXDbYWJQMNKdaAGOEP,EAAABAAAZACBeACAHAEAUAGARCEA..DAGA....bBCAJDHBMCABhAAAdCBCABIBGDDA.SDGAhACALFFBTECAhAAAfFGAFGEB.XGBA.YFHBhADA....hBGA...,1,-12,-23,11
RZMWXIeTNadPbgOQLFADYBCSEKcVGfJHU,BAAAEAAAKACAGACA.HAEARAEFZAGBMAIB..XCCCeCABaCEEhAAAdEAA...bDFAQDGDhACALFFBABIBCEEASEADhAEA.fFGAUGCAIHHAhAAAPHAA...hAEA...,1,-1,-19,18
DZNMJUTbGFWgYROBEeQKLXdSaIfPHCVcA,ZAAAMAAAUAEAGACBFAGE.....gAGBRCAAECGA.eBBBhAFALDEBdCFA.aDGEfDDAhAIAHEBA.CDHAAFFAhBAADFHBTFDA.YFHBBGFA...hABA......hACA...,2,-25,-4,21
THRUfLMcGXOPdFWAgCYNSDJVZbeQIaEKB,CAAASAAADACA.ZACBeADA..aAEDEAGABAGAHCBARCEALCHBhAAAGCFAOBHDdEBAAAIB.hABA..gECAhAAAJEEFQGGAKFHBfHCBXGAC.FHFA.hAGA......hBEA...,1,-8,-17,9
GMgaQdbLDKEFYTPIXHNfRCcVJSeBUZAWO,GAAAaAAA.dADALADAEAFA.FAHBTBGA..XBBChAEAHCDCRDBFCDHAVCDA.eCHFhAFAZEEAAAABMEGBbGECKFADhACAIGCA.fFHA...hAFA......hAIA...,1,-2,-15,13
cUJaEYKZVDQTbGWdSXHRFeANOMBPgIfLC,MAAABAAA....IACALAEACAEA.UBBA.EBHFZAFBQCEAhAFAGCCAdBHAHECAhAGAREABACCB.ODHD.fFGEhAIAaEFAKFFADEIBTGDASHCA.hBAA......hCAA...,1,-12,-30,18
UdTOWEGJRNeMQZfAaFPbSgVDHCXYcLKIB,aAAAFAAA..SACHDADAHAEC..CAHB.XAEALCCABAHAdCHAODBBhBAAECDAGCGARDFBeECFhBBAZDEBAAEA..PEEBhBDAbGFA...YFHBKHAA....hCAA......hCBA...,1,-10,-17,7
gGUKdSWDIcAQaHLCRTVfJNFOEYMbBeZPX,HAAARAAA.TAEAVAEA...JAHBOAHDECAB.MCCBeCCBZDAFXCEAhAAAGDDAdDGADDIBAAGAhACAaFGELEEA.hAAAfEAEFHAABHHA.gGGASGEHhABAWECD....hADA...,2,-9,-4,5
MIKYReAFHWNdQcEDaXBLbSJTZCgGUfVPO,HAAAdAAAEADAaACALAGB..bAEDTBEAZAGFGCCA.fEFAhAAAOCAEMAIBhACAKEHBRGBEADEBFEFAQGGChAIAXFFCBHEACGBA........hBGA......hBIA...,1,7,-20,27
KTbCWaONLQUdfeRPBMEVSIGXDAgJFZcHY,FAAAHAAAKADATAEA.CAGB.aAFALCAA.dCEDRBEAMAIBEBHFSDGAhAAAGCCAACCBZDAFhADAbEAA.ODHBUFEAeHFAhACABEFA....XFECDEAA...hADA......hAEA...,2,-23,6,29
fGYFWUaXVcRbANECgBdPTOQDLJSIKeMZH,EAAABAAAdADAOACALAFA..SAFAeBCDHCEAGBCAhAAAFDBHaCGAXBGAREEA.hAAAABCBCCEBTGAAQDGChAGADEIBKGGAZEEBfHEBUGGA....hAGA......hAHA...,1,0,-10,10
HQfZIcAPJbUTFRSdaegDGWONCXMLEKVYB,JAAATAAA..RADFdAFAeACEGBGA..OAFACAHB.MBDBhAAAECCB.KBFABDAAHDFAZEEBhADAABIBbCDDFFDB...aFGDhCAADEIBNCCA...XGFDYHDA...hBAA......hCAA...,2,-28,1,29
EFDWPQUZJKNBReIOGTaCAVMHgdXfbSYLc,HAAAdAAA.XADBSADALAGBEAGADBIBQCABZABB.hAEAKBFDRCEAeDCFGDCAaEEChAGAAAIBMCIB.bEEBFEGAhBAAPEGDUGGABHCAIGBA....hAAA......hACA...,1,2,-9,11
RJHLDOBWQdecIaCYMVUbZEfSFPTNGXgKA,HAAALAAABADBdAEAeAEHaAGA.MAGB.UCABEBGBFCAA..TDEAhAAAGDCAKAHBREEFOCHDhABAQEGACEBC.bDCDhACASGGA..XGGCAGGAWHBA.hACAIHAA.YHCAhAHA,1,2,-21,23
YULBdPfNTXOKCWHDcVeIMZGJSbEAaQgFR,aAAAQAAA.RACALAFBdADA..fAFATDAAKAHBhAAAHAGBDCHB.eBBBZCDBGFEBhADAbDDAAAIBFDHDBEHAhAHAXFAACHHA.cFDAMIDA.EGGA...hCAA......hDAA...,2,-5,-5,0
gTeWXEcDAZGJaPCRYKBIMdFQLbHOSUNfV,GAAAaAAA.RADABAGBdADALAFAHCDCSAHHUCFA..fBBEhAGATDGAeDADhAAAEDBBACIBZFFA.CDCDKGCAMDDBhAHA.QFFANIDB.WEDHDEEB...hACA......hADA...,1,-3,-17,14
cZOBXTgMNPIQRDebJfSLCYEWaKHFdVGUA,ZAAAXAAAMACA.....IADARAEAeAHHJCCFLAFA.hABAECDAaCFDHCFAdEHAGEDAhAHAAAAABDCDTEEAhAGA.gEGHQGFDfGHAhAHA.CHCA.....hCAA...,1,-13,-16,3
DgBRbeTOVaCYXESIAGQNZFWJHKMPLUfdc,GAAAZAAAFADAHAFBMADALAHBdBHADCAABCDARBFFeCDB..ODEChABAaDBDCEGA...EEHFAAABQFCDhACA.hACAJFFFKFFB.fHAB....hAHA......hAIA...,1,-8,-31,23
QEcaBgSLZGONHPIUAYbJKWFTeMVDRdCXf,JAAAFAAAeACH.DAEARADFdAFA..CAGA.QCGA.ECCBaAHDhBAA.SBDHhBFAGDAAHEEAUDFAAAHAbGEATFCAhCAA..MFDBfFHABHBA...hADA......hBAA...,1,-12,-34,22
ZRMXFQgIaGNcOHePBEKfVdULACDJbWSTY,DAAAJAAA...SABAZADBRAFA.MAEAQCFB..aAGEhBAAGDAAOBCEHEEAhADAeCEAEDCBfCHAhBFAdEHAACCACGGD.bDDC.TFFA...YFHBhCAA....hCBA...,2,-27,-14,13
LbPEgcKdXIWONeTMYaZBSQHDRFUCVfJGA,LAAAEAAAKACA.dAEA..XAEBOAGBeAHHMAHB.ZCAAQCCAhAAAHEBAREEFCDHAJHAAAAIB.hBGA.bCFD..gGGAhABAIFDATGGA.aCHD...hACA......hAHA...,1,-10,-13,3
ReQgTNHJUXKBFYPGOCcfSLdWZEabIDMAV,RAAAeAAAQADC..TADAHAFBXCCCFAFAGCCACAHASCHHhAAAdCFAEBHFaDHDDFFBhAAAADFBVEFB..gGFHhABAUFAABHDAOFDD.....hABA......hAFA...,2,-9,-5,4
JNcbLKTfGPVeBZaUYWQDFHSERIgXdCMOA,JAAA..bAAALADBKAEAGAGAeAFAZCAAUCFA..QCEChAAAHFAARFDF.XEAAhABAdCCCMBIBAAIBTEFAhACA.fFHABFFBaFHBDGIBEGAB....hAFA......hAGA...,2,-16,7,23
aIbgCYVRPOeGEATfdHSDJQWUcXZFMLBKN,dAAAHAAADADAQADCUAGA.ZAFBMBDALBHBBCBA.aCAC.bDDChAAACCEA..RDCB...eFABhACAADHA.TFFASEEBhACAcFCCKEGAIHHA..gGEAhBAA...hAFA...,2,-42,3,45
YPcMBNeWXJAFESIZOfVLUKGCTbRHdagDQ,EAAAZAAAOACALADAGAFACAHA..RCBAHCFAaAHF.QEAChAAA..cCCChABAMEEBeECHXDGDABCBSFFAhAEAfCEEKGHBdFBADICABFFD.WHBAhBFAIHAA..hAFA...,1,-8,-12,4
BeEWMNdQZOXUfbLYcJDgFaHRTKVISACPG,GAAAEAAA.MADAdADAZAEBOAFEUBGALCDA..JCBBFCHBhAAAHEEARDBFKEEASEGEhAAAAEIBBFGAeFCHQGCAhAHAXGECfGGA....hAIA......hBCA...,1,-9,-18,9
DKTYIFNVCRGMbXeBfEgaOZJSUHcQPALdW,dAAAKAAA...TADAFACACAFAGAGAMAFAeBFABCCA..ECBAOCEBhAAAZCFESDADhACA.HDDBQEGBhAFAADDBLEHBDFCBIGDARGBAfFGAaFFH..hADA..cGGD.hBAA...,1,4,-35,39
KWEYULISXegMDNcVTAZJCadPHQGBROfFb,ZAAAaAAAHACBGAEARAEA.FAGAKBHB..ECAALDEA..XCGAhABAeBBDMEABDACAVEBAhBEAACGBdFDAQFFAhAEABDDBOEGBbFAD.WFHHIHCA.SFHHhBGA...hAFA...,2,-13,-3,10
USfCTcJAPbdKZMNHRIEVgLWBeOaYXDGQF,dAAAZAAAHAEAEADALAGBeAHHOCAB..aBDEDCCBGCABQDDAhABASCHHTDFAhACAAAIBbDEDMDIB.REAFgGCAhADABFHAFGBACHFA.PFGDIHHA..hACA......hADA...,2,-15,18,33
OCMSKgceLQTJUfHbIdZDWAaBYRPNXFEVG,aAAARAAA..XADBEADAGAFA..MAGBKAHBeBBBLAHBTDDAhADAfCCAHDGBdFBAhAHAZDEAADIBBFDD.PFFBhBAAFFBACFFASEHH....hAAA......hABA...,1,5,-25,30
YSFBCTHVEWOAQGcJePMbXIDdZKfgLaNRU,GAAAeAAAMAEA..bADADAIBZAGBKBCALCDBRBEF.UEABFCGDCDDDhAAAHEGB.EFEAABGAQEBChABA.JEHBhBEA.....XGFD...hAAA......hACA...,1,-15,-24,9
CFaBYRPZMLgHbVUWQGKOcNADIdEeSJfTX,dAAAEAAA.eADA..fACATAGAFCBDaADDBCFA..RAFAZCEEhAAAMCIBHEFAUEDAGFABhAFAODAHACIBSDDDhAGA.CGHAPHECbFFBWFCD...KHDChACADIAAIHHA.hAIA...,2,-14,-1,13
JNfEPWcdAGLXMFKbVCRBgYQUTaeOHSDIZ,GAAAMAAAKADACADARAEFBAFB..QAGCUCBA.eCDBHAGBDCIBhAAAZDDB.JDFBEDFA.PEGDhACAdEHAAAIBLFCDhBAA.FGGH.........hADA......hAIA...,2,-22,-20,2
OIKeEaCGgdHbVASXJZQDTNPcRBLYWMfFU,XAAAZAAAQAEADADA...TAGA..cAEDRCAALDEAhABAMAHBFCDHODHDhACAeCFFEEABGDBAHECAAFGBhADASDGAPGDCBHGAfFGA.hAEAIHHA.aGFHhAAA...,2,-30,15,45
SFXfOGecWTaDBUJIAMQENZLCYgdRKVPHb,EAAAZAAALADB.CAFA.dADARAGF.KAFAHCABbBFA.FCFH..OBCHhAAAeCHH...TDEAhAFAaEECBFADUFGAACABMFIBhABAQGDA.YDBF.PHAChAHAfGGA..hACA...,1,-7,-24,17
SNAfKGMETaCYUDeXFdLBgZWIcVJbOPQRH,GAAAEAAA.aADACACADAEAFAGA.LAHBZCDA....ICHAhAAAVBDAOCCBRDBFHEEAABGAKDFAhAAAMEIB.TGCAhACAeEEBdGGABGGA..WHCG.....hBAA......hBCA...,1,-6,-25,19
RWQfNGHLAIdJTBUOFCYeSgXEMKDaZcbPV,dAAATAAAOADA.FAGDeACE..SBDBEAFEMAIBaBDCZCAE.hACA....bCCCRCEFQDGAhAIAGCFAHFGBhAAAABIBBFGDCEEDYHAAKGHBDIEA.....hAHA......hCAA...,2,-23,-2,21
XPeEaGZCTdLMQHDVgcfYJIFKNAURBbWOS,RAAABAAAOADASACA..eAGFEAFAZBEEdCCAMAIBHCAADAIBhAAAVDGB....fDEAhACAIEEAKBEDhAAAACCAbDFDXFDCGFABLEHBQGGBYHDAhADA...hABA...,2,-19,4,23
THcIGgSPOUeXdNLCFWZRVMDfBYaQbAEJK,EAAATAAAHACA.GAFASACBOAHFeAEAdCCDLEAAhAAAFAHDRCCAMCGBBDHD.aEEBAAEAKDHBhAAAIFFAUFCACEEB.hAEAVFGBfFHA.YHAA.hCAA......hCCA...,1,7,-10,17
VLIJRGBFMTUgeKAOQCZHYXWfcSDadNEPb,QAAAHAAAXADB..fACFDAGAdBFAEBHBVAEALCAAhAAARCDBGCGAMDEBTGDAhAAAeDGFAEIBZFFF.YDCFhAHASFCB.aFED.PHFC..hACA......hBIA...,1,8,-6,14
bJSPfaAFRIXgCEUHcQBDGZYLOKWVNdeMT,RAAAXAAAEADE.HADAQAFCGAGAZCDALAHBKDAA.VCCAhAAAeDHH.MEEBJDFBSEGHhABAaFAAAAAAFFFBCGAABGHAhADAOFHD.dHCBbFCD.......hCAA......hCCA...,2,-10,9,19
MEQYBRgGcLVWadAIeTFPDKJNSCZHfUXOb,eAAATAAADAEA.KAGASACB.HAEAXBCAMAIBECCBhAAAQCFARCEAGEAALDBBhAAAaECCAEABFEGAPDDBhABACFFAfGHAOCHFbFEABHCA....hAEA......hAGA...,2,-15,5,20
ZSVfbdagUGOcFRMNXPKCALYJeTHWEDIQB,LAAAeAAAHADAEAEAQAGCZAGB.SCCBbCAA.aCEDhAAAGCEAFCHDREFBMFAAhABAXEAACFHB.ABGBTEGAhABADGDABHHAdGGD.........hAFA......hAIA...,2,-8,-6,2
TUPCReOKZBaSVDQcXILFAgJbNHfGMWdEY,JAAAHAAAGADAdADAEAFA.UCABRAFA..eCCBZBFEBDDA.aDFDDCHBhADA.QEFChAFA.XFDDLDHBhAAAACIB.bFAAMEIB.TGAAOFEBSGHDhAGAIHBAFGGH..hACA...,1,-8,-11,3
feTGLFcHWKJNMDYUXZQbBPOdAREgVSIaC,EAAASAAA.CADA.eACAGAEALAGBHAGDKCCAMAIBDCIBXBDAhAAAZDAABDGDdDAARFFA.hAAAgCCGaEEC.hABATEFAFGAA.cFECNIAB.QGBAhADA.OEHDAHHA.hADA...,1,8,-9,17
LSFNadGJVfIBARXHTDMQZKCebPUgWEOYc,HAAAMAAAZABEeACEUAFAEAFE..OAHDLBHBFCCAdCFAGCCAVEGBhAAABEFA.RFBBTFGAhAIAQFDA.CHAA.bFDDhBAAWHDA..........hAHA......hCAA...,1,-7,-8,1
LZQbcVNRWGXYfMgaKFUECOJBdSAeTHDPI,HAAADAAALADAZADBQAFA.VDAARAGFGBBA.fDEAhAEAaBHDFDFBUFGAEDGBOECDhAFAdHBBAACA.eEHHhAIAIHEA..bFFD......hBAA......hBBA...,1,-7,-16,9
HXZQeaTbFYLEcfDUBPNAIGWCVKOgdSRJM,GAAACAAAKACA.dADARAEF.HAFAZAGB.eCEF.aCGDFCAALFAA.hAAAEEHFDBIBBFEAADDA.IHAAhAAAOEAA.SDBHhACAMEEA.TGFA..bEFA.fGAAhACA.PGCAhAEA.,1,8,-48,56
BJHUWZbDIQSVPEKNRfTYcFadCMOGXgAeL,eAAALAAAHADAZADBDAFAQAFA.SBHBEAHFRCCBTCEAhAAAFCAAdDFAMCIBGEGAhABAADHBBEFAUFCA.WHDAhACAbFGDIGCA......hABA......hCAA...,2,-16,-4,12
gMdNZWIbRVBcXCEOLfHPAaDYSKFQTUeGJ,aAAASAAA.QADAeACHGAEAMAGBZAGB.IDDAhAEARCCBBAHACCHAEDHFLDABhAAAHEBAAAGBKFFATEFAgGEGhBAAdEHAbFBDXFDD....hABA......hADA...,1,-1,-7,6
MKfebZIGQFDgcBROHVLCSNXWTdYJEaAPU,MAAAeAAAZADBGACBQAFADAFABAHAHCEBLCCACAHA.SCFHhBAAXCGAdCCCECHBABBBhCAAKEGA...fGGAhAAAbEEAFGGH.........hCDA......hCIA...,2,-23,-12,11
XNfHegRBLQPEIMUVFGdAWDCYObJcSTaKZ,CAAAOAAA..JACATADAZAFB...XAFBHCBARCGFLEEBhAAAEAHFUCDB.GECAhAFAABBBDCCB....bDFDaGFDhAIAKCHBNEIA.eEHBBBHB.......hBAA......hCAA...,1,-15,-22,7
WYCaAcGHXEdSLQTNKVZJPFfMRgUeBIDbO,HAAAEAAAdADALADB.TAFAKAFAZBFEFBHDRCBBeDDGDCAB.ODGDhAAACCCCAAHAGCEA.QEGAhAAAVFAB.fFAAhACAMDIBBFFDbGDAaGDB.....hAFA......hDBA...,1,-4,-14,10
KcOEBVISQWJfCTaALDPRYFGbgMXdZUeHN,LAAARAAAGADAMAFAZADBHAFA.KCAAEBFEBCFD..SBHBhAAAQDGAJCCFTEEAhABAADAADDGBFDHH.XFDAhABAeHAAcGGA..IGGA.hACA......hAHA...,2,-19,-15,4
dMVReaSJKPUTCXfAgILcbZFDEWHNGBQOY,LAAAZAAAEADEHAFBGADAQCAAdAFBRBFFeBHHaAHF...KCAATCDAhABACEFD.ADHAgEFAhACAbFGD.DEIBNDDA.hABAOFAAMEIB.SFED.PHBChAFA.fGHEhBHA..,2,-19,17,36
JYHLMaTAeZcWUKRbVOQFgGfCPINDdBEXS,eAAAZAAAUAEARADA..OAGDQAGAGCCACCAA.....IEAAhAAAdDDAEDGASCCDhABAHEFAaCHDAAIBKCFDbFDA.hACAFGAA...fGHADEBBBEHA...hADA......hBEA...,1,-6,-26,20
NVZQDfIOgCTULGScEFRPYAdeXMJKBbWaH,eAAAMAAABADA..aADDHAEBZAEBQAGADAGAOBBBCBGBTDBAhAAAGDCA..ECGBREEFABIBhBAAdEEAKEHB..bEFD.hBCANDIA.fGGA......hCAA......hCDA...,1,-7,-24,17
NYaJMGVTXeKPOdALfUgbQcSEDIBRHZWFC,LAAAUAAAQADAEAEABAGAHAFAZBFEFCAACCDD..aCFEGDCAhABA..TDAAeCEDOEABhACAAAHAbDFA.DDIBRFFANEEAhADAMEGB.KFHD.fHDF..hAEA......hAIA...,2,-12,-2,10
AVIFWUCZMGONaDSPBcHKQYgbdRXTeEJfL,FAAACAAAGACAOACDDAEABAEA..HAFCQAGA..bCADhAAARCDFeCFGECEALDGBhACAAEAA.IEEAhAIAZEGBaEAESFEAKGEA.dGAA....hAEA......hAGA...,2,-22,-12,10
dGECAeVPLUFgXSJWYcQHORBbDTKNZaIfM,eAAALAAAFADD.SADH.JAFAcAFA..HBEBhABARBEFDAIBTCAAZDFBaCCHMCHBhACA.EDDBAAAAPDHDhAHAXFFC.QGCABEEDKGHD.fGHAhAIA....hCAA...,2,-22,-11,11
FAgIVGYSBcbXTEMQUPRLedDfaOJCHNWZK,VAAAGAAA.BADA..XADBEAFAMAIBQAFARCDA.hAAAeBHHdCGAaDAHCCDDHCEBhAAAZECAACDAIFGASEGAhACAbGDC.TGGA.LHBADEIB..hADA......hAFA...,1,-5,-6,1
VLNXHZAaIGdQeEUgcCYPJWbRTFBMDfOKS,GAAAeAAAEADAUADA.CAFA.JAFB..RAGFBDDAMAHBDAIB.KCCALDFAhAAAHDECZECAAFFAdFHAhACAQGGA..hAAAgGDA.....YDBBhAIA....hBAA...,2,-32,-18,14
TeSXWEfaYCMVGHbORAZUPJgIFBdKLcNQD,ZAAAUAAAJADAFADA.BAGAdAGALCAB..QCDAhAGAeBHH.XBGAECCBaCEB.hABAMDBBHDFB.RFDBADFBgDFBhAIAKGHBDIAA.TGGA...fDCEhBAACHGD..hBCA...,1,-6,-39,33
FIPQELZAabMUJeOHVDgcdXKTNYCWSBRfG,aAAAMAAA.UAEAeACHHAGDDAEA..dAHATBBACBEA..BBGCRDBAGDFAhAIAFDDA.QFDChBAAEDGAABBB.OCHDhBBAVEBA....XEGAKHGA...YFFFhBAA.fGDAhBEA,2,-28,-8,20
CRAfLDTUJXPMHQdOFZbEKaGYVgNIBcWeS,LAAATAAA.XADDHACBdAEB.ZAGBEAFAGCEA.gCAGhAAABAHAeCABREGBABIBDCCBhABAUFBAMCGB.QDDAhACA.bDGDaGGHYFAF.IHCAhAFA...hACA...,2,-8,-1,7
JILCfPQMegSNdacRYVDKOXHWGTAZEbUBF,EAAABAAAFACDLACA.CAGA.QAEA.eAHBSAHHhAAAaCDDRCGBDDFBXCCAhADAHEAAGEFAACCAZCEBbDFDhAEAIHHAMDIBdGAAcGBBKHDAOHFA.hAAA......hAEA...,1,-7,-11,4
ZIOYaFBJMDNQXgWRSTVfCUGLcHedbEAPK,ZAAAOAAAaACA.BADADAFA...QAFA..XAGAhABARCCATDFACBEAGCEBhCAAHFAAeDHHECCBAEEAKAHBFEGDMBBBhAFA.gGGASFFDfEEEhBAA.....hCBA...,2,-32,4,36
TaWLZHSCcYbIfPQREKXJVNUOAMdeBgGFD,eAAAGAAADAEAaADAZAEEHAFB..CBCA.bCDD....fBHAhAAARDBFEAHBKDGA.JCEBUFGAhAAAACGBdEGA.BFFC.FGHDhABA.....WDDD.....hACA......hAIA...,2,-32,-11,21
CIWPSfdbUTREZaXLDBKAcJgGeMVNHFYQO,JAAAeAAA.MAEAHADBFAHDQAFA.CAHA.IBDA.hADASBEHbCFAREEAECCBZFAAhAFAaBGHLEEAhAAAKFHBAEEA.GGEB.YCCFOHEA.WDHHhABA......hCAA...,1,-3,-23,20
JDLMSNTWCXcVaAGQgZfEHUIedFObBYPKR,GAAAZAAAHAEAeADAdAHAOCABBAGAKBHBRCCALDGBMCDA..TDDAhAAAXEAD.aEEAhABAAADAQDFChACA.EEHFFGCDPHDASFFDCHHA...hAIA......hBAA...,2,-15,-6,9
EZNeDGICYVAaMdLXWFfJPbKBSHgTRcOUQ,dAAALAAAFADA.JAEAKAGAHBCCRCAA..UCEAEBHFZCAA..eCHBhACAGCFA.CEEDAAHAaEDCMDIBhABA...fFDEhACAbEGDBGAASGDA...hCBA......hDFA...,2,-32,-16,16
SLPRHgKYeDQUBJCEIWMfabZTAVcXNdGOF,XAAAGAAASADARADA.HAFBKAGCeBHFQCDCBCDDECFBhAAAMAIB.bDGDAADAVEEBhABAdEADLEFD.hCAAPHAADDIBCGCAfGHA...hAAA......hACA...,2,-22,5,27
HbMAVRFeLUBYaWZQfXTIOcEDSGKPdJNCg,RAAAeAAALADBBADA..aAEDZAFA.QCFA..TAGAhAAAOCCHECCBGEEAhAAAdCGDCDFDHEDAAAGAFEHDYFCBhABAXFGADGAA.KHEA......hABA......hAGA...,1,-8,-22,14
AEBfDgLWJHXKOSUMZcYaPdNebIGCRVQFT,EAAADAAALADAHACAOAEAMAHBZBEE..aBBBdDDD.eBHHGCCAhAEAREFBQGDAAAIBBCFA.hAFA.fDHAhBAA.gEFDWCCD.KGHBSFHBhAAA..YFCFhCAA..,1,-11,-14,3
BQKUJFaXHLVWeIGPATRbDEcdSMONYZgCf,RAAAEAAAdADA..MADAOAFAZAEE..CBCABBHAQBFC.KCCDFCBHhAAAHDFCLCFB.hAAAeDDBGEDAADFBbDGDSFCDhABA.gFFB..hBIA......hCAA...,1,-17,-26,9
KgOdAYTaWCQUJfRMXPeEDISLcGVFbZHBN,aAAAQAAA.UADARACFMAEA.eAHFEAFASAHHhAAAGBEAFDHDHECBKCFAdDBAABBBTGEAhBAACDDAJDHB..XFEAhBCADGBBIHHALHBA.....hBGA......hCAA...,1,-10,-11,1
DHfQCLFNbBTAdPVEYMeRZJgIOXKUWcaSG,dAAAEAAA.eADARACAZAFB..JAGBOAHD.KCCDUCCA.aBHDGDAAhAAAHDAB.QDGDhADALEFAFFCDBDEDAADAVGEAhACAMFFBXECD.SGGAhAFADIAA.CHBA.....hBHA...,1,-9,-10,1
NZLAYcXOVUafSPKDWGRIdQgbJeMBCETFH,XAAAOAAAUAEA..aADA..SAGADAGARBCFdBGAQCEAhAAAJBBFBCGA.EDHFHDCBhAHAZEBAABIBVEGB.KEEChBAAIFFAeEBDMICAFFHD......hBDA......hBEA...,1,-12,-18,6
bdaOEXZgRWTAVHfISQUDCcNMePGKFJBLY,HAAASAAAQADCCADA.MAFAeAEHGBFAFAGALCCBhAAAdCADEBHBZDDFRBFFACIB..IDAAhABADEHBPFCB.BGGDhAAAaDGDXEEDWFHH.fFHAhADA.NIEB.....hCAA...,1,8,-21,29
QBVHCDMaFfPKcGOINJYSbdEXWTRAUgLZe,LAAAeAAAQADAHADBMAFAFAFEKBHBGBFA.OBHFJCCBSCGDhAAAECAA.TEDAhABAADDBZEEFCEHD.aFBAfEHAhAIAIHBA.bGFAdGGA....WHDGhCAA.....hABA...,1,-5,-7,2
PBZEbYSegfUTGFWMVdXRJQCLcaNAOKIDH,KAAAHAAAZACBEADE.SAFBeAEAUCAAGBGA.MCABdBHARCFBQCCAhAAALEDBaFAAhAAAAAHADCFB.bEDA.fFHAhACATFGA....WFEH...hBIA......hCCA...,2,-20,-3,17
ZBSGbaCJYgIXAHEdVTQcOefDUNLWPKRFM,HAAAEAAAdADATAEA.QAGCeAFADBCBLCFAKCADRCCAZDFBGEAAhAAAaDBC.CDHAJFHBgDDBhAAAACCA.OEGBhAFAfEEAUGAAPFHDMICABHFBSGCAhAGA....hBDA...,1,14,-14,28
SYAENePQMBGLbRTdfCUZaHXVcWJDgFKIO,EAAAeAAA.MAEAGACARBCA.dAEBUBFAHAGB.XBED.VEEAhAAAcDBADCBBKDHBSAHHhAAAAAIB.QEEAhABABGHA.bEGDCHGD.......hBCA......hCAA...,1,-12,-15,3
WeSTOIbQPCNBaYEVdFMLGgfUXJDcHRZKA,eAAATAAAOADC..QACCCAGBBBHA.EAEEdCCAMAHBGCFAhAAAfCDAUFAADDIBhABAHCEBREDB.AAIBSCHHhAAAIGHA.bFGBaHDCFGAA.LGDAhAGA......hCAA...,2,-18,1,19
QRUecCPNATKdbESLaHDJgIVZfYFMXGOWB,dAAAEAAALADAHADADAFA..JAHBVBGB.ZBCAFCBDGDDABCFARDCFeEAAhAAA.CAHB.ADABKDHBaFGA.hAEA.....fGGAhAFAMEFBOEGB......hACA......hADA...,2,-36,-3,33
JgAFaQbSfHORELNDeMKYPVUCGZXWIcdBT,aAAAQAAA.SACAHACBEAEALAHBeAEHKAGAVCFAhAAAGCEA.ZEAA.XEGAhAEAIDAAdGBATDCAhADAABBBbGDA.RFEAMEIB.PGAACHHA.BHFAhAGA......hAIA...,1,5,-5,10
SWUBCPZbTNLfKMgRacDAHdGYFEXOJVQIe,HAAAGAAAEADEOADAQAFCeAGFSAHHBAHBZCAA.TCDAhAAALCEA.MCIBhAAARDBFaDFEACCAdEEAFEHDXFCDhACAIGGACHEA..bFFD......hBAA......hBCA...,2,-8,-2,6
HVKScdZTAMQLNOYDREBaUXWeFJbIGfPgC,MAAALAAA.OADDRACAEAFEBAHBUAFA..eBHHFBBH..JCEAGCAAhABA..fDDAhBAACCCDHDEBSEHHhACAZEFAACHA.QGDCDEGAaGGB.XFBDhAIAIHHAgGGGhBFA..,2,-38,11,49
JGNODAEBfdHRbYgXMSFcUVaZTPeCKILQW,EAAAdAAAHADARACA...bABDXAFB.MAIBFAGAVCEAZCCAeBGHhAAAKDADLCHBhADA.QFAAhAFAGDAADECAAEEBfFFASEFAaEHDCGHA.IHHAhADAWHEG.OFCChCAA...,2,-12,5,17
TDcaQVBbfLdERUMWSgAHCIPKNOXGFZeJY,HAAACAAAKACA.XADBZAEB.eAFA.TCCAaAGDBCAA.LCCBhAAARCEFMBIBSCADhAAA.ACGAIEGAhACAOBHDGEAAFFHDDGAAQEEAbGAA.hAGAEEHB.gGDBhACA..,1,2,-24,26
VBNYXDLHCeWFKJaMRfdcbTgOZIUGAPSEQ,EAAAQAAABACA...XACAHADBeAFAKAFAMAIBRCFAdEEATFAAhAAAZCDAGDAA.ACGASDGHhAAAVGFADCCBCEHAFGCDhAFAaEEBbFCD.OEHD.PFFB.hAGA......hBIA...,2,-8,11,19
RNKPQZEDMLGgAXWcdJUHaVbOBeFISCfYT,XAAAdAAAHADAaAFA..OADAeAHHSCAACAGA.TCEAhACARBCFKBHBZCEB.EDGBhAAAMDDBGEBAADIBcEEChADAVGFAFHDC..fEGB.YGFGhBAA.QGCBhBCA,2,-20,5,25
ANSCdGEWYTBaIXbOUKQcLDZJfMFgePHVR,CAAAEAAA....TACAaACD..XAEAOAEAKAHBLAHBhAAAZCAA.MCBBeBEFHCDAhAEAACGAdDFAGEFABDHAIFHAhAAAbFAA.....cFECfEHEhAFAFHDC....hBCA...,2,-23,-8,15
HEJIFPSdUZOWMCfALQTKbGgReXYDNaBVc,TAAAGAAARADA.eAGHDACABAEAHCEBECHFFAGA..dCCAZDCB.MDABhAAAABGBLCFAQFGAhACAKEDA.XGADaDBBJEGB.hAAASGFD..OFHD.fGEAhBDA..hCAA...,2,-34,15,49
MQFHOfJgBNcXDaCeZLUIEdVYGSbWPTARK,RAAAMAAAHADB.OAFAJADBBAFA..XBFDCAHA.ZDAALBBBhAFAEDHFdEEAGGEBhAAASCFA..bFBDTEDAhAHAACCB.QFGA.fFCEhBAA.cGFChCAADFBB.aCHD.,1,5,-40,45
ULVfYKeEJWHMaOPQcFSgNRTdbIDGXBZCA,LAAAVAAA.KAEAEADEHAGB.MCAAaAFA.QCDAFBFD.hAAASDFBRCDBdCHAbFFA.hAIAGEAAZGEA.AAIBfDHAhABAeDCB.OFFB....hACA......hAEA...,2,-10,-10,0
ZIAYOUXbgGCSBFMQJPcKfedWELVHTNaRD,OAAAXAAAGADABADA.MAFA.QBFCPAFA.KBBDeBEFhAAAECHF.HCFA.aDAAhABARDBBZEFAABIBUEFBbGEASHBAhBAAFGGHfHCB.WDCH...hBDA......hBHA...,1,-2,-6,4
PTMDIFfXJBWGQLHdSUCKebNVOEcRgaAYZ,ZAAAMAAAFADA..XACABAGAGCAA.HCCCdAFACAHAeAHHVCCBhAHAEDFF..RCFAABBBTEGAhABADEFB...fFCAhACAQEGASGADbFBA.cGCDhAGAaGGC.IHHAhCAA...,2,-17,-16,1
QdNbPTWgOeZSUVGHFaMIALRJCBEKYcfDX,RAAABAAAEADE.KACA......fAFBQAECdAHAbAGBTCCAhAAA.OCEDhABAeCAAZDDASCGDhCAAGEGAHFDBaDHDAECBLGFACCFADBIB....hCCA......hCEA...,1,-13,-16,3
LgPCMebaEfNDcRGWKVSTQdIOFYAXBZUHJ,ZAAAHAAALADBCADB.eAFAEAFADAIBRCABGCFAKBGB..SCAAhAAAdDHAFEEHAAFABBHAUDDAJDGFhACAMFCB..aECB.hABA.fGHA..cFACWFDD.hACAQGGB.hCAA...,1,-13,-18,5
FeRLOKTIfPAgQSEUdGDCaZcMWNXHYJbVB,QAAAEAAAGACACAEAZACB.MAFA..XAFDHBEAJCHBBAHAhAAAREBALEEBTDFAIEAAhAEAABGASEGDdDHAaEDDhAHANIBB...bFFCFGHDeCBB....hBCA......hCAA...,1,0,-9,9
eAQdIaUVSgJMTBKcXCZEFbHYOGPWNfDRL,dAAAaAAA.SADA..MADAKAGACCBAEAGAHCEAGBBB.PBHDhBAAfDAELDEBhBBAACGAQDCDhACAIEBAgFBATEGAXGAAbEFD.OFFBhADADEHB.....hBEA...,1,-8,-13,5
GVUQPeCHKFEXTObDAZMNLIJWadYgRfSBc,ZAAAMAAALADB.JAFAdAEA.RAGBBBBAGCAAQDBAhAGA.eCGDHCFAEDEBTEEAhABADDIBAAIB.IEHAhACAaFDD.fFCASFGDcGGA.hBAAPHCCCBDC...hBBA...,1,-4,-25,21
SHMVCAITagYcdGBQfPbLWZEURJDOFNeXK,aAAA..gAAAdADAGAFAQADA..bCCCZAFBRDGFOAHFhAFAeAHFSCCBhAAAHEEBMBBBACIBTDAAhABABFBALHAAEEDADEGAXFBDCGHA.IFFAhADA.fFHAhBFA,2,-10,2,12
ODZSEXMYKRGBeACILHcFTWQaUNJVfdPgb,LAAAHAAATAEAaADD.UAGA..VAFAdCAD....bCECZCAAhABAEDCFMCFB.RDGBeEDFhACAADIBCEAAFEFAQFAAhAFA.fGFAOFFBSGHBhAAA......hACA...,1,-2,-13,11
YOPXFMZDRSHWEQAfLdbTGNJUCVaBegKcI,dAAAGAAAUADAaADABAFAKAGA......ICDAOAGDFCBDhACAZCEBRCGBHDDA.EDHFAAABbDBDhACA..TFFAhAIACFGDeFHH...gGAGPFDBMFIBSGEBhAGA...hBAA...,2,-27,-4,23
DBECeKNHYGcZTIFRPgJQfAWdObUSLaXMV,dAAAOAAASADALAEA.MAIBBAGAEBBBeAHH.HCACGCEAhAFAZCFFTEAARCGBJDBFADDAUGGAhAGAaDEBDDIB.KFEA.hBAA.cGCBFGAHPHEA.....hBDA......hCAA...,1,-3,-8,5
EgfSGDdRPQOLcTAbWaZJIHYNVCeBUKFXM,aAAAZAAAHAEA.VCAAeACH.KAEAFBHDEAGE..SCFHhABAdCEARCGBQEAALDEDABBB.hAEAbEAAJEDF..IEHAhACACFFABFHAMIAAGGAB.OFFD..hADA......hAEA...,2,-16,2,18
OKMTaDVGJYcAbXdPeFSECfgILNUQRBWHZ,dAAAeAAAEADACADA.....IAGALAFAQBEDRCCAHCFBZFCAhAAAMAIBaCHFDFIBGCBAhACAJHAA.ACHBXDFChADAFGGB.fEHA.gGFBhBAABEED.WEED...hABA...,1,0,-17,17
MDITZRAbeYKQFWdOUSPcVgCNfELGaBJHX,eAAAQAAAdAEAOAGBSACA..VCCBCAFAEAHBGCGAhAAAaCDAHCFBMAIB.TFDAhABAACHBbDAA..FEEHPEBBhAHAgFAALFFBXGGAIHHA.hAAA......hADA...,1,6,-9,15
eFGEfHTLDIRgUNcbQJadXWKPYMBAVCZSO,ZAAAeAAAEADEHADALAFBRAGFUCDB....bBGDaCHD.dEEDKCAAMCCBhAAAAAHACCEC.FFABGEEAhABADFHB...IGHAhACAgGDANDDA...cGAD...hBIA......hCAA...,2,-17,-5,12
SMHdeJaNZCFTcDGfEUAgXLKIQbWOVYBPR,LAAAQAAAOADDBACARADFHAFA.eCABaAFAZBFEFCCHTCGAhABAGDEBEFFB.ADDBKFHBhAAAbEEB....VFCBhACASGBAdGGACFADfHAB...hAIA......hBGA...,1,12,-21,33
TaeXARSGPgNLMUWKZJQVECcHIFfbOBDYd,RAAAGAAA..PADALADA.MAHBKAGAZCCAQCDAhAAA.EDCBHCGBFDGHbFABhACADCEAdFFA.aEEHAAEASEHHhAIANIAB.UGCA.JFFFCGDDfHGFhAAABHHA...hBAA...,2,-23,3,26
KLbSFAdeCEJBRfQcIYUaXOgDNWTZMGPVH,eAAAEAAARACA.QADA..IAGAaAFEOAHDDAIBTCDAhAAAGCCAHCFBLCFBhADAbFDDAAAAdDHABFFD.fFHAhAGAcFAAXFEC...WCCDhAFA.PHEC.hCAA...,1,-6,-10,4
EbeTOZDdQacVBHGAWSIMUCYXJLgRPKNfF,SAAAMAAAUAEA.CADA...JAHBRAEFKAGC..FBBAEBHF.eCCBhAAAZDDAdEBA.QFDAhAHAaCFDBDAAHEDBADFA.hBAAIFHAXFGALFFBPHFCfDHAhBEA...hABA...,2,-21,-18,3
UKSeTGDECbNOZdWgLQacPAVFRJIYHBXfM,RAAAJAAAHADBBADBMAFA.KBFCeAEH.GAGAEBHF..CCCDODABhAAAdCCALDFB.aDHDhAGAADFAFDHD.XEEAhABASEEFDGHB.ZGBA.......hADA......hCAA...,1,-21,-24,3
eTgZDEbWPCFcGUIaKHfNJVdQRBOLMAYXS,SAAAeAAAZADBEAFA....bACDCAHAGCEAaAEA.HCGDfAHAhAAAVDBB.RBEBLDHBhABAAAAATGCADEIBFEBAIEGAhAHAKGFA.dGCABBCAMEEB.XGGChBEA....hCAA...,2,-5,-2,3
cACHPZeLbgOQMNJBfREdaDVXFSIUKTYGW,HAAAeAAALAEAOACAMAGBBBCA.EBHFaAHBDCEAFBED..SDDAhAAAKCCBGDGAAAFAZEDEhABAbEEB.QFGAhAIA.fGDA......hCAA......hCBA...,1,-17,-22,5
cPaDEFLJVgNKeSOBCbdfMRAXIZTGWYUQH,ZAAAGAAAUAEAHADA.aAFAEAGALCDA.VDGBKBHBeCABhABABBHAdEEARDDAACCB...XFCBhAAATEGAQGDAhACADDABFGGHNIAB.CGGD........hACA......hADA...,2,-22,1,23
TFBecOJGRaUMELSHIdfAbWKXQCNPDYZgV,KAAAQAAACACB.DADAZADB...TAFAeAEAOAHD.hAAARCBAaCFBEBHFHCEB.hAAAdCCCADGAbECDXEGAhAHAPEFCgGDABGGA...cGGAhAIA......hCAA...,2,-23,-15,8
OaAMbfPdRVJHgDYZLXIcKETSNWCQUBGFe,MAAA..bAAAdAEARAEAHCAADAGAZBBBLAHB.XCEAhAAAKBGAEDDA.TECASDFAhBAACEADQEECGGBBeFFAhBBAAEHAfFHA.PHCA..hABA......hACA...,2,-25,4,29
bRDMLIEQaZVGdAfOHXcJFKPgNYSUTCWBe,HAAAXAAAFADAKAGA....PADANCAA.SAGAhAAACCCA.eBCHRCEAMCIBECFAZDEAhABAdECAAEEBOCHF.hAAAgFCATFFABEGBbFFCIHAAhAHAaGADfHCB...hCAA...,2,-21,-8,13
aSDQRbMIOEYUVPJWFefGHZAdBTgLKXcCN,dAAATAAALADA.KAHBCACB..aADDQCBARAFA.MCFBhACAECCBVCEB.JCHBeCGBhAEAHFAAADDAXECAhAFA.SEHHbGFAOHCCPGEC.hAAAfHABBFGD.hAFANIDB...,2,-9,-8,1
PbLUINaYCdSMOKcHEQBXATfZgJRGVWFDe,ZAAARAAAGADAFADADAGAeAFA.LCGBUBGA...aCCHdCAAMBIBhAAAKCCDHDEABDAAAAFA..hABATECAJFDA..PFHDhADA..bFGB...NICB.SGDDhCAAOGCE....hDAA...,2,-22,-11,11
DbRcWPgYZJeTCUaNfHOLQSMIGBEVFKXdA,RAAA..PAAAZADBeAFAUAEA..aBGEHAGDLCCDMBDBGDFAhAIAEDAB.KDHBAAAADDGAbEBA.hBAA....gEEAhADA.TGAAfHGFQGGAhAGA.BDEA.FHEChCAA...,1,-10,-11,1
YaKZfSJNOQGCcARXbdVEWPMLeDBFHTIgU,RAAAdAAAEADEMADA.LAHBeAFEFBFDHBDA..TCCAIDBAhACAUECBaBFAZDGB.SFEHhAAAODDBGEFAhBAAACHA.bFDD...WFHBBGHA....hABA......hAIA...,2,-21,4,25
HTFJQgIaSLXCBEVOUfYNWRDAcdKPZGbMe,dAAAZAAAGAEAeADAHAGBFAGA.QCBA.aCFHLCABhABA.BADBEDABODDDhACAfCCEYDHBhADARCGBACIBKEDAbFFDMEGB.TGBAgGBA.hACA.SFHHhBGACHEC...,1,15,-22,37
ARMFaQEHScBbPVCeNZTDgIOUKWYLGdXfJ,RAAAaAAAHADBBADA..VAFAeAEHZCFE.DCCBOAGB.KBBDLDABhAAAdAHA.XEEAhABAACDBMDABEDEFSEHBhADA.bFGDCDGATFFA.IHHAhADAWDDD......hBAA...,1,2,-35,37
OFWRQNdUJfBIZCSVYHGEXPLADTagcbMKe,aAAA..bAAAeACHFAEA.RAEA.dAHAUCEBBBEDZCGB..SCAAhAAAHEAAEFEBLHAAhAEAACAADCGB.TGGAMDDBODHBhABA.QEEC.fGGEhACA.CHBA...hBHA...,1,-2,-26,24
HMFUTRgBVdcJWZCeDaNLSbAQEXYPfKIOG,EAAAXAAA..fACAOADAHAGBMAEAFBDB.RCEBBDHAhAAAdBEAJAHBZFGBeCDDDEEBaGBAhABALEGB.ABGBQGDAhAAAKGFD........hCAA......hCBA...,2,-21,-16,5
APgcXOHeGbfLURQFYKIVMaCZEJBNdWTDS,...PAAAXAAAHADAeADAGAGALAHBRCCBQEFChAFAKBFAMCDBZFDBECEBBCEAdDAATEFAhAAAAAIBOFHDbGDCFGAAhAGA....IHBACHGD.WHEA.hBAASEED.hCAA...,2,0,3,3
DTBbZCcMYLWFOPGJXaVRdAgeHUQISfNEK,HAAAQAAASACEEACA.DAFABAEAZAFEMCCBLAGB.OCDAhAAAGCGAaCHDRDDBACGBeDDBhAIAfGFATFFAbGBChBGACHHA...YFHBWFDD....hBIA......hCAA...,2,-10,-7,3
CgLKASXIaVEJbQFTUeHYcZPNBDdRWfMGO,XAAAaAAA..EADAQADAFAFD.eAFAHBGBZCDABAHBhADARDAAMBIBGCCA.CBBDLEFAhBAAAAAASCGBhADAIGEAbEECTGAAcGGADFIB.dGGA..hAGA......hCAA...,1,2,-16,18
EcVYMeCPdaFONJLBZKUXSHbWQDAfTIRGg,TAAARAAAEADE....VAGBeACE.dAFAaCCAOAHB.LCCBhAAAZDDAXEGDHEDBbFFBhAIAQFAAACEB.hBDAGGDBYFHBMIAACDHA.FFCE....hAAA......hABA...,1,3,-6,9
ZQFfPGDSECWTBaXUALRIOJHdbNMcgYeKV,RAAAOAAAHADBdAFB.MAIB..gADAeBFHZDAA.QAGAhAEAFDGD.GCDBhAGAEEEBTGGAaBBHADIBLEEAhBAAIHCA.bGCA.cGGA....hBIA......hCAA...,2,-9,-9,0
TZGHBDdfNQXbRALWCFaEgeSVYUJPIOcMK,LAAAFAAAEADA.eADH..SAFAUAFAJCAB.OAHDKAHBGDEAhABAHCCAdCFA.QDAChADARDGBACCBCEDC.aDGDhAGAVFBBIGGA.MEEBBGGDDEIBXGDDhACAWFFD....hBFA...,2,-13,-4,9
HENFcKYMDWLGbUVSXIeCJfRBOATPgZadQ,TAAAZAAAdAEAHAGB.ECAAFACA.KAFAMDDALAHBGDABVCCAhAAAXDGA.eEFBhABAfDFARGAAAACA.aEGDhAFA.QFCAYFHF.bGFA.SHCGhCAA....hCCA...,2,-15,9,24
OCXJgDRIbGBTQPVAfZUeFLSKEaWYcdNHM,ZAAAeAAALADBEADA.aAFA....cAEDHBFAMCAB.hAAAXDEDDAHBRCCBGCEBhABATDGAQEFBhAIAAAIBFFBAKFHB.dGHACGGD.........hABA......hACA...,2,-14,-10,4
FVcdXAMTBKfNHESGbPWDIRJQeCLgYOUaZ,MAAATAAAKADA.HAFBEACEGAEA..bBBCDAGA.RBGFeCCBhAAALAHBODHDZDDAFEHBhAFAdEAAAEEBfFDAhBAASEGDIHBAQGBACFFD.YFFFhAEAaGHD......hBGA...,2,-2,-1,1
IDFTKEBVXUCNafZbYcGOdLSMHWAQPJegR,QAAAeAAARADA.FACEEAGEBAFAUCDBCAHA...aCGAZCDA...hAAA.bDFDGDGA.hABAdECAMCCBHEEBADHBgEADhAEADCFAKFABNICB.fGHA.OEEBhAIASGHH.hCAA...,2,-14,-14,0
XVNgfQRFJMbIGZTdcLCAUEKYODaPWSeBH,EAAAOAAADADA...aADDSAEAHAFA..XCCCVBCB.hAAAfCFERAGFMCBBGCEAhAIAdCHALEEBhAFAACIBKEGA.PHAAeGDGBGGBQGGA..hAHA......hAIA...,2,-10,-10,0
KcRVfUJFdNXEMbeSaQAWGYOgPCHBLDTZI,GAAAOAAA.CADAHAEBLAEAZAGB.KBBDRDCAUEGAdCDA..EBHFeDADhAAAaCFB.AAGB.....hACAgDBFDBIBIHHAhADAfDGEFGFH.MDIB.bFAA.QFFChAFA..hAGA...,1,-7,-20,13
JOGMWDAeUVIKHFCNfdXYPBETSaLcZRbQg,eAAAVAAA.HADA.CAGBdCCAXADBBBHA.EAFA..aCFBZBFERDFF.QDCAhAAAODHDGEDAhAAAMDGBADHAKFAAFEHB.fFEAhAIA.PHBCSGHD.hBHA......hCAA...,1,-10,-14,4
YCRGKJSUWPHeZAVgFTIQXfMdNOEcLaBDb,FAAATAAAQADA..MACAdAGAECCBaAEEDAHB..bCFARCCAGCFAhAAA.SBHHhAIAPDABHEDAABDBgFCAhCAAfEHEOEHDBFBAKGEAJHFA..hADA......hAIA...,2,-15,-3,12
IWDBdCTgJbNHeQfGSUPXcEMRFAZOVaYLK,ZAAAaAAALADAKADCDAGA.dAHA..CBEA.TCCA..JBGBHCEBhAEA.eCGBGCAASECDhAFAXDDAEFGBREGB.hABAABBBOHBA..VGBAWFHHBCCD.hBAANBIA......hBHA...,2,-28,-9,19
ZLPIASTYEWVFQGfCdOKaBgcUNHDJRbeMX,TAAAEAAAFACD..GAEAdACAKAEABAGA.UDGAHAGB.RCDAeDHFhAAAZDDFLEAAAAIB.SAHHhAAAVEAAQFEAhAEAOGAA.aGACgGEADFIB...hAGA......hCAA...,1,-4,-13,9
QeWKMRFUfPCYIAVEdgbHDOaLcJBZGNXST,EAAAdAAAHADADADA.aAFALAGBBBHA.GBCASCAAeBEBMAIBhAAARCEAFDCD.UEEB.CBFBABCBhCAAbEEA...OFHDhACAZFGB.TGEAKHEC.......hCBA......hDAA...,2,-13,-9,4
cYQXTNDURfFLEJHedMAVOaBPCKgGIbSZW,aAAACAAAGACA..SACHZAEA....cCAAQAEAhAEA.TAGAhAIADAFARCFBLDHBHCDAeBBDhBAAAAIBBEDAKCHBbEFBXFCCfFHAEFFBdHFDhAAAMFFB.....hACA...,1,3,-19,22
adCVTGQfgXASHORNJBeIYDPKEMbLcUWFZ,HAAARAAABADBeACEDAFA.EAFELBFAUCCAZBFE.dDGACCCA.GGEB.hAAA.QDEAhABAXEDAAAHAODGF.IECAhAIA.KGBAMDIB....cGGChBGA...WHBAhBHA..,1,-10,-32,22
dVIOZMFHKfDLaWbCEgJXTQeUABPSGRNYc,SAAARAAA..NADBdBEAOACDZBFBHCCBDAEALAHB.hAAAaBEAbCGD..ECEBXFFChABAeDFHAAAAGEGAhBHA.VFCBMAIB.fGHA.hCAA......hCBA...,2,-14,-14,0
RVQFMAUgaWYSCHdfEDBeIGXKOcNZLbJPT,aAAASAAAHACBEAEAeACH.GAEAOAGDZAGBLDEB.hAAAbEAATEAA.RDDBQFGAhABAAAIBgGBBhAEACDHAdGADBEHAKGEAcGEDNIBB.....hAEA......hAGA...,2,-2,2,4
eDCTGYQMJAfKEVaOIFgBHSPNbZRWcUXLd,EAAAaAAA.FACDHACB.SAEA..bADDRAGFUDEAdAFAeAHBhAAATEAAGCGA.MEEBhAIAAAEAKDHBOFBBBFCAZGEAhAIAXFFDCFGA........hBFA......hCAA...,2,-15,-10,5
fATCgYWGeHSZXcEQRODNPVLFMdBJbKIaU,TAAACAAA....gACAGACAHAEAZAEB.EBHFRAGBDCABPCABhAAALDDAdDFAbEDDaDADhAAAAAGA...eDHFXFGAhACAQGCAOHEEFFFBMIAAKECDfGHAhACA...hAEA...,1,4,-5,9
gDJPLAWcefYZQFCRVMXSNKBbUGdIOaTHE,eAAAZAAAQAEARADA.MAHBSAGBBCAAGCCBdCCAaBHDHEAAhABAECFB.DACALEABhAAAAAIB.fEDAhABACDHAXEFCbEGDOFHDTFEAgGBAhBGA......hCAA...,1,1,-10,11
QAFTVbEWOSYUgcDCGPKHMNXLaJBdRefIZ,TAAAEAAA..SACAUACADAFAGBEAHAEBMAHBLBGBhAAAaCCBdDAAREBA..eDHHZDDAAAGBhAAAFGCDbEGDOFGH.hADA.gGDA......hAIA......hBIA...,2,-9,-9,0
HQADgbNRXOYWUBTPcIEJdMFGSVLfeKZaC,DAAA..bAAARABAOAEAUAEABAGA....TBEAICAAhAAAEAHF.dCHAGDCALDDAhABAeCHFaEBBHEEBAAIBXFDAhACAYEHBcGFD.....hBAA......hCAA...,2,-17,-15,2
PNUEAaRgcWOLedKYZVQMIXJBGCfTHbSFD,RAAA....gAAAOADAeAGFdADAZAEBMAIBXAGAGBDACCCChAAAHCFB.FCCHDCHBPEEBhAAAEEGBAEIB..aFCBLDHBhABAKFEA.YDBFIHHAfGGEhAHA.SHCGhBDA.,2,-18,-5,13
BfHLAMaKOSgZbXIPNFRYGDdTUecQVJECW,aAAASAAAZACB...XACDIAFAFAEARAGFGCEAdAHAeCDAhAAAQEBAEDFA.hABABBBDHEBAABEBMCIBhAIAODHDbEGDPFFB.DHBATGDA..hBAA......hCAA...,2,-10,-3,7
DNedBQScJYZELXICWOMgTGUfAKHRbVaPF,HAAARAAA.aACADADAeAEHdAGAQBDA..SAGAhAAAJCCFZDGBLEEBCCCAMCGBGEEAhAGAAAAA.KCHBPFCBhAIABEHDEGHB.IHAA.OFDHhAHA.....hBGA...,1,1,-32,33
ZcbITHCaQYFVNOgLWKJEBMfXDAdePURSG,eAAARAAAZADB...IAEAHAFAaCCB.QCFBFAGAOBCCLDABhAAAKBGDBCHAMCIBDDDAAAAAhCAAdEEA.SEHDhABAGEEA.TGFACEHA.YHAA..hADA......hAHA...,2,-34,2,36
RNdWHXFPcYBOCDGIMTbUZaVEALfeSJKQg,eAAAKAAARACF.dAEAHAEBFAGA.....PAHBBBCADBGBGCAAMCHBhAAAUDEBZDDA..EEBBAAGBLEHBhAAA.SFFAhACAQFDANIAB.XFGA..hABA......hBEA...,2,-33,-6,27
dRLIBUFSXeENQPYcHKGZVabDCTWJMgfOA,RAAALAAABADBFAFAeADH.EAFAQBED..PAHDhABAHCCBZCGBbCAB.TFDAhAAAMCFBOCGBAAIBdGGA.SEDBhACANDIA.KEHB.aFAC.CGGAWHEGhAFA......hDAA...,2,-15,-9,6
cKVPSbRTZYQBGIWJHDgfCNMOEeXLAUadF,dAAAKAAA.SADARACFZAEBBAGAGAFA.JCBBHCAB.DAIBCAHAMCIBhACAECGB..LEEBhAAAAADAaDCD.FECD..PEEBhAHATGGA.IHCAfFHE.eHDAhBAAXEGA..hACA...,1,-14,-25,11
KUBfdgVPcaDMCbNEAZHeLGYQITSROXFJW,HAAAeAAAGADAQADCSAFARAFFFBHDKCADBBHAdDDA..VEGBhAAAaCCHMCGB.bDGDAAHAZFAAhACALFAATGEAXFDDhAAA.........hAFA......hCCA...,1,-3,-6,3
SbKAWEYHPCTdUIXQLgFJZVGBecaNDOfRM,EAAAHAAA.TAEAdADAUAFAQAGCLBCDFCAHZCFEGCCABAHAeDDHhAAAaCGEOEFA.hBFARFDFbFFDAEGA..PEHDhCAACFHA...XFFD....hCBA......hDAA...,2,-22,15,37
EOAGWIRSLTbZNXBgDPedCJYMcfHFVaUKQ,GAAARAAALADBZADABAGBDAFA.eAHHdBFACAHAMCDB..HCGBaCEB.hAAAQEECAAEA.hACASCCDbEFA.hBAAXFCBgFEGPFHDcGDC.FHGEhBCA......hDAA...,1,-13,-15,2
EWdZGSINJYTKHQRACDPVgceMUfbXBLaOF,DAAAVAAAeABA.UAFA..bADBLBEDFAFD.ECCBZAGBGDFAhAIASCDD.IEFAhAAAYBHBHEGBhBIAAFDACFHA.gFDBMHBABHHA.....hCAA......hCIA...,1,-15,-17,2
WGCVfeHdIEMDFUaZABcPgQSNOTYbRJKLX,BAAA..gAAAQACAOADATAEARAGBLBDBhAAA.GCFAfAGBhAAAHFCAECCFMCABFEHDZCCAhACAAAIB.SCGANIDB.bEEA.XGCAhAIACHHB.eFHH.DGGBhCBA...,2,-17,8,25
YMUDFZJKCGETeOLfdWbNHIPRBaQAXcgVS,XAAAVAAA..MADAFADAZAFB.CAHA.EAGA.eBDFLCDBhAAAdCFA...bCGDHDGBhAAARDBFQFEDABIBSEDHhBFADCIBKHGAOFFB.fGHA.hABAIHCA..hCAA...,1,-9,-21,12
FAVSWPgbUIRXBdEQOcMYKTDaeCGLNZJfH,SAAA..gAAAUADARAFAdCHAEADA.QAFAhAAAMCCBKDDADDBBeBHHGDFAhAAAZCCAHDAAAFDA.PEEBhABAXGAAODGH.YFCBaFHDCHDA.JFHBhADA......hAIA...,2,-16,0,16
GQXAeZHWdMDaSTNgFJPIbEYKVcBUCRfOL,HAAAdAAAaADATAEA.FAGAJAGB..ICCAEBDB..KCBABCADhAAARDEBLDHBGCEBACHAhACAeEBBZEAAMECADAIBSGABhACAgEFA.PFHDbFCD..cGEChAGA...fGGEhBAA,2,-11,-11,0
AaZWdELRgXKeJfMFVbHNUYSCPTOIQGDcB,ZAAAEAAARACAKADC..eAFEMAGB..FBFDHCAAUCCBCAHA...TDGAhAAAQDEC.GDGAhABABCHBADAAdECALFEBhADAJHAA.fGGANIEB....hAIA......hCAA...,1,-14,-23,9
KHSULCGPOXdQcfbNMZVDegAJEBaRYWTIF,EAAARAAA..TAEAKACAHAEBLAGBGBGAOCCBdAGBQCCChAAA..bDADZEAAeCHHhAAAAEEAaEFDIDEAhABASEHHCEFAXFGANICB.MIAA.DDABBHHAhAEAFGCE.....hADA...,1,7,-4,11
KDJcHMYQBEbfVUOLXWNGZRPTgaACSeFId,eAAAdAAADADAHADA.MAFAQAFABBGAECCB..VBDBLCFAhAAA.XEDAhABAGCBARDFATEGAAAIBFFFHKGDBhACAcGECfHBB.OHFE..hBAA......hBCA...,1,-2,-16,14
ALCEHgVMFKRbZOdTNYSWcXfJaeUPIBQGD,EAAAHAAA.MACARACAZAFBdAGA...TBDASAHH.XCCAhAAAaBHDeCCB.IEEAhAAAGDAAADABLEGBhAIACDGAFEFHODHDYFBAfFCA..hADA......hAFA...,2,-21,-1,20
NgcIXVFJYQbUaGRTBCZKLHAfdSeMEPDWO,dAAAeAAAEADADAEA..OAFC..gAFAXCAAFCFAQBCAhAAAUDDA.RCFATECAhABAZEGBLHAAHEEBAAIBhCAAMFIBPEHB.NICB.IGEA..hACA......hADA...,2,-21,1,22
AgBRXFdfLCJbcOGSQPaeNMHWITZKEYVDU,RAAAdAAALADBCADA..JAFAOAFAGBDBQBFC.eBHHhAAAHCAC.TDFAhACAEDCBDEEAACIBXEDChADAFEHDbFCA.SEHHaGFD.MHDAIHHAhABAYHFG....hAIA...,1,-1,-26,25
WaRgADXLCGBMOHUEYbVTPSdZeJNcIfFQK,LAAAGAAAMADAHADBEAGAVAFA..TCDAdCAAeCCB.JCHBhABAICGAFEEA.QEBAhAAAaFAAAFIB.CDHAOEFBhACAbFDD.SGEDcGGA.KGGA.hACA......hAFA...,2,-6,-6,0
YBFIWECPUaAJLGXeOTNZDfRcQKdVgSMbH,GAAAeAAAOADCZADARBGFKCDAdAGA....SBHHHEACFEEAEEHFhAAACCCAUDEAAAEA.LECBhAAATGAA.DEGA.QFABhABAMIDABGGDIFHAaAGA.XGGChAFA.NIAB....hACA...,2,-12,-4,8
OWXYRPKJDCATaQFgUbHBcLGVfZENIdSeM,aAAAQAAA.FACEbACDHAEB.LAGBGAEAZAGBECDBdEFAhAAAeCHHMAIBXEAAhAEARGBAKFHBCHEAAAGBTFFABHHD.hBGAfGEE.IHHA.OBBBhBAA....hBEA...,2,-9,-1,8
GcYFObXKIRMVHDBNUQTadLgPZJESCfAeW,eAAAGAAAFADDOADAKAFA.RAGBHCDABAHBUCFAaDBD..dEFALDDBhAAAZEGBEFCA..SGCAhAAAACCB.WFHHhACAbFABMCIB.DFFANIAB.QGGA.hAIAPHDC...hBAA...,2,-21,1,22
UgdeGbaVCAFMOLSRcfPDQNIKBZYTEJXHW,MAAALAAARACA...fAEAQAFCKAGAZCCA.EBHFHCAAhABAUDGBeCEAGECAaCHDACCAhACASFFADEABBEEATFCAhAEAWBBD.bFGBFGHDOHDC...hAHA......hAIA...,2,-9,2,11
aIcRZMOFEWTAXfJSBLUYdKHgePVNCQbDG,XAAASAAALADAdADAHAFA.eCCBVBGBQCEDhAAAGCDAaDCBRDGFZFAA.MEFBhABAEEABAAAABCHBKEHBgFFBhAEACDBDDFIBOHACFFCDfGGEYHAA..hAFA......hAHA...,1,4,3,1
ZOKBDAVbUFPceYQITEgWaCMSfXRGJHLdN,UAAAFAAAeACHQADA..EAEAaAFEMAHB..XBGAhADARCEBHEAAdEHAZCDABDHDhAGAAAIBbGBA.PEEB.IFHAhAIATGFACDDDfGFA...hAEA......hBAA...,2,-14,-13,1
RJTUZSaHGXNYeCdVfMgbLOKAQcPDFIBEW,QAAADAAABACARADF.UADAZAFB.HAFAGCGAXCFA.eDBAhAAAdEEAMAIBLEEBABBBFCCHhAFAEEGB.JHAA.aGGCCFCA.hBAA.....fGFA.OHBAhBHA....hCAA...,1,2,-31,33
fRHSETIBPDdXgacWJFYbMCeLZGQKUNAOV,OAAARAAAHADBEAFABADAdBHA..aAED..JCCFFAGAMCGBLCCBhBAAGDAAQCGAhBBAKEEBAAAA.SEDHhBGATGGADEIBXFED.gGGBYHCA.hADACGCD......hAFA...,2,-15,-10,5
LfQNdWGVAODRXHPFMbaYgIeBJcEUCZSKT,RAAAHAAAMADAaACA.....IAFAeAFABBDAEAHBZCCATCEAhAAALCFBQCGChABAdDHAGECAABIBXEEChCAAFGGAYHEAgFGA.JCCF.CHFD...hDAA......hDBA...,2,-12,5,17
CbSLYTJKcGMWDQIZOEXFfeBHaRNAVUdPg,dAAACAAALACAJADA.GAFAMAHB..DAIBZCCA.EAHBFBDHBDAAHCBBhACARDGF..AADA.UDGB.hAAA.bECBTFCA.hAIAKEEBQGGB..XGAChAGA.eFHB.aGGH.hCAA...,1,-14,-17,3
SQLTXNdFgZCVcKaDUfYHIGPJBeObRAMWE,EAAALAAA.TAEAdADAZAEB.CAGAKBHBaAGA..DBHBUDBA.HDEChAAAGCAABBCCeCCBhABARFFA.ACABMCGBQGCAhAIAFDHDgEDH.fGGAhACAIHHA......hAEA...,1,-15,-16,1
MQGDIOVWdNHBZeEJcKbYUFLRCSaXAgPfT,...fAAAMAAAGACBOADAdAGAHCCAeAGF.ECHFKBCAbDFDFBHDhAAA.RCAB..CDDAaCFHAAIBTFAAhAFA.QFCChBAADEHBIFFANEIABBBD......hCAA......hCFA...,1,1,-22,23
BWaRETIQDVXZYObLgUMKJACPHNdGefScF,HAAAGAAAeACESADABAFBRAGF.EAGATCCAQCDA.XBGAhAAAZCEFbEGBLGDAhAAAMDABADCBCDFBdEHA.FFFBhACAaEEHIHDADFIB.OHFC.KGAANIAB.hAIA......hCAA...,2,-3,12,15
QBFAPTeMWILZNfODRXYdESgcaJbCVKGHU,eAAAMAAALAEAZADBOAFCRBBA..dCFAEBCF..SAHHhAFA.aDDBbCED.KCGAHDGBhAGAQEGCABBATFDAhBAAIGCADGGB.YHAA...hCAA......hDAA...,2,-17,-13,4
JXfWTgROANeSEMHKIZGCYDVBaUbQLPcdF,eAAAEAAAHACAZADBGAFADAEABAGAUEFBLCCAdBHA.FBHD.JDFBfBCAhAAA.TFBAhABARECBAEEBMEHB..hAAACFDBaFHD..........hAHA......hAIA...,1,-17,-25,8
dBPMARZUbOeQCgJYIGENVcKaLXTFHDWfS,RAAAZAAAOADAeACEQAFC.CAHB.gAGA.JBDBhAAAGCCB.ECHBVDFAhABAaEFATFFAHFCAfFHAhAHABHHAAFIB........hCAA......hCCA...,2,-24,-16,8
EHaYdSVCLIGNXfTeRFPAgDQOBJMbZUWcK,QAAABAAAMACAZADEUADA.KAFAHAGBdAHA.CCBAGCEA..hAAAfCFARECBAAIBDDIBOEHHhBCAbDBA..EDGAaGFDhCAASEGA.IGGA..hAAA......hBCA...,2,-30,-15,15
EWQDHBOFIcKTYXSgUfNebGRLMAdZVaCPJ,ZAAAaAAA.CADB...EADAQAFAHAFAFBBHKCEA..TCAA.hADASBHBfCHAhAHAeCEBRDCBAEEAdEGDVDGBPFFBhAIADDDBOEEH.IFAA.XGGAhABA.NIAB..hBAA...,1,-5,-17,12
ADCWVcJRKgPSYQOEFZbHXNefMdaBLITUG,CAAAVAAARACA..KAFC..SADB.QAFAEAHFZCAAHCEAhAAAeBHHdECDaCDCLEGBhACATEEAADGBDCIBJEHB.hADA.gGCAOFAAFHBA.....hCBA......hCCA...,2,-22,-6,16
HgJQDRBGaZOEXATKSFcMNVdPWUfIeYbCL,TAAAFAAAMADA..dACAUBDAeAEA.CAHAHCDAQAGABCGBZDFEhAAAECFE.AAEA.KDCD.SDGAhBAAVFCA..fFHAhCAAbEEC.LHFADFIBaGGB...hBIA......hCAA...,1,-2,-26,24
GEcbgKRMJXFHDILeZWONBVUYSPaQTAdfC,dAAAGAAAEADA...bADARAFAMCCA.FCGDHBGB.LCDBhAAAeDAAZDEFOCFHBEHAUGAAhACASAHB.aDAHhACAADAACGHAKEHBDEEBIGFA..NIDB...hADA......hAGA...,2,-17,-2,15
XcSVNIfRTYOKGFAQDEWaJHLgCZePBUdbM,EAAAaAAAHACBLADAZAEABAHBdAHA..MBCBSBBD.VCEAhAFAfCFA.hAGARDCFTEFAKDHBAEEBQFFAhBAADDIBgEAD.eHBA.PHEChAAA.....hCAA...,1,-1,-22,21
IBRXbPdZFLWNOQGYJgaMKAeCVHcDUETfS,eAAAHAAADACAEADA.SAEARAFA..bCCAZAGBLCHBOCCAGDDBhAAAJECA.aDHDAAAACDGAhAGAUFAA..TGDAhAIABFGDdGCAFFGH.........hCAA......hCBA...,2,-15,-9,6
IJYTOKEaBPeDgMHZfWQRAXLGCSVdbUcNF,GAAASAAAdADAUAFAFADA...JCHBTAGA.KBCAEDDAaCDEhAAAeDBH..MCGBhABAHEFBZDGBQGDChAAAAEEALGAACAHA..........hAGA......hAIA...,1,-13,-28,15
gfedbMEUaAJKNDGHRPIcYTVWBSXLZOCFQ,KAAAGAAAHACBRADA...IAEATBGABAHBLAGBZCDAFDHDQCAChAAAeDAD.bCEDEEEBhAAAAAIB.DFCB..cEGAhACAVGFASGAD..CEDCdGBA.hACAaGGB.....hADA...,1,-2,-7,5
KGOQIAMbcXWZaJFEdfeTYLVDHCgBPNSRU,MAAAXAAAZABEFAFAdADA....eAFATBEALCFA.HDBAhAAABBHASEDAhABARCCBGDGAQFEChAIAAAFAbEGBaGCAEGFB...fHCBDGDB..hBDA......hBIA...,2,-21,-4,17
GKEAMcLfHXIWedDSVTFBQgNZbPaUJOCYR,MAAALAAAHACCXADDeAFEdCCA.SBBDTAFA.QBFDhAIAZCAAaAHDUDFACDFAREDBEDHFhBAAADIB..IFAAhABADFIBBFFBbEDD.OHACKHGA.fGGAhACA.....hCAA...,2,-4,1,5
FeTKdRaNIAUDGWVfBJLMgZXbcEPSOQHCY,GAAAVAAA.BADAMADAZAEB...XAGAEAGAOBDCHCFBFBHDhAAAeCDDdDDA.RFFAaDAHADGBDEHBhBFA..JECFLFFBhCAA...........hAAA......hACA...,1,-15,-24,9
WTDSAFZMUYeNPCEBOJIgdbcKVQGHaRfLX,ZAAAMAAAeACE.CAFB.EADABAHAOAFC..JCCFdBBA.KCEAGCFAhABAHCGBRDCBLCHBhAHA..TFEAACFBFEEH.hCAAYHAAIGHAcGFDaHDA....hAHA......hAIA...,2,-21,-20,1
TXGUIKMJBFRWDNPQfadACHeZbLESOgVYc,HAAAeAAAZADBEADEOAFA..gAFAVBFB..TCCAhAAAGCGAKCADMAIBFDHDRECAhACADCCBQGFAhBIAdDFCAAAAbGAASDBD.XGGA.hCCA......hCEA...,1,-2,-3,1
eFdVWLGZAYIHEOgSTNfQbUBcRJaXPCDKM,HAAAEAAA.SACE..TACAQAFAbAEBBAGARCCAaBHDhAAACBHAMCCBeDFFdEHALDDAhAAAACCAOFAA.fGFAhAFAcDGDXFFCKHBA.FGCA.WHDAhAIA.....hAIA...,1,-4,-10,6
bVFJOfLCdMAGRWPSDIKBeZgTXcHENaQYU,RAAASAAAKADCZAFB...TADAHCCBEAHFaAFA.UEFA.FFBBfBFAhAAA.dCCAhABAAAAA.GCGADCIBeFHHhBFAXDAB.QEDAYHDA.bFFD.hCAAOFHD.MAIBhADA...,2,-18,-8,10
UaQfZXdbAIBHJNYGPOELReWSDgFCVKMcT,HAAAJAAAGADAEADERAFF..eAHHDAFA..CAHA.MCAB.UCCAaBFDZCGBhADAdEFAADIBBCCD..PEHBhAAALEFD.SEHHhBAAFFADKFDB.TFBA....hBFA......hCAA...,1,-3,-32,29
MGYUebgSAZdPBNXaOKLDQCHJERWFTcVIf,dAAABAAAaADALACA.QAGAHAFBRBDBTCBA.VDGBhACAMCCA.GCEBUGGBeAHBhAIAbDAAAADAZEEA.XGAAhAAADEFB.EGGB.FHEC.....hBAA......hBCA...,2,-9,0,9
IUZKOeSMXPdBRQNWCabfEHTFGgADJYcVL,DAAAJAAA...VACALADBZAFB.eAFAMAIBdCCC.RCFA..QEEChAFACBBD.aEHBEDDBhAFA.HCGBGGABAFCAIFFAhBAAOFHDSGGDBFHANHBB...hBHA......hCAA...,2,-30,-6,24
gEHPOWfBDMQYUeZXRFIJKcVdCbNaSLTAG,EAAAHAAA.OACABACAMAEAQAFA.eBHHRBCAFAHDKCCAdBFACCEB.hAAAaDECLEEB.hAAAADGBPHBCDDHBZFFA.XEGAhAIA.IGGA....hBHA......hCAA...,2,-37,-7,30
YcMJQEIKPbVCTegUGDWHFRSXOLaBANfdZ,dAAAZAAAMACAEADA.KAFA..VAFA.eCAAGBDAHCEARCFFOAHDhABAaCHDBDDDACCB...fECEhACAJEHB.QEFDhADAbFCA.CGGD.......hAIA......hBAA...,1,-11,-26,15
YJRIaHgPTBQNZLEdMVbAWCUcDOfKFXGSe,CAAADAAAKACAGABB.eAEERAEFHAGB..TCDAQCAAZCFBECHFhAHAdDCA.MDGBAAIBUFCAhBAAODHDFFGD..SCCDhCAAIEEAaEAH.BGHDNEIA...bGAAhAAA.fHEBhACA...,2,-22,-5,17
FECZONTWSQRVgeJULbDMAXBaGfPdYcKIH,aAAAGAAA.dADAKADAHAFAEAFE.ZCEE.TEFAQCCA.RCEAeCHHhADALEHBDBBBAAHAfFAAhAAA.cFCAhACACEFAOFCB.SFGAJHAEMIDA.BHHAhBAA.....hAFA...,2,-19,-4,15
eRULcHCSBGZIDWMJNXFagdYbPTfOAVEQK,EAAAeAAARACA.LAEAHAFBBAHAZBAEDAIB.MCEAXCCA.aCHDhAAAdDDA...bDEDTDAAhADAAAAAKDGA.CDFDGFABhAFAIFAANHDBFFFA..gGAAfHABhAHAOFHB...hCAA...,1,-2,-13,11
QFRUfeEYKCHaMGIWTVDdbABZSOcgPLXNJ,ZAAAOAAA..PADALAEA.XBBAQAGA.RCAAeCEBhABAEBHFCCEAHCFBGDGAhACATECAdFCAACGBSEEDhBIAgFABFEHD.fFFEaGEEMIDA.hCAAIHHA.DGABhAFA...,1,6,-19,25
dUVGWDJMBAbSIXLTaRCFEcKOYeHNZPQfg,SAAALAAARADFEAFEOACD..HCAAZAEAQCEAhAAAdAHAGCEADDGAMAFAAEHAbGCCTECAhABA.aBHDFGGAKEGA.hABAeFFB...fGDA..hCAA......hCBA...,2,-14,-6,8
ADeBRPEMLGIHQWJbYcZUdgaVKSTCfNXFO,eAAARAAAEADE.GADAHAFBQCCAJAFA..bCFAZDFA.dBHAaCCHhAAASFAA.hABATFFAfEFAhAIAFHAAAAAABHFDMDBBLFHBIHHA.cFBDhBDA......hBFA...,2,-15,3,18
QKDNOVJadEFASBReXZCfLbYTIcUgMPGWH,RAAAeAAAZADBLAGB..bADA.TCCAIBFA.UDAAhAAAMAHBGDEAHCEBQEAAhAAADAIBODHDaGEHhABAEDHFAAEABGGAfFGE.gGDAhABA.....hADA...,2,-19,6,25
McLDeFUgXQfdHBWZPEOVNaTCYJAKSGbRI,GAAARAAAMADA.LADAFAGD.XAGDdBEAHCCBZCDAECHFODGDhAAA.aEACTEFA.hACACFEDAAAAbECBDEIBeEFD.hAIA.gGDGBHHA......hBIA......hCAA...,1,1,-20,21
WfIQJHRbYeGEDCAUPcXTBSgNOVZKMadFL,UAAAXAAABADA..SADAOAEDZAGBaAFDLDAA.hAAA.fAHAhABAQEDAHCDARFFFeCHHECHFAADAhAHATGAAgEFB.KDCDdGCAFGHDIHHAhADAYFFFDAGB..hBAA...,2,-13,1,14
gNPGfXYUETcHLeDFWIVSBaKORJdQZACbM,MAAA..gAAAGACB..XAGBEADAHAFAeBBBFCCAICHAhAAABCFAaBHDRDCFdDAAhABAAEFACEGAbCED..fFAAhAFATFGALHAADEIBSFFDOHEC.hADAQGGC.hAHA...,2,-6,1,7
RXGPJZTbdaEUYLDVSHFfNMKCIAeQWBgOc,eAAAQAAABADAOAEDRACAGAFA.ZDAAdAGAEAHBLCCB.hAAASBHHHCDDfDHAhADAMDGBCEEAAAAAgFAAhAFA.XFEATGBAaEHBDFIBFHDAhAIAKGHB......hCAA...,2,-21,7,28
SIeJCTDRGdPVLaAXYZbMQgfWEcNHOBKUF,ZAAAMAAAQAEA..fADAEAGAHCAAKBHBSAEHhAGAeCEBTDGARAGBdBBALDDAhAIAAACAXEAAbEFAgFGAhABAcFDABGCAFGDA.CGGADIBA...hAEA......hCAA...,1,1,-6,7
TUFaBNAEgKHYcWLbVDQdGefRJCMXPSZOI,EAAAHAAA.....cADAbACADAGAGAGARBFF.MCABSBHBhAAAZCCATECAaCCAAADAKEGDhAAALEEAdGAAeEHHCFHAOHDAhCAAFGDD.BHHAYFFFWDDD...hCBA......hDAA...,2,-19,16,35
IYQdLcMUGCaEBFRJfVNebPWKXgHSODTAZ,ZAAAQAAAdAEAMAGBGACB.EAGERCAAJAHB..fCDEhAAA.eCFAbDECKEBAhABAHDAADDIBACFALEFAhADA.CFADaGEAFFFAPHAAWHEA.SGHHhACA....hADA...,2,-26,13,39
HGQIYPJARcXOLedaNbBfKWMFTgDCSZUEV,RAAAOAAAeADE.dAEA..aAGABAGA.KBBDMBEBFBHD.DBHBZCDAECCBHDBAhAGAGCFA.QFCAhAAAIEHAJEFFACFBLFHBhABA.NICB.bGCC.....fHGFhAIA..hBAA...,1,-3,-30,27
LHcaQONRdKPIDZASbMVJEgWGXeCFUfYTB,MAAAEAAAGACA.eAEAFADDUAFA..TBGAHBBBaBHDQCEDhAAARDEAdFBA.KCBDDEDBhAIAAAEAbEFAJEHB...XFEChAIACGFA.BGHDOFDDPHEC..hBCA......hBIA...,2,-20,-2,18
BXKHcFbLIYSdJDWgTaANQPeCGUZVMEfRO,QAAAeAAAGADAZACBEAFARAEABAHBHBGBFCCHLCEA.SCHHhAAAdEFADAIBTFAAhAAAAEEACEFA.MEIB.XFDBhABAbFAA.IHFAYFGB....hAFA......hBCA...,2,-25,8,33
DJgERPFQaCKTBZHeXNVUYbMAIfOcWLGSd,OAAALAAAdAEADAEA.EAGARAGBFBBH..aBCEKCFBZBFAHDBC.eDHFhAGAXCAC.UDDAhABAbFEB.ADGA..fEGAhACA..cGGCSEHH.hAIAgGEB.hBAACHHA...,2,-24,-15,9
PZLEDOBTVbgWdRFJYIAUXcaQSKfMNeCGH,XAAAaAAA.KADAMADA.eAFAHAFBZBBAEAHBBBHA.TCFAhBAAbCDDdDAA.RDGBFDCBIDBAhBDAAAAAUGGB..QEEChBEANIAB.CDHALFCBDGFB.OFHBhCAA....hCFA...,1,0,-14,14
gNWHAKLGXeIQPBRaOZSJFbfdMcECYVDUT,GAAAeAAAQADARADAZAGBFCDH.dAGA.ECCBCCFC.DAIBUEAB..TDFAhAAA..gDGAhAAAHEDBABFALDHBhABA.XGGCBFEAaFHD.SGAHhACA.....hCAA...,2,-23,-8,15
PKUTNDALVJOYegFEdfCZQcSXaMRbGBIWH,LAAAOAAA.eADHEADAdAGAZAEB..QAGAXBBCRBEBGCAAhABABCHAHDDBKCGDTEEAhACAAAIBJEHB.FDHD.CGGA.aGBAhBAAMIBA..IGFA...WHEGhBGA.....hBIA...,1,-9,-13,4
ORTdcfeBLCJbaDNAGYWQMVSXPEUIZHFgK,GAAAQAAAMADASACAEAGA.ZAEBHCDAKAGA.RCGFdFBAeCDDhAAALFEBCCGA.aEHDhAAAACIBVDABXGGCIEGAhADAgGCHOEHDfDCEbFEDDGCA.hAIA......hCAA...,1,13,-10,23
dDeEUKXgNSTPaABQFfJGcWYRbLIOMHVCZ,QAAAFAAAGACA.......cADARAEAbCEALEABhAEA.MAIBHAGBZEEAhAFAeBDBEGCAKGEAXDEDhAAANEIA.TFAAAHHB.fDGE.hAHAYEHB..hAFA...,2,-29,1,30
LBTJMZXcfCdGbIRaUWNOgASHVDeQEPKFY,HAAAeAAAEADAFADALAGBBAFA.MAIBZAGBXCCACBFA.GDEAhAAARCAAaCEHUEGAOCHDhABAAFDADFFBQFCChBIA.KGGA..........hCAA......hCBA...,2,-25,-11,14
JadKDfVEWGYPeNFOCXZRTcBgISQHbMAUL,LAAAdAAADADA.EAEAGAEB.eBDBOAGDZCFARCAATCAA.hACABCCBSEFAhAHAHCEBAAIBaCHDKFED..fFHAhAIAVECBPEABCHCA.XFGA.gGFGhABA..hACA...,1,-9,-18,9
NLcedIgTYfaBCPWbKQSDAGVMZHXUJEORF,GAAAZAAAHAEAUADAEBHFRCAALAGB.eCHHdCEDTEEA.hAAAaDGECBFBbDBD.QDDAhACAAACAMEABOFHBhABAFFGHIGEAfHAF......hAEA......hAGA...,1,-6,-9,3
KJIAQFbEecgDWXdCVMYfZBULSTNRHGOPa,QAAAEAAA.eACADADAdAGA.MAIBZAFBLBHB.hAAATDAAHBCAGDEAhBCAaCDBKEDAACHBbDGD.gEBAhBEACEGDfFBASGBAOFHD.IHHAhBFA....hBGA...,1,-8,-21,13
cFOAfXdPUHBZQVEgRLSNMKIbTWDCYJaGe,dAAAHAAAZABBEADERADALAGBMAFA..bBDADAIB...CCEA.aBHBGDCAhAEAeCABOCCBhAAA.ACIBXDEChACABEEBQEGASEGAKGEAIHHATGGAYFDFhDFA...hBAA...,2,-29,14,43
MSeWBcCKQVYgLOIZbXfaRNFDAGUJPTEHd,GAAAUAAA.JADAEADAHAGBdAGA...eCDBBBEAKCFDQDAAhADA..gDGAhAAALDDAZDGBbDBDaFFChACARFDBDAIBAAIBMFIBSGBBCGAD.....hAGA......hBAA...,1,-6,-19,13
WUcaXeNCLPQFEDOGZJVfdKIRHSYbAgTBM,TAAAMAAAUAEA..aACAeAHBLAFAQBBAEBDBGCEAhAAAZCEE.VEGBdEBAREFAHGAAhAGASFEDACCBBCGAWDDDhAHAXGBA.CGHADIAA......hAIA......hBAA...,1,7,-14,21
HbfGIQARcYUZeJFTCKdaLNMVDPOXBgSEW,RAAAUAAAeADEFADA..KAGCdAGALCCA.MBIBDAIBXBDChBAA.BDEAECGBHEBAhAAAGDFAABEBZEEB.TGGAhABAaDHF..PEDBSHCG..hCAAfGBA.hCDAIHEA.,1,0,-34,34
bfHREPaOWJUdKZFYDeALNTIBQGSCcVXMg,TAAAQAAA.GACBCACB..XADDbAGBHCDCRAFAECCBaCHDODABhAAA.UEEBhADAZCEEDCIBADCBLFHBhAFABEFASEGHMIBAfGCBPFAAJFEF.hBIAFGAH.....hCAA...,2,-13,11,24
LPMWQGTJdBUFaIOAKVgeZcDNRHbCfSYXE,KAAAeAAAZACBDAEAHAEA.CAHB.SAFA.EBCAMCABGCDAhAAAdCEDFCHBaAHD.AEEA.gCFBhABAREFB.bFFAXGAAhAAA.LFHBPHFCWFDD.hACA......hAGA...,2,-22,-2,20
cbdWCVYIgOTBALJeEfGQKMRPUFaNDSHXZ,eAAAEAAAGACAMAEARBCAFAEA..DAIBHAGBZBFB.dDFA.CCBD..IEBAhAAATDBAAAAA.LDHBhBDAQEDAKEDAaFBChBFAXGGA.WHEGgGFBBDHA.fHCBhCAA..hCBA...,2,-21,-5,16
QDALYaIRdCNGEBMFJXebVWUPZcSfKTgHO,aAAARAAAdADAGACABAFA.FAEA..eAGH..bAGDUDDA.ZDGBfCEAhAIAKFAAHGEADAIBhAAAABBBLEBB.CEFAEEHBhBAAMCCBXFEC......hBEA......hBIA...,1,-14,-26,12
JXNULEcCRYHaBAGDOIWSgdFeMVKbTZPfQ,GAAAOAAA.SADAdAEAeAGB.MAGBKBBDZCDAQCDA.hAHAXCGDLEBAEAHBhAAAREGBHFEBAADADDCBgFDAhACAFGCB.bGFA.......hAIA......hBAA...,1,3,-17,20
aCSGZOYMdbNKWETcVPRfBAXHgLIQFJDeU,HAAALAAAQADCDAEAeAFAaAFAGBCBZBFEMCABdCAAKBHB.EDDBhABATDDA.PDGBhAAARDFAADFA..XFFAhACAFFHDCCCDOFFH.bGBAWFHH....hDAA......hDCA...,1,13,-15,28
GaTCYUgOZBVDWHJcfMRbKQLdXNPeSFIAE,EAAAaAAA...CACAUAEAZACBDAFA.HBEA.JCHBMAHB.RCCBQDGBhAAAdDED..XEBAhAIAeEBBFEFHABBBTFFAhBAAOFDDBFHA..cGBA..hBEA......hBGA...,1,-21,-29,8
LBUZDGcSYHQFRgPfIXJVNOEeWMCAdKbaT,dAAAaAAALADAZABBGADA..SAGHHAFARCFA..fEFEhAFAXBBCVCDAEEHBeDDDhAHAMAIBAGHB.KDGA.bEAAhAEA.BFFADIAA.YFHB....hAFA......hBAA...,1,-2,-16,14
ZBFaMAQNdPgfbOKWCReJSVLGYUTDXIcHE,dAAA..fAAAKADARAFF.eADASAHBGAGATCAAhAAADCCA.XCCBHCGBEDAAhACAZDFFaDDAAAIBQEABhACA.gEDAbFAACEEDLGFAIHFAhADA.FGBDMIDAODHDhAEA..,2,-22,28,50
ePJEQbLagfHDARFNWdGBXTUKYCZMIVSOc,RAAAFAAAdADAGACABAFA.UAFAKAHB.ZCFE..MCCB..SEAAhAEAeCGB.EEDFLDDBhAAAaEGAHFFAADFBXFAChABACAHAOHFE...PFFB...JHAEhAFA......hAHA...,2,-29,-9,20
BAHXNdUWFCJVEGMbZDfTSIYaPLceORQgK,HAAAdAAAFADACADB..EAFAGAFAZBEE.DAIBSBHH.aCACLCCBhACA.eCEBhAHARDCBQEECBDBAADHAXEGAhBAAUFAAJEHBMEEBbGDA.TGGA.IHBAhBCA...hAAA...,1,-6,-18,12
XWeNbHJfgUMSPROcKZGdELCYFDTIVaABQ,QAAAeAAAHADAJAHBUADA..MCCBRAFAKCGAdDDALDBAFDGHDAFA.hAAA..TEFAaEHDAFFBBGCAhABAXFDC.NEIA.hAAAfGGE..SGAAhAGA.OHEA..hAIA...,1,-16,-19,3
ePZaObdCFXDLWRUJQcGIEYfTNSVHgMKAB,eAAAaAAA.dAEAFADALAGBRAFF.UDBAQBBBGDEAEBCATDDAhAHA..SCHHhAAAHCGBMAIBAAIBZGBAbFDADECBhBAAJHFE...IHHA....hCAA......hCEA...,1,-7,-15,8
YUINROPBdQLHKSMXeTJCVFDbcGgAEaZWf,EAAAZAAA....fADBIADARAEFBAFBdAGAHCBAKAHB.MAIBhAAAeCAB.CCCD.DDGBGCEAhABAADHBaEEB.UDGA.OECBhACALFFASGCHJHFA.FGGA..hAHA......hCBA...,1,-11,-16,5
EKfJPYdZLRaFQSIcUXWOGebAgDNMVTBHC,DAAAMAAABACAHACCKAEAJAFA..dAGARCCBFCEE..QCCAhAEA..SCGHhAIAUDFAOBBBeDHHAAIB.gFEAhBAA.NBBACGHAEFCA.fFHAhBAA.PHEC.hCAA...,2,-35,-21,14
EQdMeGXURZTSYPJHCWBbcOfVIaLKgFDAN,EAAAdAAAeADAGACARAGBZABB..TAEA.SAGBPCEBHDFBhAEABCBDODCDIDFAhAAAaEHDLGCAhAIAFCHDAAIBMEAB.XEDD.UFFACHHA.cGCChAEA.....hBAA...,1,2,-8,10
bRNHCMKaFfUcDIQBVeYWJdPGZSLgETXOA,RAAAHAAAMADAaACA.FAFAUBEA..DAIBQBGAeBEF.JCCBGCFAhAAA.ZCCFLEEAhAAAECHBOFFHAAHAbGEAKHGAhCAA............hDAA......hDBA...,2,-27,-10,17
gZCaWObGYSfNILJAEMHPFQcdTXVKReUBD,HAAAQAAAdADATAFAKACARAEF..BAGBZCAAaAHD..OAHDhAAAGCEASCDDhAEA.IDGAADGAEDHFMFAAhAAAFEFHXGCAeFHFDGGBCHAA..YFHBhCAA.....hACA...,1,-6,-15,9
LRGAVBUdfbJCcONgSYQMZPWFIEaTDXHKe,BAAAdAAAJADAOACA..SAGBMAGBZBCAFAHB..EBDBaCHDhAAADAIB.HCACLDBAhBDAACFAUDFACEFA..NHDB.QGGAhACA.IHEATFBAKFGA.hBAA......hBCA...,1,-22,-30,8
USPXKTNVeHbcAOdLWgEFQCRaMGBJYfZDI,dAAALAAAEADA.QAEARAFAGCABBCFDJAHBZCAADCHB..SCCEhABAKECA.TDFAhACAeDHHHEEB.AGAAOGAEhACAFEAAaDHDMEEBfGHAIGBA.hADAXFFCNIAB..hAEA...,1,-7,-18,11
EDYPHOGKQBfcNJgdUeaWFAMTRbVSZICXL,RAAASAAAZADB.CADA.EAFA.DAIBHAEBGBGAQAGABCCC.hAAAfCCAJDAB.hABAdDAAeCEHaDECAAAAbFFAXDGBhADA.LFFAOGCCNIEBgGAAhAGA....hBIA...,2,-13,-10,3
cAHYEgCFbGJMIRQXWZOTaLSDKBeVPUdNf,HAAAEAAAFACDGADA.MAFARAEAQCDDZBFBaBHDLDAAKBHBeCGBhAAAUFBAdEAA...fEGAhAAAAAHACEED.bFDDhACAXFGAOFHDDFFBBGEA.NIEB....hADA......hBFA...,1,8,-16,24
QJPLVWAHUZbRgCMGNdDFBYOKEfIcaXeST,HAAAZAAARAEA.MACAdAHABCAAKAFA..EBDF...ICFAaCCCeCFFhABATDGA.QEDAhAAALDHBAACAbFFDGEAAhAEAFFHDOAHDXECASCCDPGEC.hAFAWHAA....hAHA...,1,-7,-11,4
ZdMEJXVTQgUIBRfAHFbCYSGPDOaLNeWcK,HAAACAAAGACAOACALAEAeAFAKBHBZBFEdCAAECCA....XCEAhAAATDFAUFAARDGFAEEAFFCAhAGASDHBDFFB.hCAAaEDDcGGC..MFFB.QGGAhAAA....hACA...,1,-3,-11,8
fgPONKaYbEeUTXAMBSIQWFCRVdcZGHJDL,MAAASAAA.QADACADARAEFdAGAGBBAHAFALCCBhAAA.fCGAhABAOBHDaDECEDAAeEGFTEEAhADAABBBBFHAFDHDcGGADFFBgGDDKHAA..hAIA......hBAA...,2,-26,16,42
efDaWQCZXUKNdJbgATLSIVOEGcRHYFMPB,TAAALAAA.SADHOACAGAFAHAFAMCABeAHBaBDHQCEDhABAZECAKDHDdGGAbCGDAAHAhACAEFBB..RFAAFCCHBDEAhAAADCIB.XFECNIAB.IGHA.hAIA......hBFA...,2,-4,11,15
adHBXUNfACLFGOJMZTQeEcYbRDSVKIWPg,LAAAGAAAMADAZADBeAFAEAGA....bBFARCABSBGAhABA.KCFDICDAhAAAgDGAHDBBXFFChACAfDEAACCAOGAATDGA.QFFChACADEEBWHDA.dGDABHHAhAGACHHA...,2,-16,12,28
IZHefDBagXYbNTKCQVMOSWJdFLRUAPGEc,EAAAZAAAHAEADADA.aAGA..XAEA..bCABTBCAQCDDhABAMAHB.SCGAhACAdDEAREGBAAIB.GEEBhADAeCBBBFCAgGCAKGDA.OEAH.FGHBhAEA......hCGA...,2,-19,9,28
VdDZbBYCgXAKaWROLfEMHNcIJSeTQGUPF,aAAARAAALADB.EAFAHACB.IAEAeAHFGCEAFAGAdCFAZEGBhAAABCHACCCCACGB.OBBHhBAAMFAA.JEDB.QFFAhBGA..........hCAA......hCHA...,2,-20,-20,0
TDQUeVXWPKEbYASFGfJLdHcZMCaIONgBR,GAAALAAAHADAZADBaAFDOAFA.BBHARBGFQCAAeCDAXDCChAAAKDEA..EEHFADABfDFAhACAdFBAMFFBCAHB.hABAgDGHDGGB.UGGA....hADA......hBAA...,1,-6,-12,6
XMIFfSZdRYNOUKcCQeLTGDgPVWbaEHBAJ,MAAAFAAAZACBRACA...OAECKAFC..QBGAeAHHGCEADBBB.hAIA..VECBaCCCHCEBhBAAAAGA.XECChCAASEHBdEHAUGDALHFATGFA...hBAA......hCAA...,1,0,-21,21
TCHSgdMbOefQJXKNcaUILWARVYPBGZDFE,RAAAVAAABADB.ZAEBEADEHAGB..dAFAMCCBeAHB..QDFDhAAAKCDAaCGDLEEBhAAAAAIBGECATGGASEHHhABAODCBXGFC..NIAB....hBGA......hCAA...,2,-12,-8,4
CdIWSVJeBAfTGOHNXQULDZRPFYMgEKcba,GAAAHAAAQADCLADARAGFFAFAMCDBEBHFKCAD..aCEBdCFASCHHhAAAeCCBADIBTEGAhAAAXEAAZFDBgGGAhACAbEFCCFDA..IGGA...hAIA......hDEA...,2,-5,1,6
IRLSGBJbEcTfZaMXCVdKHPDAUQeOYFWgN,eAAAFAAA....NADA.RADAGAGABAEA.ECCB..TAGAaCEDMDGBhAAACCEA.dEAAHCFBAAIBODHDhABA..gEAAhAEASFFDbFFAZGAEKCHB.DEEB.YGAGhAGAIHHA..JHFAhAIA...,1,-1,-27,26
VPSTcDWEUeRMBAQZgHbIXdfLGKYFCaONJ,ZAAAHAAA.XADBdAEAGAGAFAFD.aCAAOAHB..VDABTCCAhAAADDDAUEEARDFBBCADAAGB.hABAQFDA.hACAIGHALFHBCDHANIABSGDD.hACAcGFD...hAIA...,2,-14,-9,5
HTKIQGBSFXZbfWcMdNaLUOEYJCgPRVeDA,HAAATAAAQADC.GAFAFACAbAEDfAHE.hAAAMCABaAGALBGBhCAAECCBCDHAREDAeFAFACCABDDDZFGBdHDBhAAAODHD.gECG.DFFB.hACASGCD.hAFAXGFD.,1,28,-14,42
KZYXebSJFAUBdaDRMVgWLcNCHPfTGQOEI,dAAARAAAMADA..VADALAHB.CBDAHBEBTBGAGEEB.hACAECCBZCBB.eDAFbGBA.hAAAFDDAABGA.aDFD.DDIB.hABA..gGAA.NEHA.fGHAhCAA....hCGA...,2,-14,-12,2
UDCaEcVFINBQLAYZKRHeOMPWTgbdJSfGX,ZAAAHAAAeACEMACA..TAGAdAGASBDAGCCBDCIBECCBFDGDBCHAhAAAAAFA.RDFBOEBBhAIA.PEDDbFCAXGGAhABAaFFH..IHHANIAB....hBEA......hBGA...,2,-11,-8,3
fNUWTOLDIPJgecBFKXSYbZVRHGEQAMaCd,aAAAdAAAUADA..TADALAGB.DAIBIAGA.JBBFhADAeCBFFBHD.SDDAhACAZCFFHDCBEFABABGBMDIBhBAAfFEAOEFDgFBAKFHBYHEG.hBCA......hBDA...,1,-3,-32,29
WTFbQOdXJGgCHEcaLeADIfBSNYVMPKRUZ,DAAABAAA.SACAVACA.KAFARAFFZCCAFBHD...QDGAhAFAdCAAGCCAHFFAECFBaEFChAAAAAHAIHCA..hBAAfFAAMBBBWEEDbGCA.OHAC.hBIAXGGACHHA..hACA...,1,-10,-22,12
fNRTXSaAHJCEcVLPeIdDgUKOYGbMQZWFB,HAAAEAAALADAeACEdAFADAHBKAHBGCBA.MAIBZCCABCGA.hAAARECATEGAaDDAAAEACDGA.VGEAhAAA..gEEGhBCAOHAA.bFCD.FEHD......hCAA......hCBA...,1,-6,-11,5
beXcGZSYORKJUdMDfVaFgNLWEBQAPHCTI,HAAATAAAeACE.GAFAZACBOAECRCCAKAHBdDHAMAIBDEEB..aCAHhAAAFFAALCEAEFFBACCA.hAAACEEAXEGASHAAhAFAUGAA.VGCAWHEAQGGC.hAHA......hCAA...,2,-7,8,15
eYTGWgLZbcfdIKCPSRQXBaFUDEAJHMVON,HAAAMAAA.OACAeACAGAFALAGBZBBA..bBEDdBHA.CDDDREFAQCCBhAAABFBAFFDBEGHBhAHAAAIBVEGB.TGBAhBGA.WFFD.........hAIA......hBAA...,1,6,-18,24
ZTFLScdQKDVHfAMaCEbJRYIWeGUNPgOBX,aAAAEAAARACA....IADAeAFEGBEBUAFA...PCCBhAAABAHAZBBATDGALDDAhBAAdDAAQEDAhADADCIBHDGBAFBAbFFDJFDA..NIABOFHDSGHH.hAIA......hCAA...,2,-20,11,31
bIZWULYFOdKNVRMPaQBGXgSfDJHcECAeT,eAAATAAAZADB.LAGBOACA.dCCCKAFAREEA.MAIB..aBFBGCCAhAAA.SCFAhAHADAIBHGCAEGGAACCBbEFAWDBDhAAAFFEH...NIEB.QGGC.BGCDhBDA.....hABA...,2,-14,-1,13
KbeWacMNJQXBTLCSDAEHYdUFPOVIRGZfg,HAAAdAAAFADAOACARAFF.ZAFBKBDDeAHF.aBDEMAIB..QDDChAAABCBALDEAhACADCCBEDHFUFDAVFFB..hCAAIFGA.....fGHAhAHA...WHCGhBAA..,1,-10,-32,22
JfLOXcBHYWaETdZVUIeKRQPFgCSDGMAbN,JAAALAAA.XADDHADBaAFA.EBFEZAFA.UCAAKCCDRDABQCFAhABA.FDDBSBHHhADAGFEBAAGAfHDBhACABDEATEFAIHHAeEHHCGDAMIAAhAIA.OHEC..hBAA...,2,-15,-5,10
agYBNMVePKIGHcObZXRfULdAWSDFEJTQC,DAAAEAAA.QACACACA..aADDBAEAMAFAeAFH.KAHBHBEBhAAAOBBBZBGBRFFALDDAhAHAABGBFCCH.TEGA.hCAANHCB.IHHA..cGGDXEEChCBA......hCIA...,1,-18,-21,3
BHUOVRPCISeaNDQfLGWFMZgETbAXYcJdK,XAAAJAAABADB.HADA.UAGARAEF.CCDD.eAGH.DAIBLDABhAAAGCCA.MCFBZEFA.EDGAhABAACCB.dFGAKGAAOEEHhADA..IDHAaGDH.QGEAhAGAWFHH.FGHH....hBAA...,1,1,-27,28
WKgNeZbULFREBHaPAJMTdfXVCQOSDYIGc,MAAAdAAA..XADAQADADAGAGBFAKAFAeAHHZABBLBBBhAHAEBHBHDCAACGB..TDDAhBAACEAASEGH.hCAAIHHAgDGANIBB.bFDC.FFHDaFFH.hCBA......hCDA...,2,-11,-4,7
ZUFWdafTCSPYAKOVHENBceQJMIDLbgXGR,OAAAHAAAEADEBADAeAFE..MAFALCAA.bBFDGBDBhBAARECAZFGBFCHFaBBHTDDAhBGA.SBHBhCAAACEAKGFDNIAB.QDGC.DFFB.XGGAhCCA.....hAAA...,2,-8,-1,7
QYOEGgMfVXINPUBbCaDZTLSHcReFWKdAJ,QAAAEAAAGACAMAEA..XACA.IAFAhAAAPAHDbBEBaAGDZCDALDGBhAAAHDAARDGFeCBBKEEBAAIBOEDChBCAfFCAUGCADFIBSFHH.hCAA......hCGA...,2,2,3,1
dHWUgeZVPMIXKBbaLRfOYFGSDCJQcETNA,HAAAUAAAeADAZADBMAGBKAGA.BAHALCDARCGF..OCABGCGAhADACCCC.QEAAhAEA.EECAABFBdEEAVFEBXGFAhAAA.aFDB.FHAADGIB....hAIA......hBAA...,2,-15,-9,6
XeISbUHRKJFCNQLMGcfBgYDdZaWVTOAPE,EAAAeAAA..SACAHADARAGFFCCBQAFAGDEABDGDDAIBaCCAhAAATFAAACFB..XDAAhADAbFCD.KDDDCEHA.MDGBhAFAfGGAdDHAZFEFOHBA.IGHAhBHA....hCAA...,2,-6,-5,1
dgWZRXaMTVbLDGPKOSFQAYfCNUcIeJBHE,CAAAUAAA.eADAHACAdAHAZAFB.RCAAMAIB..bBDAGCGA.hADAOCEHQDDAhAEAAAEA.fDGAhBAAIFCAEFFBXFGAaFHDLHBAKHBAFHFA...hBCA......hBHA...,1,-1,-15,14
MbXVHLKRQYUWedcCTaDOFPAfJNgIGBZES,JAAA..gAAAGADAEAFAMADA..XBGAHAFCRBDBQCFChAAAUDAAdDFATFGAhADAaCCHFDHD.ADBBfFFAhABABDHDbFAA.KGHBeFEBDIAA.OHBC.hAIA......hBDA...,1,1,-6,7
RJLUAQCWaYbSBKfEgHFZMGOeTXPcDIdVN,QAAAaAAA.SACAfADAHAEBZAEBGAGAeAGBTDAAhAAAXDAADAIBdDCAhADARDFBLGBAADGBCDHA.YFFFhADAbEDDEFFAMFIBODDBIHAANDIA.hAIA......hBAA...,1,14,-5,19
RdVSAXCEgJLPZGWaKeOTIDBfcbNYUMFQH,EAAALAAAGACAaADDeAEA..OAFATBGABBFA..bCEDhAAAUCAAFCBH.HCFCREGFdFAAhAEAABIBCDDAJGDAZEFA.KFBADGIBhAFA.NIAB.MGEA........hABA......hACA...,1,11,-22,33
DCREFGNTKUQMBVfLSXZYWOIgHaJdAePbc,eAAA..bAAACADAEAFAGAEA.KAGAMAIBBCAALCCAZCGBOCCBhAAAHCFBdEAAAAAADBHBREDBFFHDhABATECA.QFAChAFASGAAXFFA...WFHHhCAAaGDH.....hACA...,1,-4,-12,8
HZQIeTRXgVLCAKdJDBSOPWEMbYUfcFGaN,dAAABAAAOADAEACA..MAFAUBEB.FAHBaBCEHCACZBEB..eBGFhAAARDEB..XDGAhACALCABAFHBDGGBSBHHhACA.bEDCfHDBGEGA.IHHAhBAA.....hDAA...,2,-16,-13,3
YcZGbCQEPXeSIOWVDJRKfHUMNadFgLTBA,ZAAAGAAAQAEAEADAeAFAOAGF.DACARCDAHCGB.MDABhAAAdCCDLDFAABIB.hACAbEECXECC.hABASFEAIGGAWFHHKFHBfGAAhADAaGDC.TGCA.hAIABHHD.,2,-12,-5,7
RYBeMgcQaAdDJFTOGbISZXLWPUfENCVKH,dAAAFAAAGACASADAZAEALAHBUAGA.ECEACCBAHCEA.RDCBeDABhACAMDGBQFAAhAFA.AEEADEHBTEGAhADAOFFHbGBAXGGAWEHH....hAEA......hBAA...,2,-11,-9,2
cELOKDgBYVGQRICAFeNUSHbWZdJPafMTX,eAAASAAAHADAZAGBdADA.aCCBMAFA..TDDAEBFALCHBhAAADBIBBCFCGDBAREGBAAAAFFAAhAFAbDDA.JFDB.XFFChABAKFFDgGAG..YHEGhBDA......hBFA...,1,-2,-6,4
gfaEPYDbJROMVFBGQSILXZTNeUcdWAKCH,HAAAaAAA.EADEDADARAFF..MAIBBAFA.GAGAQCABLBBAhAIAZDCBeCHDdDBAADDACDEAfEEAhAAA.bFABODFDhBAASFGBTFCAcGEBKEHB...hBDA......hBIA...,1,16,-29,45
GfXTSdaVebEUHcOWIKMQYCPgZLDNARJBF,RAAAFAAAGADA..TADAaAFA..eAHHEAFEHCCAOBFDKBHBMCCBhAAAQCFC.hABACDAAZEEALDABAAHAfGGEhADAdEFDUGGAIHEAYDDFDGIB..hBAA......hCAA...,1,0,-18,18
ETXWDRaLMbGAVOeJZSFfPKcCdUBQHYINg,eAAAZAAAFADAKADAdAGABAFBHCAA....IAHAECEB..TDGAhABADCCARCDALCGBhAAAGFCBAAIBOFHDSEFDhABAfGBECFHA.......hCAA......hCBA...,2,-39,-9,30
fILJgbBROeNVDATYUCQPGEHKMXWFdaZSc,TAAACAAAGACA.HAEAMACAFBHDZADE..SCAB..hAAAfAHALDFBbEAChACARCCAeCFGDEEBAAHAQEEAhAAAEEHBKGAA.dEHAaGCDIHAABGHDNIEB.YHFAhAHA...hAEA...,2,-6,-4,2
QFdLOBNPYGUVTRASDbZXWHfaECgMJeIcK,DAAAZAAAHAEAEACA.MAIBeAEAKCAA..dBHALCEABBBD..PCDAhAFAGEAA.TEEAhABAADDBSDFHXEGBhACAaEEBCDDDIHHAFEHBOHCA.UGGBRGCA..hAIA......hBAA...,2,-22,6,28
IBcQMLPANHgJTSaZeURfWbEYCVGXKOdDF,HAAATAAAZADB.RAFA.....bACBECABCAEAGAFAOCCHdCHAFAHFBCEDhAAAMDFBADGA.JEGFeCCDhCAA.fDHAhDAA.VEEBDEEBQGAALHDA..hAAA......hACA...,2,-18,7,25
HIdLBFgUeTfbAESJQXVKWZCNYGRcPaODM,EAAAQAAAKACA.ZACBCAEBGAFARAEA..aAHDMAIBHCECdCCALECAhAAAFDHH.eDHFhAFAbCDD.AFGBSFHHhAHA..XFEA.NHAB....hBCA......hCAA...,2,-21,-8,13
QAEVYUKZOaMgFNILfdSTDXJCHeWBRGbPc,EAAAUAAAZACBMADA..FAEDLAHBdAGADAIB.CBDAHBEBBCBCRDEAGDBAhBAA...bEEAQFDChAAAABGA.KFHBhBCAaFHD.IGEATGFAXGBB.hBCA......hBDA...,2,-21,-16,5
gcbDTfPFEUaIYJZdCOASGLNKBHQXeVRMW,GAAALAAABADAHADBeAEHRAFAMCAB....gAGAhAAAbCFATEEAFCHD.EDCBaCCHhABAIEEAZEGFdGAAAFIBKEGDhACA.QGAAWHCADGGB.fFHAhADA.PGDC..hAGA...,2,-15,10,25
YHOAdWQcNMVgZPSIKTXDFaLJBUGfeCbER,dAAAQAAAMADAZAEESACA.KAFATCBAFBHD.aAHDLCDAhAAABCFAGDGAhACAeDABEECAHEDBAAHAcEFAhADANIDB...gFCA.XGGAhAFADFCB.fHEBhCAA.,1,-13,-19,6
CbPSfGAHMKQXTUaORFEIVBZgDeWNdLYcJ,HAAAMAAAKADATAEA.OAGDEAFEBAHBZCAAeCCEdBBALCEAhBAA..cDGCCDCASCHHhCAAAAIBQEAAhAAAaEEARFCA.FEEB.gFGGDFHB.NICBbGAC.hCBA......hCDA...,1,23,-28,51
PCbcWIZUfFETJgRXdONHDLBYGSKAeaQVM,eAAAaAAA.MAEACADA......bAEDIBDAZAGF.FAHDEBBBhADATCEARDCB.dDHAHEEBhAIALEGDBEHASGBBhBAAAAAAQFBAcGFDfCCE.hBGAJEEF.....hBIA...,1,-9,-21,12
SLJGWCZVadKTbRPDcHgMOeABNfEXQFIUY,BAAAEAAAFACDUACA.LAFAGAEAZAGBdCFA.KDDBRDDB.DBIBHDGB.hAAAMCBBAAEB..XEGAhAGAQGAA.SCHBhAAACFFDaGBA..bGEAgGGAhAGA.eFDD...hBGA...,1,-2,-28,26
UgAFDfIJbCGcSQRPNMEaTWZdOBXVHeKLY,DAAAJAAAGADAQACA.RAEA.MAFA.EBFEaAHD.ZCCAdBHABCGDhAFAHDAAeDHFLDFBhADAUEEBABBBfEHAhBAA.CCCDSFEDPHAAWFHHOHEE.hAHA......hBAA...,2,-22,2,24
agcYNJZIeWCRFVLfMbSBTQKAGEdXHPDOU,EAAAHAAADADAaACA.......gAEHcAED.JAHBeAGHhAAARCCBLEFAMAIBbBCBhCAATFDA.ACGBdGGAhAAAODFB.UGGAYHAAIEHACHEA.fEDAhCBA.BHDAhCCA..,1,-11,-12,1
FZedgHUJPIcKGMAbaQfTYSOBDEWVRLXCN,aAAATAAA..OACDEACE.RAEA.LAEBCAHB.ZAGBeBBDHCCBhAAAUCGAIEFAGDEAhAEAAAGBbEGDQECAhAFA.SGGADBIBXGCANIDB....hCAA......hCCA...,1,-7,-11,4
HfGUdbJLcNZESCXgTKQPIFYDWeaMVAOBR,RAAAHAAAGADAdADALAFAZAFA.ECABXCFAKCCD..QCFAhAAAFCCHDAGAeDABaDEHAAGAhACABEFAUFGAJEHBSFCBhCFACFED.PHDCIGCA.MIDAhAAA......hABA...,2,-22,1,23
dIBXKSNCeORDfVcTGPHgALWJaZYFUbEMQ,LAAAaAAAZACB.FAEAEAEAdAHA.BBDAKAGA..CBBD.RCAADCFB..VCEAhAIAGDFAHECAACAA.JDHBhBAAUGCA..bGFAMFIBhABA...IEDASHCA..hCAAeHEG....hACA...,2,-25,-11,14
DWUNRGVeCEPOAKacHdBbQLgFYJTIfMZXS,aAAAHAAABADALADB.FAFATAFAMAIBZCEBDAIB.UCABRCCAeCGFhADAECGF..AEHA.dEEAQFBAhAAAJDHB.XFGAhACASBBG.NFABCGGDKGFD.....hAFA......hAHA...,2,-28,2,30
SbXIRBAgZdLEFGeNQHWKOYUVcTPDMJfaC,dAAAEAAAGACAeADAHAGBOAEAUCCA..TBGAMCFB..aDABbBEDhAAAREAF..BDGDAAIBZEBALFGBhACAQFFA.hADAKDHBcGBDDGDBCCBDSHGA..hBCA......hBEA...,2,-6,-4,2
GYCUfATONbLPeFcaDIKBdWSVMQXgZJRHE,TAAAOAAALAEA.eAHHaACAKAFAdBBD.SAHBhAAAMCEBQDFCZBDAHCGBEEHFhAFAGDDACFCAACFA.bFABFGABhAGADCCBBGGDXFGA.gGFGhAFA......hCAA...,1,-2,-10,8
QWNdODIMJZbfBPaeXgSYHLRTcEAGCFUKV,GAAAFAAAKADA.QADAdAFA.DAGAMAHBZBFBBBHA.eCDBhAAASCCAHDGBRFBAEFFBhACAAAIBCDAA..UDGB..hADANDAAIHHAJDEB..bFGD....hBAA......hCAA...,1,6,-41,47
TQLUXGVPDKEeCfaWHBdRSNIcAgbMFZOYJ,MAAAZAAAOACA..TADALAGBGAFADAIBEBEAeAHBCCCD.aBBBhAFAHDEARCCB..SDGHhAIAIFGAADIBbFDDFEDHhABAQGGA..XGCCKFFD.hBAABGHA....hCAA...,1,9,-23,32
KJGgWSXIRFDEBPCHfNZVOYUbLcdeaMTQA,GAAASAAARADAEAGECADA..HAEBZCDAOCFAUBGALCCB.hAAAeDABaDAHMDIBAAAAKEEAJEHBhADAXEEC.DEHBhACAfGAE.YHEAcGGC..hAGA......hAHA...,1,-10,-18,8
ZNbHfCgRcUESOLJTFVIBYDWMaPKXQdeAG,ZAAAHAAACADB.RADFEAFELAFAFBHD.BCAADCAB..MCCBaCCC..KCECdDDDhAAAGCGA..bDADhACA..fEEAhABAUEGAOFCDTGAAIHAA..YFGFhACAXGFCAAGAgGDAhCAA,2,-18,-17,1
VBUaHSLPTMgZXeKfcDJECOYRFbAGQNIWd,GAAAQAAA..IADAdADABAFAHAEBLAHBMAHBZDCAhAAAeBGFKDGDDCFBEEHFODBAhAAARGAAAAGB.VEGBaGGC.TFAAhAFA...fEEE..hBCA......hBDA...,1,-7,-18,11
MGeIWHAJKEQaRcCgXYVDfSLZTdFBUbONP,EAAARAAACADB.....XACADAFALBFAdAFABAHAOCCBMCCBGDEAhAAAeCGFHDDB.hABAACIBQFGAhAAAaDGA.gFBGfEGBSDAFhADAZECBTGGAFHACNIAB.IHEAhAHA..,1,9,-27,36
cLYHZETCIbgOBQNdfeWJVMGAXKDRaUFPS,DAAARAAAFADA..SABALAGBHCCAEAEACAGA...IEEAhAAAOAHDQCCAhAEAdEGAeECB.VCEAAAIBaBEEPEGDhBAAZGFA...........hABA......hCAA...,2,-22,-13,9
UfRbdgYDEHOBIMXCWAeFKQNTaZJPVcSLG,eAAAQAAA.aACEZADB.PAFC..SAEHhAAAGCEARCGBdCCCDAGAHBFBBFHAMDBBhAAACBHAACDBKDAATGCAhABAcDECfGFA..bEGD.EHBAIHHAhAIA...hADA...,1,2,-24,26
XJZKLcfQSVGMBPHAdWINeYOTEgRDFabCU,dAAA..IAAAeADATAGARACAFAFA.CCBA.UCAAZCEA.LCFAhACA.QDDChADAGDCAMCIBHEGBAADAYEEBhACAEGCAaFFB...XGFD...hAIA......hBIA...,2,-15,-11,4
BQYWcPIDEFAVRZXMOdGJTbNHCaLKgfSUe,RAAAZAAAMADAGAEA.JAHB..TAGAHCAAaACALBEB.fCCAhAAAeDEDQDGBhABA..cCGChABADFIBAAGAOGBAbECDKEFASFGABGFA.hBGA......hCAA...,2,-10,-9,1
UgdAQHNKXcGLWeYISaEVRZPJBfbDCMFOT,HAAAXAAAGADALADAeAFASBGA.ECABRAGFZCDAhAAABCCDbEAAMDFAOCHDhABATEFAdEEAAAEAQFAAhAAAKFHD.cFEC.IHHAaGFD.hAIA......hCAA...,1,16,-13,29
NaPHTDCGKYSRUfLFZVOAeJWgMcIBdbQXE,eAAAJAAA.MAEABADBdBDA..QAFAEAHF..aBFBHCCAhAFATDFAGDFAKCHBRFFALBHBhAIAZGCAAAAA.gECAhBAAIHHAXDCCDFIBSHDA.hCAA......hCBA...,1,-12,-14,2
UeAHEYLDdWPTgMcZBCFIfOKbVNaRJSGXQ,HAAAEAAALADAdADATAFAMAHB..ZCAAFBCHOAHDKCEA.VCEBhAAAREAAGEEA.QGCChAAAADHBDEIB.WBHHhAEAgFAA.CFGAbGFCaGHB...SHAAhACA...hAFA...,1,1,-14,15
ZEJNLagPfVADWbcQMOdFSRYUHBCXKTGeI,DAAA..bAAAMADAdAEARAGBHAFC.CBBAKBDAeCAB.ECCBLDBAhAIA.aCFDfCFAhAAA.AAIBQEDDhABASCHHBFDAGEGAZFFAgGAAhACAPHDA.cGEC..hAGA...,2,-19,-5,14
MCGYFfZBPXTJIVSagDKAOLdebNUHcRQEW,dAAAeAAAUADAHADARAFA.EAGE..MCCBGCCA.fCFAhAAAZCGBBDDA.TEFAJFDA.SCHBhABADDBB.ACCBbFABhAFAQGAACFHAFHDAIHHAaEHDKGDD...hACA......hAGA...,2,-31,22,53
NRcTQFLABYaCGOVgPfeKUDdXZHJSEMIbW,aAAAGAAA.OADAVADA.....fAGAeAGHDAIBZCCAhADAHCDAEDGAbCGDRFFAQGAAhAGAAAABCDCDKFCA.XEEChBAAMAIBIGGA.NEFA.....hACA......hBCA...,1,-9,-14,5
gVaKREHFPQcbLdUCSMWDOYJBTAeXZfGIN,eAAAZAAAGAEA..gADAaACARAGBHDDBQAGALEHBdGAAhABASCCDMCCBODGHhAGABCFAAAAA.fDDBhAEANIDB.EDGA.FEHD.bFCA.CGAADFCAhAGA......hBIA...,2,-15,4,19
YNTUXbLMCOAPWERVaSDHKfgJcdIGFZBQe,EAAARAAA..aADAHACAKAGA.JAFA.dCCDGBDAZCEBBCGAeCCD.TCGAhAAAXDGA.MEAAhAAAACFAVFEA..fFGAhAEAgGAAIHHAYHFG..NIAB.hAIA......hCAA...,2,-21,-6,15
ROdIeAgaLSJPVQTYMEKBbWFUDfHCNZcXG,aAAALAAA.SADHVADA.QAFAMAHBEBBBBCFAhADAFCAADAIBHDCAZCFAGDDAhABAREFAdGAAACIB.JFAA.TFGAhACAbGEA...fGFE.CHBA..hAGA......hAIA...,2,-15,-2,13
UATCMLRIYOBXZEVJbQKGFDWefHcSaNgPd,MAAARAAAOADAZABE..EAFA..VAGB..bBEAGBDA.DCCBhAAAeCCBHDFAaCHDgFCBhABAdEEAAAIBTFAALFFAhAIABFHAQGFDFHFA.fGDEhAFA....hBAA...,2,-11,1,12
bFSXHRZUOLMECYeBDacQKgdVPJfAWNGIT,GAAATAAA.SADAHACBRAEAZCEELAGBECAB.eBFFDAIBaDGEhAAAQDCA.dEGAhAAAPEABAADAIHHAhACAbEFCFGCAOFFH.MAIBBGGA.KHAA..hACA......hAEA...,1,2,0,2
THJFCSOQVGKXPWDdabIMBZLARUcNefEYg,RAAAUAAAeADEEADA....TBDAHAFACCDAQAGCGCEAXCGAhADADCCBaCGE..bDDCMDCBhAHA.ZGFEAAAAfEGAhAIA.gFDASEGHKFHBdHCBhAIABHHD....hCAA...,2,-14,-3,11
SgXFQJbUTRGeCIDcHZMadPfBEKOYLNAWV,SAAAFAAAQADAUADARAFA.GAGA.eCCBDCCBHCFCZEDBdFBAhAAABDAAEFFA.ODCDhADA.LEEBAAGB.hABAgEGAJFHBCDBDMIAAaGAA.KGHB.NIAB..hAIA......hBDA...,2,-10,-3,7
PLgZdaUATXIBJfHMNVeKSCOGbERQcWYDF,TAAABAAAHACA.MAEAeACEKAHBOAFAGBFARBEA..QCCChAAA..cCAAhAAADBIBLDBDdDDAADIBXEGDhACAfDFASFCDEDHBFFGB.PFEDhCCAaEEHIHHA.hCEA...,1,4,-23,27
JLOYPDcCAVIRKSWeZNMgfBdaHUXEGbQTF,RAAASAAAeADEZAGB.MADABBDA.HCEBEAGAGBCAQEGATBEAhAAALDDD.OGAChAAADBIBACHBKDGD.gEBDhABAaGGC.bEED.FGGA....hBEA......hCAA...,1,-8,-12,4
GTVDYOcXZdRCMfKWNFBLISgAeHbUPaQEJ,HAAAUAAAQADAEADEGAFADAIB.OCABZAFBRCBAMAIB.KDADhADAFCCALEEASDEHhAAAABHBeEHHaDGDTFAAhACAVFBA.XFGACGEA.fHBFhAFAWHDA.BHHD...hBAA...,1,7,-8,15
IUWgPHBOZFGReaQAXNfCTSbEVdDcKJYML,XAAACAAA..bACAEADA..dAGAKAFAMAIBLAHB.ICDAhAAAUCAA.PCFBhABAHCDAZEAE.RDGBeEFBhAAAACGATDAADGBA.cEFDWGBABHHAFFHD..hACA......hADA...,2,-13,-12,1
TQaMLRFfcVdEZPYSUJODBeNXHACKIGgWb,KAAAGAAA...bADAaACA.RAEFFAGA..fAHAdCCAZCFB.hAAASCDAOCHDeDBDhBDAHDEC.AAABCCHAIGGAhCAATECAMDAB.LFFAEEDA.PHAAhACAYHDADHFANIEB.hCBA...,2,-28,12,40
fKaAIQXMLZBRbHeVSDdYJPCWOcFGUEgNT,QAAAMAAAZABERAEF.HACA.eAEEDAGAdBHAJBHB..CCDA.OCCBhBAAGCEAEDEB..TGCAhAAAaCGB.AAHALFHBhCAABEGASEHH.......hCGA......hDAA...,1,-8,-30,22
fEAbRFJCdKHTMUGQcZLgIVeOYPBaNXDWS,RAAACAAAHACAMADA.GAFAZAEELCCA..gCAAeAHHOCFDhAAABAHA.aCEHDDIBfCHAhAAAAEEBFFFHKHGA.TFAAhACA.QFDA.IFGAhAEA.YHAGhAFA.NEIA.SEHD,2,-21,-10,11
CSTaRfeBcFMGgEKbNPdDULOZVXWQYAHJI,HAAACAAA.aACARACAeAFEFAFAGBDB.ECCBKBFA....bDFAdCAAhAAALFFBZCCAXCGAhACAQGDBAECA.IHHAhAAATEFABFHAMIAA.gECAhADADEEB.OHEA..hAIA...,1,12,-26,38
RDETIWMAaJXQKcPfFBdCeLSUOGZgHNVYb,aAAAQAAA.KACAfADAdAEALAGBOAEDZDCAHEFBhAAAVAGB.RFDBEDHF.TGBAhAIAMBBBACCB.XDDChADA.FDGHCHHA.eEHH.GGAB.YFFFhAGADDDA...hBGA...,1,1,-3,4
bPfMZCRdSFJaAWQGITOcDHgEeYLKNXUVB,GAAATAAA.DADAHACBEAFA.eAEALBHBXBFABCDA..bDEBhAAAMCFBZEAA.RDBFdDGCFDHDAAIBhACAQGCAOEGH.hAEAgFGANEEA.......hAFA......hCAA...,2,-10,3,13
CYbKDBfaVNJOSXEUATgZQGPIMHWReFdLc,ZAAAGAAAMACAHADARAEA.eAFEdAHALDDACCDDKCFABCHB..aDGDVEEAhAAA..OECBhABAEFCBADAB.TFDA.QGGAhCAAIGHAFHEA......hACA......hADA...,1,-11,-15,4
aVFMEeXZWKIDfLYBTCdOJbNAPgSQUHcGR,SAAAHAAARADFFAFA.EADAeAHH.ZCAAKAFADCFBLAHB.TCCAhAAAdDGDOEEB.hABAJFGBACEAQCFAhADA.GEEAaGCBMFIBIGHA.BEHAhCAA.....hAAA...,1,-7,-18,11
JTGIdFaRUWBYHPVgDAEcObKSMZLCeNfQX,EAAAOAAAKACA.ZADBLAEB..eAFAQAGATCFAdBBDhAGARCCBBCGDHEEA.gFCBhBAAADIBbEFB.MBIBhCAAfFHAXGGAGGABaHCC.WFFD.hCFA......hCHA...,2,-10,-5,5
NWUbDZPLATFIQdEXYOCVgfcKRBHaJMSGe,TAAAQAAA.EACAOACA.CAFA.fAEARAGFHCCAaCHDMAGBhAAAGDFAeAHBUECBhAAAZDCAACFBFFHDdEGA.XGFChAIA..........hCAA......hCDA...,1,-7,-15,8
GMSdRNXIEWbZOHeCLcFPABaQKDUYfJTgV,aAAAQAAA.DADAfADA.JAFATAFA.GBDAhAAAdCCDRCEFXCGBhADAEBHFZDBFHDFAeDHHLFFAhAHAFFBAABBBKGEAYHFAMIAAIHHA.hAIA......hBCA...,2,-9,-4,5
GJHFLMRCADWQUfYaEbINPVKSdXZBTgcOe,QAAAUAAA.aACEEADA...bAFAIAFA.VBGBhAAAdCDAZCEBBAHBTCGAhADAOCDBeEGBHCEBMEIBhAGAADAAfEHAPHAASGGDXDAAgGFBhADA..hCAA...,2,-17,-5,12
YFIcVNUQgXOGaCJLKZbRMTDBdAWeHSEfP,HAAAEAAA...fADBFACDVAEAUDDAQAFC.OAHDhAAAaAHDLDGBZCAARDFAMCEBhACATEAAdFDDACCAeFHHhAAASFHB.IGGAgGEBCHAA.hAHAKHAA.....hDFA...,1,-2,-8,6
XEMWYJBeGIfANabHQVCgRZSPUOLTcdKDF,aAAAHAAA.QADCCADAZAEB.SAFBOAGDLCCBdAHAFCAHECCBhAAAMAIBJCEBGEEAhADAADGAVEGBRGBA...TGEAhACADBBB...YHBABGHA....hBHA......hDIA...,2,-20,1,21
NXZSPHUcaFEDGQAMOeYCKdWbVRBfgJLIT,eAAAKAAAdACA..VADARAEABAHB..JAHBLCEA..TCCAhAAAZDDAHEAAaCFDEDHFhABAGEGAAAGA.MCIBCEED.hCAA.bFDAfGCA..IHHAhCBASFFD...hCCA...,2,-23,-15,8
UFVEBAaOYJdHQTGcSWDRgKfNICLPebMZX,aAAAOAAA.dAEAHACBGAGASAEA.RAGFKCEAfBBEhAGACDHALEAAeBDDZEEAFDFBhAIAEGEAADIBQEBAhBAA.TFGADBBBIHHAbGBAMIFA..hBEA......hBGA...,2,-13,-2,11
UAgeBVdXZIfHWDRGLcOKJCPQNYFETbSaM,eAAAdAAAZABBHADARADAGAGALAGB.KCCACCEA.QDEDFDCD.hAEAEDHFTEEAaFAAAAAABFFDhAFA..XGAAhAGAfFHADDIBOFHBPGCCNIABbGDA...hAIA......hBIA...,1,-6,-10,4
ZKOYWbGgLaVQPNBTRCfFJEcUAeXDMSIHd,eAAAMAAAHACCZADBOAFC..bAFBGCEAaAHD.QCGAhAAABBBDRCEBFDCBEBCFADHASEEDhBAAdFHAKGCA.gGFAhBHA.........hABA......hAHA...,2,-18,-7,11
FVNBeafJKdCgScTLQMEWIRUbDXOPAYHZG,HAAAGAAAFADABADAeAFHaAEDKAHB..dAGASCAALDCAECHFhAAARCGBDCEB..ODAHhACAADDBZEFF.VEFBJHAACFHATGBAhADA..MFFBIHHA.XGDDhAIA.....hAAA...,2,-20,3,23
LfBQDaWEPTXCGFOHISZUVgJcbNdRKAeYM,eAAAMAAALAEAQADADAIBEAFA..TBBAGBGA.HCCAhAAAZCEAVEEAgEEAhABAJDBF.bGCCRFCF.AAIBBGGAhCAAaEHD..XGAD.CDDD..IHHAhAFA.....hCBA...,1,1,-2,3
PRfabGIWdTHYSgAVDQeCLBENZcUXKMFOJ,QAAAeAAALAEAEACAZAEBUCCA.MAIBOAGD.RDCBaCHDGCFAhAAA.dDBCHEEBSEHHhABAAAIBCBDABGBAXFAChAFAFGHB.JFDB.fHFB..hAGA......hBDA...,1,-10,-11,1
TQdHUJLcKVBWfCDPaZFIeSGbMROAXEYNg,EAAA..gAAAdADAHAFALBCDKADABAFBCAHAaCFC.ZDDFeCCAhAAAGGEBRCFA.AAHAXDGAhAAATDAAUEFB.VGCAhABADFAAFHCC.SFFEMFIB...hADA......hAHA...,1,4,-15,19
JfHICFgPAaULXWMBYdEGSNcTZVROKDbQe,aAAALAAA.MAEAdADAEAFAGBCB.SAGATBGARCDADBBBhAFAeCABHDBBFCGDACIBXDGAhAIABDDD..cEFChABAZFEAKHFA..bFBA.JHFA.....hBAA......hBDA...,2,-11,-5,6
DECcTHJINLZQBdRWgOMFPXUaAbSVYKGfe,SAAAKAAAeACEDAFAEADA....TBCAHAFAICCAhAAA.ZCEAdBGARDABODHDhABAMAIBXCEDAAHAVEEBfFCAhADACEDDJEGBLGCABGHD.FHCE..hCAA......hCBA...,1,3,-27,30
SaRTYfHFCIUDQVMPdcZLWBbOKAeEgXNJG,EAAAXAAAGACARADA...TAEAHAGBCCDDDAGAMCFBdBHAZCFB.LEABhAAAbDAB.ACBBeEDFhAEAgDGASEGHhBCAaEEHFFHDIHHAQGAB.cGDChAAA......hABA...,1,3,-5,8
IRQDXVAZNTLEgCBFPbGWOcfaJdHMSeKUY,ZAAATAAAEADEBAFB..FACAGAGAOAEDaCAAHAGB.eCCBhAAAKCEAUECAREDFQFGAhAGAXEFCAAIB..gGBBhBGAbGEA.fGFEMDIB...hABA......hACA...,2,-21,4,25
IKgNQUVCXfYMEbDBRJLdFOAaPZSTecHGW,ZAAAeAAAHAEAGADAKBHBQCAACAFA..fAHAhAAAECDFBCFARDFAdCGDAACA.aCCHTFGAhABAIEFA.gEGHhABAVGAAMEEBbFAADAGAFGHDSEAGhAEA.WFFD...hAFA...,1,8,-15,23
LgaXNRBGVDHYIUZFOQfMCTAEdPecWKJSb,EAAAeAAAKACA..SADALAEBaAGARAFFGCCA.HCGBIBGAhAAAZEAFQFEAhAAA.MAIBACCAdDGAcGGAhABAbDDCXFFCBHADDIFAFGHD.OECHhCAA......hCBA...,2,-22,12,34
ILVFZHDgTGNOEYJMCRbAdKeacXfQUBPSW,eAAAaAAA...XADAQADABAGASAFALCCBZCEAhAAAHCCATEEAGCFAEEAAhABAMAIBRGAA.ABBBdDAAfEHAhAEAPEEBIFHADAIBOGEECGAAKHCA.hAGA......hCAA...,2,-7,1,8
IDaCUcWXQHABMfSTgNZYOVRLdKFePJbEG,MAAATAAAZABE..OACARAEFdAGA..eBHHJAFBGBGA.aAHFhAAACCCAUDEB.XFFAhAIAHCCBACCBSDBDhBDA.gEFDNEIA.YFHBhCAA.....hBAA...,2,-32,1,33
JUXRaLHgWeOBCGNKQcMYIFdEZSDbfVPTA,XAAARAAAHADBeAFABADAGCFA.QDAAMAFAFBEDEBGAZFAADBIBhAAA..VDAAACHBaDDHhABALDGBOEHDKHFAhADAIEEA.bGBA...fGFEhAAA.....hAFA...,2,-15,2,17
JeCLfdWRTDKQBEaOFgbVHPGYUcMAIXZSN,ZAAASAAAeACELAFBdADARAFA.KAHBECCBFCCH....bCEAHCGBhABAGEEAUFCAAAAA.XEEDhAHACDBD.fFHAhCAATFAABEHA.aFCD.....hCBA......hCEA...,2,-15,-13,2
YJFgRXeEVCAPZKQOTWBfGLIUNdacHMSbD,ZAAAQAAAOACABAFAGACBLAHBUAGAaCDCHCCC.MCGBhABAbDAB.DEFB..FDFDREGFEFCAhBHAADHATFCA.fEHAhAAAdHCBSGHHgGGA.eFADhADA.CHEA....hCAA...,2,-13,12,25
NOLbSHPXgWQBcTaEDRIVCUKYAZMFdJfGe,ZAAAdAAAGADAeACELAFBHAFA..XCAAQCCBBCGAaAHBhABARDEFCDHAKCHB..AAHAMDDBhACAfEEA.bFCDhBIASFAA.gGFATFGAEGFBhCAADICA.....hCBA...,2,-11,-10,1
gEfDdWYRGKTUJNXPVOLFbQaZIMeCABSHc,HAAAEAAAdADARADFGAFA.KAHBTAFAUCAB.XCBCODDBLDHBhAAAQCEDZFABeAHHhAAAAEFBBEGASDHHhAFA.fEFEDFABYFDBPHAAFGGH.hACAaGHB.CHEA....hADA...,2,0,3,3
TSZGPDLaUFeIHcgMdbNBfQEKJCRVOYXWA,ZAAAGAAALADBaADAFAGAHAFA.MCABdCDABBFAECFB.CCGAREBBOCCHhABA...XDGDhACAAAABTEFADCIBeEHHhACAgEED.bFAAQFDCKGHBJHAA.hAFA......hAHA...,1,2,-17,19
QBRSUDFAeETOdWKfPLbVIXHcgNJCMGaZY,EAAAdAAAKADALADA..IAGAHAGBgBCG.CCFDGEAAhAAAZABBQCEAhAFAREEADDIBAAEAeHEATCGA.hAIAfDCA.bEEC.XFGAhAIA.NIBB.aGGABHHD.hBIA...,1,-2,-13,11
REQUMXCZHYKPcaWbgJADVGSONIBdLTFfe,GAAAOAAABADAdADALAFAFAFA.RCDAECGEMAIB.ZBBAHDBBKBFD.hBAAaEFA...bFFAACHBSDDDhCAA.hAAATEGAeGAG.QFEDCHAD...hACA......hAGA...,1,-1,-31,30
dgNabfOTLXAHUPQRFMEecVISDGCZJYBKW,HAAAQAAARADFEAFE.eACA..ICFAGAFAZCDFBAHBdBHAaCAChAAAbDAAOCGDLEHBhAAAACIBFDDHMFBB.SFEAhADACFEAKFHB.WHFGfGFA..hACA......hADA...,2,-20,9,29
VNdKcPaGUTgAIJFbDRSeMQHOWBEXLYfZC,FAAARAAAeADEHACBBAGBEAEALAHBZBEA.CBFA.dCCA.KDFA..aDEAhAEAGEDAUEFBABHBIFHAhAAADEEB..MEIBhBAAQGFD........hABA......hAIA...,1,-23,-27,4
bFKeTGcgdODCXAYZEMIRVLQBfJPaHWNUS,EAAARAAALADBBACA..JAEAHAFA.UCFBFBDDKBHBeCCD.GEEBhAAAdCFADCCBAAHAZFAA.MICAhABAQEGA.hAFAaEEHSGHB..cGGC.hCAACHAA....IHDAhAAA.,2,-48,4,52
cbaTfeBXGLFgUHRKIdQMOEWJDAPSYCVNZ,SAAACAAAZACA..aAEAeACHGAGALAEAFCCA.HCEARDAAdDFAhAAAMAIB.EDDBDDIBAAAAPECBhAFA.VEGBhAGAbFEABEECXGEC.......hADA......hAIA...,1,7,-28,35
MVJHSCUWPFKRGXBDNdLAaZgYbIQTEfcOe,ZAAA..bAAATAEAEAEA.OAGD.eCABMAHBHCCCCBFAPCABhAAARDFBGGAB.DAIBdCCDhABAADIBaEAHgDEAhACA.QEGAfFHAcEADSFFDhABAFFDHBGGD.NIAB..hACA...,2,-1,5,6
AdZHPIXWfBEFNSaVRbeQUDTCgOcGLYMJK,HAAAXAAABADBFADAaAED..RAFF.eAGBQCDCDAIB.CAHB.OCABhAAAGCGAMCCBAAAAZDBBhBDAIDDAEEFB.SCGDhACA.bEFA.TFDA.LHAAhAHAKGHB.dGGA.hCAA...,1,8,-18,26
XgHbBILAPOZKdceTREaJSMCDfFUGYWVQN,ZAAAdAAAeADAEADE..aAFAMAHB.DAIBFBFDGCAB..VCAAhABAQDEA.XDGAhACAHCGBbECALEAAhADAAAIBKFHBTGFARFCACFHDfGBE..hAEA......hBAA...,2,-10,-9,1
BFNaXJIRbZUdSKDOYVAeWQGgcEMHCfLTP,eAAAGAAAEADAHADALAGBTBGABBEAaAGA...XCCChAAARCDAZDFEdFAADAIBODCBABGBQDEDhABAMFGBCFHA.FDHDIHHAhAAAbFFC.........hCAA......hCBA...,2,-17,8,25
COMdGJbSULKcaHVRfEIWZFQNPeDgXABTY,TAAAOAAAGADA..bACBLAFAaAED.HCFARAGBECFFZDBBhAGAQEBAeEFAXFEChAHAAAIBCDHAdEEDSFHHhBAAKFGAfGAAFHCCDBBBBHHA....hAAA......hAGA...,2,-9,8,17
fKWbRNPUgHCIXcYaMDGZJEFSVBTOQdLeA,KAAARAAAUADAHACB.CAEA...XAFAaAFDGBGAZCCA..FCGHBAHBhAAA.TCAAdFFAAAAA..hACA.bDEDPEHD.hAEA.gGFAIGAAMAIBEEDF.OEEHhAGA.....hCAA...,1,-14,-19,5
YJUeVMRXDaScANKgWGFfOTLQbHIECdZBP,KAAAGAAAOACALADAHAFA.EAHBZCCABCDA.JCFAeCGF.RECAaBDChAAAAAAB...NCIA.FDCHhACA.TEEAQGGChAHAbEGBdFAA..........hAEA......hAFA...,1,-9,-18,9
WCRHfDKeOJNIMFdTQYPVXbcAgBSZUEaGL,SAAAEAAAGACALAEARACFHAEB.KBHBeAGBOCBBJDEFMAIBhAAAdCFAQEDD.hABAVEGBbEAAAEAAZGAAaEGA.hAAACFHDDGGBNIEB...TGDA...PHAChAEA....hAHA...,2,-5,6,11
dYbeAEQgZBCRLScPFfDKUWXMTIOaHJVNG,EAAAZAAARAEALADA..SAHBFAHBKBCDUCEAMACA.TCDAhABAaCGEHEAA.VEGBhAAAdCGAeCCD.ADIBQFEAhCAACDDC.fGDEDFFB.XGGBhCBA...hAEA...,2,-20,-7,13
ZWAVNJHEDYGceFUKLIXdgSbCROaMfPBTQ,VAAAHAAAEADE.GAFAeADEKAGCLAHBdCDA.SCAAhAAARCFA.aCEHMEBBBDCAZEFAhAAAAEHADFAAFFCAXGCChBEACFDAfFFATGGAWHBA...JHFE..hACA......hAFA...,2,-8,-7,1
OYNVUbKXdeQPTSMgFLEcWBGaCIDHZRAfJ,OAAAVAAA.KADAeADE..QAFC.SAHBhBAAMAHBLCDAEBBBBCEDhCAAaCHDDEBAHCGBAAIBfEEAhAAAYDCBUFEAdFCATFGAFGGA.cGABhAGA.CGEA....hCDA...,1,-13,-14,1
HRQOKBDLAIefZUFYXJcSgWaVdTbPMGENC,eAAAZAAAFADA..XADASAFH..aAGAdAHA..bBFDGCAAhABA.ECCBHCCAhAAARDFAQEDDBBHDADHAfEAAhABAUGGAJHBA.gECA.TFFAhAEA.MEIBCHFC.hACAOHFE.,1,0,-1,1
JPabVNHMBTKOIfZWADFEcXdYQULGgCReS,EAAAdAAAQADAGACARAEA.eAFA.SBGAaAHD.VCBAhACAHCEC.MCBBKDADODFAhADAZEEAAAEAFGGH.YHAAhAAALEEBCDHA.bGAA.TGGA...hAHA......hBCA...,2,-9,5,14
fVZEMCOdNDbFKJWXIGLBHgYUSeARPQcaT,RAAAQAAA.aACETAEA.ZAGBEAFAMBIBdBHADCDAKCCA.XCEAhAAAGDAAHDEAhAAAUDAAADDBfECBhABA.OFGBbEEAFGGHIGCALHCABFHBhADA.SGADhAEA...,2,-9,-4,5
aKgQJCIZGYdAXBDEVfPSReOMLWcbFTUHN,DAAAEAAA...VACASACA.RAEFeAGHMAFALBGBhBAA..bCCDTCEAhBBAHDADaBHDQFFAhBIACEEBGEGAACCBfDDEOGAEFGEB.KFHB.gGCAhCAA...hAAA...,2,-13,-2,11
PUHbacKMgJYZIXdBEFONDRAeQLCfSTGWV,eAAALAAACADA.TAEAGAEA..VBGBHAGD.aCCBKCAAMCIBhAAAJCCA.ZDDF.dFFAEEAAOEHHhABAREEAAAGA.QGAAhAGASEHH.........hAIA......hCAA...,1,0,-23,23
XTIUQMJAVOWZCdFDBRKNeGEfgbLHPYcSa,OAAAZAAAdAEABAGARADA.KBHBeAGH.EBBB....bCABHCEBhAEA.PCHDSCEAhABAaDCD.TDGAQFGChAGAADABCDDD.DIAAGEBA.LFEBhACA.XGGA.hAIA...,2,-14,-12,2
HAOdKIRGJVCYFMeZDWXNaLPgfQcTSBbUE,dAAARAAAGADACADA.MAFAeAEH.ZABBDBFA....XAGAhAGAaBGELDAA.fDFAhAAATCFABDCAEDHBHFDAhABAADIBKEEAIFHAJFHF.FGGHNIDB.PHAAhAHA.....hADA...,2,-21,-8,13
dOBWSJgENMCYGbAFHaecIZRDfXLUKQVTP,HAAAeAAAZADBRADFDAFALAGBKAHB..QBFDTDBA.dCADBBCAhAAA.SBFFhABAEDDBMDGBCDHAbDFA.AAIBaEEChCAAfFEAUGCAOFGDJFHB.....hAAA......hACA...,2,-21,1,22
ReDWSOFbBJPgZfEAMaNHcQYCdUVXTLGKI,aAAAHAAA.QADCdADAUAFA.TAGAGDBARCAAeCEFDAIB.OCFDhAAABBBDJDDAZDGBAAFA.MEIBhACA..NDHACFFA..hBAA.LHBAWFFD.SGHH.hAIA......hCAA...,2,-25,1,26
IUZRBcGTKMLSPaCegfdDYbQWOVNAFJXHE,XAAAHAAAEADEZAFBRADA.GCABKAGC.MAIBLCDA.aBHDeCGHhAAAdDAA.bECA.QFAChACAOEEAAAAAFEHDIFHAhAFABFCASFFDCGGDDIEA...YHCAhADA...hBHA...,2,-17,5,22
LIJaFDSbRAcHMUeWNBGVKdgOYTZCEPXfQ,HAAAeAAABADAGADAdAFAOAFAZAGB.EBFE..XCCALDAAhAAAaCHDSBHHhACA.ACCBMDFBUFBAVEFBhAAAKDGDTGGACFDA........hADA......hCAA...,1,-6,-25,19
UMeLFgQYcCaAZSdWRHTBKNbVXJDfPGIEO,dAAAHAAAKADAVAEADAFA.GCAB..EAHFMAIBLCCAQDEAhAAACCGD.AACAZEAARDABBDHAhACAbEGB...JECAfHABhAEA.OHCAeEGBFGBD...hAHA......hCAA...,2,-33,5,38
YKeOSJfMALWBFaCPTEXRcVGUDQZbINdHg,LAAAFAAACADA.EAEARAEFGAGADAHB.ZCCF..bBDAdDAA.HEEBhADAKCAAeBHH.SDDAhABAMDIBAAIBBGAAaEAATEFAhACA.cFGD.....hAGA......hBAA...,1,-12,-27,15
GfLaHVWAgXBKdJYUPDZOQESNeICRFTcMb,BAAAdAAAUADAZACAEAFE..eAFARCCA.FBHDMAIBGCAB.LDFBhACAHCFBAADAKEED.JEHBhAAADEEB.QGAAhAGA.SEHBCHAA.TGCAfHCBhAHAaFHH....hCAA...,2,-33,-5,28
YSHNEKaWBPQVgedbCMFXfRGLODAcZTJIU,ZAAATAAAUAEA.HAGDEACE.KCAABAEB.QAGAeCHHdDDAMDGBhABAXCCA.RCFBGFCBhAAALEBBACCAIFHAhAGASFDAaHDCPFHD.....hBIA......hCAA...,2,-12,-12,0
OCbZUaJcMQFfeNTSgPIGVEWYdBRKHXADL,LAAACAAAZACA.aADDMADA..QAFAeAGF.TCAAhABASAHHIDDAECCAdDEAhAAARDFAHFAAADHA.bFDBUEGAhCAAFFGD..fHBFgGFG...hACA......hAFA...,1,2,-25,27
GXFQATPSBOWcJZIKELfgCaMbeRdVYHUDN,TAAABAAAOACA..JACAZAFBKAFCEAHFLBHB.CCCA.bBCChAAARCEA...dDBDHECAhAAADCIBGDGAQFGAhAIAAEEASFBAIGEAaHCCeFFB....hBDA......hBFA...,1,-10,-21,11
EAVgXWLGYBJRabZKHIPTFdeUCMSNfDQcO,XAAAGAAABADARADA.ZAEBHAGB.TCEAeAGFMAIB.SCDDhAAADCDBQDAAhAAAEDGFADAB.gDGAhABALECAaEHDbFFAKEEDFGGHdHCBCGAANIAB.....hADA......hAEA...,1,1,-3,4
MYcRfKXQJSWVTGOHICPFdNUDBbeZaLEgA,MAAARAAAKADC...QADASAFATAFAHCCA..CBHAdCFADAIBeBBBhAHAZDGBLFFDhAAAACHBfDDAJECF.GEFAhBAAIGAAFDHDBFDAEGHF......hBCA......hCAA...,2,-17,-12,5
SKBUOfGCgbPceITRNdLAaFEXMVZJWQYHD,EAAAMAAAZACB..QADAHAEAKBHBOCBHGAGACAFA...bBBDhAIAeCFF.RDGBdEDAABBBaDDAhBAAXGAA..hAAAVEFBYFGFBGDA.......hBIA......hCAA...,1,-4,-20,16
LTgCPfQSRGVIdXFNOAYKWBJaUbeEMZDcH,KAAABAAAUACAEACAZAEBHAEALAHB..TCFACBDA.QDDChAAARCAAGCFAdFHAFDHDAAGAhAIAJEEFeFFB.MHCAhBIADGBA....PHBA.SHGGhAAAIHHA.....hCAA...,2,-20,-13,7
EPUgAKZHFJYaLReNXTCcVdBMQDObGWfSI,HAAAFAAA.aACARACFeAEE..TAFACAHB.dAHAMBFBQCCAhAAAOCDD.GDFA.hBAASDHBECGAUEGAAFFAhCAAZFAALGCAcFDADCFB.fHGFhAFAIHHA.....hCBA...,1,16,-27,43
PSJQZFCHNRTdbEXBWLYgAaGMDfVcKeUOI,GAAAMAAADAEA..fADAKAGA.eAEHOBBA.SBEHhAIAZAFBHCGBREEBdCGAEGHBhAAABCCDLHBAACIBaECA.hBAA.UFFA...IGDA..hCAA......hCBA...,1,-1,-39,38
WVHZCXbMLTFUOIacSNdBPRfegDQEGYJAK,KAAAHAAAZACBXADBLAFAFAFDUCAA..aAHB..SCFAhAAAdCADRDCAeBHHQECAhACAEEFFJEHBAGDA.CDHAbEFC.hAAA..MHAA.TGGA....hAGA......hAHA...,2,-17,-9,8
JPIaeRMQfTVWLBUcKNgCYFZSObdGEAXDH,HAAAJAAA.aACARADF.MAFA..TAGALBFABCCDKCCA.CDEAZDFBhAAAOCEDGECAAAFADCGBeEHBhBGA..QDAChADAfHGBUFGA.NIABFCHD....hAIA......hBAA...,1,0,-26,26
SEWgZAOIKRDVLFCNJQfBTdaUXPebGcMHY,KAAARAAALADBCACB.QAFABAEAdAGAUCCAeBHHGCEA.hAAAHFAAECFBZDGBAAAADCCBFEABhAEAfEHA.hAIAaGDDbFEB..cGGCMEIB....SGBAhBGA..hBIA...,2,-35,6,41
RKTcZFALEagDJMSXQWfPCeUYbNOVHGdIB,EAAAaAAA.DADA..MADAQAFA..fAGAeBCBbCDD.hAAAOAHDHDGBdDBARBBATCEAhBAAZGDAAAIB.LEBAhBBASHBGXDGDCHHA.UGEA...hBDA......hBEA...,2,-8,-6,2
DLgHUEbeXZAaYMTPQJKCBWIfOSRVFGdcN,aAAAMAAA..QADACADABAFA...fAFFRAGFGBBAdDEAhAFADAIBHBGBEDGB.eBBBhADAABBB.TDDAKFCAOEHDhAIAFEGHLGCA..gGFBhBAA......hCAA...,1,0,-29,29
cTZbUfFJegaLOGRPdEBMSWICYNQXKHDVA,ZAAAUAAAFADAeADALAGBRAGB.dCAAECDABBFA..MCGB.SDAAhADACCCDQDEChABAHEEBAAIB...bEAAfDHAhACAaDHDOHEEGECA.IGFAhCEA.....hAEA...,2,-19,-11,8
QUZYWPNVKMDTXIHRbCOSgJcfBFGLdeEaA,ZAAA..PAAAKADCMAGBDAEA....TAGAHCAARCEB.OAHBhABASBCA.gCDAhAIAfDHAGCFAhBAAeECBAEEBQFBAUFGBYFBFNCIAXFGDhBDACHHD.BHDA.hACA...,2,-17,-4,13
QFZUTPaKRgVXBdbcOeNIGDAYLJEWHfSMC,LAAAEAAAHACAMAEAQAEAZBEE.TAGAaBHD..RDDAXEGAhAAAbCAA..eCEBhABAGGBBACAAJCHBSFFGhAIAFEAAKFGDBGDAOCCBDFIB.YHEGCHHD.hACA......hAEA...,2,-10,14,24
dPNOJMVbESGfaRDTYXAKWLIBFeZgHcQUC,LAAAFAAAeACHHAEAQAEAdAHA.OAGFMCEB..ECFFGCAAhABARDGBDDDB.TCCA.hAEAAAIBKDFABFFAZEEAgGAAhAGACFDDNCIA.........hACA......hAEA...,1,-13,-14,1
TABXgWGJHOYFMeUKRaVQIdPDSNfLbCcEZ,XAAAGAAAHADAFADA.eAFE.RCDAaCGAQAGA.dCDASDADhAAALCFBbDBBhAAAEDCBADHBBDHAJEFBMEIBhACAKFDAIFHADFEBCHFA.ZGAA.gGGGhABA......hAGA...,2,-11,2,13
HaENUFJMGQAYbXdfgKLcDPORCBTIVeWZS,XAAAdAAAKADALAFBDADA.RCAA.BAFA..TDGAeAGHZBCBhAAAHDCCECHFFAHBGECBhABAACIB.bFGD..fFCAhACAgGEAOFFB.CGHA....hAIA......hBIA...,2,-17,-15,2
USgTcDHPEGJAeYBWOaNXfQIbdZVCRLKFM,eAAABAAAaACA..fADAQAFAdAFAZBCARBGFLDDBhAAAFCHDMDBA.SCCDhABA.TFFAHDFBEFAAhAAAAAHAODHDIGHAbFBBCHHAKFED.....hBFA......hBIA...,1,-7,-17,10
MISLQODANUeYVFaGgBfRbZdHCXcKJWETP,eAAAFAAAGACABADARAEFdAEBHAGB..XAGDKCCAEDFF..MDIBhAAALDFA.QEDDhAIAAAIBUGAAaEEHbFBDCGFA.hABAJFHB...TGDASHEGDFBB..hAGA......hCAA...,2,-17,-6,11
UPTXeEWQZVcDOKfdLGMYFgIbCSBNaHJRA,TAAAEAAAZACB..DAFAKACCLBEAGAEAMAHBFCHD...bCCDBCBChAAA.HDEBAAGBXDGAhAAAeEDDQGBChAIA.OFHBdEBCgFFA.SGDBhAIA..hBEA...,2,-21,-10,11
MVOXFEKaReQfISCUPHBLTgbJcNGAWdZYD,ZAAAMAAAOACAFADD.KAFARAFA....eBBBQCCB.SAHBhABACCFDHCGBTDDAhAFAJCFAGEEAACIBdFFADFIBhAGAEEHBaFDB...fGHE..hCAA......hCBA...,1,-21,-24,3
HMbISRAKCTedXNGUPQEDcOZLgYaVJBfFW,TAAAeAAAdAEA.GAGAQACCDBDBZDEBLAEB.aAGABEBAhAAAFBGBHDFCbEFDRGAAAAGBXECAhAAA.PFFBhCAAEEDFOEHD........hABA......hAIA...,1,-1,-15,14
JQDgGLPFYHKNeZfMCBOaXTRbEUcVdWISA,QAAAGAAALADAFACEHAEBeAGHZAGBMAIBOCDB.aCHDRCDBEDCBhAAA.VDGBdEEASFHBhAAAAAEADFCB.gGAAhAGAKFFDCGHA.TGFA....hBGA......hBIA...,2,-6,-6,0
fIbgZOYEKTeLRAFGcCNdaSBQJDHWMVUXP,GAAACAAAdACABAEAQADA.HAFAMAGBXCDC.fCGAhAAAbBGDZCBAEEAAeCHHhACA.AAHAFEEB.aDAHhADADAIBUFGBgEFG.KECA.LHAAhAAA....hAEA...,1,17,-33,50
UXTLWNBMCAfZaQeHGDYPcIVRObJFdgKES,aAAAHAAAGACADACA....PAECIAEARCCA.OAFDFBHDdCFAhAAAEAHBSEEDhAHAUDFBTGFALEHBBEDAABBBhAIAZFFBeHCE.........hAIA......hCAA...,1,-9,-14,5
XBaIVfOdHcGSYCELTUZQJPbDeAgKWFNMR,KAAAFAAARACFBACB..aAEA..IAEA..OAGDHAFBGCCAhAAACBEAEDEALEDAhAIAZEFAQGEAJDHBDGGBABIBhBAANAIAMHAA.fGHE...hCAA......hCBA...,1,-14,-34,20
AIQLDVfYHUWMGCXNeZBdTcaFSEJRbKgPO,LAAADAAA.VAEAHABC.MAEAGCAAXAGAeAHHdCCBaBED.hBAAEDDBRCFF.KDFA.ODHDhABAACCBQECAUFDBCGGABHAAhACATFGA.SFFD.JHCA.hAEA......hAHA...,1,-2,-9,7
baFfUKTMGIVXPQOACEeLRgWYdNcSZHBJD,EAAARAAA......gADBdADASAFAHAGBDCCBaAHDfCBAhAAATDDAGDFAhAAAXCEAQFAAhABAAAFAeDDBLEHBNDHA.BAFBbFCDKFFBMFDB.hBCA......hBDA...,2,-18,7,25
JEBVCUNFHRfTZaQgSObYdWPGXAKMILcDe,MAAALAAADAEA.EAEABAGAUBGAHBBA.RBEFZCGBaCAA...QDBBhAIAOCEBdEAAGGDBhBAAAAHAKDCBeEGBCEED.FFCHhABA...TFEASGGE..WEHBhACA.....hBBA...,2,-21,-9,12
bIaOBJQMPKZWYRAHdScXFCNgVDULTEGef,HAAAdAAASADAFADACAGA....VCCALAGBGCFAeBFFhACA.bCBAaAHDBDADMCABhAAAZEAERFCAADIBXDGAhADA.DAIBEFHBOFFBQGACKGHB.YHDGhACA....hAGA...,2,-9,-4,5
JHKYIFREdXMNecWCBSTfPgAGQLbVUDaOZ,GAAALAAAUADAaADDZAEBHAFA.KCGAFAGDEDDAdCAA...MAIBhABAeDBH.CEFABEHASCCDhACATGGA..fDFAhDAAAAAB.bDGDOFEBIHHA.hACANEEA.PHAA..hAHA...,2,-14,-10,4
MTbFgYLXVUfRJOZHaIANKdWESDGPQCBce,dAAAEAAAGACAQADABAEAeAFA.MBIBbAFD...FCBDLBHBhAAAXCFAUEAARDCFZEFAhACAHEDAADAB.KFGADGAACCBDTGEAhAEAVGEA.OHAA.IHHAhAHA......hAIA...,2,-1,0,1
cgLJSaBGOXEWfUHFNbVKPRATCeIZYdQDM,eAAAZAAAdAEAMAEALAGB..aAGEGCAAEBCAUCEAHDDAFCGEbEGDhABAKEDD..AACATGBAhAIACEGAQGGA.DFBBhAAAgFDGBFFD..WFBHNBIA...hBEA......hBGA...,2,-16,-3,13
NAfWbYKFLISCeaPREXQgZUMTHOJDBVdGc,...bAAAFAAA.LADACAEA.eAGHRAFFEBHFQCCAZCAA.hAAAMAIBHEAADCFBdEEAGDGAhAEAAAHAfDHAhABAKFAAaFFH.XGEA.......hAFA......hBAA...,2,-22,-8,14
CfKVePIaZdgbFHUTYOQXBEDRWJGALcNMS,LAAAMAAA.CAEAKAGAeACA.aAFDdCAAFAHBHCCA.UCFAOBBBhBAABCHARCDBGDFA.hABAACIBSDCDhBFAfECEIFFA.bGACYEHB.hACAEHDADEEB.JEHB..hAEA...,2,-21,-6,15
NAeSJdaRfcPbXVCLgITFBMEOUKGQZWHDY,eAAAdAAARADA.....fADAbABD.CAFALAHBTBGAMCFBhADAEBGFKCCDZEAAHEFBhAEADCFBAAAA.aAGA..XECAhAFAIEHAOEHBQGDDYFFBSDCAhBAA...hCAA...,2,-28,6,34
gJPbaDQFHMIcTLKUYfRNGeAEdVBZOSWXC,EAAAdAAAZABB.OADCXACA..CAGB.JAFA..aAHDQCCChAAAHCEAMDDBTCFAhADALEEAKDHBUFBARFABeEHHhAFAAEEASFFA.WGFAgGEAhBAADIAA.....hAIA...,2,-21,-2,19
FHZSDdBXWEPQfIeMagGObcNLTRYAKVJUC,KAAAUAAAHACBZADAdAHABAEA.EAGAQCDA..eBHFaDCHGDGAhAEAbCADLDEBhAAARFABAAFA.CEHADCAB.XFCDhACAfFDAMCGBOFFBTGGA...hBAA......hBCA...,1,-1,-17,16
VKEFJADQWabMcZfUHgPOdBRNTeYGCLXSI,QAAAaAAA.MADAZACBHAEA.OAHDRAFAeBDBGCFAhAGALCFASDEDhAHAKEBAEEFAADDBbECDUGGAdFHABBBDhBAANHCB.CHGD..........hAAA......hAIA...,2,-16,-1,15
ZMaCdJYPUgfOcBDRXQGKVeIAWTbSLHEFN,TAAALAAA.HADBEACEZAEBaAFA..dBFAJAGBUCAA..OBHDhAAADAIBRCGFGEEAeCCBAEAASEAAhAEAMDDBCGHA.hABAgEEABHGD.QGGA.hACAKHEA.....hDAA...,1,-3,-9,6
gBFIYceXafJGSPdWCQLKZRUHNDAOVTEbM,TAAAEAAA..MADAFACA....IAFAeAFAaBCAGAGAhAAAdCCAQCFAZCCAHDFBAAIBhCAAbEDDBECA.XFCAhCDASBHHCFHA.RFFADFCB.....hCEA......hCFA...,2,-14,-9,5
HOaAJdRMQDTPEBLNCIXgbUSfZceKWGVYF,RAAAMAAAQADCDAEA..EAGALAFB.CAHA.XBBAhBAAUEDAZCGBeBEBGGEBFBHDHDFBhBBAAAAAdFCCBCCDgEDDhBCAfHABKFBAYEHB.aHEA.hAHA......hCAA...,2,-12,-2,10
MgEeXZVJLbDNQROaYHSCAcfWdTFKPGIUB,...fAAAdAAATADAKADAGAFABAFBEAHBeAHB.ZABBLCBAhAAADDDARDGF.aCEDHEEBhAFAACCAFCGBIHHAMDABXEFAhACA.........hAIA......hBAA...,1,-12,-20,8
XKNfbDPEJYSdGAVLCRFUeZHaWTOMgBcQI,LAAARAAAeADEHAGBaADD.OBDDBAFAQBGAKCFD..bEFAhAAAECAA..SCCDhABAAAHAFCEDZEFBMDDBIGAAhAGAfEHADGEAPHEAdFAACGDA....hABA......hACA...,2,-18,-1,17
OIPBDRJNTUQSgeCYFbKWdLVEGXMfcaHZA,OAAABAAARACA...TADAQAFC.eAHHFAFAKBBDdCAAECCBhAAAGCDB.MAIBaCECHEEAhACAACGADDCBUEEBCDHAbGEA.hADALEHB.fHFBIHAA..hBAA......hCAA...,2,-22,-3,19
JWeXGLMPaTQKbZgfScREACYUHdDVOIBFN,CAAAHAAAdACA.OACAFAEA.JAFB..eAGHGBGAMAIB..aAHFQCDAhAAAZCCB.SCBDhBCAEEEAACCBDEIBBFGDhAAAXDGD.TFDA.KGGA.gEBAhBEA...hCAA...,1,-15,-24,9
FTcIARGedgHQCZJBVDUbaWYKEOfSXMPNL,RAAAeAAAHADBZADBBAFADAGA.UCGA..aBFAKCCD..EBCFSDABhAAAMBIBLCFBFDED.hABATFDAAAHAdFADQFGAhADACDEAJFHB.bGDCOHDE....hAAA......hABA...,1,-10,-20,10
QBHaXcReZCKAgELIUFVDPSdfbMJOTWGYN,EAAALAAAFACD.DAEAdAEAMAHB..TAGAGBCB.QCAChABAHCECaCHDREBAeCHHZEEFAEBAhAAAgDDAUGGASGABhAGAbFBCOFFB.NIABBGHA.CHGD..hAIA......hBEA...,2,-7,9,16
PGYgCVJFZOBHNSDTdWeUaAIRfbMXQcKEL,RAAAMAAAQADCKADALAFBGAFA.CAHA.FAHBZCCAHBBA.DCIBdDHAhAAAeDDBAEEB..bFAAEDGFhBAA....gFFBhABAOFCBSFEHWHAG.aGGAfHEBhAFAPHFC...hBBA...,1,-5,-17,12
UTNSdfXKcbegVBMDaOPEIYLFCAWZGHQJR,GAAAHAAARADFUAFASADAdBHA.KAGAeCABBCDADCCBOCED.hAAAECGALDDA.hAAAAEHAZFDATEGA.XEAAhACA.bGAAMFFAaGEAIHHAhADACHGA......hAEA...,2,-16,-16,0
UOFVEgGdRAbKYeDfPQCMNSBLWJTcZXHaI,KAAAeAAADACAQADA.MAGBBAEALAHBTAGAZBDAHCCAhAAAUDDAFEEAEEHB.dFBAhABAACCB.fGGAhBFACCHA.SHBAJEGBaFHD..OGAA.hBHA....gGEDhAAA,2,-40,-2,38
TYZgFaEMLBXWcJePQVCUSHGKIAORDdbNf,RAAAdAAA....bADBTADA.ZABBaAFDEAFELAHBBAHB.XCCDhAAAJCEB.eDFBhABAQCGACEHAHFBAGGDBhBFAADDBDEGB..fFHA.FGCAWHBGhBHA.....hBAA...,1,6,-34,40
SYRGLVQCTNdHUJMWDXEcbaFgPefOABKZI,ZAAASAAARAEAGCAALADA.QBGATCDAHCFBMCCAhAAAXFFAEDDA.aAHDhABAFDFDeFADAAEAKEHBIHDAhACACGGAdHAB..WHEGDADA......hABA......hAHA...,1,3,-21,24
LRHfbJVTUQEYdWCNcegDKOPaBSAZFGIMX,GAAAMAAARACA.HADA.JAHBTAGAUCDB.EBBBdDGD...CEEDeDADhAAAKCEAaCHDBFGAAAFAZDDAFGAHhACALFFA.bGCChAIAQGCA.YFHBcECCOHFChBAASGFD..hADA...,2,-11,1,12
cHYGAIPEQaXgCNBLeVSbdRFTDZJKOWUfM,EAAAaAAA...CACALAEAeACH..bADDRCCADAIBZAFA...OCFDhAAAfCFBHEGBAAFAQEEAhAGA.XEGAhAHABCHDdFCAFGHHKEEDMBBB.YHCAhAIA.....hCAA...,2,-28,3,31
YgKJZPaCFTNAeXRfVOBMWGbIdQELHcUSD,RAAAOAAAMADA.GADAdAHALBEBHAFASBBDDBGB.KCGAZCCBhAAAaDBETDGA.ACCB.hABAeDFB.fEHAhAFABFFAIGHAEGHFYFFFPHBA.FHAA.hBHA......hCAA...,2,-25,8,33
JWGNZDTEIQcebBgFLKdSOUVXHPARaYMCf,RAAAaAAAMADA..CADA...JAGBGAEAZBDB.EAGAQDFBhAAAeBBBBBHALCCDdDAAODCDhADAXFCAHEECADHAfFFEhABADEIBTGAAIFHAgGDA.hAIASGHD.hBIA...,2,-24,2,26
XTNWLGbBcFSgRIUdMOeVEJAQDHCKPaZfY,HAAAKAAAZACBXADB..TAEALAGBGAGAbBEDFCAHRCABdDEAhAAAeCCBEECA.AAIBQEGAhAAACEGD.aFFHfFHAhACAYGBABHHASGAA.gGDAhAGAMICA..hAIA...,1,17,-21,38
KdMBfFAWUJZHXOgGNbCVDScaEPIRLTYeQ,UAAAHAAAOACAGADACAFASAFA.EBHFRAGFTDAA.hAAAeCHHdCCAMCFBBDFAAADBhAFAZEFB.XECAhAGA.bFGDDDDBaGCBLFFA.KFDB..hAIA......hBAA...,2,-22,5,27
JcDKHQRBfWOdLIZGYVAbTPSFXgeCNUEaM,TAAAFAAAeACH.UAEAEACE....aAEAMAHBDAHBHBDCRDDA.BCCDhAAAOCHDdDEDZDGBGEBAhAIAAAIBSFFDhCAACFFA.NEIA.KFHD.QGDD...hCIA......hDAA...,1,-15,-17,2
KdSZFNUAIaLPfWeOEMCGQJYVgTHDRXcBb,aAAALAAA...fAEAeACHEAEAGAGAQAGAVCEBhAEAHCAARECBBEHAdCFAZDGBhABAFFGHAAIBIEDA.hBAAOEABMBBBCGBAgFDADGIB.bGFANIDB.hBGA......hCAA...,2,-8,8,16
JFXeNIUPTAWZVMaYgDLHdOQcSKCfBRGEb,ZAAAaAAA.DACAHACBdAFA.QAEAKAHB.BAGAECCB.FBHD.eBBDhAEAUDFAADEA.MBEBLEEAhAIA.SEHHhBAARFBAJFHB.XGDA.IHHAPHCC.hABA......hAHA...,2,-34,1,35
dRbWZUJEBcKQeHTVOPIFNLDYSAXMGCafg,GAAAaAAA.dADARACFZAEBEAFABAHAKAGA.HCDCOBBHFCGA..LEEAhAAASCFHAEIBMFAAhACACCHA....bEAAUGEAhAFA..QEGA.eEEB.hBAAPHCCDGHB.fGGEhAEA,2,-15,-14,1
CXfQZBgcUOebTKaNHWVSMdAYGJRDLEFPI,GAAARAAAEADE.FADACAFB.QAGAZAGB.BCDAUCCA.eCFDbCED.hAAAKDHBHDBB.SDGAhACAAAAADFFB.LFHBhAGAXGCAfGCAOHFC.aGDD..hBAA......hBCA...,1,-3,-30,27
gSBFNeZOYbRTIWAMdVKDPHafJECLQGXUc,dAAADAAAHABCaADA.EAEELAGBGAGAUCCBSBDBBCFDeDHHhAGAZCAEOCED.REFF.TFEAhAIAAAIBKDHB..JGBACEFB.hBAA............hBIA......hCAA...,2,-22,-18,4
MEaeRbNYJLQUZFIgPVdfSTKBOcWHGACDX,XAAAEAAARACA......bAFBYADALBHB.ZCCAFAGAhAAAIDAAVCDAdCGATECAhAAAODCBHFFAACIBMEIBhABAeHCAQFFA.gFADhAFASHFA....hADA...,1,-2,-4,2
CfQGYXeBZDaUOSRbFTdKPHJNMIELgVWcA,QAAAGAAAeADAZACBaAGDOAEC.RCEA.bCDBdAHA.HECAMAIBhAAAEDHFLDFB.hAAAgEAAcFGCACEAfGAAhAGABDHDSFHBTGEAKGBA..hACA......hADA...,1,8,-7,15
WOKDabGRdYHZILgPMNACcVeXTFEJBfUQS,CAAAeAAAFACA.EADABAFAUAGA....QBGAOBEDDCCAGCBAhAAARDFFHFGBZDDBLGBAhAAAMEHB.ADDB...XFADhAFA.TGEASHDAaDFD..hABA......hBGA...,2,-22,-18,4
HZTagNQUWLCJKBYEAbRVSMOFdIDGcXPfe,RAAAMAAAdADAGAFA..XACAeAHBHDDBaAFA.QFAAhAAALBFAKBBDECCBAAFBbCDCODGDhABADDHB..fEEAhAIAgGGAUFGB.CGBABGEA..hBAA......hBGA...,1,8,-21,29
fXdOSeZKcbYgGIFLAHRCaPBTVEQWNMDJU,HAAARAAACADB.aACABAFAEAFA...QBGAMAIBDBHBUCCAdCCAeCFBhAAAZCFFKFAA..bCDDGFDBhAAA.LEHBhAFAAAHATFAA...VFGB...NICB..hCAA......hDAA...,1,-4,-14,10
BZJcLTbRUGMeQPHDgAXfFSEYOCWIaVNdK,FAAAEAAA.CADA...aACDdAFAZADBLAHB.RCCA.GAFA.eAHBhAAAHDABACBBSDEHhAIAODFCIFFAKDHDBFBAhBCAJFHB.bGFA..MEEBDGFA...fHBBhADA...hBFA...,2,-21,-17,4
LcdVbKYJATeSNQaCUGEOFZDBHIXfWPMgR,eAAAQAAACADA.EACAZAEBHAEA.XBGAfAGA.MAIBhAAARCDBdDFA.KDCDACCATDFAhABAaDHHGGAB.DAGAhAAABDDDIGGAgECG.LFFAhCAA.....hCAA...,2,-16,0,16
PLGMFaSIUYbJNdOgKCBfXZAVHRWQcETeD,HAAARAAAQADCEADEeAFELAFBGBEBaCACSAHB.UEDAhAAAbCCDdDHAKCCDBCHDhABAZEEBAGGA.VGFA..WHEAhAAADEIBMFCB........hBHA......hCAA...,1,4,-12,16
EDCgcZUBQNMbPSdJfHVXLIaGYKOTeRAFW,EAAACAAAZACABACA..MADASADH.dAFAHAGBLAHBhAAAGCCAOCCBREFAAAIBDFEBUDEAhBFAQGBC.hBHANIDB.bEGB.fHCBIGHA.aGGH..hCAA......hCBA...,1,-17,-18,1
ICeLRBUFOSaHKQZGfDEYNPXTdgAbWJcVM,JAAAMAAA..eADERACAFAFA..aAGAHCCCZBEAGCCAEBHF..PDFDhAIAdEFAACCB...bEGDhBAA..WCHH..hBAAIFCALHBAOBBBKGHB.DDIB.XGCAhCAA...hBHA...,2,-23,-2,21
aQEfMXbAHGCYVDeRBIcdFLONZTUgJKSPW,HAAAGAAACADBDAFARADABAGB.dCDDLBFAZCFB.TCCAUEABKCHBhAAASCAD.aDFAhAAAEEHB.MEEBABGAeDHHhACAFGGB.OECB.gEEA..hAIA......hCCA...,1,-17,-23,6
YMWKbdOUDJLZGXPTNgSAIaEfQHFBcCeRV,EAAAHAAABACAeACERADF.MAFA.KBFAdAFADBIBZAGBGCCA..TDEAhAAASDHDABIBaCCH.hCAAQFEA.hCBACGGBYHBAbEGD.......hDAA......hDBA...,2,-30,-6,24
WTMRSDOIACBbXeLcQaUJKNgVFfGdYHPZE,BAAAeAAALAEAaACA.KBCAVAFAGCDBHBCAEDHF..MCBBhAAAREFBOEEHACIB.bFAAQDEAhAFA.UEGAhAIANIAB.fEDE.dHDBYFHBhAAA.....hBCA...,2,-16,1,17
LEPSeWUROITcGDQCZNKaMbFABJYfdXgHV,BAAAJAAA.dACAHADBEAEA.eAFA.RCFA.TAGAGDAA.DCCBZCBAKDDDhADAaCEA..MEFBACIB.hAAA.XDEDLEHBhAFASDHDOHFCQGCAbEAAFGEAfHGFhAEA...hAGA...,2,-15,-4,11
WUDAZLGVPBYTeKXMcbaSOEHfFRJdgIQCN,GAAABAAAeACAMADA..aAFDEAGAHBGBRCDAdCGAQCAA.hAAACAHBUDCAABIBZEBBLEFAhACAVFEA.TGGAhBAAXFBC.SHFA.OEHFhAAA......hACA...,2,-10,-8,2
WYeFaMHcPKJVXdLZGNSCRbOUDBEQAgfTI,TAAA..IAAAeACEFAFAHACAKBDD.XAFBZBFEGDEBhAAACAHARCAAUCFBEEDB.ACAA.fFFEhAIAaDEH.MCCBhCAAPEABdFHASHDAbECDBEGDQGGAhACA....hAEA...,1,5,-12,17
HeOadEVUXILBZRGPbfJQATMSKYCcgWFND,MAAAKAAACACB.......gACAFAEAHAGBeBDFdAFAEAHBXCEDhAAALCEAREFAGGDBhAIAbDDCQEGAhAIA.ABBBTFBASHGAcFFCDCCB...hBIA......hCAA...,1,0,-21,21
dNADaBLWYcfOeSJQVTMbIFKGXgHPURCZE,aAAALAAA......cACDeADHQAFAhABAMAFAFBEDGBGAHCABRDEAEDAAAAIBBCHAhACA.fEDEhAFASDDDTFGAbEEBXGBAPFCBCGFDdGGAhADADIEA.....hBAA...,2,-17,3,20
cUYTMABEXaGZLdFbWCVePfOISQRKDNgHJ,EAAAGAAAdADA.FADACAFA.eAFH..OAGDQCGARCBB.DCDBHDDBhAAAUECBMAIBAAABaFEDbFAChAFA....PHAAhACASEHBKGGANIDB.gFGD.cGDDhBCA....hBDA...,2,-19,-11,8
ZGYKQgONPIdHFeTVWSEDBcJaLRMXbCUfA,GAAAQAAAOADA..IADAHAGBeCDBTAFASCEBhAAAEBHFBCDAaDBDRCEFbEFDhAAAfDGE.AAIBZFFAhACAKDCDgFABdGBA.FDHDDDIBLHAAhAFACHHD....hAHA...,1,10,-2,12
KXVdeTQBYFHaRbCZASfUcNIPgJMOWLDGE,SAAAUAAA..IADAJADA.MAFALAGB.EBCFhAAAXBDAeCEBTEGAhABAQBGAFDDHHGCAhAIARDDBZFGBABIB.fGBANIEB.ODFCDGEA.hCAAKGFDBGHA...hBAA...,1,0,-23,23
gEPBDOXZTWeHcJGaNKSfFIdYMUVLCQRbA,EAAADAAAZABE..eACAHAEBGAFAaAGAKBHDFAHF.dCCAUDAALDABhAAARCCF.ADFBBDHAODGBhADATEDA.JFGBfEEAhBAAMFIB.QGBAbFBD.XFGDhBGA.NIEB.SHDEhADA,1,4,-21,25
dNPCceQYJaEOVGHXMZKbRUBSIFfDLTAgW,dAAACAAA.eADAQACA..aAGDEAEAGCABHAGBZCAARDEASBHHhACAfCEATEAAhADAAAIB..gDGAhAAAPEHDJFCBXFECbFDDBGFADFIB...hAEA......hAIA...,1,-5,-7,2
XMAZdOPVQbeRDECNWKFULHJScIaYfBgTG,dAAAOAAAQADARADA.EAFACAGBKBBD.LCDAHBGBSCAAhACA.aDCDBBHAhAEAGEDAADHAZEEAbFFBeFCBhAIADAIBFFHDUGEA.IHHAfGCE..hADA......hBAA...,1,2,-27,29
TFXJeGCEVQfUbWaSZIBKdMDgAHOPRNYLc,HAAARAAALADBTAEAFAFAeAGHGCEA..ECABQCGAhAAAUCCAaBHDZDFAKDCDdFBDMEABAAIBOFHBhABAPFFBNIABXGCAhBFA..CHGA.fGFA..hCAA......hCCA...,1,9,-9,18
UDNGHARgaJBVXcCdEZKIFPQefMLOWYTbS,RAAAaAAABADB..XACDdAFAEAHB..ZCCAFAEA.eAGHMCHBLDDBhAIA.OBBHhBAATECAbDFADDIB.HFFAhAAAABIBgEBAJFBF.CFFAKFHDQGDDhABA..fHDBhBEA..,2,-20,-1,19
dcCePEHGKIAWOgZVJRafNDYTQLFMXbBSU,OAAAZAAARAEA..aAHDDAEA.QAGALCABMCCBBBBDdBDAeCGBhABAHCEBGDDAACGBVEGBhBAAJFGF....fHABhACATFBAFHDASGEHCDCD...hBFA......hBIA...,2,-18,-6,12
HUfBAVgLSOYXQPNWTDFCaeZRKcJEMbdIG,LAAAOAAA.QAEA..PADCTAGACAGBeAHHhBAARCAAKCEDECHFdCCAHCFB.hABABEDAACAASDFHhACAXFCCDBBBZEAAMEIBbFFAIHFAfFEEhAEA.gGGDhAIA...,1,-10,-14,4
MQedLNKbZWCVUBSOXgRAGaEFIYDTfJcHP,EAAAFAAADADA..TACA..fAFAHAEBMAHBeAGHdDDALEABhAAAKBCAZDDACCHABEBAhAIAXDGAAEHA.aCCHIFDAhBAAcFEBQGGA.NIAB.bFFAhBEA.WHFG...hAEA...,1,-6,-28,22
cZfUBGaJgPYFRTIHeLdCMWNbSEKVXQAOD,DAAAZAAABADBGABB..aAEDJAFA......gAGAhABAFCCHRCFAHEAAeCABdEEAMEHBhAEAbCCC.EGCBKCHB.QDFDhACAAEIB.fFGE.PGAAhAGA.YEEFhAHA..,2,-28,-5,23
AaSRPNQKIDOdHWZcYUEMLGebBTJVXgCFf,RAAAQAAADADAHAECZCCAUADALAHBGAGAeDBABDGD..JECAXDFDhAAA.FFBAAAAAaEGEhCAASEED.hCDAKFHBdGGA..cGAAEFCB.MIDA..hAGA......hAIA...,2,-19,-12,7
YAdZeWSgIbOEfJBCDMKQHPacXVURLTFNG,eAAASAAA..bADAEADABAHADAGAMBFAHCCA..aCGDXCCAhAAAREAALEEB.TGGAhAAAGCFAAAEAdGDCZDAAgFCAhABAfHAB.KEHB.PHDC.hABA......hAHA...,1,-3,-6,3
DBOZGTKEIYJFaCLNHgRcePUVMXAdQbSfW,dAAAQAAASADADADAZADEGAFA.EAHBIAHA.FCDDhAAAaCAELCFAHDCARDGFeEABhACAVEFA.AFFBbFDDBFEDhBCAKGGDCGCA....NIEB.......hCAA......hCGA...,1,6,-21,27
eBRfYUXTdEMSGPAJINQCLVKbgaDcWZFHO,JAAAQAAALADBKACA...aAEADAFAZAGBHBFABBEARDEBUEGAhAIAdDCAEDHF..MCCBGEDAhAAAABHA.CFFB...bFBAhBAAWFHH..eHDAfGCE..hBIA......hCAA...,1,-15,-22,7
fAKdPVRSbFHMWcCGEUgXLaOeBYIDTNJQZ,dAAARAAAFADAHADA.MAFACAGAGCCAUCDBLBHB..eAHHhAAABCBADCFBTEFAQEFAhABAACGAKDAD.SDHHhAGAbGDC.EGCBaEEHIHHA...hACA......hADA...,1,-16,-18,2
HgVXUOYbDRfBQSTIPCZdGLENFMaAKecJW,eAAAJAAAHADB..XADAOAFADBGBRAGBQCCA.TDFAhAAACBHAGDAA.ECCBhADAMDIBADFBKDGA..gEAAhABAUFFA.bFDBSEEDZGAEdGGA.hAEANIDB......hAGA...,1,1,-18,19
SZPXcCTafdNDRMKbHgUVIJBWEAQeOGFLY,eAAAGAAALAEAZADA..XAGBTBCAdCFARCDAMBIBHDGBUEABhAAAIEDABDGAACDAQFAAhAAAFEFH.SAHHhABACFHAaHFA.DFFB.KGGD....hAFA......hAGA...,1,-5,-15,10
cQDUgZBCWKTaLIRYfPXbHGFOMJeNASEVd,EAAAdAAAQADADADA.ZABBCAFAKAHBLAGBRBCA...fDCAhAIAXCEAHDBAhAAAGEDAMCHBeCHHABCASEFDhAHAcFBCBDFDaEHDIGGA..hBAA......hBFA...,2,-26,-11,15
DPdVEfTUIBcRLJYZNeWCbKOagHFMQSAXG,GAAAdAAAEADA.UADABAFARAFALCHBZABB..eAGHCDDA.OBHDhAIAHDBBMDGBACEA.DEFBhAAAfDCA.hACATEDAIGAAJEHF.YFDB..hAGAWFGDaGHB.FGED..hBAA...,1,-6,-27,21
aMIRZEASPDHTLFKWXCeOJbUVGdYgQcfNB,DAAAHAAALADAKADCCAFA.eAGHOAGD.UCABdBBAQDCAhAEA..fCFEhAAAaBHDREEFACFBSEHBhAFATDDAXEGAJHFE.......hAIA......hBAA...,1,-19,-26,7
CaZfKLQJYVWcMRBgOAPSFNHIedXUDTbGE,FAAAHAAAeACHdADADAFAGAEAEAHF.ZAGBLBFB.QCABhAAAVEAAMBIBRDDBOCHDhACAAAEBSDDBXFCDTEGAhAGAaFGBKHGA..YFFF.BHHAhBAA.gGBAhBGA...,2,-14,7,21
cedECKXgRVIZYGPabOJNSUfDFQLMBTWHA,eAAAEAAAKACARADAZAGB.GCCAaAEA..OAGDSCFD.DBIBhAAALCCABEAAHEFChABAAAIBdDGDXGAAgECAhAAAIHHAbFEANICB........hAEA......hAGA...,1,-12,-17,5
LcDQBNSaOITMAfJKUEHdgGRVbeFWXPZCY,KAAAHAAAGACARADFeAFEFAEA..XBFDZAGBLCABQCABhAAASCEHaCHDODDBhACAMBIB.AEFAUFFAdEGAVGCAhAAAPHCC..CFFCDFIB.BHHD...hADA......hAIA...,2,-10,3,13
fEFYSaAPcNWJHTZUgReXMILKQCBGbOVDd,...PAAANAAAHAFAZADBRBBA...eAFAMCFBLCCDQCGAhABAGCGAODADdEEAEGAAhAGASDDBABIB.cEGChACATGCA.XGFDCGGDbEBDDIAA...hBAA......hBDA...,1,2,-9,11
HcIBSOEPFWKVMUbdATXNCegLYGRDaQfJZ,TAAACAAALACA.RAFF.aACA..QCCAZAEBHAGBBBDDEBHFFDABhAAAKCCDUEFAAAIBeDFF.hADAGEGAfFDAhAEAIGBAOEHF.PHACMEEB....hAHA......hAIA...,1,-8,-11,3
GVfZTdBQeaRCKXNYJWFASPHLMDIUbOgEc,HAAAMAAADAEAUADA.OAFCEAGA.GCABZBBAdCFAeCFARDBA.XDGAhAAAJBHB..ABDALFBAhBAAbEEC.VFFAhBCATGCA.aGGANIEB.FHAC......hACA......hAHA...,1,3,-16,19
NIBQRHJgPZXDETLeOdMKAafWUSFbVcGYC,aAAAUAAA.FADA..VADAGAFA.CAHA.BAGBHCBCJBBFZDGBEBHFLECAhAHA.eFHHhBAAdDDAACGB.SDADhADA...bDEDNICB.RGFA..XDGAhAIA......hBAA...,2,-24,-14,10
ZEcQXIaVAPKHYMBFJGUbSRLWDCOdTfeNg,HAAAMAAAFADDGADA.SAFARAFALBBBCBHAdCADeCFAZDAEEDDBQCFDhAAA.aDHDhACAAAFAKDHBBEFAbFCAOFAChADATGGAfGGA.NIAB....hAIA......hBAA...,1,13,-21,34
OLEaJUHTBXWbFNIPAGMSZefDgVCdKYcRQ,GAAAZAAAeACEDADACAFB.dAGA.KCDARAGFLCCA..ECHFaCHDHDBBhAAABDFAXDEAhACA.FEHDIECAhABAAAIBMFFBSGBAfEEEgGFAhAIA..cGGC.hCAA...,1,-11,-31,20
HGRLPMBZaAfQCWOdNIgFXSTceYUEbVKDJ,QAAAOAAAdAEA...IADAXAGASAEHeBBAECFAKDDAhAGAHAGB.RCBAMDFBhAAAaDGDADIB.CDGD...gFFGhAHATGAAcEGD.bGFADFIB...hAGA......hAIA...,1,-9,-20,11
UbWKgRCSaVJBZEMLFYGNeOXfcPAIHdDQT,HAAAdAAAQADATAEAUAGAKAFA..RCAA.aCACBAHBZCCBLDGBhAAAGCEBeEEBXEABhACA.fEEAhADAACHAbEGD.CGEASGHH.....hACA......hADA...,1,9,-23,32
dBZXcKbORFfACPJDQLWYEGVHNgUaSIMeT,CAAADAAALACAEACA.HAFBUAFA..aAHFMAIBdCCAZDABKBBDRCDBAADA..hBAA..QDFBhAAAGDFAVEBBSDHHhBHAeDHBBHBDbEDDfFFE...hBEA......hBFA...,1,-2,-20,18
HPAOKMUNaJCTLfSgdeBVZGbWREIFcYQXD,MAAAaAAA..CADALAFASACA.eAEHZBBAGCEARAGB.ECGAhADAFBBH.QDCDhAGAHEGBAAGAKGCAUDGB.TFEAhAIA.dGCA.BGHA.....hBAA......hCAA...,1,-6,-23,17
geREMWBUTJcOCFaPKHXAZIfQLdbNVGYSD,ZAAAQAAAdAEA..VAGBGACB.DAFARCAAEDEAMAIB.BBGAhAAAUEGATCEA.OCDHhADAaEBDKEDDHDGBAACALFFDhABAbGEC.SGAD...hCAA......hDAA...,2,-16,-10,6
AaTXefIDGSLHBQMRcdbWZPJEKYVCFUgNO,aAAAeAAA.DAEAGACAHAFCBBCARAEAdAHAZDFAEBEB.KEAA..CCGDFDDBUFFAhAEA..OCHDABBB.hAFA.TGCAXEFChAAASCGGMIAAbGEA.......hBAA......hCAA...,2,-18,-15,3
WeaFJIKRfHAUCYGXNMQDPgZTbOBdcSEVL,CAAAGAAA.MADAQACADAHBZBFF.TAEABCDAdDHA.EDCBLAGBhAAA.eCABhACAaEEBFFCHKCCDHDEAAAABUGFAhACAXEGA.gGCA.cGGAhAIA....hBIA...,1,-19,-21,2
RFANbLWJOedCcGKHMZTUEYBDVIQSPXgfa,LAAAOAAAdAEAGADAHAGBZBCBEAFADAIBQDFC.SBBDhAGAXBGDaCAAAAIB.hBAA..bDEDeDHHKEHBMDDBhABATGBABFAAIHHAfGCEREDB.hBGAFGHH.....hCAA...,1,-3,-4,1
BgecJRMWaFNDVTbAYQHPKUdICfOGLXSEZ,HAAAKAAAdACACADBGAEALAEAEAGAZBFE.BCDAeBHF.RCAA.MDGBaDCEDDGBhAAA..TFAAhAAAADIBQFFB.IGAAhACAXFEDSFHHJDHBNIAB...hAFA......hAGA...,1,3,-28,31
KIOFBeVEfdQbMYHASNCZDgcWJRXTPaGUL,CAAAZAAADACA....gADBJAEB.RAGB...TAGAGCAAhABALBCBOCFDeCCBhACAECFFdDHAbEDDHEFBAAFASFFAhAIA.WHEAaGAAKEED.BHEAhAAA......hAGA...,2,-30,0,30
aMbXRIFfKPDVTEOSHZNcQeLdUYCGJBgAW,aAAAMAAA.RACA.FADAKAFCDAGA....EAHFHBBCZCCA.QBFAhBAAdCGDCECA.GDEABEEDABBBhBAAbEGB...fHCBhBBATEGAOGECSEDD..NIEB.hCAA......hCEA...,1,-9,-30,21
edObNQRTgIaYFfLACEJKBXcHZMVWUPDSG,EAAABAAAHACAZACAMADAUAFADAIB..eAGFdCCDODEC.QEAAhAAARCCATDGAaAHDhAAAFEHDADGAKEEA..XFFDhAEA..cFGDPHBA....hBHA......hCAA...,1,-11,-31,20
YLORcXGBJSVFfEgNbaQdAKCMTPUDeHWIZ,MAAATAAADAEA.HAFCZACBLAFA.RCEAGEBASBBAhAIAFCAHEDHFbBDDdCGD.ABBACEFAhBAAeEEB.IGGAhAAAOEGDBFCAfGAEaFDD.....hCAA......hCFA...,2,-24,4,28
bGBNDHLPeUdZCIAVSRKFXTEQYaMOJgcfW,RAAAXAAAEADE..aAFAMADA..OAHDJAGB...fBFAhAAAGBCADAIBHCCBhABAeBEBZDGFAAAAKDGATFEAhCAAQFBC.gEEG.WFHBhBFABEFB.NIEB...hCCA...,1,-13,-17,4
ZaIXBdVcFWDKMeLGOSJYHbREPUTNfQCAg,aAAABAAA.dACAFADAKAEALAGBGAGA.OBBB..SCBDhAAAHCDBEBFFUEGATCDAhAEA.QEFChAGAAAIBZDBBXGFCVFCBDEIB.......hBAA......hBDA...,2,-16,-16,0
bBeTRAaGNOPEdVcMWgKQILHDUXYFCfSJZ,GAAAOAAAdAEAMADAKAGALAHB.HBFDXBBACCDA.SCEAhAGAbDBDBDEAREFAACHA.hAIAaGHBEDGA..WHBAhAAAQEBA.DEEB.FEHD.ZFEB..hBAA......hBBA...,1,-3,-21,18
YHEOWXUceaIPQZNCdFfJAKBSGVRDMTgLb,SAAARAAAMADA.LADAHAFCEBDFXAGDeCCD..aCFBQCCAhAAAZDGBdEEDfGDAhAAAAAEAGDFATFCAhABA.YEHBOFHD.WHEG...hABA......hAIA...,1,-5,-7,2
eSUJdcINTHWXYLKBQZCFRabAEVDfgMGPO,EAAADAAAMADAGACA.eAEAUBBA..dBHA..IAHAHCEBXEAAhAAALBEBQEGAhAEAZCFBRECBACEB.fGCAhAFAOCHDSFGHcGDD....hBAA......hBGA...,1,5,-31,36
MQIgUXGVBKfPDJTZLbYcaeNFOHACWEdSR,EAAARAAAMADA..QACAUBEAGAGAKAEADAGAZCCBLEEBhAAA..bBFAaDHDeCCBhAAAOEGHHDGBAAIBCHHAdEEA.hABASGDD.XGEA.BHBAhBHA.....hCAA...,1,-3,-17,14
ZWcXYDFCbQeEJIUgHNRPOMSAdKTVBaLfG,dAAATAAAaADA..GAFAZACB..XAEAFAHFQCBAEAHBICEAhAAAHDDBRDGF.MEBBhACAACABBCGA.LEEAhACAfGGEcFAADFIB.eEHH.gGEAhAFA....hAIA...,1,-4,-12,8
QNWHgRMPGIXbOESBDdZTeLKVUFYaCcJfA,QAAAHAAARADFGAFA..bACAEAHBDAGAZCAALBGBKDHBFEEBaFAAhAAACCDA..JDAAAFDB...hACAgEAGMFGBIHDAhADASDFDBFHD.eDHH.UGDA.hAFAfGGE.hAIA...,2,-4,-4,0
QVRJdUOebKXaCgDNBcAETFHWGYILPMSfZ,EAAAHAAAGACALADBMAEAZAFA.RCEFdCADeAHFKCHDCBEB.DAGABCBDAEGB.hAAAFCFD...IEHAhAAAfEHA.QGCAhACAUGBAbEDDaFFCgGGA..hCDA......hCGA...,1,-8,-14,6
fTCPBMNaWeEDgSOXRHbcKFUYIGJQdZALV,LAAATAAA.BAEAaACA.EAGA..SAEHRCAAHCEAKBHBFAGAUEABhABAGBFAdEEDACAACCCAMCIBhAAA.eDBBOEGDhACAbEDB....IGGAZGAE.fHCBhBDAWFHHDIEA....hCAA...,1,-6,-15,9
HOXATEgCURYPSWVFBDbdIeZKcNLJMfaQG,EAAACAAARACA...SACAFAFABBHA.dAFAZCAAKAHB.LCCB.hAAAMCEBaCEAHDFCACHBTDAAhAAAUFDA..PDGBhADADFGB.eEHHNIAB.fFEA.OHAAhAHA....hBFA...,1,-12,-34,22
HBEYQCXWPDKALMSVbNaZcFfdIUJOeGgTR,MAAASAAA..bABAZACB.FAEDdAFAUAGAeAHBGDEARCCBHCGBhAIAEDGAQFBChBAA.XFDDDEDBAAAALGBAhBGAaFFCfGHAOHFCBGGB..hBIA......hCAA...,1,11,-19,30
VWXgcNEHIbAUZDFYeTdaLSPORCGKQBMfJ,ZAAAFAAAeACHaACA.LAEAOAED.GCEAQAGAMAIBJDHF.hABA.XCCC.hAFAgCGGEECBHGAAACGAhAGADEEAdGGARFFABGAA.......hBAA......hCAA...,2,-16,-7,9
ROEBbDfZHVINCKAJFPQeLdcgYMXaWSTGU,FAAAeAAAdADA....gADAMAFAaBED.SAFHGBGARDBABEFAhBAADAHBHDDA.IDHAhAAAKFEDABGB.QEAAhABA.LFDAXGGAWFHB.hBDA......hBIA...,2,-34,-5,29
PeaRbGSLUIQHBXMDTOWEcCZNVdAfgKJYF,KAAAFAAAeACHRACFGAEALAEA..QAGAHCEAMAIBTCAAhAAAEDDBZEGB.dFAAADEBJDGBhACAaECHUGEABEADOEHDhAEACHCA...fGAA.gGDAhAGA...hAFA...,2,-11,-7,4
ZHGSaWEcOCRBPUebfTDLANKIMFXJgVYQd,KAAAMAAAFACA..XACA..gAEHQAFAHAGBhAAAaBBCECEFCCCA..RDEABEDDhAIAeBHHbDFDDDIBAFGAIFAAhAFA.JHBAdGGASDDD.OEHFhAIA....hBAA...,2,-33,-10,23
VaSTdAWFLYIRJcXDeCHUPKNBZQgEbMOfG,LAAARAAA.XADDeADEHAGB.KBDAZAFAECCBMCABGDFAhAAAaCCCdCGAAAIBFEDD.IGAAhABADAGACDEAUFFA.BGDAhABA...........hAGA......hCAA...,2,-23,-20,3
KdgOfaTUbWJXFABYRHCDMVIPEcNSZLeGQ,RAAAHAAAMADAVAEA..EAGASAHBZBDBGCFAdCAD.OCEBhAAAaBHDUFCAJCGB..ADDBCEAADCCBhAAA...IFHAhABAcEGD.eFFDKFEBfGHA..hACA......hADA...,1,-9,-19,10
CfcBVLPAHGEFMTYKQOSbDZdaWgeJNXURI,HAAAEAAAFACDMACA.KAFAQAEA.SAGAZBEAaAHFeCCBhAAAXCDDREDFCDHABFGAhCAALCHBAFIB.GEAAhAAA.TFDAbGFC.dDFA.gGGAhAEA.....hCDA...,2,-18,8,26
YXUZVBEcAeQWbfODNLGFJMTPdgKRCSaHI,eAAAQAAA..bADADADAGBGAMAGBdAHARCCA.CBDA.HEAA.hAAAXEEAZDBAEDFBABFBOEHDhAAALDHBFHAA.PFFBhBCA.KHBA.IHHA...hABA......hAEA...,1,-6,-12,6
CXfAZedMbKPFDTJWOVYcHGEQSgIBaRLUN,eAAAdAAAMADAKADADAFA..TAGA.OBDBVBFAHCCA.hACAEDHFQBEChAIA.SCBHhBAABECDREEBNIABCGHAACIBbDFD.FDHH.YEED..hBCA......hDAA...,2,-25,-16,9
EacIbYBGKCOPXTfeMJZRSLNFAVgUDQWdH,UAAAQAAAHADAEAGEaACE....IAFAbCDA..GDAAhADAOAGDTEEAeCDBZCEFhAAAREGFLHCAAAIBDCIBdDAAhADABDCDCDGDfFGASGHH....hAFA......hAIA...,1,2,-10,12
fSeAgMRBWPNCZVGXaYTEQOcJKFHUIdDbL,RAAABAAA....PADAZACAGAGA.aAEAEAGAQCCAhAAAOBHDKCCAHDABdCEALCGDhAAAeDFBAAIBMDIBCFFD.hABAXFGD.TGDAFFHDDHEA...hADA......hCAA...,2,-22,-8,14
APaVJCdSYHbDEcfOKMGLeINWRXUFgQZBT,aAAACAAAdACAHACB.EAEAOAEA.GBDAeAGF..ICHAhAEARBFAFCBHZDFEAAIBJCEB.SBBDhBAADFBAKFGALHDAhAAAXEGA.QGEABHHA....hCAA......hDAA...,1,-12,-22,10
EVDTPBfUIdJSMQabACeYLcgZXWFRKGNOH,eAAALAAAZADBFAFDRADFGAFAHBGB.DAIBBAHBUCAAdCCC..MDDBhABAaDBHAAAA..CDHA...hACA..gEEAhBDAKEEAEFAATFGAfEHASHAAQGGBhCAAYHDAWFDD..hCBA...,2,-18,-11,7
FNHcLEaCOdDQWbZSATgKUXIfeMJYVRGBP,TAAAKAAAUACA....XACBeAEAMAIBVAEAGCDB.hAAAFEEHHCCCLEHBhAAAEBHFaDFDdFAAQFGAhAHAZGCAAGGA.fFEE.....hAFA......hBHA...,1,0,-17,17
VDaGEbeNYZSURLHcJQOIBTXPgWdfKAMFC,MAAACAAADACA.GACB.EAGEeADA.ZAGBRCCBHCEAQCBABBBDTEFAhAFA.XGCAhAIAgBEAdGHAACGAaCHDhAAA...bEEB.SGFH..hBCA......hBIA...,1,-2,-33,31
PfMOCEDUGaZLdbTFQeXYIABHgNSRcKJWV,HAAASAAARADFKAFC...VADAMAIBEAGEGCEA.ZCAAbCCCTEGAhAAA..eCFHhAAAXGCAACHABDAAgGGAhACAcDGD..PFHDCBGA.aEEH.dHDBhABA......hADA...,1,1,-15,16
SLPWRKBaTMOfVYEUHCNXJQFDgAeZGbIdc,eAAAGAAAdAEALADARAGBBBCA.aAGD.MAIBOCFD..fCDAhAAAEDDAHEBAXEGDhAAAQDFA.DDCBAAIBbGAAhABASEAD.KEEDYFFFCEHBFFCDgGGAhACAIHHA..hAEA...,1,-5,-11,6
EGcWZHSBAYIPVfaTKRUQXJLNFdMCOgbeD,..IAAAfAAAKACA.RADA..UAGAQAECLCBBdAGAMDABhAAAOBHDeDDAECAAGDGAhACAZCDAHEEAADDAPFCChADAaFHDJHEA..NIBB........hACA......hAIA...,2,-14,3,17
ERNKFYWcVHBagQLIDbJePZASOdUXMfTGC,dAAAMAAAGADARACA.FAFA......cAFAHCACaAHDLAHBhBAAbCFD.eBBBADFBODHFhACAfCFA.hADAEDDBKFBAVEGBQGGCDFCB.PHDAhBAASFFD...hBCA...,1,-6,-9,3
DXdEQZCFLcfeOKAgNVHGBTPUSWaMJRbIY,VAAAHAAAGADA.TAFASADBaAHD.RAFA...bCACDCDBhAAAEDFAZCEE.LEFAhAFAeDHFAFAABFDAPFCBMFFBhAAAIGAAdGGDFHAAOGEA.KHEA..hAGA......hAIA...,2,-17,16,33
gEfBLFRcbPSKHADeWaCJONITVMXQUdZYG,eAAAaAAA.OADC..TADAMAFAQBGAZAFBGCCAEAHFhADALCCAREFA.bDFDKBBDhAFAHECAACIBCFEDJHDA..hBAAIEHA........hAAA......hABA...,2,-15,-14,1
FIEZBcUQMdaVWGbNOJLRfeDAgTKSYCPXH,TAAASAAA.CADA.HACB.EAEAZAEBBAGAQAGAaAHDGCEAhAAAOCCBRDGFeCABAAAAKCGDhADAXGCAFDHDUFEAdGGDhACA.WEADNIBB..fGGBDEDB.YECBhBIA...hAEA...,1,7,-14,21
DJaUASPHBLbeWGNgYKTEcZIdFfQVXMORC,HAAALAAAeACEGADA..gAFBTAFAEBHFZCCAdCAAQDGAhAAAMCCB.RECADAIBhAHAaDDHAAHABFGD.NIEBKGDAhCAAFDGHXFACCGHA.SEHHhABA.bFED.cGGChACA...,1,5,-10,15
QHDEJPUYVIgRdKLBMecaNSFWGZXfACbOT,OAAAHAAAEADEUAEA..IAGARAGBLBDDeAHH..aBBHFCAHhAAAZDFAACCATCDA.hAIAQDFDDFFAPGDAhBAAgFAAdGHAMIBA.SEHH.hBIAGGCB.CHHA..hCAA...,2,-16,13,29
eHSDPCZYMbNcRLXfTOaKJIdGBVgWFUAEQ,EAAAHAAADADAZADB.MAGB....bADARCGFLCCD.TEEAhAAAaAHBKBCDdDAAGCEAhAAABAHA.gDGBhBIAFFHDAACAeHAACDDC..cECC.OGFC.hAHA......hBFA...,2,-17,-8,9
DVSJHcUGLgOIXPeaRZCNETBKFWAQfMYbd,MAAAdAAASADAHACCGAFALAGBOAHF..XCAAhACAeBBBRDCFZEFAEBFFKDDAADHBQFAChAFAbEAC.DGGBcDGDhADAIHHA.aFDDTGEA.FGGA.hAHA......hBAA...,1,4,-2,6
HUKXQLFBCfgVSNZOcdAIWERYJeTMbaDGP,EAAARAAAeADE..MADAaAGA.GAGAHBDAKBHDLBCABCCDCDEAfDBAhAAA.SDDAhAIAZEFBdGDAAAAAIHHAhCAAYDFB..bGBA.DDIB.PFHB.hDAA......hDBA...,1,0,-24,24
GHQgOCKUXcRALEbPBYINJMZaTWFfedVSD,EAAABAAA...IACAMADAaAFE.FBCAeADH.dAFADAIBHBGBhAAAQCEACAHB.XDGBhAAAACCBbDED.PCCBhCAAJEHBZFBB..TFFA.fHCBhCBA.SFHHhCHA.OEEB,1,-3,-29,26
KNceJdPHYUVLCQbWERFMZDGIfASTgBOXa,TAAAOAAAKADA..eACEdAFAHBGBUAFALBHBQCCAEBDBhAAAREDAZFGBGDEAAAHABBBDhBAAaCCHJHFE....hAIA............hCAA......hDAA...,1,-13,-24,11
TKEIfGbQcJWVBSeYNOaXgZdAFMCURHPDL,MAAARAAAHADBLAEAEAFAGBGAQBBA.JBHBBCCD.eDABhAAAOCEBaDEDZGCAAAFACCFBDEGBhAIATGGAKEHB..IHGAhBAA.fFEAWFAD...hABA......hADA...,2,-22,-8,14
QLFYeRANEHBSOcCXDUMJWGTbdPIKaZVgf,HAAAOAAAXADBDAEA.MAGBGAGAdAHAKCADZBBA..VDBAQCCChAAALBFDeCFDhACAAAIBEEHFSDHBhBFA.CEEDUGGATGDAIHBAaFFF.FHEG.hBAA......hBDA...,1,12,-19,31
MWZeJaOVSAFXDBQbCEGdfKgIUcRLPTNYH,DAAAQAAAEACA.dADAKAEAUAFARAGF.LBHB..TCCAhAGAHDBAZDFBeCEHaDDASCHHhAIAAFBBBFHACHFA.GDFAhBAAIHHAPECBMIAAOBBB.FFHDhCAA......hCEA...,2,-12,-8,4
BfdZJEDGHKeVNYPQFIALXOaCbgURSTMWc,LAAAaAAA.CAEAUAGARACFMAEA.BAHAZCAADCCAHBEA.KCHBeCEFhABA..VDFB..hBAAPDFCQGBAhBBAAEAAOEAEbEDD..SGHBTFFA..fGBAhACA.dFHAhAEA...,2,-27,-6,21
NfRcaHLAWSUXdTZgCQYKBFeIbJDEGVPOM,SAAAdAAAZABBQADABADAFAFA..eAFAJBEB.EBHFGCFAhAAAOCFDMAIBRDCB.HDAAhABAADIBXEGDCCCA.KGAAhAGAbFGDDFFB..PHCA.....hBAA......hCDA...,2,-12,-12,0
VTXgeWcLRFPOYbaHESCGNIBDUfJAdZQKM,ZAAAMAAA..TAEAeACALAGBRAGF.OBBBaCAAHDAAEBFFGCDAhAIABDDBfDFAhABAABIBdDCCQFFAhBAAXEGAgFBGFFDBPHEASEHBhBFACGAADIAA......hCAA...,1,2,-3,5
FHfKbGCMTcWIJDVgRANdSeLaXZUPOEQYB,dAAAeAAAaADAZADB.OAFCEAGA..BBDAHCEBKBHBGDBA.MCIBhAAATCBA.ICFAhACADDHBRGDAAAHASGGBhABA..LDEA.XEGAhAGA.QGGChBAA..,2,-21,-14,7
IKCZGaRBOHTSUNPfgXQbEDVFdcWJeAYML,MAAALAAAKADAGAFARADFHAFBUCAA....fAHEhAFAQDDBEBBBFAHFdDDAcDFDhABAeDGHADIB.CECCaFDEhAIATFAASFHH..gFGAhACA.DIDA...hBAA...,2,-20,2,22
QdGMPZXbaRWKTUYSDEeNJHBACOVLfcFIg,OAAALAAAFADDQAEAGAFA.ZAGBaAHFRCAAKCED..TDDAhAFASCHH.EEABhABAeBBBHEFAADHAfEGAhBAAgGBAdGHAMEIBPFEBbFBB..YFFFhBFA...hACA...,2,-6,-1,5
AZcadQXLbVYMSOTDCFgIeGKNRHUfEWJPB,aAAAdAAALADA..bACDMAHB.TCBAFAEAeAGH.GCEAhAIARCFBHEAAECHFPDEBhACAABBBZEBAQGFAhBAA..XFGA.SHFAhAEACEHA.....hBEA...,2,-10,-6,4
SCbEAgHVBDfeUTWOMPRdQLcXNYJaGKIFZ,HAAADAAAeABATAEA.MAHBRAEAdAHA.LCCBXCAA.JCFBGCEBhAFAFDDBZEAFCEEAAEHABDHAhAAAUFGAOFGB..hACA............hADA......hAEA...,1,-12,-30,18
FJZLMGbHPOXSCKRNVTcEYeUdgWDfAaBIQ,aAAAQAAAZACB.GACBHAEAOAHDCAGBRCDA...TCFAhAGAEBHFeDABdECADBBBADCBFDHDMEEBhAHAXEFDKFFANEIA.VGCAhAAA...YFAFWHEA.BGHA.hBAA......hCAA...,2,-14,4,18
HZfYVOagdXUNMCJbGWQTFAKcEIPSDReBL,EAAASAAARACA.eACHHAFBZADBVCDBOAFCdBHAUDAA.MEGBhAAAbCEDGCGA.hADATGCAAAHAKEHBIHEAhAFABGGDfHAB..aHGE...hAAA......hABA...,1,-5,-15,10
EHRaZFMgSBPfDOAcdCGNTLeUWVQYKJbXI,dAAAGAAALADAeADAUBGAQBGAKCDA.JCBB..XDCChAAAHDCBREEFFEHBMDABBFADhACADEFAAAHACGGD...TFCAhACA.VFFAIHAA.....hADA......hAEA...,2,-16,-14,2
NBVICbGHFXADPJSUZTfdOKYQegMEacWRL,DAAASAAAZABEdAFA.KADA..eAHBEAFE..aAHDRCCALDABhADA.BCGACCCAHCEAACCAUEEAhAIATDAA.ODHDhAAA.QECAMEHBcFBDVFFB.IHAAhABA.FGCH.hBAA...,2,-29,4,33
INEgJDWALCYGMKSQaRfBeXVTZPOcHUdFb,LAAAGAAAMADAQAEARAFABCDA.eAHB..TCGAZCAAOCEBhABAHCEBdFGAFCGDbEABhACAEDCBDEIB.AAAB.KEHB.hACAaFED.XGBD.cGFDNIAB..hAEA......hAIA...,1,-4,-9,5
MSeLHJTZEUNdXRaBYCgWcFPVfGDOKAIbQ,QAAAeAAAHADAZAGBEACA.dCCARAEA.BCFCCAHB.....gDGAhAAAFCDBfCFAhAAAGEDAKCHBAAFAMFIBLEEAhAFA.TGEA.XGGBaGGB..hCAA......hCHA...,2,-16,-9,7
aNeKfOGPcLAbHXVRIUTdCEMFJYWSDQgZB,HAAARAAAUADAdADA.EAFAMAGBFAHD....JCAFSAHB.hAAAQDDAZCCAaCFFeDGHhACAOBHHGFABLFBBhAAAADIB.bFEAIGHACCCDDEIB.BEED.hABA......hBFA...,1,-5,-20,15
BTUPWLVYgIQDdMGeFOASbNaRKCZJfHcEX,SAAAaAAA.RACFZAEBHACB.EAEABAGATAGAUCGALCFAhAEA.VEDAgEAAhAAAQGCCdEEAeECHhABAABBBKFHBfGGEXGFA.....hAEA......hAIA...,2,-20,4,24
OVgdeLHNAWUPXKbYDFBRSQfZTacMIECGJ,UAAAKAAADACARADA...QAEAZAGB..aCBEMAHBECEAGEAAhADAOBCD..dDFAHEEAhAEAAAIB.XDGAFDHDfECEhAAATGGA.CEEC......gGBBhBGANICB...hAGA...,1,-10,-30,20
fVSMKTDRZbeHOIgEJAFQCXcBdWLaGUYPN,QAAAXAAAdADAaACEGAFA.UDBAPAFA..fAHEhAAAMBFBDBIBRCGBeDEBhABAHDAAODGDECDBAEGBCFFDBFADhAFA...YFDBSFHHKGGD.bGCChAAA......hADA...,2,-12,-4,8
LaZEXTRVgONbKJdHWceAPfDICMQUFYBGS,DAAAMAAAQACAFADDGAFALAFA.EBBBRBBBOAHF.hAGAKDEBHCEAeDGHACGAfDDEhAHACEDDBFAA.ZEBFhBAAXFBDTEGAgGEAJFHB..hBEAWHAGIHHA.hAFA...,1,3,-24,27
OTSZMKPaceAVfGCWJFDdRBNQEbUgXLHYI,GAAACAAAFACA.RADAQAGCUAFA.LCFAHCBAOAHFZDCAMDABhAAAKDEA...aEFDADGA.hAAA.VECBfEHAhACADEHBBFFAEGHF.........hBCA......hBFA...,1,0,-37,37
dYJGHIVUfWPALOSBcFEgQKZeRNbXMCaTD,LAAABAAAEACAKAEARADF..XAFB.MAIBaAGAdCAA.GBGAhAAAHCAAIDFAhABAUCCA.fDHEhACAACFASDFDFEEHZFCFeEHHbGFATGEA.DICAhACA......hCIA...,1,7,-25,32
FgNXbCOGQfWAKYZDJEUceIaLBTSRdHMVP,ZAAAEAAAUADAeACELAFBBAFA.RCDBHCGBMAHB.FAHF..XCBChAAAOCCH.GCFAhAIAQFCDABIBDDEBIFHAhBCAaFFBdGGA...gFDA.CHHA.hBDA......hCAA...,1,-1,-29,28
JgeAMFRDLaCNBQEVYIKPHZTSfWGbdcUOX,RAAAaAAABADB..EADA..IAFAHAFAZBBA.TCGASAGHhAAAGCEAdCCAODAAhADAXCFCeEHFAAIBMCIBhABALHAAQEDDKGFB.fEGAhCAA.bGEA....hCEA...,2,-29,9,38
HIeUWDTSJGXOKbMBPLFECRgYaNQAVdfZc,dAAAZAAAHAEAeADADAHBTCAAGBFA.KCBAMAIB.LCEAhABAEDABRDCA.aDDCAAIB..VFGBhACAfEAE.IEGAhACASCHHOEHDbFCA.FFFH.CGADgGCAhADA..hAEA...,2,-10,-5,5
ZGdHTLFOPCebaKREQfNgXBUMJDWYAVcSI,SAAAGAAAHADALADAOAFAeBHFaAGD.ECDBQCCAhAAA..fCFAhAAAXCFCMAIBDDABADIBIFCAhACAdEAATEFACEFARFGBBEHB....hABA......hAEA...,2,-19,1,20
IHeACgcfGUOXYFRWEZdMbTJKDQBaLNVPS,CAAA..fAAAGACAOAEAFADA.EAHFdAGA.MAIB.TBCAhAAADBFBaCABLDEAhACA.PCBBHCFBACIBgEGAhBCAXEBCREDFbFCAQFGABCFDSGBDhBGAeHDA...hAAA...,2,-14,7,21
JaYZfSeAOVQGHTPXFEWDNcMKdIUCBbgLR,QAAAHAAATAEAFACEEAGEDAFA..MCABdBFACAHABCCA.bCEARCDB.hAAA.aCGDZEAB.eDHHhAAAACIBODCBGECA.XEEAhACA..cEGDKGHB...gGFGhCAA.YFCBhCDA,2,-25,4,29
caeCGMRfOSNYVHQIPZKAgFWEdbXDLJUTB,FAAAEAAAdADADADALAGB..TAFAaBCD.eAHHGCEARCBBSDDBhAAA.VDFBhAFAHEBAQFCDhAHAZEGBAAIBbGBA.JFHBBBECMIDA......hBCA......hBDA...,2,-19,-1,18
eCROdQHVFKaDAGMgJcTILYXWUSNZPEBfb,GAAAMAAA.JADATADALAGB..XAFBSCDAZBBFEAHFhBAABDCD.eCHHRDDFdDGAhCAAHECCKFCDACIBIGCAhAAAUGGAfGEAbGEA......hCBA......hCDA...,1,-7,-9,2
UfaAEOWgHGNZRQbDXTKVSeJBFCPIMcLYd,EAAAOAAAHACAZADBRAFFDAIBKAFA....eAHHFCCHCCHD..MBBBLEABhAAAdCCCUDGBADFBGECBhAEAQFCA.TFEAhAHASEHBBCFCIGHAfFGA.hBAAaGED.WHAA..hAFA...,2,-20,-11,9
DSZPaQAOJWRgfHXdCIGBbMcTeLVYNUFKE,OAAARAAAHADBdAFBGADAMAIBeAFA.LCGBVCFB.UDBAECCBZDAFhAAAaDED..AAFAJFHBfEEEhABA.CEHABGGAhADAbGDA...cGBDNIBBDGDA.....hBAA......hBBA...,2,-11,-2,9
GIDYKdMSfOeLaJcTFWNAEHRCBXgPUZbVQ,HAAARAAABADBXADBUAFA.ZAFB..QCCAGCABDAIBdBHAMBHBhAAA.ODHDeDFBaEHBhAAATEEAFFBAAFFBEFBA.hABACGED....gGGB...hAIA......hBFA...,1,5,-32,37
IeLcHMOEZSJGBUdRbYNTaFgXPCKfQDVAW,eAAAHAAAEADEZADBGAFAdAFARBGF....bCAATDBA.aAHFXECAhAAAKDHB.QFFAhACAAAAALEEBMDIBhAHASFBABCEDNIAB.FGGA.CBCADHBA.WHDAhBFA......hBHA...,2,-15,3,18
JTdNVSOUPLRGFMCaQKHEXgAfIZceDYbBW,ZAAAeAAADACABADA..TAEAdAFASAHBUAGA.RCCAGBGAhAAAMCCB.QEEAhABAHDDAEDGEAFDBIFBAhBFA.bGFANIBBOFFA.FGGH....hABA......hBIA...,2,-20,-4,16
UJfCIeLNGBTKDEWVYgSHdFRXQcMAPbaOZ,aAAAZAAAUAEA..CADAeAEHGBGABAGADAIB..ECAA..VCFAhADASDAAHCCBRFEAQGAAhAGAAACA.OBBBhAIAfDDA.LEFBKEHB.gFDAhABA.dGBAhAHA.FHGE.,1,-8,-21,13
QBKHRPcGDAIFXWLSYdUOeVfbCMNZgTJEa,XAAALAAAdAEAUADAeAGB..VAFACAHBZCAA...TDFAhABAECHFaDBABEBA.HEDBhACARDFBGEDAACCAFFHBSGCDhBEAfFHAMIAANIEB.....hCBA......hCGA...,2,-10,-10,0
aUJAXKVbLGQCHeEZTYNfIdcWPROMSgBFD,KAAALAAAGACAHADBEAEA.ZAFA..TAGAfCAA.dCGAhABAPCABRDEBMCCBBCEAhAAAaDDHAAGAXCFD.hACAbEECeDHH.IGDAOCHFFGGADGGB..hACA......hAEA...,2,-14,3,17
WTJcCMaNbYDVefEXgHOBPGQISLUdKZARF,RAAATAAACADB..MAFAaACA......bAEDDBFA.eBHFEAGAHCCBhAAABCCAGCEAhAAAQCGCLECBdDBCABIBFEFHhAGAJEHB.YEHBXGDDOHFCSGGDhABA.....hBDA...,2,-19,2,21
QBFfLEAKMYRWSUeCVZdbaOJNDgXGITHcP,MAAARAAAUADA..eACAZAFBdBHAOAFC.DBBBGDDAHCCAQCFChAHAFCCHLFBBACHAKDHBhAIA.SECAhBAACFGA.aFFAgGFG..XGGAhCAA.....hAAA...,1,-3,-28,25
IeaVYPQfGdFOHCZUbWMXBSTREJgKNcDLA,eAAAaAAA...VADAQADAGAGAdCCAHAFAZDFFUDAA.bCEAhADAMDIBBBBDREDBEGAAKDCADCIBhAHAAAAA...IEFAhAIAfHFBCFGASFHH...hAGA......hAIA...,2,-13,-9,4
AbZRSPWafLBgHXKGEMUVTYOeNdcQICJFD,RAAASAAA..aADALADAHAFBGBDAEAHBMCCATDGAhAAAeCEAdCCCQDGAhAAACAHADFFBACIB.ZEAA.fDDEhABAXGFDKHAAVFEA.NIABIHHAhAEA......hAFA...,2,-11,-2,9
FBKGdPRWATUbZCefgNJYDLOcXSEaHVQIM,TAAAZAAAeACE.....fAFBgACBJBHBLAEBhAAAOCCB.SAGAhAGAHDEBQFCDMCCBKCGAhAHAdFHAREEAADDBCGGCDIAAEFHFaGCA.FHEE....hCAA......hCGA...,1,-3,-8,5
cSFAdXgWaLOeQCMYPBGRTUfbJHZENKIVD,dAAAXAAAaADA.LADAeAFH..MAHBBAHARCAA.TCDA.hACAUCFAbDECHEBBEDCBKCHBhAAADAIBFEABADIBOFFAhBAA.QGDACFFAPFHBfHABhABA......hAEA...,1,1,-18,19
EabSXfNTIJVMUYPCBKLAgQdFGDZOWHecR,dAAAGAAAZABBHADARADAEAGE.aAFA...SAHHfCDE.TCFAhAAAICFA.MDDBhBAAPDHDKDHBAEEAQEABhACAOEFDeFHBbFCAXGFDJHDA..hADA......hAEA...,1,-3,-8,5
WLXBgOTFaHVcIRQYfEGedKUAPSCJNDMbZ,CAAADAAAZACALADABAFB.OAGDFAHB.HBBA..VCCARCEBQEAAhAEA.EDDBeCFHhAAAdEHAAAIBSCHHhADA.MEABbGDA.XFGA.aGFCIHHAhAFA..fHDBhAEA,2,-31,-18,13
WIJCEfaTceFKZNAYSXOQHMLVUGBPgdDbR,XAAAHAAAMACALADAGAEBBCCA.dCEARAGFICDAhAAAECGAaDGE.eCEHZEDAAAHAOCHDhABA.QEAAhAEAPFHB.bDFD.CGHAfHFB..hAFA......hAIA...,1,-8,-10,2
NTIKEFHXPcAUWaQMYGfdbRVSCgJOZDeBL,aAAAMAAAGACAdAEARAGB...CAEA.OBBAZAFBeAHFLDDA..hAGATEAAEDHFHFDAXDGAhAEAAAIB.QEDAhBAAbGFASGCDDBBBBFFB.KFHD...hBAA......hCAA...,1,-4,-15,11
fBWNeMJdOVgDGCFXKPRTaYZUISALEbQcH,EAAAQAAAHACABAFBeACAdAHA..OAFCDCCBGCFAFCDAKCGARDDBaDHDhAAAZDAAUEEA.AAHALEHBhAAAbEAC.fGCAhADAMHBA........hCAA......hCGA...,1,-9,-14,5
dIWXATeVEQLZOHgDSNcMBURPbfaCKJFGY,eAAAEAAAZACBHADA.SAFEMAFARBEA...bBFAaBHD.KDEDGCCAhAAAdCBC.XEFAhABAADGBTEGALHDAhAIA.DFEBBFBA.fFFECHHA.FHBAhAAA.IHHA.hCAA...,1,-2,-17,15
CTfDRdcSbHGNQBAUYZOeEXgaLKMPVFWJI,ZAAAEAAA.aACAMADA.FAGDJAFA...CBEA.TBCA..RCEAdCHAhABAbBED.HEECGDGABCCDhAIAAAIBOCBBeFHF.LGDAhAAA.........hCAA......hCBA...,2,-29,-9,20
ABZFDdacHPQCJeSVXEObfTUNWMRYKLgIG,ZAAAdAAAHADAQAEAeAFE..SCAAEAGAOBHD..bCEATCAAhABAUEEA.MCEBRDCBLFHBhACAGDFAAACADCIBaEAChAEACGCD.XFDCNIAB.KFHBBHGCFHEC...hCAA......hCCA...,2,3,6,3
UKYBJIfceGFdZCXTMRNaWESQLgVPHODAb,KAAABAAA.JACA..fACBGAFAZCBACAEB...MAIBRAFFaAHD.hAAA.EDHBLCCBhAAA.VDGBHDEBACEBUGGBhAHAIECAeEEBdFAA.TGGA.SHAAhAFA...hCAA...,2,-20,-13,7
QJcLHgFIGNOBXeCDAZYfPdKMbWaSVURTE,ZAAA..fAAAdAEAMAGB.aADAUCAAEAGA...QDDAhABALBCBHCADFAHBGDGAhACABBHAeCFBACIBKGEA.bDGDhAAA.SECA.RFEBTGAA.hADAgGCBNIEB.hBEACHHA...,2,-21,19,40
WUHVBcIKdGLTMRfNgSDXQCZFAOEebJPYa,EAAAeAAA..JACBaADDHAEABAFA..KBHBGAGAMCEB.RCDA...hAAA.fDBAhABASCFHQEFChAFAZEAAAAGAbEGD.PFHD..YFFD..hAAA......hAEA...,2,-26,-12,14
EaPLCeSFIHRUYcJdbDOTMZNgQVfWABKGX,GAAAEAAALADAeADAFAGDHAGBRCDA.UCBA.JCFFdDHA.ODAHhAAAZDDFQFAAVECBAAIBKFFAhACAaDHD...SGGAhAAAIHEA.YHEADGIB.MIAA.hADA......hAEA...,2,-13,5,18
ZQNKVJRSIObMdPEULBXHAfTaDWFCGegYc,aAAAFAAAeACH....gACHZADBQAFAKAFARCDAOAHDhAFAdBHAECFBLEEAhAIAHDFCABBBTECACFHA.GGCBhAHAcGGC..........hBAA......hCAA...,1,-5,-23,18
HYMOUgfVaTNFCQXJIeDKdEcRWSLBbAPGZ,ZAAAHAAAMACAOACAUAGA..VAFA.aCCATCDA.CBEB.QDDBhAAA.XCGAhAIAeCCDdDGAREGBLFCAhCAAADIBGGBBfFEB.FGHBDGGBhCFA......hDAA...,2,-17,-3,14
dfbRBQOFYWaPgLTJNVCIcUZXGADHeSKME,HAAAeAAAMAEAEADEdAFARBCA.QCAB.FAHBaAGELDDAhAAATCFAVDBBCCEDUFFAGEDAhAAAACIBKHDABDHDOCHD.hACAPFHB.........hCDA......hEAA...,2,-9,1,10
TWYBAcbMCdGFINJDZEVOHQeLXSPfagRUK,MAAAGAAAFADDJADAZAEB..EAGEHAGB.eBBBLCDA.SCGHhAAAaDDCRDFFKEHBTGBAhAIABECAACEACEEA.dFGADGHBhBAA............hBCA......hBGA...,1,-14,-32,18
EeCTfILFKQOJcVDXZRNSPbBAaHMgWGUdY,HAAAMAAAGACBdADAEAFA.eAFECAHA...TCCALCCA.QCGAhAAAOBBBcCEDhAIAXEEARCGF.SCADhACAbFCAAEIB.aFAAgGFHYFGBFGCDhAFA......hCGA...,2,-11,3,14
XeYAGZdKcEVRSMHOgUWfQFBTLaCPDIJbN,dAAAEAAARACAHADA.OAFAUAFA..QCCBTCBALCFAhACACAHADCIB.JDAF..bDADeDEBhADAGDFAZEFBKEHBSEEDhAAAMIBA.fFHAaGCAIHHAYFDFhADAAHCA....hCAA...,1,8,-20,28
gSKUeCWcMILbVfFOBEXRJPdAGNTYaDZHQ,GAAATAAA.aADAHACB.QAEAKAGAeCDACCGAMAHB.bDEBFDCHhAAABCADREEAdEHA.ACIBDGAAhACAZEAASCHHhAAA.cEGCIHHALGBA.fGGEhACA...hAGA...,2,-27,16,43
GUZcTERgSbVJdNMLCYFWHKaQAPeDBOXIf,eAAAOAAA..XADAGADAZAFA.EBBBRAGBSCCAhAAA.VDEAdCGAMDBBhAGALEAAFEFHHFDBaDHDAAIBBGAAhABAfGHATGCAJHAACGGA.....hAEA......hAGA...,2,-10,-7,3
bGCWKOHgafVQMdEeFXYAZLBcSJRTDNUPI,ZAAALAAASACERADFDAFA.UAFA..IBGAGCCBKAHBHCAAhABAaDFEQDEAhACA.ECHFeDHHFEHDAAIBBFBAhABATFCAbFFDCHHBOGEC.....hBFA......hCAA...,2,-19,-3,16
UeaSYXCdDEFTOLKZNbVMIWgAcQPfRBGHJ,QAAARAAAHADBeAFAaACE..XBGAdAFAEAHB.OCCBZCDAVDAAhAAAMDAB...gDEAhAAAACHBfDHAGDGAhABASEEBDFDBTGAAKFHBbFBA.cGGChADA.....hADA...,1,3,-1,4
SCVaeJYXHQdTUfRKBEZFPIGLgbNWDOcMA,CAAAeAAA..XACAHADAdAGAUAFARCCBECFBZCAAFCHDGDFA.LBHBhAAAbEFC.DEEBMFABhAAAACCA.aGGAQFBAhACA.KFHBBHHDPHDCNIBB....hADA......hAIA...,2,-12,-3,9
aXAbTfdEOHKcFRSVYDBMJWLNCeQGgZPIU,TAAAEAAAHACA.FAFARACF...SAHHDAEAMAHBLBFBhAAAeCCAGCFAZCDBUFFAADHAdEAAKEEDhAAA...cFGDhAEABCADNAIACHFD..........hACA......hDCA...,2,-26,-1,25
UGDcgeQECWMFJdNXfTOZVAIPBKRbSHLYa,BAAARAAAHADBaACAGAGA.DCCBeAEH.EAGAMDABdBCA..XBGAhAAATDEAZFAB.AAAAKEHBhADAbDEALFDAhAGAUGDAQGFAFFHD..NIEB......hAFA......hAGA...,2,-10,-3,7
MZEIbDAHLCWFcdSXJGBRYPOVgKaTNUfeQ,HAAALAAAFADAdAGAXADDGCAB.RDEA.OAFAKCHB..aECDTCAAhABA.UBGBeFDHhAAAZDDAEFGADDHBAAIBCGBDSEHHhACABGFD.PFBA...gGGGhBFA...hACA...,2,-14,-7,7
bAETYdOUKHMBcFQNVSeGaDPZWCLJfgRIX,EAAAdAAAKADAHACABAFBQAFC.SAHBeAGHaBHDZABBLCEAhAAA.JCCFRCEBXDCDhAIAADIBTEAAOEEAhAEAMEHB.FFFH..NEIADFGBCHGA.....hCAA......hCBA...,1,-1,-27,26
POZYDagIEXSUVAbNRWeTdBLQGJcMKfHFC,RAAAeAAAdADALAFAGADAMAFAHCDC.CCGBZEEAaBFA..ECCBUGAAAAAA.hBDA...bCFATGEAhAAAQEFAKDHB.FFEHhBIAOCCHDFIBXGCD.SHFAhCAA.....hABA...,2,-16,12,28
CaRIAPUcNfTdJXEQGMDBLbVSHOgKZeWYF,UAAA..fAAAdADAEAFAGBGAMADALAHB.bBCAhAAAHCEBKBGDZCBAeDBAFEBAhACARFAAAAIB.PFGBTEFAhBCAXGCABEHBOFEBWFHH.aGHB.IHBAhBDA....hBEA...,1,-2,-4,2
CcZDGUXMFaEgSTLARVPBWdJKHNOIbeQYf,RAAABAAAdADAHAFAOACAeCCB..QAFACCEAZCGBGEEAMAIBEFAAhAAATBCA.ACBBVCEBhAAAPHAA..KDHDIGHAhABAbGFA..fHBBDDIB..hBCA......hBHA...,1,1,-23,24
CYIEFeBDPcgXMHKAWTdbOVLfUNQaGZJSR,dAAAOAAALADAUAEA.aAGDZAGB..RCAA.CBBD.ECEBBBDC.DBIB.hACA.gCGAhAEAHDDAAEHA.TFAA.bEEChAFAfFDE.QFFASEHHhAIAFGBBeFCH.XGGChBAAMFIB,1,-8,-37,29
WKXBPDaANQMCRbJVYIFGZHcLOTgdEeSUf,MAAARAAA..VAEAFADDHAFALAHBOBBBdCCA.ECEFeDAB.SDFBhAAAfCGAXECAhABADCIBAAHAQEFBhAFAbFED.IGHAcGGA.....hADA......hAEA...,1,-13,-14,1
acVKBCAfPJZEeLXFDNIWQYTHGUgOMSRdb,JAAAEAAALADA.DAHBIAEA.QAGAHCBAGCFAhAAAOCCAREABaDHDKCFAAAEAZECBhAIAeDAAFGHB.NIBB.TEEAhADA.MDIBSFFDbEGDBGAA.fGEEhAGA..hBAA...,2,-27,3,30
CDUdMHcaGNXfTOSKFVJeWPRAQLEbgBIYZ,EAAABAAAZACBDACA.dAFAHAEAGBCA..fBHAOAHBFDGHeCBDhAAA.RDEAAAGALCBDhAAAbECD...gEEDhAIACFGAMDIBaGFCNCIA....SGHDhBCA.....hAIA...,1,-9,-23,14
BRCPYKgDedWQJOFIHbZEGATNfLMVUXaSc,TAAALAAA.MAEAUACA..aAGEBAEARBCA.CAGAKBHBeCABdCFAQCFAhABA.FDEHhACAHDDBEEHFACIBfDHEhAAASFBAPFGBDFGBOHDCZGAA...hAGA......hAIA...,2,-22,0,22
KfbSPcdFELgCOZQNVDXTJHIYGMBWRUaeA,KAAASAAAdACALAEAOACDZBFE..QAEADCEB.TAGAhAAAHDFAGFABhAAABCEDRDEAeDHHAAFAbFFAFHDAEEAACGFAhABA...NIAB.........hAEA......hAIA...,2,-15,-14,1
XEQeWfNdPAIMgBJYGaKbHZRCOTSFLcUDV,MAAABAAAGACAKADAHAFBRAEA..OAHDFAHFLBBBDCAB.EDDAeCBBhAAA...fCGEhACAdDHAAEFAgFAAhAFAaDFHZFAA.TFFAUGEA.......hAEA......hAFA...,1,-12,-17,5
PcgXMIAHKZVSDRLEdUbTCBWFOJQeaNGYf,HAAAZAAADACAEADEdAFAUAFA..CAHABBECOAHF.eCAAGCGA.hAAA.fCEEhACA.gDFHhCAAMCCBACIBSDDARFGB.bFFDFDDH..aFHD.hEAA..PHAA.hEBAXGDB.,1,9,-31,40
acFJTCVQEDdfHWLZONAMKbRgIPUSBeXYG,MAAARAAA..IAEASACABAGAeAEHGCCAFAGA..TCFAhBAAQCFA.EDAAhAAAdCCAHFEAZEEAABBBbGACgGBAhBGA.XGGAaGHDCEHADBIBfHEBhCAAOHDC...hABA...,2,-8,-8,0
IWDPHNMfZgQdTJYeaXBAUcRCEGLbKVOSF,RAAAEAAAGADALADAKAFA.OAGDFBHD.DAIBHCFB.MCCBZBCAdDDAhAAA.TEAAeDABaDDHhAAAAAEACDGD.SEHHhABA.IHAAPEHDfFEAgFDAYHFAhADABGFA..hAFA...,1,-9,-15,6
eSAUKVcGRCHaNFEZODLQYMBJbfIdTXWgP,KAAAGAAAHACBaADAEAEAZAFBLAHB.MBGBbBGD..dCDATCAAhAAAXDBD..gDEDhACAeEFBAAABcFCDhACAREAAFEHBQGGBBFHAIHHASFCAhAEACHFDDAIB.fHBBhBHA..,1,17,-13,30
gecRAIUTXVdPMQJfHESDZLBWYabFCNOGK,TAAAdAAAMADA..QACCHAFCEBDBZCEBLAEBBCBAaCGEbAGBFDDHhAAA..ODDBhACAGCFAeEBBABIBXFGDhBGAPEGB.SECDDEIBCHEA.NIDB....hAIA......hBAA...,1,8,-10,18
UgCeVdPLZKBfAROXQTYWIFEDSGHcbaJNM,RAAAQAAA..TAEAIADAEAGEGCCAHAEBaAGAMCGBhAAACBGBeCDBdCHAZDABBCHAAADAOEFHhABAXDFDFGHBSEHBhAAA.cGGAbFDD....hBCA......hCAA...,1,0,-18,18
MOKIWgZATHGPDbJfNdXYUSVeQcaRBFCEL,HAAAGAAADACAJADAdAFA.UCCAeAGH.QCDARBGFFDFH.ECHFMDIBhAAA..KDCD.IFDAhAAAZEBAAAHA.bFFAXFGDhBEA..SGAA.aHFAhACA......hAGA...,2,-23,-18,5
aBPQAMgRLTXUWNHSIEeDJdYOcKZCVfbGF,RAAATAAAUADAHAFA..EACEeCCBdAEAOAGBZCEECDHA...bCCChAAAaEFBBAHBAAAA.MCHBhCAALFHB.NHAB.DCIBhCDA.cEEAKGFA.fFHA.FGEBhDAA......hDBA...,1,-14,-17,3
JFUZLXVIBfTEACKgQeHDWcYMaNbPGdOSR,KAAAeAAAHACBDAEA.......cAEAaAFE..bBAAdAHARCDFFBHDhAAAZCAFLDEAhAAA.XEGABCFBEEBBhABAADFAQFCAMEGBPEHBSFFDhACAJFEB.IGAA.hAIACGGB...,1,-4,-22,18
ZSfHVXcWbODEaQMeNABUdJIKTCGgYFRPL,dAAAKAAAGACAFADARAFF.ZAEAHCAC..XCAC..bCGDECEAhAAAaAHFeBHH.AAFABDFAhACAIDEACEED.PECDhACALFGB.fHABcFFC.DEIBMIDAhBAA.....hAHA...,1,-13,-22,9
CZNYVTgeSIQFKWHXRDJaGMUEcBOLAPbdf,dAAAZAAA..VAEAeADA.QAGAKBHBHCAARDEAaCAEGEAB.EEHFhABAOCEB.ACFAbDAAhACACGFA..NHAB...TDGAhADAIHHAXFEAMIAA.BFHA.fGDEhAEA..hBAA...,2,-19,-2,17
EaNfYQDOcVCZSUMIXLgJedbPFHKABGTWR,GAAARAAAEADE.aADA....fAFBQAGAOAHDCCDAZCEBMDCBhAAALCCAeDGBbCFDhAAAHGAAADHBBECATGFAhACANEEADFIB...SGGB.IHAAhABA....hAHA...,1,3,-21,24
QAaJNKfbZTMDBGLWSPXUdeYVCIFEcROHg,aAAAKAAAZACB.DAFAGACA.LAEASAGAXBGAdBEAeCABhAAACCEAEDFA..RCFFHECAhACAAAFAJEEF...bEGDMBBBhAIABCHBPEHB.......hCBA......hCCA...,1,-13,-20,7
ScRIAUFNDXGBPJeQgKOYLHdMfaETZbWCV,FAAAXAAAGACABADAeAEA..QAFAOAHDHCEAdBHAaCDAhAAAEEAAZEEACDAA..SDDBhABARFAAAAEADEGA.gDGGhADAKGGDMFIBbGCAcFAA.UGFA.NIAB.hAFA......hAIA...,1,8,-17,25
UgePVBafMFQDZSACHYKGbILXdONRcJEWT,HAAAGAAALADBdADARAFA.EAFAUCFBeAHFBDDAaCAC.FEFDZCEB.ACCAKDGDhAAA..XDBDhAAAODHDJFAA.TGGAhACAgFAG.fEHAMICA.SGHHhACA..hAFA...,1,8,-31,39
VABNZWRLdeOXKMPTEGDCYcJSgQbHUafIF,ZAAARAAAeADEKADC..MAGBEAGEGBDA.CCCC.JAHB..QCFChAAAHCAAaCEB.FDHDADFBBDHAhABALFFBdFBAOEFChACAPHCADIAA..SGGA..hAHA......hBFA...,2,-30,-4,26
dKVXIMbZJPTNBSQGLHYgUREOCfWAacFDe,aAAADAAAeABA.dAFAXACD.MAEAZAGBTCCABAHAGBEAhBAAHEBAUEEAEBGBCDDDABBBKDHBhBAA...IGHAhBEAbEBCJDHB.SHFGLGFA.....hBEA......hCAA...,2,-16,-12,4
MeUNEdPOCaLRYBDfQbFVWcZgKAGTHJXIS,HAAAXAAAMACAUADAEAFA..dBHA.CBDALCCARAFADCHB.QDFDhAAAbDBA.FFGHVFEAhAAAZGCAAEEBGGAB.hAIAIDFANEIA.aHFE......hABA......hAGA...,1,-1,-18,17
fdeTJSDVRgQGLMZYcCBPKUWAXObFEINaH,OAAAEAAA..aACDHADAdAEA.eAFE.TCCADAGARBFFGDDAhAAAZCEBCBBDKCGAABHAFCBH..fEGAhAIASCHHQGEChBAAMFGBBFHAWEHHIHHA..hBCA......hBEA...,1,-4,-25,21
JZBKOMbVfDFSANYTPCQGWgdcXREHLIeaU,TAAAQAAA.GACBdACARAEAHCDAeAFEaCDCZCGBOEAA.hAAAMDIBbCFBDCIBAAHA.PDABhADACEFC..gFABhAAAEEEBLFHBIGGABGGAfHDBhAIASGCH....hCAA...,2,-3,0,3
UKQTRNAMHIWPgbSJfZGEVcXFedOBLDaCY,HAAA..IAAAgADBSACAZAFBEAHF.XAEDhACA.eAGBdCADLDDBhAAAaAHFCCCAKDAARDEAACIBMDHBhACAbFDA.GGEBFEHDDIDAQFAA..hAFA......hCDA...,1,-1,-7,6
ORVKWLBPCAYbSMEXcHedFGNQJIfDgUTZa,SAAAEAAAHACAeAEEGACA..QCCBfAEBDAIBTBGAhAAAaCEDRCGBKEFBLDFAhABACFHAAGCA.bEBAMHAAdFFAFGAAhAGAIHHAZFGBWHAA.BAHB...hAAA......hAHA...,1,16,-12,28
bKRNIUCPDfeAEQHdaVMSGFZBYJcXWgTOL,HAAAaAAA.MACAGACAZAEEBBHAJAEA...XCCCTCEALAHBhBAARCFBUFCA.DBBBADIBEFFBhAAAdEBAFEEH..cGABhAGAOEHB.KGCACFHAeHFASGFH.hAIA......hCAA...,1,-7,-10,3
KabdRQZTHcBCGeXJVYgSPONAfWIEDLMUF,..IAAAEAAAMADAKACAdAHA.RBCA.ZAEBHBFBCAGA.eCBB.XEDAhAAAVCAA..SAHHhACAODHDADEBDFBBLDGBhAEAaGFD.bECA.TGCABHBA...YFHBhCAA...hBCA...,2,-15,-11,4
PYgJOCIQeGKFZNMdHDVBSEUWAbLRTacfX,RAAAaAAA..XADB..gACHCAFAeAGHGCCAZAEBdAHAHEFAhAAABBGCECHFABBBbDDA.hABALDHBfFEEhAIAPECBOFCH.KGHBMFFBDIEA.SGGDhBAA....hCAA...,1,6,-19,25
LIeOdSNDVKTHFWQgPJMcZBCRaUXbGfAYE,EAAAeAAAdADADAEA.KAGAHAFA.QCBC.JCFFZBAEREDBUFAAhAAAGBDA.AAAALCFBhAIASDHBTFBAhBFAFFHHPHECMCIBCFGA.aGHD.....fHCFhCHA..hDBA...,1,0,-26,26
WYFTgcLSaCVMUGIDKfPQJbZeOXdERNBAH,HAAAFAAA.TAEALADACAGB.MAHBGCABKCCA.QCFAhAAAZCEBeCHHdEAAREABAACA..gEEBhAEAaECBUFGBDGDAfEHAhAIA.bECD.EGHFBHHD..YHDGhBIA...hAEA...,1,25,-25,50
AYOEDaZGBLbRCTJUIWSVXNfKQPHFcedgM,EAAAZAAAGAEALADARAGB.CAHA.UCAA..SBCD.XCEAhAAAKDDBHDFBeCHBhAEAdEHAAADADECAbGAA..TFAAhAFAIHHAVFEA.NICB......hABA......hACA...,1,-7,-17,10
HCfMIbLFgaVXURPGAOSWZYKDBEJeNTQdc,SAAAZAAADACABAEAEADA..eAFH..TAFAdAHAHCDBMAIBhAAALDGBaCCA.XGEChABARCEFACHBODAAKCCD.hBHAQEGACFFC.bGEC.FHAA...hCAA......hCBA...,1,0,-25,25
MHDRVSNLZadGeOKPFgAEcCBYXIfJWUTbQ,EAAABAAA...XACAfACA.UAEATAFA.MAIBhAAAHAGDRCAA.SCDDhAAAZCEEGEFAeCHHKEHBFFAAhACAADFACEBAIEFAJHAA.QGGADFEB.hADANIAB......hAFA...,1,-6,-12,6
IeZDEGCLaNOVPYURXMATWbcKFfQJBSdHg,TAAA..bAAAFACAQAEABAFAHAGBeAHBECCA.GCAAhAAAaCED.OCCE.PCGDhABARDFFAAIBKEDDSEEBhACAdFAAZFGBDIDACFHAVGBA.XGFD.hAAA......hAFA...,2,-13,15,28
cSFUfLTCbRJGOZHEQaIVXNgKdeAPDMWYB,MAAABAAAFACALAEA.CBBA.RAEFGAGAHCDAEBHFaBCH..XDBChAFAKDEDAAIB.DDIB..hAGA...cEFAhAIAfEGEbFCA.ZGAAQGGBIHHAgGDBhAAA.eFFBhAGA..,1,-12,-23,11
AYBNZXWaMQUOHJECbKLVdIgDfcTPeRSGF,BAAAZAAAaACAMACA.UAGAHAEB.EAGAKBCAdCHA.DCCB..TCEAhAAARDDBGGAB.ADGAXFGAhABAQDGACGFD.bEBAhBCA.LFFB.gGBA.hAGA......hBIA...,2,-20,-11,9
OHAUPeYXfCIVGFZKLbWERNcMDBSTagdJQ,eAAAXAAACADA.GADAZAEBLAHB.EBGFRAFAMCHB.SDAAhAAAaCCBdEEAQGBAhAAAHDEBAADBPFAAhABAfEHAFFHDbGAAcGEDBGED.....hAFA......hAGA...,2,-13,0,13
ISLVgEPCRQHcAYBKDXaFNOeWGdbZMJTfU,KAAAaAAA.OACAGACAZAFBMAEA..JAHBTBFA..UCCAhAAALBHBEDHF.REBBHEDAhAIAABFBDDBB.FFGD.eHDEhBAAdEFA....fFHASBBD..hBEA......hBFA...,2,-39,1,40
JILRQcHdgeFbBUAYGNVZWaXPSDOTCfEMK,GAAAZAAAaACA.SADADAFA.CAGAEBHFMAIB.KBEALCDAhAAA.REAAHEEAeBGHbCCChABAAADANDIA....XGAAhACATEEAJEHBQGEBdGBABHEA...hAGA......hAIA...,1,2,-19,21
XBDEKMJfQaNIeYdRgOSCWUAHPbFcGTZLV,HAAAFAAAGACAZADBLAGBBAEAKAGAMAIB.QCABaCED.hAEAeBFFRCGBSEFHhAGACEEDAEGA..bFBBTGCAhAIADEIBEFGBJFHB..fHFB..hAAA......hACA...,1,-5,-25,20
DGCRPEHJWSQdFXABaTfbgcILVUeKYZMNO,aAAATAAA....bACDIADA.LAFAeAEAZBFEMCABhAAADBBBRDEAHCCASDHBhAEAdCFAAAGAfCHAhACAVECBKFABOFGBGECBEEHFWHBAQGGBhCCABHHA.....hAFA...,2,-10,16,26
bKZXGUWSeaLMCEFOdQAcgTBfPDYJVNHRI,TAAABAAADACA..JACAHADC.RAGFKBCDGAFA.SAHBhAAAeCEBaCHD.MCCB.EDDAhAFAdFGAADHA...fDDEhAAAPEFB.VGAAbEGD.XGDBLHBAhBHA......hCAA...,1,-12,-17,5
JcTISLFUKCaGEZWRdbMQDgPNBYXVAfeHO,HAAAOAAATAEALAEAKAGCGCABEBBBRCEA.dCGAMAIBQDEAhAAADBDB...gEABhACABECAXEEAhAFAABIBeDHHIEHAFGGH.aGAAbECDPHCC.hADA......hAEA...,1,11,-15,26
PIEOAJGBDUcLgKYSQVTWdHbXafZFRNMCe,GAAADAAALADAKADAQAFC..TBBAHCDAaAHDZAGBRCEBhAEAMDABeCHH.EDDBAAABBDCDhACAUFAA..gFGAhAFASDFAdGCAbEFA.FGGB.CHAA...hADA......hAHA...,2,-10,-5,5
ERdgSQJYIFXNUDGZCOAbMcWVHaKfPBLTe,MAAAVAAA.HACC.aAFAKADC.BAFALCCAEAHB.RCFFdCHA.QFFBhAIAICDAXCEDhAAADBBBZGBAAEEBWFHHhBAATCGA...eEHF.SFFBhAIA.FGCA....hCAA...,1,1,-31,32
KgVdTUDaGZMNWEQYbIBOAfJFRLHScXCeP,FAAAHAAA.XADBeACHKAEAdAGADAGAZBEB.MAIBEBGA...bCAAOCEBhAEA.ACIBRDFALDGBhAAA.CEFA.gFCBhBAA.TFGAaFHDNIEB...YFFFhCAA....hCBA...,2,-33,-3,30
RPMJUWeCGKOHBFQNZAgXDbEIVcYdTfSaL,DAAAEAAA...VACAdADATAFA..aAFARCBBMAIBUBGBeBBBhAIAGCGAHDDAQDDChAAAACFB.bFACIEHAhBAAfFFALFFBPHACCHDABHHAFGHD..hCAA......hDAA...,2,-19,15,34
dVcZUWHeICPfDFNTEOBRSYbMgKLJQAGaX,aAAAdAAAZABBHACBeADACAEA.DAHBFAGA..EBFFRBFB....SBBDhAEAMAIBLDDAACHAGDEAhBAAXDGDUGGAIEHAhCAAfEAAOEDHbECCKGGA....hAEA......hBAA...,1,-5,-20,15
JdLSWcaFDeANVRYfGOHCKgXMbIZTUEBPQ,RAAAGAAAHADBKAFAMADAZCFBEAGABAHB..QCDAdDAALDHBhAAASBGA.aDBDhAAAeCCBADFAVDGBOEEHhABAXFBAIHFAPFFB..cFADhADADGIB......hAFA...,2,-16,3,19
BYHOPdVQfeCTEDZUNScbLGaIRKJMAXWFg,FAAABAAAHACBdACAQAEAeAEA..EAHFZAGBSCEAhAEALCBAaCHDRDFAMEEB.ACIBXFAAhAFAgEAAOFFBhBAAfDEADGHB.cEGCbFCD.GGBBhAAA.KGGD...hCAA...,1,-3,-4,1
dZQBTACbKMEGLPegfXDSNJVOUWRaIYcFH,KAAAEAAAGACAeACE...XAEASAFBJAHB.OAHB.hAAARBCBaCEDIDFA.hAAAFCBHHDFBZEAATEGAhAEAACIBMECBLEHBfEEEDIAAUGGB.YHAAhAFA...hAIA...,2,-17,6,23
QUTCeFfaMLOKDBGAZREWSJcPXIgVdYHNb,EAAASAAA..PACCXACD..IAGAdAEBHAGBhAAAQCCATCEAeDDBhABAaAHDMCFBLEHBhAIADCGBADHARFBBcFFBgEGANIDB.bFAA.FGHD.hBFAKHEA.....hBIA...,2,-3,2,5
UYaERfOcQTeHMXFJZCVGLWBAgDPbNdKIS,DAAA..bAAAdADAKAEASAFA.UBBAEAGERCAA.OCEAhAAAQCEAHDEAMCIBhABAFBHDZEEAGEABLEHBhAFAACAAgFGBIGAAaGDAfHDB.hAGA......hAIA...,2,-24,5,29
aASJPbYDWMEBgRLZefHTFVIUKCNQXdcOG,SAAAJAAA....bADBDADAEAFARAEAeAHH.HBCBTBGAhAIAFCFDUECBKCCBQDFChBAAdEHAOFFBADIBPFCBhBIAMHAABHHA..ZFEA.fHFBhCAA.....hAAA...,2,-16,-8,8
FcVbXWCeAIBaJDNLRQUGHZMfOEdKSPgTY,aAAADAAARABAGACAHAEBZAGB..MAEAECDBdEAASAGA.TCEAhBAAFDHDVFEA..hAEAbCGBCGBAABIBBEBA.LFFAhBBA.fGEE...hAGA......hBAA...,1,-7,-23,16
XPQgfZeJcLdNbGBDREOIVCYWMFKSHaATU,TAAAXAAA..QACCZACBeAEALBHBdAEAGAGARCEAEECAhAAAODDA.CEEDMDIBhAAASEFHHFGBAAGBgFABhABAfGEANIABDFHB......hAFA......hAIA...,1,-1,-12,11
RgPLQIAZYBDUETdCHMcabFJONSeGfVKWX,ZAAADAAAEACAdAEAHAGB.aCAAFAED.OAGBeDABGDDAKBBD.RFGBLGAAhABAAAHABBHACCDD.MDIBhACA..JDEBfGFEhADA..XDGA.QFGChBAA.IHDAhCAA.,1,9,-51,60
AcYRMNDHWEbTVdUZGgIaOfBFLSKQPXCeJ,RAAAMAAAHADB.EAFATADAdBHAGCFA..aAFABCCDLBBBhAIAQDACCBFAABIB.NEEADFDBhAAAbCGDZDCB..OFFHhABASEEBXFAAeFDH.cGED.hADA......hAFA...,1,-2,-8,6
GSOgECeWPNdYZBIHXVRQDfcTaALKbFUJM,LAAAFAAAMADAGAGAOADD..EAFAeBCA....PAHDhABAdDBAZDDAHCAARFCAQGGAhAIAfCFAaGBHADHBbEEChACA.UFAA.SEHHCEHA.WFCHhAFA.BGEA.XGGChCAA,1,9,-20,29
CcLWQXVSJOGRMHBFeZDAUbdPafIgETNYK,dAAAaAAA...IADAEADA..TAFAKAFALAHBQCCAhADASCAAGCGAHCEDhAHAeCEAACEAbGFA..fDCAhACANBBA.CEEAXEGA.OFABhAFAMAIB.ZGEADIFA.hBAA...,2,-22,10,32
EPQgSVdeFYUbIBLfNADOaWTJRGHKcMZXC,aAAATAAAGACA.HAEAMACAZCEE.EDHFQAFA.SBDBhAAAeBBDFEABbEFDhAEALBHBAAHAOFEBRCCBXCFChAIACGAA.gEGGdGCA.IHHAhCAA.fFFEhCCADFIB,1,1,-22,23
ObRFEeMfDHUABKILgGVPNTcZJQdCaSXWY,KAAALAAAGACAVAEA..TAEAZCAAdAHAaAGA..SCCEhABAXBGD.ODFAhACARCABEDFBeEADMEABHEEAhAEAAEEBBEHAgGEA..cFFCCHGA.hCBAbGCC.DGIB...hEBA...,1,0,-5,5
eNBRZfOLIDaQXJdKAGbYUCFVHESgTPWMc,GAAAUAAAFADAHADA.EAGESAFH..TCEAMAHBeBDBhAIARCGFZDCFLFABhAAADBIBaDDH.QFFChACAdEGAAEIBCFEA.gGCG..cGDChBAABHHA.fGHAhBCA...,1,17,-36,53
XJSeLdIbAUCgBFGcNTaQDKYHfWMRZVPOE,CAAAFAAAGACA..TADAaAEA.KAFCHAGB.MBFBRBFAZCCAOCABhAAAEDAB...SDFHhACAeDGFdFHAAAIBBDHAhAIANEEA.QEBCDFFB.fFGAhBCA.WEDH...hADA...,1,-6,-28,22
YUbQKHJWZdFEPDVNeGOXRLafMgTSCBcAI,UAAAQAAAHADAZAGBEACA.DBIB..eAEAGCBBRBFALCDBhAAAMDAB.TDGABEEAACFAbDEDhAFAKEGAdGHAFGAD..NIAB.hAIAaGEA...SHGA...hBIA......hCAA...,2,-18,0,18
NJIZgcHQBPEXGUVRaOFMdDTCbLKYWfeSA,JAAAZAAAHAEABADB.EBHFGAEARCAA..aCECMAHB..dEADCCCALEDAhAGAKDHB..fEEAhABAAAIB.gFGBhACAQFGAXGAAOGBADCIBTGEAhADAYHEA..hBAA...,2,-39,0,39
PRHIYaZXACUGFSNWEJcQBDMKOTVdLfebg,GAAASAAAEADAQAFAMADA.OAHFdAHAeBCA.bBFDhAAARCDAHDFC.aDAHACFBFDBAhABAJDCFDFFBTEDAfGGAhAAAgFGA.IHBA.YHDAhBDA...hACA...,2,-6,-4,2
URECWPaKebDZJGYBLgSdOQHMXcIFAVTfN,TAAAUAAAEADA..CACB...aAFDeADHZAGBGCBBLAFAdECDHCEAhAAAMBIBXDGAhAGA.FEEHADABfEGAhADARGCEKGGADCCBBHAAOFBB.QGEChBAA.IHHA.hAHA...,2,-9,-1,8
CPNJIYfKLDSMEWdbOcXTGFaRVQHAgZUBe,ZAAAeAAACADB...JADB..IAFAKAFALAHBDAHB..ECAAdCFAhAAA.OCCH.TEDAhABAaBHDRCDAHECA.hAFAAEGABEHAPEHBfFGEMFGB.bGCA.hCAA......hCBA...,2,-25,-25,0
LCAFJEYMOeWNfGabDXTPHVQBZRgKUdcSI,EAAAMAAA..eACA..fADAaAFDXBGDHAEB.QAGAhAGARCCAKDAAdEEASAHBhAAALBBBADDAFDFDOEHBhADAGEGAbFBBDGGBPHDA.....hBFA......hCAA...,2,-9,-3,6
PYFGdcUJQgeIEOVbBMDHSRLaZWNCfXAKT,TAAAFAAAdADAUAFA..QACC.eAEEECCBOAHFhBAAbBEDMAIBHDFA.REDBZFBFhBDACCDAACGAKDHD.GGDBhAAAgGGABFFBSHAA.aHGEhAHA......hCAA...,1,-8,-16,8
BSWJOgUCKaDXATeFHIPYMGEZNdfbQRLcV,eAAAHAAA..IAEAMAEAEAHFdAGA.QCABRBCALBFBBCEAhAAASCHHOBHDCDCAaDBBhAAAADGBFEEBGEDAZFGBbGBChACAcFFA...WFHB.....hADA......hAIA...,1,-3,-8,5
HFdWACKUgcBQfGTJVSRbeMOPIYXEDLZNa,KAAAUAAABACBGADA..TAEASAFARAGF.eAHHMCCBOCFDhADA..IDDAhAAAEDBAZEGBHFAAdDFAACIBCEAAhAEAQFDC..fEHAhAGA.JFEF....hAIA...,2,-37,2,39
BNEXSLOCHYVFRgGaKJAPUebQWIdTDcMfZ,eAAAQAAAdAEADAGAMADAZBAE.BAGA.EBDALBGB.HDDBhAAAFBHDRCDAaDHDADBAbEFATGCAhABA...fCFAhBEASFEDCFGD.gGCDKGHB..hAAA......hAIA...,1,-6,-27,21
QDFdEPSfOYZNLaAVUeWIbHcTGMgKCBRJX,eAAA..bAAAHADAGAEAMAFACAGARCAAQBGA.dCCAEBHFhAAAfCFEZEAAaDEHACAAUEGAhABAIEEA.TEGAhAAABGAADGFBSGGANIAB....hABA......hCAA...,2,-13,-6,7
DGbKUESPVYIeBRaJgdAWHCQOcFTfLXNZM,HAAAQAAAFADALAGBZACBGAEAKCADEBFFSAGA.VCGBhAAAeCCBBEBAREDFaCHDdEDAhAGAAAIB.OFFB.fGHAhAHAMECBbFGB........hBCA......hBEA...,1,-7,-8,1
IERUJAfcegGSXFdLVWBOPNKTQDCYMZbaH,eAAAGAAAFADDdADALAFABAFAOAGD.KCEATCEA.QCGChAAACDDDZDFEHDBBRFFAAAGAhABA..fFAEhAAASCCDXFGAWEEDDICAMIAAIHHAhCAAEGFB......hCBA...,2,-17,-6,11
YdFQAHSMXEfCKLaTeRVUGWNPJDBOIgbZc,HAAAMAAA.EADEKADAaAFARAFF..GBBA..PBFDBAHBOCGDhAFAbCAA.ZDEFdCHAABBB.fECEhAAACFHA.eEEBhACA.UGGANEEADCIBIHDA..YECBhBAA...hAIA...,1,-4,-25,21
RcLASNTJdDEYVCOIaHWKGebUfFBgXPZMQ,TAAAdAAAEADA..CAFA.aACAHAGB.GCABeAEHUAGABCFDXDGAhACAZCCFRDGBADBA..SEEBhAAADEEBOECDKGBAbFEDhADAFGFD.MIBAQGGA....hAIA......hBAA...,2,-9,-6,3
dNRVYGOcJbBUFTDeXMPZfaCKQgHAEWLIS,EAAALAAAdADA.RADFGAFAOAFA..JBFBBAHA.TCAAeBCDMBIBhAAAZDGBCDDD..QFAAhABAHDGBADBBSEDHhBDAVFDB.bFBBDDFBfFFEaGHD..hBFAWHAGIHHA.hACA...,1,-3,-9,6
dCJbNAGIeHKLfWQgOZRDBTMSPaEcVXYUF,eAAAHAAALADBQADAZAFARAFABCCAMCABaCCBECGA...XCFAhAAAFDEBdEGACFFC.JGAAAAGAGEEAhACA.fEHAhAIAOFHDDIAATGCA.SFCChCFA.....hAAA...,2,-22,10,32
XFbLQfNCAUcWSDKOIMPdHBVGEJeaYRgTZ,UAAASAAAOADAMADAHAGB.GBDAEAGA.eDBBRBCAZCEEFDFDLDBBhAAAQFGACDHAABIBDEFBhABAKGBDdHEBBEGD.aFHDhBDA.....TGCA....hBFA......hCAA...,1,-5,-17,12
cfNXFQOURYAaSeTJHMPKVdDZEgbWCIBGL,eAAAHAAAMACAKADAdAFAEAFA.....bBDDCAHAGCCALBHB.hAAA.fCGAhABAFCCBQCFBREFAACCB.aFFASFDHhAHATGCA........hCAA......hCBA...,2,-30,0,30
EDbPGKBdAOLUTCfSIgRaecFMVWZXHQNJY,LAAATAAA.SADHRACF.eAFAMAEAZBFEHBEA.QDEBhAAAJCAAEDEBDDGAGDGAhACAdEGAAAFA.CAHAfGBAhBGAaFHDFGFH.........hABA......hACA...,2,-20,-7,13
gVAYZLWESPfNORTGCKcFaeIDMbHBUdXQJ,ZAAAEAAA.SACE..fACARAEFGAGAKCCDaADDeAFAhAAAMDEBHDFBdCFAQDDAhAFAVGAA.ABIBLDHBhAGAPFHD.TGFA.FHCADIDABEGA.hABA......hAGA...,2,-8,3,11
TcWdGeLZPbfVEgMCaXFDHJQKIBOARUNSY,RAAASAAA..TAEAdADAeAFAZAGB...bBFAECCAMCCBhAAAaCHDDDABHDDAKDEAODGDhABAAAAAUFFA..cFAAhAFAGEAALGDA.fGAEhAGACEDDFGCD.IHHA.hADA...,2,-18,11,29
NPIMWdQYBFXECJaefgGHbTRVKSOcAUDZL,ZAAALAAA..IAEAdAEAQAGAFAGA.ECAAaBEEeCDBhABAGCAAHCFARCFASCCGhABAAEBADEHBMEIBBFEAhACACEEAJEGB.bGAA.KGFAOFHDcEBD..NICB..hAGA......hBEA...,2,-15,0,15
NVSbLBeGOTfZQAHaCJKPDdgEWXYIRUMFc,HAAAaAAA.KADCdADAEAFA..XAFARBFA.MAIBFCAHVCCA.hAFALDHBeBBBGCFAhAGATEFAZDDB.ADBBCEHADFEBhAAAYFCFIHHA.NIAB.BGHA.OFFHhBAA.....hACA...,2,-12,-2,10
BFXQVTUefDdICEOaAZKJgRbNcSGMPWYLH,ZAAAKAAARACF....bADBSAEBGAFAMAIB....PAGBhAAALCABHCABXDDAhABATDEAeBHHhACAdEHAEFBAAAHAJECBgGFBcEGD.BCCD.FHAAhACA......hAHA...,1,-2,-13,11
ATPcWgNKGDUOJHLZXEQdBVMeRIbafYFCS,TAAA..cAAA..gACBGADAOAFAHAFAZCCAhAAAEBFEdCAAMCHBRDBFaBHDhACAFEAAAAHA.PEEBKDFADEIBhADALFAAQFDAeFHFbFGDCGFANICB...hBAA......hBDA...,1,15,-4,19
WIYUQTMdXKZNebCGAJSFHcPBgRVOLfEDa,FAAAHAAABADARADFLAFBDAFA.aAHB....IBFAQCABhAAAdBHAZCCAeBHHGDAAhADAADDBSEEA.hAIAgFCBfDGEEFGAUECAMIEAKFFACGHA.hACAPHCA...hADA...,2,-24,0,24
KaVITPfYZgWENFdMOcJGebUXDCLRAQHSB,HAAAKAAA.aACATADA..fAFAZAFBEAHFdCAAMAHB.OCCBhAAAGCCAeCGDbEFADEFAhAAARDEBAAIBQFAChAFABCHAIFAAgGGAFGGB.JEDF...hACA......hADA...,1,16,-15,31
aQOEASKJYeFVPCgGcWbMLRHNTXDBIfZUd,KAAAeAAAFACACADA.GAEA....bAEDRAGBHCCB..TAGAhAAABDGDZEFEaCCBECHFAAIBSGAAhAAA..hAGAVECAgGGAMEIBLFGBDIDA.fGAAhABA..hAGA...,1,-15,-22,7
XKOMPQcNFGWLSdDRaTVefgUJCAbHEYIBZ,HAAAEAAABACAZADBOAFC..MAEAQCABFAHDGBCBLCFAhAAAdDDDRDFF.aEEAeDHHhAAAfEHAUFBAAGIB.bGCAhACA...XGGAKHDA.NIABDGCA..hADA......hAHA...,1,0,-16,16
WKZFESIPDdLRTBCfAYOMHabUgJcVXGeQN,MAAAHAAAaACAUAEA..JAFA..XAGAeBEFQCFAhAAAKBBAECGF.SCCBhAIADDBARDEBCDHA.ACIBOEFB.hAHAgGGAGEBAWFHBFHDC.dGGA.BEDDhBAA......hBBA...,2,-19,-1,18
NETfPcVgCGOSIUFXLJRDBdbHWZAaeQMYK,eAAAMAAAKADAEADA....TAFA..fAFBVCCAGCGAhAAASAHBFEFHLFCBhABARBBBdCFAHDGBAAHAaFHD.hBIAQECA.PFFB.CHCAIHHAhBAA...hCAA...,1,-8,-10,2
cPUeEKVTRHJfdWYCZBSQAMNIgbXFGLODa,MAAA..gAAAFADDGAFALADAaAHF.PAHBEBBBKDDAhAFARCCAHCFBdDHA.CEAAZFAEhAAAQFBAAAEA.bFDAhBAADDIBeHEGTFGAWHBGSEED.hBCANIAB......hBFA...,2,-8,7,15
QXUKOHTgNJPARcGZVDbLdWCfIaESBMeYF,RAAAZAAADADAdAEA.CAGA...aAEEEBHFBAHA..eCABQCCAhAAAKCCDHCFB..TCEAhABAJEDBADEA.GCGALFFAhABAfFFAMHFAXGAAOHAANIDB...hACA......hADA...,1,-15,-16,1
eUdLZacOVSTBDRWXIYPHNfAGMCKbJEFgQ,GAAAMAAAKADAEADA.QAFAeAFELBBBaBHD.OBFC.hAAASDCHTCDARDFBXFCAhACAIDGAHEDBhAIAADABCDCDFFHDdFFA.........hADA......hAIA...,1,-7,-13,6
OLAYZXJKVRETFHeIgCDPUBMafbdQSWcGN,ZAAAKAAAEACEHAEA.eAHHCAEB.DACABAGA..aCCCdCCA.QCFAhAAASCFHGECBhAGALECBAAIBJEHBREFAFGAB.hCAAIGHAPHDA.MEEB.....hCBA......hCEA...,1,-7,-26,19
PKLfeTVWGYBCbUHRQOgdcJMSZNDEIaAXF,FAAALAAAeACH.TAEAGAEA.BAGACAGBHCAARCGB..QEAAhAEAdCEDMAIBZDEEEDDBAAIBKEADhABA.VFFA..bFFAhAGAOHCA..gGEG..hBAA......hBEA...,2,-14,-4,10
RcaLfWbMZNAXYOTQgBFUGIKHSEVCeDJPd,OAAATAAA.BADAGACAHAEB..EAEAeAGBDAHBdCFARCCBLEFAhAHA..bDGDZGDAAAIBQEAAhAAAFGGAKBBD.hAIACCADPEDD.aFFBMIBANICB....hBAA......hBIA...,2,-13,3,16
eTDUGAFRfNKEcdSIWLHZCOBaMXQVJbPgY,RAAAKAAAEADEdACA...SAEALAFBHCCBZAGBBCDAaAHBMBIBhAAA.QEFAhABAVDEBJDHB.bFCC...PHDAhCAAeEAATFCADGIBACCB.fGGEhAAA.NIBB.....hAEA...,1,10,-29,39
QWUaMBLTISeOZdKbfHPEXGgRVDFcAJCYN,CAAAQAAAUACA.aACEMAFA..TAFAeBEEZCBA.dBHAbCDBhAAAHDEB..EBHFGEGAhAAARDAAFDFBAAHAJFCBYDHBhADABGED.LFAA.OFGH.hBCA......hCAA...,2,-17,10,27
bFgCfOENWGPaVSUcAQZMJKeHDYIdLTXRB,ZAAAMAAAeACEHACCDAFAdAFALBGBRBGFBAHBFBBH..CCCD..ECEAGDCAhBAA.aEEASDHHhABAADIBQFFBKECATFEAhAIA.........hCAA......hCDA...,2,-29,-15,14
QaYHTACJDbFIVBKeUERdXfMgPLcOWSNZG,DAAAFAAABADAeABARAEAdAFA...MAHBLAHB.OCCBSCCAhADAGDEAaCHDHECBhAFAAAIB.CEHA.JDEBIGGAhBAAKFBAUFGA...EGEA......hBAA......hBFA...,1,-13,-33,20
GOXeBQUZSWJFKNMVaCDfPLYRAgEIbTcHd,EAAATAAAHACA.GAFAeACEBAFBZCCASAHBFAHBKBDD.MDHBhAAAaCCH.DDIBLCFAhAAA.AEEA.bEAAdEGAQGFChAEAUGCA.NEEAfHBBYFFFIHHAhCAA....hCGA...,1,11,-21,32
gLMcQJbKPTeWHDRGANSOEVXaZBfUCFdIY,OAAAEAAA..aACDZADBBAEACAFA..dAHA..IAGALCCDhBAAMAIBQDEAhBBAKCBDeCEAHDGDRDFAGEABhAAAADBBSFCAfFFEFGGHYHBAJFHB.hAEA......hBCA...,1,-9,-16,7
XWaOPcSLYJUQNeDHbZFCdITEgKMRBGfVA,aAAAOAAA..SACHLAEAUBBBeAEAHBFCZBFEdDEDECDFMDHBhAFARDFBGEAA.AAEAXFDAhAIAPECBJFFBDBBBhBAAFGABCDHA..IGHA.....hAGA......hAIA...,1,6,-22,28
dSZJKbfQLVOcaMEBeNHRIGgACUTXDYWFP,TAAADAAAFACD..dAEAZACB.KAEAQAGALAGBOCAB.hAGAaCEBECFF.eBBDHDEBhAAARDDBGDGAAAIBXDGAhACAPEBBbGCC..fGGAMIBABGEA..hBAA......hBEA...,1,4,-14,18
IHMLDVAOPGFBgdcfNJSCKTbaWQYeZEUXR,GAAABAAAdACA..fADASAEAKAFA..aAGDQCDAhAAAeBHHZCBA.EBHFRDEFHEAAhAAAMCGBLEHBhACAAAEAFEHD.gFAANIAB.TFDAbGDA.YHAGhADAIHHAOHFChAFA..,1,13,-15,28
QLXSYgAPcECJGTebdaFBHWIRDNZVOMKfU,EAAAGAAA.eADAaACDHAEARAGBZCDA..MDABfBHALECASCBDhAAAAAAB.CCDAbCFDhAEAdEHABFGC.DGCAhACAODHF.QFDC.XGAAhAGA.gGGBhAHA.,1,-11,-18,7
ZGgdODQKJEHIBMeXbcSYNRFaTfVCWPLUA,GAAAdAAAQADAEADAHAFAMAGBeCDB.XCFASAHBRECBaDAHhAAATCBA.CCHDLDEBhACAAAHAZFEBDCIBKGGABDADhADA.bEFD...cFBA.FEHB.fHBBhBAA..hBCA...,1,5,-12,17
aMEJUTOWfbHFXCedYBLPDSAQRcNgGZVKI,RAAA..NAAA.ZADB.KAFAaAFA..EBHFUBBA..TDAAOAHD.hAAA...bCFDHBEBhABACCCCdEECLEBA.hABASDGHAAHAQGGAGGBBMFCBfFFEhACAeFDD.BHGAhADADDIB...,1,-2,-24,22
LQFTeWgOICGUNcEDdABRbKJVPaXMfHYSZ,RAAAKAAA..VAEAaACA..MAFAHCCA.ZCGBLBDAQDACeBGHhAAAOECEGDDAUGDAhAAAECCBABIBBAHB.PFHDhABAfDHA.FFBB.TGFA..hBFA......hCAA...,1,-2,-17,15
GacbIOeKdAQVTPJMLfHURSCgXZYWBNFED,TAAAMAAAHACC.RAFF.CACBZADBBAHB.EBBBaAFD....bCGDeAHBhAAA.ACCAQDEAhAIAJDCBLEEBSCGHhBFAXFAD.YEHBFGGADCIB.IHFAhCAA......hDAA...,2,-22,-6,16
CPSDOHdBgeNFRaEKfZWLTJMUbIXGVQAcY,CAAADAAAHACAdADABAFA..eAEERAGF.EBHFZBBBLCAB.MCCBhAAAbDDA.GDDA.hAFAAAHAPDGBOCHDFFCAhAIAaFHDKGCBTFGA........hBAA......hBBA...,1,-1,-35,34
eVdUPWACBSGFKELaTQXDHYOgcRJZbfMNI,SAAAGAAAEADALAGBQADAHCDBOAFCREGBZFBA.MAIBhAAAeCCBdDCCUCGAADABFFFHaDABhAAADIEA..gEDHhABA.bFGB.fHAB..hADA......hAHA...,2,-12,0,12
EJPLAYIGMdgCTRDbXaeHKOQBWVcfNZSUF,GAAAdAAACADA.RADADAGA..aAEDHBFCKAGABCBAVDCA.....hAAA.fDGEhACAZCEEFDAHEDCFLFFAACIB.hACAMDABTEFA.eEHH.QGAAhADANIBB.SFEDhAGA..,1,-14,-21,7
dNDgfIQeXRPTKAOSUCYBLEWcZJbVMGaFH,SAAACAAALACA.EADAZAFB...VCCBaAFDHBGB.dCCADAIBhAAAfDAAeBHDRDABKEFAhADAAAAAODFBBFED.cECDhADAMFIBFGGB..gEGAIHEA.hAEAPHAA...hCAA...,1,-1,-19,18
OCIVTSYdKcGXHNMPARUDWFBJeZaELbgQf,RAAADAAABADBeABAZAEBLAFA..QAGACBDA.TDCAhAAAdCFAGDDA.HDGBhAGAMCGBACCBFGGHEDHBbFEAhABAOHAA..SCCC...hAHA......hBAA...,1,-20,-22,2
DRPXNVGWdecLTHFQOZAMYagUBbJSfICEK,aAAABAAA.SACACADA.DAFARAEFXAGBGBDB..eBHHhAAATCCAHCAA.QDEBhACAABBBMBIBUEEAbFGBIGBAhADAECGBKDAAPFHBWHBA.....hAIA......hBGA...,2,-20,-14,6
APSZTRVXGHcBaLKWMNDeCfgdFQOEIUbJY,ZAAARAAAGADAHAEAaAGALAFA.KCCDMCABDCGA.eCCB.CCEDdCGAhABAQDFA.EDABhAAAbDADAAGA.SDHHhACA.TEEAXFDABGDAfGGAhABAFGGA.ODHF.hADA...,1,-4,-12,8
dZDGfKWLaBXAJENRbIPgVceFCYMTHUOSQ,EAAARAAA....bADBIADA..PAFCVAFA..eBCBhAAACCCAMCFAHCEA.SCHHhAFAZDEBGDGAKECDaGEEhAAAAEEBgEGG.FFFH....hAIA......hCAA...,1,-13,-20,7
CTQFLHaKVIRMGXOBfSdEZJAUeYPbNWcgD,eAAA..bAAA..NAEA...gAEATAFALAHBhAAAHAGBaCAAKBCBRDDAGEAAhAAABCFDdEFAEDHFAEHAUFAAPFFBhABADFHBFGDBMFIBfHGFSHCA..hABA......hAFA...,2,-20,23,43
OZERSCTcWbMHeLJagFQBIDYGfKVNdXPUA,EAAARAAACADB.....TACA..bAEDHAEBLAHBaAGAQBGChAAADAGBGCCAKCCDdEFAhAAAXDECABHBZEGB.SDHHhAEAMFIB.eFFB.....hABA......hCAA...,1,-3,-23,20
TDMcVJXdUFGBaEgYePZICQAHKSfNWLObR,HAAASAAA..fADBLADARAGFMAFAVCCAdBGAGDFAhAAAECABeCCAZEAACDHAABIBKDEAhAAAOFEBTEGA.DFFBhACAJFHBFGCA.aGGC........hCCA......hCDA...,1,-4,-8,4
GARcLFKXQJMSEfgbTICaeOHVBdUYWPDNZ,RAAALAAAKADC.QAEAMAGB.EAGA..bBEDCBHA..eCAAhABAHCCDdDDAUFFA.PAHBhAAAZDEBACAAXDGAhACA.fEAA.TGFAaECHBDHAhABADECB.NIAB.FHDCSHGAhAIA,2,-12,-11,1
IVdecRSMbACOQNUZPfWKFBHJEGYgLTXaD,QAAAZAAA..fADBFACEHAEBEAGAGAFALCHBhAAAaAHFDCAAdDCARCDB.bEDDADHAOEGDhABAPFGB.BFAAgGAAhAGAXFDAIDGAeHBAMEIB..hACA......hAFA...,1,13,-14,27
GEZWFAYQOdDHMBRUKJTLIceabSVNfXgPC,QAAAdAAAHADARAGFKCBALADA.eAGHaCED.SBHHhAAA.VCDBXDAChACACEAAEEGAZFAEACIBDDGBBFFDTFAAhADAbGEA...fEDE.gFFAhAFA.WEHBhAGA...,1,3,-33,36
QAfTIFJWGRBbXUKLcEOgHMeDYSCNZPVda,TAAAFAAAGACA.RAEABAHBXACB.LAFAECFAHDFCeBDHhAAASEAAZCEBdCHAAAGAJEDBhAEAbDFD..KFFAOFHDhCAAMFIBDICACHDA..NCCAaHFC.....hAFA......hBAA...,1,8,-16,24
dUQPbRNYZDKTaAcfCMOFHJgILXGBVEeSW,CAAAMAAAHACA..JADBLAFBGAFABAHAEAHBeCAB..dBBAQCCBhAAARDEBZDGBKEDDAAFBOCGDhACA.FEEBIHAAhAHASEAD.PFCBNEIA.TGFAhAEA.aEHD....hAIA...,1,-2,-26,24
KUgLFYPbDeEZXTaCSWdIGOfQcHJNMABVR,RAAAKAAALADBFACA.....bAFAEAFAZCEBaAHD..SCCDhAAAdCCAGCFAQCGDhABAHECCMDIBAAFABEGAhAHAgFABDFIBXGGDCGHDOHBE...fHFBhAAA..hAFA...,1,-6,-22,16
AdLHPfRGSJTIXQZEgKNUWVaeOcbFCMBDY,HAAARAAAGADATAEAQAFAEAGE.KAHBUCAB.aCFDeCCBOCHBhAAAFDABMDGBDDDAAEEBdFFAhACALDHBSEAHhADAXFAANEIA.VFDBbECDBHGAfHFF.hAEA......hAIA...,2,4,7,3
YCMKRXWGDPaNdcAEJZbSTFeULHQgVfOIB,EAAAZAAASACEFACD.LAFAHAEAQCDD.fBHAhAAABCCDMCEARDFFGEAAhAEAaCGEdDEAAAGAbFGDeEGBhABAVGCAOHEC.CEHB......hAGA......hAHA...,1,3,-20,23
ELMFWIRKZNbCYAVBSfPcHUQDXJaGTeOdg,SAAA..fAAAHACBQAEAXADAGBGAhAAAeAGBdCBAEDEBMEAAhABAFCFDRDCFZEFEbEFDAAHABAHBcGBAhAEADDABaGGA.OHEAWFDB.....hBGA......hBIA...,1,-4,-13,9
DMHYXEAcTUfRWeLPQbIGOVKaNdSZFCJBg,TAAARAAAeADELAGB..bACBGBDAKAEAdAGAZDFEFCEBBCCChAAAMAIBHFCA.EFHBACCBfDFAhAAAQGFD.hABAODGDNIAB.CGGDDEIB......hCAA......hDAA...,2,-23,7,30
VJQWBYKgGMLUDabFXcOSRfATCNHIdZeEP,TAAAHAAAZADB.EAFAJACABAHA..KAFCGCEAMAIB.LCCDhAAAaBFE.bCGBFCCAOCABhACARDEAAEIB.CFHA.dFDAeGDGhADAQFGC........hAAA......hCAA...,2,-27,5,32
LFJegTBKcCWbNMSdaXVROYPDQGIHfUZAE,EAAALAAAFACD.eADHBAEACAFA.....bAFDMAHB.aCAARCDBOAHDhAAADAIBGCEAHEAAhAEAZEGBAAHB.JEDFKEGA.NGEB.hCAAdFAA...........hCBA......hCFA...,2,-21,-18,3
FXVIWMgSfDLYdJQUEORHKPZBTecGANbCa,CAAAaAAAFACA....XACD..IAFAMAEA.SAGHhAAALBEBdBGAQCBAhAIAEDHFHEFBZCFAeBBDhAIAABIBVEDAfEDEDEHBUGGBRGCEBHHA.hBCA......hCAA...,2,-29,2,31
HVGWcTZDUPENFJfIASLgbBRQaMOKCeYXd,LAAABAAARACA.aADDMAFA..CAFAeAGHdBGAHCAAGCAA..hABATDEAZCCADAIBEDHFFDGDhACAJECBADIB..SEEDhAFAbGFA.QGGA.KFCB..hCAA......hCFA...,1,-7,-22,15
XPKdJOWeaLNGbTCfRHADBYgVMFEUSIcQZ,BAAAVAAA.EACA.UAFASADB.QAFAZBDBKAHBdCAAOAHFhAAAeCCFLDFAhAAAGCDBbEEACFFA.HFAAADGADFHBhACAMEIB.FDCH.XGEA..WFHHhCCA.....hAFA...,2,-26,3,29
ZBUKQTgWYcXLRDPNfSGdIOJHMaEAbFCVe,CAAAeAAAZACABAFBQADA...TAFA..gAGHhAAAcBGD.RCCADCIBfCCAhAAAdDAAODFDHDEAhABAEEHBAAHAbFGB.FEDHKFED.....YHDGhADA...hCAA...,2,-28,-8,20
gEQGYeODZdRcHLFJKPCbWfaNVTBUASMIX,MAAAXAAA..EADAGADAeAFAZBBARAFAHCFCLCFAKDAACEFA..hAGA.bDDCaDDH.TFAAhAAAACGASEFA.hABAQGGADEIBdGGA.......hADA......hAFA...,2,-10,-10,0
CJcWLDeTMZdNSYQXgRFAGUVfEbaHKBPIO,GAAAVAAA.EADAHADBBAFAOAFA.CBFB.JAHBLCHBeCDAZDCAhAAAdDAASDADhACAQDDBREFFADIBUGDA.aDFDhAAAKFHBIGGADGDB.......hADA......hAHA...,2,-17,0,17
eVQSCHaZfDYPUMLOFIJRXABENdbWTGgcK,EAAAdAAA..TADAGACAKAFCeAEA.QBGAHBFCZABBDDDAPCBBhAAAMDGBLDFBhAEAFDHDRFEBAAIB.bEDD...gFAAhAFASHGAaGHB......hAIA......hBCA...,1,4,-17,21
DRXBUELeKTVZcYJQFbWCAHGMSgOaNdfPI,HAAAGAAAMACAOADAdAGA....fBDADAHBRBFBBCDAECEFeCHHhAAAKCHBZEFAJDCFQEEChACAFFBACGBD.AAIB.aCCHhAAA.IGEAXGGATGGA...hBAA......hBCA...,1,-2,-22,20
RYECMOgXcATSFJULBDHbeKaIQdfVWGNZP,TAAAFAAALADA.HAGBeACEKCCAaAFAdCEA..VBFBGDFAhAEAZCCBREDFEFAA.MDIBXFGAhAAAAAIB.SCHHhAIABHEAIHHAfDBA.PHFChBDA......hBIA...,1,-5,-12,7
WRMgKGfBZEaJASNLdCcPUHTbOeIVYFDQX,LAAAdAAACADA.UAEAHAEBOAGFeAGB..VCBADAIB..QCAAhABARDFBMAIB.GDCAhACABDADEEEBADIB.SEHBhACAPEEA.IHAAXFGAKGHDaGDD.hADAJHFA.....hAHA...,1,-8,-14,6
bVfHSgPFDWZdQaRKcYNGCUETOJIXeABLM,MAAAVAAA.HACC.SAFBFADAZAFBdBHARBGFKBBD....NCDAGEEAhAAAECDBTEFAOEHBhAIAXFCA.AAHABFHAhBAAfHCBDCFB.aCEBCHHA.....hBIA......hCAA...,1,-13,-18,5
TaZRSCEGIgNMKJWHDdQAcXLFfePYUVBOb,LAAAeAAAUAEAOADD..aAGERAFAECAAGBCA..ICHAhABAMCHBKEBBHCEBdEEAAAAAhAHAFEGD...fFAAhACAPFHDBGDDZGDACHHANICB.DDDB...cGADhAFA....hAGA...,1,-12,-17,5
ebfGLQCDEIRVHNJKTcFadOBMXSPgAZUYW,ZAAAUAAAeACEGADALAFBQAFADAHBRCDB.HDAA.KAHBTDGAhABAaDFABEFA.MDIBhADASCCDAFAB.bFCAhAIAEFEB.IGGA..NIBBFGGA..hBIA......hCAA...,2,-15,-6,9
efcWRBgZQVAKbEUaGCJPdNXODHYIMSLTF,EAAAGAAA.CADAdAFAOACCHBGBMAEALCDBeAHF...fEGEhAAARCCAZCFFACCAKDHBaAHFJEEBhAAA..XFBChACADGBASGGATFEAFGHD......hADA......hBAA...,2,-20,-5,15
EOABTKSGFdCWgIDaUNXQfPMLHRJbcVYeZ,TAAAGAAAdADA.CAFA...IADAaAGDUDDAQAFAhAAA.MAIBHDGBRCAAbCEChACAcFAAeEFAZGDAAEFASFAAhAFA.FFHDDAIBfHBBhBHA......hCAA...,1,-4,-21,17
SDMCGUAJbVOZXdELHKTPcFfQgNIYWaBRe,VAAAZAAAEADE.HAFBKADC...TCAAFAFDQCDC..hAAAgDDA.hAHAIAHAaAHDRDFAeFFAhBHAMCIBCGDAAGIBbDGD.dFAA.LFFD..hABA......hACA...,2,-26,-2,24
ZNbaYdCTKEOfDRWBPQceMUHAFVgJXLGSI,FAAAVAAA..XACDGADAZAFA..aAEAdCGAKAHBEDAA.DAGARBEFBCGAhAHA.QEBAhBAAeDDDHFEBADIBLEEAhBEASDHHbGEACGGB........hCAA......hCBA...,2,-18,-10,8
cJHaCOPVYDUdKNRMXZbFEQBLGTSIeAWfg,...fAAAgAAAHADAOADAPAHBDAHBdBDA.RBFBZDCAhAAAEBCBLCFBGEGATFDAhABAeCAFADEA.cEGDhAAA.aEEB.CFAAYGAGNAIA.MHEAhACA......hADA...,2,-6,-4,2
MKPUVLfcAaZbTBFHWEeXGSJQODIRdCYgN,ZAAATAAAHAEA.EBHFeACEGCAA.QCCBDAFARBEAdBHACCCA..hAAAgDFBMDBBKDEDUEGAhAIALEEBAFFAaGDAbGAAhABA.FGGA..........hACA......hADA...,1,6,-20,26
ZgRFYGBeVSJQPHdEMUAXKWILfOacNCbTD,KAAALAAAOACAaADD..CAFA.DAFAZAGBRBEFGBGABBCA..eCDAhAAASCAA.QEEBhABAHECAEDHFABIBXGBAhACAfFGEcGGATGEA...hAIA......hBGA...,2,-25,-21,4
GHFMVELYSNadTOCZIPQgUADbfecRWBXJK,DAAAeAAARABABAEBKADAHAFB.FAHFEAGA.LCDASCCA.dDFDhAAATDGAZEEA.QECAhAGAACCA.bFEBfFAAhABA.XGGAMIBA.NIDB.aGGAhBAA.CBHA.....hCAA...,2,-24,-13,11
NefDBLPYdMZRcKCFSUVWJOXETQbAaHIgG,HAAAGAAAeACEBADALAFBdAFARBGF.CAHASCCAUDCA.VDGBhAAAODAH.EEEEbEEDhAHAAAAB...aFCAIFHAhACAfHCB.DGIBMHAA.ZGEA..hADA......hAHA...,1,3,-23,26
GEKLJFHNDBXRCQYWVdPgcTZIMSebUOAfa,GAAAEAAALADAHADABAGBRAGF.QCDBVCBA.dCGAPCFBhAAATFAA.ZEFAMCIBhAEAeGDAOEEHAAABaGHH.FFAAhAFADAIBCFHD....gGGG..hAIA......hBCA...,1,2,-11,13
aLERcJBSYUZeAObXdHQCgKTFDPWNMVGfI,XAAAHAAAQADCKADA.TAGADAFA...PCABMAIBGBFAhAAAaCCCRCEFBCHASCDBhABAZEFBAEIBdGAAFDAAWFGHhAAAfEHA.EFCAcGCAUGGBeFEFhADA.CHBA....hACA...,2,-5,3,8
fUDALBEeYOHVgJPbaIRdZTFKQXWNMSGCc,EAAAeAAAHACA.JAFAaADD.RAFAZCCAKCCD..QCFA..hAAAXCGAMCIBGEAAhAEAfDBEADEBLFCBhAIAOEEBgEFGbFAAdFGAWFHHCGHA.DIAA.hCAABHEA....hAAA...,1,7,-19,26
WKbGcTSCALDOYJFVMUBRIfgQHZaedPNXE,LAAAOAAAFADDMAEABAFARBCA......fAHAhABAHAGBeBBBdBFAXDDAhAFAECABbDEA.GEFA.TFCAhAIAACIBDEDBVFFBIEHA.....hACA......hCBA...,2,-14,-13,1
aQUYBMOCTNHPFeARIDWJKVdEXfbcLZSGg,RAAADAAAKADCEACA....XAFA..bAEAZCCAGCCAQCGBhAAABBBDMAIBCECAHEEChABAeCFBAAIB.IEHAhAFAVGAAdGHALFEB.aGAA.UGGA.hAGA......hCAA...,2,-12,-4,8
BILZKbaFeYQGPNMVdUCERDgAJHcOTSWXf,HAAATAAAXADB.BAFAZACBaAEDeAGHGAGAMAIBdCADECABRDEBhAAAACFB..ODCCSDHHhACAIEGAbEBDQGDChAGAPFFB.UGGADEIB.....hAAA......hACA...,2,-17,16,33
JAYIDdHQXgWRMePCNLOTGfaVKZEUBFcSb,DAAAHAAAQACAXADBRAFA..eAEACCADLCCAGBGAaBBHZCGBEDFFhAAAFCED...bGAAAAIBdFAAhAFA.MDDBOEEHhACATFFAKFHBBGGDSFHH....hBAA......hCAA...,2,-13,5,18
gZNTMROYIJALHPFbGcSdQKfeEDVUCXWaB,HAAAFAAAGACAdADAQAFAeAEA.ECABDAIBUDDACBGA..aCEDZDGBhAAA.MCCBRDFF.OFABhACAIEAAABHALGFAhAFA..bFAAKGDBXFGD.BHDAhAEA......hAFA...,1,6,-26,32
HbRGYPMXVJgKCEIceDLUWZNBdQSfAaFOT,aAAATAAAHACB.RAEAGCEBMACA..XAEAVEAA..KEEAEAHBhAAAeEGHLCCA.hAEAZDBAdAHAQCGDhAIAABBBOFHD.bEGD.PFED.....hAFA......hBAA...,2,-5,4,9
MJBYFgWULKQVSPbDZHeNXGcAROdfETCaI,RAAAdAAAEADEaADA..MAFABAGA.FBDBUBGALCFAKCCA..QDEDhAAASCAADCEAHEDAhACAeEGHGGAB.hABAAAIBTFGACHHA........hAGA......hBAA...,2,-27,-20,7
CcOZDAbSQULaJVNeKHBMGfFXWEYPTIgRd,QAAAaAAA.JACEeACH.HAEAGAFAXBGAEAHBTCDAhAAARDDAdDGAOEAB.hAIAABBBSECDhAEALDHBKDCDMEIBFEFHPFBBCFFDDGHB.....hAGA......hAHA...,1,-6,-9,3
FGRCdbBJcefUNYVZDEKQaWOAMHLTXSIPg,HAAATAAASACE..gACBRAEFbAGB.BAEBeCCBhAAAfAGAUDGBVFEBhBIAEBHFaGCBACCBMCFB.hCAALDDBIHHAGGABCEEC.dFGA.NDIA.hAAA......hAGA...,1,9,-9,18
fbXdgGLFNYacTPHCKJDVWISOReQEUMBZA,XAAAGAAALADAFADA.aAGD..TAGAHCDAKCHBDBDB.IEFAhAAARCDFECFE.MDCBhACAAAAAdEGA..NEAAPEHBhAEACFEAVGAAOFHD..eFCH...hAGA......hAIA...,2,-20,5,25
RKQgcCWUXODFZPAIBGEYabHdNMfLJTeVS,GAAAEAAA.aADAHACAdAGA.MAEALCDBeAHFRCCAQDGAhAAA.CCFDUGBADBGBZDFEAAIBBEBAhACAbFCBJFGB..TFEAhBAA.KGHBWFHH......hAAA......hCAA...,1,-4,-16,12
TGcWQYFCdLIKXBHbfaSAOeUMVDEJRgNPZ,eAAAMAAADAEARADA......gAGBZAEEGBBAQCCChAAACBHAdDEALDGBXCFChABAHFCAaDGEABBBOFHDhAIAEEABPEEB.TGFA.cGCC.hBAA......hBDA...,1,9,-23,32
JTCRSIgWLdHcNZXPOVYBGFbUKfEQADeaM,eAAAaAAA.MAEACADA.RBCA...SAEH..gAGAhAAAdAGAHCCAZDAFOCHDhABABBBDbDBAfCHAhADAADBATFBALDFBXDFDPFEBYFHFFGGAhAIAEHDADIBA....hBAA...,1,6,-17,23
YHReVXbLcNUPFJDEWMZGagQIACdBKTOfS,dAAATAAASADA.HAFBRACFeAEEXCAALAHB.UCEAhAAAFAHFEDDAZEDAaCACQDGAhACAAEHAKFBA.fEAAhADAbFGD.PEFBDFIBMHCAIGHAhAEA......hBAA...,2,-13,0,13
bQCEZXgYBRGVUHLNSFJcdOKeaIMfTAWPD,DAAAQAAAEACA.ZACB..XAEABAEARAFFGCGAHBGBLCCAhAFAFCEHdFFAeHAAaAHFMBBBhBAAAAHA...bECACHHA.hAAAgEGA.......hBCA......hBIA...,1,-6,-19,13
CcbKYOJedBLSEXgWVHQFANRfDGTUZIPMa,RAAAGAAAZADB.MADAaAFD.CAGA...KAHBOAHDdCCCLDAB.hAAA.EBFB.XCDChACAgCFAHDBBAAAADDIBhADATDGA.IEEAbEEA.eFGBSFBHhAHA.QGGBhBFA.,2,-22,-2,20
aLGFUbJPQOfeRCMDgXWHNVcBSAdYTIKZE,dAAATAAAZABBEADA.GAFAFACAUAFA..JCEFQCCAhAAA.eBHHRDCBMAIBXDFDhAIAHEGBNHABBFBAAEIBKGFDhAHAbFDC.OEHDCFBA.WHBA....hBFA......hBHA...,1,-6,-14,8
KIDXZPVTMJfHWNOSYLAUdFCaGEbBeQcgR,dAAAaAAAGACAEADABAFA..eAEAQBGARBFADBBBZDFA..TCBAhACAMEABHEDAOCFBLHDAhAEAAAHACDAD.bFADKECAhADAXGGBPEGBfHEB.NEIA.hBAA......hBCA...,2,-23,13,36
eJAIfSORCbBHZgLGMKaEdNVWPQTDXcYFU,SAAARAAABADBHAEBZACBGBGAKAEA.ECCBdAGA...VCEBQEDAhAAADAIB.XFFDhABAFDHBeECBAAGAOEHDhAIAbGFA.MIBA.aGBA......hBGA......hBIA...,2,-24,-5,19
MgLOGTJQcHBCKVEbFRZYPIeDSafUWAXdN,dAAAMAAALADAGACBQAGCHAGBKCBAECEBRCCBZCFA..IEAAhACAeEFBaEGF.fFAAhAFAAAIBXDFDOBBBhAIATFCABHHACEHBFGGADICA......hBAA......hCAA...,2,-12,-1,11
aVBAWQPFJOcUMbGdNHgIEeYXCKLTSRDfZ,QAAAFAAAOACD.MADAdAEAHAGB.EDEAeAFA.CBDATCEAhAAAREBAZEGBBFFAABIB..PCHBhBCAUGBB.GDBAhBDA.gEEA.XGCDSGEDhAGAaFHD.WFHH..hAIA...,1,6,-22,28
XUZRWaCOIGYPbQEKTgBcMVSLAdFefDHJN,eAAAHAAAXADBRADA.CAFA.GAGA.bCCAEAHB.TCCAhAAABEAAMDGBLCFBAAAAdFHAhAEADCABUGAAaCHHOEEHhACAPEEB.QGGA.....hAGA......hAIA...,2,-13,2,15
HgNYefBdXacVTMOIUCSRWbKZLQAEPDFJG,EAAAFAAAHACB..NADA.eAEABAEAaAHD...TCEAMAGBOAHBhAAACDGAREAA.KCBBZEEAACFBDCIBhAEAGGCB..fEDAhAIAcGGD.IEGASHBGbFEDQGGAhBCA.hAEA...,2,-23,-6,17
fYNEPGMbFgRWBOQJeKATZCXaLDIScUdHV,ZAAAaAAALADASACEdAHAHAEB.VCGB..fBBEhAEA.ECEAGDDAhABAbDCDREEABDHAQFGBhAGAeFABAECBTGBADFIBIGGA...YHDAhAFAMCCBFAGE..hCAA...,2,-5,0,5
SKcdMgUAIHLWFXPNVfTJQeYaDRBbCZEOG,HAAALAAAXADBVAEA...TAFAeAHHDCAARCAACAHB.ZCAEECEFGDEAhABAKCGA.dDGDMEFAhAAAACEBFEAD..fFFAhACAQGGAaGHBOHAA.....hCAA......hCDA...,2,-8,-2,6
ZAeQKBOFRabPdLVITMHWGDUfNXECYcgJS,eAAAQAAAOADCRACA...aAFAdAFALCCATCDAHBGBGCFAhAAADAIBUECA.XFGDhABAEDAACEFA..gFEGhAAASAHHAEIBFHAAPHDCIHHAWDHB.hCAA......hCBA...,2,-10,-2,8
KVeDNXTBdMfPZIHGOALSaQgFEJCYbUWRc,aAAAQAAA.EACACADAUAFA.RCCA.KAEADAIBTBGA.dCDAhAAAMBBBZDFAHFCAACCALDGBhADAFFFAJHAA...hBAA.bEEB...VFBA...NDIABHBDhBFAfGHA..hAGA...,2,-17,-15,2
REHSVLPIKYDbFWacOJegfUdAXCBTZQMGN,BAAAZAAAGAEAEACAHAEALAGBKBHB.DACAFCAA..aCCCOCEBhAAAeCHHUEBAAAGA.CEED.MCGBhACARGEA.SDCHhAIA.IEHA.bFED...cGGAhCDA....hDAA...,2,-25,-21,4
BZUWVSKeGTIcORLFAQNMaYdJPCbXgEDHf,MAAAdAAACADA...XACAEAFAHBFC.ZABBVAFAKCED..GDCAhAFATCCAOEGBLCFAhAFAAAIB.aEEAJFEB..bEGDhAIADDIBBBBDSHGA.....hBAA......hCAA...,2,-20,-12,8
PVMXIFTNYAcBEKegQJSCfZUbdWGaHDORL,EAAAeAAA.QADACACAZADB.dAGAaAFDHCCARBGF.LDGB.hAAAMAIBFDCHTEEAhAHAAAAAKEEASFBAUGEB.hAIAbGBADDIBOFHDXFBC.IHHAhBFA......hBIA...,2,-20,6,26
QaVSFdHKALUBYeZXJbcTRWPNDCOEfGgMI,LAAABAAAeACAZADB.JAFBTAFA.RCAA...PAHBCAHBECEBGCGAhAAAMCAA.aEECFDFDhABAHFCAADIBUGGA..hACAXGGA..WEEDDICA....hAIA......hDAA...,2,-31,-3,28
DgJRIfZQNVLBHeKOSFYUWcEPdXTbGMCaA,DAAARAAAZADBQACALAGBHCEBKAEA.FDAAUAGA..EDHFdDDATFBAhAAAGDGA.aBBHAAIBJFGFhABA..IGDAhBAANICBBBFB.eFFB.SCFD..hBIA......hCAA...,2,-23,-6,17
SPLCQHZFVJEeBdAXbDRWcKNfGYgTMaOUI,DAAARAAAKADCGABB..TAFAaAEA.UCCASAGH.LCCAhAIAHCFCZEDEFCHDEEHFhAAAeDFFAAHA.XECAhBAAcGGC.fFHA.MIBAOFCHhABACGFA......hBIA...,1,-6,-21,15
VfgFGdESMAIHDXYBPNLcROUJQKbWeaZCT,HAAAXAAABADBLADARAEFOAGD.UCABQBGA.bCDBhAAAeCHHZDEB.TDDAhAAAfEAAGGABEEHBAAIBDDGBhACAPGFCJFFF.aHAACHHA.......hAGA......hCDA...,2,-5,2,7
BJMQREIfNaLUCZgFWODGVXecKPYSTdAbH,HAAAMAAARACAEADE...IAGAaAFALCCAZBFEFCAHDAIBGCCAhAAAeBGBKDFBSDHBhACA.ACCBBEFAQECAhBAAfFAACEHAOFFBXEGD.PFEBhAFAdGHANBBA.....hCAA...,1,7,-15,22
KQNDCPZdXTeFYUfIgVLGWaRAcEHSMbOJB,HAAAMAAA.OACAKADADAFAZAFB.dBHA.eBEFFAHDUCBA..fCCAhAAA.gEFAhAIAGBFARDDFEDHFhBAAbGEABHCAQGGANEIA.CFCD.....hBBA......hBCA...,1,2,-29,31
dCbESJIOWUXRYPMaLNFKTQcGBgDVZfeHA,dAAAEAAA.SADAOACCUAFARAFF..MAIBaBHD.LCCB.hAAAKCEDTCCAGCGADDFBhAEAZDABHEFBAADACEFDJHAAXECAhAIA.PHBAQGGBBFHB...hBHA......hCAA...,1,-4,-15,11
cOVFMJbIEaPKUCZTeDAQLgSBfHXGWRYdN,LAAABAAAHACAGADARAFFdAHA.OAFAMCAB.JBGFECCB..aCAAKCEDhAAAZEFAeDFA.AEIBQFAAhACAfFBAXFDChABA.YGEGcFFAFHFC..hAEA......hAFA...,2,-12,-10,2
BOGXJRZCFATIaeYdcVSLDEWgfMQNbKHUP,aAAAeAAA.dAEA..SACHEAGA..fBCAMAEAbAFAHBDBhBAABBHAGCEBhAAA.REBAZEEFABBBTCGAhCAAIEHAcEFALGAADEIBQFCAhCFAKGGC.OFFB.CHHA.hCGA...,2,-10,0,10
XUZPfdVTbRCOGgYLBNHJQKDWeFcAESIaM,EAAAaAAA.UADAZACBdAFA....TAFARBGFGDEALAHBHEBBQGGAhAHADBCBeDBAADFAMEEAhAAA...fEHAhBDACBBD.OFFBBBECNIABKGHB.FHCAhCAASDHH.hCBA...,2,-12,-8,4
BaWSbFQTXPRLMVDEICJNZeGdfgAKHUYcO,HAAAUAAAOADAaACA..SAEHQAGATAGARBDBLCFBhBAAMCCBECGBCDBAZDGBeDDBhAAA.dFFAADDBKFEDBDFDFGHDhBCAXGAADIBA.IHHA...hBDA......hBIA...,1,3,-15,18
bSUfTKdGDNLaZeAXcWIPRCgBJOMFEQVYH,XAAA..IAAARADABAGBMAIBEACAQAEA.hAAAHAGDbCDAUDAATCAAhACAGDGALCCBeEEBhABAACEBPDGBCFCAOHCCFEEBSGGDdGHADCIBNIAB.hAIA......hCAA...,1,-2,-3,1
LgQDWNAbafVFSRZYXeCKTEJPdHGBcMOUI,aAAAFAAARACFZACB..eAEEKAEA...EBEFdAGAHCFAGCEABAHBMAIBhBAAOEEBLDGB.hBAAQECCDEIBACHAbFGD.hCAASFHHCGFA.......hCBA......hDAA...,1,-16,-21,5
ICfNbDRQAGJdUgOaLcBKSXTVYZeWPMHEF,dAAAOAAAaADA.LAEAKAGA...TBCAZBDAeCBF.MCHBhACAHCEAFDDAfDHAhAFA.bEFDREBFACIBGGABhAGAgFFBSBBDXGED...hAIA......hBAA...,2,-19,-8,11
fQdJZceCBHFgRVMOTUANLSXbaWGKDYEPI,LAAAXAAA.aADDGADA.DAFAEAFA...IBHAhABAdBFAZBGBeDAAHCAARCEAMCIBhAAATEFAAADBSEFDhABAKDHBfFAAJFHF.BFCA.FGHB.OEEHhACANIAB.....hAIA...,1,5,-17,22
KQETXYbHBfcZCLMVIaJUADeWFGgRSPONd,eAAAGAAARADA.OADAdAGAKCCAEAGA...TCDAXCED.HDGBhAAAfBHAZEAAMAIBhABAaCFDAFFB.FDCH.SDHHhAAAQGDDbFCACGGD.LHEA..hACA......hBAA...,2,-7,-7,0
JRaePYgKSLHZGEQVCNDUTBdWcIFOAfXbM,XAAAMAAARACA..eAFE..PADAKBBDHBECEAGA.QDDAhAIACBDDDBIBBCEAdDHAICGAhAAAAEGAbGFA..aFEESDDDhABA.GEEANICB.WEHB.hBAAFHGC.....hCAA...,2,-15,-6,9
WcIXfEMCTVOHbQJFZBALNaSKPeDYUgGdR,aAAAKAAAeACE.DAFAUADA.dAGARBCB...IDBAEAHF.MAIBhBAATCFA.HECChAAAbDDA.QFGAhBGAZEGBABBBLFBASCHHPHDC.....hCAA......hCBA...,1,-16,-21,5
FXBJCdGQNbcTaDHMeERIPOAWUVZSfLKgY,VAAAZAAALADB.KAFAFADABAHBdAGAGCDA.QDFChAAAbCAB.aBHDHCEBhABAEEHFRFCBOCGF.ACIBSEHHhACAfGBEXGGACFADTGCAeFGDhAFA.....hAIA...,2,-11,-8,3
QCbNVJDaGOeBMRYHLcPZgdIEFfTUXKSWA,QAAACAAA..bACAVACA.aAFAeAGB.RCAAHCFBLCFAhAAAZEAAdDECEDDBTEGAhAIAKEHBAACADAIBGGBBBGGAMHAAhAAAcFFC.........hAEA......hAHA...,1,1,-15,16
EBcLgaRDJHbeYFKPWIGdZXSfVNAUOCQMT,CAAAMAAABACALAEA.RBBAHCEAeADHKAFA..IEGAhAFAZBFESCAAVGAAAAIBQGGAhAGAEDEB.aDDHhBAAbDFD.FDHB.GFAB...fGHAhAAAOFFB...hBBA...,2,-24,-5,19
EDAZMaSGBHRNTbYLIQdPfFCVOUJKgeWcX,aAAAGAAAHACBRADA...TAEALAGBdAGAFCHDOCDB.KDHBeBBDhAEAXCEDAAIBZDEBMEDBhBAABEAD...bEFDQFFAhAAA.CGCA.......hACA......hADA...,1,-2,-24,22
HTOPFAVBZKLUScNEeYXaQDbCRIJGgdMfW,ZAAALAAASACEEAEA..eAGFaAEDQAGACBHARCAA.GCEBhABAdCEAMDHBHEEATGEAhABAFCCHAEHAKFHBUEABcGAAhAGAXEDCDGGB.IHHA...hBIA......hCAA...,1,-4,-6,2
gHIfAcebaPBLUdYRTWCNGDJMQZEOKSXVF,eAAAaAAALADAdAEARAGB..CBCA.GAGA.MBBBECFFKDDB..hAAAXCCAFDHDHEBBAAEAbCEDhAIABFFAUGDA.TGGAhBAADGABZGEAODHD......hBIA......hCAA...,2,-22,-5,17
beRTWHFfZSJadBMcKgXADLGENYVUQCPOI,GAAAEAAA..VACAQADA.OAFCeAFERBFBHCECZCCAaCHDhAAAdCHAMCDBKEEDAFGALHCAhAIAUFEACGGBIHAAhAAATGGA...WDAD......hACA......hADA...,2,-10,-9,1
fHABdaPFDSgJVcOGRXYMEQKeZTUICLbNW,aAAADAAA..SABA..gACHVAEAGCCARAEFMAHBhAGAEBHF.eBBDZEAFTEFAhAEACDDALEFA.bGCAfFEEhAHAAAIBdGGA.FGHB......hAIA......hBAA...,1,-9,-16,7
ZeFTQOSURbAfDXPdHINgYLBEMJGVaKCWc,XAAAHAAA..gADBLADAEAHBGAGAKCDA.CAFBZCAAeCFEhAAATEDAQDFDhABASDGDREAAAAEADEEBdGGAIGFAhAIANDIAMIAA.aEHD.......hAAA......hACA...,1,-4,-5,1
UfLMaWJBOegIEbQRANHYSdXcKVDZTPCGF,HAAAdAAAKADAZADB.TAFAGAFA.FAHFLAHB.aCACBCBAhACAeCEHECEBRDFF.ADABSDCHhADAXFGDDEIBCDHA.MHCAhAAA..OEEB.bFAC...QFGAhAFA.cGFChBAA.,1,2,-31,33
VRIGFbgNPfHdeMKaUYQSCXDJZcTAWBLOE,LAAAEAAARACA.GADAFAFA...bAFAPBHDHCAA..eCFFhABAaCCC.QDGAhACA.XFAAZCEBADAAODGBhAAAgFGGdECAMFHBKHAA.....hAFA......hAGA...,1,5,-23,28
LVSAdBebZWKYRCOGUfQNTaDXEPgcFJMIH,eAAAZAAAKADCRADAGAGAUAGA...QCCCaBED.ECFB.PEABhAAAFCAAMDDB.HEEAhABALEEBADHAdEHABGBAhACAYDHBOGDCfGGEDIBA.cGADhABAIHHA...hAEA...,1,-7,-21,14
CIPLgSJaGZQbKefUVcOdNBDWHRAYEXTFM,EAAATAAAFACD...MACACAEALAGB..SAEAhAAAGCDAZEAAbAGDeCHHUCCAOFFBhAAAdCFCDAIBHGBAADBAXEFAhBDAIGHAgGGA...hAEA......hAIA...,2,-10,-10,0
ZWXVKbJdYSfLUgcIPFNEGHODQBCRaAMTe,eAAAZAAA..XADBKADAdAFA..SAHBLAGBUCAA.hAAAIBFAFCCAECGFHDEBhABAQDDAREGFADIBMHBAhBHATEGA.VGEA.......hCAA......hCBA...,2,-17,-12,5
VAWYcXHOKNCFPZIRDMBEfbeUJdgSaLGQT,......cAAAHAAAKADC.FAFDZACBRBGFMCABEAEA.eCCBhAAAdAHAaBEEGEDAQDEAhACAAAHA.XDGAhBAACCEDDDIBbFFBgGGA.LHBAhBHA......hCAA...,1,-12,-15,3
CBINZdUaGbWcEPROgYJDMKAHLXeFTVQfS,HAAAeAAAFADDTAEA.QAGCCAFABAHAZCCAaCACGCGA..hAAAbCCBEEEBRDGB..OEABhAAAJFAAKGDAACIBLEEBhACA.fFDASGFHdGGDWHAG.hADA......hAEA...,1,13,-25,38
gcZGSYMPWUAVeDTQfJLRIdCKaENHOBXFb,eAAATAAAQADA.LAGBRACFdAEAaAGAHCCABBGAbDFAZCFEhAAAGFBBMCABUEEBhACAAAAAfFFBCEHA.EGHFhAIAXGBA.FGHB.SHEAhBGA......hDBA...,1,11,-13,24
AaSPMROCJfGHVXceFWIQKDgEbdUNTLZBY,aAAAMAAA.RACA.CADAGAEAHAFB....XCCAeAGBFBBHQDFBhAFADAIBEDAB.dFFDTDCAhADALHAAZEFBADIBOBBBhAHAJHAA.fGHA.WBHBKGDBbFGDhAHA.....hAIA...,1,-3,-11,8
GWUTJAZbYOLVECKFHedBMNaDQfXSPRIgc,ZAAAOAAAEADE.FADDHAFBBAFAMAIB.DCAAQBGA.SBBDhAFARCDBgEGAhABAGCEATFAAAAHAbEGDLHAAhACA.KGEAeDDD.aGDC...hAFA......hAHA...,1,-6,-16,10
eXMDbRKGSFTUOWcQZIgYCJEfPABHLNaVd,HAAAaAAA.eACEMADARAFFGCCAFAGD.TEFAOBBB..QFAAhAAAZCDAIDHACAHBEDHBhAFAAAIBLECAdGHADFEBKHCAhCAASFBD.cFGA...hCCA......hCEA...,1,8,-25,33
CXSZPWMKFaERUHeAQcdVGJBfLNbIODgYT,dAAAGAAABADALADA..bABDDAHB.TCDASAEHhADAZCFFMAIBaAGA.REAAHFEAhAAAABGAQCFA.VEDAhBAAfDHEOCHFCFHD.XGGCKGHB.hACA......hAEA...,2,-11,-7,4
KMSWPNVCIQBETJfGgHXeRbcUaDAZFLdYO,ZAAAdAAAKADAMACA..SAFB..PAFCCAHABCBAEBEB.hACAJCCFGCEA.HCGDhADARCFFUFFBACEBLHAAhAHAOCHD.VGFAIHCAfDCA..hBAA......hBCA...,2,-24,-18,6
DSFOGBXKJHCTAYWRLMeUZIVQENdPgbacf,RAAAeAAAZADB.QADAEAFA.dAGA..bBFAaBHD.DCCBOCCHhAAAGDCAKDABHEEBADFALEEAhABAMEHBIGBAhAAA.NEIA.gFGA.SGEBhADA.BHBA.CHDA.hAIA...,2,-16,1,17
TCLFcaNVEIefUdYOZXBgPKJRHSDGWAQMb,MAAATAAALAEA.FBBAaACA.EAFAeAHHdBHAZBDABCDAKCCDHCEBhAFAGDEAACGBQEGAhAGAbEGB.CGGDNIDBfFAAhAAA.OEDH.....hBAA......hCAA...,2,-19,-2,17
XDPJfGQIRHLYbOEFCBWaNScUVeZTgAKMd,dAAADAAA.JADAGABB.RAFFHCCCLAGBOAHDEBDBBCBA..hACAaDFESCEHhAIAUEAAeEHFZEFBAFFAKHAAMBIB.hAEAXGCA.fHGF..hBAA......hBCA...,2,-30,-14,16
KSCAELYNTWdPQUOFVHJDfGIbMRceaZgBX,EAAALAAA.TAEAdADAQAFA.FCBBHAGBDAIBGCEAhAAAbCAARDFBeEABZDGBXFAAhAFACCEDAAIB.NDDA.PEEBhABA.ODHFfGHAIHGAaGDDBHBDhBCASGAD.hBDA...,2,-12,5,17
TFYBSLRXNIabJMUAePVDcCKZdHgQfOEWG,eAAADAAAKACAHADA.QAGCEAEEGAGATCCABBBDLCDBhAGA.RFDA.XCEDhAAAaCFH.bDGBMDIBAEIBcFAAhABAdHFB.OFFB.FGHDNIAB....hAFA......hAIA...,1,2,-18,20
aFgWecQLPOfISUBETGJNdDVKXMACZHbRY,HAAARAAAFADA.eACELAGBOAFA..SBEAEBFFGCCAdCCAKBHBhAAAAAAAZDFAaDHH..gEFDhCAAQEDDfGDAhCCABFHDTGFADGIBMIEA....hCEA......hDAA...,1,0,-21,21
fcHNIdMWDTASLJbeVBFEgZCXGPQOUKaYR,LAAAeAAAFADDZAEBGADA.QAFAKAGARCFFHEGBdBHA.MCABhABADCCBAAAASCCDhACA.bDFCEDDB.CCHBOFFHhAIAaFADfFGA.IGDA.hCAAWFHH....hAFA...,1,-10,-22,12
ZOdAFgcEaDRPHJQMSWeIfUTBLGYNCVbKX,FAAAEAAARACAHACB.MAEAeAFE.UCCBLBEBGBFACAHAKBGDZDAFACHA.hBAA.aCHDDDIB.QFCChAAASEDDIGGAhADATEFABFHA.YHDAbFED..hCAA......hCBA...,2,-23,-2,21
YANbGZVcaeWPRSDMfJHFQOEdBCLXgITKU,GAAAZAAAaACA.eADARAEF.MAHBHAGB.QDDCEBFFdCDALEFAhAAAXDGATGDA.hABAKEADAAIBbFFB.VGAAhAGAcGGASCCDDAIB.FGDACDGD.IHHAhCAA.....hACA...,2,-10,18,28
RIdSAWUaFGbVBYTgEPXZHOQfcLMeKJDCN,aAAAGAAABADA..TADAEAFA.ZAFBHBFCQDCALCCBeAHFhAAADBBBREDFdEEAAAIBFDAHbFAB.hACA..VFGB..hADAgDGAXGEDfCEEMFIBCGGANICB.hADA......hAFA...,2,-6,3,9
IbZJedgLPfCADFGNQBWYETKOXcMaVSURH,GAAAQAAABADAEACAOAED.MAGBaAEDSAGAhAAA.HCECZBGBeCDBhAAAdCHALDCBCEHAAAHAFFEDNDAATEEAhAGA.XGGAUGGA.IEBAhAHA......hBEA...,2,-19,-5,14
QfVdeFJESGHKCLTPMXNWUcbYgORaDABIZ,ZAAAQAAAdAEAeAGBEACAHCAALAFA.MBEBXCEA.hAAAUEFBbCEDOCGDhAGAREBAAACABAHBfDCAhAHAFGGH.GGCB.CGGBNCIA......hCAA......hCDA...,2,-16,1,17
FPbYCaNQJIHUBgKTXOcVDGMZREWdfeSLA,FAAA..bAAAaACDQAEAHAEABAHBKAGAOCDCDAAA..ZCCAECGEhAEAdCHA.eDFHAEEACEFA.IEAAhAEAUGAA.TECAhAIAXEGD..cGGAMIEA...fHDBhCAA..hCBA...,2,-22,-17,5
fWcXeTOEbVFDYGJZSHPQIKCdNUaRLgMAB,BAAA..fAAAXACA.eADAEAFA.bAGDDAIB..GCAAhAAAZCAAHBGBQCCAhACACCEAdEEAaEHDREDAMEHB.hAAAAADATGBAFFAASGCHKGEANEIA.LHFAhACA.....hAIA...,2,-9,5,14
gaDTQeWBOSHFAYKEVMGdINPCRLXbfZUcJ,EAAAGAAAdADA...IADACAFARAGF.LAFA..bCBCZCDAhAAAUDGBgCGBhACA.aECATFAAeFCBOFEChAGAHEEBACFBKGHBMFIBNIAB.fHABhAHA.DHFABHFA..hAAA...,2,-20,8,28
FUBacPVWNAEdXHeSfJObGZMRYILgCQTDK,EAAAHAAA.eACESACAOAFAZBDERAEFLAGBQCGAKCCABDAAhAAAaCCH...PDHDhADAVEDAAFHAdEEAXGEAhAAAbEFD.MIBA.IHHATGCADAIB.hBIA......hCAA...,2,-6,-1,5
NXWJKUDYCPLcBeAZREOMgdVIbTQFGafHS,EAAAMAAAdADA..VADA..bAEDFAGAGAGAHBBB...XCBChAAAKCFADCIBCDEDLEEBhAGAeEFFREGF.ODHD.hBAATGBAaGHDSHCAWEGD....hBBA......hCAA...,1,-2,-18,16
GERNIXHWZeJMBKLbCPgFfUadQYScATOVD,TAAADAAARABA....XAEBHACBeAEABAGAbBFA..CBHAFCDBhAIAaCACdDEA.QDGChAAASCFHAAEAGGEBhACAEDHB.IHBAZEEAMFDB.KGGD...hAIA......hBHA...,1,5,-32,37
YQPVTIJZWFeUOaCgSNbDRMXAGBEHLdKfc,EAAAHAAAdADAKADC.....fAFAQAFATBGAZCBAeBHHhAAAaCAC.SCFDhAFADCCARDDAAAHAGEGALFFAhAIAPGDCIGDA.FHBC.CHFA.NIBB...hAAA......hACA...,1,-6,-8,2
IaTLZGVSYPJCBcdKOeHWEXRFAgNMbDfUQ,MAAADAAAQACA..aACEZAEBGAEASAGAJAHBBAGChBAAdCGAeBBBHCCBEBBBREBAACIB.hAHA..bEFAIFFAhBAATGDA.LFHB.YGDACDGDKGGA.hCAA......hDAA...,2,-12,-5,7
PJEdAfeNaTRGXWIbLSOcBYMgUFQZDCHKV,eAAAaAAAGACA..XADA.IAGAbAEALCFAhAEAOAHDBEDA.MBBBhAFAFCCAZDEBHEGBKDGAPFEDhAGAEEAAAAAATGCASGCBgGFADIAA.hAIA......hBAA...,2,-11,-7,4
XCbHFGgJcdVYKPEUDeZWNAMRTafOQSIBL,RAAAaAAAQADCBADALAFA..bAFBHCCAGCEAJCFAdDAAKAHBECCBhAAADECB..ZEEAACHBMDIBhABAOFHD..XGFAhCAAFGAB..gGEA...hDAA......hDBA...,1,-12,-16,4
VNGgEYMHacfFQOAUbKZCJIXWPdeLTDBSR,KAAAZAAACADB..XACBdAFALAHBBAEARAFFGCAA..EBHFHCCChABAaCCC.FDFD.ABHBUGGAhACAbDED...IEHAhBFAeDHFTECA.SFHH.hCAANHABMIAA...hCCA...,1,-11,-16,5
BVRJgQIeSTfNWMFHEUdCDLZbAKOPYGXac,OAAAGAAAaADABADARAFF...QAFAeAHHSCDB.hAFATEBAfBBEhAIAMDIBHDEBECEBdBHALEGBhAAAADDBKDGDXFCAJHAA.gFFAhBAA.IHHA.hACA...,2,-16,2,18
BOTQANSDPMcWgLYeFHUGRJbXaKVIfEdCZ,DAAAMAAA......gABAeACAHAFARADF.bBBCKAFCfCEAhAHAEAHFZCEB.TCGAhAIAACIBSDGB.hBAA.cEFALGEAFFFH......hBAA......hCAA...,2,-34,-3,31
IWHeDEUOaZMXJQGVfgLCFNPAbBYdScKRT,BAAAdAAAKADARACA....TAGAHAFBEAHBUCAAZABB.MCEB.QDFBhAFAGCDAfCFBhAAALFFAFDCDAAFASCHHhACAIHFADIAAaFDHXFFA.hAIA......hBAA...,2,-20,-12,8
KaDOTbRUfdQSZFNEHIPLVXJBYcGACMgeW,MAAAeAAAKADADAEA...OAFARAFAdBBAZBCBEBFF.HCFCLCCB.hAIAJBHBBEDA.GFEBhBAAAAAACEEA.aFCHUEGBSHFAhCAAFGDA..IHGA...hCBA......hCEA...,1,-18,-25,7
FgLaAODUPQZeIXdEVHfWNTJSBcGYKMRbC,DAAAQAAAeABAdAFAHACA...fAFBTCCABAHAGCDAhAAAMCHBRCFAFEAALDFBhAHAAAHAOEHBZEBAEFHFNIBBSFCHhAEA.KFFBCEEB......hBIA......hCAA...,2,-24,1,25
AJDgFQKWOUMebNIRfYVPZGEdSBaHXTcLC,DAAAQAAAOABE.eACA...bAFARAEFVBGB.GCCAhAEAECDAdCGABAHBHDAATEFAhAGALDFD.AAGAFEHDhAAAKFEDMEIBIHHAfHGB...hADA......hCAA...,2,-19,-4,15
WdTJMaQLIDRZVgfeUAKNFGPCXcOBESYHb,FAAAGAAACADA.OADABAFA.EAGAHAGB.dCCAMBIBLDABRCDAZCGF.hAAA.VEBAeCFBACDAKFEAhACAXECA.SDHHhADAbGEA.TGGA.aFEDDGIB..hBAA......hBCA...,2,-16,-4,12
adbDJXSWeAGHQTEOFPYcfgMNLVCRUBIKZ,HAAAEAAAFACD..PADA..fAEAMAHBLCAARAFFBAHBhAAAZCEBdCHADAIBSDDAhAEAACEBGEGATGBAhAAAOEFCgGGACGDBKGFD.aHDA....hCAA......hCBA...,1,-2,-20,18
WRfJXDdbYEGSVMgeaTOKIZNUcABQFPCHL,QAAACAAAHACARAFF.JACEdAHA...ECAAGAFA.MAIBeCDFhAAAaCDBTDGAKDHDZEDBUEAAhACAAAHBFFBALEEBhAEA.XGFDbFFA.......hAAA......hBFA...,2,-17,0,17
NSELVDMgKcCeAWUbaBdfIJRQYFHOGZPTX,UAAAaAAABADAdADA....JAFARAEFQAGCHBEBZCGB...TCCAhADASDBAECHFLEEBhAIAMDIBKEEDeDGDhBAAADBA.fGGEFGCBGGEBNBBADEIB...hAIA......hBAA...,2,-18,-1,17
MPgSDEUNfOFGRdCXIYbBTQeVHAZcJKaWL,ZAAAKAAALACBMACA..SAEAEAEAUBGA.OAGDRCEB.dCCDhABAXEAA..hAAAbCEDTEGAeCHHHGDAhAIAAAHAaEEH.gGGBDGGBFGCDCHHA.....hAEA......hCAA...,1,-3,-18,15
ZWUXfcOGeCVQLMdbBNgAFKaEPIJDTHRYS,aAAAEAAA....IADATADAHAFB.RCCBZDAFXAED.hADAOAGFeAHBQDGDhAFAdCBAbDCDBDHAABBBKFDAhAIADAIBSEEAfFHECGGDMFHB.FGAB.hBAAYGDG..hAAA...,1,5,-25,30
ebRUdJOWcZMfCSLHAXgKDNEYBIGaPQFVT,KAAAEAAABACAGACA.QAEAFAEA.eAHBRAGFdCCA.OBEBhAAAZCAFMCHBCDFA.HEDAACIBDEHBhAIAIGBA.aEHDhAAATFDAbGDA.UGGB......hCAA......hCBA...,1,7,-32,39
dZOLBPHMbFDTUaNfIgAQVWcGCYXKRJSEe,QAAAVAAA.GACBXADBRAGFECDBeAFAZDAA.LCDAhAAAHEFAMFABDBIBUEEA.hAAAaCHHfFCEhADAAFCA.CFEDKGHBdFHABGAAFHEA......hAGA......hCAA...,1,12,-19,31
TJXdUOGaYCSFADQcPLWRIgKBHMNeZbEfV,QAAALAAARADFKAFCHACA.eAEEEAHF.TCDAdCAAGCEA.hAAAaCCHSAHBhCAA.ACFADCHBPCHDgEFBhDAAMFHBZGCAbGDC.......hABA......hACA...,1,0,-12,12
YQJBgfZFTIGEWdNSROVXUCDHcKbeaLMPA,QAAABAAAZACAFAFAGACB.EAGEdCCARCDA.OAHDUCGAHDAAhAAAKCFA.eEFBLDABhAAAAFABJFHB...TEDAhADANIAB.SEHBCHFD.DFGBcFADaFHH.hAEA......hCAA...,1,11,-30,41
EaILcPZJBDHKYQfGAONVedgMSTUbFRXWC,OAAAeAAAdAEA.MAGBTADA..FAHBRAFFCAHBEBCA..LCCBhAFAZDDADCIBHEGBQDGAhBAAAAAA.gEDHhBBAbFDB.aFGC.IHCA....hCAA......hCBA...,2,-17,-17,0
GFObCZgNMeLcTKIYQPWRUEfSaBHDJXdVA,GAAAOAAAZADBMADALAGBKAGA.QBBBRCDAECGE.aBFBHDBBhAAA.XEFAhACAAAIBCDHAeEEBTGEA.IHHAhAIAPEGBfGCADEIB...hBAA......hBCA...,1,-8,-18,10
FgWPcTBNCQaIRZJdbAXGVDHUYSEeLMfKO,GAAAHAAASACEEADAeAFALCDAMAFAOBDEFBHD..PECAhAAATCGA.CBHBaCCCREGBdGAAhACAADFBDEEBUGEA.KFCDgFFAhAAA.BGBA.IHHAhBGA......hCAA...,1,5,-18,23
KgbdFALDISJfRVGUMQeCaOZXHBWNYcETP,LAAASAAARADFGAFAMADA..eAFAaAHFZCAAHBCABDHANBIA.hAAAEEEBKCFA..dFAAADEBDEBAhABAJFDF.UEFA.OHCAhBEAXGFA..YHFG..hCAA......hCBA...,1,-13,-14,1
fGHdZELQUTNXcBgDOPASCRbJIaYVeWMKF,RAAAJAAA..aADAeADEKAGA.GAGAHBDAECCBLCCA.UEBATCGAhAAA..XDFDhAGABDFDOEEBAAIBCBDAIGGAhBAAVFGBMGAA..dEECNIABDGFB...hCAA......hCBA...,1,-3,-18,15
JBHIdWfUKLOSENcVgReQZPbaMCDTFXGAY,BAAAHAAAdADAUACALAFA.ECABVAEARCDAZCGB..aAHDMCCBhAAADCBB.FFEBGDDA.hACAADDB.IGAAKDGAOFGBhAAASFHH.gGCDeFHHPHAAhAHACGGC.....hAGA...,2,-23,-6,17
eGRMYKLZJUVFIcAESBgWOTXPaNfDQdCHb,EAAABAAA.OACA..TACAaAFDDAHBdAEA.HAGBGBCARDDAMCCBhAAALCBDZEGBVGAAhAGAFCHDAAIBSFFFhAIA.XGDDfEEA.bFGB.eGDAhAAA......hBCA...,1,9,-27,36
KMVeJCSEWGPIUALfgbdDYNHFTQaXZORBc,LAAA..bAAAdAEADAAAHAGBFAEA.aCAAZAGBRDCAKDGD.eDHHhABASBDHGGABUGGBhACAABIB..fDEAhCAA.gDGA.TFCAhCBAXFDABFFD.MCCBhCFACEBD.EFHF.,1,2,-30,32
TCEKXdYSWDGgFLfPaMIVJeHZBQAUNcROb,UAAARAAAOADACADA..KAFAdAHA...SBDHGCBBLAHBhADAaBFD.MCEA.JDFBhAFAHDFC.ZFCAAEEB.bFFDhAAAEEHB...XGGCDCCBfHBBhABA......hBHA...,2,-28,-21,7
IgZUKAafNEWcJMeHVTYPLSQDGFRbXCdBO,aAAAEAAA....JACBHACB.TAEALAEAQAGCGCEARCGBhAAAbCFAdDDCBDEDOECHhAFAZEAAABBB..fFHAhAGAcEFBeFHB........hAEA......hAIA...,1,-7,-15,8
VCNHGPaObWgQSMTXFDcfJREZUAKYLIBde,LAAAdAAAeADACAGAHADB.aAFAOAHD..bBFDQCBAhACA.MCFBTCAAhABADCGBJDAFEBHFADDB.KEEDBDDBhADAVFBBGDGAgFGASGGD.hACA......hAIA...,1,-4,-14,10
YOWNDUfKMcSQIGHTZVXCEPJgaRABLdeFb,dAAAeAAAFADAOADCDAGA.KAGC..MBDBQCCAHBECZDFACBHA.ECBFhACA..JCFBREDBABHALDHBhAAA..bFFBYFAAhABA.NHEB......fEGAhAFASHDA.IHHAhBAA,1,-19,-33,14
XeYIBUNFQVGWHgTObSEDfKLacCJPZdRAM,eAAABAAAFACAGADAHAEBOAFA.EBFEKAGALDBBaBCH.CCHAZDEBhAAAACHAMDEB..XGEAhABAIDGANDDA.QFFAhAAA.gGAA.SEHHhAGADEIB..hAIA...,1,-5,-37,32
VREQgZCcJIOKGSBUXdHeTbPWAaMLYfFND,aAAAMAAALADAFADD.DAHBEAFA.ZBBFCBBD...JAHBKCDA.GCFAhAEABCFAdDDAHFAAeDHFhAFAbFGD.AEGB...fDCEhAFARFEB..cFCCSDHB.hBAA......hCAA...,1,-12,-28,16
fgEeJWaDdYCNUBOPTASXMbGZQKcHFILVR,MAAAZAAAQAEAHACCLAFBRAGB.EAHBeCAB.aCCCdCCACDEABDGDhABATDGA.ABBBbEDDGECAhACA.FEHD.fFFAhADAgFFBDEABYFCD.NIDB..hAEA......hAIA...,1,3,-10,13
eJFfZgHTVUPQKCEGaXdDRIALbBcMNWSOY,LAAABAAAMACASADH.eAFAfAFAHCAATCEAhABAUBCAQBGAhAAAKBHBEDGFaEEH.dDFA.RECBAAHAbFAAhACANEHA.OEHD.FGGH......hAFA......hAGA...,1,4,-26,30
ZRQXWOaUKeNILBPFVGDSMHCbJdcEfgYAT,RAAAQAAAOADA.aACEeAGF.LCCAFAFAGBDBMAIBHDAAhAAACBDA.dDDAEDGF..fCHAhADAAAAAZEEFUGGAKEGDhAIABEHADEIBbFEDJHCA........hBIA......hCAA...,2,-9,-3,6
KEPTUSGJMWebaYNADFLIVgRcCfZOHXBdQ,LAAAVAAA.RADFCAFBZADB.HAFAdAHAKCAAECFBUDAA..GCEAhABAMCHB.eCGB.aDDHhACAAAHAFEEB.IGFAhAAAfFHABHGAPHBASEHH..hADA......hCAA...,1,-16,-17,1
bQYeOBMATDFUKCcGLZWagdXNIESPHVJfR,TAAAFAAACADA..GAEAZACB..aAEDdAGB..XAGAEBHBHCCBhADAVCFARDGB..bFFDeCABhAAA.MDEBACCBKGDALFFAhACA.gEBH.SGADhAGA.fHFBhAHA,1,4,-28,32
ZHOcDLESMTYXGRVIFBPJgaUQbKWCANefd,eAAAZAAAHAEADAEALAHBEBHF..MCABTBCAGCCB.REAFFDHDhABABBEBJEFBaBFDQGCAhACAbDEC.CGHAAAHAdFFAhAAA.SEHH.YHBA.hADAIHHA..hABA...,2,-27,2,29
UgKNQfcCbSAIYPaVLBHMWGZdJRDTOeXFE,..IAAAaAAALADAHACAGAFAdAHARCCAOBBBeAHBECAA.KCDAhACAQCFCCDHD.hAEAAAEAVEGBMEEBZFAADEEBFHBAhBAAgFFA.NIAB......hBHA......hCAA...,1,8,-16,24
FUXRfLeWBTaIQOYPdVAJHbMZcNCEGDSKg,HAAAZAAACADBGAEAKADCFAFDRBGFLAGB.BCAAaCAC..QCCChAAAOCCBdEDAAAHAMDFBhACAEDHF.DDIBUFGB.eGBGhABATGFA.........hACA......hAIA...,2,-18,-17,1
RYaPfDNCUEXgBGFSHTAeVJZOcIKdQLWMb,eAAAZAAAOACAKADAdAFALAGB.MAIBRBGFaCCA..DBFBCAHBUDDBhAAAECCB..BECDGEFAhABAHEDBADIB.VGFA.hCAAIGBA..WFHB....hCBA......hDAA...,2,-28,-15,13
MEDWZISOXaABYgVHQFPCedfJRLKNcGTUb,BAAAVAAA.HACA.QAFCCADBdAFA.RCAALAHBKAHBGCDATDEAhAAAMCHB..EFBAZEAAhACA.OEGDACDBFFFBeEHHhAAAfGDA.cGFCDGDBSHAAhAHA.....hAEA...,1,-9,-16,7
AXfPQVJIdGbeKRcUMTHgEOSBNZaWFCDLY,XAAAQAAA.JACEGADA.eAFARAFAMCDBHCFA.EDAABCEAhAAAaDDHFEGDLCHBhAGAAAAAVFAAbEEB..KFEBTGGAhAIASGHH.NIBB.CDGBDECB...hADA......hAFA...,1,3,-13,16
LDZQUegYHdMaVcGSBJTCIXEAOWbFKPRNf,OAAAFAAARACFLAEBZADBUAGA..eAGBHCEBdDGDMBBB..aAHFhBAAGDBABECATEEAhCAAXDGB.ACCAbGFAKFHB.hCBA...fGCADGBB...YHFAhCEA...hBAA...,2,-17,-11,6
JFKcEaOfPWHBVYZGMgNeXDdQRSIUCLATb,TAAAFAAAEADA...aACAOAFC..fAFAHCCABCFBZAGBhAAAGCGAMBDBeCEBhAFAdDAARECASFEAhADACDHAABIBKEGDPFHD..YFHBXGCADHAA..hAHA......hAIA...,1,-6,-14,8
KcSPLReIXTgDJVYAWHNZFEadUBObMfQGC,HAAAZAAAEADEdADABAFBMAFAGAGAKBFA..SBHBRCAA.eCABhAAATCEADCCBVDDAhACAAAIBFECAaDHD..bDGDQFFChABA.CGEC.PFBCIHHAXGDAhBFA....hDDA...,2,-10,-10,0
eEPQRIJaWAfKCYMdNcbFBZVTgDSHXLOGU,CAAAdAAA.....bABDZACA.TAGADADAHAECLCCBGCEAECEBhAAARCGBaAHFAADA..KCGDMECBhBAAFDHDBEEDSEDDhBDAOFABeFHFQGFA....hAFA......hAGA...,2,-25,1,26
BHAPLOcZKEdTefgCRaGQYVFSMIJUbNXDW,LAAAZAAAEADE.eADHCAFBGAGAQAFAFCAA.MAIBUDDAXCAAhABABECCHFEC.AAIB.hABAOCFBdFHA.TDGAhACAfGDEREDBaFAASFHH.IHBAhAFA...hACA...,1,7,-20,27
DFUEaOcRJIXeCVfBKSAgdLWZMTQGHYPbN,dAAAZAAAMACAGADAHAEC..bABDFBHDEAFAaCCC..RBGB..XDAChADAeCEHCDGDBECA.hAFAAAHALFFATEFAQFDChAIAPHFA.DEIB......hBAA......hBDA...,1,-6,-16,10
OUKVgeZFESJPHfTCGYdABRbWXIMDNLacQ,RAAAXAAAMADA.LADAQAGA.KBDAeAGHZCCA.ECDASCGDhAAAHDEATEAAGFBBhABAAAAAbFGBDDIB.aEECOBHDhAEAUGGAFHDEfDCE....hAFA......hAIA...,1,-1,-3,2
GdFQECeJUTgYXPcVKBMIDHANWaRbZOSfL,aAAARAAAZADB..OACDLAGBdAEA.EBFFeAGBUDAA....TDEAhAHAXDGA.VEEBhAAAMAIB.HEBAAAIB.hABAbEGDfGHAQGCACHFA....gFBAhADA..hBFA...,1,-4,-17,13
SLJcYDMIZBdgebaWANfHQFPVRKCXGEUOT,HAAAQAAAFADARAFFKBHBGACB.EAGEOCABLCDA.JCHBDCCAhAAAZDAAdDDAeEEB.aEGHhAAAAAHA..fDGAhACACFAAXFCCTFEASGHHMEIBBHFA.hADA......hAFA...,2,-17,1,18
MIXgBPCVDcZFKUNTERHdGLWfQJaSbAYOe,eAAAMAAA...XADABADACAFADAHBZAFBKAHB..UCBAECCAHCGBhAAAGCFALEAAhABA.QEEChAEAaBHDABBAODDDgGGA..cFAA.hCAAFEHD.NIAB....hCBA...,1,-3,-33,30
dQbBFcHfMODCTYLXWaIKNJEZGPgUReAVS,dAAAQAAAFADAHAFBMADACAHA.LAHB.aBDAKBDD.ECBFGCBBhAAAUDFBACIBSBGFhBCABEDA.OECBhCAATGFAXEEA.IEHAJHAA.PHCChCEA....hCHA...,2,-31,-7,24
fCMZLJFKAQGSDOYIcbXBRgVdHPTUeWaNE,GAAAOAAA...IADAXADARAEFdAGAHAGB.UCCAeBHHaBBHhAEAECDB..MDFBZEFALGDAhAAAKDGDAAGBQGGAhAIADIAA..........hBAA......hBIA...,1,-12,-18,6
GMCEbfVceRDAQWFBgSKOUITHLdNaPYJZX,QAAABAAAKACAUAEAHACA.dAFA.aAHBJAHBGCDA.ECHF.hAAA.VCAAREAAADGBFEHD.hACAOFFBTDEA.LEHBhAHA...PEDB.XGBDhBGAMIBACHHA...fFGAhCAA,1,-7,-28,21
PISEVQcZfCAGHKbBRFYJNMUdgLWTOaeDX,HAAABAAARACAFADA.JAGBMAFA..dCADLBGBOBHD.eCABDCEB.hAAA..XCCAhAAASCFDECFFQFCAhACAZFFAADDBGGABbFFA.YHFA...hACA......hAGA...,2,-22,-4,18
VKZBYEQIaPXDTOJGCSUMHeAWbgFNLRfcd,...bAAAFAAA.RACFdAEAZADBEAFAQAGA..aAHDDCGBTCAAhAAAGDEACCFA.MDHBHDFChABAADEB.NEEA.LGAAhAGA.fGGEKFCBBFFAIGHA.hBAA......hBIA...,2,-22,-5,17
UCLZQSJFKADgOXVEBRPMdHaeYWcNfbTGI,OAAAEAAARACA.dAEAHAFB.eAHB....cAGAbCCCGDAAhAAACBBDZCDA.QDGDhADAFCHHABDADEEB.XECDhAFABFFAaFHBYEEH.fGGATGBA.hAIA......hBAA...,2,-37,23,60
OYfAHWBRCgJUNPbdZDKTLXeSEcQGIaVFM,HAAARAAACADB.UADA....bAEDZAFBKAGATDDA.eAHFECCAGCGAhAAAaCAC.MEEBhABAfDHAACIBBFFAJGAAhAGAdFBALFFA.SGEDIHHA.hAIA......hCAA...,1,-2,-25,23
WAfCcTGHUDYNgVMIPBbKdFaSXZOJLeEQR,CAAAGAAAHACADAEA..gADAMAHBBBFAdAGA.FCED.aBHDZCAAhAAALEAAECEBRDFFAAIB.TEFAhAAA..YDHBhACAIGBA.bGDCSEED..hCBA......hCCA...,2,-30,-4,26
OABIEMbaKJSRUVCfdNTcgQeZWYXDPHGFL,EAAAaAAA.KACARACF..UAEACAEB..dAGA..TAGAQCCA.hAIAeBHHZCFEXEDChBAAHCEDGEFALEGBhBBAAEIBMGBASGFDNIAB......hCAA......hCBA...,1,-9,-21,12
BaIPNfSgVdLeEHUXTJCObRMZWcGFYKDQA,aAAA..IAAA..fADASACAdAFAEAFAHBGBhADATBGAOBBBRCAAZCEFGCDAhAHAKDHBAACABEDAgFBAhAIAeFABXFGDbFFAMIBAFHFAQGDAhAFA.....hBAA...,2,0,1,1
PBMgJLfbcUZYNdRaIVXeGATHOEWDKCFSQ,HAAAEAAAKACASACE.QAFAMAEALBFA.bCCBhAAAZCCA.dBHARDGBaEDDXDFDhAAAABGA.TECAhAFADFFBFGGHBEHB.fGGA...hAIA......hCAA...,1,-4,-26,22
UEMNDcGfBVTaJXFZAdLOCQKRIbgeWYPSH,dAAALAAAQADARADF..IAGAeAFA..PBHDHCAAEBHFhABAMCCBDCFBGDDAhACABDGDaDHDFDABACGBKEEDbFGBgFAAhACASGAAUGFAfHEFTGCA.hAFA......hAIA...,1,5,-5,10
RUcNgELQbfVCWdZOaJSIDAGeBYHXFMKPT,eAAAHAAAMACAKADARAFF.UAGA....NAIA.EBDALCCBQCEDhAAA.bDGDCCEDZEEAaCCH.hBGASCGHADIBBEFD.hBIAFFAB...cGGC...fHAFhAAA...hCAA...,2,-22,-15,7
fDIMePYUQaEbRFAGKBdNSHCOXVWcJZTLg,GAAAdAAAHADAOADAXAGB..VAGBJCBBZCFALCDB.hACADCFBeDCHUDGBEEEARDBFAAABhACABEGA.CFADTGCAhADAfFFE.MFHBQGGA..hAFA......hBAA...,2,-11,-9,2
NgJAdbLGPZUWDOKTHRCeVSYIacXFfQMEB,dAAAGAAAZABBDAEAKADAHAFB.RCDB.eAFASAHBaBEC.FDCHMBIBhBAABDGA..JCGBAAABLFABhACAUDDA.TFFAhADACFGA..IHHA....hBDA......hCDA...,2,-36,-11,25
SYgbfKOFTNLRMCWDHecUQaIBEVAdXZJGP,ZAAAGAAASACE..bADAOAEDTCDARAGB..MCCBDADAHBGBhAAAeCGDUEDAaAHFEDCBhACAAAIBdFFAXEFC.hABAPFCBfGAAFFHDCGED.WDHH.IHHAhAGA....hCAA...,2,-18,12,30
BTIKQNGfMFSWPJERYXcHUDdbCOAZageLV,aAAAeAAALADABADAKAFAGAGA.MBBBSAHB.JCCAhAAARCCAXDFDHCFBdDHAOEEBhABAAAEAZFCATGGAhAIAQFAANIBB.FGGA...WFCH..hAFA......hCAA...,1,-2,-18,16
aEHbeRQFMIfZCPcOAULgVBXDGYNdKSTWJ,LAAABAAAGACAdAEASAGAJAEA.HCAARCABMAIBZCEECDHAOCFBhAAAAAGA..gEBAhABADCHBKEDB.aEFBEEHFhACAeFHBQGCC.FGFBfGCAhACA.....hAHA...,1,-4,-22,18
YdgAPaGNJOKCfXUWHZScbBVeTQERFILMD,GAAAOAAAKADACADAUAFAHAFB.ZBBA..SBHBBAHAeCHFECDBhAAARDDALFAA.hACAMEIBdDFAADAB.aDHHfFFAhAFAXECCcGGA....hADA......hAIA...,2,-30,-11,19
SENVXAbfeDGBKOMaPIHWRFJYZCTLUgcQd,eAAAGAAAOADCaADAHAFBRAGF.FAHFZCCALCDBUDGB..QECAhAAAEDGAXEBDAAFADFFBhABAMEIB..IGGAhAIAYFEB.CGGA........hCAA......hCBA...,2,-25,0,25
YPNMIgRHbXDZQLfGCSJdVOaKAFcUTeEBW,FAAATAAAEADA..BAFA..PACAMAHBRCCAHAFA.DCCAZCFFLCFAhAAAGDAASCHHhADAdDDAaEGAAAHAeFEANEEA.hAIAIGHA..bFFAfHCBhCAACHHD......hCHA...,2,-12,-12,0
EFXcGgAJNPeOaUMHVILTdKbYDCfWBSRQZ,JAAAeAAA.OADCMADAHAFCLAGB.dCCAKBDADAIBCCCDBCFA.hAAARDFA.EDFB.XECAhABAGEDAACIBaDHDUGGATFAAhAFA...bFFC.fGCA.hAIASHEA.hBAA...,2,-29,3,32
TSdBUbeRCOfPNQXIJZaDEgVMFWKGAHcLY,HAAALAAATAEAdAEABAGAeAGH.RCAA.OBHD..fBHAhABAQCABJCFBaCEHEDHFhACAMDDB.KEADADEBSEBAhAGAbEFDCEHD.XFGAZFDBDGIBFGADcGFChAIA.....hAAA...,1,9,-18,27
HefQgIKTFOGaPEXRAZJUCbWcSDdMYVLBN,ZAAACAAA.....bADBSACA.dAFAMAGBLAHBhAAAHCAAeAHBQCAAhACAKDEATEGAGCDAEFBAABHBUFBAhADADFFBBGGDfDGEFHCA.aEHD.RFFB.hBFA......hCAA...,2,-9,-9,0
adWRLXTJFDBNIAMPeUbYgZcCVSGKOEfHQ,eAAAUAAA.....bADAZADA.CAGBGCBBEAHBHCCAdCHARCGBTEAAhAAADDGBBEAA..AAEAMEEBhABA..PECBhAEAgFFB.SFCHfEEAaGEDLFHBhAFA.FGGB.hAIAIHDA.,1,9,-24,33
KbHfacEJXNRUedOSFWYBQgCDGZLMVAPIT,TAAAHAAAaACA.EAFAJACA..RBFA.dAFAFCCABAHA..QDEDhAAADCCAZCEEMCIBAAIBKDHB.hAAAbFAAXEFA.hAFAeDDDSFFA.YHDGGGEBLHAAhAHAIHHA..hCAA...,2,-15,3,18
BVMgNfEGHKAZISTPaULdCQFJYWeRbDXOc,ZAAATAAAaACA..dAFAQACC.FAEAJAHBeAGHRCCADDGBOBHDhAAABDHA.MCEB.fDFEhAIAHEEBAEEBSFBAhABALFCACEHD......YHAAhAHAXGGA...hBFA...,2,-36,-1,35
OcCYTHBRWSgQUbdKGAEXLIPZMVfNaeJDF,EAAALAAAZACB.MAEA..fAEAeAHFFBDDCBFAHAFB.RDEBSAHBhAAAQCAAdDFAhABAABCBXDGAIEHAhACAPEDBaEEBOFBBTGGABGGAWHBA..hBHA......hCAA...,1,-9,-10,1
FOMQXRcNYJEZKSfPIdHADULbBeVCGgWTa,LAAAeAAAGADATAEAaAFA...MAHBRBFF....cDBAhAAAYCAAZDGBSFBBhABAfCEEdDGDHFEBhAIAAAIBbEAACHHA...FEEH.QGAAhABA.XGFA.hBDA...,1,2,-9,11
STaOWZLFBJbHQCGgXYVPAUIfMdceNDREK,UAAAMAAAdAEAeADARAGB.KAGA....aBBAZCBELDDABCFAHCGBhADAGEBA..XEAAhAEAPDHDAAIB.IFFAhAGAfEEA.DFGBEGHBOFCD.FFHDhAIAbFDD.....hBAA...,2,-21,-8,13
JIZVgGBCERUKfFaHQDSdeTLAWMcNOXPbY,MAAAOAAA..XACA..bADAJAFAZAGBGBEAEBBBRCEBKDCAhAEAaBBC..HCGBDBIBeEGFhAFAACIB..NDDAIGFAhAIABFHACHHA.FHGE.SGCD..hBAA......hCAA...,1,-15,-23,8
XPFbeRZYATLBIJgHMGUOEdScWCaNKVDQf,TAAALAAA.BAEAJACA.HAFBGAFAEAHBdCAA..SAHBhAAACCCAaCEH.KCCAQDGAhABAXDEDbDGDREAAAFFAMIAAhACAOECB.NIDBDFABFFDD......hAFA......hBHA...,2,-17,-4,13
fIOGSaPbdBJXFTRYMUeZNQVcWECgHKDLA,OAAAaAAA.dAEAXACDRAGB..MBBBeAEAZCCAQBGAhAEA.VCEBEDGBHEBAhAGALEHBAAIBGGCBhBAAbFAAFFGBUGGA..WBBDCFFCDDIB....hBDA......hBEA...,2,-5,-1,4
TVaIgMLCNbGYdWUZPSfEKBXeJARDFHcQO,RAAAHAAAQADCTAEA..aAGAMAFA.LBGBbBGD.dDDAZCAAhAAASCCDECEBXEAAhACAAAAAFCFBOEEB.hBIAgFGACEHAYFFAWHFA.fGCAhADABHHADICA....hAEA...,2,-10,4,14
eBFaDJSbgNHRcGIKATPZQWCVXEUOdfYLM,ZAAAQAAACADB.EACAdAFALAFAeAHBFCAAaBDD..DCEBbCEDHCGBhABA.RFBA.GCGAhAAAADDB.TGAA.PDCBhAGAXFEBfGDAMFIBSGGBhACAgGGANIAB....hAHA...,2,-15,2,17
TaQGPYIdcOVgDEFLHRKCUZefbWXBMSNAJ,aAAAGAAA...IADAdADAOAFADAFALBFAHBEBRCGFCBBDeDBBhBAA..bCDCBDDDhBDAMDHBABGBQFFChBIA..cECC.EEEA.KGBA.ZGFAhAAAWEHHNIAB....hCAA...,2,-21,-3,18
TRaANEecUFXOJPWHDKSCfVLGQMdgBIYZb,EAAAeAAAFACDOADC..JAEAHAGB.SCCACAHBLCEAGCEAhAAAdEBABDDDZEGBRFAAACIB.hAAANIAB.UEFA..WFHHhABAKEHB..QGCA...IHHAhBEA...hAFA...,2,-26,-8,18
eCJPBUMZOgFKLDAadSXbEYTVIRQGNcHfW,dAAAXAAAEADA....TAFARADAGAGAHCACeCDBCAHBBCFDZDAAFCFHhAAALCHBAAIB.bDEChACAIFFA.QGAAhABAfECAPEHDMFFBKGGADIDA..hADA......hBAA...,2,-13,-1,12
cOdSgLafBDPHMbVXFNUZWRKJeAEYQIGTC,EAAAQAAAGACACAEAdADA.LAFABAGAHCEAMCFA..bEABFDBAhAAAZEEARDFAeEDF.AAGATFGAhBCASAHHaFFHDIDAhBDAXDGA.UGCA.KGGD...hCAA......hDAA...,1,-1,-6,5
KMLQdHNgGERBUCbOFcafXZDTAIYVJWeSP,VAAAeAAAKADA.LAFBHADBGAGABAHAUCCAODAA.aDEDZCGBhAAAAAFA...JFCASDGDhAAAMDIB.dFBAEGGBhABACFHAFGGH..fHABDIAA...hADA......hAIA...,1,-11,-24,13
OFQXWDeIPCRfKUbdTJAMBHZLENGVcgYSa,HAAAEAAAGACAVAEA......gCAAaAEAQBEChAAADACAeAHHCAHARCGBKCBDdDDAADGBZEEBhAHALECD.cDGDhAAASGFH..XFDAIHHAhBCAfGGA.hCAA...,1,-1,-17,16
eZCBTXNbHVEMKGfgdaULAPOSQDcIJFRWY,SAAAQAAADADA..IADARAEAeAHHZCBEBAFA.TBGAhAAAXCFDHCCAEEEBGDFAhABAdFHALHAAhAAAAAHAODHFFGFDCECDbFAC.MEEBfFDEaHGE.hAFA......hBIA...,2,-6,-1,5
JYGBKIULScPOHaQNXWMfgECdTDbRFZeAV,VAAAGAAA.KADALADB..SAFBOAFAHBFAaAHBQCDAhAAAXDCCMDFBhAAAECHFdDFATDGARFGBeDADhACAAFBBBFHA.IHHAPDCBNIBBfGFAhBFA.DIBA..hBIA...,2,-14,2,16
GZcRFaTdHQXBSeKNMIOUgYLDAVEJPbWfC,EAAAJAAA.....bACACADBZAEB.RAGB.aAGAHCCBBBGA..eCFHhAIAMCCBUFGALDABhAAAACCB.PCHD.GDDAhADAFHEC.dFGA.QGBA.SGEHhAEA..hBGA...,1,-6,-33,27
AaRdXNKYCZDFQHGBEWIbcTgJLSfUeMPOV,RAAAdAAAKADCZABB.QADAHAFAECCA...IAGATCEALCHBhAAASAHHeDGFMCGBhBAAOEEBADDA.aGHBXEEDhBFACHAA.FDHB.BFDC.WFHH.hABA......hAHA...,1,-12,-15,3
TDLGQFEMUcZHNWJBOACIefYSPdVbKRaXg,eAAASAAAdAEAKAGARACF....aAEATCCAGAGA.FBEDECFAMDGBhAAAZDFEHEBA.JFGBhAAAAAIBfEEAhABA.PEHDbGAADFIB.......hCAA......hCBA...,1,-10,-22,12
gePFNSdGbOcHLTaDMYQKZIAEUBRCJVWXf,EAAARAAACADB...JACB..XAEDeAEAFAHDdAGBGCEA.ODDHhAAAHBGBaCCB.MDDBhAAAQEAAZEDBAEIBBFFAhABAfDHA.gGCASFHDbGFAhAEA......hAFA...,1,-17,-20,3
DeKbJYfFgRUCGHAOLZQIXNPEMVWcSBadT,ZAAAQAAA..XADBEACAMAFAVAFASBDABCAAdDDAhABAeBFHKCFD.JBHBFCHDRDDBGEBAhAAAHFFAACCBLHFAhACAIFGA..WEHH.aGEDDGEB...hBEA......hBHA...,2,-14,-5,9
aSOMfFLVXPGQcbegDIACZYWTdHKRBNJUE,ZAAATAAAHAEA.RCAABAHBUACA..EAEAaCECMAHBLCGB..hABAXCDAGEABbEEBhACAeCGD.DAIBACIBCGAAdFFAKGGAhADASEED.FGBA.....hAEA......hAGA...,1,-6,-13,7
CbUQJIaGNLTFXYADVgPReZKcHBEfSdWOM,DAAAVAAARABAZAEB..HADBBAGAEAFA.dBHAMAIBCCFA..UDAAQDCChAEA..aDDChAAAGCGATEFAXFEAhBAAAEHAeFHFKHCA..SFHHWFAA.hADAbGCC.....hAFA...,2,-21,-10,11
dOPXWEFfLCATaNbZBgJUScYeIQVDKRHMG,aAAAZAAABADB.UAFASACH.eAEAQCAAKAHBHCDAhAEAdBHAXCGDECDFLDFBhABAABBBTFAA.bEFChAFAgFBA.JEHBIGGADEEBMIAAhACAOFCDFHEA...hAIA...,1,-1,-15,14
YUOLGJeVWHgSfZXaBQEdbPRITcADCMFNK,MAAAKAAAOACAGACB.eAFEHAFA.SBCHZCCAaCFABDGDECEBdCHAhAAARFFA...TEFAhAHAABBBCEED.FFCANIAB.LHDAhAIA.JFHB........hCAA......hCBA...,2,-23,-9,14
LQCYDfBMWIGHVEaZUgTXeOcRdPAbJKSNF,KAAAFAAALADAQACCDAHBBAEB.MAGBGCCA.HCFAEAHBZCDBhAAATEAA.eEFAhAEARCGFADDBSEHHhAIACFED.fFEAIGGA.aGFD....hCAA......hCBA...,2,-23,-17,6
JGBZSIAbQTYcXVKfgaENdRPOUMDWHCLFe,TAAAXAAA.KADAaACA..dAFARAEFOAGDMAHB..HCDALCCBhAAAeCHHGDAAhAAAZEDBAAIBbFFAQFEAhABA.cDCCfDBAEGGENIABDIFAFDGHSGAAhAGA...hADA...,2,-2,2,4
aTbAPORfDVFdLGeJWKIBcHUgYZNEMXSCQ,RAAADAAAdADAeABAKAFA.BAEAHCDC..UAGAZCGBEEEB..MCCACAHB.hAAAaDDAACCB...ODFDhBAAFFAAGGCB.IHHAhABAgFGH.XGBA.SEEDhBGA..hBIA...,1,-16,-40,24
gDdaMNPYQRAZBFSUfGHILVXTKOCEJbWce,ZAAASAAAGAEAHAGDLADA.TBGACADBECAA..JDDBbCCAeCHHhABA..dDGDaEGHMEAAhAAA...PEEBhABARGAAAFFBFGHDfFAAXGDD.OFHB.hACAWHAA.DCCA..hAEA...,1,4,-16,20
JOdNCEQXLeUbVgfHDSWRBcZAMYGTFIPKa,GAAATAAA.FADAKACCOAFD..dAFAEAHBLAHB.eBDFhAAAbCDD.VDFBHCGBSEDHhBFARDBFZFDEAAABMFIBhACAIGHA.aHBACHGA.......hAIA......hBCA...,1,-4,-14,10
KQLWPVBYHDNaCZgOdJURbGESeXTMAfIFc,FAAAQAAALADA..VACAHAGBaAFAZCCA.dDGDRBFB.EEAAeCHHhAAAMEEBAAIB...fECAhAEAKDDABFDADFFBCFFAOFHBhAFAUGGASHCA....hCAA......hCHA...,1,-9,-16,7
WAGaIDNfYXedTKOSQFbMBZULVgREPHJcC,aAAADAAA......fACAeACHdAEATAGASADHQCFDhAGAMAFAZBEBLDDBhAIARBGBHDFBCDDCABBBGGEBhBAAIGHAXEBBOBBH.BFFC...hBAA......hBIA...,1,-2,-24,22
NQfETgBHKFbWRPAGISXJMdcLaOeYDUVZC,GAAAXAAAdADALADAeAFADBIBZAGB.QCDAECEABCGAHDBBhAAAFDCHREAB.AAFA..SDDGhACAMBIBaEFDOEHBhAAAVEFACGHA.TGCA.......hBAA......hBCA...,2,-14,1,15
APVNeZLJgHdWEGUKCaOTFMcRbQBfYSIDX,VAAAeAAAZADB.LAGBHADBEAFAGCEACAHA.aCCBFCFD.RDAAQEGAhAAABBFBSCHHhAAAXFAAAAIBJFHBdHDBKGFBhABA.MDBBfEEE.DGGB...hBDA......hCAA...,1,1,-12,13
KIBgdTYaMeQNFOAcWLSRDGECbJHVfXZPU,LAAARAAAEADE.CAEAHAFB..XAFBZCAAKAHBBCEDdBHAaCCAeDFAhABAQDDBFEAAACCA.hACASDFHDEEB.hAEAbEGDfEHA.IFFATFCAMIAAhAAAOHAA...hABA...,1,-14,-17,3
AVcTGKfZFUEDNCQXPRedSHMYLaIOBgbWJ,TAAAGAAAZADA.EAGECACB..QAEARCDAeCGHHEACMAHBaDHDBCCAhAAA...bDEBAAABKFEAhACAFDHDDAIBNIAB.dEAASGHBhAEALECBOEGH.WEED.hAFA......hAIA...,2,-4,-4,0
TeEAKDaBZPHOCNUdJWSXQLMIFYgcbVRGf,aAAAZAAAHAEA.CAHBdCAASACHLCEAMAEAFCCH...gAGAhBAAVEEA.RBDFGDEAhBBAeEHHAADABGAAOCHDhBFAUGCAXGDD.QGGA.hABA......hACA...,1,0,-13,13
XWeSFdgOcZJbHDAQEMfaRIBTNPVGCUYLK,EAAAaAAABADA..TACA..PAFAGAEA.CAGALCHBhAAAXBBC.eCCBdCEAOBHDhADAZEABHEDBACGAMDDBhBAARFFFIHHAUFFAKFBBSHDGFGDD..hAEA......hAGA...,1,1,-19,20
PKAUHILFcZGCQaBXDVbSTOJRMEgefWNdY,HAAALAAAZADBGAFAaADDBAFADAIB.SCAAOAGD.RDEB.ECAAhABAeDHB..fCEAhACAdFBAKGGAAACA.FDFDCHAD.hAAAQFAA.bEGDMIDANAIA..YDDFhAFA...hAHA...,2,-10,-8,2
NHaLbJMcRPeIXAEKVfdOCGYFgDWZTBQUS,EAAAKAAAdACAGACAFAEA.DAEAZAGBBAGA.UCFAHBDB.LEFAhAAA.MFCBREBBeDHHABIB.hCAAOEDCCGEA.gGGAhAAATGGA.SHDA...hCBA......hCFA...,1,-17,-27,10
PORVLQGfFabWgTBNZcCAJYdEKMeUHXDIS,dAAAEAAAKACAeADA.HAGBDAEA...SCAARAFALCCAGCEAhACAaCGD.bDAA..TECAhAAAZEGBAAIBMFIBUFFAXGDDhAIAOGBA.........hADA......hAEA...,1,-1,-24,23
XICSBAZbWPHefLVEOdQYFaDGcNgUTRKJM,ZAAA..bAAAHAEAeAEALAHB.ECAAdBHAQCDDhABAaCAAGCEANCGA.TEAA.hACARECFMEHBCEAAAEEB.fGFAhAAAOEHBDFFB.gGAA.KHCAhADA......hAEA...,2,-8,-1,7
gITcAdMaXRJKGEWULVFCBNObHPQSYDfZe,aAAARAAAGADA.EAFALADA.CAHAOBBBHBGBQDAAhAAA.DAIBeCDATEFAhABAAAEAdCHAMDDBKDCDVEEAhAHABFADbFDDSFHHfFHAZGDA...hBAA......hCAA...,2,-19,8,27
FfOCEGYQbgUZWSBPVLJTDMNaHKRdIAcXe,eAAAOAAAEADAGADA.QAFAUAGAZBCEBDDALBHBTDFAhAAAMBBBHFDARDBFADFAFEFBhAFACDHB....gGBBhABASFHBPFHBDGGBaHDA....hAIA......hBAA...,1,-7,-9,2
bBAUVdHNYXGIFJOKDETScgCPaWMRZQLfe,dAAAHAAA.XADBGADAFAFAKAFA.EBHFTCCA..SCAAhACACAHBaCAH.RCFBZDAELCFAhAAAeDHHAEFBVEEAIFBAhADADEIBgGCAMIAAQGGBBGHD.hACA......hCCA...,1,3,-7,10
LSEefIZXYbWAQMFBaGOHNTCKgPRDcUJdV,MAAAaAAAHACB.CAEA.KADA.RAFFDAIBUAGA.dDEALBBB.ECHBhAFAeBBDZDCB.bDFDAEEABEFAhAHAGEAA.ODHDhAEATFGAgFCB.PHECJHEA..hBAA......hBGA...,2,-25,1,26
NRKPYSaEcCJQXDHIbMTFfeAGOLVUWBZdg,GAAALAAAUADAZADBdAGARAFA.KCAA..SCFAECFB.CDDA.hAAAQEECHDBBbEFA.hACAMAIB.TFBAhABAeFEBACIBODHBBGAAgGGBYFHB..hAGA......hAIA...,1,-10,-11,1
YCJRIMNPDZeAWVHcdBGXTSbOKQLEFafUg,HAAAdAAAGADATAEAOAFALAGB.ECABaBFDUCCA.CDFDREFAMBIBhACA.DCCBAAIBVGCAhAAAXDADKEAD.FDGDfGHAhACAJFEB..IGGA.NDDA..hADA......hAEA...,1,0,-18,18
WIMULRGObVBQPNDTSZJdcXgEaKFfHYCeA,MAAARAAAGADA.OAFABADAQAFA.DAIBZBFFdBBAXDAAhAAAECEBFDCDHDGBhAFAeCHBABIBUGDALFDAhABA.PFHBSGGA.....hADA......hCAA...,2,-17,-15,2
KJDFPMeTcQBUIAHbXZWVNOYSGERdCfgaL,HAAAZAAA.VAEAOACAGCABRAFAdCCD..CAHB.aCEDLCHB.hABADACAMCHBeDEATFFAhAGAQECDBGDAACIBbFFChAAA....NEIA.SHEA..hCAA......hCDA...,1,-2,-27,25
TZBXHNUSgDKJMRGWcLdeIYaEAVOfbPCFQ,OAAA..bAAAFADDZADBHAFAUAGADBBBKCAARCDAGCGA.LFAAhAFAeBFDaDGDAAHA.VFEBhAAACEFDBGGD.SCCDhBAAMDIBdGBAEHGA.......hCAA......hCIA...,2,-18,-10,8
NHgEeWTOXRVFIcLJbGSCKaBfYAMdPDQZU,dAAAQAAAZABBHADAEACAeAFE..TAEARCEAFDCDLCHBhAIAGAGAKCDAaEECBDCD.AAIBMDGBhAAADGEA.UGAAWGEAhBAAXFED.IHHA...hCDA......hCFA...,2,-13,-5,8
JIFAbKeCZGEgXDBNOTLaWQHSRUdcfPVYM,eAAAGAAAEADADADABAFAOAEELAHB.QCCAHCDARCGFdFCAhAAA..fBGAhAAAPEFBMEIBFDFHAEHACAHB.ZFCAhABANICB.aGGA.SHFA....hCAA......hCBA...,1,-8,-11,3
XDaUNPgFIRKbGHTWeQELVBMCOZYAcSdfJ,dAAAXAAAaADA.UADA....gAFHRAFAGCGAHDBAhAAAeAHHEBDBLDFD.hACAMFIBZDDAACCBfGAAhABADDIBFEBBbEGD.TFDA.....hAGA......hAIA...,1,-9,-10,1
cdHaQDFIZRSUNgbXEAeTLBMVPKYOJCGfW,eAAATAAAMAEA.KAHBOACA.GAFA..fBCAhAAAdBHAHCCAaDBHQBEAhABAFEEBRFGBSEHBhAAAgCGBEGFBADDALEBABHAA.PEGBhBEA.CFEADFIB...hAHA...,2,-4,-2,2
bPcgTfZGJQXVOAYaMUNSKWRFLEdeCBIHD,aAAAMAAA.UAEAKADARAFFLAHB.dBBAeAHHBBGBHCCA.bDADhADA..PDCC.hAFA.TEEAGDFAQEGChAHAOEBBAEHASFDBEECBDGIB.fFHAhBAA..hBDA...,1,-1,-29,28
CNfWRTZGDaUbAgQFeKIdYcBXELPVSJOMH,QAAAeAAAdAEABAGAEACALAFA.SBDHMAIBHBCBhAAACCFA.fCFAhABARCGFGEEAaDCCACHBKEBA.IEGAhAGAXFCB.PHACOEEBWEHHTGGAhBEADGAA......hCAA...,1,7,-23,30
ZWEJIFMagAVRXDCbGOKQNcTdPHBSYefLU,RAAACAAAGACAQADC..TAEAHAFBSAHBeAGHLCABhAAAZCCAEDGAFCHDMDFBAAAADEEBKEHBhAFAdFHABEDAUGFAIHBAhBHAaEGHXGAA.......hCAA......hDAA...,2,-7,-3,4
ZaeCUSfLIgGFVDdNBcHQRbYWEXOTJPAMK,ZAAAeAAASACELAEAGBCADAFA.dCEABAHAHCGBRBEA.bFABECCBhABA..OFFBJCHBADGB.hBFAaGCAUFEA..fGHAhAAAFGGA........hABA......hAFA...,2,-31,-3,28
egfCHOEPBNKYabTURVcQXSZDWdALGIFJM,GAAAFAAAeACHCADAHAEB..EAEABAGAKAGA.aAHDUCEA.RCGB.QDCAhAAAZEAAdFFAACIB.LDGBhACA.MDABhADAfHGFOEEDPGACNIAB....hAGA......hBAA...,1,-11,-22,11
gPEGCBcNLIOfFVdeaARJXbWHMQDUKTYZS,RAAAXAAAHADBMAFADADA.KBFCZADE..SBHHEAHBGCDABCCDhAAALCFBODABFCHHeDEFhABAAAAAJFGBQFFAhADA..YFDFCDGDIHCA...hAIA......hCAA...,1,-5,-20,15
YfRGXCEJSeBcHbTAVIWgdQaPFKMDLUZON,VAAA..gAAAdADA.aADAKAFAMAGBLAHBZBDFOAHBhAAA..fCEAhAAARDCBGEGAEGEBeCFHBCCChABAHEGBACFB.QFAADCIBNIABCFFC.SDDDhAFA.cGFChCAA...,2,-19,5,24
RQEaKXfTNVgcLBdIWHDOSPJMeUCAFYbZG,FAAAZAAARAEAEADAKBHB....TAFA..gCAALAHBdCCAhADAHCECSCFDhBAAMACAeDDBAEEBGEGAhCAAQFFAaFFBfGDANECABEHBDGIB....hCBA......hCEA...,2,-13,-7,6
UeAXdWCgRLBcSHQKbIJYENTMDfVOPGFaZ,dAAACAAARACA.LADABAFB.HAGBKAHB.JCBB..ECAAMCFB.DDDBOCDChAAAGEDAZCGFAAEA..hACA..XGFAhACA..gDAASDHHbEEB.IFCAhADA...TGGAhAHA.,1,-14,-40,26
JTCQKGbZNVfELHPFYAXIgUWdBDeRMcaOS,XAAAUAAAdADADAFARADA....aAGASAGACBGA.GBEAhBAAZCDAfCHAhAAAHCGBFDBAACIBIDAABFGDeEEDhBCAMEEB.OEAETGCAbFEDEGHF...hABA......hADA...,2,-21,-9,12
WagOcLKeIUBAHYVSNFJGbfRCXETQDZMdP,HAAASAAAFADAGAFARACF.EAHBQAECZCAAdDHA.aAGAOCEBhAAALCGBeFEFBDEAhAAAACCA.VGDAJGFE.CEDDDCIBhABAMIAA..gGGB.KHBA..hBHA......hCAA...,1,-1,-9,8
BCgWGLHDUdVTfFAEcPbXQMZeNJSKOaYIR,EAAA..bAAAMADAeAEA..SAFAOAHDaCAARBCACBHA.GCEBhAAAHCEAdEAA.TECAhAAAABCAXEECZEGBKFFDBEHAhAIALHBADGGAfHEB...hABA......hACA...,2,-18,2,20
OLGgJNdeUISCBQYDfaPWTRbAcEVKHXFMZ,EAAAHAAAFACDZADB.GAFA.JCAFeAEAUEFBCAHAQCDAhAAA.DCGAaAHF.TFBAhAAAAAEAKDFCMDIBLFDBhACAdFFABHEDfGGEWFGH......hADA......hBFA...,2,-26,-10,16
DUZfOTQPAEWGCIdgNcRbHeMYBKSaFVXJL,EAAAGAAAdADA...NADA.RAFAHCBA.eCFAMAEAKDHBaAGE.FBFHXEEAhAAALCHBZFAATEBAhAAAABCACFHD..IHHAhAFAbEDDBDGA.SFFBDIAA.fHGFhACA...hAGA...,2,-14,-7,7
aUDOeSKPcJgTXYNLZVdIFbBCMERAHfQGW,HAAAGAAAaACAOADAeAEH.KAGA..PAGBJCDA...TDCAhAAAXCGBLAHBhCAAdEEAFEBDbEFAMDDBACCAQFDDhDAADDIB.SGGBgGEA..hAAA......hACA...,1,13,-28,41
QYKLRAfbNTXGMdHaDSUOgZPIVcFWeECBJ,...bAAATAAA.GACAHAEAaAGASAEAOCABZCCAIAHAhAAAFCGAEDGBBCADQECAhAAALCFAAEIBXEADhABAdEAADEEAgEFAcFFA.eEHH.hACACGCAYHCG.hAEA...,1,0,-2,2
fKCYgJGDIcObVPXFSHUTaBeLARMNZdQEW,RAAAZAAAEADEKADC..CAFB.JAFBGAGA.DCCAOAHB..VCEBhAAAFCAAHDDA.aCHDeDDDhABA.AAIBdFGAQFFAhABA..WFHHfECE..hACA......hAIA...,1,-23,-33,10
YFAJWaVCEXBSOQecPZGDUKHMbdgfTLINR,aAAAEAAABACA..QADAeADHZAEBGAGAKAFAHCCAdEEATCGAhADALFHBREEA.AAIBVGBAhAAASAHB.OBBBhBAADCCBbEFDfFHA.IGCAhCAA.NIEB....hBGA...,1,3,-10,13
ZOfVBMIgTGKDEbRQXCdcUYFWaSAPLJHeN,LAAAHAAAeACEZADBOAFABAFAMAHB..TBFAGCAAECCAhAAARCFBQFCAhABAdDEAUEGAFGFHaEEDABIB...PFHBhACA...NAIA.IHDADGGBCCCC..hCAA......hCCA...,1,1,-14,15
BaHADEXcebQKZISTPNFCYJfWdLRGgMOUV,EAAAeAAAKACAZADB...TAFAFAEACAHA...JBHBdCCAGCEAMCFAUDFAhAAAaCCB..HGDAhAAAADIBDEEBXGGB.hAHA.QGGASDBD.PHACfHEBhCAA....hCBA...,2,-37,5,42
ZaJFXHcIALfbCYgUMEQDdVNSGePRWTKBO,LAAACAAAUACA.EAEAdAFA..SAGAeAHBRCGB.KCAAZCBAaCCAFDFHhAAAHCEB.ACGA..bDGBhABAMEBB.QGGAhAIADDDBGEAA.TGFA.....hBCA......hBEA...,1,1,-26,27
ILZbJHFKQUgCGSWVMcdRXNYOfaeAPBTDE,TAAAEAAAZACBHAEA.QCEBCACBGADASAFAMAIB.hAAARCFA.XCGDOCCBeEFAhAAAAAGADCBBbEECKFAAgFEGhAFAcFGD.NIABaHGE.BGCA..hAGA......hAIA...,2,-5,1,6
ZYTGWJdfNMcbIDBeHKRgFUALQVSCEOXaP,LAAAQAAACAEA.EACAOAFD..aAEDZBGBGAGAdCAAMCCBhABAbCDCBEBAHDDBRFGBFEEAAAHA.hACAXFGA.TGAAhAAAfGFE.NCIA.DHFA....hAGA......hAIA...,2,-11,-9,2
BQXYdFOVKLHSaeRgcAUMJfbPEZGDTCINW,MAAAJAAA.....bABAEADE.GAFATAFACAHA...ICCAhAFABCCAQECAhAFA.dDHAOAHDhAHALFEBHCEAeHAAREEAAEHAfFHADGGA.hAHA......hBAA...,1,-11,-24,13
TSUKGWYXEPQgMZCcaRFdDVAHNebOJLIBf,HAAAeAAAOADCLADBBAGBTAFA.KBHBGCCA.XBGAhAAAECABQDEAhAAAZEFAaCFCRFABdCCC.AAHAbDGDfGEAhABASFAA.YFCBgGGBhAFAMIEA.FGECDEGA..hAIA...,1,17,-12,29
KFRZbWUHIdgCaEYePTONAcDQLSBJGfXVM,QAAALAAABAEAGACB..XAFDMAFARBFAZDAAUCAAHDGBhAAAdBHACCDAECDB.eEFDhADATDEAADIBSFDHhBIA..fEGA.FFHDIHHAhCAAaGDAOHAA.DIEAhABA...,1,13,-29,42
fRZABSNPCXGJKUYDcgHTbLMaQIFdVOEWe,SAAACAAAGACAKAEADADA.HAECLAGBaAHD.QCAChAAAdCCAECFB.eCEFRDGFAAAABDBChAHAXDGAUGGB..gEAAhACAbECA.MFFB.FGCA...hBDA......hCAA...,2,-14,-3,11
feGLJKUbDTSMcXgBQZHOYIRPNWVAEFaCd,EAAAaAAA.dADAGACALAFAKAEA.DBCB..MAHB..XCEAhAAAQCEAHDBCOBBHhAEARDGFPFCBVEGBAAGAfFEAhBDAeEEBbGAA.SFHH..hCAA......hCBA...,2,-12,-4,8
gQDHRBeMCZSGIcaLXfFAWdVPOYTENbKJU,dAAAOAAAEADA.KADAUAGA..QAFCHBEBRCAAeDGFZBBAGCGAhAHAaDHD.LDFDhAIAFECAAFFB.PDDBTGBAbGFAhBAADGHB..MIBA.......hACA......hADA...,2,-13,1,14
UbZOSXJMBIaRcdWfHGeQNDYKTCLPFAEgV,EAAAUAAAZACBOADA..XAEAMAHBBBDARBGFdCBCHCDCGDEAhAAAeCHHQECAhAFADDBBKEEDLGCAAAHA..hAIAgGGASGBDaDHDfGGAhBAANIBB......hBCA...,1,5,-22,27
gRWDaCAGIEBXeLdNZfKcJPVUbYHTSOQFM,EAAAeAAAdADAZADB.KAFAJAFA..UCFAHBEB.OBCHMAIBRDBBaCGAGFDBhAAA..XDGDhAAALHAA.fGHAhABAPEEB..YDBF.TGGAhAIA.....hAHA...,1,-10,-19,9
CLAKcOTBQJVFUIHREWPXMdfDaSYGZgNeb,OAAATAAA.BADAQACCFAFA.HAEBEBBB...XAGAhAAAdCEAaAHDGDCAZDDAeCHBhAEALEGBAAGAKFFDcGDChCAAJFBF.IGHA..PHDC.hDAA......hDBA...,2,-20,-3,17
dTZNWYMSOeEFfHCDgQaKLIXRBUAcVJbGP,VAAAGAAA.dADAZADB....NAFAMAGBeAFAEBHF.HCEBDAHBaBHDhAAALDAB.REGBACGBhAAAbDBD..PDCBhADATEDASGGDFEHBCDDCQGEA.KGHBhACA......hAIA...,1,3,-12,15
QRHcJODCWPbUNYdIeBaKEFALSZXTgMVfG,ZAAATAAAMACA.GAEBHACBOAEA.CAHA.bCCAUCFA.dDEChAAAeCGFaCAC.EDHFABEALDHBhACAXECAfFFEhABARGFEDICA.PFHD.IHAAhAHA......hAIA...,2,-13,-4,9
LHNTbEaAVKUWBJcIgdfXCeDFPZRQOYGSM,KAAABAAA.JACA..IADAdAFA.CAFA.eAHB.FBCHRAGFQCAAhAAAGCGA.MCDBhACAHDEB.TGDAECFBACIBUEFBhAFA..gECFDEEBOFHDSGGAhAAANIABaGGH...hAIA...,2,-22,-20,2
OJDFaXZeTGdfBULPWQHSKINYRcCEbVAgM,MAAADAAAFACDZABEGAEAdAFABAHALAGB..QCCAhAHAHDDBKDHB..IEAAhAEARCFAEEFBAEHAOFBAaBBH.eFGHhBAATFGA.fGBAWFHH.SGEHhAIA...hBFA...,2,-23,-9,14
KYXeRgZQFUJPIDLVOSTfbNEGaHMCWBAcd,dAAAXAAARADAZABB.FADAUAGA....IAGALDDASAHHhAAA.bBCDEDHBhAEA.HFCA.MFHBhBAABCFAACFBKGFBeDFA.QFCADIBA.TFFAhABA.NEIAaHFC.hBIA...,2,-21,-10,11
cZgQfMHaILSCTbNdVGFOUKBXJYRWEDeAP,ZAAAQAAAHAEAaAGALADA.TBGAdCAAGCCB.OCGDhABABAHBXCBAhAAAREAAEEFBAADA.gCEBhAEAMCIBCGCA.bEDDFGHBKFAA.YFFA.eHEAhAFA.....hACA...,2,-5,7,12
QfMNTLAdEZRGIgKOJDBeacSCWHFUbPVYX,EAAARAAAGADAKACA.DAFAeAEE..aAGECAHBHBDCFCCH.UDEB..hAAAbCFAVFGB..QEFAhAAAMCCBLHCAhCAAACGAZDAFOFEBBDHAWDDDPHFA...hCBA......hCHA...,2,-12,-5,7
OLcRHFEbNKZAJUfdeQXaMBWgPGIVSYCDT,UAAAeAAAQADAMADABAGA...gAGAGBDA.SCCBhAAADAIBTCGALDFAhABAHDBBEEGBbEDDZGCEAAGAdFBAhBFAaGGC.IFFA.CGHAOHFC.hBAA......hBCA...,2,-18,11,29
MHVJBTeALOagEbZcIDRPNYUXdQfCSFGWK,aAAAEAAAZACB..DADARAEA.....PAFCUCEBdAHA.QEFBhAAASBBAGFABhAFAMBEBHCFABCBCADHALEFAhAIAOEHD.bFCB.IGGA.YHEAhBAACHHD...hBCA...,1,-16,-17,1
BPQNEaJgdfTUObVGZSceIDYXCAFMLHWRK,MAAAHAAARADFBADAQAFC.EBHFaAEDdCADUAGAODDBGBBAhBAAZEFAeFDHDDEA.CGGAAAHALDHBhBBAKHEA.PEEAhBGA...gGGG...hAAA......hACA...,2,-22,-4,18
FWQRAUEcDbdTKMNSOVIYCHaLfJBZeXPGg,EAAADAAAdADAKACA...MAFAOAEA..VBFACAHAHBDC.aCCCLBBBhBAABCGA.eDDBhBDAGEEAFDFHRFBBACIB.UGGAhBFA............hBIA......hCAA...,2,-34,-19,15
RbVTaOgWEUIFPXHJMdCDYefAcQNLGSZKB,QAAAGAAAZADARBGF..TACAaAGA.OAEAECDA.FAHDHDEBhAAAdCEADCGBeDCBADDALDHBhAAABEADbGEA..gFAAhACAIFBAXFFBMDIB.fHEBhBFA....hCAA...,2,-22,12,34
NAfPYbWQdHaXTUBSGCEZJIOKLVFgDRecM,...fAAAbAAAdAEAHAGB..aADATCAASAFHGDDAhAAAEAHBZEBBOBCBLFGBhABAFCADRCFAMDIBADDAPECChAAA.QEGABDGDCGAC.KGGDDIAANIAB..hACA......hAGA...,1,5,3,2
WYceTfCUESVQNaBbHJKDdGROLXMAZIgFP,ZAAAFAAA.....PADA..cACDeAGFCBHAUAFA.ECDFhADAQCAA.hAIAaCDDHDFADCFBRDGBLFBAhBAAADIB.gFFATGFA.SBHBhBFABFFC.KHDA..hCAA...,1,-21,-23,2
QPbIcSACXRaKUJNEFBYGZOTVHdgfMeLDW,RAAAaAAAKADC..UADAEAFA.BAFAZBEE...OAGDHCCBdDGA.MAIBhAAAeBBBLEFDhABAQDDA.IEGAhAIAACCBXGGBFFHDTGDAfFDADBIBWDBDhBAA......hBDA...,1,-11,-29,18
FeCaJRZQfHPEATLSBONMGWgbIcYVdXKDU,TAAALAAA.OADDGACA...bAEAIAFA.VBGBhABAdCFADAEA.eBHHhAAAaCAARDDAZEEAHFCAACABBFDDhACAMEIBgGGAXFFBFHAA.CHGA...hACA......hAHA...,2,-6,-6,0
RDTXQZOfGVYKgMSWHdCLcFNEAeIJPaUBb,eAAAJAAA.UAEARADF.DAHBQAFC.ZCFEGBCA.KCHBhAAAMCCBHEBBdDAALEEAhABAFDDHAAHA.aFGEbEGBTGDAhAIA..fFFA.YHCAhADA...SGHHhBAA,2,-22,-16,6
OTeUYSaFXfJRGMPWgNZKIcCBAHLdbDQEV,HAAAdAAAQADAEADEOAFAeAFA.SBGAaBEEFBHD.XCAAhACARCAAGDCB.MEHBhAAAgDCHZFDA.KDGAhADA.CEFDAFHADEIBUGAA.fFDA.hACA......hCAA...,2,-7,-2,5
QfCeZBPGIYEDRcKdNWHTLVSAFgbaOMXUJ,FAAAaAAA.MADAUADA..QAGAeAFAZCCAGCGAEBCA.RFFBdGAAhAGAHBEB.TDGA.hBAALECBABBBbDBCXGCAhBDACEEDBFGDIHHA.DIBA...hBIA......hCAA...,2,-8,-6,2
OJdSRUfLIHBVYcEMgbPKZNTFaGXQeDCWA,dAAARAAALADBHADABAGB..VAFAEBHFMCCB..bCEDZDAFFCHDhAAAGDDA.eDGBhACACCCCADGBSFAAhABAfGCAIGFA.YFAFgFGAhAFANDIA.aHFC.DIAA..hAIA...,1,4,-20,24
PKQORWdEcXYUFLgZCeMDNGTAaBVfSHJbI,aAAABAAA.SACAHACBJAEA...IAFAQCEA.RCGBEEBAhAHAXAGDFEEHZGFEeCAAhAAAMAIBGCEA.hBAAAACAbDGBOBBHdDDCcGGC...YECFhAIA...hBEA...,1,-7,-8,1
LCUDMZYcfTeRSGJaFOXHQbgIABVEWdPNK,EAAAdAAAKADALADADAFA.ZAGB.....fBCERBEAGCABaBHDhACAXCDDHDECQFFBhADAbEAB.AEIBBHBAhAIAPDHDCHHA.MEGB.TFCA.SHGAhAAA..hAEA...,1,-17,-19,2
EMRKDBZfaVJGbTFICOeNXYcLAPgWSUdQH,...PAAASAAAdAEAHAGBRACFBAEBaBCD.GAFA.bCDDTDEAhAGA.CDHAeEBBhAIAXDGDLFGBAAAAgGGAhAHAQGDAEHBAMAIBDEDB....hBHA......hCAA...,2,-21,1,22
bPQKBFMSHYELcNGOZVaWTDUgfXeJARCdI,RAAAdAAA...IADAbADB.KAFAMAGBHCACEAHBLAHB.hAAAGCFAZCCFaCEDTECAhACADCHBfEGEhABAeEHFAFAACHCA.QFBCSFFDcFFC.NDIA.hAIA......hBFA...,2,-14,-2,12
cQbHgRFLDfXCSaVBUGPJWNOEAZKdeTIYM,dAAAeAAA..TADAMAEAQBCAHAFBRCAALAHBDAIB.CDEAaEDChACABBEA.GBFA.hADAPDHDNEGAAEHAZFAAKEEBIFHAhAFA..cGGAFHBC.SHBAhAAA....hABA...,1,5,-27,32
cOEDMTYRQCGJXbfFWVSZPIBeLaKNdHAgU,UAAAEAAADADAMADA..RAEAGBCA..bAEAFBHD..SBDDhAIAZEEABCBCeECDhAAAaBHDdCEAHGEAACGB.OHAChAHATEFA.CEHBfGHA...hAIA......hBCA...,2,-25,-14,11
GOFfQeIALJWXTcaHRCZNKMPdBSVbgYUED,LAAAXAAA.aADDHADAZAEB.MAFABAGASBFA.VDAAhAAAbCABUCGAGDDAFDDHhABAeBHHAAIB.TFGAhABARFEAKGDD....PHFC.....hADA......hCAA...,2,-15,-1,14
AXMKTYfDaQNBEFLCcbIRZSdVUegPHGOJW,MAAATAAADAEA..aACAQAGA.EBBALAFA.hBAAbBDCRBDAdDDDeCCDHDFBhBBAGCGAODHFAAGAKEEAfEBAhBEAFGDACGGD.IHDA.SGHDhBIA...hAAA...,1,-4,-16,12
TOGFMagSKNWRLZUAVfDXQEecJCPIBHYbd,DAAAEAAA.eABACACA.BAEAHADB.dAFBGAFAaAHD.KAHBRCFB.ZCCAACCB..hAHA.XDGDQFEChAAAJECA.IGBAhBGA..TGGAMDDBSDHB.hBAAWHFA....hCAA...,2,-25,-21,4
JLUZWVbFgReIKaPONBGdXACfMDEcHYTQS,MAAAEAAAHACA.QAFCLAEAZBBAVCDBFBHD.RCEFKDBA..hAFAaAHDOEFDGDFAAEHADFHBhAGATEAA.SDHBhAAAUGCA.WHAA.eHEG...hAIA......hBAA...,2,-26,13,39
XLbcREZBDCOQafYTGdgSKVMWIHePNUAJF,XAAALAAARADFZACBCAFB...QAEA.aAGETBGAhABAdCHAKCEDMCABHDFBeCCBhACAPFEBAAHAFCFH.EDHFOHAAhAAA.fGHAgEEG.SFHHhBIA...hABA...,1,-7,-16,9
QbCMKgeFSXREZPBILWUaVOcdTYfJHGAND,QAAAMAAAKADA.eACAFAFA.RAFA.ZBBABCDALCFAUCFBaDAAODDBhAIA..dEEDTEFAhBAAJEHBHGAA.ACIBDGGBhAAAbGCA....SGHB...hADA......hAGA...,1,-12,-22,10
EWJIdMDSgZfVeBHGQKFAYNLbXCcORUTaP,LAAACAAARACA.aADDEAFE....IAFAdAHAMCAB.SCCAhAAAZAGBeCABHCEBhABAGCEAQEGAhACAACGB.bGCAODGDPCCBDDIBfGGEhBIAKGGD......hCBA...,1,-5,-26,21
KGYSdNfHQTDBZcPARUCgeVFEJLOWbXIMa,RAAACAAA.eADEEACA.LAGB..bAEAMAIBGCAAdCCAHECCDAIBZCCAhAAAAAAAUFGAFCGH.OEBHhBEAXECAKGCASGEHhCAAQFFABFHA.gGAAhACA......hAFA...,1,-2,-14,12
BeFSJbOZNCXQgWdMKHfRUDGIYTLEacAVP,BAAAeAAAFADDSACA..bAEDZAEBCAGA.QAGA.hAAAdCAAHCGBRCCBGCFAhAAATEEAEEHFAAIBPCCBhABAOECHNHDBXGAA.MFIB.fGGAhAGADGIB....hCAA...,1,-3,-15,12
gYcZTALQWCSBROUXPNKFaeJIfHGbDdEMV,LAAAQAAASADHRACAUAFA...XAFAKAHBeCDFICAAhABAHDABGDGAhAAAdCFAECCBMEEB.gGEHhADAZDGBAAFABEDA.OFFH.NEIA...hACA......hAIA...,2,-19,2,21
ARXfaKDgJeLNPZWYEGFdTOUBMIbQVScHC,RAAAaAAADADA..eACHLAGBZADB..EAFAdBEAOAHDMAIBQCCAhAAASCEHHDFBhBAAABGBKEFA.JFHB..PFEBhABAGGCB..TGGABHBD.....hBBA......hBHA...,2,-23,-8,15
OKZbHWFRBgMTfILaGNEPJdAceVYQUCDSX,eAAAQAAADAEA.OACCZAEEHBCB.RCEFMAIBTAGA.LCDAhAAAGCGAEGCAdDHAAAEA.hAAAVECACGFA.KFGD.bGAChAGABHHA..fGEA.IHHAhAIA....hCAA...,2,-14,-11,3
SRDaeGTJCfKcNgbBMPQHdWXFAIYUVLZEO,UAAAZAAAEADERADA..DAGAeAFE.GBEBCBGA.KCAA...NDDA.bCDChADABEEA..MBIBhAEAHEGBdEEAFGEB.ADIB.IFCAhBAA.LFHB.aGEE..hBCA......hCFA...,2,-32,-18,14
ODcYHWLZfPMFJeVUTQNXECAIdgRaBGbSK,dAAARAAAGADAKADADAFAHAFA.ZCFEMAIBFCCH..eDABUCCA..TEFAhAAAQBFA.hABAEDAAAAHAaEHDBDFDOFAHhADA...YHCALEHB.fFFAhACA.PHCChADANHEB.CHGD,2,-39,-2,37
EKVGODAJTcdfaPgRMNeXBSFCYUHWLZQIb,TAAAdAAAaADA..RAFF.eACEBAHBFAFA.CBDD.HBDBZBFE.QCBAhACA.ECHBGDDAhAAAAEFAJEGB.fCCEhAIA.MDGBSFHHYDHBWFFDLHDAhCAA.IHHAhDAA...,2,-15,-15,0
XAaVHWcJMPUQLSNDTOFBRdZeIYbGfEgCK,HAAAJAAA.MACAQADCLAGBDAFATBDABAHAZCCA..eCCBhAAA.bEEAEBGBKFBAACIBaDFDhBAAVGEA..PEHBhCAANAIA...RFCA........hBFA......hBGA...,1,-2,-25,23
GODYQENIaJgVSfRXHBMLPTbACUdKeWcFZ,dAAAeAAAFADAGADADAGA.EAFA..aBDCVBGB..RBFFHCACMCCBTEFAhAAAABHAKCHB.ZFAAQEDAhACAIGHASDDDhABABEHDLFFB.CHHA.....hBAA......hBCA...,2,-22,2,24
BOgVZdAJLECRXKFSDGYbHefWcTMPIUNaQ,EAAARAAAFADAGACAHAFB.eAEA....fAHETBGAMCBBhAAAICCAaCEDBDGDOCEBhAAAZEFEAAEALDHBhABAKGGADIAA.bFED...cGGCNIDB....hAIA......hCAA...,1,-5,-17,12
dcPHXbDSCAQLUFaYGOgIVWEMKTNZeRfJB,LAAAaAAAGACAOADD..IAEAEAFAMAIBKAGA.ZCEBRCAABBGAhABAdCHAHFGBDCFBACAAQGAAhAGAFDGB.gGDAhAIATFAAeEEB.fEHAhACA.cGGC..hAFA...,2,-24,0,24
ICfYOFbZcHGAMBNgWVSdXTQUREPeDLaKJ,MAAABAAA....NACA.VADA.dAGATADARBBB..ECHFeAFEhAAAaDEA.KBFA..CEEAOEHDhAIAZCFEHDAB.ADABSDDBhADAQGFCDIBALEGB.fFFAhAIA...hBAA...,2,-24,-16,8
eGSKFXfDAabTUYNWPMdLRZIOHEVgQcJBC,aAAATAAA..UADA..NACB.MAGBRAFAZBDFHCGB.EAHBQCFBhAAABBBDeDBAGDCAhAIAFEEBDFBAACCA..bEGDPFGBhAIAdGFC..........hBAA......hBDA...,2,-20,-5,15
WeQCVPRbAfMNKEOgFJdTXaSHDLUGIBZcY,MAAAEAAAFACDdAEA...aAGAHAEA.LAHBGBBAZBFB..hBAAcCECeCHBQEDChBBACCGCREAAADDB.KFGAOEEBhAAAgGFGTFGADEBBBGAD...hBDA......hBEA...,2,-13,-10,3
RSHJILWegUYFVCODEKabfBXdPZMNQTAcG,RAAAHAAALADBeACEUAFAFAFA.OAHFEBFBKBHB..aCCABCCCdDDDZDFBhAAAMDFB..NEHAAEIBGDGAhAAA.SGEAhABA..........hAIA......hCAA...,2,-26,-17,9
BPeROcDFLgSZYMEGdNUCfIJTKVaQXWbHA,eAAARAAADADALAGBZADBEAFA.GBDAdBHACBCA...JDCFKCFB.QEEChAAA..bEGBhAAAHFCBAAIBOFBBFFHBSGGDhABAMFFB........hAIA......hCAA...,1,-16,-25,9
SGWKILaeXVCBdcgHPYUAENDMOTFJfbQRZ,EAAAMAAAFACD..JADBQAEAZAEB.GBGAKAGALBBBhAIA.eCFHCAHBdDDAHDGBhBAAPEAAACHAOEEH.hAAA.bFDASGGAaEHDBGBA.....hAEA......hBGA...,1,-16,-17,1
LYPCGHIOXfBQaVZRJNTMUgcFAWbKESedD,KAAAEAAAdADALACB.CAEA.HAFA.XCBCQAGAZCEEREFATCEAhAAAMFAA...UEAAhAEAFFEHAAHASDGAhAGADCIB.GECBfGHAaFGDNIBB..WFHHhBIA......hCAA...,2,-15,-12,3
CPGFHdQBgZOAEIUbYNXTLfKRcDaMeVSJW,EAAAUAAA....bACAXADA.LAGBRAGBaCCA.eCBAhADASCFHCDEAGEAAHDAAhAAAdEGAQGCAhAEAZEEAAADAIGAANAIA.KDHBMFFBWFDDBEDD..hBAAgGGA.hBCA...,1,-3,-7,4
DNBeYgbLGKCFEVQAZJPUfSXMTcHIaWOdR,ZAAAUAAASACEMADAHAFC..aAEDdBDARAGBBCCDeCEH....hABAbCFDGCFA.FEDBhAGAECHFAAIBJEHBXFGAhAIA..cFDDODCBDIDANIEB.....hBAA......hBCA...,2,-16,-8,8
ZSOeBdRfUTKAHaGEWbQPMXcYVCgJFDNLI,HAAAEAAA.QADCMADA.XAFBVAGBCBCA.FAHDLBEBhAAAZCAAeCEFRDFF.TDFAACBBGECAhAIAbFFA...cFGDhBCAYHDADIEA.SHFEBCDA...hCAA......hDAA...,1,16,-13,29
TfOaVJFIUgGERQCBYWKLbcDdAXMSZHNeP,MAAAHAAAeACE.TAGAaACEFAFA.UCCAECCARCEABBFD.KBHBbEEAhAAA.dFAAABBB.ZFCA.fGGEhAFAODFBVEGBhAIA.....gGDB..hBAA......hCAA...,2,-36,9,45
ABOSHfDVJYPdFCRXEQeWTNbKZUaIMGcgL,SAAAHAAADACAJAEBdADA.RAFA...EAGAeCCB..TCFAhAAAbCEAZEEAaCCB..GFABhAAALCHBAAFAOFHDhABAfDDE.PFECXGEAQGAAhAGAKDBDMIAABGHA.FHEAhBIA...,1,5,-11,16
FWRGYdHNCZDUMTPbSLVaBeQIAOgEJcKfX,EAAAKAAAFACARACA.GAEAHAFBZCCA.DAIBMAHB..TDAASCCBhAAAaDGD.eCHHAAHBOECChAAAJEDB..XFFChAGAdGEACFADUGGA........hADA......hAFA...,1,-6,-26,20
eHXLOgQMWFKSabVPGRNTdDCBJfIUcAZYE,EAAAHAAALADAQADCMAHBKAFC.aAHDVCBARCAA..dCFABCFAhAAAJDHB.UEEAADEA.eCHHhAEAOEEBFFAA..bFCDPHBChAAA...TGFAfFHA.hACA......hBHA...,1,-6,-9,3
SDEadegJQfcUKFMZObBCHYLPRVITANGWX,GAAASAAAEADAeAFAQADA.UAGAMBIBZCCABCDAHDAAhAAALCFBRDFF.TFDAhAAAADHAXFBAdFHAfDCEhACAFEHDCHHA.PGACNEEADIBA.aDAH..hADA......hAGA...,2,-7,1,8
UKXYLPFJHNADBQdSCZcIgaTfMOVEGWebR,QAAAdAAAZABB..IAEAaACE..MAFAEAGAGCEAhAGAeBDARBGBXDAALCGBFDCDhBAAHDDAABIBSEHHhBDACEHATFFAOFDBbGDA.......hCDA......hCEA...,1,1,-11,12
aPdGBNFgDcWXeATYUZbOEIMLCQVHfKSJR,TAAAZAAAEADELAFB..QACCHCAASAHBhABARAEFdAGAGDDAFCHHDCEBXCGAhAAAAEFAUFCAOFFAhACAMEAAfFGAaGGCBHBD.NIABWFHH...hBHA......hCAA...,1,-1,-6,5
TRfYMaWHOSDFUGeEgQJLIZBbdKCNPAVcX,XAAARAAAMADA.HADADAHBGBDA..EAGEQCFChAAALCDAZCGBdCCCCDHAAAAATDAAhADAaFBA.SEEBhAFAeFFAgGBBBFCAbGEAKGHBNDIA.....hAIA......hCAA...,2,-6,-6,0
GXMbEcAOPNWJYTfZSVgHLadKRDeBIQCUF,OAAA..PAAAJADB...TADAZAEBSAGAhAHAHAFBdBHARCCBeBBBQEFAhAFAFCGAGDEBbFDDAAHA..hBAAYFFFfGHAgGGB..hBAA......hCAA...,2,-24,0,24
HQIOBSUNLCbYDWTgEGdePVAXMZfKaFRcJ,ZAAAaAAA.RAEAHCAA.QCEBBADASAEHLAHBCAGADAIBTEFAhABAEBBB.GEAB.hADAeEHHACGAMDDAFHCA.IDHAhAGA.OEEB.bFGB.gGEHhBAA...hACA...,1,3,-26,29
OYPeSXKLDbBaQWGAERZMVHIgTJNcdUCfF,RAAAZAAAHADB..TAEAJAFAdCGAUAGA.FCAAOCCB.eDABhAAAKCEDLDAABDEAaDHD.hABAGDFA.EDHBMFFBhADAIHHA.NIBB.fGDA.hABASGGADFEB.hACA...,1,-16,-19,3
gKPIEUAWbcJaDLHRBNSdXZQOYMGfVCFeT,...bAAAaAAA.HACBRAEABAHBdAEBZAGB.QCEAMCABGCCBhAAACDHAeBBDTDGA.KEFDhABAEEEBACGA.JFBADFIBLFHBhBAAXEADfGFAFGGB....hBFA......hBIA...,1,-4,-9,5
KeRTFZBIQMOgVYNXWAPSfabDGUcdCLEJH,SAAAaAAAGACAdAEBEADA.HAGB.RCEBZEGBQAFA.MAIBhAAAOBBHVCCAXFBAhAIAADAA..bDFDDEEBhBAACDHDLFCB.eFEDBGFCIHHAhABANIBB.....hBFA...,1,1,-8,9
MSeOFRUHBCfKWDPZYEGbJaNXLgIQTVcAd,dAAAeAAARADAHAGBCADA.KCBADAFAZDAAGBDB..aCFHLBHBhAAA.QDDChABATEGAAAIBMEEBFEGHfGBAhAIAPFFB.EGDAbGAA.......hBGA......hCAA...,1,-9,-18,9
TgPJDAaERUWIYMdHKZQOFfLXbNcSGCVBe,RAAAUAAA..IAEAdADAHAFAZAFBQCEDFAHDLCCB..hAAAbCGDSCEDhABAGDBABFADeDABTFEAhAFAgDGADCIBEGHBMFFBfHABXFCA.hAHACGGA......hAIA...,2,-5,-3,2
CTDRVSbaZeEIMGcYAJWQPKOXUgFBdHLNf,QAAAOAAAUAEABACAHAGDLAEA.CBHARCDAbBCD.eCHHhAIAEDCBGDGAABBB.JFAAhAAAKDFBFFEBdFDA.TGGAhBAASGADaEBHMFFBcGED....hAFA......hAGA...,2,-14,-2,12
NWJPCLVBAYFQgDdIKXMcOafGESbeUZHTR,QAAAdAAAKADA.MADAaAFAGBEB..EAGAeCAAHBDARDDA.hACAJBHBLDHBADBAFDDHDDGBhAAAXFFBOEHDbFBChBCA............hBDA......hBFA...,1,-14,-21,7
aURSOcCFbKeDJXYABQfTWPNgGEMVZILdH,QAAATAAA....PACAGACBEAFAZAGBLBHBhAAAHCEBRDAAOCHDFCCAeCEHXFAAhAAAACGAfEGEhAIAgFGBMFFBdGDAaGCDSGGDCGGDDGIB.hCAA......hDAA...,1,8,-4,12
EBJUgMCNPLHQFXDafKdTWObGcIYSeRAVZ,EAAABAAAUADAMACA..CAFA.LAGBHAGBQCBCDAIBKBCAdBEAODEBhAAAGEEA..IEHAhAIAeCBBABGBJDHBgFFBhBCAFDDH.aFDHfGHA..hAAA......hBCA...,1,-10,-26,16
fIaMgUcQVGSdKCJRWeLFZPNAHYXBbEDTO,HAAABAAAEACATAEA.OAGDaAED.MAIBUAGA.QCAAhAAAGCABdDFACCDD.REABeECAhAAAZDEBADHA.bEGDDEHB.IGBAhACA...gGEASGAD.hBEA......hBGA...,1,14,-30,44
XVeALBdGFRJIWZagTcUOKfMHQSEbPYNDC,dAAARAAA.JADAZADB.aAFD....TBGAOAHBMBDBHDAAECBF.hAAA.bDFA..PCEBhACADEEBXFBA.hAGAACCALFFBGDFAFFCBIHHAWDHH.cGDDhABAfHAB.hADASHEG.,2,-16,-1,15
KOFeVSBEMPHYCdXDfLIGANQTgWbUcaRJZ,TAAA..bAAAaACARAEAZCAA..FAFAeAHHBBDD.EBFBHCFBhAAAdCHADCCBLEABGDDAhAAAACEBQFDAhABAUFGA.KFGASGEHMIDACHHA.....hACA......hAEA...,2,-16,-3,13
EYPRQCHeVgFdLGaOTNKXDIAZScBUbfWJM,ZAAABAAAUAEA..bACAJAHB....EAGARCAAHDEAeBHFFCAAGEBAhABAOCEBKEHBDFGBAADA.hAAA.SCFHhACA.fDCAMIDA.QFFAhAGACEDD......hCDA...,1,-24,-26,2
MXGUHIBRYKJQeVbTCfFEWdcaSDNOgZPAL,MAAAGAAAHACCRADAKAGCeAFE...bBFDTCEA.FBHDEBBBdDCAhAAAaCHFDDAB..ODCDhAIAZEEAAEGALGCAhACAXEECBCEAQGGBfFGA.SFHHhBAA.PHDChCAA..,1,7,-14,21
aMSbLXEKACeVYUWcBdGHJTDFQINfZPRgO,eAAAUAAABADAHADATBGAFAFA..QBEDICCAZDEARCGF.hADAaAGA..MCDBbFAAEFFBhAAAAAIB..CEEA.YEHBhABAdFGDDICA...NIDB.......hAFA......hCAA...,1,1,-39,40
RXYJcSWaDTeKMfFCEgGBdZQbVPOILUHAN,RAAAXAAA..JADASADAaAGA.eAFHMBHBFAHBECCAGCDAhAAAZCEB.QDAAhABAVFGB.OCHDhADALEDDHDFBAAAANICBYHDA.DGHB..hAEA......hCAA...,2,-23,1,24
GIPZQMUTWLEacASOHgRCBKFfJbDXYdeVN,HAAARAAAKADC.FADA.JAGBDAGA.dBFA..eBHHGCCAZCAAUECBLBHBhAAA.EEFBACCAOEHDhAAABFHA...bFEDXGEChABA..YGAAIHCAMIAAhACAaHFE.....cGGChAGA.,1,-22,-23,1
PRCYaBAWdTMUGNbecLgFOHDEQVISXJZfK,dAAAMAAAGADA.eAFALAEAFBHDHCACEBBAQCDAhAFA.SAHHhAGAZDEBKEHBRFAAaGEEACGBTDGA.hACAbFDA.ODCBIHHAfFHA.hADA......hAFA...,2,-11,-4,7
ObAPgJMaBFEXcCZKGRfUTNDWILVeHQSYd,JAAAaAAABADA..EADECAFA.GAFA.RCCA.TBGADAIB.LCCAhADAHDGBQFAAhAFAdDGDAAHAMBBBXEEDhAHAZECAKFAAUGGAIHHA.eHBA....hBAA......hBHA...,1,-9,-23,14
RMWdBaFLKIQUZDeGNEcATgXPHbJOfSYCV,TAAAXAAA.HADAOACA..SAFECAFARAGF.dCDDaBDChAAALCGBQDDAhAIAZDAAeEEBEDGBACCBbGFAfGDAhAAA.MAIBBFGDKGGADCIBNIEB...hABA......hADA...,2,-12,-5,7
UASGWYCKbReNZdafVOLgDTMXIEQPFcJBH,GAAACAAARACA.eADAdAFA.aAGDOAHB.LCABTCDAMAIBhAAA.EDCBQCCBhAAA.FDFBBDGAHEGBhACAAADASEFDKGFDNEEA.ZGBA.fFHAhACADCIB.IHFAhBAA..,1,-1,-19,18
SEPVTAGIgHBLadJZRCfQNXceOMKUDYbWF,GAAAHAAAaACAZADARAEF.QCDA..XAGBeAFEMCHBhAAADBIBbCCDSDCDhACA.EEABTDGAACIBBEFAhAEAdEEAfFDAOFHDKGCAUGGAFGFD...hAAA......hCAA...,1,5,-6,11
AfTVaKOcIdBYgLGCPeEXMUWFHNRQSDZbJ,TAAAaAAA..OACDdACABAEALAEAGAFAeAHHEAHBMCEBhAAAFCEAHEDA.RFAAQFGAhAFAZDGBADDBKEAA.IHEAhAGACFDDXFED.NEIADIAA.....hBAA......hBBA...,1,-9,-10,1
bcTOfIJNXWBZDUPAGQFaKMVYdHEgLReSC,GAAAaAAA.MADAdADAHAFAEAGA.RCDAeBBBCBFD..TCDAOCGDhAFAJBHBXFEAZEBBDDGBAAABhACAKFHB...YDBFhAHALFEA.SFHH...hAIA......hBAA...,1,-13,-15,2
WdVNbgTFEROcMBeGCSZUIXLfHaQDAKPJY,KAAAJAAA.dACA....VAEA..bADDFBHDRAFA...MCCBeCGFhAAAGDDAZEEFUFAALDABhADAHEGBQFCAhAFAAAHA..PDGBNIAB.EFHF...hAGA......hAIA...,1,-6,-25,19
TLbQdYZCaMEWNJcRPHFOSIXgfDeGBAKVU,KAAATAAALACB.dAEAZACB.aAEDEAGAJAGBRCEA..HEBAFCAHOBHDhAAASCHB.XEGChAAADDEBeDFBAFFB.bEBDhACAQGAC.MHEAcFGD.IHEAhAGA...hAGA...,2,-13,-10,3
NYaDELJOXHGCcbFTeAQWKZPBRfVgISMdU,QAAAZAAARAEA..VCAASACA.dAFAUCGAaAHBECDBhAAALDEBOBHDHECDhABAGDAAbFAD.eDEHAACAKFHBhAEAfDGE.MFGBDFABCGFAFFHD.WECBhADABHHD....hAFA...,1,12,-11,23
LQNgDORVcfAEXSJWBFPbUaeHTYdCZIGMK,EAAASAAABACAFAEAUADA.HAFAdAHAZCCAGCGALCFBQDBAhAAADDHB.RDEBfGDAhABAABEB.XGGAhAHAPFHDeEED.CHBAMIDA...hAIA......hBDA...,2,-27,-4,23
NKcUXMaFeRfEHgLAdGVYJbOSWQBCZPITD,GAAAVAAA.JADAOADA..QAGCZAGB.TCDAhAAAKBDAXDDAaCGE.REFFHGBAhAAAADCBbEFABFCACFHADBIB.hBGAUGEAMIEAFGHH........hACA......hAIA...,1,-10,-14,4
aTgAbJDMfWdZUKQLYFVNHIBXGcORSPCEe,DAAAMAAAdADAZABEKAFALAFA..FBBBHCCABAHBGCFARCDA.hAFACCHAEECBeCGH..aEEHhAGAACIB.JEHBUFFB..hBAAYHAA.NHCB.XDBD.SGCAhBDA..hCAA...,2,-43,2,45
SfXACZRYQDNaETcPBWbKOIHLgVdGeJUFM,RAAAQAAADADA.EACATAFABAEAKAGAHBDBLCDAdAHAGDFAhAAAeCGHFDCH..MCIBhAAAXFCAACEAZEEFaGAAPFHDhABAOHFE..IDHA...hAGA......hAIA...,1,-5,-15,10
agEONLGbfCIDSVPWAJZQdYHUBMceTFXRK,ZAAAdAAAHADAMACA.eAFEFAFD.RCAA.KAHB..ECEALCEAGCGACEEASCCDhABA..hAHAPGDAADIBQEEAhBEABGHA.TEGA.aGHDNIAB.....hACA......hADA...,2,-17,-15,2
KEPaDSYLeRTHBFUJANVdMOGCIWXZQbgcf,dAAAGAAACADA...XADAZABBQAFA..bAFDfCEAhAFAEAHBaCDB.SBHBhAIAeDADHEDAFDCDAAABMDIBhACAODGBgGEAKEHBDEFBLHDAhBAABHCA......hCDA...,2,-20,9,29
JaHIYZSEBVTWdcKXgCUOfFRPMLQeDGbAN,aAAAHAAAZACBEADE.BAFB..TAEAdAHAXCAACAGB.OCFBhAAARCEAMAIBLDDBhACAeECBGEEBADHAJEHBSGCDhBHAWHCA.KGEAfGHA..hBAA......hBBA...,2,-22,-7,15
QNFRgCKOUEPYeAVbDdZTcGMafSJXBHIWL,DAAAZAAAGAEAMADA.aACA..SAFABAGAHCGBLBBAhAIAQEDCRCDAKBHBEFGBeDBBhBAAAAIBdGAATDGA.fEFEhBCAXCCCNICBCFHAOGCC...hABA......hAGA...,2,-9,-8,1
eTEVUIcFgNWJZDdGCaLOMfQbAHPRYBSXK,HAAARAAABADBKADC.EAFAUAFA.FCCA..gBFA.JCAFhAAAdBHAGCCAaDEDMDGBhAAAQEFA.AAIBSDHBhACAeEHBTFBAIHFA..hCCANIABDGHBOFEB..hCEA...,1,-9,-30,21
BYTHKDbJAROaceCGLdEQMFZPgINfXWUVS,RAAAaAAAeADEGACALAGBdAEB..EAHBMAIBZCEB....gDGAhAIAfBDAXFBAhBAAVDEBBEHA.HFCBhAAADBBBACHBCGGA.QGGA....hBFA......hCAA...,2,-12,-11,1
WYUgGbBFHfMdIJKXOVSPLRAEDTCZNeaQc,EAAATAAAZACB..eAEAaACA...QBGA..cAEDhAAAUDEAbECBHAGBdEGAKCCAhAFAOFABSDBDhAIALCBDADFACDHAYEEABGHAMICAXFGAhBDA.RGEEDIBA...hAAA...,2,-3,3,6
dNAUZGFJHXcLaefPDSYIbVRQWBOgTMKEC,GAAAHAAALADBeADADAHBSAFA.ICFARBFBQCDChAAAOAHDMAIBECABdCCChAAAAADAZEFAXDFAhACAaGGB.fEEE.bFAABHEATGFAhAFACHHA.NEIA.....hAGA...,2,-13,4,17
SKgXAGVBDIcZLEORTJaNeYWbFdUQMCfPH,GAAADAAAZABELAFARADA..aAGAeCCA..bBGDdCGAMCDBhAAACDAAHDEBKCEA.AAGABEHAhADAEEABOEEB.TFGAhACAYGDAFGCBfGFESGGB...hBAA......hCAA...,1,1,-29,30
cKZdRTfFEaPWGYQeCVNMSXgIOHbABUDJL,DAAALAAAZABERAEF.TAEA..EAGEaAGAGCCA..eBGFhABACCGAMCIBXCAA.hADAOCHDHEFBACCBBDDAhACAUGCBKEAAdHFDFEFH.PFDB.YFHFhAEA.....hAIA...,2,-17,-1,16
SADCcfKHPNWRMYXdEaLgGJbeTQIOBVFUZ,CAAAKAAAHACA....PACARAFFMAIBdAGAECAALBFDGCDAeCGHhAAAQCCABEAAFEHDhACAZDGBAAIBDFDB..fGDAhAAA.YFFFaFAEgGGGhAEA.JHAAIHHAhCAA...,1,6,-34,40
eVGdKFfDZbCUOHYaRcNWTgPJQEXALSBIM,LAAABAAAeACAdAEAFAFDZAFB.CAHA.HBGBRCAA...NCAA...TDGAhABAJCCA..EEEAACAAMDEBhACAKEHBDAIBUFGBaFGH.hAAA....gEBAPHAA.SFEHhBEA.IHCAhCDA.,2,-28,-21,7
SCFBRUdgIETLDfMPAeGWXJNZabVYOHKQc,eAAAGAAA.JADAaADD....VBGBHAFAKCDAQCEDhAAA.CCCDRDGFdEEAEDBBTGAAhAAALFAAMDCBAAHAXFEChABAZFCBOEHDFGHDBGFAIHCADAGA..hAFA......hBDA...,1,-2,-13,11
SXOcQbMAUFfJeRZGBNDLIPYaCHVgTKWEd,FAAAeAAARACFGAEADAEALAHB..IAGAaBCDHBEA.TDFAhAAAEBHFdDGD..ODEHhABAbEAA.ABGAUEBAZEEABGGDhAEAPEHD.CGGD........hAIA......hBAA...,2,-21,-3,18
fHdMbSYEeAQPGBKWZLFNIDJCcOgUXTaRV,GAAAKAAAZACBLAFAFADADAGA..CBFA.OBEBUDCA...aCABRBGFHEEBhAAAdCGA..MCIBhAAASDHHEEFB.AGHABHHAhACAIFDA.gGAA.XFGDhACA...hBAA...,2,-31,-16,15
PMXQWNTfDAdYgJcRUIHELOGZKbaeVCBSF,dAAAJAAA.RADAHAGBLADBZABBKCEA..eAFABDCAFBHD..MDIBhAEAQDEA.TFAAhAFAAAIB..gEEAhAGAIEHAEDCBOFHHaGCDSGEAhAGA.....hBAA...,2,-31,-15,16
TScKAbCXGPNDYfWOIFdZEBaVQgHUReMJL,XAAAGAAADADA.....fAFAOADAdAHAEAHBaBCDQCDChAAAHBFBREBAeCEDhAAAMCGBTEGAKCHDAEFBbDBDhACACGGD..PHBA.NIEB.IFHA.hABABGGD....hAIA...,1,4,-19,23
KeIdNHWTcRAQYZXDLfgCUbOMPFBGJaEVS,ZAAALAAACADB.OADDMAFABBEAGAFA.EAHBKBGA..eCABhABAdCAAHDDATEEAACCBQDGChABADCCBUFABbDGDFFDHhACA..aFDHSFFDIHHA..NIAB.cGBChBGA...XGGBhBIA,2,-17,-7,10
PDASeCNRGOXLgFcEZbMVIUJfQHYdaKBWT,eAAARAAAGADALAEAFAFAZCFBMAIB.UCCAQDAAHCFBaDBBBCHAhAAA..TFCAhAAAAAIBCEHAODDHXFFAEGGA.hABAIGAA.fHDFKHEA.DFIBhABA......hAFA...,1,-7,-17,10
CGNUcbXRESYeaPZgFQAKDLWHTfdMVOIJB,LAAAHAAAdADAMAFAOADDBBFAGAFAUCAB..XCAAhABAEBHBeDDAZDGB.QDDBhACAADDADDHB.TFAAhAFAfEFAIAHACFBANEIA.bGFA....SGGBhAAA..hACA...,1,8,-25,33
IFSYXcVNBaRAZPfJTECgWGHLDdbKeQMUO,ZAAAJAAA.EADE..CADBGAEAHAFBdBHA.eCABMAHBOCCB.SDEBhABAXCCCVEFAhAGAaECDAAHA...TGBAhAIALEGBKGDCIHHAFFAHYEEF.NEIA.hACA......hAFA...,1,0,-25,25
ZSGfEePLYbQDKWgcUOaMNRFCBIAHdXVJT,HAAAdAAAJADAZADB.GAFA.EAHBeAGHLCCDQCBAKCAD.hAAA...gDGHhACAOBHDaCFHREEBBFBDhADAADDATEGAfGHA..bGAADIAAcEEChACA.....hAIA...,1,1,-23,24
UTNFeYgXHSCfKVLDdMQOBIRbPEAJcGWZa,GAAAaAAA.UADATADAeAFA..XAFBHCECCBHAKDDD.LEFAhAAAdBHAMBBBQGAAhACABCCARCEBEEGAAGGAJHEAhAGAZGDAFGGA.SDAD.DEEB..hADA......hAIA...,1,-4,-11,7
dVXFNPREbQcIBTeYJMUafZKLDCGAWgOSH,OAAAHAAAdADAFADDRAFAECAB..QAFABCCDeCEFMAIB.aBBHhAFAZCGBLDDAGFABAAFAhAAASDGHXFEDNDIAhACAbFCA...TGGA.YHBAhBAA......hBHA...,2,-16,0,16
gQYIeJXKRSFfWDHGEAZTcVNBLOdaCPbUM,ZAAATAAA..VAEALACBdAHA.aAEACCAA.UBFB..MCCBhABAQDEBeDDAKDGAREBAfDHAhAAAHEABAACABFFAhAEAbGFA...IHAASFHBDGFA.EHGEhCAANICB......hCEA...,2,-21,3,24
CBHIOQbXLJPgTdAWMGFcYZVeENSDURfKa,GAAAFAAAZACB.EADADAFARAFA..KCDABAHA.HBEAQCGALDEAhBAAJDCF..TEBAhBEAAAABMDAB..VFFAeEEBhACASGBAaEGCOGACXGDDdGGA..hBGA......hCAA...,1,1,-20,21
YbAQBeSOMFGTREZJdXDHKCLaWgcVIfPUN,eAAAMAAAGACBEADAdAGAHBEBLAGB.aBBC..gCCDhAAA.IDHAhABAfCEAPECBUEFAbEFDhAIAAAIBQFAASGBD.FGCA....hAFA......hBAA...,1,8,-18,26
gPVXUAMJaSRdDQcEFTBKIGCbNefLHOWZY,aAAARAAAdADA.DAFAEADA.BAFAGBEA..CAHAeBBBHBGDZFGB..hAAAPCFAXGBAADAAMDDBhADAQGEB.hAHAFCCHTEEA.bEGB.NIDB.....hBAA......hCAA...,2,-25,-11,14
QBWJAVMZKUYPGcSOaLEdFbfHeITDNgRXC,ZAAAKAAAUACAGAEA.OAGFEAEA..dAHAFCAAHBFBeCHHDDDBRDDB..hAAAQEAABDHAAEEAMFCBhBHA..PFGBhABAaFFA.bGAA..fGGE...hACA......hADA...,1,-6,-31,25
TIKgJBQcZEHSYDMWGVLfeANUPbaFOXCdR,UAAAaAAA.OADAdADARAFA..KBBDBAGA.ZBDAHCDCDAIB.GCGAhAFALDDBACIB..bDBDCCHD.hBAA...TEBAhBCAgEEGQFFAEGABMFIBfHEBhBEA.NEIA.....hDAA...,2,-29,-4,25
gWMEaAcPROQLXUCDdeZfFNVYBSTJKHGbI,RAAALAAACADB.eADHZAEBFAGD..VAFABCCA..TCAAhABAHDECGECA..hAAAbCEDIFHAMCIBADEBODGFhACAXGGCdFAA.fGDASBHHhABAKGGD.....hAIA...,2,-30,1,31
bHKcgLRDBUJIPAXTaCGNOQEdMSeYVFZWf,aAAAGAAA.QADAEADAdAGA.eAFAFBBHZBEB..bCDAHDCBhADAKBHBLEEAREGBBCHAIGEAhAIAAAABTGAA.ODAHhACAMIBASGGDYDCFfFHAhADA.DGGB...hBAA...,2,-18,19,37
CbLWYgTeBZIQSaOEUJDcXVHKGFPNAdfRM,RAAAMAAALADB....gACAeAFAZBFEQDFAhAAAaAEDEAGADBBB.XDCChABAHCECGEEAFFABACCAdEHAbGAA.hAGA.YEHBBFFDIHHASDDD.hAFA......hAGA...,2,-11,4,15
AYGdgUZWCXBOfRNbIFQMcePDaHEJLSVKT,dAAAZAAACADBOADA.RAGB...bAEDQBDC.eCAAaAGAHBGDhABAECFFLEEAhACAKCAAADDBGECBUGEABGHAhAIAfEHA.FGBA.MIDADDIB.SGEAhACA....hBGA...,1,-7,-16,9
FeQTMEZBYIOgcbDXLHWKCAGPJfSdURNaV,GAAAJAAA.dADARADF.aAFAeAFE..MAIBEBFFZCGBBBFA.OCGDhAAA..bDAALDDBhACAHEEBCGDDACCBSDBHhBAA.VFFBFGHB.......hADA......hAIA...,1,-12,-21,9
dMeJHRfgKBCNTVGaYLFSODQXbIUPcAWEZ,EAAAdAAAeADAHACARAFFKAGABAHB..CCBA.TCDAGCEA.LCGBhACAOCCHQDGAhAAA.bEADIEAAhADAPEFBAAEAZDCB.MCIBfGHAgGGAhAEAaHCE.SGDHhAIA...,1,9,-22,31
eLFaOGAfSNcJDBIWYgHRdCPKXQEMUVbZT,SAAAJAAABADB.....IADA..gAEHhAHAHAEBRAGBdCCAKAHBEDFFMCCBhBAAbEDDeFGBaCGBADDA.fGAAhAAADDFB.CHFA.QEGA.hABA......hAGA...,1,-11,-43,32
EOCQdMTeJSKNZPWaFHIAGDUBLgXfYbcVR,GAAABAAALACA..fADA.bAEDRAFFEBHFQAGAhAAAdCCAeDABKDDDZDFAhAAAaDAHHECCADHADECBXFGChADAcEFA.CHAAMIDATGAA.SEHBhACA.PFFBIHHAhAEAgGCH.,1,10,-6,16
KIXgfRWDPbQTBdAOLGNHMVYJUaSZFecCE,GAAAHAAAMACAJADA.aAEEZAGB..FAHBeCDAECCA.KDCD..XCEAhAAAREEADBIB..QGAAhAAAdDHAAEEALFCAhCAA.VGFASEHBCHED.fGGAhACA.....hCCA...,2,-17,-7,10
TFUbRMPGKeSYQEADZfHJgILCXadNBVOWc,ZAAAHAAAJADALADB.aAFAdAGABBFAOBHD..TCGAhAAAFCAARCEB.GDEA.eCAAhACAQECAAAIBfEHAhBFACEHD.XGGAVGFA.....hABA......hACA...,2,-32,6,38
CKAXNSFYTRLbWQZGgDJEPOaBfIceMUdHV,SAAATAAA.RACFLAEBQACCGAGADAEAEAGA.aBEDfDFAhAAA.eDHHhABAdCGAHECAKECAAAGBFGFBhAIAbFEAWFHH.........hBIA......hCAA...,2,-14,-9,5
XdUYQJFcbAESBONHCPDWRKZgfTaLIVeGM,EAAAOAAAHACADAEARAFFZCCA....TAGAaAHDLDHB.hAIAeEAAGBBBdEED.QCFDhBAAFGGHAAEABHAACEBAKEDAhBBAIHEAMCIBXFGC.YHFGhBEA....hBFA...,1,-2,-29,27
ZeTIWGXKcdQgHEabNRJFSLUBOPfCYMDAV,eAAATAAAGADA.KAFAdACAHCFAEAEAaAGDRDBBFEFHLCEBBAHBOEHBhAAACCHADDDB..AAIBZEABhAAAXFADQEGAhAEANICB.SGBH.fGDAhBGA.MIFA...hABA...,2,-13,2,15
JMHGQcfVNbCdKAFBaWPTOESYLDgRUIeZX,aAAATAAA..EADALACBRAFA.eAEAZBBAMCFBHBFCGDEAhAAAQCGAfDGEhAEAbDAA.dECAADAABEGDhADAOEHDDEEBgFADXFGAVGAAKGGD..hAGA......hAIA...,2,-8,17,25
JABbLRUYOaNcCZgfIEVFeMTHdXGWPDKSQ,LAAARAAAOADA.aADD..CAGAZBEA..fAFAECCB.eAGHhABAHDFAGCAADAIBQEDDhAAAAAIBbDDB.UGGAhABAcCGD.gFEH.FGHB.hCAAMFAB....hACA...,1,-11,-17,6
GOgTLfEQPZWCVMHJBeSAXDKdYcbNUaIRF,KAAAdAAA....bABDaACA.RAEFGAGA..TADAEBCFZDDACAFBHAGBhADAeDHH.AAIBDCFB.hAAA.NGABFFFHLEDAhBAA.QFGA.PGDCMIAABHHAhAGA.....hCDA...,1,-10,-19,9
edGDXAWEcSMRbQFLBTaZICNgUHJVYKfOP,EAAAMAAARACA.FADDLAFBBAFA.ZBGB.CCCD.UCFAHDAA..VCBBhAFAKEDAODHD.eFCBhAAAGEDAAAHA.SAHBhBAAbGFC.aDHD.IGGA..hBBA......hBCA...,1,-4,-35,31
CXVNSWQIEeAcbgJaBPYRFZLMKGdfODTUH,...bAAAaAAA.BADARAEAZCAAMAFAGCEBdBFADBBBHEAA.CAHB..XEEChAAASBHBQFGAhABAECCAACHB.JHCAFDAHhADA.LEDA.OEGD...hACA......hAEA...,2,-29,0,29
eKAMJdXVZPTUYFEScbHNBLQWaGDRICOgf,dAAAZAAAUAEAEADA..SAFAHAGDLCABQCBAGDDARCFAODABhACAeCHHACCBMDGBhABAXDDD..PFHDhACATEGA.FFCHbEBDBGAADIAA.CGGD....hADA......hAIA...,2,-5,-2,3
QDcUBJGaLgRfTbPMIVYHWZSAFKXdECeON,XAAAEAAA..eACAQADADAGABBEAaAFERBFF...bCDAMBIBhAAA...ICCAhADAHDAAZCGBADEBdEFDOEEBhAAAUGGALGAA.TGGAPHBA.hABA......hADA...,1,-3,-23,20
FPCBbJDSTGNKOIeEgXLWfRZHQUcdYAMVa,aAAACAAABACA..DADAGADAOAEE..EAFALAHBRBGB.HBBChBAAQCAAdCFAADEAMEEBhBBAFDFBJEHBSFFAhCAATFAA.KGHB.eHCGXGFD.WDDDhAAA......hACA...,1,-11,-28,17
ALHNEOTUXGFQaBCKSeDVMbIdcWZgfYRPJ,HAAAEAAAUADAGADA.aAFAKAFADAIB.MBGBdAHAZCBA..fCAEhAAARCFBADHALFEATEGAhACAFGHD.BCCD.eDEHhADA.bFBB.IHDA...gGGAhBFA..hCHA...,1,-2,-35,33
UFbLOETXVaKgJMCeNAdQGSBIZfHDcPWRY,GAAABAAAZACAHADADADA...PAHBRAGBFCCA.LCDA.EDHFhAAATDEAaDAHKEEAMDIBhAAAeFAA.AFIBdGEA.QGGChACAfEGAWGAAbGAA.....hAGA......hAIA...,1,19,-43,62
aHgdANVDIOKcFWGbfLRCZYeQJMBTSXUEP,DAAAKAAAFACAGABBLAFARAFFZCCA...eCCAMAIBBCFA..TDGAhAEAXCGD.EEEBhAAAHECA.AFAAIGFAhAFAOFHB..bGAACHAAYHCASGFHaHGEhAHA......hBAA...,1,-16,-23,7
ACcESJTaLdfVgHPFKXbRGQDOWBZNIYUMe,EAAATAAAdADA....VAFAHACB.KAEARCBBGDDAQAGCOCHDhAAAZCFAIEAAhAAA.MDEBABCASDGDhAFAaCACLFFAfGGAFHEADIAABHHANIAB.hAIA......hCAA...,2,-17,6,23
DcAWMZGeNCXIgdQVOREBSbUPFJfTYLaKH,ZAAAeAAACADB...XADAdAFAQCAA.RBGF.EAGABAHBbCCBFBHDhAAA..TCDAhABAaCEEHEABADIBGEFA.hABAIFBAOEEASEHH.PFFBhAEAYFEF..hACA...,2,-27,0,27
VegKMBRTfObNCAEdDPaLSXGIYcHZQJUFW,EAAAdAAAaADALADA.GAGA..IAGAHCBAZDEBQBDChACAFEABeDHHMFCBhAAARCBBTCGAbEFD.AAIBSDFDhBAA.XFGA.JGCA..hBCA......hCDA...,1,4,-25,29
aZSgfYcACQVFNPeEIXOJLTBUKDdGbHWRM,QAAAFAAAeACH.EACAOAEALAFABAHADBEBGBDAHCEBRCGBZBFAhBAASDCB.hCAAfFGEADGACEGAPFEDhCBAXGAATGGA........hAAA......hAGA...,1,-12,-17,5
DFGgCaYdEWbSLPUHOKAcQNMVTeZBXfIRJ,QAAAMAAA.eACAZABEXAEDRAFA.FAGAGCDA.hBAAaCFCECCBbDABLCHBhBGAHFFAACHA.cDFB.hAAATFDAfDHADGGACHEA.dGAD....hADA......hAGA...,1,1,-13,14
aHKVSODYfZQNEWeXGgAICJMTUcFbdPLBR,CAAAMAAAUACAFADD..dAFALAFABAHA.HBBBKCBD.OCFA.hAAADDEAZCEEEDHFeCHHGEEAhAGAADDB.JHAA..TEBAhAHA.....bEFDaGHB..SFEFhBCA..hBEA...,2,-39,-9,30
COQcLIKbMZHEfBaedFJPXNSgRAYGVWDUT,GAAADAAACACA.QADALAEA.KAFAZBBAHCECBBHAeCDD.dAHAhAAAFCFBXEGA.hAFASDADADDBVDGBUGAAhAGATFEA.OHEEIHHA.EEEB.hACA......hADA...,1,2,-34,36
QBEDPIGZHVKdaOXARcYeFgLMUfSNTCWbJ,RAAAeAAALADBMAEAUBDA..SAFACAHA.JBHBEBGBDCCBhAAAGDEBHDEBdFAAaCCBAAAAhCAAFEHD...fFCAhABATFCAQFFBBCFBZGEA.OFHDhCBA......hCFA...,1,-8,-15,7
LcQCSRNTaAbgeJWUDfPIHXdVMZBFEKYOG,eAAAUAAADADA..fADAHAECdAHAZCBEEAFA.KCFDGBGA.hBAALCCAQDGAhBCARECAaEGHAEEB.bFADJFFBIHHAhAAA...XGCABHGA...hBDA......hCDA...,1,9,-28,37
NfeGcLDdOBYbaJIgSEWAZHKQCFPVMUXTR,HAAAQAAAFADAMAGBUADA.RAFA.eAHBGCGALCAAdDBABDDAhAAAaCEB..JDFFSDFDhAGAACHBZEGB.CGDAXGGAhAIANIABDFIB..........hBCA......hBDA...,1,-12,-18,6
MZJfBYLXOPcUIaKDACRQEGNSTFbHeVdWg,RAAAEAAAGADA..TACAHAFAeCCBdAEAMAGBZCFEBDAALAHBhAAAOEFCUDDAaFAAABHBQEGAhCAAFGGA.bGEChCBAWHAA...fHEB..hAAA......hABA...,2,-11,-6,5
aMPGKCHQTRYbeNDZOIgSBXJVAFWcUfLdE,FAAAUAAAdADAEADA..aAFAGAFA.HCBCRBEFeAHHZDGBODABhADA.SAHBhBAAXDBAACCB..fECEhBCAMDGBCDHATGBAbEEDDEEBBEEDWFBDLFHBhBAA.....hBFA...,2,-17,-1,16
GDMYHaBFfdIKPQEATLbVXUCRJSNWegZcO,TAAALAAA.XADDRACF..SAEBeAFAZCAAGCEBhABAMAGBHCDBaEEBfEHAhACAdAHAKCADEDGAAEIBbFAACFDDNHBBhAAA....gFFDDFFAFGGA.IHEAhAFA....hAGA...,1,-3,-9,6
DMYSRfeOEdLKJFgZVTUBAabWCGNcHQIXP,aAAACAAAGACAHACBQAEA..XAEAMAHBRDEAeBBDhAEAEAHBdCAALFDAFCEDZDFBTFAAhAAAAAIBbGBC..NCIA.hBAAIEHADFHB.fGHA.KHCAhACA......hAEA...,1,11,-21,32
KaPYdFOTBcHMNDSJegEUQVZXLGAfIbWCR,..IAAAbAAA.RACA.aAEA..dAFATBEAHBGBMCAB.SAHBhACAeAHBECAAQDDChAAAZCCAGECAAECBCCGAKEBBhABAFEFDBEHADEGAgFFA...hADA......hCBA...,2,-8,-6,2
EQeFZTBLbHCKGDafIOXJgASWdYMNRcPVU,dAAAMAAARADA...VADAEAGEFCBD..ZAGBLCFAHBBBGDEAhAGAaDAH.OCHD.XGCAhBAAACGASDCHhACAYHFGPEEA.eEHFBEDC.CGGCDIBA.hADA......hAEA...,2,-27,2,29
dYUacPMAQGFZKRSCVLEJgfNOHDeXBTWbI,GAAAZAAARAEA.CADALAFAEBHF..JCAA..fCDAhAAAHCFBeDABTCFA.bEEAhACAdDEC.aDHD.MECBhABAAAGAQFCCSFADgGGADGGABHHAWHAAhACAYDAF..hADA...,2,-18,-7,11
dSJBDCbIZLAQEfePFHWKXgcYUOTMVRaGN,EAAAeAAAHACAKADA...XAFB..gAFBUCCBMAIBhAAARCCAGDFAdCFDBEAAbFCBhAAAZEFAAAHA.QGEAhAEA.FGHHYBHBOHBC.aFHD...hBHA......hCAA...,1,1,-13,14
SYIAaXRKcBPDdQgCGfOMTHbZVNJUeWELF,RAAABAAAdADA.QACAGAFAMAIBHAEAZCCAVCAA..UFAAEBHFLDEBhAAASDGHAAGAaCGHhACAKEEDDEIBCEHA.OHBEhAAAbGFA....NIAB.......hAIA......hCAA...,2,-17,-5,12
BFJLgaXWPeObUGDRTYIdZHCANVcSMfQKE,VAAAMAAAKADA.BAFBLADB.aAFAXAGD.eBBBhAIAbBEDGDGA.RGBA.hAAATDDAdBGDCDCDADIBSCFGhBAAEFFB.FDHD.gFFB.hAIA......hCAA...,1,-10,-28,18
XbFDgJAUNfdKWSZPQLREceVYGIHBCOTaM,UAAAdAAASADAZADALAGBRAFF..EBHFeCBAGCABHCEBODEChACAaCHD..MEAAbEAA.hADADFAAAAHA.KFGA..QFFAhAEA..cGFC...hBAA......hBCA...,2,-17,-12,5
EYQJHcTGOFZLaNbIXCMWedVgPUSKADBfR,BAAAEAAA.QACAHACAGAFAZAEBaAGDbCCC....CAHAeCHFhAAAdCAAVDFAUFAA.AAEARECFJCCFhAAAOEEDLFFAXGFDhAHAMAIB..gGBASEHHDEEB.hCAA......hCBA...,2,-8,8,16
QgDYEOcJWHKUbFNZIMCLTXfaBAGPdSVeR,dAAAeAAARADADAGAEADA..OAFC..JBGBHCCAKCBA.FCFAZDAAMCIBhAAA.LECA.hACATFGAaCHDACFBGEDAhADASGEB..QFFCYHAA..hAEA.WHFA...hABA...,2,-30,-12,18
HbSAJTQfcLWZeCNBDYIgdEMVaPUFGORXK,TAAAQAAA.LADAeACEBAFBDAHB...IAHAhAAAECDAaBHDFCFDRCCAHCFBAAEAJDCFfCHEhBDAZEEA.CEEDgFCBhCAAdGGDMIAA.PFGDOHEC..hAAA......hAIA...,1,0,-12,12
aEJTQbPMBFDYZAGHeCKIVgSORcXfLNUWd,HAAAeAAAKADAVAEA..OAFARCAA..fBHALCCAUBGBhAAAaCEC.EDGFQEABhAAAMECADEIB.AACAGEEAhAEACFFDSFHDXDGA.dGHA.JHAA..hAHA......hAIA...,1,10,-25,35
bARDfSJeLWFaPgXYUINEBVdMTOGcCKQHZ,RAAASAAAeADELAGBFADA...aBDDXAFDUEEA.EAHBdCCChAAAMBDBOCHD.CCFCHGFChABAAAAAfCEEhAIA.PDGB.IGHANIAB.BDHBhCAA......hCBA...,1,-7,-34,27
YeLJIOQPMBaSFGbADVRKXHZWgdfNUCcTE,RAAAHAAAZADBdAGAUADA.CAFA.ECFBLAHB.OCABMAIBaCCBGCFAhAAA.ABHB.KDABXCCChACA..fDHEhAAATFDAeFHBQEEC.SFBAhABADIEA.gGGAhADA,2,-22,-15,7
BVOWJDAFUMCYeXGTKEcNbZPfaQgRLSHdI,MAAAeAAAGADAKADA.EAFA....bAFBZBGB.aCCHRBBBHCGBhAIAdDFCBEHAODEBDDBBAAAACBHB.hBAATGCA..PECDhBBAQFABLFFASGGAIHHAhCAA......hCDA...,2,-16,-5,11
bLIdKCMNZFXUGaORPSJDgYWEHfTBQecVA,LAAAdAAAMADAZAEEXADDGCAB.RCFA.SAFA.DAIBhABAgEEBECAAHCECTEEAhACAeEHBAAIBbFCBCDDDFDHDhAFA.aGAA.OHCC......hAGA......hCAA...,1,-5,-13,8
fNeHTZIDGKRLCgFQEcPAUaMXOBWVdbSJY,aAAAMAAABADAdAEA....SAGAJAFA....fBBEhADAHBBBZCFBGEDAhAGARBDALCHBFCHDEEBBADDBODFBhAIAWFHB..YHAAeGDGDGGAKGGBCHDD..hAHA......hBAA...,2,-28,-12,16
XHaUBZTAcNKDWdMJYERbOSfPQgLeVIFGC,KAAAdAAAMADAEACE.RAFA.OAEA..SBDBQBEDeCAAhACAFAHDGCCAHCEBaCGEZEFAhAAAADDBDEHBJGEA..fHDBhCAALGFACHCA........hAIA......hBAA...,1,-13,-19,6
bYCWaZPUXeRFJISHBdETLGMNgQcKAOfVD,OAAADAAACACA.ZADBUAEARAFA..FBBH..SAGAHCEBECGAGEGAhAGA..MBBBhAHANIAB.QCCChBAAAGFB.bCFA...aEEA.eEGH.BHCAhBEA......hCAA...,1,-17,-35,18
dKLMUPWHETQZObGJgRAcDCeYBIaVfNFSX,CAAAeAAABACA..aADD..VAEAFAFAdCFALAHBMAIB..UDBAhAAAHCAA.ECEBZEDFGDFAhAAARDGFAFFBDFIB..fEAEhACASGGDKFHB.PHCA..WHCGhABA.....hAEA...,2,-20,-17,3
VNGIDRFBceMSXgTZAYbHKCWOPQdEfUaLJ,HAAACAAA.OACAdACAEAEAaAFDLAHB..VCCAGCDARBGFBAHBhAAAeBGFMDIBSCBDhAAATEFAZFBAACFBbEACKGHDhBFAQFFA.fGBA.hCAANEIAFHEC....hAEA...,1,0,-7,7
AYCDRcOUSZGWbeHKFfJLgXENQaTVBPIdM,DAAARAAAOADAZABEGAEA..eAGFHAGDFBDDLCCBEBHF.aCHDhADATDEABEEDdFGAAAAACDHA.hAIASGAAKFCA.hCAAfGDAXFGA.......hCCA......hCFA...,1,-11,-26,15
CAMITLEDSWcNHdJQfFBZRgXUeabKOYVPG,MAAATAAALAEA.EBBASACB.NAEA.HCDAdAFAQCGAhAAABBHARDFAXFAAhAFAeCCBbEFCOFFBhAGAPFBBADCBDGHB.cGCDFFDDgGGAhAHA......hAIA...,2,-10,-5,5
aRVgYGAFEPeDbWBUHLTQdCJZfKcXSIONM,EAAAeAAADADABADA.HAEBLAGBdAGBZCCFKBCA..SBGHhAAAOBEDaCBCREEF..gGGAhABAAAIBFDHD..bEBAhAAA.UGBACDHA.fFFA.IGHAhBCAMICA....hBEA...,2,-28,-11,17
eRNFMZDBHcOGaEUVQbCLYdSTKAXJgPWfI,XAAAJAAA....PADAIADARAGB.MAFAZCCAHDFBhAIAGBDBEECAQDDChAAA.bDGBLEHBhBAAdFFATGBAACEAfGCANEIABGECaBGACHGD...hBIA......hCAA...,1,9,-19,28
aEYdfUBTSRFPbKAIXZMDJOWLCVcGeHgQN,ZAAAMAAAOACALAEA.CBBA.GAFAHCDAQCGCEAHBdCCDBDEAhABARDBBFEFHKDHBAFBADAIB.JEHBhAFAVFFA..eGAGhAGAaFBE....fHDB...hBAA......hBBA...,2,-17,-9,8
GgdXONaDTHJYAcFQPBfLMVbWeICRUEKZS,QAAABAAAMACA...VACAeAEARAFFKBHBGBCA.dBHAODDBhAAAaCBBHCEBAAHA.FEGDLEFAhAFA.bFDDCCGCEGHFhAAASGGANECADIEA.......hAIA......hBCA...,2,-12,-11,1
SfBWUFJARDIbgVLOMcPaZTXNHKCEdeGYQ,RAAADAAA....bADBLADA.MAHBaAFDZAGB..TBBAhAEAHCCBEDHFeCEBGEFAhAAAQDGBBFBAFFDDhABAAAIBgFAAOFHD.XFCDNIBB.dFGDhAFA.fDDEhBAA...,1,4,-27,31
egZWdOSCVGBUPfKIYTJNMLQDbaEHAXFRc,RAAAeAAAZADBdAGACADA.GCEABAFAUCCA..KCHB..TBGAhAAAMCCBLDABQDFChABAaEGDHFAA.AAHAFEHDhAFAgGBASFCEfGHAIHHA.hAAANIBBDGGBXGDD.hBIA...,1,-11,-15,4
aSCJQLOUGAMYPFbdNWVBeTDgZIcRKXHEf,MAAAFAAAdADA..VADAeAFA.DBIBZAGB.RBBBHDEAECCB..aCEDCEDDLFGBhAGA.GGCBhBAAAAFAbCFD..BDBDhBAA.TGGA.IHCA.KHEA.hBBASEHB.hBIA...,1,-13,-22,9
FYPMeBgNZXHdDJafSKLVTbQCUGEAWORcI,RAAAFAAAMADAeACH.BAEAZAEEHCCA.dCFAaAFDKBHBLAHB.hAAA.bDGDQDDAhAEA.GEGAAEEBOFFHhABAIGDA.YHBANIAB.DECB.hAIASGFDCHHA.hCAA...,2,-16,-14,2
IQHcCedLXgSZDWFbJVfOaRTGEUKMPYANB,BAAAHAAAeACEdACALAEASAFBZBFEFCBHVCCA...aAHBRDDBEDFAhAAAMBIB..AAFA.QDFAhAAACDHA.DFCAhCAAbFGBOFFB........hCCA......hCFA...,2,-32,-8,24
HCOWXPLDfFMYaTSZGgQKbURJcVedNAEBI,EAAAHAAA.OACA..XACALAGBFAFAaBDEZBFAGDDAhAAAQCCCbFGB.RDABVDFAhAAAdGBAAAIBCCCDDEEBMIDATGGAhADASDGA..KFFD....hAIA......hBIA...,2,-10,5,15
VDWKBONGaQEHSAJReIXPcCMZbYLTfdFUg,RAAAeAAA..XADBCADAZAEBLAHBdAGAFCCBUDEADBGBBCCA.GECAhAAAECHFHFBA.AAAAJEHBhAIAIEEA.MEHBhABATGEA..fGEA..hBHA......hCAA...,1,-13,-31,18
KTHWAOIPFQUMdVSgaXBDZebGcLNEJfYCR,OAAAFAAAMADAdAEA...SAGAaAFEDAIBZBCBeBBA.GCEBhAGALCFBEDDBfEGAhAHAREDBTGGA.HFEBhBAAACCB.IHCAPCHB.......hBAA......hCAA...,1,-1,-28,27
FgAROTXPHCJQBbWZDKYEUaSNLIMcfVGed,RAAATAAAHADBQAFA.BAHAZACBKAEAECCBUDFAaAGALCEAhAAAMCIB.VEEAeDABhAAAdEHAAEEAOFAHCCAD.hACAJHEAbFCDDGGA.........hBHA......hCCA...,1,2,-17,19
KEMJgbIOTWVHaDGLANFUcfSQYdRBCePXZ,FAAAUAAA..SACHdADARAFABCEAeAEAZCGB.EAHF..MDBBbCDA.hAEA..ODDB.hAFA.TECAHFEAGGABhAFAACEAfCHACGHA.KEHB.gEEBhBAA.IHGAhCAA...,2,-22,-19,3
bIERGMYfVWKHcUPeDNBFATXSQJZaLdgCO,TAAAQAAA.aACEdACA.OAEA.EAHFRAEFGAGA.hAAAMCDBfBEAhBEAKDAAHEDBPCFDeDHHBFFBhAAAACIBSDDDZGAACGHA.bDGD.IHHAhCAA.YFFF.hADA...,2,-5,-3,2
IeZaQUWXGAJOcDHbfCNTEgFMBVKdPLYSR,OAAAHAAACADB..EAFAMAEABAHAdBBD.LBEARCAAZCEA.UDDAGEEAhAAAAAIB.DCFA..bDGBhBAATFAA.FEHDKFBAhBFA.SFEAIHHA.eFHH...hACA......hAFA...,2,-17,-16,1
ZNaVIfbEFPLXeBHKGQDdUgcYCSTOJRWAM,ZAAAaAAA...IAEAEADALAGBBAGAHCAAGCCAdCEAUDAA.hABA.gBGAhACACBBDOCHDREFBADIBMEDB.fEFAhADAbFDDXGBCeEGHDGIBSFHHhAGA.....hADA...,1,-4,-10,6
THYaSbDedWZgEQVGBMOCPfLKIUNcJFXAR,HAAAaAAA.DACAeACHZAEBEAGAGAEA.MAHBCBDALCGBKDDB.UEEAhAAAJDGFAAEB...RGAASFFDhAGAdGHAgGDGhBIABHHAOCCB.......hAIA......hBAA...,1,-9,-24,15
KegZIMUQALBVCODSJbGfWPcXNaFdTHEYR,LAAACAAADACA.SADHGADB....fBCEhAAAPAFAXBEDaAGA.dCAAhABAHCDBRCGFeCCBZCFBMCIBhCAAABIBOEEBbDGDcFDCTGFAEGCB...hCBA......hDAA...,1,1,-19,20
HAFIBSVYcRWNULDZdbXePagGfQTECJMOK,BAAASAAA..VACARACFUAEAZAFBdBHAeAHB..aCAAGCGAhAAA.TEDAEDDBMEGBhAAAHGBAAEHA.FGFBIFAAhACA.....cFCA.LFHBhAFADDEA.bFED.hABA...,2,-15,-12,3
ZOJFEbBTMKXNYdLDfRAQgHSPGaICcUVeW,HAAAGAAAaACACADAUAFAeAEHZAFB..FCDBEAHFBAHAKCCB..XDFAhAAAdDFALDHB.hCAARFBAAAABQFFChCCA.SEEDIHEA.WEHHODAH.hCIA......hDAA...,1,-8,-27,19
aTLfegYbQVMWXNPOSJHdFUZKEDcRICAGB,aAAATAAALADA..eACE.bAFBMAHB.XBBChAEAOAHDHCCAdCEAZEDAEDBBRFAAAAIBhAFAGDGABDHAfFHAhBAAQEEAVFCBPGDCSGHHhAAA......hBDA...,2,-7,7,14
DPfQEACRFNXgMKdHZBVWeYISaJGTLUOcb,RAAAXAAAMADA.HADAZAEEBBHA..eAFESCCBGCDBTDAAhAAALCFBOCHDhABADDHBQEDAhAAAACGAFEEHKFHD.dGGA..........hABA......hAIA...,2,-28,-5,23
JaeETWAYfQSGDKLbdXOFcNgBCMUPVZIRH,QAAAGAAALADAdADAFAFA..gAGHMAIBUCFAZCDAHDBAhAAAeCHFEEHFAAABSEAAhACAKFBDOFDABGGDhBCACEEAIGFAaHDA.TFCA.fHGFhAEADDDA.....hBDA...,2,-8,-1,7
FOaQcVNUGgJbeBXfMRdLETYCSADKPWHIZ,KAAAHAAAZACBaACA.QAFA..cAEBUCCAGDFAhAAA.bFAAeAGFBAHAMAIBhAAAdEHAEFEBTDEACCHAACFBDFAAhAFAICAA.OCHH.gFCAhACA.fFGEhCCA.,2,-37,10,47
TXBYcSRdgCbONaVKDIZLEFMfUQWPJGHeA,TAAABAAASACA.RAEF.dACACAGB.bADD..OAHDaAFADAIBhAAAZCAAEBFBFCGH.MEEBhAAAQDGA.PEEBhBGAHFFAACCAXGFAYHFG....hACA......hADA...,1,-7,-26,19
gENYdMJVXbFRAPeaWHcfLTCUBKQSIZODG,eAAAHAAALADBCADA.KAFAQAFAZBFEGDEBECCAdCADMAIBhAAAXFAARCEBADGA.aFFCfEGAhABABFHB.OEEHhAFADHDANIAB.JFHB.FHBA......hBHA......hCAA...,2,-12,-6,6
XEdDRCUGbLTNBAHQcagZIMOfJeKSVYWPF,HAAAaAAAZACBMACA.OAEEeAEAKAHB..SAHB.hAFAVCCAPCEAECFEREFAGDGAhBAATGEAABBBQEDAhCAAIHCA..fHGF..hAAA......hCAA...,1,-11,-22,11
HeOITbWEUNRYXCJZSaABLVDgFfdPKMGQc,LAAADAAAFACD.dAEAMAEAGAGA.HCAAeAHFTDEA.EEBAhABARBDFCBFBZFGBABBBBDFA.hACA.fGAAhAGAQEGAOGDA..bFDBNIBB.XGGChBAA......hCAA...,1,12,-37,49
CQAESIHbRYVWcZGLKdFPOJXDUMBNefgaT,EAAAHAAARACA.VAEAZAFBGCDAdAHA..OCABDAIBBCCDeCCB.aCEChAAATDAA.ABHB.bDGDhACA....cDFDhAAALEEB..FEHDXEADMFABfFCAhADACHHA.SGGDhAFA,2,-13,-12,1
KDaUfMZWLbIPOCQRSBNHdVYAcJgeFXETG,JAAAeAAA.EADAGADADAGA.UAGAZBCELBGB..bDAAODDAhAAARDGB.BEEDHFAAhADAdFGAAAFBFEFHTGCAaFDD.hBAAMBIB..IHHA....hBGA......hBIA...,2,-17,-17,0
MEfXeOdgIZGSKCURPVabcTAYDBQFWJNLH,BAAAQAAAFACA.JACEHAEB.EAGAeAFAdCBAZCGBGCDA.CBHARCFBhAAAaDCD...bEDDACDBDDIBhAGA.LFCBhCAAMDIBOGAASFFAKGGA......hCFA......hDAA...,1,-13,-16,3
bZfATRaJBSOIFKcHdDUNLMegGQEPWXVYC,RAAAaAAABADB..OACDKAFAHCCAdAEADAGALAHB..eBBDhBAAGCFAEBGA.XECAhAAACCHAZDEAADFA.TFAA.hBEASEHHFFFBUGBAMEIBPHCA.YHFGhABAfHGB..hBGA...,1,-1,-23,22
YbSTDNXgCVRJPUEeQLHBdaFWcIAKZOfGM,ZAAAGAAAMACASADADAGA..XBDDCAGARCDAUCGA.EDCBeBFAhABAHFEAdDGA.aCCHFEAHhAAA.IHHAABFAKEEBOEHDhCAAbGAA...gGEA..hCBA......hCIA...,2,-26,0,26
AJRbdNHEFWZcOQDITGBLVUCgeXaMYPSKf,RAAAdAAAHADBEADAZABBQAFA.DAIBGAFALDAACAHAeCEBaDFAMDIBhAAASCHH.hABAADDB.bEEBFFBAOFAAhADATFGABGGA.........hAHA......hBAA...,1,4,-24,28
WJdFVYSBMOaeUcXIACZTDHPfNLQGgKbER,ZAAAHAAA...fADBLADBGAFAKAFCRBFA.dBHAFCAHSCAAhABAMCCB.eDEFhACAXDDAAAFBDEHBQGFChAHAEDGAVFGB.........hAAA......hACA...,2,-18,-17,1
ZRUHCVOaFJEBYeDLKPQfgdWcAbTMXINGS,MAAAXAAAGACBRADA.HAGB.OBBBaAGAEBGFeCDB.LDFAhAFAQCDBdFCAAAIBbDABhAAATFFA.SFHBhAGAZDFECFGAFGFHBHDA.DEAB....hABA......hADA...,1,6,-12,18
CAMcgIKbQSXUTHNdJBDeGPVZWLOFEYaRf,MAAA..gAAAKADAQAFCSADAUCBAHCFCdAGADAIBhAAAeDDGGCCAZEFELHAAhAHAECFBRDABAADA.IGGAhAIAbEFATGBA.BFED.PHDC.hBAA......hBBA...,2,-10,8,18
VeEWKYUdaTQBCFgDIHSfMbLPXOGJcRNAZ,eAAAEAAAKACAdAEA.QAGAFAEA.DBDBHAGB.MCCALDEAhAAAODDAGEBAREEAAAIB.hAAAZEFE.YFDBhABAaEHDCGGDSHEGfGAE.XGGA.hCAA......hCBA...,1,4,-25,29
IdbMUSXfCRWYJZKeAaHDELTcPNGVQgOFB,HAAAEAAALADATAEA.....PAHBGAGA.QCABhAAAFBCHdCEAMCGBXCEChACAREAAJDHB.eDCFAAEAaFFHDDIBhADA.cEFA.gGABBHHA.IHHAhAEA.SFFDhAGA,1,16,-28,44
QSIBJEaKPZcNOfWYAdgRGVbHUTXMeLDFC,RAAAGAAAHADBUAGAMADAeAFALDAA.CAFD.QCDABDFA.hAAAEBHFaDGDZDFF.ODBDhAAA.fDHAhACAACCBdFDAbFFADIBASFFD.KGCANIEB...hABA......hADA...,2,-17,5,22
OUCBLRVbeJTXEdSAMPIfQYagHGNZKFcWD,MAAA..fAAAaACEHAEBZAGBFADADAGACBBD.RBCB..eBEATDCAhAGAEBHFACBB..QEFAhBAAGDFAKDHBODHDhBGALEEDJFEF.SHGAIHHA...hBIA......hCAA...,2,-14,-11,3
RPCMHXNYaEcObDAgeVFSfBTQdJKILGZUW,eAAASAAABADAdAFAKADAGAFAZAGB.RCCA.MBIBHDAB.XDGDhAAAaCCA..EDDBbEEDhABAAAAAFDFH..QGGChADALFBBPEHBCAHAYHAADGGB...hBFA......hCAA...,2,-25,8,33
aFCDUENJYXRgcSLHTBbOdIZeQPAVGWKfM,GAAAKAAAMACAaADA.DAGAEAFA...JAHBRBFASCDB.hAAAHDBBbBCDdCFAeDEHABEB.hCAAfDGACDHA.hCBAUGBBXFDALFHBTGGABGGA..hAAA......hACA...,1,-2,-26,24
TbPQAYSIBXRafZCdgWcDFJLUMEGOHeKNV,SAAAXAAARADA.ZACB.dAFA....gAGBDAHBLBEDhAAAECDBHCFAeBHHKEFAhABATDAAbFDC.AAAABEFDhADAaEHDCHHA.FEHB.MFCBNIAB.QGGB.hAIA......hCAA...,2,-17,3,20
AVaRHfKTZSOgWQJNBDEcFdCGMYUbXPLIe,RAAAHAAAKADCZAFBOACA.QAFABAHADCCA.ECCA.dBHAGCGAhAAAMCFBUEGA.bEDDLDDBhABA.ABFBaFEDhCAA...SGFH....hCIA......hDAA...,2,-34,-8,26
JcDaMAdVNQRWBHbYXSKZETGFLPIfCUOeg,dAAAQAAARADAHAGB...XACAZABBECEFGDCALAFA.fCDEhAAAOEABeEGBhAEAgCFADDIBAAIBVFEBhAGABDAA.bEFA.KFCA.TGAA.FGGB.hBAACHEA......hCDA...,2,0,6,6
cOdJQZBUWSTaLPIXfMERAeCKVGYgNHbFD,eAAAKAAAGACA..gADAHAEAbCAD.DAGA.dBGAZCEEBCCDhAAASAGEaCED.LEFAhAAAXDGAEGCAABIBCEAAhABAVGEAFEDHOFFB......hAEA......hCAA...,2,-24,3,27
FJPAdbQYfOHGKeBaDZRUEIXVTMLWNcSCg,dAAAQAAAOADAHAGBeACADAGARBDB.EBEA..XCAA.hAAAMDDBLBHB.hACAcCDCCDHAFEFBAAIBbCFDfFHAhBAAGDAAaFDBZGBAIGGA.WFHHhADASGGDPHDC.hCAA...,1,-6,-10,4
JMNUOFBEaXgIdHPbSCceGZVATWQfRLDKY,TAAAQAAA.RACALAFBKACCMAFAOBDCEAHB..aCDDXBGBhAAAdDAAHCGBbCCCCEFDeFCBhAAA..ZDFEAFIBDGGBhADAYEEF.UFBABHHAgGFHhBFA.....hAIA...,1,2,-5,7
fCEXbZdNDQJcFTegVUMOSaHKLGPWBRIYA,EAAAZAAAdAEADADA.QAGAFAFD..eAHBUCAAMBCBaCFDHDDBhABAGBDABDHARCGB.ADDBCFGAXFEAhAAA.JFHBTGAAhACAODBHLGFA.IHDAhADA......hAGA...,2,-14,-9,5
YaVLXWGRQZOBcfJITUDNPFedCEbSgKHMA,aAAALAAAGACARADFZAFBBAEA..JAHBTAGA..DCAAFCEDeDDBhABAECGB...SDGAhACAHEAAABBBXEFDhAEAQFAAfGAEIFFAPHFAdFHAbFCDhAFAMCIB....hAGA...,2,-11,-10,1
WHDZdAGcXFKQeVRLgBEfTCSJPaObIMYUN,GAAAFAAAeACHRADALAGBBAEA..EAGATDCA..SBGAhAEAaCFBOCHDbCECMDABhAAA.UFFAHEFAdGEChACAADDBKFCA.QGAC.fGHAhAGA.CDHA...hBAA...,1,-4,-20,16
MHRfJPbGDATZUBEQaXLCgWcFeIdVOSNKY,ZAAAEAAA.aACALADA.CAHA...gAEHFBCHeCEAdDHASAGHhABAKEAAHECBRDDAJCHBhAIAGEFA.AAEABEEAhAAAQFFC.XCCCIHAANIBBfGDFhBIADICA...hAHA...,1,-11,-13,2
ITaROXZDUKNfgcdYAMbeCGEJQVSPHBLWF,eAAAEAAA.QADASACAHAFALAFAFCCBaCFERCCAZCFB.KCHBhAAAfDEEdDAAAAGAMEEBhADAGEFA.PDHDhAAABFCATFGADHAANIAB.......hABA......hAHA...,1,-1,-10,9
bEedVTBHWJOFKLYNfUcZQMIPXGRDgCSaA,EAAAeAAAdADABADAHAFAOAEDLBCD...fCFEhAAAZAGBMBIBXCCCRDDFCCHA.hAFAAAAA.bFFA..TEEAhAGAFHAAKHEAUGBA.QEGC.IHHAhBGADFFA...hAHA...,1,-4,-15,11
WfbIRLUADVdXMKEBFJcCHSYTeaPNgOZQG,dAAAMAAAEADAFADD..CAFAHAGB..TAFAeCAA..aCEBgBBDhAFAZDAEGDFA.bFDDhACARCEBAAHA.DBIBKDHBBCGAhBAASHGAPEGDOEEH...WFHHhCAA.....hADA...,1,-4,-20,16
OGfeBJLYQIDUMcbXFWCaNTdSZVPKHAgRE,EAAAGAAABACALADA.QBGADAEAMAHB.XCDAhAAACBDA.aDCCdBFAZEAAKCCDHEFAhACAREDAeCHHIGHAhAEAUGGAFFCHTGDA.SHAAAAIB..hAFAfGEA.hAHA...,2,-30,8,38
ZbFVaJYDTeWMBLdIRPgOHfcKQESUXGCAN,ZAAAFAAA.aACADADA..eAEHMAGBLAGB.RDDA.OAHBHEGBKCCDhABAEBCAUDDAGGBBABFB.hAIANAIA...VEGB.hBGA..TGEABFFC.dECC.....hCAA......hCBA...,1,-3,-26,23
ONfcCPXVDAgHILadTSWZeJERGUMQbYFKB,HAAAaAAA.dADA.TAFAZACBEAEA.RAGBGCEAMAIB..QCABhAAAFDHDOBBBfCEAhACACECA.XCGDhAFAAAIBLGDAeDDD.bFEDBHGAPHAADGCB.SGGAhAHA..hDGA...,1,5,-16,21
NTPBQUgbXMIZVGYLRHKJSADFOefWdcCEa,OAAAeAAAdAEA.EAGAaADD....TCCAQAFA.bCCAhAFAMBIBZDBA.GCFAhAAARDFFHFGBSDBDhABAAAIBFHBA.fEEECBBD.BFDD.XGAAhAGA.IFHAhBDA.LHDA,2,-15,6,21
DeLMaOTANJQVYHcbXUgSGCdKFEfZPWRIB,QAAAHAAAXADBSACAdAGAFCAHECCBZAEBRAGB.BCDCLBFDhAAAaCFD.AAIBJCHB.VEDBhACAbDABGEGA.hCDAfEEEIGGAMFIBNIAB....hDEA......hDGA...,2,-2,-2,0
ABRCcXPdMDITEQHfLFbeaUZJGNSVWgKYO,RAAAXAAAdADADAFA...EADAHBEBLAGBeAHFZEEAGCDA.SBFFhAAAVGBA.KDAAhABAAAAACCCDMAIB.TFFAhADAQGECbGCCaHFE.NEIA......hBGA......hCAA...,2,-22,12,34
NMOPKbSXWeCQHJFUgBAdRVZcYGLIEfDaT,RAAAZAAAGADAEADE.DAFAaAFA..MAIBKBFA...SBFBhAAAeBHHHCAAFCCHBCEDABHBdDAAVEEAhABALEFA.TFDAhABAOEHD.bGDCCGGA.......hADA......hCAA...,2,-17,-9,8
JRFKUYCBNOdeQPSVAXfDHTMbZGLWgEacI,DAAAHAAAMADAGADALAHBEAFA..aAHDJBBARCAAKCFA..CBEBBBGAhBAAdEFAeDHF.QFAAhAAASDDAAACAfGHAhAFAZEDE.WHBAgEGH.hBHAFGBB.....hCAA...,2,-35,2,37
KTLICAaWdORbeMXQGZBNYUPJFHgcVDEfS,dAAARAAAeADEMADAGAGAZAEEBBHAUCCA.FCFHHCAC...VCFBhACAEEBBKEHBLEDBAAAAOFFBhAGAQFFB.hAIANDIA....YFCD....hAIA......hBAA...,1,-13,-22,9
fJLWaMZHOSQbDYBdCeTAEIUgcGVXFPKRN,EAAAUAAAGACAFADA.RAEA...JAGBaAHDHCBCQCFD.DCBBhAAAdCEAeDHHAAIB.IFAAhAEAVDGBKFFDLFFBhAFAZGAA.bEDDCGHA.........hAGA......hBAA...,1,10,-30,40
ERHXPIMKLGdJAZVafDFSTWYgCNOcQeBUb,aAAAFAAA..SACH..TADA.gAFBhADAOAEAeAHFBAHBEBEBHCCAhBAAXCFDMBBBGDFAhCAAACIBZDDFDEIBCCHAQFCARFBBKFFCdHGB.fFHAhCCA.NIEB...hCFA...,1,-6,-10,4
HegJWMAXSaRPCVGIfbBOLUcDQNYFKZETd,aAAARAAACADB.GACA....bAEDLAEADAGA.QCEAhAFAFBGAECCA.HCGD.eBBDhAGAgDFAMEEBAAIBSFFBhBAAIFHAOEEHNEIA.KGCB..hAAA......hABA...,1,6,-35,41
GIUCVENWRYKBbFdecaQJXADTPLgOfMSHZ,TAAALAAA.OADDMACAHAECGAFACAHB.EAHBRCCABCGA.dEEAhAAAeCABQFCAhBDAAAFBDCCBfDDEZGFE.hCAAIDHA.VFEAYCHB..hCCA......hCDA...,1,-8,-11,3
ASWXLITEVaMNPdGeDURHFYcKZgOBbCQJf,XAAATAAA..EACEaADA..MAEAdAGAeBCHRBDAHBGBFBEHKCCDZDEEhAAABDEAQFFAhABAAAIBLFFAIGBAVGBAPHFAhAAADAIB..cGDA....hBGA......hCAA...,2,-17,3,20
FXGVYbLAMIKOUfCENPRcWJBeZHDQgTSad,MAAAOAAAUAEA..EADARAGB...JAFBeBBAHBGBQDDAhAIA.SDGAhBAAdCCAGECBVFGBbFGDAAHAfGDAhBBACGEANBBA........hBCA......hBIA...,2,-17,-16,1
DAaEXfgHUQMbGOLIJcFRBNKYZTPVSeWdC,EAAAXAAAHACAMAEAGADALBGB.JCCFRAFAKCGA.ZDAATEEAhAAASEFAdFHAAAIBaFCChCAAfFAA.hCBAQFDDbGDA.OEHD.FGGH.hCEANIAB......hCFA...,2,-5,0,5
VRaAITGQeXCLbWZFEMDOSdUKgBNJPcYfH,GAAAeAAALAEAZADAEAGE.MAIBDCDAdCHAKBCABCEA..PDDAhAAA..fCGAhAAAHEACREFBAAEA.TEEAhABACFHBFHDA.SEGH.gFAAhAFA.cGCB.aFHDhAGAIHHA.,2,-10,-9,1
EcGKDIBWLdNQFPagTXfYbZVUJeOMCSHRA,EAAAGAAADADA.BADAdAGA.QAFAFBCA.aBHDTCEA..hAAAfCDAZDGBUFBAeDDBhAIAMCFBHEFBABIBKGEA.hBFALEHB.gFAA.XGDChAAA...hBGA...,2,-26,1,27
EgYUAITPBCLKScfOdaDbGJRVNQHeXMFWZ,TAAACAAALACA.KAGASACB.OAEAaCCAGCEAhAAARBDFQBGAHCGDeDAAhADAMCCBZEAEEDFBUGCAAEHABFBDhAAAdGGADFIBbFFANIABFGAD..gGDEhAIA......hBFA...,2,-6,4,10
ZcLNMUBWPeSEFRXOTVIDKfbgGJYQCdHAa,ZAAALAAAMACABAFAeADHEAFA..RAGFOBDDTBGA..DCAAKCFDhABA....bCEDGEFAhAIAQDGBdFHAACCBaCHDhCAAcFAA.UGGA.SEDDhABA......hACA...,2,-25,-12,13
aDKSgeXbQMOYTLEJUfCPRBHAVFZIcGNWd,ZAAAGAAAdAEAKAGAeADA.QAGAMCAB.TCDAECCB.UDGAhAAACCFARCGF.HEAC.AADAFFEBhACAIEBANIBB.aEDDSGGAhBAA..bFED.OEHD.hBCAJGAABGCA..cGGChABA.,2,-30,16,46
QcRPLSDgYFXdAKfaWbCOUeNBMTVHJIEZG,aAAACAAAUACABADA...MAFAHAEA.EBHFGBDBRCFB.LBHBhADADAGAFCBH.ABBBKCCD..hBAAbDDDeDEA.TFFAhBGAIFHA.....cGGCSEDDhCAA.YFHBhDAA..,1,-11,-36,25
OeHCWXUABQDgSIVNbMRfKdJcYaFZGETPL,QAAASAAA...IADAVADAMAHBRAEFdAGA..JCCBaBHDhAAAGDFAECDB.TFDAhAAALEFAHGAAXGDAhAIAAAIBDCIB.gGGAfDAA.KFHB.hBCA......hCAA...,2,-13,-4,9
FZTGNbJOHMWPDCYBQKVUeLXgIfESAaRcd,RAAAdAAAZADBGADA.JAFAHAFA.MCCBDCCBBCFAQCGA.hACAKDABeCGHLEEBhAAAXDADfEGEhABA.AAHAaFCDTFEANIDB.ODDHCGGD.YDHBhADA....hAIA...,1,2,-35,37
dGORTMXZEfPQVeCaJIKSNbFYADBUWgLcH,BAAAUAAALADAHACAGAFARAGF.MAIBECDA.QCAA.hAEAeCDFaCHDKDCDSDGHhAAAbDFD.AAEADEEBgFABhAFAdGGAXFEDZFDBfGHACHAANEIA.hACA......hAHA...,1,0,-9,9
DaKAgJbPFfXMBRGdeTUVEIcNYWSLHZOQC,JAAAFAAAMADAGADA..eAFAUAGA..EBCA..IDAAhADA..cBGD.hAFANCEA.SCCDhBAAHFCBZFEBQGGAaDFAABFAbEFAXFECdCFC..hBIA......hCAA...,2,-31,-2,29
GUNSJROKbAFDdPVaWTXcQEIeYfLZBgCMH,dAAAaAAA...TADAQADAEAFE.eAFALAHBZCCABBHAMCCBhACAHDAAGDDASCGDhADARFGBbDAD.ABBBDDIBWHCAhADAXEEC.IGAA.fFGAhAGACDGD.JHDA.hBAA...,2,-7,-1,6
fNUMXQdSRAbWgcDPZEOGHTaJICLYFBVeK,...bAAAgAAA.DADAEAEAHAECaAGDCCAALAHBBCCDeBHHhAAAfBDEUDEAMEAAhABAdDDDAAAA..PEHDhACAGDFA.TFCAIFCAFFHDKHEAQGEAhAEA.SGBDhAIA.,1,5,-14,19
BfRGeJMPYFQNLOWbaDXZHcdSEATICVKUg,TAAACAAAKACA..BAEBRACFGAEA.eAGBMAGBFCAHLAHBhAAA.OCAAaAHFZEAEHCEBhACAdDGDAEEBUFGAJFFA.QECChBHA.NIEB.DIFA..SHCChCEA....hCHA...,1,-8,-22,14
AWEQPOHgCDbTSIcKZMaFfBVLRdeJNUGYX,EAAAQAAAHACADAEASACAKAGA.aAEDBCCD.RCEAeCHHhAAAUAGAGDAAACEA.OCDBhAAAbEFD.TDGAhADAIHCAZEEFMFIBFEEH.fFDA.hAIAdGGA.NIBB....hCAA...,2,-23,17,40
XGfDQSLUgZWMCaJIYEFeRcNPBAOTKVbHd,TAAAKAAAHACB.GAEBQACCLCABZAEBMAHBaCED.IEAAhAAAECGAREFA..PEDBhAAAAAIBbCFD.dGHA.DHAASCHHhAEA.gECACGEA.FFHDhBGANIAB......hCAA...,2,-13,4,17
VaZBceQYSTLEGgFRDWPfCbdNOIMUJKHAX,aAAAZAAAeACE.QAFCTADAGAFARCCA.DAIB..fBHAhABAdCCAOBBHMDGBhAHAKDHBHEDAADIBBEEASDADhADAEEHBFGHH.CFGAIHAA.XFAAhAFA.YHDAhAHA..,1,1,-22,23
MaKVWNCSRTAYbeGHQfgEDdPLUBJOIcZFX,eAAAHAAAQADCEADAdAGALBFDBAFBOAGDZCCBFCHD.aCACKEEDVCEBhAAA..CFGARGDAAAIBGEGAhACADCCB....hCCA............hCIA......hDDA...,2,-25,-13,12
HRcBaLXFWGbeUCONYDfgEPZAJTIKdQSVM,TAAAdAAAQADA.MAGBHACBRCAABAHAaAEALAHB.hACAFBFHbCGDeCAB.ODEBhAAADCIBEDEBABHBKEHBSFBAhADAXEBDGGEBCFFAfGHEPHAA.hAHAIHEA..hACA...,2,-12,1,13
fJaZQXeADOUbHGdYVCTPERgSWFLKBMIcN,OAAAHAAAdADA.CAFA.EADARAGF...SAFALCCAMCAB.hAGA.ICCA.hAAAfBHAZDFEeEEDAFIBhACAbCEBVFAATEGAgGFHKEDBBGDDNIAB.aGEDhAIA.QGGBhBAA.DBBB.,2,-20,1,21
GUOEWPNLRAfMbBFdDJKVTZcYXgeaISHCQ,MAAAFAAAdADAKADAZAEB....XAFBeAGFaAHDHBBA.GBGAhAIAECCB...PCEDhBAARDFAADBBBEEDDDDBTGEAhBBA..gFGACGGB....hBAA......hBDA...,1,-12,-32,20
NTCeLHRGBfASOEWMKJVIFQPZcDagdXbYU,EAAAMAAAKACA..VADAQAEC.ZAGBaAGAdCCA..bBBDUEEAhAAA.CDHAHGAARBGBGDDAhBAAAFDAOFHBIFGAhBBA.FGHDDICAXGED.....hAGA......hBIA...,2,-16,-5,11
YdGXDTEFJCNbKaPfVOQZMLAIeWBSUgcHR,eAAASAAAUAEAHAGDRACFGAEADBDBFDEACAGA..KBHB..aCCHVDGBhAAAZEBALEHBhAAA.ACIBBFFAgEAAhABA.dEDAEHFEbGDA.......hABA......hAIA...,2,-17,-9,8
MfPFSQACZNLBRYKVGHcIDTOWbEUadJXeg,ZAAALAAARAEAKBHB.HADB.DAFAOCABEAHFdBFA..eCCBMCABFCEHhABAACCBBCHAGDGATEEAhABAUGCA...aEGAXFADhACA.fFFEQGGA.CDDD.hACA......hCBA...,1,-13,-16,3
HFELBJSOPfMgGcQaIWVeDKRZTCNdYbAXU,HAAAEAAALADASACEOAGDMAFAGCBAaBDE...IDFAhAAAeBFHRCGFZDDF.TGFAhAAAdDDAAAEAFDHDBBHBfFFAhAIA........hBCA......hBIA...,1,-7,-22,15
XJLDYHFQegROKcWIZSPVGBfNbUCAdEaTM,EAAAaAAA...MADALADAHAFCeBCBRAGFKBBD...ICEAhAAAZCDASCHHGCFAfDBAhAIAUEAAAEEAdFCATFFAhAEADCIBFEEHOFHB.PHDABFHBCHHA.hBDA......hBEA...,1,1,-15,16
ZeNVGbHDITEaCcLJOUBMFWRKYfAQgSdPX,QAAAdAAAZABBeADAGACBHAGBDCEBEAGEaCDCLDFA.ODCDhAEAMCFARDAA.KDFAAAIBSFFAhBAAXEECbFAATGBAhBGACEHA..cGGABGHA.FHDE...hCDA......hCFA...,1,9,-12,21
LIDMdFOKRVXPTYUaESCeJfAHBWQcbGZgN,HAAAQAAAGADAZACBLAFAMAFAdBEAKCADRBGB.XCFA.hAAATEFAaDEEEECBeCCBhAAAABIBBEHA..bGAAgFFBhBCADCIBOFEBYGBACFHA...hACA......hADA...,1,3,-8,11
TdPSZbgcaNJWfKMEFAXGHQLVOBeRDYUCI,HAAALAAABADBRADFDAFACAFAdAHAZBFB......bCAAaAHDJCEAKCAAhABA.EDDBADIB..GEDAhAAAQEGAeFAAIFHAhACATFCA.SFFBgGGG.WFFDhACAFHBA.....hAFA...,2,-16,-13,3
AQTNabdSVLGBWgYCcXFUPIOHJfZREeDKM,TAAAaAAA..dADALACBGAFABAHA..gAEAhAAACBBDFCHDUDBAOAGDHDEBZFAAhAFAEDEAeCHHMFHBADEBbEAAhAEA.SEFH.YFHBPHAC.hAHA......hBAA...,1,2,-12,14
PIDXfdWVGCSTONRcZAFMEbgeUaQKJBYLH,EAAAeAAAUADAQADABAFA.HAFADAHB.dCCAGCBATCGARDDFZDGBhAAAAAAAMDFB..aFFBKEDBhAHA.LFHB.hAIAXGEAfGCA.CGHANIEB....hBCA......hBDA...,2,-24,4,28
XZWbHSdLUfVKYcCaJeTNAEgFGIBQORDMP,EAAAGAAABACARADAMAHBZADBHAFA.LCCDVCEB.KCGA.CDEA.eCHHhAAAAAHA.FDCB.QFGBhACADEGAXFCAbGAA.hADAdFFA...fHGFaEAH...hAEA......hAGA...,2,-20,-6,14
YZCXDaWfgeTAEURNLJMbPQGBHSFOcIVdK,RAAALAAAMADA.QAEAHAFCOBDCVCAAdDDA.ZCFEDAHBaCCH.hABA...fCHAhACAeEGBEFFB.UDEANEIA.hAAAbEAABHEAFEHDKGBA.XGEA..hAEA......hAIA...,1,-4,-8,4
JNZDREaWTgfAeUHbLdBQMYXGOIPcKCSFV,HAAAdAAAMADAGADA.OAFA.ICGAKAGAFBDAVCBA.hAAAZCFBECAB.aCCHTFDAhACAABFAeCHHLDHBhAIAQFDAXGGCCDFDSFGADICA...hBAA......hBCA...,1,3,-20,23
HZEcUXSgTWVJIRDYOFQeAbMdGCNBaPLfK,dAAAGAAABADAaADALAFAHAFBZCDFUCCASAHB.TDGAhAAAVCFARDAB..ODBDhACAeEFBAAGAMDDB.CFGDfGHAhBAAEEHF..XFCAJHBA.hBCADGIB.....hBDA...,2,-23,3,26
JEKReZDaNFCIgSOQUYWcMbTXfVAHLBGPd,HAAAGAAAdADAEADARAFAeCABZAFBDAIB..aCCCCCDA....SBHDhAAAQCFBUEEAcDGDhAAAMDAB..bEEDTFBAhACA.XGFAAAFABGGB.KEHBNIAB...hACA......hAIA...,2,-9,-8,1
OGSMBbIcHVPXUNRYZdEFeADKJWCQfaLTg,KAAACAAA.QACCaACALAFA..TAFAGBCABAHB..hAAAbCEBHCDA.XCGDhAEARCGBdCBCEFGBACIBDEFBfGAAhAAASFAAMEEBIFHA.cFCDhAFA....hCAA...,2,-30,-8,22
deBOJYGcEgLKMbTHFUXRNQCaAISWDZfPV,SAAAZAAA..fADBdADAeAFAOBHDGAFAEAHBLCCAhAAAMCABHCCCXCFDhABARDGFQFAAhABAAAFADDBBBEEDcFEAbFGBFHCACHHA.......hACA......hAFA...,2,-8,-3,5
cPfRDEICGNTYMKQZAHVLXdgWbFaeUJBSO,HAAALAAAdADA...bADDeAFA.BBHAOAFAfCAEhAAAEBFBGCAATCEAMBIBZDGBhACAACABXDFAFCCHaEECSFAAhAFARFFBCCCCKEEDQGBAgGCAWFHHhABA......hACA...,1,6,-1,7
VcGJCgNBYOMDIXFSPKLQfEUTHWadZeAbR,RAAAGAAACADB.BADAMAFADAFA.FAHDKBEALBFB..EBGEHCDDhAAAdCCAAAAA..bDGDVDFAhBIA..JDCF..hACANEEA.ODAH.SFFDQGGA.hADA......hBAA...,2,-32,-19,13
gdDRTGMJPbWVCFOaXEHUeYNQfASZKcLBI,ZAAALAAABADBdAFARADFGAFA..MAHBJCAA....bDEDCCAAaCCChABA.HDEAeAHBQECChACAADHBKEHB.IFGAhAIATFAA.PGDCFGHH...OFBHhBFA.....hABA...,1,-14,-17,3
SgCAIXPKDEMWZVOJYdLTQefNFUcHabRGB,XAAADAAAEACA.ZACBOAEC..dAFALAHBeAHBFCEHHCCAhAGARCGBGEBASCEEhBAAAAAAKEFB.MBBB.VEEAhCAAYFHBfFHA.NHCB.....hCCA......hCHA...,2,-14,-13,1
CNgMOPKSEGHRQFaJDBUIYLbcTXfedWAVZ,ZAAACAAA.MACAKACAGAEAHAECRCCA...aAGABAHB.UDGALBGBhAAA.TCAAeEEBACHAhABAVDCBOFCB.EGGAhCAAQFFADGEB.YEAF.XGDDhACA.WDHHhAEA...,1,-14,-23,9
AdHKOJZTVMeBLfYXQGFSgUbWcCREIPaND,HAAAOAAAZADB.MAGBeADALAHB..XAGAGCEASCAAhAAAbBBC.hAEACEGAEFBAaCDEACGAdGGATDFAhAHAfHBBQFFB.FHDA...hACA......hADA...,1,-8,-12,4
BYXICOZLWJDGVNFKSRbdTcaEfeMgQUAHP,HAAABAAA.XADBOACAZAFBLAGBDAIBGBCAFBFBRCAAdEDA.aCHDhAAAECHB..eFEHMCBBhAAAQGGAACEA.hBCA.IEEA.CEGAVFBB.SFGAhBFA.bGEC.hACA...,1,-5,-15,10
dPALRXBNZYSfGWDIEVeMbOFcJCTKHaQUg,RAAABAAAZADB.SACAGAFADAIB..EAFAeCCDMAIBFDAB..CBGAHCAAhAAAaDGD.QCEChACAdEEAAAAALFBBXDGDhADA.fEDEIGGA.bFAB.OFFBhAFA.....hADA...,2,-21,4,25
CeMVIFYPfJBDQELacgZOTUXSWdNbGKRHA,eAAAMAAAFADD..fADADAFALBBBaAED.ZAFE..TAGAhAAASCFAdCGDGDDAhABAHDDAACIBCCCDVFGB.hBAAIGAAPEGDQGCA..hCAA......hCBA...,1,-4,-23,19
OSbfWEAUQNMdTDJZcVKIHYeFPXgCaRGLB,QAAAdAAADADAZADE.KACAHAGBFAEA...XCAAaAGDGCDALDDAhACASBHH.hAIA.bEFAECFBACFBMHEAhBAATFFA...........hBCA......hBIA...,2,-21,-21,0
gOIRDCVLfJPWQXYNAETaGedKZBSHcbUFM,EAAAGAAAdADAZAEBHADA.UAGAMAHBOCDBRCBB.CCFDLDHBhAAA.JEEAQDFDhAAA.XFGAhAIAADABeFABSGGDbGBAFGFHDBIB......hACA......hADA...,1,-9,-13,4
DGcaPYUbZNXfgIKRAVBFQETOJdLSeCHWM,FAAAEAAA.OACDdADAeAFAHAEA..MBCBGCDA.aAGAUCFAZCFB.hAEAfDDAKCHBAEHBQGGAhBAATFAALDHBhAAASFDDDFFA.PFDD....hAFA......hAGA...,1,-7,-16,9
JDBfcHNZTAFbEdQCPVSYKeLWMgUIOXaGR,EAAAdAAAQADA.CAFA.SACA.eAEHMAHBgAGAhAAAOCAEGCFAhACARCCBBCHAHEDBZDAFAAGAFFHBhADAbEFA...PFDD.KGGA...hAIA......hBAA...,1,-5,-21,16
fVHeKIPWgZJXLRYaMdQOFUSbBDcCGATEN,EAAAVAAAHACA.eAEEKADC....IAGAgBGA.ZCCAhAAALBFARECAaDHDdEGCQCDChAAAFGHDSHAAhAHAbDFADFFA.GGDBACEA.NIAB.....hAIA......hCAA...,1,10,-21,31
JTbSHMDgGEKXVLcNWCFPRZBfYdaUeQIAO,TAAAHAAAMACA.GAEBEACEKAECLCCA..NAHAFBFDRCGBZECAhAAABCCAdGEDeHAAAAIBOCEHhAAASEEE.hCAADFIBXEGA.cFFCCHGA.fGEEhCCA.aHGE.hAHA...,2,-21,0,21
GVUPLcNbDeFTaZHSBQXIYKEgOJRWfMCAd,GAAAUAAALADA..bADAeAGHaAHBHCDAQCDA.hAAAXDGAKCHBEDCBODAHhACAREAAMFFBAAEAdEFAPFDDhAIADEHBFFCH.SFHHBGGA....hADA......hAEA...,1,-2,-8,6
JfDFEWcQaUXbgAeZPGdMTBINHKCYVLROS,eAAAGAAAdAEAMADABAGAHAFCKBCB.CCDALCFARCEA..SAHHhAAADDCBEEEAQEGAhAAAaDGE.bGCAAEBAZEBEhABAIHHAVFFAOGAE.....hACA......hAIA...,2,-19,-5,14
cZHeKUNTQdSPDXOBFGJWCIVbRYgaAMEfL,EAAALAAAHACAeAEEKAEAUAGA..TCDAdCAADCCABAHBGCDBhABACCFB..ICHAhAAAREAAaDGE.ACCBMEFAZEEAQGGBhACAXFFA.........hCAA......hCBA...,2,-22,-11,11
GQBIeMTWCcgAVdRfHPJEOSZNLYKXUFabD,RAAAHAAAEADE.ZADBLAFBXAFAFAHB.DCCAGCEA.QCABhAAAeCHFMDDBTEGAhACACEEAAAAA.dCGD.fGAAhADAOEGHSFCDKGGD.aFHD...hAGA......hAIA...,2,-20,4,24
eQBOTFgZLMVWaJNGPYRbEdcIXHfACUKDS,KAAAeAAAQACCOADCFAGAZAEB.LAHBMCCA...aBGBGCEBhAAAREAAdEEA.XDDChABAHGECADDBDEIBTEGA.hAAAgFAAWHCG.PFFB.EHCA.hAEAIHHA..hAFA...,1,-6,-13,7
bAHGOaEXJCVfDeYFUMWdTZLBcgINQSPKR,HAAAaAAA.EADECADA.DAFAFAFAUBGA..dCCAZCAALBFABCEA..hADAIEEAQDFAhAIAKECDACCAGEDA.XGGAhBAAfEGAMBBBTGCA.gGEBhAAA.NEIA..hCAA...,1,-15,-24,9
YWEPHfDCNGKUJZOdVFSQBIeTAMXRgabLc,RAAAaAAALADB......cACDEAFAHBFCDAFAGBEAhADAKDCDZDFAdFAAFAHDQDGAhBAAeEEBAAAAMIAAbECBPHFChAFACFGD..NBBA........hAIA......hBIA...,1,-9,-18,9
IgJZAQNdWTYCfbSBLUPDOVKMaRGFHXecE,dAAATAAACADA...SACBLAFADCCAKAEARAGFHCDC.eCGHhACAECCBJCEBAAGA..QDAAhADANCIA.fEEEhBAAbDFDBEAAOECBaDHDGGCBXGADhAAAgGGBYHEA.hBCA...,2,-16,-6,10
TRSEDKVMUPNaJAdZHceIfQWFCOBYGLXbg,HAAAeAAAQADACADBBAFAGAGALAGB.XCCCbCAARCEBDDIBhAAAMAIB.UEEAaECCAAIBhACAZFBB.fEHAhAAAOFABTFGAEGHFKHEAPGDC....hAFA......hCAA...,2,-8,8,16
ZDWAYOIFgNcVMEfKPQGXUBCTJSLedRabH,OAAAFAAA....gACHVADAEAGE.KAFAGCCABAHBCCDATCFAhAIA..LCFAhAFAREFAaBBH.HEEADCIBAFEBhBAAIGCAMHCAfGHAQGEB..hBAA......hCAA...,1,-4,-33,29
BGPcHMAUgdTDEReZQfCVFWabNISKOJLYX,dAAAEAAARACAeADA.ZABBQAFC.CAHB.FAGD.bCECSCCAhAAAOCHD.LCHBhADABDCAGEAAHDEAADGATEFAhAEAfFGEaFCAKGHB......hAIA......hBAA...,1,-10,-12,2
ZLUMdgPBGYbICAEKQTFSNDeXRcOJWVaHf,EAAATAAAFACD..DAEARACF..OAEA..VAGBHBEAZBDBMAIBhAAAdDFABDHAGDEB.bFFAhACAAFCAQFGAhAAAeEDBJHBAaHFA....fFEE..hAIA......hCAA...,2,-35,13,48
EAPSGgHOdbBMVKTLYXUINQFDaecWfJCZR,GAAAHAAAdADAMADATAFALAHB.XBFBICHAQCDAhAAAaCAC.eDBHhACAfCEAZEFBAEIBSFDAhBAAbDFDKEHBUFAADGIBJHCAEHEAODDHBHGA.hBCA......hBDA...,2,3,3,0
YAICcHGQFUDJdLKfPXZaMeTNREgVWSOBb,CAAAHAAAGACAQADCDAEA.dAFALAHBfAHAZBEBeBGFhAAARCAAECHF...VCABODEBhAAABEGAADFAFEHDKFFDaEHDhACAMFFB.gGGG.SHAAhACAIHHA.....hBCA...,2,-21,15,36
HAdCGTgLSEWRMZXbPYeBVJDUIaOfNKQcF,GAAATAAA.LADAEACE.RAGFZCDA..bAEBeCHHBAGADEABaAHDhAAAOECAKCCA.QFCChAAAHCFBADHAdECASFAHhACAMEEBXFFAPFFB.....hCAA......hCCA...,1,0,-12,12
TcRSQYgdKPDHaVJGfUXNBEAMOZbFeLWIC,ZAAAeAAALADBCADA.RAFA.QAFAdCAADCCBHCFCaBHDGCCAhAAA.XEFAEEEAAAFAMEIBhABAbFAB.FFCB.TGFAhACASFDH.KGGD......hABA......hAFA...,1,-10,-15,5
cWbKSYEFXATVDHPaROBCUedZJfMgQGINL,TAAAHAAARADFCAFB..eACEZAGB..MBIBGAFALCFD..hAAAbCCBSCAAhACAEAHBADBADDHBaEDDBDDDdFAAfEGBhADAQFFCIGGAWEHH....hCAA......hEAA...,1,-1,-22,21
BcQIdKAYVEDOaNZHRXeTUMWCfgPGSLFJb,EAAAaAAAHACBRACA.eAEAMAFA..CAHA...fBFAGCEALCGBhAEAFBHBBCCDQFAAhAFAdDAAACEBDDGBZEEFTGDAhBAAUGGAgGGASDHH....hAAA......hADA...,2,-19,6,25
JUOZBRfCLESaXGNHgdbKDPQVWcFeITAMY,MAAAUAAAZADARACA.LAGBEAFE..aAHDGCBBHCCC.dEAADBBBQECBhAEA.VEGBhAFAFCGHeDHH.AEFBOFCBhAHACFEA.XGFCNAIA....hBAA......hCAA...,2,-19,-10,9
ZYfFRAbTUHKeOECIcDGNSWdgLVBaPMXQJ,TAAAHAAAeACE.EAFECACBDAEAGCCA.SAHBdAHALBEBhAAAaCFAMDIBQCCBhBGAZEFBFFEBACGBKDGAOHFEIFFAhBHA...WFHB.BHGA..hCAA......hCDA...,2,-31,7,38
EgVBUePKFcdJQGCRXSNTIfMAbDZaHWYOL,ZAAAHAAAOACAEADEBAFBUAGAeAGH.FCAHdBFCGCCARCDB.SBHHhAAATDGA.MCFBhACAACCBDFFBaEFD...LEHBhAIAgGFHKHFA.......hCCA......hCEA...,2,-32,1,33
AGUdWgRJLXZPMYfEIOCcDbFSNQeBTaKHV,dAAARAAALADBZABBMAEAEAFA..CAHA.DAIBFBEA..QCFAhAAABCEDKCGA.HEEAGDBBgFAAhABA.XFCDhAFAfEFAOFHDbEGD.eHDA.aCCBAEIB.hBAA......hBDA...,2,-35,11,46
OUcdETefRSJCbXBLFYIAPGMaHWZQDKgVN,GAAAHAAAZADBQADAKAFA..gBGAOAFCdCGAECABeCDBhAAA.RFDACDFCBCCCLFHBhACAFDEDAAHAaDGEDCIBNDAATFCAhAAA..SGFAbFGB.YHAGhADA....hAHA...,1,-5,-9,4
UNTcZJXYgFBAdfOGeELHMPaQVKIDCSbRW,dAAAGAAAEADAHAFAaADAKAGACCBA...RCDAUCGATCEA..ZEBBXCGDhACAFEFHBFHA.AAAB.eDABhADALHFAMDDBQFFAhAHADGAB.SHGA.NECA.hAIA......hBAA...,1,-6,-22,16
QGfDdNLJeKBbFMHWgVOcICEXSRZPTYUAa,GAAAdAAALADAeADABAGAMAHBHCAC..gBGAhAAAOCFBCDHAEEABRCDBZEAA.TEGAhACAAAIBaECDDEEBKFFDFGHDVFGBhACA.....XGEDSGED.hAEA......hAFA...,1,-4,-10,6
YPZeOACbRDcWUTJVQFNXMIaGSBLKEfdgH,RAAADAAAUADA..TACAQAFA.FCCHMAEA.GBEAhAIALBHBEBBBdBGBHDFBZDGBhBAAAAAACEDAbECB..JFHBXGEChCAAaHDA.BHCD......hCEA......hCHA...,2,-19,-12,7
UdFPeRWcaDKZMIbESJfGNAQOgXHLBTVYC,QAAAXAAAHADALADABAGB.TBGACBHAdCDD..FCGHRCBAaCFHhAAAZDAA..MDIBEDHFfEAAhAEAAAAA.OECChAFAgEEBUFGBeHAADFAAKGHDSGDBhAHANIAB....hAIA...,1,5,-14,19
OYWacCZMJDANRLBTdQPeKEGUfSFXgHbVI,RAAATAAAdADA..eAFAEACEGAEAUCFA.FAGAHDDB..bCCDOBHDhAAA.aCCHZCGBMFABhABAACCBLEABBFGAKGFDhAFAXFFC.gGBHIHHA.WEHHhAAA.....hAGA...,2,-17,3,20
XgCdRfKWHbcIMETOSVFAZaBPLYQGJeDUN,aAAALAAAGACAeADHDAEA.UAFA..XAFAdBHARCABKDEAHCEAhAIA...bEBAMEDBhABAEDHFSBBDhBAAACCBZEFEBFBAQGGAgFFBfGCAhBEAIHEA......hBIA...,1,-8,-12,4
gOCEUdKMARPVfLWeaGYbNZDcFBSQTIXHJ,RAAAVAAALADB.eAFAGADA...bAFAZBFE.FDCHQCFAhAAATDGAHEEBODAAhADAEFABdGHAAAFA.fGDEhAAAaDHDDEFBSGFA.IHAAhAHA.....hABA...,2,-8,-6,2
MOEGFPLBfXQUaCHYZKVRWgDecISNbTJAd,dAAAEAAAGACALADABAEAQBGAUAGAHCEAZCAERCEBDCBB.eDHFhAAASEAA.bECDhACAAEABMEEB.FFFBXEGAhAEAaGBAKGHB.gGGBNIBB.OHAChAFA.CHEA....hAEA...,1,6,-9,15
RHMVDgWYPdJZfSCQBbLXAOIacFUGNTeKE,aAAAFAAAGACA.eAEARACFHAEB.MAHBDAIB....gBFAhAEAPDEBZEAACDGAQEDAhAFAbFGB.ADIBOFFAhBAAIGAAcGGCTGEA....hAEA......hAGA...,2,-19,-15,4
DZJHcKCWNFYMQedIAaSXTOgbVGUBELfPR,aAAATAAA..OACD..bACBGAEAEAEALAHBRAGBZEAAHEEChAEACBFAFCEHMBBBdEGAABHBXGAAhAGAUGDABGHADDIBKGDAhAIANCCA.eHEA........hBAA......hBEA...,1,1,-10,11
AgYVTReJbKNIfDZaUMGcQEXHLdFSBCOWP,VAAARAAAeADE..KADC..IAHAZAFBMAIBGBDA.ECFEHCDBhAAAdCCCBCHBOCGDAAAA.hAGATFBAJEGB.bFFADEIBhCAA.aFED..........hDAA......hDBA...,1,-17,-18,1
XIVMFZJNcLSPUeBKbTOYGHCWfRgEDQAad,dAAAXAAAMADAZAEE..JADALCCA.SAHHhACAeAGHbBCD.OCFDHDFCfFCAhAAAEDBBADHA.aFDDhABAFEEHPFFBKEHBTGGACGAA.....hAGA......hAIA...,1,-14,-16,2
JQfGbMYgeTKBCZaUIPRLDXdFWVAHNSEOc,HAAAEAAA.OACAQACAGAFAMAFAeAHBTBFACCCAZDEFaDGDIDDAhAAA..RECBDEIBhAAAdBHAFDFHAEEB.SEBBhBEAfFBEbEGDKGHD.......hBFA......hCAA...,1,-1,-10,9
WOeLBabDgXFEPZGKIJHUdQCVMTAfSRNcY,RAAA..NAAA.......cADAOAFAeAFEaBBADBEAFBGHECCAhAAAGCCB.KBHBHDEAhABAdEFAQEAAhABAMCIBAEDBSFGBLEHB.bFCB.....hAIA......hCAA...,2,-22,-11,11
XBeJGcMCVZIgfATREdSDYHNPUbOQKFLaW,EAAAdAAADADAHACAUAGAQAFC.LAHBaBDABCBAeCCBGDCAhACAMCEB.ZEAB.fDGEhAAAREEFSCEGhBAAPFECKEHBFGBBJHCACGHA..IGGAAEAB.hAEA..NIDB....hCAA...,1,8,-22,30
ZQbRHOGUCVWKEAgLBFfcIYXePDNaJTdSM,LAAAFAAA..fADAIAEAeAFHDAFA...aAHBdBFAhADAZCAARCDBHCGBGDFACAHAKFCAhBAAABIBBDHA.XECAhABAPFFB.JFHBMCCBOHDC....hACA......hCBA...,1,-13,-22,9
MYAQUXVJHgGIdaDNLOfFCcbKePBZRWTES,QAAAXAAAHADAGACBdAGA.DAFALCFAFAHD.CCDDKDAAeCDAhAAAZEEARDAAEDFA.MDIBhADAAAAAVFAA..gEEGhCAAaEGA.fGHEcGGC.BHEAhCDA......hDAA...,2,-9,-9,0
XMPJcQCeFaIKUBYbVANEDLGdTORHfZSWg,EAAAGAAAdADA.RADAHAGBZAEB..SAGAXCDAMDAB.JDCFhAAAQCBCFDHD.hACAaCFDKEEDBCHAbGDAAAIBLEEAhAAATGAA.fFHA.PHAAhAHACHHA.....hADA...,2,-15,2,17
KdDCYUOSEePAFcgWZNBJGLITRVQXMabHf,FAAA..gAAAZACBBAEAGAFALADARDEB.QBGAhAAA.aCCAHECBdDDDCDGDOAHFhAHAEEAAAAEA.NEHAJHDETFCAhABA.MEIB.bFFBDGIBSHAAhAHA......hAIA...,2,-21,-2,19
MJbYRVQcPCFfXgAZGIeNUTOKBdHSWLDEa,GAAAeAAAUAEAKADAHAFBLAHBEAHBMCDB..bBAARDGBQEEChAAACBGB.XFAAhACAAAAAZDEATEBAdGGDDDABhADAaEHD.VFDA........hBEA......hDAA...,1,4,-14,18
YeSaGNAHJBVWQOcPTUXbCfFRLDdgKMIEZ,HAAABAAAQACAOACA..TAFAbAEA.FBHDRCAA.dCCAMAIBhAAAECFBeECAGCEAAAHAVEGBhAAAPDHB...CEDDLFABhACADFFB.KGCA.ZGFE....hAFA......hAGA...,2,-6,2,8
HCFXLfOKPUBIVZNdeYJMWaGAEbDQTcSgR,EAAAQAAA.SACAHACAXAFBLAFAKAHBBCCDhAAAZCDAeCFEMCEBGDAAhAAAACFBbCGD.TEEAREAA.fEHAhADAOFECIHHAdECAYHAGaGDCDIDAhAEACGGDFHEC....hAGA...,2,-1,8,9
fPECDFgILOdcZbHaNYUTeRMKSWQGAJBXV,XAAAVAAA..EADEFADALAFBdAGAZCDAHDBA..aAHBUEFBhAAARCDBMBIBSBHHhABAGDGAADCBBFCACFCADFFBOFHDhAIA.bGBA........hBDA......hBGA...,1,-8,-18,10
NFLCKaWRMOBSGPVcUDdfHIYZeXJTEbQgA,LAAAaAAA.RADFMAFASACH.GAEAVBFA.DAGAHCAAhABAZBGBeBBDTDEAEDDBQEGAhACAAAEBCEHA.KGGDhBIABFFA.PGBA.dGHA....hBAA......hBGA...,1,-4,-17,13
BgcTDPMKLbJWfSUdXCFeAZOQENIRGVaHY,ZAAAEAAARACAaACA..HAFBBAFA..TCDAMAHBLCCAJCHB.hAAASCFHdDAAFEFBAAHAQGGAhADAGECAgEEGhABADCCBbFAAfHBBCEHAeFABOHEA.hAFA......hBHA...,2,-8,-3,5
RDBYUJeaSQPKZNgCVXdbOAFHMGITELWfc,HAAAGAAAEADELADA..fAFBRAGFBCDAUDGBeAHHaCEDhAAAQCABZEAA.hACACCEAdDGDADCBMFFBTDCAhAAADGGA.SEFD.KFHBNIAB.XGCAhACA.FHACIHHAhAEAYHFA.,1,0,-12,12
ceTJbBYIVfLKDCdMgSAGEWQRXNZaPHFOU,EAAARAAAZADBHACAFAFD.OAEA..eAHBTBGABCCC..ICEAhAAALDABDCCBdDFAMDDBhAIAAAAAGEGAQEEAhBIAaEEB.cGFDJHCA.YEHH.KGDAhCAA......hCBA...,1,-6,-19,13
aPJBgTeORYLHGSXdMNcIUVDEAZCWfKQbF,ZAAACAAAKACAQAEA.FAGEaAEABCAAeAGHRCCA.HCAAGCGAdCEAMAIBhAAA..IEAAhABADDHBACCA..bEDAgEEBhACA.TGDALFBBSGHHhADAcFGD....hAEA...,2,-18,-18,0
fgSdRNDeIPEMGJZYaVBTWCcHAFXKQOULb,KAAAQAAALACB....bACASAEARAGBeCDB.EAHBGCFAhAAAZCEA.aDAATEAAhAAACEAAHECBAAEAFEEAOEHDhADAUGCAdGAADFHBMFFB.......hAIA......hCAA...,2,-27,21,48
dFEHTQcYXPOWNgZBeRLaIMAUSKCJfDGbV,KAAACAAADACAGACA.dAEBHADC.QAGCXAGD.OBCBhAAA..gCABhAAAeCHFRDDAaEHDAAIBSBFDhACAJFFB.bDFAEGDBTEDA.PFGBhDAA......hDEA...,2,-18,-13,5
fQVINdKJgbEPCHUGWSYOeMBXaLZADFTRc,TAAARAAAQADC..IADAdAFAKAHB.JAFAECCB.HCFCGBDBhAAASEDAeCABMCCBhACAaEGCAAAAFCHD.fDDAhAIAgGGAbEFCCHAA.UGEB....hDDA......hDGA...,1,-5,-7,2
DRIXeEKVGOdNFAZHWPCBUYJfQScTMabLg,HAAACAAABACAUADA.JAFEQAEA..TCFAaAGELCAAhAAARCAAeCHH.ECEBGEDAhAAAdCHAADGAZEAA..PFHDhACASEEA.bFGDDGGBKHAA...hBIA......hCAA...,1,-11,-13,2
DcSAXBYaGPObQZHUKTRVegCMfEdJNFILW,BAAAGAAAOACAZADAHBGBKAFA.RCDB..eDCBMAIBEEAB..dBCAFEGHhAAALCEADAGAABIBaFCHQEEAhAAA.TEGAhAHACGHANIEB...IFCASFFDXGCAhCAA....hCBA...,2,-33,1,34
TDZgKOLNfSQBHWRYdCIAcPJFaXeUGbMEV,JAAAaAAA..UADAGADA.EAFADAGA.ZBFBOAHDLCHB..hBAASCCDHDBARFBAdFFAhBBAACGBFDABeHDGMDFB.hBDATDGA.KFAA.QGFABHHA.hBFACHBA......hBIA...,1,-11,-12,1
WLAOfBTgEDRXFaPJQUYHIcNGedCbZSVKM,BAAAEAAARACA.aACA..QAFCHAEB..IAGAGCCBeAHHhAAAdBCAZCGBKDAAMDEBADIBTEFAhADAXFEDFFEHPHAAhAHAUGGA..NIABCDFASGHB.WHEAhCAA.....hAAA...,2,-20,7,27
EeLCUWFNDSgHJXIRAZOfGQKacBTPYbdVM,ZAAAGAAAaACA.BADA..TAFA..bAEDdAHAEAGAeCCALCDDhAAACDEAFDGA.SBGAhACAHEFAXFAAADABQDGAhADAKGHB.PFEC.MGAA.NIEB.hAGA......hBAA...,2,-12,-11,1
KEFXdCefMIaUGLSJPVBNZQATgWYbOcHDR,TAAA..gAAA..bACBHADARAEAEBHFdAGAeCCDhAAAMAIBUDGBGCCALEEBhAFASCFDJHAABFDAhAHAZDABAAAAOHFCKDHDCFFAaFHD.....hAIA......hCAA...,1,-2,-7,5
cESRBFCJUgdKTNLIGDAVPXZHabQYMeWOf,XAAAHAAAaACAQAFA.eBHHfADA.EAFAhAAARCCACDFAUCEAdFAATFCAhAAALBHBDEIBACHBZDAAbFFBMIAAhAFAOFABBHHAFFFAKGDA.IHHAhABA......hADA...,2,-16,10,26
XKRNeLYWfEHVQFMbdaGDgScBJOCIPUZTA,RAAAeAAALADB..fADAHAFAQCFBMAFAdBFAGEEAhAAASBHBBCCCCDHAIDDAhAAAZFAAAAHAKGHBYCGBhABA...EECB.bFECDICA...hCAA......hCBA...,1,-9,-22,13
XNcYJPVDGAMCZUBIRWbQeTSFEKHOdgLaf,ZAAABAAARAEA.QACAeAHHFCAA.HAEA.dAHAaCECXCAA.hABA.NDAA.JCFBDDDBACAAMDDBhAAACDHA.UFGA.bEDDhACAEEEA.OFGB.LFHBfGAAhAGAPGCA....hACA...,2,-22,1,23
GYeVfMTRPaBNOHIAUFDQKWZJXgCcdbLES,DAAAQAAAZABE.JACECAFAdAHA.LCCAEAFAGBGA.eCDAhAAAMCGBRECABDCDHDAAADHAKFGDhAIA..XECAhADA..gGEDbFACSEHB.fFFEhAFA.aFHHhBAAIHHAFHBA,2,-19,-11,8
BZCbYEQVLHPOGJDNRMIUAfeKFWXScaTgd,eAAAFAAA..SACHaADDdAFAZAGBCAEA..EAGALDBA.HEFAhAAAGCDADBIBRFBAMBIBhAEAACCBKGHBXCFA.hABATFFABHEA.bFCD.QGAB.hBDAOFHD...hBFA...,2,-15,-4,11
QeHYKJSPWZBCTcGbOENIDARgFaMVUXfLd,RAAAaAAAMADA..XACDdAHAHBDA.KCCDSAEAZDEBBDGA.TBGAhAEAGGBB.EFBADBBBhAFAAAAA.FCED.UDGBQGGAhBFAeDDDPFFB.CAHB.....hBAA......hCAA...,1,-8,-18,10
ERXLeTdYWbDKcVJONgPASFIMHBUfQaZGC,FAAAHAAABADAQADCGAEA.RAFFeAHHdAGB...bCACKBHDVDEBhAAAOCCB..gEGHhACAADAAMDEB.aEDHEDGBhADATFAADDIB.NIDBSHAAfFFACGHA.hAFA......hAHA...,2,-34,16,50
LPeDBOgRTaZGdfCWVUNYAXHFEMKScbJQI,HAAAEAAAKACASACE.JAFALAEBeBEFBCCARAGBZCCBdCGACDGDUFEAhAAAACIB.FGAAbDED.hAGA.QGGChAIADEIBOFHHaDHD..fGDENIBB.MIAAhAAA......hAIA...,2,-20,-9,11
FBKNQXdJUHAbSaeZRDGWEYIfCVgOTMLPc,aAAARAAAGADA.EAFAIADA.CAFA.OAHDLAHBFCCHKCFAhAAAQCCAdDAAHEFAABBBeBGFhAFAZFAEDFEB.fGHAhABATEGAMCFBBHBAXGGA..hBAA......hCAA...,2,-25,0,25
SMCXIGFgRJaOEeUDbYWKHcZNVdBQALPfT,LAAATAAA.MAEACACBGADARBCA.OAFAEAHFDBGB....hABAbBFDKCAAHFBAZDEAdFBAhACAABIBSCCDFFDAaDHFeGFAhBFAUFFA...YHDANICB...hCAA......hCIA...,2,-8,-2,6
TPVFcYJbBMHSCfXUeLRQDWaZgdENKGAIO,TAAAFAAA..JADAMACAHAGB..CAFAUCCARBCBQCEC.hAAADDIBZAGB.EDFBGEFAhAGAABDAOCHD.PFCAhBIA...cGCCBHEA...XFGDhCAA....hCFA...,1,-24,-29,5
GVHMafcFJYPQIDTWSCBZUROEgdLNKbeXA,HAAAaAAA.FADA.JAGBQADA.TAFACCADZCCARDGB..EBBBhADAdECALAHBKEED.hAAAeDCAAAIBMFGBfDFAhBAA.PEGDDCIBBGAAOHCA..hCAA......hCDA...,2,-29,-10,19
IDdHYZcgXOeENGUFVfQbaRJBSLKPTCWAM,MAAAdAAAHADAZABE.XAGBEAFA..GBGAFCBDQCFChACARCCABEEALFAATEDAABIBDAIBhAFA....gFAAhADAeEGDNEIA.fDHAaGCE.KFGD.hBAACDDCIHHA.hCAA...,2,-14,-1,13
ESgfYbHIXAPcCDLdeBVFTONKGMZJQURaW,CAAAdAAABACAFADA..OAFDGADA.ZAFAQCBARCAA.EAHBSCFAhAAA..hACAfCHEHEFAAAGADFEBhAIAeDDENIDB.MEEBaGCB.gFFA.hCAAIHHA..hACA...,1,-19,-34,15
OAbfHSJNLBMcVPCaDRTZWFKQdGUYIgEXe,HAAASAAALADBMADAVAFA.aCACRAFAZBAE.KBEDGCEAhAAAUDDB.IDHAECGAeDHFhAAAACCAJFAABGEA.CGGDDFIBhABATGDA.QGGA....hACA......hAFA...,1,0,-18,18
eUQSJXGFOfKaIAMLbDENPCcBdYHTWgZRV,MAAALAAADAEA.EAEA..CAGABBBAHAGBTCAAZBDA.RCCFeCFBhABAQDDA.SAHHhBAAGEEAfDHAhACAaDFE.AAIBbGBCcEBAdGHA...gEGAhBBA.JFBFOEABhAEAKGHB,2,-40,11,51
fSVdJGcPOUXCELDNMAZBRWagFeQITbHKY,RAAAaAAAeADE..TADAHAGBKBDA.SCCDdAFAGBGAODDAhAAACAHBEBBBLDAAhADA.MDFBAAIBZEEABEDAhBAAFGAAbGECfFHA.cGECXDGAhABADICA......hAGA...,2,-10,-3,7
LbFMQIPHGJZBfXAYERaWNgedOCTKUVScD,RAAAaAAA....NADB.eACH.dAEACAHAKBDASAGA.LCGBhAGAMBGBQDDAhAAAHDDAZEBFXFDAhAHAECHBOCCBTGGAUFBBDEHB.FGFB...IHHAhABA...hBAA...,2,-19,-11,8
XfOYIgZeRLaKbAUVdCQPcJBTEFHDSNMGW,dAAAQAAAJADA.EACAHAGB.DBDBMAFAGCBA..fBDAhAAAODFB.gBEHhBHAREGBaEDD.ABIBCCGABGAAhACATEEASGGDXDGA.IGGAhCAA.LHFAhDAA...,2,-21,-18,3
QKOaTbWZXFLMfYANSdVJGUgEDIHecPCRB,dAAAGAAAEADAHAFAeADACAGARCAABCEA.KCGAaAHD...TCDAhAAAZECALEGBMCGBAADASDCDhACAJHAADEIB.IDHAhBAA.QFEC.OHFChBCA.....hACA...,2,-25,-2,23
LGXWTDgZKOdcUBANIbHYfJQFCEPaeRMVS,..IAAAHAAAfADBFACA.EAFEeAEHRCAA.MAGBLAHBhAAAGCBATCEAZBGBdEEAhAHABECAACBB.bEEAQGFAhAIAaFHDXGCADCIBOFDH...hACA......hCAA...,2,-7,-1,6
LaHVMXcgTIRYSQKGPFfJOdWBNEZAeCUbD,eAAACAAADACA.HADA.MAFA..XADATBGARCCBQAGAhAAA.GCBAfCFEhAAAdDDABDGAEDHFAEFBbFDAhAGAaFGC...........hBCA......hBIA...,1,-8,-32,24
JDHWVBTQEPaYfNdZOcSAbICRLMgFKUGeX,CAAARAAAMADAKACA..GAEAeAFA..DBEBHAGDBBHAECAA..aCCB.hAAA.fCDEhACAZCFASDDDACIBLEAAhAEAFEEAUGCAXDGC.VFGBTFGAQGAAhAGA....hAIA...,1,-5,-20,15
XTMJDHEKfPLIbUBcQdSWVaGZOFYCNAgRe,RAAAeAAAMADAHADA.EAGEKAGALCCAUCCABBEBdCGASDHHhAAA.aEEBZCFBFFAACCHAAAAAhAIATFFADEHB.fGDEhABA.IHHAbFDC..WEHHhCAA......hDAA...,2,-45,11,56
CQSBdWeAYZFLMKTJINVcHEaDRbOXPUGgf,ZAAAMAAAKADC..TADAJAFB...VAGBHBGB.ECAARBBBOCFBhAFAUECAGEFA.CAHB.hABAQEGABCDAeFHHhACAADEBLGAA.IGEA.aGGChAGADICA.....hAIA...,1,-16,-18,2
RZJXHYaSNdfVbAGgQCePMUTWEBLFDcOKI,GAAAQAAAeADAMADAUBGA..EAGALCDBDBDA.KEADRCBAZBFEhAAAHEGBaDEEdCFCVECBhBCAAAABCFFC....PHAAhACATFFA.FEHF.OHDC.IHHAhCAA.....hADA...,2,-15,8,23
TIgfbXCYeJPRBaVFHALMEdNDGUcOZSWKQ,EAAAdAAAGADAUADAZAFBKAFA...QCBDTCBA...fBHAhACAbBGD.CCFAeDADhADAREDAaFBBHFGBAAHAMDIBhAFADAIBSEFA.gFEGhBAA......hBCA...,1,-12,-15,3
ZJcfXTSUOPHGgRLEVbBQDYMWaNIFAedKC,eAAAdAAAZABB..JADBXADAUAFA.HAGBRDEALDHB..hAAAECEBBAHAQDCDhAEAMCCB.aDFDFEDHAAGBCDHATGFAhABAOFGD..PFBB....hBFA......hCAA...,2,-22,-13,9
JFYfbZLWOHNcaETPRdSGDgBMeAICVKQXU,CAAAQAAAUACA.FACE....bAEAZAEB.LAHBHCDCaBHDhAAAEBGF.RDCBGEEAhAAABCBDAAFAKEEDXGBC.hAIAfEHAOEHBTGCASGHHMFGB.hBCA......hCAA...,2,-27,1,28
XWQJgTUVOLRdDECaSMKGYcPfIbHFNBeAZ,ZAAAQAAAJADA.UADALAGBRAFA.ECAAaCFE..KCDAGDBAhAAA...PDEBhAGAbDFAHFCABDHAAAIBXFFBhABATFGA.........hAIA......hBCA...,2,-23,-20,3
OLWbXVYgCdeAIGHcFfQUDKaJBTERNPZMS,HAAAFAAAQADAKADCaAFD.BAFARBGF.ZAGBMCABLCCB..hADAbCCBXDGA.hAAAVEEBCAHBADIBGEDAhACA.fFBADGCBEGHB.SFFBhBFA.OFHB..hDBA...,1,-11,-18,7
gDfHZcQJdMFWSIOaYEPXKCTUbBANRVGeL,RAAAeAAALADBDAEAHAFCZAFA..QCFAdBDAMCCBFCGH..SCCDhAAAaDED.EEEBhABAKEHBTFCAbFCDAAAA.VGFAhAGA..fFGEWHAG....hAIA......hCAA...,1,-2,-22,20
QYXKJVDPgaWTNBAEfGZMceCLUOHbSdFIR,EAAAZAAAeACELADAHAFBdAHARCCA...QCBAKAHBDDHB.aCFBTEEAhABAAAEAGDDA.MDGBhAAACFAAOEHDFDHBIGHAhBCAXGEA.PHAAWHBG.BHHD..hAFA......hAHA...,1,-4,-13,9
bIdEOVTfUJLNWYGcFCZBSaMPHXQRDAKeg,eAAA..bAAAEADAOAEA..TAFAUBFBLCABhAAA.NAIA.GCCA.hABACAHBZCFAaCCCHDECREFAAAAAKFEDhCAAdECAfGHAYFFFBGGBMICA...hCBA......hCCA...,2,-16,1,17
BUbLZSTFaXGRMeIYKgJVOEcHWQNADfPdC,DAAAdAAABADALADAZABBFAFAGAGA.RBBB.eAHHKCFD...JBEBEEABhAEA.HECA.QEGBhAFAACGBCDCA.SGGAhAIAaDGE.MIBAgEFG.OFHDhBAA....hCDA...,1,-3,-44,41
UaJQgfXdcOeFLSKVWZBGMYbPHRADITECN,TAAAEAAAUADA..aACAQAFA..XAEDdBCCeBHHhAAALAGBKDEAZEDAGGDBhAIAbCCCHEEAAEIBCHBAgGBAhAAA.ODBHSHGABEHBMAIBhBDA.RGEADGIB..hBGA...,1,2,-8,10
eEbLCDGZIJfgVOMaPYWXSFUNcARBdKTHQ,RAAAdAAAHADBEADALAGBGAGAZDAA..IBFAfEEA.ODGHhAAAaCAE..PCEBhACAXFAAFDCDUEGAhADAAAFAKFHB.eFFDDIAA.........hABA......hADA...,1,-11,-12,1
OJCKbVcEZGUIaMeBXWSALRPFfHdgDQYTN,RAAAFAAAHADBdADADAFAQAFA..TBFAOAHF.KCCD.bDADhAAAECCB.GDGAUDFAaEEBhABAeDBBBEHBSBHBhAIAADAB.LEEBfGGAYFBFhBAA.CFDA.....hBDA...,1,0,-20,20
eWXERIaCOVYJgQfDFUZMHAKcBLSdTPNbG,BAAAdAAA..TADA..bACAeAFEEAGARCAAaBFD...OCAEhACAVCFA.JCHBQEABhAAAFDEHZFCAAFIB.LEDBhACASGFHPFFANIAB.XGAACHHA.fGHAhADADHCA..hAEA...,2,-15,-8,7
XYCAcEVZTKNbOHIMfSFWQGRBDLJdeUPag,EAAAZAAAKADC..OACCHAFAMCABFAFAGCCARCCALCHBdCFAeAHHhAAAUEEA..aDHDXFCBhABAACCB..TEAAhAEAbGFA.SFDHBHAA.DFFB.gGFHhCAACHDA...hACA...,1,-5,-12,7
MESbFDROfZPXaHJCLNGegTWcAQKUIBdVY,QAAAKAAABACBdAEAMADA..EAGAFAGDRCCB.ZBDB...aBHDHCEChAAALDBBeCHHTFEAhAGAADFAIEFA.SEGHhAAAbEBDOHCEXFCDCGHA.NEIA..hBEA......hBIA...,1,-12,-15,3
ZRcdTaHbEXDYeILOSPgNJAFVfBGMWQCKU,FAAABAAAGACAMACA.QAEAKAFAZBCA.RAGB.dAHAHDFA.EEAADCGBhAAAeEDFLDBA.hAEASDGHgFFAhAIAADIB....fFEACHHA.TGGAhBDA.....hBAA...,1,-5,-35,30
bBUdWOIacRYgJEQCSNfPZVeLGAHXKMTFD,HAAAMAAADAEABADB.dAFAOAFEaAHB.RBBA.JCAF..ECEA.QCGAhAIASBHH..hAAAfDDEZCCAeDFHAECAhACATEBAbEGD.IFFAgECACFHAPHFAhBAA.....hBFA...,2,-18,-13,5
GFDgCRJPMfOXdBUSeZWANbKYaITHQVELc,KAAAaAAAHACBEACE.GAEBDAEA.RCEB.MAHBOBBHdBFABCCA.UECAhAAAeCHB.AAEAbEGD.hAIA.TEFALHAAhAHAFFHDCDHAfGDB......hAIA......hBAA...,2,-35,-2,33
WBgSCIRfEbVaHFZUdTXNJcOMYQPeLKDGA,BAAACAAARACA.EACA..aAFAHAEA.ZCAAdBGDTCFA..XCAAhAAAJDHB.MCFBQECBhAAAeDDBLDGBhACAGGABAAGASFHHbFEDFGHD.cGFC.hACA......hAIA...,1,-3,-20,17
AWBFMaecdgEHObKGRLVINSfXTCUJDPYQZ,FAAAeAAAdADAHADAKAFA.RAGFLCCA.VDFBSAHB.hAAATCEACFAADCIBPFHDhABAZCGFACCBBDBD.aDDHgGAAhAFA.OEEHGFAB.fFFAhAFA...hAGA...,2,-29,-6,23
KcAVgLdIEZJeRPGQCbafBOMHUWTDXSFYN,LAAAEAAAZACB.RADFGAFAQAEA.aAGEOAHF.HCAAhABATCGASDEHhACAFCEHKEFAABCBdEHAeEHHbFAAMFGBhAFADGGB..NHAB.........hAAA......hAHA...,1,4,-18,22
aKNRCLFOQdAUWBTIEfGMXJbSPeZDVHcgY,BAAAEAAAGACAMACA...XAEASAEAeAHBZAGBHCEA.hAAAgEAAaBCBRCEBLECBhBIAQEEBACIBTEGAhCAAfEHA.PHCADEEBcGGChCBAKCBDFGGH.....hCDA...,2,-24,23,47
FXPQDOMHUNabTgRdIBeGAJfKcVESZWLYC,KAAAEAAAZACBLACB.FAEAQAEA.MAHBHAGBaCBBbBDDhAAARDEABCEDAAIB.JEHBfCFEhCAA.SDHHhCBACGBADAIBNIDB.dFFAIGFA..hAAA......hBCA...,1,-18,-22,4
GCTRcXaPgfQSNZWJEDVIdBAYbHMKFeOUL,HAAAMAAAFADDeACELAFAGAFARCCA.aAHF....fBBAhAGAQEECZCDEEDHBDCHBhAHAdFAAACIBKEEACFHDXGGChAAASEHHJHBE.BFCA.bGEC....hBAA......hBBA...,1,13,-26,39
KLVCOMGBPAXeUYfHFSZdDagbEcTWQIJNR,eAAAUAAAHADAZADBdAGAaAFA..EBCF..TCEAQDEA.hADAIDHARCGFLDCBhAIAOFBAGGCBAAAAfFGAhAIADFIBgEEGbGBA....WFHHhBFAKHGA......hBGA...,2,-20,3,23
BFIHQbZCgfPNAXRWLScdEMaVUYeDOKGTJ,RAAALAAAdADA.EAEAaAFAUBGA..eAHHKCAAGCCABBFAHDDAhAAAZEAFCCFC....fDHAhABAAAHASEFAhABAMCCBDEIBTFFAFFEHQGGCbFBC..hACA......hAEA...,1,-11,-14,3
gDOcbYGNdKPLTXJSaQHBCEFVfMUeZARWI,RAAA..IAAAOADA.....bACAGAGAdAGALCAAhACATBDASCCDhAAAHDEAEEAAfECAeDFBAAIBDDIBhABAcEGDKEEDXFGDaBHDQGBBFGBA.hBGA......hCAA...,2,-13,5,18
IbAegXEGFZCVYUQRTOaLWJPBdHNcfKSDM,eAAAEAAAZACBCADA..UAFARAEA..aAHDLBHB..PCEBhAAAHCCAfDFAhAAADCBB.MECBACGBGDGAhAFAFFGA.QGEAOEEHBGGDdHAB.NIAB.SGHHhAHA...hABA...,2,-16,-6,10
QbDRZWVPLeIaOFdHUJgXMcAESfGKBNCTY,EAAAGAAABACACADA..QAFARADFZAFB..VDGBeBHH.aCDAdEEAhAAAHDDAUFAA..XEGAhAAAAAIBKCCD.TFAAhACADGGB.LGDAFHCE.MIAAfFCFhAFA.....hADA...,2,-20,-3,17
LJCDYBKFMIWPaAHVSgbQZdXNecUGETRfO,HAAASAAAQADCdADA.eAFEGAFARBFBLCHBDAIBKCCDMDBBhAAAIDDA.aCACAAFBbDEDhABAZFDA...XDGDhAHANIABEHEE.OEDBCEFDBHHAFGHB...WHBAhBDA.....hAAA...,1,3,-6,9
JAQgdRGOKaLVYDHMZfceNTUbIPBWXESCF,dAAARAAAGADAaADA.LAFADAGAHBDAZCFBeBGHUDAA....bABDhBAABCHA.EEHBFDEDAAAAQFDChADAKDHBMFGBfFHEhBDATGAAIGGAXGBA.CHHD..hAGA......hAHA...,1,-4,-12,8
HNeKIWQgTLMUdZVSBYaAPDGcOXECRFbJf,GAAAXAAARADAFAGA..JADAHCDC.eCGHKAGCQCDAhAAALEAAdFFDZCFBBGCAABDBDBIBhABAEGHFCDHD...NEEA.gFDBhCAAMCIB.SGGA..hCBA......hDAA...,1,0,-31,31
cDQTXFPNVMIBSEHKAJbOUgLYeZGRdWfaC,OAAALAAAZADBRADFdAFA..aAFDDAHBQBBBFCAA..VDEAhABAMAHBBCHAHDEAAAIB.hACAbFBA.UFGAeDDD.hAIA....fEHA.CGGD..hBAA......hBFA...,1,-14,-28,14
QWPaTEIDZJULKSgRFMfHYBbcdNXVAeCGO,eAAAGAAAQADAaADA.EAFAZAFBLBHBSAHHRCCBMCGBhAAAHCDBBFDAdDCCXDGAhAAAACHBOFED.TFFAhACADGGA.KHBA.fHDB....hBAA......hBCA...,2,-13,-5,8
RULaKTOBYAJQbNeGdcVDHCPEFgZfWSMIX,QAAAeAAAdAEADAGAHACA.EAFEZBAESAHBMBGB.RCDAaCGDhAAATDDABEAA.ADIBJECBhAEAGDGA.CBHAFEBBfEFEhCAAXFDALFHBOHBA..NIEB.cGCDhCEA....hCGA...,1,-4,-10,6
HOZGbLIJCTWSXaUPYBKDRFMEfQAVgcNde,VAAA..gAAAdADAHAFAGCDBLADACCHB.TBGA.hAAAXCCAaEECUEGABAHBhAAARFAAMIAAECFBAAEA.eDHFhABA.bFEBIHHASGGA...hAFA......hAHA...,2,-8,1,9
GPUJRQdMZBXVgfDObASLNEHaYCcIFTWKe,LAAAHAAAaACACAFAFAEA.KAHBGAGA.UCCARBCAdCAAZDFFBCFA.hAAA.XEDAVDGBDDEBhABAAAIBEFAA...IHFAhAFAeFEFQGGBMDIB.OHAAhACA......hAHA...,2,-20,-3,17
ePIAdVMHDYNbCJKgOUEQBXTLGSFfWacRZ,dAAAHAAADADA..bADBKAFA.UCCAEAFAQBGA.TDCAhAAAGCFAFCAHaAHDREFAeFCBhACAABDA.MFEBCDHBOFCAhACABCCCSGHB..fFHAhAHA.WHFA.hAIA...,2,-40,7,47
GeLAUdfaQPTMBcWRYONgJKHISZCXFDEVb,dAAAaAAA.QADA.MAGBBADARCAA.OAED.JAGBHCGBhACAZCCFFCHDEAHBGDEAhADALDABADEBfFBAhAIA.TGGAcEEA.NIABKFHB.CGEA.DIDAhBAAeGAA...PHFChADA.,1,12,-28,40
JQaOKCPDZNXdLVREAgYFeHGBbSWcTUfIM,FAAAHAAAGACASACE..TAEAfAFAMAHBaCEECAHAZCCAhAAAdEAARCGBACIB..eCHHhAEAbECB.UEEA.IGHAhAGAQFAA.KEFBDIAA.....hAFA......hAHA...,1,-9,-10,1
JgHOXMVALYaGBEePcfZdTNSCbFRDQKIUW,aAAAEAAA..eACA..fADAdAGASBDAFAFARBEB.QDAAhAAAKBBDUCGA.JCHBHDAChADAMDDAAAIBGDDABEEAZGBAhADATFGAbGFADEGB........hAIA......hBGA...,2,-6,-5,1
dYDgAcWBXPRUZKGfHQISOCENFVTJeaLbM,BAAARAAAZADBGAFAHACAQAFC.OAHDEAHBFDAA.TEEAhAAAeCABaCCCLDHBhABAdDFADDHBACCA.XECAhAAAKFBASGGDCFHAJHAAMIEA......hACA......hAEA...,1,-8,-12,4
dXaCJIeKPYZRcLObfAEVTGNUWgFHDQBSM,EAAAGAAAUADAFADAHAFAQAGABBCCdCHACCDA...eDDAKCFAZDCAhAAAREFBLFHBODHDAEGA.hAAA.NHAB.DFCA.MFGBhACAaHDE...JGAA.IHHA...hAHA......hAIA...,1,-12,-15,3
PBLdCJAgMXeDIcfSKaVGHFYOWRTNZEUbQ,MAAAeAAADAEA..IAEASAFAKAGAGBBAHBCAOAHDhAAARCGBZDEF.ECFFUGAA.QGCAhAGALEBAdEGAhABAABBBXGFAaFFBFGHDYHDA...hAIA......hBAA...,2,-14,1,15
RHBgNCDZEPMKdJIFcSeQUbAWGLaVOYXfT,GAAAaAAA.OADAXACDRAGBHCDA.BDCDCAEAEAGAMDIB.dEFAhAAAFBHDeFCAQCEAhAEAAAIBLHEAfDDEhAGA.TEGA.DBBB.ZGDA...hACA......hBAA...,1,-8,-10,2
YBALDVSJCefOFMGTbUZcdWPIKXRHQaENg,LAAASAAAeADHFADAGAFAUAFAdBHA....IAHAhAAARCABHDEAEEDB.NEIA.BBCAhABA.ACEBDCIBCFBAMFGBhABAZEEAPFDBQGDBaFHD......hACA......hAIA...,1,-4,-22,18
FJeGBfSEOHbQPdVKcYNIWZXLMUATaDgCR,aAAACAAARACA...eACHGAFABAEA..EAHBHAFB.QDDAhAEAdCAAKCCD.NAIAZEGFMDEBAAHBDBBBhBAAFDHBSDFDhAAA.OECDPECB.cFEDIFAAhACALHDATGGA..hADA...,1,2,-23,25
DdNVaPGKRMIZALEgXJQCeWbYSOUFBcTHf,EAAAXAAA..QACAeADA.bAEAOAGD.BCDAhAAAHCDCdDAAaBHDGCEAhABAREEAZFAAACCBLEHBCEHBSGGAhAAAFDCHTGBADIAA.NIDB......hAFA......hAGA...,2,-6,-4,2
WHPaAgfOUYBJGXVZNTQIECdSFKRDecLMb,OAAABAAAGACAZADB.QAEAEAFA.dAHAKAHBRCAB.eBBBMDFAhAAAHCFAAACB.UEFBXEDAhAEATFCA.SDBDhBAADEGAbGBA.aFHDfFHA.YHFAhBGANIEBCHCD...hBDA...,2,-11,-4,7
FaXWMLNEcSKIGDPeVbOQJCgBAfRZUHTYd,RAAAHAAAdADAFAFAaACAMAFA..EBFBKBEAGCGAeBGH...OCCBhAAAQCCC.CDHAABIBhAAAZDEFTEEA.XGBAhBGANEEASFHHDFHB......hABA......hAIA...,2,-26,-6,20
TSVKPWZNcHGXUYAQgFCeORaIDbfJLdMBE,QAAACAAARACA.aACEDAFA...JAHBdAFABBFAEAHB..TCDAhAAAKCAA.ZDAAHDDAGCGAhADAUFDBAEFBeFBB.hAAAbGDAMDIB.SGFH...hAIA....WEHDhACA...,1,8,-49,57
SbJMaBIGgFdeXcONPUfATCLRYEZDQHVWK,TAAARAAAEADE..ZAFBHACBKAHB.SAEA.MAHBaCCAGCGAhAAAdCFAeCABODDBhABAPDHDAEFBLFABhAFAQEDCbGFABFAD.FFGHNIDB......hAAA......hACA...,2,-3,-3,0
gWQcESXRMPaFOAeGNKUIfJDTLVCdbBHZY,eAAAGAAAKADAUADA..JAFATAFALCCAdAHAHDBBZCFB..hAAA.gDDBhACAQECAEDGARFGBaCHDAEIBfFGAhBAACHDA.BGDA......hBCA......hBDA...,2,-24,-5,19
QfTGHANIdKJORVcbeBZECYLDaPUXMgFWS,dAAAOAAARADA...VADAeAGH.ECBALAGBDAIB.UDCAMCFBhACAFDHDQDGAhADAGEEAAAIBKBBDJDDBBEAA.hBAAZGAAaGCB..XFGCSGHB..hCAA......hCDA...,1,-12,-20,8
XfBSZJaeTUEDLOCcFWINHRYQgVdGbPAKM,MAAABAAAZACA.eAEEEADALAGB.CBBAFBEDICCA.hAIAHCECRDCBQEEChBAAdAHAbDAC.ABGBXGEAhBBA.SCHHaDHDTEEADFIBOHEAhAAANIBB......hADA...,1,-7,-22,15
WbXUHFMOPAIKJCNfSGTeaEdcZRDQVYgBL,KAAACAAA..SACAeACEEAFEZBDARAEF.DAIBQAGC.VCAAhAAABCCD.bCGDHDEChACAMDEBACIBJEDFGGEBdFFD.hADA....YHAALHDA.WFHHhAIA......hCAA...,2,-20,-8,12
aPHDJZbNcIfARKTeVEFgWOdBCXMQLUSYG,RAAAeAAAEADE.FADD..OAFAdAFACAHA...MBGBLCHBUCCAGDGAhAAAHDDAZFBA.bFFCIFCAhABA.ABIBTFEAhCAAWCCD.BHCASHAAaGHDDIEA...hCFA......hCHA...,1,-13,-16,3
MeZQgSOGYfaNUPEDJIKALdVFcWBbHRTCX,dAAAFAAABADAHADARAGF.CCBA.eAEHZDAA...QAGAOCFBGEDAhACAaCCB.UFAAECFFDDABhADAKDHBLHFA.hAGA.cDDC.bDGDMIAASGEBhBAAfGGF....hADA...,1,-6,-20,14
ATePRMCcYVWDNXbHGKgSULJIdQOBafEFZ,eAAARAAAMADACADA.....VAGBDAFAXAGAHBDBGDFA.SCCDhAAALCCAdCGAhAAAQFBAaDHDEECAAEFBPFEBhABA..cFBCNDIAKHGA.UGDA.OGFChABA....hBFA...,2,-23,9,32
gEdDWKJQNISfFTeXGVcYUaOMPLABZbHCR,ZAAAHAAARAEAdAHAKADCQAFA.SBHBTCAAeCEBGCABhAAA..VDGBcCFChACAaDDH..MACAAEEAbECDhAIAEGCADEIB..NIDB.FFFAXGGAOHDEBHHAhCAA.....hABA...,2,-15,11,26
NaOUPRdEIZXJWVYALDTBQfFbGMeScCHgK,TAAAQAAA.FACEGACA.eAEACAFAHAGBKAHBOCABhAAARCDAEDCBZEFAXCEA.hAAAVEEBAAIBLFABhAFABCHDbEADMGEA.SDGAgFCD.aGHBhACA......hAEA...,1,-2,-6,4
fdWXTEIPVUFROgHQSYDBKZJLeNGAbMcaC,MAAAaAAA.dAEA..TADAEAGA..VBBBRAFFHCCA.QDAChADADBIBZCFBeDEFAAHAbCGDCDHD.hAGA..XEEBhAFAUEBBOFGDSGGA.BBBD...hBAA......hBBA...,2,-20,2,22
abfMQNdDHZOXIVLAUCGKeWPSFJBRTgcEY,GAAAeAAA.SADABADARAEF..TBGAEAGAaBGE..MCCBhAAAdCDAHDFAZDCB.XEAAhAAALEEAAADAKFDAFFHDgGABhABAbGACQGGAOGDC...hACA......hAGA...,1,1,-10,11
bZHAPNCROeLdKQYIDfGSVEgXJcBTFUaWM,CAAARAAAeADEdACA..QAEADAGAGBDA.EBGAJAHB..BCCCFCBHUDDAhAAAaCGE..MEGBhAAAHEGBAEHA.OEABLFCAhABAKGBA.fFHASGDB....hAEA......hAHA...,2,-24,-12,12
ANGfUdJQePHaTWbFYBLEDRMcZSKOVgCIX,GAAAdAAAeADAHADA.aAFATAGAFBHDLCDARCAAZCEA.KEEAODHDhACACEGB.ACFA.UGGAQEABhADA.bEEBEFCBhAAADGGBMDAB.........hAEA......hAIA...,1,-9,-13,4
RBNYKPfFGZCDTEgVAMXLUISeabcWHdQOJ,MAAALAAAUAEAeADH..aAGE..bAEDHBBBdAGA.QCGAhAHARCABBCHAKEEAFDEBZEGBTFFAhBAAEGBA.ABBBSEBAhBDA.OFHDNIABfGEEDGEB.hBEA......hCAA...,1,-10,-11,1
OaCbcSJNeDUMfFRTHKLXVGBIdZQgEPYAW,aAAACAAA..SACAeACHMAEARAEF..HAGBLBEAGCAAdDDAZCCFhAAAECHFAACAODGBJEGFDBBBFFBBhAIAXFEDBFEA.QGABhAGA.YDHBbGDCNEIA...hBAA......hBFA...,2,-13,5,18
AZXHcJGMKfdRPDYNWLQgSeIbTBaUVCEFO,HAAAGAAAMACAdADARAFADAGA....NCFA.LBEA.QCCChAAAeCGFTFAAaBHDCDFAhBFAEDDBAEEBZEGB.XFDAhBGAKDHBfFHE......hAAA......hACA...,1,-12,-24,12
NYMRcBGHbDSeVaKLTXCAJdIWOQFfPEUgZ,dAAAOAAAQADAFADD.EAFAZAEB.MAHBRBGBGCABHCFBSBBDhAIAeDEFaDFD.TFGAhBAAAAIBIFHA.fGGEhACAgGBANICB.BDDD.DDIB..hBGA......hBIA...,1,1,-20,21
UEFMIdJLNaXWOKDAcCYbeVZGfTQSBHRPg,CAAAeAAAGACAQADAHAEARCAB.UAGA.ECCBMAIB.dCGALDFAhAAAaDFB.OEDChABAAACB.bFBCZFGB.TGAAhAAABFGAFGHDIGFAXGDADEAB..YEDBhAEA....hAGA...,2,-11,2,13
OLQRTUbVSZgYeNDAGJPFfaIBXdEHKMWCc,GAAAFAAA.aADAXACDHAFBKAHB.MCDBCAEALAGB.RCEBUEAAhAEAbDBDZEDB.eFFAhAAAAAIB.JHAA..fDDEhBAABGHAEHEA.OCHD.TFGA.hACASGBA.hAHA...,1,1,-22,23
PZdbCJBEIVMgHLXcKTSeDUNFQfOWRaGAY,ZAAAdAAACADAEADE..MAFAHAFB.LAHBKBEA.eCABDBGAFCBDQCCBhABA.ODFBhACARCFAADAB.bEGDBDDAgFAAhAFATEGAUGGBfHBF.WEEDhBHAaFEB......hCBA...,1,3,-39,42
fMLEPQCDRHgYTAFVSBeUWcNaOJKZIXbdG,SAAAeAAAUAEA.....NADAOAEAZAGBbBAA..GDEAhAAAMAIBEBEBQEBAhABA.REGF.HCFB.TEDAhAAAABIBBGBDaEHD.KFBA.dHBB.LHFAhABADGEB.....hBEA...,1,2,-11,13
fGFNEBPgbWYIOReLZAMTUScKXaQHJCVDd,MAAATAAAUAEA..KACCQAGAHAEACAHBdCCAGBBAFCFDECHBBDEAhBAA...bDFDIFFAhAAAeDHBABBBXEDChBDAaECEDEHB..fGAAPHFA.YFHBhAGAOEBH....hCAA...,1,1,-26,27
SHBJOEaAbYRDITMGXCcFWPVdUgLNQfKZe,RAAATAAAGADA.CAFA.FACA....VBGBdAFALAHB.hAAAQCCAZDAAHEFAOFABhABAABHBbDFCDFBAMFEBhADAXFGA.PGDC.....hAFA......hAHA...,2,-18,-13,5
fXNgYCHMQASRPUJTBVFWbLEeZKaDcOdIG,RAAAUAAABADBFADALAFAZAFB.DCCAdBHAGCDB..XBDChAIA..gDGAhAAAHEDAAEHASFGAhBAATGAAbFFAEGEF.eHFAaGCAOHCCIHCA.hABA......hAGA...,2,-17,-14,3
QIEKRDLbPacZCOUJWYNgVAFfGdXHSBMeT,GAAAHAAAMACAeADAQAFAEAGA.RBDBLBHBaBGEZCDAODAHhAAAUFCAJEGF..YDGBhACANIAB.ACEAdEEAhADABCCDKGHBDFFB.........hAEA......hBAA...,2,-9,-8,1
HSfTaIYbVDMgBdLCZOcFNRXKPeJGUQAWE,HAAATAAAaACA....IADAbAEDMAHBdAFAZCCBFAHB.RCAAKCEDhAAAeCHHGDFAAAGBEEEAfFGEhAAADCIBLFBAOGCAhAIA.NIBB.PFHD.JHDAWFHH.hACA......hBFA...,1,13,-8,21
gPbaBFMKNQdLfXOUDYJEGRHZeScAWICTV,CAAATAAA..VACA..bACBFAFAMAFAKBHB...dBEALCABhAAAOBGBDBIBECCBHCEAhACAeCCDADHB..gEEAhAIAaEEBQFFAXGCCYHBA.hCGA.JFHB....hDAA...,2,-19,-5,14
BUEgFPHDWGdOZSRMLbaXAcVCYfeTKQNJI,CAAAeAAAKACA.QADA..IAFAEAFAFAHDHCCAGAGAZDFBhAAARCAAMCEBaDHDAEEAVGCAhABA..TFCABGHA.hCAAgEAA.DDIB.dFFASHGGhCBAbFGD....hCCA...,2,-15,0,15
JUYdMWNTHIEARPVOfDLCSaQcZbGBKXegF,RAAAOAAALADB.CAFA.aADDZAGBGAFA.KAHBeCCDFBBHUDDAhAFAdCFCMBIB..TEGAhAHAHEFCAAAA..fFBAhBAAQFAABDHBXGGAgGGAhBDAYEEF....hAFA...,2,-17,-11,6
IcfAabMdBQGPESJWKXFDTRCeULNVYgHOZ,aAAAdAAAGADA.EAFASACH.KAEADAIBRAGFUDDALCGBhACA.VCBBHEABZFAAhADAfDGEADFAMDIBQFEChAFAPFGBWFHHFGHHeHBG..NIAB.hAEA......hAGA...,2,-25,9,34
ORBFCaTMZENbLcVDJUIgeHKPSdWYGAXfQ,QAAARAAACADB.aACEZAEB.EAGALAFADBIB.UCDAeCCBHCFAhAAAKCGB.dDAAGEEAhAAAAAGAOEFEFEHD.MHCA.hABAcGGAIGCA.......hADA......hCAA...,1,-9,-25,16
IGHXMPRLZDgbWFdCUVSEfOaQTJYAcBeNK,eAAAKAAAHACBMAEARAEAZCAFDAIB......bBAAdAHA.CCGDSDEBhAAAEBEAOBGDaDEBQEGAhACA.TGEAhAEAAAAABEBA.GFEBLFAAFGCB....hAFA......hDAA...,2,-13,-13,0
gPRbBdELMNOWKDUGVFQICAHaeJTXcfYSZ,HAAAeAAA.TAEA..fADAZAGBRCAAdDEAEDHFMAFA.OBEChAAADACAGECAQDDAhABAABIBaFGC.XCGAhBGASGABbEGDLHBAKGEA.....hAAA......hAGA...,1,0,-1,1
eRLQWFfVJCcXHDYaUBNGOgITKEbSZdPMA,RAAALAAAQADCFAEA..JAHBCAFBHAGB.aCCCBBDA.GCAAhABAOCED..TDDAhACAEDGBZGFAdDFAAAAAWDHHhAIAVFCB..DEIB..NIBB.KFGB.SHAGhAHA.PHEC.hBIA...,2,-15,-9,6
bgTDLONWaJUSBICYZfeHVcRGKdPAXEFMQ,EAAAMAAA..QACATADA.LAFAOAFA.aCCCUBGBBCFAhAAACBBAZDCAHCGB.REBAdEEAhAGAACFBFDGDbGFADEIB..JHAAhAHASGGB.......hBEA......hCAA...,1,5,-31,36
DCMGNLfeEASgUcQJTXYPIWFBOaVbRHKdZ,SAAAUAAAQADA..TADAXAFAIAGABCDDaBHDhADARCCBHCEA.ZDAFMCGBhAGAGEFALEEBhAIAEDHFAAAAgGCAcEGDYFDDWFADOFHDhADAKGHB.CBHA....hBAA...,1,17,-20,37
OgYecBEZXLUQWfRNHaDTSAGKbIdVJPFMC,GAAAKAAAdACA.JADAMAEA..OAGD.eCDBEAHFZBDBLDFAhAAAQCFCRDBFHFCBaCHDhAAATFFAAFDA.IGAAhACAFFFACGBA..YFHBBFHB....hBGA......hCAA...,1,2,-30,32
DWZQRKTFPbHXMJELdeSBYfcAINOGaVCUg,OAAAaAAA.UAEADADAZADE.RAGF.FAGEHCCCMBBBLEFA.hBAAeFCBBCCA.fCGAhBDAABBBGGEB.CDEAQEBAhBEA.TEGA...XGGAhCAA...hAIA...,2,-24,-22,2
XCDHWGTLfgPYcNMdObeIZKSJEQRFaBVUA,DAAAHAAAGABBTAEALAFB..fAGB.gCAAhAAAcCCCdAHAeCEAhACAZDFESEAAhAEAECHFRDCBaEEABEHAAFGACFCAPFHDMFFBIGGAKHBAFHDA.hBAA......hBHA...,2,-16,12,28
aSdgVMLNHGTCWRFDJEPbIUYZABecQfKXO,eAAAQAAAKADA.aACEdAFA.MAHBHAEBGCCATAGA.RDAADCIBhAAAEDHF....bEFDIDGAhADAZFDBAAAA.fDDBhAGASHGALFFA.CHFA...hAIA......hCAA...,2,-15,-8,7
INSWLeCGAbVXFcaMTQUKHRJdOYZgDfBEP,XAAAaAAA..MADAQADAHAFCRBBAdCFAZAFBDAIBECHF.IDAAhAAASDDB.eEBBhAIAABHBbDCBFEHD.TGFAhBAAKDHBOEEB.fFBABFDD.PFGBhABA....hADA...,2,-22,1,23
RUfIMFLJHNCXbdgTEPGWZVacQYSOBDKeA,RAAAUAAAMADALADA.HAGBXAFAdCDAECFBGBDAZEAA.aBHDhAAAQEFBOCCHKDFAhABAAAIBFFHDCEHA..bFCA.hAEA....TGGA.....hAFA......hBAA...,1,-7,-15,8
NcaZRKDYbOILfTEMQUgFBdSVAHJPXeCGW,HAAAXAAAeACEGADA..NAGAZCCARAFADCHBOAHBLDAAEDHFUECAhAAABDFAdFAA.AAAACEHAhADAaFABKFDA..bFFATGFAhAFAMIAA..........hAGA......hAIA...,1,1,-19,20
RKUZELCBbVHPJQcXMIOSYTaDegWNdfGAF,RAAAZAAAEADELADB.BAFAHAFBQBGAMAIBSCCAhAAA.aDEDeCAB.gDEAhABAdEGAAAHBKFAAbGFAhABAPEGD.XFAAOHDC.DCCB.fFDEhACA.FHAC.hAFA...,2,-12,-5,7
YMPZITOegCSdAXQUBfcJHVbWDFaKLRNGE,QAAABAAAJACA.HACA..VAGBbAFBFAHDLCBA.RCEF.hAAAECDA.MDFBZEFBODHDhAFAeDGFSDHHhAAA.AEAAfGHADGAAaHGENIAB.GEABhAEA......hCAA...,1,3,-25,28
TQIadEXeLHPVMgcROADUCbFYZJWBGKNSf,CAAAFAAAZACABADAGAGAKAFA.....SAEETCCA.aCCAEBHFhADALDAAHCEBMDIBhAFARDFBAAIB.DECBUFDA..hAAAbEGD...YGCGNDIAfHGB.hAHA......hAIA...,1,-13,-30,17
FOUDPHYSZWKNLMCgXTbdaBeGfcVIJAREQ,EAAAQAAAFACD.DADAHAEAZADE.KBHBMAHBCCDA....TCFAhAAAaCDDeCFBGEAAfDHAhAAAIEEARFEBUGGAhAIASEGA.LHEAXGCCdGGB.hBCA......hBIA...,1,-4,-13,9
TQGafLCZVDHJIFdAXMBgPORSKbYWNcEUe,MAAABAAAOACARACA.KAFA..bAFB....NAIA.EAHFeBCBhAAAGCDALCEAZDGBHFCBhBAAFDBBACFAXGEDhBBA.SGHH..cEEA.hCAATGEA.aEGFCCCD.hCBADGIB.dHAB,1,-2,-23,21
WBCJeXNTPURAKLfgQMcDbaYFdOIHSVZEG,LAAAQAAAMAEADADA...aAGEdAGAHBCCZBDBECFBGCAACCHA.hAAAeCFA.TEEAhABARDBBAAIBKEFDfDHAhACA.bFBDOEGDSFHHBGBDNEIAgGEAhBFA....hCAA...,1,10,-23,33
SfQZHNEcTXLDIVRYPgKGAaWUBbOeMJCdF,aAAABAAA.eACAMADAdAGAFAGD..QBEAHBBCECEF..TDFAhAIALCAA.DAIBREBAgFFAhBAAADEBbDFA.hAAACCHA.ZFFANEIA.IHDA.PHFC.hBBA......hBEA...,1,-10,-11,1
AUHQafKONBSFGILJVZDXRdYgbPeWcMTCE,HAAAaAAA.OACABADAGAEALAGBZAGBRBDAdDDD...bEFAeBBBhADA.MBIBEGBAAAIBQEDChAGAKGEAFHGE.IFGAhBAADCCB.XGBC.PHEAhBGA......hCAA...,1,-7,-18,11
ORUEFDgKIJXfCMQPHZLBVAdGTbYeSaNcW,GAAATAAA.eADA.aAGD..NACBOAFEECDADAIB...KBDAXDCChAAAMCCBHCGBZDFALFFBhACAACGBdDDASFDAhAAARGBAFEAHIHHACFHAQGFDBFHD...hADA......hAEA...,1,2,-9,11
aVSDKYEfgPCOTZIBRAMeFXcLdQJHWUbNG,eAAAXAAAdAEAHAGBUADA.GBCA.aDGCDAGA.EBFE..fEBAhAAACBHBZDBARDFAAAAAFFDHhBDALEEB.QGABhABAbFFA.SGFHKHFA...hCAA......hCBA...,1,3,-23,26
YebCTcLfKIFWZaPVAQgJNSRDdXMBUHEGO,QAAAJAAA.RACAdAFAMADAHBGBEAGAGBCBeCDF..bDABTCGAhBAALEEB.KEGDhAAAFDDHaAHFABIBSEGAhBFABFDA.OFDECGHA.fGHAhCAA......hCBA...,1,6,-26,32
IOaWGJVZQSgCDeLFHMXUKRPYfcETdBAbN,..IAAAaAAAGACAZACA.QAEA.CAGALCHBhAEAHAGBMADAKDFARCCAfDFAhAIAEEDFdFFAAAIBOBBHVEGBDEEBhBGAeHDG..........hBAA......hCAA...,2,-15,-6,9
fcFQMNeYgPTCdaGJUHLBIKXbZWEASVORD,OAAARAAADADA.FADDMAGB..eAFA....gBDAhAAATCEAaBBHGCGAHCGBLFAAhAFAKAHBZEBAACCBfEEBhABAQFFCNEEACGGDdHABBHHA....hAGA......hBAA...,1,-11,-15,4
EfGALQVBSCRMXPOKgHYTFDUbNecadZJIW,LAAAQAAASADHRACA.MAFAOAFAHBEBTBFAhAAADBGAUCAAeBHHdCGAZDAAIFFAhABAEDDEAEGBCEHAKFDAFDDH.hACA...NCIAaFHHfGGA...hDAA......hDCA...,2,-10,-8,2
MLDaPHdcCWERVOGfTFAIUgNebZKSYBXQJ,UAAAeAAAZADBKADABAFBQAFA.MAIBaAGD..HCBCdCCCCCFDRCEFGDGAhADAFDGD.AAIB.IEEAhAAA.NDBA.SECDhBAA.XGEADEIBcGGA.hBCAEHBA.....hCEA...,2,-27,-11,16
YcCfDaFbQZVKBXgIOMeEJRTSHdULNWAGP,GAAA..cAAADADAaAEE..QADAZAGBBCDAXCEDhAAAOAFCECAB.RCEAHDCBhACAdEHALFFBAAHACCHBbEGBKFFBhADAMDCB.eGCA.......hBAA......hCBA...,2,-16,-11,5
fgASJdbDaEcMRIZUBKHXQYCWNTVGOPeLF,dAAAaAAA.EADARACF.ZABBKAECHAFA..QAGACCEA..TCGAhAHAGCDAeDCFLCFBhBAAfEEAABBBbDGDMFDBhBIABEHAXFGC.NIAB.....hAIA......hBAA...,2,-14,-10,4
cWQgPJNSabCGMdXTLKfOIeEVBYADUZRHF,ZAAAHAAAFADAQADC.JAFAaAFDGCABdAHALCABOCFAEDEAhAAABCCDADIB.RDEA...hABAgEFASDHBhACAbGEAMECB.TFDA.KFHD.fGFAhBHA...hACA...,2,-16,-7,9
WFBSHRKLgeUGAaYfONdMcQJCEXTDbIVPZ,aAAAOAAA.dAEAMADA..QAGAEAGADBBB.VCCBZBEABCCAhBAAHCFAREFALDEBhBDAUGAAABBB.fDGEhBFAJFEFCEBD.bGFA..IGHA....hAGA......hBAA...,2,-20,-10,10
FQZRgYPUfLcdEIDTbCJSMONXWGAKaHBVe,HAAAeAAAZADBRADF....gAFBPAFCLCCDECAB.TCGAhAAAbCED..SAHBhAAAMDBBXDEDhABAACCBaDGAFEHHQFGAfGEAdGCACGEAODDBhACANIEB.KGGD....hADA...,2,-1,7,8
TXOSWeYZMfGNAIcHRdQCVaPEDgBFJLKUb,HAAARAAAdADA.QADCCAFA.aAFAEAHBBBFALCCAKBHBUCAB.hAAA.bCFDTDDA.hABASDFBeCHBZFAAMEEBhAFAGEGAAGGAIHHAPHDADIAAFHEE..hAIA......hCAA...,1,3,-11,14
QDSBcPNObgWMJZLIVEfHTYGUdXReaCAKF,QAAABAAA..PACAOACC...bAFBMAGBZBGBLCDBhAAAEAHBHCBAGCGAhAAAdEAARFDAeDHHABFBDDFBSFCDhAEAgECAIHHATGFA....hAIA......hCAA...,1,-3,-16,13
HIcdCRQaEBZfVTbJOeKAFWMXgGUSNLPDY,MAAAGAAAUAEALADA.DAHBHAGDdCDARCFBEBBAZEAA..TDCAhAIAOBHDACIBFDGH.XFDAhBAASEFDPEBBhBBAIFHA.CHHA.aEHD.fGGEhBEA.....hAAA...,1,-1,-26,25
OTcPEIUWBSKAeXaVbZRDJLfYNCGFgQMHd,eAAAaAAAZACBRADALAGB..fAEACCCAGCEAFDHDMAGBHEAAhAAAdAHATDEAEGCAUGGAhABASDGHAAIB.hAEAbFCBDICAJFHB.NBBA........hCAA......hCBA...,1,-2,-6,4
ORXSQgVaMFUTYKcBNLbHJIdfAPDCeEGZW,CAAAEAAAZACARACA...QAGAaAFA.FCCATBFA..KCFABCCDhAAALDABHDAAdDFDhADAAAEAeDHFGECB.XFGAhAIASEEAMBIBcGADJHFA.fGGEhAAA.DFIB.hCAA...,2,-25,-3,22
fLJKBaMRPQFAHEWDIGCdOZVbeUXcYgSNT,HAAAEAAADADAGADA.dAFBZADEeAHHUCCBXCAA..gAGHhAAATDFALFDBhAAABCFDRDFAFFFHAACACFFDODHDhBGA..........hCAA......hCGA...,1,-2,-37,35
WEaSGgPdfbHOYQDKMcVFILUBCXRNTeZAJ,EAAAGAAAdADAHAFAQADAMBCB.FAFELCFACBHARCEA.eDBDAAABaCDHhACASDDB.hADAfEGAbEFADGEAKGHDhAIAIGEABHEA.NEIAJFAF...WHCGhAAA......hAFA...,1,-7,-12,5
dYeGUfFOaWHNDLMZAPKbEVXIgCBcJQRST,KAAAEAAA...XACBCACABAEA..QAGARAEAdAHAeCCBGCCAhAAAFCEH.aCFBHDGBLDHBhAEAACGBVFAAIEGAhAGA.gGDASFFD.....hBIA......hCAA...,1,-13,-18,5
ETCgDUabePcONWVGSZAKQILFXMBfHdYRJ,QAAALAAAMAEAHACARBCA.EAFE.TCDADAIBUBFA.eCABhABAOAHD.VDFAZDEAADIBhACAFEAABFFAdGCACFFDaFHDPFHDhAAA..WHCAKHAC......hCBA......hCHA...,1,13,-26,39
AOaJdCWVRBeEbPYLTGUgNXSFfQIMDKcZH,aAAAdAAACADA..RACFBAEBEAFA......bABDLAGB.hADAGCDAgBFAhAFASBBDQDGAhAIAMAIBKEHBHDCCABGBOFCBVFFB.eFFB..hBAA......hCAA...,2,-26,-8,18
USHaMdgFBbfeWKZYIPVGEDCLARONXJcQT,RAAAXAAAQADCUADAHAFB.dBHABAFAeCCBZAGB..IEEAhAAAGDBAEDDALEGBhABAAAAAODHDJFAASGFDhAFAaEFBMHEA.FHAA.......hBDA......hBIA...,1,7,-25,32
YUGJdBLZQHCfFAOcKXVPaDgRMeWTbSENI,KAAAXAAA..aACARADA.eAEH..bAGBEAGA...ICCAhAAAGCEAdDAAZCFBHEGBhAGAFDCBAAAAOCHDVFDBDBIBhBDAMFHB.TGCA.SGFHhADA......hAEA...,2,-14,-12,2
MNXWFRUQYDHgCLSOfaEZKIcTVGAJbdPeB,dAAAeAAAMADA..XADARAFAUCCA.QAGAHCFCLDBDhACAfCCAEEFBZFCBKCFA.hAIATEAAAEIBJFHFBGEAhBAAFDEHDDIB.SECH.aEGB.IGHAhAAA.cGAChABA...,1,-6,-22,16
FAQgVZJXEUNWYfaHMcICOSGBbKTePRDLd,QAAAZAAAEADE.UADA..NAGA...fAFFHCAAMAHBhABACAHAGCEBKCEBeCHHRDBAdEFDhAAAAAIBVECAXFGAhBCAaFAB.OHCABFGD........hBDA......hCAA...,2,-10,-10,0
XbNgMacIKPYZGQBSWJUHVAeFfROdDCTEL,eAAARAAAdADADAFAEADALAGB..XAGA..bBCAMBFBhAAAaCHDKDDAZCFBGEDAhABAQEFDBCCDSFHHhAAAUGGAADHA.OGBACHFC.NIAB....hCAA......hDAA...,1,-5,-24,19
eZAfYacBJHTRWObgPNIGDVLMEXQdKSFCU,aAAABAAAHACBRACA.OAEA..bAFB..PAHDGCAALBEBhBAAEAHFdCCDFCHDeBBDAACA.hAAAfCGEJDEB.hCAATEFAgFCDDEDBMEIBQFGAhCFACHGA......hDAA...,1,4,-12,16
OHUbgQIfMSGBFDVJXCTYNdAeEWZKLcRPa,EAAAZAAALADBRACA.aAFAHAFB.bCCCQBFC.MAIBhABAGDAADCAAXDFAhACATDGAdEEA.AAHAeECHhAAAKEEDOEHDgGFASFCB.FGFBhCFA.CHHD.YHBGhADA...,2,-4,-4,0
ReKfSdCWaXVNALcUYPTBHIFEGbQDgOJMZ,LAAAUAAA.TAEAHADAEAGE.GCBBQAGCOCFAZCAAhABARDFBeDABSCCEhACAdEHAaEEHXCGA.hADAADFBPEABBHHA.bEEADFABMFIB.CGEANIAB.hAFA......hAIA...,1,8,-4,12
PHBUIXJYZCSbRaATGWeELQfKDdgcOFNVM,GAAAEAAALADAQADADAHB.dAGAOBCBFCDHMAIBHCFABDFAhAAAXDDCZEFECFBARFDBAAEAeEFAhAAAKGGA...gFCAhAIANDAA.PFHD.....hACA......hADA...,2,-11,-5,6
AUVXWHOYFGgDQfKTSZLEePNdaCBRMJbIc,XAAAHAAAFADAGAFADADA.QCABKAFAZBCBLAHBEAHBeCEBhAAAdCFAaDCDRECA..MEHBhAAAbDGDADIB...WEEDhACAOHCA..........hABA......hCAA...,2,-28,8,36
fPUAQaNOGDLbHZKMERTeXSdCgFYIJVBWc,aAAAGAAALADAHADAZAGBKAHB.RCEBeCDD.dEHAFBBH.JCEABFAAhAAA.fGCAhACAAAEAQDCADBIBEGFBTEGAhAHACHHA.IGEA...cGGC.hADA......hAFA...,2,-23,-3,20
BeMDWcgFVdTHIbSKaYXGNRJCZfUAPQLOE,LAAAEAAABACADAEA..gADHdAHAHBCC.SAFHhABAKBFC.aAHBGDDBRCAAZCFEACAAhACAQFGAeDEDMEGBhBIAFGDAIEHA.......hAAA......hCAA...,1,-1,-29,28
EZbfOBQCgeGdRANIUFKVMJYPWDLScXaHT,UAAAKAAAMACA..JADA....PAFCLAGB.XBDChAIAHBCAECFAZDEAbDEABFDAhBAA..QEBAhAAAeEHHdFFAABIBFFFB.YEHBSGCD.hAIA......hBEA...,2,-28,-19,9
LAdZDaXPJUHeYTMKCGbcFEgfOSNRQWVBI,ZAAAaAAA.JADAHACB.eAEAMAHBGBGA.FCEDECAAOBBHRCDA.hABAQEABBDHAAAIBdECAhACAXEFDUFEAKGAAbGCChAEA...fGHASGGB.NICB..hAFA......hAIA...,2,-25,5,30
ZBMeFADEJbTPRLIQHYGcXfUdCSaOgKVWN,EAAATAAARACA..LAFBHACBGAEB.fCAEdAHAaCCCKDAAhAAAVCEBZDEEeDHHAAEAbCGD.hAAAQFCC.hACAXFFDSGGAWHBAMHAA.DCIB.hADA......hBHA...,2,-10,10,20
DdVBcPFAEJHgYRQKXUZbNOfaTGMISCeWL,HAAARAAAQADCXADBZAFBOAFC.aCACGCGA.MAIBhAAACCCBeCEALDDBdDHABEEAhAAAFFAAEFFBgFCBhACAKHBA.bGFA.fHABSCCDDGFA.hABA......hAFA...,1,8,-10,18
GMfKNVJORDZLXaAUWCcSPIFdgQeBTYHEb,CAAASAAAFACA.dADAeAEHBAFAHAGBEAHB.GCBA.MDFBhAAAKCCDVCFAREGBZGAAaGDFAAAAUEDAhAFA...PEHDhAIA...QGFD.YDBFhBDA....hCAA...,1,-15,-24,9
YFRbNeXQgWfHIdDJEOTVGPcSZACUBaLMK,BAAAaAAALADAMACAFAFDRAGF....eBBBQBCA..hAAAfCFEHBGBdECAEEEAhAHATDDAPEHDZEAAACIBhAEAKCBDbEGDXGFC..IFFAhAFADAIB......hAIA...,1,-9,-16,7
UNGSTHJLQDCcBgAIOEPfaVReFKWZdYMXb,EAAAaAAA.RACA.KADAZAFB..dAFAMAIBUCCAGCDAHBGBLDABhADA.QEFChAHACCCDBDAAABHBODGD.fFAAhAAAeEHHFFDB.XFCDNIAB.SFFDhADA.DEIB.hAIAIHHA.,2,-14,-3,11
DaTcHASeNRPOIGMJVbWUCEfKLZgYdXBFQ,eAAARAAAOADAGADA.MAFAJAGB...VBGBUCCA..ECCBLDFAhAAAZEFAdFBAFFDBaEBCHFCChABAAAAA..SGEAhBDAIFHAbFFDfHGF...hAIA......hBEA...,1,-3,-22,19
MCXPZVGJOIaTEbdLUcDYAFBfeRQHSWKgN,BAAARAAAHADBKACAMAFA..XAEBZBFBGDAA.OCHBaAGDECAAhAAAdFDALCDBDCCBAAAAeFFBhADAQDGA.hBFASFDANEIACDDD.PGFC.IGBAhACA....hAIA...,2,-33,1,34
IZCBJdAWQcGbOYMfRFXaLPKHENVUTSDge,QAAAGAAAOADAMADARAGB..FCDAaAFELDDAHBDA.EDHFUDBAhAAA.TCGADFFBeDBHhAAAZEEABGEAAAIB.cGGChAIAfGCA.KGGANIBB.....hBCA......hBDA...,1,-6,-11,5
eFQEgOXYdCIbKPVUfLZAMRJSWHDTaNBGc,RAAASAAAHADBDAFA...aACDGBFA.eBHBEAEAXAGAhAAAdDAACCCDKEEB.UCEAZFBBAAAAMCHBhABA.TEAABEHDQGGAhADAODDHbFFAfGDA.hAIA......hBFA...,2,-10,-3,7
UERCPLWINaJdgGFMXefYVcSTHKABQbODZ,QAAADAAAEACA.RACALAFB..IAFAaAHBdCECGDAAhAAAMAHBeBBB.fBDAhAIAcCGDHFFAhADAABIBbCFDODDH.CEHANIBBFDEB.XFCChBAA.SEHBhCAABHHA...,1,15,-33,48
fSYOUaGQVDZCLWJRbPMXAdFcTHgBENIeK,dAAATAAAHADA.EAGEeACEKCBA...SAFBOCECGEEAhACAQCCAZDAALCHBhADARBGFbCEDMDBBAEEBFFAABAHBhAAAfGCAaDHDCGEA........hAFA......hAIA...,2,-4,-4,0
OHdVgWaCBEIGDbUFLXRJQKSYZcePMTfAN,HAAAdAAA.VAEAaADAEAGAGCAB..DBDBFBHDRCBB.QDEAhAAAKBEDZCGB.eEABMDFBAACAOECDhAEACFHA.BEGBbGAA.hACAXFGA.SHAAcGECfGGEhAGANIEB...hAHA...,1,2,-20,22
GcXfMCWHBOKeRPAZFYJIVbdgQTNEUDaLS,ZAAAFAAA.JADA..IADAdAGA..QCAAEAFA.DAIBaAHDhAFAGCDA..fCCAhBAAMDFAHFCBKCFAhBHARFFAAEIBbDEC...TFCA.LFFAhCAA.SHFAhCBACHEABHHA..,2,-19,-14,5
RNFUbZASDEKcVTYMXJdPWLgBaHIQOeGCf,EAAAKAAA....TADAMADAdAHALAFBaBCAHBEBQCAAhAAAGCCAREFAFAHBZGBAAACADCDB.hAAA.cGEAXDFAhCAA.PEDDBHHA.eFCD.fFFAhCFA.NCIASGHDhDCA.,1,-1,-15,14
TVQdYAeIRZMDWHgbKEBNSOfCGPUFXacLJ,RAAAZAAAMADAHAEA.KBHBEAGABCAA..OBDCGCCBFBHDaDFELDDAhAAA..TEAAhABAdEHAACCBeFBADACAbEFAfFFAhABAUGAB.JHFEQGGC.hBFA......hCAA...,2,-15,-2,13
QDOUafKNIYdBRXcGbJFeHZEAMgPWLVCTS,MAAA..gAAALAEACBBAQADAOAHD.aAFEKBDDICCAhAAAdCFARDGF.GCEBhABAFEDBHFABAAIBPDABhADA.TEEADFFBfGGEBEHAbGAAeHEAhAGA......hCHA...,2,-21,4,25
AHcMZUFVXWfbQCaKeEILODdPJTNBYgGSR,HAAAZAAAFADAXADB..bAFDaAFDKAHBEAHB.LCAAdCAA.hABATCGABCCDGECAhACAADEAMEEBVFBBQEEAhAHAeFFADGIBPEHB.NIEB....SCEFhCHA...hAAA...,1,0,-6,6
WCEaGeUgIRQdDAPXYKbFMHLVBNOTZfScJ,XAAAKAAAMACAHAECLADABAHB..TBGAZCCA..SBDGhAAAJCDAEDDBGEAAhAAAeCGFUFFBREGBdGEAAAEA..hABA............hAHA......hAIA...,1,-10,-30,20
KFVZdNeHUDLBYaAQRMWCJTgcEXfSOIPbG,RAAAMAAACADB...TADAEAFA...SAFBOAHD.IAHAhBAAGCCAFCFB.dEGAhAAAHBBBLFABaCFCABBBQEDAhCAAgGFGfHDBbFFBKDHB.hCDA......hCHA...,2,-17,-15,2
GecQSUVdERYDHWfJXgNOMBZPKabCTILAF,eAAAQAAAUAEAdAHARACAHAFB..JBCBXCDD.OAHFhAAAZDEAaDGACDAALEGBhADAAAAAGEBB.SFAAhAFA.EFDADFGBfHABMFIBKGBA.IHDAhAHA....hCAA...,2,-25,-6,19
eRZgHaYKEVIbSBQcXCUWfNMFdTOJPADGL,GAAARAAAHADBKAFAEADA....IAGABAHBQCFACBFD.hAAAUDAAfBHAhACAMCIBdEEATCDAODDHADABeDCBhADAaFHH.bEFAXGFDFFEHDGGB....hAAA......hABA...,1,0,-15,15
SYcWOIfTMaJbRgFQAedZCVKDNGBHLEPXU,eAAAZAAAKADCGADAHAFAECAAUAGA..SCDA..cDBAhAAAOCGD.TECAhABAaDGAREFAQFAAhABAAAHA.dGEADCIBBAFDLEEB.XGFDhACAIGHA...hCAA...,1,-6,-19,13
aLbMUQAHFXZDRfISJcWPYdTBeEKOCgNGV,HAAAZAAARAEA.SACE.JAFAPBHDdCCABBEAECAA..CCDAGCFAhABAaCFDLCHB.hACAMEEBAAEADEEB.fFHAhADAIFFAYHDGeFDDOFFH..hAHA......hAIA...,1,-17,-18,1
LcXbdKZaGOJUBCERPNSfAYMQWFeVIDgTH,MAAAQAAAFADD.eACADAFAHBBBLAGB.XBDAdBFAaAHDGDGAhBAAOCHDBDAAhAAAREDBSFCDAAIBVDDBTFGAhADA.KGBA........hBGA......hCAA...,2,-19,-7,12
ZBHeEDOKSJVFYXCAWcPMNgQaLbUfdGTRI,...PAAAMAAAQADALAEAUCCAGAGARCFA.ZBBFHEDChAFAEDDEKEFASDBDhAGAFFBACAFAAAIB.NEHA...bFDDdGCAhAIABFHADEIB..........hBAA......hCAA...,2,-18,-6,12
PgYVaGIESTUKHXcCReQJMNLBZOFbfdWDA,...PAAAgAAA..aADDEADATAFAHAFACCCA.RCEBeCHBhAAAMAIBLCCAhAFAZDAAbEGD.dDGAAAHA.GEEAhAHASEEDXDBCcGDCNEIAFHCADIGAIHGAhBAA.....hABA...,2,-5,9,14
WPLIEMAYQTGVFSDcCRJNdKbfaUOZHgXBe,TAAAGAAASADA.CAGARCDAdACA.bADDUCGAHAFABDCDhAAAeCGFLFEAEDHFAAHAQFAAhAAADDABJGAAKGHBaEEBhAFA.ZFFA...WFCHMIAA....hACA......hADA...,1,11,-19,30
QgUIRCcKHGJEFbMBdYAXVeaWZTOLSNPDf,eAAAZAAALADB.SAFADAEAQAGAUCAA.RBCAKCFAHCFAhABAEDBBMEEBdEDAAAAAaAHDODHDhBDA..fFAAhACACFBDGGEB.bFCDBFFCXFFA.WFHHhAFANIBB.....hBFA...,2,-14,2,16
YEcQfSPHICdRKLTbWJABVeGOgNMDXUFZa,eAAAGAAAOADCMADADAHBFAGA.ZBFF..ECCAQCDA.hAAASBHHHCEAdCHAREEAhABATEBAbFAAAFAABFHAhAFAgEGAXGGCaFDDfGHA.hCAA......hCBA...,1,-6,-7,1
bUgBELcRGSZQJWOVHPdFMIeYaDXCAKTfN,TAAA..bAAABACBEAEA.RADFZAFB..QAGAOAHDHDFChAAAdCAAMCCBeCCBaEEChAFACCGDAAAAKDDAUGGALEGBhACASFCDVFCA........hAEA......hBIA...,1,-3,-15,12
HZJOCgKcaSVGUeDFLbEBXfWRNQTMPAYdI,dAAAHAAAZABBCADBKAFA..aADDGCABDAFALBFAEBHFBCFA...hAIAXDGARDBAQDFAhBAAMEEBAAHAJFDA.ODHFhBDASECHUGBAFGHHbFAB....fFFAhAAA.WHFAhACA...,1,-5,-28,23
VSULZPHYdGNgeCAIObEcDfQWRMBKFXJaT,OAAAEAAADADA...QADARAEAKBCA.XAFAaAHD.TCCAhAGASCBD.ZCDEhAAAHCFAGDGAeEEBADIBIEEAhAHAbEGDWBBDMIAAFGEA.....hBCA......hCAA...,1,1,-23,24
HAKZXYRETIULbCWfQGJeVSaNBdODMFcPg,ZAAARAAAEADEUAEA.LAHBCAFB..QBGAeCAB.aCCAdDDAhABADCFBMCCB.FDGHPDDBhAAAHFDCABGA.KGHBTEGAhABA..IHCAbGDA..fHABhAHA...hACA...,2,-20,-18,2
DIPRLOcHeQCbZSNAMaBgFETYUWGJfKXVd,aAAAFAAAEADA..TADAUAGAGBEA.KCCBdAFA.DAHBRDABLDHBhADAHCCAeBHHQGBAhBAAZDAFABBBMDGBBEGAhBGAgFEDJGEA.fEHA.IHHAhADA...hBIA...,1,-7,-12,5
cObXRaEFCZHKVYdJSILTNDBMgGAUPfQeW,UAAAQAAAeADA.OACCRAGB..ECDAZAFBHCFBKAHBdCDA.SCGHhAAATDAABEEDhADAGEAAAAIB..fEHAhAEAbEFAaFCAFGGBCFDD........hAEA......hAFA...,2,-17,-9,8
dYDMLXQFKbSEOgUBANaCZcIRPWeJTHGfV,aAAAZAAARAEA..eACHHCAAGAEAdAHAMACALAGBFCEH.SCHHhAEAECGB.ODDBhAIABEFAADIBCEBAIFFAhBAAJFGB.TGBA.fFHADFIB.KGEDhBBA......hBEA...,1,-7,-26,19
LWIOGTJXPcNCQHeSZYgfDbBMUdFREVaAK,LAAAOAAAGADATAEA..XAFA..cAGAhABAQCFDHCAAeCCEhACAZDBBfEFAbCFDMDIBdEADhAEAEEHFAAFAKFEDIHHAPHECCGGB....hAIA......hCAA...,1,6,-11,17
PRGEKeFBNSHDbUOMaLdcWJfQCAVTXYgIZ,TAAAXAAA....IADARADAEAGEeCDABAFAHCGBDAHBOBHDhAAAaDAAdEAA..JEEBQCABhACAAAAA.gCEAhAFAZGFE.GDCANIAB.bEGD.MFFBhAIA.....hADA...,1,-3,-8,5
MBLaPCYAJDbFEIZdKeSRfgGVHUTcQOWXN,DAAAEAAAdADAeABA.RAEA.GAFAHCCA.UDBAQCGAOAHF.XECAhAFAMDEBLEHBhAAA.aFACCAHBAFFA.bFGDZFEBhAFASGCBfHABTGEA...hAHA......hBCA...,1,-4,-8,4
dHgOGBERaJPKLIXQfUCYSFceATDWbMZNV,TAAADAAAMADA.ZAEEdACA.HAEAGBBARCDBaAGAKBHB.LDEAhAIA.QFCAhBAACCFAFCHBAEAAbEAAVFFABEGD.EFFBhAAA...JFHB........hAEA......hCAA...,1,-8,-16,8
HAKQDeRPWdEGMYNCJULOXfbZcagITBFSV,QAAARAAAdADAGAFAMADA..CAHALDDBXAFAZBDA.aBHDhAAATFAABDDASDFDhAIAHFEBAAAAeCCDEEBBJCHBhAFAfEGB.gGGAFGGA.hAHA......hBFA...,2,-7,-6,1
DTPbNSAEcGULgYfCWIdKOJHQZeVXaRMBF,EAAAGAAALADA..fADACAHAdCBAOCFAHAEB.eAGBhAAAaDCDBDGDTDDA.bDFDhACAAAEAUFEA..YCHBhADAKGGCJHAA.........hAAA......hAHA...,2,-29,1,30
WcJZORALGbEQBedPTIUHXgaYSDFfNCKMV,GAAAEAAABACAeADAdAEA...TAGAHAGBaCCBDCDAFCFD.CCHAKDDBhAAAMDDA.VEEA.JEBFhAAAREAAAADALEHBQEGAhACA.IHHA......hAIA......hBAA...,1,-14,-16,2
WCEOYKVdgAPDeJSQZIGNFbRTcMaUBfHLX,eAAAQAAAGADAFACERAFA..MCCBaAEDBAGAHCGBLDFDhAAA.CFAAEFHFKBHBdDCAAAFADDDBhABAZDGF.bEDD.TGAAhAAA...fFFE...hAIA......hBDA...,1,-9,-17,8
YQDgZIWFMVJUOfEdPBKTcNAHbGXeCSaRL,HAAAGAAAeACEaADARAFFLAFB.QCCAZCDFFBHDMDDBUEFAhAAAEEBFdAHABEGATFCAhBHAAAAB.CEHADGIB.WHDAhCAAOEHD.KGEA.NIAB.......hACA......hAHA...,1,3,-17,20
bFTHcSJeAaIMPXGVDgCfEBWNRdOLYZUKQ,aAAAMAAAGACADAEA..CAGA.EAEABBBA..RAGBdCFALBDBZEAAQEGAhAEAFBFHHCGBSDCDhAIAAAIBXFDDfFFEhBAAOEFBKGGA........hBBA......hCAA...,1,-9,-32,23
OWePEdgbaHfVXFYQTBcCSKJGZUMDRAILN,LAAAOAAA.eADHEADAdAGA..aAFAHBEB.XBBChAIAQBFCTDGACCAAKCHBZECAhBAAMCCBABIB.IEDAhABAPFHD.bEGDFGBABFEASGFH..hBGA......hCAA...,2,-15,-6,9
ROUeYcBXWbAMFTSVLgfNDGKQaZHPCIdJE,MAAATAAALAEA..fACBGBBAaAHDHAEBCCGDdDEARAGBeCCBhAAABDHA.bEABAAFASECHhBAAgDGAKEEBhAEAZFGBIGEAEFHFOGDC......hAGA......hAIA...,2,-16,9,25
LCeVBIKEPYdZRQUaXOgJHFbcMGWfDTANS,LAAAeAAABADAEAEAdAFARAGB.UCCA..aCAAOAHBHCEBFDCD.hAAAMDIBGDFA.DCIBhABAAAIBCEAAKFBAZFGFQFDChAIAXGCA.JFHB........hBFA......hCAA...,1,-10,-18,8
fMDHbcOTAGUFPNRSVYKIWQCgeXZJaELdB,GAAAFAAARACF.SADAKAEC.QAGAeAGFZCDB.ECDAdCHAMCGBhAAAHFDCODAHAAIB.hBAAPDCB.VFDAhACAIGHACDHAXGADaHDC.LHDA.hCAABHHA....hADA...,1,11,-27,38
RJAeMZdXELHPQVNfYODSUgCbFWGaBKcIT,eAAAdAAAEADAHADA.QAGCVAFA...fCCAhAAADCCASCDACCFDFCHDaDECKCHBTDAAhACAAFAAZFAELFFAhABA.PHFAODEE.bFFA.BHFA.hAFA......hAIA...,1,4,-22,26
HcLSQMOJCTUfZIGYVaWKEPAbXdRegFDBN,dAAARAAAeADEDADAHAECLAGBMAIB..CBDAUDDAZCAEGCEA.aCHHhACAEDHF.AAAA..XFCChAIABECASFHBhAHA.QGDCTGEAfGGBhBIAIGGA......hCAA...,1,-6,-27,21
dgPGQCROJfHYZNSBKLMeaDVEUAbTcFIXW,TAAAFAAA..XACDdACAGAEA.RAGBODDBHAEAZCDEBDHAhAAAMAIBeEABaCGDEEAAAAIB.hAEA.IFFA.hAEAPFHBQEECfGDASEHHhAGADGAB......hAHA...,1,-2,-23,21
EXNMIAQTLRCJGSWfOaVbHFcKYPUdDeBgZ,TAAARAAAGADA..SACBOAFAaBFDHAEA.KBHBUDAAeCCBhAAAZCGBECEBMDDBAAGALDGBhAEACEFC.JEEFfFHAhAAAFGCB.........hAIA......hCAA...,1,-8,-20,12
CEAeTadSKVWBIUZHJgPGcNRMXDfLYbOFQ,eAAAdAAAKADABADAZABBHAFB..PAFAGDCARBDA.MAIBDBIBLDDAhAAAOEEA.QEGAhABAAAHBaEHD.SFDAhCAAIFAAgGGGXGGCfHCBhCBAFHDECCED....hCCA...,2,-23,-5,18
OeVEXWKPYRUIHSQgFLZacbCABNfMDGdTJ,BAAAMAAAdAEAOACA..EAGAKAFARBBBHCFAQBCCLEBAZBFE.hAAAaEGDCDED...ABDADEIBhAGAGDFAeFEF..WDHBhAHA.....YHEAIHCA.hAIA......hCAA...,2,-35,-11,24
HAfBFQNVJIMeYLcERKXabCTGWZPdgDOUS,FAAAQAAA.JACEeACH.LAEARAFAKCDA.bBFAGCGAhAAAZCEAdEEAODCBHFAAAAFABEEAhAGAVGFAMFGB.EGDAhAIAaDDHCHHA...........hCAA......hCDA...,1,-3,-18,15
EQGPTfROgeAUFJMDdWYINSKCbLBcHaXVZ,FAAAMAAAdADA....IAEAKAFALAHBHAFBaAHFZCCAEDBBGBBAhBAA...TDEAhBBARDFFeEEDADHADEDB.YEGBhBDACEHAbFAA.BHBA......hBHA......hCAA...,2,-23,-17,6
ALBbQgdRSYfHUGJWZeXcODIECTVKMPNFa,LAAAQAAARADF.SACAHAFBGCAAZAEBeAGFOAHFEBHFTDEAhABAMCDB.FDHHADAABDHAhAAAdGFA.UEEAJHAA.XDAAhADADDDBCHHA.KFHB.aHFA.....hACA......hAFA...,2,-1,2,3
CTdXfFcDVIebELWOSBGAHKQaPgRJMNZYU,HAAAaAAA.RADFMAFAZACBCAEA.dBGA..FAGADBIB.eCABEBFFLCHBhBAA.OBBBGCEAhAAAACEBKDFAQEGAhACA.gGCANEEAUGFA.fCCEhADA.IHHA.hCAA...,1,4,-26,30
MOAIGVTKgCYNJDecXLRbEdQPSZFfaWHBU,GAAATAAA.CADA...JACAeAEHLAFBEAGAdCGAQCCAhAAAZDCAFEHD.aAHBHFDABCHAMDABhAAAAEFAKEGA..gGAAhACADFCAXFFC.......hADA......hAGA...,1,-8,-21,13
OKEbVaDdFPMYBgRTUCGWSXHAQJcfLIZeN,QAAAJAAALADBeACA.KAFAEAFA..aAHDdBHA.MCCBBCDAhAAARDEAUFGAGCEA.XDAAhADAHFAAAFDAfHCBhAFAZDGBbGCCFGHD.........hAHA......hCAA...,1,-6,-14,8
DdJgbQZCYBIaMNHKfcSPAEXeWRGVOLTUF,EAAAeAAARACA.GADALAFBFAFAdCGA..bBGDZDBB.BDFC.aDHDhAAAHCDB.fDAAhAAASFFBAAHAXFCChADA.OFFADAIB.QGGBhBIACHGA.MICA.KCCD.hABA...,1,16,-30,46
EQgOAcRWDVeCNHfPKXbTZYSIFGJMLdUaB,RAAADAAAeADEHABC.KAEC..TBDAZAGBSBEAGAGAMCCBdDDABDHAhBAAEDDB..QEGBhAAAABIB.cFDChABACEGDfFEAXGAAIGGAFGGH..hCAA......hCBA...,1,9,-40,49
HBYQTFNPKGZDfOCcWJEbXaLVeAUSgIdMR,SAAAdAAAHADAQAGCFADA.KCBAZAFBOCECCAHA.JDAFEBCFhAAA.aCEBLEEAhACA.ACIBUGEAMCHBREFBBGHAhADAYDDF.NCIA.DIAA.....hABA......hCAA...,2,-28,-10,18
VZTMHadXgFKeCYILbNAQRGfDEcWPSOJUB,RAAAGAAAEADE...PADAOAFA.BBFAZAGBHCDBdCCAFBHDeCHHhAAA.CBFALDCDhACAAAAAQDFCDEGBSFFDhBAAUGGAMEEB.aHGE........hBCA......hBDA...,2,-26,-3,23
XTOUQLagZHEeCcANFVWPfGYBRbDMJSdIK,FAAAVAAA....fADAGADARAFAMCHBdAFAKAHB..TDAAhAAAQCCBLDFBhADAZDAFHCFCEFABeDDDAEEAPEFDhADABFHADCIB.IHHAOEHDaHAA.hAFACHFD.NIAB.....hAGA...,2,-6,-2,4
LUHDfVKaFGEJYTAcCgIZdeNRPXSBQbOMW,CAAAZAAAdACARAEA....SAHBQAEAMACALAHB.HCDAhAAAfCCEaCBHEEABJEFAhAEAACEB..ICGAhABAeFFBXGBAbDFAOEEB.DFDB.FFGB.hBCA......hBGA...,1,-11,-15,4
PLXFUCSbDNdGQMWZfAgeRTOaBVJIKcHYE,RAAAaAAABADB..VADAKAFAHCCA.EBHFLAGB.FBBHSCEEhAAADAIBGDCAMDIBhABAZEEBADABeEEAOEGDhADAIFAA.PFGD.CHAA.NDIA...hBAA......hCAA...,1,-17,-19,2
RZTDWHBSfKcONQGVaYgbJFIUPECdAeLMX,eAAAMAAARACAZADB.DAGAHAFBBBCAKAHB.OBBBGBFA..aCDD.hAAA.bEEDFDFH.UFAAhAFAEBHBABFBLDHB.hABAXGGCSEGH.NEIA.....hBIA......hCAA...,2,-27,-9,18
NcgFGUXKRQCDPLeZVaWfHISOYdAEbBMTJ,EAAAMAAA..JACB..NAEA.FAEAGAFA.KAHBRAGFQCEChAAA.DCIBeBBBaDDBHEBBhAIAODBH.AAFBbDCDhAHATEFAUEFBCFHALHEAWDHB..SGGDhBAA.BHHBhBCA...,1,-7,-21,14
NWeBUgSYVHfbZAKcJRGICEFDTaXdOQPML,KAAARAAAGADAEACE.DAFA..aAEAdBFA.QDAAMAHBLCCAhAAAeAHFBDHASCFHhAIAHEFA.ZECAAAAA.IEHAhBFAFFEH.TGFA.......hADA......hCAA...,1,-15,-19,4
ZPGcEXAWQOIaSJdfVCRHeMbFYDNTLUKgB,QAAAaAAA.dADACADAHAEBeAFAMBIBFAGADBBBLCFBKCCAZCGBGEEAhADAEDBAAAFA.OEHDhBAASDEF.fEHEhAAARGBA.YHCA.TGGAhBCABHHD.....hBGA...,1,-1,-18,17
XPgKBeFZVRaHJNbGMIfSOCTEUcLYWAdQD,dAAAQAAADADA..XAEAKACAeAEEZAGBRBDAHCFC.bDDCGCABhACA.MBIBSAHBhAAATDEAEECFLFFAhCAAAEHBBFGDaHFAIHHA....hBAA......hBCA...,2,-27,2,29
TLMRXfZPEIKFCUWBcQgeSJDYOVAbdGHNa,GAAAHAAAaACAMADARAEFZAGBEAGA..FCCBCBFDBBHA..QEDAhAAAeCDBDDFA.OCHDhAGAAAABdECALEGBfFFBhBIAKFEAcGCA.SGHH..hCAA......hCGA...,2,-24,-7,17
agdTODbcWGPIAVEQYZLMeKfFRCHBSUXJN,EAAAZAAAeACEFACD.HAFBBAEAUCCB..XAFDaAHF.dBHATDGAhABADCEB...bDEDhAFAGDEAAFIB.QEAAhAAAMHBARGFA.SDGG.gGGAhAEA.OHAAhAHA.WDDD,2,-18,-9,9
AObRZUXJFeYPNdEMcGQVaKfDHTLIWSgBC,RAAAZAAAUADAFADA..eAFH....PAFCEAHBGCAA.aCCChABADCCBHCGBTCFALEEBhACASCHBCECAAFIBXGFDhAIAJDDBdFFAMEHB......hAAA......hABA...,2,-34,1,35
KOTEeZcQGYASRBJWIDgfVbCXHdMNLFaUP,RAAABAAA.JACADADA...VAFACAFBHAGBdCCALCFAFBCH.UEEAhAAAOCEB.EDFFeEBBhABAZEGB....QFCChAAAAEHASFHB.gGFAhAIA......hBEA...,1,-25,-32,7
OHRVZGbNXTcKaWSedEUYCBLMDgPFfQJIA,HAAARAAAGADAXADBKAFA...aAFDeAHHEAHBUCABBCCDMCGBhAAADCHBFDDA..QDAChABAADGBZEFETFBASDEHhADAdGGA.LEHB.fFGAhAFA.OHAANIAB.hAAA...,2,-6,-1,5
NcXaRYSdJUPGIOMFDZKTHQBfELAWVbegC,VAAAeAAACADA....XADBRAEFdAGAUDCAGAFA..MAIBhAAAZDCAHDGBBDGAEEEEAAHAbFBAhAAA....NEIA.aBHFhBFA.SGGA..IGDAhABADDDA.KFGB....hCAA...,1,1,-33,34
KDOJRTfHFgEUPXQSdIAWeVNYGCbLcZaMB,eAAAVAAA.GADALADBaAFA.KAFA.DAIBRBFFHDBB.ECHFXCEDhAAAdFEAAAAA..YHFGhAIAbCGD..ZFAAMIBAhBDAOFFB.fDCEgEGAPHAChAFA.SGHBhAHA..,1,-3,-8,5
RUXMLcfOEGHAdeVBICTSPQDbJgZaYNKWF,eAAABAAACACA..TADAQAEA.DAHBbAFB.ZBGB.aCCBKCAAhAAA.RCCFUDGAMCFBLDDBhAAA.ODHDhABAHEABAAIBdGFASEEB.gGEAhACANIAB.FHGE.fFDAhAEA,1,-12,-19,7
UXEWDNZbeOgVPGITJFYCdSaQcRKBHMLAf,XAAAEAAADADA.ZACBeAEA..OAECVBCB.GCEA.TCGAhAAAFAHDdCFA.aCBHRECBHGFAhABAADHAUFDANIAB...hAGA..bFGB.........hAHA......hAIA...,1,-6,-21,15
FMIEdDQYZbJSUXfcWPgHOCKeLGVRTaNBA,MAAAEAAAdADADAEAZAEB....SAFAXAGA...fBBAhAIAPCBBHCFBKBEDeBHFhBAALDHBRDBAaDFBADDBFEEHhAAAQEGBYHAAbGCAcGGC.OHCAhAHACGGD....hBCA...,2,-9,-4,5
ORcXUILAHKTESYCZMPVgJGNQDaBbfdFeW,HAAAEAAA.CADBZAEBMADA...VAGBGAGAQBCAaCACBCCBdCEAhAAAeDFFRDFFUFBAAAIBTECAhAAASCBD.gFGHhAIADDIBbGBAFFHH.......hBCA......hBFA...,1,-3,-8,5
NbOIZKMULdfRPQCJGXFHBYAecWDgSEVTa,eAAADAAAEACA..aADDOAECZAEB..MAHBdAHARCCA..QDBAhAAAGCFAHFCAAAIBgDEAhABATGAA.bEGDKBBDhAGALGBACEEDFEHDBHDA......hBAA......hCAA...,1,-6,-9,3
fgWeBAGHOYZRCPTEFdVQaXMSJLUKIcNDb,HAAAZAAARAEA.TAEAEBHF.dAGAQCAA.MACALCAAhAAAKCDA.IDEADCGB.hABAbDFDfDHAhAHAeBHHAEAAGEABCEEAFFGH.aFHD.SHFG.hAIA......hCAA...,1,10,-22,32
gaZeGQFVcWJAIYXEKRMObBCHfTDUdPSLN,XAAARAAAMADA.BADAHAFC.DBEBdAFALCCBaAHB.GCEAhAAAQCDCFCHD.VDABhAAAJFHBACGBECHFKGFB..bDFDhABA...CEHAfGHA...hABA......hAIA...,1,-11,-18,7
RSOZPUJcbaNXKTMFCWVAEeDLfIdBHYgQG,EAAAeAAALADAdAEAHAGBQBGARBCBZDFAUFFAJBCF...aCEBKEBAhAAAFDFBCGAA..AAGBDEEBBEAAhAAA.GEGA.OFAEhAEA.PHAAcGDC.....hAFA......hAHA...,1,-8,-23,15
DgGLEdWXMZCNfVKYcIaRSOeBFTJAQHUbP,HAAAUAAADADAGADALAGBEAFAdBHA.MCABZBDB..CBFA...fCCEhAAAKDBB.IDFAhACAREFAeFDBFGHBACGAbDADhADA.....gEFANAIA.YEHBhAFA...hBAA...,1,9,-36,45
ASdUIaXFeHJEWPgcbZKBGfONYVLCQTMDR,dAAAaAAA.eADAHACBEAGA....gAEBZABBGCEAOAHBhAGAVEAALCHBTDEAREBAABBBhAIASGCAXEGAFGDAhBAAPGFCKGGANICBCDDCMIBA.DIGA...hBEA......hCAA...,1,5,3,2
afRIVDWQZgCNPMOXeYFcTLBKJbdGESAHU,HAAAaAAA.RADFDAFAZACBCAEA..MAIB.eBFFFAGALCEABCADKCCD.hAAAdEEAGCGAABBBUFCAVGDAhACA..QGFAhBAA...NCIA.......hBGA......hCAA...,1,-15,-28,13
XSIFYJRaGQbDVdAELWefHBPgOZcCTNKUM,EAAAeAAAHACABADAOAEAZAEB..CAGAKBHBMAIB...SBFAhAAAFCCBRCFFGECAbCCCdDGAhCAAAAAA.LEEB.hAIAfECAgFFATGGA..NEIA.hCAA......hCBA...,1,9,-29,38
MgBXVSGROcDTWdEPeJFZCYAaKNIHLUQbf,aAAAKAAAHACBLADAQAEA.MAHBXAGDGCAARCCADBBBhAEAdDEAEDGBeDFAZGBEAAIBUFAAhAFA..bGFABEEDhBAA.OEHD.TFCA.PHFChCAACFGDNAIA......hCCA...,2,-10,6,16
SJfLFAPRGXUacHEYVgQNIZOKeDbCBMWTd,RAAAGAAAUADAHAFAEADA..VAFAQCGAZCDAKCHB.eCCB.CEEAMEGBhAAAdECASDADhAAA.LEEAhACAAAHAaFHB.gFGANIDB.DIAA....hADA......hAIA...,2,-12,-7,5
VFQNBbATfEeIaSdZLGKYCgPcDUJWMORXH,EAAAeAAA..aACDZADBGAEACAFA....gAGHDAGAUBGAMCBBhAAARCEFHDBBQEDChAEAbDGD.ADDATFGAhBCASGEBdHEBYEBB....hBEA......hCAA...,1,-9,-17,8
JAgKBPeLVdXWNQTbIOUfYCZHGDaEFMRcS,BAAAeAAAdAEA..XACAQAGA.TCCAbAED.OCFChAAAUAGACCAAHEBAGCCAhAAAEEEEREGFSDHBhACAABDAKGAA.LEFBNIBB.fGBADGIBaGEC.hABAMEHB....hADA...,2,-24,14,38
MUWKdYZGFPHgOEbBDSaXNfQILCJTcReAV,MAAAKAAAZACBGACBHAEAEBHFDAFA...aCABXBBC.QBGAhAIALDEBTECAhAAARCDAAEFAUFFAdEHA.FGAAOEHDhBAAbGDABHADSHEGIHHA...hCAA......hCIA...,2,-14,1,15
KefCWBUgIAZGYJDdXHTNaQSPRVFLObcME,GAAADAAAHABCaADAQAECRAFF.LAGBbCDD.ECCBeAHHhAAACDFDBDHAUEGA.ACDBZEBBhACAdFFATGCASGFDhAHAFHGE............hBAA......hBCA...,1,-9,-14,5
LQVESdYRcBPfZCXHGJKNAUFWMbgIaDTeO,FAAAMAAA....bACDaACE.eAEHLAEAEAGA.dCEARCCBBBBDhAGAZCFBHEGBGCFAKCHBAAFAgFDAhBAADIAA.OBHDhCAA.SFHB....hCHA......hDAA...,2,-27,-10,17
fHVaLcBMNJTCRFAQePOEXGYdgUWbKSZID,eAAAEAAAGACAdAEAUAGAKAEAZAGB..DBDBHCEBLDEAMBIBTEAAhAAAREBAAAAA..QFFAhBEAXEGDgGAAhAEASEHHfGBEaGCDBCBDCGFD.FGDB.hAGA......hBCA...,2,-18,1,19
MBLADCOaeVWPcYRQdSZUKJITbXNEGfgFH,OAAAeAAA..VADA..PADCRAGFdCCAZDFAKAGC...TEDAhAAAbBBC..EBHFGGABhABAFCEDHDFBMFGBADDBaEHDhBAA..YFHFQGCA.SHEEhCAA.IHHAhCGA..,1,2,-12,14
AbPCdWRITgLSHEZcUfDMOJYVQNGaFeBKX,CAAARAAA....TAEALACAHAGBEAGAZCCAUCCAMDAB..OBHDhAAAVECAGGABeCFBXDABhADAAAAAdFGA.IFEAhAEASGEH.DDIBQGAA.hADAaEHH.KGCA...hAEA...,2,-10,-1,9
BeJZPLEYMQbNaGWKDcTSROFHUAgdfVXCI,dAAAXAAABADAeAEHZACBLAFA.EBEBMAGB.QCBAhACAaCFDGDGADAHBTEDAhAAARDFAHFDAAAGA..fHCBhABACDADIFHA........hADA......hAIA...,2,-26,-7,19
egNHCLTEODYAdKbMRaVFBfcQWZJSGXPIU,dAAAMAAARADAFAGABADA...QAFAZABBGCEA..XBBChAFAUDGAeDCFHCDALEABhAEAECHFDEFBAAIBKGCAaEGC.hBAAfFCA.cGGASGGAhCDA......hCGA...,2,-16,-12,4
CNdYBMAZJQHTRgfPDWbIcaKGSEUVXFeOL,ZAAAHAAARAEA...fADBDACA..bCCCaAFA.GBEBUCGAFECDhABAeCAA.LDDBhAAAdEEAMFABAAIBTFFAhACA.PDHDIFHASHDAEGFF..hCAA......hDFA...,2,-25,-1,24
ODacPLAIGeKVQMZRgfEdTHXUJSYbBNWFC,eAAAQAAARADA.EACAHAGB.XCCCSAEABCFDFAHBDDIBhAAAaCDALEAAACGB.hAAAGEEAMCIBZDDAdGAA.hABATFAAYEHFbDGDCHHA.OFFH..hAFA......hCAA...,1,2,-10,12
cLdfFSaCJXMReKYEHGgDWBbVPOTAIZNUQ,ZAAAQAAAdAEAFAGA.aACE..CBGD...MAFARCAAKCHBHBDC.GBGAhAAADDEABEBAbDAAOEDDhADA.ABIBIFFAhBGAUEEALFHBSFHHeHEA....hCAA......hDAA...,2,-36,-2,34
JHIFWODePXCMbBcKNQAZRSYGTULagfEVd,RAAAGAAALADBaADA.EAFAdAGA.HCDAFAHDDCCBeBHH.CDCD.BCFAKEFAAAABhACAZDEE...TFAAhAAAfFCA.IGGAhAIAODHDMFFBNEIASFEDgFCBhABA......hAFA...,2,-24,-4,20
JUYPERSafVCMOFDITNBWLeZHXKGdAgcQb,QAAAUAAAEADA.RACA...aAFDCAFBMAHBDAHB....TCDAhADABCDAeCEHHDFAGFBBhAIAAAIBbCFD.JFHBSCHHhAAAOHDC.FDAA.IGGA.WFHHhADA.....hBAA...,1,-16,-18,2
DAOPdcWeMNELRGBbZHIJSTKFQXYfUCgaV,dAAAeAAAEADARADAGAGAZABBHAFA..SCCBTCEA.QCEDhAAAXCGD.fEAAhABACDCAaECE.AAIBODHDhAEAcFFA.MEFBLFHBbGAAKGGAFHAA...hAGA......hCAA...,2,1,4,3
RfTaHEWQOZBXMCPKdGFbSAeUNLYVDJIcg,eAAALAAADAEA.JAEA....IAHARBCAaAHD.HBCA.EBFEhAAAQCACZCFEMDEBKEBAhABAGCEBSEHBhBEAAEEAUFFANEIAVFFB..fHAB.hCAAWHEG....hABA...,1,-1,-25,24
dKfXGLUSOHTDgCbBWMZeVIcERJYAaFPNQ,aAAAFAAAQADA.dAGAXACDGCCALDABOAEAHBEBhAIATEFACBGABCHAZCFEeEHHhADAIEBARGBEAAIBKHEAhBAASBBD.bEEA.MDDB.EGEA.hBFA......hBGA...,2,-14,6,20
WCgaSYfXOHNULTGIReVBAFMEbJDQcdPKZ,EAAADAAAdADAZACB..CAEA.aAFA....SAFHXBBBHBEBhAIALAHBGCGARDEAeCBDhAAAABGBMDDBQFDChBCAKEED.gGFAOFGHNIBB.IHBA.hBAA......hBIA...,1,-8,-20,12
YbVBZMTEQOHPcgSRDCXKIGfeAJWUNLaFd,UAAAaAAA.dADA..VADAZAEBEAGAHAGB.....gBBGhADARCFFXDBAGDEAhAGAABIB.NDIALEDDhAIAFDHDBEEDMHCAOEGDSGGADIBA...hBAA......hBIA...,2,-28,0,28
NTgaOAMSdFIDVbGQfKUCLYREZXeWcBPHJ,dAAADAAAGABBQADAKAFCLBHBEAFA.ZCCAeAHFBCFBHCAChACA.TDEAaEAAACHBFEEHhAEAbEGDCEDD..RGEA.XGCAhADA..WECH......hAIA......hBAA...,1,2,-28,30
WMXIHeJTQBZLEOUdVCcNPagYDfRSFGbKA,MAAAHAAAeACE.TAGAZABEEAFA.dBHACCCA.....PCCAhAFAaCEADCIBRCFBGEEAhAIAAAFAXDECJEHBBHCALFDAhAAA.ODHH.......hBAA......hCAA...,2,-19,-12,7
JFABVTEHXdgRSLGQfDcbWCPIOeZKYUMNa,TAAAHAAAdADA.RAFAGCABQACCDCFB...bAEBCCGA..OCHDhAAAeAGFZCGBKEEDMFAAhACAaCDDAAIBEFEB..SFGBhAFAfGGAPGAA.....hAAA......hCAA...,2,-15,-10,5
fXOIdKMBJPTZDVGcSFYUNbLgCREaWHAQe,eAAAOAAAdAEABADA..TAGAZAEBGAGAFBCDUCGBLCCBhAIARDEB.EEEAHEBAABBBQFGAhBAAXEGDMIAAhAAADGBASGDA.NIBB.CGAA.....hABA......hAGA...,1,-11,-12,1
aZFBEOSUNIPVDfRQKWGebTCHMJcLXgdYA,ZAAAEAAAUADA..IAEADAGA.RAFFKBHBeBCD.CBFB.HCAAMBHBhAAALDEA.dECAhABAABIBaDBHOEHD.SFDHhACAPDFBQGDCbFFBJHAA.XGGAhBDA....hCAA...,1,-1,-34,33
ILCJVTZXUYdBNKRfcASQFeEbMgPDaHGWO,QAAAEAAA.MADADADAHAECGAGAOAHDLBDBCBCATCDAhAAAZDFFXFBA.hAHAdFEAKCBDfGHAhAAAADGAeEFAbFCBaCBE..IGEA.UGGAhBCABBFC.NIAB....hCAA...,1,9,-14,23
NIRMJHSTdCKaBAUGLgYQVWXPZcbEefDOF,GAAALAAAQADAXADD.ZAFBEAFAeAHF.OCDBFAHDRCAAHCEChABAdEEAaCHDACAAUEFBhACAVFBB...PFAAhAFAbEFDDDABMDIB.SGGD.CHHB..hAAA......hACA...,2,1,6,5
LgYcVRIdJKBabECDAeMfZQSGNTUHWFOPX,eAAAZAAAGAEAUAEAHAGDOAGFLBDD..gCAAhABAVDFBRFDBdGHABDDA.EDGBhACAAAAAMCCBQEBDhADA.TFFA.FGAH.YFHB.hAIA......hCAA...,2,-13,3,16
dZPJgNDXfULbOcMVeIHBTKRFaGCYESQAW,ZAAAJAAA.DACAUADALAFA..OAFCMBEB..eCCBHCECKCFAhABAREEBaCCHGEFA.EDHFhAGAAAHAdCHA..gFCAhAHAfGHA........hBAA......hCAA...,1,-14,-33,19
TbeJcKLFQERaNSOZDBPWdCIMGVUXfAgHY,HAAATAAAeACE.KAFCLACBEAHF.RAEAaAHDOCCAZCEABEAAhAAAdCGDMDDBGEEAUEEAAAEA.hAHA..bGFAFEHDSEHFhAAADGCBCHHA.........hCAA......hCCA...,1,-2,-14,12
TeaLRdbIEBZPWVKYFSNCDcfQUgMJHGXAO,eAAARAAAdADA.EADAZAEB....VAFAFAGDCCCDDCCA..QDFAhAAAMCFBHDGBAAIB.aDDBLEHBhABAbGDA.BEED.hAAA............hABA......hAIA...,1,-18,-36,18
fIXBOPFLcVEbWGgAaJRUZSMKdeDHNYQCT,RAAAZAAAMADAeACE.HAFBQAGACAHA..TCDAXBDAOCCHhABALDDA.EDHBhAAAGDGAACCBaEBBSFFAhABAdEFCDCIBfFAABGCAFGHD....hBEA......hBIA...,2,-12,-6,6
CeTRNOaXHdYWZfVIGQMUDAcEPLKgSFBJb,EAAALAAAKACA.FAEABAEBCAHA.RAFF...aBCEHCCA.dAHAZCAAVDGBhAAAGCEA.MCHBhABAAECB....gEEDhCAAbGCCTGGANIDB........hACA......hAHA...,1,-20,-24,4
JXHReTZaLUBYSAWfDcMdIbNFPgKEGVQOC,DAAAdAAA....bABDFACD.KAEAGADAQAGCCAFAHAGBRCDAZDFEaDACLDFAhADABEAA.AAIB.hAFA..fECAhAEAMFFAIGDA.gGGAEFGAOHDA.hBAAeBBD....hAIA...,2,-29,3,32
KOSPUAWegaERTVLGXJIDQcbBdNCHFYMfZ,eAAAEAAARACA.LAEAGAFA.JBCBQCCB.BAHAdCFAHDGBhAAAMCIBZDAFSAHHhABAADFBaDGD.TECA.hAAAXFACDEEBbFFCFHAAKFFD......hADA......hAFA...,2,-10,-3,7
WCdLJNgEePTbGcXFVASRYHKBIOZQMaDfU,RAAAHAAABADBZADB.aAFDDAFA.UBFAdAHALCCD..JCCBECABhAAA.eDEA.bEFAGEDAhAAA.FDHDAFBBKFDAhACAQFFCMHBACGGANIDB.......hABA......hAIA...,2,-43,8,51
CUFgTXSYPHOANQRdcaIJDWVebGKEfLZBM,RAAAaAAADADA..eACHGAEBEAEA.ZCCABAGAUDGAFBHD...TCEAhAEASECAHECAABBBdGEAhAAAJEGB...bGCALHAAhABA.CGGA........hAIA......hBAA...,2,-25,-17,8
HQSMECKFGNTRWZbLOfBedVPJXAIYDaUcg,DAAAaAAA.UADAHACB.MAEAEAFA...FAHDGBBARBEFZDFBLEBAhBAABAHAeCGBdEHA.PGBAhBBAABBB..IDEAhBAA..YHFAQFFC.KHCA.hBEAWCHB....hBDA...,2,-37,5,42
eOfWPGgbNVAZdKSTUBLYJQFaMIDHEcXCR,dAAATAAALADA.QBGAaACADAFAHBDCECBA.CAHA.RCEBeDDBhACAOCCB...fCGAhAAAGEAAbFGBACIBZEDAhBDASGDABEHAFGBAMICAIGHA.WHEGhBGA.....hAEA...,1,-3,-8,5
NJDgUbdCYOKfEaVPMLTRIBcXGFWZHeSQA,DAAAUAAAdADAOADAKAFA...EAGAaAHD..MBDBRBBBBCFAGCEAhBAAZDEA.HCGD.eEBBhBCAADBB.JFHBCDHB...fGFAhBEALFAATFFAXGCDFHAA.SFHHhAFA..hAHA...,2,-36,3,39
RBFQGgEPWVdKZHDLaMUCcbTNefXASOIJY,OAAAJAAABADBGADA.EAFA..VAFAZBGBHDBBLCCAaDEDMBBBhAFAUDGA..CECA.bFGBhAIA..eEEBACIBSGCAhBAARFABFGGA.........hAFA......hAIA...,1,4,-32,36
fJAUFHOYcDIWETQdXGRLNMPeZagSKCbVB,HAAAOAAADACA.EAEAdAEAGAGARAGBLBDDMCCA.eBBBZDDAaDHDKCFB.hAGA.CDHA.BFDA.AAIBFFFHhAAAIFEA.TGFAhAIAQGBC..NIBB.SHGAhBGA.....hBAA...,1,-2,-26,24
CDPXLcJRabGKZVedYfOUBHMAISWgTFNEQ,SAAATAAA.EADAQACC.DAEALAGBRAFAGCDAhAAAZBCEeCFAdDAAOCHDhAAAHFCBAEIBgFFAhAIACDDAXEFCaFDB.bGEA.KGBB.....hCAA......hCFA...,2,-7,-3,4
QRBYZEcWLPeGVfFJHaSDATOXCIdMUgbNK,TAAACAAAdACA..MAEAUACA.....bAEAQBEAhAAABCEAECGBLEEBeAHFGDDAhBCAFEGHHFAAaCHDADDBXEBDhBEAIHHANAIARFGB........hAAA......hAFA...,2,-13,-12,1
fZXUPONCAbQFBHRMVgKILEWJcGaeSdYDT,QAAAHAAARADFMAFAKACALBGB.ECABJAEAGDEAeAHHdCDAhAAATFCAZCEBUDGB.hAAAOFGDABIBBCCDIHAAhAHAaEHDDGGB..........hCAA......hDAA...,2,-22,0,22
JSCcBEPeMYdHgTZADXbKLFaQGUIVNOWfR,XAAALAAAaADDGADA..UAFAIAFAOAHF.RCAA.CAHAECFAhAAAeDEA..dDAAHEFChABAZDBBACIBbFBAQDGDhABANIEB.fFEASGGABFHD.hACAMHAA.gGGGhADADFBA,1,-10,-11,1
PHeNWgDRbKVEcJAIZFSQYBTLXdfaMGUOC,ZAAAQAAABADBLAFAdADAMAFAGCAACBFA.HCCCeBGH..hAAAgCFBRDBAKDHBEEFBABIBhBCASCHB.hBDATFEAaFBCOFDDPHAADFHB..cGFDhABA.....hBFA...,1,-2,-15,13
ZFGNCSQfYUeTRcKIaOMPBgVXWdLADEJbH,EAAAHAAAGACASACEQAEAUAFARCCAKAGAOAHFBCBDXCFAhAAAdDGAACCA..bEEBZEAAhAEA.CEEAeDHH.TGEAhAIAaEHDMFBA.gGGG..hAAA......hBFA...,1,-1,-10,9
agFePJCTEUIAQdSLbBKMGYZfROVHXNcWD,dAAALAAAKADAGAFAZADBRAFAHCAB..XCAA..cCFChABAaAHFeDCHCCCCECHBADHAQEEChACABEEA.hACAMEHBOFGB.VGAADEIBFFAB.PHBAhADA.....hAGA...,1,-5,-13,8
UCYZeBXGaJVcHDgRdPLIbfEMAOTQSNKWF,TAAAQAAA.KACAFACAUAEAZAEBeAGFGBGA..aAHDVDCAhAAAHCCB.RDGBdFEALFFAhAHAIHHAEGBAAAIBSGFHhAAACGEDBHHA.........hBGA......hCAA...,1,-3,-14,11
MQfWPdJcHKbBAZXRYVeDaELSFGgNCOUIT,RAAAeAAAEADE.LAEAGAFA.CBCA.OAHFUCEA.MCCBQCGAhAAA..fDDAhAAAdDDCHFAAbFFAADHBZEFA.XFAChABADFFA.aFDD.FGGBNIAB.....hABA......hAFA...,1,1,-9,10
ZLIOCDNSKFfcAQMaUXTdBRbYeVWJGPEHg,aAAATAAABADA..RACF.eAEH..VAFAGAGAHCDBZCCFLCFAhAAACDAADDGB.KCADFEHDAEGAMEIBhACAdEEA..bGAAYEABhAEA.PFFBEGGB.....hADA......hAGA...,2,-22,1,23
MVSDPONAaRQUgbHBdJeYTIGCKWLXFEZfc,RAAAQAAAUADAHAFAdADA.eAFA..TCGAGCDBKCCDLCHBhAAAEDEBZFDA.MDBBDEIBOFHHhAAAAAFAbEFDBEEDJHAA.hABACGCA....WHEG......hBCA......hBDA...,2,-11,-11,0
RZYQdfJBPMgbHITCaKGSLDcNFEAUeVWOX,eAAAOAAARADAZAGBdAEABAGA..MBIBHBCBCCCAGCEALCGBDEAAhAAAFDFB.AAIBUGAA.hABA.XEGDQGGAhAGAfEDE.gGAAbEBA.hBAAaGCDKBBD....hBEA...,1,-10,-14,4
WDCFUdORafMZbYTcNIGQJKELSXPeHgAVB,BAAACAAAdACA.RACA..MAFAZADB....TAFA..IBGAhAAAGCEAQCGAhAAAECAALCEBXGFAhAHAHDACAACADBIBOCBBbDFDNEIA.KHDA...SHFEhCAA...hAIA...,1,-9,-27,18
LUAJVaXKeYfNDIZdTEPORCHcBbWMgFSGQ,aAAAeAAA.....fADADADAdAGAEBBBRAEFHAGBBBDAMAIBhBAASCCDGBEALDDBhAAAADBB.XDFDhABAKDDDIEGAZGAATGGACFHA..bGBAFHEC.hBDA......hBGA...,2,-31,11,42
dAGOFfabYUTPWZCXeMLSIKcDEJVBNHQRg,GAAAFAAA.aADAUADA..TAGAZAFBeAHFMCDALDBAhBAA.KDHBECHFBCCDHDBBhAAAREFB.ADDAbDED.PEHDhACAXFBASGABDFEB..NICB.gGDGhAGA...hBDA...,1,13,-27,40
TRebZCMJKXLIUOFVcNAfgDYdQaHSWPGBE,DAAAdAAAHADA.SAFEGABBEAFERCAAZBFEMAIB.KCCDLDEAhACAOCFB.FEHD.VGDAhADAACGA..fDGAhAEA.QECA.aEHDBFFBeHAAhAHACHHA.XGGC.hAIA...,1,-10,-11,1
fQRINgdeBYLJPTSMWOEDCXZUabKHVGAcF,FAAARAAA....IAEAdADAeAFALAGBTCEA.MAIB.EBFFhAAAXBGAZCCB.bDBBhAFAHDAD.ACCBQEEAhABABDGAPEEBOEGFCFHAaGABKGFA...hADA......hCAA...,2,-14,-11,3
AdYZNcGCBQFLgPSXUMEbDRKIJfHTOaeWV,ZAAAGAAAQAEALADA.SAGHMAHBECAARCDBKCDA.fCHAhAAAHDACaCHDeDFHhABAAAEAdEEA...NIABBFDDhACAFDCHXGDCDFHBIGBATGGAWFHH..hADA......hAEA...,1,2,-9,11
DeQIcZWALMYdXUPNKTGHgJVOFaBfREbSC,MAAAdAAAUADAKADAHAFB..VAFAFAHFBBBARCAA..ECHFCCDAeDCBhAFA..QDEAhACAZEEAADHALEHBXFGAhAIATGEAgGEB.OEDB.hBAA......hBBA...,2,-22,-8,14
XJcDMQRWZPHfFVaCALdEYbUGNITgBSKOe,EAAAUAAAGACA..TADASAEAeAFE.XAGDDBGBRCBAZCGBhADAHCEA.FCBHaCFHAAEAdEEDhAAA.bEGDIGGAhAIA.KEED.........hAIA......hBCA...,1,-8,-24,16
QXNdFDECLUOMRcSfPYeAKIJbBWZHaVTgG,KAAAJAAABADBHACBaAEA....TAFAGAGA.QCAChAAAdAHAECCALDEAMBFBREBAfEGEhACAeDHHACFBIFAAhAFAZGDA...XFFDDDIBCFFD.cGDBhBAA.....hAIA...,1,-3,-23,20
MFPXKQYAUHEOCgJbNTGfLWZcVedIaSRBD,HAAAEAAA.CADB.JACB..TAFAGAEALAHBZAGBeCHHdCADaDDBRCEBMDDBhAAA..XEAAhAAAQEGAAAEBOEEBhAGAbFAB..fGDAcFGC.SGGDhACAFGBH....hAFA...,1,-4,-7,3
BOUYZWPVGeXaFgNEQDCSAKJILHdMcfRTb,KAAALAAAHACBdAEBMAEARAGFBCAAUBEAZBGB....VCEBeCAAhABAFDHDEDDB.DCIBAFBA.JECFhACA..IGFAhAAA..TFEAOFBEPHFCaHGE.NIAB..hACA......hAIA...,2,-24,-9,15
VGgPKIQHAaERLdDYeOUSNbWcZXfTFCJBM,RAAAdAAAeADESADA..bAGBZABB.TAGACBDABCCD.GCEAhAAAKCEAHDCAEDHFLGDAhABAOCHDUFFA.cEAAhAEAFHGEMIBA..gGAB.hBIAIHDAACGB.aHGEhAGA...,1,-4,-14,10
QNLOKRaMdJEGbHVWSCZFIgDeXPBfYcTUA,LAAARAAAdADAGAFAHADB.SAFAZCCAFAHFDDHBeAHH.BCAAhABA.fCCEhACATFAAAAAAQFFChAFAKCFBaDHDEEEBbFAACHHA...XGFA...hBFA......hCAA...,1,8,-24,32
YIESXGBcfgQbUVPaZMWeNdJATCRLDFKOH,RAAALAAAKADCHAFAEAEAGCCABAGA.....fCFEhAAAbBFAVCAA.ZCGB.eEFDdDEAADGAhABADDIBOEABSHAAhABAXECD.QFGAaHGE.MIAAhACA.JHEA....hAEA...,1,-1,-8,7
HQdTKNXMOaIGPDBSULCfZFVYEARgWJbce,RAAAJAAAeADEHADB.dAFBKAGC..MAIBaBDDGCEABBGDLDAAhADAZCGBFDCH.EDFAAAAA....hBAA.bEEATGCA.hCAAOFHDDEIBCFDDfGGE...hBIA......hCAA...,2,-20,-12,8
FQAJPLeGZYgdMVKHBEbaWUcRDINXCTfOS,LAAAeAAAZADBdAGAMAEAHCEBBAHA.EBDAaBHD.UFBARBFB.DCCBXCAAhABA.TDDAhACASEGA.AAAAPGDAhAIAGEGAgFDAKGHB.WCHBhCAA......hCBA...,2,-20,-13,7
eUPZMNRYdBXJbDKGVTEAHCFfIcOgQaLSW,HAAAFAAA...fADBOACDaAEALAFB.eAHBZAGBRBEFhBAAdCADXDGAbCGDGDCAhAAAEEBAABEBCCEC..gFFGhACAQFFASGEDWEED.MIAAhAIANIBB......hCDA...,1,6,-18,24
PLSOCNHUXMfVQBWZGRIYAbDKgadTJEeFc,KAAAdAAAEADAeACE.FAFALAGB.CBEAHCACMAIBQBCDhAAAZDEARFDAAAIB.DCFA.aDDCTGBAhACA..PDGBhCAAOFHDUFDA.fGHABHGD.WHDAhCBA.....hADA...,1,-16,-17,1
MTSdYPVgeOWHaXAfCZURcKFNIGEDLJQBb,ZAAARAAAFADAGAEALAGBQAGABBFA.MCABdCCA...PCCBhABAeCHHHECC.AAAACFGDhAIAKDGA.EEDFDFIBbDADTGEAhBIASFFA.YFHB.OGDChACA....hADA...,1,-6,-21,15
KBdARFfcDGWIVYTOEPMgSNLUJeXbCQaHZ,RAAAFAAADADAGACA..VAFATAEA.EAGEMBEB..SCEAhAEALCCBeCHFhAAAbCGD.aEFBHEEBZGDABGGBhABAACIBfGHA.......hAIA......hCAA...,2,-26,-6,20
OfJQBVEPaHgGIDCZRXWcLYebUTNFSdKMA,OAAAQAAABADAEACAHAEBGAEADAGARBGF..XAGALCCBhBAAeCDBUEEATCGAhAAASBBDdEBAAAGAfEGEhBEAVGBA.aFFHCFHA.cGGDNIEB..MHFAhBGA.....hCAA...,2,-5,-3,2
QCLHScZTXVBEJbaKNPOfYeWARIDFUGMdg,RAAAFAAAGADAdADA.QAFAHAFAZCCA..TCGABAHAECCB.aCGEhAAAKDBD.OEEBeDABADFBhABADEIBMEGBLFAAhAFASEHBXFGDbFGD.fHAB.hADA.YFAF.hAHA...,1,5,-19,24
WYEOBDFbKGHIgQANaeCJPUTcMRZXfVSLd,eAAACAAAUACAMAEA.RBCA.ZAEB....fAHALAHBdCGChAAAECFFDCIBKCBDHEBA.hAAAQEECABFAaDBBTEDAhABAXGBASDGHOEHDbGEA..IHFAhBCA...hBDA...,2,-19,-13,6
ZWEVMCgQdLYfDBbcaFIUHJXAeSKNGOPTR,eAAAKAAAGACAOADCRAEAZCAF..EAGEMAIBQCCA.dCFAhAAALCGBDCHBBEHAaDFBhAAAFFAAHEDBACIBSFDAhABATGGACFAD.fGFAIHAA....hAFA......hAIA...,2,-20,-6,14
ESAZJYIDVdRNPKFWgHcLbBTeaGfOCUXMQ,ZAAAJAAA.DACARADF.KAEA..FAFAHAGBLCFABCCD..eCEBGDAAhADACDGD.MDDB.EEEAAAIBVFCAhABA..dEHA.hAGAPHCA..gGFA..hCAAcGFA...hCBA...,2,-34,-17,17
CTHGaRLPXYVQDSEObBdMcAJgFUfWeNIKZ,FAAAUAAAeACHKADAZAFBHAEA.RCEA.LBHB..XDGAhAEAQCDAEDDBBAHBdDAAACHBJDCFhADAfECE.hAFAIFFAGEFAaFHDPFHBDIAA.OGAChAGA.MICA...hAIA...,1,3,-17,20
HFDEQGfBYcbNZXdOeSTRAKVMLaICJPgUW,MAAAaAAA..CADA.JADBUAFAHAFA..EBBBGCBA.BBBC.hADA.bCECZDFAdEFAeEDFhAFARDCBAAIBLEHBgFFAhAHADFBB...fHBFNIAB.SHFGhBAA...hAIA...,2,-18,-17,1
MgfQaJeDNVEZYLbXABGUCPOcSHFKRTIWd,GAAACAAA.OADAHACARAFF..TAGAdAHAMCABQCDAhAAAeCCBDCEBECGBZDGBLFDAhACAAEFABFAA.cEBBKFDA.hAAAIFHA..fGHANIAB.hAIA......hBAA...,1,-5,-24,19
MNSAEgcLVeOPaCbTGYKRWZJIBFdHXUfDQ,EAAALAAA.eADHaACDCAEAGAFA.RCABZDEFBAGAHDGBXBGAhAAADAIBMEEBACBB.VFBBhABAbCDD..KCFD.IEAAhAEAFGHD...dEGA.QGAAhAGA.SFHHhAIA.OHDA.,2,-10,6,16
UZPDEaeIFfYdbWSJCTAHBVcQMOKNGXgRL,HAAABAAAQACAMACAKAFAGBDARAEAZCAADAIBEBHF....eCCDhAAAFCFDdDHASCFBhAHACEDAAFAA.ODHD.XFEAhAIALFFBaHECfHAB..hAAA......hACA...,1,4,-34,38
YSQUbgRKFZXcDJVANWCaGMTOHLEIedBfP,CAAAGAAA.MADAHACAEAGAeAEE.dAHABBFD..fCAAhAAASBHHQCCBhACAbCDCREBBZEEA.DCFBAAABaEGAhACATDGAOHCCLFFAIHHAPGCC.hBCA......hBDA...,1,-2,-10,8
GBHLCQaEKMXUFJfIDVgSNYAPTZceObWdR,ZAAAeAAAOACAdAEARAGBHBCBLAGB.QCCBECFFMDIBFEBBJDFF.hABADEEB...SFFAhAAAAAIBTFBAbEGDGGABhABABBFAaHEE.........hBFA......hCAA...,2,-24,1,25
RJTADUGOIKeQHNXcaSdFCWfYELVZMBbgP,GAAAKAAAHACB..XADAaAEAdAHACBEB..fAGALCABZDEAhAAAMAIBBCFA..hACAbCDCRFFBADHAOCGDeHBA.hBHAQEAB.SEEBWFHH.hDAAEFHF.gGAAhAAA..,1,1,-15,16
GWHgJYXQfbEdMaBDZTLCRVSNOcPeFKUIA,HAAAJAAA.QADCEADE.aAFAZAFBTBFARCCB..SAHHhAFAOBHDeCABKDGAACEAGDDAhAAA.gFGAhACAfEFEMCCBLFHBCHEA.NHBB...hBAA......hBHA...,1,19,-33,52
FAbfcSDKHaIPBNGEWQRYeCLZgMVJUOXdT,...bAAASAAA.HACBaAEABAHAEAEARAGBeCEFZBDBMCABhAAAUDGBdCFAAAAADEAAKCCDICHAhABAGGCBQGGChAEALEHBVFDA.OHAA...hAIA......hBIA...,2,-4,-4,0
GgHfNMaDKAXdZIFOTSecPLRCWEYbQUBVJ,ZAAAOAAAeACELAEARAFF.EBBBQCCBBBDDGCEAHCGBMAIBhAFAaAHFADFBdDDCFEEHTEGAhAGASFAA.CFHA.hABAbGCC.UGGBgGGG.DIDA..hAFA......hCAA...,2,-5,2,7
GEDbJSYNMOfWPeILCXBRcTdZaHQFVAUKg,KAAAEAAADADA..SACBMAGB.OAEA..fAHAhAAAeAHFLBEBBBCARBDFhAHAdCCDHDEBQDGBhAAAACBBGEGAbFFAYFBAPGCCCHHD....hCAA......hCBA...,2,-19,-12,7
SYAKDcPZNCEFTGOWIBXVUdHJQMbLafeRg,DAAAZAAAEADEGABB.OAEABAFBUCAA.HAGBMAIBLDDAhABAeBGFRCCA.SDHHhACAADHBKEEA...PFCAhAIAFEHDTFCAXFGC......hBIA......hCEA...,2,-24,-16,8
IfHAMXcPLFUWNZaJGOdKbCgRSeVBDETYQ,MAAAXAAALAEAFADA.UBBAZAFBGBCAdCEAKBHB...bBGDRDFFeEDBhAFA.BFHAEEEBTGFAhAAAQGAAfFCEhABAAHDB..PHFANIAB....hAGA......hAIA...,2,-17,-5,12
SXOPHCBVIEGUYMcgdKJQaNeZDfbLFWART,RAAATAAAOADA.HAGBBACB.EAEAGBDAMAHB.dCCC.QDFDhAAAeBFFZCCBDAIBLFCBhABAACCBXDGACFGDIGBAhAIAUEAA.YFHBKEEDaFGBfGDEhAAA.FHGE....hAEA...,1,11,-10,21
QECdHDYTcFSIZKeOaUNbJLBGAXgMRPVWf,MAAARAAA..VAEAQADAdAHAHCCATAFAFDABZDFB..eAHHhAHAaDHD.UCBA.bDDBLECAhAAAABBA.PHEAhABAEDFFDDIB.SEHD.OFGHhBAA......hCAA...,2,-11,-7,4
IPdXecNOgLTDHKbCWfaJYRSMBGUFZEAQV,QAAAVAAA.dADAeADEOAFALAGBHBEBCBGDaBDD.RDEBMAIBhAAAGDBA.ZDGBACFAXEGBhCAAgEEAKDCDfGHAhAAASFHHBDDD.....hCDA......hDAA...,1,1,-15,16
IBbRNEgTMQFCLeSUWYZHGXOPDJfKaVAcd,dAAABAAARADA.EACAMAHBFAED.LCCA.UDGBZAFBHCAA.GCGAhAAAODABDAIBKEEBACCAIEDAhACA..hBHAbGAATFEAeFHBSGGD..hACA......hADA...,2,-22,-19,3
BMFUEWZGbdLNYHIcXfTAOQaKgJeDCPSRV,aAAAKAAAeACE.DAFASACH.RAEAMAIBEAHFGBCA.hAEAdCEALCEAHDGBXGBAhAAAABBBQEEAhAFACFFDBGEDFEGE.ZGCANIEB.IGHA.fHABhAHA.ODDBhBAA..,1,-4,-23,19
WOIfQEPVcYFDRAbJTdZMNaeSgLHCUGXBK,TAAAZAAAaACA...eACELAFAHAFBGCCAKCCDOCFAQEFAhAAAEDEA.PFABhAFAVECBFEHBABIBdDBC.MDIBhAHASFFBCFEDBHBAfHDBDGAB.JHFAhAIANIDB......hBDA...,1,15,-16,31
CGIeTLZWFMEVPgdbARUYKDBaQJNfSXHOc,RAAAKAAABADBQACC..fAFAHAEBCAGAeAHHZAGBMBIBhAAAEDDB..VDFBdCCAADFBDDIBhAAAaECESEAAhAEA.OGAAGEGAIGHATFAALFFDhABA.FGCD..hAFA...,2,-12,-1,11
SOCWdVEcQIAJGfaeRKZHbgTUXFDPNYMLB,GAAAeAAARADAHAGB..bADATCCAFAHBDADA....PCFBhAAAMCDBLCEBhAAAODHDdEAAECHFQGFAhABAADGBaEGEKGGA.ZGAE.........hACA......hBAA...,2,-22,9,31
KcagGZdATQCMReIWFbLBVfSPNJUHXYDEO,TAAAMAAARACA...eACEFAFALCCABAFBSAGH.JBDFhAAAHCFB.DAIBECFBKECAhBAAaBHDZFFAACCB.CCHDIHFAhBBAbEFA..fFEE.NIABXGGChAIA...hCAA...,1,-9,-27,18
UTHNgKYDdcIWaCVMJPAefXFGQSbEZRLOB,eAAAFAAAGACAQADAEAEA.RAFALCCBBAGAHCEAKCGAdCHAIEEAhAAAaEAA..MEEBhAEAAEGASEGAZFFAOHFChAIATGAA.gGGADGCB...hBAA......hBIA...,1,-6,-9,3
KBXCfIUMDGaJgdARVWPQbLTSEFNZHYOec,RAAAVAAAQADC.LAFBEADEZAFBHCDBeAHBBCCDCAHA.UEDAhAAAGCGA.aDCBdEHAhABAACIB.bFFBTFAAFHCA.hAIAOFCD.XFFDIHHAMFIB.hCAA......hCFA...,2,-7,3,10
RBfAHOTDcFPMaZQIYSbXJUGKWVCNdegLE,HAAATAAAFADA.aAFDZACB.QAEA.SAGAhAAAbAGDXCAAGCGAKDDACEFAeCABhACAEEHB.RDEBACEB.DFIBMFDBhAAAIGDA.YHAA...hACA......hAIA...,2,-24,7,31
OHXeaVKdYBUCWTSLQMgcIAZEDbfFPNRJG,EAAADAAAFACDRACA.GAEAHAFBeAHB.aCCCdAGB.BBHDUDFBTDGAhAEALDAB.MECBhAAAIDDAAEEBZGFA...hADAbEBCNIAB...XFFC.KGDB.CGHASBBDhBAA.hAFA...,1,-2,-20,18
gdHCOEJXFRNUWMZaLGVYbBceIQKTADPSf,SAAAdAAAHADAEAGEFADARCAA...UAGAZCEBGCGA.VFAAhACAbBAAeCDH.QDGAhAAAACIBfGDAOCFBhABAXGFCMFGBaGBABEDCIHHADGIB.hADA......hAFA...,2,-9,-1,8
edMYaROXHgPZIQDbNUTSKFBEfcGCWAVJL,LAAAeAAAdAEAMAGBRADFHAFB.ZCAADAHBUDFBKBCB.BAHA.EFAAGDEAhAAA.AAIBVEBBhABAaEEHOEHD.XGFDhABAgEGB.IHDANHAB.FGGH.hACA......hAFA...,1,-9,-15,6
WUOPHYSBbgDKAXRVaeLNQIZdTcFEGfMCJ,RAAAeAAALADBQADAdAFAFAHBEAFA.GBGAMCCB.CCCA..UEDAhAAAHDEABFFBDCIBAAAAaEHDZFBAhBFA...TFGAhCAAfGCEOHDE........hCDA......hDAA...,1,-12,-13,1
RHMUJIgTLWPVbSXCDaKQZGBdNefYOcFAE,HAAAMAAAUAEAJADA....TBGALAHB.VBBBbCAACAHBaDEAhBAAZCEF.GEDAdEBDeEEBhBBAODHDABGA.RGAAgGGBhAAASEGAKGGA.BHCA...hACA......hAGA...,1,2,-13,15
TUcIPdVbaXHGDeONQgMJKSfWBZEAFRCYL,RAAALAAAUADA...IAEAdAGAaBHDHDDAeAFH..QCAAhABAMCCBKEGA.SAHBhACABFBDAAAA.CCDATCGAhBHAVGDA.GEEADGGA.OEHD...hAIA......hBFA...,2,-25,-1,24
PXUCHfTJeNVRgYKaZLMbABEDdcIGSWQFO,EAAAdAAAGADA.QAFAOACCXAFBHCACJCHB.eDEHhACARBGFKCCAZFAAMCFBBAHADDIBhAAASFGAFEAAUGEACGHAhAEATGEA..gECH..hAIA......hBIA...,2,-21,3,24
acVgLWIUDJYFReSObNTZBCHKGfEdMPAQX,aAAAVAAALADA.UCCADADAFAFD.RBDB.eAGH.OBBHhAEATCGAZDFAHEFAGFABhAFAEAHBdGHAAAIBQFFAhBAA..cFECIHDA.SHGAhCAANDDA....hCFA...,1,-4,-15,11
GJdQKNgYASCfUPDMRHZBXIaOeVbFTWELc,CAAAUAAADACA.HADAZACE.BAGB..aAFDeAHH.FCDHEAHBGCFAhADAdCDAKCGA....gFAAhAFAADFBSEFAhAAAMDIBRGEA.OFCD.bFGD.....hAIA......hCAA...,2,-41,-2,39
HVbFefNUOEJGZDWgLBIcPXYTdSMRAaQCK,aAAAQAAAHACBFAEAeACA.UAGAEAHBZCEBDBFBLCDBBCGA.hAIA.IEBAXDAAhAAAdEDCRDGBADAAKDHB.bFGDOFEDhADA.JGBEgGEAcGGC...hBGA......hBIA...,1,-7,-9,2
YLXCObVNeZdSaEMBHJQWgcRFUKTAfPDGI,DAAAGAAALADAOADA..VBBBeAGFdAHAEBHFHCFAQCDAhAAA..gEABhAEARDBFKDHBAEGBfFDAhACAIEDACEGAZFFAaEHDMIAABFEAWHFGFGGHPHBAhAFA.....hAIA...,2,0,0,0
UVYbGPEIZeADTRCaHMBKXWNcLFSfOgJQd,RAAAHAAAMADAXADB....NAHALBEBfAFAOCCBhAAAQBGA.dCADhAAAVEFBGDCAEEDBeFHHhABAAAHATEGAaGBA.KEEC.FGGH.SGDHhACA.....hAIA...,2,-20,12,32
UATWePdBZQKcYECRVagFJHOfNGIDLSMbX,eAAAdAAAZABBQADAKADA.EAFARAFF.aAHDFBHD.HDCA.OEFChAFAGCCA.LDHBhAAAMHAA.bCFDAEHA.PFEBhABABFDACGGAgGGG.fHBBhBHADGIB.....hAHA...,1,20,-30,50
GJcXFESVHKBICRdZQgWTYDNLfPAaeUbOM,eAAAOAAAGADA.JAFAFADD.EAFAHCFABAHARDBBZEFAQCEAhAFA..TGGAhAAADBBBLCHBACHAaFBHMIAAhABASCCDKHEA.dFFA.gGDDhBAA......hCAA...,1,3,-28,31
IBfCAKNDbZTaMPUVReGcWXdJYgOESFHQL,DAAAZAAAaACAMADA..UAFARAFAGBBA..XCCAdCHA.JCHBhABAOBEB.EDFAHDEBhAIALFDAfFBAhBFAABBBKFHB.bGDA..PHFC....hAIA......hBAA...,2,-22,-14,8
OASXbJUKPDNBHaIMQWdRZECVFLgcYfeTG,XAAAUAAADADAHAEC..aADAMAIBdAGAEBDBFBDH.LCFAhAAA..gCFAhAHAfDDEeEEBGEBAhABAAEHAbFCDKEGA.BFEAQGGARGEA...hAIA......hBEA...,1,-6,-11,5
cPMNeTJYadRLXKAZQgFHWVbCUOGDfEBSI,ZAAAQAAAHAEAVCAACACAGADA.EAFASAGE.ICGAhABAMAIBeBGFTDEAhACAaDDHRDGFLEAAhADAAFAAFFEDUGGBfDHA.BFGDcFADNICBYFHBhAEA...hAAA...,1,6,-7,13
bCHYLZdUSfTMgIDWEcOJNQXBPKRGVAeaF,eAAAaAAA.CADA.HACBZAEB.dAEBUBGASAGH.MAIBDCCAEDDBhAAAOBBH.QCEDhBAABEGARFEBAAHAFGCBbDGDLFBAhBFA.fGFEgGGBIHHAhCAA....hDAA...,2,-32,-2,30
ebMLZTOdSDfcaFKJgRBAUHPWVNXCIEQYG,HAAAVAAA.CADB..EAFAGADA.eAFAbBEA.ZCFB.dDAADAIBaBHDKCADhAAA.RCCBBDGDADDB.UFAAhACAPEHB.XFAAhAAAQFDALFDBTFGASGGDhADA.....hAFA...,2,-15,5,20
cWdgVMRKZDefINLXbQYFOHTACJBaUSGPE,BAAAaAAAGACAEACAdAFA..MAEARBDBZAGBeAHF....fCAAhAAALBEBbCFDQEFAhACAOBBHHGBAhBAAABIBCCCDUFBASFGA.PHECcFEC.hBGAWEHH....hBFA...,2,-27,10,37
GgQOfJNePEHYTFbDBdWCMVKaRAcLUZXIS,LAAAZAAASACEGADA.QAFAOAEDJAGBeBHH.HCAAhABATDDAbDEDdFAAMAIBhABAaDGHACCB..UEGAIGHAhACA.fHBFEGAADFFBCHDA....hAFA......hAIA...,1,8,-20,28
cAMOPReQXEUKHaGJgFVBYbIfWCNTdSDZL,MAAARAAAeADE..EADAHAGBGAFAFBDDBCFD..bBBC.IAHAhBAACDHAdEEAZGAA.AAAAQGFAhAGAKCHBaDDA..hAIAgEEG.fEHENCCADFIB.hBIALFBB..hBCA...,2,-18,-11,7
ONPcaRCGMDZeXIEQfFUVTHYbdWgASBLKJ,LAAAOAAA...PAEARADAGAGAZBEA.eBBBECAA.QDDAhAEAFCDHUDGBHFDAdEGDAAIBKFCAhAGAJFHF.aGDEMIAAXGGAhBAA..........hCAA......hCDA...,2,-10,-9,1
KDdaZCJQWIRTNVSeHBEbUOcFAPXMYLfgG,MAAALAAAGACBdAEAZAFBQAGCRCAA..TDGASBBDhAFAHDCCEAHFbCCDOCEChAIAACAA.XDGAhBAAfFFADFFAaGGACGHA........hCAA......hCCA...,1,-6,-12,6
WFJCVGbNHQLdASTfPMEYXZOURegKIcaBD,TAAAMAAA..EADAZACBRAFA.eAEA.KAHBaBBBDCABFCCA..CCEAGCFAhAAAHCEBdCHA.ADGASFGAhAGAfCHEXECAhACAOHFA.gFAB.BFHAhAFA.JHFANIAB....hCCA...,1,-12,-14,2
aZDXcUAYVSKTdWPBbMHQICJefGNRELFgO,SAAAdAAABADAHAEBQADACAGA.eAFAGCABRCCB.EBHFLCGBhAAAODEEZEFEXDAChABAAGAA.KFDATGGAhACAbGACMBIB.fFHAgGAAaGEEDIDAhADA......hAGA...,1,7,-18,25
LcFYMRCGgHQeNaUEWJDOVPATXbKSIfZBd,TAAAKAAA..SACBZACBdAFALAHBFAEARAGF.GDEAHBDBeCCDhAAAaBEBECABDCIBOEGDhAAAADGB..XEFAhAIAfGDABFCDMEIBQGGB.WFEDhCAA.....hACA...,1,-10,-13,3
BAKcPDHMdENVJRgCSYQZUfTbXeaGIOFLW,KAAADAAAHABCEACE.JAEARAEF....SAGBZBFEUCCB...bCCDhAAAeDFAGDGAFEHDLFFBhAHAAAIBMEAB.dGDAgGCAhAEACHHA.fFFE..hCAA......hCBA...,1,-19,-21,2
cJbfAgXCRIDQYUZFOKMLSEGTHWNadPeVB,CAAARAAAQADCZACA.KAFCMADA.EAGAHBFC.aCCCeBHFBDEAhAAAJCCAAAIB...XDEAhAAADDGBFDHDSFFDhABAGGCBTFGAdGGA........hCAA......hCBA...,2,-25,-15,10
HQLKEFfXJGBVTcdeIZbCNSagMDRYPWAUO,HAAALAAAEADEFAFAXADDGCAB.BBHATAFAeCFB.ZDGBbCABhABASECA.hACAaFEDMAIBDEIB.RCGBPDDBhAFAAGCA.QFEA.fGGBhAHA....hDAA...,1,-8,-9,1
VaMFYcOZbdeIEKLgJAPCNDTHXQGBRWSUf,CAAATAAAHACAGAFA.RCAA.SACBUEAB.aAEAMAIBFAHBOBDDhAAAdDEAEDHBLFGBhAAAABFBDCCBQCFDhCAABHAA.fEFA.cEGDbECD.KGHBhCIA......hDAA...,1,1,-22,23
WcKMGRVCFAHDgbNBPEefTYXJZSOQdLUIa,HAAADAAA...bADBBACA.EAEAeAFA.TCFAXAGAZCAAQEEChAAAdCCALCFBhAEAaCHDKCHDRFCBFFHBABBBPEDDhAHAfGAA.SGGDOFGD..hACA......hAGA...,1,9,-32,41
QAaEOGCFJUDZfNdgLTIbeBVSYPMXHRcWK,EAAAGAAAFACD.DADAZADBdAGALAGB..bCDBeBFFBCHASCHHhAAAMDDB.HEEChAIAREGBKEBBAFBAaFBECFEA.fFHAhBFA.NIBB.gGBG..hAAA......hACA...,1,-1,-32,31
NWfHDMGgRIFOTLYaJbKScEPUQVAZBedCX,eAAAdAAACADA...XADA..fAFAHAGBGCCARAGFOCAEhACATEAA.aDHDKCEDhADAEEFAQDFDhAFAAAAAZFEABGADDCIBMIAAFFGH........hAEA......hAGA...,1,-3,-30,27
GacXNWPLCgRUeKDEMdbTVFBYIJHQfSOZA,aAAAXAAA....PADALADARAGBKBBDEAHB.dCDATCDAhAIABCFAIDHAhAAA.HEAAQDBDhBAAOEFBAAEAGCFANIABCGGAgFCAeDHHbFCAFGHDhBDA......hBIA...,2,-5,-5,0
SHgZEDJWFKNAIQCeXBOTYbPdUfaMGcLVR,QAAAeAAAOADC..TACA..bAGBdAEAUCCAaAGAGBFAhAAALCFBRDDBHFGBhBHAEDHFDFAAFHCAAAAA..XFDChAFA.BFHA.fGGEMCIB.hCAA......hCHA...,1,-2,-13,11
USLcYVeTgKMaRfEODWIbFJQNPHAGdXCZB,dAAAZAAASACELADA..VBGBeAEHKCBARAGBECCB..DCEBIDFAhABAFDFH.QEGAhAGAHEAAAAEAGFCBhACABEEDcGCA.gGGGaFHBOHAA.hAIA......hBIA...,1,-12,-15,3
JcBVPNLHeFMabEGQRXWOSZKfYdUDACgIT,CAAATAAABACA.....VADALAEAHAGBeCAAaAHDGCAAhAAARDDAODHDZCCAKCGDdFFAAACAJDHBhACA..PGAAFECDEEEBhAFAQGDA.SHGAfGAEhAGADIAAgGGAhCAA...,2,-22,13,35
SeRWZMUCFDdaYcKTPGIgOAVNXEfQHLJBb,XAAAEAAAHACALAFBBADA.eAHBRAEFZAGBMCCBFCDH.dDDAaCHDKDGAhAAA.GEAA.OFEChAEAAAAAfDAAhADAJHCAbGFA.SEFB.CFHADFFB.TGAAhAGA.gGCBhBIA..,2,-16,7,23
baBCGcUAZNEMSYRIJFQePTVLDWfKdHgOX,EAAAMAAARACA.FADD..eAFE..TAFALCCADAIBKBBBHCFBOCEChAFAaCHFGDAA.hAHAADABZECBSDDDhBAAIFHAQEECPFFB.fDHAhBBA.dGGA....hCAA...,1,8,-27,35
XGYDZJcaOMABfKbQUdVCEgHRPTSWeINLF,KAAAQAAAdACA.EACAHAEA.RCDBSAGEeAEALBHBGCGAhAAAZCDAaCFAACGB.bECACEAA.hAEA..TFAAIFFAhCAAXGFADFDBOFHDMFIB.....hAAA......hAFA...,2,-16,-3,13
GgfFcaNJXVHYTbOEeDSZIPCUdAKMBRQWL,MAAARAAALADBGACBFAFA..aAFA.JBBFHCEB.TCGAEBHFeCFBhAIAZFBACCCCADDA.BFGAQFEChBAA.fDHAhCAAXGFC.........hAAA......hABA...,1,-11,-25,14
bMSXJODdGIgCTAVQPZefBKcUaRYFWNLHE,QAAAeAAAKADAUAFARACAFAFA..LBHBHCDAEBHFMCCB..hAAAXDAADDDAGDFAhABACDHAADAAZEFABEEC.aECDYFCBhAAA.bGEAOFHD.dHDB..hAIA......hCAA...,1,2,-15,17
VbISLCEKXJAQNPTgGcMFOefRDdWUBaHYZ,QAAATAAA.GACBMACAFAFDeAFERBDB.dCDDBAHAHCFBZCGBbDABhAAALDBBKCHB.ADDB.hAAAgFFAOEFHDDIBhAHAaHCA.IHHAEGDB......hADA......hAIA...,1,5,-15,20
QXDPHYFSEOMIeBTCAbfLRcGUVKdJZgNWa,LAAARAAAGADAKAFAZADB....NAGA.aAHDQCAADCCB.HDEBhABASCFHEAHBMCHBhACAeDABCFBA.AAAAbDGDfFHAhAIA..cFDA.dHABWFCHhBFA......hCAA...,1,-15,-18,3
ZAIJeEaONTdLCYFWgXQPfRHBcKMSDVbUG,eAAAEAAA.OADCdADALAFAFAGA.XCBCQCCA.RCEAHEFAhAAAKCEAMCHBDCIBbFAAhABAZEEBAAGA.aGCB.TGGAhAAACGHA..YHCG.....hBCA......hBDA...,1,-1,-22,21
ebdEcUTRYNCLKJPfHSaGAVDMXZBQWgIOF,MAAAZAAAQAEA..gACAFAGEeCABECCBTAFARCFA.hABACAHBLCEAKECD.hACAfDDEHEDBaEAHAEIBhADAXDGABFFBOFHBdFAAcFCANICB.SBBDhAFA.DFFAhBAA.IGGA.,2,-3,7,10
CcGJSXFfIVZMbQYDOgBedPTERWaHUNKLA,GAAAXAAAFADA...VAGBZACBbAEADCDA..BDDAdCEAECGBRDFB.hAAAHEFAKDHB.AAAACEDD..hAFASDBHMAIBQGAAhAGAOFDBeFFD.TGAAaGHB..hACA......hAGA...,2,-20,1,21
CaIHQBcbVWYKFMLePTJSZENdGfARDgUXO,RAAADAAAUADACACA.HAFABAEA....bCCCVAGB..KCGAMBBBhAEAeEEA...TFGAhAAAZCCAEDGBdHABACEAOEEBhAGA...aFGC.....IHHAhAIA....hBAA...,1,-16,-44,28
OUIcWXEZaHSgKVBLeMdfGNFJTQCbPARDY,RAAAOAAAUADA.....IAEAXAFAEAGAHCEC.KCCDLCCAhAGAeCHHdEEAGCFAhBAAFFHDQGAAhAAAbDBCABBBDBIB....cFGDaGFD.SHCAhBDA.BHFD..hCAA...,1,-6,-22,16
JRaQTfAWeHBOVdPMCULgXEbZKcGINDFSY,HAAAOAAAdADA.MAFALAEA.EBBBZBEBGCEADBHBSCAAhAAARCGBaBDH.TEFAhACAAAFAeECBBDDCCFHA.XGCAhBIAKGFANIAB.FFHD........hCAA......hCGA...,2,-16,-12,4
ZdACXeGUOSEQFbYaJWITVMgLPDcHNRfKB,eAAAGAAAOADCEADAQAFAFAGA.aBHDICCA.MCEAhAAALCDB.DCFBhAAAHDEAREGBBFFDACIBXEGAhABAbGDC.JEDFWDADTFAA.gGGBhAFANIEB....hCAA...,2,-16,-1,15
EeUYDRLQfFWTPASOaZIVXMNJbdGHcKCBg,aAAAZAAA..XADBMADA..JAGBGAFAHBBCKCEBBAHA.ECAAeBHHhAIADCIBRDDBLEBAhBAA.QEGBhBBAFEHHTFBAAFFBSGGAOFGHIHAA..hABA......hACA...,1,-7,-19,12
RISFKeHdYPOVWXGgMQDLabBUTNcECJAZf,RAAAFAAAHADBdADA.OAFA..XAFAGBFAMBIBLCCAbDAA.hAAATDFA.EDBBACCBZEEFhABA.SEGHhADAeDHHPEEBgFBBaFABBGCA.UGGBCHHA.hBFA......hCAA...,1,4,-6,10
UGBeYgFZbdAOPcIXVEQHMRCTJfLaKSDWN,OAAA..IAAAEADAHAFARACACAFBTCCALAHB.KCAADBBBhAHA.UCFBeBGFFECHdCEAhACAACIBXEEAMDDBaEFE.hADASEHH.NIABBHFAgFGAhCAA......hCCA...,1,-6,-27,21
BCfAMKZLFcEbJSNVQGWPdaUXTYDeHRIOg,ZAAALAAAEADE.SADHQAFCGAFAdAHAUCAA..TCAAhABAeCDFHDGBRDDBOAHFhACACEEAADGBMIDAFDHHbFAA.hABAJFGF...WHAGaGGC...DFAA..hAFA......hAHA...,2,-5,-5,0
gIYZRXGWPUeADEOQVCFabLNTJfBSKHcMd,EAAAQAAAFACD.aACELAEA.TCDABAFAHAGB.hAAAdCDAgBGAhAFAZDABRDFBXFCAGEFAPFHDhAAAADIBOFCACDHA.bGAANIABSFFDMFIBIHEAhAGA.....hADA...,1,4,-8,12
aXgEWRQMeFYUVCBTNPZIcSLGdJHAfKDbO,DAAAaAAA.EACARACF...eAEAFAEAUCEABAHA....TCCAZAGBSBBDhBAAdCEAHCGBABBBKDHBhBIAXFAA.QFFChAFAMEDBCFFAIGHAcGCD....hCAA......hCIA...,1,-9,-34,25
dPEIWDCKLeXaMBfNYRJOSgHUVZATbcGFQ,TAAAGAAAdADA.EAFADACALBHBeADAaAGDMCFB..fCCAhAAARDBFSDDBHDEAhAIAZDFBABIBFECDQGCAhAAAIFGAKFADBDHBYFHBOFHD.gGBGhBGA...hACA...,2,-4,-2,2
AcWERbUHVfNDIOSZQFePKJdYGMBLagTCX,EAAARAAAHADB..VACADAFASAGAZAFB.eCCBKAHBdDDAGCFAhAAAMCCBaCHFCCHDAEGA..hAAAbDADUFFA..fEEEhABAOEHDQFACFFHBPHDA..hADA......hBFA...,2,-18,1,19
UaMNGBXYCZcPRQgdOTIJLAfHDVKFbeEWS,HAAAKAAAeACEEADESAFBUAFA.aAHBGBCA.BAHACCADZCCAhAAARDGBdEEATDGALGDAhAAAABIBDECAFFCAMECBXFFChACA..........hCDA......hCEA...,1,-12,-22,10
EdUZBGJODWefMQAHRVcYSaTKXFbLNCPgI,HAAARAAA.VAEASADBKBHB.FAFALCAACBFD..ICCAhAAAECEBZDFBGEAAhAAA.DEEBeAHHMEHBADEAaDEEhABA.bEFANEIA.dGGA.BHEA....hCAA......hDAA...,1,-2,-26,24
FPgNXTREJZMcdOSAUaeWYfILVGKbQCBDH,eAAA..fAAALAEAGBCAQADADAIBHCEBFAFEgBGAhAAATCGAEEHFZCABhACAdFAAACDBaDEBIGCAhAAAbDFABFFAXGFCMFHB.......hADA......hAIA...,1,4,-10,14
MOaZSTLHAIBfYbUKPgeXVQCdcWJEDNRFG,BAAA..bAAAKACAeAEAQAECdBHAJCAA.EAGE..RCEBGEAAhAAAaCAAZCEE.LECBhABAHDCBACIB.fEGAhACAUEGAXFEDCFHADEEBMIEASGCD.IHHAhAAA....hACA...,2,-22,4,26
PBDUYIVXeEdRQMbaLTCHfAKcJWFZSGONg,KAAAJAAAZADBGACA.OAEA..PAFCDAIBUBFB..VCFAhADAECAB..RDFBMDIBhAAAaCCBLEEB.HFCDhAIAAEEBFEBDSGFHBGHDIHEA..hACA......hBEA...,2,-24,-19,5
IXbUSETKJVPHLNWfDdeYAgcQRBFaOCMZG,QAAARAAAFADA.aACEMAGB.GCCAXAEDUEFA.EAHBTAGAhAAA.KCDDPHCAhAAAHDABLDFAhADA.fEEEeHFAACCB.BFHA.ZGAA.hABASGDB.hAIAJHFA..,1,13,-24,37
BPILaSCVgWQEJZFfdUeTORAcKMHYbNGXD,MAAAHAAA....bADBGACBBAFALAHBaAFACBBD..VCEAhAIAQCABZDCF.dCFAhAAAeCHHRDCBABHBKEGAXFFChBAADFFBSGGAEGHFfHCB...hACA......hCDA...,1,-7,-11,4
QLdDNWFAgESBCUPVKaRYGTOMXfHZcIbJe,EAAACAAAUACAKACA..RAEF.GAEB..MAHBHCDCZCCF..bCGDeCFHhAAALFAAdEAADAIBFCBHhAAAADIBBEGA.aFGETGEAhAFA.fGGBIHHA.NIAB.SGAAhAEA...hAHA...,2,-23,-12,11
cDAfLKYRQGPbFHaVEBeCUTSgIXNJWZMOd,LAAARAAAGADAFAFAHADB.EAFAeAHHUCAA..TDAASAHHhABA.XCFDhACAJCFBZEGBdGFCADDBKEEDQFBAhAAAaDHDCFAA..gFGG.IHBAhAFA.MFDB.hABA...,1,3,-11,14
fZVKbYBEaOCTURgIcSPQHdLJWNGFeXADM,MAAAZAAAKADCBADA..EAFAaAED..TBGARAGB....gBBBhAGASCAAHCFBhAIAdCEALDDDhABAJEDBNDIA.eDHFADEADFFBbEFDCGGA.......hBAA......hBIA...,2,-25,-17,8
aMZFONCWKPRVGcSEIBLHfJdUeDTQbYXAg,aAAAZAAAOACA..CADAKAFARAFAGCCB.ECHBLAHB.hABAHCCAdEFAeEHBTDAAhADAbFCBABBBMCGBFGAA.PEEBhAFASGHDBFCAfFHADIAA.hAGAYHCA..hBAA...,2,-29,2,31
MQTIKEXHCfAcGFNSBVbYOZgaUdLeWDRJP,GAAASAAABADA..VADAOAEDZAGBUDAAeAGBRDCA.MAIBhAAATDCA..EDGBHEFAhAAAACDBFFFBbFDD.aCHDdGCAhACALGAADDAB........hABA......hADA...,2,-16,-3,13
CDBIZUaeFKcfPObgNJdRHQSGXYTVEMWAL,LAAABAAAZACAeAEEKAEA....fAGBOAHD..bCCBhAAAJCAA.HCEAGCFAhADATEAAEEEBAEIBDCGAaFHHFDHDhABA...gECBdHABSHDAXFFChACA.MIAA.CGHA.hAEA...,2,-15,-10,5
OfAYGcSRNFBTbJPLdIEXgWCVUZKeDMaQH,GAAARAAABADB.JADAdAFA..EAGE..XBGDCCDAZCEB..eCGFhAAAaAHFHCCAACIB.SECAhAAATFGA.bEGBIHEAhACA..gFBGWDBH.KFEAhABAMIAA....hAIA...,2,-28,-15,13
VaSeNJgObWDRZUdMXLFAHYKEPGBQcITCf,HAAAEAAAGACAQADC.TAGAfAEBaCAC.eAGHgCEAhAAAbCEDRDGB.dDHAMAIBhAAALEGDACBBKEBABGAAhAGACFAASDDDNIEB.OFCB.DFFB.hBCA......hBEA...,1,13,-2,15
gHOaYbdCEKVNWUBecSILQXfTRDMFAPJGZ,GAAAHAAAaACAdADAEAFAKAFA....VBGBUCFABCCAeDBHSCEBhAAALAHBQDDAhAAATEDARFAA.MEIBhACAAAIBZFGBOFAHCGEA.cGFA....hAFA......hBAA...,2,-14,-3,11
IBLYRUWCSQKDGeNfXbcHMTaVdOAZEFJgP,EAAAFAAA..JADA..IADALAGBRAEFUAGA..SBCHhAIAQCBAGCEAhBAAeDDGXDGBHECBaCHDdFHAhBIAAEIBZFFABGFACHHDDIBA.......hCAA......hCBA...,1,-12,-19,7
DFYMHEaJXGNIRUfKWPdcABLTOeVbZSQCg,TAAAeAAAZADB.QAFADACAFAED.HCEBEAGA...aBHDGCCAhAAARDBBKEGAdGDAABIBLCGBhAGA.bFDDCBCAgGGAhAAAMDBBXFFCIHBAfGHA.hABA......hAIA...,1,-4,-7,3
cZNWSRYFeLKfMDTPbaGVgQOJBAEHUXCId,HAAACAAAdACAZADBSACE.RAEFFAGAeAFALCCBMBIB.TCGAhAAAaCBHGCFA.QFCAhAAABEEAEEGBXGCAhCAAIFHA.cGGCYFFFDFIB...hCGA......hCIA...,1,-9,-15,6
JTfEPLBIOQFRWXeDYgcdVZNCMabGSUAKH,HAAATAAAEADE.LAFBOACA.RCAAeAHBDAGA....gBDAhAAAdCECZEFBMEIBGBFAhBDAACHBKHGAfBHEhBIA.BEEA.QFGA.FHEAhCAA.YCCFNIAB.hAAA...,2,-11,-4,7
QVGPULEBOMNgYAKfTHbaCeJXRDISZFWcd,TAAAHAAAaACA.eAEHRACFDAEAZAFB..FAGDdBHAGBEALCCBECABBCHAhAAAMEEA..gEGAhAAAAAIBKECA.CGHAIHCAhAIASEGAWFFDQGEA..hACA......hCEA...,2,-24,2,26
ZYGJQFRIdPNAfaDTEgbOVcCSeWMUXHBLK,aAAAEAAA..OACCCADA..eAEHMAEAHAGBLBGBZCCFGDAAhADAQCCAREEFdDGDAAGBTCEAhAAA.VFFASGGAhAIAXGCA.........hBAA......hBBA...,2,-11,-8,3
aOEMGASFUBCVPHNTLDgYeIKJWZQfbRcdX,FAAACAAAHACALADADAEA.eAGHKAGAZCAA..QCCARCEA.hAAAdDFDaCHDEEAAACEABEEDhACAPEHD...TFCAhAEAgEGGJFFB...fGGEhAIA......hCBA...,1,-9,-36,27
KXHWfbASZaDBgECYPQcedOMTVIGUFRLNJ,aAAABAAA.EACACADA...QAEAeAEHdAGAMAIB..TAGAhAAAGCCARCAALDEAhACAKBBDHEFA.bECCADABZGBADCIBgFGAhAIA.cGDAIGHA.hCAA......hCBA...,2,-16,-12,4
DKWPfeQSbdRcaIGOVXNAECMBTHFLJgUZY,EAAAMAAAHACALAEAUAFAZCCAKBBA.....fCHAhAAAeAHHbCDARDBBaDFD.GEAAhAEAXEECAAIBTECAFDHDJFABhAFADEIBQGGAdGGA......hAGA......hBAA...,1,8,-9,17
EaZcQgCKAGYOWbLIDHeFfXUdSRMVJBTNP,GAAAOAAALAEAHADAeAFEFBBHUCDBRCEA.MCGBBBHA..TFGAhAAAEDCFZEEA.QFAChAFAKCHBADAB.bFCDfEEEhACA.dHCBSEGE.hADA......hAIA...,1,-7,-12,5
JKGOEcBRCIgDHMfVLPSXFYWadQTUZeANb,JAAAGAAA.EADARADF.CAFA.DAFAHAGB.MCDBLBGB.SCCDhADAFCEBaDAHdDGDQEEChAIAZEFAAAABKGGA.BCFAhBAA...IFCA.fEHAhBIA.XGGAhCAA...,2,-39,-11,28
dSGIERJNQLVeCKgZTfMAHYDXOcbUFaWPB,HAAAXAAAOACAUADAaAFD..BAFAGBGARAGF.QCCAhAAAeCHHKDBAZDDBMDFBAAAADFFBhAIAbEFDFFBA.dHABEGGANEIA.hAHACDFA............hAIA......hBFA...,1,6,-27,33
fMbOGJSVHPdNAIQYECDgUcTaXFReBZLKW,QAAAEAAADADA.UADAaAEE.RAFA.ZAGBLCHBKBCA..MBIBhAAAGDBA.SDDAhAAAHCEBdDDCACBBCDGATFFAhAGAeEGFfFHA.bGCA....hBCA......hCAA...,1,-12,-17,5
JHVZdYNFgWCfGUAMETcBQDIeSXROKPbLa,EAAATAAABACA.DAEAeACE.RAFF.KAGALAHBHBCCdCGAFBDHCDDD.GDEAhAAA.ACCBMEHBhAFAQFBASGEDhCAAOEFBaGGHJEHB.........hCHA......hDAA...,2,-33,-7,26
XDEAfNSPGgLaeQUZcTFbBOYWVKdRJCHMI,SAAAGAAAaADAUAGAZACBFAED..OCDB..VAGBRCEFHDGBhAAAMDEBDECBAAAA...hAGAfGBEgDFBhAIAeGEETGGA.bFED......hCAA......hCBA...,2,-22,-9,13
HFTDZgGPQUVRYJXKIaNbecdBECALSOMfW,LAAAMAAAHACCTAEAZAFBGCCA.QEFARAGFXCAAaAHDhAFAeCHHdDHABBBDACAAfDDAhABADFCB.gEABhACAPFEB.VFDAKGHB.bGACCHBD...SGHBhAEA..hAGA...,2,-5,4,9
GbcXJEIFUHSeKCBfMYaQADRVOTWZNgdPL,RAAATAAAZADBdAGA.GCEA..bACB.XAEAECHFFDAAHFBAhAAAeAHBBCEA.MCCBhAAAaEHDAAIBOCGD.gECHhAFALHFA.IFFA.KFHBCGGD.hABAQGDD.hADADIAA..,2,-11,6,17
ZgaDTXVOUBFGRAEICPbfSLdWHNKJYcMQe,EAAACAAA.....bACALACA.HAFBKAGAJCCAMAIBeCFHhAAAaCCADDAA..TDAAhADAODDBFCHBAAHBfDHEhAAAdFGANEEA.QEAAZGAA.XEFChADA.BGED.hAEAIGGAWFHH,1,-8,-18,10
COcfRTMFaSLQUNVEHdBWYJGeDbXPAgIKZ,KAAAZAAAOACARACF.FAFDaAEA.LAHBUCCB..EAHBHBEAdDFABCHDhABAJCABeDEB.XDGChAAAAEHACFED.TGGAhACAMFHB...SHBANIAB...hAIA......hCAA...,1,-7,-34,27
KNdMEIJHOZWTceADRCBQgbSfYLFPUVXaG,RAAAQAAA.SACALADBFAFAUAFAaAHDGCDAdCCCEBFBhAAAHDABZDFA.TDGAhAAAADHABEEDbFFA...fGDEhADAPFGB.KAHB......hBFA......hCAA...,2,-27,2,29
YeZIfFdbCTgSHLWAOQGcaRXPNKDVUBEJM,GAAARAAA..XADBKADADAFABAHA.EBFFMAGB.eAHBhAAAZCDFFCGDdCCATDGAhABAHFECAAABODAHaBED..hACAPEEB.UGGAIHHACHCA.SDHHhADA...hAIA...,2,-20,-16,4
JTFNEPRLXAMZcIVCeDBgdKbQaUSYWfGOH,ZAAAVAAAeACE.BAFBdADAQAFAUCCB..SAGHhABA..fCEAhAAAHDEBTDGAECHFRDFBAAIBMFCBhCAACAHAKFAAaDDH.YEHBOFHDFGDB.hAFA......hCAA...,1,-10,-19,9
LZWDfIPFQRHdSECeJOUbaVNKgYGBTAcXM,MAAAZAAADACA....fADAFAEDHAGBECCBeAEHUDGB..hABAaAGAKEDAGBBAAAGBLHFAhAIAIBGA.RDEAdDHAhBAACFGA.bFDA.NICBBHHA.....hBIA......hCAA...,1,4,-29,33
BKSRGZATIUCQMXeJcbgDLVEadNPfWFOYH,TAAACAAA..MACAeACE..JAFBbAFBLAHB.EBCAdBHAhAAA.fBDEhAIAFCBHHDDAKEGARDDAACCBQEGAhCAA.XFCCDFFBaGDBNIEBOFFBBGGA.hAAASHCAIHBA.hBCA...,1,10,-30,40
RBPMDbedUSaCXVcEKZFYQHgJNWLfAGOTI,GAAATAAA.RADAMAHBeACE..dAFAUCDBaAHB...CDGD...XCCAhAAAEEABZEEAQGABhAAAHDEBgCGAhBDANAIA.LFHBAADABGGDDFIBSGGF.hACA.cGCD..hAGA...,2,-16,1,17
WCGAZdOLaFSPfVMeUQRbHgcEKBXNJIDTY,dAAAaAAA.SADA..fADAeAFHRBGFHCACEAFAXBFAhADAIEAA.DAIBTECAhACACBBDACEBZDDALEEBhADAFDHDMFAAQEGB.gGGAhAEABFDAYFFFOHAA..hAHA...,1,3,-19,22
TOgKEQFNXUGBaLSfPWCRDMAJVeYZbIcdH,eAAAZAAA..IAEAHADATBGAKAGAFCAAXCCC.GDEAhAAAaCEALCHBSAGEhABA.fDGEhAFACDADRDDAADDAVFFBbFCD.dGGAEGAA...NIAB...hABA......hACA...,1,17,-19,36
bSUJdHRBZcAMefPDQCTYNWXKFELIgaGOV,eAAADAAAQACACADA..TAFA..YAEGXCCAhAAAEBBBLAHB.hAFAaCFHGCEAbEFASFAAhABAdCGBHDGBBDDCACCAMGDAfGGEhAIAPHCAKGHD.....hBAA...,1,2,-20,22
cKCPRaOdLbAYDEgVSUNXBeMHWIFTJQGfZ,EAAASAAAUADABAFAHACB.FAEA.QBGAZAGBCBCC.RCEBdEBAhAAAABIBDDDA..VEGBeDHFhAAAMEEB..TEEAhCAAfHABKGCAaFHD.......hABA......hAHA...,2,-35,-9,26
GNQLBTKbPASCVdUXZHeMfIgFcaEJYRWOD,CAAAdAAAZACAHADA.eAFEMADA....fCBAFAGDECCARDEA.DCFAhACA.GDCALDHBhAAATEGAKEDDAAIBSCGAhADAXGFC.gGEA.aEED..hAIA......hBAA...,2,-31,-6,25
AfaTcPdeDIKYUbHGRCXFJBEgNOQZVSLMW,aAAATAAA..dADAeACEKAFAUCFAHAFBRCCA.FAHFEBBB..ODBBhAAAZDBALAHBACCA.hAFA.fDGAhBDADDDAbFAA.GEEACEHA.BEHAQFFCSGHBhCAA.....hAFA...,2,-24,7,31
CaJDdWMZbYgPFNUEHKILRBOAfTScVXGQe,TAAASAAA..XACBeACHaAEAdAFAZAGB...bBDDgBGHhAAA.FCCHhAHAEDHFHECCLFBAhAAARFGBABEAfGEAGGEBCCFCDIBAMDIB....hAIA......hCAA...,2,-9,-4,5
CIVJYcaRZWeBbNgPXLKQOFDEUfHGdTAMS,MAAACAAA..VACAJADB....aAFARAFFeAHHBBBA.....hAIAbCABgBEHhBAALDDBQFABhAAADBIBECGFHEEAdEHAAEHASFHHIFFAYHAGhACA.WHFA...hBBA...,2,-33,-1,32
cRNOWFMCIUaVDKAgQSfXeZdBTLGPbEHJY,QAAAXAAAdADALADAGAFAEAHBHAGB.JCDARDBA..ODFHhAAAMDDBCDHAUFBBDEAAAAIBSEGHhABAeEEBZFABTGGAhAAAPHDC..........hAEA......hAFA...,2,-9,-4,5
SJEcHDbCRgOLKdeNWAMFYaBIVXTfUZGPQ,MAAAaAAABADA..XACAUAFAGCCAQAFA.EBBBHDABhADACAHA.REFALGEAhAIAdDDAeCFBACIBFHBA..IEHAhAFAfBBEZFFASHDADBIB.hBAA......hBFA...,1,-11,-14,3
XUNYBMPcSLdWAeaCfZHEgJVTGQKOIFbRD,eAAAaAAAZACBHADA.EAGEJAEBGCCA.QCFAOAGBFBHDRFABXEFChAAAUEEA.BDHBhABAMBBBSFHHhAFAdEHAAAHA.CGGC...fHFB..hBAA......hCAA...,1,12,-37,49
aQgYZTJePXcCILUNABGWSdKbfFRMDHVOE,GAAAdAAAKADAFAFARADAHAGB.ECDBQCBA.ZBFEeCFB.hACAXEAACDADLDDBhADAAAABSDHHMDHBODFDhAIAaEFHTGAA.PHEAIHHA.hACA......hADA...,1,-4,-22,18
ADcCaINWQRObYGXTMELVBSZUFfHgJPKde,CAAAaAAA....IACAQADA.RAFAOBBBGADAMAFAhAAAECDBLCHBSBFBhBHAZDEBFGAAHCGBJGFEdFDAADABDIAAhADAcFFA.WFHHYHDA...hBIA......hCAA...,2,-28,-2,26
PegHRKUTcFaMIQNGWAbLXfCZJSDEdYBOV,LAAACAAAZACA.DAEAEAFEdAHABAHB..OBCEeCCBHCECRCABKCFA.hABAUEAAFDDB..MDIBhACAQEEC.NCIAAADAhAAAbEFB...fFBASFHDPHBChBFA.....hCAA...,1,-18,-24,6
HEGVRQWLdIfYCBgaXKUSFeNcJAbMDZTOP,MAAAZAAAOACAHACCEAFERAFA.LAHBdCCD...ICCAhBAACCFDaCGD.KCEAFEEBeEEA.hABAJEHBACIBDEIBGGCBQGAAhAGAWBBD.BFGA...XGFChAIA.....hCAA...,1,-6,-23,17
XfNGTLYJZQgSaAKCOUPeERIBcFdbHVWDM,OAAAeAAARADABAGBdAEAHAGB.DBBBMAIB..XCCCGCCATCFAhAAALDFAZEAFQEBBhAGAaEFCACCB.CEEDEFGAhAIAFFHD.VGDAfHCF.NIEB...hABA......hAEA...,1,-2,-10,8
REHZWONFGcYgfaBIdCQVADKbTLUePXSJM,KAAATAAAeACE..SACBRAFFHBCBZCGBOAEAGEEA..gBDHhAAAaECCdFAACGHAAAIBbBGDhAIA.LDFD.hAAAXGCA.EFHBWHAANCCA....hAFA......hAHA...,2,-15,2,17
ZSOXfURVEIQGKcATDNaPJdBCMgFYHWbeL,TAAAaAAA..dADAMACAFAFAHBEB.eAHHZADEXAGDhAAARDBA.ECCBGEFAAAIBDCEBJCFFhCAACBBDgGCAhBAA..bDGDLFHBOFFH.....hDAA......hDBA...,2,-19,0,19
aTVDcRHGbgCAIKJEeWdPXMZQUYfLFNOSB,KAAAEAAAdADAMACAZAEB..QAFAUBGALBCDOAHFBEEAaBCD.hAAADEGAHCEA.bEBAAAHAeFGBhAAA..XFFAhBEAFGCASFHB......hCAA......hCBA...,1,-12,-27,15
aMYBTILWPJSFbXZdKACNfHgQeVRDcOEGU,CAAAHAAA.eACERACAOAFAEAFEGCCA.aAHDMBGBBCFALCABhAAAJDHB.FBHDZEFFACCB.fHABhAAAQDDADFCBhAHAUFGAIHDASECD....hACA......hADA...,2,-27,3,30
dGSYOgeIbXBVJEDWKLFZaUQCMPRNHfAcT,dAAAGAAAOADAeADA...XAGABAGAEBDBKCDAZBFEQCFChAAAMCCB.REAAHEFChACAADDBTDFASEEDhADA.gGGAbFFADEBBLHDAaHAA.CEED.hACA......hAIA...,2,-25,17,42
PQaMCdRSWABIfcbLTgGEFJVDNOHUYZKXe,BAAA..fAAALACAGAFAEADAFAFDDAHBHCCAZCABeAHBhAAAaBHD.dDAARCDB.ADHBbECATEGAhAAA..JEHBODCBhACAKGFB.QFDBMIAA.SGGAhADA.....hADA...,2,-11,2,13
TgYMRVGDXNUBJPZASdOWCQcfHEaKbIFeL,dAAACAAA.QADAHACAEAFEKBHBFAFELCCB..TCAAhAAAMAIBRCEAGCEADDAAXEEAhACABCGDZEAA.AAHAOEGDhACAfEHAaGHD.eHCA.....hAEA......hCAA...,1,-10,-14,4
MfXbJVATUSOFLcBWdCQeEKZHNDRIgGYPa,TAAAOAAALAEA.BBBDdACAeAEAEBDBHCEBRBFAGCDAhAAAaAHD.MDHB.bEABAAFAFDGAhBAACFFA.ZFGBDDIBgGCAhCAAfGHA........hAEA......hAFA...,2,-14,-11,3
bWdEQFSZMOGHTIKLAYcgBXRPJVCaNeUfD,....gAAARAAAPADA.CADA..eAEHDAHBdCCAFAGA.ZCDBGBFAhAAAHBFBKDHBACCABCHBJFEB.hAAAaDAA.UFFB..hABAfGGAEDDBMEIBOHEE...hABA......hAIA...,1,-2,-29,27
daAZMYRGPcQFLDeSNbCWBVOXHgUTEKfIJ,ZAAARAAAGADAQAEALAFAeAHB.SCAACCCDBCFA.XCEChABAHCGBTDAA.hACAEEFBfDGAhADAdGAAAAAAMFIBcEAADGHBNICB.bFEA.ODDH.KGBDhAEA.aGHD.FHCE..hAIA...,1,2,-2,4
FQfAICEaTgXMeKSbPLWcYVUGNOJdHRZDB,EAAAaAAA....TADAMADAeAFA.SBCAbAFB.LCFAhAAA.cCBChBCAUCDBGCGA.hBDAOAHFHDDBRFGBZDABFGCBABBBCEEDKGEAYFGFhADA......hBAA...,1,4,-18,22
PJNVHQcAMBSTRgeIYWCaXLbfGKDEdFOZU,MAAATAAARACA...eACE..IAGACAFBaAGD.LCCAhAFAGCCAECFBdCGAZECAUEFBPEHDhAIANAIA.HGDAACCBSDBDhAAA.gGGA..hBDA......hCAA...,2,-13,-13,0
bdJLOFTQEacDeHIYVGMAfWgBNXRKSUZCP,...fAAABAAARACASAFBZADA.CAHA.dAHALCABhAAATCAAECCEDCCBHCFCVDEAAAEAhAAA..NDDA.KECAUEEAhACAbFGDFGAAaEHD.eHBAIHAAMEIB...WFCDhADA...PHFAhAHA..,2,-10,-2,8
VKJGXFaDYUROeTANICZLEWgHMfcPSBdQb,CAAAEAAAHACA..MADA..fAFBSAFAdAHAQBCAhAAAbCAB.KBHBGCDAhAAAaCBHDCFBRCFBeDHHACGBZECBLEGBhAIAgFCDBFFAXGGAFHDE.OEAHhACA....hAEA...,1,2,-6,8
SRJfCeAGXadUHFMVQZPbcYgIWBNEKTDLO,aAAAHAAA.MACAZACB.....bAEAgAEABCCAECEATDFAhAAALAHB.RCFBCBBDAAIBdDHAhAGAFDEH.QECAhCAA.cFFCIFAANICB.OEHD.fGGEhAFA.eHBAhBAA..,2,-14,-5,9
FgdLAHaOYTJWbEXUDBMZVcQRINCKGfSeP,HAAAaAAA.TAEA..bACDEAGE.DACAZAEAQCCARCEFCAHB.hAFAGCEBeCHFFECBdEFDACHAhAAAOBBBYEHBXEFDhAGAMIAA...IHHA.fGCAhBAASGGD..hAIA...,1,-4,-11,7
BaDXELAZbSYFOGCJNPMgVHUdfRcKQWeTI,ZAAASAAAOACAGAFACADA..JAFAMAIBHBDCdCCDRCGBQDAAhAAAeDEFBDHDaFBAEDDBACIBhABA..FFFA..gFEAhADAfGHAKGHBIHAADIAA..hABA......hAHA...,2,-21,-9,12
CbRZWXQPeAaHNdFOUGfVYKSgLTDJIBEMc,HAAAdAAAOADAGADA.VAFASAGALDAADBDBBCHA.EDFBhAAAMBEBCEHAZFAAQCFAhACAAACAFFFH.fCBAhAHAKHGA.TFCA.IFFA.hAFA......hAIA...,1,-5,-20,15
gVTbYeNXILcMdJSOaBKDFQCEGfAPHWZRU,HAAARAAAUADATAEA.eAGHXAFALCAAdCGD.OBHDKCCDFDEBhAAAECEB.AEAAZEAE.bEEAhAAAIEGA.MEIBhABAaFHDQGAAGGABfFFEgGEAhACA.....hAGA...,1,30,-27,57
XPHedZFGWQbcfaKUOSMgDNLCETYIJRBVA,HAAAeAAAZADBGADAQAFA..bAFAaBHDOCAB.MCCBhAAADCCBLDFBhAAAECGBTEFAIEEARFABADDBdFDAFFHDhACAfEHA.SDBDNIDB.hADACFCABGHA.PHBAhABA.KHEA,1,10,-6,16
TgAXMfVFcBSeHDaUGQIYERPKNdLOCbJWZ,MAAAFAAABADAHACCDAFAGAFA.QCCCEAHF.RDGFKAHBdBFALCCBhADACEEA.JCHBhBAAZFAAACEA.fGGEhAFA.SBBDeEDHaFEDIGGAhCAAPHAC......hCBA...,1,10,-40,50
SYOLFDHJcdbCZXPKWgTUABGMIRaeQfVNE,GAAARAAAeADE.QADA..fAGBEAFAOAHDLCCAhAAAHCECdDCAZCFBKEEATEBAhABAAAABMDABaCHDSEGHhACADEEBbFGD.CGHAPHBAWHDCBBDANIEB..hAIA......hCAA...,1,11,-13,24
YdNBFXaQURWAMeIODLKGbSPZCHTJcVEgf,eAAADAAAGABB..bADAZAFBHBGBJAHB.ECCA....fCCEhAEAdDEAFEAAaAHFRECAACEAMEGBhAAA.LFAAhABAKDHBCEGD....TFAA...gGGAhAFABEHA...hAEA...,1,-6,-25,19
YFXCAbGDZBgfQdcESOLNPReIHTMUJKWaV,GAAAZAAABADBQADAEAFA.LAGBRBFAHCAAMCEBKCDDaCHDFDFHhABAAAABDDAB..dDHAODFBhACAeFAAUGGAVFBACBFBhADA..fHEFSFHB.IGGAhAIA.....hACA...,1,2,-13,15
fXbIMZJWHOedGKRQCANYSDEcPaTFUVLgB,SAAAEAAA..aACDTADAFAEALAHBBAFB..bAGDZBEEhAAAHCCAeCBBGDAAhAAARDDAAEBBDEHBPEEAUGDA.fEHAhABAXFFD.MGCA.....hBCA......hBEA...,1,3,-15,18
NfVMWcRLAZBYDTbQGeEJFadCUHgKIXSPO,ZAAADAAAQACAEADE.FAEEdAFA.HBGBKAHB.SAHBhABAOBBB.fCAAhACAMCFBRCGBADDABFGDbCCC.eEEDhAHAaECDCEEA.UEGBXGCC.NIDB....hCAA......hCEA...,1,-8,-17,9
LCUYWbSMDGTOfPFVHeBRJaKAgdcIQXZEN,dAAAQAAAEADALAGBCACA.UCCA..bADDMAIBGAFAOBEDhACAFAHFHDGBBDAAREFAaDCChAAAABGB.IFAAZGEA.hADANEFA....SFBHDGIB.fGGEhAFA...hBAA...,2,-19,2,21
OFQbRPgaAMEYGedIHZKUBDJWXCVLSNfTc,EAAAeAAAHACAZADBBAFADAEA..JAGBCAHALCCD..fCCEhAAATCGA.FCEBRDEBaEHDhAAAAAIBGDGA.dEFChCAAKGCA.XGGCSGHHOHAC..hABA......hAHA...,1,-15,-20,5
CPaRdHbBQVWGIDNXLeEZKTScFUgMYJOfA,aAAAHAAABADAQADCGAEA.DAFALAGBEAHFZCAAKBFB.SCHHhAAAFBBHMAIBODABhADAADFBREDBdFFA.VDCB.IEGAhBAAeHFA.TGBA.UGGA..hBGA......hCAA...,2,-7,-2,5
LHRAOfTXZKdaJGBPFSNebVWYCMEUgIDQc,TAAAZAAAaACA..GAEAFACA..eAEHVCGBCAGAUCGA.DCCBLDDBhABAHDCB.AAGAXAGAhCAAdEEABFHASGAAhAAAbFFA.MHFA......hAGA......hAIA...,2,-20,-14,6
XGbeVINCUZDJOALYKHFSaMWcgREfdQPTB,LAAAHAAAaACAMAFA..gADHRBDAEBGE.dAGAQDDBhAAATCAAGCEAeDFHIDHAhBIACCHAZEGBODDHhABAACCBFFHBSGBB.fGDAhACA......hAIA...,2,-11,0,11
RADBNdYELXWbVKcGSFHCfUgTZMeJIaPOQ,BAAAdAAAEADALACA..bABDKAGAGAFAHCCACCFBUECAZCGBeDABhAAAaAHF...QECBhADAADABDDHBXFEBhADAVFEBFGAHTGGA.MDIBIHHAOFBH.hAEA......hAGA...,2,-12,2,14
JUSLfXNEaOFYZIGbgPHVMWcTCdRDBKeQA,SAAALAAAXADDEADA..aAFDFAFAZAGBGCAA..hABAbCCBHCFA.MDDBhACATDAAREEBKEGAAAAAfDHAhADAOFBDIGHAgEDH.PFBDhBFA.cFGCDAIB.hBFAQGEDNIEB,1,0,-5,5
DYMgOPANeJfXBbGTFVZdaIWEcUQHLRKSC,eAAAXAAAGADAFADA.dAFB...aAHDEAGAQCFDHBCBRCEFCBHAMDHBhAAAOCCB.AAAAJEFBhBDAbEFD.ZGBA..IGAAhABA.UGCASGHBDFIB...hAGA......hCAA...,2,-8,-8,0
LXUQeIEAFGDaJPCbZBWgMROTNdfKVYHcS,GAAAaAAA.CADAZAEBBADA.MAFARAGB.OBBBdCDCKDFA.HFFALBFAhADAQGCAECDBABGADDFAhBAA...bDFAWDADhAAA..TECA.fFFAhCAAYHFG.SGHBhCEA...,1,-11,-28,17
JPDKFaEdVcbLgWXYBRTSCHQMAGIZOeNUf,ZAAAeAAAUAEA..fADADAHBFCAA.EAFAdDDA....bBEAhAAALDGB.XDAChABARDDATEGAHFEBhACAAAIBGFABOGBAPFFB.aCCC...hADA......hAIA...,2,-27,2,29
aHUVIJgTYRNdMGeQWDSEXLfOCBcKbAZPF,ZAAAaAAAHACBUAEA...VAEAJAHB...TCGARCAAdDEAGEBAhABA..eBBDQEGAhACASAHBEGDA.LDEBhAEACGGDBHAA.bEFDAHIB.FEHD.....hADA......hAHA...,2,-17,2,19
PJcVKFOaUgZNIAHLGMSXYRTDCeQEbfBWd,HAAAGAAAMACASADARAEADAIB.eAFHECCABCFAdAHAJCDB.KDGAaCGDhAAAZEFA..ADEBLEFAhAHATGDA.QGGAhCAAfEAE.cGGA.FHBC...hCCA......hDAA...,2,-17,-2,15
UPCGEgfeWcKRQBMdOYDNTLSaXbVJZFIHA,CAAAEAAA..eACAKACARAEFMAGB..dAGADAHBLCCB.aBHDbBCAhAAAZEABHCAA.AACAGDGAhAIA..fDGEhAAAQEDAOEDDNIBBXGEAFFFBIGHAhAEA....hAIA...,1,-5,-26,21
bQVeHOgfaJZMSEGABPDUNcCWYKdXIFRLT,DAAAUAAACACA.KADA..dAEAFAFARAGB.LCDA..TCCAQDAAhADAHCFBOBBBhAGA.aDHDZCGB.EECEAAIBBEBAhBAAcFFC..XFDA.IGGAhBEA....hCAA...,2,-30,-28,2
PKNEXeJIBRfWMLVSTbUgGYaCQcHdDAZFO,ZAAAOAAAKADC..EAFAeADA.BAGARBFA.MAIBLCAB.TCDAhABAbBBCGCDB.hACAaEAAQDGAhAIAHEECACGAFFHDXFEAIHEAfHGF.hAEASCCD.hBAA...,2,-12,-12,0
RYSBFTUCIeaJEMVOPbANKcGgHDWLXQdZf,KAAAGAAAHACBLADAdAEBRAGFBCAATBGA.CAHB.eBEH.EDFFMCDBhAAA.OCEBACIB.hAAAgDGAXEGAQGGChACAZFAASFEHFHEG.aGGA...hAIA......hCAA...,2,-15,0,15
FdZMBNAeECKXgJWGUTRODaLIYPbSfHcQV,EAAAXAAA..JACBGADARAEA.aAFALAHB.IDDAhAAAbBFDHDAA.QFBAhAAAdCGCZEAAMEFBAADBeAHHhABAKEHB.gEGATGGAOFDDDFFBSGHHhBFA...hAEA...,2,-18,13,31
cgWObXfaHSNTGBdFRQKCMVIULYJZDEeAP,...PAAAgAAA.OADAXADAHAGBTAGAdBDARCEFQEGAhAAAMCCBUCGBLDDBhAEAZGBAEDCBAAIBcGEAhABAbFEDaEHHGGABBHHA.CGGD.....hAGA......hAIA...,1,11,-1,12
FYDBcebdUXKERfTAGNPZgJWSCHLQVOaMI,GAAAZAAAJADA.CADAHAEBLAGB..QAGAOCAB.aCDHMAIBhABAFDFDBDHA.eDADhAAAdCCDKDEARFGBAFIB.gEFAhACASGAAIFCADHDA...cGCDhCBA....hCFA...,1,-4,-35,31
ANOEVcLSeJUgbPBQIDfaFTCYWGMRXHdZK,EAAALAAA.eADHUADA...bAFAQAFA.fCAAhABAaBCBTCFACAHAGCEAhACARDDBHFGBZGAAACCBOCHDhAFASEHBgGDBBGFC.FGGA..hCAA......hDEA...,1,-5,-9,4
GgBDWCeIMQYdVASKaHUTcNJERLPOXfFbZ,aAAAHAAA.TAEA..JADARAGFLCAAOAGDFBBHGDEABCEADAIBhAGAeCHH.MEAAdDGDADDBhBAAKGAA.cGDCEECB.hBDAfGGAZEEACGGD.......hCAA......hCDA...,2,-33,13,46
QINFGWcJEDHOgATKRXeSadbLCYfVUPMZB,RAAAeAAAdADALAFACADA..VAFAMCCBZCCAQCGAFCHD.hAAAGDDAJECAHFAAAAAATFGAhAGASEGD.hAHAaFHDfGCABGDAIHFAcGFCDIAA.hCAA......hCFA...,2,-13,-13,0
HCJMcAYNELUgGSOKdbITaRfXPZeDVBFWQ,EAAALAAAGACAKAEAdAEB..TBGARAGF..XBEDeCAABAHBhABAQEEAHCEBMDDBhACAACBBNCIA.SDHHhAEA.bGACaFHHZGFAFHEACHED......hAAA......hAIA...,2,-14,4,18
EHbCDVRKLYZaBfGASQXWFcdPMIUegJTON,QAAAFAAAdADA.MADAeAFA..TAGAEBHFHCDC.DCCBRBDALDBBhAAAaDBH.GDDBhAIAAAFAXDGAPEHDhBCAIFFAgGDAOFHBCCHAKGGDZGCA..hBAA......hBDA...,1,10,-17,27
IYTcSeXbOCZKDRVQGUaALWfFBEHJgPMNd,LAAAFAAAHACBJAEAMAEA.dBEA..TCEAeAHFOCAA.hAHAZDDARCGFGEBAABGBBDHAEECBhABAgEEG.hACAIGHASFFA.CGDADFIB...hAIA......hBAA...,1,-16,-21,5
OLXCgRfWPUdYMEJQbFHaKGNZVcDTSABIe,eAAALAAACADA.RADF.....fAFAPAFAdCAAEAHBQCFAhABAHCCAGCFAZEEADBIBhACAAAAAODHD.XECAhAFAgFCBYFFFMEIBFCCHaHCA.KGGDhCFA......hDAA...,1,1,-9,10
fAQDFRYGZBVEKOMeSJdcgUIaTPXHCNWLb,QAAARAAAZADBBAFA.EACAKAHB..eAEAdCCC.UCDA..aCFATBGAhAAAHDAB.CDFBLEHBhAFAAAAAFDFB..GEGAhADAMFFBSGGDJHAA.....hAHA......hCAA...,1,-8,-22,14
AaVEYDOHLNUQWMIdcFBGgRXbTZfSJPKCe,EAAAOAAAHACALAEAQAFCMAIBdAHABBBDRCCA...bBDCZDFBhAAA.SDHHhAEAKCGBAAFA.aEEBDDEBNHEB.IFFAhBAA.FEHD.XGEC...hCAA......hCBA...,1,-7,-24,17
WQbLFBYfMZOHPaDKNEXgdASVcIRJGTeUC,SAAAVAAA.RACFGAEAeADECAGB.QAGALCDABBEDhAAAMDEBHDFBaAHD.KDHBEDGAhCAAdEAAAEEA.IGHAhAAAUFFA.bGAA..........hABA......hAEA...,1,1,-27,28
VAXLcOIUaNRJYDMZFbHfSGdPQKBWTgCEe,LAAAOAAAUAEARADFDAFAZAGBHBFA.GCAAdBBDQDDAhBAABAHA..TDEAEDHFABIB.hBEAXDGDaEGH.NDDA.hABAMFIBFGGA.SGBA....hBGA......hCAA...,1,-6,-22,16
CINBcfLRKJWTOUZYbSeaFDdXEMAQgVHPG,QAAAHAAAGADACACABAEALAFA.RCAAKCFATAGAZDFESFGAhAAAeCDADCIB.EGAAACDAVDFBhAAA..IHCAhACAfEAAOHFAbGAAdGHA...MEEBhAEA.....hADA...,2,-6,-6,0
SaTNJeGRcbPLBWCVYAdgEXUFMKZHDOfQI,EAAAFAAAZACBHACADAFAQAFC.aAHDTBEA..eCCBhAAARBGF.bCECLEBAhAIABDHACEAAAEFAdEGDUFFAMFFBfHABhAEASGBA.......hAHA......hCAA...,1,-3,-29,26
XCgDGEYfFQKeSNIZLUORMHAPBTcabdJWV,TAAAaAAA..dADAJACA..XAFADAFAGBEBEBBB..FCEDeCCBhAAASBHHZDGBLEEBhAIARDFFHFAAABHABFDAhCAAbFGDCDBD.fGHA..NIABOGCEhAFA......hAGA...,2,-14,-5,9
ecYDNSGWVUTCAPgRZHFOEIdBfQLKbMJaX,RAAAHAAAEADE.dADABAFBLAFA.MCABaAGD.eCCBDAIBGCCAhAAAUCFAAAGAZEEAOCFB.QEGAhABAKCHBXGGAhAAANHDB............hACA......hDBA...,2,-22,-11,11
XBJGSTcaAQfEFIPOYDdHVeWLbZKRUCMNg,EAAAFAAAOACDdADAHAFA.eBCDLAEAZCEEREFA.MAIB..XFAAhAAAGCDATCFAhAFAAAHAQGECIEHADCIB.hAFAbFCDCDBDBHGA..SFFB.hBDAaGAA.fHGFhAGA..,2,-6,-4,2
cBRVQJZfTSYUPKbGCNXLIagDOHFWMAEde,EAAAeAAARACA.QADAZAFB..TDAASAFAUEDAKAHBGCCAhAAA.XBGAhABAaCCCOCGDHEFAFFAHACCBdGAAhAGABFCCfFEE.YHDAbFFDCFHA.hAAAIGHA..hAIA...,2,-7,-4,3
aGOMPgLNSCWceXTRUfDVYEbdKFQHAZIBJ,ZAAABAAAGAEAMACALAGBCADB.eBCARAGBDCAA.EDDBdCFCFDGHHDBAhAAA.AAIB..aCHDOEHDhABA..gFFAhBCASFFDXGBATGAA....hBDA......hBGA...,2,-25,-22,3
XZPUgNAGIcCYBKJfFRaebELdWTHDVQMOS,GAAACAAAKACA.FADARAEF.eAFHLAGB..dAHAHCAAQDCAhAAAMAIB.XDGAhACAZDEAUEABACDAIFFAhBAABFFAaEHD.EFHB.TGDAOGCCSHBGhBCA......hBDA...,1,-7,-19,12
AaGETBWeXMKbCSJQIPgUFRYcdLfVZHNDO,EAAATAAABACA..eACEMAEAKAFC.CAHA.QBDA.IBGAhAAAgBDGRDEAdDHAhAIALCGBZFCADCCBABIBGEEAhAAA.WCCDSDDD.UGGAhCAAFGDHfDDEhCAA.NCIAaGHH.,2,-7,-4,3
gdBbFOPQTYSRWMLGHfaCVUNKcAeXZIEDJ,eAAAZAAAEADEDAEA.dAHAFAFA..QBCASAHHRBEBLDHBhAAAHCAAaCEACDEAUEEB.KGBAhABAADHAXEDCJHEA.hBGAbEGB...........hBHA......hCAA...,2,-16,-15,1
ACTMeGDNdJVBXHOYFaKcbWSPLfEIZUQgR,MAAAeAAAGADAdAEABAGAHAFA.FCCHaAHDKCGA....bBBBSDBDhAAA.LEFAhABAECFFZDCBQEEBhAGAAAHATFDADFABJDHBOHECcGGCfGGBhAFAIHDA....hBDA...,2,-18,-7,11
QENVXBeRcFUbdASIHMKDgfPWGYJZOaLTC,HAAAMAAADAEA..fADBGAGAZBBAaAFALBEB.TDBAhAIAEBFFXCAAhAAA.RCGBFDDBdEGDAFFBKEFBgGBAhBAAPFEB........hBCA......hBDA...,1,-7,-22,15
HVXIcRGWKPZeNfYDFCgOJdBLbSTMUEAaQ,HAAAXAAARADFGAFAKADA.eAHB..fAFBFCAHOCCBdAHAhAAALEEASCDAhABAMEIBACDAaCFDQFAChAAAIDAAPFDBZDGBDEEBCGGA.BFFC...hACA......hADA...,1,8,-19,27
dJTRHgGeXFLOENVPZQfcYWMaKSABCbDIU,CAAADAAAdACARABAHAEBGAEAFAGALAGB..ECDB..VEAAZCGBQEAAhAEA.hAAAfDFAcDDCMAIBhAEAaEHDAGGBbEGB.IGFA....hBCA......hBEA...,2,-21,-16,5
YDKAXJFHOQBCgIabUEeWNcZSdPGMRfLVT,FAAAHAAAQADACADB..aAEDEAFAeAGB..NAIA.ZCAAdCCAGCFAhAAARCFBLDABTEDAhACAKEDAAAHAODHDBFGAIHBAhADA...WFHHSGHDhBIA.MICAfHDBhBAA..,1,-10,-13,3
HPSRAVCYGOLUfWDJFaKNXZbgTEcedBQIM,CAAAGAAALACAUADADAGAFAFE..KBFAZCDE...TDGAECCAeBHHhAAAdEEABBHA.MFIBhAAAHDAA.RDFBAADAODBDhACAfEDAaGFD.NEIA.......hBHA......hCAA...,2,-27,-14,13
YaOKeEMDWRUGAJQZCTdcfBPHbFLVgNXIS,ZAAAdAAABADAHAEALAHB..gAEHXCAASCFHhABAaAGD.eDDBhACAECBAMAIBREABAEHAQFFAhADATDDA.fHCBbDFBFDAH..IEHAhACAKFHBDGAB.WFFD.hAEA...,1,2,-25,27
gFYOWGHXAfMcJQRELZIeVaSPbUdDCKNTB,MAAAQAAARACA.EACAZAFB.eAHF..aAEDSBBDhAFAUAGAdDCAKDGATDDAFEEBOEBHhAAAHEGBACEA..fGEAhBAALFGB.........hBEA......hBGA...,1,-11,-20,9
ZHcTRDQYJVPabdGfeOIKNABMSFgLXECWU,MAAAFAAALADA.EAHBCADAZAEB.HAGBRCCAQCFCVBBB.hAIAaDHDGDEB.eECFhBAAKEAAAAEASFFAhBBAXEECUGGADFIB.PHCA....hAIA......hBAA...,1,-10,-13,3
MFAWRdCOKTBbLNYSZQGHacIPfEgeUVXJD,RAAAdAAAKADCBADALAGB..SAEHGCCAHBEDaAGA.IEGAhAAAEBGBUDAA.JDCEMAIBhABA.ACCBOEHDhBGA..bDFA.ZFFAPFFBeGDGDHBACHHD.NICB.hACA......hADA...,1,-3,-19,16
KFfegYEVDCMOBUbAIcPSXdHQWRNGaTLZJ,..IAAASAAAHACARACFGAEALAFBZAGBFAHBeCHHECAACCDAMDEBhAAABCHAAAGB..XEAAhABAdEAAQEEAhACA.aEGETFFAfFCAYFHBOHEAhAEA......hCAA...,2,-6,-3,3
EIeHZFNTWXPYdSKQfVGMgOLCURbJBDcAa,EAAAHAAAZACBTAEA..XAEAdAGAQCABGBGAMCBBhAAALDDARCEBBAHBAAIBeCHFhAAAFECA.PEABKFADfFGEhAFAOECBbFDADEIBaEHDNICB......hACA......hADA...,2,-4,6,10
dDXEMbHSJGWLCePAfRTNKBUIgaYcQFVOZ,RAAATAAABADBUAFA..aACA..QCCAOAEDdAGAECHFHCCBhAAA.GDGALDFBhAAAeDBDAAIBKEHBgFEBhAIAFFBADFEB.bGBASGHD.CHBA..hBDA......hBGA...,2,-25,1,26
TSXcVMOJgafYRFQGCPEADBUNbHZLIWKed,BAAAUAAAHADAZACALAFBKAGCdCDD...TCCAXBGA.MDABhADAOAHB.aCHDRDEAQFGAhAFAGDAAEEEAAADAhAAADGFB.IHDAeFGBSFHB.hBAA......hBCA...,1,-11,-16,5
BVFDMNHSYebXcdJgCKLWQfUIaEZTGRPOA,FAAAMAAAHACB.eAEAXACAdBHA.CAFALAHBQCEAUCDBhAFAEEAAGEGARDFF.AAEADEEBhAIASBBD.hBAAbFGDgGDAKGCA..WHBG.aEEHhBAA......hBHA...,1,-2,-20,18
EGWDXVAUTcdRYLFPgIfBHbZJNCOSKQaeM,TAAARAAALADB.FAFA..IADAHCEBZCGBCAFAKAHBeCCDECABGGCBhAAA.DDIBACCAdCEAhAAA.PCGBBFBA.bFAAhACA.....OEHDaGGAMIAAWFFD.hABA......hAIA...,2,-14,-8,6
ZcAdEfUWNVTHXBIGFRMJOSbKPaQeCgYDL,EAAAUAAA...VADAHACA.BAFBGAGARAGFMCCBOCBEKDDAaCHDhAAAeDAB...CDEADDGBhADAZDFFAEAAdFFD..fFCAhAEANDIA.IHFASGAA..hAGA......hAIA...,1,-19,-22,3
RWVgcIeYQNHfTUZFdMLKSBJaAPbXGECDO,XAAAEAAADADA.RADA...VAFA..gAGBeBCB.QCDBhAAAHCEATEBAhAAAZDAAdDGAMCIBLEFDhABABBDBAEEBGEGAOEHDIGCAfGEA.hADA......hAEA...,2,-10,-5,5
JgXIdKENVOMbYBeFGZPDcHUWSTRAfCaQL,aAAALAAA.XADDdADAEAFA..OAHDMAFABBFBGCDBZBGBhABADBBBHCAAUEEBTEDAhACAACCBQFAAJEHBKDEC.hCAA..bFGDFGFB..cGCA...hCCA......hCIA...,1,-8,-9,1
cAPTHMGVJZYXWgQCEdbUOISKeaBNFRLDf,HAAAGAAAZADB.XAFAQADA.EAFAdCADOAHDKCFAeCHHhAAAaCDCFCGHREEBLFCBhACA.DFIBAAABMDAB.hADAVEEB.JEHBgGAACHBA.IHGAhAGA.SGEDhAIA.,2,-9,-5,4
YfCIHaSBTKJZcGEbNDUOedAgQWPRVFXML,QAAARAAAFADALAGBCACAHADBBBFA..TAFAZCCAGECA.hAAAEEEBbCFA.DDDBeCHHhAAAAAHA..gEEAhAFAVGFA.MEHB.fHCB.aGGHhBIA......hCAA...,1,-12,-13,1
WYLVMPKcNICbXdTAJSZfQgDRUGHEFOBea,ZAAAQAAARAEAHCAAEBHFBACA.eADH.aAFALDEB.MACAhABAKBFAIDEAhAAAXDGAAAHAfCHAhAIADECAFFHHOGCCVEFBcFBA.CHHA....hCAA......hCCA...,1,-10,-13,3
GSQTcLYaHCUIZKFANDVdOJeWXgRBPEfMb,DAAAdAAAeADA..XABARAGBECBA.MAEAGCEA.QEAAhACATBEALBGBhAIAHECDCEGAIGGAZDDFABIBOCCHhBAAWFHHBEHA.bFFDSGDHaEBHFGDH.hBEA......hCAA...,2,-16,5,21
KFIaHCUDLPZWJGNEOXgebBTYQSfAMVcdR,MAAAdAAARADAFAGAHACC.DAFAZABBGBFA.EAHFXCEA..hAEAeBBBBCHATDDAhBAAQDCDACIBKEHBaFCBLEHBhBAAPFFBJFCB.OFEC...YHFAhCDAfHGF.hCFA...,1,1,-21,22
GPIaMJCQWBTRgVSEKFcfALYZDdHeUONbX,ZAAAHAAAeACEOACA..XAFBGAFAaAHFMAIBQCCAhAAABCCDRCEB.SDFDhBFAEDGEFECAABHBLFGBhABAdDHAUGGAPHBA.CHEA.......hBHA......hCAA...,2,-16,3,19
QDLbOEUScJaeRXAIFGZCfMgVdPNBTHYKW,GAAAZAAAMACAdADABAFAHAFA.KCEAQBGALCHBEDDBUCCBSDBHhAAAaCFH.RFEAAAHAhACACEBDVEGB.TGDAhABADFABOHDC..eHAEFGHD....hAHA......hAIA...,1,4,-17,21
JIcADBETQVXUMgZCfLKSedYORPHGNWaFb,EAAATAAA..QACAUACAZAEBLAHBeAEAdBHARCDAHCFBGEFAhAAAaDDHFEBBJFAAACCBBEHAhAAAMEIBCFFD..KGBAOFEHhAFA....WHBAIHCADGHB..hAIA......hCAA...,1,-8,-9,1
gEeUGSYCaNRIfWOHdFZBVLcTbXPKQDMJA,EAAAeAAAGACACADA.RAEA...IAFAOAHDHCECZAGBLCCAhAAAbEAB.KDHBMEEBABIBSECAhABAaFFA.fEGEhCAAdGGDBCBD.TFEA.QGCChCBADFAB....hCDA...,1,3,-21,24
XHeEdRSWJCMKgPYBVAOabFUcDNZGIfQLT,aAAAFAAADADAGACA..QAFALAEAHCEAEBCA.REEASAHHhAFACAHAKCDA.gGAAhAGABCHAADGBOEEBhBAAcGCDZFCF..TGGAeFGB.WBBDMFIB.hBAA......hCAA...,1,-4,-26,22
VgZUYeWdRHOMTNaIFbLSXfBDKcAGQJCEP,GAAAQAAAEADA...VACAZAFBeAHFRAFFHCGBMCDB.aCEBbDDBhAAALEFA.fFBAhAAAKFAAAAHACFFAPFHDhAFAgGEA........hACA......hADA...,2,-11,-7,4
PEMQgDAGKUXeLBaYRcOSVfTNWbdHJIZCF,GAAAXAAAeADALADAaAGD..RCDAOBHDSAGH.TCDAhAAAbEAA.HDFAZEFAFGBBhAAAEDCBMAIBQGEAhACAAAEABFCD.cFFCfGHEdHDB...hABA......hCAA...,1,8,-7,15
WZVfBHcSNMLFRXTPgdDOCIYAEKQbGUJea,EAAAQAAAGACAeAEAZACBBAEAHBFCSAFHMCBBRDFB..TEDAhAAAdAHACCEDADGAKDHBUEEAhAAAaEAH....fGHAhAEALEHBFHBA.......hAFA......hAIA...,1,1,-23,24
WBVZOGUPfaACDJMLHXQbdYgRNFEeKcIST,DAAAMAAAHABC.QAECdAEARAGBEBBAKCDDSAGB.TCFAhAIABCFAZDFE.GEBAhAGAfCCEAAIBLFGBhBAAbEDD.NEEA.eCHH.IFFA..hBAA......hBIA...,2,-17,-15,2
DAdHgIQRPJSeLOXKfETYcGZbaMVCUWFBN,HAAAQAAARADF.SACAeAFELCFAKAFA.ECAB.TEEAhAAAGCDAZEGBaAHDMCCBhACACCFAFDAADDDBADHAdEHA.gFAAhAAAIGBAOHCCfFFA.bFCDhADAWFHHBHFA...hADA...,2,-4,1,5
NWAeSBRQKVDPXOHLEUTCfYbMIagGZdJcF,eAAARAAAQADCDAEA..OAFEHAFBEAHBCBCA....bBDDaCCChAAA.ZDEEdCFBFEHDAAAAKDGDhAIAXFAALFFATGFAhABAMHFA..gFDA...hCAA......hCBA...,2,-32,6,38
YKfRWaeNISFHVPTdEGOLAUcJBbCDMXZQg,UAAABAAADACAZADA..QCDAKAEARAGF..eBCBSAFEhAEAHCEB..TEGAEBHFGDFAhAIAACEB.bFDDMDBBhAAA.XGAAfDCEaGDAFGGHPFHD.hAGA......hAIA...,1,-1,-23,22
OVFHTRPUBQaIDACNfJZgSLeYXEGKbWcMd,CAAAJAAAZACALADB..eAEEEAFAGBGAKBHB....bCCBhAAAMCCBdDAA.FDEDHCEChADARFABBFCAaEEB.AAIB.fEHAhAHASEGDXFFDOFHD....hAIA......hCAA...,2,-21,-18,3
cUPGWadDAFNQKZMRgfXbTOCYLHeEVISBJ,QAAAZAAARAEA..XBGATACACAEBHCAA.ECEBSAFHhAAABDGAUEABGBGAhAHAdFFAAACAKEHBMCEB.bDEDLHAAhABAeEHH.IHHA....hAEA......hAFA...,1,-6,-10,4
dXQZFIcLPVWbKCgONBJMGSDRYaeHAfEUT,EAAAdAAAZABBFACD.LAEA..PAEAVCEA.KAHB..OAHDhAFABBEDGCEBRDBA.hAGAeDDBHEFCAEHATFFAhAAAQGGB..IHCA.WFHBhCAA......hCBA...,2,-30,-11,19
EGDFfHJWAZKYUOMPgeISLVcNBbCdXTRQa,ZAAAKAAAOACAMACA..eAEALAGB..VBGBBBCAdCCDRBEFEDDBhAAAGCEAFDHDHFFAhAIAAAIBUGGA....gGBAhBGASEGAcGEC...CECD.hBIA......hCAA...,2,-18,-18,0
bLKRdQZCOJWSGgVHEUIfFAcMYXDaPBNTe,MAAADAAABACA..eACALAEARAFAZBBAOCEDSAHH.GCCAhAFAHCGBEFGBUEFAFGAAhAGAABBB.XGDA.hAGAaDDHTGDA.KCFA.CGHA....WFCDhBAA.....hAIA...,1,-11,-27,16
AdDeGaQFVZSCRgcIOEXPBfHLNJTUMWbYK,eAAAaAAA.QADAZACBRAEA...gAGAOAHDECEBBCCAhAAAHDFBLDEAJFAAMBBBhAFAbEFA.AAGAGFBBhABAFFHDCDHD.XGGC..fHABhAHA.NEEA.....hBAA...,1,4,-15,19
HLUDAXEacZMTGNIJeWVPdORYCBKbfFSgQ,EAAAZAAAGAEA.JAHBeACA.VAFAdCAARDDBBCCA.KCEAFDGHQDAChAAAHEACLGAAhABAACIBaDFE.MDIB.TGGAhACAIFFA.OECDCADB.SEHHhADA.DEEB.NIABPHFAhAIA,1,-5,-10,5
AVFLcZYdTQPMgSbJORfKDUeBGNECIaHXW,LAAAZAAAdAEAQAGAMAEA..bAFARCAADCGB.BDEAEBDFaCAAhABAHDGB.AACA.FCEDTEBAhABASCGB.fEFAhACAeFFBCGAAIHHAXGDC.cEGDhDAA.....hAGA...,1,-9,-18,9
gZAbFDWEHYXCBSMKLOTJcRQGeUadPVNIf,DAAAHAAACACA.MACALAEAOAEE..JBBFRCCAeAHH.dCFAVCFAhAFA..fDHAhAAAAAIBFDDB.EEEBBEFDTGFAhAHAGFCB.aFHB.....IGAAhAGA....hBAA...,2,-38,-2,36
MQaFEGBYRdcgUPfCHJTNOVWSbeZIKDLAX,MAAAaAAAGACARACA.dAEBUAFA..CAHAHBEBTCDAOBBH.hAIASCGBeBBBZDFBDBIBhBAAACIBQEEBhAHAEEHBBFEC.gGGAfGHE.NHBB....hBAA......hCAA...,2,-12,-12,0
WCSDGARPHcaXFKbgLJYNZQTfMEUBOIVde,HAAAaAAA.KADCLADAJAFB.ZAGBQCABMBBBBCCAOAHBhAAAdCEAeCHHSCEDhACAGEABRFFBXDCDFGCD.hAEAbEGB...gGDA...hAFA......hBAA...,1,-5,-10,5
YIGeVKHEOJUfbNDAFTgXLRWBMCaQPSdZc,TAAALAAA.RADFMAFAaACA...QBFAdAFAZAGB..ICCAhAAAeCABHDDCECEBOCHDhBDAfDHAbEECAFBAhBFAXFGABGEASGGAcGFC..YHCAhABA.KCCDNIBB.hBIA...,2,-18,5,23
cTMXAdYgeLKBHbPJVEUCfQSZDWRGFaION,dAAAeAAALADAHADAJAHBEAHB..CCCA.QCBAZCEBREGB.aCFAOEDHhAAA..TDFAhACAAAFAKGEABHAAVEABSDDBhAEADDIB.GFDB.FGHD.NIAB.hAFA......hAIA...,1,1,-26,27
gARKeLPVaEIMNGSBWOZbdHXUYFDcTCQJf,RAAAeAAALADB..aADDEAFAMAFAGBGABBFAZCEBHBGBUFAADCCBhAAACCCC.QDDAhABA.fEGEhBDAAAAAKFGDIGEASFBA.OFHD..hBFA......hBIA...,2,-22,-16,6
VRPfTcUNWAXFMbZCEgGaLSeIBHdDYOJQK,MAAAZAAAEADEGACBLAFBeAFEHCAA.dAHAOBBBQDGAhABARCDATDGAUECA.AEFBbGFAhACAaCGABDCD.DEFBKHBAhBHAfFHA.NIABFGFDCFGD....hAIA......hBAA...,2,-9,8,17
EgWHSUdABJGTCbXQRIFaKcMPDLZeONVYf,GAAATAAA.CADA.QACCRAEF.aAEAMAHB.LDCBhAAAeAGHOBEDVEEAEFHFHDGBhAAAdGAAAAIBbECB.FFFHKGDAhACADCIBNICB...........hADA......hAGA...,2,-13,2,15
gZJcEUMTDNQHXVfWPaYISbRLCdBKGOeAF,ZAAAEAAAUADAMACADAGAHAFA....XBDDfCBA.aCFEhAAASBFALDDBdEHAhAHAGDEBABCAFFFBgFBAhABAJHFE.TFGANIAB...WFFDhBFA.IHDA.hAIA...,2,-21,-8,13
SMJOEXGNafKbWTRUAeLgIcYHCBFVPDQZd,eAAALAAA..IAEAHADBFAFADAGAdCAA.MAIBEBCFGBEBhAAAaCCHKCFA...bDDBREEAAEEAhABA....gDFAhABACEHBBFBAQGGAZFGBOHBAfHCBhACA....hBFA...,1,-8,-13,5
LPOUdYJWaAgbCRSEHVKQFceBTXDZIMfGN,CAAAEAAAHACAKACA.FAFABAEB..DAIBZAFBMCABGCCA.LBHBhAAAOCCBdCGAJEFBACCBRDEB..hAIAQFCAeFCD.hCAATGGAfGHA......hCBA......hCEA...,1,-20,-22,2
LSegGTcKURFAOVHdDXIZMBbNPCEQfWJYa,HAAAdAAADADAZADBBAFA..bAFACAHA...ECABQBDC.hAAA.fCFAhACAJCBBLCGBeCCDGEEAhACATDGAKGDDRFCAAAGA.XFFDMCIB.WHCGaGHBSHAAhAHA.hADA...,1,-6,-24,18
QBNCXYPdRDFUTOgcMISHGaZVLbWKAJfeE,eAAAEAAABACACADA....XAEDdAEARAGBFCCBOAGF.MAIBhAAAHCFBZCCAbEBA.AAIB.QEEBhABA.PEHBhAGATFGA.gGAASGDBaFFH.hCAA......hCBA...,2,-21,-17,4
OfMIHBUgNFTYeWSDEVAQbRLGPaJcXdCZK,RAAAGAAA.aADAXADBZAFB.KAFAMAIBHCCABCDAUCFAFDCHeDHHhAAADBHB..AAABLEEAhACAPEEB.dGEAfGFAhABA.IHAATGGA....hAHA......hAIA...,2,-22,-19,3
CKDdIFZOAWSRfeQVLbPBNYUEaHGgTcMJX,RAAAeAAALADBBADAUAFAHAFAGCEA.TCGAMAIBCCCAdCCCZCEAhAAAAAAA...SEEAhABAQFAA.bGFAPEHDhBFAEEHFaHAC..cGGC...KHBAhBHA......hCAA...,1,14,-31,45
HdVPKTRDeaEWFQYANZgBUSJIGfMLCXcOb,ZAAABAAASACEGACAMAEALAFA.CCCD.OAHDHCEAdCHAhABAKBECRCABeECBECFFQDGDhAAAAAGAUEEBJFHB.XEDDhACA...cFFD...PHBAhBCAaGCH....hBHA...,1,-7,-17,10
VRUGEcedACWODBMSHgNXPZYaTILbFQJfK,OAAAMAAAHACC..XADAZAFBaAHDLCCBQAGAKDGARCCAECGBhAEAeBBD.AEEADFABSBBGhAGA.gEEAhBAAPFFAIHBAFEHDfGGE.hAFA......hBAA...,1,-7,-17,10
PONIQEAWZUYdaFBTgMVXeGCJDRcKLbHSf,ZAAAdAAAaADABADB.MAFAeAFH.GBGADBFA.RCAALECAHCAASBGAhABAOEGHIHAAhACAACEAUDEA..TDGAhACA...XFGACHHA....hCAA......hCCA...,2,-31,-14,17
ZLIMBWTSGHKfDYbRNUJCQgFEdcaVeOXPA,ZAAAMAAABADB..TADAHAEBDAGA.RBGFUCAAQAFC.hABAEBBBaDDBeAHH.XDCAhAHAADIBLEEBSDFBhBAAKEGD.bEGDCGBAdGHAOFED...hACA......hBGA...,2,-21,-4,17
dFDULZOQKJEfNeGPTRAXMgaSHCcVIYBWb,MAAAaAAAHACB.CAEA.IAEABAGA.dAGADAIBZBBAKCEA..ECFBeBBDhAEAGDBARCGF.AAIBSDDGhBAAVEEB.bDGDhBCALGAA.OEHDfGFE.hAGA......hBAA...,1,-12,-17,5
NDVSZXYMIAbdRKPacJBHLQCWTeOgUfEFG,RAAAaAAABADBHACBLAFAQAEA.CAGA.eCCAUDEAECFA.GDGAhAAADAIBZDGBMEEBABBBdEAAKFFDhABAJHCAOGAA.FHAChAGASFHH.......hAHA......hCAA...,1,-12,-14,2
eLSXdaBIKCOHURTGMQEgNcfbVDZWAPJYF,JAAAeAAALADBdAEABAGA.KBCBHAFA.RCEFGCGAEBHF...hAAANCCA.bCFDZFAF.AAHAFGFBhAFAaDEBODHF.MEBBhABA.QGGC.....hBAA......hCAA...,2,-16,-16,0
bJVDEILKQCFTNOGgcUSRAdYHBZPeXMfWa,HAAAZAAAeACEMACA.aAEEVAGB..EAHBLCCAQCCATDFAhABAGCEB.gEFAhAAASDHHAEIBdFCAhAIABECAfGHAbFACDEEBCFFDFGHBOFEH..hCAA......hCCA...,1,4,-6,10
MeHRLYAbGBQSFdDTVNOZCaKfUJPgIcEXW,GAAAQAAAdADADAFA..TACAOAHDaAEAKBFBUBFB.JCDBhAAAIDDA.EDFBhAAAMAIBHDBBREFAADGBbDGDFFEHhAHA.NIEB...fHBB...hCAA......hDAA...,2,-14,-13,1
CUGdPNLKXeAYJHbTSIQVFMcDgWfOaREBZ,HAAATAAAQADC.MAFADACAfAEARBFAECABZCCAGDGAhAAAdAGALCCAeEEBADIBbGBAhACASBHH.hBGAFDBH.gDEAaGGH.CEGAPFHDhAAA.XGBA.hBIA...,1,16,-9,25
NCEQGfDBWXHgadTUcISKAFYPLRbJMVZOe,FAAALAAARACF.MAEAZAEBeAGF..EAHFGCGABBDAHBEBhABAdEAAUECASCAAhACAAAIB.bDGDOEFB.hBGAQGGBDCIBXEEC.aGCB.TGEAhCAA.IHHAhCBA...,2,-15,-14,1
KcYZBOREWTeaHAdbIFgfGLJQPCDUNMXSV,dAAAFAAAGACALADAQAEADAHBUCCA.MAHB..SBHHhACAKDFAZEAARFDF.ECFBeFFEhAEAHEAAAAIB...bEFAfGBAhBAACFED.XGGCcGCABGGAhAEA......hAFA...,2,-21,-2,19
PUSCFVKcdAGbINaRBEMZYTDQXeHOLWfgJ,GAAA..bAAAaADAEAEAZAFB.DAIBeAGFHCDBLCAB.hAAAfBHAgDGAhACAPCCBCDCCKFCAABHBREDAMDIBhAAATGGAQGEA..OFFBhBAA......hBCA...,2,-13,3,16
SRCAHUZGJLMXObdgcEFWQNKYBPIVeaTfD,HAAAGAAAMACAOADAdAGAEBDAQAGA.KCDABCCD.IDEAhAAAeCFGaDBDTDGAhAIASEEAABIBZFCALFFBhBGAbEGD.........hAAA......hACA...,1,-9,-20,11
ZBOCPDMYaHNcFVGARgQLfJbWIUeESTXdK,RAAALAAA.JAEAbADB..UCAAEAFA..SAHHdAHAZCDACDHA.hABAMCCBHEBCFCGHAEEA.QDDBhAAA.fEHAhABAeFFAKGCDOHDCDFFBaFCDNIDB...hACA......hBEA...,1,-3,-20,17
ZHQJdfcWgAOTbGPIYKUeNXMCFRDSLBaVE,TAAAGAAA..IADAKACCUAFA..eAEHMAIBRAGBLDCAhAAABBDAECCB.HDFB.dEHAhACAfDFAgGAAhAGAADHBOEDD.bFBBNIDBCHHBSFGAhAAA.ZGFA....hBFA...,2,-21,9,30
gKRVYJMPHGdZaLeIEDBCOXWQTbcNFUASf,SAAAKAAARACF..VAFAMADA.HAFCZCAFLCEBEBCABCDAXCEDhAAAQDGAbDGBhABAFFAH.AAEA...fFFAhAIAJFGFdEDCaGDEDEIB.CGCA.....hCAA......hCBA...,2,-17,-13,4
CVLHBKAZePcDFUTESafJYWXbgIMQdNOGR,eAAADAAAFACDEADA...aAFDJAEA..XBGD..bBDDMCCBhAAA.dDDAGCGAhAHAREGBLHAAHFCAAAIBZFBAUGGBhBAAfFFE..YBBF.hABAICFANIEB..hCAA...,1,5,-33,38
KdIaUEABOFVbGMfNTSWeZXcDLCPJgHQYR,FAAAGAAAMADA..TADAeAFAZBCBDAFALBGB.CCDD.gBGAhBAAHDEBRFCBdFHAaCFHhCAAAAABODAH..hACAbCDDSGGDXEGAPHEA..hCBA......hCCA...,2,-21,-4,17
UeNBVZgfWTbJcRYaXdMLKSEGDQAIOFHPC,FAAAHAAACADA.eACEBAFAZAFB.....fAHATBGA.bCCBhAAARCCA..aDABdDHAMDGBhADALEEB.EFAAGFABhAFAAEGAIGGAODHDNICBgFCAhAFAJHEA..YHAAhAHA.SEEB.,2,-17,15,32
VILEBGcbegDNAfdCOJKFPQXZTMaWHYRSU,dAAAOAAAFADA..QAGAZADBaAFD.HCACRBGFUEEALCFB.hAHAEDEFGDBA.eDHHhAIADDHBADIBCBBDKGHBTGAAhACAMIBASECH.BFHA.gGGGhAGA...hBAA...,1,-4,-18,14
ERGMaDVYTFABLKgCfUdHQPZWSNIXcObeJ,LAAACAAAdACAHAEAZADB.SAFA..XBGAOAHDeCAAhABARCDBaCBHDAGA.TDGAhAAAACAAKCFAfEEAhACA.QFGAPEABIFFAhAEAbFCDEGAA.MFDBFGFH.BFHAhBCA...,1,5,-23,28
SRDIYdfLNZTMCHeBKgbGVOEQJcPWXUAFa,aAAARAAADADA..dADALAGBZAEB..MAHBHBDAeBBBKCCDGDEAhAAAEDDB.QEGChABAJDFB..PDHDhAIAXFBAABGBSDBDfGHATGGA.hAIA......hBFA...,1,-14,-17,3
IWACHZOJeNgcSKPRMbaQXLGBdYETVfUFD,HAAAZAAAeACE..gADBKAFCRBFA.aAFALDDBGBFAdCADhAAAEDFB.TDCAUFFBDCCBhABAAAIBOCHD.cEDDhACAMDIB...bFGDBECAfHCBFHDC.hAIA......hBIA...,1,15,-20,35
MeNKWUEFDHTVPcQSJAgYGaCXZRfIdLBbO,GAAAaAAAZACB.RADAdAGALAFABCDD..MAIBeBEB.KBBDUDFAECGAHEDAhAGA..TFCAhAAAPDHDQEABhACA.AADACEECfGCAOEHDFGGHDGGB.SGEHhAHA..hBAA...,1,-7,-15,8
PQBLfVNHIdJGXODMEcWZUKgYeRFAbCaTS,aAAATAAA..QADALACBVAEAHAFAdCCAGCGADBBBECGAhADAZDEBKEAAeDFBAAHASECBhAAAfDHAIGHAhAHAOFHDMIBA..WEDH...YFFFhAIAFGFD...hAEA...,1,-2,-5,3
SdINHQVREWDMPGafKTgOAZeXbJUFcYLBC,eAAAXAAAUAEAFADALAHB.CBCA.dAGAHDDARBCFECEF.MAIBhAAAaEBBKEGA..TDFAhABAAAAAZFDA..JHBABEHAhBGASHGAQGGA.DFFB.fHDBhCAA....hCBA...,1,-15,-18,3
QNGFBRTPCLaOSJWbHUDceEKgXVfMYZdIA,GAAARAAACADB.aADAOAED..SAFH.JAHBHAGBhAAADCDBECEBXCCC.hAAAMDGBdDGDAEEBQGAAhABABEBATFFALEEBWFHB.bEGDeHAA.hAGA......hAIA...,1,-12,-19,7
FJKBREbgLXQDYcPZIUWVafCMSGNTeHAdO,dAAAFAAABADAEADALAGBDAFA.....PBEDZAFEICCAhADAVCBB...aCECMAIBhACAGCGAeDADHEEBhBAAAEEBKEGA.RGBAXFFCQGCC....hCAA......hCBA...,1,0,-29,29
ALKfaJCdXNBIYeTGFbPWSEVQZcRgHMDUO,LAAAaAAA.dAEABADAeAGBGAEAFCAA...bAGBSAHBhABAEBBBZDAA.RCFBHDCAhACAMBIBODGBADIBKEBDCFFDIFHAhBEATGBA..PEEB...WFHBhADA.....hCDA...,2,-16,-5,11
cBeJgHMdfRDaYEXGCVLUSANZQTbOFKIPW,ZAAATAAAFADAKAGA....IADA..PCABBAFAeAGHhAAAHCCCdCFARCAAaBHDECHBhABAGCEALFFAACEBbEGDhACAOGAAJFAA.MHEADEIB.CEGA.....hACA......hAGA...,2,-17,-5,12
YfaUPZOARCBbHLFVJEMQGTdSDgKWecIXN,RAAABAAAHADBLACAFAFA.EAGAGCFA.dDAADBIBKBHBeCCAXFBAhAAA..fCFAhAAAaCCHZFDB.AADAbCGDhAGAMFHBQGEA.SGHBhCAA......hCBA...,1,-7,-30,23
cDXYQeOSgEGaPAHCNFBRfbLMZJdITUWVK,HAAAFAAARACFLAEBZADBdAGAUCAB.KCFDXAGA..eBHHhAAASCFHEEEBGGBBhACAAAGABCHDMEGB.IFBAhADATECAVEGB.DFFBOHFE..hAIA......hBFA...,1,-3,-24,21
YAJLNZRdDXEabPOgcIWCHQGBMKFTeVSUf,LAAARAAAdADADAFA.EAEA...aAGDOAHD..ICAAhABAHBEBGDGAMAIBTCCAhACAeCCBSEEDhAAAUDFAACEAZEAAbGBCPFEB.gGBBcGED.hABAQGGA.hBGA...,1,8,-16,24
KYIdFNPcSgfVJbeBEAWGXUCTHZLMOaDRQ,GAAACAAAHACAZAFBMADADAIBRAFA..KCDAdCAAFCGD......PCCBhAAASDBH.hACAfEEAbBGDBEDAAFAAhAEAXFCDLFFAaFGAIHFAgGGBhAAA......hACA...,2,-26,-18,8
CRGPWLOfAXDHYJeEIBbSTNMadUFKQgVcZ,HAAAeAAAEADABADB.TAFAaAFD..dAHAKBHBQCCA.hAAAVDFAZCAARCEBGFBBhAAALDGBAFBADFIBIFAAhACASGGBMECBFHBCCGFDOHAC...hABA......hBFA...,2,-9,-4,5
HgIOdESeLRWVYAGfMcKDUPZBCaFQJXbNT,GAAAMAAADAEAZADABAGAaAFA...FBBAQCDA.XCFAhAAAbBDDHCFA.OEFEhAIAEDCBeDHHRFBA.VGEAhACAABFBKGGACEAD...NIBB........hAEA......hAIA...,1,-8,-24,16
TJEKMAPaRWOVUQIDfdXLYZGNecgFBCHSb,RAAAOAAAQADCDAEA.dAFALAHBGBGAeCCBFBBHHBEA.TDCAhBAAEEEAAAAA..aAHFUEFAhBDAXFGAZGBA.gGFGhCAASFHB.......hDAA......hDBA...,1,-7,-13,6
bXEHLcZROWNDYSFVCTdKBUPMeAaQJfGgI,aAAAQAAAGACA...IADAEAEAHAGBZAEBRCEBOBBHDAHBFCGHCCDChAAAdEAD.BDHAUFEAeEEDhAEAAAIB.JGBA.fGGAhAIAXGBAcEGDNIBB.....hBAA......hBGA...,1,5,-26,31
KfSRJWgOHPCNbFBMGZTLcQYEAVUIedaDX,UAAAeAAAdAEADADA.KAGARAEA.....JBCBOAHDHCFA..CDEDFEBHhAAAGCBB.ZDFBTEGAhABALECA.QGCAhAHAACHAaFFH.SEHBgGAGPHFAhBAABHHA.....hAGA...,1,-15,-25,10
UEcKPaZWJQgOYXDRdBTAHfFCNSGIMeVbL,HAAACAAAGACAeACELAEAEAFEKBHB.ZBFEQCCA.OCEChAAADCABRDFAdFAAAAHA.FCBHSEFAhCAAMEEBUFFBaEHDhCCA.gFEG.BGCANIAB.IHHAhCGA....hDAA...,1,-8,-16,8
QUJVXGEgbBfMHZaCdORIKcANSLTWFDPeY,LAAATAAA.DAEAeACEQAGAUAFA..XCCAEBDABCAAhABAHDEBaCCC.dBHARCEFKDGAhACAABDBSDGGFFGA.hBIAPFHBVGCAgGGGMIAA...hAAA......hAIA...,1,-4,-12,8
GJYZXVWEPCOdUHcIMbDTfQAFRaLeBNSKg,RAAAeAAABADBKADAGAEAZAFB....XCCAEAGAOBHDHCGBMCCBhAAATFAA.AAAAaEFHhAFALDDB.SDFHhABAgFCBVFGBCAHAdGHAIGAADICA.hCAAFHCA.....hCBA...,1,-6,-10,4
MPKIRBACDNGbFLEVcaSZgYfTJHWUQeXOd,DAAAGAAALADAEADA..aAFDZAGB...fBBAHBGBQCDChAAAeCDAdEAAMDABhACAKDCDREEAAAHAbEFAFFHDSCHHhAEATFBAUGEA........hADA......hBAA...,2,-17,2,19
SaYcPKTZNADJbFEVQGgORMXfIHBdeUWLC,DAAAFAAAEADAGABB.RAFF.MAGB..XCCAHCCAeAHBLAHBhAEAaCGD...PDFBhAFAZDAFACEAbEECQGGAhBAAfFHAdHCBCHFDSGGD...hCAA......hCBA...,2,-14,-6,8
KFCRgXTbVDcIJeNdAWQUPEaZBLGMSfHYO,QAAAEAAAZACBGAEAMADAHAGD.KDGDRAFATBDADCBB.JCGBeDEDhAAA.ACIBUGAAaDBALEEBhAAASEBAODHDhAIACEHA.XGGC..cGGAIFDAhBCA.....hAGA...,1,0,-12,12
IbJFYVOABdWGCNXPHRTgfZMLSeKQaEDUc,dAAAGAAACADA...XADAHAEBRAGB.TAGAZABBMDDB.eDHFhAGAaCDBECFF..DEEAIDHAhAAAFFFB.ODAHhACAAAIBBGDAPEDD.LFFAKGHB.QGAAhADA..hAEA...,2,-23,-7,16
XSQfWcYITKAOERZJgHMaFeVPUGNDCLbdB,RAAAZAAAHADBaACA.eAFAUAFAGCFA.CBHAdDAASBHB.QCCBhABAfCCE.hAIA..cFADTDFAhBFAAAAAEEEBMEEBFEHDPFFBLHDABHDD..hCAA......hCBA...,1,10,-23,33
CTDPaBXeLUfIHJMbRGOcVNWAgESQFKdZY,EAAAQAAAdADAZAEB.CACA.DAHBBAEA.eAFHLBCD.UCGBhAAAHBGBMEEBRCDBGEAAhAAAOFFAcEGC.NICB.hAEAAAIBFGBAKDCD...PHECaAHFfFFEhCAA.IHHAhCDA...,2,-20,-5,15
gWILOXTFeURYadPNBfCKVGbcEHDQMASJZ,ZAAA..gAAALADBTAFAeADARAGBdCCABAHBKCFBGCAAhABAEDAAHECCMCFB.ACABSCGAhACAIEHAFFGHaEEHhAFANIAB.CEHA....bGEADGIB....WHCGhCCA.....hAAA...,1,-2,-9,7
WZJQbXOCFPKUfgGDLSAMYacRIBTHdVEeN,aAAARAAABADBHACBdAFAEAEA..eAHBZAGBQCEA.OBBHhAEAFCCAKCGBUFFAGDEAhAAALGBAAEIBMFBB..hABA.IGGANBIA.....WHFAhAIA......hBFA...,1,-1,-34,33
TSFMRIEPWJUeAZNcLCOYdbfgKVBGXDQaH,ZAAALAAAOACAdAEA.....bAFDKAFAGCAAQCCBhABAHCCDTEEAMAIBECFAPAHDhABAUEEAADHB.CEHA.fEGBhACABFCADGHBaHAAFGGAIHAA.hAHA......hCAA...,2,-26,10,36
HTPVEQSGfcgaXFJYWORBdKZCMUNbeIDAL,HAAATAAAEADE.GAFA..fACBaAHFFCAH.JAEAOCCBhAAARCCAdAHAZCFFMDEBbEEDeDFDhACA.ADHALEHBhAFAQGGCSECH.....hAAA......hCAA...,1,9,-15,24
NISbcdQCEVTJOLFPWKgaDBeRAfHGMYXUZ,HAAAGAAAMACAUADAZAEE..SAFAdCCAEBHF.JBHBLCFBhAAAFCFD.KDHBaDBDeEDFhAGAAAAB.XFGD.hACANIAB.bDDD.QFFC.TGAAhAGA.OEHF..hAIA...,1,-2,-14,12
UFRKCcTMNIQBfXdObgLJDYeEAGaPHWZSV,aAAAHAAAZACBSACE.FAFARAEACAHBMAIBQCEBBBEAdCCAOBBBhAFALCGB.DDFBhAAAECHBADGBGEDA.hBAAPFHDUEEBKEHD.NICBfGHAhCAA......hCIA...,2,-19,-6,13
JXePKAfMNgBTHCQSZcabVEYFWORdGUILD,MAAABAAAHACA.QAFCZABEaAEDEAGAFBHD.RCAAGDEALCCBhAGADCEBeBHFAAHA.fEEAhBAATGGA.SCEAhCAAbEAA.VFGB......hDAA......hDBA...,2,-15,-9,6
GZdYJfLAORITPCXeaWMFEDNVQgUSHKBcb,RAAATAAACADB..eAEHaACA...MAGBEAFADAIB..QDCChAAASBDDHCGBBBGAhAAAGFDBdCEAfDGAhAFAAAHAOHBAIHHAXFFAFGDB.NCCA..hABA......hBHA...,2,-15,-12,3
IFYfKGQSOCWTbaHLJZDMeBRUcNAdPXgEV,dAAAXAAAEADA.FADAKAFA.GCAB.QCFACAGATCDAHCFBhAAAZECBeEFBRDBBUFFBAAHA.hACA..PBHDIFHAhADASGABOBHD.aGHD.....hBAA......hBCA...,2,-13,-6,7
NZbgYCeTIRGUMPLaQfBKXWHODSJdcAVEF,EAAAZAAA....bADBCACAeADH.RAFAGCEAMAGBLAHB.hAAAaCAAQCGAhAFAKDDDHEFASFBBhABAdFHAACCBFEDHgGAATFDAIGHAfGFABHBDhACA.OHEC..hBFA...,1,-5,-9,4
XQVEYaMbPJHdKBUfegDGWOFCcTRZIANSL,LAAAQAAAEAEAaACE..MAHB.JBFBHAEB.dAGBBCAAhABAeBGHGCCAFCDHTDAAhAAAREABAAIBSCHHhACAXEFAYFEFKEFAUGGA.DCIB.CGGD....hAEA......hCAA...,2,-13,3,16
aNABFZLKHXYWgcMGDJTObCeRPEQSIUfdV,ZAAAHAAA.XADB..gADBGAFATCCACAFBRAGFECAAQEEChAAA.SAHBhACAfDDAaDHBhBFAACIBLEFAKFHBcGGCMGDAOFDHeHEAIHBAhBHA...hABA...,2,-28,20,48
eQOfNHCdFPaGbXSDKYLMETWIARZUgBcVJ,RAAAZAAABADBJADA...eAEHQAGC..fAGAhAAAHCAAdCEAaCGEGCCA.bCFAhABADEDBLEFBEEFATFGAhABAAAIBUGAA.........hACA......hAIA...,1,-11,-22,11
UZHAbNDTEYJROBcQadMfKVeGPCIgWSFXL,DAAAEAAARACABACA..aAFAdAEA.MAGBKBFAGCCB..CAHA.IDAAhAAASBBDLDHBhADAHCCBACHA.TDGAhAHAOEFB.fGGEeEBBPEFB.FFDDhBAA......hBEA...,2,-30,-15,15
ZEYbSUXIeOVTBPRCMGKaJNAgdfFDWQHcL,dAAADAAAHABCZABBEADASAEB.UAGAeAFA.TCEARCCAGDFAhBAAaBGE.ADHA.FDCDQGBAhBGALDHBbEECOEEHhBIABGAAMEIBKGEA........hCAA......hCBA...,1,-7,-9,2
LVRWMfUDaAJTQcZNCgdOKGBYSPbIXeHEF,TAAAZAAACADB..dAFAGACABAHA...SAEA.bAGDhAAAeCABHCEBECCBLEABhACARCFAMCEBDEHBAAIBQEGAhAEA.gGCAKFBAIFFAFGGH.hAFAfGHA.hCAAaHAA..,1,5,-35,40
HKRdNQJTaZfAUDeXCOcgLIWGBVbFYSPEM,eAAAOAAALAEAGADABAFAFBCD.SAGHEBHFHCEBRECBdDBAQFAChAAA.aEHBhABAAAIBXCGACGFA.hAFAgDFGIHHA.bFAAMIAAKFFD...hAFA......hBAA...,1,6,-27,33
JUCHNPZAdQXYSRGfVDaeWcBKLOIgFbETM,dAAAQAAASADARACAGAFADAGA.eAHBBBFALDAAOBGDFCBDhACAEDHBMDFB.CEDAHFAAhAAAZDCBAADAXEEAhBAA..fFHEaDHDKGHB....hADA......hAFA...,2,-28,2,30
cJKTWGVAfLYPedBCbXHgRNEMSZQOUDFIa,LAAAeAAAdAEACAGAHADB.RAFAECAAZBAEQCFADCHB.FDDBaDDChABA.KEFAGEBAAAFA.hACA.fFDAhAIABDHBbEFC.XFGA.MICASGADhAAA.IGGA.hCAA...,2,-17,-14,3
cJIZeCGTdBfgYPOXQMVNSRDKLWbAFHUaE,HAAAEAAA.JADAeACAGAGAdAGABBEA..fCAE.hAAA.gCCBhADAOCCAMDDBSBHHhAIAREEAKFHBbGACADFAaEFA.ZFFACGGD.TGBAXGDDNIEB.hBGA......hCAA...,1,1,-20,21
ZbYTcHCMXSLaJPUQAEeGRfdVKNBIODgWF,EAAARAAAdADAKACABAFA..DAEAFAHBZAFE....TCEAHCCAMCGBhAAALDHBaCHBUECBhAHAAAAAGFAB..fEHAhCAAIFFAOHEAbFEDCGGD.SCCDhAFA.....hCBA...,1,-20,-21,1
