RGKNMbIXPHODTfAJeSYZgcLVQWaFECdBU,eAAAZAAALADBQADAaAFA.EAFABBFARBGBGCCAKBHB..MCABhABAbEFA....XFDDhAAAHDEATFBAAAIBSGGBhABAgEGA.cGDB.FGHD.hCAA......hCBA...,1,-5,-8,3
DFUBAEYQfIdCeNGbMgOJRWTXZaPKcVSLH,EAAAQAAAdADA.eACAGAFA.MAIBOAFCRCBB.TCDAhAAAaDDAKDHDSCFBhADA.HDGBFEEHAAFBfDCEhAHACFHANHAB.bFEDgGGGXGGA..hAAA......hAHA...,2,-21,7,28
XTSZbVFABcUOJgMWEafdeLDHPQIGKCNYR,BAAAOAAAMACA..EADAdAGAeAFAHBCAQCCAGDEACCBDRDGBTCEAhAGAZEBB..FGDBABBBUCGAhBAA.JFFAaGGCDIBAhBIA.IHHANAIA.......hAAA......hBCA...,2,-15,-9,6
XDPJgAQdRIaKUVNMTbEYHfCeGFLOWcSBZ,RAAAaAAAKADC..UADAMAGB..EAFAHCCAeAHFGCGALDBAOAHFhAAASCFHZECADFBB.hABAJDHBAEEAdGGD..IFDAhBAA.TGFAYHAGCBBD...hBDA......hCAA...,1,-10,-23,13
DbEFNaRgdOPBXSMHWKfJGUQCeYLVIAcTZ,ZAAAEAAAFACDRAEAdAHA.BCAAMAEA..HCCCKAHBGBDAQDFAeBFBhAAALEAAACHB.TGCAhABAbEGD..aFEDOFFBhACASGBA..fGHAhADA......hAEA...,1,-12,-17,5
VBAIDcNLHERZFQWUCTXOeMgfSdKbPGYJa,DAAALAAAHABCRAEFZADBFAGAQAFA.CAHA.TCGA.eCCBhAEAMCAA.SCEHhABAbEDD.GDFAhACAaFFAAEIBIHHAECHFWEHH.......hDAA......hDBA....,2,-16,-7,9
KeBbSZIWOFXDaRLEVcYPCNHMGJgQdAfTU,TAAAeAAABADA.ZAEBOACADAHB.RAFAEBDB..VDCB..hAAAPCCBHEGBGGCBhABAQCGAAAIBKCGDbEEBSCCChBGAFFCDaGABcGFDCFFCMCIB....hCAA......hCBA...,1,-1,-13,12
WFUVMNXDgBLZcCabGfASEKQOPYTHJReId,EAAAQAAA.OACCTACAHAFBRAEFeAGHdBHAFCDBUEAAMDFBhAAADAIBLDDBZEAA.hAEAaDFEGEGAACCB.KGEDhAFAPEHDIHAANIDBBFFA.....hAHA......hAIA...,2,-7,-1,6
EfXDSTaGMYIUFPWcgbAJCRKQHZVOdeNLB,RAAAHAAAZADBdAGAeACELBFDEAFEDAIB..aCCAGDAA..MCFBhAAAIDHAFCGB..cDGDhAHAAAAAKEED..QFGAhADAODDBfFHASCCD.UGDBhAIA......hBIA...,2,-14,-7,7
dUHJXCKaAfNWZEYbLTOcVPGFDIQeBSMRg,...fAAAZAAAEADELAFBOADA.VCAAGAGA.DBCAeAHBhABAMCCARDFAdEDAHCAACFCCAFFBhACAYDEB.bGBChAAATGGAFFHBBEDCSHCA...hACA......hAIA...,2,-8,-6,2
PRMcQSBHXaDUYFGCLeAWNEfbOIgTJVdZK,EAAAOAAA..TACAdAEAZAFB.RBCB.MAEAQDGAHBEAaAGEDAIBhBAAFCCHGEBALDGBhAAAABBB.fEDAhCAA.bFEDgEEBKGHB.SGHBhBEA.....hCBA...,1,-6,-14,8
bGEgdfOPDTXJINYcHeMWSVaBFCUARLQKZ,RAAALAAAZADBGAFAEAEAdAHA..OAHFTCAAJDAA..ICEAhABA..cEEAhAAAHCCBeBGD.MDIBhACASDHDaEACCEFAAFEBbFGDfFBADHBA.hAEAXFDCWHBA.FGHBhABA....,2,-16,10,26
abLJYgZAdFBPfNMDKQRXTVcSIeHUWCOEG,dAAABAAA....fADAMACAQAFARAEF.TBCAhAAASAGBHCEACAHAECBFbEBAhBCALDDA.gDGHhACAACIBFEHBDEBAXFFDIGCAeDADhADA.OFFB.aGHBhAIA...,2,-22,-9,13
IBFegVPZRASGNJUMXHObaECdKTDcQWYLf,GAAAUAAAHADAaADAdAGADAFA..QBGALCDBBCFDeCDBVDAAhADARDBFAAAB..SBHHhACAMDFBODGBEEGATFEAhAIA..YEHBFGBH.PFCDhAIA......hBAA...,1,-5,-9,4
NLHZWfRIMKAbUaQPeBXGCEJVFYDTdcOgS,aAAAeAAAGACAEADAFAFDDAEA..dAHA.OCCBSAFA.HCEAhAIAZDEARECFMBBBAAAAQFFChBHAXBGACEBA.VEFAhBAA...YEEF....hBEA......hCAA....,1,0,-21,21
EHUVRIPcdgQLZYFbTMSaKGXJNOBeDfCAW,HAAARAAA..IAEAdADALAFAZAFBFAHDbCAC..MCCAKCEAGCGAhAAA.JEEBBDAAhAAAeFHHCDDAEDGAUGAAPEFBhABA...........hACA......hAGA...,1,-5,-31,26
gRTDGdQAaXEOCcSeKZMFHNIUPBWJbLfVY,EAAACAAA..eACAZACBHAEAUAGABBEAJBHBLCBD..fCAAhAAAVDEB.RCCBGDGAhACAAAGAaECD..OEHDhAAAKFDAMIBAFGDDIHFAbGDA....hAIA......hBCA...,1,-12,-18,6
KVAEgWDfBTUOcGPSHQRNYdFIMbaJZXCLe,EAAADAAABACAUADAGAGAHADBRAFA...dBCCMBBB..aDEAZCFELEEBhAAAeCCBAAFA.fFBAhAGAOEEB.SDHHhAIAQFGAFGGAIHCA.XGEDhAIA....hBAA....,1,-10,-14,4
FSDJMabYKPITCdLUcNgfOEBQAZWeVGHRX,eAAAHAAARADFFADDDAFA..aAFAKAHB...TBFAdBFALCHBhAAA.UEDAgCAAhAAAEFFEAAIB.ZDDA.GEGAhACASCCGbFDB.IHDACDHB.fGHAhABA.BFCChCAA....,2,-18,-1,17
DATCYGHbLWFfJNPeXQZSEOUVKRdaBMcIg,TAAAGAAAHADA.LAGBFACAJAFA.eCDAZBFA.EDCBOCCBhAAAKDHBREEAaDAHMDEA..gFAAhAAAAEEACEFA..hACAbECDfGGA.NIAB.QFGAhAIA.SHEAhCAA...,2,-15,18,33
JGTSAQgHfeCVMLOIUWEbBYcPRFXdaDKZN,HAAAeAAAMAEALADBUBDAEAFA.BAHA..PAHDRCEFdCADaCGAhAAAZCFFGEEAADHB.QGBAhAAACEGDOEHDbFAAhACAFDCHKGHB..........hABA......hBGA...,1,-8,-10,2
JGYgCZFWQTSaHDPcLVAdRIfBXMEbUKNeO,RAAABAAAEADE.KACA..eAFEGAEA.CAGAZCAAQBFD.aCCAhAAAHCGBDCIBLDDAhABAAAIBdEAAXEDDbEGDOFFBhAIAJFHB..FGFD.SGAA..hAAA......hACA....,1,-5,-17,12
OAVXQgGUaWPFCLKHDRSfETIYMZbNdeBJc,QAAAGAAAaADAFAGALADA.HAGBRBFBECDBTCDA.MDCBhAAAbDBD.eDFFBCHBODHDhAEAAAAB.XFADhAFAgEFAPGFCDEIBfGHEZFCB.hAIAdFDA.....hBCA...,1,13,-9,22
eUJTDBOQVAZgPCLcfNMdXRbEHKYaSIFGW,ZAAACAAALACA..fADBdAGARCCAHDABaAFAFCHDGBEB.hAAAeCABTEEAOCCBhABAAADA.PDEBMFHBEFCFhAIASDGAUGEBDFIBQFGA.cGFChACA.NIAB...hAIA...,2,-11,-6,5
JcKOZLQfMGbDAEeRXHCUaNBVWPFgSTYdI,RAAAHAAACADB.aACABAFA..VAFAFAHB.SCCAdCCA.JCFFOCFBhAAAZDGB.LDHBhABAMEEBDEIBEEDFUFAA.hAFA..NIAB.gGCAIHHA.QGFChCAA....hCEA...,2,-29,-5,24
TZOAbBFXMIPDQRHNcdgYWeafULSGEKJVC,FAAAMAAADADAHACC.dAFA....gAEAeAHBaBBCLDDAhAIAEAHB.KDHDCBCAZCDEhAIAAFDAbFDABCHD.XEEAhBAAIHCARFGF.YFHBfHEB..hCAA......hCBA....,2,-26,-4,22
QEAfabZOTgJcSGdNKBeFLDRUHCYPVXWIM,aAAAZAAAOACA..TADAJAFB.GAFAdAHABCCDeAHBLDEAhABARCCBHDABCBBD.PDHBhADAXECC.MDIBhBHAAEFBbFDA....SFFANIABDGIB.YGDAhCAA.IHHAhCBA.,1,10,-39,49
TKLQFdAYZPGEIWgUHNfcMOVCaSDRXBebJ,ZAAAEAAA...IAEAUADAHAFA..fAGAMBCBCCGAaCHDRCAAeAHHhABA..bDDBTCEAhACALFFAdECAADIBPHAAhAAAGEEB.gGABODBHDHFABGHAhADA.KHEA....hAGA...,2,-4,-4,0
RfCNWZVMLeBGcJDIQTYXaUgOdEAFKPSHb,KAAAHAAARACF.CADBZAEBLAEBGAGADAGA..TDCA..aBGAOCABhAAAACAAFCGB...bEFAhACA..fDHAhAAAVGBAeFEBBECAIGGAQEEC.XGGAhACA...hAIA....,2,-30,12,42
CGgZYeXHAfSPTLcWaEUbRKDQOdMNVJIFB,SAAATAAA.LADAaACA.EAHBRAEFQAGCdCCA.hAAAMBDBVCFAFCHDGEAAhABAZEDBeDFHHECCACCBfFHAhAAAcFED.WHFAKGHBDIEA..NIAB.hAIA......hCAA....,2,3,5,2
FCQNdDfTHbRGYIMaLBWUeEJgAOSKZXVcP,KAAAZAAA..XADBVADA.FAFDQAGC.dCAATCAAhABAHCCARDFAGBGAMEEBaFFChAAALDDBBFHB.eDFBhACA.EFHFACIBSGDDCAHBDFFB....hACA......hADA....,1,-3,-6,3
CDQfKPAdIEaJMFecgbHYRVWUXLZSBGTON,EAAAaAAA.FACD..eACH....bADDHAEARAFA.UCEBZCGBGEEAhAAATEAACAHBQFAAhAFAKCHBABBBdEFD.MDIBgFGAhAEAWFCH.LGAABGHD.DDDB..hAGA......hBAA....,2,-3,-1,2
FgSJOPYKaTICUEbGABXDNfeMcVdRWHQLZ,DAAAeAAAMADAdAEAHAGBZAEE.FBCD..SAHHODEBKDGDaBBACEBA.hAAA..UDDAEEHFAAGBBCFBhBAA..XGGAhABAfDGA.RFGB.WFDD.....hCAA......hCBA....,2,-29,-17,12
KFTSUOJDILeQYGfVbdcaAEZPBNMHRXWgC,EAAAZAAABADBHACARAFF..XAEDCAHB.FAGATCDA.OCCHhAAADCAAeCFAGCGAVDDBhABAdEAA.ACIBMEFBKDHBSFGBhACAIHHA.QGBA.fGEAhBGAaGFD..hDAA...,1,2,-29,31
LUcGSRgNDOMEFIaQefCJZPXHdBVbYKWAT,TAAALAAA.GADARACFDAEA.EAFA.aAHDeAFA.CBHA.ZCAAHCDBhAAAdDFABDHA.bFAAKCADhACA.ACFASDFBhDCAOFEBMFHBQFFB.fDHEhDIA.....hABA...,1,-9,-14,5
WIaYCJbLGSRNHOTPAQFDfXUZgEcVKBMde,QAAADAAAUADAZAFBEACA..KAHBdAFA.eAHB..aBBBCBDALDDAhAAARCGF.HDGBhAIATDBAAFBAXFBAhBFA.gGGABDDBMEFBYHCGbFBASGFHhBAA.NEIA..hCAA....,1,10,-28,38
APUNCYDMJFaeKZcVBdWGSIEXgRQOLbTfH,UAAACAAADACA.MADA..aADEeAFA.ZBDABAGAGCGAEBCBRCDFLDDBhBAA..bBFAHEBDhBCA.ABIBPFFBhBEA..YDFB.KDHD.dGAAIHHAhDAA....hDBA....,1,3,-36,39
CZPYUdeASMfgTWLIXKRDcVbEOHNQaGJFB,MAAATAAALAEA.KBBARACFDAEA.VAGBEBHFHCDA.aDBBhAFAGBEABDHAZEFAPCABhAAAdFCAAGAA..fDHAhACAgGEAXECA.bGEA.NIAB.hAIAFHGE.....hCEA....,2,-3,1,4
TAbgGVcdWNIQJCDOYRMfFHSUeXBaKLEZP,GAAAdAAA..IADAQADA.DAGARAEFMAHBHBFBeBHBhAAAaCAE.ECDBZDCBADABbEFCVEEAhACA....cFBAhACAJFHBOGACFGGASHEABHEA...hAGA......hAIA...,1,7,-22,29
QfeGKLOCJdMVgSWUAbIYaNPRHcBTZFDEX,..IAAAaAAARACFHAEBBACAZAGB..EAEAQEAAGAGALCAAhACACDEDdEGA.MCEBSBBDhAEAAAIB.bGAAPCFBhAEAFGFH.fEHA.eFGD.hAGAOGBA...hBAA....,2,-7,-1,6
DBRUJbgOEASQaTZGXfcWNdHCILPMVKYeF,aAAAGAAA..XACDfADA....NAEBHBEBLAFAhAAAMBBBKCDAeBGBBCFBhACAREBAUEGBbCGDEEEAABHASFFDhBAAZGAAdGGA.CHGA.......hBEA......hCAA...,2,-10,-7,3
RHcXgVDKOWfMSQCLIdGBPZYENAbeFUJaT,eAAAFAAAUADA..aADDHAFA..XAFADCCBOCFEMAIBQDDChAHALCCAGCFAhAAAZEGBEFFF.AAFAbDBC.hAIARFGF............hBAA......hBDA....,1,-8,-20,12
UMCZEYOfQIKdBaXFeDVNHRgcWTSALPJGb,LAAAGAAAMADAEAEA.OAFEQAGAdCDABCFAaCAA..eCEBhABADCHBHDBBRDCB.gEFBhAAATEAAACGBbEGBCGHA.hACA..fGFA.IHDAhACA......hAEA...,1,-7,-19,12
deaBFIDfYgRAcPCSKGUHZLONMETVXWJbQ,CAAAGAAAHACAZAFBLADA.MAHBEAHFTCAAXCDA.JDCFdCEChAAABDHADCIB..fDGAhACAREEAAAAB.SDDDhAEAOEABNIABbGDAeFAB.aFFC.FGHDIHHAhACA....hAEA....,1,1,-2,3
UfdaQVGAMOZgSIEBbKCeNLDHTWcJFRXPY,ZAAASAAAEADEBAFBCADA.LAHBHAEB..TAGAJCAA.RCCB..hABAXCGAUCEAaEDCGDAAhAAAABHB.MEFBOEGDhACAbEGD.eGDEDEGB........hDAA......hDEA...,2,-26,3,29
CaXJEFVANfUDOZGeBLKcRWYHTQMdPIgbS,UAAAZAAAeACELADARAFFHCCCMAHB.dCDAICHA.SEFAhABAaCFBEDGB.AAHADEIBhAFAGEAAKFED...cFFAhAEATGGA.........hAFA......hAIA....,2,-18,-14,4
JGCVIeEZMSYQUKBcaTdPAWXLFNDRgbfHO,LAAADAAARABA...bADDHAEB.GBGACAFAeAGHECDBZCABMEAAhAEAQDGABAGCaEFBdEEAhABAAAIB.FDCH..fFHAhBAAOGFC.........hACA......hAFA....,1,-6,-21,15
efKMEPASXaQRHCYUGNIdOgcFBWVLTDJbZ,aAAAHAAA.CADBGAEAdADAOAFAFAGABCAD.LCCBTBFADBBBhBAAZCGBeEDHMBIBACCBQGEAhAAARDBA.NDIA.gDFAhBDA.cFBC...VFGBhBFAfGBAEFDB.hCAASGHD.null,2,0,0,0
MBRKTUbeNaIFJCEPYSDVdgZHAWXfQOLcG,XAAAQAAALADAGACBRAGF.KCDDTBGAUDAA..eCEHhAAAaCDAFDDB..EDGBSDGAhAAAdFFAHGAAACIBOEABhABAMEIBBHGAbEFCIGDA.CGGADGIBhAEA......hAFA....,2,-2,7,9
eYOBGQMJaKDETFHWZcbIPgSVfCURALXNd,LAAAdAAAeADABAGAGADA.MAFAaAHDDCCAEBFEHCAA.ZCFEICFAhACASEFACDAA.hADAABHAXFGAODDBQEFAhAEATGEA.FFEH.....WDHBhBAA.PHFC.hABA....,1,5,-19,24
QSbNKRMIEJAaWCgLOcFTPGdfeXVHUZDBY,aAAACAAALACA.FAGAGACA.eAEAHBECZBFEBCCAQDFAhAEASCHHbEDDRFAAEDABhAAAABBBOHBC.TGGAhAFAdDEAXEGC.DGHB.KHDA..hADA......hAEA...,1,8,-26,34
IbRJDPHedVcAOXBQFKENGSLWMZCafUgYT,BAAAQAAAEACAGAEALADAZAGB.aAGDUCAA..TCDAhAAARDCFDBIBHEFAeBHHdEAAAAGBFGHBhAAASDCD.hACAMDGBfHEBgFCA.bFED.PEHDhAEA....hAFA...,2,-11,-1,10
TUeBAfYdFKLREWSPVCDIGJacgOHbMNZXQ,dAAALAAAEADA.SADHCAFAGAGA.aAFAOCAE..HBEBhABAMCEBZCAA.TDGAhACAeCFBAAIBFEEHRFEB.PFHDhAIADDIBIHHAgGBA.XBGA.hACABGFA....hBGA...,2,-19,-1,18
ZdJNDYfACUQGXRHWFcKObBgSVEaIMeLPT,QAAARAAAHADBFAFAKBHBBACA...SADHECCB.aAFAeCFFhAAALBFAZDAFdEGADDDAhAAAAEEBCGFDGDEB.XFFAhAIAOHDC.bGBAIHHAMFIB...hBGA......hCAA....,1,-3,-15,12
JPYCLUAOIdXSGKefZNFBaRTEMbQDVHgWc,dAAAGAAAeADAZADABAGARBGF..ECDAMAIBQDEDHCAC..gCFAhACAJDCF.CEAAACFAhADAXFAC.fEHAhAAAaDEHbECDDEIBcFFCLFGBOHAChACA......hAEA...,1,-4,-14,10
deXDYfQJFKRMUHVgPbSIZCBAOLaEcGWNT,aAAAEAAAGACA..TADAeAEADAIBQAFCKBGBRCEB.HCCAhADAVEAAbCGD..ZEGBAAHALEEBhBAA.cGGAhBBAdGDA..........hBIA......hCAA....,1,1,-16,17
BbNAHTIaOZfXVEMcUeDdSFQWJLgRGYKCP,HAAAaAAAZACBXADB.EAFAMAFA.eBEAdBHAQCABhAAALCHBRDEAGEBACCEABCGCADDBhACATGFAfEEAhAIAcEDCSEHB.FFGB....hCDA......hEAA....,1,4,-6,10
KNIgUAXBEORQDCVFcHfLeGJdPZTMWSabY,EAAARAAAQADCDADA.FAFAHAEC.eAHHdCFAZCGBMBCB.aBDCbCCChAAAKDDA...IEGAhAAAAAIBOEEB.CFHA.fFDAhAHA.LFFA...hABA......hCAA....,1,-13,-20,7
RQaJfTFDACNIWdUbHYPOKeMcSgLGZBEVX,CAAA..IAAAdACAHAEAOACAeAHHMCBB..SAFAhAGAGCDAEDFERBCBaAHD.TCFAhBCAAAGAUFFA.YEAFhAAAKDHBLECABGCA.QFGC.hAEA......hBCA...,2,-13,-11,2
QaYVAHgFfDBTZMIXdJENPWORSCUGKceLb,HAAAFAAABADAZADBMAGBdAFA..EAHB..PAHBRCCA..CCGAGDAAhADAeCAALDFAhAAA.aEECACCADDIBTFBAhACAXEEAWFGH.SEHD...hADA......hAIA....,1,2,-35,37
gTGPbNEeQFfYCDHMAJUKLXdWaZISBVcOR,KAAAdAAAZABBBACBOADCRADF.GAGA..bAFBECEB..eAHFhAAAQDCDFCCH.CEGDHFAAhAFAACFBLEEAaEHDSFFDhAGAVGEA........hAIA......hBAA....,2,-29,3,32
TXDBWdQHgGSPYVMNAEfRFaICLJcOUZebK,RAAAaAAALADB.OAFAeACHTAEA.BAGBdBFAHCGBhAAAGCEBSCCDhABAVEAAAAIBEDDBFEEB.CFCAUFGBhBIAbEGDDBBB...gFEAMICA.fHCBhAEA...hCAA...,2,-14,0,14
ZOBAcXMgNbaWedfYUSRTGCIDFLPVEKJHQ,MAAA..bAAAeACAdAEAUAGARAFAGCCADAAALDDAEBBB.HDGBhBEAZCFAACHA.XEFAhAGAaFDA..fGBAhBGATGEACHHA.FGGH........hBIA......hCAA...,1,-9,-15,6
QBOXCcFENGSdPVAJWDgZHIaRfMTebKLUY,DAAAHAAARABA.MACA.eAEALAEBUCCAQBGAXAGAFCGBECFBhAAAGDCAdEFD.AAGA.gFGAhAIAZEEF..hCAAaEGD...........hCIA......hDAA...,2,-28,-7,21
FfMHOGYSAVeUJDXCZTRWgIEbdNLKQaPcB,eAAADAAAZABERADA.....IAFAEAGEdCCALCFAKAHB.aEABhAAABCCAMEEAHCEAGGCBhABAACGAUECACFFA.TEFAhADA..WHFANDIA......PHAAhAHA.fHEBhBAA.,1,-9,-35,26
CKIYRGPVHEXSOeZJBTfNgdUQcWAbDaLMF,aAAAMAAA.KADARACFGAEAHAFB..EAHBOAGFeBBBZDCBBDGD..hAEATEEA.fDHAhAFAdEDAQFFAhAGAAFIBbGEA.DAIB.CFHAYBBF....hBAA......hCAA...,2,-26,-3,23
WdJeTIfMVEQHUaYAbDRgKCLPcXSOGNFZB,RAAACAAALACA..XADBGAFAZCCAdAGAeBEH.TDFAhAAAMAIBEDABHDCBaDGDAAIBDCCBhABAKECA...SDHBhBGAFFFHBHAAIHHAQFFB...hAAA......hADA...,1,-8,-26,18
cfgFMdSCZRGXWYAJUBOaNPbDHIeQVLKET,BAAAaAAA.....bACAHACB.eAEALAGBEAHFTCEAhAEAfCAAMBBBdDHAZCCAREAAhAAAGEFA.XFAAhAFAAACAOCHDDEEBQEEB.KFHD.hBAAFGBDCHEA.....hCAA...,2,-10,-1,9
TQANKOFcbdMLUBGCeWDSJXZVEIYRgHPfa,OAAAFAAAdADALAFAGADAeAFADCCB.SBBDZCFA.EBHFRDDBHFGBhAGA.aDBHAAFAKCFBhBAAMHAACDHAXDBAhBDA.IFEAgGEFTGFA...hAHA......hBAA...,1,-7,-18,11
UNFLefJgXDbERGTKZIWHSCcBVMaAOYdQP,dAAAQAAAUADALAGBeACA..fAFAJCBB.DAHBRDDAGEGAhACAZCDAHDAACFBABFFChAIAaBHDAEEAOEFE.hBAAPGCAFGCD.XGGA....hAAA......hADA....,2,-28,7,35
bQUZRWCDVIBXFaScGLOPAJfdgKNMHEeTY,dAAAKAAAHACBEADA.eAEA..bABDZBFERAFA.DCABBCEAFDEH..aDGAGCGAhADA.LECAhAGAAEGAJEAB.fGDAhAIAMFGB.TGFA..YFHB.hBAAWHBA....hAAA....,1,-1,-21,20
fMZLSKUWVBAPecHTYNCOgIFadXDGJbREQ,eAAAHAAATAEACADA.OAGDFAFAdCCAGCABRBEB.EDEAMAIBZEAALEGBhAAAKDGA.VGAAhACAAAAA..PEDDhCAAYFFD..gFFA.aGCHDAIBhADA......hAEA....,2,-28,23,51
bdRYVCSFeaGTMHDQBgXAfWLNZOcIJEKPU,LAAAZAAAOACAJAEAKAFA..UCAARCCA..CAHB.eAHHGCFAHCDAhABABCHAACFA..fDHAhACA..cFCAhABAEEFBdGEA.SEBAaFFHMEIB.DGHB.hCAA......hCBA....,1,-12,-26,14
ZCRMcXLVWFGHObSfUQPdDEaBeNgJYTIKA,RAAAMAAALADBFADDHAFAOAFA..SBBBQBFCdCFDECHFhAAAeCHH..gDCGhABATDDAAAHAZFAAXEGAhBIAGGEBUGEA.aFCHBFFC...hCAA......hCCA...,2,-10,-4,6
BOSEYbLXQRcWeDHJUFKPdITZAgNVfaMGC,VAAAaAAAGACA.BAEAEADELAFB.RCDB.eAFHHCGBFAHBhAEAdFCAZDFBAAHA.fDHAhBAAMFFBSBHBhAAA.XGGAcEDBDBBB.KFHB...hCAA......hCDA....,1,0,-15,15
EMQFbTgcHBfAXVZYUSLPIWDaCRGKeOdNJ,ZAAASAAALADB...IAFAaACDRAEAeAHHdAHA..ECAAMCEBhAAAQCFCTDFAHEAAhABAADIB.XFDAhAEAUFDADFGAKEHBOHBCFGCHgGGBfGGAhABA......hACA...,2,-20,11,31
gYUbSdHFKCWRLJTXAQeOMcBZVaPEfNDIG,eAAAMAAAZABE..aADDEAFADAFAGBGA.UCCAdBFAHCGB.hAFACAHARDBATFCAAAAA.QFEChAIABEFDfFCAhBDAIGHA..gFGASCFD.hCAA......hCBA...,2,-28,-8,20
EgLDRbVOPKBefFNCYcaAXHdUWMSIJTGQZ,HAAAdAAAMADASACE.JAFAGAGAEBEF.LBDBRCCB.hAAAbABDOCFCBBFCeDFBhAIAFEFACFFDaEHDADIBUGDAIHCAhAIA..........hCAA......hCCA...,2,-17,-17,0
HeNbMdSEUcRILGADOYaVPfCZTXBQFgJWK,OAAAaAAA..VADACADAZAEB.BAGAFAGA....JBBFHCCBeCFAhADAbCFD..dDDAEBBBREGBGGCBhBAAAAIB.DDIBfCHAhBAA.TGGA.XFEChCAA.WHCA..hCEA...,2,-27,-18,9
WAQTLZdVbKYJRHfCOSIaXBgeUPDFGMcEN,TAAAdAAAKADARAFF..HACB.OAEAaAHDBCBAeAHF.DBFBGDCAhACAECABACGBZDEA.VEBAhAAAbEEB....fDAEhADASEHHXEGAgFFDFFAHMIDAhAFANICB.....hACA....,1,10,-15,25
CdBLRZgNWMfFHIbADUcSPKYEaTVJGQeOX,DAAASAAAKACA.EADAaAEA....TAFAGAGA.eBBBhAIACAHBdCCARBEBZDCB..gCFAhAAAMDIBHEECACIBPDABhABA.VEDB.QGFAhADABGHDNIBB.WFCD...hBAA...,2,-19,-3,16
bIWNaOQGXLYCScgUdAVBHRfDEPFTJMeKZ,HAAARAAAEADE.TAEA.eAGHZAFB..bBGDICCA.aBHDGCCAhAAALDABSEFDhABAgDEBAAIBfFAAhAFAFECAMEHBNEIAXGFAcGAD....hCAA......hCCA....,1,12,-8,20
PGBOXbNIdKeREJMAVcCDYSFTWLHagZfUQ,CAAASAAAFACA.LADAHAEBZAGBQBGAGCBAOCHDhAAAbCCA.dDDARDFF..EEAAAAGBDEGBhBCATECA.aEHDfFEAhBIABHAA.IGHAeHFA...hAAA......hABA...,2,-18,-7,11
FGLUeCWgbXfaJQHZNOTMIBVSdYRAcPDEK,DAAAEAAAGACAeABA.CAEA.....bAEAaAFDHCCAZAGB..TEAAhAAAMAIBBCFB.dECDhAFAABIBKDFDLEGBUFGAXEDDhAEAQGAAOHECSFEA.hBCAYHDA..hAGA...,2,-19,-7,12
DRHQVGLJAZFeBbgISYcWNOTUECdKXfMPa,eAAABAAA...IAEASACA......cAFDhAAAOAEDEBCFdAGAfBHAhABAaBHDHCAAGDCBhAAAACEBbDDA.gEGA.YFFFhACATFDAKDHBMGBARGAALHFAhAGA.,2,-15,-14,1
XcQfeEATZdIJgMKNRHBUYFLOGWSaVDPCb,dAAAJAAA.MADARADF.HAFCBAFBFBDBGAGA..aCAEDCCB..bCEDhACAQDDB.hAIAEDABACGBZDGB.KGEAUEGBhADAOEDHSFCBCHHA.fGHEhAIA.eFFD..hBAA...,1,-12,-24,12
XTdVZWLbHBROKDaIcAPQeMSYEgCUFNGJf,eAAAMAAA.EADACADA.FAFDGAEA..XBGDdAGBZBBFLCHBhBAAHCCARECADAIBaDDDAAAAQEGAhAHASDGFUGGAhBHAfGEA.........hCAA......hCBA...,1,-8,-19,11
TMPGRXHaCAQNFcUYOgSfLWIKeDEBbdJZV,QAAAFAAAUADA.OACC..fAFFLAFBKAHBEAHF.hBAAdCDAZCCAMCHB.REAAHEFBhAAAACGB..cCGDhBDASFCA.eFHHbEECTGGAPHAA.hAEA......hAHA....,1,10,-26,36
PDSVTQcBJdCgWbEIHMZKGXeYafNUOALFR,RAAASAAAQADCBADAdAFA...CAFA...bAGDHAGBZCCAGEEBhAAAeCCAaDAB.fDEAhAAAOHEAAAIB.LEGBhABADICA.TFAA.gGDAhADA......hAFA....,2,-13,-5,8
gBfHANbaDLEFSVCQeKUROPXMIcJYGTWdZ,aAAAEAAAFACD..CADAKAFARAEA..OAHD..MAIBJCDBGCFAhAAAdCCAZCDBBCFAHEABAAEADBBBhADALFHBQDGDhAFAeFDFUFFB.IHAAYFFF...hAHA.WHCG...hAHA....,2,-26,1,27
fHYQSGRVBbIXaMWFJdKLcTeNPUDgACZEO,EAAAHAAA.QADCRACABAFB.XAFBaAGDFCCH.dBHALCFAhAAAeCABPCCBDDAB.ADFAZEDBhAAAOECESFFAhACAGEGAbDADMEIB.KHEATGEA...NIAB.hADACFCA......hAIA....,2,0,17,17
bWRdMAKSVJUgTEGZeNOQaXCIYFBcfDPLH,SAAAUAAAEADAZAFBeACH..QCDAaAEA.CAHAFCHBfAHAhAAALDABHBDBhABAREFBADCB.KCGD.gEFAhAHANEIA.XFBABHFD.DCIBbFBDdGHA.hADAMFEB....hBFA....,1,7,-6,13
aePLJcOKIXMfRBEVbHCYSgUFNTQAWZdDG,dAAAaAAALADAOADAKAGA..MAHBRBDBBCBAEBBBHCEB.SCHHhAEAFCFAQEFAhACAAAIBZDCBeFAB.cFGAhAFAfFEE.CEHA.gGCANDDA.hAIADGGB.....hBAA...,2,-37,9,46
RVJBNcCEaeGgMFZYTOKPHbWXLUQADdfIS,dAAASAAARADABAGB.CADA...EBHFeAEHGCABMAGBZCFF..TDAAhAAAKDEBHEAA.XFGAhACALAHBADIBDHEAhADAfCCE.IEEANIAB.aEGA.hAEAFFDH.OFGB.hAIAWHBG.,1,-5,-31,26
AbTMfPXHcZCOSJFadWYgLKRGIDVeQUEBN,MAAAXAAAHACCZACBSAFB.aAHBdAFA.gBGHhAAARCCBGDGADBBBeBEDECFBAAHAbEEAhABATFEA..fFBAhBFA.CGEAFGGH.....hBAA......hBIA....,1,-3,-5,2
MEAULCbDFeYfVaHdRWOSTQGKXJINcPgBZ,LAAADAAAeABA.VAEAHAEA.RCCA..SAGEGCAAXCCAhABAJCGB...ICHAhACAPEEBBFHAEDFBAAHAbEGDhAEAfGCAdGDAOFFBKGGD.....hBAA......hCAA...,1,3,-26,29
QNFHLRaTSePMYEgcJZUDCGbWAfOIKVXdB,OAAAKAAAdACABAEAFADDHAFALAGB..RCDAaBBHeBFF.MAIBhAAAECHB..JEFAZDDFCFAA.GEAAhAEAAAHA..fFFEhAFAXFFBNEIASHGA..YECHhCAA...hBAA....,2,-18,-12,6
aBONPLgUAeYWJTGHfXRCcVdSFMEKZDQbI,eAAAJAAAHADBRADA..CAGB.dAFBFBHDEBGB.ZDAAQCCC..hAAAaCHDOCFBLEEBhADAAEAA.TGGAGEFAXEGChAIASEHBMIBAbGCCBCCD...hABA......hAEA....,2,-11,-3,8
SYMXRgUQZfaNdOCcAVKFGJITHEbBWDeLP,FAAAGAAA.JADAHACBBAGBeAEA.LBHBSAHHMCFBRCDA.hAAAQEAAZDFE.hACAaDGBdECACEDAAAEAKFGAEFGAbGCAhBAADGIB...XGCA....hAIA......hBAA...,1,-13,-20,7
fWZdYSJXUCEGTcLKMQRHFBVbNPOgDIeAa,aAAAZAAAdAEA..SACHXAGAUCAAEAEAGAGA.TCDAhAEALCGB.MDDAhABAHDFBBEEAbFCBOBBHhAIADDIBAAGA.fFHAJGEA.KGBB...hACA......hADA....,1,9,-27,36
gEVKNQZBWfXeCTDHMaRIbPcSFULOYJAdG,GAAAEAAAKACA.ZADABAEB..XAGBeAFHDAHBHCDA.RDFAbEAAhAAASBHH.LCCBhAAAOFFBAAEAdEEA.hACAgDGG.QGFACGHAaHGC.hBAA......hBCA...,1,-6,-22,16
ZYFPBACSbfEUgKXWTaODLJcHNGdRIVeMQ,SAAAEAAAKACA...TADAaAEALAHBHAFBdBHARBDAeCCBhAAAZCCAFDABABHB.CEEDUEGA.hCAAXFAADDGBNEEAVFGBhCBAMIAA...........hDAA......hDBA...,1,-6,-20,14
UJaZQYTDAKcdHgLBNeWbfCOMERGISVXPF,dAAAHAAALADAeACE..bAFBOAGD.RCAAGCEASAHHhAAAXEAAFCCAaCEDZEGBTDGAhBHAAAEAKEDD.BFFA.hACAfFHAEGDF.......hAIA......hBAA....,2,-7,-3,4
DdeXFAbPLTRWgVaSNIUcHYJOGZCKQMBfE,LAAARAAA.VAEAaADASAFH.UCCAHCAAOAHBhAAAZCEAQEABhABABDFAEDHF.eDHHAEBB.bEEBTFDAhABAgGGA.IHAAcFFA.YHCAhACA...hAIA....,1,8,-22,30
KMYARHaGWJBeLdSUIXNQObCVfZcTDPgEF,HAAAGAAABADBeADAdAFASAGAUCAB..XBGDQCDAhAAACAHBZDCBTCFA.hAAADCIBEEEAMDABREGBaFBBLFFAhACA.ODCB.fHABhADA.PHCA.hACAKHFAAEIB...,2,-15,16,31
RZIEDTUYdBCcAKQVGFNHPWSabgJLeXOfM,QAAAGAAAHADASACAaAFA.JAFAeAHH.fCDEhAAARBDAECGADDAA.TDFAhACAdDDDCDHAAEGBFEHD.PFCAhADAbFFA.LGCA.MIDAIHFABGGD.hBAA......hBCA....,2,-19,27,46
GSUdQXYgAFDIVafbTNCcBKPRLOHZJEMeW,DAAAaAAA...TACACADAKAFA.RAEF.HCCAZAGB.EBHFeBBB.GDDAhAEAdCFAQDAC.hAGAXECAABIBFDHDfFGEhBAAbFFABBBDLHAA.MHEASGCBhCAA...hADA...,2,-13,-11,2
EIDbANcWTaGSYBXHeFOVZPfQLRKdUCMJg,...NAAA.TAAAGAFABACBHBBAeADHOAHFZAEBQAGAhAAARDAF.dDGAMDDBEEEAbGCAhBIAADHBaEEB.XFBDhABAFGGA.fEHA.LFFBhACA.CHADIHHAhADADCCB...,2,-4,-3,1
ZXGQdVWBNATUFKYfebOgPcERISaLMDHCJ,TAAAKAAAeACE..OACA..gAFBEAFARBFA.aAHFMBDBhAAAHBCAZDFAGDEAhAAAdECDBFFAADEBFDGAfFHEhAIAcGGA.LHDACHFA.....hCAA......hCBA....,1,-5,-6,1
MGdcTbNUDEfJgOLYWFQKAPeRSVHaCZXBI,RAAAHAAAZADBBAFAGADA.dAFB.TCFAUCFAEAHBJCAF..LCHBhAAAFDAA.AAIBeCCBaDHD.hAAAXFEAMEEB.bGBChACADFDBOHECQFFC.....hADA......hBGA....,2,-29,23,52
OVNXHCadGZEeUKLIASRWbDTgMPJBfQcYF,RAAADAAAMADABACA..QAGAFAEA.OBDCXAGD.HBCChAIAdDDAEDGAeBBDLFBBhAAAADDB.bDEDTDFAhBAAgGDGJEEFfEHA.cGGChBIA...YFDFhCAACGHA,1,-16,-40,24
CMXaSGVJgdLZRQNIHUbBWfOKTcYPAeEFD,EAAACAAA..aACAGACA.VAEAdAFARBCBQCGAHBGBBAHBOCBBhAAAKCBD...TEDAhAEAPDFBAAHAeFGB.hAAAMFIBSECA.LFHBIHFAhBCAbFBC.fGGAhBCA..,1,-8,-15,7
dUBWDMHZQTIbEgcKPVYNaGXReSCLfAOJF,FAAAdAAABADAMADAHAFCZABB..QAFA..bBCDECEBKBEDhAIA.VCFBaBHDRDCBeDHHhBAALEGBACCBUGGBTFAAhAFA...gGDA...hCAA......hCBA...,2,-14,-12,2
dacWDQORVXgILSKCYJBefZFHPETAUMGbN,GAAAdAAAaADA.DADARAFF...XAEALAHBCAHA.BBDAZCDAHDBBhAAAECBFADDA.MCHB..bDEDhACANCIA....QEEChACAOEHBIHCAKGGAeHAA....hAHA......hBAA....,1,4,-24,28
IdUbXGefTPSJNHRagQDBOMFAELZcWYVCK,EAAAZAAA........cADAVACAKAFCdAGAUCAAGBGAeBHHhABATDDA.SEGDhAAAHCDAREFBaFAAQFCChAIAOEHFAFEBWGBGCCCDIHHA...hACA......hAFA...,2,-15,-11,4
gaSJUbdEIKFGeMQAHfXBTOWRCZcPDYLNV,HAAABAAAOACARADFZAFBDAIBLAGB..VDAAaBCB.UEEAEBEAFDCDhAAAGDGA.eFABhAAAAAIBTEEA.CDHA.PFCDhACA..gGCASGHHdFHA.hADA......hAFA...,1,-5,-22,17
AdGHDUbXfFQJCcORVSEYeZKTLaMIgWBPN,HAAADAAAUADAXADB.QAFACAFARAGF.ECABeBBBZCCATDGAhAAAMCIB...gEEGhACABDDAADBBGDFAhAIAbFCDFFHDOFDBSBHBLHEA..hBAA......hBCA...,1,23,-30,53
CdPWYbaHgeNUXDIBSTLGAEfZcKQOVRFJM,EAAAZAAAQAEARACA.MAHBdAFAPAHB..bCABHCCChAAAeCDFXDACBDGDTEEAhABAADGBKDHBFEFHCEHAaEAH.hADAUGGASFHDGGBB......hAIA......hCAA....,2,-9,9,18
HSYRNbLGXDfOAaKgJQBecWZVdICTFMPEU,aAAAKAAAQACCBADA..eAEHZAEBdAHATAGAMBGB.EDDBHCCBhADA.RCFBLDHBhAGAGDGAfEAAhAAAABBBJFEB.VFEBFGGH.SECD.YHBAhAEA....hBHA...,2,-10,-10,0
MZRcIGKgYHbBSCANUOVTfJXEdPWeFaDQL,OAAATAAA...XADAEACEdAEAeAGBDAGALBGBRCCB.GCCAhAEAKCFBHEFCBBBDAAHAUGGBhAAAfCFAPFEBhBIAaDHD.ZFFA.........hCAA......hCCA....,2,-17,2,19
cMVQgERGLXdYUOKIZFDBWJTCNaebPHSfA,MAAAQAAARACA.GACBdAFAOAHBZAGBBCDD.JDAATCDAhAIACCFC.eBBBHEEAACIBVDFBhBAAEFAALEHB.hCAAXGAAKFHBDIEA.aGEC......hAAA......hADA...,2,-14,-6,8
gDQGcHOXMCLRAPEbUYVFKJNWZBIafedST,EAAAUAAAFACDKADA....JAEAZAFBBAHBaAHD...eBDHdCDA..hAAASDAATCFAQEEChCAAHDFCMFAARFCBACHAhCBA..bFCA.NIDB.fFHA.DGGBhCFAOHBGCHEA...hDAA...,2,-22,-14,8
IUXKRVQEPNOASJZgWTGBFCcdeDMLbYfaH,ZAAATAAAGAEA.CADB.eACELAGB..bAFBaCAAHCCAUEEBhABARCGFEDBB.OEEBhAAAAAIBSCHHgFGAhAIAFFHBdGBAMIBA.fFCA...hACA......hBGA....,2,-15,15,30
TPUNCgSLdeBfVIRWaHYXGMbZQADJcFKEO,DAAAFAAAEADAOABE..UAGACAEB.LBFDeAFHBAHA..fCCAhADARCCBHCGBGFEBhAHAZDGBADEBKECA.TGDAhBAAgGDG..SGHHIHHA.hBAA......hCAA....,1,-17,-19,2
TWRQNaCHEbVAMfBXYUPcZIOSJKdGFDgeL,MAAAXAAAUAEAZACB..OAGFKAEAGAGADAIB.LCEBhAAARBBB.aDGHHDEA.EEBBhBAAAAIBBEDC.cFGDhABASDHH.dGDAeGAATGFANIDB.CBDC.hBBA......hCAA....,2,-11,-8,3
ARJKfeXCEdYFbZcaBHWgSVMNPOTQLUIGD,RAAAKAAAeADEEACE..dAEAFAGAZAFBBBDA.HCDCSAHH.MCCBhAAAOCCH.TDGAhAAALDDBGGCBADHAXFEDhBHAbFFA.aGGA.....WHEAhCAA......hCBA....,1,-10,-18,8
VRJNHgZIDPKSBGXaTFOCWYLUEAQbcdfeM,QAAAdAAAeADARAGBHCACZACBDAFA..SCFBGBEAaAGETEAAhACACCGBLEBA.ACIB.hAAAbDEDMEGB.NEHA.gECHhADA.KDHB.FFHH....hAEA......hAIA...,2,-17,-3,14
IfOGWXDPCUVbFdZMJAcKaeHNQLBYRgTES,aAAAHAAALADARADFEAFE..SAHBOAGDGCCADCABUCFAbEAD.hAEAZDAB.ADDB.eCFBQFDAhAAABBBDTFEAhAFAfFGAPDHDCDHB.dHGBMFIB....hACA......hADA...,1,8,-8,16
TQREgZNBVXMHcaObGSUAPDFYIWJLCdeKf,FAAA..IAAALADAeACATBGAEAFAZBEEBAHB..MAIBhACAHCCAaCCBGDFA.hADAAAEADDIBYDDFCECDdEECfHEBhBAARFEFNDHA.......hCAA......hCBA...,1,-13,-17,4
AQRfWdGXaOTHIFJeLMSBNgUcDKYPCVZbE,RAAAdAAAGADAaADA.HAFAFAGALBDAMCCBBCGAUDDAKDAB..CDFDZEFEhAAAACCB..QCGAhACA.XEBBhBAATGGAeDDDSEGDgFAGDFIBPHFChBCAEHEEWHAA....hABA...,1,-9,-10,1
SHbRJfZABaUEIFMgYGOVeWLQdCNKDXTPc,aAAAEAAAFACD..MADAGAEA..eAFALAGBdBBDKBEDTEAAhAAASBGAHDDBRFGBZDDAhBAAAAEBBDHAUFDAgDGBhCAAOGBC.QGGADAIBXGED.hDAA......hDBA...,2,-16,1,17
cDIVXbBSLUYGafQCgOPNZKWHJdFAERMTe,RAAAeAAADADA...XADASAEALAGBGAGAaCCA.QDDBhAAAOCCAZDDAHEAAhABAdFDAEFFBMAIB.TEGAhAEAIFHAbGBABFFD.fGHAhBGACHHANIAB......hCAA...,2,-18,4,22
bdGNZQUCMWTOfKDBcASIVYJeLXERFHaPg,SAAAVAAA.eACHEADEHAFB.aAHFbADDGCDAZAFAQCFChAAAMDCB.TEGAhABAKDGABFAAAAGA.IFFAhAAALHCAFFHBdGGDCHBAOFDHDEEB...hAIA......hCAA....,1,5,1,4
RfCTHLAXSEDQOaKPGWBNMYVIZFdJecUgb,EAAAQAAAKACA.GACBBAEBMAGB..IAHAdAHAeCCAhAAAgCDARDEB.hBHATCGAHDGDACCADDAAaFHDhCAAPEFBNIDB.ZFAA.FEHD.....hCBA......hDAA....,2,-12,-2,10
MdGRDLKAIUaJBgZYWTPXEQNOHfCbecFSV,aAAABAAAZACB..TACAEAEA...QAECHAGBCBBDeCEBSAGBhAAAdDGDRFCALFHBhAIAAAIBICAA.gCCGhACA.PCFDNIBBfGFFFCHDMFFBhEAA.KGGA....hEBA...,1,-4,-26,22
WBQPZDgUOEGVbKdfFcHXSMTCaRNALeIYJ,eAAAJAAABADBZADBDAGA..OAEDEBCFGBFA..KAGAdCHAFCCBhAGAHEEB.MFBAaCFDACHAhAIALHBA.IGHAhAAAQEDC.gFGA.hABA......hBFA....,1,0,-45,45
cKGBdZfILSFWeRTaMUXOQVDNAEbgHYPCJ,EAAAHAAA.CADBKAFAdADAZAEBLAHBFAGD.RCAA.aBCB..MCEAUDGAQDEAhAAADAIB.AEDB.hACA..bDDC..gEGBhAFAPFFB.cGGCfHGF.hCAA......hCDA....,2,-24,-7,17
fZKHWBROQcGNVAegXFCPdYJDITELUbMSa,eAAAFAAAdADADAEA..EAFALAHB.MBDAaAHDZCCAHCCARDFF.QDFDhAAAGFABADBBCDHBPECBhABA..IFHAhAFAbGFAKHCAOEEH......hBHA......hCAA...,1,-5,-28,23
KFEdXeOLJQaSWADVZbRGIUYBNfTcPgHCM,ZAAARAAAGADAUAEABAGA..TAFA..PBHDHCFCMCCBhAAAFCAA.EDABdDDAeDDDhABALEBBaAHFAEIBbFAC.hABA.IEGA.fFEACFFAOFHB.hADAQGGA.hAFADDAB.NIAB,2,-34,6,40
AZMYJUPFELOTNScbKWQVGegfRdDHCBIXa,ZAAAMAAAUAEAFADDLAFA..TAGASBBBKCAAQDDAhABAeCEARDFA.HDFAhACABDDDaEBBAAGAJFCA.EFHBhBAAOFGD.NIAB.cGGC....hCAA......hCBA...,1,-15,-24,9
GTKBCJUPNFEWdfLeaIYVcMQORbAZgDSHX,ZAAASAAAHAEAGCAABADAUAFAFBHDECCBdBHALDFB.eECAhABAaCCA..VDAAMEHBhACARDFBAAAAXGAA.hADA.TFDA.CFHAPHECWFHH...hADA......hAEA...,1,-3,-18,15
CPfAIeNSJgWFREbQUHTKXBZdLDcVOMaGY,eAAASAAA..gADARACFEAEEQAGCHAFBKAHBZCDBdDDAhAAALDGBDCCBODGDhABAaFDECGHAADIBJEAB.bDED.hAAA............hABA......hAIA...,1,-8,-23,15
XaCRSQZGYWUgcFBDdJLNAbEeTHOfIKPVM,EAAAHAAA.OACAKACAMAEAaAFD...RBDAZBGBGBGA.UCCAFCCHdDFChAAALEFBACIB.eEHHhAAATFGAfFBAhAHAVGBA.SFDA.....hAIA......hBGA....,2,-17,3,20
FERTQedUBZHbADfMICKGWaOYXNScVPJgL,MAAAKAAAGACA.OAEAXACA.SAFAVBGB.JBBFhAFALBEBRCFA.eCABhAAAdDDAZEGBHEFAAAIBfFCEhAGACGHAaHGC.cFEB....hBAA......hCAA...,2,-25,-10,15
CAEVUGZSgPBaIdHXMLTfWKNDObcFYeRQJ,EAAAGAAAZACB.SADABAEAdAGAHCEAMAGBLAHB.TCDAhAAAKDHBOCBHFDCHREFAQGEChACAAAIBUEEBaECD.hAAAfEAEDFHB.YHBECGBD..hADA......hAEA...,2,-22,-1,21
fRdSPTKgHLbcUJOQeMNBEaFDGZWAYVXIC,XAAACAAARACA.dADASAFB.KAHBHAFA.bCEAUCAAhAAAQDBAeCDFMCFBhACAEEEAaDHDGCGAAAAAIFAAhAFATGDA.LGFAOFGHFHAADHAAWHAAhAHA......hAIA....,1,9,-9,18
RgYVIDCcOeWUJBNQATFHPESdfXaGbMZKL,HAAAEAAAdADAaACAGAFAZAEBRAGB....VDCBCAHAeBCD.UEFBBCCChAAAAAFBFDBHSCGDhAIA.XEGAbEDDMCIBhAAAKFEA....gGGADGHB.OHAChAHANIBB....hBDA...,1,-6,-11,5
SKGWCbDELeNIcMdRUHgTfPVFaYOJZQBXA,GAAACAAADACA.EADALAFAeAFA..ICDAdBCAHCEA.TEBAhAAAfBHA.FCFBhAAAaCHDODAHZEEAQGAChAGAADIBKEEDbFGBcGABRGEA...gGEAhACA...hAHA....,1,6,-8,14
SDAOQfNEeYabdcHGgLRZUXFTKBPMVIJCW,QAAAEAAA.eACAbACAHAGBGAFARCCAZDAFFAHFBCDA.MDABhAAAIEEACDCD.DDGBhAAAADFBODGDfDHAhADAaEEHdFBALGAAUGGB.TGGA...hADA......hBFA....,2,2,4,2
gVTLBfUEDXaGRWJSbHcQdOZFPeCMKYNAI,VAAATAAA..LADBBACBEAEADAFAGAGARBFA...SCCAhAAAHDEAdDHAZFBAeCEHhAEAMFGBKEGDAAIB.fFHAhBGAaDCH.bGDC.......hAAA......hAIA....,2,-14,-9,5
fARMOKTDcFZGbgISUJaVWHQXBNLYdEePC,RAAAMAAAKADC.DAEAZAFBGAGA....bBGDSBBA.hAAAaBDDHCCBBBFCLFBAhABAEDEAeDHHfBEAhAIAAAIBTGEA.FFFAIHHA....hBAA......hBBA...,1,-17,-29,12
AQXDCaWJUBIcMFbLfEOKZNHgTYRGPVeSd,QAAACAAA.aACEUACA.BAEAMAFALAGBEBEA.ZCBAhAAAHBGB.TDAAhAAARDEFGEGAeCDBAAIBDCIBIFFAhADAFFCB.bGCC.KGHB......hBIA......hCAA...,1,-2,-35,33
IVTFefcBPWRLXAKZMCQDGbUHagJEYNSOd,ZAAAMAAAQAEAGACBHAGB..aAGEEBBBSCAAdDDA.hAFATCGAeCFBBDHAhAGARDDAAACADEAAbFEA..gEGAhABANIAB.OFFH.FHAA...hAIA......hBAA...,1,-4,-10,6
JZMAYPeXcVINDSWFTdbLQEOGKBaHfUgRC,eAAAXAAA..IAEASADAFAGAdCCALAGB.EBFFhAAAGBEBaCDBHDABfDFEhAAAREDAZFGBAADAcGEBhABADDBBbDGDKEDABDHACHHAMIDA.....hAIA......hBIA...,2,-13,-2,11
YOUAXQgBaLVbfIHGKRZcPEMNSTDJWdeCF,QAAAaAAALADA..VACA..bAGDHAFBRCCA.ZDDAEEAAMAIBhAAA.TFAADAIBdEEAhAEAeDHBFEHBOFAEhAFAAAHBBFDAfFFEGGEBKBBD......hAFA......hCAA....,1,5,1,4
YXWKFaITPBgGMUDZfcHJVLdOCeAESNQbR,EAAAQAAARACA..XAFBFACEaAED...TCDABAGAGCEBhAAAMAIBZDAAHDCALDGBhAAAdEHAeFFBABHBbFCAKGAAhAGA.IHHA.PHCCDEIB...hADA......hCAA....,2,-4,2,6
HYAZDPKOUgJBebXNLEWMVGfCFSdRQcTIa,ZAAAKAAAOACAUAEABAGA..eAFA..XCAAEBCFMBIBGCGAhABAFCEARDDB..TFGAhAAAHDDBAACA.DAIBgGAAhAGAbGDA.LHDAfEBESDFAhCAA....hCBA....,2,-21,1,22
INSEVdQYJUbPaWgeZCOcMfFXRHTBLDGKA,SAAAEAAAdADA.QADAUAFA.aAFEeBCD.ZCFEOAHDhAAAMDBBFEDDHCCALEHBhAAAGCFAADAA.IFHAhABANHBB.VGAAbFFB.PEEBCAHA...hBDA......hBFA...,1,7,-15,22
aQEHIATBNPFWfgMOYCRdGeKDcSbJLVXUZ,TAAABAAAFACA......fACBMAFACBCDRBEA.eAEEDBIB.hAAAbBEDLDDAUDCAaAHDhAAAHDGBACCA..PDHBhAHAOFBAGGCBSFFD.JHBA..hBFA......hBHA....,1,4,-23,27
AMGWJPCgaOBEXcDReNKLfQYbHISdVUFTZ,GAAAJAAA.CADA.aADAEAFA..DAGARBFAKCDALBEA..QDGAhAAAHCCAdDGAFEEBAAIBMDABhACA..PFHDhBAABDCDeEEB.fGGAbGBCSGEHhBGA......hBIA...,1,-18,-25,7
CaPOLWBKYDENZFIAQUbTGcfHSMRXgdeJV,QAAATAAA.GACBHACBRAEAdAGAeAHHCCDD.aCACLCFAhAAA.KDAAECFFZEEAAAEAbEDAhAAASEGEMDIBXFGDhACAgFAAJHAAOHECBGGDDGIB.NIAB..hAHA......hDEA...,2,-3,7,10
TENOXVWYdGMfCSIAgRDbacHJQePBZFULK,RAAAaAAAHADB.eAFAZACBLAFAEBHF.XBECVDAAdDFAGCGAhAGAMDIB.CBBD.AAAADEEBJDEBBGDDhAHAKFAD..TGCAhADAOFGH..fFGA.IHHAhAFA....hAGA....,1,5,-20,25
XGKdMTJDQgZcWeYIfHCObUVBESAFNPLaR,FAAALAAARACFGAEAdAEAMAGB..TAGAQCAAZDFBeCHHhAEAIAHAHEDDOFHDhAGAVDDABCHAAHGB.aEGD.hAIAKGFD...DEIB.......hBAA......hCAA....,1,-2,-19,17
MbfeDFESNYaWdgUVHOPKBXLZCGRTJAcQI,QAAAMAAA.eACAEADASAFA.aAHDdAGAVBBBhAGAHBEB.KCHBLCFBhBAAGDAARDCBADEAIDHAhBBAbEGDFFFBNIAB.gECA.OFGD.hAAA......hADA...,1,-1,-3,2
QPaVAMDUdCTeWgNBYFZOKbLGcXIEJSRHf,MAAAdAAAeADA....gACABAGAZABBKBHBGAEA.XAGAhAGAECEARDCBHEABQCGDhAHAaDHHAEAB.CDDATEGAhBAA.NBBAOFFBbEEBIGGAfGHAhCAADGIB.....hAEA....,1,5,-11,16
SODbgKMQAWVEdFYaUcRXIfPCBNTeHZLGJ,EAAAdAAAaADARACA....XAFB..fAGABAHAeCCAhAAAHBDBGCGAOAHDhACAbDACKEEAABDBFCBD.cDEDhAGACFDDZGDE.LEHBDFIB.MFCB.QGFAhBAA...hADA....,2,-5,-3,2
GNXeLDMVbTYfQRBcIPWEJAKdOHaCUSFgZ,dAAAHAAAaADASACE.ZAEBGAFAeAGFMAIBbABD.TDCAhAAAQEBABCCCIEFAhCAAEAHBABEBCDHAFEDEXEGDhCEALFGBDHCAfHDB...hCHA......hDAA...,1,-6,-10,4
IKFaOdCAEcePXRNJMGBgYWVTZDUHSQLbf,EAAAeAAARACA.MAEAGAFABAHA....gCCAVBCAZBFFHDEBhAAALAHB.bDADKCHBhABAODFHAFHAXGGAhCAAJEHB...YHCADDABSGGD.hCBAfHBB.hCHAIHEA.null,2,0,0,0
MBgGCZOHLAXKWYENVQcDJfIUaPFdbTReS,KAAAEAAA.QACCDADA..IAGAaAEAdAHARBEBeAHH.MBCAhAAAGDDAZCCAHDFBADDBXDGAhAAANDIA..cECAhCAAfFGA.FGCBbGCABHHACFCD.OHDEhBHA.....hCBA...,1,-3,-14,11
UdDOaPGWCSHLBMKQNTRFZefcEJYAXgbVI,XAAAVAAA.dADAaADAGAFA.CAHA.HAFBLDBAMAIBQCDChAAARDGFZFAA.eDGFhAHAEFDEAAAAbEBCDFIBOEHDhBEASGGDKFEBFHBAfHAB..hAFA......hAHA...,2,-15,9,24
eGQNYDOZASaLgUTJHdfREWKcPXCbMFIVB,aAAALAAA.TAEAHACBRAEA.EBHFKAGC..XCEAMBIBFCAAhABABDHAeCEAGEAAhAEAQDCDDBBBAAHASEEBhAFAgDFAdEAAfFHAPFGD.CGFA..hACA......hAEA....,2,-6,1,7
cdLbJAVYOZeCHGPfaIgWNQRUMKSBDFTEX,OAAAeAAAHADAGADAaAFA....ICCAgAFB.QDBAhAHARCEAMAIBBEEDhAAATDGAEEGAdFCALFBAhAIAAFIBZGEA.fFFA.NIBBSGHBhBAA.DBBB..hBDA....,1,8,-5,13
fHTEJVDCdXOFKUSPYMgLRIQbNWaZGcAeB,eAAAHAAAEADEDAEAdAHAFAFAKBHB..SBCAMCABLCCARBEFQDBAhAAA..bCFDhAAAaDGAGECAABGABEEDTGGAhACACEGAOFHD.PGEAIHEA..hAIA......hCDA....,2,-15,5,20
DPUVbXEgYcSIKaAfQWJFeCdLMBRGHTOZN,QAAAFAAAeACHdAEAMADAGAGAHAFCZDDADBDB.UCEA.XCGAhAAAEEBB..gFDAhAGASEBAaFHBAEBAfEGAhAIACGBD.BFHA.OFFHhBCANIAB......hBEA....,1,-1,-15,14
HKPLXOIYQfCNDMgGJaUZVFecRdTAbSWEB,SAAAEAAAHACALAFBOACD.QCCBCAEA.MAHBGAFAhAAAaCHDZEAAeAHBREEAAAIBbCDDhABAKFHB..XDGDhAEAfGGEDGGA.........hAIA......hCAA...,2,-24,6,30
YSXBGTOceMDIVNFdaAZfHWCKgQPbUJREL,HAAAKAAAQACCUADAEAFALBHB..XAEBGCABTCFAhAAAeAGFMAIBDEEBIFFAhACAFCDDACHBZDFACFFAPFHBhAIAJFHF...SHCA..hCAA......hCHA....,1,9,-22,31
UAeDbKFOQJfHVIaTgdRXLMGBNZcCYEWSP,eAAAKAAAQACCHADAaAFA.dAEARCCB.LAGBGCEBZEFACDDA.EFCBSCHHhAAAAAAA.FDFHhAIAfGGA.hBGAIHEATFGAMGCABBHA.NIBB....hAIA......hCAA....,1,3,-15,18
HeGQIJAbEdDCNUgVFPLMYBWXRfOacTSZK,EAAAdAAACADAUADA..FAFAMAGBBBEA..RCBB.OAHD..aAHBhAAA.TDGAZABBHCEChBAAeDDHGDCAQFEAhBCAAEEADEHB.gGGBLFFB.YFBFhBDA..WEHH..hCDA...,1,2,-29,31
YPJGcfQeBUSMDXgbVLHaCKEOZdWRATFNI,TAAAFAAA..IADAJACA..GAFAQAFAeAHBSCCAhAAAMAIBDCCAXCDAhAFAbDCAHDGB.aFAAEDGBhBAAdGGDAEEB...NIAB.cFFA.BHBA.hAFA......hAIA....,1,10,-29,39
DbOfaLZdYgWAPNMIBHKUGQCJXcFSeEVTR,MAAAHAAAGADA.QAFAXACASAFAECABRDEFDAIBOCCBhAAAaAHDdCCA.gCFBhAFAADGAIEHAKEDACFAAFGFDhACAeDHH.TGAALHBAZFDE....hADA......hAFA....,2,-4,14,18
cXUeREGaCKHJFPVdBWMfYZQNDATIOgbSL,TAAAOAAA..SADALACBXAEARAFFGCCA..aAHDHBGBhAAA.FCEBdDHAMEAAhAEAZEAFQEFAhAEAAAHAbEFAeFAAEFEBKBBDPFEBBGGA.fGHAhAHADIBA......hBAA....,1,9,7,2
CGIAeBUcXLMWHbaZFdSTQfYERgVPNJDKO,eAAABAAAUACALAEAHAEAZBAEdAHAQCDA.EBHFRCEAPCBBhAAADCGBCDHAGFAB.hAGAAAAAMFDAaDDHFDHDTFGAhAFA..fFFA....hBCA......hCAA...,1,1,-27,28
TEPBGdaHRUKOSYLDFQVCJZANIbceXMfgW,..IAAAeAAAMAEA....fACATBCAEAHFGADAhACAHBEBRDGBOAFALEBAhAAAQBFCCFFAABGBNICB.hABAbDFA.XFFA.PHDAaGHD.SDDDhBIA.DGIBhCAA...,2,-18,-1,17
JaMPOLfDUQYBXZWCNdcGRbVTFAHeEIKSg,HAAAEAAAKACASACE.aAEDMAEALAGBDAIBQBEAhAAABCCAZDEACFDAdCCARFFBTGBAhAAAABHBeDFAJEDB.OEHDhCAA.UFFAWFHH.NAIA......hCBA......hCGA...,1,-2,-18,16
AegBHQdXWbVcSMDJCaOYGPLKNfZERFUTI,eAAAHAAAdADA.XAFAbADA..SAHBMAIBDCABaCCCGBGAhAAA.LCCAhABAKCFAZEEARFAATEAAAAFABEHBQECChAEAVGEA.CEEBOEGH.YFHBhAFA....hCAA...,1,-5,-7,2
IFbDgBfPZEWNTUaSVYKMQcORGXALHdJeC,HAAAeAAAFADDDACABAEAZAEB.EAGA..TAGAaBGE...SCCDhAAAKCCAMCFBQDGAhAAARCFFACIBdEHA.CECAIGAAhAGAfEEEPFGBNIAB...UGDAhCAAcGGC....hABA....,1,-8,-15,7
YGLTZFOQBWJebRDEgXIKAVSdMPHCaUNfc,dAAAHAAAaADAUADA.....fAFFGAFAZBDFQBGAhAAABAHAeCAARCAAEDEAXDGDhACAAEDBMEGBCFDA.YEHBhACATGGAFHAA.OFFBWFFDDIAA..hAIA......hCAA....,2,-13,6,19
eFUfZHTWBdaGSVXRQgONDKPbMJCLAYEcI,EAAAeAAAFACDZADB.HAFABAEAGCEA.XCGARAFFQCDDhAAAOCCHKBHB.MDHBLFHBhAAAAAHA.IGGAhABATEAAaEECSHAAVGEADEIB....hAEA......hCAA....,2,-11,4,15
MTBXDPZOFAaHUdRbNSgcQLCEWYVIfeGKJ,HAAARAAA.SACEQADCEAFAVAGBeAHFGCEAMCCATDDAhAAADCCBZEGBAAAA..dDFAbFAAhAFAgEGH.hAGALFAACDDC.IHHA...hAIA......hCAA....,1,10,-7,17
JAKQIVNOecELPaGWfUCdZXSTYbRHDFMgB,QAAAVAAA.eACAEADELAFBGAFAUDAAZBGB..TDCAhAAARDCAHDGBFEFHMAIBBCDBhAHAAAHBKFDAODHDaGGC.CFCDdHGBhAIA...........hAAA......hADA....,1,4,-9,13
ITNUHRVXQOWCMYEgeABfcLFDJZdSKGaPb,BAAALAAADACAdAFAGADA.aAFA..IAHATCAAHBFBhABARBCB.QEFBhACACBEC.EFBAACBBFCGDSAHHhBFAKEEA.PFHDbFDC.NIDB.....hCAA......hCCA...,2,-51,8,59
bYXaCFVJUgNWPKISRcBEDfMLOeGZTdHQA,XAAAaAAA.FADAUADA...NAGA.KAGA.RBCFECEAMAHBeCGFhAAAZCCAHEFC.AAIBCDBDgEEDhABA.IEHAhAGABFBAfGGE.OEEHhBAAdGHA......hBBA....,1,-15,-20,5
cdAWMfNRCHZSEBeGDLTFXabPQVKYOIJgU,MAAARAAAHADBZABEEAFAGAEALBHB.FCCHaAGA..QDFAhAAAKBHDOCCBIDAAhABAUDGBADEB.fEEEhADACFFD.eFAATGBAXGCAPFHBYFHBhAFA.....hBAA...,2,-24,20,44
YXFcIbgLOeUKCRJBMSfVdNPGTZHQEADaW,aAAAXAAA.FADAIADA.LAFAeAFHCAHARBCFBBBDMCHBhAAASCDA.hABAdCGAGEDAHECAAAGADCIBhAHAcEGDbFFDOFHDKGDAfGHA.hCAANICB......hCBA...,1,-13,-14,1
ObEDJdHAVICBNUKMgXLfZYWaPQTRGceSF,CAAABAAAKACA.MACALAEBZADE...aAGATBGA.GCBAhAAAeBGBOCAAEDDE.dECAhAAAHDFBACIB.IFDAhAHAgEEAfFHAPEHD....cGGChACAFHEADIAA..NHBB.hBHA....,2,-18,-2,16
aNYdVEBGJMHcDZQXFIAebCPOgfSTWRLUK,eAAACAAA.OADCSACARAGF.LAFAaCCA.dCAAECFBGCCAhAAAHEEAZFAAQCFAhACAFFHDAAAA.bEFAfHEBhAFATGAAKFEDNIABBDDDMICAXGGC.hAGA......hAIA...,2,-5,6,11
DfMACLNJHGZBYIXEaSPOReKUgdcTFWVbQ,LAAAHAAAZADBBAFAXADDEAHB..aCACOAFA.RBFFeBHHhABAKCFAdEEAFCAA..bEFDQDDChACADDIB.AEIBCFBAhBFAJFCBIFFASEHDPFHB...hAAA......hACA....,1,-3,-13,10
aQFHgcMCdeNSPBAVDOLfTUWXGJKRZEIbY,OAAATAAA.UAEAGACA.RAEA.EAGA..ICGAaBBCHCFCMAIBhAAAeDBA..SCADhACAABDALEEBXDFChAEAKEGD.bEDDFGHBCFAAdFGANIBB.BHAA.DEIBhAFA......hAHA....,2,-9,10,19
AIJCDRUHTgGFLPZWSOEfbaNceMdQYBVXK,CAAARAAAHADBGACALAFAZAEA.OCCBECAB.aCGAeBHH.dCFAQDEAhAAABEDAKEHBAAFADDABhABAUGFATDGA.FFHDhADASHAAbGAA.......hAGA......hAHA...,2,-23,2,25
AQfGVRWENbSLZBTDcJXIPKCdgYeOaFMHU,GAAARAAAEADE.SADAZAFBDAIB...XAFDKCCAdDHAeECAhAAAaAHFHCDA.AAABQDGAhACAVFAB.bEAATFFAhABAIFEACGEDOHCCMHBAfGFAhADA.....hAFA....,1,10,-14,24
VbADfBKUEOLcFXadgYZJTGeNPQHCIMRSW,BAAAEAAALADAFACAdAFAZAGBGAGA.eBCBQCBAHCEBMDIBhAAARDDF.SEAAhAEA.bFAAABIBKDHBUGFAXFBChAAAaGDD.JFFA...TGEACHHB.hAFAIHHADIAA..hBCA...,2,-32,24,56
gbTOPZDLRXMVeKacJSCIUFfWBdAQHNGYE,HAAAGAAAEADE..bADATAGA.ZCAARBGFMCDBeCCEKCGD.aCHDhAAASCEB.hACACAHBFEAHBEEAAAABQEEBhACAgFAADFGALFHBXFCD.cGGAhAFAIGGA..hADA....,1,4,-5,9
PLDOJIZMEdAgefYGaFHUXQTKNSWbBcCRV,eAAAGAAAHADAQADATBGA.SAFABAHBRCCBLEFAhAAAOAHDZCDAECFBAAFAfDHEhAAAaGGAFHEA.KEEA.bFGDhACACHHD.DDAB.MGAA.gGCA.hABA......hCAA....,2,0,15,15
SOFWQXAbdCUfHeTZBKaNJVLPRIGMEYcgD,dAAACAAAHACAeADAZAFBKAGA..aAHD..VCBARCAAGDGA.EDEB.hACA.gCFAhADAOEABQECCACFAUFFATEAAhAEABGEAJHBA........hAAA......hACA...,2,-23,-5,18
YHCLQRfVTOaXZBeAJEWGgMKcPFSIdUDNb,EAAAGAAAKACA.FADAdAEADAGA......bAFDHBFALBHBhAAARCDBTDGAaCCB.ZFDAAAHAJDDBhCAAMDCB...SFHHhAAAIFFAYFHBfHBB..XGEChCBA.BHCAhCHA...,2,-24,-12,12
LWGYDAQMBHCSFacVNXdKObUJEgITZRPef,MAAAHAAAFADA.aAFDVADA..dAHAOAGDUCAB..EDDATBBAhAGARDFA..eFFALDDAhAIA.GEGAhBAAAGDACGHASHBAXFDA.......hBBA......hBIA....,1,-11,-15,4
bPJOeXIGHcMLASRTZDaWCUQBEdgfYNVFK,RAAAZAAADADAaACA..CAFA.QAFABAHA.ECCBdCCA....fCEAhABAVCFA.bDFAhAFAOBEB.eEFBhAAAGGDB.MECBAEIBSFHDWHBG..hABA...YHAAhAHAKAHBJFFA...,2,-37,7,44
DPSXKIEbgWfYFGdRaVHeLAQTcNUOZJCBM,TAAAUAAAZADA.BAGBMACA..DAIBXAEA..ECDAbAGDhAAA....fCGAhAEAGCCAREFAHFDBhAIAADCBQEECODBHCGHAKDHB...IFAAhAFA.gGGAhBAA.YFDF,1,-8,-31,23
WZTeEACKMJPFHagfdbXIGOVLRYBNDUcSQ,MAAAFAAAHACB.aAEAdAEA.XAGAGAGALBEBRBBBBBDCDCGBSDFHhAIAZDEF.EEDBhBAAAAGAKCHDJEHB...fEHAhBAA.bGFA......hBBA......hCAA...,2,-30,-12,18
daEFPGRAYINTOVegDUbfBLMWXZCHKScJQ,..IAAATAAAeACEDACA.UAFABAEAMAIBZAFBHBCA.SAHHhBCAQCCAEDEBhBHAGDFAADHA.ODBBhAAAbEFD.LEHBCEHA.KFDA.dHBBaHEC.hBDA......hBHA...,2,-20,-1,19
aAbgCDLIEWRZSPGFeXJcBfMUTHQOVYKNd,CAAALAAA.EAEARACAZAFBGAGAeAHFJCAABCAA.UCCBHCEB.hAAAQEAAOCHDKEFAhACAaDHD.AAIBDEDB.SFGDhABAXFAAMFEBTGDA....hACA......hAEA...,2,-30,-7,23
cfTadZBWPHUMeYKAgXSFERDQVNJILGbCO,SAAARAAAQADC..VADAJAFAGCDBOAGD...TEFAhAAAZCCABDAAHGCAeCHHhAAAACCBFGHBEEEBDCGALGAAhABA.bGEA.........hABA......hAIA....,1,-7,-9,2
BLfUTZOAEdQMGJbDKgICYXPRaVFNecWSH,EAAAdAAAGADADADA.KAFACAFA....XAGDRCAAaAHD..FCFDeBCBhAAA..SDGHhACAHCEALDBBTFAAhADAAAIBMDIBbFFA.gEEAYHAGNIEBBGGAhBDA.fHEBhBEA...,2,-29,-5,24
WSONgAUTcFRKLICMdXZBVfeaHbGPDJYQE,TAAARAAALADB.MAFAZACBBAEA.eAFHHBFAGBGADCCBQDEDhAAAECABOCEHABHAFDHBhABACAHBdFFAXFBAhBFA.aFFC..........hCAA......hCDA...,2,-19,-13,6
ZOdYIHKSCRVMJNFfabLGcXAPQBTegEWDU,QAAAeAAAEADADAGAZACB.dAFAHBDCKAHBRCFAMBHB.FCCH.aDFDGEBAhAAA.ABEATEDAhAHAgEDFUFGAODHDhAAASHEGCGBA..NIBBfGGAhABA......hBGA...,1,-8,-13,5
HEKCFOPGWTZbIgVceXMdUNLRafSDABYQJ,QAAAHAAAEADEFAFAGACBZBFE...bAGBICCA.VDFAhAAAeCDA.dDAALECBhACARDEAaDCHDBIBAEEBBFFDhAIAKEHBOFGBPFHD........hCAA......hCEA....,2,-2,-1,1
EOcSNDdVLRGBZHaJgWYfXTUMPFCAbIQeK,QAAAEAAA.SACAdADARAFAZCBAHCFCaAED.JEFB..gAGAhAAA.fCDEhADATFAAMEIBhAAACCHAAAGAeDEHOFCDDDGB.LEHBBHFA.YHFAhCAA...hAFA....,1,-2,-15,13
FUVEHcfeLAIWMgODYQXTSKCdPBJRbNGZa,MAAADAAAQACA..TADACAEAdAGABBBDRAFFGBBAZCFAFDDBhAIAEBHFHDEA.eDHHhAFAABIB.gGFBhAHAXEFAKFEDPEDB.NIAB.aFHD.UGBA..hBAA.cGED..hBGA....,1,14,-18,32
ZJQYbPBUaKcgSORIHDFfVeXNGWMATdCLE,dAAAEAAAZACBQADA..bAEABAFAKCEA.SAGHRDFA.hAAAHCACfECAhAFAeBHHGDEAAAIBTFGALEDDhACAPEEBaGGAOCBHFHFENIAB.MICA.CGAA.hAGA......hBCA...,1,7,-9,16
CJFNOSbWTMEcfYAGLRBKXdIUaDgVZeQPH,RAAAXAAAdADAUAFADADA..ZCCA..eAEAHDFBFAHDOAHF.hAAA.bBCDMEEB.EDHBhAAAfCFA.hABAADHAGEFALFBBKEHBaGHBQFCAhABA.CHEA.....hCAA....,2,-9,-6,3
QHPIbBTLdYZNFUAaDeWGcKVSJCMOXgRfE,eAAAGAAAKADASADA.MAGBXAFBRCDB.EAHFHCGBhAAA.bEAATCCAdFFANHAB.hACAAAAAaCEDDAIB...cCGDhCAACHGA...fECE.QFFAhCBA.BFHAhCCA..,2,-14,-8,6
YfKMaSHIFNgUTeAZEBcRPdDGJLXCbOWVQ,EAAARAAAdADAGACALAFACAEA...OCCBQAGAKCGA.aCBHHDEAhAAAFCFB.UFGAADHAZEAABEDDhABADEEB.XGAAhAGA..bFFA.VGAAMIEASHEAhAAA......hAEA....,1,1,-11,12
PSZQJRFXcHUTICOeWfAEgabBdYNGVDLKM,EAAAaAAABADAdADAGAFALAFAKAHB..MBCBZBBARCEF..FDDAHCGBhADAUFAATGAA.ODDHhAGAeDGHADBB..bGFAhAHAYEHBDGFA.SFFD..hAAA......hAFA....,2,-11,-4,7
BEdXDMTWHbCYNUGZSQIcagPVRAKfFLJOe,FAAALAAAeACHdAEAMAEAHAGB..bAFACDDAUDGB..ZBEAQEBChAGAaCAA.VFDAhAIAADDAfDEAhABA.BDGDEGHBDIBATFFA.YFHBhACA......hCDA....,1,-8,-13,5
LfRNVcMUICOPdBKXEHZWbeDJQgTAaSFYG,aAAAFAAAGACALADARAEA.....VBGBMAIBCAHB.dCGABBBDEEAAHEDAhAEAZCDB..eDCFhAEAQFGAAEGB.fGDEhAFAcEGDOFABKHAA.XFDAhAFADIGA......hBAA...,2,-24,-1,23
YWdDTFJHSXRcBbNQMKEOaLACPgfeUGZVI,CAAA..fAAAeACAZAFB...VADAIBHAdAGAFBCH.HCABhAAARCAABCECQDEAhACAKDGAEEEB.aBHDLFBBhAAAAEDBgEGBUGGA.........hACA......hADA....,2,-19,-1,18
FGYKTJEdDAagfZIXONPBcMCRLeVbHWSUQ,aAAAZAAAOACABADA..MAFARAFALCCA.eCGFHBDCSCHHhABAQBGCGECAhAGATDAAEEEBABBBfCCEhADAXGGA.cDGDCFHC.VEDB.UGGAhBAA.....hAIA...,1,-2,-10,8
NBRQYATKfJDaZbELCIdFMHOegXVScGWPU,TAAAKAAADACAZADE..EACELAHBdAEAHAGB.eCCB.XDGAhAAASBFAGEDAhAGAPCCBBFFB.QGBChAIAADFAaEDD.CFHDIHHAMEHBOFAB.hBGAgFEH.hBIA...,1,3,-32,35
SdYUMFXNVPGKcgbZBQHfEOLJeRaCTDWAI,dAAAMAAAFADA..XACA..PAGBGAFAKBDD..bCCChAFAZDEAHDGBECBFLAHBhACAREEBaAHFDBBBADIB.SFBAhBAAUFCAVFFBBGHA.OHBA..hBFA......hBHA....,2,-20,10,30
HUbIGSMcBPaNQTdKWCAYDVJXLOERfgFZe,DAAAXAAAEACA.RADA.FAEDHAGB..UAGAGCEAMBBBBCDD.hBAAaDAATCCAdEAACDHAAAAAJDFAhBGALFHB.fGDAhADAeEEBSGFHcGAD....hBIA......hCAA....,2,-24,1,25
BWVaGLOFTKgXRDQNMHJfPUbEcCIZYAeSd,eAAAdAAABADA..aADDGAEALAFATAGAXCCC.RCFAQEEChAAAHCACfCHAhACAbFCB.EEDBCEHAIGAAhABAADGBSEHHOHEAKFFBDGAA.MIAAhADA......hAGA....,1,2,-4,6
MRGWTfLbKUgACadBXeIHcPNZFYQSDJEVO,dAAAeAAAHADA..PADCZABBQAGC.DCFBEAGEMCIBhAFARCCAGCFA.TFCAhAAAbDCDKEFAACCAaCHFBGGAXFGDhABAIHDAFHDE.......hAIA......hBAA....,2,-11,-2,9
DWeZGTIKNUVHJgQdfRLSAEaOcCFXPMBYb,EAAAaAAA...CACAFAEAMADA.BAGADAHBZCCAGBBB.KBHBUCGBHCEChAIA.QEBAhBAAREBAAAIB.XEEC.hAAAbFGDeEGF.IHHA....hBEA......hCAA...,2,-41,-6,35
YFAOPCMHaDbfLdWeUNQBRJXTKIGSVgZEc,CAAAHAAADACA.LADB.eAFAQAEARCEFTDGAGBCA.hAAASAGAZFAAECABFDCHhACAABCBMCHBbGFAdHCDUEEAhAAABBHAKFHB...gGDG.OHAChAHA....hCAA....,2,-16,16,32
UFPBGDfdJRIeSVAgaZLcXTYbWEHMQKOCN,ZAAALAAA.TAEAbADBHAFA.MCABQAGC.CCAAFCCAhABAGCEAdDFAREAAeCCBhABAACIB.aCGEXEGDhACAEEGAOFHDPFEBfHABIHHASGGDhACA....hAHA...,1,-1,-4,3
LZNGCaDgVJXdQHFeUAPMWBEcOfIYTKSbR,MAAAEAAA..OACC..fADATAGASCCAhAAARAEFZAGBGBBAaCEDDAEAVEDAdCGDhAIAHGAAeEFAABBBBEHAhAGAIGEAbGEA.CGGA.........hCAA......hCBA...,1,3,-20,23
CfOMRAJPHLWVKEcYGTIQgFUDXaSeNbdZB,HAAALAAAKADCEAFAGADA.QAFAFAHDDCAB.aBHDeCCAdCAAZDEBhABACCFA.MCCBACCAJDGBPEHBhACA...cFAAhAFAIEEA..XGEASEHHhAAABHBD.ODDH.hACA....,2,-29,18,47
EGDaUcfeFTBHCOLXVRIANdbZSQJgKMWYP,dAAAZAAAQAEAKADA.MAHBPAFAECAA.GCAB.aBGEfCDAhABA.eCHHhACATDEAHEAALDGBhACAREEBAAIBbGBASGHBgFCADDIB.FGFHhADA.CECA.....hBAA....,2,-5,14,19
bGKWLYFeOfEBJaRCdMTSAQVPgcNDUZXHI,QAAAVAAA....PADAgADADAHBZBDEHAFBGDEAhAAALAHBFCHDeEDDhAIAEDAAaDDAdGGA.MEEBAFIB.hBIAcEAD.XFFA.KHBA.OHEChAAA....hADA....,1,16,-14,30
EbLPAKMQVGCWOYUZDaXcFIBHfNJTegdSR,MAAAGAAA.OADAZABEaAEDFAGD.HCDAJAGB.eBHH.dEFAECCBLFCBhAAAAAIB.KEHBQDFBhAGACDCD.UFFBhBAADGHB...........hACA......hAIA....,2,-32,-6,26
BOLNAgUebcISMPRTZEVWCfaFXGYHDQJKd,eAAA..bAAASADARAEAZCAA.EAGACAHBFCEHGCCAHCGBQCFAhAAAdEAALFFAABIBgEABhABAIGCAMICAhAAATFEA...fEHA.aGAChAEA.DGIBBHHAOHDChAGA....,1,11,-5,16
OMVFScZaQTCXfgJPINBdDRUKbAWLeYHEG,eAAAHAAAEADEGADAMAFASAFAZBDE.aAHDTCGA.fCAEhAAAgCGGIDEAhACAdDBARDEFKFADABHALFFAhCCAOFHBFGFDCEGD........hAAA......hABA...,2,-6,-1,5
UgdCEOHFGZWQIfcaXJBTAeSRPbDYVNKLM,RAAADAAA..VAEALADA.MAHBdAHAECCAHBBAZDAAQCEAhAEA.IEHAhAFAaDGABEEAAAIBeDDBbEGDKGEBCFFAFGDHhBAA...fGHA...hAAA......hABA...,2,-27,-6,21
KRCcfNYAeMEDZgVQHGTUIXdBOPaJWLbFS,EAAAZAAAQAEAHACAGAFAUBGAdBHAOCCB..aCAALDEBhAAAbDAA.KEABREDFCFGAfEHAhAEAAADA.eECHhAFAMEIBDGGBgGFGIHAABHEAPHAAhABA......hACA....,1,8,-2,10
JVUSXMTIEOgKCGFBZDAPWbYRHQafcLNde,...bAAAHAAA.aACALAEAeAEHUAGAMAIBECCBKCAAGDFAhAAAZCEAAAAA...PFDBhBGAREEAQFAAfFHAhBIAdGCASDDG.TGGAOHEC.hACACEEC.DEIB....hAFA...,1,9,-9,18
YGCMWEaPDLNAZVQcFbSJOTXHgeRKIfUdB,ZAAAQAAAFADA.SACATAGAHCAARAEFKAGCUCEA.dDGAGCFAhAAA.MBIBEEDBaEHDhABALDAAACIB.bEDDhADAXGAAeFGHBHCDCFFD.DFIB....hCAA......hCDA....,2,-12,10,22
JZWHXFaeNTMfKIPbGdYgLCScEOBAQUVDR,QAAADAAARABAZAEB.HACAFAGD.eAEE.MAIBKCHB...bCDAdCDChAEALECASDFHhAIAEDHBAFGAUGGAJHAAaGGA.hBAA...fFEE....hBIA......hCAA....,1,4,-31,35
QgeTKCOLWFSbMXJYaEIRVBNPdHcZDUAfG,GAAAeAAACADA.LADAFAFA.MAHB.XCDAaAHDRBDABCCDdDGDHEAChAAAZDEB.AAEAQFFAhACATDGA.OEEBhAIAbGFA.EGCF..NIDB.DFIB.....hAAA......hABA....,1,11,-22,33
NFaeWSOBGMIZLHcJdVfEATPbXKgDCQRYU,TAAAXAAA.DADARACFUAEA..aAEEeAHB..OAGDhAAAGCGAZCDAHDEBdDBAEDHFhABAACABbGBACEEA..QFCDhAIAFGGHBEDCMFIBLGFA.....hAAA......hACA....,1,7,-10,17
PQBObfVXZEKTDdgIWFSMceGUARCLYNHJa,RAAALAAAHADB.aADDQAFABAFA.OAHFVBGB.ECCBDCAAdDAAhAAA...IDFAhABASCDAeDGHAAHACEEAYEEFhADAJEGF.bFAAZFAAKGHB..WFHHMIEAhAFA......hCAA...,1,9,-31,40
NXJRPQMLSDTYFefdGUCbcgKVZIOHaWEBA,XAAARAAAMADA.LADADAHB..TBDAeAGHGCDA.hAAAbDGDKCCDZEAAHBFBEGEFAAAAhAEAPDHD.QEEChABA.FFBA.dGGACDCC.....hAFA......hAIA....,1,-3,-9,6
ONRKSCHWDcFYgGfIVUZeTLMbaPJEABXdQ,dAAAQAAARADAKAGC.HACADBIB.FAFAGCABVCDA.ZCFBLCGBhAAA.aEAAEDEFBFFDODHBhACACFHA....cGEChAEAfEAA.eFCBMAIB...hADA......hAEA...,2,-26,-3,23
HYTPUbJgNXAWcQVZBIDSGMLROeEKdCFfa,QAAAZAAADACAGAEARACA..EAFEdAGBFBHDHBGB..TCDAhAAAbDDD.JDAA..XEBBhABAAAHAVDFBBFCAMEIBeFFHhBEACFHA..aGCE.......hCAA......hCBA...,1,-11,-12,1
QYNaCWIbUAHLgMXZBDeKRPfVJFOdGTcSE,HAAAMAAAZABEeACERAEF.VAGB..OAGDGCCA.SCFDhAAAECCBQDFDaDHDCFAAIFFAhAFAAAIBLGAABGDAhAGAKEDBfFGEdGHA......hAGA......hBAA...,1,4,-22,26
AUSBNeRLbTOdGYgCFPDEIaVfQWZMcKXJH,BAAARAAALADBOACAGAFA..CAFADAHBEAHB..aCCBQBCChAAAZDGBMDFB.KCEAHFAAhAAAAAIBUEEAeFHH..dDHAhCAA.FGCB...IGHAWEED.JHEANIAB.hABA......hAFA...,2,-29,-1,28
TMbaBgVUWNSRIGOKYfXEJLCDFPAecQdHZ,eAAAdAAAHADAZADBMAGBaAFABBHA..UDFBSCAARDBB.GCEAhACAKAHBXFGAhAAAECGBLDDDFGFHABDB.TGFAhADA...........hABA......hAHA....,2,-24,-7,17
BJWPRfeDTCFcGULaYHNbgKZdEXAVOSQIM,SAAAMAAABADA...JADARAEFeAGH.CBBA.GAGALDCBhAGAHBCA.bDEBZEDBEEGBAAIBQFFAhBAA.hAAAPCHDTGAA.FGGHaHGENDIA.....hABA......hAGA....,1,-2,-13,11
fBHgDeFWEcRZMCUdSQNJPbKVGYILAXTaO,aAAABAAAHACBeACAEAEARAFAZCAA..MAHBdCEA.QCEA.hAAAPDHDbCGDGGABhACALEAAACCAOFFBDAIBFEEHhAEACGHA.SBBD.KGBA.IGGAhBAA.....hADA...,1,12,-22,34
DVHBKbPgaSEUIOGYQMLRTAZCdcWXefFJN,dAAAXAAAeADAFAGDDADA.HCACBAFA.KAHB..bCFA..aBCDEDEBhACAUCEAGEAA.MEGBhADARCGBAAAAZEBACECA..fEHEhAEAVFFB.SHGAOHAA..hAIA......hBAA...,1,-2,-24,22
gaQPDIbVEfFMUOHTcSKXGeRACdYNJZLBW,dAAAJAAAZADBLADA.BAHAaAFD.QCBADAHB..VDAAhADAECFAMCIB.HDDBhACATDFAKDGBeEAB.hAIAAFCBCFGDNBIA...WHAAgFBA.bFDDhBAAFGHDOFFE..hBFA....,1,-2,-19,17
SWfLRbUQYNTHDMcCOGKVaZdEIgBFPeJXA,SAAALAAARADFQAFC..TADAHCAAMAIBhABAOAFAGCGAaBFDEBHFBDEAhACAeCCBAFFAbGDAUEEADFIBhAHAKDAA.dEHA.FFCH.PHFA...hCAA......hCCA....,2,-5,6,11
MKZCRWAaPUVeYBGgXdNcJSDLFbfTIOQHE,aAAAVAAABADA.GAEAdADA..JAFALAGBFBFH...bCCDhADATDDA.QDGAhAAAHEGBEBBBZGBARFFBACHA.hAIAeFFD..........hAIA......hBAA....,1,0,-28,28
gLIAceRQfbCGWZUDTJEXHPBFdOaYSKMVN,RAAAQAAACADB.ZACBTAFAEAEA.HCCAFAGDdCEA..aAHDKCHBhAAAMDGBVEFALDHBhAAAAAIB.eECAGGDBhBCADFABPHACBEDD.SFFD.IHHAhABA...hCAA...,1,-2,-15,13
VLSGgHWMYdfIUADXEROeNJBZaCQcKbPFT,EAAARAAAeADEBACAZAGB..aADDQBDD.KDEDbAED.TAGAhAAALEGB.GGABhAAAHDFCMCCBdGFC.fDDEhAGAABIBOCCHNDIACFFAFFHD.SGCAhAIA.....hABA...,1,-4,-7,3
RUCfBaPgZDXILOAKcHMNSWTdJYFeVGEQb,HAAAMAAA.SACEdAEAFAGAGBBAEAFARBFACCCABBGD...aCGEZDEAhAAA.XECCLDEBhBAAAAIBKFAB..cGEDhBBATFFAeEBD........hBDA......hBEA...,1,-11,-25,14
gFQaUJTYABEeVNGSMLPfIHbCdXDcRKWZO,EAAAeAAAGACAMAEALBDA..fAEBHBGBdDDADAIBhAAARAGFZDFAFEBBaCBHTFEAhABAACIBBEDASEHHhBEA.IHHAbFCAXGAC.KGGA..hAAA......hAGA....,2,-4,-2,2
JReUbGafFgBPDHMLCYAEQOdcSVKXNWZIT,EAAAdAAASADAKACA..XAEBZABBTAGARAGBUCCA.GCFAhAAAaCEAFCHDBEHAHDCAhAEAMFDBLFFAAAIBOFFHhCAAcGAA.WFDHIHHA..eHFAhAGA.....hCBA....,2,-13,4,17
QVNRefIYdMCHSFbXEcJZPKDOUWLAaBTgG,aAAATAAAGACA..QACCRAEA.eAEEfBHAhAEAdAHAHBEBbCFDEDDB.ZDGBDBBBhAFAOECBLEEDAEGBBGHAhAAAgFGANIEB.MFDBSFFDhCAAFHAA.cGCD..hCEA....,2,3,15,12
bXEIYUSCGMWdOKJPAVLDecHBTQRfZNFga,LAAAeAAAHADATAEARAGFZCCAFDGH..aAGAEEEBUCAAGFABdCDAKBGAhABAAAAADCIBBDFA.QEGAhACAfFHAbFDBhAEA.....XGGCSGGD.hDAAMIAA....hAFA....,2,-3,1,4
WeTCVUAIMXOBFKNaGRdZgLSHcfbJYEDQP,MAAABAAAKACAGACBRAEF.ZAGBLAGBHCCA..bDFAECAA.QDCAhAAAeEEBTFAACDHA.hACAAAFAOBBBFEAB.dFCAhBAASEEBfGGADAIB.PEGB.hBIAUGCA.IHHAhAEA..,1,6,-11,17
CBYMFJGSREVPLdTXKcabDeHWNIgOAfQUZ,QAAAZAAABADBMAFAGACB.EAGELBFAdCDDKCGA..aDAAeCABhABAHEEA..IDDAhACAAEGACFAAFFHDRGCA..TDFAhBGA.XECCDGGB.gFDAhBHA.fFHAhCBA.YHDG.,1,-1,-14,13
HWMJCOAPGENBFQKXLbDecYUaVIdfgZRST,EAAAFAAAQADALADAeAGHUAGA..aBCCdCCAZDDARDABHDFA.hAAAMEEBOBHD.AAEAGEGAhAIAKFFDDFDB.cFCAhCAAIGHASFFD..WHDACCEA.hCBABGBA....hADA....,1,2,-10,12
VfUGXHgOZbJeDLCITPdAEWBSMQaFNRYcK,EAAASAAA.MADAaACDRAEA.KBHBUBDAHCDAZAGB..eCBBhAAALCCDTDGAAAAAQEEAhBGAFEAB.cDGDhBIAGFEB.OGCCbGCCCGHA.IHAAhAEA......hAFA...,1,-6,-11,5
BWHceKEFVgYLPSIRMDCdbTNZaGQXfAUJO,OAAAHAAAeACEFADD.VAGBLAFA..SCCARCDAMBBBdCGAhAGAbCEDZEFAGEGA.hAHAQFAAACCBBGGA.hBAAKGDA...........hCAA......hCIA....,2,-25,3,28
IfHSOPgUZCdGNMWLAFcTKRYbQeEVBDJXa,TAAARAAAQADC..EACEDAFA.aAGEHAEB.OAGFUCFAdDDAhAAAGCCAMCCBAAIBKDHBhAAAeDHHBEAA.XEFChAEASFDAZGAACGEDLHDAFGGA...hAGA......hCAA...,1,-2,-12,10
bXTCWNcVSHPRMAKgDBfILGQedFZaUJYOE,DAAABAAALADAeACAZAFBUCBA..OAHDEAHB...bCAATCFAhAEA..CBEA.NDIA.hAFASDFAHDDBMEHBhAIAAACAKEDA..fFCEQFGAaGFBYHBAhAAA.cGFChBHA...,1,-14,-24,10
KXfDSHMbWPZgJeRNUOdLIaBGcAEQCVYFT,EAAAQAAA.CACA.FACDKAEADAEA.HAFCMAHB..bBDDZCDAeCFBhAAAREAAOCHDdDHAaFFCGEEAhAAAAGCA...TGCAhAEASGCA.PHEC...hAGA......hAIA...,1,-10,-18,8
AQBXWUbYZITVNdFHMDPKCERcOaSJfGeLg,QAAAXAAAUADAZACB....TAEAdAGAHDBAMAHBKCHBRCFBOCEHhAAAaDDA.SDHHhAGAGDFAeFBAAAIBbFFChBCAIHEA.FHGECHHA......hAAA......hABA...,1,-4,-12,8
eaWTGgHNPRXdcOFMDAZfEYIBbUQKCVLSJ,EAAABAAAUADAQACA.CAEA.LAGBeAFH.aBCBGBGAhAAAHDDAREGBdCAAFFBAAAHAZDDA.hAAAIGGAbGBAKFFD..hACA............hBIA......hCCA...,1,-11,-26,15
bQLJUNcTFRWISECeADYgfKMadGBHZVOPX,DAAA..fAAAaABEGADAHADAZAFA.OAFA.XBGAhAAAbCFDLDHBUCBATDFAhACARFDBSCCDEEDFACFBKEHBhADAdGAABGGDQGGC.JHDE...hAGA......hAHA....,2,-8,15,23
CNfYMWJLQdbFDSTXUgREZVIPBeOGaHAKc,CAAA..fAAAMACALAGBdADADAFA..TBCAXAGARBEFZEBAhAAAVCAABCBD.eCHHhAIAaBFCHDEAAFFA.KEDDNIBB.hBCAYDHB.QGDAbGEASGBAhBEAEGGB.....hAAA...,1,-4,-10,6
TVagEBMNXfOLKRIAdGYHDSZFJceQWPUbC,GAAAHAAAZADBFADAeAFAQAGAUCABCBHA...aCDAECFBBCGDMDHBhAAA..XDBDhAAALEEBRDDBADIBdGAADEHBSGCBhACAJGAA.cGGCbGFA.....hACA......hAGA....,2,-5,-1,4
fZRaXDYBJSIVePQFLdETKNHUAgGcMbOWC,GAAAMAAA.OADACADARAEF.DAHBBAGB..SBFHeAHHQBBChBAAdCDAECHFTEBAhAAAHCFBADDA...bEFAZFFAhCAAaFECYHFA..IHGA.hCBA......hDAA...,1,-11,-21,10
UWDMaVAZRXYCFdPSfGbgQELKTNIcJeBHO,RAAACAAAdACA..SADBGAEA.QAFAEAGALCHBTCCAhAAA.IDFAeCBBHDDBhAAAOAHFDDGBaEABADHBZEEAhABAFGADbFAAKGGA.JHDABGGD.MEIB..hAFA......hCAA....,1,8,-4,12
AeTJGBNZFdPWgRXbODcQSUCIMYELfHaVK,eAAAGAAAZADBdADA....PAFCRAFAbCEA.DCCB..QEEAhAAACCFAMCHB.EEHFHEEBhAAAaDBDAAFABFCAFFCD.WDHHhABA.....ODBHSGHHIHHAhAIA.....hACA...,2,-16,-15,1
WYQREbfUKSeaXVFTGONIgcJDLCHPMdZAB,BAAAQAAAEACAUAFAeACA...aAFDFBDDGBGAOAHFICDAhAAA..gCAAhAAADAIBHDAAdEEAACAARDEAKEHBhACAXFBA.TGFAJFBALHDAhBFAMEIBYHAASGFChDFA...,2,-22,12,34
AZIXdSfBeQCETbOLPKGcMVRYWJHNFUDag,ZAAAdAAABADAeACEEAFEOAED..LAHBGAGA.MCCBRCAA.JDDAhABAHDCCFEGD.aDFDACGA.SDHHhACAQFCAbGAAhADAKGHB...YFFFUGGADGAA...hCAA......hCBA...,2,-15,-2,13
TBSNVAZXafcCIJEDbYHRFdKgGMOPUeQWL,aAAACAAA..EACADADAHAEARAEA.dAHAGBCA.MAIBOCAA.eCEBhAAALCGBTDGASECDhAHAACGBZGAA.fEEAhBAAIGFAYDDFKBBDgFGAhCAA......hCEA....,2,-10,-9,1
RHPIQKEDfFSVUbBaOYNGTdeJWACcZgMXL,ZAAAMAAARAEAHCAA.QCEBEADAFAFDSAHBUEABBAHBaBBBOCHBhABA..GBGAhBAAeEEBAACACCCAXDEChCAA.LECBKGGADEGB.bFFANICB....hCCA......hCEA....,2,-5,-3,2
FGHPcXMgCNKbJaUdOfDYBLRTESAZWeQIV,eAAAQAAAFADDHAFA..XACAMCCBCCGA.KAFA.aAHDdDDADCDBhAAALEGBECEA.AAAAZFAAhAFAIDAA.GDFAhADAgFEAbFAAOEEHBHAA.SFHHhAFA.PHAChAHANCIA...,2,-9,-6,3
IPDeBCYRWbfKgVJUcaOSZTXNHMAdFLEGQ,dAAAEAAAGACAQADADAEABAGARAFA....bABDKBFD.VCGBhAAAUDEA.aCGDZEBATFGAhADAHFEBAAIBLGAAhAGA..IHHA.CCBD.....hBCA......hBEA....,1,-7,-15,8
VUeQZFXHTaIWEPgRBNDGcdLMKAbYfSOCJ,...bAAASAAA.CADAUAFAeAEAZBEEHCCAaBHDECHFRCAADAAAhAEAdDAAMDGBADFA.OECBhAAAQEEAFEEBXFGDhABATEGAIFAA..WHBABGHAhAFA.NIAB.....hAIA...,1,-7,-13,6
QEbSKADRLBVFGeHYaPWJfMOgcZXUdNICT,RAAALAAAFADAHAFBaADD..JCCAMAFA.OBEDZDEEdFFA.CAHA.EBGAhABA.KCAAAAAABEHAGDFAhACA.eDDB.PCHDhBGAfHAB........hAHA......hCAA....,2,-33,-6,27
SagAZNYfGFVPCOIUBcLEHebKdMWRTDQXJ,ZAAA..fAAAGAEAFAGACADA.OCABBAFAEAHBHCGB.eCCBhABAdCBARCFAQFFChACASDADACIBVGBAIDDAhAAA.LEFAMFIBDEBBaFAE.gFCHhACA.PHEA.hADA....,1,10,-4,14
ITNOAfWLSZFXGVYPMEUDbJKBdeQHgCcRa,LAAAZAAAGAEAVAEAMAHB..DAIBKCAAdCAAHDDB.CDGDREABaCCA.hABA...TFGAhACAACHBSDDAFGFH.XDFDhABA.EFHF.JHAA.eHEEcGBDhADAOEAE....hACA....,2,-10,-6,4
dKVBcNEGYWULfQJMCADZeHRPgaTbFSIOX,eAAAHAAARADF..aADDTAGAFAFA..OAHDdCADBCFA.ECHFGBEAhAAAUEEALFAAhAAAQDBAMEIBADHBZFGBgGFAhACAbGCA........hADA......hAFA...,2,-11,-6,5
bfUVSQAJeFXGNEKWdYHLBgDcCOPMaTZRI,eAAAGAAAEADAdADAHAFALAFADCCA.OCDEaCDEZCGBRCGF...IEEAhAAAUFEAQGAAhAAAAAHAFFHDKGDA.BGCA.hABACGGBMEIB.........hCAA......hCBA....,2,-13,-10,3
JEKCfGHFQPYDATSeLMVXWaUbcRdNOIBgZ,eAAAMAAA...XADAaACEUAFA.RCCA.dAGA.OBHDBAHAZDFBhBAAECCACDEAHFBA.FDHDQEAAhAAADBBBACCA.TEFAhABASGHBLHEA.....hBFA......hCAA....,1,-10,-18,8
APEMGbdFNeLHBDTfcVgCQKXIZOWYRUSaJ,EAAAGAAAdADA.eADAHAFADAHB..TCBAVCDA.QCFBhAAAKCHBZEAA.OCHDREFAUGCBaDEHhAFAAAAB.bFEAFGHB.BDCDhACAfHAB........hAHA......hAIA....,1,10,-13,23
aDTVLWGeRgHFdcXBKPEAOfYCSbJIZMNUQ,OAAACAAA..SACAJADBZAEB.MAFAQAGA.DBBBhBAATBEALDGBeBGHhAAAHEEDdCAABCCAEGCAACCB.hBIAbEDBIHHAaCHDVFFA......hACA......hADA....,2,-14,-13,1
gVbMfdGADKQBREXSeUWHOLJFNaIYZCPTc,QAAAEAAA.eACAHACALAGBFAFAaAHDZCCATBEA.VDAAhAAAbCFDdEAAGDDAACEABDHAhAAARFGBSCHHhADAOEEHIGGACGBA........hAEA......hCAA...,1,11,-16,27
cgIaZRSTPJOLHKMVdXEQfeNDWFCBYAbUG,GAAA..gAAAZADARBGFSAGETADA.OCDBHAFBMAIBhAAAdCEAEEABeCCBDDIBCEFAhAAAAAHBbDAD..IGGAhACAaDGDLEEB.XGGA.fFDAhABAWHFA..hADA....,2,-14,11,25
JeLDGdfXSTWbNRagAcZVKYMOQECHFPUIB,ZAAAKAAAMACAEADEHAFB.FAHFUAGABCAAeBCAGCDA..dDBASDGAhABATDDA.bFAAhACARDFFADHA...VFCBhAAAQFFACFHA.PHDCLHFADCCB..hBDA......hBGA...,1,6,-16,22
XBSJUTLGAEKHfMIWdQZeCVcRgDNObYPFa,HAAAMAAAdAEAeACE.CAFBRAGFDAGA...OBBA..bCCAFBGAaCHDhAAASCCDUECAGEFAhAIAECFF..KDGAIHHAhCAAZDDF..gFFB.NIDB..hCCA......hCDA....,1,2,-26,28
IHcXGWVbYJeORMUSTaCBPAKdQDNgFELfZ,dAAAQAAADADAFAFD.EACAZAGBHAEA.GCDA..bABDeAHHhAAARDCA.MCGBUEGAaDCBBEBDhBAAAAGAKDHBLFFDhBDA..fFFE.IHHAhCAAWFDH.YFDF.hBEA...,2,-29,9,38
aBGYKSRAFePTQdNUgVWHJDLfEbXIZOMCc,eAAATAAAdAEA.UAGA..VADAHBCBLAGBEDFA.bCAAZEBAhAAA.MDIBCDFD.aFFAGEDAhAAASGBAAACAQFFChAIANHEB.WBHHDIBA.fGCEhCAA.OHFE..hCCA....,2,-5,7,12
ZXTFYEWUaIMBJRGNSKHQObDdCcfegAVLP,LAAAZAAAFADA.EAEAaAFDBAGA.GCAAKAHBHCAAQCCAhABADCEBdDFA.CBHA..eCFBACHB.hABAXEDATFGA.UGCAhACAMFEBNEHA.OHAA......hACA......hAHA....,1,0,-19,19
ZgDPCLbVWNSAadecHYERUfOIGQBTMXFJK,eAAAHAAARADFOADCGAFABAGBMAIB.FCAHZBFEDCCBLCCB.hAAAVDGBSDDAhACA.AAHBdEHAEEEBfFAAhAAATFAAKFFBCHDAbGDAaHFC......hADA......hAFA....,2,-14,5,19
PgNaKXBeYTIVHRUJAQDbdCZWfcFMLSEOG,QAAAdAAAZABB....fADAMADAEAGAGBDA.hAFAgBFGaAFDBAHAeCEBhAHATDBAHCGBREGBABDBbFEDhAAACDDDFFBA.LGFA.SGDHhBAANBIA.....hBCA....,1,10,-7,17
MGdHCNOBLKEFYPVQDURfZaAcXWTJgIeSb,XAAATAAA..JACAeADA..MAFAHAGB.OCDBLBGBhAAAECEEFDAAPCCAQEEAhAAARDEBaDHD.AAIBgEAGhABAbGCCdGGA.BDHA.KFHB.DHFA.hBIAZGBE.....hCAA....,1,13,-4,17
eSIfPORVXNDcUWYGCHbJaAQgZdMTELKFB,ZAAAdAAAEADALADBBAFA.eAFA..SAGHICAAOBHDhABARCAA..XCEChACADCCBUCFAGDGAHFAAaEEChACAAAIBMEFBTFGAfFCA.NICB..hAFA......hAGA....,1,1,-19,20
aVNKUBOPgIJYXdQbWFZATeRCSEcHDLMfG,RAAAEAAAHADBLADAGAGA.aCCHKAHB.OBCB..gDADhAAAICFA.XDFDhABAbCGD.ZFAAAAEAeDDBhAAASEEDMFFBfGGAUGGA.BHAAhAHA......hCAA....,1,10,-13,23
LGNbTPRZdegXCcQWMIDUHfVSJaOBKEAFY,LAAAGAAA.TAEARADAeAGH.CCDD.QAGCMAIB.DCAAHCEBhAAASCDBaDAHKDHDAFGBhACAFCHD...bDEDdGAAhADAXEAAIGHAfFHA.ODDHhABA.EHFE.NIAB.hACA...,2,-15,-7,8
KJAPeWIZSVCYFBNTXLMbHDEUdacfgOQRG,eAAAZAAACADBBAFA..TADALAHBHAFBDCAAEAHB.dCCA.aDFChAAA..fBGAhABAQEDDRCDBGEGAhACAADHAIFAASFAAFEHDMIAAbFCDgGGGhABAKGEA.....hAFA...,1,11,-24,35
FPWbdRNeVaKMQJfSDEZgTXCAYOHBcGLUI,HAAAGAAALADBFADA...bAFARAFFeAHHaCAC.MCDBQCFAhAAASCEDEEEBZFAAhACATEFAACCABEHA.IGGAhAFAdEHAKFDADHAACHAAOHDC....hAGA......hAHA....,1,18,-16,34
UVHJSEGYTMWIceNZAPDfRdOgCXFLaQbKB,DAAARAAAdADACACA.LAFA..aADDQCEABAFAHAGBECCBGCEAhAFAMCHB...IEHAhAIAeEEBAAAAOEHDhAGAFBBHKEDDUGGASGDBTGDAcGGC.PHAAhAHA....hCAA...,2,-20,-10,10
HITQKAXWPSDMZdbfJgcFaEGYVUONRLeCB,XAAASAAAZACBdADA...JAFAFAEDGBEAUAGARDEALCGBhAAAeDHHHFDAQDBAhABAAAAADGBB.bGEA..fGHAhBGAaEEH...YHDGNCIA.hAIA......hBDA...,1,-9,-10,1
FVBKTISaORLHgbANfQDMeXYPEUGZCdJcW,QAAAeAAA..XADAEACAZAEBdAHAJAGBFCCAKCGD..TDCAhAAAaBHDLEAAHEFCABEBDFEBhBGAMEEAUGGBGFDBhAAACHBA.VGAA.SGHH...hBHA......hCAA...,2,-9,-3,6
FDOARZUKYdTVMfGSQPEIcCgLXaBbJWeHN,RAAAZAAAKADCdAEA.MAGBGAFA..QCAAEAHB.CAHALCHBhABAaCCABDDD..bDGDeDDBhACA.HFEBDDFBAAAAUGGAhADA.YHAATFBASGFDhAIA.IHHA.hAHA...,2,-22,-4,18
fRBdWVZPIecKAXaELbSgJDFGMCUNHYOQT,EAAALAAA.SADHDADAGAEBMAFACBCAHCDA.QDGAhAAARBEFdBGAZCAAeCHHAAHAbFCA.hBCAFEEHUGGAOFHDBHCAhCAA............hCBA......hCFA...,1,-11,-16,5
RUBTaSPdVYKOgbAZIJGFDcXfeWCEMNLQH,ZAAAGAAADACA...fADAeAEAEAHFLCCAHAEBRAGBBDDAaCFD.hABAdDGD.KEFDOCHDhAFAAAABFFHB.XECAMDABQGAAhACATFFASHDA...hADA......hAGA...,2,-12,-7,5
FZKNbacLXWeBUMIfDSdRAgCJHQEVPOYTG,CAAAHAAA.EADEOACAGAFAZAFBKAHB.aCACLBCA.eAHFhAAAMCEBDCIBRDGFACCA.QFAAhAAAPDBA.TFEAhACAbEEA...WFDDBGEAfGHAhAFAdGGD......hAHA...,2,-22,-4,18
JXKAfVHELgQFDecYdZNIbSPTUaWRBGCOM,HAAAEAAALADAQADCeAGHdAFAZBCAbAGD..TDDAUCABRDDAGDGAhAAAMEHB.KEAAAAIB.fFFEhAEAFFFBDEIBNICB.SGEDhAFA........hAIA......hBIA....,2,0,5,5
YNVSCgeTQOULMHEPWJKbFaBZRcdXGIADf,DAAA..fAAAVACA.CADA.eAFETAFAQBFD.hAAALDDAHCAAEBHFPBBBhAIAKCEAaDGEREFAdGHAGECAhACAACIB.SEEB.OFAB.hBAAMFHB....hADA...,2,-11,-10,1
OfYBCFIbeJXAKREVZcHaNPLTSWUQMgDGd,EAAAZAAAHAEA.aAGALADA.TBGASCAAQCBAhAAAMCEBGCFAdDDAfCFEhAEACCHAbDAA.eDHFhAFAAACARFGF.cFEBPHCAgGGA.OHAAhAHA....hAIA...,2,-8,2,10
bUAHCWBFIJVSdMNPKZafREgXQGeDLTYcO,HAAABAAAFACAVAEAdAFA..MAIBKAHBZCBARCAA..ECEB..QCGDhAAAeCGFTFGAODEDhAHAAACACEAD...JECBSEEDhAAA.aHAAXEGDDHEA..hBCA......hBFA....,1,2,-33,35
bSXeaHBfFGCAORMKQZdVJDTWcNLYPgUIE,RAAAMAAAZADBdAGADAEA.....TDAA..cAFDLCFAhAAA..gBBAhAIAEEEAbEGD.eBEDHFBAFBHDhBAAAAIB.QEEB.VFBANIEB.PEHBhBBA.SGGDhBCABCCCCGFC...,1,-1,-5,4
bXaeZMgNDFfJKUcQIHSBATWPRCYdEGLOV,TAAARAAAdADAGAFA.LAHBOACAXAFAeCCBZEDBMEIBhAAADAIBFBDH.KCFAUFAAQEEAhAAAHFFBAFFB.CDHAEFCBhAGA...aCCH.fFHA.IHFAhCAA...hABA....,2,-9,1,10
gPWSaIbQYRHOdCXLBNVeMFZEDTAcUfGKJ,UAAAGAAAKADAJADA......PAFAaAGAQBGDhAAA.HCDBdCDALCFAhADABDCCeDGFZEFAEEHFACGAfGEAhBAASFCBIHHA.YFFFhACACGGA...hBCA....,2,-33,-4,29
WSKMRFUdNbAOCGQHLTeJPaBXfEgYcZVID,GAAAHAAAeACEaADABAGAEAFE....gBGAZBFEDCDBKDFARCCAdEEAhAAAAAAB.QFCAhAHALDHBTEBAXGFAhAIA..fEEE...cGAAhACA.IHFAhAGAMDIB...,2,-34,9,43
ITeEWfUcCFKOVBNagARGdPXZbDLHJQMSY,RAAAdAAAZADBLADAHAFAMCCBSAGH..TCGAECBAUDDAhACAFDABODEDBCHAaDGCAAAAGGEBhADA.bFCDQEAAhAEA.eFEAfEGEKFHBNIAB.hAFA......hAIA....,1,4,-5,9
LNFWGfKQBbCdVJIaDARHUYPZXTEcOMSge,HAAAUAAAZADAEADEMAFA..eAFELBGBFCDAGCGAQCABhAAACDDD.dCEAJEAAaDCDRFEB.hAEAXEGA.TGCAhACASGDDgFFG....hBIA......hCDA...,1,3,-26,29
OXGFCfRQUWVIdBcJMHZaKDAPTNebgEYSL,TAAAeAAAEADA.LAGBGACACAEA.RAFF.QCCAUDFB.IBFAhAAAdAHABCADMAIBhABAHEAAaDFCADIB..bEDDSEGAhCAAFFGH.fFFE..hCBA......hCCA....,2,-7,-4,3
OAbYWFUXNETfVRLHMaPgQCZBGdSKIDJce,...bAAAFAAA.XACDEAEA..TAGARAEAHCEC.MAIBaCAAQCEAhAAAZEAAdEEAKEHBDGGBhAEAeCHFADDB.UEAA.hAFAfDDELHAACHEAGGDBIHHA.hABA......hACA...,2,-6,-4,2
OULVDNcaEfeZSdHBbCIRPQJGXMYWTFAKg,OAAALAAADAEAaADD..EAGAeAFA.dCAAHBBCCBHA.RBEFQCGAhBAAGCDBMCCBTEBAhBBAAAFAKDHBUEEB..hABAcEECZGCABGHAbGEA.......hBEA......hBIA...,2,-16,-7,9
XFgOfQRUVaSGICKTAHbLdMPZBEJDYeNcW,HAAAdAAAZABBEADEDAEAeAFE.....NBGA.XAFAOCABRCCAaBEChAIAGEEA.KCHBABIBMDDAhBAABEHDJFCB..hAAAcDFDFGHB.QFGA.SEEDhBDA...hACA....,1,4,-31,35
QJEGXLbUcAHZRYdBPCITSNMaFVKDWgfeO,HAAARAAAdADABAFACADB..TAFAMAHB.aAHDKCCD..DCAB...hAAA.fCFAhABAeCCAQDEAEDHFGEDAhAFAbDGDACCAZFFFIFAAFFHD.gGEBhAAAOFCH.LHAA.hAIA....,1,2,-8,10
GIdCQJWXTMefPVaFHNSbRABUKcEgDZOLY,KAAAEAAAZACBLACBGAEAdAEA..QAGAXAGA.eCBD.hAAAfDGAaCEEHCGBbEBAhAGAADEBBEHA.gFFGhAAAOFEDCGGAWHAAMGAAFGDD....hAGA......hBCA...,2,-12,-4,8
bIJVFACLgYQcOeDNRHKSfdTaMGEUWZXBP,LAAAQAAAeADHRACAHAFBKAFA.dBHAaAHDECDF.ZDABBCAA..hABAbDFCICFA.hAAAFDEHAAHACFGA..gDGAhACAOEEHSFHHMCCBUGGA.XFAChAFA.PHAChAHA...,2,-19,2,21
KOABbQULVPdWNcfIGHZYCFSaJgMXTRDEe,QAAALAAAdAEA....NADA.fAGAHAEAZCEAFEAAaAHD.hABAMAIBRCAA.EEEAeDCAhACAAAGABEHAVDFA.PFFBhAGAIGCA.CFGDSGHH..hAAA......hAEA....,1,-7,-11,4
NQeIXfJbREMVAOgBcPUaHTDFYWdSLGZKC,BAAAUAAAHADAFACAdAFAGAGAZAGB.CCDD..eCEH..fBCEhAAARDAAEEGB.ABIBOCDDhBFAgFAA.aFFHTEGAhCAADDIB..SGDBKDFDQGGBhCBAIHHA....hADA....,2,-25,0,25
gBJIVDAHTYLZeEFONPGQWcfRXKMSadUCb,HAAATAAAZADB.EAFAOACAGBGA.QCAB..fAFAhAAARDEBMEIBdFCAbAGDhAIABGEDICCAAAIB.hAAAeCEBFGGB.PDBB.XEFD.hACAaEHF.CGCAJHFADICA.NEEA.hBDA....,1,7,4,3
cbRgDeKCTVUNIPaFOEJMQfASBWYGdHXZL,BAAAGAAAHACAZADALAGBRAFFeAHH.TCDAUCAA...IEFAhAAAaCDDEDFB..MDIBhAAAAAEASCHHdFAA.hACAbFCBKFFDCDCD.PHFCOFGD.....hAEA......hAFA...,2,-9,-9,0
QeLKRObAYDTGINgSFdZCaXfcMHUPVJEBW,TAAAGAAA..IADASACB.ZADBaAED..XAFAhAAAMAGBHCGBVCFBEAHBQFCAhAGAeCDBRFDAAAABDFIBhACAFFFHfHGF..cGFD.hAIA......hBIA....,1,0,-4,4
WRgFCQZAEPDeVHJfXdLbGNaIYTMKcUOBS,EAAAeAAAHACA.JAFAdAEA.GAGA.aBCDTCDAMDEBKDFBOCCHhAAABEBARCGBFEABZFFAAAAADEFBhAEA...XFCAhAIAbGAA.IGGA..YHFAhAGA......hAIA...,1,-6,-21,15
KDZEQIVBXHceYMTJWGSdUafLPCFObNRgA,ZAAAEAAA.QAEABACAHADBeAHBMAFAJCAAGBFA.dCHAaCECLEEBhAAAFDAH.bFBBRDFAAEEBhABADCCB..XFFAhACATGGA.SGBA.....hBFA......hBHA....,2,-11,2,13
GNfWVUHFEXaYJQeTBICRcKAZDdgbMLSOP,dAAAMAAALADA.OAGDGACB.fAGBUCCAHDFAEBBBhAFAaEABQCEAhAIABFCARFDFAAIBZFABbCGD..SDCHhBAA.PEEBWFHBFGGBXGGAhCAA......hCDA...,1,-8,-11,3
QWDcbVPECaAJYfIRKSdMZUeTBHLgFNOXG,JAAA..fAAARADF.dADAZAFBeAFAHCGBLBCDFCCHOAHFhADAGCFA.QEDDhAAADEEB.bCADEFAAhAFAABIBKEHBMFFBTGAABFCAXGGAWHCA.hACA......hAFA...,2,-22,-3,19
NRSQgFMCbTeLcWAPKOJEDXUBZaVYdfGHI,OAAAEAAADADA.BADAZADE...aAEDdAHAHAGBRCBB..QDDChAAAMBBBTCCAeCGBLDFAhAGAADIBKFFA.XEEChAIA.VFGBfGEEGGBB.SGHHhBCA.CHBA...hBHA....,1,7,-13,20
RJDOATQMIeYSgGWBHFcCPafbUKdVNLXZE,MAAAeAAA..SADAGACBHAGBCAGA.aBBCUCCAdDDALEGBhAFAEBHFRCFBDDIB.AAIBQGAAhAGA.gFDAhBAAFEABfFCAKCFDNDIA.ZFEA.OHFC.hCAA......hDAA...,1,6,-14,20
APZagdOBXRGDHNYcCEMbKeLQSVWJfUTFI,aAAAdAAABADAGACAHAEB....NAEB.CAGAEBHFMBBBKCBA.LEDAhACAQBFA.SCHBhBAAVFGB.fDFEhBEATGAAADABgGDAREDBDFBBbFBDeFHBhBFA.JHEE....hBIA...,1,-1,-18,17
ZdWSKTfRJAGgPOELCBUDMFbcXaYNQIeVH,GAAAOAAALAEABADAMAFAFBBH..XBFAaAHD.QCDChAAAeCEBHDBCdDGDKCGDhAFARFBAABFAEDHFDDAB..bFCChAGANEFA.ZGFE..TGGA.....hBAA......hBDA...,2,-11,-5,6
SYBgGXEeNIDZVUMfdcTAPWaORbLJHFQCK,aAAARAAALADBHACBQAEAKAFABAHBGCEAEAGA..eBBDDCCBZCGBhAAAMBIB.dDEAACGBOEHDhABAbCGDCEAA..SGDAhAEAXFAA.IGGA..fGGEhAFA...hBAA....,1,9,-23,32
aFPGBZOJSKgdEDRYeCQbXLNHfUAWcVIMT,VAAAMAAAFADD.GAFAZADBOAFC.KCFAEAHB.RBBB..eDEBhAFAQDAALDHBHEEAhAAAAEHB.IGGAhADAaFBABGFASCHBDIAAbFDD.fFCAhAHA.cGEC..hAIA...,2,-23,-5,18
afbDIVXGJMFKUYQALTOcSZPHNREBgdeCW,TAAASAAA.HACBEACEdAEAeAEAaAGADAIB...XBFAhAAAGBFAMCCBKDEAQEAAhABAABHBLDDBZEDARFEFCDHAhAAAbEGDIGHAFGDA.......hAEA......hAFA...,2,-5,-2,3
NPaJVFWXMYZBOGgTbUAHfcCESReILQDdK,HAAACAAARACA.eACELAFBdAFAKAHB..aAHBFCCA.MCHBZCAAGDGAhAAA..bDEDABIBEECBhACASEHHQEEAhADADDGBPHAA........hAAA......hAHA....,1,-8,-17,9
AWNLfZYFIbCGPUQaKMOdBTgERDcVeXSHJ,LAAAZAAAFADA.CAEAGAFAQAGA.MCABdBHATCAA.hABARCCFDEABeCCA.HCFAhACAAAHA.fEEAhAGAIEEAUFGAaEHBBGFAEHEE.......hABA......hACA...,2,-18,-12,6
GKZeUHAdRQNbDOcTfBSYEIPJLXgMFCVWa,RAAAQAAADADA.OACCTAFABAFB.EAHBJBDB.LAHBhAAAMCDACCGA...aCEDZDDAhAAAHDFBADIBdEAA.bEGDSEHBhABA.IHCAXFDAFGHH.hAEAWCCD....hCAA....,2,-14,-12,2
LBFgQGEZdSYTbCHKXePfAVMOcUIaWJNDR,MAAAOAAAUAEA..aADD..JAHBRAFALCCAFBBA.GCGAhAFAEDDAdDGDTEEAHEBAeFEAhAHAABBB..IGAAhAGADFIBQGBBZGDAbDBCCHHAKHGA....hBAA......hBEA....,2,-8,-2,6
ZQSWfUFDRPNcOMCTaYbBLVKHIdgGEXeAJ,ZAAAQAAASACEUADARAEF.....PAFCOAGDMCGBhAAAaCCCBDFALCHBHEFChABAdDBAEGAAADDAJDEBFGGHDAIBhAGACGGA....YHDA....hAIA......hBCA....,2,-16,-11,5
YRbZBOdXEaIUGFVKNQPAJDceHWLfTMSgC,DAAAHAAALADAMACACAFA.RAGFZBBAdAHA..EBDFUDDBGCEA.KDGCQDGBhAEAACCB.eFABhAFATGCA.SEGAhAAAbFCCOFHDaGGAFGFD......hAIA......hBAA....,1,-3,-11,8
CPRDKNXaSUbVWcFYJMAQEfdOIZTgHGBLe,EAAAdAAAZABBHACAGADAeAEERCCAKAFA..aAHDSAHB.UDFAhAFAbCFD..VFCAFFEHMDDBhBAAADIBQGGAhAAA.OHACTGGABHEACDHADGCB....hBDA......hCGA...,1,11,-18,29
QVeNdbWXIUCREJfcgMFZPDBOHTAGKSYLa,GAAASAAAaADA.eACHdAGA...XAEACCDAECFB..JCHBfAHAhAAA.MCEBhABAZDCABFGDHDFAAAEALGBAhAAAQFCCNIABIHHARFFAFHACOHDChAHA......hCAA....,2,-19,14,33
KHMfZVRcCXBTOLaEUIdQFNeWDbGYJPASg,KAAAHAAAZACBRADFCAFBBAEALAHB..EAGAdCADFBHDeBGF.DCFBGCAAhAAA..PDDBhAAAACABMCFB..fEGAhACAXDGCaECDIGHAQFGA.hADAbEDDSFFDhEAA..gGAG.,2,-14,-9,5
bRQfgYULANHIGTFdaSVECWePMZDOcBKXJ,HAAAGAAAdADAaADAEAFA..eAFHZBFEOCABKAHB..XCDDhAAARDDBQDFA.fFAAhAAAgDFHLEHBhACAACDBTEBASGGDCEHAMHAABGGAYHBAhAFANIDB....hAIA...,1,-5,-6,1
ELMGCPZAdSQNDbReaHITcKYJFOVBfWgUX,dAAAQAAADADARAEA.HACA..TCBAKAFCFAHDBAHB..fCDAhAAAUCGAEDEAGECAhACAZCEBADGAbEAB.eDHFhAEAaFFA.IGEA.cGGCOFHD..hBAA......hBCA....,2,-17,3,20
DcVNICUFbJOPBTEQdLSeHRMXaAZGWYfgK,GAAA..fAAADADAVAFA.CADAFAFAOCDBBBCD.EBEFdCEAhAAA.eCHFHCAAREBBaEFDhACAAAIBZCFB...gEGHhAAAKFHBNIAB.bFDD.......hAIA......hBAA...,1,-13,-20,7
dNaLBIeMcPGKXVbWSYETFRUQCAOJfZDHg,OAAAZAAAHAEAdAEAaAGALAGBBCAA.eBBAMCCBGDDA.KDHBhAIAbCGB..SFGBhBAAEDDAREABQFEAhABAABGBDGGBNIBB.IHHA.cGDC...hBBA......hBIA...,2,-20,1,21
FTVaObEGWCHNPAcBYQXIdfLKeJUZDRSMg,BAAAQAAAdACALAEAeACAZAFBRCDA.MAIBFBHD....aCBHEBEFhAAA.GCGAHECAAAFAXDAAhADAKEGA.DDDBTGEAhAAAbEEDCHBA..cGGDfGCE.SGGBhAIA..hBCA....,2,-17,6,23
SWDLZAKbEYJGVFPIgCfXRTMeacNUQOdBH,EAAAGAAAFACD...IADACAEA.RAEF.eAFH.aAHBUAGAdDDAHDGBhAAADCDBAAABKDFA.JEDBhACAgEAA.hBCATFEAMDIBQFFASGDD...hAEA......hBIA....,1,-9,-23,14
UKcaDfYIbPdRBZVFEQGXAHTeOWgNMLCSJ,HAAAeAAAOADC..gADBMAFALBHBSAFBhAAAKCCAaCEAfAHAhACA.bCCCRDEBZGEAECHFGDFAhAHAAAAAWHCG.CEECJFHBDGGA.......hCAA......hCBA....,1,9,-13,22
AOFQaeULJCXMWGdPcENHBYKfbTIgRSDZV,QAAAeAAALAEACACA.MAIBdAEAEAGAHBCABBHAKCFA..bDECTCFAhAAA..RFAAZFFAhAAAACDBaDEHJHCAGEBA.hABAPDHD...cFEDfHFBhAFASGAD.DGHB.hAGA...,2,-7,-4,3
PFEeVJYCcBTORfWZAbaQNUHKGSXMDgdIL,aAAAQAAAHACBGAEBMADA.dCFDLAHBEDEB.eBDAJDHBCEAATDBAhAAA.RDDFZFFAAAEAbEFDhAHAKDGD.DGCB.IHFAhBCA..........hBDA......hBEA...,2,-17,-7,10
HTbKcGDVRdXZQSIMeFNgBLOJCAYaUPEfW,aAAAEAAAHACA.KAFCGACARBFA.ZAEAQCCBMAFAeBBDFDFHBCFAhBAALDHBCCHA.AAIBUEAAhAAAfEDA.hAEAbEGBDEEB.dHEBSFCDIHHA.OFEDhBIA.....hCAA...,2,-8,-6,2
eNbRTMPFJZDIWCaVSgHcABUXLGdKfOQYE,XAAAdAAAOADA..EADAeAGF.RBDB.MAGBFBHDZDBBDAHBCBEA..hAAAaEFASBHHhABA.HDAAADBBLFFAhACAGDDAQFGAbFCD.PHECIHHAhAIA.....hADA...,2,-14,-10,4
PLNFeMZadDCYOXBWSUcIAVHfEbKQTgJRG,HAAAEAAAKACATAEA.RAGFGCABLAEBeCHHaAGAdBGADACAODEDhAAABCCAUECAADGB..bECDhAGAQEFA.hAIAPHFAMFIBCGFA..WCHH....hAAA......hCAA....,1,10,-18,28
EbYWZDBaKITXLAdJGPOFCVHMgRSUNecfQ,GAAAFAAAHACBRADAUAGAeAEA..QBGAECDB...bCEDZCFAhAAABDGDaDAHTEFAhACAAAEAdEDCOEHDMFEBSFHHhADAfGGEDIAA.......hAEA......hBAA...,2,-13,-6,7
ZTBDWAPOGcVIFbEXCUSeaHKMgQJfRLNYd,GAAAVAAA.FADAEADECAGA...UAFAeAHHHCDAMCDA..QDGAhAAARDBFLDDBdFEAZDFAhAAATGGADFFAAGAAOGDEhACAIHBA.SDCDaGGA.KAHB..hCAA......hCDA...,1,-7,-9,2
eGMLDgfVObPFUCSENBWKcIZHdJQXYaRAT,eAAAGAAAMAEALADADAIB.VBGB.OCDBbBAA..FBEASCEBhAAAECEBBCGAKDHBhAAAZEEAHFAAdEED.QGEAhACAaFGDAGIB.fGHACHBA.WHAAhAEA......hAFA....,2,-21,12,33
FKcVDMIWgSaYefBAJXTRQNdHZLUCGbPOE,TAAARAAAdADAHAFA.ZCCALACBGCGAOEEBEAEAKAGADCEA.MCHBhAAAIFAA.SFCBhAAAeDEBACIBQEAAhAEACGFAFHAA.cFDC...gGFHhAIA...hABA....,2,-10,-5,5
OKQgWYeVATJEBdNFUXHGaILDCSZPcbfMR,EAAAdAAAFADAHACAGAFAaAEA.LAHBDAHBZCCA.....bABDRDFFQECAhAAA.hBAAgFGHeCEBAEEBTEGAhBDABCHAXGCCSGGA.fHBBhBHAMIEA....hCDA....,1,0,-6,6
ISZGLFVNacEdPOHbCfgJTBQYUAeWMDKRX,eAAAMAAARACA..SADAGAFALAHBFAGA.aBBHEBFFdDDAHCCBhAAACECC.fCGAhABA.TEAAQEGAhAFAACCBKDHBZFEAcFDDOHFCgGGGhBAA.BHBA...hAEA....,1,5,-1,6
IKaETOdACLHVRfUYXbQBJNeFDGWMPZgcS,HAAARAAAUADAXADBBAFA.eAFAGAGAMBIBZCCA..SCAAhAAAaDFD.ECEAdFHAACHBLDDAhACA.fEGAhAGAYEEF.JFHBDGGBWFFD...hAAA......hABA....,1,9,-28,37
bRCXLBZNUaHMPgODJQTFSIGVYKcWEfeAd,RAAALAAAZADBUAGAHADB.MAFAOBFHQBFC.TCAAhABASCCDGDGAKDABhAAAEDDBADHAdEEDXFEDhACAaEGD.DBIBFGBAIHBA....YFHBhABA...hBHA....,2,-25,14,39
gVQDSIYFLOCXPHbNeTaRUZdKEGAMcfJWB,MAAAJAAABADB..QADADAFA.SAFAFAHDLBFBhBAAXBBCHCCAeDGHhCAARCEAdCHAEDDBACEA...fEGEhAGA.gGGAIGHACEEDNIAB.hAIA......hBAA...,1,-18,-40,22
UdIOSQJPNFLBZRMcfGDHVEgTYXaCWbKAe,eAAAdAAASADAQADA..JAGBFAFEZABBRCCBMAIBGCEAHCEChAAAECHF.TEGA.aEFHhABAbDCDAGIB.UGGA.OEABhAEALHCABEHA.DIAA.....hCAA......hCBA....,1,9,-6,15
YbNBXJFMOUAPdfCVSDTQKLRZEeWgIHcaG,dAAACAAADACAQADA.RAFAZABBEAEAeAGF..ICHAhAGAHBCAGCGA.bDEDXDCAhAIAMAIB.ADFAfEGAhBAASCBDLEDDgGEBaFHDBHHAhCDA.....hAAA....,2,-12,-5,7
NXOTLDZCEUQMHfGRcbPIdYgAaBFeWJKVS,aAAAeAAA.KADA..SACHOAFALCCAZADBEAFA.UBGBHBFChAIARDFA...bDEDdECAABBBFDGHhBAAVFGB..NDIADGHBhBIAMEEB...........hCAA......hDAA....,1,-5,-18,13
MZHADKCXdfYPGaJITeNVcQbELSRFWUOBg,CAAAdAAA.....fADAGACAaAEAJAFAeAGH..VBEBhACAbBED.LCHB.hAAARCBBFDAHOBHDBDGAZCAFhACAHFFAAEHBXFFC.IHHANEEA.hADA......hAIA....,2,-16,-5,11
dVTJLbEKHQWOBZNUaFCSIgeXAMfPRcDYG,MAAARAAADADAGAEBdAEA..TAGALCCAEBBA.HCGB.QECAhAAABCDDZCFEaEBASEFDhABAeEEAAEIBfFGAhAGAcGFD.VGCAKHAAWFHH...hAIA......hBAA....,2,-6,-3,3
bWZKQdfUVCHAFNTSDELGMPagXeRBYcIJO,TAAAEAAAGACA.MAEAaACA...eAHFRAEFBAGB..IBFAhAAAbCCDZCGB.dDFAfDBAhAAACCBDHEBAACIBSEGHhBCALEEBXGCBYFHBcGGA.hBEA......hCAA....,2,-5,1,6
EDNGMTOARdeXHfLCWSKYVFQZUcgBabPIJ,RAAAeAAAHADBLAEACAFA.KBCAFAHBZBFEUCGBBDDA..aCCHIDGAhAAADDAB..GEEAhAAAMDIBAAFAdFDC.XFAAhABASEFD.YFHF...hADA......hAFA...,1,-18,-29,11
DKbCFJHgROUMadcQEZfYTGNSIeBAPXWVL,XAAALAAAKAEAFADA.HAGB.RCAAMCEBdAGAEBDB.ZCFA..TDFAhABAGEEA.SDDDhAAAeDHHAAIBVFCBbGBCCGHAhABAOEAB.aFFH...cGGD.hAIA......hBGA...,2,-19,6,25
QKOcADSdMGCBZRWETLYINbHFePUagXfJV,dAAAGAAAZABBEADALADA...IAHAHAFAeCEBUCDAaCGDhAHAXCFAVDCBQFGAhAIAODHDAAABMEABhACARGDA.TFFA.bFAD.FGCA....hAEA......hAFA...,1,0,-7,7
WHIGcVaZAFbPfYRKdgeXJSLUODQBNMTEC,FAAA..bAAA..fADARAEAdAHA.eAEHSCAALAGBhADADAAAQDDBhAIAMCEBECFFHDGBGEGAaEAAABGBKGEAhBAAXFAC.OFFBNBIAWCCDIHHAhAEA.....hCAA....,2,-4,2,6
WQCeNALBgXYEdVKSGJcfIZHFMUaPODTRb,LAAAXAAAdADASADHGAFA.JAFA..IAHAHBEBMCABhABAaCHD.DCCBRDBAQFAChAAAeCGHACIBBDDDEEFBKEHBhACAZFDFFFFHOFGD..TGCA.CHGA.hAIA......hCBA....,2,-3,4,7
AGWEYCTVJbefPUNFMRcdKSOXHZBQagLDI,EAAATAAA..VACAeACE.UAFAMAFARCCA.dBGAKAHB..XCCChAAAHDFAZFFABCFCaDBHLHDAhAAAABIBGEEACDHA.hBDA..fGHA.....hCAA......hCCA....,2,-19,0,19
IOTCdYHfLXPReMDAKZgcJSEVNUbQGWFBa,ZAAAJAAA.EADEUADAGAFA.BAHAOAFCdCAAHCCCLCGBRDGFeEFDhABAAAHA..KCCD..SFAAhACA.NHAB.hAFAbDEB.QGEBaFHD.CHGA....hAHA......hCCA...,1,1,-36,37
fbRHBeJPcOKgQNDWLTCUFMGZAadVSYIXE,dAAASAAA..XADAEADARAFAHCCAeAGB.JCBBOCGDhAAAQDDADCIBTDAAhABAFDGHZGCAAEEAaFCA.IFFAhADABAHBKGGA.WDADLGAA.MFIBhAGA......hAIA...,2,-24,-4,20
UMARVOHcWBGXKFEYPQfeSZDgJTLCNbdIa,RAAAHAAABADBGADAFAFA.EAFA.QBGAeAHHZCCADCEATDAALEEAhAAAbDED..aDDHADGB.hABAOEHB.XFAAhAAAKFBAfFHASGDD....hACA......hADA...,2,-35,11,46
McNLQFAIBTHXaGOUgJePCRSKYfDVdbEWZ,TAAAHAAAGADA.OAFAUACAeAEARBFFKCADDBIBdBHAECEA.ZDDAhAAAMCCBLEHBADDBXDGDhAAAaFAA..gFFAhAFACFBDSEFDfGDA...hACA......hADA...,1,-1,-18,17
fIKTRXDMSBGbAcaFEZeOQUVgWLPYHCdNJ,aAAAEAAAZACB..eACHQAEAUAEA..VCGBLAHB.hAHAHDEAdDDAJEBBKECARFGBMBBBhAIAGGBBABIB.OCBHhAAA..gFDA.PFHDhBAACBGB.fGFAhBEA....,2,-9,2,11
HKTWLfXBaMPDISbANdZCgeQVOUcYRGJEF,ZAAAeAAAQAEAOADCUAGARAGBGCAA.ECCBHCCA.TDFAhAAALDFABDHBaECEMECBhABADACASFFAhABAAEEBdFAACFFD.gGDB..YFHBhAFAKGHB.WFCH..hBIA....,1,7,-6,13
IPdHMXVbUDBRANfaZcgSGeOKWTYFLCJQE,aAAAZAAASACEGACAKAEA....TBGALAFA.QCCBhABAECEFdDGDHEAAMCFAhAGAbEFCBDFAAAGA.fDHAhAHAeBBD.OEEBFGGA.CFGDIHHAhCAA.....hAEA...,1,-4,-16,12
ELQbFNeXUgAfIBPGJaMTHWdRVSKCDOYcZ,BAAAGAAAaACAHADA.RAGFKCDDOAEDZDFAEEEBLAGB.QCBAhAAAbFAA.eCHHhAIAXGDDABCA.fFHEhAAAIEEAMEGBTGFAdGBASDADhACADFIB.....hBGA....,2,-16,11,27
WVdXQBJDNRUGPELCSOMTYZgFIbcfAeKHa,HAAAaAAA.dADAQADADAFARBEFGBGAEAFALBHB.OBBBhADAMCABZFFAFCDHbCFDAAIBeCCBhAAAKFDA.XGBAhACABFHANHCB.CGED...........hBGA......hCIA...,2,-10,-6,4
gXEOcbFdMAWSVUYBeaCRGNLJZTQfDIHPK,SAAAUAAAeADARAGBGACA.LAEAZCBEQDEADAIBHCEAhAAAKDHBEDHF.OEEBhABAbEAA.dFAAAADA.VGFAaFGD.hAIACGCA.....NIBB..fGEFhBAA......hBCA....,1,4,-7,11
eJNPIRTfHaKdSZEVcUDbOQgGWCALBFYXM,LAAAFAAAMADA.eADH..JAGB..IAFARBCAHDBAdDFDEAHBUCAAhABAODHDGCFAhACAAAIBBFBDXEDC.hBAAPEHDaFFBSGGB....hBDA......hBFA....,1,-9,-19,10
fIcHXTPZgdEFObGaWVASYJeCBMRUDNLQK,SAAAeAAAMAEARBCADADA.LAGBKAHB....fBFBhAAAHBCATDEAZDBAEDFAhABAbEBBaDHDADIBCEGABFDD.hAAAQGGAXFGCgGCHOFFB.hBDAWHEA....hABA....,1,-4,-5,1
MIXBHJdSYAGRNDcaPKETUVLgFWfCZbQOe,RAAADAAA..aADAEACAUAGALAFA.FBBHCBDAZCCA..QCEAhAGAeDFH.MCHBBDHAhAAAHDCBdFCAAEEBGGDBhAHA.NCIA.KFHB.........hBAA......hBEA...,2,-37,-12,25
BMbgEcRTGOPWILCZAFSDHdeNafUKVYJQX,DAAAHAAAeABAaACAKAFA..VAEAQCCABAHB.MAIBECCARCFAGCFAhAAA.OEHDhAFAIEDAZFCAACHBdEHAfHABhAHAUFFA.........hBAA......hCAA...,2,-30,4,34
QADWbPLfNZGFUMaXcIeRKdYCSTJVHgOEB,DAAA..bAAALADAZADBGAFAMAHBaAHF..XBBC.hAAAeCDARCABdDHACDFATEAAhAEAHDEBEFBA.ACCBfGGAhABAFDHDIFFASHBAgECBBHEAhACA......hBFA...,2,-19,0,19
cNSaJeHMUATFREgBKWbOGIfCVLPdQYXZD,RAAAEAAAKADC..OACCGAFACAFB.LAHB.dCCAQBGAhAAAZECEDEHB.SCCAhAEAeFBDHGFAAAHATDEAhCAA.BEGA.bFCB.fFHA.hAAA......hABA...,2,-18,-18,0
EHCXaFWbfPdRMDSOcITLYJUZGABegQNKV,eAAAQAAAKADAHAFBaACE.FAHF....bAEDdCCA.RDFAMEEBhAAAOAGD.TDAALFAAhABAUEEAAFFBBFHAVGAAEEHBhAAAXGGCfGHEDIDA.SCDFhADA.....hAFA....,2,-8,10,18
MRGcLOKBWaDQJEAbZIVXfNTHSgFCPdeYU,ZAAAXAAA..TAEAHADAFAGAdAGAeBHHMCDBRCEAGCAA.hAAALDDABCHBaDAAQFDAhABAAEEBVEGBSFAAhABACFGA.YFFF....hADA......hAFA....,2,-14,-2,12
RdCTIfXUNQDAKVPGJBEMOSYZWgeLbHFac,KAAAGAAAEACE.MADA.OAFEZAEBeAGFHCDAaAHDRCGF..dFCATDCAhAAAXFEA..QDGAhAEAAAABJFHBBDCDSCCChCAA.gFEA.FGHBhCBA......hDAA...,2,-15,-11,4
WFDPQANcgSEaYOJfXGVHKBeRMLTCIUdbZ,...NAAA.SAAA.EADAaAFAOAFCXBBAHCCAeAHHhABARCFFMCIBLBEBCDAAdECDZFCEhAAADBGBABBA..gGGAhABAfDHAKHAATEAAIHEAbECDFEFDhACA.PFHD..hADA...,1,5,-19,24
ZQgSKDVRFJIHPCEUAeYbBNGXOTdWcaMLf,eAAABAAAGACAOADCdAGAaAEA.LCCAZAGB.QDFAhAAAKBFDRCABFDHDHEDAEECAAAIB..bFAChABATGEA.MIBAhAAASCHHDGGA.IGGACHHA...hACA......hBCA....,2,-4,-4,0
OYQWdIEJPVNRCfDUGZMFaBAXeHTLScKbg,HAAATAAALADB.KAFAbACBOAHDQAEAdCADECFBPAHBhAAARDGFDEEB..ZFAAaCCHAFFB.hAAAeDFB.SDHHhAIAgGGAIGBAJHAA.CEDAGGDBhBGA......hCAA...,2,0,0,0
ZNUcAGHYEPRMIaSDCKWTFebdQVLJfgXBO,HAAAEAAARACA.aACA.CAFA.KAFC.FAHDeAGH.dCCALCCA.JCGFhAAAXDFAZDAA.cECDhAAAADIBGEEA..hADAMAIBDGHB.bFAB.QFFC..hAFA......hCAA....,1,2,-24,26
WQcZHIeOJdDYBSNgETMLKFCRfabPGUVAX,QAAAHAAAeACEdAFABACASAHBEAEAMAHB.LCCB.hAAACCEDRCGBbBDAGEEAAAIBXDDAhAEA.ZEFBOHBAhAAADCIB....YHFG...hBHA......hCAA....,2,-14,1,15
MIPCSKEGAaeVUXgFWJTcQdYOBNDfZHbLR,eAAAXAAAFADD...JADATAFA.dAHABAGBDCCB.HBCBRDDA.hAAAMAIBCDGB.ECEEADDAaDHDhABAUEEA...gGCBhAAAQFAAOCHHZFFAbFCDIGHAhABA......hCAA...,1,-6,-23,17
fGOJUNVaceZLWCQHBEgSADPTdKXbIYRFM,TAAAdAAAKADA....XAFBIADARBGF.MAFAGCAB.OCFHhACAUBFAaCAC.eCCHhAAAZECBLFGBhADAQEDA.HFFB.EDHFAAIBDDIBPHCC..hACA......hBIA....,1,9,-16,25
NVSJEHRCBFTGcPAdMKaDXefOQUbLgIWZY,dAAAaAAA.eADA.QAGALADAIAHAZABB..VCEAhAEAEBBBHCEARDCBFDHD.GDCAhAEAAFFAMIBAXEGAhAFA.OFFBgGGA.....hBAA......hCAA....,2,-6,-5,1
JSCfaBgFNMHGALEWTcIUbPDXdeZKYORVQ,EAAATAAAUADA..DACAeAFAZADE..OAGDRCBBQCGA.hAAACDDBBDFDFCCHHDFAABCALFFAhAAAIFAAXGAAhAGAdFCAKEEDVFGB..fHFBhBIANIAB......hCAA....,2,-8,-6,2
SKFGWXEVeaAZDLHROcJPUNQgdfYBMIbCT,ZAAAHAAARAEA.OACA.JAFBPBHD.UCAAQCCA.hABAdAHABCDAMDGBbCFDSDHBhAAAGFABEDEFeEHDhBHAAADA.LFEB..gFGAhACA.fHABhAFACHHD.FHEC,1,-3,-13,10
XBeHCRKGSULfYbAQEcVdOaNDTgPZFJIMW,EAAAdAAAaADADADA.....TAGAZADEFAHBMBDBBCBA.HCEARCEAGEBAhACALECB.bEEAhAAAABEBQEEBhAGA.ODHDgGEAIGGA.eCBFhAIACHHA.SHEGhBAA...,2,-18,-9,9
AZTgRXDCIKUWVYJMcNSfGOeaEdHQLPBFb,ZAAARAAACADB.KADC.UAGA..VAFA..MBFBSCCAGCAAeCCBhABAECFB.HDGBLDHBhAAAFEEHACAB.TEEAhABADGDB.IFAA.YHEAcGEDfGBAhACAaGGC..hBGA...,2,-21,-15,6
bdYFNSDAUGPWKLOXHVEacMRegJICZQTfB,GAAAKAAALACBHADAEAGEMAEARCDA..eCGHJAHB.ZFAA..TBEAhAAAbFEA..FDCHDDEBAAAB.hACAUDGB..WFHHhADAXEBA.aFED...IGBAhBEA.QGGAhBGA...,1,4,-28,32
QPgNJAHUVKYLTRSeEZFfbaGOCcMBIXDdW,HAAAKAAALACBRADFEAFEZBFEFAEA...aAGDGDAA.CCCDMDGBhAAAXCECdDHA..PEEBhACAJCHBAAIB..UEBA.hADA.YHAGeEFBOFHDBGHA.DGEB..hAAA......hBEA....,1,5,-21,26
OBRQGYTbDJaMIEZFcNXSKHfULgCAWPeVd,eAAAdAAARADAGAGA..bADAaCAE..EAHBZDAEFCCA..XDFDhACAHCEBLDGBhAAAAAIB.PEAABEDATGAAhADAMDIBIHCASEHHfFAEhABACFCD.WGFG...hAEA....,1,3,-13,16
DNTJVQBMAWXeHCgfdYFaRSbIKLGPcOUEZ,eAAAHAAACADBdAEAFAFARAGB....SBCHKBEAGCABOCFDEBHFZDEBhAAADDEB..JDHBQEBAhAAAAEEB.XEGDhABAfGFAaFFHbGACIHHA...hAGA......hAIA....,1,-4,-20,16
gMTSRHKOCNQBcPAYfXUDLFdaVbEIJGZWe,XAAALAAAaADD..EADAGAFAZAFBeAHFMAIBRCDB.HCAACDAABDCDhAAAAAFBUEDA.dEHAbEGBhABAIHAA.gGGGhABATFBAOFFB.....hACA......hAHA...,2,-9,-8,1
JeXgQIcdLAFaUPVGMSbZYRWTOCfDNEHBK,aAAAVAAAGACA..MADAZAEARCEA.OBBHDAHBHBDA.KCHBeCHHhAFAQDDBdEEDAAGAFFCBhAIASDFH.hBAAbEGDTGGACFBA.NIBB.......hBIA......hCAA....,1,2,-19,21
ADEfdGeacZUPHWgBbCKQXSTRIYJVNFOML,EAAAGAAA.eADAZACBHAEABAGAKBHBQCEB.TDGAhAAARCDAIECAVFFBOAHDhAGAAAABdEFAUGCA..PHAAhAHA.WCBDCEADSEHBNEEAMFIB.LHFAhACA...hBCA...,1,7,-15,22
dXCfTBWKgDQSFIbUVeYAOJHLPNGcREaZM,HAAALAAAGADAEAEAZAGBdAFBCBGDBBFAKCADDAIBFCAA...UDFAeCEBhABAACCB.OCHD.JDCBhACAPFEB..REFFaEABhAEAMDDB..fHGFTGGA.WEEDhBIA......hCDA....,2,-19,-5,14
fIUWaHVSeADgTYZQNJGFBdRKEMcbLCOPX,TAAAZAAAQAEA.GBGAdACAEAEAMCABLAHB.OBEEhAAAfCCEUDDAHEABhAEAeCEBAAHADDGBgEAHhABAYEGBFHBERGBAbEFD......hACA......hADA...,1,-2,-4,2
LdbBWaXPEGFDKeHTgNfYVRcSMAUQZCJOI,ZAAAOAAAdAEABAGA..aADDEBHFGAFAKCAA.HDBA.TEGAhAFA..fCFAhABARFBAMAIBAAHBQFEChBAACDDALEBBbEFAWHDAFGEADBBB..NIAB...hACA......hADA....,2,-18,5,23
KacXCQHTSbVRMPYDfLOJNUdIGFZBAWgEe,EAAAeAAAKACA..aADDCAEB.HAFA..TAGAbCCA..RCGBMDBBhAAADCCALCFA.ODDBhAAAUEEBdGHAGEFAhAGABHAAAEFB....gGCA..hAIA......hCAA....,2,-19,-9,10
PGVCfUcQbSLYeWZRFDAXBEMOIaJNHKdgT,EAAAMAAA..aACDHACCdAEA.TAGAGAGACBBD.UDDA..bCDALEBBhAAA.eDGDhAGARDGFAAFAODCBIHHAKEEBhAIA.gGGA......hBAA......hCAA...,2,-15,-15,0
JCgMSZcaIDQVWObBTeNGHEYdLfXAKFURP,FAAARAAACADB.MADAZAEB.....aAFEQAGAOAHD.BCCAeBCFhBAAHCFBEBEB.dDHALDDAhCAAAAAAKECAUGGAJDHFSFFBhCBADFFB.bGCANIBB.....fHGFhCGA..hDAA....,1,-4,-20,16
RPeSQWVcKGbUgMdEABDNYLOfJZIFXHTaC,DAAALAAAOABEZADB.FAFDHAEB.aAGARBGFeCAA..QBGChAEAVDEB.GCCAhBAAUGGAdHABACCBBDHA.hABAfEFA.XGGACEHA.SFEDhCAA..hCBA...,2,-23,-19,4
eWaPQLUADfJZTgcYMBCObFESKHVGRdXIN,DAAAZAAA..TAEA..gABAMAHBOCABEAEAHAGBGCCBhABARCDAdEAAXDGAeDCBaDHDhAEALFEAAAIB.fGAAhACAcEFBCGBASFEDKGCAIHHA.hBAANIBB.QGGAhBGA....,1,8,5,3
QWBgOLZEJYefHbCAXacdMDKPTNRSVFIUG,aAAAdAAAMADA.KAGATADA..RBDAFCBDGAFABCGALAHBhADAZDDA.EBBBeCHHHDCAhAFAAFDA.DEHB.SFDAhBAAIGGA.QGFD.OHBAhBHA......hCAA...,1,0,-39,39
IOZbMeWXRCUdVLQJTDcPKaABFfNYGgHSE,FAAA..fAAAGACAHAEAEADAZAFBeAHHRCAAdBHALDFA.hAAATEAADCEBKEFAAAGABEDAhAEAgFBAOFFAbFEChACAMGCA.CGGD.........hBAA......hCAA....,1,0,-12,12
SOgMKeWQENHPIGXJFLfUYcACDadVTZbBR,aAAAdAAAZABBBADARADA...OAEDMAHBKCEA..eAGB.EBBBHDCAhAEAGCFAFDHDLFFBhAGAfDAAUGCAAAHADBIBhADA...TDCA.bFGD.SFFDhBAA....hCAA...,1,-18,-20,2
DOdRXQENUcIKJbefPCABYWaLSTGVMgHFZ,BAAAaAAALADAGACAMAEAHAGBZBBA.dDDDRBEFEAHFUDGB.KEAAeCABhAAA.CCHA.AAEASFCAhAIATEFA.FFFHXEBDhACA.QGDAIHHA.fFHAhBCA...hBAA...,1,-7,-18,11
QMHdgeXSaKBNcGfDAFCREVPWJIYLbUZOT,RAAAEAAA..VAEAJACBLAEAZCCA..TCGAHCEAeCHH.hAAAaDDHBAHBGFABAADACECA.hABAIFFAUEEBMEIBhCAAdGHASHCAKHFA......hAAA......hAFA...,2,-24,-8,16
IFNOWABXHPJUgcfdKLaRMbEYVZCDQTSGe,HAAAUAAA...fADBdADAaAFA.RAFFEBHFZBEBQCGAhAIA.GDBAeCAAFCEHhAAAOEFCAAHAXDGAhACA.gFAAKGGAMIBA.bFFBCDDCDIGASDDDhAFA.IHHAhCAA..,1,12,-21,33
bEQHfBYDKNPgOAUMdGCSZJcWIFRTLXaeV,dAAAGAAAZABB.JADA..IAEARAGFLCDB..eAFHECFBHEGBhAAABAHAKCGA..gDBHhACAACEBMDDBSEEAhAHAFFEDaGAA.bEGD.......hAGA......hAIA...,2,-32,-8,24
YQDBPKdTWIAegMHaRFZCUOXLfNEcbVSGJ,eAAAHAAARADFZADBOAFALAGB..EBFFVDBBGCGA.QCABhAAABBCAdEEATGCAhAAAABIBaDDCCFFA.UGGA..hABAfGDANAIA.SFHHDGBB.hBFA......hBGA....,2,-7,-1,6
GDVbKNJdLHOBYTPfXZWUSaCIFcegEMAQR,RAAAGAAADADA.KADAdAGAHAFBBBDA..TCDA..XBEDhAAAZDFESAHBaBHDFCCH.hABAeDAD.EDCBAEEAQEFAhAIAbFGBLHBAOEHF...fGBAhBGA.CHHD.hCAA...,2,-35,8,43
LDPWNTMQObcFaSBgRKXGVCeZfEHIdYUJA,LAAADAAA..PACCTAEA.MAHBQAFC.OAHDhAHAbCAAaCECBBBDREAAGEEAhABAeCDBEDFAHGACdECAhBAAYEHBAEHA..cFDD.SFHBhCAA.XGFAhCEA..,1,8,-14,22
dAJNGFWVfMQSOLIeKZCXHcDBRTYPagbUE,GAAAFAAA..VADAMADA.QAGALAGBeCCBZCDAHDBBhAAABDAARDGFTFEAaCHDUEEAhADAAEEA..NIBB.SFHBhAIAKGCACGHA.DGCB.gGFA..hBAA......hBIA....,1,5,-12,17
QJPYTSWCVLZMUANefEGHOdKabcXgDIFBR,eAAAEAAAHACAdAEAKAGAaAEA.....XBCDDAHBBCCD.RCEAQECAhAAAJCFB.TEFAhAIACCHAZEBAAAAA.GGABhAGAOCHD..bFGBIGHAFHEE...hAIA......hBEA...,2,-20,-11,9
KDaYGTJHMFReWfcVgSQbALPdXIZENOUCB,dAAAZAAAEADEOADABAFBDAHBGAGA.HCAARBDBeBGD..fCEAhABAVCBB.QECChACAAAIBLEFAXEGAhAIAIGEACFEAaGEETGGAMIBAFFCD...hBIA......hCAA....,2,-18,8,26
QcSdAPDROINZaMEbBeKLfUJTFHYCVWXGg,RAAAOAAAZADB..EAFAeADALBHBUBGAFBBHHCEB..CCEA.XDAAhAAAGDCA..QEAAhAEAdFGAACCADFIBaGCAbEEBBEGAhAHAKHCA...TGGA....hAIA......hBAA....,2,-11,-6,5
XgYcBROZFIdGVEJaPbQHeCKUTAfWLDMSN,LAAAMAAA.XADD..gACABAFARAGFZCAAdAFAEDFBhABAaAHB.QCDDhBAAHEDBeCHHKCHBAFAADFIBSBBDhBFANIAB.ODFDFGGB.IFHAhBIA.JHEA.CHHB...hCAA...,1,-2,-22,20
MJdLNXKEFDfCAagWBQHTPVRIGZOeYcUSb,aAAABAAAHACB..TACARAEAZCEE..eBBDUAEAMAIBdAHALCABhAAAKEAADEFA.ABGAQDDAhACAIFFA.GDGAhCCAOEHDSGDAJGCAEHAACHFA.....hAEA......hAFA....,1,2,-18,20
KZdRPAGYMLOWcTHCgfVaIUEbJXSFQBDeN,GAAAMAAALAEAOADA...TBBAHAGBfCDAhAAAaAHD.ECFBbCEBSDBHhACAQDBBeDHFZDFBRFABhAFAAAIBcEEACDHAIFHAXGBADEEB.KGHB.hAGA......hBAA...,1,10,-3,13
JYMUdKWGSOEIXRgLbZTHeQPcaVfADCNBF,CAAAFAAA.MADAdACAGAEA..EAGARAGBLDDBZBCBHBEAeBHHhBAAQEAAaDFD.AAEBBCBDhAAAUGGASEDHhCAA..XDFD.bGAC.TGGAhAGA.....hCBA....,2,-12,-9,3
bBHNTSAGMXLEKcWFaQfPgRODeZCdVYIJU,GAAAMAAALAEAEADAKAFA.FBBA..aAHDQCDA..hAFAfCDARCFAeEFAdGAAhAGAICFAbGCABGGAHDFChAAA.TFFAAGCA.WDAD.ODCHhACADGIB.CEEDYFHBhADA.NHAB...,1,4,-6,10
faeCLRSZBcAVgYbEHFJDIXMdGKTWQNUOP,VAAA..bAAAHADBDAAA.MAFAGAEAKBFC.TAGA.QDGAhAEAOBHDaDAAeCCBhAGARDDAZFFAAEBAEEEBFGDBIHFAhAAAdGDAUGGA...CHHD.......hADA......hCAA...,2,-10,5,15
GMIEUFbXLcfWDJORVQAYaNeZBTKdPgCHS,aAAAeAAAZACBKADA.dAFACAEA.HBGBGAFA..ECCAFAHFLDEBhAAA..fCEEhBAADAIBRGEAAEEBBHAATEGASHGAhABAMBBBIHDA.XGGAhCAA.cEEC..hCCA...,2,-26,-15,11
OdbgNUeDZTKWRcVAQYMLFXPGHSEJCfBaI,MAAALAAAFADDGAFAHADBEAFA..CAHABBBAaAHDdCAA...bCFDhABAUDDAZFAA.KCHB.REGBAAFBhAHAQDDB.hBAAXFGASGGDfHBB.OHEAhACA....hAFA...,2,-33,0,33
LFMGeKRIDZUJEbAPQWdfHCSgTONcVYXBa,QAAAdAAAHADASAFEOACC..VAGBBBHALCDBhAAAGCABRCFBZDEBEEEBAAEAfDHAhAGATFCA.NIAB.XGGAhACAFFCH.MIAAeFHFDIEA....hADA......hAIA...,1,0,-8,8
cXKACbMTZFYVEBfgUaQDHLRJdNIeWSGPO,MAAAZAAAFADA..EADABAGAUAGAQCAA.HCDARBBBdBFCeAHHhABAGDGAODHDKDEDADIBhBAATFCA.fEFAhACAaECDDFFB.LHEANIBBSGGDXGAChAGA.CGGC....hBBA...,2,-24,9,33
HPLBDWNEMASXRTIGZUFVeJQCbfgcaYKOd,RAAAGAAAZADBFAFDeADA.QAGACAHA...bCDAfCGAhAAAaDAHKDCD.HDAALDHBhAAADCIBEEEBAEEATFCAhACAIFHAUFFA..gGGG.hADAOFDBBHED...hAEA....,2,-18,16,34
eJKVWZcQLMAIUCGDgfHaTSFXPNYBbEORd,CAAAGAAADACA.HADA.aAFATAEAFBHD..XCDA..hAAAPAHBBDCDEDGBRBCBeCBBhAAAKEEDZGCALDFAhAGAADABgFGASEEDNIAB.bFFB.dGCA.WFHHhAIA.....hACA....,2,-11,5,16
cMURYfBEXLTJDFGQIWKgZHOCPSNAbedaV,eAAAaAAA.MAEARACFBAEBLBDA.DAIBGAFA.QECAhAHAKCCDHBGBCDEASBBDhAIAAAAAdEBDUEGBECEB.TFFAhBAAFGHH.IDHAZFBEOFFHPHBA.hBEA......hBFA....,1,0,-4,4
GDAHFPUSKBIRbgcTeQWEXYJVCfdNZMaLO,HAAAFAAAUADABADB.RAEF.....bAFATBGA.eCAAECCB.hAGAXDDCJCFB.fDGEhAAAZDGBaDBHGEDAhAHAAAGAKFFA..IHHA.....hBAA......hBDA...,1,-14,-26,12
HJDcPEBUFWGOgdICXVNbATKaSeMZQRfLY,aAAAeAAAZACBRADALAGB.HCCADAFAEAHFFDHDGEAAdBEA.XEEAhAAAbBFD.AAIBTGCAhABAMBBBQECAhBAA.fEHA.cFFCBGHA.hAEAOHDCCHGD...hCAA....,2,-11,9,20
fXYOPIeTFgQMJWBKLGDVcEASaCNRbZUHd,aAAARAAAZADBHACBdAGA...XAEAOBFH.eAHBFCHD...MBBBhAEABCCCGCEADDABEEEBACHBCEDDhAFA.bEGDUGBA..hAAAfGDA..IFHA.hAIATGFA...hBAA....,1,7,-31,38
GYQJcaVZXbWEUPAfFdSKCBTOMRDgHNLeI,dAAACAAABACAMADA.RAFA.HADBLBDBeAFAGCAA..QCFBhACAaBHDZCFB.bCBDECCBhAAAACIB.SEEDhACAKEFDTGGADEHB.IHHA...cGAChAFA.WFDDfEHEhAIA.,2,-28,-5,23
YDUPLgHcATCVNSWQGRBOFebdXIfEKZJaM,TAAACAAA..SACAGACARAEAFBHDeAEHdDFA...XCAChAAAEAGAZCAAaBGE.MDFAhAAADEEBLEHBhACAHEEAACCAVGAAQEAAOEHDbGECKGCAYHAAhAEA.....hACA...,1,6,-8,14
DgFfWZIXaGPSAYMRcOCBdQENVTULJKbeH,RAAACAAAdACAEADE.....TAEALAFBKAGC.HCCB.FAHBZCBAaCHDhAAAGCFAACCB.MBIBhAAABEFAQEAAhAEAUFCBeFGFfFDAIHHASHDAhABAOFFH......hCAA...,2,-13,-13,0
RPBOYCKVNHMALWefbJZaEdgFSTcGUIQDX,eAAAJAAAZADBEADA.dAGAFAFD....TCCAGBGAUDFAQDAAhADARFBABBEA.CAHBKDEA.hAAAHFFAAAIBLEHBhABA............hBGA......hCAA...,1,-22,-28,6
RSNPWFcEXGVKZJHeIfBDOaMbULTAgYdQC,dAAARAAA.SADA..PADAFAGAEBFFGAGAZABB.HCCAhAAAeCEDBDFAOCGDbECCLFGBhABAACIBQEAAhAEACGBDNDIA.XDCD.KFGD.fGDAhBAAMIAA.....hAIA...,1,-2,-12,10
RLdVaUCSNMGTPJbIEAcKZWXDfYHeOBQgF,ZAAADAAAHABCeACEQAFCRAEFdAGA.UCCBSBHHGCGAJEFFhABAECCBADGB..KFDBXEAAhAEAOFHDBAHBLEEAhAIA.aEHDMICA.......hBAA......hCAA....,1,-9,-11,2
ADUIOCWaJcMXgVHePGBKTFbYQLNESRfZd,DAAAOAAACACA...aADDMAEA..XAFAHBCCeAHFGCDBhAFATDEAFBBHQEEBhAGA.EDHFREGBdFBAhBAAAAIBIGCAcGCD.gGGA..hBAA......hBDA...,2,-23,-16,7
MJHLWQTUVabeOKZGgFcNDBXAIPfSREdYC,..IAAASAAARACA.EADAdAFA.MAHBHAFA.LCCAhAAA.TCGAaCAAeCEBhACAZDAAGEEAFDABDAIBADDBfEHAhABACDGDQFGA......hADA......hDIA....,2,-18,-1,17
FfaDVMAHJgCBXUTNeYZGdKORQLcWSEbIP,HAAACAAABACATAEA.eAGHGADA.dAFBRCAALDEASAHHhAAAEEAB.bECCFCAAaDHDMBGBhACAAACA..JFGFXDEDhDAANIAB.ZDGB.OFHDWGAA....hDDA......hEAA....,1,15,-18,33
aBbMYUQeVCOKGRdXgANPSEZIHcJFfDLTW,SAAAEAAAHACAFAFALADA.aAGDbBFA.UCCBeBHHODEDhAAARCCAdEAAAAAAZDGF.JEABTEEAhAEABGED.MEIB.hAEAQFCCKGGD.XGEANIAB..hAFA......hAIA...,2,-8,-3,5
JDORBePSGUCYbNgTIEFMZQWKfLdacXHAV,DAAARAAAeADEGABB.CAFB...bAGB..TBGAEBDFZCEB.QDGBhAAAKCCDdDEA.aCCHHEAAhAEAABIB.ODGBSFGAhABAYDHBgGFGMHAA....hCAA......hDAA....,2,-18,6,24
CgJPELaUWGRBIOcAVeYHTDZbfFQMKdXSN,eAAAHAAAZADBFADDKAFAdAGASBFD.CCAD.gBGAhAAA.ECCBaBHDGCEAhABARDAAOEEAAAHA.TFGAhAAAbEGDMDIBXGBA.NIEB.LFAA.hACA......hADA...,1,-6,-10,4
WAXeBUJHNbZKdPDfFYGTCVMSEIgOQaRcL,eAAABAAAHACAZADBdAGADAEAFCFHGAGA.CCAA.MAIB..ECCBOCCHhAAARCEBLFGBABDBUFBBhABAJECFKEED..fGBEhAAATFGA.SEEDIHEA...hBFA......hBGA...,2,-24,-14,10
bSMQgLOPUfTeCZVFEJYAIGKdXRaBWcHND,GAAAdAAARADABAGBHADA.DAFAMAIBLBHB.OCDBUCDBeCBFhACAZCEBECGFAADA.KFGA.aDAHhAAA..NCGA.SGFDhACA..gFGH.fEEEhBAACHHA.FHCA.hADA...,1,-6,-30,24
FQSRdgDBfZYNUWHIMbJKEOLTPAeGCcXVa,eAAAGAAACADA...XADAaAED.QAGARAGBdCCABCFAZCDAUEEAhAAAHDGB.MDABKDHBEFHBhABATECA.AAABFFEDhACADGAA.fGAA.NIBBIHHAhADAbGAA......hAEA....,2,-24,18,42
AIUGXCBgDfFbHWJTEeVPZQYMRNSaOLdKc,GAAABAAADACAFADAHADC..TAGAEAGEeBCBZCDAMCIB.RDBF.hAAAaCECdEEAACGAUEEA.hACACCHA.bDGD..JEHBQGAChAGASHEA.......hAIA......hBAA....,1,5,-28,33
HCZeFTULQXGEPADWfNbdJSVORKgIcaBYM,DAAA..fAAAdADASAFARADAKAGC....ICBAhAAAaAHDMBBBHCEAZCCAeCFGhAFATDCALEEAGEAAAADAhACAbGAAOCHDBFHAFGEAQEFD.EGCAhBCANIEB.gGGAhBIA.YHCG.,2,-9,18,27
HbLGANSJgePYTREKZXfMVCQOIDUdaBWcF,SAAAeAAA..TADAEADAZAFBMAFAQCCADBGA.aAHDhAAABCCAFDAB.HCEAGDGAhABAAAAAgDGAhCAARFBAKFFD.fEEEOHBE.dGCA.cGGAhCBA......hCCA...,1,1,-21,22
FaCLDYWRdPIVXbHMcONJUKeTSGEAQZfBg,ZAAABAAAaACALACA.DAGARAEFdAGA..IBGAXCCCHCCAhAAAMAIBOBHD.hABAUEAAeDEAGDFAhADAAEHAQFFAFFCACFHA.WFHH.....hAEA......hCAA...,2,-19,-18,1
TLgNCPbWDcYSMJGOUaIReBQXAKEFZdHfV,EAAAdAAAHADA.TBGALADA.CAHA...bABDDBCB.SCEAhAAAGCEAaAGARCGFeDCFhAEAQEGAAEEAZFAFVFFBhAFAgDAG.PEDBcFCDMFAB.hAHA......hCAA....,2,-8,13,21
PZVdRGNDAIYSTBHUCQaLfOMXbFKWEgJec,SAAAHAAAQADCLADAMAFAFAHBEBFAeCCAZCAARCFAGCFAhAAAABIB.TEAACEDAOEGDhAAAbFDB.KFEB..gFGHhABA.........hACA......hCCA....,1,0,-5,5
TYfSQbXKDOMUgdLFHVNcWZeBCRJPAIGEa,EAAAaAAA....TADASACA.QAFAbAFB.DAIBhAAAMAIBdCCAHDABVCCBNBBAhADAZCDBBDGARDGBADABGGDBhADAXEFCOHBCLHBA.FFCH.eFHFhBAACFFB......hBHA....,2,8,9,1
eGEaLfCIAKPMVRDBQUNdHgOScYXFZWJTb,MAAARAAAQADCdAEAHAGB..SAFB..XBBAhAGAZAGBTDDAeDEBEDHFaDFFhAIALFCACDHAABBAKEBADFHBhBAABCCDUGBAOFHD.FGFDWFHH...hAAA......hABA...,2,-10,-10,0
YEIUMNZdXJRAGDVHOQeBaFgfLPbKTcCSW,GAAAHAAAeACEaADAFAGALAFB.bBGDTBFA..SAHBhAAAECDBMCIBdDFDRCCBACEAOEFBhCAAQEBAfGGAhCCAKFFACGHAIHFA.....hDAA......hDBA...,1,-6,-8,2
QRHBKLGdDFbEZeYTWVcPMOAfXJgSUNCaI,XAAASAAAUADACADA....aAEDRAFAHCFCLAGBdDBAFDDBhAAAECCBZDAFeEFB.TGAAhABAVEDAMAIB.AAAAJEHBhADAgGED.IHHAQGCDhBGA......hCAA...,1,0,-14,14
fUHbLJReWFBAMYXIDdGTOQNECScKZgPVa,MAAAXAAAdAEAGAGA..TADAQBBAEAFECAHBKCDDZDCEVEFBhAGAUCFAHDAB.hAIAbEECRGBAeFHH..hBAABCHAADIBDEBBSEHH.gGGGhAAA.aFDH..hABA....,2,-1,7,8
KaYCEGPMOTLWQJdUZNecVFbXgDRHfABIS,SAAAaAAA.EADAGACA.MAEATAFALBEB.hAAAQBGAdAHAZCCAeDABhABAFDGHbFFADDGAHECAhADAABBBKGBACHHDOEGB.JFHBNIAB......hCAA......hCBA....,1,2,-8,10
